Ticker,Name,buy,sell,diff,Branch,Date,Branch_Code
2892,第一金,101,0,101,凱基-林口,2023-01-03,9257
6443,元晶,77,0,77,凱基-林口,2023-01-03,9257
00670L,富邦NASDAQ正2,72,2,70,凱基-林口,2023-01-03,9257
1752,南光,50,1,49,凱基-林口,2023-01-03,9257
4161,聿新科,49,0,49,凱基-林口,2023-01-03,9257
2303,聯電,33,2,31,凱基-林口,2023-01-03,9257
2610,華航,54,26,28,凱基-林口,2023-01-03,9257
00700,富邦�琤肭磪�,19,0,19,凱基-林口,2023-01-03,9257
00885,富邦越南,19,0,19,凱基-林口,2023-01-03,9257
00878,國泰永續高股息,24,5,19,凱基-林口,2023-01-03,9257
0056,元大高股息,16,0,16,凱基-林口,2023-01-03,9257
3532,台勝科,16,0,16,凱基-林口,2023-01-03,9257
00882,中信中國高股息,16,1,15,凱基-林口,2023-01-03,9257
1605,華新,14,1,13,凱基-林口,2023-01-03,9257
3479,安勤,13,0,13,凱基-林口,2023-01-03,9257
00637L,元大滬深300正2,16,4,12,凱基-林口,2023-01-03,9257
6285,啟��,12,0,12,凱基-林口,2023-01-03,9257
2890,永豐金,11,0,11,凱基-林口,2023-01-03,9257
00773B,中信優先金融債,10,0,10,凱基-林口,2023-01-03,9257
1802,台玻,12,2,10,凱基-林口,2023-01-03,9257
1909,榮成,10,0,10,凱基-林口,2023-01-03,9257
6118,建達,10,0,10,凱基-林口,2023-01-03,9257
6168,宏齊,10,0,10,凱基-林口,2023-01-03,9257
8097,常珵,10,0,10,凱基-林口,2023-01-03,9257
2002,中鋼,10,1,9,凱基-林口,2023-01-03,9257
2882,國泰金,16,8,8,凱基-林口,2023-01-03,9257
2609,陽明,10,2,8,凱基-林口,2023-01-03,9257
4743,合一,9,1,8,凱基-林口,2023-01-03,9257
3693,營邦,7,0,7,凱基-林口,2023-01-03,9257
2317,鴻海,16,10,6,凱基-林口,2023-01-03,9257
2707,晶華,6,0,6,凱基-林口,2023-01-03,9257
00881,國泰台灣5G+,6,0,6,凱基-林口,2023-01-03,9257
00757,統一FANG+,6,0,6,凱基-林口,2023-01-03,9257
1701,中化,7,1,6,凱基-林口,2023-01-03,9257
2402,毅嘉,6,0,6,凱基-林口,2023-01-03,9257
5227,立凱-KY,6,0,6,凱基-林口,2023-01-03,9257
5880,合庫金,5,0,5,凱基-林口,2023-01-03,9257
00720B,元大投資級公司債,5,0,5,凱基-林口,2023-01-03,9257
00772B,中信高評級公司債,5,0,5,凱基-林口,2023-01-03,9257
2607,榮運,5,0,5,凱基-林口,2023-01-03,9257
1301,台塑,5,0,5,凱基-林口,2023-01-03,9257
00673R,期元大S＆P原油反1,5,0,5,凱基-林口,2023-01-03,9257
2603,長榮,10,5,5,凱基-林口,2023-01-03,9257
3083,網龍,5,0,5,凱基-林口,2023-01-03,9257
3265,台星科,5,0,5,凱基-林口,2023-01-03,9257
5009,榮剛,5,0,5,凱基-林口,2023-01-03,9257
8043,蜜望實,5,0,5,凱基-林口,2023-01-03,9257
00632R,元大台灣50反1,72,68,4,凱基-林口,2023-01-03,9257
00891,中信關鍵半導體,4,0,4,凱基-林口,2023-01-03,9257
00852L,國泰美國道瓊正2,4,0,4,凱基-林口,2023-01-03,9257
00632R,元大台灣50反1,310,50,260,凱基-林口,2023-01-04,9257
2303,聯電,56,2,54,凱基-林口,2023-01-04,9257
2637,慧洋-KY,31,0,31,凱基-林口,2023-01-04,9257
00671R,富邦NASDAQ反1,30,3,27,凱基-林口,2023-01-04,9257
4161,聿新科,20,0,20,凱基-林口,2023-01-04,9257
6443,元晶,48,29,19,凱基-林口,2023-01-04,9257
2317,鴻海,20,1,19,凱基-林口,2023-01-04,9257
3047,訊舟,17,0,17,凱基-林口,2023-01-04,9257
2331,精英,15,0,15,凱基-林口,2023-01-04,9257
8183,精星,15,0,15,凱基-林口,2023-01-04,9257
4979,華星光,13,0,13,凱基-林口,2023-01-04,9257
4114,健喬,23,11,12,凱基-林口,2023-01-04,9257
9103,美德醫療-DR,12,0,12,凱基-林口,2023-01-04,9257
00895,富邦未來車,11,0,11,凱基-林口,2023-01-04,9257
2413,環科,11,0,11,凱基-林口,2023-01-04,9257
00713,元大台灣高息低波,10,0,10,凱基-林口,2023-01-04,9257
00680L,元大美債20正2,10,0,10,凱基-林口,2023-01-04,9257
2409,友達,10,0,10,凱基-林口,2023-01-04,9257
0056,元大高股息,10,1,9,凱基-林口,2023-01-04,9257
2014,中鴻,7,0,7,凱基-林口,2023-01-04,9257
2603,長榮,9,2,7,凱基-林口,2023-01-04,9257
4989,榮科,7,0,7,凱基-林口,2023-01-04,9257
8171,天宇,7,0,7,凱基-林口,2023-01-04,9257
3037,欣興,7,0,7,凱基-林口,2023-01-04,9257
3380,明泰,6,0,6,凱基-林口,2023-01-04,9257
9951,皇田,6,0,6,凱基-林口,2023-01-04,9257
00715L,期街口布蘭特正2,5,0,5,凱基-林口,2023-01-04,9257
00665L,富邦�琤肭磪囓�2,10,5,5,凱基-林口,2023-01-04,9257
00900,富邦特選高股息30,5,0,5,凱基-林口,2023-01-04,9257
1231,聯華食,5,0,5,凱基-林口,2023-01-04,9257
3017,奇鋐,5,0,5,凱基-林口,2023-01-04,9257
3322,建舜電,5,0,5,凱基-林口,2023-01-04,9257
3689,湧德,5,0,5,凱基-林口,2023-01-04,9257
5340,建榮,5,0,5,凱基-林口,2023-01-04,9257
6806,森崴能源,6,1,5,凱基-林口,2023-01-04,9257
2609,陽明,7,3,4,凱基-林口,2023-01-04,9257
1701,中化,11,7,4,凱基-林口,2023-01-04,9257
2338,光罩,4,0,4,凱基-林口,2023-01-04,9257
3312,弘憶股,4,0,4,凱基-林口,2023-01-04,9257
5706,鳳凰,8,4,4,凱基-林口,2023-01-04,9257
5425,台半,26,22,4,凱基-林口,2023-01-04,9257
2884,玉山金,5,2,3,凱基-林口,2023-01-04,9257
2610,華航,21,18,3,凱基-林口,2023-01-04,9257
2618,長榮航,14,11,3,凱基-林口,2023-01-04,9257
1217,愛之味,3,0,3,凱基-林口,2023-01-04,9257
1760,寶齡富錦,7,4,3,凱基-林口,2023-01-04,9257
2344,華邦電,3,0,3,凱基-林口,2023-01-04,9257
2615,萬海,4,1,3,凱基-林口,2023-01-04,9257
2867,三商壽,4,1,3,凱基-林口,2023-01-04,9257
2929,淘帝-KY,3,0,3,凱基-林口,2023-01-04,9257
2610,華航,81,11,70,凱基-林口,2023-01-05,9257
6276,安鈦克,50,0,50,凱基-林口,2023-01-05,9257
2425,承啟,45,0,45,凱基-林口,2023-01-05,9257
2614,東森,65,21,44,凱基-林口,2023-01-05,9257
3019,亞光,35,0,35,凱基-林口,2023-01-05,9257
6443,元晶,35,1,34,凱基-林口,2023-01-05,9257
4161,聿新科,32,0,32,凱基-林口,2023-01-05,9257
5425,台半,32,0,32,凱基-林口,2023-01-05,9257
2317,鴻海,26,0,26,凱基-林口,2023-01-05,9257
00632R,元大台灣50反1,35,12,23,凱基-林口,2023-01-05,9257
1444,力麗,22,0,22,凱基-林口,2023-01-05,9257
00885,富邦越南,35,13,22,凱基-林口,2023-01-05,9257
8249,菱光,21,0,21,凱基-林口,2023-01-05,9257
00671R,富邦NASDAQ反1,50,30,20,凱基-林口,2023-01-05,9257
00665L,富邦�琤肭磪囓�2,20,0,20,凱基-林口,2023-01-05,9257
2484,希華,20,0,20,凱基-林口,2023-01-05,9257
5512,力麒,18,0,18,凱基-林口,2023-01-05,9257
1513,中興電,37,22,15,凱基-林口,2023-01-05,9257
4130,健亞,29,14,15,凱基-林口,2023-01-05,9257
8046,南電,15,1,14,凱基-林口,2023-01-05,9257
1701,中化,13,1,12,凱基-林口,2023-01-05,9257
2609,陽明,14,2,12,凱基-林口,2023-01-05,9257
1529,樂事綠能,11,0,11,凱基-林口,2023-01-05,9257
2349,錸德,11,0,11,凱基-林口,2023-01-05,9257
1752,南光,13,3,10,凱基-林口,2023-01-05,9257
2338,光罩,10,0,10,凱基-林口,2023-01-05,9257
2460,建通,40,30,10,凱基-林口,2023-01-05,9257
5258,虹堡,10,0,10,凱基-林口,2023-01-05,9257
6282,康舒,10,0,10,凱基-林口,2023-01-05,9257
6741,91APP*-KY,11,1,10,凱基-林口,2023-01-05,9257
1504,東元,10,0,10,凱基-林口,2023-01-05,9257
1519,華城,35,26,9,凱基-林口,2023-01-05,9257
3673,TPK-KY,9,0,9,凱基-林口,2023-01-05,9257
4123,晟德,10,1,9,凱基-林口,2023-01-05,9257
9802,鈺齊-KY,10,1,9,凱基-林口,2023-01-05,9257
8069,元太,11,2,9,凱基-林口,2023-01-05,9257
2498,宏達電,12,3,9,凱基-林口,2023-01-05,9257
4979,華星光,8,0,8,凱基-林口,2023-01-05,9257
2882,國泰金,10,3,7,凱基-林口,2023-01-05,9257
00679B,元大美債20年,6,0,6,凱基-林口,2023-01-05,9257
00720B,元大投資級公司債,6,0,6,凱基-林口,2023-01-05,9257
3013,晟銘電,6,0,6,凱基-林口,2023-01-05,9257
6104,創惟,21,15,6,凱基-林口,2023-01-05,9257
6806,森崴能源,7,1,6,凱基-林口,2023-01-05,9257
2615,萬海,10,5,5,凱基-林口,2023-01-05,9257
1605,華新,11,6,5,凱基-林口,2023-01-05,9257
3374,精材,5,0,5,凱基-林口,2023-01-05,9257
2642,宅配通,6,1,5,凱基-林口,2023-01-05,9257
2109,華豐,5,0,5,凱基-林口,2023-01-05,9257
2331,精英,5,0,5,凱基-林口,2023-01-05,9257
00885,富邦越南,130,0,130,凱基-林口,2023-01-06,9257
6274,台燿,87,2,85,凱基-林口,2023-01-06,9257
2303,聯電,71,5,66,凱基-林口,2023-01-06,9257
3479,安勤,40,7,33,凱基-林口,2023-01-06,9257
00641R,富邦日本反1,30,0,30,凱基-林口,2023-01-06,9257
1467,南緯,50,25,25,凱基-林口,2023-01-06,9257
00632R,元大台灣50反1,22,0,22,凱基-林口,2023-01-06,9257
5388,中磊,20,0,20,凱基-林口,2023-01-06,9257
6443,元晶,20,0,20,凱基-林口,2023-01-06,9257
8114,振樺電,20,0,20,凱基-林口,2023-01-06,9257
00671R,富邦NASDAQ反1,15,0,15,凱基-林口,2023-01-06,9257
2748,雲品,15,0,15,凱基-林口,2023-01-06,9257
00720B,元大投資級公司債,13,0,13,凱基-林口,2023-01-06,9257
00878,國泰永續高股息,22,9,13,凱基-林口,2023-01-06,9257
6589,台康生技,21,8,13,凱基-林口,2023-01-06,9257
00893,國泰智能電動車,11,0,11,凱基-林口,2023-01-06,9257
3673,TPK-KY,11,0,11,凱基-林口,2023-01-06,9257
8105,凌巨,16,5,11,凱基-林口,2023-01-06,9257
1618,合機,19,9,10,凱基-林口,2023-01-06,9257
3693,營邦,23,13,10,凱基-林口,2023-01-06,9257
4161,聿新科,10,0,10,凱基-林口,2023-01-06,9257
6220,岳豐,10,0,10,凱基-林口,2023-01-06,9257
6282,康舒,10,0,10,凱基-林口,2023-01-06,9257
1752,南光,17,8,9,凱基-林口,2023-01-06,9257
1605,華新,30,22,8,凱基-林口,2023-01-06,9257
1519,華城,18,10,8,凱基-林口,2023-01-06,9257
8016,矽創,10,2,8,凱基-林口,2023-01-06,9257
6585,鼎基,7,0,7,凱基-林口,2023-01-06,9257
1101,台泥,6,0,6,凱基-林口,2023-01-06,9257
2915,潤泰全,6,0,6,凱基-林口,2023-01-06,9257
3576,聯合再生,6,0,6,凱基-林口,2023-01-06,9257
6215,和椿,25,19,6,凱基-林口,2023-01-06,9257
6219,富旺,6,0,6,凱基-林口,2023-01-06,9257
2615,萬海,9,4,5,凱基-林口,2023-01-06,9257
1909,榮成,5,0,5,凱基-林口,2023-01-06,9257
2105,正新,5,0,5,凱基-林口,2023-01-06,9257
2408,南亞科,10,5,5,凱基-林口,2023-01-06,9257
2834,臺企銀,5,0,5,凱基-林口,2023-01-06,9257
3027,盛達,5,0,5,凱基-林口,2023-01-06,9257
4155,訊映,5,0,5,凱基-林口,2023-01-06,9257
4167,松瑞藥,5,0,5,凱基-林口,2023-01-06,9257
4426,利勤,5,0,5,凱基-林口,2023-01-06,9257
5222,全訊,6,1,5,凱基-林口,2023-01-06,9257
5531,鄉林,5,0,5,凱基-林口,2023-01-06,9257
5608,四維航,7,2,5,凱基-林口,2023-01-06,9257
6245,立端,5,0,5,凱基-林口,2023-01-06,9257
8171,天宇,10,6,4,凱基-林口,2023-01-06,9257
5351,鈺創,7,3,4,凱基-林口,2023-01-06,9257
6180,橘子,4,0,4,凱基-林口,2023-01-06,9257
3141,晶宏,4,0,4,凱基-林口,2023-01-06,9257
00893,國泰智能電動車,81,0,81,凱基-林口,2023-01-09,9257
6282,康舒,62,0,62,凱基-林口,2023-01-09,9257
2614,東森,38,0,38,凱基-林口,2023-01-09,9257
6285,啟��,33,0,33,凱基-林口,2023-01-09,9257
00902,中信電池及儲能,30,0,30,凱基-林口,2023-01-09,9257
6124,業強,37,10,27,凱基-林口,2023-01-09,9257
1752,南光,22,0,22,凱基-林口,2023-01-09,9257
8044,網家,26,4,22,凱基-林口,2023-01-09,9257
2338,光罩,23,7,16,凱基-林口,2023-01-09,9257
4130,健亞,16,0,16,凱基-林口,2023-01-09,9257
8155,博智,16,0,16,凱基-林口,2023-01-09,9257
2530,華建,15,0,15,凱基-林口,2023-01-09,9257
8069,元太,35,20,15,凱基-林口,2023-01-09,9257
00720B,元大投資級公司債,14,0,14,凱基-林口,2023-01-09,9257
2603,長榮,12,1,11,凱基-林口,2023-01-09,9257
1519,華城,11,0,11,凱基-林口,2023-01-09,9257
2328,廣宇,17,6,11,凱基-林口,2023-01-09,9257
00753L,中信中國50正2,10,0,10,凱基-林口,2023-01-09,9257
2312,金寶,10,0,10,凱基-林口,2023-01-09,9257
2929,淘帝-KY,10,0,10,凱基-林口,2023-01-09,9257
3003,健和興,10,0,10,凱基-林口,2023-01-09,9257
3710,連展投控,11,1,10,凱基-林口,2023-01-09,9257
6168,宏齊,10,0,10,凱基-林口,2023-01-09,9257
6768,志強-KY,10,0,10,凱基-林口,2023-01-09,9257
2609,陽明,9,0,9,凱基-林口,2023-01-09,9257
6727,亞泰金屬,9,0,9,凱基-林口,2023-01-09,9257
8183,精星,9,0,9,凱基-林口,2023-01-09,9257
1609,大亞,20,13,7,凱基-林口,2023-01-09,9257
2615,萬海,13,6,7,凱基-林口,2023-01-09,9257
00891,中信關鍵半導體,6,0,6,凱基-林口,2023-01-09,9257
2317,鴻海,6,0,6,凱基-林口,2023-01-09,9257
8299,群聯,5,0,5,凱基-林口,2023-01-09,9257
00670L,富邦NASDAQ正2,5,0,5,凱基-林口,2023-01-09,9257
1714,和桐,5,0,5,凱基-林口,2023-01-09,9257
2486,一詮,39,34,5,凱基-林口,2023-01-09,9257
3027,盛達,5,0,5,凱基-林口,2023-01-09,9257
3030,德律,5,0,5,凱基-林口,2023-01-09,9257
3444,利機,5,0,5,凱基-林口,2023-01-09,9257
3673,TPK-KY,5,0,5,凱基-林口,2023-01-09,9257
6122,擎邦,5,0,5,凱基-林口,2023-01-09,9257
8016,矽創,5,0,5,凱基-林口,2023-01-09,9257
8050,廣積,5,0,5,凱基-林口,2023-01-09,9257
8091,翔名,5,0,5,凱基-林口,2023-01-09,9257
3035,智原,5,1,4,凱基-林口,2023-01-09,9257
6125,廣運,4,0,4,凱基-林口,2023-01-09,9257
6642,富致,4,0,4,凱基-林口,2023-01-09,9257
2618,長榮航,33,29,4,凱基-林口,2023-01-09,9257
006207,復華滬深,3,0,3,凱基-林口,2023-01-09,9257
00715L,期街口布蘭特正2,20,17,3,凱基-林口,2023-01-09,9257
1457,宜進,3,0,3,凱基-林口,2023-01-09,9257
4950,牧東,200,0,200,凱基-林口,2023-01-10,9257
00885,富邦越南,190,2,188,凱基-林口,2023-01-10,9257
6443,元晶,146,25,121,凱基-林口,2023-01-10,9257
00632R,元大台灣50反1,75,0,75,凱基-林口,2023-01-10,9257
4977,眾達-KY,50,5,45,凱基-林口,2023-01-10,9257
2614,東森,38,0,38,凱基-林口,2023-01-10,9257
4161,聿新科,33,0,33,凱基-林口,2023-01-10,9257
3047,訊舟,30,0,30,凱基-林口,2023-01-10,9257
1752,南光,30,4,26,凱基-林口,2023-01-10,9257
6118,建達,26,0,26,凱基-林口,2023-01-10,9257
2609,陽明,31,6,25,凱基-林口,2023-01-10,9257
2916,滿心,25,0,25,凱基-林口,2023-01-10,9257
6182,合晶,22,0,22,凱基-林口,2023-01-10,9257
2882,國泰金,17,0,17,凱基-林口,2023-01-10,9257
00900,富邦特選高股息30,12,0,12,凱基-林口,2023-01-10,9257
3374,精材,12,0,12,凱基-林口,2023-01-10,9257
00881,國泰台灣5G+,12,0,12,凱基-林口,2023-01-10,9257
00715L,期街口布蘭特正2,10,0,10,凱基-林口,2023-01-10,9257
1618,合機,17,7,10,凱基-林口,2023-01-10,9257
2359,所羅門,10,0,10,凱基-林口,2023-01-10,9257
2929,淘帝-KY,10,0,10,凱基-林口,2023-01-10,9257
5009,榮剛,10,0,10,凱基-林口,2023-01-10,9257
6226,光鼎,10,0,10,凱基-林口,2023-01-10,9257
6235,華孚,10,0,10,凱基-林口,2023-01-10,9257
6741,91APP*-KY,10,0,10,凱基-林口,2023-01-10,9257
6781,AES-KY,9,0,9,凱基-林口,2023-01-10,9257
2338,光罩,10,2,8,凱基-林口,2023-01-10,9257
1701,中化,9,1,8,凱基-林口,2023-01-10,9257
3419,譁裕,8,0,8,凱基-林口,2023-01-10,9257
6133,金橋,7,0,7,凱基-林口,2023-01-10,9257
00919,群益台灣精選高息,6,0,6,凱基-林口,2023-01-10,9257
00679B,元大美債20年,6,0,6,凱基-林口,2023-01-10,9257
1760,寶齡富錦,6,0,6,凱基-林口,2023-01-10,9257
2027,大成鋼,7,1,6,凱基-林口,2023-01-10,9257
2363,矽統,6,0,6,凱基-林口,2023-01-10,9257
3714,富采,11,5,6,凱基-林口,2023-01-10,9257
1708,東鹼,5,0,5,凱基-林口,2023-01-10,9257
3491,昇達科,5,0,5,凱基-林口,2023-01-10,9257
00643,群益深証中小,5,0,5,凱基-林口,2023-01-10,9257
00902,中信電池及儲能,5,0,5,凱基-林口,2023-01-10,9257
1909,榮成,5,0,5,凱基-林口,2023-01-10,9257
3162,精確,5,0,5,凱基-林口,2023-01-10,9257
8938,明安,5,0,5,凱基-林口,2023-01-10,9257
1605,華新,27,23,4,凱基-林口,2023-01-10,9257
1503,士電,4,0,4,凱基-林口,2023-01-10,9257
3705,永信,4,0,4,凱基-林口,2023-01-10,9257
4104,佳醫,4,0,4,凱基-林口,2023-01-10,9257
4919,新唐,4,0,4,凱基-林口,2023-01-10,9257
4961,天鈺,5,1,4,凱基-林口,2023-01-10,9257
5340,建榮,5,1,4,凱基-林口,2023-01-10,9257
6182,合晶,35,0,35,凱基-林口,2023-01-11,9257
8477,創業家,37,2,35,凱基-林口,2023-01-11,9257
4161,聿新科,26,0,26,凱基-林口,2023-01-11,9257
0050,元大台灣50,43,18,25,凱基-林口,2023-01-11,9257
2495,普安,21,0,21,凱基-林口,2023-01-11,9257
3710,連展投控,20,0,20,凱基-林口,2023-01-11,9257
1605,華新,22,3,19,凱基-林口,2023-01-11,9257
2615,萬海,19,5,14,凱基-林口,2023-01-11,9257
4167,松瑞藥,13,2,11,凱基-林口,2023-01-11,9257
1513,中興電,11,0,11,凱基-林口,2023-01-11,9257
1618,合機,20,10,10,凱基-林口,2023-01-11,9257
2359,所羅門,10,0,10,凱基-林口,2023-01-11,9257
2482,連宇,10,0,10,凱基-林口,2023-01-11,9257
2611,志信,10,0,10,凱基-林口,2023-01-11,9257
2634,漢翔,12,2,10,凱基-林口,2023-01-11,9257
3149,正達,10,0,10,凱基-林口,2023-01-11,9257
5388,中磊,10,0,10,凱基-林口,2023-01-11,9257
8358,金居,10,0,10,凱基-林口,2023-01-11,9257
5608,四維航,10,0,10,凱基-林口,2023-01-11,9257
2530,華建,10,1,9,凱基-林口,2023-01-11,9257
2887,台新金,10,1,9,凱基-林口,2023-01-11,9257
6187,萬潤,9,0,9,凱基-林口,2023-01-11,9257
4503,金雨,8,0,8,凱基-林口,2023-01-11,9257
00670L,富邦NASDAQ正2,7,0,7,凱基-林口,2023-01-11,9257
5009,榮剛,7,0,7,凱基-林口,2023-01-11,9257
6781,AES-KY,6,0,6,凱基-林口,2023-01-11,9257
4943,康控-KY,6,0,6,凱基-林口,2023-01-11,9257
6727,亞泰金屬,6,0,6,凱基-林口,2023-01-11,9257
4743,合一,6,1,5,凱基-林口,2023-01-11,9257
1529,樂事綠能,5,0,5,凱基-林口,2023-01-11,9257
2867,三商壽,5,0,5,凱基-林口,2023-01-11,9257
3455,由田,5,0,5,凱基-林口,2023-01-11,9257
3508,位速,6,1,5,凱基-林口,2023-01-11,9257
4977,眾達-KY,10,5,5,凱基-林口,2023-01-11,9257
6123,上奇,5,0,5,凱基-林口,2023-01-11,9257
6143,振曜,5,0,5,凱基-林口,2023-01-11,9257
6443,元晶,5,0,5,凱基-林口,2023-01-11,9257
8069,元太,6,1,5,凱基-林口,2023-01-11,9257
8215,明基材,5,0,5,凱基-林口,2023-01-11,9257
3374,精材,5,0,5,凱基-林口,2023-01-11,9257
00878,國泰永續高股息,7,3,4,凱基-林口,2023-01-11,9257
00637L,元大滬深300正2,12,8,4,凱基-林口,2023-01-11,9257
1342,八貫,4,0,4,凱基-林口,2023-01-11,9257
1612,宏泰,4,0,4,凱基-林口,2023-01-11,9257
3059,華晶科,4,0,4,凱基-林口,2023-01-11,9257
5251,天鉞電,6,2,4,凱基-林口,2023-01-11,9257
5425,台半,6,2,4,凱基-林口,2023-01-11,9257
6164,華興,4,0,4,凱基-林口,2023-01-11,9257
2884,玉山金,4,0,4,凱基-林口,2023-01-11,9257
2009,第一銅,5,1,4,凱基-林口,2023-01-11,9257
00680L,元大美債20正2,80,0,80,凱基-林口,2023-01-12,9257
6282,康舒,50,0,50,凱基-林口,2023-01-12,9257
8358,金居,60,11,49,凱基-林口,2023-01-12,9257
3710,連展投控,51,4,47,凱基-林口,2023-01-12,9257
2609,陽明,29,2,27,凱基-林口,2023-01-12,9257
3704,合勤控,24,0,24,凱基-林口,2023-01-12,9257
2615,萬海,26,3,23,凱基-林口,2023-01-12,9257
00900,富邦特選高股息30,21,0,21,凱基-林口,2023-01-12,9257
00920,富邦ESG綠色電力,20,0,20,凱基-林口,2023-01-12,9257
2349,錸德,20,0,20,凱基-林口,2023-01-12,9257
2358,廷鑫,30,12,18,凱基-林口,2023-01-12,9257
5351,鈺創,17,0,17,凱基-林口,2023-01-12,9257
6182,合晶,16,0,16,凱基-林口,2023-01-12,9257
1608,華榮,13,0,13,凱基-林口,2023-01-12,9257
2888,新光金,13,0,13,凱基-林口,2023-01-12,9257
1711,永光,10,0,10,凱基-林口,2023-01-12,9257
6245,立端,24,15,9,凱基-林口,2023-01-12,9257
4919,新唐,11,2,9,凱基-林口,2023-01-12,9257
2317,鴻海,8,0,8,凱基-林口,2023-01-12,9257
00882,中信中國高股息,8,1,7,凱基-林口,2023-01-12,9257
2834,臺企銀,22,15,7,凱基-林口,2023-01-12,9257
4161,聿新科,22,15,7,凱基-林口,2023-01-12,9257
0050,元大台灣50,9,3,6,凱基-林口,2023-01-12,9257
2603,長榮,6,0,6,凱基-林口,2023-01-12,9257
1701,中化,6,0,6,凱基-林口,2023-01-12,9257
2338,光罩,6,0,6,凱基-林口,2023-01-12,9257
2610,華航,11,5,6,凱基-林口,2023-01-12,9257
3260,威剛,7,1,6,凱基-林口,2023-01-12,9257
6727,亞泰金屬,6,0,6,凱基-林口,2023-01-12,9257
2409,友達,6,1,5,凱基-林口,2023-01-12,9257
00655L,國泰中國A50正2,5,0,5,凱基-林口,2023-01-12,9257
1714,和桐,5,0,5,凱基-林口,2023-01-12,9257
2105,正新,5,0,5,凱基-林口,2023-01-12,9257
2376,技嘉,6,1,5,凱基-林口,2023-01-12,9257
2867,三商壽,5,0,5,凱基-林口,2023-01-12,9257
3027,盛達,5,0,5,凱基-林口,2023-01-12,9257
3138,耀登,6,1,5,凱基-林口,2023-01-12,9257
3149,正達,5,0,5,凱基-林口,2023-01-12,9257
3558,神準,7,2,5,凱基-林口,2023-01-12,9257
5478,智冠,5,0,5,凱基-林口,2023-01-12,9257
0056,元大高股息,4,0,4,凱基-林口,2023-01-12,9257
2607,榮運,4,0,4,凱基-林口,2023-01-12,9257
2412,中華電,4,0,4,凱基-林口,2023-01-12,9257
2916,滿心,4,0,4,凱基-林口,2023-01-12,9257
3511,矽瑪,5,1,4,凱基-林口,2023-01-12,9257
4173,久裕,4,0,4,凱基-林口,2023-01-12,9257
8016,矽創,4,0,4,凱基-林口,2023-01-12,9257
8044,網家,4,0,4,凱基-林口,2023-01-12,9257
8477,創業家,4,0,4,凱基-林口,2023-01-12,9257
1605,華新,21,18,3,凱基-林口,2023-01-12,9257
2888,新光金,100,0,100,凱基-林口,2023-01-13,9257
00680L,元大美債20正2,70,0,70,凱基-林口,2023-01-13,9257
00632R,元大台灣50反1,106,72,34,凱基-林口,2023-01-13,9257
3704,合勤控,32,3,29,凱基-林口,2023-01-13,9257
00665L,富邦�琤肭磪囓�2,21,1,20,凱基-林口,2023-01-13,9257
6226,光鼎,20,0,20,凱基-林口,2023-01-13,9257
8084,巨虹,20,0,20,凱基-林口,2023-01-13,9257
2498,宏達電,33,14,19,凱基-林口,2023-01-13,9257
4919,新唐,19,1,18,凱基-林口,2023-01-13,9257
6443,元晶,18,1,17,凱基-林口,2023-01-13,9257
2891,中信金,15,1,14,凱基-林口,2023-01-13,9257
4130,健亞,30,16,14,凱基-林口,2023-01-13,9257
2609,陽明,13,1,12,凱基-林口,2023-01-13,9257
2881,富邦金,11,0,11,凱基-林口,2023-01-13,9257
00900,富邦特選高股息30,10,0,10,凱基-林口,2023-01-13,9257
1618,合機,10,0,10,凱基-林口,2023-01-13,9257
2312,金寶,10,0,10,凱基-林口,2023-01-13,9257
3313,斐成,10,0,10,凱基-林口,2023-01-13,9257
3062,建漢,9,0,9,凱基-林口,2023-01-13,9257
8069,元太,12,3,9,凱基-林口,2023-01-13,9257
2382,廣達,10,2,8,凱基-林口,2023-01-13,9257
1101,台泥,31,23,8,凱基-林口,2023-01-13,9257
2014,中鴻,18,10,8,凱基-林口,2023-01-13,9257
2916,滿心,8,0,8,凱基-林口,2023-01-13,9257
6689,伊雲谷,13,5,8,凱基-林口,2023-01-13,9257
1513,中興電,8,1,7,凱基-林口,2023-01-13,9257
00715L,期街口布蘭特正2,10,3,7,凱基-林口,2023-01-13,9257
1560,中砂,14,7,7,凱基-林口,2023-01-13,9257
2332,友訊,7,0,7,凱基-林口,2023-01-13,9257
6770,力積電,7,0,7,凱基-林口,2023-01-13,9257
8050,廣積,7,0,7,凱基-林口,2023-01-13,9257
1734,杏輝,6,0,6,凱基-林口,2023-01-13,9257
2836,高雄銀,6,0,6,凱基-林口,2023-01-13,9257
3293,鈊象,5,0,5,凱基-林口,2023-01-13,9257
00643,群益深証中小,5,0,5,凱基-林口,2023-01-13,9257
1714,和桐,5,0,5,凱基-林口,2023-01-13,9257
1720,生達,5,0,5,凱基-林口,2023-01-13,9257
2331,精英,5,0,5,凱基-林口,2023-01-13,9257
2380,虹光,5,0,5,凱基-林口,2023-01-13,9257
2867,三商壽,5,0,5,凱基-林口,2023-01-13,9257
3013,晟銘電,5,0,5,凱基-林口,2023-01-13,9257
3664,安瑞-KY,5,0,5,凱基-林口,2023-01-13,9257
4167,松瑞藥,5,0,5,凱基-林口,2023-01-13,9257
6148,驊宏資,5,0,5,凱基-林口,2023-01-13,9257
6205,詮欣,5,0,5,凱基-林口,2023-01-13,9257
8086,宏捷科,4,0,4,凱基-林口,2023-01-13,9257
00919,群益台灣精選高息,4,0,4,凱基-林口,2023-01-13,9257
2317,鴻海,5,1,4,凱基-林口,2023-01-13,9257
4105,東洋,4,0,4,凱基-林口,2023-01-13,9257
4426,利勤,4,0,4,凱基-林口,2023-01-13,9257
00632R,元大台灣50反1,330,200,130,凱基-林口,2023-01-16,9257
00885,富邦越南,71,0,71,凱基-林口,2023-01-16,9257
3704,合勤控,44,0,44,凱基-林口,2023-01-16,9257
00679B,元大美債20年,25,0,25,凱基-林口,2023-01-16,9257
2312,金寶,20,0,20,凱基-林口,2023-01-16,9257
4161,聿新科,18,0,18,凱基-林口,2023-01-16,9257
2317,鴻海,16,0,16,凱基-林口,2023-01-16,9257
6770,力積電,21,6,15,凱基-林口,2023-01-16,9257
5478,智冠,14,0,14,凱基-林口,2023-01-16,9257
3479,安勤,12,0,12,凱基-林口,2023-01-16,9257
00720B,元大投資級公司債,11,0,11,凱基-林口,2023-01-16,9257
4105,東洋,12,1,11,凱基-林口,2023-01-16,9257
00753L,中信中國50正2,10,0,10,凱基-林口,2023-01-16,9257
2358,廷鑫,11,1,10,凱基-林口,2023-01-16,9257
4167,松瑞藥,10,0,10,凱基-林口,2023-01-16,9257
5529,鉅陞,10,0,10,凱基-林口,2023-01-16,9257
6443,元晶,10,1,9,凱基-林口,2023-01-16,9257
00673R,期元大S＆P原油反1,8,0,8,凱基-林口,2023-01-16,9257
2609,陽明,9,1,8,凱基-林口,2023-01-16,9257
2916,滿心,8,0,8,凱基-林口,2023-01-16,9257
00670L,富邦NASDAQ正2,7,0,7,凱基-林口,2023-01-16,9257
00900,富邦特選高股息30,7,0,7,凱基-林口,2023-01-16,9257
2338,光罩,8,2,6,凱基-林口,2023-01-16,9257
2614,東森,6,0,6,凱基-林口,2023-01-16,9257
6188,廣明,6,0,6,凱基-林口,2023-01-16,9257
1219,福壽,5,0,5,凱基-林口,2023-01-16,9257
00639,富邦深100,5,0,5,凱基-林口,2023-01-16,9257
1314,中石化,5,0,5,凱基-林口,2023-01-16,9257
2867,三商壽,5,0,5,凱基-林口,2023-01-16,9257
3019,亞光,5,0,5,凱基-林口,2023-01-16,9257
3209,全科,5,0,5,凱基-林口,2023-01-16,9257
4746,台耀,5,0,5,凱基-林口,2023-01-16,9257
00881,國泰台灣5G+,4,0,4,凱基-林口,2023-01-16,9257
1599,宏佳騰,4,0,4,凱基-林口,2023-01-16,9257
3234,光環,4,0,4,凱基-林口,2023-01-16,9257
2303,聯電,48,44,4,凱基-林口,2023-01-16,9257
00878,國泰永續高股息,7,3,4,凱基-林口,2023-01-16,9257
00882,中信中國高股息,3,0,3,凱基-林口,2023-01-16,9257
1452,宏益,3,0,3,凱基-林口,2023-01-16,9257
2313,華通,3,0,3,凱基-林口,2023-01-16,9257
2812,台中銀,3,0,3,凱基-林口,2023-01-16,9257
2836,高雄銀,3,0,3,凱基-林口,2023-01-16,9257
6218,豪勉,3,0,3,凱基-林口,2023-01-16,9257
6266,泰詠,3,0,3,凱基-林口,2023-01-16,9257
6465,威潤,3,0,3,凱基-林口,2023-01-16,9257
8477,創業家,3,0,3,凱基-林口,2023-01-16,9257
2605,新興,2,0,2,凱基-林口,2023-01-16,9257
3491,昇達科,2,0,2,凱基-林口,2023-01-16,9257
00713,元大台灣高息低波,5,3,2,凱基-林口,2023-01-16,9257
006207,復華滬深,2,0,2,凱基-林口,2023-01-16,9257
2812,台中銀,42,0,42,凱基-林口,2023-01-17,9257
0056,元大高股息,36,10,26,凱基-林口,2023-01-17,9257
8155,博智,59,35,24,凱基-林口,2023-01-17,9257
0050,元大台灣50,24,1,23,凱基-林口,2023-01-17,9257
8234,新漢,25,2,23,凱基-林口,2023-01-17,9257
8358,金居,30,8,22,凱基-林口,2023-01-17,9257
2610,華航,45,25,20,凱基-林口,2023-01-17,9257
5425,台半,20,1,19,凱基-林口,2023-01-17,9257
2614,東森,50,33,17,凱基-林口,2023-01-17,9257
00671R,富邦NASDAQ反1,19,4,15,凱基-林口,2023-01-17,9257
3019,亞光,15,0,15,凱基-林口,2023-01-17,9257
4167,松瑞藥,15,1,14,凱基-林口,2023-01-17,9257
00637L,元大滬深300正2,17,4,13,凱基-林口,2023-01-17,9257
1219,福壽,12,0,12,凱基-林口,2023-01-17,9257
6443,元晶,12,0,12,凱基-林口,2023-01-17,9257
1444,力麗,10,0,10,凱基-林口,2023-01-17,9257
00919,群益台灣精選高息,10,0,10,凱基-林口,2023-01-17,9257
00753L,中信中國50正2,10,0,10,凱基-林口,2023-01-17,9257
1529,樂事綠能,11,1,10,凱基-林口,2023-01-17,9257
2014,中鴻,11,1,10,凱基-林口,2023-01-17,9257
2359,所羅門,10,0,10,凱基-林口,2023-01-17,9257
4161,聿新科,10,0,10,凱基-林口,2023-01-17,9257
2317,鴻海,29,20,9,凱基-林口,2023-01-17,9257
00770,國泰北美科技,10,1,9,凱基-林口,2023-01-17,9257
00881,國泰台灣5G+,8,0,8,凱基-林口,2023-01-17,9257
6182,合晶,8,0,8,凱基-林口,2023-01-17,9257
00882,中信中國高股息,7,0,7,凱基-林口,2023-01-17,9257
8084,巨虹,7,0,7,凱基-林口,2023-01-17,9257
2888,新光金,10,4,6,凱基-林口,2023-01-17,9257
3234,光環,6,0,6,凱基-林口,2023-01-17,9257
3664,安瑞-KY,6,0,6,凱基-林口,2023-01-17,9257
5014,建錩,6,0,6,凱基-林口,2023-01-17,9257
6129,普誠,6,0,6,凱基-林口,2023-01-17,9257
6605,帝寶,6,0,6,凱基-林口,2023-01-17,9257
8215,明基材,6,0,6,凱基-林口,2023-01-17,9257
00639,富邦深100,5,0,5,凱基-林口,2023-01-17,9257
00720B,元大投資級公司債,5,0,5,凱基-林口,2023-01-17,9257
2886,兆豐金,5,0,5,凱基-林口,2023-01-17,9257
3004,豐達科,5,0,5,凱基-林口,2023-01-17,9257
3030,德律,10,5,5,凱基-林口,2023-01-17,9257
3402,漢科,5,0,5,凱基-林口,2023-01-17,9257
3704,合勤控,6,1,5,凱基-林口,2023-01-17,9257
4919,新唐,5,0,5,凱基-林口,2023-01-17,9257
5269,祥碩,5,0,5,凱基-林口,2023-01-17,9257
1229,聯華,4,0,4,凱基-林口,2023-01-17,9257
00900,富邦特選高股息30,4,0,4,凱基-林口,2023-01-17,9257
00795B,中信美國公債20年,4,0,4,凱基-林口,2023-01-17,9257
1308,亞聚,4,0,4,凱基-林口,2023-01-17,9257
2603,長榮,7,3,4,凱基-林口,2023-01-17,9257
2915,潤泰全,4,0,4,凱基-林口,2023-01-17,9257
4161,聿新科,53,0,53,凱基-林口,2023-01-30,9257
1101,台泥,50,11,39,凱基-林口,2023-01-30,9257
00885,富邦越南,43,4,39,凱基-林口,2023-01-30,9257
2317,鴻海,36,4,32,凱基-林口,2023-01-30,9257
00680L,元大美債20正2,25,0,25,凱基-林口,2023-01-30,9257
2812,台中銀,21,0,21,凱基-林口,2023-01-30,9257
6226,光鼎,20,0,20,凱基-林口,2023-01-30,9257
6443,元晶,22,2,20,凱基-林口,2023-01-30,9257
2892,第一金,20,0,20,凱基-林口,2023-01-30,9257
3264,欣銓,20,3,17,凱基-林口,2023-01-30,9257
4123,晟德,15,0,15,凱基-林口,2023-01-30,9257
5443,均豪,20,5,15,凱基-林口,2023-01-30,9257
4155,訊映,13,0,13,凱基-林口,2023-01-30,9257
2609,陽明,17,5,12,凱基-林口,2023-01-30,9257
3481,群創,20,9,11,凱基-林口,2023-01-30,9257
2891,中信金,11,0,11,凱基-林口,2023-01-30,9257
9933,中鼎,11,0,11,凱基-林口,2023-01-30,9257
00900,富邦特選高股息30,10,0,10,凱基-林口,2023-01-30,9257
2371,大同,10,0,10,凱基-林口,2023-01-30,9257
2530,華建,10,0,10,凱基-林口,2023-01-30,9257
4114,健喬,11,1,10,凱基-林口,2023-01-30,9257
2014,中鴻,14,6,8,凱基-林口,2023-01-30,9257
3664,安瑞-KY,8,0,8,凱基-林口,2023-01-30,9257
5478,智冠,7,0,7,凱基-林口,2023-01-30,9257
3706,神達,6,0,6,凱基-林口,2023-01-30,9257
2884,玉山金,6,0,6,凱基-林口,2023-01-30,9257
00639,富邦深100,6,0,6,凱基-林口,2023-01-30,9257
1308,亞聚,6,0,6,凱基-林口,2023-01-30,9257
1443,立益物流,6,0,6,凱基-林口,2023-01-30,9257
2916,滿心,6,0,6,凱基-林口,2023-01-30,9257
6104,創惟,8,2,6,凱基-林口,2023-01-30,9257
8091,翔名,6,0,6,凱基-林口,2023-01-30,9257
00636,國泰中國A50,5,0,5,凱基-林口,2023-01-30,9257
00673R,期元大S＆P原油反1,5,0,5,凱基-林口,2023-01-30,9257
1417,嘉裕,5,0,5,凱基-林口,2023-01-30,9257
2006,東和鋼鐵,5,0,5,凱基-林口,2023-01-30,9257
2038,海光,5,0,5,凱基-林口,2023-01-30,9257
3024,憶聲,5,0,5,凱基-林口,2023-01-30,9257
3356,奇偶,5,0,5,凱基-林口,2023-01-30,9257
2603,長榮,6,2,4,凱基-林口,2023-01-30,9257
8069,元太,6,2,4,凱基-林口,2023-01-30,9257
2368,金像電,4,0,4,凱基-林口,2023-01-30,9257
2731,雄獅,4,0,4,凱基-林口,2023-01-30,9257
6155,鈞寶,4,0,4,凱基-林口,2023-01-30,9257
6182,合晶,5,1,4,凱基-林口,2023-01-30,9257
6279,胡連,6,2,4,凱基-林口,2023-01-30,9257
9905,大華,4,0,4,凱基-林口,2023-01-30,9257
4755,三福化,4,0,4,凱基-林口,2023-01-30,9257
00753L,中信中國50正2,3,0,3,凱基-林口,2023-01-30,9257
00676R,富邦臺灣加權反1,3,0,3,凱基-林口,2023-01-30,9257
00632R,元大台灣50反1,123,65,58,凱基-林口,2023-01-31,9257
00878,國泰永續高股息,68,13,55,凱基-林口,2023-01-31,9257
2812,台中銀,49,5,44,凱基-林口,2023-01-31,9257
4128,中天,43,4,39,凱基-林口,2023-01-31,9257
00905,FT臺灣Smart,34,0,34,凱基-林口,2023-01-31,9257
2892,第一金,33,1,32,凱基-林口,2023-01-31,9257
1409,新纖,30,0,30,凱基-林口,2023-01-31,9257
2880,華南金,28,0,28,凱基-林口,2023-01-31,9257
6104,創惟,28,1,27,凱基-林口,2023-01-31,9257
5321,美而快,25,0,25,凱基-林口,2023-01-31,9257
2890,永豐金,25,0,25,凱基-林口,2023-01-31,9257
2408,南亞科,25,1,24,凱基-林口,2023-01-31,9257
2324,仁寶,23,0,23,凱基-林口,2023-01-31,9257
00885,富邦越南,22,0,22,凱基-林口,2023-01-31,9257
00882,中信中國高股息,22,0,22,凱基-林口,2023-01-31,9257
00753L,中信中國50正2,20,0,20,凱基-林口,2023-01-31,9257
2888,新光金,20,0,20,凱基-林口,2023-01-31,9257
00692,富邦公司治理,20,1,19,凱基-林口,2023-01-31,9257
4979,華星光,28,9,19,凱基-林口,2023-01-31,9257
8155,博智,20,2,18,凱基-林口,2023-01-31,9257
00772B,中信高評級公司債,17,0,17,凱基-林口,2023-01-31,9257
1608,華榮,21,4,17,凱基-林口,2023-01-31,9257
3013,晟銘電,20,5,15,凱基-林口,2023-01-31,9257
8081,致新,15,0,15,凱基-林口,2023-01-31,9257
00637L,元大滬深300正2,12,0,12,凱基-林口,2023-01-31,9257
3703,欣陸,12,0,12,凱基-林口,2023-01-31,9257
2330,台積電,16,4,12,凱基-林口,2023-01-31,9257
2412,中華電,11,0,11,凱基-林口,2023-01-31,9257
1101,台泥,10,0,10,凱基-林口,2023-01-31,9257
00636,國泰中國A50,10,0,10,凱基-林口,2023-01-31,9257
1529,樂事綠能,10,0,10,凱基-林口,2023-01-31,9257
2867,三商壽,10,0,10,凱基-林口,2023-01-31,9257
3535,晶彩科,10,0,10,凱基-林口,2023-01-31,9257
8234,新漢,10,0,10,凱基-林口,2023-01-31,9257
2885,元大金,9,0,9,凱基-林口,2023-01-31,9257
4931,新盛力,9,0,9,凱基-林口,2023-01-31,9257
912000,晨訊科-DR,8,0,8,凱基-林口,2023-01-31,9257
1618,合機,7,0,7,凱基-林口,2023-01-31,9257
3665,貿聯-KY,7,0,7,凱基-林口,2023-01-31,9257
6235,華孚,7,0,7,凱基-林口,2023-01-31,9257
2038,海光,6,0,6,凱基-林口,2023-01-31,9257
2615,萬海,9,3,6,凱基-林口,2023-01-31,9257
2616,山隆,6,0,6,凱基-林口,2023-01-31,9257
6285,啟��,8,2,6,凱基-林口,2023-01-31,9257
8222,寶一,13,7,6,凱基-林口,2023-01-31,9257
5347,世界,9,4,5,凱基-林口,2023-01-31,9257
00888,永豐台灣ESG,5,0,5,凱基-林口,2023-01-31,9257
00852L,國泰美國道瓊正2,5,0,5,凱基-林口,2023-01-31,9257
00915,凱基優選高股息30,5,0,5,凱基-林口,2023-01-31,9257
1584,精剛,5,0,5,凱基-林口,2023-01-31,9257
00671R,富邦NASDAQ反1,150,0,150,凱基-林口,2023-02-01,9257
3019,亞光,70,1,69,凱基-林口,2023-02-01,9257
2929,淘帝-KY,38,5,33,凱基-林口,2023-02-01,9257
2603,長榮,55,22,33,凱基-林口,2023-02-01,9257
2607,榮運,30,0,30,凱基-林口,2023-02-01,9257
2880,華南金,30,0,30,凱基-林口,2023-02-01,9257
6129,普誠,22,0,22,凱基-林口,2023-02-01,9257
1584,精剛,22,3,19,凱基-林口,2023-02-01,9257
4161,聿新科,19,0,19,凱基-林口,2023-02-01,9257
00850,元大臺灣ESG永續,18,0,18,凱基-林口,2023-02-01,9257
2412,中華電,15,0,15,凱基-林口,2023-02-01,9257
3017,奇鋐,15,0,15,凱基-林口,2023-02-01,9257
1810,和成,26,11,15,凱基-林口,2023-02-01,9257
2230,泰茂,15,0,15,凱基-林口,2023-02-01,9257
00878,國泰永續高股息,21,7,14,凱基-林口,2023-02-01,9257
2883,凱基金,14,0,14,凱基-林口,2023-02-01,9257
3591,艾笛森,14,0,14,凱基-林口,2023-02-01,9257
4555,氣立,14,0,14,凱基-林口,2023-02-01,9257
6244,茂迪,16,2,14,凱基-林口,2023-02-01,9257
2609,陽明,15,1,14,凱基-林口,2023-02-01,9257
2891,中信金,13,0,13,凱基-林口,2023-02-01,9257
8478,東哥遊艇,13,1,12,凱基-林口,2023-02-01,9257
2409,友達,12,0,12,凱基-林口,2023-02-01,9257
1605,華新,48,36,12,凱基-林口,2023-02-01,9257
00720B,元大投資級公司債,11,0,11,凱基-林口,2023-02-01,9257
2845,遠東銀,11,0,11,凱基-林口,2023-02-01,9257
2890,永豐金,11,0,11,凱基-林口,2023-02-01,9257
3704,合勤控,32,21,11,凱基-林口,2023-02-01,9257
2605,新興,10,0,10,凱基-林口,2023-02-01,9257
3515,華擎,10,0,10,凱基-林口,2023-02-01,9257
4167,松瑞藥,10,0,10,凱基-林口,2023-02-01,9257
8050,廣積,10,0,10,凱基-林口,2023-02-01,9257
2368,金像電,13,5,8,凱基-林口,2023-02-01,9257
8033,雷虎,9,1,8,凱基-林口,2023-02-01,9257
6202,盛群,12,4,8,凱基-林口,2023-02-01,9257
1609,大亞,11,3,8,凱基-林口,2023-02-01,9257
1909,榮成,22,15,7,凱基-林口,2023-02-01,9257
0056,元大高股息,13,7,6,凱基-林口,2023-02-01,9257
00631L,元大台灣50正2,6,0,6,凱基-林口,2023-02-01,9257
00795B,中信美國公債20年,7,1,6,凱基-林口,2023-02-01,9257
00772B,中信高評級公司債,6,0,6,凱基-林口,2023-02-01,9257
2338,光罩,6,0,6,凱基-林口,2023-02-01,9257
2812,台中銀,6,0,6,凱基-林口,2023-02-01,9257
3664,安瑞-KY,6,0,6,凱基-林口,2023-02-01,9257
6859,伯特光,6,0,6,凱基-林口,2023-02-01,9257
8086,宏捷科,6,0,6,凱基-林口,2023-02-01,9257
1219,福壽,5,0,5,凱基-林口,2023-02-01,9257
00882,中信中國高股息,5,0,5,凱基-林口,2023-02-01,9257
00905,FT臺灣Smart,5,0,5,凱基-林口,2023-02-01,9257
00673R,期元大S＆P原油反1,5,0,5,凱基-林口,2023-02-01,9257
2892,第一金,306,35,271,凱基-林口,2023-02-02,9257
00632R,元大台灣50反1,212,24,188,凱基-林口,2023-02-02,9257
6443,元晶,129,13,116,凱基-林口,2023-02-02,9257
3564,其陽,72,0,72,凱基-林口,2023-02-02,9257
2618,長榮航,80,31,49,凱基-林口,2023-02-02,9257
00885,富邦越南,49,0,49,凱基-林口,2023-02-02,9257
00665L,富邦�琤肭磪囓�2,30,0,30,凱基-林口,2023-02-02,9257
00878,國泰永續高股息,71,44,27,凱基-林口,2023-02-02,9257
0056,元大高股息,70,45,25,凱基-林口,2023-02-02,9257
2891,中信金,23,0,23,凱基-林口,2023-02-02,9257
8044,網家,24,2,22,凱基-林口,2023-02-02,9257
9904,寶成,22,0,22,凱基-林口,2023-02-02,9257
00882,中信中國高股息,22,0,22,凱基-林口,2023-02-02,9257
5285,界霖,36,15,21,凱基-林口,2023-02-02,9257
6719,力智,21,1,20,凱基-林口,2023-02-02,9257
1701,中化,25,6,19,凱基-林口,2023-02-02,9257
6589,台康生技,22,3,19,凱基-林口,2023-02-02,9257
6689,伊雲谷,18,0,18,凱基-林口,2023-02-02,9257
1101,台泥,20,2,18,凱基-林口,2023-02-02,9257
2834,臺企銀,17,0,17,凱基-林口,2023-02-02,9257
3374,精材,15,0,15,凱基-林口,2023-02-02,9257
3710,連展投控,21,6,15,凱基-林口,2023-02-02,9257
8038,長園科,15,0,15,凱基-林口,2023-02-02,9257
2409,友達,24,11,13,凱基-林口,2023-02-02,9257
6770,力積電,20,8,12,凱基-林口,2023-02-02,9257
9802,鈺齊-KY,11,0,11,凱基-林口,2023-02-02,9257
00830,國泰費城半導體,11,0,11,凱基-林口,2023-02-02,9257
00633L,富邦上証正2,10,0,10,凱基-林口,2023-02-02,9257
00680L,元大美債20正2,10,0,10,凱基-林口,2023-02-02,9257
2867,三商壽,10,0,10,凱基-林口,2023-02-02,9257
2883B,凱基金乙特,10,0,10,凱基-林口,2023-02-02,9257
2888,新光金,10,0,10,凱基-林口,2023-02-02,9257
3019,亞光,10,0,10,凱基-林口,2023-02-02,9257
3024,憶聲,10,0,10,凱基-林口,2023-02-02,9257
3062,建漢,10,0,10,凱基-林口,2023-02-02,9257
3209,全科,10,0,10,凱基-林口,2023-02-02,9257
4114,健喬,11,1,10,凱基-林口,2023-02-02,9257
5009,榮剛,20,10,10,凱基-林口,2023-02-02,9257
5371,中光電,10,0,10,凱基-林口,2023-02-02,9257
2610,華航,75,66,9,凱基-林口,2023-02-02,9257
5321,美而快,12,3,9,凱基-林口,2023-02-02,9257
00720B,元大投資級公司債,8,0,8,凱基-林口,2023-02-02,9257
2347,聯強,8,0,8,凱基-林口,2023-02-02,9257
3693,營邦,9,2,7,凱基-林口,2023-02-02,9257
2884,玉山金,6,0,6,凱基-林口,2023-02-02,9257
2727,王品,7,1,6,凱基-林口,2023-02-02,9257
1513,中興電,14,8,6,凱基-林口,2023-02-02,9257
1605,華新,15,9,6,凱基-林口,2023-02-02,9257
2890,永豐金,11,5,6,凱基-林口,2023-02-02,9257
3037,欣興,12,6,6,凱基-林口,2023-02-02,9257
00878,國泰永續高股息,186,4,182,凱基-林口,2023-02-03,9257
3564,其陽,161,1,160,凱基-林口,2023-02-03,9257
4114,健喬,60,0,60,凱基-林口,2023-02-03,9257
6190,萬泰科,50,0,50,凱基-林口,2023-02-03,9257
00885,富邦越南,37,0,37,凱基-林口,2023-02-03,9257
00753L,中信中國50正2,30,0,30,凱基-林口,2023-02-03,9257
5340,建榮,30,0,30,凱基-林口,2023-02-03,9257
2610,華航,31,2,29,凱基-林口,2023-02-03,9257
1795,美時,45,17,28,凱基-林口,2023-02-03,9257
2409,友達,40,15,25,凱基-林口,2023-02-03,9257
00680L,元大美債20正2,25,0,25,凱基-林口,2023-02-03,9257
2609,陽明,32,8,24,凱基-林口,2023-02-03,9257
00882,中信中國高股息,23,0,23,凱基-林口,2023-02-03,9257
2314,台揚,20,0,20,凱基-林口,2023-02-03,9257
6122,擎邦,20,0,20,凱基-林口,2023-02-03,9257
6244,茂迪,20,0,20,凱基-林口,2023-02-03,9257
2015,豐興,18,0,18,凱基-林口,2023-02-03,9257
6104,創惟,33,15,18,凱基-林口,2023-02-03,9257
6116,彩晶,30,12,18,凱基-林口,2023-02-03,9257
2891,中信金,18,1,17,凱基-林口,2023-02-03,9257
00637L,元大滬深300正2,24,7,17,凱基-林口,2023-02-03,9257
6443,元晶,33,16,17,凱基-林口,2023-02-03,9257
2388,威盛,46,32,14,凱基-林口,2023-02-03,9257
1216,統一,12,0,12,凱基-林口,2023-02-03,9257
1584,精剛,16,4,12,凱基-林口,2023-02-03,9257
2633,台灣高鐵,10,0,10,凱基-林口,2023-02-03,9257
3010,華立,10,0,10,凱基-林口,2023-02-03,9257
4555,氣立,10,0,10,凱基-林口,2023-02-03,9257
8084,巨虹,10,0,10,凱基-林口,2023-02-03,9257
2892,第一金,13,4,9,凱基-林口,2023-02-03,9257
4746,台耀,19,10,9,凱基-林口,2023-02-03,9257
6770,力積電,17,9,8,凱基-林口,2023-02-03,9257
3481,群創,13,5,8,凱基-林口,2023-02-03,9257
5009,榮剛,8,0,8,凱基-林口,2023-02-03,9257
8038,長園科,8,0,8,凱基-林口,2023-02-03,9257
2607,榮運,7,0,7,凱基-林口,2023-02-03,9257
1701,中化,8,1,7,凱基-林口,2023-02-03,9257
2867,三商壽,7,0,7,凱基-林口,2023-02-03,9257
2884,玉山金,9,2,7,凱基-林口,2023-02-03,9257
3141,晶宏,10,3,7,凱基-林口,2023-02-03,9257
5269,祥碩,8,1,7,凱基-林口,2023-02-03,9257
8358,金居,12,5,7,凱基-林口,2023-02-03,9257
3037,欣興,8,1,7,凱基-林口,2023-02-03,9257
3105,穩懋,8,1,7,凱基-林口,2023-02-03,9257
2317,鴻海,11,5,6,凱基-林口,2023-02-03,9257
2888,新光金,6,0,6,凱基-林口,2023-02-03,9257
3313,斐成,6,0,6,凱基-林口,2023-02-03,9257
3508,位速,7,1,6,凱基-林口,2023-02-03,9257
3701,大眾控,6,0,6,凱基-林口,2023-02-03,9257
4164,承業醫,6,0,6,凱基-林口,2023-02-03,9257
00639,富邦深100,200,0,200,凱基-林口,2023-02-06,9257
3564,其陽,75,0,75,凱基-林口,2023-02-06,9257
00878,國泰永續高股息,72,1,71,凱基-林口,2023-02-06,9257
2103,台橡,71,1,70,凱基-林口,2023-02-06,9257
6799,來頡,61,10,51,凱基-林口,2023-02-06,9257
4128,中天,50,10,40,凱基-林口,2023-02-06,9257
2609,陽明,41,3,38,凱基-林口,2023-02-06,9257
1605,華新,57,19,38,凱基-林口,2023-02-06,9257
4915,致伸,33,0,33,凱基-林口,2023-02-06,9257
6443,元晶,41,8,33,凱基-林口,2023-02-06,9257
00669R,國泰美國道瓊反1,30,0,30,凱基-林口,2023-02-06,9257
6548,長科*,30,0,30,凱基-林口,2023-02-06,9257
6165,浪凡,28,0,28,凱基-林口,2023-02-06,9257
8043,蜜望實,25,0,25,凱基-林口,2023-02-06,9257
00885,富邦越南,21,0,21,凱基-林口,2023-02-06,9257
2408,南亞科,21,0,21,凱基-林口,2023-02-06,9257
00850,元大臺灣ESG永續,18,0,18,凱基-林口,2023-02-06,9257
00637L,元大滬深300正2,18,0,18,凱基-林口,2023-02-06,9257
00679B,元大美債20年,17,0,17,凱基-林口,2023-02-06,9257
00891,中信關鍵半導體,21,6,15,凱基-林口,2023-02-06,9257
2603,長榮,15,0,15,凱基-林口,2023-02-06,9257
00900,富邦特選高股息30,14,0,14,凱基-林口,2023-02-06,9257
3701,大眾控,13,0,13,凱基-林口,2023-02-06,9257
4102,永日,13,0,13,凱基-林口,2023-02-06,9257
4161,聿新科,13,0,13,凱基-林口,2023-02-06,9257
2882,國泰金,12,0,12,凱基-林口,2023-02-06,9257
9802,鈺齊-KY,13,1,12,凱基-林口,2023-02-06,9257
2537,聯上發,11,0,11,凱基-林口,2023-02-06,9257
3231,緯創,13,2,11,凱基-林口,2023-02-06,9257
3588,通嘉,12,1,11,凱基-林口,2023-02-06,9257
4162,智擎,12,2,10,凱基-林口,2023-02-06,9257
8436,大江,13,3,10,凱基-林口,2023-02-06,9257
00671R,富邦NASDAQ反1,10,0,10,凱基-林口,2023-02-06,9257
00633L,富邦上証正2,10,0,10,凱基-林口,2023-02-06,9257
1522,堤維西,10,0,10,凱基-林口,2023-02-06,9257
2023,燁輝,10,0,10,凱基-林口,2023-02-06,9257
2455,全新,31,21,10,凱基-林口,2023-02-06,9257
8105,凌巨,10,0,10,凱基-林口,2023-02-06,9257
8341,日友,10,0,10,凱基-林口,2023-02-06,9257
9955,佳龍,10,0,10,凱基-林口,2023-02-06,9257
00715L,期街口布蘭特正2,23,14,9,凱基-林口,2023-02-06,9257
2388,威盛,15,6,9,凱基-林口,2023-02-06,9257
4919,新唐,11,2,9,凱基-林口,2023-02-06,9257
2002,中鋼,8,0,8,凱基-林口,2023-02-06,9257
2338,光罩,8,0,8,凱基-林口,2023-02-06,9257
2911,麗嬰房,8,0,8,凱基-林口,2023-02-06,9257
2330,台積電,13,5,8,凱基-林口,2023-02-06,9257
6770,力積電,13,6,7,凱基-林口,2023-02-06,9257
2834,臺企銀,7,0,7,凱基-林口,2023-02-06,9257
4107,邦特,7,0,7,凱基-林口,2023-02-06,9257
2103,台橡,257,80,177,凱基-林口,2023-02-07,9257
6443,元晶,172,1,171,凱基-林口,2023-02-07,9257
00670L,富邦NASDAQ正2,71,0,71,凱基-林口,2023-02-07,9257
00878,國泰永續高股息,70,0,70,凱基-林口,2023-02-07,9257
00665L,富邦�琤肭磪囓�2,30,0,30,凱基-林口,2023-02-07,9257
1605,華新,38,11,27,凱基-林口,2023-02-07,9257
2610,華航,23,0,23,凱基-林口,2023-02-07,9257
3564,其陽,20,0,20,凱基-林口,2023-02-07,9257
6190,萬泰科,20,0,20,凱基-林口,2023-02-07,9257
00715L,期街口布蘭特正2,17,0,17,凱基-林口,2023-02-07,9257
2891,中信金,16,0,16,凱基-林口,2023-02-07,9257
2834,臺企銀,15,0,15,凱基-林口,2023-02-07,9257
3011,今皓,15,0,15,凱基-林口,2023-02-07,9257
8084,巨虹,14,0,14,凱基-林口,2023-02-07,9257
2618,長榮航,20,7,13,凱基-林口,2023-02-07,9257
1312,國喬,12,0,12,凱基-林口,2023-02-07,9257
3013,晟銘電,12,0,12,凱基-林口,2023-02-07,9257
2603,長榮,11,0,11,凱基-林口,2023-02-07,9257
2344,華邦電,11,0,11,凱基-林口,2023-02-07,9257
2455,全新,15,5,10,凱基-林口,2023-02-07,9257
4167,松瑞藥,10,0,10,凱基-林口,2023-02-07,9257
4961,天鈺,11,1,10,凱基-林口,2023-02-07,9257
6165,浪凡,10,0,10,凱基-林口,2023-02-07,9257
3693,營邦,8,0,8,凱基-林口,2023-02-07,9257
6104,創惟,9,1,8,凱基-林口,2023-02-07,9257
6235,華孚,19,11,8,凱基-林口,2023-02-07,9257
2330,台積電,8,0,8,凱基-林口,2023-02-07,9257
2888,新光金,10,3,7,凱基-林口,2023-02-07,9257
1417,嘉裕,12,6,6,凱基-林口,2023-02-07,9257
0056,元大高股息,6,0,6,凱基-林口,2023-02-07,9257
2428,興勤,6,0,6,凱基-林口,2023-02-07,9257
2812,台中銀,9,3,6,凱基-林口,2023-02-07,9257
5478,智冠,6,0,6,凱基-林口,2023-02-07,9257
6282,康舒,23,17,6,凱基-林口,2023-02-07,9257
8109,博大,6,0,6,凱基-林口,2023-02-07,9257
00674R,期元大S＆P黃金反1,5,0,5,凱基-林口,2023-02-07,9257
00673R,期元大S＆P原油反1,5,0,5,凱基-林口,2023-02-07,9257
2363,矽統,5,0,5,凱基-林口,2023-02-07,9257
2368,金像電,5,0,5,凱基-林口,2023-02-07,9257
2731,雄獅,5,0,5,凱基-林口,2023-02-07,9257
3088,艾訊,5,0,5,凱基-林口,2023-02-07,9257
4161,聿新科,5,0,5,凱基-林口,2023-02-07,9257
5353,台林,5,0,5,凱基-林口,2023-02-07,9257
9955,佳龍,5,0,5,凱基-林口,2023-02-07,9257
00679B,元大美債20年,5,1,4,凱基-林口,2023-02-07,9257
2884,玉山金,4,0,4,凱基-林口,2023-02-07,9257
2498,宏達電,29,25,4,凱基-林口,2023-02-07,9257
1519,華城,5,1,4,凱基-林口,2023-02-07,9257
3588,通嘉,4,0,4,凱基-林口,2023-02-07,9257
4944,兆遠,4,0,4,凱基-林口,2023-02-07,9257
2880,華南金,204,0,204,凱基-林口,2023-02-08,9257
3037,欣興,165,0,165,凱基-林口,2023-02-08,9257
00632R,元大台灣50反1,82,10,72,凱基-林口,2023-02-08,9257
2618,長榮航,53,1,52,凱基-林口,2023-02-08,9257
00885,富邦越南,47,0,47,凱基-林口,2023-02-08,9257
2890,永豐金,39,0,39,凱基-林口,2023-02-08,9257
00902,中信電池及儲能,36,0,36,凱基-林口,2023-02-08,9257
2609,陽明,33,1,32,凱基-林口,2023-02-08,9257
4114,健喬,64,33,31,凱基-林口,2023-02-08,9257
6173,信昌電,29,0,29,凱基-林口,2023-02-08,9257
1605,華新,34,6,28,凱基-林口,2023-02-08,9257
1711,永光,25,0,25,凱基-林口,2023-02-08,9257
1513,中興電,27,3,24,凱基-林口,2023-02-08,9257
00715L,期街口布蘭特正2,25,1,24,凱基-林口,2023-02-08,9257
00878,國泰永續高股息,30,7,23,凱基-林口,2023-02-08,9257
6443,元晶,53,30,23,凱基-林口,2023-02-08,9257
5425,台半,64,42,22,凱基-林口,2023-02-08,9257
2009,第一銅,25,4,21,凱基-林口,2023-02-08,9257
5009,榮剛,21,0,21,凱基-林口,2023-02-08,9257
8097,常珵,18,0,18,凱基-林口,2023-02-08,9257
3588,通嘉,17,0,17,凱基-林口,2023-02-08,9257
1326,台化,16,0,16,凱基-林口,2023-02-08,9257
2338,光罩,25,10,15,凱基-林口,2023-02-08,9257
4157,太景*-KY,15,0,15,凱基-林口,2023-02-08,9257
6182,合晶,15,0,15,凱基-林口,2023-02-08,9257
2610,華航,12,0,12,凱基-林口,2023-02-08,9257
2367,燿華,34,22,12,凱基-林口,2023-02-08,9257
5309,系統電,12,0,12,凱基-林口,2023-02-08,9257
6470,宇智,12,0,12,凱基-林口,2023-02-08,9257
8044,網家,18,6,12,凱基-林口,2023-02-08,9257
4167,松瑞藥,11,0,11,凱基-林口,2023-02-08,9257
6104,創惟,17,6,11,凱基-林口,2023-02-08,9257
1524,耿鼎,10,0,10,凱基-林口,2023-02-08,9257
2356,英業達,10,0,10,凱基-林口,2023-02-08,9257
2845,遠東銀,10,0,10,凱基-林口,2023-02-08,9257
4763,材料-KY,10,0,10,凱基-林口,2023-02-08,9257
8114,振樺電,10,0,10,凱基-林口,2023-02-08,9257
00679B,元大美債20年,10,0,10,凱基-林口,2023-02-08,9257
2014,中鴻,9,0,9,凱基-林口,2023-02-08,9257
2371,大同,9,0,9,凱基-林口,2023-02-08,9257
5285,界霖,10,1,9,凱基-林口,2023-02-08,9257
8996,高力,24,15,9,凱基-林口,2023-02-08,9257
00662,富邦NASDAQ,10,2,8,凱基-林口,2023-02-08,9257
2897,王道銀行,8,0,8,凱基-林口,2023-02-08,9257
3027,盛達,8,0,8,凱基-林口,2023-02-08,9257
6164,華興,8,0,8,凱基-林口,2023-02-08,9257
2474,可成,7,0,7,凱基-林口,2023-02-08,9257
4979,華星光,12,5,7,凱基-林口,2023-02-08,9257
6509,聚和,7,0,7,凱基-林口,2023-02-08,9257
2883,凱基金,7,1,6,凱基-林口,2023-02-08,9257
3564,其陽,126,0,126,凱基-林口,2023-02-09,9257
5880,合庫金,114,2,112,凱基-林口,2023-02-09,9257
2498,宏達電,110,27,83,凱基-林口,2023-02-09,9257
6531,愛普*,82,2,80,凱基-林口,2023-02-09,9257
4915,致伸,51,5,46,凱基-林口,2023-02-09,9257
2880,華南金,37,0,37,凱基-林口,2023-02-09,9257
6443,元晶,36,0,36,凱基-林口,2023-02-09,9257
1708,東鹼,31,0,31,凱基-林口,2023-02-09,9257
2892,第一金,30,0,30,凱基-林口,2023-02-09,9257
8097,常珵,30,0,30,凱基-林口,2023-02-09,9257
4161,聿新科,24,0,24,凱基-林口,2023-02-09,9257
00662,富邦NASDAQ,23,0,23,凱基-林口,2023-02-09,9257
1312,國喬,20,0,20,凱基-林口,2023-02-09,9257
00878,國泰永續高股息,25,5,20,凱基-林口,2023-02-09,9257
4155,訊映,19,0,19,凱基-林口,2023-02-09,9257
6235,華孚,43,24,19,凱基-林口,2023-02-09,9257
2458,義隆,18,0,18,凱基-林口,2023-02-09,9257
6104,創惟,44,28,16,凱基-林口,2023-02-09,9257
2610,華航,16,0,16,凱基-林口,2023-02-09,9257
2884,玉山金,16,0,16,凱基-林口,2023-02-09,9257
00885,富邦越南,16,0,16,凱基-林口,2023-02-09,9257
2009,第一銅,15,0,15,凱基-林口,2023-02-09,9257
6719,力智,15,0,15,凱基-林口,2023-02-09,9257
3617,碩天,13,0,13,凱基-林口,2023-02-09,9257
8044,網家,16,3,13,凱基-林口,2023-02-09,9257
1795,美時,23,11,12,凱基-林口,2023-02-09,9257
5351,鈺創,12,0,12,凱基-林口,2023-02-09,9257
2314,台揚,11,0,11,凱基-林口,2023-02-09,9257
2401,凌陽,10,0,10,凱基-林口,2023-02-09,9257
2461,光群雷,10,0,10,凱基-林口,2023-02-09,9257
2812,台中銀,10,0,10,凱基-林口,2023-02-09,9257
2897,王道銀行,10,0,10,凱基-林口,2023-02-09,9257
4721,美琪瑪,10,0,10,凱基-林口,2023-02-09,9257
6147,頎邦,10,0,10,凱基-林口,2023-02-09,9257
4114,健喬,29,20,9,凱基-林口,2023-02-09,9257
4919,新唐,14,5,9,凱基-林口,2023-02-09,9257
5475,德宏,9,0,9,凱基-林口,2023-02-09,9257
3701,大眾控,10,2,8,凱基-林口,2023-02-09,9257
3710,連展投控,27,19,8,凱基-林口,2023-02-09,9257
6129,普誠,9,1,8,凱基-林口,2023-02-09,9257
3035,智原,25,17,8,凱基-林口,2023-02-09,9257
3706,神達,8,0,8,凱基-林口,2023-02-09,9257
00713,元大台灣高息低波,7,0,7,凱基-林口,2023-02-09,9257
00773B,中信優先金融債,7,0,7,凱基-林口,2023-02-09,9257
00772B,中信高評級公司債,7,0,7,凱基-林口,2023-02-09,9257
2409,友達,18,11,7,凱基-林口,2023-02-09,9257
3027,盛達,7,0,7,凱基-林口,2023-02-09,9257
6143,振曜,7,0,7,凱基-林口,2023-02-09,9257
6165,浪凡,7,0,7,凱基-林口,2023-02-09,9257
6789,采鈺,10,3,7,凱基-林口,2023-02-09,9257
2610,華航,186,17,169,凱基-林口,2023-02-10,9257
00632R,元大台灣50反1,141,0,141,凱基-林口,2023-02-10,9257
00878,國泰永續高股息,150,11,139,凱基-林口,2023-02-10,9257
6116,彩晶,55,1,54,凱基-林口,2023-02-10,9257
00665L,富邦�琤肭磪囓�2,100,49,51,凱基-林口,2023-02-10,9257
4721,美琪瑪,33,2,31,凱基-林口,2023-02-10,9257
5351,鈺創,25,0,25,凱基-林口,2023-02-10,9257
6531,愛普*,47,22,25,凱基-林口,2023-02-10,9257
8050,廣積,32,10,22,凱基-林口,2023-02-10,9257
2609,陽明,44,23,21,凱基-林口,2023-02-10,9257
1701,中化,23,2,21,凱基-林口,2023-02-10,9257
4915,致伸,24,3,21,凱基-林口,2023-02-10,9257
00900,富邦特選高股息30,17,0,17,凱基-林口,2023-02-10,9257
2897,王道銀行,17,0,17,凱基-林口,2023-02-10,9257
2349,錸德,19,3,16,凱基-林口,2023-02-10,9257
6155,鈞寶,16,0,16,凱基-林口,2023-02-10,9257
2618,長榮航,26,12,14,凱基-林口,2023-02-10,9257
4155,訊映,14,0,14,凱基-林口,2023-02-10,9257
2027,大成鋼,13,0,13,凱基-林口,2023-02-10,9257
2890,永豐金,13,0,13,凱基-林口,2023-02-10,9257
4161,聿新科,13,0,13,凱基-林口,2023-02-10,9257
0056,元大高股息,19,7,12,凱基-林口,2023-02-10,9257
1524,耿鼎,12,0,12,凱基-林口,2023-02-10,9257
8016,矽創,13,1,12,凱基-林口,2023-02-10,9257
1605,華新,14,2,12,凱基-林口,2023-02-10,9257
6235,華孚,15,4,11,凱基-林口,2023-02-10,9257
8996,高力,22,11,11,凱基-林口,2023-02-10,9257
1513,中興電,15,4,11,凱基-林口,2023-02-10,9257
00679B,元大美債20年,10,0,10,凱基-林口,2023-02-10,9257
2002,中鋼,10,0,10,凱基-林口,2023-02-10,9257
6274,台燿,10,0,10,凱基-林口,2023-02-10,9257
1218,泰山,10,0,10,凱基-林口,2023-02-10,9257
00713,元大台灣高息低波,10,0,10,凱基-林口,2023-02-10,9257
2607,榮運,14,4,10,凱基-林口,2023-02-10,9257
00669R,國泰美國道瓊反1,10,0,10,凱基-林口,2023-02-10,9257
1437,勤益控,10,0,10,凱基-林口,2023-02-10,9257
2101,南港,11,1,10,凱基-林口,2023-02-10,9257
8201,無敵,9,0,9,凱基-林口,2023-02-10,9257
5706,鳳凰,8,0,8,凱基-林口,2023-02-10,9257
2884,玉山金,13,5,8,凱基-林口,2023-02-10,9257
00891,中信關鍵半導體,8,0,8,凱基-林口,2023-02-10,9257
3362,先進光,14,6,8,凱基-林口,2023-02-10,9257
3710,連展投控,12,5,7,凱基-林口,2023-02-10,9257
4919,新唐,8,1,7,凱基-林口,2023-02-10,9257
2495,普安,10,3,7,凱基-林口,2023-02-10,9257
3035,智原,11,4,7,凱基-林口,2023-02-10,9257
00720B,元大投資級公司債,6,0,6,凱基-林口,2023-02-10,9257
2603,長榮,9,3,6,凱基-林口,2023-02-10,9257
4968,立積,9,3,6,凱基-林口,2023-02-10,9257
2891,中信金,6,0,6,凱基-林口,2023-02-10,9257
2880,華南金,200,0,200,凱基-林口,2023-02-13,9257
2884,玉山金,220,50,170,凱基-林口,2023-02-13,9257
2609,陽明,134,17,117,凱基-林口,2023-02-13,9257
00670L,富邦NASDAQ正2,73,0,73,凱基-林口,2023-02-13,9257
6116,彩晶,62,2,60,凱基-林口,2023-02-13,9257
0056,元大高股息,39,0,39,凱基-林口,2023-02-13,9257
2409,友達,35,0,35,凱基-林口,2023-02-13,9257
6462,神盾,20,0,20,凱基-林口,2023-02-13,9257
3037,欣興,25,5,20,凱基-林口,2023-02-13,9257
4721,美琪瑪,20,0,20,凱基-林口,2023-02-13,9257
00772B,中信高評級公司債,20,0,20,凱基-林口,2023-02-13,9257
00885,富邦越南,19,0,19,凱基-林口,2023-02-13,9257
00878,國泰永續高股息,47,28,19,凱基-林口,2023-02-13,9257
2498,宏達電,21,3,18,凱基-林口,2023-02-13,9257
00641R,富邦日本反1,18,0,18,凱基-林口,2023-02-13,9257
2883,凱基金,22,4,18,凱基-林口,2023-02-13,9257
3481,群創,50,32,18,凱基-林口,2023-02-13,9257
6443,元晶,18,0,18,凱基-林口,2023-02-13,9257
2303,聯電,26,11,15,凱基-林口,2023-02-13,9257
2314,台揚,15,0,15,凱基-林口,2023-02-13,9257
3515,華擎,15,0,15,凱基-林口,2023-02-13,9257
6446,藥華藥,15,0,15,凱基-林口,2023-02-13,9257
3289,宜特,14,0,14,凱基-林口,2023-02-13,9257
6625,必應,15,1,14,凱基-林口,2023-02-13,9257
8033,雷虎,22,8,14,凱基-林口,2023-02-13,9257
00900,富邦特選高股息30,11,0,11,凱基-林口,2023-02-13,9257
2614,東森,10,0,10,凱基-林口,2023-02-13,9257
1599,宏佳騰,10,0,10,凱基-林口,2023-02-13,9257
3596,智易,10,0,10,凱基-林口,2023-02-13,9257
2610,華航,24,15,9,凱基-林口,2023-02-13,9257
1595,川寶,9,0,9,凱基-林口,2023-02-13,9257
5222,全訊,9,0,9,凱基-林口,2023-02-13,9257
6509,聚和,14,5,9,凱基-林口,2023-02-13,9257
6806,森崴能源,11,2,9,凱基-林口,2023-02-13,9257
00892,富邦台灣半導體,11,2,9,凱基-林口,2023-02-13,9257
00669R,國泰美國道瓊反1,8,0,8,凱基-林口,2023-02-13,9257
1618,合機,8,0,8,凱基-林口,2023-02-13,9257
4114,健喬,43,35,8,凱基-林口,2023-02-13,9257
6164,華興,8,0,8,凱基-林口,2023-02-13,9257
6235,華孚,12,4,8,凱基-林口,2023-02-13,9257
2201,裕隆,14,7,7,凱基-林口,2023-02-13,9257
2634,漢翔,26,19,7,凱基-林口,2023-02-13,9257
1437,勤益控,6,0,6,凱基-林口,2023-02-13,9257
2344,華邦電,13,7,6,凱基-林口,2023-02-13,9257
2801,彰銀,6,0,6,凱基-林口,2023-02-13,9257
00679B,元大美債20年,5,0,5,凱基-林口,2023-02-13,9257
00905,FT臺灣Smart,5,0,5,凱基-林口,2023-02-13,9257
00888,永豐台灣ESG,5,0,5,凱基-林口,2023-02-13,9257
2393,億光,5,0,5,凱基-林口,2023-02-13,9257
2431,聯昌,5,0,5,凱基-林口,2023-02-13,9257
2884,玉山金,400,2,398,凱基-林口,2023-02-14,9257
00665L,富邦�琤肭磪囓�2,280,0,280,凱基-林口,2023-02-14,9257
00671R,富邦NASDAQ反1,140,10,130,凱基-林口,2023-02-14,9257
4114,健喬,99,1,98,凱基-林口,2023-02-14,9257
00878,國泰永續高股息,116,20,96,凱基-林口,2023-02-14,9257
2495,普安,60,0,60,凱基-林口,2023-02-14,9257
3564,其陽,55,0,55,凱基-林口,2023-02-14,9257
1522,堤維西,42,0,42,凱基-林口,2023-02-14,9257
2002,中鋼,38,0,38,凱基-林口,2023-02-14,9257
3013,晟銘電,36,1,35,凱基-林口,2023-02-14,9257
3024,憶聲,35,0,35,凱基-林口,2023-02-14,9257
3710,連展投控,41,6,35,凱基-林口,2023-02-14,9257
8171,天宇,28,2,26,凱基-林口,2023-02-14,9257
2885,元大金,21,0,21,凱基-林口,2023-02-14,9257
2801,彰銀,20,0,20,凱基-林口,2023-02-14,9257
4960,誠美材,20,0,20,凱基-林口,2023-02-14,9257
1795,美時,20,4,16,凱基-林口,2023-02-14,9257
4961,天鈺,15,0,15,凱基-林口,2023-02-14,9257
6153,嘉聯益,15,0,15,凱基-林口,2023-02-14,9257
3164,景岳,14,0,14,凱基-林口,2023-02-14,9257
2845,遠東銀,23,10,13,凱基-林口,2023-02-14,9257
00637L,元大滬深300正2,28,16,12,凱基-林口,2023-02-14,9257
1529,樂事綠能,13,1,12,凱基-林口,2023-02-14,9257
1513,中興電,11,0,11,凱基-林口,2023-02-14,9257
2887,台新金,15,4,11,凱基-林口,2023-02-14,9257
00907,永豐優息存股,10,0,10,凱基-林口,2023-02-14,9257
00673R,期元大S＆P原油反1,10,0,10,凱基-林口,2023-02-14,9257
00756B,群益投等新興公債,10,0,10,凱基-林口,2023-02-14,9257
00632R,元大台灣50反1,10,0,10,凱基-林口,2023-02-14,9257
1711,永光,10,0,10,凱基-林口,2023-02-14,9257
2486,一詮,17,7,10,凱基-林口,2023-02-14,9257
2897,王道銀行,10,0,10,凱基-林口,2023-02-14,9257
2929,淘帝-KY,10,0,10,凱基-林口,2023-02-14,9257
3537,堡達,10,0,10,凱基-林口,2023-02-14,9257
2458,義隆,12,3,9,凱基-林口,2023-02-14,9257
1101,台泥,9,1,8,凱基-林口,2023-02-14,9257
5258,虹堡,18,10,8,凱基-林口,2023-02-14,9257
2618,長榮航,12,5,7,凱基-林口,2023-02-14,9257
2743,山富,11,4,7,凱基-林口,2023-02-14,9257
6443,元晶,16,9,7,凱基-林口,2023-02-14,9257
2201,裕隆,15,8,7,凱基-林口,2023-02-14,9257
8069,元太,18,11,7,凱基-林口,2023-02-14,9257
00890B,凱基ESG BBB債,6,0,6,凱基-林口,2023-02-14,9257
4161,聿新科,6,0,6,凱基-林口,2023-02-14,9257
6672,騰輝電子-KY,6,0,6,凱基-林口,2023-02-14,9257
3661,世芯-KY,6,1,5,凱基-林口,2023-02-14,9257
00642U,期元大S＆P石油,5,0,5,凱基-林口,2023-02-14,9257
3504,揚明光,5,0,5,凱基-林口,2023-02-14,9257
3580,友威科,5,0,5,凱基-林口,2023-02-14,9257
4128,中天,5,0,5,凱基-林口,2023-02-14,9257
2884,玉山金,1244,0,1244,凱基-林口,2023-02-15,9257
5880,合庫金,305,0,305,凱基-林口,2023-02-15,9257
2892,第一金,300,0,300,凱基-林口,2023-02-15,9257
3221,台嘉碩,258,5,253,凱基-林口,2023-02-15,9257
00878,國泰永續高股息,101,12,89,凱基-林口,2023-02-15,9257
2495,普安,84,1,83,凱基-林口,2023-02-15,9257
2610,華航,52,6,46,凱基-林口,2023-02-15,9257
2330,台積電,28,5,23,凱基-林口,2023-02-15,9257
2618,長榮航,24,2,22,凱基-林口,2023-02-15,9257
0056,元大高股息,22,0,22,凱基-林口,2023-02-15,9257
2880,華南金,22,0,22,凱基-林口,2023-02-15,9257
3013,晟銘電,25,4,21,凱基-林口,2023-02-15,9257
1609,大亞,45,25,20,凱基-林口,2023-02-15,9257
5512,力麒,20,0,20,凱基-林口,2023-02-15,9257
2809,京城銀,16,0,16,凱基-林口,2023-02-15,9257
3164,景岳,16,0,16,凱基-林口,2023-02-15,9257
0050,元大台灣50,16,0,16,凱基-林口,2023-02-15,9257
00891,中信關鍵半導體,15,0,15,凱基-林口,2023-02-15,9257
00665L,富邦�琤肭磪囓�2,14,0,14,凱基-林口,2023-02-15,9257
00885,富邦越南,14,0,14,凱基-林口,2023-02-15,9257
2002,中鋼,20,6,14,凱基-林口,2023-02-15,9257
4961,天鈺,15,2,13,凱基-林口,2023-02-15,9257
2883,凱基金,11,0,11,凱基-林口,2023-02-15,9257
8109,博大,11,0,11,凱基-林口,2023-02-15,9257
1440,南紡,10,0,10,凱基-林口,2023-02-15,9257
00753L,中信中國50正2,10,0,10,凱基-林口,2023-02-15,9257
1708,東鹼,10,0,10,凱基-林口,2023-02-15,9257
3141,晶宏,12,2,10,凱基-林口,2023-02-15,9257
3163,波若威,10,0,10,凱基-林口,2023-02-15,9257
4161,聿新科,10,0,10,凱基-林口,2023-02-15,9257
6426,統新,10,0,10,凱基-林口,2023-02-15,9257
6719,力智,10,0,10,凱基-林口,2023-02-15,9257
8107,大億金茂,10,0,10,凱基-林口,2023-02-15,9257
2103,台橡,10,1,9,凱基-林口,2023-02-15,9257
2603,長榮,8,0,8,凱基-林口,2023-02-15,9257
00881,國泰台灣5G+,8,0,8,凱基-林口,2023-02-15,9257
2344,華邦電,7,0,7,凱基-林口,2023-02-15,9257
4171,瑞基,7,0,7,凱基-林口,2023-02-15,9257
5347,世界,7,0,7,凱基-林口,2023-02-15,9257
006208,富邦台50,6,0,6,凱基-林口,2023-02-15,9257
00720B,元大投資級公司債,6,0,6,凱基-林口,2023-02-15,9257
2328,廣宇,10,4,6,凱基-林口,2023-02-15,9257
2812,台中銀,6,0,6,凱基-林口,2023-02-15,9257
6874,倍力,6,0,6,凱基-林口,2023-02-15,9257
8201,無敵,6,0,6,凱基-林口,2023-02-15,9257
8349,�矬�,6,0,6,凱基-林口,2023-02-15,9257
00751B,元大AAA至A公司債,5,0,5,凱基-林口,2023-02-15,9257
1701,中化,15,10,5,凱基-林口,2023-02-15,9257
2017,官田鋼,5,0,5,凱基-林口,2023-02-15,9257
2453,凌群,44,39,5,凱基-林口,2023-02-15,9257
00665L,富邦�琤肭磪囓�2,220,0,220,凱基-林口,2023-02-16,9257
00632R,元大台灣50反1,215,0,215,凱基-林口,2023-02-16,9257
5880,合庫金,234,33,201,凱基-林口,2023-02-16,9257
2892,第一金,200,0,200,凱基-林口,2023-02-16,9257
00679B,元大美債20年,54,0,54,凱基-林口,2023-02-16,9257
6282,康舒,52,1,51,凱基-林口,2023-02-16,9257
2324,仁寶,50,0,50,凱基-林口,2023-02-16,9257
2495,普安,46,0,46,凱基-林口,2023-02-16,9257
2328,廣宇,50,10,40,凱基-林口,2023-02-16,9257
3013,晟銘電,40,0,40,凱基-林口,2023-02-16,9257
4161,聿新科,118,90,28,凱基-林口,2023-02-16,9257
00673R,期元大S＆P原油反1,25,0,25,凱基-林口,2023-02-16,9257
3047,訊舟,25,0,25,凱基-林口,2023-02-16,9257
2206,三陽工業,21,1,20,凱基-林口,2023-02-16,9257
4915,致伸,20,0,20,凱基-林口,2023-02-16,9257
2103,台橡,20,0,20,凱基-林口,2023-02-16,9257
1609,大亞,77,59,18,凱基-林口,2023-02-16,9257
3221,台嘉碩,17,0,17,凱基-林口,2023-02-16,9257
2471,資通,16,0,16,凱基-林口,2023-02-16,9257
2369,菱生,15,0,15,凱基-林口,2023-02-16,9257
3515,華擎,15,0,15,凱基-林口,2023-02-16,9257
3707,漢磊,15,0,15,凱基-林口,2023-02-16,9257
2882,國泰金,14,1,13,凱基-林口,2023-02-16,9257
2399,映泰,20,8,12,凱基-林口,2023-02-16,9257
1714,和桐,11,0,11,凱基-林口,2023-02-16,9257
3027,盛達,16,5,11,凱基-林口,2023-02-16,9257
3037,欣興,14,3,11,凱基-林口,2023-02-16,9257
00885,富邦越南,10,0,10,凱基-林口,2023-02-16,9257
2329,華泰,10,0,10,凱基-林口,2023-02-16,9257
3017,奇鋐,12,2,10,凱基-林口,2023-02-16,9257
3438,類比科,10,0,10,凱基-林口,2023-02-16,9257
6111,大宇資,10,0,10,凱基-林口,2023-02-16,9257
8097,常珵,10,0,10,凱基-林口,2023-02-16,9257
5608,四維航,9,0,9,凱基-林口,2023-02-16,9257
1103,嘉泥,8,0,8,凱基-林口,2023-02-16,9257
2618,長榮航,102,94,8,凱基-林口,2023-02-16,9257
2027,大成鋼,7,0,7,凱基-林口,2023-02-16,9257
3450,聯鈞,7,0,7,凱基-林口,2023-02-16,9257
8358,金居,7,0,7,凱基-林口,2023-02-16,9257
00878,國泰永續高股息,100,94,6,凱基-林口,2023-02-16,9257
2884,玉山金,6,0,6,凱基-林口,2023-02-16,9257
3094,聯傑,6,0,6,凱基-林口,2023-02-16,9257
3483,力致,8,2,6,凱基-林口,2023-02-16,9257
4438,廣越,6,0,6,凱基-林口,2023-02-16,9257
8171,天宇,7,1,6,凱基-林口,2023-02-16,9257
00683L,期元大美元指正2,5,0,5,凱基-林口,2023-02-16,9257
00751B,元大AAA至A公司債,5,0,5,凱基-林口,2023-02-16,9257
2313,華通,5,0,5,凱基-林口,2023-02-16,9257
2607,榮運,18,13,5,凱基-林口,2023-02-16,9257
3016,嘉晶,5,0,5,凱基-林口,2023-02-16,9257
3481,群創,170,33,137,凱基-林口,2023-02-17,9257
3013,晟銘電,70,6,64,凱基-林口,2023-02-17,9257
2891,中信金,55,0,55,凱基-林口,2023-02-17,9257
00692,富邦公司治理,50,0,50,凱基-林口,2023-02-17,9257
1437,勤益控,50,0,50,凱基-林口,2023-02-17,9257
00878,國泰永續高股息,72,26,46,凱基-林口,2023-02-17,9257
2618,長榮航,52,15,37,凱基-林口,2023-02-17,9257
00900,富邦特選高股息30,36,0,36,凱基-林口,2023-02-17,9257
3024,憶聲,35,0,35,凱基-林口,2023-02-17,9257
3564,其陽,30,0,30,凱基-林口,2023-02-17,9257
4950,牧東,30,0,30,凱基-林口,2023-02-17,9257
2610,華航,136,108,28,凱基-林口,2023-02-17,9257
00679B,元大美債20年,27,0,27,凱基-林口,2023-02-17,9257
8358,金居,27,2,25,凱基-林口,2023-02-17,9257
6104,創惟,52,29,23,凱基-林口,2023-02-17,9257
6288,聯嘉,20,0,20,凱基-林口,2023-02-17,9257
1611,中電,20,1,19,凱基-林口,2023-02-17,9257
2455,全新,24,5,19,凱基-林口,2023-02-17,9257
00893,國泰智能電動車,17,0,17,凱基-林口,2023-02-17,9257
00888,永豐台灣ESG,16,0,16,凱基-林口,2023-02-17,9257
00891,中信關鍵半導體,15,0,15,凱基-林口,2023-02-17,9257
8478,東哥遊艇,33,18,15,凱基-林口,2023-02-17,9257
00772B,中信高評級公司債,14,0,14,凱基-林口,2023-02-17,9257
00637L,元大滬深300正2,15,2,13,凱基-林口,2023-02-17,9257
00680L,元大美債20正2,12,0,12,凱基-林口,2023-02-17,9257
2401,凌陽,12,0,12,凱基-林口,2023-02-17,9257
4161,聿新科,12,0,12,凱基-林口,2023-02-17,9257
5425,台半,84,72,12,凱基-林口,2023-02-17,9257
00902,中信電池及儲能,11,0,11,凱基-林口,2023-02-17,9257
2375,凱美,19,8,11,凱基-林口,2023-02-17,9257
1216,統一,10,0,10,凱基-林口,2023-02-17,9257
00683L,期元大美元指正2,10,0,10,凱基-林口,2023-02-17,9257
00671R,富邦NASDAQ反1,10,0,10,凱基-林口,2023-02-17,9257
3454,晶睿,10,0,10,凱基-林口,2023-02-17,9257
8069,元太,21,11,10,凱基-林口,2023-02-17,9257
8261,富鼎,12,2,10,凱基-林口,2023-02-17,9257
2867,三商壽,9,0,9,凱基-林口,2023-02-17,9257
5347,世界,8,0,8,凱基-林口,2023-02-17,9257
6146,耕興,8,0,8,凱基-林口,2023-02-17,9257
2609,陽明,9,2,7,凱基-林口,2023-02-17,9257
2615,萬海,12,5,7,凱基-林口,2023-02-17,9257
2330,台積電,10,4,6,凱基-林口,2023-02-17,9257
00712,復華富時不動產,6,0,6,凱基-林口,2023-02-17,9257
1708,東鹼,6,0,6,凱基-林口,2023-02-17,9257
2439,美律,7,1,6,凱基-林口,2023-02-17,9257
6235,華孚,21,15,6,凱基-林口,2023-02-17,9257
00715L,期街口布蘭特正2,5,0,5,凱基-林口,2023-02-17,9257
00830,國泰費城半導體,5,0,5,凱基-林口,2023-02-17,9257
00688L,國泰20年美債正2,5,0,5,凱基-林口,2023-02-17,9257
2465,麗臺,5,0,5,凱基-林口,2023-02-17,9257
3013,晟銘電,130,2,128,凱基-林口,2023-02-20,9257
00680L,元大美債20正2,100,0,100,凱基-林口,2023-02-20,9257
00670L,富邦NASDAQ正2,73,0,73,凱基-林口,2023-02-20,9257
00632R,元大台灣50反1,70,0,70,凱基-林口,2023-02-20,9257
6282,康舒,65,0,65,凱基-林口,2023-02-20,9257
00885,富邦越南,50,0,50,凱基-林口,2023-02-20,9257
3062,建漢,40,7,33,凱基-林口,2023-02-20,9257
1101,台泥,32,2,30,凱基-林口,2023-02-20,9257
00720B,元大投資級公司債,30,0,30,凱基-林口,2023-02-20,9257
2867,三商壽,29,0,29,凱基-林口,2023-02-20,9257
00637L,元大滬深300正2,28,0,28,凱基-林口,2023-02-20,9257
00900,富邦特選高股息30,36,10,26,凱基-林口,2023-02-20,9257
00674R,期元大S＆P黃金反1,20,0,20,凱基-林口,2023-02-20,9257
2208,台船,105,86,19,凱基-林口,2023-02-20,9257
6026,福邦證,18,0,18,凱基-林口,2023-02-20,9257
3673,TPK-KY,16,1,15,凱基-林口,2023-02-20,9257
4538,大詠城,15,0,15,凱基-林口,2023-02-20,9257
2455,全新,14,1,13,凱基-林口,2023-02-20,9257
3594,磐儀,20,7,13,凱基-林口,2023-02-20,9257
1519,華城,15,3,12,凱基-林口,2023-02-20,9257
1609,大亞,22,10,12,凱基-林口,2023-02-20,9257
2371,大同,12,0,12,凱基-林口,2023-02-20,9257
2701,萬企,12,0,12,凱基-林口,2023-02-20,9257
00878,國泰永續高股息,54,43,11,凱基-林口,2023-02-20,9257
4960,誠美材,52,41,11,凱基-林口,2023-02-20,9257
2409,友達,73,63,10,凱基-林口,2023-02-20,9257
8069,元太,10,0,10,凱基-林口,2023-02-20,9257
00664R,國泰臺灣加權反1,10,0,10,凱基-林口,2023-02-20,9257
00882,中信中國高股息,10,0,10,凱基-林口,2023-02-20,9257
1504,東元,12,2,10,凱基-林口,2023-02-20,9257
2425,承啟,10,0,10,凱基-林口,2023-02-20,9257
3003,健和興,10,0,10,凱基-林口,2023-02-20,9257
3024,憶聲,10,0,10,凱基-林口,2023-02-20,9257
3211,順達,10,0,10,凱基-林口,2023-02-20,9257
5340,建榮,11,1,10,凱基-林口,2023-02-20,9257
6235,華孚,23,13,10,凱基-林口,2023-02-20,9257
2317,鴻海,13,5,8,凱基-林口,2023-02-20,9257
00751B,元大AAA至A公司債,8,0,8,凱基-林口,2023-02-20,9257
00679B,元大美債20年,8,0,8,凱基-林口,2023-02-20,9257
3234,光環,8,0,8,凱基-林口,2023-02-20,9257
3322,建舜電,8,0,8,凱基-林口,2023-02-20,9257
6142,友勁,8,0,8,凱基-林口,2023-02-20,9257
4128,中天,28,20,8,凱基-林口,2023-02-20,9257
1795,美時,7,0,7,凱基-林口,2023-02-20,9257
2812,台中銀,7,0,7,凱基-林口,2023-02-20,9257
3035,智原,11,4,7,凱基-林口,2023-02-20,9257
6111,大宇資,7,0,7,凱基-林口,2023-02-20,9257
6120,達運,7,0,7,凱基-林口,2023-02-20,9257
2889,國票金,6,0,6,凱基-林口,2023-02-20,9257
1503,士電,6,0,6,凱基-林口,2023-02-20,9257
2884,玉山金,178,17,161,凱基-林口,2023-02-21,9257
6282,康舒,157,57,100,凱基-林口,2023-02-21,9257
00878,國泰永續高股息,73,2,71,凱基-林口,2023-02-21,9257
2614,東森,63,1,62,凱基-林口,2023-02-21,9257
00919,群益台灣精選高息,60,0,60,凱基-林口,2023-02-21,9257
0056,元大高股息,72,13,59,凱基-林口,2023-02-21,9257
2618,長榮航,125,72,53,凱基-林口,2023-02-21,9257
5701,劍湖山,42,0,42,凱基-林口,2023-02-21,9257
2867,三商壽,32,0,32,凱基-林口,2023-02-21,9257
2303,聯電,51,22,29,凱基-林口,2023-02-21,9257
2610,華航,57,28,29,凱基-林口,2023-02-21,9257
3481,群創,46,20,26,凱基-林口,2023-02-21,9257
1437,勤益控,27,1,26,凱基-林口,2023-02-21,9257
2634,漢翔,30,5,25,凱基-林口,2023-02-21,9257
8358,金居,26,1,25,凱基-林口,2023-02-21,9257
2409,友達,27,5,22,凱基-林口,2023-02-21,9257
00665L,富邦�琤肭磪囓�2,21,0,21,凱基-林口,2023-02-21,9257
00882,中信中國高股息,20,0,20,凱基-林口,2023-02-21,9257
2328,廣宇,20,0,20,凱基-林口,2023-02-21,9257
2611,志信,20,0,20,凱基-林口,2023-02-21,9257
2883,凱基金,20,0,20,凱基-林口,2023-02-21,9257
3062,建漢,17,0,17,凱基-林口,2023-02-21,9257
4979,華星光,18,2,16,凱基-林口,2023-02-21,9257
8454,富邦媒,15,1,14,凱基-林口,2023-02-21,9257
3013,晟銘電,20,6,14,凱基-林口,2023-02-21,9257
2701,萬企,13,0,13,凱基-林口,2023-02-21,9257
6517,保勝光學,13,0,13,凱基-林口,2023-02-21,9257
2317,鴻海,14,2,12,凱基-林口,2023-02-21,9257
2368,金像電,13,1,12,凱基-林口,2023-02-21,9257
3689,湧德,15,3,12,凱基-林口,2023-02-21,9257
6535,順藥,12,0,12,凱基-林口,2023-02-21,9257
2201,裕隆,20,9,11,凱基-林口,2023-02-21,9257
6202,盛群,11,0,11,凱基-林口,2023-02-21,9257
6266,泰詠,11,0,11,凱基-林口,2023-02-21,9257
1440,南紡,10,0,10,凱基-林口,2023-02-21,9257
00902,中信電池及儲能,10,0,10,凱基-林口,2023-02-21,9257
3594,磐儀,30,20,10,凱基-林口,2023-02-21,9257
3673,TPK-KY,10,0,10,凱基-林口,2023-02-21,9257
4105,東洋,10,0,10,凱基-林口,2023-02-21,9257
8081,致新,10,0,10,凱基-林口,2023-02-21,9257
2208,台船,8,0,8,凱基-林口,2023-02-21,9257
6531,愛普*,17,10,7,凱基-林口,2023-02-21,9257
00725B,國泰投資級公司債,6,0,6,凱基-林口,2023-02-21,9257
3011,今皓,6,0,6,凱基-林口,2023-02-21,9257
1314,中石化,5,0,5,凱基-林口,2023-02-21,9257
00692,富邦公司治理,5,0,5,凱基-林口,2023-02-21,9257
00830,國泰費城半導體,5,0,5,凱基-林口,2023-02-21,9257
1524,耿鼎,5,0,5,凱基-林口,2023-02-21,9257
1529,樂事綠能,5,0,5,凱基-林口,2023-02-21,9257
2329,華泰,5,0,5,凱基-林口,2023-02-21,9257
2303,聯電,323,52,271,凱基-林口,2023-02-22,9257
00671R,富邦NASDAQ反1,155,0,155,凱基-林口,2023-02-22,9257
6290,良維,40,0,40,凱基-林口,2023-02-22,9257
2891,中信金,39,0,39,凱基-林口,2023-02-22,9257
3576,聯合再生,35,0,35,凱基-林口,2023-02-22,9257
020029,元大ESG高股息N,30,0,30,凱基-林口,2023-02-22,9257
2388,威盛,41,11,30,凱基-林口,2023-02-22,9257
3013,晟銘電,28,0,28,凱基-林口,2023-02-22,9257
1519,華城,50,23,27,凱基-林口,2023-02-22,9257
2610,華航,46,22,24,凱基-林口,2023-02-22,9257
3673,TPK-KY,21,0,21,凱基-林口,2023-02-22,9257
2882,國泰金,20,0,20,凱基-林口,2023-02-22,9257
00902,中信電池及儲能,20,0,20,凱基-林口,2023-02-22,9257
2705,六福,20,0,20,凱基-林口,2023-02-22,9257
2618,長榮航,23,5,18,凱基-林口,2023-02-22,9257
3035,智原,27,10,17,凱基-林口,2023-02-22,9257
00881,國泰台灣5G+,17,0,17,凱基-林口,2023-02-22,9257
2883,凱基金,17,0,17,凱基-林口,2023-02-22,9257
00878,國泰永續高股息,104,87,17,凱基-林口,2023-02-22,9257
2890,永豐金,15,0,15,凱基-林口,2023-02-22,9257
00893,國泰智能電動車,24,10,14,凱基-林口,2023-02-22,9257
2330,台積電,17,4,13,凱基-林口,2023-02-22,9257
0056,元大高股息,48,36,12,凱基-林口,2023-02-22,9257
00772B,中信高評級公司債,12,0,12,凱基-林口,2023-02-22,9257
00669R,國泰美國道瓊反1,11,0,11,凱基-林口,2023-02-22,9257
3558,神準,11,0,11,凱基-林口,2023-02-22,9257
2603,長榮,14,3,11,凱基-林口,2023-02-22,9257
0050,元大台灣50,12,1,11,凱基-林口,2023-02-22,9257
3504,揚明光,10,0,10,凱基-林口,2023-02-22,9257
00830,國泰費城半導體,11,1,10,凱基-林口,2023-02-22,9257
2406,國碩,10,0,10,凱基-林口,2023-02-22,9257
2455,全新,10,0,10,凱基-林口,2023-02-22,9257
6160,欣技,10,0,10,凱基-林口,2023-02-22,9257
6282,康舒,14,4,10,凱基-林口,2023-02-22,9257
5347,世界,11,2,9,凱基-林口,2023-02-22,9257
00679B,元大美債20年,9,0,9,凱基-林口,2023-02-22,9257
1522,堤維西,9,0,9,凱基-林口,2023-02-22,9257
1609,大亞,18,9,9,凱基-林口,2023-02-22,9257
2049,上銀,9,0,9,凱基-林口,2023-02-22,9257
3011,今皓,9,0,9,凱基-林口,2023-02-22,9257
4903,聯光通,9,0,9,凱基-林口,2023-02-22,9257
00712,復華富時不動產,8,0,8,凱基-林口,2023-02-22,9257
00773B,中信優先金融債,8,0,8,凱基-林口,2023-02-22,9257
1444,力麗,8,0,8,凱基-林口,2023-02-22,9257
5309,系統電,8,0,8,凱基-林口,2023-02-22,9257
5905,南仁湖,10,2,8,凱基-林口,2023-02-22,9257
6133,金橋,8,0,8,凱基-林口,2023-02-22,9257
8478,東哥遊艇,16,8,8,凱基-林口,2023-02-22,9257
2344,華邦電,12,5,7,凱基-林口,2023-02-22,9257
8016,矽創,12,5,7,凱基-林口,2023-02-22,9257
2376,技嘉,224,49,175,凱基-林口,2023-02-23,9257
3481,群創,123,26,97,凱基-林口,2023-02-23,9257
2409,友達,94,4,90,凱基-林口,2023-02-23,9257
00670L,富邦NASDAQ正2,172,100,72,凱基-林口,2023-02-23,9257
2317,鴻海,72,10,62,凱基-林口,2023-02-23,9257
3673,TPK-KY,61,0,61,凱基-林口,2023-02-23,9257
2883,凱基金,52,0,52,凱基-林口,2023-02-23,9257
00632R,元大台灣50反1,51,0,51,凱基-林口,2023-02-23,9257
6129,普誠,51,0,51,凱基-林口,2023-02-23,9257
2610,華航,67,26,41,凱基-林口,2023-02-23,9257
00639,富邦深100,40,0,40,凱基-林口,2023-02-23,9257
2614,東森,34,4,30,凱基-林口,2023-02-23,9257
6235,華孚,66,39,27,凱基-林口,2023-02-23,9257
4161,聿新科,25,0,25,凱基-林口,2023-02-23,9257
6116,彩晶,23,0,23,凱基-林口,2023-02-23,9257
00885,富邦越南,22,0,22,凱基-林口,2023-02-23,9257
3037,欣興,24,3,21,凱基-林口,2023-02-23,9257
1773,勝一,20,0,20,凱基-林口,2023-02-23,9257
1584,精剛,23,3,20,凱基-林口,2023-02-23,9257
2867,三商壽,20,0,20,凱基-林口,2023-02-23,9257
00664R,國泰臺灣加權反1,19,0,19,凱基-林口,2023-02-23,9257
00637L,元大滬深300正2,19,0,19,凱基-林口,2023-02-23,9257
00715L,期街口布蘭特正2,26,7,19,凱基-林口,2023-02-23,9257
6768,志強-KY,17,0,17,凱基-林口,2023-02-23,9257
6282,康舒,22,6,16,凱基-林口,2023-02-23,9257
2458,義隆,20,5,15,凱基-林口,2023-02-23,9257
2884,玉山金,20,6,14,凱基-林口,2023-02-23,9257
00720B,元大投資級公司債,13,0,13,凱基-林口,2023-02-23,9257
00665L,富邦�琤肭磪囓�2,25,13,12,凱基-林口,2023-02-23,9257
2344,華邦電,12,0,12,凱基-林口,2023-02-23,9257
2371,大同,12,0,12,凱基-林口,2023-02-23,9257
3058,立德,12,0,12,凱基-林口,2023-02-23,9257
00642U,期元大S＆P石油,11,0,11,凱基-林口,2023-02-23,9257
2308,台達電,11,0,11,凱基-林口,2023-02-23,9257
00919,群益台灣精選高息,10,0,10,凱基-林口,2023-02-23,9257
00753L,中信中國50正2,10,0,10,凱基-林口,2023-02-23,9257
1434,福懋,10,0,10,凱基-林口,2023-02-23,9257
1437,勤益控,10,0,10,凱基-林口,2023-02-23,9257
1605,華新,13,3,10,凱基-林口,2023-02-23,9257
3231,緯創,11,1,10,凱基-林口,2023-02-23,9257
3520,華盈,10,0,10,凱基-林口,2023-02-23,9257
6122,擎邦,10,0,10,凱基-林口,2023-02-23,9257
6142,友勁,10,0,10,凱基-林口,2023-02-23,9257
6288,聯嘉,10,0,10,凱基-林口,2023-02-23,9257
8473,山林水,10,0,10,凱基-林口,2023-02-23,9257
8928,鉅明,10,0,10,凱基-林口,2023-02-23,9257
00773B,中信優先金融債,9,0,9,凱基-林口,2023-02-23,9257
2609,陽明,38,29,9,凱基-林口,2023-02-23,9257
1104,環泥,8,0,8,凱基-林口,2023-02-23,9257
5701,劍湖山,8,0,8,凱基-林口,2023-02-23,9257
4950,牧東,200,0,200,凱基-林口,2023-02-24,9257
3013,晟銘電,130,1,129,凱基-林口,2023-02-24,9257
00637L,元大滬深300正2,108,0,108,凱基-林口,2023-02-24,9257
3231,緯創,106,14,92,凱基-林口,2023-02-24,9257
00878,國泰永續高股息,77,1,76,凱基-林口,2023-02-24,9257
3037,欣興,72,5,67,凱基-林口,2023-02-24,9257
2482,連宇,60,0,60,凱基-林口,2023-02-24,9257
1618,合機,50,0,50,凱基-林口,2023-02-24,9257
8097,常珵,40,0,40,凱基-林口,2023-02-24,9257
1108,幸福,36,1,35,凱基-林口,2023-02-24,9257
8069,元太,38,8,30,凱基-林口,2023-02-24,9257
4960,誠美材,30,0,30,凱基-林口,2023-02-24,9257
2614,東森,30,1,29,凱基-林口,2023-02-24,9257
3058,立德,27,0,27,凱基-林口,2023-02-24,9257
4961,天鈺,22,0,22,凱基-林口,2023-02-24,9257
1708,東鹼,20,0,20,凱基-林口,2023-02-24,9257
6139,亞翔,19,0,19,凱基-林口,2023-02-24,9257
2618,長榮航,20,2,18,凱基-林口,2023-02-24,9257
2014,中鴻,20,4,16,凱基-林口,2023-02-24,9257
2834,臺企銀,21,5,16,凱基-林口,2023-02-24,9257
8033,雷虎,19,3,16,凱基-林口,2023-02-24,9257
4161,聿新科,15,0,15,凱基-林口,2023-02-24,9257
5512,力麒,16,1,15,凱基-林口,2023-02-24,9257
2377,微星,15,1,14,凱基-林口,2023-02-24,9257
5258,虹堡,15,1,14,凱基-林口,2023-02-24,9257
2891,中信金,13,0,13,凱基-林口,2023-02-24,9257
00885,富邦越南,13,0,13,凱基-林口,2023-02-24,9257
3022,威強電,13,0,13,凱基-林口,2023-02-24,9257
6547,高端疫苗,13,0,13,凱基-林口,2023-02-24,9257
8222,寶一,16,3,13,凱基-林口,2023-02-24,9257
1444,力麗,12,0,12,凱基-林口,2023-02-24,9257
2002,中鋼,12,0,12,凱基-林口,2023-02-24,9257
4968,立積,13,1,12,凱基-林口,2023-02-24,9257
8401,白紗科,12,0,12,凱基-林口,2023-02-24,9257
6282,康舒,11,0,11,凱基-林口,2023-02-24,9257
1101,台泥,11,0,11,凱基-林口,2023-02-24,9257
2405,輔信,11,0,11,凱基-林口,2023-02-24,9257
6219,富旺,11,0,11,凱基-林口,2023-02-24,9257
2408,南亞科,10,0,10,凱基-林口,2023-02-24,9257
2353,宏��,10,0,10,凱基-林口,2023-02-24,9257
00882,中信中國高股息,10,0,10,凱基-林口,2023-02-24,9257
2329,華泰,10,0,10,凱基-林口,2023-02-24,9257
2460,建通,10,0,10,凱基-林口,2023-02-24,9257
2890,永豐金,10,0,10,凱基-林口,2023-02-24,9257
4977,眾達-KY,10,0,10,凱基-林口,2023-02-24,9257
5009,榮剛,11,1,10,凱基-林口,2023-02-24,9257
6026,福邦證,10,0,10,凱基-林口,2023-02-24,9257
6288,聯嘉,10,0,10,凱基-林口,2023-02-24,9257
6715,嘉基,10,0,10,凱基-林口,2023-02-24,9257
8234,新漢,10,0,10,凱基-林口,2023-02-24,9257
00665L,富邦�琤肭磪囓�2,371,1,370,凱基-林口,2023-03-01,9257
1605,華新,138,23,115,凱基-林口,2023-03-01,9257
00671R,富邦NASDAQ反1,170,71,99,凱基-林口,2023-03-01,9257
00632R,元大台灣50反1,109,50,59,凱基-林口,2023-03-01,9257
00878,國泰永續高股息,51,2,49,凱基-林口,2023-03-01,9257
3013,晟銘電,42,0,42,凱基-林口,2023-03-01,9257
1437,勤益控,41,0,41,凱基-林口,2023-03-01,9257
2884,玉山金,42,8,34,凱基-林口,2023-03-01,9257
6190,萬泰科,33,0,33,凱基-林口,2023-03-01,9257
00882,中信中國高股息,32,0,32,凱基-林口,2023-03-01,9257
3576,聯合再生,30,0,30,凱基-林口,2023-03-01,9257
5009,榮剛,28,0,28,凱基-林口,2023-03-01,9257
00753L,中信中國50正2,20,0,20,凱基-林口,2023-03-01,9257
1101,台泥,20,3,17,凱基-林口,2023-03-01,9257
2885,元大金,17,0,17,凱基-林口,2023-03-01,9257
5608,四維航,51,34,17,凱基-林口,2023-03-01,9257
2609,陽明,27,11,16,凱基-林口,2023-03-01,9257
2606,裕民,46,31,15,凱基-林口,2023-03-01,9257
00683L,期元大美元指正2,15,0,15,凱基-林口,2023-03-01,9257
2883,凱基金,15,0,15,凱基-林口,2023-03-01,9257
2014,中鴻,16,2,14,凱基-林口,2023-03-01,9257
2637,慧洋-KY,15,1,14,凱基-林口,2023-03-01,9257
6770,力積電,13,0,13,凱基-林口,2023-03-01,9257
2882,國泰金,12,0,12,凱基-林口,2023-03-01,9257
2845,遠東銀,12,0,12,凱基-林口,2023-03-01,9257
00772B,中信高評級公司債,11,0,11,凱基-林口,2023-03-01,9257
2408,南亞科,11,0,11,凱基-林口,2023-03-01,9257
2614,東森,11,0,11,凱基-林口,2023-03-01,9257
2618,長榮航,19,8,11,凱基-林口,2023-03-01,9257
4167,松瑞藥,11,0,11,凱基-林口,2023-03-01,9257
0056,元大高股息,15,5,10,凱基-林口,2023-03-01,9257
8358,金居,12,2,10,凱基-林口,2023-03-01,9257
1108,幸福,10,0,10,凱基-林口,2023-03-01,9257
00669R,國泰美國道瓊反1,10,0,10,凱基-林口,2023-03-01,9257
2388,威盛,16,6,10,凱基-林口,2023-03-01,9257
2425,承啟,16,6,10,凱基-林口,2023-03-01,9257
2867,三商壽,11,1,10,凱基-林口,2023-03-01,9257
2945,三商家購,10,0,10,凱基-林口,2023-03-01,9257
3564,其陽,10,0,10,凱基-林口,2023-03-01,9257
6026,福邦證,10,0,10,凱基-林口,2023-03-01,9257
8097,常珵,10,0,10,凱基-林口,2023-03-01,9257
8222,寶一,24,14,10,凱基-林口,2023-03-01,9257
8249,菱光,10,0,10,凱基-林口,2023-03-01,9257
9945,潤泰新,12,2,10,凱基-林口,2023-03-01,9257
2707,晶華,10,1,9,凱基-林口,2023-03-01,9257
4433,興采,9,0,9,凱基-林口,2023-03-01,9257
2002,中鋼,21,13,8,凱基-林口,2023-03-01,9257
2603,長榮,16,8,8,凱基-林口,2023-03-01,9257
8289,泰藝,8,0,8,凱基-林口,2023-03-01,9257
5011,久陽,7,0,7,凱基-林口,2023-03-01,9257
00665L,富邦�琤肭磪囓�2,100,0,100,凱基-林口,2023-03-02,9257
00878,國泰永續高股息,88,0,88,凱基-林口,2023-03-02,9257
8289,泰藝,89,6,83,凱基-林口,2023-03-02,9257
3013,晟銘電,88,6,82,凱基-林口,2023-03-02,9257
6443,元晶,82,0,82,凱基-林口,2023-03-02,9257
6229,研通,50,0,50,凱基-林口,2023-03-02,9257
2614,東森,65,20,45,凱基-林口,2023-03-02,9257
5452,佶優,50,5,45,凱基-林口,2023-03-02,9257
2887,台新金,40,0,40,凱基-林口,2023-03-02,9257
8069,元太,50,17,33,凱基-林口,2023-03-02,9257
3207,耀勝,52,22,30,凱基-林口,2023-03-02,9257
2498,宏達電,32,4,28,凱基-林口,2023-03-02,9257
2845,遠東銀,27,0,27,凱基-林口,2023-03-02,9257
00632R,元大台灣50反1,21,0,21,凱基-林口,2023-03-02,9257
4915,致伸,22,3,19,凱基-林口,2023-03-02,9257
00712,復華富時不動產,18,0,18,凱基-林口,2023-03-02,9257
2388,威盛,23,7,16,凱基-林口,2023-03-02,9257
4114,健喬,15,0,15,凱基-林口,2023-03-02,9257
2303,聯電,13,1,12,凱基-林口,2023-03-02,9257
3710,連展投控,15,3,12,凱基-林口,2023-03-02,9257
1220,台榮,20,10,10,凱基-林口,2023-03-02,9257
00679B,元大美債20年,13,3,10,凱基-林口,2023-03-02,9257
1618,合機,10,0,10,凱基-林口,2023-03-02,9257
3088,艾訊,11,1,10,凱基-林口,2023-03-02,9257
3481,群創,25,15,10,凱基-林口,2023-03-02,9257
5475,德宏,10,0,10,凱基-林口,2023-03-02,9257
6108,競國,10,0,10,凱基-林口,2023-03-02,9257
00772B,中信高評級公司債,9,0,9,凱基-林口,2023-03-02,9257
00881,國泰台灣5G+,9,0,9,凱基-林口,2023-03-02,9257
2201,裕隆,19,10,9,凱基-林口,2023-03-02,9257
3545,敦泰,9,0,9,凱基-林口,2023-03-02,9257
4743,合一,11,3,8,凱基-林口,2023-03-02,9257
006208,富邦台50,8,0,8,凱基-林口,2023-03-02,9257
8033,雷虎,8,0,8,凱基-林口,2023-03-02,9257
00773B,中信優先金融債,7,0,7,凱基-林口,2023-03-02,9257
4968,立積,8,1,7,凱基-林口,2023-03-02,9257
5258,虹堡,14,7,7,凱基-林口,2023-03-02,9257
6155,鈞寶,7,0,7,凱基-林口,2023-03-02,9257
9945,潤泰新,6,0,6,凱基-林口,2023-03-02,9257
00919,群益台灣精選高息,6,0,6,凱基-林口,2023-03-02,9257
2748,雲品,18,12,6,凱基-林口,2023-03-02,9257
8112,至上,10,4,6,凱基-林口,2023-03-02,9257
00713,元大台灣高息低波,5,0,5,凱基-林口,2023-03-02,9257
1437,勤益控,5,0,5,凱基-林口,2023-03-02,9257
1434,福懋,5,0,5,凱基-林口,2023-03-02,9257
1506,正道,5,0,5,凱基-林口,2023-03-02,9257
1786,科妍,5,0,5,凱基-林口,2023-03-02,9257
2337,旺宏,5,0,5,凱基-林口,2023-03-02,9257
2406,國碩,5,0,5,凱基-林口,2023-03-02,9257
2607,榮運,5,0,5,凱基-林口,2023-03-02,9257
6443,元晶,103,0,103,凱基-林口,2023-03-03,9257
00671R,富邦NASDAQ反1,100,30,70,凱基-林口,2023-03-03,9257
3024,憶聲,65,0,65,凱基-林口,2023-03-03,9257
4743,合一,57,0,57,凱基-林口,2023-03-03,9257
2845,遠東銀,56,11,45,凱基-林口,2023-03-03,9257
00665L,富邦�琤肭磪囓�2,60,20,40,凱基-林口,2023-03-03,9257
1101,台泥,38,0,38,凱基-林口,2023-03-03,9257
1605,華新,53,21,32,凱基-林口,2023-03-03,9257
2606,裕民,49,18,31,凱基-林口,2023-03-03,9257
4967,十銓,50,20,30,凱基-林口,2023-03-03,9257
5425,台半,35,5,30,凱基-林口,2023-03-03,9257
2610,華航,39,13,26,凱基-林口,2023-03-03,9257
2419,仲琦,27,2,25,凱基-林口,2023-03-03,9257
2388,威盛,27,4,23,凱基-林口,2023-03-03,9257
8050,廣積,21,0,21,凱基-林口,2023-03-03,9257
4167,松瑞藥,20,0,20,凱基-林口,2023-03-03,9257
2457,飛宏,33,14,19,凱基-林口,2023-03-03,9257
2498,宏達電,21,4,17,凱基-林口,2023-03-03,9257
4114,健喬,17,0,17,凱基-林口,2023-03-03,9257
8046,南電,20,4,16,凱基-林口,2023-03-03,9257
9945,潤泰新,14,0,14,凱基-林口,2023-03-03,9257
2450,神腦,14,0,14,凱基-林口,2023-03-03,9257
00885,富邦越南,13,0,13,凱基-林口,2023-03-03,9257
3128,昇銳,16,4,12,凱基-林口,2023-03-03,9257
4961,天鈺,22,10,12,凱基-林口,2023-03-03,9257
6104,創惟,13,1,12,凱基-林口,2023-03-03,9257
8016,矽創,12,0,12,凱基-林口,2023-03-03,9257
1708,東鹼,13,2,11,凱基-林口,2023-03-03,9257
3211,順達,11,0,11,凱基-林口,2023-03-03,9257
6509,聚和,11,0,11,凱基-林口,2023-03-03,9257
8289,泰藝,12,1,11,凱基-林口,2023-03-03,9257
2834,臺企銀,20,10,10,凱基-林口,2023-03-03,9257
1734,杏輝,10,0,10,凱基-林口,2023-03-03,9257
2449,京元電子,26,16,10,凱基-林口,2023-03-03,9257
8249,菱光,10,0,10,凱基-林口,2023-03-03,9257
2884,玉山金,11,2,9,凱基-林口,2023-03-03,9257
2601,益航,10,1,9,凱基-林口,2023-03-03,9257
2637,慧洋-KY,10,1,9,凱基-林口,2023-03-03,9257
3094,聯傑,9,0,9,凱基-林口,2023-03-03,9257
1201,味全,8,0,8,凱基-林口,2023-03-03,9257
5465,富驊,8,0,8,凱基-林口,2023-03-03,9257
00712,復華富時不動產,8,1,7,凱基-林口,2023-03-03,9257
6245,立端,12,5,7,凱基-林口,2023-03-03,9257
3661,世芯-KY,10,3,7,凱基-林口,2023-03-03,9257
00679B,元大美債20年,6,0,6,凱基-林口,2023-03-03,9257
2351,順德,6,0,6,凱基-林口,2023-03-03,9257
2886,兆豐金,6,0,6,凱基-林口,2023-03-03,9257
3406,玉晶光,10,4,6,凱基-林口,2023-03-03,9257
3673,TPK-KY,6,0,6,凱基-林口,2023-03-03,9257
5245,智晶,6,0,6,凱基-林口,2023-03-03,9257
2495,普安,120,5,115,凱基-林口,2023-03-06,9257
3689,湧德,117,13,104,凱基-林口,2023-03-06,9257
00680L,元大美債20正2,75,0,75,凱基-林口,2023-03-06,9257
00720B,元大投資級公司債,61,0,61,凱基-林口,2023-03-06,9257
4915,致伸,32,0,32,凱基-林口,2023-03-06,9257
00773B,中信優先金融債,30,0,30,凱基-林口,2023-03-06,9257
2352,佳世達,30,0,30,凱基-林口,2023-03-06,9257
5309,系統電,25,0,25,凱基-林口,2023-03-06,9257
00637L,元大滬深300正2,22,0,22,凱基-林口,2023-03-06,9257
3504,揚明光,23,1,22,凱基-林口,2023-03-06,9257
1584,精剛,25,7,18,凱基-林口,2023-03-06,9257
3362,先進光,31,13,18,凱基-林口,2023-03-06,9257
6152,百一,18,0,18,凱基-林口,2023-03-06,9257
3432,台端,17,0,17,凱基-林口,2023-03-06,9257
5512,力麒,17,0,17,凱基-林口,2023-03-06,9257
2633,台灣高鐵,17,1,16,凱基-林口,2023-03-06,9257
00713,元大台灣高息低波,15,0,15,凱基-林口,2023-03-06,9257
2462,良得電,15,0,15,凱基-林口,2023-03-06,9257
3484,崧騰,15,0,15,凱基-林口,2023-03-06,9257
2945,三商家購,12,0,12,凱基-林口,2023-03-06,9257
4919,新唐,37,25,12,凱基-林口,2023-03-06,9257
1101,台泥,13,2,11,凱基-林口,2023-03-06,9257
1609,大亞,14,3,11,凱基-林口,2023-03-06,9257
2388,威盛,14,3,11,凱基-林口,2023-03-06,9257
2498,宏達電,13,2,11,凱基-林口,2023-03-06,9257
2887,台新金,11,0,11,凱基-林口,2023-03-06,9257
4164,承業醫,11,0,11,凱基-林口,2023-03-06,9257
4192,杏國,11,0,11,凱基-林口,2023-03-06,9257
8050,廣積,11,0,11,凱基-林口,2023-03-06,9257
2609,陽明,34,24,10,凱基-林口,2023-03-06,9257
1473,台南,10,0,10,凱基-林口,2023-03-06,9257
2014,中鴻,10,0,10,凱基-林口,2023-03-06,9257
2344,華邦電,20,10,10,凱基-林口,2023-03-06,9257
2607,榮運,13,3,10,凱基-林口,2023-03-06,9257
4161,聿新科,10,0,10,凱基-林口,2023-03-06,9257
1220,台榮,8,0,8,凱基-林口,2023-03-06,9257
3042,晶技,9,1,8,凱基-林口,2023-03-06,9257
3664,安瑞-KY,8,0,8,凱基-林口,2023-03-06,9257
1314,中石化,15,8,7,凱基-林口,2023-03-06,9257
3128,昇銳,13,6,7,凱基-林口,2023-03-06,9257
8016,矽創,10,3,7,凱基-林口,2023-03-06,9257
2371,大同,7,1,6,凱基-林口,2023-03-06,9257
3006,晶豪科,8,2,6,凱基-林口,2023-03-06,9257
3322,建舜電,6,0,6,凱基-林口,2023-03-06,9257
5603,陸海,6,0,6,凱基-林口,2023-03-06,9257
2002,中鋼,7,1,6,凱基-林口,2023-03-06,9257
00891,中信關鍵半導體,10,5,5,凱基-林口,2023-03-06,9257
00673R,期元大S＆P原油反1,5,0,5,凱基-林口,2023-03-06,9257
00894,中信小資高價30,10,5,5,凱基-林口,2023-03-06,9257
1539,巨庭,7,2,5,凱基-林口,2023-03-06,9257
3013,晟銘電,525,118,407,凱基-林口,2023-03-07,9257
2495,普安,143,10,133,凱基-林口,2023-03-07,9257
00637L,元大滬深300正2,101,2,99,凱基-林口,2023-03-07,9257
2614,東森,80,10,70,凱基-林口,2023-03-07,9257
3149,正達,50,0,50,凱基-林口,2023-03-07,9257
6139,亞翔,37,0,37,凱基-林口,2023-03-07,9257
00772B,中信高評級公司債,30,0,30,凱基-林口,2023-03-07,9257
4960,誠美材,30,0,30,凱基-林口,2023-03-07,9257
4977,眾達-KY,24,1,23,凱基-林口,2023-03-07,9257
5258,虹堡,24,2,22,凱基-林口,2023-03-07,9257
4541,晟田,20,0,20,凱基-林口,2023-03-07,9257
6233,旺玖,20,0,20,凱基-林口,2023-03-07,9257
8249,菱光,20,0,20,凱基-林口,2023-03-07,9257
3664,安瑞-KY,19,0,19,凱基-林口,2023-03-07,9257
4967,十銓,30,11,19,凱基-林口,2023-03-07,9257
2867,三商壽,21,3,18,凱基-林口,2023-03-07,9257
00680L,元大美債20正2,15,0,15,凱基-林口,2023-03-07,9257
4739,康普,14,0,14,凱基-林口,2023-03-07,9257
6104,創惟,13,1,12,凱基-林口,2023-03-07,9257
6548,長科*,15,3,12,凱基-林口,2023-03-07,9257
2618,長榮航,21,10,11,凱基-林口,2023-03-07,9257
2344,華邦電,11,0,11,凱基-林口,2023-03-07,9257
3552,同致,29,18,11,凱基-林口,2023-03-07,9257
1108,幸福,10,0,10,凱基-林口,2023-03-07,9257
1101,台泥,13,3,10,凱基-林口,2023-03-07,9257
2208,台船,10,0,10,凱基-林口,2023-03-07,9257
2312,金寶,10,0,10,凱基-林口,2023-03-07,9257
2634,漢翔,12,2,10,凱基-林口,2023-03-07,9257
2881,富邦金,10,0,10,凱基-林口,2023-03-07,9257
3027,盛達,10,0,10,凱基-林口,2023-03-07,9257
6015,宏遠證,10,0,10,凱基-林口,2023-03-07,9257
6122,擎邦,10,0,10,凱基-林口,2023-03-07,9257
6175,立敦,10,0,10,凱基-林口,2023-03-07,9257
6265,方土昶,10,0,10,凱基-林口,2023-03-07,9257
2482,連宇,31,22,9,凱基-林口,2023-03-07,9257
4906,正文,10,1,9,凱基-林口,2023-03-07,9257
6279,胡連,10,1,9,凱基-林口,2023-03-07,9257
2486,一詮,12,4,8,凱基-林口,2023-03-07,9257
2610,華航,10,2,8,凱基-林口,2023-03-07,9257
2845,遠東銀,8,0,8,凱基-林口,2023-03-07,9257
3056,富華新,8,0,8,凱基-林口,2023-03-07,9257
3211,順達,8,0,8,凱基-林口,2023-03-07,9257
8222,寶一,10,2,8,凱基-林口,2023-03-07,9257
1708,東鹼,7,0,7,凱基-林口,2023-03-07,9257
4919,新唐,30,23,7,凱基-林口,2023-03-07,9257
4968,立積,10,3,7,凱基-林口,2023-03-07,9257
6472,保瑞,8,1,7,凱基-林口,2023-03-07,9257
00679B,元大美債20年,6,0,6,凱基-林口,2023-03-07,9257
1524,耿鼎,6,0,6,凱基-林口,2023-03-07,9257
2455,全新,6,0,6,凱基-林口,2023-03-07,9257
3013,晟銘電,135,19,116,凱基-林口,2023-03-08,9257
1524,耿鼎,65,3,62,凱基-林口,2023-03-08,9257
00713,元大台灣高息低波,55,0,55,凱基-林口,2023-03-08,9257
00671R,富邦NASDAQ反1,48,0,48,凱基-林口,2023-03-08,9257
00878,國泰永續高股息,63,18,45,凱基-林口,2023-03-08,9257
00632R,元大台灣50反1,45,0,45,凱基-林口,2023-03-08,9257
3481,群創,49,11,38,凱基-林口,2023-03-08,9257
00669R,國泰美國道瓊反1,35,0,35,凱基-林口,2023-03-08,9257
00673R,期元大S＆P原油反1,35,0,35,凱基-林口,2023-03-08,9257
1584,精剛,34,0,34,凱基-林口,2023-03-08,9257
00637L,元大滬深300正2,34,0,34,凱基-林口,2023-03-08,9257
2603,長榮,31,1,30,凱基-林口,2023-03-08,9257
2498,宏達電,30,1,29,凱基-林口,2023-03-08,9257
2883,凱基金,28,0,28,凱基-林口,2023-03-08,9257
1605,華新,34,11,23,凱基-林口,2023-03-08,9257
5425,台半,27,4,23,凱基-林口,2023-03-08,9257
1503,士電,21,0,21,凱基-林口,2023-03-08,9257
4915,致伸,23,2,21,凱基-林口,2023-03-08,9257
3710,連展投控,23,3,20,凱基-林口,2023-03-08,9257
4114,健喬,20,0,20,凱基-林口,2023-03-08,9257
5230,雷笛克光學,20,0,20,凱基-林口,2023-03-08,9257
2609,陽明,39,20,19,凱基-林口,2023-03-08,9257
2455,全新,22,3,19,凱基-林口,2023-03-08,9257
2484,希華,20,1,19,凱基-林口,2023-03-08,9257
2897,王道銀行,20,1,19,凱基-林口,2023-03-08,9257
6235,華孚,74,55,19,凱基-林口,2023-03-08,9257
1504,東元,71,53,18,凱基-林口,2023-03-08,9257
3419,譁裕,18,0,18,凱基-林口,2023-03-08,9257
3004,豐達科,21,3,18,凱基-林口,2023-03-08,9257
4739,康普,19,1,18,凱基-林口,2023-03-08,9257
6190,萬泰科,21,3,18,凱基-林口,2023-03-08,9257
00885,富邦越南,17,0,17,凱基-林口,2023-03-08,9257
1701,中化,17,0,17,凱基-林口,2023-03-08,9257
8069,元太,23,6,17,凱基-林口,2023-03-08,9257
6531,愛普*,23,7,16,凱基-林口,2023-03-08,9257
2634,漢翔,85,70,15,凱基-林口,2023-03-08,9257
00715L,期街口布蘭特正2,15,0,15,凱基-林口,2023-03-08,9257
1339,昭輝,15,0,15,凱基-林口,2023-03-08,9257
3128,昇銳,21,6,15,凱基-林口,2023-03-08,9257
3617,碩天,15,0,15,凱基-林口,2023-03-08,9257
3664,安瑞-KY,14,0,14,凱基-林口,2023-03-08,9257
3673,TPK-KY,14,0,14,凱基-林口,2023-03-08,9257
3093,港建*,35,22,13,凱基-林口,2023-03-08,9257
0056,元大高股息,15,2,13,凱基-林口,2023-03-08,9257
00712,復華富時不動產,12,0,12,凱基-林口,2023-03-08,9257
3362,先進光,28,17,11,凱基-林口,2023-03-08,9257
5608,四維航,13,2,11,凱基-林口,2023-03-08,9257
2614,東森,10,0,10,凱基-林口,2023-03-08,9257
00633L,富邦上証正2,10,0,10,凱基-林口,2023-03-08,9257
2014,中鴻,10,0,10,凱基-林口,2023-03-08,9257
3481,群創,151,0,151,凱基-林口,2023-03-09,9257
2888,新光金,142,0,142,凱基-林口,2023-03-09,9257
2614,東森,89,0,89,凱基-林口,2023-03-09,9257
2409,友達,95,15,80,凱基-林口,2023-03-09,9257
1513,中興電,94,27,67,凱基-林口,2023-03-09,9257
6116,彩晶,61,0,61,凱基-林口,2023-03-09,9257
2618,長榮航,118,60,58,凱基-林口,2023-03-09,9257
6290,良維,52,2,50,凱基-林口,2023-03-09,9257
2344,華邦電,39,2,37,凱基-林口,2023-03-09,9257
2884,玉山金,36,0,36,凱基-林口,2023-03-09,9257
2402,毅嘉,41,9,32,凱基-林口,2023-03-09,9257
3576,聯合再生,31,0,31,凱基-林口,2023-03-09,9257
2317,鴻海,34,3,31,凱基-林口,2023-03-09,9257
1618,合機,29,0,29,凱基-林口,2023-03-09,9257
3047,訊舟,42,14,28,凱基-林口,2023-03-09,9257
00632R,元大台灣50反1,28,2,26,凱基-林口,2023-03-09,9257
6104,創惟,28,3,25,凱基-林口,2023-03-09,9257
2359,所羅門,31,7,24,凱基-林口,2023-03-09,9257
1314,中石化,33,10,23,凱基-林口,2023-03-09,9257
2486,一詮,36,13,23,凱基-林口,2023-03-09,9257
3037,欣興,30,7,23,凱基-林口,2023-03-09,9257
2371,大同,23,1,22,凱基-林口,2023-03-09,9257
2484,希華,21,0,21,凱基-林口,2023-03-09,9257
2890,永豐金,21,0,21,凱基-林口,2023-03-09,9257
3664,安瑞-KY,21,0,21,凱基-林口,2023-03-09,9257
1455,集盛,20,0,20,凱基-林口,2023-03-09,9257
2376,技嘉,21,1,20,凱基-林口,2023-03-09,9257
2855,統一證,20,0,20,凱基-林口,2023-03-09,9257
3055,蔚華科,20,0,20,凱基-林口,2023-03-09,9257
3666,光耀,20,0,20,凱基-林口,2023-03-09,9257
4977,眾達-KY,55,35,20,凱基-林口,2023-03-09,9257
9105,泰金寶-DR,20,0,20,凱基-林口,2023-03-09,9257
4163,鐿鈦,55,36,19,凱基-林口,2023-03-09,9257
6443,元晶,26,8,18,凱基-林口,2023-03-09,9257
00712,復華富時不動產,17,0,17,凱基-林口,2023-03-09,9257
6129,普誠,23,6,17,凱基-林口,2023-03-09,9257
2880,華南金,16,0,16,凱基-林口,2023-03-09,9257
1326,台化,15,0,15,凱基-林口,2023-03-09,9257
3689,湧德,15,0,15,凱基-林口,2023-03-09,9257
5425,台半,35,20,15,凱基-林口,2023-03-09,9257
8933,愛地雅,15,0,15,凱基-林口,2023-03-09,9257
4164,承業醫,14,0,14,凱基-林口,2023-03-09,9257
6282,康舒,19,6,13,凱基-林口,2023-03-09,9257
2002,中鋼,13,0,13,凱基-林口,2023-03-09,9257
2330,台積電,14,2,12,凱基-林口,2023-03-09,9257
5009,榮剛,22,10,12,凱基-林口,2023-03-09,9257
2328,廣宇,13,1,12,凱基-林口,2023-03-09,9257
2201,裕隆,14,3,11,凱基-林口,2023-03-09,9257
1560,中砂,11,0,11,凱基-林口,2023-03-09,9257
2405,輔信,11,0,11,凱基-林口,2023-03-09,9257
00632R,元大台灣50反1,306,50,256,凱基-林口,2023-03-10,9257
2402,毅嘉,273,38,235,凱基-林口,2023-03-10,9257
2609,陽明,352,125,227,凱基-林口,2023-03-10,9257
2610,華航,226,27,199,凱基-林口,2023-03-10,9257
1504,東元,179,4,175,凱基-林口,2023-03-10,9257
2614,東森,147,1,146,凱基-林口,2023-03-10,9257
3576,聯合再生,123,0,123,凱基-林口,2023-03-10,9257
00713,元大台灣高息低波,94,0,94,凱基-林口,2023-03-10,9257
00720B,元大投資級公司債,93,0,93,凱基-林口,2023-03-10,9257
3706,神達,56,1,55,凱基-林口,2023-03-10,9257
00671R,富邦NASDAQ反1,41,0,41,凱基-林口,2023-03-10,9257
2883,凱基金,50,15,35,凱基-林口,2023-03-10,9257
2634,漢翔,34,0,34,凱基-林口,2023-03-10,9257
3013,晟銘電,51,18,33,凱基-林口,2023-03-10,9257
3037,欣興,32,0,32,凱基-林口,2023-03-10,9257
8097,常珵,30,0,30,凱基-林口,2023-03-10,9257
3664,安瑞-KY,28,0,28,凱基-林口,2023-03-10,9257
00712,復華富時不動產,25,0,25,凱基-林口,2023-03-10,9257
6548,長科*,32,8,24,凱基-林口,2023-03-10,9257
00637L,元大滬深300正2,24,3,21,凱基-林口,2023-03-10,9257
00641R,富邦日本反1,20,0,20,凱基-林口,2023-03-10,9257
2481,強茂,20,0,20,凱基-林口,2023-03-10,9257
8069,元太,27,8,19,凱基-林口,2023-03-10,9257
00715L,期街口布蘭特正2,19,0,19,凱基-林口,2023-03-10,9257
00923,群益台ESG低碳50,19,0,19,凱基-林口,2023-03-10,9257
3624,光頡,22,4,18,凱基-林口,2023-03-10,9257
9933,中鼎,17,0,17,凱基-林口,2023-03-10,9257
2867,三商壽,16,0,16,凱基-林口,2023-03-10,9257
2882,國泰金,16,1,15,凱基-林口,2023-03-10,9257
2845,遠東銀,20,5,15,凱基-林口,2023-03-10,9257
3264,欣銓,19,5,14,凱基-林口,2023-03-10,9257
5425,台半,48,34,14,凱基-林口,2023-03-10,9257
6770,力積電,16,2,14,凱基-林口,2023-03-10,9257
5880,合庫金,13,0,13,凱基-林口,2023-03-10,9257
2369,菱生,13,0,13,凱基-林口,2023-03-10,9257
3481,群創,13,0,13,凱基-林口,2023-03-10,9257
2498,宏達電,13,1,12,凱基-林口,2023-03-10,9257
6164,華興,12,0,12,凱基-林口,2023-03-10,9257
6799,來頡,12,0,12,凱基-林口,2023-03-10,9257
00900,富邦特選高股息30,11,0,11,凱基-林口,2023-03-10,9257
2812,台中銀,11,0,11,凱基-林口,2023-03-10,9257
2885,元大金,11,0,11,凱基-林口,2023-03-10,9257
3209,全科,11,0,11,凱基-林口,2023-03-10,9257
5009,榮剛,13,2,11,凱基-林口,2023-03-10,9257
5512,力麒,12,1,11,凱基-林口,2023-03-10,9257
2308,台達電,10,0,10,凱基-林口,2023-03-10,9257
1220,台榮,10,0,10,凱基-林口,2023-03-10,9257
1108,幸福,10,0,10,凱基-林口,2023-03-10,9257
00853B,統一美債10年Aa-,10,0,10,凱基-林口,2023-03-10,9257
2945,三商家購,10,0,10,凱基-林口,2023-03-10,9257
00632R,元大台灣50反1,260,139,121,凱基-林口,2023-03-13,9257
00878,國泰永續高股息,124,8,116,凱基-林口,2023-03-13,9257
5530,龍巖,85,0,85,凱基-林口,2023-03-13,9257
1514,亞力,82,0,82,凱基-林口,2023-03-13,9257
00713,元大台灣高息低波,68,0,68,凱基-林口,2023-03-13,9257
3236,千如,55,0,55,凱基-林口,2023-03-13,9257
3481,群創,71,19,52,凱基-林口,2023-03-13,9257
6226,光鼎,50,0,50,凱基-林口,2023-03-13,9257
2352,佳世達,47,1,46,凱基-林口,2023-03-13,9257
3576,聯合再生,90,50,40,凱基-林口,2023-03-13,9257
2880,華南金,31,0,31,凱基-林口,2023-03-13,9257
2883,凱基金,31,0,31,凱基-林口,2023-03-13,9257
2328,廣宇,30,0,30,凱基-林口,2023-03-13,9257
2402,毅嘉,158,133,25,凱基-林口,2023-03-13,9257
00712,復華富時不動產,27,3,24,凱基-林口,2023-03-13,9257
5512,力麒,24,0,24,凱基-林口,2023-03-13,9257
2634,漢翔,37,15,22,凱基-林口,2023-03-13,9257
4161,聿新科,21,0,21,凱基-林口,2023-03-13,9257
8097,常珵,20,0,20,凱基-林口,2023-03-13,9257
1101,台泥,26,6,20,凱基-林口,2023-03-13,9257
6139,亞翔,20,0,20,凱基-林口,2023-03-13,9257
2482,連宇,18,2,16,凱基-林口,2023-03-13,9257
1108,幸福,16,0,16,凱基-林口,2023-03-13,9257
6443,元晶,24,10,14,凱基-林口,2023-03-13,9257
9945,潤泰新,17,5,12,凱基-林口,2023-03-13,9257
2613,中櫃,12,0,12,凱基-林口,2023-03-13,9257
9902,台火,12,0,12,凱基-林口,2023-03-13,9257
8933,愛地雅,31,20,11,凱基-林口,2023-03-13,9257
2375,凱美,12,1,11,凱基-林口,2023-03-13,9257
2867,三商壽,11,0,11,凱基-林口,2023-03-13,9257
3491,昇達科,34,23,11,凱基-林口,2023-03-13,9257
1444,力麗,10,0,10,凱基-林口,2023-03-13,9257
3019,亞光,10,0,10,凱基-林口,2023-03-13,9257
3455,由田,10,0,10,凱基-林口,2023-03-13,9257
3548,兆利,10,0,10,凱基-林口,2023-03-13,9257
3564,其陽,10,0,10,凱基-林口,2023-03-13,9257
4960,誠美材,10,0,10,凱基-林口,2023-03-13,9257
6589,台康生技,10,0,10,凱基-林口,2023-03-13,9257
9105,泰金寶-DR,10,0,10,凱基-林口,2023-03-13,9257
2834,臺企銀,10,1,9,凱基-林口,2023-03-13,9257
2312,金寶,10,2,8,凱基-林口,2023-03-13,9257
2014,中鴻,10,2,8,凱基-林口,2023-03-13,9257
2338,光罩,8,0,8,凱基-林口,2023-03-13,9257
1540,喬福,7,0,7,凱基-林口,2023-03-13,9257
2851,中再保,7,0,7,凱基-林口,2023-03-13,9257
6282,康舒,7,0,7,凱基-林口,2023-03-13,9257
8349,�矬�,7,0,7,凱基-林口,2023-03-13,9257
3232,昱捷,6,0,6,凱基-林口,2023-03-13,9257
5009,榮剛,12,6,6,凱基-林口,2023-03-13,9257
00923,群益台ESG低碳50,6,0,6,凱基-林口,2023-03-13,9257
00680L,元大美債20正2,330,1,329,凱基-林口,2023-03-14,9257
00878,國泰永續高股息,173,0,173,凱基-林口,2023-03-14,9257
2027,大成鋼,155,34,121,凱基-林口,2023-03-14,9257
2614,東森,60,0,60,凱基-林口,2023-03-14,9257
00713,元大台灣高息低波,57,0,57,凱基-林口,2023-03-14,9257
6573,虹揚-KY,54,0,54,凱基-林口,2023-03-14,9257
3236,千如,100,48,52,凱基-林口,2023-03-14,9257
3706,神達,51,0,51,凱基-林口,2023-03-14,9257
2610,華航,53,2,51,凱基-林口,2023-03-14,9257
5530,龍巖,40,0,40,凱基-林口,2023-03-14,9257
1710,東聯,38,0,38,凱基-林口,2023-03-14,9257
00637L,元大滬深300正2,36,0,36,凱基-林口,2023-03-14,9257
1314,中石化,33,0,33,凱基-林口,2023-03-14,9257
2618,長榮航,53,20,33,凱基-林口,2023-03-14,9257
2891,中信金,32,1,31,凱基-林口,2023-03-14,9257
2457,飛宏,48,23,25,凱基-林口,2023-03-14,9257
00772B,中信高評級公司債,21,0,21,凱基-林口,2023-03-14,9257
6244,茂迪,43,22,21,凱基-林口,2023-03-14,9257
2030,彰源,20,0,20,凱基-林口,2023-03-14,9257
2484,希華,20,0,20,凱基-林口,2023-03-14,9257
2845,遠東銀,20,0,20,凱基-林口,2023-03-14,9257
2887,台新金,18,0,18,凱基-林口,2023-03-14,9257
2482,連宇,29,11,18,凱基-林口,2023-03-14,9257
2883,凱基金,44,26,18,凱基-林口,2023-03-14,9257
1513,中興電,17,0,17,凱基-林口,2023-03-14,9257
2885,元大金,16,0,16,凱基-林口,2023-03-14,9257
3037,欣興,18,3,15,凱基-林口,2023-03-14,9257
5512,力麒,20,6,14,凱基-林口,2023-03-14,9257
2881,富邦金,12,0,12,凱基-林口,2023-03-14,9257
00665L,富邦�琤肭磪囓�2,13,1,12,凱基-林口,2023-03-14,9257
1444,力麗,12,0,12,凱基-林口,2023-03-14,9257
00882,中信中國高股息,11,0,11,凱基-林口,2023-03-14,9257
00679B,元大美債20年,17,6,11,凱基-林口,2023-03-14,9257
00920,富邦ESG綠色電力,10,0,10,凱基-林口,2023-03-14,9257
00715L,期街口布蘭特正2,10,0,10,凱基-林口,2023-03-14,9257
2945,三商家購,10,0,10,凱基-林口,2023-03-14,9257
3024,憶聲,10,0,10,凱基-林口,2023-03-14,9257
3481,群創,19,9,10,凱基-林口,2023-03-14,9257
9945,潤泰新,10,0,10,凱基-林口,2023-03-14,9257
2888,新光金,12,2,10,凱基-林口,2023-03-14,9257
2303,聯電,47,38,9,凱基-林口,2023-03-14,9257
00642U,期元大S＆P石油,8,0,8,凱基-林口,2023-03-14,9257
00712,復華富時不動產,18,10,8,凱基-林口,2023-03-14,9257
2534,宏盛,8,0,8,凱基-林口,2023-03-14,9257
4164,承業醫,11,3,8,凱基-林口,2023-03-14,9257
8046,南電,8,0,8,凱基-林口,2023-03-14,9257
8105,凌巨,8,0,8,凱基-林口,2023-03-14,9257
5880,合庫金,8,0,8,凱基-林口,2023-03-14,9257
2609,陽明,38,31,7,凱基-林口,2023-03-14,9257
00907,永豐優息存股,7,0,7,凱基-林口,2023-03-14,9257
2614,東森,238,8,230,凱基-林口,2023-03-15,9257
1504,東元,164,31,133,凱基-林口,2023-03-15,9257
2027,大成鋼,133,4,129,凱基-林口,2023-03-15,9257
00713,元大台灣高息低波,104,0,104,凱基-林口,2023-03-15,9257
3706,神達,101,0,101,凱基-林口,2023-03-15,9257
8112,至上,86,1,85,凱基-林口,2023-03-15,9257
3236,千如,80,5,75,凱基-林口,2023-03-15,9257
2609,陽明,129,58,71,凱基-林口,2023-03-15,9257
1314,中石化,59,0,59,凱基-林口,2023-03-15,9257
1609,大亞,82,35,47,凱基-林口,2023-03-15,9257
2371,大同,45,0,45,凱基-林口,2023-03-15,9257
00878,國泰永續高股息,42,3,39,凱基-林口,2023-03-15,9257
2891,中信金,34,1,33,凱基-林口,2023-03-15,9257
2352,佳世達,32,0,32,凱基-林口,2023-03-15,9257
6244,茂迪,68,36,32,凱基-林口,2023-03-15,9257
2880,華南金,31,0,31,凱基-林口,2023-03-15,9257
00712,復華富時不動產,29,0,29,凱基-林口,2023-03-15,9257
8374,羅昇,30,2,28,凱基-林口,2023-03-15,9257
1512,瑞利,24,0,24,凱基-林口,2023-03-15,9257
6235,華孚,38,16,22,凱基-林口,2023-03-15,9257
00679B,元大美債20年,23,1,22,凱基-林口,2023-03-15,9257
00680L,元大美債20正2,20,0,20,凱基-林口,2023-03-15,9257
00632R,元大台灣50反1,20,0,20,凱基-林口,2023-03-15,9257
3048,益登,20,0,20,凱基-林口,2023-03-15,9257
5608,四維航,20,0,20,凱基-林口,2023-03-15,9257
6226,光鼎,20,0,20,凱基-林口,2023-03-15,9257
2359,所羅門,20,2,18,凱基-林口,2023-03-15,9257
2641,正德,17,0,17,凱基-林口,2023-03-15,9257
00642U,期元大S＆P石油,15,0,15,凱基-林口,2023-03-15,9257
8086,宏捷科,15,0,15,凱基-林口,2023-03-15,9257
8289,泰藝,14,0,14,凱基-林口,2023-03-15,9257
2884,玉山金,25,11,14,凱基-林口,2023-03-15,9257
2892,第一金,13,0,13,凱基-林口,2023-03-15,9257
2820,華票,13,0,13,凱基-林口,2023-03-15,9257
2201,裕隆,19,8,11,凱基-林口,2023-03-15,9257
2812,台中銀,11,0,11,凱基-林口,2023-03-15,9257
1477,聚陽,10,0,10,凱基-林口,2023-03-15,9257
2323,中環,10,0,10,凱基-林口,2023-03-15,9257
2349,錸德,10,0,10,凱基-林口,2023-03-15,9257
2376,技嘉,10,0,10,凱基-林口,2023-03-15,9257
2457,飛宏,79,69,10,凱基-林口,2023-03-15,9257
2498,宏達電,25,15,10,凱基-林口,2023-03-15,9257
5425,台半,26,16,10,凱基-林口,2023-03-15,9257
5512,力麒,10,0,10,凱基-林口,2023-03-15,9257
6116,彩晶,10,0,10,凱基-林口,2023-03-15,9257
6217,中探針,10,0,10,凱基-林口,2023-03-15,9257
1503,士電,10,1,9,凱基-林口,2023-03-15,9257
9945,潤泰新,8,0,8,凱基-林口,2023-03-15,9257
6664,群翊,8,0,8,凱基-林口,2023-03-15,9257
2409,友達,8,0,8,凱基-林口,2023-03-15,9257
00878,國泰永續高股息,119,6,113,凱基-林口,2023-03-16,9257
00713,元大台灣高息低波,112,6,106,凱基-林口,2023-03-16,9257
1710,東聯,104,0,104,凱基-林口,2023-03-16,9257
3481,群創,107,7,100,凱基-林口,2023-03-16,9257
1605,華新,107,8,99,凱基-林口,2023-03-16,9257
1314,中石化,102,5,97,凱基-林口,2023-03-16,9257
2883,凱基金,85,12,73,凱基-林口,2023-03-16,9257
2891,中信金,73,1,72,凱基-林口,2023-03-16,9257
6443,元晶,68,4,64,凱基-林口,2023-03-16,9257
6116,彩晶,65,2,63,凱基-林口,2023-03-16,9257
2834,臺企銀,114,54,60,凱基-林口,2023-03-16,9257
8097,常珵,50,0,50,凱基-林口,2023-03-16,9257
00665L,富邦�琤肭磪囓�2,49,0,49,凱基-林口,2023-03-16,9257
2884,玉山金,44,1,43,凱基-林口,2023-03-16,9257
2615,萬海,39,4,35,凱基-林口,2023-03-16,9257
2880,華南金,35,0,35,凱基-林口,2023-03-16,9257
2867,三商壽,35,0,35,凱基-林口,2023-03-16,9257
00642U,期元大S＆P石油,34,0,34,凱基-林口,2023-03-16,9257
2882,國泰金,33,0,33,凱基-林口,2023-03-16,9257
2312,金寶,30,0,30,凱基-林口,2023-03-16,9257
2603,長榮,49,21,28,凱基-林口,2023-03-16,9257
3062,建漢,27,0,27,凱基-林口,2023-03-16,9257
00715L,期街口布蘭特正2,24,0,24,凱基-林口,2023-03-16,9257
3236,千如,34,10,24,凱基-林口,2023-03-16,9257
9902,台火,24,0,24,凱基-林口,2023-03-16,9257
5880,合庫金,23,0,23,凱基-林口,2023-03-16,9257
2385,群光,25,2,23,凱基-林口,2023-03-16,9257
00671R,富邦NASDAQ反1,20,0,20,凱基-林口,2023-03-16,9257
2349,錸德,20,0,20,凱基-林口,2023-03-16,9257
6226,光鼎,20,0,20,凱基-林口,2023-03-16,9257
8050,廣積,20,0,20,凱基-林口,2023-03-16,9257
4161,聿新科,19,0,19,凱基-林口,2023-03-16,9257
8069,元太,34,18,16,凱基-林口,2023-03-16,9257
1524,耿鼎,17,1,16,凱基-林口,2023-03-16,9257
3564,其陽,17,1,16,凱基-林口,2023-03-16,9257
6477,安集,16,0,16,凱基-林口,2023-03-16,9257
9945,潤泰新,24,8,16,凱基-林口,2023-03-16,9257
2605,新興,15,0,15,凱基-林口,2023-03-16,9257
3704,合勤控,14,0,14,凱基-林口,2023-03-16,9257
2614,東森,16,3,13,凱基-林口,2023-03-16,9257
2890,永豐金,13,0,13,凱基-林口,2023-03-16,9257
8358,金居,14,1,13,凱基-林口,2023-03-16,9257
1560,中砂,12,0,12,凱基-林口,2023-03-16,9257
3027,盛達,21,9,12,凱基-林口,2023-03-16,9257
6672,騰輝電子-KY,12,0,12,凱基-林口,2023-03-16,9257
1444,力麗,12,0,12,凱基-林口,2023-03-16,9257
0056,元大高股息,34,23,11,凱基-林口,2023-03-16,9257
2845,遠東銀,11,0,11,凱基-林口,2023-03-16,9257
1707,葡萄王,10,0,10,凱基-林口,2023-03-16,9257
2367,燿華,10,0,10,凱基-林口,2023-03-16,9257
6443,元晶,235,42,193,凱基-林口,2023-03-17,9257
3481,群創,84,23,61,凱基-林口,2023-03-17,9257
00713,元大台灣高息低波,51,0,51,凱基-林口,2023-03-17,9257
2891,中信金,51,0,51,凱基-林口,2023-03-17,9257
6138,茂達,50,1,49,凱基-林口,2023-03-17,9257
00772B,中信高評級公司債,33,0,33,凱基-林口,2023-03-17,9257
2834,臺企銀,58,26,32,凱基-林口,2023-03-17,9257
2883,凱基金,31,0,31,凱基-林口,2023-03-17,9257
4953,緯軟,30,0,30,凱基-林口,2023-03-17,9257
00665L,富邦�琤肭磪囓�2,30,3,27,凱基-林口,2023-03-17,9257
1444,力麗,27,0,27,凱基-林口,2023-03-17,9257
00632R,元大台灣50反1,42,20,22,凱基-林口,2023-03-17,9257
8114,振樺電,20,0,20,凱基-林口,2023-03-17,9257
8289,泰藝,20,0,20,凱基-林口,2023-03-17,9257
2609,陽明,26,7,19,凱基-林口,2023-03-17,9257
8016,矽創,19,1,18,凱基-林口,2023-03-17,9257
00715L,期街口布蘭特正2,20,4,16,凱基-林口,2023-03-17,9257
2409,友達,13,0,13,凱基-林口,2023-03-17,9257
4906,正文,12,0,12,凱基-林口,2023-03-17,9257
1504,東元,20,9,11,凱基-林口,2023-03-17,9257
6182,合晶,14,3,11,凱基-林口,2023-03-17,9257
2884,玉山金,13,3,10,凱基-林口,2023-03-17,9257
8097,常珵,10,0,10,凱基-林口,2023-03-17,9257
00636,國泰中國A50,10,0,10,凱基-林口,2023-03-17,9257
2615,萬海,21,11,10,凱基-林口,2023-03-17,9257
2881,富邦金,11,1,10,凱基-林口,2023-03-17,9257
3016,嘉晶,10,0,10,凱基-林口,2023-03-17,9257
2027,大成鋼,9,0,9,凱基-林口,2023-03-17,9257
2376,技嘉,10,1,9,凱基-林口,2023-03-17,9257
3027,盛達,17,8,9,凱基-林口,2023-03-17,9257
00679B,元大美債20年,13,5,8,凱基-林口,2023-03-17,9257
4931,新盛力,8,0,8,凱基-林口,2023-03-17,9257
00637L,元大滬深300正2,7,0,7,凱基-林口,2023-03-17,9257
2892,第一金,11,4,7,凱基-林口,2023-03-17,9257
5483,中美晶,7,0,7,凱基-林口,2023-03-17,9257
5880,合庫金,7,1,6,凱基-林口,2023-03-17,9257
2617,台航,6,0,6,凱基-林口,2023-03-17,9257
2886,兆豐金,6,0,6,凱基-林口,2023-03-17,9257
6874,倍力,6,0,6,凱基-林口,2023-03-17,9257
4966,譜瑞-KY,8,2,6,凱基-林口,2023-03-17,9257
1513,中興電,12,6,6,凱基-林口,2023-03-17,9257
1101,台泥,5,0,5,凱基-林口,2023-03-17,9257
1517,利奇,5,0,5,凱基-林口,2023-03-17,9257
1810,和成,5,0,5,凱基-林口,2023-03-17,9257
2201,裕隆,5,0,5,凱基-林口,2023-03-17,9257
2328,廣宇,5,0,5,凱基-林口,2023-03-17,9257
2412,中華電,5,0,5,凱基-林口,2023-03-17,9257
4510,高鋒,5,0,5,凱基-林口,2023-03-17,9257
6776,展�眥篕�,5,0,5,凱基-林口,2023-03-17,9257
6271,同欣電,4,0,4,凱基-林口,2023-03-17,9257
2845,遠東銀,115,5,110,凱基-林口,2023-03-20,9257
2812,台中銀,100,0,100,凱基-林口,2023-03-20,9257
6129,普誠,99,0,99,凱基-林口,2023-03-20,9257
3481,群創,70,7,63,凱基-林口,2023-03-20,9257
2481,強茂,114,53,61,凱基-林口,2023-03-20,9257
00878,國泰永續高股息,43,1,42,凱基-林口,2023-03-20,9257
9945,潤泰新,45,5,40,凱基-林口,2023-03-20,9257
2406,國碩,33,0,33,凱基-林口,2023-03-20,9257
00632R,元大台灣50反1,20,0,20,凱基-林口,2023-03-20,9257
6139,亞翔,20,0,20,凱基-林口,2023-03-20,9257
1605,華新,20,1,19,凱基-林口,2023-03-20,9257
9951,皇田,19,0,19,凱基-林口,2023-03-20,9257
00637L,元大滬深300正2,23,5,18,凱基-林口,2023-03-20,9257
2645,長榮航太,18,0,18,凱基-林口,2023-03-20,9257
2376,技嘉,21,4,17,凱基-林口,2023-03-20,9257
2884,玉山金,16,0,16,凱基-林口,2023-03-20,9257
00772B,中信高評級公司債,15,0,15,凱基-林口,2023-03-20,9257
4161,聿新科,15,0,15,凱基-林口,2023-03-20,9257
5452,佶優,15,0,15,凱基-林口,2023-03-20,9257
3038,全台,13,0,13,凱基-林口,2023-03-20,9257
3027,盛達,49,37,12,凱基-林口,2023-03-20,9257
8210,勤誠,12,0,12,凱基-林口,2023-03-20,9257
00642U,期元大S＆P石油,12,0,12,凱基-林口,2023-03-20,9257
0056,元大高股息,13,1,12,凱基-林口,2023-03-20,9257
2890,永豐金,24,12,12,凱基-林口,2023-03-20,9257
4533,協易機,12,0,12,凱基-林口,2023-03-20,9257
4164,承業醫,15,4,11,凱基-林口,2023-03-20,9257
5289,宜鼎,11,0,11,凱基-林口,2023-03-20,9257
6477,安集,11,0,11,凱基-林口,2023-03-20,9257
00923,群益台ESG低碳50,10,0,10,凱基-林口,2023-03-20,9257
3046,建��,10,0,10,凱基-林口,2023-03-20,9257
1444,力麗,10,0,10,凱基-林口,2023-03-20,9257
2892,第一金,10,0,10,凱基-林口,2023-03-20,9257
4763,材料-KY,22,12,10,凱基-林口,2023-03-20,9257
2882,國泰金,10,0,10,凱基-林口,2023-03-20,9257
1519,華城,17,8,9,凱基-林口,2023-03-20,9257
2353,宏��,11,2,9,凱基-林口,2023-03-20,9257
6127,九豪,9,0,9,凱基-林口,2023-03-20,9257
5880,合庫金,8,0,8,凱基-林口,2023-03-20,9257
3048,益登,8,0,8,凱基-林口,2023-03-20,9257
8936,國統,11,3,8,凱基-林口,2023-03-20,9257
4966,譜瑞-KY,7,0,7,凱基-林口,2023-03-20,9257
8926,台汽電,7,0,7,凱基-林口,2023-03-20,9257
2888,新光金,11,5,6,凱基-林口,2023-03-20,9257
8929,富堡,6,0,6,凱基-林口,2023-03-20,9257
6547,高端疫苗,6,0,6,凱基-林口,2023-03-20,9257
2471,資通,6,1,5,凱基-林口,2023-03-20,9257
4119,旭富,5,0,5,凱基-林口,2023-03-20,9257
1310,台苯,5,0,5,凱基-林口,2023-03-20,9257
00885,富邦越南,5,0,5,凱基-林口,2023-03-20,9257
00632R,元大台灣50反1,95,0,95,凱基-林口,2023-03-21,9257
6443,元晶,166,109,57,凱基-林口,2023-03-21,9257
1504,東元,62,20,42,凱基-林口,2023-03-21,9257
2495,普安,29,0,29,凱基-林口,2023-03-21,9257
1513,中興電,30,8,22,凱基-林口,2023-03-21,9257
2347,聯強,21,0,21,凱基-林口,2023-03-21,9257
1319,東陽,22,1,21,凱基-林口,2023-03-21,9257
00885,富邦越南,21,0,21,凱基-林口,2023-03-21,9257
5258,虹堡,24,3,21,凱基-林口,2023-03-21,9257
2610,華航,19,0,19,凱基-林口,2023-03-21,9257
6116,彩晶,20,2,18,凱基-林口,2023-03-21,9257
1519,華城,42,25,17,凱基-林口,2023-03-21,9257
2444,兆勁,20,3,17,凱基-林口,2023-03-21,9257
2883,凱基金,17,0,17,凱基-林口,2023-03-21,9257
4533,協易機,17,0,17,凱基-林口,2023-03-21,9257
3005,神基,16,0,16,凱基-林口,2023-03-21,9257
6133,金橋,16,0,16,凱基-林口,2023-03-21,9257
8046,南電,16,1,15,凱基-林口,2023-03-21,9257
00900,富邦特選高股息30,14,0,14,凱基-林口,2023-03-21,9257
2303,聯電,16,3,13,凱基-林口,2023-03-21,9257
3481,群創,23,10,13,凱基-林口,2023-03-21,9257
6219,富旺,13,0,13,凱基-林口,2023-03-21,9257
2845,遠東銀,12,0,12,凱基-林口,2023-03-21,9257
6649,台生材,12,0,12,凱基-林口,2023-03-21,9257
5880,合庫金,13,2,11,凱基-林口,2023-03-21,9257
2409,友達,22,11,11,凱基-林口,2023-03-21,9257
2609,陽明,12,1,11,凱基-林口,2023-03-21,9257
1524,耿鼎,63,52,11,凱基-林口,2023-03-21,9257
2388,威盛,16,5,11,凱基-林口,2023-03-21,9257
2369,菱生,10,0,10,凱基-林口,2023-03-21,9257
3049,精金,10,0,10,凱基-林口,2023-03-21,9257
3141,晶宏,15,5,10,凱基-林口,2023-03-21,9257
9945,潤泰新,16,7,9,凱基-林口,2023-03-21,9257
1720,生達,15,6,9,凱基-林口,2023-03-21,9257
4161,聿新科,9,0,9,凱基-林口,2023-03-21,9257
2360,致茂,8,0,8,凱基-林口,2023-03-21,9257
4770,上品,8,0,8,凱基-林口,2023-03-21,9257
6806,森崴能源,13,5,8,凱基-林口,2023-03-21,9257
00679B,元大美債20年,7,0,7,凱基-林口,2023-03-21,9257
2884,玉山金,10,3,7,凱基-林口,2023-03-21,9257
6531,愛普*,12,5,7,凱基-林口,2023-03-21,9257
2883B,凱基金乙特,6,0,6,凱基-林口,2023-03-21,9257
3027,盛達,25,19,6,凱基-林口,2023-03-21,9257
3228,金麗科,12,6,6,凱基-林口,2023-03-21,9257
3272,東碩,6,0,6,凱基-林口,2023-03-21,9257
8050,廣積,10,4,6,凱基-林口,2023-03-21,9257
00715L,期街口布蘭特正2,5,0,5,凱基-林口,2023-03-21,9257
1802,台玻,5,0,5,凱基-林口,2023-03-21,9257
2101,南港,5,0,5,凱基-林口,2023-03-21,9257
2106,建大,5,0,5,凱基-林口,2023-03-21,9257
2495,普安,276,10,266,凱基-林口,2023-03-22,9257
00665L,富邦�琤肭磪囓�2,200,1,199,凱基-林口,2023-03-22,9257
2845,遠東銀,54,0,54,凱基-林口,2023-03-22,9257
6443,元晶,55,2,53,凱基-林口,2023-03-22,9257
1504,東元,72,21,51,凱基-林口,2023-03-22,9257
2881,富邦金,51,1,50,凱基-林口,2023-03-22,9257
4960,誠美材,50,0,50,凱基-林口,2023-03-22,9257
00679B,元大美債20年,49,2,47,凱基-林口,2023-03-22,9257
2368,金像電,50,6,44,凱基-林口,2023-03-22,9257
6462,神盾,30,0,30,凱基-林口,2023-03-22,9257
2352,佳世達,40,13,27,凱基-林口,2023-03-22,9257
2450,神腦,25,0,25,凱基-林口,2023-03-22,9257
2457,飛宏,35,12,23,凱基-林口,2023-03-22,9257
8201,無敵,22,0,22,凱基-林口,2023-03-22,9257
1314,中石化,20,0,20,凱基-林口,2023-03-22,9257
1810,和成,20,0,20,凱基-林口,2023-03-22,9257
6109,亞元,20,0,20,凱基-林口,2023-03-22,9257
4919,新唐,18,1,17,凱基-林口,2023-03-22,9257
4915,致伸,16,0,16,凱基-林口,2023-03-22,9257
6182,合晶,43,27,16,凱基-林口,2023-03-22,9257
4123,晟德,15,0,15,凱基-林口,2023-03-22,9257
5452,佶優,12,0,12,凱基-林口,2023-03-22,9257
8936,國統,12,1,11,凱基-林口,2023-03-22,9257
3231,緯創,29,18,11,凱基-林口,2023-03-22,9257
00882,中信中國高股息,10,0,10,凱基-林口,2023-03-22,9257
1455,集盛,10,0,10,凱基-林口,2023-03-22,9257
2201,裕隆,12,2,10,凱基-林口,2023-03-22,9257
3710,連展投控,14,4,10,凱基-林口,2023-03-22,9257
4102,永日,10,0,10,凱基-林口,2023-03-22,9257
6649,台生材,10,0,10,凱基-林口,2023-03-22,9257
1513,中興電,9,0,9,凱基-林口,2023-03-22,9257
2481,強茂,10,1,9,凱基-林口,2023-03-22,9257
6219,富旺,9,0,9,凱基-林口,2023-03-22,9257
3013,晟銘電,40,32,8,凱基-林口,2023-03-22,9257
3093,港建*,10,2,8,凱基-林口,2023-03-22,9257
4979,華星光,8,0,8,凱基-林口,2023-03-22,9257
9945,潤泰新,13,5,8,凱基-林口,2023-03-22,9257
2834,臺企銀,7,0,7,凱基-林口,2023-03-22,9257
2436,偉詮電,7,0,7,凱基-林口,2023-03-22,9257
2915,潤泰全,21,14,7,凱基-林口,2023-03-22,9257
4306,炎洲,11,4,7,凱基-林口,2023-03-22,9257
5009,榮剛,7,0,7,凱基-林口,2023-03-22,9257
6282,康舒,7,0,7,凱基-林口,2023-03-22,9257
6531,愛普*,14,7,7,凱基-林口,2023-03-22,9257
2383,台光電,6,0,6,凱基-林口,2023-03-22,9257
3264,欣銓,6,0,6,凱基-林口,2023-03-22,9257
3545,敦泰,6,0,6,凱基-林口,2023-03-22,9257
3673,TPK-KY,6,0,6,凱基-林口,2023-03-22,9257
6235,華孚,6,0,6,凱基-林口,2023-03-22,9257
6782,視陽,8,2,6,凱基-林口,2023-03-22,9257
2883,凱基金,506,2,504,凱基-林口,2023-03-23,9257
2402,毅嘉,597,348,249,凱基-林口,2023-03-23,9257
2303,聯電,105,4,101,凱基-林口,2023-03-23,9257
2845,遠東銀,100,0,100,凱基-林口,2023-03-23,9257
2515,中工,60,10,50,凱基-林口,2023-03-23,9257
3090,日電貿,50,0,50,凱基-林口,2023-03-23,9257
8358,金居,40,0,40,凱基-林口,2023-03-23,9257
6233,旺玖,34,0,34,凱基-林口,2023-03-23,9257
00772B,中信高評級公司債,30,0,30,凱基-林口,2023-03-23,9257
6116,彩晶,30,0,30,凱基-林口,2023-03-23,9257
1504,東元,48,18,30,凱基-林口,2023-03-23,9257
3481,群創,23,1,22,凱基-林口,2023-03-23,9257
00632R,元大台灣50反1,40,20,20,凱基-林口,2023-03-23,9257
1614,三洋電,20,0,20,凱基-林口,2023-03-23,9257
2607,榮運,20,0,20,凱基-林口,2023-03-23,9257
2884,玉山金,21,1,20,凱基-林口,2023-03-23,9257
5425,台半,74,55,19,凱基-林口,2023-03-23,9257
3013,晟銘電,17,0,17,凱基-林口,2023-03-23,9257
6788,華景電,16,0,16,凱基-林口,2023-03-23,9257
3515,華擎,15,0,15,凱基-林口,2023-03-23,9257
4558,寶緯,15,0,15,凱基-林口,2023-03-23,9257
5608,四維航,15,0,15,凱基-林口,2023-03-23,9257
00679B,元大美債20年,14,0,14,凱基-林口,2023-03-23,9257
2027,大成鋼,13,0,13,凱基-林口,2023-03-23,9257
4977,眾達-KY,13,0,13,凱基-林口,2023-03-23,9257
8050,廣積,15,3,12,凱基-林口,2023-03-23,9257
6235,華孚,15,4,11,凱基-林口,2023-03-23,9257
4533,協易機,13,2,11,凱基-林口,2023-03-23,9257
4934,太極,11,0,11,凱基-林口,2023-03-23,9257
6143,振曜,11,0,11,凱基-林口,2023-03-23,9257
9907,統一實,10,0,10,凱基-林口,2023-03-23,9257
2376,技嘉,11,1,10,凱基-林口,2023-03-23,9257
2406,國碩,10,0,10,凱基-林口,2023-03-23,9257
2888,新光金,10,0,10,凱基-林口,2023-03-23,9257
3093,港建*,10,0,10,凱基-林口,2023-03-23,9257
3664,安瑞-KY,10,0,10,凱基-林口,2023-03-23,9257
4933,友輝,10,0,10,凱基-林口,2023-03-23,9257
6015,宏遠證,10,0,10,凱基-林口,2023-03-23,9257
6649,台生材,10,0,10,凱基-林口,2023-03-23,9257
8028,昇陽半導體,10,0,10,凱基-林口,2023-03-23,9257
8213,志超,10,0,10,凱基-林口,2023-03-23,9257
8215,明基材,10,0,10,凱基-林口,2023-03-23,9257
00680L,元大美債20正2,10,1,9,凱基-林口,2023-03-23,9257
2427,三商電,13,4,9,凱基-林口,2023-03-23,9257
3362,先進光,10,1,9,凱基-林口,2023-03-23,9257
3419,譁裕,11,2,9,凱基-林口,2023-03-23,9257
4906,正文,10,1,9,凱基-林口,2023-03-23,9257
6164,華興,10,1,9,凱基-林口,2023-03-23,9257
6196,帆宣,10,1,9,凱基-林口,2023-03-23,9257
3491,昇達科,28,20,8,凱基-林口,2023-03-23,9257
2402,毅嘉,811,215,596,凱基-林口,2023-03-24,9257
00665L,富邦�琤肭磪囓�2,230,5,225,凱基-林口,2023-03-24,9257
2845,遠東銀,65,0,65,凱基-林口,2023-03-24,9257
2515,中工,60,0,60,凱基-林口,2023-03-24,9257
2883,凱基金,35,0,35,凱基-林口,2023-03-24,9257
3231,緯創,59,25,34,凱基-林口,2023-03-24,9257
6245,立端,45,11,34,凱基-林口,2023-03-24,9257
2352,佳世達,33,1,32,凱基-林口,2023-03-24,9257
3024,憶聲,30,0,30,凱基-林口,2023-03-24,9257
3689,湧德,30,0,30,凱基-林口,2023-03-24,9257
4702,中美實,30,0,30,凱基-林口,2023-03-24,9257
2450,神腦,25,0,25,凱基-林口,2023-03-24,9257
2891,中信金,25,0,25,凱基-林口,2023-03-24,9257
2890,永豐金,24,0,24,凱基-林口,2023-03-24,9257
8289,泰藝,23,0,23,凱基-林口,2023-03-24,9257
6733,博晟生醫,22,1,21,凱基-林口,2023-03-24,9257
2812,台中銀,20,0,20,凱基-林口,2023-03-24,9257
6120,達運,20,0,20,凱基-林口,2023-03-24,9257
2392,正崴,25,8,17,凱基-林口,2023-03-24,9257
1309,台達化,20,4,16,凱基-林口,2023-03-24,9257
1785,光洋科,15,0,15,凱基-林口,2023-03-24,9257
4164,承業醫,15,0,15,凱基-林口,2023-03-24,9257
00679B,元大美債20年,12,0,12,凱基-林口,2023-03-24,9257
1402,遠東新,12,0,12,凱基-林口,2023-03-24,9257
8210,勤誠,12,0,12,凱基-林口,2023-03-24,9257
1611,中電,12,0,12,凱基-林口,2023-03-24,9257
8171,天宇,13,2,11,凱基-林口,2023-03-24,9257
3419,譁裕,11,0,11,凱基-林口,2023-03-24,9257
6411,晶焱,11,0,11,凱基-林口,2023-03-24,9257
00772B,中信高評級公司債,10,0,10,凱基-林口,2023-03-24,9257
00680L,元大美債20正2,10,0,10,凱基-林口,2023-03-24,9257
00664R,國泰臺灣加權反1,10,0,10,凱基-林口,2023-03-24,9257
1444,力麗,10,0,10,凱基-林口,2023-03-24,9257
2375,凱美,10,0,10,凱基-林口,2023-03-24,9257
2498,宏達電,11,1,10,凱基-林口,2023-03-24,9257
2915,潤泰全,10,0,10,凱基-林口,2023-03-24,9257
3051,力特,10,0,10,凱基-林口,2023-03-24,9257
3093,港建*,10,0,10,凱基-林口,2023-03-24,9257
6649,台生材,10,0,10,凱基-林口,2023-03-24,9257
2880,華南金,9,0,9,凱基-林口,2023-03-24,9257
00631L,元大台灣50正2,9,0,9,凱基-林口,2023-03-24,9257
3596,智易,8,0,8,凱基-林口,2023-03-24,9257
2609,陽明,8,1,7,凱基-林口,2023-03-24,9257
5907,大洋-KY,7,0,7,凱基-林口,2023-03-24,9257
6219,富旺,7,0,7,凱基-林口,2023-03-24,9257
9951,皇田,7,0,7,凱基-林口,2023-03-24,9257
4536,拓凱,8,2,6,凱基-林口,2023-03-24,9257
2471,資通,6,0,6,凱基-林口,2023-03-24,9257
3162,精確,6,0,6,凱基-林口,2023-03-24,9257
3363,上詮,6,0,6,凱基-林口,2023-03-24,9257
2402,毅嘉,272,142,130,凱基-林口,2023-03-27,9257
4532,瑞智,100,0,100,凱基-林口,2023-03-27,9257
4533,協易機,85,0,85,凱基-林口,2023-03-27,9257
3231,緯創,113,35,78,凱基-林口,2023-03-27,9257
1605,華新,72,2,70,凱基-林口,2023-03-27,9257
1504,東元,90,33,57,凱基-林口,2023-03-27,9257
3714,富采,56,2,54,凱基-林口,2023-03-27,9257
00898,國泰基因免疫革命,50,0,50,凱基-林口,2023-03-27,9257
8097,常珵,40,0,40,凱基-林口,2023-03-27,9257
2634,漢翔,47,12,35,凱基-林口,2023-03-27,9257
00902,中信電池及儲能,32,0,32,凱基-林口,2023-03-27,9257
1314,中石化,32,0,32,凱基-林口,2023-03-27,9257
2450,神腦,30,0,30,凱基-林口,2023-03-27,9257
6189,豐藝,25,0,25,凱基-林口,2023-03-27,9257
2482,連宇,26,2,24,凱基-林口,2023-03-27,9257
2890,永豐金,22,0,22,凱基-林口,2023-03-27,9257
2845,遠東銀,20,0,20,凱基-林口,2023-03-27,9257
3260,威剛,20,0,20,凱基-林口,2023-03-27,9257
2201,裕隆,20,1,19,凱基-林口,2023-03-27,9257
00680L,元大美債20正2,15,0,15,凱基-林口,2023-03-27,9257
4971,IET-KY,15,0,15,凱基-林口,2023-03-27,9257
6835,圓裕,15,0,15,凱基-林口,2023-03-27,9257
6244,茂迪,35,21,14,凱基-林口,2023-03-27,9257
3499,環天科,15,2,13,凱基-林口,2023-03-27,9257
4161,聿新科,21,8,13,凱基-林口,2023-03-27,9257
2388,威盛,13,1,12,凱基-林口,2023-03-27,9257
2867,三商壽,11,0,11,凱基-林口,2023-03-27,9257
1219,福壽,10,0,10,凱基-林口,2023-03-27,9257
2392,正崴,10,0,10,凱基-林口,2023-03-27,9257
2413,環科,10,0,10,凱基-林口,2023-03-27,9257
2511,太子,10,0,10,凱基-林口,2023-03-27,9257
4702,中美實,10,0,10,凱基-林口,2023-03-27,9257
6120,達運,10,0,10,凱基-林口,2023-03-27,9257
6271,同欣電,10,0,10,凱基-林口,2023-03-27,9257
6606,建德工業,10,0,10,凱基-林口,2023-03-27,9257
8088,品安,11,1,10,凱基-林口,2023-03-27,9257
3209,全科,10,0,10,凱基-林口,2023-03-27,9257
00631L,元大台灣50正2,10,0,10,凱基-林口,2023-03-27,9257
2330,台積電,11,2,9,凱基-林口,2023-03-27,9257
6245,立端,10,1,9,凱基-林口,2023-03-27,9257
8171,天宇,10,1,9,凱基-林口,2023-03-27,9257
3035,智原,22,13,9,凱基-林口,2023-03-27,9257
2303,聯電,9,1,8,凱基-林口,2023-03-27,9257
2498,宏達電,13,5,8,凱基-林口,2023-03-27,9257
3715,定穎投控,19,11,8,凱基-林口,2023-03-27,9257
4716,大立,8,0,8,凱基-林口,2023-03-27,9257
00922,國泰台灣領袖50,7,0,7,凱基-林口,2023-03-27,9257
2206,三陽工業,13,6,7,凱基-林口,2023-03-27,9257
3027,盛達,7,0,7,凱基-林口,2023-03-27,9257
3264,欣銓,6,0,6,凱基-林口,2023-03-27,9257
3231,緯創,355,33,322,凱基-林口,2023-03-28,9257
00888,永豐台灣ESG,145,0,145,凱基-林口,2023-03-28,9257
00922,國泰台灣領袖50,138,0,138,凱基-林口,2023-03-28,9257
2845,遠東銀,135,0,135,凱基-林口,2023-03-28,9257
1314,中石化,100,0,100,凱基-林口,2023-03-28,9257
6443,元晶,70,3,67,凱基-林口,2023-03-28,9257
2610,華航,67,25,42,凱基-林口,2023-03-28,9257
2342,茂矽,45,7,38,凱基-林口,2023-03-28,9257
8097,常珵,31,0,31,凱基-林口,2023-03-28,9257
6116,彩晶,30,0,30,凱基-林口,2023-03-28,9257
1605,華新,34,5,29,凱基-林口,2023-03-28,9257
4979,華星光,43,17,26,凱基-林口,2023-03-28,9257
00679B,元大美債20年,24,0,24,凱基-林口,2023-03-28,9257
2402,毅嘉,43,19,24,凱基-林口,2023-03-28,9257
6168,宏齊,22,0,22,凱基-林口,2023-03-28,9257
00772B,中信高評級公司債,21,0,21,凱基-林口,2023-03-28,9257
3037,欣興,24,4,20,凱基-林口,2023-03-28,9257
1312,國喬,20,0,20,凱基-林口,2023-03-28,9257
4532,瑞智,20,0,20,凱基-林口,2023-03-28,9257
1504,東元,19,2,17,凱基-林口,2023-03-28,9257
3362,先進光,17,0,17,凱基-林口,2023-03-28,9257
3035,智原,29,13,16,凱基-林口,2023-03-28,9257
6189,豐藝,15,0,15,凱基-林口,2023-03-28,9257
6285,啟��,17,3,14,凱基-林口,2023-03-28,9257
1810,和成,15,1,14,凱基-林口,2023-03-28,9257
4919,新唐,14,1,13,凱基-林口,2023-03-28,9257
3017,奇鋐,17,5,12,凱基-林口,2023-03-28,9257
2330,台積電,12,0,12,凱基-林口,2023-03-28,9257
2303,聯電,14,2,12,凱基-林口,2023-03-28,9257
5512,力麒,20,8,12,凱基-林口,2023-03-28,9257
6240,松崗,12,0,12,凱基-林口,2023-03-28,9257
8046,南電,13,2,11,凱基-林口,2023-03-28,9257
1217,愛之味,11,0,11,凱基-林口,2023-03-28,9257
2371,大同,13,2,11,凱基-林口,2023-03-28,9257
2478,大毅,12,1,11,凱基-林口,2023-03-28,9257
2014,中鴻,10,0,10,凱基-林口,2023-03-28,9257
2211,長榮鋼,10,0,10,凱基-林口,2023-03-28,9257
2486,一詮,10,0,10,凱基-林口,2023-03-28,9257
2542,興富發,10,0,10,凱基-林口,2023-03-28,9257
3011,今皓,10,0,10,凱基-林口,2023-03-28,9257
3169,亞信,11,1,10,凱基-林口,2023-03-28,9257
3209,全科,10,0,10,凱基-林口,2023-03-28,9257
4142,國光生,10,0,10,凱基-林口,2023-03-28,9257
4161,聿新科,10,0,10,凱基-林口,2023-03-28,9257
4533,協易機,10,0,10,凱基-林口,2023-03-28,9257
4702,中美實,10,0,10,凱基-林口,2023-03-28,9257
8213,志超,10,0,10,凱基-林口,2023-03-28,9257
2645,長榮航太,12,3,9,凱基-林口,2023-03-28,9257
6698,旭暉應材,10,1,9,凱基-林口,2023-03-28,9257
2603,長榮,10,2,8,凱基-林口,2023-03-28,9257
00753L,中信中國50正2,320,0,320,凱基-林口,2023-03-29,9257
2402,毅嘉,137,2,135,凱基-林口,2023-03-29,9257
2845,遠東銀,105,0,105,凱基-林口,2023-03-29,9257
00878,國泰永續高股息,75,1,74,凱基-林口,2023-03-29,9257
6288,聯嘉,60,0,60,凱基-林口,2023-03-29,9257
00692,富邦公司治理,41,0,41,凱基-林口,2023-03-29,9257
6226,光鼎,40,0,40,凱基-林口,2023-03-29,9257
6235,華孚,34,12,22,凱基-林口,2023-03-29,9257
2634,漢翔,23,1,22,凱基-林口,2023-03-29,9257
4161,聿新科,47,25,22,凱基-林口,2023-03-29,9257
2329,華泰,45,24,21,凱基-林口,2023-03-29,9257
00922,國泰台灣領袖50,19,0,19,凱基-林口,2023-03-29,9257
6189,豐藝,20,1,19,凱基-林口,2023-03-29,9257
8171,天宇,21,2,19,凱基-林口,2023-03-29,9257
2610,華航,26,8,18,凱基-林口,2023-03-29,9257
3624,光頡,17,0,17,凱基-林口,2023-03-29,9257
2615,萬海,31,16,15,凱基-林口,2023-03-29,9257
2867,三商壽,15,0,15,凱基-林口,2023-03-29,9257
4919,新唐,13,0,13,凱基-林口,2023-03-29,9257
00720B,元大投資級公司債,13,0,13,凱基-林口,2023-03-29,9257
3016,嘉晶,13,0,13,凱基-林口,2023-03-29,9257
3105,穩懋,18,6,12,凱基-林口,2023-03-29,9257
00772B,中信高評級公司債,12,0,12,凱基-林口,2023-03-29,9257
3715,定穎投控,77,65,12,凱基-林口,2023-03-29,9257
6531,愛普*,15,3,12,凱基-林口,2023-03-29,9257
00891,中信關鍵半導體,10,0,10,凱基-林口,2023-03-29,9257
1529,樂事綠能,10,0,10,凱基-林口,2023-03-29,9257
2342,茂矽,29,19,10,凱基-林口,2023-03-29,9257
2498,宏達電,27,17,10,凱基-林口,2023-03-29,9257
3447,展達,11,1,10,凱基-林口,2023-03-29,9257
6278,台表科,10,0,10,凱基-林口,2023-03-29,9257
8021,尖點,10,0,10,凱基-林口,2023-03-29,9257
2645,長榮航太,20,11,9,凱基-林口,2023-03-29,9257
6591,動力-KY,9,0,9,凱基-林口,2023-03-29,9257
6285,啟��,10,1,9,凱基-林口,2023-03-29,9257
00679B,元大美債20年,8,0,8,凱基-林口,2023-03-29,9257
1218,泰山,7,0,7,凱基-林口,2023-03-29,9257
3011,今皓,9,2,7,凱基-林口,2023-03-29,9257
5243,乙盛-KY,10,3,7,凱基-林口,2023-03-29,9257
6182,合晶,7,0,7,凱基-林口,2023-03-29,9257
6840,東研信超,7,0,7,凱基-林口,2023-03-29,9257
3035,智原,14,7,7,凱基-林口,2023-03-29,9257
00888,永豐台灣ESG,6,0,6,凱基-林口,2023-03-29,9257
1789,神隆,6,0,6,凱基-林口,2023-03-29,9257
3027,盛達,6,0,6,凱基-林口,2023-03-29,9257
8222,寶一,6,0,6,凱基-林口,2023-03-29,9257
8046,南電,7,2,5,凱基-林口,2023-03-29,9257
0056,元大高股息,6,1,5,凱基-林口,2023-03-29,9257
00725B,國泰投資級公司債,5,0,5,凱基-林口,2023-03-29,9257
1731,美吾華,5,0,5,凱基-林口,2023-03-29,9257
2402,毅嘉,286,5,281,凱基-林口,2023-03-30,9257
1314,中石化,35,3,32,凱基-林口,2023-03-30,9257
2890,永豐金,28,0,28,凱基-林口,2023-03-30,9257
2883,凱基金,28,0,28,凱基-林口,2023-03-30,9257
4979,華星光,36,10,26,凱基-林口,2023-03-30,9257
2753,八方雲集,24,0,24,凱基-林口,2023-03-30,9257
2342,茂矽,27,4,23,凱基-林口,2023-03-30,9257
6015,宏遠證,22,0,22,凱基-林口,2023-03-30,9257
6285,啟��,61,39,22,凱基-林口,2023-03-30,9257
2867,三商壽,140,120,20,凱基-林口,2023-03-30,9257
6138,茂達,21,1,20,凱基-林口,2023-03-30,9257
6226,光鼎,20,0,20,凱基-林口,2023-03-30,9257
2465,麗臺,19,0,19,凱基-林口,2023-03-30,9257
6531,愛普*,19,2,17,凱基-林口,2023-03-30,9257
1442,名軒,15,0,15,凱基-林口,2023-03-30,9257
1609,大亞,46,32,14,凱基-林口,2023-03-30,9257
2429,銘旺科,15,1,14,凱基-林口,2023-03-30,9257
2481,強茂,14,0,14,凱基-林口,2023-03-30,9257
4533,協易機,13,0,13,凱基-林口,2023-03-30,9257
5475,德宏,14,2,12,凱基-林口,2023-03-30,9257
3035,智原,13,2,11,凱基-林口,2023-03-30,9257
4746,台耀,11,0,11,凱基-林口,2023-03-30,9257
1218,泰山,10,0,10,凱基-林口,2023-03-30,9257
3189,景碩,22,12,10,凱基-林口,2023-03-30,9257
3447,展達,18,8,10,凱基-林口,2023-03-30,9257
5706,鳳凰,10,0,10,凱基-林口,2023-03-30,9257
6244,茂迪,13,3,10,凱基-林口,2023-03-30,9257
6715,嘉基,12,2,10,凱基-林口,2023-03-30,9257
2002,中鋼,10,0,10,凱基-林口,2023-03-30,9257
00679B,元大美債20年,9,0,9,凱基-林口,2023-03-30,9257
4128,中天,20,11,9,凱基-林口,2023-03-30,9257
6134,萬旭,12,3,9,凱基-林口,2023-03-30,9257
7402,邑錡,9,0,9,凱基-林口,2023-03-30,9257
4162,智擎,14,5,9,凱基-林口,2023-03-30,9257
1708,東鹼,8,0,8,凱基-林口,2023-03-30,9257
8215,明基材,8,0,8,凱基-林口,2023-03-30,9257
4968,立積,8,1,7,凱基-林口,2023-03-30,9257
1109,信大,7,0,7,凱基-林口,2023-03-30,9257
00885,富邦越南,7,0,7,凱基-林口,2023-03-30,9257
2834,臺企銀,7,0,7,凱基-林口,2023-03-30,9257
3213,茂訊,7,0,7,凱基-林口,2023-03-30,9257
5243,乙盛-KY,9,2,7,凱基-林口,2023-03-30,9257
8171,天宇,10,3,7,凱基-林口,2023-03-30,9257
6840,東研信超,6,0,6,凱基-林口,2023-03-30,9257
2882,國泰金,6,0,6,凱基-林口,2023-03-30,9257
3624,光頡,6,0,6,凱基-林口,2023-03-30,9257
00715L,期街口布蘭特正2,5,0,5,凱基-林口,2023-03-30,9257
00881,國泰台灣5G+,5,0,5,凱基-林口,2023-03-30,9257
00907,永豐優息存股,5,0,5,凱基-林口,2023-03-30,9257
2103,台橡,5,0,5,凱基-林口,2023-03-30,9257
2427,三商電,190,0,190,凱基-林口,2023-03-31,9257
1618,合機,155,0,155,凱基-林口,2023-03-31,9257
2606,裕民,29,2,27,凱基-林口,2023-03-31,9257
2731,雄獅,25,0,25,凱基-林口,2023-03-31,9257
2337,旺宏,67,44,23,凱基-林口,2023-03-31,9257
00680L,元大美債20正2,20,0,20,凱基-林口,2023-03-31,9257
1471,首利,20,0,20,凱基-林口,2023-03-31,9257
5521,工信,20,0,20,凱基-林口,2023-03-31,9257
1442,名軒,15,0,15,凱基-林口,2023-03-31,9257
2457,飛宏,19,4,15,凱基-林口,2023-03-31,9257
3005,神基,15,0,15,凱基-林口,2023-03-31,9257
8105,凌巨,15,0,15,凱基-林口,2023-03-31,9257
2890,永豐金,14,0,14,凱基-林口,2023-03-31,9257
4161,聿新科,14,0,14,凱基-林口,2023-03-31,9257
1611,中電,15,2,13,凱基-林口,2023-03-31,9257
6282,康舒,17,5,12,凱基-林口,2023-03-31,9257
2618,長榮航,11,0,11,凱基-林口,2023-03-31,9257
00632R,元大台灣50反1,10,0,10,凱基-林口,2023-03-31,9257
1314,中石化,10,0,10,凱基-林口,2023-03-31,9257
4702,中美實,10,0,10,凱基-林口,2023-03-31,9257
6733,博晟生醫,10,0,10,凱基-林口,2023-03-31,9257
00631L,元大台灣50正2,8,0,8,凱基-林口,2023-03-31,9257
4979,華星光,23,15,8,凱基-林口,2023-03-31,9257
6664,群翊,8,0,8,凱基-林口,2023-03-31,9257
6715,嘉基,13,5,8,凱基-林口,2023-03-31,9257
6770,力積電,13,5,8,凱基-林口,2023-03-31,9257
6829,千附精密,8,0,8,凱基-林口,2023-03-31,9257
6840,東研信超,8,0,8,凱基-林口,2023-03-31,9257
8088,品安,8,0,8,凱基-林口,2023-03-31,9257
00679B,元大美債20年,7,0,7,凱基-林口,2023-03-31,9257
3231,緯創,16,9,7,凱基-林口,2023-03-31,9257
6245,立端,11,4,7,凱基-林口,2023-03-31,9257
6285,啟��,62,55,7,凱基-林口,2023-03-31,9257
9912,偉聯,7,0,7,凱基-林口,2023-03-31,9257
2317,鴻海,7,1,6,凱基-林口,2023-03-31,9257
2340,台亞,6,0,6,凱基-林口,2023-03-31,9257
2356,英業達,7,1,6,凱基-林口,2023-03-31,9257
2436,偉詮電,8,2,6,凱基-林口,2023-03-31,9257
2547,日勝生,6,0,6,凱基-林口,2023-03-31,9257
3664,安瑞-KY,13,7,6,凱基-林口,2023-03-31,9257
6191,精成科,7,1,6,凱基-林口,2023-03-31,9257
2461,光群雷,5,0,5,凱基-林口,2023-03-31,9257
2612,中航,5,0,5,凱基-林口,2023-03-31,9257
3162,精確,6,1,5,凱基-林口,2023-03-31,9257
3264,欣銓,5,0,5,凱基-林口,2023-03-31,9257
5011,久陽,5,0,5,凱基-林口,2023-03-31,9257
5483,中美晶,5,0,5,凱基-林口,2023-03-31,9257
6111,大宇資,5,0,5,凱基-林口,2023-03-31,9257
6244,茂迪,5,0,5,凱基-林口,2023-03-31,9257
8255,朋程,6,1,5,凱基-林口,2023-03-31,9257
2303,聯電,362,4,358,凱基-林口,2023-04-06,9257
00680L,元大美債20正2,350,0,350,凱基-林口,2023-04-06,9257
2427,三商電,175,1,174,凱基-林口,2023-04-06,9257
2402,毅嘉,75,12,63,凱基-林口,2023-04-06,9257
1442,名軒,60,0,60,凱基-林口,2023-04-06,9257
6142,友勁,57,0,57,凱基-林口,2023-04-06,9257
00632R,元大台灣50反1,40,0,40,凱基-林口,2023-04-06,9257
00712,復華富時不動產,31,0,31,凱基-林口,2023-04-06,9257
2891,中信金,30,0,30,凱基-林口,2023-04-06,9257
1560,中砂,26,1,25,凱基-林口,2023-04-06,9257
00893,國泰智能電動車,26,2,24,凱基-林口,2023-04-06,9257
4968,立積,30,7,23,凱基-林口,2023-04-06,9257
2344,華邦電,24,2,22,凱基-林口,2023-04-06,9257
5309,系統電,25,3,22,凱基-林口,2023-04-06,9257
5258,虹堡,26,5,21,凱基-林口,2023-04-06,9257
1217,愛之味,20,0,20,凱基-林口,2023-04-06,9257
6285,啟��,43,26,17,凱基-林口,2023-04-06,9257
4161,聿新科,16,0,16,凱基-林口,2023-04-06,9257
2867,三商壽,116,101,15,凱基-林口,2023-04-06,9257
8069,元太,20,6,14,凱基-林口,2023-04-06,9257
6245,立端,14,0,14,凱基-林口,2023-04-06,9257
2027,大成鋼,13,0,13,凱基-林口,2023-04-06,9257
00637L,元大滬深300正2,13,0,13,凱基-林口,2023-04-06,9257
2546,根基,13,0,13,凱基-林口,2023-04-06,9257
00922,國泰台灣領袖50,12,0,12,凱基-林口,2023-04-06,9257
00673R,期元大S＆P原油反1,11,0,11,凱基-林口,2023-04-06,9257
2748,雲品,16,5,11,凱基-林口,2023-04-06,9257
00907,永豐優息存股,10,0,10,凱基-林口,2023-04-06,9257
00923,群益台ESG低碳50,10,0,10,凱基-林口,2023-04-06,9257
3231,緯創,42,32,10,凱基-林口,2023-04-06,9257
6015,宏遠證,10,0,10,凱基-林口,2023-04-06,9257
8110,華東,11,1,10,凱基-林口,2023-04-06,9257
00688L,國泰20年美債正2,10,1,9,凱基-林口,2023-04-06,9257
3038,全台,10,1,9,凱基-林口,2023-04-06,9257
4164,承業醫,8,0,8,凱基-林口,2023-04-06,9257
6782,視陽,8,0,8,凱基-林口,2023-04-06,9257
6840,東研信超,8,0,8,凱基-林口,2023-04-06,9257
8163,達方,8,0,8,凱基-林口,2023-04-06,9257
2615,萬海,12,4,8,凱基-林口,2023-04-06,9257
2605,新興,21,14,7,凱基-林口,2023-04-06,9257
3447,展達,13,6,7,凱基-林口,2023-04-06,9257
6485,點序,27,20,7,凱基-林口,2023-04-06,9257
2889,國票金,7,0,7,凱基-林口,2023-04-06,9257
8046,南電,6,0,6,凱基-林口,2023-04-06,9257
2603,長榮,6,0,6,凱基-林口,2023-04-06,9257
1529,樂事綠能,6,0,6,凱基-林口,2023-04-06,9257
3035,智原,19,13,6,凱基-林口,2023-04-06,9257
2353,宏��,10,4,6,凱基-林口,2023-04-06,9257
3675,德微,6,0,6,凱基-林口,2023-04-06,9257
4716,大立,6,0,6,凱基-林口,2023-04-06,9257
3231,緯創,126,7,119,凱基-林口,2023-04-07,9257
6443,元晶,110,12,98,凱基-林口,2023-04-07,9257
1442,名軒,70,0,70,凱基-林口,2023-04-07,9257
1314,中石化,56,0,56,凱基-林口,2023-04-07,9257
2402,毅嘉,77,21,56,凱基-林口,2023-04-07,9257
2484,希華,47,0,47,凱基-林口,2023-04-07,9257
2380,虹光,32,0,32,凱基-林口,2023-04-07,9257
8028,昇陽半導體,31,1,30,凱基-林口,2023-04-07,9257
8040,九暘,30,0,30,凱基-林口,2023-04-07,9257
2208,台船,28,0,28,凱基-林口,2023-04-07,9257
2867,三商壽,95,70,25,凱基-林口,2023-04-07,9257
5309,系統電,22,0,22,凱基-林口,2023-04-07,9257
3006,晶豪科,32,11,21,凱基-林口,2023-04-07,9257
5381,合正,16,0,16,凱基-林口,2023-04-07,9257
6278,台表科,16,0,16,凱基-林口,2023-04-07,9257
00632R,元大台灣50反1,15,0,15,凱基-林口,2023-04-07,9257
2436,偉詮電,16,1,15,凱基-林口,2023-04-07,9257
6235,華孚,100,87,13,凱基-林口,2023-04-07,9257
3707,漢磊,15,2,13,凱基-林口,2023-04-07,9257
2486,一詮,12,0,12,凱基-林口,2023-04-07,9257
6605,帝寶,12,0,12,凱基-林口,2023-04-07,9257
4953,緯軟,12,0,12,凱基-林口,2023-04-07,9257
1218,泰山,12,1,11,凱基-林口,2023-04-07,9257
1514,亞力,11,0,11,凱基-林口,2023-04-07,9257
2731,雄獅,11,0,11,凱基-林口,2023-04-07,9257
2388,威盛,17,7,10,凱基-林口,2023-04-07,9257
2023,燁輝,10,0,10,凱基-林口,2023-04-07,9257
2546,根基,10,0,10,凱基-林口,2023-04-07,9257
5289,宜鼎,10,0,10,凱基-林口,2023-04-07,9257
5529,鉅陞,10,0,10,凱基-林口,2023-04-07,9257
6245,立端,10,0,10,凱基-林口,2023-04-07,9257
2206,三陽工業,11,3,8,凱基-林口,2023-04-07,9257
2427,三商電,10,2,8,凱基-林口,2023-04-07,9257
6142,友勁,20,12,8,凱基-林口,2023-04-07,9257
1796,金穎生技,7,0,7,凱基-林口,2023-04-07,9257
6861,睿生光電,7,0,7,凱基-林口,2023-04-07,9257
6568,宏觀,6,0,6,凱基-林口,2023-04-07,9257
00712,復華富時不動產,74,68,6,凱基-林口,2023-04-07,9257
2027,大成鋼,6,0,6,凱基-林口,2023-04-07,9257
2201,裕隆,6,0,6,凱基-林口,2023-04-07,9257
2440,太空梭,6,0,6,凱基-林口,2023-04-07,9257
3032,偉訓,6,0,6,凱基-林口,2023-04-07,9257
3236,千如,6,0,6,凱基-林口,2023-04-07,9257
5227,立凱-KY,6,0,6,凱基-林口,2023-04-07,9257
6843,進典,12,6,6,凱基-林口,2023-04-07,9257
2603,長榮,9,3,6,凱基-林口,2023-04-07,9257
2889,國票金,6,0,6,凱基-林口,2023-04-07,9257
2367,燿華,5,0,5,凱基-林口,2023-04-07,9257
2547,日勝生,5,0,5,凱基-林口,2023-04-07,9257
2756,聯發國際,5,0,5,凱基-林口,2023-04-07,9257
4566,時碩工業,65,0,65,凱基-林口,2023-04-10,9257
4968,立積,90,31,59,凱基-林口,2023-04-10,9257
6152,百一,52,0,52,凱基-林口,2023-04-10,9257
5381,合正,40,0,40,凱基-林口,2023-04-10,9257
00679B,元大美債20年,40,2,38,凱基-林口,2023-04-10,9257
8028,昇陽半導體,28,0,28,凱基-林口,2023-04-10,9257
4128,中天,24,0,24,凱基-林口,2023-04-10,9257
00712,復華富時不動產,23,0,23,凱基-林口,2023-04-10,9257
2344,華邦電,51,28,23,凱基-林口,2023-04-10,9257
5531,鄉林,22,0,22,凱基-林口,2023-04-10,9257
6163,華電網,24,2,22,凱基-林口,2023-04-10,9257
3447,展達,23,2,21,凱基-林口,2023-04-10,9257
00713,元大台灣高息低波,20,0,20,凱基-林口,2023-04-10,9257
4977,眾達-KY,20,0,20,凱基-林口,2023-04-10,9257
5488,松普,20,0,20,凱基-林口,2023-04-10,9257
00900,富邦特選高股息30,17,0,17,凱基-林口,2023-04-10,9257
5258,虹堡,16,0,16,凱基-林口,2023-04-10,9257
1514,亞力,16,1,15,凱基-林口,2023-04-10,9257
6285,啟��,15,0,15,凱基-林口,2023-04-10,9257
4533,協易機,13,0,13,凱基-林口,2023-04-10,9257
00632R,元大台灣50反1,12,0,12,凱基-林口,2023-04-10,9257
2440,太空梭,12,0,12,凱基-林口,2023-04-10,9257
2605,新興,12,0,12,凱基-林口,2023-04-10,9257
3162,精確,12,0,12,凱基-林口,2023-04-10,9257
3260,威剛,13,1,12,凱基-林口,2023-04-10,9257
3711,日月光投控,11,0,11,凱基-林口,2023-04-10,9257
8926,台汽電,11,0,11,凱基-林口,2023-04-10,9257
3035,智原,11,1,10,凱基-林口,2023-04-10,9257
1506,正道,10,0,10,凱基-林口,2023-04-10,9257
1442,名軒,10,0,10,凱基-林口,2023-04-10,9257
00680L,元大美債20正2,10,0,10,凱基-林口,2023-04-10,9257
2406,國碩,10,0,10,凱基-林口,2023-04-10,9257
8261,富鼎,10,0,10,凱基-林口,2023-04-10,9257
6245,立端,10,0,10,凱基-林口,2023-04-10,9257
1101,台泥,10,1,9,凱基-林口,2023-04-10,9257
2409,友達,10,1,9,凱基-林口,2023-04-10,9257
2603,長榮,14,5,9,凱基-林口,2023-04-10,9257
6155,鈞寶,8,0,8,凱基-林口,2023-04-10,9257
6461,益得,8,0,8,凱基-林口,2023-04-10,9257
3715,定穎投控,10,3,7,凱基-林口,2023-04-10,9257
00888,永豐台灣ESG,7,0,7,凱基-林口,2023-04-10,9257
2609,陽明,8,1,7,凱基-林口,2023-04-10,9257
6123,上奇,7,0,7,凱基-林口,2023-04-10,9257
2206,三陽工業,8,2,6,凱基-林口,2023-04-10,9257
2408,南亞科,7,1,6,凱基-林口,2023-04-10,9257
3037,欣興,7,1,6,凱基-林口,2023-04-10,9257
3189,景碩,6,0,6,凱基-林口,2023-04-10,9257
3545,敦泰,11,5,6,凱基-林口,2023-04-10,9257
5457,宣德,6,0,6,凱基-林口,2023-04-10,9257
5529,鉅陞,6,0,6,凱基-林口,2023-04-10,9257
2402,毅嘉,66,6,60,凱基-林口,2023-04-11,9257
2303,聯電,60,1,59,凱基-林口,2023-04-11,9257
2867,三商壽,72,15,57,凱基-林口,2023-04-11,9257
00712,復華富時不動產,49,0,49,凱基-林口,2023-04-11,9257
1104,環泥,50,2,48,凱基-林口,2023-04-11,9257
3035,智原,37,4,33,凱基-林口,2023-04-11,9257
2457,飛宏,36,8,28,凱基-林口,2023-04-11,9257
8028,昇陽半導體,31,6,25,凱基-林口,2023-04-11,9257
2489,瑞軒,20,0,20,凱基-林口,2023-04-11,9257
1609,大亞,24,6,18,凱基-林口,2023-04-11,9257
00888,永豐台灣ESG,16,0,16,凱基-林口,2023-04-11,9257
00720B,元大投資級公司債,15,0,15,凱基-林口,2023-04-11,9257
1314,中石化,20,5,15,凱基-林口,2023-04-11,9257
5512,力麒,15,0,15,凱基-林口,2023-04-11,9257
4906,正文,15,1,14,凱基-林口,2023-04-11,9257
6223,旺矽,14,0,14,凱基-林口,2023-04-11,9257
6548,長科*,14,0,14,凱基-林口,2023-04-11,9257
2609,陽明,15,2,13,凱基-林口,2023-04-11,9257
2356,英業達,13,1,12,凱基-林口,2023-04-11,9257
2413,環科,12,0,12,凱基-林口,2023-04-11,9257
6182,合晶,11,0,11,凱基-林口,2023-04-11,9257
00632R,元大台灣50反1,10,0,10,凱基-林口,2023-04-11,9257
00680L,元大美債20正2,10,0,10,凱基-林口,2023-04-11,9257
1442,名軒,10,0,10,凱基-林口,2023-04-11,9257
2353,宏��,10,0,10,凱基-林口,2023-04-11,9257
2886,兆豐金,10,0,10,凱基-林口,2023-04-11,9257
3515,華擎,10,0,10,凱基-林口,2023-04-11,9257
5381,合正,10,0,10,凱基-林口,2023-04-11,9257
8358,金居,10,0,10,凱基-林口,2023-04-11,9257
9927,泰銘,10,0,10,凱基-林口,2023-04-11,9257
2492,華新科,9,0,9,凱基-林口,2023-04-11,9257
2617,台航,9,0,9,凱基-林口,2023-04-11,9257
6122,擎邦,11,2,9,凱基-林口,2023-04-11,9257
1319,東陽,8,0,8,凱基-林口,2023-04-11,9257
2027,大成鋼,8,0,8,凱基-林口,2023-04-11,9257
2208,台船,8,0,8,凱基-林口,2023-04-11,9257
5388,中磊,8,0,8,凱基-林口,2023-04-11,9257
5469,瀚宇博,13,5,8,凱基-林口,2023-04-11,9257
1108,幸福,7,0,7,凱基-林口,2023-04-11,9257
3049,精金,7,0,7,凱基-林口,2023-04-11,9257
4174,浩鼎,7,0,7,凱基-林口,2023-04-11,9257
4979,華星光,36,29,7,凱基-林口,2023-04-11,9257
5243,乙盛-KY,8,1,7,凱基-林口,2023-04-11,9257
6782,視陽,7,0,7,凱基-林口,2023-04-11,9257
1504,東元,55,49,6,凱基-林口,2023-04-11,9257
2421,建準,6,0,6,凱基-林口,2023-04-11,9257
3558,神準,18,12,6,凱基-林口,2023-04-11,9257
3714,富采,8,2,6,凱基-林口,2023-04-11,9257
00679B,元大美債20年,9,3,6,凱基-林口,2023-04-11,9257
2317,鴻海,5,0,5,凱基-林口,2023-04-11,9257
2402,毅嘉,414,69,345,凱基-林口,2023-04-12,9257
2498,宏達電,180,3,177,凱基-林口,2023-04-12,9257
2409,友達,100,0,100,凱基-林口,2023-04-12,9257
6156,松上,58,0,58,凱基-林口,2023-04-12,9257
2634,漢翔,72,16,56,凱基-林口,2023-04-12,9257
00878,國泰永續高股息,69,23,46,凱基-林口,2023-04-12,9257
1785,光洋科,40,0,40,凱基-林口,2023-04-12,9257
2457,飛宏,56,17,39,凱基-林口,2023-04-12,9257
5309,系統電,40,3,37,凱基-林口,2023-04-12,9257
2486,一詮,30,0,30,凱基-林口,2023-04-12,9257
3059,華晶科,31,2,29,凱基-林口,2023-04-12,9257
5488,松普,26,0,26,凱基-林口,2023-04-12,9257
0056,元大高股息,35,12,23,凱基-林口,2023-04-12,9257
00712,復華富時不動產,23,0,23,凱基-林口,2023-04-12,9257
1442,名軒,22,0,22,凱基-林口,2023-04-12,9257
2371,大同,23,2,21,凱基-林口,2023-04-12,9257
2484,希華,20,0,20,凱基-林口,2023-04-12,9257
5381,合正,20,0,20,凱基-林口,2023-04-12,9257
6288,聯嘉,20,0,20,凱基-林口,2023-04-12,9257
6691,洋基工程,20,1,19,凱基-林口,2023-04-12,9257
00692,富邦公司治理,18,0,18,凱基-林口,2023-04-12,9257
2233,宇隆,20,2,18,凱基-林口,2023-04-12,9257
2883,凱基金,45,28,17,凱基-林口,2023-04-12,9257
00888,永豐台灣ESG,15,0,15,凱基-林口,2023-04-12,9257
8183,精星,15,0,15,凱基-林口,2023-04-12,9257
4566,時碩工業,14,0,14,凱基-林口,2023-04-12,9257
9924,福興,14,0,14,凱基-林口,2023-04-12,9257
6160,欣技,18,6,12,凱基-林口,2023-04-12,9257
3037,欣興,13,1,12,凱基-林口,2023-04-12,9257
2376,技嘉,11,0,11,凱基-林口,2023-04-12,9257
6104,創惟,23,12,11,凱基-林口,2023-04-12,9257
2388,威盛,18,7,11,凱基-林口,2023-04-12,9257
1605,華新,13,3,10,凱基-林口,2023-04-12,9257
1506,正道,10,0,10,凱基-林口,2023-04-12,9257
2472,立隆電,10,0,10,凱基-林口,2023-04-12,9257
2495,普安,10,0,10,凱基-林口,2023-04-12,9257
5351,鈺創,10,0,10,凱基-林口,2023-04-12,9257
6026,福邦證,10,0,10,凱基-林口,2023-04-12,9257
6142,友勁,10,0,10,凱基-林口,2023-04-12,9257
8097,常珵,10,0,10,凱基-林口,2023-04-12,9257
8112,至上,10,0,10,凱基-林口,2023-04-12,9257
9907,統一實,10,0,10,凱基-林口,2023-04-12,9257
6196,帆宣,10,0,10,凱基-林口,2023-04-12,9257
00637L,元大滬深300正2,9,0,9,凱基-林口,2023-04-12,9257
4746,台耀,10,1,9,凱基-林口,2023-04-12,9257
4979,華星光,41,32,9,凱基-林口,2023-04-12,9257
6840,東研信超,9,0,9,凱基-林口,2023-04-12,9257
8069,元太,15,7,8,凱基-林口,2023-04-12,9257
2206,三陽工業,30,22,8,凱基-林口,2023-04-12,9257
3447,展達,8,0,8,凱基-林口,2023-04-12,9257
2515,中工,151,59,92,凱基-林口,2023-04-13,9257
4164,承業醫,93,20,73,凱基-林口,2023-04-13,9257
2392,正崴,60,1,59,凱基-林口,2023-04-13,9257
2201,裕隆,70,12,58,凱基-林口,2023-04-13,9257
00671R,富邦NASDAQ反1,54,0,54,凱基-林口,2023-04-13,9257
3231,緯創,56,5,51,凱基-林口,2023-04-13,9257
4916,事欣科,73,23,50,凱基-林口,2023-04-13,9257
3693,營邦,60,10,50,凱基-林口,2023-04-13,9257
4960,誠美材,40,0,40,凱基-林口,2023-04-13,9257
00878,國泰永續高股息,40,0,40,凱基-林口,2023-04-13,9257
9942,茂順,40,1,39,凱基-林口,2023-04-13,9257
00720B,元大投資級公司債,35,0,35,凱基-林口,2023-04-13,9257
00692,富邦公司治理,30,0,30,凱基-林口,2023-04-13,9257
00680L,元大美債20正2,30,0,30,凱基-林口,2023-04-13,9257
2313,華通,31,1,30,凱基-林口,2023-04-13,9257
2897,王道銀行,50,21,29,凱基-林口,2023-04-13,9257
00713,元大台灣高息低波,29,0,29,凱基-林口,2023-04-13,9257
00888,永豐台灣ESG,28,0,28,凱基-林口,2023-04-13,9257
00665L,富邦�琤肭磪囓�2,28,0,28,凱基-林口,2023-04-13,9257
00673R,期元大S＆P原油反1,25,0,25,凱基-林口,2023-04-13,9257
5009,榮剛,41,21,20,凱基-林口,2023-04-13,9257
00922,國泰台灣領袖50,19,0,19,凱基-林口,2023-04-13,9257
2845,遠東銀,18,0,18,凱基-林口,2023-04-13,9257
3711,日月光投控,24,6,18,凱基-林口,2023-04-13,9257
2330,台積電,19,1,18,凱基-林口,2023-04-13,9257
2609,陽明,19,4,15,凱基-林口,2023-04-13,9257
00923,群益台ESG低碳50,14,0,14,凱基-林口,2023-04-13,9257
2486,一詮,14,0,14,凱基-林口,2023-04-13,9257
3701,大眾控,13,0,13,凱基-林口,2023-04-13,9257
00712,復華富時不動產,12,0,12,凱基-林口,2023-04-13,9257
2498,宏達電,13,1,12,凱基-林口,2023-04-13,9257
1504,東元,80,70,10,凱基-林口,2023-04-13,9257
2323,中環,10,0,10,凱基-林口,2023-04-13,9257
3294,英濟,10,0,10,凱基-林口,2023-04-13,9257
5381,合正,10,0,10,凱基-林口,2023-04-13,9257
6198,瑞築,10,0,10,凱基-林口,2023-04-13,9257
6547,高端疫苗,10,0,10,凱基-林口,2023-04-13,9257
8112,至上,10,0,10,凱基-林口,2023-04-13,9257
00679B,元大美債20年,9,0,9,凱基-林口,2023-04-13,9257
2206,三陽工業,32,23,9,凱基-林口,2023-04-13,9257
8454,富邦媒,9,0,9,凱基-林口,2023-04-13,9257
1609,大亞,23,14,9,凱基-林口,2023-04-13,9257
2408,南亞科,10,1,9,凱基-林口,2023-04-13,9257
6477,安集,16,7,9,凱基-林口,2023-04-13,9257
1447,力鵬,8,0,8,凱基-林口,2023-04-13,9257
4167,松瑞藥,10,2,8,凱基-林口,2023-04-13,9257
4566,時碩工業,11,3,8,凱基-林口,2023-04-13,9257
6219,富旺,8,0,8,凱基-林口,2023-04-13,9257
6244,茂迪,9,1,8,凱基-林口,2023-04-13,9257
8938,明安,8,0,8,凱基-林口,2023-04-13,9257
2402,毅嘉,630,375,255,凱基-林口,2023-04-14,9257
2344,華邦電,215,6,209,凱基-林口,2023-04-14,9257
2614,東森,201,0,201,凱基-林口,2023-04-14,9257
00720B,元大投資級公司債,123,0,123,凱基-林口,2023-04-14,9257
2547,日勝生,101,0,101,凱基-林口,2023-04-14,9257
2515,中工,110,14,96,凱基-林口,2023-04-14,9257
00671R,富邦NASDAQ反1,90,0,90,凱基-林口,2023-04-14,9257
3231,緯創,84,33,51,凱基-林口,2023-04-14,9257
6285,啟��,86,36,50,凱基-林口,2023-04-14,9257
2303,聯電,49,19,30,凱基-林口,2023-04-14,9257
00679B,元大美債20年,25,0,25,凱基-林口,2023-04-14,9257
3481,群創,29,5,24,凱基-林口,2023-04-14,9257
6127,九豪,23,0,23,凱基-林口,2023-04-14,9257
1442,名軒,22,0,22,凱基-林口,2023-04-14,9257
3027,盛達,32,10,22,凱基-林口,2023-04-14,9257
2634,漢翔,108,86,22,凱基-林口,2023-04-14,9257
1810,和成,20,2,18,凱基-林口,2023-04-14,9257
3715,定穎投控,32,14,18,凱基-林口,2023-04-14,9257
4916,事欣科,17,0,17,凱基-林口,2023-04-14,9257
5009,榮剛,23,6,17,凱基-林口,2023-04-14,9257
4128,中天,17,0,17,凱基-林口,2023-04-14,9257
2457,飛宏,84,68,16,凱基-林口,2023-04-14,9257
4961,天鈺,30,14,16,凱基-林口,2023-04-14,9257
6282,康舒,17,1,16,凱基-林口,2023-04-14,9257
00772B,中信高評級公司債,19,4,15,凱基-林口,2023-04-14,9257
4979,華星光,16,1,15,凱基-林口,2023-04-14,9257
1611,中電,14,0,14,凱基-林口,2023-04-14,9257
3029,零壹,19,5,14,凱基-林口,2023-04-14,9257
5381,合正,12,0,12,凱基-林口,2023-04-14,9257
6142,友勁,12,0,12,凱基-林口,2023-04-14,9257
2382,廣達,21,10,11,凱基-林口,2023-04-14,9257
00673R,期元大S＆P原油反1,10,0,10,凱基-林口,2023-04-14,9257
00696B,富邦美債20年,10,0,10,凱基-林口,2023-04-14,9257
1471,首利,10,0,10,凱基-林口,2023-04-14,9257
2206,三陽工業,11,1,10,凱基-林口,2023-04-14,9257
3030,德律,11,1,10,凱基-林口,2023-04-14,9257
3062,建漢,10,0,10,凱基-林口,2023-04-14,9257
4550,長佳,10,0,10,凱基-林口,2023-04-14,9257
4953,緯軟,25,15,10,凱基-林口,2023-04-14,9257
5398,慕康生醫,10,0,10,凱基-林口,2023-04-14,9257
8112,至上,10,0,10,凱基-林口,2023-04-14,9257
1609,大亞,38,29,9,凱基-林口,2023-04-14,9257
00893,國泰智能電動車,9,0,9,凱基-林口,2023-04-14,9257
3540,曜越,10,1,9,凱基-林口,2023-04-14,9257
4566,時碩工業,9,0,9,凱基-林口,2023-04-14,9257
4906,正文,9,0,9,凱基-林口,2023-04-14,9257
1513,中興電,21,13,8,凱基-林口,2023-04-14,9257
2059,川湖,8,0,8,凱基-林口,2023-04-14,9257
2409,友達,8,0,8,凱基-林口,2023-04-14,9257
1514,亞力,23,16,7,凱基-林口,2023-04-14,9257
00720B,元大投資級公司債,130,0,130,凱基-林口,2023-04-17,9257
00878,國泰永續高股息,120,0,120,凱基-林口,2023-04-17,9257
2402,毅嘉,256,160,96,凱基-林口,2023-04-17,9257
3013,晟銘電,113,22,91,凱基-林口,2023-04-17,9257
2845,遠東銀,90,0,90,凱基-林口,2023-04-17,9257
2547,日勝生,59,3,56,凱基-林口,2023-04-17,9257
2867,三商壽,52,2,50,凱基-林口,2023-04-17,9257
3710,連展投控,54,7,47,凱基-林口,2023-04-17,9257
6547,高端疫苗,54,8,46,凱基-林口,2023-04-17,9257
00679B,元大美債20年,45,0,45,凱基-林口,2023-04-17,9257
1471,首利,42,0,42,凱基-林口,2023-04-17,9257
8088,品安,47,15,32,凱基-林口,2023-04-17,9257
1605,華新,48,21,27,凱基-林口,2023-04-17,9257
1445,大宇,25,0,25,凱基-林口,2023-04-17,9257
00712,復華富時不動產,25,1,24,凱基-林口,2023-04-17,9257
2610,華航,40,16,24,凱基-林口,2023-04-17,9257
00690,兆豐藍籌30,20,0,20,凱基-林口,2023-04-17,9257
5353,台林,20,0,20,凱基-林口,2023-04-17,9257
00772B,中信高評級公司債,17,0,17,凱基-林口,2023-04-17,9257
2002,中鋼,18,1,17,凱基-林口,2023-04-17,9257
6161,捷波,17,0,17,凱基-林口,2023-04-17,9257
1513,中興電,31,15,16,凱基-林口,2023-04-17,9257
1519,華城,34,18,16,凱基-林口,2023-04-17,9257
4961,天鈺,41,25,16,凱基-林口,2023-04-17,9257
00751B,元大AAA至A公司債,15,0,15,凱基-林口,2023-04-17,9257
3540,曜越,15,0,15,凱基-林口,2023-04-17,9257
00888,永豐台灣ESG,14,0,14,凱基-林口,2023-04-17,9257
6806,森崴能源,28,14,14,凱基-林口,2023-04-17,9257
4114,健喬,40,27,13,凱基-林口,2023-04-17,9257
2618,長榮航,13,0,13,凱基-林口,2023-04-17,9257
2489,瑞軒,12,0,12,凱基-林口,2023-04-17,9257
5371,中光電,17,5,12,凱基-林口,2023-04-17,9257
00680L,元大美債20正2,11,0,11,凱基-林口,2023-04-17,9257
2371,大同,11,0,11,凱基-林口,2023-04-17,9257
3027,盛達,14,3,11,凱基-林口,2023-04-17,9257
3059,華晶科,10,0,10,凱基-林口,2023-04-17,9257
3325,旭品,10,0,10,凱基-林口,2023-04-17,9257
00922,國泰台灣領袖50,10,0,10,凱基-林口,2023-04-17,9257
00674R,期元大S＆P黃金反1,10,0,10,凱基-林口,2023-04-17,9257
1609,大亞,16,6,10,凱基-林口,2023-04-17,9257
2351,順德,10,0,10,凱基-林口,2023-04-17,9257
2495,普安,10,0,10,凱基-林口,2023-04-17,9257
2705,六福,10,0,10,凱基-林口,2023-04-17,9257
2888,新光金,10,0,10,凱基-林口,2023-04-17,9257
3673,TPK-KY,10,0,10,凱基-林口,2023-04-17,9257
6152,百一,10,0,10,凱基-林口,2023-04-17,9257
8110,華東,10,0,10,凱基-林口,2023-04-17,9257
3038,全台,14,5,9,凱基-林口,2023-04-17,9257
2330,台積電,10,2,8,凱基-林口,2023-04-17,9257
00631L,元大台灣50正2,8,0,8,凱基-林口,2023-04-17,9257
2402,毅嘉,171,1,170,凱基-林口,2023-04-18,9257
1560,中砂,147,2,145,凱基-林口,2023-04-18,9257
2634,漢翔,140,24,116,凱基-林口,2023-04-18,9257
00878,國泰永續高股息,61,6,55,凱基-林口,2023-04-18,9257
2888,新光金,53,0,53,凱基-林口,2023-04-18,9257
00850,元大臺灣ESG永續,50,0,50,凱基-林口,2023-04-18,9257
00679B,元大美債20年,41,0,41,凱基-林口,2023-04-18,9257
3163,波若威,70,30,40,凱基-林口,2023-04-18,9257
2547,日勝生,41,1,40,凱基-林口,2023-04-18,9257
2457,飛宏,106,67,39,凱基-林口,2023-04-18,9257
00720B,元大投資級公司債,39,0,39,凱基-林口,2023-04-18,9257
00713,元大台灣高息低波,38,0,38,凱基-林口,2023-04-18,9257
6235,華孚,81,45,36,凱基-林口,2023-04-18,9257
3037,欣興,35,4,31,凱基-林口,2023-04-18,9257
5009,榮剛,52,23,29,凱基-林口,2023-04-18,9257
2867,三商壽,27,0,27,凱基-林口,2023-04-18,9257
1584,精剛,34,8,26,凱基-林口,2023-04-18,9257
00772B,中信高評級公司債,23,0,23,凱基-林口,2023-04-18,9257
8033,雷虎,33,10,23,凱基-林口,2023-04-18,9257
3046,建��,22,0,22,凱基-林口,2023-04-18,9257
2515,中工,22,0,22,凱基-林口,2023-04-18,9257
2603,長榮,22,1,21,凱基-林口,2023-04-18,9257
2388,威盛,26,6,20,凱基-林口,2023-04-18,9257
2891,中信金,20,0,20,凱基-林口,2023-04-18,9257
6209,今國光,20,0,20,凱基-林口,2023-04-18,9257
5457,宣德,20,1,19,凱基-林口,2023-04-18,9257
1609,大亞,44,27,17,凱基-林口,2023-04-18,9257
2206,三陽工業,24,7,17,凱基-林口,2023-04-18,9257
2324,仁寶,16,0,16,凱基-林口,2023-04-18,9257
6282,康舒,15,1,14,凱基-林口,2023-04-18,9257
00885,富邦越南,13,0,13,凱基-林口,2023-04-18,9257
3005,神基,15,2,13,凱基-林口,2023-04-18,9257
00712,復華富時不動產,12,0,12,凱基-林口,2023-04-18,9257
3013,晟銘電,14,2,12,凱基-林口,2023-04-18,9257
3078,僑威,12,0,12,凱基-林口,2023-04-18,9257
2481,強茂,12,1,11,凱基-林口,2023-04-18,9257
3162,精確,11,0,11,凱基-林口,2023-04-18,9257
00922,國泰台灣領袖50,10,0,10,凱基-林口,2023-04-18,9257
1712,興農,10,0,10,凱基-林口,2023-04-18,9257
2618,長榮航,10,0,10,凱基-林口,2023-04-18,9257
4121,優盛,10,0,10,凱基-林口,2023-04-18,9257
5521,工信,10,0,10,凱基-林口,2023-04-18,9257
6265,方土昶,10,0,10,凱基-林口,2023-04-18,9257
6477,安集,21,11,10,凱基-林口,2023-04-18,9257
6715,嘉基,20,10,10,凱基-林口,2023-04-18,9257
1503,士電,9,0,9,凱基-林口,2023-04-18,9257
2375,凱美,9,0,9,凱基-林口,2023-04-18,9257
2429,銘旺科,9,0,9,凱基-林口,2023-04-18,9257
8086,宏捷科,9,0,9,凱基-林口,2023-04-18,9257
2615,萬海,8,0,8,凱基-林口,2023-04-18,9257
3712,永崴投控,146,0,146,凱基-林口,2023-04-19,9257
2515,中工,112,8,104,凱基-林口,2023-04-19,9257
2867,三商壽,84,0,84,凱基-林口,2023-04-19,9257
4977,眾達-KY,85,20,65,凱基-林口,2023-04-19,9257
3481,群創,80,26,54,凱基-林口,2023-04-19,9257
2897,王道銀行,42,0,42,凱基-林口,2023-04-19,9257
6443,元晶,163,122,41,凱基-林口,2023-04-19,9257
2352,佳世達,41,2,39,凱基-林口,2023-04-19,9257
00888,永豐台灣ESG,34,0,34,凱基-林口,2023-04-19,9257
00923,群益台ESG低碳50,32,0,32,凱基-林口,2023-04-19,9257
6770,力積電,41,10,31,凱基-林口,2023-04-19,9257
3169,亞信,33,2,31,凱基-林口,2023-04-19,9257
1810,和成,38,10,28,凱基-林口,2023-04-19,9257
2634,漢翔,92,65,27,凱基-林口,2023-04-19,9257
2884,玉山金,26,0,26,凱基-林口,2023-04-19,9257
0056,元大高股息,25,0,25,凱基-林口,2023-04-19,9257
00679B,元大美債20年,24,0,24,凱基-林口,2023-04-19,9257
1513,中興電,24,1,23,凱基-林口,2023-04-19,9257
8069,元太,24,1,23,凱基-林口,2023-04-19,9257
2484,希華,30,7,23,凱基-林口,2023-04-19,9257
1314,中石化,22,0,22,凱基-林口,2023-04-19,9257
3701,大眾控,22,0,22,凱基-林口,2023-04-19,9257
1785,光洋科,21,0,21,凱基-林口,2023-04-19,9257
3029,零壹,26,5,21,凱基-林口,2023-04-19,9257
6122,擎邦,26,5,21,凱基-林口,2023-04-19,9257
6179,亞通,21,0,21,凱基-林口,2023-04-19,9257
2888,新光金,40,20,20,凱基-林口,2023-04-19,9257
3306,鼎天,20,0,20,凱基-林口,2023-04-19,9257
2495,普安,57,40,17,凱基-林口,2023-04-19,9257
6244,茂迪,58,42,16,凱基-林口,2023-04-19,9257
3322,建舜電,15,0,15,凱基-林口,2023-04-19,9257
2208,台船,67,52,15,凱基-林口,2023-04-19,9257
2887,台新金,31,17,14,凱基-林口,2023-04-19,9257
3711,日月光投控,13,0,13,凱基-林口,2023-04-19,9257
6190,萬泰科,14,1,13,凱基-林口,2023-04-19,9257
1471,首利,13,1,12,凱基-林口,2023-04-19,9257
1308,亞聚,11,0,11,凱基-林口,2023-04-19,9257
1519,華城,64,53,11,凱基-林口,2023-04-19,9257
3362,先進光,12,1,11,凱基-林口,2023-04-19,9257
9927,泰銘,11,0,11,凱基-林口,2023-04-19,9257
2009,第一銅,24,14,10,凱基-林口,2023-04-19,9257
00712,復華富時不動產,10,0,10,凱基-林口,2023-04-19,9257
00688L,國泰20年美債正2,10,0,10,凱基-林口,2023-04-19,9257
1795,美時,11,1,10,凱基-林口,2023-04-19,9257
2481,強茂,10,0,10,凱基-林口,2023-04-19,9257
3673,TPK-KY,19,9,10,凱基-林口,2023-04-19,9257
4702,中美實,10,0,10,凱基-林口,2023-04-19,9257
4968,立積,20,10,10,凱基-林口,2023-04-19,9257
8016,矽創,10,0,10,凱基-林口,2023-04-19,9257
00632R,元大台灣50反1,10,1,9,凱基-林口,2023-04-19,9257
00720B,元大投資級公司債,141,0,141,凱基-林口,2023-04-20,9257
2913,農林,59,3,56,凱基-林口,2023-04-20,9257
2303,聯電,55,9,46,凱基-林口,2023-04-20,9257
3038,全台,43,0,43,凱基-林口,2023-04-20,9257
4164,承業醫,37,2,35,凱基-林口,2023-04-20,9257
00888,永豐台灣ESG,31,0,31,凱基-林口,2023-04-20,9257
1810,和成,36,7,29,凱基-林口,2023-04-20,9257
3029,零壹,25,0,25,凱基-林口,2023-04-20,9257
2498,宏達電,26,3,23,凱基-林口,2023-04-20,9257
00907,永豐優息存股,23,0,23,凱基-林口,2023-04-20,9257
4161,聿新科,27,5,22,凱基-林口,2023-04-20,9257
2484,希華,80,59,21,凱基-林口,2023-04-20,9257
4128,中天,30,10,20,凱基-林口,2023-04-20,9257
00912,中信臺灣智慧50,20,0,20,凱基-林口,2023-04-20,9257
5309,系統電,29,9,20,凱基-林口,2023-04-20,9257
2748,雲品,29,11,18,凱基-林口,2023-04-20,9257
6265,方土昶,18,0,18,凱基-林口,2023-04-20,9257
1760,寶齡富錦,40,23,17,凱基-林口,2023-04-20,9257
00878,國泰永續高股息,23,6,17,凱基-林口,2023-04-20,9257
00637L,元大滬深300正2,17,1,16,凱基-林口,2023-04-20,9257
4979,華星光,16,1,15,凱基-林口,2023-04-20,9257
1232,大統益,15,0,15,凱基-林口,2023-04-20,9257
2606,裕民,15,0,15,凱基-林口,2023-04-20,9257
8088,品安,15,0,15,凱基-林口,2023-04-20,9257
6806,森崴能源,22,7,15,凱基-林口,2023-04-20,9257
0056,元大高股息,16,2,14,凱基-林口,2023-04-20,9257
3078,僑威,14,1,13,凱基-林口,2023-04-20,9257
3264,欣銓,13,0,13,凱基-林口,2023-04-20,9257
6190,萬泰科,13,0,13,凱基-林口,2023-04-20,9257
3003,健和興,14,2,12,凱基-林口,2023-04-20,9257
6719,力智,13,1,12,凱基-林口,2023-04-20,9257
3504,揚明光,11,0,11,凱基-林口,2023-04-20,9257
4533,協易機,11,0,11,凱基-林口,2023-04-20,9257
6109,亞元,11,0,11,凱基-林口,2023-04-20,9257
6122,擎邦,12,1,11,凱基-林口,2023-04-20,9257
6244,茂迪,89,78,11,凱基-林口,2023-04-20,9257
00713,元大台灣高息低波,12,1,11,凱基-林口,2023-04-20,9257
00680L,元大美債20正2,10,0,10,凱基-林口,2023-04-20,9257
2369,菱生,10,0,10,凱基-林口,2023-04-20,9257
2392,正崴,20,10,10,凱基-林口,2023-04-20,9257
2492,華新科,11,1,10,凱基-林口,2023-04-20,9257
2495,普安,13,3,10,凱基-林口,2023-04-20,9257
2891,中信金,11,1,10,凱基-林口,2023-04-20,9257
3058,立德,10,0,10,凱基-林口,2023-04-20,9257
3163,波若威,10,0,10,凱基-林口,2023-04-20,9257
4114,健喬,16,6,10,凱基-林口,2023-04-20,9257
4702,中美實,10,0,10,凱基-林口,2023-04-20,9257
4906,正文,10,0,10,凱基-林口,2023-04-20,9257
5531,鄉林,10,0,10,凱基-林口,2023-04-20,9257
6148,驊宏資,10,0,10,凱基-林口,2023-04-20,9257
3481,群創,152,5,147,凱基-林口,2023-04-21,9257
00888,永豐台灣ESG,100,0,100,凱基-林口,2023-04-21,9257
00632R,元大台灣50反1,59,0,59,凱基-林口,2023-04-21,9257
6218,豪勉,60,3,57,凱基-林口,2023-04-21,9257
1101,台泥,72,30,42,凱基-林口,2023-04-21,9257
0056,元大高股息,37,0,37,凱基-林口,2023-04-21,9257
00720B,元大投資級公司債,37,1,36,凱基-林口,2023-04-21,9257
2515,中工,37,5,32,凱基-林口,2023-04-21,9257
2897,王道銀行,32,2,30,凱基-林口,2023-04-21,9257
2535,達欣工,26,0,26,凱基-林口,2023-04-21,9257
5009,榮剛,28,3,25,凱基-林口,2023-04-21,9257
2402,毅嘉,33,10,23,凱基-林口,2023-04-21,9257
00772B,中信高評級公司債,22,0,22,凱基-林口,2023-04-21,9257
6290,良維,22,0,22,凱基-林口,2023-04-21,9257
00680L,元大美債20正2,20,0,20,凱基-林口,2023-04-21,9257
1444,力麗,20,0,20,凱基-林口,2023-04-21,9257
3048,益登,20,0,20,凱基-林口,2023-04-21,9257
4161,聿新科,20,0,20,凱基-林口,2023-04-21,9257
2027,大成鋼,14,0,14,凱基-林口,2023-04-21,9257
3363,上詮,23,9,14,凱基-林口,2023-04-21,9257
4919,新唐,14,0,14,凱基-林口,2023-04-21,9257
2603,長榮,14,1,13,凱基-林口,2023-04-21,9257
2495,普安,21,8,13,凱基-林口,2023-04-21,9257
3038,全台,13,0,13,凱基-林口,2023-04-21,9257
3062,建漢,13,0,13,凱基-林口,2023-04-21,9257
4503,金雨,13,0,13,凱基-林口,2023-04-21,9257
2609,陽明,13,1,12,凱基-林口,2023-04-21,9257
9945,潤泰新,12,0,12,凱基-林口,2023-04-21,9257
1609,大亞,17,6,11,凱基-林口,2023-04-21,9257
2484,希華,21,10,11,凱基-林口,2023-04-21,9257
006208,富邦台50,10,0,10,凱基-林口,2023-04-21,9257
00713,元大台灣高息低波,10,0,10,凱基-林口,2023-04-21,9257
3322,建舜電,10,0,10,凱基-林口,2023-04-21,9257
4702,中美實,10,0,10,凱基-林口,2023-04-21,9257
8916,光隆,10,0,10,凱基-林口,2023-04-21,9257
1402,遠東新,9,0,9,凱基-林口,2023-04-21,9257
2891,中信金,10,1,9,凱基-林口,2023-04-21,9257
3078,僑威,11,2,9,凱基-林口,2023-04-21,9257
3576,聯合再生,9,0,9,凱基-林口,2023-04-21,9257
1513,中興電,13,4,9,凱基-林口,2023-04-21,9257
1783,和康生,10,2,8,凱基-林口,2023-04-21,9257
5301,寶得利,8,0,8,凱基-林口,2023-04-21,9257
00891,中信關鍵半導體,10,3,7,凱基-林口,2023-04-21,9257
00922,國泰台灣領袖50,7,0,7,凱基-林口,2023-04-21,9257
00692,富邦公司治理,7,0,7,凱基-林口,2023-04-21,9257
1560,中砂,9,2,7,凱基-林口,2023-04-21,9257
2313,華通,7,0,7,凱基-林口,2023-04-21,9257
6715,嘉基,10,3,7,凱基-林口,2023-04-21,9257
8046,南電,11,4,7,凱基-林口,2023-04-21,9257
6589,台康生技,7,1,6,凱基-林口,2023-04-21,9257
00637L,元大滬深300正2,66,13,53,凱基-林口,2023-04-24,9257
1709,和益,47,3,44,凱基-林口,2023-04-24,9257
4960,誠美材,50,14,36,凱基-林口,2023-04-24,9257
2845,遠東銀,24,0,24,凱基-林口,2023-04-24,9257
00772B,中信高評級公司債,22,0,22,凱基-林口,2023-04-24,9257
2303,聯電,33,13,20,凱基-林口,2023-04-24,9257
2812,台中銀,20,0,20,凱基-林口,2023-04-24,9257
0056,元大高股息,24,5,19,凱基-林口,2023-04-24,9257
3078,僑威,17,0,17,凱基-林口,2023-04-24,9257
2324,仁寶,16,0,16,凱基-林口,2023-04-24,9257
4979,華星光,17,2,15,凱基-林口,2023-04-24,9257
2834,臺企銀,16,1,15,凱基-林口,2023-04-24,9257
00923,群益台ESG低碳50,14,0,14,凱基-林口,2023-04-24,9257
2610,華航,15,1,14,凱基-林口,2023-04-24,9257
00878,國泰永續高股息,12,0,12,凱基-林口,2023-04-24,9257
1310,台苯,12,0,12,凱基-林口,2023-04-24,9257
6770,力積電,11,0,11,凱基-林口,2023-04-24,9257
2504,國產,12,1,11,凱基-林口,2023-04-24,9257
00679B,元大美債20年,10,0,10,凱基-林口,2023-04-24,9257
00641R,富邦日本反1,10,0,10,凱基-林口,2023-04-24,9257
00720B,元大投資級公司債,10,0,10,凱基-林口,2023-04-24,9257
1312,國喬,10,0,10,凱基-林口,2023-04-24,9257
1909,榮成,11,1,10,凱基-林口,2023-04-24,9257
2014,中鴻,10,0,10,凱基-林口,2023-04-24,9257
2233,宇隆,10,0,10,凱基-林口,2023-04-24,9257
5258,虹堡,10,0,10,凱基-林口,2023-04-24,9257
5353,台林,10,0,10,凱基-林口,2023-04-24,9257
6026,福邦證,10,0,10,凱基-林口,2023-04-24,9257
2886,兆豐金,9,0,9,凱基-林口,2023-04-24,9257
1471,首利,10,1,9,凱基-林口,2023-04-24,9257
2027,大成鋼,9,0,9,凱基-林口,2023-04-24,9257
2313,華通,10,1,9,凱基-林口,2023-04-24,9257
2913,農林,211,202,9,凱基-林口,2023-04-24,9257
1611,中電,21,13,8,凱基-林口,2023-04-24,9257
2457,飛宏,11,3,8,凱基-林口,2023-04-24,9257
4121,優盛,8,0,8,凱基-林口,2023-04-24,9257
00888,永豐台灣ESG,7,0,7,凱基-林口,2023-04-24,9257
00892,富邦台灣半導體,7,0,7,凱基-林口,2023-04-24,9257
00712,復華富時不動產,7,0,7,凱基-林口,2023-04-24,9257
2340,台亞,7,0,7,凱基-林口,2023-04-24,9257
2645,長榮航太,7,0,7,凱基-林口,2023-04-24,9257
5371,中光電,7,0,7,凱基-林口,2023-04-24,9257
6282,康舒,13,6,7,凱基-林口,2023-04-24,9257
8046,南電,9,2,7,凱基-林口,2023-04-24,9257
1442,名軒,6,0,6,凱基-林口,2023-04-24,9257
1522,堤維西,6,0,6,凱基-林口,2023-04-24,9257
2401,凌陽,6,0,6,凱基-林口,2023-04-24,9257
3027,盛達,6,0,6,凱基-林口,2023-04-24,9257
5478,智冠,6,0,6,凱基-林口,2023-04-24,9257
2472,立隆電,5,0,5,凱基-林口,2023-04-24,9257
1752,南光,112,5,107,凱基-林口,2023-04-25,9257
0056,元大高股息,95,5,90,凱基-林口,2023-04-25,9257
2634,漢翔,134,79,55,凱基-林口,2023-04-25,9257
3207,耀勝,62,12,50,凱基-林口,2023-04-25,9257
4960,誠美材,50,3,47,凱基-林口,2023-04-25,9257
00888,永豐台灣ESG,35,0,35,凱基-林口,2023-04-25,9257
3712,永崴投控,34,1,33,凱基-林口,2023-04-25,9257
2206,三陽工業,38,8,30,凱基-林口,2023-04-25,9257
2489,瑞軒,29,2,27,凱基-林口,2023-04-25,9257
00878,國泰永續高股息,47,23,24,凱基-林口,2023-04-25,9257
2609,陽明,30,6,24,凱基-林口,2023-04-25,9257
9904,寶成,22,0,22,凱基-林口,2023-04-25,9257
0050,元大台灣50,23,2,21,凱基-林口,2023-04-25,9257
3548,兆利,21,0,21,凱基-林口,2023-04-25,9257
6719,力智,21,0,21,凱基-林口,2023-04-25,9257
00680L,元大美債20正2,20,0,20,凱基-林口,2023-04-25,9257
2515,中工,20,2,18,凱基-林口,2023-04-25,9257
00637L,元大滬深300正2,26,9,17,凱基-林口,2023-04-25,9257
1709,和益,20,4,16,凱基-林口,2023-04-25,9257
3071,協禧,71,56,15,凱基-林口,2023-04-25,9257
2482,連宇,52,39,13,凱基-林口,2023-04-25,9257
2027,大成鋼,12,0,12,凱基-林口,2023-04-25,9257
2603,長榮,14,2,12,凱基-林口,2023-04-25,9257
3004,豐達科,12,0,12,凱基-林口,2023-04-25,9257
00685L,群益臺灣加權正2,12,0,12,凱基-林口,2023-04-25,9257
1795,美時,21,10,11,凱基-林口,2023-04-25,9257
6472,保瑞,16,6,10,凱基-林口,2023-04-25,9257
4919,新唐,24,14,10,凱基-林口,2023-04-25,9257
00692,富邦公司治理,10,0,10,凱基-林口,2023-04-25,9257
00687B,國泰20年美債,10,0,10,凱基-林口,2023-04-25,9257
1503,士電,21,11,10,凱基-林口,2023-04-25,9257
3062,建漢,10,0,10,凱基-林口,2023-04-25,9257
8088,品安,10,0,10,凱基-林口,2023-04-25,9257
00922,國泰台灣領袖50,9,0,9,凱基-林口,2023-04-25,9257
2457,飛宏,46,37,9,凱基-林口,2023-04-25,9257
00923,群益台ESG低碳50,9,0,9,凱基-林口,2023-04-25,9257
1442,名軒,9,0,9,凱基-林口,2023-04-25,9257
2352,佳世達,10,1,9,凱基-林口,2023-04-25,9257
2610,華航,21,12,9,凱基-林口,2023-04-25,9257
3419,譁裕,10,1,9,凱基-林口,2023-04-25,9257
1560,中砂,10,2,8,凱基-林口,2023-04-25,9257
1319,東陽,8,0,8,凱基-林口,2023-04-25,9257
00715L,期街口布蘭特正2,10,2,8,凱基-林口,2023-04-25,9257
2313,華通,8,0,8,凱基-林口,2023-04-25,9257
2913,農林,21,13,8,凱基-林口,2023-04-25,9257
2851,中再保,10,2,8,凱基-林口,2023-04-25,9257
00713,元大台灣高息低波,7,0,7,凱基-林口,2023-04-25,9257
1519,華城,32,25,7,凱基-林口,2023-04-25,9257
2605,新興,7,0,7,凱基-林口,2023-04-25,9257
6234,高僑,7,0,7,凱基-林口,2023-04-25,9257
00902,中信電池及儲能,101,14,87,凱基-林口,2023-04-26,9257
2471,資通,77,11,66,凱基-林口,2023-04-26,9257
00885,富邦越南,61,0,61,凱基-林口,2023-04-26,9257
2402,毅嘉,68,12,56,凱基-林口,2023-04-26,9257
2486,一詮,50,0,50,凱基-林口,2023-04-26,9257
00888,永豐台灣ESG,34,0,34,凱基-林口,2023-04-26,9257
2002,中鋼,42,8,34,凱基-林口,2023-04-26,9257
00916,國泰全球品牌50,30,0,30,凱基-林口,2023-04-26,9257
2610,華航,35,5,30,凱基-林口,2023-04-26,9257
2897,王道銀行,30,0,30,凱基-林口,2023-04-26,9257
1314,中石化,31,5,26,凱基-林口,2023-04-26,9257
2609,陽明,30,5,25,凱基-林口,2023-04-26,9257
2634,漢翔,26,1,25,凱基-林口,2023-04-26,9257
00712,復華富時不動產,24,0,24,凱基-林口,2023-04-26,9257
3712,永崴投控,21,0,21,凱基-林口,2023-04-26,9257
00878,國泰永續高股息,23,3,20,凱基-林口,2023-04-26,9257
1101,台泥,21,3,18,凱基-林口,2023-04-26,9257
1907,永豐餘,64,47,17,凱基-林口,2023-04-26,9257
2748,雲品,17,0,17,凱基-林口,2023-04-26,9257
6770,力積電,16,0,16,凱基-林口,2023-04-26,9257
8093,保銳,16,0,16,凱基-林口,2023-04-26,9257
1709,和益,15,0,15,凱基-林口,2023-04-26,9257
3048,益登,16,1,15,凱基-林口,2023-04-26,9257
3062,建漢,15,1,14,凱基-林口,2023-04-26,9257
4960,誠美材,20,6,14,凱基-林口,2023-04-26,9257
0050,元大台灣50,14,1,13,凱基-林口,2023-04-26,9257
00715L,期街口布蘭特正2,13,0,13,凱基-林口,2023-04-26,9257
2883,凱基金,14,1,13,凱基-林口,2023-04-26,9257
3548,兆利,15,2,13,凱基-林口,2023-04-26,9257
1108,幸福,18,6,12,凱基-林口,2023-04-26,9257
00720B,元大投資級公司債,12,0,12,凱基-林口,2023-04-26,9257
2882,國泰金,12,0,12,凱基-林口,2023-04-26,9257
2329,華泰,11,0,11,凱基-林口,2023-04-26,9257
00772B,中信高評級公司債,10,0,10,凱基-林口,2023-04-26,9257
2344,華邦電,10,0,10,凱基-林口,2023-04-26,9257
2481,強茂,10,0,10,凱基-林口,2023-04-26,9257
3481,群創,10,0,10,凱基-林口,2023-04-26,9257
5009,榮剛,11,1,10,凱基-林口,2023-04-26,9257
3035,智原,13,3,10,凱基-林口,2023-04-26,9257
6209,今國光,9,0,9,凱基-林口,2023-04-26,9257
2330,台積電,9,2,7,凱基-林口,2023-04-26,9257
006208,富邦台50,7,0,7,凱基-林口,2023-04-26,9257
00641R,富邦日本反1,7,0,7,凱基-林口,2023-04-26,9257
00713,元大台灣高息低波,6,0,6,凱基-林口,2023-04-26,9257
2031,新光鋼,6,0,6,凱基-林口,2023-04-26,9257
2233,宇隆,6,0,6,凱基-林口,2023-04-26,9257
3231,緯創,33,27,6,凱基-林口,2023-04-26,9257
5488,松普,6,0,6,凱基-林口,2023-04-26,9257
6799,來頡,6,0,6,凱基-林口,2023-04-26,9257
3374,精材,6,0,6,凱基-林口,2023-04-26,9257
2913,農林,108,3,105,凱基-林口,2023-04-27,9257
1752,南光,75,9,66,凱基-林口,2023-04-27,9257
6244,茂迪,45,3,42,凱基-林口,2023-04-27,9257
4128,中天,40,0,40,凱基-林口,2023-04-27,9257
3712,永崴投控,40,0,40,凱基-林口,2023-04-27,9257
1721,三晃,35,2,33,凱基-林口,2023-04-27,9257
2801,彰銀,30,0,30,凱基-林口,2023-04-27,9257
2402,毅嘉,43,14,29,凱基-林口,2023-04-27,9257
00922,國泰台灣領袖50,30,3,27,凱基-林口,2023-04-27,9257
1905,華紙,46,20,26,凱基-林口,2023-04-27,9257
2002,中鋼,29,4,25,凱基-林口,2023-04-27,9257
0056,元大高股息,28,6,22,凱基-林口,2023-04-27,9257
2353,宏��,22,0,22,凱基-林口,2023-04-27,9257
6271,同欣電,20,0,20,凱基-林口,2023-04-27,9257
2349,錸德,20,0,20,凱基-林口,2023-04-27,9257
3265,台星科,26,6,20,凱基-林口,2023-04-27,9257
2610,華航,61,42,19,凱基-林口,2023-04-27,9257
1513,中興電,18,0,18,凱基-林口,2023-04-27,9257
3363,上詮,22,5,17,凱基-林口,2023-04-27,9257
00773B,中信優先金融債,16,0,16,凱基-林口,2023-04-27,9257
2303,聯電,18,4,14,凱基-林口,2023-04-27,9257
1907,永豐餘,23,9,14,凱基-林口,2023-04-27,9257
00772B,中信高評級公司債,13,0,13,凱基-林口,2023-04-27,9257
00878,國泰永續高股息,13,0,13,凱基-林口,2023-04-27,9257
00715L,期街口布蘭特正2,14,3,11,凱基-林口,2023-04-27,9257
3016,嘉晶,10,0,10,凱基-林口,2023-04-27,9257
4953,緯軟,10,0,10,凱基-林口,2023-04-27,9257
8088,品安,10,0,10,凱基-林口,2023-04-27,9257
1514,亞力,10,1,9,凱基-林口,2023-04-27,9257
2409,友達,10,1,9,凱基-林口,2023-04-27,9257
4541,晟田,10,1,9,凱基-林口,2023-04-27,9257
8227,巨有科技,14,5,9,凱基-林口,2023-04-27,9257
1442,名軒,8,0,8,凱基-林口,2023-04-27,9257
2603,長榮,7,0,7,凱基-林口,2023-04-27,9257
3010,華立,7,0,7,凱基-林口,2023-04-27,9257
6443,元晶,7,0,7,凱基-林口,2023-04-27,9257
00712,復華富時不動產,6,0,6,凱基-林口,2023-04-27,9257
00725B,國泰投資級公司債,6,0,6,凱基-林口,2023-04-27,9257
00685L,群益臺灣加權正2,6,0,6,凱基-林口,2023-04-27,9257
1711,永光,62,56,6,凱基-林口,2023-04-27,9257
2605,新興,6,0,6,凱基-林口,2023-04-27,9257
3481,群創,11,5,6,凱基-林口,2023-04-27,9257
4767,誠泰科技,6,0,6,凱基-林口,2023-04-27,9257
9958,世紀鋼,6,0,6,凱基-林口,2023-04-27,9257
00679B,元大美債20年,5,0,5,凱基-林口,2023-04-27,9257
1605,華新,9,4,5,凱基-林口,2023-04-27,9257
1446,宏和,5,0,5,凱基-林口,2023-04-27,9257
3162,精確,5,0,5,凱基-林口,2023-04-27,9257
4566,時碩工業,5,0,5,凱基-林口,2023-04-27,9257
2330,台積電,6,1,5,凱基-林口,2023-04-27,9257
2344,華邦電,897,45,852,凱基-林口,2023-04-28,9257
2303,聯電,512,3,509,凱基-林口,2023-04-28,9257
00878,國泰永續高股息,228,5,223,凱基-林口,2023-04-28,9257
2880,華南金,70,0,70,凱基-林口,2023-04-28,9257
2330,台積電,51,1,50,凱基-林口,2023-04-28,9257
00772B,中信高評級公司債,46,0,46,凱基-林口,2023-04-28,9257
3481,群創,38,2,36,凱基-林口,2023-04-28,9257
6139,亞翔,27,0,27,凱基-林口,2023-04-28,9257
3308,聯德,26,0,26,凱基-林口,2023-04-28,9257
4161,聿新科,26,0,26,凱基-林口,2023-04-28,9257
2498,宏達電,25,1,24,凱基-林口,2023-04-28,9257
00679B,元大美債20年,23,0,23,凱基-林口,2023-04-28,9257
3029,零壹,22,1,21,凱基-林口,2023-04-28,9257
4111,濟生,20,0,20,凱基-林口,2023-04-28,9257
00632R,元大台灣50反1,69,50,19,凱基-林口,2023-04-28,9257
2409,友達,29,10,19,凱基-林口,2023-04-28,9257
2634,漢翔,42,23,19,凱基-林口,2023-04-28,9257
8222,寶一,36,22,14,凱基-林口,2023-04-28,9257
4960,誠美材,46,33,13,凱基-林口,2023-04-28,9257
2201,裕隆,16,3,13,凱基-林口,2023-04-28,9257
2645,長榮航太,12,0,12,凱基-林口,2023-04-28,9257
1717,長興,11,0,11,凱基-林口,2023-04-28,9257
2834,臺企銀,11,0,11,凱基-林口,2023-04-28,9257
4916,事欣科,11,0,11,凱基-林口,2023-04-28,9257
00715L,期街口布蘭特正2,10,0,10,凱基-林口,2023-04-28,9257
2481,強茂,10,0,10,凱基-林口,2023-04-28,9257
4702,中美實,10,0,10,凱基-林口,2023-04-28,9257
6114,久威,10,0,10,凱基-林口,2023-04-28,9257
6156,松上,10,0,10,凱基-林口,2023-04-28,9257
6196,帆宣,10,0,10,凱基-林口,2023-04-28,9257
8088,品安,10,0,10,凱基-林口,2023-04-28,9257
8112,至上,10,0,10,凱基-林口,2023-04-28,9257
2368,金像電,13,4,9,凱基-林口,2023-04-28,9257
2618,長榮航,12,3,9,凱基-林口,2023-04-28,9257
1514,亞力,11,3,8,凱基-林口,2023-04-28,9257
5425,台半,10,3,7,凱基-林口,2023-04-28,9257
00753L,中信中國50正2,7,0,7,凱基-林口,2023-04-28,9257
2497,怡利電,9,2,7,凱基-林口,2023-04-28,9257
2916,滿心,7,0,7,凱基-林口,2023-04-28,9257
3035,智原,12,5,7,凱基-林口,2023-04-28,9257
00641R,富邦日本反1,6,0,6,凱基-林口,2023-04-28,9257
00773B,中信優先金融債,6,0,6,凱基-林口,2023-04-28,9257
4513,福裕,6,0,6,凱基-林口,2023-04-28,9257
5284,jpp-KY,6,0,6,凱基-林口,2023-04-28,9257
1442,名軒,5,0,5,凱基-林口,2023-04-28,9257
00830,國泰費城半導體,5,0,5,凱基-林口,2023-04-28,9257
1524,耿鼎,5,0,5,凱基-林口,2023-04-28,9257
1702,南僑,5,0,5,凱基-林口,2023-04-28,9257
1735,日勝化,5,0,5,凱基-林口,2023-04-28,9257
3576,聯合再生,5,0,5,凱基-林口,2023-04-28,9257
2880,華南金,722,2,720,凱基-林口,2023-05-02,9257
00878,國泰永續高股息,235,0,235,凱基-林口,2023-05-02,9257
2402,毅嘉,182,15,167,凱基-林口,2023-05-02,9257
2834,臺企銀,87,0,87,凱基-林口,2023-05-02,9257
8222,寶一,81,11,70,凱基-林口,2023-05-02,9257
2603,長榮,71,18,53,凱基-林口,2023-05-02,9257
00885,富邦越南,44,0,44,凱基-林口,2023-05-02,9257
00680L,元大美債20正2,40,0,40,凱基-林口,2023-05-02,9257
3481,群創,58,20,38,凱基-林口,2023-05-02,9257
6806,森崴能源,87,53,34,凱基-林口,2023-05-02,9257
8093,保銳,32,0,32,凱基-林口,2023-05-02,9257
2609,陽明,34,3,31,凱基-林口,2023-05-02,9257
6167,久正,31,0,31,凱基-林口,2023-05-02,9257
1905,華紙,55,28,27,凱基-林口,2023-05-02,9257
00772B,中信高評級公司債,28,2,26,凱基-林口,2023-05-02,9257
2409,友達,25,1,24,凱基-林口,2023-05-02,9257
2338,光罩,24,0,24,凱基-林口,2023-05-02,9257
6245,立端,24,0,24,凱基-林口,2023-05-02,9257
3711,日月光投控,22,0,22,凱基-林口,2023-05-02,9257
3029,零壹,35,13,22,凱基-林口,2023-05-02,9257
4121,優盛,26,6,20,凱基-林口,2023-05-02,9257
1314,中石化,20,0,20,凱基-林口,2023-05-02,9257
2427,三商電,20,0,20,凱基-林口,2023-05-02,9257
2495,普安,19,0,19,凱基-林口,2023-05-02,9257
3363,上詮,21,5,16,凱基-林口,2023-05-02,9257
6477,安集,23,7,16,凱基-林口,2023-05-02,9257
2455,全新,16,1,15,凱基-林口,2023-05-02,9257
2482,連宇,19,6,13,凱基-林口,2023-05-02,9257
5425,台半,15,2,13,凱基-林口,2023-05-02,9257
8088,品安,14,2,12,凱基-林口,2023-05-02,9257
2457,飛宏,21,10,11,凱基-林口,2023-05-02,9257
2429,銘旺科,11,0,11,凱基-林口,2023-05-02,9257
1312,國喬,10,0,10,凱基-林口,2023-05-02,9257
1308,亞聚,10,0,10,凱基-林口,2023-05-02,9257
2201,裕隆,10,0,10,凱基-林口,2023-05-02,9257
2349,錸德,10,0,10,凱基-林口,2023-05-02,9257
2705,六福,10,0,10,凱基-林口,2023-05-02,9257
3706,神達,10,0,10,凱基-林口,2023-05-02,9257
6139,亞翔,10,0,10,凱基-林口,2023-05-02,9257
8011,台通,10,0,10,凱基-林口,2023-05-02,9257
8210,勤誠,10,0,10,凱基-林口,2023-05-02,9257
2882,國泰金,10,0,10,凱基-林口,2023-05-02,9257
00720B,元大投資級公司債,9,0,9,凱基-林口,2023-05-02,9257
1611,中電,10,1,9,凱基-林口,2023-05-02,9257
2471,資通,12,3,9,凱基-林口,2023-05-02,9257
8069,元太,28,20,8,凱基-林口,2023-05-02,9257
3147,大綜,8,1,7,凱基-林口,2023-05-02,9257
3548,兆利,7,0,7,凱基-林口,2023-05-02,9257
00679B,元大美債20年,16,9,7,凱基-林口,2023-05-02,9257
5009,榮剛,13,7,6,凱基-林口,2023-05-02,9257
3481,群創,301,0,301,凱基-林口,2023-05-03,9257
2834,臺企銀,200,0,200,凱基-林口,2023-05-03,9257
2402,毅嘉,165,0,165,凱基-林口,2023-05-03,9257
4968,立積,52,3,49,凱基-林口,2023-05-03,9257
2603,長榮,56,10,46,凱基-林口,2023-05-03,9257
00632R,元大台灣50反1,45,0,45,凱基-林口,2023-05-03,9257
6209,今國光,41,0,41,凱基-林口,2023-05-03,9257
00712,復華富時不動產,40,0,40,凱基-林口,2023-05-03,9257
6167,久正,111,80,31,凱基-林口,2023-05-03,9257
1314,中石化,30,0,30,凱基-林口,2023-05-03,9257
00715L,期街口布蘭特正2,38,10,28,凱基-林口,2023-05-03,9257
1519,華城,38,11,27,凱基-林口,2023-05-03,9257
00679B,元大美債20年,33,11,22,凱基-林口,2023-05-03,9257
00720B,元大投資級公司債,28,7,21,凱基-林口,2023-05-03,9257
2812,台中銀,20,0,20,凱基-林口,2023-05-03,9257
8097,常珵,20,0,20,凱基-林口,2023-05-03,9257
2610,華航,21,2,19,凱基-林口,2023-05-03,9257
1514,亞力,17,1,16,凱基-林口,2023-05-03,9257
00637L,元大滬深300正2,15,0,15,凱基-林口,2023-05-03,9257
2634,漢翔,26,11,15,凱基-林口,2023-05-03,9257
1558,伸興,14,0,14,凱基-林口,2023-05-03,9257
3432,台端,14,0,14,凱基-林口,2023-05-03,9257
2338,光罩,12,0,12,凱基-林口,2023-05-03,9257
2002,中鋼,11,0,11,凱基-林口,2023-05-03,9257
2371,大同,11,0,11,凱基-林口,2023-05-03,9257
6672,騰輝電子-KY,11,0,11,凱基-林口,2023-05-03,9257
6829,千附精密,14,3,11,凱基-林口,2023-05-03,9257
1611,中電,10,0,10,凱基-林口,2023-05-03,9257
2367,燿華,10,0,10,凱基-林口,2023-05-03,9257
6139,亞翔,10,0,10,凱基-林口,2023-05-03,9257
8011,台通,10,0,10,凱基-林口,2023-05-03,9257
8088,品安,10,0,10,凱基-林口,2023-05-03,9257
8358,金居,10,0,10,凱基-林口,2023-05-03,9257
8069,元太,16,6,10,凱基-林口,2023-05-03,9257
00680L,元大美債20正2,10,1,9,凱基-林口,2023-05-03,9257
4767,誠泰科技,9,0,9,凱基-林口,2023-05-03,9257
6148,驊宏資,11,2,9,凱基-林口,2023-05-03,9257
1101,台泥,25,17,8,凱基-林口,2023-05-03,9257
1442,名軒,8,0,8,凱基-林口,2023-05-03,9257
2484,希華,8,0,8,凱基-林口,2023-05-03,9257
2303,聯電,8,0,8,凱基-林口,2023-05-03,9257
1104,環泥,9,2,7,凱基-林口,2023-05-03,9257
6244,茂迪,9,2,7,凱基-林口,2023-05-03,9257
2344,華邦電,6,0,6,凱基-林口,2023-05-03,9257
1326,台化,6,0,6,凱基-林口,2023-05-03,9257
3260,威剛,6,0,6,凱基-林口,2023-05-03,9257
2409,友達,6,0,6,凱基-林口,2023-05-03,9257
1513,中興電,17,12,5,凱基-林口,2023-05-03,9257
00683L,期元大美元指正2,5,0,5,凱基-林口,2023-05-03,9257
1717,長興,5,0,5,凱基-林口,2023-05-03,9257
00878,國泰永續高股息,277,27,250,凱基-林口,2023-05-04,9257
1786,科妍,86,0,86,凱基-林口,2023-05-04,9257
2402,毅嘉,87,15,72,凱基-林口,2023-05-04,9257
00679B,元大美債20年,65,10,55,凱基-林口,2023-05-04,9257
2640,大車隊,45,0,45,凱基-林口,2023-05-04,9257
2489,瑞軒,40,2,38,凱基-林口,2023-05-04,9257
00715L,期街口布蘭特正2,45,11,34,凱基-林口,2023-05-04,9257
3325,旭品,81,50,31,凱基-林口,2023-05-04,9257
00712,復華富時不動產,29,0,29,凱基-林口,2023-05-04,9257
00680L,元大美債20正2,30,6,24,凱基-林口,2023-05-04,9257
4767,誠泰科技,20,0,20,凱基-林口,2023-05-04,9257
2609,陽明,21,2,19,凱基-林口,2023-05-04,9257
4961,天鈺,17,0,17,凱基-林口,2023-05-04,9257
00642U,期元大S＆P石油,16,0,16,凱基-林口,2023-05-04,9257
3715,定穎投控,20,5,15,凱基-林口,2023-05-04,9257
4755,三福化,15,0,15,凱基-林口,2023-05-04,9257
2891,中信金,25,11,14,凱基-林口,2023-05-04,9257
4746,台耀,16,2,14,凱基-林口,2023-05-04,9257
2409,友達,17,4,13,凱基-林口,2023-05-04,9257
1314,中石化,13,0,13,凱基-林口,2023-05-04,9257
00720B,元大投資級公司債,12,0,12,凱基-林口,2023-05-04,9257
2913,農林,31,20,11,凱基-林口,2023-05-04,9257
4510,高鋒,11,0,11,凱基-林口,2023-05-04,9257
1337,再生-KY,10,0,10,凱基-林口,2023-05-04,9257
1515,力山,10,0,10,凱基-林口,2023-05-04,9257
1711,永光,10,0,10,凱基-林口,2023-05-04,9257
2002,中鋼,10,0,10,凱基-林口,2023-05-04,9257
2206,三陽工業,24,14,10,凱基-林口,2023-05-04,9257
5521,工信,10,0,10,凱基-林口,2023-05-04,9257
6139,亞翔,10,0,10,凱基-林口,2023-05-04,9257
1905,華紙,27,18,9,凱基-林口,2023-05-04,9257
2313,華通,10,1,9,凱基-林口,2023-05-04,9257
4513,福裕,9,0,9,凱基-林口,2023-05-04,9257
1104,環泥,8,0,8,凱基-林口,2023-05-04,9257
00632R,元大台灣50反1,8,0,8,凱基-林口,2023-05-04,9257
5511,德昌,8,0,8,凱基-林口,2023-05-04,9257
2457,飛宏,12,5,7,凱基-林口,2023-05-04,9257
2748,雲品,12,5,7,凱基-林口,2023-05-04,9257
5529,鉅陞,7,0,7,凱基-林口,2023-05-04,9257
6209,今國光,7,0,7,凱基-林口,2023-05-04,9257
00773B,中信優先金融債,6,0,6,凱基-林口,2023-05-04,9257
2201,裕隆,6,0,6,凱基-林口,2023-05-04,9257
3664,安瑞-KY,9,3,6,凱基-林口,2023-05-04,9257
8222,寶一,7,1,6,凱基-林口,2023-05-04,9257
4968,立積,7,2,5,凱基-林口,2023-05-04,9257
1308,亞聚,5,0,5,凱基-林口,2023-05-04,9257
00772B,中信高評級公司債,5,0,5,凱基-林口,2023-05-04,9257
1503,士電,13,8,5,凱基-林口,2023-05-04,9257
2329,華泰,5,0,5,凱基-林口,2023-05-04,9257
2338,光罩,5,0,5,凱基-林口,2023-05-04,9257
2344,華邦電,1063,0,1063,凱基-林口,2023-05-05,9257
2402,毅嘉,78,0,78,凱基-林口,2023-05-05,9257
2353,宏��,69,18,51,凱基-林口,2023-05-05,9257
00923,群益台ESG低碳50,50,0,50,凱基-林口,2023-05-05,9257
4114,健喬,52,4,48,凱基-林口,2023-05-05,9257
00878,國泰永續高股息,45,5,40,凱基-林口,2023-05-05,9257
6209,今國光,34,0,34,凱基-林口,2023-05-05,9257
1734,杏輝,35,3,32,凱基-林口,2023-05-05,9257
00720B,元大投資級公司債,29,0,29,凱基-林口,2023-05-05,9257
4167,松瑞藥,29,0,29,凱基-林口,2023-05-05,9257
1609,大亞,51,23,28,凱基-林口,2023-05-05,9257
00772B,中信高評級公司債,25,0,25,凱基-林口,2023-05-05,9257
8210,勤誠,24,0,24,凱基-林口,2023-05-05,9257
2352,佳世達,24,1,23,凱基-林口,2023-05-05,9257
3481,群創,26,3,23,凱基-林口,2023-05-05,9257
2618,長榮航,21,0,21,凱基-林口,2023-05-05,9257
3576,聯合再生,20,0,20,凱基-林口,2023-05-05,9257
00885,富邦越南,20,0,20,凱基-林口,2023-05-05,9257
00679B,元大美債20年,19,0,19,凱基-林口,2023-05-05,9257
00715L,期街口布蘭特正2,28,10,18,凱基-林口,2023-05-05,9257
00712,復華富時不動產,18,0,18,凱基-林口,2023-05-05,9257
1314,中石化,18,0,18,凱基-林口,2023-05-05,9257
6160,欣技,29,13,16,凱基-林口,2023-05-05,9257
8215,明基材,15,0,15,凱基-林口,2023-05-05,9257
1307,三芳,15,0,15,凱基-林口,2023-05-05,9257
1337,再生-KY,15,0,15,凱基-林口,2023-05-05,9257
4510,高鋒,15,0,15,凱基-林口,2023-05-05,9257
1786,科妍,14,0,14,凱基-林口,2023-05-05,9257
2515,中工,14,0,14,凱基-林口,2023-05-05,9257
2609,陽明,14,1,13,凱基-林口,2023-05-05,9257
1529,樂事綠能,12,0,12,凱基-林口,2023-05-05,9257
6244,茂迪,15,3,12,凱基-林口,2023-05-05,9257
2615,萬海,14,3,11,凱基-林口,2023-05-05,9257
2436,偉詮電,11,0,11,凱基-林口,2023-05-05,9257
5309,系統電,12,1,11,凱基-林口,2023-05-05,9257
0056,元大高股息,12,2,10,凱基-林口,2023-05-05,9257
00753L,中信中國50正2,10,0,10,凱基-林口,2023-05-05,9257
1515,力山,10,0,10,凱基-林口,2023-05-05,9257
1702,南僑,10,0,10,凱基-林口,2023-05-05,9257
1708,東鹼,10,0,10,凱基-林口,2023-05-05,9257
1815,富喬,10,0,10,凱基-林口,2023-05-05,9257
2313,華通,10,0,10,凱基-林口,2023-05-05,9257
2457,飛宏,11,1,10,凱基-林口,2023-05-05,9257
2603,長榮,10,0,10,凱基-林口,2023-05-05,9257
3526,凡甲,10,0,10,凱基-林口,2023-05-05,9257
3548,兆利,10,0,10,凱基-林口,2023-05-05,9257
3588,通嘉,10,0,10,凱基-林口,2023-05-05,9257
6139,亞翔,10,0,10,凱基-林口,2023-05-05,9257
1446,宏和,9,0,9,凱基-林口,2023-05-05,9257
2453,凌群,10,1,9,凱基-林口,2023-05-05,9257
2409,友達,152,24,128,凱基-林口,2023-05-08,9257
2480,敦陽科,57,0,57,凱基-林口,2023-05-08,9257
2883B,凱基金乙特,40,0,40,凱基-林口,2023-05-08,9257
1101,台泥,33,3,30,凱基-林口,2023-05-08,9257
2882,國泰金,30,3,27,凱基-林口,2023-05-08,9257
3231,緯創,38,13,25,凱基-林口,2023-05-08,9257
00679B,元大美債20年,23,0,23,凱基-林口,2023-05-08,9257
00680L,元大美債20正2,42,20,22,凱基-林口,2023-05-08,9257
3029,零壹,27,7,20,凱基-林口,2023-05-08,9257
1795,美時,22,2,20,凱基-林口,2023-05-08,9257
1605,華新,40,20,20,凱基-林口,2023-05-08,9257
1314,中石化,26,6,20,凱基-林口,2023-05-08,9257
2312,金寶,20,0,20,凱基-林口,2023-05-08,9257
3033,威健,20,0,20,凱基-林口,2023-05-08,9257
020022,元大電動車N,18,0,18,凱基-林口,2023-05-08,9257
4953,緯軟,18,0,18,凱基-林口,2023-05-08,9257
2208,台船,15,0,15,凱基-林口,2023-05-08,9257
2916,滿心,15,0,15,凱基-林口,2023-05-08,9257
5498,凱崴,15,0,15,凱基-林口,2023-05-08,9257
3481,群創,48,35,13,凱基-林口,2023-05-08,9257
2371,大同,14,3,11,凱基-林口,2023-05-08,9257
4977,眾達-KY,11,0,11,凱基-林口,2023-05-08,9257
8069,元太,14,3,11,凱基-林口,2023-05-08,9257
2515,中工,10,0,10,凱基-林口,2023-05-08,9257
2353,宏��,12,2,10,凱基-林口,2023-05-08,9257
2736,富野,10,0,10,凱基-林口,2023-05-08,9257
2812,台中銀,10,0,10,凱基-林口,2023-05-08,9257
6122,擎邦,13,3,10,凱基-林口,2023-05-08,9257
9962,有益,10,0,10,凱基-林口,2023-05-08,9257
2801,彰銀,10,1,9,凱基-林口,2023-05-08,9257
3710,連展投控,9,0,9,凱基-林口,2023-05-08,9257
3013,晟銘電,12,3,9,凱基-林口,2023-05-08,9257
9933,中鼎,11,2,9,凱基-林口,2023-05-08,9257
00687B,國泰20年美債,7,0,7,凱基-林口,2023-05-08,9257
8210,勤誠,7,0,7,凱基-林口,2023-05-08,9257
00881,國泰台灣5G+,6,0,6,凱基-林口,2023-05-08,9257
2344,華邦電,6,0,6,凱基-林口,2023-05-08,9257
2408,南亞科,7,1,6,凱基-林口,2023-05-08,9257
2492,華新科,13,7,6,凱基-林口,2023-05-08,9257
4123,晟德,6,0,6,凱基-林口,2023-05-08,9257
2401,凌陽,5,0,5,凱基-林口,2023-05-08,9257
3128,昇銳,5,0,5,凱基-林口,2023-05-08,9257
3545,敦泰,8,3,5,凱基-林口,2023-05-08,9257
5315,光聯,5,0,5,凱基-林口,2023-05-08,9257
8076,伍豐,5,0,5,凱基-林口,2023-05-08,9257
6443,元晶,5,0,5,凱基-林口,2023-05-08,9257
00712,復華富時不動產,4,0,4,凱基-林口,2023-05-08,9257
00720B,元大投資級公司債,4,0,4,凱基-林口,2023-05-08,9257
00715L,期街口布蘭特正2,44,40,4,凱基-林口,2023-05-08,9257
3051,力特,4,0,4,凱基-林口,2023-05-08,9257
2402,毅嘉,471,69,402,凱基-林口,2023-05-09,9257
00680L,元大美債20正2,67,0,67,凱基-林口,2023-05-09,9257
00772B,中信高評級公司債,60,0,60,凱基-林口,2023-05-09,9257
5284,jpp-KY,67,8,59,凱基-林口,2023-05-09,9257
00878,國泰永續高股息,82,35,47,凱基-林口,2023-05-09,9257
00687B,國泰20年美債,45,0,45,凱基-林口,2023-05-09,9257
00900,富邦特選高股息30,42,0,42,凱基-林口,2023-05-09,9257
00885,富邦越南,50,10,40,凱基-林口,2023-05-09,9257
1314,中石化,45,5,40,凱基-林口,2023-05-09,9257
6112,邁達特,76,42,34,凱基-林口,2023-05-09,9257
2392,正崴,30,0,30,凱基-林口,2023-05-09,9257
00679B,元大美債20年,30,1,29,凱基-林口,2023-05-09,9257
00713,元大台灣高息低波,25,2,23,凱基-林口,2023-05-09,9257
2883B,凱基金乙特,20,0,20,凱基-林口,2023-05-09,9257
2916,滿心,20,0,20,凱基-林口,2023-05-09,9257
4566,時碩工業,21,1,20,凱基-林口,2023-05-09,9257
6226,光鼎,20,0,20,凱基-林口,2023-05-09,9257
4744,皇將,19,2,17,凱基-林口,2023-05-09,9257
1101,台泥,18,2,16,凱基-林口,2023-05-09,9257
00720B,元大投資級公司債,16,0,16,凱基-林口,2023-05-09,9257
2888,新光金,16,0,16,凱基-林口,2023-05-09,9257
2913,農林,25,10,15,凱基-林口,2023-05-09,9257
3062,建漢,15,0,15,凱基-林口,2023-05-09,9257
5315,光聯,15,0,15,凱基-林口,2023-05-09,9257
8210,勤誠,15,0,15,凱基-林口,2023-05-09,9257
3715,定穎投控,30,16,14,凱基-林口,2023-05-09,9257
6275,元山,14,0,14,凱基-林口,2023-05-09,9257
00751B,元大AAA至A公司債,12,0,12,凱基-林口,2023-05-09,9257
00773B,中信優先金融債,12,0,12,凱基-林口,2023-05-09,9257
00725B,國泰投資級公司債,12,0,12,凱基-林口,2023-05-09,9257
1504,東元,18,6,12,凱基-林口,2023-05-09,9257
4919,新唐,12,0,12,凱基-林口,2023-05-09,9257
9933,中鼎,11,0,11,凱基-林口,2023-05-09,9257
1904,正隆,13,2,11,凱基-林口,2023-05-09,9257
3005,神基,15,4,11,凱基-林口,2023-05-09,9257
3483,力致,11,0,11,凱基-林口,2023-05-09,9257
1444,力麗,10,0,10,凱基-林口,2023-05-09,9257
2367,燿華,10,0,10,凱基-林口,2023-05-09,9257
2471,資通,11,1,10,凱基-林口,2023-05-09,9257
2883,凱基金,15,6,9,凱基-林口,2023-05-09,9257
2317,鴻海,17,8,9,凱基-林口,2023-05-09,9257
6122,擎邦,11,2,9,凱基-林口,2023-05-09,9257
1605,華新,10,2,8,凱基-林口,2023-05-09,9257
2515,中工,8,0,8,凱基-林口,2023-05-09,9257
3481,群創,31,23,8,凱基-林口,2023-05-09,9257
4541,晟田,10,2,8,凱基-林口,2023-05-09,9257
2609,陽明,35,27,8,凱基-林口,2023-05-09,9257
2480,敦陽科,7,0,7,凱基-林口,2023-05-09,9257
3706,神達,7,0,7,凱基-林口,2023-05-09,9257
6244,茂迪,48,42,6,凱基-林口,2023-05-09,9257
00878,國泰永續高股息,164,54,110,凱基-林口,2023-05-10,9257
1314,中石化,104,32,72,凱基-林口,2023-05-10,9257
00687B,國泰20年美債,49,0,49,凱基-林口,2023-05-10,9257
2402,毅嘉,65,18,47,凱基-林口,2023-05-10,9257
2834,臺企銀,34,0,34,凱基-林口,2023-05-10,9257
2354,鴻準,29,0,29,凱基-林口,2023-05-10,9257
6276,安鈦克,25,0,25,凱基-林口,2023-05-10,9257
1442,名軒,24,0,24,凱基-林口,2023-05-10,9257
9945,潤泰新,24,0,24,凱基-林口,2023-05-10,9257
1101,台泥,23,0,23,凱基-林口,2023-05-10,9257
1609,大亞,48,27,21,凱基-林口,2023-05-10,9257
00900,富邦特選高股息30,21,1,20,凱基-林口,2023-05-10,9257
1444,力麗,20,0,20,凱基-林口,2023-05-10,9257
2385,群光,20,0,20,凱基-林口,2023-05-10,9257
3481,群創,20,0,20,凱基-林口,2023-05-10,9257
2884,玉山金,31,11,20,凱基-林口,2023-05-10,9257
00713,元大台灣高息低波,18,0,18,凱基-林口,2023-05-10,9257
00888,永豐台灣ESG,16,0,16,凱基-林口,2023-05-10,9257
3044,健鼎,20,6,14,凱基-林口,2023-05-10,9257
00753L,中信中國50正2,10,0,10,凱基-林口,2023-05-10,9257
00920,富邦ESG綠色電力,10,0,10,凱基-林口,2023-05-10,9257
2348,海悅,10,0,10,凱基-林口,2023-05-10,9257
2376,技嘉,11,1,10,凱基-林口,2023-05-10,9257
2495,普安,10,0,10,凱基-林口,2023-05-10,9257
2820,華票,10,0,10,凱基-林口,2023-05-10,9257
2887,台新金,10,0,10,凱基-林口,2023-05-10,9257
3062,建漢,11,1,10,凱基-林口,2023-05-10,9257
3217,優群,10,0,10,凱基-林口,2023-05-10,9257
4167,松瑞藥,10,0,10,凱基-林口,2023-05-10,9257
5301,寶得利,10,0,10,凱基-林口,2023-05-10,9257
00720B,元大投資級公司債,9,0,9,凱基-林口,2023-05-10,9257
2317,鴻海,11,3,8,凱基-林口,2023-05-10,9257
0056,元大高股息,8,0,8,凱基-林口,2023-05-10,9257
3231,緯創,33,25,8,凱基-林口,2023-05-10,9257
2338,光罩,7,0,7,凱基-林口,2023-05-10,9257
2352,佳世達,13,6,7,凱基-林口,2023-05-10,9257
2915,潤泰全,7,0,7,凱基-林口,2023-05-10,9257
4729,熒茂,7,0,7,凱基-林口,2023-05-10,9257
6547,高端疫苗,7,0,7,凱基-林口,2023-05-10,9257
2355,敬鵬,10,4,6,凱基-林口,2023-05-10,9257
2421,建準,41,35,6,凱基-林口,2023-05-10,9257
2881,富邦金,6,0,6,凱基-林口,2023-05-10,9257
3483,力致,8,2,6,凱基-林口,2023-05-10,9257
4119,旭富,6,0,6,凱基-林口,2023-05-10,9257
6532,瑞耘,6,0,6,凱基-林口,2023-05-10,9257
0050,元大台灣50,5,0,5,凱基-林口,2023-05-10,9257
3712,永崴投控,5,0,5,凱基-林口,2023-05-10,9257
8938,明安,5,0,5,凱基-林口,2023-05-10,9257
1303,南亞,5,0,5,凱基-林口,2023-05-10,9257
00891,中信關鍵半導體,5,0,5,凱基-林口,2023-05-10,9257
00878,國泰永續高股息,96,8,88,凱基-林口,2023-05-11,9257
2402,毅嘉,79,2,77,凱基-林口,2023-05-11,9257
2609,陽明,34,1,33,凱基-林口,2023-05-11,9257
2890,永豐金,31,0,31,凱基-林口,2023-05-11,9257
1444,力麗,30,0,30,凱基-林口,2023-05-11,9257
1762,中化生,31,2,29,凱基-林口,2023-05-11,9257
2610,華航,24,0,24,凱基-林口,2023-05-11,9257
1337,再生-KY,21,0,21,凱基-林口,2023-05-11,9257
3032,偉訓,33,12,21,凱基-林口,2023-05-11,9257
0056,元大高股息,30,10,20,凱基-林口,2023-05-11,9257
2480,敦陽科,20,0,20,凱基-林口,2023-05-11,9257
5531,鄉林,20,0,20,凱基-林口,2023-05-11,9257
6226,光鼎,20,0,20,凱基-林口,2023-05-11,9257
2504,國產,19,0,19,凱基-林口,2023-05-11,9257
3006,晶豪科,25,6,19,凱基-林口,2023-05-11,9257
5512,力麒,19,0,19,凱基-林口,2023-05-11,9257
2618,長榮航,45,28,17,凱基-林口,2023-05-11,9257
00713,元大台灣高息低波,16,0,16,凱基-林口,2023-05-11,9257
3308,聯德,16,0,16,凱基-林口,2023-05-11,9257
4161,聿新科,16,0,16,凱基-林口,2023-05-11,9257
1442,名軒,15,0,15,凱基-林口,2023-05-11,9257
2542,興富發,36,22,14,凱基-林口,2023-05-11,9257
3051,力特,14,0,14,凱基-林口,2023-05-11,9257
1312,國喬,12,0,12,凱基-林口,2023-05-11,9257
6217,中探針,13,1,12,凱基-林口,2023-05-11,9257
6689,伊雲谷,15,3,12,凱基-林口,2023-05-11,9257
2884,玉山金,12,0,12,凱基-林口,2023-05-11,9257
6285,啟��,14,3,11,凱基-林口,2023-05-11,9257
2634,漢翔,23,12,11,凱基-林口,2023-05-11,9257
2603,長榮,12,1,11,凱基-林口,2023-05-11,9257
1513,中興電,11,0,11,凱基-林口,2023-05-11,9257
2367,燿華,10,0,10,凱基-林口,2023-05-11,9257
1522,堤維西,10,0,10,凱基-林口,2023-05-11,9257
1217,愛之味,10,0,10,凱基-林口,2023-05-11,9257
00720B,元大投資級公司債,10,0,10,凱基-林口,2023-05-11,9257
1815,富喬,10,0,10,凱基-林口,2023-05-11,9257
2349,錸德,10,0,10,凱基-林口,2023-05-11,9257
2705,六福,10,0,10,凱基-林口,2023-05-11,9257
4906,正文,10,0,10,凱基-林口,2023-05-11,9257
8916,光隆,10,0,10,凱基-林口,2023-05-11,9257
00715L,期街口布蘭特正2,20,11,9,凱基-林口,2023-05-11,9257
2409,友達,9,0,9,凱基-林口,2023-05-11,9257
2495,普安,18,9,9,凱基-林口,2023-05-11,9257
00923,群益台ESG低碳50,10,2,8,凱基-林口,2023-05-11,9257
1701,中化,8,0,8,凱基-林口,2023-05-11,9257
3322,建舜電,8,0,8,凱基-林口,2023-05-11,9257
4114,健喬,10,2,8,凱基-林口,2023-05-11,9257
4503,金雨,11,3,8,凱基-林口,2023-05-11,9257
8091,翔名,8,0,8,凱基-林口,2023-05-11,9257
2312,金寶,7,0,7,凱基-林口,2023-05-11,9257
2890,永豐金,137,0,137,凱基-林口,2023-05-12,9257
2313,華通,102,0,102,凱基-林口,2023-05-12,9257
2888,新光金,42,0,42,凱基-林口,2023-05-12,9257
2883B,凱基金乙特,40,0,40,凱基-林口,2023-05-12,9257
00878,國泰永續高股息,42,6,36,凱基-林口,2023-05-12,9257
00680L,元大美債20正2,40,7,33,凱基-林口,2023-05-12,9257
3481,群創,35,3,32,凱基-林口,2023-05-12,9257
8048,德勝,26,0,26,凱基-林口,2023-05-12,9257
3058,立德,25,0,25,凱基-林口,2023-05-12,9257
6160,欣技,23,0,23,凱基-林口,2023-05-12,9257
2002,中鋼,22,0,22,凱基-林口,2023-05-12,9257
4510,高鋒,21,0,21,凱基-林口,2023-05-12,9257
4533,協易機,21,0,21,凱基-林口,2023-05-12,9257
00637L,元大滬深300正2,20,0,20,凱基-林口,2023-05-12,9257
2486,一詮,20,0,20,凱基-林口,2023-05-12,9257
5706,鳳凰,20,0,20,凱基-林口,2023-05-12,9257
6226,光鼎,20,0,20,凱基-林口,2023-05-12,9257
1608,華榮,21,2,19,凱基-林口,2023-05-12,9257
8011,台通,22,3,19,凱基-林口,2023-05-12,9257
8176,智捷,16,0,16,凱基-林口,2023-05-12,9257
2409,友達,14,0,14,凱基-林口,2023-05-12,9257
1314,中石化,22,10,12,凱基-林口,2023-05-12,9257
9907,統一實,12,0,12,凱基-林口,2023-05-12,9257
1503,士電,22,11,11,凱基-林口,2023-05-12,9257
2338,光罩,10,0,10,凱基-林口,2023-05-12,9257
3576,聯合再生,11,1,10,凱基-林口,2023-05-12,9257
4953,緯軟,12,2,10,凱基-林口,2023-05-12,9257
5512,力麒,10,0,10,凱基-林口,2023-05-12,9257
6111,大宇資,10,0,10,凱基-林口,2023-05-12,9257
6167,久正,13,3,10,凱基-林口,2023-05-12,9257
2883,凱基金,16,7,9,凱基-林口,2023-05-12,9257
8076,伍豐,11,2,9,凱基-林口,2023-05-12,9257
00882,中信中國高股息,8,0,8,凱基-林口,2023-05-12,9257
2618,長榮航,17,9,8,凱基-林口,2023-05-12,9257
9945,潤泰新,7,0,7,凱基-林口,2023-05-12,9257
9919,康那香,6,0,6,凱基-林口,2023-05-12,9257
2546,根基,6,0,6,凱基-林口,2023-05-12,9257
2371,大同,31,25,6,凱基-林口,2023-05-12,9257
2368,金像電,6,0,6,凱基-林口,2023-05-12,9257
6472,保瑞,7,2,5,凱基-林口,2023-05-12,9257
00772B,中信高評級公司債,10,5,5,凱基-林口,2023-05-12,9257
00751B,元大AAA至A公司債,5,0,5,凱基-林口,2023-05-12,9257
2329,華泰,5,0,5,凱基-林口,2023-05-12,9257
2344,華邦電,6,1,5,凱基-林口,2023-05-12,9257
2498,宏達電,7,2,5,凱基-林口,2023-05-12,9257
2515,中工,5,0,5,凱基-林口,2023-05-12,9257
3027,盛達,5,0,5,凱基-林口,2023-05-12,9257
3419,譁裕,5,0,5,凱基-林口,2023-05-12,9257
8112,至上,5,0,5,凱基-林口,2023-05-12,9257
5009,榮剛,4,0,4,凱基-林口,2023-05-12,9257
00878,國泰永續高股息,286,20,266,凱基-林口,2023-05-15,9257
2402,毅嘉,241,12,229,凱基-林口,2023-05-15,9257
2515,中工,77,5,72,凱基-林口,2023-05-15,9257
5531,鄉林,30,1,29,凱基-林口,2023-05-15,9257
1504,東元,34,7,27,凱基-林口,2023-05-15,9257
00772B,中信高評級公司債,24,0,24,凱基-林口,2023-05-15,9257
00642U,期元大S＆P石油,23,1,22,凱基-林口,2023-05-15,9257
1605,華新,21,0,21,凱基-林口,2023-05-15,9257
5706,鳳凰,20,0,20,凱基-林口,2023-05-15,9257
6226,光鼎,20,0,20,凱基-林口,2023-05-15,9257
1442,名軒,18,0,18,凱基-林口,2023-05-15,9257
8940,新天地,18,0,18,凱基-林口,2023-05-15,9257
1314,中石化,28,11,17,凱基-林口,2023-05-15,9257
00713,元大台灣高息低波,17,0,17,凱基-林口,2023-05-15,9257
2834,臺企銀,15,0,15,凱基-林口,2023-05-15,9257
3105,穩懋,14,0,14,凱基-林口,2023-05-15,9257
1609,大亞,16,4,12,凱基-林口,2023-05-15,9257
1795,美時,25,13,12,凱基-林口,2023-05-15,9257
1904,正隆,12,0,12,凱基-林口,2023-05-15,9257
2888,新光金,12,0,12,凱基-林口,2023-05-15,9257
8426,紅木-KY,12,0,12,凱基-林口,2023-05-15,9257
2731,雄獅,11,0,11,凱基-林口,2023-05-15,9257
00773B,中信優先金融債,11,0,11,凱基-林口,2023-05-15,9257
2542,興富發,11,0,11,凱基-林口,2023-05-15,9257
00687B,國泰20年美債,10,0,10,凱基-林口,2023-05-15,9257
1784,訊聯,10,0,10,凱基-林口,2023-05-15,9257
2353,宏��,10,0,10,凱基-林口,2023-05-15,9257
2489,瑞軒,12,2,10,凱基-林口,2023-05-15,9257
3481,群創,20,10,10,凱基-林口,2023-05-15,9257
5324,士開,10,0,10,凱基-林口,2023-05-15,9257
6235,華孚,26,16,10,凱基-林口,2023-05-15,9257
00720B,元大投資級公司債,9,0,9,凱基-林口,2023-05-15,9257
1337,再生-KY,13,4,9,凱基-林口,2023-05-15,9257
6179,亞通,9,0,9,凱基-林口,2023-05-15,9257
00715L,期街口布蘭特正2,8,0,8,凱基-林口,2023-05-15,9257
2392,正崴,8,0,8,凱基-林口,2023-05-15,9257
2880,華南金,10,2,8,凱基-林口,2023-05-15,9257
4961,天鈺,8,0,8,凱基-林口,2023-05-15,9257
9945,潤泰新,8,0,8,凱基-林口,2023-05-15,9257
6589,台康生技,7,0,7,凱基-林口,2023-05-15,9257
8996,高力,9,3,6,凱基-林口,2023-05-15,9257
2614,東森,6,0,6,凱基-林口,2023-05-15,9257
2338,光罩,6,0,6,凱基-林口,2023-05-15,9257
2801,彰銀,6,0,6,凱基-林口,2023-05-15,9257
4142,國光生,6,0,6,凱基-林口,2023-05-15,9257
8011,台通,13,7,6,凱基-林口,2023-05-15,9257
8478,東哥遊艇,8,2,6,凱基-林口,2023-05-15,9257
2605,新興,5,0,5,凱基-林口,2023-05-15,9257
3037,欣興,6,1,5,凱基-林口,2023-05-15,9257
3227,原相,5,0,5,凱基-林口,2023-05-15,9257
2618,長榮航,290,15,275,凱基-林口,2023-05-16,9257
00885,富邦越南,148,3,145,凱基-林口,2023-05-16,9257
3052,夆典,50,0,50,凱基-林口,2023-05-16,9257
00680L,元大美債20正2,41,0,41,凱基-林口,2023-05-16,9257
2313,華通,41,0,41,凱基-林口,2023-05-16,9257
2890,永豐金,40,0,40,凱基-林口,2023-05-16,9257
00772B,中信高評級公司債,38,0,38,凱基-林口,2023-05-16,9257
2480,敦陽科,37,0,37,凱基-林口,2023-05-16,9257
2323,中環,45,15,30,凱基-林口,2023-05-16,9257
5353,台林,26,0,26,凱基-林口,2023-05-16,9257
1560,中砂,25,0,25,凱基-林口,2023-05-16,9257
2468,華經,20,0,20,凱基-林口,2023-05-16,9257
3548,兆利,20,0,20,凱基-林口,2023-05-16,9257
8183,精星,20,0,20,凱基-林口,2023-05-16,9257
00720B,元大投資級公司債,17,0,17,凱基-林口,2023-05-16,9257
1519,華城,80,66,14,凱基-林口,2023-05-16,9257
00687B,國泰20年美債,13,0,13,凱基-林口,2023-05-16,9257
1442,名軒,12,0,12,凱基-林口,2023-05-16,9257
5907,大洋-KY,12,0,12,凱基-林口,2023-05-16,9257
6535,順藥,12,0,12,凱基-林口,2023-05-16,9257
3017,奇鋐,11,0,11,凱基-林口,2023-05-16,9257
8081,致新,10,0,10,凱基-林口,2023-05-16,9257
1905,華紙,44,34,10,凱基-林口,2023-05-16,9257
2101,南港,10,0,10,凱基-林口,2023-05-16,9257
2504,國產,10,0,10,凱基-林口,2023-05-16,9257
00632R,元大台灣50反1,9,0,9,凱基-林口,2023-05-16,9257
2371,大同,11,2,9,凱基-林口,2023-05-16,9257
2603,長榮,9,0,9,凱基-林口,2023-05-16,9257
2913,農林,10,1,9,凱基-林口,2023-05-16,9257
8076,伍豐,17,8,9,凱基-林口,2023-05-16,9257
2633,台灣高鐵,8,1,7,凱基-林口,2023-05-16,9257
2743,山富,14,7,7,凱基-林口,2023-05-16,9257
6138,茂達,6,0,6,凱基-林口,2023-05-16,9257
1227,佳格,6,0,6,凱基-林口,2023-05-16,9257
2634,漢翔,8,2,6,凱基-林口,2023-05-16,9257
1444,力麗,5,0,5,凱基-林口,2023-05-16,9257
1608,華榮,5,0,5,凱基-林口,2023-05-16,9257
2365,昆盈,5,0,5,凱基-林口,2023-05-16,9257
2380,虹光,5,0,5,凱基-林口,2023-05-16,9257
2399,映泰,5,0,5,凱基-林口,2023-05-16,9257
3058,立德,5,0,5,凱基-林口,2023-05-16,9257
3363,上詮,13,8,5,凱基-林口,2023-05-16,9257
4114,健喬,5,0,5,凱基-林口,2023-05-16,9257
6269,台郡,5,0,5,凱基-林口,2023-05-16,9257
1558,伸興,4,0,4,凱基-林口,2023-05-16,9257
2408,南亞科,5,1,4,凱基-林口,2023-05-16,9257
2867,三商壽,4,0,4,凱基-林口,2023-05-16,9257
2882,國泰金,4,0,4,凱基-林口,2023-05-16,9257
3504,揚明光,4,0,4,凱基-林口,2023-05-16,9257
2317,鴻海,4,1,3,凱基-林口,2023-05-16,9257
2402,毅嘉,271,142,129,凱基-林口,2023-05-17,9257
00632R,元大台灣50反1,98,0,98,凱基-林口,2023-05-17,9257
2897,王道銀行,50,15,35,凱基-林口,2023-05-17,9257
00878,國泰永續高股息,62,31,31,凱基-林口,2023-05-17,9257
2634,漢翔,36,9,27,凱基-林口,2023-05-17,9257
1444,力麗,30,5,25,凱基-林口,2023-05-17,9257
00642U,期元大S＆P石油,21,0,21,凱基-林口,2023-05-17,9257
2883,凱基金,25,4,21,凱基-林口,2023-05-17,9257
00687B,國泰20年美債,20,0,20,凱基-林口,2023-05-17,9257
1104,環泥,20,0,20,凱基-林口,2023-05-17,9257
2313,華通,20,0,20,凱基-林口,2023-05-17,9257
6179,亞通,20,0,20,凱基-林口,2023-05-17,9257
1314,中石化,25,7,18,凱基-林口,2023-05-17,9257
2633,台灣高鐵,22,5,17,凱基-林口,2023-05-17,9257
2480,敦陽科,25,11,14,凱基-林口,2023-05-17,9257
00720B,元大投資級公司債,13,0,13,凱基-林口,2023-05-17,9257
00680L,元大美債20正2,12,0,12,凱基-林口,2023-05-17,9257
1584,精剛,15,3,12,凱基-林口,2023-05-17,9257
9919,康那香,12,0,12,凱基-林口,2023-05-17,9257
1727,中華化,12,2,10,凱基-林口,2023-05-17,9257
2312,金寶,10,0,10,凱基-林口,2023-05-17,9257
2329,華泰,10,0,10,凱基-林口,2023-05-17,9257
2371,大同,51,41,10,凱基-林口,2023-05-17,9257
2374,佳能,10,0,10,凱基-林口,2023-05-17,9257
2801,彰銀,11,1,10,凱基-林口,2023-05-17,9257
3447,展達,10,0,10,凱基-林口,2023-05-17,9257
4953,緯軟,10,0,10,凱基-林口,2023-05-17,9257
6111,大宇資,10,0,10,凱基-林口,2023-05-17,9257
6605,帝寶,10,0,10,凱基-林口,2023-05-17,9257
8403,盛弘,10,0,10,凱基-林口,2023-05-17,9257
3037,欣興,19,9,10,凱基-林口,2023-05-17,9257
2317,鴻海,12,3,9,凱基-林口,2023-05-17,9257
2834,臺企銀,12,3,9,凱基-林口,2023-05-17,9257
1608,華榮,8,0,8,凱基-林口,2023-05-17,9257
2201,裕隆,17,9,8,凱基-林口,2023-05-17,9257
3715,定穎投控,12,4,8,凱基-林口,2023-05-17,9257
5512,力麒,8,0,8,凱基-林口,2023-05-17,9257
00772B,中信高評級公司債,7,0,7,凱基-林口,2023-05-17,9257
5289,宜鼎,9,2,7,凱基-林口,2023-05-17,9257
6223,旺矽,13,6,7,凱基-林口,2023-05-17,9257
6196,帆宣,7,0,7,凱基-林口,2023-05-17,9257
3046,建��,16,10,6,凱基-林口,2023-05-17,9257
2609,陽明,8,2,6,凱基-林口,2023-05-17,9257
3006,晶豪科,7,1,6,凱基-林口,2023-05-17,9257
6219,富旺,6,0,6,凱基-林口,2023-05-17,9257
00882,中信中國高股息,5,0,5,凱基-林口,2023-05-17,9257
1605,華新,6,1,5,凱基-林口,2023-05-17,9257
1810,和成,8,3,5,凱基-林口,2023-05-17,9257
2208,台船,5,0,5,凱基-林口,2023-05-17,9257
2409,友達,5,0,5,凱基-林口,2023-05-17,9257
1504,東元,250,21,229,凱基-林口,2023-05-18,9257
2610,華航,106,6,100,凱基-林口,2023-05-18,9257
00632R,元大台灣50反1,69,32,37,凱基-林口,2023-05-18,9257
3032,偉訓,26,5,21,凱基-林口,2023-05-18,9257
1514,亞力,20,3,17,凱基-林口,2023-05-18,9257
2633,台灣高鐵,16,1,15,凱基-林口,2023-05-18,9257
3481,群創,15,0,15,凱基-林口,2023-05-18,9257
8069,元太,20,6,14,凱基-林口,2023-05-18,9257
4533,協易機,14,0,14,凱基-林口,2023-05-18,9257
00720B,元大投資級公司債,13,0,13,凱基-林口,2023-05-18,9257
2736,富野,14,1,13,凱基-林口,2023-05-18,9257
2402,毅嘉,36,24,12,凱基-林口,2023-05-18,9257
3058,立德,14,2,12,凱基-林口,2023-05-18,9257
3701,大眾控,12,0,12,凱基-林口,2023-05-18,9257
8076,伍豐,27,16,11,凱基-林口,2023-05-18,9257
2834,臺企銀,11,0,11,凱基-林口,2023-05-18,9257
1104,環泥,10,0,10,凱基-林口,2023-05-18,9257
1584,精剛,12,2,10,凱基-林口,2023-05-18,9257
1711,永光,10,0,10,凱基-林口,2023-05-18,9257
1721,三晃,10,0,10,凱基-林口,2023-05-18,9257
2913,農林,10,0,10,凱基-林口,2023-05-18,9257
3447,展達,10,0,10,凱基-林口,2023-05-18,9257
5201,凱衛,10,0,10,凱基-林口,2023-05-18,9257
00772B,中信高評級公司債,9,0,9,凱基-林口,2023-05-18,9257
2323,中環,10,1,9,凱基-林口,2023-05-18,9257
6163,華電網,10,1,9,凱基-林口,2023-05-18,9257
1101,台泥,9,1,8,凱基-林口,2023-05-18,9257
2489,瑞軒,10,2,8,凱基-林口,2023-05-18,9257
00725B,國泰投資級公司債,7,0,7,凱基-林口,2023-05-18,9257
00680L,元大美債20正2,7,0,7,凱基-林口,2023-05-18,9257
1314,中石化,7,0,7,凱基-林口,2023-05-18,9257
1442,名軒,7,0,7,凱基-林口,2023-05-18,9257
2206,三陽工業,23,16,7,凱基-林口,2023-05-18,9257
2609,陽明,7,0,7,凱基-林口,2023-05-18,9257
2603,長榮,6,0,6,凱基-林口,2023-05-18,9257
3232,昱捷,8,2,6,凱基-林口,2023-05-18,9257
3362,先進光,7,1,6,凱基-林口,2023-05-18,9257
3675,德微,8,2,6,凱基-林口,2023-05-18,9257
4919,新唐,10,4,6,凱基-林口,2023-05-18,9257
4979,華星光,6,0,6,凱基-林口,2023-05-18,9257
6146,耕興,6,0,6,凱基-林口,2023-05-18,9257
1560,中砂,7,2,5,凱基-林口,2023-05-18,9257
2468,華經,7,2,5,凱基-林口,2023-05-18,9257
4581,光隆精密-KY,5,0,5,凱基-林口,2023-05-18,9257
6229,研通,5,0,5,凱基-林口,2023-05-18,9257
00688L,國泰20年美債正2,4,0,4,凱基-林口,2023-05-18,9257
1503,士電,35,31,4,凱基-林口,2023-05-18,9257
2413,環科,4,0,4,凱基-林口,2023-05-18,9257
2634,漢翔,4,0,4,凱基-林口,2023-05-18,9257
3689,湧德,4,0,4,凱基-林口,2023-05-18,9257
6223,旺矽,92,33,59,凱基-林口,2023-05-19,9257
2402,毅嘉,158,111,47,凱基-林口,2023-05-19,9257
6203,海韻電,38,1,37,凱基-林口,2023-05-19,9257
00772B,中信高評級公司債,32,0,32,凱基-林口,2023-05-19,9257
2457,飛宏,54,23,31,凱基-林口,2023-05-19,9257
2419,仲琦,28,0,28,凱基-林口,2023-05-19,9257
00632R,元大台灣50反1,30,5,25,凱基-林口,2023-05-19,9257
3058,立德,22,0,22,凱基-林口,2023-05-19,9257
00712,復華富時不動產,22,1,21,凱基-林口,2023-05-19,9257
3548,兆利,20,0,20,凱基-林口,2023-05-19,9257
00679B,元大美債20年,19,1,18,凱基-林口,2023-05-19,9257
2371,大同,33,15,18,凱基-林口,2023-05-19,9257
2323,中環,22,6,16,凱基-林口,2023-05-19,9257
6243,迅杰,16,0,16,凱基-林口,2023-05-19,9257
8076,伍豐,31,15,16,凱基-林口,2023-05-19,9257
3715,定穎投控,17,2,15,凱基-林口,2023-05-19,9257
1721,三晃,14,0,14,凱基-林口,2023-05-19,9257
3362,先進光,13,1,12,凱基-林口,2023-05-19,9257
2317,鴻海,15,4,11,凱基-林口,2023-05-19,9257
1701,中化,11,0,11,凱基-林口,2023-05-19,9257
4968,立積,11,0,11,凱基-林口,2023-05-19,9257
5324,士開,11,0,11,凱基-林口,2023-05-19,9257
00720B,元大投資級公司債,11,0,11,凱基-林口,2023-05-19,9257
3419,譁裕,10,0,10,凱基-林口,2023-05-19,9257
00637L,元大滬深300正2,10,0,10,凱基-林口,2023-05-19,9257
1514,亞力,14,4,10,凱基-林口,2023-05-19,9257
1815,富喬,10,0,10,凱基-林口,2023-05-19,9257
3511,矽瑪,10,0,10,凱基-林口,2023-05-19,9257
4953,緯軟,10,0,10,凱基-林口,2023-05-19,9257
6101,寬魚國際,10,0,10,凱基-林口,2023-05-19,9257
1519,華城,37,28,9,凱基-林口,2023-05-19,9257
1512,瑞利,8,0,8,凱基-林口,2023-05-19,9257
2731,雄獅,11,3,8,凱基-林口,2023-05-19,9257
2882,國泰金,12,4,8,凱基-林口,2023-05-19,9257
6146,耕興,7,0,7,凱基-林口,2023-05-19,9257
4105,東洋,7,0,7,凱基-林口,2023-05-19,9257
3163,波若威,55,49,6,凱基-林口,2023-05-19,9257
020022,元大電動車N,5,0,5,凱基-林口,2023-05-19,9257
00911,兆豐洲際半導體,5,0,5,凱基-林口,2023-05-19,9257
00885,富邦越南,13,8,5,凱基-林口,2023-05-19,9257
1711,永光,7,2,5,凱基-林口,2023-05-19,9257
2408,南亞科,13,8,5,凱基-林口,2023-05-19,9257
2440,太空梭,5,0,5,凱基-林口,2023-05-19,9257
2468,華經,5,0,5,凱基-林口,2023-05-19,9257
2605,新興,10,5,5,凱基-林口,2023-05-19,9257
3707,漢磊,5,0,5,凱基-林口,2023-05-19,9257
4163,鐿鈦,5,0,5,凱基-林口,2023-05-19,9257
4919,新唐,8,3,5,凱基-林口,2023-05-19,9257
5347,世界,5,0,5,凱基-林口,2023-05-19,9257
6535,順藥,20,15,5,凱基-林口,2023-05-19,9257
00632R,元大台灣50反1,220,0,220,凱基-林口,2023-05-22,9257
2610,華航,755,550,205,凱基-林口,2023-05-22,9257
2618,長榮航,362,191,171,凱基-林口,2023-05-22,9257
8048,德勝,60,6,54,凱基-林口,2023-05-22,9257
2332,友訊,50,0,50,凱基-林口,2023-05-22,9257
00680L,元大美債20正2,38,0,38,凱基-林口,2023-05-22,9257
6257,矽格,35,0,35,凱基-林口,2023-05-22,9257
0056,元大高股息,36,5,31,凱基-林口,2023-05-22,9257
6190,萬泰科,30,0,30,凱基-林口,2023-05-22,9257
2206,三陽工業,42,13,29,凱基-林口,2023-05-22,9257
4164,承業醫,26,0,26,凱基-林口,2023-05-22,9257
2303,聯電,21,0,21,凱基-林口,2023-05-22,9257
2405,輔信,21,0,21,凱基-林口,2023-05-22,9257
3706,神達,31,12,19,凱基-林口,2023-05-22,9257
2031,新光鋼,18,0,18,凱基-林口,2023-05-22,9257
2406,國碩,20,2,18,凱基-林口,2023-05-22,9257
6548,長科*,18,0,18,凱基-林口,2023-05-22,9257
2882,國泰金,21,6,15,凱基-林口,2023-05-22,9257
5258,虹堡,15,0,15,凱基-林口,2023-05-22,9257
6234,高僑,16,1,15,凱基-林口,2023-05-22,9257
2457,飛宏,16,2,14,凱基-林口,2023-05-22,9257
3324,雙鴻,15,1,14,凱基-林口,2023-05-22,9257
3694,海華,15,1,14,凱基-林口,2023-05-22,9257
6235,華孚,13,0,13,凱基-林口,2023-05-22,9257
3037,欣興,13,1,12,凱基-林口,2023-05-22,9257
00692,富邦公司治理,12,0,12,凱基-林口,2023-05-22,9257
00679B,元大美債20年,11,0,11,凱基-林口,2023-05-22,9257
1337,再生-KY,10,0,10,凱基-林口,2023-05-22,9257
00885,富邦越南,10,0,10,凱基-林口,2023-05-22,9257
00688L,國泰20年美債正2,10,0,10,凱基-林口,2023-05-22,9257
1815,富喬,10,0,10,凱基-林口,2023-05-22,9257
2615,萬海,11,1,10,凱基-林口,2023-05-22,9257
6282,康舒,20,11,9,凱基-林口,2023-05-22,9257
00712,復華富時不動產,11,2,9,凱基-林口,2023-05-22,9257
2352,佳世達,16,8,8,凱基-林口,2023-05-22,9257
6223,旺矽,11,3,8,凱基-林口,2023-05-22,9257
00642U,期元大S＆P石油,7,0,7,凱基-林口,2023-05-22,9257
4967,十銓,7,0,7,凱基-林口,2023-05-22,9257
5706,鳳凰,22,15,7,凱基-林口,2023-05-22,9257
00751B,元大AAA至A公司債,6,0,6,凱基-林口,2023-05-22,9257
00720B,元大投資級公司債,6,0,6,凱基-林口,2023-05-22,9257
1519,華城,92,86,6,凱基-林口,2023-05-22,9257
8255,朋程,6,0,6,凱基-林口,2023-05-22,9257
2409,友達,6,0,6,凱基-林口,2023-05-22,9257
00772B,中信高評級公司債,5,0,5,凱基-林口,2023-05-22,9257
1442,名軒,5,0,5,凱基-林口,2023-05-22,9257
1608,華榮,10,5,5,凱基-林口,2023-05-22,9257
2374,佳能,5,0,5,凱基-林口,2023-05-22,9257
2401,凌陽,5,0,5,凱基-林口,2023-05-22,9257
2867,三商壽,5,0,5,凱基-林口,2023-05-22,9257
2618,長榮航,427,52,375,凱基-林口,2023-05-23,9257
2610,華航,380,18,362,凱基-林口,2023-05-23,9257
6233,旺玖,150,0,150,凱基-林口,2023-05-23,9257
6257,矽格,65,0,65,凱基-林口,2023-05-23,9257
1609,大亞,69,6,63,凱基-林口,2023-05-23,9257
2332,友訊,60,0,60,凱基-林口,2023-05-23,9257
3024,憶聲,60,0,60,凱基-林口,2023-05-23,9257
6203,海韻電,55,0,55,凱基-林口,2023-05-23,9257
3164,景岳,50,0,50,凱基-林口,2023-05-23,9257
2404,漢唐,31,0,31,凱基-林口,2023-05-23,9257
5324,士開,32,2,30,凱基-林口,2023-05-23,9257
00713,元大台灣高息低波,38,9,29,凱基-林口,2023-05-23,9257
1402,遠東新,28,0,28,凱基-林口,2023-05-23,9257
00772B,中信高評級公司債,26,0,26,凱基-林口,2023-05-23,9257
6190,萬泰科,26,0,26,凱基-林口,2023-05-23,9257
3078,僑威,40,15,25,凱基-林口,2023-05-23,9257
1444,力麗,20,0,20,凱基-林口,2023-05-23,9257
1605,華新,20,0,20,凱基-林口,2023-05-23,9257
1513,中興電,55,37,18,凱基-林口,2023-05-23,9257
2303,聯電,19,1,18,凱基-林口,2023-05-23,9257
00878,國泰永續高股息,22,6,16,凱基-林口,2023-05-23,9257
5009,榮剛,81,65,16,凱基-林口,2023-05-23,9257
6470,宇智,20,5,15,凱基-林口,2023-05-23,9257
1514,亞力,17,3,14,凱基-林口,2023-05-23,9257
5531,鄉林,62,50,12,凱基-林口,2023-05-23,9257
8926,台汽電,12,0,12,凱基-林口,2023-05-23,9257
1325,恆大,11,0,11,凱基-林口,2023-05-23,9257
2609,陽明,13,2,11,凱基-林口,2023-05-23,9257
00882,中信中國高股息,10,0,10,凱基-林口,2023-05-23,9257
1201,味全,10,0,10,凱基-林口,2023-05-23,9257
1442,名軒,10,0,10,凱基-林口,2023-05-23,9257
3209,全科,10,0,10,凱基-林口,2023-05-23,9257
4906,正文,10,0,10,凱基-林口,2023-05-23,9257
4968,立積,10,0,10,凱基-林口,2023-05-23,9257
5512,力麒,10,0,10,凱基-林口,2023-05-23,9257
5521,工信,10,0,10,凱基-林口,2023-05-23,9257
6719,力智,10,0,10,凱基-林口,2023-05-23,9257
8049,晶采,10,0,10,凱基-林口,2023-05-23,9257
8088,品安,10,0,10,凱基-林口,2023-05-23,9257
8176,智捷,10,0,10,凱基-林口,2023-05-23,9257
9958,世紀鋼,10,0,10,凱基-林口,2023-05-23,9257
00885,富邦越南,10,1,9,凱基-林口,2023-05-23,9257
3558,神準,9,0,9,凱基-林口,2023-05-23,9257
00751B,元大AAA至A公司債,8,0,8,凱基-林口,2023-05-23,9257
6112,邁達特,16,8,8,凱基-林口,2023-05-23,9257
2390,云辰,8,0,8,凱基-林口,2023-05-23,9257
6282,康舒,27,20,7,凱基-林口,2023-05-23,9257
00720B,元大投資級公司債,7,0,7,凱基-林口,2023-05-23,9257
00688L,國泰20年美債正2,7,0,7,凱基-林口,2023-05-23,9257
2313,華通,9,2,7,凱基-林口,2023-05-23,9257
2402,毅嘉,412,32,380,凱基-林口,2023-05-24,9257
6233,旺玖,217,2,215,凱基-林口,2023-05-24,9257
1504,東元,222,26,196,凱基-林口,2023-05-24,9257
5009,榮剛,169,43,126,凱基-林口,2023-05-24,9257
2610,華航,147,42,105,凱基-林口,2023-05-24,9257
00878,國泰永續高股息,72,13,59,凱基-林口,2023-05-24,9257
00637L,元大滬深300正2,55,10,45,凱基-林口,2023-05-24,9257
2897,王道銀行,32,0,32,凱基-林口,2023-05-24,9257
2457,飛宏,66,40,26,凱基-林口,2023-05-24,9257
4953,緯軟,21,0,21,凱基-林口,2023-05-24,9257
00687B,國泰20年美債,20,0,20,凱基-林口,2023-05-24,9257
00680L,元大美債20正2,20,0,20,凱基-林口,2023-05-24,9257
5324,士開,21,1,20,凱基-林口,2023-05-24,9257
5905,南仁湖,20,4,16,凱基-林口,2023-05-24,9257
6535,順藥,16,0,16,凱基-林口,2023-05-24,9257
2419,仲琦,14,0,14,凱基-林口,2023-05-24,9257
00882,中信中國高股息,13,0,13,凱基-林口,2023-05-24,9257
1101,台泥,13,0,13,凱基-林口,2023-05-24,9257
00692,富邦公司治理,13,0,13,凱基-林口,2023-05-24,9257
6146,耕興,13,0,13,凱基-林口,2023-05-24,9257
6281,全國電,13,0,13,凱基-林口,2023-05-24,9257
1785,光洋科,13,1,12,凱基-林口,2023-05-24,9257
2630,亞航,18,7,11,凱基-林口,2023-05-24,9257
3036A,文曄甲特,11,0,11,凱基-林口,2023-05-24,9257
2884,玉山金,13,2,11,凱基-林口,2023-05-24,9257
00632R,元大台灣50反1,10,0,10,凱基-林口,2023-05-24,9257
00795B,中信美國公債20年,10,0,10,凱基-林口,2023-05-24,9257
1810,和成,13,3,10,凱基-林口,2023-05-24,9257
2409,友達,10,0,10,凱基-林口,2023-05-24,9257
2606,裕民,13,3,10,凱基-林口,2023-05-24,9257
6829,千附精密,12,2,10,凱基-林口,2023-05-24,9257
8011,台通,10,0,10,凱基-林口,2023-05-24,9257
1905,華紙,41,33,8,凱基-林口,2023-05-24,9257
2705,六福,8,0,8,凱基-林口,2023-05-24,9257
3013,晟銘電,10,2,8,凱基-林口,2023-05-24,9257
4164,承業醫,8,0,8,凱基-林口,2023-05-24,9257
3454,晶睿,7,0,7,凱基-林口,2023-05-24,9257
00713,元大台灣高息低波,7,1,6,凱基-林口,2023-05-24,9257
00885,富邦越南,6,0,6,凱基-林口,2023-05-24,9257
00665L,富邦�琤肭磪囓�2,6,0,6,凱基-林口,2023-05-24,9257
2615,萬海,11,5,6,凱基-林口,2023-05-24,9257
4744,皇將,10,4,6,凱基-林口,2023-05-24,9257
6215,和椿,6,0,6,凱基-林口,2023-05-24,9257
00888,永豐台灣ESG,5,0,5,凱基-林口,2023-05-24,9257
00671R,富邦NASDAQ反1,5,0,5,凱基-林口,2023-05-24,9257
2313,華通,5,0,5,凱基-林口,2023-05-24,9257
2712,遠雄來,5,0,5,凱基-林口,2023-05-24,9257
4130,健亞,5,0,5,凱基-林口,2023-05-24,9257
6674,鋐寶科技,5,0,5,凱基-林口,2023-05-24,9257
6689,伊雲谷,11,6,5,凱基-林口,2023-05-24,9257
00637L,元大滬深300正2,129,5,124,凱基-林口,2023-05-25,9257
2402,毅嘉,127,60,67,凱基-林口,2023-05-25,9257
2880,華南金,61,0,61,凱基-林口,2023-05-25,9257
1605,華新,65,7,58,凱基-林口,2023-05-25,9257
2317,鴻海,57,0,57,凱基-林口,2023-05-25,9257
3164,景岳,50,0,50,凱基-林口,2023-05-25,9257
3481,群創,50,0,50,凱基-林口,2023-05-25,9257
00632R,元大台灣50反1,46,0,46,凱基-林口,2023-05-25,9257
2809,京城銀,45,0,45,凱基-林口,2023-05-25,9257
6257,矽格,44,0,44,凱基-林口,2023-05-25,9257
00679B,元大美債20年,47,4,43,凱基-林口,2023-05-25,9257
2399,映泰,54,12,42,凱基-林口,2023-05-25,9257
2883,凱基金,41,0,41,凱基-林口,2023-05-25,9257
1442,名軒,35,0,35,凱基-林口,2023-05-25,9257
6233,旺玖,36,1,35,凱基-林口,2023-05-25,9257
00882,中信中國高股息,34,0,34,凱基-林口,2023-05-25,9257
8097,常珵,33,1,32,凱基-林口,2023-05-25,9257
2609,陽明,27,0,27,凱基-林口,2023-05-25,9257
8222,寶一,32,5,27,凱基-林口,2023-05-25,9257
8403,盛弘,26,0,26,凱基-林口,2023-05-25,9257
1460,宏遠,23,0,23,凱基-林口,2023-05-25,9257
1905,華紙,30,8,22,凱基-林口,2023-05-25,9257
6821,聯寶,18,0,18,凱基-林口,2023-05-25,9257
2891,中信金,24,7,17,凱基-林口,2023-05-25,9257
1504,東元,22,6,16,凱基-林口,2023-05-25,9257
2419,仲琦,16,0,16,凱基-林口,2023-05-25,9257
2611,志信,15,0,15,凱基-林口,2023-05-25,9257
2913,農林,15,0,15,凱基-林口,2023-05-25,9257
3511,矽瑪,15,0,15,凱基-林口,2023-05-25,9257
2458,義隆,15,1,14,凱基-林口,2023-05-25,9257
3260,威剛,15,1,14,凱基-林口,2023-05-25,9257
6125,廣運,15,1,14,凱基-林口,2023-05-25,9257
2204,中華,12,0,12,凱基-林口,2023-05-25,9257
5301,寶得利,12,0,12,凱基-林口,2023-05-25,9257
6712,長聖,20,8,12,凱基-林口,2023-05-25,9257
8088,品安,12,0,12,凱基-林口,2023-05-25,9257
00665L,富邦�琤肭磪囓�2,11,0,11,凱基-林口,2023-05-25,9257
3583,辛耘,11,0,11,凱基-林口,2023-05-25,9257
1721,三晃,10,0,10,凱基-林口,2023-05-25,9257
1734,杏輝,10,0,10,凱基-林口,2023-05-25,9257
1815,富喬,10,0,10,凱基-林口,2023-05-25,9257
2375,凱美,10,0,10,凱基-林口,2023-05-25,9257
2385,群光,10,0,10,凱基-林口,2023-05-25,9257
3252,海灣,10,0,10,凱基-林口,2023-05-25,9257
6168,宏齊,10,0,10,凱基-林口,2023-05-25,9257
6182,合晶,10,0,10,凱基-林口,2023-05-25,9257
2610,華航,24,14,10,凱基-林口,2023-05-25,9257
6111,大宇資,9,0,9,凱基-林口,2023-05-25,9257
2885,元大金,10,1,9,凱基-林口,2023-05-25,9257
4977,眾達-KY,10,1,9,凱基-林口,2023-05-25,9257
2323,中環,249,35,214,凱基-林口,2023-05-26,9257
2402,毅嘉,173,11,162,凱基-林口,2023-05-26,9257
00632R,元大台灣50反1,116,40,76,凱基-林口,2023-05-26,9257
6026,福邦證,72,0,72,凱基-林口,2023-05-26,9257
2890,永豐金,218,152,66,凱基-林口,2023-05-26,9257
00637L,元大滬深300正2,62,4,58,凱基-林口,2023-05-26,9257
5443,均豪,50,0,50,凱基-林口,2023-05-26,9257
2332,友訊,56,10,46,凱基-林口,2023-05-26,9257
2356,英業達,57,15,42,凱基-林口,2023-05-26,9257
2615,萬海,38,0,38,凱基-林口,2023-05-26,9257
2419,仲琦,37,0,37,凱基-林口,2023-05-26,9257
2883,凱基金,62,31,31,凱基-林口,2023-05-26,9257
8210,勤誠,31,0,31,凱基-林口,2023-05-26,9257
00885,富邦越南,31,0,31,凱基-林口,2023-05-26,9257
2880,華南金,30,0,30,凱基-林口,2023-05-26,9257
1605,華新,35,6,29,凱基-林口,2023-05-26,9257
8403,盛弘,27,0,27,凱基-林口,2023-05-26,9257
1783,和康生,25,1,24,凱基-林口,2023-05-26,9257
1905,華紙,36,14,22,凱基-林口,2023-05-26,9257
1314,中石化,21,0,21,凱基-林口,2023-05-26,9257
2349,錸德,20,0,20,凱基-林口,2023-05-26,9257
3028,增你強,21,1,20,凱基-林口,2023-05-26,9257
4564,元翎,27,7,20,凱基-林口,2023-05-26,9257
6233,旺玖,20,0,20,凱基-林口,2023-05-26,9257
1519,華城,35,16,19,凱基-林口,2023-05-26,9257
00680L,元大美債20正2,26,8,18,凱基-林口,2023-05-26,9257
2317,鴻海,17,0,17,凱基-林口,2023-05-26,9257
00712,復華富時不動產,16,0,16,凱基-林口,2023-05-26,9257
00692,富邦公司治理,16,0,16,凱基-林口,2023-05-26,9257
1785,光洋科,16,0,16,凱基-林口,2023-05-26,9257
3324,雙鴻,14,0,14,凱基-林口,2023-05-26,9257
2376,技嘉,21,8,13,凱基-林口,2023-05-26,9257
2303,聯電,69,57,12,凱基-林口,2023-05-26,9257
1560,中砂,12,0,12,凱基-林口,2023-05-26,9257
1609,大亞,13,1,12,凱基-林口,2023-05-26,9257
3706,神達,13,1,12,凱基-林口,2023-05-26,9257
3715,定穎投控,12,0,12,凱基-林口,2023-05-26,9257
3029,零壹,30,18,12,凱基-林口,2023-05-26,9257
00713,元大台灣高息低波,13,2,11,凱基-林口,2023-05-26,9257
1442,名軒,11,0,11,凱基-林口,2023-05-26,9257
2002,中鋼,11,0,11,凱基-林口,2023-05-26,9257
5243,乙盛-KY,13,2,11,凱基-林口,2023-05-26,9257
6470,宇智,11,0,11,凱基-林口,2023-05-26,9257
00687B,國泰20年美債,10,0,10,凱基-林口,2023-05-26,9257
2424,隴華,10,0,10,凱基-林口,2023-05-26,9257
3702,大聯大,10,0,10,凱基-林口,2023-05-26,9257
6101,寬魚國際,10,0,10,凱基-林口,2023-05-26,9257
1101,台泥,12,2,10,凱基-林口,2023-05-26,9257
2606,裕民,15,6,9,凱基-林口,2023-05-26,9257
4968,立積,8,0,8,凱基-林口,2023-05-26,9257
2409,友達,1159,0,1159,凱基-林口,2023-05-29,9257
00751B,元大AAA至A公司債,400,0,400,凱基-林口,2023-05-29,9257
6026,福邦證,178,0,178,凱基-林口,2023-05-29,9257
2614,東森,57,1,56,凱基-林口,2023-05-29,9257
00795B,中信美國公債20年,51,0,51,凱基-林口,2023-05-29,9257
2851,中再保,51,0,51,凱基-林口,2023-05-29,9257
6257,矽格,50,1,49,凱基-林口,2023-05-29,9257
2323,中環,47,6,41,凱基-林口,2023-05-29,9257
2884,玉山金,38,1,37,凱基-林口,2023-05-29,9257
00772B,中信高評級公司債,31,0,31,凱基-林口,2023-05-29,9257
00706L,期元大S＆P日圓正2,31,0,31,凱基-林口,2023-05-29,9257
2515,中工,30,0,30,凱基-林口,2023-05-29,9257
3037,欣興,31,6,25,凱基-林口,2023-05-29,9257
020022,元大電動車N,25,0,25,凱基-林口,2023-05-29,9257
2382,廣達,24,0,24,凱基-林口,2023-05-29,9257
5009,榮剛,24,0,24,凱基-林口,2023-05-29,9257
2897,王道銀行,25,4,21,凱基-林口,2023-05-29,9257
1525,江申,20,0,20,凱基-林口,2023-05-29,9257
1442,名軒,19,0,19,凱基-林口,2023-05-29,9257
3006,晶豪科,28,11,17,凱基-林口,2023-05-29,9257
2431,聯昌,15,0,15,凱基-林口,2023-05-29,9257
8069,元太,16,2,14,凱基-林口,2023-05-29,9257
1503,士電,34,20,14,凱基-林口,2023-05-29,9257
2059,川湖,15,1,14,凱基-林口,2023-05-29,9257
2206,三陽工業,17,3,14,凱基-林口,2023-05-29,9257
00679B,元大美債20年,24,11,13,凱基-林口,2023-05-29,9257
3289,宜特,16,3,13,凱基-林口,2023-05-29,9257
6125,廣運,13,0,13,凱基-林口,2023-05-29,9257
00637L,元大滬深300正2,17,5,12,凱基-林口,2023-05-29,9257
8996,高力,26,14,12,凱基-林口,2023-05-29,9257
00687B,國泰20年美債,11,0,11,凱基-林口,2023-05-29,9257
2701,萬企,11,0,11,凱基-林口,2023-05-29,9257
00680L,元大美債20正2,10,0,10,凱基-林口,2023-05-29,9257
1409,新纖,10,0,10,凱基-林口,2023-05-29,9257
2442,新美齊,11,1,10,凱基-林口,2023-05-29,9257
2883,凱基金,10,0,10,凱基-林口,2023-05-29,9257
5309,系統電,10,0,10,凱基-林口,2023-05-29,9257
6278,台表科,10,0,10,凱基-林口,2023-05-29,9257
6470,宇智,10,0,10,凱基-林口,2023-05-29,9257
8201,無敵,10,0,10,凱基-林口,2023-05-29,9257
1432,大魯閣,10,0,10,凱基-林口,2023-05-29,9257
3363,上詮,10,1,9,凱基-林口,2023-05-29,9257
00882,中信中國高股息,8,0,8,凱基-林口,2023-05-29,9257
9934,成霖,8,0,8,凱基-林口,2023-05-29,9257
00688L,國泰20年美債正2,7,0,7,凱基-林口,2023-05-29,9257
2421,建準,23,16,7,凱基-林口,2023-05-29,9257
3078,僑威,7,0,7,凱基-林口,2023-05-29,9257
3264,欣銓,10,3,7,凱基-林口,2023-05-29,9257
1560,中砂,7,1,6,凱基-林口,2023-05-29,9257
5465,富驊,8,2,6,凱基-林口,2023-05-29,9257
2610,華航,928,95,833,凱基-林口,2023-05-30,9257
2371,大同,195,88,107,凱基-林口,2023-05-30,9257
00632R,元大台灣50反1,101,0,101,凱基-林口,2023-05-30,9257
2618,長榮航,152,51,101,凱基-林口,2023-05-30,9257
00637L,元大滬深300正2,96,0,96,凱基-林口,2023-05-30,9257
00680L,元大美債20正2,110,30,80,凱基-林口,2023-05-30,9257
3710,連展投控,74,0,74,凱基-林口,2023-05-30,9257
8112,至上,70,0,70,凱基-林口,2023-05-30,9257
2105,正新,61,0,61,凱基-林口,2023-05-30,9257
6257,矽格,60,0,60,凱基-林口,2023-05-30,9257
5706,鳳凰,47,0,47,凱基-林口,2023-05-30,9257
5425,台半,45,0,45,凱基-林口,2023-05-30,9257
00679B,元大美債20年,44,0,44,凱基-林口,2023-05-30,9257
2883,凱基金,43,0,43,凱基-林口,2023-05-30,9257
1513,中興電,41,2,39,凱基-林口,2023-05-30,9257
00753L,中信中國50正2,38,0,38,凱基-林口,2023-05-30,9257
00857B,永豐20年美公債,30,0,30,凱基-林口,2023-05-30,9257
0056,元大高股息,35,6,29,凱基-林口,2023-05-30,9257
2882,國泰金,29,2,27,凱基-林口,2023-05-30,9257
5498,凱崴,26,0,26,凱基-林口,2023-05-30,9257
2382,廣達,58,32,26,凱基-林口,2023-05-30,9257
2201,裕隆,46,21,25,凱基-林口,2023-05-30,9257
00882,中信中國高股息,24,0,24,凱基-林口,2023-05-30,9257
3044,健鼎,61,37,24,凱基-林口,2023-05-30,9257
4906,正文,25,1,24,凱基-林口,2023-05-30,9257
00795B,中信美國公債20年,20,0,20,凱基-林口,2023-05-30,9257
2484,希華,22,2,20,凱基-林口,2023-05-30,9257
3702,大聯大,20,0,20,凱基-林口,2023-05-30,9257
5309,系統電,18,0,18,凱基-林口,2023-05-30,9257
3028,增你強,17,0,17,凱基-林口,2023-05-30,9257
2329,華泰,28,12,16,凱基-林口,2023-05-30,9257
3419,譁裕,18,2,16,凱基-林口,2023-05-30,9257
1605,華新,21,6,15,凱基-林口,2023-05-30,9257
2380,虹光,15,0,15,凱基-林口,2023-05-30,9257
3715,定穎投控,15,0,15,凱基-林口,2023-05-30,9257
6190,萬泰科,15,0,15,凱基-林口,2023-05-30,9257
00712,復華富時不動產,14,1,13,凱基-林口,2023-05-30,9257
00902,中信電池及儲能,12,0,12,凱基-林口,2023-05-30,9257
3231,緯創,63,52,11,凱基-林口,2023-05-30,9257
00891,中信關鍵半導體,10,0,10,凱基-林口,2023-05-30,9257
00706L,期元大S＆P日圓正2,10,0,10,凱基-林口,2023-05-30,9257
1524,耿鼎,10,0,10,凱基-林口,2023-05-30,9257
1560,中砂,10,0,10,凱基-林口,2023-05-30,9257
2104,國際中橡,10,0,10,凱基-林口,2023-05-30,9257
4973,廣穎,10,0,10,凱基-林口,2023-05-30,9257
6470,宇智,10,0,10,凱基-林口,2023-05-30,9257
9904,寶成,10,0,10,凱基-林口,2023-05-30,9257
2388,威盛,9,0,9,凱基-林口,2023-05-30,9257
2031,新光鋼,9,0,9,凱基-林口,2023-05-30,9257
2324,仁寶,34,25,9,凱基-林口,2023-05-30,9257
00772B,中信高評級公司債,110,5,105,凱基-林口,2023-05-31,9257
2515,中工,606,505,101,凱基-林口,2023-05-31,9257
8374,羅昇,92,0,92,凱基-林口,2023-05-31,9257
00680L,元大美債20正2,75,1,74,凱基-林口,2023-05-31,9257
00637L,元大滬深300正2,70,0,70,凱基-林口,2023-05-31,9257
00753L,中信中國50正2,50,0,50,凱基-林口,2023-05-31,9257
3231,緯創,83,37,46,凱基-林口,2023-05-31,9257
3264,欣銓,46,0,46,凱基-林口,2023-05-31,9257
1314,中石化,52,10,42,凱基-林口,2023-05-31,9257
5512,力麒,30,0,30,凱基-林口,2023-05-31,9257
2705,六福,26,0,26,凱基-林口,2023-05-31,9257
2328,廣宇,55,30,25,凱基-林口,2023-05-31,9257
2891,中信金,25,0,25,凱基-林口,2023-05-31,9257
2610,華航,53,30,23,凱基-林口,2023-05-31,9257
5328,華容,22,0,22,凱基-林口,2023-05-31,9257
00642U,期元大S＆P石油,21,0,21,凱基-林口,2023-05-31,9257
00795B,中信美國公債20年,20,0,20,凱基-林口,2023-05-31,9257
3380,明泰,40,21,19,凱基-林口,2023-05-31,9257
4968,立積,21,2,19,凱基-林口,2023-05-31,9257
00878,國泰永續高股息,21,3,18,凱基-林口,2023-05-31,9257
6271,同欣電,18,1,17,凱基-林口,2023-05-31,9257
6470,宇智,16,0,16,凱基-林口,2023-05-31,9257
00882,中信中國高股息,15,0,15,凱基-林口,2023-05-31,9257
00919,群益台灣精選高息,15,0,15,凱基-林口,2023-05-31,9257
2103,台橡,13,0,13,凱基-林口,2023-05-31,9257
2888,新光金,13,0,13,凱基-林口,2023-05-31,9257
6180,橘子,14,1,13,凱基-林口,2023-05-31,9257
6189,豐藝,13,0,13,凱基-林口,2023-05-31,9257
6235,華孚,19,6,13,凱基-林口,2023-05-31,9257
2609,陽明,12,0,12,凱基-林口,2023-05-31,9257
00679B,元大美債20年,12,0,12,凱基-林口,2023-05-31,9257
00715L,期街口布蘭特正2,23,11,12,凱基-林口,2023-05-31,9257
3037,欣興,12,0,12,凱基-林口,2023-05-31,9257
1503,士電,11,0,11,凱基-林口,2023-05-31,9257
4973,廣穎,18,7,11,凱基-林口,2023-05-31,9257
4977,眾達-KY,12,1,11,凱基-林口,2023-05-31,9257
6223,旺矽,11,0,11,凱基-林口,2023-05-31,9257
1802,台玻,10,0,10,凱基-林口,2023-05-31,9257
2344,華邦電,60,50,10,凱基-林口,2023-05-31,9257
3046,建��,10,0,10,凱基-林口,2023-05-31,9257
6104,創惟,21,11,10,凱基-林口,2023-05-31,9257
8059,凱碩,10,0,10,凱基-林口,2023-05-31,9257
2883,凱基金,11,1,10,凱基-林口,2023-05-31,9257
6515,穎崴,8,0,8,凱基-林口,2023-05-31,9257
2002,中鋼,8,1,7,凱基-林口,2023-05-31,9257
2457,飛宏,21,14,7,凱基-林口,2023-05-31,9257
3552,同致,7,0,7,凱基-林口,2023-05-31,9257
4967,十銓,11,4,7,凱基-林口,2023-05-31,9257
4979,華星光,28,21,7,凱基-林口,2023-05-31,9257
00712,復華富時不動產,10,4,6,凱基-林口,2023-05-31,9257
2303,聯電,1017,7,1010,凱基-林口,2023-06-01,9257
2515,中工,1038,60,978,凱基-林口,2023-06-01,9257
3706,神達,261,52,209,凱基-林口,2023-06-01,9257
3564,其陽,88,0,88,凱基-林口,2023-06-01,9257
2402,毅嘉,74,11,63,凱基-林口,2023-06-01,9257
2883,凱基金,60,0,60,凱基-林口,2023-06-01,9257
6118,建達,52,0,52,凱基-林口,2023-06-01,9257
3703,欣陸,37,0,37,凱基-林口,2023-06-01,9257
00888,永豐台灣ESG,34,0,34,凱基-林口,2023-06-01,9257
2748,雲品,46,12,34,凱基-林口,2023-06-01,9257
3062,建漢,52,22,30,凱基-林口,2023-06-01,9257
6026,福邦證,26,0,26,凱基-林口,2023-06-01,9257
2888,新光金,25,0,25,凱基-林口,2023-06-01,9257
3252,海灣,23,1,22,凱基-林口,2023-06-01,9257
2371,大同,26,5,21,凱基-林口,2023-06-01,9257
3594,磐儀,21,0,21,凱基-林口,2023-06-01,9257
2913,農林,29,9,20,凱基-林口,2023-06-01,9257
6276,安鈦克,20,0,20,凱基-林口,2023-06-01,9257
1519,華城,29,10,19,凱基-林口,2023-06-01,9257
4564,元翎,27,10,17,凱基-林口,2023-06-01,9257
00642U,期元大S＆P石油,15,0,15,凱基-林口,2023-06-01,9257
00679B,元大美債20年,15,1,14,凱基-林口,2023-06-01,9257
4164,承業醫,14,0,14,凱基-林口,2023-06-01,9257
1710,東聯,14,1,13,凱基-林口,2023-06-01,9257
2495,普安,13,0,13,凱基-林口,2023-06-01,9257
00919,群益台灣精選高息,17,4,13,凱基-林口,2023-06-01,9257
1101,台泥,12,0,12,凱基-林口,2023-06-01,9257
0056,元大高股息,12,1,11,凱基-林口,2023-06-01,9257
6188,廣明,19,8,11,凱基-林口,2023-06-01,9257
3260,威剛,10,0,10,凱基-林口,2023-06-01,9257
1312,國喬,10,0,10,凱基-林口,2023-06-01,9257
1432,大魯閣,10,0,10,凱基-林口,2023-06-01,9257
1709,和益,10,0,10,凱基-林口,2023-06-01,9257
1721,三晃,24,14,10,凱基-林口,2023-06-01,9257
1722,台肥,10,0,10,凱基-林口,2023-06-01,9257
2892,第一金,10,0,10,凱基-林口,2023-06-01,9257
4167,松瑞藥,10,0,10,凱基-林口,2023-06-01,9257
5512,力麒,20,10,10,凱基-林口,2023-06-01,9257
1608,華榮,10,1,9,凱基-林口,2023-06-01,9257
5243,乙盛-KY,11,2,9,凱基-林口,2023-06-01,9257
1444,力麗,8,0,8,凱基-林口,2023-06-01,9257
00706L,期元大S＆P日圓正2,13,5,8,凱基-林口,2023-06-01,9257
2358,廷鑫,8,0,8,凱基-林口,2023-06-01,9257
3019,亞光,11,3,8,凱基-林口,2023-06-01,9257
8210,勤誠,9,1,8,凱基-林口,2023-06-01,9257
00715L,期街口布蘭特正2,7,0,7,凱基-林口,2023-06-01,9257
1605,華新,8,1,7,凱基-林口,2023-06-01,9257
2330,台積電,6,0,6,凱基-林口,2023-06-01,9257
2739,寒舍,6,0,6,凱基-林口,2023-06-01,9257
00795B,中信美國公債20年,6,0,6,凱基-林口,2023-06-01,9257
2618,長榮航,2137,132,2005,凱基-林口,2023-06-02,9257
00632R,元大台灣50反1,223,15,208,凱基-林口,2023-06-02,9257
3706,神達,167,20,147,凱基-林口,2023-06-02,9257
00882,中信中國高股息,91,0,91,凱基-林口,2023-06-02,9257
2890,永豐金,112,58,54,凱基-林口,2023-06-02,9257
4543,萬在,45,0,45,凱基-林口,2023-06-02,9257
6026,福邦證,44,0,44,凱基-林口,2023-06-02,9257
1101,台泥,53,20,33,凱基-林口,2023-06-02,9257
5704,老爺知,28,0,28,凱基-林口,2023-06-02,9257
1533,車王電,26,0,26,凱基-林口,2023-06-02,9257
2489,瑞軒,44,18,26,凱基-林口,2023-06-02,9257
2105,正新,35,11,24,凱基-林口,2023-06-02,9257
00679B,元大美債20年,24,0,24,凱基-林口,2023-06-02,9257
6535,順藥,25,2,23,凱基-林口,2023-06-02,9257
2892,第一金,26,4,22,凱基-林口,2023-06-02,9257
3617,碩天,22,0,22,凱基-林口,2023-06-02,9257
2436,偉詮電,21,0,21,凱基-林口,2023-06-02,9257
4953,緯軟,20,0,20,凱基-林口,2023-06-02,9257
1308,亞聚,20,1,19,凱基-林口,2023-06-02,9257
1905,華紙,30,11,19,凱基-林口,2023-06-02,9257
00665L,富邦�琤肭磪囓�2,22,4,18,凱基-林口,2023-06-02,9257
3260,威剛,18,0,18,凱基-林口,2023-06-02,9257
8048,德勝,18,0,18,凱基-林口,2023-06-02,9257
2851,中再保,20,3,17,凱基-林口,2023-06-02,9257
4564,元翎,24,7,17,凱基-林口,2023-06-02,9257
00712,復華富時不動產,17,1,16,凱基-林口,2023-06-02,9257
2633,台灣高鐵,15,0,15,凱基-林口,2023-06-02,9257
00640L,富邦日本正2,14,0,14,凱基-林口,2023-06-02,9257
00919,群益台灣精選高息,13,0,13,凱基-林口,2023-06-02,9257
2603,長榮,14,1,13,凱基-林口,2023-06-02,9257
6770,力積電,13,0,13,凱基-林口,2023-06-02,9257
3047,訊舟,23,10,13,凱基-林口,2023-06-02,9257
00885,富邦越南,11,0,11,凱基-林口,2023-06-02,9257
4967,十銓,11,0,11,凱基-林口,2023-06-02,9257
6276,安鈦克,11,0,11,凱基-林口,2023-06-02,9257
1210,大成,10,0,10,凱基-林口,2023-06-02,9257
00795B,中信美國公債20年,10,0,10,凱基-林口,2023-06-02,9257
2748,雲品,10,0,10,凱基-林口,2023-06-02,9257
3252,海灣,11,1,10,凱基-林口,2023-06-02,9257
3419,譁裕,10,0,10,凱基-林口,2023-06-02,9257
3704,合勤控,10,0,10,凱基-林口,2023-06-02,9257
6525,捷敏-KY,10,0,10,凱基-林口,2023-06-02,9257
6672,騰輝電子-KY,10,0,10,凱基-林口,2023-06-02,9257
2888,新光金,10,0,10,凱基-林口,2023-06-02,9257
3037,欣興,13,4,9,凱基-林口,2023-06-02,9257
2409,友達,10,1,9,凱基-林口,2023-06-02,9257
4763,材料-KY,13,5,8,凱基-林口,2023-06-02,9257
6288,聯嘉,8,0,8,凱基-林口,2023-06-02,9257
2610,華航,153,146,7,凱基-林口,2023-06-02,9257
1218,泰山,6,0,6,凱基-林口,2023-06-02,9257
2610,華航,347,132,215,凱基-林口,2023-06-05,9257
2515,中工,660,521,139,凱基-林口,2023-06-05,9257
2618,長榮航,150,37,113,凱基-林口,2023-06-05,9257
5465,富驊,106,6,100,凱基-林口,2023-06-05,9257
6276,安鈦克,70,0,70,凱基-林口,2023-06-05,9257
00878,國泰永續高股息,98,33,65,凱基-林口,2023-06-05,9257
2812,台中銀,55,0,55,凱基-林口,2023-06-05,9257
6026,福邦證,50,0,50,凱基-林口,2023-06-05,9257
2206,三陽工業,92,43,49,凱基-林口,2023-06-05,9257
6125,廣運,45,4,41,凱基-林口,2023-06-05,9257
2888,新光金,117,81,36,凱基-林口,2023-06-05,9257
3715,定穎投控,36,1,35,凱基-林口,2023-06-05,9257
3231,緯創,74,40,34,凱基-林口,2023-06-05,9257
00679B,元大美債20年,30,0,30,凱基-林口,2023-06-05,9257
2457,飛宏,39,10,29,凱基-林口,2023-06-05,9257
8011,台通,30,2,28,凱基-林口,2023-06-05,9257
8213,志超,27,0,27,凱基-林口,2023-06-05,9257
2436,偉詮電,24,0,24,凱基-林口,2023-06-05,9257
2481,強茂,31,8,23,凱基-林口,2023-06-05,9257
00720B,元大投資級公司債,22,0,22,凱基-林口,2023-06-05,9257
00650L,復華香港正2,20,0,20,凱基-林口,2023-06-05,9257
1442,名軒,20,0,20,凱基-林口,2023-06-05,9257
911868,同方友友-DR,20,0,20,凱基-林口,2023-06-05,9257
3058,立德,18,1,17,凱基-林口,2023-06-05,9257
4938,和碩,21,5,16,凱基-林口,2023-06-05,9257
1519,華城,94,78,16,凱基-林口,2023-06-05,9257
1905,華紙,25,9,16,凱基-林口,2023-06-05,9257
1907,永豐餘,20,4,16,凱基-林口,2023-06-05,9257
2883,凱基金,18,2,16,凱基-林口,2023-06-05,9257
00632R,元大台灣50反1,20,5,15,凱基-林口,2023-06-05,9257
8027,鈦昇,15,0,15,凱基-林口,2023-06-05,9257
4931,新盛力,25,10,15,凱基-林口,2023-06-05,9257
00751B,元大AAA至A公司債,14,0,14,凱基-林口,2023-06-05,9257
2382,廣達,16,2,14,凱基-林口,2023-06-05,9257
1711,永光,24,11,13,凱基-林口,2023-06-05,9257
8069,元太,24,11,13,凱基-林口,2023-06-05,9257
00885,富邦越南,13,0,13,凱基-林口,2023-06-05,9257
2399,映泰,22,10,12,凱基-林口,2023-06-05,9257
3013,晟銘電,12,0,12,凱基-林口,2023-06-05,9257
3265,台星科,12,0,12,凱基-林口,2023-06-05,9257
4916,事欣科,32,20,12,凱基-林口,2023-06-05,9257
1514,亞力,17,6,11,凱基-林口,2023-06-05,9257
2303,聯電,11,0,11,凱基-林口,2023-06-05,9257
3591,艾笛森,11,0,11,凱基-林口,2023-06-05,9257
6266,泰詠,11,0,11,凱基-林口,2023-06-05,9257
00919,群益台灣精選高息,10,0,10,凱基-林口,2023-06-05,9257
1560,中砂,10,0,10,凱基-林口,2023-06-05,9257
2014,中鴻,11,1,10,凱基-林口,2023-06-05,9257
2104,國際中橡,10,0,10,凱基-林口,2023-06-05,9257
3052,夆典,10,0,10,凱基-林口,2023-06-05,9257
2402,毅嘉,193,6,187,凱基-林口,2023-06-06,9257
2427,三商電,109,7,102,凱基-林口,2023-06-06,9257
2461,光群雷,118,30,88,凱基-林口,2023-06-06,9257
4533,協易機,86,13,73,凱基-林口,2023-06-06,9257
00632R,元大台灣50反1,52,0,52,凱基-林口,2023-06-06,9257
2888,新光金,56,5,51,凱基-林口,2023-06-06,9257
2399,映泰,53,5,48,凱基-林口,2023-06-06,9257
5425,台半,44,0,44,凱基-林口,2023-06-06,9257
00679B,元大美債20年,42,0,42,凱基-林口,2023-06-06,9257
00680L,元大美債20正2,42,0,42,凱基-林口,2023-06-06,9257
00919,群益台灣精選高息,38,0,38,凱基-林口,2023-06-06,9257
00927,群益半導體收益,32,0,32,凱基-林口,2023-06-06,9257
5512,力麒,30,0,30,凱基-林口,2023-06-06,9257
2419,仲琦,29,0,29,凱基-林口,2023-06-06,9257
3481,群創,41,16,25,凱基-林口,2023-06-06,9257
1905,華紙,33,9,24,凱基-林口,2023-06-06,9257
4950,牧東,23,2,21,凱基-林口,2023-06-06,9257
2380,虹光,20,0,20,凱基-林口,2023-06-06,9257
2408,南亞科,20,0,20,凱基-林口,2023-06-06,9257
3231,緯創,70,50,20,凱基-林口,2023-06-06,9257
3594,磐儀,20,0,20,凱基-林口,2023-06-06,9257
8028,昇陽半導體,21,1,20,凱基-林口,2023-06-06,9257
2371,大同,22,4,18,凱基-林口,2023-06-06,9257
3715,定穎投控,18,0,18,凱基-林口,2023-06-06,9257
1514,亞力,20,2,18,凱基-林口,2023-06-06,9257
00713,元大台灣高息低波,17,0,17,凱基-林口,2023-06-06,9257
1605,華新,26,9,17,凱基-林口,2023-06-06,9257
2353,宏��,19,2,17,凱基-林口,2023-06-06,9257
2455,全新,16,0,16,凱基-林口,2023-06-06,9257
1201,味全,15,0,15,凱基-林口,2023-06-06,9257
00664R,國泰臺灣加權反1,15,0,15,凱基-林口,2023-06-06,9257
3548,兆利,15,0,15,凱基-林口,2023-06-06,9257
8996,高力,19,4,15,凱基-林口,2023-06-06,9257
5498,凱崴,14,0,14,凱基-林口,2023-06-06,9257
2498,宏達電,20,7,13,凱基-林口,2023-06-06,9257
3071,協禧,13,0,13,凱基-林口,2023-06-06,9257
8213,志超,13,0,13,凱基-林口,2023-06-06,9257
1504,東元,14,2,12,凱基-林口,2023-06-06,9257
2481,強茂,12,0,12,凱基-林口,2023-06-06,9257
3265,台星科,12,0,12,凱基-林口,2023-06-06,9257
6143,振曜,12,0,12,凱基-林口,2023-06-06,9257
8105,凌巨,22,10,12,凱基-林口,2023-06-06,9257
1513,中興電,11,0,11,凱基-林口,2023-06-06,9257
2442,新美齊,11,0,11,凱基-林口,2023-06-06,9257
3025,星通,12,1,11,凱基-林口,2023-06-06,9257
4906,正文,14,3,11,凱基-林口,2023-06-06,9257
00720B,元大投資級公司債,10,0,10,凱基-林口,2023-06-06,9257
1340,勝悅-KY,10,0,10,凱基-林口,2023-06-06,9257
3162,精確,11,1,10,凱基-林口,2023-06-06,9257
3515,華擎,10,0,10,凱基-林口,2023-06-06,9257
3231,緯創,223,110,113,凱基-林口,2023-06-07,9257
5465,富驊,76,0,76,凱基-林口,2023-06-07,9257
2323,中環,44,10,34,凱基-林口,2023-06-07,9257
00637L,元大滬深300正2,35,4,31,凱基-林口,2023-06-07,9257
4114,健喬,31,0,31,凱基-林口,2023-06-07,9257
1442,名軒,30,0,30,凱基-林口,2023-06-07,9257
1609,大亞,68,39,29,凱基-林口,2023-06-07,9257
1616,億泰,21,0,21,凱基-林口,2023-06-07,9257
6276,安鈦克,30,9,21,凱基-林口,2023-06-07,9257
2104,國際中橡,20,0,20,凱基-林口,2023-06-07,9257
3014,聯陽,20,0,20,凱基-林口,2023-06-07,9257
00919,群益台灣精選高息,20,1,19,凱基-林口,2023-06-07,9257
4927,泰鼎-KY,20,2,18,凱基-林口,2023-06-07,9257
1102,亞泥,20,3,17,凱基-林口,2023-06-07,9257
3037,欣興,22,7,15,凱基-林口,2023-06-07,9257
2634,漢翔,15,0,15,凱基-林口,2023-06-07,9257
00666R,富邦�琤肭磪齯�1,14,0,14,凱基-林口,2023-06-07,9257
1519,華城,22,9,13,凱基-林口,2023-06-07,9257
2440,太空梭,15,2,13,凱基-林口,2023-06-07,9257
1446,宏和,12,0,12,凱基-林口,2023-06-07,9257
00922,國泰台灣領袖50,11,0,11,凱基-林口,2023-06-07,9257
6235,華孚,38,27,11,凱基-林口,2023-06-07,9257
1589,永冠-KY,12,2,10,凱基-林口,2023-06-07,9257
00680L,元大美債20正2,30,20,10,凱基-林口,2023-06-07,9257
00679B,元大美債20年,11,1,10,凱基-林口,2023-06-07,9257
00927,群益半導體收益,10,0,10,凱基-林口,2023-06-07,9257
2014,中鴻,10,0,10,凱基-林口,2023-06-07,9257
2337,旺宏,10,0,10,凱基-林口,2023-06-07,9257
2606,裕民,10,0,10,凱基-林口,2023-06-07,9257
4532,瑞智,10,0,10,凱基-林口,2023-06-07,9257
5609,中菲行,10,0,10,凱基-林口,2023-06-07,9257
6153,嘉聯益,11,1,10,凱基-林口,2023-06-07,9257
6591,動力-KY,10,0,10,凱基-林口,2023-06-07,9257
8059,凱碩,10,0,10,凱基-林口,2023-06-07,9257
2376,技嘉,16,8,8,凱基-林口,2023-06-07,9257
1560,中砂,12,4,8,凱基-林口,2023-06-07,9257
3071,協禧,17,9,8,凱基-林口,2023-06-07,9257
2356,英業達,14,7,7,凱基-林口,2023-06-07,9257
2882,國泰金,7,0,7,凱基-林口,2023-06-07,9257
3013,晟銘電,27,20,7,凱基-林口,2023-06-07,9257
4979,華星光,11,4,7,凱基-林口,2023-06-07,9257
5309,系統電,10,3,7,凱基-林口,2023-06-07,9257
6188,廣明,7,0,7,凱基-林口,2023-06-07,9257
6191,精成科,17,10,7,凱基-林口,2023-06-07,9257
4763,材料-KY,9,3,6,凱基-林口,2023-06-07,9257
1514,亞力,8,2,6,凱基-林口,2023-06-07,9257
1591,駿吉-KY,6,0,6,凱基-林口,2023-06-07,9257
1710,東聯,6,0,6,凱基-林口,2023-06-07,9257
3048,益登,6,0,6,凱基-林口,2023-06-07,9257
6244,茂迪,7,1,6,凱基-林口,2023-06-07,9257
2402,毅嘉,216,7,209,凱基-林口,2023-06-08,9257
5609,中菲行,85,10,75,凱基-林口,2023-06-08,9257
00919,群益台灣精選高息,61,0,61,凱基-林口,2023-06-08,9257
00679B,元大美債20年,52,1,51,凱基-林口,2023-06-08,9257
2609,陽明,100,54,46,凱基-林口,2023-06-08,9257
3374,精材,57,16,41,凱基-林口,2023-06-08,9257
3583,辛耘,45,5,40,凱基-林口,2023-06-08,9257
2323,中環,39,6,33,凱基-林口,2023-06-08,9257
00632R,元大台灣50反1,60,30,30,凱基-林口,2023-06-08,9257
1605,華新,30,3,27,凱基-林口,2023-06-08,9257
2427,三商電,27,0,27,凱基-林口,2023-06-08,9257
6203,海韻電,42,15,27,凱基-林口,2023-06-08,9257
2850,新產,25,0,25,凱基-林口,2023-06-08,9257
5905,南仁湖,25,0,25,凱基-林口,2023-06-08,9257
8213,志超,25,1,24,凱基-林口,2023-06-08,9257
2390,云辰,22,0,22,凱基-林口,2023-06-08,9257
2399,映泰,40,18,22,凱基-林口,2023-06-08,9257
3511,矽瑪,22,0,22,凱基-林口,2023-06-08,9257
2812,台中銀,21,0,21,凱基-林口,2023-06-08,9257
00687B,國泰20年美債,20,0,20,凱基-林口,2023-06-08,9257
2425,承啟,18,0,18,凱基-林口,2023-06-08,9257
0056,元大高股息,18,1,17,凱基-林口,2023-06-08,9257
2330,台積電,17,0,17,凱基-林口,2023-06-08,9257
2337,旺宏,16,0,16,凱基-林口,2023-06-08,9257
8069,元太,18,3,15,凱基-林口,2023-06-08,9257
8076,伍豐,15,0,15,凱基-林口,2023-06-08,9257
8996,高力,14,0,14,凱基-林口,2023-06-08,9257
1442,名軒,13,0,13,凱基-林口,2023-06-08,9257
1612,宏泰,54,41,13,凱基-林口,2023-06-08,9257
3071,協禧,13,0,13,凱基-林口,2023-06-08,9257
00751B,元大AAA至A公司債,12,0,12,凱基-林口,2023-06-08,9257
2882,國泰金,12,0,12,凱基-林口,2023-06-08,9257
2105,正新,12,0,12,凱基-林口,2023-06-08,9257
6285,啟��,16,5,11,凱基-林口,2023-06-08,9257
00713,元大台灣高息低波,11,0,11,凱基-林口,2023-06-08,9257
00882,中信中國高股息,11,0,11,凱基-林口,2023-06-08,9257
2356,英業達,14,3,11,凱基-林口,2023-06-08,9257
3363,上詮,11,0,11,凱基-林口,2023-06-08,9257
8215,明基材,11,0,11,凱基-林口,2023-06-08,9257
1609,大亞,60,49,11,凱基-林口,2023-06-08,9257
2603,長榮,31,20,11,凱基-林口,2023-06-08,9257
2027,大成鋼,12,2,10,凱基-林口,2023-06-08,9257
3189,景碩,11,1,10,凱基-林口,2023-06-08,9257
3037,欣興,22,12,10,凱基-林口,2023-06-08,9257
00900,富邦特選高股息30,10,0,10,凱基-林口,2023-06-08,9257
1340,勝悅-KY,10,0,10,凱基-林口,2023-06-08,9257
2380,虹光,10,0,10,凱基-林口,2023-06-08,9257
2461,光群雷,11,1,10,凱基-林口,2023-06-08,9257
2890,永豐金,10,0,10,凱基-林口,2023-06-08,9257
3712,永崴投控,10,0,10,凱基-林口,2023-06-08,9257
2515,中工,691,213,478,凱基-林口,2023-06-09,9257
3706,神達,202,3,199,凱基-林口,2023-06-09,9257
2352,佳世達,143,24,119,凱基-林口,2023-06-09,9257
00751B,元大AAA至A公司債,100,5,95,凱基-林口,2023-06-09,9257
6026,福邦證,60,0,60,凱基-林口,2023-06-09,9257
3576,聯合再生,50,0,50,凱基-林口,2023-06-09,9257
00885,富邦越南,50,1,49,凱基-林口,2023-06-09,9257
00929,復華台灣科技優息,48,0,48,凱基-林口,2023-06-09,9257
00680L,元大美債20正2,40,0,40,凱基-林口,2023-06-09,9257
1710,東聯,47,9,38,凱基-林口,2023-06-09,9257
5609,中菲行,35,0,35,凱基-林口,2023-06-09,9257
6743,安普新,35,14,21,凱基-林口,2023-06-09,9257
2834,臺企銀,21,0,21,凱基-林口,2023-06-09,9257
9943,好樂迪,42,22,20,凱基-林口,2023-06-09,9257
2705,六福,20,0,20,凱基-林口,2023-06-09,9257
6125,廣運,21,2,19,凱基-林口,2023-06-09,9257
2748,雲品,18,0,18,凱基-林口,2023-06-09,9257
3346,麗清,20,2,18,凱基-林口,2023-06-09,9257
1504,東元,15,0,15,凱基-林口,2023-06-09,9257
2337,旺宏,16,1,15,凱基-林口,2023-06-09,9257
3152,璟德,15,0,15,凱基-林口,2023-06-09,9257
4533,協易機,15,0,15,凱基-林口,2023-06-09,9257
5704,老爺知,15,0,15,凱基-林口,2023-06-09,9257
00715L,期街口布蘭特正2,15,2,13,凱基-林口,2023-06-09,9257
3202,樺晟,13,0,13,凱基-林口,2023-06-09,9257
2458,義隆,13,1,12,凱基-林口,2023-06-09,9257
6266,泰詠,15,3,12,凱基-林口,2023-06-09,9257
6697,東捷資訊,12,0,12,凱基-林口,2023-06-09,9257
00919,群益台灣精選高息,11,0,11,凱基-林口,2023-06-09,9257
00713,元大台灣高息低波,11,0,11,凱基-林口,2023-06-09,9257
2201,裕隆,12,1,11,凱基-林口,2023-06-09,9257
6282,康舒,11,0,11,凱基-林口,2023-06-09,9257
8926,台汽電,23,12,11,凱基-林口,2023-06-09,9257
00712,復華富時不動產,11,1,10,凱基-林口,2023-06-09,9257
00632R,元大台灣50反1,10,0,10,凱基-林口,2023-06-09,9257
1446,宏和,10,0,10,凱基-林口,2023-06-09,9257
3232,昱捷,10,0,10,凱基-林口,2023-06-09,9257
4532,瑞智,10,0,10,凱基-林口,2023-06-09,9257
8105,凌巨,10,0,10,凱基-林口,2023-06-09,9257
2634,漢翔,11,2,9,凱基-林口,2023-06-09,9257
2890,永豐金,9,0,9,凱基-林口,2023-06-09,9257
1802,台玻,9,0,9,凱基-林口,2023-06-09,9257
6101,寬魚國際,9,0,9,凱基-林口,2023-06-09,9257
8446,華研,9,0,9,凱基-林口,2023-06-09,9257
4953,緯軟,10,1,9,凱基-林口,2023-06-09,9257
5443,均豪,11,3,8,凱基-林口,2023-06-09,9257
00642U,期元大S＆P石油,8,0,8,凱基-林口,2023-06-09,9257
2892,第一金,8,0,8,凱基-林口,2023-06-09,9257
3058,立德,12,4,8,凱基-林口,2023-06-09,9257
3260,威剛,8,0,8,凱基-林口,2023-06-09,9257
00712,復華富時不動產,626,0,626,凱基-林口,2023-06-12,9257
2618,長榮航,605,31,574,凱基-林口,2023-06-12,9257
2888,新光金,413,50,363,凱基-林口,2023-06-12,9257
3231,緯創,120,32,88,凱基-林口,2023-06-12,9257
1513,中興電,84,1,83,凱基-林口,2023-06-12,9257
2388,威盛,71,1,70,凱基-林口,2023-06-12,9257
2449,京元電子,71,1,70,凱基-林口,2023-06-12,9257
5425,台半,101,31,70,凱基-林口,2023-06-12,9257
00929,復華台灣科技優息,62,0,62,凱基-林口,2023-06-12,9257
00919,群益台灣精選高息,75,19,56,凱基-林口,2023-06-12,9257
2352,佳世達,56,2,54,凱基-林口,2023-06-12,9257
1710,東聯,52,0,52,凱基-林口,2023-06-12,9257
2313,華通,52,0,52,凱基-林口,2023-06-12,9257
2402,毅嘉,56,5,51,凱基-林口,2023-06-12,9257
3715,定穎投控,42,0,42,凱基-林口,2023-06-12,9257
5905,南仁湖,40,0,40,凱基-林口,2023-06-12,9257
2312,金寶,29,2,27,凱基-林口,2023-06-12,9257
0056,元大高股息,54,32,22,凱基-林口,2023-06-12,9257
4157,太景*-KY,21,0,21,凱基-林口,2023-06-12,9257
8358,金居,23,3,20,凱基-林口,2023-06-12,9257
2356,英業達,23,3,20,凱基-林口,2023-06-12,9257
2332,友訊,20,0,20,凱基-林口,2023-06-12,9257
3374,精材,29,9,20,凱基-林口,2023-06-12,9257
2382,廣達,45,26,19,凱基-林口,2023-06-12,9257
00642U,期元大S＆P石油,19,0,19,凱基-林口,2023-06-12,9257
2031,新光鋼,18,0,18,凱基-林口,2023-06-12,9257
3062,建漢,20,3,17,凱基-林口,2023-06-12,9257
6122,擎邦,22,5,17,凱基-林口,2023-06-12,9257
8210,勤誠,18,1,17,凱基-林口,2023-06-12,9257
2329,華泰,26,10,16,凱基-林口,2023-06-12,9257
2461,光群雷,25,10,15,凱基-林口,2023-06-12,9257
2913,農林,15,0,15,凱基-林口,2023-06-12,9257
5609,中菲行,14,0,14,凱基-林口,2023-06-12,9257
00715L,期街口布蘭特正2,13,0,13,凱基-林口,2023-06-12,9257
2201,裕隆,13,0,13,凱基-林口,2023-06-12,9257
5530,龍巖,13,0,13,凱基-林口,2023-06-12,9257
8996,高力,13,0,13,凱基-林口,2023-06-12,9257
1720,生達,12,0,12,凱基-林口,2023-06-12,9257
3481,群創,18,6,12,凱基-林口,2023-06-12,9257
2457,飛宏,13,2,11,凱基-林口,2023-06-12,9257
3027,盛達,13,2,11,凱基-林口,2023-06-12,9257
00632R,元大台灣50反1,60,50,10,凱基-林口,2023-06-12,9257
1220,台榮,10,0,10,凱基-林口,2023-06-12,9257
1308,亞聚,10,0,10,凱基-林口,2023-06-12,9257
2630,亞航,15,5,10,凱基-林口,2023-06-12,9257
2722,夏都,10,0,10,凱基-林口,2023-06-12,9257
2801,彰銀,10,0,10,凱基-林口,2023-06-12,9257
2834,臺企銀,14,4,10,凱基-林口,2023-06-12,9257
3209,全科,10,0,10,凱基-林口,2023-06-12,9257
6158,禾昌,10,0,10,凱基-林口,2023-06-12,9257
3706,神達,201,8,193,凱基-林口,2023-06-13,9257
2402,毅嘉,110,1,109,凱基-林口,2023-06-13,9257
1785,光洋科,109,13,96,凱基-林口,2023-06-13,9257
2888,新光金,76,0,76,凱基-林口,2023-06-13,9257
2436,偉詮電,53,1,52,凱基-林口,2023-06-13,9257
3576,聯合再生,52,0,52,凱基-林口,2023-06-13,9257
5498,凱崴,40,0,40,凱基-林口,2023-06-13,9257
00919,群益台灣精選高息,40,3,37,凱基-林口,2023-06-13,9257
2614,東森,33,0,33,凱基-林口,2023-06-13,9257
2705,六福,32,0,32,凱基-林口,2023-06-13,9257
00715L,期街口布蘭特正2,31,0,31,凱基-林口,2023-06-13,9257
2312,金寶,30,0,30,凱基-林口,2023-06-13,9257
2432,倚天酷��-創,29,0,29,凱基-林口,2023-06-13,9257
6689,伊雲谷,27,0,27,凱基-林口,2023-06-13,9257
00642U,期元大S＆P石油,25,0,25,凱基-林口,2023-06-13,9257
8358,金居,25,0,25,凱基-林口,2023-06-13,9257
2328,廣宇,24,1,23,凱基-林口,2023-06-13,9257
00929,復華台灣科技優息,46,24,22,凱基-林口,2023-06-13,9257
1524,耿鼎,27,6,21,凱基-林口,2023-06-13,9257
00679B,元大美債20年,20,0,20,凱基-林口,2023-06-13,9257
2706,第一店,20,0,20,凱基-林口,2023-06-13,9257
3014,聯陽,20,1,19,凱基-林口,2023-06-13,9257
5340,建榮,19,0,19,凱基-林口,2023-06-13,9257
2609,陽明,22,4,18,凱基-林口,2023-06-13,9257
3715,定穎投控,17,0,17,凱基-林口,2023-06-13,9257
2882,國泰金,18,3,15,凱基-林口,2023-06-13,9257
3518,柏騰,15,0,15,凱基-林口,2023-06-13,9257
4960,誠美材,15,0,15,凱基-林口,2023-06-13,9257
5452,佶優,15,0,15,凱基-林口,2023-06-13,9257
8034,榮群,15,0,15,凱基-林口,2023-06-13,9257
00712,復華富時不動產,15,0,15,凱基-林口,2023-06-13,9257
8926,台汽電,20,6,14,凱基-林口,2023-06-13,9257
3013,晟銘電,14,0,14,凱基-林口,2023-06-13,9257
3055,蔚華科,15,2,13,凱基-林口,2023-06-13,9257
3152,璟德,13,0,13,凱基-林口,2023-06-13,9257
3231,緯創,125,112,13,凱基-林口,2023-06-13,9257
6605,帝寶,17,4,13,凱基-林口,2023-06-13,9257
2371,大同,24,12,12,凱基-林口,2023-06-13,9257
2731,雄獅,13,1,12,凱基-林口,2023-06-13,9257
3294,英濟,11,0,11,凱基-林口,2023-06-13,9257
2515,中工,20,10,10,凱基-林口,2023-06-13,9257
1104,環泥,14,4,10,凱基-林口,2023-06-13,9257
00895,富邦未來車,14,4,10,凱基-林口,2023-06-13,9257
00773B,中信優先金融債,10,0,10,凱基-林口,2023-06-13,9257
2323,中環,11,1,10,凱基-林口,2023-06-13,9257
6101,寬魚國際,10,0,10,凱基-林口,2023-06-13,9257
8059,凱碩,10,0,10,凱基-林口,2023-06-13,9257
1904,正隆,10,0,10,凱基-林口,2023-06-13,9257
9945,潤泰新,11,2,9,凱基-林口,2023-06-13,9257
1609,大亞,25,17,8,凱基-林口,2023-06-13,9257
00919,群益台灣精選高息,283,0,283,凱基-林口,2023-06-14,9257
2634,漢翔,204,0,204,凱基-林口,2023-06-14,9257
00878,國泰永續高股息,213,88,125,凱基-林口,2023-06-14,9257
3706,神達,100,1,99,凱基-林口,2023-06-14,9257
4510,高鋒,81,12,69,凱基-林口,2023-06-14,9257
2356,英業達,120,65,55,凱基-林口,2023-06-14,9257
2301,光寶科,94,42,52,凱基-林口,2023-06-14,9257
4950,牧東,52,0,52,凱基-林口,2023-06-14,9257
5258,虹堡,67,16,51,凱基-林口,2023-06-14,9257
2812,台中銀,50,0,50,凱基-林口,2023-06-14,9257
2436,偉詮電,60,11,49,凱基-林口,2023-06-14,9257
2388,威盛,43,0,43,凱基-林口,2023-06-14,9257
1104,環泥,40,1,39,凱基-林口,2023-06-14,9257
5425,台半,36,1,35,凱基-林口,2023-06-14,9257
2353,宏��,39,8,31,凱基-林口,2023-06-14,9257
00885,富邦越南,33,2,31,凱基-林口,2023-06-14,9257
8076,伍豐,30,2,28,凱基-林口,2023-06-14,9257
3623,富晶通,26,0,26,凱基-林口,2023-06-14,9257
00679B,元大美債20年,24,0,24,凱基-林口,2023-06-14,9257
1785,光洋科,24,0,24,凱基-林口,2023-06-14,9257
00924,復華S＆P500成長,20,0,20,凱基-林口,2023-06-14,9257
2354,鴻準,20,0,20,凱基-林口,2023-06-14,9257
3028,增你強,20,2,18,凱基-林口,2023-06-14,9257
8215,明基材,24,6,18,凱基-林口,2023-06-14,9257
00773B,中信優先金融債,17,0,17,凱基-林口,2023-06-14,9257
2363,矽統,15,0,15,凱基-林口,2023-06-14,9257
4931,新盛力,15,0,15,凱基-林口,2023-06-14,9257
5483,中美晶,15,0,15,凱基-林口,2023-06-14,9257
00687B,國泰20年美債,14,0,14,凱基-林口,2023-06-14,9257
2885,元大金,15,1,14,凱基-林口,2023-06-14,9257
5452,佶優,13,0,13,凱基-林口,2023-06-14,9257
1522,堤維西,30,17,13,凱基-林口,2023-06-14,9257
00772B,中信高評級公司債,12,0,12,凱基-林口,2023-06-14,9257
00688L,國泰20年美債正2,12,0,12,凱基-林口,2023-06-14,9257
9945,潤泰新,11,0,11,凱基-林口,2023-06-14,9257
1904,正隆,10,0,10,凱基-林口,2023-06-14,9257
2367,燿華,10,0,10,凱基-林口,2023-06-14,9257
2450,神腦,10,0,10,凱基-林口,2023-06-14,9257
2504,國產,10,0,10,凱基-林口,2023-06-14,9257
2706,第一店,10,0,10,凱基-林口,2023-06-14,9257
2801,彰銀,10,0,10,凱基-林口,2023-06-14,9257
3324,雙鴻,10,0,10,凱基-林口,2023-06-14,9257
3419,譁裕,10,0,10,凱基-林口,2023-06-14,9257
6265,方土昶,10,0,10,凱基-林口,2023-06-14,9257
1905,華紙,11,1,10,凱基-林口,2023-06-14,9257
1710,東聯,9,0,9,凱基-林口,2023-06-14,9257
2324,仁寶,13,4,9,凱基-林口,2023-06-14,9257
3019,亞光,20,11,9,凱基-林口,2023-06-14,9257
3711,日月光投控,10,1,9,凱基-林口,2023-06-14,9257
8050,廣積,14,5,9,凱基-林口,2023-06-14,9257
00632R,元大台灣50反1,244,16,228,凱基-林口,2023-06-15,9257
6015,宏遠證,126,0,126,凱基-林口,2023-06-15,9257
00712,復華富時不動產,118,0,118,凱基-林口,2023-06-15,9257
1513,中興電,120,9,111,凱基-林口,2023-06-15,9257
00919,群益台灣精選高息,91,2,89,凱基-林口,2023-06-15,9257
00671R,富邦NASDAQ反1,66,0,66,凱基-林口,2023-06-15,9257
2356,英業達,123,61,62,凱基-林口,2023-06-15,9257
2888,新光金,60,4,56,凱基-林口,2023-06-15,9257
00772B,中信高評級公司債,54,0,54,凱基-林口,2023-06-15,9257
6689,伊雲谷,53,0,53,凱基-林口,2023-06-15,9257
1314,中石化,54,2,52,凱基-林口,2023-06-15,9257
3481,群創,55,4,51,凱基-林口,2023-06-15,9257
2812,台中銀,50,0,50,凱基-林口,2023-06-15,9257
00927,群益半導體收益,50,0,50,凱基-林口,2023-06-15,9257
00922,國泰台灣領袖50,50,0,50,凱基-林口,2023-06-15,9257
2436,偉詮電,40,1,39,凱基-林口,2023-06-15,9257
3022,威強電,50,13,37,凱基-林口,2023-06-15,9257
4950,牧東,31,0,31,凱基-林口,2023-06-15,9257
3035,智原,35,5,30,凱基-林口,2023-06-15,9257
2388,威盛,27,1,26,凱基-林口,2023-06-15,9257
8227,巨有科技,27,2,25,凱基-林口,2023-06-15,9257
6245,立端,22,0,22,凱基-林口,2023-06-15,9257
2329,華泰,23,1,22,凱基-林口,2023-06-15,9257
1504,東元,28,7,21,凱基-林口,2023-06-15,9257
00650L,復華香港正2,20,0,20,凱基-林口,2023-06-15,9257
1446,宏和,20,0,20,凱基-林口,2023-06-15,9257
00751B,元大AAA至A公司債,20,0,20,凱基-林口,2023-06-15,9257
4973,廣穎,30,11,19,凱基-林口,2023-06-15,9257
2331,精英,22,4,18,凱基-林口,2023-06-15,9257
2392,正崴,18,0,18,凱基-林口,2023-06-15,9257
2705,六福,17,0,17,凱基-林口,2023-06-15,9257
8050,廣積,28,12,16,凱基-林口,2023-06-15,9257
2891,中信金,15,0,15,凱基-林口,2023-06-15,9257
5452,佶優,15,0,15,凱基-林口,2023-06-15,9257
1609,大亞,23,9,14,凱基-林口,2023-06-15,9257
2344,華邦電,27,14,13,凱基-林口,2023-06-15,9257
2489,瑞軒,15,2,13,凱基-林口,2023-06-15,9257
00773B,中信優先金融債,14,1,13,凱基-林口,2023-06-15,9257
6234,高僑,23,10,13,凱基-林口,2023-06-15,9257
8234,新漢,12,0,12,凱基-林口,2023-06-15,9257
1714,和桐,11,0,11,凱基-林口,2023-06-15,9257
2606,裕民,18,7,11,凱基-林口,2023-06-15,9257
00895,富邦未來車,11,1,10,凱基-林口,2023-06-15,9257
1503,士電,20,10,10,凱基-林口,2023-06-15,9257
1785,光洋科,10,0,10,凱基-林口,2023-06-15,9257
2312,金寶,10,0,10,凱基-林口,2023-06-15,9257
2376,技嘉,18,8,10,凱基-林口,2023-06-15,9257
2425,承啟,14,4,10,凱基-林口,2023-06-15,9257
2801,彰銀,10,0,10,凱基-林口,2023-06-15,9257
2867,三商壽,10,0,10,凱基-林口,2023-06-15,9257
2610,華航,3676,998,2678,凱基-林口,2023-06-16,9257
5880,合庫金,352,0,352,凱基-林口,2023-06-16,9257
2892,第一金,350,0,350,凱基-林口,2023-06-16,9257
2371,大同,322,121,201,凱基-林口,2023-06-16,9257
00919,群益台灣精選高息,75,0,75,凱基-林口,2023-06-16,9257
1609,大亞,100,29,71,凱基-林口,2023-06-16,9257
00671R,富邦NASDAQ反1,66,0,66,凱基-林口,2023-06-16,9257
2103,台橡,55,0,55,凱基-林口,2023-06-16,9257
5483,中美晶,50,3,47,凱基-林口,2023-06-16,9257
00680L,元大美債20正2,50,5,45,凱基-林口,2023-06-16,9257
2888,新光金,82,38,44,凱基-林口,2023-06-16,9257
4114,健喬,40,0,40,凱基-林口,2023-06-16,9257
8215,明基材,35,2,33,凱基-林口,2023-06-16,9257
1319,東陽,35,3,32,凱基-林口,2023-06-16,9257
2329,華泰,33,1,32,凱基-林口,2023-06-16,9257
3652,精聯,30,0,30,凱基-林口,2023-06-16,9257
5905,南仁湖,40,10,30,凱基-林口,2023-06-16,9257
4938,和碩,30,0,30,凱基-林口,2023-06-16,9257
2504,國產,26,0,26,凱基-林口,2023-06-16,9257
6015,宏遠證,24,0,24,凱基-林口,2023-06-16,9257
6788,華景電,22,0,22,凱基-林口,2023-06-16,9257
1307,三芳,31,10,21,凱基-林口,2023-06-16,9257
2812,台中銀,20,0,20,凱基-林口,2023-06-16,9257
00857B,永豐20年美公債,20,0,20,凱基-林口,2023-06-16,9257
2883,凱基金,21,1,20,凱基-林口,2023-06-16,9257
2886,兆豐金,21,1,20,凱基-林口,2023-06-16,9257
6026,福邦證,20,0,20,凱基-林口,2023-06-16,9257
6438,迅得,20,0,20,凱基-林口,2023-06-16,9257
00665L,富邦�琤肭磪囓�2,21,2,19,凱基-林口,2023-06-16,9257
4916,事欣科,34,16,18,凱基-林口,2023-06-16,9257
6684,安格,18,0,18,凱基-林口,2023-06-16,9257
2301,光寶科,41,24,17,凱基-林口,2023-06-16,9257
3685,元創精密,22,5,17,凱基-林口,2023-06-16,9257
0056,元大高股息,24,7,17,凱基-林口,2023-06-16,9257
020022,元大電動車N,15,0,15,凱基-林口,2023-06-16,9257
2489,瑞軒,16,2,14,凱基-林口,2023-06-16,9257
3617,碩天,14,0,14,凱基-林口,2023-06-16,9257
5425,台半,14,0,14,凱基-林口,2023-06-16,9257
2409,友達,29,15,14,凱基-林口,2023-06-16,9257
00893,國泰智能電動車,22,9,13,凱基-林口,2023-06-16,9257
6245,立端,13,0,13,凱基-林口,2023-06-16,9257
6282,康舒,22,9,13,凱基-林口,2023-06-16,9257
00772B,中信高評級公司債,14,2,12,凱基-林口,2023-06-16,9257
1605,華新,48,36,12,凱基-林口,2023-06-16,9257
00929,復華台灣科技優息,15,3,12,凱基-林口,2023-06-16,9257
2359,所羅門,15,3,12,凱基-林口,2023-06-16,9257
3152,璟德,12,0,12,凱基-林口,2023-06-16,9257
3682,亞太電,12,0,12,凱基-林口,2023-06-16,9257
6147,頎邦,13,1,12,凱基-林口,2023-06-16,9257
6689,伊雲谷,14,2,12,凱基-林口,2023-06-16,9257
2610,華航,1183,604,579,凱基-林口,2023-06-19,9257
2634,漢翔,201,69,132,凱基-林口,2023-06-19,9257
2633,台灣高鐵,100,0,100,凱基-林口,2023-06-19,9257
2836,高雄銀,100,0,100,凱基-林口,2023-06-19,9257
2436,偉詮電,85,0,85,凱基-林口,2023-06-19,9257
2104,國際中橡,69,3,66,凱基-林口,2023-06-19,9257
2913,農林,73,10,63,凱基-林口,2023-06-19,9257
2618,長榮航,95,34,61,凱基-林口,2023-06-19,9257
3706,神達,57,12,45,凱基-林口,2023-06-19,9257
5258,虹堡,47,2,45,凱基-林口,2023-06-19,9257
2312,金寶,64,20,44,凱基-林口,2023-06-19,9257
6114,久威,44,0,44,凱基-林口,2023-06-19,9257
2353,宏��,52,11,41,凱基-林口,2023-06-19,9257
00671R,富邦NASDAQ反1,33,0,33,凱基-林口,2023-06-19,9257
2892,第一金,31,0,31,凱基-林口,2023-06-19,9257
00919,群益台灣精選高息,42,11,31,凱基-林口,2023-06-19,9257
2324,仁寶,37,11,26,凱基-林口,2023-06-19,9257
2401,凌陽,25,0,25,凱基-林口,2023-06-19,9257
1605,華新,35,11,24,凱基-林口,2023-06-19,9257
6689,伊雲谷,46,22,24,凱基-林口,2023-06-19,9257
00772B,中信高評級公司債,33,10,23,凱基-林口,2023-06-19,9257
2609,陽明,27,4,23,凱基-林口,2023-06-19,9257
6104,創惟,25,2,23,凱基-林口,2023-06-19,9257
2603,長榮,25,3,22,凱基-林口,2023-06-19,9257
00679B,元大美債20年,20,0,20,凱基-林口,2023-06-19,9257
00637L,元大滬深300正2,30,10,20,凱基-林口,2023-06-19,9257
3532,台勝科,21,1,20,凱基-林口,2023-06-19,9257
5512,力麒,20,0,20,凱基-林口,2023-06-19,9257
6743,安普新,20,0,20,凱基-林口,2023-06-19,9257
8201,無敵,20,0,20,凱基-林口,2023-06-19,9257
3715,定穎投控,34,18,16,凱基-林口,2023-06-19,9257
6148,驊宏資,16,0,16,凱基-林口,2023-06-19,9257
2354,鴻準,15,0,15,凱基-林口,2023-06-19,9257
3011,今皓,17,2,15,凱基-林口,2023-06-19,9257
3028,增你強,15,0,15,凱基-林口,2023-06-19,9257
5452,佶優,15,0,15,凱基-林口,2023-06-19,9257
2409,友達,31,17,14,凱基-林口,2023-06-19,9257
2356,英業達,26,12,14,凱基-林口,2023-06-19,9257
00725B,國泰投資級公司債,14,0,14,凱基-林口,2023-06-19,9257
1907,永豐餘,14,0,14,凱基-林口,2023-06-19,9257
2014,中鴻,24,10,14,凱基-林口,2023-06-19,9257
4541,晟田,14,0,14,凱基-林口,2023-06-19,9257
00929,復華台灣科技優息,13,0,13,凱基-林口,2023-06-19,9257
00885,富邦越南,18,5,13,凱基-林口,2023-06-19,9257
1528,恩德,25,12,13,凱基-林口,2023-06-19,9257
3046,建��,23,10,13,凱基-林口,2023-06-19,9257
8215,明基材,14,1,13,凱基-林口,2023-06-19,9257
2344,華邦電,35,22,13,凱基-林口,2023-06-19,9257
6235,華孚,19,7,12,凱基-林口,2023-06-19,9257
00773B,中信優先金融債,12,0,12,凱基-林口,2023-06-19,9257
2634,漢翔,337,26,311,凱基-林口,2023-06-20,9257
2883,凱基金,306,0,306,凱基-林口,2023-06-20,9257
3325,旭品,103,10,93,凱基-林口,2023-06-20,9257
2436,偉詮電,75,0,75,凱基-林口,2023-06-20,9257
6244,茂迪,70,2,68,凱基-林口,2023-06-20,9257
3652,精聯,50,0,50,凱基-林口,2023-06-20,9257
2881,富邦金,50,1,49,凱基-林口,2023-06-20,9257
00927,群益半導體收益,40,0,40,凱基-林口,2023-06-20,9257
00637L,元大滬深300正2,40,0,40,凱基-林口,2023-06-20,9257
00929,復華台灣科技優息,29,0,29,凱基-林口,2023-06-20,9257
00679B,元大美債20年,28,0,28,凱基-林口,2023-06-20,9257
00888,永豐台灣ESG,27,0,27,凱基-林口,2023-06-20,9257
2615,萬海,26,0,26,凱基-林口,2023-06-20,9257
3032,偉訓,25,0,25,凱基-林口,2023-06-20,9257
1319,東陽,28,4,24,凱基-林口,2023-06-20,9257
2027,大成鋼,31,7,24,凱基-林口,2023-06-20,9257
3665,貿聯-KY,31,7,24,凱基-林口,2023-06-20,9257
6217,中探針,28,5,23,凱基-林口,2023-06-20,9257
00650L,復華香港正2,20,0,20,凱基-林口,2023-06-20,9257
2440,太空梭,20,0,20,凱基-林口,2023-06-20,9257
8103,瀚荃,20,0,20,凱基-林口,2023-06-20,9257
2461,光群雷,17,0,17,凱基-林口,2023-06-20,9257
00725B,國泰投資級公司債,16,0,16,凱基-林口,2023-06-20,9257
2891,中信金,22,7,15,凱基-林口,2023-06-20,9257
2504,國產,15,0,15,凱基-林口,2023-06-20,9257
2748,雲品,55,40,15,凱基-林口,2023-06-20,9257
3028,增你強,15,0,15,凱基-林口,2023-06-20,9257
00772B,中信高評級公司債,14,0,14,凱基-林口,2023-06-20,9257
2409,友達,15,1,14,凱基-林口,2023-06-20,9257
6148,驊宏資,13,0,13,凱基-林口,2023-06-20,9257
2610,華航,58,46,12,凱基-林口,2023-06-20,9257
2337,旺宏,14,2,12,凱基-林口,2023-06-20,9257
3078,僑威,13,1,12,凱基-林口,2023-06-20,9257
3685,元創精密,12,0,12,凱基-林口,2023-06-20,9257
6147,頎邦,11,0,11,凱基-林口,2023-06-20,9257
00919,群益台灣精選高息,11,0,11,凱基-林口,2023-06-20,9257
1504,東元,18,7,11,凱基-林口,2023-06-20,9257
2302,麗正,11,0,11,凱基-林口,2023-06-20,9257
2303,聯電,16,5,11,凱基-林口,2023-06-20,9257
2331,精英,11,0,11,凱基-林口,2023-06-20,9257
8215,明基材,11,0,11,凱基-林口,2023-06-20,9257
2401,凌陽,21,11,10,凱基-林口,2023-06-20,9257
2457,飛宏,13,3,10,凱基-林口,2023-06-20,9257
2485,兆赫,10,0,10,凱基-林口,2023-06-20,9257
2801,彰銀,10,0,10,凱基-林口,2023-06-20,9257
5452,佶優,10,0,10,凱基-林口,2023-06-20,9257
6116,彩晶,10,0,10,凱基-林口,2023-06-20,9257
1522,堤維西,10,1,9,凱基-林口,2023-06-20,9257
3013,晟銘電,16,7,9,凱基-林口,2023-06-20,9257
4979,華星光,22,13,9,凱基-林口,2023-06-20,9257
2610,華航,204,32,172,凱基-林口,2023-06-21,9257
2883,凱基金,106,0,106,凱基-林口,2023-06-21,9257
5905,南仁湖,91,1,90,凱基-林口,2023-06-21,9257
6188,廣明,68,1,67,凱基-林口,2023-06-21,9257
00929,復華台灣科技優息,55,0,55,凱基-林口,2023-06-21,9257
3011,今皓,30,0,30,凱基-林口,2023-06-21,9257
2812,台中銀,30,0,30,凱基-林口,2023-06-21,9257
00772B,中信高評級公司債,20,0,20,凱基-林口,2023-06-21,9257
00725B,國泰投資級公司債,20,0,20,凱基-林口,2023-06-21,9257
6152,百一,20,0,20,凱基-林口,2023-06-21,9257
6743,安普新,36,16,20,凱基-林口,2023-06-21,9257
8103,瀚荃,20,0,20,凱基-林口,2023-06-21,9257
2371,大同,144,125,19,凱基-林口,2023-06-21,9257
1609,大亞,23,5,18,凱基-林口,2023-06-21,9257
3014,聯陽,20,3,17,凱基-林口,2023-06-21,9257
5530,龍巖,17,0,17,凱基-林口,2023-06-21,9257
2362,藍天,15,0,15,凱基-林口,2023-06-21,9257
4916,事欣科,33,18,15,凱基-林口,2023-06-21,9257
2603,長榮,16,1,15,凱基-林口,2023-06-21,9257
2323,中環,16,2,14,凱基-林口,2023-06-21,9257
2425,承啟,14,0,14,凱基-林口,2023-06-21,9257
1802,台玻,15,2,13,凱基-林口,2023-06-21,9257
00665L,富邦�琤肭磪囓�2,12,0,12,凱基-林口,2023-06-21,9257
2405,輔信,17,5,12,凱基-林口,2023-06-21,9257
3058,立德,13,1,12,凱基-林口,2023-06-21,9257
3623,富晶通,12,0,12,凱基-林口,2023-06-21,9257
2705,六福,22,10,12,凱基-林口,2023-06-21,9257
1605,華新,11,0,11,凱基-林口,2023-06-21,9257
2104,國際中橡,11,0,11,凱基-林口,2023-06-21,9257
3078,僑威,14,3,11,凱基-林口,2023-06-21,9257
6214,精誠,11,0,11,凱基-林口,2023-06-21,9257
8446,華研,14,3,11,凱基-林口,2023-06-21,9257
5706,鳳凰,10,0,10,凱基-林口,2023-06-21,9257
00680L,元大美債20正2,20,10,10,凱基-林口,2023-06-21,9257
2363,矽統,10,0,10,凱基-林口,2023-06-21,9257
2401,凌陽,11,1,10,凱基-林口,2023-06-21,9257
2436,偉詮電,10,0,10,凱基-林口,2023-06-21,9257
2615,萬海,18,8,10,凱基-林口,2023-06-21,9257
2913,農林,10,0,10,凱基-林口,2023-06-21,9257
3380,明泰,10,0,10,凱基-林口,2023-06-21,9257
5347,世界,10,0,10,凱基-林口,2023-06-21,9257
5452,佶優,10,0,10,凱基-林口,2023-06-21,9257
5531,鄉林,10,0,10,凱基-林口,2023-06-21,9257
6120,達運,17,7,10,凱基-林口,2023-06-21,9257
8059,凱碩,10,0,10,凱基-林口,2023-06-21,9257
9951,皇田,10,0,10,凱基-林口,2023-06-21,9257
00713,元大台灣高息低波,10,0,10,凱基-林口,2023-06-21,9257
00882,中信中國高股息,10,1,9,凱基-林口,2023-06-21,9257
1905,華紙,24,15,9,凱基-林口,2023-06-21,9257
2313,華通,10,1,9,凱基-林口,2023-06-21,9257
2610,華航,261,57,204,凱基-林口,2023-06-26,9257
6116,彩晶,111,0,111,凱基-林口,2023-06-26,9257
3483,力致,112,5,107,凱基-林口,2023-06-26,9257
2883,凱基金,108,3,105,凱基-林口,2023-06-26,9257
00882,中信中國高股息,103,12,91,凱基-林口,2023-06-26,9257
1513,中興電,96,17,79,凱基-林口,2023-06-26,9257
3706,神達,81,7,74,凱基-林口,2023-06-26,9257
2812,台中銀,62,0,62,凱基-林口,2023-06-26,9257
2436,偉詮電,55,0,55,凱基-林口,2023-06-26,9257
1605,華新,39,5,34,凱基-林口,2023-06-26,9257
2748,雲品,35,1,34,凱基-林口,2023-06-26,9257
2356,英業達,30,1,29,凱基-林口,2023-06-26,9257
5905,南仁湖,32,4,28,凱基-林口,2023-06-26,9257
6217,中探針,25,0,25,凱基-林口,2023-06-26,9257
1514,亞力,37,14,23,凱基-林口,2023-06-26,9257
00637L,元大滬深300正2,23,0,23,凱基-林口,2023-06-26,9257
1504,東元,27,4,23,凱基-林口,2023-06-26,9257
2409,友達,26,4,22,凱基-林口,2023-06-26,9257
3715,定穎投控,32,10,22,凱基-林口,2023-06-26,9257
00680L,元大美債20正2,20,0,20,凱基-林口,2023-06-26,9257
2327,國巨,20,0,20,凱基-林口,2023-06-26,9257
3260,威剛,22,2,20,凱基-林口,2023-06-26,9257
5531,鄉林,20,0,20,凱基-林口,2023-06-26,9257
6234,高僑,20,0,20,凱基-林口,2023-06-26,9257
2362,藍天,18,0,18,凱基-林口,2023-06-26,9257
2344,華邦電,19,1,18,凱基-林口,2023-06-26,9257
0056,元大高股息,20,3,17,凱基-林口,2023-06-26,9257
2382,廣達,22,6,16,凱基-林口,2023-06-26,9257
2427,三商電,19,4,15,凱基-林口,2023-06-26,9257
4989,榮科,15,0,15,凱基-林口,2023-06-26,9257
2618,長榮航,35,20,15,凱基-林口,2023-06-26,9257
00772B,中信高評級公司債,18,4,14,凱基-林口,2023-06-26,9257
1785,光洋科,14,0,14,凱基-林口,2023-06-26,9257
2882,國泰金,14,0,14,凱基-林口,2023-06-26,9257
8234,新漢,16,3,13,凱基-林口,2023-06-26,9257
6282,康舒,14,2,12,凱基-林口,2023-06-26,9257
1533,車王電,11,0,11,凱基-林口,2023-06-26,9257
2425,承啟,11,0,11,凱基-林口,2023-06-26,9257
5351,鈺創,11,0,11,凱基-林口,2023-06-26,9257
8446,華研,12,1,11,凱基-林口,2023-06-26,9257
6222,上揚,50,39,11,凱基-林口,2023-06-26,9257
00722B,群益投資級電信債,10,0,10,凱基-林口,2023-06-26,9257
1722,台肥,10,0,10,凱基-林口,2023-06-26,9257
1903,士紙,12,2,10,凱基-林口,2023-06-26,9257
3374,精材,13,3,10,凱基-林口,2023-06-26,9257
8021,尖點,10,0,10,凱基-林口,2023-06-26,9257
8171,天宇,10,0,10,凱基-林口,2023-06-26,9257
9907,統一實,10,0,10,凱基-林口,2023-06-26,9257
3037,欣興,9,0,9,凱基-林口,2023-06-26,9257
00715L,期街口布蘭特正2,9,0,9,凱基-林口,2023-06-26,9257
2371,大同,317,45,272,凱基-林口,2023-06-27,9257
3483,力致,69,0,69,凱基-林口,2023-06-27,9257
00671R,富邦NASDAQ反1,65,0,65,凱基-林口,2023-06-27,9257
3706,神達,76,25,51,凱基-林口,2023-06-27,9257
3231,緯創,60,24,36,凱基-林口,2023-06-27,9257
1314,中石化,31,0,31,凱基-林口,2023-06-27,9257
00665L,富邦�琤肭磪囓�2,30,0,30,凱基-林口,2023-06-27,9257
2332,友訊,29,0,29,凱基-林口,2023-06-27,9257
0056,元大高股息,32,6,26,凱基-林口,2023-06-27,9257
2891,中信金,25,0,25,凱基-林口,2023-06-27,9257
6222,上揚,25,0,25,凱基-林口,2023-06-27,9257
3038,全台,33,9,24,凱基-林口,2023-06-27,9257
2851,中再保,22,0,22,凱基-林口,2023-06-27,9257
00902,中信電池及儲能,21,0,21,凱基-林口,2023-06-27,9257
8103,瀚荃,20,0,20,凱基-林口,2023-06-27,9257
2323,中環,22,4,18,凱基-林口,2023-06-27,9257
1471,首利,17,0,17,凱基-林口,2023-06-27,9257
2402,毅嘉,31,14,17,凱基-林口,2023-06-27,9257
2630,亞航,19,2,17,凱基-林口,2023-06-27,9257
2356,英業達,17,2,15,凱基-林口,2023-06-27,9257
3548,兆利,15,0,15,凱基-林口,2023-06-27,9257
1301,台塑,14,0,14,凱基-林口,2023-06-27,9257
2885,元大金,14,0,14,凱基-林口,2023-06-27,9257
2303,聯電,14,1,13,凱基-林口,2023-06-27,9257
2312,金寶,23,10,13,凱基-林口,2023-06-27,9257
5706,鳳凰,37,25,12,凱基-林口,2023-06-27,9257
6217,中探針,12,0,12,凱基-林口,2023-06-27,9257
1519,華城,19,7,12,凱基-林口,2023-06-27,9257
2888,新光金,11,0,11,凱基-林口,2023-06-27,9257
3033,威健,11,0,11,凱基-林口,2023-06-27,9257
3363,上詮,21,10,11,凱基-林口,2023-06-27,9257
1101,台泥,17,7,10,凱基-林口,2023-06-27,9257
00637L,元大滬深300正2,10,0,10,凱基-林口,2023-06-27,9257
1907,永豐餘,10,0,10,凱基-林口,2023-06-27,9257
3325,旭品,10,0,10,凱基-林口,2023-06-27,9257
3558,神準,11,1,10,凱基-林口,2023-06-27,9257
1240,茂生農經,9,0,9,凱基-林口,2023-06-27,9257
6188,廣明,16,7,9,凱基-林口,2023-06-27,9257
00919,群益台灣精選高息,8,0,8,凱基-林口,2023-06-27,9257
2344,華邦電,8,0,8,凱基-林口,2023-06-27,9257
3078,僑威,8,0,8,凱基-林口,2023-06-27,9257
1513,中興電,22,14,8,凱基-林口,2023-06-27,9257
8234,新漢,8,0,8,凱基-林口,2023-06-27,9257
2408,南亞科,7,0,7,凱基-林口,2023-06-27,9257
00706L,期元大S＆P日圓正2,7,0,7,凱基-林口,2023-06-27,9257
2618,長榮航,46,39,7,凱基-林口,2023-06-27,9257
2748,雲品,8,1,7,凱基-林口,2023-06-27,9257
3152,璟德,7,0,7,凱基-林口,2023-06-27,9257
1514,亞力,20,14,6,凱基-林口,2023-06-27,9257
2883,凱基金,6,0,6,凱基-林口,2023-06-27,9257
6768,志強-KY,113,0,113,凱基-林口,2023-06-28,9257
2883,凱基金,73,0,73,凱基-林口,2023-06-28,9257
3706,神達,65,0,65,凱基-林口,2023-06-28,9257
00671R,富邦NASDAQ反1,50,0,50,凱基-林口,2023-06-28,9257
1605,華新,69,22,47,凱基-林口,2023-06-28,9257
2615,萬海,50,11,39,凱基-林口,2023-06-28,9257
00715L,期街口布蘭特正2,38,0,38,凱基-林口,2023-06-28,9257
00642U,期元大S＆P石油,32,0,32,凱基-林口,2023-06-28,9257
6276,安鈦克,37,6,31,凱基-林口,2023-06-28,9257
8936,國統,30,0,30,凱基-林口,2023-06-28,9257
2104,國際中橡,29,0,29,凱基-林口,2023-06-28,9257
2427,三商電,40,11,29,凱基-林口,2023-06-28,9257
4916,事欣科,37,10,27,凱基-林口,2023-06-28,9257
2634,漢翔,65,39,26,凱基-林口,2023-06-28,9257
2323,中環,28,2,26,凱基-林口,2023-06-28,9257
00878,國泰永續高股息,22,1,21,凱基-林口,2023-06-28,9257
00650L,復華香港正2,20,0,20,凱基-林口,2023-06-28,9257
3027,盛達,20,0,20,凱基-林口,2023-06-28,9257
5530,龍巖,20,0,20,凱基-林口,2023-06-28,9257
3016,嘉晶,19,0,19,凱基-林口,2023-06-28,9257
0056,元大高股息,19,3,16,凱基-林口,2023-06-28,9257
2882,國泰金,20,4,16,凱基-林口,2023-06-28,9257
3037,欣興,15,0,15,凱基-林口,2023-06-28,9257
2913,農林,19,5,14,凱基-林口,2023-06-28,9257
1101,台泥,13,0,13,凱基-林口,2023-06-28,9257
1609,大亞,15,2,13,凱基-林口,2023-06-28,9257
3231,緯創,72,61,11,凱基-林口,2023-06-28,9257
5531,鄉林,11,0,11,凱基-林口,2023-06-28,9257
00891,中信關鍵半導體,10,0,10,凱基-林口,2023-06-28,9257
1301,台塑,11,1,10,凱基-林口,2023-06-28,9257
2329,華泰,10,0,10,凱基-林口,2023-06-28,9257
2402,毅嘉,18,8,10,凱基-林口,2023-06-28,9257
6269,台郡,10,0,10,凱基-林口,2023-06-28,9257
1303,南亞,9,0,9,凱基-林口,2023-06-28,9257
2489,瑞軒,10,1,9,凱基-林口,2023-06-28,9257
2382,廣達,18,9,9,凱基-林口,2023-06-28,9257
1514,亞力,10,2,8,凱基-林口,2023-06-28,9257
1522,堤維西,10,2,8,凱基-林口,2023-06-28,9257
2834,臺企銀,8,0,8,凱基-林口,2023-06-28,9257
6243,迅杰,8,0,8,凱基-林口,2023-06-28,9257
2412,中華電,8,0,8,凱基-林口,2023-06-28,9257
8046,南電,7,0,7,凱基-林口,2023-06-28,9257
020028,元大特選電動車N,7,0,7,凱基-林口,2023-06-28,9257
3059,華晶科,10,3,7,凱基-林口,2023-06-28,9257
3152,璟德,7,0,7,凱基-林口,2023-06-28,9257
8210,勤誠,16,9,7,凱基-林口,2023-06-28,9257
3078,僑威,8,2,6,凱基-林口,2023-06-28,9257
3372,典範,6,0,6,凱基-林口,2023-06-28,9257
8996,高力,11,5,6,凱基-林口,2023-06-28,9257
00900,富邦特選高股息30,5,0,5,凱基-林口,2023-06-28,9257
2618,長榮航,412,20,392,凱基-林口,2023-06-29,9257
2610,華航,94,33,61,凱基-林口,2023-06-29,9257
2323,中環,40,5,35,凱基-林口,2023-06-29,9257
2609,陽明,40,10,30,凱基-林口,2023-06-29,9257
3592,瑞鼎,30,1,29,凱基-林口,2023-06-29,9257
2706,第一店,30,2,28,凱基-林口,2023-06-29,9257
2634,漢翔,28,2,26,凱基-林口,2023-06-29,9257
1605,華新,33,9,24,凱基-林口,2023-06-29,9257
1460,宏遠,21,0,21,凱基-林口,2023-06-29,9257
4157,太景*-KY,21,1,20,凱基-林口,2023-06-29,9257
6114,久威,20,0,20,凱基-林口,2023-06-29,9257
6217,中探針,20,0,20,凱基-林口,2023-06-29,9257
4908,前鼎,20,1,19,凱基-林口,2023-06-29,9257
4916,事欣科,22,3,19,凱基-林口,2023-06-29,9257
2615,萬海,19,0,19,凱基-林口,2023-06-29,9257
3025,星通,23,5,18,凱基-林口,2023-06-29,9257
4155,訊映,20,2,18,凱基-林口,2023-06-29,9257
1909,榮成,15,0,15,凱基-林口,2023-06-29,9257
3044,健鼎,15,0,15,凱基-林口,2023-06-29,9257
1312,國喬,14,0,14,凱基-林口,2023-06-29,9257
0056,元大高股息,12,0,12,凱基-林口,2023-06-29,9257
6101,寬魚國際,12,0,12,凱基-林口,2023-06-29,9257
6285,啟��,19,8,11,凱基-林口,2023-06-29,9257
1215,卜蜂,10,0,10,凱基-林口,2023-06-29,9257
1591,駿吉-KY,10,0,10,凱基-林口,2023-06-29,9257
2312,金寶,10,0,10,凱基-林口,2023-06-29,9257
2450,神腦,10,0,10,凱基-林口,2023-06-29,9257
2705,六福,10,0,10,凱基-林口,2023-06-29,9257
5009,榮剛,10,0,10,凱基-林口,2023-06-29,9257
5531,鄉林,10,0,10,凱基-林口,2023-06-29,9257
8050,廣積,10,0,10,凱基-林口,2023-06-29,9257
8936,國統,10,0,10,凱基-林口,2023-06-29,9257
2504,國產,10,0,10,凱基-林口,2023-06-29,9257
2317,鴻海,11,2,9,凱基-林口,2023-06-29,9257
1444,力麗,12,3,9,凱基-林口,2023-06-29,9257
3481,群創,25,16,9,凱基-林口,2023-06-29,9257
00922,國泰台灣領袖50,8,0,8,凱基-林口,2023-06-29,9257
4747,強生,8,0,8,凱基-林口,2023-06-29,9257
6531,愛普*,16,8,8,凱基-林口,2023-06-29,9257
6743,安普新,65,57,8,凱基-林口,2023-06-29,9257
00919,群益台灣精選高息,7,0,7,凱基-林口,2023-06-29,9257
4746,台耀,11,4,7,凱基-林口,2023-06-29,9257
6596,寬宏藝術,10,3,7,凱基-林口,2023-06-29,9257
7402,邑錡,15,8,7,凱基-林口,2023-06-29,9257
2412,中華電,6,0,6,凱基-林口,2023-06-29,9257
1802,台玻,7,1,6,凱基-林口,2023-06-29,9257
2247,汎德永業,6,0,6,凱基-林口,2023-06-29,9257
2347,聯強,6,0,6,凱基-林口,2023-06-29,9257
3005,神基,13,7,6,凱基-林口,2023-06-29,9257
3078,僑威,7,1,6,凱基-林口,2023-06-29,9257
2614,東森,170,3,167,凱基-林口,2023-06-30,9257
2883,凱基金,120,0,120,凱基-林口,2023-06-30,9257
6203,海韻電,92,0,92,凱基-林口,2023-06-30,9257
3481,群創,46,1,45,凱基-林口,2023-06-30,9257
1201,味全,42,0,42,凱基-林口,2023-06-30,9257
6535,順藥,35,0,35,凱基-林口,2023-06-30,9257
2610,華航,38,10,28,凱基-林口,2023-06-30,9257
9907,統一實,33,10,23,凱基-林口,2023-06-30,9257
00772B,中信高評級公司債,21,0,21,凱基-林口,2023-06-30,9257
2353,宏��,21,1,20,凱基-林口,2023-06-30,9257
8358,金居,35,15,20,凱基-林口,2023-06-30,9257
2323,中環,25,6,19,凱基-林口,2023-06-30,9257
2408,南亞科,19,0,19,凱基-林口,2023-06-30,9257
2206,三陽工業,26,7,19,凱基-林口,2023-06-30,9257
2402,毅嘉,32,14,18,凱基-林口,2023-06-30,9257
4916,事欣科,18,0,18,凱基-林口,2023-06-30,9257
00720B,元大投資級公司債,17,0,17,凱基-林口,2023-06-30,9257
2498,宏達電,20,3,17,凱基-林口,2023-06-30,9257
00687B,國泰20年美債,18,3,15,凱基-林口,2023-06-30,9257
00882,中信中國高股息,15,0,15,凱基-林口,2023-06-30,9257
6605,帝寶,15,0,15,凱基-林口,2023-06-30,9257
2412,中華電,14,0,14,凱基-林口,2023-06-30,9257
00878,國泰永續高股息,19,5,14,凱基-林口,2023-06-30,9257
4155,訊映,16,2,14,凱基-林口,2023-06-30,9257
2368,金像電,19,6,13,凱基-林口,2023-06-30,9257
3711,日月光投控,15,2,13,凱基-林口,2023-06-30,9257
3045,台灣大,12,0,12,凱基-林口,2023-06-30,9257
3207,耀勝,73,61,12,凱基-林口,2023-06-30,9257
3032,偉訓,13,1,12,凱基-林口,2023-06-30,9257
00632R,元大台灣50反1,21,10,11,凱基-林口,2023-06-30,9257
2027,大成鋼,12,1,11,凱基-林口,2023-06-30,9257
2340,台亞,15,4,11,凱基-林口,2023-06-30,9257
2409,友達,11,0,11,凱基-林口,2023-06-30,9257
3374,精材,12,1,11,凱基-林口,2023-06-30,9257
6142,友勁,11,0,11,凱基-林口,2023-06-30,9257
6269,台郡,10,0,10,凱基-林口,2023-06-30,9257
00706L,期元大S＆P日圓正2,10,0,10,凱基-林口,2023-06-30,9257
2208,台船,10,0,10,凱基-林口,2023-06-30,9257
2347,聯強,10,0,10,凱基-林口,2023-06-30,9257
3631,晟楠,10,0,10,凱基-林口,2023-06-30,9257
4566,時碩工業,10,0,10,凱基-林口,2023-06-30,9257
4979,華星光,29,19,10,凱基-林口,2023-06-30,9257
8215,明基材,10,0,10,凱基-林口,2023-06-30,9257
1786,科妍,10,1,9,凱基-林口,2023-06-30,9257
1301,台塑,9,0,9,凱基-林口,2023-06-30,9257
2727,王品,9,0,9,凱基-林口,2023-06-30,9257
5347,世界,9,0,9,凱基-林口,2023-06-30,9257
1513,中興電,26,17,9,凱基-林口,2023-06-30,9257
00679B,元大美債20年,13,5,8,凱基-林口,2023-06-30,9257
2645,長榮航太,8,0,8,凱基-林口,2023-06-30,9257
3706,神達,453,169,284,凱基-林口,2023-07-03,9257
2614,東森,150,0,150,凱基-林口,2023-07-03,9257
2883,凱基金,107,0,107,凱基-林口,2023-07-03,9257
0056,元大高股息,95,11,84,凱基-林口,2023-07-03,9257
4532,瑞智,77,4,73,凱基-林口,2023-07-03,9257
1513,中興電,86,20,66,凱基-林口,2023-07-03,9257
2402,毅嘉,154,95,59,凱基-林口,2023-07-03,9257
5521,工信,50,0,50,凱基-林口,2023-07-03,9257
8358,金居,51,3,48,凱基-林口,2023-07-03,9257
00900,富邦特選高股息30,50,6,44,凱基-林口,2023-07-03,9257
6203,海韻電,36,0,36,凱基-林口,2023-07-03,9257
6689,伊雲谷,32,1,31,凱基-林口,2023-07-03,9257
00650L,復華香港正2,30,0,30,凱基-林口,2023-07-03,9257
2705,六福,40,10,30,凱基-林口,2023-07-03,9257
3576,聯合再生,30,1,29,凱基-林口,2023-07-03,9257
00720B,元大投資級公司債,42,15,27,凱基-林口,2023-07-03,9257
2880,華南金,26,1,25,凱基-林口,2023-07-03,9257
1314,中石化,24,0,24,凱基-林口,2023-07-03,9257
2368,金像電,46,23,23,凱基-林口,2023-07-03,9257
3013,晟銘電,23,0,23,凱基-林口,2023-07-03,9257
3207,耀勝,57,35,22,凱基-林口,2023-07-03,9257
1240,茂生農經,20,0,20,凱基-林口,2023-07-03,9257
00632R,元大台灣50反1,20,0,20,凱基-林口,2023-07-03,9257
9105,泰金寶-DR,20,0,20,凱基-林口,2023-07-03,9257
3078,僑威,23,4,19,凱基-林口,2023-07-03,9257
5864,致和證,19,0,19,凱基-林口,2023-07-03,9257
1218,泰山,18,0,18,凱基-林口,2023-07-03,9257
2888,新光金,22,4,18,凱基-林口,2023-07-03,9257
6441,廣錠,18,0,18,凱基-林口,2023-07-03,9257
2634,漢翔,25,9,16,凱基-林口,2023-07-03,9257
1467,南緯,15,0,15,凱基-林口,2023-07-03,9257
6577,勁豐,15,0,15,凱基-林口,2023-07-03,9257
1528,恩德,14,0,14,凱基-林口,2023-07-03,9257
6182,合晶,14,1,13,凱基-林口,2023-07-03,9257
2637,慧洋-KY,12,0,12,凱基-林口,2023-07-03,9257
00679B,元大美債20年,11,0,11,凱基-林口,2023-07-03,9257
1301,台塑,11,0,11,凱基-林口,2023-07-03,9257
5388,中磊,13,2,11,凱基-林口,2023-07-03,9257
2412,中華電,10,0,10,凱基-林口,2023-07-03,9257
2409,友達,10,0,10,凱基-林口,2023-07-03,9257
020028,元大特選電動車N,10,0,10,凱基-林口,2023-07-03,9257
020022,元大電動車N,10,0,10,凱基-林口,2023-07-03,9257
00773B,中信優先金融債,10,0,10,凱基-林口,2023-07-03,9257
2367,燿華,10,0,10,凱基-林口,2023-07-03,9257
2374,佳能,10,0,10,凱基-林口,2023-07-03,9257
3450,聯鈞,10,0,10,凱基-林口,2023-07-03,9257
5464,霖宏,10,0,10,凱基-林口,2023-07-03,9257
5512,力麒,10,0,10,凱基-林口,2023-07-03,9257
6148,驊宏資,10,0,10,凱基-林口,2023-07-03,9257
6245,立端,10,0,10,凱基-林口,2023-07-03,9257
2610,華航,933,28,905,凱基-林口,2023-07-04,9257
2883,凱基金,237,0,237,凱基-林口,2023-07-04,9257
0056,元大高股息,124,38,86,凱基-林口,2023-07-04,9257
2421,建準,81,9,72,凱基-林口,2023-07-04,9257
3045,台灣大,61,0,61,凱基-林口,2023-07-04,9257
2706,第一店,55,0,55,凱基-林口,2023-07-04,9257
2449,京元電子,48,0,48,凱基-林口,2023-07-04,9257
6577,勁豐,48,0,48,凱基-林口,2023-07-04,9257
2312,金寶,67,27,40,凱基-林口,2023-07-04,9257
4510,高鋒,40,0,40,凱基-林口,2023-07-04,9257
2888,新光金,39,0,39,凱基-林口,2023-07-04,9257
2614,東森,30,0,30,凱基-林口,2023-07-04,9257
2405,輔信,40,10,30,凱基-林口,2023-07-04,9257
00929,復華台灣科技優息,32,2,30,凱基-林口,2023-07-04,9257
020028,元大特選電動車N,28,0,28,凱基-林口,2023-07-04,9257
2399,映泰,27,0,27,凱基-林口,2023-07-04,9257
2618,長榮航,39,13,26,凱基-林口,2023-07-04,9257
00885,富邦越南,23,0,23,凱基-林口,2023-07-04,9257
00751B,元大AAA至A公司債,23,0,23,凱基-林口,2023-07-04,9257
2637,慧洋-KY,23,0,23,凱基-林口,2023-07-04,9257
6112,邁達特,22,0,22,凱基-林口,2023-07-04,9257
2317,鴻海,25,3,22,凱基-林口,2023-07-04,9257
00722B,群益投資級電信債,22,0,22,凱基-林口,2023-07-04,9257
8076,伍豐,22,0,22,凱基-林口,2023-07-04,9257
00679B,元大美債20年,32,11,21,凱基-林口,2023-07-04,9257
4157,太景*-KY,21,0,21,凱基-林口,2023-07-04,9257
6104,創惟,22,1,21,凱基-林口,2023-07-04,9257
00687B,國泰20年美債,20,0,20,凱基-林口,2023-07-04,9257
5531,鄉林,20,0,20,凱基-林口,2023-07-04,9257
2605,新興,30,11,19,凱基-林口,2023-07-04,9257
6438,迅得,21,2,19,凱基-林口,2023-07-04,9257
3152,璟德,16,0,16,凱基-林口,2023-07-04,9257
1301,台塑,15,0,15,凱基-林口,2023-07-04,9257
1409,新纖,15,0,15,凱基-林口,2023-07-04,9257
3078,僑威,20,5,15,凱基-林口,2023-07-04,9257
2607,榮運,18,4,14,凱基-林口,2023-07-04,9257
2748,雲品,14,0,14,凱基-林口,2023-07-04,9257
2812,台中銀,14,0,14,凱基-林口,2023-07-04,9257
6187,萬潤,15,1,14,凱基-林口,2023-07-04,9257
8093,保銳,16,2,14,凱基-林口,2023-07-04,9257
3264,欣銓,22,10,12,凱基-林口,2023-07-04,9257
4977,眾達-KY,15,3,12,凱基-林口,2023-07-04,9257
6282,康舒,86,74,12,凱基-林口,2023-07-04,9257
8028,昇陽半導體,13,1,12,凱基-林口,2023-07-04,9257
2382,廣達,70,59,11,凱基-林口,2023-07-04,9257
1326,台化,11,0,11,凱基-林口,2023-07-04,9257
1504,東元,11,0,11,凱基-林口,2023-07-04,9257
2887,台新金,11,0,11,凱基-林口,2023-07-04,9257
8033,雷虎,13,2,11,凱基-林口,2023-07-04,9257
00795B,中信美國公債20年,10,0,10,凱基-林口,2023-07-04,9257
3706,神達,354,11,343,凱基-林口,2023-07-05,9257
2610,華航,227,68,159,凱基-林口,2023-07-05,9257
00919,群益台灣精選高息,100,0,100,凱基-林口,2023-07-05,9257
6577,勁豐,72,0,72,凱基-林口,2023-07-05,9257
2883,凱基金,69,0,69,凱基-林口,2023-07-05,9257
6244,茂迪,51,3,48,凱基-林口,2023-07-05,9257
8034,榮群,37,1,36,凱基-林口,2023-07-05,9257
4977,眾達-KY,31,1,30,凱基-林口,2023-07-05,9257
2609,陽明,121,91,30,凱基-林口,2023-07-05,9257
3483,力致,28,3,25,凱基-林口,2023-07-05,9257
2356,英業達,50,27,23,凱基-林口,2023-07-05,9257
0056,元大高股息,38,15,23,凱基-林口,2023-07-05,9257
5425,台半,22,0,22,凱基-林口,2023-07-05,9257
6770,力積電,33,11,22,凱基-林口,2023-07-05,9257
00878,國泰永續高股息,26,5,21,凱基-林口,2023-07-05,9257
2324,仁寶,21,0,21,凱基-林口,2023-07-05,9257
2107,厚生,20,0,20,凱基-林口,2023-07-05,9257
2365,昆盈,20,0,20,凱基-林口,2023-07-05,9257
2460,建通,30,10,20,凱基-林口,2023-07-05,9257
9907,統一實,16,0,16,凱基-林口,2023-07-05,9257
1467,南緯,15,0,15,凱基-林口,2023-07-05,9257
3152,璟德,15,0,15,凱基-林口,2023-07-05,9257
6188,廣明,17,2,15,凱基-林口,2023-07-05,9257
6591,動力-KY,15,0,15,凱基-林口,2023-07-05,9257
2340,台亞,21,7,14,凱基-林口,2023-07-05,9257
2618,長榮航,375,362,13,凱基-林口,2023-07-05,9257
2409,友達,13,0,13,凱基-林口,2023-07-05,9257
2880,華南金,13,0,13,凱基-林口,2023-07-05,9257
4526,東台,15,2,13,凱基-林口,2023-07-05,9257
3374,精材,15,2,13,凱基-林口,2023-07-05,9257
2419,仲琦,16,4,12,凱基-林口,2023-07-05,9257
6217,中探針,20,8,12,凱基-林口,2023-07-05,9257
1503,士電,11,0,11,凱基-林口,2023-07-05,9257
2338,光罩,11,0,11,凱基-林口,2023-07-05,9257
3027,盛達,18,7,11,凱基-林口,2023-07-05,9257
3380,明泰,36,25,11,凱基-林口,2023-07-05,9257
6605,帝寶,11,0,11,凱基-林口,2023-07-05,9257
1529,樂事綠能,10,0,10,凱基-林口,2023-07-05,9257
2002,中鋼,10,0,10,凱基-林口,2023-07-05,9257
2353,宏��,12,2,10,凱基-林口,2023-07-05,9257
2812,台中銀,10,0,10,凱基-林口,2023-07-05,9257
2888,新光金,12,2,10,凱基-林口,2023-07-05,9257
3036A,文曄甲特,10,0,10,凱基-林口,2023-07-05,9257
3043,科風,10,0,10,凱基-林口,2023-07-05,9257
3481,群創,10,0,10,凱基-林口,2023-07-05,9257
6148,驊宏資,10,0,10,凱基-林口,2023-07-05,9257
6689,伊雲谷,10,0,10,凱基-林口,2023-07-05,9257
2454,聯發科,12,3,9,凱基-林口,2023-07-05,9257
1319,東陽,9,0,9,凱基-林口,2023-07-05,9257
2303,聯電,17,8,9,凱基-林口,2023-07-05,9257
1611,中電,158,2,156,凱基-林口,2023-07-06,9257
1513,中興電,94,0,94,凱基-林口,2023-07-06,9257
2402,毅嘉,120,51,69,凱基-林口,2023-07-06,9257
2329,華泰,84,20,64,凱基-林口,2023-07-06,9257
00878,國泰永續高股息,69,7,62,凱基-林口,2023-07-06,9257
00919,群益台灣精選高息,53,0,53,凱基-林口,2023-07-06,9257
2885,元大金,52,0,52,凱基-林口,2023-07-06,9257
4960,誠美材,52,0,52,凱基-林口,2023-07-06,9257
3706,神達,54,7,47,凱基-林口,2023-07-06,9257
2409,友達,53,11,42,凱基-林口,2023-07-06,9257
2883,凱基金,92,50,42,凱基-林口,2023-07-06,9257
2031,新光鋼,41,0,41,凱基-林口,2023-07-06,9257
0056,元大高股息,39,2,37,凱基-林口,2023-07-06,9257
2618,長榮航,141,105,36,凱基-林口,2023-07-06,9257
00706L,期元大S＆P日圓正2,30,0,30,凱基-林口,2023-07-06,9257
1101,台泥,29,0,29,凱基-林口,2023-07-06,9257
2884,玉山金,33,4,29,凱基-林口,2023-07-06,9257
2317,鴻海,30,2,28,凱基-林口,2023-07-06,9257
00679B,元大美債20年,28,0,28,凱基-林口,2023-07-06,9257
2382,廣達,56,31,25,凱基-林口,2023-07-06,9257
3037,欣興,34,10,24,凱基-林口,2023-07-06,9257
2891,中信金,23,0,23,凱基-林口,2023-07-06,9257
1591,駿吉-KY,22,0,22,凱基-林口,2023-07-06,9257
6532,瑞耘,20,0,20,凱基-林口,2023-07-06,9257
6577,勁豐,20,0,20,凱基-林口,2023-07-06,9257
6282,康舒,27,7,20,凱基-林口,2023-07-06,9257
1102,亞泥,19,0,19,凱基-林口,2023-07-06,9257
3707,漢磊,26,7,19,凱基-林口,2023-07-06,9257
2707,晶華,21,2,19,凱基-林口,2023-07-06,9257
2886,兆豐金,20,1,19,凱基-林口,2023-07-06,9257
2405,輔信,20,2,18,凱基-林口,2023-07-06,9257
8916,光隆,18,0,18,凱基-林口,2023-07-06,9257
0050,元大台灣50,17,0,17,凱基-林口,2023-07-06,9257
1609,大亞,18,1,17,凱基-林口,2023-07-06,9257
1471,首利,19,2,17,凱基-林口,2023-07-06,9257
2356,英業達,56,39,17,凱基-林口,2023-07-06,9257
6591,動力-KY,17,1,16,凱基-林口,2023-07-06,9257
00720B,元大投資級公司債,15,0,15,凱基-林口,2023-07-06,9257
1217,愛之味,15,0,15,凱基-林口,2023-07-06,9257
2301,光寶科,37,22,15,凱基-林口,2023-07-06,9257
3027,盛達,16,1,15,凱基-林口,2023-07-06,9257
4108,懷特,20,5,15,凱基-林口,2023-07-06,9257
2330,台積電,18,3,15,凱基-林口,2023-07-06,9257
6285,啟��,16,2,14,凱基-林口,2023-07-06,9257
2880,華南金,13,0,13,凱基-林口,2023-07-06,9257
5425,台半,13,0,13,凱基-林口,2023-07-06,9257
8926,台汽電,13,0,13,凱基-林口,2023-07-06,9257
4967,十銓,43,31,12,凱基-林口,2023-07-06,9257
1312,國喬,12,0,12,凱基-林口,2023-07-06,9257
2049,上銀,12,0,12,凱基-林口,2023-07-06,9257
2618,長榮航,379,17,362,凱基-林口,2023-07-07,9257
00632R,元大台灣50反1,170,5,165,凱基-林口,2023-07-07,9257
2610,華航,228,114,114,凱基-林口,2023-07-07,9257
2883,凱基金,117,3,114,凱基-林口,2023-07-07,9257
2515,中工,78,5,73,凱基-林口,2023-07-07,9257
00679B,元大美債20年,67,2,65,凱基-林口,2023-07-07,9257
3706,神達,55,2,53,凱基-林口,2023-07-07,9257
1513,中興電,54,3,51,凱基-林口,2023-07-07,9257
2409,友達,46,0,46,凱基-林口,2023-07-07,9257
2603,長榮,48,9,39,凱基-林口,2023-07-07,9257
8358,金居,54,20,34,凱基-林口,2023-07-07,9257
00795B,中信美國公債20年,30,0,30,凱基-林口,2023-07-07,9257
2329,華泰,67,37,30,凱基-林口,2023-07-07,9257
2301,光寶科,114,90,24,凱基-林口,2023-07-07,9257
5706,鳳凰,27,3,24,凱基-林口,2023-07-07,9257
1101,台泥,25,1,24,凱基-林口,2023-07-07,9257
3044,健鼎,23,0,23,凱基-林口,2023-07-07,9257
1786,科妍,23,1,22,凱基-林口,2023-07-07,9257
2888,新光金,22,0,22,凱基-林口,2023-07-07,9257
6674,鋐寶科技,22,0,22,凱基-林口,2023-07-07,9257
2344,華邦電,23,2,21,凱基-林口,2023-07-07,9257
5521,工信,20,0,20,凱基-林口,2023-07-07,9257
00878,國泰永續高股息,44,25,19,凱基-林口,2023-07-07,9257
00919,群益台灣精選高息,21,2,19,凱基-林口,2023-07-07,9257
0056,元大高股息,37,18,19,凱基-林口,2023-07-07,9257
4916,事欣科,18,0,18,凱基-林口,2023-07-07,9257
1301,台塑,18,1,17,凱基-林口,2023-07-07,9257
3481,群創,17,0,17,凱基-林口,2023-07-07,9257
3038,全台,16,0,16,凱基-林口,2023-07-07,9257
4976,佳凌,16,0,16,凱基-林口,2023-07-07,9257
5289,宜鼎,15,0,15,凱基-林口,2023-07-07,9257
3231,緯創,88,73,15,凱基-林口,2023-07-07,9257
1701,中化,14,0,14,凱基-林口,2023-07-07,9257
2347,聯強,14,0,14,凱基-林口,2023-07-07,9257
2897,王道銀行,14,0,14,凱基-林口,2023-07-07,9257
2887,台新金,13,0,13,凱基-林口,2023-07-07,9257
00720B,元大投資級公司債,13,0,13,凱基-林口,2023-07-07,9257
2412,中華電,13,0,13,凱基-林口,2023-07-07,9257
5880,合庫金,40,27,13,凱基-林口,2023-07-07,9257
2460,建通,12,0,12,凱基-林口,2023-07-07,9257
8403,盛弘,12,0,12,凱基-林口,2023-07-07,9257
3260,威剛,13,2,11,凱基-林口,2023-07-07,9257
00929,復華台灣科技優息,11,0,11,凱基-林口,2023-07-07,9257
2890,永豐金,11,0,11,凱基-林口,2023-07-07,9257
00712,復華富時不動產,15,4,11,凱基-林口,2023-07-07,9257
00680L,元大美債20正2,11,0,11,凱基-林口,2023-07-07,9257
1416,廣豐,11,0,11,凱基-林口,2023-07-07,9257
3701,大眾控,11,0,11,凱基-林口,2023-07-07,9257
1218,泰山,10,0,10,凱基-林口,2023-07-07,9257
1584,精剛,11,1,10,凱基-林口,2023-07-07,9257
2618,長榮航,222,109,113,凱基-林口,2023-07-10,9257
00919,群益台灣精選高息,108,1,107,凱基-林口,2023-07-10,9257
2323,中環,67,4,63,凱基-林口,2023-07-10,9257
00929,復華台灣科技優息,54,0,54,凱基-林口,2023-07-10,9257
4960,誠美材,50,0,50,凱基-林口,2023-07-10,9257
2515,中工,41,0,41,凱基-林口,2023-07-10,9257
3715,定穎投控,40,0,40,凱基-林口,2023-07-10,9257
2367,燿華,30,0,30,凱基-林口,2023-07-10,9257
2460,建通,30,0,30,凱基-林口,2023-07-10,9257
00878,國泰永續高股息,42,15,27,凱基-林口,2023-07-10,9257
00679B,元大美債20年,25,0,25,凱基-林口,2023-07-10,9257
2884,玉山金,25,1,24,凱基-林口,2023-07-10,9257
2301,光寶科,75,52,23,凱基-林口,2023-07-10,9257
1101,台泥,23,1,22,凱基-林口,2023-07-10,9257
2883,凱基金,47,25,22,凱基-林口,2023-07-10,9257
2356,英業達,24,2,22,凱基-林口,2023-07-10,9257
1504,東元,31,10,21,凱基-林口,2023-07-10,9257
2610,華航,45,24,21,凱基-林口,2023-07-10,9257
00632R,元大台灣50反1,21,0,21,凱基-林口,2023-07-10,9257
00673R,期元大S＆P原油反1,20,0,20,凱基-林口,2023-07-10,9257
3623,富晶通,20,0,20,凱基-林口,2023-07-10,9257
3706,神達,21,1,20,凱基-林口,2023-07-10,9257
5529,鉅陞,20,0,20,凱基-林口,2023-07-10,9257
6821,聯寶,20,0,20,凱基-林口,2023-07-10,9257
4916,事欣科,22,5,17,凱基-林口,2023-07-10,9257
2603,長榮,20,4,16,凱基-林口,2023-07-10,9257
00795B,中信美國公債20年,16,0,16,凱基-林口,2023-07-10,9257
8028,昇陽半導體,15,0,15,凱基-林口,2023-07-10,9257
2324,仁寶,17,4,13,凱基-林口,2023-07-10,9257
1513,中興電,13,0,13,凱基-林口,2023-07-10,9257
2303,聯電,12,0,12,凱基-林口,2023-07-10,9257
1217,愛之味,12,0,12,凱基-林口,2023-07-10,9257
2498,宏達電,12,0,12,凱基-林口,2023-07-10,9257
5457,宣德,12,0,12,凱基-林口,2023-07-10,9257
5483,中美晶,14,2,12,凱基-林口,2023-07-10,9257
2359,所羅門,11,0,11,凱基-林口,2023-07-10,9257
8096,擎亞,11,0,11,凱基-林口,2023-07-10,9257
00927,群益半導體收益,10,0,10,凱基-林口,2023-07-10,9257
3576,聯合再生,10,0,10,凱基-林口,2023-07-10,9257
00912,中信臺灣智慧50,10,0,10,凱基-林口,2023-07-10,9257
1614,三洋電,10,0,10,凱基-林口,2023-07-10,9257
2903,遠百,10,0,10,凱基-林口,2023-07-10,9257
3257,虹冠電,11,1,10,凱基-林口,2023-07-10,9257
3481,群創,24,14,10,凱基-林口,2023-07-10,9257
4527,方土霖,11,1,10,凱基-林口,2023-07-10,9257
4563,百德,10,0,10,凱基-林口,2023-07-10,9257
4906,正文,10,0,10,凱基-林口,2023-07-10,9257
6220,岳豐,10,0,10,凱基-林口,2023-07-10,9257
6494,九齊,10,0,10,凱基-林口,2023-07-10,9257
8027,鈦昇,10,0,10,凱基-林口,2023-07-10,9257
3481,群創,231,19,212,凱基-林口,2023-07-11,9257
2641,正德,180,0,180,凱基-林口,2023-07-11,9257
00706L,期元大S＆P日圓正2,150,13,137,凱基-林口,2023-07-11,9257
00632R,元大台灣50反1,105,0,105,凱基-林口,2023-07-11,9257
2409,友達,102,39,63,凱基-林口,2023-07-11,9257
00929,復華台灣科技優息,61,0,61,凱基-林口,2023-07-11,9257
1101,台泥,55,1,54,凱基-林口,2023-07-11,9257
6120,達運,44,5,39,凱基-林口,2023-07-11,9257
4960,誠美材,30,0,30,凱基-林口,2023-07-11,9257
2312,金寶,42,13,29,凱基-林口,2023-07-11,9257
00919,群益台灣精選高息,24,0,24,凱基-林口,2023-07-11,9257
2371,大同,32,9,23,凱基-林口,2023-07-11,9257
00650L,復華香港正2,21,0,21,凱基-林口,2023-07-11,9257
6226,光鼎,20,0,20,凱基-林口,2023-07-11,9257
3055,蔚華科,28,10,18,凱基-林口,2023-07-11,9257
2609,陽明,35,23,12,凱基-林口,2023-07-11,9257
2603,長榮,25,13,12,凱基-林口,2023-07-11,9257
6190,萬泰科,12,0,12,凱基-林口,2023-07-11,9257
6443,元晶,12,0,12,凱基-林口,2023-07-11,9257
2727,王品,11,0,11,凱基-林口,2023-07-11,9257
5439,高技,13,2,11,凱基-林口,2023-07-11,9257
6148,驊宏資,12,1,11,凱基-林口,2023-07-11,9257
4934,太極,15,4,11,凱基-林口,2023-07-11,9257
1314,中石化,13,3,10,凱基-林口,2023-07-11,9257
00673R,期元大S＆P原油反1,10,0,10,凱基-林口,2023-07-11,9257
1786,科妍,10,0,10,凱基-林口,2023-07-11,9257
2438,翔耀,10,0,10,凱基-林口,2023-07-11,9257
3687,歐買尬,10,0,10,凱基-林口,2023-07-11,9257
4510,高鋒,15,5,10,凱基-林口,2023-07-11,9257
4538,大詠城,10,0,10,凱基-林口,2023-07-11,9257
3016,嘉晶,28,19,9,凱基-林口,2023-07-11,9257
2376,技嘉,14,5,9,凱基-林口,2023-07-11,9257
3058,立德,9,0,9,凱基-林口,2023-07-11,9257
4915,致伸,10,1,9,凱基-林口,2023-07-11,9257
2317,鴻海,11,3,8,凱基-林口,2023-07-11,9257
00888,永豐台灣ESG,8,0,8,凱基-林口,2023-07-11,9257
2002,中鋼,8,0,8,凱基-林口,2023-07-11,9257
2419,仲琦,12,4,8,凱基-林口,2023-07-11,9257
2424,隴華,8,0,8,凱基-林口,2023-07-11,9257
2444,兆勁,8,0,8,凱基-林口,2023-07-11,9257
6288,聯嘉,8,0,8,凱基-林口,2023-07-11,9257
1609,大亞,25,18,7,凱基-林口,2023-07-11,9257
1701,中化,7,0,7,凱基-林口,2023-07-11,9257
8916,光隆,7,0,7,凱基-林口,2023-07-11,9257
9958,世紀鋼,8,1,7,凱基-林口,2023-07-11,9257
6274,台燿,7,1,6,凱基-林口,2023-07-11,9257
1604,聲寶,9,3,6,凱基-林口,2023-07-11,9257
3028,增你強,6,0,6,凱基-林口,2023-07-11,9257
8234,新漢,6,0,6,凱基-林口,2023-07-11,9257
1514,亞力,6,0,6,凱基-林口,2023-07-11,9257
9929,秋雨,172,0,172,凱基-林口,2023-07-12,9257
2610,華航,164,45,119,凱基-林口,2023-07-12,9257
00919,群益台灣精選高息,97,1,96,凱基-林口,2023-07-12,9257
00706L,期元大S＆P日圓正2,68,0,68,凱基-林口,2023-07-12,9257
2356,英業達,176,111,65,凱基-林口,2023-07-12,9257
2303,聯電,68,7,61,凱基-林口,2023-07-12,9257
2641,正德,60,0,60,凱基-林口,2023-07-12,9257
00929,復華台灣科技優息,52,0,52,凱基-林口,2023-07-12,9257
1604,聲寶,51,0,51,凱基-林口,2023-07-12,9257
2880,華南金,50,0,50,凱基-林口,2023-07-12,9257
3035,智原,83,35,48,凱基-林口,2023-07-12,9257
3017,奇鋐,49,2,47,凱基-林口,2023-07-12,9257
2881,富邦金,46,0,46,凱基-林口,2023-07-12,9257
2312,金寶,40,2,38,凱基-林口,2023-07-12,9257
2882,國泰金,38,0,38,凱基-林口,2023-07-12,9257
3027,盛達,42,5,37,凱基-林口,2023-07-12,9257
4155,訊映,30,0,30,凱基-林口,2023-07-12,9257
2399,映泰,31,2,29,凱基-林口,2023-07-12,9257
2301,光寶科,88,61,27,凱基-林口,2023-07-12,9257
2340,台亞,32,5,27,凱基-林口,2023-07-12,9257
2481,強茂,30,4,26,凱基-林口,2023-07-12,9257
2374,佳能,25,1,24,凱基-林口,2023-07-12,9257
5328,華容,24,0,24,凱基-林口,2023-07-12,9257
2323,中環,59,36,23,凱基-林口,2023-07-12,9257
3078,僑威,24,2,22,凱基-林口,2023-07-12,9257
2461,光群雷,20,0,20,凱基-林口,2023-07-12,9257
6117,迎廣,20,0,20,凱基-林口,2023-07-12,9257
5483,中美晶,30,11,19,凱基-林口,2023-07-12,9257
2883,凱基金,18,0,18,凱基-林口,2023-07-12,9257
2498,宏達電,34,16,18,凱基-林口,2023-07-12,9257
8097,常珵,18,0,18,凱基-林口,2023-07-12,9257
4953,緯軟,19,2,17,凱基-林口,2023-07-12,9257
8046,南電,18,3,15,凱基-林口,2023-07-12,9257
2329,華泰,22,8,14,凱基-林口,2023-07-12,9257
2867,三商壽,14,0,14,凱基-林口,2023-07-12,9257
3058,立德,14,0,14,凱基-林口,2023-07-12,9257
4916,事欣科,14,0,14,凱基-林口,2023-07-12,9257
1504,東元,17,4,13,凱基-林口,2023-07-12,9257
1513,中興電,17,5,12,凱基-林口,2023-07-12,9257
1416,廣豐,12,0,12,凱基-林口,2023-07-12,9257
6282,康舒,31,20,11,凱基-林口,2023-07-12,9257
1240,茂生農經,11,0,11,凱基-林口,2023-07-12,9257
00673R,期元大S＆P原油反1,11,0,11,凱基-林口,2023-07-12,9257
1701,中化,11,0,11,凱基-林口,2023-07-12,9257
00650L,復華香港正2,30,20,10,凱基-林口,2023-07-12,9257
2913,農林,10,0,10,凱基-林口,2023-07-12,9257
3346,麗清,10,0,10,凱基-林口,2023-07-12,9257
3707,漢磊,11,1,10,凱基-林口,2023-07-12,9257
6122,擎邦,10,0,10,凱基-林口,2023-07-12,9257
9919,康那香,10,0,10,凱基-林口,2023-07-12,9257
00929,復華台灣科技優息,154,3,151,凱基-林口,2023-07-13,9257
2641,正德,120,0,120,凱基-林口,2023-07-13,9257
00632R,元大台灣50反1,155,40,115,凱基-林口,2023-07-13,9257
5880,合庫金,100,0,100,凱基-林口,2023-07-13,9257
2610,華航,181,108,73,凱基-林口,2023-07-13,9257
3035,智原,148,84,64,凱基-林口,2023-07-13,9257
1609,大亞,76,13,63,凱基-林口,2023-07-13,9257
00850,元大臺灣ESG永續,60,0,60,凱基-林口,2023-07-13,9257
3234,光環,51,2,49,凱基-林口,2023-07-13,9257
1409,新纖,50,2,48,凱基-林口,2023-07-13,9257
00720B,元大投資級公司債,46,2,44,凱基-林口,2023-07-13,9257
3017,奇鋐,57,21,36,凱基-林口,2023-07-13,9257
3704,合勤控,39,4,35,凱基-林口,2023-07-13,9257
00930,永豐ESG低碳高息,34,0,34,凱基-林口,2023-07-13,9257
1584,精剛,33,0,33,凱基-林口,2023-07-13,9257
2609,陽明,59,26,33,凱基-林口,2023-07-13,9257
2324,仁寶,58,26,32,凱基-林口,2023-07-13,9257
8050,廣積,31,0,31,凱基-林口,2023-07-13,9257
5315,光聯,30,0,30,凱基-林口,2023-07-13,9257
9929,秋雨,30,0,30,凱基-林口,2023-07-13,9257
3231,緯創,66,37,29,凱基-林口,2023-07-13,9257
6190,萬泰科,34,10,24,凱基-林口,2023-07-13,9257
00706L,期元大S＆P日圓正2,25,3,22,凱基-林口,2023-07-13,9257
1618,合機,23,2,21,凱基-林口,2023-07-13,9257
2371,大同,25,4,21,凱基-林口,2023-07-13,9257
00673R,期元大S＆P原油反1,20,0,20,凱基-林口,2023-07-13,9257
6148,驊宏資,20,0,20,凱基-林口,2023-07-13,9257
6226,光鼎,20,0,20,凱基-林口,2023-07-13,9257
6188,廣明,32,13,19,凱基-林口,2023-07-13,9257
2303,聯電,21,4,17,凱基-林口,2023-07-13,9257
2546,根基,16,0,16,凱基-林口,2023-07-13,9257
3558,神準,20,4,16,凱基-林口,2023-07-13,9257
00679B,元大美債20年,15,1,14,凱基-林口,2023-07-13,9257
2353,宏��,26,12,14,凱基-林口,2023-07-13,9257
2603,長榮,37,23,14,凱基-林口,2023-07-13,9257
1240,茂生農經,15,2,13,凱基-林口,2023-07-13,9257
2399,映泰,13,1,12,凱基-林口,2023-07-13,9257
2409,友達,15,3,12,凱基-林口,2023-07-13,9257
5457,宣德,12,0,12,凱基-林口,2023-07-13,9257
1605,華新,13,2,11,凱基-林口,2023-07-13,9257
2449,京元電子,19,8,11,凱基-林口,2023-07-13,9257
1217,愛之味,10,0,10,凱基-林口,2023-07-13,9257
1701,中化,10,0,10,凱基-林口,2023-07-13,9257
1905,華紙,11,1,10,凱基-林口,2023-07-13,9257
2415,錩新,10,0,10,凱基-林口,2023-07-13,9257
2438,翔耀,10,0,10,凱基-林口,2023-07-13,9257
2887,台新金,10,0,10,凱基-林口,2023-07-13,9257
2913,農林,10,0,10,凱基-林口,2023-07-13,9257
3016,嘉晶,10,0,10,凱基-林口,2023-07-13,9257
3227,原相,10,0,10,凱基-林口,2023-07-13,9257
00706L,期元大S＆P日圓正2,125,0,125,凱基-林口,2023-07-14,9257
1513,中興電,124,21,103,凱基-林口,2023-07-14,9257
2610,華航,234,148,86,凱基-林口,2023-07-14,9257
2641,正德,81,0,81,凱基-林口,2023-07-14,9257
2382,廣達,113,41,72,凱基-林口,2023-07-14,9257
00679B,元大美債20年,57,0,57,凱基-林口,2023-07-14,9257
00680L,元大美債20正2,52,0,52,凱基-林口,2023-07-14,9257
00929,復華台灣科技優息,50,0,50,凱基-林口,2023-07-14,9257
9958,世紀鋼,50,0,50,凱基-林口,2023-07-14,9257
3032,偉訓,51,1,50,凱基-林口,2023-07-14,9257
2888,新光金,55,10,45,凱基-林口,2023-07-14,9257
2883,凱基金,51,12,39,凱基-林口,2023-07-14,9257
00673R,期元大S＆P原油反1,30,0,30,凱基-林口,2023-07-14,9257
5864,致和證,30,0,30,凱基-林口,2023-07-14,9257
6282,康舒,32,3,29,凱基-林口,2023-07-14,9257
6026,福邦證,25,0,25,凱基-林口,2023-07-14,9257
00632R,元大台灣50反1,20,0,20,凱基-林口,2023-07-14,9257
6788,華景電,20,0,20,凱基-林口,2023-07-14,9257
3532,台勝科,20,1,19,凱基-林口,2023-07-14,9257
2402,毅嘉,22,3,19,凱基-林口,2023-07-14,9257
6138,茂達,20,1,19,凱基-林口,2023-07-14,9257
2618,長榮航,90,74,16,凱基-林口,2023-07-14,9257
00882,中信中國高股息,16,0,16,凱基-林口,2023-07-14,9257
6164,華興,15,0,15,凱基-林口,2023-07-14,9257
2376,技嘉,26,12,14,凱基-林口,2023-07-14,9257
2371,大同,19,6,13,凱基-林口,2023-07-14,9257
2344,華邦電,23,12,11,凱基-林口,2023-07-14,9257
2436,偉詮電,15,4,11,凱基-林口,2023-07-14,9257
00850,元大臺灣ESG永續,10,0,10,凱基-林口,2023-07-14,9257
1308,亞聚,10,0,10,凱基-林口,2023-07-14,9257
2415,錩新,10,0,10,凱基-林口,2023-07-14,9257
2442,新美齊,10,0,10,凱基-林口,2023-07-14,9257
6806,森崴能源,12,2,10,凱基-林口,2023-07-14,9257
6843,進典,10,0,10,凱基-林口,2023-07-14,9257
8033,雷虎,10,0,10,凱基-林口,2023-07-14,9257
1102,亞泥,9,0,9,凱基-林口,2023-07-14,9257
1711,永光,10,1,9,凱基-林口,2023-07-14,9257
4915,致伸,10,1,9,凱基-林口,2023-07-14,9257
5457,宣德,11,3,8,凱基-林口,2023-07-14,9257
1240,茂生農經,7,0,7,凱基-林口,2023-07-14,9257
1701,中化,7,0,7,凱基-林口,2023-07-14,9257
3287,廣寰科,8,1,7,凱基-林口,2023-07-14,9257
4938,和碩,8,1,7,凱基-林口,2023-07-14,9257
00924,復華S＆P500成長,6,0,6,凱基-林口,2023-07-14,9257
00720B,元大投資級公司債,6,0,6,凱基-林口,2023-07-14,9257
1529,樂事綠能,22,16,6,凱基-林口,2023-07-14,9257
1722,台肥,6,0,6,凱基-林口,2023-07-14,9257
8096,擎亞,6,0,6,凱基-林口,2023-07-14,9257
8110,華東,6,0,6,凱基-林口,2023-07-14,9257
2421,建準,16,10,6,凱基-林口,2023-07-14,9257
2402,毅嘉,594,49,545,凱基-林口,2023-07-17,9257
2312,金寶,379,140,239,凱基-林口,2023-07-17,9257
3481,群創,106,23,83,凱基-林口,2023-07-17,9257
00930,永豐ESG低碳高息,77,0,77,凱基-林口,2023-07-17,9257
6691,洋基工程,66,0,66,凱基-林口,2023-07-17,9257
00665L,富邦�琤肭磪囓�2,64,0,64,凱基-林口,2023-07-17,9257
2888,新光金,61,10,51,凱基-林口,2023-07-17,9257
2329,華泰,52,3,49,凱基-林口,2023-07-17,9257
2353,宏��,64,24,40,凱基-林口,2023-07-17,9257
3037,欣興,86,47,39,凱基-林口,2023-07-17,9257
2457,飛宏,49,10,39,凱基-林口,2023-07-17,9257
1314,中石化,55,16,39,凱基-林口,2023-07-17,9257
9802,鈺齊-KY,37,0,37,凱基-林口,2023-07-17,9257
2356,英業達,48,13,35,凱基-林口,2023-07-17,9257
0056,元大高股息,122,87,35,凱基-林口,2023-07-17,9257
3325,旭品,57,23,34,凱基-林口,2023-07-17,9257
6188,廣明,56,26,30,凱基-林口,2023-07-17,9257
6207,雷科,29,2,27,凱基-林口,2023-07-17,9257
00637L,元大滬深300正2,25,0,25,凱基-林口,2023-07-17,9257
3707,漢磊,25,0,25,凱基-林口,2023-07-17,9257
2002,中鋼,25,1,24,凱基-林口,2023-07-17,9257
2352,佳世達,25,2,23,凱基-林口,2023-07-17,9257
1503,士電,36,14,22,凱基-林口,2023-07-17,9257
1795,美時,21,0,21,凱基-林口,2023-07-17,9257
1402,遠東新,21,1,20,凱基-林口,2023-07-17,9257
6138,茂達,20,0,20,凱基-林口,2023-07-17,9257
1303,南亞,21,1,20,凱基-林口,2023-07-17,9257
2313,華通,76,57,19,凱基-林口,2023-07-17,9257
00679B,元大美債20年,18,0,18,凱基-林口,2023-07-17,9257
00720B,元大投資級公司債,18,0,18,凱基-林口,2023-07-17,9257
00929,復華台灣科技優息,18,0,18,凱基-林口,2023-07-17,9257
4532,瑞智,19,1,18,凱基-林口,2023-07-17,9257
5425,台半,20,2,18,凱基-林口,2023-07-17,9257
5009,榮剛,19,2,17,凱基-林口,2023-07-17,9257
1217,愛之味,15,0,15,凱基-林口,2023-07-17,9257
00882,中信中國高股息,14,0,14,凱基-林口,2023-07-17,9257
2331,精英,19,6,13,凱基-林口,2023-07-17,9257
3005,神基,15,2,13,凱基-林口,2023-07-17,9257
6190,萬泰科,22,9,13,凱基-林口,2023-07-17,9257
0050,元大台灣50,14,1,13,凱基-林口,2023-07-17,9257
8215,明基材,13,0,13,凱基-林口,2023-07-17,9257
3338,泰碩,15,3,12,凱基-林口,2023-07-17,9257
6290,良維,12,0,12,凱基-林口,2023-07-17,9257
2328,廣宇,13,2,11,凱基-林口,2023-07-17,9257
4533,協易機,16,5,11,凱基-林口,2023-07-17,9257
3711,日月光投控,11,1,10,凱基-林口,2023-07-17,9257
00919,群益台灣精選高息,11,1,10,凱基-林口,2023-07-17,9257
00687B,國泰20年美債,10,0,10,凱基-林口,2023-07-17,9257
1467,南緯,10,0,10,凱基-林口,2023-07-17,9257
3058,立德,10,0,10,凱基-林口,2023-07-17,9257
2312,金寶,593,291,302,凱基-林口,2023-07-18,9257
1513,中興電,132,5,127,凱基-林口,2023-07-18,9257
2402,毅嘉,254,153,101,凱基-林口,2023-07-18,9257
6282,康舒,109,20,89,凱基-林口,2023-07-18,9257
3481,群創,113,32,81,凱基-林口,2023-07-18,9257
9105,泰金寶-DR,65,5,60,凱基-林口,2023-07-18,9257
0056,元大高股息,117,61,56,凱基-林口,2023-07-18,9257
2324,仁寶,121,74,47,凱基-林口,2023-07-18,9257
2421,建準,82,42,40,凱基-林口,2023-07-18,9257
2888,新光金,69,30,39,凱基-林口,2023-07-18,9257
3035,智原,62,25,37,凱基-林口,2023-07-18,9257
00665L,富邦�琤肭磪囓�2,36,0,36,凱基-林口,2023-07-18,9257
4938,和碩,44,11,33,凱基-林口,2023-07-18,9257
2515,中工,82,50,32,凱基-林口,2023-07-18,9257
6190,萬泰科,35,6,29,凱基-林口,2023-07-18,9257
00679B,元大美債20年,28,0,28,凱基-林口,2023-07-18,9257
3325,旭品,33,6,27,凱基-林口,2023-07-18,9257
1731,美吾華,25,0,25,凱基-林口,2023-07-18,9257
4960,誠美材,25,0,25,凱基-林口,2023-07-18,9257
6691,洋基工程,25,0,25,凱基-林口,2023-07-18,9257
4916,事欣科,24,0,24,凱基-林口,2023-07-18,9257
00893,國泰智能電動車,25,3,22,凱基-林口,2023-07-18,9257
6138,茂達,20,0,20,凱基-林口,2023-07-18,9257
2614,東森,20,0,20,凱基-林口,2023-07-18,9257
5315,光聯,20,0,20,凱基-林口,2023-07-18,9257
6213,聯茂,22,2,20,凱基-林口,2023-07-18,9257
9929,秋雨,20,0,20,凱基-林口,2023-07-18,9257
4953,緯軟,26,7,19,凱基-林口,2023-07-18,9257
8210,勤誠,23,4,19,凱基-林口,2023-07-18,9257
00882,中信中國高股息,18,0,18,凱基-林口,2023-07-18,9257
3362,先進光,29,11,18,凱基-林口,2023-07-18,9257
1609,大亞,33,15,18,凱基-林口,2023-07-18,9257
1802,台玻,17,0,17,凱基-林口,2023-07-18,9257
3088,艾訊,20,3,17,凱基-林口,2023-07-18,9257
1102,亞泥,16,0,16,凱基-林口,2023-07-18,9257
2457,飛宏,26,11,15,凱基-林口,2023-07-18,9257
2425,承啟,17,3,14,凱基-林口,2023-07-18,9257
4968,立積,14,0,14,凱基-林口,2023-07-18,9257
9962,有益,14,0,14,凱基-林口,2023-07-18,9257
6689,伊雲谷,13,0,13,凱基-林口,2023-07-18,9257
1218,泰山,13,0,13,凱基-林口,2023-07-18,9257
5425,台半,27,14,13,凱基-林口,2023-07-18,9257
5531,鄉林,13,0,13,凱基-林口,2023-07-18,9257
00720B,元大投資級公司債,12,0,12,凱基-林口,2023-07-18,9257
3374,精材,13,1,12,凱基-林口,2023-07-18,9257
3163,波若威,33,21,12,凱基-林口,2023-07-18,9257
1514,亞力,37,26,11,凱基-林口,2023-07-18,9257
2609,陽明,50,39,11,凱基-林口,2023-07-18,9257
1605,華新,10,0,10,凱基-林口,2023-07-18,9257
8097,常珵,10,0,10,凱基-林口,2023-07-18,9257
2313,華通,123,9,114,凱基-林口,2023-07-19,9257
9105,泰金寶-DR,100,10,90,凱基-林口,2023-07-19,9257
5386,青雲,76,1,75,凱基-林口,2023-07-19,9257
3481,群創,77,6,71,凱基-林口,2023-07-19,9257
00665L,富邦�琤肭磪囓�2,51,0,51,凱基-林口,2023-07-19,9257
2356,英業達,141,91,50,凱基-林口,2023-07-19,9257
3706,神達,158,114,44,凱基-林口,2023-07-19,9257
1513,中興電,44,2,42,凱基-林口,2023-07-19,9257
00878,國泰永續高股息,84,45,39,凱基-林口,2023-07-19,9257
3710,連展投控,38,0,38,凱基-林口,2023-07-19,9257
2329,華泰,63,26,37,凱基-林口,2023-07-19,9257
2402,毅嘉,38,7,31,凱基-林口,2023-07-19,9257
1444,力麗,31,0,31,凱基-林口,2023-07-19,9257
2303,聯電,37,8,29,凱基-林口,2023-07-19,9257
00929,復華台灣科技優息,29,0,29,凱基-林口,2023-07-19,9257
6161,捷波,29,0,29,凱基-林口,2023-07-19,9257
9904,寶成,30,2,28,凱基-林口,2023-07-19,9257
2353,宏��,95,69,26,凱基-林口,2023-07-19,9257
2458,義隆,26,1,25,凱基-林口,2023-07-19,9257
4919,新唐,32,7,25,凱基-林口,2023-07-19,9257
1504,東元,26,2,24,凱基-林口,2023-07-19,9257
2376,技嘉,24,2,22,凱基-林口,2023-07-19,9257
2340,台亞,24,2,22,凱基-林口,2023-07-19,9257
5425,台半,32,11,21,凱基-林口,2023-07-19,9257
2323,中環,20,0,20,凱基-林口,2023-07-19,9257
2929,淘帝-KY,20,0,20,凱基-林口,2023-07-19,9257
8299,群聯,20,1,19,凱基-林口,2023-07-19,9257
2027,大成鋼,16,0,16,凱基-林口,2023-07-19,9257
2382,廣達,32,17,15,凱基-林口,2023-07-19,9257
5521,工信,15,0,15,凱基-林口,2023-07-19,9257
2603,長榮,26,13,13,凱基-林口,2023-07-19,9257
8201,無敵,12,0,12,凱基-林口,2023-07-19,9257
0056,元大高股息,23,11,12,凱基-林口,2023-07-19,9257
2317,鴻海,12,0,12,凱基-林口,2023-07-19,9257
2882,國泰金,44,32,12,凱基-林口,2023-07-19,9257
00687B,國泰20年美債,11,0,11,凱基-林口,2023-07-19,9257
00715L,期街口布蘭特正2,11,0,11,凱基-林口,2023-07-19,9257
2489,瑞軒,11,0,11,凱基-林口,2023-07-19,9257
2515,中工,11,0,11,凱基-林口,2023-07-19,9257
2883,凱基金,17,6,11,凱基-林口,2023-07-19,9257
3305,昇貿,11,0,11,凱基-林口,2023-07-19,9257
3694,海華,11,0,11,凱基-林口,2023-07-19,9257
8403,盛弘,14,3,11,凱基-林口,2023-07-19,9257
3017,奇鋐,16,5,11,凱基-林口,2023-07-19,9257
6288,聯嘉,10,0,10,凱基-林口,2023-07-19,9257
2618,長榮航,47,37,10,凱基-林口,2023-07-19,9257
1514,亞力,10,0,10,凱基-林口,2023-07-19,9257
2504,國產,10,0,10,凱基-林口,2023-07-19,9257
00882,中信中國高股息,10,0,10,凱基-林口,2023-07-19,9257
1618,合機,11,1,10,凱基-林口,2023-07-19,9257
6235,華孚,64,10,54,凱基-林口,2023-07-20,9257
00688L,國泰20年美債正2,50,0,50,凱基-林口,2023-07-20,9257
2303,聯電,54,5,49,凱基-林口,2023-07-20,9257
00720B,元大投資級公司債,45,0,45,凱基-林口,2023-07-20,9257
00671R,富邦NASDAQ反1,43,0,43,凱基-林口,2023-07-20,9257
3481,群創,34,3,31,凱基-林口,2023-07-20,9257
2618,長榮航,99,68,31,凱基-林口,2023-07-20,9257
3710,連展投控,30,0,30,凱基-林口,2023-07-20,9257
1102,亞泥,25,0,25,凱基-林口,2023-07-20,9257
8299,群聯,25,0,25,凱基-林口,2023-07-20,9257
2881,富邦金,21,0,21,凱基-林口,2023-07-20,9257
2929,淘帝-KY,21,0,21,凱基-林口,2023-07-20,9257
00687B,國泰20年美債,20,0,20,凱基-林口,2023-07-20,9257
6283,淳安,20,0,20,凱基-林口,2023-07-20,9257
2312,金寶,23,4,19,凱基-林口,2023-07-20,9257
2316,楠梓電,34,15,19,凱基-林口,2023-07-20,9257
2323,中環,30,13,17,凱基-林口,2023-07-20,9257
1786,科妍,27,11,16,凱基-林口,2023-07-20,9257
2481,強茂,17,1,16,凱基-林口,2023-07-20,9257
2353,宏��,39,24,15,凱基-林口,2023-07-20,9257
2468,華經,15,0,15,凱基-林口,2023-07-20,9257
2614,東森,17,2,15,凱基-林口,2023-07-20,9257
3518,柏騰,18,4,14,凱基-林口,2023-07-20,9257
2317,鴻海,15,1,14,凱基-林口,2023-07-20,9257
4123,晟德,36,23,13,凱基-林口,2023-07-20,9257
4746,台耀,16,3,13,凱基-林口,2023-07-20,9257
6213,聯茂,14,2,12,凱基-林口,2023-07-20,9257
5469,瀚宇博,12,0,12,凱基-林口,2023-07-20,9257
6191,精成科,14,2,12,凱基-林口,2023-07-20,9257
2419,仲琦,15,4,11,凱基-林口,2023-07-20,9257
2425,承啟,11,0,11,凱基-林口,2023-07-20,9257
2888,新光金,13,2,11,凱基-林口,2023-07-20,9257
3362,先進光,15,4,11,凱基-林口,2023-07-20,9257
6206,飛捷,11,0,11,凱基-林口,2023-07-20,9257
6753,龍德造船,11,0,11,凱基-林口,2023-07-20,9257
00725B,國泰投資級公司債,10,0,10,凱基-林口,2023-07-20,9257
1611,中電,11,1,10,凱基-林口,2023-07-20,9257
2812,台中銀,10,0,10,凱基-林口,2023-07-20,9257
6220,岳豐,10,0,10,凱基-林口,2023-07-20,9257
9927,泰銘,10,0,10,凱基-林口,2023-07-20,9257
1618,合機,12,2,10,凱基-林口,2023-07-20,9257
1514,亞力,23,14,9,凱基-林口,2023-07-20,9257
3305,昇貿,9,0,9,凱基-林口,2023-07-20,9257
3289,宜特,13,5,8,凱基-林口,2023-07-20,9257
5289,宜鼎,8,0,8,凱基-林口,2023-07-20,9257
8234,新漢,11,3,8,凱基-林口,2023-07-20,9257
6770,力積電,8,1,7,凱基-林口,2023-07-20,9257
5483,中美晶,7,0,7,凱基-林口,2023-07-20,9257
00893,國泰智能電動車,7,0,7,凱基-林口,2023-07-20,9257
00679B,元大美債20年,7,0,7,凱基-林口,2023-07-20,9257
2402,毅嘉,445,25,420,凱基-林口,2023-07-21,9257
2534,宏盛,90,0,90,凱基-林口,2023-07-21,9257
1504,東元,78,10,68,凱基-林口,2023-07-21,9257
2609,陽明,62,6,56,凱基-林口,2023-07-21,9257
2313,華通,44,1,43,凱基-林口,2023-07-21,9257
2382,廣達,181,140,41,凱基-林口,2023-07-21,9257
2883,凱基金,62,24,38,凱基-林口,2023-07-21,9257
1309,台達化,34,0,34,凱基-林口,2023-07-21,9257
2888,新光金,27,0,27,凱基-林口,2023-07-21,9257
5009,榮剛,28,2,26,凱基-林口,2023-07-21,9257
3037,欣興,34,9,25,凱基-林口,2023-07-21,9257
020030,統一智慧電動車N,25,0,25,凱基-林口,2023-07-21,9257
2312,金寶,26,4,22,凱基-林口,2023-07-21,9257
9105,泰金寶-DR,20,0,20,凱基-林口,2023-07-21,9257
6206,飛捷,19,0,19,凱基-林口,2023-07-21,9257
2206,三陽工業,19,2,17,凱基-林口,2023-07-21,9257
3264,欣銓,22,5,17,凱基-林口,2023-07-21,9257
00679B,元大美債20年,16,0,16,凱基-林口,2023-07-21,9257
2303,聯電,18,3,15,凱基-林口,2023-07-21,9257
2421,建準,129,114,15,凱基-林口,2023-07-21,9257
2330,台積電,20,5,15,凱基-林口,2023-07-21,9257
2344,華邦電,16,2,14,凱基-林口,2023-07-21,9257
2027,大成鋼,17,3,14,凱基-林口,2023-07-21,9257
1102,亞泥,16,2,14,凱基-林口,2023-07-21,9257
6158,禾昌,14,1,13,凱基-林口,2023-07-21,9257
6188,廣明,18,5,13,凱基-林口,2023-07-21,9257
00891,中信關鍵半導體,12,0,12,凱基-林口,2023-07-21,9257
2201,裕隆,12,1,11,凱基-林口,2023-07-21,9257
00673R,期元大S＆P原油反1,11,0,11,凱基-林口,2023-07-21,9257
1217,愛之味,12,1,11,凱基-林口,2023-07-21,9257
1710,東聯,15,4,11,凱基-林口,2023-07-21,9257
2405,輔信,30,19,11,凱基-林口,2023-07-21,9257
2436,偉詮電,12,1,11,凱基-林口,2023-07-21,9257
6278,台表科,21,10,11,凱基-林口,2023-07-21,9257
1605,華新,10,0,10,凱基-林口,2023-07-21,9257
00923,群益台ESG低碳50,10,0,10,凱基-林口,2023-07-21,9257
1402,遠東新,10,0,10,凱基-林口,2023-07-21,9257
2820,華票,10,0,10,凱基-林口,2023-07-21,9257
3003,健和興,10,0,10,凱基-林口,2023-07-21,9257
4919,新唐,30,20,10,凱基-林口,2023-07-21,9257
4960,誠美材,10,0,10,凱基-林口,2023-07-21,9257
6152,百一,10,0,10,凱基-林口,2023-07-21,9257
6231,系微,11,1,10,凱基-林口,2023-07-21,9257
8446,華研,10,0,10,凱基-林口,2023-07-21,9257
9929,秋雨,10,0,10,凱基-林口,2023-07-21,9257
2380,虹光,9,0,9,凱基-林口,2023-07-21,9257
1905,華紙,16,7,9,凱基-林口,2023-07-21,9257
2929,淘帝-KY,9,0,9,凱基-林口,2023-07-21,9257
3287,廣寰科,22,13,9,凱基-林口,2023-07-21,9257
4746,台耀,14,5,9,凱基-林口,2023-07-21,9257
2534,宏盛,210,0,210,凱基-林口,2023-07-24,9257
3706,神達,130,13,117,凱基-林口,2023-07-24,9257
2402,毅嘉,101,0,101,凱基-林口,2023-07-24,9257
2887,台新金,86,6,80,凱基-林口,2023-07-24,9257
6276,安鈦克,64,2,62,凱基-林口,2023-07-24,9257
6122,擎邦,51,0,51,凱基-林口,2023-07-24,9257
6274,台燿,122,71,51,凱基-林口,2023-07-24,9257
2323,中環,49,2,47,凱基-林口,2023-07-24,9257
3481,群創,48,3,45,凱基-林口,2023-07-24,9257
2603,長榮,32,0,32,凱基-林口,2023-07-24,9257
2515,中工,41,10,31,凱基-林口,2023-07-24,9257
6125,廣運,30,3,27,凱基-林口,2023-07-24,9257
3035,智原,49,23,26,凱基-林口,2023-07-24,9257
1609,大亞,74,50,24,凱基-林口,2023-07-24,9257
6230,尼得科超眾,32,10,22,凱基-林口,2023-07-24,9257
3693,營邦,32,10,22,凱基-林口,2023-07-24,9257
3548,兆利,21,0,21,凱基-林口,2023-07-24,9257
00632R,元大台灣50反1,23,3,20,凱基-林口,2023-07-24,9257
2929,淘帝-KY,20,0,20,凱基-林口,2023-07-24,9257
6152,百一,20,0,20,凱基-林口,2023-07-24,9257
6226,光鼎,20,0,20,凱基-林口,2023-07-24,9257
6283,淳安,20,0,20,凱基-林口,2023-07-24,9257
9105,泰金寶-DR,20,0,20,凱基-林口,2023-07-24,9257
2301,光寶科,95,77,18,凱基-林口,2023-07-24,9257
6190,萬泰科,17,0,17,凱基-林口,2023-07-24,9257
3338,泰碩,24,8,16,凱基-林口,2023-07-24,9257
3264,欣銓,16,1,15,凱基-林口,2023-07-24,9257
1709,和益,15,0,15,凱基-林口,2023-07-24,9257
2637,慧洋-KY,15,0,15,凱基-林口,2023-07-24,9257
3003,健和興,15,0,15,凱基-林口,2023-07-24,9257
3689,湧德,15,0,15,凱基-林口,2023-07-24,9257
2481,強茂,101,87,14,凱基-林口,2023-07-24,9257
3014,聯陽,15,1,14,凱基-林口,2023-07-24,9257
4953,緯軟,21,8,13,凱基-林口,2023-07-24,9257
1101,台泥,12,1,11,凱基-林口,2023-07-24,9257
1727,中華化,11,0,11,凱基-林口,2023-07-24,9257
8071,能率網通,11,0,11,凱基-林口,2023-07-24,9257
2353,宏��,84,74,10,凱基-林口,2023-07-24,9257
2367,燿華,10,0,10,凱基-林口,2023-07-24,9257
2440,太空梭,10,0,10,凱基-林口,2023-07-24,9257
2706,第一店,10,0,10,凱基-林口,2023-07-24,9257
3062,建漢,10,0,10,凱基-林口,2023-07-24,9257
5531,鄉林,10,0,10,凱基-林口,2023-07-24,9257
6220,岳豐,10,0,10,凱基-林口,2023-07-24,9257
6417,韋僑,10,0,10,凱基-林口,2023-07-24,9257
8027,鈦昇,10,0,10,凱基-林口,2023-07-24,9257
8076,伍豐,10,0,10,凱基-林口,2023-07-24,9257
8996,高力,12,2,10,凱基-林口,2023-07-24,9257
9929,秋雨,10,0,10,凱基-林口,2023-07-24,9257
1102,亞泥,9,0,9,凱基-林口,2023-07-24,9257
2329,華泰,207,24,183,凱基-林口,2023-07-25,9257
2801,彰銀,100,0,100,凱基-林口,2023-07-25,9257
3011,今皓,100,0,100,凱基-林口,2023-07-25,9257
2359,所羅門,101,6,95,凱基-林口,2023-07-25,9257
00919,群益台灣精選高息,63,1,62,凱基-林口,2023-07-25,9257
3706,神達,58,24,34,凱基-林口,2023-07-25,9257
2610,華航,56,23,33,凱基-林口,2023-07-25,9257
3231,緯創,39,7,32,凱基-林口,2023-07-25,9257
00878,國泰永續高股息,52,21,31,凱基-林口,2023-07-25,9257
2301,光寶科,159,129,30,凱基-林口,2023-07-25,9257
2637,慧洋-KY,29,0,29,凱基-林口,2023-07-25,9257
00671R,富邦NASDAQ反1,25,0,25,凱基-林口,2023-07-25,9257
1314,中石化,25,0,25,凱基-林口,2023-07-25,9257
6206,飛捷,25,0,25,凱基-林口,2023-07-25,9257
6285,啟��,25,0,25,凱基-林口,2023-07-25,9257
8093,保銳,26,1,25,凱基-林口,2023-07-25,9257
2382,廣達,72,48,24,凱基-林口,2023-07-25,9257
2316,楠梓電,24,0,24,凱基-林口,2023-07-25,9257
00673R,期元大S＆P原油反1,22,0,22,凱基-林口,2023-07-25,9257
6231,系微,22,0,22,凱基-林口,2023-07-25,9257
8358,金居,67,45,22,凱基-林口,2023-07-25,9257
2887,台新金,21,0,21,凱基-林口,2023-07-25,9257
1409,新纖,21,0,21,凱基-林口,2023-07-25,9257
1101,台泥,20,0,20,凱基-林口,2023-07-25,9257
020030,統一智慧電動車N,20,0,20,凱基-林口,2023-07-25,9257
2812,台中銀,20,0,20,凱基-林口,2023-07-25,9257
8021,尖點,20,0,20,凱基-林口,2023-07-25,9257
00632R,元大台灣50反1,19,0,19,凱基-林口,2023-07-25,9257
1338,廣華-KY,19,0,19,凱基-林口,2023-07-25,9257
3711,日月光投控,22,3,19,凱基-林口,2023-07-25,9257
1905,華紙,36,19,17,凱基-林口,2023-07-25,9257
4123,晟德,17,0,17,凱基-林口,2023-07-25,9257
1711,永光,16,0,16,凱基-林口,2023-07-25,9257
2353,宏��,20,4,16,凱基-林口,2023-07-25,9257
00650L,復華香港正2,15,0,15,凱基-林口,2023-07-25,9257
2221,大甲,15,0,15,凱基-林口,2023-07-25,9257
3024,憶聲,17,2,15,凱基-林口,2023-07-25,9257
6026,福邦證,15,0,15,凱基-林口,2023-07-25,9257
6690,安�硌穈T,15,0,15,凱基-林口,2023-07-25,9257
2312,金寶,32,18,14,凱基-林口,2023-07-25,9257
3032,偉訓,24,10,14,凱基-林口,2023-07-25,9257
5386,青雲,19,5,14,凱基-林口,2023-07-25,9257
5443,均豪,20,6,14,凱基-林口,2023-07-25,9257
1513,中興電,19,6,13,凱基-林口,2023-07-25,9257
4953,緯軟,21,8,13,凱基-林口,2023-07-25,9257
00929,復華台灣科技優息,13,0,13,凱基-林口,2023-07-25,9257
2834,臺企銀,13,0,13,凱基-林口,2023-07-25,9257
6124,業強,15,2,13,凱基-林口,2023-07-25,9257
2888,新光金,30,17,13,凱基-林口,2023-07-25,9257
4523,永彰,12,0,12,凱基-林口,2023-07-25,9257
3481,群創,133,30,103,凱基-林口,2023-07-26,9257
00671R,富邦NASDAQ反1,75,0,75,凱基-林口,2023-07-26,9257
2610,華航,72,13,59,凱基-林口,2023-07-26,9257
2888,新光金,73,21,52,凱基-林口,2023-07-26,9257
3163,波若威,45,4,41,凱基-林口,2023-07-26,9257
3019,亞光,45,5,40,凱基-林口,2023-07-26,9257
00878,國泰永續高股息,67,32,35,凱基-林口,2023-07-26,9257
6282,康舒,42,7,35,凱基-林口,2023-07-26,9257
6274,台燿,53,20,33,凱基-林口,2023-07-26,9257
6276,安鈦克,43,10,33,凱基-林口,2023-07-26,9257
2889,國票金,31,0,31,凱基-林口,2023-07-26,9257
3013,晟銘電,30,0,30,凱基-林口,2023-07-26,9257
2614,東森,28,0,28,凱基-林口,2023-07-26,9257
1504,東元,147,120,27,凱基-林口,2023-07-26,9257
6761,穩得,21,0,21,凱基-林口,2023-07-26,9257
2421,建準,34,13,21,凱基-林口,2023-07-26,9257
6234,高僑,20,0,20,凱基-林口,2023-07-26,9257
8021,尖點,20,0,20,凱基-林口,2023-07-26,9257
3706,神達,25,6,19,凱基-林口,2023-07-26,9257
6213,聯茂,22,4,18,凱基-林口,2023-07-26,9257
6275,元山,18,1,17,凱基-林口,2023-07-26,9257
6125,廣運,27,11,16,凱基-林口,2023-07-26,9257
2427,三商電,15,0,15,凱基-林口,2023-07-26,9257
2705,六福,15,0,15,凱基-林口,2023-07-26,9257
3694,海華,15,0,15,凱基-林口,2023-07-26,9257
6117,迎廣,36,22,14,凱基-林口,2023-07-26,9257
00929,復華台灣科技優息,14,0,14,凱基-林口,2023-07-26,9257
2344,華邦電,14,0,14,凱基-林口,2023-07-26,9257
2457,飛宏,15,2,13,凱基-林口,2023-07-26,9257
4123,晟德,16,3,13,凱基-林口,2023-07-26,9257
8046,南電,13,1,12,凱基-林口,2023-07-26,9257
2353,宏��,27,15,12,凱基-林口,2023-07-26,9257
2355,敬鵬,14,2,12,凱基-林口,2023-07-26,9257
4533,協易機,22,10,12,凱基-林口,2023-07-26,9257
6116,彩晶,12,0,12,凱基-林口,2023-07-26,9257
2890,永豐金,12,0,12,凱基-林口,2023-07-26,9257
2324,仁寶,13,2,11,凱基-林口,2023-07-26,9257
6160,欣技,11,0,11,凱基-林口,2023-07-26,9257
6841,長佳智能,10,0,10,凱基-林口,2023-07-26,9257
00891,中信關鍵半導體,10,0,10,凱基-林口,2023-07-26,9257
00888,永豐台灣ESG,10,0,10,凱基-林口,2023-07-26,9257
1301,台塑,10,0,10,凱基-林口,2023-07-26,9257
1444,力麗,10,0,10,凱基-林口,2023-07-26,9257
1905,華紙,17,7,10,凱基-林口,2023-07-26,9257
2009,第一銅,10,0,10,凱基-林口,2023-07-26,9257
2027,大成鋼,10,0,10,凱基-林口,2023-07-26,9257
2371,大同,11,1,10,凱基-林口,2023-07-26,9257
2439,美律,10,0,10,凱基-林口,2023-07-26,9257
2801,彰銀,10,0,10,凱基-林口,2023-07-26,9257
3049,精金,10,0,10,凱基-林口,2023-07-26,9257
2618,長榮航,102,20,82,凱基-林口,2023-07-27,9257
00680L,元大美債20正2,77,0,77,凱基-林口,2023-07-27,9257
6188,廣明,75,19,56,凱基-林口,2023-07-27,9257
2329,華泰,90,41,49,凱基-林口,2023-07-27,9257
3706,神達,52,4,48,凱基-林口,2023-07-27,9257
00679B,元大美債20年,47,0,47,凱基-林口,2023-07-27,9257
00795B,中信美國公債20年,40,0,40,凱基-林口,2023-07-27,9257
00650L,復華香港正2,35,0,35,凱基-林口,2023-07-27,9257
3357,臺慶科,35,0,35,凱基-林口,2023-07-27,9257
1560,中砂,45,11,34,凱基-林口,2023-07-27,9257
00885,富邦越南,45,16,29,凱基-林口,2023-07-27,9257
3035,智原,39,11,28,凱基-林口,2023-07-27,9257
5488,松普,30,2,28,凱基-林口,2023-07-27,9257
1504,東元,42,14,28,凱基-林口,2023-07-27,9257
2881,富邦金,27,0,27,凱基-林口,2023-07-27,9257
2609,陽明,28,2,26,凱基-林口,2023-07-27,9257
1303,南亞,25,0,25,凱基-林口,2023-07-27,9257
2340,台亞,27,2,25,凱基-林口,2023-07-27,9257
00929,復華台灣科技優息,29,5,24,凱基-林口,2023-07-27,9257
2002,中鋼,23,0,23,凱基-林口,2023-07-27,9257
1618,合機,29,9,20,凱基-林口,2023-07-27,9257
3338,泰碩,21,1,20,凱基-林口,2023-07-27,9257
5351,鈺創,24,4,20,凱基-林口,2023-07-27,9257
6125,廣運,75,55,20,凱基-林口,2023-07-27,9257
2887,台新金,19,0,19,凱基-林口,2023-07-27,9257
3346,麗清,20,2,18,凱基-林口,2023-07-27,9257
2913,農林,23,6,17,凱基-林口,2023-07-27,9257
1338,廣華-KY,16,0,16,凱基-林口,2023-07-27,9257
2353,宏��,20,4,16,凱基-林口,2023-07-27,9257
9105,泰金寶-DR,16,0,16,凱基-林口,2023-07-27,9257
2382,廣達,45,30,15,凱基-林口,2023-07-27,9257
2344,華邦電,17,4,13,凱基-林口,2023-07-27,9257
2449,京元電子,15,2,13,凱基-林口,2023-07-27,9257
3231,緯創,16,3,13,凱基-林口,2023-07-27,9257
3037,欣興,24,11,13,凱基-林口,2023-07-27,9257
8046,南電,12,0,12,凱基-林口,2023-07-27,9257
1907,永豐餘,23,11,12,凱基-林口,2023-07-27,9257
2614,東森,10,0,10,凱基-林口,2023-07-27,9257
6223,旺矽,11,1,10,凱基-林口,2023-07-27,9257
1609,大亞,18,8,10,凱基-林口,2023-07-27,9257
1731,美吾華,10,0,10,凱基-林口,2023-07-27,9257
2324,仁寶,33,23,10,凱基-林口,2023-07-27,9257
8028,昇陽半導體,14,4,10,凱基-林口,2023-07-27,9257
6187,萬潤,17,7,10,凱基-林口,2023-07-27,9257
0050,元大台灣50,11,2,9,凱基-林口,2023-07-27,9257
1240,茂生農經,9,0,9,凱基-林口,2023-07-27,9257
1568,倉佑,9,0,9,凱基-林口,2023-07-27,9257
6150,撼訊,9,0,9,凱基-林口,2023-07-27,9257
9962,有益,10,1,9,凱基-林口,2023-07-27,9257
00902,中信電池及儲能,8,0,8,凱基-林口,2023-07-27,9257
2883,凱基金,511,0,511,凱基-林口,2023-07-28,9257
2606,裕民,225,5,220,凱基-林口,2023-07-28,9257
2402,毅嘉,228,45,183,凱基-林口,2023-07-28,9257
00706L,期元大S＆P日圓正2,155,0,155,凱基-林口,2023-07-28,9257
00688L,國泰20年美債正2,117,0,117,凱基-林口,2023-07-28,9257
00919,群益台灣精選高息,100,3,97,凱基-林口,2023-07-28,9257
00680L,元大美債20正2,91,0,91,凱基-林口,2023-07-28,9257
00679B,元大美債20年,73,0,73,凱基-林口,2023-07-28,9257
1905,華紙,117,62,55,凱基-林口,2023-07-28,9257
00795B,中信美國公債20年,53,0,53,凱基-林口,2023-07-28,9257
2610,華航,47,5,42,凱基-林口,2023-07-28,9257
2323,中環,38,0,38,凱基-林口,2023-07-28,9257
2888,新光金,97,60,37,凱基-林口,2023-07-28,9257
2027,大成鋼,39,5,34,凱基-林口,2023-07-28,9257
6591,動力-KY,32,0,32,凱基-林口,2023-07-28,9257
2421,建準,33,2,31,凱基-林口,2023-07-28,9257
00929,復華台灣科技優息,30,0,30,凱基-林口,2023-07-28,9257
2753,八方雲集,30,0,30,凱基-林口,2023-07-28,9257
3693,營邦,30,0,30,凱基-林口,2023-07-28,9257
00687B,國泰20年美債,31,2,29,凱基-林口,2023-07-28,9257
1609,大亞,33,7,26,凱基-林口,2023-07-28,9257
00878,國泰永續高股息,78,54,24,凱基-林口,2023-07-28,9257
00772B,中信高評級公司債,23,0,23,凱基-林口,2023-07-28,9257
2356,英業達,27,5,22,凱基-林口,2023-07-28,9257
5488,松普,21,0,21,凱基-林口,2023-07-28,9257
9938,百和,25,4,21,凱基-林口,2023-07-28,9257
2820,華票,20,0,20,凱基-林口,2023-07-28,9257
1314,中石化,18,0,18,凱基-林口,2023-07-28,9257
1303,南亞,17,0,17,凱基-林口,2023-07-28,9257
1591,駿吉-KY,17,0,17,凱基-林口,2023-07-28,9257
3035,智原,21,4,17,凱基-林口,2023-07-28,9257
3357,臺慶科,16,0,16,凱基-林口,2023-07-28,9257
2014,中鴻,20,5,15,凱基-林口,2023-07-28,9257
2887,台新金,15,0,15,凱基-林口,2023-07-28,9257
1605,華新,16,1,15,凱基-林口,2023-07-28,9257
2371,大同,15,1,14,凱基-林口,2023-07-28,9257
6279,胡連,14,0,14,凱基-林口,2023-07-28,9257
2405,輔信,23,10,13,凱基-林口,2023-07-28,9257
4961,天鈺,14,1,13,凱基-林口,2023-07-28,9257
8110,華東,13,0,13,凱基-林口,2023-07-28,9257
2031,新光鋼,15,3,12,凱基-林口,2023-07-28,9257
6269,台郡,12,0,12,凱基-林口,2023-07-28,9257
1101,台泥,31,20,11,凱基-林口,2023-07-28,9257
00907,永豐優息存股,10,0,10,凱基-林口,2023-07-28,9257
1618,合機,10,0,10,凱基-林口,2023-07-28,9257
2489,瑞軒,10,0,10,凱基-林口,2023-07-28,9257
2867,三商壽,15,5,10,凱基-林口,2023-07-28,9257
2885,元大金,10,0,10,凱基-林口,2023-07-28,9257
3374,精材,10,0,10,凱基-林口,2023-07-28,9257
6216,居易,10,0,10,凱基-林口,2023-07-28,9257
2402,毅嘉,495,10,485,凱基-林口,2023-07-31,9257
00665L,富邦�琤肭磪囓�2,220,60,160,凱基-林口,2023-07-31,9257
3706,神達,119,3,116,凱基-林口,2023-07-31,9257
00919,群益台灣精選高息,117,6,111,凱基-林口,2023-07-31,9257
6285,啟��,110,10,100,凱基-林口,2023-07-31,9257
00679B,元大美債20年,89,1,88,凱基-林口,2023-07-31,9257
00929,復華台灣科技優息,73,3,70,凱基-林口,2023-07-31,9257
2206,三陽工業,48,4,44,凱基-林口,2023-07-31,9257
3357,臺慶科,45,4,41,凱基-林口,2023-07-31,9257
2603,長榮,38,0,38,凱基-林口,2023-07-31,9257
2371,大同,75,45,30,凱基-林口,2023-07-31,9257
2409,友達,30,2,28,凱基-林口,2023-07-31,9257
2610,華航,43,16,27,凱基-林口,2023-07-31,9257
2324,仁寶,41,14,27,凱基-林口,2023-07-31,9257
8358,金居,38,11,27,凱基-林口,2023-07-31,9257
2002,中鋼,23,0,23,凱基-林口,2023-07-31,9257
2630,亞航,25,3,22,凱基-林口,2023-07-31,9257
2382,廣達,97,76,21,凱基-林口,2023-07-31,9257
3325,旭品,22,2,20,凱基-林口,2023-07-31,9257
5353,台林,20,0,20,凱基-林口,2023-07-31,9257
3037,欣興,38,19,19,凱基-林口,2023-07-31,9257
4919,新唐,21,3,18,凱基-林口,2023-07-31,9257
3231,緯創,77,60,17,凱基-林口,2023-07-31,9257
4953,緯軟,20,4,16,凱基-林口,2023-07-31,9257
3035,智原,28,13,15,凱基-林口,2023-07-31,9257
3479,安勤,15,0,15,凱基-林口,2023-07-31,9257
1319,東陽,14,0,14,凱基-林口,2023-07-31,9257
2313,華通,14,0,14,凱基-林口,2023-07-31,9257
2425,承啟,14,0,14,凱基-林口,2023-07-31,9257
6269,台郡,13,0,13,凱基-林口,2023-07-31,9257
00673R,期元大S＆P原油反1,13,0,13,凱基-林口,2023-07-31,9257
00923,群益台ESG低碳50,12,0,12,凱基-林口,2023-07-31,9257
2337,旺宏,12,0,12,凱基-林口,2023-07-31,9257
2393,億光,12,0,12,凱基-林口,2023-07-31,9257
2457,飛宏,12,0,12,凱基-林口,2023-07-31,9257
1618,合機,11,0,11,凱基-林口,2023-07-31,9257
9938,百和,11,0,11,凱基-林口,2023-07-31,9257
00905,FT臺灣Smart,10,0,10,凱基-林口,2023-07-31,9257
00756B,群益投等新興公債,10,0,10,凱基-林口,2023-07-31,9257
00650L,復華香港正2,10,0,10,凱基-林口,2023-07-31,9257
1584,精剛,10,0,10,凱基-林口,2023-07-31,9257
2451,創見,10,0,10,凱基-林口,2023-07-31,9257
2542,興富發,10,0,10,凱基-林口,2023-07-31,9257
3264,欣銓,10,0,10,凱基-林口,2023-07-31,9257
4714,永捷,10,0,10,凱基-林口,2023-07-31,9257
5488,松普,10,0,10,凱基-林口,2023-07-31,9257
6278,台表科,10,0,10,凱基-林口,2023-07-31,9257
2301,光寶科,49,40,9,凱基-林口,2023-07-31,9257
2369,菱生,10,1,9,凱基-林口,2023-07-31,9257
6150,撼訊,9,0,9,凱基-林口,2023-07-31,9257
2888,新光金,157,9,148,凱基-林口,2023-08-01,9257
2312,金寶,165,29,136,凱基-林口,2023-08-01,9257
3033,威健,83,2,81,凱基-林口,2023-08-01,9257
3481,群創,102,24,78,凱基-林口,2023-08-01,9257
5488,松普,74,0,74,凱基-林口,2023-08-01,9257
00680L,元大美債20正2,57,0,57,凱基-林口,2023-08-01,9257
6138,茂達,53,0,53,凱基-林口,2023-08-01,9257
2883,凱基金,51,1,50,凱基-林口,2023-08-01,9257
00878,國泰永續高股息,142,94,48,凱基-林口,2023-08-01,9257
00929,復華台灣科技優息,65,30,35,凱基-林口,2023-08-01,9257
3706,神達,38,5,33,凱基-林口,2023-08-01,9257
2534,宏盛,40,10,30,凱基-林口,2023-08-01,9257
2363,矽統,61,32,29,凱基-林口,2023-08-01,9257
2913,農林,84,56,28,凱基-林口,2023-08-01,9257
6547,高端疫苗,29,1,28,凱基-林口,2023-08-01,9257
1802,台玻,38,11,27,凱基-林口,2023-08-01,9257
6274,台燿,53,28,25,凱基-林口,2023-08-01,9257
1905,華紙,24,1,23,凱基-林口,2023-08-01,9257
3710,連展投控,22,0,22,凱基-林口,2023-08-01,9257
1301,台塑,21,3,18,凱基-林口,2023-08-01,9257
6282,康舒,52,34,18,凱基-林口,2023-08-01,9257
3105,穩懋,23,6,17,凱基-林口,2023-08-01,9257
1513,中興電,18,2,16,凱基-林口,2023-08-01,9257
1303,南亞,18,2,16,凱基-林口,2023-08-01,9257
2324,仁寶,24,8,16,凱基-林口,2023-08-01,9257
2425,承啟,18,2,16,凱基-林口,2023-08-01,9257
0050,元大台灣50,16,0,16,凱基-林口,2023-08-01,9257
2812,台中銀,15,0,15,凱基-林口,2023-08-01,9257
00673R,期元大S＆P原油反1,14,0,14,凱基-林口,2023-08-01,9257
3035,智原,13,0,13,凱基-林口,2023-08-01,9257
3363,上詮,13,0,13,凱基-林口,2023-08-01,9257
3704,合勤控,14,1,13,凱基-林口,2023-08-01,9257
5483,中美晶,13,0,13,凱基-林口,2023-08-01,9257
00923,群益台ESG低碳50,12,0,12,凱基-林口,2023-08-01,9257
3305,昇貿,11,0,11,凱基-林口,2023-08-01,9257
2344,華邦電,17,6,11,凱基-林口,2023-08-01,9257
1519,華城,25,15,10,凱基-林口,2023-08-01,9257
1701,中化,10,0,10,凱基-林口,2023-08-01,9257
2426,鼎元,10,0,10,凱基-林口,2023-08-01,9257
2542,興富發,10,0,10,凱基-林口,2023-08-01,9257
4720,德淵,10,0,10,凱基-林口,2023-08-01,9257
5328,華容,10,0,10,凱基-林口,2023-08-01,9257
8016,矽創,11,1,10,凱基-林口,2023-08-01,9257
4919,新唐,16,6,10,凱基-林口,2023-08-01,9257
1584,精剛,10,1,9,凱基-林口,2023-08-01,9257
2201,裕隆,11,2,9,凱基-林口,2023-08-01,9257
2331,精英,9,0,9,凱基-林口,2023-08-01,9257
2472,立隆電,9,0,9,凱基-林口,2023-08-01,9257
6684,安格,12,3,9,凱基-林口,2023-08-01,9257
8926,台汽電,10,1,9,凱基-林口,2023-08-01,9257
2888,新光金,172,1,171,凱基-林口,2023-08-02,9257
3481,群創,193,36,157,凱基-林口,2023-08-02,9257
00878,國泰永續高股息,138,3,135,凱基-林口,2023-08-02,9257
6138,茂達,87,0,87,凱基-林口,2023-08-02,9257
2882,國泰金,77,3,74,凱基-林口,2023-08-02,9257
00929,復華台灣科技優息,65,1,64,凱基-林口,2023-08-02,9257
00930,永豐ESG低碳高息,63,0,63,凱基-林口,2023-08-02,9257
2706,第一店,60,0,60,凱基-林口,2023-08-02,9257
00688L,國泰20年美債正2,55,0,55,凱基-林口,2023-08-02,9257
00706L,期元大S＆P日圓正2,50,0,50,凱基-林口,2023-08-02,9257
6282,康舒,73,26,47,凱基-林口,2023-08-02,9257
00687B,國泰20年美債,47,0,47,凱基-林口,2023-08-02,9257
3706,神達,51,9,42,凱基-林口,2023-08-02,9257
6015,宏遠證,42,1,41,凱基-林口,2023-08-02,9257
2883,凱基金,42,2,40,凱基-林口,2023-08-02,9257
3231,緯創,67,27,40,凱基-林口,2023-08-02,9257
00900,富邦特選高股息30,36,2,34,凱基-林口,2023-08-02,9257
2312,金寶,129,96,33,凱基-林口,2023-08-02,9257
0056,元大高股息,67,35,32,凱基-林口,2023-08-02,9257
00885,富邦越南,30,3,27,凱基-林口,2023-08-02,9257
5351,鈺創,31,5,26,凱基-林口,2023-08-02,9257
00923,群益台ESG低碳50,26,0,26,凱基-林口,2023-08-02,9257
2402,毅嘉,494,470,24,凱基-林口,2023-08-02,9257
2323,中環,21,0,21,凱基-林口,2023-08-02,9257
2850,新產,21,0,21,凱基-林口,2023-08-02,9257
2356,英業達,45,24,21,凱基-林口,2023-08-02,9257
1338,廣華-KY,20,0,20,凱基-林口,2023-08-02,9257
2349,錸德,20,0,20,凱基-林口,2023-08-02,9257
2542,興富發,20,0,20,凱基-林口,2023-08-02,9257
00713,元大台灣高息低波,21,2,19,凱基-林口,2023-08-02,9257
00891,中信關鍵半導體,19,0,19,凱基-林口,2023-08-02,9257
2340,台亞,20,1,19,凱基-林口,2023-08-02,9257
3357,臺慶科,19,0,19,凱基-林口,2023-08-02,9257
8071,能率網通,19,0,19,凱基-林口,2023-08-02,9257
6188,廣明,22,4,18,凱基-林口,2023-08-02,9257
00850,元大臺灣ESG永續,16,0,16,凱基-林口,2023-08-02,9257
2002,中鋼,16,0,16,凱基-林口,2023-08-02,9257
3689,湧德,15,0,15,凱基-林口,2023-08-02,9257
1605,華新,235,220,15,凱基-林口,2023-08-02,9257
00720B,元大投資級公司債,14,0,14,凱基-林口,2023-08-02,9257
2367,燿華,16,2,14,凱基-林口,2023-08-02,9257
2382,廣達,54,41,13,凱基-林口,2023-08-02,9257
00772B,中信高評級公司債,13,0,13,凱基-林口,2023-08-02,9257
3035,智原,14,1,13,凱基-林口,2023-08-02,9257
3033,威健,16,3,13,凱基-林口,2023-08-02,9257
6591,動力-KY,12,0,12,凱基-林口,2023-08-02,9257
00722B,群益投資級電信債,11,0,11,凱基-林口,2023-08-02,9257
6531,愛普*,18,7,11,凱基-林口,2023-08-02,9257
4979,華星光,16,5,11,凱基-林口,2023-08-02,9257
5864,致和證,11,0,11,凱基-林口,2023-08-02,9257
2882,國泰金,373,13,360,凱基-林口,2023-08-04,9257
00753L,中信中國50正2,347,0,347,凱基-林口,2023-08-04,9257
2344,華邦電,78,5,73,凱基-林口,2023-08-04,9257
2610,華航,73,2,71,凱基-林口,2023-08-04,9257
2460,建通,57,5,52,凱基-林口,2023-08-04,9257
3231,緯創,130,81,49,凱基-林口,2023-08-04,9257
3706,神達,69,21,48,凱基-林口,2023-08-04,9257
00679B,元大美債20年,70,22,48,凱基-林口,2023-08-04,9257
00680L,元大美債20正2,94,51,43,凱基-林口,2023-08-04,9257
00900,富邦特選高股息30,37,0,37,凱基-林口,2023-08-04,9257
00929,復華台灣科技優息,38,1,37,凱基-林口,2023-08-04,9257
2356,英業達,56,20,36,凱基-林口,2023-08-04,9257
3693,營邦,36,5,31,凱基-林口,2023-08-04,9257
9927,泰銘,25,0,25,凱基-林口,2023-08-04,9257
1785,光洋科,24,0,24,凱基-林口,2023-08-04,9257
2014,中鴻,26,2,24,凱基-林口,2023-08-04,9257
00712,復華富時不動產,24,1,23,凱基-林口,2023-08-04,9257
00751B,元大AAA至A公司債,21,0,21,凱基-林口,2023-08-04,9257
9939,宏全,21,0,21,凱基-林口,2023-08-04,9257
0056,元大高股息,30,10,20,凱基-林口,2023-08-04,9257
6234,高僑,20,0,20,凱基-林口,2023-08-04,9257
8046,南電,21,2,19,凱基-林口,2023-08-04,9257
1504,東元,25,7,18,凱基-林口,2023-08-04,9257
2801,彰銀,18,0,18,凱基-林口,2023-08-04,9257
3481,群創,16,1,15,凱基-林口,2023-08-04,9257
2705,六福,14,0,14,凱基-林口,2023-08-04,9257
2312,金寶,14,1,13,凱基-林口,2023-08-04,9257
1802,台玻,32,20,12,凱基-林口,2023-08-04,9257
3014,聯陽,15,3,12,凱基-林口,2023-08-04,9257
3029,零壹,15,3,12,凱基-林口,2023-08-04,9257
2009,第一銅,11,0,11,凱基-林口,2023-08-04,9257
2472,立隆電,11,0,11,凱基-林口,2023-08-04,9257
00687B,國泰20年美債,10,0,10,凱基-林口,2023-08-04,9257
1313,聯成,10,0,10,凱基-林口,2023-08-04,9257
2353,宏��,10,0,10,凱基-林口,2023-08-04,9257
2369,菱生,10,0,10,凱基-林口,2023-08-04,9257
2607,榮運,10,0,10,凱基-林口,2023-08-04,9257
2880,華南金,10,0,10,凱基-林口,2023-08-04,9257
6257,矽格,10,0,10,凱基-林口,2023-08-04,9257
6806,森崴能源,10,0,10,凱基-林口,2023-08-04,9257
9938,百和,10,0,10,凱基-林口,2023-08-04,9257
9955,佳龍,10,0,10,凱基-林口,2023-08-04,9257
2727,王品,11,1,10,凱基-林口,2023-08-04,9257
1216,統一,9,0,9,凱基-林口,2023-08-04,9257
2330,台積電,11,2,9,凱基-林口,2023-08-04,9257
1605,華新,19,11,8,凱基-林口,2023-08-04,9257
00923,群益台ESG低碳50,9,0,9,凱基-林口,2023-08-04,9257
2498,宏達電,15,7,8,凱基-林口,2023-08-04,9257
2301,光寶科,21,14,7,凱基-林口,2023-08-04,9257
8215,明基材,21,14,7,凱基-林口,2023-08-04,9257
2891,中信金,72,2,70,凱基-林口,2023-08-07,9257
2913,農林,70,1,69,凱基-林口,2023-08-07,9257
00679B,元大美債20年,62,0,62,凱基-林口,2023-08-07,9257
2883,凱基金,56,1,55,凱基-林口,2023-08-07,9257
00929,復華台灣科技優息,55,1,54,凱基-林口,2023-08-07,9257
00902,中信電池及儲能,51,0,51,凱基-林口,2023-08-07,9257
00795B,中信美國公債20年,36,0,36,凱基-林口,2023-08-07,9257
2812,台中銀,30,0,30,凱基-林口,2023-08-07,9257
5351,鈺創,30,0,30,凱基-林口,2023-08-07,9257
2892,第一金,31,2,29,凱基-林口,2023-08-07,9257
3035,智原,34,7,27,凱基-林口,2023-08-07,9257
6138,茂達,27,0,27,凱基-林口,2023-08-07,9257
2458,義隆,26,0,26,凱基-林口,2023-08-07,9257
6285,啟��,47,21,26,凱基-林口,2023-08-07,9257
00772B,中信高評級公司債,20,0,20,凱基-林口,2023-08-07,9257
00920,富邦ESG綠色電力,20,0,20,凱基-林口,2023-08-07,9257
2323,中環,20,0,20,凱基-林口,2023-08-07,9257
4953,緯軟,27,7,20,凱基-林口,2023-08-07,9257
2603,長榮,44,25,19,凱基-林口,2023-08-07,9257
00637L,元大滬深300正2,21,3,18,凱基-林口,2023-08-07,9257
2356,英業達,54,37,17,凱基-林口,2023-08-07,9257
2020,美亞,16,0,16,凱基-林口,2023-08-07,9257
2328,廣宇,16,0,16,凱基-林口,2023-08-07,9257
3715,定穎投控,16,0,16,凱基-林口,2023-08-07,9257
2534,宏盛,15,0,15,凱基-林口,2023-08-07,9257
8034,榮群,17,2,15,凱基-林口,2023-08-07,9257
2301,光寶科,62,47,15,凱基-林口,2023-08-07,9257
2352,佳世達,21,7,14,凱基-林口,2023-08-07,9257
6015,宏遠證,14,0,14,凱基-林口,2023-08-07,9257
3706,神達,108,94,14,凱基-林口,2023-08-07,9257
00931B,統一美債20年,13,0,13,凱基-林口,2023-08-07,9257
00923,群益台ESG低碳50,12,0,12,凱基-林口,2023-08-07,9257
3014,聯陽,12,0,12,凱基-林口,2023-08-07,9257
00692,富邦公司治理,13,2,11,凱基-林口,2023-08-07,9257
2303,聯電,11,0,11,凱基-林口,2023-08-07,9257
5213,亞昕,11,0,11,凱基-林口,2023-08-07,9257
6150,撼訊,11,0,11,凱基-林口,2023-08-07,9257
8050,廣積,16,5,11,凱基-林口,2023-08-07,9257
5009,榮剛,16,5,11,凱基-林口,2023-08-07,9257
2504,國產,28,18,10,凱基-林口,2023-08-07,9257
00673R,期元大S＆P原油反1,10,0,10,凱基-林口,2023-08-07,9257
1795,美時,10,0,10,凱基-林口,2023-08-07,9257
1815,富喬,10,0,10,凱基-林口,2023-08-07,9257
3576,聯合再生,11,1,10,凱基-林口,2023-08-07,9257
3707,漢磊,10,0,10,凱基-林口,2023-08-07,9257
4912,聯德控股-KY,10,0,10,凱基-林口,2023-08-07,9257
6120,達運,10,0,10,凱基-林口,2023-08-07,9257
00900,富邦特選高股息30,10,0,10,凱基-林口,2023-08-07,9257
8046,南電,9,0,9,凱基-林口,2023-08-07,9257
2890,永豐金,8,0,8,凱基-林口,2023-08-07,9257
2883,凱基金,155,2,153,凱基-林口,2023-08-08,9257
00929,復華台灣科技優息,96,0,96,凱基-林口,2023-08-08,9257
6285,啟��,64,7,57,凱基-林口,2023-08-08,9257
00878,國泰永續高股息,82,27,55,凱基-林口,2023-08-08,9257
2356,英業達,142,100,42,凱基-林口,2023-08-08,9257
00931B,統一美債20年,39,0,39,凱基-林口,2023-08-08,9257
8103,瀚荃,38,0,38,凱基-林口,2023-08-08,9257
5880,合庫金,37,0,37,凱基-林口,2023-08-08,9257
3035,智原,36,2,34,凱基-林口,2023-08-08,9257
00679B,元大美債20年,32,0,32,凱基-林口,2023-08-08,9257
1229,聯華,30,0,30,凱基-林口,2023-08-08,9257
8021,尖點,30,0,30,凱基-林口,2023-08-08,9257
8050,廣積,37,13,24,凱基-林口,2023-08-08,9257
3611,鼎翰,22,0,22,凱基-林口,2023-08-08,9257
00888,永豐台灣ESG,21,0,21,凱基-林口,2023-08-08,9257
00772B,中信高評級公司債,20,0,20,凱基-林口,2023-08-08,9257
00671R,富邦NASDAQ反1,20,0,20,凱基-林口,2023-08-08,9257
3287,廣寰科,20,0,20,凱基-林口,2023-08-08,9257
3706,神達,75,55,20,凱基-林口,2023-08-08,9257
3231,緯創,150,131,19,凱基-林口,2023-08-08,9257
2888,新光金,18,0,18,凱基-林口,2023-08-08,9257
6470,宇智,20,2,18,凱基-林口,2023-08-08,9257
2367,燿華,18,1,17,凱基-林口,2023-08-08,9257
2834,臺企銀,18,1,17,凱基-林口,2023-08-08,9257
00680L,元大美債20正2,16,0,16,凱基-林口,2023-08-08,9257
00891,中信關鍵半導體,15,0,15,凱基-林口,2023-08-08,9257
2457,飛宏,21,6,15,凱基-林口,2023-08-08,9257
2382,廣達,67,53,14,凱基-林口,2023-08-08,9257
00923,群益台ESG低碳50,14,0,14,凱基-林口,2023-08-08,9257
1108,幸福,14,0,14,凱基-林口,2023-08-08,9257
1101,台泥,13,0,13,凱基-林口,2023-08-08,9257
6139,亞翔,12,0,12,凱基-林口,2023-08-08,9257
6231,系微,12,0,12,凱基-林口,2023-08-08,9257
8234,新漢,12,0,12,凱基-林口,2023-08-08,9257
2890,永豐金,13,1,12,凱基-林口,2023-08-08,9257
1303,南亞,11,0,11,凱基-林口,2023-08-08,9257
1513,中興電,14,3,11,凱基-林口,2023-08-08,9257
00907,永豐優息存股,10,0,10,凱基-林口,2023-08-08,9257
00706L,期元大S＆P日圓正2,10,0,10,凱基-林口,2023-08-08,9257
1338,廣華-KY,10,0,10,凱基-林口,2023-08-08,9257
2329,華泰,20,10,10,凱基-林口,2023-08-08,9257
2388,威盛,13,3,10,凱基-林口,2023-08-08,9257
2472,立隆電,10,0,10,凱基-林口,2023-08-08,9257
3029,零壹,10,0,10,凱基-林口,2023-08-08,9257
4938,和碩,10,0,10,凱基-林口,2023-08-08,9257
6216,居易,10,0,10,凱基-林口,2023-08-08,9257
6538,倉和,12,2,10,凱基-林口,2023-08-08,9257
8059,凱碩,10,0,10,凱基-林口,2023-08-08,9257
1446,宏和,9,0,9,凱基-林口,2023-08-08,9257
3264,欣銓,9,0,9,凱基-林口,2023-08-08,9257
2883,凱基金,230,11,219,凱基-林口,2023-08-09,9257
2618,長榮航,237,41,196,凱基-林口,2023-08-09,9257
00929,復華台灣科技優息,62,0,62,凱基-林口,2023-08-09,9257
3481,群創,65,12,53,凱基-林口,2023-08-09,9257
2363,矽統,80,28,52,凱基-林口,2023-08-09,9257
00772B,中信高評級公司債,46,0,46,凱基-林口,2023-08-09,9257
00712,復華富時不動產,50,5,45,凱基-林口,2023-08-09,9257
2385,群光,44,0,44,凱基-林口,2023-08-09,9257
3231,緯創,88,50,38,凱基-林口,2023-08-09,9257
00878,國泰永續高股息,41,3,38,凱基-林口,2023-08-09,9257
2316,楠梓電,32,0,32,凱基-林口,2023-08-09,9257
2913,農林,83,51,32,凱基-林口,2023-08-09,9257
3163,波若威,36,5,31,凱基-林口,2023-08-09,9257
00753L,中信中國50正2,30,0,30,凱基-林口,2023-08-09,9257
3356,奇偶,27,0,27,凱基-林口,2023-08-09,9257
2323,中環,50,25,25,凱基-林口,2023-08-09,9257
2344,華邦電,24,0,24,凱基-林口,2023-08-09,9257
1210,大成,26,3,23,凱基-林口,2023-08-09,9257
2838,聯邦銀,20,0,20,凱基-林口,2023-08-09,9257
2027,大成鋼,19,0,19,凱基-林口,2023-08-09,9257
2890,永豐金,18,0,18,凱基-林口,2023-08-09,9257
4906,正文,35,18,17,凱基-林口,2023-08-09,9257
00900,富邦特選高股息30,20,5,15,凱基-林口,2023-08-09,9257
00923,群益台ESG低碳50,14,0,14,凱基-林口,2023-08-09,9257
3013,晟銘電,15,1,14,凱基-林口,2023-08-09,9257
4720,德淵,13,0,13,凱基-林口,2023-08-09,9257
4973,廣穎,14,1,13,凱基-林口,2023-08-09,9257
5880,合庫金,13,0,13,凱基-林口,2023-08-09,9257
2201,裕隆,14,2,12,凱基-林口,2023-08-09,9257
1319,東陽,14,2,12,凱基-林口,2023-08-09,9257
1616,億泰,12,0,12,凱基-林口,2023-08-09,9257
2329,華泰,24,12,12,凱基-林口,2023-08-09,9257
8215,明基材,12,0,12,凱基-林口,2023-08-09,9257
3260,威剛,11,0,11,凱基-林口,2023-08-09,9257
6223,旺矽,14,3,11,凱基-林口,2023-08-09,9257
9962,有益,11,0,11,凱基-林口,2023-08-09,9257
2352,佳世達,11,0,11,凱基-林口,2023-08-09,9257
1338,廣華-KY,10,0,10,凱基-林口,2023-08-09,9257
2233,宇隆,10,0,10,凱基-林口,2023-08-09,9257
2367,燿華,10,0,10,凱基-林口,2023-08-09,9257
3004,豐達科,11,1,10,凱基-林口,2023-08-09,9257
3045,台灣大,10,0,10,凱基-林口,2023-08-09,9257
3704,合勤控,10,0,10,凱基-林口,2023-08-09,9257
4164,承業醫,10,0,10,凱基-林口,2023-08-09,9257
6194,育富,16,6,10,凱基-林口,2023-08-09,9257
6269,台郡,10,0,10,凱基-林口,2023-08-09,9257
8059,凱碩,10,0,10,凱基-林口,2023-08-09,9257
2002,中鋼,9,0,9,凱基-林口,2023-08-09,9257
2891,中信金,13,4,9,凱基-林口,2023-08-09,9257
3014,聯陽,14,5,9,凱基-林口,2023-08-09,9257
2402,毅嘉,528,310,218,凱基-林口,2023-08-10,9257
2883,凱基金,143,0,143,凱基-林口,2023-08-10,9257
2610,華航,173,48,125,凱基-林口,2023-08-10,9257
3706,神達,101,7,94,凱基-林口,2023-08-10,9257
00878,國泰永續高股息,140,51,89,凱基-林口,2023-08-10,9257
6231,系微,88,3,85,凱基-林口,2023-08-10,9257
00637L,元大滬深300正2,81,2,79,凱基-林口,2023-08-10,9257
3231,緯創,92,28,64,凱基-林口,2023-08-10,9257
00929,復華台灣科技優息,67,6,61,凱基-林口,2023-08-10,9257
0056,元大高股息,88,28,60,凱基-林口,2023-08-10,9257
2457,飛宏,56,5,51,凱基-林口,2023-08-10,9257
2409,友達,47,1,46,凱基-林口,2023-08-10,9257
2363,矽統,86,44,42,凱基-林口,2023-08-10,9257
4960,誠美材,40,0,40,凱基-林口,2023-08-10,9257
8358,金居,45,13,32,凱基-林口,2023-08-10,9257
2382,廣達,78,46,32,凱基-林口,2023-08-10,9257
00900,富邦特選高股息30,31,0,31,凱基-林口,2023-08-10,9257
2301,光寶科,37,7,30,凱基-林口,2023-08-10,9257
2376,技嘉,29,1,28,凱基-林口,2023-08-10,9257
3032,偉訓,57,29,28,凱基-林口,2023-08-10,9257
3035,智原,25,2,23,凱基-林口,2023-08-10,9257
2324,仁寶,25,3,22,凱基-林口,2023-08-10,9257
9962,有益,21,0,21,凱基-林口,2023-08-10,9257
00671R,富邦NASDAQ反1,20,0,20,凱基-林口,2023-08-10,9257
5284,jpp-KY,36,16,20,凱基-林口,2023-08-10,9257
2888,新光金,525,506,19,凱基-林口,2023-08-10,9257
00923,群益台ESG低碳50,26,7,19,凱基-林口,2023-08-10,9257
2323,中環,20,3,17,凱基-林口,2023-08-10,9257
2312,金寶,21,5,16,凱基-林口,2023-08-10,9257
2329,華泰,20,4,16,凱基-林口,2023-08-10,9257
00919,群益台灣精選高息,15,0,15,凱基-林口,2023-08-10,9257
2405,輔信,20,5,15,凱基-林口,2023-08-10,9257
6285,啟��,20,5,15,凱基-林口,2023-08-10,9257
3044,健鼎,41,26,15,凱基-林口,2023-08-10,9257
6194,育富,15,0,15,凱基-林口,2023-08-10,9257
2886,兆豐金,14,0,14,凱基-林口,2023-08-10,9257
2367,燿華,19,5,14,凱基-林口,2023-08-10,9257
6684,安格,14,0,14,凱基-林口,2023-08-10,9257
4906,正文,16,2,14,凱基-林口,2023-08-10,9257
1101,台泥,16,3,13,凱基-林口,2023-08-10,9257
2458,義隆,13,0,13,凱基-林口,2023-08-10,9257
6550,北極星藥業-KY,12,0,12,凱基-林口,2023-08-10,9257
00888,永豐台灣ESG,12,0,12,凱基-林口,2023-08-10,9257
1519,華城,17,5,12,凱基-林口,2023-08-10,9257
3689,湧德,22,10,12,凱基-林口,2023-08-10,9257
5469,瀚宇博,12,0,12,凱基-林口,2023-08-10,9257
00927,群益半導體收益,11,0,11,凱基-林口,2023-08-10,9257
2383,台光電,16,5,11,凱基-林口,2023-08-10,9257
6223,旺矽,11,0,11,凱基-林口,2023-08-10,9257
1618,合機,11,0,11,凱基-林口,2023-08-10,9257
2888,新光金,506,3,503,凱基-林口,2023-08-11,9257
00878,國泰永續高股息,185,5,180,凱基-林口,2023-08-11,9257
2883,凱基金,132,0,132,凱基-林口,2023-08-11,9257
8403,盛弘,100,1,99,凱基-林口,2023-08-11,9257
8050,廣積,59,1,58,凱基-林口,2023-08-11,9257
00929,復華台灣科技優息,51,0,51,凱基-林口,2023-08-11,9257
6548,長科*,49,0,49,凱基-林口,2023-08-11,9257
00900,富邦特選高股息30,42,0,42,凱基-林口,2023-08-11,9257
2349,錸德,40,0,40,凱基-林口,2023-08-11,9257
2892,第一金,40,0,40,凱基-林口,2023-08-11,9257
00679B,元大美債20年,47,10,37,凱基-林口,2023-08-11,9257
3052,夆典,40,3,37,凱基-林口,2023-08-11,9257
00632R,元大台灣50反1,35,0,35,凱基-林口,2023-08-11,9257
00795B,中信美國公債20年,34,0,34,凱基-林口,2023-08-11,9257
2610,華航,152,120,32,凱基-林口,2023-08-11,9257
00923,群益台ESG低碳50,29,0,29,凱基-林口,2023-08-11,9257
3035,智原,48,21,27,凱基-林口,2023-08-11,9257
00931B,統一美債20年,23,0,23,凱基-林口,2023-08-11,9257
2356,英業達,30,8,22,凱基-林口,2023-08-11,9257
2618,長榮航,38,17,21,凱基-林口,2023-08-11,9257
3483,力致,21,1,20,凱基-林口,2023-08-11,9257
00637L,元大滬深300正2,24,5,19,凱基-林口,2023-08-11,9257
2634,漢翔,20,2,18,凱基-林口,2023-08-11,9257
2421,建準,18,0,18,凱基-林口,2023-08-11,9257
2637,慧洋-KY,18,2,16,凱基-林口,2023-08-11,9257
2882,國泰金,15,0,15,凱基-林口,2023-08-11,9257
3325,旭品,15,0,15,凱基-林口,2023-08-11,9257
00680L,元大美債20正2,14,0,14,凱基-林口,2023-08-11,9257
2913,農林,20,6,14,凱基-林口,2023-08-11,9257
8070,長華*,14,0,14,凱基-林口,2023-08-11,9257
00772B,中信高評級公司債,13,0,13,凱基-林口,2023-08-11,9257
1609,大亞,45,32,13,凱基-林口,2023-08-11,9257
2409,友達,13,0,13,凱基-林口,2023-08-11,9257
2603,長榮,22,11,11,凱基-林口,2023-08-11,9257
3481,群創,22,11,11,凱基-林口,2023-08-11,9257
2014,中鴻,11,0,11,凱基-林口,2023-08-11,9257
2342,茂矽,11,0,11,凱基-林口,2023-08-11,9257
5529,鉅陞,11,0,11,凱基-林口,2023-08-11,9257
2809,京城銀,10,0,10,凱基-林口,2023-08-11,9257
2504,國產,10,0,10,凱基-林口,2023-08-11,9257
00725B,國泰投資級公司債,10,0,10,凱基-林口,2023-08-11,9257
2516,新建,15,5,10,凱基-林口,2023-08-11,9257
2881,富邦金,10,0,10,凱基-林口,2023-08-11,9257
4550,長佳,10,0,10,凱基-林口,2023-08-11,9257
00893,國泰智能電動車,12,3,9,凱基-林口,2023-08-11,9257
2027,大成鋼,10,1,9,凱基-林口,2023-08-11,9257
2377,微星,8,0,8,凱基-林口,2023-08-11,9257
6770,力積電,14,6,8,凱基-林口,2023-08-11,9257
3450,聯鈞,8,0,8,凱基-林口,2023-08-11,9257
2330,台積電,8,0,8,凱基-林口,2023-08-11,9257
2618,長榮航,344,50,294,凱基-林口,2023-08-14,9257
00878,國泰永續高股息,203,9,194,凱基-林口,2023-08-14,9257
2888,新光金,176,3,173,凱基-林口,2023-08-14,9257
2402,毅嘉,158,10,148,凱基-林口,2023-08-14,9257
2883,凱基金,114,0,114,凱基-林口,2023-08-14,9257
00929,復華台灣科技優息,86,0,86,凱基-林口,2023-08-14,9257
00706L,期元大S＆P日圓正2,71,0,71,凱基-林口,2023-08-14,9257
00900,富邦特選高股息30,65,0,65,凱基-林口,2023-08-14,9257
00637L,元大滬深300正2,81,22,59,凱基-林口,2023-08-14,9257
3622,洋華,52,0,52,凱基-林口,2023-08-14,9257
2609,陽明,44,0,44,凱基-林口,2023-08-14,9257
2344,華邦電,42,3,39,凱基-林口,2023-08-14,9257
00888,永豐台灣ESG,36,0,36,凱基-林口,2023-08-14,9257
1101,台泥,38,4,34,凱基-林口,2023-08-14,9257
8070,長華*,33,0,33,凱基-林口,2023-08-14,9257
2457,飛宏,32,1,31,凱基-林口,2023-08-14,9257
2317,鴻海,34,4,30,凱基-林口,2023-08-14,9257
4707,磐亞,30,0,30,凱基-林口,2023-08-14,9257
1513,中興電,27,2,25,凱基-林口,2023-08-14,9257
2352,佳世達,25,1,24,凱基-林口,2023-08-14,9257
0056,元大高股息,54,31,23,凱基-林口,2023-08-14,9257
3481,群創,24,1,23,凱基-林口,2023-08-14,9257
00882,中信中國高股息,22,0,22,凱基-林口,2023-08-14,9257
3593,力銘,22,0,22,凱基-林口,2023-08-14,9257
2834,臺企銀,26,5,21,凱基-林口,2023-08-14,9257
00923,群益台ESG低碳50,21,0,21,凱基-林口,2023-08-14,9257
00756B,群益投等新興公債,29,9,20,凱基-林口,2023-08-14,9257
00753L,中信中國50正2,20,0,20,凱基-林口,2023-08-14,9257
00920,富邦ESG綠色電力,20,0,20,凱基-林口,2023-08-14,9257
2838,聯邦銀,20,0,20,凱基-林口,2023-08-14,9257
6005,群益證,20,0,20,凱基-林口,2023-08-14,9257
3231,緯創,54,35,19,凱基-林口,2023-08-14,9257
3715,定穎投控,16,0,16,凱基-林口,2023-08-14,9257
6198,瑞築,16,0,16,凱基-林口,2023-08-14,9257
1314,中石化,15,0,15,凱基-林口,2023-08-14,9257
0050,元大台灣50,16,3,13,凱基-林口,2023-08-14,9257
3043,科風,23,10,13,凱基-林口,2023-08-14,9257
2887,台新金,12,0,12,凱基-林口,2023-08-14,9257
2890,永豐金,18,6,12,凱基-林口,2023-08-14,9257
2634,漢翔,12,1,11,凱基-林口,2023-08-14,9257
2880,華南金,11,0,11,凱基-林口,2023-08-14,9257
00931B,統一美債20年,11,0,11,凱基-林口,2023-08-14,9257
2606,裕民,21,10,11,凱基-林口,2023-08-14,9257
4746,台耀,11,0,11,凱基-林口,2023-08-14,9257
6443,元晶,11,0,11,凱基-林口,2023-08-14,9257
00919,群益台灣精選高息,20,10,10,凱基-林口,2023-08-14,9257
2303,聯電,12,2,10,凱基-林口,2023-08-14,9257
1313,聯成,10,0,10,凱基-林口,2023-08-14,9257
1618,合機,10,0,10,凱基-林口,2023-08-14,9257
2020,美亞,10,0,10,凱基-林口,2023-08-14,9257
00929,復華台灣科技優息,321,8,313,凱基-林口,2023-08-15,9257
00878,國泰永續高股息,343,39,304,凱基-林口,2023-08-15,9257
00900,富邦特選高股息30,300,0,300,凱基-林口,2023-08-15,9257
00671R,富邦NASDAQ反1,75,0,75,凱基-林口,2023-08-15,9257
00680L,元大美債20正2,65,0,65,凱基-林口,2023-08-15,9257
6548,長科*,62,1,61,凱基-林口,2023-08-15,9257
00923,群益台ESG低碳50,60,0,60,凱基-林口,2023-08-15,9257
2317,鴻海,45,4,41,凱基-林口,2023-08-15,9257
6285,啟��,45,4,41,凱基-林口,2023-08-15,9257
00850,元大臺灣ESG永續,32,0,32,凱基-林口,2023-08-15,9257
6538,倉和,31,1,30,凱基-林口,2023-08-15,9257
1710,東聯,24,0,24,凱基-林口,2023-08-15,9257
00722B,群益投資級電信債,22,0,22,凱基-林口,2023-08-15,9257
2913,農林,81,62,19,凱基-林口,2023-08-15,9257
3593,力銘,16,0,16,凱基-林口,2023-08-15,9257
8048,德勝,16,0,16,凱基-林口,2023-08-15,9257
00756B,群益投等新興公債,15,0,15,凱基-林口,2023-08-15,9257
5464,霖宏,15,0,15,凱基-林口,2023-08-15,9257
2883,凱基金,14,0,14,凱基-林口,2023-08-15,9257
6274,台燿,15,2,13,凱基-林口,2023-08-15,9257
2891,中信金,12,0,12,凱基-林口,2023-08-15,9257
00907,永豐優息存股,11,0,11,凱基-林口,2023-08-15,9257
2886,兆豐金,11,0,11,凱基-林口,2023-08-15,9257
1314,中石化,11,0,11,凱基-林口,2023-08-15,9257
2884,玉山金,11,0,11,凱基-林口,2023-08-15,9257
6104,創惟,11,1,10,凱基-林口,2023-08-15,9257
1440,南紡,10,0,10,凱基-林口,2023-08-15,9257
2495,普安,10,0,10,凱基-林口,2023-08-15,9257
3033,威健,10,0,10,凱基-林口,2023-08-15,9257
6112,邁達特,10,0,10,凱基-林口,2023-08-15,9257
6226,光鼎,10,0,10,凱基-林口,2023-08-15,9257
9929,秋雨,55,45,10,凱基-林口,2023-08-15,9257
1802,台玻,10,1,9,凱基-林口,2023-08-15,9257
6223,旺矽,10,1,9,凱基-林口,2023-08-15,9257
3706,神達,11,3,8,凱基-林口,2023-08-15,9257
6139,亞翔,8,0,8,凱基-林口,2023-08-15,9257
2887,台新金,7,0,7,凱基-林口,2023-08-15,9257
3693,營邦,10,3,7,凱基-林口,2023-08-15,9257
6770,力積電,9,2,7,凱基-林口,2023-08-15,9257
3105,穩懋,7,1,6,凱基-林口,2023-08-15,9257
2890,永豐金,6,0,6,凱基-林口,2023-08-15,9257
00795B,中信美國公債20年,6,0,6,凱基-林口,2023-08-15,9257
00687B,國泰20年美債,6,0,6,凱基-林口,2023-08-15,9257
3043,科風,7,1,6,凱基-林口,2023-08-15,9257
6204,艾華,6,0,6,凱基-林口,2023-08-15,9257
8112,至上,8,2,6,凱基-林口,2023-08-15,9257
6691,洋基工程,5,0,5,凱基-林口,2023-08-15,9257
1101,台泥,5,0,5,凱基-林口,2023-08-15,9257
1312,國喬,5,0,5,凱基-林口,2023-08-15,9257
00931B,統一美債20年,5,0,5,凱基-林口,2023-08-15,9257
2888,新光金,1799,3,1796,凱基-林口,2023-08-16,9257
00878,國泰永續高股息,119,26,93,凱基-林口,2023-08-16,9257
2883,凱基金,93,14,79,凱基-林口,2023-08-16,9257
3481,群創,48,0,48,凱基-林口,2023-08-16,9257
2303,聯電,45,5,40,凱基-林口,2023-08-16,9257
2493,揚博,35,0,35,凱基-林口,2023-08-16,9257
2243,宏旭-KY,31,0,31,凱基-林口,2023-08-16,9257
00929,復華台灣科技優息,50,21,29,凱基-林口,2023-08-16,9257
00772B,中信高評級公司債,28,0,28,凱基-林口,2023-08-16,9257
00712,復華富時不動產,32,5,27,凱基-林口,2023-08-16,9257
1101,台泥,25,1,24,凱基-林口,2023-08-16,9257
2897,王道銀行,23,0,23,凱基-林口,2023-08-16,9257
00900,富邦特選高股息30,22,0,22,凱基-林口,2023-08-16,9257
8426,紅木-KY,20,0,20,凱基-林口,2023-08-16,9257
2884,玉山金,20,0,20,凱基-林口,2023-08-16,9257
2317,鴻海,19,1,18,凱基-林口,2023-08-16,9257
5880,合庫金,16,0,16,凱基-林口,2023-08-16,9257
6158,禾昌,16,0,16,凱基-林口,2023-08-16,9257
2610,華航,32,17,15,凱基-林口,2023-08-16,9257
5284,jpp-KY,15,0,15,凱基-林口,2023-08-16,9257
2312,金寶,15,1,14,凱基-林口,2023-08-16,9257
2002,中鋼,14,1,13,凱基-林口,2023-08-16,9257
3035,智原,41,29,12,凱基-林口,2023-08-16,9257
2889,國票金,12,0,12,凱基-林口,2023-08-16,9257
2603,長榮,12,0,12,凱基-林口,2023-08-16,9257
3483,力致,77,66,11,凱基-林口,2023-08-16,9257
2892,第一金,11,0,11,凱基-林口,2023-08-16,9257
3583,辛耘,14,4,10,凱基-林口,2023-08-16,9257
1301,台塑,11,1,10,凱基-林口,2023-08-16,9257
4167,松瑞藥,10,0,10,凱基-林口,2023-08-16,9257
2880,華南金,9,0,9,凱基-林口,2023-08-16,9257
2329,華泰,32,23,9,凱基-林口,2023-08-16,9257
2332,友訊,18,9,9,凱基-林口,2023-08-16,9257
8299,群聯,9,0,9,凱基-林口,2023-08-16,9257
00923,群益台ESG低碳50,13,4,9,凱基-林口,2023-08-16,9257
2330,台積電,9,1,8,凱基-林口,2023-08-16,9257
6188,廣明,13,5,8,凱基-林口,2023-08-16,9257
2891,中信金,18,10,8,凱基-林口,2023-08-16,9257
3711,日月光投控,10,2,8,凱基-林口,2023-08-16,9257
2206,三陽工業,9,1,8,凱基-林口,2023-08-16,9257
1303,南亞,7,0,7,凱基-林口,2023-08-16,9257
2834,臺企銀,18,11,7,凱基-林口,2023-08-16,9257
6438,迅得,9,2,7,凱基-林口,2023-08-16,9257
9919,康那香,7,0,7,凱基-林口,2023-08-16,9257
00850,元大臺灣ESG永續,6,0,6,凱基-林口,2023-08-16,9257
1614,三洋電,6,0,6,凱基-林口,2023-08-16,9257
1802,台玻,7,1,6,凱基-林口,2023-08-16,9257
2338,光罩,6,0,6,凱基-林口,2023-08-16,9257
3704,合勤控,6,0,6,凱基-林口,2023-08-16,9257
6531,愛普*,18,12,6,凱基-林口,2023-08-16,9257
2888,新光金,731,6,725,凱基-林口,2023-08-17,9257
3338,泰碩,161,0,161,凱基-林口,2023-08-17,9257
00688L,國泰20年美債正2,111,0,111,凱基-林口,2023-08-17,9257
2883,凱基金,103,2,101,凱基-林口,2023-08-17,9257
00671R,富邦NASDAQ反1,110,31,79,凱基-林口,2023-08-17,9257
2520,冠德,62,0,62,凱基-林口,2023-08-17,9257
1303,南亞,60,0,60,凱基-林口,2023-08-17,9257
3689,湧德,54,8,46,凱基-林口,2023-08-17,9257
00929,復華台灣科技優息,61,17,44,凱基-林口,2023-08-17,9257
2324,仁寶,69,28,41,凱基-林口,2023-08-17,9257
2401,凌陽,41,1,40,凱基-林口,2023-08-17,9257
00679B,元大美債20年,36,0,36,凱基-林口,2023-08-17,9257
2388,威盛,35,3,32,凱基-林口,2023-08-17,9257
3231,緯創,168,141,27,凱基-林口,2023-08-17,9257
8358,金居,70,43,27,凱基-林口,2023-08-17,9257
00900,富邦特選高股息30,23,2,21,凱基-林口,2023-08-17,9257
00715L,期街口布蘭特正2,20,0,20,凱基-林口,2023-08-17,9257
5388,中磊,20,0,20,凱基-林口,2023-08-17,9257
00772B,中信高評級公司債,17,0,17,凱基-林口,2023-08-17,9257
1301,台塑,16,0,16,凱基-林口,2023-08-17,9257
6235,華孚,26,11,15,凱基-林口,2023-08-17,9257
1240,茂生農經,14,0,14,凱基-林口,2023-08-17,9257
3036,文曄,15,1,14,凱基-林口,2023-08-17,9257
2329,華泰,37,24,13,凱基-林口,2023-08-17,9257
2880,華南金,13,0,13,凱基-林口,2023-08-17,9257
3532,台勝科,12,0,12,凱基-林口,2023-08-17,9257
00907,永豐優息存股,11,0,11,凱基-林口,2023-08-17,9257
2618,長榮航,13,2,11,凱基-林口,2023-08-17,9257
00712,復華富時不動產,23,13,10,凱基-林口,2023-08-17,9257
2301,光寶科,15,5,10,凱基-林口,2023-08-17,9257
00921,兆豐龍頭等權重,10,0,10,凱基-林口,2023-08-17,9257
00888,永豐台灣ESG,10,0,10,凱基-林口,2023-08-17,9257
00753L,中信中國50正2,10,0,10,凱基-林口,2023-08-17,9257
00687B,國泰20年美債,14,4,10,凱基-林口,2023-08-17,9257
1714,和桐,10,0,10,凱基-林口,2023-08-17,9257
1795,美時,10,0,10,凱基-林口,2023-08-17,9257
2460,建通,10,0,10,凱基-林口,2023-08-17,9257
6203,海韻電,10,0,10,凱基-林口,2023-08-17,9257
006208,富邦台50,9,0,9,凱基-林口,2023-08-17,9257
2303,聯電,13,4,9,凱基-林口,2023-08-17,9257
2634,漢翔,10,1,9,凱基-林口,2023-08-17,9257
2383,台光電,16,7,9,凱基-林口,2023-08-17,9257
2834,臺企銀,9,0,9,凱基-林口,2023-08-17,9257
6411,晶焱,9,0,9,凱基-林口,2023-08-17,9257
00751B,元大AAA至A公司債,8,0,8,凱基-林口,2023-08-17,9257
2890,永豐金,8,0,8,凱基-林口,2023-08-17,9257
00637L,元大滬深300正2,10,2,8,凱基-林口,2023-08-17,9257
1802,台玻,8,0,8,凱基-林口,2023-08-17,9257
2002,中鋼,11,3,8,凱基-林口,2023-08-17,9257
2897,王道銀行,8,0,8,凱基-林口,2023-08-17,9257
2402,毅嘉,257,110,147,凱基-林口,2023-08-18,9257
00671R,富邦NASDAQ反1,85,0,85,凱基-林口,2023-08-18,9257
00929,復華台灣科技優息,99,20,79,凱基-林口,2023-08-18,9257
6274,台燿,59,0,59,凱基-林口,2023-08-18,9257
3231,緯創,122,75,47,凱基-林口,2023-08-18,9257
2883,凱基金,44,0,44,凱基-林口,2023-08-18,9257
2329,華泰,94,52,42,凱基-林口,2023-08-18,9257
2382,廣達,74,37,37,凱基-林口,2023-08-18,9257
00900,富邦特選高股息30,33,0,33,凱基-林口,2023-08-18,9257
6285,啟��,44,11,33,凱基-林口,2023-08-18,9257
00919,群益台灣精選高息,31,0,31,凱基-林口,2023-08-18,9257
2890,永豐金,28,0,28,凱基-林口,2023-08-18,9257
2324,仁寶,65,37,28,凱基-林口,2023-08-18,9257
2356,英業達,21,1,20,凱基-林口,2023-08-18,9257
00921,兆豐龍頭等權重,20,0,20,凱基-林口,2023-08-18,9257
2603,長榮,61,41,20,凱基-林口,2023-08-18,9257
5388,中磊,20,0,20,凱基-林口,2023-08-18,9257
2363,矽統,93,75,18,凱基-林口,2023-08-18,9257
3044,健鼎,32,14,18,凱基-林口,2023-08-18,9257
2301,光寶科,35,18,17,凱基-林口,2023-08-18,9257
1605,華新,21,4,17,凱基-林口,2023-08-18,9257
3056,富華新,16,0,16,凱基-林口,2023-08-18,9257
3689,湧德,31,15,16,凱基-林口,2023-08-18,9257
6282,康舒,40,24,16,凱基-林口,2023-08-18,9257
00930,永豐ESG低碳高息,15,0,15,凱基-林口,2023-08-18,9257
2460,建通,15,0,15,凱基-林口,2023-08-18,9257
3035,智原,32,18,14,凱基-林口,2023-08-18,9257
2376,技嘉,20,6,14,凱基-林口,2023-08-18,9257
2383,台光電,24,11,13,凱基-林口,2023-08-18,9257
2449,京元電子,15,2,13,凱基-林口,2023-08-18,9257
1609,大亞,16,3,13,凱基-林口,2023-08-18,9257
2308,台達電,14,2,12,凱基-林口,2023-08-18,9257
2002,中鋼,12,0,12,凱基-林口,2023-08-18,9257
2618,長榮航,12,0,12,凱基-林口,2023-08-18,9257
2812,台中銀,11,0,11,凱基-林口,2023-08-18,9257
5439,高技,12,1,11,凱基-林口,2023-08-18,9257
1319,東陽,14,3,11,凱基-林口,2023-08-18,9257
1504,東元,30,19,11,凱基-林口,2023-08-18,9257
2421,建準,18,7,11,凱基-林口,2023-08-18,9257
2886,兆豐金,11,0,11,凱基-林口,2023-08-18,9257
00680L,元大美債20正2,10,0,10,凱基-林口,2023-08-18,9257
2609,陽明,38,28,10,凱基-林口,2023-08-18,9257
2897,王道銀行,10,0,10,凱基-林口,2023-08-18,9257
3033,威健,10,0,10,凱基-林口,2023-08-18,9257
5880,合庫金,10,0,10,凱基-林口,2023-08-18,9257
00878,國泰永續高股息,48,39,9,凱基-林口,2023-08-18,9257
2206,三陽工業,10,1,9,凱基-林口,2023-08-18,9257
2323,中環,9,0,9,凱基-林口,2023-08-18,9257
2425,承啟,10,1,9,凱基-林口,2023-08-18,9257
2880,華南金,10,1,9,凱基-林口,2023-08-18,9257
00632R,元大台灣50反1,295,0,295,凱基-林口,2023-08-21,9257
2382,廣達,122,24,98,凱基-林口,2023-08-21,9257
1303,南亞,70,0,70,凱基-林口,2023-08-21,9257
2359,所羅門,53,0,53,凱基-林口,2023-08-21,9257
2888,新光金,52,0,52,凱基-林口,2023-08-21,9257
00929,復華台灣科技優息,45,1,44,凱基-林口,2023-08-21,9257
5608,四維航,47,7,40,凱基-林口,2023-08-21,9257
00673R,期元大S＆P原油反1,38,0,38,凱基-林口,2023-08-21,9257
2610,華航,38,1,37,凱基-林口,2023-08-21,9257
2605,新興,46,10,36,凱基-林口,2023-08-21,9257
2301,光寶科,37,10,27,凱基-林口,2023-08-21,9257
3035,智原,34,10,24,凱基-林口,2023-08-21,9257
00637L,元大滬深300正2,20,0,20,凱基-林口,2023-08-21,9257
5284,jpp-KY,20,0,20,凱基-林口,2023-08-21,9257
2363,矽統,89,69,20,凱基-林口,2023-08-21,9257
2609,陽明,19,0,19,凱基-林口,2023-08-21,9257
2637,慧洋-KY,23,5,18,凱基-林口,2023-08-21,9257
2606,裕民,23,10,13,凱基-林口,2023-08-21,9257
2329,華泰,44,32,12,凱基-林口,2023-08-21,9257
2886,兆豐金,11,0,11,凱基-林口,2023-08-21,9257
00882,中信中國高股息,13,2,11,凱基-林口,2023-08-21,9257
2883,凱基金,40,30,10,凱基-林口,2023-08-21,9257
1210,大成,10,0,10,凱基-林口,2023-08-21,9257
1815,富喬,11,1,10,凱基-林口,2023-08-21,9257
2009,第一銅,10,0,10,凱基-林口,2023-08-21,9257
2316,楠梓電,10,0,10,凱基-林口,2023-08-21,9257
3078,僑威,12,2,10,凱基-林口,2023-08-21,9257
3338,泰碩,15,5,10,凱基-林口,2023-08-21,9257
3706,神達,34,24,10,凱基-林口,2023-08-21,9257
9929,秋雨,60,50,10,凱基-林口,2023-08-21,9257
00679B,元大美債20年,9,0,9,凱基-林口,2023-08-21,9257
1101,台泥,9,0,9,凱基-林口,2023-08-21,9257
3558,神準,8,0,8,凱基-林口,2023-08-21,9257
3231,緯創,14,7,7,凱基-林口,2023-08-21,9257
2618,長榮航,13,6,7,凱基-林口,2023-08-21,9257
4906,正文,15,8,7,凱基-林口,2023-08-21,9257
00923,群益台ESG低碳50,6,0,6,凱基-林口,2023-08-21,9257
00720B,元大投資級公司債,8,2,6,凱基-林口,2023-08-21,9257
00687B,國泰20年美債,6,0,6,凱基-林口,2023-08-21,9257
2338,光罩,6,0,6,凱基-林口,2023-08-21,9257
2603,長榮,12,6,6,凱基-林口,2023-08-21,9257
0050,元大台灣50,6,0,6,凱基-林口,2023-08-21,9257
2409,友達,15,10,5,凱基-林口,2023-08-21,9257
00907,永豐優息存股,5,0,5,凱基-林口,2023-08-21,9257
00892,富邦台灣半導體,5,0,5,凱基-林口,2023-08-21,9257
1802,台玻,5,0,5,凱基-林口,2023-08-21,9257
2460,建通,5,0,5,凱基-林口,2023-08-21,9257
2495,普安,5,0,5,凱基-林口,2023-08-21,9257
3680,家登,6,1,5,凱基-林口,2023-08-21,9257
5471,松翰,5,0,5,凱基-林口,2023-08-21,9257
00706L,期元大S＆P日圓正2,100,0,100,凱基-林口,2023-08-22,9257
00878,國泰永續高股息,118,27,91,凱基-林口,2023-08-22,9257
00637L,元大滬深300正2,71,0,71,凱基-林口,2023-08-22,9257
2606,裕民,70,10,60,凱基-林口,2023-08-22,9257
00680L,元大美債20正2,53,0,53,凱基-林口,2023-08-22,9257
5388,中磊,51,0,51,凱基-林口,2023-08-22,9257
2355,敬鵬,55,7,48,凱基-林口,2023-08-22,9257
2353,宏��,43,0,43,凱基-林口,2023-08-22,9257
2883,凱基金,36,0,36,凱基-林口,2023-08-22,9257
5488,松普,35,0,35,凱基-林口,2023-08-22,9257
00929,復華台灣科技優息,34,0,34,凱基-林口,2023-08-22,9257
6170,統振,32,0,32,凱基-林口,2023-08-22,9257
3231,緯創,55,24,31,凱基-林口,2023-08-22,9257
2888,新光金,31,0,31,凱基-林口,2023-08-22,9257
00900,富邦特選高股息30,30,0,30,凱基-林口,2023-08-22,9257
6285,啟��,32,3,29,凱基-林口,2023-08-22,9257
2332,友訊,44,20,24,凱基-林口,2023-08-22,9257
3338,泰碩,24,0,24,凱基-林口,2023-08-22,9257
00679B,元大美債20年,38,15,23,凱基-林口,2023-08-22,9257
3035,智原,40,19,21,凱基-林口,2023-08-22,9257
1444,力麗,20,0,20,凱基-林口,2023-08-22,9257
1101,台泥,22,4,18,凱基-林口,2023-08-22,9257
2515,中工,30,12,18,凱基-林口,2023-08-22,9257
3305,昇貿,17,0,17,凱基-林口,2023-08-22,9257
3617,碩天,18,2,16,凱基-林口,2023-08-22,9257
2421,建準,23,8,15,凱基-林口,2023-08-22,9257
2324,仁寶,47,32,15,凱基-林口,2023-08-22,9257
6234,高僑,15,0,15,凱基-林口,2023-08-22,9257
6125,廣運,33,19,14,凱基-林口,2023-08-22,9257
2834,臺企銀,15,2,13,凱基-林口,2023-08-22,9257
6282,康舒,15,2,13,凱基-林口,2023-08-22,9257
3325,旭品,17,6,11,凱基-林口,2023-08-22,9257
3704,合勤控,12,1,11,凱基-林口,2023-08-22,9257
6005,群益證,11,0,11,凱基-林口,2023-08-22,9257
6612,奈米醫材,38,27,11,凱基-林口,2023-08-22,9257
2352,佳世達,10,0,10,凱基-林口,2023-08-22,9257
2369,菱生,10,0,10,凱基-林口,2023-08-22,9257
2913,農林,11,1,10,凱基-林口,2023-08-22,9257
3625,西勝,10,0,10,凱基-林口,2023-08-22,9257
4532,瑞智,10,0,10,凱基-林口,2023-08-22,9257
4906,正文,11,1,10,凱基-林口,2023-08-22,9257
6226,光鼎,10,0,10,凱基-林口,2023-08-22,9257
6283,淳安,10,0,10,凱基-林口,2023-08-22,9257
2886,兆豐金,10,0,10,凱基-林口,2023-08-22,9257
2002,中鋼,9,0,9,凱基-林口,2023-08-22,9257
2891,中信金,9,0,9,凱基-林口,2023-08-22,9257
1718,中纖,10,1,9,凱基-林口,2023-08-22,9257
2329,華泰,41,32,9,凱基-林口,2023-08-22,9257
3483,力致,20,11,9,凱基-林口,2023-08-22,9257
1301,台塑,8,0,8,凱基-林口,2023-08-22,9257
00885,富邦越南,151,5,146,凱基-林口,2023-08-23,9257
00878,國泰永續高股息,107,8,99,凱基-林口,2023-08-23,9257
2888,新光金,90,0,90,凱基-林口,2023-08-23,9257
2355,敬鵬,71,1,70,凱基-林口,2023-08-23,9257
3051,力特,48,6,42,凱基-林口,2023-08-23,9257
2883,凱基金,43,6,37,凱基-林口,2023-08-23,9257
2618,長榮航,53,17,36,凱基-林口,2023-08-23,9257
2913,農林,26,0,26,凱基-林口,2023-08-23,9257
3035,智原,44,22,22,凱基-林口,2023-08-23,9257
2609,陽明,29,8,21,凱基-林口,2023-08-23,9257
8222,寶一,20,0,20,凱基-林口,2023-08-23,9257
1560,中砂,20,1,19,凱基-林口,2023-08-23,9257
2610,華航,21,4,17,凱基-林口,2023-08-23,9257
5483,中美晶,17,0,17,凱基-林口,2023-08-23,9257
00632R,元大台灣50反1,16,0,16,凱基-林口,2023-08-23,9257
6261,久元,15,0,15,凱基-林口,2023-08-23,9257
3689,湧德,24,10,14,凱基-林口,2023-08-23,9257
3680,家登,23,9,14,凱基-林口,2023-08-23,9257
2329,華泰,34,21,13,凱基-林口,2023-08-23,9257
1434,福懋,11,0,11,凱基-林口,2023-08-23,9257
1316,上曜,10,0,10,凱基-林口,2023-08-23,9257
00753L,中信中國50正2,10,0,10,凱基-林口,2023-08-23,9257
1305,華夏,10,0,10,凱基-林口,2023-08-23,9257
1909,榮成,10,0,10,凱基-林口,2023-08-23,9257
2324,仁寶,21,11,10,凱基-林口,2023-08-23,9257
3163,波若威,19,9,10,凱基-林口,2023-08-23,9257
6120,達運,10,0,10,凱基-林口,2023-08-23,9257
6198,瑞築,10,0,10,凱基-林口,2023-08-23,9257
2382,廣達,77,67,10,凱基-林口,2023-08-23,9257
1101,台泥,9,0,9,凱基-林口,2023-08-23,9257
00772B,中信高評級公司債,10,1,9,凱基-林口,2023-08-23,9257
2486,一詮,37,28,9,凱基-林口,2023-08-23,9257
2520,冠德,9,0,9,凱基-林口,2023-08-23,9257
6235,華孚,36,28,8,凱基-林口,2023-08-23,9257
2645,長榮航太,7,0,7,凱基-林口,2023-08-23,9257
8103,瀚荃,7,0,7,凱基-林口,2023-08-23,9257
6691,洋基工程,6,0,6,凱基-林口,2023-08-23,9257
2303,聯電,6,0,6,凱基-林口,2023-08-23,9257
00706L,期元大S＆P日圓正2,6,0,6,凱基-林口,2023-08-23,9257
1240,茂生農經,6,0,6,凱基-林口,2023-08-23,9257
2615,萬海,7,1,6,凱基-林口,2023-08-23,9257
3094,聯傑,7,1,6,凱基-林口,2023-08-23,9257
3483,力致,7,1,6,凱基-林口,2023-08-23,9257
1442,名軒,5,0,5,凱基-林口,2023-08-23,9257
00882,中信中國高股息,5,0,5,凱基-林口,2023-08-23,9257
1471,首利,11,6,5,凱基-林口,2023-08-23,9257
1506,正道,5,0,5,凱基-林口,2023-08-23,9257
1522,堤維西,5,0,5,凱基-林口,2023-08-23,9257
2438,翔耀,5,0,5,凱基-林口,2023-08-23,9257
4533,協易機,5,0,5,凱基-林口,2023-08-23,9257
00878,國泰永續高股息,118,39,79,凱基-林口,2023-08-24,9257
3715,定穎投控,83,23,60,凱基-林口,2023-08-24,9257
3035,智原,93,40,53,凱基-林口,2023-08-24,9257
00919,群益台灣精選高息,49,0,49,凱基-林口,2023-08-24,9257
00633L,富邦上証正2,45,3,42,凱基-林口,2023-08-24,9257
4167,松瑞藥,44,2,42,凱基-林口,2023-08-24,9257
2363,矽統,185,145,40,凱基-林口,2023-08-24,9257
00712,復華富時不動產,40,2,38,凱基-林口,2023-08-24,9257
2838,聯邦銀,35,0,35,凱基-林口,2023-08-24,9257
2883,凱基金,40,10,30,凱基-林口,2023-08-24,9257
4707,磐亞,30,0,30,凱基-林口,2023-08-24,9257
2002,中鋼,28,1,27,凱基-林口,2023-08-24,9257
00706L,期元大S＆P日圓正2,25,0,25,凱基-林口,2023-08-24,9257
2355,敬鵬,53,29,24,凱基-林口,2023-08-24,9257
3583,辛耘,23,1,22,凱基-林口,2023-08-24,9257
2356,英業達,61,39,22,凱基-林口,2023-08-24,9257
2880,華南金,26,5,21,凱基-林口,2023-08-24,9257
00650L,復華香港正2,20,0,20,凱基-林口,2023-08-24,9257
6168,宏齊,21,1,20,凱基-林口,2023-08-24,9257
6274,台燿,21,1,20,凱基-林口,2023-08-24,9257
2449,京元電子,27,8,19,凱基-林口,2023-08-24,9257
2360,致茂,30,12,18,凱基-林口,2023-08-24,9257
3483,力致,19,2,17,凱基-林口,2023-08-24,9257
2329,華泰,41,25,16,凱基-林口,2023-08-24,9257
00929,復華台灣科技優息,27,12,15,凱基-林口,2023-08-24,9257
2444,兆勁,15,0,15,凱基-林口,2023-08-24,9257
6282,康舒,18,3,15,凱基-林口,2023-08-24,9257
1905,華紙,15,1,14,凱基-林口,2023-08-24,9257
3693,營邦,14,0,14,凱基-林口,2023-08-24,9257
1802,台玻,14,1,13,凱基-林口,2023-08-24,9257
2402,毅嘉,24,11,13,凱基-林口,2023-08-24,9257
6234,高僑,14,1,13,凱基-林口,2023-08-24,9257
6768,志強-KY,13,0,13,凱基-林口,2023-08-24,9257
6285,啟��,21,8,13,凱基-林口,2023-08-24,9257
5348,正能量智能,11,0,11,凱基-林口,2023-08-24,9257
6185,幃翔,11,0,11,凱基-林口,2023-08-24,9257
2618,長榮航,14,4,10,凱基-林口,2023-08-24,9257
1402,遠東新,10,0,10,凱基-林口,2023-08-24,9257
3062,建漢,10,0,10,凱基-林口,2023-08-24,9257
3694,海華,10,0,10,凱基-林口,2023-08-24,9257
4550,長佳,10,0,10,凱基-林口,2023-08-24,9257
6116,彩晶,10,0,10,凱基-林口,2023-08-24,9257
3231,緯創,112,102,10,凱基-林口,2023-08-24,9257
3264,欣銓,10,1,9,凱基-林口,2023-08-24,9257
1301,台塑,9,0,9,凱基-林口,2023-08-24,9257
3305,昇貿,10,2,8,凱基-林口,2023-08-24,9257
00893,國泰智能電動車,12,4,8,凱基-林口,2023-08-24,9257
00679B,元大美債20年,17,10,7,凱基-林口,2023-08-24,9257
6125,廣運,12,5,7,凱基-林口,2023-08-24,9257
5880,合庫金,6,0,6,凱基-林口,2023-08-24,9257
2355,敬鵬,183,1,182,凱基-林口,2023-08-25,9257
00878,國泰永續高股息,164,5,159,凱基-林口,2023-08-25,9257
3231,緯創,148,48,100,凱基-林口,2023-08-25,9257
2485,兆赫,101,1,100,凱基-林口,2023-08-25,9257
2363,矽統,219,133,86,凱基-林口,2023-08-25,9257
2610,華航,79,19,60,凱基-林口,2023-08-25,9257
00919,群益台灣精選高息,43,0,43,凱基-林口,2023-08-25,9257
2332,友訊,49,9,40,凱基-林口,2023-08-25,9257
2382,廣達,65,26,39,凱基-林口,2023-08-25,9257
00706L,期元大S＆P日圓正2,38,0,38,凱基-林口,2023-08-25,9257
6284,佳邦,34,2,32,凱基-林口,2023-08-25,9257
3037,欣興,35,5,30,凱基-林口,2023-08-25,9257
2883,凱基金,26,1,25,凱基-林口,2023-08-25,9257
00929,復華台灣科技優息,25,0,25,凱基-林口,2023-08-25,9257
0056,元大高股息,164,140,24,凱基-林口,2023-08-25,9257
1504,東元,20,0,20,凱基-林口,2023-08-25,9257
2360,致茂,35,18,17,凱基-林口,2023-08-25,9257
5381,合正,18,2,16,凱基-林口,2023-08-25,9257
2303,聯電,15,0,15,凱基-林口,2023-08-25,9257
1805,寶徠,15,0,15,凱基-林口,2023-08-25,9257
3706,神達,36,21,15,凱基-林口,2023-08-25,9257
4906,正文,39,24,15,凱基-林口,2023-08-25,9257
3617,碩天,13,0,13,凱基-林口,2023-08-25,9257
2331,精英,53,40,13,凱基-林口,2023-08-25,9257
2353,宏��,17,4,13,凱基-林口,2023-08-25,9257
2330,台積電,13,1,12,凱基-林口,2023-08-25,9257
2634,漢翔,39,27,12,凱基-林口,2023-08-25,9257
3017,奇鋐,15,3,12,凱基-林口,2023-08-25,9257
00881,國泰台灣5G+,17,6,11,凱基-林口,2023-08-25,9257
2913,農林,12,1,11,凱基-林口,2023-08-25,9257
4979,華星光,11,0,11,凱基-林口,2023-08-25,9257
00679B,元大美債20年,10,0,10,凱基-林口,2023-08-25,9257
1217,愛之味,10,0,10,凱基-林口,2023-08-25,9257
00637L,元大滬深300正2,10,0,10,凱基-林口,2023-08-25,9257
00680L,元大美債20正2,10,0,10,凱基-林口,2023-08-25,9257
2359,所羅門,10,0,10,凱基-林口,2023-08-25,9257
2605,新興,10,0,10,凱基-林口,2023-08-25,9257
2888,新光金,10,0,10,凱基-林口,2023-08-25,9257
4550,長佳,10,0,10,凱基-林口,2023-08-25,9257
4916,事欣科,13,3,10,凱基-林口,2023-08-25,9257
5608,四維航,10,0,10,凱基-林口,2023-08-25,9257
6226,光鼎,10,0,10,凱基-林口,2023-08-25,9257
9945,潤泰新,10,0,10,凱基-林口,2023-08-25,9257
2388,威盛,15,6,9,凱基-林口,2023-08-25,9257
2618,長榮航,45,37,8,凱基-林口,2023-08-25,9257
2486,一詮,10,2,8,凱基-林口,2023-08-25,9257
3042,晶技,8,0,8,凱基-林口,2023-08-25,9257
3056,富華新,8,0,8,凱基-林口,2023-08-25,9257
3689,湧德,10,2,8,凱基-林口,2023-08-25,9257
00900,富邦特選高股息30,7,0,7,凱基-林口,2023-08-25,9257
00671R,富邦NASDAQ反1,200,0,200,凱基-林口,2023-08-28,9257
00632R,元大台灣50反1,109,0,109,凱基-林口,2023-08-28,9257
2355,敬鵬,91,18,73,凱基-林口,2023-08-28,9257
3035,智原,91,26,65,凱基-林口,2023-08-28,9257
8227,巨有科技,58,0,58,凱基-林口,2023-08-28,9257
4541,晟田,53,0,53,凱基-林口,2023-08-28,9257
00688L,國泰20年美債正2,50,0,50,凱基-林口,2023-08-28,9257
2610,華航,61,15,46,凱基-林口,2023-08-28,9257
2303,聯電,72,28,44,凱基-林口,2023-08-28,9257
2618,長榮航,48,8,40,凱基-林口,2023-08-28,9257
6285,啟��,41,2,39,凱基-林口,2023-08-28,9257
00919,群益台灣精選高息,37,0,37,凱基-林口,2023-08-28,9257
00878,國泰永續高股息,45,12,33,凱基-林口,2023-08-28,9257
00706L,期元大S＆P日圓正2,33,0,33,凱基-林口,2023-08-28,9257
2402,毅嘉,37,6,31,凱基-林口,2023-08-28,9257
9929,秋雨,80,50,30,凱基-林口,2023-08-28,9257
5388,中磊,30,1,29,凱基-林口,2023-08-28,9257
4944,兆遠,27,0,27,凱基-林口,2023-08-28,9257
2323,中環,24,3,21,凱基-林口,2023-08-28,9257
00929,復華台灣科技優息,40,20,20,凱基-林口,2023-08-28,9257
00720B,元大投資級公司債,20,0,20,凱基-林口,2023-08-28,9257
3055,蔚華科,20,0,20,凱基-林口,2023-08-28,9257
4532,瑞智,20,0,20,凱基-林口,2023-08-28,9257
8070,長華*,20,0,20,凱基-林口,2023-08-28,9257
3017,奇鋐,22,2,20,凱基-林口,2023-08-28,9257
2614,東森,19,1,18,凱基-林口,2023-08-28,9257
4105,東洋,17,0,17,凱基-林口,2023-08-28,9257
6244,茂迪,15,0,15,凱基-林口,2023-08-28,9257
2913,農林,14,0,14,凱基-林口,2023-08-28,9257
3078,僑威,14,0,14,凱基-林口,2023-08-28,9257
3231,緯創,44,30,14,凱基-林口,2023-08-28,9257
0056,元大高股息,13,0,13,凱基-林口,2023-08-28,9257
2801,彰銀,36,23,13,凱基-林口,2023-08-28,9257
2301,光寶科,13,2,11,凱基-林口,2023-08-28,9257
00719B,元大美債1-3,10,0,10,凱基-林口,2023-08-28,9257
00715L,期街口布蘭特正2,10,0,10,凱基-林口,2023-08-28,9257
2460,建通,10,0,10,凱基-林口,2023-08-28,9257
2534,宏盛,10,0,10,凱基-林口,2023-08-28,9257
2743,山富,10,0,10,凱基-林口,2023-08-28,9257
6016,康和證,10,0,10,凱基-林口,2023-08-28,9257
6226,光鼎,10,0,10,凱基-林口,2023-08-28,9257
1737,臺鹽,12,2,10,凱基-林口,2023-08-28,9257
2890,永豐金,10,0,10,凱基-林口,2023-08-28,9257
3037,欣興,14,5,9,凱基-林口,2023-08-28,9257
3044,健鼎,36,27,9,凱基-林口,2023-08-28,9257
1413,宏洲,8,0,8,凱基-林口,2023-08-28,9257
1584,精剛,10,2,8,凱基-林口,2023-08-28,9257
2449,京元電子,21,13,8,凱基-林口,2023-08-28,9257
5301,寶得利,8,0,8,凱基-林口,2023-08-28,9257
5864,致和證,8,0,8,凱基-林口,2023-08-28,9257
00671R,富邦NASDAQ反1,200,0,200,凱基-林口,2023-08-29,9257
00632R,元大台灣50反1,89,0,89,凱基-林口,2023-08-29,9257
2303,聯電,67,2,65,凱基-林口,2023-08-29,9257
2363,矽統,144,97,47,凱基-林口,2023-08-29,9257
2355,敬鵬,51,10,41,凱基-林口,2023-08-29,9257
2312,金寶,33,0,33,凱基-林口,2023-08-29,9257
2880,華南金,31,0,31,凱基-林口,2023-08-29,9257
3706,神達,47,16,31,凱基-林口,2023-08-29,9257
00650L,復華香港正2,30,0,30,凱基-林口,2023-08-29,9257
2534,宏盛,30,0,30,凱基-林口,2023-08-29,9257
2883,凱基金,26,1,25,凱基-林口,2023-08-29,9257
2634,漢翔,61,40,21,凱基-林口,2023-08-29,9257
00857B,永豐20年美公債,20,0,20,凱基-林口,2023-08-29,9257
6414,樺漢,20,0,20,凱基-林口,2023-08-29,9257
2317,鴻海,20,1,19,凱基-林口,2023-08-29,9257
4944,兆遠,18,0,18,凱基-林口,2023-08-29,9257
6167,久正,18,0,18,凱基-林口,2023-08-29,9257
2374,佳能,17,0,17,凱基-林口,2023-08-29,9257
3058,立德,13,0,13,凱基-林口,2023-08-29,9257
2421,建準,14,2,12,凱基-林口,2023-08-29,9257
00923,群益台ESG低碳50,11,0,11,凱基-林口,2023-08-29,9257
1240,茂生農經,10,0,10,凱基-林口,2023-08-29,9257
00891,中信關鍵半導體,10,0,10,凱基-林口,2023-08-29,9257
00921,兆豐龍頭等權重,10,0,10,凱基-林口,2023-08-29,9257
1413,宏洲,10,0,10,凱基-林口,2023-08-29,9257
2419,仲琦,10,0,10,凱基-林口,2023-08-29,9257
2834,臺企銀,10,0,10,凱基-林口,2023-08-29,9257
3052,夆典,10,0,10,凱基-林口,2023-08-29,9257
6015,宏遠證,10,0,10,凱基-林口,2023-08-29,9257
6226,光鼎,10,0,10,凱基-林口,2023-08-29,9257
2484,希華,10,1,9,凱基-林口,2023-08-29,9257
5381,合正,18,9,9,凱基-林口,2023-08-29,9257
2356,英業達,13,5,8,凱基-林口,2023-08-29,9257
2913,農林,9,1,8,凱基-林口,2023-08-29,9257
6235,華孚,33,25,8,凱基-林口,2023-08-29,9257
3011,今皓,10,2,8,凱基-林口,2023-08-29,9257
2323,中環,7,0,7,凱基-林口,2023-08-29,9257
5009,榮剛,9,2,7,凱基-林口,2023-08-29,9257
00679B,元大美債20年,6,0,6,凱基-林口,2023-08-29,9257
2887,台新金,6,0,6,凱基-林口,2023-08-29,9257
9945,潤泰新,12,6,6,凱基-林口,2023-08-29,9257
1529,樂事綠能,6,0,6,凱基-林口,2023-08-29,9257
2606,裕民,7,1,6,凱基-林口,2023-08-29,9257
3035,智原,30,24,6,凱基-林口,2023-08-29,9257
2891,中信金,5,0,5,凱基-林口,2023-08-29,9257
2002,中鋼,5,0,5,凱基-林口,2023-08-29,9257
00706L,期元大S＆P日圓正2,5,0,5,凱基-林口,2023-08-29,9257
00687B,國泰20年美債,5,0,5,凱基-林口,2023-08-29,9257
2324,仁寶,6,1,5,凱基-林口,2023-08-29,9257
2344,華邦電,5,0,5,凱基-林口,2023-08-29,9257
00919,群益台灣精選高息,161,0,161,凱基-林口,2023-08-30,9257
4909,新復興,93,0,93,凱基-林口,2023-08-30,9257
3481,群創,63,4,59,凱基-林口,2023-08-30,9257
8936,國統,57,0,57,凱基-林口,2023-08-30,9257
00688L,國泰20年美債正2,50,0,50,凱基-林口,2023-08-30,9257
00712,復華富時不動產,35,0,35,凱基-林口,2023-08-30,9257
2618,長榮航,33,4,29,凱基-林口,2023-08-30,9257
2409,友達,25,0,25,凱基-林口,2023-08-30,9257
00637L,元大滬深300正2,20,0,20,凱基-林口,2023-08-30,9257
5284,jpp-KY,21,1,20,凱基-林口,2023-08-30,9257
6015,宏遠證,20,0,20,凱基-林口,2023-08-30,9257
2883,凱基金,30,11,19,凱基-林口,2023-08-30,9257
00929,復華台灣科技優息,37,20,17,凱基-林口,2023-08-30,9257
6170,統振,16,0,16,凱基-林口,2023-08-30,9257
00706L,期元大S＆P日圓正2,15,0,15,凱基-林口,2023-08-30,9257
2324,仁寶,13,0,13,凱基-林口,2023-08-30,9257
5388,中磊,12,0,12,凱基-林口,2023-08-30,9257
1449,佳和,11,0,11,凱基-林口,2023-08-30,9257
2421,建準,12,1,11,凱基-林口,2023-08-30,9257
6194,育富,11,0,11,凱基-林口,2023-08-30,9257
2485,兆赫,15,4,11,凱基-林口,2023-08-30,9257
00753L,中信中國50正2,10,0,10,凱基-林口,2023-08-30,9257
00795B,中信美國公債20年,10,0,10,凱基-林口,2023-08-30,9257
2481,強茂,10,0,10,凱基-林口,2023-08-30,9257
2913,農林,10,0,10,凱基-林口,2023-08-30,9257
3057,喬鼎,10,0,10,凱基-林口,2023-08-30,9257
6191,精成科,10,0,10,凱基-林口,2023-08-30,9257
6532,瑞耘,10,0,10,凱基-林口,2023-08-30,9257
3338,泰碩,10,0,10,凱基-林口,2023-08-30,9257
4763,材料-KY,10,0,10,凱基-林口,2023-08-30,9257
3041,揚智,10,1,9,凱基-林口,2023-08-30,9257
6829,千附精密,15,6,9,凱基-林口,2023-08-30,9257
2328,廣宇,8,0,8,凱基-林口,2023-08-30,9257
3088,艾訊,8,0,8,凱基-林口,2023-08-30,9257
5009,榮剛,10,2,8,凱基-林口,2023-08-30,9257
2356,英業達,13,6,7,凱基-林口,2023-08-30,9257
2344,華邦電,13,6,7,凱基-林口,2023-08-30,9257
2364,倫飛,9,2,7,凱基-林口,2023-08-30,9257
3257,虹冠電,7,0,7,凱基-林口,2023-08-30,9257
4533,協易機,7,0,7,凱基-林口,2023-08-30,9257
6189,豐藝,7,0,7,凱基-林口,2023-08-30,9257
00923,群益台ESG低碳50,6,0,6,凱基-林口,2023-08-30,9257
2340,台亞,6,0,6,凱基-林口,2023-08-30,9257
5876,上海商銀,6,0,6,凱基-林口,2023-08-30,9257
6182,合晶,6,0,6,凱基-林口,2023-08-30,9257
00679B,元大美債20年,6,0,6,凱基-林口,2023-08-30,9257
8210,勤誠,12,6,6,凱基-林口,2023-08-30,9257
2891,中信金,5,0,5,凱基-林口,2023-08-30,9257
2301,光寶科,8,3,5,凱基-林口,2023-08-30,9257
1712,興農,5,0,5,凱基-林口,2023-08-30,9257
2409,友達,143,31,112,凱基-林口,2023-08-31,9257
1904,正隆,105,0,105,凱基-林口,2023-08-31,9257
2888,新光金,61,0,61,凱基-林口,2023-08-31,9257
00878,國泰永續高股息,48,4,44,凱基-林口,2023-08-31,9257
1802,台玻,59,19,40,凱基-林口,2023-08-31,9257
00688L,國泰20年美債正2,50,20,30,凱基-林口,2023-08-31,9257
5243,乙盛-KY,30,0,30,凱基-林口,2023-08-31,9257
00885,富邦越南,30,1,29,凱基-林口,2023-08-31,9257
5388,中磊,48,21,27,凱基-林口,2023-08-31,9257
3078,僑威,31,5,26,凱基-林口,2023-08-31,9257
4909,新復興,26,0,26,凱基-林口,2023-08-31,9257
00706L,期元大S＆P日圓正2,25,0,25,凱基-林口,2023-08-31,9257
6170,統振,37,12,25,凱基-林口,2023-08-31,9257
8936,國統,25,0,25,凱基-林口,2023-08-31,9257
2834,臺企銀,34,10,24,凱基-林口,2023-08-31,9257
00900,富邦特選高股息30,22,0,22,凱基-林口,2023-08-31,9257
3035,智原,27,6,21,凱基-林口,2023-08-31,9257
3037,欣興,23,2,21,凱基-林口,2023-08-31,9257
00888,永豐台灣ESG,21,0,21,凱基-林口,2023-08-31,9257
7402,邑錡,23,3,20,凱基-林口,2023-08-31,9257
2323,中環,25,5,20,凱基-林口,2023-08-31,9257
5483,中美晶,20,0,20,凱基-林口,2023-08-31,9257
3481,群創,21,5,16,凱基-林口,2023-08-31,9257
1618,合機,16,0,16,凱基-林口,2023-08-31,9257
4906,正文,16,0,16,凱基-林口,2023-08-31,9257
2881,富邦金,15,0,15,凱基-林口,2023-08-31,9257
6116,彩晶,14,0,14,凱基-林口,2023-08-31,9257
6547,高端疫苗,18,4,14,凱基-林口,2023-08-31,9257
2890,永豐金,15,2,13,凱基-林口,2023-08-31,9257
6605,帝寶,13,0,13,凱基-林口,2023-08-31,9257
2324,仁寶,12,0,12,凱基-林口,2023-08-31,9257
3715,定穎投控,51,40,11,凱基-林口,2023-08-31,9257
2367,燿華,17,6,11,凱基-林口,2023-08-31,9257
2330,台積電,10,0,10,凱基-林口,2023-08-31,9257
00891,中信關鍵半導體,10,0,10,凱基-林口,2023-08-31,9257
00850,元大臺灣ESG永續,10,0,10,凱基-林口,2023-08-31,9257
00680L,元大美債20正2,10,0,10,凱基-林口,2023-08-31,9257
00679B,元大美債20年,10,0,10,凱基-林口,2023-08-31,9257
1540,喬福,10,0,10,凱基-林口,2023-08-31,9257
3062,建漢,10,0,10,凱基-林口,2023-08-31,9257
4973,廣穎,10,0,10,凱基-林口,2023-08-31,9257
2618,長榮航,19,10,9,凱基-林口,2023-08-31,9257
1513,中興電,10,1,9,凱基-林口,2023-08-31,9257
2886,兆豐金,9,0,9,凱基-林口,2023-08-31,9257
2002,中鋼,9,0,9,凱基-林口,2023-08-31,9257
00637L,元大滬深300正2,8,0,8,凱基-林口,2023-08-31,9257
1795,美時,13,5,8,凱基-林口,2023-08-31,9257
3532,台勝科,8,0,8,凱基-林口,2023-08-31,9257
2303,聯電,23,16,7,凱基-林口,2023-08-31,9257
5529,鉅陞,7,0,7,凱基-林口,2023-08-31,9257
1605,華新,251,7,244,凱基-林口,2023-09-01,9257
2495,普安,70,5,65,凱基-林口,2023-09-01,9257
2409,友達,75,11,64,凱基-林口,2023-09-01,9257
2402,毅嘉,144,80,64,凱基-林口,2023-09-01,9257
00932,兆豐永續高息等權,47,0,47,凱基-林口,2023-09-01,9257
00929,復華台灣科技優息,47,2,45,凱基-林口,2023-09-01,9257
2303,聯電,51,8,43,凱基-林口,2023-09-01,9257
00919,群益台灣精選高息,42,0,42,凱基-林口,2023-09-01,9257
3231,緯創,70,33,37,凱基-林口,2023-09-01,9257
6414,樺漢,35,0,35,凱基-林口,2023-09-01,9257
3432,台端,31,0,31,凱基-林口,2023-09-01,9257
1616,億泰,30,0,30,凱基-林口,2023-09-01,9257
2356,英業達,38,15,23,凱基-林口,2023-09-01,9257
3062,建漢,24,1,23,凱基-林口,2023-09-01,9257
2634,漢翔,60,37,23,凱基-林口,2023-09-01,9257
6173,信昌電,44,22,22,凱基-林口,2023-09-01,9257
00650L,復華香港正2,20,0,20,凱基-林口,2023-09-01,9257
5388,中磊,20,0,20,凱基-林口,2023-09-01,9257
8227,巨有科技,18,0,18,凱基-林口,2023-09-01,9257
1513,中興電,29,12,17,凱基-林口,2023-09-01,9257
2329,華泰,20,3,17,凱基-林口,2023-09-01,9257
00679B,元大美債20年,15,0,15,凱基-林口,2023-09-01,9257
8390,金益鼎,15,0,15,凱基-林口,2023-09-01,9257
2618,長榮航,20,6,14,凱基-林口,2023-09-01,9257
3715,定穎投控,36,22,14,凱基-林口,2023-09-01,9257
2485,兆赫,64,51,13,凱基-林口,2023-09-01,9257
1522,堤維西,34,21,13,凱基-林口,2023-09-01,9257
8210,勤誠,16,3,13,凱基-林口,2023-09-01,9257
2645,長榮航太,12,0,12,凱基-林口,2023-09-01,9257
8033,雷虎,15,3,12,凱基-林口,2023-09-01,9257
00751B,元大AAA至A公司債,12,0,12,凱基-林口,2023-09-01,9257
2368,金像電,14,2,12,凱基-林口,2023-09-01,9257
1584,精剛,11,1,10,凱基-林口,2023-09-01,9257
1409,新纖,10,0,10,凱基-林口,2023-09-01,9257
3049,精金,10,0,10,凱基-林口,2023-09-01,9257
3710,連展投控,10,0,10,凱基-林口,2023-09-01,9257
5347,世界,10,0,10,凱基-林口,2023-09-01,9257
6170,統振,10,0,10,凱基-林口,2023-09-01,9257
6282,康舒,21,11,10,凱基-林口,2023-09-01,9257
00923,群益台ESG低碳50,13,5,8,凱基-林口,2023-09-01,9257
6274,台燿,46,38,8,凱基-林口,2023-09-01,9257
2383,台光電,8,0,8,凱基-林口,2023-09-01,9257
1101,台泥,7,0,7,凱基-林口,2023-09-01,9257
00720B,元大投資級公司債,10,3,7,凱基-林口,2023-09-01,9257
2332,友訊,16,9,7,凱基-林口,2023-09-01,9257
5426,振發,7,0,7,凱基-林口,2023-09-01,9257
9938,百和,7,0,7,凱基-林口,2023-09-01,9257
2206,三陽工業,13,6,7,凱基-林口,2023-09-01,9257
2382,廣達,35,29,6,凱基-林口,2023-09-01,9257
1618,合機,6,0,6,凱基-林口,2023-09-01,9257
00919,群益台灣精選高息,123,0,123,凱基-林口,2023-09-04,9257
00929,復華台灣科技優息,118,0,118,凱基-林口,2023-09-04,9257
5347,世界,88,0,88,凱基-林口,2023-09-04,9257
00679B,元大美債20年,61,0,61,凱基-林口,2023-09-04,9257
2888,新光金,50,5,45,凱基-林口,2023-09-04,9257
3481,群創,33,1,32,凱基-林口,2023-09-04,9257
2614,東森,33,2,31,凱基-林口,2023-09-04,9257
9105,泰金寶-DR,30,0,30,凱基-林口,2023-09-04,9257
2402,毅嘉,124,95,29,凱基-林口,2023-09-04,9257
2374,佳能,28,0,28,凱基-林口,2023-09-04,9257
1471,首利,27,0,27,凱基-林口,2023-09-04,9257
2634,漢翔,47,21,26,凱基-林口,2023-09-04,9257
2610,華航,38,13,25,凱基-林口,2023-09-04,9257
2369,菱生,56,32,24,凱基-林口,2023-09-04,9257
00932,兆豐永續高息等權,56,33,23,凱基-林口,2023-09-04,9257
00673R,期元大S＆P原油反1,20,0,20,凱基-林口,2023-09-04,9257
4532,瑞智,20,0,20,凱基-林口,2023-09-04,9257
6288,聯嘉,20,0,20,凱基-林口,2023-09-04,9257
2409,友達,20,1,19,凱基-林口,2023-09-04,9257
00713,元大台灣高息低波,17,0,17,凱基-林口,2023-09-04,9257
2206,三陽工業,19,3,16,凱基-林口,2023-09-04,9257
00720B,元大投資級公司債,15,0,15,凱基-林口,2023-09-04,9257
3673,TPK-KY,15,1,14,凱基-林口,2023-09-04,9257
2405,輔信,13,0,13,凱基-林口,2023-09-04,9257
00772B,中信高評級公司債,12,0,12,凱基-林口,2023-09-04,9257
2301,光寶科,13,1,12,凱基-林口,2023-09-04,9257
2331,精英,12,0,12,凱基-林口,2023-09-04,9257
2201,裕隆,71,59,12,凱基-林口,2023-09-04,9257
2376,技嘉,17,6,11,凱基-林口,2023-09-04,9257
1513,中興電,21,10,11,凱基-林口,2023-09-04,9257
3260,威剛,13,2,11,凱基-林口,2023-09-04,9257
00900,富邦特選高股息30,10,0,10,凱基-林口,2023-09-04,9257
00918,大華優利高填息30,10,0,10,凱基-林口,2023-09-04,9257
1536,和大,10,0,10,凱基-林口,2023-09-04,9257
1802,台玻,31,21,10,凱基-林口,2023-09-04,9257
2109,華豐,10,0,10,凱基-林口,2023-09-04,9257
2546,根基,10,0,10,凱基-林口,2023-09-04,9257
3583,辛耘,10,0,10,凱基-林口,2023-09-04,9257
00751B,元大AAA至A公司債,9,0,9,凱基-林口,2023-09-04,9257
2340,台亞,9,0,9,凱基-林口,2023-09-04,9257
2534,宏盛,9,0,9,凱基-林口,2023-09-04,9257
6282,康舒,18,9,9,凱基-林口,2023-09-04,9257
1304,台聚,8,0,8,凱基-林口,2023-09-04,9257
2317,鴻海,7,0,7,凱基-林口,2023-09-04,9257
00724B,群益投資級金融債,7,0,7,凱基-林口,2023-09-04,9257
00923,群益台ESG低碳50,7,0,7,凱基-林口,2023-09-04,9257
2204,中華,11,4,7,凱基-林口,2023-09-04,9257
4533,協易機,7,0,7,凱基-林口,2023-09-04,9257
4542,科嶠,9,2,7,凱基-林口,2023-09-04,9257
5009,榮剛,9,2,7,凱基-林口,2023-09-04,9257
2880,華南金,171,0,171,凱基-林口,2023-09-05,9257
00929,復華台灣科技優息,333,170,163,凱基-林口,2023-09-05,9257
00915,凱基優選高股息30,135,0,135,凱基-林口,2023-09-05,9257
00918,大華優利高填息30,110,0,110,凱基-林口,2023-09-05,9257
2363,矽統,201,101,100,凱基-林口,2023-09-05,9257
00932,兆豐永續高息等權,89,0,89,凱基-林口,2023-09-05,9257
2344,華邦電,55,0,55,凱基-林口,2023-09-05,9257
2801,彰銀,55,0,55,凱基-林口,2023-09-05,9257
2353,宏��,46,1,45,凱基-林口,2023-09-05,9257
2402,毅嘉,76,32,44,凱基-林口,2023-09-05,9257
1618,合機,45,3,42,凱基-林口,2023-09-05,9257
3346,麗清,41,0,41,凱基-林口,2023-09-05,9257
2610,華航,41,3,38,凱基-林口,2023-09-05,9257
00720B,元大投資級公司債,36,0,36,凱基-林口,2023-09-05,9257
00706L,期元大S＆P日圓正2,36,0,36,凱基-林口,2023-09-05,9257
3231,緯創,64,31,33,凱基-林口,2023-09-05,9257
00650L,復華香港正2,60,30,30,凱基-林口,2023-09-05,9257
00679B,元大美債20年,26,0,26,凱基-林口,2023-09-05,9257
2615,萬海,27,1,26,凱基-林口,2023-09-05,9257
8358,金居,73,48,25,凱基-林口,2023-09-05,9257
00751B,元大AAA至A公司債,20,0,20,凱基-林口,2023-09-05,9257
00633L,富邦上証正2,20,0,20,凱基-林口,2023-09-05,9257
6176,瑞儀,20,0,20,凱基-林口,2023-09-05,9257
3481,群創,22,3,19,凱基-林口,2023-09-05,9257
00878,國泰永續高股息,19,0,19,凱基-林口,2023-09-05,9257
6158,禾昌,30,11,19,凱基-林口,2023-09-05,9257
2618,長榮航,19,0,19,凱基-林口,2023-09-05,9257
2427,三商電,18,0,18,凱基-林口,2023-09-05,9257
2409,友達,15,0,15,凱基-林口,2023-09-05,9257
2349,錸德,15,0,15,凱基-林口,2023-09-05,9257
9802,鈺齊-KY,16,1,15,凱基-林口,2023-09-05,9257
2359,所羅門,50,36,14,凱基-林口,2023-09-05,9257
5425,台半,13,0,13,凱基-林口,2023-09-05,9257
6235,華孚,15,2,13,凱基-林口,2023-09-05,9257
2809,京城銀,12,0,12,凱基-林口,2023-09-05,9257
00712,復華富時不動產,12,0,12,凱基-林口,2023-09-05,9257
5529,鉅陞,12,0,12,凱基-林口,2023-09-05,9257
00772B,中信高評級公司債,11,0,11,凱基-林口,2023-09-05,9257
1802,台玻,26,15,11,凱基-林口,2023-09-05,9257
2913,農林,11,0,11,凱基-林口,2023-09-05,9257
2109,華豐,10,0,10,凱基-林口,2023-09-05,9257
2374,佳能,10,0,10,凱基-林口,2023-09-05,9257
6226,光鼎,10,0,10,凱基-林口,2023-09-05,9257
6770,力積電,11,1,10,凱基-林口,2023-09-05,9257
00830,國泰費城半導體,10,1,9,凱基-林口,2023-09-05,9257
1605,華新,18,9,9,凱基-林口,2023-09-05,9257
2634,漢翔,24,16,8,凱基-林口,2023-09-05,9257
6515,穎崴,12,4,8,凱基-林口,2023-09-05,9257
2303,聯電,11,4,7,凱基-林口,2023-09-05,9257
2324,仁寶,7,0,7,凱基-林口,2023-09-05,9257
00929,復華台灣科技優息,272,39,233,凱基-林口,2023-09-06,9257
1316,上曜,200,0,200,凱基-林口,2023-09-06,9257
2888,新光金,137,0,137,凱基-林口,2023-09-06,9257
00671R,富邦NASDAQ反1,100,0,100,凱基-林口,2023-09-06,9257
3483,力致,81,0,81,凱基-林口,2023-09-06,9257
2883,凱基金,84,10,74,凱基-林口,2023-09-06,9257
2402,毅嘉,67,23,44,凱基-林口,2023-09-06,9257
2409,友達,47,5,42,凱基-林口,2023-09-06,9257
00633L,富邦上証正2,40,0,40,凱基-林口,2023-09-06,9257
2801,彰銀,40,0,40,凱基-林口,2023-09-06,9257
3311,閎暉,40,0,40,凱基-林口,2023-09-06,9257
2363,矽統,182,144,38,凱基-林口,2023-09-06,9257
5258,虹堡,102,64,38,凱基-林口,2023-09-06,9257
3706,神達,31,2,29,凱基-林口,2023-09-06,9257
6274,台燿,68,41,27,凱基-林口,2023-09-06,9257
3481,群創,25,2,23,凱基-林口,2023-09-06,9257
00720B,元大投資級公司債,22,0,22,凱基-林口,2023-09-06,9257
00751B,元大AAA至A公司債,21,0,21,凱基-林口,2023-09-06,9257
2834,臺企銀,21,0,21,凱基-林口,2023-09-06,9257
2208,台船,20,0,20,凱基-林口,2023-09-06,9257
2355,敬鵬,20,0,20,凱基-林口,2023-09-06,9257
00919,群益台灣精選高息,30,10,20,凱基-林口,2023-09-06,9257
5284,jpp-KY,20,1,19,凱基-林口,2023-09-06,9257
00885,富邦越南,17,0,17,凱基-林口,2023-09-06,9257
2353,宏��,64,48,16,凱基-林口,2023-09-06,9257
2534,宏盛,13,0,13,凱基-林口,2023-09-06,9257
00907,永豐優息存股,12,0,12,凱基-林口,2023-09-06,9257
00637L,元大滬深300正2,15,3,12,凱基-林口,2023-09-06,9257
2312,金寶,12,0,12,凱基-林口,2023-09-06,9257
2880,華南金,12,0,12,凱基-林口,2023-09-06,9257
6158,禾昌,12,0,12,凱基-林口,2023-09-06,9257
00679B,元大美債20年,11,0,11,凱基-林口,2023-09-06,9257
3346,麗清,11,0,11,凱基-林口,2023-09-06,9257
00715L,期街口布蘭特正2,10,0,10,凱基-林口,2023-09-06,9257
00930,永豐ESG低碳高息,11,1,10,凱基-林口,2023-09-06,9257
2107,厚生,10,0,10,凱基-林口,2023-09-06,9257
5289,宜鼎,10,0,10,凱基-林口,2023-09-06,9257
5706,鳳凰,10,0,10,凱基-林口,2023-09-06,9257
6015,宏遠證,10,0,10,凱基-林口,2023-09-06,9257
6173,信昌電,10,0,10,凱基-林口,2023-09-06,9257
6226,光鼎,10,0,10,凱基-林口,2023-09-06,9257
00931B,統一美債20年,9,0,9,凱基-林口,2023-09-06,9257
2485,兆赫,10,1,9,凱基-林口,2023-09-06,9257
2457,飛宏,9,1,8,凱基-林口,2023-09-06,9257
5608,四維航,8,0,8,凱基-林口,2023-09-06,9257
2376,技嘉,15,7,8,凱基-林口,2023-09-06,9257
4906,正文,9,2,7,凱基-林口,2023-09-06,9257
00915,凱基優選高股息30,12,5,7,凱基-林口,2023-09-06,9257
00680L,元大美債20正2,7,0,7,凱基-林口,2023-09-06,9257
3228,金麗科,9,2,7,凱基-林口,2023-09-06,9257
00929,復華台灣科技優息,153,1,152,凱基-林口,2023-09-07,9257
2402,毅嘉,113,2,111,凱基-林口,2023-09-07,9257
00919,群益台灣精選高息,76,0,76,凱基-林口,2023-09-07,9257
2618,長榮航,70,7,63,凱基-林口,2023-09-07,9257
6274,台燿,80,41,39,凱基-林口,2023-09-07,9257
00706L,期元大S＆P日圓正2,36,0,36,凱基-林口,2023-09-07,9257
2610,華航,30,0,30,凱基-林口,2023-09-07,9257
2358,廷鑫,34,4,30,凱基-林口,2023-09-07,9257
6176,瑞儀,30,0,30,凱基-林口,2023-09-07,9257
00637L,元大滬深300正2,25,0,25,凱基-林口,2023-09-07,9257
2603,長榮,24,0,24,凱基-林口,2023-09-07,9257
3704,合勤控,28,4,24,凱基-林口,2023-09-07,9257
5258,虹堡,68,46,22,凱基-林口,2023-09-07,9257
2486,一詮,27,6,21,凱基-林口,2023-09-07,9257
2880,華南金,24,3,21,凱基-林口,2023-09-07,9257
4167,松瑞藥,21,0,21,凱基-林口,2023-09-07,9257
9928,中視,21,0,21,凱基-林口,2023-09-07,9257
2376,技嘉,42,21,21,凱基-林口,2023-09-07,9257
2383,台光電,24,4,20,凱基-林口,2023-09-07,9257
00932,兆豐永續高息等權,22,2,20,凱基-林口,2023-09-07,9257
2888,新光金,20,0,20,凱基-林口,2023-09-07,9257
3033,威健,20,0,20,凱基-林口,2023-09-07,9257
3078,僑威,25,5,20,凱基-林口,2023-09-07,9257
3483,力致,20,0,20,凱基-林口,2023-09-07,9257
3715,定穎投控,32,12,20,凱基-林口,2023-09-07,9257
4532,瑞智,20,0,20,凱基-林口,2023-09-07,9257
5483,中美晶,20,0,20,凱基-林口,2023-09-07,9257
2614,東森,34,14,20,凱基-林口,2023-09-07,9257
2324,仁寶,19,0,19,凱基-林口,2023-09-07,9257
2409,友達,21,3,18,凱基-林口,2023-09-07,9257
00918,大華優利高填息30,18,0,18,凱基-林口,2023-09-07,9257
3481,群創,24,7,17,凱基-林口,2023-09-07,9257
2534,宏盛,17,0,17,凱基-林口,2023-09-07,9257
6285,啟��,25,9,16,凱基-林口,2023-09-07,9257
4934,太極,18,3,15,凱基-林口,2023-09-07,9257
4944,兆遠,15,0,15,凱基-林口,2023-09-07,9257
00878,國泰永續高股息,25,10,15,凱基-林口,2023-09-07,9257
00923,群益台ESG低碳50,13,0,13,凱基-林口,2023-09-07,9257
1605,華新,13,0,13,凱基-林口,2023-09-07,9257
2313,華通,21,9,12,凱基-林口,2023-09-07,9257
4533,協易機,30,18,12,凱基-林口,2023-09-07,9257
2891,中信金,12,0,12,凱基-林口,2023-09-07,9257
00915,凱基優選高股息30,11,0,11,凱基-林口,2023-09-07,9257
2352,佳世達,11,0,11,凱基-林口,2023-09-07,9257
2883,凱基金,11,0,11,凱基-林口,2023-09-07,9257
8112,至上,18,7,11,凱基-林口,2023-09-07,9257
6235,華孚,11,1,10,凱基-林口,2023-09-07,9257
00712,復華富時不動產,10,0,10,凱基-林口,2023-09-07,9257
00633L,富邦上証正2,10,0,10,凱基-林口,2023-09-07,9257
00632R,元大台灣50反1,20,10,10,凱基-林口,2023-09-07,9257
00918,大華優利高填息30,153,0,153,凱基-林口,2023-09-08,9257
2880,華南金,109,2,107,凱基-林口,2023-09-08,9257
00919,群益台灣精選高息,72,0,72,凱基-林口,2023-09-08,9257
00929,復華台灣科技優息,76,9,67,凱基-林口,2023-09-08,9257
00632R,元大台灣50反1,60,0,60,凱基-林口,2023-09-08,9257
00671R,富邦NASDAQ反1,55,0,55,凱基-林口,2023-09-08,9257
2402,毅嘉,87,40,47,凱基-林口,2023-09-08,9257
00902,中信電池及儲能,38,0,38,凱基-林口,2023-09-08,9257
2634,漢翔,31,1,30,凱基-林口,2023-09-08,9257
00637L,元大滬深300正2,30,0,30,凱基-林口,2023-09-08,9257
6158,禾昌,26,2,24,凱基-林口,2023-09-08,9257
2355,敬鵬,23,0,23,凱基-林口,2023-09-08,9257
1301,台塑,22,0,22,凱基-林口,2023-09-08,9257
2630,亞航,26,4,22,凱基-林口,2023-09-08,9257
3481,群創,23,3,20,凱基-林口,2023-09-08,9257
4167,松瑞藥,20,0,20,凱基-林口,2023-09-08,9257
0050,元大台灣50,17,0,17,凱基-林口,2023-09-08,9257
00931B,統一美債20年,16,0,16,凱基-林口,2023-09-08,9257
1612,宏泰,16,0,16,凱基-林口,2023-09-08,9257
00915,凱基優選高股息30,15,0,15,凱基-林口,2023-09-08,9257
2421,建準,16,2,14,凱基-林口,2023-09-08,9257
3483,力致,18,4,14,凱基-林口,2023-09-08,9257
00753L,中信中國50正2,13,0,13,凱基-林口,2023-09-08,9257
2486,一詮,21,8,13,凱基-林口,2023-09-08,9257
2913,農林,13,0,13,凱基-林口,2023-09-08,9257
3231,緯創,13,3,10,凱基-林口,2023-09-08,9257
8112,至上,11,1,10,凱基-林口,2023-09-08,9257
00680L,元大美債20正2,10,0,10,凱基-林口,2023-09-08,9257
2323,中環,10,0,10,凱基-林口,2023-09-08,9257
2534,宏盛,10,0,10,凱基-林口,2023-09-08,9257
3338,泰碩,10,0,10,凱基-林口,2023-09-08,9257
5388,中磊,10,0,10,凱基-林口,2023-09-08,9257
00764B,群益25年美債,9,0,9,凱基-林口,2023-09-08,9257
2371,大同,24,15,9,凱基-林口,2023-09-08,9257
2884,玉山金,10,1,9,凱基-林口,2023-09-08,9257
3711,日月光投控,10,1,9,凱基-林口,2023-09-08,9257
00907,永豐優息存股,8,0,8,凱基-林口,2023-09-08,9257
2208,台船,8,0,8,凱基-林口,2023-09-08,9257
2353,宏��,13,5,8,凱基-林口,2023-09-08,9257
2485,兆赫,49,41,8,凱基-林口,2023-09-08,9257
2606,裕民,10,2,8,凱基-林口,2023-09-08,9257
5381,合正,20,12,8,凱基-林口,2023-09-08,9257
6770,力積電,10,2,8,凱基-林口,2023-09-08,9257
2887,台新金,8,0,8,凱基-林口,2023-09-08,9257
9105,泰金寶-DR,12,5,7,凱基-林口,2023-09-08,9257
1101,台泥,7,0,7,凱基-林口,2023-09-08,9257
1714,和桐,7,0,7,凱基-林口,2023-09-08,9257
3037,欣興,8,1,7,凱基-林口,2023-09-08,9257
5258,虹堡,41,34,7,凱基-林口,2023-09-08,9257
2618,長榮航,7,0,7,凱基-林口,2023-09-08,9257
00878,國泰永續高股息,132,3,129,凱基-林口,2023-09-11,9257
2402,毅嘉,117,20,97,凱基-林口,2023-09-11,9257
00919,群益台灣精選高息,78,0,78,凱基-林口,2023-09-11,9257
00929,復華台灣科技優息,71,3,68,凱基-林口,2023-09-11,9257
1618,合機,76,10,66,凱基-林口,2023-09-11,9257
2312,金寶,63,0,63,凱基-林口,2023-09-11,9257
00882,中信中國高股息,52,0,52,凱基-林口,2023-09-11,9257
4960,誠美材,51,0,51,凱基-林口,2023-09-11,9257
2355,敬鵬,43,3,40,凱基-林口,2023-09-11,9257
2618,長榮航,38,0,38,凱基-林口,2023-09-11,9257
00918,大華優利高填息30,39,1,38,凱基-林口,2023-09-11,9257
0056,元大高股息,45,8,37,凱基-林口,2023-09-11,9257
2379,瑞昱,36,0,36,凱基-林口,2023-09-11,9257
3481,群創,34,1,33,凱基-林口,2023-09-11,9257
3287,廣寰科,30,0,30,凱基-林口,2023-09-11,9257
5258,虹堡,111,84,27,凱基-林口,2023-09-11,9257
2002,中鋼,24,0,24,凱基-林口,2023-09-11,9257
3231,緯創,68,47,21,凱基-林口,2023-09-11,9257
4532,瑞智,20,0,20,凱基-林口,2023-09-11,9257
6139,亞翔,20,0,20,凱基-林口,2023-09-11,9257
00713,元大台灣高息低波,19,0,19,凱基-林口,2023-09-11,9257
5347,世界,19,0,19,凱基-林口,2023-09-11,9257
5381,合正,25,7,18,凱基-林口,2023-09-11,9257
00915,凱基優選高股息30,17,0,17,凱基-林口,2023-09-11,9257
2352,佳世達,18,1,17,凱基-林口,2023-09-11,9257
00932,兆豐永續高息等權,16,0,16,凱基-林口,2023-09-11,9257
1504,東元,18,2,16,凱基-林口,2023-09-11,9257
00679B,元大美債20年,15,0,15,凱基-林口,2023-09-11,9257
6122,擎邦,15,0,15,凱基-林口,2023-09-11,9257
2356,英業達,27,13,14,凱基-林口,2023-09-11,9257
6282,康舒,20,6,14,凱基-林口,2023-09-11,9257
2913,農林,13,0,13,凱基-林口,2023-09-11,9257
2382,廣達,34,21,13,凱基-林口,2023-09-11,9257
2363,矽統,139,126,13,凱基-林口,2023-09-11,9257
2481,強茂,12,0,12,凱基-林口,2023-09-11,9257
4533,協易機,12,0,12,凱基-林口,2023-09-11,9257
2323,中環,11,0,11,凱基-林口,2023-09-11,9257
2388,威盛,24,14,10,凱基-林口,2023-09-11,9257
2884,玉山金,11,1,10,凱基-林口,2023-09-11,9257
00907,永豐優息存股,10,0,10,凱基-林口,2023-09-11,9257
00931B,統一美債20年,10,0,10,凱基-林口,2023-09-11,9257
3078,僑威,18,8,10,凱基-林口,2023-09-11,9257
3419,譁裕,10,0,10,凱基-林口,2023-09-11,9257
6226,光鼎,10,0,10,凱基-林口,2023-09-11,9257
2838,聯邦銀,9,0,9,凱基-林口,2023-09-11,9257
3706,神達,20,11,9,凱基-林口,2023-09-11,9257
5706,鳳凰,9,0,9,凱基-林口,2023-09-11,9257
6770,力積電,11,2,9,凱基-林口,2023-09-11,9257
8210,勤誠,9,0,9,凱基-林口,2023-09-11,9257
2376,技嘉,26,18,8,凱基-林口,2023-09-11,9257
3715,定穎投控,106,5,101,凱基-林口,2023-09-12,9257
2427,三商電,100,0,100,凱基-林口,2023-09-12,9257
2402,毅嘉,111,20,91,凱基-林口,2023-09-12,9257
00929,復華台灣科技優息,69,4,65,凱基-林口,2023-09-12,9257
00680L,元大美債20正2,55,0,55,凱基-林口,2023-09-12,9257
2883,凱基金,52,0,52,凱基-林口,2023-09-12,9257
00918,大華優利高填息30,50,0,50,凱基-林口,2023-09-12,9257
2025,千興,50,0,50,凱基-林口,2023-09-12,9257
5439,高技,31,1,30,凱基-林口,2023-09-12,9257
1409,新纖,30,0,30,凱基-林口,2023-09-12,9257
6158,禾昌,28,0,28,凱基-林口,2023-09-12,9257
00679B,元大美債20年,23,0,23,凱基-林口,2023-09-12,9257
00919,群益台灣精選高息,20,0,20,凱基-林口,2023-09-12,9257
00650L,復華香港正2,30,10,20,凱基-林口,2023-09-12,9257
6691,洋基工程,20,0,20,凱基-林口,2023-09-12,9257
00915,凱基優選高股息30,19,0,19,凱基-林口,2023-09-12,9257
2105,正新,19,0,19,凱基-林口,2023-09-12,9257
6120,達運,19,0,19,凱基-林口,2023-09-12,9257
2618,長榮航,17,0,17,凱基-林口,2023-09-12,9257
1471,首利,22,6,16,凱基-林口,2023-09-12,9257
1101,台泥,14,0,14,凱基-林口,2023-09-12,9257
5347,世界,14,0,14,凱基-林口,2023-09-12,9257
8069,元太,12,0,12,凱基-林口,2023-09-12,9257
2363,矽統,138,126,12,凱基-林口,2023-09-12,9257
3035,智原,24,13,11,凱基-林口,2023-09-12,9257
2457,飛宏,11,0,11,凱基-林口,2023-09-12,9257
00720B,元大投資級公司債,11,0,11,凱基-林口,2023-09-12,9257
6117,迎廣,15,4,11,凱基-林口,2023-09-12,9257
00772B,中信高評級公司債,10,0,10,凱基-林口,2023-09-12,9257
1815,富喬,11,1,10,凱基-林口,2023-09-12,9257
2601,益航,10,0,10,凱基-林口,2023-09-12,9257
2888,新光金,10,0,10,凱基-林口,2023-09-12,9257
4960,誠美材,10,0,10,凱基-林口,2023-09-12,9257
5483,中美晶,10,0,10,凱基-林口,2023-09-12,9257
6182,合晶,18,8,10,凱基-林口,2023-09-12,9257
6689,伊雲谷,10,0,10,凱基-林口,2023-09-12,9257
5227,立凱-KY,9,0,9,凱基-林口,2023-09-12,9257
5381,合正,13,4,9,凱基-林口,2023-09-12,9257
2206,三陽工業,12,4,8,凱基-林口,2023-09-12,9257
4967,十銓,10,2,8,凱基-林口,2023-09-12,9257
2002,中鋼,7,0,7,凱基-林口,2023-09-12,9257
1515,力山,22,16,6,凱基-林口,2023-09-12,9257
2603,長榮,7,1,6,凱基-林口,2023-09-12,9257
6443,元晶,8,2,6,凱基-林口,2023-09-12,9257
1513,中興電,5,0,5,凱基-林口,2023-09-12,9257
3036,文曄,5,0,5,凱基-林口,2023-09-12,9257
2376,技嘉,12,7,5,凱基-林口,2023-09-12,9257
00902,中信電池及儲能,5,0,5,凱基-林口,2023-09-12,9257
00673R,期元大S＆P原油反1,5,0,5,凱基-林口,2023-09-12,9257
00751B,元大AAA至A公司債,5,0,5,凱基-林口,2023-09-12,9257
00929,復華台灣科技優息,79,3,76,凱基-林口,2023-09-13,9257
3704,合勤控,60,2,58,凱基-林口,2023-09-13,9257
0056,元大高股息,37,0,37,凱基-林口,2023-09-13,9257
00919,群益台灣精選高息,45,9,36,凱基-林口,2023-09-13,9257
00902,中信電池及儲能,35,0,35,凱基-林口,2023-09-13,9257
00900,富邦特選高股息30,26,0,26,凱基-林口,2023-09-13,9257
3685,元創精密,26,0,26,凱基-林口,2023-09-13,9257
2634,漢翔,30,10,20,凱基-林口,2023-09-13,9257
1752,南光,20,0,20,凱基-林口,2023-09-13,9257
2313,華通,31,11,20,凱基-林口,2023-09-13,9257
1101,台泥,18,2,16,凱基-林口,2023-09-13,9257
00918,大華優利高填息30,16,0,16,凱基-林口,2023-09-13,9257
00751B,元大AAA至A公司債,15,0,15,凱基-林口,2023-09-13,9257
00679B,元大美債20年,14,0,14,凱基-林口,2023-09-13,9257
3090,日電貿,15,1,14,凱基-林口,2023-09-13,9257
3078,僑威,13,0,13,凱基-林口,2023-09-13,9257
00881,國泰台灣5G+,12,0,12,凱基-林口,2023-09-13,9257
00680L,元大美債20正2,12,0,12,凱基-林口,2023-09-13,9257
00687B,國泰20年美債,11,0,11,凱基-林口,2023-09-13,9257
00720B,元大投資級公司債,11,0,11,凱基-林口,2023-09-13,9257
2317,鴻海,11,0,11,凱基-林口,2023-09-13,9257
00932,兆豐永續高息等權,10,0,10,凱基-林口,2023-09-13,9257
00637L,元大滬深300正2,10,0,10,凱基-林口,2023-09-13,9257
00857B,永豐20年美公債,10,0,10,凱基-林口,2023-09-13,9257
00907,永豐優息存股,10,0,10,凱基-林口,2023-09-13,9257
1312,國喬,10,0,10,凱基-林口,2023-09-13,9257
2834,臺企銀,10,0,10,凱基-林口,2023-09-13,9257
4105,東洋,12,2,10,凱基-林口,2023-09-13,9257
6125,廣運,11,1,10,凱基-林口,2023-09-13,9257
00878,國泰永續高股息,18,9,9,凱基-林口,2023-09-13,9257
2457,飛宏,10,1,9,凱基-林口,2023-09-13,9257
2337,旺宏,11,2,9,凱基-林口,2023-09-13,9257
4915,致伸,10,1,9,凱基-林口,2023-09-13,9257
3037,欣興,9,1,8,凱基-林口,2023-09-13,9257
8081,致新,10,2,8,凱基-林口,2023-09-13,9257
00719B,元大美債1-3,7,0,7,凱基-林口,2023-09-13,9257
00673R,期元大S＆P原油反1,6,0,6,凱基-林口,2023-09-13,9257
2241,艾姆勒,6,0,6,凱基-林口,2023-09-13,9257
2356,英業達,7,1,6,凱基-林口,2023-09-13,9257
2402,毅嘉,28,22,6,凱基-林口,2023-09-13,9257
2538,基泰,7,1,6,凱基-林口,2023-09-13,9257
2606,裕民,6,0,6,凱基-林口,2023-09-13,9257
6689,伊雲谷,6,0,6,凱基-林口,2023-09-13,9257
2308,台達電,5,0,5,凱基-林口,2023-09-13,9257
2206,三陽工業,5,0,5,凱基-林口,2023-09-13,9257
2362,藍天,5,0,5,凱基-林口,2023-09-13,9257
00772B,中信高評級公司債,5,0,5,凱基-林口,2023-09-13,9257
1612,宏泰,5,0,5,凱基-林口,2023-09-13,9257
2340,台亞,6,1,5,凱基-林口,2023-09-13,9257
2353,宏��,5,0,5,凱基-林口,2023-09-13,9257
6284,佳邦,205,1,204,凱基-林口,2023-09-14,9257
00637L,元大滬深300正2,85,2,83,凱基-林口,2023-09-14,9257
00929,復華台灣科技優息,84,4,80,凱基-林口,2023-09-14,9257
3715,定穎投控,86,18,68,凱基-林口,2023-09-14,9257
3706,神達,52,0,52,凱基-林口,2023-09-14,9257
00919,群益台灣精選高息,36,2,34,凱基-林口,2023-09-14,9257
3035,智原,35,5,30,凱基-林口,2023-09-14,9257
2402,毅嘉,30,1,29,凱基-林口,2023-09-14,9257
2838,聯邦銀,23,0,23,凱基-林口,2023-09-14,9257
00665L,富邦�琤肭磪囓�2,20,0,20,凱基-林口,2023-09-14,9257
2427,三商電,20,0,20,凱基-林口,2023-09-14,9257
2889,國票金,20,0,20,凱基-林口,2023-09-14,9257
1568,倉佑,20,1,19,凱基-林口,2023-09-14,9257
00918,大華優利高填息30,20,2,18,凱基-林口,2023-09-14,9257
00931B,統一美債20年,16,0,16,凱基-林口,2023-09-14,9257
2347,聯強,15,0,15,凱基-林口,2023-09-14,9257
2438,翔耀,15,0,15,凱基-林口,2023-09-14,9257
2313,華通,43,29,14,凱基-林口,2023-09-14,9257
8034,榮群,14,0,14,凱基-林口,2023-09-14,9257
00679B,元大美債20年,13,0,13,凱基-林口,2023-09-14,9257
00915,凱基優選高股息30,12,0,12,凱基-林口,2023-09-14,9257
00680L,元大美債20正2,12,0,12,凱基-林口,2023-09-14,9257
2363,矽統,58,46,12,凱基-林口,2023-09-14,9257
2387,精元,12,0,12,凱基-林口,2023-09-14,9257
5876,上海商銀,20,10,10,凱基-林口,2023-09-14,9257
1402,遠東新,10,0,10,凱基-林口,2023-09-14,9257
1612,宏泰,10,0,10,凱基-林口,2023-09-14,9257
2337,旺宏,20,10,10,凱基-林口,2023-09-14,9257
3230,錦明,10,0,10,凱基-林口,2023-09-14,9257
6026,福邦證,10,0,10,凱基-林口,2023-09-14,9257
6176,瑞儀,30,20,10,凱基-林口,2023-09-14,9257
8358,金居,10,0,10,凱基-林口,2023-09-14,9257
2364,倫飛,9,0,9,凱基-林口,2023-09-14,9257
00719B,元大美債1-3,8,0,8,凱基-林口,2023-09-14,9257
3014,聯陽,10,2,8,凱基-林口,2023-09-14,9257
3481,群創,8,1,7,凱基-林口,2023-09-14,9257
00673R,期元大S＆P原油反1,7,0,7,凱基-林口,2023-09-14,9257
2630,亞航,8,1,7,凱基-林口,2023-09-14,9257
3583,辛耘,7,0,7,凱基-林口,2023-09-14,9257
0056,元大高股息,13,6,7,凱基-林口,2023-09-14,9257
4739,康普,11,5,6,凱基-林口,2023-09-14,9257
2204,中華,9,3,6,凱基-林口,2023-09-14,9257
2485,兆赫,7,1,6,凱基-林口,2023-09-14,9257
6531,愛普*,7,1,6,凱基-林口,2023-09-14,9257
2634,漢翔,6,1,5,凱基-林口,2023-09-14,9257
2301,光寶科,17,12,5,凱基-林口,2023-09-14,9257
1907,永豐餘,5,0,5,凱基-林口,2023-09-14,9257
2020,美亞,5,0,5,凱基-林口,2023-09-14,9257
2406,國碩,5,0,5,凱基-林口,2023-09-14,9257
2913,農林,6,1,5,凱基-林口,2023-09-14,9257
00929,復華台灣科技優息,187,3,184,凱基-林口,2023-09-15,9257
00919,群益台灣精選高息,162,14,148,凱基-林口,2023-09-15,9257
2409,友達,103,6,97,凱基-林口,2023-09-15,9257
2486,一詮,122,48,74,凱基-林口,2023-09-15,9257
2609,陽明,181,114,67,凱基-林口,2023-09-15,9257
4173,久裕,50,0,50,凱基-林口,2023-09-15,9257
2605,新興,80,42,38,凱基-林口,2023-09-15,9257
2312,金寶,44,10,34,凱基-林口,2023-09-15,9257
4102,永日,33,0,33,凱基-林口,2023-09-15,9257
2020,美亞,30,1,29,凱基-林口,2023-09-15,9257
3058,立德,28,0,28,凱基-林口,2023-09-15,9257
2618,長榮航,27,2,25,凱基-林口,2023-09-15,9257
2402,毅嘉,29,6,23,凱基-林口,2023-09-15,9257
4994,傳奇,21,0,21,凱基-林口,2023-09-15,9257
00650L,復華香港正2,20,0,20,凱基-林口,2023-09-15,9257
2438,翔耀,20,0,20,凱基-林口,2023-09-15,9257
2851,中再保,20,0,20,凱基-林口,2023-09-15,9257
4532,瑞智,20,0,20,凱基-林口,2023-09-15,9257
2637,慧洋-KY,34,16,18,凱基-林口,2023-09-15,9257
0056,元大高股息,35,18,17,凱基-林口,2023-09-15,9257
00637L,元大滬深300正2,17,0,17,凱基-林口,2023-09-15,9257
00915,凱基優選高股息30,17,0,17,凱基-林口,2023-09-15,9257
00679B,元大美債20年,16,0,16,凱基-林口,2023-09-15,9257
5871,中租-KY,16,0,16,凱基-林口,2023-09-15,9257
6442,光聖,26,10,16,凱基-林口,2023-09-15,9257
2352,佳世達,15,1,14,凱基-林口,2023-09-15,9257
4919,新唐,16,2,14,凱基-林口,2023-09-15,9257
3481,群創,13,0,13,凱基-林口,2023-09-15,9257
2356,英業達,13,1,12,凱基-林口,2023-09-15,9257
00931B,統一美債20年,11,0,11,凱基-林口,2023-09-15,9257
3163,波若威,32,21,11,凱基-林口,2023-09-15,9257
2641,正德,17,6,11,凱基-林口,2023-09-15,9257
5258,虹堡,34,23,11,凱基-林口,2023-09-15,9257
5353,台林,11,0,11,凱基-林口,2023-09-15,9257
00918,大華優利高填息30,10,0,10,凱基-林口,2023-09-15,9257
2534,宏盛,10,0,10,凱基-林口,2023-09-15,9257
2888,新光金,10,0,10,凱基-林口,2023-09-15,9257
3122,笙泉,10,0,10,凱基-林口,2023-09-15,9257
8277,商丞,10,0,10,凱基-林口,2023-09-15,9257
9938,百和,20,11,9,凱基-林口,2023-09-15,9257
2206,三陽工業,10,1,9,凱基-林口,2023-09-15,9257
3363,上詮,15,6,9,凱基-林口,2023-09-15,9257
2476,鉅祥,10,1,9,凱基-林口,2023-09-15,9257
8068,全達,9,0,9,凱基-林口,2023-09-15,9257
2355,敬鵬,8,0,8,凱基-林口,2023-09-15,9257
2374,佳能,8,0,8,凱基-林口,2023-09-15,9257
3011,今皓,8,0,8,凱基-林口,2023-09-15,9257
00673R,期元大S＆P原油反1,7,0,7,凱基-林口,2023-09-15,9257
00772B,中信高評級公司債,7,0,7,凱基-林口,2023-09-15,9257
6176,瑞儀,40,33,7,凱基-林口,2023-09-15,9257
3481,群創,452,0,452,凱基-林口,2023-09-18,9257
00929,復華台灣科技優息,287,15,272,凱基-林口,2023-09-18,9257
00919,群益台灣精選高息,171,89,82,凱基-林口,2023-09-18,9257
00878,國泰永續高股息,69,0,69,凱基-林口,2023-09-18,9257
2363,矽統,132,73,59,凱基-林口,2023-09-18,9257
2618,長榮航,60,2,58,凱基-林口,2023-09-18,9257
2634,漢翔,53,0,53,凱基-林口,2023-09-18,9257
00922,國泰台灣領袖50,51,0,51,凱基-林口,2023-09-18,9257
2367,燿華,55,9,46,凱基-林口,2023-09-18,9257
3685,元創精密,45,0,45,凱基-林口,2023-09-18,9257
3706,神達,52,9,43,凱基-林口,2023-09-18,9257
3037,欣興,39,1,38,凱基-林口,2023-09-18,9257
3693,營邦,39,1,38,凱基-林口,2023-09-18,9257
2027,大成鋼,43,6,37,凱基-林口,2023-09-18,9257
3231,緯創,31,3,28,凱基-林口,2023-09-18,9257
3715,定穎投控,48,21,27,凱基-林口,2023-09-18,9257
3035,智原,30,4,26,凱基-林口,2023-09-18,9257
00679B,元大美債20年,25,0,25,凱基-林口,2023-09-18,9257
2402,毅嘉,35,10,25,凱基-林口,2023-09-18,9257
2605,新興,103,78,25,凱基-林口,2023-09-18,9257
2352,佳世達,21,1,20,凱基-林口,2023-09-18,9257
2382,廣達,24,4,20,凱基-林口,2023-09-18,9257
2405,輔信,18,0,18,凱基-林口,2023-09-18,9257
3163,波若威,21,3,18,凱基-林口,2023-09-18,9257
2330,台積電,19,2,17,凱基-林口,2023-09-18,9257
0056,元大高股息,17,0,17,凱基-林口,2023-09-18,9257
2354,鴻準,16,0,16,凱基-林口,2023-09-18,9257
5371,中光電,21,5,16,凱基-林口,2023-09-18,9257
2603,長榮,42,27,15,凱基-林口,2023-09-18,9257
00687B,國泰20年美債,15,0,15,凱基-林口,2023-09-18,9257
00673R,期元大S＆P原油反1,15,0,15,凱基-林口,2023-09-18,9257
00782B,國泰A級公用債,15,0,15,凱基-林口,2023-09-18,9257
1471,首利,15,0,15,凱基-林口,2023-09-18,9257
00915,凱基優選高股息30,13,0,13,凱基-林口,2023-09-18,9257
00772B,中信高評級公司債,12,0,12,凱基-林口,2023-09-18,9257
2457,飛宏,11,0,11,凱基-林口,2023-09-18,9257
2883B,凱基金乙特,11,0,11,凱基-林口,2023-09-18,9257
00715L,期街口布蘭特正2,10,0,10,凱基-林口,2023-09-18,9257
2328,廣宇,10,0,10,凱基-林口,2023-09-18,9257
2438,翔耀,10,0,10,凱基-林口,2023-09-18,9257
2890,永豐金,10,0,10,凱基-林口,2023-09-18,9257
3230,錦明,10,0,10,凱基-林口,2023-09-18,9257
3522,御嵿,10,0,10,凱基-林口,2023-09-18,9257
6120,達運,10,0,10,凱基-林口,2023-09-18,9257
2002,中鋼,9,0,9,凱基-林口,2023-09-18,9257
00893,國泰智能電動車,9,0,9,凱基-林口,2023-09-18,9257
00921,兆豐龍頭等權重,9,0,9,凱基-林口,2023-09-18,9257
1802,台玻,10,1,9,凱基-林口,2023-09-18,9257
2301,光寶科,12,4,8,凱基-林口,2023-09-18,9257
2303,聯電,18,10,8,凱基-林口,2023-09-18,9257
3481,群創,269,9,260,凱基-林口,2023-09-19,9257
1316,上曜,205,0,205,凱基-林口,2023-09-19,9257
2402,毅嘉,106,0,106,凱基-林口,2023-09-19,9257
00882,中信中國高股息,93,0,93,凱基-林口,2023-09-19,9257
00919,群益台灣精選高息,93,0,93,凱基-林口,2023-09-19,9257
00929,復華台灣科技優息,63,5,58,凱基-林口,2023-09-19,9257
3058,立德,56,0,56,凱基-林口,2023-09-19,9257
00921,兆豐龍頭等權重,45,0,45,凱基-林口,2023-09-19,9257
9928,中視,47,3,44,凱基-林口,2023-09-19,9257
00878,國泰永續高股息,64,27,37,凱基-林口,2023-09-19,9257
4173,久裕,30,0,30,凱基-林口,2023-09-19,9257
2354,鴻準,48,23,25,凱基-林口,2023-09-19,9257
3105,穩懋,21,0,21,凱基-林口,2023-09-19,9257
4167,松瑞藥,20,0,20,凱基-林口,2023-09-19,9257
5258,虹堡,25,5,20,凱基-林口,2023-09-19,9257
2312,金寶,19,0,19,凱基-林口,2023-09-19,9257
2206,三陽工業,22,6,16,凱基-林口,2023-09-19,9257
6274,台燿,26,10,16,凱基-林口,2023-09-19,9257
2363,矽統,64,49,15,凱基-林口,2023-09-19,9257
3035,智原,98,85,13,凱基-林口,2023-09-19,9257
6285,啟��,31,18,13,凱基-林口,2023-09-19,9257
2610,華航,18,5,13,凱基-林口,2023-09-19,9257
1584,精剛,12,0,12,凱基-林口,2023-09-19,9257
4714,永捷,12,0,12,凱基-林口,2023-09-19,9257
6284,佳邦,13,1,12,凱基-林口,2023-09-19,9257
2457,飛宏,11,0,11,凱基-林口,2023-09-19,9257
2344,華邦電,11,0,11,凱基-林口,2023-09-19,9257
3450,聯鈞,12,1,11,凱基-林口,2023-09-19,9257
6190,萬泰科,14,3,11,凱基-林口,2023-09-19,9257
2367,燿華,39,28,11,凱基-林口,2023-09-19,9257
3036,文曄,13,2,11,凱基-林口,2023-09-19,9257
2618,長榮航,15,5,10,凱基-林口,2023-09-19,9257
00680L,元大美債20正2,10,0,10,凱基-林口,2023-09-19,9257
2208,台船,10,0,10,凱基-林口,2023-09-19,9257
2425,承啟,10,0,10,凱基-林口,2023-09-19,9257
3346,麗清,10,0,10,凱基-林口,2023-09-19,9257
6015,宏遠證,10,0,10,凱基-林口,2023-09-19,9257
8105,凌巨,10,0,10,凱基-林口,2023-09-19,9257
00923,群益台ESG低碳50,10,1,9,凱基-林口,2023-09-19,9257
2427,三商電,9,0,9,凱基-林口,2023-09-19,9257
3013,晟銘電,11,2,9,凱基-林口,2023-09-19,9257
3230,錦明,9,0,9,凱基-林口,2023-09-19,9257
0056,元大高股息,10,1,9,凱基-林口,2023-09-19,9257
3231,緯創,27,19,8,凱基-林口,2023-09-19,9257
4979,華星光,18,10,8,凱基-林口,2023-09-19,9257
2330,台積電,8,0,8,凱基-林口,2023-09-19,9257
2301,光寶科,11,3,8,凱基-林口,2023-09-19,9257
2382,廣達,28,20,8,凱基-林口,2023-09-19,9257
1471,首利,7,0,7,凱基-林口,2023-09-19,9257
2492,華新科,15,8,7,凱基-林口,2023-09-19,9257
2883,凱基金,124,0,124,凱基-林口,2023-09-20,9257
2888,新光金,105,0,105,凱基-林口,2023-09-20,9257
00919,群益台灣精選高息,89,6,83,凱基-林口,2023-09-20,9257
00929,復華台灣科技優息,198,128,70,凱基-林口,2023-09-20,9257
3122,笙泉,59,0,59,凱基-林口,2023-09-20,9257
3715,定穎投控,133,74,59,凱基-林口,2023-09-20,9257
00680L,元大美債20正2,57,0,57,凱基-林口,2023-09-20,9257
2353,宏��,46,3,43,凱基-林口,2023-09-20,9257
2332,友訊,33,0,33,凱基-林口,2023-09-20,9257
5483,中美晶,30,0,30,凱基-林口,2023-09-20,9257
5258,虹堡,37,7,30,凱基-林口,2023-09-20,9257
00878,國泰永續高股息,31,1,30,凱基-林口,2023-09-20,9257
2834,臺企銀,27,0,27,凱基-林口,2023-09-20,9257
2344,華邦電,25,0,25,凱基-林口,2023-09-20,9257
2634,漢翔,25,1,24,凱基-林口,2023-09-20,9257
2606,裕民,32,10,22,凱基-林口,2023-09-20,9257
00921,兆豐龍頭等權重,23,2,21,凱基-林口,2023-09-20,9257
2329,華泰,25,4,21,凱基-林口,2023-09-20,9257
3005,神基,24,3,21,凱基-林口,2023-09-20,9257
2610,華航,40,20,20,凱基-林口,2023-09-20,9257
00902,中信電池及儲能,20,0,20,凱基-林口,2023-09-20,9257
2206,三陽工業,21,1,20,凱基-林口,2023-09-20,9257
2312,金寶,20,0,20,凱基-林口,2023-09-20,9257
8088,品安,44,25,19,凱基-林口,2023-09-20,9257
3037,欣興,21,4,17,凱基-林口,2023-09-20,9257
2201,裕隆,17,0,17,凱基-林口,2023-09-20,9257
2913,農林,17,0,17,凱基-林口,2023-09-20,9257
2352,佳世達,16,1,15,凱基-林口,2023-09-20,9257
2405,輔信,16,1,15,凱基-林口,2023-09-20,9257
2449,京元電子,21,6,15,凱基-林口,2023-09-20,9257
5009,榮剛,15,0,15,凱基-林口,2023-09-20,9257
00918,大華優利高填息30,14,0,14,凱基-林口,2023-09-20,9257
2618,長榮航,41,28,13,凱基-林口,2023-09-20,9257
00923,群益台ESG低碳50,13,0,13,凱基-林口,2023-09-20,9257
00932,兆豐永續高息等權,13,0,13,凱基-林口,2023-09-20,9257
00885,富邦越南,12,0,12,凱基-林口,2023-09-20,9257
00881,國泰台灣5G+,10,0,10,凱基-林口,2023-09-20,9257
2323,中環,10,0,10,凱基-林口,2023-09-20,9257
6176,瑞儀,10,0,10,凱基-林口,2023-09-20,9257
6209,今國光,10,0,10,凱基-林口,2023-09-20,9257
6443,元晶,10,0,10,凱基-林口,2023-09-20,9257
2330,台積電,9,0,9,凱基-林口,2023-09-20,9257
8358,金居,10,1,9,凱基-林口,2023-09-20,9257
00679B,元大美債20年,8,0,8,凱基-林口,2023-09-20,9257
1584,精剛,13,5,8,凱基-林口,2023-09-20,9257
3265,台星科,20,12,8,凱基-林口,2023-09-20,9257
6282,康舒,19,11,8,凱基-林口,2023-09-20,9257
3035,智原,8,0,8,凱基-林口,2023-09-20,9257
2355,敬鵬,7,0,7,凱基-林口,2023-09-20,9257
2441,超豐,7,0,7,凱基-林口,2023-09-20,9257
00929,復華台灣科技優息,217,6,211,凱基-林口,2023-09-21,9257
1316,上曜,200,0,200,凱基-林口,2023-09-21,9257
2888,新光金,134,0,134,凱基-林口,2023-09-21,9257
00878,國泰永續高股息,126,12,114,凱基-林口,2023-09-21,9257
00687B,國泰20年美債,105,0,105,凱基-林口,2023-09-21,9257
2367,燿華,103,1,102,凱基-林口,2023-09-21,9257
00679B,元大美債20年,104,5,99,凱基-林口,2023-09-21,9257
2834,臺企銀,61,0,61,凱基-林口,2023-09-21,9257
3706,神達,56,3,53,凱基-林口,2023-09-21,9257
1101,台泥,53,1,52,凱基-林口,2023-09-21,9257
2883,凱基金,48,1,47,凱基-林口,2023-09-21,9257
3058,立德,47,0,47,凱基-林口,2023-09-21,9257
3685,元創精密,47,0,47,凱基-林口,2023-09-21,9257
00680L,元大美債20正2,56,10,46,凱基-林口,2023-09-21,9257
0056,元大高股息,49,4,45,凱基-林口,2023-09-21,9257
00919,群益台灣精選高息,64,25,39,凱基-林口,2023-09-21,9257
4532,瑞智,32,0,32,凱基-林口,2023-09-21,9257
2330,台積電,28,1,27,凱基-林口,2023-09-21,9257
2002,中鋼,23,0,23,凱基-林口,2023-09-21,9257
00900,富邦特選高股息30,22,0,22,凱基-林口,2023-09-21,9257
1584,精剛,30,8,22,凱基-林口,2023-09-21,9257
2534,宏盛,21,0,21,凱基-林口,2023-09-21,9257
00753L,中信中國50正2,20,0,20,凱基-林口,2023-09-21,9257
6546,正基,18,0,18,凱基-林口,2023-09-21,9257
00713,元大台灣高息低波,17,0,17,凱基-林口,2023-09-21,9257
2891,中信金,16,0,16,凱基-林口,2023-09-21,9257
5880,合庫金,16,0,16,凱基-林口,2023-09-21,9257
00637L,元大滬深300正2,15,0,15,凱基-林口,2023-09-21,9257
00932,兆豐永續高息等權,14,0,14,凱基-林口,2023-09-21,9257
1809,中釉,14,0,14,凱基-林口,2023-09-21,9257
3287,廣寰科,14,0,14,凱基-林口,2023-09-21,9257
2890,永豐金,13,0,13,凱基-林口,2023-09-21,9257
1102,亞泥,12,0,12,凱基-林口,2023-09-21,9257
4720,德淵,11,0,11,凱基-林口,2023-09-21,9257
00902,中信電池及儲能,11,0,11,凱基-林口,2023-09-21,9257
0050,元大台灣50,10,0,10,凱基-林口,2023-09-21,9257
2457,飛宏,12,2,10,凱基-林口,2023-09-21,9257
00715L,期街口布蘭特正2,10,0,10,凱基-林口,2023-09-21,9257
00918,大華優利高填息30,10,0,10,凱基-林口,2023-09-21,9257
00930,永豐ESG低碳高息,10,0,10,凱基-林口,2023-09-21,9257
2329,華泰,29,19,10,凱基-林口,2023-09-21,9257
2880,華南金,10,0,10,凱基-林口,2023-09-21,9257
5498,凱崴,10,0,10,凱基-林口,2023-09-21,9257
6104,創惟,10,0,10,凱基-林口,2023-09-21,9257
6185,幃翔,10,0,10,凱基-林口,2023-09-21,9257
6226,光鼎,10,0,10,凱基-林口,2023-09-21,9257
6283,淳安,10,0,10,凱基-林口,2023-09-21,9257
6443,元晶,10,0,10,凱基-林口,2023-09-21,9257
6182,合晶,9,0,9,凱基-林口,2023-09-21,9257
2618,長榮航,28,19,9,凱基-林口,2023-09-21,9257
2883,凱基金,114,2,112,凱基-林口,2023-09-22,9257
00679B,元大美債20年,109,0,109,凱基-林口,2023-09-22,9257
8054,安國,95,1,94,凱基-林口,2023-09-22,9257
00929,復華台灣科技優息,83,8,75,凱基-林口,2023-09-22,9257
3685,元創精密,53,0,53,凱基-林口,2023-09-22,9257
2888,新光金,40,0,40,凱基-林口,2023-09-22,9257
00878,國泰永續高股息,47,9,38,凱基-林口,2023-09-22,9257
4102,永日,31,0,31,凱基-林口,2023-09-22,9257
1560,中砂,32,2,30,凱基-林口,2023-09-22,9257
00712,復華富時不動產,29,0,29,凱基-林口,2023-09-22,9257
3706,神達,41,12,29,凱基-林口,2023-09-22,9257
00772B,中信高評級公司債,28,0,28,凱基-林口,2023-09-22,9257
2891,中信金,23,0,23,凱基-林口,2023-09-22,9257
00720B,元大投資級公司債,22,0,22,凱基-林口,2023-09-22,9257
2331,精英,23,1,22,凱基-林口,2023-09-22,9257
00632R,元大台灣50反1,20,0,20,凱基-林口,2023-09-22,9257
6271,同欣電,21,2,19,凱基-林口,2023-09-22,9257
2618,長榮航,21,2,19,凱基-林口,2023-09-22,9257
1101,台泥,19,0,19,凱基-林口,2023-09-22,9257
2330,台積電,17,0,17,凱基-林口,2023-09-22,9257
00931B,統一美債20年,16,0,16,凱基-林口,2023-09-22,9257
2303,聯電,14,0,14,凱基-林口,2023-09-22,9257
00885,富邦越南,13,0,13,凱基-林口,2023-09-22,9257
3450,聯鈞,38,25,13,凱基-林口,2023-09-22,9257
2002,中鋼,18,6,12,凱基-林口,2023-09-22,9257
00680L,元大美債20正2,12,0,12,凱基-林口,2023-09-22,9257
3122,笙泉,12,0,12,凱基-林口,2023-09-22,9257
00687B,國泰20年美債,12,0,12,凱基-林口,2023-09-22,9257
00633L,富邦上証正2,10,0,10,凱基-林口,2023-09-22,9257
00696B,富邦美債20年,10,0,10,凱基-林口,2023-09-22,9257
3006,晶豪科,10,0,10,凱基-林口,2023-09-22,9257
9962,有益,10,0,10,凱基-林口,2023-09-22,9257
00915,凱基優選高股息30,9,0,9,凱基-林口,2023-09-22,9257
00637L,元大滬深300正2,9,0,9,凱基-林口,2023-09-22,9257
1584,精剛,13,4,9,凱基-林口,2023-09-22,9257
2353,宏��,13,4,9,凱基-林口,2023-09-22,9257
2534,宏盛,9,0,9,凱基-林口,2023-09-22,9257
3036,文曄,14,6,8,凱基-林口,2023-09-22,9257
4111,濟生,8,0,8,凱基-林口,2023-09-22,9257
2301,光寶科,10,3,7,凱基-林口,2023-09-22,9257
00907,永豐優息存股,7,0,7,凱基-林口,2023-09-22,9257
00751B,元大AAA至A公司債,6,0,6,凱基-林口,2023-09-22,9257
00903,富邦元宇宙,6,0,6,凱基-林口,2023-09-22,9257
00881,國泰台灣5G+,6,0,6,凱基-林口,2023-09-22,9257
00787B,元大10年IG醫療債,6,0,6,凱基-林口,2023-09-22,9257
1102,亞泥,6,0,6,凱基-林口,2023-09-22,9257
3264,欣銓,7,1,6,凱基-林口,2023-09-22,9257
2317,鴻海,6,0,6,凱基-林口,2023-09-22,9257
0056,元大高股息,6,1,5,凱基-林口,2023-09-22,9257
3231,緯創,42,37,5,凱基-林口,2023-09-22,9257
2883,凱基金,159,10,149,凱基-林口,2023-09-25,9257
00680L,元大美債20正2,123,0,123,凱基-林口,2023-09-25,9257
3311,閎暉,80,0,80,凱基-林口,2023-09-25,9257
2618,長榮航,84,11,73,凱基-林口,2023-09-25,9257
8054,安國,71,0,71,凱基-林口,2023-09-25,9257
3033,威健,70,0,70,凱基-林口,2023-09-25,9257
2888,新光金,70,10,60,凱基-林口,2023-09-25,9257
2542,興富發,53,0,53,凱基-林口,2023-09-25,9257
6176,瑞儀,40,0,40,凱基-林口,2023-09-25,9257
3017,奇鋐,41,2,39,凱基-林口,2023-09-25,9257
3685,元創精密,38,0,38,凱基-林口,2023-09-25,9257
00878,國泰永續高股息,32,0,32,凱基-林口,2023-09-25,9257
8097,常珵,30,0,30,凱基-林口,2023-09-25,9257
00632R,元大台灣50反1,28,0,28,凱基-林口,2023-09-25,9257
00931B,統一美債20年,27,0,27,凱基-林口,2023-09-25,9257
3706,神達,26,0,26,凱基-林口,2023-09-25,9257
2376,技嘉,42,17,25,凱基-林口,2023-09-25,9257
00772B,中信高評級公司債,22,0,22,凱基-林口,2023-09-25,9257
2838,聯邦銀,19,0,19,凱基-林口,2023-09-25,9257
6285,啟��,20,1,19,凱基-林口,2023-09-25,9257
2402,毅嘉,17,2,15,凱基-林口,2023-09-25,9257
2481,強茂,15,0,15,凱基-林口,2023-09-25,9257
3163,波若威,19,5,14,凱基-林口,2023-09-25,9257
8110,華東,13,0,13,凱基-林口,2023-09-25,9257
3287,廣寰科,12,0,12,凱基-林口,2023-09-25,9257
2329,華泰,11,0,11,凱基-林口,2023-09-25,9257
2382,廣達,41,31,10,凱基-林口,2023-09-25,9257
1435,中福,10,0,10,凱基-林口,2023-09-25,9257
00633L,富邦上証正2,10,0,10,凱基-林口,2023-09-25,9257
1560,中砂,10,0,10,凱基-林口,2023-09-25,9257
3583,辛耘,10,0,10,凱基-林口,2023-09-25,9257
6234,高僑,10,0,10,凱基-林口,2023-09-25,9257
00679B,元大美債20年,10,0,10,凱基-林口,2023-09-25,9257
1101,台泥,16,6,10,凱基-林口,2023-09-25,9257
2890,永豐金,9,0,9,凱基-林口,2023-09-25,9257
2610,華航,11,2,9,凱基-林口,2023-09-25,9257
1504,東元,38,29,9,凱基-林口,2023-09-25,9257
2801,彰銀,10,1,9,凱基-林口,2023-09-25,9257
00915,凱基優選高股息30,6,0,6,凱基-林口,2023-09-25,9257
3013,晟銘電,6,0,6,凱基-林口,2023-09-25,9257
5469,瀚宇博,6,0,6,凱基-林口,2023-09-25,9257
9945,潤泰新,5,0,5,凱基-林口,2023-09-25,9257
1519,華城,6,1,5,凱基-林口,2023-09-25,9257
1477,聚陽,5,0,5,凱基-林口,2023-09-25,9257
2023,燁輝,5,0,5,凱基-林口,2023-09-25,9257
2460,建通,5,0,5,凱基-林口,2023-09-25,9257
4164,承業醫,5,0,5,凱基-林口,2023-09-25,9257
2405,輔信,4,0,4,凱基-林口,2023-09-25,9257
2449,京元電子,5,1,4,凱基-林口,2023-09-25,9257
2641,正德,5,1,4,凱基-林口,2023-09-25,9257
2888,新光金,155,0,155,凱基-林口,2023-09-26,9257
2402,毅嘉,103,1,102,凱基-林口,2023-09-26,9257
00679B,元大美債20年,102,0,102,凱基-林口,2023-09-26,9257
2883,凱基金,88,0,88,凱基-林口,2023-09-26,9257
00888,永豐台灣ESG,70,0,70,凱基-林口,2023-09-26,9257
00919,群益台灣精選高息,53,10,43,凱基-林口,2023-09-26,9257
8054,安國,45,3,42,凱基-林口,2023-09-26,9257
00905,FT臺灣Smart,40,0,40,凱基-林口,2023-09-26,9257
2206,三陽工業,41,4,37,凱基-林口,2023-09-26,9257
00772B,中信高評級公司債,34,0,34,凱基-林口,2023-09-26,9257
5880,合庫金,32,0,32,凱基-林口,2023-09-26,9257
00929,復華台灣科技優息,34,2,32,凱基-林口,2023-09-26,9257
2303,聯電,33,2,31,凱基-林口,2023-09-26,9257
3715,定穎投控,108,78,30,凱基-林口,2023-09-26,9257
5465,富驊,30,1,29,凱基-林口,2023-09-26,9257
2538,基泰,26,3,23,凱基-林口,2023-09-26,9257
00633L,富邦上証正2,20,0,20,凱基-林口,2023-09-26,9257
00882,中信中國高股息,20,0,20,凱基-林口,2023-09-26,9257
2816,旺旺保,20,0,20,凱基-林口,2023-09-26,9257
4167,松瑞藥,20,0,20,凱基-林口,2023-09-26,9257
8070,長華*,20,0,20,凱基-林口,2023-09-26,9257
00878,國泰永續高股息,17,0,17,凱基-林口,2023-09-26,9257
6770,力積電,17,0,17,凱基-林口,2023-09-26,9257
2330,台積電,17,0,17,凱基-林口,2023-09-26,9257
2356,英業達,18,2,16,凱基-林口,2023-09-26,9257
2481,強茂,16,0,16,凱基-林口,2023-09-26,9257
00687B,國泰20年美債,15,0,15,凱基-林口,2023-09-26,9257
2610,華航,16,2,14,凱基-林口,2023-09-26,9257
1522,堤維西,28,15,13,凱基-林口,2023-09-26,9257
6414,樺漢,14,1,13,凱基-林口,2023-09-26,9257
6139,亞翔,45,33,12,凱基-林口,2023-09-26,9257
9929,秋雨,83,71,12,凱基-林口,2023-09-26,9257
2002,中鋼,12,1,11,凱基-林口,2023-09-26,9257
3231,緯創,28,18,10,凱基-林口,2023-09-26,9257
00885,富邦越南,20,10,10,凱基-林口,2023-09-26,9257
2405,輔信,10,0,10,凱基-林口,2023-09-26,9257
912000,晨訊科-DR,10,0,10,凱基-林口,2023-09-26,9257
1618,合機,12,3,9,凱基-林口,2023-09-26,9257
3189,景碩,12,3,9,凱基-林口,2023-09-26,9257
2409,友達,8,0,8,凱基-林口,2023-09-26,9257
1504,東元,8,0,8,凱基-林口,2023-09-26,9257
00923,群益台ESG低碳50,8,0,8,凱基-林口,2023-09-26,9257
00881,國泰台灣5G+,8,0,8,凱基-林口,2023-09-26,9257
0056,元大高股息,9,1,8,凱基-林口,2023-09-26,9257
2382,廣達,23,16,7,凱基-林口,2023-09-26,9257
5347,世界,8,1,7,凱基-林口,2023-09-26,9257
00751B,元大AAA至A公司債,7,0,7,凱基-林口,2023-09-26,9257
00637L,元大滬深300正2,7,0,7,凱基-林口,2023-09-26,9257
6547,高端疫苗,7,0,7,凱基-林口,2023-09-26,9257
0050,元大台灣50,7,0,7,凱基-林口,2023-09-26,9257
2888,新光金,151,0,151,凱基-林口,2023-09-27,9257
2883,凱基金,59,0,59,凱基-林口,2023-09-27,9257
00919,群益台灣精選高息,49,0,49,凱基-林口,2023-09-27,9257
00929,復華台灣科技優息,60,13,47,凱基-林口,2023-09-27,9257
2303,聯電,34,0,34,凱基-林口,2023-09-27,9257
00632R,元大台灣50反1,27,0,27,凱基-林口,2023-09-27,9257
3035,智原,38,13,25,凱基-林口,2023-09-27,9257
4542,科嶠,26,1,25,凱基-林口,2023-09-27,9257
5243,乙盛-KY,25,1,24,凱基-林口,2023-09-27,9257
3043,科風,23,0,23,凱基-林口,2023-09-27,9257
00633L,富邦上証正2,20,0,20,凱基-林口,2023-09-27,9257
1536,和大,20,0,20,凱基-林口,2023-09-27,9257
9929,秋雨,115,99,16,凱基-林口,2023-09-27,9257
1449,佳和,15,0,15,凱基-林口,2023-09-27,9257
3037,欣興,14,0,14,凱基-林口,2023-09-27,9257
1609,大亞,17,6,11,凱基-林口,2023-09-27,9257
2534,宏盛,11,0,11,凱基-林口,2023-09-27,9257
00637L,元大滬深300正2,10,0,10,凱基-林口,2023-09-27,9257
00885,富邦越南,10,0,10,凱基-林口,2023-09-27,9257
00715L,期街口布蘭特正2,10,0,10,凱基-林口,2023-09-27,9257
2323,中環,10,0,10,凱基-林口,2023-09-27,9257
2355,敬鵬,10,0,10,凱基-林口,2023-09-27,9257
2748,雲品,10,0,10,凱基-林口,2023-09-27,9257
2838,聯邦銀,10,0,10,凱基-林口,2023-09-27,9257
912000,晨訊科-DR,10,0,10,凱基-林口,2023-09-27,9257
00712,復華富時不動產,10,0,10,凱基-林口,2023-09-27,9257
8088,品安,11,2,9,凱基-林口,2023-09-27,9257
8110,華東,9,0,9,凱基-林口,2023-09-27,9257
00878,國泰永續高股息,15,7,8,凱基-林口,2023-09-27,9257
3680,家登,8,0,8,凱基-林口,2023-09-27,9257
6235,華孚,10,2,8,凱基-林口,2023-09-27,9257
1584,精剛,7,0,7,凱基-林口,2023-09-27,9257
1618,合機,23,16,7,凱基-林口,2023-09-27,9257
5880,合庫金,7,0,7,凱基-林口,2023-09-27,9257
00907,永豐優息存股,6,0,6,凱基-林口,2023-09-27,9257
2313,華通,18,12,6,凱基-林口,2023-09-27,9257
2603,長榮,21,15,6,凱基-林口,2023-09-27,9257
8210,勤誠,9,3,6,凱基-林口,2023-09-27,9257
2890,永豐金,5,0,5,凱基-林口,2023-09-27,9257
2351,順德,5,0,5,凱基-林口,2023-09-27,9257
00772B,中信高評級公司債,5,0,5,凱基-林口,2023-09-27,9257
1218,泰山,5,0,5,凱基-林口,2023-09-27,9257
00932,兆豐永續高息等權,5,0,5,凱基-林口,2023-09-27,9257
1605,華新,5,0,5,凱基-林口,2023-09-27,9257
2337,旺宏,5,0,5,凱基-林口,2023-09-27,9257
2543,皇昌,5,0,5,凱基-林口,2023-09-27,9257
3419,譁裕,5,0,5,凱基-林口,2023-09-27,9257
3704,合勤控,5,0,5,凱基-林口,2023-09-27,9257
5009,榮剛,5,0,5,凱基-林口,2023-09-27,9257
5324,士開,5,0,5,凱基-林口,2023-09-27,9257
2883,凱基金,91,0,91,凱基-林口,2023-09-28,9257
00929,復華台灣科技優息,61,0,61,凱基-林口,2023-09-28,9257
3231,緯創,64,34,30,凱基-林口,2023-09-28,9257
2388,威盛,43,15,28,凱基-林口,2023-09-28,9257
2376,技嘉,33,6,27,凱基-林口,2023-09-28,9257
6117,迎廣,31,4,27,凱基-林口,2023-09-28,9257
00673R,期元大S＆P原油反1,25,0,25,凱基-林口,2023-09-28,9257
00679B,元大美債20年,35,11,24,凱基-林口,2023-09-28,9257
2610,華航,26,2,24,凱基-林口,2023-09-28,9257
3715,定穎投控,61,38,23,凱基-林口,2023-09-28,9257
5439,高技,21,0,21,凱基-林口,2023-09-28,9257
00772B,中信高評級公司債,22,2,20,凱基-林口,2023-09-28,9257
2360,致茂,20,0,20,凱基-林口,2023-09-28,9257
2888,新光金,50,30,20,凱基-林口,2023-09-28,9257
00720B,元大投資級公司債,19,0,19,凱基-林口,2023-09-28,9257
2363,矽統,28,9,19,凱基-林口,2023-09-28,9257
3483,力致,21,2,19,凱基-林口,2023-09-28,9257
2880,華南金,16,0,16,凱基-林口,2023-09-28,9257
00633L,富邦上証正2,15,0,15,凱基-林口,2023-09-28,9257
3322,建舜電,23,8,15,凱基-林口,2023-09-28,9257
00712,復華富時不動產,14,0,14,凱基-林口,2023-09-28,9257
3481,群創,12,0,12,凱基-林口,2023-09-28,9257
2408,南亞科,11,0,11,凱基-林口,2023-09-28,9257
2329,華泰,21,10,11,凱基-林口,2023-09-28,9257
3051,力特,12,1,11,凱基-林口,2023-09-28,9257
6770,力積電,12,1,11,凱基-林口,2023-09-28,9257
5880,合庫金,11,0,11,凱基-林口,2023-09-28,9257
00637L,元大滬深300正2,10,0,10,凱基-林口,2023-09-28,9257
2618,長榮航,20,10,10,凱基-林口,2023-09-28,9257
00931B,統一美債20年,9,0,9,凱基-林口,2023-09-28,9257
2236,百達-KY,9,0,9,凱基-林口,2023-09-28,9257
2337,旺宏,10,1,9,凱基-林口,2023-09-28,9257
3043,科風,9,0,9,凱基-林口,2023-09-28,9257
3122,笙泉,23,14,9,凱基-林口,2023-09-28,9257
6285,啟��,10,1,9,凱基-林口,2023-09-28,9257
2364,倫飛,8,0,8,凱基-林口,2023-09-28,9257
3105,穩懋,8,0,8,凱基-林口,2023-09-28,9257
8088,品安,7,0,7,凱基-林口,2023-09-28,9257
3036,文曄,52,45,7,凱基-林口,2023-09-28,9257
2468,華經,12,6,6,凱基-林口,2023-09-28,9257
3088,艾訊,6,0,6,凱基-林口,2023-09-28,9257
5381,合正,6,0,6,凱基-林口,2023-09-28,9257
00687B,國泰20年美債,7,2,5,凱基-林口,2023-09-28,9257
6245,立端,5,0,5,凱基-林口,2023-09-28,9257
1101,台泥,7,2,5,凱基-林口,2023-09-28,9257
2201,裕隆,6,1,5,凱基-林口,2023-09-28,9257
00764B,群益25年美債,5,0,5,凱基-林口,2023-09-28,9257
00722B,群益投資級電信債,5,0,5,凱基-林口,2023-09-28,9257
1605,華新,5,0,5,凱基-林口,2023-09-28,9257
2353,宏��,6,1,5,凱基-林口,2023-09-28,9257
2888,新光金,209,1,208,凱基-林口,2023-10-02,9257
2363,矽統,141,37,104,凱基-林口,2023-10-02,9257
6116,彩晶,62,6,56,凱基-林口,2023-10-02,9257
6128,上福,51,0,51,凱基-林口,2023-10-02,9257
4979,華星光,53,7,46,凱基-林口,2023-10-02,9257
2883,凱基金,40,0,40,凱基-林口,2023-10-02,9257
5258,虹堡,32,1,31,凱基-林口,2023-10-02,9257
2618,長榮航,41,11,30,凱基-林口,2023-10-02,9257
00852L,國泰美國道瓊正2,30,0,30,凱基-林口,2023-10-02,9257
00679B,元大美債20年,30,0,30,凱基-林口,2023-10-02,9257
00687B,國泰20年美債,25,0,25,凱基-林口,2023-10-02,9257
8358,金居,22,1,21,凱基-林口,2023-10-02,9257
6282,康舒,31,11,20,凱基-林口,2023-10-02,9257
3035,智原,27,8,19,凱基-林口,2023-10-02,9257
2355,敬鵬,40,22,18,凱基-林口,2023-10-02,9257
2409,友達,19,2,17,凱基-林口,2023-10-02,9257
2884,玉山金,16,0,16,凱基-林口,2023-10-02,9257
00907,永豐優息存股,15,0,15,凱基-林口,2023-10-02,9257
3693,營邦,15,0,15,凱基-林口,2023-10-02,9257
8155,博智,15,0,15,凱基-林口,2023-10-02,9257
3234,光環,18,4,14,凱基-林口,2023-10-02,9257
6770,力積電,14,2,12,凱基-林口,2023-10-02,9257
00929,復華台灣科技優息,23,11,12,凱基-林口,2023-10-02,9257
1609,大亞,17,6,11,凱基-林口,2023-10-02,9257
2438,翔耀,10,0,10,凱基-林口,2023-10-02,9257
2465,麗臺,10,0,10,凱基-林口,2023-10-02,9257
6153,嘉聯益,10,0,10,凱基-林口,2023-10-02,9257
6176,瑞儀,10,0,10,凱基-林口,2023-10-02,9257
00772B,中信高評級公司債,9,0,9,凱基-林口,2023-10-02,9257
00632R,元大台灣50反1,9,0,9,凱基-林口,2023-10-02,9257
00720B,元大投資級公司債,8,0,8,凱基-林口,2023-10-02,9257
1519,華城,7,0,7,凱基-林口,2023-10-02,9257
3264,欣銓,7,0,7,凱基-林口,2023-10-02,9257
3583,辛耘,10,3,7,凱基-林口,2023-10-02,9257
4542,科嶠,7,0,7,凱基-林口,2023-10-02,9257
4912,聯德控股-KY,7,0,7,凱基-林口,2023-10-02,9257
00919,群益台灣精選高息,7,0,7,凱基-林口,2023-10-02,9257
2107,厚生,6,0,6,凱基-林口,2023-10-02,9257
2324,仁寶,6,0,6,凱基-林口,2023-10-02,9257
3715,定穎投控,42,36,6,凱基-林口,2023-10-02,9257
8048,德勝,6,0,6,凱基-林口,2023-10-02,9257
00722B,群益投資級電信債,5,0,5,凱基-林口,2023-10-02,9257
2206,三陽工業,7,2,5,凱基-林口,2023-10-02,9257
1326,台化,5,0,5,凱基-林口,2023-10-02,9257
2323,中環,5,0,5,凱基-林口,2023-10-02,9257
2520,冠德,5,0,5,凱基-林口,2023-10-02,9257
2609,陽明,5,0,5,凱基-林口,2023-10-02,9257
3017,奇鋐,9,4,5,凱基-林口,2023-10-02,9257
3230,錦明,7,2,5,凱基-林口,2023-10-02,9257
3711,日月光投控,10,5,5,凱基-林口,2023-10-02,9257
0056,元大高股息,381,7,374,凱基-林口,2023-10-03,9257
2888,新光金,168,0,168,凱基-林口,2023-10-03,9257
2402,毅嘉,249,105,144,凱基-林口,2023-10-03,9257
2409,友達,168,31,137,凱基-林口,2023-10-03,9257
2883,凱基金,101,0,101,凱基-林口,2023-10-03,9257
00637L,元大滬深300正2,75,0,75,凱基-林口,2023-10-03,9257
2002,中鋼,66,0,66,凱基-林口,2023-10-03,9257
00712,復華富時不動產,63,0,63,凱基-林口,2023-10-03,9257
2485,兆赫,56,0,56,凱基-林口,2023-10-03,9257
00922,國泰台灣領袖50,58,3,55,凱基-林口,2023-10-03,9257
00929,復華台灣科技優息,69,25,44,凱基-林口,2023-10-03,9257
1605,華新,36,0,36,凱基-林口,2023-10-03,9257
2618,長榮航,38,4,34,凱基-林口,2023-10-03,9257
3672,康聯訊,30,0,30,凱基-林口,2023-10-03,9257
1815,富喬,36,8,28,凱基-林口,2023-10-03,9257
1609,大亞,31,5,26,凱基-林口,2023-10-03,9257
2365,昆盈,25,0,25,凱基-林口,2023-10-03,9257
00753L,中信中國50正2,20,0,20,凱基-林口,2023-10-03,9257
00680L,元大美債20正2,20,0,20,凱基-林口,2023-10-03,9257
00679B,元大美債20年,18,1,17,凱基-林口,2023-10-03,9257
2388,威盛,20,4,16,凱基-林口,2023-10-03,9257
3013,晟銘電,18,2,16,凱基-林口,2023-10-03,9257
3231,緯創,47,32,15,凱基-林口,2023-10-03,9257
00931B,統一美債20年,15,0,15,凱基-林口,2023-10-03,9257
2107,厚生,15,0,15,凱基-林口,2023-10-03,9257
3706,神達,16,1,15,凱基-林口,2023-10-03,9257
1514,亞力,20,6,14,凱基-林口,2023-10-03,9257
9945,潤泰新,13,0,13,凱基-林口,2023-10-03,9257
4167,松瑞藥,13,0,13,凱基-林口,2023-10-03,9257
3362,先進光,13,0,13,凱基-林口,2023-10-03,9257
1312,國喬,12,0,12,凱基-林口,2023-10-03,9257
4171,瑞基,12,0,12,凱基-林口,2023-10-03,9257
2356,英業達,12,0,12,凱基-林口,2023-10-03,9257
2603,長榮,15,4,11,凱基-林口,2023-10-03,9257
3311,閎暉,11,0,11,凱基-林口,2023-10-03,9257
8069,元太,26,15,11,凱基-林口,2023-10-03,9257
2301,光寶科,10,0,10,凱基-林口,2023-10-03,9257
3163,波若威,48,38,10,凱基-林口,2023-10-03,9257
5864,致和證,10,0,10,凱基-林口,2023-10-03,9257
6139,亞翔,19,9,10,凱基-林口,2023-10-03,9257
6573,虹揚-KY,10,0,10,凱基-林口,2023-10-03,9257
00882,中信中國高股息,10,0,10,凱基-林口,2023-10-03,9257
3704,合勤控,9,0,9,凱基-林口,2023-10-03,9257
5321,美而快,9,0,9,凱基-林口,2023-10-03,9257
3037,欣興,10,1,9,凱基-林口,2023-10-03,9257
3036,文曄,17,9,8,凱基-林口,2023-10-03,9257
00636,國泰中國A50,8,0,8,凱基-林口,2023-10-03,9257
2417,圓剛,11,3,8,凱基-林口,2023-10-03,9257
3346,麗清,27,19,8,凱基-林口,2023-10-03,9257
00720B,元大投資級公司債,17,10,7,凱基-林口,2023-10-03,9257
00712,復華富時不動產,264,0,264,凱基-林口,2023-10-04,9257
0056,元大高股息,153,0,153,凱基-林口,2023-10-04,9257
2888,新光金,138,0,138,凱基-林口,2023-10-04,9257
2883,凱基金,93,0,93,凱基-林口,2023-10-04,9257
00929,復華台灣科技優息,114,25,89,凱基-林口,2023-10-04,9257
6451,訊芯-KY,92,11,81,凱基-林口,2023-10-04,9257
00919,群益台灣精選高息,79,0,79,凱基-林口,2023-10-04,9257
00679B,元大美債20年,81,6,75,凱基-林口,2023-10-04,9257
2538,基泰,60,0,60,凱基-林口,2023-10-04,9257
00688L,國泰20年美債正2,100,50,50,凱基-林口,2023-10-04,9257
6139,亞翔,47,1,46,凱基-林口,2023-10-04,9257
2618,長榮航,58,15,43,凱基-林口,2023-10-04,9257
4923,力士,40,1,39,凱基-林口,2023-10-04,9257
2880,華南金,35,0,35,凱基-林口,2023-10-04,9257
00637L,元大滬深300正2,35,0,35,凱基-林口,2023-10-04,9257
3483,力致,35,0,35,凱基-林口,2023-10-04,9257
3715,定穎投控,52,20,32,凱基-林口,2023-10-04,9257
1609,大亞,33,3,30,凱基-林口,2023-10-04,9257
3231,緯創,31,4,27,凱基-林口,2023-10-04,9257
4960,誠美材,25,0,25,凱基-林口,2023-10-04,9257
2603,長榮,24,0,24,凱基-林口,2023-10-04,9257
4167,松瑞藥,24,0,24,凱基-林口,2023-10-04,9257
9929,秋雨,23,0,23,凱基-林口,2023-10-04,9257
00922,國泰台灣領袖50,22,0,22,凱基-林口,2023-10-04,9257
00720B,元大投資級公司債,22,0,22,凱基-林口,2023-10-04,9257
2884,玉山金,24,3,21,凱基-林口,2023-10-04,9257
2303,聯電,21,0,21,凱基-林口,2023-10-04,9257
3122,笙泉,31,10,21,凱基-林口,2023-10-04,9257
2515,中工,20,0,20,凱基-林口,2023-10-04,9257
1536,和大,20,0,20,凱基-林口,2023-10-04,9257
3217,優群,20,0,20,凱基-林口,2023-10-04,9257
00772B,中信高評級公司債,18,0,18,凱基-林口,2023-10-04,9257
00931B,統一美債20年,16,0,16,凱基-林口,2023-10-04,9257
8086,宏捷科,20,4,16,凱基-林口,2023-10-04,9257
00751B,元大AAA至A公司債,15,0,15,凱基-林口,2023-10-04,9257
00687B,國泰20年美債,14,0,14,凱基-林口,2023-10-04,9257
2838,聯邦銀,14,0,14,凱基-林口,2023-10-04,9257
2885,元大金,19,5,14,凱基-林口,2023-10-04,9257
00881,國泰台灣5G+,13,0,13,凱基-林口,2023-10-04,9257
5608,四維航,12,0,12,凱基-林口,2023-10-04,9257
2317,鴻海,11,0,11,凱基-林口,2023-10-04,9257
5009,榮剛,11,0,11,凱基-林口,2023-10-04,9257
2427,三商電,11,0,11,凱基-林口,2023-10-04,9257
2605,新興,15,4,11,凱基-林口,2023-10-04,9257
1216,統一,12,1,11,凱基-林口,2023-10-04,9257
9945,潤泰新,10,0,10,凱基-林口,2023-10-04,9257
00915,凱基優選高股息30,10,0,10,凱基-林口,2023-10-04,9257
2610,華航,10,0,10,凱基-林口,2023-10-04,9257
00930,永豐ESG低碳高息,10,0,10,凱基-林口,2023-10-04,9257
1519,華城,19,9,10,凱基-林口,2023-10-04,9257
00712,復華富時不動產,471,0,471,凱基-林口,2023-10-05,9257
0056,元大高股息,111,5,106,凱基-林口,2023-10-05,9257
00706L,期元大S＆P日圓正2,100,0,100,凱基-林口,2023-10-05,9257
2883,凱基金,83,0,83,凱基-林口,2023-10-05,9257
6274,台燿,118,46,72,凱基-林口,2023-10-05,9257
00882,中信中國高股息,53,0,53,凱基-林口,2023-10-05,9257
1303,南亞,51,0,51,凱基-林口,2023-10-05,9257
2408,南亞科,40,0,40,凱基-林口,2023-10-05,9257
6176,瑞儀,40,0,40,凱基-林口,2023-10-05,9257
3035,智原,48,13,35,凱基-林口,2023-10-05,9257
00929,復華台灣科技優息,25,0,25,凱基-林口,2023-10-05,9257
6684,安格,25,0,25,凱基-林口,2023-10-05,9257
1324,地球,20,0,20,凱基-林口,2023-10-05,9257
6288,聯嘉,18,2,16,凱基-林口,2023-10-05,9257
2603,長榮,26,11,15,凱基-林口,2023-10-05,9257
3715,定穎投控,93,80,13,凱基-林口,2023-10-05,9257
2417,圓剛,13,1,12,凱基-林口,2023-10-05,9257
3037,欣興,11,0,11,凱基-林口,2023-10-05,9257
00892,富邦台灣半導體,10,0,10,凱基-林口,2023-10-05,9257
3317,尼克森,10,0,10,凱基-林口,2023-10-05,9257
3376,新日興,10,0,10,凱基-林口,2023-10-05,9257
4923,力士,10,0,10,凱基-林口,2023-10-05,9257
6015,宏遠證,10,0,10,凱基-林口,2023-10-05,9257
6226,光鼎,10,0,10,凱基-林口,2023-10-05,9257
00715L,期街口布蘭特正2,10,1,9,凱基-林口,2023-10-05,9257
2402,毅嘉,14,6,8,凱基-林口,2023-10-05,9257
00772B,中信高評級公司債,10,2,8,凱基-林口,2023-10-05,9257
00632R,元大台灣50反1,8,0,8,凱基-林口,2023-10-05,9257
00751B,元大AAA至A公司債,8,0,8,凱基-林口,2023-10-05,9257
5289,宜鼎,7,0,7,凱基-林口,2023-10-05,9257
2201,裕隆,7,0,7,凱基-林口,2023-10-05,9257
2382,廣達,17,10,7,凱基-林口,2023-10-05,9257
2465,麗臺,8,1,7,凱基-林口,2023-10-05,9257
2542,興富發,7,0,7,凱基-林口,2023-10-05,9257
2002,中鋼,6,0,6,凱基-林口,2023-10-05,9257
2206,三陽工業,6,0,6,凱基-林口,2023-10-05,9257
3704,合勤控,14,8,6,凱基-林口,2023-10-05,9257
5215,科嘉-KY,6,0,6,凱基-林口,2023-10-05,9257
5284,jpp-KY,6,0,6,凱基-林口,2023-10-05,9257
1449,佳和,6,0,6,凱基-林口,2023-10-05,9257
2317,鴻海,6,1,5,凱基-林口,2023-10-05,9257
2357,華碩,6,1,5,凱基-林口,2023-10-05,9257
6282,康舒,5,0,5,凱基-林口,2023-10-05,9257
00773B,中信優先金融債,5,0,5,凱基-林口,2023-10-05,9257
2312,金寶,5,0,5,凱基-林口,2023-10-05,9257
2630,亞航,5,0,5,凱基-林口,2023-10-05,9257
3062,建漢,5,0,5,凱基-林口,2023-10-05,9257
3230,錦明,6,1,5,凱基-林口,2023-10-05,9257
4707,磐亞,5,0,5,凱基-林口,2023-10-05,9257
5210,寶碩,5,0,5,凱基-林口,2023-10-05,9257
3481,群創,434,0,434,凱基-林口,2023-10-06,9257
5426,振發,155,1,154,凱基-林口,2023-10-06,9257
6139,亞翔,68,6,62,凱基-林口,2023-10-06,9257
00712,復華富時不動產,51,0,51,凱基-林口,2023-10-06,9257
6530,創威,41,0,41,凱基-林口,2023-10-06,9257
00929,復華台灣科技優息,42,2,40,凱基-林口,2023-10-06,9257
0056,元大高股息,41,4,37,凱基-林口,2023-10-06,9257
4923,力士,36,0,36,凱基-林口,2023-10-06,9257
9105,泰金寶-DR,35,1,34,凱基-林口,2023-10-06,9257
00637L,元大滬深300正2,31,0,31,凱基-林口,2023-10-06,9257
00920,富邦ESG綠色電力,30,0,30,凱基-林口,2023-10-06,9257
2834,臺企銀,25,0,25,凱基-林口,2023-10-06,9257
3264,欣銓,25,0,25,凱基-林口,2023-10-06,9257
00679B,元大美債20年,23,1,22,凱基-林口,2023-10-06,9257
2838,聯邦銀,20,0,20,凱基-林口,2023-10-06,9257
00772B,中信高評級公司債,19,0,19,凱基-林口,2023-10-06,9257
2880,華南金,20,1,19,凱基-林口,2023-10-06,9257
6191,精成科,23,5,18,凱基-林口,2023-10-06,9257
00919,群益台灣精選高息,18,0,18,凱基-林口,2023-10-06,9257
8069,元太,21,4,17,凱基-林口,2023-10-06,9257
2618,長榮航,17,2,15,凱基-林口,2023-10-06,9257
2408,南亞科,15,0,15,凱基-林口,2023-10-06,9257
2883,凱基金,15,0,15,凱基-林口,2023-10-06,9257
4123,晟德,15,0,15,凱基-林口,2023-10-06,9257
6235,華孚,15,2,13,凱基-林口,2023-10-06,9257
6274,台燿,23,11,12,凱基-林口,2023-10-06,9257
6588,東典光電,12,0,12,凱基-林口,2023-10-06,9257
8088,品安,12,0,12,凱基-林口,2023-10-06,9257
2317,鴻海,20,9,11,凱基-林口,2023-10-06,9257
2374,佳能,11,0,11,凱基-林口,2023-10-06,9257
00902,中信電池及儲能,10,0,10,凱基-林口,2023-10-06,9257
2641,正德,10,0,10,凱基-林口,2023-10-06,9257
3044,健鼎,10,0,10,凱基-林口,2023-10-06,9257
3483,力致,12,2,10,凱基-林口,2023-10-06,9257
5531,鄉林,10,0,10,凱基-林口,2023-10-06,9257
6605,帝寶,10,0,10,凱基-林口,2023-10-06,9257
2364,倫飛,9,0,9,凱基-林口,2023-10-06,9257
2442,新美齊,12,3,9,凱基-林口,2023-10-06,9257
3231,緯創,23,14,9,凱基-林口,2023-10-06,9257
5210,寶碩,9,0,9,凱基-林口,2023-10-06,9257
8046,南電,7,0,7,凱基-林口,2023-10-06,9257
1815,富喬,20,13,7,凱基-林口,2023-10-06,9257
2365,昆盈,11,4,7,凱基-林口,2023-10-06,9257
4707,磐亞,7,0,7,凱基-林口,2023-10-06,9257
00918,大華優利高填息30,6,0,6,凱基-林口,2023-10-06,9257
2458,義隆,6,0,6,凱基-林口,2023-10-06,9257
2606,裕民,31,25,6,凱基-林口,2023-10-06,9257
3037,欣興,6,0,6,凱基-林口,2023-10-06,9257
3380,明泰,6,0,6,凱基-林口,2023-10-06,9257
2331,精英,9,4,5,凱基-林口,2023-10-06,9257
00915,凱基優選高股息30,151,1,150,凱基-林口,2023-10-11,9257
3231,緯創,102,21,81,凱基-林口,2023-10-11,9257
00919,群益台灣精選高息,79,0,79,凱基-林口,2023-10-11,9257
5426,振發,76,0,76,凱基-林口,2023-10-11,9257
2883,凱基金,81,19,62,凱基-林口,2023-10-11,9257
6577,勁豐,53,0,53,凱基-林口,2023-10-11,9257
2892,第一金,50,2,48,凱基-林口,2023-10-11,9257
5258,虹堡,37,0,37,凱基-林口,2023-10-11,9257
1609,大亞,32,0,32,凱基-林口,2023-10-11,9257
1524,耿鼎,31,1,30,凱基-林口,2023-10-11,9257
6570,維田,27,0,27,凱基-林口,2023-10-11,9257
00650L,復華香港正2,30,5,25,凱基-林口,2023-10-11,9257
2356,英業達,33,10,23,凱基-林口,2023-10-11,9257
3207,耀勝,22,0,22,凱基-林口,2023-10-11,9257
00733,富邦臺灣中小,20,0,20,凱基-林口,2023-10-11,9257
00673R,期元大S＆P原油反1,20,0,20,凱基-林口,2023-10-11,9257
2515,中工,20,0,20,凱基-林口,2023-10-11,9257
3311,閎暉,20,0,20,凱基-林口,2023-10-11,9257
2614,東森,20,1,19,凱基-林口,2023-10-11,9257
4923,力士,19,0,19,凱基-林口,2023-10-11,9257
2014,中鴻,18,0,18,凱基-林口,2023-10-11,9257
6116,彩晶,20,2,18,凱基-林口,2023-10-11,9257
2382,廣達,36,18,18,凱基-林口,2023-10-11,9257
3483,力致,37,21,16,凱基-林口,2023-10-11,9257
5210,寶碩,16,0,16,凱基-林口,2023-10-11,9257
2618,長榮航,18,3,15,凱基-林口,2023-10-11,9257
00642U,期元大S＆P石油,15,0,15,凱基-林口,2023-10-11,9257
2105,正新,15,0,15,凱基-林口,2023-10-11,9257
00929,復華台灣科技優息,22,8,14,凱基-林口,2023-10-11,9257
2329,華泰,24,10,14,凱基-林口,2023-10-11,9257
2365,昆盈,15,1,14,凱基-林口,2023-10-11,9257
2520,冠德,13,0,13,凱基-林口,2023-10-11,9257
3694,海華,15,2,13,凱基-林口,2023-10-11,9257
00878,國泰永續高股息,16,4,12,凱基-林口,2023-10-11,9257
3715,定穎投控,36,24,12,凱基-林口,2023-10-11,9257
1529,樂事綠能,14,2,12,凱基-林口,2023-10-11,9257
2405,輔信,32,20,12,凱基-林口,2023-10-11,9257
2605,新興,13,2,11,凱基-林口,2023-10-11,9257
4123,晟德,17,6,11,凱基-林口,2023-10-11,9257
00882,中信中國高股息,10,0,10,凱基-林口,2023-10-11,9257
2888,新光金,10,0,10,凱基-林口,2023-10-11,9257
6118,建達,10,0,10,凱基-林口,2023-10-11,9257
8277,商丞,10,0,10,凱基-林口,2023-10-11,9257
2364,倫飛,9,0,9,凱基-林口,2023-10-11,9257
3036,文曄,10,1,9,凱基-林口,2023-10-11,9257
2609,陽明,13,6,7,凱基-林口,2023-10-11,9257
6245,立端,7,0,7,凱基-林口,2023-10-11,9257
2337,旺宏,7,0,7,凱基-林口,2023-10-11,9257
3037,欣興,8,1,7,凱基-林口,2023-10-11,9257
1815,富喬,16,10,6,凱基-林口,2023-10-11,9257
2889,國票金,120,5,115,凱基-林口,2023-10-12,9257
00919,群益台灣精選高息,48,2,46,凱基-林口,2023-10-12,9257
2883,凱基金,87,42,45,凱基-林口,2023-10-12,9257
2888,新光金,40,0,40,凱基-林口,2023-10-12,9257
0056,元大高股息,53,15,38,凱基-林口,2023-10-12,9257
2363,矽統,149,112,37,凱基-林口,2023-10-12,9257
5321,美而快,30,0,30,凱基-林口,2023-10-12,9257
8112,至上,30,5,25,凱基-林口,2023-10-12,9257
2486,一詮,23,1,22,凱基-林口,2023-10-12,9257
6588,東典光電,20,0,20,凱基-林口,2023-10-12,9257
8271,宇瞻,20,0,20,凱基-林口,2023-10-12,9257
2382,廣達,31,17,14,凱基-林口,2023-10-12,9257
00929,復華台灣科技優息,19,8,11,凱基-林口,2023-10-12,9257
2402,毅嘉,12,1,11,凱基-林口,2023-10-12,9257
8088,品安,10,0,10,凱基-林口,2023-10-12,9257
1519,華城,10,2,8,凱基-林口,2023-10-12,9257
2312,金寶,8,0,8,凱基-林口,2023-10-12,9257
9928,中視,8,0,8,凱基-林口,2023-10-12,9257
3376,新日興,7,0,7,凱基-林口,2023-10-12,9257
8210,勤誠,10,3,7,凱基-林口,2023-10-12,9257
00679B,元大美債20年,13,6,7,凱基-林口,2023-10-12,9257
1612,宏泰,6,0,6,凱基-林口,2023-10-12,9257
2538,基泰,6,0,6,凱基-林口,2023-10-12,9257
4938,和碩,6,0,6,凱基-林口,2023-10-12,9257
6234,高僑,6,0,6,凱基-林口,2023-10-12,9257
3037,欣興,5,0,5,凱基-林口,2023-10-12,9257
00706L,期元大S＆P日圓正2,5,0,5,凱基-林口,2023-10-12,9257
00650L,復華香港正2,5,0,5,凱基-林口,2023-10-12,9257
1449,佳和,5,0,5,凱基-林口,2023-10-12,9257
1326,台化,5,0,5,凱基-林口,2023-10-12,9257
2324,仁寶,5,0,5,凱基-林口,2023-10-12,9257
2331,精英,8,3,5,凱基-林口,2023-10-12,9257
2387,精元,5,0,5,凱基-林口,2023-10-12,9257
3419,譁裕,5,0,5,凱基-林口,2023-10-12,9257
3694,海華,11,6,5,凱基-林口,2023-10-12,9257
2634,漢翔,4,0,4,凱基-林口,2023-10-12,9257
1319,東陽,19,15,4,凱基-林口,2023-10-12,9257
2427,三商電,19,15,4,凱基-林口,2023-10-12,9257
2520,冠德,4,0,4,凱基-林口,2023-10-12,9257
2881,富邦金,4,0,4,凱基-林口,2023-10-12,9257
3051,力特,8,4,4,凱基-林口,2023-10-12,9257
3163,波若威,12,8,4,凱基-林口,2023-10-12,9257
4746,台耀,4,0,4,凱基-林口,2023-10-12,9257
5009,榮剛,4,0,4,凱基-林口,2023-10-12,9257
6449,鈺邦,4,0,4,凱基-林口,2023-10-12,9257
8054,安國,4,0,4,凱基-林口,2023-10-12,9257
9105,泰金寶-DR,50,46,4,凱基-林口,2023-10-12,9257
2376,技嘉,15,11,4,凱基-林口,2023-10-12,9257
4744,皇將,3,0,3,凱基-林口,2023-10-12,9257
0050,元大台灣50,5,2,3,凱基-林口,2023-10-12,9257
2402,毅嘉,101,2,99,凱基-林口,2023-10-13,9257
3078,僑威,103,5,98,凱基-林口,2023-10-13,9257
00919,群益台灣精選高息,88,0,88,凱基-林口,2023-10-13,9257
2618,長榮航,82,0,82,凱基-林口,2023-10-13,9257
8112,至上,80,0,80,凱基-林口,2023-10-13,9257
0056,元大高股息,67,7,60,凱基-林口,2023-10-13,9257
00720B,元大投資級公司債,43,0,43,凱基-林口,2023-10-13,9257
00932,兆豐永續高息等權,33,0,33,凱基-林口,2023-10-13,9257
00637L,元大滬深300正2,31,0,31,凱基-林口,2023-10-13,9257
00878,國泰永續高股息,30,0,30,凱基-林口,2023-10-13,9257
6276,安鈦克,30,1,29,凱基-林口,2023-10-13,9257
9105,泰金寶-DR,27,0,27,凱基-林口,2023-10-13,9257
00922,國泰台灣領袖50,26,0,26,凱基-林口,2023-10-13,9257
2382,廣達,57,31,26,凱基-林口,2023-10-13,9257
2324,仁寶,31,8,23,凱基-林口,2023-10-13,9257
2883,凱基金,22,0,22,凱基-林口,2023-10-13,9257
3231,緯創,33,12,21,凱基-林口,2023-10-13,9257
5347,世界,25,4,21,凱基-林口,2023-10-13,9257
6719,力智,25,5,20,凱基-林口,2023-10-13,9257
00632R,元大台灣50反1,19,0,19,凱基-林口,2023-10-13,9257
00679B,元大美債20年,19,0,19,凱基-林口,2023-10-13,9257
2891,中信金,20,2,18,凱基-林口,2023-10-13,9257
00713,元大台灣高息低波,17,0,17,凱基-林口,2023-10-13,9257
2888,新光金,17,0,17,凱基-林口,2023-10-13,9257
9929,秋雨,162,145,17,凱基-林口,2023-10-13,9257
00680L,元大美債20正2,31,15,16,凱基-林口,2023-10-13,9257
00772B,中信高評級公司債,15,0,15,凱基-林口,2023-10-13,9257
4967,十銓,16,1,15,凱基-林口,2023-10-13,9257
2405,輔信,14,0,14,凱基-林口,2023-10-13,9257
2353,宏��,13,1,12,凱基-林口,2023-10-13,9257
2301,光寶科,13,2,11,凱基-林口,2023-10-13,9257
4933,友輝,11,0,11,凱基-林口,2023-10-13,9257
8271,宇瞻,11,0,11,凱基-林口,2023-10-13,9257
2486,一詮,11,0,11,凱基-林口,2023-10-13,9257
00882,中信中國高股息,10,0,10,凱基-林口,2023-10-13,9257
3374,精材,10,0,10,凱基-林口,2023-10-13,9257
3693,營邦,13,3,10,凱基-林口,2023-10-13,9257
3694,海華,10,0,10,凱基-林口,2023-10-13,9257
6284,佳邦,62,52,10,凱基-林口,2023-10-13,9257
00929,復華台灣科技優息,21,12,9,凱基-林口,2023-10-13,9257
5210,寶碩,9,0,9,凱基-林口,2023-10-13,9257
6770,力積電,10,1,9,凱基-林口,2023-10-13,9257
2603,長榮,8,0,8,凱基-林口,2023-10-13,9257
1815,富喬,19,12,7,凱基-林口,2023-10-13,9257
2312,金寶,10,3,7,凱基-林口,2023-10-13,9257
4923,力士,7,0,7,凱基-林口,2023-10-13,9257
6188,廣明,8,1,7,凱基-林口,2023-10-13,9257
4979,華星光,28,21,7,凱基-林口,2023-10-13,9257
00687B,國泰20年美債,6,0,6,凱基-林口,2023-10-13,9257
00888,永豐台灣ESG,6,0,6,凱基-林口,2023-10-13,9257
00929,復華台灣科技優息,78,1,77,凱基-林口,2023-10-16,9257
2888,新光金,72,0,72,凱基-林口,2023-10-16,9257
00878,國泰永續高股息,56,1,55,凱基-林口,2023-10-16,9257
00919,群益台灣精選高息,53,0,53,凱基-林口,2023-10-16,9257
1504,東元,51,0,51,凱基-林口,2023-10-16,9257
0056,元大高股息,47,2,45,凱基-林口,2023-10-16,9257
3706,神達,73,30,43,凱基-林口,2023-10-16,9257
1710,東聯,36,0,36,凱基-林口,2023-10-16,9257
2515,中工,92,56,36,凱基-林口,2023-10-16,9257
00922,國泰台灣領袖50,33,0,33,凱基-林口,2023-10-16,9257
3207,耀勝,34,1,33,凱基-林口,2023-10-16,9257
3481,群創,32,0,32,凱基-林口,2023-10-16,9257
6530,創威,31,1,30,凱基-林口,2023-10-16,9257
5258,虹堡,23,0,23,凱基-林口,2023-10-16,9257
9950,萬國通,22,0,22,凱基-林口,2023-10-16,9257
1605,華新,38,17,21,凱基-林口,2023-10-16,9257
2323,中環,20,0,20,凱基-林口,2023-10-16,9257
9907,統一實,20,0,20,凱基-林口,2023-10-16,9257
6538,倉和,16,0,16,凱基-林口,2023-10-16,9257
00932,兆豐永續高息等權,17,4,13,凱基-林口,2023-10-16,9257
6120,達運,13,0,13,凱基-林口,2023-10-16,9257
8271,宇瞻,13,0,13,凱基-林口,2023-10-16,9257
00642U,期元大S＆P石油,11,0,11,凱基-林口,2023-10-16,9257
3287,廣寰科,11,0,11,凱基-林口,2023-10-16,9257
1815,富喬,11,0,11,凱基-林口,2023-10-16,9257
2382,廣達,15,5,10,凱基-林口,2023-10-16,9257
00637L,元大滬深300正2,10,0,10,凱基-林口,2023-10-16,9257
2305,全友,10,0,10,凱基-林口,2023-10-16,9257
2363,矽統,228,218,10,凱基-林口,2023-10-16,9257
2838,聯邦銀,10,0,10,凱基-林口,2023-10-16,9257
5272,笙科,10,0,10,凱基-林口,2023-10-16,9257
5521,工信,10,0,10,凱基-林口,2023-10-16,9257
6118,建達,10,0,10,凱基-林口,2023-10-16,9257
6203,海韻電,10,0,10,凱基-林口,2023-10-16,9257
6282,康舒,10,0,10,凱基-林口,2023-10-16,9257
911868,同方友友-DR,10,0,10,凱基-林口,2023-10-16,9257
00673R,期元大S＆P原油反1,9,0,9,凱基-林口,2023-10-16,9257
2609,陽明,11,2,9,凱基-林口,2023-10-16,9257
2883,凱基金,12,3,9,凱基-林口,2023-10-16,9257
1802,台玻,8,0,8,凱基-林口,2023-10-16,9257
3051,力特,12,4,8,凱基-林口,2023-10-16,9257
4967,十銓,13,5,8,凱基-林口,2023-10-16,9257
8046,南電,7,0,7,凱基-林口,2023-10-16,9257
1609,大亞,7,0,7,凱基-林口,2023-10-16,9257
1904,正隆,8,1,7,凱基-林口,2023-10-16,9257
2457,飛宏,7,0,7,凱基-林口,2023-10-16,9257
2481,強茂,7,0,7,凱基-林口,2023-10-16,9257
4923,力士,7,0,7,凱基-林口,2023-10-16,9257
6244,茂迪,12,5,7,凱基-林口,2023-10-16,9257
00715L,期街口布蘭特正2,6,0,6,凱基-林口,2023-10-16,9257
0056,元大高股息,125,3,122,凱基-林口,2023-10-17,9257
00878,國泰永續高股息,74,0,74,凱基-林口,2023-10-17,9257
5483,中美晶,60,0,60,凱基-林口,2023-10-17,9257
8048,德勝,52,7,45,凱基-林口,2023-10-17,9257
5521,工信,40,0,40,凱基-林口,2023-10-17,9257
00680L,元大美債20正2,57,20,37,凱基-林口,2023-10-17,9257
3207,耀勝,37,0,37,凱基-林口,2023-10-17,9257
5348,正能量智能,30,0,30,凱基-林口,2023-10-17,9257
1815,富喬,28,0,28,凱基-林口,2023-10-17,9257
9950,萬國通,30,5,25,凱基-林口,2023-10-17,9257
3231,緯創,47,24,23,凱基-林口,2023-10-17,9257
00687B,國泰20年美債,21,0,21,凱基-林口,2023-10-17,9257
2888,新光金,20,0,20,凱基-林口,2023-10-17,9257
6163,華電網,20,0,20,凱基-林口,2023-10-17,9257
2312,金寶,15,0,15,凱基-林口,2023-10-17,9257
8038,長園科,15,0,15,凱基-林口,2023-10-17,9257
00679B,元大美債20年,19,4,15,凱基-林口,2023-10-17,9257
3481,群創,15,1,14,凱基-林口,2023-10-17,9257
3094,聯傑,16,4,12,凱基-林口,2023-10-17,9257
00772B,中信高評級公司債,11,0,11,凱基-林口,2023-10-17,9257
00696B,富邦美債20年,10,0,10,凱基-林口,2023-10-17,9257
00637L,元大滬深300正2,10,0,10,凱基-林口,2023-10-17,9257
00720B,元大投資級公司債,10,0,10,凱基-林口,2023-10-17,9257
4979,華星光,43,33,10,凱基-林口,2023-10-17,9257
8093,保銳,10,0,10,凱基-林口,2023-10-17,9257
00922,國泰台灣領袖50,9,0,9,凱基-林口,2023-10-17,9257
6148,驊宏資,10,1,9,凱基-林口,2023-10-17,9257
2356,英業達,13,5,8,凱基-林口,2023-10-17,9257
3715,定穎投控,60,52,8,凱基-林口,2023-10-17,9257
1609,大亞,8,0,8,凱基-林口,2023-10-17,9257
2002,中鋼,15,7,8,凱基-林口,2023-10-17,9257
2425,承啟,14,6,8,凱基-林口,2023-10-17,9257
2610,華航,16,9,7,凱基-林口,2023-10-17,9257
3704,合勤控,13,6,7,凱基-林口,2023-10-17,9257
00751B,元大AAA至A公司債,6,0,6,凱基-林口,2023-10-17,9257
3045,台灣大,6,0,6,凱基-林口,2023-10-17,9257
4102,永日,6,0,6,凱基-林口,2023-10-17,9257
6672,騰輝電子-KY,6,0,6,凱基-林口,2023-10-17,9257
6282,康舒,6,0,6,凱基-林口,2023-10-17,9257
00713,元大台灣高息低波,5,0,5,凱基-林口,2023-10-17,9257
1471,首利,5,0,5,凱基-林口,2023-10-17,9257
1905,華紙,5,0,5,凱基-林口,2023-10-17,9257
2236,百達-KY,5,0,5,凱基-林口,2023-10-17,9257
2314,台揚,5,0,5,凱基-林口,2023-10-17,9257
3055,蔚華科,5,0,5,凱基-林口,2023-10-17,9257
3491,昇達科,6,1,5,凱基-林口,2023-10-17,9257
8182,加高,5,0,5,凱基-林口,2023-10-17,9257
2301,光寶科,10,5,5,凱基-林口,2023-10-17,9257
1513,中興電,8,4,4,凱基-林口,2023-10-17,9257
2838,聯邦銀,4,0,4,凱基-林口,2023-10-17,9257
1316,上曜,233,24,209,凱基-林口,2023-10-18,9257
00878,國泰永續高股息,153,5,148,凱基-林口,2023-10-18,9257
0056,元大高股息,153,7,146,凱基-林口,2023-10-18,9257
5439,高技,99,1,98,凱基-林口,2023-10-18,9257
00922,國泰台灣領袖50,86,0,86,凱基-林口,2023-10-18,9257
00929,復華台灣科技優息,86,0,86,凱基-林口,2023-10-18,9257
2388,威盛,88,12,76,凱基-林口,2023-10-18,9257
8054,安國,59,2,57,凱基-林口,2023-10-18,9257
00720B,元大投資級公司債,53,1,52,凱基-林口,2023-10-18,9257
2405,輔信,30,0,30,凱基-林口,2023-10-18,9257
00919,群益台灣精選高息,31,3,28,凱基-林口,2023-10-18,9257
3545,敦泰,26,2,24,凱基-林口,2023-10-18,9257
00751B,元大AAA至A公司債,21,0,21,凱基-林口,2023-10-18,9257
2317,鴻海,24,3,21,凱基-林口,2023-10-18,9257
00673R,期元大S＆P原油反1,41,21,20,凱基-林口,2023-10-18,9257
2838,聯邦銀,20,0,20,凱基-林口,2023-10-18,9257
5498,凱崴,20,0,20,凱基-林口,2023-10-18,9257
2313,華通,29,13,16,凱基-林口,2023-10-18,9257
5258,虹堡,17,1,16,凱基-林口,2023-10-18,9257
1513,中興電,16,1,15,凱基-林口,2023-10-18,9257
3715,定穎投控,61,46,15,凱基-林口,2023-10-18,9257
6282,康舒,16,1,15,凱基-林口,2023-10-18,9257
9928,中視,15,0,15,凱基-林口,2023-10-18,9257
3035,智原,46,32,14,凱基-林口,2023-10-18,9257
2883,凱基金,14,0,14,凱基-林口,2023-10-18,9257
5425,台半,13,0,13,凱基-林口,2023-10-18,9257
2465,麗臺,12,0,12,凱基-林口,2023-10-18,9257
00902,中信電池及儲能,12,0,12,凱基-林口,2023-10-18,9257
2618,長榮航,30,19,11,凱基-林口,2023-10-18,9257
2027,大成鋼,11,0,11,凱基-林口,2023-10-18,9257
2328,廣宇,11,0,11,凱基-林口,2023-10-18,9257
8271,宇瞻,11,0,11,凱基-林口,2023-10-18,9257
00680L,元大美債20正2,10,0,10,凱基-林口,2023-10-18,9257
2458,義隆,10,0,10,凱基-林口,2023-10-18,9257
3207,耀勝,11,1,10,凱基-林口,2023-10-18,9257
5324,士開,10,0,10,凱基-林口,2023-10-18,9257
9945,潤泰新,10,0,10,凱基-林口,2023-10-18,9257
1101,台泥,10,0,10,凱基-林口,2023-10-18,9257
4960,誠美材,30,20,10,凱基-林口,2023-10-18,9257
00900,富邦特選高股息30,14,5,9,凱基-林口,2023-10-18,9257
00885,富邦越南,10,1,9,凱基-林口,2023-10-18,9257
2515,中工,10,1,9,凱基-林口,2023-10-18,9257
5215,科嘉-KY,10,1,9,凱基-林口,2023-10-18,9257
5521,工信,10,1,9,凱基-林口,2023-10-18,9257
9955,佳龍,25,16,9,凱基-林口,2023-10-18,9257
9105,泰金寶-DR,9,0,9,凱基-林口,2023-10-18,9257
2457,飛宏,8,0,8,凱基-林口,2023-10-18,9257
2352,佳世達,10,3,7,凱基-林口,2023-10-18,9257
2603,長榮,7,0,7,凱基-林口,2023-10-18,9257
2330,台積電,6,0,6,凱基-林口,2023-10-18,9257
00637L,元大滬深300正2,105,0,105,凱基-林口,2023-10-19,9257
0056,元大高股息,83,2,81,凱基-林口,2023-10-19,9257
6530,創威,128,52,76,凱基-林口,2023-10-19,9257
00751B,元大AAA至A公司債,73,0,73,凱基-林口,2023-10-19,9257
00687B,國泰20年美債,71,1,70,凱基-林口,2023-10-19,9257
2883,凱基金,63,0,63,凱基-林口,2023-10-19,9257
2317,鴻海,57,2,55,凱基-林口,2023-10-19,9257
4102,永日,54,0,54,凱基-林口,2023-10-19,9257
2449,京元電子,63,10,53,凱基-林口,2023-10-19,9257
2363,矽統,51,4,47,凱基-林口,2023-10-19,9257
00933B,國泰10Y+金融債,45,0,45,凱基-林口,2023-10-19,9257
5426,振發,40,0,40,凱基-林口,2023-10-19,9257
00929,復華台灣科技優息,36,6,30,凱基-林口,2023-10-19,9257
6118,建達,30,0,30,凱基-林口,2023-10-19,9257
00922,國泰台灣領袖50,26,0,26,凱基-林口,2023-10-19,9257
1101,台泥,31,6,25,凱基-林口,2023-10-19,9257
8210,勤誠,29,5,24,凱基-林口,2023-10-19,9257
9929,秋雨,130,107,23,凱基-林口,2023-10-19,9257
3035,智原,86,64,22,凱基-林口,2023-10-19,9257
1210,大成,20,0,20,凱基-林口,2023-10-19,9257
6116,彩晶,20,0,20,凱基-林口,2023-10-19,9257
00680L,元大美債20正2,17,0,17,凱基-林口,2023-10-19,9257
3481,群創,20,4,16,凱基-林口,2023-10-19,9257
00919,群益台灣精選高息,15,0,15,凱基-林口,2023-10-19,9257
2888,新光金,15,0,15,凱基-林口,2023-10-19,9257
2618,長榮航,15,0,15,凱基-林口,2023-10-19,9257
00712,復華富時不動產,14,0,14,凱基-林口,2023-10-19,9257
2457,飛宏,15,3,12,凱基-林口,2023-10-19,9257
3041,揚智,20,8,12,凱基-林口,2023-10-19,9257
6588,東典光電,12,0,12,凱基-林口,2023-10-19,9257
1513,中興電,11,0,11,凱基-林口,2023-10-19,9257
00885,富邦越南,11,0,11,凱基-林口,2023-10-19,9257
2816,旺旺保,11,0,11,凱基-林口,2023-10-19,9257
3013,晟銘電,11,0,11,凱基-林口,2023-10-19,9257
00931B,統一美債20年,10,0,10,凱基-林口,2023-10-19,9257
00720B,元大投資級公司債,10,0,10,凱基-林口,2023-10-19,9257
2891,中信金,11,1,10,凱基-林口,2023-10-19,9257
2356,英業達,14,4,10,凱基-林口,2023-10-19,9257
00673R,期元大S＆P原油反1,10,0,10,凱基-林口,2023-10-19,9257
00715L,期街口布蘭特正2,10,0,10,凱基-林口,2023-10-19,9257
1514,亞力,10,0,10,凱基-林口,2023-10-19,9257
4128,中天,10,0,10,凱基-林口,2023-10-19,9257
6203,海韻電,10,0,10,凱基-林口,2023-10-19,9257
8358,金居,10,0,10,凱基-林口,2023-10-19,9257
00893,國泰智能電動車,9,0,9,凱基-林口,2023-10-19,9257
3231,緯創,26,17,9,凱基-林口,2023-10-19,9257
2465,麗臺,9,0,9,凱基-林口,2023-10-19,9257
3025,星通,11,2,9,凱基-林口,2023-10-19,9257
3105,穩懋,8,0,8,凱基-林口,2023-10-19,9257
00902,中信電池及儲能,8,0,8,凱基-林口,2023-10-19,9257
2344,華邦電,201,0,201,凱基-林口,2023-10-20,9257
3287,廣寰科,143,2,141,凱基-林口,2023-10-20,9257
2883,凱基金,106,2,104,凱基-林口,2023-10-20,9257
2888,新光金,88,0,88,凱基-林口,2023-10-20,9257
2402,毅嘉,77,9,68,凱基-林口,2023-10-20,9257
00878,國泰永續高股息,71,6,65,凱基-林口,2023-10-20,9257
5531,鄉林,63,2,61,凱基-林口,2023-10-20,9257
00712,復華富時不動產,46,0,46,凱基-林口,2023-10-20,9257
00919,群益台灣精選高息,39,0,39,凱基-林口,2023-10-20,9257
0056,元大高股息,39,2,37,凱基-林口,2023-10-20,9257
00751B,元大AAA至A公司債,33,0,33,凱基-林口,2023-10-20,9257
00929,復華台灣科技優息,33,3,30,凱基-林口,2023-10-20,9257
2618,長榮航,27,0,27,凱基-林口,2023-10-20,9257
6216,居易,26,0,26,凱基-林口,2023-10-20,9257
1785,光洋科,26,1,25,凱基-林口,2023-10-20,9257
2363,矽統,34,11,23,凱基-林口,2023-10-20,9257
4167,松瑞藥,21,0,21,凱基-林口,2023-10-20,9257
6237,驊訊,21,0,21,凱基-林口,2023-10-20,9257
00673R,期元大S＆P原油反1,20,0,20,凱基-林口,2023-10-20,9257
1536,和大,20,0,20,凱基-林口,2023-10-20,9257
3481,群創,20,0,20,凱基-林口,2023-10-20,9257
00679B,元大美債20年,21,3,18,凱基-林口,2023-10-20,9257
1514,亞力,17,0,17,凱基-林口,2023-10-20,9257
2303,聯電,108,92,16,凱基-林口,2023-10-20,9257
3041,揚智,33,17,16,凱基-林口,2023-10-20,9257
3374,精材,17,1,16,凱基-林口,2023-10-20,9257
3035,智原,46,30,16,凱基-林口,2023-10-20,9257
1560,中砂,19,3,16,凱基-林口,2023-10-20,9257
2002,中鋼,21,5,16,凱基-林口,2023-10-20,9257
2382,廣達,42,26,16,凱基-林口,2023-10-20,9257
3363,上詮,15,0,15,凱基-林口,2023-10-20,9257
6770,力積電,15,0,15,凱基-林口,2023-10-20,9257
00687B,國泰20年美債,14,0,14,凱基-林口,2023-10-20,9257
00773B,中信優先金融債,14,0,14,凱基-林口,2023-10-20,9257
4967,十銓,20,7,13,凱基-林口,2023-10-20,9257
6163,華電網,12,0,12,凱基-林口,2023-10-20,9257
3231,緯創,24,12,12,凱基-林口,2023-10-20,9257
00881,國泰台灣5G+,11,0,11,凱基-林口,2023-10-20,9257
6197,佳必琪,10,0,10,凱基-林口,2023-10-20,9257
00713,元大台灣高息低波,10,0,10,凱基-林口,2023-10-20,9257
2457,飛宏,10,0,10,凱基-林口,2023-10-20,9257
00637L,元大滬深300正2,10,0,10,凱基-林口,2023-10-20,9257
1444,力麗,10,0,10,凱基-林口,2023-10-20,9257
3596,智易,10,0,10,凱基-林口,2023-10-20,9257
4944,兆遠,10,0,10,凱基-林口,2023-10-20,9257
5355,佳總,10,0,10,凱基-林口,2023-10-20,9257
6213,聯茂,12,2,10,凱基-林口,2023-10-20,9257
3105,穩懋,9,0,9,凱基-林口,2023-10-20,9257
00892,富邦台灣半導體,10,2,8,凱基-林口,2023-10-20,9257
2323,中環,8,0,8,凱基-林口,2023-10-20,9257
2402,毅嘉,194,11,183,凱基-林口,2023-10-23,9257
2888,新光金,116,0,116,凱基-林口,2023-10-23,9257
2883,凱基金,82,0,82,凱基-林口,2023-10-23,9257
00919,群益台灣精選高息,58,0,58,凱基-林口,2023-10-23,9257
2317,鴻海,48,5,43,凱基-林口,2023-10-23,9257
00679B,元大美債20年,34,0,34,凱基-林口,2023-10-23,9257
2449,京元電子,39,7,32,凱基-林口,2023-10-23,9257
2409,友達,29,2,27,凱基-林口,2023-10-23,9257
00878,國泰永續高股息,33,7,26,凱基-林口,2023-10-23,9257
3596,智易,24,1,23,凱基-林口,2023-10-23,9257
3481,群創,30,7,23,凱基-林口,2023-10-23,9257
00922,國泰台灣領袖50,22,0,22,凱基-林口,2023-10-23,9257
00637L,元大滬深300正2,25,3,22,凱基-林口,2023-10-23,9257
2329,華泰,25,3,22,凱基-林口,2023-10-23,9257
0056,元大高股息,33,11,22,凱基-林口,2023-10-23,9257
4944,兆遠,30,10,20,凱基-林口,2023-10-23,9257
5521,工信,28,8,20,凱基-林口,2023-10-23,9257
00929,復華台灣科技優息,44,25,19,凱基-林口,2023-10-23,9257
6216,居易,19,0,19,凱基-林口,2023-10-23,9257
00772B,中信高評級公司債,17,0,17,凱基-林口,2023-10-23,9257
2516,新建,18,4,14,凱基-林口,2023-10-23,9257
3035,智原,29,15,14,凱基-林口,2023-10-23,9257
00751B,元大AAA至A公司債,13,0,13,凱基-林口,2023-10-23,9257
3325,旭品,14,1,13,凱基-林口,2023-10-23,9257
8024,佑華,23,10,13,凱基-林口,2023-10-23,9257
1101,台泥,12,0,12,凱基-林口,2023-10-23,9257
2610,華航,12,0,12,凱基-林口,2023-10-23,9257
3032,偉訓,11,1,10,凱基-林口,2023-10-23,9257
2504,國產,10,0,10,凱基-林口,2023-10-23,9257
00918,大華優利高填息30,10,0,10,凱基-林口,2023-10-23,9257
2211,長榮鋼,10,0,10,凱基-林口,2023-10-23,9257
3617,碩天,10,0,10,凱基-林口,2023-10-23,9257
4908,前鼎,16,6,10,凱基-林口,2023-10-23,9257
6237,驊訊,24,14,10,凱基-林口,2023-10-23,9257
6799,來頡,10,0,10,凱基-林口,2023-10-23,9257
3376,新日興,9,0,9,凱基-林口,2023-10-23,9257
2382,廣達,12,3,9,凱基-林口,2023-10-23,9257
00720B,元大投資級公司債,8,0,8,凱基-林口,2023-10-23,9257
1785,光洋科,8,0,8,凱基-林口,2023-10-23,9257
2356,英業達,22,14,8,凱基-林口,2023-10-23,9257
2891,中信金,7,0,7,凱基-林口,2023-10-23,9257
00931B,統一美債20年,7,0,7,凱基-林口,2023-10-23,9257
2606,裕民,8,1,7,凱基-林口,2023-10-23,9257
00932,兆豐永續高息等權,6,0,6,凱基-林口,2023-10-23,9257
00715L,期街口布蘭特正2,10,4,6,凱基-林口,2023-10-23,9257
1326,台化,6,0,6,凱基-林口,2023-10-23,9257
2338,光罩,7,1,6,凱基-林口,2023-10-23,9257
2609,陽明,6,0,6,凱基-林口,2023-10-23,9257
0050,元大台灣50,6,0,6,凱基-林口,2023-10-23,9257
3231,緯創,12,7,5,凱基-林口,2023-10-23,9257
2816,旺旺保,60,0,60,凱基-林口,2023-10-24,9257
00878,國泰永續高股息,51,3,48,凱基-林口,2023-10-24,9257
00712,復華富時不動產,43,0,43,凱基-林口,2023-10-24,9257
2883,凱基金,42,0,42,凱基-林口,2023-10-24,9257
00929,復華台灣科技優息,50,10,40,凱基-林口,2023-10-24,9257
9950,萬國通,48,10,38,凱基-林口,2023-10-24,9257
00637L,元大滬深300正2,37,0,37,凱基-林口,2023-10-24,9257
6216,居易,32,0,32,凱基-林口,2023-10-24,9257
3706,神達,32,4,28,凱基-林口,2023-10-24,9257
00919,群益台灣精選高息,27,2,25,凱基-林口,2023-10-24,9257
3260,威剛,30,6,24,凱基-林口,2023-10-24,9257
1609,大亞,20,0,20,凱基-林口,2023-10-24,9257
2303,聯電,23,3,20,凱基-林口,2023-10-24,9257
2890,永豐金,20,1,19,凱基-林口,2023-10-24,9257
3035,智原,75,57,18,凱基-林口,2023-10-24,9257
3596,智易,15,0,15,凱基-林口,2023-10-24,9257
00687B,國泰20年美債,16,2,14,凱基-林口,2023-10-24,9257
6150,撼訊,15,2,13,凱基-林口,2023-10-24,9257
3372,典範,12,0,12,凱基-林口,2023-10-24,9257
3522,御嵿,12,0,12,凱基-林口,2023-10-24,9257
5871,中租-KY,11,0,11,凱基-林口,2023-10-24,9257
00918,大華優利高填息30,11,0,11,凱基-林口,2023-10-24,9257
1560,中砂,11,0,11,凱基-林口,2023-10-24,9257
3231,緯創,44,34,10,凱基-林口,2023-10-24,9257
1612,宏泰,10,0,10,凱基-林口,2023-10-24,9257
3045,台灣大,10,0,10,凱基-林口,2023-10-24,9257
3481,群創,10,0,10,凱基-林口,2023-10-24,9257
5522,遠雄,10,0,10,凱基-林口,2023-10-24,9257
6414,樺漢,10,0,10,凱基-林口,2023-10-24,9257
5009,榮剛,9,0,9,凱基-林口,2023-10-24,9257
5381,合正,12,3,9,凱基-林口,2023-10-24,9257
00680L,元大美債20正2,10,2,8,凱基-林口,2023-10-24,9257
1303,南亞,8,0,8,凱基-林口,2023-10-24,9257
1301,台塑,8,0,8,凱基-林口,2023-10-24,9257
2745,五福,8,0,8,凱基-林口,2023-10-24,9257
3163,波若威,21,13,8,凱基-林口,2023-10-24,9257
2352,佳世達,9,2,7,凱基-林口,2023-10-24,9257
2489,瑞軒,7,0,7,凱基-林口,2023-10-24,9257
2630,亞航,7,0,7,凱基-林口,2023-10-24,9257
1101,台泥,6,0,6,凱基-林口,2023-10-24,9257
4967,十銓,6,0,6,凱基-林口,2023-10-24,9257
3715,定穎投控,23,17,6,凱基-林口,2023-10-24,9257
0050,元大台灣50,5,0,5,凱基-林口,2023-10-24,9257
8069,元太,6,1,5,凱基-林口,2023-10-24,9257
2330,台積電,5,0,5,凱基-林口,2023-10-24,9257
00715L,期街口布蘭特正2,12,7,5,凱基-林口,2023-10-24,9257
1603,華電,9,4,5,凱基-林口,2023-10-24,9257
1721,三晃,6,1,5,凱基-林口,2023-10-24,9257
2023,燁輝,5,0,5,凱基-林口,2023-10-24,9257
2637,慧洋-KY,5,0,5,凱基-林口,2023-10-24,9257
00712,復華富時不動產,61,0,61,凱基-林口,2023-10-25,9257
3694,海華,61,0,61,凱基-林口,2023-10-25,9257
00687B,國泰20年美債,32,2,30,凱基-林口,2023-10-25,9257
2324,仁寶,30,0,30,凱基-林口,2023-10-25,9257
00680L,元大美債20正2,30,2,28,凱基-林口,2023-10-25,9257
3044,健鼎,38,11,27,凱基-林口,2023-10-25,9257
9105,泰金寶-DR,21,0,21,凱基-林口,2023-10-25,9257
00632R,元大台灣50反1,19,0,19,凱基-林口,2023-10-25,9257
00753L,中信中國50正2,20,2,18,凱基-林口,2023-10-25,9257
8215,明基材,20,2,18,凱基-林口,2023-10-25,9257
2329,華泰,17,0,17,凱基-林口,2023-10-25,9257
00662,富邦NASDAQ,17,0,17,凱基-林口,2023-10-25,9257
3706,神達,20,3,17,凱基-林口,2023-10-25,9257
4960,誠美材,20,3,17,凱基-林口,2023-10-25,9257
6274,台燿,28,14,14,凱基-林口,2023-10-25,9257
2543,皇昌,13,0,13,凱基-林口,2023-10-25,9257
2838,聯邦銀,16,3,13,凱基-林口,2023-10-25,9257
1303,南亞,12,0,12,凱基-林口,2023-10-25,9257
2409,友達,20,10,10,凱基-林口,2023-10-25,9257
1210,大成,10,0,10,凱基-林口,2023-10-25,9257
1612,宏泰,15,5,10,凱基-林口,2023-10-25,9257
2002,中鋼,11,1,10,凱基-林口,2023-10-25,9257
2371,大同,10,0,10,凱基-林口,2023-10-25,9257
2610,華航,16,6,10,凱基-林口,2023-10-25,9257
3023,信邦,10,0,10,凱基-林口,2023-10-25,9257
6191,精成科,10,0,10,凱基-林口,2023-10-25,9257
6418,詠昇,10,0,10,凱基-林口,2023-10-25,9257
9802,鈺齊-KY,10,0,10,凱基-林口,2023-10-25,9257
9950,萬國通,10,0,10,凱基-林口,2023-10-25,9257
8358,金居,10,0,10,凱基-林口,2023-10-25,9257
00933B,國泰10Y+金融債,10,0,10,凱基-林口,2023-10-25,9257
4105,東洋,10,0,10,凱基-林口,2023-10-25,9257
2337,旺宏,10,0,10,凱基-林口,2023-10-25,9257
2882,國泰金,10,1,9,凱基-林口,2023-10-25,9257
3363,上詮,16,8,8,凱基-林口,2023-10-25,9257
5215,科嘉-KY,8,0,8,凱基-林口,2023-10-25,9257
00878,國泰永續高股息,11,3,8,凱基-林口,2023-10-25,9257
2462,良得電,7,0,7,凱基-林口,2023-10-25,9257
4162,智擎,31,24,7,凱基-林口,2023-10-25,9257
4923,力士,7,0,7,凱基-林口,2023-10-25,9257
1514,亞力,8,2,6,凱基-林口,2023-10-25,9257
1603,華電,11,5,6,凱基-林口,2023-10-25,9257
2369,菱生,26,20,6,凱基-林口,2023-10-25,9257
8096,擎亞,6,0,6,凱基-林口,2023-10-25,9257
4967,十銓,6,0,6,凱基-林口,2023-10-25,9257
2888,新光金,5,0,5,凱基-林口,2023-10-25,9257
3037,欣興,8,3,5,凱基-林口,2023-10-25,9257
2884,玉山金,6,1,5,凱基-林口,2023-10-25,9257
2645,長榮航太,5,0,5,凱基-林口,2023-10-25,9257
1219,福壽,5,0,5,凱基-林口,2023-10-25,9257
2888,新光金,206,0,206,凱基-林口,2023-10-26,9257
00687B,國泰20年美債,111,0,111,凱基-林口,2023-10-26,9257
6109,亞元,99,2,97,凱基-林口,2023-10-26,9257
00929,復華台灣科技優息,92,1,91,凱基-林口,2023-10-26,9257
2883,凱基金,80,0,80,凱基-林口,2023-10-26,9257
00712,復華富時不動產,67,0,67,凱基-林口,2023-10-26,9257
00919,群益台灣精選高息,55,1,54,凱基-林口,2023-10-26,9257
0050,元大台灣50,52,0,52,凱基-林口,2023-10-26,9257
00878,國泰永續高股息,44,0,44,凱基-林口,2023-10-26,9257
0056,元大高股息,67,30,37,凱基-林口,2023-10-26,9257
6133,金橋,35,0,35,凱基-林口,2023-10-26,9257
2303,聯電,35,9,26,凱基-林口,2023-10-26,9257
8088,品安,21,0,21,凱基-林口,2023-10-26,9257
3035,智原,24,4,20,凱基-林口,2023-10-26,9257
6829,千附精密,22,2,20,凱基-林口,2023-10-26,9257
00893,國泰智能電動車,21,2,19,凱基-林口,2023-10-26,9257
2344,華邦電,19,4,15,凱基-林口,2023-10-26,9257
00637L,元大滬深300正2,15,0,15,凱基-林口,2023-10-26,9257
5483,中美晶,15,0,15,凱基-林口,2023-10-26,9257
6118,建達,15,0,15,凱基-林口,2023-10-26,9257
2330,台積電,14,0,14,凱基-林口,2023-10-26,9257
00900,富邦特選高股息30,13,0,13,凱基-林口,2023-10-26,9257
2887,台新金,14,1,13,凱基-林口,2023-10-26,9257
8936,國統,34,21,13,凱基-林口,2023-10-26,9257
6274,台燿,20,8,12,凱基-林口,2023-10-26,9257
3037,欣興,13,1,12,凱基-林口,2023-10-26,9257
00922,國泰台灣領袖50,12,0,12,凱基-林口,2023-10-26,9257
00679B,元大美債20年,13,2,11,凱基-林口,2023-10-26,9257
2337,旺宏,15,4,11,凱基-林口,2023-10-26,9257
2356,英業達,12,1,11,凱基-林口,2023-10-26,9257
00918,大華優利高填息30,10,0,10,凱基-林口,2023-10-26,9257
1528,恩德,10,0,10,凱基-林口,2023-10-26,9257
1721,三晃,14,4,10,凱基-林口,2023-10-26,9257
2838,聯邦銀,10,0,10,凱基-林口,2023-10-26,9257
3176,基亞,10,0,10,凱基-林口,2023-10-26,9257
5340,建榮,10,0,10,凱基-林口,2023-10-26,9257
2834,臺企銀,10,1,9,凱基-林口,2023-10-26,9257
2363,矽統,13,4,9,凱基-林口,2023-10-26,9257
2485,兆赫,10,1,9,凱基-林口,2023-10-26,9257
3481,群創,10,1,9,凱基-林口,2023-10-26,9257
6664,群翊,9,0,9,凱基-林口,2023-10-26,9257
3105,穩懋,8,0,8,凱基-林口,2023-10-26,9257
8046,南電,8,0,8,凱基-林口,2023-10-26,9257
2886,兆豐金,9,1,8,凱基-林口,2023-10-26,9257
00885,富邦越南,7,0,7,凱基-林口,2023-10-26,9257
1301,台塑,7,0,7,凱基-林口,2023-10-26,9257
3511,矽瑪,7,0,7,凱基-林口,2023-10-26,9257
6216,居易,7,0,7,凱基-林口,2023-10-26,9257
8110,華東,7,0,7,凱基-林口,2023-10-26,9257
1434,福懋,6,0,6,凱基-林口,2023-10-26,9257
2323,中環,60,0,60,凱基-林口,2023-10-27,9257
00929,復華台灣科技優息,58,0,58,凱基-林口,2023-10-27,9257
2888,新光金,55,0,55,凱基-林口,2023-10-27,9257
1609,大亞,35,0,35,凱基-林口,2023-10-27,9257
2486,一詮,30,0,30,凱基-林口,2023-10-27,9257
6109,亞元,30,2,28,凱基-林口,2023-10-27,9257
4105,東洋,30,4,26,凱基-林口,2023-10-27,9257
2618,長榮航,26,4,22,凱基-林口,2023-10-27,9257
00680L,元大美債20正2,20,0,20,凱基-林口,2023-10-27,9257
00671R,富邦NASDAQ反1,20,0,20,凱基-林口,2023-10-27,9257
2641,正德,29,9,20,凱基-林口,2023-10-27,9257
00919,群益台灣精選高息,19,0,19,凱基-林口,2023-10-27,9257
2838,聯邦銀,18,0,18,凱基-林口,2023-10-27,9257
2363,矽統,17,2,15,凱基-林口,2023-10-27,9257
00712,復華富時不動產,15,0,15,凱基-林口,2023-10-27,9257
1210,大成,13,0,13,凱基-林口,2023-10-27,9257
3051,力特,13,0,13,凱基-林口,2023-10-27,9257
2409,友達,12,0,12,凱基-林口,2023-10-27,9257
6146,耕興,15,4,11,凱基-林口,2023-10-27,9257
2388,威盛,69,58,11,凱基-林口,2023-10-27,9257
2408,南亞科,10,0,10,凱基-林口,2023-10-27,9257
8358,金居,10,0,10,凱基-林口,2023-10-27,9257
1560,中砂,10,0,10,凱基-林口,2023-10-27,9257
2424,隴華,10,0,10,凱基-林口,2023-10-27,9257
2731,雄獅,10,0,10,凱基-林口,2023-10-27,9257
6799,來頡,10,0,10,凱基-林口,2023-10-27,9257
8049,晶采,10,0,10,凱基-林口,2023-10-27,9257
2369,菱生,25,15,10,凱基-林口,2023-10-27,9257
4707,磐亞,9,0,9,凱基-林口,2023-10-27,9257
4908,前鼎,12,4,8,凱基-林口,2023-10-27,9257
4967,十銓,8,0,8,凱基-林口,2023-10-27,9257
5009,榮剛,28,20,8,凱基-林口,2023-10-27,9257
5258,虹堡,23,15,8,凱基-林口,2023-10-27,9257
6593,台灣銘板,8,0,8,凱基-林口,2023-10-27,9257
8088,品安,8,0,8,凱基-林口,2023-10-27,9257
2303,聯電,19,12,7,凱基-林口,2023-10-27,9257
3044,健鼎,8,1,7,凱基-林口,2023-10-27,9257
00713,元大台灣高息低波,7,0,7,凱基-林口,2023-10-27,9257
2364,倫飛,7,0,7,凱基-林口,2023-10-27,9257
2630,亞航,12,5,7,凱基-林口,2023-10-27,9257
00632R,元大台灣50反1,16,10,6,凱基-林口,2023-10-27,9257
2329,華泰,43,37,6,凱基-林口,2023-10-27,9257
2606,裕民,7,1,6,凱基-林口,2023-10-27,9257
3308,聯德,6,0,6,凱基-林口,2023-10-27,9257
3491,昇達科,9,3,6,凱基-林口,2023-10-27,9257
3653,健策,6,0,6,凱基-林口,2023-10-27,9257
6190,萬泰科,6,0,6,凱基-林口,2023-10-27,9257
6418,詠昇,6,0,6,凱基-林口,2023-10-27,9257
6257,矽格,6,1,5,凱基-林口,2023-10-27,9257
0051,元大中型100,5,0,5,凱基-林口,2023-10-27,9257
00633L,富邦上証正2,105,0,105,凱基-林口,2023-10-30,9257
2888,新光金,93,0,93,凱基-林口,2023-10-30,9257
00712,復華富時不動產,88,0,88,凱基-林口,2023-10-30,9257
2618,長榮航,65,0,65,凱基-林口,2023-10-30,9257
2317,鴻海,63,7,56,凱基-林口,2023-10-30,9257
2332,友訊,53,0,53,凱基-林口,2023-10-30,9257
00715L,期街口布蘭特正2,50,3,47,凱基-林口,2023-10-30,9257
3035,智原,42,4,38,凱基-林口,2023-10-30,9257
00929,復華台灣科技優息,26,2,24,凱基-林口,2023-10-30,9257
1524,耿鼎,25,1,24,凱基-林口,2023-10-30,9257
2417,圓剛,17,0,17,凱基-林口,2023-10-30,9257
1514,亞力,15,0,15,凱基-林口,2023-10-30,9257
3287,廣寰科,20,5,15,凱基-林口,2023-10-30,9257
00933B,國泰10Y+金融債,12,0,12,凱基-林口,2023-10-30,9257
3122,笙泉,17,5,12,凱基-林口,2023-10-30,9257
6117,迎廣,16,4,12,凱基-林口,2023-10-30,9257
2610,華航,12,1,11,凱基-林口,2023-10-30,9257
6216,居易,12,1,11,凱基-林口,2023-10-30,9257
6244,茂迪,12,1,11,凱基-林口,2023-10-30,9257
2303,聯電,10,0,10,凱基-林口,2023-10-30,9257
1305,華夏,10,0,10,凱基-林口,2023-10-30,9257
1710,東聯,10,0,10,凱基-林口,2023-10-30,9257
1711,永光,10,0,10,凱基-林口,2023-10-30,9257
2025,千興,10,0,10,凱基-林口,2023-10-30,9257
2404,漢唐,10,0,10,凱基-林口,2023-10-30,9257
2543,皇昌,10,0,10,凱基-林口,2023-10-30,9257
2641,正德,10,0,10,凱基-林口,2023-10-30,9257
3045,台灣大,10,0,10,凱基-林口,2023-10-30,9257
5324,士開,10,0,10,凱基-林口,2023-10-30,9257
8049,晶采,10,0,10,凱基-林口,2023-10-30,9257
2356,英業達,12,3,9,凱基-林口,2023-10-30,9257
8054,安國,42,33,9,凱基-林口,2023-10-30,9257
2337,旺宏,9,1,8,凱基-林口,2023-10-30,9257
2883,凱基金,47,39,8,凱基-林口,2023-10-30,9257
00713,元大台灣高息低波,8,0,8,凱基-林口,2023-10-30,9257
3363,上詮,8,0,8,凱基-林口,2023-10-30,9257
00878,國泰永續高股息,18,11,7,凱基-林口,2023-10-30,9257
2891,中信金,6,0,6,凱基-林口,2023-10-30,9257
1513,中興電,10,4,6,凱基-林口,2023-10-30,9257
00902,中信電池及儲能,6,0,6,凱基-林口,2023-10-30,9257
2331,精英,6,0,6,凱基-林口,2023-10-30,9257
3207,耀勝,6,0,6,凱基-林口,2023-10-30,9257
3236,千如,6,0,6,凱基-林口,2023-10-30,9257
3260,威剛,18,12,6,凱基-林口,2023-10-30,9257
2353,宏��,5,0,5,凱基-林口,2023-10-30,9257
2504,國產,5,0,5,凱基-林口,2023-10-30,9257
2457,飛宏,6,1,5,凱基-林口,2023-10-30,9257
2885,元大金,5,0,5,凱基-林口,2023-10-30,9257
2886,兆豐金,5,0,5,凱基-林口,2023-10-30,9257
3454,晶睿,5,0,5,凱基-林口,2023-10-30,9257
2610,華航,110,21,89,凱基-林口,2023-10-31,9257
2641,正德,60,0,60,凱基-林口,2023-10-31,9257
2332,友訊,49,0,49,凱基-林口,2023-10-31,9257
00878,國泰永續高股息,47,0,47,凱基-林口,2023-10-31,9257
00715L,期街口布蘭特正2,52,6,46,凱基-林口,2023-10-31,9257
00687B,國泰20年美債,37,0,37,凱基-林口,2023-10-31,9257
3706,神達,33,1,32,凱基-林口,2023-10-31,9257
00929,復華台灣科技優息,68,41,27,凱基-林口,2023-10-31,9257
00919,群益台灣精選高息,27,0,27,凱基-林口,2023-10-31,9257
3707,漢磊,25,0,25,凱基-林口,2023-10-31,9257
0056,元大高股息,51,28,23,凱基-林口,2023-10-31,9257
00679B,元大美債20年,21,0,21,凱基-林口,2023-10-31,9257
2382,廣達,37,16,21,凱基-林口,2023-10-31,9257
3715,定穎投控,44,24,20,凱基-林口,2023-10-31,9257
2888,新光金,20,0,20,凱基-林口,2023-10-31,9257
3033,威健,20,0,20,凱基-林口,2023-10-31,9257
5439,高技,51,32,19,凱基-林口,2023-10-31,9257
2449,京元電子,19,1,18,凱基-林口,2023-10-31,9257
9950,萬國通,18,0,18,凱基-林口,2023-10-31,9257
3078,僑威,17,1,16,凱基-林口,2023-10-31,9257
1618,合機,15,0,15,凱基-林口,2023-10-31,9257
6274,台燿,15,1,14,凱基-林口,2023-10-31,9257
3576,聯合再生,15,2,13,凱基-林口,2023-10-31,9257
2337,旺宏,13,0,13,凱基-林口,2023-10-31,9257
2352,佳世達,13,1,12,凱基-林口,2023-10-31,9257
8358,金居,12,0,12,凱基-林口,2023-10-31,9257
1909,榮成,11,0,11,凱基-林口,2023-10-31,9257
6216,居易,24,13,11,凱基-林口,2023-10-31,9257
9928,中視,11,0,11,凱基-林口,2023-10-31,9257
00632R,元大台灣50反1,10,0,10,凱基-林口,2023-10-31,9257
00680L,元大美債20正2,10,0,10,凱基-林口,2023-10-31,9257
00918,大華優利高填息30,10,0,10,凱基-林口,2023-10-31,9257
00896,中信綠能及電動車,10,0,10,凱基-林口,2023-10-31,9257
2543,皇昌,10,0,10,凱基-林口,2023-10-31,9257
3045,台灣大,10,0,10,凱基-林口,2023-10-31,9257
4707,磐亞,10,0,10,凱基-林口,2023-10-31,9257
6118,建達,10,0,10,凱基-林口,2023-10-31,9257
9962,有益,10,0,10,凱基-林口,2023-10-31,9257
2301,光寶科,13,4,9,凱基-林口,2023-10-31,9257
1513,中興電,9,0,9,凱基-林口,2023-10-31,9257
00885,富邦越南,9,0,9,凱基-林口,2023-10-31,9257
3189,景碩,11,2,9,凱基-林口,2023-10-31,9257
3491,昇達科,31,22,9,凱基-林口,2023-10-31,9257
5258,虹堡,33,24,9,凱基-林口,2023-10-31,9257
8088,品安,9,0,9,凱基-林口,2023-10-31,9257
2338,光罩,10,2,8,凱基-林口,2023-10-31,9257
4961,天鈺,10,2,8,凱基-林口,2023-10-31,9257
8261,富鼎,8,0,8,凱基-林口,2023-10-31,9257
2883,凱基金,9,2,7,凱基-林口,2023-10-31,9257
1314,中石化,10,3,7,凱基-林口,2023-10-31,9257
2618,長榮航,402,37,365,凱基-林口,2023-11-01,9257
2610,華航,316,3,313,凱基-林口,2023-11-01,9257
00679B,元大美債20年,117,4,113,凱基-林口,2023-11-01,9257
00935,野村臺灣新科技50,67,0,67,凱基-林口,2023-11-01,9257
2641,正德,60,0,60,凱基-林口,2023-11-01,9257
2344,華邦電,54,0,54,凱基-林口,2023-11-01,9257
2405,輔信,51,0,51,凱基-林口,2023-11-01,9257
00934,中信成長高股息,41,0,41,凱基-林口,2023-11-01,9257
9950,萬國通,39,0,39,凱基-林口,2023-11-01,9257
00907,永豐優息存股,30,0,30,凱基-林口,2023-11-01,9257
3033,威健,30,0,30,凱基-林口,2023-11-01,9257
2883,凱基金,27,0,27,凱基-林口,2023-11-01,9257
6216,居易,23,0,23,凱基-林口,2023-11-01,9257
00878,國泰永續高股息,27,4,23,凱基-林口,2023-11-01,9257
00687B,國泰20年美債,22,0,22,凱基-林口,2023-11-01,9257
00905,FT臺灣Smart,20,0,20,凱基-林口,2023-11-01,9257
3014,聯陽,20,0,20,凱基-林口,2023-11-01,9257
5439,高技,20,2,18,凱基-林口,2023-11-01,9257
6492,生華科,18,0,18,凱基-林口,2023-11-01,9257
6213,聯茂,20,3,17,凱基-林口,2023-11-01,9257
00933B,國泰10Y+金融債,15,0,15,凱基-林口,2023-11-01,9257
00929,復華台灣科技優息,46,32,14,凱基-林口,2023-11-01,9257
2417,圓剛,26,12,14,凱基-林口,2023-11-01,9257
2516,新建,12,0,12,凱基-林口,2023-11-01,9257
1524,耿鼎,12,1,11,凱基-林口,2023-11-01,9257
00923,群益台ESG低碳50,11,0,11,凱基-林口,2023-11-01,9257
6127,九豪,11,0,11,凱基-林口,2023-11-01,9257
8054,安國,12,1,11,凱基-林口,2023-11-01,9257
2409,友達,11,1,10,凱基-林口,2023-11-01,9257
00795B,中信美國公債20年,10,0,10,凱基-林口,2023-11-01,9257
2809,京城銀,10,0,10,凱基-林口,2023-11-01,9257
4726,永昕,10,0,10,凱基-林口,2023-11-01,9257
6282,康舒,10,0,10,凱基-林口,2023-11-01,9257
6443,元晶,10,0,10,凱基-林口,2023-11-01,9257
8358,金居,10,0,10,凱基-林口,2023-11-01,9257
00751B,元大AAA至A公司債,10,0,10,凱基-林口,2023-11-01,9257
3035,智原,39,30,9,凱基-林口,2023-11-01,9257
2748,雲品,11,2,9,凱基-林口,2023-11-01,9257
6770,力積電,12,3,9,凱基-林口,2023-11-01,9257
2382,廣達,26,18,8,凱基-林口,2023-11-01,9257
00919,群益台灣精選高息,9,2,7,凱基-林口,2023-11-01,9257
3230,錦明,7,0,7,凱基-林口,2023-11-01,9257
1301,台塑,6,0,6,凱基-林口,2023-11-01,9257
1795,美時,16,10,6,凱基-林口,2023-11-01,9257
6257,矽格,6,0,6,凱基-林口,2023-11-01,9257
9929,秋雨,76,70,6,凱基-林口,2023-11-01,9257
2504,國產,5,0,5,凱基-林口,2023-11-01,9257
00655L,國泰中國A50正2,5,0,5,凱基-林口,2023-11-01,9257
00885,富邦越南,5,0,5,凱基-林口,2023-11-01,9257
2402,毅嘉,5,0,5,凱基-林口,2023-11-01,9257
00680L,元大美債20正2,240,7,233,凱基-林口,2023-11-02,9257
00934,中信成長高股息,63,0,63,凱基-林口,2023-11-02,9257
5272,笙科,43,1,42,凱基-林口,2023-11-02,9257
5521,工信,42,0,42,凱基-林口,2023-11-02,9257
1210,大成,35,0,35,凱基-林口,2023-11-02,9257
8112,至上,30,0,30,凱基-林口,2023-11-02,9257
2748,雲品,30,1,29,凱基-林口,2023-11-02,9257
6216,居易,62,39,23,凱基-林口,2023-11-02,9257
4102,永日,22,0,22,凱基-林口,2023-11-02,9257
2618,長榮航,32,10,22,凱基-林口,2023-11-02,9257
00878,國泰永續高股息,34,13,21,凱基-林口,2023-11-02,9257
2332,友訊,20,0,20,凱基-林口,2023-11-02,9257
6492,生華科,15,1,14,凱基-林口,2023-11-02,9257
00933B,國泰10Y+金融債,13,0,13,凱基-林口,2023-11-02,9257
5236,凌陽創新,13,0,13,凱基-林口,2023-11-02,9257
6605,帝寶,13,0,13,凱基-林口,2023-11-02,9257
00715L,期街口布蘭特正2,12,0,12,凱基-林口,2023-11-02,9257
00720B,元大投資級公司債,16,5,11,凱基-林口,2023-11-02,9257
6235,華孚,16,5,11,凱基-林口,2023-11-02,9257
8033,雷虎,10,0,10,凱基-林口,2023-11-02,9257
00719B,元大美債1-3,10,0,10,凱基-林口,2023-11-02,9257
2025,千興,10,0,10,凱基-林口,2023-11-02,9257
2516,新建,10,0,10,凱基-林口,2023-11-02,9257
6290,良維,10,0,10,凱基-林口,2023-11-02,9257
6491,晶碩,10,0,10,凱基-林口,2023-11-02,9257
1731,美吾華,9,0,9,凱基-林口,2023-11-02,9257
2883,凱基金,9,0,9,凱基-林口,2023-11-02,9257
2344,華邦電,40,32,8,凱基-林口,2023-11-02,9257
2885,元大金,8,0,8,凱基-林口,2023-11-02,9257
6153,嘉聯益,7,0,7,凱基-林口,2023-11-02,9257
1605,華新,8,2,6,凱基-林口,2023-11-02,9257
2305,全友,6,0,6,凱基-林口,2023-11-02,9257
2356,英業達,10,4,6,凱基-林口,2023-11-02,9257
3036,文曄,8,2,6,凱基-林口,2023-11-02,9257
6189,豐藝,6,0,6,凱基-林口,2023-11-02,9257
6282,康舒,6,0,6,凱基-林口,2023-11-02,9257
8046,南電,6,0,6,凱基-林口,2023-11-02,9257
2888,新光金,5,0,5,凱基-林口,2023-11-02,9257
00752,中信中國50,5,0,5,凱基-林口,2023-11-02,9257
2706,第一店,5,0,5,凱基-林口,2023-11-02,9257
3055,蔚華科,55,50,5,凱基-林口,2023-11-02,9257
5871,中租-KY,5,0,5,凱基-林口,2023-11-02,9257
6156,松上,5,0,5,凱基-林口,2023-11-02,9257
8011,台通,5,0,5,凱基-林口,2023-11-02,9257
9955,佳龍,5,0,5,凱基-林口,2023-11-02,9257
2634,漢翔,4,0,4,凱基-林口,2023-11-02,9257
1301,台塑,4,0,4,凱基-林口,2023-11-02,9257
00902,中信電池及儲能,4,0,4,凱基-林口,2023-11-02,9257
00636,國泰中國A50,4,0,4,凱基-林口,2023-11-02,9257
1905,華紙,4,0,4,凱基-林口,2023-11-02,9257
2888,新光金,354,99,255,凱基-林口,2023-11-03,9257
00671R,富邦NASDAQ反1,250,0,250,凱基-林口,2023-11-03,9257
2883,凱基金,91,2,89,凱基-林口,2023-11-03,9257
6274,台燿,83,2,81,凱基-林口,2023-11-03,9257
2363,矽統,127,59,68,凱基-林口,2023-11-03,9257
2618,長榮航,162,96,66,凱基-林口,2023-11-03,9257
00680L,元大美債20正2,50,0,50,凱基-林口,2023-11-03,9257
1609,大亞,50,1,49,凱基-林口,2023-11-03,9257
3672,康聯訊,30,0,30,凱基-林口,2023-11-03,9257
8069,元太,35,11,24,凱基-林口,2023-11-03,9257
3035,智原,34,10,24,凱基-林口,2023-11-03,9257
2390,云辰,23,0,23,凱基-林口,2023-11-03,9257
6231,系微,20,0,20,凱基-林口,2023-11-03,9257
00933B,國泰10Y+金融債,20,0,20,凱基-林口,2023-11-03,9257
00720B,元大投資級公司債,17,0,17,凱基-林口,2023-11-03,9257
00931B,統一美債20年,17,0,17,凱基-林口,2023-11-03,9257
6770,力積電,22,5,17,凱基-林口,2023-11-03,9257
8358,金居,15,0,15,凱基-林口,2023-11-03,9257
5215,科嘉-KY,19,6,13,凱基-林口,2023-11-03,9257
00878,國泰永續高股息,13,2,11,凱基-林口,2023-11-03,9257
2317,鴻海,16,6,10,凱基-林口,2023-11-03,9257
1504,東元,12,2,10,凱基-林口,2023-11-03,9257
2332,友訊,10,0,10,凱基-林口,2023-11-03,9257
8033,雷虎,10,0,10,凱基-林口,2023-11-03,9257
8086,宏捷科,11,1,10,凱基-林口,2023-11-03,9257
2369,菱生,14,5,9,凱基-林口,2023-11-03,9257
6112,邁達特,10,1,9,凱基-林口,2023-11-03,9257
2002,中鋼,10,2,8,凱基-林口,2023-11-03,9257
3363,上詮,13,5,8,凱基-林口,2023-11-03,9257
6158,禾昌,9,1,8,凱基-林口,2023-11-03,9257
6213,聯茂,8,0,8,凱基-林口,2023-11-03,9257
8150,南茂,10,2,8,凱基-林口,2023-11-03,9257
8926,台汽電,8,0,8,凱基-林口,2023-11-03,9257
2458,義隆,7,0,7,凱基-林口,2023-11-03,9257
2405,輔信,7,0,7,凱基-林口,2023-11-03,9257
3545,敦泰,7,0,7,凱基-林口,2023-11-03,9257
3576,聯合再生,7,0,7,凱基-林口,2023-11-03,9257
5236,凌陽創新,7,0,7,凱基-林口,2023-11-03,9257
0056,元大高股息,10,4,6,凱基-林口,2023-11-03,9257
2399,映泰,6,0,6,凱基-林口,2023-11-03,9257
2457,飛宏,6,0,6,凱基-林口,2023-11-03,9257
2303,聯電,20,15,5,凱基-林口,2023-11-03,9257
2201,裕隆,5,0,5,凱基-林口,2023-11-03,9257
00922,國泰台灣領袖50,5,0,5,凱基-林口,2023-11-03,9257
1907,永豐餘,5,0,5,凱基-林口,2023-11-03,9257
3042,晶技,5,0,5,凱基-林口,2023-11-03,9257
4123,晟德,5,0,5,凱基-林口,2023-11-03,9257
4919,新唐,5,0,5,凱基-林口,2023-11-03,9257
5227,立凱-KY,5,0,5,凱基-林口,2023-11-03,9257
6164,華興,5,0,5,凱基-林口,2023-11-03,9257
00671R,富邦NASDAQ反1,200,0,200,凱基-林口,2023-11-06,9257
00632R,元大台灣50反1,50,0,50,凱基-林口,2023-11-06,9257
5483,中美晶,40,2,38,凱基-林口,2023-11-06,9257
2388,威盛,87,56,31,凱基-林口,2023-11-06,9257
6133,金橋,40,10,30,凱基-林口,2023-11-06,9257
2882,國泰金,30,1,29,凱基-林口,2023-11-06,9257
00679B,元大美債20年,24,0,24,凱基-林口,2023-11-06,9257
2002,中鋼,24,1,23,凱基-林口,2023-11-06,9257
3043,科風,23,0,23,凱基-林口,2023-11-06,9257
8112,至上,25,2,23,凱基-林口,2023-11-06,9257
2543,皇昌,20,0,20,凱基-林口,2023-11-06,9257
9105,泰金寶-DR,20,0,20,凱基-林口,2023-11-06,9257
9929,秋雨,100,80,20,凱基-林口,2023-11-06,9257
9934,成霖,20,0,20,凱基-林口,2023-11-06,9257
6285,啟��,18,1,17,凱基-林口,2023-11-06,9257
00878,國泰永續高股息,38,21,17,凱基-林口,2023-11-06,9257
2337,旺宏,16,0,16,凱基-林口,2023-11-06,9257
00720B,元大投資級公司債,15,0,15,凱基-林口,2023-11-06,9257
2363,矽統,32,17,15,凱基-林口,2023-11-06,9257
00934,中信成長高股息,15,0,15,凱基-林口,2023-11-06,9257
6216,居易,15,0,15,凱基-林口,2023-11-06,9257
9950,萬國通,25,10,15,凱基-林口,2023-11-06,9257
2329,華泰,20,8,12,凱基-林口,2023-11-06,9257
2427,三商電,12,0,12,凱基-林口,2023-11-06,9257
3014,聯陽,13,1,12,凱基-林口,2023-11-06,9257
6901,鑽石投資,12,0,12,凱基-林口,2023-11-06,9257
2303,聯電,36,25,11,凱基-林口,2023-11-06,9257
2324,仁寶,10,0,10,凱基-林口,2023-11-06,9257
6182,合晶,10,0,10,凱基-林口,2023-11-06,9257
6603,富強鑫,10,0,10,凱基-林口,2023-11-06,9257
00919,群益台灣精選高息,10,1,9,凱基-林口,2023-11-06,9257
6231,系微,9,0,9,凱基-林口,2023-11-06,9257
00931B,統一美債20年,7,0,7,凱基-林口,2023-11-06,9257
2486,一詮,11,4,7,凱基-林口,2023-11-06,9257
3311,閎暉,7,0,7,凱基-林口,2023-11-06,9257
3006,晶豪科,7,1,6,凱基-林口,2023-11-06,9257
6235,華孚,11,5,6,凱基-林口,2023-11-06,9257
2603,長榮,5,0,5,凱基-林口,2023-11-06,9257
0056,元大高股息,17,12,5,凱基-林口,2023-11-06,9257
1444,力麗,5,0,5,凱基-林口,2023-11-06,9257
2332,友訊,13,8,5,凱基-林口,2023-11-06,9257
2820,華票,5,0,5,凱基-林口,2023-11-06,9257
3062,建漢,5,0,5,凱基-林口,2023-11-06,9257
3118,進階,5,0,5,凱基-林口,2023-11-06,9257
6414,樺漢,5,0,5,凱基-林口,2023-11-06,9257
9904,寶成,5,0,5,凱基-林口,2023-11-06,9257
3017,奇鋐,8,3,5,凱基-林口,2023-11-06,9257
2401,凌陽,7,3,4,凱基-林口,2023-11-06,9257
3230,錦明,4,0,4,凱基-林口,2023-11-06,9257
3518,柏騰,4,0,4,凱基-林口,2023-11-06,9257
2609,陽明,58,2,56,凱基-林口,2023-11-07,9257
3481,群創,55,0,55,凱基-林口,2023-11-07,9257
00690,兆豐藍籌30,33,0,33,凱基-林口,2023-11-07,9257
6271,同欣電,53,20,33,凱基-林口,2023-11-07,9257
2457,飛宏,27,1,26,凱基-林口,2023-11-07,9257
3163,波若威,25,0,25,凱基-林口,2023-11-07,9257
2888,新光金,20,0,20,凱基-林口,2023-11-07,9257
9934,成霖,20,0,20,凱基-林口,2023-11-07,9257
00751B,元大AAA至A公司債,19,0,19,凱基-林口,2023-11-07,9257
2739,寒舍,18,1,17,凱基-林口,2023-11-07,9257
6285,啟��,17,0,17,凱基-林口,2023-11-07,9257
9950,萬國通,17,0,17,凱基-林口,2023-11-07,9257
00878,國泰永續高股息,16,0,16,凱基-林口,2023-11-07,9257
2488,漢平,18,2,16,凱基-林口,2023-11-07,9257
2634,漢翔,15,0,15,凱基-林口,2023-11-07,9257
00934,中信成長高股息,14,0,14,凱基-林口,2023-11-07,9257
3363,上詮,13,0,13,凱基-林口,2023-11-07,9257
1314,中石化,12,0,12,凱基-林口,2023-11-07,9257
2439,美律,22,10,12,凱基-林口,2023-11-07,9257
00687B,國泰20年美債,10,0,10,凱基-林口,2023-11-07,9257
2369,菱生,10,0,10,凱基-林口,2023-11-07,9257
2401,凌陽,23,13,10,凱基-林口,2023-11-07,9257
3017,奇鋐,21,11,10,凱基-林口,2023-11-07,9257
4167,松瑞藥,11,1,10,凱基-林口,2023-11-07,9257
8059,凱碩,10,0,10,凱基-林口,2023-11-07,9257
2206,三陽工業,11,2,9,凱基-林口,2023-11-07,9257
8069,元太,8,0,8,凱基-林口,2023-11-07,9257
2610,華航,10,2,8,凱基-林口,2023-11-07,9257
3207,耀勝,10,2,8,凱基-林口,2023-11-07,9257
00919,群益台灣精選高息,9,2,7,凱基-林口,2023-11-07,9257
1519,華城,24,17,7,凱基-林口,2023-11-07,9257
8112,至上,7,0,7,凱基-林口,2023-11-07,9257
8155,博智,7,0,7,凱基-林口,2023-11-07,9257
1605,華新,7,1,6,凱基-林口,2023-11-07,9257
2002,中鋼,6,0,6,凱基-林口,2023-11-07,9257
2421,建準,7,1,6,凱基-林口,2023-11-07,9257
3015,全漢,6,0,6,凱基-林口,2023-11-07,9257
3044,健鼎,6,0,6,凱基-林口,2023-11-07,9257
2891,中信金,5,0,5,凱基-林口,2023-11-07,9257
2504,國產,5,0,5,凱基-林口,2023-11-07,9257
2405,輔信,10,5,5,凱基-林口,2023-11-07,9257
2460,建通,5,0,5,凱基-林口,2023-11-07,9257
2913,農林,5,0,5,凱基-林口,2023-11-07,9257
3380,明泰,5,0,5,凱基-林口,2023-11-07,9257
5905,南仁湖,5,0,5,凱基-林口,2023-11-07,9257
6104,創惟,5,0,5,凱基-林口,2023-11-07,9257
8024,佑華,5,0,5,凱基-林口,2023-11-07,9257
1524,耿鼎,9,5,4,凱基-林口,2023-11-07,9257
00712,復華富時不動產,4,0,4,凱基-林口,2023-11-07,9257
2355,敬鵬,5,1,4,凱基-林口,2023-11-07,9257
00935,野村臺灣新科技50,606,0,606,凱基-林口,2023-11-08,9257
00936,台新永續高息中小,146,10,136,凱基-林口,2023-11-08,9257
00688L,國泰20年美債正2,100,0,100,凱基-林口,2023-11-08,9257
00915,凱基優選高股息30,60,1,59,凱基-林口,2023-11-08,9257
2206,三陽工業,64,5,59,凱基-林口,2023-11-08,9257
2313,華通,52,1,51,凱基-林口,2023-11-08,9257
2363,矽統,88,39,49,凱基-林口,2023-11-08,9257
2641,正德,35,0,35,凱基-林口,2023-11-08,9257
00933B,國泰10Y+金融債,33,2,31,凱基-林口,2023-11-08,9257
1319,東陽,30,0,30,凱基-林口,2023-11-08,9257
5351,鈺創,30,0,30,凱基-林口,2023-11-08,9257
3694,海華,26,1,25,凱基-林口,2023-11-08,9257
2495,普安,20,0,20,凱基-林口,2023-11-08,9257
00919,群益台灣精選高息,17,1,16,凱基-林口,2023-11-08,9257
3231,緯創,178,163,15,凱基-林口,2023-11-08,9257
5871,中租-KY,15,0,15,凱基-林口,2023-11-08,9257
9929,秋雨,55,40,15,凱基-林口,2023-11-08,9257
3622,洋華,16,2,14,凱基-林口,2023-11-08,9257
2739,寒舍,13,0,13,凱基-林口,2023-11-08,9257
3363,上詮,35,23,12,凱基-林口,2023-11-08,9257
2484,希華,12,1,11,凱基-林口,2023-11-08,9257
6290,良維,11,0,11,凱基-林口,2023-11-08,9257
1314,中石化,10,0,10,凱基-林口,2023-11-08,9257
00680L,元大美債20正2,10,0,10,凱基-林口,2023-11-08,9257
1909,榮成,10,0,10,凱基-林口,2023-11-08,9257
2888,新光金,10,0,10,凱基-林口,2023-11-08,9257
5347,世界,10,0,10,凱基-林口,2023-11-08,9257
6191,精成科,10,0,10,凱基-林口,2023-11-08,9257
3037,欣興,10,1,9,凱基-林口,2023-11-08,9257
9943,好樂迪,11,2,9,凱基-林口,2023-11-08,9257
3221,台嘉碩,13,5,8,凱基-林口,2023-11-08,9257
00885,富邦越南,7,0,7,凱基-林口,2023-11-08,9257
2338,光罩,7,0,7,凱基-林口,2023-11-08,9257
8110,華東,7,0,7,凱基-林口,2023-11-08,9257
1568,倉佑,7,1,6,凱基-林口,2023-11-08,9257
2409,友達,11,5,6,凱基-林口,2023-11-08,9257
4167,松瑞藥,6,0,6,凱基-林口,2023-11-08,9257
6156,松上,6,0,6,凱基-林口,2023-11-08,9257
2885,元大金,5,0,5,凱基-林口,2023-11-08,9257
00642U,期元大S＆P石油,5,0,5,凱基-林口,2023-11-08,9257
2385,群光,5,0,5,凱基-林口,2023-11-08,9257
2405,輔信,23,18,5,凱基-林口,2023-11-08,9257
2460,建通,5,0,5,凱基-林口,2023-11-08,9257
2488,漢平,10,5,5,凱基-林口,2023-11-08,9257
2617,台航,5,0,5,凱基-林口,2023-11-08,9257
3049,精金,5,0,5,凱基-林口,2023-11-08,9257
3163,波若威,5,0,5,凱基-林口,2023-11-08,9257
3308,聯德,5,0,5,凱基-林口,2023-11-08,9257
3706,神達,5,0,5,凱基-林口,2023-11-08,9257
8044,網家,5,0,5,凱基-林口,2023-11-08,9257
00637L,元大滬深300正2,200,0,200,凱基-林口,2023-11-09,9257
00688L,國泰20年美債正2,100,0,100,凱基-林口,2023-11-09,9257
00687B,國泰20年美債,151,52,99,凱基-林口,2023-11-09,9257
2495,普安,84,0,84,凱基-林口,2023-11-09,9257
00936,台新永續高息中小,41,0,41,凱基-林口,2023-11-09,9257
00934,中信成長高股息,42,6,36,凱基-林口,2023-11-09,9257
5347,世界,34,0,34,凱基-林口,2023-11-09,9257
3043,科風,33,1,32,凱基-林口,2023-11-09,9257
3481,群創,31,0,31,凱基-林口,2023-11-09,9257
2206,三陽工業,42,12,30,凱基-林口,2023-11-09,9257
3022,威強電,30,0,30,凱基-林口,2023-11-09,9257
8936,國統,33,3,30,凱基-林口,2023-11-09,9257
2388,威盛,46,19,27,凱基-林口,2023-11-09,9257
00935,野村臺灣新科技50,22,0,22,凱基-林口,2023-11-09,9257
8046,南電,22,0,22,凱基-林口,2023-11-09,9257
1314,中石化,20,0,20,凱基-林口,2023-11-09,9257
6117,迎廣,23,3,20,凱基-林口,2023-11-09,9257
00751B,元大AAA至A公司債,20,2,18,凱基-林口,2023-11-09,9257
2883,凱基金,18,0,18,凱基-林口,2023-11-09,9257
00929,復華台灣科技優息,19,2,17,凱基-林口,2023-11-09,9257
2303,聯電,28,12,16,凱基-林口,2023-11-09,9257
2610,華航,16,0,16,凱基-林口,2023-11-09,9257
6284,佳邦,17,2,15,凱基-林口,2023-11-09,9257
2329,華泰,80,67,13,凱基-林口,2023-11-09,9257
8111,立��,18,5,13,凱基-林口,2023-11-09,9257
9950,萬國通,21,10,11,凱基-林口,2023-11-09,9257
00680L,元大美債20正2,11,1,10,凱基-林口,2023-11-09,9257
00719B,元大美債1-3,10,0,10,凱基-林口,2023-11-09,9257
00764B,群益25年美債,10,0,10,凱基-林口,2023-11-09,9257
1909,榮成,10,0,10,凱基-林口,2023-11-09,9257
2331,精英,16,6,10,凱基-林口,2023-11-09,9257
2485,兆赫,11,1,10,凱基-林口,2023-11-09,9257
2897,王道銀行,10,0,10,凱基-林口,2023-11-09,9257
3419,譁裕,10,0,10,凱基-林口,2023-11-09,9257
4953,緯軟,11,1,10,凱基-林口,2023-11-09,9257
4967,十銓,14,4,10,凱基-林口,2023-11-09,9257
5340,建榮,10,0,10,凱基-林口,2023-11-09,9257
5381,合正,16,6,10,凱基-林口,2023-11-09,9257
5521,工信,10,0,10,凱基-林口,2023-11-09,9257
6133,金橋,10,0,10,凱基-林口,2023-11-09,9257
6664,群翊,10,0,10,凱基-林口,2023-11-09,9257
3363,上詮,15,5,10,凱基-林口,2023-11-09,9257
6170,統振,14,5,9,凱基-林口,2023-11-09,9257
2484,希華,8,0,8,凱基-林口,2023-11-09,9257
5351,鈺創,10,2,8,凱基-林口,2023-11-09,9257
00878,國泰永續高股息,9,1,8,凱基-林口,2023-11-09,9257
2353,宏��,7,0,7,凱基-林口,2023-11-09,9257
6158,禾昌,10,3,7,凱基-林口,2023-11-09,9257
3260,威剛,20,13,7,凱基-林口,2023-11-09,9257
2344,華邦電,6,0,6,凱基-林口,2023-11-09,9257
00687B,國泰20年美債,181,0,181,凱基-林口,2023-11-10,9257
2467,志聖,102,6,96,凱基-林口,2023-11-10,9257
00929,復華台灣科技優息,87,4,83,凱基-林口,2023-11-10,9257
00680L,元大美債20正2,111,45,66,凱基-林口,2023-11-10,9257
2376,技嘉,46,3,43,凱基-林口,2023-11-10,9257
00878,國泰永續高股息,45,5,40,凱基-林口,2023-11-10,9257
00936,台新永續高息中小,36,0,36,凱基-林口,2023-11-10,9257
00935,野村臺灣新科技50,36,0,36,凱基-林口,2023-11-10,9257
00679B,元大美債20年,35,3,32,凱基-林口,2023-11-10,9257
2338,光罩,31,0,31,凱基-林口,2023-11-10,9257
2888,新光金,30,0,30,凱基-林口,2023-11-10,9257
1301,台塑,23,0,23,凱基-林口,2023-11-10,9257
00923,群益台ESG低碳50,21,0,21,凱基-林口,2023-11-10,9257
2404,漢唐,20,0,20,凱基-林口,2023-11-10,9257
2405,輔信,20,0,20,凱基-林口,2023-11-10,9257
2816,旺旺保,20,0,20,凱基-林口,2023-11-10,9257
3707,漢磊,20,0,20,凱基-林口,2023-11-10,9257
00751B,元大AAA至A公司債,18,0,18,凱基-林口,2023-11-10,9257
2609,陽明,18,0,18,凱基-林口,2023-11-10,9257
3043,科風,18,0,18,凱基-林口,2023-11-10,9257
3169,亞信,17,0,17,凱基-林口,2023-11-10,9257
2363,矽統,61,44,17,凱基-林口,2023-11-10,9257
4127,天良,16,0,16,凱基-林口,2023-11-10,9257
00934,中信成長高股息,15,0,15,凱基-林口,2023-11-10,9257
00772B,中信高評級公司債,15,0,15,凱基-林口,2023-11-10,9257
4123,晟德,15,0,15,凱基-林口,2023-11-10,9257
4967,十銓,21,6,15,凱基-林口,2023-11-10,9257
3078,僑威,25,10,15,凱基-林口,2023-11-10,9257
9943,好樂迪,13,1,12,凱基-林口,2023-11-10,9257
1618,合機,12,0,12,凱基-林口,2023-11-10,9257
2606,裕民,12,0,12,凱基-林口,2023-11-10,9257
4162,智擎,13,1,12,凱基-林口,2023-11-10,9257
6664,群翊,12,0,12,凱基-林口,2023-11-10,9257
00724B,群益投資級金融債,11,0,11,凱基-林口,2023-11-10,9257
1319,東陽,11,0,11,凱基-林口,2023-11-10,9257
1568,倉佑,11,0,11,凱基-林口,2023-11-10,9257
2884,玉山金,11,0,11,凱基-林口,2023-11-10,9257
3703,欣陸,11,0,11,凱基-林口,2023-11-10,9257
1314,中石化,10,0,10,凱基-林口,2023-11-10,9257
1603,華電,10,0,10,凱基-林口,2023-11-10,9257
1809,中釉,10,0,10,凱基-林口,2023-11-10,9257
2020,美亞,10,0,10,凱基-林口,2023-11-10,9257
4707,磐亞,10,0,10,凱基-林口,2023-11-10,9257
4939,亞電,10,0,10,凱基-林口,2023-11-10,9257
5381,合正,10,0,10,凱基-林口,2023-11-10,9257
6125,廣運,12,2,10,凱基-林口,2023-11-10,9257
4561,健椿,9,0,9,凱基-林口,2023-11-10,9257
5258,虹堡,61,52,9,凱基-林口,2023-11-10,9257
3036,文曄,16,8,8,凱基-林口,2023-11-10,9257
5347,世界,8,0,8,凱基-林口,2023-11-10,9257
2607,榮運,117,6,111,凱基-林口,2023-11-13,9257
3481,群創,80,0,80,凱基-林口,2023-11-13,9257
00715L,期街口布蘭特正2,60,0,60,凱基-林口,2023-11-13,9257
00687B,國泰20年美債,57,1,56,凱基-林口,2023-11-13,9257
00933B,國泰10Y+金融債,51,0,51,凱基-林口,2023-11-13,9257
00772B,中信高評級公司債,50,0,50,凱基-林口,2023-11-13,9257
8940,新天地,50,0,50,凱基-林口,2023-11-13,9257
3169,亞信,49,0,49,凱基-林口,2023-11-13,9257
00878,國泰永續高股息,44,0,44,凱基-林口,2023-11-13,9257
1513,中興電,41,1,40,凱基-林口,2023-11-13,9257
2206,三陽工業,35,4,31,凱基-林口,2023-11-13,9257
2498,宏達電,32,1,31,凱基-林口,2023-11-13,9257
00929,復華台灣科技優息,76,45,31,凱基-林口,2023-11-13,9257
2439,美律,31,1,30,凱基-林口,2023-11-13,9257
2882,國泰金,31,4,27,凱基-林口,2023-11-13,9257
00882,中信中國高股息,27,0,27,凱基-林口,2023-11-13,9257
1609,大亞,20,0,20,凱基-林口,2023-11-13,9257
2816,旺旺保,20,0,20,凱基-林口,2023-11-13,9257
00679B,元大美債20年,18,0,18,凱基-林口,2023-11-13,9257
2382,廣達,59,42,17,凱基-林口,2023-11-13,9257
2748,雲品,15,0,15,凱基-林口,2023-11-13,9257
4960,誠美材,20,5,15,凱基-林口,2023-11-13,9257
6213,聯茂,16,1,15,凱基-林口,2023-11-13,9257
2468,華經,14,0,14,凱基-林口,2023-11-13,9257
2002,中鋼,13,0,13,凱基-林口,2023-11-13,9257
2329,華泰,42,29,13,凱基-林口,2023-11-13,9257
3325,旭品,17,4,13,凱基-林口,2023-11-13,9257
2408,南亞科,14,2,12,凱基-林口,2023-11-13,9257
4561,健椿,11,0,11,凱基-林口,2023-11-13,9257
5871,中租-KY,10,0,10,凱基-林口,2023-11-13,9257
00904,新光臺灣半導體30,10,0,10,凱基-林口,2023-11-13,9257
00764B,群益25年美債,10,0,10,凱基-林口,2023-11-13,9257
00850,元大臺灣ESG永續,10,0,10,凱基-林口,2023-11-13,9257
00724B,群益投資級金融債,10,0,10,凱基-林口,2023-11-13,9257
2377,微星,10,0,10,凱基-林口,2023-11-13,9257
2734,易飛網,10,0,10,凱基-林口,2023-11-13,9257
3402,漢科,10,0,10,凱基-林口,2023-11-13,9257
4953,緯軟,10,0,10,凱基-林口,2023-11-13,9257
5521,工信,10,0,10,凱基-林口,2023-11-13,9257
3036,文曄,9,0,9,凱基-林口,2023-11-13,9257
00712,復華富時不動產,9,0,9,凱基-林口,2023-11-13,9257
6111,大宇資,10,1,9,凱基-林口,2023-11-13,9257
00936,台新永續高息中小,9,1,8,凱基-林口,2023-11-13,9257
2417,圓剛,7,0,7,凱基-林口,2023-11-13,9257
2462,良得電,15,8,7,凱基-林口,2023-11-13,9257
3027,盛達,8,1,7,凱基-林口,2023-11-13,9257
4533,協易機,7,0,7,凱基-林口,2023-11-13,9257
6806,森崴能源,7,0,7,凱基-林口,2023-11-13,9257
2412,中華電,8,1,7,凱基-林口,2023-11-13,9257
6139,亞翔,9,3,6,凱基-林口,2023-11-13,9257
00772B,中信高評級公司債,271,0,271,凱基-林口,2023-11-14,9257
00679B,元大美債20年,269,0,269,凱基-林口,2023-11-14,9257
2355,敬鵬,41,0,41,凱基-林口,2023-11-14,9257
00633L,富邦上証正2,40,0,40,凱基-林口,2023-11-14,9257
00933B,國泰10Y+金融債,50,11,39,凱基-林口,2023-11-14,9257
3035,智原,27,2,25,凱基-林口,2023-11-14,9257
00680L,元大美債20正2,20,0,20,凱基-林口,2023-11-14,9257
4960,誠美材,20,0,20,凱基-林口,2023-11-14,9257
2363,矽統,83,68,15,凱基-林口,2023-11-14,9257
2344,華邦電,32,18,14,凱基-林口,2023-11-14,9257
1101,台泥,12,0,12,凱基-林口,2023-11-14,9257
1815,富喬,24,12,12,凱基-林口,2023-11-14,9257
3231,緯創,39,28,11,凱基-林口,2023-11-14,9257
4128,中天,11,0,11,凱基-林口,2023-11-14,9257
5314,世紀,11,0,11,凱基-林口,2023-11-14,9257
00878,國泰永續高股息,11,0,11,凱基-林口,2023-11-14,9257
0056,元大高股息,10,0,10,凱基-林口,2023-11-14,9257
00935,野村臺灣新科技50,10,0,10,凱基-林口,2023-11-14,9257
2303,聯電,20,10,10,凱基-林口,2023-11-14,9257
2438,翔耀,10,0,10,凱基-林口,2023-11-14,9257
6133,金橋,10,0,10,凱基-林口,2023-11-14,9257
00890B,凱基ESG BBB債,9,0,9,凱基-林口,2023-11-14,9257
2324,仁寶,10,1,9,凱基-林口,2023-11-14,9257
8936,國統,11,2,9,凱基-林口,2023-11-14,9257
2883,凱基金,9,0,9,凱基-林口,2023-11-14,9257
2610,華航,10,2,8,凱基-林口,2023-11-14,9257
2412,中華電,8,0,8,凱基-林口,2023-11-14,9257
8048,德勝,10,2,8,凱基-林口,2023-11-14,9257
2618,長榮航,8,1,7,凱基-林口,2023-11-14,9257
2369,菱生,17,10,7,凱基-林口,2023-11-14,9257
2616,山隆,7,0,7,凱基-林口,2023-11-14,9257
6451,訊芯-KY,8,1,7,凱基-林口,2023-11-14,9257
2834,臺企銀,11,5,6,凱基-林口,2023-11-14,9257
2515,中工,11,5,6,凱基-林口,2023-11-14,9257
4561,健椿,6,0,6,凱基-林口,2023-11-14,9257
5344,立衛,6,0,6,凱基-林口,2023-11-14,9257
2457,飛宏,7,1,6,凱基-林口,2023-11-14,9257
2382,廣達,11,6,5,凱基-林口,2023-11-14,9257
00687B,國泰20年美債,6,1,5,凱基-林口,2023-11-14,9257
1240,茂生農經,5,0,5,凱基-林口,2023-11-14,9257
1434,福懋,5,0,5,凱基-林口,2023-11-14,9257
1319,東陽,5,0,5,凱基-林口,2023-11-14,9257
00900,富邦特選高股息30,5,0,5,凱基-林口,2023-11-14,9257
2338,光罩,5,0,5,凱基-林口,2023-11-14,9257
3169,亞信,6,1,5,凱基-林口,2023-11-14,9257
3346,麗清,5,0,5,凱基-林口,2023-11-14,9257
4906,正文,5,0,5,凱基-林口,2023-11-14,9257
6127,九豪,6,1,5,凱基-林口,2023-11-14,9257
3006,晶豪科,5,0,5,凱基-林口,2023-11-14,9257
6223,旺矽,5,1,4,凱基-林口,2023-11-14,9257
00680L,元大美債20正2,392,0,392,凱基-林口,2023-11-15,9257
00679B,元大美債20年,168,21,147,凱基-林口,2023-11-15,9257
2331,精英,106,2,104,凱基-林口,2023-11-15,9257
00772B,中信高評級公司債,100,3,97,凱基-林口,2023-11-15,9257
2883,凱基金,88,10,78,凱基-林口,2023-11-15,9257
6235,華孚,117,64,53,凱基-林口,2023-11-15,9257
00633L,富邦上証正2,40,0,40,凱基-林口,2023-11-15,9257
00936,台新永續高息中小,34,3,31,凱基-林口,2023-11-15,9257
00650L,復華香港正2,30,0,30,凱基-林口,2023-11-15,9257
00637L,元大滬深300正2,40,10,30,凱基-林口,2023-11-15,9257
4702,中美實,30,0,30,凱基-林口,2023-11-15,9257
00935,野村臺灣新科技50,30,0,30,凱基-林口,2023-11-15,9257
2204,中華,30,1,29,凱基-林口,2023-11-15,9257
2516,新建,29,0,29,凱基-林口,2023-11-15,9257
6426,統新,28,0,28,凱基-林口,2023-11-15,9257
2449,京元電子,27,0,27,凱基-林口,2023-11-15,9257
1519,華城,38,13,25,凱基-林口,2023-11-15,9257
2353,宏��,30,6,24,凱基-林口,2023-11-15,9257
00929,復華台灣科技優息,33,12,21,凱基-林口,2023-11-15,9257
6282,康舒,31,12,19,凱基-林口,2023-11-15,9257
6719,力智,19,1,18,凱基-林口,2023-11-15,9257
9924,福興,14,1,13,凱基-林口,2023-11-15,9257
4533,協易機,13,1,12,凱基-林口,2023-11-15,9257
4967,十銓,23,11,12,凱基-林口,2023-11-15,9257
2317,鴻海,11,0,11,凱基-林口,2023-11-15,9257
00885,富邦越南,13,2,11,凱基-林口,2023-11-15,9257
2882,國泰金,11,0,11,凱基-林口,2023-11-15,9257
3043,科風,11,0,11,凱基-林口,2023-11-15,9257
8163,達方,11,0,11,凱基-林口,2023-11-15,9257
6015,宏遠證,11,0,11,凱基-林口,2023-11-15,9257
1603,華電,12,2,10,凱基-林口,2023-11-15,9257
3078,僑威,10,0,10,凱基-林口,2023-11-15,9257
3715,定穎投控,10,0,10,凱基-林口,2023-11-15,9257
5215,科嘉-KY,10,0,10,凱基-林口,2023-11-15,9257
5315,光聯,10,0,10,凱基-林口,2023-11-15,9257
6141,柏承,10,0,10,凱基-林口,2023-11-15,9257
2504,國產,10,1,9,凱基-林口,2023-11-15,9257
00632R,元大台灣50反1,9,1,8,凱基-林口,2023-11-15,9257
2338,光罩,8,0,8,凱基-林口,2023-11-15,9257
2405,輔信,11,3,8,凱基-林口,2023-11-15,9257
3206,志豐,8,0,8,凱基-林口,2023-11-15,9257
3260,威剛,12,4,8,凱基-林口,2023-11-15,9257
8110,華東,9,1,8,凱基-林口,2023-11-15,9257
0056,元大高股息,24,17,7,凱基-林口,2023-11-15,9257
3234,光環,8,1,7,凱基-林口,2023-11-15,9257
6901,鑽石投資,8,1,7,凱基-林口,2023-11-15,9257
6139,亞翔,11,5,6,凱基-林口,2023-11-15,9257
00933B,國泰10Y+金融債,10,4,6,凱基-林口,2023-11-15,9257
3017,奇鋐,24,18,6,凱基-林口,2023-11-15,9257
3264,欣銓,7,1,6,凱基-林口,2023-11-15,9257
00671R,富邦NASDAQ反1,130,0,130,凱基-林口,2023-11-16,9257
2331,精英,100,1,99,凱基-林口,2023-11-16,9257
2607,榮運,58,0,58,凱基-林口,2023-11-16,9257
00933B,國泰10Y+金融債,52,0,52,凱基-林口,2023-11-16,9257
00929,復華台灣科技優息,62,12,50,凱基-林口,2023-11-16,9257
2312,金寶,42,0,42,凱基-林口,2023-11-16,9257
6156,松上,60,19,41,凱基-林口,2023-11-16,9257
2204,中華,40,1,39,凱基-林口,2023-11-16,9257
2467,志聖,38,0,38,凱基-林口,2023-11-16,9257
3041,揚智,44,6,38,凱基-林口,2023-11-16,9257
00751B,元大AAA至A公司債,35,0,35,凱基-林口,2023-11-16,9257
8054,安國,30,2,28,凱基-林口,2023-11-16,9257
6257,矽格,30,5,25,凱基-林口,2023-11-16,9257
00687B,國泰20年美債,52,30,22,凱基-林口,2023-11-16,9257
00679B,元大美債20年,20,0,20,凱基-林口,2023-11-16,9257
2516,新建,21,1,20,凱基-林口,2023-11-16,9257
5388,中磊,20,0,20,凱基-林口,2023-11-16,9257
2882,國泰金,19,0,19,凱基-林口,2023-11-16,9257
1605,華新,22,3,19,凱基-林口,2023-11-16,9257
2618,長榮航,64,50,14,凱基-林口,2023-11-16,9257
00772B,中信高評級公司債,12,0,12,凱基-林口,2023-11-16,9257
00690,兆豐藍籌30,12,0,12,凱基-林口,2023-11-16,9257
2374,佳能,12,0,12,凱基-林口,2023-11-16,9257
8034,榮群,13,1,12,凱基-林口,2023-11-16,9257
3481,群創,11,0,11,凱基-林口,2023-11-16,9257
4967,十銓,12,1,11,凱基-林口,2023-11-16,9257
5512,力麒,11,0,11,凱基-林口,2023-11-16,9257
6603,富強鑫,11,0,11,凱基-林口,2023-11-16,9257
1455,集盛,10,0,10,凱基-林口,2023-11-16,9257
2405,輔信,10,0,10,凱基-林口,2023-11-16,9257
2412,中華電,10,0,10,凱基-林口,2023-11-16,9257
00720B,元大投資級公司債,9,0,9,凱基-林口,2023-11-16,9257
2020,美亞,19,10,9,凱基-林口,2023-11-16,9257
2417,圓剛,43,34,9,凱基-林口,2023-11-16,9257
4953,緯軟,10,1,9,凱基-林口,2023-11-16,9257
00665L,富邦�琤肭磪囓�2,8,0,8,凱基-林口,2023-11-16,9257
3035,智原,33,25,8,凱基-林口,2023-11-16,9257
3260,威剛,12,4,8,凱基-林口,2023-11-16,9257
4561,健椿,8,0,8,凱基-林口,2023-11-16,9257
4702,中美實,8,0,8,凱基-林口,2023-11-16,9257
0056,元大高股息,9,2,7,凱基-林口,2023-11-16,9257
2606,裕民,7,0,7,凱基-林口,2023-11-16,9257
6141,柏承,11,4,7,凱基-林口,2023-11-16,9257
1101,台泥,6,0,6,凱基-林口,2023-11-16,9257
3147,大綜,6,0,6,凱基-林口,2023-11-16,9257
3402,漢科,7,1,6,凱基-林口,2023-11-16,9257
4720,德淵,6,0,6,凱基-林口,2023-11-16,9257
6456,GIS-KY,8,2,6,凱基-林口,2023-11-16,9257
2382,廣達,8,3,5,凱基-林口,2023-11-16,9257
00878,國泰永續高股息,19,14,5,凱基-林口,2023-11-16,9257
1609,大亞,106,0,106,凱基-林口,2023-11-17,9257
2618,長榮航,199,95,104,凱基-林口,2023-11-17,9257
2331,精英,104,4,100,凱基-林口,2023-11-17,9257
00632R,元大台灣50反1,66,0,66,凱基-林口,2023-11-17,9257
00633L,富邦上証正2,60,0,60,凱基-林口,2023-11-17,9257
6770,力積電,50,1,49,凱基-林口,2023-11-17,9257
00933B,國泰10Y+金融債,30,0,30,凱基-林口,2023-11-17,9257
00637L,元大滬深300正2,30,0,30,凱基-林口,2023-11-17,9257
6285,啟��,30,1,29,凱基-林口,2023-11-17,9257
2467,志聖,27,1,26,凱基-林口,2023-11-17,9257
2603,長榮,26,0,26,凱基-林口,2023-11-17,9257
3081,聯亞,24,1,23,凱基-林口,2023-11-17,9257
2401,凌陽,45,23,22,凱基-林口,2023-11-17,9257
4105,東洋,22,0,22,凱基-林口,2023-11-17,9257
00680L,元大美債20正2,20,0,20,凱基-林口,2023-11-17,9257
2516,新建,20,0,20,凱基-林口,2023-11-17,9257
6274,台燿,21,2,19,凱基-林口,2023-11-17,9257
2439,美律,19,0,19,凱基-林口,2023-11-17,9257
2722,夏都,18,0,18,凱基-林口,2023-11-17,9257
2312,金寶,25,9,16,凱基-林口,2023-11-17,9257
3481,群創,52,37,15,凱基-林口,2023-11-17,9257
00915,凱基優選高股息30,15,0,15,凱基-林口,2023-11-17,9257
00679B,元大美債20年,29,14,15,凱基-林口,2023-11-17,9257
00885,富邦越南,15,0,15,凱基-林口,2023-11-17,9257
1455,集盛,15,0,15,凱基-林口,2023-11-17,9257
2353,宏��,15,0,15,凱基-林口,2023-11-17,9257
3715,定穎投控,21,6,15,凱基-林口,2023-11-17,9257
00772B,中信高評級公司債,13,0,13,凱基-林口,2023-11-17,9257
3287,廣寰科,13,0,13,凱基-林口,2023-11-17,9257
3712,永崴投控,14,1,13,凱基-林口,2023-11-17,9257
5703,亞都,13,0,13,凱基-林口,2023-11-17,9257
0051,元大中型100,12,0,12,凱基-林口,2023-11-17,9257
2610,華航,13,2,11,凱基-林口,2023-11-17,9257
6591,動力-KY,11,0,11,凱基-林口,2023-11-17,9257
2611,志信,10,0,10,凱基-林口,2023-11-17,9257
3036,文曄,10,0,10,凱基-林口,2023-11-17,9257
5302,太欣,10,0,10,凱基-林口,2023-11-17,9257
6541,泰福-KY,10,0,10,凱基-林口,2023-11-17,9257
8112,至上,10,0,10,凱基-林口,2023-11-17,9257
9950,萬國通,18,8,10,凱基-林口,2023-11-17,9257
2884,玉山金,12,3,9,凱基-林口,2023-11-17,9257
6133,金橋,9,0,9,凱基-林口,2023-11-17,9257
3017,奇鋐,9,1,8,凱基-林口,2023-11-17,9257
1319,東陽,7,0,7,凱基-林口,2023-11-17,9257
4702,中美實,7,0,7,凱基-林口,2023-11-17,9257
3227,原相,10,4,6,凱基-林口,2023-11-17,9257
1442,名軒,7,1,6,凱基-林口,2023-11-17,9257
1519,華城,23,17,6,凱基-林口,2023-11-17,9257
2201,裕隆,12,6,6,凱基-林口,2023-11-17,9257
2367,燿華,6,0,6,凱基-林口,2023-11-17,9257
3035,智原,120,34,86,凱基-林口,2023-11-20,9257
00679B,元大美債20年,75,0,75,凱基-林口,2023-11-20,9257
2467,志聖,75,0,75,凱基-林口,2023-11-20,9257
2331,精英,60,4,56,凱基-林口,2023-11-20,9257
2543,皇昌,69,26,43,凱基-林口,2023-11-20,9257
2801,彰銀,42,0,42,凱基-林口,2023-11-20,9257
2882,國泰金,35,0,35,凱基-林口,2023-11-20,9257
8358,金居,30,0,30,凱基-林口,2023-11-20,9257
3081,聯亞,30,4,26,凱基-林口,2023-11-20,9257
3147,大綜,21,0,21,凱基-林口,2023-11-20,9257
2887,台新金,30,10,20,凱基-林口,2023-11-20,9257
3285,微端,20,0,20,凱基-林口,2023-11-20,9257
5706,鳳凰,30,12,18,凱基-林口,2023-11-20,9257
6108,競國,18,0,18,凱基-林口,2023-11-20,9257
2363,矽統,57,40,17,凱基-林口,2023-11-20,9257
00885,富邦越南,16,0,16,凱基-林口,2023-11-20,9257
00772B,中信高評級公司債,15,0,15,凱基-林口,2023-11-20,9257
2353,宏��,16,1,15,凱基-林口,2023-11-20,9257
6558,興能高,15,0,15,凱基-林口,2023-11-20,9257
2201,裕隆,12,0,12,凱基-林口,2023-11-20,9257
8163,達方,12,0,12,凱基-林口,2023-11-20,9257
00923,群益台ESG低碳50,11,0,11,凱基-林口,2023-11-20,9257
3701,大眾控,12,1,11,凱基-林口,2023-11-20,9257
3454,晶睿,10,0,10,凱基-林口,2023-11-20,9257
1522,堤維西,10,0,10,凱基-林口,2023-11-20,9257
1802,台玻,10,0,10,凱基-林口,2023-11-20,9257
2417,圓剛,11,1,10,凱基-林口,2023-11-20,9257
3045,台灣大,10,0,10,凱基-林口,2023-11-20,9257
9904,寶成,10,0,10,凱基-林口,2023-11-20,9257
6213,聯茂,9,0,9,凱基-林口,2023-11-20,9257
8227,巨有科技,12,4,8,凱基-林口,2023-11-20,9257
2610,華航,10,2,8,凱基-林口,2023-11-20,9257
00929,復華台灣科技優息,48,41,7,凱基-林口,2023-11-20,9257
00637L,元大滬深300正2,7,0,7,凱基-林口,2023-11-20,9257
00751B,元大AAA至A公司債,7,0,7,凱基-林口,2023-11-20,9257
1402,遠東新,7,1,6,凱基-林口,2023-11-20,9257
1504,東元,9,3,6,凱基-林口,2023-11-20,9257
1513,中興電,6,0,6,凱基-林口,2023-11-20,9257
2338,光罩,7,1,6,凱基-林口,2023-11-20,9257
2603,長榮,8,2,6,凱基-林口,2023-11-20,9257
2731,雄獅,29,23,6,凱基-林口,2023-11-20,9257
4908,前鼎,6,0,6,凱基-林口,2023-11-20,9257
6237,驊訊,12,6,6,凱基-林口,2023-11-20,9257
00878,國泰永續高股息,17,12,5,凱基-林口,2023-11-20,9257
1101,台泥,5,0,5,凱基-林口,2023-11-20,9257
00719B,元大美債1-3,5,0,5,凱基-林口,2023-11-20,9257
2329,華泰,19,14,5,凱基-林口,2023-11-20,9257
3169,亞信,7,2,5,凱基-林口,2023-11-20,9257
3176,基亞,5,0,5,凱基-林口,2023-11-20,9257
3481,群創,10,5,5,凱基-林口,2023-11-20,9257
2402,毅嘉,246,9,237,凱基-林口,2023-11-21,9257
6112,邁達特,115,1,114,凱基-林口,2023-11-21,9257
3230,錦明,50,0,50,凱基-林口,2023-11-21,9257
2363,矽統,76,27,49,凱基-林口,2023-11-21,9257
2516,新建,47,7,40,凱基-林口,2023-11-21,9257
5465,富驊,41,1,40,凱基-林口,2023-11-21,9257
1524,耿鼎,62,31,31,凱基-林口,2023-11-21,9257
2332,友訊,30,0,30,凱基-林口,2023-11-21,9257
6216,居易,28,0,28,凱基-林口,2023-11-21,9257
00632R,元大台灣50反1,45,20,25,凱基-林口,2023-11-21,9257
3035,智原,30,6,24,凱基-林口,2023-11-21,9257
5533,皇鼎,22,0,22,凱基-林口,2023-11-21,9257
3715,定穎投控,72,50,22,凱基-林口,2023-11-21,9257
2352,佳世達,21,0,21,凱基-林口,2023-11-21,9257
00706L,期元大S＆P日圓正2,20,0,20,凱基-林口,2023-11-21,9257
1815,富喬,21,1,20,凱基-林口,2023-11-21,9257
2331,精英,27,7,20,凱基-林口,2023-11-21,9257
4906,正文,22,3,19,凱基-林口,2023-11-21,9257
2382,廣達,46,27,19,凱基-林口,2023-11-21,9257
00915,凱基優選高股息30,20,5,15,凱基-林口,2023-11-21,9257
4967,十銓,15,0,15,凱基-林口,2023-11-21,9257
2801,彰銀,14,0,14,凱基-林口,2023-11-21,9257
3694,海華,15,1,14,凱基-林口,2023-11-21,9257
6282,康舒,14,0,14,凱基-林口,2023-11-21,9257
8940,新天地,14,1,13,凱基-林口,2023-11-21,9257
2498,宏達電,12,0,12,凱基-林口,2023-11-21,9257
3017,奇鋐,14,2,12,凱基-林口,2023-11-21,9257
3041,揚智,17,5,12,凱基-林口,2023-11-21,9257
00933B,國泰10Y+金融債,11,0,11,凱基-林口,2023-11-21,9257
2462,良得電,13,2,11,凱基-林口,2023-11-21,9257
6695,芯鼎,13,2,11,凱基-林口,2023-11-21,9257
6125,廣運,24,13,11,凱基-林口,2023-11-21,9257
00680L,元大美債20正2,10,0,10,凱基-林口,2023-11-21,9257
4952,凌通,10,0,10,凱基-林口,2023-11-21,9257
5213,亞昕,10,0,10,凱基-林口,2023-11-21,9257
6118,建達,10,0,10,凱基-林口,2023-11-21,9257
6234,高僑,10,0,10,凱基-林口,2023-11-21,9257
3558,神準,10,0,10,凱基-林口,2023-11-21,9257
00919,群益台灣精選高息,21,11,10,凱基-林口,2023-11-21,9257
3049,精金,10,1,9,凱基-林口,2023-11-21,9257
3231,緯創,52,43,9,凱基-林口,2023-11-21,9257
3308,聯德,10,1,9,凱基-林口,2023-11-21,9257
00692,富邦公司治理,8,0,8,凱基-林口,2023-11-21,9257
2377,微星,10,2,8,凱基-林口,2023-11-21,9257
3163,波若威,13,5,8,凱基-林口,2023-11-21,9257
8088,品安,8,0,8,凱基-林口,2023-11-21,9257
00720B,元大投資級公司債,8,1,7,凱基-林口,2023-11-21,9257
00679B,元大美債20年,9,2,7,凱基-林口,2023-11-21,9257
00929,復華台灣科技優息,37,31,6,凱基-林口,2023-11-21,9257
2367,燿華,15,9,6,凱基-林口,2023-11-21,9257
3706,神達,128,1,127,凱基-林口,2023-11-22,9257
00671R,富邦NASDAQ反1,120,0,120,凱基-林口,2023-11-22,9257
2618,長榮航,112,6,106,凱基-林口,2023-11-22,9257
2891,中信金,75,4,71,凱基-林口,2023-11-22,9257
00665L,富邦�琤肭磪囓�2,50,0,50,凱基-林口,2023-11-22,9257
2363,矽統,87,37,50,凱基-林口,2023-11-22,9257
2610,華航,52,5,47,凱基-林口,2023-11-22,9257
6112,邁達特,40,0,40,凱基-林口,2023-11-22,9257
3231,緯創,36,5,31,凱基-林口,2023-11-22,9257
2382,廣達,33,3,30,凱基-林口,2023-11-22,9257
2515,中工,30,0,30,凱基-林口,2023-11-22,9257
2883,凱基金,51,25,26,凱基-林口,2023-11-22,9257
00878,國泰永續高股息,28,2,26,凱基-林口,2023-11-22,9257
5465,富驊,25,0,25,凱基-林口,2023-11-22,9257
8940,新天地,25,0,25,凱基-林口,2023-11-22,9257
9928,中視,25,0,25,凱基-林口,2023-11-22,9257
3437,榮創,24,0,24,凱基-林口,2023-11-22,9257
6770,力積電,24,2,22,凱基-林口,2023-11-22,9257
2020,美亞,21,0,21,凱基-林口,2023-11-22,9257
2331,精英,21,0,21,凱基-林口,2023-11-22,9257
2377,微星,21,0,21,凱基-林口,2023-11-22,9257
8112,至上,21,0,21,凱基-林口,2023-11-22,9257
6568,宏觀,20,0,20,凱基-林口,2023-11-22,9257
8936,國統,26,6,20,凱基-林口,2023-11-22,9257
6533,晶心科,20,0,20,凱基-林口,2023-11-22,9257
2353,宏��,19,1,18,凱基-林口,2023-11-22,9257
00919,群益台灣精選高息,17,0,17,凱基-林口,2023-11-22,9257
2405,輔信,24,10,14,凱基-林口,2023-11-22,9257
3059,華晶科,17,3,14,凱基-林口,2023-11-22,9257
2376,技嘉,14,1,13,凱基-林口,2023-11-22,9257
00751B,元大AAA至A公司債,13,0,13,凱基-林口,2023-11-22,9257
00679B,元大美債20年,13,0,13,凱基-林口,2023-11-22,9257
2317,鴻海,14,2,12,凱基-林口,2023-11-22,9257
00687B,國泰20年美債,12,0,12,凱基-林口,2023-11-22,9257
3051,力特,20,8,12,凱基-林口,2023-11-22,9257
3230,錦明,12,0,12,凱基-林口,2023-11-22,9257
9950,萬國通,13,1,12,凱基-林口,2023-11-22,9257
3481,群創,20,9,11,凱基-林口,2023-11-22,9257
3227,原相,13,2,11,凱基-林口,2023-11-22,9257
1540,喬福,10,0,10,凱基-林口,2023-11-22,9257
5608,四維航,10,0,10,凱基-林口,2023-11-22,9257
6667,信紘科,10,0,10,凱基-林口,2023-11-22,9257
6695,芯鼎,11,1,10,凱基-林口,2023-11-22,9257
8011,台通,15,5,10,凱基-林口,2023-11-22,9257
00915,凱基優選高股息30,9,0,9,凱基-林口,2023-11-22,9257
2481,強茂,9,0,9,凱基-林口,2023-11-22,9257
3548,兆利,19,10,9,凱基-林口,2023-11-22,9257
2504,國產,10,1,9,凱基-林口,2023-11-22,9257
2356,英業達,23,15,8,凱基-林口,2023-11-22,9257
00905,FT臺灣Smart,8,0,8,凱基-林口,2023-11-22,9257
2467,志聖,559,6,553,凱基-林口,2023-11-23,9257
2363,矽統,118,31,87,凱基-林口,2023-11-23,9257
5521,工信,62,4,58,凱基-林口,2023-11-23,9257
5880,合庫金,56,0,56,凱基-林口,2023-11-23,9257
00919,群益台灣精選高息,55,0,55,凱基-林口,2023-11-23,9257
2516,新建,60,5,55,凱基-林口,2023-11-23,9257
3363,上詮,92,38,54,凱基-林口,2023-11-23,9257
3147,大綜,50,0,50,凱基-林口,2023-11-23,9257
6216,居易,50,0,50,凱基-林口,2023-11-23,9257
6237,驊訊,47,11,36,凱基-林口,2023-11-23,9257
1727,中華化,35,0,35,凱基-林口,2023-11-23,9257
3209,全科,35,0,35,凱基-林口,2023-11-23,9257
8054,安國,37,5,32,凱基-林口,2023-11-23,9257
00753L,中信中國50正2,30,0,30,凱基-林口,2023-11-23,9257
6138,茂達,43,17,26,凱基-林口,2023-11-23,9257
2801,彰銀,21,0,21,凱基-林口,2023-11-23,9257
6485,點序,19,0,19,凱基-林口,2023-11-23,9257
00637L,元大滬深300正2,19,1,18,凱基-林口,2023-11-23,9257
2329,華泰,27,9,18,凱基-林口,2023-11-23,9257
2610,華航,17,0,17,凱基-林口,2023-11-23,9257
6104,創惟,20,3,17,凱基-林口,2023-11-23,9257
8277,商丞,17,0,17,凱基-林口,2023-11-23,9257
8121,越峰,15,0,15,凱基-林口,2023-11-23,9257
4967,十銓,20,6,14,凱基-林口,2023-11-23,9257
00878,國泰永續高股息,15,2,13,凱基-林口,2023-11-23,9257
6411,晶焱,13,0,13,凱基-林口,2023-11-23,9257
2382,廣達,18,5,13,凱基-林口,2023-11-23,9257
8358,金居,21,8,13,凱基-林口,2023-11-23,9257
00934,中信成長高股息,12,0,12,凱基-林口,2023-11-23,9257
2520,冠德,11,0,11,凱基-林口,2023-11-23,9257
6284,佳邦,12,1,11,凱基-林口,2023-11-23,9257
00712,復華富時不動產,10,0,10,凱基-林口,2023-11-23,9257
2337,旺宏,10,0,10,凱基-林口,2023-11-23,9257
6118,建達,10,0,10,凱基-林口,2023-11-23,9257
9105,泰金寶-DR,10,0,10,凱基-林口,2023-11-23,9257
6139,亞翔,10,0,10,凱基-林口,2023-11-23,9257
1524,耿鼎,12,3,9,凱基-林口,2023-11-23,9257
2455,全新,11,2,9,凱基-林口,2023-11-23,9257
3013,晟銘電,11,2,9,凱基-林口,2023-11-23,9257
2891,中信金,11,2,9,凱基-林口,2023-11-23,9257
2481,強茂,9,1,8,凱基-林口,2023-11-23,9257
2367,燿華,8,0,8,凱基-林口,2023-11-23,9257
2402,毅嘉,9,1,8,凱基-林口,2023-11-23,9257
2405,輔信,10,2,8,凱基-林口,2023-11-23,9257
3017,奇鋐,21,13,8,凱基-林口,2023-11-23,9257
5272,笙科,8,0,8,凱基-林口,2023-11-23,9257
6222,上揚,8,0,8,凱基-林口,2023-11-23,9257
6530,創威,13,5,8,凱基-林口,2023-11-23,9257
4908,前鼎,13,6,7,凱基-林口,2023-11-23,9257
6901,鑽石投資,18,11,7,凱基-林口,2023-11-23,9257
2467,志聖,681,4,677,凱基-林口,2023-11-24,9257
2867,三商壽,413,0,413,凱基-林口,2023-11-24,9257
00898,國泰基因免疫革命,100,0,100,凱基-林口,2023-11-24,9257
5880,合庫金,80,0,80,凱基-林口,2023-11-24,9257
4956,光鋐,70,3,67,凱基-林口,2023-11-24,9257
2610,華航,55,2,53,凱基-林口,2023-11-24,9257
1795,美時,52,0,52,凱基-林口,2023-11-24,9257
6216,居易,36,0,36,凱基-林口,2023-11-24,9257
4720,德淵,35,0,35,凱基-林口,2023-11-24,9257
2516,新建,30,4,26,凱基-林口,2023-11-24,9257
2618,長榮航,23,1,22,凱基-林口,2023-11-24,9257
1457,宜進,20,0,20,凱基-林口,2023-11-24,9257
1711,永光,20,0,20,凱基-林口,2023-11-24,9257
2337,旺宏,20,0,20,凱基-林口,2023-11-24,9257
5452,佶優,20,0,20,凱基-林口,2023-11-24,9257
5351,鈺創,44,24,20,凱基-林口,2023-11-24,9257
1314,中石化,20,1,19,凱基-林口,2023-11-24,9257
6533,晶心科,20,1,19,凱基-林口,2023-11-24,9257
4543,萬在,17,0,17,凱基-林口,2023-11-24,9257
00878,國泰永續高股息,17,0,17,凱基-林口,2023-11-24,9257
1815,富喬,22,6,16,凱基-林口,2023-11-24,9257
1727,中華化,15,0,15,凱基-林口,2023-11-24,9257
4909,新復興,14,1,13,凱基-林口,2023-11-24,9257
00885,富邦越南,12,0,12,凱基-林口,2023-11-24,9257
2498,宏達電,12,0,12,凱基-林口,2023-11-24,9257
2356,英業達,11,0,11,凱基-林口,2023-11-24,9257
2363,矽統,38,27,11,凱基-林口,2023-11-24,9257
2609,陽明,11,0,11,凱基-林口,2023-11-24,9257
3044,健鼎,11,0,11,凱基-林口,2023-11-24,9257
00687B,國泰20年美債,11,0,11,凱基-林口,2023-11-24,9257
3052,夆典,10,0,10,凱基-林口,2023-11-24,9257
3287,廣寰科,10,0,10,凱基-林口,2023-11-24,9257
3701,大眾控,10,0,10,凱基-林口,2023-11-24,9257
3045,台灣大,10,0,10,凱基-林口,2023-11-24,9257
1612,宏泰,10,1,9,凱基-林口,2023-11-24,9257
2352,佳世達,9,0,9,凱基-林口,2023-11-24,9257
5222,全訊,21,12,9,凱基-林口,2023-11-24,9257
00679B,元大美債20年,8,0,8,凱基-林口,2023-11-24,9257
00795B,中信美國公債20年,8,0,8,凱基-林口,2023-11-24,9257
2364,倫飛,9,1,8,凱基-林口,2023-11-24,9257
6164,華興,10,2,8,凱基-林口,2023-11-24,9257
6168,宏齊,10,2,8,凱基-林口,2023-11-24,9257
2382,廣達,18,11,7,凱基-林口,2023-11-24,9257
00724B,群益投資級金融債,7,0,7,凱基-林口,2023-11-24,9257
2891,中信金,7,0,7,凱基-林口,2023-11-24,9257
3016,嘉晶,7,0,7,凱基-林口,2023-11-24,9257
3031,佰鴻,7,0,7,凱基-林口,2023-11-24,9257
6278,台表科,7,0,7,凱基-林口,2023-11-24,9257
8088,品安,7,0,7,凱基-林口,2023-11-24,9257
00751B,元大AAA至A公司債,6,0,6,凱基-林口,2023-11-24,9257
00637L,元大滬深300正2,343,0,343,凱基-林口,2023-11-27,9257
2867,三商壽,76,0,76,凱基-林口,2023-11-27,9257
00878,國泰永續高股息,61,2,59,凱基-林口,2023-11-27,9257
6245,立端,54,0,54,凱基-林口,2023-11-27,9257
5521,工信,70,18,52,凱基-林口,2023-11-27,9257
1440,南紡,50,0,50,凱基-林口,2023-11-27,9257
6235,華孚,49,4,45,凱基-林口,2023-11-27,9257
00919,群益台灣精選高息,45,1,44,凱基-林口,2023-11-27,9257
00633L,富邦上証正2,40,0,40,凱基-林口,2023-11-27,9257
2883,凱基金,44,4,40,凱基-林口,2023-11-27,9257
3494,誠研,30,0,30,凱基-林口,2023-11-27,9257
6194,育富,30,0,30,凱基-林口,2023-11-27,9257
6216,居易,30,1,29,凱基-林口,2023-11-27,9257
00918,大華優利高填息30,29,1,28,凱基-林口,2023-11-27,9257
2888,新光金,50,23,27,凱基-林口,2023-11-27,9257
5347,世界,31,7,24,凱基-林口,2023-11-27,9257
00929,復華台灣科技優息,41,18,23,凱基-林口,2023-11-27,9257
1710,東聯,22,0,22,凱基-林口,2023-11-27,9257
2382,廣達,26,5,21,凱基-林口,2023-11-27,9257
2344,華邦電,30,10,20,凱基-林口,2023-11-27,9257
2850,新產,20,0,20,凱基-林口,2023-11-27,9257
3705,永信,20,1,19,凱基-林口,2023-11-27,9257
5351,鈺創,34,15,19,凱基-林口,2023-11-27,9257
2363,矽統,39,21,18,凱基-林口,2023-11-27,9257
3035,智原,18,1,17,凱基-林口,2023-11-27,9257
1612,宏泰,16,0,16,凱基-林口,2023-11-27,9257
0056,元大高股息,14,0,14,凱基-林口,2023-11-27,9257
00687B,國泰20年美債,15,1,14,凱基-林口,2023-11-27,9257
3583,辛耘,15,2,13,凱基-林口,2023-11-27,9257
9950,萬國通,12,0,12,凱基-林口,2023-11-27,9257
3017,奇鋐,14,3,11,凱基-林口,2023-11-27,9257
2455,全新,12,1,11,凱基-林口,2023-11-27,9257
3715,定穎投控,12,1,11,凱基-林口,2023-11-27,9257
00915,凱基優選高股息30,10,0,10,凱基-林口,2023-11-27,9257
1529,樂事綠能,12,2,10,凱基-林口,2023-11-27,9257
2105,正新,10,0,10,凱基-林口,2023-11-27,9257
3058,立德,13,3,10,凱基-林口,2023-11-27,9257
3287,廣寰科,10,0,10,凱基-林口,2023-11-27,9257
3437,榮創,11,1,10,凱基-林口,2023-11-27,9257
4714,永捷,10,0,10,凱基-林口,2023-11-27,9257
5465,富驊,10,0,10,凱基-林口,2023-11-27,9257
6197,佳必琪,10,0,10,凱基-林口,2023-11-27,9257
2330,台積電,9,0,9,凱基-林口,2023-11-27,9257
2516,新建,13,4,9,凱基-林口,2023-11-27,9257
2834,臺企銀,9,0,9,凱基-林口,2023-11-27,9257
3081,聯亞,9,1,8,凱基-林口,2023-11-27,9257
2630,亞航,9,1,8,凱基-林口,2023-11-27,9257
3105,穩懋,8,1,7,凱基-林口,2023-11-27,9257
8086,宏捷科,11,4,7,凱基-林口,2023-11-27,9257
1810,和成,7,0,7,凱基-林口,2023-11-27,9257
2457,飛宏,79,16,63,凱基-林口,2023-11-28,9257
6125,廣運,60,1,59,凱基-林口,2023-11-28,9257
2891,中信金,70,14,56,凱基-林口,2023-11-28,9257
00680L,元大美債20正2,40,0,40,凱基-林口,2023-11-28,9257
4102,永日,40,0,40,凱基-林口,2023-11-28,9257
2472,立隆電,45,7,38,凱基-林口,2023-11-28,9257
3706,神達,40,2,38,凱基-林口,2023-11-28,9257
00633L,富邦上証正2,30,0,30,凱基-林口,2023-11-28,9257
1455,集盛,30,0,30,凱基-林口,2023-11-28,9257
2883,凱基金,54,27,27,凱基-林口,2023-11-28,9257
2344,華邦電,25,0,25,凱基-林口,2023-11-28,9257
1795,美時,25,1,24,凱基-林口,2023-11-28,9257
1101,台泥,34,14,20,凱基-林口,2023-11-28,9257
2258,鴻華先進-創,20,0,20,凱基-林口,2023-11-28,9257
2897,王道銀行,20,0,20,凱基-林口,2023-11-28,9257
6216,居易,20,0,20,凱基-林口,2023-11-28,9257
6482,弘煜科,20,0,20,凱基-林口,2023-11-28,9257
3373,熱映,20,0,20,凱基-林口,2023-11-28,9257
2492,華新科,45,25,20,凱基-林口,2023-11-28,9257
2317,鴻海,22,3,19,凱基-林口,2023-11-28,9257
3715,定穎投控,21,3,18,凱基-林口,2023-11-28,9257
5347,世界,21,3,18,凱基-林口,2023-11-28,9257
4114,健喬,28,10,18,凱基-林口,2023-11-28,9257
3041,揚智,18,1,17,凱基-林口,2023-11-28,9257
00712,復華富時不動產,15,0,15,凱基-林口,2023-11-28,9257
6217,中探針,15,0,15,凱基-林口,2023-11-28,9257
2641,正德,17,3,14,凱基-林口,2023-11-28,9257
00934,中信成長高股息,13,0,13,凱基-林口,2023-11-28,9257
8926,台汽電,13,0,13,凱基-林口,2023-11-28,9257
00885,富邦越南,22,12,10,凱基-林口,2023-11-28,9257
00706L,期元大S＆P日圓正2,10,0,10,凱基-林口,2023-11-28,9257
00720B,元大投資級公司債,10,0,10,凱基-林口,2023-11-28,9257
5531,鄉林,10,0,10,凱基-林口,2023-11-28,9257
8011,台通,10,0,10,凱基-林口,2023-11-28,9257
2882,國泰金,10,1,9,凱基-林口,2023-11-28,9257
00632R,元大台灣50反1,9,0,9,凱基-林口,2023-11-28,9257
00923,群益台ESG低碳50,10,1,9,凱基-林口,2023-11-28,9257
3481,群創,20,11,9,凱基-林口,2023-11-28,9257
2353,宏��,10,2,8,凱基-林口,2023-11-28,9257
6194,育富,8,0,8,凱基-林口,2023-11-28,9257
6204,艾華,8,0,8,凱基-林口,2023-11-28,9257
3305,昇貿,7,0,7,凱基-林口,2023-11-28,9257
00919,群益台灣精選高息,6,0,6,凱基-林口,2023-11-28,9257
2360,致茂,6,0,6,凱基-林口,2023-11-28,9257
3005,神基,10,4,6,凱基-林口,2023-11-28,9257
2367,燿華,19,13,6,凱基-林口,2023-11-28,9257
00637L,元大滬深300正2,5,0,5,凱基-林口,2023-11-28,9257
3227,原相,5,0,5,凱基-林口,2023-11-28,9257
4128,中天,5,0,5,凱基-林口,2023-11-28,9257
4953,緯軟,5,0,5,凱基-林口,2023-11-28,9257
00637L,元大滬深300正2,238,0,238,凱基-林口,2023-11-29,9257
2867,三商壽,200,0,200,凱基-林口,2023-11-29,9257
5347,世界,128,2,126,凱基-林口,2023-11-29,9257
1618,合機,112,1,111,凱基-林口,2023-11-29,9257
9105,泰金寶-DR,100,0,100,凱基-林口,2023-11-29,9257
6684,安格,56,4,52,凱基-林口,2023-11-29,9257
2363,矽統,55,16,39,凱基-林口,2023-11-29,9257
2492,華新科,51,17,34,凱基-林口,2023-11-29,9257
00712,復華富時不動產,33,0,33,凱基-林口,2023-11-29,9257
2618,長榮航,102,72,30,凱基-林口,2023-11-29,9257
1314,中石化,30,0,30,凱基-林口,2023-11-29,9257
4533,協易機,30,0,30,凱基-林口,2023-11-29,9257
2402,毅嘉,28,1,27,凱基-林口,2023-11-29,9257
6138,茂達,20,0,20,凱基-林口,2023-11-29,9257
00885,富邦越南,20,0,20,凱基-林口,2023-11-29,9257
3014,聯陽,20,0,20,凱基-林口,2023-11-29,9257
6125,廣運,82,62,20,凱基-林口,2023-11-29,9257
1732,毛寶,20,2,18,凱基-林口,2023-11-29,9257
3231,緯創,33,16,17,凱基-林口,2023-11-29,9257
00687B,國泰20年美債,17,0,17,凱基-林口,2023-11-29,9257
00751B,元大AAA至A公司債,29,13,16,凱基-林口,2023-11-29,9257
1513,中興電,28,12,16,凱基-林口,2023-11-29,9257
3041,揚智,15,0,15,凱基-林口,2023-11-29,9257
4958,臻鼎-KY,15,0,15,凱基-林口,2023-11-29,9257
00680L,元大美債20正2,14,0,14,凱基-林口,2023-11-29,9257
00882,中信中國高股息,14,0,14,凱基-林口,2023-11-29,9257
2383,台光電,15,2,13,凱基-林口,2023-11-29,9257
00923,群益台ESG低碳50,13,0,13,凱基-林口,2023-11-29,9257
2352,佳世達,13,1,12,凱基-林口,2023-11-29,9257
2897,王道銀行,12,0,12,凱基-林口,2023-11-29,9257
6695,芯鼎,18,6,12,凱基-林口,2023-11-29,9257
3005,神基,20,10,10,凱基-林口,2023-11-29,9257
00918,大華優利高填息30,10,0,10,凱基-林口,2023-11-29,9257
2031,新光鋼,10,0,10,凱基-林口,2023-11-29,9257
2417,圓剛,10,0,10,凱基-林口,2023-11-29,9257
2707,晶華,14,4,10,凱基-林口,2023-11-29,9257
3025,星通,14,4,10,凱基-林口,2023-11-29,9257
5607,遠雄港,10,0,10,凱基-林口,2023-11-29,9257
6175,立敦,10,0,10,凱基-林口,2023-11-29,9257
6285,啟��,10,0,10,凱基-林口,2023-11-29,9257
6491,晶碩,10,0,10,凱基-林口,2023-11-29,9257
00919,群益台灣精選高息,11,2,9,凱基-林口,2023-11-29,9257
2301,光寶科,10,1,9,凱基-林口,2023-11-29,9257
2442,新美齊,10,1,9,凱基-林口,2023-11-29,9257
2460,建通,10,1,9,凱基-林口,2023-11-29,9257
3689,湧德,12,3,9,凱基-林口,2023-11-29,9257
6482,弘煜科,9,0,9,凱基-林口,2023-11-29,9257
8996,高力,10,1,9,凱基-林口,2023-11-29,9257
00893,國泰智能電動車,8,0,8,凱基-林口,2023-11-29,9257
2457,飛宏,29,21,8,凱基-林口,2023-11-29,9257
00680L,元大美債20正2,353,0,353,凱基-林口,2023-11-30,9257
1618,合機,104,0,104,凱基-林口,2023-11-30,9257
8096,擎亞,85,0,85,凱基-林口,2023-11-30,9257
2883,凱基金,88,35,53,凱基-林口,2023-11-30,9257
2891,中信金,60,14,46,凱基-林口,2023-11-30,9257
2317,鴻海,35,0,35,凱基-林口,2023-11-30,9257
00919,群益台灣精選高息,31,0,31,凱基-林口,2023-11-30,9257
00929,復華台灣科技優息,47,16,31,凱基-林口,2023-11-30,9257
3189,景碩,31,0,31,凱基-林口,2023-11-30,9257
2338,光罩,79,49,30,凱基-林口,2023-11-30,9257
2313,華通,32,10,22,凱基-林口,2023-11-30,9257
5388,中磊,20,0,20,凱基-林口,2023-11-30,9257
3147,大綜,21,1,20,凱基-林口,2023-11-30,9257
4720,德淵,20,0,20,凱基-林口,2023-11-30,9257
5347,世界,20,0,20,凱基-林口,2023-11-30,9257
4543,萬在,19,0,19,凱基-林口,2023-11-30,9257
2363,矽統,34,16,18,凱基-林口,2023-11-30,9257
1455,集盛,16,1,15,凱基-林口,2023-11-30,9257
2457,飛宏,19,4,15,凱基-林口,2023-11-30,9257
00637L,元大滬深300正2,14,0,14,凱基-林口,2023-11-30,9257
2492,華新科,19,5,14,凱基-林口,2023-11-30,9257
4908,前鼎,14,0,14,凱基-林口,2023-11-30,9257
5465,富驊,25,11,14,凱基-林口,2023-11-30,9257
00885,富邦越南,13,0,13,凱基-林口,2023-11-30,9257
2888,新光金,12,0,12,凱基-林口,2023-11-30,9257
3013,晟銘電,24,13,11,凱基-林口,2023-11-30,9257
6173,信昌電,11,0,11,凱基-林口,2023-11-30,9257
00891,中信關鍵半導體,10,0,10,凱基-林口,2023-11-30,9257
00753L,中信中國50正2,10,0,10,凱基-林口,2023-11-30,9257
2458,義隆,20,10,10,凱基-林口,2023-11-30,9257
2530,華建,10,0,10,凱基-林口,2023-11-30,9257
6118,建達,20,10,10,凱基-林口,2023-11-30,9257
6213,聯茂,10,0,10,凱基-林口,2023-11-30,9257
6243,迅杰,10,0,10,凱基-林口,2023-11-30,9257
2707,晶華,8,0,8,凱基-林口,2023-11-30,9257
6799,來頡,8,0,8,凱基-林口,2023-11-30,9257
00679B,元大美債20年,8,0,8,凱基-林口,2023-11-30,9257
2379,瑞昱,7,0,7,凱基-林口,2023-11-30,9257
3017,奇鋐,8,1,7,凱基-林口,2023-11-30,9257
6104,創惟,10,3,7,凱基-林口,2023-11-30,9257
3231,緯創,9,3,6,凱基-林口,2023-11-30,9257
00878,國泰永續高股息,23,17,6,凱基-林口,2023-11-30,9257
2441,超豐,6,0,6,凱基-林口,2023-11-30,9257
3227,原相,6,0,6,凱基-林口,2023-11-30,9257
00687B,國泰20年美債,5,0,5,凱基-林口,2023-11-30,9257
1319,東陽,5,0,5,凱基-林口,2023-11-30,9257
2383,台光電,13,8,5,凱基-林口,2023-11-30,9257
2402,毅嘉,14,9,5,凱基-林口,2023-11-30,9257
2834,臺企銀,7,2,5,凱基-林口,2023-11-30,9257
3035,智原,19,14,5,凱基-林口,2023-11-30,9257
2883,凱基金,1022,21,1001,凱基-林口,2023-12-01,9257
00919,群益台灣精選高息,173,20,153,凱基-林口,2023-12-01,9257
8150,南茂,80,1,79,凱基-林口,2023-12-01,9257
00687B,國泰20年美債,51,0,51,凱基-林口,2023-12-01,9257
0056,元大高股息,53,4,49,凱基-林口,2023-12-01,9257
00637L,元大滬深300正2,48,0,48,凱基-林口,2023-12-01,9257
3706,神達,67,22,45,凱基-林口,2023-12-01,9257
2363,矽統,52,12,40,凱基-林口,2023-12-01,9257
2884,玉山金,40,0,40,凱基-林口,2023-12-01,9257
2888,新光金,37,2,35,凱基-林口,2023-12-01,9257
8054,安國,46,15,31,凱基-林口,2023-12-01,9257
5347,世界,29,1,28,凱基-林口,2023-12-01,9257
4720,德淵,26,0,26,凱基-林口,2023-12-01,9257
2409,友達,23,0,23,凱基-林口,2023-12-01,9257
2618,長榮航,26,4,22,凱基-林口,2023-12-01,9257
2317,鴻海,21,1,20,凱基-林口,2023-12-01,9257
5521,工信,20,0,20,凱基-林口,2023-12-01,9257
00929,復華台灣科技優息,24,5,19,凱基-林口,2023-12-01,9257
3147,大綜,17,0,17,凱基-林口,2023-12-01,9257
0050,元大台灣50,16,1,15,凱基-林口,2023-12-01,9257
1101,台泥,15,0,15,凱基-林口,2023-12-01,9257
00715L,期街口布蘭特正2,14,0,14,凱基-林口,2023-12-01,9257
5880,合庫金,13,0,13,凱基-林口,2023-12-01,9257
00935,野村臺灣新科技50,13,0,13,凱基-林口,2023-12-01,9257
00915,凱基優選高股息30,12,0,12,凱基-林口,2023-12-01,9257
3545,敦泰,28,16,12,凱基-林口,2023-12-01,9257
2382,廣達,22,11,11,凱基-林口,2023-12-01,9257
1522,堤維西,26,15,11,凱基-林口,2023-12-01,9257
4109,加捷生醫,11,0,11,凱基-林口,2023-12-01,9257
4142,國光生,11,0,11,凱基-林口,2023-12-01,9257
5465,富驊,16,5,11,凱基-林口,2023-12-01,9257
1409,新纖,10,0,10,凱基-林口,2023-12-01,9257
2324,仁寶,10,0,10,凱基-林口,2023-12-01,9257
2515,中工,10,0,10,凱基-林口,2023-12-01,9257
3390,旭軟,11,1,10,凱基-林口,2023-12-01,9257
4533,協易機,10,0,10,凱基-林口,2023-12-01,9257
00679B,元大美債20年,9,0,9,凱基-林口,2023-12-01,9257
00918,大華優利高填息30,9,0,9,凱基-林口,2023-12-01,9257
3512,皇龍,9,0,9,凱基-林口,2023-12-01,9257
2367,燿華,14,6,8,凱基-林口,2023-12-01,9257
2402,毅嘉,44,36,8,凱基-林口,2023-12-01,9257
5425,台半,11,3,8,凱基-林口,2023-12-01,9257
00893,國泰智能電動車,7,0,7,凱基-林口,2023-12-01,9257
00795B,中信美國公債20年,7,0,7,凱基-林口,2023-12-01,9257
1514,亞力,38,31,7,凱基-林口,2023-12-01,9257
6147,頎邦,7,0,7,凱基-林口,2023-12-01,9257
00885,富邦越南,6,0,6,凱基-林口,2023-12-01,9257
2009,第一銅,6,0,6,凱基-林口,2023-12-01,9257
2481,強茂,8,2,6,凱基-林口,2023-12-01,9257
2609,陽明,22,16,6,凱基-林口,2023-12-01,9257
2883,凱基金,215,10,205,凱基-林口,2023-12-04,9257
00637L,元大滬深300正2,205,0,205,凱基-林口,2023-12-04,9257
1618,合機,124,2,122,凱基-林口,2023-12-04,9257
00919,群益台灣精選高息,111,5,106,凱基-林口,2023-12-04,9257
4533,協易機,55,1,54,凱基-林口,2023-12-04,9257
00882,中信中國高股息,46,0,46,凱基-林口,2023-12-04,9257
3450,聯鈞,49,4,45,凱基-林口,2023-12-04,9257
2641,正德,50,6,44,凱基-林口,2023-12-04,9257
2634,漢翔,51,8,43,凱基-林口,2023-12-04,9257
5465,富驊,44,1,43,凱基-林口,2023-12-04,9257
1605,華新,49,7,42,凱基-林口,2023-12-04,9257
00687B,國泰20年美債,41,0,41,凱基-林口,2023-12-04,9257
3147,大綜,40,0,40,凱基-林口,2023-12-04,9257
3715,定穎投控,38,3,35,凱基-林口,2023-12-04,9257
00706L,期元大S＆P日圓正2,30,0,30,凱基-林口,2023-12-04,9257
2352,佳世達,37,7,30,凱基-林口,2023-12-04,9257
2367,燿華,39,11,28,凱基-林口,2023-12-04,9257
9919,康那香,34,8,26,凱基-林口,2023-12-04,9257
00680L,元大美債20正2,25,0,25,凱基-林口,2023-12-04,9257
3363,上詮,21,0,21,凱基-林口,2023-12-04,9257
1609,大亞,20,0,20,凱基-林口,2023-12-04,9257
9103,美德醫療-DR,20,0,20,凱基-林口,2023-12-04,9257
2329,華泰,41,25,16,凱基-林口,2023-12-04,9257
1616,億泰,16,0,16,凱基-林口,2023-12-04,9257
2618,長榮航,28,12,16,凱基-林口,2023-12-04,9257
2436,偉詮電,20,5,15,凱基-林口,2023-12-04,9257
6233,旺玖,16,1,15,凱基-林口,2023-12-04,9257
00751B,元大AAA至A公司債,18,5,13,凱基-林口,2023-12-04,9257
8086,宏捷科,18,5,13,凱基-林口,2023-12-04,9257
2301,光寶科,20,7,13,凱基-林口,2023-12-04,9257
6245,立端,12,0,12,凱基-林口,2023-12-04,9257
3013,晟銘電,36,24,12,凱基-林口,2023-12-04,9257
1568,倉佑,11,0,11,凱基-林口,2023-12-04,9257
3390,旭軟,11,0,11,凱基-林口,2023-12-04,9257
1409,新纖,10,0,10,凱基-林口,2023-12-04,9257
2258,鴻華先進-創,10,0,10,凱基-林口,2023-12-04,9257
2316,楠梓電,10,0,10,凱基-林口,2023-12-04,9257
2338,光罩,10,0,10,凱基-林口,2023-12-04,9257
2601,益航,10,0,10,凱基-林口,2023-12-04,9257
3305,昇貿,10,0,10,凱基-林口,2023-12-04,9257
00929,復華台灣科技優息,21,12,9,凱基-林口,2023-12-04,9257
2363,矽統,31,22,9,凱基-林口,2023-12-04,9257
2614,東森,11,2,9,凱基-林口,2023-12-04,9257
6243,迅杰,10,1,9,凱基-林口,2023-12-04,9257
1701,中化,10,2,8,凱基-林口,2023-12-04,9257
2880,華南金,10,2,8,凱基-林口,2023-12-04,9257
3481,群創,17,10,7,凱基-林口,2023-12-04,9257
1101,台泥,12,5,7,凱基-林口,2023-12-04,9257
2489,瑞軒,10,3,7,凱基-林口,2023-12-04,9257
2612,中航,12,5,7,凱基-林口,2023-12-04,9257
00937B,群益ESG投等債20,291,16,275,凱基-林口,2023-12-05,9257
00918,大華優利高填息30,134,0,134,凱基-林口,2023-12-05,9257
2409,友達,114,8,106,凱基-林口,2023-12-05,9257
2367,燿華,186,110,76,凱基-林口,2023-12-05,9257
00929,復華台灣科技優息,58,10,48,凱基-林口,2023-12-05,9257
2515,中工,75,30,45,凱基-林口,2023-12-05,9257
2363,矽統,53,10,43,凱基-林口,2023-12-05,9257
00712,復華富時不動產,50,9,41,凱基-林口,2023-12-05,9257
1409,新纖,40,0,40,凱基-林口,2023-12-05,9257
4113,聯上,40,0,40,凱基-林口,2023-12-05,9257
00878,國泰永續高股息,45,5,40,凱基-林口,2023-12-05,9257
2612,中航,59,20,39,凱基-林口,2023-12-05,9257
3035,智原,45,9,36,凱基-林口,2023-12-05,9257
00650L,復華香港正2,34,0,34,凱基-林口,2023-12-05,9257
00637L,元大滬深300正2,32,0,32,凱基-林口,2023-12-05,9257
6426,統新,31,0,31,凱基-林口,2023-12-05,9257
8183,精星,31,0,31,凱基-林口,2023-12-05,9257
00931B,統一美債20年,31,0,31,凱基-林口,2023-12-05,9257
00882,中信中國高股息,30,0,30,凱基-林口,2023-12-05,9257
0056,元大高股息,47,18,29,凱基-林口,2023-12-05,9257
3450,聯鈞,26,3,23,凱基-林口,2023-12-05,9257
2329,華泰,49,26,23,凱基-林口,2023-12-05,9257
00680L,元大美債20正2,20,0,20,凱基-林口,2023-12-05,9257
2338,光罩,20,0,20,凱基-林口,2023-12-05,9257
5469,瀚宇博,31,11,20,凱基-林口,2023-12-05,9257
00751B,元大AAA至A公司債,22,3,19,凱基-林口,2023-12-05,9257
5347,世界,42,23,19,凱基-林口,2023-12-05,9257
8054,安國,21,2,19,凱基-林口,2023-12-05,9257
2405,輔信,20,2,18,凱基-林口,2023-12-05,9257
2610,華航,18,1,17,凱基-林口,2023-12-05,9257
2489,瑞軒,14,0,14,凱基-林口,2023-12-05,9257
2888,新光金,14,0,14,凱基-林口,2023-12-05,9257
6233,旺玖,16,2,14,凱基-林口,2023-12-05,9257
00923,群益台ESG低碳50,13,0,13,凱基-林口,2023-12-05,9257
3231,緯創,24,11,13,凱基-林口,2023-12-05,9257
2344,華邦電,14,2,12,凱基-林口,2023-12-05,9257
2601,益航,14,2,12,凱基-林口,2023-12-05,9257
2886,兆豐金,12,0,12,凱基-林口,2023-12-05,9257
3715,定穎投控,25,14,11,凱基-林口,2023-12-05,9257
1314,中石化,11,0,11,凱基-林口,2023-12-05,9257
2605,新興,72,61,11,凱基-林口,2023-12-05,9257
2607,榮運,19,8,11,凱基-林口,2023-12-05,9257
2891,中信金,10,0,10,凱基-林口,2023-12-05,9257
1528,恩德,10,0,10,凱基-林口,2023-12-05,9257
1582,信錦,11,1,10,凱基-林口,2023-12-05,9257
2371,大同,20,10,10,凱基-林口,2023-12-05,9257
2809,京城銀,10,0,10,凱基-林口,2023-12-05,9257
3260,威剛,11,1,10,凱基-林口,2023-12-05,9257
3363,上詮,10,0,10,凱基-林口,2023-12-05,9257
6191,精成科,10,0,10,凱基-林口,2023-12-05,9257
00937B,群益ESG投等債20,368,0,368,凱基-林口,2023-12-06,9257
00680L,元大美債20正2,220,0,220,凱基-林口,2023-12-06,9257
8150,南茂,93,0,93,凱基-林口,2023-12-06,9257
3050,鈺德,80,4,76,凱基-林口,2023-12-06,9257
00929,復華台灣科技優息,72,4,68,凱基-林口,2023-12-06,9257
00919,群益台灣精選高息,264,202,62,凱基-林口,2023-12-06,9257
00687B,國泰20年美債,52,1,51,凱基-林口,2023-12-06,9257
00637L,元大滬深300正2,43,0,43,凱基-林口,2023-12-06,9257
00753L,中信中國50正2,30,0,30,凱基-林口,2023-12-06,9257
1513,中興電,51,22,29,凱基-林口,2023-12-06,9257
1605,華新,28,0,28,凱基-林口,2023-12-06,9257
2317,鴻海,23,0,23,凱基-林口,2023-12-06,9257
2889,國票金,20,0,20,凱基-林口,2023-12-06,9257
3481,群創,17,2,15,凱基-林口,2023-12-06,9257
3558,神準,17,3,14,凱基-林口,2023-12-06,9257
00679B,元大美債20年,14,2,12,凱基-林口,2023-12-06,9257
00751B,元大AAA至A公司債,12,0,12,凱基-林口,2023-12-06,9257
00931B,統一美債20年,12,0,12,凱基-林口,2023-12-06,9257
4413,飛寶企業,12,0,12,凱基-林口,2023-12-06,9257
6143,振曜,13,1,12,凱基-林口,2023-12-06,9257
6180,橘子,12,0,12,凱基-林口,2023-12-06,9257
1612,宏泰,11,0,11,凱基-林口,2023-12-06,9257
2352,佳世達,11,0,11,凱基-林口,2023-12-06,9257
2358,廷鑫,11,0,11,凱基-林口,2023-12-06,9257
3715,定穎投控,21,11,10,凱基-林口,2023-12-06,9257
2489,瑞軒,10,0,10,凱基-林口,2023-12-06,9257
3419,譁裕,10,0,10,凱基-林口,2023-12-06,9257
00915,凱基優選高股息30,10,0,10,凱基-林口,2023-12-06,9257
3013,晟銘電,26,17,9,凱基-林口,2023-12-06,9257
2201,裕隆,12,3,9,凱基-林口,2023-12-06,9257
1815,富喬,10,1,9,凱基-林口,2023-12-06,9257
2498,宏達電,10,1,9,凱基-林口,2023-12-06,9257
1710,東聯,8,0,8,凱基-林口,2023-12-06,9257
2338,光罩,8,0,8,凱基-林口,2023-12-06,9257
3548,兆利,10,2,8,凱基-林口,2023-12-06,9257
4533,協易機,8,0,8,凱基-林口,2023-12-06,9257
2606,裕民,16,9,7,凱基-林口,2023-12-06,9257
2303,聯電,11,4,7,凱基-林口,2023-12-06,9257
1303,南亞,7,0,7,凱基-林口,2023-12-06,9257
2408,南亞科,7,0,7,凱基-林口,2023-12-06,9257
2542,興富發,7,0,7,凱基-林口,2023-12-06,9257
3229,晟鈦,7,0,7,凱基-林口,2023-12-06,9257
2388,威盛,12,5,7,凱基-林口,2023-12-06,9257
6282,康舒,6,0,6,凱基-林口,2023-12-06,9257
00720B,元大投資級公司債,6,0,6,凱基-林口,2023-12-06,9257
1781,合世,6,0,6,凱基-林口,2023-12-06,9257
2328,廣宇,6,0,6,凱基-林口,2023-12-06,9257
2376,技嘉,12,6,6,凱基-林口,2023-12-06,9257
2537,聯上發,6,0,6,凱基-林口,2023-12-06,9257
3006,晶豪科,6,0,6,凱基-林口,2023-12-06,9257
00918,大華優利高填息30,234,0,234,凱基-林口,2023-12-07,9257
00937B,群益ESG投等債20,186,12,174,凱基-林口,2023-12-07,9257
2356,英業達,150,11,139,凱基-林口,2023-12-07,9257
2845,遠東銀,126,0,126,凱基-林口,2023-12-07,9257
00929,復華台灣科技優息,126,2,124,凱基-林口,2023-12-07,9257
3645,達邁,121,0,121,凱基-林口,2023-12-07,9257
00687B,國泰20年美債,84,1,83,凱基-林口,2023-12-07,9257
00919,群益台灣精選高息,81,0,81,凱基-林口,2023-12-07,9257
00712,復華富時不動產,72,0,72,凱基-林口,2023-12-07,9257
1612,宏泰,69,5,64,凱基-林口,2023-12-07,9257
1409,新纖,60,0,60,凱基-林口,2023-12-07,9257
00632R,元大台灣50反1,54,0,54,凱基-林口,2023-12-07,9257
3450,聯鈞,53,6,47,凱基-林口,2023-12-07,9257
2889,國票金,43,0,43,凱基-林口,2023-12-07,9257
00751B,元大AAA至A公司債,37,0,37,凱基-林口,2023-12-07,9257
00650L,復華香港正2,30,0,30,凱基-林口,2023-12-07,9257
2363,矽統,32,3,29,凱基-林口,2023-12-07,9257
2388,威盛,39,12,27,凱基-林口,2023-12-07,9257
8936,國統,29,2,27,凱基-林口,2023-12-07,9257
00637L,元大滬深300正2,25,0,25,凱基-林口,2023-12-07,9257
6843,進典,25,0,25,凱基-林口,2023-12-07,9257
00713,元大台灣高息低波,22,0,22,凱基-林口,2023-12-07,9257
2888,新光金,22,0,22,凱基-林口,2023-12-07,9257
4919,新唐,21,1,20,凱基-林口,2023-12-07,9257
4958,臻鼎-KY,20,0,20,凱基-林口,2023-12-07,9257
4960,誠美材,20,0,20,凱基-林口,2023-12-07,9257
4967,十銓,29,10,19,凱基-林口,2023-12-07,9257
5521,工信,20,5,15,凱基-林口,2023-12-07,9257
00931B,統一美債20年,17,2,15,凱基-林口,2023-12-07,9257
00727B,國泰優選非投等債,15,0,15,凱基-林口,2023-12-07,9257
2365,昆盈,14,0,14,凱基-林口,2023-12-07,9257
2367,燿華,29,16,13,凱基-林口,2023-12-07,9257
6151,晉倫,13,0,13,凱基-林口,2023-12-07,9257
00715L,期街口布蘭特正2,12,0,12,凱基-林口,2023-12-07,9257
00694B,富邦美債1-3,12,0,12,凱基-林口,2023-12-07,9257
2606,裕民,14,2,12,凱基-林口,2023-12-07,9257
3050,鈺德,17,5,12,凱基-林口,2023-12-07,9257
6237,驊訊,12,0,12,凱基-林口,2023-12-07,9257
2399,映泰,12,1,11,凱基-林口,2023-12-07,9257
2617,台航,11,0,11,凱基-林口,2023-12-07,9257
9917,中保科,10,0,10,凱基-林口,2023-12-07,9257
1471,首利,10,0,10,凱基-林口,2023-12-07,9257
1616,億泰,10,0,10,凱基-林口,2023-12-07,9257
2337,旺宏,10,0,10,凱基-林口,2023-12-07,9257
2836,高雄銀,10,0,10,凱基-林口,2023-12-07,9257
3045,台灣大,10,0,10,凱基-林口,2023-12-07,9257
3548,兆利,10,0,10,凱基-林口,2023-12-07,9257
6111,大宇資,10,0,10,凱基-林口,2023-12-07,9257
2102,泰豐,9,0,9,凱基-林口,2023-12-07,9257
2353,宏��,9,0,9,凱基-林口,2023-12-07,9257
2618,長榮航,468,32,436,凱基-林口,2023-12-08,9257
2356,英業達,544,180,364,凱基-林口,2023-12-08,9257
00929,復華台灣科技優息,105,21,84,凱基-林口,2023-12-08,9257
2376,技嘉,84,12,72,凱基-林口,2023-12-08,9257
2371,大同,92,33,59,凱基-林口,2023-12-08,9257
2303,聯電,65,10,55,凱基-林口,2023-12-08,9257
00919,群益台灣精選高息,51,0,51,凱基-林口,2023-12-08,9257
2605,新興,63,20,43,凱基-林口,2023-12-08,9257
4906,正文,43,1,42,凱基-林口,2023-12-08,9257
5388,中磊,41,0,41,凱基-林口,2023-12-08,9257
00772B,中信高評級公司債,39,0,39,凱基-林口,2023-12-08,9257
5347,世界,49,11,38,凱基-林口,2023-12-08,9257
00679B,元大美債20年,39,5,34,凱基-林口,2023-12-08,9257
00918,大華優利高填息30,34,0,34,凱基-林口,2023-12-08,9257
6414,樺漢,31,0,31,凱基-林口,2023-12-08,9257
00633L,富邦上証正2,30,0,30,凱基-林口,2023-12-08,9257
00687B,國泰20年美債,30,0,30,凱基-林口,2023-12-08,9257
2889,國票金,25,0,25,凱基-林口,2023-12-08,9257
00720B,元大投資級公司債,24,0,24,凱基-林口,2023-12-08,9257
00937B,群益ESG投等債20,53,31,22,凱基-林口,2023-12-08,9257
00680L,元大美債20正2,21,0,21,凱基-林口,2023-12-08,9257
4746,台耀,21,0,21,凱基-林口,2023-12-08,9257
4739,康普,20,0,20,凱基-林口,2023-12-08,9257
4960,誠美材,20,0,20,凱基-林口,2023-12-08,9257
4533,協易機,19,0,19,凱基-林口,2023-12-08,9257
00637L,元大滬深300正2,13,0,13,凱基-林口,2023-12-08,9257
2610,華航,26,13,13,凱基-林口,2023-12-08,9257
4426,利勤,13,0,13,凱基-林口,2023-12-08,9257
00931B,統一美債20年,11,0,11,凱基-林口,2023-12-08,9257
2888,新光金,11,0,11,凱基-林口,2023-12-08,9257
1721,三晃,10,0,10,凱基-林口,2023-12-08,9257
2328,廣宇,10,0,10,凱基-林口,2023-12-08,9257
2516,新建,10,0,10,凱基-林口,2023-12-08,9257
3045,台灣大,10,0,10,凱基-林口,2023-12-08,9257
5351,鈺創,27,17,10,凱基-林口,2023-12-08,9257
6005,群益證,10,0,10,凱基-林口,2023-12-08,9257
6426,統新,10,0,10,凱基-林口,2023-12-08,9257
2449,京元電子,9,0,9,凱基-林口,2023-12-08,9257
3028,增你強,9,0,9,凱基-林口,2023-12-08,9257
00719B,元大美債1-3,8,0,8,凱基-林口,2023-12-08,9257
2882,國泰金,8,0,8,凱基-林口,2023-12-08,9257
9929,秋雨,8,0,8,凱基-林口,2023-12-08,9257
2637,慧洋-KY,7,0,7,凱基-林口,2023-12-08,9257
3035,智原,13,6,7,凱基-林口,2023-12-08,9257
3231,緯創,16,9,7,凱基-林口,2023-12-08,9257
00795B,中信美國公債20年,6,0,6,凱基-林口,2023-12-08,9257
1301,台塑,6,0,6,凱基-林口,2023-12-08,9257
5009,榮剛,7,1,6,凱基-林口,2023-12-08,9257
6163,華電網,6,0,6,凱基-林口,2023-12-08,9257
1514,亞力,56,50,6,凱基-林口,2023-12-08,9257
00919,群益台灣精選高息,135,1,134,凱基-林口,2023-12-11,9257
2618,長榮航,143,14,129,凱基-林口,2023-12-11,9257
2888,新光金,118,0,118,凱基-林口,2023-12-11,9257
2867,三商壽,100,0,100,凱基-林口,2023-12-11,9257
00679B,元大美債20年,95,0,95,凱基-林口,2023-12-11,9257
2641,正德,86,7,79,凱基-林口,2023-12-11,9257
00937B,群益ESG投等債20,69,5,64,凱基-林口,2023-12-11,9257
00637L,元大滬深300正2,61,0,61,凱基-林口,2023-12-11,9257
3231,緯創,57,10,47,凱基-林口,2023-12-11,9257
3013,晟銘電,52,9,43,凱基-林口,2023-12-11,9257
2303,聯電,45,3,42,凱基-林口,2023-12-11,9257
6414,樺漢,37,0,37,凱基-林口,2023-12-11,9257
00882,中信中國高股息,44,11,33,凱基-林口,2023-12-11,9257
00772B,中信高評級公司債,36,3,33,凱基-林口,2023-12-11,9257
3213,茂訊,40,10,30,凱基-林口,2023-12-11,9257
6684,安格,35,7,28,凱基-林口,2023-12-11,9257
8054,安國,34,6,28,凱基-林口,2023-12-11,9257
4720,德淵,24,0,24,凱基-林口,2023-12-11,9257
2313,華通,25,2,23,凱基-林口,2023-12-11,9257
6591,動力-KY,22,0,22,凱基-林口,2023-12-11,9257
00671R,富邦NASDAQ反1,20,0,20,凱基-林口,2023-12-11,9257
2323,中環,20,0,20,凱基-林口,2023-12-11,9257
2328,廣宇,20,0,20,凱基-林口,2023-12-11,9257
2516,新建,20,0,20,凱基-林口,2023-12-11,9257
2883B,凱基金乙特,20,0,20,凱基-林口,2023-12-11,9257
3032,偉訓,20,0,20,凱基-林口,2023-12-11,9257
3045,台灣大,20,0,20,凱基-林口,2023-12-11,9257
4960,誠美材,20,0,20,凱基-林口,2023-12-11,9257
2409,友達,20,1,19,凱基-林口,2023-12-11,9257
00918,大華優利高填息30,18,0,18,凱基-林口,2023-12-11,9257
00720B,元大投資級公司債,16,0,16,凱基-林口,2023-12-11,9257
3305,昇貿,17,1,16,凱基-林口,2023-12-11,9257
00648R,元大S＆P500反1,15,0,15,凱基-林口,2023-12-11,9257
6282,康舒,22,7,15,凱基-林口,2023-12-11,9257
2388,威盛,59,45,14,凱基-林口,2023-12-11,9257
2897,王道銀行,15,1,14,凱基-林口,2023-12-11,9257
3450,聯鈞,27,13,14,凱基-林口,2023-12-11,9257
00878,國泰永續高股息,14,1,13,凱基-林口,2023-12-11,9257
1314,中石化,13,0,13,凱基-林口,2023-12-11,9257
6415,矽力*-KY,13,0,13,凱基-林口,2023-12-11,9257
2382,廣達,16,4,12,凱基-林口,2023-12-11,9257
5432,新門,12,0,12,凱基-林口,2023-12-11,9257
00915,凱基優選高股息30,17,5,12,凱基-林口,2023-12-11,9257
2606,裕民,12,1,11,凱基-林口,2023-12-11,9257
3041,揚智,16,5,11,凱基-林口,2023-12-11,9257
3374,精材,17,6,11,凱基-林口,2023-12-11,9257
5272,笙科,16,5,11,凱基-林口,2023-12-11,9257
6245,立端,11,0,11,凱基-林口,2023-12-11,9257
3715,定穎投控,19,8,11,凱基-林口,2023-12-11,9257
00687B,國泰20年美債,18,8,10,凱基-林口,2023-12-11,9257
3481,群創,201,0,201,凱基-林口,2023-12-12,9257
00919,群益台灣精選高息,225,41,184,凱基-林口,2023-12-12,9257
2467,志聖,114,9,105,凱基-林口,2023-12-12,9257
00687B,國泰20年美債,92,1,91,凱基-林口,2023-12-12,9257
1612,宏泰,105,39,66,凱基-林口,2023-12-12,9257
8068,全達,60,0,60,凱基-林口,2023-12-12,9257
1618,合機,112,55,57,凱基-林口,2023-12-12,9257
2352,佳世達,50,0,50,凱基-林口,2023-12-12,9257
00918,大華優利高填息30,44,0,44,凱基-林口,2023-12-12,9257
00680L,元大美債20正2,40,0,40,凱基-林口,2023-12-12,9257
8096,擎亞,50,10,40,凱基-林口,2023-12-12,9257
00922,國泰台灣領袖50,37,0,37,凱基-林口,2023-12-12,9257
4933,友輝,30,0,30,凱基-林口,2023-12-12,9257
5521,工信,48,18,30,凱基-林口,2023-12-12,9257
2371,大同,108,80,28,凱基-林口,2023-12-12,9257
4908,前鼎,27,0,27,凱基-林口,2023-12-12,9257
2888,新光金,25,0,25,凱基-林口,2023-12-12,9257
2443,昶虹,24,0,24,凱基-林口,2023-12-12,9257
3380,明泰,32,8,24,凱基-林口,2023-12-12,9257
4533,協易機,24,0,24,凱基-林口,2023-12-12,9257
5324,士開,24,0,24,凱基-林口,2023-12-12,9257
1514,亞力,61,39,22,凱基-林口,2023-12-12,9257
00929,復華台灣科技優息,33,12,21,凱基-林口,2023-12-12,9257
3260,威剛,21,1,20,凱基-林口,2023-12-12,9257
2883B,凱基金乙特,20,0,20,凱基-林口,2023-12-12,9257
2889,國票金,20,0,20,凱基-林口,2023-12-12,9257
3363,上詮,21,1,20,凱基-林口,2023-12-12,9257
2363,矽統,35,15,20,凱基-林口,2023-12-12,9257
3019,亞光,30,11,19,凱基-林口,2023-12-12,9257
4967,十銓,21,2,19,凱基-林口,2023-12-12,9257
5388,中磊,20,1,19,凱基-林口,2023-12-12,9257
00882,中信中國高股息,21,4,17,凱基-林口,2023-12-12,9257
6415,矽力*-KY,17,0,17,凱基-林口,2023-12-12,9257
2402,毅嘉,62,46,16,凱基-林口,2023-12-12,9257
2614,東森,15,0,15,凱基-林口,2023-12-12,9257
00915,凱基優選高股息30,15,0,15,凱基-林口,2023-12-12,9257
6245,立端,16,1,15,凱基-林口,2023-12-12,9257
8011,台通,20,5,15,凱基-林口,2023-12-12,9257
00772B,中信高評級公司債,20,6,14,凱基-林口,2023-12-12,9257
2516,新建,14,0,14,凱基-林口,2023-12-12,9257
3025,星通,17,4,13,凱基-林口,2023-12-12,9257
2002,中鋼,13,0,13,凱基-林口,2023-12-12,9257
00934,中信成長高股息,12,0,12,凱基-林口,2023-12-12,9257
2883,凱基金,20,8,12,凱基-林口,2023-12-12,9257
00751B,元大AAA至A公司債,11,0,11,凱基-林口,2023-12-12,9257
2374,佳能,11,0,11,凱基-林口,2023-12-12,9257
3032,偉訓,11,0,11,凱基-林口,2023-12-12,9257
3515,華擎,11,0,11,凱基-林口,2023-12-12,9257
4919,新唐,12,1,11,凱基-林口,2023-12-12,9257
5880,合庫金,11,0,11,凱基-林口,2023-12-12,9257
00919,群益台灣精選高息,422,22,400,凱基-林口,2023-12-13,9257
00929,復華台灣科技優息,269,7,262,凱基-林口,2023-12-13,9257
00918,大華優利高填息30,147,0,147,凱基-林口,2023-12-13,9257
00878,國泰永續高股息,97,23,74,凱基-林口,2023-12-13,9257
00934,中信成長高股息,63,0,63,凱基-林口,2023-12-13,9257
3287,廣寰科,59,5,54,凱基-林口,2023-12-13,9257
6517,保勝光學,53,2,51,凱基-林口,2023-12-13,9257
2515,中工,80,31,49,凱基-林口,2023-12-13,9257
1609,大亞,65,18,47,凱基-林口,2023-12-13,9257
3209,全科,35,0,35,凱基-林口,2023-12-13,9257
3035,智原,78,45,33,凱基-林口,2023-12-13,9257
3019,亞光,36,3,33,凱基-林口,2023-12-13,9257
2002,中鋼,30,0,30,凱基-林口,2023-12-13,9257
00715L,期街口布蘭特正2,35,5,30,凱基-林口,2023-12-13,9257
2618,長榮航,56,27,29,凱基-林口,2023-12-13,9257
00637L,元大滬深300正2,22,0,22,凱基-林口,2023-12-13,9257
5521,工信,58,38,20,凱基-林口,2023-12-13,9257
1711,永光,20,0,20,凱基-林口,2023-12-13,9257
1718,中纖,20,0,20,凱基-林口,2023-12-13,9257
2369,菱生,20,0,20,凱基-林口,2023-12-13,9257
3032,偉訓,20,0,20,凱基-林口,2023-12-13,9257
5880,合庫金,20,0,20,凱基-林口,2023-12-13,9257
2883,凱基金,24,6,18,凱基-林口,2023-12-13,9257
3047,訊舟,17,0,17,凱基-林口,2023-12-13,9257
5426,振發,34,17,17,凱基-林口,2023-12-13,9257
2603,長榮,62,46,16,凱基-林口,2023-12-13,9257
00727B,國泰優選非投等債,15,0,15,凱基-林口,2023-12-13,9257
00933B,國泰10Y+金融債,13,0,13,凱基-林口,2023-12-13,9257
2457,飛宏,14,1,13,凱基-林口,2023-12-13,9257
00687B,國泰20年美債,13,0,13,凱基-林口,2023-12-13,9257
2419,仲琦,43,31,12,凱基-林口,2023-12-13,9257
2641,正德,18,6,12,凱基-林口,2023-12-13,9257
2317,鴻海,11,0,11,凱基-林口,2023-12-13,9257
3078,僑威,13,2,11,凱基-林口,2023-12-13,9257
3380,明泰,35,24,11,凱基-林口,2023-12-13,9257
3694,海華,12,1,11,凱基-林口,2023-12-13,9257
6415,矽力*-KY,11,0,11,凱基-林口,2023-12-13,9257
2884,玉山金,10,0,10,凱基-林口,2023-12-13,9257
3231,緯創,33,23,10,凱基-林口,2023-12-13,9257
00679B,元大美債20年,15,5,10,凱基-林口,2023-12-13,9257
00907,永豐優息存股,10,0,10,凱基-林口,2023-12-13,9257
1582,信錦,12,2,10,凱基-林口,2023-12-13,9257
1815,富喬,15,5,10,凱基-林口,2023-12-13,9257
2206,三陽工業,10,0,10,凱基-林口,2023-12-13,9257
2352,佳世達,10,0,10,凱基-林口,2023-12-13,9257
2362,藍天,10,0,10,凱基-林口,2023-12-13,9257
9941,裕融,10,0,10,凱基-林口,2023-12-13,9257
3363,上詮,16,7,9,凱基-林口,2023-12-13,9257
6770,力積電,11,2,9,凱基-林口,2023-12-13,9257
2376,技嘉,45,36,9,凱基-林口,2023-12-13,9257
2467,志聖,129,0,129,凱基-林口,2023-12-14,9257
5351,鈺創,118,15,103,凱基-林口,2023-12-14,9257
00929,復華台灣科技優息,119,31,88,凱基-林口,2023-12-14,9257
8034,榮群,85,0,85,凱基-林口,2023-12-14,9257
6125,廣運,72,1,71,凱基-林口,2023-12-14,9257
00687B,國泰20年美債,71,1,70,凱基-林口,2023-12-14,9257
00751B,元大AAA至A公司債,63,2,61,凱基-林口,2023-12-14,9257
00637L,元大滬深300正2,44,0,44,凱基-林口,2023-12-14,9257
00680L,元大美債20正2,58,15,43,凱基-林口,2023-12-14,9257
2641,正德,50,13,37,凱基-林口,2023-12-14,9257
00715L,期街口布蘭特正2,38,2,36,凱基-林口,2023-12-14,9257
2515,中工,45,10,35,凱基-林口,2023-12-14,9257
00918,大華優利高填息30,35,2,33,凱基-林口,2023-12-14,9257
2365,昆盈,33,1,32,凱基-林口,2023-12-14,9257
3715,定穎投控,36,4,32,凱基-林口,2023-12-14,9257
00931B,統一美債20年,38,7,31,凱基-林口,2023-12-14,9257
3019,亞光,30,1,29,凱基-林口,2023-12-14,9257
3221,台嘉碩,28,0,28,凱基-林口,2023-12-14,9257
00724B,群益投資級金融債,27,1,26,凱基-林口,2023-12-14,9257
2303,聯電,35,11,24,凱基-林口,2023-12-14,9257
8011,台通,24,0,24,凱基-林口,2023-12-14,9257
1605,華新,23,0,23,凱基-林口,2023-12-14,9257
00933B,國泰10Y+金融債,42,20,22,凱基-林口,2023-12-14,9257
6770,力積電,21,0,21,凱基-林口,2023-12-14,9257
00632R,元大台灣50反1,21,0,21,凱基-林口,2023-12-14,9257
2457,飛宏,21,1,20,凱基-林口,2023-12-14,9257
1301,台塑,21,1,20,凱基-林口,2023-12-14,9257
3231,緯創,40,22,18,凱基-林口,2023-12-14,9257
2405,輔信,18,0,18,凱基-林口,2023-12-14,9257
2605,新興,20,3,17,凱基-林口,2023-12-14,9257
3005,神基,26,9,17,凱基-林口,2023-12-14,9257
00795B,中信美國公債20年,15,0,15,凱基-林口,2023-12-14,9257
3032,偉訓,16,1,15,凱基-林口,2023-12-14,9257
2356,英業達,21,6,15,凱基-林口,2023-12-14,9257
1609,大亞,14,0,14,凱基-林口,2023-12-14,9257
1805,寶徠,13,0,13,凱基-林口,2023-12-14,9257
2388,威盛,15,2,13,凱基-林口,2023-12-14,9257
00679B,元大美債20年,31,19,12,凱基-林口,2023-12-14,9257
1402,遠東新,12,0,12,凱基-林口,2023-12-14,9257
1618,合機,16,4,12,凱基-林口,2023-12-14,9257
2425,承啟,14,2,12,凱基-林口,2023-12-14,9257
2606,裕民,12,0,12,凱基-林口,2023-12-14,9257
3013,晟銘電,14,2,12,凱基-林口,2023-12-14,9257
3045,台灣大,12,0,12,凱基-林口,2023-12-14,9257
00722B,群益投資級電信債,11,0,11,凱基-林口,2023-12-14,9257
2317,鴻海,12,1,11,凱基-林口,2023-12-14,9257
2867,三商壽,11,0,11,凱基-林口,2023-12-14,9257
3047,訊舟,10,0,10,凱基-林口,2023-12-14,9257
00902,中信電池及儲能,10,0,10,凱基-林口,2023-12-14,9257
00857B,永豐20年美公債,10,0,10,凱基-林口,2023-12-14,9257
00919,群益台灣精選高息,485,9,476,凱基-林口,2023-12-15,9257
2331,精英,162,3,159,凱基-林口,2023-12-15,9257
2363,矽統,208,95,113,凱基-林口,2023-12-15,9257
00751B,元大AAA至A公司債,109,4,105,凱基-林口,2023-12-15,9257
2353,宏��,101,0,101,凱基-林口,2023-12-15,9257
00929,復華台灣科技優息,93,16,77,凱基-林口,2023-12-15,9257
2324,仁寶,106,31,75,凱基-林口,2023-12-15,9257
2204,中華,70,1,69,凱基-林口,2023-12-15,9257
2516,新建,44,1,43,凱基-林口,2023-12-15,9257
00915,凱基優選高股息30,43,1,42,凱基-林口,2023-12-15,9257
00679B,元大美債20年,46,6,40,凱基-林口,2023-12-15,9257
6443,元晶,42,2,40,凱基-林口,2023-12-15,9257
6147,頎邦,44,5,39,凱基-林口,2023-12-15,9257
3265,台星科,49,17,32,凱基-林口,2023-12-15,9257
1522,堤維西,30,0,30,凱基-林口,2023-12-15,9257
00637L,元大滬深300正2,29,0,29,凱基-林口,2023-12-15,9257
4550,長佳,28,0,28,凱基-林口,2023-12-15,9257
00933B,國泰10Y+金融債,25,1,24,凱基-林口,2023-12-15,9257
8112,至上,25,2,23,凱基-林口,2023-12-15,9257
00907,永豐優息存股,23,0,23,凱基-林口,2023-12-15,9257
2801,彰銀,22,0,22,凱基-林口,2023-12-15,9257
5371,中光電,23,1,22,凱基-林口,2023-12-15,9257
1609,大亞,20,0,20,凱基-林口,2023-12-15,9257
3583,辛耘,20,0,20,凱基-林口,2023-12-15,9257
8011,台通,34,14,20,凱基-林口,2023-12-15,9257
00922,國泰台灣領袖50,20,1,19,凱基-林口,2023-12-15,9257
2356,英業達,206,187,19,凱基-林口,2023-12-15,9257
2351,順德,34,16,18,凱基-林口,2023-12-15,9257
3715,定穎投控,16,1,15,凱基-林口,2023-12-15,9257
00632R,元大台灣50反1,15,1,14,凱基-林口,2023-12-15,9257
00936,台新永續高息中小,14,0,14,凱基-林口,2023-12-15,9257
6125,廣運,14,0,14,凱基-林口,2023-12-15,9257
3545,敦泰,14,1,13,凱基-林口,2023-12-15,9257
1513,中興電,20,7,13,凱基-林口,2023-12-15,9257
5210,寶碩,13,0,13,凱基-林口,2023-12-15,9257
5521,工信,58,45,13,凱基-林口,2023-12-15,9257
6257,矽格,15,2,13,凱基-林口,2023-12-15,9257
2436,偉詮電,12,0,12,凱基-林口,2023-12-15,9257
1560,中砂,11,0,11,凱基-林口,2023-12-15,9257
2462,良得電,11,0,11,凱基-林口,2023-12-15,9257
2481,強茂,29,18,11,凱基-林口,2023-12-15,9257
3045,台灣大,12,1,11,凱基-林口,2023-12-15,9257
4953,緯軟,12,1,11,凱基-林口,2023-12-15,9257
2367,燿華,10,0,10,凱基-林口,2023-12-15,9257
5880,合庫金,10,0,10,凱基-林口,2023-12-15,9257
00931B,統一美債20年,10,0,10,凱基-林口,2023-12-15,9257
00688L,國泰20年美債正2,10,0,10,凱基-林口,2023-12-15,9257
2030,彰源,10,0,10,凱基-林口,2023-12-15,9257
2352,佳世達,10,0,10,凱基-林口,2023-12-15,9257
2401,凌陽,10,0,10,凱基-林口,2023-12-15,9257
2356,英業達,865,57,808,凱基-林口,2023-12-18,9257
00929,復華台灣科技優息,310,27,283,凱基-林口,2023-12-18,9257
00918,大華優利高填息30,224,0,224,凱基-林口,2023-12-18,9257
2344,華邦電,139,22,117,凱基-林口,2023-12-18,9257
2014,中鴻,129,34,95,凱基-林口,2023-12-18,9257
00679B,元大美債20年,72,17,55,凱基-林口,2023-12-18,9257
00633L,富邦上証正2,50,0,50,凱基-林口,2023-12-18,9257
2618,長榮航,66,17,49,凱基-林口,2023-12-18,9257
2324,仁寶,71,25,46,凱基-林口,2023-12-18,9257
00712,復華富時不動產,55,11,44,凱基-林口,2023-12-18,9257
2038,海光,50,7,43,凱基-林口,2023-12-18,9257
00720B,元大投資級公司債,34,0,34,凱基-林口,2023-12-18,9257
5011,久陽,33,0,33,凱基-林口,2023-12-18,9257
00753L,中信中國50正2,30,0,30,凱基-林口,2023-12-18,9257
2610,華航,28,0,28,凱基-林口,2023-12-18,9257
00751B,元大AAA至A公司債,27,0,27,凱基-林口,2023-12-18,9257
00891,中信關鍵半導體,27,0,27,凱基-林口,2023-12-18,9257
00919,群益台灣精選高息,84,61,23,凱基-林口,2023-12-18,9257
5425,台半,24,2,22,凱基-林口,2023-12-18,9257
00885,富邦越南,21,0,21,凱基-林口,2023-12-18,9257
5469,瀚宇博,21,0,21,凱基-林口,2023-12-18,9257
6233,旺玖,30,9,21,凱基-林口,2023-12-18,9257
2007,燁興,20,0,20,凱基-林口,2023-12-18,9257
2332,友訊,20,0,20,凱基-林口,2023-12-18,9257
2801,彰銀,20,0,20,凱基-林口,2023-12-18,9257
00915,凱基優選高股息30,20,1,19,凱基-林口,2023-12-18,9257
00637L,元大滬深300正2,19,1,18,凱基-林口,2023-12-18,9257
2020,美亞,23,5,18,凱基-林口,2023-12-18,9257
2882,國泰金,18,0,18,凱基-林口,2023-12-18,9257
5009,榮剛,17,0,17,凱基-林口,2023-12-18,9257
00882,中信中國高股息,15,0,15,凱基-林口,2023-12-18,9257
2002,中鋼,27,13,14,凱基-林口,2023-12-18,9257
00934,中信成長高股息,13,0,13,凱基-林口,2023-12-18,9257
6770,力積電,83,70,13,凱基-林口,2023-12-18,9257
00931B,統一美債20年,12,0,12,凱基-林口,2023-12-18,9257
2101,南港,12,0,12,凱基-林口,2023-12-18,9257
2363,矽統,20,9,11,凱基-林口,2023-12-18,9257
2388,威盛,26,16,10,凱基-林口,2023-12-18,9257
00922,國泰台灣領袖50,10,0,10,凱基-林口,2023-12-18,9257
2492,華新科,10,0,10,凱基-林口,2023-12-18,9257
2515,中工,10,0,10,凱基-林口,2023-12-18,9257
2706,第一店,10,0,10,凱基-林口,2023-12-18,9257
3088,艾訊,10,0,10,凱基-林口,2023-12-18,9257
5381,合正,10,0,10,凱基-林口,2023-12-18,9257
6125,廣運,10,0,10,凱基-林口,2023-12-18,9257
6136,富爾特,10,0,10,凱基-林口,2023-12-18,9257
6603,富強鑫,10,0,10,凱基-林口,2023-12-18,9257
2233,宇隆,9,0,9,凱基-林口,2023-12-18,9257
3036,文曄,10,1,9,凱基-林口,2023-12-18,9257
3264,欣銓,9,0,9,凱基-林口,2023-12-18,9257
2324,仁寶,172,1,171,凱基-林口,2023-12-19,9257
00929,復華台灣科技優息,181,43,138,凱基-林口,2023-12-19,9257
5351,鈺創,108,1,107,凱基-林口,2023-12-19,9257
2615,萬海,62,4,58,凱基-林口,2023-12-19,9257
00679B,元大美債20年,70,14,56,凱基-林口,2023-12-19,9257
2457,飛宏,41,0,41,凱基-林口,2023-12-19,9257
3645,達邁,38,1,37,凱基-林口,2023-12-19,9257
2356,英業達,87,51,36,凱基-林口,2023-12-19,9257
6443,元晶,38,2,36,凱基-林口,2023-12-19,9257
00934,中信成長高股息,32,1,31,凱基-林口,2023-12-19,9257
3231,緯創,39,10,29,凱基-林口,2023-12-19,9257
3545,敦泰,37,8,29,凱基-林口,2023-12-19,9257
2882,國泰金,28,0,28,凱基-林口,2023-12-19,9257
0056,元大高股息,43,17,26,凱基-林口,2023-12-19,9257
00712,復華富時不動產,69,47,22,凱基-林口,2023-12-19,9257
00878,國泰永續高股息,54,32,22,凱基-林口,2023-12-19,9257
1605,華新,31,10,21,凱基-林口,2023-12-19,9257
2313,華通,24,3,21,凱基-林口,2023-12-19,9257
00919,群益台灣精選高息,49,29,20,凱基-林口,2023-12-19,9257
2890,永豐金,20,0,20,凱基-林口,2023-12-19,9257
3036,文曄,20,0,20,凱基-林口,2023-12-19,9257
4167,松瑞藥,36,16,20,凱基-林口,2023-12-19,9257
6191,精成科,22,4,18,凱基-林口,2023-12-19,9257
00931B,統一美債20年,16,0,16,凱基-林口,2023-12-19,9257
2610,華航,27,11,16,凱基-林口,2023-12-19,9257
00937B,群益ESG投等債20,34,18,16,凱基-林口,2023-12-19,9257
2409,友達,15,0,15,凱基-林口,2023-12-19,9257
5314,世紀,15,0,15,凱基-林口,2023-12-19,9257
6770,力積電,20,5,15,凱基-林口,2023-12-19,9257
00918,大華優利高填息30,14,0,14,凱基-林口,2023-12-19,9257
00915,凱基優選高股息30,17,3,14,凱基-林口,2023-12-19,9257
2002,中鋼,14,0,14,凱基-林口,2023-12-19,9257
2812,台中銀,14,0,14,凱基-林口,2023-12-19,9257
8011,台通,16,2,14,凱基-林口,2023-12-19,9257
2312,金寶,21,8,13,凱基-林口,2023-12-19,9257
2344,華邦電,15,2,13,凱基-林口,2023-12-19,9257
00720B,元大投資級公司債,12,0,12,凱基-林口,2023-12-19,9257
2241,艾姆勒,12,0,12,凱基-林口,2023-12-19,9257
2482,連宇,19,7,12,凱基-林口,2023-12-19,9257
00891,中信關鍵半導體,11,0,11,凱基-林口,2023-12-19,9257
00933B,國泰10Y+金融債,11,0,11,凱基-林口,2023-12-19,9257
2801,彰銀,12,1,11,凱基-林口,2023-12-19,9257
9941,裕融,11,0,11,凱基-林口,2023-12-19,9257
00936,台新永續高息中小,10,0,10,凱基-林口,2023-12-19,9257
00753L,中信中國50正2,10,0,10,凱基-林口,2023-12-19,9257
2007,燁興,10,0,10,凱基-林口,2023-12-19,9257
2010,春源,10,0,10,凱基-林口,2023-12-19,9257
2427,三商電,10,0,10,凱基-林口,2023-12-19,9257
2465,麗臺,10,0,10,凱基-林口,2023-12-19,9257
3380,明泰,10,0,10,凱基-林口,2023-12-19,9257
2609,陽明,200,78,122,凱基-林口,2023-12-20,9257
2889,國票金,100,0,100,凱基-林口,2023-12-20,9257
2801,彰銀,60,0,60,凱基-林口,2023-12-20,9257
2891,中信金,55,1,54,凱基-林口,2023-12-20,9257
00937B,群益ESG投等債20,53,0,53,凱基-林口,2023-12-20,9257
2816,旺旺保,54,1,53,凱基-林口,2023-12-20,9257
00929,復華台灣科技優息,52,1,51,凱基-林口,2023-12-20,9257
1732,毛寶,61,16,45,凱基-林口,2023-12-20,9257
00919,群益台灣精選高息,52,11,41,凱基-林口,2023-12-20,9257
00679B,元大美債20年,35,1,34,凱基-林口,2023-12-20,9257
2603,長榮,38,6,32,凱基-林口,2023-12-20,9257
3035,智原,30,0,30,凱基-林口,2023-12-20,9257
2838,聯邦銀,29,0,29,凱基-林口,2023-12-20,9257
6265,方土昶,28,0,28,凱基-林口,2023-12-20,9257
00934,中信成長高股息,25,0,25,凱基-林口,2023-12-20,9257
4402,郡都開發,25,0,25,凱基-林口,2023-12-20,9257
00687B,國泰20年美債,20,0,20,凱基-林口,2023-12-20,9257
00680L,元大美債20正2,21,1,20,凱基-林口,2023-12-20,9257
2886,兆豐金,19,0,19,凱基-林口,2023-12-20,9257
2371,大同,29,13,16,凱基-林口,2023-12-20,9257
2027,大成鋼,22,6,16,凱基-林口,2023-12-20,9257
2408,南亞科,15,0,15,凱基-林口,2023-12-20,9257
6198,瑞築,14,0,14,凱基-林口,2023-12-20,9257
8011,台通,14,0,14,凱基-林口,2023-12-20,9257
3444,利機,12,0,12,凱基-林口,2023-12-20,9257
8054,安國,13,1,12,凱基-林口,2023-12-20,9257
2353,宏��,112,101,11,凱基-林口,2023-12-20,9257
2516,新建,11,0,11,凱基-林口,2023-12-20,9257
1781,合世,10,0,10,凱基-林口,2023-12-20,9257
2399,映泰,10,0,10,凱基-林口,2023-12-20,9257
2534,宏盛,10,0,10,凱基-林口,2023-12-20,9257
2610,華航,14,4,10,凱基-林口,2023-12-20,9257
2880,華南金,10,0,10,凱基-林口,2023-12-20,9257
2888,新光金,10,0,10,凱基-林口,2023-12-20,9257
4532,瑞智,10,0,10,凱基-林口,2023-12-20,9257
4915,致伸,10,0,10,凱基-林口,2023-12-20,9257
5388,中磊,10,0,10,凱基-林口,2023-12-20,9257
2885,元大金,10,0,10,凱基-林口,2023-12-20,9257
2337,旺宏,10,1,9,凱基-林口,2023-12-20,9257
3264,欣銓,9,0,9,凱基-林口,2023-12-20,9257
6125,廣運,10,1,9,凱基-林口,2023-12-20,9257
00712,復華富時不動產,10,2,8,凱基-林口,2023-12-20,9257
2882,國泰金,8,0,8,凱基-林口,2023-12-20,9257
6182,合晶,8,0,8,凱基-林口,2023-12-20,9257
6482,弘煜科,8,0,8,凱基-林口,2023-12-20,9257
1618,合機,7,0,7,凱基-林口,2023-12-20,9257
6215,和椿,7,0,7,凱基-林口,2023-12-20,9257
3105,穩懋,6,0,6,凱基-林口,2023-12-20,9257
1522,堤維西,6,0,6,凱基-林口,2023-12-20,9257
2303,聯電,6,0,6,凱基-林口,2023-12-20,9257
2033,佳大,170,1,169,凱基-林口,2023-12-21,9257
2324,仁寶,227,103,124,凱基-林口,2023-12-21,9257
00929,復華台灣科技優息,88,6,82,凱基-林口,2023-12-21,9257
00919,群益台灣精選高息,72,0,72,凱基-林口,2023-12-21,9257
2356,英業達,107,50,57,凱基-林口,2023-12-21,9257
00937B,群益ESG投等債20,70,15,55,凱基-林口,2023-12-21,9257
4102,永日,43,0,43,凱基-林口,2023-12-21,9257
1504,東元,37,1,36,凱基-林口,2023-12-21,9257
2838,聯邦銀,30,0,30,凱基-林口,2023-12-21,9257
4909,新復興,40,12,28,凱基-林口,2023-12-21,9257
00637L,元大滬深300正2,26,1,25,凱基-林口,2023-12-21,9257
00687B,國泰20年美債,25,0,25,凱基-林口,2023-12-21,9257
2890,永豐金,25,0,25,凱基-林口,2023-12-21,9257
00934,中信成長高股息,24,0,24,凱基-林口,2023-12-21,9257
4960,誠美材,24,0,24,凱基-林口,2023-12-21,9257
8088,品安,22,0,22,凱基-林口,2023-12-21,9257
00933B,國泰10Y+金融債,20,0,20,凱基-林口,2023-12-21,9257
3376,新日興,21,1,20,凱基-林口,2023-12-21,9257
8085,福華,20,0,20,凱基-林口,2023-12-21,9257
2367,燿華,20,1,19,凱基-林口,2023-12-21,9257
2457,飛宏,20,1,19,凱基-林口,2023-12-21,9257
3041,揚智,20,1,19,凱基-林口,2023-12-21,9257
3035,智原,26,9,17,凱基-林口,2023-12-21,9257
2816,旺旺保,16,0,16,凱基-林口,2023-12-21,9257
5521,工信,15,0,15,凱基-林口,2023-12-21,9257
00878,國泰永續高股息,14,1,13,凱基-林口,2023-12-21,9257
006205,富邦上証,12,0,12,凱基-林口,2023-12-21,9257
3704,合勤控,12,0,12,凱基-林口,2023-12-21,9257
5347,世界,12,0,12,凱基-林口,2023-12-21,9257
6593,台灣銘板,13,2,11,凱基-林口,2023-12-21,9257
3045,台灣大,10,0,10,凱基-林口,2023-12-21,9257
6414,樺漢,10,0,10,凱基-林口,2023-12-21,9257
00936,台新永續高息中小,10,0,10,凱基-林口,2023-12-21,9257
00922,國泰台灣領袖50,10,0,10,凱基-林口,2023-12-21,9257
2022,聚亨,10,0,10,凱基-林口,2023-12-21,9257
3230,錦明,10,0,10,凱基-林口,2023-12-21,9257
3264,欣銓,10,0,10,凱基-林口,2023-12-21,9257
3372,典範,10,0,10,凱基-林口,2023-12-21,9257
4702,中美實,10,0,10,凱基-林口,2023-12-21,9257
5213,亞昕,10,0,10,凱基-林口,2023-12-21,9257
2412,中華電,9,0,9,凱基-林口,2023-12-21,9257
6005,群益證,10,1,9,凱基-林口,2023-12-21,9257
8054,安國,17,8,9,凱基-林口,2023-12-21,9257
6443,元晶,8,0,8,凱基-林口,2023-12-21,9257
3034,聯詠,8,0,8,凱基-林口,2023-12-21,9257
2303,聯電,8,0,8,凱基-林口,2023-12-21,9257
1731,美吾華,8,0,8,凱基-林口,2023-12-21,9257
2486,一詮,8,0,8,凱基-林口,2023-12-21,9257
4532,瑞智,8,0,8,凱基-林口,2023-12-21,9257
5608,四維航,13,5,8,凱基-林口,2023-12-21,9257
00937B,群益ESG投等債20,118,0,118,凱基-林口,2023-12-22,9257
2324,仁寶,114,19,95,凱基-林口,2023-12-22,9257
2515,中工,86,9,77,凱基-林口,2023-12-22,9257
2033,佳大,65,5,60,凱基-林口,2023-12-22,9257
4402,郡都開發,47,0,47,凱基-林口,2023-12-22,9257
00679B,元大美債20年,33,0,33,凱基-林口,2023-12-22,9257
1314,中石化,30,0,30,凱基-林口,2023-12-22,9257
4909,新復興,25,0,25,凱基-林口,2023-12-22,9257
00919,群益台灣精選高息,23,0,23,凱基-林口,2023-12-22,9257
00936,台新永續高息中小,22,0,22,凱基-林口,2023-12-22,9257
2323,中環,20,0,20,凱基-林口,2023-12-22,9257
6015,宏遠證,20,0,20,凱基-林口,2023-12-22,9257
2020,美亞,20,1,19,凱基-林口,2023-12-22,9257
00687B,國泰20年美債,21,3,18,凱基-林口,2023-12-22,9257
3706,神達,29,11,18,凱基-林口,2023-12-22,9257
3017,奇鋐,22,6,16,凱基-林口,2023-12-22,9257
00751B,元大AAA至A公司債,15,0,15,凱基-林口,2023-12-22,9257
5609,中菲行,13,0,13,凱基-林口,2023-12-22,9257
8011,台通,13,0,13,凱基-林口,2023-12-22,9257
2609,陽明,87,74,13,凱基-林口,2023-12-22,9257
2408,南亞科,16,4,12,凱基-林口,2023-12-22,9257
3363,上詮,12,0,12,凱基-林口,2023-12-22,9257
4979,華星光,15,4,11,凱基-林口,2023-12-22,9257
2337,旺宏,11,0,11,凱基-林口,2023-12-22,9257
00632R,元大台灣50反1,10,0,10,凱基-林口,2023-12-22,9257
2027,大成鋼,10,0,10,凱基-林口,2023-12-22,9257
2812,台中銀,10,0,10,凱基-林口,2023-12-22,9257
2867,三商壽,10,0,10,凱基-林口,2023-12-22,9257
3583,辛耘,10,0,10,凱基-林口,2023-12-22,9257
5355,佳總,10,0,10,凱基-林口,2023-12-22,9257
9105,泰金寶-DR,11,1,10,凱基-林口,2023-12-22,9257
2393,億光,10,0,10,凱基-林口,2023-12-22,9257
3576,聯合再生,9,0,9,凱基-林口,2023-12-22,9257
00795B,中信美國公債20年,8,0,8,凱基-林口,2023-12-22,9257
2886,兆豐金,8,0,8,凱基-林口,2023-12-22,9257
3346,麗清,13,5,8,凱基-林口,2023-12-22,9257
1605,華新,10,3,7,凱基-林口,2023-12-22,9257
2201,裕隆,10,3,7,凱基-林口,2023-12-22,9257
00788B,元大10年IG電能債,6,0,6,凱基-林口,2023-12-22,9257
1303,南亞,8,2,6,凱基-林口,2023-12-22,9257
6257,矽格,6,0,6,凱基-林口,2023-12-22,9257
6770,力積電,8,2,6,凱基-林口,2023-12-22,9257
00933B,國泰10Y+金融債,6,0,6,凱基-林口,2023-12-22,9257
6189,豐藝,5,0,5,凱基-林口,2023-12-22,9257
00720B,元大投資級公司債,7,2,5,凱基-林口,2023-12-22,9257
00725B,國泰投資級公司債,6,1,5,凱基-林口,2023-12-22,9257
00900,富邦特選高股息30,5,0,5,凱基-林口,2023-12-22,9257
00915,凱基優選高股息30,5,0,5,凱基-林口,2023-12-22,9257
2069,運錩,5,0,5,凱基-林口,2023-12-22,9257
2375,凱美,5,0,5,凱基-林口,2023-12-22,9257
3231,緯創,242,52,190,凱基-林口,2023-12-25,9257
4402,郡都開發,121,0,121,凱基-林口,2023-12-25,9257
2301,光寶科,104,0,104,凱基-林口,2023-12-25,9257
00919,群益台灣精選高息,101,1,100,凱基-林口,2023-12-25,9257
00937B,群益ESG投等債20,101,1,100,凱基-林口,2023-12-25,9257
2353,宏��,202,113,89,凱基-林口,2023-12-25,9257
2609,陽明,102,24,78,凱基-林口,2023-12-25,9257
2610,華航,201,148,53,凱基-林口,2023-12-25,9257
00918,大華優利高填息30,48,2,46,凱基-林口,2023-12-25,9257
5521,工信,48,14,34,凱基-林口,2023-12-25,9257
2421,建準,35,4,31,凱基-林口,2023-12-25,9257
2607,榮運,30,0,30,凱基-林口,2023-12-25,9257
00934,中信成長高股息,29,0,29,凱基-林口,2023-12-25,9257
00713,元大台灣高息低波,27,0,27,凱基-林口,2023-12-25,9257
3260,威剛,31,4,27,凱基-林口,2023-12-25,9257
00679B,元大美債20年,25,0,25,凱基-林口,2023-12-25,9257
8011,台通,31,6,25,凱基-林口,2023-12-25,9257
2617,台航,24,0,24,凱基-林口,2023-12-25,9257
2449,京元電子,24,1,23,凱基-林口,2023-12-25,9257
2614,東森,22,0,22,凱基-林口,2023-12-25,9257
00929,復華台灣科技優息,23,3,20,凱基-林口,2023-12-25,9257
2605,新興,19,0,19,凱基-林口,2023-12-25,9257
6550,北極星藥業-KY,23,5,18,凱基-林口,2023-12-25,9257
2603,長榮,32,15,17,凱基-林口,2023-12-25,9257
2460,建通,16,0,16,凱基-林口,2023-12-25,9257
2371,大同,15,0,15,凱基-林口,2023-12-25,9257
2014,中鴻,18,4,14,凱基-林口,2023-12-25,9257
6191,精成科,15,2,13,凱基-林口,2023-12-25,9257
2892,第一金,12,0,12,凱基-林口,2023-12-25,9257
00885,富邦越南,10,0,10,凱基-林口,2023-12-25,9257
00632R,元大台灣50反1,10,0,10,凱基-林口,2023-12-25,9257
1609,大亞,10,0,10,凱基-林口,2023-12-25,9257
2105,正新,10,0,10,凱基-林口,2023-12-25,9257
2363,矽統,22,12,10,凱基-林口,2023-12-25,9257
2606,裕民,18,8,10,凱基-林口,2023-12-25,9257
2867,三商壽,10,0,10,凱基-林口,2023-12-25,9257
3704,合勤控,10,0,10,凱基-林口,2023-12-25,9257
4550,長佳,10,0,10,凱基-林口,2023-12-25,9257
2027,大成鋼,9,0,9,凱基-林口,2023-12-25,9257
3035,智原,10,1,9,凱基-林口,2023-12-25,9257
4173,久裕,9,0,9,凱基-林口,2023-12-25,9257
6695,芯鼎,15,6,9,凱基-林口,2023-12-25,9257
2382,廣達,39,31,8,凱基-林口,2023-12-25,9257
3230,錦明,8,0,8,凱基-林口,2023-12-25,9257
2344,華邦電,27,20,7,凱基-林口,2023-12-25,9257
1522,堤維西,7,0,7,凱基-林口,2023-12-25,9257
2007,燁興,7,0,7,凱基-林口,2023-12-25,9257
2206,三陽工業,7,0,7,凱基-林口,2023-12-25,9257
3047,訊舟,9,2,7,凱基-林口,2023-12-25,9257
3512,皇龍,7,0,7,凱基-林口,2023-12-25,9257
00688L,國泰20年美債正2,560,0,560,凱基-林口,2023-12-26,9257
4402,郡都開發,56,0,56,凱基-林口,2023-12-26,9257
00882,中信中國高股息,44,0,44,凱基-林口,2023-12-26,9257
2889,國票金,40,0,40,凱基-林口,2023-12-26,9257
3231,緯創,52,12,40,凱基-林口,2023-12-26,9257
5521,工信,41,4,37,凱基-林口,2023-12-26,9257
00900,富邦特選高股息30,53,26,27,凱基-林口,2023-12-26,9257
8054,安國,29,2,27,凱基-林口,2023-12-26,9257
00680L,元大美債20正2,21,2,19,凱基-林口,2023-12-26,9257
4532,瑞智,19,0,19,凱基-林口,2023-12-26,9257
8059,凱碩,18,1,17,凱基-林口,2023-12-26,9257
00937B,群益ESG投等債20,17,0,17,凱基-林口,2023-12-26,9257
2356,英業達,20,3,17,凱基-林口,2023-12-26,9257
2365,昆盈,15,0,15,凱基-林口,2023-12-26,9257
2610,華航,41,26,15,凱基-林口,2023-12-26,9257
8066,來思達,15,1,14,凱基-林口,2023-12-26,9257
00915,凱基優選高股息30,14,1,13,凱基-林口,2023-12-26,9257
2809,京城銀,12,0,12,凱基-林口,2023-12-26,9257
00919,群益台灣精選高息,30,19,11,凱基-林口,2023-12-26,9257
2374,佳能,11,0,11,凱基-林口,2023-12-26,9257
6222,上揚,11,0,11,凱基-林口,2023-12-26,9257
8069,元太,11,1,10,凱基-林口,2023-12-26,9257
00751B,元大AAA至A公司債,10,0,10,凱基-林口,2023-12-26,9257
3308,聯德,10,0,10,凱基-林口,2023-12-26,9257
1733,五鼎,20,10,10,凱基-林口,2023-12-26,9257
2607,榮運,10,0,10,凱基-林口,2023-12-26,9257
4720,德淵,10,0,10,凱基-林口,2023-12-26,9257
2618,長榮航,21,12,9,凱基-林口,2023-12-26,9257
3479,安勤,9,0,9,凱基-林口,2023-12-26,9257
2382,廣達,12,4,8,凱基-林口,2023-12-26,9257
2377,微星,41,33,8,凱基-林口,2023-12-26,9257
6664,群翊,7,0,7,凱基-林口,2023-12-26,9257
2331,精英,20,14,6,凱基-林口,2023-12-26,9257
8103,瀚荃,6,0,6,凱基-林口,2023-12-26,9257
1513,中興電,9,4,5,凱基-林口,2023-12-26,9257
00632R,元大台灣50反1,5,0,5,凱基-林口,2023-12-26,9257
00933B,國泰10Y+金融債,5,0,5,凱基-林口,2023-12-26,9257
1522,堤維西,5,0,5,凱基-林口,2023-12-26,9257
1524,耿鼎,6,1,5,凱基-林口,2023-12-26,9257
1701,中化,5,0,5,凱基-林口,2023-12-26,9257
2363,矽統,6,1,5,凱基-林口,2023-12-26,9257
2369,菱生,5,0,5,凱基-林口,2023-12-26,9257
2425,承啟,5,0,5,凱基-林口,2023-12-26,9257
3311,閎暉,5,0,5,凱基-林口,2023-12-26,9257
5309,系統電,5,0,5,凱基-林口,2023-12-26,9257
5515,建國,5,0,5,凱基-林口,2023-12-26,9257
5530,龍巖,5,0,5,凱基-林口,2023-12-26,9257
00904,新光臺灣半導體30,4,0,4,凱基-林口,2023-12-26,9257
00712,復華富時不動產,4,0,4,凱基-林口,2023-12-26,9257
00726B,國泰新興投等債,4,0,4,凱基-林口,2023-12-26,9257
00937B,群益ESG投等債20,217,0,217,凱基-林口,2023-12-27,9257
00679B,元大美債20年,227,10,217,凱基-林口,2023-12-27,9257
00919,群益台灣精選高息,155,11,144,凱基-林口,2023-12-27,9257
00751B,元大AAA至A公司債,127,0,127,凱基-林口,2023-12-27,9257
3047,訊舟,105,0,105,凱基-林口,2023-12-27,9257
4413,飛寶企業,91,0,91,凱基-林口,2023-12-27,9257
00713,元大台灣高息低波,91,4,87,凱基-林口,2023-12-27,9257
2838,聯邦銀,62,0,62,凱基-林口,2023-12-27,9257
2618,長榮航,82,21,61,凱基-林口,2023-12-27,9257
2369,菱生,62,20,42,凱基-林口,2023-12-27,9257
00680L,元大美債20正2,50,10,40,凱基-林口,2023-12-27,9257
2353,宏��,113,83,30,凱基-林口,2023-12-27,9257
00688L,國泰20年美債正2,25,0,25,凱基-林口,2023-12-27,9257
00753L,中信中國50正2,25,0,25,凱基-林口,2023-12-27,9257
2405,輔信,98,75,23,凱基-林口,2023-12-27,9257
3481,群創,26,6,20,凱基-林口,2023-12-27,9257
8054,安國,22,2,20,凱基-林口,2023-12-27,9257
8936,國統,21,1,20,凱基-林口,2023-12-27,9257
2889,國票金,19,0,19,凱基-林口,2023-12-27,9257
00772B,中信高評級公司債,19,1,18,凱基-林口,2023-12-27,9257
2409,友達,18,1,17,凱基-林口,2023-12-27,9257
00632R,元大台灣50反1,15,0,15,凱基-林口,2023-12-27,9257
2328,廣宇,15,0,15,凱基-林口,2023-12-27,9257
3504,揚明光,15,0,15,凱基-林口,2023-12-27,9257
6668,中揚光,15,0,15,凱基-林口,2023-12-27,9257
8996,高力,22,7,15,凱基-林口,2023-12-27,9257
2542,興富發,20,6,14,凱基-林口,2023-12-27,9257
00900,富邦特選高股息30,14,0,14,凱基-林口,2023-12-27,9257
4979,華星光,14,1,13,凱基-林口,2023-12-27,9257
2402,毅嘉,17,6,11,凱基-林口,2023-12-27,9257
4123,晟德,11,0,11,凱基-林口,2023-12-27,9257
3532,台勝科,13,3,10,凱基-林口,2023-12-27,9257
1532,勤美,10,0,10,凱基-林口,2023-12-27,9257
1608,華榮,10,0,10,凱基-林口,2023-12-27,9257
1711,永光,10,0,10,凱基-林口,2023-12-27,9257
2331,精英,10,0,10,凱基-林口,2023-12-27,9257
3022,威強電,10,0,10,凱基-林口,2023-12-27,9257
3704,合勤控,10,0,10,凱基-林口,2023-12-27,9257
4173,久裕,10,0,10,凱基-林口,2023-12-27,9257
6129,普誠,11,1,10,凱基-林口,2023-12-27,9257
6186,新潤,10,0,10,凱基-林口,2023-12-27,9257
9934,成霖,10,0,10,凱基-林口,2023-12-27,9257
9962,有益,10,0,10,凱基-林口,2023-12-27,9257
3231,緯創,39,29,10,凱基-林口,2023-12-27,9257
1815,富喬,11,2,9,凱基-林口,2023-12-27,9257
3563,牧德,9,0,9,凱基-林口,2023-12-27,9257
5425,台半,34,25,9,凱基-林口,2023-12-27,9257
6550,北極星藥業-KY,12,3,9,凱基-林口,2023-12-27,9257
00720B,元大投資級公司債,8,0,8,凱基-林口,2023-12-27,9257
2421,建準,8,0,8,凱基-林口,2023-12-27,9257
2324,仁寶,326,57,269,凱基-林口,2023-12-28,9257
4402,郡都開發,135,21,114,凱基-林口,2023-12-28,9257
00919,群益台灣精選高息,79,1,78,凱基-林口,2023-12-28,9257
00679B,元大美債20年,88,22,66,凱基-林口,2023-12-28,9257
2618,長榮航,71,13,58,凱基-林口,2023-12-28,9257
00937B,群益ESG投等債20,77,20,57,凱基-林口,2023-12-28,9257
5530,龍巖,50,0,50,凱基-林口,2023-12-28,9257
00929,復華台灣科技優息,47,0,47,凱基-林口,2023-12-28,9257
2353,宏��,161,114,47,凱基-林口,2023-12-28,9257
3481,群創,146,102,44,凱基-林口,2023-12-28,9257
2801,彰銀,35,0,35,凱基-林口,2023-12-28,9257
2365,昆盈,38,5,33,凱基-林口,2023-12-28,9257
8011,台通,31,0,31,凱基-林口,2023-12-28,9257
2405,輔信,45,15,30,凱基-林口,2023-12-28,9257
2303,聯電,75,49,26,凱基-林口,2023-12-28,9257
00688L,國泰20年美債正2,25,0,25,凱基-林口,2023-12-28,9257
00687B,國泰20年美債,23,0,23,凱基-林口,2023-12-28,9257
4576,大銀微系統,21,0,21,凱基-林口,2023-12-28,9257
2352,佳世達,20,0,20,凱基-林口,2023-12-28,9257
00680L,元大美債20正2,20,0,20,凱基-林口,2023-12-28,9257
3376,新日興,25,7,18,凱基-林口,2023-12-28,9257
2020,美亞,15,0,15,凱基-林口,2023-12-28,9257
3006,晶豪科,30,16,14,凱基-林口,2023-12-28,9257
2328,廣宇,13,0,13,凱基-林口,2023-12-28,9257
2809,京城銀,13,0,13,凱基-林口,2023-12-28,9257
3380,明泰,13,0,13,凱基-林口,2023-12-28,9257
3231,緯創,25,13,12,凱基-林口,2023-12-28,9257
6276,安鈦克,16,4,12,凱基-林口,2023-12-28,9257
2882,國泰金,16,5,11,凱基-林口,2023-12-28,9257
00772B,中信高評級公司債,10,0,10,凱基-林口,2023-12-28,9257
2607,榮運,10,0,10,凱基-林口,2023-12-28,9257
00933B,國泰10Y+金融債,10,0,10,凱基-林口,2023-12-28,9257
3390,旭軟,12,2,10,凱基-林口,2023-12-28,9257
5355,佳總,10,0,10,凱基-林口,2023-12-28,9257
5498,凱崴,10,0,10,凱基-林口,2023-12-28,9257
6120,達運,10,0,10,凱基-林口,2023-12-28,9257
6186,新潤,10,0,10,凱基-林口,2023-12-28,9257
2408,南亞科,12,3,9,凱基-林口,2023-12-28,9257
0050,元大台灣50,11,2,9,凱基-林口,2023-12-28,9257
2609,陽明,22,13,9,凱基-林口,2023-12-28,9257
00891,中信關鍵半導體,10,2,8,凱基-林口,2023-12-28,9257
00918,大華優利高填息30,8,0,8,凱基-林口,2023-12-28,9257
6290,良維,8,0,8,凱基-林口,2023-12-28,9257
8059,凱碩,10,2,8,凱基-林口,2023-12-28,9257
00915,凱基優選高股息30,7,0,7,凱基-林口,2023-12-28,9257
2421,建準,7,0,7,凱基-林口,2023-12-28,9257
2838,聯邦銀,7,0,7,凱基-林口,2023-12-28,9257
5521,工信,7,0,7,凱基-林口,2023-12-28,9257
6550,北極星藥業-KY,12,5,7,凱基-林口,2023-12-28,9257
6568,宏觀,7,0,7,凱基-林口,2023-12-28,9257
2331,精英,178,12,166,凱基-林口,2023-12-29,9257
00936,台新永續高息中小,73,0,73,凱基-林口,2023-12-29,9257
00937B,群益ESG投等債20,63,0,63,凱基-林口,2023-12-29,9257
00679B,元大美債20年,61,2,59,凱基-林口,2023-12-29,9257
2340,台亞,50,0,50,凱基-林口,2023-12-29,9257
4123,晟德,40,0,40,凱基-林口,2023-12-29,9257
4402,郡都開發,80,47,33,凱基-林口,2023-12-29,9257
2303,聯電,122,91,31,凱基-林口,2023-12-29,9257
2353,宏��,84,53,31,凱基-林口,2023-12-29,9257
00687B,國泰20年美債,29,0,29,凱基-林口,2023-12-29,9257
4576,大銀微系統,28,0,28,凱基-林口,2023-12-29,9257
5213,亞昕,28,0,28,凱基-林口,2023-12-29,9257
00891,中信關鍵半導體,25,0,25,凱基-林口,2023-12-29,9257
2344,華邦電,99,75,24,凱基-林口,2023-12-29,9257
1608,華榮,20,0,20,凱基-林口,2023-12-29,9257
1609,大亞,21,1,20,凱基-林口,2023-12-29,9257
3260,威剛,43,23,20,凱基-林口,2023-12-29,9257
5324,士開,20,0,20,凱基-林口,2023-12-29,9257
2027,大成鋼,18,0,18,凱基-林口,2023-12-29,9257
3006,晶豪科,24,7,17,凱基-林口,2023-12-29,9257
2352,佳世達,67,52,15,凱基-林口,2023-12-29,9257
00929,復華台灣科技優息,44,32,12,凱基-林口,2023-12-29,9257
6282,康舒,17,6,11,凱基-林口,2023-12-29,9257
00688L,國泰20年美債正2,10,0,10,凱基-林口,2023-12-29,9257
00650L,復華香港正2,10,0,10,凱基-林口,2023-12-29,9257
1503,士電,19,9,10,凱基-林口,2023-12-29,9257
1909,榮成,10,0,10,凱基-林口,2023-12-29,9257
2337,旺宏,10,0,10,凱基-林口,2023-12-29,9257
2399,映泰,10,0,10,凱基-林口,2023-12-29,9257
2472,立隆電,10,0,10,凱基-林口,2023-12-29,9257
4127,天良,10,0,10,凱基-林口,2023-12-29,9257
5450,南良,10,0,10,凱基-林口,2023-12-29,9257
6180,橘子,10,0,10,凱基-林口,2023-12-29,9257
6426,統新,10,0,10,凱基-林口,2023-12-29,9257
00795B,中信美國公債20年,9,0,9,凱基-林口,2023-12-29,9257
1514,亞力,38,29,9,凱基-林口,2023-12-29,9257
6125,廣運,14,5,9,凱基-林口,2023-12-29,9257
2107,厚生,8,0,8,凱基-林口,2023-12-29,9257
3288,點晶,8,0,8,凱基-林口,2023-12-29,9257
5521,工信,31,23,8,凱基-林口,2023-12-29,9257
5351,鈺創,11,4,7,凱基-林口,2023-12-29,9257
1519,華城,22,15,7,凱基-林口,2023-12-29,9257
1605,華新,7,0,7,凱基-林口,2023-12-29,9257
3706,神達,12,5,7,凱基-林口,2023-12-29,9257
5210,寶碩,7,0,7,凱基-林口,2023-12-29,9257
6933,AMAX-KY,7,0,7,凱基-林口,2023-12-29,9257
6488,環球晶,7,0,7,凱基-林口,2023-12-29,9257
6593,台灣銘板,8,1,7,凱基-林口,2023-12-29,9257
2465,麗臺,7,1,6,凱基-林口,2023-12-29,9257
00720B,元大投資級公司債,6,0,6,凱基-林口,2023-12-29,9257
3047,訊舟,205,0,205,凱基-林口,2024-01-02,9257
00687B,國泰20年美債,151,5,146,凱基-林口,2024-01-02,9257
00937B,群益ESG投等債20,146,1,145,凱基-林口,2024-01-02,9257
3706,神達,67,5,62,凱基-林口,2024-01-02,9257
9945,潤泰新,54,2,52,凱基-林口,2024-01-02,9257
00919,群益台灣精選高息,51,0,51,凱基-林口,2024-01-02,9257
3231,緯創,107,59,48,凱基-林口,2024-01-02,9257
6668,中揚光,52,9,43,凱基-林口,2024-01-02,9257
1337,再生-KY,40,0,40,凱基-林口,2024-01-02,9257
00878,國泰永續高股息,42,3,39,凱基-林口,2024-01-02,9257
00679B,元大美債20年,43,6,37,凱基-林口,2024-01-02,9257
5425,台半,67,32,35,凱基-林口,2024-01-02,9257
1513,中興電,38,8,30,凱基-林口,2024-01-02,9257
3481,群創,75,45,30,凱基-林口,2024-01-02,9257
8085,福華,30,0,30,凱基-林口,2024-01-02,9257
8477,創業家,30,0,30,凱基-林口,2024-01-02,9257
2332,友訊,30,2,28,凱基-林口,2024-01-02,9257
00929,復華台灣科技優息,26,0,26,凱基-林口,2024-01-02,9257
00915,凱基優選高股息30,26,0,26,凱基-林口,2024-01-02,9257
5213,亞昕,25,0,25,凱基-林口,2024-01-02,9257
00772B,中信高評級公司債,25,1,24,凱基-林口,2024-01-02,9257
00637L,元大滬深300正2,22,0,22,凱基-林口,2024-01-02,9257
00923,群益台ESG低碳50,20,0,20,凱基-林口,2024-01-02,9257
00936,台新永續高息中小,20,0,20,凱基-林口,2024-01-02,9257
2382,廣達,33,13,20,凱基-林口,2024-01-02,9257
2352,佳世達,25,7,18,凱基-林口,2024-01-02,9257
2356,英業達,58,41,17,凱基-林口,2024-01-02,9257
00720B,元大投資級公司債,17,2,15,凱基-林口,2024-01-02,9257
1471,首利,15,0,15,凱基-林口,2024-01-02,9257
00900,富邦特選高股息30,17,2,15,凱基-林口,2024-01-02,9257
00934,中信成長高股息,14,0,14,凱基-林口,2024-01-02,9257
3694,海華,13,0,13,凱基-林口,2024-01-02,9257
00891,中信關鍵半導體,12,0,12,凱基-林口,2024-01-02,9257
8092,建暐,11,0,11,凱基-林口,2024-01-02,9257
3006,晶豪科,14,3,11,凱基-林口,2024-01-02,9257
00918,大華優利高填息30,11,1,10,凱基-林口,2024-01-02,9257
2731,雄獅,10,0,10,凱基-林口,2024-01-02,9257
3221,台嘉碩,10,0,10,凱基-林口,2024-01-02,9257
3630,新鉅科,10,0,10,凱基-林口,2024-01-02,9257
6186,新潤,10,0,10,凱基-林口,2024-01-02,9257
0056,元大高股息,15,5,10,凱基-林口,2024-01-02,9257
00712,復華富時不動產,9,0,9,凱基-林口,2024-01-02,9257
4736,泰博,9,0,9,凱基-林口,2024-01-02,9257
6196,帆宣,10,1,9,凱基-林口,2024-01-02,9257
8011,台通,9,0,9,凱基-林口,2024-01-02,9257
2457,飛宏,9,0,9,凱基-林口,2024-01-02,9257
00642U,期元大S＆P石油,8,0,8,凱基-林口,2024-01-02,9257
6541,泰福-KY,8,0,8,凱基-林口,2024-01-02,9257
1524,耿鼎,7,0,7,凱基-林口,2024-01-02,9257
3017,奇鋐,20,13,7,凱基-林口,2024-01-02,9257
2618,長榮航,563,15,548,凱基-林口,2024-01-03,9257
00937B,群益ESG投等債20,215,0,215,凱基-林口,2024-01-03,9257
2352,佳世達,90,0,90,凱基-林口,2024-01-03,9257
0056,元大高股息,91,2,89,凱基-林口,2024-01-03,9257
00919,群益台灣精選高息,72,0,72,凱基-林口,2024-01-03,9257
9105,泰金寶-DR,70,0,70,凱基-林口,2024-01-03,9257
2609,陽明,130,78,52,凱基-林口,2024-01-03,9257
2801,彰銀,43,0,43,凱基-林口,2024-01-03,9257
0050,元大台灣50,38,2,36,凱基-林口,2024-01-03,9257
2353,宏��,96,61,35,凱基-林口,2024-01-03,9257
3231,緯創,46,12,34,凱基-林口,2024-01-03,9257
2356,英業達,38,5,33,凱基-林口,2024-01-03,9257
2331,精英,65,35,30,凱基-林口,2024-01-03,9257
6770,力積電,27,0,27,凱基-林口,2024-01-03,9257
00713,元大台灣高息低波,24,0,24,凱基-林口,2024-01-03,9257
2610,華航,25,2,23,凱基-林口,2024-01-03,9257
00915,凱基優選高股息30,21,0,21,凱基-林口,2024-01-03,9257
1609,大亞,21,1,20,凱基-林口,2024-01-03,9257
1337,再生-KY,20,0,20,凱基-林口,2024-01-03,9257
4576,大銀微系統,20,0,20,凱基-林口,2024-01-03,9257
6196,帆宣,20,0,20,凱基-林口,2024-01-03,9257
00934,中信成長高股息,19,0,19,凱基-林口,2024-01-03,9257
00927,群益半導體收益,18,0,18,凱基-林口,2024-01-03,9257
6292,迅德,18,0,18,凱基-林口,2024-01-03,9257
00720B,元大投資級公司債,16,0,16,凱基-林口,2024-01-03,9257
3260,威剛,16,0,16,凱基-林口,2024-01-03,9257
4960,誠美材,20,4,16,凱基-林口,2024-01-03,9257
6719,力智,15,0,15,凱基-林口,2024-01-03,9257
00918,大華優利高填息30,15,0,15,凱基-林口,2024-01-03,9257
2303,聯電,17,3,14,凱基-林口,2024-01-03,9257
6108,競國,14,0,14,凱基-林口,2024-01-03,9257
8477,創業家,14,0,14,凱基-林口,2024-01-03,9257
2344,華邦電,18,5,13,凱基-林口,2024-01-03,9257
3711,日月光投控,14,1,13,凱基-林口,2024-01-03,9257
6222,上揚,13,0,13,凱基-林口,2024-01-03,9257
3006,晶豪科,15,3,12,凱基-林口,2024-01-03,9257
00891,中信關鍵半導體,12,0,12,凱基-林口,2024-01-03,9257
2641,正德,19,7,12,凱基-林口,2024-01-03,9257
5213,亞昕,12,0,12,凱基-林口,2024-01-03,9257
2885,元大金,13,2,11,凱基-林口,2024-01-03,9257
00712,復華富時不動產,11,0,11,凱基-林口,2024-01-03,9257
2515,中工,11,0,11,凱基-林口,2024-01-03,9257
2455,全新,10,0,10,凱基-林口,2024-01-03,9257
00715L,期街口布蘭特正2,10,0,10,凱基-林口,2024-01-03,9257
1612,宏泰,10,0,10,凱基-林口,2024-01-03,9257
1733,五鼎,10,0,10,凱基-林口,2024-01-03,9257
2838,聯邦銀,10,0,10,凱基-林口,2024-01-03,9257
9802,鈺齊-KY,10,0,10,凱基-林口,2024-01-03,9257
2201,裕隆,9,0,9,凱基-林口,2024-01-03,9257
00773B,中信優先金融債,10,1,9,凱基-林口,2024-01-03,9257
2324,仁寶,211,4,207,凱基-林口,2024-01-04,9257
2363,矽統,88,13,75,凱基-林口,2024-01-04,9257
3390,旭軟,72,3,69,凱基-林口,2024-01-04,9257
3706,神達,68,2,66,凱基-林口,2024-01-04,9257
5521,工信,65,0,65,凱基-林口,2024-01-04,9257
00929,復華台灣科技優息,59,0,59,凱基-林口,2024-01-04,9257
00927,群益半導體收益,47,0,47,凱基-林口,2024-01-04,9257
00937B,群益ESG投等債20,54,8,46,凱基-林口,2024-01-04,9257
6185,幃翔,40,0,40,凱基-林口,2024-01-04,9257
2449,京元電子,38,2,36,凱基-林口,2024-01-04,9257
00720B,元大投資級公司債,32,0,32,凱基-林口,2024-01-04,9257
00712,復華富時不動產,30,0,30,凱基-林口,2024-01-04,9257
2486,一詮,30,0,30,凱基-林口,2024-01-04,9257
6292,迅德,31,1,30,凱基-林口,2024-01-04,9257
6668,中揚光,29,0,29,凱基-林口,2024-01-04,9257
2362,藍天,28,3,25,凱基-林口,2024-01-04,9257
4167,松瑞藥,30,6,24,凱基-林口,2024-01-04,9257
6233,旺玖,27,3,24,凱基-林口,2024-01-04,9257
2303,聯電,36,15,21,凱基-林口,2024-01-04,9257
2515,中工,21,0,21,凱基-林口,2024-01-04,9257
3376,新日興,21,0,21,凱基-林口,2024-01-04,9257
3694,海華,22,1,21,凱基-林口,2024-01-04,9257
0056,元大高股息,42,22,20,凱基-林口,2024-01-04,9257
1325,恆大,21,1,20,凱基-林口,2024-01-04,9257
3311,閎暉,20,0,20,凱基-林口,2024-01-04,9257
00753L,中信中國50正2,20,1,19,凱基-林口,2024-01-04,9257
4702,中美實,19,0,19,凱基-林口,2024-01-04,9257
9919,康那香,76,57,19,凱基-林口,2024-01-04,9257
2356,英業達,78,60,18,凱基-林口,2024-01-04,9257
3041,揚智,20,2,18,凱基-林口,2024-01-04,9257
2331,精英,17,0,17,凱基-林口,2024-01-04,9257
2915,潤泰全,15,0,15,凱基-林口,2024-01-04,9257
5880,合庫金,15,0,15,凱基-林口,2024-01-04,9257
8046,南電,13,0,13,凱基-林口,2024-01-04,9257
1514,亞力,18,6,12,凱基-林口,2024-01-04,9257
00772B,中信高評級公司債,12,0,12,凱基-林口,2024-01-04,9257
3704,合勤控,12,0,12,凱基-林口,2024-01-04,9257
2376,技嘉,12,1,11,凱基-林口,2024-01-04,9257
1609,大亞,11,0,11,凱基-林口,2024-01-04,9257
2101,南港,19,8,11,凱基-林口,2024-01-04,9257
3260,威剛,11,0,11,凱基-林口,2024-01-04,9257
00885,富邦越南,15,5,10,凱基-林口,2024-01-04,9257
00905,FT臺灣Smart,10,0,10,凱基-林口,2024-01-04,9257
2328,廣宇,10,0,10,凱基-林口,2024-01-04,9257
2340,台亞,10,0,10,凱基-林口,2024-01-04,9257
3479,安勤,10,0,10,凱基-林口,2024-01-04,9257
6719,力智,10,0,10,凱基-林口,2024-01-04,9257
3231,緯創,35,26,9,凱基-林口,2024-01-04,9257
3032,偉訓,13,4,9,凱基-林口,2024-01-04,9257
5608,四維航,8,0,8,凱基-林口,2024-01-04,9257
00929,復華台灣科技優息,173,0,173,凱基-林口,2024-01-05,9257
3232,昱捷,116,0,116,凱基-林口,2024-01-05,9257
2609,陽明,203,89,114,凱基-林口,2024-01-05,9257
2356,英業達,116,12,104,凱基-林口,2024-01-05,9257
3390,旭軟,100,2,98,凱基-林口,2024-01-05,9257
3481,群創,145,53,92,凱基-林口,2024-01-05,9257
00937B,群益ESG投等債20,75,10,65,凱基-林口,2024-01-05,9257
00679B,元大美債20年,84,22,62,凱基-林口,2024-01-05,9257
2353,宏��,87,27,60,凱基-林口,2024-01-05,9257
00687B,國泰20年美債,68,15,53,凱基-林口,2024-01-05,9257
2363,矽統,30,0,30,凱基-林口,2024-01-05,9257
4167,松瑞藥,30,0,30,凱基-林口,2024-01-05,9257
6292,迅德,30,0,30,凱基-林口,2024-01-05,9257
00919,群益台灣精選高息,29,0,29,凱基-林口,2024-01-05,9257
00720B,元大投資級公司債,28,0,28,凱基-林口,2024-01-05,9257
8034,榮群,27,0,27,凱基-林口,2024-01-05,9257
2723,美食-KY,25,0,25,凱基-林口,2024-01-05,9257
2615,萬海,38,16,22,凱基-林口,2024-01-05,9257
8011,台通,22,0,22,凱基-林口,2024-01-05,9257
8121,越峰,20,0,20,凱基-林口,2024-01-05,9257
2486,一詮,20,1,19,凱基-林口,2024-01-05,9257
2891,中信金,22,5,17,凱基-林口,2024-01-05,9257
00712,復華富時不動產,16,0,16,凱基-林口,2024-01-05,9257
2605,新興,16,0,16,凱基-林口,2024-01-05,9257
00885,富邦越南,16,0,16,凱基-林口,2024-01-05,9257
00915,凱基優選高股息30,15,0,15,凱基-林口,2024-01-05,9257
00881,國泰台灣5G+,14,0,14,凱基-林口,2024-01-05,9257
8046,南電,13,0,13,凱基-林口,2024-01-05,9257
2301,光寶科,13,0,13,凱基-林口,2024-01-05,9257
00934,中信成長高股息,12,0,12,凱基-林口,2024-01-05,9257
2303,聯電,31,19,12,凱基-林口,2024-01-05,9257
00770,國泰北美科技,11,0,11,凱基-林口,2024-01-05,9257
2393,億光,11,0,11,凱基-林口,2024-01-05,9257
3540,曜越,11,0,11,凱基-林口,2024-01-05,9257
6108,競國,13,2,11,凱基-林口,2024-01-05,9257
2885,元大金,12,1,11,凱基-林口,2024-01-05,9257
9103,美德醫療-DR,10,0,10,凱基-林口,2024-01-05,9257
1101,台泥,10,0,10,凱基-林口,2024-01-05,9257
1455,集盛,10,0,10,凱基-林口,2024-01-05,9257
2906,高林,10,0,10,凱基-林口,2024-01-05,9257
5202,力新,10,0,10,凱基-林口,2024-01-05,9257
00936,台新永續高息中小,10,1,9,凱基-林口,2024-01-05,9257
8936,國統,9,0,9,凱基-林口,2024-01-05,9257
2636,台驊控股,11,2,9,凱基-林口,2024-01-05,9257
3037,欣興,8,0,8,凱基-林口,2024-01-05,9257
00751B,元大AAA至A公司債,18,10,8,凱基-林口,2024-01-05,9257
00655L,國泰中國A50正2,8,0,8,凱基-林口,2024-01-05,9257
2867,三商壽,10,2,8,凱基-林口,2024-01-05,9257
6290,良維,8,0,8,凱基-林口,2024-01-05,9257
2641,正德,12,5,7,凱基-林口,2024-01-05,9257
2331,精英,155,7,148,凱基-林口,2024-01-08,9257
2498,宏達電,113,8,105,凱基-林口,2024-01-08,9257
00919,群益台灣精選高息,98,9,89,凱基-林口,2024-01-08,9257
00687B,國泰20年美債,146,61,85,凱基-林口,2024-01-08,9257
2353,宏��,103,20,83,凱基-林口,2024-01-08,9257
00937B,群益ESG投等債20,78,4,74,凱基-林口,2024-01-08,9257
00929,復華台灣科技優息,83,10,73,凱基-林口,2024-01-08,9257
00679B,元大美債20年,72,0,72,凱基-林口,2024-01-08,9257
2509,全坤建,55,0,55,凱基-林口,2024-01-08,9257
3232,昱捷,51,0,51,凱基-林口,2024-01-08,9257
00633L,富邦上証正2,50,0,50,凱基-林口,2024-01-08,9257
1609,大亞,50,0,50,凱基-林口,2024-01-08,9257
4167,松瑞藥,40,0,40,凱基-林口,2024-01-08,9257
00680L,元大美債20正2,35,0,35,凱基-林口,2024-01-08,9257
00637L,元大滬深300正2,37,3,34,凱基-林口,2024-01-08,9257
1319,東陽,32,0,32,凱基-林口,2024-01-08,9257
00902,中信電池及儲能,30,0,30,凱基-林口,2024-01-08,9257
3163,波若威,24,0,24,凱基-林口,2024-01-08,9257
00772B,中信高評級公司債,33,10,23,凱基-林口,2024-01-08,9257
00720B,元大投資級公司債,36,13,23,凱基-林口,2024-01-08,9257
00882,中信中國高股息,25,4,21,凱基-林口,2024-01-08,9257
00632R,元大台灣50反1,20,0,20,凱基-林口,2024-01-08,9257
2393,億光,20,0,20,凱基-林口,2024-01-08,9257
2442,新美齊,20,0,20,凱基-林口,2024-01-08,9257
8092,建暐,20,0,20,凱基-林口,2024-01-08,9257
2388,威盛,33,14,19,凱基-林口,2024-01-08,9257
1455,集盛,17,0,17,凱基-林口,2024-01-08,9257
1513,中興電,18,1,17,凱基-林口,2024-01-08,9257
8011,台通,16,2,14,凱基-林口,2024-01-08,9257
3374,精材,13,0,13,凱基-林口,2024-01-08,9257
2610,華航,12,0,12,凱基-林口,2024-01-08,9257
1612,宏泰,19,7,12,凱基-林口,2024-01-08,9257
6108,競國,12,0,12,凱基-林口,2024-01-08,9257
2607,榮運,11,0,11,凱基-林口,2024-01-08,9257
2303,聯電,17,6,11,凱基-林口,2024-01-08,9257
2489,瑞軒,21,10,11,凱基-林口,2024-01-08,9257
00752,中信中國50,11,0,11,凱基-林口,2024-01-08,9257
3041,揚智,10,0,10,凱基-林口,2024-01-08,9257
3588,通嘉,27,17,10,凱基-林口,2024-01-08,9257
6156,松上,10,0,10,凱基-林口,2024-01-08,9257
5521,工信,32,23,9,凱基-林口,2024-01-08,9257
6603,富強鑫,9,0,9,凱基-林口,2024-01-08,9257
8227,巨有科技,10,2,8,凱基-林口,2024-01-08,9257
3390,旭軟,12,5,7,凱基-林口,2024-01-08,9257
4934,太極,7,0,7,凱基-林口,2024-01-08,9257
2344,華邦電,16,10,6,凱基-林口,2024-01-08,9257
2201,裕隆,6,0,6,凱基-林口,2024-01-08,9257
00934,中信成長高股息,6,0,6,凱基-林口,2024-01-08,9257
00881,國泰台灣5G+,6,0,6,凱基-林口,2024-01-08,9257
1101,台泥,6,0,6,凱基-林口,2024-01-08,9257
2882,國泰金,151,0,151,凱基-林口,2024-01-09,9257
00919,群益台灣精選高息,137,3,134,凱基-林口,2024-01-09,9257
00927,群益半導體收益,106,0,106,凱基-林口,2024-01-09,9257
00929,復華台灣科技優息,101,10,91,凱基-林口,2024-01-09,9257
0050,元大台灣50,60,2,58,凱基-林口,2024-01-09,9257
2618,長榮航,112,60,52,凱基-林口,2024-01-09,9257
00772B,中信高評級公司債,52,2,50,凱基-林口,2024-01-09,9257
2356,英業達,44,3,41,凱基-林口,2024-01-09,9257
5521,工信,36,0,36,凱基-林口,2024-01-09,9257
3035,智原,37,5,32,凱基-林口,2024-01-09,9257
2609,陽明,55,24,31,凱基-林口,2024-01-09,9257
6219,富旺,31,1,30,凱基-林口,2024-01-09,9257
2312,金寶,26,0,26,凱基-林口,2024-01-09,9257
2324,仁寶,77,52,25,凱基-林口,2024-01-09,9257
2457,飛宏,22,0,22,凱基-林口,2024-01-09,9257
9919,康那香,21,0,21,凱基-林口,2024-01-09,9257
3260,威剛,20,0,20,凱基-林口,2024-01-09,9257
6191,精成科,21,1,20,凱基-林口,2024-01-09,9257
00633L,富邦上証正2,20,0,20,凱基-林口,2024-01-09,9257
3576,聯合再生,20,0,20,凱基-林口,2024-01-09,9257
6550,北極星藥業-KY,20,0,20,凱基-林口,2024-01-09,9257
8085,福華,21,1,20,凱基-林口,2024-01-09,9257
00878,國泰永續高股息,31,12,19,凱基-林口,2024-01-09,9257
3325,旭品,19,0,19,凱基-林口,2024-01-09,9257
6125,廣運,18,0,18,凱基-林口,2024-01-09,9257
00679B,元大美債20年,21,6,15,凱基-林口,2024-01-09,9257
2362,藍天,30,15,15,凱基-林口,2024-01-09,9257
2617,台航,14,0,14,凱基-林口,2024-01-09,9257
3481,群創,16,2,14,凱基-林口,2024-01-09,9257
00637L,元大滬深300正2,13,0,13,凱基-林口,2024-01-09,9257
00680L,元大美債20正2,13,0,13,凱基-林口,2024-01-09,9257
00715L,期街口布蘭特正2,12,0,12,凱基-林口,2024-01-09,9257
2002,中鋼,14,2,12,凱基-林口,2024-01-09,9257
2801,彰銀,11,0,11,凱基-林口,2024-01-09,9257
3163,波若威,11,0,11,凱基-林口,2024-01-09,9257
6770,力積電,11,0,11,凱基-林口,2024-01-09,9257
8936,國統,11,0,11,凱基-林口,2024-01-09,9257
00882,中信中國高股息,13,2,11,凱基-林口,2024-01-09,9257
2421,建準,10,0,10,凱基-林口,2024-01-09,9257
2303,聯電,16,6,10,凱基-林口,2024-01-09,9257
2614,東森,10,0,10,凱基-林口,2024-01-09,9257
00885,富邦越南,10,0,10,凱基-林口,2024-01-09,9257
00753L,中信中國50正2,10,0,10,凱基-林口,2024-01-09,9257
00891,中信關鍵半導體,10,0,10,凱基-林口,2024-01-09,9257
00915,凱基優選高股息30,10,0,10,凱基-林口,2024-01-09,9257
1319,東陽,10,0,10,凱基-林口,2024-01-09,9257
3710,連展投控,10,0,10,凱基-林口,2024-01-09,9257
5469,瀚宇博,10,0,10,凱基-林口,2024-01-09,9257
6593,台灣銘板,10,0,10,凱基-林口,2024-01-09,9257
8114,振樺電,10,0,10,凱基-林口,2024-01-09,9257
2882,國泰金,150,0,150,凱基-林口,2024-01-10,9257
00919,群益台灣精選高息,146,15,131,凱基-林口,2024-01-10,9257
00927,群益半導體收益,111,0,111,凱基-林口,2024-01-10,9257
00770,國泰北美科技,100,0,100,凱基-林口,2024-01-10,9257
00929,復華台灣科技優息,76,3,73,凱基-林口,2024-01-10,9257
3013,晟銘電,56,0,56,凱基-林口,2024-01-10,9257
2002,中鋼,51,0,51,凱基-林口,2024-01-10,9257
2609,陽明,91,41,50,凱基-林口,2024-01-10,9257
6414,樺漢,41,0,41,凱基-林口,2024-01-10,9257
2457,飛宏,45,5,40,凱基-林口,2024-01-10,9257
5521,工信,35,2,33,凱基-林口,2024-01-10,9257
9105,泰金寶-DR,30,2,28,凱基-林口,2024-01-10,9257
0056,元大高股息,61,33,28,凱基-林口,2024-01-10,9257
1515,力山,28,0,28,凱基-林口,2024-01-10,9257
00878,國泰永續高股息,27,2,25,凱基-林口,2024-01-10,9257
6770,力積電,24,0,24,凱基-林口,2024-01-10,9257
2312,金寶,23,0,23,凱基-林口,2024-01-10,9257
2618,長榮航,26,5,21,凱基-林口,2024-01-10,9257
1319,東陽,21,0,21,凱基-林口,2024-01-10,9257
00671R,富邦NASDAQ反1,20,0,20,凱基-林口,2024-01-10,9257
00669R,國泰美國道瓊反1,20,0,20,凱基-林口,2024-01-10,9257
1455,集盛,20,0,20,凱基-林口,2024-01-10,9257
2241,艾姆勒,20,0,20,凱基-林口,2024-01-10,9257
2027,大成鋼,15,0,15,凱基-林口,2024-01-10,9257
2460,建通,15,0,15,凱基-林口,2024-01-10,9257
2409,友達,23,11,12,凱基-林口,2024-01-10,9257
00680L,元大美債20正2,12,0,12,凱基-林口,2024-01-10,9257
6278,台表科,12,0,12,凱基-林口,2024-01-10,9257
00679B,元大美債20年,12,1,11,凱基-林口,2024-01-10,9257
2610,華航,16,5,11,凱基-林口,2024-01-10,9257
00937B,群益ESG投等債20,13,2,11,凱基-林口,2024-01-10,9257
2342,茂矽,11,0,11,凱基-林口,2024-01-10,9257
9958,世紀鋼,12,1,11,凱基-林口,2024-01-10,9257
1609,大亞,12,2,10,凱基-林口,2024-01-10,9257
2467,志聖,10,0,10,凱基-林口,2024-01-10,9257
00753L,中信中國50正2,10,0,10,凱基-林口,2024-01-10,9257
2537,聯上發,10,0,10,凱基-林口,2024-01-10,9257
2617,台航,10,0,10,凱基-林口,2024-01-10,9257
2743,山富,10,0,10,凱基-林口,2024-01-10,9257
5469,瀚宇博,10,0,10,凱基-林口,2024-01-10,9257
6719,力智,10,0,10,凱基-林口,2024-01-10,9257
9934,成霖,10,0,10,凱基-林口,2024-01-10,9257
00637L,元大滬深300正2,10,1,9,凱基-林口,2024-01-10,9257
4909,新復興,9,0,9,凱基-林口,2024-01-10,9257
8111,立��,15,6,9,凱基-林口,2024-01-10,9257
2603,長榮,22,13,9,凱基-林口,2024-01-10,9257
1519,華城,18,10,8,凱基-林口,2024-01-10,9257
2362,藍天,16,8,8,凱基-林口,2024-01-10,9257
2498,宏達電,9,1,8,凱基-林口,2024-01-10,9257
2324,仁寶,14,6,8,凱基-林口,2024-01-10,9257
2329,華泰,296,14,282,凱基-林口,2024-01-11,9257
00927,群益半導體收益,210,0,210,凱基-林口,2024-01-11,9257
2331,精英,189,6,183,凱基-林口,2024-01-11,9257
2352,佳世達,104,0,104,凱基-林口,2024-01-11,9257
00937B,群益ESG投等債20,104,10,94,凱基-林口,2024-01-11,9257
2882,國泰金,91,1,90,凱基-林口,2024-01-11,9257
4161,聿新科,65,0,65,凱基-林口,2024-01-11,9257
00919,群益台灣精選高息,73,16,57,凱基-林口,2024-01-11,9257
2243,宏旭-KY,52,0,52,凱基-林口,2024-01-11,9257
6719,力智,41,0,41,凱基-林口,2024-01-11,9257
5211,蒙恬,38,0,38,凱基-林口,2024-01-11,9257
00679B,元大美債20年,39,2,37,凱基-林口,2024-01-11,9257
2449,京元電子,31,0,31,凱基-林口,2024-01-11,9257
00929,復華台灣科技優息,51,21,30,凱基-林口,2024-01-11,9257
6239,力成,29,0,29,凱基-林口,2024-01-11,9257
00900,富邦特選高股息30,23,0,23,凱基-林口,2024-01-11,9257
2363,矽統,33,12,21,凱基-林口,2024-01-11,9257
00650L,復華香港正2,20,0,20,凱基-林口,2024-01-11,9257
2303,聯電,20,0,20,凱基-林口,2024-01-11,9257
2537,聯上發,20,0,20,凱基-林口,2024-01-11,9257
3576,聯合再生,20,0,20,凱基-林口,2024-01-11,9257
00878,國泰永續高股息,20,2,18,凱基-林口,2024-01-11,9257
2371,大同,23,5,18,凱基-林口,2024-01-11,9257
2743,山富,20,3,17,凱基-林口,2024-01-11,9257
5450,南良,17,0,17,凱基-林口,2024-01-11,9257
4702,中美實,15,0,15,凱基-林口,2024-01-11,9257
2610,華航,13,0,13,凱基-林口,2024-01-11,9257
2324,仁寶,16,3,13,凱基-林口,2024-01-11,9257
2454,聯發科,13,0,13,凱基-林口,2024-01-11,9257
3622,洋華,15,2,13,凱基-林口,2024-01-11,9257
2317,鴻海,21,8,13,凱基-林口,2024-01-11,9257
2344,華邦電,12,0,12,凱基-林口,2024-01-11,9257
3712,永崴投控,13,1,12,凱基-林口,2024-01-11,9257
1529,樂事綠能,11,0,11,凱基-林口,2024-01-11,9257
2362,藍天,18,7,11,凱基-林口,2024-01-11,9257
3321,同泰,11,0,11,凱基-林口,2024-01-11,9257
00905,FT臺灣Smart,10,0,10,凱基-林口,2024-01-11,9257
00680L,元大美債20正2,10,0,10,凱基-林口,2024-01-11,9257
00688L,國泰20年美債正2,10,0,10,凱基-林口,2024-01-11,9257
00676R,富邦臺灣加權反1,10,0,10,凱基-林口,2024-01-11,9257
1303,南亞,10,0,10,凱基-林口,2024-01-11,9257
2406,國碩,10,0,10,凱基-林口,2024-01-11,9257
2543,皇昌,31,21,10,凱基-林口,2024-01-11,9257
2867,三商壽,10,0,10,凱基-林口,2024-01-11,9257
3390,旭軟,22,12,10,凱基-林口,2024-01-11,9257
4953,緯軟,10,0,10,凱基-林口,2024-01-11,9257
5203,訊連,11,1,10,凱基-林口,2024-01-11,9257
5355,佳總,10,0,10,凱基-林口,2024-01-11,9257
8028,昇陽半導體,10,0,10,凱基-林口,2024-01-11,9257
8114,振樺電,10,0,10,凱基-林口,2024-01-11,9257
2324,仁寶,104,1,103,凱基-林口,2024-01-12,9257
4161,聿新科,95,0,95,凱基-林口,2024-01-12,9257
2352,佳世達,50,0,50,凱基-林口,2024-01-12,9257
00927,群益半導體收益,49,0,49,凱基-林口,2024-01-12,9257
00932,兆豐永續高息等權,44,0,44,凱基-林口,2024-01-12,9257
0056,元大高股息,53,10,43,凱基-林口,2024-01-12,9257
2243,宏旭-KY,41,0,41,凱基-林口,2024-01-12,9257
2609,陽明,80,39,41,凱基-林口,2024-01-12,9257
00929,復華台灣科技優息,47,12,35,凱基-林口,2024-01-12,9257
8011,台通,31,0,31,凱基-林口,2024-01-12,9257
00919,群益台灣精選高息,40,10,30,凱基-林口,2024-01-12,9257
2329,華泰,28,5,23,凱基-林口,2024-01-12,9257
2890,永豐金,24,2,22,凱基-林口,2024-01-12,9257
5211,蒙恬,21,0,21,凱基-林口,2024-01-12,9257
00753L,中信中國50正2,20,0,20,凱基-林口,2024-01-12,9257
00751B,元大AAA至A公司債,25,5,20,凱基-林口,2024-01-12,9257
2801,彰銀,20,0,20,凱基-林口,2024-01-12,9257
4953,緯軟,20,0,20,凱基-林口,2024-01-12,9257
00878,國泰永續高股息,19,0,19,凱基-林口,2024-01-12,9257
2363,矽統,20,1,19,凱基-林口,2024-01-12,9257
00687B,國泰20年美債,13,0,13,凱基-林口,2024-01-12,9257
00918,大華優利高填息30,13,0,13,凱基-林口,2024-01-12,9257
00934,中信成長高股息,13,0,13,凱基-林口,2024-01-12,9257
2371,大同,13,0,13,凱基-林口,2024-01-12,9257
8150,南茂,24,11,13,凱基-林口,2024-01-12,9257
2331,精英,14,2,12,凱基-林口,2024-01-12,9257
6140,訊達,33,21,12,凱基-林口,2024-01-12,9257
00904,新光臺灣半導體30,10,0,10,凱基-林口,2024-01-12,9257
00680L,元大美債20正2,10,0,10,凱基-林口,2024-01-12,9257
00885,富邦越南,10,0,10,凱基-林口,2024-01-12,9257
2338,光罩,10,0,10,凱基-林口,2024-01-12,9257
3630,新鉅科,10,0,10,凱基-林口,2024-01-12,9257
5426,振發,32,22,10,凱基-林口,2024-01-12,9257
6016,康和證,10,0,10,凱基-林口,2024-01-12,9257
6265,方土昶,10,0,10,凱基-林口,2024-01-12,9257
6290,良維,10,0,10,凱基-林口,2024-01-12,9257
6482,弘煜科,10,0,10,凱基-林口,2024-01-12,9257
6668,中揚光,10,0,10,凱基-林口,2024-01-12,9257
7402,邑錡,11,1,10,凱基-林口,2024-01-12,9257
8049,晶采,10,0,10,凱基-林口,2024-01-12,9257
00636,國泰中國A50,9,0,9,凱基-林口,2024-01-12,9257
3706,神達,12,3,9,凱基-林口,2024-01-12,9257
5347,世界,12,3,9,凱基-林口,2024-01-12,9257
8111,立��,15,6,9,凱基-林口,2024-01-12,9257
8096,擎亞,104,96,8,凱基-林口,2024-01-12,9257
2353,宏��,17,10,7,凱基-林口,2024-01-12,9257
3481,群創,7,0,7,凱基-林口,2024-01-12,9257
00936,台新永續高息中小,7,0,7,凱基-林口,2024-01-12,9257
3090,日電貿,7,0,7,凱基-林口,2024-01-12,9257
6108,競國,7,0,7,凱基-林口,2024-01-12,9257
00680L,元大美債20正2,159,0,159,凱基-林口,2024-01-15,9257
2356,英業達,181,36,145,凱基-林口,2024-01-15,9257
00929,復華台灣科技優息,119,4,115,凱基-林口,2024-01-15,9257
2303,聯電,109,1,108,凱基-林口,2024-01-15,9257
0056,元大高股息,96,2,94,凱基-林口,2024-01-15,9257
8096,擎亞,76,14,62,凱基-林口,2024-01-15,9257
4161,聿新科,40,0,40,凱基-林口,2024-01-15,9257
00679B,元大美債20年,37,0,37,凱基-林口,2024-01-15,9257
8429,金麗-KY,27,0,27,凱基-林口,2024-01-15,9257
3231,緯創,46,23,23,凱基-林口,2024-01-15,9257
2338,光罩,22,0,22,凱基-林口,2024-01-15,9257
5211,蒙恬,22,0,22,凱基-林口,2024-01-15,9257
2329,華泰,34,13,21,凱基-林口,2024-01-15,9257
2353,宏��,16,0,16,凱基-林口,2024-01-15,9257
6120,達運,20,5,15,凱基-林口,2024-01-15,9257
00637L,元大滬深300正2,16,2,14,凱基-林口,2024-01-15,9257
3686,達能,13,0,13,凱基-林口,2024-01-15,9257
8105,凌巨,12,0,12,凱基-林口,2024-01-15,9257
00932,兆豐永續高息等權,16,5,11,凱基-林口,2024-01-15,9257
2027,大成鋼,11,0,11,凱基-林口,2024-01-15,9257
00937B,群益ESG投等債20,12,2,10,凱基-林口,2024-01-15,9257
00933B,國泰10Y+金融債,10,0,10,凱基-林口,2024-01-15,9257
00740B,富邦全球投等債,10,0,10,凱基-林口,2024-01-15,9257
8111,立��,10,0,10,凱基-林口,2024-01-15,9257
00919,群益台灣精選高息,20,11,9,凱基-林口,2024-01-15,9257
1513,中興電,21,12,9,凱基-林口,2024-01-15,9257
3032,偉訓,17,9,8,凱基-林口,2024-01-15,9257
3372,典範,8,0,8,凱基-林口,2024-01-15,9257
2363,矽統,8,1,7,凱基-林口,2024-01-15,9257
00927,群益半導體收益,7,0,7,凱基-林口,2024-01-15,9257
00881,國泰台灣5G+,7,0,7,凱基-林口,2024-01-15,9257
1528,恩德,10,3,7,凱基-林口,2024-01-15,9257
2634,漢翔,12,5,7,凱基-林口,2024-01-15,9257
00878,國泰永續高股息,9,2,7,凱基-林口,2024-01-15,9257
2409,友達,6,0,6,凱基-林口,2024-01-15,9257
00770,國泰北美科技,7,1,6,凱基-林口,2024-01-15,9257
3380,明泰,6,0,6,凱基-林口,2024-01-15,9257
5398,慕康生醫,6,0,6,凱基-林口,2024-01-15,9257
6192,巨路,6,0,6,凱基-林口,2024-01-15,9257
2610,華航,5,0,5,凱基-林口,2024-01-15,9257
1314,中石化,5,0,5,凱基-林口,2024-01-15,9257
00888,永豐台灣ESG,5,0,5,凱基-林口,2024-01-15,9257
00930,永豐ESG低碳高息,5,0,5,凱基-林口,2024-01-15,9257
1529,樂事綠能,6,1,5,凱基-林口,2024-01-15,9257
2362,藍天,5,0,5,凱基-林口,2024-01-15,9257
2723,美食-KY,5,0,5,凱基-林口,2024-01-15,9257
3021,鴻名,5,0,5,凱基-林口,2024-01-15,9257
3041,揚智,5,0,5,凱基-林口,2024-01-15,9257
3178,公準,5,0,5,凱基-林口,2024-01-15,9257
3224,三顧,5,0,5,凱基-林口,2024-01-15,9257
00929,復華台灣科技優息,243,1,242,凱基-林口,2024-01-16,9257
00927,群益半導體收益,143,0,143,凱基-林口,2024-01-16,9257
0056,元大高股息,108,18,90,凱基-林口,2024-01-16,9257
00720B,元大投資級公司債,87,5,82,凱基-林口,2024-01-16,9257
4161,聿新科,66,0,66,凱基-林口,2024-01-16,9257
2888,新光金,63,2,61,凱基-林口,2024-01-16,9257
2889,國票金,60,0,60,凱基-林口,2024-01-16,9257
3706,神達,54,3,51,凱基-林口,2024-01-16,9257
1609,大亞,62,15,47,凱基-林口,2024-01-16,9257
9919,康那香,45,0,45,凱基-林口,2024-01-16,9257
2356,英業達,32,0,32,凱基-林口,2024-01-16,9257
4402,郡都開發,67,35,32,凱基-林口,2024-01-16,9257
00937B,群益ESG投等債20,29,0,29,凱基-林口,2024-01-16,9257
2352,佳世達,26,0,26,凱基-林口,2024-01-16,9257
1314,中石化,24,0,24,凱基-林口,2024-01-16,9257
2883,凱基金,25,1,24,凱基-林口,2024-01-16,9257
00923,群益台ESG低碳50,20,0,20,凱基-林口,2024-01-16,9257
00904,新光臺灣半導體30,20,0,20,凱基-林口,2024-01-16,9257
1460,宏遠,20,0,20,凱基-林口,2024-01-16,9257
2537,聯上發,20,0,20,凱基-林口,2024-01-16,9257
2486,一詮,51,33,18,凱基-林口,2024-01-16,9257
8096,擎亞,44,26,18,凱基-林口,2024-01-16,9257
2610,華航,22,5,17,凱基-林口,2024-01-16,9257
5347,世界,17,0,17,凱基-林口,2024-01-16,9257
00915,凱基優選高股息30,17,0,17,凱基-林口,2024-01-16,9257
3622,洋華,19,2,17,凱基-林口,2024-01-16,9257
2618,長榮航,22,6,16,凱基-林口,2024-01-16,9257
00687B,國泰20年美債,15,0,15,凱基-林口,2024-01-16,9257
00633L,富邦上証正2,20,5,15,凱基-林口,2024-01-16,9257
2634,漢翔,29,14,15,凱基-林口,2024-01-16,9257
3390,旭軟,15,0,15,凱基-林口,2024-01-16,9257
4576,大銀微系統,14,0,14,凱基-林口,2024-01-16,9257
2882,國泰金,13,0,13,凱基-林口,2024-01-16,9257
1568,倉佑,13,0,13,凱基-林口,2024-01-16,9257
8092,建暐,13,0,13,凱基-林口,2024-01-16,9257
3231,緯創,17,4,13,凱基-林口,2024-01-16,9257
6505,台塑化,14,1,13,凱基-林口,2024-01-16,9257
2344,華邦電,13,1,12,凱基-林口,2024-01-16,9257
5381,合正,12,0,12,凱基-林口,2024-01-16,9257
6005,群益證,12,0,12,凱基-林口,2024-01-16,9257
1101,台泥,13,2,11,凱基-林口,2024-01-16,9257
00725B,國泰投資級公司債,11,0,11,凱基-林口,2024-01-16,9257
6116,彩晶,11,0,11,凱基-林口,2024-01-16,9257
00753L,中信中國50正2,10,0,10,凱基-林口,2024-01-16,9257
00930,永豐ESG低碳高息,10,0,10,凱基-林口,2024-01-16,9257
1201,味全,10,0,10,凱基-林口,2024-01-16,9257
2412,中華電,10,0,10,凱基-林口,2024-01-16,9257
2497,怡利電,10,0,10,凱基-林口,2024-01-16,9257
5533,皇鼎,10,0,10,凱基-林口,2024-01-16,9257
9962,有益,10,0,10,凱基-林口,2024-01-16,9257
00919,群益台灣精選高息,225,0,225,凱基-林口,2024-01-17,9257
0056,元大高股息,218,23,195,凱基-林口,2024-01-17,9257
1303,南亞,190,0,190,凱基-林口,2024-01-17,9257
00937B,群益ESG投等債20,167,7,160,凱基-林口,2024-01-17,9257
00882,中信中國高股息,136,2,134,凱基-林口,2024-01-17,9257
2889,國票金,105,0,105,凱基-林口,2024-01-17,9257
2356,英業達,96,2,94,凱基-林口,2024-01-17,9257
00929,復華台灣科技優息,136,45,91,凱基-林口,2024-01-17,9257
0050,元大台灣50,50,0,50,凱基-林口,2024-01-17,9257
1609,大亞,50,0,50,凱基-林口,2024-01-17,9257
2543,皇昌,50,0,50,凱基-林口,2024-01-17,9257
1605,華新,43,0,43,凱基-林口,2024-01-17,9257
00687B,國泰20年美債,34,1,33,凱基-林口,2024-01-17,9257
6770,力積電,35,2,33,凱基-林口,2024-01-17,9257
2352,佳世達,32,0,32,凱基-林口,2024-01-17,9257
6116,彩晶,32,0,32,凱基-林口,2024-01-17,9257
00680L,元大美債20正2,31,0,31,凱基-林口,2024-01-17,9257
3163,波若威,30,0,30,凱基-林口,2024-01-17,9257
5531,鄉林,30,0,30,凱基-林口,2024-01-17,9257
2303,聯電,42,13,29,凱基-林口,2024-01-17,9257
00900,富邦特選高股息30,27,0,27,凱基-林口,2024-01-17,9257
2618,長榮航,33,6,27,凱基-林口,2024-01-17,9257
2885,元大金,25,0,25,凱基-林口,2024-01-17,9257
1413,宏洲,25,0,25,凱基-林口,2024-01-17,9257
5213,亞昕,25,0,25,凱基-林口,2024-01-17,9257
2515,中工,24,0,24,凱基-林口,2024-01-17,9257
00927,群益半導體收益,23,0,23,凱基-林口,2024-01-17,9257
1301,台塑,27,4,23,凱基-林口,2024-01-17,9257
4102,永日,23,0,23,凱基-林口,2024-01-17,9257
2637,慧洋-KY,21,0,21,凱基-林口,2024-01-17,9257
00671R,富邦NASDAQ反1,20,0,20,凱基-林口,2024-01-17,9257
2355,敬鵬,20,0,20,凱基-林口,2024-01-17,9257
1460,宏遠,17,0,17,凱基-林口,2024-01-17,9257
3706,神達,19,2,17,凱基-林口,2024-01-17,9257
00679B,元大美債20年,32,15,17,凱基-林口,2024-01-17,9257
2308,台達電,18,1,17,凱基-林口,2024-01-17,9257
6005,群益證,16,0,16,凱基-林口,2024-01-17,9257
1326,台化,15,0,15,凱基-林口,2024-01-17,9257
00753L,中信中國50正2,15,0,15,凱基-林口,2024-01-17,9257
2332,友訊,14,0,14,凱基-林口,2024-01-17,9257
2344,華邦電,32,19,13,凱基-林口,2024-01-17,9257
3522,御嵿,13,0,13,凱基-林口,2024-01-17,9257
00918,大華優利高填息30,12,0,12,凱基-林口,2024-01-17,9257
4906,正文,15,3,12,凱基-林口,2024-01-17,9257
5324,士開,12,0,12,凱基-林口,2024-01-17,9257
5871,中租-KY,11,0,11,凱基-林口,2024-01-17,9257
2884,玉山金,11,0,11,凱基-林口,2024-01-17,9257
1455,集盛,11,0,11,凱基-林口,2024-01-17,9257
2408,南亞科,12,1,11,凱基-林口,2024-01-17,9257
2809,京城銀,11,0,11,凱基-林口,2024-01-17,9257
2329,華泰,538,29,509,凱基-林口,2024-01-18,9257
2356,英業達,139,0,139,凱基-林口,2024-01-18,9257
2888,新光金,103,2,101,凱基-林口,2024-01-18,9257
3706,神達,61,1,60,凱基-林口,2024-01-18,9257
00933B,國泰10Y+金融債,58,0,58,凱基-林口,2024-01-18,9257
00882,中信中國高股息,45,0,45,凱基-林口,2024-01-18,9257
00679B,元大美債20年,35,0,35,凱基-林口,2024-01-18,9257
2243,宏旭-KY,31,0,31,凱基-林口,2024-01-18,9257
2002,中鋼,29,0,29,凱基-林口,2024-01-18,9257
8096,擎亞,51,22,29,凱基-林口,2024-01-18,9257
5388,中磊,20,0,20,凱基-林口,2024-01-18,9257
2457,飛宏,20,0,20,凱基-林口,2024-01-18,9257
00902,中信電池及儲能,19,0,19,凱基-林口,2024-01-18,9257
2609,陽明,41,23,18,凱基-林口,2024-01-18,9257
4532,瑞智,18,0,18,凱基-林口,2024-01-18,9257
0056,元大高股息,27,10,17,凱基-林口,2024-01-18,9257
5351,鈺創,17,1,16,凱基-林口,2024-01-18,9257
00878,國泰永續高股息,16,0,16,凱基-林口,2024-01-18,9257
2363,矽統,18,3,15,凱基-林口,2024-01-18,9257
3013,晟銘電,14,0,14,凱基-林口,2024-01-18,9257
6219,富旺,18,4,14,凱基-林口,2024-01-18,9257
2382,廣達,18,4,14,凱基-林口,2024-01-18,9257
3035,智原,16,4,12,凱基-林口,2024-01-18,9257
4960,誠美材,11,0,11,凱基-林口,2024-01-18,9257
2303,聯電,33,22,11,凱基-林口,2024-01-18,9257
2892,第一金,11,0,11,凱基-林口,2024-01-18,9257
2537,聯上發,10,0,10,凱基-林口,2024-01-18,9257
3034,聯詠,10,0,10,凱基-林口,2024-01-18,9257
3576,聯合再生,10,0,10,凱基-林口,2024-01-18,9257
6278,台表科,10,0,10,凱基-林口,2024-01-18,9257
8049,晶采,10,0,10,凱基-林口,2024-01-18,9257
8105,凌巨,10,0,10,凱基-林口,2024-01-18,9257
00919,群益台灣精選高息,59,50,9,凱基-林口,2024-01-18,9257
00772B,中信高評級公司債,9,0,9,凱基-林口,2024-01-18,9257
1734,杏輝,10,1,9,凱基-林口,2024-01-18,9257
2886,兆豐金,12,3,9,凱基-林口,2024-01-18,9257
5381,合正,9,0,9,凱基-林口,2024-01-18,9257
5880,合庫金,9,0,9,凱基-林口,2024-01-18,9257
6770,力積電,9,0,9,凱基-林口,2024-01-18,9257
8215,明基材,10,1,9,凱基-林口,2024-01-18,9257
2409,友達,39,31,8,凱基-林口,2024-01-18,9257
1101,台泥,8,0,8,凱基-林口,2024-01-18,9257
2388,威盛,16,9,7,凱基-林口,2024-01-18,9257
00631L,元大台灣50正2,7,0,7,凱基-林口,2024-01-18,9257
2317,鴻海,8,1,7,凱基-林口,2024-01-18,9257
2344,華邦電,7,0,7,凱基-林口,2024-01-18,9257
2354,鴻準,7,0,7,凱基-林口,2024-01-18,9257
3694,海華,7,0,7,凱基-林口,2024-01-18,9257
4306,炎洲,7,0,7,凱基-林口,2024-01-18,9257
8354,冠好,12,5,7,凱基-林口,2024-01-18,9257
00687B,國泰20年美債,178,0,178,凱基-林口,2024-01-19,9257
2356,英業達,212,39,173,凱基-林口,2024-01-19,9257
00937B,群益ESG投等債20,85,0,85,凱基-林口,2024-01-19,9257
00680L,元大美債20正2,62,0,62,凱基-林口,2024-01-19,9257
0056,元大高股息,65,12,53,凱基-林口,2024-01-19,9257
2867,三商壽,50,0,50,凱基-林口,2024-01-19,9257
6237,驊訊,50,0,50,凱基-林口,2024-01-19,9257
00929,復華台灣科技優息,49,2,47,凱基-林口,2024-01-19,9257
4161,聿新科,34,0,34,凱基-林口,2024-01-19,9257
3520,華盈,33,0,33,凱基-林口,2024-01-19,9257
00882,中信中國高股息,29,1,28,凱基-林口,2024-01-19,9257
2603,長榮,29,4,25,凱基-林口,2024-01-19,9257
4561,健椿,23,0,23,凱基-林口,2024-01-19,9257
5521,工信,23,0,23,凱基-林口,2024-01-19,9257
5871,中租-KY,21,0,21,凱基-林口,2024-01-19,9257
00933B,國泰10Y+金融債,20,0,20,凱基-林口,2024-01-19,9257
1717,長興,20,0,20,凱基-林口,2024-01-19,9257
00633L,富邦上証正2,20,0,20,凱基-林口,2024-01-19,9257
5211,蒙恬,20,0,20,凱基-林口,2024-01-19,9257
4402,郡都開發,20,1,19,凱基-林口,2024-01-19,9257
2618,長榮航,25,6,19,凱基-林口,2024-01-19,9257
6120,達運,22,4,18,凱基-林口,2024-01-19,9257
1301,台塑,18,2,16,凱基-林口,2024-01-19,9257
00733,富邦臺灣中小,16,0,16,凱基-林口,2024-01-19,9257
6223,旺矽,15,0,15,凱基-林口,2024-01-19,9257
4188,安克,16,1,15,凱基-林口,2024-01-19,9257
2610,華航,15,1,14,凱基-林口,2024-01-19,9257
1802,台玻,14,0,14,凱基-林口,2024-01-19,9257
00931B,統一美債20年,14,0,14,凱基-林口,2024-01-19,9257
4532,瑞智,13,0,13,凱基-林口,2024-01-19,9257
9906,欣巴巴,14,1,13,凱基-林口,2024-01-19,9257
2883,凱基金,13,0,13,凱基-林口,2024-01-19,9257
00795B,中信美國公債20年,12,0,12,凱基-林口,2024-01-19,9257
00679B,元大美債20年,49,38,11,凱基-林口,2024-01-19,9257
4915,致伸,11,0,11,凱基-林口,2024-01-19,9257
00688L,國泰20年美債正2,10,0,10,凱基-林口,2024-01-19,9257
00715L,期街口布蘭特正2,10,0,10,凱基-林口,2024-01-19,9257
00904,新光臺灣半導體30,10,0,10,凱基-林口,2024-01-19,9257
3163,波若威,10,0,10,凱基-林口,2024-01-19,9257
3419,譁裕,10,0,10,凱基-林口,2024-01-19,9257
3623,富晶通,31,21,10,凱基-林口,2024-01-19,9257
5425,台半,11,1,10,凱基-林口,2024-01-19,9257
8044,網家,10,0,10,凱基-林口,2024-01-19,9257
2002,中鋼,9,0,9,凱基-林口,2024-01-19,9257
2615,萬海,10,1,9,凱基-林口,2024-01-19,9257
00751B,元大AAA至A公司債,9,0,9,凱基-林口,2024-01-19,9257
00915,凱基優選高股息30,9,0,9,凱基-林口,2024-01-19,9257
1815,富喬,11,2,9,凱基-林口,2024-01-19,9257
2486,一詮,10,1,9,凱基-林口,2024-01-19,9257
2885,元大金,9,0,9,凱基-林口,2024-01-19,9257
2329,華泰,238,44,194,凱基-林口,2024-01-22,9257
00882,中信中國高股息,71,0,71,凱基-林口,2024-01-22,9257
2516,新建,50,0,50,凱基-林口,2024-01-22,9257
2606,裕民,50,0,50,凱基-林口,2024-01-22,9257
3032,偉訓,54,6,48,凱基-林口,2024-01-22,9257
2406,國碩,40,0,40,凱基-林口,2024-01-22,9257
4161,聿新科,40,0,40,凱基-林口,2024-01-22,9257
6218,豪勉,40,0,40,凱基-林口,2024-01-22,9257
4188,安克,36,0,36,凱基-林口,2024-01-22,9257
2609,陽明,77,42,35,凱基-林口,2024-01-22,9257
00937B,群益ESG投等債20,33,0,33,凱基-林口,2024-01-22,9257
0056,元大高股息,54,22,32,凱基-林口,2024-01-22,9257
3231,緯創,146,120,26,凱基-林口,2024-01-22,9257
00632R,元大台灣50反1,25,0,25,凱基-林口,2024-01-22,9257
3390,旭軟,25,0,25,凱基-林口,2024-01-22,9257
2353,宏��,30,6,24,凱基-林口,2024-01-22,9257
00679B,元大美債20年,23,0,23,凱基-林口,2024-01-22,9257
00753L,中信中國50正2,23,0,23,凱基-林口,2024-01-22,9257
2379,瑞昱,21,0,21,凱基-林口,2024-01-22,9257
3260,威剛,21,0,21,凱基-林口,2024-01-22,9257
2887,台新金,22,2,20,凱基-林口,2024-01-22,9257
3376,新日興,20,0,20,凱基-林口,2024-01-22,9257
2547,日勝生,19,0,19,凱基-林口,2024-01-22,9257
6668,中揚光,15,0,15,凱基-林口,2024-01-22,9257
3025,星通,16,3,13,凱基-林口,2024-01-22,9257
3105,穩懋,13,0,13,凱基-林口,2024-01-22,9257
2308,台達電,14,1,13,凱基-林口,2024-01-22,9257
2884,玉山金,13,1,12,凱基-林口,2024-01-22,9257
3325,旭品,66,55,11,凱基-林口,2024-01-22,9257
00929,復華台灣科技優息,28,17,11,凱基-林口,2024-01-22,9257
2458,義隆,10,0,10,凱基-林口,2024-01-22,9257
2362,藍天,10,0,10,凱基-林口,2024-01-22,9257
2705,六福,10,0,10,凱基-林口,2024-01-22,9257
2801,彰銀,10,0,10,凱基-林口,2024-01-22,9257
6285,啟��,14,5,9,凱基-林口,2024-01-22,9257
0050,元大台灣50,11,3,8,凱基-林口,2024-01-22,9257
3380,明泰,11,3,8,凱基-林口,2024-01-22,9257
3687,歐買尬,14,6,8,凱基-林口,2024-01-22,9257
6233,旺玖,33,25,8,凱基-林口,2024-01-22,9257
3066,李洲,7,0,7,凱基-林口,2024-01-22,9257
3504,揚明光,7,0,7,凱基-林口,2024-01-22,9257
4303,信立,7,0,7,凱基-林口,2024-01-22,9257
00752,中信中國50,7,0,7,凱基-林口,2024-01-22,9257
3521,鴻翊,6,0,6,凱基-林口,2024-01-22,9257
5426,振發,12,6,6,凱基-林口,2024-01-22,9257
3227,原相,8,3,5,凱基-林口,2024-01-22,9257
2313,華通,6,1,5,凱基-林口,2024-01-22,9257
00891,中信關鍵半導體,6,1,5,凱基-林口,2024-01-22,9257
00719B,元大美債1-3,5,0,5,凱基-林口,2024-01-22,9257
1402,遠東新,5,0,5,凱基-林口,2024-01-22,9257
3481,群創,740,113,627,凱基-林口,2024-01-23,9257
2344,華邦電,508,5,503,凱基-林口,2024-01-23,9257
2329,華泰,127,25,102,凱基-林口,2024-01-23,9257
1471,首利,92,0,92,凱基-林口,2024-01-23,9257
3325,旭品,89,0,89,凱基-林口,2024-01-23,9257
00937B,群益ESG投等債20,67,0,67,凱基-林口,2024-01-23,9257
6218,豪勉,51,0,51,凱基-林口,2024-01-23,9257
00715L,期街口布蘭特正2,50,7,43,凱基-林口,2024-01-23,9257
2609,陽明,92,50,42,凱基-林口,2024-01-23,9257
2363,矽統,59,18,41,凱基-林口,2024-01-23,9257
3066,李洲,30,0,30,凱基-林口,2024-01-23,9257
3017,奇鋐,41,12,29,凱基-林口,2024-01-23,9257
00679B,元大美債20年,30,3,27,凱基-林口,2024-01-23,9257
00708L,期元大S＆P黃金正2,20,0,20,凱基-林口,2024-01-23,9257
2385,群光,20,0,20,凱基-林口,2024-01-23,9257
2515,中工,20,0,20,凱基-林口,2024-01-23,9257
00904,新光臺灣半導體30,17,0,17,凱基-林口,2024-01-23,9257
4161,聿新科,16,0,16,凱基-林口,2024-01-23,9257
6179,亞通,17,1,16,凱基-林口,2024-01-23,9257
1514,亞力,36,22,14,凱基-林口,2024-01-23,9257
2610,華航,13,0,13,凱基-林口,2024-01-23,9257
3059,華晶科,13,1,12,凱基-林口,2024-01-23,9257
8996,高力,12,0,12,凱基-林口,2024-01-23,9257
00637L,元大滬深300正2,11,0,11,凱基-林口,2024-01-23,9257
3260,威剛,11,0,11,凱基-林口,2024-01-23,9257
6127,九豪,11,0,11,凱基-林口,2024-01-23,9257
00902,中信電池及儲能,11,0,11,凱基-林口,2024-01-23,9257
00687B,國泰20年美債,10,0,10,凱基-林口,2024-01-23,9257
2867,三商壽,10,0,10,凱基-林口,2024-01-23,9257
2888,新光金,10,0,10,凱基-林口,2024-01-23,9257
3704,合勤控,10,0,10,凱基-林口,2024-01-23,9257
5425,台半,16,6,10,凱基-林口,2024-01-23,9257
6538,倉和,10,0,10,凱基-林口,2024-01-23,9257
00882,中信中國高股息,9,0,9,凱基-林口,2024-01-23,9257
2352,佳世達,10,3,7,凱基-林口,2024-01-23,9257
00929,復華台灣科技優息,6,0,6,凱基-林口,2024-01-23,9257
2002,中鋼,7,1,6,凱基-林口,2024-01-23,9257
2206,三陽工業,6,0,6,凱基-林口,2024-01-23,9257
2233,宇隆,6,0,6,凱基-林口,2024-01-23,9257
2501,國建,6,0,6,凱基-林口,2024-01-23,9257
6284,佳邦,7,1,6,凱基-林口,2024-01-23,9257
2376,技嘉,24,18,6,凱基-林口,2024-01-23,9257
5432,新門,7,1,6,凱基-林口,2024-01-23,9257
1301,台塑,5,0,5,凱基-林口,2024-01-23,9257
8210,勤誠,7,2,5,凱基-林口,2024-01-23,9257
00909,國泰數位支付服務,5,0,5,凱基-林口,2024-01-23,9257
00632R,元大台灣50反1,5,0,5,凱基-林口,2024-01-23,9257
1524,耿鼎,5,0,5,凱基-林口,2024-01-23,9257
1597,直得,5,0,5,凱基-林口,2024-01-23,9257
2402,毅嘉,10,5,5,凱基-林口,2024-01-23,9257
6127,九豪,100,0,100,凱基-林口,2024-01-24,9257
3231,緯創,146,48,98,凱基-林口,2024-01-24,9257
2329,華泰,85,6,79,凱基-林口,2024-01-24,9257
00715L,期街口布蘭特正2,70,0,70,凱基-林口,2024-01-24,9257
00637L,元大滬深300正2,50,0,50,凱基-林口,2024-01-24,9257
00665L,富邦�琤肭磪囓�2,50,0,50,凱基-林口,2024-01-24,9257
00850,元大臺灣ESG永續,50,0,50,凱基-林口,2024-01-24,9257
2344,華邦電,53,3,50,凱基-林口,2024-01-24,9257
00933B,國泰10Y+金融債,45,0,45,凱基-林口,2024-01-24,9257
2363,矽統,36,0,36,凱基-林口,2024-01-24,9257
5469,瀚宇博,32,1,31,凱基-林口,2024-01-24,9257
6425,易發,29,0,29,凱基-林口,2024-01-24,9257
3260,威剛,36,14,22,凱基-林口,2024-01-24,9257
4161,聿新科,21,0,21,凱基-林口,2024-01-24,9257
00891,中信關鍵半導體,21,1,20,凱基-林口,2024-01-24,9257
2880,華南金,20,0,20,凱基-林口,2024-01-24,9257
00679B,元大美債20年,21,3,18,凱基-林口,2024-01-24,9257
00937B,群益ESG投等債20,18,0,18,凱基-林口,2024-01-24,9257
2353,宏��,28,11,17,凱基-林口,2024-01-24,9257
00720B,元大投資級公司債,17,1,16,凱基-林口,2024-01-24,9257
2884,玉山金,13,0,13,凱基-林口,2024-01-24,9257
00885,富邦越南,15,2,13,凱基-林口,2024-01-24,9257
1733,五鼎,13,0,13,凱基-林口,2024-01-24,9257
3265,台星科,18,5,13,凱基-林口,2024-01-24,9257
00687B,國泰20年美債,12,0,12,凱基-林口,2024-01-24,9257
3037,欣興,14,2,12,凱基-林口,2024-01-24,9257
2352,佳世達,12,0,12,凱基-林口,2024-01-24,9257
5426,振發,22,11,11,凱基-林口,2024-01-24,9257
2301,光寶科,12,2,10,凱基-林口,2024-01-24,9257
3680,家登,16,6,10,凱基-林口,2024-01-24,9257
00688L,國泰20年美債正2,10,0,10,凱基-林口,2024-01-24,9257
3706,神達,11,1,10,凱基-林口,2024-01-24,9257
5398,慕康生醫,10,0,10,凱基-林口,2024-01-24,9257
5425,台半,12,2,10,凱基-林口,2024-01-24,9257
5450,南良,10,0,10,凱基-林口,2024-01-24,9257
8096,擎亞,31,21,10,凱基-林口,2024-01-24,9257
00929,復華台灣科技優息,15,5,10,凱基-林口,2024-01-24,9257
2425,承啟,9,0,9,凱基-林口,2024-01-24,9257
3045,台灣大,10,1,9,凱基-林口,2024-01-24,9257
4114,健喬,11,2,9,凱基-林口,2024-01-24,9257
4939,亞電,9,0,9,凱基-林口,2024-01-24,9257
2374,佳能,8,0,8,凱基-林口,2024-01-24,9257
3374,精材,8,0,8,凱基-林口,2024-01-24,9257
3013,晟銘電,7,0,7,凱基-林口,2024-01-24,9257
00931B,統一美債20年,6,0,6,凱基-林口,2024-01-24,9257
00751B,元大AAA至A公司債,8,2,6,凱基-林口,2024-01-24,9257
1603,華電,6,0,6,凱基-林口,2024-01-24,9257
2606,裕民,6,0,6,凱基-林口,2024-01-24,9257
3437,榮創,6,0,6,凱基-林口,2024-01-24,9257
3545,敦泰,6,0,6,凱基-林口,2024-01-24,9257
00937B,群益ESG投等債20,99,2,97,凱基-林口,2024-01-25,9257
2329,華泰,344,258,86,凱基-林口,2024-01-25,9257
00687B,國泰20年美債,76,1,75,凱基-林口,2024-01-25,9257
00679B,元大美債20年,70,5,65,凱基-林口,2024-01-25,9257
00712,復華富時不動產,60,5,55,凱基-林口,2024-01-25,9257
8105,凌巨,45,0,45,凱基-林口,2024-01-25,9257
2618,長榮航,47,6,41,凱基-林口,2024-01-25,9257
3706,神達,50,18,32,凱基-林口,2024-01-25,9257
1314,中石化,31,0,31,凱基-林口,2024-01-25,9257
2369,菱生,31,0,31,凱基-林口,2024-01-25,9257
2606,裕民,31,2,29,凱基-林口,2024-01-25,9257
6116,彩晶,30,2,28,凱基-林口,2024-01-25,9257
4161,聿新科,25,0,25,凱基-林口,2024-01-25,9257
1609,大亞,25,2,23,凱基-林口,2024-01-25,9257
3032,偉訓,23,0,23,凱基-林口,2024-01-25,9257
2615,萬海,21,0,21,凱基-林口,2024-01-25,9257
2845,遠東銀,20,0,20,凱基-林口,2024-01-25,9257
3312,弘憶股,20,0,20,凱基-林口,2024-01-25,9257
5469,瀚宇博,20,0,20,凱基-林口,2024-01-25,9257
6229,研通,20,0,20,凱基-林口,2024-01-25,9257
6274,台燿,26,6,20,凱基-林口,2024-01-25,9257
00882,中信中國高股息,52,34,18,凱基-林口,2024-01-25,9257
3380,明泰,18,0,18,凱基-林口,2024-01-25,9257
2344,華邦電,17,0,17,凱基-林口,2024-01-25,9257
5521,工信,17,0,17,凱基-林口,2024-01-25,9257
6245,立端,38,21,17,凱基-林口,2024-01-25,9257
00636,國泰中國A50,15,0,15,凱基-林口,2024-01-25,9257
2603,長榮,15,0,15,凱基-林口,2024-01-25,9257
6233,旺玖,15,1,14,凱基-林口,2024-01-25,9257
00720B,元大投資級公司債,12,0,12,凱基-林口,2024-01-25,9257
6526,達發,13,1,12,凱基-林口,2024-01-25,9257
2382,廣達,15,3,12,凱基-林口,2024-01-25,9257
2363,矽統,24,13,11,凱基-林口,2024-01-25,9257
2365,昆盈,24,13,11,凱基-林口,2024-01-25,9257
3363,上詮,11,0,11,凱基-林口,2024-01-25,9257
6668,中揚光,11,0,11,凱基-林口,2024-01-25,9257
2376,技嘉,30,20,10,凱基-林口,2024-01-25,9257
00650L,復華香港正2,10,0,10,凱基-林口,2024-01-25,9257
00719B,元大美債1-3,10,0,10,凱基-林口,2024-01-25,9257
2460,建通,10,0,10,凱基-林口,2024-01-25,9257
8040,九暘,11,1,10,凱基-林口,2024-01-25,9257
6237,驊訊,24,15,9,凱基-林口,2024-01-25,9257
6593,台灣銘板,9,0,9,凱基-林口,2024-01-25,9257
3013,晟銘電,8,0,8,凱基-林口,2024-01-25,9257
3260,威剛,10,2,8,凱基-林口,2024-01-25,9257
5351,鈺創,8,0,8,凱基-林口,2024-01-25,9257
5483,中美晶,8,0,8,凱基-林口,2024-01-25,9257
2002,中鋼,10,3,7,凱基-林口,2024-01-25,9257
00931B,統一美債20年,7,0,7,凱基-林口,2024-01-25,9257
2409,友達,7,0,7,凱基-林口,2024-01-25,9257
2303,聯電,273,0,273,凱基-林口,2024-01-26,9257
00680L,元大美債20正2,226,0,226,凱基-林口,2024-01-26,9257
2329,華泰,183,12,171,凱基-林口,2024-01-26,9257
00715L,期街口布蘭特正2,102,2,100,凱基-林口,2024-01-26,9257
3481,群創,212,132,80,凱基-林口,2024-01-26,9257
00679B,元大美債20年,76,3,73,凱基-林口,2024-01-26,9257
6270,倍微,65,1,64,凱基-林口,2024-01-26,9257
00772B,中信高評級公司債,52,1,51,凱基-林口,2024-01-26,9257
00937B,群益ESG投等債20,42,0,42,凱基-林口,2024-01-26,9257
00919,群益台灣精選高息,39,0,39,凱基-林口,2024-01-26,9257
00929,復華台灣科技優息,32,2,30,凱基-林口,2024-01-26,9257
2606,裕民,30,1,29,凱基-林口,2024-01-26,9257
1609,大亞,26,0,26,凱基-林口,2024-01-26,9257
2641,正德,25,1,24,凱基-林口,2024-01-26,9257
4161,聿新科,20,0,20,凱基-林口,2024-01-26,9257
4960,誠美材,20,0,20,凱基-林口,2024-01-26,9257
2324,仁寶,23,4,19,凱基-林口,2024-01-26,9257
3264,欣銓,19,0,19,凱基-林口,2024-01-26,9257
3066,李洲,41,24,17,凱基-林口,2024-01-26,9257
6265,方土昶,30,13,17,凱基-林口,2024-01-26,9257
3715,定穎投控,15,0,15,凱基-林口,2024-01-26,9257
6290,良維,15,0,15,凱基-林口,2024-01-26,9257
00918,大華優利高填息30,13,0,13,凱基-林口,2024-01-26,9257
1514,亞力,14,2,12,凱基-林口,2024-01-26,9257
2314,台揚,11,0,11,凱基-林口,2024-01-26,9257
2618,長榮航,18,7,11,凱基-林口,2024-01-26,9257
2610,華航,13,3,10,凱基-林口,2024-01-26,9257
2409,友達,10,0,10,凱基-林口,2024-01-26,9257
2365,昆盈,11,1,10,凱基-林口,2024-01-26,9257
2880,華南金,10,0,10,凱基-林口,2024-01-26,9257
6275,元山,10,0,10,凱基-林口,2024-01-26,9257
8215,明基材,10,0,10,凱基-林口,2024-01-26,9257
2363,矽統,20,11,9,凱基-林口,2024-01-26,9257
2362,藍天,10,1,9,凱基-林口,2024-01-26,9257
2537,聯上發,9,0,9,凱基-林口,2024-01-26,9257
2723,美食-KY,8,0,8,凱基-林口,2024-01-26,9257
6120,達運,10,2,8,凱基-林口,2024-01-26,9257
2027,大成鋼,8,1,7,凱基-林口,2024-01-26,9257
2516,新建,7,0,7,凱基-林口,2024-01-26,9257
4127,天良,7,0,7,凱基-林口,2024-01-26,9257
6245,立端,10,3,7,凱基-林口,2024-01-26,9257
6125,廣運,7,0,7,凱基-林口,2024-01-26,9257
2382,廣達,10,4,6,凱基-林口,2024-01-26,9257
3037,欣興,6,0,6,凱基-林口,2024-01-26,9257
00687B,國泰20年美債,6,0,6,凱基-林口,2024-01-26,9257
4173,久裕,6,0,6,凱基-林口,2024-01-26,9257
6257,矽格,6,0,6,凱基-林口,2024-01-26,9257
1316,上曜,6,0,6,凱基-林口,2024-01-26,9257
6803,崑鼎,6,0,6,凱基-林口,2024-01-26,9257
00636,國泰中國A50,5,0,5,凱基-林口,2024-01-26,9257
4161,聿新科,418,0,418,凱基-林口,2024-01-29,9257
2610,華航,224,11,213,凱基-林口,2024-01-29,9257
6282,康舒,218,42,176,凱基-林口,2024-01-29,9257
2329,華泰,119,1,118,凱基-林口,2024-01-29,9257
00937B,群益ESG投等債20,107,1,106,凱基-林口,2024-01-29,9257
00665L,富邦�琤肭磪囓�2,50,0,50,凱基-林口,2024-01-29,9257
2888,新光金,50,0,50,凱基-林口,2024-01-29,9257
0050,元大台灣50,50,7,43,凱基-林口,2024-01-29,9257
00679B,元大美債20年,37,0,37,凱基-林口,2024-01-29,9257
00687B,國泰20年美債,36,0,36,凱基-林口,2024-01-29,9257
2409,友達,35,0,35,凱基-林口,2024-01-29,9257
8054,安國,39,9,30,凱基-林口,2024-01-29,9257
6179,亞通,26,0,26,凱基-林口,2024-01-29,9257
2421,建準,36,10,26,凱基-林口,2024-01-29,9257
2303,聯電,23,0,23,凱基-林口,2024-01-29,9257
6770,力積電,24,1,23,凱基-林口,2024-01-29,9257
00632R,元大台灣50反1,21,0,21,凱基-林口,2024-01-29,9257
00688L,國泰20年美債正2,20,0,20,凱基-林口,2024-01-29,9257
2440,太空梭,20,0,20,凱基-林口,2024-01-29,9257
3481,群創,22,4,18,凱基-林口,2024-01-29,9257
5469,瀚宇博,35,17,18,凱基-林口,2024-01-29,9257
2609,陽明,23,6,17,凱基-林口,2024-01-29,9257
6531,愛普*,18,2,16,凱基-林口,2024-01-29,9257
8085,福華,21,5,16,凱基-林口,2024-01-29,9257
00933B,國泰10Y+金融債,16,1,15,凱基-林口,2024-01-29,9257
00650L,復華香港正2,15,0,15,凱基-林口,2024-01-29,9257
5521,工信,15,0,15,凱基-林口,2024-01-29,9257
6116,彩晶,15,0,15,凱基-林口,2024-01-29,9257
00850,元大臺灣ESG永續,17,2,15,凱基-林口,2024-01-29,9257
2356,英業達,14,1,13,凱基-林口,2024-01-29,9257
2867,三商壽,13,0,13,凱基-林口,2024-01-29,9257
2313,華通,13,0,13,凱基-林口,2024-01-29,9257
00673R,期元大S＆P原油反1,12,0,12,凱基-林口,2024-01-29,9257
5515,建國,12,0,12,凱基-林口,2024-01-29,9257
5426,振發,20,9,11,凱基-林口,2024-01-29,9257
6237,驊訊,14,3,11,凱基-林口,2024-01-29,9257
5439,高技,10,0,10,凱基-林口,2024-01-29,9257
8096,擎亞,30,20,10,凱基-林口,2024-01-29,9257
2010,春源,9,0,9,凱基-林口,2024-01-29,9257
6274,台燿,11,2,9,凱基-林口,2024-01-29,9257
1733,五鼎,8,0,8,凱基-林口,2024-01-29,9257
00929,復華台灣科技優息,9,1,8,凱基-林口,2024-01-29,9257
3691,碩禾,7,0,7,凱基-林口,2024-01-29,9257
4532,瑞智,9,2,7,凱基-林口,2024-01-29,9257
4968,立積,14,8,6,凱基-林口,2024-01-29,9257
2352,佳世達,25,19,6,凱基-林口,2024-01-29,9257
2491,吉祥全,6,0,6,凱基-林口,2024-01-29,9257
6133,金橋,6,0,6,凱基-林口,2024-01-29,9257
6933,AMAX-KY,6,0,6,凱基-林口,2024-01-29,9257
8069,元太,6,0,6,凱基-林口,2024-01-29,9257
00680L,元大美債20正2,350,0,350,凱基-林口,2024-01-30,9257
00715L,期街口布蘭特正2,200,2,198,凱基-林口,2024-01-30,9257
00937B,群益ESG投等債20,110,0,110,凱基-林口,2024-01-30,9257
4161,聿新科,276,200,76,凱基-林口,2024-01-30,9257
00720B,元大投資級公司債,50,5,45,凱基-林口,2024-01-30,9257
2495,普安,43,0,43,凱基-林口,2024-01-30,9257
2609,陽明,44,6,38,凱基-林口,2024-01-30,9257
2611,志信,33,0,33,凱基-林口,2024-01-30,9257
2606,裕民,32,0,32,凱基-林口,2024-01-30,9257
3260,威剛,30,0,30,凱基-林口,2024-01-30,9257
2421,建準,35,8,27,凱基-林口,2024-01-30,9257
2641,正德,25,0,25,凱基-林口,2024-01-30,9257
6270,倍微,25,0,25,凱基-林口,2024-01-30,9257
1540,喬福,37,15,22,凱基-林口,2024-01-30,9257
6113,亞矽,44,22,22,凱基-林口,2024-01-30,9257
2515,中工,20,0,20,凱基-林口,2024-01-30,9257
2303,聯電,25,5,20,凱基-林口,2024-01-30,9257
2337,旺宏,20,2,18,凱基-林口,2024-01-30,9257
2618,長榮航,19,1,18,凱基-林口,2024-01-30,9257
3066,李洲,17,2,15,凱基-林口,2024-01-30,9257
3623,富晶通,27,12,15,凱基-林口,2024-01-30,9257
2491,吉祥全,14,0,14,凱基-林口,2024-01-30,9257
3339,泰谷,14,0,14,凱基-林口,2024-01-30,9257
1314,中石化,13,0,13,凱基-林口,2024-01-30,9257
2409,友達,12,0,12,凱基-林口,2024-01-30,9257
00933B,國泰10Y+金融債,11,0,11,凱基-林口,2024-01-30,9257
8040,九暘,11,0,11,凱基-林口,2024-01-30,9257
00637L,元大滬深300正2,10,0,10,凱基-林口,2024-01-30,9257
2385,群光,10,0,10,凱基-林口,2024-01-30,9257
6233,旺玖,10,0,10,凱基-林口,2024-01-30,9257
2363,矽統,14,5,9,凱基-林口,2024-01-30,9257
1533,車王電,9,0,9,凱基-林口,2024-01-30,9257
2377,微星,10,1,9,凱基-林口,2024-01-30,9257
3033,威健,10,1,9,凱基-林口,2024-01-30,9257
5426,振發,10,1,9,凱基-林口,2024-01-30,9257
2388,威盛,8,0,8,凱基-林口,2024-01-30,9257
2731,雄獅,8,0,8,凱基-林口,2024-01-30,9257
3005,神基,8,0,8,凱基-林口,2024-01-30,9257
3380,明泰,10,2,8,凱基-林口,2024-01-30,9257
6245,立端,8,0,8,凱基-林口,2024-01-30,9257
00929,復華台灣科技優息,18,11,7,凱基-林口,2024-01-30,9257
00687B,國泰20年美債,8,1,7,凱基-林口,2024-01-30,9257
5871,中租-KY,7,0,7,凱基-林口,2024-01-30,9257
6770,力積電,8,1,7,凱基-林口,2024-01-30,9257
6462,神盾,25,18,7,凱基-林口,2024-01-30,9257
00772B,中信高評級公司債,7,0,7,凱基-林口,2024-01-30,9257
00655L,國泰中國A50正2,7,0,7,凱基-林口,2024-01-30,9257
2460,建通,7,0,7,凱基-林口,2024-01-30,9257
00652,富邦印度,6,0,6,凱基-林口,2024-01-30,9257
2327,國巨,6,0,6,凱基-林口,2024-01-30,9257
00753L,中信中國50正2,458,0,458,凱基-林口,2024-01-31,9257
2641,正德,82,0,82,凱基-林口,2024-01-31,9257
2356,英業達,60,1,59,凱基-林口,2024-01-31,9257
00688L,國泰20年美債正2,52,0,52,凱基-林口,2024-01-31,9257
00720B,元大投資級公司債,59,9,50,凱基-林口,2024-01-31,9257
00929,復華台灣科技優息,53,8,45,凱基-林口,2024-01-31,9257
2329,華泰,57,16,41,凱基-林口,2024-01-31,9257
4161,聿新科,37,3,34,凱基-林口,2024-01-31,9257
3036,文曄,34,1,33,凱基-林口,2024-01-31,9257
00631L,元大台灣50正2,32,1,31,凱基-林口,2024-01-31,9257
00680L,元大美債20正2,30,0,30,凱基-林口,2024-01-31,9257
8096,擎亞,55,31,24,凱基-林口,2024-01-31,9257
3231,緯創,30,6,24,凱基-林口,2024-01-31,9257
2606,裕民,21,0,21,凱基-林口,2024-01-31,9257
6116,彩晶,20,0,20,凱基-林口,2024-01-31,9257
2303,聯電,26,7,19,凱基-林口,2024-01-31,9257
6462,神盾,23,4,19,凱基-林口,2024-01-31,9257
3339,泰谷,24,5,19,凱基-林口,2024-01-31,9257
4303,信立,19,0,19,凱基-林口,2024-01-31,9257
2369,菱生,26,8,18,凱基-林口,2024-01-31,9257
2618,長榮航,23,7,16,凱基-林口,2024-01-31,9257
2888,新光金,16,0,16,凱基-林口,2024-01-31,9257
3066,李洲,15,0,15,凱基-林口,2024-01-31,9257
00878,國泰永續高股息,20,5,15,凱基-林口,2024-01-31,9257
2330,台積電,18,5,13,凱基-林口,2024-01-31,9257
8054,安國,21,8,13,凱基-林口,2024-01-31,9257
1781,合世,12,0,12,凱基-林口,2024-01-31,9257
3515,華擎,12,0,12,凱基-林口,2024-01-31,9257
2363,矽統,11,0,11,凱基-林口,2024-01-31,9257
5439,高技,11,0,11,凱基-林口,2024-01-31,9257
2610,華航,12,2,10,凱基-林口,2024-01-31,9257
2609,陽明,10,0,10,凱基-林口,2024-01-31,9257
00673R,期元大S＆P原油反1,10,0,10,凱基-林口,2024-01-31,9257
3128,昇銳,10,0,10,凱基-林口,2024-01-31,9257
6005,群益證,10,0,10,凱基-林口,2024-01-31,9257
6526,達發,12,2,10,凱基-林口,2024-01-31,9257
6550,北極星藥業-KY,10,0,10,凱基-林口,2024-01-31,9257
2101,南港,9,0,9,凱基-林口,2024-01-31,9257
3706,神達,10,1,9,凱基-林口,2024-01-31,9257
3360,尚立,34,26,8,凱基-林口,2024-01-31,9257
00893,國泰智能電動車,8,0,8,凱基-林口,2024-01-31,9257
1560,中砂,14,6,8,凱基-林口,2024-01-31,9257
2491,吉祥全,8,0,8,凱基-林口,2024-01-31,9257
3055,蔚華科,19,11,8,凱基-林口,2024-01-31,9257
4532,瑞智,8,0,8,凱基-林口,2024-01-31,9257
6239,力成,10,2,8,凱基-林口,2024-01-31,9257
9945,潤泰新,8,0,8,凱基-林口,2024-01-31,9257
3236,千如,7,0,7,凱基-林口,2024-01-31,9257
00687B,國泰20年美債,13,6,7,凱基-林口,2024-01-31,9257
3013,晟銘電,8,1,7,凱基-林口,2024-01-31,9257
00878,國泰永續高股息,445,13,432,凱基-林口,2024-02-01,9257
00753L,中信中國50正2,180,0,180,凱基-林口,2024-02-01,9257
00929,復華台灣科技優息,107,0,107,凱基-林口,2024-02-01,9257
00715L,期街口布蘭特正2,101,5,96,凱基-林口,2024-02-01,9257
2883,凱基金,92,2,90,凱基-林口,2024-02-01,9257
4161,聿新科,94,10,84,凱基-林口,2024-02-01,9257
00712,復華富時不動產,96,13,83,凱基-林口,2024-02-01,9257
3706,神達,81,0,81,凱基-林口,2024-02-01,9257
6237,驊訊,90,30,60,凱基-林口,2024-02-01,9257
3715,定穎投控,67,19,48,凱基-林口,2024-02-01,9257
2515,中工,40,0,40,凱基-林口,2024-02-01,9257
2897,王道銀行,36,0,36,凱基-林口,2024-02-01,9257
3308,聯德,36,0,36,凱基-林口,2024-02-01,9257
1795,美時,34,1,33,凱基-林口,2024-02-01,9257
5512,力麒,33,0,33,凱基-林口,2024-02-01,9257
00751B,元大AAA至A公司債,35,5,30,凱基-林口,2024-02-01,9257
00688L,國泰20年美債正2,50,20,30,凱基-林口,2024-02-01,9257
3260,威剛,25,0,25,凱基-林口,2024-02-01,9257
2356,英業達,29,7,22,凱基-林口,2024-02-01,9257
00637L,元大滬深300正2,22,2,20,凱基-林口,2024-02-01,9257
3050,鈺德,20,0,20,凱基-林口,2024-02-01,9257
8011,台通,35,15,20,凱基-林口,2024-02-01,9257
00937B,群益ESG投等債20,18,0,18,凱基-林口,2024-02-01,9257
8111,立��,20,2,18,凱基-林口,2024-02-01,9257
6233,旺玖,16,0,16,凱基-林口,2024-02-01,9257
5515,建國,15,0,15,凱基-林口,2024-02-01,9257
7402,邑錡,15,0,15,凱基-林口,2024-02-01,9257
00919,群益台灣精選高息,14,0,14,凱基-林口,2024-02-01,9257
2303,聯電,23,10,13,凱基-林口,2024-02-01,9257
8085,福華,16,3,13,凱基-林口,2024-02-01,9257
2371,大同,18,7,11,凱基-林口,2024-02-01,9257
00687B,國泰20年美債,10,0,10,凱基-林口,2024-02-01,9257
00706L,期元大S＆P日圓正2,10,0,10,凱基-林口,2024-02-01,9257
00665L,富邦�琤肭磪囓�2,10,0,10,凱基-林口,2024-02-01,9257
3066,李洲,10,0,10,凱基-林口,2024-02-01,9257
3362,先進光,10,0,10,凱基-林口,2024-02-01,9257
3548,兆利,55,45,10,凱基-林口,2024-02-01,9257
4953,緯軟,10,0,10,凱基-林口,2024-02-01,9257
6156,松上,10,0,10,凱基-林口,2024-02-01,9257
2454,聯發科,9,0,9,凱基-林口,2024-02-01,9257
00933B,國泰10Y+金融債,11,2,9,凱基-林口,2024-02-01,9257
8936,國統,40,31,9,凱基-林口,2024-02-01,9257
6568,宏觀,8,0,8,凱基-林口,2024-02-01,9257
3324,雙鴻,11,4,7,凱基-林口,2024-02-01,9257
3029,零壹,7,0,7,凱基-林口,2024-02-01,9257
4739,康普,7,0,7,凱基-林口,2024-02-01,9257
6672,騰輝電子-KY,9,2,7,凱基-林口,2024-02-01,9257
2409,友達,7,1,6,凱基-林口,2024-02-01,9257
6121,新普,7,1,6,凱基-林口,2024-02-01,9257
00652,富邦印度,6,0,6,凱基-林口,2024-02-01,9257
00937B,群益ESG投等債20,221,14,207,凱基-林口,2024-02-02,9257
00680L,元大美債20正2,133,15,118,凱基-林口,2024-02-02,9257
00712,復華富時不動產,113,0,113,凱基-林口,2024-02-02,9257
4161,聿新科,80,12,68,凱基-林口,2024-02-02,9257
6156,松上,62,0,62,凱基-林口,2024-02-02,9257
3029,零壹,62,1,61,凱基-林口,2024-02-02,9257
00878,國泰永續高股息,69,13,56,凱基-林口,2024-02-02,9257
00885,富邦越南,55,3,52,凱基-林口,2024-02-02,9257
00753L,中信中國50正2,50,0,50,凱基-林口,2024-02-02,9257
00665L,富邦�琤肭磪囓�2,50,10,40,凱基-林口,2024-02-02,9257
1605,華新,40,0,40,凱基-林口,2024-02-02,9257
00688L,國泰20年美債正2,40,2,38,凱基-林口,2024-02-02,9257
2303,聯電,41,3,38,凱基-林口,2024-02-02,9257
3033,威健,30,0,30,凱基-林口,2024-02-02,9257
2603,長榮,27,1,26,凱基-林口,2024-02-02,9257
00690,兆豐藍籌30,26,0,26,凱基-林口,2024-02-02,9257
2641,正德,25,0,25,凱基-林口,2024-02-02,9257
3308,聯德,25,0,25,凱基-林口,2024-02-02,9257
2329,華泰,28,4,24,凱基-林口,2024-02-02,9257
00919,群益台灣精選高息,49,25,24,凱基-林口,2024-02-02,9257
4960,誠美材,20,0,20,凱基-林口,2024-02-02,9257
2301,光寶科,21,2,19,凱基-林口,2024-02-02,9257
4303,信立,17,0,17,凱基-林口,2024-02-02,9257
6770,力積電,20,3,17,凱基-林口,2024-02-02,9257
1453,大將,16,0,16,凱基-林口,2024-02-02,9257
4906,正文,15,0,15,凱基-林口,2024-02-02,9257
00933B,國泰10Y+金融債,15,0,15,凱基-林口,2024-02-02,9257
00700,富邦�琤肭磪�,14,0,14,凱基-林口,2024-02-02,9257
8085,福華,14,0,14,凱基-林口,2024-02-02,9257
2618,長榮航,17,4,13,凱基-林口,2024-02-02,9257
1316,上曜,14,1,13,凱基-林口,2024-02-02,9257
2388,威盛,16,4,12,凱基-林口,2024-02-02,9257
3081,聯亞,12,0,12,凱基-林口,2024-02-02,9257
3715,定穎投控,42,31,11,凱基-林口,2024-02-02,9257
5258,虹堡,15,4,11,凱基-林口,2024-02-02,9257
0050,元大台灣50,10,0,10,凱基-林口,2024-02-02,9257
2891,中信金,10,0,10,凱基-林口,2024-02-02,9257
00915,凱基優選高股息30,10,0,10,凱基-林口,2024-02-02,9257
00669R,國泰美國道瓊反1,10,0,10,凱基-林口,2024-02-02,9257
2323,中環,10,0,10,凱基-林口,2024-02-02,9257
3030,德律,10,0,10,凱基-林口,2024-02-02,9257
6189,豐藝,10,0,10,凱基-林口,2024-02-02,9257
00929,復華台灣科技優息,12,3,9,凱基-林口,2024-02-02,9257
00637L,元大滬深300正2,11,2,9,凱基-林口,2024-02-02,9257
1503,士電,13,5,8,凱基-林口,2024-02-02,9257
2408,南亞科,8,0,8,凱基-林口,2024-02-02,9257
2880,華南金,8,0,8,凱基-林口,2024-02-02,9257
3066,李洲,9,1,8,凱基-林口,2024-02-02,9257
6233,旺玖,8,0,8,凱基-林口,2024-02-02,9257
00918,大華優利高填息30,8,0,8,凱基-林口,2024-02-02,9257
00937B,群益ESG投等債20,786,1,785,凱基-林口,2024-02-05,9257
00712,復華富時不動產,633,0,633,凱基-林口,2024-02-05,9257
2618,長榮航,277,21,256,凱基-林口,2024-02-05,9257
00933B,國泰10Y+金融債,215,4,211,凱基-林口,2024-02-05,9257
2356,英業達,219,16,203,凱基-林口,2024-02-05,9257
4161,聿新科,203,18,185,凱基-林口,2024-02-05,9257
00878,國泰永續高股息,152,8,144,凱基-林口,2024-02-05,9257
2610,華航,102,15,87,凱基-林口,2024-02-05,9257
2609,陽明,80,7,73,凱基-林口,2024-02-05,9257
00687B,國泰20年美債,68,0,68,凱基-林口,2024-02-05,9257
00679B,元大美債20年,63,0,63,凱基-林口,2024-02-05,9257
00929,復華台灣科技優息,61,0,61,凱基-林口,2024-02-05,9257
2365,昆盈,115,66,49,凱基-林口,2024-02-05,9257
3481,群創,78,31,47,凱基-林口,2024-02-05,9257
1609,大亞,43,0,43,凱基-林口,2024-02-05,9257
2329,華泰,65,24,41,凱基-林口,2024-02-05,9257
3491,昇達科,40,0,40,凱基-林口,2024-02-05,9257
00931B,統一美債20年,41,5,36,凱基-林口,2024-02-05,9257
2606,裕民,32,0,32,凱基-林口,2024-02-05,9257
8085,福華,32,0,32,凱基-林口,2024-02-05,9257
3434,哲固,30,1,29,凱基-林口,2024-02-05,9257
00772B,中信高評級公司債,28,0,28,凱基-林口,2024-02-05,9257
6282,康舒,29,2,27,凱基-林口,2024-02-05,9257
2363,矽統,24,0,24,凱基-林口,2024-02-05,9257
6245,立端,23,3,20,凱基-林口,2024-02-05,9257
3483,力致,25,6,19,凱基-林口,2024-02-05,9257
3548,兆利,50,32,18,凱基-林口,2024-02-05,9257
2884,玉山金,17,0,17,凱基-林口,2024-02-05,9257
5302,太欣,16,0,16,凱基-林口,2024-02-05,9257
3308,聯德,15,0,15,凱基-林口,2024-02-05,9257
00919,群益台灣精選高息,33,20,13,凱基-林口,2024-02-05,9257
8210,勤誠,39,26,13,凱基-林口,2024-02-05,9257
8096,擎亞,22,10,12,凱基-林口,2024-02-05,9257
2385,群光,10,0,10,凱基-林口,2024-02-05,9257
3047,訊舟,10,0,10,凱基-林口,2024-02-05,9257
6684,安格,10,0,10,凱基-林口,2024-02-05,9257
8114,振樺電,10,0,10,凱基-林口,2024-02-05,9257
9904,寶成,10,0,10,凱基-林口,2024-02-05,9257
5347,世界,11,2,9,凱基-林口,2024-02-05,9257
00882,中信中國高股息,15,6,9,凱基-林口,2024-02-05,9257
6290,良維,10,2,8,凱基-林口,2024-02-05,9257
00764B,群益25年美債,7,0,7,凱基-林口,2024-02-05,9257
00757,統一FANG+,8,1,7,凱基-林口,2024-02-05,9257
1303,南亞,7,0,7,凱基-林口,2024-02-05,9257
1528,恩德,32,25,7,凱基-林口,2024-02-05,9257
6695,芯鼎,13,6,7,凱基-林口,2024-02-05,9257
3376,新日興,12,6,6,凱基-林口,2024-02-05,9257
8996,高力,50,44,6,凱基-林口,2024-02-05,9257
1513,中興電,6,0,6,凱基-林口,2024-02-05,9257
2457,飛宏,11,5,6,凱基-林口,2024-02-05,9257
2618,長榮航,243,6,237,凱基-林口,2024-02-15,9257
00937B,群益ESG投等債20,223,0,223,凱基-林口,2024-02-15,9257
00679B,元大美債20年,169,1,168,凱基-林口,2024-02-15,9257
00632R,元大台灣50反1,155,0,155,凱基-林口,2024-02-15,9257
00878,國泰永續高股息,169,18,151,凱基-林口,2024-02-15,9257
00687B,國泰20年美債,148,2,146,凱基-林口,2024-02-15,9257
00712,復華富時不動產,131,0,131,凱基-林口,2024-02-15,9257
4161,聿新科,183,56,127,凱基-林口,2024-02-15,9257
00680L,元大美債20正2,115,0,115,凱基-林口,2024-02-15,9257
2610,華航,114,0,114,凱基-林口,2024-02-15,9257
3481,群創,81,0,81,凱基-林口,2024-02-15,9257
00933B,國泰10Y+金融債,57,0,57,凱基-林口,2024-02-15,9257
00720B,元大投資級公司債,56,1,55,凱基-林口,2024-02-15,9257
2344,華邦電,58,5,53,凱基-林口,2024-02-15,9257
00931B,統一美債20年,38,0,38,凱基-林口,2024-02-15,9257
3078,僑威,40,3,37,凱基-林口,2024-02-15,9257
5512,力麒,31,0,31,凱基-林口,2024-02-15,9257
5521,工信,38,8,30,凱基-林口,2024-02-15,9257
00772B,中信高評級公司債,25,0,25,凱基-林口,2024-02-15,9257
2408,南亞科,24,0,24,凱基-林口,2024-02-15,9257
00795B,中信美國公債20年,25,2,23,凱基-林口,2024-02-15,9257
00706L,期元大S＆P日圓正2,21,0,21,凱基-林口,2024-02-15,9257
6226,光鼎,20,0,20,凱基-林口,2024-02-15,9257
2472,立隆電,15,0,15,凱基-林口,2024-02-15,9257
2460,建通,12,0,12,凱基-林口,2024-02-15,9257
4303,信立,16,4,12,凱基-林口,2024-02-15,9257
5426,振發,17,5,12,凱基-林口,2024-02-15,9257
3548,兆利,19,8,11,凱基-林口,2024-02-15,9257
6182,合晶,11,0,11,凱基-林口,2024-02-15,9257
1513,中興電,12,1,11,凱基-林口,2024-02-15,9257
2002,中鋼,10,0,10,凱基-林口,2024-02-15,9257
00673R,期元大S＆P原油反1,10,0,10,凱基-林口,2024-02-15,9257
1442,名軒,10,0,10,凱基-林口,2024-02-15,9257
1568,倉佑,10,0,10,凱基-林口,2024-02-15,9257
2338,光罩,11,1,10,凱基-林口,2024-02-15,9257
3050,鈺德,10,0,10,凱基-林口,2024-02-15,9257
4532,瑞智,10,0,10,凱基-林口,2024-02-15,9257
8016,矽創,11,1,10,凱基-林口,2024-02-15,9257
00725B,國泰投資級公司債,9,0,9,凱基-林口,2024-02-15,9257
2885,元大金,10,1,9,凱基-林口,2024-02-15,9257
3339,泰谷,9,0,9,凱基-林口,2024-02-15,9257
5483,中美晶,10,1,9,凱基-林口,2024-02-15,9257
00751B,元大AAA至A公司債,9,1,8,凱基-林口,2024-02-15,9257
00655L,國泰中國A50正2,10,2,8,凱基-林口,2024-02-15,9257
2376,技嘉,16,9,7,凱基-林口,2024-02-15,9257
4931,新盛力,9,2,7,凱基-林口,2024-02-15,9257
6443,元晶,9,2,7,凱基-林口,2024-02-15,9257
6684,安格,7,0,7,凱基-林口,2024-02-15,9257
8112,至上,7,0,7,凱基-林口,2024-02-15,9257
00919,群益台灣精選高息,27,20,7,凱基-林口,2024-02-15,9257
00687B,國泰20年美債,68,0,68,凱基-林口,2024-02-16,9257
00937B,群益ESG投等債20,63,0,63,凱基-林口,2024-02-16,9257
00679B,元大美債20年,58,0,58,凱基-林口,2024-02-16,9257
00929,復華台灣科技優息,75,18,57,凱基-林口,2024-02-16,9257
00933B,國泰10Y+金融債,55,0,55,凱基-林口,2024-02-16,9257
5521,工信,50,0,50,凱基-林口,2024-02-16,9257
00753L,中信中國50正2,100,54,46,凱基-林口,2024-02-16,9257
2353,宏��,74,30,44,凱基-林口,2024-02-16,9257
4161,聿新科,103,60,43,凱基-林口,2024-02-16,9257
1582,信錦,37,2,35,凱基-林口,2024-02-16,9257
00795B,中信美國公債20年,34,0,34,凱基-林口,2024-02-16,9257
5302,太欣,32,0,32,凱基-林口,2024-02-16,9257
6216,居易,30,0,30,凱基-林口,2024-02-16,9257
2382,廣達,41,12,29,凱基-林口,2024-02-16,9257
2425,承啟,29,2,27,凱基-林口,2024-02-16,9257
00772B,中信高評級公司債,18,0,18,凱基-林口,2024-02-16,9257
2408,南亞科,18,0,18,凱基-林口,2024-02-16,9257
2888,新光金,18,0,18,凱基-林口,2024-02-16,9257
6257,矽格,21,3,18,凱基-林口,2024-02-16,9257
1815,富喬,31,14,17,凱基-林口,2024-02-16,9257
3017,奇鋐,36,19,17,凱基-林口,2024-02-16,9257
2491,吉祥全,16,0,16,凱基-林口,2024-02-16,9257
3231,緯創,36,20,16,凱基-林口,2024-02-16,9257
00931B,統一美債20年,15,0,15,凱基-林口,2024-02-16,9257
2882,國泰金,20,5,15,凱基-林口,2024-02-16,9257
00712,復華富時不動產,19,5,14,凱基-林口,2024-02-16,9257
8996,高力,20,6,14,凱基-林口,2024-02-16,9257
3322,建舜電,14,1,13,凱基-林口,2024-02-16,9257
3324,雙鴻,25,13,12,凱基-林口,2024-02-16,9257
5871,中租-KY,11,0,11,凱基-林口,2024-02-16,9257
2449,京元電子,23,12,11,凱基-林口,2024-02-16,9257
2867,三商壽,11,0,11,凱基-林口,2024-02-16,9257
3715,定穎投控,10,0,10,凱基-林口,2024-02-16,9257
00680L,元大美債20正2,10,0,10,凱基-林口,2024-02-16,9257
1409,新纖,20,10,10,凱基-林口,2024-02-16,9257
1584,精剛,10,0,10,凱基-林口,2024-02-16,9257
2809,京城銀,10,0,10,凱基-林口,2024-02-16,9257
3372,典範,10,0,10,凱基-林口,2024-02-16,9257
5213,亞昕,10,0,10,凱基-林口,2024-02-16,9257
5398,慕康生醫,10,0,10,凱基-林口,2024-02-16,9257
6015,宏遠證,10,0,10,凱基-林口,2024-02-16,9257
6108,競國,10,0,10,凱基-林口,2024-02-16,9257
6194,育富,10,0,10,凱基-林口,2024-02-16,9257
1449,佳和,9,0,9,凱基-林口,2024-02-16,9257
5258,虹堡,9,0,9,凱基-林口,2024-02-16,9257
6245,立端,11,2,9,凱基-林口,2024-02-16,9257
6290,良維,10,1,9,凱基-林口,2024-02-16,9257
00720B,元大投資級公司債,8,0,8,凱基-林口,2024-02-16,9257
1591,駿吉-KY,8,0,8,凱基-林口,2024-02-16,9257
2467,志聖,9,1,8,凱基-林口,2024-02-16,9257
2883,凱基金,1130,20,1110,凱基-林口,2024-02-19,9257
00878,國泰永續高股息,189,8,181,凱基-林口,2024-02-19,9257
2329,華泰,224,55,169,凱基-林口,2024-02-19,9257
4161,聿新科,167,22,145,凱基-林口,2024-02-19,9257
00937B,群益ESG投等債20,141,0,141,凱基-林口,2024-02-19,9257
00690,兆豐藍籌30,100,0,100,凱基-林口,2024-02-19,9257
3706,神達,96,3,93,凱基-林口,2024-02-19,9257
8070,長華*,76,5,71,凱基-林口,2024-02-19,9257
6548,長科*,66,0,66,凱基-林口,2024-02-19,9257
00929,復華台灣科技優息,72,13,59,凱基-林口,2024-02-19,9257
2367,燿華,50,0,50,凱基-林口,2024-02-19,9257
3363,上詮,53,3,50,凱基-林口,2024-02-19,9257
00919,群益台灣精選高息,49,1,48,凱基-林口,2024-02-19,9257
00687B,國泰20年美債,45,0,45,凱基-林口,2024-02-19,9257
2515,中工,62,20,42,凱基-林口,2024-02-19,9257
00933B,國泰10Y+金融債,35,0,35,凱基-林口,2024-02-19,9257
2353,宏��,39,10,29,凱基-林口,2024-02-19,9257
3376,新日興,28,1,27,凱基-林口,2024-02-19,9257
00637L,元大滬深300正2,32,7,25,凱基-林口,2024-02-19,9257
5202,力新,25,0,25,凱基-林口,2024-02-19,9257
1717,長興,25,1,24,凱基-林口,2024-02-19,9257
2369,菱生,70,48,22,凱基-林口,2024-02-19,9257
6223,旺矽,22,0,22,凱基-林口,2024-02-19,9257
2884,玉山金,23,3,20,凱基-林口,2024-02-19,9257
2867,三商壽,20,0,20,凱基-林口,2024-02-19,9257
4953,緯軟,20,0,20,凱基-林口,2024-02-19,9257
6188,廣明,20,0,20,凱基-林口,2024-02-19,9257
00712,復華富時不動產,19,0,19,凱基-林口,2024-02-19,9257
4303,信立,22,3,19,凱基-林口,2024-02-19,9257
6229,研通,18,0,18,凱基-林口,2024-02-19,9257
1528,恩德,17,0,17,凱基-林口,2024-02-19,9257
1773,勝一,17,0,17,凱基-林口,2024-02-19,9257
3516,亞帝歐,17,0,17,凱基-林口,2024-02-19,9257
5443,均豪,23,7,16,凱基-林口,2024-02-19,9257
1103,嘉泥,15,0,15,凱基-林口,2024-02-19,9257
3047,訊舟,15,0,15,凱基-林口,2024-02-19,9257
3504,揚明光,15,0,15,凱基-林口,2024-02-19,9257
3231,緯創,36,21,15,凱基-林口,2024-02-19,9257
2382,廣達,22,7,15,凱基-林口,2024-02-19,9257
4908,前鼎,19,5,14,凱基-林口,2024-02-19,9257
00891,中信關鍵半導體,15,2,13,凱基-林口,2024-02-19,9257
1582,信錦,13,0,13,凱基-林口,2024-02-19,9257
4529,淳紳,15,2,13,凱基-林口,2024-02-19,9257
1316,上曜,25,12,13,凱基-林口,2024-02-19,9257
00655L,國泰中國A50正2,12,0,12,凱基-林口,2024-02-19,9257
6425,易發,12,0,12,凱基-林口,2024-02-19,9257
00680L,元大美債20正2,11,0,11,凱基-林口,2024-02-19,9257
1305,華夏,11,0,11,凱基-林口,2024-02-19,9257
2491,吉祥全,11,0,11,凱基-林口,2024-02-19,9257
00934,中信成長高股息,10,0,10,凱基-林口,2024-02-19,9257
00878,國泰永續高股息,175,23,152,凱基-林口,2024-02-20,9257
4161,聿新科,141,10,131,凱基-林口,2024-02-20,9257
00919,群益台灣精選高息,219,139,80,凱基-林口,2024-02-20,9257
3706,神達,86,11,75,凱基-林口,2024-02-20,9257
2020,美亞,70,0,70,凱基-林口,2024-02-20,9257
00680L,元大美債20正2,67,0,67,凱基-林口,2024-02-20,9257
00688L,國泰20年美債正2,60,0,60,凱基-林口,2024-02-20,9257
00687B,國泰20年美債,59,0,59,凱基-林口,2024-02-20,9257
1609,大亞,60,1,59,凱基-林口,2024-02-20,9257
00679B,元大美債20年,54,1,53,凱基-林口,2024-02-20,9257
8092,建暐,45,0,45,凱基-林口,2024-02-20,9257
2353,宏��,47,6,41,凱基-林口,2024-02-20,9257
00933B,國泰10Y+金融債,41,1,40,凱基-林口,2024-02-20,9257
8097,常珵,40,0,40,凱基-林口,2024-02-20,9257
4960,誠美材,30,0,30,凱基-林口,2024-02-20,9257
3363,上詮,33,4,29,凱基-林口,2024-02-20,9257
00712,復華富時不動產,32,4,28,凱基-林口,2024-02-20,9257
3437,榮創,28,0,28,凱基-林口,2024-02-20,9257
2405,輔信,68,41,27,凱基-林口,2024-02-20,9257
8070,長華*,29,3,26,凱基-林口,2024-02-20,9257
5213,亞昕,25,0,25,凱基-林口,2024-02-20,9257
4303,信立,23,0,23,凱基-林口,2024-02-20,9257
8112,至上,25,2,23,凱基-林口,2024-02-20,9257
1513,中興電,32,10,22,凱基-林口,2024-02-20,9257
2338,光罩,22,0,22,凱基-林口,2024-02-20,9257
4529,淳紳,22,1,21,凱基-林口,2024-02-20,9257
2481,強茂,20,0,20,凱基-林口,2024-02-20,9257
3321,同泰,20,0,20,凱基-林口,2024-02-20,9257
6126,信音,22,2,20,凱基-林口,2024-02-20,9257
2492,華新科,20,1,19,凱基-林口,2024-02-20,9257
6143,振曜,20,1,19,凱基-林口,2024-02-20,9257
6548,長科*,20,1,19,凱基-林口,2024-02-20,9257
3041,揚智,27,11,16,凱基-林口,2024-02-20,9257
3035,智原,36,20,16,凱基-林口,2024-02-20,9257
3037,欣興,75,60,15,凱基-林口,2024-02-20,9257
5351,鈺創,17,2,15,凱基-林口,2024-02-20,9257
3260,威剛,18,4,14,凱基-林口,2024-02-20,9257
2376,技嘉,33,19,14,凱基-林口,2024-02-20,9257
3231,緯創,29,16,13,凱基-林口,2024-02-20,9257
2801,彰銀,13,0,13,凱基-林口,2024-02-20,9257
6799,來頡,16,3,13,凱基-林口,2024-02-20,9257
8182,加高,16,3,13,凱基-林口,2024-02-20,9257
2457,飛宏,14,2,12,凱基-林口,2024-02-20,9257
2365,昆盈,12,0,12,凱基-林口,2024-02-20,9257
3066,李洲,37,25,12,凱基-林口,2024-02-20,9257
5439,高技,12,0,12,凱基-林口,2024-02-20,9257
2516,新建,11,0,11,凱基-林口,2024-02-20,9257
3032,偉訓,12,1,11,凱基-林口,2024-02-20,9257
3548,兆利,31,20,11,凱基-林口,2024-02-20,9257
3545,敦泰,20,10,10,凱基-林口,2024-02-20,9257
00753L,中信中國50正2,170,30,140,凱基-林口,2024-02-21,9257
00878,國泰永續高股息,142,6,136,凱基-林口,2024-02-21,9257
00937B,群益ESG投等債20,113,0,113,凱基-林口,2024-02-21,9257
00687B,國泰20年美債,111,0,111,凱基-林口,2024-02-21,9257
00933B,國泰10Y+金融債,96,0,96,凱基-林口,2024-02-21,9257
2356,英業達,105,10,95,凱基-林口,2024-02-21,9257
00795B,中信美國公債20年,91,0,91,凱基-林口,2024-02-21,9257
00712,復華富時不動產,62,0,62,凱基-林口,2024-02-21,9257
4161,聿新科,57,1,56,凱基-林口,2024-02-21,9257
3231,緯創,53,8,45,凱基-林口,2024-02-21,9257
9105,泰金寶-DR,43,1,42,凱基-林口,2024-02-21,9257
00679B,元大美債20年,31,0,31,凱基-林口,2024-02-21,9257
2883,凱基金,28,0,28,凱基-林口,2024-02-21,9257
0056,元大高股息,29,3,26,凱基-林口,2024-02-21,9257
2025,千興,26,0,26,凱基-林口,2024-02-21,9257
2637,慧洋-KY,27,1,26,凱基-林口,2024-02-21,9257
4534,慶騰,25,0,25,凱基-林口,2024-02-21,9257
00929,復華台灣科技優息,40,16,24,凱基-林口,2024-02-21,9257
2885,元大金,24,0,24,凱基-林口,2024-02-21,9257
1434,福懋,23,0,23,凱基-林口,2024-02-21,9257
2609,陽明,42,20,22,凱基-林口,2024-02-21,9257
3481,群創,32,10,22,凱基-林口,2024-02-21,9257
00919,群益台灣精選高息,30,9,21,凱基-林口,2024-02-21,9257
8054,安國,20,0,20,凱基-林口,2024-02-21,9257
4909,新復興,21,1,20,凱基-林口,2024-02-21,9257
6198,瑞築,20,0,20,凱基-林口,2024-02-21,9257
8085,福華,21,2,19,凱基-林口,2024-02-21,9257
2460,建通,31,13,18,凱基-林口,2024-02-21,9257
3035,智原,31,13,18,凱基-林口,2024-02-21,9257
2426,鼎元,17,0,17,凱基-林口,2024-02-21,9257
8110,華東,17,0,17,凱基-林口,2024-02-21,9257
2884,玉山金,16,0,16,凱基-林口,2024-02-21,9257
6282,康舒,16,0,16,凱基-林口,2024-02-21,9257
8940,新天地,16,0,16,凱基-林口,2024-02-21,9257
1316,上曜,16,1,15,凱基-林口,2024-02-21,9257
1773,勝一,15,0,15,凱基-林口,2024-02-21,9257
2303,聯電,15,0,15,凱基-林口,2024-02-21,9257
3073,天方能源,12,0,12,凱基-林口,2024-02-21,9257
5880,合庫金,12,0,12,凱基-林口,2024-02-21,9257
2382,廣達,11,1,10,凱基-林口,2024-02-21,9257
3037,欣興,11,1,10,凱基-林口,2024-02-21,9257
00885,富邦越南,10,0,10,凱基-林口,2024-02-21,9257
1568,倉佑,10,0,10,凱基-林口,2024-02-21,9257
1603,華電,10,0,10,凱基-林口,2024-02-21,9257
2313,華通,11,1,10,凱基-林口,2024-02-21,9257
2317,鴻海,10,0,10,凱基-林口,2024-02-21,9257
5383,金利,10,0,10,凱基-林口,2024-02-21,9257
6180,橘子,10,0,10,凱基-林口,2024-02-21,9257
9950,萬國通,10,0,10,凱基-林口,2024-02-21,9257
2485,兆赫,10,1,9,凱基-林口,2024-02-21,9257
2356,英業達,727,14,713,凱基-林口,2024-02-22,9257
00712,復華富時不動產,539,100,439,凱基-林口,2024-02-22,9257
00919,群益台灣精選高息,416,10,406,凱基-林口,2024-02-22,9257
2855,統一證,230,0,230,凱基-林口,2024-02-22,9257
3014,聯陽,122,1,121,凱基-林口,2024-02-22,9257
00937B,群益ESG投等債20,116,0,116,凱基-林口,2024-02-22,9257
2543,皇昌,114,0,114,凱基-林口,2024-02-22,9257
00687B,國泰20年美債,64,0,64,凱基-林口,2024-02-22,9257
8150,南茂,60,0,60,凱基-林口,2024-02-22,9257
00933B,國泰10Y+金融債,55,0,55,凱基-林口,2024-02-22,9257
3221,台嘉碩,67,14,53,凱基-林口,2024-02-22,9257
00680L,元大美債20正2,43,0,43,凱基-林口,2024-02-22,9257
2324,仁寶,38,3,35,凱基-林口,2024-02-22,9257
2062,橋椿,36,1,35,凱基-林口,2024-02-22,9257
1316,上曜,35,6,29,凱基-林口,2024-02-22,9257
00795B,中信美國公債20年,27,0,27,凱基-林口,2024-02-22,9257
4161,聿新科,26,0,26,凱基-林口,2024-02-22,9257
1503,士電,46,21,25,凱基-林口,2024-02-22,9257
00679B,元大美債20年,23,1,22,凱基-林口,2024-02-22,9257
3044,健鼎,24,4,20,凱基-林口,2024-02-22,9257
8070,長華*,20,0,20,凱基-林口,2024-02-22,9257
1513,中興電,21,3,18,凱基-林口,2024-02-22,9257
00720B,元大投資級公司債,17,0,17,凱基-林口,2024-02-22,9257
3689,湧德,27,11,16,凱基-林口,2024-02-22,9257
00650L,復華香港正2,15,0,15,凱基-林口,2024-02-22,9257
4131,浩泰,15,0,15,凱基-林口,2024-02-22,9257
00931B,統一美債20年,13,1,12,凱基-林口,2024-02-22,9257
2367,燿華,21,9,12,凱基-林口,2024-02-22,9257
2461,光群雷,11,0,11,凱基-林口,2024-02-22,9257
4908,前鼎,27,16,11,凱基-林口,2024-02-22,9257
00632R,元大台灣50反1,11,0,11,凱基-林口,2024-02-22,9257
1108,幸福,10,0,10,凱基-林口,2024-02-22,9257
1589,永冠-KY,11,1,10,凱基-林口,2024-02-22,9257
2867,三商壽,10,0,10,凱基-林口,2024-02-22,9257
6122,擎邦,10,0,10,凱基-林口,2024-02-22,9257
6147,頎邦,10,0,10,凱基-林口,2024-02-22,9257
6548,長科*,10,0,10,凱基-林口,2024-02-22,9257
8289,泰藝,10,0,10,凱基-林口,2024-02-22,9257
2301,光寶科,10,1,9,凱基-林口,2024-02-22,9257
3081,聯亞,15,6,9,凱基-林口,2024-02-22,9257
5351,鈺創,10,1,9,凱基-林口,2024-02-22,9257
2409,友達,10,1,9,凱基-林口,2024-02-22,9257
4968,立積,10,1,9,凱基-林口,2024-02-22,9257
2303,聯電,20,12,8,凱基-林口,2024-02-22,9257
6205,詮欣,8,0,8,凱基-林口,2024-02-22,9257
8096,擎亞,31,23,8,凱基-林口,2024-02-22,9257
9933,中鼎,8,0,8,凱基-林口,2024-02-22,9257
4123,晟德,7,0,7,凱基-林口,2024-02-22,9257
00751B,元大AAA至A公司債,7,0,7,凱基-林口,2024-02-22,9257
3005,神基,28,21,7,凱基-林口,2024-02-22,9257
1522,堤維西,250,0,250,凱基-林口,2024-02-23,9257
2356,英業達,241,26,215,凱基-林口,2024-02-23,9257
00933B,國泰10Y+金融債,146,1,145,凱基-林口,2024-02-23,9257
2460,建通,137,0,137,凱基-林口,2024-02-23,9257
00632R,元大台灣50反1,102,0,102,凱基-林口,2024-02-23,9257
00937B,群益ESG投等債20,95,0,95,凱基-林口,2024-02-23,9257
3363,上詮,105,24,81,凱基-林口,2024-02-23,9257
1514,亞力,109,31,78,凱基-林口,2024-02-23,9257
8034,榮群,71,0,71,凱基-林口,2024-02-23,9257
00929,復華台灣科技優息,69,0,69,凱基-林口,2024-02-23,9257
6116,彩晶,50,0,50,凱基-林口,2024-02-23,9257
00679B,元大美債20年,33,2,31,凱基-林口,2024-02-23,9257
6806,森崴能源,31,0,31,凱基-林口,2024-02-23,9257
3147,大綜,30,0,30,凱基-林口,2024-02-23,9257
1303,南亞,29,0,29,凱基-林口,2024-02-23,9257
00918,大華優利高填息30,27,0,27,凱基-林口,2024-02-23,9257
2464,盟立,26,0,26,凱基-林口,2024-02-23,9257
4906,正文,35,10,25,凱基-林口,2024-02-23,9257
00687B,國泰20年美債,24,0,24,凱基-林口,2024-02-23,9257
3481,群創,24,0,24,凱基-林口,2024-02-23,9257
2489,瑞軒,21,0,21,凱基-林口,2024-02-23,9257
3042,晶技,21,0,21,凱基-林口,2024-02-23,9257
5469,瀚宇博,27,6,21,凱基-林口,2024-02-23,9257
5213,亞昕,20,0,20,凱基-林口,2024-02-23,9257
6245,立端,20,1,19,凱基-林口,2024-02-23,9257
00922,國泰台灣領袖50,20,2,18,凱基-林口,2024-02-23,9257
2618,長榮航,18,2,16,凱基-林口,2024-02-23,9257
3014,聯陽,20,4,16,凱基-林口,2024-02-23,9257
6282,康舒,22,7,15,凱基-林口,2024-02-23,9257
3374,精材,21,7,14,凱基-林口,2024-02-23,9257
4532,瑞智,20,6,14,凱基-林口,2024-02-23,9257
00927,群益半導體收益,13,0,13,凱基-林口,2024-02-23,9257
00891,中信關鍵半導體,13,0,13,凱基-林口,2024-02-23,9257
2358,廷鑫,13,0,13,凱基-林口,2024-02-23,9257
2363,矽統,21,8,13,凱基-林口,2024-02-23,9257
006208,富邦台50,12,0,12,凱基-林口,2024-02-23,9257
9951,皇田,12,0,12,凱基-林口,2024-02-23,9257
1503,士電,21,9,12,凱基-林口,2024-02-23,9257
00795B,中信美國公債20年,11,0,11,凱基-林口,2024-02-23,9257
2457,飛宏,11,0,11,凱基-林口,2024-02-23,9257
1316,上曜,21,10,11,凱基-林口,2024-02-23,9257
2025,千興,11,0,11,凱基-林口,2024-02-23,9257
3049,精金,11,0,11,凱基-林口,2024-02-23,9257
5009,榮剛,11,0,11,凱基-林口,2024-02-23,9257
8044,網家,11,0,11,凱基-林口,2024-02-23,9257
3360,尚立,13,2,11,凱基-林口,2024-02-23,9257
1506,正道,10,0,10,凱基-林口,2024-02-23,9257
2885,元大金,10,0,10,凱基-林口,2024-02-23,9257
3483,力致,10,0,10,凱基-林口,2024-02-23,9257
4207,環泰,10,0,10,凱基-林口,2024-02-23,9257
2883,凱基金,603,12,591,凱基-林口,2024-02-26,9257
00937B,群益ESG投等債20,520,50,470,凱基-林口,2024-02-26,9257
1522,堤維西,387,25,362,凱基-林口,2024-02-26,9257
00933B,國泰10Y+金融債,332,5,327,凱基-林口,2024-02-26,9257
00753L,中信中國50正2,300,0,300,凱基-林口,2024-02-26,9257
00919,群益台灣精選高息,154,17,137,凱基-林口,2024-02-26,9257
00929,復華台灣科技優息,109,24,85,凱基-林口,2024-02-26,9257
00878,國泰永續高股息,154,68,86,凱基-林口,2024-02-26,9257
4720,德淵,68,3,65,凱基-林口,2024-02-26,9257
3437,榮創,59,1,58,凱基-林口,2024-02-26,9257
00679B,元大美債20年,79,33,46,凱基-林口,2024-02-26,9257
2405,輔信,86,46,40,凱基-林口,2024-02-26,9257
1609,大亞,47,10,37,凱基-林口,2024-02-26,9257
00680L,元大美債20正2,35,0,35,凱基-林口,2024-02-26,9257
3260,威剛,30,0,30,凱基-林口,2024-02-26,9257
4161,聿新科,49,20,29,凱基-林口,2024-02-26,9257
3706,神達,26,2,24,凱基-林口,2024-02-26,9257
3354,律勝,22,0,22,凱基-林口,2024-02-26,9257
5469,瀚宇博,22,0,22,凱基-林口,2024-02-26,9257
2301,光寶科,20,0,20,凱基-林口,2024-02-26,9257
00923,群益台ESG低碳50,20,0,20,凱基-林口,2024-02-26,9257
4576,大銀微系統,20,0,20,凱基-林口,2024-02-26,9257
00632R,元大台灣50反1,19,0,19,凱基-林口,2024-02-26,9257
4526,東台,41,23,18,凱基-林口,2024-02-26,9257
8034,榮群,18,0,18,凱基-林口,2024-02-26,9257
2353,宏��,22,5,17,凱基-林口,2024-02-26,9257
2062,橋椿,15,0,15,凱基-林口,2024-02-26,9257
2495,普安,15,0,15,凱基-林口,2024-02-26,9257
6514,芮特-KY,15,0,15,凱基-林口,2024-02-26,9257
5355,佳總,14,0,14,凱基-林口,2024-02-26,9257
2637,慧洋-KY,15,1,14,凱基-林口,2024-02-26,9257
4979,華星光,16,2,14,凱基-林口,2024-02-26,9257
2892,第一金,13,0,13,凱基-林口,2024-02-26,9257
1227,佳格,13,0,13,凱基-林口,2024-02-26,9257
4147,中裕,14,1,13,凱基-林口,2024-02-26,9257
00712,復華富時不動產,13,0,13,凱基-林口,2024-02-26,9257
2362,藍天,12,0,12,凱基-林口,2024-02-26,9257
2630,亞航,13,1,12,凱基-林口,2024-02-26,9257
3231,緯創,36,24,12,凱基-林口,2024-02-26,9257
2426,鼎元,16,5,11,凱基-林口,2024-02-26,9257
8473,山林水,12,1,11,凱基-林口,2024-02-26,9257
1608,華榮,10,0,10,凱基-林口,2024-02-26,9257
2317,鴻海,21,11,10,凱基-林口,2024-02-26,9257
2417,圓剛,10,0,10,凱基-林口,2024-02-26,9257
3390,旭軟,12,2,10,凱基-林口,2024-02-26,9257
6152,百一,10,0,10,凱基-林口,2024-02-26,9257
6550,北極星藥業-KY,10,0,10,凱基-林口,2024-02-26,9257
9939,宏全,10,0,10,凱基-林口,2024-02-26,9257
2337,旺宏,10,1,9,凱基-林口,2024-02-26,9257
8027,鈦昇,9,0,9,凱基-林口,2024-02-26,9257
2883,凱基金,500,5,495,凱基-林口,2024-02-27,9257
00878,國泰永續高股息,252,5,247,凱基-林口,2024-02-27,9257
00919,群益台灣精選高息,278,43,235,凱基-林口,2024-02-27,9257
00937B,群益ESG投等債20,203,3,200,凱基-林口,2024-02-27,9257
00712,復華富時不動產,103,0,103,凱基-林口,2024-02-27,9257
00753L,中信中國50正2,300,222,78,凱基-林口,2024-02-27,9257
3706,神達,83,6,77,凱基-林口,2024-02-27,9257
00933B,國泰10Y+金融債,119,51,68,凱基-林口,2024-02-27,9257
2363,矽統,185,126,59,凱基-林口,2024-02-27,9257
00929,復華台灣科技優息,72,17,55,凱基-林口,2024-02-27,9257
6125,廣運,76,25,51,凱基-林口,2024-02-27,9257
1711,永光,75,25,50,凱基-林口,2024-02-27,9257
4161,聿新科,52,5,47,凱基-林口,2024-02-27,9257
2356,英業達,46,3,43,凱基-林口,2024-02-27,9257
1609,大亞,55,13,42,凱基-林口,2024-02-27,9257
3450,聯鈞,60,18,42,凱基-林口,2024-02-27,9257
2486,一詮,43,2,41,凱基-林口,2024-02-27,9257
3363,上詮,41,3,38,凱基-林口,2024-02-27,9257
2408,南亞科,39,5,34,凱基-林口,2024-02-27,9257
2301,光寶科,33,1,32,凱基-林口,2024-02-27,9257
8034,榮群,29,0,29,凱基-林口,2024-02-27,9257
3231,緯創,55,30,25,凱基-林口,2024-02-27,9257
3354,律勝,25,0,25,凱基-林口,2024-02-27,9257
00687B,國泰20年美債,24,0,24,凱基-林口,2024-02-27,9257
2495,普安,25,1,24,凱基-林口,2024-02-27,9257
4532,瑞智,22,0,22,凱基-林口,2024-02-27,9257
6237,驊訊,47,25,22,凱基-林口,2024-02-27,9257
1316,上曜,54,32,22,凱基-林口,2024-02-27,9257
2382,廣達,22,0,22,凱基-林口,2024-02-27,9257
00900,富邦特選高股息30,21,0,21,凱基-林口,2024-02-27,9257
3163,波若威,34,13,21,凱基-林口,2024-02-27,9257
6438,迅得,21,2,19,凱基-林口,2024-02-27,9257
3049,精金,18,0,18,凱基-林口,2024-02-27,9257
00679B,元大美債20年,19,1,18,凱基-林口,2024-02-27,9257
6284,佳邦,23,6,17,凱基-林口,2024-02-27,9257
2208,台船,20,4,16,凱基-林口,2024-02-27,9257
3227,原相,17,2,15,凱基-林口,2024-02-27,9257
1522,堤維西,24,9,15,凱基-林口,2024-02-27,9257
4906,正文,14,0,14,凱基-林口,2024-02-27,9257
6282,康舒,14,0,14,凱基-林口,2024-02-27,9257
5880,合庫金,13,0,13,凱基-林口,2024-02-27,9257
00923,群益台ESG低碳50,16,4,12,凱基-林口,2024-02-27,9257
00795B,中信美國公債20年,12,0,12,凱基-林口,2024-02-27,9257
2467,志聖,30,18,12,凱基-林口,2024-02-27,9257
3014,聯陽,12,0,12,凱基-林口,2024-02-27,9257
3078,僑威,12,0,12,凱基-林口,2024-02-27,9257
4576,大銀微系統,12,0,12,凱基-林口,2024-02-27,9257
2834,臺企銀,15,3,12,凱基-林口,2024-02-27,9257
3615,安可,11,0,11,凱基-林口,2024-02-27,9257
4977,眾達-KY,14,3,11,凱基-林口,2024-02-27,9257
2329,華泰,222,13,209,凱基-林口,2024-02-29,9257
1522,堤維西,179,27,152,凱基-林口,2024-02-29,9257
00937B,群益ESG投等債20,146,4,142,凱基-林口,2024-02-29,9257
2331,精英,138,3,135,凱基-林口,2024-02-29,9257
00919,群益台灣精選高息,140,23,117,凱基-林口,2024-02-29,9257
2356,英業達,163,71,92,凱基-林口,2024-02-29,9257
2883B,凱基金乙特,75,7,68,凱基-林口,2024-02-29,9257
00687B,國泰20年美債,65,8,57,凱基-林口,2024-02-29,9257
00918,大華優利高填息30,77,22,55,凱基-林口,2024-02-29,9257
00753L,中信中國50正2,52,0,52,凱基-林口,2024-02-29,9257
1434,福懋,51,0,51,凱基-林口,2024-02-29,9257
00764B,群益25年美債,50,0,50,凱基-林口,2024-02-29,9257
00933B,國泰10Y+金融債,53,10,43,凱基-林口,2024-02-29,9257
4161,聿新科,43,0,43,凱基-林口,2024-02-29,9257
1711,永光,42,1,41,凱基-林口,2024-02-29,9257
2303,聯電,33,4,29,凱基-林口,2024-02-29,9257
4977,眾達-KY,26,2,24,凱基-林口,2024-02-29,9257
6122,擎邦,23,0,23,凱基-林口,2024-02-29,9257
3516,亞帝歐,22,0,22,凱基-林口,2024-02-29,9257
8050,廣積,28,6,22,凱基-林口,2024-02-29,9257
00934,中信成長高股息,21,0,21,凱基-林口,2024-02-29,9257
6288,聯嘉,21,0,21,凱基-林口,2024-02-29,9257
5531,鄉林,20,0,20,凱基-林口,2024-02-29,9257
5452,佶優,21,4,17,凱基-林口,2024-02-29,9257
2363,矽統,30,16,14,凱基-林口,2024-02-29,9257
3055,蔚華科,18,4,14,凱基-林口,2024-02-29,9257
6438,迅得,18,4,14,凱基-林口,2024-02-29,9257
1503,士電,93,80,13,凱基-林口,2024-02-29,9257
2109,華豐,13,0,13,凱基-林口,2024-02-29,9257
1618,合機,20,8,12,凱基-林口,2024-02-29,9257
3014,聯陽,172,160,12,凱基-林口,2024-02-29,9257
3227,原相,12,0,12,凱基-林口,2024-02-29,9257
2412,中華電,11,0,11,凱基-林口,2024-02-29,9257
1101,台泥,13,2,11,凱基-林口,2024-02-29,9257
2353,宏��,11,0,11,凱基-林口,2024-02-29,9257
2371,大同,30,19,11,凱基-林口,2024-02-29,9257
2634,漢翔,30,19,11,凱基-林口,2024-02-29,9257
4953,緯軟,11,0,11,凱基-林口,2024-02-29,9257
5608,四維航,12,1,11,凱基-林口,2024-02-29,9257
8027,鈦昇,11,1,10,凱基-林口,2024-02-29,9257
2409,友達,15,5,10,凱基-林口,2024-02-29,9257
00935,野村臺灣新科技50,10,0,10,凱基-林口,2024-02-29,9257
00664R,國泰臺灣加權反1,10,0,10,凱基-林口,2024-02-29,9257
00891,中信關鍵半導體,10,0,10,凱基-林口,2024-02-29,9257
2340,台亞,11,1,10,凱基-林口,2024-02-29,9257
2820,華票,10,0,10,凱基-林口,2024-02-29,9257
5309,系統電,10,0,10,凱基-林口,2024-02-29,9257
9934,成霖,10,0,10,凱基-林口,2024-02-29,9257
9940,信義,10,0,10,凱基-林口,2024-02-29,9257
00751B,元大AAA至A公司債,10,0,10,凱基-林口,2024-02-29,9257
2329,華泰,785,10,775,凱基-林口,2024-03-01,9257
00919,群益台灣精選高息,326,18,308,凱基-林口,2024-03-01,9257
00680L,元大美債20正2,297,0,297,凱基-林口,2024-03-01,9257
1609,大亞,80,13,67,凱基-林口,2024-03-01,9257
3338,泰碩,65,2,63,凱基-林口,2024-03-01,9257
00933B,國泰10Y+金融債,55,1,54,凱基-林口,2024-03-01,9257
3390,旭軟,49,0,49,凱基-林口,2024-03-01,9257
6691,洋基工程,51,5,46,凱基-林口,2024-03-01,9257
2834,臺企銀,45,4,41,凱基-林口,2024-03-01,9257
1522,堤維西,43,2,41,凱基-林口,2024-03-01,9257
3036,文曄,52,18,34,凱基-林口,2024-03-01,9257
00882,中信中國高股息,31,0,31,凱基-林口,2024-03-01,9257
00918,大華優利高填息30,29,2,27,凱基-林口,2024-03-01,9257
3163,波若威,22,0,22,凱基-林口,2024-03-01,9257
3055,蔚華科,70,49,21,凱基-林口,2024-03-01,9257
6122,擎邦,20,1,19,凱基-林口,2024-03-01,9257
2371,大同,49,31,18,凱基-林口,2024-03-01,9257
1316,上曜,83,65,18,凱基-林口,2024-03-01,9257
6770,力積電,21,4,17,凱基-林口,2024-03-01,9257
2409,友達,16,0,16,凱基-林口,2024-03-01,9257
8182,加高,16,0,16,凱基-林口,2024-03-01,9257
3481,群創,15,0,15,凱基-林口,2024-03-01,9257
00650L,復華香港正2,15,0,15,凱基-林口,2024-03-01,9257
2387,精元,15,0,15,凱基-林口,2024-03-01,9257
2426,鼎元,14,0,14,凱基-林口,2024-03-01,9257
3028,增你強,13,0,13,凱基-林口,2024-03-01,9257
3058,立德,15,2,13,凱基-林口,2024-03-01,9257
5469,瀚宇博,20,7,13,凱基-林口,2024-03-01,9257
2344,華邦電,13,1,12,凱基-林口,2024-03-01,9257
1303,南亞,12,0,12,凱基-林口,2024-03-01,9257
3044,健鼎,19,7,12,凱基-林口,2024-03-01,9257
6148,驊宏資,12,0,12,凱基-林口,2024-03-01,9257
6233,旺玖,13,1,12,凱基-林口,2024-03-01,9257
3360,尚立,36,25,11,凱基-林口,2024-03-01,9257
2615,萬海,12,1,11,凱基-林口,2024-03-01,9257
6150,撼訊,12,1,11,凱基-林口,2024-03-01,9257
00706L,期元大S＆P日圓正2,10,0,10,凱基-林口,2024-03-01,9257
00639,富邦深100,10,0,10,凱基-林口,2024-03-01,9257
1727,中華化,10,0,10,凱基-林口,2024-03-01,9257
2408,南亞科,12,2,10,凱基-林口,2024-03-01,9257
2460,建通,11,1,10,凱基-林口,2024-03-01,9257
4303,信立,30,20,10,凱基-林口,2024-03-01,9257
5309,系統電,10,0,10,凱基-林口,2024-03-01,9257
6546,正基,10,0,10,凱基-林口,2024-03-01,9257
8027,鈦昇,11,1,10,凱基-林口,2024-03-01,9257
00922,國泰台灣領袖50,10,1,9,凱基-林口,2024-03-01,9257
00632R,元大台灣50反1,8,0,8,凱基-林口,2024-03-01,9257
0056,元大高股息,8,0,8,凱基-林口,2024-03-01,9257
2405,輔信,12,4,8,凱基-林口,2024-03-01,9257
3701,大眾控,11,3,8,凱基-林口,2024-03-01,9257
2356,英業達,909,60,849,凱基-林口,2024-03-04,9257
6015,宏遠證,202,0,202,凱基-林口,2024-03-04,9257
3062,建漢,160,0,160,凱基-林口,2024-03-04,9257
1609,大亞,72,4,68,凱基-林口,2024-03-04,9257
00935,野村臺灣新科技50,62,0,62,凱基-林口,2024-03-04,9257
2543,皇昌,60,0,60,凱基-林口,2024-03-04,9257
2329,華泰,67,14,53,凱基-林口,2024-03-04,9257
00919,群益台灣精選高息,66,13,53,凱基-林口,2024-03-04,9257
00933B,國泰10Y+金融債,51,1,50,凱基-林口,2024-03-04,9257
00937B,群益ESG投等債20,46,0,46,凱基-林口,2024-03-04,9257
2331,精英,50,7,43,凱基-林口,2024-03-04,9257
3128,昇銳,41,3,38,凱基-林口,2024-03-04,9257
6127,九豪,43,10,33,凱基-林口,2024-03-04,9257
00878,國泰永續高股息,55,29,26,凱基-林口,2024-03-04,9257
2637,慧洋-KY,31,6,25,凱基-林口,2024-03-04,9257
2421,建準,36,13,23,凱基-林口,2024-03-04,9257
3034,聯詠,22,0,22,凱基-林口,2024-03-04,9257
00679B,元大美債20年,22,0,22,凱基-林口,2024-03-04,9257
2376,技嘉,50,30,20,凱基-林口,2024-03-04,9257
1528,恩德,20,0,20,凱基-林口,2024-03-04,9257
2892,第一金,20,0,20,凱基-林口,2024-03-04,9257
6803,崑鼎,20,1,19,凱基-林口,2024-03-04,9257
00918,大華優利高填息30,19,0,19,凱基-林口,2024-03-04,9257
6233,旺玖,20,2,18,凱基-林口,2024-03-04,9257
3005,神基,122,105,17,凱基-林口,2024-03-04,9257
00915,凱基優選高股息30,20,3,17,凱基-林口,2024-03-04,9257
3548,兆利,26,9,17,凱基-林口,2024-03-04,9257
00687B,國泰20年美債,17,1,16,凱基-林口,2024-03-04,9257
5347,世界,17,2,15,凱基-林口,2024-03-04,9257
3006,晶豪科,32,19,13,凱基-林口,2024-03-04,9257
2379,瑞昱,13,0,13,凱基-林口,2024-03-04,9257
2426,鼎元,15,2,13,凱基-林口,2024-03-04,9257
4303,信立,14,1,13,凱基-林口,2024-03-04,9257
1603,華電,12,0,12,凱基-林口,2024-03-04,9257
6182,合晶,12,0,12,凱基-林口,2024-03-04,9257
1316,上曜,13,1,12,凱基-林口,2024-03-04,9257
1446,宏和,11,0,11,凱基-林口,2024-03-04,9257
5213,亞昕,11,0,11,凱基-林口,2024-03-04,9257
6547,高端疫苗,11,0,11,凱基-林口,2024-03-04,9257
9941,裕融,10,0,10,凱基-林口,2024-03-04,9257
2634,漢翔,11,1,10,凱基-林口,2024-03-04,9257
00637L,元大滬深300正2,10,0,10,凱基-林口,2024-03-04,9257
1326,台化,10,0,10,凱基-林口,2024-03-04,9257
1710,東聯,10,0,10,凱基-林口,2024-03-04,9257
2464,盟立,10,0,10,凱基-林口,2024-03-04,9257
2481,強茂,10,0,10,凱基-林口,2024-03-04,9257
2630,亞航,10,0,10,凱基-林口,2024-03-04,9257
3516,亞帝歐,10,0,10,凱基-林口,2024-03-04,9257
4183,福永生技,10,0,10,凱基-林口,2024-03-04,9257
4939,亞電,11,1,10,凱基-林口,2024-03-04,9257
00919,群益台灣精選高息,204,3,201,凱基-林口,2024-03-05,9257
1522,堤維西,142,2,140,凱基-林口,2024-03-05,9257
3062,建漢,70,0,70,凱基-林口,2024-03-05,9257
00937B,群益ESG投等債20,71,5,66,凱基-林口,2024-03-05,9257
00764B,群益25年美債,56,0,56,凱基-林口,2024-03-05,9257
00687B,國泰20年美債,55,5,50,凱基-林口,2024-03-05,9257
2356,英業達,63,16,47,凱基-林口,2024-03-05,9257
6290,良維,54,7,47,凱基-林口,2024-03-05,9257
1609,大亞,51,5,46,凱基-林口,2024-03-05,9257
8097,常珵,40,0,40,凱基-林口,2024-03-05,9257
3481,群創,83,45,38,凱基-林口,2024-03-05,9257
00929,復華台灣科技優息,48,14,34,凱基-林口,2024-03-05,9257
00915,凱基優選高股息30,34,0,34,凱基-林口,2024-03-05,9257
2888,新光金,31,0,31,凱基-林口,2024-03-05,9257
2481,強茂,30,0,30,凱基-林口,2024-03-05,9257
00918,大華優利高填息30,33,5,28,凱基-林口,2024-03-05,9257
00637L,元大滬深300正2,52,25,27,凱基-林口,2024-03-05,9257
2353,宏��,25,0,25,凱基-林口,2024-03-05,9257
4729,熒茂,25,0,25,凱基-林口,2024-03-05,9257
2834,臺企銀,27,5,22,凱基-林口,2024-03-05,9257
1568,倉佑,20,0,20,凱基-林口,2024-03-05,9257
3049,精金,20,0,20,凱基-林口,2024-03-05,9257
2368,金像電,21,4,17,凱基-林口,2024-03-05,9257
1409,新纖,19,2,17,凱基-林口,2024-03-05,9257
2886,兆豐金,20,5,15,凱基-林口,2024-03-05,9257
1303,南亞,15,0,15,凱基-林口,2024-03-05,9257
00935,野村臺灣新科技50,15,0,15,凱基-林口,2024-03-05,9257
2460,建通,15,0,15,凱基-林口,2024-03-05,9257
2409,友達,15,1,14,凱基-林口,2024-03-05,9257
2417,圓剛,15,1,14,凱基-林口,2024-03-05,9257
2609,陽明,15,1,14,凱基-林口,2024-03-05,9257
2349,錸德,12,0,12,凱基-林口,2024-03-05,9257
1795,美時,12,1,11,凱基-林口,2024-03-05,9257
3105,穩懋,12,1,11,凱基-林口,2024-03-05,9257
6120,達運,11,0,11,凱基-林口,2024-03-05,9257
1503,士電,18,8,10,凱基-林口,2024-03-05,9257
2338,光罩,10,0,10,凱基-林口,2024-03-05,9257
2483,百容,10,0,10,凱基-林口,2024-03-05,9257
3090,日電貿,10,0,10,凱基-林口,2024-03-05,9257
3221,台嘉碩,10,0,10,凱基-林口,2024-03-05,9257
3663,鑫科,10,0,10,凱基-林口,2024-03-05,9257
4207,環泰,10,0,10,凱基-林口,2024-03-05,9257
4942,嘉彰,10,0,10,凱基-林口,2024-03-05,9257
5522,遠雄,10,0,10,凱基-林口,2024-03-05,9257
6227,茂綸,11,1,10,凱基-林口,2024-03-05,9257
8064,東捷,11,1,10,凱基-林口,2024-03-05,9257
8070,長華*,10,0,10,凱基-林口,2024-03-05,9257
8054,安國,18,9,9,凱基-林口,2024-03-05,9257
2605,新興,10,1,9,凱基-林口,2024-03-05,9257
00772B,中信高評級公司債,9,0,9,凱基-林口,2024-03-05,9257
00679B,元大美債20年,776,6,770,凱基-林口,2024-03-06,9257
00680L,元大美債20正2,501,0,501,凱基-林口,2024-03-06,9257
00937B,群益ESG投等債20,301,22,279,凱基-林口,2024-03-06,9257
3481,群創,166,25,141,凱基-林口,2024-03-06,9257
00919,群益台灣精選高息,139,27,112,凱基-林口,2024-03-06,9257
6015,宏遠證,110,3,107,凱基-林口,2024-03-06,9257
4906,正文,65,5,60,凱基-林口,2024-03-06,9257
5498,凱崴,43,0,43,凱基-林口,2024-03-06,9257
3221,台嘉碩,35,0,35,凱基-林口,2024-03-06,9257
5388,中磊,35,1,34,凱基-林口,2024-03-06,9257
5213,亞昕,31,0,31,凱基-林口,2024-03-06,9257
1589,永冠-KY,30,0,30,凱基-林口,2024-03-06,9257
2405,輔信,32,2,30,凱基-林口,2024-03-06,9257
00918,大華優利高填息30,29,1,28,凱基-林口,2024-03-06,9257
2481,強茂,26,0,26,凱基-林口,2024-03-06,9257
6117,迎廣,65,39,26,凱基-林口,2024-03-06,9257
00915,凱基優選高股息30,28,3,25,凱基-林口,2024-03-06,9257
3032,偉訓,25,2,23,凱基-林口,2024-03-06,9257
2618,長榮航,25,2,23,凱基-林口,2024-03-06,9257
1432,大魯閣,22,0,22,凱基-林口,2024-03-06,9257
00632R,元大台灣50反1,21,0,21,凱基-林口,2024-03-06,9257
2356,英業達,22,1,21,凱基-林口,2024-03-06,9257
2883,凱基金,31,10,21,凱基-林口,2024-03-06,9257
4960,誠美材,19,0,19,凱基-林口,2024-03-06,9257
00900,富邦特選高股息30,20,2,18,凱基-林口,2024-03-06,9257
1303,南亞,18,0,18,凱基-林口,2024-03-06,9257
4533,協易機,20,3,17,凱基-林口,2024-03-06,9257
2002,中鋼,20,4,16,凱基-林口,2024-03-06,9257
2329,華泰,16,0,16,凱基-林口,2024-03-06,9257
2206,三陽工業,30,15,15,凱基-林口,2024-03-06,9257
3339,泰谷,15,0,15,凱基-林口,2024-03-06,9257
3631,晟楠,14,0,14,凱基-林口,2024-03-06,9257
8011,台通,21,7,14,凱基-林口,2024-03-06,9257
2882,國泰金,13,0,13,凱基-林口,2024-03-06,9257
1301,台塑,14,1,13,凱基-林口,2024-03-06,9257
6163,華電網,25,12,13,凱基-林口,2024-03-06,9257
1591,駿吉-KY,12,0,12,凱基-林口,2024-03-06,9257
2352,佳世達,12,0,12,凱基-林口,2024-03-06,9257
6125,廣運,51,40,11,凱基-林口,2024-03-06,9257
2303,聯電,16,5,11,凱基-林口,2024-03-06,9257
3483,力致,11,0,11,凱基-林口,2024-03-06,9257
5309,系統電,11,0,11,凱基-林口,2024-03-06,9257
2353,宏��,12,1,11,凱基-林口,2024-03-06,9257
3037,欣興,11,0,11,凱基-林口,2024-03-06,9257
3035,智原,21,11,10,凱基-林口,2024-03-06,9257
00650L,復華香港正2,10,0,10,凱基-林口,2024-03-06,9257
00830,國泰費城半導體,10,0,10,凱基-林口,2024-03-06,9257
00713,元大台灣高息低波,10,0,10,凱基-林口,2024-03-06,9257
3005,神基,18,8,10,凱基-林口,2024-03-06,9257
6127,九豪,20,10,10,凱基-林口,2024-03-06,9257
00937B,群益ESG投等債20,305,0,305,凱基-林口,2024-03-07,9257
00753L,中信中國50正2,260,0,260,凱基-林口,2024-03-07,9257
00665L,富邦�琤肭磪囓�2,200,0,200,凱基-林口,2024-03-07,9257
00706L,期元大S＆P日圓正2,100,0,100,凱基-林口,2024-03-07,9257
2618,長榮航,104,39,65,凱基-林口,2024-03-07,9257
00679B,元大美債20年,67,4,63,凱基-林口,2024-03-07,9257
5530,龍巖,60,0,60,凱基-林口,2024-03-07,9257
00632R,元大台灣50反1,60,1,59,凱基-林口,2024-03-07,9257
4161,聿新科,57,0,57,凱基-林口,2024-03-07,9257
1815,富喬,100,48,52,凱基-林口,2024-03-07,9257
00687B,國泰20年美債,52,4,48,凱基-林口,2024-03-07,9257
1605,華新,50,2,48,凱基-林口,2024-03-07,9257
1303,南亞,43,0,43,凱基-林口,2024-03-07,9257
2845,遠東銀,74,31,43,凱基-林口,2024-03-07,9257
2324,仁寶,41,1,40,凱基-林口,2024-03-07,9257
1609,大亞,37,2,35,凱基-林口,2024-03-07,9257
3169,亞信,39,7,32,凱基-林口,2024-03-07,9257
3450,聯鈞,38,6,32,凱基-林口,2024-03-07,9257
3033,威健,30,0,30,凱基-林口,2024-03-07,9257
4532,瑞智,30,0,30,凱基-林口,2024-03-07,9257
00680L,元大美債20正2,30,1,29,凱基-林口,2024-03-07,9257
1316,上曜,31,2,29,凱基-林口,2024-03-07,9257
00915,凱基優選高股息30,54,26,28,凱基-林口,2024-03-07,9257
2340,台亞,30,6,24,凱基-林口,2024-03-07,9257
6120,達運,25,1,24,凱基-林口,2024-03-07,9257
5213,亞昕,20,0,20,凱基-林口,2024-03-07,9257
1455,集盛,20,0,20,凱基-林口,2024-03-07,9257
2883B,凱基金乙特,20,0,20,凱基-林口,2024-03-07,9257
6127,九豪,20,0,20,凱基-林口,2024-03-07,9257
3564,其陽,22,3,19,凱基-林口,2024-03-07,9257
6770,力積電,20,2,18,凱基-林口,2024-03-07,9257
6282,康舒,17,0,17,凱基-林口,2024-03-07,9257
00830,國泰費城半導體,15,0,15,凱基-林口,2024-03-07,9257
2313,華通,30,15,15,凱基-林口,2024-03-07,9257
3147,大綜,18,3,15,凱基-林口,2024-03-07,9257
2204,中華,15,0,15,凱基-林口,2024-03-07,9257
3231,緯創,21,7,14,凱基-林口,2024-03-07,9257
2101,南港,18,4,14,凱基-林口,2024-03-07,9257
2368,金像電,18,5,13,凱基-林口,2024-03-07,9257
2464,盟立,13,0,13,凱基-林口,2024-03-07,9257
4906,正文,15,2,13,凱基-林口,2024-03-07,9257
5309,系統電,13,0,13,凱基-林口,2024-03-07,9257
5469,瀚宇博,13,0,13,凱基-林口,2024-03-07,9257
6202,盛群,13,0,13,凱基-林口,2024-03-07,9257
2603,長榮,22,10,12,凱基-林口,2024-03-07,9257
3044,健鼎,40,28,12,凱基-林口,2024-03-07,9257
3540,曜越,17,5,12,凱基-林口,2024-03-07,9257
5425,台半,12,0,12,凱基-林口,2024-03-07,9257
8215,明基材,12,0,12,凱基-林口,2024-03-07,9257
2409,友達,12,1,11,凱基-林口,2024-03-07,9257
00922,國泰台灣領袖50,303,42,261,凱基-林口,2024-03-08,9257
00632R,元大台灣50反1,175,0,175,凱基-林口,2024-03-08,9257
2331,精英,163,0,163,凱基-林口,2024-03-08,9257
1303,南亞,113,4,109,凱基-林口,2024-03-08,9257
00937B,群益ESG投等債20,353,245,108,凱基-林口,2024-03-08,9257
2303,聯電,367,267,100,凱基-林口,2024-03-08,9257
00665L,富邦�琤肭磪囓�2,100,0,100,凱基-林口,2024-03-08,9257
1522,堤維西,98,1,97,凱基-林口,2024-03-08,9257
2409,友達,107,18,89,凱基-林口,2024-03-08,9257
00915,凱基優選高股息30,99,26,73,凱基-林口,2024-03-08,9257
00687B,國泰20年美債,112,43,69,凱基-林口,2024-03-08,9257
6664,群翊,55,0,55,凱基-林口,2024-03-08,9257
2367,燿華,64,21,43,凱基-林口,2024-03-08,9257
4161,聿新科,43,0,43,凱基-林口,2024-03-08,9257
2020,美亞,39,0,39,凱基-林口,2024-03-08,9257
2460,建通,44,10,34,凱基-林口,2024-03-08,9257
2603,長榮,41,10,31,凱基-林口,2024-03-08,9257
00918,大華優利高填息30,30,0,30,凱基-林口,2024-03-08,9257
2025,千興,30,0,30,凱基-林口,2024-03-08,9257
3033,威健,30,0,30,凱基-林口,2024-03-08,9257
3706,神達,53,24,29,凱基-林口,2024-03-08,9257
2449,京元電子,69,41,28,凱基-林口,2024-03-08,9257
9902,台火,32,7,25,凱基-林口,2024-03-08,9257
2610,華航,26,2,24,凱基-林口,2024-03-08,9257
3669,圓展,23,0,23,凱基-林口,2024-03-08,9257
2344,華邦電,36,14,22,凱基-林口,2024-03-08,9257
5469,瀚宇博,22,0,22,凱基-林口,2024-03-08,9257
6288,聯嘉,21,0,21,凱基-林口,2024-03-08,9257
2323,中環,20,0,20,凱基-林口,2024-03-08,9257
3055,蔚華科,30,10,20,凱基-林口,2024-03-08,9257
5213,亞昕,20,0,20,凱基-林口,2024-03-08,9257
8097,常珵,20,0,20,凱基-林口,2024-03-08,9257
2109,華豐,20,2,18,凱基-林口,2024-03-08,9257
4576,大銀微系統,18,0,18,凱基-林口,2024-03-08,9257
2488,漢平,18,1,17,凱基-林口,2024-03-08,9257
4960,誠美材,17,0,17,凱基-林口,2024-03-08,9257
1314,中石化,19,3,16,凱基-林口,2024-03-08,9257
3481,群創,31,16,15,凱基-林口,2024-03-08,9257
3548,兆利,44,29,15,凱基-林口,2024-03-08,9257
1513,中興電,48,33,15,凱基-林口,2024-03-08,9257
6143,振曜,14,0,14,凱基-林口,2024-03-08,9257
4420,光明,13,0,13,凱基-林口,2024-03-08,9257
5443,均豪,13,0,13,凱基-林口,2024-03-08,9257
3715,定穎投控,14,1,13,凱基-林口,2024-03-08,9257
4968,立積,18,6,12,凱基-林口,2024-03-08,9257
1316,上曜,12,0,12,凱基-林口,2024-03-08,9257
1808,潤隆,12,0,12,凱基-林口,2024-03-08,9257
3021,鴻名,15,3,12,凱基-林口,2024-03-08,9257
3712,永崴投控,20,8,12,凱基-林口,2024-03-08,9257
6284,佳邦,17,5,12,凱基-林口,2024-03-08,9257
00919,群益台灣精選高息,445,9,436,凱基-林口,2024-03-11,9257
5515,建國,292,1,291,凱基-林口,2024-03-11,9257
2331,精英,135,0,135,凱基-林口,2024-03-11,9257
00922,國泰台灣領袖50,105,0,105,凱基-林口,2024-03-11,9257
3706,神達,133,31,102,凱基-林口,2024-03-11,9257
00937B,群益ESG投等債20,136,40,96,凱基-林口,2024-03-11,9257
1522,堤維西,69,4,65,凱基-林口,2024-03-11,9257
2002,中鋼,55,2,53,凱基-林口,2024-03-11,9257
2303,聯電,63,10,53,凱基-林口,2024-03-11,9257
00929,復華台灣科技優息,142,104,38,凱基-林口,2024-03-11,9257
00915,凱基優選高股息30,48,12,36,凱基-林口,2024-03-11,9257
5530,龍巖,35,0,35,凱基-林口,2024-03-11,9257
5469,瀚宇博,30,0,30,凱基-林口,2024-03-11,9257
6122,擎邦,29,4,25,凱基-林口,2024-03-11,9257
00687B,國泰20年美債,37,16,21,凱基-林口,2024-03-11,9257
1815,富喬,25,4,21,凱基-林口,2024-03-11,9257
2888,新光金,20,0,20,凱基-林口,2024-03-11,9257
6285,啟��,20,0,20,凱基-林口,2024-03-11,9257
00680L,元大美債20正2,20,0,20,凱基-林口,2024-03-11,9257
1316,上曜,25,5,20,凱基-林口,2024-03-11,9257
2820,華票,20,0,20,凱基-林口,2024-03-11,9257
6616,特昇-KY,20,0,20,凱基-林口,2024-03-11,9257
3227,原相,20,1,19,凱基-林口,2024-03-11,9257
1240,茂生農經,18,0,18,凱基-林口,2024-03-11,9257
2330,台積電,21,4,17,凱基-林口,2024-03-11,9257
3035,智原,15,0,15,凱基-林口,2024-03-11,9257
2338,光罩,15,0,15,凱基-林口,2024-03-11,9257
8349,�矬�,15,0,15,凱基-林口,2024-03-11,9257
00757,統一FANG+,16,2,14,凱基-林口,2024-03-11,9257
2603,長榮,16,2,14,凱基-林口,2024-03-11,9257
00878,國泰永續高股息,55,42,13,凱基-林口,2024-03-11,9257
2890,永豐金,12,0,12,凱基-林口,2024-03-11,9257
3014,聯陽,11,0,11,凱基-林口,2024-03-11,9257
2020,美亞,11,0,11,凱基-林口,2024-03-11,9257
00935,野村臺灣新科技50,11,0,11,凱基-林口,2024-03-11,9257
00712,復華富時不動產,10,0,10,凱基-林口,2024-03-11,9257
2457,飛宏,11,1,10,凱基-林口,2024-03-11,9257
00686R,群益臺灣加權反1,10,0,10,凱基-林口,2024-03-11,9257
1473,台南,10,0,10,凱基-林口,2024-03-11,9257
1736,喬山,10,0,10,凱基-林口,2024-03-11,9257
2427,三商電,10,0,10,凱基-林口,2024-03-11,9257
2613,中櫃,10,0,10,凱基-林口,2024-03-11,9257
2809,京城銀,10,0,10,凱基-林口,2024-03-11,9257
3360,尚立,10,0,10,凱基-林口,2024-03-11,9257
6198,瑞築,10,0,10,凱基-林口,2024-03-11,9257
6443,元晶,10,0,10,凱基-林口,2024-03-11,9257
8027,鈦昇,10,0,10,凱基-林口,2024-03-11,9257
8150,南茂,10,0,10,凱基-林口,2024-03-11,9257
2462,良得電,9,0,9,凱基-林口,2024-03-11,9257
2834,臺企銀,12,3,9,凱基-林口,2024-03-11,9257
2610,華航,514,1,513,凱基-林口,2024-03-12,9257
00632R,元大台灣50反1,491,14,477,凱基-林口,2024-03-12,9257
5515,建國,380,2,378,凱基-林口,2024-03-12,9257
00937B,群益ESG投等債20,228,2,226,凱基-林口,2024-03-12,9257
2313,華通,142,56,86,凱基-林口,2024-03-12,9257
00637L,元大滬深300正2,90,10,80,凱基-林口,2024-03-12,9257
00911,兆豐洲際半導體,75,0,75,凱基-林口,2024-03-12,9257
00665L,富邦�琤肭磪囓�2,75,0,75,凱基-林口,2024-03-12,9257
00687B,國泰20年美債,88,15,73,凱基-林口,2024-03-12,9257
4161,聿新科,72,0,72,凱基-林口,2024-03-12,9257
00764B,群益25年美債,70,0,70,凱基-林口,2024-03-12,9257
3356,奇偶,42,0,42,凱基-林口,2024-03-12,9257
3033,威健,40,0,40,凱基-林口,2024-03-12,9257
2383,台光電,37,0,37,凱基-林口,2024-03-12,9257
2880,華南金,30,0,30,凱基-林口,2024-03-12,9257
8476,台境*,30,0,30,凱基-林口,2024-03-12,9257
1240,茂生農經,27,0,27,凱基-林口,2024-03-12,9257
6122,擎邦,24,0,24,凱基-林口,2024-03-12,9257
6806,森崴能源,26,2,24,凱基-林口,2024-03-12,9257
1815,富喬,25,2,23,凱基-林口,2024-03-12,9257
2888,新光金,23,1,22,凱基-林口,2024-03-12,9257
2301,光寶科,21,0,21,凱基-林口,2024-03-12,9257
00902,中信電池及儲能,23,3,20,凱基-林口,2024-03-12,9257
1535,中宇,20,0,20,凱基-林口,2024-03-12,9257
4960,誠美材,20,0,20,凱基-林口,2024-03-12,9257
6616,特昇-KY,20,0,20,凱基-林口,2024-03-12,9257
1519,華城,20,3,17,凱基-林口,2024-03-12,9257
4961,天鈺,27,10,17,凱基-林口,2024-03-12,9257
2883,凱基金,49,33,16,凱基-林口,2024-03-12,9257
3481,群創,17,2,15,凱基-林口,2024-03-12,9257
1710,東聯,15,0,15,凱基-林口,2024-03-12,9257
3511,矽瑪,15,0,15,凱基-林口,2024-03-12,9257
2352,佳世達,14,0,14,凱基-林口,2024-03-12,9257
00915,凱基優選高股息30,13,0,13,凱基-林口,2024-03-12,9257
2732,六角,20,7,13,凱基-林口,2024-03-12,9257
4906,正文,13,0,13,凱基-林口,2024-03-12,9257
1402,遠東新,12,0,12,凱基-林口,2024-03-12,9257
2344,華邦電,13,1,12,凱基-林口,2024-03-12,9257
2408,南亞科,12,0,12,凱基-林口,2024-03-12,9257
2645,長榮航太,13,1,12,凱基-林口,2024-03-12,9257
2883B,凱基金乙特,12,0,12,凱基-林口,2024-03-12,9257
2886,兆豐金,12,1,11,凱基-林口,2024-03-12,9257
3221,台嘉碩,11,0,11,凱基-林口,2024-03-12,9257
3564,其陽,16,5,11,凱基-林口,2024-03-12,9257
00650L,復華香港正2,10,0,10,凱基-林口,2024-03-12,9257
2509,全坤建,10,0,10,凱基-林口,2024-03-12,9257
2601,益航,10,0,10,凱基-林口,2024-03-12,9257
2614,東森,10,0,10,凱基-林口,2024-03-12,9257
4908,前鼎,10,0,10,凱基-林口,2024-03-12,9257
5328,華容,10,0,10,凱基-林口,2024-03-12,9257
00918,大華優利高填息30,542,10,532,凱基-林口,2024-03-13,9257
00919,群益台灣精選高息,255,20,235,凱基-林口,2024-03-13,9257
5515,建國,230,0,230,凱基-林口,2024-03-13,9257
00937B,群益ESG投等債20,179,8,171,凱基-林口,2024-03-13,9257
3325,旭品,120,6,114,凱基-林口,2024-03-13,9257
00927,群益半導體收益,102,0,102,凱基-林口,2024-03-13,9257
00915,凱基優選高股息30,84,15,69,凱基-林口,2024-03-13,9257
2025,千興,56,0,56,凱基-林口,2024-03-13,9257
3005,神基,67,13,54,凱基-林口,2024-03-13,9257
4306,炎洲,51,0,51,凱基-林口,2024-03-13,9257
2313,華通,62,11,51,凱基-林口,2024-03-13,9257
00878,國泰永續高股息,51,4,47,凱基-林口,2024-03-13,9257
1522,堤維西,45,6,39,凱基-林口,2024-03-13,9257
2457,飛宏,30,0,30,凱基-林口,2024-03-13,9257
3715,定穎投控,30,1,29,凱基-林口,2024-03-13,9257
3231,緯創,64,35,29,凱基-林口,2024-03-13,9257
2812,台中銀,34,5,29,凱基-林口,2024-03-13,9257
00687B,國泰20年美債,52,25,27,凱基-林口,2024-03-13,9257
2323,中環,21,1,20,凱基-林口,2024-03-13,9257
6226,光鼎,20,0,20,凱基-林口,2024-03-13,9257
6616,特昇-KY,20,0,20,凱基-林口,2024-03-13,9257
4973,廣穎,21,2,19,凱基-林口,2024-03-13,9257
3540,曜越,21,3,18,凱基-林口,2024-03-13,9257
3704,合勤控,25,7,18,凱基-林口,2024-03-13,9257
2486,一詮,62,46,16,凱基-林口,2024-03-13,9257
4161,聿新科,26,10,16,凱基-林口,2024-03-13,9257
00751B,元大AAA至A公司債,16,0,16,凱基-林口,2024-03-13,9257
1608,華榮,20,5,15,凱基-林口,2024-03-13,9257
2516,新建,14,0,14,凱基-林口,2024-03-13,9257
3049,精金,14,0,14,凱基-林口,2024-03-13,9257
3363,上詮,15,1,14,凱基-林口,2024-03-13,9257
2383,台光電,22,8,14,凱基-林口,2024-03-13,9257
3035,智原,20,7,13,凱基-林口,2024-03-13,9257
00795B,中信美國公債20年,13,0,13,凱基-林口,2024-03-13,9257
8011,台通,53,40,13,凱基-林口,2024-03-13,9257
2353,宏��,36,23,13,凱基-林口,2024-03-13,9257
00712,復華富時不動產,23,10,13,凱基-林口,2024-03-13,9257
3013,晟銘電,12,0,12,凱基-林口,2024-03-13,9257
2201,裕隆,13,1,12,凱基-林口,2024-03-13,9257
4123,晟德,12,0,12,凱基-林口,2024-03-13,9257
6165,浪凡,12,0,12,凱基-林口,2024-03-13,9257
6233,旺玖,12,0,12,凱基-林口,2024-03-13,9257
00933B,國泰10Y+金融債,12,0,12,凱基-林口,2024-03-13,9257
2421,建準,17,6,11,凱基-林口,2024-03-13,9257
2329,華泰,12,1,11,凱基-林口,2024-03-13,9257
2363,矽統,12,1,11,凱基-林口,2024-03-13,9257
2481,強茂,10,0,10,凱基-林口,2024-03-13,9257
2495,普安,10,0,10,凱基-林口,2024-03-13,9257
2614,東森,10,0,10,凱基-林口,2024-03-13,9257
3090,日電貿,10,0,10,凱基-林口,2024-03-13,9257
00918,大華優利高填息30,333,0,333,凱基-林口,2024-03-14,9257
00919,群益台灣精選高息,299,41,258,凱基-林口,2024-03-14,9257
00688L,國泰20年美債正2,100,0,100,凱基-林口,2024-03-14,9257
2618,長榮航,104,31,73,凱基-林口,2024-03-14,9257
2801,彰銀,95,23,72,凱基-林口,2024-03-14,9257
00929,復華台灣科技優息,136,76,60,凱基-林口,2024-03-14,9257
1608,華榮,114,55,59,凱基-林口,2024-03-14,9257
3706,神達,61,6,55,凱基-林口,2024-03-14,9257
00915,凱基優選高股息30,81,30,51,凱基-林口,2024-03-14,9257
00878,國泰永續高股息,53,4,49,凱基-林口,2024-03-14,9257
00687B,國泰20年美債,46,1,45,凱基-林口,2024-03-14,9257
2883,凱基金,168,123,45,凱基-林口,2024-03-14,9257
2515,中工,42,0,42,凱基-林口,2024-03-14,9257
3014,聯陽,42,1,41,凱基-林口,2024-03-14,9257
2887,台新金,65,25,40,凱基-林口,2024-03-14,9257
2891,中信金,58,18,40,凱基-林口,2024-03-14,9257
2603,長榮,44,5,39,凱基-林口,2024-03-14,9257
2882,國泰金,47,10,37,凱基-林口,2024-03-14,9257
2356,英業達,92,55,37,凱基-林口,2024-03-14,9257
1612,宏泰,34,0,34,凱基-林口,2024-03-14,9257
6021,美好證,30,0,30,凱基-林口,2024-03-14,9257
3325,旭品,27,4,23,凱基-林口,2024-03-14,9257
2890,永豐金,24,1,23,凱基-林口,2024-03-14,9257
2354,鴻準,27,5,22,凱基-林口,2024-03-14,9257
2313,華通,27,5,22,凱基-林口,2024-03-14,9257
00679B,元大美債20年,21,0,21,凱基-林口,2024-03-14,9257
5515,建國,21,0,21,凱基-林口,2024-03-14,9257
4161,聿新科,20,0,20,凱基-林口,2024-03-14,9257
3512,皇龍,18,0,18,凱基-林口,2024-03-14,9257
1618,合機,15,0,15,凱基-林口,2024-03-14,9257
4702,中美實,15,0,15,凱基-林口,2024-03-14,9257
5201,凱衛,15,0,15,凱基-林口,2024-03-14,9257
6127,九豪,15,0,15,凱基-林口,2024-03-14,9257
2002,中鋼,27,13,14,凱基-林口,2024-03-14,9257
2449,京元電子,15,1,14,凱基-林口,2024-03-14,9257
00937B,群益ESG投等債20,73,60,13,凱基-林口,2024-03-14,9257
2105,正新,14,1,13,凱基-林口,2024-03-14,9257
6151,晉倫,13,0,13,凱基-林口,2024-03-14,9257
00930,永豐ESG低碳高息,13,0,13,凱基-林口,2024-03-14,9257
9945,潤泰新,17,5,12,凱基-林口,2024-03-14,9257
1524,耿鼎,12,0,12,凱基-林口,2024-03-14,9257
2369,菱生,12,0,12,凱基-林口,2024-03-14,9257
2020,美亞,15,3,12,凱基-林口,2024-03-14,9257
00830,國泰費城半導體,11,0,11,凱基-林口,2024-03-14,9257
00673R,期元大S＆P原油反1,11,0,11,凱基-林口,2024-03-14,9257
2489,瑞軒,11,0,11,凱基-林口,2024-03-14,9257
5498,凱崴,12,1,11,凱基-林口,2024-03-14,9257
00753L,中信中國50正2,50,40,10,凱基-林口,2024-03-14,9257
1616,億泰,12,2,10,凱基-林口,2024-03-14,9257
2303,聯電,20,10,10,凱基-林口,2024-03-14,9257
00919,群益台灣精選高息,288,66,222,凱基-林口,2024-03-15,9257
00941,中信上游半導體,232,12,220,凱基-林口,2024-03-15,9257
00918,大華優利高填息30,186,69,117,凱基-林口,2024-03-15,9257
2356,英業達,105,4,101,凱基-林口,2024-03-15,9257
00915,凱基優選高股息30,97,0,97,凱基-林口,2024-03-15,9257
2467,志聖,72,1,71,凱基-林口,2024-03-15,9257
00687B,國泰20年美債,64,2,62,凱基-林口,2024-03-15,9257
2408,南亞科,62,3,59,凱基-林口,2024-03-15,9257
00933B,國泰10Y+金融債,51,0,51,凱基-林口,2024-03-15,9257
1618,合機,50,0,50,凱基-林口,2024-03-15,9257
6122,擎邦,50,0,50,凱基-林口,2024-03-15,9257
3338,泰碩,48,1,47,凱基-林口,2024-03-15,9257
00929,復華台灣科技優息,55,16,39,凱基-林口,2024-03-15,9257
00937B,群益ESG投等債20,48,10,38,凱基-林口,2024-03-15,9257
2313,華通,35,0,35,凱基-林口,2024-03-15,9257
3481,群創,46,13,33,凱基-林口,2024-03-15,9257
00679B,元大美債20年,36,4,32,凱基-林口,2024-03-15,9257
8034,榮群,30,0,30,凱基-林口,2024-03-15,9257
2457,飛宏,30,1,29,凱基-林口,2024-03-15,9257
00922,國泰台灣領袖50,31,5,26,凱基-林口,2024-03-15,9257
00751B,元大AAA至A公司債,27,4,23,凱基-林口,2024-03-15,9257
00830,國泰費城半導體,21,0,21,凱基-林口,2024-03-15,9257
00688L,國泰20年美債正2,21,0,21,凱基-林口,2024-03-15,9257
2371,大同,21,0,21,凱基-林口,2024-03-15,9257
00882,中信中國高股息,21,1,20,凱基-林口,2024-03-15,9257
2022,聚亨,30,10,20,凱基-林口,2024-03-15,9257
6118,建達,20,0,20,凱基-林口,2024-03-15,9257
6261,久元,20,0,20,凱基-林口,2024-03-15,9257
8114,振樺電,20,0,20,凱基-林口,2024-03-15,9257
1210,大成,39,20,19,凱基-林口,2024-03-15,9257
2890,永豐金,20,1,19,凱基-林口,2024-03-15,9257
1809,中釉,16,0,16,凱基-林口,2024-03-15,9257
2615,萬海,21,5,16,凱基-林口,2024-03-15,9257
00891,中信關鍵半導體,15,0,15,凱基-林口,2024-03-15,9257
1471,首利,13,0,13,凱基-林口,2024-03-15,9257
3037,欣興,12,0,12,凱基-林口,2024-03-15,9257
00637L,元大滬深300正2,13,1,12,凱基-林口,2024-03-15,9257
00927,群益半導體收益,21,9,12,凱基-林口,2024-03-15,9257
2486,一詮,79,67,12,凱基-林口,2024-03-15,9257
4973,廣穎,12,0,12,凱基-林口,2024-03-15,9257
4989,榮科,12,0,12,凱基-林口,2024-03-15,9257
8011,台通,12,0,12,凱基-林口,2024-03-15,9257
2882,國泰金,16,5,11,凱基-林口,2024-03-15,9257
2636,台驊控股,15,4,11,凱基-林口,2024-03-15,9257
1815,富喬,11,0,11,凱基-林口,2024-03-15,9257
2641,正德,11,0,11,凱基-林口,2024-03-15,9257
2889,國票金,11,0,11,凱基-林口,2024-03-15,9257
00753L,中信中國50正2,10,0,10,凱基-林口,2024-03-15,9257
2645,長榮航太,13,3,10,凱基-林口,2024-03-15,9257
2838,聯邦銀,10,0,10,凱基-林口,2024-03-15,9257
1522,堤維西,641,27,614,凱基-林口,2024-03-18,9257
00687B,國泰20年美債,49,0,49,凱基-林口,2024-03-18,9257
2609,陽明,50,1,49,凱基-林口,2024-03-18,9257
2834,臺企銀,43,0,43,凱基-林口,2024-03-18,9257
2885,元大金,41,0,41,凱基-林口,2024-03-18,9257
5443,均豪,45,4,41,凱基-林口,2024-03-18,9257
2356,英業達,51,13,38,凱基-林口,2024-03-18,9257
00919,群益台灣精選高息,72,37,35,凱基-林口,2024-03-18,9257
00937B,群益ESG投等債20,74,40,34,凱基-林口,2024-03-18,9257
00679B,元大美債20年,35,1,34,凱基-林口,2024-03-18,9257
2457,飛宏,35,4,31,凱基-林口,2024-03-18,9257
2301,光寶科,30,0,30,凱基-林口,2024-03-18,9257
00878,國泰永續高股息,30,1,29,凱基-林口,2024-03-18,9257
2618,長榮航,29,3,26,凱基-林口,2024-03-18,9257
5213,亞昕,25,0,25,凱基-林口,2024-03-18,9257
8034,榮群,25,0,25,凱基-林口,2024-03-18,9257
2353,宏��,30,5,25,凱基-林口,2024-03-18,9257
2890,永豐金,23,0,23,凱基-林口,2024-03-18,9257
00795B,中信美國公債20年,23,0,23,凱基-林口,2024-03-18,9257
00680L,元大美債20正2,21,0,21,凱基-林口,2024-03-18,9257
2317,鴻海,68,47,21,凱基-林口,2024-03-18,9257
4953,緯軟,20,0,20,凱基-林口,2024-03-18,9257
3033,威健,20,0,20,凱基-林口,2024-03-18,9257
3308,聯德,20,0,20,凱基-林口,2024-03-18,9257
6274,台燿,30,10,20,凱基-林口,2024-03-18,9257
5234,達興材料,20,1,19,凱基-林口,2024-03-18,9257
8054,安國,28,10,18,凱基-林口,2024-03-18,9257
6230,尼得科超眾,21,3,18,凱基-林口,2024-03-18,9257
2801,彰銀,17,0,17,凱基-林口,2024-03-18,9257
8085,福華,20,3,17,凱基-林口,2024-03-18,9257
2884,玉山金,32,16,16,凱基-林口,2024-03-18,9257
00931B,統一美債20年,17,2,15,凱基-林口,2024-03-18,9257
1101,台泥,15,0,15,凱基-林口,2024-03-18,9257
8011,台通,18,3,15,凱基-林口,2024-03-18,9257
00915,凱基優選高股息30,14,0,14,凱基-林口,2024-03-18,9257
00751B,元大AAA至A公司債,14,0,14,凱基-林口,2024-03-18,9257
2338,光罩,14,0,14,凱基-林口,2024-03-18,9257
2368,金像電,14,0,14,凱基-林口,2024-03-18,9257
2408,南亞科,17,4,13,凱基-林口,2024-03-18,9257
1402,遠東新,12,0,12,凱基-林口,2024-03-18,9257
1710,東聯,12,0,12,凱基-林口,2024-03-18,9257
2855,統一證,12,0,12,凱基-林口,2024-03-18,9257
5425,台半,15,3,12,凱基-林口,2024-03-18,9257
5521,工信,12,0,12,凱基-林口,2024-03-18,9257
2486,一詮,26,14,12,凱基-林口,2024-03-18,9257
2603,長榮,16,5,11,凱基-林口,2024-03-18,9257
2608,嘉里大榮,10,0,10,凱基-林口,2024-03-18,9257
00706L,期元大S＆P日圓正2,10,0,10,凱基-林口,2024-03-18,9257
00921,兆豐龍頭等權重,10,0,10,凱基-林口,2024-03-18,9257
2929,淘帝-KY,10,0,10,凱基-林口,2024-03-18,9257
2353,宏��,106,0,106,凱基-林口,2024-03-19,9257
00937B,群益ESG投等債20,107,9,98,凱基-林口,2024-03-19,9257
00687B,國泰20年美債,79,0,79,凱基-林口,2024-03-19,9257
2457,飛宏,51,0,51,凱基-林口,2024-03-19,9257
3047,訊舟,51,0,51,凱基-林口,2024-03-19,9257
1503,士電,65,16,49,凱基-林口,2024-03-19,9257
3041,揚智,43,1,42,凱基-林口,2024-03-19,9257
00919,群益台灣精選高息,105,69,36,凱基-林口,2024-03-19,9257
2516,新建,30,0,30,凱基-林口,2024-03-19,9257
1609,大亞,39,14,25,凱基-林口,2024-03-19,9257
00665L,富邦�琤肭磪囓�2,25,0,25,凱基-林口,2024-03-19,9257
1522,堤維西,36,13,23,凱基-林口,2024-03-19,9257
2618,長榮航,21,0,21,凱基-林口,2024-03-19,9257
00637L,元大滬深300正2,20,0,20,凱基-林口,2024-03-19,9257
00877,復華中國5G,20,0,20,凱基-林口,2024-03-19,9257
1434,福懋,20,0,20,凱基-林口,2024-03-19,9257
1618,合機,31,11,20,凱基-林口,2024-03-19,9257
1815,富喬,21,1,20,凱基-林口,2024-03-19,9257
6121,新普,20,0,20,凱基-林口,2024-03-19,9257
5515,建國,19,1,18,凱基-林口,2024-03-19,9257
2313,華通,23,6,17,凱基-林口,2024-03-19,9257
1104,環泥,15,1,14,凱基-林口,2024-03-19,9257
00878,國泰永續高股息,17,3,14,凱基-林口,2024-03-19,9257
1308,亞聚,14,0,14,凱基-林口,2024-03-19,9257
2208,台船,25,11,14,凱基-林口,2024-03-19,9257
6411,晶焱,13,0,13,凱基-林口,2024-03-19,9257
2344,華邦電,12,0,12,凱基-林口,2024-03-19,9257
2888,新光金,12,0,12,凱基-林口,2024-03-19,9257
00751B,元大AAA至A公司債,12,0,12,凱基-林口,2024-03-19,9257
2515,中工,16,4,12,凱基-林口,2024-03-19,9257
8112,至上,17,5,12,凱基-林口,2024-03-19,9257
1101,台泥,11,0,11,凱基-林口,2024-03-19,9257
2329,華泰,20,9,11,凱基-林口,2024-03-19,9257
1513,中興電,93,83,10,凱基-林口,2024-03-19,9257
00706L,期元大S＆P日圓正2,20,10,10,凱基-林口,2024-03-19,9257
2903,遠百,10,0,10,凱基-林口,2024-03-19,9257
3516,亞帝歐,10,0,10,凱基-林口,2024-03-19,9257
5521,工信,10,0,10,凱基-林口,2024-03-19,9257
6227,茂綸,10,0,10,凱基-林口,2024-03-19,9257
8926,台汽電,10,0,10,凱基-林口,2024-03-19,9257
2887,台新金,10,1,9,凱基-林口,2024-03-19,9257
00882,中信中國高股息,19,10,9,凱基-林口,2024-03-19,9257
3481,群創,10,1,9,凱基-林口,2024-03-19,9257
00941,中信上游半導體,12,3,9,凱基-林口,2024-03-19,9257
00715L,期街口布蘭特正2,10,1,9,凱基-林口,2024-03-19,9257
2890,永豐金,10,1,9,凱基-林口,2024-03-19,9257
3005,神基,68,59,9,凱基-林口,2024-03-19,9257
3665,貿聯-KY,10,1,9,凱基-林口,2024-03-19,9257
3218,大學光,9,1,8,凱基-林口,2024-03-19,9257
6176,瑞儀,11,3,8,凱基-林口,2024-03-19,9257
00939,統一台灣高息動能,880,25,855,凱基-林口,2024-03-20,9257
2885,元大金,324,0,324,凱基-林口,2024-03-20,9257
4938,和碩,260,2,258,凱基-林口,2024-03-20,9257
00919,群益台灣精選高息,289,108,181,凱基-林口,2024-03-20,9257
00878,國泰永續高股息,164,14,150,凱基-林口,2024-03-20,9257
2313,華通,121,8,113,凱基-林口,2024-03-20,9257
2834,臺企銀,114,5,109,凱基-林口,2024-03-20,9257
00937B,群益ESG投等債20,126,23,103,凱基-林口,2024-03-20,9257
8034,榮群,75,0,75,凱基-林口,2024-03-20,9257
1455,集盛,52,1,51,凱基-林口,2024-03-20,9257
2883,凱基金,50,11,39,凱基-林口,2024-03-20,9257
2618,長榮航,43,4,39,凱基-林口,2024-03-20,9257
1609,大亞,34,2,32,凱基-林口,2024-03-20,9257
2888,新光金,31,0,31,凱基-林口,2024-03-20,9257
2457,飛宏,30,3,27,凱基-林口,2024-03-20,9257
1301,台塑,38,13,25,凱基-林口,2024-03-20,9257
1446,宏和,25,0,25,凱基-林口,2024-03-20,9257
2812,台中銀,23,0,23,凱基-林口,2024-03-20,9257
00753L,中信中國50正2,20,0,20,凱基-林口,2024-03-20,9257
2495,普安,18,0,18,凱基-林口,2024-03-20,9257
2344,華邦電,22,5,17,凱基-林口,2024-03-20,9257
2486,一詮,53,36,17,凱基-林口,2024-03-20,9257
6122,擎邦,17,0,17,凱基-林口,2024-03-20,9257
2383,台光電,47,31,16,凱基-林口,2024-03-20,9257
3706,神達,63,48,15,凱基-林口,2024-03-20,9257
00687B,國泰20年美債,15,0,15,凱基-林口,2024-03-20,9257
3704,合勤控,15,0,15,凱基-林口,2024-03-20,9257
5201,凱衛,20,5,15,凱基-林口,2024-03-20,9257
3231,緯創,52,37,15,凱基-林口,2024-03-20,9257
3481,群創,24,10,14,凱基-林口,2024-03-20,9257
2002,中鋼,15,1,14,凱基-林口,2024-03-20,9257
2382,廣達,21,8,13,凱基-林口,2024-03-20,9257
00679B,元大美債20年,22,9,13,凱基-林口,2024-03-20,9257
2889,國票金,13,0,13,凱基-林口,2024-03-20,9257
5530,龍巖,13,0,13,凱基-林口,2024-03-20,9257
2634,漢翔,12,0,12,凱基-林口,2024-03-20,9257
6176,瑞儀,12,1,11,凱基-林口,2024-03-20,9257
1101,台泥,18,7,11,凱基-林口,2024-03-20,9257
00830,國泰費城半導體,10,0,10,凱基-林口,2024-03-20,9257
1217,愛之味,10,0,10,凱基-林口,2024-03-20,9257
1810,和成,10,0,10,凱基-林口,2024-03-20,9257
2014,中鴻,10,0,10,凱基-林口,2024-03-20,9257
2460,建通,10,0,10,凱基-林口,2024-03-20,9257
3707,漢磊,11,1,10,凱基-林口,2024-03-20,9257
4960,誠美材,10,0,10,凱基-林口,2024-03-20,9257
5531,鄉林,10,0,10,凱基-林口,2024-03-20,9257
5534,長虹,10,0,10,凱基-林口,2024-03-20,9257
3037,欣興,94,84,10,凱基-林口,2024-03-20,9257
2641,正德,9,0,9,凱基-林口,2024-03-20,9257
2449,京元電子,20,11,9,凱基-林口,2024-03-20,9257
2610,華航,401,15,386,凱基-林口,2024-03-21,9257
00937B,群益ESG投等債20,424,150,274,凱基-林口,2024-03-21,9257
2618,長榮航,226,15,211,凱基-林口,2024-03-21,9257
00939,統一台灣高息動能,241,57,184,凱基-林口,2024-03-21,9257
00919,群益台灣精選高息,181,35,146,凱基-林口,2024-03-21,9257
00687B,國泰20年美債,142,0,142,凱基-林口,2024-03-21,9257
00680L,元大美債20正2,120,0,120,凱基-林口,2024-03-21,9257
1522,堤維西,95,3,92,凱基-林口,2024-03-21,9257
00632R,元大台灣50反1,85,0,85,凱基-林口,2024-03-21,9257
00918,大華優利高填息30,100,23,77,凱基-林口,2024-03-21,9257
00830,國泰費城半導體,64,0,64,凱基-林口,2024-03-21,9257
2313,華通,57,2,55,凱基-林口,2024-03-21,9257
3005,神基,77,24,53,凱基-林口,2024-03-21,9257
6188,廣明,83,46,37,凱基-林口,2024-03-21,9257
2352,佳世達,35,1,34,凱基-林口,2024-03-21,9257
3163,波若威,33,3,30,凱基-林口,2024-03-21,9257
2371,大同,24,0,24,凱基-林口,2024-03-21,9257
2405,輔信,26,2,24,凱基-林口,2024-03-21,9257
6285,啟��,24,0,24,凱基-林口,2024-03-21,9257
3498,陽程,24,1,23,凱基-林口,2024-03-21,9257
3594,磐儀,23,0,23,凱基-林口,2024-03-21,9257
3041,揚智,30,8,22,凱基-林口,2024-03-21,9257
6166,凌華,22,0,22,凱基-林口,2024-03-21,9257
00720B,元大投資級公司債,21,0,21,凱基-林口,2024-03-21,9257
2538,基泰,21,0,21,凱基-林口,2024-03-21,9257
1608,華榮,20,1,19,凱基-林口,2024-03-21,9257
00637L,元大滬深300正2,20,1,19,凱基-林口,2024-03-21,9257
1303,南亞,21,3,18,凱基-林口,2024-03-21,9257
8034,榮群,17,0,17,凱基-林口,2024-03-21,9257
6191,精成科,16,0,16,凱基-林口,2024-03-21,9257
00650L,復華香港正2,15,0,15,凱基-林口,2024-03-21,9257
3230,錦明,15,0,15,凱基-林口,2024-03-21,9257
3450,聯鈞,20,5,15,凱基-林口,2024-03-21,9257
3481,群創,25,11,14,凱基-林口,2024-03-21,9257
3491,昇達科,14,0,14,凱基-林口,2024-03-21,9257
00751B,元大AAA至A公司債,14,0,14,凱基-林口,2024-03-21,9257
6244,茂迪,20,7,13,凱基-林口,2024-03-21,9257
8996,高力,24,11,13,凱基-林口,2024-03-21,9257
8435,鉅邁,16,3,13,凱基-林口,2024-03-21,9257
2301,光寶科,22,9,13,凱基-林口,2024-03-21,9257
2323,中環,12,0,12,凱基-林口,2024-03-21,9257
4123,晟德,15,3,12,凱基-林口,2024-03-21,9257
6589,台康生技,11,0,11,凱基-林口,2024-03-21,9257
2427,三商電,10,0,10,凱基-林口,2024-03-21,9257
3346,麗清,10,0,10,凱基-林口,2024-03-21,9257
4714,永捷,10,0,10,凱基-林口,2024-03-21,9257
4953,緯軟,10,0,10,凱基-林口,2024-03-21,9257
5493,三聯,15,5,10,凱基-林口,2024-03-21,9257
8088,品安,10,0,10,凱基-林口,2024-03-21,9257
4938,和碩,12,2,10,凱基-林口,2024-03-21,9257
00918,大華優利高填息30,426,1,425,凱基-林口,2024-03-22,9257
00919,群益台灣精選高息,304,47,257,凱基-林口,2024-03-22,9257
2486,一詮,311,63,248,凱基-林口,2024-03-22,9257
3706,神達,234,48,186,凱基-林口,2024-03-22,9257
00937B,群益ESG投等債20,235,53,182,凱基-林口,2024-03-22,9257
00665L,富邦�琤肭磪囓�2,150,0,150,凱基-林口,2024-03-22,9257
0056,元大高股息,144,2,142,凱基-林口,2024-03-22,9257
00939,統一台灣高息動能,140,13,127,凱基-林口,2024-03-22,9257
00679B,元大美債20年,115,5,110,凱基-林口,2024-03-22,9257
2329,華泰,79,16,63,凱基-林口,2024-03-22,9257
2353,宏��,136,88,48,凱基-林口,2024-03-22,9257
2301,光寶科,51,13,38,凱基-林口,2024-03-22,9257
3083,網龍,35,1,34,凱基-林口,2024-03-22,9257
6147,頎邦,33,0,33,凱基-林口,2024-03-22,9257
2352,佳世達,34,2,32,凱基-林口,2024-03-22,9257
2002,中鋼,42,12,30,凱基-林口,2024-03-22,9257
00927,群益半導體收益,111,81,30,凱基-林口,2024-03-22,9257
00753L,中信中國50正2,30,0,30,凱基-林口,2024-03-22,9257
00882,中信中國高股息,24,0,24,凱基-林口,2024-03-22,9257
2344,華邦電,23,0,23,凱基-林口,2024-03-22,9257
1503,士電,48,26,22,凱基-林口,2024-03-22,9257
2457,飛宏,22,0,22,凱基-林口,2024-03-22,9257
8271,宇瞻,22,0,22,凱基-林口,2024-03-22,9257
2371,大同,21,0,21,凱基-林口,2024-03-22,9257
3227,原相,20,0,20,凱基-林口,2024-03-22,9257
4123,晟德,20,0,20,凱基-林口,2024-03-22,9257
2317,鴻海,123,104,19,凱基-林口,2024-03-22,9257
1603,華電,23,4,19,凱基-林口,2024-03-22,9257
5243,乙盛-KY,19,0,19,凱基-林口,2024-03-22,9257
3498,陽程,21,3,18,凱基-林口,2024-03-22,9257
6443,元晶,32,15,17,凱基-林口,2024-03-22,9257
6213,聯茂,16,0,16,凱基-林口,2024-03-22,9257
3481,群創,22,7,15,凱基-林口,2024-03-22,9257
5498,凱崴,37,23,14,凱基-林口,2024-03-22,9257
00688L,國泰20年美債正2,13,0,13,凱基-林口,2024-03-22,9257
2354,鴻準,16,3,13,凱基-林口,2024-03-22,9257
00878,國泰永續高股息,15,3,12,凱基-林口,2024-03-22,9257
2376,技嘉,16,4,12,凱基-林口,2024-03-22,9257
6005,群益證,12,0,12,凱基-林口,2024-03-22,9257
2367,燿華,25,13,12,凱基-林口,2024-03-22,9257
8926,台汽電,12,0,12,凱基-林口,2024-03-22,9257
00645,富邦日本,11,0,11,凱基-林口,2024-03-22,9257
1446,宏和,11,0,11,凱基-林口,2024-03-22,9257
2421,建準,12,1,11,凱基-林口,2024-03-22,9257
4127,天良,11,0,11,凱基-林口,2024-03-22,9257
1434,福懋,10,0,10,凱基-林口,2024-03-22,9257
1453,大將,10,0,10,凱基-林口,2024-03-22,9257
3322,建舜電,12,2,10,凱基-林口,2024-03-22,9257
3712,永崴投控,10,0,10,凱基-林口,2024-03-22,9257
6127,九豪,10,0,10,凱基-林口,2024-03-22,9257
2356,英業達,622,375,247,凱基-林口,2024-03-25,9257
00939,統一台灣高息動能,240,5,235,凱基-林口,2024-03-25,9257
00919,群益台灣精選高息,117,15,102,凱基-林口,2024-03-25,9257
00927,群益半導體收益,100,0,100,凱基-林口,2024-03-25,9257
2329,華泰,90,1,89,凱基-林口,2024-03-25,9257
2486,一詮,170,90,80,凱基-林口,2024-03-25,9257
1609,大亞,223,148,75,凱基-林口,2024-03-25,9257
3005,神基,89,28,61,凱基-林口,2024-03-25,9257
9105,泰金寶-DR,41,0,41,凱基-林口,2024-03-25,9257
5515,建國,36,1,35,凱基-林口,2024-03-25,9257
6770,力積電,35,0,35,凱基-林口,2024-03-25,9257
3058,立德,33,0,33,凱基-林口,2024-03-25,9257
2301,光寶科,42,12,30,凱基-林口,2024-03-25,9257
00680L,元大美債20正2,29,0,29,凱基-林口,2024-03-25,9257
2834,臺企銀,30,1,29,凱基-林口,2024-03-25,9257
3706,神達,44,16,28,凱基-林口,2024-03-25,9257
1618,合機,33,6,27,凱基-林口,2024-03-25,9257
3231,緯創,34,8,26,凱基-林口,2024-03-25,9257
6120,達運,30,5,25,凱基-林口,2024-03-25,9257
2353,宏��,70,47,23,凱基-林口,2024-03-25,9257
3032,偉訓,22,0,22,凱基-林口,2024-03-25,9257
00934,中信成長高股息,21,0,21,凱基-林口,2024-03-25,9257
2543,皇昌,22,2,20,凱基-林口,2024-03-25,9257
3437,榮創,20,0,20,凱基-林口,2024-03-25,9257
3062,建漢,21,2,19,凱基-林口,2024-03-25,9257
5529,鉅陞,20,1,19,凱基-林口,2024-03-25,9257
6491,晶碩,21,3,18,凱基-林口,2024-03-25,9257
00687B,國泰20年美債,16,0,16,凱基-林口,2024-03-25,9257
4953,緯軟,15,0,15,凱基-林口,2024-03-25,9257
5530,龍巖,15,0,15,凱基-林口,2024-03-25,9257
0056,元大高股息,15,1,14,凱基-林口,2024-03-25,9257
2352,佳世達,13,0,13,凱基-林口,2024-03-25,9257
2367,燿華,28,15,13,凱基-林口,2024-03-25,9257
3035,智原,15,3,12,凱基-林口,2024-03-25,9257
00688L,國泰20年美債正2,12,0,12,凱基-林口,2024-03-25,9257
00918,大華優利高填息30,11,0,11,凱基-林口,2024-03-25,9257
1785,光洋科,12,1,11,凱基-林口,2024-03-25,9257
2338,光罩,11,0,11,凱基-林口,2024-03-25,9257
2701,萬企,11,0,11,凱基-林口,2024-03-25,9257
3017,奇鋐,14,3,11,凱基-林口,2024-03-25,9257
2303,聯電,16,6,10,凱基-林口,2024-03-25,9257
00679B,元大美債20年,26,16,10,凱基-林口,2024-03-25,9257
2399,映泰,10,0,10,凱基-林口,2024-03-25,9257
3013,晟銘電,10,0,10,凱基-林口,2024-03-25,9257
6015,宏遠證,10,0,10,凱基-林口,2024-03-25,9257
2882,國泰金,14,4,10,凱基-林口,2024-03-25,9257
00632R,元大台灣50反1,10,1,9,凱基-林口,2024-03-25,9257
2504,國產,9,1,8,凱基-林口,2024-03-25,9257
00830,國泰費城半導體,8,0,8,凱基-林口,2024-03-25,9257
2009,第一銅,9,1,8,凱基-林口,2024-03-25,9257
2486,一詮,247,7,240,凱基-林口,2024-03-26,9257
2618,長榮航,251,52,199,凱基-林口,2024-03-26,9257
2367,燿華,159,20,139,凱基-林口,2024-03-26,9257
00919,群益台灣精選高息,145,25,120,凱基-林口,2024-03-26,9257
2371,大同,103,25,78,凱基-林口,2024-03-26,9257
3706,神達,71,8,63,凱基-林口,2024-03-26,9257
2344,華邦電,61,8,53,凱基-林口,2024-03-26,9257
00878,國泰永續高股息,83,32,51,凱基-林口,2024-03-26,9257
00687B,國泰20年美債,62,20,42,凱基-林口,2024-03-26,9257
00929,復華台灣科技優息,56,17,39,凱基-林口,2024-03-26,9257
1513,中興電,56,18,38,凱基-林口,2024-03-26,9257
00937B,群益ESG投等債20,61,30,31,凱基-林口,2024-03-26,9257
8936,國統,46,15,31,凱基-林口,2024-03-26,9257
00909,國泰數位支付服務,29,0,29,凱基-林口,2024-03-26,9257
1618,合機,50,21,29,凱基-林口,2024-03-26,9257
1504,東元,37,9,28,凱基-林口,2024-03-26,9257
1514,亞力,58,36,22,凱基-林口,2024-03-26,9257
2449,京元電子,23,2,21,凱基-林口,2024-03-26,9257
2303,聯電,35,15,20,凱基-林口,2024-03-26,9257
2883,凱基金,20,0,20,凱基-林口,2024-03-26,9257
4161,聿新科,17,0,17,凱基-林口,2024-03-26,9257
8996,高力,40,23,17,凱基-林口,2024-03-26,9257
2417,圓剛,16,1,15,凱基-林口,2024-03-26,9257
3260,威剛,15,0,15,凱基-林口,2024-03-26,9257
2609,陽明,14,0,14,凱基-林口,2024-03-26,9257
3231,緯創,51,37,14,凱基-林口,2024-03-26,9257
6546,正基,14,0,14,凱基-林口,2024-03-26,9257
4576,大銀微系統,18,5,13,凱基-林口,2024-03-26,9257
8040,九暘,13,0,13,凱基-林口,2024-03-26,9257
1616,億泰,18,6,12,凱基-林口,2024-03-26,9257
6115,鎰勝,12,0,12,凱基-林口,2024-03-26,9257
6770,力積電,12,0,12,凱基-林口,2024-03-26,9257
5371,中光電,12,1,11,凱基-林口,2024-03-26,9257
6290,良維,11,0,11,凱基-林口,2024-03-26,9257
6691,洋基工程,11,0,11,凱基-林口,2024-03-26,9257
00935,野村臺灣新科技50,10,0,10,凱基-林口,2024-03-26,9257
00715L,期街口布蘭特正2,10,0,10,凱基-林口,2024-03-26,9257
00885,富邦越南,10,0,10,凱基-林口,2024-03-26,9257
020028,元大特選電動車N,10,0,10,凱基-林口,2024-03-26,9257
1587,吉茂,20,10,10,凱基-林口,2024-03-26,9257
3202,樺晟,10,0,10,凱基-林口,2024-03-26,9257
3483,力致,20,10,10,凱基-林口,2024-03-26,9257
4961,天鈺,12,2,10,凱基-林口,2024-03-26,9257
6207,雷科,10,0,10,凱基-林口,2024-03-26,9257
8112,至上,11,1,10,凱基-林口,2024-03-26,9257
00915,凱基優選高股息30,9,0,9,凱基-林口,2024-03-26,9257
6182,合晶,9,0,9,凱基-林口,2024-03-26,9257
2634,漢翔,10,1,9,凱基-林口,2024-03-26,9257
3037,欣興,15,6,9,凱基-林口,2024-03-26,9257
2308,台達電,17,8,9,凱基-林口,2024-03-26,9257
2486,一詮,217,2,215,凱基-林口,2024-03-27,9257
8011,台通,157,6,151,凱基-林口,2024-03-27,9257
5521,工信,91,3,88,凱基-林口,2024-03-27,9257
00939,統一台灣高息動能,81,1,80,凱基-林口,2024-03-27,9257
2371,大同,75,7,68,凱基-林口,2024-03-27,9257
2301,光寶科,56,0,56,凱基-林口,2024-03-27,9257
00919,群益台灣精選高息,50,9,41,凱基-林口,2024-03-27,9257
00712,復華富時不動產,34,0,34,凱基-林口,2024-03-27,9257
00720B,元大投資級公司債,30,0,30,凱基-林口,2024-03-27,9257
1808,潤隆,26,3,23,凱基-林口,2024-03-27,9257
3481,群創,28,6,22,凱基-林口,2024-03-27,9257
00937B,群益ESG投等債20,54,33,21,凱基-林口,2024-03-27,9257
2615,萬海,21,0,21,凱基-林口,2024-03-27,9257
2609,陽明,20,0,20,凱基-林口,2024-03-27,9257
2388,威盛,28,9,19,凱基-林口,2024-03-27,9257
6612,奈米醫材,17,0,17,凱基-林口,2024-03-27,9257
00929,復華台灣科技優息,61,45,16,凱基-林口,2024-03-27,9257
2457,飛宏,15,0,15,凱基-林口,2024-03-27,9257
5213,亞昕,15,0,15,凱基-林口,2024-03-27,9257
2303,聯電,16,2,14,凱基-林口,2024-03-27,9257
1609,大亞,20,6,14,凱基-林口,2024-03-27,9257
00891,中信關鍵半導體,13,0,13,凱基-林口,2024-03-27,9257
5905,南仁湖,14,1,13,凱基-林口,2024-03-27,9257
3231,緯創,17,4,13,凱基-林口,2024-03-27,9257
8996,高力,17,4,13,凱基-林口,2024-03-27,9257
6188,廣明,13,1,12,凱基-林口,2024-03-27,9257
1605,華新,17,5,12,凱基-林口,2024-03-27,9257
1513,中興電,19,7,12,凱基-林口,2024-03-27,9257
1303,南亞,12,0,12,凱基-林口,2024-03-27,9257
3025,星通,16,5,11,凱基-林口,2024-03-27,9257
3444,利機,11,0,11,凱基-林口,2024-03-27,9257
2887,台新金,13,2,11,凱基-林口,2024-03-27,9257
3376,新日興,16,5,11,凱基-林口,2024-03-27,9257
3044,健鼎,10,0,10,凱基-林口,2024-03-27,9257
2481,強茂,10,0,10,凱基-林口,2024-03-27,9257
5471,松翰,12,2,10,凱基-林口,2024-03-27,9257
8050,廣積,12,2,10,凱基-林口,2024-03-27,9257
9933,中鼎,10,0,10,凱基-林口,2024-03-27,9257
2834,臺企銀,11,1,10,凱基-林口,2024-03-27,9257
1612,宏泰,10,1,9,凱基-林口,2024-03-27,9257
2465,麗臺,13,4,9,凱基-林口,2024-03-27,9257
1316,上曜,51,43,8,凱基-林口,2024-03-27,9257
2329,華泰,10,2,8,凱基-林口,2024-03-27,9257
4961,天鈺,19,11,8,凱基-林口,2024-03-27,9257
1617,榮星,7,0,7,凱基-林口,2024-03-27,9257
2413,環科,7,0,7,凱基-林口,2024-03-27,9257
3049,精金,10,3,7,凱基-林口,2024-03-27,9257
3545,敦泰,7,0,7,凱基-林口,2024-03-27,9257
3622,洋華,7,0,7,凱基-林口,2024-03-27,9257
5210,寶碩,7,0,7,凱基-林口,2024-03-27,9257
2515,中工,227,26,201,凱基-林口,2024-03-28,9257
2356,英業達,88,8,80,凱基-林口,2024-03-28,9257
00939,統一台灣高息動能,77,6,71,凱基-林口,2024-03-28,9257
3706,神達,105,37,68,凱基-林口,2024-03-28,9257
8936,國統,63,1,62,凱基-林口,2024-03-28,9257
2301,光寶科,52,3,49,凱基-林口,2024-03-28,9257
00712,復華富時不動產,48,10,38,凱基-林口,2024-03-28,9257
2486,一詮,52,20,32,凱基-林口,2024-03-28,9257
2313,華通,31,2,29,凱基-林口,2024-03-28,9257
3005,神基,72,45,27,凱基-林口,2024-03-28,9257
2883,凱基金,386,362,24,凱基-林口,2024-03-28,9257
00931B,統一美債20年,32,10,22,凱基-林口,2024-03-28,9257
00919,群益台灣精選高息,40,20,20,凱基-林口,2024-03-28,9257
00637L,元大滬深300正2,20,0,20,凱基-林口,2024-03-28,9257
2323,中環,20,0,20,凱基-林口,2024-03-28,9257
4304,勝昱,20,0,20,凱基-林口,2024-03-28,9257
00882,中信中國高股息,19,0,19,凱基-林口,2024-03-28,9257
3022,威強電,19,0,19,凱基-林口,2024-03-28,9257
3498,陽程,19,0,19,凱基-林口,2024-03-28,9257
00687B,國泰20年美債,24,7,17,凱基-林口,2024-03-28,9257
00770,國泰北美科技,17,0,17,凱基-林口,2024-03-28,9257
8996,高力,24,7,17,凱基-林口,2024-03-28,9257
1413,宏洲,15,0,15,凱基-林口,2024-03-28,9257
2344,華邦電,16,1,15,凱基-林口,2024-03-28,9257
3673,TPK-KY,16,1,15,凱基-林口,2024-03-28,9257
5471,松翰,14,0,14,凱基-林口,2024-03-28,9257
5213,亞昕,13,0,13,凱基-林口,2024-03-28,9257
8033,雷虎,16,3,13,凱基-林口,2024-03-28,9257
1316,上曜,12,0,12,凱基-林口,2024-03-28,9257
2834,臺企銀,12,0,12,凱基-林口,2024-03-28,9257
2845,遠東銀,12,0,12,凱基-林口,2024-03-28,9257
2465,麗臺,12,1,11,凱基-林口,2024-03-28,9257
2362,藍天,11,0,11,凱基-林口,2024-03-28,9257
9945,潤泰新,10,0,10,凱基-林口,2024-03-28,9257
00650L,復華香港正2,10,0,10,凱基-林口,2024-03-28,9257
00680L,元大美債20正2,10,0,10,凱基-林口,2024-03-28,9257
1303,南亞,10,0,10,凱基-林口,2024-03-28,9257
1612,宏泰,10,0,10,凱基-林口,2024-03-28,9257
2369,菱生,10,0,10,凱基-林口,2024-03-28,9257
3419,譁裕,10,0,10,凱基-林口,2024-03-28,9257
3481,群創,11,1,10,凱基-林口,2024-03-28,9257
3710,連展投控,10,0,10,凱基-林口,2024-03-28,9257
5512,力麒,12,2,10,凱基-林口,2024-03-28,9257
5905,南仁湖,10,0,10,凱基-林口,2024-03-28,9257
8085,福華,10,0,10,凱基-林口,2024-03-28,9257
8201,無敵,10,0,10,凱基-林口,2024-03-28,9257
9934,成霖,10,0,10,凱基-林口,2024-03-28,9257
2354,鴻準,58,48,10,凱基-林口,2024-03-28,9257
5469,瀚宇博,11,2,9,凱基-林口,2024-03-28,9257
2542,興富發,10,1,9,凱基-林口,2024-03-28,9257
2356,英業達,575,219,356,凱基-林口,2024-03-29,9257
2855,統一證,268,10,258,凱基-林口,2024-03-29,9257
2486,一詮,156,6,150,凱基-林口,2024-03-29,9257
00632R,元大台灣50反1,116,5,111,凱基-林口,2024-03-29,9257
3706,神達,92,29,63,凱基-林口,2024-03-29,9257
0056,元大高股息,69,14,55,凱基-林口,2024-03-29,9257
3481,群創,101,50,51,凱基-林口,2024-03-29,9257
2543,皇昌,50,1,49,凱基-林口,2024-03-29,9257
5515,建國,45,0,45,凱基-林口,2024-03-29,9257
00687B,國泰20年美債,42,1,41,凱基-林口,2024-03-29,9257
00665L,富邦�琤肭磪囓�2,40,0,40,凱基-林口,2024-03-29,9257
2371,大同,52,13,39,凱基-林口,2024-03-29,9257
6735,美達科技,32,0,32,凱基-林口,2024-03-29,9257
2301,光寶科,51,20,31,凱基-林口,2024-03-29,9257
2613,中櫃,30,0,30,凱基-林口,2024-03-29,9257
1609,大亞,42,14,28,凱基-林口,2024-03-29,9257
00941,中信上游半導體,41,18,23,凱基-林口,2024-03-29,9257
1316,上曜,22,1,21,凱基-林口,2024-03-29,9257
3260,威剛,21,0,21,凱基-林口,2024-03-29,9257
4576,大銀微系統,21,0,21,凱基-林口,2024-03-29,9257
00637L,元大滬深300正2,20,0,20,凱基-林口,2024-03-29,9257
020028,元大特選電動車N,20,0,20,凱基-林口,2024-03-29,9257
6151,晉倫,20,0,20,凱基-林口,2024-03-29,9257
2317,鴻海,98,79,19,凱基-林口,2024-03-29,9257
00882,中信中國高股息,18,0,18,凱基-林口,2024-03-29,9257
1108,幸福,17,0,17,凱基-林口,2024-03-29,9257
4161,聿新科,28,11,17,凱基-林口,2024-03-29,9257
00919,群益台灣精選高息,34,18,16,凱基-林口,2024-03-29,9257
3450,聯鈞,16,0,16,凱基-林口,2024-03-29,9257
00911,兆豐洲際半導體,15,0,15,凱基-林口,2024-03-29,9257
5469,瀚宇博,15,0,15,凱基-林口,2024-03-29,9257
2324,仁寶,17,3,14,凱基-林口,2024-03-29,9257
4960,誠美材,14,0,14,凱基-林口,2024-03-29,9257
5388,中磊,15,1,14,凱基-林口,2024-03-29,9257
2206,三陽工業,18,5,13,凱基-林口,2024-03-29,9257
2461,光群雷,33,20,13,凱基-林口,2024-03-29,9257
4562,穎漢,13,0,13,凱基-林口,2024-03-29,9257
00720B,元大投資級公司債,12,0,12,凱基-林口,2024-03-29,9257
9904,寶成,15,3,12,凱基-林口,2024-03-29,9257
2354,鴻準,44,33,11,凱基-林口,2024-03-29,9257
00652,富邦印度,10,0,10,凱基-林口,2024-03-29,9257
00722B,群益投資級電信債,10,0,10,凱基-林口,2024-03-29,9257
00715L,期街口布蘭特正2,10,0,10,凱基-林口,2024-03-29,9257
1584,精剛,10,0,10,凱基-林口,2024-03-29,9257
2392,正崴,20,10,10,凱基-林口,2024-03-29,9257
2472,立隆電,10,0,10,凱基-林口,2024-03-29,9257
3038,全台,10,0,10,凱基-林口,2024-03-29,9257
5324,士開,10,0,10,凱基-林口,2024-03-29,9257
5521,工信,10,0,10,凱基-林口,2024-03-29,9257
6127,九豪,10,0,10,凱基-林口,2024-03-29,9257
00940,元大台灣價值高息,992,252,740,凱基-林口,2024-04-01,9257
2356,英業達,119,5,114,凱基-林口,2024-04-01,9257
00927,群益半導體收益,100,0,100,凱基-林口,2024-04-01,9257
8033,雷虎,72,11,61,凱基-林口,2024-04-01,9257
00878,國泰永續高股息,43,0,43,凱基-林口,2024-04-01,9257
00937B,群益ESG投等債20,39,4,35,凱基-林口,2024-04-01,9257
2634,漢翔,43,10,33,凱基-林口,2024-04-01,9257
00919,群益台灣精選高息,43,12,31,凱基-林口,2024-04-01,9257
00882,中信中國高股息,30,0,30,凱基-林口,2024-04-01,9257
3231,緯創,53,26,27,凱基-林口,2024-04-01,9257
2891,中信金,28,1,27,凱基-林口,2024-04-01,9257
2376,技嘉,45,21,24,凱基-林口,2024-04-01,9257
3356,奇偶,23,0,23,凱基-林口,2024-04-01,9257
6753,龍德造船,30,7,23,凱基-林口,2024-04-01,9257
2834,臺企銀,21,0,21,凱基-林口,2024-04-01,9257
00939,統一台灣高息動能,64,43,21,凱基-林口,2024-04-01,9257
00650L,復華香港正2,20,0,20,凱基-林口,2024-04-01,9257
1582,信錦,20,0,20,凱基-林口,2024-04-01,9257
2313,華通,21,1,20,凱基-林口,2024-04-01,9257
2323,中環,20,0,20,凱基-林口,2024-04-01,9257
3479,安勤,20,0,20,凱基-林口,2024-04-01,9257
2382,廣達,37,18,19,凱基-林口,2024-04-01,9257
5213,亞昕,18,0,18,凱基-林口,2024-04-01,9257
2461,光群雷,17,0,17,凱基-林口,2024-04-01,9257
4960,誠美材,17,0,17,凱基-林口,2024-04-01,9257
2301,光寶科,17,1,16,凱基-林口,2024-04-01,9257
8054,安國,19,3,16,凱基-林口,2024-04-01,9257
00918,大華優利高填息30,15,1,14,凱基-林口,2024-04-01,9257
00632R,元大台灣50反1,14,0,14,凱基-林口,2024-04-01,9257
1503,士電,16,3,13,凱基-林口,2024-04-01,9257
5347,世界,14,2,12,凱基-林口,2024-04-01,9257
00929,復華台灣科技優息,48,36,12,凱基-林口,2024-04-01,9257
2845,遠東銀,12,0,12,凱基-林口,2024-04-01,9257
3036,文曄,11,0,11,凱基-林口,2024-04-01,9257
1504,東元,13,2,11,凱基-林口,2024-04-01,9257
2303,聯電,13,2,11,凱基-林口,2024-04-01,9257
00687B,國泰20年美債,11,0,11,凱基-林口,2024-04-01,9257
2610,華航,10,0,10,凱基-林口,2024-04-01,9257
1310,台苯,10,0,10,凱基-林口,2024-04-01,9257
2538,基泰,10,0,10,凱基-林口,2024-04-01,9257
2615,萬海,11,1,10,凱基-林口,2024-04-01,9257
3032,偉訓,11,1,10,凱基-林口,2024-04-01,9257
6127,九豪,10,0,10,凱基-林口,2024-04-01,9257
6191,精成科,10,0,10,凱基-林口,2024-04-01,9257
8936,國統,71,61,10,凱基-林口,2024-04-01,9257
912000,晨訊科-DR,10,0,10,凱基-林口,2024-04-01,9257
3037,欣興,14,5,9,凱基-林口,2024-04-01,9257
4576,大銀微系統,9,0,9,凱基-林口,2024-04-01,9257
3711,日月光投控,9,0,9,凱基-林口,2024-04-01,9257
1316,上曜,12,4,8,凱基-林口,2024-04-01,9257
00940,元大台灣價值高息,397,13,384,凱基-林口,2024-04-02,9257
00929,復華台灣科技優息,400,32,368,凱基-林口,2024-04-02,9257
00927,群益半導體收益,138,0,138,凱基-林口,2024-04-02,9257
00687B,國泰20年美債,128,1,127,凱基-林口,2024-04-02,9257
8358,金居,123,39,84,凱基-林口,2024-04-02,9257
00679B,元大美債20年,72,0,72,凱基-林口,2024-04-02,9257
00937B,群益ESG投等債20,72,4,68,凱基-林口,2024-04-02,9257
5213,亞昕,55,0,55,凱基-林口,2024-04-02,9257
00933B,國泰10Y+金融債,52,1,51,凱基-林口,2024-04-02,9257
2543,皇昌,40,0,40,凱基-林口,2024-04-02,9257
2371,大同,197,159,38,凱基-林口,2024-04-02,9257
2387,精元,36,0,36,凱基-林口,2024-04-02,9257
3706,神達,36,2,34,凱基-林口,2024-04-02,9257
2888,新光金,34,1,33,凱基-林口,2024-04-02,9257
00665L,富邦�琤肭磪囓�2,30,0,30,凱基-林口,2024-04-02,9257
5469,瀚宇博,30,0,30,凱基-林口,2024-04-02,9257
6753,龍德造船,29,0,29,凱基-林口,2024-04-02,9257
2009,第一銅,59,30,29,凱基-林口,2024-04-02,9257
1717,長興,28,0,28,凱基-林口,2024-04-02,9257
3036,文曄,26,0,26,凱基-林口,2024-04-02,9257
912000,晨訊科-DR,26,0,26,凱基-林口,2024-04-02,9257
8033,雷虎,32,9,23,凱基-林口,2024-04-02,9257
00720B,元大投資級公司債,20,0,20,凱基-林口,2024-04-02,9257
00939,統一台灣高息動能,21,1,20,凱基-林口,2024-04-02,9257
2354,鴻準,30,10,20,凱基-林口,2024-04-02,9257
2356,英業達,126,106,20,凱基-林口,2024-04-02,9257
00857B,永豐20年美公債,19,0,19,凱基-林口,2024-04-02,9257
2014,中鴻,20,1,19,凱基-林口,2024-04-02,9257
00680L,元大美債20正2,17,0,17,凱基-林口,2024-04-02,9257
1725,元禎,15,1,14,凱基-林口,2024-04-02,9257
4542,科嶠,13,0,13,凱基-林口,2024-04-02,9257
6284,佳邦,10,0,10,凱基-林口,2024-04-02,9257
00897,富邦基因免疫生技,10,0,10,凱基-林口,2024-04-02,9257
1522,堤維西,31,21,10,凱基-林口,2024-04-02,9257
4966,譜瑞-KY,10,0,10,凱基-林口,2024-04-02,9257
6589,台康生技,10,0,10,凱基-林口,2024-04-02,9257
8996,高力,10,0,10,凱基-林口,2024-04-02,9257
00646,元大S＆P500,9,0,9,凱基-林口,2024-04-02,9257
5371,中光電,32,23,9,凱基-林口,2024-04-02,9257
6695,芯鼎,10,1,9,凱基-林口,2024-04-02,9257
8054,安國,40,31,9,凱基-林口,2024-04-02,9257
3363,上詮,9,1,8,凱基-林口,2024-04-02,9257
2845,遠東銀,8,0,8,凱基-林口,2024-04-02,9257
00662,富邦NASDAQ,7,0,7,凱基-林口,2024-04-02,9257
00725B,國泰投資級公司債,7,0,7,凱基-林口,2024-04-02,9257
00885,富邦越南,9,2,7,凱基-林口,2024-04-02,9257
6151,晉倫,7,0,7,凱基-林口,2024-04-02,9257
00931B,統一美債20年,6,0,6,凱基-林口,2024-04-02,9257
2305,全友,6,0,6,凱基-林口,2024-04-02,9257
2328,廣宇,6,0,6,凱基-林口,2024-04-02,9257
2356,英業達,554,45,509,凱基-林口,2024-04-03,9257
00632R,元大台灣50反1,320,10,310,凱基-林口,2024-04-03,9257
8358,金居,202,60,142,凱基-林口,2024-04-03,9257
00927,群益半導體收益,120,8,112,凱基-林口,2024-04-03,9257
2881,富邦金,105,1,104,凱基-林口,2024-04-03,9257
3481,群創,68,0,68,凱基-林口,2024-04-03,9257
00937B,群益ESG投等債20,61,0,61,凱基-林口,2024-04-03,9257
0056,元大高股息,60,0,60,凱基-林口,2024-04-03,9257
00687B,國泰20年美債,74,15,59,凱基-林口,2024-04-03,9257
00679B,元大美債20年,51,0,51,凱基-林口,2024-04-03,9257
1609,大亞,57,15,42,凱基-林口,2024-04-03,9257
2515,中工,137,97,40,凱基-林口,2024-04-03,9257
2543,皇昌,40,0,40,凱基-林口,2024-04-03,9257
2317,鴻海,57,20,37,凱基-林口,2024-04-03,9257
00911,兆豐洲際半導體,33,0,33,凱基-林口,2024-04-03,9257
2359,所羅門,32,2,30,凱基-林口,2024-04-03,9257
6753,龍德造船,30,0,30,凱基-林口,2024-04-03,9257
2885,元大金,28,0,28,凱基-林口,2024-04-03,9257
1101,台泥,30,4,26,凱基-林口,2024-04-03,9257
00931B,統一美債20年,25,0,25,凱基-林口,2024-04-03,9257
8033,雷虎,22,0,22,凱基-林口,2024-04-03,9257
00720B,元大投資級公司債,20,0,20,凱基-林口,2024-04-03,9257
5880,合庫金,20,0,20,凱基-林口,2024-04-03,9257
2354,鴻準,20,1,19,凱基-林口,2024-04-03,9257
00919,群益台灣精選高息,25,6,19,凱基-林口,2024-04-03,9257
2301,光寶科,21,3,18,凱基-林口,2024-04-03,9257
2888,新光金,18,2,16,凱基-林口,2024-04-03,9257
00680L,元大美債20正2,16,0,16,凱基-林口,2024-04-03,9257
1314,中石化,16,0,16,凱基-林口,2024-04-03,9257
3535,晶彩科,16,0,16,凱基-林口,2024-04-03,9257
00939,統一台灣高息動能,21,5,16,凱基-林口,2024-04-03,9257
2382,廣達,21,6,15,凱基-林口,2024-04-03,9257
2609,陽明,15,0,15,凱基-林口,2024-04-03,9257
00770,國泰北美科技,15,0,15,凱基-林口,2024-04-03,9257
1802,台玻,20,5,15,凱基-林口,2024-04-03,9257
1402,遠東新,12,0,12,凱基-林口,2024-04-03,9257
1717,長興,12,0,12,凱基-林口,2024-04-03,9257
3450,聯鈞,12,0,12,凱基-林口,2024-04-03,9257
8086,宏捷科,13,1,12,凱基-林口,2024-04-03,9257
3017,奇鋐,22,11,11,凱基-林口,2024-04-03,9257
2618,長榮航,11,0,11,凱基-林口,2024-04-03,9257
3673,TPK-KY,31,20,11,凱基-林口,2024-04-03,9257
3015,全漢,10,0,10,凱基-林口,2024-04-03,9257
3588,通嘉,10,0,10,凱基-林口,2024-04-03,9257
4746,台耀,10,0,10,凱基-林口,2024-04-03,9257
4909,新復興,20,10,10,凱基-林口,2024-04-03,9257
5478,智冠,10,0,10,凱基-林口,2024-04-03,9257
5521,工信,10,0,10,凱基-林口,2024-04-03,9257
6767,台微醫,10,0,10,凱基-林口,2024-04-03,9257
8936,國統,50,40,10,凱基-林口,2024-04-03,9257
2356,英業達,317,6,311,凱基-林口,2024-04-08,9257
00940,元大台灣價值高息,311,6,305,凱基-林口,2024-04-08,9257
00929,復華台灣科技優息,150,7,143,凱基-林口,2024-04-08,9257
00679B,元大美債20年,129,0,129,凱基-林口,2024-04-08,9257
00687B,國泰20年美債,118,0,118,凱基-林口,2024-04-08,9257
00927,群益半導體收益,107,0,107,凱基-林口,2024-04-08,9257
00937B,群益ESG投等債20,58,0,58,凱基-林口,2024-04-08,9257
6491,晶碩,46,0,46,凱基-林口,2024-04-08,9257
4510,高鋒,43,5,38,凱基-林口,2024-04-08,9257
00680L,元大美債20正2,36,0,36,凱基-林口,2024-04-08,9257
6282,康舒,36,0,36,凱基-林口,2024-04-08,9257
5213,亞昕,33,0,33,凱基-林口,2024-04-08,9257
3715,定穎投控,43,13,30,凱基-林口,2024-04-08,9257
5530,龍巖,30,0,30,凱基-林口,2024-04-08,9257
00882,中信中國高股息,30,2,28,凱基-林口,2024-04-08,9257
2371,大同,30,2,28,凱基-林口,2024-04-08,9257
00919,群益台灣精選高息,35,10,25,凱基-林口,2024-04-08,9257
2344,華邦電,25,0,25,凱基-林口,2024-04-08,9257
3231,緯創,33,12,21,凱基-林口,2024-04-08,9257
2486,一詮,139,118,21,凱基-林口,2024-04-08,9257
00795B,中信美國公債20年,20,0,20,凱基-林口,2024-04-08,9257
3704,合勤控,20,0,20,凱基-林口,2024-04-08,9257
2464,盟立,21,2,19,凱基-林口,2024-04-08,9257
3059,華晶科,17,2,15,凱基-林口,2024-04-08,9257
00751B,元大AAA至A公司債,15,0,15,凱基-林口,2024-04-08,9257
2460,建通,15,0,15,凱基-林口,2024-04-08,9257
00939,統一台灣高息動能,18,3,15,凱基-林口,2024-04-08,9257
2374,佳能,22,10,12,凱基-林口,2024-04-08,9257
00706L,期元大S＆P日圓正2,11,0,11,凱基-林口,2024-04-08,9257
2312,金寶,11,0,11,凱基-林口,2024-04-08,9257
2489,瑞軒,11,0,11,凱基-林口,2024-04-08,9257
2850,新產,11,0,11,凱基-林口,2024-04-08,9257
00885,富邦越南,11,0,11,凱基-林口,2024-04-08,9257
00696B,富邦美債20年,10,0,10,凱基-林口,2024-04-08,9257
2109,華豐,10,0,10,凱基-林口,2024-04-08,9257
2405,輔信,10,0,10,凱基-林口,2024-04-08,9257
2611,志信,10,0,10,凱基-林口,2024-04-08,9257
2887,台新金,10,0,10,凱基-林口,2024-04-08,9257
5478,智冠,10,0,10,凱基-林口,2024-04-08,9257
6190,萬泰科,10,0,10,凱基-林口,2024-04-08,9257
8021,尖點,10,0,10,凱基-林口,2024-04-08,9257
8085,福華,10,0,10,凱基-林口,2024-04-08,9257
3481,群創,9,0,9,凱基-林口,2024-04-08,9257
2362,藍天,11,2,9,凱基-林口,2024-04-08,9257
2618,長榮航,9,0,9,凱基-林口,2024-04-08,9257
3664,安瑞-KY,9,0,9,凱基-林口,2024-04-08,9257
2301,光寶科,9,1,8,凱基-林口,2024-04-08,9257
2515,中工,53,45,8,凱基-林口,2024-04-08,9257
5324,士開,8,0,8,凱基-林口,2024-04-08,9257
6933,AMAX-KY,8,0,8,凱基-林口,2024-04-08,9257
2421,建準,227,0,227,凱基-林口,2024-04-09,9257
00937B,群益ESG投等債20,228,20,208,凱基-林口,2024-04-09,9257
00940,元大台灣價值高息,268,113,155,凱基-林口,2024-04-09,9257
00632R,元大台灣50反1,122,0,122,凱基-林口,2024-04-09,9257
00929,復華台灣科技優息,122,2,120,凱基-林口,2024-04-09,9257
4161,聿新科,90,0,90,凱基-林口,2024-04-09,9257
00679B,元大美債20年,66,0,66,凱基-林口,2024-04-09,9257
00637L,元大滬深300正2,60,0,60,凱基-林口,2024-04-09,9257
00664R,國泰臺灣加權反1,50,0,50,凱基-林口,2024-04-09,9257
00927,群益半導體收益,50,4,46,凱基-林口,2024-04-09,9257
3231,緯創,121,79,42,凱基-林口,2024-04-09,9257
0056,元大高股息,52,12,40,凱基-林口,2024-04-09,9257
2845,遠東銀,30,0,30,凱基-林口,2024-04-09,9257
5469,瀚宇博,25,0,25,凱基-林口,2024-04-09,9257
3036,文曄,23,0,23,凱基-林口,2024-04-09,9257
3305,昇貿,23,0,23,凱基-林口,2024-04-09,9257
4720,德淵,23,0,23,凱基-林口,2024-04-09,9257
2313,華通,22,0,22,凱基-林口,2024-04-09,9257
1612,宏泰,38,16,22,凱基-林口,2024-04-09,9257
6505,台塑化,23,1,22,凱基-林口,2024-04-09,9257
5347,世界,21,1,20,凱基-林口,2024-04-09,9257
00692,富邦公司治理,20,0,20,凱基-林口,2024-04-09,9257
2611,志信,20,0,20,凱基-林口,2024-04-09,9257
912000,晨訊科-DR,20,1,19,凱基-林口,2024-04-09,9257
2610,華航,21,3,18,凱基-林口,2024-04-09,9257
3013,晟銘電,19,2,17,凱基-林口,2024-04-09,9257
6188,廣明,21,4,17,凱基-林口,2024-04-09,9257
5443,均豪,54,38,16,凱基-林口,2024-04-09,9257
8011,台通,16,0,16,凱基-林口,2024-04-09,9257
00919,群益台灣精選高息,18,3,15,凱基-林口,2024-04-09,9257
5351,鈺創,15,0,15,凱基-林口,2024-04-09,9257
9904,寶成,20,5,15,凱基-林口,2024-04-09,9257
2887,台新金,21,7,14,凱基-林口,2024-04-09,9257
1817,凱撒衛,13,0,13,凱基-林口,2024-04-09,9257
00687B,國泰20年美債,13,2,11,凱基-林口,2024-04-09,9257
1618,合機,12,1,11,凱基-林口,2024-04-09,9257
2412,中華電,11,0,11,凱基-林口,2024-04-09,9257
2376,技嘉,14,4,10,凱基-林口,2024-04-09,9257
3162,精確,10,0,10,凱基-林口,2024-04-09,9257
3558,神準,10,0,10,凱基-林口,2024-04-09,9257
4119,旭富,10,0,10,凱基-林口,2024-04-09,9257
5521,工信,13,3,10,凱基-林口,2024-04-09,9257
6491,晶碩,11,1,10,凱基-林口,2024-04-09,9257
2801,彰銀,10,1,9,凱基-林口,2024-04-09,9257
2365,昆盈,12,3,9,凱基-林口,2024-04-09,9257
2032,新鋼,11,2,9,凱基-林口,2024-04-09,9257
2344,華邦電,9,0,9,凱基-林口,2024-04-09,9257
3059,華晶科,10,1,9,凱基-林口,2024-04-09,9257
6215,和椿,10,1,9,凱基-林口,2024-04-09,9257
2317,鴻海,40,32,8,凱基-林口,2024-04-09,9257
00927,群益半導體收益,101,0,101,凱基-林口,2024-04-10,9257
00937B,群益ESG投等債20,105,8,97,凱基-林口,2024-04-10,9257
2356,英業達,120,26,94,凱基-林口,2024-04-10,9257
00939,統一台灣高息動能,106,34,72,凱基-林口,2024-04-10,9257
6578,達邦蛋白,58,0,58,凱基-林口,2024-04-10,9257
00918,大華優利高填息30,76,21,55,凱基-林口,2024-04-10,9257
2023,燁輝,51,0,51,凱基-林口,2024-04-10,9257
00940,元大台灣價值高息,52,3,49,凱基-林口,2024-04-10,9257
5426,振發,50,2,48,凱基-林口,2024-04-10,9257
3481,群創,52,6,46,凱基-林口,2024-04-10,9257
2421,建準,45,0,45,凱基-林口,2024-04-10,9257
3230,錦明,43,0,43,凱基-林口,2024-04-10,9257
2002,中鋼,55,21,34,凱基-林口,2024-04-10,9257
2301,光寶科,34,1,33,凱基-林口,2024-04-10,9257
00679B,元大美債20年,43,13,30,凱基-林口,2024-04-10,9257
8096,擎亞,45,17,28,凱基-林口,2024-04-10,9257
8088,品安,96,70,26,凱基-林口,2024-04-10,9257
2883,凱基金,22,0,22,凱基-林口,2024-04-10,9257
4119,旭富,22,0,22,凱基-林口,2024-04-10,9257
2887,台新金,22,1,21,凱基-林口,2024-04-10,9257
00929,復華台灣科技優息,49,29,20,凱基-林口,2024-04-10,9257
00907,永豐優息存股,20,0,20,凱基-林口,2024-04-10,9257
2206,三陽工業,22,2,20,凱基-林口,2024-04-10,9257
3227,原相,20,0,20,凱基-林口,2024-04-10,9257
4906,正文,20,0,20,凱基-林口,2024-04-10,9257
2317,鴻海,32,13,19,凱基-林口,2024-04-10,9257
00919,群益台灣精選高息,24,8,16,凱基-林口,2024-04-10,9257
1513,中興電,33,17,16,凱基-林口,2024-04-10,9257
2645,長榮航太,18,3,15,凱基-林口,2024-04-10,9257
6274,台燿,68,53,15,凱基-林口,2024-04-10,9257
1101,台泥,24,11,13,凱基-林口,2024-04-10,9257
2376,技嘉,56,43,13,凱基-林口,2024-04-10,9257
3231,緯創,24,12,12,凱基-林口,2024-04-10,9257
2328,廣宇,12,0,12,凱基-林口,2024-04-10,9257
6770,力積電,14,2,12,凱基-林口,2024-04-10,9257
3715,定穎投控,15,3,12,凱基-林口,2024-04-10,9257
00687B,國泰20年美債,11,0,11,凱基-林口,2024-04-10,9257
2382,廣達,14,3,11,凱基-林口,2024-04-10,9257
2634,漢翔,21,10,11,凱基-林口,2024-04-10,9257
1514,亞力,68,58,10,凱基-林口,2024-04-10,9257
00751B,元大AAA至A公司債,10,0,10,凱基-林口,2024-04-10,9257
00882,中信中國高股息,10,0,10,凱基-林口,2024-04-10,9257
1605,華新,11,1,10,凱基-林口,2024-04-10,9257
2006,東和鋼鐵,11,1,10,凱基-林口,2024-04-10,9257
2022,聚亨,10,0,10,凱基-林口,2024-04-10,9257
2412,中華電,10,0,10,凱基-林口,2024-04-10,9257
2611,志信,10,0,10,凱基-林口,2024-04-10,9257
2885,元大金,10,0,10,凱基-林口,2024-04-10,9257
2905,三商,10,0,10,凱基-林口,2024-04-10,9257
3014,聯陽,10,0,10,凱基-林口,2024-04-10,9257
2356,英業達,389,11,378,凱基-林口,2024-04-11,9257
00632R,元大台灣50反1,200,10,190,凱基-林口,2024-04-11,9257
00687B,國泰20年美債,105,0,105,凱基-林口,2024-04-11,9257
00937B,群益ESG投等債20,90,0,90,凱基-林口,2024-04-11,9257
3481,群創,83,2,81,凱基-林口,2024-04-11,9257
2317,鴻海,90,29,61,凱基-林口,2024-04-11,9257
00679B,元大美債20年,72,15,57,凱基-林口,2024-04-11,9257
00772B,中信高評級公司債,55,0,55,凱基-林口,2024-04-11,9257
2371,大同,137,83,54,凱基-林口,2024-04-11,9257
00927,群益半導體收益,53,5,48,凱基-林口,2024-04-11,9257
2506,太設,50,9,41,凱基-林口,2024-04-11,9257
00929,復華台灣科技優息,29,0,29,凱基-林口,2024-04-11,9257
4303,信立,45,17,28,凱基-林口,2024-04-11,9257
00680L,元大美債20正2,26,0,26,凱基-林口,2024-04-11,9257
1786,科妍,25,0,25,凱基-林口,2024-04-11,9257
2887,台新金,23,0,23,凱基-林口,2024-04-11,9257
00795B,中信美國公債20年,22,0,22,凱基-林口,2024-04-11,9257
1605,華新,26,4,22,凱基-林口,2024-04-11,9257
00712,復華富時不動產,21,0,21,凱基-林口,2024-04-11,9257
2421,建準,21,0,21,凱基-林口,2024-04-11,9257
2905,三商,20,0,20,凱基-林口,2024-04-11,9257
8011,台通,30,11,19,凱基-林口,2024-04-11,9257
00720B,元大投資級公司債,18,0,18,凱基-林口,2024-04-11,9257
3042,晶技,20,2,18,凱基-林口,2024-04-11,9257
00933B,國泰10Y+金融債,17,0,17,凱基-林口,2024-04-11,9257
3059,華晶科,17,0,17,凱基-林口,2024-04-11,9257
3231,緯創,21,5,16,凱基-林口,2024-04-11,9257
3230,錦明,20,4,16,凱基-林口,2024-04-11,9257
3363,上詮,18,2,16,凱基-林口,2024-04-11,9257
5469,瀚宇博,16,0,16,凱基-林口,2024-04-11,9257
2014,中鴻,15,0,15,凱基-林口,2024-04-11,9257
3673,TPK-KY,20,6,14,凱基-林口,2024-04-11,9257
2355,敬鵬,14,1,13,凱基-林口,2024-04-11,9257
8171,天宇,12,0,12,凱基-林口,2024-04-11,9257
2344,華邦電,14,2,12,凱基-林口,2024-04-11,9257
8936,國統,16,4,12,凱基-林口,2024-04-11,9257
00751B,元大AAA至A公司債,12,0,12,凱基-林口,2024-04-11,9257
0056,元大高股息,12,0,12,凱基-林口,2024-04-11,9257
2328,廣宇,12,1,11,凱基-林口,2024-04-11,9257
00706L,期元大S＆P日圓正2,10,0,10,凱基-林口,2024-04-11,9257
4953,緯軟,10,0,10,凱基-林口,2024-04-11,9257
00637L,元大滬深300正2,10,0,10,凱基-林口,2024-04-11,9257
00740B,富邦全球投等債,10,0,10,凱基-林口,2024-04-11,9257
020028,元大特選電動車N,10,0,10,凱基-林口,2024-04-11,9257
2025,千興,10,0,10,凱基-林口,2024-04-11,9257
2312,金寶,10,0,10,凱基-林口,2024-04-11,9257
2337,旺宏,10,0,10,凱基-林口,2024-04-11,9257
2460,建通,10,0,10,凱基-林口,2024-04-11,9257
2611,志信,10,0,10,凱基-林口,2024-04-11,9257
2845,遠東銀,10,0,10,凱基-林口,2024-04-11,9257
2353,宏��,564,18,546,凱基-林口,2024-04-12,9257
00687B,國泰20年美債,158,0,158,凱基-林口,2024-04-12,9257
00940,元大台灣價值高息,153,27,126,凱基-林口,2024-04-12,9257
00929,復華台灣科技優息,107,1,106,凱基-林口,2024-04-12,9257
8936,國統,77,8,69,凱基-林口,2024-04-12,9257
5880,合庫金,51,0,51,凱基-林口,2024-04-12,9257
2363,矽統,161,118,43,凱基-林口,2024-04-12,9257
6727,亞泰金屬,47,5,42,凱基-林口,2024-04-12,9257
8271,宇瞻,40,2,38,凱基-林口,2024-04-12,9257
00937B,群益ESG投等債20,37,0,37,凱基-林口,2024-04-12,9257
00878,國泰永續高股息,32,0,32,凱基-林口,2024-04-12,9257
3062,建漢,27,0,27,凱基-林口,2024-04-12,9257
3049,精金,26,0,26,凱基-林口,2024-04-12,9257
00795B,中信美國公債20年,24,0,24,凱基-林口,2024-04-12,9257
2887,台新金,23,0,23,凱基-林口,2024-04-12,9257
1514,亞力,73,52,21,凱基-林口,2024-04-12,9257
00909,國泰數位支付服務,20,0,20,凱基-林口,2024-04-12,9257
5355,佳總,20,0,20,凱基-林口,2024-04-12,9257
00696B,富邦美債20年,19,0,19,凱基-林口,2024-04-12,9257
2352,佳世達,18,0,18,凱基-林口,2024-04-12,9257
3372,典範,20,2,18,凱基-林口,2024-04-12,9257
8171,天宇,18,0,18,凱基-林口,2024-04-12,9257
2883,凱基金,20,2,18,凱基-林口,2024-04-12,9257
3231,緯創,34,17,17,凱基-林口,2024-04-12,9257
1402,遠東新,16,0,16,凱基-林口,2024-04-12,9257
2501,國建,17,1,16,凱基-林口,2024-04-12,9257
1217,愛之味,15,0,15,凱基-林口,2024-04-12,9257
00688L,國泰20年美債正2,15,0,15,凱基-林口,2024-04-12,9257
5425,台半,25,10,15,凱基-林口,2024-04-12,9257
2382,廣達,18,3,15,凱基-林口,2024-04-12,9257
0056,元大高股息,15,1,14,凱基-林口,2024-04-12,9257
00887,永豐中國科技50大,14,0,14,凱基-林口,2024-04-12,9257
00931B,統一美債20年,13,0,13,凱基-林口,2024-04-12,9257
1310,台苯,12,0,12,凱基-林口,2024-04-12,9257
00857B,永豐20年美公債,12,0,12,凱基-林口,2024-04-12,9257
1786,科妍,14,2,12,凱基-林口,2024-04-12,9257
2303,聯電,24,12,12,凱基-林口,2024-04-12,9257
8210,勤誠,14,3,11,凱基-林口,2024-04-12,9257
2312,金寶,11,0,11,凱基-林口,2024-04-12,9257
2340,台亞,12,1,11,凱基-林口,2024-04-12,9257
2506,太設,22,11,11,凱基-林口,2024-04-12,9257
5392,能率,12,1,11,凱基-林口,2024-04-12,9257
00720B,元大投資級公司債,10,0,10,凱基-林口,2024-04-12,9257
2369,菱生,10,0,10,凱基-林口,2024-04-12,9257
2610,華航,17,7,10,凱基-林口,2024-04-12,9257
2801,彰銀,10,0,10,凱基-林口,2024-04-12,9257
2845,遠東銀,10,0,10,凱基-林口,2024-04-12,9257
3027,盛達,10,0,10,凱基-林口,2024-04-12,9257
3038,全台,10,0,10,凱基-林口,2024-04-12,9257
3363,上詮,10,0,10,凱基-林口,2024-04-12,9257
00929,復華台灣科技優息,431,13,418,凱基-林口,2024-04-15,9257
3260,威剛,156,33,123,凱基-林口,2024-04-15,9257
00937B,群益ESG投等債20,120,3,117,凱基-林口,2024-04-15,9257
0056,元大高股息,143,28,115,凱基-林口,2024-04-15,9257
2867,三商壽,120,14,106,凱基-林口,2024-04-15,9257
2486,一詮,130,28,102,凱基-林口,2024-04-15,9257
6290,良維,150,50,100,凱基-林口,2024-04-15,9257
00940,元大台灣價值高息,116,16,100,凱基-林口,2024-04-15,9257
5426,振發,90,0,90,凱基-林口,2024-04-15,9257
2634,漢翔,91,18,73,凱基-林口,2024-04-15,9257
00712,復華富時不動產,72,0,72,凱基-林口,2024-04-15,9257
00919,群益台灣精選高息,68,11,57,凱基-林口,2024-04-15,9257
00927,群益半導體收益,50,0,50,凱基-林口,2024-04-15,9257
2344,華邦電,49,5,44,凱基-林口,2024-04-15,9257
2618,長榮航,44,4,40,凱基-林口,2024-04-15,9257
2367,燿華,50,11,39,凱基-林口,2024-04-15,9257
00878,國泰永續高股息,43,4,39,凱基-林口,2024-04-15,9257
1605,華新,78,43,35,凱基-林口,2024-04-15,9257
3062,建漢,32,0,32,凱基-林口,2024-04-15,9257
00720B,元大投資級公司債,35,4,31,凱基-林口,2024-04-15,9257
2317,鴻海,39,8,31,凱基-林口,2024-04-15,9257
4510,高鋒,30,0,30,凱基-林口,2024-04-15,9257
1513,中興電,39,10,29,凱基-林口,2024-04-15,9257
2405,輔信,29,0,29,凱基-林口,2024-04-15,9257
3060,銘異,29,1,28,凱基-林口,2024-04-15,9257
3231,緯創,30,5,25,凱基-林口,2024-04-15,9257
00905,FT臺灣Smart,25,0,25,凱基-林口,2024-04-15,9257
2883,凱基金,24,0,24,凱基-林口,2024-04-15,9257
3037,欣興,25,4,21,凱基-林口,2024-04-15,9257
2324,仁寶,21,0,21,凱基-林口,2024-04-15,9257
3015,全漢,21,0,21,凱基-林口,2024-04-15,9257
5213,亞昕,21,0,21,凱基-林口,2024-04-15,9257
8271,宇瞻,22,1,21,凱基-林口,2024-04-15,9257
1608,華榮,41,24,17,凱基-林口,2024-04-15,9257
2382,廣達,48,31,17,凱基-林口,2024-04-15,9257
2376,技嘉,20,4,16,凱基-林口,2024-04-15,9257
1785,光洋科,26,10,16,凱基-林口,2024-04-15,9257
2002,中鋼,17,1,16,凱基-林口,2024-04-15,9257
6116,彩晶,16,0,16,凱基-林口,2024-04-15,9257
00915,凱基優選高股息30,16,0,16,凱基-林口,2024-04-15,9257
00637L,元大滬深300正2,15,0,15,凱基-林口,2024-04-15,9257
2303,聯電,19,5,14,凱基-林口,2024-04-15,9257
00891,中信關鍵半導體,14,0,14,凱基-林口,2024-04-15,9257
5351,鈺創,14,0,14,凱基-林口,2024-04-15,9257
8033,雷虎,19,5,14,凱基-林口,2024-04-15,9257
00939,統一台灣高息動能,21,8,13,凱基-林口,2024-04-15,9257
8916,光隆,13,0,13,凱基-林口,2024-04-15,9257
00941,中信上游半導體,13,0,13,凱基-林口,2024-04-15,9257
00631L,元大台灣50正2,13,1,12,凱基-林口,2024-04-15,9257
8358,金居,14,2,12,凱基-林口,2024-04-15,9257
00937B,群益ESG投等債20,581,0,581,凱基-林口,2024-04-16,9257
00940,元大台灣價值高息,480,92,388,凱基-林口,2024-04-16,9257
00929,復華台灣科技優息,358,8,350,凱基-林口,2024-04-16,9257
6290,良維,258,1,257,凱基-林口,2024-04-16,9257
2867,三商壽,178,33,145,凱基-林口,2024-04-16,9257
0056,元大高股息,151,42,109,凱基-林口,2024-04-16,9257
00927,群益半導體收益,107,0,107,凱基-林口,2024-04-16,9257
00878,國泰永續高股息,103,18,85,凱基-林口,2024-04-16,9257
2371,大同,160,80,80,凱基-林口,2024-04-16,9257
2884,玉山金,79,10,69,凱基-林口,2024-04-16,9257
1605,華新,63,2,61,凱基-林口,2024-04-16,9257
3260,威剛,61,1,60,凱基-林口,2024-04-16,9257
1609,大亞,122,66,56,凱基-林口,2024-04-16,9257
2344,華邦電,55,1,54,凱基-林口,2024-04-16,9257
1722,台肥,51,0,51,凱基-林口,2024-04-16,9257
4960,誠美材,40,0,40,凱基-林口,2024-04-16,9257
3481,群創,70,31,39,凱基-林口,2024-04-16,9257
00919,群益台灣精選高息,166,127,39,凱基-林口,2024-04-16,9257
2883,凱基金,39,1,38,凱基-林口,2024-04-16,9257
8033,雷虎,41,3,38,凱基-林口,2024-04-16,9257
5521,工信,36,0,36,凱基-林口,2024-04-16,9257
1455,集盛,35,0,35,凱基-林口,2024-04-16,9257
2486,一詮,34,0,34,凱基-林口,2024-04-16,9257
00939,統一台灣高息動能,103,70,33,凱基-林口,2024-04-16,9257
2317,鴻海,82,53,29,凱基-林口,2024-04-16,9257
4127,天良,30,1,29,凱基-林口,2024-04-16,9257
00931B,統一美債20年,31,3,28,凱基-林口,2024-04-16,9257
2323,中環,28,0,28,凱基-林口,2024-04-16,9257
2401,凌陽,30,3,27,凱基-林口,2024-04-16,9257
2609,陽明,26,0,26,凱基-林口,2024-04-16,9257
1402,遠東新,25,0,25,凱基-林口,2024-04-16,9257
00712,復華富時不動產,32,9,23,凱基-林口,2024-04-16,9257
5426,振發,23,0,23,凱基-林口,2024-04-16,9257
8011,台通,26,3,23,凱基-林口,2024-04-16,9257
2618,長榮航,24,2,22,凱基-林口,2024-04-16,9257
00885,富邦越南,22,0,22,凱基-林口,2024-04-16,9257
00687B,國泰20年美債,21,0,21,凱基-林口,2024-04-16,9257
3706,神達,29,8,21,凱基-林口,2024-04-16,9257
2312,金寶,21,0,21,凱基-林口,2024-04-16,9257
00753L,中信中國50正2,20,0,20,凱基-林口,2024-04-16,9257
2201,裕隆,21,1,20,凱基-林口,2024-04-16,9257
4161,聿新科,20,0,20,凱基-林口,2024-04-16,9257
00881,國泰台灣5G+,19,0,19,凱基-林口,2024-04-16,9257
2330,台積電,23,4,19,凱基-林口,2024-04-16,9257
2363,矽統,36,17,19,凱基-林口,2024-04-16,9257
2845,遠東銀,19,0,19,凱基-林口,2024-04-16,9257
3363,上詮,25,6,19,凱基-林口,2024-04-16,9257
00900,富邦特選高股息30,21,3,18,凱基-林口,2024-04-16,9257
00915,凱基優選高股息30,18,1,17,凱基-林口,2024-04-16,9257
8034,榮群,17,0,17,凱基-林口,2024-04-16,9257
00929,復華台灣科技優息,349,12,337,凱基-林口,2024-04-17,9257
00671R,富邦NASDAQ反1,120,0,120,凱基-林口,2024-04-17,9257
3013,晟銘電,98,2,96,凱基-林口,2024-04-17,9257
2486,一詮,171,75,96,凱基-林口,2024-04-17,9257
00940,元大台灣價值高息,79,0,79,凱基-林口,2024-04-17,9257
00937B,群益ESG投等債20,137,65,72,凱基-林口,2024-04-17,9257
00632R,元大台灣50反1,72,12,60,凱基-林口,2024-04-17,9257
0056,元大高股息,92,49,43,凱基-林口,2024-04-17,9257
00679B,元大美債20年,44,3,41,凱基-林口,2024-04-17,9257
00687B,國泰20年美債,41,0,41,凱基-林口,2024-04-17,9257
6290,良維,38,2,36,凱基-林口,2024-04-17,9257
00733,富邦臺灣中小,35,1,34,凱基-林口,2024-04-17,9257
6449,鈺邦,32,0,32,凱基-林口,2024-04-17,9257
00712,復華富時不動產,30,0,30,凱基-林口,2024-04-17,9257
8358,金居,30,0,30,凱基-林口,2024-04-17,9257
8033,雷虎,29,0,29,凱基-林口,2024-04-17,9257
3260,威剛,31,2,29,凱基-林口,2024-04-17,9257
4161,聿新科,36,7,29,凱基-林口,2024-04-17,9257
3231,緯創,39,11,28,凱基-林口,2024-04-17,9257
8034,榮群,30,2,28,凱基-林口,2024-04-17,9257
2302,麗正,26,1,25,凱基-林口,2024-04-17,9257
00696B,富邦美債20年,23,0,23,凱基-林口,2024-04-17,9257
2356,英業達,27,6,21,凱基-林口,2024-04-17,9257
6770,力積電,25,4,21,凱基-林口,2024-04-17,9257
00919,群益台灣精選高息,26,6,20,凱基-林口,2024-04-17,9257
3015,全漢,20,0,20,凱基-林口,2024-04-17,9257
00857B,永豐20年美公債,19,0,19,凱基-林口,2024-04-17,9257
1810,和成,33,14,19,凱基-林口,2024-04-17,9257
3035,智原,18,1,17,凱基-林口,2024-04-17,9257
2308,台達電,18,2,16,凱基-林口,2024-04-17,9257
00680L,元大美債20正2,16,0,16,凱基-林口,2024-04-17,9257
2353,宏��,17,2,15,凱基-林口,2024-04-17,9257
1310,台苯,15,0,15,凱基-林口,2024-04-17,9257
1605,華新,46,31,15,凱基-林口,2024-04-17,9257
3706,神達,15,0,15,凱基-林口,2024-04-17,9257
2885,元大金,14,0,14,凱基-林口,2024-04-17,9257
5009,榮剛,21,7,14,凱基-林口,2024-04-17,9257
00720B,元大投資級公司債,13,0,13,凱基-林口,2024-04-17,9257
8092,建暐,13,0,13,凱基-林口,2024-04-17,9257
3673,TPK-KY,12,0,12,凱基-林口,2024-04-17,9257
2330,台積電,13,1,12,凱基-林口,2024-04-17,9257
8054,安國,54,43,11,凱基-林口,2024-04-17,9257
1101,台泥,13,2,11,凱基-林口,2024-04-17,9257
2880,華南金,11,0,11,凱基-林口,2024-04-17,9257
3105,穩懋,11,0,11,凱基-林口,2024-04-17,9257
2002,中鋼,12,1,11,凱基-林口,2024-04-17,9257
00706L,期元大S＆P日圓正2,10,0,10,凱基-林口,2024-04-17,9257
3078,僑威,10,0,10,凱基-林口,2024-04-17,9257
5222,全訊,10,0,10,凱基-林口,2024-04-17,9257
5272,笙科,10,0,10,凱基-林口,2024-04-17,9257
2371,大同,323,186,137,凱基-林口,2024-04-18,9257
2355,敬鵬,127,10,117,凱基-林口,2024-04-18,9257
00671R,富邦NASDAQ反1,100,0,100,凱基-林口,2024-04-18,9257
1529,樂事綠能,100,15,85,凱基-林口,2024-04-18,9257
3706,神達,92,8,84,凱基-林口,2024-04-18,9257
2201,裕隆,83,4,79,凱基-林口,2024-04-18,9257
00929,復華台灣科技優息,67,5,62,凱基-林口,2024-04-18,9257
3645,達邁,62,1,61,凱基-林口,2024-04-18,9257
00937B,群益ESG投等債20,49,0,49,凱基-林口,2024-04-18,9257
2301,光寶科,81,37,44,凱基-林口,2024-04-18,9257
8033,雷虎,47,3,44,凱基-林口,2024-04-18,9257
0056,元大高股息,42,0,42,凱基-林口,2024-04-18,9257
00885,富邦越南,37,0,37,凱基-林口,2024-04-18,9257
00933B,國泰10Y+金融債,35,0,35,凱基-林口,2024-04-18,9257
00919,群益台灣精選高息,50,16,34,凱基-林口,2024-04-18,9257
2867,三商壽,43,10,33,凱基-林口,2024-04-18,9257
00940,元大台灣價值高息,52,21,31,凱基-林口,2024-04-18,9257
2609,陽明,31,2,29,凱基-林口,2024-04-18,9257
4142,國光生,28,0,28,凱基-林口,2024-04-18,9257
6244,茂迪,26,4,22,凱基-林口,2024-04-18,9257
5347,世界,25,4,21,凱基-林口,2024-04-18,9257
6290,良維,21,0,21,凱基-林口,2024-04-18,9257
9105,泰金寶-DR,21,0,21,凱基-林口,2024-04-18,9257
1608,華榮,34,14,20,凱基-林口,2024-04-18,9257
3703,欣陸,20,0,20,凱基-林口,2024-04-18,9257
5512,力麒,31,15,16,凱基-林口,2024-04-18,9257
2467,志聖,19,4,15,凱基-林口,2024-04-18,9257
2376,技嘉,40,25,15,凱基-林口,2024-04-18,9257
1513,中興電,55,41,14,凱基-林口,2024-04-18,9257
2405,輔信,14,0,14,凱基-林口,2024-04-18,9257
2486,一詮,35,21,14,凱基-林口,2024-04-18,9257
3540,曜越,14,0,14,凱基-林口,2024-04-18,9257
2354,鴻準,25,12,13,凱基-林口,2024-04-18,9257
3707,漢磊,18,5,13,凱基-林口,2024-04-18,9257
2363,矽統,23,10,13,凱基-林口,2024-04-18,9257
2509,全坤建,13,0,13,凱基-林口,2024-04-18,9257
8926,台汽電,17,4,13,凱基-林口,2024-04-18,9257
00687B,國泰20年美債,12,0,12,凱基-林口,2024-04-18,9257
1584,精剛,15,3,12,凱基-林口,2024-04-18,9257
6196,帆宣,12,0,12,凱基-林口,2024-04-18,9257
1611,中電,16,5,11,凱基-林口,2024-04-18,9257
1444,力麗,10,0,10,凱基-林口,2024-04-18,9257
2010,春源,10,0,10,凱基-林口,2024-04-18,9257
3441,聯一光,10,0,10,凱基-林口,2024-04-18,9257
8358,金居,21,11,10,凱基-林口,2024-04-18,9257
1503,士電,21,12,9,凱基-林口,2024-04-18,9257
3260,威剛,32,23,9,凱基-林口,2024-04-18,9257
3481,群創,15,7,8,凱基-林口,2024-04-18,9257
0050,元大台灣50,10,2,8,凱基-林口,2024-04-18,9257
2409,友達,8,0,8,凱基-林口,2024-04-18,9257
00929,復華台灣科技優息,479,29,450,凱基-林口,2024-04-19,9257
00940,元大台灣價值高息,429,16,413,凱基-林口,2024-04-19,9257
2486,一詮,197,1,196,凱基-林口,2024-04-19,9257
00878,國泰永續高股息,145,0,145,凱基-林口,2024-04-19,9257
00919,群益台灣精選高息,139,6,133,凱基-林口,2024-04-19,9257
5521,工信,175,79,96,凱基-林口,2024-04-19,9257
1609,大亞,217,126,91,凱基-林口,2024-04-19,9257
1529,樂事綠能,91,0,91,凱基-林口,2024-04-19,9257
8034,榮群,85,0,85,凱基-林口,2024-04-19,9257
0056,元大高股息,201,118,83,凱基-林口,2024-04-19,9257
2101,南港,80,6,74,凱基-林口,2024-04-19,9257
2867,三商壽,68,0,68,凱基-林口,2024-04-19,9257
00939,統一台灣高息動能,70,10,60,凱基-林口,2024-04-19,9257
3260,威剛,62,6,56,凱基-林口,2024-04-19,9257
2330,台積電,61,11,50,凱基-林口,2024-04-19,9257
2618,長榮航,67,18,49,凱基-林口,2024-04-19,9257
3287,廣寰科,41,0,41,凱基-林口,2024-04-19,9257
2834,臺企銀,40,0,40,凱基-林口,2024-04-19,9257
1504,東元,82,42,40,凱基-林口,2024-04-19,9257
2107,厚生,40,1,39,凱基-林口,2024-04-19,9257
2610,華航,41,3,38,凱基-林口,2024-04-19,9257
2606,裕民,70,32,38,凱基-林口,2024-04-19,9257
3576,聯合再生,37,0,37,凱基-林口,2024-04-19,9257
2405,輔信,39,4,35,凱基-林口,2024-04-19,9257
4532,瑞智,40,7,33,凱基-林口,2024-04-19,9257
2371,大同,256,223,33,凱基-林口,2024-04-19,9257
4161,聿新科,33,1,32,凱基-林口,2024-04-19,9257
2303,聯電,35,4,31,凱基-林口,2024-04-19,9257
2457,飛宏,31,1,30,凱基-林口,2024-04-19,9257
2882,國泰金,32,2,30,凱基-林口,2024-04-19,9257
3444,利機,30,3,27,凱基-林口,2024-04-19,9257
3027,盛達,31,5,26,凱基-林口,2024-04-19,9257
00694B,富邦美債1-3,25,0,25,凱基-林口,2024-04-19,9257
2363,矽統,37,14,23,凱基-林口,2024-04-19,9257
2317,鴻海,41,19,22,凱基-林口,2024-04-19,9257
006208,富邦台50,22,0,22,凱基-林口,2024-04-19,9257
00900,富邦特選高股息30,23,1,22,凱基-林口,2024-04-19,9257
2520,冠德,47,25,22,凱基-林口,2024-04-19,9257
5880,合庫金,21,0,21,凱基-林口,2024-04-19,9257
00885,富邦越南,20,0,20,凱基-林口,2024-04-19,9257
00671R,富邦NASDAQ反1,20,0,20,凱基-林口,2024-04-19,9257
3128,昇銳,20,0,20,凱基-林口,2024-04-19,9257
0050,元大台灣50,22,2,20,凱基-林口,2024-04-19,9257
9962,有益,19,0,19,凱基-林口,2024-04-19,9257
2009,第一銅,24,6,18,凱基-林口,2024-04-19,9257
2421,建準,20,3,17,凱基-林口,2024-04-19,9257
00923,群益台ESG低碳50,25,8,17,凱基-林口,2024-04-19,9257
2374,佳能,17,1,16,凱基-林口,2024-04-19,9257
6282,康舒,15,0,15,凱基-林口,2024-04-19,9257
2855,統一證,14,0,14,凱基-林口,2024-04-19,9257
00929,復華台灣科技優息,492,123,369,凱基-林口,2024-04-22,9257
3481,群創,330,1,329,凱基-林口,2024-04-22,9257
00919,群益台灣精選高息,178,32,146,凱基-林口,2024-04-22,9257
00940,元大台灣價值高息,234,115,119,凱基-林口,2024-04-22,9257
2515,中工,142,34,108,凱基-林口,2024-04-22,9257
2371,大同,375,301,74,凱基-林口,2024-04-22,9257
00939,統一台灣高息動能,70,10,60,凱基-林口,2024-04-22,9257
2344,華邦電,70,11,59,凱基-林口,2024-04-22,9257
8936,國統,67,13,54,凱基-林口,2024-04-22,9257
2486,一詮,47,0,47,凱基-林口,2024-04-22,9257
2457,飛宏,40,0,40,凱基-林口,2024-04-22,9257
5230,雷笛克光學,82,42,40,凱基-林口,2024-04-22,9257
00632R,元大台灣50反1,35,1,34,凱基-林口,2024-04-22,9257
00878,國泰永續高股息,40,7,33,凱基-林口,2024-04-22,9257
2637,慧洋-KY,34,5,29,凱基-林口,2024-04-22,9257
2402,毅嘉,29,1,28,凱基-林口,2024-04-22,9257
2458,義隆,22,0,22,凱基-林口,2024-04-22,9257
2337,旺宏,20,0,20,凱基-林口,2024-04-22,9257
3032,偉訓,20,0,20,凱基-林口,2024-04-22,9257
6229,研通,20,0,20,凱基-林口,2024-04-22,9257
2324,仁寶,20,1,19,凱基-林口,2024-04-22,9257
2363,矽統,42,23,19,凱基-林口,2024-04-22,9257
2885,元大金,21,3,18,凱基-林口,2024-04-22,9257
8054,安國,44,26,18,凱基-林口,2024-04-22,9257
2465,麗臺,17,0,17,凱基-林口,2024-04-22,9257
4532,瑞智,17,0,17,凱基-林口,2024-04-22,9257
1616,億泰,16,0,16,凱基-林口,2024-04-22,9257
1522,堤維西,15,0,15,凱基-林口,2024-04-22,9257
9902,台火,16,1,15,凱基-林口,2024-04-22,9257
2409,友達,22,8,14,凱基-林口,2024-04-22,9257
2520,冠德,22,8,14,凱基-林口,2024-04-22,9257
00679B,元大美債20年,24,12,12,凱基-林口,2024-04-22,9257
3287,廣寰科,17,5,12,凱基-林口,2024-04-22,9257
2356,英業達,14,2,12,凱基-林口,2024-04-22,9257
2101,南港,72,61,11,凱基-林口,2024-04-22,9257
6125,廣運,35,24,11,凱基-林口,2024-04-22,9257
020028,元大特選電動車N,10,0,10,凱基-林口,2024-04-22,9257
1810,和成,15,5,10,凱基-林口,2024-04-22,9257
3708,上緯投控,10,0,10,凱基-林口,2024-04-22,9257
3710,連展投控,10,0,10,凱基-林口,2024-04-22,9257
4966,譜瑞-KY,10,0,10,凱基-林口,2024-04-22,9257
6264,富裔,10,0,10,凱基-林口,2024-04-22,9257
8213,志超,10,0,10,凱基-林口,2024-04-22,9257
2913,農林,9,0,9,凱基-林口,2024-04-22,9257
3444,利機,10,1,9,凱基-林口,2024-04-22,9257
6230,尼得科超眾,9,0,9,凱基-林口,2024-04-22,9257
8034,榮群,10,1,9,凱基-林口,2024-04-22,9257
2353,宏��,9,1,8,凱基-林口,2024-04-22,9257
2405,輔信,12,4,8,凱基-林口,2024-04-22,9257
8438,昶昕,8,0,8,凱基-林口,2024-04-22,9257
2888,新光金,1911,0,1911,凱基-林口,2024-04-23,9257
2486,一詮,277,0,277,凱基-林口,2024-04-23,9257
00632R,元大台灣50反1,165,0,165,凱基-林口,2024-04-23,9257
00929,復華台灣科技優息,143,7,136,凱基-林口,2024-04-23,9257
0056,元大高股息,117,0,117,凱基-林口,2024-04-23,9257
00940,元大台灣價值高息,109,3,106,凱基-林口,2024-04-23,9257
00687B,國泰20年美債,71,4,67,凱基-林口,2024-04-23,9257
00679B,元大美債20年,64,3,61,凱基-林口,2024-04-23,9257
2371,大同,111,68,43,凱基-林口,2024-04-23,9257
00733,富邦臺灣中小,40,0,40,凱基-林口,2024-04-23,9257
2323,中環,40,0,40,凱基-林口,2024-04-23,9257
2363,矽統,34,3,31,凱基-林口,2024-04-23,9257
2542,興富發,31,2,29,凱基-林口,2024-04-23,9257
00919,群益台灣精選高息,38,11,27,凱基-林口,2024-04-23,9257
2337,旺宏,40,15,25,凱基-林口,2024-04-23,9257
00711B,復華彭博新興債,22,0,22,凱基-林口,2024-04-23,9257
6120,達運,21,0,21,凱基-林口,2024-04-23,9257
5512,力麒,20,1,19,凱基-林口,2024-04-23,9257
2515,中工,27,10,17,凱基-林口,2024-04-23,9257
2409,友達,16,0,16,凱基-林口,2024-04-23,9257
6264,富裔,16,0,16,凱基-林口,2024-04-23,9257
2511,太子,31,16,15,凱基-林口,2024-04-23,9257
5515,建國,15,0,15,凱基-林口,2024-04-23,9257
00939,統一台灣高息動能,32,18,14,凱基-林口,2024-04-23,9257
1314,中石化,63,50,13,凱基-林口,2024-04-23,9257
2547,日勝生,12,0,12,凱基-林口,2024-04-23,9257
2634,漢翔,11,0,11,凱基-林口,2024-04-23,9257
2457,飛宏,10,0,10,凱基-林口,2024-04-23,9257
2885,元大金,10,0,10,凱基-林口,2024-04-23,9257
3622,洋華,10,0,10,凱基-林口,2024-04-23,9257
2344,華邦電,10,1,9,凱基-林口,2024-04-23,9257
00891,中信關鍵半導體,9,0,9,凱基-林口,2024-04-23,9257
5511,德昌,9,0,9,凱基-林口,2024-04-23,9257
5521,工信,9,0,9,凱基-林口,2024-04-23,9257
912000,晨訊科-DR,9,0,9,凱基-林口,2024-04-23,9257
1612,宏泰,15,7,8,凱基-林口,2024-04-23,9257
3623,富晶通,8,0,8,凱基-林口,2024-04-23,9257
3706,神達,10,2,8,凱基-林口,2024-04-23,9257
8050,廣積,8,0,8,凱基-林口,2024-04-23,9257
1609,大亞,108,101,7,凱基-林口,2024-04-23,9257
2610,華航,14,7,7,凱基-林口,2024-04-23,9257
6770,力積電,12,5,7,凱基-林口,2024-04-23,9257
8046,南電,30,24,6,凱基-林口,2024-04-23,9257
2338,光罩,6,0,6,凱基-林口,2024-04-23,9257
2449,京元電子,14,8,6,凱基-林口,2024-04-23,9257
3015,全漢,6,0,6,凱基-林口,2024-04-23,9257
3450,聯鈞,6,0,6,凱基-林口,2024-04-23,9257
3576,聯合再生,9,3,6,凱基-林口,2024-04-23,9257
8080,印鉐,6,0,6,凱基-林口,2024-04-23,9257
8089,康全電訊,11,5,6,凱基-林口,2024-04-23,9257
00637L,元大滬深300正2,300,0,300,凱基-林口,2024-04-24,9257
1809,中釉,161,0,161,凱基-林口,2024-04-24,9257
2610,華航,136,31,105,凱基-林口,2024-04-24,9257
2354,鴻準,169,76,93,凱基-林口,2024-04-24,9257
2486,一詮,78,4,74,凱基-林口,2024-04-24,9257
3481,群創,56,2,54,凱基-林口,2024-04-24,9257
00679B,元大美債20年,57,4,53,凱基-林口,2024-04-24,9257
00929,復華台灣科技優息,92,53,39,凱基-林口,2024-04-24,9257
00830,國泰費城半導體,32,0,32,凱基-林口,2024-04-24,9257
2409,友達,35,4,31,凱基-林口,2024-04-24,9257
2374,佳能,35,5,30,凱基-林口,2024-04-24,9257
6125,廣運,75,46,29,凱基-林口,2024-04-24,9257
1609,大亞,196,170,26,凱基-林口,2024-04-24,9257
5371,中光電,46,21,25,凱基-林口,2024-04-24,9257
2886,兆豐金,24,0,24,凱基-林口,2024-04-24,9257
2834,臺企銀,21,0,21,凱基-林口,2024-04-24,9257
5213,亞昕,20,0,20,凱基-林口,2024-04-24,9257
1402,遠東新,17,0,17,凱基-林口,2024-04-24,9257
8358,金居,20,3,17,凱基-林口,2024-04-24,9257
00687B,國泰20年美債,16,0,16,凱基-林口,2024-04-24,9257
1725,元禎,27,11,16,凱基-林口,2024-04-24,9257
2412,中華電,16,0,16,凱基-林口,2024-04-24,9257
00942B,台新美A公司債20+,15,0,15,凱基-林口,2024-04-24,9257
2363,矽統,36,21,15,凱基-林口,2024-04-24,9257
6261,久元,20,5,15,凱基-林口,2024-04-24,9257
6239,力成,15,2,13,凱基-林口,2024-04-24,9257
2515,中工,24,12,12,凱基-林口,2024-04-24,9257
8349,�矬�,12,0,12,凱基-林口,2024-04-24,9257
00680L,元大美債20正2,11,0,11,凱基-林口,2024-04-24,9257
2887,台新金,11,0,11,凱基-林口,2024-04-24,9257
3703,欣陸,74,64,10,凱基-林口,2024-04-24,9257
1307,三芳,10,0,10,凱基-林口,2024-04-24,9257
2105,正新,10,0,10,凱基-林口,2024-04-24,9257
2331,精英,10,0,10,凱基-林口,2024-04-24,9257
2362,藍天,10,0,10,凱基-林口,2024-04-24,9257
2867,三商壽,10,0,10,凱基-林口,2024-04-24,9257
2892,第一金,10,0,10,凱基-林口,2024-04-24,9257
3206,志豐,10,0,10,凱基-林口,2024-04-24,9257
5531,鄉林,10,0,10,凱基-林口,2024-04-24,9257
6188,廣明,17,7,10,凱基-林口,2024-04-24,9257
6695,芯鼎,10,0,10,凱基-林口,2024-04-24,9257
2812,台中銀,10,1,9,凱基-林口,2024-04-24,9257
6215,和椿,30,21,9,凱基-林口,2024-04-24,9257
6770,力積電,12,3,9,凱基-林口,2024-04-24,9257
2542,興富發,10,1,9,凱基-林口,2024-04-24,9257
2367,燿華,8,0,8,凱基-林口,2024-04-24,9257
2509,全坤建,8,0,8,凱基-林口,2024-04-24,9257
3665,貿聯-KY,9,1,8,凱基-林口,2024-04-24,9257
6667,信紘科,10,2,8,凱基-林口,2024-04-24,9257
2002,中鋼,7,0,7,凱基-林口,2024-04-24,9257
4716,大立,142,0,142,凱基-林口,2024-04-25,9257
00882,中信中國高股息,155,48,107,凱基-林口,2024-04-25,9257
3013,晟銘電,112,6,106,凱基-林口,2024-04-25,9257
2610,華航,95,2,93,凱基-林口,2024-04-25,9257
00940,元大台灣價值高息,77,1,76,凱基-林口,2024-04-25,9257
6125,廣運,215,148,67,凱基-林口,2024-04-25,9257
2371,大同,185,128,57,凱基-林口,2024-04-25,9257
00929,復華台灣科技優息,60,5,55,凱基-林口,2024-04-25,9257
2444,兆勁,50,0,50,凱基-林口,2024-04-25,9257
1809,中釉,103,60,43,凱基-林口,2024-04-25,9257
2542,興富發,41,1,40,凱基-林口,2024-04-25,9257
8034,榮群,36,1,35,凱基-林口,2024-04-25,9257
00937B,群益ESG投等債20,32,0,32,凱基-林口,2024-04-25,9257
0056,元大高股息,30,0,30,凱基-林口,2024-04-25,9257
00711B,復華彭博新興債,30,0,30,凱基-林口,2024-04-25,9257
3059,華晶科,30,1,29,凱基-林口,2024-04-25,9257
5213,亞昕,28,0,28,凱基-林口,2024-04-25,9257
8183,精星,25,0,25,凱基-林口,2024-04-25,9257
00878,國泰永續高股息,25,0,25,凱基-林口,2024-04-25,9257
2383,台光電,46,21,25,凱基-林口,2024-04-25,9257
1440,南紡,36,11,25,凱基-林口,2024-04-25,9257
8111,立��,20,0,20,凱基-林口,2024-04-25,9257
2317,鴻海,27,9,18,凱基-林口,2024-04-25,9257
8054,安國,22,4,18,凱基-林口,2024-04-25,9257
8112,至上,17,0,17,凱基-林口,2024-04-25,9257
2382,廣達,21,5,16,凱基-林口,2024-04-25,9257
2885,元大金,16,0,16,凱基-林口,2024-04-25,9257
2354,鴻準,23,8,15,凱基-林口,2024-04-25,9257
2363,矽統,24,10,14,凱基-林口,2024-04-25,9257
2465,麗臺,14,0,14,凱基-林口,2024-04-25,9257
2409,友達,13,0,13,凱基-林口,2024-04-25,9257
1522,堤維西,13,0,13,凱基-林口,2024-04-25,9257
2882,國泰金,15,2,13,凱基-林口,2024-04-25,9257
1301,台塑,12,0,12,凱基-林口,2024-04-25,9257
00665L,富邦�琤肭磪囓�2,12,0,12,凱基-林口,2024-04-25,9257
00915,凱基優選高股息30,12,0,12,凱基-林口,2024-04-25,9257
5531,鄉林,12,0,12,凱基-林口,2024-04-25,9257
2845,遠東銀,12,0,12,凱基-林口,2024-04-25,9257
4966,譜瑞-KY,11,0,11,凱基-林口,2024-04-25,9257
2486,一詮,16,5,11,凱基-林口,2024-04-25,9257
3211,順達,11,0,11,凱基-林口,2024-04-25,9257
3617,碩天,11,0,11,凱基-林口,2024-04-25,9257
3706,神達,20,10,10,凱基-林口,2024-04-25,9257
1609,大亞,117,107,10,凱基-林口,2024-04-25,9257
3231,緯創,11,1,10,凱基-林口,2024-04-25,9257
00795B,中信美國公債20年,10,0,10,凱基-林口,2024-04-25,9257
00673R,期元大S＆P原油反1,10,0,10,凱基-林口,2024-04-25,9257
2399,映泰,10,0,10,凱基-林口,2024-04-25,9257
3041,揚智,10,0,10,凱基-林口,2024-04-25,9257
3491,昇達科,10,0,10,凱基-林口,2024-04-25,9257
00882,中信中國高股息,482,1,481,凱基-林口,2024-04-26,9257
3013,晟銘電,210,110,100,凱基-林口,2024-04-26,9257
00679B,元大美債20年,68,0,68,凱基-林口,2024-04-26,9257
6125,廣運,175,119,56,凱基-林口,2024-04-26,9257
3706,神達,53,0,53,凱基-林口,2024-04-26,9257
2101,南港,83,35,48,凱基-林口,2024-04-26,9257
3363,上詮,61,26,35,凱基-林口,2024-04-26,9257
00632R,元大台灣50反1,31,1,30,凱基-林口,2024-04-26,9257
4967,十銓,34,4,30,凱基-林口,2024-04-26,9257
2363,矽統,36,9,27,凱基-林口,2024-04-26,9257
00751B,元大AAA至A公司債,41,15,26,凱基-林口,2024-04-26,9257
00687B,國泰20年美債,26,0,26,凱基-林口,2024-04-26,9257
00725B,國泰投資級公司債,21,0,21,凱基-林口,2024-04-26,9257
00711B,復華彭博新興債,20,0,20,凱基-林口,2024-04-26,9257
1413,宏洲,20,0,20,凱基-林口,2024-04-26,9257
2889,國票金,20,0,20,凱基-林口,2024-04-26,9257
5514,三豐,30,10,20,凱基-林口,2024-04-26,9257
6757,台灣虎航,20,0,20,凱基-林口,2024-04-26,9257
00939,統一台灣高息動能,16,0,16,凱基-林口,2024-04-26,9257
00940,元大台灣價值高息,16,0,16,凱基-林口,2024-04-26,9257
3444,利機,16,0,16,凱基-林口,2024-04-26,9257
2316,楠梓電,16,0,16,凱基-林口,2024-04-26,9257
2354,鴻準,17,4,13,凱基-林口,2024-04-26,9257
1760,寶齡富錦,12,1,11,凱基-林口,2024-04-26,9257
00929,復華台灣科技優息,26,16,10,凱基-林口,2024-04-26,9257
2337,旺宏,10,0,10,凱基-林口,2024-04-26,9257
00673R,期元大S＆P原油反1,10,0,10,凱基-林口,2024-04-26,9257
00652,富邦印度,10,0,10,凱基-林口,2024-04-26,9257
00650L,復華香港正2,10,0,10,凱基-林口,2024-04-26,9257
00942B,台新美A公司債20+,10,0,10,凱基-林口,2024-04-26,9257
1618,合機,13,3,10,凱基-林口,2024-04-26,9257
2109,華豐,10,0,10,凱基-林口,2024-04-26,9257
2369,菱生,10,0,10,凱基-林口,2024-04-26,9257
2465,麗臺,10,0,10,凱基-林口,2024-04-26,9257
4726,永昕,10,0,10,凱基-林口,2024-04-26,9257
3324,雙鴻,18,8,10,凱基-林口,2024-04-26,9257
1440,南紡,15,6,9,凱基-林口,2024-04-26,9257
1808,潤隆,10,1,9,凱基-林口,2024-04-26,9257
3231,緯創,10,2,8,凱基-林口,2024-04-26,9257
00878,國泰永續高股息,11,3,8,凱基-林口,2024-04-26,9257
00795B,中信美國公債20年,8,0,8,凱基-林口,2024-04-26,9257
2352,佳世達,10,2,8,凱基-林口,2024-04-26,9257
2883,凱基金,8,0,8,凱基-林口,2024-04-26,9257
3037,欣興,12,4,8,凱基-林口,2024-04-26,9257
5292,華懋,8,0,8,凱基-林口,2024-04-26,9257
6213,聯茂,9,1,8,凱基-林口,2024-04-26,9257
2542,興富發,8,0,8,凱基-林口,2024-04-26,9257
5515,建國,7,0,7,凱基-林口,2024-04-26,9257
2408,南亞科,7,0,7,凱基-林口,2024-04-26,9257
0056,元大高股息,8,1,7,凱基-林口,2024-04-26,9257
6125,廣運,259,71,188,凱基-林口,2024-04-29,9257
3013,晟銘電,145,0,145,凱基-林口,2024-04-29,9257
00937B,群益ESG投等債20,128,0,128,凱基-林口,2024-04-29,9257
2363,矽統,129,49,80,凱基-林口,2024-04-29,9257
3622,洋華,52,0,52,凱基-林口,2024-04-29,9257
00941,中信上游半導體,51,0,51,凱基-林口,2024-04-29,9257
3052,夆典,45,0,45,凱基-林口,2024-04-29,9257
2618,長榮航,77,42,35,凱基-林口,2024-04-29,9257
3703,欣陸,32,1,31,凱基-林口,2024-04-29,9257
00632R,元大台灣50反1,36,6,30,凱基-林口,2024-04-29,9257
1409,新纖,30,0,30,凱基-林口,2024-04-29,9257
3540,曜越,28,0,28,凱基-林口,2024-04-29,9257
2609,陽明,77,51,26,凱基-林口,2024-04-29,9257
2324,仁寶,24,0,24,凱基-林口,2024-04-29,9257
6282,康舒,24,0,24,凱基-林口,2024-04-29,9257
1609,大亞,41,20,21,凱基-林口,2024-04-29,9257
3264,欣銓,21,0,21,凱基-林口,2024-04-29,9257
2323,中環,36,16,20,凱基-林口,2024-04-29,9257
6206,飛捷,20,0,20,凱基-林口,2024-04-29,9257
9907,統一實,20,0,20,凱基-林口,2024-04-29,9257
00733,富邦臺灣中小,17,0,17,凱基-林口,2024-04-29,9257
6425,易發,16,0,16,凱基-林口,2024-04-29,9257
8076,伍豐,16,0,16,凱基-林口,2024-04-29,9257
6191,精成科,17,3,14,凱基-林口,2024-04-29,9257
006208,富邦台50,13,0,13,凱基-林口,2024-04-29,9257
6177,達麗,13,0,13,凱基-林口,2024-04-29,9257
6215,和椿,17,4,13,凱基-林口,2024-04-29,9257
2409,友達,18,6,12,凱基-林口,2024-04-29,9257
1612,宏泰,12,0,12,凱基-林口,2024-04-29,9257
3481,群創,43,31,12,凱基-林口,2024-04-29,9257
3631,晟楠,12,0,12,凱基-林口,2024-04-29,9257
6213,聯茂,12,0,12,凱基-林口,2024-04-29,9257
00706L,期元大S＆P日圓正2,11,0,11,凱基-林口,2024-04-29,9257
2610,華航,66,55,11,凱基-林口,2024-04-29,9257
4916,事欣科,11,0,11,凱基-林口,2024-04-29,9257
8936,國統,11,0,11,凱基-林口,2024-04-29,9257
2467,志聖,15,4,11,凱基-林口,2024-04-29,9257
00652,富邦印度,10,0,10,凱基-林口,2024-04-29,9257
1444,力麗,10,0,10,凱基-林口,2024-04-29,9257
2362,藍天,10,0,10,凱基-林口,2024-04-29,9257
2421,建準,10,0,10,凱基-林口,2024-04-29,9257
2601,益航,10,0,10,凱基-林口,2024-04-29,9257
4967,十銓,10,0,10,凱基-林口,2024-04-29,9257
6024,群益期,10,0,10,凱基-林口,2024-04-29,9257
7402,邑錡,14,4,10,凱基-林口,2024-04-29,9257
1459,聯發,9,0,9,凱基-林口,2024-04-29,9257
1587,吉茂,27,18,9,凱基-林口,2024-04-29,9257
2537,聯上發,10,1,9,凱基-林口,2024-04-29,9257
3704,合勤控,10,1,9,凱基-林口,2024-04-29,9257
8110,華東,15,6,9,凱基-林口,2024-04-29,9257
5608,四維航,500,0,500,凱基-林口,2024-04-30,9257
3481,群創,110,5,105,凱基-林口,2024-04-30,9257
2486,一詮,167,81,86,凱基-林口,2024-04-30,9257
00665L,富邦�琤肭磪囓�2,84,0,84,凱基-林口,2024-04-30,9257
1314,中石化,51,8,43,凱基-林口,2024-04-30,9257
3622,洋華,24,0,24,凱基-林口,2024-04-30,9257
2515,中工,63,41,22,凱基-林口,2024-04-30,9257
00941,中信上游半導體,20,0,20,凱基-林口,2024-04-30,9257
5531,鄉林,20,0,20,凱基-林口,2024-04-30,9257
2501,國建,47,28,19,凱基-林口,2024-04-30,9257
8349,�矬�,19,0,19,凱基-林口,2024-04-30,9257
2359,所羅門,39,22,17,凱基-林口,2024-04-30,9257
2611,志信,15,0,15,凱基-林口,2024-04-30,9257
6275,元山,17,2,15,凱基-林口,2024-04-30,9257
00929,復華台灣科技優息,14,0,14,凱基-林口,2024-04-30,9257
1316,上曜,18,4,14,凱基-林口,2024-04-30,9257
3049,精金,15,1,14,凱基-林口,2024-04-30,9257
3188,鑫龍騰,13,0,13,凱基-林口,2024-04-30,9257
6213,聯茂,13,0,13,凱基-林口,2024-04-30,9257
2323,中環,22,10,12,凱基-林口,2024-04-30,9257
2913,農林,12,1,11,凱基-林口,2024-04-30,9257
3483,力致,13,2,11,凱基-林口,2024-04-30,9257
2547,日勝生,10,0,10,凱基-林口,2024-04-30,9257
3163,波若威,13,3,10,凱基-林口,2024-04-30,9257
00645,富邦日本,10,0,10,凱基-林口,2024-04-30,9257
1310,台苯,10,0,10,凱基-林口,2024-04-30,9257
2107,厚生,10,0,10,凱基-林口,2024-04-30,9257
8110,華東,10,0,10,凱基-林口,2024-04-30,9257
9907,統一實,10,0,10,凱基-林口,2024-04-30,9257
4532,瑞智,10,0,10,凱基-林口,2024-04-30,9257
1413,宏洲,9,0,9,凱基-林口,2024-04-30,9257
3363,上詮,33,24,9,凱基-林口,2024-04-30,9257
2505,國揚,8,0,8,凱基-林口,2024-04-30,9257
6215,和椿,11,3,8,凱基-林口,2024-04-30,9257
00919,群益台灣精選高息,18,11,7,凱基-林口,2024-04-30,9257
2605,新興,7,0,7,凱基-林口,2024-04-30,9257
6230,尼得科超眾,8,1,7,凱基-林口,2024-04-30,9257
5515,建國,7,1,6,凱基-林口,2024-04-30,9257
2408,南亞科,7,1,6,凱基-林口,2024-04-30,9257
00652,富邦印度,6,0,6,凱基-林口,2024-04-30,9257
2354,鴻準,15,9,6,凱基-林口,2024-04-30,9257
2801,彰銀,8,2,6,凱基-林口,2024-04-30,9257
4906,正文,6,0,6,凱基-林口,2024-04-30,9257
6274,台燿,13,7,6,凱基-林口,2024-04-30,9257
00830,國泰費城半導體,5,0,5,凱基-林口,2024-04-30,9257
2352,佳世達,5,0,5,凱基-林口,2024-04-30,9257
2613,中櫃,5,0,5,凱基-林口,2024-04-30,9257
2836,高雄銀,5,0,5,凱基-林口,2024-04-30,9257
3052,夆典,5,0,5,凱基-林口,2024-04-30,9257
4142,國光生,5,0,5,凱基-林口,2024-04-30,9257
2486,一詮,209,16,193,凱基-林口,2024-05-02,9257
2897,王道銀行,95,0,95,凱基-林口,2024-05-02,9257
00671R,富邦NASDAQ反1,90,0,90,凱基-林口,2024-05-02,9257
00929,復華台灣科技優息,84,11,73,凱基-林口,2024-05-02,9257
00878,國泰永續高股息,69,7,62,凱基-林口,2024-05-02,9257
3481,群創,38,0,38,凱基-林口,2024-05-02,9257
6125,廣運,47,12,35,凱基-林口,2024-05-02,9257
2354,鴻準,30,0,30,凱基-林口,2024-05-02,9257
9927,泰銘,30,0,30,凱基-林口,2024-05-02,9257
1608,華榮,31,2,29,凱基-林口,2024-05-02,9257
2371,大同,138,109,29,凱基-林口,2024-05-02,9257
00680L,元大美債20正2,28,0,28,凱基-林口,2024-05-02,9257
00940,元大台灣價值高息,49,22,27,凱基-林口,2024-05-02,9257
2330,台積電,28,2,26,凱基-林口,2024-05-02,9257
2303,聯電,32,7,25,凱基-林口,2024-05-02,9257
00939,統一台灣高息動能,24,0,24,凱基-林口,2024-05-02,9257
00937B,群益ESG投等債20,48,26,22,凱基-林口,2024-05-02,9257
2401,凌陽,23,2,21,凱基-林口,2024-05-02,9257
2883,凱基金,37,16,21,凱基-林口,2024-05-02,9257
6005,群益證,23,3,20,凱基-林口,2024-05-02,9257
8064,東捷,22,3,19,凱基-林口,2024-05-02,9257
00715L,期街口布蘭特正2,18,0,18,凱基-林口,2024-05-02,9257
00915,凱基優選高股息30,20,2,18,凱基-林口,2024-05-02,9257
5608,四維航,16,1,15,凱基-林口,2024-05-02,9257
6190,萬泰科,16,1,15,凱基-林口,2024-05-02,9257
3363,上詮,26,12,14,凱基-林口,2024-05-02,9257
6770,力積電,29,15,14,凱基-林口,2024-05-02,9257
2609,陽明,40,26,14,凱基-林口,2024-05-02,9257
00919,群益台灣精選高息,13,0,13,凱基-林口,2024-05-02,9257
2891,中信金,13,1,12,凱基-林口,2024-05-02,9257
1605,華新,12,0,12,凱基-林口,2024-05-02,9257
2515,中工,19,7,12,凱基-林口,2024-05-02,9257
3163,波若威,11,0,11,凱基-林口,2024-05-02,9257
6113,亞矽,17,6,11,凱基-林口,2024-05-02,9257
00932,兆豐永續高息等權,10,0,10,凱基-林口,2024-05-02,9257
00650L,復華香港正2,10,0,10,凱基-林口,2024-05-02,9257
2547,日勝生,10,0,10,凱基-林口,2024-05-02,9257
2867,三商壽,10,0,10,凱基-林口,2024-05-02,9257
3290,東浦,10,0,10,凱基-林口,2024-05-02,9257
3715,定穎投控,15,5,10,凱基-林口,2024-05-02,9257
5351,鈺創,10,0,10,凱基-林口,2024-05-02,9257
6241,易通展,10,0,10,凱基-林口,2024-05-02,9257
7402,邑錡,13,3,10,凱基-林口,2024-05-02,9257
8021,尖點,10,0,10,凱基-林口,2024-05-02,9257
00679B,元大美債20年,10,0,10,凱基-林口,2024-05-02,9257
1504,東元,20,12,8,凱基-林口,2024-05-02,9257
3062,建漢,8,0,8,凱基-林口,2024-05-02,9257
3419,譁裕,8,0,8,凱基-林口,2024-05-02,9257
5493,三聯,8,0,8,凱基-林口,2024-05-02,9257
6442,光聖,15,7,8,凱基-林口,2024-05-02,9257
00937B,群益ESG投等債20,613,10,603,凱基-林口,2024-05-03,9257
1608,華榮,152,6,146,凱基-林口,2024-05-03,9257
2913,農林,100,0,100,凱基-林口,2024-05-03,9257
00679B,元大美債20年,85,1,84,凱基-林口,2024-05-03,9257
3013,晟銘電,84,4,80,凱基-林口,2024-05-03,9257
8234,新漢,71,2,69,凱基-林口,2024-05-03,9257
6770,力積電,51,5,46,凱基-林口,2024-05-03,9257
1413,宏洲,45,6,39,凱基-林口,2024-05-03,9257
6207,雷科,40,1,39,凱基-林口,2024-05-03,9257
00688L,國泰20年美債正2,30,0,30,凱基-林口,2024-05-03,9257
2301,光寶科,30,0,30,凱基-林口,2024-05-03,9257
00687B,國泰20年美債,28,0,28,凱基-林口,2024-05-03,9257
2383,台光電,28,1,27,凱基-林口,2024-05-03,9257
9945,潤泰新,34,8,26,凱基-林口,2024-05-03,9257
2338,光罩,25,1,24,凱基-林口,2024-05-03,9257
2201,裕隆,26,3,23,凱基-林口,2024-05-03,9257
1316,上曜,26,7,19,凱基-林口,2024-05-03,9257
1808,潤隆,20,2,18,凱基-林口,2024-05-03,9257
2613,中櫃,17,0,17,凱基-林口,2024-05-03,9257
1301,台塑,16,0,16,凱基-林口,2024-05-03,9257
4714,永捷,17,1,16,凱基-林口,2024-05-03,9257
6282,康舒,16,0,16,凱基-林口,2024-05-03,9257
2727,王品,16,1,15,凱基-林口,2024-05-03,9257
3313,斐成,15,0,15,凱基-林口,2024-05-03,9257
4161,聿新科,15,0,15,凱基-林口,2024-05-03,9257
3363,上詮,14,0,14,凱基-林口,2024-05-03,9257
6113,亞矽,21,7,14,凱基-林口,2024-05-03,9257
2891,中信金,52,39,13,凱基-林口,2024-05-03,9257
3481,群創,12,0,12,凱基-林口,2024-05-03,9257
00945B,凱基美國非投等債,11,0,11,凱基-林口,2024-05-03,9257
2915,潤泰全,11,0,11,凱基-林口,2024-05-03,9257
3227,原相,12,1,11,凱基-林口,2024-05-03,9257
6125,廣運,198,188,10,凱基-林口,2024-05-03,9257
1444,力麗,10,0,10,凱基-林口,2024-05-03,9257
1460,宏遠,10,0,10,凱基-林口,2024-05-03,9257
2387,精元,10,0,10,凱基-林口,2024-05-03,9257
2705,六福,10,0,10,凱基-林口,2024-05-03,9257
2897,王道銀行,10,0,10,凱基-林口,2024-05-03,9257
5230,雷笛克光學,35,25,10,凱基-林口,2024-05-03,9257
9904,寶成,10,0,10,凱基-林口,2024-05-03,9257
5324,士開,10,0,10,凱基-林口,2024-05-03,9257
6005,群益證,12,3,9,凱基-林口,2024-05-03,9257
9933,中鼎,10,1,9,凱基-林口,2024-05-03,9257
9951,皇田,9,0,9,凱基-林口,2024-05-03,9257
2504,國產,13,5,8,凱基-林口,2024-05-03,9257
3163,波若威,11,3,8,凱基-林口,2024-05-03,9257
2739,寒舍,11,3,8,凱基-林口,2024-05-03,9257
3706,神達,11,3,8,凱基-林口,2024-05-03,9257
6443,元晶,10,2,8,凱基-林口,2024-05-03,9257
1503,士電,11,4,7,凱基-林口,2024-05-03,9257
00680L,元大美債20正2,660,5,655,凱基-林口,2024-05-06,9257
00929,復華台灣科技優息,566,43,523,凱基-林口,2024-05-06,9257
00878,國泰永續高股息,134,8,126,凱基-林口,2024-05-06,9257
00882,中信中國高股息,106,4,102,凱基-林口,2024-05-06,9257
00664R,國泰臺灣加權反1,100,0,100,凱基-林口,2024-05-06,9257
00927,群益半導體收益,100,0,100,凱基-林口,2024-05-06,9257
00919,群益台灣精選高息,124,28,96,凱基-林口,2024-05-06,9257
3564,其陽,72,14,58,凱基-林口,2024-05-06,9257
6282,康舒,57,6,51,凱基-林口,2024-05-06,9257
00665L,富邦�琤肭磪囓�2,50,0,50,凱基-林口,2024-05-06,9257
6125,廣運,51,5,46,凱基-林口,2024-05-06,9257
3537,堡達,43,0,43,凱基-林口,2024-05-06,9257
3390,旭軟,35,0,35,凱基-林口,2024-05-06,9257
2882,國泰金,38,7,31,凱基-林口,2024-05-06,9257
2328,廣宇,30,0,30,凱基-林口,2024-05-06,9257
3481,群創,30,0,30,凱基-林口,2024-05-06,9257
00679B,元大美債20年,39,13,26,凱基-林口,2024-05-06,9257
6265,方土昶,25,0,25,凱基-林口,2024-05-06,9257
4306,炎洲,23,2,21,凱基-林口,2024-05-06,9257
8271,宇瞻,20,0,20,凱基-林口,2024-05-06,9257
6269,台郡,20,1,19,凱基-林口,2024-05-06,9257
2353,宏��,36,18,18,凱基-林口,2024-05-06,9257
00915,凱基優選高股息30,21,3,18,凱基-林口,2024-05-06,9257
3450,聯鈞,20,2,18,凱基-林口,2024-05-06,9257
4916,事欣科,18,0,18,凱基-林口,2024-05-06,9257
2834,臺企銀,38,22,16,凱基-林口,2024-05-06,9257
4128,中天,15,0,15,凱基-林口,2024-05-06,9257
2344,華邦電,65,50,15,凱基-林口,2024-05-06,9257
2354,鴻準,15,1,14,凱基-林口,2024-05-06,9257
9933,中鼎,14,1,13,凱基-林口,2024-05-06,9257
2501,國建,17,5,12,凱基-林口,2024-05-06,9257
2301,光寶科,12,0,12,凱基-林口,2024-05-06,9257
2363,矽統,26,14,12,凱基-林口,2024-05-06,9257
3211,順達,12,0,12,凱基-林口,2024-05-06,9257
6770,力積電,22,10,12,凱基-林口,2024-05-06,9257
3017,奇鋐,15,4,11,凱基-林口,2024-05-06,9257
00945B,凱基美國非投等債,10,0,10,凱基-林口,2024-05-06,9257
2489,瑞軒,10,0,10,凱基-林口,2024-05-06,9257
3338,泰碩,10,0,10,凱基-林口,2024-05-06,9257
6138,茂達,10,0,10,凱基-林口,2024-05-06,9257
2615,萬海,10,0,10,凱基-林口,2024-05-06,9257
2504,國產,9,0,9,凱基-林口,2024-05-06,9257
00939,統一台灣高息動能,9,0,9,凱基-林口,2024-05-06,9257
5230,雷笛克光學,9,0,9,凱基-林口,2024-05-06,9257
1513,中興電,13,5,8,凱基-林口,2024-05-06,9257
1815,富喬,10,2,8,凱基-林口,2024-05-06,9257
3260,威剛,21,13,8,凱基-林口,2024-05-06,9257
6015,宏遠證,10,2,8,凱基-林口,2024-05-06,9257
2367,燿華,13,5,8,凱基-林口,2024-05-06,9257
2605,新興,7,0,7,凱基-林口,2024-05-06,9257
6125,廣運,308,22,286,凱基-林口,2024-05-07,9257
2392,正崴,121,9,112,凱基-林口,2024-05-07,9257
00940,元大台灣價值高息,108,8,100,凱基-林口,2024-05-07,9257
00664R,國泰臺灣加權反1,100,0,100,凱基-林口,2024-05-07,9257
2317,鴻海,152,83,69,凱基-林口,2024-05-07,9257
2363,矽統,74,6,68,凱基-林口,2024-05-07,9257
2739,寒舍,64,2,62,凱基-林口,2024-05-07,9257
2543,皇昌,73,13,60,凱基-林口,2024-05-07,9257
00680L,元大美債20正2,54,0,54,凱基-林口,2024-05-07,9257
00937B,群益ESG投等債20,75,24,51,凱基-林口,2024-05-07,9257
00706L,期元大S＆P日圓正2,50,0,50,凱基-林口,2024-05-07,9257
6282,康舒,48,1,47,凱基-林口,2024-05-07,9257
00679B,元大美債20年,49,4,45,凱基-林口,2024-05-07,9257
2101,南港,196,152,44,凱基-林口,2024-05-07,9257
2312,金寶,31,0,31,凱基-林口,2024-05-07,9257
3024,憶聲,30,0,30,凱基-林口,2024-05-07,9257
4960,誠美材,30,0,30,凱基-林口,2024-05-07,9257
2515,中工,46,17,29,凱基-林口,2024-05-07,9257
1612,宏泰,38,12,26,凱基-林口,2024-05-07,9257
3321,同泰,24,0,24,凱基-林口,2024-05-07,9257
1616,億泰,22,1,21,凱基-林口,2024-05-07,9257
2049,上銀,20,0,20,凱基-林口,2024-05-07,9257
2888,新光金,20,0,20,凱基-林口,2024-05-07,9257
4306,炎洲,20,0,20,凱基-林口,2024-05-07,9257
8271,宇瞻,21,1,20,凱基-林口,2024-05-07,9257
1314,中石化,29,10,19,凱基-林口,2024-05-07,9257
8349,�矬�,19,0,19,凱基-林口,2024-05-07,9257
00878,國泰永續高股息,26,7,19,凱基-林口,2024-05-07,9257
1609,大亞,34,16,18,凱基-林口,2024-05-07,9257
2834,臺企銀,17,0,17,凱基-林口,2024-05-07,9257
3049,精金,17,0,17,凱基-林口,2024-05-07,9257
2362,藍天,26,10,16,凱基-林口,2024-05-07,9257
2634,漢翔,15,0,15,凱基-林口,2024-05-07,9257
2505,國揚,20,5,15,凱基-林口,2024-05-07,9257
2889,國票金,60,45,15,凱基-林口,2024-05-07,9257
00942B,台新美A公司債20+,14,0,14,凱基-林口,2024-05-07,9257
5213,亞昕,14,0,14,凱基-林口,2024-05-07,9257
3564,其陽,35,22,13,凱基-林口,2024-05-07,9257
1570,力肯,15,2,13,凱基-林口,2024-05-07,9257
8121,越峰,14,1,13,凱基-林口,2024-05-07,9257
6269,台郡,12,0,12,凱基-林口,2024-05-07,9257
6443,元晶,12,0,12,凱基-林口,2024-05-07,9257
2371,大同,16,4,12,凱基-林口,2024-05-07,9257
1513,中興電,13,2,11,凱基-林口,2024-05-07,9257
2367,燿華,12,1,11,凱基-林口,2024-05-07,9257
2440,太空梭,11,0,11,凱基-林口,2024-05-07,9257
3325,旭品,13,2,11,凱基-林口,2024-05-07,9257
6213,聯茂,14,4,10,凱基-林口,2024-05-07,9257
00933B,國泰10Y+金融債,10,0,10,凱基-林口,2024-05-07,9257
1307,三芳,10,0,10,凱基-林口,2024-05-07,9257
00937B,群益ESG投等債20,439,96,343,凱基-林口,2024-05-08,9257
3013,晟銘電,180,2,178,凱基-林口,2024-05-08,9257
2605,新興,217,59,158,凱基-林口,2024-05-08,9257
00929,復華台灣科技優息,151,23,128,凱基-林口,2024-05-08,9257
8011,台通,86,2,84,凱基-林口,2024-05-08,9257
2465,麗臺,43,0,43,凱基-林口,2024-05-08,9257
6125,廣運,43,0,43,凱基-林口,2024-05-08,9257
1313,聯成,40,0,40,凱基-林口,2024-05-08,9257
8121,越峰,30,0,30,凱基-林口,2024-05-08,9257
3481,群創,34,5,29,凱基-林口,2024-05-08,9257
3036,文曄,28,0,28,凱基-林口,2024-05-08,9257
1314,中石化,34,7,27,凱基-林口,2024-05-08,9257
2303,聯電,23,1,22,凱基-林口,2024-05-08,9257
5515,建國,21,1,20,凱基-林口,2024-05-08,9257
1721,三晃,20,0,20,凱基-林口,2024-05-08,9257
2516,新建,20,0,20,凱基-林口,2024-05-08,9257
2601,益航,20,0,20,凱基-林口,2024-05-08,9257
6150,撼訊,20,0,20,凱基-林口,2024-05-08,9257
5871,中租-KY,21,2,19,凱基-林口,2024-05-08,9257
2515,中工,19,1,18,凱基-林口,2024-05-08,9257
00927,群益半導體收益,19,2,17,凱基-林口,2024-05-08,9257
2371,大同,51,35,16,凱基-林口,2024-05-08,9257
2359,所羅門,30,15,15,凱基-林口,2024-05-08,9257
00753L,中信中國50正2,14,0,14,凱基-林口,2024-05-08,9257
6269,台郡,21,8,13,凱基-林口,2024-05-08,9257
5608,四維航,13,0,13,凱基-林口,2024-05-08,9257
2353,宏��,13,1,12,凱基-林口,2024-05-08,9257
2618,長榮航,15,3,12,凱基-林口,2024-05-08,9257
1789,神隆,12,0,12,凱基-林口,2024-05-08,9257
3622,洋華,12,0,12,凱基-林口,2024-05-08,9257
4161,聿新科,12,0,12,凱基-林口,2024-05-08,9257
5386,青雲,12,0,12,凱基-林口,2024-05-08,9257
6257,矽格,12,0,12,凱基-林口,2024-05-08,9257
1905,華紙,11,0,11,凱基-林口,2024-05-08,9257
3049,精金,11,0,11,凱基-林口,2024-05-08,9257
5213,亞昕,11,0,11,凱基-林口,2024-05-08,9257
2603,長榮,14,4,10,凱基-林口,2024-05-08,9257
1733,五鼎,10,0,10,凱基-林口,2024-05-08,9257
2505,國揚,10,0,10,凱基-林口,2024-05-08,9257
2887,台新金,10,0,10,凱基-林口,2024-05-08,9257
3211,順達,10,0,10,凱基-林口,2024-05-08,9257
4306,炎洲,10,0,10,凱基-林口,2024-05-08,9257
5302,太欣,10,0,10,凱基-林口,2024-05-08,9257
6491,晶碩,10,0,10,凱基-林口,2024-05-08,9257
8176,智捷,10,0,10,凱基-林口,2024-05-08,9257
2883,凱基金,10,1,9,凱基-林口,2024-05-08,9257
3169,亞信,9,0,9,凱基-林口,2024-05-08,9257
8096,擎亞,13,4,9,凱基-林口,2024-05-08,9257
3231,緯創,28,19,9,凱基-林口,2024-05-08,9257
2368,金像電,8,0,8,凱基-林口,2024-05-08,9257
00929,復華台灣科技優息,148,5,143,凱基-林口,2024-05-09,9257
2409,友達,121,0,121,凱基-林口,2024-05-09,9257
2363,矽統,123,16,107,凱基-林口,2024-05-09,9257
1714,和桐,71,1,70,凱基-林口,2024-05-09,9257
00944,野村趨勢動能高息,66,0,66,凱基-林口,2024-05-09,9257
1504,東元,49,0,49,凱基-林口,2024-05-09,9257
2739,寒舍,50,2,48,凱基-林口,2024-05-09,9257
2392,正崴,50,5,45,凱基-林口,2024-05-09,9257
00937B,群益ESG投等債20,100,60,40,凱基-林口,2024-05-09,9257
2887,台新金,40,0,40,凱基-林口,2024-05-09,9257
2367,燿華,131,93,38,凱基-林口,2024-05-09,9257
5521,工信,38,0,38,凱基-林口,2024-05-09,9257
2618,長榮航,55,18,37,凱基-林口,2024-05-09,9257
00946,群益科技高息成長,37,0,37,凱基-林口,2024-05-09,9257
6125,廣運,42,7,35,凱基-林口,2024-05-09,9257
2610,華航,47,13,34,凱基-林口,2024-05-09,9257
3060,銘異,33,0,33,凱基-林口,2024-05-09,9257
1314,中石化,32,1,31,凱基-林口,2024-05-09,9257
8112,至上,35,5,30,凱基-林口,2024-05-09,9257
3036,文曄,32,2,30,凱基-林口,2024-05-09,9257
2449,京元電子,26,0,26,凱基-林口,2024-05-09,9257
2542,興富發,23,0,23,凱基-林口,2024-05-09,9257
00878,國泰永續高股息,32,12,20,凱基-林口,2024-05-09,9257
00632R,元大台灣50反1,20,0,20,凱基-林口,2024-05-09,9257
00753L,中信中國50正2,20,0,20,凱基-林口,2024-05-09,9257
00830,國泰費城半導體,20,0,20,凱基-林口,2024-05-09,9257
1721,三晃,40,20,20,凱基-林口,2024-05-09,9257
4736,泰博,20,0,20,凱基-林口,2024-05-09,9257
6114,久威,20,0,20,凱基-林口,2024-05-09,9257
6261,久元,20,0,20,凱基-林口,2024-05-09,9257
00940,元大台灣價值高息,21,1,20,凱基-林口,2024-05-09,9257
00915,凱基優選高股息30,19,0,19,凱基-林口,2024-05-09,9257
1609,大亞,36,19,17,凱基-林口,2024-05-09,9257
2371,大同,27,11,16,凱基-林口,2024-05-09,9257
1614,三洋電,25,10,15,凱基-林口,2024-05-09,9257
5351,鈺創,16,1,15,凱基-林口,2024-05-09,9257
5410,國眾,15,0,15,凱基-林口,2024-05-09,9257
6016,康和證,15,0,15,凱基-林口,2024-05-09,9257
5871,中租-KY,17,3,14,凱基-林口,2024-05-09,9257
2101,南港,15,2,13,凱基-林口,2024-05-09,9257
2486,一詮,46,33,13,凱基-林口,2024-05-09,9257
2834,臺企銀,13,0,13,凱基-林口,2024-05-09,9257
5457,宣德,13,0,13,凱基-林口,2024-05-09,9257
1522,堤維西,19,7,12,凱基-林口,2024-05-09,9257
00919,群益台灣精選高息,14,4,10,凱基-林口,2024-05-09,9257
00713,元大台灣高息低波,10,0,10,凱基-林口,2024-05-09,9257
00690,兆豐藍籌30,10,0,10,凱基-林口,2024-05-09,9257
00706L,期元大S＆P日圓正2,10,0,10,凱基-林口,2024-05-09,9257
1307,三芳,10,0,10,凱基-林口,2024-05-09,9257
2331,精英,10,0,10,凱基-林口,2024-05-09,9257
2486,一詮,624,22,602,凱基-林口,2024-05-10,9257
3706,神達,528,4,524,凱基-林口,2024-05-10,9257
00929,復華台灣科技優息,172,10,162,凱基-林口,2024-05-10,9257
00932,兆豐永續高息等權,101,0,101,凱基-林口,2024-05-10,9257
8234,新漢,81,0,81,凱基-林口,2024-05-10,9257
00946,群益科技高息成長,73,0,73,凱基-林口,2024-05-10,9257
00937B,群益ESG投等債20,120,60,60,凱基-林口,2024-05-10,9257
00632R,元大台灣50反1,53,0,53,凱基-林口,2024-05-10,9257
2883,凱基金,92,54,38,凱基-林口,2024-05-10,9257
2363,矽統,63,27,36,凱基-林口,2024-05-10,9257
2542,興富發,35,2,33,凱基-林口,2024-05-10,9257
2303,聯電,36,8,28,凱基-林口,2024-05-10,9257
3481,群創,32,5,27,凱基-林口,2024-05-10,9257
8358,金居,31,5,26,凱基-林口,2024-05-10,9257
00680L,元大美債20正2,23,0,23,凱基-林口,2024-05-10,9257
2421,建準,23,0,23,凱基-林口,2024-05-10,9257
00940,元大台灣價值高息,24,2,22,凱基-林口,2024-05-10,9257
00753L,中信中國50正2,21,0,21,凱基-林口,2024-05-10,9257
00665L,富邦�琤肭磪囓�2,20,0,20,凱基-林口,2024-05-10,9257
4916,事欣科,30,10,20,凱基-林口,2024-05-10,9257
1786,科妍,21,2,19,凱基-林口,2024-05-10,9257
2884,玉山金,30,13,17,凱基-林口,2024-05-10,9257
2313,華通,16,1,15,凱基-林口,2024-05-10,9257
3049,精金,15,0,15,凱基-林口,2024-05-10,9257
00944,野村趨勢動能高息,14,0,14,凱基-林口,2024-05-10,9257
4161,聿新科,27,14,13,凱基-林口,2024-05-10,9257
3376,新日興,21,10,11,凱基-林口,2024-05-10,9257
3444,利機,11,0,11,凱基-林口,2024-05-10,9257
4303,信立,10,0,10,凱基-林口,2024-05-10,9257
1808,潤隆,11,1,10,凱基-林口,2024-05-10,9257
2881A,富邦特,10,0,10,凱基-林口,2024-05-10,9257
2892,第一金,10,0,10,凱基-林口,2024-05-10,9257
3227,原相,10,0,10,凱基-林口,2024-05-10,9257
5609,中菲行,10,0,10,凱基-林口,2024-05-10,9257
6116,彩晶,10,0,10,凱基-林口,2024-05-10,9257
2412,中華電,10,0,10,凱基-林口,2024-05-10,9257
3363,上詮,28,18,10,凱基-林口,2024-05-10,9257
00679B,元大美債20年,74,65,9,凱基-林口,2024-05-10,9257
6269,台郡,14,6,8,凱基-林口,2024-05-10,9257
1609,大亞,12,5,7,凱基-林口,2024-05-10,9257
00731,復華富時高息低波,7,0,7,凱基-林口,2024-05-10,9257
1463,強盛新,7,0,7,凱基-林口,2024-05-10,9257
2501,國建,8,1,7,凱基-林口,2024-05-10,9257
3583,辛耘,8,1,7,凱基-林口,2024-05-10,9257
6438,迅得,7,0,7,凱基-林口,2024-05-10,9257
6605,帝寶,7,0,7,凱基-林口,2024-05-10,9257
6616,特昇-KY,7,0,7,凱基-林口,2024-05-10,9257
8112,至上,55,48,7,凱基-林口,2024-05-10,9257
8150,南茂,6,0,6,凱基-林口,2024-05-10,9257
2204,中華,6,0,6,凱基-林口,2024-05-10,9257
00937B,群益ESG投等債20,449,0,449,凱基-林口,2024-05-13,9257
2356,英業達,261,4,257,凱基-林口,2024-05-13,9257
2486,一詮,234,26,208,凱基-林口,2024-05-13,9257
2618,長榮航,192,24,168,凱基-林口,2024-05-13,9257
00753L,中信中國50正2,154,0,154,凱基-林口,2024-05-13,9257
3013,晟銘電,62,3,59,凱基-林口,2024-05-13,9257
2605,新興,47,2,45,凱基-林口,2024-05-13,9257
00929,復華台灣科技優息,42,1,41,凱基-林口,2024-05-13,9257
2834,臺企銀,41,3,38,凱基-林口,2024-05-13,9257
2617,台航,95,60,35,凱基-林口,2024-05-13,9257
3052,夆典,30,0,30,凱基-林口,2024-05-13,9257
00944,野村趨勢動能高息,29,0,29,凱基-林口,2024-05-13,9257
2641,正德,114,90,24,凱基-林口,2024-05-13,9257
3047,訊舟,24,0,24,凱基-林口,2024-05-13,9257
2636,台驊控股,28,4,24,凱基-林口,2024-05-13,9257
2883,凱基金,36,16,20,凱基-林口,2024-05-13,9257
00680L,元大美債20正2,22,3,19,凱基-林口,2024-05-13,9257
5515,建國,20,1,19,凱基-林口,2024-05-13,9257
00679B,元大美債20年,32,15,17,凱基-林口,2024-05-13,9257
2891,中信金,26,11,15,凱基-林口,2024-05-13,9257
2367,燿華,52,37,15,凱基-林口,2024-05-13,9257
4161,聿新科,30,15,15,凱基-林口,2024-05-13,9257
6139,亞翔,15,1,14,凱基-林口,2024-05-13,9257
1446,宏和,12,0,12,凱基-林口,2024-05-13,9257
2607,榮運,24,12,12,凱基-林口,2024-05-13,9257
2637,慧洋-KY,14,2,12,凱基-林口,2024-05-13,9257
00632R,元大台灣50反1,12,0,12,凱基-林口,2024-05-13,9257
3017,奇鋐,20,9,11,凱基-林口,2024-05-13,9257
2515,中工,11,0,11,凱基-林口,2024-05-13,9257
6283,淳安,13,2,11,凱基-林口,2024-05-13,9257
2241,艾姆勒,11,1,10,凱基-林口,2024-05-13,9257
00945B,凱基美國非投等債,10,0,10,凱基-林口,2024-05-13,9257
1104,環泥,10,0,10,凱基-林口,2024-05-13,9257
2614,東森,10,0,10,凱基-林口,2024-05-13,9257
2881A,富邦特,10,0,10,凱基-林口,2024-05-13,9257
4916,事欣科,10,0,10,凱基-林口,2024-05-13,9257
5392,能率,12,2,10,凱基-林口,2024-05-13,9257
5475,德宏,10,0,10,凱基-林口,2024-05-13,9257
2106,建大,8,0,8,凱基-林口,2024-05-13,9257
4529,淳紳,8,0,8,凱基-林口,2024-05-13,9257
8349,�矬�,8,0,8,凱基-林口,2024-05-13,9257
2520,冠德,13,5,8,凱基-林口,2024-05-13,9257
1524,耿鼎,54,47,7,凱基-林口,2024-05-13,9257
2884,玉山金,10,3,7,凱基-林口,2024-05-13,9257
4562,穎漢,8,1,7,凱基-林口,2024-05-13,9257
6770,力積電,11,4,7,凱基-林口,2024-05-13,9257
00933B,國泰10Y+金融債,10,4,6,凱基-林口,2024-05-13,9257
2206,三陽工業,6,0,6,凱基-林口,2024-05-13,9257
2354,鴻準,7,1,6,凱基-林口,2024-05-13,9257
3303,岱稜,6,0,6,凱基-林口,2024-05-13,9257
2464,盟立,286,0,286,凱基-林口,2024-05-14,9257
2356,英業達,316,33,283,凱基-林口,2024-05-14,9257
00946,群益科技高息成長,300,70,230,凱基-林口,2024-05-14,9257
2486,一詮,238,21,217,凱基-林口,2024-05-14,9257
00665L,富邦�琤肭磪囓�2,70,0,70,凱基-林口,2024-05-14,9257
2615,萬海,160,91,69,凱基-林口,2024-05-14,9257
2374,佳能,94,32,62,凱基-林口,2024-05-14,9257
00878,國泰永續高股息,85,26,59,凱基-林口,2024-05-14,9257
00929,復華台灣科技優息,61,3,58,凱基-林口,2024-05-14,9257
00937B,群益ESG投等債20,55,7,48,凱基-林口,2024-05-14,9257
6215,和椿,41,2,39,凱基-林口,2024-05-14,9257
2317,鴻海,100,65,35,凱基-林口,2024-05-14,9257
3013,晟銘電,34,1,33,凱基-林口,2024-05-14,9257
00679B,元大美債20年,34,6,28,凱基-林口,2024-05-14,9257
3481,群創,31,5,26,凱基-林口,2024-05-14,9257
3062,建漢,26,0,26,凱基-林口,2024-05-14,9257
3231,緯創,25,4,21,凱基-林口,2024-05-14,9257
9945,潤泰新,19,0,19,凱基-林口,2024-05-14,9257
1608,華榮,22,4,18,凱基-林口,2024-05-14,9257
2516,新建,17,0,17,凱基-林口,2024-05-14,9257
2505,國揚,15,0,15,凱基-林口,2024-05-14,9257
00932,兆豐永續高息等權,14,0,14,凱基-林口,2024-05-14,9257
2316,楠梓電,13,0,13,凱基-林口,2024-05-14,9257
2834,臺企銀,15,2,13,凱基-林口,2024-05-14,9257
00632R,元大台灣50反1,12,0,12,凱基-林口,2024-05-14,9257
8227,巨有科技,15,3,12,凱基-林口,2024-05-14,9257
2542,興富發,12,1,11,凱基-林口,2024-05-14,9257
00941,中信上游半導體,10,0,10,凱基-林口,2024-05-14,9257
00934,中信成長高股息,10,0,10,凱基-林口,2024-05-14,9257
00902,中信電池及儲能,10,0,10,凱基-林口,2024-05-14,9257
1104,環泥,10,0,10,凱基-林口,2024-05-14,9257
1312,國喬,10,0,10,凱基-林口,2024-05-14,9257
1402,遠東新,10,0,10,凱基-林口,2024-05-14,9257
1455,集盛,10,0,10,凱基-林口,2024-05-14,9257
1714,和桐,10,0,10,凱基-林口,2024-05-14,9257
2444,兆勁,10,0,10,凱基-林口,2024-05-14,9257
2905,三商,10,0,10,凱基-林口,2024-05-14,9257
4167,松瑞藥,10,0,10,凱基-林口,2024-05-14,9257
5469,瀚宇博,10,0,10,凱基-林口,2024-05-14,9257
5533,皇鼎,10,0,10,凱基-林口,2024-05-14,9257
2915,潤泰全,19,10,9,凱基-林口,2024-05-14,9257
2801,彰銀,8,0,8,凱基-林口,2024-05-14,9257
00795B,中信美國公債20年,8,0,8,凱基-林口,2024-05-14,9257
8299,群聯,9,1,8,凱基-林口,2024-05-14,9257
00940,元大台灣價值高息,28,20,8,凱基-林口,2024-05-14,9257
2355,敬鵬,25,17,8,凱基-林口,2024-05-14,9257
2867,三商壽,8,0,8,凱基-林口,2024-05-14,9257
3211,順達,10,2,8,凱基-林口,2024-05-14,9257
1522,堤維西,27,20,7,凱基-林口,2024-05-14,9257
2105,正新,7,0,7,凱基-林口,2024-05-14,9257
00680L,元大美債20正2,605,0,605,凱基-林口,2024-05-15,9257
00929,復華台灣科技優息,224,20,204,凱基-林口,2024-05-15,9257
2323,中環,225,24,201,凱基-林口,2024-05-15,9257
2486,一詮,187,15,172,凱基-林口,2024-05-15,9257
2464,盟立,139,5,134,凱基-林口,2024-05-15,9257
00937B,群益ESG投等債20,128,4,124,凱基-林口,2024-05-15,9257
00919,群益台灣精選高息,140,19,121,凱基-林口,2024-05-15,9257
00878,國泰永續高股息,165,89,76,凱基-林口,2024-05-15,9257
00900,富邦特選高股息30,31,0,31,凱基-林口,2024-05-15,9257
4543,萬在,50,22,28,凱基-林口,2024-05-15,9257
00632R,元大台灣50反1,26,0,26,凱基-林口,2024-05-15,9257
4707,磐亞,24,0,24,凱基-林口,2024-05-15,9257
2704,國賓,22,0,22,凱基-林口,2024-05-15,9257
2354,鴻準,26,4,22,凱基-林口,2024-05-15,9257
3481,群創,29,8,21,凱基-林口,2024-05-15,9257
1815,富喬,20,0,20,凱基-林口,2024-05-15,9257
2301,光寶科,22,2,20,凱基-林口,2024-05-15,9257
5213,亞昕,20,0,20,凱基-林口,2024-05-15,9257
1614,三洋電,18,0,18,凱基-林口,2024-05-15,9257
2516,新建,18,0,18,凱基-林口,2024-05-15,9257
00679B,元大美債20年,21,4,17,凱基-林口,2024-05-15,9257
2376,技嘉,24,7,17,凱基-林口,2024-05-15,9257
2367,燿華,54,38,16,凱基-林口,2024-05-15,9257
5864,致和證,19,3,16,凱基-林口,2024-05-15,9257
00731,復華富時高息低波,15,0,15,凱基-林口,2024-05-15,9257
8349,�矬�,15,0,15,凱基-林口,2024-05-15,9257
2603,長榮,19,5,14,凱基-林口,2024-05-15,9257
3576,聯合再生,13,0,13,凱基-林口,2024-05-15,9257
4716,大立,14,1,13,凱基-林口,2024-05-15,9257
2611,志信,13,0,13,凱基-林口,2024-05-15,9257
2881,富邦金,65,53,12,凱基-林口,2024-05-15,9257
3287,廣寰科,53,41,12,凱基-林口,2024-05-15,9257
4161,聿新科,22,10,12,凱基-林口,2024-05-15,9257
1101,台泥,17,6,11,凱基-林口,2024-05-15,9257
1471,首利,12,1,11,凱基-林口,2024-05-15,9257
8481,政伸,11,0,11,凱基-林口,2024-05-15,9257
00941,中信上游半導體,10,0,10,凱基-林口,2024-05-15,9257
00706L,期元大S＆P日圓正2,10,0,10,凱基-林口,2024-05-15,9257
1312,國喬,10,0,10,凱基-林口,2024-05-15,9257
1611,中電,10,0,10,凱基-林口,2024-05-15,9257
2324,仁寶,11,1,10,凱基-林口,2024-05-15,9257
2444,兆勁,10,0,10,凱基-林口,2024-05-15,9257
2547,日勝生,10,0,10,凱基-林口,2024-05-15,9257
3162,精確,10,0,10,凱基-林口,2024-05-15,9257
3264,欣銓,14,4,10,凱基-林口,2024-05-15,9257
3708,上緯投控,15,5,10,凱基-林口,2024-05-15,9257
6807,峰源-KY,10,0,10,凱基-林口,2024-05-15,9257
00909,國泰數位支付服務,10,1,9,凱基-林口,2024-05-15,9257
4961,天鈺,10,1,9,凱基-林口,2024-05-15,9257
6443,元晶,11,2,9,凱基-林口,2024-05-15,9257
00680L,元大美債20正2,232,34,198,凱基-林口,2024-05-16,9257
00878,國泰永續高股息,138,18,120,凱基-林口,2024-05-16,9257
00753L,中信中國50正2,101,0,101,凱基-林口,2024-05-16,9257
00665L,富邦�琤肭磪囓�2,100,0,100,凱基-林口,2024-05-16,9257
00632R,元大台灣50反1,93,0,93,凱基-林口,2024-05-16,9257
00731,復華富時高息低波,80,0,80,凱基-林口,2024-05-16,9257
2605,新興,93,13,80,凱基-林口,2024-05-16,9257
1442,名軒,50,0,50,凱基-林口,2024-05-16,9257
5864,致和證,52,2,50,凱基-林口,2024-05-16,9257
2301,光寶科,48,1,47,凱基-林口,2024-05-16,9257
2356,英業達,46,7,39,凱基-林口,2024-05-16,9257
5443,均豪,40,3,37,凱基-林口,2024-05-16,9257
1612,宏泰,34,0,34,凱基-林口,2024-05-16,9257
00922,國泰台灣領袖50,35,1,34,凱基-林口,2024-05-16,9257
1608,華榮,55,25,30,凱基-林口,2024-05-16,9257
5521,工信,30,0,30,凱基-林口,2024-05-16,9257
2365,昆盈,25,0,25,凱基-林口,2024-05-16,9257
6189,豐藝,25,1,24,凱基-林口,2024-05-16,9257
6215,和椿,23,1,22,凱基-林口,2024-05-16,9257
3363,上詮,56,35,21,凱基-林口,2024-05-16,9257
6269,台郡,20,0,20,凱基-林口,2024-05-16,9257
2363,矽統,91,72,19,凱基-林口,2024-05-16,9257
6282,康舒,19,1,18,凱基-林口,2024-05-16,9257
3455,由田,20,5,15,凱基-林口,2024-05-16,9257
00891,中信關鍵半導體,23,10,13,凱基-林口,2024-05-16,9257
1605,華新,12,0,12,凱基-林口,2024-05-16,9257
5312,寶島科,12,0,12,凱基-林口,2024-05-16,9257
00944,野村趨勢動能高息,11,0,11,凱基-林口,2024-05-16,9257
6270,倍微,11,0,11,凱基-林口,2024-05-16,9257
00720B,元大投資級公司債,10,0,10,凱基-林口,2024-05-16,9257
00715L,期街口布蘭特正2,10,0,10,凱基-林口,2024-05-16,9257
1515,力山,10,0,10,凱基-林口,2024-05-16,9257
2362,藍天,174,164,10,凱基-林口,2024-05-16,9257
2547,日勝生,10,0,10,凱基-林口,2024-05-16,9257
6026,福邦證,10,0,10,凱基-林口,2024-05-16,9257
2383,台光電,10,1,9,凱基-林口,2024-05-16,9257
00929,復華台灣科技優息,26,17,9,凱基-林口,2024-05-16,9257
2360,致茂,10,1,9,凱基-林口,2024-05-16,9257
00679B,元大美債20年,18,10,8,凱基-林口,2024-05-16,9257
2486,一詮,14,6,8,凱基-林口,2024-05-16,9257
2739,寒舍,10,2,8,凱基-林口,2024-05-16,9257
2845,遠東銀,10,2,8,凱基-林口,2024-05-16,9257
3390,旭軟,8,0,8,凱基-林口,2024-05-16,9257
8040,九暘,8,0,8,凱基-林口,2024-05-16,9257
6274,台燿,65,57,8,凱基-林口,2024-05-16,9257
2891,中信金,12,4,8,凱基-林口,2024-05-16,9257
2618,長榮航,54,47,7,凱基-林口,2024-05-16,9257
2465,麗臺,7,0,7,凱基-林口,2024-05-16,9257
2881A,富邦特,7,0,7,凱基-林口,2024-05-16,9257
3303,岱稜,16,9,7,凱基-林口,2024-05-16,9257
00882,中信中國高股息,201,11,190,凱基-林口,2024-05-17,9257
00679B,元大美債20年,175,57,118,凱基-林口,2024-05-17,9257
00665L,富邦�琤肭磪囓�2,100,0,100,凱基-林口,2024-05-17,9257
00937B,群益ESG投等債20,108,21,87,凱基-林口,2024-05-17,9257
2486,一詮,218,132,86,凱基-林口,2024-05-17,9257
2867,三商壽,89,10,79,凱基-林口,2024-05-17,9257
00929,復華台灣科技優息,89,14,75,凱基-林口,2024-05-17,9257
6282,康舒,44,0,44,凱基-林口,2024-05-17,9257
6770,力積電,45,2,43,凱基-林口,2024-05-17,9257
2543,皇昌,45,4,41,凱基-林口,2024-05-17,9257
3043,科風,31,0,31,凱基-林口,2024-05-17,9257
2371,大同,32,2,30,凱基-林口,2024-05-17,9257
2489,瑞軒,42,12,30,凱基-林口,2024-05-17,9257
4562,穎漢,29,0,29,凱基-林口,2024-05-17,9257
3013,晟銘電,31,3,28,凱基-林口,2024-05-17,9257
3033,威健,30,5,25,凱基-林口,2024-05-17,9257
5457,宣德,30,5,25,凱基-林口,2024-05-17,9257
6237,驊訊,22,0,22,凱基-林口,2024-05-17,9257
00919,群益台灣精選高息,23,2,21,凱基-林口,2024-05-17,9257
00940,元大台灣價值高息,31,10,21,凱基-林口,2024-05-17,9257
2317,鴻海,22,5,17,凱基-林口,2024-05-17,9257
2408,南亞科,15,0,15,凱基-林口,2024-05-17,9257
2312,金寶,27,12,15,凱基-林口,2024-05-17,9257
2845,遠東銀,25,10,15,凱基-林口,2024-05-17,9257
2409,友達,19,5,14,凱基-林口,2024-05-17,9257
3481,群創,19,5,14,凱基-林口,2024-05-17,9257
00878,國泰永續高股息,44,30,14,凱基-林口,2024-05-17,9257
00946,群益科技高息成長,13,0,13,凱基-林口,2024-05-17,9257
2367,燿華,36,23,13,凱基-林口,2024-05-17,9257
912000,晨訊科-DR,13,0,13,凱基-林口,2024-05-17,9257
9945,潤泰新,18,6,12,凱基-林口,2024-05-17,9257
00753L,中信中國50正2,12,0,12,凱基-林口,2024-05-17,9257
4161,聿新科,12,0,12,凱基-林口,2024-05-17,9257
2027,大成鋼,13,1,12,凱基-林口,2024-05-17,9257
00944,野村趨勢動能高息,12,0,12,凱基-林口,2024-05-17,9257
1725,元禎,11,0,11,凱基-林口,2024-05-17,9257
2537,聯上發,11,0,11,凱基-林口,2024-05-17,9257
3059,華晶科,14,3,11,凱基-林口,2024-05-17,9257
3706,神達,17,6,11,凱基-林口,2024-05-17,9257
6438,迅得,11,0,11,凱基-林口,2024-05-17,9257
00902,中信電池及儲能,10,0,10,凱基-林口,2024-05-17,9257
00933B,國泰10Y+金融債,10,0,10,凱基-林口,2024-05-17,9257
00936,台新永續高息中小,10,0,10,凱基-林口,2024-05-17,9257
1301,台塑,10,0,10,凱基-林口,2024-05-17,9257
1314,中石化,21,11,10,凱基-林口,2024-05-17,9257
1524,耿鼎,13,3,10,凱基-林口,2024-05-17,9257
1532,勤美,10,0,10,凱基-林口,2024-05-17,9257
2364,倫飛,10,0,10,凱基-林口,2024-05-17,9257
2444,兆勁,10,0,10,凱基-林口,2024-05-17,9257
2514,龍邦,20,10,10,凱基-林口,2024-05-17,9257
00937B,群益ESG投等債20,92,2,90,凱基-林口,2024-05-20,9257
6164,華興,82,0,82,凱基-林口,2024-05-20,9257
2543,皇昌,62,0,62,凱基-林口,2024-05-20,9257
00929,復華台灣科技優息,82,21,61,凱基-林口,2024-05-20,9257
2836,高雄銀,58,5,53,凱基-林口,2024-05-20,9257
00665L,富邦�琤肭磪囓�2,50,0,50,凱基-林口,2024-05-20,9257
00878,國泰永續高股息,77,33,44,凱基-林口,2024-05-20,9257
2515,中工,40,5,35,凱基-林口,2024-05-20,9257
6269,台郡,30,0,30,凱基-林口,2024-05-20,9257
4562,穎漢,29,0,29,凱基-林口,2024-05-20,9257
2618,長榮航,120,95,25,凱基-林口,2024-05-20,9257
4161,聿新科,25,0,25,凱基-林口,2024-05-20,9257
3540,曜越,22,0,22,凱基-林口,2024-05-20,9257
2317,鴻海,27,6,21,凱基-林口,2024-05-20,9257
1617,榮星,21,0,21,凱基-林口,2024-05-20,9257
2486,一詮,24,3,21,凱基-林口,2024-05-20,9257
5009,榮剛,25,4,21,凱基-林口,2024-05-20,9257
5324,士開,21,0,21,凱基-林口,2024-05-20,9257
2467,志聖,32,12,20,凱基-林口,2024-05-20,9257
2027,大成鋼,67,48,19,凱基-林口,2024-05-20,9257
2374,佳能,47,28,19,凱基-林口,2024-05-20,9257
2359,所羅門,36,19,17,凱基-林口,2024-05-20,9257
5381,合正,26,10,16,凱基-林口,2024-05-20,9257
00687B,國泰20年美債,16,0,16,凱基-林口,2024-05-20,9257
3231,緯創,18,3,15,凱基-林口,2024-05-20,9257
1522,堤維西,15,0,15,凱基-林口,2024-05-20,9257
4938,和碩,16,2,14,凱基-林口,2024-05-20,9257
1591,駿吉-KY,15,1,14,凱基-林口,2024-05-20,9257
2025,千興,14,0,14,凱基-林口,2024-05-20,9257
2834,臺企銀,14,0,14,凱基-林口,2024-05-20,9257
6472,保瑞,13,0,13,凱基-林口,2024-05-20,9257
2609,陽明,18,6,12,凱基-林口,2024-05-20,9257
5469,瀚宇博,12,0,12,凱基-林口,2024-05-20,9257
3033,威健,11,0,11,凱基-林口,2024-05-20,9257
00943,兆豐電子高息等權,11,0,11,凱基-林口,2024-05-20,9257
2905,三商,11,0,11,凱基-林口,2024-05-20,9257
3703,欣陸,12,1,11,凱基-林口,2024-05-20,9257
3455,由田,11,1,10,凱基-林口,2024-05-20,9257
00933B,國泰10Y+金融債,10,0,10,凱基-林口,2024-05-20,9257
00655L,國泰中國A50正2,10,0,10,凱基-林口,2024-05-20,9257
2208,台船,12,2,10,凱基-林口,2024-05-20,9257
2329,華泰,13,3,10,凱基-林口,2024-05-20,9257
2501,國建,10,0,10,凱基-林口,2024-05-20,9257
2606,裕民,10,0,10,凱基-林口,2024-05-20,9257
3035,智原,10,0,10,凱基-林口,2024-05-20,9257
3712,永崴投控,10,0,10,凱基-林口,2024-05-20,9257
5488,松普,10,0,10,凱基-林口,2024-05-20,9257
6244,茂迪,10,0,10,凱基-林口,2024-05-20,9257
00679B,元大美債20年,11,1,10,凱基-林口,2024-05-20,9257
1609,大亞,16,7,9,凱基-林口,2024-05-20,9257
2323,中環,222,0,222,凱基-林口,2024-05-21,9257
00929,復華台灣科技優息,140,0,140,凱基-林口,2024-05-21,9257
2027,大成鋼,106,3,103,凱基-林口,2024-05-21,9257
2867,三商壽,92,8,84,凱基-林口,2024-05-21,9257
2340,台亞,60,0,60,凱基-林口,2024-05-21,9257
2618,長榮航,69,15,54,凱基-林口,2024-05-21,9257
2363,矽統,110,64,46,凱基-林口,2024-05-21,9257
00940,元大台灣價值高息,45,0,45,凱基-林口,2024-05-21,9257
2367,燿華,256,217,39,凱基-林口,2024-05-21,9257
3622,洋華,30,0,30,凱基-林口,2024-05-21,9257
00939,統一台灣高息動能,28,0,28,凱基-林口,2024-05-21,9257
1605,華新,32,5,27,凱基-林口,2024-05-21,9257
00878,國泰永續高股息,26,0,26,凱基-林口,2024-05-21,9257
00712,復華富時不動產,25,0,25,凱基-林口,2024-05-21,9257
2421,建準,23,0,23,凱基-林口,2024-05-21,9257
5864,致和證,22,0,22,凱基-林口,2024-05-21,9257
2801,彰銀,20,0,20,凱基-林口,2024-05-21,9257
2731,雄獅,20,0,20,凱基-林口,2024-05-21,9257
4562,穎漢,18,1,17,凱基-林口,2024-05-21,9257
2880,華南金,16,0,16,凱基-林口,2024-05-21,9257
912000,晨訊科-DR,16,0,16,凱基-林口,2024-05-21,9257
3264,欣銓,15,0,15,凱基-林口,2024-05-21,9257
1101,台泥,14,0,14,凱基-林口,2024-05-21,9257
2891,中信金,14,0,14,凱基-林口,2024-05-21,9257
00930,永豐ESG低碳高息,13,0,13,凱基-林口,2024-05-21,9257
00919,群益台灣精選高息,13,1,12,凱基-林口,2024-05-21,9257
5469,瀚宇博,12,0,12,凱基-林口,2024-05-21,9257
1313,聯成,12,0,12,凱基-林口,2024-05-21,9257
2243,宏旭-KY,12,0,12,凱基-林口,2024-05-21,9257
5230,雷笛克光學,18,7,11,凱基-林口,2024-05-21,9257
00706L,期元大S＆P日圓正2,10,0,10,凱基-林口,2024-05-21,9257
00931B,統一美債20年,10,0,10,凱基-林口,2024-05-21,9257
2374,佳能,180,170,10,凱基-林口,2024-05-21,9257
2915,潤泰全,10,0,10,凱基-林口,2024-05-21,9257
3024,憶聲,10,0,10,凱基-林口,2024-05-21,9257
3189,景碩,10,0,10,凱基-林口,2024-05-21,9257
3305,昇貿,15,5,10,凱基-林口,2024-05-21,9257
3413,京鼎,10,0,10,凱基-林口,2024-05-21,9257
5302,太欣,10,0,10,凱基-林口,2024-05-21,9257
5521,工信,10,0,10,凱基-林口,2024-05-21,9257
8271,宇瞻,10,0,10,凱基-林口,2024-05-21,9257
6933,AMAX-KY,10,1,9,凱基-林口,2024-05-21,9257
00936,台新永續高息中小,8,0,8,凱基-林口,2024-05-21,9257
1326,台化,8,0,8,凱基-林口,2024-05-21,9257
1442,名軒,10,2,8,凱基-林口,2024-05-21,9257
2014,中鴻,8,0,8,凱基-林口,2024-05-21,9257
2884,玉山金,18,10,8,凱基-林口,2024-05-21,9257
3017,奇鋐,12,4,8,凱基-林口,2024-05-21,9257
4533,協易機,17,9,8,凱基-林口,2024-05-21,9257
00772B,中信高評級公司債,7,0,7,凱基-林口,2024-05-21,9257
00680L,元大美債20正2,520,0,520,凱基-林口,2024-05-22,9257
00632R,元大台灣50反1,305,0,305,凱基-林口,2024-05-22,9257
2486,一詮,145,16,129,凱基-林口,2024-05-22,9257
00637L,元大滬深300正2,100,0,100,凱基-林口,2024-05-22,9257
00937B,群益ESG投等債20,94,0,94,凱基-林口,2024-05-22,9257
2888,新光金,70,0,70,凱基-林口,2024-05-22,9257
2883,凱基金,70,5,65,凱基-林口,2024-05-22,9257
5521,工信,65,0,65,凱基-林口,2024-05-22,9257
3047,訊舟,59,4,55,凱基-林口,2024-05-22,9257
00753L,中信中國50正2,102,50,52,凱基-林口,2024-05-22,9257
3013,晟銘電,128,79,49,凱基-林口,2024-05-22,9257
00713,元大台灣高息低波,48,0,48,凱基-林口,2024-05-22,9257
1504,東元,46,1,45,凱基-林口,2024-05-22,9257
2027,大成鋼,41,0,41,凱基-林口,2024-05-22,9257
6166,凌華,41,1,40,凱基-林口,2024-05-22,9257
1815,富喬,230,195,35,凱基-林口,2024-05-22,9257
6237,驊訊,35,0,35,凱基-林口,2024-05-22,9257
5347,世界,39,5,34,凱基-林口,2024-05-22,9257
8048,德勝,28,1,27,凱基-林口,2024-05-22,9257
3548,兆利,27,1,26,凱基-林口,2024-05-22,9257
2543,皇昌,41,16,25,凱基-林口,2024-05-22,9257
3033,威健,23,0,23,凱基-林口,2024-05-22,9257
6770,力積電,26,4,22,凱基-林口,2024-05-22,9257
2890,永豐金,22,0,22,凱基-林口,2024-05-22,9257
5213,亞昕,24,2,22,凱基-林口,2024-05-22,9257
6275,元山,23,1,22,凱基-林口,2024-05-22,9257
5880,合庫金,20,1,19,凱基-林口,2024-05-22,9257
8112,至上,18,0,18,凱基-林口,2024-05-22,9257
00929,復華台灣科技優息,38,21,17,凱基-林口,2024-05-22,9257
3450,聯鈞,19,2,17,凱基-林口,2024-05-22,9257
1612,宏泰,33,17,16,凱基-林口,2024-05-22,9257
3062,建漢,15,0,15,凱基-林口,2024-05-22,9257
1313,聯成,14,0,14,凱基-林口,2024-05-22,9257
2867,三商壽,24,10,14,凱基-林口,2024-05-22,9257
3163,波若威,17,3,14,凱基-林口,2024-05-22,9257
2421,建準,24,11,13,凱基-林口,2024-05-22,9257
6230,尼得科超眾,18,5,13,凱基-林口,2024-05-22,9257
8064,東捷,17,5,12,凱基-林口,2024-05-22,9257
2204,中華,12,0,12,凱基-林口,2024-05-22,9257
2352,佳世達,13,1,12,凱基-林口,2024-05-22,9257
2515,中工,12,0,12,凱基-林口,2024-05-22,9257
5351,鈺創,18,6,12,凱基-林口,2024-05-22,9257
2731,雄獅,18,7,11,凱基-林口,2024-05-22,9257
2504,國產,11,0,11,凱基-林口,2024-05-22,9257
4961,天鈺,11,0,11,凱基-林口,2024-05-22,9257
6514,芮特-KY,12,1,11,凱基-林口,2024-05-22,9257
00933B,國泰10Y+金融債,10,0,10,凱基-林口,2024-05-22,9257
00652,富邦印度,10,0,10,凱基-林口,2024-05-22,9257
2369,菱生,11,1,10,凱基-林口,2024-05-22,9257
2905,三商,10,0,10,凱基-林口,2024-05-22,9257
00937B,群益ESG投等債20,271,1,270,凱基-林口,2024-05-23,9257
8071,能率網通,181,1,180,凱基-林口,2024-05-23,9257
6166,凌華,153,0,153,凱基-林口,2024-05-23,9257
2618,長榮航,174,76,98,凱基-林口,2024-05-23,9257
2363,矽統,84,14,70,凱基-林口,2024-05-23,9257
3013,晟銘電,71,13,58,凱基-林口,2024-05-23,9257
00919,群益台灣精選高息,55,2,53,凱基-林口,2024-05-23,9257
00940,元大台灣價值高息,65,13,52,凱基-林口,2024-05-23,9257
2302,麗正,50,1,49,凱基-林口,2024-05-23,9257
1815,富喬,93,47,46,凱基-林口,2024-05-23,9257
2405,輔信,44,0,44,凱基-林口,2024-05-23,9257
00936,台新永續高息中小,42,0,42,凱基-林口,2024-05-23,9257
2453,凌群,42,3,39,凱基-林口,2024-05-23,9257
1314,中石化,31,0,31,凱基-林口,2024-05-23,9257
3017,奇鋐,45,14,31,凱基-林口,2024-05-23,9257
00945B,凱基美國非投等債,30,1,29,凱基-林口,2024-05-23,9257
4183,福永生技,29,0,29,凱基-林口,2024-05-23,9257
2905,三商,28,0,28,凱基-林口,2024-05-23,9257
3481,群創,158,133,25,凱基-林口,2024-05-23,9257
00687B,國泰20年美債,21,1,20,凱基-林口,2024-05-23,9257
00632R,元大台灣50反1,20,0,20,凱基-林口,2024-05-23,9257
1313,聯成,20,0,20,凱基-林口,2024-05-23,9257
3049,精金,20,0,20,凱基-林口,2024-05-23,9257
4942,嘉彰,20,0,20,凱基-林口,2024-05-23,9257
6285,啟��,22,4,18,凱基-林口,2024-05-23,9257
8112,至上,17,0,17,凱基-林口,2024-05-23,9257
1108,幸福,16,0,16,凱基-林口,2024-05-23,9257
2611,志信,16,0,16,凱基-林口,2024-05-23,9257
2886,兆豐金,16,1,15,凱基-林口,2024-05-23,9257
4128,中天,15,0,15,凱基-林口,2024-05-23,9257
2356,英業達,15,1,14,凱基-林口,2024-05-23,9257
3231,緯創,15,2,13,凱基-林口,2024-05-23,9257
1587,吉茂,22,10,12,凱基-林口,2024-05-23,9257
2883,凱基金,12,0,12,凱基-林口,2024-05-23,9257
3356,奇偶,12,0,12,凱基-林口,2024-05-23,9257
6147,頎邦,11,0,11,凱基-林口,2024-05-23,9257
2617,台航,11,0,11,凱基-林口,2024-05-23,9257
3033,威健,11,0,11,凱基-林口,2024-05-23,9257
3227,原相,12,1,11,凱基-林口,2024-05-23,9257
3264,欣銓,11,0,11,凱基-林口,2024-05-23,9257
3312,弘憶股,19,8,11,凱基-林口,2024-05-23,9257
4161,聿新科,36,25,11,凱基-林口,2024-05-23,9257
6282,康舒,15,4,11,凱基-林口,2024-05-23,9257
8040,九暘,11,0,11,凱基-林口,2024-05-23,9257
00715L,期街口布蘭特正2,10,0,10,凱基-林口,2024-05-23,9257
1447,力鵬,10,0,10,凱基-林口,2024-05-23,9257
1752,南光,20,10,10,凱基-林口,2024-05-23,9257
2509,全坤建,10,0,10,凱基-林口,2024-05-23,9257
2736,富野,10,0,10,凱基-林口,2024-05-23,9257
3162,精確,10,0,10,凱基-林口,2024-05-23,9257
00712,復華富時不動產,815,0,815,凱基-林口,2024-05-24,9257
00937B,群益ESG投等債20,532,110,422,凱基-林口,2024-05-24,9257
6166,凌華,152,7,145,凱基-林口,2024-05-24,9257
2344,華邦電,102,10,92,凱基-林口,2024-05-24,9257
6282,康舒,49,6,43,凱基-林口,2024-05-24,9257
2867,三商壽,35,0,35,凱基-林口,2024-05-24,9257
2303,聯電,30,1,29,凱基-林口,2024-05-24,9257
2027,大成鋼,26,0,26,凱基-林口,2024-05-24,9257
3062,建漢,46,20,26,凱基-林口,2024-05-24,9257
5706,鳳凰,25,0,25,凱基-林口,2024-05-24,9257
3694,海華,28,6,22,凱基-林口,2024-05-24,9257
00936,台新永續高息中小,21,0,21,凱基-林口,2024-05-24,9257
3481,群創,21,3,18,凱基-林口,2024-05-24,9257
3706,神達,25,7,18,凱基-林口,2024-05-24,9257
5213,亞昕,18,0,18,凱基-林口,2024-05-24,9257
6147,頎邦,17,0,17,凱基-林口,2024-05-24,9257
6209,今國光,18,1,17,凱基-林口,2024-05-24,9257
2367,燿華,36,20,16,凱基-林口,2024-05-24,9257
2845,遠東銀,15,0,15,凱基-林口,2024-05-24,9257
3163,波若威,17,2,15,凱基-林口,2024-05-24,9257
6770,力積電,19,5,14,凱基-林口,2024-05-24,9257
8255,朋程,14,0,14,凱基-林口,2024-05-24,9257
9906,欣巴巴,14,0,14,凱基-林口,2024-05-24,9257
2614,東森,15,2,13,凱基-林口,2024-05-24,9257
2851,中再保,12,0,12,凱基-林口,2024-05-24,9257
3049,精金,14,2,12,凱基-林口,2024-05-24,9257
3024,憶聲,11,0,11,凱基-林口,2024-05-24,9257
6706,惠特,11,0,11,凱基-林口,2024-05-24,9257
6284,佳邦,10,0,10,凱基-林口,2024-05-24,9257
00929,復華台灣科技優息,20,10,10,凱基-林口,2024-05-24,9257
00632R,元大台灣50反1,10,0,10,凱基-林口,2024-05-24,9257
00945B,凱基美國非投等債,10,0,10,凱基-林口,2024-05-24,9257
1752,南光,12,2,10,凱基-林口,2024-05-24,9257
2365,昆盈,105,95,10,凱基-林口,2024-05-24,9257
2442,新美齊,10,0,10,凱基-林口,2024-05-24,9257
2465,麗臺,11,1,10,凱基-林口,2024-05-24,9257
2476,鉅祥,10,0,10,凱基-林口,2024-05-24,9257
2546,根基,10,0,10,凱基-林口,2024-05-24,9257
5371,中光電,31,21,10,凱基-林口,2024-05-24,9257
6505,台塑化,11,1,10,凱基-林口,2024-05-24,9257
8906,花王,10,0,10,凱基-林口,2024-05-24,9257
2002,中鋼,9,0,9,凱基-林口,2024-05-24,9257
1503,士電,10,1,9,凱基-林口,2024-05-24,9257
2324,仁寶,18,9,9,凱基-林口,2024-05-24,9257
5521,工信,9,0,9,凱基-林口,2024-05-24,9257
2603,長榮,37,28,9,凱基-林口,2024-05-24,9257
3013,晟銘電,12,4,8,凱基-林口,2024-05-24,9257
2880,華南金,8,0,8,凱基-林口,2024-05-24,9257
00933B,國泰10Y+金融債,8,0,8,凱基-林口,2024-05-24,9257
00671R,富邦NASDAQ反1,8,0,8,凱基-林口,2024-05-24,9257
2353,宏��,607,142,465,凱基-林口,2024-05-27,9257
2486,一詮,304,68,236,凱基-林口,2024-05-27,9257
912000,晨訊科-DR,206,0,206,凱基-林口,2024-05-27,9257
9105,泰金寶-DR,204,0,204,凱基-林口,2024-05-27,9257
00946,群益科技高息成長,177,0,177,凱基-林口,2024-05-27,9257
00937B,群益ESG投等債20,165,6,159,凱基-林口,2024-05-27,9257
1815,富喬,209,89,120,凱基-林口,2024-05-27,9257
00753L,中信中國50正2,52,2,50,凱基-林口,2024-05-27,9257
2890,永豐金,70,20,50,凱基-林口,2024-05-27,9257
3033,威健,50,0,50,凱基-林口,2024-05-27,9257
2453,凌群,57,19,38,凱基-林口,2024-05-27,9257
6125,廣運,114,77,37,凱基-林口,2024-05-27,9257
2609,陽明,51,19,32,凱基-林口,2024-05-27,9257
2367,燿華,42,11,31,凱基-林口,2024-05-27,9257
2406,國碩,28,0,28,凱基-林口,2024-05-27,9257
6213,聯茂,30,2,28,凱基-林口,2024-05-27,9257
3013,晟銘電,84,58,26,凱基-林口,2024-05-27,9257
5706,鳳凰,25,0,25,凱基-林口,2024-05-27,9257
3169,亞信,25,1,24,凱基-林口,2024-05-27,9257
1303,南亞,23,2,21,凱基-林口,2024-05-27,9257
2543,皇昌,20,0,20,凱基-林口,2024-05-27,9257
3090,日電貿,20,0,20,凱基-林口,2024-05-27,9257
3363,上詮,23,3,20,凱基-林口,2024-05-27,9257
5213,亞昕,20,0,20,凱基-林口,2024-05-27,9257
2610,華航,27,8,19,凱基-林口,2024-05-27,9257
3481,群創,20,1,19,凱基-林口,2024-05-27,9257
2002,中鋼,18,0,18,凱基-林口,2024-05-27,9257
8103,瀚荃,18,0,18,凱基-林口,2024-05-27,9257
2368,金像電,19,2,17,凱基-林口,2024-05-27,9257
6234,高僑,18,1,17,凱基-林口,2024-05-27,9257
2801,彰銀,16,0,16,凱基-林口,2024-05-27,9257
00712,復華富時不動產,17,1,16,凱基-林口,2024-05-27,9257
00882,中信中國高股息,16,0,16,凱基-林口,2024-05-27,9257
2603,長榮,43,28,15,凱基-林口,2024-05-27,9257
5225,東科-KY,15,0,15,凱基-林口,2024-05-27,9257
3338,泰碩,30,15,15,凱基-林口,2024-05-27,9257
5498,凱崴,16,1,15,凱基-林口,2024-05-27,9257
1513,中興電,17,6,11,凱基-林口,2024-05-27,9257
00885,富邦越南,11,0,11,凱基-林口,2024-05-27,9257
2369,菱生,14,3,11,凱基-林口,2024-05-27,9257
00933B,國泰10Y+金融債,10,0,10,凱基-林口,2024-05-27,9257
1301,台塑,13,3,10,凱基-林口,2024-05-27,9257
00945B,凱基美國非投等債,10,0,10,凱基-林口,2024-05-27,9257
00902,中信電池及儲能,10,0,10,凱基-林口,2024-05-27,9257
2020,美亞,10,0,10,凱基-林口,2024-05-27,9257
2867,三商壽,10,0,10,凱基-林口,2024-05-27,9257
2880,華南金,10,0,10,凱基-林口,2024-05-27,9257
2888,新光金,15,5,10,凱基-林口,2024-05-27,9257
3035,智原,11,1,10,凱基-林口,2024-05-27,9257
5289,宜鼎,10,0,10,凱基-林口,2024-05-27,9257
6166,凌華,373,155,218,凱基-林口,2024-05-28,9257
00946,群益科技高息成長,87,4,83,凱基-林口,2024-05-28,9257
00918,大華優利高填息30,80,1,79,凱基-林口,2024-05-28,9257
2354,鴻準,80,30,50,凱基-林口,2024-05-28,9257
4720,德淵,45,0,45,凱基-林口,2024-05-28,9257
2353,宏��,137,96,41,凱基-林口,2024-05-28,9257
1316,上曜,41,1,40,凱基-林口,2024-05-28,9257
2609,陽明,60,23,37,凱基-林口,2024-05-28,9257
2363,矽統,82,49,33,凱基-林口,2024-05-28,9257
2367,燿華,37,7,30,凱基-林口,2024-05-28,9257
2421,建準,33,3,30,凱基-林口,2024-05-28,9257
6188,廣明,38,10,28,凱基-林口,2024-05-28,9257
3231,緯創,44,18,26,凱基-林口,2024-05-28,9257
2834,臺企銀,30,6,24,凱基-林口,2024-05-28,9257
2637,慧洋-KY,23,0,23,凱基-林口,2024-05-28,9257
00940,元大台灣價值高息,57,34,23,凱基-林口,2024-05-28,9257
2401,凌陽,39,17,22,凱基-林口,2024-05-28,9257
00665L,富邦�琤肭磪囓�2,21,0,21,凱基-林口,2024-05-28,9257
2376,技嘉,24,4,20,凱基-林口,2024-05-28,9257
8996,高力,25,5,20,凱基-林口,2024-05-28,9257
00632R,元大台灣50反1,20,0,20,凱基-林口,2024-05-28,9257
1303,南亞,20,0,20,凱基-林口,2024-05-28,9257
8150,南茂,20,0,20,凱基-林口,2024-05-28,9257
2615,萬海,21,1,20,凱基-林口,2024-05-28,9257
3594,磐儀,32,13,19,凱基-林口,2024-05-28,9257
2610,華航,67,49,18,凱基-林口,2024-05-28,9257
3372,典範,22,5,17,凱基-林口,2024-05-28,9257
4576,大銀微系統,17,0,17,凱基-林口,2024-05-28,9257
1308,亞聚,20,4,16,凱基-林口,2024-05-28,9257
00929,復華台灣科技優息,42,26,16,凱基-林口,2024-05-28,9257
2603,長榮,28,13,15,凱基-林口,2024-05-28,9257
3631,晟楠,15,0,15,凱基-林口,2024-05-28,9257
2002,中鋼,15,0,15,凱基-林口,2024-05-28,9257
00687B,國泰20年美債,33,19,14,凱基-林口,2024-05-28,9257
2402,毅嘉,20,6,14,凱基-林口,2024-05-28,9257
3363,上詮,15,1,14,凱基-林口,2024-05-28,9257
2317,鴻海,19,5,14,凱基-林口,2024-05-28,9257
2467,志聖,13,0,13,凱基-林口,2024-05-28,9257
00712,復華富時不動產,13,0,13,凱基-林口,2024-05-28,9257
2905,三商,16,3,13,凱基-林口,2024-05-28,9257
3356,奇偶,13,0,13,凱基-林口,2024-05-28,9257
3202,樺晟,12,0,12,凱基-林口,2024-05-28,9257
2464,盟立,43,32,11,凱基-林口,2024-05-28,9257
00933B,國泰10Y+金融債,11,0,11,凱基-林口,2024-05-28,9257
2340,台亞,11,0,11,凱基-林口,2024-05-28,9257
2501,國建,11,0,11,凱基-林口,2024-05-28,9257
2382,廣達,10,0,10,凱基-林口,2024-05-28,9257
5371,中光電,33,23,10,凱基-林口,2024-05-28,9257
1570,力肯,10,0,10,凱基-林口,2024-05-28,9257
1605,華新,11,1,10,凱基-林口,2024-05-28,9257
2486,一詮,201,8,193,凱基-林口,2024-05-29,9257
6166,凌華,337,204,133,凱基-林口,2024-05-29,9257
2489,瑞軒,141,19,122,凱基-林口,2024-05-29,9257
2401,凌陽,193,71,122,凱基-林口,2024-05-29,9257
00929,復華台灣科技優息,124,51,73,凱基-林口,2024-05-29,9257
00679B,元大美債20年,63,0,63,凱基-林口,2024-05-29,9257
00664R,國泰臺灣加權反1,50,0,50,凱基-林口,2024-05-29,9257
2883,凱基金,51,5,46,凱基-林口,2024-05-29,9257
8048,德勝,45,0,45,凱基-林口,2024-05-29,9257
00946,群益科技高息成長,38,0,38,凱基-林口,2024-05-29,9257
2363,矽統,36,1,35,凱基-林口,2024-05-29,9257
4714,永捷,35,0,35,凱基-林口,2024-05-29,9257
2610,華航,42,9,33,凱基-林口,2024-05-29,9257
00878,國泰永續高股息,31,1,30,凱基-林口,2024-05-29,9257
6227,茂綸,32,2,30,凱基-林口,2024-05-29,9257
2354,鴻準,101,71,30,凱基-林口,2024-05-29,9257
2801,彰銀,29,0,29,凱基-林口,2024-05-29,9257
2887,台新金,31,3,28,凱基-林口,2024-05-29,9257
3062,建漢,30,2,28,凱基-林口,2024-05-29,9257
3048,益登,42,15,27,凱基-林口,2024-05-29,9257
2880,華南金,25,0,25,凱基-林口,2024-05-29,9257
5425,台半,25,0,25,凱基-林口,2024-05-29,9257
2618,長榮航,43,19,24,凱基-林口,2024-05-29,9257
00940,元大台灣價值高息,55,31,24,凱基-林口,2024-05-29,9257
00687B,國泰20年美債,34,10,24,凱基-林口,2024-05-29,9257
2884,玉山金,26,3,23,凱基-林口,2024-05-29,9257
00795B,中信美國公債20年,23,0,23,凱基-林口,2024-05-29,9257
6160,欣技,27,4,23,凱基-林口,2024-05-29,9257
2328,廣宇,39,17,22,凱基-林口,2024-05-29,9257
1517,利奇,20,0,20,凱基-林口,2024-05-29,9257
2421,建準,20,1,19,凱基-林口,2024-05-29,9257
2002,中鋼,18,0,18,凱基-林口,2024-05-29,9257
2886,兆豐金,17,0,17,凱基-林口,2024-05-29,9257
1303,南亞,19,2,17,凱基-林口,2024-05-29,9257
00882,中信中國高股息,17,0,17,凱基-林口,2024-05-29,9257
2362,藍天,17,0,17,凱基-林口,2024-05-29,9257
2303,聯電,30,13,17,凱基-林口,2024-05-29,9257
1309,台達化,15,0,15,凱基-林口,2024-05-29,9257
1516,川飛,15,0,15,凱基-林口,2024-05-29,9257
2501,國建,15,0,15,凱基-林口,2024-05-29,9257
3013,晟銘電,46,32,14,凱基-林口,2024-05-29,9257
00712,復華富時不動產,13,0,13,凱基-林口,2024-05-29,9257
3035,智原,15,2,13,凱基-林口,2024-05-29,9257
3588,通嘉,14,1,13,凱基-林口,2024-05-29,9257
5706,鳳凰,12,0,12,凱基-林口,2024-05-29,9257
8996,高力,17,5,12,凱基-林口,2024-05-29,9257
2615,萬海,21,10,11,凱基-林口,2024-05-29,9257
2834,臺企銀,11,0,11,凱基-林口,2024-05-29,9257
5880,合庫金,11,0,11,凱基-林口,2024-05-29,9257
00918,大華優利高填息30,11,0,11,凱基-林口,2024-05-29,9257
00679B,元大美債20年,157,15,142,凱基-林口,2024-05-30,9257
2613,中櫃,129,21,108,凱基-林口,2024-05-30,9257
00937B,群益ESG投等債20,95,1,94,凱基-林口,2024-05-30,9257
2363,矽統,81,3,78,凱基-林口,2024-05-30,9257
2610,華航,80,4,76,凱基-林口,2024-05-30,9257
00929,復華台灣科技優息,77,2,75,凱基-林口,2024-05-30,9257
2486,一詮,83,14,69,凱基-林口,2024-05-30,9257
6166,凌華,64,0,64,凱基-林口,2024-05-30,9257
3360,尚立,63,0,63,凱基-林口,2024-05-30,9257
2543,皇昌,58,0,58,凱基-林口,2024-05-30,9257
3481,群創,54,1,53,凱基-林口,2024-05-30,9257
2489,瑞軒,222,178,44,凱基-林口,2024-05-30,9257
00940,元大台灣價值高息,44,1,43,凱基-林口,2024-05-30,9257
4906,正文,56,13,43,凱基-林口,2024-05-30,9257
8046,南電,43,0,43,凱基-林口,2024-05-30,9257
2349,錸德,40,0,40,凱基-林口,2024-05-30,9257
2353,宏��,46,7,39,凱基-林口,2024-05-30,9257
00680L,元大美債20正2,36,0,36,凱基-林口,2024-05-30,9257
3356,奇偶,33,1,32,凱基-林口,2024-05-30,9257
1304,台聚,31,0,31,凱基-林口,2024-05-30,9257
0056,元大高股息,32,2,30,凱基-林口,2024-05-30,9257
3379,彬台,30,0,30,凱基-林口,2024-05-30,9257
2356,英業達,28,0,28,凱基-林口,2024-05-30,9257
2887,台新金,28,0,28,凱基-林口,2024-05-30,9257
3013,晟銘電,34,7,27,凱基-林口,2024-05-30,9257
2417,圓剛,27,0,27,凱基-林口,2024-05-30,9257
2312,金寶,30,4,26,凱基-林口,2024-05-30,9257
00720B,元大投資級公司債,23,0,23,凱基-林口,2024-05-30,9257
1442,名軒,21,0,21,凱基-林口,2024-05-30,9257
2354,鴻準,26,5,21,凱基-林口,2024-05-30,9257
3363,上詮,27,8,19,凱基-林口,2024-05-30,9257
3706,神達,20,1,19,凱基-林口,2024-05-30,9257
00918,大華優利高填息30,18,1,17,凱基-林口,2024-05-30,9257
00915,凱基優選高股息30,17,0,17,凱基-林口,2024-05-30,9257
1303,南亞,19,2,17,凱基-林口,2024-05-30,9257
2367,燿華,25,8,17,凱基-林口,2024-05-30,9257
00946,群益科技高息成長,16,0,16,凱基-林口,2024-05-30,9257
3049,精金,23,7,16,凱基-林口,2024-05-30,9257
0050,元大台灣50,16,0,16,凱基-林口,2024-05-30,9257
00941,中信上游半導體,16,0,16,凱基-林口,2024-05-30,9257
5706,鳳凰,15,0,15,凱基-林口,2024-05-30,9257
00688L,國泰20年美債正2,15,0,15,凱基-林口,2024-05-30,9257
2317,鴻海,21,7,14,凱基-林口,2024-05-30,9257
00712,復華富時不動產,14,0,14,凱基-林口,2024-05-30,9257
6274,台燿,13,0,13,凱基-林口,2024-05-30,9257
00687B,國泰20年美債,13,0,13,凱基-林口,2024-05-30,9257
2607,榮運,13,0,13,凱基-林口,2024-05-30,9257
1536,和大,13,1,12,凱基-林口,2024-05-30,9257
1618,合機,12,0,12,凱基-林口,2024-05-30,9257
2888,新光金,27,15,12,凱基-林口,2024-05-30,9257
2486,一詮,247,45,202,凱基-林口,2024-05-31,9257
00671R,富邦NASDAQ反1,150,0,150,凱基-林口,2024-05-31,9257
2312,金寶,137,6,131,凱基-林口,2024-05-31,9257
2609,陽明,201,84,117,凱基-林口,2024-05-31,9257
2515,中工,137,23,114,凱基-林口,2024-05-31,9257
4906,正文,103,5,98,凱基-林口,2024-05-31,9257
00637L,元大滬深300正2,80,0,80,凱基-林口,2024-05-31,9257
00929,復華台灣科技優息,76,0,76,凱基-林口,2024-05-31,9257
00946,群益科技高息成長,55,0,55,凱基-林口,2024-05-31,9257
2317,鴻海,53,2,51,凱基-林口,2024-05-31,9257
2543,皇昌,52,2,50,凱基-林口,2024-05-31,9257
3047,訊舟,61,13,48,凱基-林口,2024-05-31,9257
00939,統一台灣高息動能,38,0,38,凱基-林口,2024-05-31,9257
5469,瀚宇博,35,0,35,凱基-林口,2024-05-31,9257
8210,勤誠,41,6,35,凱基-林口,2024-05-31,9257
1313,聯成,30,0,30,凱基-林口,2024-05-31,9257
1701,中化,30,0,30,凱基-林口,2024-05-31,9257
3016,嘉晶,30,0,30,凱基-林口,2024-05-31,9257
3622,洋華,30,0,30,凱基-林口,2024-05-31,9257
2498,宏達電,29,0,29,凱基-林口,2024-05-31,9257
00665L,富邦�琤肭磪囓�2,50,22,28,凱基-林口,2024-05-31,9257
00940,元大台灣價值高息,28,1,27,凱基-林口,2024-05-31,9257
3231,緯創,34,7,27,凱基-林口,2024-05-31,9257
3322,建舜電,22,0,22,凱基-林口,2024-05-31,9257
2303,聯電,25,4,21,凱基-林口,2024-05-31,9257
2258,鴻華先進-創,20,0,20,凱基-林口,2024-05-31,9257
3631,晟楠,20,0,20,凱基-林口,2024-05-31,9257
2353,宏��,30,11,19,凱基-林口,2024-05-31,9257
3033,威健,20,1,19,凱基-林口,2024-05-31,9257
2887,台新金,19,1,18,凱基-林口,2024-05-31,9257
1410,南染,17,0,17,凱基-林口,2024-05-31,9257
2603,長榮,62,45,17,凱基-林口,2024-05-31,9257
2002,中鋼,17,1,16,凱基-林口,2024-05-31,9257
2489,瑞軒,24,9,15,凱基-林口,2024-05-31,9257
3024,憶聲,15,0,15,凱基-林口,2024-05-31,9257
2492,華新科,19,4,15,凱基-林口,2024-05-31,9257
3312,弘憶股,26,12,14,凱基-林口,2024-05-31,9257
3227,原相,16,2,14,凱基-林口,2024-05-31,9257
6770,力積電,14,0,14,凱基-林口,2024-05-31,9257
0050,元大台灣50,15,1,14,凱基-林口,2024-05-31,9257
1536,和大,15,2,13,凱基-林口,2024-05-31,9257
1725,元禎,13,0,13,凱基-林口,2024-05-31,9257
2340,台亞,15,2,13,凱基-林口,2024-05-31,9257
2634,漢翔,12,0,12,凱基-林口,2024-05-31,9257
1815,富喬,130,118,12,凱基-林口,2024-05-31,9257
2363,矽統,13,1,12,凱基-林口,2024-05-31,9257
6552,易華電,12,0,12,凱基-林口,2024-05-31,9257
00918,大華優利高填息30,11,0,11,凱基-林口,2024-05-31,9257
2344,華邦電,11,1,10,凱基-林口,2024-05-31,9257
2457,飛宏,10,0,10,凱基-林口,2024-05-31,9257
4906,正文,814,3,811,凱基-林口,2024-06-03,9257
00680L,元大美債20正2,660,390,270,凱基-林口,2024-06-03,9257
00918,大華優利高填息30,136,0,136,凱基-林口,2024-06-03,9257
00935,野村臺灣新科技50,101,0,101,凱基-林口,2024-06-03,9257
00637L,元大滬深300正2,80,1,79,凱基-林口,2024-06-03,9257
2618,長榮航,85,16,69,凱基-林口,2024-06-03,9257
2427,三商電,60,5,55,凱基-林口,2024-06-03,9257
00712,復華富時不動產,53,1,52,凱基-林口,2024-06-03,9257
4939,亞電,50,0,50,凱基-林口,2024-06-03,9257
2377,微星,62,13,49,凱基-林口,2024-06-03,9257
6270,倍微,52,3,49,凱基-林口,2024-06-03,9257
6770,力積電,48,0,48,凱基-林口,2024-06-03,9257
00946,群益科技高息成長,55,9,46,凱基-林口,2024-06-03,9257
00919,群益台灣精選高息,48,2,46,凱基-林口,2024-06-03,9257
00929,復華台灣科技優息,54,12,42,凱基-林口,2024-06-03,9257
3706,神達,38,0,38,凱基-林口,2024-06-03,9257
2002,中鋼,37,6,31,凱基-林口,2024-06-03,9257
3481,群創,44,16,28,凱基-林口,2024-06-03,9257
6290,良維,73,50,23,凱基-林口,2024-06-03,9257
3059,華晶科,35,15,20,凱基-林口,2024-06-03,9257
3622,洋華,20,0,20,凱基-林口,2024-06-03,9257
3033,威健,20,1,19,凱基-林口,2024-06-03,9257
5469,瀚宇博,19,0,19,凱基-林口,2024-06-03,9257
2356,英業達,35,17,18,凱基-林口,2024-06-03,9257
6269,台郡,18,0,18,凱基-林口,2024-06-03,9257
2317,鴻海,35,17,18,凱基-林口,2024-06-03,9257
00882,中信中國高股息,17,0,17,凱基-林口,2024-06-03,9257
3356,奇偶,17,0,17,凱基-林口,2024-06-03,9257
4540,全球傳動,17,0,17,凱基-林口,2024-06-03,9257
2383,台光電,17,1,16,凱基-林口,2024-06-03,9257
2610,華航,17,1,16,凱基-林口,2024-06-03,9257
2303,聯電,16,1,15,凱基-林口,2024-06-03,9257
2353,宏��,25,10,15,凱基-林口,2024-06-03,9257
1802,台玻,20,5,15,凱基-林口,2024-06-03,9257
3372,典範,15,0,15,凱基-林口,2024-06-03,9257
3511,矽瑪,15,0,15,凱基-林口,2024-06-03,9257
1605,華新,14,0,14,凱基-林口,2024-06-03,9257
1815,富喬,211,198,13,凱基-林口,2024-06-03,9257
2641,正德,15,2,13,凱基-林口,2024-06-03,9257
2867,三商壽,18,5,13,凱基-林口,2024-06-03,9257
1303,南亞,18,6,12,凱基-林口,2024-06-03,9257
00715L,期街口布蘭特正2,12,0,12,凱基-林口,2024-06-03,9257
2020,美亞,12,0,12,凱基-林口,2024-06-03,9257
2401,凌陽,44,32,12,凱基-林口,2024-06-03,9257
5864,致和證,12,0,12,凱基-林口,2024-06-03,9257
00679B,元大美債20年,28,17,11,凱基-林口,2024-06-03,9257
00915,凱基優選高股息30,10,0,10,凱基-林口,2024-06-03,9257
00922,國泰台灣領袖50,10,0,10,凱基-林口,2024-06-03,9257
00650L,復華香港正2,15,5,10,凱基-林口,2024-06-03,9257
1313,聯成,10,0,10,凱基-林口,2024-06-03,9257
4906,正文,291,0,291,凱基-林口,2024-06-04,9257
3013,晟銘電,164,22,142,凱基-林口,2024-06-04,9257
00919,群益台灣精選高息,128,5,123,凱基-林口,2024-06-04,9257
2049,上銀,78,1,77,凱基-林口,2024-06-04,9257
3260,威剛,79,3,76,凱基-林口,2024-06-04,9257
1815,富喬,222,157,65,凱基-林口,2024-06-04,9257
00929,復華台灣科技優息,68,10,58,凱基-林口,2024-06-04,9257
2425,承啟,51,0,51,凱基-林口,2024-06-04,9257
2888,新光金,68,18,50,凱基-林口,2024-06-04,9257
6197,佳必琪,50,0,50,凱基-林口,2024-06-04,9257
6125,廣運,110,61,49,凱基-林口,2024-06-04,9257
2834,臺企銀,41,0,41,凱基-林口,2024-06-04,9257
00936,台新永續高息中小,48,9,39,凱基-林口,2024-06-04,9257
2367,燿華,65,26,39,凱基-林口,2024-06-04,9257
6164,華興,36,0,36,凱基-林口,2024-06-04,9257
2889,國票金,34,0,34,凱基-林口,2024-06-04,9257
4939,亞電,34,0,34,凱基-林口,2024-06-04,9257
6274,台燿,95,61,34,凱基-林口,2024-06-04,9257
2317,鴻海,37,4,33,凱基-林口,2024-06-04,9257
00878,國泰永續高股息,30,0,30,凱基-林口,2024-06-04,9257
3580,友威科,30,0,30,凱基-林口,2024-06-04,9257
2887,台新金,27,0,27,凱基-林口,2024-06-04,9257
00857B,永豐20年美公債,31,5,26,凱基-林口,2024-06-04,9257
2324,仁寶,26,1,25,凱基-林口,2024-06-04,9257
3338,泰碩,29,5,24,凱基-林口,2024-06-04,9257
4303,信立,28,4,24,凱基-林口,2024-06-04,9257
1102,亞泥,23,0,23,凱基-林口,2024-06-04,9257
00722B,群益投資級電信債,20,0,20,凱基-林口,2024-06-04,9257
3481,群創,77,57,20,凱基-林口,2024-06-04,9257
3035,智原,20,1,19,凱基-林口,2024-06-04,9257
00940,元大台灣價值高息,44,26,18,凱基-林口,2024-06-04,9257
2618,長榮航,22,4,18,凱基-林口,2024-06-04,9257
5519,隆大,21,3,18,凱基-林口,2024-06-04,9257
6166,凌華,23,6,17,凱基-林口,2024-06-04,9257
6215,和椿,30,13,17,凱基-林口,2024-06-04,9257
3231,緯創,21,5,16,凱基-林口,2024-06-04,9257
2891,中信金,16,0,16,凱基-林口,2024-06-04,9257
2489,瑞軒,16,0,16,凱基-林口,2024-06-04,9257
6163,華電網,16,0,16,凱基-林口,2024-06-04,9257
00715L,期街口布蘭特正2,15,0,15,凱基-林口,2024-06-04,9257
2417,圓剛,14,0,14,凱基-林口,2024-06-04,9257
4967,十銓,32,18,14,凱基-林口,2024-06-04,9257
5864,致和證,18,5,13,凱基-林口,2024-06-04,9257
4526,東台,16,3,13,凱基-林口,2024-06-04,9257
2809,京城銀,13,1,12,凱基-林口,2024-06-04,9257
3049,精金,12,0,12,凱基-林口,2024-06-04,9257
5230,雷笛克光學,21,9,12,凱基-林口,2024-06-04,9257
2344,華邦電,12,0,12,凱基-林口,2024-06-04,9257
1301,台塑,13,2,11,凱基-林口,2024-06-04,9257
3511,矽瑪,11,0,11,凱基-林口,2024-06-04,9257
00680L,元大美債20正2,669,0,669,凱基-林口,2024-06-05,9257
4906,正文,285,10,275,凱基-林口,2024-06-05,9257
2888,新光金,226,9,217,凱基-林口,2024-06-05,9257
2915,潤泰全,130,0,130,凱基-林口,2024-06-05,9257
00918,大華優利高填息30,112,0,112,凱基-林口,2024-06-05,9257
8047,星雲,105,1,104,凱基-林口,2024-06-05,9257
00878,國泰永續高股息,87,20,67,凱基-林口,2024-06-05,9257
3260,威剛,62,3,59,凱基-林口,2024-06-05,9257
2402,毅嘉,50,0,50,凱基-林口,2024-06-05,9257
2344,華邦電,42,1,41,凱基-林口,2024-06-05,9257
4303,信立,38,0,38,凱基-林口,2024-06-05,9257
00929,復華台灣科技優息,52,15,37,凱基-林口,2024-06-05,9257
00936,台新永續高息中小,35,0,35,凱基-林口,2024-06-05,9257
00942B,台新美A公司債20+,32,0,32,凱基-林口,2024-06-05,9257
2303,聯電,51,20,31,凱基-林口,2024-06-05,9257
2397,友通,30,0,30,凱基-林口,2024-06-05,9257
2002,中鋼,30,1,29,凱基-林口,2024-06-05,9257
3048,益登,37,8,29,凱基-林口,2024-06-05,9257
9945,潤泰新,22,0,22,凱基-林口,2024-06-05,9257
1301,台塑,23,1,22,凱基-林口,2024-06-05,9257
00933B,國泰10Y+金融債,20,0,20,凱基-林口,2024-06-05,9257
2328,廣宇,83,63,20,凱基-林口,2024-06-05,9257
2520,冠德,21,1,20,凱基-林口,2024-06-05,9257
2867,三商壽,20,0,20,凱基-林口,2024-06-05,9257
6152,百一,20,0,20,凱基-林口,2024-06-05,9257
0056,元大高股息,18,0,18,凱基-林口,2024-06-05,9257
3231,緯創,19,2,17,凱基-林口,2024-06-05,9257
00712,復華富時不動產,16,0,16,凱基-林口,2024-06-05,9257
2495,普安,30,15,15,凱基-林口,2024-06-05,9257
5213,亞昕,15,0,15,凱基-林口,2024-06-05,9257
2317,鴻海,77,62,15,凱基-林口,2024-06-05,9257
2324,仁寶,15,1,14,凱基-林口,2024-06-05,9257
3013,晟銘電,22,8,14,凱基-林口,2024-06-05,9257
3481,群創,25,13,12,凱基-林口,2024-06-05,9257
1605,華新,12,0,12,凱基-林口,2024-06-05,9257
4533,協易機,14,2,12,凱基-林口,2024-06-05,9257
2353,宏��,20,9,11,凱基-林口,2024-06-05,9257
3035,智原,12,1,11,凱基-林口,2024-06-05,9257
3356,奇偶,15,4,11,凱基-林口,2024-06-05,9257
2376,技嘉,14,4,10,凱基-林口,2024-06-05,9257
5880,合庫金,10,0,10,凱基-林口,2024-06-05,9257
2107,厚生,10,0,10,凱基-林口,2024-06-05,9257
2538,基泰,10,0,10,凱基-林口,2024-06-05,9257
3380,明泰,10,0,10,凱基-林口,2024-06-05,9257
4938,和碩,10,0,10,凱基-林口,2024-06-05,9257
4939,亞電,10,0,10,凱基-林口,2024-06-05,9257
5009,榮剛,11,1,10,凱基-林口,2024-06-05,9257
6147,頎邦,10,0,10,凱基-林口,2024-06-05,9257
2356,英業達,12,3,9,凱基-林口,2024-06-05,9257
8028,昇陽半導體,10,1,9,凱基-林口,2024-06-05,9257
00687B,國泰20年美債,170,3,167,凱基-林口,2024-06-06,9257
3163,波若威,71,5,66,凱基-林口,2024-06-06,9257
3013,晟銘電,65,6,59,凱基-林口,2024-06-06,9257
2838,聯邦銀,55,0,55,凱基-林口,2024-06-06,9257
6274,台燿,49,0,49,凱基-林口,2024-06-06,9257
00936,台新永續高息中小,56,14,42,凱基-林口,2024-06-06,9257
2427,三商電,44,4,40,凱基-林口,2024-06-06,9257
3706,神達,41,1,40,凱基-林口,2024-06-06,9257
2609,陽明,144,107,37,凱基-林口,2024-06-06,9257
00632R,元大台灣50反1,33,0,33,凱基-林口,2024-06-06,9257
4161,聿新科,31,0,31,凱基-林口,2024-06-06,9257
2498,宏達電,28,0,28,凱基-林口,2024-06-06,9257
3580,友威科,27,0,27,凱基-林口,2024-06-06,9257
00915,凱基優選高股息30,50,25,25,凱基-林口,2024-06-06,9257
1303,南亞,25,0,25,凱基-林口,2024-06-06,9257
2049,上銀,23,0,23,凱基-林口,2024-06-06,9257
2323,中環,22,0,22,凱基-林口,2024-06-06,9257
2881,富邦金,25,3,22,凱基-林口,2024-06-06,9257
5515,建國,21,0,21,凱基-林口,2024-06-06,9257
3481,群創,22,1,21,凱基-林口,2024-06-06,9257
00662,富邦NASDAQ,20,0,20,凱基-林口,2024-06-06,9257
6152,百一,20,0,20,凱基-林口,2024-06-06,9257
1722,台肥,20,0,20,凱基-林口,2024-06-06,9257
00878,國泰永續高股息,29,9,20,凱基-林口,2024-06-06,9257
2312,金寶,73,54,19,凱基-林口,2024-06-06,9257
5381,合正,19,0,19,凱基-林口,2024-06-06,9257
4939,亞電,17,0,17,凱基-林口,2024-06-06,9257
3033,威健,20,3,17,凱基-林口,2024-06-06,9257
2002,中鋼,19,3,16,凱基-林口,2024-06-06,9257
2330,台積電,31,15,16,凱基-林口,2024-06-06,9257
3017,奇鋐,27,12,15,凱基-林口,2024-06-06,9257
00680L,元大美債20正2,25,10,15,凱基-林口,2024-06-06,9257
2417,圓剛,17,2,15,凱基-林口,2024-06-06,9257
3062,建漢,28,13,15,凱基-林口,2024-06-06,9257
2328,廣宇,52,38,14,凱基-林口,2024-06-06,9257
3227,原相,14,0,14,凱基-林口,2024-06-06,9257
5608,四維航,20,6,14,凱基-林口,2024-06-06,9257
9105,泰金寶-DR,15,1,14,凱基-林口,2024-06-06,9257
5388,中磊,14,0,14,凱基-林口,2024-06-06,9257
00882,中信中國高股息,22,10,12,凱基-林口,2024-06-06,9257
00895,富邦未來車,12,0,12,凱基-林口,2024-06-06,9257
1536,和大,12,0,12,凱基-林口,2024-06-06,9257
00929,復華台灣科技優息,24,13,11,凱基-林口,2024-06-06,9257
5880,合庫金,11,0,11,凱基-林口,2024-06-06,9257
00720B,元大投資級公司債,11,0,11,凱基-林口,2024-06-06,9257
2495,普安,11,0,11,凱基-林口,2024-06-06,9257
3268,海德威,11,0,11,凱基-林口,2024-06-06,9257
00751B,元大AAA至A公司債,18,8,10,凱基-林口,2024-06-06,9257
2458,義隆,10,0,10,凱基-林口,2024-06-06,9257
00931B,統一美債20年,10,0,10,凱基-林口,2024-06-06,9257
2312,金寶,232,21,211,凱基-林口,2024-06-07,9257
8103,瀚荃,203,2,201,凱基-林口,2024-06-07,9257
00687B,國泰20年美債,154,17,137,凱基-林口,2024-06-07,9257
2834,臺企銀,103,17,86,凱基-林口,2024-06-07,9257
00942B,台新美A公司債20+,70,0,70,凱基-林口,2024-06-07,9257
2838,聯邦銀,60,0,60,凱基-林口,2024-06-07,9257
4906,正文,55,1,54,凱基-林口,2024-06-07,9257
2615,萬海,129,82,47,凱基-林口,2024-06-07,9257
00900,富邦特選高股息30,52,5,47,凱基-林口,2024-06-07,9257
2353,宏��,44,4,40,凱基-林口,2024-06-07,9257
3558,神準,41,1,40,凱基-林口,2024-06-07,9257
3231,緯創,43,5,38,凱基-林口,2024-06-07,9257
2331,精英,43,5,38,凱基-林口,2024-06-07,9257
00878,國泰永續高股息,52,15,37,凱基-林口,2024-06-07,9257
00936,台新永續高息中小,31,0,31,凱基-林口,2024-06-07,9257
2882,國泰金,30,2,28,凱基-林口,2024-06-07,9257
1612,宏泰,30,3,27,凱基-林口,2024-06-07,9257
4161,聿新科,22,0,22,凱基-林口,2024-06-07,9257
3324,雙鴻,25,4,21,凱基-林口,2024-06-07,9257
00637L,元大滬深300正2,20,0,20,凱基-林口,2024-06-07,9257
2495,普安,20,0,20,凱基-林口,2024-06-07,9257
2498,宏達電,35,16,19,凱基-林口,2024-06-07,9257
8112,至上,17,1,16,凱基-林口,2024-06-07,9257
2371,大同,25,10,15,凱基-林口,2024-06-07,9257
00680L,元大美債20正2,16,1,15,凱基-林口,2024-06-07,9257
3017,奇鋐,23,9,14,凱基-林口,2024-06-07,9257
2340,台亞,14,0,14,凱基-林口,2024-06-07,9257
3047,訊舟,23,10,13,凱基-林口,2024-06-07,9257
2613,中櫃,24,12,12,凱基-林口,2024-06-07,9257
5706,鳳凰,12,0,12,凱基-林口,2024-06-07,9257
1503,士電,11,0,11,凱基-林口,2024-06-07,9257
2489,瑞軒,11,0,11,凱基-林口,2024-06-07,9257
2382,廣達,13,2,11,凱基-林口,2024-06-07,9257
3455,由田,11,1,10,凱基-林口,2024-06-07,9257
1101,台泥,10,0,10,凱基-林口,2024-06-07,9257
00632R,元大台灣50反1,10,0,10,凱基-林口,2024-06-07,9257
2915,潤泰全,10,0,10,凱基-林口,2024-06-07,9257
3163,波若威,10,0,10,凱基-林口,2024-06-07,9257
6277,宏正,10,0,10,凱基-林口,2024-06-07,9257
2356,英業達,9,0,9,凱基-林口,2024-06-07,9257
2367,燿華,23,14,9,凱基-林口,2024-06-07,9257
3356,奇偶,10,1,9,凱基-林口,2024-06-07,9257
2409,友達,10,2,8,凱基-林口,2024-06-07,9257
3624,光頡,8,0,8,凱基-林口,2024-06-07,9257
6164,華興,8,0,8,凱基-林口,2024-06-07,9257
00923,群益台ESG低碳50,8,0,8,凱基-林口,2024-06-07,9257
5388,中磊,7,0,7,凱基-林口,2024-06-07,9257
1336,台翰,7,0,7,凱基-林口,2024-06-07,9257
3005,神基,7,0,7,凱基-林口,2024-06-07,9257
5213,亞昕,8,1,7,凱基-林口,2024-06-07,9257
00936,台新永續高息中小,659,0,659,凱基-林口,2024-06-11,9257
00937B,群益ESG投等債20,557,52,505,凱基-林口,2024-06-11,9257
2323,中環,242,0,242,凱基-林口,2024-06-11,9257
4906,正文,238,5,233,凱基-林口,2024-06-11,9257
2609,陽明,224,61,163,凱基-林口,2024-06-11,9257
00929,復華台灣科技優息,161,13,148,凱基-林口,2024-06-11,9257
00687B,國泰20年美債,147,0,147,凱基-林口,2024-06-11,9257
00919,群益台灣精選高息,143,3,140,凱基-林口,2024-06-11,9257
2834,臺企銀,132,0,132,凱基-林口,2024-06-11,9257
00637L,元大滬深300正2,113,0,113,凱基-林口,2024-06-11,9257
00918,大華優利高填息30,78,0,78,凱基-林口,2024-06-11,9257
2371,大同,202,132,70,凱基-林口,2024-06-11,9257
00878,國泰永續高股息,75,10,65,凱基-林口,2024-06-11,9257
00679B,元大美債20年,60,0,60,凱基-林口,2024-06-11,9257
2374,佳能,51,7,44,凱基-林口,2024-06-11,9257
2301,光寶科,41,0,41,凱基-林口,2024-06-11,9257
2615,萬海,55,17,38,凱基-林口,2024-06-11,9257
4960,誠美材,40,3,37,凱基-林口,2024-06-11,9257
1714,和桐,35,0,35,凱基-林口,2024-06-11,9257
1301,台塑,30,0,30,凱基-林口,2024-06-11,9257
00764B,群益25年美債,30,0,30,凱基-林口,2024-06-11,9257
8103,瀚荃,30,0,30,凱基-林口,2024-06-11,9257
2884,玉山金,30,1,29,凱基-林口,2024-06-11,9257
00900,富邦特選高股息30,28,0,28,凱基-林口,2024-06-11,9257
3048,益登,30,3,27,凱基-林口,2024-06-11,9257
00720B,元大投資級公司債,26,0,26,凱基-林口,2024-06-11,9257
2002,中鋼,26,1,25,凱基-林口,2024-06-11,9257
3227,原相,25,0,25,凱基-林口,2024-06-11,9257
0056,元大高股息,23,0,23,凱基-林口,2024-06-11,9257
1815,富喬,68,45,23,凱基-林口,2024-06-11,9257
3049,精金,31,8,23,凱基-林口,2024-06-11,9257
9945,潤泰新,25,2,23,凱基-林口,2024-06-11,9257
1608,華榮,25,3,22,凱基-林口,2024-06-11,9257
2543,皇昌,82,60,22,凱基-林口,2024-06-11,9257
2845,遠東銀,22,0,22,凱基-林口,2024-06-11,9257
1218,泰山,21,0,21,凱基-林口,2024-06-11,9257
3665,貿聯-KY,22,1,21,凱基-林口,2024-06-11,9257
2375,凱美,20,0,20,凱基-林口,2024-06-11,9257
2401,凌陽,20,0,20,凱基-林口,2024-06-11,9257
8028,昇陽半導體,20,0,20,凱基-林口,2024-06-11,9257
2882,國泰金,25,6,19,凱基-林口,2024-06-11,9257
00712,復華富時不動產,19,0,19,凱基-林口,2024-06-11,9257
6207,雷科,20,1,19,凱基-林口,2024-06-11,9257
6215,和椿,18,0,18,凱基-林口,2024-06-11,9257
2618,長榮航,60,43,17,凱基-林口,2024-06-11,9257
8210,勤誠,17,0,17,凱基-林口,2024-06-11,9257
00921,兆豐龍頭等權重,16,0,16,凱基-林口,2024-06-11,9257
3325,旭品,15,0,15,凱基-林口,2024-06-11,9257
3356,奇偶,15,1,14,凱基-林口,2024-06-11,9257
00680L,元大美債20正2,103,90,13,凱基-林口,2024-06-11,9257
00937B,群益ESG投等債20,301,14,287,凱基-林口,2024-06-12,9257
00942B,台新美A公司債20+,201,0,201,凱基-林口,2024-06-12,9257
00931B,統一美債20年,200,6,194,凱基-林口,2024-06-12,9257
2888,新光金,189,26,163,凱基-林口,2024-06-12,9257
4906,正文,249,113,136,凱基-林口,2024-06-12,9257
00929,復華台灣科技優息,140,5,135,凱基-林口,2024-06-12,9257
00936,台新永續高息中小,135,2,133,凱基-林口,2024-06-12,9257
00948B,中信優息投資級債,114,0,114,凱基-林口,2024-06-12,9257
2371,大同,108,11,97,凱基-林口,2024-06-12,9257
2883,凱基金,90,1,89,凱基-林口,2024-06-12,9257
1815,富喬,107,22,85,凱基-林口,2024-06-12,9257
2801,彰銀,52,0,52,凱基-林口,2024-06-12,9257
00918,大華優利高填息30,50,0,50,凱基-林口,2024-06-12,9257
2515,中工,50,0,50,凱基-林口,2024-06-12,9257
2356,英業達,50,6,44,凱基-林口,2024-06-12,9257
3227,原相,42,0,42,凱基-林口,2024-06-12,9257
2002,中鋼,39,0,39,凱基-林口,2024-06-12,9257
2615,萬海,74,35,39,凱基-林口,2024-06-12,9257
3481,群創,39,2,37,凱基-林口,2024-06-12,9257
00947,台新臺灣IC設計,35,0,35,凱基-林口,2024-06-12,9257
6290,良維,33,0,33,凱基-林口,2024-06-12,9257
2905,三商,30,0,30,凱基-林口,2024-06-12,9257
6152,百一,25,0,25,凱基-林口,2024-06-12,9257
00919,群益台灣精選高息,38,13,25,凱基-林口,2024-06-12,9257
00712,復華富時不動產,24,0,24,凱基-林口,2024-06-12,9257
00933B,國泰10Y+金融債,21,0,21,凱基-林口,2024-06-12,9257
3033,威健,20,0,20,凱基-林口,2024-06-12,9257
8404,百和興業-KY,20,0,20,凱基-林口,2024-06-12,9257
2353,宏��,37,18,19,凱基-林口,2024-06-12,9257
00882,中信中國高股息,18,0,18,凱基-林口,2024-06-12,9257
1336,台翰,18,0,18,凱基-林口,2024-06-12,9257
3322,建舜電,18,0,18,凱基-林口,2024-06-12,9257
6164,華興,18,0,18,凱基-林口,2024-06-12,9257
2020,美亞,17,0,17,凱基-林口,2024-06-12,9257
4939,亞電,17,0,17,凱基-林口,2024-06-12,9257
00687B,國泰20年美債,26,11,15,凱基-林口,2024-06-12,9257
8147,正淩,15,0,15,凱基-林口,2024-06-12,9257
00878,國泰永續高股息,23,11,12,凱基-林口,2024-06-12,9257
2409,友達,25,14,11,凱基-林口,2024-06-12,9257
3706,神達,21,10,11,凱基-林口,2024-06-12,9257
5864,致和證,11,0,11,凱基-林口,2024-06-12,9257
6177,達麗,11,0,11,凱基-林口,2024-06-12,9257
1514,亞力,13,3,10,凱基-林口,2024-06-12,9257
1301,台塑,13,3,10,凱基-林口,2024-06-12,9257
2606,裕民,13,3,10,凱基-林口,2024-06-12,9257
2340,台亞,10,0,10,凱基-林口,2024-06-12,9257
3027,盛達,10,0,10,凱基-林口,2024-06-12,9257
5213,亞昕,10,0,10,凱基-林口,2024-06-12,9257
5603,陸海,10,0,10,凱基-林口,2024-06-12,9257
5608,四維航,10,0,10,凱基-林口,2024-06-12,9257
00937B,群益ESG投等債20,814,179,635,凱基-林口,2024-06-13,9257
1815,富喬,166,47,119,凱基-林口,2024-06-13,9257
00948B,中信優息投資級債,118,0,118,凱基-林口,2024-06-13,9257
00929,復華台灣科技優息,144,29,115,凱基-林口,2024-06-13,9257
4958,臻鼎-KY,100,16,84,凱基-林口,2024-06-13,9257
4906,正文,80,2,78,凱基-林口,2024-06-13,9257
2867,三商壽,79,2,77,凱基-林口,2024-06-13,9257
3580,友威科,56,0,56,凱基-林口,2024-06-13,9257
2888,新光金,52,3,49,凱基-林口,2024-06-13,9257
3047,訊舟,54,5,49,凱基-林口,2024-06-13,9257
2801,彰銀,50,2,48,凱基-林口,2024-06-13,9257
2353,宏��,107,73,34,凱基-林口,2024-06-13,9257
2323,中環,30,0,30,凱基-林口,2024-06-13,9257
2211,長榮鋼,25,0,25,凱基-林口,2024-06-13,9257
6152,百一,25,0,25,凱基-林口,2024-06-13,9257
00936,台新永續高息中小,24,0,24,凱基-林口,2024-06-13,9257
00947,台新臺灣IC設計,21,0,21,凱基-林口,2024-06-13,9257
00753L,中信中國50正2,20,0,20,凱基-林口,2024-06-13,9257
1701,中化,20,0,20,凱基-林口,2024-06-13,9257
00919,群益台灣精選高息,42,22,20,凱基-林口,2024-06-13,9257
2061,風青,19,0,19,凱基-林口,2024-06-13,9257
8028,昇陽半導體,33,17,16,凱基-林口,2024-06-13,9257
6156,松上,15,0,15,凱基-林口,2024-06-13,9257
6215,和椿,15,0,15,凱基-林口,2024-06-13,9257
6188,廣明,14,0,14,凱基-林口,2024-06-13,9257
6207,雷科,18,4,14,凱基-林口,2024-06-13,9257
3227,原相,20,7,13,凱基-林口,2024-06-13,9257
00662,富邦NASDAQ,12,0,12,凱基-林口,2024-06-13,9257
6116,彩晶,12,0,12,凱基-林口,2024-06-13,9257
6121,新普,12,0,12,凱基-林口,2024-06-13,9257
00679B,元大美債20年,14,2,12,凱基-林口,2024-06-13,9257
2367,燿華,35,24,11,凱基-林口,2024-06-13,9257
2427,三商電,11,0,11,凱基-林口,2024-06-13,9257
2458,義隆,11,0,11,凱基-林口,2024-06-13,9257
3024,憶聲,11,0,11,凱基-林口,2024-06-13,9257
4161,聿新科,26,15,11,凱基-林口,2024-06-13,9257
5469,瀚宇博,11,0,11,凱基-林口,2024-06-13,9257
2204,中華,10,0,10,凱基-林口,2024-06-13,9257
1717,長興,10,0,10,凱基-林口,2024-06-13,9257
1720,生達,10,0,10,凱基-林口,2024-06-13,9257
2460,建通,10,0,10,凱基-林口,2024-06-13,9257
2809,京城銀,10,0,10,凱基-林口,2024-06-13,9257
2905,三商,10,0,10,凱基-林口,2024-06-13,9257
3167,大量,10,0,10,凱基-林口,2024-06-13,9257
4714,永捷,10,0,10,凱基-林口,2024-06-13,9257
4939,亞電,10,0,10,凱基-林口,2024-06-13,9257
6209,今國光,10,0,10,凱基-林口,2024-06-13,9257
6451,訊芯-KY,12,2,10,凱基-林口,2024-06-13,9257
2618,長榮航,15,6,9,凱基-林口,2024-06-13,9257
2352,佳世達,9,0,9,凱基-林口,2024-06-13,9257
00680L,元大美債20正2,495,10,485,凱基-林口,2024-06-14,9257
00948B,中信優息投資級債,513,50,463,凱基-林口,2024-06-14,9257
00937B,群益ESG投等債20,281,19,262,凱基-林口,2024-06-14,9257
00942B,台新美A公司債20+,221,0,221,凱基-林口,2024-06-14,9257
00931B,統一美債20年,200,5,195,凱基-林口,2024-06-14,9257
00687B,國泰20年美債,127,1,126,凱基-林口,2024-06-14,9257
2382,廣達,105,23,82,凱基-林口,2024-06-14,9257
4906,正文,83,7,76,凱基-林口,2024-06-14,9257
2371,大同,390,328,62,凱基-林口,2024-06-14,9257
6770,力積電,63,9,54,凱基-林口,2024-06-14,9257
6290,良維,65,18,47,凱基-林口,2024-06-14,9257
3322,建舜電,41,0,41,凱基-林口,2024-06-14,9257
5258,虹堡,70,31,39,凱基-林口,2024-06-14,9257
2427,三商電,39,3,36,凱基-林口,2024-06-14,9257
6152,百一,30,0,30,凱基-林口,2024-06-14,9257
00918,大華優利高填息30,30,1,29,凱基-林口,2024-06-14,9257
2061,風青,31,2,29,凱基-林口,2024-06-14,9257
1503,士電,34,5,29,凱基-林口,2024-06-14,9257
2353,宏��,28,1,27,凱基-林口,2024-06-14,9257
00924,復華S＆P500成長,25,0,25,凱基-林口,2024-06-14,9257
2363,矽統,84,60,24,凱基-林口,2024-06-14,9257
3287,廣寰科,23,0,23,凱基-林口,2024-06-14,9257
00904,新光臺灣半導體30,21,0,21,凱基-林口,2024-06-14,9257
00706L,期元大S＆P日圓正2,20,0,20,凱基-林口,2024-06-14,9257
2834,臺企銀,20,0,20,凱基-林口,2024-06-14,9257
6127,九豪,20,0,20,凱基-林口,2024-06-14,9257
2330,台積電,22,3,19,凱基-林口,2024-06-14,9257
00936,台新永續高息中小,20,1,19,凱基-林口,2024-06-14,9257
1570,力肯,18,0,18,凱基-林口,2024-06-14,9257
5243,乙盛-KY,34,17,17,凱基-林口,2024-06-14,9257
3376,新日興,30,14,16,凱基-林口,2024-06-14,9257
2449,京元電子,60,45,15,凱基-林口,2024-06-14,9257
00713,元大台灣高息低波,14,0,14,凱基-林口,2024-06-14,9257
2324,仁寶,14,1,13,凱基-林口,2024-06-14,9257
2458,義隆,13,0,13,凱基-林口,2024-06-14,9257
00888,永豐台灣ESG,12,0,12,凱基-林口,2024-06-14,9257
1608,華榮,23,11,12,凱基-林口,2024-06-14,9257
00947,台新臺灣IC設計,11,0,11,凱基-林口,2024-06-14,9257
2392,正崴,19,8,11,凱基-林口,2024-06-14,9257
2606,裕民,11,0,11,凱基-林口,2024-06-14,9257
2905,三商,11,0,11,凱基-林口,2024-06-14,9257
4526,東台,12,1,11,凱基-林口,2024-06-14,9257
6116,彩晶,11,0,11,凱基-林口,2024-06-14,9257
00650L,復華香港正2,10,0,10,凱基-林口,2024-06-14,9257
1701,中化,10,0,10,凱基-林口,2024-06-14,9257
2356,英業達,13,3,10,凱基-林口,2024-06-14,9257
2377,微星,10,0,10,凱基-林口,2024-06-14,9257
2486,一詮,35,25,10,凱基-林口,2024-06-14,9257
2888,新光金,13,3,10,凱基-林口,2024-06-14,9257
3040,遠見,10,0,10,凱基-林口,2024-06-14,9257
00929,復華台灣科技優息,380,32,348,凱基-林口,2024-06-17,9257
00942B,台新美A公司債20+,311,0,311,凱基-林口,2024-06-17,9257
00680L,元大美債20正2,170,20,150,凱基-林口,2024-06-17,9257
00918,大華優利高填息30,161,15,146,凱基-林口,2024-06-17,9257
00947,台新臺灣IC設計,108,5,103,凱基-林口,2024-06-17,9257
4906,正文,101,0,101,凱基-林口,2024-06-17,9257
00882,中信中國高股息,98,0,98,凱基-林口,2024-06-17,9257
2427,三商電,92,0,92,凱基-林口,2024-06-17,9257
2867,三商壽,77,1,76,凱基-林口,2024-06-17,9257
2609,陽明,79,7,72,凱基-林口,2024-06-17,9257
9105,泰金寶-DR,47,0,47,凱基-林口,2024-06-17,9257
2331,精英,42,10,32,凱基-林口,2024-06-17,9257
911608,明輝-DR,30,0,30,凱基-林口,2024-06-17,9257
912000,晨訊科-DR,40,13,27,凱基-林口,2024-06-17,9257
5469,瀚宇博,25,0,25,凱基-林口,2024-06-17,9257
2615,萬海,41,17,24,凱基-林口,2024-06-17,9257
2514,龍邦,22,0,22,凱基-林口,2024-06-17,9257
00753L,中信中國50正2,21,0,21,凱基-林口,2024-06-17,9257
00688L,國泰20年美債正2,21,0,21,凱基-林口,2024-06-17,9257
00902,中信電池及儲能,20,0,20,凱基-林口,2024-06-17,9257
2884,玉山金,20,0,20,凱基-林口,2024-06-17,9257
3033,威健,21,1,20,凱基-林口,2024-06-17,9257
4161,聿新科,20,0,20,凱基-林口,2024-06-17,9257
00881,國泰台灣5G+,19,0,19,凱基-林口,2024-06-17,9257
2851,中再保,19,0,19,凱基-林口,2024-06-17,9257
1513,中興電,26,7,19,凱基-林口,2024-06-17,9257
2356,英業達,28,10,18,凱基-林口,2024-06-17,9257
1609,大亞,46,29,17,凱基-林口,2024-06-17,9257
3664,安瑞-KY,17,0,17,凱基-林口,2024-06-17,9257
8024,佑華,17,0,17,凱基-林口,2024-06-17,9257
4540,全球傳動,17,1,16,凱基-林口,2024-06-17,9257
3005,神基,18,3,15,凱基-林口,2024-06-17,9257
6841,長佳智能,21,6,15,凱基-林口,2024-06-17,9257
3293,鈊象,16,1,15,凱基-林口,2024-06-17,9257
2367,燿華,16,1,15,凱基-林口,2024-06-17,9257
2449,京元電子,49,35,14,凱基-林口,2024-06-17,9257
2498,宏達電,15,1,14,凱基-林口,2024-06-17,9257
4532,瑞智,18,4,14,凱基-林口,2024-06-17,9257
2368,金像電,13,0,13,凱基-林口,2024-06-17,9257
1608,華榮,34,21,13,凱基-林口,2024-06-17,9257
3062,建漢,26,13,13,凱基-林口,2024-06-17,9257
6757,台灣虎航,12,0,12,凱基-林口,2024-06-17,9257
3455,由田,11,0,11,凱基-林口,2024-06-17,9257
00923,群益台ESG低碳50,10,0,10,凱基-林口,2024-06-17,9257
1532,勤美,10,0,10,凱基-林口,2024-06-17,9257
2314,台揚,10,0,10,凱基-林口,2024-06-17,9257
3437,榮創,10,0,10,凱基-林口,2024-06-17,9257
4958,臻鼎-KY,10,0,10,凱基-林口,2024-06-17,9257
6163,華電網,11,1,10,凱基-林口,2024-06-17,9257
6799,來頡,10,0,10,凱基-林口,2024-06-17,9257
2845,遠東銀,620,0,620,凱基-林口,2024-06-18,9257
00947,台新臺灣IC設計,164,0,164,凱基-林口,2024-06-18,9257
00948B,中信優息投資級債,132,0,132,凱基-林口,2024-06-18,9257
00858,永豐美國500大,88,0,88,凱基-林口,2024-06-18,9257
00687B,國泰20年美債,81,2,79,凱基-林口,2024-06-18,9257
2363,矽統,97,28,69,凱基-林口,2024-06-18,9257
2888,新光金,80,11,69,凱基-林口,2024-06-18,9257
00937B,群益ESG投等債20,62,1,61,凱基-林口,2024-06-18,9257
6180,橘子,165,113,52,凱基-林口,2024-06-18,9257
00673R,期元大S＆P原油反1,50,0,50,凱基-林口,2024-06-18,9257
00942B,台新美A公司債20+,50,0,50,凱基-林口,2024-06-18,9257
2543,皇昌,50,0,50,凱基-林口,2024-06-18,9257
1609,大亞,48,1,47,凱基-林口,2024-06-18,9257
2385,群光,48,2,46,凱基-林口,2024-06-18,9257
00713,元大台灣高息低波,41,0,41,凱基-林口,2024-06-18,9257
1711,永光,40,0,40,凱基-林口,2024-06-18,9257
6269,台郡,32,0,32,凱基-林口,2024-06-18,9257
2353,宏��,39,14,25,凱基-林口,2024-06-18,9257
3049,精金,24,0,24,凱基-林口,2024-06-18,9257
6284,佳邦,23,0,23,凱基-林口,2024-06-18,9257
8996,高力,22,0,22,凱基-林口,2024-06-18,9257
00662,富邦NASDAQ,20,0,20,凱基-林口,2024-06-18,9257
00637L,元大滬深300正2,20,0,20,凱基-林口,2024-06-18,9257
2520,冠德,20,0,20,凱基-林口,2024-06-18,9257
9103,美德醫療-DR,20,1,19,凱基-林口,2024-06-18,9257
2455,全新,20,3,17,凱基-林口,2024-06-18,9257
4562,穎漢,36,19,17,凱基-林口,2024-06-18,9257
5443,均豪,27,10,17,凱基-林口,2024-06-18,9257
9941,裕融,16,0,16,凱基-林口,2024-06-18,9257
00939,統一台灣高息動能,17,1,16,凱基-林口,2024-06-18,9257
00936,台新永續高息中小,39,24,15,凱基-林口,2024-06-18,9257
2383,台光電,14,0,14,凱基-林口,2024-06-18,9257
00915,凱基優選高股息30,30,17,13,凱基-林口,2024-06-18,9257
2301,光寶科,13,0,13,凱基-林口,2024-06-18,9257
3006,晶豪科,14,1,13,凱基-林口,2024-06-18,9257
3062,建漢,21,8,13,凱基-林口,2024-06-18,9257
1326,台化,13,1,12,凱基-林口,2024-06-18,9257
2356,英業達,13,1,12,凱基-林口,2024-06-18,9257
5490,同亨,34,22,12,凱基-林口,2024-06-18,9257
9927,泰銘,12,0,12,凱基-林口,2024-06-18,9257
00929,復華台灣科技優息,126,115,11,凱基-林口,2024-06-18,9257
2515,中工,12,1,11,凱基-林口,2024-06-18,9257
2615,萬海,18,7,11,凱基-林口,2024-06-18,9257
3227,原相,11,0,11,凱基-林口,2024-06-18,9257
3231,緯創,17,6,11,凱基-林口,2024-06-18,9257
3105,穩懋,13,2,11,凱基-林口,2024-06-18,9257
3013,晟銘電,10,0,10,凱基-林口,2024-06-18,9257
00753L,中信中國50正2,10,0,10,凱基-林口,2024-06-18,9257
00632R,元大台灣50反1,20,10,10,凱基-林口,2024-06-18,9257
00924,復華S＆P500成長,10,0,10,凱基-林口,2024-06-18,9257
2855,統一證,600,0,600,凱基-林口,2024-06-19,9257
00680L,元大美債20正2,265,0,265,凱基-林口,2024-06-19,9257
2610,華航,197,14,183,凱基-林口,2024-06-19,9257
00632R,元大台灣50反1,214,35,179,凱基-林口,2024-06-19,9257
6290,良維,85,5,80,凱基-林口,2024-06-19,9257
00940,元大台灣價值高息,116,38,78,凱基-林口,2024-06-19,9257
00939,統一台灣高息動能,100,31,69,凱基-林口,2024-06-19,9257
2371,大同,91,31,60,凱基-林口,2024-06-19,9257
00673R,期元大S＆P原油反1,50,0,50,凱基-林口,2024-06-19,9257
00946,群益科技高息成長,70,21,49,凱基-林口,2024-06-19,9257
4161,聿新科,81,35,46,凱基-林口,2024-06-19,9257
00665L,富邦�琤肭磪囓�2,45,0,45,凱基-林口,2024-06-19,9257
8403,盛弘,42,0,42,凱基-林口,2024-06-19,9257
9945,潤泰新,40,0,40,凱基-林口,2024-06-19,9257
3062,建漢,64,29,35,凱基-林口,2024-06-19,9257
00888,永豐台灣ESG,32,0,32,凱基-林口,2024-06-19,9257
3227,原相,32,0,32,凱基-林口,2024-06-19,9257
1712,興農,30,0,30,凱基-林口,2024-06-19,9257
3163,波若威,53,28,25,凱基-林口,2024-06-19,9257
6147,頎邦,34,11,23,凱基-林口,2024-06-19,9257
2301,光寶科,24,2,22,凱基-林口,2024-06-19,9257
00713,元大台灣高息低波,20,0,20,凱基-林口,2024-06-19,9257
1711,永光,20,0,20,凱基-林口,2024-06-19,9257
4164,承業醫,20,0,20,凱基-林口,2024-06-19,9257
3450,聯鈞,45,26,19,凱基-林口,2024-06-19,9257
2609,陽明,73,54,19,凱基-林口,2024-06-19,9257
1570,力肯,31,13,18,凱基-林口,2024-06-19,9257
6160,欣技,18,0,18,凱基-林口,2024-06-19,9257
2739,寒舍,18,0,18,凱基-林口,2024-06-19,9257
2539,櫻花建,17,0,17,凱基-林口,2024-06-19,9257
6139,亞翔,20,4,16,凱基-林口,2024-06-19,9257
2061,風青,16,0,16,凱基-林口,2024-06-19,9257
1447,力鵬,15,0,15,凱基-林口,2024-06-19,9257
2402,毅嘉,15,0,15,凱基-林口,2024-06-19,9257
8183,精星,15,0,15,凱基-林口,2024-06-19,9257
1815,富喬,88,74,14,凱基-林口,2024-06-19,9257
5469,瀚宇博,13,0,13,凱基-林口,2024-06-19,9257
00712,復華富時不動產,13,1,12,凱基-林口,2024-06-19,9257
3055,蔚華科,16,4,12,凱基-林口,2024-06-19,9257
00933B,國泰10Y+金融債,13,1,12,凱基-林口,2024-06-19,9257
1582,信錦,12,0,12,凱基-林口,2024-06-19,9257
2347,聯強,12,0,12,凱基-林口,2024-06-19,9257
2887,台新金,22,10,12,凱基-林口,2024-06-19,9257
4142,國光生,12,0,12,凱基-林口,2024-06-19,9257
4979,華星光,12,0,12,凱基-林口,2024-06-19,9257
6770,力積電,20,8,12,凱基-林口,2024-06-19,9257
00923,群益台ESG低碳50,16,5,11,凱基-林口,2024-06-19,9257
1326,台化,10,0,10,凱基-林口,2024-06-19,9257
00662,富邦NASDAQ,10,0,10,凱基-林口,2024-06-19,9257
00942B,台新美A公司債20+,10,0,10,凱基-林口,2024-06-19,9257
00936,台新永續高息中小,245,1,244,凱基-林口,2024-06-20,9257
2353,宏��,199,10,189,凱基-林口,2024-06-20,9257
00919,群益台灣精選高息,182,62,120,凱基-林口,2024-06-20,9257
00688L,國泰20年美債正2,105,0,105,凱基-林口,2024-06-20,9257
00937B,群益ESG投等債20,94,3,91,凱基-林口,2024-06-20,9257
00940,元大台灣價值高息,77,12,65,凱基-林口,2024-06-20,9257
2498,宏達電,54,13,41,凱基-林口,2024-06-20,9257
1701,中化,36,0,36,凱基-林口,2024-06-20,9257
8234,新漢,33,0,33,凱基-林口,2024-06-20,9257
2882,國泰金,34,5,29,凱基-林口,2024-06-20,9257
00942B,台新美A公司債20+,28,0,28,凱基-林口,2024-06-20,9257
00929,復華台灣科技優息,44,18,26,凱基-林口,2024-06-20,9257
00939,統一台灣高息動能,26,1,25,凱基-林口,2024-06-20,9257
4956,光鋐,46,21,25,凱基-林口,2024-06-20,9257
3715,定穎投控,35,11,24,凱基-林口,2024-06-20,9257
1582,信錦,23,0,23,凱基-林口,2024-06-20,9257
00680L,元大美債20正2,41,20,21,凱基-林口,2024-06-20,9257
3037,欣興,27,6,21,凱基-林口,2024-06-20,9257
3363,上詮,50,29,21,凱基-林口,2024-06-20,9257
00665L,富邦�琤肭磪囓�2,20,0,20,凱基-林口,2024-06-20,9257
4961,天鈺,25,5,20,凱基-林口,2024-06-20,9257
00679B,元大美債20年,42,23,19,凱基-林口,2024-06-20,9257
8096,擎亞,26,7,19,凱基-林口,2024-06-20,9257
00927,群益半導體收益,18,0,18,凱基-林口,2024-06-20,9257
2605,新興,17,0,17,凱基-林口,2024-06-20,9257
00946,群益科技高息成長,15,0,15,凱基-林口,2024-06-20,9257
2610,華航,20,6,14,凱基-林口,2024-06-20,9257
3339,泰谷,17,3,14,凱基-林口,2024-06-20,9257
1504,東元,13,0,13,凱基-林口,2024-06-20,9257
2486,一詮,12,0,12,凱基-林口,2024-06-20,9257
2347,聯強,12,0,12,凱基-林口,2024-06-20,9257
2371,大同,36,24,12,凱基-林口,2024-06-20,9257
2457,飛宏,15,3,12,凱基-林口,2024-06-20,9257
6188,廣明,11,0,11,凱基-林口,2024-06-20,9257
8050,廣積,15,4,11,凱基-林口,2024-06-20,9257
00712,復華富時不動產,21,10,11,凱基-林口,2024-06-20,9257
3231,緯創,30,19,11,凱基-林口,2024-06-20,9257
3055,蔚華科,11,0,11,凱基-林口,2024-06-20,9257
1609,大亞,13,3,10,凱基-林口,2024-06-20,9257
2458,義隆,10,0,10,凱基-林口,2024-06-20,9257
3432,台端,10,0,10,凱基-林口,2024-06-20,9257
9941,裕融,10,0,10,凱基-林口,2024-06-20,9257
2356,英業達,36,27,9,凱基-林口,2024-06-20,9257
1810,和成,10,1,9,凱基-林口,2024-06-20,9257
6431,光麗-KY,9,0,9,凱基-林口,2024-06-20,9257
2365,昆盈,16,7,9,凱基-林口,2024-06-20,9257
6215,和椿,8,0,8,凱基-林口,2024-06-20,9257
1612,宏泰,11,3,8,凱基-林口,2024-06-20,9257
3034,聯詠,8,0,8,凱基-林口,2024-06-20,9257
3372,典範,8,0,8,凱基-林口,2024-06-20,9257
00937B,群益ESG投等債20,569,88,481,凱基-林口,2024-06-21,9257
00942B,台新美A公司債20+,209,0,209,凱基-林口,2024-06-21,9257
00936,台新永續高息中小,221,40,181,凱基-林口,2024-06-21,9257
5488,松普,89,0,89,凱基-林口,2024-06-21,9257
2363,矽統,89,1,88,凱基-林口,2024-06-21,9257
2836,高雄銀,60,0,60,凱基-林口,2024-06-21,9257
2356,英業達,53,0,53,凱基-林口,2024-06-21,9257
00637L,元大滬深300正2,50,0,50,凱基-林口,2024-06-21,9257
2855,統一證,50,0,50,凱基-林口,2024-06-21,9257
00929,復華台灣科技優息,66,22,44,凱基-林口,2024-06-21,9257
00687B,國泰20年美債,52,9,43,凱基-林口,2024-06-21,9257
9945,潤泰新,37,0,37,凱基-林口,2024-06-21,9257
8048,德勝,42,6,36,凱基-林口,2024-06-21,9257
6270,倍微,36,0,36,凱基-林口,2024-06-21,9257
00753L,中信中國50正2,31,0,31,凱基-林口,2024-06-21,9257
4906,正文,50,23,27,凱基-林口,2024-06-21,9257
2317,鴻海,102,76,26,凱基-林口,2024-06-21,9257
1503,士電,41,18,23,凱基-林口,2024-06-21,9257
2382,廣達,29,7,22,凱基-林口,2024-06-21,9257
1301,台塑,21,0,21,凱基-林口,2024-06-21,9257
00633L,富邦上証正2,21,0,21,凱基-林口,2024-06-21,9257
2501,國建,21,0,21,凱基-林口,2024-06-21,9257
1709,和益,20,0,20,凱基-林口,2024-06-21,9257
2201,裕隆,22,3,19,凱基-林口,2024-06-21,9257
2368,金像電,26,8,18,凱基-林口,2024-06-21,9257
3483,力致,34,16,18,凱基-林口,2024-06-21,9257
00947,台新臺灣IC設計,17,0,17,凱基-林口,2024-06-21,9257
6233,旺玖,17,0,17,凱基-林口,2024-06-21,9257
00915,凱基優選高股息30,17,0,17,凱基-林口,2024-06-21,9257
00919,群益台灣精選高息,100,84,16,凱基-林口,2024-06-21,9257
2221,大甲,16,0,16,凱基-林口,2024-06-21,9257
3047,訊舟,47,31,16,凱基-林口,2024-06-21,9257
3665,貿聯-KY,17,1,16,凱基-林口,2024-06-21,9257
2429,銘旺科,15,0,15,凱基-林口,2024-06-21,9257
3227,原相,15,0,15,凱基-林口,2024-06-21,9257
2520,冠德,14,0,14,凱基-林口,2024-06-21,9257
8105,凌巨,16,2,14,凱基-林口,2024-06-21,9257
2330,台積電,16,3,13,凱基-林口,2024-06-21,9257
00885,富邦越南,18,5,13,凱基-林口,2024-06-21,9257
8011,台通,20,7,13,凱基-林口,2024-06-21,9257
2455,全新,15,2,13,凱基-林口,2024-06-21,9257
2365,昆盈,14,3,11,凱基-林口,2024-06-21,9257
2392,正崴,18,7,11,凱基-林口,2024-06-21,9257
4960,誠美材,11,0,11,凱基-林口,2024-06-21,9257
2409,友達,61,50,11,凱基-林口,2024-06-21,9257
00902,中信電池及儲能,10,0,10,凱基-林口,2024-06-21,9257
00891,中信關鍵半導體,10,0,10,凱基-林口,2024-06-21,9257
00918,大華優利高填息30,34,24,10,凱基-林口,2024-06-21,9257
00665L,富邦�琤肭磪囓�2,10,0,10,凱基-林口,2024-06-21,9257
00933B,國泰10Y+金融債,10,0,10,凱基-林口,2024-06-21,9257
3481,群創,1403,603,800,凱基-林口,2024-06-24,9257
00929,復華台灣科技優息,217,21,196,凱基-林口,2024-06-24,9257
00946,群益科技高息成長,113,0,113,凱基-林口,2024-06-24,9257
00919,群益台灣精選高息,115,20,95,凱基-林口,2024-06-24,9257
00918,大華優利高填息30,62,0,62,凱基-林口,2024-06-24,9257
4157,太景*-KY,60,0,60,凱基-林口,2024-06-24,9257
2457,飛宏,55,0,55,凱基-林口,2024-06-24,9257
2369,菱生,60,11,49,凱基-林口,2024-06-24,9257
00936,台新永續高息中小,53,5,48,凱基-林口,2024-06-24,9257
3062,建漢,93,48,45,凱基-林口,2024-06-24,9257
5328,華容,86,50,36,凱基-林口,2024-06-24,9257
00679B,元大美債20年,37,3,34,凱基-林口,2024-06-24,9257
1309,台達化,38,6,32,凱基-林口,2024-06-24,9257
8112,至上,31,0,31,凱基-林口,2024-06-24,9257
00687B,國泰20年美債,65,36,29,凱基-林口,2024-06-24,9257
2353,宏��,27,0,27,凱基-林口,2024-06-24,9257
3033,威健,23,0,23,凱基-林口,2024-06-24,9257
6270,倍微,23,0,23,凱基-林口,2024-06-24,9257
2317,鴻海,27,4,23,凱基-林口,2024-06-24,9257
00909,國泰數位支付服務,22,0,22,凱基-林口,2024-06-24,9257
8028,昇陽半導體,25,3,22,凱基-林口,2024-06-24,9257
00937B,群益ESG投等債20,37,16,21,凱基-林口,2024-06-24,9257
2061,風青,20,0,20,凱基-林口,2024-06-24,9257
2405,輔信,22,2,20,凱基-林口,2024-06-24,9257
2330,台積電,26,6,20,凱基-林口,2024-06-24,9257
8105,凌巨,47,28,19,凱基-林口,2024-06-24,9257
4979,華星光,18,1,17,凱基-林口,2024-06-24,9257
6176,瑞儀,17,0,17,凱基-林口,2024-06-24,9257
00947,台新臺灣IC設計,16,0,16,凱基-林口,2024-06-24,9257
1326,台化,17,1,16,凱基-林口,2024-06-24,9257
2610,華航,20,4,16,凱基-林口,2024-06-24,9257
2489,瑞軒,30,14,16,凱基-林口,2024-06-24,9257
3576,聯合再生,16,0,16,凱基-林口,2024-06-24,9257
3665,貿聯-KY,17,1,16,凱基-林口,2024-06-24,9257
4967,十銓,20,4,16,凱基-林口,2024-06-24,9257
1301,台塑,15,1,14,凱基-林口,2024-06-24,9257
3231,緯創,15,1,14,凱基-林口,2024-06-24,9257
4526,東台,15,1,14,凱基-林口,2024-06-24,9257
6290,良維,16,2,14,凱基-林口,2024-06-24,9257
2409,友達,18,5,13,凱基-林口,2024-06-24,9257
2363,矽統,20,8,12,凱基-林口,2024-06-24,9257
2392,正崴,13,1,12,凱基-林口,2024-06-24,9257
2867,三商壽,12,0,12,凱基-林口,2024-06-24,9257
3706,神達,12,0,12,凱基-林口,2024-06-24,9257
00632R,元大台灣50反1,11,0,11,凱基-林口,2024-06-24,9257
1304,台聚,11,0,11,凱基-林口,2024-06-24,9257
3227,原相,11,0,11,凱基-林口,2024-06-24,9257
1319,東陽,10,0,10,凱基-林口,2024-06-24,9257
2634,漢翔,10,0,10,凱基-林口,2024-06-24,9257
00933B,國泰10Y+金融債,25,15,10,凱基-林口,2024-06-24,9257
3481,群創,676,208,468,凱基-林口,2024-06-25,9257
00687B,國泰20年美債,171,2,169,凱基-林口,2024-06-25,9257
2331,精英,99,1,98,凱基-林口,2024-06-25,9257
00919,群益台灣精選高息,92,2,90,凱基-林口,2024-06-25,9257
00940,元大台灣價值高息,101,31,70,凱基-林口,2024-06-25,9257
00680L,元大美債20正2,67,0,67,凱基-林口,2024-06-25,9257
2316,楠梓電,68,2,66,凱基-林口,2024-06-25,9257
00941,中信上游半導體,45,0,45,凱基-林口,2024-06-25,9257
00946,群益科技高息成長,58,13,45,凱基-林口,2024-06-25,9257
00939,統一台灣高息動能,44,6,38,凱基-林口,2024-06-25,9257
2317,鴻海,112,77,35,凱基-林口,2024-06-25,9257
2409,友達,64,32,32,凱基-林口,2024-06-25,9257
2301,光寶科,30,3,27,凱基-林口,2024-06-25,9257
2897,王道銀行,26,0,26,凱基-林口,2024-06-25,9257
3498,陽程,53,30,23,凱基-林口,2024-06-25,9257
6116,彩晶,23,0,23,凱基-林口,2024-06-25,9257
9938,百和,23,0,23,凱基-林口,2024-06-25,9257
00936,台新永續高息中小,22,0,22,凱基-林口,2024-06-25,9257
2406,國碩,21,0,21,凱基-林口,2024-06-25,9257
6269,台郡,21,0,21,凱基-林口,2024-06-25,9257
0056,元大高股息,27,7,20,凱基-林口,2024-06-25,9257
1309,台達化,20,0,20,凱基-林口,2024-06-25,9257
1609,大亞,28,9,19,凱基-林口,2024-06-25,9257
3665,貿聯-KY,21,2,19,凱基-林口,2024-06-25,9257
00903,富邦元宇宙,18,0,18,凱基-林口,2024-06-25,9257
3037,欣興,18,0,18,凱基-林口,2024-06-25,9257
00947,台新臺灣IC設計,17,0,17,凱基-林口,2024-06-25,9257
1815,富喬,23,6,17,凱基-林口,2024-06-25,9257
2401,凌陽,26,9,17,凱基-林口,2024-06-25,9257
4540,全球傳動,17,0,17,凱基-林口,2024-06-25,9257
6138,茂達,17,0,17,凱基-林口,2024-06-25,9257
00918,大華優利高填息30,16,0,16,凱基-林口,2024-06-25,9257
2354,鴻準,21,5,16,凱基-林口,2024-06-25,9257
5864,致和證,16,0,16,凱基-林口,2024-06-25,9257
8040,九暘,16,0,16,凱基-林口,2024-06-25,9257
3663,鑫科,28,15,13,凱基-林口,2024-06-25,9257
8110,華東,24,11,13,凱基-林口,2024-06-25,9257
8064,東捷,12,0,12,凱基-林口,2024-06-25,9257
00915,凱基優選高股息30,12,1,11,凱基-林口,2024-06-25,9257
6869,雲豹能源,51,41,10,凱基-林口,2024-06-25,9257
00909,國泰數位支付服務,10,0,10,凱基-林口,2024-06-25,9257
00932,兆豐永續高息等權,10,0,10,凱基-林口,2024-06-25,9257
00905,FT臺灣Smart,10,0,10,凱基-林口,2024-06-25,9257
00753L,中信中國50正2,20,10,10,凱基-林口,2024-06-25,9257
00671R,富邦NASDAQ反1,10,0,10,凱基-林口,2024-06-25,9257
00942B,台新美A公司債20+,10,0,10,凱基-林口,2024-06-25,9257
1102,亞泥,10,0,10,凱基-林口,2024-06-25,9257
1220,台榮,10,0,10,凱基-林口,2024-06-25,9257
1612,宏泰,16,6,10,凱基-林口,2024-06-25,9257
2221,大甲,10,0,10,凱基-林口,2024-06-25,9257
6548,長科*,200,1,199,凱基-林口,2024-06-26,9257
2610,華航,171,14,157,凱基-林口,2024-06-26,9257
00942B,台新美A公司債20+,150,0,150,凱基-林口,2024-06-26,9257
3481,群創,505,446,59,凱基-林口,2024-06-26,9257
00929,復華台灣科技優息,92,39,53,凱基-林口,2024-06-26,9257
3490,單井,50,0,50,凱基-林口,2024-06-26,9257
2316,楠梓電,49,7,42,凱基-林口,2024-06-26,9257
00633L,富邦上証正2,40,0,40,凱基-林口,2024-06-26,9257
00637L,元大滬深300正2,35,0,35,凱基-林口,2024-06-26,9257
2061,風青,35,0,35,凱基-林口,2024-06-26,9257
4906,正文,35,0,35,凱基-林口,2024-06-26,9257
00940,元大台灣價值高息,38,4,34,凱基-林口,2024-06-26,9257
2515,中工,38,5,33,凱基-林口,2024-06-26,9257
1101,台泥,40,10,30,凱基-林口,2024-06-26,9257
6244,茂迪,30,0,30,凱基-林口,2024-06-26,9257
3045,台灣大,28,0,28,凱基-林口,2024-06-26,9257
3419,譁裕,31,3,28,凱基-林口,2024-06-26,9257
00751B,元大AAA至A公司債,30,3,27,凱基-林口,2024-06-26,9257
8071,能率網通,26,0,26,凱基-林口,2024-06-26,9257
2303,聯電,33,8,25,凱基-林口,2024-06-26,9257
2317,鴻海,67,44,23,凱基-林口,2024-06-26,9257
3498,陽程,21,0,21,凱基-林口,2024-06-26,9257
2884,玉山金,20,0,20,凱基-林口,2024-06-26,9257
4540,全球傳動,20,0,20,凱基-林口,2024-06-26,9257
6834,天二科技,39,19,20,凱基-林口,2024-06-26,9257
8097,常珵,20,0,20,凱基-林口,2024-06-26,9257
9904,寶成,20,0,20,凱基-林口,2024-06-26,9257
911868,同方友友-DR,20,1,19,凱基-林口,2024-06-26,9257
00830,國泰費城半導體,16,0,16,凱基-林口,2024-06-26,9257
2501,國建,16,0,16,凱基-林口,2024-06-26,9257
1301,台塑,22,7,15,凱基-林口,2024-06-26,9257
1309,台達化,15,0,15,凱基-林口,2024-06-26,9257
2352,佳世達,16,2,14,凱基-林口,2024-06-26,9257
5425,台半,14,0,14,凱基-林口,2024-06-26,9257
912000,晨訊科-DR,20,6,14,凱基-林口,2024-06-26,9257
2002,中鋼,13,0,13,凱基-林口,2024-06-26,9257
00915,凱基優選高股息30,13,0,13,凱基-林口,2024-06-26,9257
2371,大同,28,15,13,凱基-林口,2024-06-26,9257
00919,群益台灣精選高息,36,24,12,凱基-林口,2024-06-26,9257
1326,台化,12,0,12,凱基-林口,2024-06-26,9257
00687B,國泰20年美債,12,0,12,凱基-林口,2024-06-26,9257
2204,中華,12,0,12,凱基-林口,2024-06-26,9257
2340,台亞,12,0,12,凱基-林口,2024-06-26,9257
2609,陽明,46,34,12,凱基-林口,2024-06-26,9257
2883,凱基金,12,0,12,凱基-林口,2024-06-26,9257
9945,潤泰新,12,0,12,凱基-林口,2024-06-26,9257
2406,國碩,15,4,11,凱基-林口,2024-06-26,9257
6269,台郡,11,0,11,凱基-林口,2024-06-26,9257
8027,鈦昇,12,1,11,凱基-林口,2024-06-26,9257
2354,鴻準,10,0,10,凱基-林口,2024-06-26,9257
00687B,國泰20年美債,284,0,284,凱基-林口,2024-06-27,9257
00937B,群益ESG投等債20,246,0,246,凱基-林口,2024-06-27,9257
00665L,富邦�琤肭磪囓�2,252,20,232,凱基-林口,2024-06-27,9257
00942B,台新美A公司債20+,214,0,214,凱基-林口,2024-06-27,9257
2331,精英,144,0,144,凱基-林口,2024-06-27,9257
6244,茂迪,102,3,99,凱基-林口,2024-06-27,9257
00929,復華台灣科技優息,95,1,94,凱基-林口,2024-06-27,9257
00679B,元大美債20年,85,0,85,凱基-林口,2024-06-27,9257
1709,和益,56,4,52,凱基-林口,2024-06-27,9257
00934,中信成長高股息,50,0,50,凱基-林口,2024-06-27,9257
2349,錸德,50,1,49,凱基-林口,2024-06-27,9257
3666,光耀,46,0,46,凱基-林口,2024-06-27,9257
3047,訊舟,87,42,45,凱基-林口,2024-06-27,9257
3663,鑫科,51,9,42,凱基-林口,2024-06-27,9257
4167,松瑞藥,95,58,37,凱基-林口,2024-06-27,9257
8076,伍豐,38,2,36,凱基-林口,2024-06-27,9257
00918,大華優利高填息30,34,2,32,凱基-林口,2024-06-27,9257
00936,台新永續高息中小,30,0,30,凱基-林口,2024-06-27,9257
2301,光寶科,72,43,29,凱基-林口,2024-06-27,9257
2543,皇昌,29,0,29,凱基-林口,2024-06-27,9257
00878,國泰永續高股息,29,4,25,凱基-林口,2024-06-27,9257
00939,統一台灣高息動能,25,0,25,凱基-林口,2024-06-27,9257
2371,大同,24,1,23,凱基-林口,2024-06-27,9257
5443,均豪,41,18,23,凱基-林口,2024-06-27,9257
4958,臻鼎-KY,22,0,22,凱基-林口,2024-06-27,9257
1303,南亞,33,12,21,凱基-林口,2024-06-27,9257
2888,新光金,31,10,21,凱基-林口,2024-06-27,9257
3455,由田,21,0,21,凱基-林口,2024-06-27,9257
2467,志聖,21,1,20,凱基-林口,2024-06-27,9257
1609,大亞,32,12,20,凱基-林口,2024-06-27,9257
2329,華泰,18,0,18,凱基-林口,2024-06-27,9257
4906,正文,43,25,18,凱基-林口,2024-06-27,9257
6806,森崴能源,45,28,17,凱基-林口,2024-06-27,9257
2609,陽明,32,15,17,凱基-林口,2024-06-27,9257
2352,佳世達,26,10,16,凱基-林口,2024-06-27,9257
2501,國建,16,0,16,凱基-林口,2024-06-27,9257
4561,健椿,17,1,16,凱基-林口,2024-06-27,9257
00637L,元大滬深300正2,15,0,15,凱基-林口,2024-06-27,9257
6282,康舒,15,0,15,凱基-林口,2024-06-27,9257
00720B,元大投資級公司債,14,0,14,凱基-林口,2024-06-27,9257
2356,英業達,19,5,14,凱基-林口,2024-06-27,9257
3055,蔚華科,31,17,14,凱基-林口,2024-06-27,9257
6727,亞泰金屬,14,0,14,凱基-林口,2024-06-27,9257
0056,元大高股息,26,12,14,凱基-林口,2024-06-27,9257
00722B,群益投資級電信債,13,0,13,凱基-林口,2024-06-27,9257
3049,精金,13,0,13,凱基-林口,2024-06-27,9257
00948B,中信優息投資級債,16,4,12,凱基-林口,2024-06-27,9257
2882,國泰金,15,3,12,凱基-林口,2024-06-27,9257
5351,鈺創,12,0,12,凱基-林口,2024-06-27,9257
6284,佳邦,12,0,12,凱基-林口,2024-06-27,9257
2427,三商電,121,0,121,凱基-林口,2024-06-28,9257
6546,正基,111,0,111,凱基-林口,2024-06-28,9257
1709,和益,100,0,100,凱基-林口,2024-06-28,9257
2618,長榮航,125,26,99,凱基-林口,2024-06-28,9257
00687B,國泰20年美債,99,0,99,凱基-林口,2024-06-28,9257
00680L,元大美債20正2,65,0,65,凱基-林口,2024-06-28,9257
00929,復華台灣科技優息,67,8,59,凱基-林口,2024-06-28,9257
2371,大同,52,5,47,凱基-林口,2024-06-28,9257
6244,茂迪,44,1,43,凱基-林口,2024-06-28,9257
2352,佳世達,46,3,43,凱基-林口,2024-06-28,9257
3490,單井,61,20,41,凱基-林口,2024-06-28,9257
00936,台新永續高息中小,39,0,39,凱基-林口,2024-06-28,9257
2337,旺宏,34,2,32,凱基-林口,2024-06-28,9257
2331,精英,32,0,32,凱基-林口,2024-06-28,9257
2402,毅嘉,31,0,31,凱基-林口,2024-06-28,9257
3666,光耀,31,1,30,凱基-林口,2024-06-28,9257
5213,亞昕,28,0,28,凱基-林口,2024-06-28,9257
3062,建漢,37,10,27,凱基-林口,2024-06-28,9257
2883,凱基金,27,1,26,凱基-林口,2024-06-28,9257
2882,國泰金,28,3,25,凱基-林口,2024-06-28,9257
6405,悅城,25,0,25,凱基-林口,2024-06-28,9257
2316,楠梓電,24,0,24,凱基-林口,2024-06-28,9257
6743,安普新,23,0,23,凱基-林口,2024-06-28,9257
3576,聯合再生,70,48,22,凱基-林口,2024-06-28,9257
00679B,元大美債20年,41,20,21,凱基-林口,2024-06-28,9257
2317,鴻海,29,9,20,凱基-林口,2024-06-28,9257
2867,三商壽,20,0,20,凱基-林口,2024-06-28,9257
9105,泰金寶-DR,20,0,20,凱基-林口,2024-06-28,9257
2312,金寶,20,3,17,凱基-林口,2024-06-28,9257
6285,啟��,20,3,17,凱基-林口,2024-06-28,9257
00919,群益台灣精選高息,19,3,16,凱基-林口,2024-06-28,9257
00712,復華富時不動產,16,0,16,凱基-林口,2024-06-28,9257
2303,聯電,18,2,16,凱基-林口,2024-06-28,9257
5515,建國,15,0,15,凱基-林口,2024-06-28,9257
3615,安可,15,0,15,凱基-林口,2024-06-28,9257
1504,東元,20,8,12,凱基-林口,2024-06-28,9257
3652,精聯,13,1,12,凱基-林口,2024-06-28,9257
00937B,群益ESG投等債20,12,1,11,凱基-林口,2024-06-28,9257
00665L,富邦�琤肭磪囓�2,11,0,11,凱基-林口,2024-06-28,9257
2489,瑞軒,21,10,11,凱基-林口,2024-06-28,9257
6509,聚和,10,0,10,凱基-林口,2024-06-28,9257
2347,聯強,10,0,10,凱基-林口,2024-06-28,9257
00830,國泰費城半導體,10,0,10,凱基-林口,2024-06-28,9257
00947,台新臺灣IC設計,10,0,10,凱基-林口,2024-06-28,9257
1733,五鼎,10,0,10,凱基-林口,2024-06-28,9257
2208,台船,10,0,10,凱基-林口,2024-06-28,9257
2377,微星,10,0,10,凱基-林口,2024-06-28,9257
2504,國產,10,0,10,凱基-林口,2024-06-28,9257
3481,群創,37,27,10,凱基-林口,2024-06-28,9257
6143,振曜,11,1,10,凱基-林口,2024-06-28,9257
00937B,群益ESG投等債20,415,4,411,凱基-林口,2024-07-01,9257
00687B,國泰20年美債,128,0,128,凱基-林口,2024-07-01,9257
00936,台新永續高息中小,121,0,121,凱基-林口,2024-07-01,9257
5498,凱崴,90,0,90,凱基-林口,2024-07-01,9257
2376,技嘉,82,0,82,凱基-林口,2024-07-01,9257
2313,華通,75,1,74,凱基-林口,2024-07-01,9257
00679B,元大美債20年,77,7,70,凱基-林口,2024-07-01,9257
2417,圓剛,54,3,51,凱基-林口,2024-07-01,9257
2882,國泰金,53,4,49,凱基-林口,2024-07-01,9257
1609,大亞,49,6,43,凱基-林口,2024-07-01,9257
2897,王道銀行,43,0,43,凱基-林口,2024-07-01,9257
3481,群創,31,0,31,凱基-林口,2024-07-01,9257
00948B,中信優息投資級債,28,0,28,凱基-林口,2024-07-01,9257
2316,楠梓電,25,2,23,凱基-林口,2024-07-01,9257
2883B,凱基金乙特,23,0,23,凱基-林口,2024-07-01,9257
2363,矽統,22,0,22,凱基-林口,2024-07-01,9257
6265,方土昶,22,0,22,凱基-林口,2024-07-01,9257
6278,台表科,22,1,21,凱基-林口,2024-07-01,9257
6743,安普新,21,0,21,凱基-林口,2024-07-01,9257
2107,厚生,20,0,20,凱基-林口,2024-07-01,9257
2367,燿華,58,38,20,凱基-林口,2024-07-01,9257
3490,單井,20,0,20,凱基-林口,2024-07-01,9257
8473,山林水,20,0,20,凱基-林口,2024-07-01,9257
00939,統一台灣高息動能,20,1,19,凱基-林口,2024-07-01,9257
3576,聯合再生,50,31,19,凱基-林口,2024-07-01,9257
6245,立端,20,1,19,凱基-林口,2024-07-01,9257
6589,台康生技,20,1,19,凱基-林口,2024-07-01,9257
6188,廣明,22,3,19,凱基-林口,2024-07-01,9257
6806,森崴能源,32,14,18,凱基-林口,2024-07-01,9257
2352,佳世達,51,34,17,凱基-林口,2024-07-01,9257
3024,憶聲,17,0,17,凱基-林口,2024-07-01,9257
2031,新光鋼,15,0,15,凱基-林口,2024-07-01,9257
1101,台泥,15,0,15,凱基-林口,2024-07-01,9257
8046,南電,13,0,13,凱基-林口,2024-07-01,9257
00680L,元大美債20正2,13,0,13,凱基-林口,2024-07-01,9257
3035,智原,14,1,13,凱基-林口,2024-07-01,9257
00933B,國泰10Y+金融債,13,1,12,凱基-林口,2024-07-01,9257
2337,旺宏,12,0,12,凱基-林口,2024-07-01,9257
00637L,元大滬深300正2,14,2,12,凱基-林口,2024-07-01,9257
00633L,富邦上証正2,12,0,12,凱基-林口,2024-07-01,9257
2464,盟立,24,12,12,凱基-林口,2024-07-01,9257
4958,臻鼎-KY,15,3,12,凱基-林口,2024-07-01,9257
912000,晨訊科-DR,12,0,12,凱基-林口,2024-07-01,9257
2101,南港,11,0,11,凱基-林口,2024-07-01,9257
3011,今皓,11,0,11,凱基-林口,2024-07-01,9257
3532,台勝科,11,1,10,凱基-林口,2024-07-01,9257
6753,龍德造船,14,4,10,凱基-林口,2024-07-01,9257
00902,中信電池及儲能,10,0,10,凱基-林口,2024-07-01,9257
1444,力麗,10,0,10,凱基-林口,2024-07-01,9257
1709,和益,11,1,10,凱基-林口,2024-07-01,9257
00942B,台新美A公司債20+,300,32,268,凱基-林口,2024-07-02,9257
00934,中信成長高股息,199,0,199,凱基-林口,2024-07-02,9257
00929,復華台灣科技優息,299,103,196,凱基-林口,2024-07-02,9257
2303,聯電,123,9,114,凱基-林口,2024-07-02,9257
00687B,國泰20年美債,104,1,103,凱基-林口,2024-07-02,9257
00937B,群益ESG投等債20,111,12,99,凱基-林口,2024-07-02,9257
00664R,國泰臺灣加權反1,100,9,91,凱基-林口,2024-07-02,9257
2618,長榮航,126,54,72,凱基-林口,2024-07-02,9257
2317,鴻海,95,24,71,凱基-林口,2024-07-02,9257
0056,元大高股息,67,0,67,凱基-林口,2024-07-02,9257
2316,楠梓電,65,0,65,凱基-林口,2024-07-02,9257
00927,群益半導體收益,58,0,58,凱基-林口,2024-07-02,9257
00936,台新永續高息中小,67,15,52,凱基-林口,2024-07-02,9257
4956,光鋐,90,39,51,凱基-林口,2024-07-02,9257
2301,光寶科,46,0,46,凱基-林口,2024-07-02,9257
2002,中鋼,36,0,36,凱基-林口,2024-07-02,9257
5905,南仁湖,35,0,35,凱基-林口,2024-07-02,9257
1303,南亞,32,1,31,凱基-林口,2024-07-02,9257
3665,貿聯-KY,30,1,29,凱基-林口,2024-07-02,9257
00882,中信中國高股息,30,2,28,凱基-林口,2024-07-02,9257
6546,正基,28,0,28,凱基-林口,2024-07-02,9257
912000,晨訊科-DR,28,1,27,凱基-林口,2024-07-02,9257
00918,大華優利高填息30,31,6,25,凱基-林口,2024-07-02,9257
2354,鴻準,24,1,23,凱基-林口,2024-07-02,9257
00946,群益科技高息成長,22,0,22,凱基-林口,2024-07-02,9257
00948B,中信優息投資級債,21,0,21,凱基-林口,2024-07-02,9257
00940,元大台灣價值高息,66,45,21,凱基-林口,2024-07-02,9257
2363,矽統,22,1,21,凱基-林口,2024-07-02,9257
1785,光洋科,21,1,20,凱基-林口,2024-07-02,9257
3712,永崴投控,20,0,20,凱基-林口,2024-07-02,9257
6290,良維,30,10,20,凱基-林口,2024-07-02,9257
2417,圓剛,18,0,18,凱基-林口,2024-07-02,9257
6197,佳必琪,21,4,17,凱基-林口,2024-07-02,9257
2329,華泰,17,1,16,凱基-林口,2024-07-02,9257
00680L,元大美債20正2,15,0,15,凱基-林口,2024-07-02,9257
00688L,國泰20年美債正2,15,0,15,凱基-林口,2024-07-02,9257
1309,台達化,15,0,15,凱基-林口,2024-07-02,9257
1447,力鵬,15,0,15,凱基-林口,2024-07-02,9257
1504,東元,15,0,15,凱基-林口,2024-07-02,9257
6873,泓德能源,15,0,15,凱基-林口,2024-07-02,9257
1301,台塑,17,2,15,凱基-林口,2024-07-02,9257
2061,風青,14,0,14,凱基-林口,2024-07-02,9257
3042,晶技,17,3,14,凱基-林口,2024-07-02,9257
3711,日月光投控,14,0,14,凱基-林口,2024-07-02,9257
8064,東捷,46,32,14,凱基-林口,2024-07-02,9257
4303,信立,13,0,13,凱基-林口,2024-07-02,9257
1608,華榮,12,0,12,凱基-林口,2024-07-02,9257
3211,順達,15,3,12,凱基-林口,2024-07-02,9257
00772B,中信高評級公司債,11,0,11,凱基-林口,2024-07-02,9257
4909,新復興,13,2,11,凱基-林口,2024-07-02,9257
00934,中信成長高股息,346,2,344,凱基-林口,2024-07-03,9257
2897,王道銀行,300,0,300,凱基-林口,2024-07-03,9257
00942B,台新美A公司債20+,186,0,186,凱基-林口,2024-07-03,9257
00937B,群益ESG投等債20,73,1,72,凱基-林口,2024-07-03,9257
1714,和桐,54,0,54,凱基-林口,2024-07-03,9257
5475,德宏,50,0,50,凱基-林口,2024-07-03,9257
2515,中工,55,7,48,凱基-林口,2024-07-03,9257
1444,力麗,40,0,40,凱基-林口,2024-07-03,9257
5905,南仁湖,37,3,34,凱基-林口,2024-07-03,9257
1905,華紙,37,4,33,凱基-林口,2024-07-03,9257
5706,鳳凰,30,0,30,凱基-林口,2024-07-03,9257
2618,長榮航,54,25,29,凱基-林口,2024-07-03,9257
00795B,中信美國公債20年,29,0,29,凱基-林口,2024-07-03,9257
4161,聿新科,39,10,29,凱基-林口,2024-07-03,9257
6443,元晶,50,21,29,凱基-林口,2024-07-03,9257
3016,嘉晶,26,0,26,凱基-林口,2024-07-03,9257
2614,東森,29,5,24,凱基-林口,2024-07-03,9257
00720B,元大投資級公司債,24,1,23,凱基-林口,2024-07-03,9257
00936,台新永續高息中小,22,0,22,凱基-林口,2024-07-03,9257
6217,中探針,24,2,22,凱基-林口,2024-07-03,9257
00679B,元大美債20年,21,0,21,凱基-林口,2024-07-03,9257
3673,TPK-KY,21,0,21,凱基-林口,2024-07-03,9257
8064,東捷,28,7,21,凱基-林口,2024-07-03,9257
2883,凱基金,216,195,21,凱基-林口,2024-07-03,9257
00650L,復華香港正2,40,20,20,凱基-林口,2024-07-03,9257
2301,光寶科,20,0,20,凱基-林口,2024-07-03,9257
3576,聯合再生,46,26,20,凱基-林口,2024-07-03,9257
4542,科嶠,20,0,20,凱基-林口,2024-07-03,9257
5443,均豪,90,70,20,凱基-林口,2024-07-03,9257
00680L,元大美債20正2,39,20,19,凱基-林口,2024-07-03,9257
2349,錸德,26,7,19,凱基-林口,2024-07-03,9257
2641,正德,28,9,19,凱基-林口,2024-07-03,9257
5392,能率,28,9,19,凱基-林口,2024-07-03,9257
6182,合晶,19,0,19,凱基-林口,2024-07-03,9257
2885,元大金,18,0,18,凱基-林口,2024-07-03,9257
3666,光耀,17,1,16,凱基-林口,2024-07-03,9257
3188,鑫龍騰,16,0,16,凱基-林口,2024-07-03,9257
6290,良維,16,0,16,凱基-林口,2024-07-03,9257
2354,鴻準,16,0,16,凱基-林口,2024-07-03,9257
1514,亞力,15,0,15,凱基-林口,2024-07-03,9257
00946,群益科技高息成長,14,0,14,凱基-林口,2024-07-03,9257
6873,泓德能源,14,0,14,凱基-林口,2024-07-03,9257
00927,群益半導體收益,13,0,13,凱基-林口,2024-07-03,9257
00687B,國泰20年美債,13,1,12,凱基-林口,2024-07-03,9257
2316,楠梓電,37,25,12,凱基-林口,2024-07-03,9257
4956,光鋐,14,2,12,凱基-林口,2024-07-03,9257
2317,鴻海,31,20,11,凱基-林口,2024-07-03,9257
1442,名軒,12,1,11,凱基-林口,2024-07-03,9257
2615,萬海,30,19,11,凱基-林口,2024-07-03,9257
3105,穩懋,11,0,11,凱基-林口,2024-07-03,9257
00680L,元大美債20正2,206,0,206,凱基-林口,2024-07-04,9257
00687B,國泰20年美債,154,0,154,凱基-林口,2024-07-04,9257
2883,凱基金,101,14,87,凱基-林口,2024-07-04,9257
6278,台表科,74,16,58,凱基-林口,2024-07-04,9257
00937B,群益ESG投等債20,55,1,54,凱基-林口,2024-07-04,9257
1447,力鵬,50,0,50,凱基-林口,2024-07-04,9257
9105,泰金寶-DR,50,0,50,凱基-林口,2024-07-04,9257
00946,群益科技高息成長,48,2,46,凱基-林口,2024-07-04,9257
6244,茂迪,42,4,38,凱基-林口,2024-07-04,9257
2397,友通,45,10,35,凱基-林口,2024-07-04,9257
3287,廣寰科,32,0,32,凱基-林口,2024-07-04,9257
8403,盛弘,32,0,32,凱基-林口,2024-07-04,9257
00919,群益台灣精選高息,30,0,30,凱基-林口,2024-07-04,9257
00934,中信成長高股息,25,0,25,凱基-林口,2024-07-04,9257
1409,新纖,25,0,25,凱基-林口,2024-07-04,9257
3037,欣興,30,6,24,凱基-林口,2024-07-04,9257
1314,中石化,45,21,24,凱基-林口,2024-07-04,9257
3062,建漢,35,12,23,凱基-林口,2024-07-04,9257
2412,中華電,23,0,23,凱基-林口,2024-07-04,9257
2609,陽明,26,4,22,凱基-林口,2024-07-04,9257
00632R,元大台灣50反1,22,0,22,凱基-林口,2024-07-04,9257
2489,瑞軒,20,0,20,凱基-林口,2024-07-04,9257
2618,長榮航,48,29,19,凱基-林口,2024-07-04,9257
1785,光洋科,44,26,18,凱基-林口,2024-07-04,9257
4958,臻鼎-KY,31,13,18,凱基-林口,2024-07-04,9257
6213,聯茂,18,0,18,凱基-林口,2024-07-04,9257
3583,辛耘,19,1,18,凱基-林口,2024-07-04,9257
4510,高鋒,51,35,16,凱基-林口,2024-07-04,9257
3450,聯鈞,151,135,16,凱基-林口,2024-07-04,9257
00645,富邦日本,15,0,15,凱基-林口,2024-07-04,9257
3576,聯合再生,29,15,14,凱基-林口,2024-07-04,9257
2323,中環,23,10,13,凱基-林口,2024-07-04,9257
6127,九豪,18,5,13,凱基-林口,2024-07-04,9257
2449,京元電子,23,11,12,凱基-林口,2024-07-04,9257
2641,正德,12,0,12,凱基-林口,2024-07-04,9257
9945,潤泰新,12,0,12,凱基-林口,2024-07-04,9257
5347,世界,12,0,12,凱基-林口,2024-07-04,9257
2546,根基,11,0,11,凱基-林口,2024-07-04,9257
2915,潤泰全,21,10,11,凱基-林口,2024-07-04,9257
5443,均豪,23,12,11,凱基-林口,2024-07-04,9257
6163,華電網,13,2,11,凱基-林口,2024-07-04,9257
3105,穩懋,13,3,10,凱基-林口,2024-07-04,9257
00899,FT潔淨能源,10,0,10,凱基-林口,2024-07-04,9257
00706L,期元大S＆P日圓正2,10,0,10,凱基-林口,2024-07-04,9257
00688L,國泰20年美債正2,10,0,10,凱基-林口,2024-07-04,9257
00665L,富邦�琤肭磪囓�2,11,1,10,凱基-林口,2024-07-04,9257
1308,亞聚,10,0,10,凱基-林口,2024-07-04,9257
1444,力麗,10,0,10,凱基-林口,2024-07-04,9257
2324,仁寶,11,1,10,凱基-林口,2024-07-04,9257
2354,鴻準,18,8,10,凱基-林口,2024-07-04,9257
00665L,富邦�琤肭磪囓�2,81,0,81,凱基-林口,2024-07-05,9257
3060,銘異,74,10,64,凱基-林口,2024-07-05,9257
6152,百一,62,1,61,凱基-林口,2024-07-05,9257
2316,楠梓電,43,1,42,凱基-林口,2024-07-05,9257
00637L,元大滬深300正2,39,0,39,凱基-林口,2024-07-05,9257
00918,大華優利高填息30,42,5,37,凱基-林口,2024-07-05,9257
2498,宏達電,42,8,34,凱基-林口,2024-07-05,9257
2365,昆盈,80,48,32,凱基-林口,2024-07-05,9257
00942B,台新美A公司債20+,31,0,31,凱基-林口,2024-07-05,9257
2457,飛宏,30,0,30,凱基-林口,2024-07-05,9257
00940,元大台灣價值高息,53,27,26,凱基-林口,2024-07-05,9257
2489,瑞軒,53,28,25,凱基-林口,2024-07-05,9257
1714,和桐,24,0,24,凱基-林口,2024-07-05,9257
2303,聯電,29,5,24,凱基-林口,2024-07-05,9257
2323,中環,26,3,23,凱基-林口,2024-07-05,9257
00934,中信成長高股息,24,2,22,凱基-林口,2024-07-05,9257
1537,廣隆,22,0,22,凱基-林口,2024-07-05,9257
2002,中鋼,28,6,22,凱基-林口,2024-07-05,9257
00936,台新永續高息中小,21,0,21,凱基-林口,2024-07-05,9257
00632R,元大台灣50反1,21,0,21,凱基-林口,2024-07-05,9257
6274,台燿,22,1,21,凱基-林口,2024-07-05,9257
3259,鑫創,20,0,20,凱基-林口,2024-07-05,9257
5356,協益,20,0,20,凱基-林口,2024-07-05,9257
6244,茂迪,112,93,19,凱基-林口,2024-07-05,9257
00679B,元大美債20年,25,8,17,凱基-林口,2024-07-05,9257
3037,欣興,18,2,16,凱基-林口,2024-07-05,9257
8104,錸寶,16,0,16,凱基-林口,2024-07-05,9257
1309,台達化,15,0,15,凱基-林口,2024-07-05,9257
2615,萬海,19,4,15,凱基-林口,2024-07-05,9257
2905,三商,15,0,15,凱基-林口,2024-07-05,9257
5484,慧友,15,0,15,凱基-林口,2024-07-05,9257
9958,世紀鋼,17,2,15,凱基-林口,2024-07-05,9257
1101,台泥,15,1,14,凱基-林口,2024-07-05,9257
2543,皇昌,137,123,14,凱基-林口,2024-07-05,9257
2888,新光金,30,16,14,凱基-林口,2024-07-05,9257
4123,晟德,15,2,13,凱基-林口,2024-07-05,9257
6139,亞翔,15,2,13,凱基-林口,2024-07-05,9257
4503,金雨,12,0,12,凱基-林口,2024-07-05,9257
6477,安集,11,0,11,凱基-林口,2024-07-05,9257
6505,台塑化,10,0,10,凱基-林口,2024-07-05,9257
2401,凌陽,39,29,10,凱基-林口,2024-07-05,9257
00680L,元大美債20正2,10,0,10,凱基-林口,2024-07-05,9257
1444,力麗,10,0,10,凱基-林口,2024-07-05,9257
1447,力鵬,10,0,10,凱基-林口,2024-07-05,9257
2349,錸德,11,1,10,凱基-林口,2024-07-05,9257
5009,榮剛,10,0,10,凱基-林口,2024-07-05,9257
6218,豪勉,10,0,10,凱基-林口,2024-07-05,9257
2603,長榮,9,0,9,凱基-林口,2024-07-05,9257
3058,立德,9,0,9,凱基-林口,2024-07-05,9257
3303,岱稜,12,3,9,凱基-林口,2024-07-05,9257
00632R,元大台灣50反1,126,20,106,凱基-林口,2024-07-08,9257
00934,中信成長高股息,70,0,70,凱基-林口,2024-07-08,9257
1447,力鵬,61,0,61,凱基-林口,2024-07-08,9257
1444,力麗,60,0,60,凱基-林口,2024-07-08,9257
2609,陽明,90,39,51,凱基-林口,2024-07-08,9257
2417,圓剛,56,6,50,凱基-林口,2024-07-08,9257
00923,群益台ESG低碳50,45,0,45,凱基-林口,2024-07-08,9257
2365,昆盈,150,105,45,凱基-林口,2024-07-08,9257
3666,光耀,44,1,43,凱基-林口,2024-07-08,9257
00929,復華台灣科技優息,56,14,42,凱基-林口,2024-07-08,9257
00946,群益科技高息成長,41,0,41,凱基-林口,2024-07-08,9257
2337,旺宏,42,4,38,凱基-林口,2024-07-08,9257
00888,永豐台灣ESG,32,0,32,凱基-林口,2024-07-08,9257
00650L,復華香港正2,30,0,30,凱基-林口,2024-07-08,9257
00945B,凱基美國非投等債,30,0,30,凱基-林口,2024-07-08,9257
2312,金寶,30,1,29,凱基-林口,2024-07-08,9257
4958,臻鼎-KY,34,5,29,凱基-林口,2024-07-08,9257
3094,聯傑,67,41,26,凱基-林口,2024-07-08,9257
2363,矽統,66,41,25,凱基-林口,2024-07-08,9257
2020,美亞,25,0,25,凱基-林口,2024-07-08,9257
2352,佳世達,34,10,24,凱基-林口,2024-07-08,9257
6187,萬潤,27,4,23,凱基-林口,2024-07-08,9257
8064,東捷,41,19,22,凱基-林口,2024-07-08,9257
1785,光洋科,35,13,22,凱基-林口,2024-07-08,9257
6789,采鈺,25,4,21,凱基-林口,2024-07-08,9257
2323,中環,32,11,21,凱基-林口,2024-07-08,9257
6282,康舒,21,1,20,凱基-林口,2024-07-08,9257
1463,強盛新,20,0,20,凱基-林口,2024-07-08,9257
3481,群創,72,52,20,凱基-林口,2024-07-08,9257
2489,瑞軒,19,0,19,凱基-林口,2024-07-08,9257
6179,亞通,23,4,19,凱基-林口,2024-07-08,9257
00881,國泰台灣5G+,18,0,18,凱基-林口,2024-07-08,9257
00680L,元大美債20正2,16,0,16,凱基-林口,2024-07-08,9257
1409,新纖,45,30,15,凱基-林口,2024-07-08,9257
8088,品安,15,0,15,凱基-林口,2024-07-08,9257
2905,三商,15,0,15,凱基-林口,2024-07-08,9257
9945,潤泰新,15,0,15,凱基-林口,2024-07-08,9257
3058,立德,14,0,14,凱基-林口,2024-07-08,9257
3379,彬台,14,0,14,凱基-林口,2024-07-08,9257
6126,信音,19,5,14,凱基-林口,2024-07-08,9257
6182,合晶,16,2,14,凱基-林口,2024-07-08,9257
00927,群益半導體收益,14,0,14,凱基-林口,2024-07-08,9257
3576,聯合再生,24,11,13,凱基-林口,2024-07-08,9257
2464,盟立,17,4,13,凱基-林口,2024-07-08,9257
4976,佳凌,17,4,13,凱基-林口,2024-07-08,9257
2530,華建,12,0,12,凱基-林口,2024-07-08,9257
2641,正德,12,0,12,凱基-林口,2024-07-08,9257
4130,健亞,12,0,12,凱基-林口,2024-07-08,9257
6153,嘉聯益,41,29,12,凱基-林口,2024-07-08,9257
00936,台新永續高息中小,11,0,11,凱基-林口,2024-07-08,9257
00927,群益半導體收益,110,0,110,凱基-林口,2024-07-09,9257
1806,冠軍,100,0,100,凱基-林口,2024-07-09,9257
2316,楠梓電,123,44,79,凱基-林口,2024-07-09,9257
8105,凌巨,82,7,75,凱基-林口,2024-07-09,9257
00936,台新永續高息中小,75,0,75,凱基-林口,2024-07-09,9257
9105,泰金寶-DR,127,59,68,凱基-林口,2024-07-09,9257
00934,中信成長高股息,65,0,65,凱基-林口,2024-07-09,9257
00632R,元大台灣50反1,62,0,62,凱基-林口,2024-07-09,9257
6016,康和證,58,0,58,凱基-林口,2024-07-09,9257
2312,金寶,86,29,57,凱基-林口,2024-07-09,9257
3490,單井,51,0,51,凱基-林口,2024-07-09,9257
2317,鴻海,76,30,46,凱基-林口,2024-07-09,9257
4161,聿新科,75,29,46,凱基-林口,2024-07-09,9257
2367,燿華,208,174,34,凱基-林口,2024-07-09,9257
3047,訊舟,104,71,33,凱基-林口,2024-07-09,9257
3062,建漢,34,4,30,凱基-林口,2024-07-09,9257
5521,工信,30,0,30,凱基-林口,2024-07-09,9257
3049,精金,29,0,29,凱基-林口,2024-07-09,9257
00881,國泰台灣5G+,32,5,27,凱基-林口,2024-07-09,9257
00650L,復華香港正2,25,0,25,凱基-林口,2024-07-09,9257
1326,台化,24,0,24,凱基-林口,2024-07-09,9257
3710,連展投控,29,5,24,凱基-林口,2024-07-09,9257
1314,中石化,23,0,23,凱基-林口,2024-07-09,9257
00680L,元大美債20正2,23,1,22,凱基-林口,2024-07-09,9257
1783,和康生,26,5,21,凱基-林口,2024-07-09,9257
6719,力智,21,0,21,凱基-林口,2024-07-09,9257
2352,佳世達,21,1,20,凱基-林口,2024-07-09,9257
1455,集盛,20,0,20,凱基-林口,2024-07-09,9257
1310,台苯,24,5,19,凱基-林口,2024-07-09,9257
2337,旺宏,19,0,19,凱基-林口,2024-07-09,9257
8103,瀚荃,21,2,19,凱基-林口,2024-07-09,9257
2374,佳能,21,2,19,凱基-林口,2024-07-09,9257
0056,元大高股息,21,2,19,凱基-林口,2024-07-09,9257
2641,正德,18,0,18,凱基-林口,2024-07-09,9257
2344,華邦電,20,2,18,凱基-林口,2024-07-09,9257
2301,光寶科,16,1,15,凱基-林口,2024-07-09,9257
00923,群益台ESG低碳50,15,0,15,凱基-林口,2024-07-09,9257
3450,聯鈞,16,1,15,凱基-林口,2024-07-09,9257
2601,益航,14,0,14,凱基-林口,2024-07-09,9257
3712,永崴投控,17,3,14,凱基-林口,2024-07-09,9257
8071,能率網通,15,1,14,凱基-林口,2024-07-09,9257
2313,華通,48,34,14,凱基-林口,2024-07-09,9257
4303,信立,12,0,12,凱基-林口,2024-07-09,9257
2388,威盛,16,4,12,凱基-林口,2024-07-09,9257
2834,臺企銀,37,26,11,凱基-林口,2024-07-09,9257
3622,洋華,24,13,11,凱基-林口,2024-07-09,9257
8046,南電,13,3,10,凱基-林口,2024-07-09,9257
00631L,元大台灣50正2,10,0,10,凱基-林口,2024-07-09,9257
00713,元大台灣高息低波,11,1,10,凱基-林口,2024-07-09,9257
3558,神準,10,0,10,凱基-林口,2024-07-09,9257
00931B,統一美債20年,400,0,400,凱基-林口,2024-07-10,9257
6126,信音,257,12,245,凱基-林口,2024-07-10,9257
00937B,群益ESG投等債20,113,0,113,凱基-林口,2024-07-10,9257
3312,弘憶股,142,32,110,凱基-林口,2024-07-10,9257
2301,光寶科,93,6,87,凱基-林口,2024-07-10,9257
2888,新光金,218,152,66,凱基-林口,2024-07-10,9257
2070,精湛,53,0,53,凱基-林口,2024-07-10,9257
3376,新日興,74,21,53,凱基-林口,2024-07-10,9257
2543,皇昌,71,20,51,凱基-林口,2024-07-10,9257
00934,中信成長高股息,48,0,48,凱基-林口,2024-07-10,9257
2509,全坤建,45,0,45,凱基-林口,2024-07-10,9257
8105,凌巨,71,30,41,凱基-林口,2024-07-10,9257
4157,太景*-KY,40,0,40,凱基-林口,2024-07-10,9257
2317,鴻海,50,13,37,凱基-林口,2024-07-10,9257
2392,正崴,223,191,32,凱基-林口,2024-07-10,9257
00935,野村臺灣新科技50,31,0,31,凱基-林口,2024-07-10,9257
00662,富邦NASDAQ,30,0,30,凱基-林口,2024-07-10,9257
00927,群益半導體收益,27,0,27,凱基-林口,2024-07-10,9257
2303,聯電,31,11,20,凱基-林口,2024-07-10,9257
00945B,凱基美國非投等債,20,0,20,凱基-林口,2024-07-10,9257
5236,凌陽創新,20,0,20,凱基-林口,2024-07-10,9257
3037,欣興,26,8,18,凱基-林口,2024-07-10,9257
00936,台新永續高息中小,23,6,17,凱基-林口,2024-07-10,9257
6770,力積電,17,0,17,凱基-林口,2024-07-10,9257
2324,仁寶,19,2,17,凱基-林口,2024-07-10,9257
2867,三商壽,23,6,17,凱基-林口,2024-07-10,9257
1326,台化,17,1,16,凱基-林口,2024-07-10,9257
00687B,國泰20年美債,16,0,16,凱基-林口,2024-07-10,9257
3580,友威科,25,9,16,凱基-林口,2024-07-10,9257
2353,宏��,30,14,16,凱基-林口,2024-07-10,9257
5880,合庫金,15,0,15,凱基-林口,2024-07-10,9257
8046,南電,17,2,15,凱基-林口,2024-07-10,9257
2845,遠東銀,15,0,15,凱基-林口,2024-07-10,9257
3231,緯創,16,1,15,凱基-林口,2024-07-10,9257
4909,新復興,21,6,15,凱基-林口,2024-07-10,9257
1718,中纖,15,1,14,凱基-林口,2024-07-10,9257
3625,西勝,14,0,14,凱基-林口,2024-07-10,9257
4904,遠傳,16,2,14,凱基-林口,2024-07-10,9257
2884,玉山金,21,8,13,凱基-林口,2024-07-10,9257
6116,彩晶,13,0,13,凱基-林口,2024-07-10,9257
8438,昶昕,13,0,13,凱基-林口,2024-07-10,9257
00692,富邦公司治理,27,15,12,凱基-林口,2024-07-10,9257
00882,中信中國高股息,14,2,12,凱基-林口,2024-07-10,9257
6278,台表科,12,0,12,凱基-林口,2024-07-10,9257
5443,均豪,14,3,11,凱基-林口,2024-07-10,9257
1616,億泰,46,35,11,凱基-林口,2024-07-10,9257
2352,佳世達,13,2,11,凱基-林口,2024-07-10,9257
00661,元大日經225,10,0,10,凱基-林口,2024-07-10,9257
00942B,台新美A公司債20+,10,0,10,凱基-林口,2024-07-10,9257
4960,誠美材,11,1,10,凱基-林口,2024-07-10,9257
6244,茂迪,152,0,152,凱基-林口,2024-07-11,9257
2891,中信金,127,6,121,凱基-林口,2024-07-11,9257
1718,中纖,103,0,103,凱基-林口,2024-07-11,9257
2427,三商電,71,1,70,凱基-林口,2024-07-11,9257
2888,新光金,154,99,55,凱基-林口,2024-07-11,9257
4414,如興,50,0,50,凱基-林口,2024-07-11,9257
2316,楠梓電,50,1,49,凱基-林口,2024-07-11,9257
1447,力鵬,46,0,46,凱基-林口,2024-07-11,9257
00680L,元大美債20正2,41,0,41,凱基-林口,2024-07-11,9257
2317,鴻海,57,17,40,凱基-林口,2024-07-11,9257
2371,大同,44,6,38,凱基-林口,2024-07-11,9257
2509,全坤建,33,0,33,凱基-林口,2024-07-11,9257
00878,國泰永續高股息,48,15,33,凱基-林口,2024-07-11,9257
2363,矽統,69,37,32,凱基-林口,2024-07-11,9257
00934,中信成長高股息,32,1,31,凱基-林口,2024-07-11,9257
2464,盟立,35,6,29,凱基-林口,2024-07-11,9257
2303,聯電,35,7,28,凱基-林口,2024-07-11,9257
1101,台泥,27,0,27,凱基-林口,2024-07-11,9257
6284,佳邦,32,5,27,凱基-林口,2024-07-11,9257
2365,昆盈,53,28,25,凱基-林口,2024-07-11,9257
6177,達麗,28,4,24,凱基-林口,2024-07-11,9257
2337,旺宏,35,13,22,凱基-林口,2024-07-11,9257
00679B,元大美債20年,34,13,21,凱基-林口,2024-07-11,9257
4303,信立,21,0,21,凱基-林口,2024-07-11,9257
6125,廣運,23,3,20,凱基-林口,2024-07-11,9257
00921,兆豐龍頭等權重,20,0,20,凱基-林口,2024-07-11,9257
2905,三商,20,0,20,凱基-林口,2024-07-11,9257
2453,凌群,30,11,19,凱基-林口,2024-07-11,9257
2515,中工,28,10,18,凱基-林口,2024-07-11,9257
00946,群益科技高息成長,21,5,16,凱基-林口,2024-07-11,9257
3048,益登,27,11,16,凱基-林口,2024-07-11,9257
9906,欣巴巴,16,0,16,凱基-林口,2024-07-11,9257
2884,玉山金,20,5,15,凱基-林口,2024-07-11,9257
3490,單井,15,0,15,凱基-林口,2024-07-11,9257
3576,聯合再生,21,7,14,凱基-林口,2024-07-11,9257
2867,三商壽,14,0,14,凱基-林口,2024-07-11,9257
6509,聚和,14,0,14,凱基-林口,2024-07-11,9257
1513,中興電,37,24,13,凱基-林口,2024-07-11,9257
00725B,國泰投資級公司債,13,0,13,凱基-林口,2024-07-11,9257
2405,輔信,17,5,12,凱基-林口,2024-07-11,9257
2002,中鋼,11,0,11,凱基-林口,2024-07-11,9257
2467,志聖,10,0,10,凱基-林口,2024-07-11,9257
00942B,台新美A公司債20+,10,0,10,凱基-林口,2024-07-11,9257
00950B,凱基A級公司債,10,0,10,凱基-林口,2024-07-11,9257
2460,建通,10,0,10,凱基-林口,2024-07-11,9257
2906,高林,10,0,10,凱基-林口,2024-07-11,9257
3217,優群,10,0,10,凱基-林口,2024-07-11,9257
6182,合晶,14,4,10,凱基-林口,2024-07-11,9257
00927,群益半導體收益,19,10,9,凱基-林口,2024-07-11,9257
2243,宏旭-KY,10,1,9,凱基-林口,2024-07-11,9257
3673,TPK-KY,321,7,314,凱基-林口,2024-07-12,9257
2402,毅嘉,310,7,303,凱基-林口,2024-07-12,9257
00740B,富邦全球投等債,125,0,125,凱基-林口,2024-07-12,9257
2317,鴻海,122,8,114,凱基-林口,2024-07-12,9257
00688L,國泰20年美債正2,90,0,90,凱基-林口,2024-07-12,9257
6244,茂迪,78,9,69,凱基-林口,2024-07-12,9257
3576,聯合再生,70,2,68,凱基-林口,2024-07-12,9257
00650L,復華香港正2,101,35,66,凱基-林口,2024-07-12,9257
00934,中信成長高股息,63,1,62,凱基-林口,2024-07-12,9257
6757,台灣虎航,52,0,52,凱基-林口,2024-07-12,9257
00919,群益台灣精選高息,166,121,45,凱基-林口,2024-07-12,9257
2905,三商,35,0,35,凱基-林口,2024-07-12,9257
2867,三商壽,58,26,32,凱基-林口,2024-07-12,9257
4956,光鋐,32,0,32,凱基-林口,2024-07-12,9257
2451,創見,30,0,30,凱基-林口,2024-07-12,9257
2330,台積電,31,1,30,凱基-林口,2024-07-12,9257
3050,鈺德,37,8,29,凱基-林口,2024-07-12,9257
2344,華邦電,30,2,28,凱基-林口,2024-07-12,9257
2453,凌群,24,0,24,凱基-林口,2024-07-12,9257
2615,萬海,30,8,22,凱基-林口,2024-07-12,9257
00940,元大台灣價值高息,52,30,22,凱基-林口,2024-07-12,9257
2509,全坤建,22,0,22,凱基-林口,2024-07-12,9257
3481,群創,129,107,22,凱基-林口,2024-07-12,9257
4303,信立,20,0,20,凱基-林口,2024-07-12,9257
00905,FT臺灣Smart,20,0,20,凱基-林口,2024-07-12,9257
1714,和桐,20,0,20,凱基-林口,2024-07-12,9257
00927,群益半導體收益,19,0,19,凱基-林口,2024-07-12,9257
3047,訊舟,18,0,18,凱基-林口,2024-07-12,9257
6111,大宇資,17,0,17,凱基-林口,2024-07-12,9257
8064,東捷,18,2,16,凱基-林口,2024-07-12,9257
2883,凱基金,20,4,16,凱基-林口,2024-07-12,9257
00881,國泰台灣5G+,18,3,15,凱基-林口,2024-07-12,9257
2897,王道銀行,25,10,15,凱基-林口,2024-07-12,9257
4726,永昕,15,0,15,凱基-林口,2024-07-12,9257
4576,大銀微系統,17,3,14,凱基-林口,2024-07-12,9257
3019,亞光,18,4,14,凱基-林口,2024-07-12,9257
2363,矽統,19,5,14,凱基-林口,2024-07-12,9257
1307,三芳,13,0,13,凱基-林口,2024-07-12,9257
1309,台達化,13,0,13,凱基-林口,2024-07-12,9257
2367,燿華,13,0,13,凱基-林口,2024-07-12,9257
2369,菱生,13,0,13,凱基-林口,2024-07-12,9257
3363,上詮,25,13,12,凱基-林口,2024-07-12,9257
6284,佳邦,12,0,12,凱基-林口,2024-07-12,9257
1785,光洋科,26,15,11,凱基-林口,2024-07-12,9257
9938,百和,11,0,11,凱基-林口,2024-07-12,9257
00923,群益台ESG低碳50,10,0,10,凱基-林口,2024-07-12,9257
2301,光寶科,16,6,10,凱基-林口,2024-07-12,9257
00921,兆豐龍頭等權重,10,0,10,凱基-林口,2024-07-12,9257
2393,億光,11,1,10,凱基-林口,2024-07-12,9257
2809,京城銀,10,0,10,凱基-林口,2024-07-12,9257
2402,毅嘉,474,12,462,凱基-林口,2024-07-15,9257
6757,台灣虎航,336,12,324,凱基-林口,2024-07-15,9257
00934,中信成長高股息,286,0,286,凱基-林口,2024-07-15,9257
2888,新光金,449,180,269,凱基-林口,2024-07-15,9257
2891,中信金,139,7,132,凱基-林口,2024-07-15,9257
00929,復華台灣科技優息,156,29,127,凱基-林口,2024-07-15,9257
2801,彰銀,120,0,120,凱基-林口,2024-07-15,9257
8105,凌巨,115,7,108,凱基-林口,2024-07-15,9257
3019,亞光,91,15,76,凱基-林口,2024-07-15,9257
2417,圓剛,65,2,63,凱基-林口,2024-07-15,9257
3712,永崴投控,62,9,53,凱基-林口,2024-07-15,9257
00919,群益台灣精選高息,53,2,51,凱基-林口,2024-07-15,9257
2889,國票金,51,0,51,凱基-林口,2024-07-15,9257
1608,華榮,63,20,43,凱基-林口,2024-07-15,9257
2312,金寶,63,24,39,凱基-林口,2024-07-15,9257
00725B,國泰投資級公司債,35,1,34,凱基-林口,2024-07-15,9257
2103,台橡,34,0,34,凱基-林口,2024-07-15,9257
3062,建漢,33,0,33,凱基-林口,2024-07-15,9257
3673,TPK-KY,33,4,29,凱基-林口,2024-07-15,9257
2332,友訊,25,0,25,凱基-林口,2024-07-15,9257
2601,益航,25,0,25,凱基-林口,2024-07-15,9257
3594,磐儀,37,13,24,凱基-林口,2024-07-15,9257
00680L,元大美債20正2,22,0,22,凱基-林口,2024-07-15,9257
8103,瀚荃,26,5,21,凱基-林口,2024-07-15,9257
2401,凌陽,21,0,21,凱基-林口,2024-07-15,9257
2897,王道銀行,25,5,20,凱基-林口,2024-07-15,9257
2905,三商,20,0,20,凱基-林口,2024-07-15,9257
3490,單井,20,0,20,凱基-林口,2024-07-15,9257
2353,宏��,40,21,19,凱基-林口,2024-07-15,9257
1532,勤美,20,1,19,凱基-林口,2024-07-15,9257
2883,凱基金,20,2,18,凱基-林口,2024-07-15,9257
00888,永豐台灣ESG,28,10,18,凱基-林口,2024-07-15,9257
00936,台新永續高息中小,17,0,17,凱基-林口,2024-07-15,9257
00687B,國泰20年美債,17,0,17,凱基-林口,2024-07-15,9257
2324,仁寶,15,1,14,凱基-林口,2024-07-15,9257
00795B,中信美國公債20年,13,0,13,凱基-林口,2024-07-15,9257
1303,南亞,14,2,12,凱基-林口,2024-07-15,9257
2929,淘帝-KY,16,4,12,凱基-林口,2024-07-15,9257
3022,威強電,15,3,12,凱基-林口,2024-07-15,9257
5381,合正,19,7,12,凱基-林口,2024-07-15,9257
8473,山林水,13,1,12,凱基-林口,2024-07-15,9257
1563,巧新,11,0,11,凱基-林口,2024-07-15,9257
1605,華新,11,0,11,凱基-林口,2024-07-15,9257
3545,敦泰,11,0,11,凱基-林口,2024-07-15,9257
6806,森崴能源,17,6,11,凱基-林口,2024-07-15,9257
00632R,元大台灣50反1,40,30,10,凱基-林口,2024-07-15,9257
00937B,群益ESG投等債20,31,21,10,凱基-林口,2024-07-15,9257
1727,中華化,15,5,10,凱基-林口,2024-07-15,9257
2405,輔信,28,18,10,凱基-林口,2024-07-15,9257
3038,全台,10,0,10,凱基-林口,2024-07-15,9257
2888,新光金,1278,163,1115,凱基-林口,2024-07-16,9257
2402,毅嘉,580,2,578,凱基-林口,2024-07-16,9257
0056,元大高股息,182,0,182,凱基-林口,2024-07-16,9257
4956,光鋐,148,33,115,凱基-林口,2024-07-16,9257
00882,中信中國高股息,107,0,107,凱基-林口,2024-07-16,9257
2401,凌陽,85,2,83,凱基-林口,2024-07-16,9257
2070,精湛,55,0,55,凱基-林口,2024-07-16,9257
00753L,中信中國50正2,50,0,50,凱基-林口,2024-07-16,9257
00949,復華日本龍頭,50,0,50,凱基-林口,2024-07-16,9257
9958,世紀鋼,47,0,47,凱基-林口,2024-07-16,9257
00650L,復華香港正2,45,0,45,凱基-林口,2024-07-16,9257
2867,三商壽,70,27,43,凱基-林口,2024-07-16,9257
00934,中信成長高股息,40,0,40,凱基-林口,2024-07-16,9257
2356,英業達,41,6,35,凱基-林口,2024-07-16,9257
4161,聿新科,70,35,35,凱基-林口,2024-07-16,9257
2303,聯電,35,2,33,凱基-林口,2024-07-16,9257
00929,復華台灣科技優息,35,3,32,凱基-林口,2024-07-16,9257
1540,喬福,38,7,31,凱基-林口,2024-07-16,9257
00905,FT臺灣Smart,30,0,30,凱基-林口,2024-07-16,9257
6757,台灣虎航,30,0,30,凱基-林口,2024-07-16,9257
6026,福邦證,25,0,25,凱基-林口,2024-07-16,9257
00933B,國泰10Y+金融債,23,0,23,凱基-林口,2024-07-16,9257
1609,大亞,31,9,22,凱基-林口,2024-07-16,9257
1514,亞力,24,3,21,凱基-林口,2024-07-16,9257
3234,光環,20,0,20,凱基-林口,2024-07-16,9257
2317,鴻海,46,28,18,凱基-林口,2024-07-16,9257
4526,東台,17,0,17,凱基-林口,2024-07-16,9257
1316,上曜,19,2,17,凱基-林口,2024-07-16,9257
00937B,群益ESG投等債20,45,29,16,凱基-林口,2024-07-16,9257
00687B,國泰20年美債,32,16,16,凱基-林口,2024-07-16,9257
2312,金寶,29,13,16,凱基-林口,2024-07-16,9257
1731,美吾華,15,0,15,凱基-林口,2024-07-16,9257
2451,創見,15,0,15,凱基-林口,2024-07-16,9257
3227,原相,15,0,15,凱基-林口,2024-07-16,9257
4123,晟德,15,0,15,凱基-林口,2024-07-16,9257
2481,強茂,18,4,14,凱基-林口,2024-07-16,9257
2884,玉山金,14,0,14,凱基-林口,2024-07-16,9257
3163,波若威,28,14,14,凱基-林口,2024-07-16,9257
2367,燿華,17,4,13,凱基-林口,2024-07-16,9257
5425,台半,13,0,13,凱基-林口,2024-07-16,9257
2492,華新科,16,3,13,凱基-林口,2024-07-16,9257
00712,復華富時不動產,21,10,11,凱基-林口,2024-07-16,9257
2388,威盛,23,12,11,凱基-林口,2024-07-16,9257
3481,群創,20,10,10,凱基-林口,2024-07-16,9257
00940,元大台灣價值高息,21,11,10,凱基-林口,2024-07-16,9257
1102,亞泥,10,0,10,凱基-林口,2024-07-16,9257
1313,聯成,10,0,10,凱基-林口,2024-07-16,9257
1471,首利,10,0,10,凱基-林口,2024-07-16,9257
1785,光洋科,15,5,10,凱基-林口,2024-07-16,9257
2010,春源,10,0,10,凱基-林口,2024-07-16,9257
2402,毅嘉,475,84,391,凱基-林口,2024-07-17,9257
00929,復華台灣科技優息,270,22,248,凱基-林口,2024-07-17,9257
6757,台灣虎航,131,0,131,凱基-林口,2024-07-17,9257
00937B,群益ESG投等債20,130,5,125,凱基-林口,2024-07-17,9257
00950B,凱基A級公司債,105,0,105,凱基-林口,2024-07-17,9257
0056,元大高股息,75,3,72,凱基-林口,2024-07-17,9257
3312,弘憶股,67,11,56,凱基-林口,2024-07-17,9257
00891,中信關鍵半導體,56,0,56,凱基-林口,2024-07-17,9257
00946,群益科技高息成長,56,3,53,凱基-林口,2024-07-17,9257
1308,亞聚,50,0,50,凱基-林口,2024-07-17,9257
3163,波若威,57,13,44,凱基-林口,2024-07-17,9257
2392,正崴,200,157,43,凱基-林口,2024-07-17,9257
2501,國建,41,2,39,凱基-林口,2024-07-17,9257
00878,國泰永續高股息,39,4,35,凱基-林口,2024-07-17,9257
00650L,復華香港正2,35,0,35,凱基-林口,2024-07-17,9257
00671R,富邦NASDAQ反1,35,0,35,凱基-林口,2024-07-17,9257
3498,陽程,35,2,33,凱基-林口,2024-07-17,9257
00940,元大台灣價值高息,66,33,33,凱基-林口,2024-07-17,9257
00915,凱基優選高股息30,33,0,33,凱基-林口,2024-07-17,9257
2509,全坤建,33,0,33,凱基-林口,2024-07-17,9257
00927,群益半導體收益,29,0,29,凱基-林口,2024-07-17,9257
4956,光鋐,40,11,29,凱基-林口,2024-07-17,9257
6658,聯策,28,0,28,凱基-林口,2024-07-17,9257
1605,華新,52,27,25,凱基-林口,2024-07-17,9257
2356,英業達,42,17,25,凱基-林口,2024-07-17,9257
2891,中信金,24,0,24,凱基-林口,2024-07-17,9257
00905,FT臺灣Smart,24,0,24,凱基-林口,2024-07-17,9257
2489,瑞軒,71,47,24,凱基-林口,2024-07-17,9257
00881,國泰台灣5G+,23,0,23,凱基-林口,2024-07-17,9257
2342,茂矽,23,0,23,凱基-林口,2024-07-17,9257
2330,台積電,24,1,23,凱基-林口,2024-07-17,9257
1102,亞泥,22,0,22,凱基-林口,2024-07-17,9257
00919,群益台灣精選高息,32,11,21,凱基-林口,2024-07-17,9257
8996,高力,20,0,20,凱基-林口,2024-07-17,9257
00909,國泰數位支付服務,20,0,20,凱基-林口,2024-07-17,9257
2382,廣達,21,3,18,凱基-林口,2024-07-17,9257
2371,大同,21,4,17,凱基-林口,2024-07-17,9257
2317,鴻海,29,12,17,凱基-林口,2024-07-17,9257
00949,復華日本龍頭,16,0,16,凱基-林口,2024-07-17,9257
3673,TPK-KY,204,188,16,凱基-林口,2024-07-17,9257
4161,聿新科,24,8,16,凱基-林口,2024-07-17,9257
5425,台半,16,0,16,凱基-林口,2024-07-17,9257
6770,力積電,19,3,16,凱基-林口,2024-07-17,9257
2451,創見,15,0,15,凱基-林口,2024-07-17,9257
00918,大華優利高填息30,15,0,15,凱基-林口,2024-07-17,9257
3059,華晶科,14,0,14,凱基-林口,2024-07-17,9257
2376,技嘉,14,1,13,凱基-林口,2024-07-17,9257
4526,東台,14,1,13,凱基-林口,2024-07-17,9257
6151,晉倫,13,0,13,凱基-林口,2024-07-17,9257
6829,千附精密,15,2,13,凱基-林口,2024-07-17,9257
00929,復華台灣科技優息,141,2,139,凱基-林口,2024-07-18,9257
00664R,國泰臺灣加權反1,100,0,100,凱基-林口,2024-07-18,9257
0056,元大高股息,98,6,92,凱基-林口,2024-07-18,9257
2353,宏��,93,7,86,凱基-林口,2024-07-18,9257
2317,鴻海,110,35,75,凱基-林口,2024-07-18,9257
6126,信音,71,1,70,凱基-林口,2024-07-18,9257
2356,英業達,64,1,63,凱基-林口,2024-07-18,9257
00632R,元大台灣50反1,80,25,55,凱基-林口,2024-07-18,9257
2331,精英,52,0,52,凱基-林口,2024-07-18,9257
2883,凱基金,70,21,49,凱基-林口,2024-07-18,9257
2402,毅嘉,96,47,49,凱基-林口,2024-07-18,9257
00878,國泰永續高股息,48,1,47,凱基-林口,2024-07-18,9257
00891,中信關鍵半導體,45,0,45,凱基-林口,2024-07-18,9257
3294,英濟,67,22,45,凱基-林口,2024-07-18,9257
1402,遠東新,44,0,44,凱基-林口,2024-07-18,9257
3481,群創,110,66,44,凱基-林口,2024-07-18,9257
2388,威盛,44,2,42,凱基-林口,2024-07-18,9257
2330,台積電,49,11,38,凱基-林口,2024-07-18,9257
8105,凌巨,88,50,38,凱基-林口,2024-07-18,9257
00934,中信成長高股息,35,0,35,凱基-林口,2024-07-18,9257
2891,中信金,33,0,33,凱基-林口,2024-07-18,9257
00888,永豐台灣ESG,31,0,31,凱基-林口,2024-07-18,9257
00950B,凱基A級公司債,31,0,31,凱基-林口,2024-07-18,9257
3673,TPK-KY,32,3,29,凱基-林口,2024-07-18,9257
2489,瑞軒,55,27,28,凱基-林口,2024-07-18,9257
6612,奈米醫材,27,0,27,凱基-林口,2024-07-18,9257
00946,群益科技高息成長,26,0,26,凱基-林口,2024-07-18,9257
2382,廣達,26,1,25,凱基-林口,2024-07-18,9257
1410,南染,25,0,25,凱基-林口,2024-07-18,9257
6290,良維,27,2,25,凱基-林口,2024-07-18,9257
3037,欣興,86,62,24,凱基-林口,2024-07-18,9257
2365,昆盈,45,22,23,凱基-林口,2024-07-18,9257
2405,輔信,27,4,23,凱基-林口,2024-07-18,9257
00852L,國泰美國道瓊正2,22,0,22,凱基-林口,2024-07-18,9257
3297,杭特,27,5,22,凱基-林口,2024-07-18,9257
2477,美隆電,28,7,21,凱基-林口,2024-07-18,9257
00650L,復華香港正2,20,0,20,凱基-林口,2024-07-18,9257
8110,華東,20,0,20,凱基-林口,2024-07-18,9257
00932,兆豐永續高息等權,18,0,18,凱基-林口,2024-07-18,9257
4161,聿新科,24,6,18,凱基-林口,2024-07-18,9257
00927,群益半導體收益,17,0,17,凱基-林口,2024-07-18,9257
4977,眾達-KY,15,0,15,凱基-林口,2024-07-18,9257
4989,榮科,15,0,15,凱基-林口,2024-07-18,9257
6264,富裔,15,0,15,凱基-林口,2024-07-18,9257
2881,富邦金,16,1,15,凱基-林口,2024-07-18,9257
3498,陽程,14,0,14,凱基-林口,2024-07-18,9257
2303,聯電,25,10,15,凱基-林口,2024-07-18,9257
8358,金居,14,1,13,凱基-林口,2024-07-18,9257
9962,有益,13,0,13,凱基-林口,2024-07-18,9257
00936,台新永續高息中小,36,23,13,凱基-林口,2024-07-18,9257
00632R,元大台灣50反1,305,30,275,凱基-林口,2024-07-19,9257
2402,毅嘉,1173,953,220,凱基-林口,2024-07-19,9257
00665L,富邦�琤肭磪囓�2,402,200,202,凱基-林口,2024-07-19,9257
3481,群創,296,110,186,凱基-林口,2024-07-19,9257
00929,復華台灣科技優息,234,76,158,凱基-林口,2024-07-19,9257
2888,新光金,168,45,123,凱基-林口,2024-07-19,9257
00940,元大台灣價值高息,137,38,99,凱基-林口,2024-07-19,9257
0056,元大高股息,90,0,90,凱基-林口,2024-07-19,9257
2330,台積電,100,12,88,凱基-林口,2024-07-19,9257
00650L,復華香港正2,80,0,80,凱基-林口,2024-07-19,9257
2509,全坤建,70,0,70,凱基-林口,2024-07-19,9257
00937B,群益ESG投等債20,70,0,70,凱基-林口,2024-07-19,9257
4916,事欣科,72,13,59,凱基-林口,2024-07-19,9257
2331,精英,52,0,52,凱基-林口,2024-07-19,9257
1785,光洋科,46,2,44,凱基-林口,2024-07-19,9257
2845,遠東銀,41,0,41,凱基-林口,2024-07-19,9257
00878,國泰永續高股息,41,2,39,凱基-林口,2024-07-19,9257
2618,長榮航,44,6,38,凱基-林口,2024-07-19,9257
1108,幸福,35,0,35,凱基-林口,2024-07-19,9257
2481,強茂,35,0,35,凱基-林口,2024-07-19,9257
1714,和桐,34,0,34,凱基-林口,2024-07-19,9257
2458,義隆,34,0,34,凱基-林口,2024-07-19,9257
2344,華邦電,34,2,32,凱基-林口,2024-07-19,9257
4123,晟德,39,7,32,凱基-林口,2024-07-19,9257
2882,國泰金,36,5,31,凱基-林口,2024-07-19,9257
2905,三商,30,0,30,凱基-林口,2024-07-19,9257
2489,瑞軒,25,0,25,凱基-林口,2024-07-19,9257
3576,聯合再生,26,3,23,凱基-林口,2024-07-19,9257
00936,台新永續高息中小,41,18,23,凱基-林口,2024-07-19,9257
2337,旺宏,29,7,22,凱基-林口,2024-07-19,9257
2887,台新金,22,0,22,凱基-林口,2024-07-19,9257
00881,國泰台灣5G+,21,1,20,凱基-林口,2024-07-19,9257
00934,中信成長高股息,20,0,20,凱基-林口,2024-07-19,9257
5356,協益,20,0,20,凱基-林口,2024-07-19,9257
2891,中信金,24,5,19,凱基-林口,2024-07-19,9257
2601,益航,19,0,19,凱基-林口,2024-07-19,9257
00919,群益台灣精選高息,125,106,19,凱基-林口,2024-07-19,9257
00946,群益科技高息成長,19,0,19,凱基-林口,2024-07-19,9257
2317,鴻海,46,27,19,凱基-林口,2024-07-19,9257
006208,富邦台50,16,0,16,凱基-林口,2024-07-19,9257
00933B,國泰10Y+金融債,17,1,16,凱基-林口,2024-07-19,9257
1101,台泥,17,1,16,凱基-林口,2024-07-19,9257
1312,國喬,16,0,16,凱基-林口,2024-07-19,9257
3294,英濟,20,5,15,凱基-林口,2024-07-19,9257
4111,濟生,15,0,15,凱基-林口,2024-07-19,9257
4989,榮科,15,0,15,凱基-林口,2024-07-19,9257
2408,南亞科,18,4,14,凱基-林口,2024-07-19,9257
00679B,元大美債20年,24,10,14,凱基-林口,2024-07-19,9257
2352,佳世達,20,6,14,凱基-林口,2024-07-19,9257
2356,英業達,18,4,14,凱基-林口,2024-07-19,9257
00929,復華台灣科技優息,347,70,277,凱基-林口,2024-07-22,9257
00680L,元大美債20正2,285,10,275,凱基-林口,2024-07-22,9257
2402,毅嘉,274,3,271,凱基-林口,2024-07-22,9257
3481,群創,207,21,186,凱基-林口,2024-07-22,9257
0056,元大高股息,179,4,175,凱基-林口,2024-07-22,9257
2845,遠東銀,160,1,159,凱基-林口,2024-07-22,9257
00679B,元大美債20年,208,79,129,凱基-林口,2024-07-22,9257
00919,群益台灣精選高息,180,51,129,凱基-林口,2024-07-22,9257
1714,和桐,110,0,110,凱基-林口,2024-07-22,9257
2331,精英,100,0,100,凱基-林口,2024-07-22,9257
00688L,國泰20年美債正2,101,8,93,凱基-林口,2024-07-22,9257
00937B,群益ESG投等債20,73,10,63,凱基-林口,2024-07-22,9257
3312,弘憶股,65,8,57,凱基-林口,2024-07-22,9257
2888,新光金,132,79,53,凱基-林口,2024-07-22,9257
3163,波若威,52,4,48,凱基-林口,2024-07-22,9257
00950B,凱基A級公司債,47,0,47,凱基-林口,2024-07-22,9257
911868,同方友友-DR,46,0,46,凱基-林口,2024-07-22,9257
00946,群益科技高息成長,45,1,44,凱基-林口,2024-07-22,9257
1108,幸福,43,0,43,凱基-林口,2024-07-22,9257
5512,力麒,52,10,42,凱基-林口,2024-07-22,9257
1216,統一,40,0,40,凱基-林口,2024-07-22,9257
2204,中華,36,0,36,凱基-林口,2024-07-22,9257
00878,國泰永續高股息,88,54,34,凱基-林口,2024-07-22,9257
00650L,復華香港正2,30,0,30,凱基-林口,2024-07-22,9257
2317,鴻海,66,37,29,凱基-林口,2024-07-22,9257
00940,元大台灣價值高息,116,88,28,凱基-林口,2024-07-22,9257
4123,晟德,25,0,25,凱基-林口,2024-07-22,9257
2356,英業達,23,0,23,凱基-林口,2024-07-22,9257
3576,聯合再生,23,0,23,凱基-林口,2024-07-22,9257
00934,中信成長高股息,55,35,20,凱基-林口,2024-07-22,9257
00706L,期元大S＆P日圓正2,20,0,20,凱基-林口,2024-07-22,9257
1444,力麗,20,0,20,凱基-林口,2024-07-22,9257
1447,力鵬,20,0,20,凱基-林口,2024-07-22,9257
2905,三商,20,0,20,凱基-林口,2024-07-22,9257
1540,喬福,20,1,19,凱基-林口,2024-07-22,9257
912000,晨訊科-DR,19,0,19,凱基-林口,2024-07-22,9257
2352,佳世達,19,1,18,凱基-林口,2024-07-22,9257
1609,大亞,31,13,18,凱基-林口,2024-07-22,9257
3037,欣興,66,50,16,凱基-林口,2024-07-22,9257
4130,健亞,16,0,16,凱基-林口,2024-07-22,9257
5309,系統電,16,0,16,凱基-林口,2024-07-22,9257
2408,南亞科,16,0,16,凱基-林口,2024-07-22,9257
00947,台新臺灣IC設計,15,0,15,凱基-林口,2024-07-22,9257
6719,力智,15,0,15,凱基-林口,2024-07-22,9257
00905,FT臺灣Smart,14,0,14,凱基-林口,2024-07-22,9257
1529,樂事綠能,32,19,13,凱基-林口,2024-07-22,9257
4161,聿新科,33,20,13,凱基-林口,2024-07-22,9257
5213,亞昕,13,0,13,凱基-林口,2024-07-22,9257
6116,彩晶,13,0,13,凱基-林口,2024-07-22,9257
2618,長榮航,19,7,12,凱基-林口,2024-07-22,9257
3481,群創,646,6,640,凱基-林口,2024-07-23,9257
0056,元大高股息,110,14,96,凱基-林口,2024-07-23,9257
8096,擎亞,72,4,68,凱基-林口,2024-07-23,9257
2408,南亞科,62,0,62,凱基-林口,2024-07-23,9257
2402,毅嘉,68,7,61,凱基-林口,2024-07-23,9257
1301,台塑,53,0,53,凱基-林口,2024-07-23,9257
00688L,國泰20年美債正2,51,0,51,凱基-林口,2024-07-23,9257
00664R,國泰臺灣加權反1,40,0,40,凱基-林口,2024-07-23,9257
4161,聿新科,58,20,38,凱基-林口,2024-07-23,9257
00878,國泰永續高股息,36,1,35,凱基-林口,2024-07-23,9257
00939,統一台灣高息動能,54,20,34,凱基-林口,2024-07-23,9257
00929,復華台灣科技優息,40,9,31,凱基-林口,2024-07-23,9257
2392,正崴,31,1,30,凱基-林口,2024-07-23,9257
2537,聯上發,30,1,29,凱基-林口,2024-07-23,9257
00937B,群益ESG投等債20,37,10,27,凱基-林口,2024-07-23,9257
3522,御嵿,39,13,26,凱基-林口,2024-07-23,9257
3492,長盛,26,0,26,凱基-林口,2024-07-23,9257
2489,瑞軒,21,0,21,凱基-林口,2024-07-23,9257
00933B,國泰10Y+金融債,21,0,21,凱基-林口,2024-07-23,9257
3706,神達,20,0,20,凱基-林口,2024-07-23,9257
00662,富邦NASDAQ,20,0,20,凱基-林口,2024-07-23,9257
00945B,凱基美國非投等債,20,0,20,凱基-林口,2024-07-23,9257
00947,台新臺灣IC設計,20,0,20,凱基-林口,2024-07-23,9257
1308,亞聚,20,0,20,凱基-林口,2024-07-23,9257
2892,第一金,20,0,20,凱基-林口,2024-07-23,9257
6257,矽格,20,1,19,凱基-林口,2024-07-23,9257
2002,中鋼,25,7,18,凱基-林口,2024-07-23,9257
00950B,凱基A級公司債,17,0,17,凱基-林口,2024-07-23,9257
00936,台新永續高息中小,16,0,16,凱基-林口,2024-07-23,9257
0050,元大台灣50,17,1,16,凱基-林口,2024-07-23,9257
2312,金寶,78,62,16,凱基-林口,2024-07-23,9257
2356,英業達,16,1,15,凱基-林口,2024-07-23,9257
00679B,元大美債20年,18,3,15,凱基-林口,2024-07-23,9257
00905,FT臺灣Smart,14,0,14,凱基-林口,2024-07-23,9257
4916,事欣科,16,2,14,凱基-林口,2024-07-23,9257
2362,藍天,13,0,13,凱基-林口,2024-07-23,9257
2317,鴻海,38,25,13,凱基-林口,2024-07-23,9257
8064,東捷,15,3,12,凱基-林口,2024-07-23,9257
2344,華邦電,12,0,12,凱基-林口,2024-07-23,9257
4526,東台,13,1,12,凱基-林口,2024-07-23,9257
5469,瀚宇博,12,0,12,凱基-林口,2024-07-23,9257
2383,台光電,11,0,11,凱基-林口,2024-07-23,9257
2405,輔信,29,18,11,凱基-林口,2024-07-23,9257
5425,台半,11,0,11,凱基-林口,2024-07-23,9257
3673,TPK-KY,11,0,11,凱基-林口,2024-07-23,9257
2542,興富發,15,5,10,凱基-林口,2024-07-23,9257
00864B,中信美國公債0-1,10,0,10,凱基-林口,2024-07-23,9257
1402,遠東新,10,0,10,凱基-林口,2024-07-23,9257
2006,東和鋼鐵,10,0,10,凱基-林口,2024-07-23,9257
2838,聯邦銀,10,0,10,凱基-林口,2024-07-23,9257
00937B,群益ESG投等債20,328,5,323,凱基-林口,2024-07-26,9257
2845,遠東銀,263,0,263,凱基-林口,2024-07-26,9257
00929,復華台灣科技優息,249,27,222,凱基-林口,2024-07-26,9257
2402,毅嘉,217,4,213,凱基-林口,2024-07-26,9257
00632R,元大台灣50反1,200,12,188,凱基-林口,2024-07-26,9257
00650L,復華香港正2,105,0,105,凱基-林口,2024-07-26,9257
00940,元大台灣價值高息,122,26,96,凱基-林口,2024-07-26,9257
2349,錸德,121,40,81,凱基-林口,2024-07-26,9257
2905,三商,70,0,70,凱基-林口,2024-07-26,9257
1314,中石化,63,0,63,凱基-林口,2024-07-26,9257
2317,鴻海,62,6,56,凱基-林口,2024-07-26,9257
2884,玉山金,65,11,54,凱基-林口,2024-07-26,9257
3312,弘憶股,55,4,51,凱基-林口,2024-07-26,9257
3163,波若威,66,15,51,凱基-林口,2024-07-26,9257
2303,聯電,49,0,49,凱基-林口,2024-07-26,9257
00919,群益台灣精選高息,46,3,43,凱基-林口,2024-07-26,9257
1714,和桐,41,0,41,凱基-林口,2024-07-26,9257
2330,台積電,42,3,39,凱基-林口,2024-07-26,9257
00934,中信成長高股息,35,0,35,凱基-林口,2024-07-26,9257
8054,安國,37,5,32,凱基-林口,2024-07-26,9257
2427,三商電,30,0,30,凱基-林口,2024-07-26,9257
00881,國泰台灣5G+,29,0,29,凱基-林口,2024-07-26,9257
4161,聿新科,26,0,26,凱基-林口,2024-07-26,9257
00923,群益台ESG低碳50,25,0,25,凱基-林口,2024-07-26,9257
4123,晟德,24,0,24,凱基-林口,2024-07-26,9257
00679B,元大美債20年,48,25,23,凱基-林口,2024-07-26,9257
2461,光群雷,21,0,21,凱基-林口,2024-07-26,9257
2352,佳世達,28,7,21,凱基-林口,2024-07-26,9257
2382,廣達,20,0,20,凱基-林口,2024-07-26,9257
00946,群益科技高息成長,20,0,20,凱基-林口,2024-07-26,9257
1449,佳和,20,0,20,凱基-林口,2024-07-26,9257
00637L,元大滬深300正2,20,1,19,凱基-林口,2024-07-26,9257
1609,大亞,46,29,17,凱基-林口,2024-07-26,9257
3105,穩懋,16,0,16,凱基-林口,2024-07-26,9257
8926,台汽電,18,2,16,凱基-林口,2024-07-26,9257
3706,神達,15,0,15,凱基-林口,2024-07-26,9257
6125,廣運,22,7,15,凱基-林口,2024-07-26,9257
6126,信音,15,0,15,凱基-林口,2024-07-26,9257
00830,國泰費城半導體,15,0,15,凱基-林口,2024-07-26,9257
3711,日月光投控,14,0,14,凱基-林口,2024-07-26,9257
1409,新纖,15,1,14,凱基-林口,2024-07-26,9257
2356,英業達,24,11,13,凱基-林口,2024-07-26,9257
2542,興富發,13,0,13,凱基-林口,2024-07-26,9257
00951,台新日本半導體,13,0,13,凱基-林口,2024-07-26,9257
2423,固緯,13,0,13,凱基-林口,2024-07-26,9257
00941,中信上游半導體,12,0,12,凱基-林口,2024-07-26,9257
3188,鑫龍騰,20,8,12,凱基-林口,2024-07-26,9257
8076,伍豐,12,0,12,凱基-林口,2024-07-26,9257
00687B,國泰20年美債,12,0,12,凱基-林口,2024-07-26,9257
6005,群益證,19,7,12,凱基-林口,2024-07-26,9257
00937B,群益ESG投等債20,228,30,198,凱基-林口,2024-07-29,9257
1714,和桐,161,10,151,凱基-林口,2024-07-29,9257
3481,群創,159,63,96,凱基-林口,2024-07-29,9257
1314,中石化,60,0,60,凱基-林口,2024-07-29,9257
00939,統一台灣高息動能,59,0,59,凱基-林口,2024-07-29,9257
00929,復華台灣科技優息,156,98,58,凱基-林口,2024-07-29,9257
3712,永崴投控,55,1,54,凱基-林口,2024-07-29,9257
00934,中信成長高股息,53,0,53,凱基-林口,2024-07-29,9257
2331,精英,53,3,50,凱基-林口,2024-07-29,9257
5475,德宏,50,0,50,凱基-林口,2024-07-29,9257
2363,矽統,72,27,45,凱基-林口,2024-07-29,9257
3540,曜越,40,0,40,凱基-林口,2024-07-29,9257
2427,三商電,30,0,30,凱基-林口,2024-07-29,9257
4933,友輝,34,6,28,凱基-林口,2024-07-29,9257
2884,玉山金,26,0,26,凱基-林口,2024-07-29,9257
0056,元大高股息,57,31,26,凱基-林口,2024-07-29,9257
4161,聿新科,26,0,26,凱基-林口,2024-07-29,9257
00946,群益科技高息成長,25,0,25,凱基-林口,2024-07-29,9257
2882,國泰金,30,5,25,凱基-林口,2024-07-29,9257
00878,國泰永續高股息,46,21,25,凱基-林口,2024-07-29,9257
3322,建舜電,21,0,21,凱基-林口,2024-07-29,9257
3663,鑫科,20,0,20,凱基-林口,2024-07-29,9257
00933B,國泰10Y+金融債,20,0,20,凱基-林口,2024-07-29,9257
3706,神達,19,0,19,凱基-林口,2024-07-29,9257
2409,友達,22,3,19,凱基-林口,2024-07-29,9257
00687B,國泰20年美債,24,6,18,凱基-林口,2024-07-29,9257
00905,FT臺灣Smart,19,2,17,凱基-林口,2024-07-29,9257
2301,光寶科,18,1,17,凱基-林口,2024-07-29,9257
1447,力鵬,16,0,16,凱基-林口,2024-07-29,9257
00947,台新臺灣IC設計,15,0,15,凱基-林口,2024-07-29,9257
8926,台汽電,16,1,15,凱基-林口,2024-07-29,9257
2402,毅嘉,340,326,14,凱基-林口,2024-07-29,9257
00715L,期街口布蘭特正2,13,0,13,凱基-林口,2024-07-29,9257
2049,上銀,13,0,13,凱基-林口,2024-07-29,9257
9904,寶成,17,4,13,凱基-林口,2024-07-29,9257
2603,長榮,12,0,12,凱基-林口,2024-07-29,9257
00923,群益台ESG低碳50,12,0,12,凱基-林口,2024-07-29,9257
00712,復華富時不動產,12,0,12,凱基-林口,2024-07-29,9257
1808,潤隆,22,10,12,凱基-林口,2024-07-29,9257
3047,訊舟,12,0,12,凱基-林口,2024-07-29,9257
8104,錸寶,11,0,11,凱基-林口,2024-07-29,9257
3037,欣興,26,15,11,凱基-林口,2024-07-29,9257
2353,宏��,12,1,11,凱基-林口,2024-07-29,9257
2376,技嘉,11,0,11,凱基-林口,2024-07-29,9257
2916,滿心,11,0,11,凱基-林口,2024-07-29,9257
4976,佳凌,11,0,11,凱基-林口,2024-07-29,9257
6153,嘉聯益,11,0,11,凱基-林口,2024-07-29,9257
6282,康舒,21,10,11,凱基-林口,2024-07-29,9257
3231,緯創,17,6,11,凱基-林口,2024-07-29,9257
4123,晟德,10,0,10,凱基-林口,2024-07-29,9257
00665L,富邦�琤肭磪囓�2,201,0,201,凱基-林口,2024-07-30,9257
00929,復華台灣科技優息,226,54,172,凱基-林口,2024-07-30,9257
00688L,國泰20年美債正2,134,0,134,凱基-林口,2024-07-30,9257
2402,毅嘉,730,604,126,凱基-林口,2024-07-30,9257
00679B,元大美債20年,116,21,95,凱基-林口,2024-07-30,9257
00878,國泰永續高股息,88,32,56,凱基-林口,2024-07-30,9257
2323,中環,55,0,55,凱基-林口,2024-07-30,9257
3163,波若威,59,9,50,凱基-林口,2024-07-30,9257
00945B,凱基美國非投等債,50,0,50,凱基-林口,2024-07-30,9257
00940,元大台灣價值高息,53,8,45,凱基-林口,2024-07-30,9257
00951,台新日本半導體,41,1,40,凱基-林口,2024-07-30,9257
2367,燿華,40,0,40,凱基-林口,2024-07-30,9257
00934,中信成長高股息,69,30,39,凱基-林口,2024-07-30,9257
2845,遠東銀,39,0,39,凱基-林口,2024-07-30,9257
4161,聿新科,35,0,35,凱基-林口,2024-07-30,9257
3312,弘憶股,30,0,30,凱基-林口,2024-07-30,9257
2349,錸德,37,8,29,凱基-林口,2024-07-30,9257
0056,元大高股息,61,32,29,凱基-林口,2024-07-30,9257
00881,國泰台灣5G+,28,0,28,凱基-林口,2024-07-30,9257
2070,精湛,26,0,26,凱基-林口,2024-07-30,9257
4927,泰鼎-KY,27,1,26,凱基-林口,2024-07-30,9257
2891,中信金,27,3,24,凱基-林口,2024-07-30,9257
00946,群益科技高息成長,22,0,22,凱基-林口,2024-07-30,9257
00715L,期街口布蘭特正2,20,0,20,凱基-林口,2024-07-30,9257
2884,玉山金,19,0,19,凱基-林口,2024-07-30,9257
2344,華邦電,41,22,19,凱基-林口,2024-07-30,9257
00631L,元大台灣50正2,18,0,18,凱基-林口,2024-07-30,9257
00637L,元大滬深300正2,18,0,18,凱基-林口,2024-07-30,9257
8054,安國,33,16,17,凱基-林口,2024-07-30,9257
00937B,群益ESG投等債20,34,19,15,凱基-林口,2024-07-30,9257
2481,強茂,15,0,15,凱基-林口,2024-07-30,9257
1722,台肥,15,0,15,凱基-林口,2024-07-30,9257
3037,欣興,25,10,15,凱基-林口,2024-07-30,9257
1714,和桐,20,5,15,凱基-林口,2024-07-30,9257
2890,永豐金,15,0,15,凱基-林口,2024-07-30,9257
2324,仁寶,25,11,14,凱基-林口,2024-07-30,9257
2303,聯電,14,0,14,凱基-林口,2024-07-30,9257
2881,富邦金,14,0,14,凱基-林口,2024-07-30,9257
9904,寶成,13,0,13,凱基-林口,2024-07-30,9257
00936,台新永續高息中小,12,0,12,凱基-林口,2024-07-30,9257
00947,台新臺灣IC設計,11,0,11,凱基-林口,2024-07-30,9257
2353,宏��,14,4,10,凱基-林口,2024-07-30,9257
00905,FT臺灣Smart,14,4,10,凱基-林口,2024-07-30,9257
00900,富邦特選高股息30,10,0,10,凱基-林口,2024-07-30,9257
00753L,中信中國50正2,10,0,10,凱基-林口,2024-07-30,9257
2426,鼎元,10,0,10,凱基-林口,2024-07-30,9257
2888,新光金,50,40,10,凱基-林口,2024-07-30,9257
8112,至上,10,0,10,凱基-林口,2024-07-30,9257
2020,美亞,13,4,9,凱基-林口,2024-07-30,9257
2337,旺宏,12,3,9,凱基-林口,2024-07-30,9257
00632R,元大台灣50反1,100,0,100,凱基-林口,2024-07-31,9257
00688L,國泰20年美債正2,100,0,100,凱基-林口,2024-07-31,9257
3481,群創,110,31,79,凱基-林口,2024-07-31,9257
00878,國泰永續高股息,75,10,65,凱基-林口,2024-07-31,9257
00940,元大台灣價值高息,45,0,45,凱基-林口,2024-07-31,9257
00937B,群益ESG投等債20,43,0,43,凱基-林口,2024-07-31,9257
00929,復華台灣科技優息,42,7,35,凱基-林口,2024-07-31,9257
0056,元大高股息,42,7,35,凱基-林口,2024-07-31,9257
2382,廣達,127,93,34,凱基-林口,2024-07-31,9257
3105,穩懋,22,0,22,凱基-林口,2024-07-31,9257
1714,和桐,20,0,20,凱基-林口,2024-07-31,9257
2458,義隆,20,0,20,凱基-林口,2024-07-31,9257
2527,宏璟,20,0,20,凱基-林口,2024-07-31,9257
4927,泰鼎-KY,18,0,18,凱基-林口,2024-07-31,9257
2061,風青,27,10,17,凱基-林口,2024-07-31,9257
2838A,聯邦銀甲特,13,0,13,凱基-林口,2024-07-31,9257
00679B,元大美債20年,22,10,12,凱基-林口,2024-07-31,9257
3037,欣興,49,38,11,凱基-林口,2024-07-31,9257
2365,昆盈,22,12,10,凱基-林口,2024-07-31,9257
00664R,國泰臺灣加權反1,10,0,10,凱基-林口,2024-07-31,9257
00708L,期元大S＆P黃金正2,10,0,10,凱基-林口,2024-07-31,9257
1702,南僑,10,0,10,凱基-林口,2024-07-31,9257
1785,光洋科,12,2,10,凱基-林口,2024-07-31,9257
2427,三商電,10,0,10,凱基-林口,2024-07-31,9257
3229,晟鈦,10,0,10,凱基-林口,2024-07-31,9257
3322,建舜電,10,0,10,凱基-林口,2024-07-31,9257
4161,聿新科,10,0,10,凱基-林口,2024-07-31,9257
5364,力麗店,10,0,10,凱基-林口,2024-07-31,9257
6026,福邦證,10,0,10,凱基-林口,2024-07-31,9257
8110,華東,10,0,10,凱基-林口,2024-07-31,9257
1503,士電,9,0,9,凱基-林口,2024-07-31,9257
1710,東聯,10,1,9,凱基-林口,2024-07-31,9257
4510,高鋒,12,3,9,凱基-林口,2024-07-31,9257
4526,東台,12,3,9,凱基-林口,2024-07-31,9257
6509,聚和,9,0,9,凱基-林口,2024-07-31,9257
2330,台積電,16,7,9,凱基-林口,2024-07-31,9257
00881,國泰台灣5G+,8,0,8,凱基-林口,2024-07-31,9257
00939,統一台灣高息動能,23,15,8,凱基-林口,2024-07-31,9257
00946,群益科技高息成長,7,0,7,凱基-林口,2024-07-31,9257
6147,頎邦,7,0,7,凱基-林口,2024-07-31,9257
00680L,元大美債20正2,10,3,7,凱基-林口,2024-07-31,9257
00725B,國泰投資級公司債,7,0,7,凱基-林口,2024-07-31,9257
1504,東元,10,3,7,凱基-林口,2024-07-31,9257
2812,台中銀,7,0,7,凱基-林口,2024-07-31,9257
4566,時碩工業,7,0,7,凱基-林口,2024-07-31,9257
6770,力積電,7,0,7,凱基-林口,2024-07-31,9257
6877,鏵友益,7,0,7,凱基-林口,2024-07-31,9257
8049,晶采,7,0,7,凱基-林口,2024-07-31,9257
8028,昇陽半導體,20,14,6,凱基-林口,2024-07-31,9257
00927,群益半導體收益,6,0,6,凱基-林口,2024-07-31,9257
00878,國泰永續高股息,152,14,138,凱基-林口,2024-08-01,9257
00753L,中信中國50正2,100,0,100,凱基-林口,2024-08-01,9257
00932,兆豐永續高息等權,65,0,65,凱基-林口,2024-08-01,9257
2882,國泰金,51,2,49,凱基-林口,2024-08-01,9257
2845,遠東銀,45,0,45,凱基-林口,2024-08-01,9257
00946,群益科技高息成長,36,0,36,凱基-林口,2024-08-01,9257
00936,台新永續高息中小,31,0,31,凱基-林口,2024-08-01,9257
00919,群益台灣精選高息,36,7,29,凱基-林口,2024-08-01,9257
00881,國泰台灣5G+,29,0,29,凱基-林口,2024-08-01,9257
4927,泰鼎-KY,29,0,29,凱基-林口,2024-08-01,9257
6284,佳邦,29,0,29,凱基-林口,2024-08-01,9257
00905,FT臺灣Smart,38,12,26,凱基-林口,2024-08-01,9257
1711,永光,30,6,24,凱基-林口,2024-08-01,9257
2107,厚生,20,0,20,凱基-林口,2024-08-01,9257
2316,楠梓電,20,0,20,凱基-林口,2024-08-01,9257
8403,盛弘,18,0,18,凱基-林口,2024-08-01,9257
5443,均豪,40,25,15,凱基-林口,2024-08-01,9257
2349,錸德,20,5,15,凱基-林口,2024-08-01,9257
00637L,元大滬深300正2,14,0,14,凱基-林口,2024-08-01,9257
2027,大成鋼,13,0,13,凱基-林口,2024-08-01,9257
00940,元大台灣價值高息,27,15,12,凱基-林口,2024-08-01,9257
1608,華榮,11,0,11,凱基-林口,2024-08-01,9257
2527,宏璟,11,0,11,凱基-林口,2024-08-01,9257
3163,波若威,25,14,11,凱基-林口,2024-08-01,9257
2618,長榮航,15,5,10,凱基-林口,2024-08-01,9257
2457,飛宏,10,0,10,凱基-林口,2024-08-01,9257
2905,三商,10,0,10,凱基-林口,2024-08-01,9257
4510,高鋒,11,1,10,凱基-林口,2024-08-01,9257
6202,盛群,10,0,10,凱基-林口,2024-08-01,9257
2481,強茂,14,5,9,凱基-林口,2024-08-01,9257
00830,國泰費城半導體,15,7,8,凱基-林口,2024-08-01,9257
1101,台泥,9,1,8,凱基-林口,2024-08-01,9257
2070,精湛,34,26,8,凱基-林口,2024-08-01,9257
3188,鑫龍騰,8,0,8,凱基-林口,2024-08-01,9257
6163,華電網,12,4,8,凱基-林口,2024-08-01,9257
0050,元大台灣50,12,4,8,凱基-林口,2024-08-01,9257
3312,弘憶股,8,1,7,凱基-林口,2024-08-01,9257
6770,力積電,12,5,7,凱基-林口,2024-08-01,9257
5515,建國,7,0,7,凱基-林口,2024-08-01,9257
2313,華通,6,0,6,凱基-林口,2024-08-01,9257
4109,加捷生醫,6,0,6,凱基-林口,2024-08-01,9257
4909,新復興,6,0,6,凱基-林口,2024-08-01,9257
5434,崇越,6,0,6,凱基-林口,2024-08-01,9257
5876,上海商銀,6,0,6,凱基-林口,2024-08-01,9257
2383,台光電,9,3,6,凱基-林口,2024-08-01,9257
00942B,台新美A公司債20+,5,0,5,凱基-林口,2024-08-01,9257
1326,台化,5,0,5,凱基-林口,2024-08-01,9257
1447,力鵬,5,0,5,凱基-林口,2024-08-01,9257
1569,濱川,5,0,5,凱基-林口,2024-08-01,9257
1714,和桐,10,5,5,凱基-林口,2024-08-01,9257
00632R,元大台灣50反1,730,0,730,凱基-林口,2024-08-02,9257
00680L,元大美債20正2,322,6,316,凱基-林口,2024-08-02,9257
00650L,復華香港正2,265,0,265,凱基-林口,2024-08-02,9257
00918,大華優利高填息30,209,0,209,凱基-林口,2024-08-02,9257
00934,中信成長高股息,219,21,198,凱基-林口,2024-08-02,9257
00919,群益台灣精選高息,171,6,165,凱基-林口,2024-08-02,9257
00753L,中信中國50正2,110,0,110,凱基-林口,2024-08-02,9257
00929,復華台灣科技優息,110,8,102,凱基-林口,2024-08-02,9257
2317,鴻海,120,26,94,凱基-林口,2024-08-02,9257
0056,元大高股息,95,10,85,凱基-林口,2024-08-02,9257
00878,國泰永續高股息,100,21,79,凱基-林口,2024-08-02,9257
3037,欣興,68,0,68,凱基-林口,2024-08-02,9257
3163,波若威,68,5,63,凱基-林口,2024-08-02,9257
2501,國建,62,3,59,凱基-林口,2024-08-02,9257
0050,元大台灣50,53,0,53,凱基-林口,2024-08-02,9257
2331,精英,53,3,50,凱基-林口,2024-08-02,9257
2027,大成鋼,49,0,49,凱基-林口,2024-08-02,9257
2330,台積電,51,4,47,凱基-林口,2024-08-02,9257
00905,FT臺灣Smart,44,0,44,凱基-林口,2024-08-02,9257
00932,兆豐永續高息等權,40,0,40,凱基-林口,2024-08-02,9257
00949,復華日本龍頭,36,0,36,凱基-林口,2024-08-02,9257
2405,輔信,34,1,33,凱基-林口,2024-08-02,9257
00720B,元大投資級公司債,32,0,32,凱基-林口,2024-08-02,9257
00940,元大台灣價值高息,75,44,31,凱基-林口,2024-08-02,9257
3706,神達,32,1,31,凱基-林口,2024-08-02,9257
2520,冠德,29,3,26,凱基-林口,2024-08-02,9257
2344,華邦電,28,3,25,凱基-林口,2024-08-02,9257
2887,台新金,23,0,23,凱基-林口,2024-08-02,9257
00931B,統一美債20年,23,0,23,凱基-林口,2024-08-02,9257
00946,群益科技高息成長,24,1,23,凱基-林口,2024-08-02,9257
2402,毅嘉,138,115,23,凱基-林口,2024-08-02,9257
3231,緯創,23,2,21,凱基-林口,2024-08-02,9257
00923,群益台ESG低碳50,21,0,21,凱基-林口,2024-08-02,9257
8105,凌巨,21,0,21,凱基-林口,2024-08-02,9257
2382,廣達,26,5,21,凱基-林口,2024-08-02,9257
00881,國泰台灣5G+,46,26,20,凱基-林口,2024-08-02,9257
1447,力鵬,20,0,20,凱基-林口,2024-08-02,9257
2905,三商,20,0,20,凱基-林口,2024-08-02,9257
5521,工信,20,0,20,凱基-林口,2024-08-02,9257
8255,朋程,20,0,20,凱基-林口,2024-08-02,9257
2449,京元電子,21,4,17,凱基-林口,2024-08-02,9257
1702,南僑,17,0,17,凱基-林口,2024-08-02,9257
3622,洋華,17,0,17,凱基-林口,2024-08-02,9257
6212,理銘,17,0,17,凱基-林口,2024-08-02,9257
2603,長榮,31,15,16,凱基-林口,2024-08-02,9257
00679B,元大美債20年,60,45,15,凱基-林口,2024-08-02,9257
2542,興富發,16,1,15,凱基-林口,2024-08-02,9257
4927,泰鼎-KY,15,0,15,凱基-林口,2024-08-02,9257
00941,中信上游半導體,14,0,14,凱基-林口,2024-08-02,9257
00893,國泰智能電動車,15,1,14,凱基-林口,2024-08-02,9257
00632R,元大台灣50反1,1055,425,630,凱基-林口,2024-08-05,9257
00940,元大台灣價值高息,482,36,446,凱基-林口,2024-08-05,9257
2323,中環,333,1,332,凱基-林口,2024-08-05,9257
00878,國泰永續高股息,303,99,204,凱基-林口,2024-08-05,9257
3481,群創,247,44,203,凱基-林口,2024-08-05,9257
00679B,元大美債20年,180,58,122,凱基-林口,2024-08-05,9257
0056,元大高股息,150,45,105,凱基-林口,2024-08-05,9257
00664R,國泰臺灣加權反1,80,0,80,凱基-林口,2024-08-05,9257
1314,中石化,74,0,74,凱基-林口,2024-08-05,9257
2317,鴻海,108,35,73,凱基-林口,2024-08-05,9257
00688L,國泰20年美債正2,80,10,70,凱基-林口,2024-08-05,9257
00631L,元大台灣50正2,56,1,55,凱基-林口,2024-08-05,9257
00948B,中信優息投資級債,51,0,51,凱基-林口,2024-08-05,9257
00946,群益科技高息成長,75,26,49,凱基-林口,2024-08-05,9257
00919,群益台灣精選高息,164,115,49,凱基-林口,2024-08-05,9257
4161,聿新科,71,25,46,凱基-林口,2024-08-05,9257
00751B,元大AAA至A公司債,45,0,45,凱基-林口,2024-08-05,9257
2834,臺企銀,48,4,44,凱基-林口,2024-08-05,9257
2352,佳世達,43,2,41,凱基-林口,2024-08-05,9257
00720B,元大投資級公司債,40,0,40,凱基-林口,2024-08-05,9257
00650L,復華香港正2,40,0,40,凱基-林口,2024-08-05,9257
00936,台新永續高息中小,40,0,40,凱基-林口,2024-08-05,9257
3211,順達,33,1,32,凱基-林口,2024-08-05,9257
4526,東台,33,2,31,凱基-林口,2024-08-05,9257
2905,三商,30,0,30,凱基-林口,2024-08-05,9257
3541,西柏,30,0,30,凱基-林口,2024-08-05,9257
2801,彰銀,28,0,28,凱基-林口,2024-08-05,9257
2301,光寶科,32,6,26,凱基-林口,2024-08-05,9257
2312,金寶,33,7,26,凱基-林口,2024-08-05,9257
00932,兆豐永續高息等權,25,0,25,凱基-林口,2024-08-05,9257
2457,飛宏,40,15,25,凱基-林口,2024-08-05,9257
00754B,群益AAA-AA公司,24,0,24,凱基-林口,2024-08-05,9257
2353,宏��,26,3,23,凱基-林口,2024-08-05,9257
00934,中信成長高股息,23,0,23,凱基-林口,2024-08-05,9257
2408,南亞科,26,5,21,凱基-林口,2024-08-05,9257
00905,FT臺灣Smart,21,0,21,凱基-林口,2024-08-05,9257
2618,長榮航,37,17,20,凱基-林口,2024-08-05,9257
1316,上曜,20,0,20,凱基-林口,2024-08-05,9257
0050,元大台灣50,35,16,19,凱基-林口,2024-08-05,9257
2002,中鋼,36,17,19,凱基-林口,2024-08-05,9257
6188,廣明,27,8,19,凱基-林口,2024-08-05,9257
00690,兆豐藍籌30,25,6,19,凱基-林口,2024-08-05,9257
4927,泰鼎-KY,20,1,19,凱基-林口,2024-08-05,9257
2880,華南金,19,1,18,凱基-林口,2024-08-05,9257
2515,中工,18,0,18,凱基-林口,2024-08-05,9257
4510,高鋒,63,45,18,凱基-林口,2024-08-05,9257
2409,友達,18,1,17,凱基-林口,2024-08-05,9257
00715L,期街口布蘭特正2,17,0,17,凱基-林口,2024-08-05,9257
00753L,中信中國50正2,17,0,17,凱基-林口,2024-08-05,9257
2330,台積電,60,44,16,凱基-林口,2024-08-05,9257
2511,太子,934,0,934,凱基-林口,2024-08-06,9257
00945B,凱基美國非投等債,530,0,530,凱基-林口,2024-08-06,9257
2402,毅嘉,473,6,467,凱基-林口,2024-08-06,9257
00940,元大台灣價值高息,233,31,202,凱基-林口,2024-08-06,9257
00929,復華台灣科技優息,201,40,161,凱基-林口,2024-08-06,9257
00632R,元大台灣50反1,790,682,108,凱基-林口,2024-08-06,9257
00671R,富邦NASDAQ反1,100,0,100,凱基-林口,2024-08-06,9257
00878,國泰永續高股息,136,42,94,凱基-林口,2024-08-06,9257
2515,中工,103,11,92,凱基-林口,2024-08-06,9257
2317,鴻海,144,63,81,凱基-林口,2024-08-06,9257
00949,復華日本龍頭,100,21,79,凱基-林口,2024-08-06,9257
2836,高雄銀,78,0,78,凱基-林口,2024-08-06,9257
2409,友達,88,11,77,凱基-林口,2024-08-06,9257
2834,臺企銀,77,5,72,凱基-林口,2024-08-06,9257
00881,國泰台灣5G+,95,24,71,凱基-林口,2024-08-06,9257
2887,台新金,64,0,64,凱基-林口,2024-08-06,9257
00935,野村臺灣新科技50,58,0,58,凱基-林口,2024-08-06,9257
4161,聿新科,50,0,50,凱基-林口,2024-08-06,9257
00637L,元大滬深300正2,45,0,45,凱基-林口,2024-08-06,9257
3163,波若威,82,38,44,凱基-林口,2024-08-06,9257
5531,鄉林,40,0,40,凱基-林口,2024-08-06,9257
00894,中信小資高價30,38,1,37,凱基-林口,2024-08-06,9257
00948B,中信優息投資級債,36,0,36,凱基-林口,2024-08-06,9257
1702,南僑,35,1,34,凱基-林口,2024-08-06,9257
1314,中石化,30,0,30,凱基-林口,2024-08-06,9257
2614,東森,30,0,30,凱基-林口,2024-08-06,9257
3037,欣興,54,26,28,凱基-林口,2024-08-06,9257
2520,冠德,27,1,26,凱基-林口,2024-08-06,9257
2905,三商,25,0,25,凱基-林口,2024-08-06,9257
4974,亞泰,21,0,21,凱基-林口,2024-08-06,9257
4927,泰鼎-KY,20,0,20,凱基-林口,2024-08-06,9257
6116,彩晶,20,0,20,凱基-林口,2024-08-06,9257
6226,光鼎,20,0,20,凱基-林口,2024-08-06,9257
00720B,元大投資級公司債,16,0,16,凱基-林口,2024-08-06,9257
00946,群益科技高息成長,16,0,16,凱基-林口,2024-08-06,9257
2610,華航,17,1,16,凱基-林口,2024-08-06,9257
00751B,元大AAA至A公司債,16,0,16,凱基-林口,2024-08-06,9257
2812,台中銀,18,3,15,凱基-林口,2024-08-06,9257
2338,光罩,12,0,12,凱基-林口,2024-08-06,9257
2867,三商壽,12,0,12,凱基-林口,2024-08-06,9257
2353,宏��,21,9,12,凱基-林口,2024-08-06,9257
006208,富邦台50,16,5,11,凱基-林口,2024-08-06,9257
00895,富邦未來車,11,0,11,凱基-林口,2024-08-06,9257
7402,邑錡,12,1,11,凱基-林口,2024-08-06,9257
00795B,中信美國公債20年,10,0,10,凱基-林口,2024-08-06,9257
0052,富邦科技,10,0,10,凱基-林口,2024-08-06,9257
1805,寶徠,10,0,10,凱基-林口,2024-08-06,9257
2331,精英,10,0,10,凱基-林口,2024-08-06,9257
2362,藍天,10,0,10,凱基-林口,2024-08-06,9257
2408,南亞科,10,0,10,凱基-林口,2024-08-06,9257
9105,泰金寶-DR,130,1,129,凱基-林口,2024-08-07,9257
2402,毅嘉,358,258,100,凱基-林口,2024-08-07,9257
3481,群創,101,11,90,凱基-林口,2024-08-07,9257
00679B,元大美債20年,117,41,76,凱基-林口,2024-08-07,9257
2888,新光金,70,0,70,凱基-林口,2024-08-07,9257
00929,復華台灣科技優息,57,10,47,凱基-林口,2024-08-07,9257
00940,元大台灣價值高息,65,23,42,凱基-林口,2024-08-07,9257
2331,精英,38,0,38,凱基-林口,2024-08-07,9257
00931B,統一美債20年,46,10,36,凱基-林口,2024-08-07,9257
1540,喬福,125,90,35,凱基-林口,2024-08-07,9257
00688L,國泰20年美債正2,32,0,32,凱基-林口,2024-08-07,9257
2344,華邦電,32,0,32,凱基-林口,2024-08-07,9257
5481,新華,30,0,30,凱基-林口,2024-08-07,9257
00919,群益台灣精選高息,45,16,29,凱基-林口,2024-08-07,9257
2317,鴻海,79,52,27,凱基-林口,2024-08-07,9257
2834,臺企銀,44,20,24,凱基-林口,2024-08-07,9257
00878,國泰永續高股息,44,22,22,凱基-林口,2024-08-07,9257
8215,明基材,20,0,20,凱基-林口,2024-08-07,9257
00795B,中信美國公債20年,20,0,20,凱基-林口,2024-08-07,9257
00921,兆豐龍頭等權重,20,0,20,凱基-林口,2024-08-07,9257
00933B,國泰10Y+金融債,18,0,18,凱基-林口,2024-08-07,9257
6770,力積電,21,5,16,凱基-林口,2024-08-07,9257
4906,正文,17,2,15,凱基-林口,2024-08-07,9257
00939,統一台灣高息動能,20,6,14,凱基-林口,2024-08-07,9257
00907,永豐優息存股,13,0,13,凱基-林口,2024-08-07,9257
2312,金寶,24,11,13,凱基-林口,2024-08-07,9257
00946,群益科技高息成長,12,0,12,凱基-林口,2024-08-07,9257
3189,景碩,18,6,12,凱基-林口,2024-08-07,9257
8040,九暘,12,0,12,凱基-林口,2024-08-07,9257
2845,遠東銀,11,0,11,凱基-林口,2024-08-07,9257
3062,建漢,11,0,11,凱基-林口,2024-08-07,9257
3711,日月光投控,11,0,11,凱基-林口,2024-08-07,9257
4960,誠美材,11,0,11,凱基-林口,2024-08-07,9257
5706,鳳凰,11,0,11,凱基-林口,2024-08-07,9257
1217,愛之味,10,0,10,凱基-林口,2024-08-07,9257
2408,南亞科,14,4,10,凱基-林口,2024-08-07,9257
00915,凱基優選高股息30,10,0,10,凱基-林口,2024-08-07,9257
00922,國泰台灣領袖50,10,0,10,凱基-林口,2024-08-07,9257
00942B,台新美A公司債20+,10,0,10,凱基-林口,2024-08-07,9257
1102,亞泥,10,0,10,凱基-林口,2024-08-07,9257
2338,光罩,10,0,10,凱基-林口,2024-08-07,9257
2501,國建,10,0,10,凱基-林口,2024-08-07,9257
3450,聯鈞,11,1,10,凱基-林口,2024-08-07,9257
5533,皇鼎,10,0,10,凱基-林口,2024-08-07,9257
8110,華東,10,0,10,凱基-林口,2024-08-07,9257
3105,穩懋,10,1,9,凱基-林口,2024-08-07,9257
1569,濱川,10,1,9,凱基-林口,2024-08-07,9257
2867,三商壽,10,1,9,凱基-林口,2024-08-07,9257
00639,富邦深100,8,0,8,凱基-林口,2024-08-07,9257
2392,正崴,30,22,8,凱基-林口,2024-08-07,9257
00679B,元大美債20年,1067,0,1067,凱基-林口,2024-08-08,9257
00680L,元大美債20正2,663,0,663,凱基-林口,2024-08-08,9257
00632R,元大台灣50反1,220,20,200,凱基-林口,2024-08-08,9257
00937B,群益ESG投等債20,129,0,129,凱基-林口,2024-08-08,9257
00878,國泰永續高股息,103,1,102,凱基-林口,2024-08-08,9257
00929,復華台灣科技優息,77,1,76,凱基-林口,2024-08-08,9257
3356,奇偶,26,0,26,凱基-林口,2024-08-08,9257
2618,長榮航,31,5,26,凱基-林口,2024-08-08,9257
2886,兆豐金,25,0,25,凱基-林口,2024-08-08,9257
00687B,國泰20年美債,26,1,25,凱基-林口,2024-08-08,9257
2834,臺企銀,44,20,24,凱基-林口,2024-08-08,9257
4510,高鋒,43,20,23,凱基-林口,2024-08-08,9257
4532,瑞智,21,0,21,凱基-林口,2024-08-08,9257
1316,上曜,20,0,20,凱基-林口,2024-08-08,9257
00919,群益台灣精選高息,19,0,19,凱基-林口,2024-08-08,9257
2634,漢翔,19,0,19,凱基-林口,2024-08-08,9257
2317,鴻海,56,40,16,凱基-林口,2024-08-08,9257
00720B,元大投資級公司債,16,0,16,凱基-林口,2024-08-08,9257
0056,元大高股息,16,0,16,凱基-林口,2024-08-08,9257
3046,建��,15,0,15,凱基-林口,2024-08-08,9257
5386,青雲,15,0,15,凱基-林口,2024-08-08,9257
2070,精湛,46,32,14,凱基-林口,2024-08-08,9257
2337,旺宏,13,0,13,凱基-林口,2024-08-08,9257
4161,聿新科,13,0,13,凱基-林口,2024-08-08,9257
2884,玉山金,11,0,11,凱基-林口,2024-08-08,9257
6603,富強鑫,25,14,11,凱基-林口,2024-08-08,9257
2615,萬海,17,6,11,凱基-林口,2024-08-08,9257
00940,元大台灣價值高息,33,23,10,凱基-林口,2024-08-08,9257
2409,友達,10,0,10,凱基-林口,2024-08-08,9257
00650L,復華香港正2,10,0,10,凱基-林口,2024-08-08,9257
1217,愛之味,10,0,10,凱基-林口,2024-08-08,9257
1442,名軒,10,0,10,凱基-林口,2024-08-08,9257
2641,正德,10,0,10,凱基-林口,2024-08-08,9257
3219,倚強科,10,0,10,凱基-林口,2024-08-08,9257
5876,上海商銀,10,0,10,凱基-林口,2024-08-08,9257
00942B,台新美A公司債20+,11,2,9,凱基-林口,2024-08-08,9257
2408,南亞科,10,1,9,凱基-林口,2024-08-08,9257
5871,中租-KY,9,0,9,凱基-林口,2024-08-08,9257
2356,英業達,12,4,8,凱基-林口,2024-08-08,9257
00891,中信關鍵半導體,8,0,8,凱基-林口,2024-08-08,9257
1702,南僑,7,0,7,凱基-林口,2024-08-08,9257
2601,益航,7,0,7,凱基-林口,2024-08-08,9257
6213,聯茂,12,5,7,凱基-林口,2024-08-08,9257
1301,台塑,9,2,7,凱基-林口,2024-08-08,9257
2881,富邦金,7,0,7,凱基-林口,2024-08-08,9257
00932,兆豐永續高息等權,6,0,6,凱基-林口,2024-08-08,9257
2392,正崴,115,109,6,凱基-林口,2024-08-08,9257
2897,王道銀行,6,0,6,凱基-林口,2024-08-08,9257
3030,德律,6,0,6,凱基-林口,2024-08-08,9257
4961,天鈺,6,0,6,凱基-林口,2024-08-08,9257
00679B,元大美債20年,1293,6,1287,凱基-林口,2024-08-09,9257
00637L,元大滬深300正2,295,0,295,凱基-林口,2024-08-09,9257
00937B,群益ESG投等債20,234,2,232,凱基-林口,2024-08-09,9257
2402,毅嘉,217,8,209,凱基-林口,2024-08-09,9257
00929,復華台灣科技優息,241,60,181,凱基-林口,2024-08-09,9257
00795B,中信美國公債20年,155,0,155,凱基-林口,2024-08-09,9257
00878,國泰永續高股息,158,9,149,凱基-林口,2024-08-09,9257
00933B,國泰10Y+金融債,86,0,86,凱基-林口,2024-08-09,9257
00687B,國泰20年美債,64,0,64,凱基-林口,2024-08-09,9257
8105,凌巨,55,2,53,凱基-林口,2024-08-09,9257
6160,欣技,54,4,50,凱基-林口,2024-08-09,9257
0056,元大高股息,37,9,28,凱基-林口,2024-08-09,9257
4555,氣立,27,0,27,凱基-林口,2024-08-09,9257
00715L,期街口布蘭特正2,26,0,26,凱基-林口,2024-08-09,9257
00932,兆豐永續高息等權,24,0,24,凱基-林口,2024-08-09,9257
3522,御嵿,21,0,21,凱基-林口,2024-08-09,9257
2886,兆豐金,22,2,20,凱基-林口,2024-08-09,9257
1616,億泰,20,0,20,凱基-林口,2024-08-09,9257
3163,波若威,26,7,19,凱基-林口,2024-08-09,9257
6285,啟��,19,1,18,凱基-林口,2024-08-09,9257
8096,擎亞,42,24,18,凱基-林口,2024-08-09,9257
2020,美亞,16,0,16,凱基-林口,2024-08-09,9257
4161,聿新科,15,0,15,凱基-林口,2024-08-09,9257
00923,群益台ESG低碳50,15,1,14,凱基-林口,2024-08-09,9257
00942B,台新美A公司債20+,14,0,14,凱基-林口,2024-08-09,9257
2349,錸德,14,1,13,凱基-林口,2024-08-09,9257
2353,宏��,15,2,13,凱基-林口,2024-08-09,9257
2474,可成,13,0,13,凱基-林口,2024-08-09,9257
3374,精材,18,5,13,凱基-林口,2024-08-09,9257
2458,義隆,12,0,12,凱基-林口,2024-08-09,9257
3715,定穎投控,50,38,12,凱基-林口,2024-08-09,9257
00688L,國泰20年美債正2,85,74,11,凱基-林口,2024-08-09,9257
2427,三商電,11,0,11,凱基-林口,2024-08-09,9257
2399,映泰,10,0,10,凱基-林口,2024-08-09,9257
4906,正文,10,0,10,凱基-林口,2024-08-09,9257
6152,百一,10,0,10,凱基-林口,2024-08-09,9257
5328,華容,10,0,10,凱基-林口,2024-08-09,9257
00857B,永豐20年美公債,9,0,9,凱基-林口,2024-08-09,9257
2884,玉山金,11,2,9,凱基-林口,2024-08-09,9257
6120,達運,10,1,9,凱基-林口,2024-08-09,9257
1717,長興,8,0,8,凱基-林口,2024-08-09,9257
5531,鄉林,10,2,8,凱基-林口,2024-08-09,9257
5443,均豪,13,6,7,凱基-林口,2024-08-09,9257
00951,台新日本半導體,12,5,7,凱基-林口,2024-08-09,9257
2486,一詮,8,1,7,凱基-林口,2024-08-09,9257
3450,聯鈞,6,0,6,凱基-林口,2024-08-09,9257
4979,華星光,6,0,6,凱基-林口,2024-08-09,9257
3231,緯創,13,7,6,凱基-林口,2024-08-09,9257
00891,中信關鍵半導體,6,1,5,凱基-林口,2024-08-09,9257
8033,雷虎,5,0,5,凱基-林口,2024-08-09,9257
00680L,元大美債20正2,646,0,646,凱基-林口,2024-08-12,9257
2402,毅嘉,283,0,283,凱基-林口,2024-08-12,9257
00795B,中信美國公債20年,250,0,250,凱基-林口,2024-08-12,9257
00937B,群益ESG投等債20,147,12,135,凱基-林口,2024-08-12,9257
1608,華榮,73,20,53,凱基-林口,2024-08-12,9257
3545,敦泰,43,0,43,凱基-林口,2024-08-12,9257
8249,菱光,40,0,40,凱基-林口,2024-08-12,9257
3483,力致,30,0,30,凱基-林口,2024-08-12,9257
00878,國泰永續高股息,32,2,30,凱基-林口,2024-08-12,9257
2891,中信金,29,1,28,凱基-林口,2024-08-12,9257
3522,御嵿,28,0,28,凱基-林口,2024-08-12,9257
2301,光寶科,26,0,26,凱基-林口,2024-08-12,9257
6160,欣技,22,0,22,凱基-林口,2024-08-12,9257
00940,元大台灣價值高息,21,0,21,凱基-林口,2024-08-12,9257
00915,凱基優選高股息30,21,1,20,凱基-林口,2024-08-12,9257
6532,瑞耘,20,1,19,凱基-林口,2024-08-12,9257
00929,復華台灣科技優息,25,7,18,凱基-林口,2024-08-12,9257
4533,協易機,24,8,16,凱基-林口,2024-08-12,9257
2371,大同,20,5,15,凱基-林口,2024-08-12,9257
2374,佳能,14,0,14,凱基-林口,2024-08-12,9257
2916,滿心,13,0,13,凱基-林口,2024-08-12,9257
8438,昶昕,12,0,12,凱基-林口,2024-08-12,9257
8937,合騏,12,0,12,凱基-林口,2024-08-12,9257
1802,台玻,11,0,11,凱基-林口,2024-08-12,9257
2009,第一銅,11,0,11,凱基-林口,2024-08-12,9257
4161,聿新科,11,0,11,凱基-林口,2024-08-12,9257
8096,擎亞,25,14,11,凱基-林口,2024-08-12,9257
6215,和椿,16,6,10,凱基-林口,2024-08-12,9257
1447,力鵬,10,0,10,凱基-林口,2024-08-12,9257
1714,和桐,10,0,10,凱基-林口,2024-08-12,9257
2312,金寶,16,6,10,凱基-林口,2024-08-12,9257
3711,日月光投控,10,0,10,凱基-林口,2024-08-12,9257
3105,穩懋,10,1,9,凱基-林口,2024-08-12,9257
1216,統一,10,1,9,凱基-林口,2024-08-12,9257
2387,精元,9,0,9,凱基-林口,2024-08-12,9257
3024,憶聲,9,0,9,凱基-林口,2024-08-12,9257
1597,直得,16,10,6,凱基-林口,2024-08-12,9257
3622,洋華,6,0,6,凱基-林口,2024-08-12,9257
6175,立敦,6,0,6,凱基-林口,2024-08-12,9257
6504,南六,6,0,6,凱基-林口,2024-08-12,9257
8054,安國,8,2,6,凱基-林口,2024-08-12,9257
00934,中信成長高股息,5,0,5,凱基-林口,2024-08-12,9257
00830,國泰費城半導體,5,0,5,凱基-林口,2024-08-12,9257
00688L,國泰20年美債正2,15,10,5,凱基-林口,2024-08-12,9257
2485,兆赫,5,0,5,凱基-林口,2024-08-12,9257
2880,華南金,5,0,5,凱基-林口,2024-08-12,9257
2897,王道銀行,5,0,5,凱基-林口,2024-08-12,9257
3498,陽程,8,3,5,凱基-林口,2024-08-12,9257
3577,泓格,5,0,5,凱基-林口,2024-08-12,9257
3707,漢磊,5,0,5,凱基-林口,2024-08-12,9257
00948B,中信優息投資級債,290,0,290,凱基-林口,2024-08-13,9257
00937B,群益ESG投等債20,144,0,144,凱基-林口,2024-08-13,9257
00680L,元大美債20正2,102,0,102,凱基-林口,2024-08-13,9257
00687B,國泰20年美債,113,14,99,凱基-林口,2024-08-13,9257
00878,國泰永續高股息,92,5,87,凱基-林口,2024-08-13,9257
2888,新光金,70,2,68,凱基-林口,2024-08-13,9257
00679B,元大美債20年,66,1,65,凱基-林口,2024-08-13,9257
2891,中信金,58,11,47,凱基-林口,2024-08-13,9257
00795B,中信美國公債20年,40,0,40,凱基-林口,2024-08-13,9257
2402,毅嘉,40,2,38,凱基-林口,2024-08-13,9257
00929,復華台灣科技優息,35,2,33,凱基-林口,2024-08-13,9257
3363,上詮,33,0,33,凱基-林口,2024-08-13,9257
3481,群創,64,33,31,凱基-林口,2024-08-13,9257
2405,輔信,35,5,30,凱基-林口,2024-08-13,9257
2801,彰銀,30,0,30,凱基-林口,2024-08-13,9257
00933B,國泰10Y+金融債,30,2,28,凱基-林口,2024-08-13,9257
00881,國泰台灣5G+,24,2,22,凱基-林口,2024-08-13,9257
1301,台塑,23,2,21,凱基-林口,2024-08-13,9257
2363,矽統,21,2,19,凱基-林口,2024-08-13,9257
2609,陽明,33,14,19,凱基-林口,2024-08-13,9257
00894,中信小資高價30,19,1,18,凱基-林口,2024-08-13,9257
2615,萬海,32,14,18,凱基-林口,2024-08-13,9257
3231,緯創,38,20,18,凱基-林口,2024-08-13,9257
8043,蜜望實,18,1,17,凱基-林口,2024-08-13,9257
4161,聿新科,14,0,14,凱基-林口,2024-08-13,9257
6504,南六,14,0,14,凱基-林口,2024-08-13,9257
2601,益航,13,0,13,凱基-林口,2024-08-13,9257
4909,新復興,13,0,13,凱基-林口,2024-08-13,9257
2880,華南金,13,0,13,凱基-林口,2024-08-13,9257
2603,長榮,13,1,12,凱基-林口,2024-08-13,9257
2489,瑞軒,13,1,12,凱基-林口,2024-08-13,9257
1815,富喬,11,0,11,凱基-林口,2024-08-13,9257
3188,鑫龍騰,10,0,10,凱基-林口,2024-08-13,9257
6532,瑞耘,10,0,10,凱基-林口,2024-08-13,9257
1513,中興電,30,20,10,凱基-林口,2024-08-13,9257
3706,神達,11,1,10,凱基-林口,2024-08-13,9257
3163,波若威,11,1,10,凱基-林口,2024-08-13,9257
2371,大同,10,2,8,凱基-林口,2024-08-13,9257
1560,中砂,9,1,8,凱基-林口,2024-08-13,9257
4714,永捷,8,1,7,凱基-林口,2024-08-13,9257
4526,東台,8,1,7,凱基-林口,2024-08-13,9257
6207,雷科,10,3,7,凱基-林口,2024-08-13,9257
3324,雙鴻,7,1,6,凱基-林口,2024-08-13,9257
1609,大亞,7,1,6,凱基-林口,2024-08-13,9257
2867,三商壽,7,1,6,凱基-林口,2024-08-13,9257
2885,元大金,16,10,6,凱基-林口,2024-08-13,9257
2886,兆豐金,6,0,6,凱基-林口,2024-08-13,9257
3062,建漢,20,14,6,凱基-林口,2024-08-13,9257
4566,時碩工業,7,1,6,凱基-林口,2024-08-13,9257
8071,能率網通,9,3,6,凱基-林口,2024-08-13,9257
00680L,元大美債20正2,749,22,727,凱基-林口,2024-08-14,9257
00942B,台新美A公司債20+,235,0,235,凱基-林口,2024-08-14,9257
00687B,國泰20年美債,218,0,218,凱基-林口,2024-08-14,9257
00679B,元大美債20年,188,0,188,凱基-林口,2024-08-14,9257
00900,富邦特選高股息30,102,2,100,凱基-林口,2024-08-14,9257
00637L,元大滬深300正2,95,0,95,凱基-林口,2024-08-14,9257
8028,昇陽半導體,75,15,60,凱基-林口,2024-08-14,9257
00929,復華台灣科技優息,59,10,49,凱基-林口,2024-08-14,9257
0056,元大高股息,51,13,38,凱基-林口,2024-08-14,9257
3645,達邁,40,2,38,凱基-林口,2024-08-14,9257
6532,瑞耘,27,0,27,凱基-林口,2024-08-14,9257
00937B,群益ESG投等債20,24,0,24,凱基-林口,2024-08-14,9257
1101,台泥,21,0,21,凱基-林口,2024-08-14,9257
3481,群創,48,30,18,凱基-林口,2024-08-14,9257
3541,西柏,17,0,17,凱基-林口,2024-08-14,9257
00881,國泰台灣5G+,16,0,16,凱基-林口,2024-08-14,9257
2371,大同,25,10,15,凱基-林口,2024-08-14,9257
3066,李洲,15,0,15,凱基-林口,2024-08-14,9257
3013,晟銘電,27,12,15,凱基-林口,2024-08-14,9257
2365,昆盈,24,10,14,凱基-林口,2024-08-14,9257
2356,英業達,18,4,14,凱基-林口,2024-08-14,9257
00882,中信中國高股息,15,2,13,凱基-林口,2024-08-14,9257
4513,福裕,14,1,13,凱基-林口,2024-08-14,9257
4562,穎漢,47,34,13,凱基-林口,2024-08-14,9257
00688L,國泰20年美債正2,12,0,12,凱基-林口,2024-08-14,9257
3048,益登,16,4,12,凱基-林口,2024-08-14,9257
4534,慶騰,12,1,11,凱基-林口,2024-08-14,9257
00928,中信上櫃ESG30,10,0,10,凱基-林口,2024-08-14,9257
00951,台新日本半導體,10,0,10,凱基-林口,2024-08-14,9257
1709,和益,10,0,10,凱基-林口,2024-08-14,9257
2616,山隆,10,0,10,凱基-林口,2024-08-14,9257
2888,新光金,10,0,10,凱基-林口,2024-08-14,9257
3694,海華,10,0,10,凱基-林口,2024-08-14,9257
5533,皇鼎,10,0,10,凱基-林口,2024-08-14,9257
6186,新潤,10,0,10,凱基-林口,2024-08-14,9257
6706,惠特,10,0,10,凱基-林口,2024-08-14,9257
1514,亞力,13,4,9,凱基-林口,2024-08-14,9257
1609,大亞,11,2,9,凱基-林口,2024-08-14,9257
1785,光洋科,9,0,9,凱基-林口,2024-08-14,9257
2368,金像電,9,0,9,凱基-林口,2024-08-14,9257
2609,陽明,24,15,9,凱基-林口,2024-08-14,9257
3062,建漢,9,0,9,凱基-林口,2024-08-14,9257
4161,聿新科,9,0,9,凱基-林口,2024-08-14,9257
8064,東捷,10,1,9,凱基-林口,2024-08-14,9257
2603,長榮,17,8,9,凱基-林口,2024-08-14,9257
6446,藥華藥,10,1,9,凱基-林口,2024-08-14,9257
2601,益航,8,0,8,凱基-林口,2024-08-14,9257
3312,弘憶股,17,9,8,凱基-林口,2024-08-14,9257
6443,元晶,10,2,8,凱基-林口,2024-08-14,9257
1527,鑽全,7,0,7,凱基-林口,2024-08-14,9257
00632R,元大台灣50反1,392,0,392,凱基-林口,2024-08-15,9257
00687B,國泰20年美債,335,12,323,凱基-林口,2024-08-15,9257
3492,長盛,64,3,61,凱基-林口,2024-08-15,9257
2543,皇昌,60,0,60,凱基-林口,2024-08-15,9257
00679B,元大美債20年,53,5,48,凱基-林口,2024-08-15,9257
00929,復華台灣科技優息,48,2,46,凱基-林口,2024-08-15,9257
8103,瀚荃,41,0,41,凱基-林口,2024-08-15,9257
1611,中電,41,2,39,凱基-林口,2024-08-15,9257
00900,富邦特選高股息30,43,5,38,凱基-林口,2024-08-15,9257
00881,國泰台灣5G+,33,1,32,凱基-林口,2024-08-15,9257
2303,聯電,32,1,31,凱基-林口,2024-08-15,9257
00950B,凱基A級公司債,30,0,30,凱基-林口,2024-08-15,9257
3202,樺晟,31,1,30,凱基-林口,2024-08-15,9257
00948B,中信優息投資級債,28,0,28,凱基-林口,2024-08-15,9257
1785,光洋科,27,2,25,凱基-林口,2024-08-15,9257
00878,國泰永續高股息,51,27,24,凱基-林口,2024-08-15,9257
5011,久陽,29,6,23,凱基-林口,2024-08-15,9257
3673,TPK-KY,22,1,21,凱基-林口,2024-08-15,9257
5364,力麗店,21,0,21,凱基-林口,2024-08-15,9257
9945,潤泰新,21,2,19,凱基-林口,2024-08-15,9257
2886,兆豐金,18,0,18,凱基-林口,2024-08-15,9257
6278,台表科,18,0,18,凱基-林口,2024-08-15,9257
8064,東捷,21,5,16,凱基-林口,2024-08-15,9257
00650L,復華香港正2,15,0,15,凱基-林口,2024-08-15,9257
6658,聯策,22,7,15,凱基-林口,2024-08-15,9257
00931B,統一美債20年,14,0,14,凱基-林口,2024-08-15,9257
2801,彰銀,12,0,12,凱基-林口,2024-08-15,9257
6719,力智,12,0,12,凱基-林口,2024-08-15,9257
2027,大成鋼,11,0,11,凱基-林口,2024-08-15,9257
2834,臺企銀,11,0,11,凱基-林口,2024-08-15,9257
2887,台新金,11,0,11,凱基-林口,2024-08-15,9257
00905,FT臺灣Smart,10,0,10,凱基-林口,2024-08-15,9257
2002,中鋼,15,5,10,凱基-林口,2024-08-15,9257
2701,萬企,10,0,10,凱基-林口,2024-08-15,9257
3167,大量,11,1,10,凱基-林口,2024-08-15,9257
4533,協易機,10,0,10,凱基-林口,2024-08-15,9257
2376,技嘉,13,3,10,凱基-林口,2024-08-15,9257
00933B,國泰10Y+金融債,10,1,9,凱基-林口,2024-08-15,9257
1314,中石化,9,0,9,凱基-林口,2024-08-15,9257
3450,聯鈞,11,2,9,凱基-林口,2024-08-15,9257
00919,群益台灣精選高息,11,3,8,凱基-林口,2024-08-15,9257
6139,亞翔,14,6,8,凱基-林口,2024-08-15,9257
00946,群益科技高息成長,8,0,8,凱基-林口,2024-08-15,9257
2340,台亞,8,0,8,凱基-林口,2024-08-15,9257
3541,西柏,8,0,8,凱基-林口,2024-08-15,9257
5009,榮剛,8,0,8,凱基-林口,2024-08-15,9257
6464,台數科,8,0,8,凱基-林口,2024-08-15,9257
1513,中興電,16,8,8,凱基-林口,2024-08-15,9257
8028,昇陽半導體,13,6,7,凱基-林口,2024-08-15,9257
1608,華榮,13,6,7,凱基-林口,2024-08-15,9257
00632R,元大台灣50反1,408,48,360,凱基-林口,2024-08-16,9257
00687B,國泰20年美債,279,5,274,凱基-林口,2024-08-16,9257
2002,中鋼,148,8,140,凱基-林口,2024-08-16,9257
00679B,元大美債20年,132,5,127,凱基-林口,2024-08-16,9257
8096,擎亞,105,34,71,凱基-林口,2024-08-16,9257
00688L,國泰20年美債正2,70,0,70,凱基-林口,2024-08-16,9257
2543,皇昌,60,0,60,凱基-林口,2024-08-16,9257
6160,欣技,55,0,55,凱基-林口,2024-08-16,9257
8070,長華*,75,25,50,凱基-林口,2024-08-16,9257
00878,國泰永續高股息,53,6,47,凱基-林口,2024-08-16,9257
6207,雷科,44,1,43,凱基-林口,2024-08-16,9257
2388,威盛,51,9,42,凱基-林口,2024-08-16,9257
00940,元大台灣價值高息,51,19,32,凱基-林口,2024-08-16,9257
2888,新光金,23,0,23,凱基-林口,2024-08-16,9257
8234,新漢,28,5,23,凱基-林口,2024-08-16,9257
1808,潤隆,21,0,21,凱基-林口,2024-08-16,9257
3037,欣興,31,10,21,凱基-林口,2024-08-16,9257
00937B,群益ESG投等債20,69,51,18,凱基-林口,2024-08-16,9257
1785,光洋科,26,11,15,凱基-林口,2024-08-16,9257
4923,力士,15,0,15,凱基-林口,2024-08-16,9257
00795B,中信美國公債20年,14,0,14,凱基-林口,2024-08-16,9257
2356,英業達,13,0,13,凱基-林口,2024-08-16,9257
00900,富邦特選高股息30,12,0,12,凱基-林口,2024-08-16,9257
2352,佳世達,12,0,12,凱基-林口,2024-08-16,9257
2915,潤泰全,11,0,11,凱基-林口,2024-08-16,9257
00931B,統一美債20年,16,5,11,凱基-林口,2024-08-16,9257
00923,群益台ESG低碳50,11,0,11,凱基-林口,2024-08-16,9257
00950B,凱基A級公司債,10,0,10,凱基-林口,2024-08-16,9257
1308,亞聚,10,0,10,凱基-林口,2024-08-16,9257
2546,根基,10,0,10,凱基-林口,2024-08-16,9257
3032,偉訓,10,0,10,凱基-林口,2024-08-16,9257
2107,厚生,10,1,9,凱基-林口,2024-08-16,9257
3390,旭軟,10,1,9,凱基-林口,2024-08-16,9257
3576,聯合再生,9,0,9,凱基-林口,2024-08-16,9257
4162,智擎,10,1,9,凱基-林口,2024-08-16,9257
2363,矽統,14,5,9,凱基-林口,2024-08-16,9257
00915,凱基優選高股息30,20,11,9,凱基-林口,2024-08-16,9257
2610,華航,9,1,8,凱基-林口,2024-08-16,9257
00939,統一台灣高息動能,11,4,7,凱基-林口,2024-08-16,9257
5484,慧友,8,1,7,凱基-林口,2024-08-16,9257
8043,蜜望實,12,5,7,凱基-林口,2024-08-16,9257
2636,台驊控股,6,0,6,凱基-林口,2024-08-16,9257
2641,正德,6,0,6,凱基-林口,2024-08-16,9257
2892,第一金,6,0,6,凱基-林口,2024-08-16,9257
5864,致和證,6,0,6,凱基-林口,2024-08-16,9257
2408,南亞科,5,0,5,凱基-林口,2024-08-16,9257
2886,兆豐金,6,1,5,凱基-林口,2024-08-16,9257
1442,名軒,5,0,5,凱基-林口,2024-08-16,9257
1609,大亞,5,0,5,凱基-林口,2024-08-16,9257
2374,佳能,6,1,5,凱基-林口,2024-08-16,9257
00680L,元大美債20正2,171,0,171,凱基-林口,2024-08-19,9257
8043,蜜望實,158,17,141,凱基-林口,2024-08-19,9257
00687B,國泰20年美債,129,0,129,凱基-林口,2024-08-19,9257
00929,復華台灣科技優息,128,2,126,凱基-林口,2024-08-19,9257
00937B,群益ESG投等債20,118,3,115,凱基-林口,2024-08-19,9257
00933B,國泰10Y+金融債,63,0,63,凱基-林口,2024-08-19,9257
00881,國泰台灣5G+,56,0,56,凱基-林口,2024-08-19,9257
8096,擎亞,240,193,47,凱基-林口,2024-08-19,9257
2354,鴻準,33,0,33,凱基-林口,2024-08-19,9257
2344,華邦電,30,0,30,凱基-林口,2024-08-19,9257
2890,永豐金,28,1,27,凱基-林口,2024-08-19,9257
6160,欣技,25,0,25,凱基-林口,2024-08-19,9257
6505,台塑化,26,2,24,凱基-林口,2024-08-19,9257
2002,中鋼,23,0,23,凱基-林口,2024-08-19,9257
2883,凱基金,22,2,20,凱基-林口,2024-08-19,9257
2888,新光金,42,22,20,凱基-林口,2024-08-19,9257
9902,台火,25,6,19,凱基-林口,2024-08-19,9257
2323,中環,40,22,18,凱基-林口,2024-08-19,9257
1609,大亞,16,0,16,凱基-林口,2024-08-19,9257
3219,倚強科,16,0,16,凱基-林口,2024-08-19,9257
00951,台新日本半導體,13,0,13,凱基-林口,2024-08-19,9257
2312,金寶,13,1,12,凱基-林口,2024-08-19,9257
00932,兆豐永續高息等權,11,0,11,凱基-林口,2024-08-19,9257
00918,大華優利高填息30,11,0,11,凱基-林口,2024-08-19,9257
1513,中興電,17,7,10,凱基-林口,2024-08-19,9257
3047,訊舟,76,66,10,凱基-林口,2024-08-19,9257
00761B,國泰A級公司債,10,0,10,凱基-林口,2024-08-19,9257
1611,中電,10,0,10,凱基-林口,2024-08-19,9257
2462,良得電,10,0,10,凱基-林口,2024-08-19,9257
3652,精聯,10,0,10,凱基-林口,2024-08-19,9257
6451,訊芯-KY,14,4,10,凱基-林口,2024-08-19,9257
1597,直得,11,2,9,凱基-林口,2024-08-19,9257
8011,台通,10,1,9,凱基-林口,2024-08-19,9257
00915,凱基優選高股息30,8,0,8,凱基-林口,2024-08-19,9257
00715L,期街口布蘭特正2,8,0,8,凱基-林口,2024-08-19,9257
00892,富邦台灣半導體,10,2,8,凱基-林口,2024-08-19,9257
2362,藍天,16,8,8,凱基-林口,2024-08-19,9257
2615,萬海,11,3,8,凱基-林口,2024-08-19,9257
4906,正文,9,1,8,凱基-林口,2024-08-19,9257
00720B,元大投資級公司債,7,0,7,凱基-林口,2024-08-19,9257
4961,天鈺,7,0,7,凱基-林口,2024-08-19,9257
5353,台林,7,0,7,凱基-林口,2024-08-19,9257
9945,潤泰新,8,1,7,凱基-林口,2024-08-19,9257
2891,中信金,6,0,6,凱基-林口,2024-08-19,9257
1785,光洋科,7,1,6,凱基-林口,2024-08-19,9257
2520,冠德,7,1,6,凱基-林口,2024-08-19,9257
2838A,聯邦銀甲特,15,9,6,凱基-林口,2024-08-19,9257
3055,蔚華科,6,0,6,凱基-林口,2024-08-19,9257
3188,鑫龍騰,7,1,6,凱基-林口,2024-08-19,9257
3231,緯創,7,1,6,凱基-林口,2024-08-19,9257
00937B,群益ESG投等債20,127,0,127,凱基-林口,2024-08-20,9257
00679B,元大美債20年,110,0,110,凱基-林口,2024-08-20,9257
8028,昇陽半導體,120,11,109,凱基-林口,2024-08-20,9257
00687B,國泰20年美債,61,0,61,凱基-林口,2024-08-20,9257
00715L,期街口布蘭特正2,48,0,48,凱基-林口,2024-08-20,9257
2520,冠德,54,6,48,凱基-林口,2024-08-20,9257
00933B,國泰10Y+金融債,45,0,45,凱基-林口,2024-08-20,9257
1785,光洋科,58,15,43,凱基-林口,2024-08-20,9257
2543,皇昌,44,2,42,凱基-林口,2024-08-20,9257
3447,展達,40,0,40,凱基-林口,2024-08-20,9257
2062,橋椿,67,31,36,凱基-林口,2024-08-20,9257
8043,蜜望實,29,0,29,凱基-林口,2024-08-20,9257
8096,擎亞,351,323,28,凱基-林口,2024-08-20,9257
2352,佳世達,26,1,25,凱基-林口,2024-08-20,9257
4161,聿新科,25,0,25,凱基-林口,2024-08-20,9257
3713,新晶投控,20,0,20,凱基-林口,2024-08-20,9257
2002,中鋼,18,0,18,凱基-林口,2024-08-20,9257
2409,友達,21,3,18,凱基-林口,2024-08-20,9257
2317,鴻海,36,18,18,凱基-林口,2024-08-20,9257
2601,益航,17,0,17,凱基-林口,2024-08-20,9257
3032,偉訓,17,0,17,凱基-林口,2024-08-20,9257
3545,敦泰,15,0,15,凱基-林口,2024-08-20,9257
6278,台表科,15,0,15,凱基-林口,2024-08-20,9257
6177,達麗,14,0,14,凱基-林口,2024-08-20,9257
2417,圓剛,14,0,14,凱基-林口,2024-08-20,9257
2356,英業達,19,7,12,凱基-林口,2024-08-20,9257
2374,佳能,26,14,12,凱基-林口,2024-08-20,9257
3047,訊舟,26,14,12,凱基-林口,2024-08-20,9257
00688L,國泰20年美債正2,11,0,11,凱基-林口,2024-08-20,9257
00631L,元大台灣50正2,10,0,10,凱基-林口,2024-08-20,9257
1709,和益,10,0,10,凱基-林口,2024-08-20,9257
2107,厚生,10,0,10,凱基-林口,2024-08-20,9257
2610,華航,12,2,10,凱基-林口,2024-08-20,9257
2905,三商,10,0,10,凱基-林口,2024-08-20,9257
4923,力士,10,0,10,凱基-林口,2024-08-20,9257
5864,致和證,10,0,10,凱基-林口,2024-08-20,9257
6153,嘉聯益,10,0,10,凱基-林口,2024-08-20,9257
6233,旺玖,10,0,10,凱基-林口,2024-08-20,9257
00905,FT臺灣Smart,9,0,9,凱基-林口,2024-08-20,9257
00900,富邦特選高股息30,9,0,9,凱基-林口,2024-08-20,9257
00923,群益台ESG低碳50,11,2,9,凱基-林口,2024-08-20,9257
2609,陽明,10,1,9,凱基-林口,2024-08-20,9257
3048,益登,13,4,9,凱基-林口,2024-08-20,9257
2365,昆盈,18,9,9,凱基-林口,2024-08-20,9257
2882,國泰金,14,6,8,凱基-林口,2024-08-20,9257
8349,�矬�,8,0,8,凱基-林口,2024-08-20,9257
1513,中興電,30,22,8,凱基-林口,2024-08-20,9257
00918,大華優利高填息30,7,0,7,凱基-林口,2024-08-20,9257
6219,富旺,8,1,7,凱基-林口,2024-08-20,9257
9902,台火,7,0,7,凱基-林口,2024-08-20,9257
00680L,元大美債20正2,801,41,760,凱基-林口,2024-08-21,9257
2888,新光金,312,137,175,凱基-林口,2024-08-21,9257
00632R,元大台灣50反1,70,0,70,凱基-林口,2024-08-21,9257
00715L,期街口布蘭特正2,69,0,69,凱基-林口,2024-08-21,9257
2891,中信金,67,5,62,凱基-林口,2024-08-21,9257
2402,毅嘉,63,3,60,凱基-林口,2024-08-21,9257
00929,復華台灣科技優息,54,0,54,凱基-林口,2024-08-21,9257
00953B,群益優選非投等債,47,0,47,凱基-林口,2024-08-21,9257
2317,鴻海,60,17,43,凱基-林口,2024-08-21,9257
00637L,元大滬深300正2,30,0,30,凱基-林口,2024-08-21,9257
2609,陽明,49,25,24,凱基-林口,2024-08-21,9257
2002,中鋼,29,6,23,凱基-林口,2024-08-21,9257
6570,維田,20,1,19,凱基-林口,2024-08-21,9257
00882,中信中國高股息,18,0,18,凱基-林口,2024-08-21,9257
00878,國泰永續高股息,16,0,16,凱基-林口,2024-08-21,9257
5864,致和證,16,0,16,凱基-林口,2024-08-21,9257
5905,南仁湖,19,3,16,凱基-林口,2024-08-21,9257
3032,偉訓,14,0,14,凱基-林口,2024-08-21,9257
3535,晶彩科,15,3,12,凱基-林口,2024-08-21,9257
00936,台新永續高息中小,12,0,12,凱基-林口,2024-08-21,9257
8104,錸寶,29,17,12,凱基-林口,2024-08-21,9257
4903,聯光通,11,0,11,凱基-林口,2024-08-21,9257
2408,南亞科,11,0,11,凱基-林口,2024-08-21,9257
3580,友威科,11,0,11,凱基-林口,2024-08-21,9257
00915,凱基優選高股息30,10,0,10,凱基-林口,2024-08-21,9257
2489,瑞軒,10,0,10,凱基-林口,2024-08-21,9257
00902,中信電池及儲能,10,0,10,凱基-林口,2024-08-21,9257
2352,佳世達,10,0,10,凱基-林口,2024-08-21,9257
2610,華航,19,9,10,凱基-林口,2024-08-21,9257
2905,三商,10,0,10,凱基-林口,2024-08-21,9257
2915,潤泰全,10,0,10,凱基-林口,2024-08-21,9257
3450,聯鈞,13,3,10,凱基-林口,2024-08-21,9257
00919,群益台灣精選高息,10,0,10,凱基-林口,2024-08-21,9257
2406,國碩,10,1,9,凱基-林口,2024-08-21,9257
8011,台通,9,0,9,凱基-林口,2024-08-21,9257
8027,鈦昇,9,0,9,凱基-林口,2024-08-21,9257
3713,新晶投控,9,0,9,凱基-林口,2024-08-21,9257
3686,達能,10,1,9,凱基-林口,2024-08-21,9257
5347,世界,8,0,8,凱基-林口,2024-08-21,9257
00679B,元大美債20年,8,0,8,凱基-林口,2024-08-21,9257
4161,聿新科,28,20,8,凱基-林口,2024-08-21,9257
2498,宏達電,7,0,7,凱基-林口,2024-08-21,9257
2618,長榮航,11,4,7,凱基-林口,2024-08-21,9257
4958,臻鼎-KY,6,0,6,凱基-林口,2024-08-21,9257
3167,大量,7,1,6,凱基-林口,2024-08-21,9257
00931B,統一美債20年,20,14,6,凱基-林口,2024-08-21,9257
1536,和大,6,0,6,凱基-林口,2024-08-21,9257
1584,精剛,14,8,6,凱基-林口,2024-08-21,9257
3189,景碩,6,0,6,凱基-林口,2024-08-21,9257
3363,上詮,16,10,6,凱基-林口,2024-08-21,9257
00680L,元大美債20正2,175,0,175,凱基-林口,2024-08-22,9257
6208,日揚,170,0,170,凱基-林口,2024-08-22,9257
2317,鴻海,55,8,47,凱基-林口,2024-08-22,9257
00907,永豐優息存股,42,0,42,凱基-林口,2024-08-22,9257
00715L,期街口布蘭特正2,41,0,41,凱基-林口,2024-08-22,9257
5469,瀚宇博,50,10,40,凱基-林口,2024-08-22,9257
3227,原相,49,12,37,凱基-林口,2024-08-22,9257
2890,永豐金,35,0,35,凱基-林口,2024-08-22,9257
00632R,元大台灣50反1,35,0,35,凱基-林口,2024-08-22,9257
00882,中信中國高股息,33,0,33,凱基-林口,2024-08-22,9257
2834,臺企銀,32,2,30,凱基-林口,2024-08-22,9257
2027,大成鋼,30,1,29,凱基-林口,2024-08-22,9257
8050,廣積,25,0,25,凱基-林口,2024-08-22,9257
2891,中信金,36,14,22,凱基-林口,2024-08-22,9257
1513,中興電,38,16,22,凱基-林口,2024-08-22,9257
6509,聚和,21,0,21,凱基-林口,2024-08-22,9257
5398,慕康生醫,20,0,20,凱基-林口,2024-08-22,9257
2002,中鋼,30,13,17,凱基-林口,2024-08-22,9257
00953B,群益優選非投等債,17,0,17,凱基-林口,2024-08-22,9257
5864,致和證,16,0,16,凱基-林口,2024-08-22,9257
2615,萬海,18,2,16,凱基-林口,2024-08-22,9257
1709,和益,15,0,15,凱基-林口,2024-08-22,9257
4540,全球傳動,15,0,15,凱基-林口,2024-08-22,9257
00881,國泰台灣5G+,14,0,14,凱基-林口,2024-08-22,9257
00719B,元大美債1-3,14,0,14,凱基-林口,2024-08-22,9257
00918,大華優利高填息30,13,0,13,凱基-林口,2024-08-22,9257
2609,陽明,18,5,13,凱基-林口,2024-08-22,9257
00946,群益科技高息成長,12,0,12,凱基-林口,2024-08-22,9257
3048,益登,12,0,12,凱基-林口,2024-08-22,9257
3580,友威科,11,0,11,凱基-林口,2024-08-22,9257
6235,華孚,11,0,11,凱基-林口,2024-08-22,9257
8182,加高,11,0,11,凱基-林口,2024-08-22,9257
00919,群益台灣精選高息,10,0,10,凱基-林口,2024-08-22,9257
00936,台新永續高息中小,10,0,10,凱基-林口,2024-08-22,9257
1316,上曜,10,0,10,凱基-林口,2024-08-22,9257
2905,三商,10,0,10,凱基-林口,2024-08-22,9257
5533,皇鼎,10,0,10,凱基-林口,2024-08-22,9257
9902,台火,10,0,10,凱基-林口,2024-08-22,9257
00940,元大台灣價值高息,9,0,9,凱基-林口,2024-08-22,9257
00731,復華富時高息低波,9,0,9,凱基-林口,2024-08-22,9257
2376,技嘉,10,1,9,凱基-林口,2024-08-22,9257
3447,展達,9,0,9,凱基-林口,2024-08-22,9257
5905,南仁湖,11,2,9,凱基-林口,2024-08-22,9257
00795B,中信美國公債20年,10,2,8,凱基-林口,2024-08-22,9257
3047,訊舟,28,20,8,凱基-林口,2024-08-22,9257
5443,均豪,31,24,7,凱基-林口,2024-08-22,9257
6005,群益證,12,5,7,凱基-林口,2024-08-22,9257
8422,可寧衛,7,0,7,凱基-林口,2024-08-22,9257
9955,佳龍,9,2,7,凱基-林口,2024-08-22,9257
3374,精材,8,2,6,凱基-林口,2024-08-22,9257
8043,蜜望實,200,1,199,凱基-林口,2024-08-23,9257
2891,中信金,96,2,94,凱基-林口,2024-08-23,9257
1314,中石化,261,200,61,凱基-林口,2024-08-23,9257
2409,友達,50,1,49,凱基-林口,2024-08-23,9257
00680L,元大美債20正2,37,1,36,凱基-林口,2024-08-23,9257
00933B,國泰10Y+金融債,31,0,31,凱基-林口,2024-08-23,9257
0056,元大高股息,31,1,30,凱基-林口,2024-08-23,9257
1708,東鹼,49,19,30,凱基-林口,2024-08-23,9257
1711,永光,48,21,27,凱基-林口,2024-08-23,9257
00937B,群益ESG投等債20,26,0,26,凱基-林口,2024-08-23,9257
00905,FT臺灣Smart,26,0,26,凱基-林口,2024-08-23,9257
00878,國泰永續高股息,38,12,26,凱基-林口,2024-08-23,9257
00953B,群益優選非投等債,25,0,25,凱基-林口,2024-08-23,9257
00679B,元大美債20年,26,4,22,凱基-林口,2024-08-23,9257
4906,正文,22,0,22,凱基-林口,2024-08-23,9257
4306,炎洲,21,0,21,凱基-林口,2024-08-23,9257
5398,慕康生醫,20,0,20,凱基-林口,2024-08-23,9257
2371,大同,20,1,19,凱基-林口,2024-08-23,9257
4155,訊映,19,0,19,凱基-林口,2024-08-23,9257
00687B,國泰20年美債,22,4,18,凱基-林口,2024-08-23,9257
00936,台新永續高息中小,15,0,15,凱基-林口,2024-08-23,9257
8438,昶昕,15,1,14,凱基-林口,2024-08-23,9257
3189,景碩,17,4,13,凱基-林口,2024-08-23,9257
00725B,國泰投資級公司債,12,0,12,凱基-林口,2024-08-23,9257
00881,國泰台灣5G+,11,0,11,凱基-林口,2024-08-23,9257
00940,元大台灣價值高息,12,1,11,凱基-林口,2024-08-23,9257
3447,展達,11,0,11,凱基-林口,2024-08-23,9257
8021,尖點,21,10,11,凱基-林口,2024-08-23,9257
1785,光洋科,13,3,10,凱基-林口,2024-08-23,9257
2365,昆盈,13,3,10,凱基-林口,2024-08-23,9257
1316,上曜,10,0,10,凱基-林口,2024-08-23,9257
2338,光罩,10,0,10,凱基-林口,2024-08-23,9257
2362,藍天,10,0,10,凱基-林口,2024-08-23,9257
2905,三商,10,0,10,凱基-林口,2024-08-23,9257
6219,富旺,10,0,10,凱基-林口,2024-08-23,9257
6226,光鼎,10,0,10,凱基-林口,2024-08-23,9257
6509,聚和,20,10,10,凱基-林口,2024-08-23,9257
3260,威剛,9,0,9,凱基-林口,2024-08-23,9257
6235,華孚,10,1,9,凱基-林口,2024-08-23,9257
2317,鴻海,31,22,9,凱基-林口,2024-08-23,9257
1326,台化,14,6,8,凱基-林口,2024-08-23,9257
3518,柏騰,10,2,8,凱基-林口,2024-08-23,9257
00907,永豐優息存股,7,0,7,凱基-林口,2024-08-23,9257
00931B,統一美債20年,7,0,7,凱基-林口,2024-08-23,9257
5309,系統電,7,0,7,凱基-林口,2024-08-23,9257
6530,創威,7,0,7,凱基-林口,2024-08-23,9257
3037,欣興,11,5,6,凱基-林口,2024-08-23,9257
1231,聯華食,6,0,6,凱基-林口,2024-08-23,9257
3017,奇鋐,7,1,6,凱基-林口,2024-08-23,9257
1301,台塑,6,0,6,凱基-林口,2024-08-23,9257
2888,新光金,753,610,143,凱基-林口,2024-08-26,9257
2014,中鴻,110,0,110,凱基-林口,2024-08-26,9257
1303,南亞,106,0,106,凱基-林口,2024-08-26,9257
2409,友達,63,1,62,凱基-林口,2024-08-26,9257
2891,中信金,59,11,48,凱基-林口,2024-08-26,9257
00706L,期元大S＆P日圓正2,50,6,44,凱基-林口,2024-08-26,9257
8021,尖點,35,2,33,凱基-林口,2024-08-26,9257
00937B,群益ESG投等債20,38,6,32,凱基-林口,2024-08-26,9257
3227,原相,30,0,30,凱基-林口,2024-08-26,9257
00687B,國泰20年美債,27,0,27,凱基-林口,2024-08-26,9257
1785,光洋科,27,1,26,凱基-林口,2024-08-26,9257
1409,新纖,25,0,25,凱基-林口,2024-08-26,9257
2359,所羅門,21,0,21,凱基-林口,2024-08-26,9257
8105,凌巨,21,0,21,凱基-林口,2024-08-26,9257
00632R,元大台灣50反1,20,0,20,凱基-林口,2024-08-26,9257
8028,昇陽半導體,24,4,20,凱基-林口,2024-08-26,9257
8096,擎亞,166,147,19,凱基-林口,2024-08-26,9257
00679B,元大美債20年,18,0,18,凱基-林口,2024-08-26,9257
2603,長榮,18,2,16,凱基-林口,2024-08-26,9257
2834,臺企銀,21,5,16,凱基-林口,2024-08-26,9257
8438,昶昕,15,0,15,凱基-林口,2024-08-26,9257
00953B,群益優選非投等債,18,5,13,凱基-林口,2024-08-26,9257
1708,東鹼,51,38,13,凱基-林口,2024-08-26,9257
2467,志聖,21,9,12,凱基-林口,2024-08-26,9257
2365,昆盈,26,15,11,凱基-林口,2024-08-26,9257
00904,新光臺灣半導體30,10,0,10,凱基-林口,2024-08-26,9257
1445,大宇,10,0,10,凱基-林口,2024-08-26,9257
2331,精英,22,12,10,凱基-林口,2024-08-26,9257
2402,毅嘉,42,32,10,凱基-林口,2024-08-26,9257
2520,冠德,10,0,10,凱基-林口,2024-08-26,9257
5864,致和證,10,0,10,凱基-林口,2024-08-26,9257
6226,光鼎,10,0,10,凱基-林口,2024-08-26,9257
8064,東捷,16,6,10,凱基-林口,2024-08-26,9257
8081,致新,10,0,10,凱基-林口,2024-08-26,9257
5469,瀚宇博,20,10,10,凱基-林口,2024-08-26,9257
3028,增你強,9,0,9,凱基-林口,2024-08-26,9257
3374,精材,10,1,9,凱基-林口,2024-08-26,9257
2905,三商,8,0,8,凱基-林口,2024-08-26,9257
3019,亞光,11,3,8,凱基-林口,2024-08-26,9257
6257,矽格,8,0,8,凱基-林口,2024-08-26,9257
00882,中信中國高股息,7,0,7,凱基-林口,2024-08-26,9257
6116,彩晶,7,0,7,凱基-林口,2024-08-26,9257
2002,中鋼,10,4,6,凱基-林口,2024-08-26,9257
2344,華邦電,8,2,6,凱基-林口,2024-08-26,9257
4161,聿新科,6,0,6,凱基-林口,2024-08-26,9257
6152,百一,6,0,6,凱基-林口,2024-08-26,9257
2537,聯上發,5,0,5,凱基-林口,2024-08-26,9257
2338,光罩,5,0,5,凱基-林口,2024-08-26,9257
2427,三商電,5,0,5,凱基-林口,2024-08-26,9257
3013,晟銘電,5,0,5,凱基-林口,2024-08-26,9257
1303,南亞,303,1,302,凱基-林口,2024-08-27,9257
2014,中鴻,150,0,150,凱基-林口,2024-08-27,9257
3481,群創,171,24,147,凱基-林口,2024-08-27,9257
2371,大同,115,2,113,凱基-林口,2024-08-27,9257
1815,富喬,100,0,100,凱基-林口,2024-08-27,9257
6505,台塑化,101,1,100,凱基-林口,2024-08-27,9257
2891,中信金,96,1,95,凱基-林口,2024-08-27,9257
00937B,群益ESG投等債20,65,2,63,凱基-林口,2024-08-27,9257
00929,復華台灣科技優息,82,40,42,凱基-林口,2024-08-27,9257
00919,群益台灣精選高息,42,0,42,凱基-林口,2024-08-27,9257
4566,時碩工業,35,0,35,凱基-林口,2024-08-27,9257
2888,新光金,257,226,31,凱基-林口,2024-08-27,9257
00687B,國泰20年美債,33,2,31,凱基-林口,2024-08-27,9257
6139,亞翔,32,1,31,凱基-林口,2024-08-27,9257
00679B,元大美債20年,30,0,30,凱基-林口,2024-08-27,9257
5225,東科-KY,26,1,25,凱基-林口,2024-08-27,9257
2890,永豐金,22,0,22,凱基-林口,2024-08-27,9257
1708,東鹼,22,0,22,凱基-林口,2024-08-27,9257
1722,台肥,20,0,20,凱基-林口,2024-08-27,9257
9958,世紀鋼,28,8,20,凱基-林口,2024-08-27,9257
1721,三晃,21,4,17,凱基-林口,2024-08-27,9257
2887,台新金,16,0,16,凱基-林口,2024-08-27,9257
00923,群益台ESG低碳50,16,0,16,凱基-林口,2024-08-27,9257
5469,瀚宇博,18,2,16,凱基-林口,2024-08-27,9257
00936,台新永續高息中小,15,0,15,凱基-林口,2024-08-27,9257
3047,訊舟,19,5,14,凱基-林口,2024-08-27,9257
8438,昶昕,13,0,13,凱基-林口,2024-08-27,9257
00881,國泰台灣5G+,11,0,11,凱基-林口,2024-08-27,9257
00725B,國泰投資級公司債,11,0,11,凱基-林口,2024-08-27,9257
3663,鑫科,16,5,11,凱基-林口,2024-08-27,9257
00915,凱基優選高股息30,10,0,10,凱基-林口,2024-08-27,9257
1447,力鵬,10,0,10,凱基-林口,2024-08-27,9257
2630,亞航,10,0,10,凱基-林口,2024-08-27,9257
2867,三商壽,10,0,10,凱基-林口,2024-08-27,9257
4960,誠美材,10,0,10,凱基-林口,2024-08-27,9257
00941,中信上游半導體,9,0,9,凱基-林口,2024-08-27,9257
4967,十銓,14,5,9,凱基-林口,2024-08-27,9257
2356,英業達,12,4,8,凱基-林口,2024-08-27,9257
2615,萬海,8,0,8,凱基-林口,2024-08-27,9257
8064,東捷,23,15,8,凱基-林口,2024-08-27,9257
2382,廣達,9,2,7,凱基-林口,2024-08-27,9257
1711,永光,16,9,7,凱基-林口,2024-08-27,9257
2317,鴻海,7,1,6,凱基-林口,2024-08-27,9257
00731,復華富時高息低波,6,0,6,凱基-林口,2024-08-27,9257
1717,長興,6,0,6,凱基-林口,2024-08-27,9257
3033,威健,6,0,6,凱基-林口,2024-08-27,9257
6207,雷科,6,0,6,凱基-林口,2024-08-27,9257
6863,永道-KY,6,0,6,凱基-林口,2024-08-27,9257
1789,神隆,5,0,5,凱基-林口,2024-08-27,9257
2420,新巨,5,0,5,凱基-林口,2024-08-27,9257
1303,南亞,215,0,215,凱基-林口,2024-08-28,9257
2402,毅嘉,241,74,167,凱基-林口,2024-08-28,9257
00753L,中信中國50正2,140,0,140,凱基-林口,2024-08-28,9257
2371,大同,74,0,74,凱基-林口,2024-08-28,9257
1617,榮星,63,8,55,凱基-林口,2024-08-28,9257
2891,中信金,52,1,51,凱基-林口,2024-08-28,9257
2388,威盛,53,5,48,凱基-林口,2024-08-28,9257
5234,達興材料,51,3,48,凱基-林口,2024-08-28,9257
00637L,元大滬深300正2,43,0,43,凱基-林口,2024-08-28,9257
00688L,國泰20年美債正2,37,0,37,凱基-林口,2024-08-28,9257
00959B,大華投等美債15Y+,36,0,36,凱基-林口,2024-08-28,9257
00937B,群益ESG投等債20,36,0,36,凱基-林口,2024-08-28,9257
00632R,元大台灣50反1,30,0,30,凱基-林口,2024-08-28,9257
5443,均豪,41,17,24,凱基-林口,2024-08-28,9257
2867,三商壽,24,0,24,凱基-林口,2024-08-28,9257
2890,永豐金,24,0,24,凱基-林口,2024-08-28,9257
3711,日月光投控,20,0,20,凱基-林口,2024-08-28,9257
4128,中天,20,0,20,凱基-林口,2024-08-28,9257
4549,桓達,21,1,20,凱基-林口,2024-08-28,9257
6220,岳豐,20,0,20,凱基-林口,2024-08-28,9257
00915,凱基優選高股息30,18,0,18,凱基-林口,2024-08-28,9257
00919,群益台灣精選高息,18,0,18,凱基-林口,2024-08-28,9257
0056,元大高股息,21,3,18,凱基-林口,2024-08-28,9257
2845,遠東銀,15,0,15,凱基-林口,2024-08-28,9257
2906,高林,15,0,15,凱基-林口,2024-08-28,9257
1711,永光,20,6,14,凱基-林口,2024-08-28,9257
5864,致和證,14,0,14,凱基-林口,2024-08-28,9257
2362,藍天,12,0,12,凱基-林口,2024-08-28,9257
4174,浩鼎,12,0,12,凱基-林口,2024-08-28,9257
4534,慶騰,15,4,11,凱基-林口,2024-08-28,9257
5871,中租-KY,10,0,10,凱基-林口,2024-08-28,9257
00680L,元大美債20正2,10,0,10,凱基-林口,2024-08-28,9257
2464,盟立,14,4,10,凱基-林口,2024-08-28,9257
2880,華南金,10,0,10,凱基-林口,2024-08-28,9257
3715,定穎投控,24,14,10,凱基-林口,2024-08-28,9257
4707,磐亞,10,0,10,凱基-林口,2024-08-28,9257
6596,寬宏藝術,10,0,10,凱基-林口,2024-08-28,9257
8111,立��,10,0,10,凱基-林口,2024-08-28,9257
1457,宜進,9,0,9,凱基-林口,2024-08-28,9257
2329,華泰,12,3,9,凱基-林口,2024-08-28,9257
2392,正崴,10,1,9,凱基-林口,2024-08-28,9257
00878,國泰永續高股息,10,2,8,凱基-林口,2024-08-28,9257
00679B,元大美債20年,13,5,8,凱基-林口,2024-08-28,9257
00687B,國泰20年美債,8,0,8,凱基-林口,2024-08-28,9257
00939,統一台灣高息動能,8,0,8,凱基-林口,2024-08-28,9257
00934,中信成長高股息,8,0,8,凱基-林口,2024-08-28,9257
2399,映泰,14,6,8,凱基-林口,2024-08-28,9257
3663,鑫科,10,2,8,凱基-林口,2024-08-28,9257
3289,宜特,8,1,7,凱基-林口,2024-08-28,9257
3580,友威科,9,2,7,凱基-林口,2024-08-28,9257
00632R,元大台灣50反1,285,30,255,凱基-林口,2024-08-29,9257
00937B,群益ESG投等債20,218,40,178,凱基-林口,2024-08-29,9257
2402,毅嘉,266,124,142,凱基-林口,2024-08-29,9257
00940,元大台灣價值高息,118,1,117,凱基-林口,2024-08-29,9257
2543,皇昌,104,0,104,凱基-林口,2024-08-29,9257
00915,凱基優選高股息30,86,0,86,凱基-林口,2024-08-29,9257
2891,中信金,83,0,83,凱基-林口,2024-08-29,9257
00687B,國泰20年美債,84,3,81,凱基-林口,2024-08-29,9257
00918,大華優利高填息30,67,1,66,凱基-林口,2024-08-29,9257
00680L,元大美債20正2,58,0,58,凱基-林口,2024-08-29,9257
2371,大同,58,4,54,凱基-林口,2024-08-29,9257
1540,喬福,113,69,44,凱基-林口,2024-08-29,9257
00919,群益台灣精選高息,56,17,39,凱基-林口,2024-08-29,9257
00929,復華台灣科技優息,46,8,38,凱基-林口,2024-08-29,9257
00878,國泰永續高股息,43,5,38,凱基-林口,2024-08-29,9257
6612,奈米醫材,54,22,32,凱基-林口,2024-08-29,9257
1708,東鹼,32,2,30,凱基-林口,2024-08-29,9257
00637L,元大滬深300正2,28,0,28,凱基-林口,2024-08-29,9257
3706,神達,20,0,20,凱基-林口,2024-08-29,9257
4960,誠美材,20,0,20,凱基-林口,2024-08-29,9257
00946,群益科技高息成長,19,0,19,凱基-林口,2024-08-29,9257
2880,華南金,19,1,18,凱基-林口,2024-08-29,9257
8064,東捷,25,7,18,凱基-林口,2024-08-29,9257
2890,永豐金,19,1,18,凱基-林口,2024-08-29,9257
2330,台積電,17,1,16,凱基-林口,2024-08-29,9257
2887,台新金,14,0,14,凱基-林口,2024-08-29,9257
4561,健椿,19,5,14,凱基-林口,2024-08-29,9257
8039,台虹,67,53,14,凱基-林口,2024-08-29,9257
2356,英業達,20,7,13,凱基-林口,2024-08-29,9257
00905,FT臺灣Smart,13,0,13,凱基-林口,2024-08-29,9257
9958,世紀鋼,39,26,13,凱基-林口,2024-08-29,9257
00715L,期街口布蘭特正2,12,0,12,凱基-林口,2024-08-29,9257
00751B,元大AAA至A公司債,12,0,12,凱基-林口,2024-08-29,9257
3147,大綜,13,1,12,凱基-林口,2024-08-29,9257
3312,弘憶股,13,2,11,凱基-林口,2024-08-29,9257
00688L,國泰20年美債正2,11,0,11,凱基-林口,2024-08-29,9257
00924,復華S＆P500成長,11,0,11,凱基-林口,2024-08-29,9257
2611,志信,11,0,11,凱基-林口,2024-08-29,9257
2845,遠東銀,11,0,11,凱基-林口,2024-08-29,9257
4956,光鋐,11,0,11,凱基-林口,2024-08-29,9257
8111,立��,31,20,11,凱基-林口,2024-08-29,9257
00923,群益台ESG低碳50,11,0,11,凱基-林口,2024-08-29,9257
00936,台新永續高息中小,10,0,10,凱基-林口,2024-08-29,9257
00939,統一台灣高息動能,10,0,10,凱基-林口,2024-08-29,9257
00947,台新臺灣IC設計,10,0,10,凱基-林口,2024-08-29,9257
00959B,大華投等美債15Y+,10,0,10,凱基-林口,2024-08-29,9257
4306,炎洲,10,0,10,凱基-林口,2024-08-29,9257
5531,鄉林,10,0,10,凱基-林口,2024-08-29,9257
6226,光鼎,10,0,10,凱基-林口,2024-08-29,9257
2412,中華電,9,0,9,凱基-林口,2024-08-29,9257
00937B,群益ESG投等債20,159,1,158,凱基-林口,2024-08-30,9257
2402,毅嘉,206,55,151,凱基-林口,2024-08-30,9257
3481,群創,199,149,50,凱基-林口,2024-08-30,9257
00918,大華優利高填息30,40,0,40,凱基-林口,2024-08-30,9257
2614,東森,40,0,40,凱基-林口,2024-08-30,9257
00687B,國泰20年美債,39,0,39,凱基-林口,2024-08-30,9257
2417,圓剛,30,0,30,凱基-林口,2024-08-30,9257
00680L,元大美債20正2,24,0,24,凱基-林口,2024-08-30,9257
00948B,中信優息投資級債,24,0,24,凱基-林口,2024-08-30,9257
5443,均豪,59,36,23,凱基-林口,2024-08-30,9257
00949,復華日本龍頭,22,0,22,凱基-林口,2024-08-30,9257
5439,高技,21,0,21,凱基-林口,2024-08-30,9257
1473,台南,20,0,20,凱基-林口,2024-08-30,9257
2834,臺企銀,20,0,20,凱基-林口,2024-08-30,9257
2883,凱基金,20,0,20,凱基-林口,2024-08-30,9257
2891,中信金,20,0,20,凱基-林口,2024-08-30,9257
00679B,元大美債20年,21,1,20,凱基-林口,2024-08-30,9257
2845,遠東銀,16,0,16,凱基-林口,2024-08-30,9257
1711,永光,142,127,15,凱基-林口,2024-08-30,9257
2426,鼎元,26,11,15,凱基-林口,2024-08-30,9257
1314,中石化,14,0,14,凱基-林口,2024-08-30,9257
2610,華航,12,0,12,凱基-林口,2024-08-30,9257
2382,廣達,11,0,11,凱基-林口,2024-08-30,9257
1541,錩泰,11,0,11,凱基-林口,2024-08-30,9257
2405,輔信,11,0,11,凱基-林口,2024-08-30,9257
2486,一詮,11,0,11,凱基-林口,2024-08-30,9257
3294,英濟,16,5,11,凱基-林口,2024-08-30,9257
4714,永捷,30,19,11,凱基-林口,2024-08-30,9257
1584,精剛,10,0,10,凱基-林口,2024-08-30,9257
3062,建漢,17,7,10,凱基-林口,2024-08-30,9257
4526,東台,94,84,10,凱基-林口,2024-08-30,9257
5386,青雲,15,5,10,凱基-林口,2024-08-30,9257
6226,光鼎,10,0,10,凱基-林口,2024-08-30,9257
8085,福華,10,0,10,凱基-林口,2024-08-30,9257
3037,欣興,13,3,10,凱基-林口,2024-08-30,9257
5225,東科-KY,9,0,9,凱基-林口,2024-08-30,9257
1597,直得,9,0,9,凱基-林口,2024-08-30,9257
2392,正崴,11,2,9,凱基-林口,2024-08-30,9257
3049,精金,11,2,9,凱基-林口,2024-08-30,9257
00720B,元大投資級公司債,8,0,8,凱基-林口,2024-08-30,9257
3048,益登,8,0,8,凱基-林口,2024-08-30,9257
5388,中磊,8,0,8,凱基-林口,2024-08-30,9257
6206,飛捷,8,0,8,凱基-林口,2024-08-30,9257
6215,和椿,18,10,8,凱基-林口,2024-08-30,9257
2317,鴻海,14,6,8,凱基-林口,2024-08-30,9257
00751B,元大AAA至A公司債,7,0,7,凱基-林口,2024-08-30,9257
2062,橋椿,7,0,7,凱基-林口,2024-08-30,9257
2340,台亞,7,0,7,凱基-林口,2024-08-30,9257
2364,倫飛,7,0,7,凱基-林口,2024-08-30,9257
2367,燿華,246,239,7,凱基-林口,2024-08-30,9257
8070,長華*,171,7,164,凱基-林口,2024-09-02,9257
00688L,國泰20年美債正2,110,0,110,凱基-林口,2024-09-02,9257
00919,群益台灣精選高息,90,15,75,凱基-林口,2024-09-02,9257
00715L,期街口布蘭特正2,72,0,72,凱基-林口,2024-09-02,9257
00937B,群益ESG投等債20,68,1,67,凱基-林口,2024-09-02,9257
00687B,國泰20年美債,64,1,63,凱基-林口,2024-09-02,9257
00934,中信成長高股息,59,0,59,凱基-林口,2024-09-02,9257
00637L,元大滬深300正2,50,0,50,凱基-林口,2024-09-02,9257
2882,國泰金,50,2,48,凱基-林口,2024-09-02,9257
9945,潤泰新,40,0,40,凱基-林口,2024-09-02,9257
4306,炎洲,40,6,34,凱基-林口,2024-09-02,9257
00878,國泰永續高股息,30,2,28,凱基-林口,2024-09-02,9257
2615,萬海,29,1,28,凱基-林口,2024-09-02,9257
00933B,國泰10Y+金融債,23,0,23,凱基-林口,2024-09-02,9257
3583,辛耘,18,0,18,凱基-林口,2024-09-02,9257
2002,中鋼,18,1,17,凱基-林口,2024-09-02,9257
2601,益航,21,4,17,凱基-林口,2024-09-02,9257
3490,單井,17,0,17,凱基-林口,2024-09-02,9257
3481,群創,16,0,16,凱基-林口,2024-09-02,9257
2344,華邦電,16,0,16,凱基-林口,2024-09-02,9257
2313,華通,17,1,16,凱基-林口,2024-09-02,9257
2609,陽明,21,5,16,凱基-林口,2024-09-02,9257
2464,盟立,15,0,15,凱基-林口,2024-09-02,9257
3623,富晶通,15,0,15,凱基-林口,2024-09-02,9257
3710,連展投控,20,5,15,凱基-林口,2024-09-02,9257
2603,長榮,14,0,14,凱基-林口,2024-09-02,9257
2891,中信金,14,0,14,凱基-林口,2024-09-02,9257
2303,聯電,17,3,14,凱基-林口,2024-09-02,9257
1809,中釉,13,0,13,凱基-林口,2024-09-02,9257
8105,凌巨,29,16,13,凱基-林口,2024-09-02,9257
1711,永光,13,1,12,凱基-林口,2024-09-02,9257
2417,圓剛,12,0,12,凱基-林口,2024-09-02,9257
1301,台塑,12,1,11,凱基-林口,2024-09-02,9257
4161,聿新科,16,5,11,凱基-林口,2024-09-02,9257
00679B,元大美債20年,24,14,10,凱基-林口,2024-09-02,9257
1308,亞聚,10,0,10,凱基-林口,2024-09-02,9257
1815,富喬,11,1,10,凱基-林口,2024-09-02,9257
2101,南港,10,0,10,凱基-林口,2024-09-02,9257
2405,輔信,12,2,10,凱基-林口,2024-09-02,9257
2801,彰銀,10,0,10,凱基-林口,2024-09-02,9257
3066,李洲,10,0,10,凱基-林口,2024-09-02,9257
4174,浩鼎,11,1,10,凱基-林口,2024-09-02,9257
6706,惠特,21,11,10,凱基-林口,2024-09-02,9257
00936,台新永續高息中小,10,0,10,凱基-林口,2024-09-02,9257
00830,國泰費城半導體,13,4,9,凱基-林口,2024-09-02,9257
1527,鑽全,9,0,9,凱基-林口,2024-09-02,9257
00942B,台新美A公司債20+,8,0,8,凱基-林口,2024-09-02,9257
4303,信立,8,0,8,凱基-林口,2024-09-02,9257
6005,群益證,8,0,8,凱基-林口,2024-09-02,9257
6431,光麗-KY,11,3,8,凱基-林口,2024-09-02,9257
2402,毅嘉,382,14,368,凱基-林口,2024-09-03,9257
00919,群益台灣精選高息,126,0,126,凱基-林口,2024-09-03,9257
00929,復華台灣科技優息,130,12,118,凱基-林口,2024-09-03,9257
00934,中信成長高股息,115,15,100,凱基-林口,2024-09-03,9257
00688L,國泰20年美債正2,100,0,100,凱基-林口,2024-09-03,9257
2543,皇昌,80,0,80,凱基-林口,2024-09-03,9257
00637L,元大滬深300正2,63,0,63,凱基-林口,2024-09-03,9257
4909,新復興,64,4,60,凱基-林口,2024-09-03,9257
00937B,群益ESG投等債20,79,24,55,凱基-林口,2024-09-03,9257
2845,遠東銀,51,0,51,凱基-林口,2024-09-03,9257
00943,兆豐電子高息等權,50,0,50,凱基-林口,2024-09-03,9257
8027,鈦昇,52,2,50,凱基-林口,2024-09-03,9257
00940,元大台灣價值高息,57,8,49,凱基-林口,2024-09-03,9257
2376,技嘉,48,1,47,凱基-林口,2024-09-03,9257
00679B,元大美債20年,42,0,42,凱基-林口,2024-09-03,9257
2323,中環,42,0,42,凱基-林口,2024-09-03,9257
4534,慶騰,47,7,40,凱基-林口,2024-09-03,9257
00878,國泰永續高股息,43,6,37,凱基-林口,2024-09-03,9257
00900,富邦特選高股息30,40,5,35,凱基-林口,2024-09-03,9257
00632R,元大台灣50反1,35,0,35,凱基-林口,2024-09-03,9257
2002,中鋼,34,0,34,凱基-林口,2024-09-03,9257
00680L,元大美債20正2,29,0,29,凱基-林口,2024-09-03,9257
3231,緯創,30,4,26,凱基-林口,2024-09-03,9257
00720B,元大投資級公司債,24,0,24,凱基-林口,2024-09-03,9257
2344,華邦電,40,20,20,凱基-林口,2024-09-03,9257
6219,富旺,20,0,20,凱基-林口,2024-09-03,9257
8096,擎亞,245,225,20,凱基-林口,2024-09-03,9257
2349,錸德,17,0,17,凱基-林口,2024-09-03,9257
2486,一詮,22,7,15,凱基-林口,2024-09-03,9257
2367,燿華,19,4,15,凱基-林口,2024-09-03,9257
00918,大華優利高填息30,14,0,14,凱基-林口,2024-09-03,9257
3481,群創,45,32,13,凱基-林口,2024-09-03,9257
3037,欣興,16,3,13,凱基-林口,2024-09-03,9257
2609,陽明,30,17,13,凱基-林口,2024-09-03,9257
3062,建漢,13,0,13,凱基-林口,2024-09-03,9257
3583,辛耘,11,0,11,凱基-林口,2024-09-03,9257
00687B,國泰20年美債,12,1,11,凱基-林口,2024-09-03,9257
5289,宜鼎,11,0,11,凱基-林口,2024-09-03,9257
6213,聯茂,14,3,11,凱基-林口,2024-09-03,9257
8070,長華*,12,2,10,凱基-林口,2024-09-03,9257
1303,南亞,10,0,10,凱基-林口,2024-09-03,9257
00733,富邦臺灣中小,10,0,10,凱基-林口,2024-09-03,9257
00830,國泰費城半導體,10,0,10,凱基-林口,2024-09-03,9257
00954,中信日本半導體,10,0,10,凱基-林口,2024-09-03,9257
1785,光洋科,35,25,10,凱基-林口,2024-09-03,9257
3095,及成,10,0,10,凱基-林口,2024-09-03,9257
3715,定穎投控,14,4,10,凱基-林口,2024-09-03,9257
6134,萬旭,10,0,10,凱基-林口,2024-09-03,9257
4906,正文,16,6,10,凱基-林口,2024-09-03,9257
6176,瑞儀,20,11,9,凱基-林口,2024-09-03,9257
00929,復華台灣科技優息,297,41,256,凱基-林口,2024-09-04,9257
00919,群益台灣精選高息,473,240,233,凱基-林口,2024-09-04,9257
00940,元大台灣價值高息,283,60,223,凱基-林口,2024-09-04,9257
0056,元大高股息,171,13,158,凱基-林口,2024-09-04,9257
00878,國泰永續高股息,158,12,146,凱基-林口,2024-09-04,9257
00946,群益科技高息成長,141,0,141,凱基-林口,2024-09-04,9257
00939,統一台灣高息動能,126,0,126,凱基-林口,2024-09-04,9257
2888,新光金,106,2,104,凱基-林口,2024-09-04,9257
00918,大華優利高填息30,96,0,96,凱基-林口,2024-09-04,9257
00637L,元大滬深300正2,80,0,80,凱基-林口,2024-09-04,9257
00680L,元大美債20正2,83,8,75,凱基-林口,2024-09-04,9257
4566,時碩工業,62,0,62,凱基-林口,2024-09-04,9257
2891,中信金,86,28,58,凱基-林口,2024-09-04,9257
00715L,期街口布蘭特正2,52,0,52,凱基-林口,2024-09-04,9257
2330,台積電,56,7,49,凱基-林口,2024-09-04,9257
0050,元大台灣50,47,1,46,凱基-林口,2024-09-04,9257
2344,華邦電,46,5,41,凱基-林口,2024-09-04,9257
1904,正隆,41,0,41,凱基-林口,2024-09-04,9257
00930,永豐ESG低碳高息,40,0,40,凱基-林口,2024-09-04,9257
2317,鴻海,57,21,36,凱基-林口,2024-09-04,9257
00945B,凱基美國非投等債,36,0,36,凱基-林口,2024-09-04,9257
3481,群創,44,10,34,凱基-林口,2024-09-04,9257
00881,國泰台灣5G+,38,4,34,凱基-林口,2024-09-04,9257
00915,凱基優選高股息30,35,1,34,凱基-林口,2024-09-04,9257
2834,臺企銀,33,1,32,凱基-林口,2024-09-04,9257
00720B,元大投資級公司債,30,1,29,凱基-林口,2024-09-04,9257
6176,瑞儀,34,6,28,凱基-林口,2024-09-04,9257
6218,豪勉,31,5,26,凱基-林口,2024-09-04,9257
2641,正德,25,0,25,凱基-林口,2024-09-04,9257
3037,欣興,47,23,24,凱基-林口,2024-09-04,9257
00935,野村臺灣新科技50,21,0,21,凱基-林口,2024-09-04,9257
2312,金寶,31,10,21,凱基-林口,2024-09-04,9257
2801,彰銀,21,0,21,凱基-林口,2024-09-04,9257
00671R,富邦NASDAQ反1,20,0,20,凱基-林口,2024-09-04,9257
2382,廣達,69,49,20,凱基-林口,2024-09-04,9257
8114,振樺電,19,0,19,凱基-林口,2024-09-04,9257
2002,中鋼,18,1,17,凱基-林口,2024-09-04,9257
1301,台塑,22,5,17,凱基-林口,2024-09-04,9257
1303,南亞,18,1,17,凱基-林口,2024-09-04,9257
3715,定穎投控,17,0,17,凱基-林口,2024-09-04,9257
00713,元大台灣高息低波,17,0,17,凱基-林口,2024-09-04,9257
2412,中華電,17,0,17,凱基-林口,2024-09-04,9257
2308,台達電,17,1,16,凱基-林口,2024-09-04,9257
2880,華南金,16,0,16,凱基-林口,2024-09-04,9257
2408,南亞科,16,0,16,凱基-林口,2024-09-04,9257
1326,台化,27,13,14,凱基-林口,2024-09-04,9257
2883,凱基金,15,0,15,凱基-林口,2024-09-04,9257
2606,裕民,14,0,14,凱基-林口,2024-09-04,9257
1717,長興,13,0,13,凱基-林口,2024-09-04,9257
8171,天宇,13,0,13,凱基-林口,2024-09-04,9257
2891,中信金,1068,5,1063,凱基-林口,2024-09-05,9257
8070,長華*,286,2,284,凱基-林口,2024-09-05,9257
00940,元大台灣價值高息,189,10,179,凱基-林口,2024-09-05,9257
00952,凱基台灣AI50,108,0,108,凱基-林口,2024-09-05,9257
00715L,期街口布蘭特正2,83,0,83,凱基-林口,2024-09-05,9257
00929,復華台灣科技優息,73,0,73,凱基-林口,2024-09-05,9257
00919,群益台灣精選高息,175,107,68,凱基-林口,2024-09-05,9257
00679B,元大美債20年,89,24,65,凱基-林口,2024-09-05,9257
2402,毅嘉,68,12,56,凱基-林口,2024-09-05,9257
2317,鴻海,38,6,32,凱基-林口,2024-09-05,9257
00713,元大台灣高息低波,33,6,27,凱基-林口,2024-09-05,9257
2367,燿華,27,0,27,凱基-林口,2024-09-05,9257
00915,凱基優選高股息30,26,0,26,凱基-林口,2024-09-05,9257
1303,南亞,25,1,24,凱基-林口,2024-09-05,9257
00918,大華優利高填息30,23,0,23,凱基-林口,2024-09-05,9257
1314,中石化,22,0,22,凱基-林口,2024-09-05,9257
00943,兆豐電子高息等權,20,0,20,凱基-林口,2024-09-05,9257
3231,緯創,20,2,18,凱基-林口,2024-09-05,9257
00900,富邦特選高股息30,25,7,18,凱基-林口,2024-09-05,9257
3189,景碩,16,0,16,凱基-林口,2024-09-05,9257
2888,新光金,22,6,16,凱基-林口,2024-09-05,9257
1326,台化,17,3,14,凱基-林口,2024-09-05,9257
00881,國泰台灣5G+,13,0,13,凱基-林口,2024-09-05,9257
4534,慶騰,13,0,13,凱基-林口,2024-09-05,9257
00687B,國泰20年美債,17,4,13,凱基-林口,2024-09-05,9257
2002,中鋼,14,2,12,凱基-林口,2024-09-05,9257
00830,國泰費城半導體,12,0,12,凱基-林口,2024-09-05,9257
00882,中信中國高股息,12,0,12,凱基-林口,2024-09-05,9257
3413,京鼎,12,0,12,凱基-林口,2024-09-05,9257
4510,高鋒,50,38,12,凱基-林口,2024-09-05,9257
4906,正文,12,0,12,凱基-林口,2024-09-05,9257
2408,南亞科,11,0,11,凱基-林口,2024-09-05,9257
8039,台虹,11,0,11,凱基-林口,2024-09-05,9257
2701,萬企,10,0,10,凱基-林口,2024-09-05,9257
2834,臺企銀,10,0,10,凱基-林口,2024-09-05,9257
3010,華立,10,0,10,凱基-林口,2024-09-05,9257
3033,威健,10,0,10,凱基-林口,2024-09-05,9257
3037,欣興,12,2,10,凱基-林口,2024-09-05,9257
4971,IET-KY,12,2,10,凱基-林口,2024-09-05,9257
8064,東捷,21,11,10,凱基-林口,2024-09-05,9257
8110,華東,10,0,10,凱基-林口,2024-09-05,9257
00632R,元大台灣50反1,41,32,9,凱基-林口,2024-09-05,9257
3095,及成,9,0,9,凱基-林口,2024-09-05,9257
5347,世界,9,0,9,凱基-林口,2024-09-05,9257
2614,東森,10,1,9,凱基-林口,2024-09-05,9257
1785,光洋科,11,3,8,凱基-林口,2024-09-05,9257
2801,彰銀,8,0,8,凱基-林口,2024-09-05,9257
8028,昇陽半導體,8,0,8,凱基-林口,2024-09-05,9257
5443,均豪,45,38,7,凱基-林口,2024-09-05,9257
6691,洋基工程,7,0,7,凱基-林口,2024-09-05,9257
8070,長華*,292,30,262,凱基-林口,2024-09-06,9257
00945B,凱基美國非投等債,205,3,202,凱基-林口,2024-09-06,9257
00940,元大台灣價值高息,135,7,128,凱基-林口,2024-09-06,9257
00919,群益台灣精選高息,79,23,56,凱基-林口,2024-09-06,9257
00715L,期街口布蘭特正2,54,0,54,凱基-林口,2024-09-06,9257
2905,三商,40,0,40,凱基-林口,2024-09-06,9257
00882,中信中國高股息,30,0,30,凱基-林口,2024-09-06,9257
8105,凌巨,30,0,30,凱基-林口,2024-09-06,9257
2495,普安,28,1,27,凱基-林口,2024-09-06,9257
1563,巧新,26,0,26,凱基-林口,2024-09-06,9257
00929,復華台灣科技優息,18,0,18,凱基-林口,2024-09-06,9257
2426,鼎元,17,0,17,凱基-林口,2024-09-06,9257
5443,均豪,53,37,16,凱基-林口,2024-09-06,9257
6219,富旺,16,0,16,凱基-林口,2024-09-06,9257
6415,矽力*-KY,20,6,14,凱基-林口,2024-09-06,9257
00878,國泰永續高股息,24,10,14,凱基-林口,2024-09-06,9257
00830,國泰費城半導體,13,0,13,凱基-林口,2024-09-06,9257
00687B,國泰20年美債,20,8,12,凱基-林口,2024-09-06,9257
00949,復華日本龍頭,12,0,12,凱基-林口,2024-09-06,9257
3455,由田,11,0,11,凱基-林口,2024-09-06,9257
00933B,國泰10Y+金融債,10,0,10,凱基-林口,2024-09-06,9257
2392,正崴,10,0,10,凱基-林口,2024-09-06,9257
2402,毅嘉,509,499,10,凱基-林口,2024-09-06,9257
2438,翔耀,10,0,10,凱基-林口,2024-09-06,9257
2462,良得電,10,0,10,凱基-林口,2024-09-06,9257
2614,東森,10,0,10,凱基-林口,2024-09-06,9257
2881,富邦金,10,0,10,凱基-林口,2024-09-06,9257
6116,彩晶,10,0,10,凱基-林口,2024-09-06,9257
6152,百一,10,0,10,凱基-林口,2024-09-06,9257
8110,華東,10,0,10,凱基-林口,2024-09-06,9257
4161,聿新科,9,0,9,凱基-林口,2024-09-06,9257
4960,誠美材,9,0,9,凱基-林口,2024-09-06,9257
2801,彰銀,8,0,8,凱基-林口,2024-09-06,9257
4566,時碩工業,9,1,8,凱基-林口,2024-09-06,9257
2891,中信金,13,5,8,凱基-林口,2024-09-06,9257
00941,中信上游半導體,7,0,7,凱基-林口,2024-09-06,9257
00881,國泰台灣5G+,7,0,7,凱基-林口,2024-09-06,9257
00932,兆豐永續高息等權,7,0,7,凱基-林口,2024-09-06,9257
2313,華通,6,0,6,凱基-林口,2024-09-06,9257
1526,日馳,6,0,6,凱基-林口,2024-09-06,9257
1582,信錦,6,0,6,凱基-林口,2024-09-06,9257
4956,光鋐,8,2,6,凱基-林口,2024-09-06,9257
6218,豪勉,6,0,6,凱基-林口,2024-09-06,9257
2497,怡利電,9,3,6,凱基-林口,2024-09-06,9257
5864,致和證,6,0,6,凱基-林口,2024-09-06,9257
3481,群創,8,2,6,凱基-林口,2024-09-06,9257
00733,富邦臺灣中小,5,0,5,凱基-林口,2024-09-06,9257
00953B,群益優選非投等債,5,0,5,凱基-林口,2024-09-06,9257
1617,榮星,5,0,5,凱基-林口,2024-09-06,9257
1785,光洋科,9,4,5,凱基-林口,2024-09-06,9257
8070,長華*,263,0,263,凱基-林口,2024-09-09,9257
00937B,群益ESG投等債20,214,0,214,凱基-林口,2024-09-09,9257
00918,大華優利高填息30,145,9,136,凱基-林口,2024-09-09,9257
00687B,國泰20年美債,91,3,88,凱基-林口,2024-09-09,9257
00919,群益台灣精選高息,105,18,87,凱基-林口,2024-09-09,9257
00680L,元大美債20正2,95,11,84,凱基-林口,2024-09-09,9257
00878,國泰永續高股息,83,1,82,凱基-林口,2024-09-09,9257
00929,復華台灣科技優息,62,0,62,凱基-林口,2024-09-09,9257
4540,全球傳動,55,0,55,凱基-林口,2024-09-09,9257
8096,擎亞,49,1,48,凱基-林口,2024-09-09,9257
2609,陽明,43,1,42,凱基-林口,2024-09-09,9257
2317,鴻海,49,11,38,凱基-林口,2024-09-09,9257
00632R,元大台灣50反1,39,1,38,凱基-林口,2024-09-09,9257
3481,群創,36,5,31,凱基-林口,2024-09-09,9257
00671R,富邦NASDAQ反1,30,0,30,凱基-林口,2024-09-09,9257
00915,凱基優選高股息30,46,20,26,凱基-林口,2024-09-09,9257
00940,元大台灣價值高息,46,21,25,凱基-林口,2024-09-09,9257
00882,中信中國高股息,21,0,21,凱基-林口,2024-09-09,9257
00688L,國泰20年美債正2,24,3,21,凱基-林口,2024-09-09,9257
3715,定穎投控,25,4,21,凱基-林口,2024-09-09,9257
2615,萬海,19,0,19,凱基-林口,2024-09-09,9257
2891,中信金,19,1,18,凱基-林口,2024-09-09,9257
0056,元大高股息,28,10,18,凱基-林口,2024-09-09,9257
2881,富邦金,16,0,16,凱基-林口,2024-09-09,9257
00715L,期街口布蘭特正2,16,0,16,凱基-林口,2024-09-09,9257
00631L,元大台灣50正2,15,0,15,凱基-林口,2024-09-09,9257
00931B,統一美債20年,14,0,14,凱基-林口,2024-09-09,9257
00830,國泰費城半導體,12,0,12,凱基-林口,2024-09-09,9257
2834,臺企銀,11,0,11,凱基-林口,2024-09-09,9257
3230,錦明,11,0,11,凱基-林口,2024-09-09,9257
3622,洋華,11,0,11,凱基-林口,2024-09-09,9257
4306,炎洲,11,0,11,凱基-林口,2024-09-09,9257
1447,力鵬,10,0,10,凱基-林口,2024-09-09,9257
1815,富喬,14,4,10,凱基-林口,2024-09-09,9257
2867,三商壽,10,0,10,凱基-林口,2024-09-09,9257
5230,雷笛克光學,10,0,10,凱基-林口,2024-09-09,9257
6457,紘康,10,0,10,凱基-林口,2024-09-09,9257
6596,寬宏藝術,10,0,10,凱基-林口,2024-09-09,9257
2330,台積電,10,0,10,凱基-林口,2024-09-09,9257
00881,國泰台灣5G+,9,0,9,凱基-林口,2024-09-09,9257
2356,英業達,10,2,8,凱基-林口,2024-09-09,9257
00923,群益台ESG低碳50,13,5,8,凱基-林口,2024-09-09,9257
00934,中信成長高股息,8,0,8,凱基-林口,2024-09-09,9257
2801,彰銀,8,0,8,凱基-林口,2024-09-09,9257
2845,遠東銀,8,0,8,凱基-林口,2024-09-09,9257
2308,台達電,9,1,8,凱基-林口,2024-09-09,9257
006208,富邦台50,8,0,8,凱基-林口,2024-09-09,9257
2382,廣達,8,1,7,凱基-林口,2024-09-09,9257
1609,大亞,7,0,7,凱基-林口,2024-09-09,9257
1711,永光,7,0,7,凱基-林口,2024-09-09,9257
00919,群益台灣精選高息,564,74,490,凱基-林口,2024-09-10,9257
8070,長華*,352,0,352,凱基-林口,2024-09-10,9257
00918,大華優利高填息30,248,0,248,凱基-林口,2024-09-10,9257
00952,凱基台灣AI50,175,0,175,凱基-林口,2024-09-10,9257
1708,東鹼,101,0,101,凱基-林口,2024-09-10,9257
00915,凱基優選高股息30,89,0,89,凱基-林口,2024-09-10,9257
3209,全科,70,9,61,凱基-林口,2024-09-10,9257
2344,華邦電,49,0,49,凱基-林口,2024-09-10,9257
0056,元大高股息,47,2,45,凱基-林口,2024-09-10,9257
2330,台積電,45,3,42,凱基-林口,2024-09-10,9257
00680L,元大美債20正2,45,4,41,凱基-林口,2024-09-10,9257
2317,鴻海,60,21,39,凱基-林口,2024-09-10,9257
6284,佳邦,36,0,36,凱基-林口,2024-09-10,9257
00940,元大台灣價值高息,83,50,33,凱基-林口,2024-09-10,9257
00948B,中信優息投資級債,31,0,31,凱基-林口,2024-09-10,9257
2337,旺宏,40,10,30,凱基-林口,2024-09-10,9257
2405,輔信,27,0,27,凱基-林口,2024-09-10,9257
00946,群益科技高息成長,30,3,27,凱基-林口,2024-09-10,9257
00957B,兆豐US優選投等債,25,0,25,凱基-林口,2024-09-10,9257
00715L,期街口布蘭特正2,30,7,23,凱基-林口,2024-09-10,9257
2891,中信金,27,5,22,凱基-林口,2024-09-10,9257
00878,國泰永續高股息,28,6,22,凱基-林口,2024-09-10,9257
00943,兆豐電子高息等權,20,0,20,凱基-林口,2024-09-10,9257
00881,國泰台灣5G+,20,0,20,凱基-林口,2024-09-10,9257
00894,中信小資高價30,19,0,19,凱基-林口,2024-09-10,9257
2382,廣達,19,2,17,凱基-林口,2024-09-10,9257
00929,復華台灣科技優息,85,69,16,凱基-林口,2024-09-10,9257
3481,群創,16,2,14,凱基-林口,2024-09-10,9257
3062,建漢,34,20,14,凱基-林口,2024-09-10,9257
00688L,國泰20年美債正2,13,1,12,凱基-林口,2024-09-10,9257
00930,永豐ESG低碳高息,11,0,11,凱基-林口,2024-09-10,9257
2338,光罩,12,1,11,凱基-林口,2024-09-10,9257
2440,太空梭,11,0,11,凱基-林口,2024-09-10,9257
2002,中鋼,11,1,10,凱基-林口,2024-09-10,9257
00934,中信成長高股息,10,0,10,凱基-林口,2024-09-10,9257
00795B,中信美國公債20年,10,0,10,凱基-林口,2024-09-10,9257
1605,華新,10,0,10,凱基-林口,2024-09-10,9257
2323,中環,10,0,10,凱基-林口,2024-09-10,9257
2368,金像電,13,3,10,凱基-林口,2024-09-10,9257
2538,基泰,10,0,10,凱基-林口,2024-09-10,9257
2543,皇昌,40,30,10,凱基-林口,2024-09-10,9257
3675,德微,10,0,10,凱基-林口,2024-09-10,9257
4306,炎洲,10,0,10,凱基-林口,2024-09-10,9257
6603,富強鑫,10,0,10,凱基-林口,2024-09-10,9257
8131,福懋科,10,0,10,凱基-林口,2024-09-10,9257
00687B,國泰20年美債,24,15,9,凱基-林口,2024-09-10,9257
5309,系統電,9,0,9,凱基-林口,2024-09-10,9257
6125,廣運,19,10,9,凱基-林口,2024-09-10,9257
006208,富邦台50,8,0,8,凱基-林口,2024-09-10,9257
1617,榮星,8,0,8,凱基-林口,2024-09-10,9257
00688L,國泰20年美債正2,231,3,228,凱基-林口,2024-09-11,9257
00687B,國泰20年美債,226,5,221,凱基-林口,2024-09-11,9257
00878,國泰永續高股息,136,1,135,凱基-林口,2024-09-11,9257
8070,長華*,84,0,84,凱基-林口,2024-09-11,9257
00948B,中信優息投資級債,78,0,78,凱基-林口,2024-09-11,9257
00940,元大台灣價值高息,75,2,73,凱基-林口,2024-09-11,9257
00713,元大台灣高息低波,65,0,65,凱基-林口,2024-09-11,9257
00680L,元大美債20正2,80,16,64,凱基-林口,2024-09-11,9257
00715L,期街口布蘭特正2,63,0,63,凱基-林口,2024-09-11,9257
0056,元大高股息,43,2,41,凱基-林口,2024-09-11,9257
00795B,中信美國公債20年,40,0,40,凱基-林口,2024-09-11,9257
1708,東鹼,40,0,40,凱基-林口,2024-09-11,9257
3360,尚立,35,0,35,凱基-林口,2024-09-11,9257
2356,英業達,24,1,23,凱基-林口,2024-09-11,9257
00894,中信小資高價30,22,0,22,凱基-林口,2024-09-11,9257
3663,鑫科,23,2,21,凱基-林口,2024-09-11,9257
00957B,兆豐US優選投等債,20,0,20,凱基-林口,2024-09-11,9257
2834,臺企銀,25,5,20,凱基-林口,2024-09-11,9257
4510,高鋒,26,9,17,凱基-林口,2024-09-11,9257
00830,國泰費城半導體,15,0,15,凱基-林口,2024-09-11,9257
00753L,中信中國50正2,15,0,15,凱基-林口,2024-09-11,9257
2883,凱基金,16,1,15,凱基-林口,2024-09-11,9257
3047,訊舟,20,5,15,凱基-林口,2024-09-11,9257
00915,凱基優選高股息30,14,0,14,凱基-林口,2024-09-11,9257
2423,固緯,12,0,12,凱基-林口,2024-09-11,9257
2467,志聖,14,3,11,凱基-林口,2024-09-11,9257
0050,元大台灣50,10,0,10,凱基-林口,2024-09-11,9257
00905,FT臺灣Smart,10,0,10,凱基-林口,2024-09-11,9257
00952,凱基台灣AI50,10,0,10,凱基-林口,2024-09-11,9257
1216,統一,10,0,10,凱基-林口,2024-09-11,9257
2002,中鋼,10,0,10,凱基-林口,2024-09-11,9257
2442,新美齊,10,0,10,凱基-林口,2024-09-11,9257
2614,東森,10,0,10,凱基-林口,2024-09-11,9257
3147,大綜,10,0,10,凱基-林口,2024-09-11,9257
4566,時碩工業,24,14,10,凱基-林口,2024-09-11,9257
4726,永昕,10,0,10,凱基-林口,2024-09-11,9257
6226,光鼎,10,0,10,凱基-林口,2024-09-11,9257
00935,野村臺灣新科技50,10,0,10,凱基-林口,2024-09-11,9257
00931B,統一美債20年,9,0,9,凱基-林口,2024-09-11,9257
2399,映泰,17,8,9,凱基-林口,2024-09-11,9257
1522,堤維西,9,1,8,凱基-林口,2024-09-11,9257
1702,南僑,8,0,8,凱基-林口,2024-09-11,9257
2331,精英,8,0,8,凱基-林口,2024-09-11,9257
4906,正文,8,0,8,凱基-林口,2024-09-11,9257
00951,台新日本半導體,7,0,7,凱基-林口,2024-09-11,9257
2520,冠德,8,1,7,凱基-林口,2024-09-11,9257
2881,富邦金,6,0,6,凱基-林口,2024-09-11,9257
00933B,國泰10Y+金融債,6,0,6,凱基-林口,2024-09-11,9257
1711,永光,12,6,6,凱基-林口,2024-09-11,9257
6150,撼訊,6,0,6,凱基-林口,2024-09-11,9257
00632R,元大台灣50反1,171,0,171,凱基-林口,2024-09-12,9257
2618,長榮航,102,4,98,凱基-林口,2024-09-12,9257
1711,永光,74,3,71,凱基-林口,2024-09-12,9257
2062,橋椿,71,1,70,凱基-林口,2024-09-12,9257
00687B,國泰20年美債,59,0,59,凱基-林口,2024-09-12,9257
00937B,群益ESG投等債20,53,0,53,凱基-林口,2024-09-12,9257
00940,元大台灣價值高息,60,20,40,凱基-林口,2024-09-12,9257
3481,群創,37,0,37,凱基-林口,2024-09-12,9257
2313,華通,38,5,33,凱基-林口,2024-09-12,9257
2543,皇昌,30,0,30,凱基-林口,2024-09-12,9257
2891,中信金,31,5,26,凱基-林口,2024-09-12,9257
2457,飛宏,23,0,23,凱基-林口,2024-09-12,9257
2887,台新金,22,0,22,凱基-林口,2024-09-12,9257
8112,至上,22,0,22,凱基-林口,2024-09-12,9257
00948B,中信優息投資級債,21,0,21,凱基-林口,2024-09-12,9257
00946,群益科技高息成長,20,0,20,凱基-林口,2024-09-12,9257
00885,富邦越南,20,0,20,凱基-林口,2024-09-12,9257
1608,華榮,20,0,20,凱基-林口,2024-09-12,9257
2816,旺旺保,20,0,20,凱基-林口,2024-09-12,9257
3230,錦明,20,0,20,凱基-林口,2024-09-12,9257
2888,新光金,18,0,18,凱基-林口,2024-09-12,9257
5864,致和證,17,0,17,凱基-林口,2024-09-12,9257
00679B,元大美債20年,21,6,15,凱基-林口,2024-09-12,9257
2867,三商壽,15,0,15,凱基-林口,2024-09-12,9257
6216,居易,16,1,15,凱基-林口,2024-09-12,9257
00918,大華優利高填息30,15,2,13,凱基-林口,2024-09-12,9257
2329,華泰,12,1,11,凱基-林口,2024-09-12,9257
00795B,中信美國公債20年,10,0,10,凱基-林口,2024-09-12,9257
1301,台塑,10,0,10,凱基-林口,2024-09-12,9257
1447,力鵬,10,0,10,凱基-林口,2024-09-12,9257
3014,聯陽,10,0,10,凱基-林口,2024-09-12,9257
6163,華電網,10,0,10,凱基-林口,2024-09-12,9257
00935,野村臺灣新科技50,10,1,9,凱基-林口,2024-09-12,9257
3716,中化控股,10,1,9,凱基-林口,2024-09-12,9257
00919,群益台灣精選高息,10,2,8,凱基-林口,2024-09-12,9257
1785,光洋科,8,0,8,凱基-林口,2024-09-12,9257
6152,百一,14,6,8,凱基-林口,2024-09-12,9257
1584,精剛,8,1,7,凱基-林口,2024-09-12,9257
4562,穎漢,9,2,7,凱基-林口,2024-09-12,9257
2605,新興,6,0,6,凱基-林口,2024-09-12,9257
00637L,元大滬深300正2,6,0,6,凱基-林口,2024-09-12,9257
2349,錸德,6,0,6,凱基-林口,2024-09-12,9257
3379,彬台,7,1,6,凱基-林口,2024-09-12,9257
5225,東科-KY,6,0,6,凱基-林口,2024-09-12,9257
5381,合正,9,3,6,凱基-林口,2024-09-12,9257
00688L,國泰20年美債正2,5,0,5,凱基-林口,2024-09-12,9257
00957B,兆豐US優選投等債,5,0,5,凱基-林口,2024-09-12,9257
1617,榮星,5,0,5,凱基-林口,2024-09-12,9257
1786,科妍,5,0,5,凱基-林口,2024-09-12,9257
2354,鴻準,5,0,5,凱基-林口,2024-09-12,9257
00679B,元大美債20年,1301,0,1301,凱基-林口,2024-09-13,9257
00680L,元大美債20正2,548,0,548,凱基-林口,2024-09-13,9257
2356,英業達,123,3,120,凱基-林口,2024-09-13,9257
00687B,國泰20年美債,118,10,108,凱基-林口,2024-09-13,9257
3511,矽瑪,81,1,80,凱基-林口,2024-09-13,9257
00918,大華優利高填息30,70,0,70,凱基-林口,2024-09-13,9257
4167,松瑞藥,60,0,60,凱基-林口,2024-09-13,9257
00922,國泰台灣領袖50,45,1,44,凱基-林口,2024-09-13,9257
3062,建漢,43,10,33,凱基-林口,2024-09-13,9257
00921,兆豐龍頭等權重,30,0,30,凱基-林口,2024-09-13,9257
3545,敦泰,20,0,20,凱基-林口,2024-09-13,9257
8906,花王,20,0,20,凱基-林口,2024-09-13,9257
8070,長華*,196,177,19,凱基-林口,2024-09-13,9257
6505,台塑化,20,2,18,凱基-林口,2024-09-13,9257
6451,訊芯-KY,15,1,14,凱基-林口,2024-09-13,9257
3663,鑫科,13,0,13,凱基-林口,2024-09-13,9257
2498,宏達電,13,0,13,凱基-林口,2024-09-13,9257
1326,台化,12,0,12,凱基-林口,2024-09-13,9257
00952,凱基台灣AI50,11,0,11,凱基-林口,2024-09-13,9257
2890,永豐金,10,0,10,凱基-林口,2024-09-13,9257
1319,東陽,20,10,10,凱基-林口,2024-09-13,9257
1721,三晃,10,0,10,凱基-林口,2024-09-13,9257
3360,尚立,11,1,10,凱基-林口,2024-09-13,9257
4561,健椿,10,0,10,凱基-林口,2024-09-13,9257
5230,雷笛克光學,14,4,10,凱基-林口,2024-09-13,9257
9907,統一實,10,0,10,凱基-林口,2024-09-13,9257
3481,群創,13,4,9,凱基-林口,2024-09-13,9257
00935,野村臺灣新科技50,10,1,9,凱基-林口,2024-09-13,9257
1711,永光,23,14,9,凱基-林口,2024-09-13,9257
2376,技嘉,10,1,9,凱基-林口,2024-09-13,9257
3522,御嵿,9,0,9,凱基-林口,2024-09-13,9257
00929,復華台灣科技優息,9,1,8,凱基-林口,2024-09-13,9257
00937B,群益ESG投等債20,13,5,8,凱基-林口,2024-09-13,9257
3189,景碩,12,4,8,凱基-林口,2024-09-13,9257
2883,凱基金,8,1,7,凱基-林口,2024-09-13,9257
2603,長榮,11,5,6,凱基-林口,2024-09-13,9257
2881,富邦金,6,0,6,凱基-林口,2024-09-13,9257
00947,台新臺灣IC設計,6,0,6,凱基-林口,2024-09-13,9257
00830,國泰費城半導體,6,0,6,凱基-林口,2024-09-13,9257
3379,彬台,7,1,6,凱基-林口,2024-09-13,9257
4510,高鋒,19,13,6,凱基-林口,2024-09-13,9257
8096,擎亞,8,2,6,凱基-林口,2024-09-13,9257
4909,新復興,8,2,6,凱基-林口,2024-09-13,9257
2303,聯電,5,0,5,凱基-林口,2024-09-13,9257
00688L,國泰20年美債正2,5,0,5,凱基-林口,2024-09-13,9257
1216,統一,6,1,5,凱基-林口,2024-09-13,9257
2374,佳能,5,0,5,凱基-林口,2024-09-13,9257
2851,中再保,5,0,5,凱基-林口,2024-09-13,9257
4533,協易機,5,0,5,凱基-林口,2024-09-13,9257
5864,致和證,5,0,5,凱基-林口,2024-09-13,9257
00679B,元大美債20年,676,30,646,凱基-林口,2024-09-16,9257
3049,精金,250,55,195,凱基-林口,2024-09-16,9257
8070,長華*,152,0,152,凱基-林口,2024-09-16,9257
00915,凱基優選高股息30,113,1,112,凱基-林口,2024-09-16,9257
00687B,國泰20年美債,88,6,82,凱基-林口,2024-09-16,9257
00632R,元大台灣50反1,75,0,75,凱基-林口,2024-09-16,9257
00919,群益台灣精選高息,97,42,55,凱基-林口,2024-09-16,9257
00921,兆豐龍頭等權重,46,0,46,凱基-林口,2024-09-16,9257
4161,聿新科,141,95,46,凱基-林口,2024-09-16,9257
00923,群益台ESG低碳50,39,0,39,凱基-林口,2024-09-16,9257
00935,野村臺灣新科技50,31,0,31,凱基-林口,2024-09-16,9257
1708,東鹼,36,5,31,凱基-林口,2024-09-16,9257
3607,谷崧,40,10,30,凱基-林口,2024-09-16,9257
4903,聯光通,30,0,30,凱基-林口,2024-09-16,9257
00878,國泰永續高股息,18,0,18,凱基-林口,2024-09-16,9257
2477,美隆電,17,0,17,凱基-林口,2024-09-16,9257
00680L,元大美債20正2,36,20,16,凱基-林口,2024-09-16,9257
00712,復華富時不動產,16,1,15,凱基-林口,2024-09-16,9257
1539,巨庭,15,0,15,凱基-林口,2024-09-16,9257
4510,高鋒,40,26,14,凱基-林口,2024-09-16,9257
9938,百和,14,0,14,凱基-林口,2024-09-16,9257
00688L,國泰20年美債正2,20,7,13,凱基-林口,2024-09-16,9257
1785,光洋科,21,8,13,凱基-林口,2024-09-16,9257
2332,友訊,13,0,13,凱基-林口,2024-09-16,9257
00946,群益科技高息成長,11,0,11,凱基-林口,2024-09-16,9257
00713,元大台灣高息低波,11,0,11,凱基-林口,2024-09-16,9257
8039,台虹,10,0,10,凱基-林口,2024-09-16,9257
2890,永豐金,10,0,10,凱基-林口,2024-09-16,9257
00931B,統一美債20年,10,0,10,凱基-林口,2024-09-16,9257
00922,國泰台灣領袖50,10,0,10,凱基-林口,2024-09-16,9257
1447,力鵬,10,0,10,凱基-林口,2024-09-16,9257
1718,中纖,10,0,10,凱基-林口,2024-09-16,9257
2062,橋椿,11,1,10,凱基-林口,2024-09-16,9257
2812,台中銀,10,0,10,凱基-林口,2024-09-16,9257
2845,遠東銀,10,0,10,凱基-林口,2024-09-16,9257
3363,上詮,10,0,10,凱基-林口,2024-09-16,9257
3576,聯合再生,10,0,10,凱基-林口,2024-09-16,9257
4979,華星光,15,5,10,凱基-林口,2024-09-16,9257
6226,光鼎,10,0,10,凱基-林口,2024-09-16,9257
2405,輔信,10,1,9,凱基-林口,2024-09-16,9257
3305,昇貿,9,0,9,凱基-林口,2024-09-16,9257
00881,國泰台灣5G+,9,1,8,凱基-林口,2024-09-16,9257
4927,泰鼎-KY,8,0,8,凱基-林口,2024-09-16,9257
8096,擎亞,11,3,8,凱基-林口,2024-09-16,9257
3706,神達,9,2,7,凱基-林口,2024-09-16,9257
00937B,群益ESG投等債20,7,0,7,凱基-林口,2024-09-16,9257
2426,鼎元,9,2,7,凱基-林口,2024-09-16,9257
3033,威健,7,0,7,凱基-林口,2024-09-16,9257
3522,御嵿,10,3,7,凱基-林口,2024-09-16,9257
1216,統一,6,0,6,凱基-林口,2024-09-16,9257
00929,復華台灣科技優息,169,1,168,凱基-林口,2024-09-18,9257
8070,長華*,128,0,128,凱基-林口,2024-09-18,9257
00687B,國泰20年美債,146,21,125,凱基-林口,2024-09-18,9257
9938,百和,108,0,108,凱基-林口,2024-09-18,9257
00712,復華富時不動產,100,0,100,凱基-林口,2024-09-18,9257
1815,富喬,100,0,100,凱基-林口,2024-09-18,9257
00632R,元大台灣50反1,70,0,70,凱基-林口,2024-09-18,9257
2867,三商壽,66,0,66,凱基-林口,2024-09-18,9257
00680L,元大美債20正2,75,21,54,凱基-林口,2024-09-18,9257
4161,聿新科,107,54,53,凱基-林口,2024-09-18,9257
2317,鴻海,57,7,50,凱基-林口,2024-09-18,9257
3049,精金,52,3,49,凱基-林口,2024-09-18,9257
00959B,大華投等美債15Y+,50,2,48,凱基-林口,2024-09-18,9257
0056,元大高股息,42,0,42,凱基-林口,2024-09-18,9257
00945B,凱基美國非投等債,40,0,40,凱基-林口,2024-09-18,9257
00679B,元大美債20年,49,10,39,凱基-林口,2024-09-18,9257
1708,東鹼,40,7,33,凱基-林口,2024-09-18,9257
3481,群創,28,2,26,凱基-林口,2024-09-18,9257
00915,凱基優選高股息30,36,10,26,凱基-林口,2024-09-18,9257
2439,美律,23,2,21,凱基-林口,2024-09-18,9257
00936,台新永續高息中小,20,0,20,凱基-林口,2024-09-18,9257
2614,東森,20,0,20,凱基-林口,2024-09-18,9257
2845,遠東銀,20,0,20,凱基-林口,2024-09-18,9257
3715,定穎投控,19,0,19,凱基-林口,2024-09-18,9257
1447,力鵬,18,0,18,凱基-林口,2024-09-18,9257
2344,華邦電,17,0,17,凱基-林口,2024-09-18,9257
1301,台塑,18,3,15,凱基-林口,2024-09-18,9257
2515,中工,15,0,15,凱基-林口,2024-09-18,9257
3062,建漢,154,139,15,凱基-林口,2024-09-18,9257
4906,正文,15,0,15,凱基-林口,2024-09-18,9257
2371,大同,15,1,14,凱基-林口,2024-09-18,9257
00713,元大台灣高息低波,13,0,13,凱基-林口,2024-09-18,9257
9958,世紀鋼,14,1,13,凱基-林口,2024-09-18,9257
2313,華通,38,26,12,凱基-林口,2024-09-18,9257
2062,橋椿,12,0,12,凱基-林口,2024-09-18,9257
3550,聯穎,12,0,12,凱基-林口,2024-09-18,9257
8064,東捷,13,2,11,凱基-林口,2024-09-18,9257
00881,國泰台灣5G+,11,0,11,凱基-林口,2024-09-18,9257
2426,鼎元,43,32,11,凱基-林口,2024-09-18,9257
6505,台塑化,11,0,11,凱基-林口,2024-09-18,9257
00878,國泰永續高股息,41,30,11,凱基-林口,2024-09-18,9257
3037,欣興,12,2,10,凱基-林口,2024-09-18,9257
00757,統一FANG+,10,0,10,凱基-林口,2024-09-18,9257
1539,巨庭,10,0,10,凱基-林口,2024-09-18,9257
2405,輔信,10,0,10,凱基-林口,2024-09-18,9257
4958,臻鼎-KY,10,0,10,凱基-林口,2024-09-18,9257
2615,萬海,15,6,9,凱基-林口,2024-09-18,9257
4909,新復興,10,1,9,凱基-林口,2024-09-18,9257
2338,光罩,8,0,8,凱基-林口,2024-09-18,9257
6189,豐藝,9,1,8,凱基-林口,2024-09-18,9257
4161,聿新科,316,0,316,凱基-林口,2024-09-19,9257
00687B,國泰20年美債,318,24,294,凱基-林口,2024-09-19,9257
00637L,元大滬深300正2,175,0,175,凱基-林口,2024-09-19,9257
00712,復華富時不動產,130,6,124,凱基-林口,2024-09-19,9257
2402,毅嘉,100,1,99,凱基-林口,2024-09-19,9257
2351,順德,98,0,98,凱基-林口,2024-09-19,9257
00632R,元大台灣50反1,120,50,70,凱基-林口,2024-09-19,9257
00671R,富邦NASDAQ反1,112,42,70,凱基-林口,2024-09-19,9257
00680L,元大美債20正2,106,45,61,凱基-林口,2024-09-19,9257
3576,聯合再生,60,0,60,凱基-林口,2024-09-19,9257
00919,群益台灣精選高息,63,6,57,凱基-林口,2024-09-19,9257
6698,旭暉應材,64,12,52,凱基-林口,2024-09-19,9257
00930,永豐ESG低碳高息,50,0,50,凱基-林口,2024-09-19,9257
00940,元大台灣價值高息,54,12,42,凱基-林口,2024-09-19,9257
00929,復華台灣科技優息,41,7,34,凱基-林口,2024-09-19,9257
00679B,元大美債20年,84,51,33,凱基-林口,2024-09-19,9257
00915,凱基優選高股息30,28,1,27,凱基-林口,2024-09-19,9257
2344,華邦電,44,19,25,凱基-林口,2024-09-19,9257
00688L,國泰20年美債正2,25,0,25,凱基-林口,2024-09-19,9257
2537,聯上發,20,0,20,凱基-林口,2024-09-19,9257
00945B,凱基美國非投等債,19,0,19,凱基-林口,2024-09-19,9257
4711,永純,17,0,17,凱基-林口,2024-09-19,9257
2383,台光電,21,6,15,凱基-林口,2024-09-19,9257
1727,中華化,20,5,15,凱基-林口,2024-09-19,9257
3163,波若威,17,2,15,凱基-林口,2024-09-19,9257
3550,聯穎,26,12,14,凱基-林口,2024-09-19,9257
4561,健椿,13,0,13,凱基-林口,2024-09-19,9257
6207,雷科,12,0,12,凱基-林口,2024-09-19,9257
6426,統新,12,0,12,凱基-林口,2024-09-19,9257
00931B,統一美債20年,12,1,11,凱基-林口,2024-09-19,9257
3017,奇鋐,12,1,11,凱基-林口,2024-09-19,9257
00772B,中信高評級公司債,10,0,10,凱基-林口,2024-09-19,9257
1102,亞泥,10,0,10,凱基-林口,2024-09-19,9257
2439,美律,10,0,10,凱基-林口,2024-09-19,9257
4906,正文,10,0,10,凱基-林口,2024-09-19,9257
2834,臺企銀,10,0,10,凱基-林口,2024-09-19,9257
3481,群創,10,0,10,凱基-林口,2024-09-19,9257
00937B,群益ESG投等債20,9,0,9,凱基-林口,2024-09-19,9257
2440,太空梭,10,1,9,凱基-林口,2024-09-19,9257
3374,精材,9,0,9,凱基-林口,2024-09-19,9257
6274,台燿,12,3,9,凱基-林口,2024-09-19,9257
00713,元大台灣高息低波,8,0,8,凱基-林口,2024-09-19,9257
3430,奇鈦科,8,0,8,凱基-林口,2024-09-19,9257
4562,穎漢,10,2,8,凱基-林口,2024-09-19,9257
5263,智崴,16,8,8,凱基-林口,2024-09-19,9257
2243,宏旭-KY,7,0,7,凱基-林口,2024-09-19,9257
5483,中美晶,7,0,7,凱基-林口,2024-09-19,9257
4768,晶呈科技,9,2,7,凱基-林口,2024-09-19,9257
00933B,國泰10Y+金融債,11,5,6,凱基-林口,2024-09-19,9257
00795B,中信美國公債20年,6,0,6,凱基-林口,2024-09-19,9257
00637L,元大滬深300正2,810,0,810,凱基-林口,2024-09-20,9257
2891,中信金,701,15,686,凱基-林口,2024-09-20,9257
00919,群益台灣精選高息,119,9,110,凱基-林口,2024-09-20,9257
00687B,國泰20年美債,118,8,110,凱基-林口,2024-09-20,9257
8070,長華*,221,123,98,凱基-林口,2024-09-20,9257
00679B,元大美債20年,60,0,60,凱基-林口,2024-09-20,9257
00680L,元大美債20正2,48,0,48,凱基-林口,2024-09-20,9257
4161,聿新科,142,102,40,凱基-林口,2024-09-20,9257
2834,臺企銀,41,3,38,凱基-林口,2024-09-20,9257
00632R,元大台灣50反1,67,30,37,凱基-林口,2024-09-20,9257
5213,亞昕,43,6,37,凱基-林口,2024-09-20,9257
4306,炎洲,35,0,35,凱基-林口,2024-09-20,9257
5460,同協,33,0,33,凱基-林口,2024-09-20,9257
2520,冠德,28,2,26,凱基-林口,2024-09-20,9257
3062,建漢,42,18,24,凱基-林口,2024-09-20,9257
00751B,元大AAA至A公司債,22,0,22,凱基-林口,2024-09-20,9257
00930,永豐ESG低碳高息,20,0,20,凱基-林口,2024-09-20,9257
00696B,富邦美債20年,20,0,20,凱基-林口,2024-09-20,9257
1708,東鹼,20,0,20,凱基-林口,2024-09-20,9257
2461,光群雷,20,0,20,凱基-林口,2024-09-20,9257
6283,淳安,20,0,20,凱基-林口,2024-09-20,9257
2515,中工,22,5,17,凱基-林口,2024-09-20,9257
2845,遠東銀,17,0,17,凱基-林口,2024-09-20,9257
00915,凱基優選高股息30,23,8,15,凱基-林口,2024-09-20,9257
1524,耿鼎,18,3,15,凱基-林口,2024-09-20,9257
3694,海華,15,0,15,凱基-林口,2024-09-20,9257
8040,九暘,15,0,15,凱基-林口,2024-09-20,9257
2883,凱基金,19,5,14,凱基-林口,2024-09-20,9257
2477,美隆電,14,0,14,凱基-林口,2024-09-20,9257
2542,興富發,13,0,13,凱基-林口,2024-09-20,9257
00946,群益科技高息成長,13,0,13,凱基-林口,2024-09-20,9257
2062,橋椿,14,1,13,凱基-林口,2024-09-20,9257
3056,富華新,13,0,13,凱基-林口,2024-09-20,9257
3035,智原,13,0,13,凱基-林口,2024-09-20,9257
00960,野村全球航運龍頭,12,0,12,凱基-林口,2024-09-20,9257
2537,聯上發,11,0,11,凱基-林口,2024-09-20,9257
2439,美律,10,0,10,凱基-林口,2024-09-20,9257
2442,新美齊,10,0,10,凱基-林口,2024-09-20,9257
2540,愛山林,10,0,10,凱基-林口,2024-09-20,9257
3390,旭軟,30,20,10,凱基-林口,2024-09-20,9257
3597,映興,10,0,10,凱基-林口,2024-09-20,9257
5864,致和證,10,0,10,凱基-林口,2024-09-20,9257
4931,新盛力,10,1,9,凱基-林口,2024-09-20,9257
6869,雲豹能源,10,1,9,凱基-林口,2024-09-20,9257
6257,矽格,8,0,8,凱基-林口,2024-09-20,9257
6763,綠界科技*,8,0,8,凱基-林口,2024-09-20,9257
5519,隆大,8,0,8,凱基-林口,2024-09-20,9257
00764B,群益25年美債,7,0,7,凱基-林口,2024-09-20,9257
1539,巨庭,7,0,7,凱基-林口,2024-09-20,9257
2425,承啟,79,72,7,凱基-林口,2024-09-20,9257
00687B,國泰20年美債,94,0,94,凱基-林口,2024-09-23,9257
2402,毅嘉,90,10,80,凱基-林口,2024-09-23,9257
8070,長華*,505,432,73,凱基-林口,2024-09-23,9257
00929,復華台灣科技優息,121,59,62,凱基-林口,2024-09-23,9257
00679B,元大美債20年,64,6,58,凱基-林口,2024-09-23,9257
00680L,元大美債20正2,55,0,55,凱基-林口,2024-09-23,9257
6138,茂達,71,18,53,凱基-林口,2024-09-23,9257
6869,雲豹能源,41,0,41,凱基-林口,2024-09-23,9257
5230,雷笛克光學,41,2,39,凱基-林口,2024-09-23,9257
2888,新光金,92,60,32,凱基-林口,2024-09-23,9257
00960,野村全球航運龍頭,31,1,30,凱基-林口,2024-09-23,9257
00878,國泰永續高股息,27,1,26,凱基-林口,2024-09-23,9257
00632R,元大台灣50反1,25,0,25,凱基-林口,2024-09-23,9257
5243,乙盛-KY,24,0,24,凱基-林口,2024-09-23,9257
1711,永光,53,30,23,凱基-林口,2024-09-23,9257
1708,東鹼,23,1,22,凱基-林口,2024-09-23,9257
00662,富邦NASDAQ,20,0,20,凱基-林口,2024-09-23,9257
1522,堤維西,20,0,20,凱基-林口,2024-09-23,9257
3048,益登,22,3,19,凱基-林口,2024-09-23,9257
00900,富邦特選高股息30,21,3,18,凱基-林口,2024-09-23,9257
2486,一詮,15,1,14,凱基-林口,2024-09-23,9257
5213,亞昕,14,0,14,凱基-林口,2024-09-23,9257
00915,凱基優選高股息30,15,1,14,凱基-林口,2024-09-23,9257
1776,展宇,19,6,13,凱基-林口,2024-09-23,9257
2376,技嘉,13,0,13,凱基-林口,2024-09-23,9257
6274,台燿,22,11,11,凱基-林口,2024-09-23,9257
6548,長科*,11,1,10,凱基-林口,2024-09-23,9257
00696B,富邦美債20年,10,0,10,凱基-林口,2024-09-23,9257
00946,群益科技高息成長,10,0,10,凱基-林口,2024-09-23,9257
1413,宏洲,10,0,10,凱基-林口,2024-09-23,9257
2426,鼎元,10,0,10,凱基-林口,2024-09-23,9257
2461,光群雷,10,0,10,凱基-林口,2024-09-23,9257
3313,斐成,10,0,10,凱基-林口,2024-09-23,9257
8112,至上,10,0,10,凱基-林口,2024-09-23,9257
2313,華通,8,0,8,凱基-林口,2024-09-23,9257
2419,仲琦,8,0,8,凱基-林口,2024-09-23,9257
3588,通嘉,8,0,8,凱基-林口,2024-09-23,9257
6446,藥華藥,8,0,8,凱基-林口,2024-09-23,9257
8080,印鉐,8,0,8,凱基-林口,2024-09-23,9257
1721,三晃,17,10,7,凱基-林口,2024-09-23,9257
1727,中華化,43,36,7,凱基-林口,2024-09-23,9257
2062,橋椿,12,5,7,凱基-林口,2024-09-23,9257
3450,聯鈞,27,20,7,凱基-林口,2024-09-23,9257
3685,元創精密,7,0,7,凱基-林口,2024-09-23,9257
5285,界霖,7,0,7,凱基-林口,2024-09-23,9257
5905,南仁湖,7,0,7,凱基-林口,2024-09-23,9257
3715,定穎投控,32,26,6,凱基-林口,2024-09-23,9257
2399,映泰,15,9,6,凱基-林口,2024-09-23,9257
2425,承啟,13,7,6,凱基-林口,2024-09-23,9257
2515,中工,7,1,6,凱基-林口,2024-09-23,9257
00918,大華優利高填息30,295,7,288,凱基-林口,2024-09-24,9257
00632R,元大台灣50反1,200,60,140,凱基-林口,2024-09-24,9257
00633L,富邦上証正2,114,1,113,凱基-林口,2024-09-24,9257
2402,毅嘉,223,114,109,凱基-林口,2024-09-24,9257
00688L,國泰20年美債正2,100,1,99,凱基-林口,2024-09-24,9257
00637L,元大滬深300正2,200,119,81,凱基-林口,2024-09-24,9257
00932,兆豐永續高息等權,50,0,50,凱基-林口,2024-09-24,9257
6138,茂達,57,10,47,凱基-林口,2024-09-24,9257
3450,聯鈞,55,12,43,凱基-林口,2024-09-24,9257
6552,易華電,40,0,40,凱基-林口,2024-09-24,9257
4161,聿新科,133,94,39,凱基-林口,2024-09-24,9257
8070,長華*,55,18,37,凱基-林口,2024-09-24,9257
3481,群創,37,1,36,凱基-林口,2024-09-24,9257
00937B,群益ESG投等債20,32,1,31,凱基-林口,2024-09-24,9257
00943,兆豐電子高息等權,30,0,30,凱基-林口,2024-09-24,9257
4540,全球傳動,23,0,23,凱基-林口,2024-09-24,9257
6274,台燿,24,2,22,凱基-林口,2024-09-24,9257
2605,新興,30,8,22,凱基-林口,2024-09-24,9257
00960,野村全球航運龍頭,20,0,20,凱基-林口,2024-09-24,9257
1776,展宇,19,0,19,凱基-林口,2024-09-24,9257
00919,群益台灣精選高息,19,2,17,凱基-林口,2024-09-24,9257
00679B,元大美債20年,26,9,17,凱基-林口,2024-09-24,9257
2515,中工,18,1,17,凱基-林口,2024-09-24,9257
2609,陽明,63,46,17,凱基-林口,2024-09-24,9257
4716,大立,16,2,14,凱基-林口,2024-09-24,9257
8358,金居,15,1,14,凱基-林口,2024-09-24,9257
2891,中信金,16,2,14,凱基-林口,2024-09-24,9257
3597,映興,16,3,13,凱基-林口,2024-09-24,9257
00946,群益科技高息成長,11,0,11,凱基-林口,2024-09-24,9257
6658,聯策,11,0,11,凱基-林口,2024-09-24,9257
00959B,大華投等美債15Y+,10,0,10,凱基-林口,2024-09-24,9257
1522,堤維西,10,0,10,凱基-林口,2024-09-24,9257
1708,東鹼,14,4,10,凱基-林口,2024-09-24,9257
2369,菱生,10,0,10,凱基-林口,2024-09-24,9257
2477,美隆電,10,0,10,凱基-林口,2024-09-24,9257
3707,漢磊,10,0,10,凱基-林口,2024-09-24,9257
5230,雷笛克光學,10,0,10,凱基-林口,2024-09-24,9257
6284,佳邦,11,1,10,凱基-林口,2024-09-24,9257
2812,台中銀,10,1,9,凱基-林口,2024-09-24,9257
2442,新美齊,9,0,9,凱基-林口,2024-09-24,9257
2888,新光金,19,10,9,凱基-林口,2024-09-24,9257
3149,正達,123,115,8,凱基-林口,2024-09-24,9257
1524,耿鼎,11,3,8,凱基-林口,2024-09-24,9257
2313,華通,12,4,8,凱基-林口,2024-09-24,9257
2540,愛山林,8,0,8,凱基-林口,2024-09-24,9257
3715,定穎投控,95,87,8,凱基-林口,2024-09-24,9257
6446,藥華藥,8,1,7,凱基-林口,2024-09-24,9257
00712,復華富時不動產,7,0,7,凱基-林口,2024-09-24,9257
3605,宏致,9,2,7,凱基-林口,2024-09-24,9257
5371,中光電,7,0,7,凱基-林口,2024-09-24,9257
00687B,國泰20年美債,234,0,234,凱基-林口,2024-09-25,9257
8070,長華*,299,102,197,凱基-林口,2024-09-25,9257
00960,野村全球航運龍頭,133,17,116,凱基-林口,2024-09-25,9257
3060,銘異,95,1,94,凱基-林口,2024-09-25,9257
00945B,凱基美國非投等債,80,0,80,凱基-林口,2024-09-25,9257
3062,建漢,77,11,66,凱基-林口,2024-09-25,9257
4161,聿新科,100,39,61,凱基-林口,2024-09-25,9257
2605,新興,40,0,40,凱基-林口,2024-09-25,9257
00679B,元大美債20年,40,1,39,凱基-林口,2024-09-25,9257
00633L,富邦上証正2,36,0,36,凱基-林口,2024-09-25,9257
00933B,國泰10Y+金融債,32,0,32,凱基-林口,2024-09-25,9257
3710,連展投控,36,5,31,凱基-林口,2024-09-25,9257
1524,耿鼎,24,1,23,凱基-林口,2024-09-25,9257
3481,群創,22,0,22,凱基-林口,2024-09-25,9257
1413,宏洲,19,0,19,凱基-林口,2024-09-25,9257
5230,雷笛克光學,20,1,19,凱基-林口,2024-09-25,9257
6138,茂達,50,31,19,凱基-林口,2024-09-25,9257
00907,永豐優息存股,16,0,16,凱基-林口,2024-09-25,9257
1584,精剛,18,4,14,凱基-林口,2024-09-25,9257
00725B,國泰投資級公司債,13,0,13,凱基-林口,2024-09-25,9257
6188,廣明,25,12,13,凱基-林口,2024-09-25,9257
00753L,中信中國50正2,12,0,12,凱基-林口,2024-09-25,9257
3550,聯穎,428,416,12,凱基-林口,2024-09-25,9257
3593,力銘,12,0,12,凱基-林口,2024-09-25,9257
00950B,凱基A級公司債,10,0,10,凱基-林口,2024-09-25,9257
2462,良得電,10,0,10,凱基-林口,2024-09-25,9257
2495,普安,10,0,10,凱基-林口,2024-09-25,9257
2610,華航,10,0,10,凱基-林口,2024-09-25,9257
6133,金橋,11,1,10,凱基-林口,2024-09-25,9257
6548,長科*,10,0,10,凱基-林口,2024-09-25,9257
8111,立��,12,2,10,凱基-林口,2024-09-25,9257
8473,山林水,10,0,10,凱基-林口,2024-09-25,9257
9958,世紀鋼,12,3,9,凱基-林口,2024-09-25,9257
2436,偉詮電,18,9,9,凱基-林口,2024-09-25,9257
2440,太空梭,12,3,9,凱基-林口,2024-09-25,9257
3149,正達,27,18,9,凱基-林口,2024-09-25,9257
6691,洋基工程,8,0,8,凱基-林口,2024-09-25,9257
4306,炎洲,8,0,8,凱基-林口,2024-09-25,9257
00942B,台新美A公司債20+,8,0,8,凱基-林口,2024-09-25,9257
6108,競國,8,0,8,凱基-林口,2024-09-25,9257
2353,宏��,7,0,7,凱基-林口,2024-09-25,9257
2845,遠東銀,10,3,7,凱基-林口,2024-09-25,9257
3406,玉晶光,7,0,7,凱基-林口,2024-09-25,9257
5871,中租-KY,12,5,7,凱基-林口,2024-09-25,9257
6967,汎瑋材料,7,0,7,凱基-林口,2024-09-25,9257
2374,佳能,6,0,6,凱基-林口,2024-09-25,9257
3047,訊舟,11,5,6,凱基-林口,2024-09-25,9257
8064,東捷,7,1,6,凱基-林口,2024-09-25,9257
8086,宏捷科,6,0,6,凱基-林口,2024-09-25,9257
2449,京元電子,45,39,6,凱基-林口,2024-09-25,9257
2402,毅嘉,602,0,602,凱基-林口,2024-09-26,9257
00687B,國泰20年美債,213,10,203,凱基-林口,2024-09-26,9257
00943,兆豐電子高息等權,80,0,80,凱基-林口,2024-09-26,9257
00945B,凱基美國非投等債,70,0,70,凱基-林口,2024-09-26,9257
1609,大亞,70,1,69,凱基-林口,2024-09-26,9257
2323,中環,106,49,57,凱基-林口,2024-09-26,9257
00688L,國泰20年美債正2,51,3,48,凱基-林口,2024-09-26,9257
2317,鴻海,44,8,36,凱基-林口,2024-09-26,9257
2204,中華,35,0,35,凱基-林口,2024-09-26,9257
3492,長盛,29,0,29,凱基-林口,2024-09-26,9257
4161,聿新科,113,85,28,凱基-林口,2024-09-26,9257
00715L,期街口布蘭特正2,30,6,24,凱基-林口,2024-09-26,9257
00679B,元大美債20年,29,8,21,凱基-林口,2024-09-26,9257
1540,喬福,30,10,20,凱基-林口,2024-09-26,9257
1584,精剛,21,1,20,凱基-林口,2024-09-26,9257
3516,亞帝歐,20,0,20,凱基-林口,2024-09-26,9257
9105,泰金寶-DR,20,0,20,凱基-林口,2024-09-26,9257
8147,正淩,19,0,19,凱基-林口,2024-09-26,9257
00764B,群益25年美債,17,0,17,凱基-林口,2024-09-26,9257
00720B,元大投資級公司債,17,0,17,凱基-林口,2024-09-26,9257
00958B,永豐ESG銀行債15,17,0,17,凱基-林口,2024-09-26,9257
6138,茂達,25,8,17,凱基-林口,2024-09-26,9257
3260,威剛,16,1,15,凱基-林口,2024-09-26,9257
6237,驊訊,15,0,15,凱基-林口,2024-09-26,9257
3019,亞光,17,3,14,凱基-林口,2024-09-26,9257
00725B,國泰投資級公司債,13,0,13,凱基-林口,2024-09-26,9257
00665L,富邦�琤肭磪囓�2,15,2,13,凱基-林口,2024-09-26,9257
00946,群益科技高息成長,13,1,12,凱基-林口,2024-09-26,9257
5460,同協,12,0,12,凱基-林口,2024-09-26,9257
6873,泓德能源,12,1,11,凱基-林口,2024-09-26,9257
1314,中石化,11,0,11,凱基-林口,2024-09-26,9257
1539,巨庭,12,1,11,凱基-林口,2024-09-26,9257
6933,AMAX-KY,11,0,11,凱基-林口,2024-09-26,9257
6188,廣明,14,3,11,凱基-林口,2024-09-26,9257
00907,永豐優息存股,11,1,10,凱基-林口,2024-09-26,9257
00655L,國泰中國A50正2,10,0,10,凱基-林口,2024-09-26,9257
00948B,中信優息投資級債,10,0,10,凱基-林口,2024-09-26,9257
00950B,凱基A級公司債,10,0,10,凱基-林口,2024-09-26,9257
2812,台中銀,10,0,10,凱基-林口,2024-09-26,9257
2356,英業達,9,0,9,凱基-林口,2024-09-26,9257
1605,華新,11,2,9,凱基-林口,2024-09-26,9257
2888,新光金,10,1,9,凱基-林口,2024-09-26,9257
1519,華城,17,8,9,凱基-林口,2024-09-26,9257
0056,元大高股息,11,3,8,凱基-林口,2024-09-26,9257
4561,健椿,8,0,8,凱基-林口,2024-09-26,9257
6160,欣技,8,0,8,凱基-林口,2024-09-26,9257
6806,森崴能源,19,11,8,凱基-林口,2024-09-26,9257
2388,威盛,13,6,7,凱基-林口,2024-09-26,9257
3622,洋華,21,14,7,凱基-林口,2024-09-26,9257
4542,科嶠,8,1,7,凱基-林口,2024-09-26,9257
8070,長華*,511,0,511,凱基-林口,2024-09-27,9257
00687B,國泰20年美債,171,7,164,凱基-林口,2024-09-27,9257
00706L,期元大S＆P日圓正2,110,0,110,凱基-林口,2024-09-27,9257
00679B,元大美債20年,88,0,88,凱基-林口,2024-09-27,9257
00937B,群益ESG投等債20,89,2,87,凱基-林口,2024-09-27,9257
00960,野村全球航運龍頭,53,0,53,凱基-林口,2024-09-27,9257
00688L,國泰20年美債正2,46,0,46,凱基-林口,2024-09-27,9257
00632R,元大台灣50反1,45,1,44,凱基-林口,2024-09-27,9257
00933B,國泰10Y+金融債,42,0,42,凱基-林口,2024-09-27,9257
2543,皇昌,80,41,39,凱基-林口,2024-09-27,9257
6138,茂達,40,6,34,凱基-林口,2024-09-27,9257
00680L,元大美債20正2,31,3,28,凱基-林口,2024-09-27,9257
3163,波若威,35,13,22,凱基-林口,2024-09-27,9257
2402,毅嘉,24,2,22,凱基-林口,2024-09-27,9257
3060,銘異,22,0,22,凱基-林口,2024-09-27,9257
2884,玉山金,23,1,22,凱基-林口,2024-09-27,9257
1313,聯成,20,0,20,凱基-林口,2024-09-27,9257
4532,瑞智,20,0,20,凱基-林口,2024-09-27,9257
2637,慧洋-KY,52,32,20,凱基-林口,2024-09-27,9257
6505,台塑化,21,2,19,凱基-林口,2024-09-27,9257
00715L,期街口布蘭特正2,17,0,17,凱基-林口,2024-09-27,9257
6274,台燿,14,0,14,凱基-林口,2024-09-27,9257
8150,南茂,14,0,14,凱基-林口,2024-09-27,9257
00725B,國泰投資級公司債,13,0,13,凱基-林口,2024-09-27,9257
2605,新興,23,10,13,凱基-林口,2024-09-27,9257
2399,映泰,22,10,12,凱基-林口,2024-09-27,9257
00712,復華富時不動產,11,0,11,凱基-林口,2024-09-27,9257
1702,南僑,11,0,11,凱基-林口,2024-09-27,9257
2317,鴻海,36,25,11,凱基-林口,2024-09-27,9257
00662,富邦NASDAQ,10,0,10,凱基-林口,2024-09-27,9257
00642U,期元大S＆P石油,10,0,10,凱基-林口,2024-09-27,9257
00885,富邦越南,10,0,10,凱基-林口,2024-09-27,9257
00942B,台新美A公司債20+,10,0,10,凱基-林口,2024-09-27,9257
1524,耿鼎,14,4,10,凱基-林口,2024-09-27,9257
2460,建通,10,0,10,凱基-林口,2024-09-27,9257
2845,遠東銀,10,0,10,凱基-林口,2024-09-27,9257
2913,農林,10,0,10,凱基-林口,2024-09-27,9257
3363,上詮,20,10,10,凱基-林口,2024-09-27,9257
3710,連展投控,13,3,10,凱基-林口,2024-09-27,9257
6163,華電網,10,0,10,凱基-林口,2024-09-27,9257
8096,擎亞,10,0,10,凱基-林口,2024-09-27,9257
4909,新復興,13,3,10,凱基-林口,2024-09-27,9257
3715,定穎投控,18,8,10,凱基-林口,2024-09-27,9257
6257,矽格,8,0,8,凱基-林口,2024-09-27,9257
00948B,中信優息投資級債,7,0,7,凱基-林口,2024-09-27,9257
2887,台新金,7,0,7,凱基-林口,2024-09-27,9257
2615,萬海,74,67,7,凱基-林口,2024-09-27,9257
00905,FT臺灣Smart,6,0,6,凱基-林口,2024-09-27,9257
2890,永豐金,6,0,6,凱基-林口,2024-09-27,9257
5299,杰力,6,0,6,凱基-林口,2024-09-27,9257
00680L,元大美債20正2,500,0,500,凱基-林口,2024-09-30,9257
00687B,國泰20年美債,228,4,224,凱基-林口,2024-09-30,9257
00919,群益台灣精選高息,188,2,186,凱基-林口,2024-09-30,9257
8070,長華*,126,0,126,凱基-林口,2024-09-30,9257
2402,毅嘉,113,5,108,凱基-林口,2024-09-30,9257
00929,復華台灣科技優息,103,0,103,凱基-林口,2024-09-30,9257
6118,建達,53,0,53,凱基-林口,2024-09-30,9257
0056,元大高股息,48,1,47,凱基-林口,2024-09-30,9257
00878,國泰永續高股息,54,10,44,凱基-林口,2024-09-30,9257
2603,長榮,42,6,36,凱基-林口,2024-09-30,9257
2609,陽明,63,27,36,凱基-林口,2024-09-30,9257
2344,華邦電,36,0,36,凱基-林口,2024-09-30,9257
00937B,群益ESG投等債20,33,0,33,凱基-林口,2024-09-30,9257
00671R,富邦NASDAQ反1,30,0,30,凱基-林口,2024-09-30,9257
00945B,凱基美國非投等債,27,0,27,凱基-林口,2024-09-30,9257
3305,昇貿,25,0,25,凱基-林口,2024-09-30,9257
9105,泰金寶-DR,25,0,25,凱基-林口,2024-09-30,9257
00725B,國泰投資級公司債,24,0,24,凱基-林口,2024-09-30,9257
5014,建錩,22,0,22,凱基-林口,2024-09-30,9257
00960,野村全球航運龍頭,22,1,21,凱基-林口,2024-09-30,9257
00636,國泰中國A50,21,0,21,凱基-林口,2024-09-30,9257
2891,中信金,25,4,21,凱基-林口,2024-09-30,9257
00943,兆豐電子高息等權,20,0,20,凱基-林口,2024-09-30,9257
2022,聚亨,70,50,20,凱基-林口,2024-09-30,9257
4532,瑞智,20,0,20,凱基-林口,2024-09-30,9257
00918,大華優利高填息30,20,0,20,凱基-林口,2024-09-30,9257
1301,台塑,22,3,19,凱基-林口,2024-09-30,9257
00946,群益科技高息成長,18,0,18,凱基-林口,2024-09-30,9257
2330,台積電,20,2,18,凱基-林口,2024-09-30,9257
2313,華通,17,1,16,凱基-林口,2024-09-30,9257
2498,宏達電,21,6,15,凱基-林口,2024-09-30,9257
1717,長興,15,0,15,凱基-林口,2024-09-30,9257
5521,工信,15,0,15,凱基-林口,2024-09-30,9257
1513,中興電,15,1,14,凱基-林口,2024-09-30,9257
2615,萬海,33,19,14,凱基-林口,2024-09-30,9257
00752,中信中國50,22,9,13,凱基-林口,2024-09-30,9257
006206,元大上證50,13,0,13,凱基-林口,2024-09-30,9257
00936,台新永續高息中小,13,0,13,凱基-林口,2024-09-30,9257
1563,巧新,13,0,13,凱基-林口,2024-09-30,9257
1313,聯成,12,0,12,凱基-林口,2024-09-30,9257
6161,捷波,12,0,12,凱基-林口,2024-09-30,9257
006208,富邦台50,11,0,11,凱基-林口,2024-09-30,9257
00881,國泰台灣5G+,11,0,11,凱基-林口,2024-09-30,9257
00905,FT臺灣Smart,11,0,11,凱基-林口,2024-09-30,9257
1605,華新,11,0,11,凱基-林口,2024-09-30,9257
5608,四維航,11,0,11,凱基-林口,2024-09-30,9257
00885,富邦越南,10,0,10,凱基-林口,2024-09-30,9257
1413,宏洲,10,0,10,凱基-林口,2024-09-30,9257
1447,力鵬,10,0,10,凱基-林口,2024-09-30,9257
2867,三商壽,10,0,10,凱基-林口,2024-09-30,9257
00919,群益台灣精選高息,143,1,142,凱基-林口,2024-10-01,9257
2363,矽統,122,21,101,凱基-林口,2024-10-01,9257
2402,毅嘉,97,6,91,凱基-林口,2024-10-01,9257
3450,聯鈞,47,3,44,凱基-林口,2024-10-01,9257
0056,元大高股息,43,0,43,凱基-林口,2024-10-01,9257
8070,長華*,52,10,42,凱基-林口,2024-10-01,9257
6139,亞翔,41,0,41,凱基-林口,2024-10-01,9257
00637L,元大滬深300正2,36,0,36,凱基-林口,2024-10-01,9257
4716,大立,56,23,33,凱基-林口,2024-10-01,9257
00687B,國泰20年美債,45,13,32,凱基-林口,2024-10-01,9257
00929,復華台灣科技優息,69,40,29,凱基-林口,2024-10-01,9257
2498,宏達電,39,11,28,凱基-林口,2024-10-01,9257
00937B,群益ESG投等債20,23,0,23,凱基-林口,2024-10-01,9257
2867,三商壽,22,0,22,凱基-林口,2024-10-01,9257
00720B,元大投資級公司債,22,0,22,凱基-林口,2024-10-01,9257
00878,國泰永續高股息,55,33,22,凱基-林口,2024-10-01,9257
2812,台中銀,20,0,20,凱基-林口,2024-10-01,9257
8403,盛弘,19,0,19,凱基-林口,2024-10-01,9257
2888,新光金,23,4,19,凱基-林口,2024-10-01,9257
1294,漢田生技,18,0,18,凱基-林口,2024-10-01,9257
1802,台玻,21,4,17,凱基-林口,2024-10-01,9257
8097,常珵,16,0,16,凱基-林口,2024-10-01,9257
00952,凱基台灣AI50,15,0,15,凱基-林口,2024-10-01,9257
00922,國泰台灣領袖50,14,0,14,凱基-林口,2024-10-01,9257
00752,中信中國50,14,0,14,凱基-林口,2024-10-01,9257
2641,正德,14,0,14,凱基-林口,2024-10-01,9257
2022,聚亨,12,0,12,凱基-林口,2024-10-01,9257
2883,凱基金,11,0,11,凱基-林口,2024-10-01,9257
00688L,國泰20年美債正2,10,0,10,凱基-林口,2024-10-01,9257
1904,正隆,10,0,10,凱基-林口,2024-10-01,9257
2062,橋椿,10,1,9,凱基-林口,2024-10-01,9257
3163,波若威,16,8,8,凱基-林口,2024-10-01,9257
2317,鴻海,11,3,8,凱基-林口,2024-10-01,9257
00915,凱基優選高股息30,8,0,8,凱基-林口,2024-10-01,9257
1314,中石化,10,2,8,凱基-林口,2024-10-01,9257
3715,定穎投控,11,3,8,凱基-林口,2024-10-01,9257
6161,捷波,8,0,8,凱基-林口,2024-10-01,9257
00905,FT臺灣Smart,7,0,7,凱基-林口,2024-10-01,9257
4161,聿新科,77,70,7,凱基-林口,2024-10-01,9257
00633L,富邦上証正2,6,0,6,凱基-林口,2024-10-01,9257
1301,台塑,12,6,6,凱基-林口,2024-10-01,9257
1524,耿鼎,6,0,6,凱基-林口,2024-10-01,9257
1569,濱川,6,0,6,凱基-林口,2024-10-01,9257
2371,大同,6,0,6,凱基-林口,2024-10-01,9257
5907,大洋-KY,6,0,6,凱基-林口,2024-10-01,9257
2881,富邦金,8,2,6,凱基-林口,2024-10-01,9257
2330,台積電,11,6,5,凱基-林口,2024-10-01,9257
1539,巨庭,5,0,5,凱基-林口,2024-10-01,9257
2477,美隆電,5,0,5,凱基-林口,2024-10-01,9257
3481,群創,5,0,5,凱基-林口,2024-10-01,9257
00918,大華優利高填息30,104,0,104,凱基-林口,2024-10-04,9257
00753L,中信中國50正2,85,14,71,凱基-林口,2024-10-04,9257
00700,富邦�琤肭磪�,55,0,55,凱基-林口,2024-10-04,9257
00688L,國泰20年美債正2,55,6,49,凱基-林口,2024-10-04,9257
00940,元大台灣價值高息,46,0,46,凱基-林口,2024-10-04,9257
00680L,元大美債20正2,40,0,40,凱基-林口,2024-10-04,9257
6743,安普新,40,0,40,凱基-林口,2024-10-04,9257
2204,中華,41,2,39,凱基-林口,2024-10-04,9257
00952,凱基台灣AI50,38,0,38,凱基-林口,2024-10-04,9257
0056,元大高股息,39,3,36,凱基-林口,2024-10-04,9257
00730,富邦臺灣優質高息,32,0,32,凱基-林口,2024-10-04,9257
00905,FT臺灣Smart,31,0,31,凱基-林口,2024-10-04,9257
00639,富邦深100,30,0,30,凱基-林口,2024-10-04,9257
00671R,富邦NASDAQ反1,30,0,30,凱基-林口,2024-10-04,9257
00927,群益半導體收益,30,0,30,凱基-林口,2024-10-04,9257
00878,國泰永續高股息,29,0,29,凱基-林口,2024-10-04,9257
2618,長榮航,28,2,26,凱基-林口,2024-10-04,9257
5876,上海商銀,26,0,26,凱基-林口,2024-10-04,9257
00636,國泰中國A50,21,0,21,凱基-林口,2024-10-04,9257
1702,南僑,23,2,21,凱基-林口,2024-10-04,9257
2615,萬海,25,4,21,凱基-林口,2024-10-04,9257
4566,時碩工業,22,2,20,凱基-林口,2024-10-04,9257
2330,台積電,20,1,19,凱基-林口,2024-10-04,9257
3037,欣興,22,2,20,凱基-林口,2024-10-04,9257
5351,鈺創,19,0,19,凱基-林口,2024-10-04,9257
2603,長榮,32,15,17,凱基-林口,2024-10-04,9257
2477,美隆電,17,0,17,凱基-林口,2024-10-04,9257
2609,陽明,31,15,16,凱基-林口,2024-10-04,9257
00907,永豐優息存股,20,4,16,凱基-林口,2024-10-04,9257
1802,台玻,22,6,16,凱基-林口,2024-10-04,9257
00713,元大台灣高息低波,16,0,16,凱基-林口,2024-10-04,9257
00960,野村全球航運龍頭,16,1,15,凱基-林口,2024-10-04,9257
2308,台達電,14,0,14,凱基-林口,2024-10-04,9257
2303,聯電,14,1,13,凱基-林口,2024-10-04,9257
00922,國泰台灣領袖50,13,0,13,凱基-林口,2024-10-04,9257
1513,中興電,15,2,13,凱基-林口,2024-10-04,9257
8071,能率網通,13,0,13,凱基-林口,2024-10-04,9257
00687B,國泰20年美債,18,6,12,凱基-林口,2024-10-04,9257
00655L,國泰中國A50正2,11,0,11,凱基-林口,2024-10-04,9257
1539,巨庭,11,0,11,凱基-林口,2024-10-04,9257
00936,台新永續高息中小,10,0,10,凱基-林口,2024-10-04,9257
1609,大亞,10,0,10,凱基-林口,2024-10-04,9257
00650L,復華香港正2,10,0,10,凱基-林口,2024-10-04,9257
3038,全台,10,0,10,凱基-林口,2024-10-04,9257
2383,台光電,10,1,9,凱基-林口,2024-10-04,9257
00946,群益科技高息成長,9,0,9,凱基-林口,2024-10-04,9257
00665L,富邦�琤肭磪囓�2,11,2,9,凱基-林口,2024-10-04,9257
00937B,群益ESG投等債20,25,16,9,凱基-林口,2024-10-04,9257
1294,漢田生技,9,0,9,凱基-林口,2024-10-04,9257
2543,皇昌,91,82,9,凱基-林口,2024-10-04,9257
00637L,元大滬深300正2,1461,48,1413,凱基-林口,2024-10-07,9257
3049,精金,202,10,192,凱基-林口,2024-10-07,9257
00688L,國泰20年美債正2,165,0,165,凱基-林口,2024-10-07,9257
1909,榮成,130,0,130,凱基-林口,2024-10-07,9257
00882,中信中國高股息,186,80,106,凱基-林口,2024-10-07,9257
00687B,國泰20年美債,107,6,101,凱基-林口,2024-10-07,9257
00632R,元大台灣50反1,75,0,75,凱基-林口,2024-10-07,9257
00636,國泰中國A50,75,20,55,凱基-林口,2024-10-07,9257
0061,元大寶滬深,50,7,43,凱基-林口,2024-10-07,9257
4161,聿新科,207,165,42,凱基-林口,2024-10-07,9257
0056,元大高股息,37,0,37,凱基-林口,2024-10-07,9257
1294,漢田生技,33,0,33,凱基-林口,2024-10-07,9257
00631L,元大台灣50正2,32,0,32,凱基-林口,2024-10-07,9257
00940,元大台灣價值高息,52,20,32,凱基-林口,2024-10-07,9257
3663,鑫科,31,0,31,凱基-林口,2024-10-07,9257
2402,毅嘉,50,21,29,凱基-林口,2024-10-07,9257
3591,艾笛森,25,0,25,凱基-林口,2024-10-07,9257
2356,英業達,29,6,23,凱基-林口,2024-10-07,9257
00905,FT臺灣Smart,22,0,22,凱基-林口,2024-10-07,9257
2929,淘帝-KY,23,1,22,凱基-林口,2024-10-07,9257
2317,鴻海,44,22,22,凱基-林口,2024-10-07,9257
00673R,期元大S＆P原油反1,21,0,21,凱基-林口,2024-10-07,9257
00725B,國泰投資級公司債,20,0,20,凱基-林口,2024-10-07,9257
006207,復華滬深,20,0,20,凱基-林口,2024-10-07,9257
1711,永光,20,0,20,凱基-林口,2024-10-07,9257
2426,鼎元,20,0,20,凱基-林口,2024-10-07,9257
00639,富邦深100,17,1,16,凱基-林口,2024-10-07,9257
1444,力麗,16,0,16,凱基-林口,2024-10-07,9257
2105,正新,21,5,16,凱基-林口,2024-10-07,9257
6161,捷波,15,0,15,凱基-林口,2024-10-07,9257
2408,南亞科,16,1,15,凱基-林口,2024-10-07,9257
00700,富邦�琤肭磪�,14,0,14,凱基-林口,2024-10-07,9257
00764B,群益25年美債,13,0,13,凱基-林口,2024-10-07,9257
6118,建達,13,0,13,凱基-林口,2024-10-07,9257
1702,南僑,15,3,12,凱基-林口,2024-10-07,9257
2881,富邦金,12,0,12,凱基-林口,2024-10-07,9257
2412,中華電,13,2,11,凱基-林口,2024-10-07,9257
8111,立��,17,6,11,凱基-林口,2024-10-07,9257
2369,菱生,10,0,10,凱基-林口,2024-10-07,9257
6841,長佳智能,10,0,10,凱基-林口,2024-10-07,9257
8473,山林水,10,0,10,凱基-林口,2024-10-07,9257
1446,宏和,10,1,9,凱基-林口,2024-10-07,9257
00881,國泰台灣5G+,8,0,8,凱基-林口,2024-10-07,9257
2231,為升,7,0,7,凱基-林口,2024-10-07,9257
6152,百一,10,3,7,凱基-林口,2024-10-07,9257
2609,陽明,10,4,6,凱基-林口,2024-10-07,9257
2495,普安,6,0,6,凱基-林口,2024-10-07,9257
2885,元大金,6,0,6,凱基-林口,2024-10-07,9257
006208,富邦台50,5,0,5,凱基-林口,2024-10-07,9257
8103,瀚荃,5,0,5,凱基-林口,2024-10-07,9257
00687B,國泰20年美債,143,1,142,凱基-林口,2024-10-08,9257
3149,正達,134,2,132,凱基-林口,2024-10-08,9257
00688L,國泰20年美債正2,77,15,62,凱基-林口,2024-10-08,9257
1314,中石化,56,0,56,凱基-林口,2024-10-08,9257
0056,元大高股息,53,0,53,凱基-林口,2024-10-08,9257
8070,長華*,51,0,51,凱基-林口,2024-10-08,9257
00922,國泰台灣領袖50,48,0,48,凱基-林口,2024-10-08,9257
00637L,元大滬深300正2,66,23,43,凱基-林口,2024-10-08,9257
00878,國泰永續高股息,36,0,36,凱基-林口,2024-10-08,9257
00933B,國泰10Y+金融債,36,0,36,凱基-林口,2024-10-08,9257
00919,群益台灣精選高息,33,0,33,凱基-林口,2024-10-08,9257
00937B,群益ESG投等債20,32,0,32,凱基-林口,2024-10-08,9257
3037,欣興,34,2,32,凱基-林口,2024-10-08,9257
00946,群益科技高息成長,32,0,32,凱基-林口,2024-10-08,9257
2883,凱基金,32,0,32,凱基-林口,2024-10-08,9257
00671R,富邦NASDAQ反1,30,0,30,凱基-林口,2024-10-08,9257
3062,建漢,29,0,29,凱基-林口,2024-10-08,9257
3481,群創,26,0,26,凱基-林口,2024-10-08,9257
8249,菱光,33,7,26,凱基-林口,2024-10-08,9257
5443,均豪,40,14,26,凱基-林口,2024-10-08,9257
00940,元大台灣價值高息,36,10,26,凱基-林口,2024-10-08,9257
00929,復華台灣科技優息,40,15,25,凱基-林口,2024-10-08,9257
5426,振發,22,0,22,凱基-林口,2024-10-08,9257
2356,英業達,21,0,21,凱基-林口,2024-10-08,9257
00673R,期元大S＆P原油反1,21,0,21,凱基-林口,2024-10-08,9257
3706,神達,20,0,20,凱基-林口,2024-10-08,9257
9105,泰金寶-DR,20,0,20,凱基-林口,2024-10-08,9257
00887,永豐中國科技50大,26,7,19,凱基-林口,2024-10-08,9257
3583,辛耘,18,0,18,凱基-林口,2024-10-08,9257
2363,矽統,30,13,17,凱基-林口,2024-10-08,9257
1563,巧新,16,0,16,凱基-林口,2024-10-08,9257
00725B,國泰投資級公司債,19,3,16,凱基-林口,2024-10-08,9257
2412,中華電,15,0,15,凱基-林口,2024-10-08,9257
8028,昇陽半導體,79,66,13,凱基-林口,2024-10-08,9257
2845,遠東銀,12,0,12,凱基-林口,2024-10-08,9257
00952,凱基台灣AI50,12,0,12,凱基-林口,2024-10-08,9257
2101,南港,13,1,12,凱基-林口,2024-10-08,9257
2425,承啟,32,20,12,凱基-林口,2024-10-08,9257
3033,威健,15,3,12,凱基-林口,2024-10-08,9257
8404,百和興業-KY,17,5,12,凱基-林口,2024-10-08,9257
5225,東科-KY,25,14,11,凱基-林口,2024-10-08,9257
2362,藍天,29,18,11,凱基-林口,2024-10-08,9257
6153,嘉聯益,11,0,11,凱基-林口,2024-10-08,9257
8111,立��,11,0,11,凱基-林口,2024-10-08,9257
00942B,台新美A公司債20+,10,0,10,凱基-林口,2024-10-08,9257
1444,力麗,10,0,10,凱基-林口,2024-10-08,9257
1447,力鵬,10,0,10,凱基-林口,2024-10-08,9257
2062,橋椿,10,0,10,凱基-林口,2024-10-08,9257
4722,國精化,10,0,10,凱基-林口,2024-10-08,9257
8131,福懋科,10,0,10,凱基-林口,2024-10-08,9257
3209,全科,217,9,208,凱基-林口,2024-10-09,9257
6134,萬旭,212,10,202,凱基-林口,2024-10-09,9257
5880,合庫金,150,0,150,凱基-林口,2024-10-09,9257
2486,一詮,122,14,108,凱基-林口,2024-10-09,9257
00688L,國泰20年美債正2,102,15,87,凱基-林口,2024-10-09,9257
00882,中信中國高股息,148,82,66,凱基-林口,2024-10-09,9257
2317,鴻海,113,54,59,凱基-林口,2024-10-09,9257
8112,至上,60,3,57,凱基-林口,2024-10-09,9257
4161,聿新科,78,30,48,凱基-林口,2024-10-09,9257
00830,國泰費城半導體,42,0,42,凱基-林口,2024-10-09,9257
00679B,元大美債20年,37,0,37,凱基-林口,2024-10-09,9257
00687B,國泰20年美債,38,3,35,凱基-林口,2024-10-09,9257
00680L,元大美債20正2,33,0,33,凱基-林口,2024-10-09,9257
00929,復華台灣科技優息,42,10,32,凱基-林口,2024-10-09,9257
1909,榮成,30,0,30,凱基-林口,2024-10-09,9257
2884,玉山金,50,21,29,凱基-林口,2024-10-09,9257
5498,凱崴,28,0,28,凱基-林口,2024-10-09,9257
2493,揚博,26,0,26,凱基-林口,2024-10-09,9257
00637L,元大滬深300正2,42,18,24,凱基-林口,2024-10-09,9257
2888,新光金,33,11,22,凱基-林口,2024-10-09,9257
3062,建漢,23,2,21,凱基-林口,2024-10-09,9257
6118,建達,21,0,21,凱基-林口,2024-10-09,9257
2477,美隆電,20,0,20,凱基-林口,2024-10-09,9257
2610,華航,25,5,20,凱基-林口,2024-10-09,9257
4960,誠美材,20,0,20,凱基-林口,2024-10-09,9257
2363,矽統,122,103,19,凱基-林口,2024-10-09,9257
00731,復華富時高息低波,20,1,19,凱基-林口,2024-10-09,9257
1314,中石化,44,25,19,凱基-林口,2024-10-09,9257
1785,光洋科,19,0,19,凱基-林口,2024-10-09,9257
3706,神達,24,5,19,凱基-林口,2024-10-09,9257
3374,精材,19,1,18,凱基-林口,2024-10-09,9257
6116,彩晶,16,0,16,凱基-林口,2024-10-09,9257
00919,群益台灣精選高息,18,2,16,凱基-林口,2024-10-09,9257
00712,復華富時不動產,15,0,15,凱基-林口,2024-10-09,9257
00936,台新永續高息中小,14,0,14,凱基-林口,2024-10-09,9257
00952,凱基台灣AI50,14,0,14,凱基-林口,2024-10-09,9257
2867,三商壽,14,0,14,凱基-林口,2024-10-09,9257
3523,迎輝,14,0,14,凱基-林口,2024-10-09,9257
2425,承啟,19,6,13,凱基-林口,2024-10-09,9257
5347,世界,13,0,13,凱基-林口,2024-10-09,9257
3048,益登,25,13,12,凱基-林口,2024-10-09,9257
5438,東友,17,5,12,凱基-林口,2024-10-09,9257
8929,富堡,12,0,12,凱基-林口,2024-10-09,9257
2603,長榮,11,0,11,凱基-林口,2024-10-09,9257
00655L,國泰中國A50正2,11,0,11,凱基-林口,2024-10-09,9257
00934,中信成長高股息,11,0,11,凱基-林口,2024-10-09,9257
1301,台塑,13,2,11,凱基-林口,2024-10-09,9257
3710,連展投控,11,0,11,凱基-林口,2024-10-09,9257
6274,台燿,79,68,11,凱基-林口,2024-10-09,9257
8404,百和興業-KY,21,10,11,凱基-林口,2024-10-09,9257
6134,萬旭,176,0,176,凱基-林口,2024-10-11,9257
00637L,元大滬深300正2,154,10,144,凱基-林口,2024-10-11,9257
3209,全科,140,1,139,凱基-林口,2024-10-11,9257
2356,英業達,107,2,105,凱基-林口,2024-10-11,9257
00740B,富邦全球投等債,72,0,72,凱基-林口,2024-10-11,9257
00687B,國泰20年美債,72,2,70,凱基-林口,2024-10-11,9257
4161,聿新科,151,90,61,凱基-林口,2024-10-11,9257
3511,矽瑪,67,7,60,凱基-林口,2024-10-11,9257
6457,紘康,50,0,50,凱基-林口,2024-10-11,9257
2495,普安,48,2,46,凱基-林口,2024-10-11,9257
2363,矽統,123,78,45,凱基-林口,2024-10-11,9257
00632R,元大台灣50反1,40,0,40,凱基-林口,2024-10-11,9257
00680L,元大美債20正2,36,0,36,凱基-林口,2024-10-11,9257
00946,群益科技高息成長,36,1,35,凱基-林口,2024-10-11,9257
2885,元大金,30,0,30,凱基-林口,2024-10-11,9257
00688L,國泰20年美債正2,27,0,27,凱基-林口,2024-10-11,9257
00725B,國泰投資級公司債,22,0,22,凱基-林口,2024-10-11,9257
3447,展達,24,3,21,凱基-林口,2024-10-11,9257
1313,聯成,20,0,20,凱基-林口,2024-10-11,9257
4566,時碩工業,19,0,19,凱基-林口,2024-10-11,9257
8404,百和興業-KY,19,0,19,凱基-林口,2024-10-11,9257
00679B,元大美債20年,29,11,18,凱基-林口,2024-10-11,9257
4927,泰鼎-KY,17,0,17,凱基-林口,2024-10-11,9257
2449,京元電子,27,11,16,凱基-林口,2024-10-11,9257
2834,臺企銀,16,1,15,凱基-林口,2024-10-11,9257
3033,威健,20,5,15,凱基-林口,2024-10-11,9257
0056,元大高股息,15,0,15,凱基-林口,2024-10-11,9257
00929,復華台灣科技優息,23,9,14,凱基-林口,2024-10-11,9257
4306,炎洲,14,0,14,凱基-林口,2024-10-11,9257
8034,榮群,14,0,14,凱基-林口,2024-10-11,9257
00882,中信中國高股息,13,0,13,凱基-林口,2024-10-11,9257
00753L,中信中國50正2,12,0,12,凱基-林口,2024-10-11,9257
5309,系統電,12,0,12,凱基-林口,2024-10-11,9257
00878,國泰永續高股息,19,8,11,凱基-林口,2024-10-11,9257
5443,均豪,15,5,10,凱基-林口,2024-10-11,9257
1536,和大,10,0,10,凱基-林口,2024-10-11,9257
2313,華通,10,0,10,凱基-林口,2024-10-11,9257
2362,藍天,14,4,10,凱基-林口,2024-10-11,9257
2399,映泰,15,5,10,凱基-林口,2024-10-11,9257
2888,新光金,10,0,10,凱基-林口,2024-10-11,9257
3379,彬台,31,21,10,凱基-林口,2024-10-11,9257
9105,泰金寶-DR,10,0,10,凱基-林口,2024-10-11,9257
2316,楠梓電,9,0,9,凱基-林口,2024-10-11,9257
5251,天鉞電,9,0,9,凱基-林口,2024-10-11,9257
8111,立��,17,8,9,凱基-林口,2024-10-11,9257
3037,欣興,9,1,8,凱基-林口,2024-10-11,9257
2890,永豐金,8,0,8,凱基-林口,2024-10-11,9257
1605,華新,7,0,7,凱基-林口,2024-10-11,9257
2354,鴻準,8,1,7,凱基-林口,2024-10-11,9257
00960,野村全球航運龍頭,6,0,6,凱基-林口,2024-10-11,9257
8032,光菱,113,0,113,凱基-林口,2024-10-14,9257
2312,金寶,109,3,106,凱基-林口,2024-10-14,9257
4161,聿新科,167,85,82,凱基-林口,2024-10-14,9257
6148,驊宏資,79,0,79,凱基-林口,2024-10-14,9257
00632R,元大台灣50反1,69,0,69,凱基-林口,2024-10-14,9257
2486,一詮,65,4,61,凱基-林口,2024-10-14,9257
8064,東捷,60,0,60,凱基-林口,2024-10-14,9257
3209,全科,54,0,54,凱基-林口,2024-10-14,9257
00887,永豐中國科技50大,49,0,49,凱基-林口,2024-10-14,9257
00687B,國泰20年美債,49,6,43,凱基-林口,2024-10-14,9257
00637L,元大滬深300正2,84,45,39,凱基-林口,2024-10-14,9257
6457,紘康,35,0,35,凱基-林口,2024-10-14,9257
2845,遠東銀,34,0,34,凱基-林口,2024-10-14,9257
2241,艾姆勒,30,0,30,凱基-林口,2024-10-14,9257
00937B,群益ESG投等債20,26,1,25,凱基-林口,2024-10-14,9257
6134,萬旭,25,2,23,凱基-林口,2024-10-14,9257
00948B,中信優息投資級債,20,0,20,凱基-林口,2024-10-14,9257
00905,FT臺灣Smart,20,0,20,凱基-林口,2024-10-14,9257
9105,泰金寶-DR,20,0,20,凱基-林口,2024-10-14,9257
8404,百和興業-KY,19,0,19,凱基-林口,2024-10-14,9257
0056,元大高股息,20,1,19,凱基-林口,2024-10-14,9257
4977,眾達-KY,24,12,12,凱基-林口,2024-10-14,9257
2618,長榮航,12,0,12,凱基-林口,2024-10-14,9257
2070,精湛,11,0,11,凱基-林口,2024-10-14,9257
1513,中興電,15,5,10,凱基-林口,2024-10-14,9257
00885,富邦越南,10,0,10,凱基-林口,2024-10-14,9257
00877,復華中國5G,10,0,10,凱基-林口,2024-10-14,9257
1714,和桐,10,0,10,凱基-林口,2024-10-14,9257
2543,皇昌,13,3,10,凱基-林口,2024-10-14,9257
3591,艾笛森,10,0,10,凱基-林口,2024-10-14,9257
3615,安可,11,1,10,凱基-林口,2024-10-14,9257
00878,國泰永續高股息,15,5,10,凱基-林口,2024-10-14,9257
00922,國泰台灣領袖50,9,0,9,凱基-林口,2024-10-14,9257
2493,揚博,12,3,9,凱基-林口,2024-10-14,9257
3324,雙鴻,12,3,9,凱基-林口,2024-10-14,9257
2101,南港,8,0,8,凱基-林口,2024-10-14,9257
3564,其陽,9,1,8,凱基-林口,2024-10-14,9257
1294,漢田生技,9,1,8,凱基-林口,2024-10-14,9257
2615,萬海,14,6,8,凱基-林口,2024-10-14,9257
5871,中租-KY,10,3,7,凱基-林口,2024-10-14,9257
00725B,國泰投資級公司債,7,0,7,凱基-林口,2024-10-14,9257
2324,仁寶,7,0,7,凱基-林口,2024-10-14,9257
2467,志聖,10,4,6,凱基-林口,2024-10-14,9257
00915,凱基優選高股息30,6,0,6,凱基-林口,2024-10-14,9257
00713,元大台灣高息低波,7,1,6,凱基-林口,2024-10-14,9257
3339,泰谷,13,7,6,凱基-林口,2024-10-14,9257
3715,定穎投控,10,4,6,凱基-林口,2024-10-14,9257
00795B,中信美國公債20年,5,0,5,凱基-林口,2024-10-14,9257
00753L,中信中國50正2,10,5,5,凱基-林口,2024-10-14,9257
00700,富邦�琤肭磪�,5,0,5,凱基-林口,2024-10-14,9257
00680L,元大美債20正2,731,0,731,凱基-林口,2024-10-15,9257
3162,精確,100,0,100,凱基-林口,2024-10-15,9257
6156,松上,99,16,83,凱基-林口,2024-10-15,9257
00961,FT臺灣永續高息,82,0,82,凱基-林口,2024-10-15,9257
6224,聚鼎,72,1,71,凱基-林口,2024-10-15,9257
00715L,期街口布蘭特正2,55,0,55,凱基-林口,2024-10-15,9257
8070,長華*,57,2,55,凱基-林口,2024-10-15,9257
00935,野村臺灣新科技50,50,1,49,凱基-林口,2024-10-15,9257
2312,金寶,45,6,39,凱基-林口,2024-10-15,9257
00632R,元大台灣50反1,45,9,36,凱基-林口,2024-10-15,9257
3062,建漢,72,36,36,凱基-林口,2024-10-15,9257
00919,群益台灣精選高息,39,5,34,凱基-林口,2024-10-15,9257
00720B,元大投資級公司債,34,0,34,凱基-林口,2024-10-15,9257
2543,皇昌,34,1,33,凱基-林口,2024-10-15,9257
00887,永豐中國科技50大,37,6,31,凱基-林口,2024-10-15,9257
2241,艾姆勒,42,11,31,凱基-林口,2024-10-15,9257
1316,上曜,30,0,30,凱基-林口,2024-10-15,9257
00753L,中信中國50正2,54,25,29,凱基-林口,2024-10-15,9257
2845,遠東銀,25,0,25,凱基-林口,2024-10-15,9257
00725B,國泰投資級公司債,25,0,25,凱基-林口,2024-10-15,9257
3209,全科,25,0,25,凱基-林口,2024-10-15,9257
2887,台新金,25,0,25,凱基-林口,2024-10-15,9257
6148,驊宏資,23,0,23,凱基-林口,2024-10-15,9257
00946,群益科技高息成長,22,1,21,凱基-林口,2024-10-15,9257
2323,中環,26,5,21,凱基-林口,2024-10-15,9257
1314,中石化,36,18,18,凱基-林口,2024-10-15,9257
00929,復華台灣科技優息,30,12,18,凱基-林口,2024-10-15,9257
4915,致伸,17,0,17,凱基-林口,2024-10-15,9257
4161,聿新科,61,45,16,凱基-林口,2024-10-15,9257
8046,南電,16,0,16,凱基-林口,2024-10-15,9257
00687B,國泰20年美債,11,0,11,凱基-林口,2024-10-15,9257
2605,新興,11,0,11,凱基-林口,2024-10-15,9257
1444,力麗,11,0,11,凱基-林口,2024-10-15,9257
3033,威健,20,9,11,凱基-林口,2024-10-15,9257
3354,律勝,11,0,11,凱基-林口,2024-10-15,9257
1313,聯成,10,0,10,凱基-林口,2024-10-15,9257
2349,錸德,11,1,10,凱基-林口,2024-10-15,9257
2801,彰銀,10,0,10,凱基-林口,2024-10-15,9257
5452,佶優,19,9,10,凱基-林口,2024-10-15,9257
6191,精成科,10,0,10,凱基-林口,2024-10-15,9257
1240,茂生農經,9,0,9,凱基-林口,2024-10-15,9257
1301,台塑,12,3,9,凱基-林口,2024-10-15,9257
1595,川寶,22,13,9,凱基-林口,2024-10-15,9257
2610,華航,10,1,9,凱基-林口,2024-10-15,9257
3257,虹冠電,20,11,9,凱基-林口,2024-10-15,9257
5538,東明-KY,9,0,9,凱基-林口,2024-10-15,9257
3149,正達,28,20,8,凱基-林口,2024-10-15,9257
00936,台新永續高息中小,8,0,8,凱基-林口,2024-10-15,9257
1734,杏輝,7,0,7,凱基-林口,2024-10-15,9257
1513,中興電,8,2,6,凱基-林口,2024-10-15,9257
00680L,元大美債20正2,240,10,230,凱基-林口,2024-10-16,9257
2915,潤泰全,200,2,198,凱基-林口,2024-10-16,9257
6156,松上,115,0,115,凱基-林口,2024-10-16,9257
3162,精確,109,23,86,凱基-林口,2024-10-16,9257
0056,元大高股息,71,8,63,凱基-林口,2024-10-16,9257
2312,金寶,86,35,51,凱基-林口,2024-10-16,9257
6609,瀧澤科,108,60,48,凱基-林口,2024-10-16,9257
6224,聚鼎,41,0,41,凱基-林口,2024-10-16,9257
8021,尖點,41,2,39,凱基-林口,2024-10-16,9257
00927,群益半導體收益,36,0,36,凱基-林口,2024-10-16,9257
00887,永豐中國科技50大,34,0,34,凱基-林口,2024-10-16,9257
00882,中信中國高股息,126,100,26,凱基-林口,2024-10-16,9257
00945B,凱基美國非投等債,25,0,25,凱基-林口,2024-10-16,9257
00922,國泰台灣領袖50,37,13,24,凱基-林口,2024-10-16,9257
8240,華宏,23,0,23,凱基-林口,2024-10-16,9257
2317,鴻海,52,29,23,凱基-林口,2024-10-16,9257
00637L,元大滬深300正2,82,61,21,凱基-林口,2024-10-16,9257
1785,光洋科,20,0,20,凱基-林口,2024-10-16,9257
00912,中信臺灣智慧50,18,0,18,凱基-林口,2024-10-16,9257
3687,歐買尬,18,0,18,凱基-林口,2024-10-16,9257
6821,聯寶,18,2,16,凱基-林口,2024-10-16,9257
2834,臺企銀,15,0,15,凱基-林口,2024-10-16,9257
0050,元大台灣50,16,1,15,凱基-林口,2024-10-16,9257
00830,國泰費城半導體,17,3,14,凱基-林口,2024-10-16,9257
2609,陽明,13,0,13,凱基-林口,2024-10-16,9257
2363,矽統,19,6,13,凱基-林口,2024-10-16,9257
2344,華邦電,12,0,12,凱基-林口,2024-10-16,9257
2002,中鋼,11,0,11,凱基-林口,2024-10-16,9257
2641,正德,11,0,11,凱基-林口,2024-10-16,9257
00713,元大台灣高息低波,11,0,11,凱基-林口,2024-10-16,9257
2241,艾姆勒,20,10,10,凱基-林口,2024-10-16,9257
6449,鈺邦,10,0,10,凱基-林口,2024-10-16,9257
00757,統一FANG+,10,0,10,凱基-林口,2024-10-16,9257
6188,廣明,13,3,10,凱基-林口,2024-10-16,9257
2062,橋椿,10,0,10,凱基-林口,2024-10-16,9257
2498,宏達電,10,0,10,凱基-林口,2024-10-16,9257
3591,艾笛森,10,0,10,凱基-林口,2024-10-16,9257
3450,聯鈞,16,7,9,凱基-林口,2024-10-16,9257
00905,FT臺灣Smart,20,11,9,凱基-林口,2024-10-16,9257
6274,台燿,9,0,9,凱基-林口,2024-10-16,9257
6770,力積電,9,0,9,凱基-林口,2024-10-16,9257
2888,新光金,8,0,8,凱基-林口,2024-10-16,9257
1904,正隆,8,0,8,凱基-林口,2024-10-16,9257
2374,佳能,8,0,8,凱基-林口,2024-10-16,9257
2543,皇昌,46,38,8,凱基-林口,2024-10-16,9257
2883,凱基金,13,5,8,凱基-林口,2024-10-16,9257
3710,連展投控,12,4,8,凱基-林口,2024-10-16,9257
6215,和椿,9,2,7,凱基-林口,2024-10-16,9257
1609,大亞,7,0,7,凱基-林口,2024-10-16,9257
8255,朋程,7,0,7,凱基-林口,2024-10-16,9257
2312,金寶,505,170,335,凱基-林口,2024-10-17,9257
00687B,國泰20年美債,200,1,199,凱基-林口,2024-10-17,9257
6156,松上,104,1,103,凱基-林口,2024-10-17,9257
0056,元大高股息,67,0,67,凱基-林口,2024-10-17,9257
4979,華星光,71,5,66,凱基-林口,2024-10-17,9257
00887,永豐中國科技50大,56,0,56,凱基-林口,2024-10-17,9257
8070,長華*,57,1,56,凱基-林口,2024-10-17,9257
2543,皇昌,62,11,51,凱基-林口,2024-10-17,9257
00905,FT臺灣Smart,50,0,50,凱基-林口,2024-10-17,9257
6125,廣運,52,13,39,凱基-林口,2024-10-17,9257
2374,佳能,58,24,34,凱基-林口,2024-10-17,9257
6224,聚鼎,31,0,31,凱基-林口,2024-10-17,9257
4161,聿新科,30,0,30,凱基-林口,2024-10-17,9257
00922,國泰台灣領袖50,27,0,27,凱基-林口,2024-10-17,9257
3260,威剛,27,0,27,凱基-林口,2024-10-17,9257
00885,富邦越南,26,0,26,凱基-林口,2024-10-17,9257
4903,聯光通,37,11,26,凱基-林口,2024-10-17,9257
3031,佰鴻,30,5,25,凱基-林口,2024-10-17,9257
00919,群益台灣精選高息,25,1,24,凱基-林口,2024-10-17,9257
2399,映泰,131,111,20,凱基-林口,2024-10-17,9257
5521,工信,20,0,20,凱基-林口,2024-10-17,9257
3231,緯創,32,14,18,凱基-林口,2024-10-17,9257
1528,恩德,79,62,17,凱基-林口,2024-10-17,9257
9105,泰金寶-DR,20,4,16,凱基-林口,2024-10-17,9257
2481,強茂,14,0,14,凱基-林口,2024-10-17,9257
6277,宏正,12,0,12,凱基-林口,2024-10-17,9257
8240,華宏,15,3,12,凱基-林口,2024-10-17,9257
6147,頎邦,11,0,11,凱基-林口,2024-10-17,9257
6197,佳必琪,11,0,11,凱基-林口,2024-10-17,9257
8040,九暘,11,0,11,凱基-林口,2024-10-17,9257
00946,群益科技高息成長,10,0,10,凱基-林口,2024-10-17,9257
00700,富邦�琤肭磪�,10,0,10,凱基-林口,2024-10-17,9257
00719B,元大美債1-3,10,0,10,凱基-林口,2024-10-17,9257
2340,台亞,10,0,10,凱基-林口,2024-10-17,9257
2421,建準,13,3,10,凱基-林口,2024-10-17,9257
2611,志信,10,0,10,凱基-林口,2024-10-17,9257
3011,今皓,10,0,10,凱基-林口,2024-10-17,9257
3413,京鼎,10,0,10,凱基-林口,2024-10-17,9257
6443,元晶,10,0,10,凱基-林口,2024-10-17,9257
6658,聯策,13,3,10,凱基-林口,2024-10-17,9257
6757,台灣虎航,10,0,10,凱基-林口,2024-10-17,9257
8085,福華,10,0,10,凱基-林口,2024-10-17,9257
2303,聯電,12,2,10,凱基-林口,2024-10-17,9257
00951,台新日本半導體,13,4,9,凱基-林口,2024-10-17,9257
6706,惠特,10,1,9,凱基-林口,2024-10-17,9257
0050,元大台灣50,8,0,8,凱基-林口,2024-10-17,9257
1413,宏洲,8,0,8,凱基-林口,2024-10-17,9257
6116,彩晶,9,1,8,凱基-林口,2024-10-17,9257
00907,永豐優息存股,10,3,7,凱基-林口,2024-10-17,9257
4542,科嶠,8,1,7,凱基-林口,2024-10-17,9257
6156,松上,226,3,223,凱基-林口,2024-10-18,9257
2317,鴻海,222,34,188,凱基-林口,2024-10-18,9257
00687B,國泰20年美債,134,0,134,凱基-林口,2024-10-18,9257
00637L,元大滬深300正2,131,5,126,凱基-林口,2024-10-18,9257
00937B,群益ESG投等債20,83,0,83,凱基-林口,2024-10-18,9257
00948B,中信優息投資級債,62,0,62,凱基-林口,2024-10-18,9257
4161,聿新科,77,15,62,凱基-林口,2024-10-18,9257
00679B,元大美債20年,54,0,54,凱基-林口,2024-10-18,9257
3062,建漢,44,1,43,凱基-林口,2024-10-18,9257
3484,崧騰,42,0,42,凱基-林口,2024-10-18,9257
00671R,富邦NASDAQ反1,40,0,40,凱基-林口,2024-10-18,9257
00680L,元大美債20正2,36,0,36,凱基-林口,2024-10-18,9257
00633L,富邦上証正2,30,0,30,凱基-林口,2024-10-18,9257
2421,建準,33,5,28,凱基-林口,2024-10-18,9257
8028,昇陽半導體,78,51,27,凱基-林口,2024-10-18,9257
2845,遠東銀,26,0,26,凱基-林口,2024-10-18,9257
5347,世界,30,5,25,凱基-林口,2024-10-18,9257
4903,聯光通,24,1,23,凱基-林口,2024-10-18,9257
2402,毅嘉,29,7,22,凱基-林口,2024-10-18,9257
3710,連展投控,22,0,22,凱基-林口,2024-10-18,9257
00946,群益科技高息成長,21,0,21,凱基-林口,2024-10-18,9257
1314,中石化,34,13,21,凱基-林口,2024-10-18,9257
00887,永豐中國科技50大,21,0,21,凱基-林口,2024-10-18,9257
8070,長華*,20,0,20,凱基-林口,2024-10-18,9257
00693U,期街口S＆P黃豆,20,0,20,凱基-林口,2024-10-18,9257
00632R,元大台灣50反1,20,0,20,凱基-林口,2024-10-18,9257
3290,東浦,22,2,20,凱基-林口,2024-10-18,9257
2356,英業達,23,5,18,凱基-林口,2024-10-18,9257
6125,廣運,17,0,17,凱基-林口,2024-10-18,9257
0056,元大高股息,22,7,15,凱基-林口,2024-10-18,9257
00932,兆豐永續高息等權,15,0,15,凱基-林口,2024-10-18,9257
3049,精金,15,0,15,凱基-林口,2024-10-18,9257
6799,來頡,15,0,15,凱基-林口,2024-10-18,9257
00933B,國泰10Y+金融債,13,0,13,凱基-林口,2024-10-18,9257
00940,元大台灣價值高息,24,11,13,凱基-林口,2024-10-18,9257
3030,德律,12,0,12,凱基-林口,2024-10-18,9257
3060,銘異,13,1,12,凱基-林口,2024-10-18,9257
1503,士電,13,1,12,凱基-林口,2024-10-18,9257
3231,緯創,17,5,12,凱基-林口,2024-10-18,9257
00929,復華台灣科技優息,42,32,10,凱基-林口,2024-10-18,9257
2489,瑞軒,10,0,10,凱基-林口,2024-10-18,9257
2439,美律,10,0,10,凱基-林口,2024-10-18,9257
00752,中信中國50,10,0,10,凱基-林口,2024-10-18,9257
00905,FT臺灣Smart,10,0,10,凱基-林口,2024-10-18,9257
2354,鴻準,10,0,10,凱基-林口,2024-10-18,9257
2493,揚博,10,0,10,凱基-林口,2024-10-18,9257
2605,新興,11,1,10,凱基-林口,2024-10-18,9257
6757,台灣虎航,10,0,10,凱基-林口,2024-10-18,9257
8111,立��,11,1,10,凱基-林口,2024-10-18,9257
00891,中信關鍵半導體,10,1,9,凱基-林口,2024-10-18,9257
2312,金寶,277,9,268,凱基-林口,2024-10-21,9257
00937B,群益ESG投等債20,98,7,91,凱基-林口,2024-10-21,9257
3710,連展投控,85,1,84,凱基-林口,2024-10-21,9257
00720B,元大投資級公司債,66,0,66,凱基-林口,2024-10-21,9257
00715L,期街口布蘭特正2,53,0,53,凱基-林口,2024-10-21,9257
4576,大銀微系統,83,31,52,凱基-林口,2024-10-21,9257
6425,易發,55,11,44,凱基-林口,2024-10-21,9257
00687B,國泰20年美債,43,0,43,凱基-林口,2024-10-21,9257
3209,全科,40,1,39,凱基-林口,2024-10-21,9257
00929,復華台灣科技優息,45,7,38,凱基-林口,2024-10-21,9257
2891,中信金,35,0,35,凱基-林口,2024-10-21,9257
00688L,國泰20年美債正2,30,0,30,凱基-林口,2024-10-21,9257
4561,健椿,34,5,29,凱基-林口,2024-10-21,9257
00830,國泰費城半導體,29,0,29,凱基-林口,2024-10-21,9257
1727,中華化,30,1,29,凱基-林口,2024-10-21,9257
00637L,元大滬深300正2,37,12,25,凱基-林口,2024-10-21,9257
2520,冠德,25,0,25,凱基-林口,2024-10-21,9257
00662,富邦NASDAQ,22,0,22,凱基-林口,2024-10-21,9257
6658,聯策,20,0,20,凱基-林口,2024-10-21,9257
00878,國泰永續高股息,26,7,19,凱基-林口,2024-10-21,9257
2002,中鋼,15,0,15,凱基-林口,2024-10-21,9257
00933B,國泰10Y+金融債,13,0,13,凱基-林口,2024-10-21,9257
0056,元大高股息,15,2,13,凱基-林口,2024-10-21,9257
4510,高鋒,16,4,12,凱基-林口,2024-10-21,9257
6763,綠界科技*,12,1,11,凱基-林口,2024-10-21,9257
2356,英業達,13,2,11,凱基-林口,2024-10-21,9257
3027,盛達,11,0,11,凱基-林口,2024-10-21,9257
00942B,台新美A公司債20+,11,0,11,凱基-林口,2024-10-21,9257
00905,FT臺灣Smart,10,0,10,凱基-林口,2024-10-21,9257
00753L,中信中國50正2,21,11,10,凱基-林口,2024-10-21,9257
00945B,凱基美國非投等債,10,0,10,凱基-林口,2024-10-21,9257
6151,晉倫,10,0,10,凱基-林口,2024-10-21,9257
6285,啟��,10,0,10,凱基-林口,2024-10-21,9257
00670L,富邦NASDAQ正2,9,0,9,凱基-林口,2024-10-21,9257
00639,富邦深100,10,1,9,凱基-林口,2024-10-21,9257
2885,元大金,9,0,9,凱基-林口,2024-10-21,9257
3591,艾笛森,10,1,9,凱基-林口,2024-10-21,9257
2890,永豐金,8,0,8,凱基-林口,2024-10-21,9257
3062,建漢,11,3,8,凱基-林口,2024-10-21,9257
00952,凱基台灣AI50,8,0,8,凱基-林口,2024-10-21,9257
2412,中華電,8,0,8,凱基-林口,2024-10-21,9257
2882,國泰金,8,0,8,凱基-林口,2024-10-21,9257
3704,合勤控,8,0,8,凱基-林口,2024-10-21,9257
2881,富邦金,8,0,8,凱基-林口,2024-10-21,9257
1540,喬福,9,2,7,凱基-林口,2024-10-21,9257
2402,毅嘉,7,0,7,凱基-林口,2024-10-21,9257
3230,錦明,7,0,7,凱基-林口,2024-10-21,9257
3379,彬台,7,0,7,凱基-林口,2024-10-21,9257
8069,元太,11,4,7,凱基-林口,2024-10-21,9257
2303,聯電,12,6,6,凱基-林口,2024-10-21,9257
2312,金寶,156,4,152,凱基-林口,2024-10-22,9257
00948B,中信優息投資級債,141,0,141,凱基-林口,2024-10-22,9257
6156,松上,120,0,120,凱基-林口,2024-10-22,9257
00687B,國泰20年美債,109,0,109,凱基-林口,2024-10-22,9257
00679B,元大美債20年,110,18,92,凱基-林口,2024-10-22,9257
2486,一詮,80,2,78,凱基-林口,2024-10-22,9257
00688L,國泰20年美債正2,54,2,52,凱基-林口,2024-10-22,9257
00720B,元大投資級公司債,73,31,42,凱基-林口,2024-10-22,9257
4561,健椿,35,0,35,凱基-林口,2024-10-22,9257
00905,FT臺灣Smart,30,0,30,凱基-林口,2024-10-22,9257
6609,瀧澤科,30,0,30,凱基-林口,2024-10-22,9257
00878,國泰永續高股息,30,2,28,凱基-林口,2024-10-22,9257
2382,廣達,68,41,27,凱基-林口,2024-10-22,9257
2363,矽統,77,54,23,凱基-林口,2024-10-22,9257
2888,新光金,21,0,21,凱基-林口,2024-10-22,9257
2303,聯電,21,2,19,凱基-林口,2024-10-22,9257
2313,華通,18,0,18,凱基-林口,2024-10-22,9257
2002,中鋼,17,0,17,凱基-林口,2024-10-22,9257
3710,連展投控,18,1,17,凱基-林口,2024-10-22,9257
4716,大立,20,6,14,凱基-林口,2024-10-22,9257
5443,均豪,14,1,13,凱基-林口,2024-10-22,9257
00951,台新日本半導體,13,0,13,凱基-林口,2024-10-22,9257
8064,東捷,14,1,13,凱基-林口,2024-10-22,9257
00706L,期元大S＆P日圓正2,12,0,12,凱基-林口,2024-10-22,9257
00959B,大華投等美債15Y+,12,0,12,凱基-林口,2024-10-22,9257
1714,和桐,12,0,12,凱基-林口,2024-10-22,9257
5907,大洋-KY,12,0,12,凱基-林口,2024-10-22,9257
6425,易發,12,0,12,凱基-林口,2024-10-22,9257
6506,雙邦,15,3,12,凱基-林口,2024-10-22,9257
00772B,中信高評級公司債,11,0,11,凱基-林口,2024-10-22,9257
2399,映泰,19,8,11,凱基-林口,2024-10-22,9257
3551,世禾,85,74,11,凱基-林口,2024-10-22,9257
8249,菱光,12,1,11,凱基-林口,2024-10-22,9257
00942B,台新美A公司債20+,10,0,10,凱基-林口,2024-10-22,9257
00924,復華S＆P500成長,10,0,10,凱基-林口,2024-10-22,9257
00753L,中信中國50正2,134,124,10,凱基-林口,2024-10-22,9257
2547,日勝生,10,0,10,凱基-林口,2024-10-22,9257
4161,聿新科,10,0,10,凱基-林口,2024-10-22,9257
00712,復華富時不動產,10,0,10,凱基-林口,2024-10-22,9257
6285,啟��,10,1,9,凱基-林口,2024-10-22,9257
8240,華宏,9,0,9,凱基-林口,2024-10-22,9257
00895,富邦未來車,8,0,8,凱基-林口,2024-10-22,9257
00639,富邦深100,7,0,7,凱基-林口,2024-10-22,9257
00725B,國泰投資級公司債,7,0,7,凱基-林口,2024-10-22,9257
2010,春源,7,0,7,凱基-林口,2024-10-22,9257
2461,光群雷,7,0,7,凱基-林口,2024-10-22,9257
3011,今皓,12,5,7,凱基-林口,2024-10-22,9257
3272,東碩,7,0,7,凱基-林口,2024-10-22,9257
2330,台積電,6,0,6,凱基-林口,2024-10-22,9257
3003,健和興,6,0,6,凱基-林口,2024-10-22,9257
00938,凱基優選30,233,0,233,凱基-林口,2024-10-23,9257
3209,全科,191,1,190,凱基-林口,2024-10-23,9257
00665L,富邦�琤肭磪囓�2,150,0,150,凱基-林口,2024-10-23,9257
5386,青雲,99,10,89,凱基-林口,2024-10-23,9257
2312,金寶,94,9,85,凱基-林口,2024-10-23,9257
00878,國泰永續高股息,63,1,62,凱基-林口,2024-10-23,9257
3141,晶宏,60,0,60,凱基-林口,2024-10-23,9257
00937B,群益ESG投等債20,55,0,55,凱基-林口,2024-10-23,9257
00948B,中信優息投資級債,43,0,43,凱基-林口,2024-10-23,9257
2382,廣達,44,9,35,凱基-林口,2024-10-23,9257
6763,綠界科技*,32,0,32,凱基-林口,2024-10-23,9257
2367,燿華,30,0,30,凱基-林口,2024-10-23,9257
2913,農林,30,0,30,凱基-林口,2024-10-23,9257
1314,中石化,28,0,28,凱基-林口,2024-10-23,9257
2329,華泰,45,19,26,凱基-林口,2024-10-23,9257
1595,川寶,35,10,25,凱基-林口,2024-10-23,9257
00919,群益台灣精選高息,24,2,22,凱基-林口,2024-10-23,9257
00887,永豐中國科技50大,21,0,21,凱基-林口,2024-10-23,9257
2070,精湛,21,0,21,凱基-林口,2024-10-23,9257
00882,中信中國高股息,20,0,20,凱基-林口,2024-10-23,9257
00643,群益深証中小,20,0,20,凱基-林口,2024-10-23,9257
2886,兆豐金,17,0,17,凱基-林口,2024-10-23,9257
3580,友威科,20,3,17,凱基-林口,2024-10-23,9257
00679B,元大美債20年,17,0,17,凱基-林口,2024-10-23,9257
00687B,國泰20年美債,19,3,16,凱基-林口,2024-10-23,9257
4161,聿新科,30,14,16,凱基-林口,2024-10-23,9257
0056,元大高股息,26,10,16,凱基-林口,2024-10-23,9257
2464,盟立,19,4,15,凱基-林口,2024-10-23,9257
3594,磐儀,15,0,15,凱基-林口,2024-10-23,9257
5356,協益,20,5,15,凱基-林口,2024-10-23,9257
00885,富邦越南,16,2,14,凱基-林口,2024-10-23,9257
00959B,大華投等美債15Y+,13,0,13,凱基-林口,2024-10-23,9257
3481,群創,54,42,12,凱基-林口,2024-10-23,9257
00950B,凱基A級公司債,12,0,12,凱基-林口,2024-10-23,9257
3550,聯穎,12,0,12,凱基-林口,2024-10-23,9257
6151,晉倫,37,25,12,凱基-林口,2024-10-23,9257
00907,永豐優息存股,11,0,11,凱基-林口,2024-10-23,9257
2834,臺企銀,10,0,10,凱基-林口,2024-10-23,9257
00933B,國泰10Y+金融債,10,0,10,凱基-林口,2024-10-23,9257
2323,中環,11,1,10,凱基-林口,2024-10-23,9257
2538,基泰,10,0,10,凱基-林口,2024-10-23,9257
4711,永純,10,0,10,凱基-林口,2024-10-23,9257
5488,松普,10,0,10,凱基-林口,2024-10-23,9257
6288,聯嘉,10,0,10,凱基-林口,2024-10-23,9257
3663,鑫科,20,10,10,凱基-林口,2024-10-23,9257
2303,聯電,21,12,9,凱基-林口,2024-10-23,9257
2313,華通,12,3,9,凱基-林口,2024-10-23,9257
3011,今皓,10,1,9,凱基-林口,2024-10-23,9257
00725B,國泰投資級公司債,8,0,8,凱基-林口,2024-10-23,9257
00857B,永豐20年美公債,7,0,7,凱基-林口,2024-10-23,9257
3209,全科,190,22,168,凱基-林口,2024-10-24,9257
2388,威盛,101,6,95,凱基-林口,2024-10-24,9257
0056,元大高股息,91,0,91,凱基-林口,2024-10-24,9257
00679B,元大美債20年,88,0,88,凱基-林口,2024-10-24,9257
00882,中信中國高股息,69,0,69,凱基-林口,2024-10-24,9257
00915,凱基優選高股息30,108,40,68,凱基-林口,2024-10-24,9257
00753L,中信中國50正2,86,18,68,凱基-林口,2024-10-24,9257
00720B,元大投資級公司債,64,0,64,凱基-林口,2024-10-24,9257
3516,亞帝歐,60,0,60,凱基-林口,2024-10-24,9257
4716,大立,70,10,60,凱基-林口,2024-10-24,9257
00948B,中信優息投資級債,58,0,58,凱基-林口,2024-10-24,9257
6742,澤米,48,0,48,凱基-林口,2024-10-24,9257
3430,奇鈦科,45,0,45,凱基-林口,2024-10-24,9257
00878,國泰永續高股息,40,1,39,凱基-林口,2024-10-24,9257
4909,新復興,40,3,37,凱基-林口,2024-10-24,9257
00637L,元大滬深300正2,35,0,35,凱基-林口,2024-10-24,9257
00929,復華台灣科技優息,45,10,35,凱基-林口,2024-10-24,9257
6763,綠界科技*,35,4,31,凱基-林口,2024-10-24,9257
2303,聯電,32,2,30,凱基-林口,2024-10-24,9257
2312,金寶,63,34,29,凱基-林口,2024-10-24,9257
00905,FT臺灣Smart,28,0,28,凱基-林口,2024-10-24,9257
00687B,國泰20年美債,31,3,28,凱基-林口,2024-10-24,9257
1528,恩德,29,2,27,凱基-林口,2024-10-24,9257
4161,聿新科,27,0,27,凱基-林口,2024-10-24,9257
2929,淘帝-KY,31,5,26,凱基-林口,2024-10-24,9257
6546,正基,25,0,25,凱基-林口,2024-10-24,9257
8064,東捷,28,3,25,凱基-林口,2024-10-24,9257
00887,永豐中國科技50大,24,0,24,凱基-林口,2024-10-24,9257
4563,百德,20,0,20,凱基-林口,2024-10-24,9257
3615,安可,36,16,20,凱基-林口,2024-10-24,9257
5425,台半,19,0,19,凱基-林口,2024-10-24,9257
6596,寬宏藝術,19,0,19,凱基-林口,2024-10-24,9257
00919,群益台灣精選高息,22,4,18,凱基-林口,2024-10-24,9257
006208,富邦台50,20,2,18,凱基-林口,2024-10-24,9257
00662,富邦NASDAQ,17,0,17,凱基-林口,2024-10-24,9257
4722,國精化,17,0,17,凱基-林口,2024-10-24,9257
00918,大華優利高填息30,21,5,16,凱基-林口,2024-10-24,9257
2329,華泰,19,3,16,凱基-林口,2024-10-24,9257
6288,聯嘉,15,0,15,凱基-林口,2024-10-24,9257
2440,太空梭,14,0,14,凱基-林口,2024-10-24,9257
00937B,群益ESG投等債20,25,12,13,凱基-林口,2024-10-24,9257
2891,中信金,13,0,13,凱基-林口,2024-10-24,9257
3037,欣興,23,10,13,凱基-林口,2024-10-24,9257
2382,廣達,26,14,12,凱基-林口,2024-10-24,9257
00680L,元大美債20正2,12,0,12,凱基-林口,2024-10-24,9257
1301,台塑,17,5,12,凱基-林口,2024-10-24,9257
3581,博磊,26,14,12,凱基-林口,2024-10-24,9257
9958,世紀鋼,12,0,12,凱基-林口,2024-10-24,9257
2421,建準,12,0,12,凱基-林口,2024-10-24,9257
3481,群創,51,40,11,凱基-林口,2024-10-24,9257
00680L,元大美債20正2,201,47,154,凱基-林口,2024-10-25,9257
6156,松上,89,0,89,凱基-林口,2024-10-25,9257
6285,啟��,89,3,86,凱基-林口,2024-10-25,9257
00720B,元大投資級公司債,84,0,84,凱基-林口,2024-10-25,9257
2495,普安,88,16,72,凱基-林口,2024-10-25,9257
3615,安可,78,28,50,凱基-林口,2024-10-25,9257
6229,研通,40,1,39,凱基-林口,2024-10-25,9257
00715L,期街口布蘭特正2,35,0,35,凱基-林口,2024-10-25,9257
3715,定穎投控,36,3,33,凱基-林口,2024-10-25,9257
00882,中信中國高股息,31,2,29,凱基-林口,2024-10-25,9257
6546,正基,25,0,25,凱基-林口,2024-10-25,9257
9105,泰金寶-DR,30,5,25,凱基-林口,2024-10-25,9257
2303,聯電,22,0,22,凱基-林口,2024-10-25,9257
00753L,中信中國50正2,25,3,22,凱基-林口,2024-10-25,9257
4161,聿新科,20,0,20,凱基-林口,2024-10-25,9257
5356,協益,18,0,18,凱基-林口,2024-10-25,9257
00959B,大華投等美債15Y+,17,0,17,凱基-林口,2024-10-25,9257
00639,富邦深100,16,0,16,凱基-林口,2024-10-25,9257
3710,連展投控,32,16,16,凱基-林口,2024-10-25,9257
2891,中信金,13,0,13,凱基-林口,2024-10-25,9257
00679B,元大美債20年,32,20,12,凱基-林口,2024-10-25,9257
2362,藍天,16,5,11,凱基-林口,2024-10-25,9257
3163,波若威,10,0,10,凱基-林口,2024-10-25,9257
3260,威剛,10,0,10,凱基-林口,2024-10-25,9257
3372,典範,12,2,10,凱基-林口,2024-10-25,9257
5328,華容,10,0,10,凱基-林口,2024-10-25,9257
8110,華東,10,0,10,凱基-林口,2024-10-25,9257
3376,新日興,10,0,10,凱基-林口,2024-10-25,9257
2324,仁寶,10,0,10,凱基-林口,2024-10-25,9257
5263,智崴,15,6,9,凱基-林口,2024-10-25,9257
1815,富喬,9,0,9,凱基-林口,2024-10-25,9257
2477,美隆電,10,1,9,凱基-林口,2024-10-25,9257
2834,臺企銀,10,1,9,凱基-林口,2024-10-25,9257
6596,寬宏藝術,9,0,9,凱基-林口,2024-10-25,9257
00905,FT臺灣Smart,8,0,8,凱基-林口,2024-10-25,9257
1721,三晃,12,4,8,凱基-林口,2024-10-25,9257
4190,佐登-KY,8,0,8,凱基-林口,2024-10-25,9257
6770,力積電,13,5,8,凱基-林口,2024-10-25,9257
2440,太空梭,9,2,7,凱基-林口,2024-10-25,9257
3058,立德,7,0,7,凱基-林口,2024-10-25,9257
3285,微端,7,0,7,凱基-林口,2024-10-25,9257
3535,晶彩科,7,0,7,凱基-林口,2024-10-25,9257
6278,台表科,12,5,7,凱基-林口,2024-10-25,9257
8227,巨有科技,8,1,7,凱基-林口,2024-10-25,9257
8404,百和興業-KY,7,0,7,凱基-林口,2024-10-25,9257
00922,國泰台灣領袖50,6,0,6,凱基-林口,2024-10-25,9257
2369,菱生,6,0,6,凱基-林口,2024-10-25,9257
2845,遠東銀,6,0,6,凱基-林口,2024-10-25,9257
2888,新光金,6,0,6,凱基-林口,2024-10-25,9257
3666,光耀,6,0,6,凱基-林口,2024-10-25,9257
2486,一詮,165,28,137,凱基-林口,2024-10-28,9257
9105,泰金寶-DR,92,1,91,凱基-林口,2024-10-28,9257
3167,大量,85,5,80,凱基-林口,2024-10-28,9257
00720B,元大投資級公司債,75,0,75,凱基-林口,2024-10-28,9257
00753L,中信中國50正2,58,17,41,凱基-林口,2024-10-28,9257
00830,國泰費城半導體,40,0,40,凱基-林口,2024-10-28,9257
00715L,期街口布蘭特正2,44,5,39,凱基-林口,2024-10-28,9257
00637L,元大滬深300正2,36,0,36,凱基-林口,2024-10-28,9257
6134,萬旭,35,0,35,凱基-林口,2024-10-28,9257
00688L,國泰20年美債正2,40,10,30,凱基-林口,2024-10-28,9257
00671R,富邦NASDAQ反1,30,0,30,凱基-林口,2024-10-28,9257
4527,方土霖,30,1,29,凱基-林口,2024-10-28,9257
3209,全科,27,0,27,凱基-林口,2024-10-28,9257
2302,麗正,41,20,21,凱基-林口,2024-10-28,9257
3014,聯陽,21,0,21,凱基-林口,2024-10-28,9257
1416,廣豐,20,0,20,凱基-林口,2024-10-28,9257
1708,東鹼,20,0,20,凱基-林口,2024-10-28,9257
00948B,中信優息投資級債,18,0,18,凱基-林口,2024-10-28,9257
2303,聯電,16,0,16,凱基-林口,2024-10-28,9257
00959B,大華投等美債15Y+,16,0,16,凱基-林口,2024-10-28,9257
00795B,中信美國公債20年,16,0,16,凱基-林口,2024-10-28,9257
3031,佰鴻,15,0,15,凱基-林口,2024-10-28,9257
00950B,凱基A級公司債,15,0,15,凱基-林口,2024-10-28,9257
2369,菱生,15,0,15,凱基-林口,2024-10-28,9257
3060,銘異,17,2,15,凱基-林口,2024-10-28,9257
00882,中信中國高股息,14,0,14,凱基-林口,2024-10-28,9257
6923,中台,14,0,14,凱基-林口,2024-10-28,9257
00662,富邦NASDAQ,13,0,13,凱基-林口,2024-10-28,9257
2890,永豐金,13,0,13,凱基-林口,2024-10-28,9257
2356,英業達,13,1,12,凱基-林口,2024-10-28,9257
3689,湧德,11,0,11,凱基-林口,2024-10-28,9257
1802,台玻,16,5,11,凱基-林口,2024-10-28,9257
3030,德律,11,0,11,凱基-林口,2024-10-28,9257
3047,訊舟,10,0,10,凱基-林口,2024-10-28,9257
00952,凱基台灣AI50,10,0,10,凱基-林口,2024-10-28,9257
4558,寶緯,10,0,10,凱基-林口,2024-10-28,9257
5386,青雲,13,3,10,凱基-林口,2024-10-28,9257
5521,工信,10,0,10,凱基-林口,2024-10-28,9257
8404,百和興業-KY,10,0,10,凱基-林口,2024-10-28,9257
3231,緯創,15,5,10,凱基-林口,2024-10-28,9257
3710,連展投控,11,2,9,凱基-林口,2024-10-28,9257
8358,金居,11,2,9,凱基-林口,2024-10-28,9257
9958,世紀鋼,14,5,9,凱基-林口,2024-10-28,9257
00887,永豐中國科技50大,8,0,8,凱基-林口,2024-10-28,9257
2882,國泰金,10,3,7,凱基-林口,2024-10-28,9257
00933B,國泰10Y+金融債,7,0,7,凱基-林口,2024-10-28,9257
2324,仁寶,7,0,7,凱基-林口,2024-10-28,9257
2354,鴻準,49,42,7,凱基-林口,2024-10-28,9257
3230,錦明,7,0,7,凱基-林口,2024-10-28,9257
6546,正基,7,0,7,凱基-林口,2024-10-28,9257
2312,金寶,206,0,206,凱基-林口,2024-10-29,9257
00929,復華台灣科技優息,145,14,131,凱基-林口,2024-10-29,9257
0056,元大高股息,119,0,119,凱基-林口,2024-10-29,9257
5488,松普,103,2,101,凱基-林口,2024-10-29,9257
00919,群益台灣精選高息,90,0,90,凱基-林口,2024-10-29,9257
00918,大華優利高填息30,82,0,82,凱基-林口,2024-10-29,9257
1314,中石化,76,0,76,凱基-林口,2024-10-29,9257
00715L,期街口布蘭特正2,70,0,70,凱基-林口,2024-10-29,9257
3209,全科,68,0,68,凱基-林口,2024-10-29,9257
00943,兆豐電子高息等權,62,0,62,凱基-林口,2024-10-29,9257
00632R,元大台灣50反1,85,25,60,凱基-林口,2024-10-29,9257
3484,崧騰,52,0,52,凱基-林口,2024-10-29,9257
4114,健喬,50,0,50,凱基-林口,2024-10-29,9257
00922,國泰台灣領袖50,64,16,48,凱基-林口,2024-10-29,9257
00946,群益科技高息成長,41,0,41,凱基-林口,2024-10-29,9257
00878,國泰永續高股息,43,2,41,凱基-林口,2024-10-29,9257
3044,健鼎,32,0,32,凱基-林口,2024-10-29,9257
3715,定穎投控,43,14,29,凱基-林口,2024-10-29,9257
2515,中工,26,0,26,凱基-林口,2024-10-29,9257
2363,矽統,32,7,25,凱基-林口,2024-10-29,9257
00937B,群益ESG投等債20,29,5,24,凱基-林口,2024-10-29,9257
00930,永豐ESG低碳高息,22,0,22,凱基-林口,2024-10-29,9257
6742,澤米,22,0,22,凱基-林口,2024-10-29,9257
00932,兆豐永續高息等權,21,0,21,凱基-林口,2024-10-29,9257
00952,凱基台灣AI50,21,0,21,凱基-林口,2024-10-29,9257
00912,中信臺灣智慧50,20,0,20,凱基-林口,2024-10-29,9257
00961,FT臺灣永續高息,20,0,20,凱基-林口,2024-10-29,9257
2493,揚博,20,0,20,凱基-林口,2024-10-29,9257
00637L,元大滬深300正2,22,3,19,凱基-林口,2024-10-29,9257
00939,統一台灣高息動能,17,0,17,凱基-林口,2024-10-29,9257
8249,菱光,61,44,17,凱基-林口,2024-10-29,9257
00934,中信成長高股息,36,20,16,凱基-林口,2024-10-29,9257
2362,藍天,16,0,16,凱基-林口,2024-10-29,9257
4161,聿新科,32,16,16,凱基-林口,2024-10-29,9257
9105,泰金寶-DR,16,1,15,凱基-林口,2024-10-29,9257
00882,中信中國高股息,14,1,13,凱基-林口,2024-10-29,9257
00936,台新永續高息中小,12,0,12,凱基-林口,2024-10-29,9257
2883,凱基金,12,0,12,凱基-林口,2024-10-29,9257
4909,新復興,13,1,12,凱基-林口,2024-10-29,9257
00927,群益半導體收益,11,0,11,凱基-林口,2024-10-29,9257
2890,永豐金,11,0,11,凱基-林口,2024-10-29,9257
0050,元大台灣50,11,0,11,凱基-林口,2024-10-29,9257
2405,輔信,11,0,11,凱基-林口,2024-10-29,9257
3709,鑫聯大投控,11,0,11,凱基-林口,2024-10-29,9257
00680L,元大美債20正2,10,0,10,凱基-林口,2024-10-29,9257
00662,富邦NASDAQ,10,0,10,凱基-林口,2024-10-29,9257
00642U,期元大S＆P石油,10,0,10,凱基-林口,2024-10-29,9257
2369,菱生,10,0,10,凱基-林口,2024-10-29,9257
2458,義隆,10,0,10,凱基-林口,2024-10-29,9257
3481,群創,15,5,10,凱基-林口,2024-10-29,9257
6156,松上,129,0,129,凱基-林口,2024-10-30,9257
2312,金寶,105,0,105,凱基-林口,2024-10-30,9257
3447,展達,58,0,58,凱基-林口,2024-10-30,9257
00929,復華台灣科技優息,75,18,57,凱基-林口,2024-10-30,9257
1314,中石化,60,8,52,凱基-林口,2024-10-30,9257
00637L,元大滬深300正2,42,0,42,凱基-林口,2024-10-30,9257
2883,凱基金,37,0,37,凱基-林口,2024-10-30,9257
3518,柏騰,36,0,36,凱基-林口,2024-10-30,9257
5521,工信,35,0,35,凱基-林口,2024-10-30,9257
00919,群益台灣精選高息,33,0,33,凱基-林口,2024-10-30,9257
00679B,元大美債20年,31,0,31,凱基-林口,2024-10-30,9257
2614,東森,30,0,30,凱基-林口,2024-10-30,9257
2303,聯電,26,2,24,凱基-林口,2024-10-30,9257
2337,旺宏,21,0,21,凱基-林口,2024-10-30,9257
00887,永豐中國科技50大,26,5,21,凱基-林口,2024-10-30,9257
00878,國泰永續高股息,25,4,21,凱基-林口,2024-10-30,9257
0056,元大高股息,22,2,20,凱基-林口,2024-10-30,9257
00940,元大台灣價值高息,17,0,17,凱基-林口,2024-10-30,9257
00939,統一台灣高息動能,16,0,16,凱基-林口,2024-10-30,9257
00953B,群益優選非投等債,16,0,16,凱基-林口,2024-10-30,9257
00930,永豐ESG低碳高息,15,0,15,凱基-林口,2024-10-30,9257
2762,世界健身-KY,13,0,13,凱基-林口,2024-10-30,9257
4919,新唐,30,17,13,凱基-林口,2024-10-30,9257
00948B,中信優息投資級債,12,0,12,凱基-林口,2024-10-30,9257
2618,長榮航,12,0,12,凱基-林口,2024-10-30,9257
8249,菱光,13,1,12,凱基-林口,2024-10-30,9257
2399,映泰,36,25,11,凱基-林口,2024-10-30,9257
3049,精金,12,1,11,凱基-林口,2024-10-30,9257
6257,矽格,13,2,11,凱基-林口,2024-10-30,9257
00946,群益科技高息成長,11,0,11,凱基-林口,2024-10-30,9257
00882,中信中國高股息,60,50,10,凱基-林口,2024-10-30,9257
00912,中信臺灣智慧50,10,0,10,凱基-林口,2024-10-30,9257
00918,大華優利高填息30,10,0,10,凱基-林口,2024-10-30,9257
00933B,國泰10Y+金融債,10,0,10,凱基-林口,2024-10-30,9257
00952,凱基台灣AI50,10,0,10,凱基-林口,2024-10-30,9257
1449,佳和,10,0,10,凱基-林口,2024-10-30,9257
2462,良得電,10,0,10,凱基-林口,2024-10-30,9257
2493,揚博,10,0,10,凱基-林口,2024-10-30,9257
3709,鑫聯大投控,10,0,10,凱基-林口,2024-10-30,9257
5469,瀚宇博,10,0,10,凱基-林口,2024-10-30,9257
3450,聯鈞,15,6,9,凱基-林口,2024-10-30,9257
00753L,中信中國50正2,10,1,9,凱基-林口,2024-10-30,9257
00662,富邦NASDAQ,11,2,9,凱基-林口,2024-10-30,9257
2543,皇昌,11,2,9,凱基-林口,2024-10-30,9257
00915,凱基優選高股息30,8,0,8,凱基-林口,2024-10-30,9257
1294,漢田生技,8,0,8,凱基-林口,2024-10-30,9257
2605,新興,8,0,8,凱基-林口,2024-10-30,9257
3550,聯穎,10,2,8,凱基-林口,2024-10-30,9257
4161,聿新科,8,0,8,凱基-林口,2024-10-30,9257
00943,兆豐電子高息等權,7,0,7,凱基-林口,2024-10-30,9257
00680L,元大美債20正2,600,20,580,凱基-林口,2024-11-01,9257
2312,金寶,161,10,151,凱基-林口,2024-11-01,9257
2317,鴻海,158,49,109,凱基-林口,2024-11-01,9257
00878,國泰永續高股息,125,35,90,凱基-林口,2024-11-01,9257
3481,群創,76,2,74,凱基-林口,2024-11-01,9257
00929,復華台灣科技優息,174,101,73,凱基-林口,2024-11-01,9257
2303,聯電,74,4,70,凱基-林口,2024-11-01,9257
0056,元大高股息,65,11,54,凱基-林口,2024-11-01,9257
2543,皇昌,61,13,48,凱基-林口,2024-11-01,9257
00940,元大台灣價值高息,53,6,47,凱基-林口,2024-11-01,9257
00919,群益台灣精選高息,80,50,30,凱基-林口,2024-11-01,9257
00632R,元大台灣50反1,30,0,30,凱基-林口,2024-11-01,9257
00671R,富邦NASDAQ反1,30,0,30,凱基-林口,2024-11-01,9257
6546,正基,29,0,29,凱基-林口,2024-11-01,9257
00938,凱基優選30,27,0,27,凱基-林口,2024-11-01,9257
1449,佳和,30,10,20,凱基-林口,2024-11-01,9257
3209,全科,25,5,20,凱基-林口,2024-11-01,9257
00946,群益科技高息成長,20,1,19,凱基-林口,2024-11-01,9257
2337,旺宏,18,0,18,凱基-林口,2024-11-01,9257
6606,建德工業,16,0,16,凱基-林口,2024-11-01,9257
4909,新復興,16,2,14,凱基-林口,2024-11-01,9257
2354,鴻準,217,203,14,凱基-林口,2024-11-01,9257
00912,中信臺灣智慧50,13,0,13,凱基-林口,2024-11-01,9257
2399,映泰,12,0,12,凱基-林口,2024-11-01,9257
00948B,中信優息投資級債,12,0,12,凱基-林口,2024-11-01,9257
6285,啟��,12,0,12,凱基-林口,2024-11-01,9257
00712,復華富時不動產,12,0,12,凱基-林口,2024-11-01,9257
00905,FT臺灣Smart,11,0,11,凱基-林口,2024-11-01,9257
00725B,國泰投資級公司債,11,0,11,凱基-林口,2024-11-01,9257
6133,金橋,12,1,11,凱基-林口,2024-11-01,9257
2887,台新金,10,0,10,凱基-林口,2024-11-01,9257
00673R,期元大S＆P原油反1,10,0,10,凱基-林口,2024-11-01,9257
00693U,期街口S＆P黃豆,10,0,10,凱基-林口,2024-11-01,9257
2458,義隆,10,0,10,凱基-林口,2024-11-01,9257
2880,華南金,10,0,10,凱基-林口,2024-11-01,9257
3027,盛達,10,0,10,凱基-林口,2024-11-01,9257
3558,神準,10,0,10,凱基-林口,2024-11-01,9257
00713,元大台灣高息低波,10,0,10,凱基-林口,2024-11-01,9257
2308,台達電,9,0,9,凱基-林口,2024-11-01,9257
00662,富邦NASDAQ,9,0,9,凱基-林口,2024-11-01,9257
2493,揚博,10,1,9,凱基-林口,2024-11-01,9257
3710,連展投控,10,1,9,凱基-林口,2024-11-01,9257
2881,富邦金,10,1,9,凱基-林口,2024-11-01,9257
00915,凱基優選高股息30,10,2,8,凱基-林口,2024-11-01,9257
3711,日月光投控,28,20,8,凱基-林口,2024-11-01,9257
00941,中信上游半導體,8,0,8,凱基-林口,2024-11-01,9257
00943,兆豐電子高息等權,8,0,8,凱基-林口,2024-11-01,9257
6274,台燿,11,3,8,凱基-林口,2024-11-01,9257
0050,元大台灣50,8,0,8,凱基-林口,2024-11-01,9257
2886,兆豐金,7,0,7,凱基-林口,2024-11-01,9257
00680L,元大美債20正2,202,20,182,凱基-林口,2024-11-04,9257
00937B,群益ESG投等債20,130,0,130,凱基-林口,2024-11-04,9257
6757,台灣虎航,74,0,74,凱基-林口,2024-11-04,9257
5426,振發,70,0,70,凱基-林口,2024-11-04,9257
6546,正基,69,0,69,凱基-林口,2024-11-04,9257
00688L,國泰20年美債正2,65,0,65,凱基-林口,2024-11-04,9257
00878,國泰永續高股息,48,0,48,凱基-林口,2024-11-04,9257
00919,群益台灣精選高息,49,2,47,凱基-林口,2024-11-04,9257
6126,信音,45,0,45,凱基-林口,2024-11-04,9257
2303,聯電,50,6,44,凱基-林口,2024-11-04,9257
00943,兆豐電子高息等權,32,0,32,凱基-林口,2024-11-04,9257
2486,一詮,61,31,30,凱基-林口,2024-11-04,9257
1307,三芳,37,10,27,凱基-林口,2024-11-04,9257
8249,菱光,33,6,27,凱基-林口,2024-11-04,9257
00712,復華富時不動產,25,1,24,凱基-林口,2024-11-04,9257
6005,群益證,21,0,21,凱基-林口,2024-11-04,9257
8064,東捷,21,0,21,凱基-林口,2024-11-04,9257
00633L,富邦上証正2,20,0,20,凱基-林口,2024-11-04,9257
00942B,台新美A公司債20+,20,0,20,凱基-林口,2024-11-04,9257
2614,東森,20,0,20,凱基-林口,2024-11-04,9257
4161,聿新科,18,0,18,凱基-林口,2024-11-04,9257
00679B,元大美債20年,24,8,16,凱基-林口,2024-11-04,9257
2337,旺宏,16,0,16,凱基-林口,2024-11-04,9257
00948B,中信優息投資級債,16,0,16,凱基-林口,2024-11-04,9257
3037,欣興,64,49,15,凱基-林口,2024-11-04,9257
2431,聯昌,41,26,15,凱基-林口,2024-11-04,9257
2887,台新金,15,0,15,凱基-林口,2024-11-04,9257
2646,星宇航空,18,4,14,凱基-林口,2024-11-04,9257
5347,世界,15,1,14,凱基-林口,2024-11-04,9257
1314,中石化,13,0,13,凱基-林口,2024-11-04,9257
00713,元大台灣高息低波,12,0,12,凱基-林口,2024-11-04,9257
2388,威盛,18,6,12,凱基-林口,2024-11-04,9257
3209,全科,12,0,12,凱基-林口,2024-11-04,9257
8111,立��,45,34,11,凱基-林口,2024-11-04,9257
1795,美時,10,0,10,凱基-林口,2024-11-04,9257
00882,中信中國高股息,10,0,10,凱基-林口,2024-11-04,9257
1308,亞聚,10,0,10,凱基-林口,2024-11-04,9257
2206,三陽工業,10,0,10,凱基-林口,2024-11-04,9257
2338,光罩,10,0,10,凱基-林口,2024-11-04,9257
4977,眾達-KY,10,0,10,凱基-林口,2024-11-04,9257
6229,研通,10,0,10,凱基-林口,2024-11-04,9257
8358,金居,10,0,10,凱基-林口,2024-11-04,9257
00946,群益科技高息成長,9,0,9,凱基-林口,2024-11-04,9257
1528,恩德,11,2,9,凱基-林口,2024-11-04,9257
2464,盟立,15,6,9,凱基-林口,2024-11-04,9257
2609,陽明,27,18,9,凱基-林口,2024-11-04,9257
0056,元大高股息,10,2,8,凱基-林口,2024-11-04,9257
4903,聯光通,26,18,8,凱基-林口,2024-11-04,9257
00881,國泰台灣5G+,8,0,8,凱基-林口,2024-11-04,9257
006208,富邦台50,7,0,7,凱基-林口,2024-11-04,9257
6546,正基,96,0,96,凱基-林口,2024-11-05,9257
2356,英業達,174,124,50,凱基-林口,2024-11-05,9257
2543,皇昌,66,17,49,凱基-林口,2024-11-05,9257
2303,聯電,61,13,48,凱基-林口,2024-11-05,9257
00919,群益台灣精選高息,47,2,45,凱基-林口,2024-11-05,9257
2354,鴻準,110,72,38,凱基-林口,2024-11-05,9257
8404,百和興業-KY,35,4,31,凱基-林口,2024-11-05,9257
4161,聿新科,30,5,25,凱基-林口,2024-11-05,9257
5258,虹堡,23,0,23,凱基-林口,2024-11-05,9257
00953B,群益優選非投等債,20,0,20,凱基-林口,2024-11-05,9257
1540,喬福,25,5,20,凱基-林口,2024-11-05,9257
2375,凱美,20,0,20,凱基-林口,2024-11-05,9257
3545,敦泰,20,0,20,凱基-林口,2024-11-05,9257
2317,鴻海,28,10,18,凱基-林口,2024-11-05,9257
5315,光聯,32,16,16,凱基-林口,2024-11-05,9257
6530,創威,21,5,16,凱基-林口,2024-11-05,9257
5871,中租-KY,15,0,15,凱基-林口,2024-11-05,9257
2609,陽明,73,59,14,凱基-林口,2024-11-05,9257
00940,元大台灣價值高息,14,0,14,凱基-林口,2024-11-05,9257
00946,群益科技高息成長,13,0,13,凱基-林口,2024-11-05,9257
2337,旺宏,12,0,12,凱基-林口,2024-11-05,9257
00930,永豐ESG低碳高息,12,0,12,凱基-林口,2024-11-05,9257
2206,三陽工業,12,0,12,凱基-林口,2024-11-05,9257
6658,聯策,11,0,11,凱基-林口,2024-11-05,9257
00632R,元大台灣50反1,10,0,10,凱基-林口,2024-11-05,9257
00671R,富邦NASDAQ反1,10,0,10,凱基-林口,2024-11-05,9257
2614,東森,10,0,10,凱基-林口,2024-11-05,9257
5213,亞昕,10,0,10,凱基-林口,2024-11-05,9257
6213,聯茂,10,0,10,凱基-林口,2024-11-05,9257
6799,來頡,10,0,10,凱基-林口,2024-11-05,9257
00932,兆豐永續高息等權,9,0,9,凱基-林口,2024-11-05,9257
00830,國泰費城半導體,9,0,9,凱基-林口,2024-11-05,9257
2408,南亞科,9,0,9,凱基-林口,2024-11-05,9257
2493,揚博,12,3,9,凱基-林口,2024-11-05,9257
4909,新復興,9,1,8,凱基-林口,2024-11-05,9257
00912,中信臺灣智慧50,7,0,7,凱基-林口,2024-11-05,9257
4903,聯光通,30,23,7,凱基-林口,2024-11-05,9257
4561,健椿,7,0,7,凱基-林口,2024-11-05,9257
2344,華邦電,6,0,6,凱基-林口,2024-11-05,9257
00929,復華台灣科技優息,18,12,6,凱基-林口,2024-11-05,9257
00948B,中信優息投資級債,6,0,6,凱基-林口,2024-11-05,9257
2369,菱生,16,10,6,凱基-林口,2024-11-05,9257
3013,晟銘電,16,10,6,凱基-林口,2024-11-05,9257
4991,環宇-KY,13,7,6,凱基-林口,2024-11-05,9257
6706,惠特,6,0,6,凱基-林口,2024-11-05,9257
6770,力積電,6,0,6,凱基-林口,2024-11-05,9257
00706L,期元大S＆P日圓正2,5,0,5,凱基-林口,2024-11-05,9257
00639,富邦深100,5,0,5,凱基-林口,2024-11-05,9257
00757,統一FANG+,5,0,5,凱基-林口,2024-11-05,9257
1904,正隆,5,0,5,凱基-林口,2024-11-05,9257
1815,富喬,510,63,447,凱基-林口,2024-11-06,9257
00679B,元大美債20年,175,11,164,凱基-林口,2024-11-06,9257
00688L,國泰20年美債正2,158,0,158,凱基-林口,2024-11-06,9257
00687B,國泰20年美債,153,24,129,凱基-林口,2024-11-06,9257
00712,復華富時不動產,126,2,124,凱基-林口,2024-11-06,9257
6546,正基,130,10,120,凱基-林口,2024-11-06,9257
00937B,群益ESG投等債20,52,0,52,凱基-林口,2024-11-06,9257
3230,錦明,43,1,42,凱基-林口,2024-11-06,9257
6220,岳豐,40,0,40,凱基-林口,2024-11-06,9257
00632R,元大台灣50反1,37,0,37,凱基-林口,2024-11-06,9257
3645,達邁,30,0,30,凱基-林口,2024-11-06,9257
3701,大眾控,30,0,30,凱基-林口,2024-11-06,9257
2303,聯電,37,10,27,凱基-林口,2024-11-06,9257
2609,陽明,46,20,26,凱基-林口,2024-11-06,9257
00933B,國泰10Y+金融債,25,0,25,凱基-林口,2024-11-06,9257
4527,方土霖,25,0,25,凱基-林口,2024-11-06,9257
2317,鴻海,76,52,24,凱基-林口,2024-11-06,9257
00946,群益科技高息成長,22,0,22,凱基-林口,2024-11-06,9257
6658,聯策,21,0,21,凱基-林口,2024-11-06,9257
1447,力鵬,20,0,20,凱基-林口,2024-11-06,9257
2614,東森,20,0,20,凱基-林口,2024-11-06,9257
2330,台積電,27,8,19,凱基-林口,2024-11-06,9257
00753L,中信中國50正2,20,2,18,凱基-林口,2024-11-06,9257
00915,凱基優選高股息30,16,0,16,凱基-林口,2024-11-06,9257
00706L,期元大S＆P日圓正2,15,0,15,凱基-林口,2024-11-06,9257
5426,振發,16,1,15,凱基-林口,2024-11-06,9257
00929,復華台灣科技優息,17,3,14,凱基-林口,2024-11-06,9257
2324,仁寶,17,3,14,凱基-林口,2024-11-06,9257
00637L,元大滬深300正2,16,3,13,凱基-林口,2024-11-06,9257
00948B,中信優息投資級債,13,0,13,凱基-林口,2024-11-06,9257
1714,和桐,12,0,12,凱基-林口,2024-11-06,9257
2888,新光金,12,0,12,凱基-林口,2024-11-06,9257
3317,尼克森,16,4,12,凱基-林口,2024-11-06,9257
3615,安可,22,11,11,凱基-林口,2024-11-06,9257
00795B,中信美國公債20年,10,0,10,凱基-林口,2024-11-06,9257
1444,力麗,10,0,10,凱基-林口,2024-11-06,9257
2020,美亞,10,0,10,凱基-林口,2024-11-06,9257
3078,僑威,10,0,10,凱基-林口,2024-11-06,9257
8085,福華,10,0,10,凱基-林口,2024-11-06,9257
8936,國統,10,0,10,凱基-林口,2024-11-06,9257
2327,國巨,9,0,9,凱基-林口,2024-11-06,9257
2543,皇昌,70,61,9,凱基-林口,2024-11-06,9257
2375,凱美,8,0,8,凱基-林口,2024-11-06,9257
00715L,期街口布蘭特正2,7,0,7,凱基-林口,2024-11-06,9257
1528,恩德,10,3,7,凱基-林口,2024-11-06,9257
00919,群益台灣精選高息,8,1,7,凱基-林口,2024-11-06,9257
00720B,元大投資級公司債,6,0,6,凱基-林口,2024-11-06,9257
4510,高鋒,9,3,6,凱基-林口,2024-11-06,9257
5438,東友,31,25,6,凱基-林口,2024-11-06,9257
6153,嘉聯益,6,0,6,凱基-林口,2024-11-06,9257
00712,復華富時不動產,603,0,603,凱基-林口,2024-11-07,9257
2312,金寶,626,214,412,凱基-林口,2024-11-07,9257
00937B,群益ESG投等債20,185,17,168,凱基-林口,2024-11-07,9257
00878,國泰永續高股息,140,0,140,凱基-林口,2024-11-07,9257
00680L,元大美債20正2,67,2,65,凱基-林口,2024-11-07,9257
6757,台灣虎航,50,0,50,凱基-林口,2024-11-07,9257
00632R,元大台灣50反1,48,0,48,凱基-林口,2024-11-07,9257
00930,永豐ESG低碳高息,50,3,47,凱基-林口,2024-11-07,9257
6134,萬旭,42,0,42,凱基-林口,2024-11-07,9257
9105,泰金寶-DR,290,260,30,凱基-林口,2024-11-07,9257
6593,台灣銘板,26,0,26,凱基-林口,2024-11-07,9257
00671R,富邦NASDAQ反1,20,0,20,凱基-林口,2024-11-07,9257
5386,青雲,23,6,17,凱基-林口,2024-11-07,9257
1540,喬福,20,4,16,凱基-林口,2024-11-07,9257
5356,協益,21,5,16,凱基-林口,2024-11-07,9257
00648R,元大S＆P500反1,15,0,15,凱基-林口,2024-11-07,9257
00915,凱基優選高股息30,15,0,15,凱基-林口,2024-11-07,9257
2399,映泰,16,2,14,凱基-林口,2024-11-07,9257
3231,緯創,20,7,13,凱基-林口,2024-11-07,9257
6282,康舒,11,0,11,凱基-林口,2024-11-07,9257
00891,中信關鍵半導體,10,0,10,凱基-林口,2024-11-07,9257
2023,燁輝,10,0,10,凱基-林口,2024-11-07,9257
2201,裕隆,10,0,10,凱基-林口,2024-11-07,9257
2353,宏��,10,0,10,凱基-林口,2024-11-07,9257
2365,昆盈,10,0,10,凱基-林口,2024-11-07,9257
2493,揚博,10,0,10,凱基-林口,2024-11-07,9257
3710,連展投控,11,1,10,凱基-林口,2024-11-07,9257
6933,AMAX-KY,10,0,10,凱基-林口,2024-11-07,9257
3029,零壹,17,8,9,凱基-林口,2024-11-07,9257
3701,大眾控,13,4,9,凱基-林口,2024-11-07,9257
3615,安可,8,0,8,凱基-林口,2024-11-07,9257
4979,華星光,29,22,7,凱基-林口,2024-11-07,9257
2634,漢翔,8,1,7,凱基-林口,2024-11-07,9257
8011,台通,10,3,7,凱基-林口,2024-11-07,9257
2892,第一金,6,0,6,凱基-林口,2024-11-07,9257
3189,景碩,16,10,6,凱基-林口,2024-11-07,9257
3498,陽程,7,1,6,凱基-林口,2024-11-07,9257
4109,加捷生醫,6,0,6,凱基-林口,2024-11-07,9257
4113,聯上,6,0,6,凱基-林口,2024-11-07,9257
8064,東捷,6,0,6,凱基-林口,2024-11-07,9257
8096,擎亞,12,6,6,凱基-林口,2024-11-07,9257
8404,百和興業-KY,6,0,6,凱基-林口,2024-11-07,9257
3014,聯陽,14,8,6,凱基-林口,2024-11-07,9257
5871,中租-KY,5,0,5,凱基-林口,2024-11-07,9257
00830,國泰費城半導體,8,3,5,凱基-林口,2024-11-07,9257
00909,國泰數位支付服務,5,0,5,凱基-林口,2024-11-07,9257
00852L,國泰美國道瓊正2,5,0,5,凱基-林口,2024-11-07,9257
3078,僑威,5,0,5,凱基-林口,2024-11-07,9257
3535,晶彩科,6,1,5,凱基-林口,2024-11-07,9257
4549,桓達,5,0,5,凱基-林口,2024-11-07,9257
2353,宏��,411,0,411,凱基-林口,2024-11-08,9257
3481,群創,135,2,133,凱基-林口,2024-11-08,9257
00680L,元大美債20正2,71,4,67,凱基-林口,2024-11-08,9257
00878,國泰永續高股息,70,4,66,凱基-林口,2024-11-08,9257
00632R,元大台灣50反1,60,0,60,凱基-林口,2024-11-08,9257
8096,擎亞,81,26,55,凱基-林口,2024-11-08,9257
2354,鴻準,85,30,55,凱基-林口,2024-11-08,9257
6821,聯寶,52,0,52,凱基-林口,2024-11-08,9257
8070,長華*,53,1,52,凱基-林口,2024-11-08,9257
1314,中石化,50,0,50,凱基-林口,2024-11-08,9257
8011,台通,48,0,48,凱基-林口,2024-11-08,9257
3062,建漢,51,7,44,凱基-林口,2024-11-08,9257
6505,台塑化,41,1,40,凱基-林口,2024-11-08,9257
2312,金寶,55,15,40,凱基-林口,2024-11-08,9257
2303,聯電,48,9,39,凱基-林口,2024-11-08,9257
00915,凱基優選高股息30,34,0,34,凱基-林口,2024-11-08,9257
00919,群益台灣精選高息,41,7,34,凱基-林口,2024-11-08,9257
6548,長科*,34,1,33,凱基-林口,2024-11-08,9257
00830,國泰費城半導體,37,6,31,凱基-林口,2024-11-08,9257
00693U,期街口S＆P黃豆,30,0,30,凱基-林口,2024-11-08,9257
3209,全科,24,0,24,凱基-林口,2024-11-08,9257
00713,元大台灣高息低波,22,0,22,凱基-林口,2024-11-08,9257
2344,華邦電,21,0,21,凱基-林口,2024-11-08,9257
3049,精金,21,0,21,凱基-林口,2024-11-08,9257
3037,欣興,48,27,21,凱基-林口,2024-11-08,9257
00948B,中信優息投資級債,20,0,20,凱基-林口,2024-11-08,9257
2324,仁寶,71,51,20,凱基-林口,2024-11-08,9257
3712,永崴投控,20,0,20,凱基-林口,2024-11-08,9257
6757,台灣虎航,20,0,20,凱基-林口,2024-11-08,9257
5426,振發,23,5,18,凱基-林口,2024-11-08,9257
4161,聿新科,15,0,15,凱基-林口,2024-11-08,9257
4909,新復興,17,2,15,凱基-林口,2024-11-08,9257
6161,捷波,15,0,15,凱基-林口,2024-11-08,9257
1301,台塑,13,1,12,凱基-林口,2024-11-08,9257
9924,福興,12,0,12,凱基-林口,2024-11-08,9257
2614,東森,10,0,10,凱基-林口,2024-11-08,9257
00751B,元大AAA至A公司債,20,10,10,凱基-林口,2024-11-08,9257
1531,高林股,15,5,10,凱基-林口,2024-11-08,9257
1802,台玻,12,2,10,凱基-林口,2024-11-08,9257
2405,輔信,10,0,10,凱基-林口,2024-11-08,9257
2633,台灣高鐵,10,0,10,凱基-林口,2024-11-08,9257
3380,明泰,10,0,10,凱基-林口,2024-11-08,9257
5438,東友,10,0,10,凱基-林口,2024-11-08,9257
5880,合庫金,10,0,10,凱基-林口,2024-11-08,9257
6133,金橋,10,0,10,凱基-林口,2024-11-08,9257
6234,高僑,10,0,10,凱基-林口,2024-11-08,9257
3231,緯創,78,68,10,凱基-林口,2024-11-08,9257
00720B,元大投資級公司債,20,10,10,凱基-林口,2024-11-08,9257
1815,富喬,14,5,9,凱基-林口,2024-11-08,9257
8043,蜜望實,9,0,9,凱基-林口,2024-11-08,9257
00753L,中信中國50正2,138,1,137,凱基-林口,2024-11-11,9257
2408,南亞科,120,17,103,凱基-林口,2024-11-11,9257
8070,長華*,102,0,102,凱基-林口,2024-11-11,9257
3062,建漢,48,0,48,凱基-林口,2024-11-11,9257
6757,台灣虎航,45,0,45,凱基-林口,2024-11-11,9257
00922,國泰台灣領袖50,41,0,41,凱基-林口,2024-11-11,9257
1605,華新,38,0,38,凱基-林口,2024-11-11,9257
00637L,元大滬深300正2,46,10,36,凱基-林口,2024-11-11,9257
00915,凱基優選高股息30,33,0,33,凱基-林口,2024-11-11,9257
00935,野村臺灣新科技50,30,0,30,凱基-林口,2024-11-11,9257
00953B,群益優選非投等債,30,0,30,凱基-林口,2024-11-11,9257
00919,群益台灣精選高息,28,0,28,凱基-林口,2024-11-11,9257
8240,華宏,30,2,28,凱基-林口,2024-11-11,9257
5356,協益,26,0,26,凱基-林口,2024-11-11,9257
1449,佳和,24,1,23,凱基-林口,2024-11-11,9257
00907,永豐優息存股,20,0,20,凱基-林口,2024-11-11,9257
00882,中信中國高股息,25,5,20,凱基-林口,2024-11-11,9257
2337,旺宏,20,0,20,凱基-林口,2024-11-11,9257
2614,東森,20,0,20,凱基-林口,2024-11-11,9257
3481,群創,20,0,20,凱基-林口,2024-11-11,9257
4161,聿新科,42,25,17,凱基-林口,2024-11-11,9257
6658,聯策,17,1,16,凱基-林口,2024-11-11,9257
00943,兆豐電子高息等權,15,0,15,凱基-林口,2024-11-11,9257
3712,永崴投控,25,11,14,凱基-林口,2024-11-11,9257
2449,京元電子,16,3,13,凱基-林口,2024-11-11,9257
2344,華邦電,14,1,13,凱基-林口,2024-11-11,9257
1229,聯華,13,0,13,凱基-林口,2024-11-11,9257
3060,銘異,13,0,13,凱基-林口,2024-11-11,9257
00713,元大台灣高息低波,13,0,13,凱基-林口,2024-11-11,9257
8080,印鉐,12,0,12,凱基-林口,2024-11-11,9257
00891,中信關鍵半導體,11,0,11,凱基-林口,2024-11-11,9257
4916,事欣科,20,9,11,凱基-林口,2024-11-11,9257
3515,華擎,15,4,11,凱基-林口,2024-11-11,9257
00632R,元大台灣50反1,10,0,10,凱基-林口,2024-11-11,9257
00948B,中信優息投資級債,10,0,10,凱基-林口,2024-11-11,9257
2845,遠東銀,10,0,10,凱基-林口,2024-11-11,9257
2903,遠百,10,0,10,凱基-林口,2024-11-11,9257
6182,合晶,10,0,10,凱基-林口,2024-11-11,9257
8044,網家,10,0,10,凱基-林口,2024-11-11,9257
8404,百和興業-KY,10,0,10,凱基-林口,2024-11-11,9257
2603,長榮,16,6,10,凱基-林口,2024-11-11,9257
2392,正崴,26,17,9,凱基-林口,2024-11-11,9257
2646,星宇航空,9,0,9,凱基-林口,2024-11-11,9257
3037,欣興,33,24,9,凱基-林口,2024-11-11,9257
3189,景碩,10,1,9,凱基-林口,2024-11-11,9257
3605,宏致,9,0,9,凱基-林口,2024-11-11,9257
00679B,元大美債20年,9,0,9,凱基-林口,2024-11-11,9257
2382,廣達,9,1,8,凱基-林口,2024-11-11,9257
6139,亞翔,8,0,8,凱基-林口,2024-11-11,9257
2834,臺企銀,11,3,8,凱基-林口,2024-11-11,9257
6005,群益證,194,0,194,凱基-林口,2024-11-12,9257
00715L,期街口布蘭特正2,94,0,94,凱基-林口,2024-11-12,9257
0056,元大高股息,103,13,90,凱基-林口,2024-11-12,9257
00878,國泰永續高股息,147,63,84,凱基-林口,2024-11-12,9257
3481,群創,73,9,64,凱基-林口,2024-11-12,9257
6546,正基,55,0,55,凱基-林口,2024-11-12,9257
3234,光環,52,0,52,凱基-林口,2024-11-12,9257
00753L,中信中國50正2,161,111,50,凱基-林口,2024-11-12,9257
2455,全新,52,2,50,凱基-林口,2024-11-12,9257
8070,長華*,52,3,49,凱基-林口,2024-11-12,9257
00922,國泰台灣領袖50,46,0,46,凱基-林口,2024-11-12,9257
1314,中石化,45,0,45,凱基-林口,2024-11-12,9257
00952,凱基台灣AI50,41,0,41,凱基-林口,2024-11-12,9257
8011,台通,40,4,36,凱基-林口,2024-11-12,9257
00631L,元大台灣50正2,35,1,34,凱基-林口,2024-11-12,9257
2356,英業達,48,14,34,凱基-林口,2024-11-12,9257
00713,元大台灣高息低波,30,0,30,凱基-林口,2024-11-12,9257
00948B,中信優息投資級債,30,0,30,凱基-林口,2024-11-12,9257
2323,中環,30,0,30,凱基-林口,2024-11-12,9257
3356,奇偶,30,0,30,凱基-林口,2024-11-12,9257
6757,台灣虎航,30,0,30,凱基-林口,2024-11-12,9257
00915,凱基優選高股息30,30,0,30,凱基-林口,2024-11-12,9257
2317,鴻海,84,57,27,凱基-林口,2024-11-12,9257
2929,淘帝-KY,23,0,23,凱基-林口,2024-11-12,9257
2360,致茂,21,0,21,凱基-林口,2024-11-12,9257
2609,陽明,88,68,20,凱基-林口,2024-11-12,9257
00935,野村臺灣新科技50,20,1,19,凱基-林口,2024-11-12,9257
2330,台積電,18,0,18,凱基-林口,2024-11-12,9257
1524,耿鼎,22,5,17,凱基-林口,2024-11-12,9257
6609,瀧澤科,20,3,17,凱基-林口,2024-11-12,9257
2834,臺企銀,20,4,16,凱基-林口,2024-11-12,9257
2614,東森,15,0,15,凱基-林口,2024-11-12,9257
4977,眾達-KY,15,1,14,凱基-林口,2024-11-12,9257
5351,鈺創,15,1,14,凱基-林口,2024-11-12,9257
5398,慕康生醫,14,0,14,凱基-林口,2024-11-12,9257
6415,矽力*-KY,17,3,14,凱基-林口,2024-11-12,9257
1326,台化,13,0,13,凱基-林口,2024-11-12,9257
00943,兆豐電子高息等權,12,0,12,凱基-林口,2024-11-12,9257
2408,南亞科,12,0,12,凱基-林口,2024-11-12,9257
00940,元大台灣價值高息,14,2,12,凱基-林口,2024-11-12,9257
4142,國光生,12,0,12,凱基-林口,2024-11-12,9257
3515,華擎,13,1,12,凱基-林口,2024-11-12,9257
5871,中租-KY,12,0,12,凱基-林口,2024-11-12,9257
00932,兆豐永續高息等權,11,0,11,凱基-林口,2024-11-12,9257
1785,光洋科,11,0,11,凱基-林口,2024-11-12,9257
2613,中櫃,18,7,11,凱基-林口,2024-11-12,9257
2636,台驊控股,11,0,11,凱基-林口,2024-11-12,9257
00687B,國泰20年美債,20,9,11,凱基-林口,2024-11-12,9257
3013,晟銘電,59,48,11,凱基-林口,2024-11-12,9257
3615,安可,10,0,10,凱基-林口,2024-11-12,9257
00878,國泰永續高股息,118,3,115,凱基-林口,2024-11-13,9257
4931,新盛力,102,3,99,凱基-林口,2024-11-13,9257
00937B,群益ESG投等債20,73,0,73,凱基-林口,2024-11-13,9257
6546,正基,70,0,70,凱基-林口,2024-11-13,9257
5225,東科-KY,51,0,51,凱基-林口,2024-11-13,9257
00680L,元大美債20正2,47,0,47,凱基-林口,2024-11-13,9257
00725B,國泰投資級公司債,46,0,46,凱基-林口,2024-11-13,9257
1524,耿鼎,51,6,45,凱基-林口,2024-11-13,9257
00724B,群益投資級金融債,44,0,44,凱基-林口,2024-11-13,9257
00720B,元大投資級公司債,43,0,43,凱基-林口,2024-11-13,9257
00929,復華台灣科技優息,46,7,39,凱基-林口,2024-11-13,9257
8011,台通,74,38,36,凱基-林口,2024-11-13,9257
00635U,期元大S＆P黃金,34,0,34,凱基-林口,2024-11-13,9257
2402,毅嘉,31,0,31,凱基-林口,2024-11-13,9257
2344,華邦電,30,0,30,凱基-林口,2024-11-13,9257
1603,華電,30,0,30,凱基-林口,2024-11-13,9257
0056,元大高股息,31,5,26,凱基-林口,2024-11-13,9257
2317,鴻海,35,11,24,凱基-林口,2024-11-13,9257
00940,元大台灣價值高息,33,10,23,凱基-林口,2024-11-13,9257
2609,陽明,28,6,22,凱基-林口,2024-11-13,9257
00919,群益台灣精選高息,22,0,22,凱基-林口,2024-11-13,9257
2493,揚博,21,0,21,凱基-林口,2024-11-13,9257
4161,聿新科,21,0,21,凱基-林口,2024-11-13,9257
1301,台塑,21,1,20,凱基-林口,2024-11-13,9257
2883,凱基金,20,0,20,凱基-林口,2024-11-13,9257
00902,中信電池及儲能,20,0,20,凱基-林口,2024-11-13,9257
00882,中信中國高股息,25,5,20,凱基-林口,2024-11-13,9257
2646,星宇航空,19,0,19,凱基-林口,2024-11-13,9257
1314,中石化,19,0,19,凱基-林口,2024-11-13,9257
6492,生華科,19,0,19,凱基-林口,2024-11-13,9257
8183,精星,20,2,18,凱基-林口,2024-11-13,9257
00915,凱基優選高股息30,18,1,17,凱基-林口,2024-11-13,9257
2881,富邦金,16,1,15,凱基-林口,2024-11-13,9257
3062,建漢,15,0,15,凱基-林口,2024-11-13,9257
2834,臺企銀,14,0,14,凱基-林口,2024-11-13,9257
3450,聯鈞,27,13,14,凱基-林口,2024-11-13,9257
00753L,中信中國50正2,35,21,14,凱基-林口,2024-11-13,9257
00662,富邦NASDAQ,13,0,13,凱基-林口,2024-11-13,9257
1528,恩德,13,0,13,凱基-林口,2024-11-13,9257
2349,錸德,38,25,13,凱基-林口,2024-11-13,9257
00687B,國泰20年美債,12,0,12,凱基-林口,2024-11-13,9257
1336,台翰,12,0,12,凱基-林口,2024-11-13,9257
1326,台化,11,0,11,凱基-林口,2024-11-13,9257
2867,三商壽,11,0,11,凱基-林口,2024-11-13,9257
00887,永豐中國科技50大,11,1,10,凱基-林口,2024-11-13,9257
00948B,中信優息投資級債,10,0,10,凱基-林口,2024-11-13,9257
1717,長興,10,0,10,凱基-林口,2024-11-13,9257
2457,飛宏,10,0,10,凱基-林口,2024-11-13,9257
2891,中信金,13,3,10,凱基-林口,2024-11-13,9257
3189,景碩,10,0,10,凱基-林口,2024-11-13,9257
00712,復華富時不動產,853,0,853,凱基-林口,2024-11-14,9257
00878,國泰永續高股息,392,2,390,凱基-林口,2024-11-14,9257
2884,玉山金,174,0,174,凱基-林口,2024-11-14,9257
0056,元大高股息,70,5,65,凱基-林口,2024-11-14,9257
00937B,群益ESG投等債20,68,21,47,凱基-林口,2024-11-14,9257
00919,群益台灣精選高息,48,2,46,凱基-林口,2024-11-14,9257
2303,聯電,45,3,42,凱基-林口,2024-11-14,9257
00929,復華台灣科技優息,40,0,40,凱基-林口,2024-11-14,9257
00680L,元大美債20正2,37,0,37,凱基-林口,2024-11-14,9257
00891,中信關鍵半導體,33,0,33,凱基-林口,2024-11-14,9257
00915,凱基優選高股息30,31,0,31,凱基-林口,2024-11-14,9257
8064,東捷,33,2,31,凱基-林口,2024-11-14,9257
00940,元大台灣價值高息,35,5,30,凱基-林口,2024-11-14,9257
1326,台化,31,2,29,凱基-林口,2024-11-14,9257
00930,永豐ESG低碳高息,26,0,26,凱基-林口,2024-11-14,9257
00679B,元大美債20年,44,20,24,凱基-林口,2024-11-14,9257
2344,華邦電,23,0,23,凱基-林口,2024-11-14,9257
3712,永崴投控,24,2,22,凱基-林口,2024-11-14,9257
8011,台通,23,2,21,凱基-林口,2024-11-14,9257
2472,立隆電,21,0,21,凱基-林口,2024-11-14,9257
2515,中工,30,10,20,凱基-林口,2024-11-14,9257
4987,科誠,20,0,20,凱基-林口,2024-11-14,9257
5243,乙盛-KY,21,1,20,凱基-林口,2024-11-14,9257
5603,陸海,20,0,20,凱基-林口,2024-11-14,9257
3048,益登,19,1,18,凱基-林口,2024-11-14,9257
6125,廣運,28,10,18,凱基-林口,2024-11-14,9257
2615,萬海,20,3,17,凱基-林口,2024-11-14,9257
1786,科妍,16,0,16,凱基-林口,2024-11-14,9257
2440,太空梭,18,2,16,凱基-林口,2024-11-14,9257
3711,日月光投控,36,20,16,凱基-林口,2024-11-14,9257
00713,元大台灣高息低波,15,0,15,凱基-林口,2024-11-14,9257
6546,正基,15,0,15,凱基-林口,2024-11-14,9257
1301,台塑,17,4,13,凱基-林口,2024-11-14,9257
6505,台塑化,13,0,13,凱基-林口,2024-11-14,9257
1603,華電,13,0,13,凱基-林口,2024-11-14,9257
1582,信錦,11,0,11,凱基-林口,2024-11-14,9257
2603,長榮,17,6,11,凱基-林口,2024-11-14,9257
2010,春源,10,0,10,凱基-林口,2024-11-14,9257
2462,良得電,10,0,10,凱基-林口,2024-11-14,9257
2836,高雄銀,10,0,10,凱基-林口,2024-11-14,9257
2867,三商壽,10,0,10,凱基-林口,2024-11-14,9257
3050,鈺德,10,0,10,凱基-林口,2024-11-14,9257
6126,信音,11,1,10,凱基-林口,2024-11-14,9257
6282,康舒,20,10,10,凱基-林口,2024-11-14,9257
6558,興能高,10,0,10,凱基-林口,2024-11-14,9257
6757,台灣虎航,10,0,10,凱基-林口,2024-11-14,9257
6869,雲豹能源,10,0,10,凱基-林口,2024-11-14,9257
8271,宇瞻,10,0,10,凱基-林口,2024-11-14,9257
9934,成霖,10,0,10,凱基-林口,2024-11-14,9257
2382,廣達,13,4,9,凱基-林口,2024-11-14,9257
00878,國泰永續高股息,122,6,116,凱基-林口,2024-11-15,9257
00637L,元大滬深300正2,110,0,110,凱基-林口,2024-11-15,9257
3481,群創,100,7,93,凱基-林口,2024-11-15,9257
2392,正崴,102,48,54,凱基-林口,2024-11-15,9257
00948B,中信優息投資級債,50,0,50,凱基-林口,2024-11-15,9257
2382,廣達,47,6,41,凱基-林口,2024-11-15,9257
2610,華航,57,20,37,凱基-林口,2024-11-15,9257
6546,正基,30,0,30,凱基-林口,2024-11-15,9257
00929,復華台灣科技優息,54,26,28,凱基-林口,2024-11-15,9257
3324,雙鴻,32,7,25,凱基-林口,2024-11-15,9257
5603,陸海,22,0,22,凱基-林口,2024-11-15,9257
6757,台灣虎航,23,2,21,凱基-林口,2024-11-15,9257
3450,聯鈞,34,14,20,凱基-林口,2024-11-15,9257
00938,凱基優選30,20,0,20,凱基-林口,2024-11-15,9257
00902,中信電池及儲能,20,0,20,凱基-林口,2024-11-15,9257
1524,耿鼎,22,2,20,凱基-林口,2024-11-15,9257
2397,友通,20,0,20,凱基-林口,2024-11-15,9257
2515,中工,30,10,20,凱基-林口,2024-11-15,9257
6873,泓德能源,20,0,20,凱基-林口,2024-11-15,9257
6530,創威,18,0,18,凱基-林口,2024-11-15,9257
8249,菱光,23,7,16,凱基-林口,2024-11-15,9257
6577,勁豐,15,0,15,凱基-林口,2024-11-15,9257
2929,淘帝-KY,16,3,13,凱基-林口,2024-11-15,9257
3037,欣興,43,30,13,凱基-林口,2024-11-15,9257
00753L,中信中國50正2,31,19,12,凱基-林口,2024-11-15,9257
00945B,凱基美國非投等債,11,0,11,凱基-林口,2024-11-15,9257
2324,仁寶,86,75,11,凱基-林口,2024-11-15,9257
8028,昇陽半導體,11,0,11,凱基-林口,2024-11-15,9257
3013,晟銘電,20,9,11,凱基-林口,2024-11-15,9257
00927,群益半導體收益,10,0,10,凱基-林口,2024-11-15,9257
1785,光洋科,10,0,10,凱基-林口,2024-11-15,9257
2201,裕隆,10,0,10,凱基-林口,2024-11-15,9257
2481,強茂,10,0,10,凱基-林口,2024-11-15,9257
6807,峰源-KY,10,0,10,凱基-林口,2024-11-15,9257
2314,台揚,10,1,9,凱基-林口,2024-11-15,9257
006208,富邦台50,8,0,8,凱基-林口,2024-11-15,9257
6155,鈞寶,8,0,8,凱基-林口,2024-11-15,9257
00891,中信關鍵半導體,7,0,7,凱基-林口,2024-11-15,9257
2472,立隆電,8,1,7,凱基-林口,2024-11-15,9257
2834,臺企銀,8,1,7,凱基-林口,2024-11-15,9257
3711,日月光投控,23,16,7,凱基-林口,2024-11-15,9257
2356,英業達,8,2,6,凱基-林口,2024-11-15,9257
2408,南亞科,6,0,6,凱基-林口,2024-11-15,9257
6163,華電網,9,3,6,凱基-林口,2024-11-15,9257
2308,台達電,7,2,5,凱基-林口,2024-11-15,9257
2440,太空梭,6,1,5,凱基-林口,2024-11-15,9257
2812,台中銀,5,0,5,凱基-林口,2024-11-15,9257
2887,台新金,5,0,5,凱基-林口,2024-11-15,9257
3419,譁裕,5,0,5,凱基-林口,2024-11-15,9257
6015,宏遠證,5,0,5,凱基-林口,2024-11-15,9257
00937B,群益ESG投等債20,662,0,662,凱基-林口,2024-11-18,9257
00932,兆豐永續高息等權,116,0,116,凱基-林口,2024-11-18,9257
00878,國泰永續高股息,176,70,106,凱基-林口,2024-11-18,9257
00948B,中信優息投資級債,100,0,100,凱基-林口,2024-11-18,9257
2609,陽明,58,2,56,凱基-林口,2024-11-18,9257
2618,長榮航,60,8,52,凱基-林口,2024-11-18,9257
6691,洋基工程,64,14,50,凱基-林口,2024-11-18,9257
00946,群益科技高息成長,50,0,50,凱基-林口,2024-11-18,9257
3665,貿聯-KY,42,0,42,凱基-林口,2024-11-18,9257
9105,泰金寶-DR,44,10,34,凱基-林口,2024-11-18,9257
00671R,富邦NASDAQ反1,30,0,30,凱基-林口,2024-11-18,9257
2337,旺宏,30,0,30,凱基-林口,2024-11-18,9257
3356,奇偶,30,0,30,凱基-林口,2024-11-18,9257
00882,中信中國高股息,40,12,28,凱基-林口,2024-11-18,9257
4540,全球傳動,26,0,26,凱基-林口,2024-11-18,9257
5521,工信,24,0,24,凱基-林口,2024-11-18,9257
2408,南亞科,22,0,22,凱基-林口,2024-11-18,9257
6546,正基,22,0,22,凱基-林口,2024-11-18,9257
6188,廣明,19,0,19,凱基-林口,2024-11-18,9257
2317,鴻海,24,6,18,凱基-林口,2024-11-18,9257
2324,仁寶,30,13,17,凱基-林口,2024-11-18,9257
2467,志聖,22,6,16,凱基-林口,2024-11-18,9257
00943,兆豐電子高息等權,13,0,13,凱基-林口,2024-11-18,9257
2354,鴻準,39,26,13,凱基-林口,2024-11-18,9257
2605,新興,14,2,12,凱基-林口,2024-11-18,9257
00715L,期街口布蘭特正2,12,0,12,凱基-林口,2024-11-18,9257
6153,嘉聯益,12,0,12,凱基-林口,2024-11-18,9257
2881,富邦金,13,1,12,凱基-林口,2024-11-18,9257
00952,凱基台灣AI50,11,0,11,凱基-林口,2024-11-18,9257
2010,春源,15,4,11,凱基-林口,2024-11-18,9257
2314,台揚,11,0,11,凱基-林口,2024-11-18,9257
2330,台積電,12,1,11,凱基-林口,2024-11-18,9257
2356,英業達,29,19,10,凱基-林口,2024-11-18,9257
5515,建國,10,0,10,凱基-林口,2024-11-18,9257
1471,首利,10,0,10,凱基-林口,2024-11-18,9257
2012,春雨,10,0,10,凱基-林口,2024-11-18,9257
2905,三商,10,0,10,凱基-林口,2024-11-18,9257
3090,日電貿,10,0,10,凱基-林口,2024-11-18,9257
5425,台半,10,0,10,凱基-林口,2024-11-18,9257
5603,陸海,10,0,10,凱基-林口,2024-11-18,9257
6142,友勁,10,0,10,凱基-林口,2024-11-18,9257
6525,捷敏-KY,10,0,10,凱基-林口,2024-11-18,9257
8044,網家,17,7,10,凱基-林口,2024-11-18,9257
8429,金麗-KY,10,0,10,凱基-林口,2024-11-18,9257
00713,元大台灣高息低波,15,5,10,凱基-林口,2024-11-18,9257
00919,群益台灣精選高息,15,6,9,凱基-林口,2024-11-18,9257
3709,鑫聯大投控,9,0,9,凱基-林口,2024-11-18,9257
4729,熒茂,24,15,9,凱基-林口,2024-11-18,9257
00679B,元大美債20年,17,9,8,凱基-林口,2024-11-18,9257
1785,光洋科,9,1,8,凱基-林口,2024-11-18,9257
00680L,元大美債20正2,550,0,550,凱基-林口,2024-11-19,9257
00878,國泰永續高股息,107,3,104,凱基-林口,2024-11-19,9257
3162,精確,100,0,100,凱基-林口,2024-11-19,9257
2317,鴻海,70,10,60,凱基-林口,2024-11-19,9257
00937B,群益ESG投等債20,53,0,53,凱基-林口,2024-11-19,9257
00706L,期元大S＆P日圓正2,50,0,50,凱基-林口,2024-11-19,9257
4161,聿新科,35,0,35,凱基-林口,2024-11-19,9257
5243,乙盛-KY,55,23,32,凱基-林口,2024-11-19,9257
00687B,國泰20年美債,32,2,30,凱基-林口,2024-11-19,9257
0056,元大高股息,32,3,29,凱基-林口,2024-11-19,9257
8249,菱光,28,3,25,凱基-林口,2024-11-19,9257
00844B,新光15年IG金融債,22,0,22,凱基-林口,2024-11-19,9257
2353,宏��,21,1,20,凱基-林口,2024-11-19,9257
2397,友通,20,0,20,凱基-林口,2024-11-19,9257
6933,AMAX-KY,20,0,20,凱基-林口,2024-11-19,9257
00637L,元大滬深300正2,18,0,18,凱基-林口,2024-11-19,9257
2891,中信金,18,1,17,凱基-林口,2024-11-19,9257
2382,廣達,13,0,13,凱基-林口,2024-11-19,9257
00753L,中信中國50正2,19,6,13,凱基-林口,2024-11-19,9257
1220,台榮,12,0,12,凱基-林口,2024-11-19,9257
00882,中信中國高股息,11,0,11,凱基-林口,2024-11-19,9257
2401,凌陽,11,0,11,凱基-林口,2024-11-19,9257
3032,偉訓,73,62,11,凱基-林口,2024-11-19,9257
00632R,元大台灣50反1,30,20,10,凱基-林口,2024-11-19,9257
1449,佳和,11,1,10,凱基-林口,2024-11-19,9257
2030,彰源,10,0,10,凱基-林口,2024-11-19,9257
2486,一詮,22,12,10,凱基-林口,2024-11-19,9257
8404,百和興業-KY,10,0,10,凱基-林口,2024-11-19,9257
2618,長榮航,13,5,8,凱基-林口,2024-11-19,9257
4577,達航科技,13,5,8,凱基-林口,2024-11-19,9257
3231,緯創,11,3,8,凱基-林口,2024-11-19,9257
00892,富邦台灣半導體,7,0,7,凱基-林口,2024-11-19,9257
1301,台塑,7,0,7,凱基-林口,2024-11-19,9257
00662,富邦NASDAQ,6,0,6,凱基-林口,2024-11-19,9257
006208,富邦台50,23,17,6,凱基-林口,2024-11-19,9257
2887,台新金,6,0,6,凱基-林口,2024-11-19,9257
00887,永豐中國科技50大,5,0,5,凱基-林口,2024-11-19,9257
3481,群創,5,0,5,凱基-林口,2024-11-19,9257
3017,奇鋐,8,3,5,凱基-林口,2024-11-19,9257
3581,博磊,5,0,5,凱基-林口,2024-11-19,9257
5864,致和證,5,0,5,凱基-林口,2024-11-19,9257
8064,東捷,5,0,5,凱基-林口,2024-11-19,9257
1605,華新,6,2,4,凱基-林口,2024-11-19,9257
2329,華泰,7,3,4,凱基-林口,2024-11-19,9257
2506,太設,4,0,4,凱基-林口,2024-11-19,9257
1528,恩德,4,0,4,凱基-林口,2024-11-19,9257
00713,元大台灣高息低波,4,0,4,凱基-林口,2024-11-19,9257
9921,巨大,3,0,3,凱基-林口,2024-11-19,9257
00946,群益科技高息成長,3,0,3,凱基-林口,2024-11-19,9257
00891,中信關鍵半導體,4,1,3,凱基-林口,2024-11-19,9257
2356,英業達,191,25,166,凱基-林口,2024-11-20,9257
3209,全科,145,0,145,凱基-林口,2024-11-20,9257
00937B,群益ESG投等債20,137,20,117,凱基-林口,2024-11-20,9257
2354,鴻準,167,63,104,凱基-林口,2024-11-20,9257
8104,錸寶,100,6,94,凱基-林口,2024-11-20,9257
8070,長華*,55,0,55,凱基-林口,2024-11-20,9257
8249,菱光,52,1,51,凱基-林口,2024-11-20,9257
3706,神達,110,67,43,凱基-林口,2024-11-20,9257
2929,淘帝-KY,40,0,40,凱基-林口,2024-11-20,9257
5426,振發,33,1,32,凱基-林口,2024-11-20,9257
2303,聯電,23,0,23,凱基-林口,2024-11-20,9257
2324,仁寶,22,0,22,凱基-林口,2024-11-20,9257
2610,華航,43,23,20,凱基-林口,2024-11-20,9257
8429,金麗-KY,20,0,20,凱基-林口,2024-11-20,9257
5880,合庫金,19,0,19,凱基-林口,2024-11-20,9257
2603,長榮,18,1,17,凱基-林口,2024-11-20,9257
00720B,元大投資級公司債,16,0,16,凱基-林口,2024-11-20,9257
00844B,新光15年IG金融債,15,0,15,凱基-林口,2024-11-20,9257
1307,三芳,15,0,15,凱基-林口,2024-11-20,9257
1569,濱川,15,0,15,凱基-林口,2024-11-20,9257
2337,旺宏,15,0,15,凱基-林口,2024-11-20,9257
6188,廣明,15,0,15,凱基-林口,2024-11-20,9257
2353,宏��,12,0,12,凱基-林口,2024-11-20,9257
2317,鴻海,19,8,11,凱基-林口,2024-11-20,9257
00951,台新日本半導體,11,0,11,凱基-林口,2024-11-20,9257
00960,野村全球航運龍頭,11,0,11,凱基-林口,2024-11-20,9257
1229,聯華,11,0,11,凱基-林口,2024-11-20,9257
3060,銘異,11,0,11,凱基-林口,2024-11-20,9257
2880,華南金,11,0,11,凱基-林口,2024-11-20,9257
00929,復華台灣科技優息,10,0,10,凱基-林口,2024-11-20,9257
9933,中鼎,10,0,10,凱基-林口,2024-11-20,9257
8404,百和興業-KY,15,5,10,凱基-林口,2024-11-20,9257
9934,成霖,10,0,10,凱基-林口,2024-11-20,9257
1303,南亞,10,1,9,凱基-林口,2024-11-20,9257
2327,國巨,8,0,8,凱基-林口,2024-11-20,9257
00953B,群益優選非投等債,8,0,8,凱基-林口,2024-11-20,9257
2059,川湖,8,0,8,凱基-林口,2024-11-20,9257
2344,華邦電,8,0,8,凱基-林口,2024-11-20,9257
6546,正基,18,10,8,凱基-林口,2024-11-20,9257
00878,國泰永續高股息,8,1,7,凱基-林口,2024-11-20,9257
2330,台積電,7,0,7,凱基-林口,2024-11-20,9257
2363,矽統,8,1,7,凱基-林口,2024-11-20,9257
2409,友達,7,0,7,凱基-林口,2024-11-20,9257
1301,台塑,7,1,6,凱基-林口,2024-11-20,9257
1449,佳和,22,16,6,凱基-林口,2024-11-20,9257
1536,和大,6,0,6,凱基-林口,2024-11-20,9257
2328,廣宇,6,0,6,凱基-林口,2024-11-20,9257
2392,正崴,9,3,6,凱基-林口,2024-11-20,9257
3447,展達,7,1,6,凱基-林口,2024-11-20,9257
4979,華星光,6,1,5,凱基-林口,2024-11-20,9257
00632R,元大台灣50反1,190,0,190,凱基-林口,2024-11-21,9257
00637L,元大滬深300正2,110,0,110,凱基-林口,2024-11-21,9257
00878,國泰永續高股息,79,5,74,凱基-林口,2024-11-21,9257
3209,全科,72,0,72,凱基-林口,2024-11-21,9257
3211,順達,56,5,51,凱基-林口,2024-11-21,9257
6546,正基,45,0,45,凱基-林口,2024-11-21,9257
3230,錦明,40,1,39,凱基-林口,2024-11-21,9257
0056,元大高股息,35,0,35,凱基-林口,2024-11-21,9257
2312,金寶,54,20,34,凱基-林口,2024-11-21,9257
2317,鴻海,49,17,32,凱基-林口,2024-11-21,9257
00712,復華富時不動產,30,0,30,凱基-林口,2024-11-21,9257
00671R,富邦NASDAQ反1,30,0,30,凱基-林口,2024-11-21,9257
2612,中航,29,0,29,凱基-林口,2024-11-21,9257
00919,群益台灣精選高息,25,0,25,凱基-林口,2024-11-21,9257
2354,鴻準,40,17,23,凱基-林口,2024-11-21,9257
00915,凱基優選高股息30,20,0,20,凱基-林口,2024-11-21,9257
2885,元大金,23,3,20,凱基-林口,2024-11-21,9257
3545,敦泰,20,0,20,凱基-林口,2024-11-21,9257
4161,聿新科,20,0,20,凱基-林口,2024-11-21,9257
2303,聯電,30,10,20,凱基-林口,2024-11-21,9257
3032,偉訓,24,5,19,凱基-林口,2024-11-21,9257
6742,澤米,19,0,19,凱基-林口,2024-11-21,9257
2890,永豐金,17,0,17,凱基-林口,2024-11-21,9257
4536,拓凱,16,0,16,凱基-林口,2024-11-21,9257
3710,連展投控,15,0,15,凱基-林口,2024-11-21,9257
6188,廣明,15,0,15,凱基-林口,2024-11-21,9257
6805,富世達,13,1,12,凱基-林口,2024-11-21,9257
1532,勤美,11,0,11,凱基-林口,2024-11-21,9257
2467,志聖,13,2,11,凱基-林口,2024-11-21,9257
3013,晟銘電,11,1,10,凱基-林口,2024-11-21,9257
2301,光寶科,12,2,10,凱基-林口,2024-11-21,9257
2324,仁寶,10,0,10,凱基-林口,2024-11-21,9257
5907,大洋-KY,10,0,10,凱基-林口,2024-11-21,9257
6220,岳豐,10,0,10,凱基-林口,2024-11-21,9257
2881,富邦金,9,0,9,凱基-林口,2024-11-21,9257
00924,復華S＆P500成長,9,0,9,凱基-林口,2024-11-21,9257
2882,國泰金,8,0,8,凱基-林口,2024-11-21,9257
1442,名軒,7,0,7,凱基-林口,2024-11-21,9257
4987,科誠,7,0,7,凱基-林口,2024-11-21,9257
8249,菱光,9,2,7,凱基-林口,2024-11-21,9257
2330,台積電,8,1,7,凱基-林口,2024-11-21,9257
2308,台達電,6,0,6,凱基-林口,2024-11-21,9257
5609,中菲行,6,0,6,凱基-林口,2024-11-21,9257
0050,元大台灣50,6,0,6,凱基-林口,2024-11-21,9257
00713,元大台灣高息低波,5,0,5,凱基-林口,2024-11-21,9257
3017,奇鋐,5,0,5,凱基-林口,2024-11-21,9257
1809,中釉,5,0,5,凱基-林口,2024-11-21,9257
2305,全友,5,0,5,凱基-林口,2024-11-21,9257
2442,新美齊,5,0,5,凱基-林口,2024-11-21,9257
3047,訊舟,5,0,5,凱基-林口,2024-11-21,9257
8070,長華*,135,0,135,凱基-林口,2024-11-22,9257
2363,矽統,103,5,98,凱基-林口,2024-11-22,9257
6757,台灣虎航,74,0,74,凱基-林口,2024-11-22,9257
2371,大同,73,17,56,凱基-林口,2024-11-22,9257
2457,飛宏,47,0,47,凱基-林口,2024-11-22,9257
2392,正崴,50,7,43,凱基-林口,2024-11-22,9257
2354,鴻準,102,61,41,凱基-林口,2024-11-22,9257
912000,晨訊科-DR,43,3,40,凱基-林口,2024-11-22,9257
5426,振發,34,0,34,凱基-林口,2024-11-22,9257
5243,乙盛-KY,41,8,33,凱基-林口,2024-11-22,9257
00882,中信中國高股息,32,0,32,凱基-林口,2024-11-22,9257
00680L,元大美債20正2,31,0,31,凱基-林口,2024-11-22,9257
3501,維熹,30,0,30,凱基-林口,2024-11-22,9257
2201,裕隆,29,0,29,凱基-林口,2024-11-22,9257
9105,泰金寶-DR,87,58,29,凱基-林口,2024-11-22,9257
1536,和大,26,3,23,凱基-林口,2024-11-22,9257
00753L,中信中國50正2,26,5,21,凱基-林口,2024-11-22,9257
2609,陽明,175,154,21,凱基-林口,2024-11-22,9257
2397,友通,20,0,20,凱基-林口,2024-11-22,9257
6806,森崴能源,20,0,20,凱基-林口,2024-11-22,9257
8183,精星,20,0,20,凱基-林口,2024-11-22,9257
5309,系統電,31,12,19,凱基-林口,2024-11-22,9257
2020,美亞,14,0,14,凱基-林口,2024-11-22,9257
6282,康舒,14,1,13,凱基-林口,2024-11-22,9257
6558,興能高,18,5,13,凱基-林口,2024-11-22,9257
2603,長榮,11,0,11,凱基-林口,2024-11-22,9257
2471,資通,11,0,11,凱基-林口,2024-11-22,9257
2867,三商壽,11,0,11,凱基-林口,2024-11-22,9257
2543,皇昌,10,0,10,凱基-林口,2024-11-22,9257
00830,國泰費城半導體,10,0,10,凱基-林口,2024-11-22,9257
00637L,元大滬深300正2,10,0,10,凱基-林口,2024-11-22,9257
2887,台新金,10,0,10,凱基-林口,2024-11-22,9257
2929,淘帝-KY,10,0,10,凱基-林口,2024-11-22,9257
3062,建漢,11,1,10,凱基-林口,2024-11-22,9257
3265,台星科,10,0,10,凱基-林口,2024-11-22,9257
4557,永新-KY,10,0,10,凱基-林口,2024-11-22,9257
6190,萬泰科,10,0,10,凱基-林口,2024-11-22,9257
6591,動力-KY,10,0,10,凱基-林口,2024-11-22,9257
3211,順達,10,0,10,凱基-林口,2024-11-22,9257
3625,西勝,9,0,9,凱基-林口,2024-11-22,9257
3706,神達,27,18,9,凱基-林口,2024-11-22,9257
8358,金居,10,1,9,凱基-林口,2024-11-22,9257
00687B,國泰20年美債,9,0,9,凱基-林口,2024-11-22,9257
2303,聯電,10,2,8,凱基-林口,2024-11-22,9257
3323,加百裕,26,18,8,凱基-林口,2024-11-22,9257
00878,國泰永續高股息,9,1,8,凱基-林口,2024-11-22,9257
00887,永豐中國科技50大,7,0,7,凱基-林口,2024-11-22,9257
00907,永豐優息存股,10,3,7,凱基-林口,2024-11-22,9257
1216,統一,7,0,7,凱基-林口,2024-11-22,9257
2882,國泰金,6,0,6,凱基-林口,2024-11-22,9257
00680L,元大美債20正2,500,0,500,凱基-林口,2024-11-25,9257
00706L,期元大S＆P日圓正2,200,0,200,凱基-林口,2024-11-25,9257
00950B,凱基A級公司債,105,0,105,凱基-林口,2024-11-25,9257
6546,正基,86,1,85,凱基-林口,2024-11-25,9257
9105,泰金寶-DR,85,19,66,凱基-林口,2024-11-25,9257
8249,菱光,192,142,50,凱基-林口,2024-11-25,9257
00637L,元大滬深300正2,37,0,37,凱基-林口,2024-11-25,9257
2312,金寶,124,90,34,凱基-林口,2024-11-25,9257
00919,群益台灣精選高息,34,0,34,凱基-林口,2024-11-25,9257
2603,長榮,33,5,28,凱基-林口,2024-11-25,9257
2356,英業達,53,26,27,凱基-林口,2024-11-25,9257
3209,全科,24,0,24,凱基-林口,2024-11-25,9257
00878,國泰永續高股息,28,6,22,凱基-林口,2024-11-25,9257
6188,廣明,20,0,20,凱基-林口,2024-11-25,9257
00753L,中信中國50正2,20,0,20,凱基-林口,2024-11-25,9257
3492,長盛,19,0,19,凱基-林口,2024-11-25,9257
2885,元大金,18,0,18,凱基-林口,2024-11-25,9257
2388,威盛,27,10,17,凱基-林口,2024-11-25,9257
1815,富喬,71,54,17,凱基-林口,2024-11-25,9257
1102,亞泥,15,0,15,凱基-林口,2024-11-25,9257
2609,陽明,36,21,15,凱基-林口,2024-11-25,9257
1101,台泥,16,1,15,凱基-林口,2024-11-25,9257
2354,鴻準,121,107,14,凱基-林口,2024-11-25,9257
3189,景碩,13,0,13,凱基-林口,2024-11-25,9257
6742,澤米,13,0,13,凱基-林口,2024-11-25,9257
1802,台玻,52,40,12,凱基-林口,2024-11-25,9257
00940,元大台灣價值高息,10,0,10,凱基-林口,2024-11-25,9257
00935,野村臺灣新科技50,10,0,10,凱基-林口,2024-11-25,9257
1460,宏遠,10,0,10,凱基-林口,2024-11-25,9257
1528,恩德,10,0,10,凱基-林口,2024-11-25,9257
2103,台橡,10,0,10,凱基-林口,2024-11-25,9257
2867,三商壽,10,0,10,凱基-林口,2024-11-25,9257
3042,晶技,10,0,10,凱基-林口,2024-11-25,9257
3501,維熹,10,0,10,凱基-林口,2024-11-25,9257
5243,乙盛-KY,11,1,10,凱基-林口,2024-11-25,9257
6282,康舒,12,2,10,凱基-林口,2024-11-25,9257
6596,寬宏藝術,10,0,10,凱基-林口,2024-11-25,9257
2886,兆豐金,11,2,9,凱基-林口,2024-11-25,9257
2646,星宇航空,11,3,8,凱基-林口,2024-11-25,9257
2486,一詮,12,4,8,凱基-林口,2024-11-25,9257
3308,聯德,11,3,8,凱基-林口,2024-11-25,9257
2891,中信金,18,11,7,凱基-林口,2024-11-25,9257
3013,晟銘電,9,2,7,凱基-林口,2024-11-25,9257
00901,永豐智能車供應鏈,7,0,7,凱基-林口,2024-11-25,9257
2440,太空梭,7,0,7,凱基-林口,2024-11-25,9257
2801,彰銀,7,0,7,凱基-林口,2024-11-25,9257
00887,永豐中國科技50大,6,0,6,凱基-林口,2024-11-25,9257
3617,碩天,13,7,6,凱基-林口,2024-11-25,9257
6706,惠特,6,0,6,凱基-林口,2024-11-25,9257
00882,中信中國高股息,5,0,5,凱基-林口,2024-11-25,9257
00953B,群益優選非投等債,245,0,245,凱基-林口,2024-11-26,9257
1815,富喬,220,33,187,凱基-林口,2024-11-26,9257
00950B,凱基A級公司債,169,0,169,凱基-林口,2024-11-26,9257
2457,飛宏,130,2,128,凱基-林口,2024-11-26,9257
2929,淘帝-KY,101,10,91,凱基-林口,2024-11-26,9257
2317,鴻海,101,11,90,凱基-林口,2024-11-26,9257
1536,和大,124,45,79,凱基-林口,2024-11-26,9257
1101,台泥,75,1,74,凱基-林口,2024-11-26,9257
9105,泰金寶-DR,73,18,55,凱基-林口,2024-11-26,9257
00919,群益台灣精選高息,47,1,46,凱基-林口,2024-11-26,9257
0056,元大高股息,36,1,35,凱基-林口,2024-11-26,9257
00671R,富邦NASDAQ反1,30,0,30,凱基-林口,2024-11-26,9257
00632R,元大台灣50反1,30,0,30,凱基-林口,2024-11-26,9257
3162,精確,30,0,30,凱基-林口,2024-11-26,9257
00878,國泰永續高股息,26,0,26,凱基-林口,2024-11-26,9257
2845,遠東銀,25,0,25,凱基-林口,2024-11-26,9257
5488,松普,25,0,25,凱基-林口,2024-11-26,9257
2887,台新金,21,0,21,凱基-林口,2024-11-26,9257
1708,東鹼,20,0,20,凱基-林口,2024-11-26,9257
2417,圓剛,20,0,20,凱基-林口,2024-11-26,9257
2349,錸德,20,1,19,凱基-林口,2024-11-26,9257
6188,廣明,25,6,19,凱基-林口,2024-11-26,9257
5309,系統電,35,17,18,凱基-林口,2024-11-26,9257
2419,仲琦,19,3,16,凱基-林口,2024-11-26,9257
00712,復華富時不動產,15,0,15,凱基-林口,2024-11-26,9257
2547,日勝生,15,0,15,凱基-林口,2024-11-26,9257
3570,大塚,15,0,15,凱基-林口,2024-11-26,9257
00918,大華優利高填息30,14,0,14,凱基-林口,2024-11-26,9257
00951,台新日本半導體,24,10,14,凱基-林口,2024-11-26,9257
2609,陽明,20,6,14,凱基-林口,2024-11-26,9257
3515,華擎,17,3,14,凱基-林口,2024-11-26,9257
3231,緯創,13,1,12,凱基-林口,2024-11-26,9257
00960,野村全球航運龍頭,12,0,12,凱基-林口,2024-11-26,9257
3492,長盛,12,0,12,凱基-林口,2024-11-26,9257
8033,雷虎,12,0,12,凱基-林口,2024-11-26,9257
00909,國泰數位支付服務,12,1,11,凱基-林口,2024-11-26,9257
1524,耿鼎,23,12,11,凱基-林口,2024-11-26,9257
6546,正基,26,15,11,凱基-林口,2024-11-26,9257
00881,國泰台灣5G+,10,0,10,凱基-林口,2024-11-26,9257
00935,野村臺灣新科技50,10,0,10,凱基-林口,2024-11-26,9257
1709,和益,10,0,10,凱基-林口,2024-11-26,9257
4161,聿新科,10,0,10,凱基-林口,2024-11-26,9257
6134,萬旭,10,0,10,凱基-林口,2024-11-26,9257
2392,正崴,53,43,10,凱基-林口,2024-11-26,9257
2615,萬海,9,0,9,凱基-林口,2024-11-26,9257
3615,安可,11,2,9,凱基-林口,2024-11-26,9257
6215,和椿,9,0,9,凱基-林口,2024-11-26,9257
8374,羅昇,10,1,9,凱基-林口,2024-11-26,9257
3535,晶彩科,8,0,8,凱基-林口,2024-11-26,9257
2548,華固,8,0,8,凱基-林口,2024-11-26,9257
2317,鴻海,165,9,156,凱基-林口,2024-11-27,9257
0056,元大高股息,143,0,143,凱基-林口,2024-11-27,9257
00919,群益台灣精選高息,138,4,134,凱基-林口,2024-11-27,9257
00950B,凱基A級公司債,111,0,111,凱基-林口,2024-11-27,9257
3162,精確,110,1,109,凱基-林口,2024-11-27,9257
00953B,群益優選非投等債,102,0,102,凱基-林口,2024-11-27,9257
2363,矽統,102,2,100,凱基-林口,2024-11-27,9257
2929,淘帝-KY,100,1,99,凱基-林口,2024-11-27,9257
00878,國泰永續高股息,93,0,93,凱基-林口,2024-11-27,9257
4977,眾達-KY,91,0,91,凱基-林口,2024-11-27,9257
4510,高鋒,88,6,82,凱基-林口,2024-11-27,9257
00918,大華優利高填息30,79,1,78,凱基-林口,2024-11-27,9257
00946,群益科技高息成長,73,0,73,凱基-林口,2024-11-27,9257
2356,英業達,68,0,68,凱基-林口,2024-11-27,9257
3209,全科,50,0,50,凱基-林口,2024-11-27,9257
5225,東科-KY,51,1,50,凱基-林口,2024-11-27,9257
2303,聯電,46,0,46,凱基-林口,2024-11-27,9257
4161,聿新科,51,10,41,凱基-林口,2024-11-27,9257
2515,中工,60,20,40,凱基-林口,2024-11-27,9257
9945,潤泰新,35,0,35,凱基-林口,2024-11-27,9257
00881,國泰台灣5G+,34,0,34,凱基-林口,2024-11-27,9257
3211,順達,33,0,33,凱基-林口,2024-11-27,9257
2609,陽明,63,31,32,凱基-林口,2024-11-27,9257
4931,新盛力,31,0,31,凱基-林口,2024-11-27,9257
00632R,元大台灣50反1,30,0,30,凱基-林口,2024-11-27,9257
2603,長榮,43,13,30,凱基-林口,2024-11-27,9257
5603,陸海,28,0,28,凱基-林口,2024-11-27,9257
2520,冠德,27,0,27,凱基-林口,2024-11-27,9257
2457,飛宏,25,0,25,凱基-林口,2024-11-27,9257
6757,台灣虎航,22,0,22,凱基-林口,2024-11-27,9257
2881,富邦金,20,0,20,凱基-林口,2024-11-27,9257
1582,信錦,20,0,20,凱基-林口,2024-11-27,9257
2498,宏達電,21,1,20,凱基-林口,2024-11-27,9257
2344,華邦電,20,0,20,凱基-林口,2024-11-27,9257
3231,緯創,25,7,18,凱基-林口,2024-11-27,9257
1605,華新,17,0,17,凱基-林口,2024-11-27,9257
5213,亞昕,17,0,17,凱基-林口,2024-11-27,9257
1536,和大,53,37,16,凱基-林口,2024-11-27,9257
3450,聯鈞,24,8,16,凱基-林口,2024-11-27,9257
2330,台積電,18,3,15,凱基-林口,2024-11-27,9257
00935,野村臺灣新科技50,15,0,15,凱基-林口,2024-11-27,9257
1316,上曜,15,0,15,凱基-林口,2024-11-27,9257
3492,長盛,13,0,13,凱基-林口,2024-11-27,9257
00712,復華富時不動產,12,0,12,凱基-林口,2024-11-27,9257
3021,鴻名,14,2,12,凱基-林口,2024-11-27,9257
006208,富邦台50,12,0,12,凱基-林口,2024-11-27,9257
00715L,期街口布蘭特正2,11,0,11,凱基-林口,2024-11-27,9257
1449,佳和,11,0,11,凱基-林口,2024-11-27,9257
2641,正德,11,0,11,凱基-林口,2024-11-27,9257
3447,展達,11,0,11,凱基-林口,2024-11-27,9257
00950B,凱基A級公司債,430,0,430,凱基-林口,2024-11-28,9257
00680L,元大美債20正2,300,0,300,凱基-林口,2024-11-28,9257
2312,金寶,170,29,141,凱基-林口,2024-11-28,9257
00632R,元大台灣50反1,120,30,90,凱基-林口,2024-11-28,9257
2204,中華,95,11,84,凱基-林口,2024-11-28,9257
6546,正基,54,0,54,凱基-林口,2024-11-28,9257
2317,鴻海,62,12,50,凱基-林口,2024-11-28,9257
0056,元大高股息,84,35,49,凱基-林口,2024-11-28,9257
00929,復華台灣科技優息,42,1,41,凱基-林口,2024-11-28,9257
00919,群益台灣精選高息,59,26,33,凱基-林口,2024-11-28,9257
2354,鴻準,60,34,26,凱基-林口,2024-11-28,9257
00712,復華富時不動產,30,4,26,凱基-林口,2024-11-28,9257
2467,志聖,27,3,24,凱基-林口,2024-11-28,9257
00940,元大台灣價值高息,23,0,23,凱基-林口,2024-11-28,9257
00671R,富邦NASDAQ反1,20,0,20,凱基-林口,2024-11-28,9257
00701,國泰股利精選30,20,0,20,凱基-林口,2024-11-28,9257
3209,全科,20,0,20,凱基-林口,2024-11-28,9257
3037,欣興,32,14,18,凱基-林口,2024-11-28,9257
1708,東鹼,22,5,17,凱基-林口,2024-11-28,9257
2392,正崴,19,3,16,凱基-林口,2024-11-28,9257
1101,台泥,20,4,16,凱基-林口,2024-11-28,9257
2610,華航,21,5,16,凱基-林口,2024-11-28,9257
1449,佳和,17,2,15,凱基-林口,2024-11-28,9257
6220,岳豐,15,0,15,凱基-林口,2024-11-28,9257
5443,均豪,15,0,15,凱基-林口,2024-11-28,9257
00915,凱基優選高股息30,15,1,14,凱基-林口,2024-11-28,9257
00918,大華優利高填息30,15,1,14,凱基-林口,2024-11-28,9257
1536,和大,61,47,14,凱基-林口,2024-11-28,9257
2455,全新,18,5,13,凱基-林口,2024-11-28,9257
4161,聿新科,20,7,13,凱基-林口,2024-11-28,9257
6505,台塑化,13,0,13,凱基-林口,2024-11-28,9257
2646,星宇航空,12,0,12,凱基-林口,2024-11-28,9257
1802,台玻,12,0,12,凱基-林口,2024-11-28,9257
3665,貿聯-KY,12,0,12,凱基-林口,2024-11-28,9257
6727,亞泰金屬,11,0,11,凱基-林口,2024-11-28,9257
00891,中信關鍵半導體,10,0,10,凱基-林口,2024-11-28,9257
6223,旺矽,26,16,10,凱基-林口,2024-11-28,9257
1808,潤隆,10,0,10,凱基-林口,2024-11-28,9257
2359,所羅門,20,10,10,凱基-林口,2024-11-28,9257
2405,輔信,11,1,10,凱基-林口,2024-11-28,9257
2458,義隆,10,0,10,凱基-林口,2024-11-28,9257
6153,嘉聯益,10,0,10,凱基-林口,2024-11-28,9257
2383,台光電,10,1,9,凱基-林口,2024-11-28,9257
2344,華邦電,13,4,9,凱基-林口,2024-11-28,9257
00894,中信小資高價30,9,0,9,凱基-林口,2024-11-28,9257
1721,三晃,10,1,9,凱基-林口,2024-11-28,9257
6757,台灣虎航,9,0,9,凱基-林口,2024-11-28,9257
4927,泰鼎-KY,19,10,9,凱基-林口,2024-11-28,9257
2520,冠德,8,0,8,凱基-林口,2024-11-28,9257
1582,信錦,8,0,8,凱基-林口,2024-11-28,9257
00680L,元大美債20正2,450,0,450,凱基-林口,2024-11-29,9257
2929,淘帝-KY,402,0,402,凱基-林口,2024-11-29,9257
00919,群益台灣精選高息,82,5,77,凱基-林口,2024-11-29,9257
00922,國泰台灣領袖50,53,0,53,凱基-林口,2024-11-29,9257
00706L,期元大S＆P日圓正2,50,0,50,凱基-林口,2024-11-29,9257
8429,金麗-KY,50,0,50,凱基-林口,2024-11-29,9257
3162,精確,40,0,40,凱基-林口,2024-11-29,9257
1605,華新,33,0,33,凱基-林口,2024-11-29,9257
2392,正崴,50,17,33,凱基-林口,2024-11-29,9257
2344,華邦電,52,20,32,凱基-林口,2024-11-29,9257
9105,泰金寶-DR,47,15,32,凱基-林口,2024-11-29,9257
4161,聿新科,25,0,25,凱基-林口,2024-11-29,9257
2313,華通,20,2,18,凱基-林口,2024-11-29,9257
2891,中信金,18,0,18,凱基-林口,2024-11-29,9257
3481,群創,17,0,17,凱基-林口,2024-11-29,9257
8104,錸寶,36,20,16,凱基-林口,2024-11-29,9257
6546,正基,15,0,15,凱基-林口,2024-11-29,9257
1326,台化,13,0,13,凱基-林口,2024-11-29,9257
2886,兆豐金,12,0,12,凱基-林口,2024-11-29,9257
2834,臺企銀,14,3,11,凱基-林口,2024-11-29,9257
1102,亞泥,11,0,11,凱基-林口,2024-11-29,9257
1303,南亞,11,0,11,凱基-林口,2024-11-29,9257
2337,旺宏,21,10,11,凱基-林口,2024-11-29,9257
6530,創威,12,1,11,凱基-林口,2024-11-29,9257
00930,永豐ESG低碳高息,10,0,10,凱基-林口,2024-11-29,9257
00877,復華中國5G,10,0,10,凱基-林口,2024-11-29,9257
3466,德晉,10,0,10,凱基-林口,2024-11-29,9257
6127,九豪,10,0,10,凱基-林口,2024-11-29,9257
6505,台塑化,9,0,9,凱基-林口,2024-11-29,9257
2317,鴻海,15,6,9,凱基-林口,2024-11-29,9257
3450,聯鈞,19,10,9,凱基-林口,2024-11-29,9257
5213,亞昕,10,1,9,凱基-林口,2024-11-29,9257
00713,元大台灣高息低波,8,0,8,凱基-林口,2024-11-29,9257
3037,欣興,20,12,8,凱基-林口,2024-11-29,9257
1582,信錦,8,0,8,凱基-林口,2024-11-29,9257
6770,力積電,10,2,8,凱基-林口,2024-11-29,9257
2303,聯電,18,11,7,凱基-林口,2024-11-29,9257
00915,凱基優選高股息30,7,0,7,凱基-林口,2024-11-29,9257
2603,長榮,8,1,7,凱基-林口,2024-11-29,9257
6139,亞翔,8,1,7,凱基-林口,2024-11-29,9257
8028,昇陽半導體,7,0,7,凱基-林口,2024-11-29,9257
2609,陽明,12,5,7,凱基-林口,2024-11-29,9257
0056,元大高股息,39,32,7,凱基-林口,2024-11-29,9257
00953B,群益優選非投等債,6,0,6,凱基-林口,2024-11-29,9257
2002,中鋼,6,0,6,凱基-林口,2024-11-29,9257
2020,美亞,6,0,6,凱基-林口,2024-11-29,9257
3047,訊舟,6,0,6,凱基-林口,2024-11-29,9257
00662,富邦NASDAQ,5,0,5,凱基-林口,2024-11-29,9257
1444,力麗,5,0,5,凱基-林口,2024-11-29,9257
1904,正隆,5,0,5,凱基-林口,2024-11-29,9257
00687B,國泰20年美債,402,91,311,凱基-林口,2024-12-02,9257
2317,鴻海,220,9,211,凱基-林口,2024-12-02,9257
8429,金麗-KY,150,0,150,凱基-林口,2024-12-02,9257
1536,和大,239,102,137,凱基-林口,2024-12-02,9257
00918,大華優利高填息30,66,1,65,凱基-林口,2024-12-02,9257
2929,淘帝-KY,48,1,47,凱基-林口,2024-12-02,9257
00632R,元大台灣50反1,106,60,46,凱基-林口,2024-12-02,9257
2312,金寶,90,48,42,凱基-林口,2024-12-02,9257
2337,旺宏,52,16,36,凱基-林口,2024-12-02,9257
6546,正基,35,2,33,凱基-林口,2024-12-02,9257
3706,神達,50,22,28,凱基-林口,2024-12-02,9257
00930,永豐ESG低碳高息,24,0,24,凱基-林口,2024-12-02,9257
3048,益登,25,1,24,凱基-林口,2024-12-02,9257
4726,永昕,24,0,24,凱基-林口,2024-12-02,9257
00915,凱基優選高股息30,22,0,22,凱基-林口,2024-12-02,9257
3260,威剛,21,0,21,凱基-林口,2024-12-02,9257
00932,兆豐永續高息等權,18,0,18,凱基-林口,2024-12-02,9257
00679B,元大美債20年,30,12,18,凱基-林口,2024-12-02,9257
2495,普安,15,0,15,凱基-林口,2024-12-02,9257
2520,冠德,17,2,15,凱基-林口,2024-12-02,9257
4161,聿新科,15,0,15,凱基-林口,2024-12-02,9257
5465,富驊,15,0,15,凱基-林口,2024-12-02,9257
1449,佳和,14,1,13,凱基-林口,2024-12-02,9257
5328,華容,15,3,12,凱基-林口,2024-12-02,9257
3231,緯創,11,0,11,凱基-林口,2024-12-02,9257
2399,映泰,21,10,11,凱基-林口,2024-12-02,9257
6606,建德工業,11,0,11,凱基-林口,2024-12-02,9257
2367,燿華,11,0,11,凱基-林口,2024-12-02,9257
6505,台塑化,12,2,10,凱基-林口,2024-12-02,9257
8033,雷虎,10,0,10,凱基-林口,2024-12-02,9257
1591,駿吉-KY,10,0,10,凱基-林口,2024-12-02,9257
2438,翔耀,10,0,10,凱基-林口,2024-12-02,9257
2886,兆豐金,10,0,10,凱基-林口,2024-12-02,9257
4123,晟德,12,2,10,凱基-林口,2024-12-02,9257
6160,欣技,10,0,10,凱基-林口,2024-12-02,9257
8249,菱光,11,2,9,凱基-林口,2024-12-02,9257
1815,富喬,39,31,8,凱基-林口,2024-12-02,9257
8059,凱碩,8,0,8,凱基-林口,2024-12-02,9257
2891,中信金,50,42,8,凱基-林口,2024-12-02,9257
1301,台塑,10,4,6,凱基-林口,2024-12-02,9257
00885,富邦越南,10,4,6,凱基-林口,2024-12-02,9257
00830,國泰費城半導體,6,0,6,凱基-林口,2024-12-02,9257
2548,華固,6,0,6,凱基-林口,2024-12-02,9257
3211,順達,17,11,6,凱基-林口,2024-12-02,9257
3323,加百裕,34,28,6,凱基-林口,2024-12-02,9257
3520,華盈,6,0,6,凱基-林口,2024-12-02,9257
6118,建達,6,0,6,凱基-林口,2024-12-02,9257
8028,昇陽半導體,11,5,6,凱基-林口,2024-12-02,9257
1326,台化,6,1,5,凱基-林口,2024-12-02,9257
00929,復華台灣科技優息,7,2,5,凱基-林口,2024-12-02,9257
2324,仁寶,150,1,149,凱基-林口,2024-12-03,9257
00919,群益台灣精選高息,132,2,130,凱基-林口,2024-12-03,9257
00953B,群益優選非投等債,100,0,100,凱基-林口,2024-12-03,9257
00918,大華優利高填息30,146,47,99,凱基-林口,2024-12-03,9257
00878,國泰永續高股息,51,5,46,凱基-林口,2024-12-03,9257
0056,元大高股息,50,6,44,凱基-林口,2024-12-03,9257
00662,富邦NASDAQ,39,0,39,凱基-林口,2024-12-03,9257
00945B,凱基美國非投等債,30,0,30,凱基-林口,2024-12-03,9257
2520,冠德,25,0,25,凱基-林口,2024-12-03,9257
3615,安可,25,0,25,凱基-林口,2024-12-03,9257
3380,明泰,30,7,23,凱基-林口,2024-12-03,9257
2317,鴻海,27,4,23,凱基-林口,2024-12-03,9257
2464,盟立,20,0,20,凱基-林口,2024-12-03,9257
2498,宏達電,23,3,20,凱基-林口,2024-12-03,9257
006208,富邦台50,19,1,18,凱基-林口,2024-12-03,9257
2204,中華,17,0,17,凱基-林口,2024-12-03,9257
4161,聿新科,83,67,16,凱基-林口,2024-12-03,9257
2929,淘帝-KY,21,6,15,凱基-林口,2024-12-03,9257
00639,富邦深100,12,0,12,凱基-林口,2024-12-03,9257
6274,台燿,22,10,12,凱基-林口,2024-12-03,9257
8027,鈦昇,15,3,12,凱基-林口,2024-12-03,9257
8028,昇陽半導體,12,0,12,凱基-林口,2024-12-03,9257
00915,凱基優選高股息30,11,0,11,凱基-林口,2024-12-03,9257
3447,展達,14,3,11,凱基-林口,2024-12-03,9257
3466,德晉,11,0,11,凱基-林口,2024-12-03,9257
3558,神準,19,8,11,凱基-林口,2024-12-03,9257
00715L,期街口布蘭特正2,10,0,10,凱基-林口,2024-12-03,9257
00706L,期元大S＆P日圓正2,10,0,10,凱基-林口,2024-12-03,9257
1229,聯華,10,0,10,凱基-林口,2024-12-03,9257
2388,威盛,11,1,10,凱基-林口,2024-12-03,9257
3374,精材,11,1,10,凱基-林口,2024-12-03,9257
3605,宏致,10,0,10,凱基-林口,2024-12-03,9257
2303,聯電,13,4,9,凱基-林口,2024-12-03,9257
6415,矽力*-KY,8,0,8,凱基-林口,2024-12-03,9257
2312,金寶,39,32,7,凱基-林口,2024-12-03,9257
2382,廣達,8,2,6,凱基-林口,2024-12-03,9257
5483,中美晶,6,0,6,凱基-林口,2024-12-03,9257
00887,永豐中國科技50大,7,1,6,凱基-林口,2024-12-03,9257
00909,國泰數位支付服務,6,0,6,凱基-林口,2024-12-03,9257
1605,華新,6,0,6,凱基-林口,2024-12-03,9257
2836,高雄銀,10,4,6,凱基-林口,2024-12-03,9257
3211,順達,69,63,6,凱基-林口,2024-12-03,9257
5309,系統電,8,2,6,凱基-林口,2024-12-03,9257
1402,遠東新,5,0,5,凱基-林口,2024-12-03,9257
1714,和桐,5,0,5,凱基-林口,2024-12-03,9257
2338,光罩,5,0,5,凱基-林口,2024-12-03,9257
3021,鴻名,5,0,5,凱基-林口,2024-12-03,9257
3060,銘異,5,0,5,凱基-林口,2024-12-03,9257
4977,眾達-KY,28,23,5,凱基-林口,2024-12-03,9257
6202,盛群,5,0,5,凱基-林口,2024-12-03,9257
6153,嘉聯益,172,0,172,凱基-林口,2024-12-04,9257
4977,眾達-KY,125,24,101,凱基-林口,2024-12-04,9257
5471,松翰,99,0,99,凱基-林口,2024-12-04,9257
6546,正基,85,6,79,凱基-林口,2024-12-04,9257
9105,泰金寶-DR,73,0,73,凱基-林口,2024-12-04,9257
00919,群益台灣精選高息,88,23,65,凱基-林口,2024-12-04,9257
00878,國泰永續高股息,54,7,47,凱基-林口,2024-12-04,9257
2610,華航,64,20,44,凱基-林口,2024-12-04,9257
2303,聯電,37,6,31,凱基-林口,2024-12-04,9257
2397,友通,30,0,30,凱基-林口,2024-12-04,9257
8089,康全電訊,30,0,30,凱基-林口,2024-12-04,9257
2344,華邦電,26,0,26,凱基-林口,2024-12-04,9257
2363,矽統,22,1,21,凱基-林口,2024-12-04,9257
00959B,大華投等美債15Y+,20,0,20,凱基-林口,2024-12-04,9257
8429,金麗-KY,20,0,20,凱基-林口,2024-12-04,9257
2883,凱基金,19,0,19,凱基-林口,2024-12-04,9257
3380,明泰,16,1,15,凱基-林口,2024-12-04,9257
4161,聿新科,15,0,15,凱基-林口,2024-12-04,9257
00915,凱基優選高股息30,13,0,13,凱基-林口,2024-12-04,9257
3593,力銘,13,0,13,凱基-林口,2024-12-04,9257
1785,光洋科,17,5,12,凱基-林口,2024-12-04,9257
00922,國泰台灣領袖50,12,1,11,凱基-林口,2024-12-04,9257
00673R,期元大S＆P原油反1,10,0,10,凱基-林口,2024-12-04,9257
00948B,中信優息投資級債,10,0,10,凱基-林口,2024-12-04,9257
1102,亞泥,10,0,10,凱基-林口,2024-12-04,9257
1217,愛之味,10,0,10,凱基-林口,2024-12-04,9257
2027,大成鋼,10,0,10,凱基-林口,2024-12-04,9257
3027,盛達,10,0,10,凱基-林口,2024-12-04,9257
3325,旭品,10,0,10,凱基-林口,2024-12-04,9257
8011,台通,10,0,10,凱基-林口,2024-12-04,9257
00713,元大台灣高息低波,9,0,9,凱基-林口,2024-12-04,9257
4979,華星光,30,21,9,凱基-林口,2024-12-04,9257
00712,復華富時不動產,10,2,8,凱基-林口,2024-12-04,9257
1714,和桐,7,0,7,凱基-林口,2024-12-04,9257
2419,仲琦,8,1,7,凱基-林口,2024-12-04,9257
2426,鼎元,7,0,7,凱基-林口,2024-12-04,9257
3105,穩懋,8,1,7,凱基-林口,2024-12-04,9257
6505,台塑化,7,0,7,凱基-林口,2024-12-04,9257
00636,國泰中國A50,6,0,6,凱基-林口,2024-12-04,9257
2543,皇昌,16,10,6,凱基-林口,2024-12-04,9257
8404,百和興業-KY,6,0,6,凱基-林口,2024-12-04,9257
3324,雙鴻,5,0,5,凱基-林口,2024-12-04,9257
1519,華城,5,0,5,凱基-林口,2024-12-04,9257
1570,力肯,5,0,5,凱基-林口,2024-12-04,9257
1591,駿吉-KY,5,0,5,凱基-林口,2024-12-04,9257
2516,新建,5,0,5,凱基-林口,2024-12-04,9257
2537,聯上發,5,0,5,凱基-林口,2024-12-04,9257
2891,中信金,5,0,5,凱基-林口,2024-12-04,9257
2929,淘帝-KY,20,15,5,凱基-林口,2024-12-04,9257
3466,德晉,10,5,5,凱基-林口,2024-12-04,9257
00688L,國泰20年美債正2,510,38,472,凱基-林口,2024-12-05,9257
4161,聿新科,320,0,320,凱基-林口,2024-12-05,9257
6153,嘉聯益,200,0,200,凱基-林口,2024-12-05,9257
2324,仁寶,131,0,131,凱基-林口,2024-12-05,9257
00918,大華優利高填息30,155,30,125,凱基-林口,2024-12-05,9257
00680L,元大美債20正2,105,11,94,凱基-林口,2024-12-05,9257
00953B,群益優選非投等債,100,7,93,凱基-林口,2024-12-05,9257
2610,華航,77,23,54,凱基-林口,2024-12-05,9257
3466,德晉,45,0,45,凱基-林口,2024-12-05,9257
00937B,群益ESG投等債20,41,0,41,凱基-林口,2024-12-05,9257
1570,力肯,41,0,41,凱基-林口,2024-12-05,9257
2392,正崴,40,13,27,凱基-林口,2024-12-05,9257
2489,瑞軒,25,0,25,凱基-林口,2024-12-05,9257
00712,復華富時不動產,24,0,24,凱基-林口,2024-12-05,9257
1815,富喬,48,25,23,凱基-林口,2024-12-05,9257
00950B,凱基A級公司債,20,0,20,凱基-林口,2024-12-05,9257
2317,鴻海,23,4,19,凱基-林口,2024-12-05,9257
5328,華容,34,16,18,凱基-林口,2024-12-05,9257
6505,台塑化,17,0,17,凱基-林口,2024-12-05,9257
6104,創惟,50,34,16,凱基-林口,2024-12-05,9257
2303,聯電,20,6,14,凱基-林口,2024-12-05,9257
1528,恩德,13,0,13,凱基-林口,2024-12-05,9257
1591,駿吉-KY,13,0,13,凱基-林口,2024-12-05,9257
00715L,期街口布蘭特正2,12,0,12,凱基-林口,2024-12-05,9257
5213,亞昕,12,0,12,凱基-林口,2024-12-05,9257
3231,緯創,24,13,11,凱基-林口,2024-12-05,9257
00662,富邦NASDAQ,11,0,11,凱基-林口,2024-12-05,9257
2431,聯昌,13,2,11,凱基-林口,2024-12-05,9257
3090,日電貿,57,46,11,凱基-林口,2024-12-05,9257
3189,景碩,11,0,11,凱基-林口,2024-12-05,9257
4961,天鈺,11,0,11,凱基-林口,2024-12-05,9257
1540,喬福,10,0,10,凱基-林口,2024-12-05,9257
3710,連展投控,10,0,10,凱基-林口,2024-12-05,9257
00713,元大台灣高息低波,9,0,9,凱基-林口,2024-12-05,9257
2375,凱美,23,15,8,凱基-林口,2024-12-05,9257
1714,和桐,10,2,8,凱基-林口,2024-12-05,9257
2477,美隆電,9,1,8,凱基-林口,2024-12-05,9257
4931,新盛力,23,15,8,凱基-林口,2024-12-05,9257
6274,台燿,9,1,8,凱基-林口,2024-12-05,9257
2344,華邦電,7,0,7,凱基-林口,2024-12-05,9257
2353,宏��,7,0,7,凱基-林口,2024-12-05,9257
2371,大同,10,3,7,凱基-林口,2024-12-05,9257
2520,冠德,7,0,7,凱基-林口,2024-12-05,9257
6706,惠特,12,5,7,凱基-林口,2024-12-05,9257
6558,興能高,40,33,7,凱基-林口,2024-12-05,9257
2409,友達,7,0,7,凱基-林口,2024-12-05,9257
1303,南亞,6,0,6,凱基-林口,2024-12-05,9257
00888,永豐台灣ESG,6,0,6,凱基-林口,2024-12-05,9257
00655L,國泰中國A50正2,6,0,6,凱基-林口,2024-12-05,9257
1802,台玻,6,0,6,凱基-林口,2024-12-05,9257
00953B,群益優選非投等債,332,0,332,凱基-林口,2024-12-06,9257
00918,大華優利高填息30,152,22,130,凱基-林口,2024-12-06,9257
00882,中信中國高股息,100,0,100,凱基-林口,2024-12-06,9257
6153,嘉聯益,100,0,100,凱基-林口,2024-12-06,9257
1612,宏泰,86,8,78,凱基-林口,2024-12-06,9257
1815,富喬,69,0,69,凱基-林口,2024-12-06,9257
00688L,國泰20年美債正2,50,0,50,凱基-林口,2024-12-06,9257
00636,國泰中國A50,50,0,50,凱基-林口,2024-12-06,9257
4979,華星光,65,16,49,凱基-林口,2024-12-06,9257
4161,聿新科,75,30,45,凱基-林口,2024-12-06,9257
00680L,元大美債20正2,51,15,36,凱基-林口,2024-12-06,9257
3257,虹冠電,28,1,27,凱基-林口,2024-12-06,9257
00962,台新AI優息動能,21,0,21,凱基-林口,2024-12-06,9257
00881,國泰台灣5G+,20,0,20,凱基-林口,2024-12-06,9257
2883,凱基金,35,15,20,凱基-林口,2024-12-06,9257
1447,力鵬,19,0,19,凱基-林口,2024-12-06,9257
3550,聯穎,18,1,17,凱基-林口,2024-12-06,9257
2317,鴻海,29,13,16,凱基-林口,2024-12-06,9257
2375,凱美,16,0,16,凱基-林口,2024-12-06,9257
00713,元大台灣高息低波,15,0,15,凱基-林口,2024-12-06,9257
2344,華邦電,16,1,15,凱基-林口,2024-12-06,9257
00712,復華富時不動產,14,0,14,凱基-林口,2024-12-06,9257
1294,漢田生技,14,0,14,凱基-林口,2024-12-06,9257
00715L,期街口布蘭特正2,12,0,12,凱基-林口,2024-12-06,9257
2305,全友,12,0,12,凱基-林口,2024-12-06,9257
3447,展達,15,3,12,凱基-林口,2024-12-06,9257
8011,台通,12,0,12,凱基-林口,2024-12-06,9257
8404,百和興業-KY,12,0,12,凱基-林口,2024-12-06,9257
4303,信立,11,0,11,凱基-林口,2024-12-06,9257
00650L,復華香港正2,10,0,10,凱基-林口,2024-12-06,9257
00937B,群益ESG投等債20,10,0,10,凱基-林口,2024-12-06,9257
00930,永豐ESG低碳高息,10,0,10,凱基-林口,2024-12-06,9257
1471,首利,10,0,10,凱基-林口,2024-12-06,9257
2363,矽統,10,0,10,凱基-林口,2024-12-06,9257
2388,威盛,10,0,10,凱基-林口,2024-12-06,9257
6160,欣技,10,0,10,凱基-林口,2024-12-06,9257
6962,ITH-KY,10,0,10,凱基-林口,2024-12-06,9257
8028,昇陽半導體,13,4,9,凱基-林口,2024-12-06,9257
00922,國泰台灣領袖50,8,0,8,凱基-林口,2024-12-06,9257
00909,國泰數位支付服務,8,0,8,凱基-林口,2024-12-06,9257
1605,華新,8,0,8,凱基-林口,2024-12-06,9257
3037,欣興,16,9,7,凱基-林口,2024-12-06,9257
3625,西勝,7,0,7,凱基-林口,2024-12-06,9257
4746,台耀,7,0,7,凱基-林口,2024-12-06,9257
6274,台燿,6,0,6,凱基-林口,2024-12-06,9257
6187,萬潤,6,0,6,凱基-林口,2024-12-06,9257
00706L,期元大S＆P日圓正2,10,4,6,凱基-林口,2024-12-06,9257
00687B,國泰20年美債,10,4,6,凱基-林口,2024-12-06,9257
2636,台驊控股,6,0,6,凱基-林口,2024-12-06,9257
3059,華晶科,6,0,6,凱基-林口,2024-12-06,9257
2324,仁寶,404,11,393,凱基-林口,2024-12-09,9257
00937B,群益ESG投等債20,108,5,103,凱基-林口,2024-12-09,9257
00918,大華優利高填息30,92,0,92,凱基-林口,2024-12-09,9257
2363,矽統,100,10,90,凱基-林口,2024-12-09,9257
00915,凱基優選高股息30,85,0,85,凱基-林口,2024-12-09,9257
3484,崧騰,83,4,79,凱基-林口,2024-12-09,9257
2317,鴻海,83,11,72,凱基-林口,2024-12-09,9257
3211,順達,70,10,60,凱基-林口,2024-12-09,9257
2231,為升,60,0,60,凱基-林口,2024-12-09,9257
1815,富喬,57,1,56,凱基-林口,2024-12-09,9257
4977,眾達-KY,85,32,53,凱基-林口,2024-12-09,9257
1464,得力,52,0,52,凱基-林口,2024-12-09,9257
6153,嘉聯益,50,0,50,凱基-林口,2024-12-09,9257
00909,國泰數位支付服務,48,0,48,凱基-林口,2024-12-09,9257
00959B,大華投等美債15Y+,40,0,40,凱基-林口,2024-12-09,9257
00878,國泰永續高股息,37,0,37,凱基-林口,2024-12-09,9257
1524,耿鼎,42,5,37,凱基-林口,2024-12-09,9257
6752,叡揚,35,0,35,凱基-林口,2024-12-09,9257
2427,三商電,30,0,30,凱基-林口,2024-12-09,9257
1326,台化,32,3,29,凱基-林口,2024-12-09,9257
6962,ITH-KY,27,0,27,凱基-林口,2024-12-09,9257
00919,群益台灣精選高息,28,2,26,凱基-林口,2024-12-09,9257
00713,元大台灣高息低波,25,1,24,凱基-林口,2024-12-09,9257
2468,華經,47,23,24,凱基-林口,2024-12-09,9257
00715L,期街口布蘭特正2,21,0,21,凱基-林口,2024-12-09,9257
3265,台星科,21,0,21,凱基-林口,2024-12-09,9257
2349,錸德,21,1,20,凱基-林口,2024-12-09,9257
1455,集盛,19,0,19,凱基-林口,2024-12-09,9257
6684,安格,28,10,18,凱基-林口,2024-12-09,9257
00662,富邦NASDAQ,17,0,17,凱基-林口,2024-12-09,9257
6546,正基,29,13,16,凱基-林口,2024-12-09,9257
1904,正隆,15,0,15,凱基-林口,2024-12-09,9257
3712,永崴投控,15,0,15,凱基-林口,2024-12-09,9257
6112,邁達特,19,4,15,凱基-林口,2024-12-09,9257
00665L,富邦�琤肭磪囓�2,19,5,14,凱基-林口,2024-12-09,9257
2362,藍天,15,1,14,凱基-林口,2024-12-09,9257
2399,映泰,18,4,14,凱基-林口,2024-12-09,9257
4953,緯軟,13,1,12,凱基-林口,2024-12-09,9257
3088,艾訊,14,2,12,凱基-林口,2024-12-09,9257
6505,台塑化,12,0,12,凱基-林口,2024-12-09,9257
1708,東鹼,21,10,11,凱基-林口,2024-12-09,9257
1216,統一,11,0,11,凱基-林口,2024-12-09,9257
6869,雲豹能源,11,0,11,凱基-林口,2024-12-09,9257
2405,輔信,10,0,10,凱基-林口,2024-12-09,9257
00670L,富邦NASDAQ正2,10,0,10,凱基-林口,2024-12-09,9257
00655L,國泰中國A50正2,10,0,10,凱基-林口,2024-12-09,9257
00877,復華中國5G,10,0,10,凱基-林口,2024-12-09,9257
00953B,群益優選非投等債,10,0,10,凱基-林口,2024-12-09,9257
1532,勤美,10,0,10,凱基-林口,2024-12-09,9257
3447,展達,10,0,10,凱基-林口,2024-12-09,9257
1220,台榮,300,4,296,凱基-林口,2024-12-10,9257
8429,金麗-KY,205,0,205,凱基-林口,2024-12-10,9257
2929,淘帝-KY,205,10,195,凱基-林口,2024-12-10,9257
00643,群益深証中小,100,0,100,凱基-林口,2024-12-10,9257
1605,華新,103,12,91,凱基-林口,2024-12-10,9257
2547,日勝生,80,0,80,凱基-林口,2024-12-10,9257
2317,鴻海,90,25,65,凱基-林口,2024-12-10,9257
1536,和大,60,0,60,凱基-林口,2024-12-10,9257
4977,眾達-KY,90,39,51,凱基-林口,2024-12-10,9257
8183,精星,50,0,50,凱基-林口,2024-12-10,9257
2609,陽明,75,25,50,凱基-林口,2024-12-10,9257
5426,振發,39,0,39,凱基-林口,2024-12-10,9257
6546,正基,42,5,37,凱基-林口,2024-12-10,9257
00713,元大台灣高息低波,30,0,30,凱基-林口,2024-12-10,9257
00918,大華優利高填息30,26,0,26,凱基-林口,2024-12-10,9257
00909,國泰數位支付服務,29,3,26,凱基-林口,2024-12-10,9257
00687B,國泰20年美債,26,0,26,凱基-林口,2024-12-10,9257
3706,神達,101,78,23,凱基-林口,2024-12-10,9257
5871,中租-KY,25,2,23,凱基-林口,2024-12-10,9257
00912,中信臺灣智慧50,20,0,20,凱基-林口,2024-12-10,9257
00948B,中信優息投資級債,20,0,20,凱基-林口,2024-12-10,9257
2323,中環,17,0,17,凱基-林口,2024-12-10,9257
2337,旺宏,16,0,16,凱基-林口,2024-12-10,9257
2886,兆豐金,16,0,16,凱基-林口,2024-12-10,9257
911608,明輝-DR,15,0,15,凱基-林口,2024-12-10,9257
2440,太空梭,12,0,12,凱基-林口,2024-12-10,9257
2520,冠德,15,3,12,凱基-林口,2024-12-10,9257
6175,立敦,12,0,12,凱基-林口,2024-12-10,9257
00915,凱基優選高股息30,15,3,12,凱基-林口,2024-12-10,9257
2375,凱美,11,0,11,凱基-林口,2024-12-10,9257
4161,聿新科,17,6,11,凱基-林口,2024-12-10,9257
6962,ITH-KY,11,0,11,凱基-林口,2024-12-10,9257
4303,信立,10,0,10,凱基-林口,2024-12-10,9257
00679B,元大美債20年,10,0,10,凱基-林口,2024-12-10,9257
00945B,凱基美國非投等債,10,0,10,凱基-林口,2024-12-10,9257
00953B,群益優選非投等債,10,0,10,凱基-林口,2024-12-10,9257
00959B,大華投等美債15Y+,10,0,10,凱基-林口,2024-12-10,9257
1540,喬福,11,1,10,凱基-林口,2024-12-10,9257
2897,王道銀行,10,0,10,凱基-林口,2024-12-10,9257
6863,永道-KY,10,0,10,凱基-林口,2024-12-10,9257
9904,寶成,10,0,10,凱基-林口,2024-12-10,9257
0056,元大高股息,10,1,9,凱基-林口,2024-12-10,9257
00922,國泰台灣領袖50,9,0,9,凱基-林口,2024-12-10,9257
6153,嘉聯益,10,1,9,凱基-林口,2024-12-10,9257
2603,長榮,14,5,9,凱基-林口,2024-12-10,9257
3037,欣興,9,1,8,凱基-林口,2024-12-10,9257
4767,誠泰科技,8,0,8,凱基-林口,2024-12-10,9257
4953,緯軟,12,4,8,凱基-林口,2024-12-10,9257
00919,群益台灣精選高息,20,13,7,凱基-林口,2024-12-10,9257
2615,萬海,8,1,7,凱基-林口,2024-12-10,9257
00919,群益台灣精選高息,356,2,354,凱基-林口,2024-12-11,9257
2897,王道銀行,180,0,180,凱基-林口,2024-12-11,9257
00940,元大台灣價值高息,85,4,81,凱基-林口,2024-12-11,9257
2883,凱基金,75,0,75,凱基-林口,2024-12-11,9257
2929,淘帝-KY,103,30,73,凱基-林口,2024-12-11,9257
00918,大華優利高填息30,68,0,68,凱基-林口,2024-12-11,9257
00715L,期街口布蘭特正2,100,41,59,凱基-林口,2024-12-11,9257
8429,金麗-KY,56,1,55,凱基-林口,2024-12-11,9257
00637L,元大滬深300正2,50,0,50,凱基-林口,2024-12-11,9257
1220,台榮,50,1,49,凱基-林口,2024-12-11,9257
00687B,國泰20年美債,38,0,38,凱基-林口,2024-12-11,9257
2468,華經,41,4,37,凱基-林口,2024-12-11,9257
1784,訊聯,31,0,31,凱基-林口,2024-12-11,9257
00671R,富邦NASDAQ反1,30,0,30,凱基-林口,2024-12-11,9257
6153,嘉聯益,30,0,30,凱基-林口,2024-12-11,9257
4977,眾達-KY,33,5,28,凱基-林口,2024-12-11,9257
6770,力積電,27,2,25,凱基-林口,2024-12-11,9257
2609,陽明,37,14,23,凱基-林口,2024-12-11,9257
1449,佳和,27,4,23,凱基-林口,2024-12-11,9257
00738U,期元大道瓊白銀,22,0,22,凱基-林口,2024-12-11,9257
00922,國泰台灣領袖50,21,0,21,凱基-林口,2024-12-11,9257
3515,華擎,26,5,21,凱基-林口,2024-12-11,9257
00939,統一台灣高息動能,21,0,21,凱基-林口,2024-12-11,9257
5426,振發,21,0,21,凱基-林口,2024-12-11,9257
9105,泰金寶-DR,21,0,21,凱基-林口,2024-12-11,9257
1447,力鵬,20,0,20,凱基-林口,2024-12-11,9257
5328,華容,25,5,20,凱基-林口,2024-12-11,9257
6112,邁達特,30,10,20,凱基-林口,2024-12-11,9257
0056,元大高股息,34,15,19,凱基-林口,2024-12-11,9257
3147,大綜,20,2,18,凱基-林口,2024-12-11,9257
2547,日勝生,20,3,17,凱基-林口,2024-12-11,9257
2354,鴻準,25,10,15,凱基-林口,2024-12-11,9257
2412,中華電,15,0,15,凱基-林口,2024-12-11,9257
2303,聯電,18,4,14,凱基-林口,2024-12-11,9257
2601,益航,14,0,14,凱基-林口,2024-12-11,9257
1455,集盛,13,0,13,凱基-林口,2024-12-11,9257
4953,緯軟,35,22,13,凱基-林口,2024-12-11,9257
2382,廣達,12,0,12,凱基-林口,2024-12-11,9257
2520,冠德,14,2,12,凱基-林口,2024-12-11,9257
5481,新華,12,0,12,凱基-林口,2024-12-11,9257
2610,華航,25,14,11,凱基-林口,2024-12-11,9257
3260,威剛,10,0,10,凱基-林口,2024-12-11,9257
2645,長榮航太,10,0,10,凱基-林口,2024-12-11,9257
00948B,中信優息投資級債,10,0,10,凱基-林口,2024-12-11,9257
00953B,群益優選非投等債,10,0,10,凱基-林口,2024-12-11,9257
00959B,大華投等美債15Y+,10,0,10,凱基-林口,2024-12-11,9257
2201,裕隆,10,0,10,凱基-林口,2024-12-11,9257
2342,茂矽,10,0,10,凱基-林口,2024-12-11,9257
2367,燿華,16,6,10,凱基-林口,2024-12-11,9257
2427,三商電,10,0,10,凱基-林口,2024-12-11,9257
00679B,元大美債20年,1299,90,1209,凱基-林口,2024-12-12,9257
00687B,國泰20年美債,254,0,254,凱基-林口,2024-12-12,9257
3013,晟銘電,97,10,87,凱基-林口,2024-12-12,9257
4979,華星光,80,13,67,凱基-林口,2024-12-12,9257
00937B,群益ESG投等債20,72,11,61,凱基-林口,2024-12-12,9257
0061,元大寶滬深,50,0,50,凱基-林口,2024-12-12,9257
00739,元大MSCI A股,50,0,50,凱基-林口,2024-12-12,9257
00940,元大台灣價值高息,66,22,44,凱基-林口,2024-12-12,9257
1524,耿鼎,44,1,43,凱基-林口,2024-12-12,9257
00857B,永豐20年美公債,41,0,41,凱基-林口,2024-12-12,9257
4161,聿新科,35,0,35,凱基-林口,2024-12-12,9257
00665L,富邦�琤肭磪囓�2,37,3,34,凱基-林口,2024-12-12,9257
4533,協易機,40,8,32,凱基-林口,2024-12-12,9257
2359,所羅門,32,2,30,凱基-林口,2024-12-12,9257
3706,神達,111,81,30,凱基-林口,2024-12-12,9257
2468,華經,36,9,27,凱基-林口,2024-12-12,9257
9105,泰金寶-DR,34,8,26,凱基-林口,2024-12-12,9257
6505,台塑化,25,0,25,凱基-林口,2024-12-12,9257
2845,遠東銀,24,0,24,凱基-林口,2024-12-12,9257
2471,資通,29,8,21,凱基-林口,2024-12-12,9257
00915,凱基優選高股息30,21,0,21,凱基-林口,2024-12-12,9257
00688L,國泰20年美債正2,21,0,21,凱基-林口,2024-12-12,9257
00772B,中信高評級公司債,21,0,21,凱基-林口,2024-12-12,9257
6546,正基,25,4,21,凱基-林口,2024-12-12,9257
00953B,群益優選非投等債,20,0,20,凱基-林口,2024-12-12,9257
2009,第一銅,20,0,20,凱基-林口,2024-12-12,9257
2317,鴻海,27,7,20,凱基-林口,2024-12-12,9257
2328,廣宇,21,3,18,凱基-林口,2024-12-12,9257
00713,元大台灣高息低波,15,0,15,凱基-林口,2024-12-12,9257
4577,達航科技,15,0,15,凱基-林口,2024-12-12,9257
2303,聯電,50,35,15,凱基-林口,2024-12-12,9257
3029,零壹,15,1,14,凱基-林口,2024-12-12,9257
00946,群益科技高息成長,14,0,14,凱基-林口,2024-12-12,9257
00725B,國泰投資級公司債,13,0,13,凱基-林口,2024-12-12,9257
2375,凱美,13,1,12,凱基-林口,2024-12-12,9257
4991,環宇-KY,74,62,12,凱基-林口,2024-12-12,9257
5328,華容,18,6,12,凱基-林口,2024-12-12,9257
6257,矽格,12,0,12,凱基-林口,2024-12-12,9257
00919,群益台灣精選高息,11,0,11,凱基-林口,2024-12-12,9257
1301,台塑,14,3,11,凱基-林口,2024-12-12,9257
0056,元大高股息,11,0,11,凱基-林口,2024-12-12,9257
00887,永豐中國科技50大,10,0,10,凱基-林口,2024-12-12,9257
1522,堤維西,11,1,10,凱基-林口,2024-12-12,9257
2402,毅嘉,11,1,10,凱基-林口,2024-12-12,9257
2897,王道銀行,10,0,10,凱基-林口,2024-12-12,9257
3037,欣興,19,9,10,凱基-林口,2024-12-12,9257
6689,伊雲谷,10,0,10,凱基-林口,2024-12-12,9257
6807,峰源-KY,10,0,10,凱基-林口,2024-12-12,9257
2515,中工,9,0,9,凱基-林口,2024-12-12,9257
6140,訊達,9,0,9,凱基-林口,2024-12-12,9257
00679B,元大美債20年,1215,0,1215,凱基-林口,2024-12-13,9257
2890,永豐金,701,0,701,凱基-林口,2024-12-13,9257
00919,群益台灣精選高息,284,2,282,凱基-林口,2024-12-13,9257
0056,元大高股息,189,1,188,凱基-林口,2024-12-13,9257
6546,正基,90,0,90,凱基-林口,2024-12-13,9257
00915,凱基優選高股息30,63,0,63,凱基-林口,2024-12-13,9257
2834,臺企銀,60,0,60,凱基-林口,2024-12-13,9257
8249,菱光,54,0,54,凱基-林口,2024-12-13,9257
3481,群創,50,0,50,凱基-林口,2024-12-13,9257
1220,台榮,50,0,50,凱基-林口,2024-12-13,9257
00918,大華優利高填息30,41,3,38,凱基-林口,2024-12-13,9257
8076,伍豐,32,0,32,凱基-林口,2024-12-13,9257
00671R,富邦NASDAQ反1,30,0,30,凱基-林口,2024-12-13,9257
5230,雷笛克光學,30,0,30,凱基-林口,2024-12-13,9257
2317,鴻海,57,28,29,凱基-林口,2024-12-13,9257
1785,光洋科,27,1,26,凱基-林口,2024-12-13,9257
4161,聿新科,26,0,26,凱基-林口,2024-12-13,9257
6505,台塑化,29,4,25,凱基-林口,2024-12-13,9257
00680L,元大美債20正2,25,0,25,凱基-林口,2024-12-13,9257
00937B,群益ESG投等債20,24,0,24,凱基-林口,2024-12-13,9257
00687B,國泰20年美債,32,9,23,凱基-林口,2024-12-13,9257
6153,嘉聯益,22,0,22,凱基-林口,2024-12-13,9257
2399,映泰,21,0,21,凱基-林口,2024-12-13,9257
1316,上曜,18,0,18,凱基-林口,2024-12-13,9257
5876,上海商銀,25,9,16,凱基-林口,2024-12-13,9257
1447,力鵬,15,0,15,凱基-林口,2024-12-13,9257
6215,和椿,33,18,15,凱基-林口,2024-12-13,9257
2618,長榮航,15,1,14,凱基-林口,2024-12-13,9257
3013,晟銘電,70,56,14,凱基-林口,2024-12-13,9257
2313,華通,17,4,13,凱基-林口,2024-12-13,9257
4540,全球傳動,32,20,12,凱基-林口,2024-12-13,9257
4979,華星光,78,67,11,凱基-林口,2024-12-13,9257
00952,凱基台灣AI50,11,0,11,凱基-林口,2024-12-13,9257
4576,大銀微系統,12,1,11,凱基-林口,2024-12-13,9257
3231,緯創,11,0,11,凱基-林口,2024-12-13,9257
1319,東陽,10,0,10,凱基-林口,2024-12-13,9257
00688L,國泰20年美債正2,10,0,10,凱基-林口,2024-12-13,9257
00932,兆豐永續高息等權,10,0,10,凱基-林口,2024-12-13,9257
1904,正隆,10,0,10,凱基-林口,2024-12-13,9257
2208,台船,10,0,10,凱基-林口,2024-12-13,9257
2328,廣宇,11,1,10,凱基-林口,2024-12-13,9257
2338,光罩,10,0,10,凱基-林口,2024-12-13,9257
2520,冠德,10,0,10,凱基-林口,2024-12-13,9257
2547,日勝生,10,0,10,凱基-林口,2024-12-13,9257
6160,欣技,10,0,10,凱基-林口,2024-12-13,9257
6191,精成科,10,0,10,凱基-林口,2024-12-13,9257
6443,元晶,10,0,10,凱基-林口,2024-12-13,9257
00878,國泰永續高股息,50,40,10,凱基-林口,2024-12-13,9257
4906,正文,9,0,9,凱基-林口,2024-12-13,9257
00881,國泰台灣5G+,10,1,9,凱基-林口,2024-12-13,9257
00937B,群益ESG投等債20,167,13,154,凱基-林口,2024-12-16,9257
2486,一詮,124,3,121,凱基-林口,2024-12-16,9257
6546,正基,122,1,121,凱基-林口,2024-12-16,9257
00919,群益台灣精選高息,114,5,109,凱基-林口,2024-12-16,9257
00918,大華優利高填息30,93,6,87,凱基-林口,2024-12-16,9257
2890,永豐金,76,0,76,凱基-林口,2024-12-16,9257
4977,眾達-KY,72,7,65,凱基-林口,2024-12-16,9257
00680L,元大美債20正2,57,0,57,凱基-林口,2024-12-16,9257
00687B,國泰20年美債,65,12,53,凱基-林口,2024-12-16,9257
00676R,富邦臺灣加權反1,50,0,50,凱基-林口,2024-12-16,9257
8429,金麗-KY,58,8,50,凱基-林口,2024-12-16,9257
2344,華邦電,50,1,49,凱基-林口,2024-12-16,9257
1815,富喬,57,12,45,凱基-林口,2024-12-16,9257
3622,洋華,40,0,40,凱基-林口,2024-12-16,9257
00878,國泰永續高股息,43,6,37,凱基-林口,2024-12-16,9257
00946,群益科技高息成長,36,0,36,凱基-林口,2024-12-16,9257
5443,均豪,31,0,31,凱基-林口,2024-12-16,9257
00905,FT臺灣Smart,30,0,30,凱基-林口,2024-12-16,9257
6188,廣明,30,0,30,凱基-林口,2024-12-16,9257
2609,陽明,32,4,28,凱基-林口,2024-12-16,9257
5328,華容,38,10,28,凱基-林口,2024-12-16,9257
0056,元大高股息,26,1,25,凱基-林口,2024-12-16,9257
5871,中租-KY,25,0,25,凱基-林口,2024-12-16,9257
00688L,國泰20年美債正2,30,7,23,凱基-林口,2024-12-16,9257
00712,復華富時不動產,20,0,20,凱基-林口,2024-12-16,9257
00953B,群益優選非投等債,20,0,20,凱基-林口,2024-12-16,9257
3231,緯創,26,7,19,凱基-林口,2024-12-16,9257
00940,元大台灣價值高息,23,4,19,凱基-林口,2024-12-16,9257
2002,中鋼,18,1,17,凱基-林口,2024-12-16,9257
00900,富邦特選高股息30,22,6,16,凱基-林口,2024-12-16,9257
00924,復華S＆P500成長,15,0,15,凱基-林口,2024-12-16,9257
5230,雷笛克光學,15,0,15,凱基-林口,2024-12-16,9257
00915,凱基優選高股息30,16,1,15,凱基-林口,2024-12-16,9257
00753L,中信中國50正2,14,0,14,凱基-林口,2024-12-16,9257
1314,中石化,12,0,12,凱基-林口,2024-12-16,9257
3558,神準,11,0,11,凱基-林口,2024-12-16,9257
00757,統一FANG+,11,0,11,凱基-林口,2024-12-16,9257
00637L,元大滬深300正2,11,0,11,凱基-林口,2024-12-16,9257
4503,金雨,12,1,11,凱基-林口,2024-12-16,9257
6505,台塑化,12,1,11,凱基-林口,2024-12-16,9257
2382,廣達,15,4,11,凱基-林口,2024-12-16,9257
00932,兆豐永續高息等權,10,0,10,凱基-林口,2024-12-16,9257
5351,鈺創,10,0,10,凱基-林口,2024-12-16,9257
00907,永豐優息存股,10,0,10,凱基-林口,2024-12-16,9257
00725B,國泰投資級公司債,10,0,10,凱基-林口,2024-12-16,9257
00948B,中信優息投資級債,10,0,10,凱基-林口,2024-12-16,9257
00959B,大華投等美債15Y+,10,0,10,凱基-林口,2024-12-16,9257
2231,為升,10,0,10,凱基-林口,2024-12-16,9257
2399,映泰,10,0,10,凱基-林口,2024-12-16,9257
6283,淳安,10,0,10,凱基-林口,2024-12-16,9257
00937B,群益ESG投等債20,112,1,111,凱基-林口,2024-12-17,9257
00915,凱基優選高股息30,76,1,75,凱基-林口,2024-12-17,9257
1314,中石化,71,2,69,凱基-林口,2024-12-17,9257
1101,台泥,59,0,59,凱基-林口,2024-12-17,9257
3622,洋華,56,0,56,凱基-林口,2024-12-17,9257
00950B,凱基A級公司債,51,0,51,凱基-林口,2024-12-17,9257
4979,華星光,68,20,48,凱基-林口,2024-12-17,9257
5426,振發,46,0,46,凱基-林口,2024-12-17,9257
00918,大華優利高填息30,52,11,41,凱基-林口,2024-12-17,9257
6546,正基,38,0,38,凱基-林口,2024-12-17,9257
2303,聯電,64,34,30,凱基-林口,2024-12-17,9257
00687B,國泰20年美債,57,30,27,凱基-林口,2024-12-17,9257
2002,中鋼,26,0,26,凱基-林口,2024-12-17,9257
00725B,國泰投資級公司債,25,0,25,凱基-林口,2024-12-17,9257
2359,所羅門,32,7,25,凱基-林口,2024-12-17,9257
2834,臺企銀,24,0,24,凱基-林口,2024-12-17,9257
1326,台化,24,2,22,凱基-林口,2024-12-17,9257
6505,台塑化,23,1,22,凱基-林口,2024-12-17,9257
00680L,元大美債20正2,20,0,20,凱基-林口,2024-12-17,9257
00882,中信中國高股息,20,0,20,凱基-林口,2024-12-17,9257
1536,和大,23,3,20,凱基-林口,2024-12-17,9257
2867,三商壽,26,6,20,凱基-林口,2024-12-17,9257
2890,永豐金,35,15,20,凱基-林口,2024-12-17,9257
1216,統一,17,0,17,凱基-林口,2024-12-17,9257
00713,元大台灣高息低波,17,0,17,凱基-林口,2024-12-17,9257
0056,元大高股息,44,28,16,凱基-林口,2024-12-17,9257
2609,陽明,25,9,16,凱基-林口,2024-12-17,9257
00772B,中信高評級公司債,15,0,15,凱基-林口,2024-12-17,9257
2382,廣達,16,1,15,凱基-林口,2024-12-17,9257
00940,元大台灣價值高息,16,1,15,凱基-林口,2024-12-17,9257
2317,鴻海,20,7,13,凱基-林口,2024-12-17,9257
4161,聿新科,33,20,13,凱基-林口,2024-12-17,9257
2882,國泰金,12,0,12,凱基-林口,2024-12-17,9257
2618,長榮航,23,11,12,凱基-林口,2024-12-17,9257
4503,金雨,12,0,12,凱基-林口,2024-12-17,9257
00688L,國泰20年美債正2,11,0,11,凱基-林口,2024-12-17,9257
5469,瀚宇博,11,0,11,凱基-林口,2024-12-17,9257
2880,華南金,10,0,10,凱基-林口,2024-12-17,9257
00887,永豐中國科技50大,10,0,10,凱基-林口,2024-12-17,9257
00902,中信電池及儲能,10,0,10,凱基-林口,2024-12-17,9257
00753L,中信中國50正2,10,0,10,凱基-林口,2024-12-17,9257
1785,光洋科,10,0,10,凱基-林口,2024-12-17,9257
3498,陽程,10,0,10,凱基-林口,2024-12-17,9257
3689,湧德,19,9,10,凱基-林口,2024-12-17,9257
5213,亞昕,10,0,10,凱基-林口,2024-12-17,9257
2062,橋椿,17,8,9,凱基-林口,2024-12-17,9257
2886,兆豐金,9,0,9,凱基-林口,2024-12-17,9257
1609,大亞,8,0,8,凱基-林口,2024-12-17,9257
2349,錸德,10,2,8,凱基-林口,2024-12-17,9257
4510,高鋒,14,6,8,凱基-林口,2024-12-17,9257
00680L,元大美債20正2,100,0,100,凱基-林口,2024-12-18,9257
00688L,國泰20年美債正2,100,0,100,凱基-林口,2024-12-18,9257
00937B,群益ESG投等債20,69,5,64,凱基-林口,2024-12-18,9257
00918,大華優利高填息30,65,2,63,凱基-林口,2024-12-18,9257
00706L,期元大S＆P日圓正2,50,0,50,凱基-林口,2024-12-18,9257
2929,淘帝-KY,55,10,45,凱基-林口,2024-12-18,9257
3376,新日興,46,4,42,凱基-林口,2024-12-18,9257
00919,群益台灣精選高息,46,14,32,凱基-林口,2024-12-18,9257
4952,凌通,33,2,31,凱基-林口,2024-12-18,9257
2520,冠德,27,0,27,凱基-林口,2024-12-18,9257
00878,國泰永續高股息,29,3,26,凱基-林口,2024-12-18,9257
2886,兆豐金,24,0,24,凱基-林口,2024-12-18,9257
00915,凱基優選高股息30,23,0,23,凱基-林口,2024-12-18,9257
2328,廣宇,23,0,23,凱基-林口,2024-12-18,9257
3450,聯鈞,23,4,19,凱基-林口,2024-12-18,9257
1785,光洋科,39,21,18,凱基-林口,2024-12-18,9257
3622,洋華,18,0,18,凱基-林口,2024-12-18,9257
2317,鴻海,23,6,17,凱基-林口,2024-12-18,9257
00679B,元大美債20年,36,20,16,凱基-林口,2024-12-18,9257
2408,南亞科,20,5,15,凱基-林口,2024-12-18,9257
2349,錸德,15,0,15,凱基-林口,2024-12-18,9257
4953,緯軟,20,5,15,凱基-林口,2024-12-18,9257
6742,澤米,15,0,15,凱基-林口,2024-12-18,9257
8404,百和興業-KY,15,0,15,凱基-林口,2024-12-18,9257
2888,新光金,13,0,13,凱基-林口,2024-12-18,9257
6282,康舒,12,0,12,凱基-林口,2024-12-18,9257
5871,中租-KY,11,0,11,凱基-林口,2024-12-18,9257
2354,鴻準,12,1,11,凱基-林口,2024-12-18,9257
00720B,元大投資級公司債,10,0,10,凱基-林口,2024-12-18,9257
00738U,期元大道瓊白銀,10,0,10,凱基-林口,2024-12-18,9257
00753L,中信中國50正2,10,0,10,凱基-林口,2024-12-18,9257
00751B,元大AAA至A公司債,10,0,10,凱基-林口,2024-12-18,9257
00635U,期元大S＆P黃金,10,0,10,凱基-林口,2024-12-18,9257
2002,中鋼,10,0,10,凱基-林口,2024-12-18,9257
2399,映泰,10,0,10,凱基-林口,2024-12-18,9257
3017,奇鋐,12,2,10,凱基-林口,2024-12-18,9257
6505,台塑化,10,1,9,凱基-林口,2024-12-18,9257
1326,台化,13,4,9,凱基-林口,2024-12-18,9257
5371,中光電,10,1,9,凱基-林口,2024-12-18,9257
6546,正基,20,11,9,凱基-林口,2024-12-18,9257
00950B,凱基A級公司債,8,0,8,凱基-林口,2024-12-18,9257
1213,大飲,8,0,8,凱基-林口,2024-12-18,9257
3665,貿聯-KY,7,0,7,凱基-林口,2024-12-18,9257
00922,國泰台灣領袖50,7,0,7,凱基-林口,2024-12-18,9257
1597,直得,11,4,7,凱基-林口,2024-12-18,9257
5474,聰泰,10,3,7,凱基-林口,2024-12-18,9257
3041,揚智,15,9,6,凱基-林口,2024-12-18,9257
2303,聯電,22,16,6,凱基-林口,2024-12-18,9257
2884,玉山金,6,0,6,凱基-林口,2024-12-18,9257
3059,華晶科,7,1,6,凱基-林口,2024-12-18,9257
00878,國泰永續高股息,141,0,141,凱基-林口,2024-12-19,9257
00918,大華優利高填息30,116,1,115,凱基-林口,2024-12-19,9257
00937B,群益ESG投等債20,105,0,105,凱基-林口,2024-12-19,9257
00950B,凱基A級公司債,116,40,76,凱基-林口,2024-12-19,9257
6558,興能高,51,10,41,凱基-林口,2024-12-19,9257
2317,鴻海,34,5,29,凱基-林口,2024-12-19,9257
00687B,國泰20年美債,26,0,26,凱基-林口,2024-12-19,9257
2609,陽明,38,14,24,凱基-林口,2024-12-19,9257
00712,復華富時不動產,24,1,23,凱基-林口,2024-12-19,9257
2303,聯電,23,1,22,凱基-林口,2024-12-19,9257
2409,友達,22,0,22,凱基-林口,2024-12-19,9257
2884,玉山金,22,0,22,凱基-林口,2024-12-19,9257
00902,中信電池及儲能,20,0,20,凱基-林口,2024-12-19,9257
00671R,富邦NASDAQ反1,20,0,20,凱基-林口,2024-12-19,9257
2890,永豐金,18,0,18,凱基-林口,2024-12-19,9257
2637,慧洋-KY,18,2,16,凱基-林口,2024-12-19,9257
2883,凱基金,16,0,16,凱基-林口,2024-12-19,9257
0056,元大高股息,15,0,15,凱基-林口,2024-12-19,9257
3323,加百裕,32,17,15,凱基-林口,2024-12-19,9257
00939,統一台灣高息動能,15,0,15,凱基-林口,2024-12-19,9257
00953B,群益優選非投等債,15,0,15,凱基-林口,2024-12-19,9257
5230,雷笛克光學,15,0,15,凱基-林口,2024-12-19,9257
6505,台塑化,15,0,15,凱基-林口,2024-12-19,9257
00830,國泰費城半導體,14,0,14,凱基-林口,2024-12-19,9257
1301,台塑,13,1,12,凱基-林口,2024-12-19,9257
00924,復華S＆P500成長,12,0,12,凱基-林口,2024-12-19,9257
8044,網家,14,2,12,凱基-林口,2024-12-19,9257
00909,國泰數位支付服務,11,0,11,凱基-林口,2024-12-19,9257
2618,長榮航,11,0,11,凱基-林口,2024-12-19,9257
00912,中信臺灣智慧50,11,0,11,凱基-林口,2024-12-19,9257
00915,凱基優選高股息30,10,0,10,凱基-林口,2024-12-19,9257
2886,兆豐金,10,0,10,凱基-林口,2024-12-19,9257
5880,合庫金,10,0,10,凱基-林口,2024-12-19,9257
00686R,群益臺灣加權反1,10,0,10,凱基-林口,2024-12-19,9257
1799,易威,10,0,10,凱基-林口,2024-12-19,9257
2250,IKKA-KY,11,1,10,凱基-林口,2024-12-19,9257
2359,所羅門,14,4,10,凱基-林口,2024-12-19,9257
6689,伊雲谷,10,0,10,凱基-林口,2024-12-19,9257
8404,百和興業-KY,10,0,10,凱基-林口,2024-12-19,9257
8429,金麗-KY,17,7,10,凱基-林口,2024-12-19,9257
00662,富邦NASDAQ,10,0,10,凱基-林口,2024-12-19,9257
1815,富喬,10,1,9,凱基-林口,2024-12-19,9257
2887,台新金,9,0,9,凱基-林口,2024-12-19,9257
4958,臻鼎-KY,11,2,9,凱基-林口,2024-12-19,9257
2880,華南金,8,0,8,凱基-林口,2024-12-19,9257
6274,台燿,9,1,8,凱基-林口,2024-12-19,9257
00933B,國泰10Y+金融債,8,0,8,凱基-林口,2024-12-19,9257
00966B,統一ESG投等債15,8,0,8,凱基-林口,2024-12-19,9257
00940,元大台灣價值高息,7,0,7,凱基-林口,2024-12-19,9257
2354,鴻準,19,12,7,凱基-林口,2024-12-19,9257
