Ticker,Name,buy,sell,diff,Branch,Date,Branch_Code
1467,南緯,60,0,60,凱基-頭份,2023-01-03,9296
1605,華新,213,171,42,凱基-頭份,2023-01-03,9296
2605,新興,20,0,20,凱基-頭份,2023-01-03,9296
1783,和康生,12,0,12,凱基-頭份,2023-01-03,9296
2615,萬海,15,3,12,凱基-頭份,2023-01-03,9296
00772B,中信高評級公司債,11,0,11,凱基-頭份,2023-01-03,9296
2888,新光金,11,0,11,凱基-頭份,2023-01-03,9296
00712,復華富時不動產,10,0,10,凱基-頭份,2023-01-03,9296
1102,亞泥,10,0,10,凱基-頭份,2023-01-03,9296
2007,燁興,10,0,10,凱基-頭份,2023-01-03,9296
3710,連展投控,10,0,10,凱基-頭份,2023-01-03,9296
2317,鴻海,13,4,9,凱基-頭份,2023-01-03,9296
2882,國泰金,15,6,9,凱基-頭份,2023-01-03,9296
6111,大宇資,14,5,9,凱基-頭份,2023-01-03,9296
00878,國泰永續高股息,9,1,8,凱基-頭份,2023-01-03,9296
00637L,元大滬深300正2,18,10,8,凱基-頭份,2023-01-03,9296
3515,華擎,8,0,8,凱基-頭份,2023-01-03,9296
4167,松瑞藥,10,3,7,凱基-頭份,2023-01-03,9296
4171,瑞基,8,2,6,凱基-頭份,2023-01-03,9296
5258,虹堡,8,2,6,凱基-頭份,2023-01-03,9296
00679B,元大美債20年,5,0,5,凱基-頭份,2023-01-03,9296
0056,元大高股息,5,1,4,凱基-頭份,2023-01-03,9296
00893,國泰智能電動車,4,0,4,凱基-頭份,2023-01-03,9296
2612,中航,4,0,4,凱基-頭份,2023-01-03,9296
4950,牧東,4,0,4,凱基-頭份,2023-01-03,9296
2636,台驊控股,3,0,3,凱基-頭份,2023-01-03,9296
1319,東陽,3,0,3,凱基-頭份,2023-01-03,9296
1752,南光,13,10,3,凱基-頭份,2023-01-03,9296
1720,生達,3,0,3,凱基-頭份,2023-01-03,9296
2312,金寶,3,0,3,凱基-頭份,2023-01-03,9296
2409,友達,4,1,3,凱基-頭份,2023-01-03,9296
2609,陽明,4,1,3,凱基-頭份,2023-01-03,9296
2845,遠東銀,3,0,3,凱基-頭份,2023-01-03,9296
2884,玉山金,3,0,3,凱基-頭份,2023-01-03,9296
3511,矽瑪,3,0,3,凱基-頭份,2023-01-03,9296
6499,益安,3,0,3,凱基-頭份,2023-01-03,9296
6550,北極星藥業-KY,3,0,3,凱基-頭份,2023-01-03,9296
1598,岱宇,2,0,2,凱基-頭份,2023-01-03,9296
1722,台肥,2,0,2,凱基-頭份,2023-01-03,9296
00632R,元大台灣50反1,27,25,2,凱基-頭份,2023-01-03,9296
2201,裕隆,10,8,2,凱基-頭份,2023-01-03,9296
2748,雲品,2,0,2,凱基-頭份,2023-01-03,9296
2834,臺企銀,2,0,2,凱基-頭份,2023-01-03,9296
3035,智原,8,6,2,凱基-頭份,2023-01-03,9296
3450,聯鈞,2,0,2,凱基-頭份,2023-01-03,9296
3481,群創,3,1,2,凱基-頭份,2023-01-03,9296
3564,其陽,2,0,2,凱基-頭份,2023-01-03,9296
3687,歐買尬,2,0,2,凱基-頭份,2023-01-03,9296
4746,台耀,2,0,2,凱基-頭份,2023-01-03,9296
6109,亞元,2,0,2,凱基-頭份,2023-01-03,9296
2025,千興,100,0,100,凱基-頭份,2023-01-04,9296
00673R,期元大S＆P原油反1,99,0,99,凱基-頭份,2023-01-04,9296
9907,統一實,96,0,96,凱基-頭份,2023-01-04,9296
00882,中信中國高股息,50,2,48,凱基-頭份,2023-01-04,9296
2443,昶虹,38,0,38,凱基-頭份,2023-01-04,9296
2605,新興,30,0,30,凱基-頭份,2023-01-04,9296
9103,美德醫療-DR,61,37,24,凱基-頭份,2023-01-04,9296
5015,華祺,21,0,21,凱基-頭份,2023-01-04,9296
4167,松瑞藥,31,11,20,凱基-頭份,2023-01-04,9296
5355,佳總,18,0,18,凱基-頭份,2023-01-04,9296
5353,台林,25,10,15,凱基-頭份,2023-01-04,9296
2497,怡利電,11,0,11,凱基-頭份,2023-01-04,9296
3710,連展投控,20,10,10,凱基-頭份,2023-01-04,9296
6241,易通展,10,0,10,凱基-頭份,2023-01-04,9296
3515,華擎,10,1,9,凱基-頭份,2023-01-04,9296
00885,富邦越南,11,3,8,凱基-頭份,2023-01-04,9296
1701,中化,7,0,7,凱基-頭份,2023-01-04,9296
3066,李洲,7,0,7,凱基-頭份,2023-01-04,9296
4979,華星光,7,0,7,凱基-頭份,2023-01-04,9296
00715L,期街口布蘭特正2,6,0,6,凱基-頭份,2023-01-04,9296
2328,廣宇,6,0,6,凱基-頭份,2023-01-04,9296
2317,鴻海,5,0,5,凱基-頭份,2023-01-04,9296
1459,聯發,5,0,5,凱基-頭份,2023-01-04,9296
2884,玉山金,7,2,5,凱基-頭份,2023-01-04,9296
5529,鉅陞,5,0,5,凱基-頭份,2023-01-04,9296
00642U,期元大S＆P石油,4,0,4,凱基-頭份,2023-01-04,9296
00679B,元大美債20年,4,0,4,凱基-頭份,2023-01-04,9296
2886,兆豐金,4,0,4,凱基-頭份,2023-01-04,9296
3682,亞太電,4,0,4,凱基-頭份,2023-01-04,9296
4747,強生,4,0,4,凱基-頭份,2023-01-04,9296
3047,訊舟,3,0,3,凱基-頭份,2023-01-04,9296
00751B,元大AAA至A公司債,3,0,3,凱基-頭份,2023-01-04,9296
00720B,元大投資級公司債,3,0,3,凱基-頭份,2023-01-04,9296
00881,國泰台灣5G+,3,0,3,凱基-頭份,2023-01-04,9296
2371,大同,3,0,3,凱基-頭份,2023-01-04,9296
2457,飛宏,13,10,3,凱基-頭份,2023-01-04,9296
2609,陽明,4,1,3,凱基-頭份,2023-01-04,9296
3272,東碩,3,0,3,凱基-頭份,2023-01-04,9296
4950,牧東,3,0,3,凱基-頭份,2023-01-04,9296
5315,光聯,3,0,3,凱基-頭份,2023-01-04,9296
6285,啟��,3,0,3,凱基-頭份,2023-01-04,9296
6512,啟發電,3,0,3,凱基-頭份,2023-01-04,9296
8481,政伸,3,0,3,凱基-頭份,2023-01-04,9296
0056,元大高股息,2,0,2,凱基-頭份,2023-01-04,9296
2017,官田鋼,10,8,2,凱基-頭份,2023-01-04,9296
1907,永豐餘,2,0,2,凱基-頭份,2023-01-04,9296
1514,亞力,2,0,2,凱基-頭份,2023-01-04,9296
1342,八貫,2,0,2,凱基-頭份,2023-01-04,9296
1734,杏輝,2,0,2,凱基-頭份,2023-01-04,9296
00631L,元大台灣50正2,2,0,2,凱基-頭份,2023-01-04,9296
00632R,元大台灣50反1,172,0,172,凱基-頭份,2023-01-05,9296
5351,鈺創,61,1,60,凱基-頭份,2023-01-05,9296
00753L,中信中國50正2,28,0,28,凱基-頭份,2023-01-05,9296
1701,中化,22,1,21,凱基-頭份,2023-01-05,9296
2605,新興,21,0,21,凱基-頭份,2023-01-05,9296
2609,陽明,14,1,13,凱基-頭份,2023-01-05,9296
00642U,期元大S＆P石油,11,0,11,凱基-頭份,2023-01-05,9296
1440,南紡,10,0,10,凱基-頭份,2023-01-05,9296
4161,聿新科,8,0,8,凱基-頭份,2023-01-05,9296
00715L,期街口布蘭特正2,57,50,7,凱基-頭份,2023-01-05,9296
8358,金居,6,0,6,凱基-頭份,2023-01-05,9296
1417,嘉裕,5,0,5,凱基-頭份,2023-01-05,9296
1342,八貫,5,0,5,凱基-頭份,2023-01-05,9296
1319,東陽,5,0,5,凱基-頭份,2023-01-05,9296
2614,東森,5,0,5,凱基-頭份,2023-01-05,9296
8171,天宇,6,1,5,凱基-頭份,2023-01-05,9296
006206,元大上證50,4,0,4,凱基-頭份,2023-01-05,9296
2401,凌陽,4,0,4,凱基-頭份,2023-01-05,9296
2615,萬海,4,0,4,凱基-頭份,2023-01-05,9296
3035,智原,16,12,4,凱基-頭份,2023-01-05,9296
2303,聯電,3,0,3,凱基-頭份,2023-01-05,9296
1760,寶齡富錦,3,0,3,凱基-頭份,2023-01-05,9296
00706L,期元大S＆P日圓正2,3,0,3,凱基-頭份,2023-01-05,9296
3356,奇偶,3,0,3,凱基-頭份,2023-01-05,9296
3576,聯合再生,3,0,3,凱基-頭份,2023-01-05,9296
5425,台半,4,1,3,凱基-頭份,2023-01-05,9296
6122,擎邦,3,0,3,凱基-頭份,2023-01-05,9296
6235,華孚,6,3,3,凱基-頭份,2023-01-05,9296
6237,驊訊,6,3,3,凱基-頭份,2023-01-05,9296
6244,茂迪,3,0,3,凱基-頭份,2023-01-05,9296
6499,益安,3,0,3,凱基-頭份,2023-01-05,9296
6547,高端疫苗,9,6,3,凱基-頭份,2023-01-05,9296
8046,南電,7,5,2,凱基-頭份,2023-01-05,9296
00891,中信關鍵半導體,2,0,2,凱基-頭份,2023-01-05,9296
1736,喬山,3,1,2,凱基-頭份,2023-01-05,9296
2382,廣達,2,0,2,凱基-頭份,2023-01-05,9296
3030,德律,2,0,2,凱基-頭份,2023-01-05,9296
3081,聯亞,2,0,2,凱基-頭份,2023-01-05,9296
3593,力銘,2,0,2,凱基-頭份,2023-01-05,9296
3694,海華,2,0,2,凱基-頭份,2023-01-05,9296
3704,合勤控,3,1,2,凱基-頭份,2023-01-05,9296
3712,永崴投控,2,0,2,凱基-頭份,2023-01-05,9296
4720,德淵,2,0,2,凱基-頭份,2023-01-05,9296
5014,建錩,2,0,2,凱基-頭份,2023-01-05,9296
5905,南仁湖,2,0,2,凱基-頭份,2023-01-05,9296
6118,建達,5,3,2,凱基-頭份,2023-01-05,9296
6207,雷科,2,0,2,凱基-頭份,2023-01-05,9296
6446,藥華藥,2,0,2,凱基-頭份,2023-01-05,9296
6465,威潤,2,0,2,凱基-頭份,2023-01-05,9296
6472,保瑞,3,1,2,凱基-頭份,2023-01-05,9296
9103,美德醫療-DR,33,0,33,凱基-頭份,2023-01-06,9296
00632R,元大台灣50反1,22,0,22,凱基-頭份,2023-01-06,9296
1440,南紡,20,0,20,凱基-頭份,2023-01-06,9296
6215,和椿,20,0,20,凱基-頭份,2023-01-06,9296
3481,群創,23,4,19,凱基-頭份,2023-01-06,9296
00902,中信電池及儲能,16,0,16,凱基-頭份,2023-01-06,9296
8044,網家,14,2,12,凱基-頭份,2023-01-06,9296
3592,瑞鼎,12,1,11,凱基-頭份,2023-01-06,9296
2380,虹光,9,0,9,凱基-頭份,2023-01-06,9296
5353,台林,9,0,9,凱基-頭份,2023-01-06,9296
00676R,富邦臺灣加權反1,8,0,8,凱基-頭份,2023-01-06,9296
2201,裕隆,15,8,7,凱基-頭份,2023-01-06,9296
2748,雲品,8,1,7,凱基-頭份,2023-01-06,9296
00682U,期元大美元指數,5,0,5,凱基-頭份,2023-01-06,9296
2465,麗臺,5,0,5,凱基-頭份,2023-01-06,9296
3515,華擎,5,0,5,凱基-頭份,2023-01-06,9296
4133,亞諾法,4,0,4,凱基-頭份,2023-01-06,9296
2317,鴻海,3,0,3,凱基-頭份,2023-01-06,9296
1459,聯發,3,0,3,凱基-頭份,2023-01-06,9296
1513,中興電,4,1,3,凱基-頭份,2023-01-06,9296
2886,兆豐金,3,0,3,凱基-頭份,2023-01-06,9296
3189,景碩,3,0,3,凱基-頭份,2023-01-06,9296
3545,敦泰,3,0,3,凱基-頭份,2023-01-06,9296
6499,益安,3,0,3,凱基-頭份,2023-01-06,9296
8033,雷虎,3,0,3,凱基-頭份,2023-01-06,9296
8940,新天地,3,0,3,凱基-頭份,2023-01-06,9296
9919,康那香,3,0,3,凱基-頭份,2023-01-06,9296
1529,樂事綠能,2,0,2,凱基-頭份,2023-01-06,9296
00706L,期元大S＆P日圓正2,2,0,2,凱基-頭份,2023-01-06,9296
00720B,元大投資級公司債,2,0,2,凱基-頭份,2023-01-06,9296
1701,中化,23,21,2,凱基-頭份,2023-01-06,9296
1736,喬山,2,0,2,凱基-頭份,2023-01-06,9296
2313,華通,2,0,2,凱基-頭份,2023-01-06,9296
2354,鴻準,2,0,2,凱基-頭份,2023-01-06,9296
2498,宏達電,6,4,2,凱基-頭份,2023-01-06,9296
2637,慧洋-KY,2,0,2,凱基-頭份,2023-01-06,9296
3006,晶豪科,2,0,2,凱基-頭份,2023-01-06,9296
3272,東碩,2,0,2,凱基-頭份,2023-01-06,9296
3715,定穎投控,2,0,2,凱基-頭份,2023-01-06,9296
4105,東洋,2,0,2,凱基-頭份,2023-01-06,9296
4747,強生,4,2,2,凱基-頭份,2023-01-06,9296
6552,易華電,2,0,2,凱基-頭份,2023-01-06,9296
6679,鈺太,2,0,2,凱基-頭份,2023-01-06,9296
9928,中視,2,0,2,凱基-頭份,2023-01-06,9296
3141,晶宏,2,0,2,凱基-頭份,2023-01-06,9296
00891,中信關鍵半導體,2,0,2,凱基-頭份,2023-01-06,9296
00751B,元大AAA至A公司債,1,0,1,凱基-頭份,2023-01-06,9296
6446,藥華藥,1,0,1,凱基-頭份,2023-01-06,9296
2603,長榮,1,0,1,凱基-頭份,2023-01-06,9296
00679B,元大美債20年,1,0,1,凱基-頭份,2023-01-06,9296
00673R,期元大S＆P原油反1,92,0,92,凱基-頭份,2023-01-09,9296
2882,國泰金,100,8,92,凱基-頭份,2023-01-09,9296
00632R,元大台灣50反1,159,85,74,凱基-頭份,2023-01-09,9296
1701,中化,38,0,38,凱基-頭份,2023-01-09,9296
00664R,國泰臺灣加權反1,30,0,30,凱基-頭份,2023-01-09,9296
4961,天鈺,26,4,22,凱基-頭份,2023-01-09,9296
1440,南紡,20,0,20,凱基-頭份,2023-01-09,9296
1605,華新,14,0,14,凱基-頭份,2023-01-09,9296
1783,和康生,14,0,14,凱基-頭份,2023-01-09,9296
2609,陽明,15,1,14,凱基-頭份,2023-01-09,9296
1220,台榮,10,0,10,凱基-頭份,2023-01-09,9296
2880,華南金,10,2,8,凱基-頭份,2023-01-09,9296
3217,優群,7,0,7,凱基-頭份,2023-01-09,9296
3272,東碩,9,2,7,凱基-頭份,2023-01-09,9296
8403,盛弘,7,0,7,凱基-頭份,2023-01-09,9296
3047,訊舟,6,0,6,凱基-頭份,2023-01-09,9296
2498,宏達電,7,1,6,凱基-頭份,2023-01-09,9296
3455,由田,7,1,6,凱基-頭份,2023-01-09,9296
6517,保勝光學,6,0,6,凱基-頭份,2023-01-09,9296
00701,國泰股利精選30,5,0,5,凱基-頭份,2023-01-09,9296
6122,擎邦,5,0,5,凱基-頭份,2023-01-09,9296
0056,元大高股息,16,12,4,凱基-頭份,2023-01-09,9296
2313,華通,4,0,4,凱基-頭份,2023-01-09,9296
2618,長榮航,5,1,4,凱基-頭份,2023-01-09,9296
2723,美食-KY,4,0,4,凱基-頭份,2023-01-09,9296
6589,台康生技,4,0,4,凱基-頭份,2023-01-09,9296
8996,高力,9,5,4,凱基-頭份,2023-01-09,9296
2317,鴻海,4,1,3,凱基-頭份,2023-01-09,9296
00893,國泰智能電動車,15,12,3,凱基-頭份,2023-01-09,9296
3059,華晶科,3,0,3,凱基-頭份,2023-01-09,9296
4126,太醫,3,0,3,凱基-頭份,2023-01-09,9296
5328,華容,3,0,3,凱基-頭份,2023-01-09,9296
6235,華孚,3,0,3,凱基-頭份,2023-01-09,9296
6546,正基,3,0,3,凱基-頭份,2023-01-09,9296
9934,成霖,3,0,3,凱基-頭份,2023-01-09,9296
00676R,富邦臺灣加權反1,2,0,2,凱基-頭份,2023-01-09,9296
1529,樂事綠能,2,0,2,凱基-頭份,2023-01-09,9296
1560,中砂,2,0,2,凱基-頭份,2023-01-09,9296
2312,金寶,7,5,2,凱基-頭份,2023-01-09,9296
2338,光罩,3,1,2,凱基-頭份,2023-01-09,9296
2359,所羅門,2,0,2,凱基-頭份,2023-01-09,9296
2615,萬海,2,0,2,凱基-頭份,2023-01-09,9296
2892,第一金,2,0,2,凱基-頭份,2023-01-09,9296
2916,滿心,2,0,2,凱基-頭份,2023-01-09,9296
3434,哲固,2,0,2,凱基-頭份,2023-01-09,9296
3479,安勤,3,1,2,凱基-頭份,2023-01-09,9296
3504,揚明光,3,1,2,凱基-頭份,2023-01-09,9296
3689,湧德,2,0,2,凱基-頭份,2023-01-09,9296
4128,中天,2,0,2,凱基-頭份,2023-01-09,9296
4768,晶呈科技,2,0,2,凱基-頭份,2023-01-09,9296
00632R,元大台灣50反1,111,0,111,凱基-頭份,2023-01-10,9296
2482,連宇,114,4,110,凱基-頭份,2023-01-10,9296
00715L,期街口布蘭特正2,50,0,50,凱基-頭份,2023-01-10,9296
1806,冠軍,50,0,50,凱基-頭份,2023-01-10,9296
00757,統一FANG+,41,0,41,凱基-頭份,2023-01-10,9296
00905,FT臺灣Smart,31,0,31,凱基-頭份,2023-01-10,9296
00673R,期元大S＆P原油反1,30,0,30,凱基-頭份,2023-01-10,9296
6138,茂達,30,0,30,凱基-頭份,2023-01-10,9296
3030,德律,16,0,16,凱基-頭份,2023-01-10,9296
1783,和康生,15,0,15,凱基-頭份,2023-01-10,9296
2338,光罩,10,0,10,凱基-頭份,2023-01-10,9296
00898,國泰基因免疫革命,10,0,10,凱基-頭份,2023-01-10,9296
1524,耿鼎,10,0,10,凱基-頭份,2023-01-10,9296
2443,昶虹,10,0,10,凱基-頭份,2023-01-10,9296
1535,中宇,8,0,8,凱基-頭份,2023-01-10,9296
00635U,期元大S＆P黃金,6,0,6,凱基-頭份,2023-01-10,9296
00893,國泰智能電動車,5,0,5,凱基-頭份,2023-01-10,9296
1789,神隆,5,0,5,凱基-頭份,2023-01-10,9296
2017,官田鋼,28,23,5,凱基-頭份,2023-01-10,9296
3062,建漢,5,0,5,凱基-頭份,2023-01-10,9296
4175,杏一,5,0,5,凱基-頭份,2023-01-10,9296
6142,友勁,5,0,5,凱基-頭份,2023-01-10,9296
8050,廣積,5,0,5,凱基-頭份,2023-01-10,9296
1308,亞聚,4,0,4,凱基-頭份,2023-01-10,9296
6220,岳豐,4,0,4,凱基-頭份,2023-01-10,9296
9962,有益,4,0,4,凱基-頭份,2023-01-10,9296
2892,第一金,3,0,3,凱基-頭份,2023-01-10,9296
1514,亞力,3,0,3,凱基-頭份,2023-01-10,9296
2380,虹光,3,0,3,凱基-頭份,2023-01-10,9296
2609,陽明,3,0,3,凱基-頭份,2023-01-10,9296
2610,華航,5,2,3,凱基-頭份,2023-01-10,9296
2615,萬海,14,11,3,凱基-頭份,2023-01-10,9296
2727,王品,4,1,3,凱基-頭份,2023-01-10,9296
3714,富采,5,2,3,凱基-頭份,2023-01-10,9296
4161,聿新科,5,2,3,凱基-頭份,2023-01-10,9296
1569,濱川,2,0,2,凱基-頭份,2023-01-10,9296
1529,樂事綠能,3,1,2,凱基-頭份,2023-01-10,9296
00642U,期元大S＆P石油,2,0,2,凱基-頭份,2023-01-10,9296
00670L,富邦NASDAQ正2,2,0,2,凱基-頭份,2023-01-10,9296
00895,富邦未來車,2,0,2,凱基-頭份,2023-01-10,9296
1304,台聚,2,0,2,凱基-頭份,2023-01-10,9296
2641,正德,2,0,2,凱基-頭份,2023-01-10,9296
3037,欣興,3,1,2,凱基-頭份,2023-01-10,9296
3413,京鼎,2,0,2,凱基-頭份,2023-01-10,9296
3454,晶睿,12,10,2,凱基-頭份,2023-01-10,9296
4167,松瑞藥,6,4,2,凱基-頭份,2023-01-10,9296
4503,金雨,2,0,2,凱基-頭份,2023-01-10,9296
4763,材料-KY,6,4,2,凱基-頭份,2023-01-10,9296
4915,致伸,2,0,2,凱基-頭份,2023-01-10,9296
6116,彩晶,2,0,2,凱基-頭份,2023-01-10,9296
5701,劍湖山,130,0,130,凱基-頭份,2023-01-11,9296
2610,華航,50,2,48,凱基-頭份,2023-01-11,9296
3704,合勤控,35,3,32,凱基-頭份,2023-01-11,9296
00632R,元大台灣50反1,30,0,30,凱基-頭份,2023-01-11,9296
00680L,元大美債20正2,20,0,20,凱基-頭份,2023-01-11,9296
00893,國泰智能電動車,20,0,20,凱基-頭份,2023-01-11,9296
1104,環泥,15,0,15,凱基-頭份,2023-01-11,9296
1609,大亞,11,0,11,凱基-頭份,2023-01-11,9296
1529,樂事綠能,13,2,11,凱基-頭份,2023-01-11,9296
4167,松瑞藥,11,0,11,凱基-頭份,2023-01-11,9296
1219,福壽,10,0,10,凱基-頭份,2023-01-11,9296
8933,愛地雅,20,10,10,凱基-頭份,2023-01-11,9296
2732,六角,9,1,8,凱基-頭份,2023-01-11,9296
3056,富華新,8,0,8,凱基-頭份,2023-01-11,9296
1584,精剛,16,9,7,凱基-頭份,2023-01-11,9296
2313,華通,7,0,7,凱基-頭份,2023-01-11,9296
3264,欣銓,7,0,7,凱基-頭份,2023-01-11,9296
2736,富野,6,0,6,凱基-頭份,2023-01-11,9296
3455,由田,6,0,6,凱基-頭份,2023-01-11,9296
6148,驊宏資,8,2,6,凱基-頭份,2023-01-11,9296
3202,樺晟,5,0,5,凱基-頭份,2023-01-11,9296
4747,強生,6,1,5,凱基-頭份,2023-01-11,9296
1701,中化,5,1,4,凱基-頭份,2023-01-11,9296
2017,官田鋼,10,6,4,凱基-頭份,2023-01-11,9296
2637,慧洋-KY,4,0,4,凱基-頭份,2023-01-11,9296
4133,亞諾法,5,1,4,凱基-頭份,2023-01-11,9296
6182,合晶,4,0,4,凱基-頭份,2023-01-11,9296
6533,晶心科,8,4,4,凱基-頭份,2023-01-11,9296
1101,台泥,3,0,3,凱基-頭份,2023-01-11,9296
2404,漢唐,3,0,3,凱基-頭份,2023-01-11,9296
2413,環科,3,0,3,凱基-頭份,2023-01-11,9296
2484,希華,3,0,3,凱基-頭份,2023-01-11,9296
3479,安勤,5,2,3,凱基-頭份,2023-01-11,9296
4916,事欣科,3,0,3,凱基-頭份,2023-01-11,9296
5009,榮剛,3,0,3,凱基-頭份,2023-01-11,9296
6527,明達醫,3,0,3,凱基-頭份,2023-01-11,9296
8420,明揚,3,0,3,凱基-頭份,2023-01-11,9296
2883,凱基金,2,0,2,凱基-頭份,2023-01-11,9296
1795,美時,5,3,2,凱基-頭份,2023-01-11,9296
00885,富邦越南,2,0,2,凱基-頭份,2023-01-11,9296
00679B,元大美債20年,2,0,2,凱基-頭份,2023-01-11,9296
00676R,富邦臺灣加權反1,2,0,2,凱基-頭份,2023-01-11,9296
2023,燁輝,2,0,2,凱基-頭份,2023-01-11,9296
2358,廷鑫,2,0,2,凱基-頭份,2023-01-11,9296
2465,麗臺,3,1,2,凱基-頭份,2023-01-11,9296
2497,怡利電,3,1,2,凱基-頭份,2023-01-11,9296
3044,健鼎,2,0,2,凱基-頭份,2023-01-11,9296
3105,穩懋,15,13,2,凱基-頭份,2023-01-11,9296
3520,華盈,2,0,2,凱基-頭份,2023-01-11,9296
5321,美而快,2,0,2,凱基-頭份,2023-01-11,9296
1304,台聚,40,0,40,凱基-頭份,2023-01-12,9296
00770,國泰北美科技,35,0,35,凱基-頭份,2023-01-12,9296
8420,明揚,28,3,25,凱基-頭份,2023-01-12,9296
00903,富邦元宇宙,21,0,21,凱基-頭份,2023-01-12,9296
9919,康那香,20,0,20,凱基-頭份,2023-01-12,9296
6245,立端,16,0,16,凱基-頭份,2023-01-12,9296
3710,連展投控,15,0,15,凱基-頭份,2023-01-12,9296
00673R,期元大S＆P原油反1,13,0,13,凱基-頭份,2023-01-12,9296
3141,晶宏,10,0,10,凱基-頭份,2023-01-12,9296
4979,華星光,18,8,10,凱基-頭份,2023-01-12,9296
6443,元晶,10,0,10,凱基-頭份,2023-01-12,9296
6609,瀧澤科,11,1,10,凱基-頭份,2023-01-12,9296
6113,亞矽,9,0,9,凱基-頭份,2023-01-12,9296
1783,和康生,7,0,7,凱基-頭份,2023-01-12,9296
1475,業旺,7,0,7,凱基-頭份,2023-01-12,9296
00895,富邦未來車,6,0,6,凱基-頭份,2023-01-12,9296
00632R,元大台灣50反1,6,0,6,凱基-頭份,2023-01-12,9296
6499,益安,6,0,6,凱基-頭份,2023-01-12,9296
1219,福壽,5,0,5,凱基-頭份,2023-01-12,9296
2409,友達,8,3,5,凱基-頭份,2023-01-12,9296
5907,大洋-KY,5,0,5,凱基-頭份,2023-01-12,9296
8081,致新,6,1,5,凱基-頭份,2023-01-12,9296
00642U,期元大S＆P石油,5,1,4,凱基-頭份,2023-01-12,9296
2017,官田鋼,10,6,4,凱基-頭份,2023-01-12,9296
6689,伊雲谷,4,0,4,凱基-頭份,2023-01-12,9296
2498,宏達電,8,5,3,凱基-頭份,2023-01-12,9296
1605,華新,7,4,3,凱基-頭份,2023-01-12,9296
00905,FT臺灣Smart,3,0,3,凱基-頭份,2023-01-12,9296
00713,元大台灣高息低波,3,0,3,凱基-頭份,2023-01-12,9296
2014,中鴻,4,1,3,凱基-頭份,2023-01-12,9296
2206,三陽工業,3,0,3,凱基-頭份,2023-01-12,9296
3576,聯合再生,4,1,3,凱基-頭份,2023-01-12,9296
5529,鉅陞,3,0,3,凱基-頭份,2023-01-12,9296
6235,華孚,6,3,3,凱基-頭份,2023-01-12,9296
6789,采鈺,9,6,3,凱基-頭份,2023-01-12,9296
8255,朋程,4,1,3,凱基-頭份,2023-01-12,9296
2317,鴻海,2,0,2,凱基-頭份,2023-01-12,9296
00900,富邦特選高股息30,2,0,2,凱基-頭份,2023-01-12,9296
00701,國泰股利精選30,2,0,2,凱基-頭份,2023-01-12,9296
2029,盛餘,2,0,2,凱基-頭份,2023-01-12,9296
2034,允強,2,0,2,凱基-頭份,2023-01-12,9296
2331,精英,2,0,2,凱基-頭份,2023-01-12,9296
2436,偉詮電,2,0,2,凱基-頭份,2023-01-12,9296
3027,盛達,2,0,2,凱基-頭份,2023-01-12,9296
3455,由田,2,0,2,凱基-頭份,2023-01-12,9296
3715,定穎投控,2,0,2,凱基-頭份,2023-01-12,9296
4128,中天,5,3,2,凱基-頭份,2023-01-12,9296
5483,中美晶,3,1,2,凱基-頭份,2023-01-12,9296
6196,帆宣,2,0,2,凱基-頭份,2023-01-12,9296
9933,中鼎,2,0,2,凱基-頭份,2023-01-12,9296
00632R,元大台灣50反1,22,0,22,凱基-頭份,2023-01-13,9296
00680L,元大美債20正2,20,0,20,凱基-頭份,2023-01-13,9296
00882,中信中國高股息,12,0,12,凱基-頭份,2023-01-13,9296
1752,南光,10,0,10,凱基-頭份,2023-01-13,9296
2009,第一銅,14,4,10,凱基-頭份,2023-01-13,9296
5351,鈺創,11,1,10,凱基-頭份,2023-01-13,9296
2603,長榮,6,0,6,凱基-頭份,2023-01-13,9296
2414,精技,5,0,5,凱基-頭份,2023-01-13,9296
3141,晶宏,5,0,5,凱基-頭份,2023-01-13,9296
4979,華星光,10,5,5,凱基-頭份,2023-01-13,9296
2317,鴻海,4,0,4,凱基-頭份,2023-01-13,9296
00642U,期元大S＆P石油,4,0,4,凱基-頭份,2023-01-13,9296
00676R,富邦臺灣加權反1,4,0,4,凱基-頭份,2023-01-13,9296
2376,技嘉,4,0,4,凱基-頭份,2023-01-13,9296
3189,景碩,4,0,4,凱基-頭份,2023-01-13,9296
6182,合晶,4,0,4,凱基-頭份,2023-01-13,9296
6196,帆宣,4,0,4,凱基-頭份,2023-01-13,9296
6609,瀧澤科,6,2,4,凱基-頭份,2023-01-13,9296
1513,中興電,3,0,3,凱基-頭份,2023-01-13,9296
1475,業旺,3,0,3,凱基-頭份,2023-01-13,9296
00921,兆豐龍頭等權重,3,0,3,凱基-頭份,2023-01-13,9296
1795,美時,13,10,3,凱基-頭份,2023-01-13,9296
3481,群創,4,1,3,凱基-頭份,2023-01-13,9296
8081,致新,3,0,3,凱基-頭份,2023-01-13,9296
00881,國泰台灣5G+,11,8,3,凱基-頭份,2023-01-13,9296
1101,台泥,8,6,2,凱基-頭份,2023-01-13,9296
00770,國泰北美科技,2,0,2,凱基-頭份,2023-01-13,9296
00920,富邦ESG綠色電力,2,0,2,凱基-頭份,2023-01-13,9296
1605,華新,2,0,2,凱基-頭份,2023-01-13,9296
1802,台玻,2,0,2,凱基-頭份,2023-01-13,9296
2454,聯發科,4,2,2,凱基-頭份,2023-01-13,9296
2891,中信金,2,0,2,凱基-頭份,2023-01-13,9296
2913,農林,2,0,2,凱基-頭份,2023-01-13,9296
3006,晶豪科,55,53,2,凱基-頭份,2023-01-13,9296
3128,昇銳,2,0,2,凱基-頭份,2023-01-13,9296
3455,由田,2,0,2,凱基-頭份,2023-01-13,9296
3558,神準,2,0,2,凱基-頭份,2023-01-13,9296
4952,凌通,2,0,2,凱基-頭份,2023-01-13,9296
5258,虹堡,2,0,2,凱基-頭份,2023-01-13,9296
5347,世界,2,0,2,凱基-頭份,2023-01-13,9296
6104,創惟,2,0,2,凱基-頭份,2023-01-13,9296
6148,驊宏資,2,0,2,凱基-頭份,2023-01-13,9296
6689,伊雲谷,3,1,2,凱基-頭份,2023-01-13,9296
6708,天擎,2,0,2,凱基-頭份,2023-01-13,9296
8038,長園科,2,0,2,凱基-頭份,2023-01-13,9296
4114,健喬,3,1,2,凱基-頭份,2023-01-13,9296
6806,森崴能源,1,0,1,凱基-頭份,2023-01-13,9296
2887,台新金,1,0,1,凱基-頭份,2023-01-13,9296
5880,合庫金,1,0,1,凱基-頭份,2023-01-13,9296
3008,大立光,1,0,1,凱基-頭份,2023-01-13,9296
4114,健喬,78,20,58,凱基-頭份,2023-01-16,9296
00878,國泰永續高股息,28,2,26,凱基-頭份,2023-01-16,9296
6770,力積電,15,0,15,凱基-頭份,2023-01-16,9296
00632R,元大台灣50反1,15,1,14,凱基-頭份,2023-01-16,9296
2610,華航,12,0,12,凱基-頭份,2023-01-16,9296
2009,第一銅,10,0,10,凱基-頭份,2023-01-16,9296
2358,廷鑫,14,4,10,凱基-頭份,2023-01-16,9296
2379,瑞昱,11,1,10,凱基-頭份,2023-01-16,9296
2401,凌陽,10,0,10,凱基-頭份,2023-01-16,9296
006206,元大上證50,5,0,5,凱基-頭份,2023-01-16,9296
4503,金雨,5,0,5,凱基-頭份,2023-01-16,9296
1101,台泥,11,7,4,凱基-頭份,2023-01-16,9296
2618,長榮航,6,2,4,凱基-頭份,2023-01-16,9296
2885,元大金,5,1,4,凱基-頭份,2023-01-16,9296
4736,泰博,4,0,4,凱基-頭份,2023-01-16,9296
8081,致新,4,0,4,凱基-頭份,2023-01-16,9296
1783,和康生,16,13,3,凱基-頭份,2023-01-16,9296
00900,富邦特選高股息30,3,0,3,凱基-頭份,2023-01-16,9296
00673R,期元大S＆P原油反1,3,0,3,凱基-頭份,2023-01-16,9296
00772B,中信高評級公司債,3,0,3,凱基-頭份,2023-01-16,9296
2436,偉詮電,3,0,3,凱基-頭份,2023-01-16,9296
3176,基亞,3,0,3,凱基-頭份,2023-01-16,9296
00731,復華富時高息低波,2,0,2,凱基-頭份,2023-01-16,9296
2380,虹光,2,0,2,凱基-頭份,2023-01-16,9296
2723,美食-KY,2,0,2,凱基-頭份,2023-01-16,9296
2884,玉山金,2,0,2,凱基-頭份,2023-01-16,9296
3030,德律,2,0,2,凱基-頭份,2023-01-16,9296
3588,通嘉,2,0,2,凱基-頭份,2023-01-16,9296
3693,營邦,5,3,2,凱基-頭份,2023-01-16,9296
3710,連展投控,2,0,2,凱基-頭份,2023-01-16,9296
3714,富采,3,1,2,凱基-頭份,2023-01-16,9296
4102,永日,2,0,2,凱基-頭份,2023-01-16,9296
4128,中天,2,0,2,凱基-頭份,2023-01-16,9296
6276,安鈦克,2,0,2,凱基-頭份,2023-01-16,9296
3264,欣銓,2,1,1,凱基-頭份,2023-01-16,9296
2317,鴻海,5,4,1,凱基-頭份,2023-01-16,9296
00679B,元大美債20年,1,0,1,凱基-頭份,2023-01-16,9296
1760,寶齡富錦,1,0,1,凱基-頭份,2023-01-16,9296
1314,中石化,1,0,1,凱基-頭份,2023-01-16,9296
1529,樂事綠能,1,0,1,凱基-頭份,2023-01-16,9296
1309,台達化,1,0,1,凱基-頭份,2023-01-16,9296
1308,亞聚,1,0,1,凱基-頭份,2023-01-16,9296
1103,嘉泥,1,0,1,凱基-頭份,2023-01-16,9296
1218,泰山,1,0,1,凱基-頭份,2023-01-16,9296
00701,國泰股利精選30,1,0,1,凱基-頭份,2023-01-16,9296
00770,國泰北美科技,1,0,1,凱基-頭份,2023-01-16,9296
2023,燁輝,1,0,1,凱基-頭份,2023-01-16,9296
2032,新鋼,1,0,1,凱基-頭份,2023-01-16,9296
2106,建大,1,0,1,凱基-頭份,2023-01-16,9296
2312,金寶,1,0,1,凱基-頭份,2023-01-16,9296
8403,盛弘,95,0,95,凱基-頭份,2023-01-17,9296
2637,慧洋-KY,65,0,65,凱基-頭份,2023-01-17,9296
2884,玉山金,55,0,55,凱基-頭份,2023-01-17,9296
00882,中信中國高股息,42,0,42,凱基-頭份,2023-01-17,9296
00830,國泰費城半導體,40,0,40,凱基-頭份,2023-01-17,9296
0050,元大台灣50,31,1,30,凱基-頭份,2023-01-17,9296
1309,台達化,20,0,20,凱基-頭份,2023-01-17,9296
3576,聯合再生,20,0,20,凱基-頭份,2023-01-17,9296
00905,FT臺灣Smart,12,0,12,凱基-頭份,2023-01-17,9296
4950,牧東,12,0,12,凱基-頭份,2023-01-17,9296
00878,國泰永續高股息,12,0,12,凱基-頭份,2023-01-17,9296
1560,中砂,11,0,11,凱基-頭份,2023-01-17,9296
1810,和成,10,0,10,凱基-頭份,2023-01-17,9296
2201,裕隆,25,15,10,凱基-頭份,2023-01-17,9296
4114,健喬,11,2,9,凱基-頭份,2023-01-17,9296
8420,明揚,9,0,9,凱基-頭份,2023-01-17,9296
0056,元大高股息,8,0,8,凱基-頭份,2023-01-17,9296
00888,永豐台灣ESG,8,0,8,凱基-頭份,2023-01-17,9296
1219,福壽,7,0,7,凱基-頭份,2023-01-17,9296
2618,長榮航,6,0,6,凱基-頭份,2023-01-17,9296
3704,合勤控,5,0,5,凱基-頭份,2023-01-17,9296
2029,盛餘,5,0,5,凱基-頭份,2023-01-17,9296
6664,群翊,5,0,5,凱基-頭份,2023-01-17,9296
5907,大洋-KY,4,0,4,凱基-頭份,2023-01-17,9296
6609,瀧澤科,7,3,4,凱基-頭份,2023-01-17,9296
2317,鴻海,3,0,3,凱基-頭份,2023-01-17,9296
00858,永豐美國500大,3,0,3,凱基-頭份,2023-01-17,9296
1809,中釉,3,0,3,凱基-頭份,2023-01-17,9296
1909,榮成,3,0,3,凱基-頭份,2023-01-17,9296
2371,大同,3,0,3,凱基-頭份,2023-01-17,9296
3701,大眾控,3,0,3,凱基-頭份,2023-01-17,9296
2002,中鋼,3,1,2,凱基-頭份,2023-01-17,9296
00772B,中信高評級公司債,2,0,2,凱基-頭份,2023-01-17,9296
1722,台肥,2,0,2,凱基-頭份,2023-01-17,9296
2324,仁寶,2,0,2,凱基-頭份,2023-01-17,9296
2414,精技,2,0,2,凱基-頭份,2023-01-17,9296
2609,陽明,2,0,2,凱基-頭份,2023-01-17,9296
2614,東森,2,0,2,凱基-頭份,2023-01-17,9296
2617,台航,2,0,2,凱基-頭份,2023-01-17,9296
3047,訊舟,2,0,2,凱基-頭份,2023-01-17,9296
3706,神達,2,0,2,凱基-頭份,2023-01-17,9296
5347,世界,17,15,2,凱基-頭份,2023-01-17,9296
6625,必應,2,0,2,凱基-頭份,2023-01-17,9296
1783,和康生,2,0,2,凱基-頭份,2023-01-17,9296
6712,長聖,1,0,1,凱基-頭份,2023-01-17,9296
2388,威盛,5,4,1,凱基-頭份,2023-01-17,9296
1605,華新,2,1,1,凱基-頭份,2023-01-17,9296
1522,堤維西,1,0,1,凱基-頭份,2023-01-17,9296
00683L,期元大美元指正2,1,0,1,凱基-頭份,2023-01-17,9296
00670L,富邦NASDAQ正2,1,0,1,凱基-頭份,2023-01-17,9296
2903,遠百,50,0,50,凱基-頭份,2023-01-30,9296
1612,宏泰,46,0,46,凱基-頭份,2023-01-30,9296
00632R,元大台灣50反1,42,11,31,凱基-頭份,2023-01-30,9296
00893,國泰智能電動車,31,5,26,凱基-頭份,2023-01-30,9296
00637L,元大滬深300正2,29,6,23,凱基-頭份,2023-01-30,9296
2317,鴻海,22,0,22,凱基-頭份,2023-01-30,9296
5483,中美晶,16,1,15,凱基-頭份,2023-01-30,9296
1806,冠軍,15,0,15,凱基-頭份,2023-01-30,9296
2009,第一銅,15,0,15,凱基-頭份,2023-01-30,9296
2497,怡利電,13,1,12,凱基-頭份,2023-01-30,9296
3455,由田,12,0,12,凱基-頭份,2023-01-30,9296
1101B,台泥乙特,11,0,11,凱基-頭份,2023-01-30,9296
00882,中信中國高股息,11,0,11,凱基-頭份,2023-01-30,9296
2609,陽明,22,11,11,凱基-頭份,2023-01-30,9296
4126,太醫,11,0,11,凱基-頭份,2023-01-30,9296
1809,中釉,10,0,10,凱基-頭份,2023-01-30,9296
2468,華經,10,0,10,凱基-頭份,2023-01-30,9296
3682,亞太電,10,0,10,凱基-頭份,2023-01-30,9296
8210,勤誠,10,0,10,凱基-頭份,2023-01-30,9296
9919,康那香,10,0,10,凱基-頭份,2023-01-30,9296
5425,台半,11,2,9,凱基-頭份,2023-01-30,9296
2303,聯電,73,65,8,凱基-頭份,2023-01-30,9296
00878,國泰永續高股息,11,5,6,凱基-頭份,2023-01-30,9296
6235,華孚,8,2,6,凱基-頭份,2023-01-30,9296
00891,中信關鍵半導體,5,0,5,凱基-頭份,2023-01-30,9296
00905,FT臺灣Smart,5,0,5,凱基-頭份,2023-01-30,9296
00673R,期元大S＆P原油反1,5,0,5,凱基-頭份,2023-01-30,9296
6435,大中,5,0,5,凱基-頭份,2023-01-30,9296
8069,元太,10,6,4,凱基-頭份,2023-01-30,9296
2812,台中銀,4,0,4,凱基-頭份,2023-01-30,9296
2388,威盛,4,0,4,凱基-頭份,2023-01-30,9296
5284,jpp-KY,7,3,4,凱基-頭份,2023-01-30,9296
6285,啟��,4,0,4,凱基-頭份,2023-01-30,9296
6582,申豐,4,0,4,凱基-頭份,2023-01-30,9296
8996,高力,5,1,4,凱基-頭份,2023-01-30,9296
2891,中信金,7,3,4,凱基-頭份,2023-01-30,9296
1712,興農,5,2,3,凱基-頭份,2023-01-30,9296
1783,和康生,3,0,3,凱基-頭份,2023-01-30,9296
2929,淘帝-KY,3,0,3,凱基-頭份,2023-01-30,9296
5009,榮剛,3,0,3,凱基-頭份,2023-01-30,9296
5014,建錩,3,0,3,凱基-頭份,2023-01-30,9296
6612,奈米醫材,7,4,3,凱基-頭份,2023-01-30,9296
8046,南電,3,0,3,凱基-頭份,2023-01-30,9296
0050,元大台灣50,5,3,2,凱基-頭份,2023-01-30,9296
2884,玉山金,3,0,3,凱基-頭份,2023-01-30,9296
2890,永豐金,17,15,2,凱基-頭份,2023-01-30,9296
00895,富邦未來車,2,0,2,凱基-頭份,2023-01-30,9296
00920,富邦ESG綠色電力,2,0,2,凱基-頭份,2023-01-30,9296
00653L,富邦印度正2,2,0,2,凱基-頭份,2023-01-30,9296
00650L,復華香港正2,2,0,2,凱基-頭份,2023-01-30,9296
00905,FT臺灣Smart,60,0,60,凱基-頭份,2023-01-31,9296
2106,建大,60,0,60,凱基-頭份,2023-01-31,9296
2887,台新金,50,0,50,凱基-頭份,2023-01-31,9296
00770,國泰北美科技,35,0,35,凱基-頭份,2023-01-31,9296
00673R,期元大S＆P原油反1,30,0,30,凱基-頭份,2023-01-31,9296
6282,康舒,30,0,30,凱基-頭份,2023-01-31,9296
00882,中信中國高股息,20,0,20,凱基-頭份,2023-01-31,9296
00893,國泰智能電動車,22,3,19,凱基-頭份,2023-01-31,9296
2313,華通,18,0,18,凱基-頭份,2023-01-31,9296
2201,裕隆,60,42,18,凱基-頭份,2023-01-31,9296
2344,華邦電,15,0,15,凱基-頭份,2023-01-31,9296
2888,新光金,12,0,12,凱基-頭份,2023-01-31,9296
4114,健喬,11,0,11,凱基-頭份,2023-01-31,9296
00720B,元大投資級公司債,10,0,10,凱基-頭份,2023-01-31,9296
6278,台表科,10,0,10,凱基-頭份,2023-01-31,9296
00637L,元大滬深300正2,10,1,9,凱基-頭份,2023-01-31,9296
2023,燁輝,10,1,9,凱基-頭份,2023-01-31,9296
3128,昇銳,9,0,9,凱基-頭份,2023-01-31,9296
4931,新盛力,8,0,8,凱基-頭份,2023-01-31,9296
6456,GIS-KY,10,2,8,凱基-頭份,2023-01-31,9296
2317,鴻海,16,8,8,凱基-頭份,2023-01-31,9296
1529,樂事綠能,12,5,7,凱基-頭份,2023-01-31,9296
3141,晶宏,7,0,7,凱基-頭份,2023-01-31,9296
2892,第一金,7,0,7,凱基-頭份,2023-01-31,9296
2455,全新,6,0,6,凱基-頭份,2023-01-31,9296
2609,陽明,6,0,6,凱基-頭份,2023-01-31,9296
6182,合晶,7,1,6,凱基-頭份,2023-01-31,9296
9945,潤泰新,6,0,6,凱基-頭份,2023-01-31,9296
2330,台積電,12,6,6,凱基-頭份,2023-01-31,9296
1806,冠軍,5,0,5,凱基-頭份,2023-01-31,9296
4123,晟德,5,0,5,凱基-頭份,2023-01-31,9296
4979,華星光,19,14,5,凱基-頭份,2023-01-31,9296
6558,興能高,5,0,5,凱基-頭份,2023-01-31,9296
00772B,中信高評級公司債,4,0,4,凱基-頭份,2023-01-31,9296
2497,怡利電,4,0,4,凱基-頭份,2023-01-31,9296
3163,波若威,5,1,4,凱基-頭份,2023-01-31,9296
4919,新唐,6,2,4,凱基-頭份,2023-01-31,9296
6443,元晶,6,2,4,凱基-頭份,2023-01-31,9296
2885,元大金,3,0,3,凱基-頭份,2023-01-31,9296
00902,中信電池及儲能,3,0,3,凱基-頭份,2023-01-31,9296
2332,友訊,3,0,3,凱基-頭份,2023-01-31,9296
2354,鴻準,3,0,3,凱基-頭份,2023-01-31,9296
2436,偉詮電,4,1,3,凱基-頭份,2023-01-31,9296
2548,華固,3,0,3,凱基-頭份,2023-01-31,9296
2897,王道銀行,3,0,3,凱基-頭份,2023-01-31,9296
5014,建錩,3,0,3,凱基-頭份,2023-01-31,9296
6150,撼訊,3,0,3,凱基-頭份,2023-01-31,9296
6806,森崴能源,3,0,3,凱基-頭份,2023-01-31,9296
9911,櫻花,3,0,3,凱基-頭份,2023-01-31,9296
5880,合庫金,3,0,3,凱基-頭份,2023-01-31,9296
2882,國泰金,120,2,118,凱基-頭份,2023-02-01,9296
2007,燁興,71,0,71,凱基-頭份,2023-02-01,9296
2443,昶虹,45,0,45,凱基-頭份,2023-02-01,9296
00903,富邦元宇宙,32,0,32,凱基-頭份,2023-02-01,9296
3149,正達,24,0,24,凱基-頭份,2023-02-01,9296
1584,精剛,28,6,22,凱基-頭份,2023-02-01,9296
4906,正文,20,0,20,凱基-頭份,2023-02-01,9296
9105,泰金寶-DR,20,1,19,凱基-頭份,2023-02-01,9296
1609,大亞,29,13,16,凱基-頭份,2023-02-01,9296
2609,陽明,16,0,16,凱基-頭份,2023-02-01,9296
4126,太醫,16,0,16,凱基-頭份,2023-02-01,9296
00673R,期元大S＆P原油反1,15,0,15,凱基-頭份,2023-02-01,9296
2634,漢翔,16,1,15,凱基-頭份,2023-02-01,9296
6129,普誠,15,0,15,凱基-頭份,2023-02-01,9296
5483,中美晶,15,1,14,凱基-頭份,2023-02-01,9296
2106,建大,13,0,13,凱基-頭份,2023-02-01,9296
00633L,富邦上証正2,16,4,12,凱基-頭份,2023-02-01,9296
5880,合庫金,11,0,11,凱基-頭份,2023-02-01,9296
2891,中信金,12,2,10,凱基-頭份,2023-02-01,9296
00905,FT臺灣Smart,10,0,10,凱基-頭份,2023-02-01,9296
00632R,元大台灣50反1,10,0,10,凱基-頭份,2023-02-01,9296
1906,寶隆,10,0,10,凱基-頭份,2023-02-01,9296
2409,友達,10,0,10,凱基-頭份,2023-02-01,9296
3147,大綜,10,0,10,凱基-頭份,2023-02-01,9296
6220,岳豐,10,0,10,凱基-頭份,2023-02-01,9296
6248,沛波,10,0,10,凱基-頭份,2023-02-01,9296
0056,元大高股息,12,2,10,凱基-頭份,2023-02-01,9296
6695,芯鼎,9,0,9,凱基-頭份,2023-02-01,9296
6770,力積電,96,87,9,凱基-頭份,2023-02-01,9296
6109,亞元,9,1,8,凱基-頭份,2023-02-01,9296
00878,國泰永續高股息,9,2,7,凱基-頭份,2023-02-01,9296
5321,美而快,7,0,7,凱基-頭份,2023-02-01,9296
2883,凱基金,6,0,6,凱基-頭份,2023-02-01,9296
00637L,元大滬深300正2,18,12,6,凱基-頭份,2023-02-01,9296
2337,旺宏,6,0,6,凱基-頭份,2023-02-01,9296
3027,盛達,6,0,6,凱基-頭份,2023-02-01,9296
6768,志強-KY,6,0,6,凱基-頭份,2023-02-01,9296
2426,鼎元,5,0,5,凱基-頭份,2023-02-01,9296
4105,東洋,5,0,5,凱基-頭份,2023-02-01,9296
5351,鈺創,5,0,5,凱基-頭份,2023-02-01,9296
4763,材料-KY,5,1,4,凱基-頭份,2023-02-01,9296
2412,中華電,4,0,4,凱基-頭份,2023-02-01,9296
2014,中鴻,4,0,4,凱基-頭份,2023-02-01,9296
2028,威致,4,0,4,凱基-頭份,2023-02-01,9296
2429,銘旺科,4,0,4,凱基-頭份,2023-02-01,9296
3081,聯亞,4,0,4,凱基-頭份,2023-02-01,9296
3037,欣興,11,7,4,凱基-頭份,2023-02-01,9296
5258,虹堡,65,62,3,凱基-頭份,2023-02-01,9296
9958,世紀鋼,3,0,3,凱基-頭份,2023-02-01,9296
2317,鴻海,11,8,3,凱基-頭份,2023-02-01,9296
00878,國泰永續高股息,65,5,60,凱基-頭份,2023-02-02,9296
00632R,元大台灣50反1,45,5,40,凱基-頭份,2023-02-02,9296
3260,威剛,30,1,29,凱基-頭份,2023-02-02,9296
6282,康舒,28,4,24,凱基-頭份,2023-02-02,9296
2618,長榮航,22,1,21,凱基-頭份,2023-02-02,9296
2363,矽統,22,1,21,凱基-頭份,2023-02-02,9296
2609,陽明,27,6,21,凱基-頭份,2023-02-02,9296
8450,霹靂,20,0,20,凱基-頭份,2023-02-02,9296
4979,華星光,30,12,18,凱基-頭份,2023-02-02,9296
3006,晶豪科,21,4,17,凱基-頭份,2023-02-02,9296
2495,普安,15,0,15,凱基-頭份,2023-02-02,9296
2634,漢翔,15,0,15,凱基-頭份,2023-02-02,9296
5483,中美晶,12,0,12,凱基-頭份,2023-02-02,9296
2892,第一金,10,0,10,凱基-頭份,2023-02-02,9296
00664R,國泰臺灣加權反1,10,0,10,凱基-頭份,2023-02-02,9296
00676R,富邦臺灣加權反1,10,0,10,凱基-頭份,2023-02-02,9296
00882,中信中國高股息,10,0,10,凱基-頭份,2023-02-02,9296
1714,和桐,10,0,10,凱基-頭份,2023-02-02,9296
1702,南僑,9,0,9,凱基-頭份,2023-02-02,9296
2888,新光金,10,1,9,凱基-頭份,2023-02-02,9296
4564,元翎,9,0,9,凱基-頭份,2023-02-02,9296
2308,台達電,8,0,8,凱基-頭份,2023-02-02,9296
2412,中華電,8,0,8,凱基-頭份,2023-02-02,9296
3041,揚智,7,0,7,凱基-頭份,2023-02-02,9296
8358,金居,17,10,7,凱基-頭份,2023-02-02,9296
6129,普誠,28,22,6,凱基-頭份,2023-02-02,9296
1609,大亞,12,6,6,凱基-頭份,2023-02-02,9296
4413,飛寶企業,6,0,6,凱基-頭份,2023-02-02,9296
4931,新盛力,6,0,6,凱基-頭份,2023-02-02,9296
6124,業強,6,0,6,凱基-頭份,2023-02-02,9296
2317,鴻海,6,1,5,凱基-頭份,2023-02-02,9296
1325,恆大,5,0,5,凱基-頭份,2023-02-02,9296
1905,華紙,5,0,5,凱基-頭份,2023-02-02,9296
2106,建大,5,0,5,凱基-頭份,2023-02-02,9296
2387,精元,5,0,5,凱基-頭份,2023-02-02,9296
2419,仲琦,5,0,5,凱基-頭份,2023-02-02,9296
2455,全新,11,6,5,凱基-頭份,2023-02-02,9296
2727,王品,5,0,5,凱基-頭份,2023-02-02,9296
3081,聯亞,5,0,5,凱基-頭份,2023-02-02,9296
6220,岳豐,5,0,5,凱基-頭份,2023-02-02,9296
00679B,元大美債20年,4,0,4,凱基-頭份,2023-02-02,9296
4977,眾達-KY,13,9,4,凱基-頭份,2023-02-02,9296
5014,建錩,4,0,4,凱基-頭份,2023-02-02,9296
5351,鈺創,10,6,4,凱基-頭份,2023-02-02,9296
5608,四維航,4,0,4,凱基-頭份,2023-02-02,9296
6233,旺玖,4,0,4,凱基-頭份,2023-02-02,9296
6589,台康生技,4,0,4,凱基-頭份,2023-02-02,9296
3481,群創,13,10,3,凱基-頭份,2023-02-02,9296
6806,森崴能源,3,0,3,凱基-頭份,2023-02-02,9296
00715L,期街口布蘭特正2,3,0,3,凱基-頭份,2023-02-02,9296
00712,復華富時不動產,150,0,150,凱基-頭份,2023-02-03,9296
00637L,元大滬深300正2,119,5,114,凱基-頭份,2023-02-03,9296
00753L,中信中國50正2,50,0,50,凱基-頭份,2023-02-03,9296
2852,第一保,50,0,50,凱基-頭份,2023-02-03,9296
6770,力積電,38,5,33,凱基-頭份,2023-02-03,9296
00882,中信中國高股息,34,10,24,凱基-頭份,2023-02-03,9296
00878,國泰永續高股息,27,4,23,凱基-頭份,2023-02-03,9296
2888,新光金,33,12,21,凱基-頭份,2023-02-03,9296
6118,建達,38,17,21,凱基-頭份,2023-02-03,9296
00671R,富邦NASDAQ反1,20,0,20,凱基-頭份,2023-02-03,9296
5299,杰力,20,0,20,凱基-頭份,2023-02-03,9296
00903,富邦元宇宙,20,2,18,凱基-頭份,2023-02-03,9296
3035,智原,43,30,13,凱基-頭份,2023-02-03,9296
2618,長榮航,14,2,12,凱基-頭份,2023-02-03,9296
4743,合一,11,0,11,凱基-頭份,2023-02-03,9296
00633L,富邦上証正2,10,0,10,凱基-頭份,2023-02-03,9296
1906,寶隆,10,0,10,凱基-頭份,2023-02-03,9296
6589,台康生技,10,0,10,凱基-頭份,2023-02-03,9296
2882,國泰金,10,2,8,凱基-頭份,2023-02-03,9296
2484,希華,28,20,8,凱基-頭份,2023-02-03,9296
3594,磐儀,9,1,8,凱基-頭份,2023-02-03,9296
4114,健喬,10,2,8,凱基-頭份,2023-02-03,9296
2498,宏達電,37,30,7,凱基-頭份,2023-02-03,9296
5608,四維航,6,0,6,凱基-頭份,2023-02-03,9296
8050,廣積,6,0,6,凱基-頭份,2023-02-03,9296
1515,力山,5,0,5,凱基-頭份,2023-02-03,9296
1513,中興電,5,0,5,凱基-頭份,2023-02-03,9296
1325,恆大,5,0,5,凱基-頭份,2023-02-03,9296
1605,華新,8,3,5,凱基-頭份,2023-02-03,9296
00676R,富邦臺灣加權反1,5,0,5,凱基-頭份,2023-02-03,9296
4147,中裕,5,0,5,凱基-頭份,2023-02-03,9296
4977,眾達-KY,15,10,5,凱基-頭份,2023-02-03,9296
8289,泰藝,5,0,5,凱基-頭份,2023-02-03,9296
2317,鴻海,6,1,5,凱基-頭份,2023-02-03,9296
3037,欣興,4,0,4,凱基-頭份,2023-02-03,9296
00632R,元大台灣50反1,4,0,4,凱基-頭份,2023-02-03,9296
00679B,元大美債20年,4,0,4,凱基-頭份,2023-02-03,9296
2201,裕隆,39,35,4,凱基-頭份,2023-02-03,9296
2436,偉詮電,13,9,4,凱基-頭份,2023-02-03,9296
3048,益登,4,0,4,凱基-頭份,2023-02-03,9296
5483,中美晶,24,20,4,凱基-頭份,2023-02-03,9296
6124,業強,4,0,4,凱基-頭份,2023-02-03,9296
6197,佳必琪,4,0,4,凱基-頭份,2023-02-03,9296
00902,中信電池及儲能,3,0,3,凱基-頭份,2023-02-03,9296
00900,富邦特選高股息30,3,0,3,凱基-頭份,2023-02-03,9296
2409,友達,8,5,3,凱基-頭份,2023-02-03,9296
2603,長榮,4,1,3,凱基-頭份,2023-02-03,9296
2610,華航,3,0,3,凱基-頭份,2023-02-03,9296
2617,台航,3,0,3,凱基-頭份,2023-02-03,9296
2641,正德,3,0,3,凱基-頭份,2023-02-03,9296
2025,千興,90,0,90,凱基-頭份,2023-02-06,9296
1524,耿鼎,48,10,38,凱基-頭份,2023-02-06,9296
4114,健喬,48,13,35,凱基-頭份,2023-02-06,9296
2882,國泰金,34,0,34,凱基-頭份,2023-02-06,9296
6788,華景電,30,0,30,凱基-頭份,2023-02-06,9296
3481,群創,30,1,29,凱基-頭份,2023-02-06,9296
6770,力積電,57,31,26,凱基-頭份,2023-02-06,9296
00753L,中信中國50正2,20,0,20,凱基-頭份,2023-02-06,9296
2353,宏��,20,0,20,凱基-頭份,2023-02-06,9296
2897,王道銀行,20,0,20,凱基-頭份,2023-02-06,9296
1605,華新,104,87,17,凱基-頭份,2023-02-06,9296
00637L,元大滬深300正2,17,1,16,凱基-頭份,2023-02-06,9296
00882,中信中國高股息,15,0,15,凱基-頭份,2023-02-06,9296
00665L,富邦�琤肭磪囓�2,14,0,14,凱基-頭份,2023-02-06,9296
00642U,期元大S＆P石油,14,0,14,凱基-頭份,2023-02-06,9296
00878,國泰永續高股息,22,9,13,凱基-頭份,2023-02-06,9296
2884,玉山金,14,1,13,凱基-頭份,2023-02-06,9296
2618,長榮航,14,2,12,凱基-頭份,2023-02-06,9296
0056,元大高股息,15,4,11,凱基-頭份,2023-02-06,9296
2344,華邦電,14,3,11,凱基-頭份,2023-02-06,9296
1906,寶隆,10,0,10,凱基-頭份,2023-02-06,9296
2482,連宇,48,38,10,凱基-頭份,2023-02-06,9296
5483,中美晶,20,10,10,凱基-頭份,2023-02-06,9296
2201,裕隆,15,7,8,凱基-頭份,2023-02-06,9296
2609,陽明,8,0,8,凱基-頭份,2023-02-06,9296
6188,廣明,20,12,8,凱基-頭份,2023-02-06,9296
2892,第一金,7,0,7,凱基-頭份,2023-02-06,9296
00905,FT臺灣Smart,10,3,7,凱基-頭份,2023-02-06,9296
2436,偉詮電,7,0,7,凱基-頭份,2023-02-06,9296
4564,元翎,7,0,7,凱基-頭份,2023-02-06,9296
00885,富邦越南,6,0,6,凱基-頭份,2023-02-06,9296
2812,台中銀,6,0,6,凱基-頭份,2023-02-06,9296
1319,東陽,5,0,5,凱基-頭份,2023-02-06,9296
2373,震旦行,5,0,5,凱基-頭份,2023-02-06,9296
2809,京城銀,5,0,5,凱基-頭份,2023-02-06,9296
4128,中天,6,1,5,凱基-頭份,2023-02-06,9296
5258,虹堡,8,3,5,凱基-頭份,2023-02-06,9296
6265,方土昶,5,0,5,凱基-頭份,2023-02-06,9296
2330,台積電,6,2,4,凱基-頭份,2023-02-06,9296
8038,長園科,5,1,4,凱基-頭份,2023-02-06,9296
006208,富邦台50,4,0,4,凱基-頭份,2023-02-06,9296
020031,統一IC設計臺灣N,4,0,4,凱基-頭份,2023-02-06,9296
00679B,元大美債20年,4,0,4,凱基-頭份,2023-02-06,9296
00633L,富邦上証正2,4,0,4,凱基-頭份,2023-02-06,9296
3508,位速,4,0,4,凱基-頭份,2023-02-06,9296
6109,亞元,4,0,4,凱基-頭份,2023-02-06,9296
2886,兆豐金,3,0,3,凱基-頭份,2023-02-06,9296
00772B,中信高評級公司債,3,0,3,凱基-頭份,2023-02-06,9296
00720B,元大投資級公司債,3,0,3,凱基-頭份,2023-02-06,9296
1783,和康生,5,2,3,凱基-頭份,2023-02-06,9296
00878,國泰永續高股息,49,5,44,凱基-頭份,2023-02-07,9296
1312,國喬,30,0,30,凱基-頭份,2023-02-07,9296
6788,華景電,30,0,30,凱基-頭份,2023-02-07,9296
2303,聯電,28,1,27,凱基-頭份,2023-02-07,9296
1304,台聚,20,0,20,凱基-頭份,2023-02-07,9296
4102,永日,20,0,20,凱基-頭份,2023-02-07,9296
2702,華園,19,0,19,凱基-頭份,2023-02-07,9296
3013,晟銘電,18,0,18,凱基-頭份,2023-02-07,9296
1605,華新,17,0,17,凱基-頭份,2023-02-07,9296
2344,華邦電,17,2,15,凱基-頭份,2023-02-07,9296
4726,永昕,16,1,15,凱基-頭份,2023-02-07,9296
6535,順藥,15,0,15,凱基-頭份,2023-02-07,9296
00712,復華富時不動產,13,0,13,凱基-頭份,2023-02-07,9296
0056,元大高股息,15,4,11,凱基-頭份,2023-02-07,9296
5347,世界,10,0,10,凱基-頭份,2023-02-07,9296
2017,官田鋼,10,0,10,凱基-頭份,2023-02-07,9296
2409,友達,15,5,10,凱基-頭份,2023-02-07,9296
2603,長榮,10,0,10,凱基-頭份,2023-02-07,9296
2888,新光金,11,1,10,凱基-頭份,2023-02-07,9296
3093,港建*,10,0,10,凱基-頭份,2023-02-07,9296
6770,力積電,10,0,10,凱基-頭份,2023-02-07,9296
1325,恆大,9,0,9,凱基-頭份,2023-02-07,9296
2002,中鋼,10,1,9,凱基-頭份,2023-02-07,9296
1432,大魯閣,8,0,8,凱基-頭份,2023-02-07,9296
2884,玉山金,7,0,7,凱基-頭份,2023-02-07,9296
00772B,中信高評級公司債,7,0,7,凱基-頭份,2023-02-07,9296
2618,長榮航,7,0,7,凱基-頭份,2023-02-07,9296
6231,系微,9,3,6,凱基-頭份,2023-02-07,9296
00679B,元大美債20年,5,0,5,凱基-頭份,2023-02-07,9296
1609,大亞,5,0,5,凱基-頭份,2023-02-07,9296
2201,裕隆,29,24,5,凱基-頭份,2023-02-07,9296
2883,凱基金,5,0,5,凱基-頭份,2023-02-07,9296
3044,健鼎,5,0,5,凱基-頭份,2023-02-07,9296
3622,洋華,5,0,5,凱基-頭份,2023-02-07,9296
6104,創惟,5,0,5,凱基-頭份,2023-02-07,9296
6155,鈞寶,5,0,5,凱基-頭份,2023-02-07,9296
8028,昇陽半導體,5,0,5,凱基-頭份,2023-02-07,9296
1733,五鼎,4,0,4,凱基-頭份,2023-02-07,9296
2108,南帝,4,0,4,凱基-頭份,2023-02-07,9296
2328,廣宇,6,2,4,凱基-頭份,2023-02-07,9296
2748,雲品,5,1,4,凱基-頭份,2023-02-07,9296
6202,盛群,4,0,4,凱基-頭份,2023-02-07,9296
6441,廣錠,7,3,4,凱基-頭份,2023-02-07,9296
3588,通嘉,5,1,4,凱基-頭份,2023-02-07,9296
6235,華孚,12,9,3,凱基-頭份,2023-02-07,9296
00713,元大台灣高息低波,3,0,3,凱基-頭份,2023-02-07,9296
2880,華南金,3,0,3,凱基-頭份,2023-02-07,9296
3062,建漢,6,3,3,凱基-頭份,2023-02-07,9296
9928,中視,3,0,3,凱基-頭份,2023-02-07,9296
2812,台中銀,7,4,3,凱基-頭份,2023-02-07,9296
6116,彩晶,62,1,61,凱基-頭份,2023-02-08,9296
00632R,元大台灣50反1,58,1,57,凱基-頭份,2023-02-08,9296
2106,建大,50,0,50,凱基-頭份,2023-02-08,9296
2887,台新金,50,0,50,凱基-頭份,2023-02-08,9296
2498,宏達電,54,10,44,凱基-頭份,2023-02-08,9296
6233,旺玖,26,0,26,凱基-頭份,2023-02-08,9296
6456,GIS-KY,24,0,24,凱基-頭份,2023-02-08,9296
00878,國泰永續高股息,25,3,22,凱基-頭份,2023-02-08,9296
2425,承啟,32,15,17,凱基-頭份,2023-02-08,9296
00665L,富邦�琤肭磪囓�2,16,0,16,凱基-頭份,2023-02-08,9296
3481,群創,161,146,15,凱基-頭份,2023-02-08,9296
00637L,元大滬深300正2,17,2,15,凱基-頭份,2023-02-08,9296
1701,中化,15,0,15,凱基-頭份,2023-02-08,9296
2358,廷鑫,15,0,15,凱基-頭份,2023-02-08,9296
2009,第一銅,15,2,13,凱基-頭份,2023-02-08,9296
3149,正達,13,0,13,凱基-頭份,2023-02-08,9296
0056,元大高股息,15,4,11,凱基-頭份,2023-02-08,9296
00673R,期元大S＆P原油反1,11,0,11,凱基-頭份,2023-02-08,9296
6531,愛普*,11,0,11,凱基-頭份,2023-02-08,9296
00679B,元大美債20年,10,0,10,凱基-頭份,2023-02-08,9296
00921,兆豐龍頭等權重,10,0,10,凱基-頭份,2023-02-08,9296
1810,和成,10,1,9,凱基-頭份,2023-02-08,9296
2618,長榮航,15,6,9,凱基-頭份,2023-02-08,9296
6138,茂達,10,1,9,凱基-頭份,2023-02-08,9296
2834,臺企銀,8,0,8,凱基-頭份,2023-02-08,9296
2884,玉山金,9,1,8,凱基-頭份,2023-02-08,9296
2344,華邦電,14,6,8,凱基-頭份,2023-02-08,9296
3712,永崴投控,8,1,7,凱基-頭份,2023-02-08,9296
2367,燿華,6,0,6,凱基-頭份,2023-02-08,9296
2897,王道銀行,6,0,6,凱基-頭份,2023-02-08,9296
3022,威強電,9,3,6,凱基-頭份,2023-02-08,9296
3094,聯傑,14,8,6,凱基-頭份,2023-02-08,9296
4102,永日,6,0,6,凱基-頭份,2023-02-08,9296
8105,凌巨,7,1,6,凱基-頭份,2023-02-08,9296
00919,群益台灣精選高息,5,0,5,凱基-頭份,2023-02-08,9296
00772B,中信高評級公司債,5,0,5,凱基-頭份,2023-02-08,9296
3576,聯合再生,5,0,5,凱基-頭份,2023-02-08,9296
4529,淳紳,5,0,5,凱基-頭份,2023-02-08,9296
4916,事欣科,5,0,5,凱基-頭份,2023-02-08,9296
2368,金像電,4,0,4,凱基-頭份,2023-02-08,9296
2929,淘帝-KY,4,0,4,凱基-頭份,2023-02-08,9296
3019,亞光,4,0,4,凱基-頭份,2023-02-08,9296
3083,網龍,4,0,4,凱基-頭份,2023-02-08,9296
4564,元翎,4,0,4,凱基-頭份,2023-02-08,9296
6282,康舒,8,4,4,凱基-頭份,2023-02-08,9296
6441,廣錠,4,0,4,凱基-頭份,2023-02-08,9296
6485,點序,4,0,4,凱基-頭份,2023-02-08,9296
3693,營邦,3,0,3,凱基-頭份,2023-02-08,9296
00715L,期街口布蘭特正2,3,0,3,凱基-頭份,2023-02-08,9296
2029,盛餘,3,0,3,凱基-頭份,2023-02-08,9296
2887,台新金,45,0,45,凱基-頭份,2023-02-09,9296
00632R,元大台灣50反1,38,1,37,凱基-頭份,2023-02-09,9296
2603,長榮,32,1,31,凱基-頭份,2023-02-09,9296
3322,建舜電,20,0,20,凱基-頭份,2023-02-09,9296
2353,宏��,20,2,18,凱基-頭份,2023-02-09,9296
2618,長榮航,21,4,17,凱基-頭份,2023-02-09,9296
00898,國泰基因免疫革命,10,0,10,凱基-頭份,2023-02-09,9296
1906,寶隆,10,0,10,凱基-頭份,2023-02-09,9296
2801,彰銀,10,0,10,凱基-頭份,2023-02-09,9296
2888,新光金,10,0,10,凱基-頭份,2023-02-09,9296
3013,晟銘電,10,0,10,凱基-頭份,2023-02-09,9296
3147,大綜,10,0,10,凱基-頭份,2023-02-09,9296
3141,晶宏,15,6,9,凱基-頭份,2023-02-09,9296
6282,康舒,46,37,9,凱基-頭份,2023-02-09,9296
8227,巨有科技,10,1,9,凱基-頭份,2023-02-09,9296
1605,華新,8,0,8,凱基-頭份,2023-02-09,9296
00637L,元大滬深300正2,32,25,7,凱基-頭份,2023-02-09,9296
2883,凱基金,6,0,6,凱基-頭份,2023-02-09,9296
00720B,元大投資級公司債,5,0,5,凱基-頭份,2023-02-09,9296
00772B,中信高評級公司債,5,0,5,凱基-頭份,2023-02-09,9296
2230,泰茂,5,0,5,凱基-頭份,2023-02-09,9296
3289,宜特,6,1,5,凱基-頭份,2023-02-09,9296
5227,立凱-KY,5,0,5,凱基-頭份,2023-02-09,9296
6123,上奇,5,0,5,凱基-頭份,2023-02-09,9296
6129,普誠,12,7,5,凱基-頭份,2023-02-09,9296
6517,保勝光學,5,0,5,凱基-頭份,2023-02-09,9296
8033,雷虎,5,0,5,凱基-頭份,2023-02-09,9296
00878,國泰永續高股息,4,0,4,凱基-頭份,2023-02-09,9296
5203,訊連,5,1,4,凱基-頭份,2023-02-09,9296
6118,建達,7,3,4,凱基-頭份,2023-02-09,9296
9902,台火,4,0,4,凱基-頭份,2023-02-09,9296
1609,大亞,6,3,3,凱基-頭份,2023-02-09,9296
2017,官田鋼,5,2,3,凱基-頭份,2023-02-09,9296
2368,金像電,3,0,3,凱基-頭份,2023-02-09,9296
2488,漢平,3,0,3,凱基-頭份,2023-02-09,9296
2498,宏達電,15,12,3,凱基-頭份,2023-02-09,9296
2609,陽明,3,0,3,凱基-頭份,2023-02-09,9296
2891,中信金,3,0,3,凱基-頭份,2023-02-09,9296
2929,淘帝-KY,3,0,3,凱基-頭份,2023-02-09,9296
3704,合勤控,3,0,3,凱基-頭份,2023-02-09,9296
5371,中光電,3,0,3,凱基-頭份,2023-02-09,9296
5457,宣德,3,0,3,凱基-頭份,2023-02-09,9296
6109,亞元,3,0,3,凱基-頭份,2023-02-09,9296
6125,廣運,3,0,3,凱基-頭份,2023-02-09,9296
6143,振曜,3,0,3,凱基-頭份,2023-02-09,9296
6494,九齊,3,0,3,凱基-頭份,2023-02-09,9296
6509,聚和,3,0,3,凱基-頭份,2023-02-09,9296
8049,晶采,3,0,3,凱基-頭份,2023-02-09,9296
8050,廣積,4,1,3,凱基-頭份,2023-02-09,9296
9802,鈺齊-KY,3,0,3,凱基-頭份,2023-02-09,9296
00878,國泰永續高股息,45,0,45,凱基-頭份,2023-02-10,9296
00712,復華富時不動產,42,0,42,凱基-頭份,2023-02-10,9296
00632R,元大台灣50反1,45,5,40,凱基-頭份,2023-02-10,9296
00753L,中信中國50正2,30,0,30,凱基-頭份,2023-02-10,9296
1605,華新,27,0,27,凱基-頭份,2023-02-10,9296
2618,長榮航,37,13,24,凱基-頭份,2023-02-10,9296
8227,巨有科技,21,4,17,凱基-頭份,2023-02-10,9296
00665L,富邦�琤肭磪囓�2,16,0,16,凱基-頭份,2023-02-10,9296
3704,合勤控,16,0,16,凱基-頭份,2023-02-10,9296
2009,第一銅,15,1,14,凱基-頭份,2023-02-10,9296
8271,宇瞻,14,0,14,凱基-頭份,2023-02-10,9296
2344,華邦電,14,1,13,凱基-頭份,2023-02-10,9296
2498,宏達電,19,6,13,凱基-頭份,2023-02-10,9296
4726,永昕,13,0,13,凱基-頭份,2023-02-10,9296
2880,華南金,12,0,12,凱基-頭份,2023-02-10,9296
2891,中信金,11,0,11,凱基-頭份,2023-02-10,9296
00720B,元大投資級公司債,10,0,10,凱基-頭份,2023-02-10,9296
1437,勤益控,10,0,10,凱基-頭份,2023-02-10,9296
2401,凌陽,10,0,10,凱基-頭份,2023-02-10,9296
2884,玉山金,12,2,10,凱基-頭份,2023-02-10,9296
1432,大魯閣,10,2,8,凱基-頭份,2023-02-10,9296
2892,第一金,10,2,8,凱基-頭份,2023-02-10,9296
1314,中石化,7,0,7,凱基-頭份,2023-02-10,9296
2609,陽明,7,0,7,凱基-頭份,2023-02-10,9296
3147,大綜,7,0,7,凱基-頭份,2023-02-10,9296
00772B,中信高評級公司債,6,0,6,凱基-頭份,2023-02-10,9296
2886,兆豐金,6,0,6,凱基-頭份,2023-02-10,9296
2929,淘帝-KY,6,0,6,凱基-頭份,2023-02-10,9296
3014,聯陽,6,0,6,凱基-頭份,2023-02-10,9296
2441,超豐,5,0,5,凱基-頭份,2023-02-10,9296
2442,新美齊,5,0,5,凱基-頭份,2023-02-10,9296
3710,連展投控,5,0,5,凱基-頭份,2023-02-10,9296
4743,合一,9,4,5,凱基-頭份,2023-02-10,9296
4960,誠美材,6,1,5,凱基-頭份,2023-02-10,9296
6142,友勁,5,0,5,凱基-頭份,2023-02-10,9296
6282,康舒,10,5,5,凱基-頭份,2023-02-10,9296
0056,元大高股息,6,1,5,凱基-頭份,2023-02-10,9296
2889,國票金,5,0,5,凱基-頭份,2023-02-10,9296
2603,長榮,5,1,4,凱基-頭份,2023-02-10,9296
3037,欣興,5,1,4,凱基-頭份,2023-02-10,9296
1513,中興電,7,3,4,凱基-頭份,2023-02-10,9296
00671R,富邦NASDAQ反1,4,0,4,凱基-頭份,2023-02-10,9296
2610,華航,4,0,4,凱基-頭份,2023-02-10,9296
4931,新盛力,10,6,4,凱基-頭份,2023-02-10,9296
6188,廣明,4,0,4,凱基-頭份,2023-02-10,9296
6441,廣錠,4,0,4,凱基-頭份,2023-02-10,9296
2883,凱基金,4,0,4,凱基-頭份,2023-02-10,9296
2887,台新金,3,0,3,凱基-頭份,2023-02-10,9296
2388,威盛,5,2,3,凱基-頭份,2023-02-10,9296
00670L,富邦NASDAQ正2,5,2,3,凱基-頭份,2023-02-10,9296
1447,力鵬,116,6,110,凱基-頭份,2023-02-13,9296
2884,玉山金,84,4,80,凱基-頭份,2023-02-13,9296
00878,國泰永續高股息,69,8,61,凱基-頭份,2023-02-13,9296
00632R,元大台灣50反1,35,2,33,凱基-頭份,2023-02-13,9296
00712,復華富時不動產,30,0,30,凱基-頭份,2023-02-13,9296
2485,兆赫,30,0,30,凱基-頭份,2023-02-13,9296
2887,台新金,25,0,25,凱基-頭份,2023-02-13,9296
911622,泰聚亨-DR,20,0,20,凱基-頭份,2023-02-13,9296
6101,寬魚國際,20,1,19,凱基-頭份,2023-02-13,9296
1810,和成,16,0,16,凱基-頭份,2023-02-13,9296
2201,裕隆,16,1,15,凱基-頭份,2023-02-13,9296
2610,華航,18,3,15,凱基-頭份,2023-02-13,9296
3037,欣興,14,0,14,凱基-頭份,2023-02-13,9296
4114,健喬,18,5,13,凱基-頭份,2023-02-13,9296
2034,允強,12,0,12,凱基-頭份,2023-02-13,9296
2897,王道銀行,12,0,12,凱基-頭份,2023-02-13,9296
6492,生華科,10,0,10,凱基-頭份,2023-02-13,9296
8033,雷虎,15,5,10,凱基-頭份,2023-02-13,9296
00772B,中信高評級公司債,8,0,8,凱基-頭份,2023-02-13,9296
2801,彰銀,8,0,8,凱基-頭份,2023-02-13,9296
00679B,元大美債20年,7,0,7,凱基-頭份,2023-02-13,9296
1504,東元,6,0,6,凱基-頭份,2023-02-13,9296
2634,漢翔,6,0,6,凱基-頭份,2023-02-13,9296
3712,永崴投控,10,4,6,凱基-頭份,2023-02-13,9296
6285,啟��,8,2,6,凱基-頭份,2023-02-13,9296
8271,宇瞻,6,0,6,凱基-頭份,2023-02-13,9296
3189,景碩,5,0,5,凱基-頭份,2023-02-13,9296
1809,中釉,5,0,5,凱基-頭份,2023-02-13,9296
3455,由田,5,0,5,凱基-頭份,2023-02-13,9296
4188,安克,5,0,5,凱基-頭份,2023-02-13,9296
4541,晟田,5,0,5,凱基-頭份,2023-02-13,9296
5227,立凱-KY,5,0,5,凱基-頭份,2023-02-13,9296
00780B,國泰A級金融債,4,0,4,凱基-頭份,2023-02-13,9296
6129,普誠,4,0,4,凱基-頭份,2023-02-13,9296
6196,帆宣,4,0,4,凱基-頭份,2023-02-13,9296
6443,元晶,4,0,4,凱基-頭份,2023-02-13,9296
6531,愛普*,5,1,4,凱基-頭份,2023-02-13,9296
6703,軒郁,4,0,4,凱基-頭份,2023-02-13,9296
00900,富邦特選高股息30,3,0,3,凱基-頭份,2023-02-13,9296
1795,美時,17,14,3,凱基-頭份,2023-02-13,9296
2358,廷鑫,5,2,3,凱基-頭份,2023-02-13,9296
2453,凌群,5,2,3,凱基-頭份,2023-02-13,9296
6112,邁達特,3,0,3,凱基-頭份,2023-02-13,9296
6415,矽力*-KY,5,2,3,凱基-頭份,2023-02-13,9296
00751B,元大AAA至A公司債,2,0,2,凱基-頭份,2023-02-13,9296
00720B,元大投資級公司債,2,0,2,凱基-頭份,2023-02-13,9296
3481,群創,6,4,2,凱基-頭份,2023-02-13,9296
1102,亞泥,2,0,2,凱基-頭份,2023-02-13,9296
2498,宏達電,11,9,2,凱基-頭份,2023-02-13,9296
1409,新纖,2,0,2,凱基-頭份,2023-02-13,9296
00673R,期元大S＆P原油反1,141,0,141,凱基-頭份,2023-02-14,9296
00753L,中信中國50正2,60,0,60,凱基-頭份,2023-02-14,9296
00885,富邦越南,30,0,30,凱基-頭份,2023-02-14,9296
00712,復華富時不動產,30,0,30,凱基-頭份,2023-02-14,9296
2485,兆赫,30,0,30,凱基-頭份,2023-02-14,9296
2884,玉山金,33,4,29,凱基-頭份,2023-02-14,9296
2401,凌陽,22,2,20,凱基-頭份,2023-02-14,9296
00632R,元大台灣50反1,16,0,16,凱基-頭份,2023-02-14,9296
6213,聯茂,13,0,13,凱基-頭份,2023-02-14,9296
1598,岱宇,12,0,12,凱基-頭份,2023-02-14,9296
8227,巨有科技,12,0,12,凱基-頭份,2023-02-14,9296
1701,中化,11,0,11,凱基-頭份,2023-02-14,9296
2471,資通,13,2,11,凱基-頭份,2023-02-14,9296
2882,國泰金,11,0,11,凱基-頭份,2023-02-14,9296
4931,新盛力,11,0,11,凱基-頭份,2023-02-14,9296
00676R,富邦臺灣加權反1,10,0,10,凱基-頭份,2023-02-14,9296
1810,和成,10,0,10,凱基-頭份,2023-02-14,9296
3029,零壹,10,0,10,凱基-頭份,2023-02-14,9296
6122,擎邦,10,0,10,凱基-頭份,2023-02-14,9296
4726,永昕,9,0,9,凱基-頭份,2023-02-14,9296
5512,力麒,9,0,9,凱基-頭份,2023-02-14,9296
8033,雷虎,11,2,9,凱基-頭份,2023-02-14,9296
2034,允強,7,0,7,凱基-頭份,2023-02-14,9296
2402,毅嘉,7,0,7,凱基-頭份,2023-02-14,9296
4129,聯合,8,1,7,凱基-頭份,2023-02-14,9296
4167,松瑞藥,8,1,7,凱基-頭份,2023-02-14,9296
2812,台中銀,6,0,6,凱基-頭份,2023-02-14,9296
1432,大魯閣,6,0,6,凱基-頭份,2023-02-14,9296
00720B,元大投資級公司債,6,0,6,凱基-頭份,2023-02-14,9296
4979,華星光,8,2,6,凱基-頭份,2023-02-14,9296
6112,邁達特,6,0,6,凱基-頭份,2023-02-14,9296
1437,勤益控,5,0,5,凱基-頭份,2023-02-14,9296
1459,聯發,5,0,5,凱基-頭份,2023-02-14,9296
3094,聯傑,6,1,5,凱基-頭份,2023-02-14,9296
00637L,元大滬深300正2,4,0,4,凱基-頭份,2023-02-14,9296
00633L,富邦上証正2,4,0,4,凱基-頭份,2023-02-14,9296
00671R,富邦NASDAQ反1,4,0,4,凱基-頭份,2023-02-14,9296
2344,華邦電,6,2,4,凱基-頭份,2023-02-14,9296
2618,長榮航,4,0,4,凱基-頭份,2023-02-14,9296
4161,聿新科,4,0,4,凱基-頭份,2023-02-14,9296
4747,強生,4,0,4,凱基-頭份,2023-02-14,9296
6441,廣錠,4,0,4,凱基-頭份,2023-02-14,9296
1101,台泥,8,5,3,凱基-頭份,2023-02-14,9296
2641,正德,3,0,3,凱基-頭份,2023-02-14,9296
2880,華南金,3,0,3,凱基-頭份,2023-02-14,9296
2881,富邦金,3,0,3,凱基-頭份,2023-02-14,9296
2897,王道銀行,13,10,3,凱基-頭份,2023-02-14,9296
3027,盛達,3,0,3,凱基-頭份,2023-02-14,9296
3189,景碩,3,0,3,凱基-頭份,2023-02-14,9296
3703,欣陸,3,0,3,凱基-頭份,2023-02-14,9296
5701,劍湖山,100,0,100,凱基-頭份,2023-02-15,9296
00878,國泰永續高股息,64,0,64,凱基-頭份,2023-02-15,9296
2371,大同,50,1,49,凱基-頭份,2023-02-15,9296
1519,華城,32,7,25,凱基-頭份,2023-02-15,9296
3221,台嘉碩,23,1,22,凱基-頭份,2023-02-15,9296
3481,群創,36,15,21,凱基-頭份,2023-02-15,9296
2009,第一銅,20,0,20,凱基-頭份,2023-02-15,9296
6116,彩晶,20,0,20,凱基-頭份,2023-02-15,9296
3037,欣興,27,8,19,凱基-頭份,2023-02-15,9296
6282,康舒,18,0,18,凱基-頭份,2023-02-15,9296
3147,大綜,13,0,13,凱基-頭份,2023-02-15,9296
1319,東陽,12,0,12,凱基-頭份,2023-02-15,9296
2401,凌陽,10,0,10,凱基-頭份,2023-02-15,9296
00881,國泰台灣5G+,10,0,10,凱基-頭份,2023-02-15,9296
2618,長榮航,14,4,10,凱基-頭份,2023-02-15,9296
2380,虹光,10,0,10,凱基-頭份,2023-02-15,9296
2905,三商,10,0,10,凱基-頭份,2023-02-15,9296
6015,宏遠證,10,0,10,凱基-頭份,2023-02-15,9296
8271,宇瞻,10,0,10,凱基-頭份,2023-02-15,9296
2884,玉山金,10,1,9,凱基-頭份,2023-02-15,9296
5464,霖宏,8,0,8,凱基-頭份,2023-02-15,9296
2330,台積電,15,7,8,凱基-頭份,2023-02-15,9296
2727,王品,8,1,7,凱基-頭份,2023-02-15,9296
1303,南亞,7,0,7,凱基-頭份,2023-02-15,9296
2498,宏達電,21,14,7,凱基-頭份,2023-02-15,9296
2317,鴻海,7,1,6,凱基-頭份,2023-02-15,9296
4142,國光生,6,0,6,凱基-頭份,2023-02-15,9296
0056,元大高股息,9,4,5,凱基-頭份,2023-02-15,9296
0050,元大台灣50,5,0,5,凱基-頭份,2023-02-15,9296
2337,旺宏,5,0,5,凱基-頭份,2023-02-15,9296
1325,恆大,5,0,5,凱基-頭份,2023-02-15,9296
1560,中砂,5,0,5,凱基-頭份,2023-02-15,9296
1432,大魯閣,5,0,5,凱基-頭份,2023-02-15,9296
00637L,元大滬深300正2,5,0,5,凱基-頭份,2023-02-15,9296
00636,國泰中國A50,5,0,5,凱基-頭份,2023-02-15,9296
1810,和成,10,5,5,凱基-頭份,2023-02-15,9296
2453,凌群,8,3,5,凱基-頭份,2023-02-15,9296
2607,榮運,5,0,5,凱基-頭份,2023-02-15,9296
3504,揚明光,14,9,5,凱基-頭份,2023-02-15,9296
3710,連展投控,5,0,5,凱基-頭份,2023-02-15,9296
4114,健喬,5,0,5,凱基-頭份,2023-02-15,9296
6112,邁達特,5,0,5,凱基-頭份,2023-02-15,9296
2834,臺企銀,5,1,4,凱基-頭份,2023-02-15,9296
006208,富邦台50,4,0,4,凱基-頭份,2023-02-15,9296
6441,廣錠,4,0,4,凱基-頭份,2023-02-15,9296
3675,德微,6,2,4,凱基-頭份,2023-02-15,9296
4167,松瑞藥,7,3,4,凱基-頭份,2023-02-15,9296
6517,保勝光學,5,1,4,凱基-頭份,2023-02-15,9296
8478,東哥遊艇,6,2,4,凱基-頭份,2023-02-15,9296
00891,中信關鍵半導體,3,0,3,凱基-頭份,2023-02-15,9296
3481,群創,341,18,323,凱基-頭份,2023-02-16,9296
2409,友達,92,14,78,凱基-頭份,2023-02-16,9296
00673R,期元大S＆P原油反1,69,0,69,凱基-頭份,2023-02-16,9296
1417,嘉裕,40,0,40,凱基-頭份,2023-02-16,9296
00878,國泰永續高股息,38,0,38,凱基-頭份,2023-02-16,9296
2401,凌陽,35,0,35,凱基-頭份,2023-02-16,9296
1304,台聚,20,0,20,凱基-頭份,2023-02-16,9296
1305,華夏,10,0,10,凱基-頭份,2023-02-16,9296
00671R,富邦NASDAQ反1,10,0,10,凱基-頭份,2023-02-16,9296
1605,華新,99,89,10,凱基-頭份,2023-02-16,9296
2369,菱生,10,0,10,凱基-頭份,2023-02-16,9296
3013,晟銘電,10,0,10,凱基-頭份,2023-02-16,9296
8086,宏捷科,10,0,10,凱基-頭份,2023-02-16,9296
2303,聯電,12,2,10,凱基-頭份,2023-02-16,9296
00679B,元大美債20年,9,0,9,凱基-頭份,2023-02-16,9296
00753L,中信中國50正2,10,1,9,凱基-頭份,2023-02-16,9296
00920,富邦ESG綠色電力,7,0,7,凱基-頭份,2023-02-16,9296
00632R,元大台灣50反1,6,0,6,凱基-頭份,2023-02-16,9296
00772B,中信高評級公司債,6,0,6,凱基-頭份,2023-02-16,9296
8446,華研,6,0,6,凱基-頭份,2023-02-16,9296
1714,和桐,5,0,5,凱基-頭份,2023-02-16,9296
2402,毅嘉,5,0,5,凱基-頭份,2023-02-16,9296
2471,資通,13,8,5,凱基-頭份,2023-02-16,9296
2743,山富,16,11,5,凱基-頭份,2023-02-16,9296
3037,欣興,13,8,5,凱基-頭份,2023-02-16,9296
3494,誠研,5,0,5,凱基-頭份,2023-02-16,9296
6245,立端,5,0,5,凱基-頭份,2023-02-16,9296
1201,味全,4,0,4,凱基-頭份,2023-02-16,9296
1460,宏遠,4,0,4,凱基-頭份,2023-02-16,9296
1514,亞力,4,0,4,凱基-頭份,2023-02-16,9296
2441,超豐,4,0,4,凱基-頭份,2023-02-16,9296
2606,裕民,4,0,4,凱基-頭份,2023-02-16,9296
2727,王品,4,0,4,凱基-頭份,2023-02-16,9296
2888,新光金,7,3,4,凱基-頭份,2023-02-16,9296
3105,穩懋,4,0,4,凱基-頭份,2023-02-16,9296
3356,奇偶,4,0,4,凱基-頭份,2023-02-16,9296
4123,晟德,4,0,4,凱基-頭份,2023-02-16,9296
4739,康普,4,0,4,凱基-頭份,2023-02-16,9296
6213,聯茂,4,0,4,凱基-頭份,2023-02-16,9296
6703,軒郁,5,1,4,凱基-頭份,2023-02-16,9296
1529,樂事綠能,3,0,3,凱基-頭份,2023-02-16,9296
00899,FT潔淨能源,3,0,3,凱基-頭份,2023-02-16,9296
00867B,新光A-BBB電信債,3,0,3,凱基-頭份,2023-02-16,9296
1609,大亞,3,0,3,凱基-頭份,2023-02-16,9296
2028,威致,4,1,3,凱基-頭份,2023-02-16,9296
2371,大同,3,0,3,凱基-頭份,2023-02-16,9296
2736,富野,4,1,3,凱基-頭份,2023-02-16,9296
4566,時碩工業,3,0,3,凱基-頭份,2023-02-16,9296
8028,昇陽半導體,3,0,3,凱基-頭份,2023-02-16,9296
6806,森崴能源,6,3,3,凱基-頭份,2023-02-16,9296
2610,華航,147,40,107,凱基-頭份,2023-02-17,9296
00637L,元大滬深300正2,75,0,75,凱基-頭份,2023-02-17,9296
6116,彩晶,46,0,46,凱基-頭份,2023-02-17,9296
5328,華容,40,0,40,凱基-頭份,2023-02-17,9296
00878,國泰永續高股息,33,4,29,凱基-頭份,2023-02-17,9296
2883,凱基金,22,1,21,凱基-頭份,2023-02-17,9296
00679B,元大美債20年,16,0,16,凱基-頭份,2023-02-17,9296
00753L,中信中國50正2,15,0,15,凱基-頭份,2023-02-17,9296
1503,士電,18,6,12,凱基-頭份,2023-02-17,9296
00772B,中信高評級公司債,11,0,11,凱基-頭份,2023-02-17,9296
00633L,富邦上証正2,13,2,11,凱基-頭份,2023-02-17,9296
2609,陽明,11,0,11,凱基-頭份,2023-02-17,9296
3704,合勤控,11,0,11,凱基-頭份,2023-02-17,9296
3264,欣銓,11,0,11,凱基-頭份,2023-02-17,9296
3622,洋華,10,0,10,凱基-頭份,2023-02-17,9296
2201,裕隆,15,7,8,凱基-頭份,2023-02-17,9296
8227,巨有科技,11,3,8,凱基-頭份,2023-02-17,9296
00720B,元大投資級公司債,7,0,7,凱基-頭份,2023-02-17,9296
3035,智原,13,7,6,凱基-頭份,2023-02-17,9296
2330,台積電,6,0,6,凱基-頭份,2023-02-17,9296
00751B,元大AAA至A公司債,5,0,5,凱基-頭份,2023-02-17,9296
2401,凌陽,5,0,5,凱基-頭份,2023-02-17,9296
1229,聯華,5,0,5,凱基-頭份,2023-02-17,9296
00780B,國泰A級金融債,5,0,5,凱基-頭份,2023-02-17,9296
2739,寒舍,5,0,5,凱基-頭份,2023-02-17,9296
3105,穩懋,6,1,5,凱基-頭份,2023-02-17,9296
4526,東台,5,0,5,凱基-頭份,2023-02-17,9296
4961,天鈺,35,30,5,凱基-頭份,2023-02-17,9296
4979,華星光,8,3,5,凱基-頭份,2023-02-17,9296
6196,帆宣,5,0,5,凱基-頭份,2023-02-17,9296
6703,軒郁,5,0,5,凱基-頭份,2023-02-17,9296
00680L,元大美債20正2,4,0,4,凱基-頭份,2023-02-17,9296
2453,凌群,6,2,4,凱基-頭份,2023-02-17,9296
3564,其陽,6,2,4,凱基-頭份,2023-02-17,9296
4164,承業醫,4,0,4,凱基-頭份,2023-02-17,9296
5464,霖宏,4,0,4,凱基-頭份,2023-02-17,9296
8033,雷虎,4,0,4,凱基-頭份,2023-02-17,9296
00900,富邦特選高股息30,4,0,4,凱基-頭份,2023-02-17,9296
2344,華邦電,4,1,3,凱基-頭份,2023-02-17,9296
2443,昶虹,3,0,3,凱基-頭份,2023-02-17,9296
2478,大毅,3,0,3,凱基-頭份,2023-02-17,9296
2618,長榮航,82,79,3,凱基-頭份,2023-02-17,9296
3013,晟銘電,4,1,3,凱基-頭份,2023-02-17,9296
4190,佐登-KY,3,0,3,凱基-頭份,2023-02-17,9296
8478,東哥遊艇,6,3,3,凱基-頭份,2023-02-17,9296
0050,元大台灣50,3,0,3,凱基-頭份,2023-02-17,9296
1504,東元,2,0,2,凱基-頭份,2023-02-17,9296
1409,新纖,2,0,2,凱基-頭份,2023-02-17,9296
00912,中信臺灣智慧50,2,0,2,凱基-頭份,2023-02-17,9296
00905,FT臺灣Smart,2,0,2,凱基-頭份,2023-02-17,9296
2443,昶虹,272,0,272,凱基-頭份,2023-02-20,9296
00673R,期元大S＆P原油反1,190,10,180,凱基-頭份,2023-02-20,9296
2887,台新金,60,0,60,凱基-頭份,2023-02-20,9296
6116,彩晶,32,0,32,凱基-頭份,2023-02-20,9296
4402,郡都開發,30,0,30,凱基-頭份,2023-02-20,9296
1432,大魯閣,25,1,24,凱基-頭份,2023-02-20,9296
5328,華容,50,29,21,凱基-頭份,2023-02-20,9296
3322,建舜電,20,0,20,凱基-頭份,2023-02-20,9296
6770,力積電,20,2,18,凱基-頭份,2023-02-20,9296
1216,統一,15,0,15,凱基-頭份,2023-02-20,9296
2009,第一銅,15,0,15,凱基-頭份,2023-02-20,9296
00632R,元大台灣50反1,14,0,14,凱基-頭份,2023-02-20,9296
2340,台亞,13,0,13,凱基-頭份,2023-02-20,9296
2486,一詮,13,0,13,凱基-頭份,2023-02-20,9296
8383,千附,21,8,13,凱基-頭份,2023-02-20,9296
2471,資通,12,0,12,凱基-頭份,2023-02-20,9296
5340,建榮,11,0,11,凱基-頭份,2023-02-20,9296
6125,廣運,12,1,11,凱基-頭份,2023-02-20,9296
1319,東陽,10,0,10,凱基-頭份,2023-02-20,9296
2468,華經,10,0,10,凱基-頭份,2023-02-20,9296
2722,夏都,10,0,10,凱基-頭份,2023-02-20,9296
3357,臺慶科,10,0,10,凱基-頭份,2023-02-20,9296
4977,眾達-KY,18,8,10,凱基-頭份,2023-02-20,9296
9933,中鼎,10,0,10,凱基-頭份,2023-02-20,9296
00631L,元大台灣50正2,9,0,9,凱基-頭份,2023-02-20,9296
1708,東鹼,10,1,9,凱基-頭份,2023-02-20,9296
3481,群創,25,16,9,凱基-頭份,2023-02-20,9296
2105,正新,8,0,8,凱基-頭份,2023-02-20,9296
2618,長榮航,23,15,8,凱基-頭份,2023-02-20,9296
4128,中天,20,13,7,凱基-頭份,2023-02-20,9296
00902,中信電池及儲能,6,0,6,凱基-頭份,2023-02-20,9296
2027,大成鋼,6,0,6,凱基-頭份,2023-02-20,9296
2375,凱美,6,0,6,凱基-頭份,2023-02-20,9296
6129,普誠,10,4,6,凱基-頭份,2023-02-20,9296
2317,鴻海,6,1,5,凱基-頭份,2023-02-20,9296
00740B,富邦全球投等債,5,0,5,凱基-頭份,2023-02-20,9296
00633L,富邦上証正2,9,4,5,凱基-頭份,2023-02-20,9296
1584,精剛,13,8,5,凱基-頭份,2023-02-20,9296
2104,國際中橡,5,0,5,凱基-頭份,2023-02-20,9296
2236,百達-KY,5,0,5,凱基-頭份,2023-02-20,9296
2312,金寶,5,0,5,凱基-頭份,2023-02-20,9296
2603,長榮,6,1,5,凱基-頭份,2023-02-20,9296
2611,志信,5,0,5,凱基-頭份,2023-02-20,9296
6015,宏遠證,5,0,5,凱基-頭份,2023-02-20,9296
00780B,國泰A級金融債,4,0,4,凱基-頭份,2023-02-20,9296
2201,裕隆,10,6,4,凱基-頭份,2023-02-20,9296
3022,威強電,4,0,4,凱基-頭份,2023-02-20,9296
3356,奇偶,5,1,4,凱基-頭份,2023-02-20,9296
3434,哲固,4,0,4,凱基-頭份,2023-02-20,9296
6188,廣明,4,0,4,凱基-頭份,2023-02-20,9296
4402,郡都開發,101,0,101,凱基-頭份,2023-02-21,9296
1216,統一,80,0,80,凱基-頭份,2023-02-21,9296
6282,康舒,62,15,47,凱基-頭份,2023-02-21,9296
3704,合勤控,31,0,31,凱基-頭份,2023-02-21,9296
1810,和成,29,0,29,凱基-頭份,2023-02-21,9296
8936,國統,27,0,27,凱基-頭份,2023-02-21,9296
00878,國泰永續高股息,36,11,25,凱基-頭份,2023-02-21,9296
8227,巨有科技,30,13,17,凱基-頭份,2023-02-21,9296
2017,官田鋼,15,0,15,凱基-頭份,2023-02-21,9296
2897,王道銀行,15,0,15,凱基-頭份,2023-02-21,9296
6288,聯嘉,15,0,15,凱基-頭份,2023-02-21,9296
3006,晶豪科,32,20,12,凱基-頭份,2023-02-21,9296
1319,東陽,11,0,11,凱基-頭份,2023-02-21,9296
00679B,元大美債20年,11,0,11,凱基-頭份,2023-02-21,9296
2618,長榮航,21,10,11,凱基-頭份,2023-02-21,9296
2332,友訊,10,0,10,凱基-頭份,2023-02-21,9296
2363,矽統,10,0,10,凱基-頭份,2023-02-21,9296
2610,華航,14,4,10,凱基-頭份,2023-02-21,9296
2867,三商壽,10,0,10,凱基-頭份,2023-02-21,9296
2471,資通,9,0,9,凱基-頭份,2023-02-21,9296
6517,保勝光學,10,1,9,凱基-頭份,2023-02-21,9296
2892,第一金,8,0,8,凱基-頭份,2023-02-21,9296
2425,承啟,8,0,8,凱基-頭份,2023-02-21,9296
4739,康普,9,1,8,凱基-頭份,2023-02-21,9296
8050,廣積,8,0,8,凱基-頭份,2023-02-21,9296
00642U,期元大S＆P石油,7,0,7,凱基-頭份,2023-02-21,9296
1760,寶齡富錦,8,1,7,凱基-頭份,2023-02-21,9296
4968,立積,19,12,7,凱基-頭份,2023-02-21,9296
2883,凱基金,9,3,6,凱基-頭份,2023-02-21,9296
00882,中信中國高股息,6,0,6,凱基-頭份,2023-02-21,9296
2468,華經,6,0,6,凱基-頭份,2023-02-21,9296
2845,遠東銀,6,0,6,凱基-頭份,2023-02-21,9296
1101,台泥,6,1,5,凱基-頭份,2023-02-21,9296
00631L,元大台灣50正2,5,0,5,凱基-頭份,2023-02-21,9296
00902,中信電池及儲能,5,0,5,凱基-頭份,2023-02-21,9296
1437,勤益控,5,0,5,凱基-頭份,2023-02-21,9296
2206,三陽工業,5,0,5,凱基-頭份,2023-02-21,9296
2314,台揚,5,0,5,凱基-頭份,2023-02-21,9296
2615,萬海,5,0,5,凱基-頭份,2023-02-21,9296
2812,台中銀,5,0,5,凱基-頭份,2023-02-21,9296
3051,力特,5,0,5,凱基-頭份,2023-02-21,9296
3622,洋華,5,0,5,凱基-頭份,2023-02-21,9296
4155,訊映,5,0,5,凱基-頭份,2023-02-21,9296
4903,聯光通,5,0,5,凱基-頭份,2023-02-21,9296
4931,新盛力,52,47,5,凱基-頭份,2023-02-21,9296
6205,詮欣,8,3,5,凱基-頭份,2023-02-21,9296
6582,申豐,5,0,5,凱基-頭份,2023-02-21,9296
2308,台達電,4,0,4,凱基-頭份,2023-02-21,9296
2355,敬鵬,4,0,4,凱基-頭份,2023-02-21,9296
2637,慧洋-KY,4,0,4,凱基-頭份,2023-02-21,9296
2812,台中銀,89,0,89,凱基-頭份,2023-02-22,9296
4402,郡都開發,79,1,78,凱基-頭份,2023-02-22,9296
6138,茂達,54,0,54,凱基-頭份,2023-02-22,9296
00637L,元大滬深300正2,61,10,51,凱基-頭份,2023-02-22,9296
1108,幸福,50,0,50,凱基-頭份,2023-02-22,9296
0050,元大台灣50,44,1,43,凱基-頭份,2023-02-22,9296
2886,兆豐金,42,0,42,凱基-頭份,2023-02-22,9296
2498,宏達電,45,5,40,凱基-頭份,2023-02-22,9296
00632R,元大台灣50反1,37,6,31,凱基-頭份,2023-02-22,9296
5512,力麒,40,10,30,凱基-頭份,2023-02-22,9296
2610,華航,36,11,25,凱基-頭份,2023-02-22,9296
00878,國泰永續高股息,41,17,24,凱基-頭份,2023-02-22,9296
6116,彩晶,22,0,22,凱基-頭份,2023-02-22,9296
00679B,元大美債20年,21,0,21,凱基-頭份,2023-02-22,9296
1319,東陽,21,0,21,凱基-頭份,2023-02-22,9296
8936,國統,23,4,19,凱基-頭份,2023-02-22,9296
3704,合勤控,17,0,17,凱基-頭份,2023-02-22,9296
2618,長榮航,16,1,15,凱基-頭份,2023-02-22,9296
2344,華邦電,19,4,15,凱基-頭份,2023-02-22,9296
2884,玉山金,15,1,14,凱基-頭份,2023-02-22,9296
3035,智原,43,31,12,凱基-頭份,2023-02-22,9296
3419,譁裕,12,0,12,凱基-頭份,2023-02-22,9296
6188,廣明,17,5,12,凱基-頭份,2023-02-22,9296
00882,中信中國高股息,11,0,11,凱基-頭份,2023-02-22,9296
00916,國泰全球品牌50,10,0,10,凱基-頭份,2023-02-22,9296
2312,金寶,10,0,10,凱基-頭份,2023-02-22,9296
2449,京元電子,10,0,10,凱基-頭份,2023-02-22,9296
4153,鈺緯,10,0,10,凱基-頭份,2023-02-22,9296
5299,杰力,10,0,10,凱基-頭份,2023-02-22,9296
8227,巨有科技,10,0,10,凱基-頭份,2023-02-22,9296
2208,台船,12,3,9,凱基-頭份,2023-02-22,9296
8033,雷虎,16,7,9,凱基-頭份,2023-02-22,9296
4726,永昕,8,0,8,凱基-頭份,2023-02-22,9296
4979,華星光,9,1,8,凱基-頭份,2023-02-22,9296
6443,元晶,11,3,8,凱基-頭份,2023-02-22,9296
00713,元大台灣高息低波,7,0,7,凱基-頭份,2023-02-22,9296
00725B,國泰投資級公司債,6,0,6,凱基-頭份,2023-02-22,9296
2201,裕隆,15,9,6,凱基-頭份,2023-02-22,9296
00670L,富邦NASDAQ正2,6,0,6,凱基-頭份,2023-02-22,9296
1609,大亞,10,4,6,凱基-頭份,2023-02-22,9296
2236,百達-KY,6,0,6,凱基-頭份,2023-02-22,9296
1101,台泥,8,2,6,凱基-頭份,2023-02-22,9296
2634,漢翔,5,0,5,凱基-頭份,2023-02-22,9296
00753L,中信中國50正2,5,0,5,凱基-頭份,2023-02-22,9296
2401,凌陽,5,0,5,凱基-頭份,2023-02-22,9296
4123,晟德,5,0,5,凱基-頭份,2023-02-22,9296
4142,國光生,5,0,5,凱基-頭份,2023-02-22,9296
4919,新唐,5,0,5,凱基-頭份,2023-02-22,9296
8433,弘帆,5,0,5,凱基-頭份,2023-02-22,9296
00772B,中信高評級公司債,4,0,4,凱基-頭份,2023-02-22,9296
2812,台中銀,76,1,75,凱基-頭份,2023-02-23,9296
00632R,元大台灣50反1,72,0,72,凱基-頭份,2023-02-23,9296
00665L,富邦�琤肭磪囓�2,101,45,56,凱基-頭份,2023-02-23,9296
00637L,元大滬深300正2,56,0,56,凱基-頭份,2023-02-23,9296
2303,聯電,35,8,27,凱基-頭份,2023-02-23,9296
6116,彩晶,22,0,22,凱基-頭份,2023-02-23,9296
2734,易飛網,20,0,20,凱基-頭份,2023-02-23,9296
3481,群創,227,209,18,凱基-頭份,2023-02-23,9296
00642U,期元大S＆P石油,17,0,17,凱基-頭份,2023-02-23,9296
00715L,期街口布蘭特正2,22,5,17,凱基-頭份,2023-02-23,9296
3149,正達,17,0,17,凱基-頭份,2023-02-23,9296
1605,華新,17,1,16,凱基-頭份,2023-02-23,9296
2243,宏旭-KY,15,0,15,凱基-頭份,2023-02-23,9296
3252,海灣,15,0,15,凱基-頭份,2023-02-23,9296
2401,凌陽,15,0,15,凱基-頭份,2023-02-23,9296
1447,力鵬,20,6,14,凱基-頭份,2023-02-23,9296
2017,官田鋼,20,8,12,凱基-頭份,2023-02-23,9296
6517,保勝光學,11,0,11,凱基-頭份,2023-02-23,9296
00664R,國泰臺灣加權反1,10,0,10,凱基-頭份,2023-02-23,9296
1708,東鹼,10,0,10,凱基-頭份,2023-02-23,9296
2312,金寶,10,0,10,凱基-頭份,2023-02-23,9296
2337,旺宏,10,0,10,凱基-頭份,2023-02-23,9296
3622,洋華,10,0,10,凱基-頭份,2023-02-23,9296
4526,東台,10,0,10,凱基-頭份,2023-02-23,9296
9934,成霖,10,0,10,凱基-頭份,2023-02-23,9296
1712,興農,9,0,9,凱基-頭份,2023-02-23,9296
1455,集盛,10,2,8,凱基-頭份,2023-02-23,9296
2453,凌群,11,3,8,凱基-頭份,2023-02-23,9296
3520,華盈,8,0,8,凱基-頭份,2023-02-23,9296
4168,醣聯,10,2,8,凱基-頭份,2023-02-23,9296
5512,力麒,8,0,8,凱基-頭份,2023-02-23,9296
2641,正德,50,43,7,凱基-頭份,2023-02-23,9296
6266,泰詠,8,1,7,凱基-頭份,2023-02-23,9296
8403,盛弘,7,0,7,凱基-頭份,2023-02-23,9296
2913,農林,6,0,6,凱基-頭份,2023-02-23,9296
2886,兆豐金,6,0,6,凱基-頭份,2023-02-23,9296
2609,陽明,29,23,6,凱基-頭份,2023-02-23,9296
2615,萬海,12,6,6,凱基-頭份,2023-02-23,9296
3052,夆典,6,0,6,凱基-頭份,2023-02-23,9296
3494,誠研,6,0,6,凱基-頭份,2023-02-23,9296
4161,聿新科,6,0,6,凱基-頭份,2023-02-23,9296
5210,寶碩,6,0,6,凱基-頭份,2023-02-23,9296
00676R,富邦臺灣加權反1,5,0,5,凱基-頭份,2023-02-23,9296
00772B,中信高評級公司債,5,0,5,凱基-頭份,2023-02-23,9296
1503,士電,5,0,5,凱基-頭份,2023-02-23,9296
2425,承啟,5,0,5,凱基-頭份,2023-02-23,9296
2482,連宇,10,5,5,凱基-頭份,2023-02-23,9296
2892,第一金,5,0,5,凱基-頭份,2023-02-23,9296
4554,橙的,5,0,5,凱基-頭份,2023-02-23,9296
5608,四維航,22,17,5,凱基-頭份,2023-02-23,9296
5608,四維航,175,13,162,凱基-頭份,2023-02-24,9296
00715L,期街口布蘭特正2,101,11,90,凱基-頭份,2023-02-24,9296
1201,味全,50,0,50,凱基-頭份,2023-02-24,9296
00665L,富邦�琤肭磪囓�2,50,0,50,凱基-頭份,2023-02-24,9296
6125,廣運,40,0,40,凱基-頭份,2023-02-24,9296
3704,合勤控,30,0,30,凱基-頭份,2023-02-24,9296
4402,郡都開發,26,0,26,凱基-頭份,2023-02-24,9296
00882,中信中國高股息,21,0,21,凱基-頭份,2023-02-24,9296
00650L,復華香港正2,20,0,20,凱基-頭份,2023-02-24,9296
2641,正德,30,10,20,凱基-頭份,2023-02-24,9296
2736,富野,22,2,20,凱基-頭份,2023-02-24,9296
6233,旺玖,20,0,20,凱基-頭份,2023-02-24,9296
00878,國泰永續高股息,20,4,16,凱基-頭份,2023-02-24,9296
1506,正道,18,4,14,凱基-頭份,2023-02-24,9296
2618,長榮航,14,1,13,凱基-頭份,2023-02-24,9296
2886,兆豐金,13,0,13,凱基-頭份,2023-02-24,9296
8033,雷虎,13,1,12,凱基-頭份,2023-02-24,9296
00751B,元大AAA至A公司債,10,0,10,凱基-頭份,2023-02-24,9296
1319,東陽,10,0,10,凱基-頭份,2023-02-24,9296
1810,和成,10,0,10,凱基-頭份,2023-02-24,9296
3419,譁裕,10,0,10,凱基-頭份,2023-02-24,9296
4903,聯光通,10,0,10,凱基-頭份,2023-02-24,9296
9945,潤泰新,10,0,10,凱基-頭份,2023-02-24,9296
00637L,元大滬深300正2,12,3,9,凱基-頭份,2023-02-24,9296
2457,飛宏,12,3,9,凱基-頭份,2023-02-24,9296
2498,宏達電,21,13,8,凱基-頭份,2023-02-24,9296
8227,巨有科技,11,3,8,凱基-頭份,2023-02-24,9296
3037,欣興,8,1,7,凱基-頭份,2023-02-24,9296
2883,凱基金,7,0,7,凱基-頭份,2023-02-24,9296
6535,順藥,7,0,7,凱基-頭份,2023-02-24,9296
9924,福興,7,0,7,凱基-頭份,2023-02-24,9296
4763,材料-KY,14,8,6,凱基-頭份,2023-02-24,9296
00633L,富邦上証正2,6,0,6,凱基-頭份,2023-02-24,9296
1584,精剛,10,4,6,凱基-頭份,2023-02-24,9296
1721,三晃,6,0,6,凱基-頭份,2023-02-24,9296
2303,聯電,7,1,6,凱基-頭份,2023-02-24,9296
2722,夏都,26,20,6,凱基-頭份,2023-02-24,9296
3013,晟銘電,23,17,6,凱基-頭份,2023-02-24,9296
3052,夆典,6,0,6,凱基-頭份,2023-02-24,9296
3520,華盈,6,0,6,凱基-頭份,2023-02-24,9296
6274,台燿,6,0,6,凱基-頭份,2023-02-24,9296
2892,第一金,6,0,6,凱基-頭份,2023-02-24,9296
1303,南亞,5,0,5,凱基-頭份,2023-02-24,9296
00680L,元大美債20正2,5,0,5,凱基-頭份,2023-02-24,9296
2243,宏旭-KY,5,0,5,凱基-頭份,2023-02-24,9296
2705,六福,7,2,5,凱基-頭份,2023-02-24,9296
2939,永邑-KY,5,0,5,凱基-頭份,2023-02-24,9296
3703,欣陸,5,0,5,凱基-頭份,2023-02-24,9296
4564,元翎,5,0,5,凱基-頭份,2023-02-24,9296
6005,群益證,5,0,5,凱基-頭份,2023-02-24,9296
3006,晶豪科,123,0,123,凱基-頭份,2023-03-01,9296
2002,中鋼,108,20,88,凱基-頭份,2023-03-01,9296
00878,國泰永續高股息,57,1,56,凱基-頭份,2023-03-01,9296
6139,亞翔,50,0,50,凱基-頭份,2023-03-01,9296
6187,萬潤,50,0,50,凱基-頭份,2023-03-01,9296
5608,四維航,56,23,33,凱基-頭份,2023-03-01,9296
2610,華航,26,0,26,凱基-頭份,2023-03-01,9296
9934,成霖,25,0,25,凱基-頭份,2023-03-01,9296
1605,華新,23,1,22,凱基-頭份,2023-03-01,9296
00882,中信中國高股息,21,0,21,凱基-頭份,2023-03-01,9296
2609,陽明,65,50,15,凱基-頭份,2023-03-01,9296
1101,台泥,11,0,11,凱基-頭份,2023-03-01,9296
6125,廣運,12,1,11,凱基-頭份,2023-03-01,9296
2482,連宇,11,1,10,凱基-頭份,2023-03-01,9296
00772B,中信高評級公司債,10,0,10,凱基-頭份,2023-03-01,9296
00632R,元大台灣50反1,10,0,10,凱基-頭份,2023-03-01,9296
1303,南亞,10,0,10,凱基-頭份,2023-03-01,9296
2371,大同,10,0,10,凱基-頭份,2023-03-01,9296
2809,京城銀,10,0,10,凱基-頭份,2023-03-01,9296
2201,裕隆,24,15,9,凱基-頭份,2023-03-01,9296
2812,台中銀,10,1,9,凱基-頭份,2023-03-01,9296
6282,康舒,9,0,9,凱基-頭份,2023-03-01,9296
2882,國泰金,14,6,8,凱基-頭份,2023-03-01,9296
1314,中石化,8,0,8,凱基-頭份,2023-03-01,9296
2885,元大金,8,0,8,凱基-頭份,2023-03-01,9296
2441,超豐,8,0,8,凱基-頭份,2023-03-01,9296
1514,亞力,7,0,7,凱基-頭份,2023-03-01,9296
0056,元大高股息,7,0,7,凱基-頭份,2023-03-01,9296
2344,華邦電,19,13,6,凱基-頭份,2023-03-01,9296
00673R,期元大S＆P原油反1,6,0,6,凱基-頭份,2023-03-01,9296
3491,昇達科,6,0,6,凱基-頭份,2023-03-01,9296
2883,凱基金,5,0,5,凱基-頭份,2023-03-01,9296
8171,天宇,5,0,5,凱基-頭份,2023-03-01,9296
1717,長興,5,0,5,凱基-頭份,2023-03-01,9296
2017,官田鋼,5,0,5,凱基-頭份,2023-03-01,9296
2606,裕民,14,9,5,凱基-頭份,2023-03-01,9296
3564,其陽,6,1,5,凱基-頭份,2023-03-01,9296
3652,精聯,5,0,5,凱基-頭份,2023-03-01,9296
4155,訊映,5,0,5,凱基-頭份,2023-03-01,9296
4168,醣聯,5,0,5,凱基-頭份,2023-03-01,9296
4903,聯光通,5,0,5,凱基-頭份,2023-03-01,9296
6266,泰詠,7,2,5,凱基-頭份,2023-03-01,9296
6698,旭暉應材,5,0,5,凱基-頭份,2023-03-01,9296
8234,新漢,5,0,5,凱基-頭份,2023-03-01,9296
3231,緯創,5,0,5,凱基-頭份,2023-03-01,9296
2892,第一金,5,0,5,凱基-頭份,2023-03-01,9296
00725B,國泰投資級公司債,4,0,4,凱基-頭份,2023-03-01,9296
00679B,元大美債20年,4,0,4,凱基-頭份,2023-03-01,9296
2388,威盛,14,10,4,凱基-頭份,2023-03-01,9296
3289,宜特,4,0,4,凱基-頭份,2023-03-01,9296
2884,玉山金,183,2,181,凱基-頭份,2023-03-02,9296
2886,兆豐金,60,0,60,凱基-頭份,2023-03-02,9296
2607,榮運,50,0,50,凱基-頭份,2023-03-02,9296
00878,國泰永續高股息,52,6,46,凱基-頭份,2023-03-02,9296
5512,力麒,40,0,40,凱基-頭份,2023-03-02,9296
5608,四維航,48,23,25,凱基-頭份,2023-03-02,9296
00713,元大台灣高息低波,23,0,23,凱基-頭份,2023-03-02,9296
00712,復華富時不動產,23,0,23,凱基-頭份,2023-03-02,9296
8936,國統,21,0,21,凱基-頭份,2023-03-02,9296
6139,亞翔,20,1,19,凱基-頭份,2023-03-02,9296
1701,中化,16,1,15,凱基-頭份,2023-03-02,9296
2892,第一金,14,0,14,凱基-頭份,2023-03-02,9296
3706,神達,14,0,14,凱基-頭份,2023-03-02,9296
1305,華夏,12,0,12,凱基-頭份,2023-03-02,9296
1513,中興電,18,7,11,凱基-頭份,2023-03-02,9296
2312,金寶,10,0,10,凱基-頭份,2023-03-02,9296
3013,晟銘電,10,0,10,凱基-頭份,2023-03-02,9296
00679B,元大美債20年,9,0,9,凱基-頭份,2023-03-02,9296
2482,連宇,9,0,9,凱基-頭份,2023-03-02,9296
6266,泰詠,9,0,9,凱基-頭份,2023-03-02,9296
6125,廣運,10,2,8,凱基-頭份,2023-03-02,9296
2812,台中銀,7,0,7,凱基-頭份,2023-03-02,9296
3062,建漢,7,0,7,凱基-頭份,2023-03-02,9296
6187,萬潤,10,3,7,凱基-頭份,2023-03-02,9296
6443,元晶,7,0,7,凱基-頭份,2023-03-02,9296
8033,雷虎,7,0,7,凱基-頭份,2023-03-02,9296
1605,華新,17,11,6,凱基-頭份,2023-03-02,9296
2601,益航,248,242,6,凱基-頭份,2023-03-02,9296
2748,雲品,7,1,6,凱基-頭份,2023-03-02,9296
3481,群創,8,2,6,凱基-頭份,2023-03-02,9296
6270,倍微,6,0,6,凱基-頭份,2023-03-02,9296
00772B,中信高評級公司債,5,0,5,凱基-頭份,2023-03-02,9296
2436,偉詮電,7,2,5,凱基-頭份,2023-03-02,9296
00637L,元大滬深300正2,5,0,5,凱基-頭份,2023-03-02,9296
1611,中電,5,0,5,凱基-頭份,2023-03-02,9296
2495,普安,5,0,5,凱基-頭份,2023-03-02,9296
2734,易飛網,5,0,5,凱基-頭份,2023-03-02,9296
2882,國泰金,5,0,5,凱基-頭份,2023-03-02,9296
3379,彬台,5,0,5,凱基-頭份,2023-03-02,9296
3419,譁裕,5,0,5,凱基-頭份,2023-03-02,9296
3707,漢磊,5,0,5,凱基-頭份,2023-03-02,9296
4915,致伸,5,0,5,凱基-頭份,2023-03-02,9296
5704,老爺知,5,0,5,凱基-頭份,2023-03-02,9296
6155,鈞寶,8,3,5,凱基-頭份,2023-03-02,9296
9962,有益,5,0,5,凱基-頭份,2023-03-02,9296
3652,精聯,4,0,4,凱基-頭份,2023-03-02,9296
4163,鐿鈦,4,0,4,凱基-頭份,2023-03-02,9296
2885,元大金,4,0,4,凱基-頭份,2023-03-02,9296
2890,永豐金,5,1,4,凱基-頭份,2023-03-02,9296
6118,建達,6,2,4,凱基-頭份,2023-03-02,9296
3481,群創,477,50,427,凱基-頭份,2023-03-03,9296
2884,玉山金,77,2,75,凱基-頭份,2023-03-03,9296
00632R,元大台灣50反1,47,0,47,凱基-頭份,2023-03-03,9296
2617,台航,30,5,25,凱基-頭份,2023-03-03,9296
6116,彩晶,30,5,25,凱基-頭份,2023-03-03,9296
2886,兆豐金,23,0,23,凱基-頭份,2023-03-03,9296
2002,中鋼,14,0,14,凱基-頭份,2023-03-03,9296
8227,巨有科技,25,12,13,凱基-頭份,2023-03-03,9296
6140,訊達,13,0,13,凱基-頭份,2023-03-03,9296
2611,志信,12,0,12,凱基-頭份,2023-03-03,9296
4747,強生,17,5,12,凱基-頭份,2023-03-03,9296
00885,富邦越南,11,0,11,凱基-頭份,2023-03-03,9296
00878,國泰永續高股息,11,0,11,凱基-頭份,2023-03-03,9296
2498,宏達電,12,2,10,凱基-頭份,2023-03-03,9296
00676R,富邦臺灣加權反1,10,0,10,凱基-頭份,2023-03-03,9296
2605,新興,16,6,10,凱基-頭份,2023-03-03,9296
2913,農林,11,1,10,凱基-頭份,2023-03-03,9296
6139,亞翔,10,0,10,凱基-頭份,2023-03-03,9296
1605,華新,17,8,9,凱基-頭份,2023-03-03,9296
2441,超豐,11,2,9,凱基-頭份,2023-03-03,9296
2409,友達,10,2,8,凱基-頭份,2023-03-03,9296
1210,大成,8,0,8,凱基-頭份,2023-03-03,9296
2388,威盛,11,4,7,凱基-頭份,2023-03-03,9296
2637,慧洋-KY,11,4,7,凱基-頭份,2023-03-03,9296
6492,生華科,7,0,7,凱基-頭份,2023-03-03,9296
8215,明基材,7,0,7,凱基-頭份,2023-03-03,9296
00881,國泰台灣5G+,7,1,6,凱基-頭份,2023-03-03,9296
1535,中宇,5,0,5,凱基-頭份,2023-03-03,9296
3013,晟銘電,5,0,5,凱基-頭份,2023-03-03,9296
3479,安勤,5,0,5,凱基-頭份,2023-03-03,9296
4128,中天,5,0,5,凱基-頭份,2023-03-03,9296
4164,承業醫,5,0,5,凱基-頭份,2023-03-03,9296
4919,新唐,5,0,5,凱基-頭份,2023-03-03,9296
6109,亞元,5,0,5,凱基-頭份,2023-03-03,9296
6118,建達,5,0,5,凱基-頭份,2023-03-03,9296
6133,金橋,5,0,5,凱基-頭份,2023-03-03,9296
6703,軒郁,5,0,5,凱基-頭份,2023-03-03,9296
2812,台中銀,6,1,5,凱基-頭份,2023-03-03,9296
3406,玉晶光,5,1,4,凱基-頭份,2023-03-03,9296
00633L,富邦上証正2,4,0,4,凱基-頭份,2023-03-03,9296
1584,精剛,9,5,4,凱基-頭份,2023-03-03,9296
1708,東鹼,5,1,4,凱基-頭份,2023-03-03,9296
1809,中釉,4,0,4,凱基-頭份,2023-03-03,9296
2358,廷鑫,4,0,4,凱基-頭份,2023-03-03,9296
3047,訊舟,4,0,4,凱基-頭份,2023-03-03,9296
4743,合一,4,0,4,凱基-頭份,2023-03-03,9296
5258,虹堡,27,23,4,凱基-頭份,2023-03-03,9296
6207,雷科,4,0,4,凱基-頭份,2023-03-03,9296
8222,寶一,4,0,4,凱基-頭份,2023-03-03,9296
2845,遠東銀,3,0,3,凱基-頭份,2023-03-03,9296
2891,中信金,203,13,190,凱基-頭份,2023-03-06,9296
2344,華邦電,107,3,104,凱基-頭份,2023-03-06,9296
3481,群創,73,14,59,凱基-頭份,2023-03-06,9296
2641,正德,39,0,39,凱基-頭份,2023-03-06,9296
8936,國統,26,0,26,凱基-頭份,2023-03-06,9296
6116,彩晶,33,12,21,凱基-頭份,2023-03-06,9296
2890,永豐金,20,0,20,凱基-頭份,2023-03-06,9296
3047,訊舟,20,0,20,凱基-頭份,2023-03-06,9296
00671R,富邦NASDAQ反1,20,1,19,凱基-頭份,2023-03-06,9296
00637L,元大滬深300正2,17,0,17,凱基-頭份,2023-03-06,9296
2603,長榮,16,0,16,凱基-頭份,2023-03-06,9296
00664R,國泰臺灣加權反1,15,0,15,凱基-頭份,2023-03-06,9296
2401,凌陽,15,0,15,凱基-頭份,2023-03-06,9296
00878,國泰永續高股息,19,6,13,凱基-頭份,2023-03-06,9296
00893,國泰智能電動車,14,2,12,凱基-頭份,2023-03-06,9296
2605,新興,21,10,11,凱基-頭份,2023-03-06,9296
2880,華南金,10,0,10,凱基-頭份,2023-03-06,9296
00898,國泰基因免疫革命,10,0,10,凱基-頭份,2023-03-06,9296
00751B,元大AAA至A公司債,10,0,10,凱基-頭份,2023-03-06,9296
00773B,中信優先金融債,20,10,10,凱基-頭份,2023-03-06,9296
2489,瑞軒,10,0,10,凱基-頭份,2023-03-06,9296
2618,長榮航,13,3,10,凱基-頭份,2023-03-06,9296
3356,奇偶,13,3,10,凱基-頭份,2023-03-06,9296
8201,無敵,10,0,10,凱基-頭份,2023-03-06,9296
1539,巨庭,10,0,10,凱基-頭份,2023-03-06,9296
2419,仲琦,11,3,8,凱基-頭份,2023-03-06,9296
3704,合勤控,10,2,8,凱基-頭份,2023-03-06,9296
00712,復華富時不動產,12,5,7,凱基-頭份,2023-03-06,9296
2374,佳能,10,3,7,凱基-頭份,2023-03-06,9296
2609,陽明,15,8,7,凱基-頭份,2023-03-06,9296
2637,慧洋-KY,6,0,6,凱基-頭份,2023-03-06,9296
3379,彬台,6,0,6,凱基-頭份,2023-03-06,9296
5272,笙科,6,0,6,凱基-頭份,2023-03-06,9296
2002,中鋼,11,5,6,凱基-頭份,2023-03-06,9296
2845,遠東銀,5,0,5,凱基-頭份,2023-03-06,9296
6153,嘉聯益,5,0,5,凱基-頭份,2023-03-06,9296
00676R,富邦臺灣加權反1,5,0,5,凱基-頭份,2023-03-06,9296
1312,國喬,5,0,5,凱基-頭份,2023-03-06,9296
1605,華新,8,3,5,凱基-頭份,2023-03-06,9296
2363,矽統,5,0,5,凱基-頭份,2023-03-06,9296
2495,普安,11,6,5,凱基-頭份,2023-03-06,9296
2610,華航,5,0,5,凱基-頭份,2023-03-06,9296
2706,第一店,5,0,5,凱基-頭份,2023-03-06,9296
3511,矽瑪,5,0,5,凱基-頭份,2023-03-06,9296
3556,禾瑞亞,5,0,5,凱基-頭份,2023-03-06,9296
4168,醣聯,5,0,5,凱基-頭份,2023-03-06,9296
5353,台林,5,0,5,凱基-頭份,2023-03-06,9296
6155,鈞寶,11,6,5,凱基-頭份,2023-03-06,9296
6163,華電網,5,0,5,凱基-頭份,2023-03-06,9296
8131,福懋科,5,0,5,凱基-頭份,2023-03-06,9296
00673R,期元大S＆P原油反1,118,0,118,凱基-頭份,2023-03-07,9296
3481,群創,28,1,27,凱基-頭份,2023-03-07,9296
3046,建��,23,2,21,凱基-頭份,2023-03-07,9296
00878,國泰永續高股息,23,4,19,凱基-頭份,2023-03-07,9296
6188,廣明,19,0,19,凱基-頭份,2023-03-07,9296
2303,聯電,17,1,16,凱基-頭份,2023-03-07,9296
1303,南亞,12,0,12,凱基-頭份,2023-03-07,9296
4543,萬在,12,0,12,凱基-頭份,2023-03-07,9296
2890,永豐金,11,0,11,凱基-頭份,2023-03-07,9296
3706,神達,11,0,11,凱基-頭份,2023-03-07,9296
1513,中興電,19,9,10,凱基-頭份,2023-03-07,9296
1309,台達化,10,0,10,凱基-頭份,2023-03-07,9296
00898,國泰基因免疫革命,10,0,10,凱基-頭份,2023-03-07,9296
2363,矽統,10,0,10,凱基-頭份,2023-03-07,9296
2722,夏都,11,1,10,凱基-頭份,2023-03-07,9296
5864,致和證,10,0,10,凱基-頭份,2023-03-07,9296
5903,全家,10,0,10,凱基-頭份,2023-03-07,9296
6282,康舒,14,4,10,凱基-頭份,2023-03-07,9296
3704,合勤控,10,0,10,凱基-頭份,2023-03-07,9296
3491,昇達科,10,0,10,凱基-頭份,2023-03-07,9296
4976,佳凌,16,7,9,凱基-頭份,2023-03-07,9296
4977,眾達-KY,13,4,9,凱基-頭份,2023-03-07,9296
8931,大汽電,9,0,9,凱基-頭份,2023-03-07,9296
1219,福壽,11,4,7,凱基-頭份,2023-03-07,9296
2353,宏��,7,0,7,凱基-頭份,2023-03-07,9296
2883,凱基金,7,0,7,凱基-頭份,2023-03-07,9296
3019,亞光,13,6,7,凱基-頭份,2023-03-07,9296
3029,零壹,23,16,7,凱基-頭份,2023-03-07,9296
3152,璟德,7,0,7,凱基-頭份,2023-03-07,9296
3684,榮昌,7,0,7,凱基-頭份,2023-03-07,9296
2618,長榮航,8,2,6,凱基-頭份,2023-03-07,9296
00715L,期街口布蘭特正2,6,0,6,凱基-頭份,2023-03-07,9296
2419,仲琦,7,1,6,凱基-頭份,2023-03-07,9296
3504,揚明光,9,3,6,凱基-頭份,2023-03-07,9296
6443,元晶,19,13,6,凱基-頭份,2023-03-07,9296
1525,江申,5,0,5,凱基-頭份,2023-03-07,9296
1314,中石化,5,0,5,凱基-頭份,2023-03-07,9296
1611,中電,5,0,5,凱基-頭份,2023-03-07,9296
2243,宏旭-KY,5,0,5,凱基-頭份,2023-03-07,9296
2328,廣宇,5,0,5,凱基-頭份,2023-03-07,9296
2601,益航,5,0,5,凱基-頭份,2023-03-07,9296
2605,新興,5,0,5,凱基-頭份,2023-03-07,9296
2736,富野,10,5,5,凱基-頭份,2023-03-07,9296
2892,第一金,5,0,5,凱基-頭份,2023-03-07,9296
3147,大綜,5,0,5,凱基-頭份,2023-03-07,9296
3687,歐買尬,5,0,5,凱基-頭份,2023-03-07,9296
6570,維田,5,0,5,凱基-頭份,2023-03-07,9296
8426,紅木-KY,6,1,5,凱基-頭份,2023-03-07,9296
1210,大成,4,0,4,凱基-頭份,2023-03-07,9296
2401,凌陽,4,0,4,凱基-頭份,2023-03-07,9296
00637L,元大滬深300正2,67,6,61,凱基-頭份,2023-03-08,9296
8936,國統,50,1,49,凱基-頭份,2023-03-08,9296
2605,新興,40,16,24,凱基-頭份,2023-03-08,9296
2028,威致,20,0,20,凱基-頭份,2023-03-08,9296
1524,耿鼎,20,1,19,凱基-頭份,2023-03-08,9296
00633L,富邦上証正2,18,0,18,凱基-頭份,2023-03-08,9296
00878,國泰永續高股息,23,6,17,凱基-頭份,2023-03-08,9296
00665L,富邦�琤肭磪囓�2,17,0,17,凱基-頭份,2023-03-08,9296
2482,連宇,18,2,16,凱基-頭份,2023-03-08,9296
2606,裕民,17,1,16,凱基-頭份,2023-03-08,9296
3499,環天科,15,0,15,凱基-頭份,2023-03-08,9296
2883,凱基金,15,1,14,凱基-頭份,2023-03-08,9296
3481,群創,21,8,13,凱基-頭份,2023-03-08,9296
3066,李洲,13,1,12,凱基-頭份,2023-03-08,9296
2634,漢翔,22,11,11,凱基-頭份,2023-03-08,9296
9933,中鼎,10,0,10,凱基-頭份,2023-03-08,9296
00642U,期元大S＆P石油,10,0,10,凱基-頭份,2023-03-08,9296
00898,國泰基因免疫革命,10,0,10,凱基-頭份,2023-03-08,9296
3052,夆典,10,0,10,凱基-頭份,2023-03-08,9296
3236,千如,10,0,10,凱基-頭份,2023-03-08,9296
6741,91APP*-KY,12,2,10,凱基-頭份,2023-03-08,9296
2618,長榮航,13,4,9,凱基-頭份,2023-03-08,9296
3673,TPK-KY,10,1,9,凱基-頭份,2023-03-08,9296
2313,華通,8,0,8,凱基-頭份,2023-03-08,9296
3346,麗清,8,0,8,凱基-頭份,2023-03-08,9296
9934,成霖,8,0,8,凱基-頭份,2023-03-08,9296
1504,東元,8,1,7,凱基-頭份,2023-03-08,9296
2481,強茂,11,4,7,凱基-頭份,2023-03-08,9296
2344,華邦電,10,3,7,凱基-頭份,2023-03-08,9296
2601,益航,6,0,6,凱基-頭份,2023-03-08,9296
2722,夏都,6,0,6,凱基-頭份,2023-03-08,9296
3147,大綜,6,0,6,凱基-頭份,2023-03-08,9296
3706,神達,6,0,6,凱基-頭份,2023-03-08,9296
8213,志超,6,0,6,凱基-頭份,2023-03-08,9296
1451,年興,5,0,5,凱基-頭份,2023-03-08,9296
1525,江申,5,0,5,凱基-頭份,2023-03-08,9296
1906,寶隆,5,0,5,凱基-頭份,2023-03-08,9296
6288,聯嘉,5,0,5,凱基-頭份,2023-03-08,9296
8426,紅木-KY,5,0,5,凱基-頭份,2023-03-08,9296
9962,有益,5,0,5,凱基-頭份,2023-03-08,9296
00902,中信電池及儲能,4,0,4,凱基-頭份,2023-03-08,9296
00662,富邦NASDAQ,4,0,4,凱基-頭份,2023-03-08,9296
2353,宏��,4,0,4,凱基-頭份,2023-03-08,9296
2534,宏盛,4,0,4,凱基-頭份,2023-03-08,9296
3013,晟銘電,9,5,4,凱基-頭份,2023-03-08,9296
3413,京鼎,4,0,4,凱基-頭份,2023-03-08,9296
4123,晟德,4,0,4,凱基-頭份,2023-03-08,9296
8931,大汽電,4,0,4,凱基-頭份,2023-03-08,9296
00712,復華富時不動產,5,2,3,凱基-頭份,2023-03-08,9296
00919,群益台灣精選高息,3,0,3,凱基-頭份,2023-03-08,9296
00665L,富邦�琤肭磪囓�2,155,0,155,凱基-頭份,2023-03-09,9296
00878,國泰永續高股息,56,0,56,凱基-頭份,2023-03-09,9296
2812,台中銀,52,2,50,凱基-頭份,2023-03-09,9296
00632R,元大台灣50反1,40,5,35,凱基-頭份,2023-03-09,9296
3189,景碩,35,4,31,凱基-頭份,2023-03-09,9296
2886,兆豐金,22,1,21,凱基-頭份,2023-03-09,9296
2890,永豐金,30,10,20,凱基-頭份,2023-03-09,9296
3704,合勤控,20,0,20,凱基-頭份,2023-03-09,9296
6443,元晶,18,1,17,凱基-頭份,2023-03-09,9296
2486,一詮,60,44,16,凱基-頭份,2023-03-09,9296
8227,巨有科技,19,3,16,凱基-頭份,2023-03-09,9296
2409,友達,15,0,15,凱基-頭份,2023-03-09,9296
2617,台航,15,0,15,凱基-頭份,2023-03-09,9296
3499,環天科,15,0,15,凱基-頭份,2023-03-09,9296
6266,泰詠,16,2,14,凱基-頭份,2023-03-09,9296
2431,聯昌,13,0,13,凱基-頭份,2023-03-09,9296
1709,和益,12,0,12,凱基-頭份,2023-03-09,9296
2610,華航,20,8,12,凱基-頭份,2023-03-09,9296
3706,神達,12,0,12,凱基-頭份,2023-03-09,9296
8213,志超,12,0,12,凱基-頭份,2023-03-09,9296
2317,鴻海,13,1,12,凱基-頭份,2023-03-09,9296
00633L,富邦上証正2,11,0,11,凱基-頭份,2023-03-09,9296
2471,資通,19,9,10,凱基-頭份,2023-03-09,9296
00923,群益台ESG低碳50,10,0,10,凱基-頭份,2023-03-09,9296
1305,華夏,10,0,10,凱基-頭份,2023-03-09,9296
9933,中鼎,10,0,10,凱基-頭份,2023-03-09,9296
3594,磐儀,10,0,10,凱基-頭份,2023-03-09,9296
2880,華南金,11,1,10,凱基-頭份,2023-03-09,9296
1303,南亞,9,0,9,凱基-頭份,2023-03-09,9296
3466,德晉,10,1,9,凱基-頭份,2023-03-09,9296
2734,易飛網,8,0,8,凱基-頭份,2023-03-09,9296
2497,怡利電,13,5,8,凱基-頭份,2023-03-09,9296
2637,慧洋-KY,8,0,8,凱基-頭份,2023-03-09,9296
6140,訊達,8,0,8,凱基-頭份,2023-03-09,9296
2498,宏達電,8,1,7,凱基-頭份,2023-03-09,9296
00642U,期元大S＆P石油,7,0,7,凱基-頭份,2023-03-09,9296
5009,榮剛,7,0,7,凱基-頭份,2023-03-09,9296
3058,立德,7,0,7,凱基-頭份,2023-03-09,9296
1536,和大,6,0,6,凱基-頭份,2023-03-09,9296
2034,允強,6,0,6,凱基-頭份,2023-03-09,9296
8234,新漢,7,1,6,凱基-頭份,2023-03-09,9296
9802,鈺齊-KY,6,0,6,凱基-頭份,2023-03-09,9296
00712,復華富時不動產,5,0,5,凱基-頭份,2023-03-09,9296
00900,富邦特選高股息30,5,0,5,凱基-頭份,2023-03-09,9296
2017,官田鋼,10,5,5,凱基-頭份,2023-03-09,9296
2363,矽統,5,0,5,凱基-頭份,2023-03-09,9296
2365,昆盈,5,0,5,凱基-頭份,2023-03-09,9296
2413,環科,7,2,5,凱基-頭份,2023-03-09,9296
2884,玉山金,6,1,5,凱基-頭份,2023-03-09,9296
3015,全漢,5,0,5,凱基-頭份,2023-03-09,9296
3481,群創,417,30,387,凱基-頭份,2023-03-10,9296
2886,兆豐金,95,0,95,凱基-頭份,2023-03-10,9296
00878,國泰永續高股息,65,11,54,凱基-頭份,2023-03-10,9296
5512,力麒,50,1,49,凱基-頭份,2023-03-10,9296
00637L,元大滬深300正2,50,12,38,凱基-頭份,2023-03-10,9296
912000,晨訊科-DR,38,0,38,凱基-頭份,2023-03-10,9296
3704,合勤控,35,0,35,凱基-頭份,2023-03-10,9296
2618,長榮航,39,6,33,凱基-頭份,2023-03-10,9296
2331,精英,40,10,30,凱基-頭份,2023-03-10,9296
2888,新光金,29,0,29,凱基-頭份,2023-03-10,9296
2883,凱基金,25,0,25,凱基-頭份,2023-03-10,9296
1319,東陽,25,2,23,凱基-頭份,2023-03-10,9296
00642U,期元大S＆P石油,22,0,22,凱基-頭份,2023-03-10,9296
00632R,元大台灣50反1,40,20,20,凱基-頭份,2023-03-10,9296
1444,力麗,20,0,20,凱基-頭份,2023-03-10,9296
00713,元大台灣高息低波,19,0,19,凱基-頭份,2023-03-10,9296
2641,正德,28,10,18,凱基-頭份,2023-03-10,9296
3047,訊舟,22,4,18,凱基-頭份,2023-03-10,9296
2344,華邦電,20,3,17,凱基-頭份,2023-03-10,9296
3652,精聯,17,0,17,凱基-頭份,2023-03-10,9296
9934,成霖,16,0,16,凱基-頭份,2023-03-10,9296
2834,臺企銀,15,0,15,凱基-頭份,2023-03-10,9296
2303,聯電,16,1,15,凱基-頭份,2023-03-10,9296
00882,中信中國高股息,14,0,14,凱基-頭份,2023-03-10,9296
2890,永豐金,14,0,14,凱基-頭份,2023-03-10,9296
5880,合庫金,14,0,14,凱基-頭份,2023-03-10,9296
2449,京元電子,13,0,13,凱基-頭份,2023-03-10,9296
1303,南亞,13,0,13,凱基-頭份,2023-03-10,9296
7402,邑錡,66,53,13,凱基-頭份,2023-03-10,9296
00665L,富邦�琤肭磪囓�2,74,62,12,凱基-頭份,2023-03-10,9296
3491,昇達科,12,0,12,凱基-頭份,2023-03-10,9296
4142,國光生,13,1,12,凱基-頭份,2023-03-10,9296
6703,軒郁,12,0,12,凱基-頭份,2023-03-10,9296
2388,威盛,24,13,11,凱基-頭份,2023-03-10,9296
00650L,復華香港正2,10,0,10,凱基-頭份,2023-03-10,9296
1734,杏輝,10,0,10,凱基-頭份,2023-03-10,9296
2401,凌陽,10,0,10,凱基-頭份,2023-03-10,9296
6265,方土昶,10,0,10,凱基-頭份,2023-03-10,9296
2605,新興,18,9,9,凱基-頭份,2023-03-10,9296
1101,台泥,8,0,8,凱基-頭份,2023-03-10,9296
2317,鴻海,10,2,8,凱基-頭份,2023-03-10,9296
2534,宏盛,8,0,8,凱基-頭份,2023-03-10,9296
2880,華南金,8,0,8,凱基-頭份,2023-03-10,9296
3684,榮昌,8,0,8,凱基-頭份,2023-03-10,9296
5258,虹堡,9,1,8,凱基-頭份,2023-03-10,9296
5309,系統電,8,0,8,凱基-頭份,2023-03-10,9296
00662,富邦NASDAQ,7,0,7,凱基-頭份,2023-03-10,9296
00633L,富邦上証正2,7,0,7,凱基-頭份,2023-03-10,9296
2442,新美齊,7,0,7,凱基-頭份,2023-03-10,9296
2887,台新金,7,0,7,凱基-頭份,2023-03-10,9296
911868,同方友友-DR,200,0,200,凱基-頭份,2023-03-13,9296
00878,國泰永續高股息,76,10,66,凱基-頭份,2023-03-13,9296
2609,陽明,131,73,58,凱基-頭份,2023-03-13,9296
2610,華航,39,2,37,凱基-頭份,2023-03-13,9296
1319,東陽,53,22,31,凱基-頭份,2023-03-13,9296
2328,廣宇,31,0,31,凱基-頭份,2023-03-13,9296
5465,富驊,30,0,30,凱基-頭份,2023-03-13,9296
00676R,富邦臺灣加權反1,30,5,25,凱基-頭份,2023-03-13,9296
2886,兆豐金,22,0,22,凱基-頭份,2023-03-13,9296
00687B,國泰20年美債,20,0,20,凱基-頭份,2023-03-13,9296
3236,千如,20,0,20,凱基-頭份,2023-03-13,9296
4916,事欣科,19,1,18,凱基-頭份,2023-03-13,9296
4977,眾達-KY,19,1,18,凱基-頭份,2023-03-13,9296
1504,東元,17,0,17,凱基-頭份,2023-03-13,9296
3673,TPK-KY,19,2,17,凱基-頭份,2023-03-13,9296
2201,裕隆,24,10,14,凱基-頭份,2023-03-13,9296
5009,榮剛,16,2,14,凱基-頭份,2023-03-13,9296
2887,台新金,21,10,11,凱基-頭份,2023-03-13,9296
00715L,期街口布蘭特正2,10,0,10,凱基-頭份,2023-03-13,9296
1734,杏輝,10,0,10,凱基-頭份,2023-03-13,9296
2009,第一銅,10,0,10,凱基-頭份,2023-03-13,9296
2401,凌陽,10,0,10,凱基-頭份,2023-03-13,9296
3704,合勤控,10,1,9,凱基-頭份,2023-03-13,9296
2618,長榮航,8,0,8,凱基-頭份,2023-03-13,9296
2457,飛宏,46,38,8,凱基-頭份,2023-03-13,9296
00713,元大台灣高息低波,7,0,7,凱基-頭份,2023-03-13,9296
2468,華經,6,0,6,凱基-頭份,2023-03-13,9296
2890,永豐金,6,0,6,凱基-頭份,2023-03-13,9296
3047,訊舟,8,2,6,凱基-頭份,2023-03-13,9296
4142,國光生,6,0,6,凱基-頭份,2023-03-13,9296
2390,云辰,5,0,5,凱基-頭份,2023-03-13,9296
2402,毅嘉,5,0,5,凱基-頭份,2023-03-13,9296
2606,裕民,8,3,5,凱基-頭份,2023-03-13,9296
6288,聯嘉,5,0,5,凱基-頭份,2023-03-13,9296
6703,軒郁,6,1,5,凱基-頭份,2023-03-13,9296
5880,合庫金,4,0,4,凱基-頭份,2023-03-13,9296
00881,國泰台灣5G+,4,0,4,凱基-頭份,2023-03-13,9296
00923,群益台ESG低碳50,4,0,4,凱基-頭份,2023-03-13,9296
2482,連宇,7,3,4,凱基-頭份,2023-03-13,9296
2498,宏達電,12,8,4,凱基-頭份,2023-03-13,9296
2641,正德,4,0,4,凱基-頭份,2023-03-13,9296
3652,精聯,4,0,4,凱基-頭份,2023-03-13,9296
6770,力積電,10,6,4,凱基-頭份,2023-03-13,9296
8097,常珵,6,2,4,凱基-頭份,2023-03-13,9296
1711,永光,4,0,4,凱基-頭份,2023-03-13,9296
2441,超豐,3,0,3,凱基-頭份,2023-03-13,9296
2413,環科,4,1,3,凱基-頭份,2023-03-13,9296
2442,新美齊,3,0,3,凱基-頭份,2023-03-13,9296
2611,志信,3,0,3,凱基-頭份,2023-03-13,9296
2613,中櫃,3,0,3,凱基-頭份,2023-03-13,9296
3006,晶豪科,241,0,241,凱基-頭份,2023-03-14,9296
00878,國泰永續高股息,129,2,127,凱基-頭份,2023-03-14,9296
2886,兆豐金,91,0,91,凱基-頭份,2023-03-14,9296
2344,華邦電,77,2,75,凱基-頭份,2023-03-14,9296
2413,環科,40,1,39,凱基-頭份,2023-03-14,9296
2618,長榮航,38,2,36,凱基-頭份,2023-03-14,9296
2812,台中銀,72,46,26,凱基-頭份,2023-03-14,9296
3704,合勤控,25,0,25,凱基-頭份,2023-03-14,9296
2834,臺企銀,25,3,22,凱基-頭份,2023-03-14,9296
00642U,期元大S＆P石油,22,0,22,凱基-頭份,2023-03-14,9296
2017,官田鋼,30,10,20,凱基-頭份,2023-03-14,9296
5465,富驊,20,0,20,凱基-頭份,2023-03-14,9296
1101,台泥,19,0,19,凱基-頭份,2023-03-14,9296
00713,元大台灣高息低波,18,0,18,凱基-頭份,2023-03-14,9296
00665L,富邦�琤肭磪囓�2,18,0,18,凱基-頭份,2023-03-14,9296
00637L,元大滬深300正2,24,8,16,凱基-頭份,2023-03-14,9296
2888,新光金,21,5,16,凱基-頭份,2023-03-14,9296
00715L,期街口布蘭特正2,19,4,15,凱基-頭份,2023-03-14,9296
2609,陽明,24,10,14,凱基-頭份,2023-03-14,9296
3481,群創,20,7,13,凱基-頭份,2023-03-14,9296
2883,凱基金,12,0,12,凱基-頭份,2023-03-14,9296
00882,中信中國高股息,12,0,12,凱基-頭份,2023-03-14,9296
2897,王道銀行,15,3,12,凱基-頭份,2023-03-14,9296
6290,良維,14,2,12,凱基-頭份,2023-03-14,9296
00712,復華富時不動產,11,0,11,凱基-頭份,2023-03-14,9296
00907,永豐優息存股,11,0,11,凱基-頭份,2023-03-14,9296
2892,第一金,13,3,10,凱基-頭份,2023-03-14,9296
1319,東陽,10,0,10,凱基-頭份,2023-03-14,9296
2613,中櫃,10,0,10,凱基-頭份,2023-03-14,9296
4989,榮科,10,0,10,凱基-頭份,2023-03-14,9296
6265,方土昶,10,0,10,凱基-頭份,2023-03-14,9296
2615,萬海,20,11,9,凱基-頭份,2023-03-14,9296
2880,華南金,9,0,9,凱基-頭份,2023-03-14,9296
2610,華航,8,0,8,凱基-頭份,2023-03-14,9296
00633L,富邦上証正2,8,0,8,凱基-頭份,2023-03-14,9296
1783,和康生,8,0,8,凱基-頭份,2023-03-14,9296
2331,精英,8,0,8,凱基-頭份,2023-03-14,9296
8926,台汽電,8,0,8,凱基-頭份,2023-03-14,9296
8213,志超,7,0,7,凱基-頭份,2023-03-14,9296
5880,合庫金,6,0,6,凱基-頭份,2023-03-14,9296
2409,友達,6,0,6,凱基-頭份,2023-03-14,9296
1326,台化,6,0,6,凱基-頭份,2023-03-14,9296
3005,神基,8,2,6,凱基-頭份,2023-03-14,9296
2885,元大金,5,0,5,凱基-頭份,2023-03-14,9296
1432,大魯閣,5,0,5,凱基-頭份,2023-03-14,9296
00902,中信電池及儲能,5,0,5,凱基-頭份,2023-03-14,9296
00710B,復華彭博非投等債,5,0,5,凱基-頭份,2023-03-14,9296
00773B,中信優先金融債,5,0,5,凱基-頭份,2023-03-14,9296
3052,夆典,5,0,5,凱基-頭份,2023-03-14,9296
3499,環天科,5,0,5,凱基-頭份,2023-03-14,9296
1102,亞泥,151,0,151,凱基-頭份,2023-03-15,9296
911868,同方友友-DR,100,0,100,凱基-頭份,2023-03-15,9296
2884,玉山金,94,1,93,凱基-頭份,2023-03-15,9296
00715L,期街口布蘭特正2,84,5,79,凱基-頭份,2023-03-15,9296
00676R,富邦臺灣加權反1,65,0,65,凱基-頭份,2023-03-15,9296
00878,國泰永續高股息,51,0,51,凱基-頭份,2023-03-15,9296
2603,長榮,53,16,37,凱基-頭份,2023-03-15,9296
2606,裕民,40,5,35,凱基-頭份,2023-03-15,9296
3481,群創,22,0,22,凱基-頭份,2023-03-15,9296
1611,中電,20,0,20,凱基-頭份,2023-03-15,9296
3704,合勤控,20,0,20,凱基-頭份,2023-03-15,9296
5880,合庫金,14,0,14,凱基-頭份,2023-03-15,9296
00642U,期元大S＆P石油,13,0,13,凱基-頭份,2023-03-15,9296
2017,官田鋼,15,2,13,凱基-頭份,2023-03-15,9296
2883,凱基金,13,1,12,凱基-頭份,2023-03-15,9296
2609,陽明,17,5,12,凱基-頭份,2023-03-15,9296
3576,聯合再生,12,0,12,凱基-頭份,2023-03-15,9296
8097,常珵,12,0,12,凱基-頭份,2023-03-15,9296
1513,中興電,17,6,11,凱基-頭份,2023-03-15,9296
2888,新光金,21,10,11,凱基-頭份,2023-03-15,9296
8936,國統,11,0,11,凱基-頭份,2023-03-15,9296
1708,東鹼,10,0,10,凱基-頭份,2023-03-15,9296
2887,台新金,10,0,10,凱基-頭份,2023-03-15,9296
6125,廣運,10,1,9,凱基-頭份,2023-03-15,9296
00712,復華富時不動產,7,0,7,凱基-頭份,2023-03-15,9296
2891,中信金,7,0,7,凱基-頭份,2023-03-15,9296
1326,台化,7,0,7,凱基-頭份,2023-03-15,9296
2413,環科,8,1,7,凱基-頭份,2023-03-15,9296
3434,哲固,7,0,7,凱基-頭份,2023-03-15,9296
3624,光頡,9,2,7,凱基-頭份,2023-03-15,9296
2497,怡利電,9,3,6,凱基-頭份,2023-03-15,9296
5272,笙科,6,0,6,凱基-頭份,2023-03-15,9296
00664R,國泰臺灣加權反1,5,0,5,凱基-頭份,2023-03-15,9296
00648R,元大S＆P500反1,5,0,5,凱基-頭份,2023-03-15,9296
00632R,元大台灣50反1,25,20,5,凱基-頭份,2023-03-15,9296
1303,南亞,5,0,5,凱基-頭份,2023-03-15,9296
2371,大同,5,0,5,凱基-頭份,2023-03-15,9296
2401,凌陽,5,0,5,凱基-頭份,2023-03-15,9296
3684,榮昌,5,0,5,凱基-頭份,2023-03-15,9296
4977,眾達-KY,5,0,5,凱基-頭份,2023-03-15,9296
6284,佳邦,5,0,5,凱基-頭份,2023-03-15,9296
6603,富強鑫,5,0,5,凱基-頭份,2023-03-15,9296
6770,力積電,6,1,5,凱基-頭份,2023-03-15,9296
1437,勤益控,4,0,4,凱基-頭份,2023-03-15,9296
1609,大亞,5,1,4,凱基-頭份,2023-03-15,9296
1712,興農,4,0,4,凱基-頭份,2023-03-15,9296
1737,臺鹽,4,0,4,凱基-頭份,2023-03-15,9296
2633,台灣高鐵,4,0,4,凱基-頭份,2023-03-15,9296
6715,嘉基,6,2,4,凱基-頭份,2023-03-15,9296
9955,佳龍,8,4,4,凱基-頭份,2023-03-15,9296
2891,中信金,66,0,66,凱基-頭份,2023-03-16,9296
2834,臺企銀,53,1,52,凱基-頭份,2023-03-16,9296
00888,永豐台灣ESG,50,0,50,凱基-頭份,2023-03-16,9296
00715L,期街口布蘭特正2,54,17,37,凱基-頭份,2023-03-16,9296
00878,國泰永續高股息,39,2,37,凱基-頭份,2023-03-16,9296
00713,元大台灣高息低波,30,0,30,凱基-頭份,2023-03-16,9296
2852,第一保,30,0,30,凱基-頭份,2023-03-16,9296
6643,M31,34,4,30,凱基-頭份,2023-03-16,9296
4402,郡都開發,25,0,25,凱基-頭份,2023-03-16,9296
2618,長榮航,23,0,23,凱基-頭份,2023-03-16,9296
2886,兆豐金,22,0,22,凱基-頭份,2023-03-16,9296
2884,玉山金,20,2,18,凱基-頭份,2023-03-16,9296
6443,元晶,37,20,17,凱基-頭份,2023-03-16,9296
2883,凱基金,17,0,17,凱基-頭份,2023-03-16,9296
3056,富華新,22,6,16,凱基-頭份,2023-03-16,9296
3704,合勤控,16,1,15,凱基-頭份,2023-03-16,9296
1605,華新,18,3,15,凱基-頭份,2023-03-16,9296
2401,凌陽,15,0,15,凱基-頭份,2023-03-16,9296
1314,中石化,12,0,12,凱基-頭份,2023-03-16,9296
6770,力積電,12,0,12,凱基-頭份,2023-03-16,9296
2603,長榮,37,25,12,凱基-頭份,2023-03-16,9296
1319,東陽,11,0,11,凱基-頭份,2023-03-16,9296
1326,台化,11,0,11,凱基-頭份,2023-03-16,9296
2609,陽明,22,11,11,凱基-頭份,2023-03-16,9296
2867,三商壽,10,0,10,凱基-頭份,2023-03-16,9296
3027,盛達,13,3,10,凱基-頭份,2023-03-16,9296
00712,復華富時不動產,13,3,10,凱基-頭份,2023-03-16,9296
00665L,富邦�琤肭磪囓�2,20,10,10,凱基-頭份,2023-03-16,9296
00637L,元大滬深300正2,12,2,10,凱基-頭份,2023-03-16,9296
2201,裕隆,14,4,10,凱基-頭份,2023-03-16,9296
2610,華航,10,0,10,凱基-頭份,2023-03-16,9296
3037,欣興,10,1,9,凱基-頭份,2023-03-16,9296
00642U,期元大S＆P石油,15,6,9,凱基-頭份,2023-03-16,9296
5880,合庫金,8,0,8,凱基-頭份,2023-03-16,9296
1810,和成,8,0,8,凱基-頭份,2023-03-16,9296
2887,台新金,7,0,7,凱基-頭份,2023-03-16,9296
3094,聯傑,8,1,7,凱基-頭份,2023-03-16,9296
2881,富邦金,6,0,6,凱基-頭份,2023-03-16,9296
0056,元大高股息,8,2,6,凱基-頭份,2023-03-16,9296
2880,華南金,6,0,6,凱基-頭份,2023-03-16,9296
2882,國泰金,6,0,6,凱基-頭份,2023-03-16,9296
2812,台中銀,6,0,6,凱基-頭份,2023-03-16,9296
3264,欣銓,13,8,5,凱基-頭份,2023-03-16,9296
1514,亞力,5,0,5,凱基-頭份,2023-03-16,9296
2017,官田鋼,5,0,5,凱基-頭份,2023-03-16,9296
2338,光罩,6,1,5,凱基-頭份,2023-03-16,9296
2409,友達,7,2,5,凱基-頭份,2023-03-16,9296
2606,裕民,40,35,5,凱基-頭份,2023-03-16,9296
2885,元大金,5,0,5,凱基-頭份,2023-03-16,9296
3047,訊舟,5,0,5,凱基-頭份,2023-03-16,9296
2834,臺企銀,55,12,43,凱基-頭份,2023-03-17,9296
2812,台中銀,73,32,41,凱基-頭份,2023-03-17,9296
2891,中信金,37,0,37,凱基-頭份,2023-03-17,9296
00671R,富邦NASDAQ反1,34,0,34,凱基-頭份,2023-03-17,9296
2353,宏��,47,14,33,凱基-頭份,2023-03-17,9296
00878,國泰永續高股息,42,12,30,凱基-頭份,2023-03-17,9296
9103,美德醫療-DR,29,0,29,凱基-頭份,2023-03-17,9296
1609,大亞,20,0,20,凱基-頭份,2023-03-17,9296
2009,第一銅,20,0,20,凱基-頭份,2023-03-17,9296
2603,長榮,27,11,16,凱基-頭份,2023-03-17,9296
00712,復華富時不動產,13,0,13,凱基-頭份,2023-03-17,9296
5483,中美晶,16,4,12,凱基-頭份,2023-03-17,9296
1319,東陽,11,0,11,凱基-頭份,2023-03-17,9296
2371,大同,11,0,11,凱基-頭份,2023-03-17,9296
3236,千如,10,0,10,凱基-頭份,2023-03-17,9296
8936,國統,12,2,10,凱基-頭份,2023-03-17,9296
00713,元大台灣高息低波,8,0,8,凱基-頭份,2023-03-17,9296
00632R,元大台灣50反1,8,0,8,凱基-頭份,2023-03-17,9296
2883,凱基金,7,0,7,凱基-頭份,2023-03-17,9296
8105,凌巨,7,0,7,凱基-頭份,2023-03-17,9296
9945,潤泰新,11,4,7,凱基-頭份,2023-03-17,9296
2338,光罩,8,2,6,凱基-頭份,2023-03-17,9296
2609,陽明,8,2,6,凱基-頭份,2023-03-17,9296
2449,京元電子,5,0,5,凱基-頭份,2023-03-17,9296
00715L,期街口布蘭特正2,5,0,5,凱基-頭份,2023-03-17,9296
00882,中信中國高股息,5,0,5,凱基-頭份,2023-03-17,9296
00664R,國泰臺灣加權反1,5,0,5,凱基-頭份,2023-03-17,9296
00642U,期元大S＆P石油,7,2,5,凱基-頭份,2023-03-17,9296
00676R,富邦臺灣加權反1,5,0,5,凱基-頭份,2023-03-17,9296
2406,國碩,7,2,5,凱基-頭份,2023-03-17,9296
2413,環科,5,0,5,凱基-頭份,2023-03-17,9296
2468,華經,5,0,5,凱基-頭份,2023-03-17,9296
2615,萬海,5,0,5,凱基-頭份,2023-03-17,9296
2845,遠東銀,5,0,5,凱基-頭份,2023-03-17,9296
2887,台新金,5,0,5,凱基-頭份,2023-03-17,9296
3652,精聯,5,0,5,凱基-頭份,2023-03-17,9296
4306,炎洲,6,1,5,凱基-頭份,2023-03-17,9296
6235,華孚,8,3,5,凱基-頭份,2023-03-17,9296
6492,生華科,5,0,5,凱基-頭份,2023-03-17,9296
00679B,元大美債20年,4,0,4,凱基-頭份,2023-03-17,9296
00706L,期元大S＆P日圓正2,4,0,4,凱基-頭份,2023-03-17,9296
1733,五鼎,4,0,4,凱基-頭份,2023-03-17,9296
2614,東森,4,0,4,凱基-頭份,2023-03-17,9296
2633,台灣高鐵,4,0,4,凱基-頭份,2023-03-17,9296
2867,三商壽,4,0,4,凱基-頭份,2023-03-17,9296
2884,玉山金,5,1,4,凱基-頭份,2023-03-17,9296
3272,東碩,5,1,4,凱基-頭份,2023-03-17,9296
6477,安集,4,0,4,凱基-頭份,2023-03-17,9296
6546,正基,4,0,4,凱基-頭份,2023-03-17,9296
6612,奈米醫材,5,1,4,凱基-頭份,2023-03-17,9296
00637L,元大滬深300正2,54,0,54,凱基-頭份,2023-03-20,9296
00632R,元大台灣50反1,35,0,35,凱基-頭份,2023-03-20,9296
2888,新光金,28,0,28,凱基-頭份,2023-03-20,9296
00878,國泰永續高股息,28,3,25,凱基-頭份,2023-03-20,9296
00923,群益台ESG低碳50,25,0,25,凱基-頭份,2023-03-20,9296
1609,大亞,23,0,23,凱基-頭份,2023-03-20,9296
3624,光頡,26,3,23,凱基-頭份,2023-03-20,9296
00665L,富邦�琤肭磪囓�2,20,0,20,凱基-頭份,2023-03-20,9296
6841,長佳智能,20,0,20,凱基-頭份,2023-03-20,9296
8936,國統,20,3,17,凱基-頭份,2023-03-20,9296
2317,鴻海,15,0,15,凱基-頭份,2023-03-20,9296
4903,聯光通,15,0,15,凱基-頭份,2023-03-20,9296
3013,晟銘電,14,0,14,凱基-頭份,2023-03-20,9296
9945,潤泰新,18,5,13,凱基-頭份,2023-03-20,9296
2481,強茂,13,0,13,凱基-頭份,2023-03-20,9296
5425,台半,14,2,12,凱基-頭份,2023-03-20,9296
2881,富邦金,11,0,11,凱基-頭份,2023-03-20,9296
3704,合勤控,14,4,10,凱基-頭份,2023-03-20,9296
1437,勤益控,10,0,10,凱基-頭份,2023-03-20,9296
00752,中信中國50,10,0,10,凱基-頭份,2023-03-20,9296
1219,福壽,10,0,10,凱基-頭份,2023-03-20,9296
2342,茂矽,10,0,10,凱基-頭份,2023-03-20,9296
4953,緯軟,16,6,10,凱基-頭份,2023-03-20,9296
8099,大世科,10,0,10,凱基-頭份,2023-03-20,9296
8201,無敵,10,0,10,凱基-頭份,2023-03-20,9296
00642U,期元大S＆P石油,15,6,9,凱基-頭份,2023-03-20,9296
1611,中電,10,1,9,凱基-頭份,2023-03-20,9296
8222,寶一,14,5,9,凱基-頭份,2023-03-20,9296
00715L,期街口布蘭特正2,22,14,8,凱基-頭份,2023-03-20,9296
2610,華航,10,2,8,凱基-頭份,2023-03-20,9296
3025,星通,8,0,8,凱基-頭份,2023-03-20,9296
6266,泰詠,8,0,8,凱基-頭份,2023-03-20,9296
5512,力麒,7,0,7,凱基-頭份,2023-03-20,9296
1760,寶齡富錦,6,0,6,凱基-頭份,2023-03-20,9296
2201,裕隆,8,2,6,凱基-頭份,2023-03-20,9296
2453,凌群,21,15,6,凱基-頭份,2023-03-20,9296
3027,盛達,11,5,6,凱基-頭份,2023-03-20,9296
3272,東碩,6,0,6,凱基-頭份,2023-03-20,9296
3576,聯合再生,7,1,6,凱基-頭份,2023-03-20,9296
4961,天鈺,6,0,6,凱基-頭份,2023-03-20,9296
1810,和成,5,0,5,凱基-頭份,2023-03-20,9296
8076,伍豐,5,0,5,凱基-頭份,2023-03-20,9296
1336,台翰,4,0,4,凱基-頭份,2023-03-20,9296
2006,東和鋼鐵,4,0,4,凱基-頭份,2023-03-20,9296
2890,永豐金,9,5,4,凱基-頭份,2023-03-20,9296
3047,訊舟,4,0,4,凱基-頭份,2023-03-20,9296
5880,合庫金,3,0,3,凱基-頭份,2023-03-20,9296
00679B,元大美債20年,5,2,3,凱基-頭份,2023-03-20,9296
00633L,富邦上証正2,3,0,3,凱基-頭份,2023-03-20,9296
1519,華城,9,6,3,凱基-頭份,2023-03-20,9296
3046,建��,62,2,60,凱基-頭份,2023-03-21,9296
00882,中信中國高股息,40,0,40,凱基-頭份,2023-03-21,9296
00665L,富邦�琤肭磪囓�2,33,1,32,凱基-頭份,2023-03-21,9296
2888,新光金,30,0,30,凱基-頭份,2023-03-21,9296
2834,臺企銀,32,3,29,凱基-頭份,2023-03-21,9296
2891,中信金,23,0,23,凱基-頭份,2023-03-21,9296
00676R,富邦臺灣加權反1,20,0,20,凱基-頭份,2023-03-21,9296
2009,第一銅,20,0,20,凱基-頭份,2023-03-21,9296
6841,長佳智能,20,0,20,凱基-頭份,2023-03-21,9296
00632R,元大台灣50反1,16,0,16,凱基-頭份,2023-03-21,9296
00679B,元大美債20年,16,0,16,凱基-頭份,2023-03-21,9296
2883,凱基金,14,0,14,凱基-頭份,2023-03-21,9296
1514,亞力,13,0,13,凱基-頭份,2023-03-21,9296
00715L,期街口布蘭特正2,23,10,13,凱基-頭份,2023-03-21,9296
2614,東森,13,1,12,凱基-頭份,2023-03-21,9296
2352,佳世達,20,8,12,凱基-頭份,2023-03-21,9296
3047,訊舟,11,0,11,凱基-頭份,2023-03-21,9296
3704,合勤控,14,3,11,凱基-頭份,2023-03-21,9296
1524,耿鼎,15,5,10,凱基-頭份,2023-03-21,9296
00687B,國泰20年美債,10,0,10,凱基-頭份,2023-03-21,9296
2303,聯電,16,6,10,凱基-頭份,2023-03-21,9296
2367,燿華,10,0,10,凱基-頭份,2023-03-21,9296
4543,萬在,10,0,10,凱基-頭份,2023-03-21,9296
8033,雷虎,11,1,10,凱基-頭份,2023-03-21,9296
8176,智捷,10,0,10,凱基-頭份,2023-03-21,9296
5009,榮剛,10,1,9,凱基-頭份,2023-03-21,9296
6109,亞元,9,0,9,凱基-頭份,2023-03-21,9296
8076,伍豐,10,1,9,凱基-頭份,2023-03-21,9296
00878,國泰永續高股息,27,20,7,凱基-頭份,2023-03-21,9296
4979,華星光,11,4,7,凱基-頭份,2023-03-21,9296
6163,華電網,18,11,7,凱基-頭份,2023-03-21,9296
6282,康舒,8,1,7,凱基-頭份,2023-03-21,9296
0050,元大台灣50,7,0,7,凱基-頭份,2023-03-21,9296
3005,神基,7,1,6,凱基-頭份,2023-03-21,9296
6155,鈞寶,7,1,6,凱基-頭份,2023-03-21,9296
1611,中電,6,1,5,凱基-頭份,2023-03-21,9296
00664R,國泰臺灣加權反1,5,0,5,凱基-頭份,2023-03-21,9296
00642U,期元大S＆P石油,5,0,5,凱基-頭份,2023-03-21,9296
00923,群益台ESG低碳50,5,0,5,凱基-頭份,2023-03-21,9296
2017,官田鋼,10,5,5,凱基-頭份,2023-03-21,9296
2371,大同,5,0,5,凱基-頭份,2023-03-21,9296
2427,三商電,5,0,5,凱基-頭份,2023-03-21,9296
2734,易飛網,5,0,5,凱基-頭份,2023-03-21,9296
2748,雲品,6,1,5,凱基-頭份,2023-03-21,9296
3128,昇銳,5,0,5,凱基-頭份,2023-03-21,9296
3272,東碩,7,2,5,凱基-頭份,2023-03-21,9296
3624,光頡,14,9,5,凱基-頭份,2023-03-21,9296
4909,新復興,5,0,5,凱基-頭份,2023-03-21,9296
5353,台林,10,5,5,凱基-頭份,2023-03-21,9296
1336,台翰,4,0,4,凱基-頭份,2023-03-21,9296
2812,台中銀,123,10,113,凱基-頭份,2023-03-22,9296
00680L,元大美債20正2,100,0,100,凱基-頭份,2023-03-22,9296
00710B,復華彭博非投等債,29,0,29,凱基-頭份,2023-03-22,9296
9103,美德醫療-DR,28,0,28,凱基-頭份,2023-03-22,9296
6443,元晶,24,0,24,凱基-頭份,2023-03-22,9296
2388,威盛,28,8,20,凱基-頭份,2023-03-22,9296
2903,遠百,19,0,19,凱基-頭份,2023-03-22,9296
00715L,期街口布蘭特正2,17,0,17,凱基-頭份,2023-03-22,9296
2605,新興,17,0,17,凱基-頭份,2023-03-22,9296
00665L,富邦�琤肭磪囓�2,25,10,15,凱基-頭份,2023-03-22,9296
2302,麗正,31,17,14,凱基-頭份,2023-03-22,9296
6129,普誠,14,0,14,凱基-頭份,2023-03-22,9296
1102,亞泥,13,0,13,凱基-頭份,2023-03-22,9296
2457,飛宏,20,7,13,凱基-頭份,2023-03-22,9296
00679B,元大美債20年,12,0,12,凱基-頭份,2023-03-22,9296
00898,國泰基因免疫革命,10,0,10,凱基-頭份,2023-03-22,9296
1568,倉佑,10,0,10,凱基-頭份,2023-03-22,9296
1815,富喬,10,0,10,凱基-頭份,2023-03-22,9296
2352,佳世達,10,0,10,凱基-頭份,2023-03-22,9296
2401,凌陽,10,0,10,凱基-頭份,2023-03-22,9296
3024,憶聲,10,0,10,凱基-頭份,2023-03-22,9296
0056,元大高股息,9,0,9,凱基-頭份,2023-03-22,9296
2427,三商電,9,0,9,凱基-頭份,2023-03-22,9296
2888,新光金,12,3,9,凱基-頭份,2023-03-22,9296
6277,宏正,8,0,8,凱基-頭份,2023-03-22,9296
00713,元大台灣高息低波,8,0,8,凱基-頭份,2023-03-22,9296
1810,和成,8,0,8,凱基-頭份,2023-03-22,9296
3013,晟銘電,21,13,8,凱基-頭份,2023-03-22,9296
3481,群創,10,2,8,凱基-頭份,2023-03-22,9296
6109,亞元,8,0,8,凱基-頭份,2023-03-22,9296
6143,振曜,10,2,8,凱基-頭份,2023-03-22,9296
6733,博晟生醫,8,0,8,凱基-頭份,2023-03-22,9296
3712,永崴投控,7,0,7,凱基-頭份,2023-03-22,9296
6155,鈞寶,10,3,7,凱基-頭份,2023-03-22,9296
8289,泰藝,7,0,7,凱基-頭份,2023-03-22,9296
2425,承啟,6,0,6,凱基-頭份,2023-03-22,9296
2442,新美齊,6,0,6,凱基-頭份,2023-03-22,9296
5015,華祺,6,0,6,凱基-頭份,2023-03-22,9296
6841,長佳智能,7,1,6,凱基-頭份,2023-03-22,9296
8033,雷虎,6,0,6,凱基-頭份,2023-03-22,9296
2303,聯電,8,3,5,凱基-頭份,2023-03-22,9296
00676R,富邦臺灣加權反1,5,0,5,凱基-頭份,2023-03-22,9296
00664R,國泰臺灣加權反1,5,0,5,凱基-頭份,2023-03-22,9296
00885,富邦越南,5,0,5,凱基-頭份,2023-03-22,9296
2017,官田鋼,10,5,5,凱基-頭份,2023-03-22,9296
2402,毅嘉,7,2,5,凱基-頭份,2023-03-22,9296
2890,永豐金,5,0,5,凱基-頭份,2023-03-22,9296
2897,王道銀行,5,0,5,凱基-頭份,2023-03-22,9296
3346,麗清,5,0,5,凱基-頭份,2023-03-22,9296
3596,智易,5,0,5,凱基-頭份,2023-03-22,9296
00632R,元大台灣50反1,173,0,173,凱基-頭份,2023-03-23,9296
8936,國統,50,0,50,凱基-頭份,2023-03-23,9296
2605,新興,47,10,37,凱基-頭份,2023-03-23,9296
2606,裕民,29,0,29,凱基-頭份,2023-03-23,9296
3481,群創,28,3,25,凱基-頭份,2023-03-23,9296
3419,譁裕,20,0,20,凱基-頭份,2023-03-23,9296
3693,營邦,20,0,20,凱基-頭份,2023-03-23,9296
6515,穎崴,18,0,18,凱基-頭份,2023-03-23,9296
3013,晟銘電,17,0,17,凱基-頭份,2023-03-23,9296
6148,驊宏資,34,18,16,凱基-頭份,2023-03-23,9296
9103,美德醫療-DR,20,6,14,凱基-頭份,2023-03-23,9296
2609,陽明,17,4,13,凱基-頭份,2023-03-23,9296
3710,連展投控,13,0,13,凱基-頭份,2023-03-23,9296
2427,三商電,15,4,11,凱基-頭份,2023-03-23,9296
3628,盈正,17,6,11,凱基-頭份,2023-03-23,9296
1442,名軒,10,0,10,凱基-頭份,2023-03-23,9296
00680L,元大美債20正2,10,0,10,凱基-頭份,2023-03-23,9296
00664R,國泰臺灣加權反1,10,0,10,凱基-頭份,2023-03-23,9296
00898,國泰基因免疫革命,10,0,10,凱基-頭份,2023-03-23,9296
2204,中華,10,0,10,凱基-頭份,2023-03-23,9296
2303,聯電,10,0,10,凱基-頭份,2023-03-23,9296
2352,佳世達,10,0,10,凱基-頭份,2023-03-23,9296
2736,富野,10,0,10,凱基-頭份,2023-03-23,9296
3290,東浦,10,0,10,凱基-頭份,2023-03-23,9296
6265,方土昶,10,0,10,凱基-頭份,2023-03-23,9296
6863,永道-KY,12,2,10,凱基-頭份,2023-03-23,9296
2317,鴻海,10,1,9,凱基-頭份,2023-03-23,9296
2485,兆赫,10,1,9,凱基-頭份,2023-03-23,9296
4157,太景*-KY,9,0,9,凱基-頭份,2023-03-23,9296
00878,國泰永續高股息,25,17,8,凱基-頭份,2023-03-23,9296
2488,漢平,8,0,8,凱基-頭份,2023-03-23,9296
3380,明泰,8,0,8,凱基-頭份,2023-03-23,9296
2402,毅嘉,46,39,7,凱基-頭份,2023-03-23,9296
3037,欣興,13,6,7,凱基-頭份,2023-03-23,9296
2834,臺企銀,6,0,6,凱基-頭份,2023-03-23,9296
6733,博晟生醫,6,0,6,凱基-頭份,2023-03-23,9296
2603,長榮,5,0,5,凱基-頭份,2023-03-23,9296
00642U,期元大S＆P石油,5,0,5,凱基-頭份,2023-03-23,9296
00897,富邦基因免疫生技,5,0,5,凱基-頭份,2023-03-23,9296
1568,倉佑,5,0,5,凱基-頭份,2023-03-23,9296
2356,英業達,6,1,5,凱基-頭份,2023-03-23,9296
2637,慧洋-KY,16,11,5,凱基-頭份,2023-03-23,9296
2880,華南金,5,0,5,凱基-頭份,2023-03-23,9296
5425,台半,33,28,5,凱基-頭份,2023-03-23,9296
6288,聯嘉,5,0,5,凱基-頭份,2023-03-23,9296
6605,帝寶,5,0,5,凱基-頭份,2023-03-23,9296
8028,昇陽半導體,5,0,5,凱基-頭份,2023-03-23,9296
8033,雷虎,5,0,5,凱基-頭份,2023-03-23,9296
00908,富邦入息REITs+,4,0,4,凱基-頭份,2023-03-23,9296
1524,耿鼎,7,3,4,凱基-頭份,2023-03-23,9296
5381,合正,300,0,300,凱基-頭份,2023-03-24,9296
00650L,復華香港正2,20,0,20,凱基-頭份,2023-03-24,9296
6733,博晟生醫,32,13,19,凱基-頭份,2023-03-24,9296
3714,富采,30,14,16,凱基-頭份,2023-03-24,9296
6122,擎邦,16,0,16,凱基-頭份,2023-03-24,9296
6148,驊宏資,15,0,15,凱基-頭份,2023-03-24,9296
8926,台汽電,15,0,15,凱基-頭份,2023-03-24,9296
1605,華新,18,5,13,凱基-頭份,2023-03-24,9296
4977,眾達-KY,17,4,13,凱基-頭份,2023-03-24,9296
6282,康舒,11,0,11,凱基-頭份,2023-03-24,9296
8996,高力,11,0,11,凱基-頭份,2023-03-24,9296
2615,萬海,10,0,10,凱基-頭份,2023-03-24,9296
00907,永豐優息存股,10,0,10,凱基-頭份,2023-03-24,9296
2887,台新金,10,1,9,凱基-頭份,2023-03-24,9296
2303,聯電,8,0,8,凱基-頭份,2023-03-24,9296
2610,華航,8,0,8,凱基-頭份,2023-03-24,9296
3466,德晉,9,1,8,凱基-頭份,2023-03-24,9296
3481,群創,8,0,8,凱基-頭份,2023-03-24,9296
4532,瑞智,8,0,8,凱基-頭份,2023-03-24,9296
6443,元晶,8,0,8,凱基-頭份,2023-03-24,9296
2618,長榮航,7,0,7,凱基-頭份,2023-03-24,9296
2236,百達-KY,7,0,7,凱基-頭份,2023-03-24,9296
2890,永豐金,10,3,7,凱基-頭份,2023-03-24,9296
3027,盛達,6,0,6,凱基-頭份,2023-03-24,9296
3217,優群,6,0,6,凱基-頭份,2023-03-24,9296
3447,展達,6,0,6,凱基-頭份,2023-03-24,9296
5009,榮剛,6,0,6,凱基-頭份,2023-03-24,9296
5211,蒙恬,6,0,6,凱基-頭份,2023-03-24,9296
1309,台達化,5,0,5,凱基-頭份,2023-03-24,9296
2371,大同,5,0,5,凱基-頭份,2023-03-24,9296
2449,京元電子,5,0,5,凱基-頭份,2023-03-24,9296
2736,富野,5,0,5,凱基-頭份,2023-03-24,9296
2884,玉山金,6,1,5,凱基-頭份,2023-03-24,9296
2888,新光金,5,0,5,凱基-頭份,2023-03-24,9296
3711,日月光投控,5,0,5,凱基-頭份,2023-03-24,9296
3715,定穎投控,7,2,5,凱基-頭份,2023-03-24,9296
4903,聯光通,5,0,5,凱基-頭份,2023-03-24,9296
6016,康和證,5,0,5,凱基-頭份,2023-03-24,9296
6101,寬魚國際,5,0,5,凱基-頭份,2023-03-24,9296
6603,富強鑫,5,0,5,凱基-頭份,2023-03-24,9296
00712,復華富時不動產,4,0,4,凱基-頭份,2023-03-24,9296
00902,中信電池及儲能,5,1,4,凱基-頭份,2023-03-24,9296
2731,雄獅,4,0,4,凱基-頭份,2023-03-24,9296
3038,全台,4,0,4,凱基-頭份,2023-03-24,9296
4162,智擎,9,5,4,凱基-頭份,2023-03-24,9296
6168,宏齊,4,0,4,凱基-頭份,2023-03-24,9296
6589,台康生技,4,0,4,凱基-頭份,2023-03-24,9296
00679B,元大美債20年,3,0,3,凱基-頭份,2023-03-24,9296
2314,台揚,3,0,3,凱基-頭份,2023-03-24,9296
00717,富邦美國特別股,3,0,3,凱基-頭份,2023-03-24,9296
2409,友達,138,0,138,凱基-頭份,2023-03-27,9296
00632R,元大台灣50反1,40,0,40,凱基-頭份,2023-03-27,9296
6770,力積電,32,1,31,凱基-頭份,2023-03-27,9296
00882,中信中國高股息,30,0,30,凱基-頭份,2023-03-27,9296
1101,台泥,43,16,27,凱基-頭份,2023-03-27,9296
1312,國喬,26,0,26,凱基-頭份,2023-03-27,9296
3011,今皓,22,2,20,凱基-頭份,2023-03-27,9296
3693,營邦,21,1,20,凱基-頭份,2023-03-27,9296
3013,晟銘電,18,1,17,凱基-頭份,2023-03-27,9296
1618,合機,16,0,16,凱基-頭份,2023-03-27,9296
00665L,富邦�琤肭磪囓�2,27,12,15,凱基-頭份,2023-03-27,9296
1605,華新,18,6,12,凱基-頭份,2023-03-27,9296
00679B,元大美債20年,12,0,12,凱基-頭份,2023-03-27,9296
1802,台玻,12,0,12,凱基-頭份,2023-03-27,9296
3594,磐儀,13,1,12,凱基-頭份,2023-03-27,9296
00878,國泰永續高股息,18,7,11,凱基-頭份,2023-03-27,9296
2349,錸德,13,2,11,凱基-頭份,2023-03-27,9296
00680L,元大美債20正2,10,0,10,凱基-頭份,2023-03-27,9296
00898,國泰基因免疫革命,10,0,10,凱基-頭份,2023-03-27,9296
1584,精剛,21,11,10,凱基-頭份,2023-03-27,9296
2014,中鴻,12,2,10,凱基-頭份,2023-03-27,9296
2338,光罩,10,0,10,凱基-頭份,2023-03-27,9296
2352,佳世達,10,0,10,凱基-頭份,2023-03-27,9296
3322,建舜電,10,0,10,凱基-頭份,2023-03-27,9296
3432,台端,10,0,10,凱基-頭份,2023-03-27,9296
1609,大亞,15,7,8,凱基-頭份,2023-03-27,9296
1504,東元,23,15,8,凱基-頭份,2023-03-27,9296
2401,凌陽,8,0,8,凱基-頭份,2023-03-27,9296
6101,寬魚國際,8,0,8,凱基-頭份,2023-03-27,9296
6288,聯嘉,42,34,8,凱基-頭份,2023-03-27,9296
6806,森崴能源,7,0,7,凱基-頭份,2023-03-27,9296
2201,裕隆,9,2,7,凱基-頭份,2023-03-27,9296
1319,東陽,8,1,7,凱基-頭份,2023-03-27,9296
2457,飛宏,17,10,7,凱基-頭份,2023-03-27,9296
2883,凱基金,12,5,7,凱基-頭份,2023-03-27,9296
1229,聯華,6,0,6,凱基-頭份,2023-03-27,9296
00772B,中信高評級公司債,6,0,6,凱基-頭份,2023-03-27,9296
2208,台船,7,1,6,凱基-頭份,2023-03-27,9296
2317,鴻海,7,1,6,凱基-頭份,2023-03-27,9296
6134,萬旭,6,0,6,凱基-頭份,2023-03-27,9296
3231,緯創,10,5,5,凱基-頭份,2023-03-27,9296
00773B,中信優先金融債,5,0,5,凱基-頭份,2023-03-27,9296
2303,聯電,6,1,5,凱基-頭份,2023-03-27,9296
2402,毅嘉,6,1,5,凱基-頭份,2023-03-27,9296
2734,易飛網,5,0,5,凱基-頭份,2023-03-27,9296
3628,盈正,5,0,5,凱基-頭份,2023-03-27,9296
6715,嘉基,5,0,5,凱基-頭份,2023-03-27,9296
1309,台達化,4,0,4,凱基-頭份,2023-03-27,9296
1524,耿鼎,5,1,4,凱基-頭份,2023-03-27,9296
2634,漢翔,17,13,4,凱基-頭份,2023-03-27,9296
1101,台泥,45,0,45,凱基-頭份,2023-03-28,9296
2890,永豐金,25,0,25,凱基-頭份,2023-03-28,9296
00882,中信中國高股息,23,0,23,凱基-頭份,2023-03-28,9296
2352,佳世達,21,0,21,凱基-頭份,2023-03-28,9296
6148,驊宏資,23,2,21,凱基-頭份,2023-03-28,9296
1618,合機,20,0,20,凱基-頭份,2023-03-28,9296
2609,陽明,20,0,20,凱基-頭份,2023-03-28,9296
00679B,元大美債20年,19,0,19,凱基-頭份,2023-03-28,9296
2303,聯電,21,4,17,凱基-頭份,2023-03-28,9296
3704,合勤控,15,0,15,凱基-頭份,2023-03-28,9296
2453,凌群,22,10,12,凱基-頭份,2023-03-28,9296
5450,南良,12,0,12,凱基-頭份,2023-03-28,9296
6770,力積電,13,1,12,凱基-頭份,2023-03-28,9296
2201,裕隆,11,0,11,凱基-頭份,2023-03-28,9296
3035,智原,27,17,10,凱基-頭份,2023-03-28,9296
1609,大亞,10,0,10,凱基-頭份,2023-03-28,9296
2401,凌陽,10,0,10,凱基-頭份,2023-03-28,9296
1605,華新,22,12,10,凱基-頭份,2023-03-28,9296
3322,建舜電,10,0,10,凱基-頭份,2023-03-28,9296
6139,亞翔,10,0,10,凱基-頭份,2023-03-28,9296
9921,巨大,10,0,10,凱基-頭份,2023-03-28,9296
1504,東元,18,9,9,凱基-頭份,2023-03-28,9296
6182,合晶,11,2,9,凱基-頭份,2023-03-28,9296
00720B,元大投資級公司債,8,0,8,凱基-頭份,2023-03-28,9296
3037,欣興,10,2,8,凱基-頭份,2023-03-28,9296
1524,耿鼎,7,0,7,凱基-頭份,2023-03-28,9296
3024,憶聲,7,0,7,凱基-頭份,2023-03-28,9296
3047,訊舟,8,1,7,凱基-頭份,2023-03-28,9296
6841,長佳智能,6,0,6,凱基-頭份,2023-03-28,9296
0056,元大高股息,6,0,6,凱基-頭份,2023-03-28,9296
1762,中化生,6,0,6,凱基-頭份,2023-03-28,9296
2379,瑞昱,6,0,6,凱基-頭份,2023-03-28,9296
8936,國統,6,0,6,凱基-頭份,2023-03-28,9296
2017,官田鋼,11,5,6,凱基-頭份,2023-03-28,9296
2206,三陽工業,6,0,6,凱基-頭份,2023-03-28,9296
3481,群創,6,0,6,凱基-頭份,2023-03-28,9296
5439,高技,6,0,6,凱基-頭份,2023-03-28,9296
9930,中聯資源,6,0,6,凱基-頭份,2023-03-28,9296
3594,磐儀,6,0,6,凱基-頭份,2023-03-28,9296
2457,飛宏,6,1,5,凱基-頭份,2023-03-28,9296
3289,宜特,5,0,5,凱基-頭份,2023-03-28,9296
2430,燦坤,5,0,5,凱基-頭份,2023-03-28,9296
2634,漢翔,5,0,5,凱基-頭份,2023-03-28,9296
3122,笙泉,5,0,5,凱基-頭份,2023-03-28,9296
4916,事欣科,5,0,5,凱基-頭份,2023-03-28,9296
4919,新唐,6,1,5,凱基-頭份,2023-03-28,9296
8028,昇陽半導體,5,0,5,凱基-頭份,2023-03-28,9296
8097,常珵,5,0,5,凱基-頭份,2023-03-28,9296
9962,有益,5,0,5,凱基-頭份,2023-03-28,9296
2344,華邦電,6,2,4,凱基-頭份,2023-03-28,9296
912000,晨訊科-DR,63,0,63,凱基-頭份,2023-03-29,9296
00632R,元大台灣50反1,80,20,60,凱基-頭份,2023-03-29,9296
4402,郡都開發,30,0,30,凱基-頭份,2023-03-29,9296
9105,泰金寶-DR,30,0,30,凱基-頭份,2023-03-29,9296
3013,晟銘電,22,2,20,凱基-頭份,2023-03-29,9296
00651R,復華香港反1,15,0,15,凱基-頭份,2023-03-29,9296
2331,精英,14,0,14,凱基-頭份,2023-03-29,9296
2610,華航,16,3,13,凱基-頭份,2023-03-29,9296
2329,華泰,15,4,11,凱基-頭份,2023-03-29,9296
00885,富邦越南,10,0,10,凱基-頭份,2023-03-29,9296
00637L,元大滬深300正2,10,0,10,凱基-頭份,2023-03-29,9296
2637,慧洋-KY,10,0,10,凱基-頭份,2023-03-29,9296
1609,大亞,11,2,9,凱基-頭份,2023-03-29,9296
8028,昇陽半導體,10,1,9,凱基-頭份,2023-03-29,9296
2303,聯電,13,5,8,凱基-頭份,2023-03-29,9296
3715,定穎投控,33,25,8,凱基-頭份,2023-03-29,9296
5243,乙盛-KY,9,1,8,凱基-頭份,2023-03-29,9296
1504,東元,18,11,7,凱基-頭份,2023-03-29,9296
00680L,元大美債20正2,7,0,7,凱基-頭份,2023-03-29,9296
1605,華新,28,21,7,凱基-頭份,2023-03-29,9296
2402,毅嘉,8,1,7,凱基-頭份,2023-03-29,9296
8926,台汽電,7,0,7,凱基-頭份,2023-03-29,9296
2371,大同,6,0,6,凱基-頭份,2023-03-29,9296
3105,穩懋,16,10,6,凱基-頭份,2023-03-29,9296
2603,長榮,5,0,5,凱基-頭份,2023-03-29,9296
00882,中信中國高股息,12,7,5,凱基-頭份,2023-03-29,9296
1598,岱宇,6,1,5,凱基-頭份,2023-03-29,9296
2476,鉅祥,5,0,5,凱基-頭份,2023-03-29,9296
3338,泰碩,6,1,5,凱基-頭份,2023-03-29,9296
3706,神達,5,0,5,凱基-頭份,2023-03-29,9296
3711,日月光投控,5,0,5,凱基-頭份,2023-03-29,9296
6116,彩晶,6,1,5,凱基-頭份,2023-03-29,9296
6265,方土昶,5,0,5,凱基-頭份,2023-03-29,9296
6609,瀧澤科,5,0,5,凱基-頭份,2023-03-29,9296
6770,力積電,5,0,5,凱基-頭份,2023-03-29,9296
8111,立��,5,0,5,凱基-頭份,2023-03-29,9296
4551,智伸科,4,0,4,凱基-頭份,2023-03-29,9296
00631L,元大台灣50正2,7,3,4,凱基-頭份,2023-03-29,9296
3058,立德,4,0,4,凱基-頭份,2023-03-29,9296
00712,復華富時不動產,3,0,3,凱基-頭份,2023-03-29,9296
3034,聯詠,3,0,3,凱基-頭份,2023-03-29,9296
2449,京元電子,3,0,3,凱基-頭份,2023-03-29,9296
00923,群益台ESG低碳50,3,0,3,凱基-頭份,2023-03-29,9296
2468,華經,3,0,3,凱基-頭份,2023-03-29,9296
3011,今皓,3,0,3,凱基-頭份,2023-03-29,9296
3491,昇達科,3,0,3,凱基-頭份,2023-03-29,9296
6015,宏遠證,3,0,3,凱基-頭份,2023-03-29,9296
6101,寬魚國際,3,0,3,凱基-頭份,2023-03-29,9296
6432,今展科,3,0,3,凱基-頭份,2023-03-29,9296
6443,元晶,21,18,3,凱基-頭份,2023-03-29,9296
1504,東元,34,2,32,凱基-頭份,2023-03-30,9296
2312,金寶,21,0,21,凱基-頭份,2023-03-30,9296
2886,兆豐金,20,0,20,凱基-頭份,2023-03-30,9296
2401,凌陽,28,10,18,凱基-頭份,2023-03-30,9296
00632R,元大台灣50反1,15,0,15,凱基-頭份,2023-03-30,9296
00882,中信中國高股息,12,0,12,凱基-頭份,2023-03-30,9296
2888,新光金,12,0,12,凱基-頭份,2023-03-30,9296
5425,台半,13,1,12,凱基-頭份,2023-03-30,9296
4153,鈺緯,10,0,10,凱基-頭份,2023-03-30,9296
4402,郡都開發,10,0,10,凱基-頭份,2023-03-30,9296
6134,萬旭,11,1,10,凱基-頭份,2023-03-30,9296
6442,光聖,10,0,10,凱基-頭份,2023-03-30,9296
1752,南光,14,5,9,凱基-頭份,2023-03-30,9296
3013,晟銘電,29,20,9,凱基-頭份,2023-03-30,9296
3055,蔚華科,8,0,8,凱基-頭份,2023-03-30,9296
2883,凱基金,7,0,7,凱基-頭份,2023-03-30,9296
3481,群創,7,0,7,凱基-頭份,2023-03-30,9296
3693,營邦,9,2,7,凱基-頭份,2023-03-30,9296
5243,乙盛-KY,7,0,7,凱基-頭份,2023-03-30,9296
6443,元晶,7,0,7,凱基-頭份,2023-03-30,9296
0056,元大高股息,6,0,6,凱基-頭份,2023-03-30,9296
8926,台汽電,6,0,6,凱基-頭份,2023-03-30,9296
2609,陽明,5,0,5,凱基-頭份,2023-03-30,9296
4979,華星光,8,3,5,凱基-頭份,2023-03-30,9296
00715L,期街口布蘭特正2,5,0,5,凱基-頭份,2023-03-30,9296
00664R,國泰臺灣加權反1,5,0,5,凱基-頭份,2023-03-30,9296
00680L,元大美債20正2,5,0,5,凱基-頭份,2023-03-30,9296
5880,合庫金,5,0,5,凱基-頭份,2023-03-30,9296
6282,康舒,5,0,5,凱基-頭份,2023-03-30,9296
8936,國統,5,0,5,凱基-頭份,2023-03-30,9296
2534,宏盛,4,0,4,凱基-頭份,2023-03-30,9296
6122,擎邦,4,0,4,凱基-頭份,2023-03-30,9296
8112,至上,4,0,4,凱基-頭份,2023-03-30,9296
3322,建舜電,3,0,3,凱基-頭份,2023-03-30,9296
00706L,期元大S＆P日圓正2,3,0,3,凱基-頭份,2023-03-30,9296
2105,正新,3,0,3,凱基-頭份,2023-03-30,9296
2342,茂矽,6,3,3,凱基-頭份,2023-03-30,9296
2449,京元電子,3,0,3,凱基-頭份,2023-03-30,9296
2612,中航,3,0,3,凱基-頭份,2023-03-30,9296
3011,今皓,3,0,3,凱基-頭份,2023-03-30,9296
3042,晶技,3,0,3,凱基-頭份,2023-03-30,9296
3272,東碩,4,1,3,凱基-頭份,2023-03-30,9296
3434,哲固,3,0,3,凱基-頭份,2023-03-30,9296
3558,神準,4,1,3,凱基-頭份,2023-03-30,9296
4754,國碳科,3,0,3,凱基-頭份,2023-03-30,9296
5272,笙科,3,0,3,凱基-頭份,2023-03-30,9296
6125,廣運,5,2,3,凱基-頭份,2023-03-30,9296
8938,明安,4,1,3,凱基-頭份,2023-03-30,9296
8942,森鉅,3,0,3,凱基-頭份,2023-03-30,9296
9904,寶成,3,0,3,凱基-頭份,2023-03-30,9296
912000,晨訊科-DR,100,0,100,凱基-頭份,2023-03-31,9296
3322,建舜電,50,0,50,凱基-頭份,2023-03-31,9296
1611,中電,41,6,35,凱基-頭份,2023-03-31,9296
2401,凌陽,20,0,20,凱基-頭份,2023-03-31,9296
4198,欣大健康,18,0,18,凱基-頭份,2023-03-31,9296
3231,緯創,24,7,17,凱基-頭份,2023-03-31,9296
00679B,元大美債20年,16,0,16,凱基-頭份,2023-03-31,9296
00632R,元大台灣50反1,15,0,15,凱基-頭份,2023-03-31,9296
00712,復華富時不動產,14,0,14,凱基-頭份,2023-03-31,9296
6134,萬旭,15,1,14,凱基-頭份,2023-03-31,9296
2201,裕隆,11,0,11,凱基-頭份,2023-03-31,9296
00650L,復華香港正2,10,0,10,凱基-頭份,2023-03-31,9296
2476,鉅祥,10,0,10,凱基-頭份,2023-03-31,9296
2609,陽明,18,8,10,凱基-頭份,2023-03-31,9296
1605,華新,12,3,9,凱基-頭份,2023-03-31,9296
6128,上福,8,0,8,凱基-頭份,2023-03-31,9296
6282,康舒,8,0,8,凱基-頭份,2023-03-31,9296
911868,同方友友-DR,8,0,8,凱基-頭份,2023-03-31,9296
00665L,富邦�琤肭磪囓�2,22,15,7,凱基-頭份,2023-03-31,9296
6770,力積電,8,1,7,凱基-頭份,2023-03-31,9296
8227,巨有科技,8,1,7,凱基-頭份,2023-03-31,9296
3664,安瑞-KY,6,0,6,凱基-頭份,2023-03-31,9296
8155,博智,6,0,6,凱基-頭份,2023-03-31,9296
8028,昇陽半導體,10,4,6,凱基-頭份,2023-03-31,9296
3264,欣銓,8,3,5,凱基-頭份,2023-03-31,9296
6005,群益證,5,0,5,凱基-頭份,2023-03-31,9296
00664R,國泰臺灣加權反1,5,0,5,凱基-頭份,2023-03-31,9296
00898,國泰基因免疫革命,5,0,5,凱基-頭份,2023-03-31,9296
1442,名軒,5,0,5,凱基-頭份,2023-03-31,9296
1444,力麗,5,0,5,凱基-頭份,2023-03-31,9296
2369,菱生,5,0,5,凱基-頭份,2023-03-31,9296
2430,燦坤,5,0,5,凱基-頭份,2023-03-31,9296
2736,富野,5,0,5,凱基-頭份,2023-03-31,9296
3088,艾訊,5,0,5,凱基-頭份,2023-03-31,9296
6242,立康,5,0,5,凱基-頭份,2023-03-31,9296
3037,欣興,11,7,4,凱基-頭份,2023-03-31,9296
00882,中信中國高股息,4,0,4,凱基-頭份,2023-03-31,9296
1454,台富,4,0,4,凱基-頭份,2023-03-31,9296
2337,旺宏,5,1,4,凱基-頭份,2023-03-31,9296
3339,泰谷,4,0,4,凱基-頭份,2023-03-31,9296
3715,定穎投控,4,0,4,凱基-頭份,2023-03-31,9296
5289,宜鼎,5,1,4,凱基-頭份,2023-03-31,9296
9925,新保,4,0,4,凱基-頭份,2023-03-31,9296
3005,神基,3,0,3,凱基-頭份,2023-03-31,9296
00881,國泰台灣5G+,3,0,3,凱基-頭份,2023-03-31,9296
2413,環科,3,0,3,凱基-頭份,2023-03-31,9296
2449,京元電子,3,0,3,凱基-頭份,2023-03-31,9296
3094,聯傑,3,0,3,凱基-頭份,2023-03-31,9296
3211,順達,3,0,3,凱基-頭份,2023-03-31,9296
3665,貿聯-KY,3,0,3,凱基-頭份,2023-03-31,9296
00673R,期元大S＆P原油反1,62,0,62,凱基-頭份,2023-04-06,9296
2618,長榮航,46,0,46,凱基-頭份,2023-04-06,9296
00637L,元大滬深300正2,35,4,31,凱基-頭份,2023-04-06,9296
2442,新美齊,26,0,26,凱基-頭份,2023-04-06,9296
2344,華邦電,15,0,15,凱基-頭份,2023-04-06,9296
3037,欣興,15,1,14,凱基-頭份,2023-04-06,9296
2606,裕民,13,0,13,凱基-頭份,2023-04-06,9296
3664,安瑞-KY,11,0,11,凱基-頭份,2023-04-06,9296
4526,東台,10,0,10,凱基-頭份,2023-04-06,9296
1312,國喬,10,0,10,凱基-頭份,2023-04-06,9296
2515,中工,10,0,10,凱基-頭份,2023-04-06,9296
1605,華新,14,5,9,凱基-頭份,2023-04-06,9296
5258,虹堡,9,0,9,凱基-頭份,2023-04-06,9296
6122,擎邦,8,0,8,凱基-頭份,2023-04-06,9296
00882,中信中國高股息,7,0,7,凱基-頭份,2023-04-06,9296
2338,光罩,11,4,7,凱基-頭份,2023-04-06,9296
6148,驊宏資,8,1,7,凱基-頭份,2023-04-06,9296
2834,臺企銀,6,0,6,凱基-頭份,2023-04-06,9296
2884,玉山金,6,0,6,凱基-頭份,2023-04-06,9296
00902,中信電池及儲能,6,0,6,凱基-頭份,2023-04-06,9296
6235,華孚,35,29,6,凱基-頭份,2023-04-06,9296
6443,元晶,6,0,6,凱基-頭份,2023-04-06,9296
6698,旭暉應材,6,0,6,凱基-頭份,2023-04-06,9296
8069,元太,8,3,5,凱基-頭份,2023-04-06,9296
2609,陽明,5,0,5,凱基-頭份,2023-04-06,9296
2324,仁寶,6,1,5,凱基-頭份,2023-04-06,9296
2358,廷鑫,10,5,5,凱基-頭份,2023-04-06,9296
2484,希華,6,1,5,凱基-頭份,2023-04-06,9296
2641,正德,5,0,5,凱基-頭份,2023-04-06,9296
2882,國泰金,5,0,5,凱基-頭份,2023-04-06,9296
6185,幃翔,5,0,5,凱基-頭份,2023-04-06,9296
8074,鉅橡,5,0,5,凱基-頭份,2023-04-06,9296
00680L,元大美債20正2,4,0,4,凱基-頭份,2023-04-06,9296
3211,順達,4,0,4,凱基-頭份,2023-04-06,9296
8038,長園科,4,0,4,凱基-頭份,2023-04-06,9296
8936,國統,4,0,4,凱基-頭份,2023-04-06,9296
00922,國泰台灣領袖50,3,0,3,凱基-頭份,2023-04-06,9296
1217,愛之味,3,0,3,凱基-頭份,2023-04-06,9296
1783,和康生,3,0,3,凱基-頭份,2023-04-06,9296
1102,亞泥,3,0,3,凱基-頭份,2023-04-06,9296
2401,凌陽,3,0,3,凱基-頭份,2023-04-06,9296
2457,飛宏,6,3,3,凱基-頭份,2023-04-06,9296
3178,公準,4,1,3,凱基-頭份,2023-04-06,9296
3272,東碩,3,0,3,凱基-頭份,2023-04-06,9296
3434,哲固,3,0,3,凱基-頭份,2023-04-06,9296
3481,群創,3,0,3,凱基-頭份,2023-04-06,9296
5289,宜鼎,3,0,3,凱基-頭份,2023-04-06,9296
5905,南仁湖,3,0,3,凱基-頭份,2023-04-06,9296
6517,保勝光學,3,0,3,凱基-頭份,2023-04-06,9296
9904,寶成,3,0,3,凱基-頭份,2023-04-06,9296
2317,鴻海,28,0,28,凱基-頭份,2023-04-07,9296
00878,國泰永續高股息,27,0,27,凱基-頭份,2023-04-07,9296
2867,三商壽,26,5,21,凱基-頭份,2023-04-07,9296
2886,兆豐金,20,0,20,凱基-頭份,2023-04-07,9296
2101,南港,19,0,19,凱基-頭份,2023-04-07,9296
00712,復華富時不動產,15,0,15,凱基-頭份,2023-04-07,9296
2401,凌陽,13,0,13,凱基-頭份,2023-04-07,9296
00673R,期元大S＆P原油反1,12,0,12,凱基-頭份,2023-04-07,9296
00632R,元大台灣50反1,10,0,10,凱基-頭份,2023-04-07,9296
3704,合勤控,10,0,10,凱基-頭份,2023-04-07,9296
5284,jpp-KY,12,2,10,凱基-頭份,2023-04-07,9296
6698,旭暉應材,8,0,8,凱基-頭份,2023-04-07,9296
2645,長榮航太,7,0,7,凱基-頭份,2023-04-07,9296
8277,商丞,12,5,7,凱基-頭份,2023-04-07,9296
0056,元大高股息,7,1,6,凱基-頭份,2023-04-07,9296
6122,擎邦,7,1,6,凱基-頭份,2023-04-07,9296
2208,台船,5,0,5,凱基-頭份,2023-04-07,9296
2236,百達-KY,5,0,5,凱基-頭份,2023-04-07,9296
2303,聯電,5,0,5,凱基-頭份,2023-04-07,9296
2427,三商電,5,0,5,凱基-頭份,2023-04-07,9296
2471,資通,5,0,5,凱基-頭份,2023-04-07,9296
2495,普安,5,0,5,凱基-頭份,2023-04-07,9296
2614,東森,5,0,5,凱基-頭份,2023-04-07,9296
3032,偉訓,5,0,5,凱基-頭份,2023-04-07,9296
3059,華晶科,5,0,5,凱基-頭份,2023-04-07,9296
4155,訊映,5,0,5,凱基-頭份,2023-04-07,9296
1514,亞力,4,0,4,凱基-頭份,2023-04-07,9296
2887E,台新戊特,4,0,4,凱基-頭份,2023-04-07,9296
3027,盛達,4,0,4,凱基-頭份,2023-04-07,9296
5328,華容,4,0,4,凱基-頭份,2023-04-07,9296
6442,光聖,4,0,4,凱基-頭份,2023-04-07,9296
6715,嘉基,5,1,4,凱基-頭份,2023-04-07,9296
5222,全訊,5,1,4,凱基-頭份,2023-04-07,9296
00679B,元大美債20年,6,3,3,凱基-頭份,2023-04-07,9296
00648R,元大S＆P500反1,3,0,3,凱基-頭份,2023-04-07,9296
1504,東元,8,5,3,凱基-頭份,2023-04-07,9296
00885,富邦越南,3,0,3,凱基-頭份,2023-04-07,9296
1808,潤隆,3,0,3,凱基-頭份,2023-04-07,9296
2610,華航,5,2,3,凱基-頭份,2023-04-07,9296
3558,神準,3,0,3,凱基-頭份,2023-04-07,9296
4927,泰鼎-KY,3,0,3,凱基-頭份,2023-04-07,9296
4934,太極,3,0,3,凱基-頭份,2023-04-07,9296
4977,眾達-KY,3,0,3,凱基-頭份,2023-04-07,9296
5608,四維航,8,5,3,凱基-頭份,2023-04-07,9296
6233,旺玖,3,0,3,凱基-頭份,2023-04-07,9296
6265,方土昶,3,0,3,凱基-頭份,2023-04-07,9296
6290,良維,3,0,3,凱基-頭份,2023-04-07,9296
00772B,中信高評級公司債,2,0,2,凱基-頭份,2023-04-07,9296
5512,力麒,2,0,2,凱基-頭份,2023-04-07,9296
6431,光麗-KY,4,2,2,凱基-頭份,2023-04-07,9296
2344,華邦電,77,5,72,凱基-頭份,2023-04-10,9296
1201,味全,50,0,50,凱基-頭份,2023-04-10,9296
00830,國泰費城半導體,36,0,36,凱基-頭份,2023-04-10,9296
1584,精剛,26,2,24,凱基-頭份,2023-04-10,9296
00679B,元大美債20年,23,0,23,凱基-頭份,2023-04-10,9296
2615,萬海,20,0,20,凱基-頭份,2023-04-10,9296
00673R,期元大S＆P原油反1,20,0,20,凱基-頭份,2023-04-10,9296
00637L,元大滬深300正2,20,0,20,凱基-頭份,2023-04-10,9296
3038,全台,20,0,20,凱基-頭份,2023-04-10,9296
4526,東台,20,0,20,凱基-頭份,2023-04-10,9296
8088,品安,15,0,15,凱基-頭份,2023-04-10,9296
1519,華城,18,4,14,凱基-頭份,2023-04-10,9296
3520,華盈,13,0,13,凱基-頭份,2023-04-10,9296
00888,永豐台灣ESG,11,0,11,凱基-頭份,2023-04-10,9296
00922,國泰台灣領袖50,10,0,10,凱基-頭份,2023-04-10,9296
00650L,復華香港正2,10,0,10,凱基-頭份,2023-04-10,9296
2388,威盛,17,7,10,凱基-頭份,2023-04-10,9296
2402,毅嘉,10,0,10,凱基-頭份,2023-04-10,9296
3289,宜特,10,0,10,凱基-頭份,2023-04-10,9296
6535,順藥,12,2,10,凱基-頭份,2023-04-10,9296
2883,凱基金,10,1,9,凱基-頭份,2023-04-10,9296
00633L,富邦上証正2,8,0,8,凱基-頭份,2023-04-10,9296
2066,世德,8,0,8,凱基-頭份,2023-04-10,9296
4541,晟田,8,0,8,凱基-頭份,2023-04-10,9296
5243,乙盛-KY,14,6,8,凱基-頭份,2023-04-10,9296
6223,旺矽,9,1,8,凱基-頭份,2023-04-10,9296
00751B,元大AAA至A公司債,7,0,7,凱基-頭份,2023-04-10,9296
2352,佳世達,7,0,7,凱基-頭份,2023-04-10,9296
2867,三商壽,6,0,6,凱基-頭份,2023-04-10,9296
3027,盛達,6,0,6,凱基-頭份,2023-04-10,9296
4924,欣厚-KY,6,0,6,凱基-頭份,2023-04-10,9296
6288,聯嘉,10,4,6,凱基-頭份,2023-04-10,9296
6733,博晟生醫,7,1,6,凱基-頭份,2023-04-10,9296
6829,千附精密,8,3,5,凱基-頭份,2023-04-10,9296
4977,眾達-KY,5,0,5,凱基-頭份,2023-04-10,9296
1514,亞力,7,2,5,凱基-頭份,2023-04-10,9296
1524,耿鼎,5,0,5,凱基-頭份,2023-04-10,9296
1618,合機,5,0,5,凱基-頭份,2023-04-10,9296
2208,台船,7,2,5,凱基-頭份,2023-04-10,9296
3682,亞太電,5,0,5,凱基-頭份,2023-04-10,9296
5608,四維航,5,0,5,凱基-頭份,2023-04-10,9296
6005,群益證,5,0,5,凱基-頭份,2023-04-10,9296
6274,台燿,5,0,5,凱基-頭份,2023-04-10,9296
6282,康舒,5,0,5,凱基-頭份,2023-04-10,9296
8440,綠電,5,0,5,凱基-頭份,2023-04-10,9296
1101,台泥,5,0,5,凱基-頭份,2023-04-10,9296
8227,巨有科技,9,5,4,凱基-頭份,2023-04-10,9296
8071,能率網通,4,0,4,凱基-頭份,2023-04-10,9296
1308,亞聚,6,2,4,凱基-頭份,2023-04-10,9296
2449,京元電子,10,6,4,凱基-頭份,2023-04-10,9296
00665L,富邦�琤肭磪囓�2,151,0,151,凱基-頭份,2023-04-11,9296
1102,亞泥,100,0,100,凱基-頭份,2023-04-11,9296
00632R,元大台灣50反1,56,20,36,凱基-頭份,2023-04-11,9296
3481,群創,31,0,31,凱基-頭份,2023-04-11,9296
2303,聯電,30,0,30,凱基-頭份,2023-04-11,9296
00673R,期元大S＆P原油反1,28,0,28,凱基-頭份,2023-04-11,9296
2615,萬海,21,0,21,凱基-頭份,2023-04-11,9296
5009,榮剛,25,5,20,凱基-頭份,2023-04-11,9296
2353,宏��,20,2,18,凱基-頭份,2023-04-11,9296
2498,宏達電,19,3,16,凱基-頭份,2023-04-11,9296
3058,立德,16,0,16,凱基-頭份,2023-04-11,9296
3046,建��,16,2,14,凱基-頭份,2023-04-11,9296
00679B,元大美債20年,12,0,12,凱基-頭份,2023-04-11,9296
2476,鉅祥,13,1,12,凱基-頭份,2023-04-11,9296
6148,驊宏資,18,6,12,凱基-頭份,2023-04-11,9296
2890,永豐金,26,15,11,凱基-頭份,2023-04-11,9296
2332,友訊,10,0,10,凱基-頭份,2023-04-11,9296
2514,龍邦,10,0,10,凱基-頭份,2023-04-11,9296
2610,華航,10,0,10,凱基-頭份,2023-04-11,9296
1504,東元,17,8,9,凱基-頭份,2023-04-11,9296
1529,樂事綠能,8,0,8,凱基-頭份,2023-04-11,9296
2208,台船,10,2,8,凱基-頭份,2023-04-11,9296
6194,育富,10,2,8,凱基-頭份,2023-04-11,9296
00900,富邦特選高股息30,10,3,7,凱基-頭份,2023-04-11,9296
4148,全宇生技-KY,6,0,6,凱基-頭份,2023-04-11,9296
6231,系微,7,1,6,凱基-頭份,2023-04-11,9296
1714,和桐,5,0,5,凱基-頭份,2023-04-11,9296
2002,中鋼,5,0,5,凱基-頭份,2023-04-11,9296
2547,日勝生,5,0,5,凱基-頭份,2023-04-11,9296
3013,晟銘電,5,0,5,凱基-頭份,2023-04-11,9296
3202,樺晟,5,0,5,凱基-頭份,2023-04-11,9296
3483,力致,5,0,5,凱基-頭份,2023-04-11,9296
6209,今國光,5,0,5,凱基-頭份,2023-04-11,9296
2330,台積電,6,1,5,凱基-頭份,2023-04-11,9296
1609,大亞,8,3,5,凱基-頭份,2023-04-11,9296
00720B,元大投資級公司債,5,1,4,凱基-頭份,2023-04-11,9296
00633L,富邦上証正2,4,0,4,凱基-頭份,2023-04-11,9296
2017,官田鋼,5,1,4,凱基-頭份,2023-04-11,9296
2108,南帝,4,0,4,凱基-頭份,2023-04-11,9296
8046,南電,6,2,4,凱基-頭份,2023-04-11,9296
2201,裕隆,6,3,3,凱基-頭份,2023-04-11,9296
3260,威剛,3,0,3,凱基-頭份,2023-04-11,9296
4554,橙的,3,0,3,凱基-頭份,2023-04-11,9296
4564,元翎,3,0,3,凱基-頭份,2023-04-11,9296
4916,事欣科,3,0,3,凱基-頭份,2023-04-11,9296
4973,廣穎,3,0,3,凱基-頭份,2023-04-11,9296
5328,華容,3,0,3,凱基-頭份,2023-04-11,9296
5512,力麒,3,0,3,凱基-頭份,2023-04-11,9296
6538,倉和,3,0,3,凱基-頭份,2023-04-11,9296
6698,旭暉應材,11,8,3,凱基-頭份,2023-04-11,9296
2329,華泰,33,0,33,凱基-頭份,2023-04-12,9296
00632R,元大台灣50反1,32,0,32,凱基-頭份,2023-04-12,9296
9962,有益,29,0,29,凱基-頭份,2023-04-12,9296
2547,日勝生,25,0,25,凱基-頭份,2023-04-12,9296
2890,永豐金,35,15,20,凱基-頭份,2023-04-12,9296
2349,錸德,17,0,17,凱基-頭份,2023-04-12,9296
6770,力積電,19,3,16,凱基-頭份,2023-04-12,9296
00902,中信電池及儲能,20,5,15,凱基-頭份,2023-04-12,9296
2317,鴻海,13,0,13,凱基-頭份,2023-04-12,9296
5425,台半,27,14,13,凱基-頭份,2023-04-12,9296
6148,驊宏資,12,0,12,凱基-頭份,2023-04-12,9296
00637L,元大滬深300正2,14,3,11,凱基-頭份,2023-04-12,9296
3046,建��,11,0,11,凱基-頭份,2023-04-12,9296
2634,漢翔,28,17,11,凱基-頭份,2023-04-12,9296
2457,飛宏,12,2,10,凱基-頭份,2023-04-12,9296
2516,新建,10,0,10,凱基-頭份,2023-04-12,9296
2867,三商壽,15,5,10,凱基-頭份,2023-04-12,9296
3169,亞信,10,0,10,凱基-頭份,2023-04-12,9296
5209,新鼎,10,0,10,凱基-頭份,2023-04-12,9296
2605,新興,10,1,9,凱基-頭份,2023-04-12,9296
1312,國喬,8,0,8,凱基-頭份,2023-04-12,9296
6209,今國光,8,0,8,凱基-頭份,2023-04-12,9296
8222,寶一,11,3,8,凱基-頭份,2023-04-12,9296
9103,美德醫療-DR,8,0,8,凱基-頭份,2023-04-12,9296
3576,聯合再生,10,2,8,凱基-頭份,2023-04-12,9296
00673R,期元大S＆P原油反1,7,0,7,凱基-頭份,2023-04-12,9296
8081,致新,7,0,7,凱基-頭份,2023-04-12,9296
2330,台積電,9,2,7,凱基-頭份,2023-04-12,9296
1609,大亞,11,5,6,凱基-頭份,2023-04-12,9296
2369,菱生,6,0,6,凱基-頭份,2023-04-12,9296
4153,鈺緯,6,0,6,凱基-頭份,2023-04-12,9296
8059,凱碩,6,0,6,凱基-頭份,2023-04-12,9296
9945,潤泰新,6,0,6,凱基-頭份,2023-04-12,9296
00712,復華富時不動產,11,5,6,凱基-頭份,2023-04-12,9296
8926,台汽電,5,0,5,凱基-頭份,2023-04-12,9296
1447,力鵬,5,0,5,凱基-頭份,2023-04-12,9296
1467,南緯,5,0,5,凱基-頭份,2023-04-12,9296
00720B,元大投資級公司債,7,2,5,凱基-頭份,2023-04-12,9296
00751B,元大AAA至A公司債,5,0,5,凱基-頭份,2023-04-12,9296
1605,華新,7,2,5,凱基-頭份,2023-04-12,9296
2022,聚亨,5,0,5,凱基-頭份,2023-04-12,9296
2618,長榮航,5,0,5,凱基-頭份,2023-04-12,9296
3454,晶睿,5,0,5,凱基-頭份,2023-04-12,9296
3693,營邦,9,4,5,凱基-頭份,2023-04-12,9296
6005,群益證,5,0,5,凱基-頭份,2023-04-12,9296
6244,茂迪,7,2,5,凱基-頭份,2023-04-12,9296
3037,欣興,5,1,4,凱基-頭份,2023-04-12,9296
4549,桓達,4,0,4,凱基-頭份,2023-04-12,9296
4967,十銓,12,8,4,凱基-頭份,2023-04-12,9296
6265,方土昶,4,0,4,凱基-頭份,2023-04-12,9296
00712,復華富時不動產,246,0,246,凱基-頭份,2023-04-13,9296
5009,榮剛,92,53,39,凱基-頭份,2023-04-13,9296
1201,味全,30,0,30,凱基-頭份,2023-04-13,9296
2344,華邦電,23,1,22,凱基-頭份,2023-04-13,9296
2312,金寶,21,0,21,凱基-頭份,2023-04-13,9296
00632R,元大台灣50反1,20,0,20,凱基-頭份,2023-04-13,9296
6443,元晶,17,0,17,凱基-頭份,2023-04-13,9296
00772B,中信高評級公司債,14,0,14,凱基-頭份,2023-04-13,9296
2201,裕隆,17,4,13,凱基-頭份,2023-04-13,9296
4506,崇友,12,0,12,凱基-頭份,2023-04-13,9296
6163,華電網,21,9,12,凱基-頭份,2023-04-13,9296
2476,鉅祥,11,0,11,凱基-頭份,2023-04-13,9296
2645,長榮航太,11,0,11,凱基-頭份,2023-04-13,9296
1444,力麗,10,0,10,凱基-頭份,2023-04-13,9296
1417,嘉裕,10,0,10,凱基-頭份,2023-04-13,9296
2485,兆赫,10,0,10,凱基-頭份,2023-04-13,9296
2734,易飛網,10,0,10,凱基-頭份,2023-04-13,9296
2801,彰銀,10,0,10,凱基-頭份,2023-04-13,9296
5309,系統電,10,0,10,凱基-頭份,2023-04-13,9296
6182,合晶,10,0,10,凱基-頭份,2023-04-13,9296
6194,育富,10,0,10,凱基-頭份,2023-04-13,9296
2812,台中銀,10,0,10,凱基-頭份,2023-04-13,9296
1605,華新,19,10,9,凱基-頭份,2023-04-13,9296
6282,康舒,10,1,9,凱基-頭份,2023-04-13,9296
00679B,元大美債20年,11,3,8,凱基-頭份,2023-04-13,9296
2516,新建,8,0,8,凱基-頭份,2023-04-13,9296
3032,偉訓,9,1,8,凱基-頭份,2023-04-13,9296
6263,普萊德,8,0,8,凱基-頭份,2023-04-13,9296
8926,台汽電,8,0,8,凱基-頭份,2023-04-13,9296
1503,士電,10,3,7,凱基-頭份,2023-04-13,9296
00720B,元大投資級公司債,7,0,7,凱基-頭份,2023-04-13,9296
00893,國泰智能電動車,10,3,7,凱基-頭份,2023-04-13,9296
2303,聯電,6,0,6,凱基-頭份,2023-04-13,9296
3011,今皓,7,1,6,凱基-頭份,2023-04-13,9296
00885,富邦越南,5,0,5,凱基-頭份,2023-04-13,9296
00919,群益台灣精選高息,5,0,5,凱基-頭份,2023-04-13,9296
00902,中信電池及儲能,5,0,5,凱基-頭份,2023-04-13,9296
1512,瑞利,5,0,5,凱基-頭份,2023-04-13,9296
1522,堤維西,5,0,5,凱基-頭份,2023-04-13,9296
2204,中華,6,1,5,凱基-頭份,2023-04-13,9296
3078,僑威,5,0,5,凱基-頭份,2023-04-13,9296
3483,力致,5,0,5,凱基-頭份,2023-04-13,9296
9962,有益,5,0,5,凱基-頭份,2023-04-13,9296
8222,寶一,17,12,5,凱基-頭份,2023-04-13,9296
2330,台積電,8,3,5,凱基-頭份,2023-04-13,9296
1513,中興電,22,18,4,凱基-頭份,2023-04-13,9296
0056,元大高股息,4,0,4,凱基-頭份,2023-04-13,9296
00673R,期元大S＆P原油反1,4,0,4,凱基-頭份,2023-04-13,9296
1609,大亞,14,10,4,凱基-頭份,2023-04-13,9296
2409,友達,5,1,4,凱基-頭份,2023-04-13,9296
3481,群創,94,3,91,凱基-頭份,2023-04-14,9296
6005,群益證,105,24,81,凱基-頭份,2023-04-14,9296
2634,漢翔,68,18,50,凱基-頭份,2023-04-14,9296
1752,南光,36,6,30,凱基-頭份,2023-04-14,9296
3706,神達,30,0,30,凱基-頭份,2023-04-14,9296
3594,磐儀,23,0,23,凱基-頭份,2023-04-14,9296
2882,國泰金,22,2,20,凱基-頭份,2023-04-14,9296
3454,晶睿,20,0,20,凱基-頭份,2023-04-14,9296
2476,鉅祥,18,0,18,凱基-頭份,2023-04-14,9296
00679B,元大美債20年,17,0,17,凱基-頭份,2023-04-14,9296
00712,復華富時不動產,16,0,16,凱基-頭份,2023-04-14,9296
2208,台船,51,35,16,凱基-頭份,2023-04-14,9296
6443,元晶,15,0,15,凱基-頭份,2023-04-14,9296
4541,晟田,16,2,14,凱基-頭份,2023-04-14,9296
00882,中信中國高股息,13,0,13,凱基-頭份,2023-04-14,9296
2023,燁輝,12,0,12,凱基-頭份,2023-04-14,9296
8936,國統,12,0,12,凱基-頭份,2023-04-14,9296
8213,志超,11,0,11,凱基-頭份,2023-04-14,9296
4126,太醫,10,0,10,凱基-頭份,2023-04-14,9296
9933,中鼎,10,0,10,凱基-頭份,2023-04-14,9296
00720B,元大投資級公司債,9,0,9,凱基-頭份,2023-04-14,9296
3715,定穎投控,8,0,8,凱基-頭份,2023-04-14,9296
2743,山富,7,0,7,凱基-頭份,2023-04-14,9296
4916,事欣科,9,2,7,凱基-頭份,2023-04-14,9296
6432,今展科,10,3,7,凱基-頭份,2023-04-14,9296
00772B,中信高評級公司債,17,11,6,凱基-頭份,2023-04-14,9296
1584,精剛,19,13,6,凱基-頭份,2023-04-14,9296
3149,正達,6,0,6,凱基-頭份,2023-04-14,9296
6176,瑞儀,6,0,6,凱基-頭份,2023-04-14,9296
6282,康舒,10,4,6,凱基-頭份,2023-04-14,9296
6509,聚和,6,1,5,凱基-頭份,2023-04-14,9296
0056,元大高股息,5,0,5,凱基-頭份,2023-04-14,9296
2017,官田鋼,10,5,5,凱基-頭份,2023-04-14,9296
2303,聯電,6,1,5,凱基-頭份,2023-04-14,9296
2314,台揚,5,0,5,凱基-頭份,2023-04-14,9296
2401,凌陽,5,0,5,凱基-頭份,2023-04-14,9296
3325,旭品,5,0,5,凱基-頭份,2023-04-14,9296
3712,永崴投控,10,5,5,凱基-頭份,2023-04-14,9296
8088,品安,5,0,5,凱基-頭份,2023-04-14,9296
00885,富邦越南,4,0,4,凱基-頭份,2023-04-14,9296
1529,樂事綠能,20,16,4,凱基-頭份,2023-04-14,9296
2344,華邦電,7,3,4,凱基-頭份,2023-04-14,9296
2425,承啟,4,0,4,凱基-頭份,2023-04-14,9296
3005,神基,4,0,4,凱基-頭份,2023-04-14,9296
3037,欣興,4,0,4,凱基-頭份,2023-04-14,9296
5243,乙盛-KY,14,10,4,凱基-頭份,2023-04-14,9296
5355,佳總,4,0,4,凱基-頭份,2023-04-14,9296
00773B,中信優先金融債,3,0,3,凱基-頭份,2023-04-14,9296
1303,南亞,3,0,3,凱基-頭份,2023-04-14,9296
1504,東元,4,1,3,凱基-頭份,2023-04-14,9296
1101,台泥,230,4,226,凱基-頭份,2023-04-17,9296
1417,嘉裕,50,0,50,凱基-頭份,2023-04-17,9296
6672,騰輝電子-KY,50,0,50,凱基-頭份,2023-04-17,9296
4916,事欣科,40,3,37,凱基-頭份,2023-04-17,9296
2476,鉅祥,32,0,32,凱基-頭份,2023-04-17,9296
1618,合機,31,0,31,凱基-頭份,2023-04-17,9296
3481,群創,29,0,29,凱基-頭份,2023-04-17,9296
6142,友勁,30,1,29,凱基-頭份,2023-04-17,9296
00679B,元大美債20年,28,1,27,凱基-頭份,2023-04-17,9296
8215,明基材,22,0,22,凱基-頭份,2023-04-17,9296
3715,定穎投控,20,0,20,凱基-頭份,2023-04-17,9296
911608,明輝-DR,19,0,19,凱基-頭份,2023-04-17,9296
00712,復華富時不動產,19,0,19,凱基-頭份,2023-04-17,9296
00720B,元大投資級公司債,16,0,16,凱基-頭份,2023-04-17,9296
2425,承啟,16,0,16,凱基-頭份,2023-04-17,9296
3013,晟銘電,18,3,15,凱基-頭份,2023-04-17,9296
3483,力致,15,0,15,凱基-頭份,2023-04-17,9296
6140,訊達,15,0,15,凱基-頭份,2023-04-17,9296
00673R,期元大S＆P原油反1,13,0,13,凱基-頭份,2023-04-17,9296
2515,中工,13,0,13,凱基-頭份,2023-04-17,9296
3576,聯合再生,13,0,13,凱基-頭份,2023-04-17,9296
2206,三陽工業,38,26,12,凱基-頭份,2023-04-17,9296
2236,百達-KY,12,0,12,凱基-頭份,2023-04-17,9296
3231,緯創,16,5,11,凱基-頭份,2023-04-17,9296
00751B,元大AAA至A公司債,10,0,10,凱基-頭份,2023-04-17,9296
1314,中石化,10,0,10,凱基-頭份,2023-04-17,9296
2332,友訊,10,0,10,凱基-頭份,2023-04-17,9296
2485,兆赫,10,0,10,凱基-頭份,2023-04-17,9296
3071,協禧,10,2,8,凱基-頭份,2023-04-17,9296
5512,力麒,8,0,8,凱基-頭份,2023-04-17,9296
2618,長榮航,7,0,7,凱基-頭份,2023-04-17,9296
2211,長榮鋼,7,0,7,凱基-頭份,2023-04-17,9296
6294,智基,7,0,7,凱基-頭份,2023-04-17,9296
6606,建德工業,7,0,7,凱基-頭份,2023-04-17,9296
6715,嘉基,7,0,7,凱基-頭份,2023-04-17,9296
1736,喬山,6,0,6,凱基-頭份,2023-04-17,9296
2609,陽明,10,4,6,凱基-頭份,2023-04-17,9296
2610,華航,6,0,6,凱基-頭份,2023-04-17,9296
5009,榮剛,11,5,6,凱基-頭份,2023-04-17,9296
6263,普萊德,6,0,6,凱基-頭份,2023-04-17,9296
6547,高端疫苗,58,52,6,凱基-頭份,2023-04-17,9296
8255,朋程,6,0,6,凱基-頭份,2023-04-17,9296
8926,台汽電,21,15,6,凱基-頭份,2023-04-17,9296
1519,華城,9,4,5,凱基-頭份,2023-04-17,9296
2363,矽統,5,0,5,凱基-頭份,2023-04-17,9296
3051,力特,5,0,5,凱基-頭份,2023-04-17,9296
3682,亞太電,5,0,5,凱基-頭份,2023-04-17,9296
4564,元翎,5,0,5,凱基-頭份,2023-04-17,9296
5212,凌網,5,0,5,凱基-頭份,2023-04-17,9296
5905,南仁湖,5,0,5,凱基-頭份,2023-04-17,9296
00632R,元大台灣50反1,70,0,70,凱基-頭份,2023-04-18,9296
00720B,元大投資級公司債,33,0,33,凱基-頭份,2023-04-18,9296
00673R,期元大S＆P原油反1,30,0,30,凱基-頭份,2023-04-18,9296
00679B,元大美債20年,29,0,29,凱基-頭份,2023-04-18,9296
1529,樂事綠能,27,1,26,凱基-頭份,2023-04-18,9296
2630,亞航,31,9,22,凱基-頭份,2023-04-18,9296
4916,事欣科,20,0,20,凱基-頭份,2023-04-18,9296
1314,中石化,20,0,20,凱基-頭份,2023-04-18,9296
3030,德律,19,0,19,凱基-頭份,2023-04-18,9296
2344,華邦電,16,0,16,凱基-頭份,2023-04-18,9296
2618,長榮航,26,11,15,凱基-頭份,2023-04-18,9296
3037,欣興,14,0,14,凱基-頭份,2023-04-18,9296
1103,嘉泥,14,0,14,凱基-頭份,2023-04-18,9296
2634,漢翔,31,17,14,凱基-頭份,2023-04-18,9296
6148,驊宏資,17,3,14,凱基-頭份,2023-04-18,9296
6527,明達醫,15,1,14,凱基-頭份,2023-04-18,9296
4142,國光生,13,0,13,凱基-頭份,2023-04-18,9296
3447,展達,12,0,12,凱基-頭份,2023-04-18,9296
2834,臺企銀,20,10,10,凱基-頭份,2023-04-18,9296
2017,官田鋼,10,0,10,凱基-頭份,2023-04-18,9296
2367,燿華,10,0,10,凱基-頭份,2023-04-18,9296
2605,新興,10,0,10,凱基-頭份,2023-04-18,9296
3483,力致,10,0,10,凱基-頭份,2023-04-18,9296
5439,高技,10,0,10,凱基-頭份,2023-04-18,9296
6116,彩晶,10,0,10,凱基-頭份,2023-04-18,9296
6167,久正,10,0,10,凱基-頭份,2023-04-18,9296
2457,飛宏,13,4,9,凱基-頭份,2023-04-18,9296
3013,晟銘電,9,0,9,凱基-頭份,2023-04-18,9296
8215,明基材,10,1,9,凱基-頭份,2023-04-18,9296
4541,晟田,8,0,8,凱基-頭份,2023-04-18,9296
1444,力麗,15,7,8,凱基-頭份,2023-04-18,9296
3522,御嵿,8,0,8,凱基-頭份,2023-04-18,9296
6470,宇智,9,1,8,凱基-頭份,2023-04-18,9296
2206,三陽工業,12,5,7,凱基-頭份,2023-04-18,9296
2431,聯昌,7,0,7,凱基-頭份,2023-04-18,9296
2867,三商壽,7,0,7,凱基-頭份,2023-04-18,9296
3025,星通,14,7,7,凱基-頭份,2023-04-18,9296
00751B,元大AAA至A公司債,6,0,6,凱基-頭份,2023-04-18,9296
1584,精剛,25,19,6,凱基-頭份,2023-04-18,9296
2359,所羅門,10,4,6,凱基-頭份,2023-04-18,9296
2601,益航,10,4,6,凱基-頭份,2023-04-18,9296
5009,榮剛,8,2,6,凱基-頭份,2023-04-18,9296
00687B,國泰20年美債,5,0,5,凱基-頭份,2023-04-18,9296
0056,元大高股息,6,1,5,凱基-頭份,2023-04-18,9296
8069,元太,5,0,5,凱基-頭份,2023-04-18,9296
1312,國喬,5,0,5,凱基-頭份,2023-04-18,9296
00680L,元大美債20正2,5,0,5,凱基-頭份,2023-04-18,9296
00713,元大台灣高息低波,5,0,5,凱基-頭份,2023-04-18,9296
00907,永豐優息存股,5,0,5,凱基-頭份,2023-04-18,9296
2208,台船,7,2,5,凱基-頭份,2023-04-18,9296
2453,凌群,77,1,76,凱基-頭份,2023-04-19,9296
6182,合晶,51,3,48,凱基-頭份,2023-04-19,9296
1101,台泥,41,0,41,凱基-頭份,2023-04-19,9296
5488,松普,35,0,35,凱基-頭份,2023-04-19,9296
6770,力積電,33,0,33,凱基-頭份,2023-04-19,9296
2409,友達,24,0,24,凱基-頭份,2023-04-19,9296
2605,新興,20,0,20,凱基-頭份,2023-04-19,9296
2882,國泰金,23,3,20,凱基-頭份,2023-04-19,9296
2913,農林,20,0,20,凱基-頭份,2023-04-19,9296
5905,南仁湖,20,0,20,凱基-頭份,2023-04-19,9296
2618,長榮航,20,0,20,凱基-頭份,2023-04-19,9296
00888,永豐台灣ESG,18,0,18,凱基-頭份,2023-04-19,9296
1810,和成,20,3,17,凱基-頭份,2023-04-19,9296
2401,凌陽,16,0,16,凱基-頭份,2023-04-19,9296
3037,欣興,15,0,15,凱基-頭份,2023-04-19,9296
00881,國泰台灣5G+,12,0,12,凱基-頭份,2023-04-19,9296
2515,中工,12,0,12,凱基-頭份,2023-04-19,9296
2609,陽明,21,9,12,凱基-頭份,2023-04-19,9296
4916,事欣科,12,0,12,凱基-頭份,2023-04-19,9296
5439,高技,12,0,12,凱基-頭份,2023-04-19,9296
6140,訊達,14,2,12,凱基-頭份,2023-04-19,9296
6177,達麗,12,0,12,凱基-頭份,2023-04-19,9296
1219,福壽,11,0,11,凱基-頭份,2023-04-19,9296
2886,兆豐金,10,0,10,凱基-頭份,2023-04-19,9296
00752,中信中國50,10,0,10,凱基-頭份,2023-04-19,9296
1522,堤維西,10,0,10,凱基-頭份,2023-04-19,9296
3707,漢磊,10,0,10,凱基-頭份,2023-04-19,9296
00878,國泰永續高股息,10,0,10,凱基-頭份,2023-04-19,9296
5403,中菲,11,2,9,凱基-頭份,2023-04-19,9296
2402,毅嘉,9,1,8,凱基-頭份,2023-04-19,9296
6547,高端疫苗,8,0,8,凱基-頭份,2023-04-19,9296
3189,景碩,7,0,7,凱基-頭份,2023-04-19,9296
00679B,元大美債20年,8,1,7,凱基-頭份,2023-04-19,9296
1504,東元,11,4,7,凱基-頭份,2023-04-19,9296
2471,資通,10,3,7,凱基-頭份,2023-04-19,9296
3231,緯創,15,8,7,凱基-頭份,2023-04-19,9296
3260,威剛,7,0,7,凱基-頭份,2023-04-19,9296
0050,元大台灣50,6,0,6,凱基-頭份,2023-04-19,9296
1312,國喬,6,0,6,凱基-頭份,2023-04-19,9296
4123,晟德,6,0,6,凱基-頭份,2023-04-19,9296
4976,佳凌,7,1,6,凱基-頭份,2023-04-19,9296
6703,軒郁,6,0,6,凱基-頭份,2023-04-19,9296
8210,勤誠,10,4,6,凱基-頭份,2023-04-19,9296
2834,臺企銀,5,0,5,凱基-頭份,2023-04-19,9296
2323,中環,7,2,5,凱基-頭份,2023-04-19,9296
2342,茂矽,5,0,5,凱基-頭份,2023-04-19,9296
2540,愛山林,5,0,5,凱基-頭份,2023-04-19,9296
3419,譁裕,5,0,5,凱基-頭份,2023-04-19,9296
3501,維熹,5,0,5,凱基-頭份,2023-04-19,9296
4979,華星光,8,3,5,凱基-頭份,2023-04-19,9296
5351,鈺創,264,0,264,凱基-頭份,2023-04-20,9296
00673R,期元大S＆P原油反1,117,8,109,凱基-頭份,2023-04-20,9296
912000,晨訊科-DR,46,0,46,凱基-頭份,2023-04-20,9296
2303,聯電,45,0,45,凱基-頭份,2023-04-20,9296
2618,長榮航,37,0,37,凱基-頭份,2023-04-20,9296
3628,盈正,36,0,36,凱基-頭份,2023-04-20,9296
3704,合勤控,41,7,34,凱基-頭份,2023-04-20,9296
2471,資通,63,31,32,凱基-頭份,2023-04-20,9296
8111,立��,25,0,25,凱基-頭份,2023-04-20,9296
2615,萬海,22,1,21,凱基-頭份,2023-04-20,9296
6160,欣技,40,20,20,凱基-頭份,2023-04-20,9296
0056,元大高股息,18,1,17,凱基-頭份,2023-04-20,9296
00720B,元大投資級公司債,18,1,17,凱基-頭份,2023-04-20,9296
3149,正達,15,0,15,凱基-頭份,2023-04-20,9296
00888,永豐台灣ESG,12,0,12,凱基-頭份,2023-04-20,9296
2610,華航,11,0,11,凱基-頭份,2023-04-20,9296
3078,僑威,11,0,11,凱基-頭份,2023-04-20,9296
5425,台半,17,6,11,凱基-頭份,2023-04-20,9296
6148,驊宏資,19,8,11,凱基-頭份,2023-04-20,9296
1319,東陽,10,0,10,凱基-頭份,2023-04-20,9296
1471,首利,10,0,10,凱基-頭份,2023-04-20,9296
00751B,元大AAA至A公司債,10,0,10,凱基-頭份,2023-04-20,9296
2401,凌陽,10,0,10,凱基-頭份,2023-04-20,9296
2457,飛宏,23,13,10,凱基-頭份,2023-04-20,9296
2605,新興,10,0,10,凱基-頭份,2023-04-20,9296
2402,毅嘉,12,3,9,凱基-頭份,2023-04-20,9296
6509,聚和,9,0,9,凱基-頭份,2023-04-20,9296
4167,松瑞藥,9,1,8,凱基-頭份,2023-04-20,9296
4566,時碩工業,8,0,8,凱基-頭份,2023-04-20,9296
00881,國泰台灣5G+,7,0,7,凱基-頭份,2023-04-20,9296
8038,長園科,7,0,7,凱基-頭份,2023-04-20,9296
3025,星通,7,0,7,凱基-頭份,2023-04-20,9296
00878,國泰永續高股息,16,9,7,凱基-頭份,2023-04-20,9296
00907,永豐優息存股,6,0,6,凱基-頭份,2023-04-20,9296
2102,泰豐,6,0,6,凱基-頭份,2023-04-20,9296
2344,華邦電,12,6,6,凱基-頭份,2023-04-20,9296
6282,康舒,80,74,6,凱基-頭份,2023-04-20,9296
6548,長科*,6,0,6,凱基-頭份,2023-04-20,9296
2886,兆豐金,6,0,6,凱基-頭份,2023-04-20,9296
1101,台泥,5,0,5,凱基-頭份,2023-04-20,9296
1522,堤維西,5,0,5,凱基-頭份,2023-04-20,9296
00895,富邦未來車,5,0,5,凱基-頭份,2023-04-20,9296
1714,和桐,5,0,5,凱基-頭份,2023-04-20,9296
1810,和成,27,22,5,凱基-頭份,2023-04-20,9296
2399,映泰,5,0,5,凱基-頭份,2023-04-20,9296
2453,凌群,10,5,5,凱基-頭份,2023-04-20,9296
3673,TPK-KY,10,5,5,凱基-頭份,2023-04-20,9296
5301,寶得利,5,0,5,凱基-頭份,2023-04-20,9296
6625,必應,5,0,5,凱基-頭份,2023-04-20,9296
1609,大亞,4,0,4,凱基-頭份,2023-04-20,9296
1906,寶隆,61,1,60,凱基-頭份,2023-04-21,9296
2605,新興,30,0,30,凱基-頭份,2023-04-21,9296
2303,聯電,32,4,28,凱基-頭份,2023-04-21,9296
912000,晨訊科-DR,25,0,25,凱基-頭份,2023-04-21,9296
1560,中砂,32,8,24,凱基-頭份,2023-04-21,9296
2409,友達,35,14,21,凱基-頭份,2023-04-21,9296
2615,萬海,22,1,21,凱基-頭份,2023-04-21,9296
00637L,元大滬深300正2,21,1,20,凱基-頭份,2023-04-21,9296
3149,正達,18,0,18,凱基-頭份,2023-04-21,9296
00881,國泰台灣5G+,16,0,16,凱基-頭份,2023-04-21,9296
1101,台泥,33,17,16,凱基-頭份,2023-04-21,9296
1319,東陽,18,2,16,凱基-頭份,2023-04-21,9296
2330,台積電,17,1,16,凱基-頭份,2023-04-21,9296
1522,堤維西,15,0,15,凱基-頭份,2023-04-21,9296
2913,農林,19,5,14,凱基-頭份,2023-04-21,9296
1305,華夏,12,0,12,凱基-頭份,2023-04-21,9296
5009,榮剛,12,0,12,凱基-頭份,2023-04-21,9296
6244,茂迪,96,85,11,凱基-頭份,2023-04-21,9296
00720B,元大投資級公司債,10,0,10,凱基-頭份,2023-04-21,9296
1220,台榮,20,10,10,凱基-頭份,2023-04-21,9296
00687B,國泰20年美債,10,0,10,凱基-頭份,2023-04-21,9296
00665L,富邦�琤肭磪囓�2,20,10,10,凱基-頭份,2023-04-21,9296
1710,東聯,16,6,10,凱基-頭份,2023-04-21,9296
2534,宏盛,10,0,10,凱基-頭份,2023-04-21,9296
3058,立德,16,6,10,凱基-頭份,2023-04-21,9296
3128,昇銳,10,0,10,凱基-頭份,2023-04-21,9296
3701,大眾控,10,0,10,凱基-頭份,2023-04-21,9296
3707,漢磊,12,2,10,凱基-頭份,2023-04-21,9296
8024,佑華,10,0,10,凱基-頭份,2023-04-21,9296
2344,華邦電,20,10,10,凱基-頭份,2023-04-21,9296
2618,長榮航,23,15,8,凱基-頭份,2023-04-21,9296
2482,連宇,9,1,8,凱基-頭份,2023-04-21,9296
0056,元大高股息,12,4,8,凱基-頭份,2023-04-21,9296
2312,金寶,10,3,7,凱基-頭份,2023-04-21,9296
00882,中信中國高股息,6,0,6,凱基-頭份,2023-04-21,9296
00679B,元大美債20年,7,1,6,凱基-頭份,2023-04-21,9296
00713,元大台灣高息低波,6,0,6,凱基-頭份,2023-04-21,9296
3594,磐儀,6,0,6,凱基-頭份,2023-04-21,9296
4934,太極,6,0,6,凱基-頭份,2023-04-21,9296
2390,云辰,5,0,5,凱基-頭份,2023-04-21,9296
3522,御嵿,5,0,5,凱基-頭份,2023-04-21,9296
3714,富采,5,0,5,凱基-頭份,2023-04-21,9296
6016,康和證,5,0,5,凱基-頭份,2023-04-21,9296
6241,易通展,5,0,5,凱基-頭份,2023-04-21,9296
6770,力積電,10,5,5,凱基-頭份,2023-04-21,9296
8038,長園科,5,0,5,凱基-頭份,2023-04-21,9296
8112,至上,5,0,5,凱基-頭份,2023-04-21,9296
2379,瑞昱,4,0,4,凱基-頭份,2023-04-21,9296
00923,群益台ESG低碳50,4,0,4,凱基-頭份,2023-04-21,9296
2031,新光鋼,4,0,4,凱基-頭份,2023-04-21,9296
00712,復華富時不動產,81,0,81,凱基-頭份,2023-04-24,9296
00878,國泰永續高股息,35,0,35,凱基-頭份,2023-04-24,9296
2634,漢翔,55,22,33,凱基-頭份,2023-04-24,9296
1905,華紙,55,25,30,凱基-頭份,2023-04-24,9296
6116,彩晶,21,0,21,凱基-頭份,2023-04-24,9296
2009,第一銅,20,0,20,凱基-頭份,2023-04-24,9296
00632R,元大台灣50反1,20,1,19,凱基-頭份,2023-04-24,9296
00637L,元大滬深300正2,19,2,17,凱基-頭份,2023-04-24,9296
00683L,期元大美元指正2,17,0,17,凱基-頭份,2023-04-24,9296
2204,中華,20,5,15,凱基-頭份,2023-04-24,9296
2402,毅嘉,14,1,13,凱基-頭份,2023-04-24,9296
1904,正隆,15,2,13,凱基-頭份,2023-04-24,9296
1709,和益,13,1,12,凱基-頭份,2023-04-24,9296
6148,驊宏資,14,2,12,凱基-頭份,2023-04-24,9296
2344,華邦電,21,9,12,凱基-頭份,2023-04-24,9296
1504,東元,11,0,11,凱基-頭份,2023-04-24,9296
5425,台半,12,1,11,凱基-頭份,2023-04-24,9296
1313,聯成,10,0,10,凱基-頭份,2023-04-24,9296
1312,國喬,10,0,10,凱基-頭份,2023-04-24,9296
1524,耿鼎,10,0,10,凱基-頭份,2023-04-24,9296
2409,友達,10,0,10,凱基-頭份,2023-04-24,9296
3059,華晶科,10,0,10,凱基-頭份,2023-04-24,9296
8926,台汽電,12,2,10,凱基-頭份,2023-04-24,9296
00902,中信電池及儲能,9,0,9,凱基-頭份,2023-04-24,9296
9902,台火,9,0,9,凱基-頭份,2023-04-24,9296
00895,富邦未來車,8,0,8,凱基-頭份,2023-04-24,9296
00679B,元大美債20年,8,0,8,凱基-頭份,2023-04-24,9296
3501,維熹,10,2,8,凱基-頭份,2023-04-24,9296
4979,華星光,8,0,8,凱基-頭份,2023-04-24,9296
6625,必應,12,4,8,凱基-頭份,2023-04-24,9296
2303,聯電,8,1,7,凱基-頭份,2023-04-24,9296
6770,力積電,7,0,7,凱基-頭份,2023-04-24,9296
0056,元大高股息,6,0,6,凱基-頭份,2023-04-24,9296
2834,臺企銀,5,0,5,凱基-頭份,2023-04-24,9296
3058,立德,5,0,5,凱基-頭份,2023-04-24,9296
0050,元大台灣50,5,0,5,凱基-頭份,2023-04-24,9296
00665L,富邦�琤肭磪囓�2,5,0,5,凱基-頭份,2023-04-24,9296
00753L,中信中國50正2,5,0,5,凱基-頭份,2023-04-24,9296
00891,中信關鍵半導體,5,0,5,凱基-頭份,2023-04-24,9296
1605,華新,5,0,5,凱基-頭份,2023-04-24,9296
2031,新光鋼,6,1,5,凱基-頭份,2023-04-24,9296
2495,普安,5,0,5,凱基-頭份,2023-04-24,9296
2633,台灣高鐵,5,0,5,凱基-頭份,2023-04-24,9296
4155,訊映,5,0,5,凱基-頭份,2023-04-24,9296
5609,中菲行,5,0,5,凱基-頭份,2023-04-24,9296
6163,華電網,6,1,5,凱基-頭份,2023-04-24,9296
6176,瑞儀,5,0,5,凱基-頭份,2023-04-24,9296
6244,茂迪,14,9,5,凱基-頭份,2023-04-24,9296
6509,聚和,5,0,5,凱基-頭份,2023-04-24,9296
1101,台泥,28,23,5,凱基-頭份,2023-04-24,9296
00878,國泰永續高股息,112,31,81,凱基-頭份,2023-04-25,9296
1310,台苯,266,205,61,凱基-頭份,2023-04-25,9296
2605,新興,60,0,60,凱基-頭份,2023-04-25,9296
3481,群創,50,0,50,凱基-頭份,2023-04-25,9296
2489,瑞軒,92,52,40,凱基-頭份,2023-04-25,9296
6116,彩晶,36,0,36,凱基-頭份,2023-04-25,9296
2312,金寶,31,0,31,凱基-頭份,2023-04-25,9296
00665L,富邦�琤肭磪囓�2,48,27,21,凱基-頭份,2023-04-25,9296
1503,士電,23,2,21,凱基-頭份,2023-04-25,9296
1721,三晃,50,30,20,凱基-頭份,2023-04-25,9296
2303,聯電,37,18,19,凱基-頭份,2023-04-25,9296
3071,協禧,23,4,19,凱基-頭份,2023-04-25,9296
00673R,期元大S＆P原油反1,19,2,17,凱基-頭份,2023-04-25,9296
00902,中信電池及儲能,17,0,17,凱基-頭份,2023-04-25,9296
3037,欣興,26,9,17,凱基-頭份,2023-04-25,9296
2344,華邦電,21,5,16,凱基-頭份,2023-04-25,9296
0056,元大高股息,15,0,15,凱基-頭份,2023-04-25,9296
6182,合晶,15,0,15,凱基-頭份,2023-04-25,9296
00882,中信中國高股息,14,0,14,凱基-頭份,2023-04-25,9296
1504,東元,19,6,13,凱基-頭份,2023-04-25,9296
2883,凱基金,11,0,11,凱基-頭份,2023-04-25,9296
6218,豪勉,11,0,11,凱基-頭份,2023-04-25,9296
2609,陽明,13,3,10,凱基-頭份,2023-04-25,9296
00905,FT臺灣Smart,10,0,10,凱基-頭份,2023-04-25,9296
2409,友達,13,3,10,凱基-頭份,2023-04-25,9296
2534,宏盛,10,0,10,凱基-頭份,2023-04-25,9296
4109,加捷生醫,10,0,10,凱基-頭份,2023-04-25,9296
8091,翔名,10,0,10,凱基-頭份,2023-04-25,9296
9902,台火,10,0,10,凱基-頭份,2023-04-25,9296
2457,飛宏,14,6,8,凱基-頭份,2023-04-25,9296
2070,精湛,8,0,8,凱基-頭份,2023-04-25,9296
0050,元大台灣50,8,0,8,凱基-頭份,2023-04-25,9296
2379,瑞昱,7,0,7,凱基-頭份,2023-04-25,9296
6753,龍德造船,9,1,8,凱基-頭份,2023-04-25,9296
00900,富邦特選高股息30,7,0,7,凱基-頭份,2023-04-25,9296
1513,中興電,9,2,7,凱基-頭份,2023-04-25,9296
1909,榮成,7,0,7,凱基-頭份,2023-04-25,9296
3673,TPK-KY,7,0,7,凱基-頭份,2023-04-25,9296
3231,緯創,7,0,7,凱基-頭份,2023-04-25,9296
2313,華通,6,0,6,凱基-頭份,2023-04-25,9296
2610,華航,9,3,6,凱基-頭份,2023-04-25,9296
3294,英濟,6,0,6,凱基-頭份,2023-04-25,9296
5222,全訊,6,0,6,凱基-頭份,2023-04-25,9296
6770,力積電,7,1,6,凱基-頭份,2023-04-25,9296
00713,元大台灣高息低波,5,0,5,凱基-頭份,2023-04-25,9296
1319,東陽,5,0,5,凱基-頭份,2023-04-25,9296
1904,正隆,11,6,5,凱基-頭份,2023-04-25,9296
2204,中華,5,0,5,凱基-頭份,2023-04-25,9296
4909,新復興,5,0,5,凱基-頭份,2023-04-25,9296
6285,啟��,5,0,5,凱基-頭份,2023-04-25,9296
1905,華紙,106,4,102,凱基-頭份,2023-04-26,9296
00632R,元大台灣50反1,52,5,47,凱基-頭份,2023-04-26,9296
8227,巨有科技,52,20,32,凱基-頭份,2023-04-26,9296
1806,冠軍,25,0,25,凱基-頭份,2023-04-26,9296
00715L,期街口布蘭特正2,21,0,21,凱基-頭份,2023-04-26,9296
4916,事欣科,21,0,21,凱基-頭份,2023-04-26,9296
00878,國泰永續高股息,21,4,17,凱基-頭份,2023-04-26,9296
00712,復華富時不動產,15,0,15,凱基-頭份,2023-04-26,9296
1513,中興電,15,0,15,凱基-頭份,2023-04-26,9296
6116,彩晶,15,0,15,凱基-頭份,2023-04-26,9296
1710,東聯,11,0,11,凱基-頭份,2023-04-26,9296
2834,臺企銀,11,0,11,凱基-頭份,2023-04-26,9296
1314,中石化,10,0,10,凱基-頭份,2023-04-26,9296
00679B,元大美債20年,10,0,10,凱基-頭份,2023-04-26,9296
2324,仁寶,10,0,10,凱基-頭份,2023-04-26,9296
2607,榮運,10,0,10,凱基-頭份,2023-04-26,9296
3481,群創,10,0,10,凱基-頭份,2023-04-26,9296
2328,廣宇,9,0,9,凱基-頭份,2023-04-26,9296
2913,農林,14,5,9,凱基-頭份,2023-04-26,9296
3231,緯創,9,0,9,凱基-頭份,2023-04-26,9296
2002,中鋼,8,0,8,凱基-頭份,2023-04-26,9296
2337,旺宏,8,0,8,凱基-頭份,2023-04-26,9296
4951,精拓科,6,0,6,凱基-頭份,2023-04-26,9296
5009,榮剛,6,0,6,凱基-頭份,2023-04-26,9296
2516,新建,5,0,5,凱基-頭份,2023-04-26,9296
00642U,期元大S＆P石油,5,0,5,凱基-頭份,2023-04-26,9296
2313,華通,5,0,5,凱基-頭份,2023-04-26,9296
2344,華邦電,7,2,5,凱基-頭份,2023-04-26,9296
2409,友達,5,0,5,凱基-頭份,2023-04-26,9296
2498,宏達電,9,4,5,凱基-頭份,2023-04-26,9296
2606,裕民,5,0,5,凱基-頭份,2023-04-26,9296
3005,神基,5,0,5,凱基-頭份,2023-04-26,9296
5222,全訊,5,0,5,凱基-頭份,2023-04-26,9296
6282,康舒,9,4,5,凱基-頭份,2023-04-26,9296
8112,至上,10,5,5,凱基-頭份,2023-04-26,9296
9105,泰金寶-DR,5,0,5,凱基-頭份,2023-04-26,9296
2618,長榮航,4,0,4,凱基-頭份,2023-04-26,9296
1471,首利,4,0,4,凱基-頭份,2023-04-26,9296
00888,永豐台灣ESG,4,0,4,凱基-頭份,2023-04-26,9296
00664R,國泰臺灣加權反1,4,0,4,凱基-頭份,2023-04-26,9296
1605,華新,6,2,4,凱基-頭份,2023-04-26,9296
2303,聯電,20,16,4,凱基-頭份,2023-04-26,9296
2609,陽明,9,5,4,凱基-頭份,2023-04-26,9296
2610,華航,4,0,4,凱基-頭份,2023-04-26,9296
4566,時碩工業,5,1,4,凱基-頭份,2023-04-26,9296
4968,立積,8,4,4,凱基-頭份,2023-04-26,9296
6829,千附精密,9,5,4,凱基-頭份,2023-04-26,9296
0050,元大台灣50,4,0,4,凱基-頭份,2023-04-26,9296
2634,漢翔,12,8,4,凱基-頭份,2023-04-26,9296
1722,台肥,3,0,3,凱基-頭份,2023-04-26,9296
2002,中鋼,27,0,27,凱基-頭份,2023-04-27,9296
1711,永光,46,29,17,凱基-頭份,2023-04-27,9296
4123,晟德,16,0,16,凱基-頭份,2023-04-27,9296
1806,冠軍,15,0,15,凱基-頭份,2023-04-27,9296
00715L,期街口布蘭特正2,13,0,13,凱基-頭份,2023-04-27,9296
1721,三晃,95,82,13,凱基-頭份,2023-04-27,9296
1709,和益,13,1,12,凱基-頭份,2023-04-27,9296
00642U,期元大S＆P石油,11,0,11,凱基-頭份,2023-04-27,9296
1560,中砂,10,0,10,凱基-頭份,2023-04-27,9296
2867,三商壽,10,0,10,凱基-頭份,2023-04-27,9296
4566,時碩工業,14,4,10,凱基-頭份,2023-04-27,9296
6582,申豐,10,0,10,凱基-頭份,2023-04-27,9296
00878,國泰永續高股息,9,1,8,凱基-頭份,2023-04-27,9296
3545,敦泰,8,0,8,凱基-頭份,2023-04-27,9296
8926,台汽電,10,2,8,凱基-頭份,2023-04-27,9296
1308,亞聚,10,3,7,凱基-頭份,2023-04-27,9296
3162,精確,10,3,7,凱基-頭份,2023-04-27,9296
2609,陽明,6,0,6,凱基-頭份,2023-04-27,9296
1513,中興電,7,1,6,凱基-頭份,2023-04-27,9296
1108,幸福,6,0,6,凱基-頭份,2023-04-27,9296
2204,中華,7,1,6,凱基-頭份,2023-04-27,9296
6589,台康生技,6,0,6,凱基-頭份,2023-04-27,9296
2883,凱基金,7,2,5,凱基-頭份,2023-04-27,9296
00679B,元大美債20年,5,0,5,凱基-頭份,2023-04-27,9296
00891,中信關鍵半導體,5,0,5,凱基-頭份,2023-04-27,9296
00772B,中信高評級公司債,7,2,5,凱基-頭份,2023-04-27,9296
1904,正隆,5,0,5,凱基-頭份,2023-04-27,9296
2027,大成鋼,5,0,5,凱基-頭份,2023-04-27,9296
2390,云辰,5,0,5,凱基-頭份,2023-04-27,9296
2426,鼎元,5,0,5,凱基-頭份,2023-04-27,9296
2431,聯昌,5,0,5,凱基-頭份,2023-04-27,9296
2889,國票金,5,0,5,凱基-頭份,2023-04-27,9296
4979,華星光,5,0,5,凱基-頭份,2023-04-27,9296
5206,坤悅,5,0,5,凱基-頭份,2023-04-27,9296
0050,元大台灣50,4,0,4,凱基-頭份,2023-04-27,9296
2317,鴻海,4,0,4,凱基-頭份,2023-04-27,9296
0056,元大高股息,4,0,4,凱基-頭份,2023-04-27,9296
1735,日勝化,4,0,4,凱基-頭份,2023-04-27,9296
1909,榮成,4,0,4,凱基-頭份,2023-04-27,9296
2884,玉山金,4,0,4,凱基-頭份,2023-04-27,9296
3035,智原,7,3,4,凱基-頭份,2023-04-27,9296
3701,大眾控,4,0,4,凱基-頭份,2023-04-27,9296
00712,復華富時不動產,3,0,3,凱基-頭份,2023-04-27,9296
2886,兆豐金,3,0,3,凱基-頭份,2023-04-27,9296
00857B,永豐20年美公債,3,0,3,凱基-頭份,2023-04-27,9296
1504,東元,4,1,3,凱基-頭份,2023-04-27,9296
1342,八貫,3,0,3,凱基-頭份,2023-04-27,9296
1907,永豐餘,3,0,3,凱基-頭份,2023-04-27,9296
2303,聯電,7,4,3,凱基-頭份,2023-04-27,9296
2324,仁寶,3,0,3,凱基-頭份,2023-04-27,9296
00712,復華富時不動產,103,10,93,凱基-頭份,2023-04-28,9296
00632R,元大台灣50反1,70,0,70,凱基-頭份,2023-04-28,9296
1609,大亞,30,0,30,凱基-頭份,2023-04-28,9296
6248,沛波,30,0,30,凱基-頭份,2023-04-28,9296
2880,華南金,30,0,30,凱基-頭份,2023-04-28,9296
3481,群創,32,4,28,凱基-頭份,2023-04-28,9296
2409,友達,25,0,25,凱基-頭份,2023-04-28,9296
00878,國泰永續高股息,26,1,25,凱基-頭份,2023-04-28,9296
00715L,期街口布蘭特正2,20,0,20,凱基-頭份,2023-04-28,9296
2331,精英,22,2,20,凱基-頭份,2023-04-28,9296
2516,新建,20,0,20,凱基-頭份,2023-04-28,9296
2634,漢翔,51,34,17,凱基-頭份,2023-04-28,9296
3029,零壹,62,45,17,凱基-頭份,2023-04-28,9296
5905,南仁湖,13,0,13,凱基-頭份,2023-04-28,9296
2612,中航,12,0,12,凱基-頭份,2023-04-28,9296
3056,富華新,11,0,11,凱基-頭份,2023-04-28,9296
00923,群益台ESG低碳50,11,0,11,凱基-頭份,2023-04-28,9296
1721,三晃,15,4,11,凱基-頭份,2023-04-28,9296
00664R,國泰臺灣加權反1,10,0,10,凱基-頭份,2023-04-28,9296
1612,宏泰,10,0,10,凱基-頭份,2023-04-28,9296
2498,宏達電,13,3,10,凱基-頭份,2023-04-28,9296
6265,方土昶,10,0,10,凱基-頭份,2023-04-28,9296
6589,台康生技,10,0,10,凱基-頭份,2023-04-28,9296
9921,巨大,10,0,10,凱基-頭份,2023-04-28,9296
4979,華星光,18,9,9,凱基-頭份,2023-04-28,9296
00725B,國泰投資級公司債,8,0,8,凱基-頭份,2023-04-28,9296
2352,佳世達,11,3,8,凱基-頭份,2023-04-28,9296
2884,玉山金,10,4,6,凱基-頭份,2023-04-28,9296
1806,冠軍,5,0,5,凱基-頭份,2023-04-28,9296
2031,新光鋼,5,0,5,凱基-頭份,2023-04-28,9296
2845,遠東銀,5,0,5,凱基-頭份,2023-04-28,9296
3202,樺晟,5,0,5,凱基-頭份,2023-04-28,9296
3303,岱稜,6,1,5,凱基-頭份,2023-04-28,9296
5465,富驊,5,0,5,凱基-頭份,2023-04-28,9296
8112,至上,5,0,5,凱基-頭份,2023-04-28,9296
8277,商丞,10,5,5,凱基-頭份,2023-04-28,9296
8358,金居,5,0,5,凱基-頭份,2023-04-28,9296
1504,東元,4,0,4,凱基-頭份,2023-04-28,9296
1529,樂事綠能,7,3,4,凱基-頭份,2023-04-28,9296
1809,中釉,5,1,4,凱基-頭份,2023-04-28,9296
2034,允強,4,0,4,凱基-頭份,2023-04-28,9296
2353,宏��,10,6,4,凱基-頭份,2023-04-28,9296
2402,毅嘉,12,8,4,凱基-頭份,2023-04-28,9296
3664,安瑞-KY,4,0,4,凱基-頭份,2023-04-28,9296
4564,元翎,4,0,4,凱基-頭份,2023-04-28,9296
6163,華電網,4,0,4,凱基-頭份,2023-04-28,9296
6218,豪勉,10,6,4,凱基-頭份,2023-04-28,9296
6266,泰詠,5,1,4,凱基-頭份,2023-04-28,9296
8227,巨有科技,6,2,4,凱基-頭份,2023-04-28,9296
3032,偉訓,5,2,3,凱基-頭份,2023-04-28,9296
2387,精元,60,0,60,凱基-頭份,2023-05-02,9296
2516,新建,40,0,40,凱基-頭份,2023-05-02,9296
2609,陽明,37,2,35,凱基-頭份,2023-05-02,9296
1528,恩德,34,0,34,凱基-頭份,2023-05-02,9296
2022,聚亨,33,0,33,凱基-頭份,2023-05-02,9296
1471,首利,27,0,27,凱基-頭份,2023-05-02,9296
00715L,期街口布蘭特正2,24,0,24,凱基-頭份,2023-05-02,9296
00924,復華S＆P500成長,20,0,20,凱基-頭份,2023-05-02,9296
2413,環科,20,0,20,凱基-頭份,2023-05-02,9296
3710,連展投控,20,0,20,凱基-頭份,2023-05-02,9296
6152,百一,20,0,20,凱基-頭份,2023-05-02,9296
00680L,元大美債20正2,17,0,17,凱基-頭份,2023-05-02,9296
2344,華邦電,28,11,17,凱基-頭份,2023-05-02,9296
4121,優盛,24,8,16,凱基-頭份,2023-05-02,9296
2471,資通,16,2,14,凱基-頭份,2023-05-02,9296
6218,豪勉,24,10,14,凱基-頭份,2023-05-02,9296
00878,國泰永續高股息,18,7,11,凱基-頭份,2023-05-02,9296
3202,樺晟,12,1,11,凱基-頭份,2023-05-02,9296
8349,�矬�,11,0,11,凱基-頭份,2023-05-02,9296
00679B,元大美債20年,10,0,10,凱基-頭份,2023-05-02,9296
00882,中信中國高股息,10,0,10,凱基-頭份,2023-05-02,9296
00641R,富邦日本反1,10,0,10,凱基-頭份,2023-05-02,9296
00632R,元大台灣50反1,10,0,10,凱基-頭份,2023-05-02,9296
1714,和桐,10,0,10,凱基-頭份,2023-05-02,9296
2102,泰豐,10,0,10,凱基-頭份,2023-05-02,9296
2495,普安,11,1,10,凱基-頭份,2023-05-02,9296
2645,長榮航太,10,0,10,凱基-頭份,2023-05-02,9296
2603,長榮,9,0,9,凱基-頭份,2023-05-02,9296
6288,聯嘉,13,4,9,凱基-頭份,2023-05-02,9296
8213,志超,9,0,9,凱基-頭份,2023-05-02,9296
6111,大宇資,9,1,8,凱基-頭份,2023-05-02,9296
8403,盛弘,8,1,7,凱基-頭份,2023-05-02,9296
1517,利奇,6,0,6,凱基-頭份,2023-05-02,9296
2352,佳世達,9,3,6,凱基-頭份,2023-05-02,9296
3628,盈正,6,0,6,凱基-頭份,2023-05-02,9296
9925,新保,6,0,6,凱基-頭份,2023-05-02,9296
2610,華航,5,0,5,凱基-頭份,2023-05-02,9296
1806,冠軍,5,0,5,凱基-頭份,2023-05-02,9296
00642U,期元大S＆P石油,5,0,5,凱基-頭份,2023-05-02,9296
00900,富邦特選高股息30,5,0,5,凱基-頭份,2023-05-02,9296
00895,富邦未來車,5,0,5,凱基-頭份,2023-05-02,9296
00891,中信關鍵半導體,5,0,5,凱基-頭份,2023-05-02,9296
1519,華城,10,5,5,凱基-頭份,2023-05-02,9296
5211,蒙恬,5,0,5,凱基-頭份,2023-05-02,9296
6234,高僑,5,0,5,凱基-頭份,2023-05-02,9296
6806,森崴能源,5,0,5,凱基-頭份,2023-05-02,9296
8440,綠電,6,1,5,凱基-頭份,2023-05-02,9296
8940,新天地,5,0,5,凱基-頭份,2023-05-02,9296
4541,晟田,12,8,4,凱基-頭份,2023-05-02,9296
5206,坤悅,4,0,4,凱基-頭份,2023-05-02,9296
00878,國泰永續高股息,63,1,62,凱基-頭份,2023-05-03,9296
4916,事欣科,40,0,40,凱基-頭份,2023-05-03,9296
1905,華紙,57,19,38,凱基-頭份,2023-05-03,9296
00637L,元大滬深300正2,32,1,31,凱基-頭份,2023-05-03,9296
4126,太醫,30,0,30,凱基-頭份,2023-05-03,9296
6167,久正,25,0,25,凱基-頭份,2023-05-03,9296
2516,新建,24,0,24,凱基-頭份,2023-05-03,9296
00712,復華富時不動產,24,0,24,凱基-頭份,2023-05-03,9296
00665L,富邦�琤肭磪囓�2,22,0,22,凱基-頭份,2023-05-03,9296
00715L,期街口布蘭特正2,24,2,22,凱基-頭份,2023-05-03,9296
6152,百一,22,0,22,凱基-頭份,2023-05-03,9296
6282,康舒,20,0,20,凱基-頭份,2023-05-03,9296
2812,台中銀,19,0,19,凱基-頭份,2023-05-03,9296
2204,中華,18,0,18,凱基-頭份,2023-05-03,9296
3231,緯創,18,1,17,凱基-頭份,2023-05-03,9296
00679B,元大美債20年,16,0,16,凱基-頭份,2023-05-03,9296
3030,德律,16,0,16,凱基-頭份,2023-05-03,9296
3481,群創,15,0,15,凱基-頭份,2023-05-03,9296
2609,陽明,22,7,15,凱基-頭份,2023-05-03,9296
8271,宇瞻,15,0,15,凱基-頭份,2023-05-03,9296
2603,長榮,15,1,14,凱基-頭份,2023-05-03,9296
00753L,中信中國50正2,13,0,13,凱基-頭份,2023-05-03,9296
00642U,期元大S＆P石油,12,0,12,凱基-頭份,2023-05-03,9296
2417,圓剛,12,0,12,凱基-頭份,2023-05-03,9296
3712,永崴投控,19,7,12,凱基-頭份,2023-05-03,9296
1528,恩德,10,0,10,凱基-頭份,2023-05-03,9296
1434,福懋,10,0,10,凱基-頭份,2023-05-03,9296
00882,中信中國高股息,10,0,10,凱基-頭份,2023-05-03,9296
1612,宏泰,10,0,10,凱基-頭份,2023-05-03,9296
3522,御嵿,10,0,10,凱基-頭份,2023-05-03,9296
5905,南仁湖,10,0,10,凱基-頭份,2023-05-03,9296
8011,台通,10,0,10,凱基-頭份,2023-05-03,9296
0050,元大台灣50,8,0,8,凱基-頭份,2023-05-03,9296
1310,台苯,11,3,8,凱基-頭份,2023-05-03,9296
2201,裕隆,11,4,7,凱基-頭份,2023-05-03,9296
2401,凌陽,7,0,7,凱基-頭份,2023-05-03,9296
8403,盛弘,15,8,7,凱基-頭份,2023-05-03,9296
00713,元大台灣高息低波,6,0,6,凱基-頭份,2023-05-03,9296
00752,中信中國50,6,0,6,凱基-頭份,2023-05-03,9296
00680L,元大美債20正2,10,5,5,凱基-頭份,2023-05-03,9296
00772B,中信高評級公司債,5,0,5,凱基-頭份,2023-05-03,9296
1504,東元,5,0,5,凱基-頭份,2023-05-03,9296
1711,永光,11,6,5,凱基-頭份,2023-05-03,9296
2495,普安,5,0,5,凱基-頭份,2023-05-03,9296
2504,國產,5,0,5,凱基-頭份,2023-05-03,9296
3260,威剛,5,0,5,凱基-頭份,2023-05-03,9296
6148,驊宏資,5,0,5,凱基-頭份,2023-05-03,9296
8038,長園科,5,0,5,凱基-頭份,2023-05-03,9296
2409,友達,5,1,4,凱基-頭份,2023-05-03,9296
3056,富華新,4,0,4,凱基-頭份,2023-05-03,9296
00715L,期街口布蘭特正2,73,0,73,凱基-頭份,2023-05-04,9296
3013,晟銘電,46,12,34,凱基-頭份,2023-05-04,9296
6443,元晶,35,2,33,凱基-頭份,2023-05-04,9296
00878,國泰永續高股息,33,10,23,凱基-頭份,2023-05-04,9296
00642U,期元大S＆P石油,23,0,23,凱基-頭份,2023-05-04,9296
2206,三陽工業,37,15,22,凱基-頭份,2023-05-04,9296
2609,陽明,22,2,20,凱基-頭份,2023-05-04,9296
8111,立��,20,0,20,凱基-頭份,2023-05-04,9296
3056,富華新,15,0,15,凱基-頭份,2023-05-04,9296
3078,僑威,16,1,15,凱基-頭份,2023-05-04,9296
8222,寶一,15,0,15,凱基-頭份,2023-05-04,9296
00712,復華富時不動產,13,0,13,凱基-頭份,2023-05-04,9296
1720,生達,12,0,12,凱基-頭份,2023-05-04,9296
6282,康舒,12,1,11,凱基-頭份,2023-05-04,9296
00893,國泰智能電動車,10,0,10,凱基-頭份,2023-05-04,9296
2009,第一銅,10,0,10,凱基-頭份,2023-05-04,9296
2106,建大,10,0,10,凱基-頭份,2023-05-04,9296
2367,燿華,10,0,10,凱基-頭份,2023-05-04,9296
3322,建舜電,10,0,10,凱基-頭份,2023-05-04,9296
3682,亞太電,10,0,10,凱基-頭份,2023-05-04,9296
8107,大億金茂,10,0,10,凱基-頭份,2023-05-04,9296
00679B,元大美債20年,26,18,8,凱基-頭份,2023-05-04,9296
1229,聯華,7,0,7,凱基-頭份,2023-05-04,9296
6244,茂迪,13,6,7,凱基-頭份,2023-05-04,9296
2201,裕隆,7,1,6,凱基-頭份,2023-05-04,9296
4114,健喬,6,0,6,凱基-頭份,2023-05-04,9296
4155,訊映,6,0,6,凱基-頭份,2023-05-04,9296
5309,系統電,8,2,6,凱基-頭份,2023-05-04,9296
6116,彩晶,6,0,6,凱基-頭份,2023-05-04,9296
6546,正基,6,0,6,凱基-頭份,2023-05-04,9296
6625,必應,12,6,6,凱基-頭份,2023-05-04,9296
8473,山林水,6,0,6,凱基-頭份,2023-05-04,9296
4111,濟生,6,0,6,凱基-頭份,2023-05-04,9296
2486,一詮,5,0,5,凱基-頭份,2023-05-04,9296
0056,元大高股息,5,0,5,凱基-頭份,2023-05-04,9296
1529,樂事綠能,6,1,5,凱基-頭份,2023-05-04,9296
1608,華榮,5,0,5,凱基-頭份,2023-05-04,9296
1802,台玻,5,0,5,凱基-頭份,2023-05-04,9296
2344,華邦電,8,3,5,凱基-頭份,2023-05-04,9296
3005,神基,6,1,5,凱基-頭份,2023-05-04,9296
4741,泓瀚,5,0,5,凱基-頭份,2023-05-04,9296
00720B,元大投資級公司債,4,0,4,凱基-頭份,2023-05-04,9296
1504,東元,5,1,4,凱基-頭份,2023-05-04,9296
1503,士電,8,4,4,凱基-頭份,2023-05-04,9296
1593,祺驊,4,0,4,凱基-頭份,2023-05-04,9296
2457,飛宏,9,5,4,凱基-頭份,2023-05-04,9296
2634,漢翔,11,7,4,凱基-頭份,2023-05-04,9296
3303,岱稜,4,0,4,凱基-頭份,2023-05-04,9296
4906,正文,4,0,4,凱基-頭份,2023-05-04,9296
5009,榮剛,8,4,4,凱基-頭份,2023-05-04,9296
00715L,期街口布蘭特正2,87,7,80,凱基-頭份,2023-05-05,9296
3715,定穎投控,29,0,29,凱基-頭份,2023-05-05,9296
6282,康舒,27,1,26,凱基-頭份,2023-05-05,9296
00878,國泰永續高股息,26,2,24,凱基-頭份,2023-05-05,9296
2367,燿華,20,0,20,凱基-頭份,2023-05-05,9296
1513,中興電,14,0,14,凱基-頭份,2023-05-05,9296
00772B,中信高評級公司債,13,0,13,凱基-頭份,2023-05-05,9296
2812,台中銀,13,0,13,凱基-頭份,2023-05-05,9296
5425,台半,18,5,13,凱基-頭份,2023-05-05,9296
00673R,期元大S＆P原油反1,11,0,11,凱基-頭份,2023-05-05,9296
2358,廷鑫,12,1,11,凱基-頭份,2023-05-05,9296
1305,華夏,10,0,10,凱基-頭份,2023-05-05,9296
1612,宏泰,10,0,10,凱基-頭份,2023-05-05,9296
00637L,元大滬深300正2,11,1,10,凱基-頭份,2023-05-05,9296
00632R,元大台灣50反1,10,0,10,凱基-頭份,2023-05-05,9296
3704,合勤控,10,0,10,凱基-頭份,2023-05-05,9296
6152,百一,10,0,10,凱基-頭份,2023-05-05,9296
8021,尖點,10,0,10,凱基-頭份,2023-05-05,9296
6499,益安,9,0,9,凱基-頭份,2023-05-05,9296
00780B,國泰A級金融債,8,0,8,凱基-頭份,2023-05-05,9296
1776,展宇,8,0,8,凱基-頭份,2023-05-05,9296
2609,陽明,12,4,8,凱基-頭份,2023-05-05,9296
5009,榮剛,13,5,8,凱基-頭份,2023-05-05,9296
6160,欣技,14,6,8,凱基-頭份,2023-05-05,9296
6241,易通展,8,0,8,凱基-頭份,2023-05-05,9296
8215,明基材,10,2,8,凱基-頭份,2023-05-05,9296
3712,永崴投控,8,0,8,凱基-頭份,2023-05-05,9296
00642U,期元大S＆P石油,9,2,7,凱基-頭份,2023-05-05,9296
6129,普誠,7,0,7,凱基-頭份,2023-05-05,9296
6169,昱泉,7,0,7,凱基-頭份,2023-05-05,9296
8112,至上,7,0,7,凱基-頭份,2023-05-05,9296
1101,台泥,7,1,6,凱基-頭份,2023-05-05,9296
4121,優盛,8,2,6,凱基-頭份,2023-05-05,9296
6218,豪勉,11,5,6,凱基-頭份,2023-05-05,9296
1760,寶齡富錦,5,0,5,凱基-頭份,2023-05-05,9296
2401,凌陽,5,0,5,凱基-頭份,2023-05-05,9296
2453,凌群,5,0,5,凱基-頭份,2023-05-05,9296
3029,零壹,6,1,5,凱基-頭份,2023-05-05,9296
3057,喬鼎,5,0,5,凱基-頭份,2023-05-05,9296
3236,千如,5,0,5,凱基-頭份,2023-05-05,9296
3663,鑫科,5,0,5,凱基-頭份,2023-05-05,9296
4162,智擎,7,2,5,凱基-頭份,2023-05-05,9296
2634,漢翔,14,10,4,凱基-頭份,2023-05-05,9296
00771,元大US高息特別股,4,0,4,凱基-頭份,2023-05-05,9296
00717,富邦美國特別股,4,0,4,凱基-頭份,2023-05-05,9296
2344,華邦電,6,2,4,凱基-頭份,2023-05-05,9296
2371,大同,4,0,4,凱基-頭份,2023-05-05,9296
2630,亞航,4,0,4,凱基-頭份,2023-05-05,9296
2882,國泰金,5,1,4,凱基-頭份,2023-05-05,9296
3035,智原,6,2,4,凱基-頭份,2023-05-05,9296
3715,定穎投控,70,2,68,凱基-頭份,2023-05-08,9296
00715L,期街口布蘭特正2,81,17,64,凱基-頭份,2023-05-08,9296
4541,晟田,40,3,37,凱基-頭份,2023-05-08,9296
00679B,元大美債20年,31,0,31,凱基-頭份,2023-05-08,9296
3149,正達,30,0,30,凱基-頭份,2023-05-08,9296
3038,全台,41,21,20,凱基-頭份,2023-05-08,9296
6005,群益證,20,0,20,凱基-頭份,2023-05-08,9296
6770,力積電,20,0,20,凱基-頭份,2023-05-08,9296
3481,群創,19,1,18,凱基-頭份,2023-05-08,9296
00878,國泰永續高股息,26,8,18,凱基-頭份,2023-05-08,9296
2888,新光金,18,1,17,凱基-頭份,2023-05-08,9296
00642U,期元大S＆P石油,16,0,16,凱基-頭份,2023-05-08,9296
1605,華新,29,16,13,凱基-頭份,2023-05-08,9296
3290,東浦,13,0,13,凱基-頭份,2023-05-08,9296
8937,合騏,13,0,13,凱基-頭份,2023-05-08,9296
2421,建準,49,38,11,凱基-頭份,2023-05-08,9296
3013,晟銘電,34,24,10,凱基-頭份,2023-05-08,9296
4123,晟德,10,0,10,凱基-頭份,2023-05-08,9296
5312,寶島科,10,0,10,凱基-頭份,2023-05-08,9296
6217,中探針,10,0,10,凱基-頭份,2023-05-08,9296
2743,山富,9,0,9,凱基-頭份,2023-05-08,9296
6603,富強鑫,9,0,9,凱基-頭份,2023-05-08,9296
3714,富采,8,0,8,凱基-頭份,2023-05-08,9296
6790,永豐實,9,1,8,凱基-頭份,2023-05-08,9296
1810,和成,7,0,7,凱基-頭份,2023-05-08,9296
6116,彩晶,7,0,7,凱基-頭份,2023-05-08,9296
6492,生華科,7,0,7,凱基-頭份,2023-05-08,9296
2204,中華,6,0,6,凱基-頭份,2023-05-08,9296
3388,崇越電,6,0,6,凱基-頭份,2023-05-08,9296
3693,營邦,6,0,6,凱基-頭份,2023-05-08,9296
6241,易通展,6,0,6,凱基-頭份,2023-05-08,9296
8473,山林水,6,0,6,凱基-頭份,2023-05-08,9296
1444,力麗,5,0,5,凱基-頭份,2023-05-08,9296
00641R,富邦日本反1,5,0,5,凱基-頭份,2023-05-08,9296
2107,厚生,5,0,5,凱基-頭份,2023-05-08,9296
3036,文曄,7,2,5,凱基-頭份,2023-05-08,9296
3265,台星科,5,0,5,凱基-頭份,2023-05-08,9296
3710,連展投控,5,0,5,凱基-頭份,2023-05-08,9296
6265,方土昶,5,0,5,凱基-頭份,2023-05-08,9296
6605,帝寶,5,0,5,凱基-頭份,2023-05-08,9296
6743,安普新,5,0,5,凱基-頭份,2023-05-08,9296
8069,元太,45,40,5,凱基-頭份,2023-05-08,9296
8099,大世科,5,0,5,凱基-頭份,2023-05-08,9296
00680L,元大美債20正2,4,0,4,凱基-頭份,2023-05-08,9296
6263,普萊德,4,0,4,凱基-頭份,2023-05-08,9296
1319,東陽,4,0,4,凱基-頭份,2023-05-08,9296
1314,中石化,4,0,4,凱基-頭份,2023-05-08,9296
00857B,永豐20年美公債,4,0,4,凱基-頭份,2023-05-08,9296
1514,亞力,6,2,4,凱基-頭份,2023-05-08,9296
2476,鉅祥,4,0,4,凱基-頭份,2023-05-08,9296
3704,合勤控,50,0,50,凱基-頭份,2023-05-09,9296
2609,陽明,40,0,40,凱基-頭份,2023-05-09,9296
1905,華紙,109,77,32,凱基-頭份,2023-05-09,9296
3290,東浦,29,0,29,凱基-頭份,2023-05-09,9296
00680L,元大美債20正2,26,0,26,凱基-頭份,2023-05-09,9296
00679B,元大美債20年,27,4,23,凱基-頭份,2023-05-09,9296
3149,正達,20,0,20,凱基-頭份,2023-05-09,9296
6443,元晶,27,11,16,凱基-頭份,2023-05-09,9296
2402,毅嘉,18,3,15,凱基-頭份,2023-05-09,9296
3078,僑威,15,0,15,凱基-頭份,2023-05-09,9296
2431,聯昌,14,0,14,凱基-頭份,2023-05-09,9296
4906,正文,13,0,13,凱基-頭份,2023-05-09,9296
4916,事欣科,13,0,13,凱基-頭份,2023-05-09,9296
8926,台汽電,12,0,12,凱基-頭份,2023-05-09,9296
1904,正隆,13,1,12,凱基-頭份,2023-05-09,9296
2101,南港,12,0,12,凱基-頭份,2023-05-09,9296
3057,喬鼎,12,0,12,凱基-頭份,2023-05-09,9296
6603,富強鑫,12,0,12,凱基-頭份,2023-05-09,9296
00641R,富邦日本反1,10,0,10,凱基-頭份,2023-05-09,9296
2897,王道銀行,10,0,10,凱基-頭份,2023-05-09,9296
5284,jpp-KY,16,7,9,凱基-頭份,2023-05-09,9296
8150,南茂,10,1,9,凱基-頭份,2023-05-09,9296
00772B,中信高評級公司債,10,2,8,凱基-頭份,2023-05-09,9296
00720B,元大投資級公司債,7,0,7,凱基-頭份,2023-05-09,9296
1612,宏泰,7,0,7,凱基-頭份,2023-05-09,9296
2206,三陽工業,18,11,7,凱基-頭份,2023-05-09,9296
3591,艾笛森,9,2,7,凱基-頭份,2023-05-09,9296
3706,神達,7,0,7,凱基-頭份,2023-05-09,9296
8033,雷虎,7,0,7,凱基-頭份,2023-05-09,9296
0056,元大高股息,6,0,6,凱基-頭份,2023-05-09,9296
00891,中信關鍵半導體,6,0,6,凱基-頭份,2023-05-09,9296
2201,裕隆,6,0,6,凱基-頭份,2023-05-09,9296
3029,零壹,7,1,6,凱基-頭份,2023-05-09,9296
3303,岱稜,7,1,6,凱基-頭份,2023-05-09,9296
8093,保銳,6,0,6,凱基-頭份,2023-05-09,9296
8403,盛弘,6,0,6,凱基-頭份,2023-05-09,9296
00878,國泰永續高股息,6,1,5,凱基-頭份,2023-05-09,9296
2457,飛宏,6,1,5,凱基-頭份,2023-05-09,9296
1312,國喬,5,0,5,凱基-頭份,2023-05-09,9296
1444,力麗,5,0,5,凱基-頭份,2023-05-09,9296
2107,厚生,5,0,5,凱基-頭份,2023-05-09,9296
6112,邁達特,16,11,5,凱基-頭份,2023-05-09,9296
6152,百一,5,0,5,凱基-頭份,2023-05-09,9296
3576,聯合再生,4,0,4,凱基-頭份,2023-05-09,9296
3701,大眾控,4,0,4,凱基-頭份,2023-05-09,9296
4763,材料-KY,14,10,4,凱基-頭份,2023-05-09,9296
5309,系統電,4,0,4,凱基-頭份,2023-05-09,9296
8473,山林水,4,0,4,凱基-頭份,2023-05-09,9296
1513,中興電,5,2,3,凱基-頭份,2023-05-09,9296
1307,三芳,3,0,3,凱基-頭份,2023-05-09,9296
00637L,元大滬深300正2,72,1,71,凱基-頭份,2023-05-10,9296
0056,元大高股息,60,0,60,凱基-頭份,2023-05-10,9296
2482,連宇,35,0,35,凱基-頭份,2023-05-10,9296
00878,國泰永續高股息,24,2,22,凱基-頭份,2023-05-10,9296
2882,國泰金,23,1,22,凱基-頭份,2023-05-10,9296
00642U,期元大S＆P石油,20,0,20,凱基-頭份,2023-05-10,9296
2103,台橡,20,0,20,凱基-頭份,2023-05-10,9296
6167,久正,20,0,20,凱基-頭份,2023-05-10,9296
00753L,中信中國50正2,18,0,18,凱基-頭份,2023-05-10,9296
3231,緯創,19,3,16,凱基-頭份,2023-05-10,9296
00882,中信中國高股息,15,0,15,凱基-頭份,2023-05-10,9296
00720B,元大投資級公司債,15,2,13,凱基-頭份,2023-05-10,9296
00752,中信中國50,12,0,12,凱基-頭份,2023-05-10,9296
6282,康舒,15,3,12,凱基-頭份,2023-05-10,9296
4114,健喬,11,1,10,凱基-頭份,2023-05-10,9296
5512,力麒,10,0,10,凱基-頭份,2023-05-10,9296
00712,復華富時不動產,8,0,8,凱基-頭份,2023-05-10,9296
3015,全漢,8,0,8,凱基-頭份,2023-05-10,9296
6570,維田,20,12,8,凱基-頭份,2023-05-10,9296
1609,大亞,13,6,7,凱基-頭份,2023-05-10,9296
2324,仁寶,10,3,7,凱基-頭份,2023-05-10,9296
6234,高僑,8,1,7,凱基-頭份,2023-05-10,9296
2303,聯電,6,0,6,凱基-頭份,2023-05-10,9296
1721,三晃,6,0,6,凱基-頭份,2023-05-10,9296
5469,瀚宇博,6,0,6,凱基-頭份,2023-05-10,9296
00633L,富邦上証正2,5,0,5,凱基-頭份,2023-05-10,9296
00641R,富邦日本反1,5,0,5,凱基-頭份,2023-05-10,9296
2401,凌陽,5,0,5,凱基-頭份,2023-05-10,9296
2425,承啟,5,0,5,凱基-頭份,2023-05-10,9296
2731,雄獅,5,0,5,凱基-頭份,2023-05-10,9296
3044,健鼎,5,0,5,凱基-頭份,2023-05-10,9296
3689,湧德,5,0,5,凱基-頭份,2023-05-10,9296
4741,泓瀚,5,0,5,凱基-頭份,2023-05-10,9296
6265,方土昶,5,0,5,凱基-頭份,2023-05-10,9296
6589,台康生技,5,0,5,凱基-頭份,2023-05-10,9296
1447,力鵬,4,0,4,凱基-頭份,2023-05-10,9296
00715L,期街口布蘭特正2,7,3,4,凱基-頭份,2023-05-10,9296
00680L,元大美債20正2,4,0,4,凱基-頭份,2023-05-10,9296
2610,華航,19,15,4,凱基-頭份,2023-05-10,9296
2880,華南金,4,0,4,凱基-頭份,2023-05-10,9296
3346,麗清,5,1,4,凱基-頭份,2023-05-10,9296
3388,崇越電,4,0,4,凱基-頭份,2023-05-10,9296
4104,佳醫,4,0,4,凱基-頭份,2023-05-10,9296
6185,幃翔,4,0,4,凱基-頭份,2023-05-10,9296
3005,神基,3,0,3,凱基-頭份,2023-05-10,9296
00679B,元大美債20年,3,0,3,凱基-頭份,2023-05-10,9296
1605,華新,3,0,3,凱基-頭份,2023-05-10,9296
2352,佳世達,4,1,3,凱基-頭份,2023-05-10,9296
2367,燿華,3,0,3,凱基-頭份,2023-05-10,9296
2634,漢翔,10,7,3,凱基-頭份,2023-05-10,9296
00680L,元大美債20正2,22,0,22,凱基-頭份,2023-05-11,9296
00632R,元大台灣50反1,20,0,20,凱基-頭份,2023-05-11,9296
00637L,元大滬深300正2,20,0,20,凱基-頭份,2023-05-11,9296
3481,群創,20,0,20,凱基-頭份,2023-05-11,9296
3704,合勤控,30,10,20,凱基-頭份,2023-05-11,9296
9943,好樂迪,20,0,20,凱基-頭份,2023-05-11,9296
4967,十銓,18,0,18,凱基-頭份,2023-05-11,9296
00882,中信中國高股息,14,0,14,凱基-頭份,2023-05-11,9296
3062,建漢,12,0,12,凱基-頭份,2023-05-11,9296
5706,鳳凰,26,14,12,凱基-頭份,2023-05-11,9296
1101,台泥,14,3,11,凱基-頭份,2023-05-11,9296
1210,大成,11,0,11,凱基-頭份,2023-05-11,9296
6285,啟��,12,1,11,凱基-頭份,2023-05-11,9296
00924,復華S＆P500成長,10,0,10,凱基-頭份,2023-05-11,9296
2017,官田鋼,10,0,10,凱基-頭份,2023-05-11,9296
8059,凱碩,10,0,10,凱基-頭份,2023-05-11,9296
2201,裕隆,12,2,10,凱基-頭份,2023-05-11,9296
1314,中石化,9,0,9,凱基-頭份,2023-05-11,9296
1609,大亞,13,4,9,凱基-頭份,2023-05-11,9296
1736,喬山,9,0,9,凱基-頭份,2023-05-11,9296
00878,國泰永續高股息,8,1,7,凱基-頭份,2023-05-11,9296
2344,華邦電,8,2,6,凱基-頭份,2023-05-11,9296
2610,華航,6,0,6,凱基-頭份,2023-05-11,9296
00891,中信關鍵半導體,6,0,6,凱基-頭份,2023-05-11,9296
00713,元大台灣高息低波,6,0,6,凱基-頭份,2023-05-11,9296
00772B,中信高評級公司債,6,0,6,凱基-頭份,2023-05-11,9296
2108,南帝,6,0,6,凱基-頭份,2023-05-11,9296
6609,瀧澤科,6,0,6,凱基-頭份,2023-05-11,9296
00679B,元大美債20年,5,0,5,凱基-頭份,2023-05-11,9296
1312,國喬,5,0,5,凱基-頭份,2023-05-11,9296
2204,中華,5,0,5,凱基-頭份,2023-05-11,9296
2401,凌陽,5,0,5,凱基-頭份,2023-05-11,9296
2453,凌群,7,2,5,凱基-頭份,2023-05-11,9296
2545,皇翔,5,0,5,凱基-頭份,2023-05-11,9296
2889,國票金,5,0,5,凱基-頭份,2023-05-11,9296
3014,聯陽,5,0,5,凱基-頭份,2023-05-11,9296
3078,僑威,5,0,5,凱基-頭份,2023-05-11,9296
3303,岱稜,5,0,5,凱基-頭份,2023-05-11,9296
3346,麗清,5,0,5,凱基-頭份,2023-05-11,9296
5353,台林,5,0,5,凱基-頭份,2023-05-11,9296
6229,研通,5,0,5,凱基-頭份,2023-05-11,9296
6288,聯嘉,5,0,5,凱基-頭份,2023-05-11,9296
8038,長園科,5,0,5,凱基-頭份,2023-05-11,9296
2457,飛宏,5,1,4,凱基-頭份,2023-05-11,9296
3057,喬鼎,4,0,4,凱基-頭份,2023-05-11,9296
3686,達能,4,0,4,凱基-頭份,2023-05-11,9296
4979,華星光,4,0,4,凱基-頭份,2023-05-11,9296
4123,晟德,3,0,3,凱基-頭份,2023-05-11,9296
3491,昇達科,3,0,3,凱基-頭份,2023-05-11,9296
1701,中化,3,0,3,凱基-頭份,2023-05-11,9296
00637L,元大滬深300正2,83,2,81,凱基-頭份,2023-05-12,9296
2882,國泰金,44,3,41,凱基-頭份,2023-05-12,9296
1608,華榮,40,0,40,凱基-頭份,2023-05-12,9296
1201,味全,35,0,35,凱基-頭份,2023-05-12,9296
00878,國泰永續高股息,32,4,28,凱基-頭份,2023-05-12,9296
00882,中信中國高股息,27,0,27,凱基-頭份,2023-05-12,9296
2736,富野,30,3,27,凱基-頭份,2023-05-12,9296
8222,寶一,28,7,21,凱基-頭份,2023-05-12,9296
00674R,期元大S＆P黃金反1,20,0,20,凱基-頭份,2023-05-12,9296
5309,系統電,21,1,20,凱基-頭份,2023-05-12,9296
2317,鴻海,19,0,19,凱基-頭份,2023-05-12,9296
2338,光罩,14,0,14,凱基-頭份,2023-05-12,9296
00676R,富邦臺灣加權反1,11,0,11,凱基-頭份,2023-05-12,9296
2331,精英,10,0,10,凱基-頭份,2023-05-12,9296
2605,新興,10,0,10,凱基-頭份,2023-05-12,9296
3481,群創,11,1,10,凱基-頭份,2023-05-12,9296
6589,台康生技,10,0,10,凱基-頭份,2023-05-12,9296
1503,士電,14,6,8,凱基-頭份,2023-05-12,9296
4123,晟德,10,2,8,凱基-頭份,2023-05-12,9296
4741,泓瀚,8,0,8,凱基-頭份,2023-05-12,9296
1314,中石化,7,0,7,凱基-頭份,2023-05-12,9296
00715L,期街口布蘭特正2,7,0,7,凱基-頭份,2023-05-12,9296
2409,友達,7,0,7,凱基-頭份,2023-05-12,9296
2743,山富,12,5,7,凱基-頭份,2023-05-12,9296
00642U,期元大S＆P石油,6,0,6,凱基-頭份,2023-05-12,9296
2610,華航,6,0,6,凱基-頭份,2023-05-12,9296
3034,聯詠,6,0,6,凱基-頭份,2023-05-12,9296
00881,國泰台灣5G+,5,0,5,凱基-頭份,2023-05-12,9296
2883,凱基金,5,0,5,凱基-頭份,2023-05-12,9296
00633L,富邦上証正2,5,0,5,凱基-頭份,2023-05-12,9296
1513,中興電,7,2,5,凱基-頭份,2023-05-12,9296
9907,統一實,5,0,5,凱基-頭份,2023-05-12,9296
1760,寶齡富錦,4,0,4,凱基-頭份,2023-05-12,9296
1519,華城,13,9,4,凱基-頭份,2023-05-12,9296
4566,時碩工業,4,0,4,凱基-頭份,2023-05-12,9296
6116,彩晶,4,0,4,凱基-頭份,2023-05-12,9296
2330,台積電,3,0,3,凱基-頭份,2023-05-12,9296
00713,元大台灣高息低波,3,0,3,凱基-頭份,2023-05-12,9296
1611,中電,3,0,3,凱基-頭份,2023-05-12,9296
2002,中鋼,3,0,3,凱基-頭份,2023-05-12,9296
2014,中鴻,5,2,3,凱基-頭份,2023-05-12,9296
2421,建準,11,8,3,凱基-頭份,2023-05-12,9296
3576,聯合再生,3,0,3,凱基-頭份,2023-05-12,9296
4503,金雨,3,0,3,凱基-頭份,2023-05-12,9296
5425,台半,3,0,3,凱基-頭份,2023-05-12,9296
6112,邁達特,4,1,3,凱基-頭份,2023-05-12,9296
6550,北極星藥業-KY,3,0,3,凱基-頭份,2023-05-12,9296
6703,軒郁,6,3,3,凱基-頭份,2023-05-12,9296
6861,睿生光電,4,1,3,凱基-頭份,2023-05-12,9296
8033,雷虎,5,2,3,凱基-頭份,2023-05-12,9296
2736,富野,64,5,59,凱基-頭份,2023-05-15,9296
2103,台橡,50,0,50,凱基-頭份,2023-05-15,9296
9928,中視,41,1,40,凱基-頭份,2023-05-15,9296
00882,中信中國高股息,34,0,34,凱基-頭份,2023-05-15,9296
00878,國泰永續高股息,51,19,32,凱基-頭份,2023-05-15,9296
4402,郡都開發,31,0,31,凱基-頭份,2023-05-15,9296
1337,再生-KY,24,0,24,凱基-頭份,2023-05-15,9296
3704,合勤控,22,0,22,凱基-頭份,2023-05-15,9296
4123,晟德,25,5,20,凱基-頭份,2023-05-15,9296
1609,大亞,20,4,16,凱基-頭份,2023-05-15,9296
3231,緯創,18,3,15,凱基-頭份,2023-05-15,9296
5905,南仁湖,20,5,15,凱基-頭份,2023-05-15,9296
1101,台泥,14,0,14,凱基-頭份,2023-05-15,9296
3481,群創,12,1,11,凱基-頭份,2023-05-15,9296
3576,聯合再生,10,0,10,凱基-頭份,2023-05-15,9296
4121,優盛,10,0,10,凱基-頭份,2023-05-15,9296
6266,泰詠,10,0,10,凱基-頭份,2023-05-15,9296
2317,鴻海,12,3,9,凱基-頭份,2023-05-15,9296
00715L,期街口布蘭特正2,9,0,9,凱基-頭份,2023-05-15,9296
6198,瑞築,8,0,8,凱基-頭份,2023-05-15,9296
00680L,元大美債20正2,7,0,7,凱基-頭份,2023-05-15,9296
00637L,元大滬深300正2,12,5,7,凱基-頭份,2023-05-15,9296
2633,台灣高鐵,7,0,7,凱基-頭份,2023-05-15,9296
3046,建��,13,6,7,凱基-頭份,2023-05-15,9296
1310,台苯,6,0,6,凱基-頭份,2023-05-15,9296
00891,中信關鍵半導體,6,0,6,凱基-頭份,2023-05-15,9296
0056,元大高股息,6,0,6,凱基-頭份,2023-05-15,9296
2208,台船,12,6,6,凱基-頭份,2023-05-15,9296
2371,大同,28,22,6,凱基-頭份,2023-05-15,9296
2457,飛宏,7,1,6,凱基-頭份,2023-05-15,9296
2002,中鋼,5,0,5,凱基-頭份,2023-05-15,9296
2359,所羅門,5,0,5,凱基-頭份,2023-05-15,9296
2401,凌陽,5,0,5,凱基-頭份,2023-05-15,9296
6550,北極星藥業-KY,5,0,5,凱基-頭份,2023-05-15,9296
8940,新天地,5,0,5,凱基-頭份,2023-05-15,9296
3105,穩懋,4,0,4,凱基-頭份,2023-05-15,9296
00753L,中信中國50正2,4,0,4,凱基-頭份,2023-05-15,9296
00751B,元大AAA至A公司債,4,0,4,凱基-頭份,2023-05-15,9296
00687B,國泰20年美債,4,0,4,凱基-頭份,2023-05-15,9296
2486,一詮,10,6,4,凱基-頭份,2023-05-15,9296
3224,三顧,6,2,4,凱基-頭份,2023-05-15,9296
5483,中美晶,4,0,4,凱基-頭份,2023-05-15,9296
6288,聯嘉,6,2,4,凱基-頭份,2023-05-15,9296
8299,群聯,4,0,4,凱基-頭份,2023-05-15,9296
3056,富華新,4,0,4,凱基-頭份,2023-05-15,9296
2884,玉山金,4,0,4,凱基-頭份,2023-05-15,9296
5871,中租-KY,3,0,3,凱基-頭份,2023-05-15,9296
8086,宏捷科,3,0,3,凱基-頭份,2023-05-15,9296
00706L,期元大S＆P日圓正2,3,0,3,凱基-頭份,2023-05-15,9296
1727,中華化,3,0,3,凱基-頭份,2023-05-15,9296
00878,國泰永續高股息,60,8,52,凱基-頭份,2023-05-16,9296
3056,富華新,32,0,32,凱基-頭份,2023-05-16,9296
6499,益安,26,0,26,凱基-頭份,2023-05-16,9296
00632R,元大台灣50反1,25,0,25,凱基-頭份,2023-05-16,9296
00720B,元大投資級公司債,24,0,24,凱基-頭份,2023-05-16,9296
3003,健和興,22,0,22,凱基-頭份,2023-05-16,9296
2402,毅嘉,20,0,20,凱基-頭份,2023-05-16,9296
2888,新光金,20,0,20,凱基-頭份,2023-05-16,9296
6122,擎邦,17,0,17,凱基-頭份,2023-05-16,9296
6218,豪勉,11,0,11,凱基-頭份,2023-05-16,9296
00664R,國泰臺灣加權反1,10,0,10,凱基-頭份,2023-05-16,9296
00896,中信綠能及電動車,10,0,10,凱基-頭份,2023-05-16,9296
2399,映泰,10,0,10,凱基-頭份,2023-05-16,9296
3628,盈正,10,0,10,凱基-頭份,2023-05-16,9296
2337,旺宏,9,0,9,凱基-頭份,2023-05-16,9296
2891,中信金,12,3,9,凱基-頭份,2023-05-16,9296
2421,建準,14,6,8,凱基-頭份,2023-05-16,9296
4581,光隆精密-KY,9,1,8,凱基-頭份,2023-05-16,9296
2610,華航,16,9,7,凱基-頭份,2023-05-16,9296
6194,育富,7,0,7,凱基-頭份,2023-05-16,9296
8426,紅木-KY,14,7,7,凱基-頭份,2023-05-16,9296
00772B,中信高評級公司債,6,0,6,凱基-頭份,2023-05-16,9296
00751B,元大AAA至A公司債,6,0,6,凱基-頭份,2023-05-16,9296
00680L,元大美債20正2,5,0,5,凱基-頭份,2023-05-16,9296
1227,佳格,5,0,5,凱基-頭份,2023-05-16,9296
00891,中信關鍵半導體,5,0,5,凱基-頭份,2023-05-16,9296
2374,佳能,5,0,5,凱基-頭份,2023-05-16,9296
6116,彩晶,5,0,5,凱基-頭份,2023-05-16,9296
8076,伍豐,46,41,5,凱基-頭份,2023-05-16,9296
2317,鴻海,4,0,4,凱基-頭份,2023-05-16,9296
2603,長榮,4,0,4,凱基-頭份,2023-05-16,9296
3162,精確,4,0,4,凱基-頭份,2023-05-16,9296
3265,台星科,4,0,4,凱基-頭份,2023-05-16,9296
6165,浪凡,4,0,4,凱基-頭份,2023-05-16,9296
6198,瑞築,6,2,4,凱基-頭份,2023-05-16,9296
8222,寶一,4,0,4,凱基-頭份,2023-05-16,9296
5701,劍湖山,4,0,4,凱基-頭份,2023-05-16,9296
1709,和益,3,0,3,凱基-頭份,2023-05-16,9296
2382,廣達,6,3,3,凱基-頭份,2023-05-16,9296
00857B,永豐20年美公債,3,0,3,凱基-頭份,2023-05-16,9296
00673R,期元大S＆P原油反1,3,0,3,凱基-頭份,2023-05-16,9296
2206,三陽工業,22,19,3,凱基-頭份,2023-05-16,9296
4931,新盛力,3,0,3,凱基-頭份,2023-05-16,9296
5202,力新,3,0,3,凱基-頭份,2023-05-16,9296
8446,華研,3,0,3,凱基-頭份,2023-05-16,9296
2449,京元電子,3,0,3,凱基-頭份,2023-05-16,9296
00712,復華富時不動產,2,0,2,凱基-頭份,2023-05-16,9296
00715L,期街口布蘭特正2,8,6,2,凱基-頭份,2023-05-16,9296
2208,台船,2,0,2,凱基-頭份,2023-05-16,9296
2323,中環,2,0,2,凱基-頭份,2023-05-16,9296
00632R,元大台灣50反1,153,52,101,凱基-頭份,2023-05-17,9296
00637L,元大滬深300正2,71,5,66,凱基-頭份,2023-05-17,9296
00878,國泰永續高股息,65,5,60,凱基-頭份,2023-05-17,9296
00679B,元大美債20年,59,1,58,凱基-頭份,2023-05-17,9296
00882,中信中國高股息,27,0,27,凱基-頭份,2023-05-17,9296
6770,力積電,26,1,25,凱基-頭份,2023-05-17,9296
2204,中華,37,13,24,凱基-頭份,2023-05-17,9296
00673R,期元大S＆P原油反1,19,0,19,凱基-頭份,2023-05-17,9296
8446,華研,17,1,16,凱基-頭份,2023-05-17,9296
1701,中化,15,0,15,凱基-頭份,2023-05-17,9296
5309,系統電,20,5,15,凱基-頭份,2023-05-17,9296
6139,亞翔,15,0,15,凱基-頭份,2023-05-17,9296
1514,亞力,12,1,11,凱基-頭份,2023-05-17,9296
6218,豪勉,11,0,11,凱基-頭份,2023-05-17,9296
6285,啟��,11,0,11,凱基-頭份,2023-05-17,9296
00664R,國泰臺灣加權反1,10,0,10,凱基-頭份,2023-05-17,9296
1612,宏泰,10,0,10,凱基-頭份,2023-05-17,9296
1815,富喬,10,0,10,凱基-頭份,2023-05-17,9296
3078,僑威,13,3,10,凱基-頭份,2023-05-17,9296
3714,富采,10,0,10,凱基-頭份,2023-05-17,9296
5324,士開,10,0,10,凱基-頭份,2023-05-17,9296
00680L,元大美債20正2,9,0,9,凱基-頭份,2023-05-17,9296
6188,廣明,9,0,9,凱基-頭份,2023-05-17,9296
2474,可成,8,0,8,凱基-頭份,2023-05-17,9296
6148,驊宏資,8,0,8,凱基-頭份,2023-05-17,9296
6492,生華科,8,0,8,凱基-頭份,2023-05-17,9296
00712,復華富時不動產,7,0,7,凱基-頭份,2023-05-17,9296
2070,精湛,7,0,7,凱基-頭份,2023-05-17,9296
4581,光隆精密-KY,7,0,7,凱基-頭份,2023-05-17,9296
6160,欣技,24,17,7,凱基-頭份,2023-05-17,9296
6282,康舒,8,2,6,凱基-頭份,2023-05-17,9296
00780B,國泰A級金融債,6,0,6,凱基-頭份,2023-05-17,9296
2887,台新金,20,14,6,凱基-頭份,2023-05-17,9296
6443,元晶,6,0,6,凱基-頭份,2023-05-17,9296
6535,順藥,6,0,6,凱基-頭份,2023-05-17,9296
00648R,元大S＆P500反1,5,0,5,凱基-頭份,2023-05-17,9296
00751B,元大AAA至A公司債,5,0,5,凱基-頭份,2023-05-17,9296
2402,毅嘉,5,0,5,凱基-頭份,2023-05-17,9296
3715,定穎投控,5,0,5,凱基-頭份,2023-05-17,9296
6625,必應,11,6,5,凱基-頭份,2023-05-17,9296
2317,鴻海,4,0,4,凱基-頭份,2023-05-17,9296
00857B,永豐20年美公債,4,0,4,凱基-頭份,2023-05-17,9296
00715L,期街口布蘭特正2,4,0,4,凱基-頭份,2023-05-17,9296
2392,正崴,4,0,4,凱基-頭份,2023-05-17,9296
2633,台灣高鐵,5,1,4,凱基-頭份,2023-05-17,9296
3062,建漢,4,0,4,凱基-頭份,2023-05-17,9296
3260,威剛,4,0,4,凱基-頭份,2023-05-17,9296
3346,麗清,5,1,4,凱基-頭份,2023-05-17,9296
6226,光鼎,4,0,4,凱基-頭份,2023-05-17,9296
2634,漢翔,9,6,3,凱基-頭份,2023-05-17,9296
00632R,元大台灣50反1,128,0,128,凱基-頭份,2023-05-18,9296
2371,大同,133,19,114,凱基-頭份,2023-05-18,9296
1312,國喬,100,0,100,凱基-頭份,2023-05-18,9296
2103,台橡,30,0,30,凱基-頭份,2023-05-18,9296
00664R,國泰臺灣加權反1,20,0,20,凱基-頭份,2023-05-18,9296
6517,保勝光學,23,3,20,凱基-頭份,2023-05-18,9296
8429,金麗-KY,18,0,18,凱基-頭份,2023-05-18,9296
00687B,國泰20年美債,17,0,17,凱基-頭份,2023-05-18,9296
3673,TPK-KY,16,0,16,凱基-頭份,2023-05-18,9296
8936,國統,15,0,15,凱基-頭份,2023-05-18,9296
4543,萬在,20,6,14,凱基-頭份,2023-05-18,9296
1810,和成,13,0,13,凱基-頭份,2023-05-18,9296
3346,麗清,17,5,12,凱基-頭份,2023-05-18,9296
1504,東元,33,22,11,凱基-頭份,2023-05-18,9296
2421,建準,15,4,11,凱基-頭份,2023-05-18,9296
2745,五福,11,0,11,凱基-頭份,2023-05-18,9296
1337,再生-KY,10,0,10,凱基-頭份,2023-05-18,9296
2206,三陽工業,26,16,10,凱基-頭份,2023-05-18,9296
2880,華南金,10,0,10,凱基-頭份,2023-05-18,9296
4161,聿新科,10,0,10,凱基-頭份,2023-05-18,9296
4167,松瑞藥,10,0,10,凱基-頭份,2023-05-18,9296
4533,協易機,10,0,10,凱基-頭份,2023-05-18,9296
8091,翔名,10,0,10,凱基-頭份,2023-05-18,9296
8926,台汽電,10,0,10,凱基-頭份,2023-05-18,9296
8996,高力,10,1,9,凱基-頭份,2023-05-18,9296
1514,亞力,9,1,8,凱基-頭份,2023-05-18,9296
2323,中環,10,2,8,凱基-頭份,2023-05-18,9296
6165,浪凡,8,0,8,凱基-頭份,2023-05-18,9296
5425,台半,7,0,7,凱基-頭份,2023-05-18,9296
6625,必應,30,23,7,凱基-頭份,2023-05-18,9296
8937,合騏,9,2,7,凱基-頭份,2023-05-18,9296
1229,聯華,10,4,6,凱基-頭份,2023-05-18,9296
2352,佳世達,8,2,6,凱基-頭份,2023-05-18,9296
3362,先進光,12,6,6,凱基-頭份,2023-05-18,9296
3707,漢磊,6,0,6,凱基-頭份,2023-05-18,9296
6148,驊宏資,8,2,6,凱基-頭份,2023-05-18,9296
6443,元晶,6,0,6,凱基-頭份,2023-05-18,9296
9943,好樂迪,9,3,6,凱基-頭份,2023-05-18,9296
00720B,元大投資級公司債,5,0,5,凱基-頭份,2023-05-18,9296
00633L,富邦上証正2,5,0,5,凱基-頭份,2023-05-18,9296
3483,力致,5,0,5,凱基-頭份,2023-05-18,9296
3504,揚明光,5,0,5,凱基-頭份,2023-05-18,9296
4919,新唐,5,0,5,凱基-頭份,2023-05-18,9296
5905,南仁湖,5,0,5,凱基-頭份,2023-05-18,9296
6235,華孚,11,6,5,凱基-頭份,2023-05-18,9296
6241,易通展,5,0,5,凱基-頭份,2023-05-18,9296
9907,統一實,5,0,5,凱基-頭份,2023-05-18,9296
1605,華新,4,0,4,凱基-頭份,2023-05-18,9296
1609,大亞,19,15,4,凱基-頭份,2023-05-18,9296
3027,盛達,9,5,4,凱基-頭份,2023-05-18,9296
4804,大略-KY,100,0,100,凱基-頭份,2023-05-19,9296
2610,華航,114,27,87,凱基-頭份,2023-05-19,9296
00632R,元大台灣50反1,82,0,82,凱基-頭份,2023-05-19,9296
3704,合勤控,50,1,49,凱基-頭份,2023-05-19,9296
00882,中信中國高股息,43,0,43,凱基-頭份,2023-05-19,9296
5009,榮剛,32,4,28,凱基-頭份,2023-05-19,9296
00753L,中信中國50正2,24,0,24,凱基-頭份,2023-05-19,9296
8426,紅木-KY,21,0,21,凱基-頭份,2023-05-19,9296
00712,復華富時不動產,25,5,20,凱基-頭份,2023-05-19,9296
2887,台新金,22,2,20,凱基-頭份,2023-05-19,9296
8429,金麗-KY,20,0,20,凱基-頭份,2023-05-19,9296
1312,國喬,15,0,15,凱基-頭份,2023-05-19,9296
1503,士電,16,4,12,凱基-頭份,2023-05-19,9296
5201,凱衛,15,3,12,凱基-頭份,2023-05-19,9296
5351,鈺創,12,0,12,凱基-頭份,2023-05-19,9296
2014,中鴻,11,0,11,凱基-頭份,2023-05-19,9296
3003,健和興,10,0,10,凱基-頭份,2023-05-19,9296
00664R,國泰臺灣加權反1,10,0,10,凱基-頭份,2023-05-19,9296
00674R,期元大S＆P黃金反1,10,0,10,凱基-頭份,2023-05-19,9296
1618,合機,10,0,10,凱基-頭份,2023-05-19,9296
2349,錸德,10,0,10,凱基-頭份,2023-05-19,9296
2897,王道銀行,10,0,10,凱基-頭份,2023-05-19,9296
3363,上詮,11,1,10,凱基-頭份,2023-05-19,9296
5483,中美晶,11,1,10,凱基-頭份,2023-05-19,9296
6190,萬泰科,10,0,10,凱基-頭份,2023-05-19,9296
6278,台表科,10,0,10,凱基-頭份,2023-05-19,9296
2736,富野,10,1,9,凱基-頭份,2023-05-19,9296
00687B,國泰20年美債,8,0,8,凱基-頭份,2023-05-19,9296
00720B,元大投資級公司債,8,0,8,凱基-頭份,2023-05-19,9296
00795B,中信美國公債20年,8,0,8,凱基-頭份,2023-05-19,9296
4979,華星光,9,1,8,凱基-頭份,2023-05-19,9296
6517,保勝光學,18,10,8,凱基-頭份,2023-05-19,9296
1513,中興電,11,4,7,凱基-頭份,2023-05-19,9296
8926,台汽電,12,5,7,凱基-頭份,2023-05-19,9296
2883,凱基金,6,0,6,凱基-頭份,2023-05-19,9296
1784,訊聯,7,1,6,凱基-頭份,2023-05-19,9296
2882,國泰金,10,4,6,凱基-頭份,2023-05-19,9296
6770,力積電,6,0,6,凱基-頭份,2023-05-19,9296
00895,富邦未來車,5,0,5,凱基-頭份,2023-05-19,9296
00669R,國泰美國道瓊反1,5,0,5,凱基-頭份,2023-05-19,9296
00673R,期元大S＆P原油反1,5,0,5,凱基-頭份,2023-05-19,9296
00671R,富邦NASDAQ反1,5,0,5,凱基-頭份,2023-05-19,9296
00683L,期元大美元指正2,5,0,5,凱基-頭份,2023-05-19,9296
00665L,富邦�琤肭磪囓�2,5,0,5,凱基-頭份,2023-05-19,9296
00857B,永豐20年美公債,5,0,5,凱基-頭份,2023-05-19,9296
1905,華紙,7,2,5,凱基-頭份,2023-05-19,9296
2520,冠德,5,0,5,凱基-頭份,2023-05-19,9296
2888,新光金,5,0,5,凱基-頭份,2023-05-19,9296
4168,醣聯,5,0,5,凱基-頭份,2023-05-19,9296
4543,萬在,5,0,5,凱基-頭份,2023-05-19,9296
2882,國泰金,200,0,200,凱基-頭份,2023-05-22,9296
4402,郡都開發,122,0,122,凱基-頭份,2023-05-22,9296
2332,友訊,30,1,29,凱基-頭份,2023-05-22,9296
1101,台泥,21,0,21,凱基-頭份,2023-05-22,9296
2402,毅嘉,20,0,20,凱基-頭份,2023-05-22,9296
2734,易飛網,21,2,19,凱基-頭份,2023-05-22,9296
2736,富野,32,17,15,凱基-頭份,2023-05-22,9296
3025,星通,17,5,12,凱基-頭份,2023-05-22,9296
2206,三陽工業,22,10,12,凱基-頭份,2023-05-22,9296
2002,中鋼,12,1,11,凱基-頭份,2023-05-22,9296
4804,大略-KY,11,0,11,凱基-頭份,2023-05-22,9296
5511,德昌,11,0,11,凱基-頭份,2023-05-22,9296
00641R,富邦日本反1,10,0,10,凱基-頭份,2023-05-22,9296
00674R,期元大S＆P黃金反1,10,0,10,凱基-頭份,2023-05-22,9296
00857B,永豐20年美公債,10,0,10,凱基-頭份,2023-05-22,9296
1608,華榮,10,0,10,凱基-頭份,2023-05-22,9296
2105,正新,10,0,10,凱基-頭份,2023-05-22,9296
3290,東浦,10,0,10,凱基-頭份,2023-05-22,9296
6509,聚和,10,0,10,凱基-頭份,2023-05-22,9296
8059,凱碩,10,0,10,凱基-頭份,2023-05-22,9296
00679B,元大美債20年,9,0,9,凱基-頭份,2023-05-22,9296
00715L,期街口布蘭特正2,8,0,8,凱基-頭份,2023-05-22,9296
3346,麗清,10,2,8,凱基-頭份,2023-05-22,9296
00795B,中信美國公債20年,7,0,7,凱基-頭份,2023-05-22,9296
2303,聯電,7,0,7,凱基-頭份,2023-05-22,9296
00687B,國泰20年美債,6,0,6,凱基-頭份,2023-05-22,9296
8926,台汽電,7,1,6,凱基-頭份,2023-05-22,9296
1519,華城,18,13,5,凱基-頭份,2023-05-22,9296
1618,合機,5,0,5,凱基-頭份,2023-05-22,9296
2331,精英,7,2,5,凱基-頭份,2023-05-22,9296
2883,凱基金,5,0,5,凱基-頭份,2023-05-22,9296
3557,嘉威,5,0,5,凱基-頭份,2023-05-22,9296
4916,事欣科,5,0,5,凱基-頭份,2023-05-22,9296
4927,泰鼎-KY,8,3,5,凱基-頭份,2023-05-22,9296
6116,彩晶,5,0,5,凱基-頭份,2023-05-22,9296
6148,驊宏資,6,1,5,凱基-頭份,2023-05-22,9296
6160,欣技,11,6,5,凱基-頭份,2023-05-22,9296
6235,華孚,5,0,5,凱基-頭份,2023-05-22,9296
0056,元大高股息,5,1,4,凱基-頭份,2023-05-22,9296
1528,恩德,23,19,4,凱基-頭份,2023-05-22,9296
2327,國巨,4,0,4,凱基-頭份,2023-05-22,9296
3022,威強電,4,0,4,凱基-頭份,2023-05-22,9296
3035,智原,6,2,4,凱基-頭份,2023-05-22,9296
3264,欣銓,6,2,4,凱基-頭份,2023-05-22,9296
3380,明泰,4,0,4,凱基-頭份,2023-05-22,9296
8210,勤誠,4,0,4,凱基-頭份,2023-05-22,9296
00772B,中信高評級公司債,6,3,3,凱基-頭份,2023-05-22,9296
00764B,群益25年美債,3,0,3,凱基-頭份,2023-05-22,9296
00882,中信中國高股息,3,0,3,凱基-頭份,2023-05-22,9296
1605,華新,4,1,3,凱基-頭份,2023-05-22,9296
4402,郡都開發,60,0,60,凱基-頭份,2023-05-23,9296
5864,致和證,41,0,41,凱基-頭份,2023-05-23,9296
2913,農林,30,0,30,凱基-頭份,2023-05-23,9296
4804,大略-KY,24,0,24,凱基-頭份,2023-05-23,9296
2323,中環,21,0,21,凱基-頭份,2023-05-23,9296
1514,亞力,21,1,20,凱基-頭份,2023-05-23,9296
2438,翔耀,20,0,20,凱基-頭份,2023-05-23,9296
2888,新光金,17,0,17,凱基-頭份,2023-05-23,9296
6116,彩晶,14,0,14,凱基-頭份,2023-05-23,9296
3628,盈正,12,0,12,凱基-頭份,2023-05-23,9296
4541,晟田,13,2,11,凱基-頭份,2023-05-23,9296
00687B,國泰20年美債,10,0,10,凱基-頭份,2023-05-23,9296
00679B,元大美債20年,10,0,10,凱基-頭份,2023-05-23,9296
00632R,元大台灣50反1,10,0,10,凱基-頭份,2023-05-23,9296
2017,官田鋼,15,5,10,凱基-頭份,2023-05-23,9296
2103,台橡,10,0,10,凱基-頭份,2023-05-23,9296
2645,長榮航太,11,1,10,凱基-頭份,2023-05-23,9296
3479,安勤,10,0,10,凱基-頭份,2023-05-23,9296
4747,強生,10,0,10,凱基-頭份,2023-05-23,9296
5531,鄉林,10,0,10,凱基-頭份,2023-05-23,9296
6005,群益證,10,0,10,凱基-頭份,2023-05-23,9296
6523,達爾膚,10,0,10,凱基-頭份,2023-05-23,9296
8059,凱碩,20,10,10,凱基-頭份,2023-05-23,9296
1584,精剛,12,3,9,凱基-頭份,2023-05-23,9296
00857B,永豐20年美公債,8,0,8,凱基-頭份,2023-05-23,9296
00637L,元大滬深300正2,17,9,8,凱基-頭份,2023-05-23,9296
00674R,期元大S＆P黃金反1,8,0,8,凱基-頭份,2023-05-23,9296
2609,陽明,7,0,7,凱基-頭份,2023-05-23,9296
00673R,期元大S＆P原油反1,6,0,6,凱基-頭份,2023-05-23,9296
00683L,期元大美元指正2,6,0,6,凱基-頭份,2023-05-23,9296
3083,網龍,6,0,6,凱基-頭份,2023-05-23,9296
1337,再生-KY,12,7,5,凱基-頭份,2023-05-23,9296
00891,中信關鍵半導體,5,0,5,凱基-頭份,2023-05-23,9296
1709,和益,5,0,5,凱基-頭份,2023-05-23,9296
3005,神基,5,0,5,凱基-頭份,2023-05-23,9296
3576,聯合再生,10,5,5,凱基-頭份,2023-05-23,9296
4746,台耀,5,0,5,凱基-頭份,2023-05-23,9296
5328,華容,5,0,5,凱基-頭份,2023-05-23,9296
6266,泰詠,5,0,5,凱基-頭份,2023-05-23,9296
8099,大世科,6,1,5,凱基-頭份,2023-05-23,9296
00772B,中信高評級公司債,4,0,4,凱基-頭份,2023-05-23,9296
2603,長榮,4,0,4,凱基-頭份,2023-05-23,9296
00882,中信中國高股息,14,10,4,凱基-頭份,2023-05-23,9296
1560,中砂,4,0,4,凱基-頭份,2023-05-23,9296
1907,永豐餘,5,1,4,凱基-頭份,2023-05-23,9296
2367,燿華,4,0,4,凱基-頭份,2023-05-23,9296
2634,漢翔,10,6,4,凱基-頭份,2023-05-23,9296
6598,ABC-KY,4,0,4,凱基-頭份,2023-05-23,9296
8926,台汽電,4,0,4,凱基-頭份,2023-05-23,9296
4763,材料-KY,10,7,3,凱基-頭份,2023-05-23,9296
00712,復華富時不動產,50,0,50,凱基-頭份,2023-05-24,9296
912000,晨訊科-DR,31,0,31,凱基-頭份,2023-05-24,9296
00882,中信中國高股息,29,0,29,凱基-頭份,2023-05-24,9296
2402,毅嘉,26,0,26,凱基-頭份,2023-05-24,9296
2421,建準,32,8,24,凱基-頭份,2023-05-24,9296
00637L,元大滬深300正2,32,10,22,凱基-頭份,2023-05-24,9296
4747,強生,20,0,20,凱基-頭份,2023-05-24,9296
00633L,富邦上証正2,17,0,17,凱基-頭份,2023-05-24,9296
00679B,元大美債20年,19,4,15,凱基-頭份,2023-05-24,9296
2630,亞航,15,2,13,凱基-頭份,2023-05-24,9296
3308,聯德,13,0,13,凱基-頭份,2023-05-24,9296
3078,僑威,12,0,12,凱基-頭份,2023-05-24,9296
2323,中環,11,0,11,凱基-頭份,2023-05-24,9296
2748,雲品,21,10,11,凱基-頭份,2023-05-24,9296
8059,凱碩,11,0,11,凱基-頭份,2023-05-24,9296
911868,同方友友-DR,11,0,11,凱基-頭份,2023-05-24,9296
1432,大魯閣,10,0,10,凱基-頭份,2023-05-24,9296
2206,三陽工業,11,1,10,凱基-頭份,2023-05-24,9296
3511,矽瑪,10,0,10,凱基-頭份,2023-05-24,9296
3576,聯合再生,10,0,10,凱基-頭份,2023-05-24,9296
4541,晟田,10,0,10,凱基-頭份,2023-05-24,9296
6167,久正,10,0,10,凱基-頭份,2023-05-24,9296
2705,六福,26,17,9,凱基-頭份,2023-05-24,9296
5465,富驊,9,0,9,凱基-頭份,2023-05-24,9296
00687B,國泰20年美債,8,0,8,凱基-頭份,2023-05-24,9296
2888,新光金,13,5,8,凱基-頭份,2023-05-24,9296
3594,磐儀,8,0,8,凱基-頭份,2023-05-24,9296
6492,生華科,8,0,8,凱基-頭份,2023-05-24,9296
8076,伍豐,10,2,8,凱基-頭份,2023-05-24,9296
00680L,元大美債20正2,7,0,7,凱基-頭份,2023-05-24,9296
1785,光洋科,8,1,7,凱基-頭份,2023-05-24,9296
2442,新美齊,7,0,7,凱基-頭份,2023-05-24,9296
3498,陽程,9,2,7,凱基-頭份,2023-05-24,9296
3706,神達,6,0,6,凱基-頭份,2023-05-24,9296
8099,大世科,10,4,6,凱基-頭份,2023-05-24,9296
2103,台橡,5,0,5,凱基-頭份,2023-05-24,9296
3025,星通,5,0,5,凱基-頭份,2023-05-24,9296
3088,艾訊,5,0,5,凱基-頭份,2023-05-24,9296
3287,廣寰科,5,0,5,凱基-頭份,2023-05-24,9296
3454,晶睿,5,0,5,凱基-頭份,2023-05-24,9296
3617,碩天,5,0,5,凱基-頭份,2023-05-24,9296
6288,聯嘉,5,0,5,凱基-頭份,2023-05-24,9296
6523,達爾膚,5,0,5,凱基-頭份,2023-05-24,9296
6603,富強鑫,5,0,5,凱基-頭份,2023-05-24,9296
00919,群益台灣精選高息,4,0,4,凱基-頭份,2023-05-24,9296
00674R,期元大S＆P黃金反1,4,0,4,凱基-頭份,2023-05-24,9296
1584,精剛,7,3,4,凱基-頭份,2023-05-24,9296
1727,中華化,4,0,4,凱基-頭份,2023-05-24,9296
1810,和成,8,4,4,凱基-頭份,2023-05-24,9296
1905,華紙,11,7,4,凱基-頭份,2023-05-24,9296
911868,同方友友-DR,118,0,118,凱基-頭份,2023-05-25,9296
00680L,元大美債20正2,53,7,46,凱基-頭份,2023-05-25,9296
4747,強生,40,0,40,凱基-頭份,2023-05-25,9296
00637L,元大滬深300正2,46,8,38,凱基-頭份,2023-05-25,9296
00882,中信中國高股息,35,0,35,凱基-頭份,2023-05-25,9296
1460,宏遠,33,0,33,凱基-頭份,2023-05-25,9296
00632R,元大台灣50反1,51,20,31,凱基-頭份,2023-05-25,9296
00679B,元大美債20年,23,0,23,凱基-頭份,2023-05-25,9296
2706,第一店,22,0,22,凱基-頭份,2023-05-25,9296
6220,岳豐,20,0,20,凱基-頭份,2023-05-25,9296
00712,復華富時不動產,20,0,20,凱基-頭份,2023-05-25,9296
5905,南仁湖,37,20,17,凱基-頭份,2023-05-25,9296
2701,萬企,16,0,16,凱基-頭份,2023-05-25,9296
2371,大同,16,1,15,凱基-頭份,2023-05-25,9296
3202,樺晟,15,0,15,凱基-頭份,2023-05-25,9296
2349,錸德,14,1,13,凱基-頭份,2023-05-25,9296
3046,建��,20,8,12,凱基-頭份,2023-05-25,9296
2323,中環,21,10,11,凱基-頭份,2023-05-25,9296
2442,新美齊,11,0,11,凱基-頭份,2023-05-25,9296
1101,台泥,11,0,11,凱基-頭份,2023-05-25,9296
00664R,國泰臺灣加權反1,10,0,10,凱基-頭份,2023-05-25,9296
00898,國泰基因免疫革命,10,0,10,凱基-頭份,2023-05-25,9296
1459,聯發,10,0,10,凱基-頭份,2023-05-25,9296
2367,燿華,10,0,10,凱基-頭份,2023-05-25,9296
2409,友達,10,0,10,凱基-頭份,2023-05-25,9296
2528,皇普,10,0,10,凱基-頭份,2023-05-25,9296
3625,西勝,10,0,10,凱基-頭份,2023-05-25,9296
1310,台苯,9,0,9,凱基-頭份,2023-05-25,9296
2734,易飛網,10,1,9,凱基-頭份,2023-05-25,9296
6285,啟��,10,1,9,凱基-頭份,2023-05-25,9296
2352,佳世達,10,2,8,凱基-頭份,2023-05-25,9296
2401,凌陽,8,0,8,凱基-頭份,2023-05-25,9296
1810,和成,7,0,7,凱基-頭份,2023-05-25,9296
2025,千興,7,0,7,凱基-頭份,2023-05-25,9296
3325,旭品,10,3,7,凱基-頭份,2023-05-25,9296
6120,達運,7,0,7,凱基-頭份,2023-05-25,9296
00857B,永豐20年美公債,6,0,6,凱基-頭份,2023-05-25,9296
00665L,富邦�琤肭磪囓�2,6,0,6,凱基-頭份,2023-05-25,9296
00633L,富邦上証正2,6,0,6,凱基-頭份,2023-05-25,9296
2739,寒舍,6,0,6,凱基-頭份,2023-05-25,9296
3056,富華新,6,0,6,凱基-頭份,2023-05-25,9296
5483,中美晶,7,1,6,凱基-頭份,2023-05-25,9296
5864,致和證,46,40,6,凱基-頭份,2023-05-25,9296
6509,聚和,6,0,6,凱基-頭份,2023-05-25,9296
00720B,元大投資級公司債,5,0,5,凱基-頭份,2023-05-25,9296
1416,廣豐,5,0,5,凱基-頭份,2023-05-25,9296
00687B,國泰20年美債,5,0,5,凱基-頭份,2023-05-25,9296
00751B,元大AAA至A公司債,5,0,5,凱基-頭份,2023-05-25,9296
1504,東元,7,2,5,凱基-頭份,2023-05-25,9296
2017,官田鋼,15,10,5,凱基-頭份,2023-05-25,9296
00632R,元大台灣50反1,298,2,296,凱基-頭份,2023-05-26,9296
2025,千興,277,0,277,凱基-頭份,2023-05-26,9296
911868,同方友友-DR,100,0,100,凱基-頭份,2023-05-26,9296
00712,復華富時不動產,56,0,56,凱基-頭份,2023-05-26,9296
1709,和益,52,0,52,凱基-頭份,2023-05-26,9296
3481,群創,41,7,34,凱基-頭份,2023-05-26,9296
2734,易飛網,32,0,32,凱基-頭份,2023-05-26,9296
3029,零壹,33,3,30,凱基-頭份,2023-05-26,9296
1609,大亞,33,5,28,凱基-頭份,2023-05-26,9296
4564,元翎,43,15,28,凱基-頭份,2023-05-26,9296
2891,中信金,27,2,25,凱基-頭份,2023-05-26,9296
2618,長榮航,77,61,16,凱基-頭份,2023-05-26,9296
00642U,期元大S＆P石油,15,0,15,凱基-頭份,2023-05-26,9296
3025,星通,18,4,14,凱基-頭份,2023-05-26,9296
2633,台灣高鐵,12,0,12,凱基-頭份,2023-05-26,9296
2409,友達,12,1,11,凱基-頭份,2023-05-26,9296
2706,第一店,11,0,11,凱基-頭份,2023-05-26,9296
6190,萬泰科,12,1,11,凱基-頭份,2023-05-26,9296
00679B,元大美債20年,10,0,10,凱基-頭份,2023-05-26,9296
2614,東森,10,0,10,凱基-頭份,2023-05-26,9296
5706,鳳凰,25,15,10,凱基-頭份,2023-05-26,9296
5905,南仁湖,10,0,10,凱基-頭份,2023-05-26,9296
6147,頎邦,10,0,10,凱基-頭份,2023-05-26,9296
2368,金像電,11,2,9,凱基-頭份,2023-05-26,9296
00882,中信中國高股息,8,0,8,凱基-頭份,2023-05-26,9296
1904,正隆,8,0,8,凱基-頭份,2023-05-26,9296
3202,樺晟,8,0,8,凱基-頭份,2023-05-26,9296
6770,力積電,10,2,8,凱基-頭份,2023-05-26,9296
1905,華紙,10,3,7,凱基-頭份,2023-05-26,9296
2356,英業達,8,1,7,凱基-頭份,2023-05-26,9296
6116,彩晶,7,0,7,凱基-頭份,2023-05-26,9296
00637L,元大滬深300正2,11,5,6,凱基-頭份,2023-05-26,9296
2349,錸德,10,4,6,凱基-頭份,2023-05-26,9296
2425,承啟,6,0,6,凱基-頭份,2023-05-26,9296
2611,志信,6,0,6,凱基-頭份,2023-05-26,9296
3205,佰研,6,0,6,凱基-頭份,2023-05-26,9296
3694,海華,6,0,6,凱基-頭份,2023-05-26,9296
1314,中石化,5,0,5,凱基-頭份,2023-05-26,9296
00715L,期街口布蘭特正2,6,1,5,凱基-頭份,2023-05-26,9296
00664R,國泰臺灣加權反1,5,0,5,凱基-頭份,2023-05-26,9296
00676R,富邦臺灣加權反1,5,0,5,凱基-頭份,2023-05-26,9296
1529,樂事綠能,5,0,5,凱基-頭份,2023-05-26,9296
2017,官田鋼,5,0,5,凱基-頭份,2023-05-26,9296
2105,正新,5,0,5,凱基-頭份,2023-05-26,9296
2204,中華,5,0,5,凱基-頭份,2023-05-26,9296
2323,中環,86,81,5,凱基-頭份,2023-05-26,9296
2453,凌群,9,4,5,凱基-頭份,2023-05-26,9296
2457,飛宏,10,5,5,凱基-頭份,2023-05-26,9296
2888,新光金,5,0,5,凱基-頭份,2023-05-26,9296
3682,亞太電,5,0,5,凱基-頭份,2023-05-26,9296
5876,上海商銀,100,0,100,凱基-頭份,2023-05-29,9296
2888,新光金,62,0,62,凱基-頭份,2023-05-29,9296
2371,大同,121,78,43,凱基-頭份,2023-05-29,9296
1905,華紙,43,14,29,凱基-頭份,2023-05-29,9296
00712,復華富時不動產,25,0,25,凱基-頭份,2023-05-29,9296
1522,堤維西,25,0,25,凱基-頭份,2023-05-29,9296
00665L,富邦�琤肭磪囓�2,20,0,20,凱基-頭份,2023-05-29,9296
2323,中環,41,21,20,凱基-頭份,2023-05-29,9296
00878,國泰永續高股息,22,4,18,凱基-頭份,2023-05-29,9296
2421,建準,20,3,17,凱基-頭份,2023-05-29,9296
0056,元大高股息,20,5,15,凱基-頭份,2023-05-29,9296
00903,富邦元宇宙,15,0,15,凱基-頭份,2023-05-29,9296
3030,德律,15,0,15,凱基-頭份,2023-05-29,9296
2025,千興,13,0,13,凱基-頭份,2023-05-29,9296
00664R,國泰臺灣加權反1,10,0,10,凱基-頭份,2023-05-29,9296
2637,慧洋-KY,10,0,10,凱基-頭份,2023-05-29,9296
3265,台星科,18,8,10,凱基-頭份,2023-05-29,9296
6005,群益證,10,0,10,凱基-頭份,2023-05-29,9296
8905,裕國,10,0,10,凱基-頭份,2023-05-29,9296
2317,鴻海,12,3,9,凱基-頭份,2023-05-29,9296
00673R,期元大S＆P原油反1,8,0,8,凱基-頭份,2023-05-29,9296
00882,中信中國高股息,8,0,8,凱基-頭份,2023-05-29,9296
2423,固緯,8,0,8,凱基-頭份,2023-05-29,9296
6248,沛波,8,0,8,凱基-頭份,2023-05-29,9296
00687B,國泰20年美債,7,0,7,凱基-頭份,2023-05-29,9296
3163,波若威,7,0,7,凱基-頭份,2023-05-29,9296
2358,廷鑫,6,0,6,凱基-頭份,2023-05-29,9296
2615,萬海,10,4,6,凱基-頭份,2023-05-29,9296
3094,聯傑,6,0,6,凱基-頭份,2023-05-29,9296
4564,元翎,7,1,6,凱基-頭份,2023-05-29,9296
5523,豐謙,6,0,6,凱基-頭份,2023-05-29,9296
1513,中興電,17,12,5,凱基-頭份,2023-05-29,9296
2412,中華電,5,0,5,凱基-頭份,2023-05-29,9296
2736,富野,31,26,5,凱基-頭份,2023-05-29,9296
4105,東洋,5,0,5,凱基-頭份,2023-05-29,9296
4114,健喬,5,0,5,凱基-頭份,2023-05-29,9296
4541,晟田,5,0,5,凱基-頭份,2023-05-29,9296
6116,彩晶,5,0,5,凱基-頭份,2023-05-29,9296
6576,逸達,5,0,5,凱基-頭份,2023-05-29,9296
00679B,元大美債20年,4,0,4,凱基-頭份,2023-05-29,9296
00751B,元大AAA至A公司債,4,0,4,凱基-頭份,2023-05-29,9296
2356,英業達,6,2,4,凱基-頭份,2023-05-29,9296
3217,優群,4,0,4,凱基-頭份,2023-05-29,9296
3306,鼎天,4,0,4,凱基-頭份,2023-05-29,9296
3466,德晉,4,0,4,凱基-頭份,2023-05-29,9296
3591,艾笛森,4,0,4,凱基-頭份,2023-05-29,9296
3617,碩天,4,0,4,凱基-頭份,2023-05-29,9296
5347,世界,4,0,4,凱基-頭份,2023-05-29,9296
5483,中美晶,12,8,4,凱基-頭份,2023-05-29,9296
6111,大宇資,4,0,4,凱基-頭份,2023-05-29,9296
00632R,元大台灣50反1,224,0,224,凱基-頭份,2023-05-30,9296
911868,同方友友-DR,100,0,100,凱基-頭份,2023-05-30,9296
00882,中信中國高股息,46,0,46,凱基-頭份,2023-05-30,9296
00725B,國泰投資級公司債,40,0,40,凱基-頭份,2023-05-30,9296
2891,中信金,37,0,37,凱基-頭份,2023-05-30,9296
2834,臺企銀,22,0,22,凱基-頭份,2023-05-30,9296
3481,群創,21,1,20,凱基-頭份,2023-05-30,9296
2633,台灣高鐵,18,0,18,凱基-頭份,2023-05-30,9296
2453,凌群,33,17,16,凱基-頭份,2023-05-30,9296
2302,麗正,15,0,15,凱基-頭份,2023-05-30,9296
00637L,元大滬深300正2,21,8,13,凱基-頭份,2023-05-30,9296
2201,裕隆,34,21,13,凱基-頭份,2023-05-30,9296
8033,雷虎,13,1,12,凱基-頭份,2023-05-30,9296
3013,晟銘電,18,7,11,凱基-頭份,2023-05-30,9296
5351,鈺創,11,0,11,凱基-頭份,2023-05-30,9296
8905,裕國,11,0,11,凱基-頭份,2023-05-30,9296
2489,瑞軒,10,1,9,凱基-頭份,2023-05-30,9296
2412,中華電,8,0,8,凱基-頭份,2023-05-30,9296
5905,南仁湖,8,0,8,凱基-頭份,2023-05-30,9296
6188,廣明,10,2,8,凱基-頭份,2023-05-30,9296
8054,安國,8,0,8,凱基-頭份,2023-05-30,9296
2618,長榮航,44,36,8,凱基-頭份,2023-05-30,9296
00720B,元大投資級公司債,7,0,7,凱基-頭份,2023-05-30,9296
2328,廣宇,10,3,7,凱基-頭份,2023-05-30,9296
00715L,期街口布蘭特正2,6,0,6,凱基-頭份,2023-05-30,9296
00665L,富邦�琤肭磪囓�2,6,0,6,凱基-頭份,2023-05-30,9296
2480,敦陽科,6,0,6,凱基-頭份,2023-05-30,9296
6160,欣技,15,9,6,凱基-頭份,2023-05-30,9296
00679B,元大美債20年,5,0,5,凱基-頭份,2023-05-30,9296
00633L,富邦上証正2,6,1,5,凱基-頭份,2023-05-30,9296
00687B,國泰20年美債,5,0,5,凱基-頭份,2023-05-30,9296
1810,和成,5,0,5,凱基-頭份,2023-05-30,9296
2017,官田鋼,5,0,5,凱基-頭份,2023-05-30,9296
2706,第一店,5,0,5,凱基-頭份,2023-05-30,9296
2883,凱基金,5,0,5,凱基-頭份,2023-05-30,9296
4979,華星光,17,12,5,凱基-頭份,2023-05-30,9296
6282,康舒,5,0,5,凱基-頭份,2023-05-30,9296
6576,逸達,5,0,5,凱基-頭份,2023-05-30,9296
6835,圓裕,5,0,5,凱基-頭份,2023-05-30,9296
8277,商丞,10,5,5,凱基-頭份,2023-05-30,9296
3037,欣興,5,0,5,凱基-頭份,2023-05-30,9296
00919,群益台灣精選高息,5,1,4,凱基-頭份,2023-05-30,9296
2367,燿華,4,0,4,凱基-頭份,2023-05-30,9296
2630,亞航,4,0,4,凱基-頭份,2023-05-30,9296
3025,星通,9,5,4,凱基-頭份,2023-05-30,9296
3078,僑威,4,0,4,凱基-頭份,2023-05-30,9296
3306,鼎天,4,0,4,凱基-頭份,2023-05-30,9296
3710,連展投控,4,0,4,凱基-頭份,2023-05-30,9296
4164,承業醫,4,0,4,凱基-頭份,2023-05-30,9296
5302,太欣,4,0,4,凱基-頭份,2023-05-30,9296
911868,同方友友-DR,100,0,100,凱基-頭份,2023-05-31,9296
2025,千興,70,0,70,凱基-頭份,2023-05-31,9296
3481,群創,52,2,50,凱基-頭份,2023-05-31,9296
912000,晨訊科-DR,100,50,50,凱基-頭份,2023-05-31,9296
6164,華興,40,0,40,凱基-頭份,2023-05-31,9296
8905,裕國,40,0,40,凱基-頭份,2023-05-31,9296
5876,上海商銀,42,3,39,凱基-頭份,2023-05-31,9296
9110,越南控-DR,30,0,30,凱基-頭份,2023-05-31,9296
00715L,期街口布蘭特正2,34,7,27,凱基-頭份,2023-05-31,9296
00882,中信中國高股息,24,0,24,凱基-頭份,2023-05-31,9296
2812,台中銀,21,0,21,凱基-頭份,2023-05-31,9296
00642U,期元大S＆P石油,15,0,15,凱基-頭份,2023-05-31,9296
2401,凌陽,15,0,15,凱基-頭份,2023-05-31,9296
6576,逸達,15,0,15,凱基-頭份,2023-05-31,9296
3011,今皓,15,1,14,凱基-頭份,2023-05-31,9296
1101,台泥,14,0,14,凱基-頭份,2023-05-31,9296
00712,復華富時不動產,11,0,11,凱基-頭份,2023-05-31,9296
1514,亞力,19,8,11,凱基-頭份,2023-05-31,9296
6591,動力-KY,13,2,11,凱基-頭份,2023-05-31,9296
4977,眾達-KY,11,0,11,凱基-頭份,2023-05-31,9296
00878,國泰永續高股息,27,17,10,凱基-頭份,2023-05-31,9296
00665L,富邦�琤肭磪囓�2,10,0,10,凱基-頭份,2023-05-31,9296
2317,鴻海,12,2,10,凱基-頭份,2023-05-31,9296
2392,正崴,10,0,10,凱基-頭份,2023-05-31,9296
4543,萬在,20,10,10,凱基-頭份,2023-05-31,9296
5351,鈺創,11,1,10,凱基-頭份,2023-05-31,9296
5864,致和證,20,10,10,凱基-頭份,2023-05-31,9296
8147,正淩,13,3,10,凱基-頭份,2023-05-31,9296
2480,敦陽科,10,0,10,凱基-頭份,2023-05-31,9296
2421,建準,11,2,9,凱基-頭份,2023-05-31,9296
2485,兆赫,9,0,9,凱基-頭份,2023-05-31,9296
6160,欣技,9,0,9,凱基-頭份,2023-05-31,9296
00674R,期元大S＆P黃金反1,8,0,8,凱基-頭份,2023-05-31,9296
2356,英業達,29,22,7,凱基-頭份,2023-05-31,9296
3169,亞信,8,1,7,凱基-頭份,2023-05-31,9296
3231,緯創,15,8,7,凱基-頭份,2023-05-31,9296
8940,新天地,7,0,7,凱基-頭份,2023-05-31,9296
2201,裕隆,8,2,6,凱基-頭份,2023-05-31,9296
2349,錸德,6,0,6,凱基-頭份,2023-05-31,9296
9924,福興,6,0,6,凱基-頭份,2023-05-31,9296
2344,華邦電,12,6,6,凱基-頭份,2023-05-31,9296
00679B,元大美債20年,5,0,5,凱基-頭份,2023-05-31,9296
1504,東元,10,5,5,凱基-頭份,2023-05-31,9296
1103,嘉泥,5,0,5,凱基-頭份,2023-05-31,9296
00795B,中信美國公債20年,5,0,5,凱基-頭份,2023-05-31,9296
1727,中華化,6,1,5,凱基-頭份,2023-05-31,9296
2204,中華,5,0,5,凱基-頭份,2023-05-31,9296
2606,裕民,5,0,5,凱基-頭份,2023-05-31,9296
2611,志信,6,1,5,凱基-頭份,2023-05-31,9296
2913,農林,5,0,5,凱基-頭份,2023-05-31,9296
2890,永豐金,54,10,44,凱基-頭份,2023-06-01,9296
3305,昇貿,44,0,44,凱基-頭份,2023-06-01,9296
00882,中信中國高股息,34,0,34,凱基-頭份,2023-06-01,9296
2515,中工,33,3,30,凱基-頭份,2023-06-01,9296
5880,合庫金,30,0,30,凱基-頭份,2023-06-01,9296
3481,群創,24,2,22,凱基-頭份,2023-06-01,9296
1721,三晃,25,5,20,凱基-頭份,2023-06-01,9296
6116,彩晶,20,0,20,凱基-頭份,2023-06-01,9296
2323,中環,20,1,19,凱基-頭份,2023-06-01,9296
2201,裕隆,22,5,17,凱基-頭份,2023-06-01,9296
2482,連宇,27,10,17,凱基-頭份,2023-06-01,9296
8930,青鋼,15,0,15,凱基-頭份,2023-06-01,9296
6122,擎邦,15,2,13,凱基-頭份,2023-06-01,9296
00878,國泰永續高股息,19,6,13,凱基-頭份,2023-06-01,9296
2352,佳世達,12,0,12,凱基-頭份,2023-06-01,9296
3706,神達,16,4,12,凱基-頭份,2023-06-01,9296
2457,飛宏,23,12,11,凱基-頭份,2023-06-01,9296
2489,瑞軒,12,1,11,凱基-頭份,2023-06-01,9296
2892,第一金,11,0,11,凱基-頭份,2023-06-01,9296
3252,海灣,11,0,11,凱基-頭份,2023-06-01,9296
00679B,元大美債20年,10,0,10,凱基-頭份,2023-06-01,9296
1444,力麗,10,0,10,凱基-頭份,2023-06-01,9296
00642U,期元大S＆P石油,10,0,10,凱基-頭份,2023-06-01,9296
00715L,期街口布蘭特正2,10,0,10,凱基-頭份,2023-06-01,9296
2702,華園,10,0,10,凱基-頭份,2023-06-01,9296
2888,新光金,10,0,10,凱基-頭份,2023-06-01,9296
6015,宏遠證,10,0,10,凱基-頭份,2023-06-01,9296
6229,研通,15,5,10,凱基-頭份,2023-06-01,9296
00720B,元大投資級公司債,9,0,9,凱基-頭份,2023-06-01,9296
2476,鉅祥,9,0,9,凱基-頭份,2023-06-01,9296
3029,零壹,11,2,9,凱基-頭份,2023-06-01,9296
4564,元翎,22,13,9,凱基-頭份,2023-06-01,9296
1525,江申,8,1,7,凱基-頭份,2023-06-01,9296
5258,虹堡,9,2,7,凱基-頭份,2023-06-01,9296
8210,勤誠,7,0,7,凱基-頭份,2023-06-01,9296
2303,聯電,6,0,6,凱基-頭份,2023-06-01,9296
5864,致和證,6,0,6,凱基-頭份,2023-06-01,9296
1762,中化生,6,0,6,凱基-頭份,2023-06-01,9296
1519,華城,5,0,5,凱基-頭份,2023-06-01,9296
1309,台達化,5,0,5,凱基-頭份,2023-06-01,9296
00919,群益台灣精選高息,5,0,5,凱基-頭份,2023-06-01,9296
00712,復華富時不動產,20,15,5,凱基-頭份,2023-06-01,9296
00687B,國泰20年美債,5,0,5,凱基-頭份,2023-06-01,9296
5706,鳳凰,15,10,5,凱基-頭份,2023-06-01,9296
6164,華興,5,0,5,凱基-頭份,2023-06-01,9296
9110,越南控-DR,5,0,5,凱基-頭份,2023-06-01,9296
9945,潤泰新,5,0,5,凱基-頭份,2023-06-01,9296
2881,富邦金,4,0,4,凱基-頭份,2023-06-01,9296
2356,英業達,10,6,4,凱基-頭份,2023-06-01,9296
3058,立德,5,1,4,凱基-頭份,2023-06-01,9296
912000,晨訊科-DR,100,0,100,凱基-頭份,2023-06-02,9296
9105,泰金寶-DR,93,0,93,凱基-頭份,2023-06-02,9296
00712,復華富時不動產,62,0,62,凱基-頭份,2023-06-02,9296
8277,商丞,37,0,37,凱基-頭份,2023-06-02,9296
00715L,期街口布蘭特正2,35,1,34,凱基-頭份,2023-06-02,9296
00632R,元大台灣50反1,87,59,28,凱基-頭份,2023-06-02,9296
00664R,國泰臺灣加權反1,25,0,25,凱基-頭份,2023-06-02,9296
2371,大同,23,0,23,凱基-頭份,2023-06-02,9296
4105,東洋,21,0,21,凱基-頭份,2023-06-02,9296
5302,太欣,20,0,20,凱基-頭份,2023-06-02,9296
1513,中興電,30,10,20,凱基-頭份,2023-06-02,9296
00919,群益台灣精選高息,20,0,20,凱基-頭份,2023-06-02,9296
1736,喬山,18,0,18,凱基-頭份,2023-06-02,9296
2515,中工,18,1,17,凱基-頭份,2023-06-02,9296
6523,達爾膚,15,0,15,凱基-頭份,2023-06-02,9296
6603,富強鑫,15,0,15,凱基-頭份,2023-06-02,9296
1904,正隆,43,29,14,凱基-頭份,2023-06-02,9296
3029,零壹,20,6,14,凱基-頭份,2023-06-02,9296
3015,全漢,12,0,12,凱基-頭份,2023-06-02,9296
3390,旭軟,12,0,12,凱基-頭份,2023-06-02,9296
1733,五鼎,11,0,11,凱基-頭份,2023-06-02,9296
1734,杏輝,12,1,11,凱基-頭份,2023-06-02,9296
2812,台中銀,13,2,11,凱基-頭份,2023-06-02,9296
3628,盈正,11,0,11,凱基-頭份,2023-06-02,9296
4523,永彰,12,1,11,凱基-頭份,2023-06-02,9296
6168,宏齊,11,0,11,凱基-頭份,2023-06-02,9296
00898,國泰基因免疫革命,10,0,10,凱基-頭份,2023-06-02,9296
1905,華紙,14,4,10,凱基-頭份,2023-06-02,9296
2426,鼎元,10,0,10,凱基-頭份,2023-06-02,9296
2706,第一店,10,0,10,凱基-頭份,2023-06-02,9296
3047,訊舟,10,0,10,凱基-頭份,2023-06-02,9296
3231,緯創,59,49,10,凱基-頭份,2023-06-02,9296
3680,家登,14,4,10,凱基-頭份,2023-06-02,9296
5469,瀚宇博,10,0,10,凱基-頭份,2023-06-02,9296
8059,凱碩,10,0,10,凱基-頭份,2023-06-02,9296
1504,東元,40,31,9,凱基-頭份,2023-06-02,9296
00882,中信中國高股息,9,0,9,凱基-頭份,2023-06-02,9296
2460,建通,9,0,9,凱基-頭份,2023-06-02,9296
8111,立��,9,0,9,凱基-頭份,2023-06-02,9296
00679B,元大美債20年,8,0,8,凱基-頭份,2023-06-02,9296
2476,鉅祥,8,0,8,凱基-頭份,2023-06-02,9296
3481,群創,16,8,8,凱基-頭份,2023-06-02,9296
2352,佳世達,7,0,7,凱基-頭份,2023-06-02,9296
2332,友訊,12,5,7,凱基-頭份,2023-06-02,9296
2855,統一證,7,0,7,凱基-頭份,2023-06-02,9296
4147,中裕,7,0,7,凱基-頭份,2023-06-02,9296
2201,裕隆,8,2,6,凱基-頭份,2023-06-02,9296
2331,精英,7,1,6,凱基-頭份,2023-06-02,9296
2486,一詮,7,1,6,凱基-頭份,2023-06-02,9296
2734,易飛網,6,0,6,凱基-頭份,2023-06-02,9296
2618,長榮航,112,3,109,凱基-頭份,2023-06-05,9296
2025,千興,100,0,100,凱基-頭份,2023-06-05,9296
911608,明輝-DR,100,0,100,凱基-頭份,2023-06-05,9296
2867,三商壽,60,21,39,凱基-頭份,2023-06-05,9296
3481,群創,99,63,36,凱基-頭份,2023-06-05,9296
00919,群益台灣精選高息,33,0,33,凱基-頭份,2023-06-05,9296
2009,第一銅,57,24,33,凱基-頭份,2023-06-05,9296
00632R,元大台灣50反1,40,10,30,凱基-頭份,2023-06-05,9296
00673R,期元大S＆P原油反1,21,0,21,凱基-頭份,2023-06-05,9296
2515,中工,33,12,21,凱基-頭份,2023-06-05,9296
00770,國泰北美科技,21,1,20,凱基-頭份,2023-06-05,9296
6005,群益證,20,0,20,凱基-頭份,2023-06-05,9296
4714,永捷,20,2,18,凱基-頭份,2023-06-05,9296
2206,三陽工業,20,3,17,凱基-頭份,2023-06-05,9296
6523,達爾膚,15,0,15,凱基-頭份,2023-06-05,9296
6188,廣明,15,0,15,凱基-頭份,2023-06-05,9296
6153,嘉聯益,14,0,14,凱基-頭份,2023-06-05,9296
00878,國泰永續高股息,17,4,13,凱基-頭份,2023-06-05,9296
2337,旺宏,11,0,11,凱基-頭份,2023-06-05,9296
00679B,元大美債20年,11,0,11,凱基-頭份,2023-06-05,9296
2812,台中銀,11,0,11,凱基-頭份,2023-06-05,9296
1101,台泥,12,2,10,凱基-頭份,2023-06-05,9296
1907,永豐餘,12,2,10,凱基-頭份,2023-06-05,9296
2605,新興,10,0,10,凱基-頭份,2023-06-05,9296
2913,農林,10,0,10,凱基-頭份,2023-06-05,9296
4916,事欣科,15,5,10,凱基-頭份,2023-06-05,9296
5703,亞都,10,0,10,凱基-頭份,2023-06-05,9296
6220,岳豐,10,0,10,凱基-頭份,2023-06-05,9296
6265,方土昶,10,0,10,凱基-頭份,2023-06-05,9296
2486,一詮,30,21,9,凱基-頭份,2023-06-05,9296
2609,陽明,15,6,9,凱基-頭份,2023-06-05,9296
00882,中信中國高股息,10,1,9,凱基-頭份,2023-06-05,9296
00772B,中信高評級公司債,8,0,8,凱基-頭份,2023-06-05,9296
00795B,中信美國公債20年,8,0,8,凱基-頭份,2023-06-05,9296
1609,大亞,21,13,8,凱基-頭份,2023-06-05,9296
2014,中鴻,29,21,8,凱基-頭份,2023-06-05,9296
3594,磐儀,8,0,8,凱基-頭份,2023-06-05,9296
3706,神達,8,0,8,凱基-頭份,2023-06-05,9296
2634,漢翔,9,1,8,凱基-頭份,2023-06-05,9296
8222,寶一,9,1,8,凱基-頭份,2023-06-05,9296
00712,復華富時不動產,7,0,7,凱基-頭份,2023-06-05,9296
1605,華新,7,0,7,凱基-頭份,2023-06-05,9296
1608,華榮,8,1,7,凱基-頭份,2023-06-05,9296
1905,華紙,13,6,7,凱基-頭份,2023-06-05,9296
6198,瑞築,7,0,7,凱基-頭份,2023-06-05,9296
1733,五鼎,7,1,6,凱基-頭份,2023-06-05,9296
3058,立德,6,0,6,凱基-頭份,2023-06-05,9296
6218,豪勉,11,5,6,凱基-頭份,2023-06-05,9296
8277,商丞,15,9,6,凱基-頭份,2023-06-05,9296
0056,元大高股息,10,4,6,凱基-頭份,2023-06-05,9296
2025,千興,75,0,75,凱基-頭份,2023-06-06,9296
2891,中信金,50,1,49,凱基-頭份,2023-06-06,9296
00632R,元大台灣50反1,43,0,43,凱基-頭份,2023-06-06,9296
6125,廣運,40,6,34,凱基-頭份,2023-06-06,9296
3707,漢磊,32,0,32,凱基-頭份,2023-06-06,9296
2888,新光金,30,3,27,凱基-頭份,2023-06-06,9296
1312,國喬,23,0,23,凱基-頭份,2023-06-06,9296
1528,恩德,21,0,21,凱基-頭份,2023-06-06,9296
5009,榮剛,24,3,21,凱基-頭份,2023-06-06,9296
00673R,期元大S＆P原油反1,16,0,16,凱基-頭份,2023-06-06,9296
00923,群益台ESG低碳50,15,0,15,凱基-頭份,2023-06-06,9296
00919,群益台灣精選高息,15,0,15,凱基-頭份,2023-06-06,9296
00712,復華富時不動產,14,0,14,凱基-頭份,2023-06-06,9296
2402,毅嘉,27,13,14,凱基-頭份,2023-06-06,9296
6163,華電網,14,0,14,凱基-頭份,2023-06-06,9296
1905,華紙,19,6,13,凱基-頭份,2023-06-06,9296
1609,大亞,40,28,12,凱基-頭份,2023-06-06,9296
00924,復華S＆P500成長,15,3,12,凱基-頭份,2023-06-06,9296
2371,大同,11,0,11,凱基-頭份,2023-06-06,9296
00679B,元大美債20年,11,0,11,凱基-頭份,2023-06-06,9296
1608,華榮,14,4,10,凱基-頭份,2023-06-06,9296
2834,臺企銀,10,0,10,凱基-頭份,2023-06-06,9296
4105,東洋,10,0,10,凱基-頭份,2023-06-06,9296
6523,達爾膚,10,0,10,凱基-頭份,2023-06-06,9296
6282,康舒,17,7,10,凱基-頭份,2023-06-06,9296
2884,玉山金,14,5,9,凱基-頭份,2023-06-06,9296
2486,一詮,9,0,9,凱基-頭份,2023-06-06,9296
1444,力麗,8,0,8,凱基-頭份,2023-06-06,9296
00882,中信中國高股息,8,1,7,凱基-頭份,2023-06-06,9296
3231,緯創,11,4,7,凱基-頭份,2023-06-06,9296
3583,辛耘,8,1,7,凱基-頭份,2023-06-06,9296
5511,德昌,7,0,7,凱基-頭份,2023-06-06,9296
1319,東陽,6,0,6,凱基-頭份,2023-06-06,9296
1337,再生-KY,6,0,6,凱基-頭份,2023-06-06,9296
1605,華新,6,0,6,凱基-頭份,2023-06-06,9296
1762,中化生,6,0,6,凱基-頭份,2023-06-06,9296
2457,飛宏,15,9,6,凱基-頭份,2023-06-06,9296
3438,類比科,6,0,6,凱基-頭份,2023-06-06,9296
6112,邁達特,6,0,6,凱基-頭份,2023-06-06,9296
00713,元大台灣高息低波,6,0,6,凱基-頭份,2023-06-06,9296
1734,杏輝,5,0,5,凱基-頭份,2023-06-06,9296
1810,和成,5,0,5,凱基-頭份,2023-06-06,9296
2017,官田鋼,15,10,5,凱基-頭份,2023-06-06,9296
2431,聯昌,5,0,5,凱基-頭份,2023-06-06,9296
2439,美律,5,0,5,凱基-頭份,2023-06-06,9296
2453,凌群,5,0,5,凱基-頭份,2023-06-06,9296
2882,國泰金,5,0,5,凱基-頭份,2023-06-06,9296
3515,華擎,5,0,5,凱基-頭份,2023-06-06,9296
4114,健喬,5,0,5,凱基-頭份,2023-06-06,9296
4147,中裕,5,0,5,凱基-頭份,2023-06-06,9296
3704,合勤控,98,0,98,凱基-頭份,2023-06-07,9296
1312,國喬,73,0,73,凱基-頭份,2023-06-07,9296
00712,復華富時不動產,52,0,52,凱基-頭份,2023-06-07,9296
5443,均豪,44,1,43,凱基-頭份,2023-06-07,9296
2371,大同,50,10,40,凱基-頭份,2023-06-07,9296
2515,中工,31,1,30,凱基-頭份,2023-06-07,9296
5864,致和證,31,1,30,凱基-頭份,2023-06-07,9296
6603,富強鑫,30,0,30,凱基-頭份,2023-06-07,9296
00632R,元大台灣50反1,43,22,21,凱基-頭份,2023-06-07,9296
1471,首利,22,2,20,凱基-頭份,2023-06-07,9296
2349,錸德,20,0,20,凱基-頭份,2023-06-07,9296
5511,德昌,21,1,20,凱基-頭份,2023-06-07,9296
00675L,富邦臺灣加權正2,16,0,16,凱基-頭份,2023-06-07,9296
5701,劍湖山,16,0,16,凱基-頭份,2023-06-07,9296
00927,群益半導體收益,13,0,13,凱基-頭份,2023-06-07,9296
2402,毅嘉,15,2,13,凱基-頭份,2023-06-07,9296
2314,台揚,12,0,12,凱基-頭份,2023-06-07,9296
1710,東聯,13,2,11,凱基-頭份,2023-06-07,9296
2610,華航,13,2,11,凱基-頭份,2023-06-07,9296
00915,凱基優選高股息30,10,0,10,凱基-頭份,2023-06-07,9296
1802,台玻,10,0,10,凱基-頭份,2023-06-07,9296
2103,台橡,10,0,10,凱基-頭份,2023-06-07,9296
3038,全台,10,0,10,凱基-頭份,2023-06-07,9296
4960,誠美材,10,0,10,凱基-頭份,2023-06-07,9296
3071,協禧,10,1,9,凱基-頭份,2023-06-07,9296
4161,聿新科,9,0,9,凱基-頭份,2023-06-07,9296
4977,眾達-KY,10,1,9,凱基-頭份,2023-06-07,9296
8038,長園科,9,0,9,凱基-頭份,2023-06-07,9296
1504,東元,18,9,9,凱基-頭份,2023-06-07,9296
00795B,中信美國公債20年,8,0,8,凱基-頭份,2023-06-07,9296
2331,精英,13,5,8,凱基-頭份,2023-06-07,9296
3058,立德,13,5,8,凱基-頭份,2023-06-07,9296
6270,倍微,8,0,8,凱基-頭份,2023-06-07,9296
8110,華東,8,0,8,凱基-頭份,2023-06-07,9296
2323,中環,12,5,7,凱基-頭份,2023-06-07,9296
2401,凌陽,7,0,7,凱基-頭份,2023-06-07,9296
2889,國票金,7,0,7,凱基-頭份,2023-06-07,9296
00679B,元大美債20年,6,0,6,凱基-頭份,2023-06-07,9296
2748,雲品,10,4,6,凱基-頭份,2023-06-07,9296
5324,士開,6,0,6,凱基-頭份,2023-06-07,9296
6198,瑞築,6,0,6,凱基-頭份,2023-06-07,9296
00687B,國泰20年美債,5,0,5,凱基-頭份,2023-06-07,9296
00919,群益台灣精選高息,5,0,5,凱基-頭份,2023-06-07,9296
00924,復華S＆P500成長,5,0,5,凱基-頭份,2023-06-07,9296
1459,聯發,5,0,5,凱基-頭份,2023-06-07,9296
1762,中化生,5,0,5,凱基-頭份,2023-06-07,9296
2332,友訊,5,0,5,凱基-頭份,2023-06-07,9296
2337,旺宏,5,0,5,凱基-頭份,2023-06-07,9296
2358,廷鑫,5,0,5,凱基-頭份,2023-06-07,9296
2486,一詮,5,0,5,凱基-頭份,2023-06-07,9296
912000,晨訊科-DR,150,0,150,凱基-頭份,2023-06-08,9296
2344,華邦電,41,5,36,凱基-頭份,2023-06-08,9296
00919,群益台灣精選高息,34,0,34,凱基-頭份,2023-06-08,9296
3704,合勤控,31,0,31,凱基-頭份,2023-06-08,9296
4168,醣聯,31,0,31,凱基-頭份,2023-06-08,9296
6570,維田,30,0,30,凱基-頭份,2023-06-08,9296
6122,擎邦,34,9,25,凱基-頭份,2023-06-08,9296
2515,中工,24,0,24,凱基-頭份,2023-06-08,9296
00878,國泰永續高股息,27,4,23,凱基-頭份,2023-06-08,9296
00712,復華富時不動產,22,0,22,凱基-頭份,2023-06-08,9296
6188,廣明,19,0,19,凱基-頭份,2023-06-08,9296
2834,臺企銀,20,1,19,凱基-頭份,2023-06-08,9296
4726,永昕,50,32,18,凱基-頭份,2023-06-08,9296
6005,群益證,21,3,18,凱基-頭份,2023-06-08,9296
00720B,元大投資級公司債,16,0,16,凱基-頭份,2023-06-08,9296
00673R,期元大S＆P原油反1,15,0,15,凱基-頭份,2023-06-08,9296
00893,國泰智能電動車,15,0,15,凱基-頭份,2023-06-08,9296
5864,致和證,15,0,15,凱基-頭份,2023-06-08,9296
2323,中環,15,2,13,凱基-頭份,2023-06-08,9296
5302,太欣,15,2,13,凱基-頭份,2023-06-08,9296
6116,彩晶,12,0,12,凱基-頭份,2023-06-08,9296
6573,虹揚-KY,12,0,12,凱基-頭份,2023-06-08,9296
00927,群益半導體收益,10,0,10,凱基-頭份,2023-06-08,9296
1337,再生-KY,10,0,10,凱基-頭份,2023-06-08,9296
1708,東鹼,10,0,10,凱基-頭份,2023-06-08,9296
1802,台玻,10,0,10,凱基-頭份,2023-06-08,9296
2201,裕隆,10,0,10,凱基-頭份,2023-06-08,9296
2356,英業達,10,0,10,凱基-頭份,2023-06-08,9296
2367,燿華,10,0,10,凱基-頭份,2023-06-08,9296
6218,豪勉,10,0,10,凱基-頭份,2023-06-08,9296
1609,大亞,27,17,10,凱基-頭份,2023-06-08,9296
00679B,元大美債20年,10,1,9,凱基-頭份,2023-06-08,9296
00772B,中信高評級公司債,11,2,9,凱基-頭份,2023-06-08,9296
1752,南光,9,0,9,凱基-頭份,2023-06-08,9296
2388,威盛,14,5,9,凱基-頭份,2023-06-08,9296
4527,方土霖,9,0,9,凱基-頭份,2023-06-08,9296
1459,聯發,8,0,8,凱基-頭份,2023-06-08,9296
1528,恩德,11,3,8,凱基-頭份,2023-06-08,9296
2002,中鋼,8,0,8,凱基-頭份,2023-06-08,9296
4960,誠美材,8,0,8,凱基-頭份,2023-06-08,9296
00680L,元大美債20正2,7,0,7,凱基-頭份,2023-06-08,9296
00795B,中信美國公債20年,7,0,7,凱基-頭份,2023-06-08,9296
2908,特力,7,0,7,凱基-頭份,2023-06-08,9296
5512,力麒,10,3,7,凱基-頭份,2023-06-08,9296
6213,聯茂,7,0,7,凱基-頭份,2023-06-08,9296
00751B,元大AAA至A公司債,6,0,6,凱基-頭份,2023-06-08,9296
3419,譁裕,6,0,6,凱基-頭份,2023-06-08,9296
3511,矽瑪,8,2,6,凱基-頭份,2023-06-08,9296
4911,德英,6,0,6,凱基-頭份,2023-06-08,9296
2888,新光金,6,0,6,凱基-頭份,2023-06-08,9296
00919,群益台灣精選高息,41,0,41,凱基-頭份,2023-06-09,9296
2401,凌陽,30,0,30,凱基-頭份,2023-06-09,9296
6139,亞翔,50,20,30,凱基-頭份,2023-06-09,9296
6603,富強鑫,30,0,30,凱基-頭份,2023-06-09,9296
8937,合騏,30,0,30,凱基-頭份,2023-06-09,9296
2356,英業達,50,26,24,凱基-頭份,2023-06-09,9296
2353,宏��,45,22,23,凱基-頭份,2023-06-09,9296
00929,復華台灣科技優息,36,15,21,凱基-頭份,2023-06-09,9296
00639,富邦深100,20,0,20,凱基-頭份,2023-06-09,9296
00712,復華富時不動產,21,2,19,凱基-頭份,2023-06-09,9296
00642U,期元大S＆P石油,17,0,17,凱基-頭份,2023-06-09,9296
2888,新光金,17,1,16,凱基-頭份,2023-06-09,9296
4161,聿新科,19,4,15,凱基-頭份,2023-06-09,9296
3481,群創,16,2,14,凱基-頭份,2023-06-09,9296
00895,富邦未來車,15,2,13,凱基-頭份,2023-06-09,9296
1525,江申,13,0,13,凱基-頭份,2023-06-09,9296
00898,國泰基因免疫革命,10,0,10,凱基-頭份,2023-06-09,9296
1218,泰山,10,0,10,凱基-頭份,2023-06-09,9296
1810,和成,10,0,10,凱基-頭份,2023-06-09,9296
6570,維田,10,0,10,凱基-頭份,2023-06-09,9296
2634,漢翔,13,4,9,凱基-頭份,2023-06-09,9296
2706,第一店,9,0,9,凱基-頭份,2023-06-09,9296
3071,協禧,10,1,9,凱基-頭份,2023-06-09,9296
6218,豪勉,14,5,9,凱基-頭份,2023-06-09,9296
2206,三陽工業,21,13,8,凱基-頭份,2023-06-09,9296
2880,華南金,8,0,8,凱基-頭份,2023-06-09,9296
5511,德昌,8,0,8,凱基-頭份,2023-06-09,9296
1802,台玻,7,0,7,凱基-頭份,2023-06-09,9296
2352,佳世達,11,4,7,凱基-頭份,2023-06-09,9296
2515,中工,22,15,7,凱基-頭份,2023-06-09,9296
2908,特力,7,0,7,凱基-頭份,2023-06-09,9296
3252,海灣,7,0,7,凱基-頭份,2023-06-09,9296
3511,矽瑪,7,0,7,凱基-頭份,2023-06-09,9296
2382,廣達,29,23,6,凱基-頭份,2023-06-09,9296
1337,再生-KY,14,8,6,凱基-頭份,2023-06-09,9296
1603,華電,6,0,6,凱基-頭份,2023-06-09,9296
1612,宏泰,6,0,6,凱基-頭份,2023-06-09,9296
3038,全台,6,0,6,凱基-頭份,2023-06-09,9296
6270,倍微,6,0,6,凱基-頭份,2023-06-09,9296
8112,至上,6,0,6,凱基-頭份,2023-06-09,9296
00679B,元大美債20年,5,0,5,凱基-頭份,2023-06-09,9296
6532,瑞耘,5,0,5,凱基-頭份,2023-06-09,9296
00637L,元大滬深300正2,6,1,5,凱基-頭份,2023-06-09,9296
2431,聯昌,5,0,5,凱基-頭份,2023-06-09,9296
4934,太極,5,0,5,凱基-頭份,2023-06-09,9296
00715L,期街口布蘭特正2,4,0,4,凱基-頭份,2023-06-09,9296
1519,華城,5,1,4,凱基-頭份,2023-06-09,9296
2337,旺宏,4,0,4,凱基-頭份,2023-06-09,9296
2457,飛宏,5,1,4,凱基-頭份,2023-06-09,9296
2610,華航,7,3,4,凱基-頭份,2023-06-09,9296
4804,大略-KY,38,0,38,凱基-頭份,2023-06-12,9296
00882,中信中國高股息,36,0,36,凱基-頭份,2023-06-12,9296
2515,中工,31,1,30,凱基-頭份,2023-06-12,9296
00915,凱基優選高股息30,27,0,27,凱基-頭份,2023-06-12,9296
3491,昇達科,26,0,26,凱基-頭份,2023-06-12,9296
00712,復華富時不動產,26,0,26,凱基-頭份,2023-06-12,9296
4543,萬在,25,0,25,凱基-頭份,2023-06-12,9296
6603,富強鑫,24,0,24,凱基-頭份,2023-06-12,9296
2401,凌陽,23,0,23,凱基-頭份,2023-06-12,9296
8937,合騏,23,0,23,凱基-頭份,2023-06-12,9296
00919,群益台灣精選高息,19,0,19,凱基-頭份,2023-06-12,9296
3231,緯創,23,5,18,凱基-頭份,2023-06-12,9296
00929,復華台灣科技優息,17,0,17,凱基-頭份,2023-06-12,9296
00900,富邦特選高股息30,15,0,15,凱基-頭份,2023-06-12,9296
2323,中環,20,5,15,凱基-頭份,2023-06-12,9296
00878,國泰永續高股息,49,34,15,凱基-頭份,2023-06-12,9296
2408,南亞科,15,1,14,凱基-頭份,2023-06-12,9296
3346,麗清,12,0,12,凱基-頭份,2023-06-12,9296
3481,群創,15,3,12,凱基-頭份,2023-06-12,9296
2633,台灣高鐵,12,0,12,凱基-頭份,2023-06-12,9296
00715L,期街口布蘭特正2,11,0,11,凱基-頭份,2023-06-12,9296
00642U,期元大S＆P石油,11,0,11,凱基-頭份,2023-06-12,9296
2352,佳世達,11,0,11,凱基-頭份,2023-06-12,9296
00671R,富邦NASDAQ反1,10,0,10,凱基-頭份,2023-06-12,9296
1810,和成,10,0,10,凱基-頭份,2023-06-12,9296
2734,易飛網,10,0,10,凱基-頭份,2023-06-12,9296
3059,華晶科,10,0,10,凱基-頭份,2023-06-12,9296
3704,合勤控,10,0,10,凱基-頭份,2023-06-12,9296
6116,彩晶,10,0,10,凱基-頭份,2023-06-12,9296
6266,泰詠,10,0,10,凱基-頭份,2023-06-12,9296
8277,商丞,10,0,10,凱基-頭份,2023-06-12,9296
00639,富邦深100,8,0,8,凱基-頭份,2023-06-12,9296
3202,樺晟,11,3,8,凱基-頭份,2023-06-12,9296
8222,寶一,10,2,8,凱基-頭份,2023-06-12,9296
1762,中化生,7,0,7,凱基-頭份,2023-06-12,9296
3374,精材,12,6,6,凱基-頭份,2023-06-12,9296
1789,神隆,6,0,6,凱基-頭份,2023-06-12,9296
1802,台玻,6,0,6,凱基-頭份,2023-06-12,9296
2890,永豐金,6,0,6,凱基-頭份,2023-06-12,9296
3583,辛耘,7,1,6,凱基-頭份,2023-06-12,9296
4161,聿新科,6,0,6,凱基-頭份,2023-06-12,9296
5351,鈺創,7,1,6,凱基-頭份,2023-06-12,9296
8038,長園科,7,1,6,凱基-頭份,2023-06-12,9296
2618,長榮航,29,23,6,凱基-頭份,2023-06-12,9296
00679B,元大美債20年,5,0,5,凱基-頭份,2023-06-12,9296
2377,微星,6,1,5,凱基-頭份,2023-06-12,9296
00773B,中信優先金融債,5,0,5,凱基-頭份,2023-06-12,9296
1584,精剛,5,0,5,凱基-頭份,2023-06-12,9296
1809,中釉,5,0,5,凱基-頭份,2023-06-12,9296
3056,富華新,5,0,5,凱基-頭份,2023-06-12,9296
00715L,期街口布蘭特正2,73,0,73,凱基-頭份,2023-06-13,9296
00712,復華富時不動產,66,2,64,凱基-頭份,2023-06-13,9296
00632R,元大台灣50反1,60,3,57,凱基-頭份,2023-06-13,9296
3710,連展投控,50,0,50,凱基-頭份,2023-06-13,9296
911622,泰聚亨-DR,40,0,40,凱基-頭份,2023-06-13,9296
2401,凌陽,30,0,30,凱基-頭份,2023-06-13,9296
1524,耿鼎,30,1,29,凱基-頭份,2023-06-13,9296
00642U,期元大S＆P石油,29,1,28,凱基-頭份,2023-06-13,9296
2488,漢平,25,0,25,凱基-頭份,2023-06-13,9296
1568,倉佑,20,0,20,凱基-頭份,2023-06-13,9296
5443,均豪,20,0,20,凱基-頭份,2023-06-13,9296
6264,富裔,20,0,20,凱基-頭份,2023-06-13,9296
3652,精聯,17,4,13,凱基-頭份,2023-06-13,9296
00895,富邦未來車,12,0,12,凱基-頭份,2023-06-13,9296
1522,堤維西,20,8,12,凱基-頭份,2023-06-13,9296
2443,昶虹,11,0,11,凱基-頭份,2023-06-13,9296
3704,合勤控,11,0,11,凱基-頭份,2023-06-13,9296
1540,喬福,10,0,10,凱基-頭份,2023-06-13,9296
3029,零壹,10,0,10,凱基-頭份,2023-06-13,9296
5371,中光電,10,0,10,凱基-頭份,2023-06-13,9296
6140,訊達,9,0,9,凱基-頭份,2023-06-13,9296
2352,佳世達,13,4,9,凱基-頭份,2023-06-13,9296
2618,長榮航,31,23,8,凱基-頭份,2023-06-13,9296
2457,飛宏,8,1,7,凱基-頭份,2023-06-13,9296
2705,六福,7,0,7,凱基-頭份,2023-06-13,9296
4977,眾達-KY,7,0,7,凱基-頭份,2023-06-13,9296
6288,聯嘉,10,3,7,凱基-頭份,2023-06-13,9296
8905,裕國,7,0,7,凱基-頭份,2023-06-13,9296
4961,天鈺,6,0,6,凱基-頭份,2023-06-13,9296
1760,寶齡富錦,6,0,6,凱基-頭份,2023-06-13,9296
2739,寒舍,6,0,6,凱基-頭份,2023-06-13,9296
3515,華擎,6,0,6,凱基-頭份,2023-06-13,9296
4108,懷特,6,0,6,凱基-頭份,2023-06-13,9296
5701,劍湖山,6,0,6,凱基-頭份,2023-06-13,9296
6668,中揚光,6,0,6,凱基-頭份,2023-06-13,9296
2883,凱基金,8,3,5,凱基-頭份,2023-06-13,9296
2483,百容,5,0,5,凱基-頭份,2023-06-13,9296
2495,普安,5,0,5,凱基-頭份,2023-06-13,9296
00885,富邦越南,4,0,4,凱基-頭份,2023-06-13,9296
2305,全友,5,1,4,凱基-頭份,2023-06-13,9296
2486,一詮,4,0,4,凱基-頭份,2023-06-13,9296
2882,國泰金,4,0,4,凱基-頭份,2023-06-13,9296
3346,麗清,4,0,4,凱基-頭份,2023-06-13,9296
3380,明泰,4,0,4,凱基-頭份,2023-06-13,9296
4551,智伸科,4,0,4,凱基-頭份,2023-06-13,9296
5309,系統電,4,0,4,凱基-頭份,2023-06-13,9296
2436,偉詮電,4,0,4,凱基-頭份,2023-06-13,9296
00679B,元大美債20年,3,0,3,凱基-頭份,2023-06-13,9296
00764B,群益25年美債,3,0,3,凱基-頭份,2023-06-13,9296
1471,首利,5,2,3,凱基-頭份,2023-06-13,9296
3710,連展投控,88,0,88,凱基-頭份,2023-06-14,9296
2356,英業達,76,10,66,凱基-頭份,2023-06-14,9296
2025,千興,62,0,62,凱基-頭份,2023-06-14,9296
8050,廣積,55,4,51,凱基-頭份,2023-06-14,9296
1710,東聯,40,0,40,凱基-頭份,2023-06-14,9296
2363,矽統,30,0,30,凱基-頭份,2023-06-14,9296
6535,順藥,30,1,29,凱基-頭份,2023-06-14,9296
00919,群益台灣精選高息,28,0,28,凱基-頭份,2023-06-14,9296
2605,新興,25,0,25,凱基-頭份,2023-06-14,9296
00712,復華富時不動產,24,1,23,凱基-頭份,2023-06-14,9296
1529,樂事綠能,26,3,23,凱基-頭份,2023-06-14,9296
00885,富邦越南,20,0,20,凱基-頭份,2023-06-14,9296
4906,正文,19,0,19,凱基-頭份,2023-06-14,9296
2443,昶虹,28,11,17,凱基-頭份,2023-06-14,9296
00830,國泰費城半導體,15,0,15,凱基-頭份,2023-06-14,9296
2303,聯電,21,6,15,凱基-頭份,2023-06-14,9296
6770,力積電,20,9,11,凱基-頭份,2023-06-14,9296
00915,凱基優選高股息30,11,0,11,凱基-頭份,2023-06-14,9296
2705,六福,12,1,11,凱基-頭份,2023-06-14,9296
4161,聿新科,15,4,11,凱基-頭份,2023-06-14,9296
6122,擎邦,17,6,11,凱基-頭份,2023-06-14,9296
00895,富邦未來車,10,0,10,凱基-頭份,2023-06-14,9296
00650L,復華香港正2,10,0,10,凱基-頭份,2023-06-14,9296
4973,廣穎,10,0,10,凱基-頭份,2023-06-14,9296
00713,元大台灣高息低波,9,0,9,凱基-頭份,2023-06-14,9296
4919,新唐,10,1,9,凱基-頭份,2023-06-14,9296
5511,德昌,9,0,9,凱基-頭份,2023-06-14,9296
2609,陽明,64,55,9,凱基-頭份,2023-06-14,9296
00674R,期元大S＆P黃金反1,8,0,8,凱基-頭份,2023-06-14,9296
2412,中華電,8,0,8,凱基-頭份,2023-06-14,9296
6128,上福,8,0,8,凱基-頭份,2023-06-14,9296
8163,達方,8,0,8,凱基-頭份,2023-06-14,9296
00679B,元大美債20年,7,0,7,凱基-頭份,2023-06-14,9296
5306,桂盟,7,0,7,凱基-頭份,2023-06-14,9296
8028,昇陽半導體,7,0,7,凱基-頭份,2023-06-14,9296
8215,明基材,8,1,7,凱基-頭份,2023-06-14,9296
9933,中鼎,7,0,7,凱基-頭份,2023-06-14,9296
00857B,永豐20年美公債,6,0,6,凱基-頭份,2023-06-14,9296
4804,大略-KY,6,0,6,凱基-頭份,2023-06-14,9296
6148,驊宏資,6,0,6,凱基-頭份,2023-06-14,9296
6290,良維,6,0,6,凱基-頭份,2023-06-14,9296
1101,台泥,5,0,5,凱基-頭份,2023-06-14,9296
1471,首利,10,5,5,凱基-頭份,2023-06-14,9296
1541,錩泰,5,0,5,凱基-頭份,2023-06-14,9296
1802,台玻,5,0,5,凱基-頭份,2023-06-14,9296
2421,建準,5,0,5,凱基-頭份,2023-06-14,9296
2426,鼎元,5,0,5,凱基-頭份,2023-06-14,9296
2495,普安,5,0,5,凱基-頭份,2023-06-14,9296
2734,易飛網,5,0,5,凱基-頭份,2023-06-14,9296
3515,華擎,5,0,5,凱基-頭份,2023-06-14,9296
4804,大略-KY,70,0,70,凱基-頭份,2023-06-15,9296
2618,長榮航,172,128,44,凱基-頭份,2023-06-15,9296
00712,復華富時不動產,43,1,42,凱基-頭份,2023-06-15,9296
2332,友訊,53,12,41,凱基-頭份,2023-06-15,9296
2324,仁寶,40,0,40,凱基-頭份,2023-06-15,9296
3706,神達,68,28,40,凱基-頭份,2023-06-15,9296
00713,元大台灣高息低波,30,0,30,凱基-頭份,2023-06-15,9296
00882,中信中國高股息,28,0,28,凱基-頭份,2023-06-15,9296
2344,華邦電,32,4,28,凱基-頭份,2023-06-15,9296
1733,五鼎,28,4,24,凱基-頭份,2023-06-15,9296
6443,元晶,22,0,22,凱基-頭份,2023-06-15,9296
2888,新光金,21,0,21,凱基-頭份,2023-06-15,9296
00632R,元大台灣50反1,40,21,19,凱基-頭份,2023-06-15,9296
2014,中鴻,17,0,17,凱基-頭份,2023-06-15,9296
00926,凱基全球菁英55,15,0,15,凱基-頭份,2023-06-15,9296
1609,大亞,22,7,15,凱基-頭份,2023-06-15,9296
8076,伍豐,15,0,15,凱基-頭份,2023-06-15,9296
3013,晟銘電,15,2,13,凱基-頭份,2023-06-15,9296
00715L,期街口布蘭特正2,12,0,12,凱基-頭份,2023-06-15,9296
6282,康舒,21,10,11,凱基-頭份,2023-06-15,9296
8112,至上,10,0,10,凱基-頭份,2023-06-15,9296
00919,群益台灣精選高息,10,0,10,凱基-頭份,2023-06-15,9296
00641R,富邦日本反1,10,0,10,凱基-頭份,2023-06-15,9296
00674R,期元大S＆P黃金反1,10,0,10,凱基-頭份,2023-06-15,9296
00671R,富邦NASDAQ反1,10,0,10,凱基-頭份,2023-06-15,9296
00898,國泰基因免疫革命,10,0,10,凱基-頭份,2023-06-15,9296
1714,和桐,10,0,10,凱基-頭份,2023-06-15,9296
1806,冠軍,10,0,10,凱基-頭份,2023-06-15,9296
2349,錸德,10,0,10,凱基-頭份,2023-06-15,9296
2412,中華電,10,0,10,凱基-頭份,2023-06-15,9296
3287,廣寰科,10,0,10,凱基-頭份,2023-06-15,9296
6218,豪勉,10,0,10,凱基-頭份,2023-06-15,9296
00929,復華台灣科技優息,12,4,8,凱基-頭份,2023-06-15,9296
00650L,復華香港正2,8,0,8,凱基-頭份,2023-06-15,9296
3346,麗清,11,3,8,凱基-頭份,2023-06-15,9296
8213,志超,8,0,8,凱基-頭份,2023-06-15,9296
00751B,元大AAA至A公司債,7,0,7,凱基-頭份,2023-06-15,9296
2331,精英,7,0,7,凱基-頭份,2023-06-15,9296
2630,亞航,13,6,7,凱基-頭份,2023-06-15,9296
2892,第一金,7,0,7,凱基-頭份,2023-06-15,9296
00679B,元大美債20年,6,0,6,凱基-頭份,2023-06-15,9296
4726,永昕,6,0,6,凱基-頭份,2023-06-15,9296
2382,廣達,13,8,5,凱基-頭份,2023-06-15,9296
00664R,國泰臺灣加權反1,5,0,5,凱基-頭份,2023-06-15,9296
00680L,元大美債20正2,5,0,5,凱基-頭份,2023-06-15,9296
1218,泰山,5,0,5,凱基-頭份,2023-06-15,9296
1611,中電,5,0,5,凱基-頭份,2023-06-15,9296
1736,喬山,5,0,5,凱基-頭份,2023-06-15,9296
3163,波若威,6,1,5,凱基-頭份,2023-06-15,9296
6220,岳豐,5,0,5,凱基-頭份,2023-06-15,9296
2014,中鴻,122,17,105,凱基-頭份,2023-06-16,9296
00712,復華富時不動產,73,0,73,凱基-頭份,2023-06-16,9296
2401,凌陽,94,34,60,凱基-頭份,2023-06-16,9296
1605,華新,59,9,50,凱基-頭份,2023-06-16,9296
00929,復華台灣科技優息,46,1,45,凱基-頭份,2023-06-16,9296
1802,台玻,64,25,39,凱基-頭份,2023-06-16,9296
2801,彰銀,35,0,35,凱基-頭份,2023-06-16,9296
2834,臺企銀,43,10,33,凱基-頭份,2023-06-16,9296
00882,中信中國高股息,34,4,30,凱基-頭份,2023-06-16,9296
2888,新光金,28,3,25,凱基-頭份,2023-06-16,9296
2609,陽明,84,62,22,凱基-頭份,2023-06-16,9296
1522,堤維西,24,4,20,凱基-頭份,2023-06-16,9296
1609,大亞,44,28,16,凱基-頭份,2023-06-16,9296
2303,聯電,20,5,15,凱基-頭份,2023-06-16,9296
2489,瑞軒,15,0,15,凱基-頭份,2023-06-16,9296
2388,威盛,13,0,13,凱基-頭份,2023-06-16,9296
6443,元晶,13,0,13,凱基-頭份,2023-06-16,9296
6147,頎邦,12,0,12,凱基-頭份,2023-06-16,9296
6282,康舒,12,1,11,凱基-頭份,2023-06-16,9296
00673R,期元大S＆P原油反1,10,0,10,凱基-頭份,2023-06-16,9296
3049,精金,10,0,10,凱基-頭份,2023-06-16,9296
3543,州巧,10,0,10,凱基-頭份,2023-06-16,9296
3576,聯合再生,10,0,10,凱基-頭份,2023-06-16,9296
5009,榮剛,10,0,10,凱基-頭份,2023-06-16,9296
6140,訊達,10,0,10,凱基-頭份,2023-06-16,9296
8011,台通,10,0,10,凱基-頭份,2023-06-16,9296
8043,蜜望實,10,0,10,凱基-頭份,2023-06-16,9296
9907,統一實,9,0,9,凱基-頭份,2023-06-16,9296
2450,神腦,9,0,9,凱基-頭份,2023-06-16,9296
3356,奇偶,9,0,9,凱基-頭份,2023-06-16,9296
5426,振發,10,1,9,凱基-頭份,2023-06-16,9296
3706,神達,34,25,9,凱基-頭份,2023-06-16,9296
2023,燁輝,10,2,8,凱基-頭份,2023-06-16,9296
2359,所羅門,26,18,8,凱基-頭份,2023-06-16,9296
00919,群益台灣精選高息,17,10,7,凱基-頭份,2023-06-16,9296
2106,建大,7,0,7,凱基-頭份,2023-06-16,9296
2457,飛宏,8,1,7,凱基-頭份,2023-06-16,9296
3322,建舜電,7,0,7,凱基-頭份,2023-06-16,9296
3673,TPK-KY,8,1,7,凱基-頭份,2023-06-16,9296
8110,華東,7,0,7,凱基-頭份,2023-06-16,9296
8112,至上,7,0,7,凱基-頭份,2023-06-16,9296
8213,志超,7,0,7,凱基-頭份,2023-06-16,9296
2460,建通,7,1,6,凱基-頭份,2023-06-16,9296
8028,昇陽半導體,6,0,6,凱基-頭份,2023-06-16,9296
2356,英業達,18,12,6,凱基-頭份,2023-06-16,9296
00706L,期元大S＆P日圓正2,5,0,5,凱基-頭份,2023-06-16,9296
1471,首利,5,0,5,凱基-頭份,2023-06-16,9296
2006,東和鋼鐵,5,0,5,凱基-頭份,2023-06-16,9296
2049,上銀,10,5,5,凱基-頭份,2023-06-16,9296
2546,根基,5,0,5,凱基-頭份,2023-06-16,9296
00632R,元大台灣50反1,80,0,80,凱基-頭份,2023-06-19,9296
1528,恩德,62,2,60,凱基-頭份,2023-06-19,9296
2014,中鴻,57,0,57,凱基-頭份,2023-06-19,9296
1432,大魯閣,36,0,36,凱基-頭份,2023-06-19,9296
3704,合勤控,30,0,30,凱基-頭份,2023-06-19,9296
3380,明泰,30,3,27,凱基-頭份,2023-06-19,9296
00673R,期元大S＆P原油反1,25,0,25,凱基-頭份,2023-06-19,9296
1605,華新,25,2,23,凱基-頭份,2023-06-19,9296
2883,凱基金,21,0,21,凱基-頭份,2023-06-19,9296
1471,首利,20,0,20,凱基-頭份,2023-06-19,9296
4105,東洋,20,0,20,凱基-頭份,2023-06-19,9296
4804,大略-KY,20,0,20,凱基-頭份,2023-06-19,9296
1304,台聚,20,1,19,凱基-頭份,2023-06-19,9296
4541,晟田,23,5,18,凱基-頭份,2023-06-19,9296
4977,眾達-KY,18,0,18,凱基-頭份,2023-06-19,9296
2206,三陽工業,16,0,16,凱基-頭份,2023-06-19,9296
2344,華邦電,28,14,14,凱基-頭份,2023-06-19,9296
00650L,復華香港正2,13,0,13,凱基-頭份,2023-06-19,9296
1522,堤維西,13,0,13,凱基-頭份,2023-06-19,9296
1584,精剛,17,5,12,凱基-頭份,2023-06-19,9296
3213,茂訊,12,0,12,凱基-頭份,2023-06-19,9296
3434,哲固,12,0,12,凱基-頭份,2023-06-19,9296
4726,永昕,12,0,12,凱基-頭份,2023-06-19,9296
00712,復華富時不動產,10,0,10,凱基-頭份,2023-06-19,9296
00676R,富邦臺灣加權反1,10,0,10,凱基-頭份,2023-06-19,9296
00898,國泰基因免疫革命,10,0,10,凱基-頭份,2023-06-19,9296
00895,富邦未來車,10,0,10,凱基-頭份,2023-06-19,9296
2401,凌陽,15,5,10,凱基-頭份,2023-06-19,9296
3049,精金,13,3,10,凱基-頭份,2023-06-19,9296
8277,商丞,10,0,10,凱基-頭份,2023-06-19,9296
1802,台玻,12,3,9,凱基-頭份,2023-06-19,9296
6751,智聯服務,9,0,9,凱基-頭份,2023-06-19,9296
1504,東元,13,5,8,凱基-頭份,2023-06-19,9296
2421,建準,17,9,8,凱基-頭份,2023-06-19,9296
2610,華航,56,48,8,凱基-頭份,2023-06-19,9296
4123,晟德,8,0,8,凱基-頭份,2023-06-19,9296
8034,榮群,10,2,8,凱基-頭份,2023-06-19,9296
00772B,中信高評級公司債,8,0,8,凱基-頭份,2023-06-19,9296
1609,大亞,11,4,7,凱基-頭份,2023-06-19,9296
00893,國泰智能電動車,10,3,7,凱基-頭份,2023-06-19,9296
3287,廣寰科,7,0,7,凱基-頭份,2023-06-19,9296
00795B,中信美國公債20年,6,0,6,凱基-頭份,2023-06-19,9296
00764B,群益25年美債,6,0,6,凱基-頭份,2023-06-19,9296
2303,聯電,17,11,6,凱基-頭份,2023-06-19,9296
2892,第一金,6,0,6,凱基-頭份,2023-06-19,9296
5302,太欣,6,0,6,凱基-頭份,2023-06-19,9296
6114,久威,8,2,6,凱基-頭份,2023-06-19,9296
6877,鏵友益,6,0,6,凱基-頭份,2023-06-19,9296
1810,和成,10,5,5,凱基-頭份,2023-06-19,9296
2030,彰源,5,0,5,凱基-頭份,2023-06-19,9296
00632R,元大台灣50反1,137,5,132,凱基-頭份,2023-06-20,9296
00665L,富邦�琤肭磪囓�2,60,0,60,凱基-頭份,2023-06-20,9296
1103,嘉泥,56,4,52,凱基-頭份,2023-06-20,9296
1217,愛之味,40,0,40,凱基-頭份,2023-06-20,9296
2468,華經,36,6,30,凱基-頭份,2023-06-20,9296
2515,中工,25,1,24,凱基-頭份,2023-06-20,9296
2618,長榮航,31,9,22,凱基-頭份,2023-06-20,9296
8112,至上,20,0,20,凱基-頭份,2023-06-20,9296
00753L,中信中國50正2,20,1,19,凱基-頭份,2023-06-20,9296
3704,合勤控,20,1,19,凱基-頭份,2023-06-20,9296
2634,漢翔,38,20,18,凱基-頭份,2023-06-20,9296
8227,巨有科技,18,1,17,凱基-頭份,2023-06-20,9296
2337,旺宏,16,0,16,凱基-頭份,2023-06-20,9296
00882,中信中國高股息,15,0,15,凱基-頭份,2023-06-20,9296
1609,大亞,16,1,15,凱基-頭份,2023-06-20,9296
3015,全漢,12,0,12,凱基-頭份,2023-06-20,9296
3481,群創,363,351,12,凱基-頭份,2023-06-20,9296
00720B,元大投資級公司債,11,0,11,凱基-頭份,2023-06-20,9296
3380,明泰,11,0,11,凱基-頭份,2023-06-20,9296
2332,友訊,10,0,10,凱基-頭份,2023-06-20,9296
4909,新復興,10,0,10,凱基-頭份,2023-06-20,9296
6148,驊宏資,10,0,10,凱基-頭份,2023-06-20,9296
6218,豪勉,10,0,10,凱基-頭份,2023-06-20,9296
1605,華新,14,5,9,凱基-頭份,2023-06-20,9296
2421,建準,19,10,9,凱基-頭份,2023-06-20,9296
6282,康舒,13,4,9,凱基-頭份,2023-06-20,9296
1303,南亞,7,0,7,凱基-頭份,2023-06-20,9296
4108,懷特,7,0,7,凱基-頭份,2023-06-20,9296
5465,富驊,12,5,7,凱基-頭份,2023-06-20,9296
6112,邁達特,8,1,7,凱基-頭份,2023-06-20,9296
00751B,元大AAA至A公司債,6,0,6,凱基-頭份,2023-06-20,9296
1810,和成,6,0,6,凱基-頭份,2023-06-20,9296
2312,金寶,6,0,6,凱基-頭份,2023-06-20,9296
3024,憶聲,6,0,6,凱基-頭份,2023-06-20,9296
6147,頎邦,6,0,6,凱基-頭份,2023-06-20,9296
2357,華碩,5,0,5,凱基-頭份,2023-06-20,9296
1339,昭輝,5,0,5,凱基-頭份,2023-06-20,9296
1783,和康生,5,0,5,凱基-頭份,2023-06-20,9296
2609,陽明,13,8,5,凱基-頭份,2023-06-20,9296
2801,彰銀,5,0,5,凱基-頭份,2023-06-20,9296
4934,太極,5,0,5,凱基-頭份,2023-06-20,9296
5309,系統電,5,0,5,凱基-頭份,2023-06-20,9296
6443,元晶,15,10,5,凱基-頭份,2023-06-20,9296
6835,圓裕,5,0,5,凱基-頭份,2023-06-20,9296
1504,東元,14,9,5,凱基-頭份,2023-06-20,9296
00687B,國泰20年美債,5,1,4,凱基-頭份,2023-06-20,9296
1789,神隆,4,0,4,凱基-頭份,2023-06-20,9296
6220,岳豐,4,0,4,凱基-頭份,2023-06-20,9296
6266,泰詠,4,0,4,凱基-頭份,2023-06-20,9296
00713,元大台灣高息低波,4,0,4,凱基-頭份,2023-06-20,9296
2401,凌陽,81,1,80,凱基-頭份,2023-06-21,9296
00706L,期元大S＆P日圓正2,32,0,32,凱基-頭份,2023-06-21,9296
4934,太極,34,2,32,凱基-頭份,2023-06-21,9296
2890,永豐金,31,0,31,凱基-頭份,2023-06-21,9296
2323,中環,40,10,30,凱基-頭份,2023-06-21,9296
00919,群益台灣精選高息,22,0,22,凱基-頭份,2023-06-21,9296
4804,大略-KY,20,0,20,凱基-頭份,2023-06-21,9296
2356,英業達,41,25,16,凱基-頭份,2023-06-21,9296
1802,台玻,15,0,15,凱基-頭份,2023-06-21,9296
5483,中美晶,18,3,15,凱基-頭份,2023-06-21,9296
00929,復華台灣科技優息,12,0,12,凱基-頭份,2023-06-21,9296
00882,中信中國高股息,12,0,12,凱基-頭份,2023-06-21,9296
4977,眾達-KY,12,0,12,凱基-頭份,2023-06-21,9296
8112,至上,12,0,12,凱基-頭份,2023-06-21,9296
8227,巨有科技,12,0,12,凱基-頭份,2023-06-21,9296
2352,佳世達,11,0,11,凱基-頭份,2023-06-21,9296
1727,中華化,16,6,10,凱基-頭份,2023-06-21,9296
3581,博磊,11,1,10,凱基-頭份,2023-06-21,9296
6282,康舒,15,5,10,凱基-頭份,2023-06-21,9296
3033,威健,10,1,9,凱基-頭份,2023-06-21,9296
3078,僑威,12,3,9,凱基-頭份,2023-06-21,9296
2645,長榮航太,9,1,8,凱基-頭份,2023-06-21,9296
6120,達運,8,0,8,凱基-頭份,2023-06-21,9296
6290,良維,10,2,8,凱基-頭份,2023-06-21,9296
1605,華新,9,2,7,凱基-頭份,2023-06-21,9296
2736,富野,18,11,7,凱基-頭份,2023-06-21,9296
6877,鏵友益,7,0,7,凱基-頭份,2023-06-21,9296
2303,聯電,6,0,6,凱基-頭份,2023-06-21,9296
00679B,元大美債20年,6,0,6,凱基-頭份,2023-06-21,9296
1218,泰山,6,0,6,凱基-頭份,2023-06-21,9296
2337,旺宏,6,0,6,凱基-頭份,2023-06-21,9296
1319,東陽,5,0,5,凱基-頭份,2023-06-21,9296
00751B,元大AAA至A公司債,5,0,5,凱基-頭份,2023-06-21,9296
1612,宏泰,6,1,5,凱基-頭份,2023-06-21,9296
2206,三陽工業,5,0,5,凱基-頭份,2023-06-21,9296
2329,華泰,5,0,5,凱基-頭份,2023-06-21,9296
2421,建準,5,0,5,凱基-頭份,2023-06-21,9296
2706,第一店,7,2,5,凱基-頭份,2023-06-21,9296
3013,晟銘電,6,1,5,凱基-頭份,2023-06-21,9296
9907,統一實,5,0,5,凱基-頭份,2023-06-21,9296
6488,環球晶,4,0,4,凱基-頭份,2023-06-21,9296
00753L,中信中國50正2,4,0,4,凱基-頭份,2023-06-21,9296
1609,大亞,6,2,4,凱基-頭份,2023-06-21,9296
2606,裕民,4,0,4,凱基-頭份,2023-06-21,9296
2707,晶華,4,0,4,凱基-頭份,2023-06-21,9296
2834,臺企銀,4,0,4,凱基-頭份,2023-06-21,9296
3046,建��,6,2,4,凱基-頭份,2023-06-21,9296
3049,精金,18,14,4,凱基-頭份,2023-06-21,9296
3207,耀勝,5,1,4,凱基-頭份,2023-06-21,9296
3483,力致,9,5,4,凱基-頭份,2023-06-21,9296
2887,台新金,192,0,192,凱基-頭份,2023-06-26,9296
9105,泰金寶-DR,60,0,60,凱基-頭份,2023-06-26,9296
3380,明泰,57,0,57,凱基-頭份,2023-06-26,9296
3706,神達,56,8,48,凱基-頭份,2023-06-26,9296
3356,奇偶,31,1,30,凱基-頭份,2023-06-26,9296
2427,三商電,33,7,26,凱基-頭份,2023-06-26,9296
1905,華紙,46,22,24,凱基-頭份,2023-06-26,9296
2104,國際中橡,21,0,21,凱基-頭份,2023-06-26,9296
00642U,期元大S＆P石油,17,0,17,凱基-頭份,2023-06-26,9296
2412,中華電,17,0,17,凱基-頭份,2023-06-26,9296
00895,富邦未來車,15,0,15,凱基-頭份,2023-06-26,9296
3213,茂訊,28,13,15,凱基-頭份,2023-06-26,9296
3704,合勤控,15,0,15,凱基-頭份,2023-06-26,9296
8147,正淩,15,0,15,凱基-頭份,2023-06-26,9296
00882,中信中國高股息,16,2,14,凱基-頭份,2023-06-26,9296
00893,國泰智能電動車,15,2,13,凱基-頭份,2023-06-26,9296
6499,益安,12,0,12,凱基-頭份,2023-06-26,9296
1605,華新,11,0,11,凱基-頭份,2023-06-26,9296
2017,官田鋼,16,5,11,凱基-頭份,2023-06-26,9296
2801,彰銀,11,0,11,凱基-頭份,2023-06-26,9296
8358,金居,11,0,11,凱基-頭份,2023-06-26,9296
1319,東陽,10,0,10,凱基-頭份,2023-06-26,9296
2406,國碩,10,0,10,凱基-頭份,2023-06-26,9296
911622,泰聚亨-DR,20,10,10,凱基-頭份,2023-06-26,9296
3032,偉訓,10,1,9,凱基-頭份,2023-06-26,9296
2449,京元電子,13,4,9,凱基-頭份,2023-06-26,9296
2344,華邦電,13,4,9,凱基-頭份,2023-06-26,9296
5306,桂盟,8,0,8,凱基-頭份,2023-06-26,9296
00929,復華台灣科技優息,8,0,8,凱基-頭份,2023-06-26,9296
2201,裕隆,7,0,7,凱基-頭份,2023-06-26,9296
00715L,期街口布蘭特正2,7,0,7,凱基-頭份,2023-06-26,9296
1337,再生-KY,7,0,7,凱基-頭份,2023-06-26,9296
1802,台玻,7,0,7,凱基-頭份,2023-06-26,9296
2748,雲品,7,0,7,凱基-頭份,2023-06-26,9296
2867,三商壽,7,0,7,凱基-頭份,2023-06-26,9296
9907,統一實,7,0,7,凱基-頭份,2023-06-26,9296
1504,東元,8,2,6,凱基-頭份,2023-06-26,9296
3093,港建*,6,0,6,凱基-頭份,2023-06-26,9296
3645,達邁,7,1,6,凱基-頭份,2023-06-26,9296
5009,榮剛,6,0,6,凱基-頭份,2023-06-26,9296
8011,台通,6,0,6,凱基-頭份,2023-06-26,9296
2382,廣達,8,2,6,凱基-頭份,2023-06-26,9296
6125,廣運,9,4,5,凱基-頭份,2023-06-26,9296
00763U,期街口道瓊銅,5,0,5,凱基-頭份,2023-06-26,9296
1609,大亞,8,3,5,凱基-頭份,2023-06-26,9296
2429,銘旺科,5,0,5,凱基-頭份,2023-06-26,9296
3055,蔚華科,5,0,5,凱基-頭份,2023-06-26,9296
4973,廣穎,5,0,5,凱基-頭份,2023-06-26,9296
8210,勤誠,9,4,5,凱基-頭份,2023-06-26,9296
2453,凌群,6,2,4,凱基-頭份,2023-06-26,9296
2409,友達,160,2,158,凱基-頭份,2023-06-27,9296
4123,晟德,50,1,49,凱基-頭份,2023-06-27,9296
3356,奇偶,46,8,38,凱基-頭份,2023-06-27,9296
6776,展�眥篕�,37,0,37,凱基-頭份,2023-06-27,9296
2618,長榮航,83,52,31,凱基-頭份,2023-06-27,9296
3704,合勤控,30,2,28,凱基-頭份,2023-06-27,9296
00674R,期元大S＆P黃金反1,25,2,23,凱基-頭份,2023-06-27,9296
1905,華紙,26,5,21,凱基-頭份,2023-06-27,9296
3380,明泰,23,2,21,凱基-頭份,2023-06-27,9296
4977,眾達-KY,20,0,20,凱基-頭份,2023-06-27,9296
00929,復華台灣科技優息,17,0,17,凱基-頭份,2023-06-27,9296
2412,中華電,16,0,16,凱基-頭份,2023-06-27,9296
3213,茂訊,15,0,15,凱基-頭份,2023-06-27,9296
6125,廣運,18,3,15,凱基-頭份,2023-06-27,9296
1471,首利,15,1,14,凱基-頭份,2023-06-27,9296
2303,聯電,16,2,14,凱基-頭份,2023-06-27,9296
2344,華邦電,17,4,13,凱基-頭份,2023-06-27,9296
00713,元大台灣高息低波,12,0,12,凱基-頭份,2023-06-27,9296
1217,愛之味,30,20,10,凱基-頭份,2023-06-27,9296
00891,中信關鍵半導體,10,0,10,凱基-頭份,2023-06-27,9296
2332,友訊,10,0,10,凱基-頭份,2023-06-27,9296
2913,農林,10,0,10,凱基-頭份,2023-06-27,9296
6576,逸達,11,1,10,凱基-頭份,2023-06-27,9296
00687B,國泰20年美債,9,0,9,凱基-頭份,2023-06-27,9296
2338,光罩,10,1,9,凱基-頭份,2023-06-27,9296
5465,富驊,8,0,8,凱基-頭份,2023-06-27,9296
6124,業強,9,1,8,凱基-頭份,2023-06-27,9296
00715L,期街口布蘭特正2,7,0,7,凱基-頭份,2023-06-27,9296
1762,中化生,9,2,7,凱基-頭份,2023-06-27,9296
4108,懷特,7,0,7,凱基-頭份,2023-06-27,9296
4503,金雨,7,0,7,凱基-頭份,2023-06-27,9296
1514,亞力,9,2,7,凱基-頭份,2023-06-27,9296
1319,東陽,6,0,6,凱基-頭份,2023-06-27,9296
1434,福懋,6,0,6,凱基-頭份,2023-06-27,9296
2388,威盛,6,0,6,凱基-頭份,2023-06-27,9296
3546,宇峻,7,1,6,凱基-頭份,2023-06-27,9296
5315,光聯,6,0,6,凱基-頭份,2023-06-27,9296
8011,台通,6,0,6,凱基-頭份,2023-06-27,9296
8926,台汽電,7,1,6,凱基-頭份,2023-06-27,9296
1513,中興電,14,9,5,凱基-頭份,2023-06-27,9296
1301,台塑,5,0,5,凱基-頭份,2023-06-27,9296
1504,東元,6,1,5,凱基-頭份,2023-06-27,9296
1603,華電,5,0,5,凱基-頭份,2023-06-27,9296
1609,大亞,9,4,5,凱基-頭份,2023-06-27,9296
2017,官田鋼,5,0,5,凱基-頭份,2023-06-27,9296
4129,聯合,5,0,5,凱基-頭份,2023-06-27,9296
4973,廣穎,6,1,5,凱基-頭份,2023-06-27,9296
6120,達運,5,0,5,凱基-頭份,2023-06-27,9296
6290,良維,5,0,5,凱基-頭份,2023-06-27,9296
6499,益安,5,0,5,凱基-頭份,2023-06-27,9296
3710,連展投控,88,0,88,凱基-頭份,2023-06-28,9296
8069,元太,54,5,49,凱基-頭份,2023-06-28,9296
00715L,期街口布蘭特正2,45,2,43,凱基-頭份,2023-06-28,9296
1605,華新,29,6,23,凱基-頭份,2023-06-28,9296
1503,士電,20,0,20,凱基-頭份,2023-06-28,9296
3481,群創,28,10,18,凱基-頭份,2023-06-28,9296
00642U,期元大S＆P石油,17,0,17,凱基-頭份,2023-06-28,9296
2371,大同,27,11,16,凱基-頭份,2023-06-28,9296
2412,中華電,15,0,15,凱基-頭份,2023-06-28,9296
00706L,期元大S＆P日圓正2,15,0,15,凱基-頭份,2023-06-28,9296
2883,凱基金,13,0,13,凱基-頭份,2023-06-28,9296
3356,奇偶,21,8,13,凱基-頭份,2023-06-28,9296
6276,安鈦克,13,0,13,凱基-頭份,2023-06-28,9296
2356,英業達,11,0,11,凱基-頭份,2023-06-28,9296
2409,友達,13,2,11,凱基-頭份,2023-06-28,9296
00674R,期元大S＆P黃金反1,10,0,10,凱基-頭份,2023-06-28,9296
2323,中環,10,0,10,凱基-頭份,2023-06-28,9296
2834,臺企銀,10,0,10,凱基-頭份,2023-06-28,9296
00687B,國泰20年美債,8,0,8,凱基-頭份,2023-06-28,9296
1305,華夏,7,0,7,凱基-頭份,2023-06-28,9296
1303,南亞,7,0,7,凱基-頭份,2023-06-28,9296
00885,富邦越南,8,1,7,凱基-頭份,2023-06-28,9296
2352,佳世達,8,1,7,凱基-頭份,2023-06-28,9296
2204,中華,6,0,6,凱基-頭份,2023-06-28,9296
2515,中工,6,0,6,凱基-頭份,2023-06-28,9296
3011,今皓,6,0,6,凱基-頭份,2023-06-28,9296
6165,浪凡,6,0,6,凱基-頭份,2023-06-28,9296
00891,中信關鍵半導體,5,0,5,凱基-頭份,2023-06-28,9296
1314,中石化,5,0,5,凱基-頭份,2023-06-28,9296
1215,卜蜂,5,0,5,凱基-頭份,2023-06-28,9296
2605,新興,5,0,5,凱基-頭份,2023-06-28,9296
2634,漢翔,7,2,5,凱基-頭份,2023-06-28,9296
4121,優盛,20,15,5,凱基-頭份,2023-06-28,9296
4931,新盛力,5,0,5,凱基-頭份,2023-06-28,9296
5009,榮剛,5,0,5,凱基-頭份,2023-06-28,9296
6576,逸達,5,0,5,凱基-頭份,2023-06-28,9296
6672,騰輝電子-KY,5,0,5,凱基-頭份,2023-06-28,9296
00679B,元大美債20年,4,0,4,凱基-頭份,2023-06-28,9296
2103,台橡,4,0,4,凱基-頭份,2023-06-28,9296
2303,聯電,5,1,4,凱基-頭份,2023-06-28,9296
2312,金寶,4,0,4,凱基-頭份,2023-06-28,9296
4157,太景*-KY,9,5,4,凱基-頭份,2023-06-28,9296
6285,啟��,7,3,4,凱基-頭份,2023-06-28,9296
6492,生華科,4,0,4,凱基-頭份,2023-06-28,9296
6776,展�眥篕�,5,1,4,凱基-頭份,2023-06-28,9296
00929,復華台灣科技優息,3,0,3,凱基-頭份,2023-06-28,9296
00763U,期街口道瓊銅,3,0,3,凱基-頭份,2023-06-28,9296
1802,台玻,3,0,3,凱基-頭份,2023-06-28,9296
2230,泰茂,3,0,3,凱基-頭份,2023-06-28,9296
2606,裕民,3,0,3,凱基-頭份,2023-06-28,9296
2443,昶虹,154,0,154,凱基-頭份,2023-06-29,9296
4746,台耀,78,7,71,凱基-頭份,2023-06-29,9296
3710,連展投控,50,0,50,凱基-頭份,2023-06-29,9296
6288,聯嘉,20,0,20,凱基-頭份,2023-06-29,9296
2610,華航,25,8,17,凱基-頭份,2023-06-29,9296
2419,仲琦,27,10,17,凱基-頭份,2023-06-29,9296
1444,力麗,15,0,15,凱基-頭份,2023-06-29,9296
00878,國泰永續高股息,17,2,15,凱基-頭份,2023-06-29,9296
00882,中信中國高股息,14,0,14,凱基-頭份,2023-06-29,9296
4126,太醫,13,0,13,凱基-頭份,2023-06-29,9296
3005,神基,12,0,12,凱基-頭份,2023-06-29,9296
3706,神達,16,4,12,凱基-頭份,2023-06-29,9296
00921,兆豐龍頭等權重,11,0,11,凱基-頭份,2023-06-29,9296
2834,臺企銀,11,0,11,凱基-頭份,2023-06-29,9296
2412,中華電,11,0,11,凱基-頭份,2023-06-29,9296
00891,中信關鍵半導體,10,0,10,凱基-頭份,2023-06-29,9296
2515,中工,10,0,10,凱基-頭份,2023-06-29,9296
6188,廣明,10,0,10,凱基-頭份,2023-06-29,9296
6282,康舒,11,1,10,凱基-頭份,2023-06-29,9296
8050,廣積,10,0,10,凱基-頭份,2023-06-29,9296
00919,群益台灣精選高息,9,0,9,凱基-頭份,2023-06-29,9296
6116,彩晶,11,2,9,凱基-頭份,2023-06-29,9296
1605,華新,11,3,8,凱基-頭份,2023-06-29,9296
00715L,期街口布蘭特正2,8,0,8,凱基-頭份,2023-06-29,9296
4123,晟德,8,0,8,凱基-頭份,2023-06-29,9296
3260,威剛,11,5,6,凱基-頭份,2023-06-29,9296
8150,南茂,6,0,6,凱基-頭份,2023-06-29,9296
1432,大魯閣,5,0,5,凱基-頭份,2023-06-29,9296
1101,台泥,5,0,5,凱基-頭份,2023-06-29,9296
1609,大亞,5,0,5,凱基-頭份,2023-06-29,9296
2303,聯電,5,0,5,凱基-頭份,2023-06-29,9296
2340,台亞,5,0,5,凱基-頭份,2023-06-29,9296
2606,裕民,9,4,5,凱基-頭份,2023-06-29,9296
2888,新光金,5,0,5,凱基-頭份,2023-06-29,9296
3205,佰研,9,4,5,凱基-頭份,2023-06-29,9296
3213,茂訊,5,0,5,凱基-頭份,2023-06-29,9296
3289,宜特,8,3,5,凱基-頭份,2023-06-29,9296
3691,碩禾,6,1,5,凱基-頭份,2023-06-29,9296
4526,東台,5,0,5,凱基-頭份,2023-06-29,9296
4804,大略-KY,5,0,5,凱基-頭份,2023-06-29,9296
8105,凌巨,5,0,5,凱基-頭份,2023-06-29,9296
00687B,國泰20年美債,4,0,4,凱基-頭份,2023-06-29,9296
00679B,元大美債20年,4,0,4,凱基-頭份,2023-06-29,9296
00902,中信電池及儲能,4,0,4,凱基-頭份,2023-06-29,9296
1904,正隆,6,2,4,凱基-頭份,2023-06-29,9296
1905,華紙,18,14,4,凱基-頭份,2023-06-29,9296
2356,英業達,4,0,4,凱基-頭份,2023-06-29,9296
2534,宏盛,4,0,4,凱基-頭份,2023-06-29,9296
3081,聯亞,4,0,4,凱基-頭份,2023-06-29,9296
4417,金洲,4,0,4,凱基-頭份,2023-06-29,9296
2002,中鋼,31,0,31,凱基-頭份,2023-06-30,9296
00674R,期元大S＆P黃金反1,30,0,30,凱基-頭份,2023-06-30,9296
5864,致和證,30,0,30,凱基-頭份,2023-06-30,9296
8227,巨有科技,28,1,27,凱基-頭份,2023-06-30,9296
00683L,期元大美元指正2,21,0,21,凱基-頭份,2023-06-30,9296
6153,嘉聯益,18,0,18,凱基-頭份,2023-06-30,9296
2888,新光金,16,0,16,凱基-頭份,2023-06-30,9296
2419,仲琦,17,2,15,凱基-頭份,2023-06-30,9296
8050,廣積,24,9,15,凱基-頭份,2023-06-30,9296
8048,德勝,14,0,14,凱基-頭份,2023-06-30,9296
2208,台船,14,1,13,凱基-頭份,2023-06-30,9296
8234,新漢,16,4,12,凱基-頭份,2023-06-30,9296
2412,中華電,10,0,10,凱基-頭份,2023-06-30,9296
00751B,元大AAA至A公司債,10,0,10,凱基-頭份,2023-06-30,9296
2748,雲品,10,0,10,凱基-頭份,2023-06-30,9296
4532,瑞智,10,0,10,凱基-頭份,2023-06-30,9296
6116,彩晶,11,1,10,凱基-頭份,2023-06-30,9296
00687B,國泰20年美債,9,0,9,凱基-頭份,2023-06-30,9296
2883,凱基金,8,0,8,凱基-頭份,2023-06-30,9296
4161,聿新科,9,1,8,凱基-頭份,2023-06-30,9296
2344,華邦電,8,1,7,凱基-頭份,2023-06-30,9296
2615,萬海,38,31,7,凱基-頭份,2023-06-30,9296
3128,昇銳,8,1,7,凱基-頭份,2023-06-30,9296
5009,榮剛,12,5,7,凱基-頭份,2023-06-30,9296
2887,台新金,6,0,6,凱基-頭份,2023-06-30,9296
00680L,元大美債20正2,6,0,6,凱基-頭份,2023-06-30,9296
5315,光聯,6,0,6,凱基-頭份,2023-06-30,9296
00679B,元大美債20年,5,0,5,凱基-頭份,2023-06-30,9296
1785,光洋科,5,0,5,凱基-頭份,2023-06-30,9296
1217,愛之味,6,1,5,凱基-頭份,2023-06-30,9296
00902,中信電池及儲能,5,0,5,凱基-頭份,2023-06-30,9296
1301,台塑,6,1,5,凱基-頭份,2023-06-30,9296
1582,信錦,5,0,5,凱基-頭份,2023-06-30,9296
1903,士紙,5,0,5,凱基-頭份,2023-06-30,9296
2356,英業達,6,1,5,凱基-頭份,2023-06-30,9296
2379,瑞昱,5,0,5,凱基-頭份,2023-06-30,9296
2706,第一店,5,0,5,凱基-頭份,2023-06-30,9296
3035,智原,5,0,5,凱基-頭份,2023-06-30,9296
3434,哲固,5,0,5,凱基-頭份,2023-06-30,9296
5608,四維航,5,0,5,凱基-頭份,2023-06-30,9296
6126,信音,5,0,5,凱基-頭份,2023-06-30,9296
6188,廣明,5,0,5,凱基-頭份,2023-06-30,9296
6210,慶生,5,0,5,凱基-頭份,2023-06-30,9296
6576,逸達,5,0,5,凱基-頭份,2023-06-30,9296
00706L,期元大S＆P日圓正2,4,0,4,凱基-頭份,2023-06-30,9296
1605,華新,6,2,4,凱基-頭份,2023-06-30,9296
1612,宏泰,4,0,4,凱基-頭份,2023-06-30,9296
2340,台亞,4,0,4,凱基-頭份,2023-06-30,9296
3693,營邦,5,1,4,凱基-頭份,2023-06-30,9296
5483,中美晶,6,2,4,凱基-頭份,2023-06-30,9296
2419,仲琦,45,5,40,凱基-頭份,2023-07-03,9296
2344,華邦電,33,3,30,凱基-頭份,2023-07-03,9296
00882,中信中國高股息,18,1,17,凱基-頭份,2023-07-03,9296
00929,復華台灣科技優息,15,0,15,凱基-頭份,2023-07-03,9296
00632R,元大台灣50反1,25,10,15,凱基-頭份,2023-07-03,9296
2356,英業達,25,11,14,凱基-頭份,2023-07-03,9296
00712,復華富時不動產,13,0,13,凱基-頭份,2023-07-03,9296
00664R,國泰臺灣加權反1,10,0,10,凱基-頭份,2023-07-03,9296
00674R,期元大S＆P黃金反1,10,0,10,凱基-頭份,2023-07-03,9296
2402,毅嘉,13,3,10,凱基-頭份,2023-07-03,9296
3017,奇鋐,12,2,10,凱基-頭份,2023-07-03,9296
4552,力達-KY,10,0,10,凱基-頭份,2023-07-03,9296
8933,愛地雅,10,0,10,凱基-頭份,2023-07-03,9296
8426,紅木-KY,12,3,9,凱基-頭份,2023-07-03,9296
2201,裕隆,8,0,8,凱基-頭份,2023-07-03,9296
4541,晟田,10,2,8,凱基-頭份,2023-07-03,9296
5009,榮剛,10,2,8,凱基-頭份,2023-07-03,9296
2913,農林,7,0,7,凱基-頭份,2023-07-03,9296
3037,欣興,6,0,6,凱基-頭份,2023-07-03,9296
2412,中華電,6,0,6,凱基-頭份,2023-07-03,9296
3045,台灣大,6,0,6,凱基-頭份,2023-07-03,9296
1460,宏遠,6,0,6,凱基-頭份,2023-07-03,9296
1515,力山,6,0,6,凱基-頭份,2023-07-03,9296
2337,旺宏,6,0,6,凱基-頭份,2023-07-03,9296
2457,飛宏,7,1,6,凱基-頭份,2023-07-03,9296
6148,驊宏資,14,8,6,凱基-頭份,2023-07-03,9296
6288,聯嘉,6,0,6,凱基-頭份,2023-07-03,9296
6532,瑞耘,6,0,6,凱基-頭份,2023-07-03,9296
1522,堤維西,10,5,5,凱基-頭份,2023-07-03,9296
00673R,期元大S＆P原油反1,5,0,5,凱基-頭份,2023-07-03,9296
1795,美時,5,0,5,凱基-頭份,2023-07-03,9296
2331,精英,8,3,5,凱基-頭份,2023-07-03,9296
2338,光罩,65,60,5,凱基-頭份,2023-07-03,9296
2353,宏��,5,0,5,凱基-頭份,2023-07-03,9296
2460,建通,5,0,5,凱基-頭份,2023-07-03,9296
2883,凱基金,5,0,5,凱基-頭份,2023-07-03,9296
3013,晟銘電,5,0,5,凱基-頭份,2023-07-03,9296
3260,威剛,5,0,5,凱基-頭份,2023-07-03,9296
5263,智崴,5,0,5,凱基-頭份,2023-07-03,9296
5452,佶優,5,0,5,凱基-頭份,2023-07-03,9296
6470,宇智,8,3,5,凱基-頭份,2023-07-03,9296
2603,長榮,21,16,5,凱基-頭份,2023-07-03,9296
2409,友達,5,1,4,凱基-頭份,2023-07-03,9296
1471,首利,4,0,4,凱基-頭份,2023-07-03,9296
1598,岱宇,4,0,4,凱基-頭份,2023-07-03,9296
2357,華碩,4,0,4,凱基-頭份,2023-07-03,9296
2610,華航,20,16,4,凱基-頭份,2023-07-03,9296
6112,邁達特,4,0,4,凱基-頭份,2023-07-03,9296
6719,力智,5,1,4,凱基-頭份,2023-07-03,9296
6282,康舒,13,9,4,凱基-頭份,2023-07-03,9296
00882,中信中國高股息,71,0,71,凱基-頭份,2023-07-04,9296
2301,光寶科,53,1,52,凱基-頭份,2023-07-04,9296
00830,國泰費城半導體,50,1,49,凱基-頭份,2023-07-04,9296
2317,鴻海,45,2,43,凱基-頭份,2023-07-04,9296
5864,致和證,41,1,40,凱基-頭份,2023-07-04,9296
6139,亞翔,34,3,31,凱基-頭份,2023-07-04,9296
2002,中鋼,30,0,30,凱基-頭份,2023-07-04,9296
2618,長榮航,25,0,25,凱基-頭份,2023-07-04,9296
2356,英業達,45,21,24,凱基-頭份,2023-07-04,9296
2913,農林,20,0,20,凱基-頭份,2023-07-04,9296
6116,彩晶,20,0,20,凱基-頭份,2023-07-04,9296
1905,華紙,26,7,19,凱基-頭份,2023-07-04,9296
00637L,元大滬深300正2,18,0,18,凱基-頭份,2023-07-04,9296
2419,仲琦,25,7,18,凱基-頭份,2023-07-04,9296
2303,聯電,17,0,17,凱基-頭份,2023-07-04,9296
2615,萬海,54,38,16,凱基-頭份,2023-07-04,9296
00720B,元大投資級公司債,15,0,15,凱基-頭份,2023-07-04,9296
0056,元大高股息,17,2,15,凱基-頭份,2023-07-04,9296
2634,漢翔,16,2,14,凱基-頭份,2023-07-04,9296
2801,彰銀,13,0,13,凱基-頭份,2023-07-04,9296
2610,華航,19,7,12,凱基-頭份,2023-07-04,9296
5388,中磊,13,1,12,凱基-頭份,2023-07-04,9296
00891,中信關鍵半導體,11,0,11,凱基-頭份,2023-07-04,9296
1708,東鹼,10,0,10,凱基-頭份,2023-07-04,9296
2515,中工,15,5,10,凱基-頭份,2023-07-04,9296
2888,新光金,10,0,10,凱基-頭份,2023-07-04,9296
3046,建��,10,0,10,凱基-頭份,2023-07-04,9296
4956,光鋐,10,0,10,凱基-頭份,2023-07-04,9296
5531,鄉林,10,0,10,凱基-頭份,2023-07-04,9296
3481,群創,10,1,9,凱基-頭份,2023-07-04,9296
2399,映泰,11,3,8,凱基-頭份,2023-07-04,9296
2706,第一店,11,3,8,凱基-頭份,2023-07-04,9296
00929,復華台灣科技優息,7,0,7,凱基-頭份,2023-07-04,9296
00632R,元大台灣50反1,7,0,7,凱基-頭份,2023-07-04,9296
2312,金寶,8,1,7,凱基-頭份,2023-07-04,9296
4977,眾達-KY,8,1,7,凱基-頭份,2023-07-04,9296
6112,邁達特,13,6,7,凱基-頭份,2023-07-04,9296
1605,華新,12,5,7,凱基-頭份,2023-07-04,9296
3356,奇偶,11,5,6,凱基-頭份,2023-07-04,9296
8064,東捷,6,0,6,凱基-頭份,2023-07-04,9296
00674R,期元大S＆P黃金反1,5,0,5,凱基-頭份,2023-07-04,9296
1471,首利,5,0,5,凱基-頭份,2023-07-04,9296
1522,堤維西,11,6,5,凱基-頭份,2023-07-04,9296
1609,大亞,7,2,5,凱基-頭份,2023-07-04,9296
2431,聯昌,5,0,5,凱基-頭份,2023-07-04,9296
2736,富野,5,0,5,凱基-頭份,2023-07-04,9296
2838A,聯邦銀甲特,5,0,5,凱基-頭份,2023-07-04,9296
4526,東台,5,0,5,凱基-頭份,2023-07-04,9296
4906,正文,5,0,5,凱基-頭份,2023-07-04,9296
4915,致伸,5,0,5,凱基-頭份,2023-07-04,9296
0056,元大高股息,72,5,67,凱基-頭份,2023-07-05,9296
2609,陽明,114,58,56,凱基-頭份,2023-07-05,9296
8403,盛弘,36,0,36,凱基-頭份,2023-07-05,9296
2890,永豐金,21,0,21,凱基-頭份,2023-07-05,9296
2303,聯電,20,4,16,凱基-頭份,2023-07-05,9296
2618,長榮航,31,17,14,凱基-頭份,2023-07-05,9296
3231,緯創,41,27,14,凱基-頭份,2023-07-05,9296
00637L,元大滬深300正2,13,0,13,凱基-頭份,2023-07-05,9296
00673R,期元大S＆P原油反1,13,0,13,凱基-頭份,2023-07-05,9296
6530,創威,13,0,13,凱基-頭份,2023-07-05,9296
3576,聯合再生,17,5,12,凱基-頭份,2023-07-05,9296
6120,達運,12,0,12,凱基-頭份,2023-07-05,9296
00929,復華台灣科技優息,11,0,11,凱基-頭份,2023-07-05,9296
1314,中石化,11,0,11,凱基-頭份,2023-07-05,9296
1905,華紙,21,10,11,凱基-頭份,2023-07-05,9296
1503,士電,10,0,10,凱基-頭份,2023-07-05,9296
020038,元大ESG配息N,10,0,10,凱基-頭份,2023-07-05,9296
1524,耿鼎,10,0,10,凱基-頭份,2023-07-05,9296
2337,旺宏,11,1,10,凱基-頭份,2023-07-05,9296
3564,其陽,11,1,10,凱基-頭份,2023-07-05,9296
8076,伍豐,10,0,10,凱基-頭份,2023-07-05,9296
2634,漢翔,10,1,9,凱基-頭份,2023-07-05,9296
1603,華電,11,2,9,凱基-頭份,2023-07-05,9296
1605,華新,10,2,8,凱基-頭份,2023-07-05,9296
2615,萬海,10,3,7,凱基-頭份,2023-07-05,9296
2476,鉅祥,7,0,7,凱基-頭份,2023-07-05,9296
3706,神達,8,1,7,凱基-頭份,2023-07-05,9296
6190,萬泰科,7,0,7,凱基-頭份,2023-07-05,9296
2356,英業達,28,22,6,凱基-頭份,2023-07-05,9296
00882,中信中國高股息,6,0,6,凱基-頭份,2023-07-05,9296
2206,三陽工業,6,0,6,凱基-頭份,2023-07-05,9296
2834,臺企銀,20,14,6,凱基-頭份,2023-07-05,9296
3056,富華新,6,0,6,凱基-頭份,2023-07-05,9296
3078,僑威,11,5,6,凱基-頭份,2023-07-05,9296
3264,欣銓,6,0,6,凱基-頭份,2023-07-05,9296
3363,上詮,10,4,6,凱基-頭份,2023-07-05,9296
6263,普萊德,6,0,6,凱基-頭份,2023-07-05,9296
00679B,元大美債20年,5,0,5,凱基-頭份,2023-07-05,9296
00751B,元大AAA至A公司債,5,0,5,凱基-頭份,2023-07-05,9296
1312,國喬,5,0,5,凱基-頭份,2023-07-05,9296
2221,大甲,5,0,5,凱基-頭份,2023-07-05,9296
2340,台亞,5,0,5,凱基-頭份,2023-07-05,9296
2371,大同,5,0,5,凱基-頭份,2023-07-05,9296
2409,友達,6,1,5,凱基-頭份,2023-07-05,9296
2427,三商電,10,5,5,凱基-頭份,2023-07-05,9296
2449,京元電子,5,0,5,凱基-頭份,2023-07-05,9296
3019,亞光,5,0,5,凱基-頭份,2023-07-05,9296
3024,憶聲,5,0,5,凱基-頭份,2023-07-05,9296
3092,鴻碩,5,0,5,凱基-頭份,2023-07-05,9296
3213,茂訊,5,0,5,凱基-頭份,2023-07-05,9296
2002,中鋼,86,0,86,凱基-頭份,2023-07-06,9296
2801,彰銀,37,0,37,凱基-頭份,2023-07-06,9296
2609,陽明,80,44,36,凱基-頭份,2023-07-06,9296
3706,神達,37,3,34,凱基-頭份,2023-07-06,9296
00673R,期元大S＆P原油反1,32,0,32,凱基-頭份,2023-07-06,9296
1611,中電,248,216,32,凱基-頭份,2023-07-06,9296
2890,永豐金,28,0,28,凱基-頭份,2023-07-06,9296
00679B,元大美債20年,27,1,26,凱基-頭份,2023-07-06,9296
2603,長榮,26,1,25,凱基-頭份,2023-07-06,9296
2486,一詮,26,1,25,凱基-頭份,2023-07-06,9296
2610,華航,29,4,25,凱基-頭份,2023-07-06,9296
8050,廣積,28,5,23,凱基-頭份,2023-07-06,9296
1603,華電,20,0,20,凱基-頭份,2023-07-06,9296
00882,中信中國高股息,19,0,19,凱基-頭份,2023-07-06,9296
1303,南亞,18,0,18,凱基-頭份,2023-07-06,9296
2883,凱基金,21,4,17,凱基-頭份,2023-07-06,9296
0050,元大台灣50,16,0,16,凱基-頭份,2023-07-06,9296
2618,長榮航,27,11,16,凱基-頭份,2023-07-06,9296
2419,仲琦,29,14,15,凱基-頭份,2023-07-06,9296
00929,復華台灣科技優息,14,0,14,凱基-頭份,2023-07-06,9296
2488,漢平,13,0,13,凱基-頭份,2023-07-06,9296
2489,瑞軒,20,7,13,凱基-頭份,2023-07-06,9296
5511,德昌,13,0,13,凱基-頭份,2023-07-06,9296
4566,時碩工業,16,4,12,凱基-頭份,2023-07-06,9296
8112,至上,12,0,12,凱基-頭份,2023-07-06,9296
6148,驊宏資,20,9,11,凱基-頭份,2023-07-06,9296
5880,合庫金,11,0,11,凱基-頭份,2023-07-06,9296
2834,臺企銀,10,0,10,凱基-頭份,2023-07-06,9296
3363,上詮,10,0,10,凱基-頭份,2023-07-06,9296
4306,炎洲,10,0,10,凱基-頭份,2023-07-06,9296
6218,豪勉,10,0,10,凱基-頭份,2023-07-06,9296
8429,金麗-KY,10,0,10,凱基-頭份,2023-07-06,9296
1471,首利,10,0,10,凱基-頭份,2023-07-06,9296
00720B,元大投資級公司債,9,0,9,凱基-頭份,2023-07-06,9296
3481,群創,27,18,9,凱基-頭份,2023-07-06,9296
1101,台泥,8,0,8,凱基-頭份,2023-07-06,9296
6133,金橋,8,0,8,凱基-頭份,2023-07-06,9296
6142,友勁,8,0,8,凱基-頭份,2023-07-06,9296
6278,台表科,8,0,8,凱基-頭份,2023-07-06,9296
2881,富邦金,7,0,7,凱基-頭份,2023-07-06,9296
00919,群益台灣精選高息,11,4,7,凱基-頭份,2023-07-06,9296
00687B,國泰20年美債,7,0,7,凱基-頭份,2023-07-06,9296
00751B,元大AAA至A公司債,7,0,7,凱基-頭份,2023-07-06,9296
1312,國喬,7,0,7,凱基-頭份,2023-07-06,9296
2892,第一金,7,0,7,凱基-頭份,2023-07-06,9296
3024,憶聲,7,0,7,凱基-頭份,2023-07-06,9296
3356,奇偶,10,3,7,凱基-頭份,2023-07-06,9296
4979,華星光,12,5,7,凱基-頭份,2023-07-06,9296
6282,康舒,21,14,7,凱基-頭份,2023-07-06,9296
2880,華南金,7,0,7,凱基-頭份,2023-07-06,9296
00673R,期元大S＆P原油反1,127,0,127,凱基-頭份,2023-07-07,9296
8926,台汽電,30,1,29,凱基-頭份,2023-07-07,9296
00637L,元大滬深300正2,30,3,27,凱基-頭份,2023-07-07,9296
00712,復華富時不動產,26,0,26,凱基-頭份,2023-07-07,9296
2609,陽明,78,52,26,凱基-頭份,2023-07-07,9296
2323,中環,24,0,24,凱基-頭份,2023-07-07,9296
2834,臺企銀,23,0,23,凱基-頭份,2023-07-07,9296
2340,台亞,24,1,23,凱基-頭份,2023-07-07,9296
2891,中信金,23,0,23,凱基-頭份,2023-07-07,9296
2002,中鋼,23,1,22,凱基-頭份,2023-07-07,9296
2882,國泰金,22,0,22,凱基-頭份,2023-07-07,9296
1304,台聚,20,0,20,凱基-頭份,2023-07-07,9296
00882,中信中國高股息,15,0,15,凱基-頭份,2023-07-07,9296
3363,上詮,24,9,15,凱基-頭份,2023-07-07,9296
4967,十銓,15,0,15,凱基-頭份,2023-07-07,9296
00679B,元大美債20年,14,0,14,凱基-頭份,2023-07-07,9296
2603,長榮,17,4,13,凱基-頭份,2023-07-07,9296
2489,瑞軒,12,0,12,凱基-頭份,2023-07-07,9296
2605,新興,12,0,12,凱基-頭份,2023-07-07,9296
00919,群益台灣精選高息,11,0,11,凱基-頭份,2023-07-07,9296
00680L,元大美債20正2,11,0,11,凱基-頭份,2023-07-07,9296
2014,中鴻,11,0,11,凱基-頭份,2023-07-07,9296
2369,菱生,22,11,11,凱基-頭份,2023-07-07,9296
3380,明泰,30,19,11,凱基-頭份,2023-07-07,9296
00751B,元大AAA至A公司債,10,0,10,凱基-頭份,2023-07-07,9296
1584,精剛,10,0,10,凱基-頭份,2023-07-07,9296
2338,光罩,10,0,10,凱基-頭份,2023-07-07,9296
2344,華邦電,12,2,10,凱基-頭份,2023-07-07,9296
2913,農林,10,0,10,凱基-頭份,2023-07-07,9296
3356,奇偶,11,1,10,凱基-頭份,2023-07-07,9296
4168,醣聯,10,0,10,凱基-頭份,2023-07-07,9296
4306,炎洲,10,0,10,凱基-頭份,2023-07-07,9296
5328,華容,10,0,10,凱基-頭份,2023-07-07,9296
0056,元大高股息,18,9,9,凱基-頭份,2023-07-07,9296
2356,英業達,12,3,9,凱基-頭份,2023-07-07,9296
00720B,元大投資級公司債,9,0,9,凱基-頭份,2023-07-07,9296
00929,復華台灣科技優息,9,0,9,凱基-頭份,2023-07-07,9296
2885,元大金,9,0,9,凱基-頭份,2023-07-07,9296
2883,凱基金,9,0,9,凱基-頭份,2023-07-07,9296
2409,友達,11,3,8,凱基-頭份,2023-07-07,9296
00713,元大台灣高息低波,8,0,8,凱基-頭份,2023-07-07,9296
1513,中興電,8,0,8,凱基-頭份,2023-07-07,9296
3715,定穎投控,8,0,8,凱基-頭份,2023-07-07,9296
6590,普鴻,8,0,8,凱基-頭份,2023-07-07,9296
1301,台塑,7,0,7,凱基-頭份,2023-07-07,9296
00687B,國泰20年美債,7,0,7,凱基-頭份,2023-07-07,9296
1609,大亞,10,3,7,凱基-頭份,2023-07-07,9296
2419,仲琦,49,42,7,凱基-頭份,2023-07-07,9296
2884,玉山金,7,0,7,凱基-頭份,2023-07-07,9296
8093,保銳,7,0,7,凱基-頭份,2023-07-07,9296
4123,晟德,111,5,106,凱基-頭份,2023-07-10,9296
2609,陽明,56,8,48,凱基-頭份,2023-07-10,9296
6122,擎邦,35,3,32,凱基-頭份,2023-07-10,9296
2603,長榮,32,2,30,凱基-頭份,2023-07-10,9296
2883,凱基金,40,10,30,凱基-頭份,2023-07-10,9296
00673R,期元大S＆P原油反1,23,0,23,凱基-頭份,2023-07-10,9296
2605,新興,23,0,23,凱基-頭份,2023-07-10,9296
1305,華夏,20,0,20,凱基-頭份,2023-07-10,9296
1304,台聚,20,0,20,凱基-頭份,2023-07-10,9296
3380,明泰,20,0,20,凱基-頭份,2023-07-10,9296
2615,萬海,22,3,19,凱基-頭份,2023-07-10,9296
4532,瑞智,26,8,18,凱基-頭份,2023-07-10,9296
6282,康舒,18,0,18,凱基-頭份,2023-07-10,9296
6285,啟��,53,36,17,凱基-頭份,2023-07-10,9296
2887,台新金,14,0,14,凱基-頭份,2023-07-10,9296
1504,東元,18,5,13,凱基-頭份,2023-07-10,9296
2801,彰銀,13,0,13,凱基-頭份,2023-07-10,9296
00919,群益台灣精選高息,12,0,12,凱基-頭份,2023-07-10,9296
3325,旭品,11,0,11,凱基-頭份,2023-07-10,9296
2409,友達,11,1,10,凱基-頭份,2023-07-10,9296
6263,普萊德,10,0,10,凱基-頭份,2023-07-10,9296
1303,南亞,10,0,10,凱基-頭份,2023-07-10,9296
00665L,富邦�琤肭磪囓�2,10,0,10,凱基-頭份,2023-07-10,9296
1734,杏輝,10,0,10,凱基-頭份,2023-07-10,9296
2356,英業達,10,0,10,凱基-頭份,2023-07-10,9296
2610,華航,10,0,10,凱基-頭份,2023-07-10,9296
3287,廣寰科,10,0,10,凱基-頭份,2023-07-10,9296
4306,炎洲,10,0,10,凱基-頭份,2023-07-10,9296
6142,友勁,10,0,10,凱基-頭份,2023-07-10,9296
6266,泰詠,10,0,10,凱基-頭份,2023-07-10,9296
00679B,元大美債20年,10,0,10,凱基-頭份,2023-07-10,9296
1101,台泥,9,0,9,凱基-頭份,2023-07-10,9296
2618,長榮航,13,5,8,凱基-頭份,2023-07-10,9296
1314,中石化,8,0,8,凱基-頭份,2023-07-10,9296
6146,耕興,8,0,8,凱基-頭份,2023-07-10,9296
00888,永豐台灣ESG,8,0,8,凱基-頭份,2023-07-10,9296
1515,力山,7,0,7,凱基-頭份,2023-07-10,9296
1802,台玻,7,0,7,凱基-頭份,2023-07-10,9296
2436,偉詮電,13,6,7,凱基-頭份,2023-07-10,9296
6492,生華科,7,0,7,凱基-頭份,2023-07-10,9296
6535,順藥,7,0,7,凱基-頭份,2023-07-10,9296
00891,中信關鍵半導體,6,0,6,凱基-頭份,2023-07-10,9296
00929,復華台灣科技優息,6,0,6,凱基-頭份,2023-07-10,9296
1533,車王電,9,3,6,凱基-頭份,2023-07-10,9296
2030,彰源,6,0,6,凱基-頭份,2023-07-10,9296
2303,聯電,6,0,6,凱基-頭份,2023-07-10,9296
6148,驊宏資,6,0,6,凱基-頭份,2023-07-10,9296
2884,玉山金,5,0,5,凱基-頭份,2023-07-10,9296
00720B,元大投資級公司債,5,0,5,凱基-頭份,2023-07-10,9296
00857B,永豐20年美公債,5,0,5,凱基-頭份,2023-07-10,9296
911868,同方友友-DR,100,0,100,凱基-頭份,2023-07-11,9296
2025,千興,67,0,67,凱基-頭份,2023-07-11,9296
00632R,元大台灣50反1,60,0,60,凱基-頭份,2023-07-11,9296
2609,陽明,48,4,44,凱基-頭份,2023-07-11,9296
00712,復華富時不動產,20,0,20,凱基-頭份,2023-07-11,9296
1304,台聚,20,0,20,凱基-頭份,2023-07-11,9296
2444,兆勁,20,0,20,凱基-頭份,2023-07-11,9296
1471,首利,19,0,19,凱基-頭份,2023-07-11,9296
2547,日勝生,19,0,19,凱基-頭份,2023-07-11,9296
6125,廣運,20,2,18,凱基-頭份,2023-07-11,9296
2356,英業達,29,14,15,凱基-頭份,2023-07-11,9296
00679B,元大美債20年,15,3,12,凱基-頭份,2023-07-11,9296
2481,強茂,17,5,12,凱基-頭份,2023-07-11,9296
4934,太極,14,2,12,凱基-頭份,2023-07-11,9296
2883,凱基金,11,0,11,凱基-頭份,2023-07-11,9296
3710,連展投控,11,0,11,凱基-頭份,2023-07-11,9296
5213,亞昕,10,0,10,凱基-頭份,2023-07-11,9296
00664R,國泰臺灣加權反1,10,0,10,凱基-頭份,2023-07-11,9296
00676R,富邦臺灣加權反1,10,0,10,凱基-頭份,2023-07-11,9296
00895,富邦未來車,10,0,10,凱基-頭份,2023-07-11,9296
1809,中釉,10,0,10,凱基-頭份,2023-07-11,9296
2354,鴻準,10,0,10,凱基-頭份,2023-07-11,9296
4306,炎洲,10,0,10,凱基-頭份,2023-07-11,9296
4552,力達-KY,10,0,10,凱基-頭份,2023-07-11,9296
5483,中美晶,10,0,10,凱基-頭份,2023-07-11,9296
6226,光鼎,10,0,10,凱基-頭份,2023-07-11,9296
4155,訊映,31,22,9,凱基-頭份,2023-07-11,9296
6120,達運,9,0,9,凱基-頭份,2023-07-11,9296
2371,大同,8,0,8,凱基-頭份,2023-07-11,9296
3706,神達,9,1,8,凱基-頭份,2023-07-11,9296
4538,大詠城,8,0,8,凱基-頭份,2023-07-11,9296
6234,高僑,8,0,8,凱基-頭份,2023-07-11,9296
1762,中化生,8,1,7,凱基-頭份,2023-07-11,9296
3289,宜特,7,0,7,凱基-頭份,2023-07-11,9296
2419,仲琦,12,6,6,凱基-頭份,2023-07-11,9296
2449,京元電子,6,0,6,凱基-頭份,2023-07-11,9296
2457,飛宏,11,5,6,凱基-頭份,2023-07-11,9296
00891,中信關鍵半導體,5,0,5,凱基-頭份,2023-07-11,9296
2017,官田鋼,5,0,5,凱基-頭份,2023-07-11,9296
2329,華泰,8,3,5,凱基-頭份,2023-07-11,9296
2892,第一金,5,0,5,凱基-頭份,2023-07-11,9296
3025,星通,23,18,5,凱基-頭份,2023-07-11,9296
3081,聯亞,5,0,5,凱基-頭份,2023-07-11,9296
3441,聯一光,5,0,5,凱基-頭份,2023-07-11,9296
4123,晟德,5,0,5,凱基-頭份,2023-07-11,9296
4168,醣聯,5,0,5,凱基-頭份,2023-07-11,9296
5328,華容,5,0,5,凱基-頭份,2023-07-11,9296
6288,聯嘉,5,0,5,凱基-頭份,2023-07-11,9296
00683L,期元大美元指正2,4,0,4,凱基-頭份,2023-07-11,9296
1540,喬福,4,0,4,凱基-頭份,2023-07-11,9296
3481,群創,53,4,49,凱基-頭份,2023-07-12,9296
2609,陽明,63,17,46,凱基-頭份,2023-07-12,9296
2303,聯電,51,12,39,凱基-頭份,2023-07-12,9296
00635U,期元大S＆P黃金,30,0,30,凱基-頭份,2023-07-12,9296
2323,中環,29,0,29,凱基-頭份,2023-07-12,9296
00885,富邦越南,26,0,26,凱基-頭份,2023-07-12,9296
2421,建準,28,2,26,凱基-頭份,2023-07-12,9296
00905,FT臺灣Smart,20,0,20,凱基-頭份,2023-07-12,9296
00923,群益台ESG低碳50,20,0,20,凱基-頭份,2023-07-12,9296
2367,燿華,20,0,20,凱基-頭份,2023-07-12,9296
4168,醣聯,20,0,20,凱基-頭份,2023-07-12,9296
6116,彩晶,20,0,20,凱基-頭份,2023-07-12,9296
6125,廣運,19,0,19,凱基-頭份,2023-07-12,9296
00650L,復華香港正2,13,0,13,凱基-頭份,2023-07-12,9296
2002,中鋼,11,0,11,凱基-頭份,2023-07-12,9296
4967,十銓,22,11,11,凱基-頭份,2023-07-12,9296
6220,岳豐,11,0,11,凱基-頭份,2023-07-12,9296
6282,康舒,18,7,11,凱基-頭份,2023-07-12,9296
00673R,期元大S＆P原油反1,10,0,10,凱基-頭份,2023-07-12,9296
2017,官田鋼,10,0,10,凱基-頭份,2023-07-12,9296
2705,六福,10,0,10,凱基-頭份,2023-07-12,9296
2834,臺企銀,10,0,10,凱基-頭份,2023-07-12,9296
1605,華新,9,1,8,凱基-頭份,2023-07-12,9296
2498,宏達電,15,7,8,凱基-頭份,2023-07-12,9296
00773B,中信優先金融債,7,0,7,凱基-頭份,2023-07-12,9296
1513,中興電,13,6,7,凱基-頭份,2023-07-12,9296
2020,美亞,8,1,7,凱基-頭份,2023-07-12,9296
2324,仁寶,9,2,7,凱基-頭份,2023-07-12,9296
6005,群益證,7,0,7,凱基-頭份,2023-07-12,9296
1503,士電,8,2,6,凱基-頭份,2023-07-12,9296
3176,基亞,6,0,6,凱基-頭份,2023-07-12,9296
3704,合勤控,7,1,6,凱基-頭份,2023-07-12,9296
5880,合庫金,6,0,6,凱基-頭份,2023-07-12,9296
1609,大亞,13,7,6,凱基-頭份,2023-07-12,9296
6285,啟��,73,68,5,凱基-頭份,2023-07-12,9296
2495,普安,5,0,5,凱基-頭份,2023-07-12,9296
4147,中裕,5,0,5,凱基-頭份,2023-07-12,9296
4161,聿新科,5,0,5,凱基-頭份,2023-07-12,9296
4533,協易機,6,1,5,凱基-頭份,2023-07-12,9296
4538,大詠城,5,0,5,凱基-頭份,2023-07-12,9296
4960,誠美材,5,0,5,凱基-頭份,2023-07-12,9296
6523,達爾膚,5,0,5,凱基-頭份,2023-07-12,9296
6576,逸達,5,0,5,凱基-頭份,2023-07-12,9296
8171,天宇,5,0,5,凱基-頭份,2023-07-12,9296
1305,華夏,4,0,4,凱基-頭份,2023-07-12,9296
00919,群益台灣精選高息,4,0,4,凱基-頭份,2023-07-12,9296
006208,富邦台50,4,0,4,凱基-頭份,2023-07-12,9296
00764B,群益25年美債,4,0,4,凱基-頭份,2023-07-12,9296
2464,盟立,4,0,4,凱基-頭份,2023-07-12,9296
2516,新建,4,0,4,凱基-頭份,2023-07-12,9296
00929,復華台灣科技優息,92,4,88,凱基-頭份,2023-07-13,9296
00632R,元大台灣50反1,78,12,66,凱基-頭份,2023-07-13,9296
00692,富邦公司治理,61,0,61,凱基-頭份,2023-07-13,9296
2609,陽明,67,8,59,凱基-頭份,2023-07-13,9296
8050,廣積,52,1,51,凱基-頭份,2023-07-13,9296
2324,仁寶,94,47,47,凱基-頭份,2023-07-13,9296
2618,長榮航,64,23,41,凱基-頭份,2023-07-13,9296
2352,佳世達,32,7,25,凱基-頭份,2023-07-13,9296
6770,力積電,30,5,25,凱基-頭份,2023-07-13,9296
00673R,期元大S＆P原油反1,24,0,24,凱基-頭份,2023-07-13,9296
1618,合機,30,7,23,凱基-頭份,2023-07-13,9296
00898,國泰基因免疫革命,20,0,20,凱基-頭份,2023-07-13,9296
00712,復華富時不動產,21,2,19,凱基-頭份,2023-07-13,9296
2323,中環,19,0,19,凱基-頭份,2023-07-13,9296
8210,勤誠,25,9,16,凱基-頭份,2023-07-13,9296
2329,華泰,21,5,16,凱基-頭份,2023-07-13,9296
2610,華航,27,11,16,凱基-頭份,2023-07-13,9296
00930,永豐ESG低碳高息,13,0,13,凱基-頭份,2023-07-13,9296
1312,國喬,13,0,13,凱基-頭份,2023-07-13,9296
00753L,中信中國50正2,12,0,12,凱基-頭份,2023-07-13,9296
1305,華夏,11,0,11,凱基-頭份,2023-07-13,9296
3013,晟銘電,16,5,11,凱基-頭份,2023-07-13,9296
2303,聯電,12,2,10,凱基-頭份,2023-07-13,9296
00905,FT臺灣Smart,10,0,10,凱基-頭份,2023-07-13,9296
00665L,富邦�琤肭磪囓�2,15,5,10,凱基-頭份,2023-07-13,9296
00664R,國泰臺灣加權反1,10,0,10,凱基-頭份,2023-07-13,9296
1314,中石化,10,0,10,凱基-頭份,2023-07-13,9296
1409,新纖,10,0,10,凱基-頭份,2023-07-13,9296
1714,和桐,10,0,10,凱基-頭份,2023-07-13,9296
2025,千興,10,0,10,凱基-頭份,2023-07-13,9296
2855,統一證,10,0,10,凱基-頭份,2023-07-13,9296
4168,醣聯,10,0,10,凱基-頭份,2023-07-13,9296
4726,永昕,10,0,10,凱基-頭份,2023-07-13,9296
5536,聖暉*,11,1,10,凱基-頭份,2023-07-13,9296
6153,嘉聯益,10,0,10,凱基-頭份,2023-07-13,9296
6164,華興,10,0,10,凱基-頭份,2023-07-13,9296
4532,瑞智,14,6,8,凱基-頭份,2023-07-13,9296
6499,益安,8,0,8,凱基-頭份,2023-07-13,9296
00679B,元大美債20年,8,0,8,凱基-頭份,2023-07-13,9296
00891,中信關鍵半導體,8,1,7,凱基-頭份,2023-07-13,9296
1605,華新,89,82,7,凱基-頭份,2023-07-13,9296
2606,裕民,7,0,7,凱基-頭份,2023-07-13,9296
1101,台泥,7,0,7,凱基-頭份,2023-07-13,9296
1231,聯華食,6,0,6,凱基-頭份,2023-07-13,9296
1723,中碳,6,0,6,凱基-頭份,2023-07-13,9296
1905,華紙,6,0,6,凱基-頭份,2023-07-13,9296
2399,映泰,6,0,6,凱基-頭份,2023-07-13,9296
4533,協易機,13,7,6,凱基-頭份,2023-07-13,9296
00923,群益台ESG低碳50,5,0,5,凱基-頭份,2023-07-13,9296
1503,士電,9,4,5,凱基-頭份,2023-07-13,9296
4414,如興,54,0,54,凱基-頭份,2023-07-14,9296
00930,永豐ESG低碳高息,50,0,50,凱基-頭份,2023-07-14,9296
00679B,元大美債20年,36,0,36,凱基-頭份,2023-07-14,9296
00687B,國泰20年美債,35,0,35,凱基-頭份,2023-07-14,9296
2618,長榮航,37,6,31,凱基-頭份,2023-07-14,9296
2610,華航,37,7,30,凱基-頭份,2023-07-14,9296
2419,仲琦,62,34,28,凱基-頭份,2023-07-14,9296
00720B,元大投資級公司債,22,0,22,凱基-頭份,2023-07-14,9296
00712,復華富時不動產,32,11,21,凱基-頭份,2023-07-14,9296
1217,愛之味,20,0,20,凱基-頭份,2023-07-14,9296
8210,勤誠,29,10,19,凱基-頭份,2023-07-14,9296
00673R,期元大S＆P原油反1,18,0,18,凱基-頭份,2023-07-14,9296
6120,達運,20,2,18,凱基-頭份,2023-07-14,9296
2603,長榮,19,2,17,凱基-頭份,2023-07-14,9296
2382,廣達,25,10,15,凱基-頭份,2023-07-14,9296
00664R,國泰臺灣加權反1,15,0,15,凱基-頭份,2023-07-14,9296
00888,永豐台灣ESG,14,0,14,凱基-頭份,2023-07-14,9296
3005,神基,14,0,14,凱基-頭份,2023-07-14,9296
00632R,元大台灣50反1,19,6,13,凱基-頭份,2023-07-14,9296
6191,精成科,14,1,13,凱基-頭份,2023-07-14,9296
2609,陽明,15,2,13,凱基-頭份,2023-07-14,9296
4532,瑞智,13,1,12,凱基-頭份,2023-07-14,9296
2025,千興,11,0,11,凱基-頭份,2023-07-14,9296
3583,辛耘,12,1,11,凱基-頭份,2023-07-14,9296
3056,富華新,10,0,10,凱基-頭份,2023-07-14,9296
6117,迎廣,10,0,10,凱基-頭份,2023-07-14,9296
6168,宏齊,10,0,10,凱基-頭份,2023-07-14,9296
6265,方土昶,10,0,10,凱基-頭份,2023-07-14,9296
6282,康舒,14,4,10,凱基-頭份,2023-07-14,9296
5483,中美晶,22,13,9,凱基-頭份,2023-07-14,9296
00751B,元大AAA至A公司債,10,1,9,凱基-頭份,2023-07-14,9296
2535,達欣工,9,0,9,凱基-頭份,2023-07-14,9296
6190,萬泰科,20,11,9,凱基-頭份,2023-07-14,9296
3231,緯創,14,6,8,凱基-頭份,2023-07-14,9296
00688L,國泰20年美債正2,8,0,8,凱基-頭份,2023-07-14,9296
6275,元山,8,0,8,凱基-頭份,2023-07-14,9296
00882,中信中國高股息,7,0,7,凱基-頭份,2023-07-14,9296
2312,金寶,10,3,7,凱基-頭份,2023-07-14,9296
3057,喬鼎,7,0,7,凱基-頭份,2023-07-14,9296
8105,凌巨,7,0,7,凱基-頭份,2023-07-14,9296
3363,上詮,42,35,7,凱基-頭份,2023-07-14,9296
2301,光寶科,20,13,7,凱基-頭份,2023-07-14,9296
2812,台中銀,6,0,6,凱基-頭份,2023-07-14,9296
3032,偉訓,7,1,6,凱基-頭份,2023-07-14,9296
6285,啟��,14,8,6,凱基-頭份,2023-07-14,9296
6548,長科*,6,0,6,凱基-頭份,2023-07-14,9296
5213,亞昕,5,0,5,凱基-頭份,2023-07-14,9296
1783,和康生,6,1,5,凱基-頭份,2023-07-14,9296
2002,中鋼,5,0,5,凱基-頭份,2023-07-14,9296
2340,台亞,10,5,5,凱基-頭份,2023-07-14,9296
2314,台揚,108,6,102,凱基-頭份,2023-07-17,9296
00929,復華台灣科技優息,80,1,79,凱基-頭份,2023-07-17,9296
00712,復華富時不動產,52,0,52,凱基-頭份,2023-07-17,9296
3481,群創,57,15,42,凱基-頭份,2023-07-17,9296
00673R,期元大S＆P原油反1,30,0,30,凱基-頭份,2023-07-17,9296
1101,台泥,23,0,23,凱基-頭份,2023-07-17,9296
6443,元晶,21,0,21,凱基-頭份,2023-07-17,9296
00930,永豐ESG低碳高息,20,0,20,凱基-頭份,2023-07-17,9296
6184,大豐電,19,0,19,凱基-頭份,2023-07-17,9296
4116,明基醫,17,0,17,凱基-頭份,2023-07-17,9296
5608,四維航,15,0,15,凱基-頭份,2023-07-17,9296
1905,華紙,26,11,15,凱基-頭份,2023-07-17,9296
6191,精成科,16,2,14,凱基-頭份,2023-07-17,9296
3163,波若威,19,6,13,凱基-頭份,2023-07-17,9296
3047,訊舟,12,0,12,凱基-頭份,2023-07-17,9296
3380,明泰,17,5,12,凱基-頭份,2023-07-17,9296
1312,國喬,11,0,11,凱基-頭份,2023-07-17,9296
00637L,元大滬深300正2,10,0,10,凱基-頭份,2023-07-17,9296
3062,建漢,10,0,10,凱基-頭份,2023-07-17,9296
3287,廣寰科,10,0,10,凱基-頭份,2023-07-17,9296
6265,方土昶,10,0,10,凱基-頭份,2023-07-17,9296
2812,台中銀,9,0,9,凱基-頭份,2023-07-17,9296
00922,國泰台灣領袖50,10,1,9,凱基-頭份,2023-07-17,9296
3704,合勤控,13,4,9,凱基-頭份,2023-07-17,9296
00772B,中信高評級公司債,10,2,8,凱基-頭份,2023-07-17,9296
00753L,中信中國50正2,8,0,8,凱基-頭份,2023-07-17,9296
1605,華新,10,2,8,凱基-頭份,2023-07-17,9296
6116,彩晶,31,23,8,凱基-頭份,2023-07-17,9296
6285,啟��,23,15,8,凱基-頭份,2023-07-17,9296
5483,中美晶,12,5,7,凱基-頭份,2023-07-17,9296
3673,TPK-KY,10,3,7,凱基-頭份,2023-07-17,9296
1471,首利,7,1,6,凱基-頭份,2023-07-17,9296
2486,一詮,6,0,6,凱基-頭份,2023-07-17,9296
2610,華航,33,27,6,凱基-頭份,2023-07-17,9296
2882,國泰金,10,4,6,凱基-頭份,2023-07-17,9296
3306,鼎天,7,1,6,凱基-頭份,2023-07-17,9296
3338,泰碩,8,2,6,凱基-頭份,2023-07-17,9296
6160,欣技,6,0,6,凱基-頭份,2023-07-17,9296
6218,豪勉,14,8,6,凱基-頭份,2023-07-17,9296
00912,中信臺灣智慧50,5,0,5,凱基-頭份,2023-07-17,9296
2312,金寶,23,18,5,凱基-頭份,2023-07-17,9296
2349,錸德,5,0,5,凱基-頭份,2023-07-17,9296
3060,銘異,5,0,5,凱基-頭份,2023-07-17,9296
3701,大眾控,5,0,5,凱基-頭份,2023-07-17,9296
4908,前鼎,5,0,5,凱基-頭份,2023-07-17,9296
6226,光鼎,5,0,5,凱基-頭份,2023-07-17,9296
8097,常珵,5,0,5,凱基-頭份,2023-07-17,9296
8401,白紗科,5,0,5,凱基-頭份,2023-07-17,9296
00882,中信中國高股息,4,0,4,凱基-頭份,2023-07-17,9296
2303,聯電,6,2,4,凱基-頭份,2023-07-17,9296
00632R,元大台灣50反1,107,10,97,凱基-頭份,2023-07-18,9296
2324,仁寶,81,20,61,凱基-頭份,2023-07-18,9296
00882,中信中國高股息,58,1,57,凱基-頭份,2023-07-18,9296
2363,矽統,51,1,50,凱基-頭份,2023-07-18,9296
5876,上海商銀,50,0,50,凱基-頭份,2023-07-18,9296
00692,富邦公司治理,49,0,49,凱基-頭份,2023-07-18,9296
2812,台中銀,53,10,43,凱基-頭份,2023-07-18,9296
1905,華紙,39,0,39,凱基-頭份,2023-07-18,9296
3706,神達,55,16,39,凱基-頭份,2023-07-18,9296
1101,台泥,28,0,28,凱基-頭份,2023-07-18,9296
3710,連展投控,27,0,27,凱基-頭份,2023-07-18,9296
00922,國泰台灣領袖50,22,0,22,凱基-頭份,2023-07-18,9296
2401,凌陽,102,80,22,凱基-頭份,2023-07-18,9296
4414,如興,21,0,21,凱基-頭份,2023-07-18,9296
00637L,元大滬深300正2,20,0,20,凱基-頭份,2023-07-18,9296
1609,大亞,26,6,20,凱基-頭份,2023-07-18,9296
4967,十銓,20,1,19,凱基-頭份,2023-07-18,9296
6282,康舒,46,27,19,凱基-頭份,2023-07-18,9296
4938,和碩,20,4,16,凱基-頭份,2023-07-18,9296
2332,友訊,16,0,16,凱基-頭份,2023-07-18,9296
6188,廣明,23,7,16,凱基-頭份,2023-07-18,9296
4533,協易機,14,1,13,凱基-頭份,2023-07-18,9296
2419,仲琦,39,27,12,凱基-頭份,2023-07-18,9296
2353,宏��,43,31,12,凱基-頭份,2023-07-18,9296
1528,恩德,10,0,10,凱基-頭份,2023-07-18,9296
2371,大同,10,0,10,凱基-頭份,2023-07-18,9296
2409,友達,13,3,10,凱基-頭份,2023-07-18,9296
3004,豐達科,10,0,10,凱基-頭份,2023-07-18,9296
3005,神基,11,1,10,凱基-頭份,2023-07-18,9296
6570,維田,10,0,10,凱基-頭份,2023-07-18,9296
2356,英業達,88,79,9,凱基-頭份,2023-07-18,9296
00772B,中信高評級公司債,10,1,9,凱基-頭份,2023-07-18,9296
00881,國泰台灣5G+,10,1,9,凱基-頭份,2023-07-18,9296
3356,奇偶,12,3,9,凱基-頭份,2023-07-18,9296
3689,湧德,9,0,9,凱基-頭份,2023-07-18,9296
1220,台榮,8,0,8,凱基-頭份,2023-07-18,9296
5607,遠雄港,8,0,8,凱基-頭份,2023-07-18,9296
6191,精成科,10,2,8,凱基-頭份,2023-07-18,9296
00925,新光標普電動車,7,0,7,凱基-頭份,2023-07-18,9296
1603,華電,7,0,7,凱基-頭份,2023-07-18,9296
2457,飛宏,8,1,7,凱基-頭份,2023-07-18,9296
3041,揚智,7,0,7,凱基-頭份,2023-07-18,9296
1314,中石化,6,0,6,凱基-頭份,2023-07-18,9296
2425,承啟,11,5,6,凱基-頭份,2023-07-18,9296
2610,華航,10,4,6,凱基-頭份,2023-07-18,9296
2890,永豐金,6,0,6,凱基-頭份,2023-07-18,9296
4532,瑞智,10,4,6,凱基-頭份,2023-07-18,9296
8409,商之器,6,0,6,凱基-頭份,2023-07-18,9296
8936,國統,7,1,6,凱基-頭份,2023-07-18,9296
6590,普鴻,6,0,6,凱基-頭份,2023-07-18,9296
00830,國泰費城半導體,50,3,47,凱基-頭份,2023-07-19,9296
2610,華航,34,0,34,凱基-頭份,2023-07-19,9296
3706,神達,91,59,32,凱基-頭份,2023-07-19,9296
00712,復華富時不動產,33,2,31,凱基-頭份,2023-07-19,9296
2353,宏��,44,15,29,凱基-頭份,2023-07-19,9296
2317,鴻海,29,3,26,凱基-頭份,2023-07-19,9296
3363,上詮,26,1,25,凱基-頭份,2023-07-19,9296
6116,彩晶,20,0,20,凱基-頭份,2023-07-19,9296
3078,僑威,21,4,17,凱基-頭份,2023-07-19,9296
00679B,元大美債20年,15,0,15,凱基-頭份,2023-07-19,9296
00929,復華台灣科技優息,17,2,15,凱基-頭份,2023-07-19,9296
00882,中信中國高股息,18,3,15,凱基-頭份,2023-07-19,9296
6218,豪勉,17,5,12,凱基-頭份,2023-07-19,9296
6282,康舒,18,7,11,凱基-頭份,2023-07-19,9296
00757,統一FANG+,10,0,10,凱基-頭份,2023-07-19,9296
2338,光罩,10,0,10,凱基-頭份,2023-07-19,9296
3051,力特,10,0,10,凱基-頭份,2023-07-19,9296
3213,茂訊,10,0,10,凱基-頭份,2023-07-19,9296
5351,鈺創,12,2,10,凱基-頭份,2023-07-19,9296
5469,瀚宇博,11,1,10,凱基-頭份,2023-07-19,9296
6535,順藥,10,0,10,凱基-頭份,2023-07-19,9296
9933,中鼎,10,0,10,凱基-頭份,2023-07-19,9296
2352,佳世達,22,13,9,凱基-頭份,2023-07-19,9296
3231,緯創,11,2,9,凱基-頭份,2023-07-19,9296
3028,增你強,9,0,9,凱基-頭份,2023-07-19,9296
4906,正文,11,2,9,凱基-頭份,2023-07-19,9296
2312,金寶,10,2,8,凱基-頭份,2023-07-19,9296
6191,精成科,11,3,8,凱基-頭份,2023-07-19,9296
1603,華電,8,1,7,凱基-頭份,2023-07-19,9296
2748,雲品,7,0,7,凱基-頭份,2023-07-19,9296
5443,均豪,7,0,7,凱基-頭份,2023-07-19,9296
1513,中興電,6,0,6,凱基-頭份,2023-07-19,9296
6488,環球晶,6,0,6,凱基-頭份,2023-07-19,9296
2881,富邦金,6,0,6,凱基-頭份,2023-07-19,9296
00905,FT臺灣Smart,6,0,6,凱基-頭份,2023-07-19,9296
2201,裕隆,8,2,6,凱基-頭份,2023-07-19,9296
3501,維熹,6,0,6,凱基-頭份,2023-07-19,9296
6550,北極星藥業-KY,7,1,6,凱基-頭份,2023-07-19,9296
00930,永豐ESG低碳高息,5,0,5,凱基-頭份,2023-07-19,9296
00881,國泰台灣5G+,5,0,5,凱基-頭份,2023-07-19,9296
00715L,期街口布蘭特正2,5,0,5,凱基-頭份,2023-07-19,9296
00713,元大台灣高息低波,5,0,5,凱基-頭份,2023-07-19,9296
2313,華通,5,0,5,凱基-頭份,2023-07-19,9296
2316,楠梓電,11,6,5,凱基-頭份,2023-07-19,9296
2399,映泰,10,5,5,凱基-頭份,2023-07-19,9296
2736,富野,5,0,5,凱基-頭份,2023-07-19,9296
4121,優盛,5,0,5,凱基-頭份,2023-07-19,9296
6235,華孚,14,9,5,凱基-頭份,2023-07-19,9296
6276,安鈦克,9,4,5,凱基-頭份,2023-07-19,9296
8038,長園科,5,0,5,凱基-頭份,2023-07-19,9296
2801,彰銀,104,0,104,凱基-頭份,2023-07-20,9296
00929,復華台灣科技優息,65,0,65,凱基-頭份,2023-07-20,9296
2303,聯電,36,2,34,凱基-頭份,2023-07-20,9296
6116,彩晶,31,0,31,凱基-頭份,2023-07-20,9296
00712,復華富時不動產,31,0,31,凱基-頭份,2023-07-20,9296
3481,群創,23,3,20,凱基-頭份,2023-07-20,9296
00687B,國泰20年美債,17,0,17,凱基-頭份,2023-07-20,9296
2897,王道銀行,14,0,14,凱基-頭份,2023-07-20,9296
1529,樂事綠能,15,2,13,凱基-頭份,2023-07-20,9296
2618,長榮航,17,4,13,凱基-頭份,2023-07-20,9296
1102,亞泥,13,0,13,凱基-頭份,2023-07-20,9296
00679B,元大美債20年,21,9,12,凱基-頭份,2023-07-20,9296
3005,神基,12,0,12,凱基-頭份,2023-07-20,9296
020034,元大IC設計N,11,0,11,凱基-頭份,2023-07-20,9296
2834,臺企銀,11,0,11,凱基-頭份,2023-07-20,9296
4153,鈺緯,18,8,10,凱基-頭份,2023-07-20,9296
5876,上海商銀,10,0,10,凱基-頭份,2023-07-20,9296
2374,佳能,10,1,9,凱基-頭份,2023-07-20,9296
5392,能率,10,1,9,凱基-頭份,2023-07-20,9296
8215,明基材,11,2,9,凱基-頭份,2023-07-20,9296
6282,康舒,18,10,8,凱基-頭份,2023-07-20,9296
3704,合勤控,17,9,8,凱基-頭份,2023-07-20,9296
6191,精成科,8,0,8,凱基-頭份,2023-07-20,9296
00900,富邦特選高股息30,8,1,7,凱基-頭份,2023-07-20,9296
2352,佳世達,19,12,7,凱基-頭份,2023-07-20,9296
00891,中信關鍵半導體,6,0,6,凱基-頭份,2023-07-20,9296
2516,新建,6,0,6,凱基-頭份,2023-07-20,9296
3013,晟銘電,11,5,6,凱基-頭份,2023-07-20,9296
6237,驊訊,6,0,6,凱基-頭份,2023-07-20,9296
6527,明達醫,7,1,6,凱基-頭份,2023-07-20,9296
00888,永豐台灣ESG,5,0,5,凱基-頭份,2023-07-20,9296
00665L,富邦�琤肭磪囓�2,5,0,5,凱基-頭份,2023-07-20,9296
2535,達欣工,5,0,5,凱基-頭份,2023-07-20,9296
3024,憶聲,5,0,5,凱基-頭份,2023-07-20,9296
3051,力特,5,0,5,凱基-頭份,2023-07-20,9296
6188,廣明,8,3,5,凱基-頭份,2023-07-20,9296
6290,良維,6,1,5,凱基-頭份,2023-07-20,9296
1513,中興電,4,0,4,凱基-頭份,2023-07-20,9296
00683L,期元大美元指正2,4,0,4,凱基-頭份,2023-07-20,9296
1527,鑽全,4,0,4,凱基-頭份,2023-07-20,9296
1795,美時,6,2,4,凱基-頭份,2023-07-20,9296
2316,楠梓電,13,9,4,凱基-頭份,2023-07-20,9296
2317,鴻海,8,4,4,凱基-頭份,2023-07-20,9296
2332,友訊,4,0,4,凱基-頭份,2023-07-20,9296
2344,華邦電,17,13,4,凱基-頭份,2023-07-20,9296
2486,一詮,7,3,4,凱基-頭份,2023-07-20,9296
2515,中工,4,0,4,凱基-頭份,2023-07-20,9296
6128,上福,5,1,4,凱基-頭份,2023-07-20,9296
6697,東捷資訊,4,0,4,凱基-頭份,2023-07-20,9296
2882,國泰金,4,1,3,凱基-頭份,2023-07-20,9296
6120,達運,62,5,57,凱基-頭份,2023-07-21,9296
3694,海華,31,0,31,凱基-頭份,2023-07-21,9296
1101,台泥,26,0,26,凱基-頭份,2023-07-21,9296
2610,華航,27,1,26,凱基-頭份,2023-07-21,9296
8933,愛地雅,20,0,20,凱基-頭份,2023-07-21,9296
2303,聯電,21,3,18,凱基-頭份,2023-07-21,9296
00929,復華台灣科技優息,18,0,18,凱基-頭份,2023-07-21,9296
4726,永昕,17,0,17,凱基-頭份,2023-07-21,9296
1905,華紙,36,20,16,凱基-頭份,2023-07-21,9296
00905,FT臺灣Smart,14,0,14,凱基-頭份,2023-07-21,9296
00712,復華富時不動產,14,1,13,凱基-頭份,2023-07-21,9296
00637L,元大滬深300正2,12,0,12,凱基-頭份,2023-07-21,9296
8411,福貞-KY,12,0,12,凱基-頭份,2023-07-21,9296
1513,中興電,22,11,11,凱基-頭份,2023-07-21,9296
1711,永光,31,20,11,凱基-頭份,2023-07-21,9296
2313,華通,11,0,11,凱基-頭份,2023-07-21,9296
6116,彩晶,21,10,11,凱基-頭份,2023-07-21,9296
2340,台亞,12,2,10,凱基-頭份,2023-07-21,9296
2883,凱基金,10,0,10,凱基-頭份,2023-07-21,9296
3324,雙鴻,10,1,9,凱基-頭份,2023-07-21,9296
2356,英業達,26,17,9,凱基-頭份,2023-07-21,9296
4532,瑞智,9,0,9,凱基-頭份,2023-07-21,9296
4908,前鼎,21,12,9,凱基-頭份,2023-07-21,9296
6492,生華科,9,0,9,凱基-頭份,2023-07-21,9296
2017,官田鋼,13,5,8,凱基-頭份,2023-07-21,9296
4906,正文,8,0,8,凱基-頭份,2023-07-21,9296
1102,亞泥,17,10,7,凱基-頭份,2023-07-21,9296
00720B,元大投資級公司債,7,0,7,凱基-頭份,2023-07-21,9296
2401,凌陽,6,0,6,凱基-頭份,2023-07-21,9296
2609,陽明,123,117,6,凱基-頭份,2023-07-21,9296
3289,宜特,13,7,6,凱基-頭份,2023-07-21,9296
6282,康舒,19,13,6,凱基-頭份,2023-07-21,9296
6609,瀧澤科,6,0,6,凱基-頭份,2023-07-21,9296
1529,樂事綠能,5,0,5,凱基-頭份,2023-07-21,9296
1789,神隆,5,0,5,凱基-頭份,2023-07-21,9296
1904,正隆,5,0,5,凱基-頭份,2023-07-21,9296
2736,富野,5,0,5,凱基-頭份,2023-07-21,9296
3024,憶聲,5,0,5,凱基-頭份,2023-07-21,9296
3078,僑威,8,3,5,凱基-頭份,2023-07-21,9296
4108,懷特,5,0,5,凱基-頭份,2023-07-21,9296
8044,網家,5,0,5,凱基-頭份,2023-07-21,9296
8104,錸寶,5,0,5,凱基-頭份,2023-07-21,9296
2352,佳世達,6,1,5,凱基-頭份,2023-07-21,9296
1432,大魯閣,4,0,4,凱基-頭份,2023-07-21,9296
1727,中華化,8,4,4,凱基-頭份,2023-07-21,9296
3055,蔚華科,5,1,4,凱基-頭份,2023-07-21,9296
3450,聯鈞,4,0,4,凱基-頭份,2023-07-21,9296
6274,台燿,5,1,4,凱基-頭份,2023-07-21,9296
6690,安�硌穈T,4,0,4,凱基-頭份,2023-07-21,9296
00679B,元大美債20年,3,0,3,凱基-頭份,2023-07-21,9296
2801,彰銀,145,0,145,凱基-頭份,2023-07-24,9296
00929,復華台灣科技優息,119,0,119,凱基-頭份,2023-07-24,9296
2883,凱基金,44,0,44,凱基-頭份,2023-07-24,9296
00712,復華富時不動產,42,0,42,凱基-頭份,2023-07-24,9296
2461,光群雷,52,15,37,凱基-頭份,2023-07-24,9296
3149,正達,35,0,35,凱基-頭份,2023-07-24,9296
3078,僑威,34,1,33,凱基-頭份,2023-07-24,9296
1609,大亞,59,29,30,凱基-頭份,2023-07-24,9296
1503,士電,29,1,28,凱基-頭份,2023-07-24,9296
3363,上詮,25,0,25,凱基-頭份,2023-07-24,9296
1504,東元,33,9,24,凱基-頭份,2023-07-24,9296
2887,台新金,24,0,24,凱基-頭份,2023-07-24,9296
2344,華邦電,32,11,21,凱基-頭份,2023-07-24,9296
00930,永豐ESG低碳高息,20,0,20,凱基-頭份,2023-07-24,9296
00673R,期元大S＆P原油反1,20,0,20,凱基-頭份,2023-07-24,9296
6570,維田,20,0,20,凱基-頭份,2023-07-24,9296
6125,廣運,42,24,18,凱基-頭份,2023-07-24,9296
2352,佳世達,22,4,18,凱基-頭份,2023-07-24,9296
2610,華航,22,6,16,凱基-頭份,2023-07-24,9296
3051,力特,16,0,16,凱基-頭份,2023-07-24,9296
3213,茂訊,15,0,15,凱基-頭份,2023-07-24,9296
3704,合勤控,15,0,15,凱基-頭份,2023-07-24,9296
8076,伍豐,14,0,14,凱基-頭份,2023-07-24,9296
00637L,元大滬深300正2,13,0,13,凱基-頭份,2023-07-24,9296
2419,仲琦,63,50,13,凱基-頭份,2023-07-24,9296
6841,長佳智能,14,1,13,凱基-頭份,2023-07-24,9296
2388,威盛,13,1,12,凱基-頭份,2023-07-24,9296
00753L,中信中國50正2,10,0,10,凱基-頭份,2023-07-24,9296
2457,飛宏,15,5,10,凱基-頭份,2023-07-24,9296
2812,台中銀,10,0,10,凱基-頭份,2023-07-24,9296
4967,十銓,10,0,10,凱基-頭份,2023-07-24,9296
2834,臺企銀,16,7,9,凱基-頭份,2023-07-24,9296
8034,榮群,9,0,9,凱基-頭份,2023-07-24,9296
2303,聯電,8,0,8,凱基-頭份,2023-07-24,9296
2442,新美齊,8,0,8,凱基-頭份,2023-07-24,9296
3037,欣興,15,7,8,凱基-頭份,2023-07-24,9296
2313,華通,11,4,7,凱基-頭份,2023-07-24,9296
3260,威剛,8,1,7,凱基-頭份,2023-07-24,9296
3596,智易,7,0,7,凱基-頭份,2023-07-24,9296
8488,吉源-KY,7,0,7,凱基-頭份,2023-07-24,9296
4995,晶達,6,0,6,凱基-頭份,2023-07-24,9296
00878,國泰永續高股息,34,28,6,凱基-頭份,2023-07-24,9296
00882,中信中國高股息,6,0,6,凱基-頭份,2023-07-24,9296
1909,榮成,7,1,6,凱基-頭份,2023-07-24,9296
4123,晟德,10,4,6,凱基-頭份,2023-07-24,9296
8112,至上,6,0,6,凱基-頭份,2023-07-24,9296
00679B,元大美債20年,5,0,5,凱基-頭份,2023-07-24,9296
2022,聚亨,5,0,5,凱基-頭份,2023-07-24,9296
2546,根基,5,0,5,凱基-頭份,2023-07-24,9296
2882,國泰金,5,0,5,凱基-頭份,2023-07-24,9296
0056,元大高股息,61,6,55,凱基-頭份,2023-07-25,9296
00878,國泰永續高股息,56,21,35,凱基-頭份,2023-07-25,9296
2618,長榮航,29,5,24,凱基-頭份,2023-07-25,9296
00632R,元大台灣50反1,20,0,20,凱基-頭份,2023-07-25,9296
5871,中租-KY,21,2,19,凱基-頭份,2023-07-25,9296
3231,緯創,19,3,16,凱基-頭份,2023-07-25,9296
00673R,期元大S＆P原油反1,15,0,15,凱基-頭份,2023-07-25,9296
1905,華紙,44,30,14,凱基-頭份,2023-07-25,9296
00915,凱基優選高股息30,13,0,13,凱基-頭份,2023-07-25,9296
2030,彰源,13,0,13,凱基-頭份,2023-07-25,9296
3055,蔚華科,18,5,13,凱基-頭份,2023-07-25,9296
8076,伍豐,13,0,13,凱基-頭份,2023-07-25,9296
2812,台中銀,12,0,12,凱基-頭份,2023-07-25,9296
5483,中美晶,28,16,12,凱基-頭份,2023-07-25,9296
3227,原相,19,8,11,凱基-頭份,2023-07-25,9296
00733,富邦臺灣中小,10,0,10,凱基-頭份,2023-07-25,9296
00706L,期元大S＆P日圓正2,10,0,10,凱基-頭份,2023-07-25,9296
00926,凱基全球菁英55,10,0,10,凱基-頭份,2023-07-25,9296
020030,統一智慧電動車N,10,0,10,凱基-頭份,2023-07-25,9296
2014,中鴻,10,0,10,凱基-頭份,2023-07-25,9296
2038,海光,10,0,10,凱基-頭份,2023-07-25,9296
2353,宏��,18,8,10,凱基-頭份,2023-07-25,9296
2515,中工,10,0,10,凱基-頭份,2023-07-25,9296
5388,中磊,10,0,10,凱基-頭份,2023-07-25,9296
3706,神達,14,5,9,凱基-頭份,2023-07-25,9296
00929,復華台灣科技優息,12,3,9,凱基-頭份,2023-07-25,9296
3037,欣興,23,14,9,凱基-頭份,2023-07-25,9296
2408,南亞科,9,0,9,凱基-頭份,2023-07-25,9296
4746,台耀,9,0,9,凱基-頭份,2023-07-25,9296
00679B,元大美債20年,8,0,8,凱基-頭份,2023-07-25,9296
1402,遠東新,8,0,8,凱基-頭份,2023-07-25,9296
2002,中鋼,10,2,8,凱基-頭份,2023-07-25,9296
2382,廣達,40,33,7,凱基-頭份,2023-07-25,9296
1442,名軒,7,0,7,凱基-頭份,2023-07-25,9296
2301,光寶科,9,2,7,凱基-頭份,2023-07-25,9296
3056,富華新,7,0,7,凱基-頭份,2023-07-25,9296
3071,協禧,18,12,6,凱基-頭份,2023-07-25,9296
3114,好德,6,0,6,凱基-頭份,2023-07-25,9296
3363,上詮,7,1,6,凱基-頭份,2023-07-25,9296
3689,湧德,6,0,6,凱基-頭份,2023-07-25,9296
4953,緯軟,10,4,6,凱基-頭份,2023-07-25,9296
00720B,元大投資級公司債,5,0,5,凱基-頭份,2023-07-25,9296
00891,中信關鍵半導體,5,0,5,凱基-頭份,2023-07-25,9296
00683L,期元大美元指正2,5,0,5,凱基-頭份,2023-07-25,9296
00900,富邦特選高股息30,6,1,5,凱基-頭份,2023-07-25,9296
00751B,元大AAA至A公司債,5,0,5,凱基-頭份,2023-07-25,9296
1609,大亞,9,4,5,凱基-頭份,2023-07-25,9296
1612,宏泰,8,3,5,凱基-頭份,2023-07-25,9296
2102,泰豐,5,0,5,凱基-頭份,2023-07-25,9296
2887,台新金,5,0,5,凱基-頭份,2023-07-25,9296
2344,華邦電,39,14,25,凱基-頭份,2023-07-26,9296
2027,大成鋼,22,0,22,凱基-頭份,2023-07-26,9296
1503,士電,22,1,21,凱基-頭份,2023-07-26,9296
2515,中工,20,0,20,凱基-頭份,2023-07-26,9296
2332,友訊,20,1,19,凱基-頭份,2023-07-26,9296
00929,復華台灣科技優息,17,2,15,凱基-頭份,2023-07-26,9296
1504,東元,47,33,14,凱基-頭份,2023-07-26,9296
2399,映泰,14,0,14,凱基-頭份,2023-07-26,9296
4726,永昕,15,1,14,凱基-頭份,2023-07-26,9296
2338,光罩,18,5,13,凱基-頭份,2023-07-26,9296
1609,大亞,13,2,11,凱基-頭份,2023-07-26,9296
2548,華固,11,0,11,凱基-頭份,2023-07-26,9296
6125,廣運,31,21,10,凱基-頭份,2023-07-26,9296
00878,國泰永續高股息,37,27,10,凱基-頭份,2023-07-26,9296
1608,華榮,10,0,10,凱基-頭份,2023-07-26,9296
2206,三陽工業,11,1,10,凱基-頭份,2023-07-26,9296
2883,凱基金,20,10,10,凱基-頭份,2023-07-26,9296
4904,遠傳,10,0,10,凱基-頭份,2023-07-26,9296
5469,瀚宇博,10,0,10,凱基-頭份,2023-07-26,9296
6116,彩晶,10,0,10,凱基-頭份,2023-07-26,9296
6499,益安,10,0,10,凱基-頭份,2023-07-26,9296
00679B,元大美債20年,9,0,9,凱基-頭份,2023-07-26,9296
2352,佳世達,16,8,8,凱基-頭份,2023-07-26,9296
1402,遠東新,7,0,7,凱基-頭份,2023-07-26,9296
8358,金居,12,5,7,凱基-頭份,2023-07-26,9296
00674R,期元大S＆P黃金反1,6,0,6,凱基-頭份,2023-07-26,9296
2425,承啟,10,4,6,凱基-頭份,2023-07-26,9296
3714,富采,6,0,6,凱基-頭份,2023-07-26,9296
5483,中美晶,28,22,6,凱基-頭份,2023-07-26,9296
6770,力積電,6,0,6,凱基-頭份,2023-07-26,9296
2002,中鋼,5,0,5,凱基-頭份,2023-07-26,9296
1528,恩德,5,0,5,凱基-頭份,2023-07-26,9296
1612,宏泰,10,5,5,凱基-頭份,2023-07-26,9296
1789,神隆,5,0,5,凱基-頭份,2023-07-26,9296
2897,王道銀行,5,0,5,凱基-頭份,2023-07-26,9296
3088,艾訊,6,1,5,凱基-頭份,2023-07-26,9296
3704,合勤控,5,0,5,凱基-頭份,2023-07-26,9296
5443,均豪,20,15,5,凱基-頭份,2023-07-26,9296
6104,創惟,7,2,5,凱基-頭份,2023-07-26,9296
6218,豪勉,10,5,5,凱基-頭份,2023-07-26,9296
8383,千附,5,0,5,凱基-頭份,2023-07-26,9296
2376,技嘉,14,10,4,凱基-頭份,2023-07-26,9296
2436,偉詮電,5,1,4,凱基-頭份,2023-07-26,9296
00637L,元大滬深300正2,5,1,4,凱基-頭份,2023-07-26,9296
3025,星通,4,0,4,凱基-頭份,2023-07-26,9296
3037,欣興,11,7,4,凱基-頭份,2023-07-26,9296
3162,精確,4,0,4,凱基-頭份,2023-07-26,9296
3265,台星科,4,0,4,凱基-頭份,2023-07-26,9296
5864,致和證,4,0,4,凱基-頭份,2023-07-26,9296
6217,中探針,4,0,4,凱基-頭份,2023-07-26,9296
00665L,富邦�琤肭磪囓�2,80,0,80,凱基-頭份,2023-07-27,9296
2883,凱基金,60,3,57,凱基-頭份,2023-07-27,9296
00753L,中信中國50正2,50,0,50,凱基-頭份,2023-07-27,9296
2884,玉山金,28,2,26,凱基-頭份,2023-07-27,9296
6283,淳安,25,0,25,凱基-頭份,2023-07-27,9296
1301,台塑,23,0,23,凱基-頭份,2023-07-27,9296
4414,如興,23,0,23,凱基-頭份,2023-07-27,9296
00680L,元大美債20正2,20,0,20,凱基-頭份,2023-07-27,9296
2009,第一銅,25,5,20,凱基-頭份,2023-07-27,9296
3051,力特,20,0,20,凱基-頭份,2023-07-27,9296
5439,高技,20,0,20,凱基-頭份,2023-07-27,9296
1560,中砂,17,3,14,凱基-頭份,2023-07-27,9296
00679B,元大美債20年,13,0,13,凱基-頭份,2023-07-27,9296
2382,廣達,34,21,13,凱基-頭份,2023-07-27,9296
00902,中信電池及儲能,13,0,13,凱基-頭份,2023-07-27,9296
8176,智捷,13,0,13,凱基-頭份,2023-07-27,9296
4123,晟德,11,0,11,凱基-頭份,2023-07-27,9296
4726,永昕,11,0,11,凱基-頭份,2023-07-27,9296
00632R,元大台灣50反1,10,0,10,凱基-頭份,2023-07-27,9296
00664R,國泰臺灣加權反1,10,0,10,凱基-頭份,2023-07-27,9296
1313,聯成,10,0,10,凱基-頭份,2023-07-27,9296
2206,三陽工業,10,0,10,凱基-頭份,2023-07-27,9296
3027,盛達,10,0,10,凱基-頭份,2023-07-27,9296
5880,合庫金,10,0,10,凱基-頭份,2023-07-27,9296
2603,長榮,45,36,9,凱基-頭份,2023-07-27,9296
2356,英業達,15,7,8,凱基-頭份,2023-07-27,9296
1303,南亞,8,0,8,凱基-頭份,2023-07-27,9296
1612,宏泰,13,5,8,凱基-頭份,2023-07-27,9296
3163,波若威,13,5,8,凱基-頭份,2023-07-27,9296
6770,力積電,11,3,8,凱基-頭份,2023-07-27,9296
2609,陽明,140,133,7,凱基-頭份,2023-07-27,9296
2882,國泰金,8,1,7,凱基-頭份,2023-07-27,9296
00772B,中信高評級公司債,6,0,6,凱基-頭份,2023-07-27,9296
00882,中信中國高股息,6,0,6,凱基-頭份,2023-07-27,9296
1532,勤美,6,0,6,凱基-頭份,2023-07-27,9296
2002,中鋼,6,0,6,凱基-頭份,2023-07-27,9296
3078,僑威,10,4,6,凱基-頭份,2023-07-27,9296
00722B,群益投資級電信債,5,0,5,凱基-頭份,2023-07-27,9296
00891,中信關鍵半導體,5,0,5,凱基-頭份,2023-07-27,9296
1513,中興電,6,1,5,凱基-頭份,2023-07-27,9296
1525,江申,5,0,5,凱基-頭份,2023-07-27,9296
1528,恩德,10,5,5,凱基-頭份,2023-07-27,9296
2313,華通,5,0,5,凱基-頭份,2023-07-27,9296
2457,飛宏,6,1,5,凱基-頭份,2023-07-27,9296
2548,華固,5,0,5,凱基-頭份,2023-07-27,9296
2637,慧洋-KY,6,1,5,凱基-頭份,2023-07-27,9296
2801,彰銀,5,0,5,凱基-頭份,2023-07-27,9296
2939,永邑-KY,5,0,5,凱基-頭份,2023-07-27,9296
3038,全台,5,0,5,凱基-頭份,2023-07-27,9296
3287,廣寰科,5,0,5,凱基-頭份,2023-07-27,9296
00830,國泰費城半導體,50,1,49,凱基-頭份,2023-07-28,9296
1905,華紙,49,15,34,凱基-頭份,2023-07-28,9296
2329,華泰,74,41,33,凱基-頭份,2023-07-28,9296
00753L,中信中國50正2,30,0,30,凱基-頭份,2023-07-28,9296
2409,友達,36,14,22,凱基-頭份,2023-07-28,9296
3710,連展投控,27,5,22,凱基-頭份,2023-07-28,9296
00665L,富邦�琤肭磪囓�2,20,0,20,凱基-頭份,2023-07-28,9296
2883,凱基金,18,0,18,凱基-頭份,2023-07-28,9296
00637L,元大滬深300正2,21,4,17,凱基-頭份,2023-07-28,9296
2888,新光金,16,0,16,凱基-頭份,2023-07-28,9296
6282,康舒,19,3,16,凱基-頭份,2023-07-28,9296
00878,國泰永續高股息,24,9,15,凱基-頭份,2023-07-28,9296
2419,仲琦,17,2,15,凱基-頭份,2023-07-28,9296
2610,華航,22,7,15,凱基-頭份,2023-07-28,9296
00680L,元大美債20正2,14,0,14,凱基-頭份,2023-07-28,9296
1783,和康生,14,0,14,凱基-頭份,2023-07-28,9296
4707,磐亞,14,0,14,凱基-頭份,2023-07-28,9296
2618,長榮航,14,0,14,凱基-頭份,2023-07-28,9296
00772B,中信高評級公司債,13,0,13,凱基-頭份,2023-07-28,9296
00679B,元大美債20年,13,0,13,凱基-頭份,2023-07-28,9296
00720B,元大投資級公司債,13,0,13,凱基-頭份,2023-07-28,9296
00929,復華台灣科技優息,13,0,13,凱基-頭份,2023-07-28,9296
2881,富邦金,12,0,12,凱基-頭份,2023-07-28,9296
6187,萬潤,13,1,12,凱基-頭份,2023-07-28,9296
3205,佰研,11,0,11,凱基-頭份,2023-07-28,9296
00632R,元大台灣50反1,10,0,10,凱基-頭份,2023-07-28,9296
3322,建舜電,10,0,10,凱基-頭份,2023-07-28,9296
00857B,永豐20年美公債,9,0,9,凱基-頭份,2023-07-28,9296
4123,晟德,9,0,9,凱基-頭份,2023-07-28,9296
3702,大聯大,9,1,8,凱基-頭份,2023-07-28,9296
5230,雷笛克光學,8,0,8,凱基-頭份,2023-07-28,9296
5388,中磊,10,2,8,凱基-頭份,2023-07-28,9296
6499,益安,8,0,8,凱基-頭份,2023-07-28,9296
00687B,國泰20年美債,7,0,7,凱基-頭份,2023-07-28,9296
1504,東元,7,0,7,凱基-頭份,2023-07-28,9296
2539,櫻花建,7,0,7,凱基-頭份,2023-07-28,9296
3704,合勤控,12,5,7,凱基-頭份,2023-07-28,9296
5386,青雲,7,0,7,凱基-頭份,2023-07-28,9296
1513,中興電,7,1,6,凱基-頭份,2023-07-28,9296
2002,中鋼,6,0,6,凱基-頭份,2023-07-28,9296
1319,東陽,14,8,6,凱基-頭份,2023-07-28,9296
1802,台玻,6,0,6,凱基-頭份,2023-07-28,9296
2344,華邦電,123,117,6,凱基-頭份,2023-07-28,9296
2471,資通,9,3,6,凱基-頭份,2023-07-28,9296
3004,豐達科,6,0,6,凱基-頭份,2023-07-28,9296
4526,東台,9,3,6,凱基-頭份,2023-07-28,9296
5880,合庫金,6,0,6,凱基-頭份,2023-07-28,9296
3056,富華新,17,11,6,凱基-頭份,2023-07-28,9296
00895,富邦未來車,5,0,5,凱基-頭份,2023-07-28,9296
1711,永光,5,0,5,凱基-頭份,2023-07-28,9296
2883,凱基金,231,0,231,凱基-頭份,2023-07-31,9296
00878,國泰永續高股息,97,19,78,凱基-頭份,2023-07-31,9296
2312,金寶,74,9,65,凱基-頭份,2023-07-31,9296
4207,環泰,60,0,60,凱基-頭份,2023-07-31,9296
00706L,期元大S＆P日圓正2,51,0,51,凱基-頭份,2023-07-31,9296
2419,仲琦,101,54,47,凱基-頭份,2023-07-31,9296
912000,晨訊科-DR,47,0,47,凱基-頭份,2023-07-31,9296
2610,華航,30,0,30,凱基-頭份,2023-07-31,9296
2002,中鋼,30,2,28,凱基-頭份,2023-07-31,9296
3078,僑威,49,23,26,凱基-頭份,2023-07-31,9296
00673R,期元大S＆P原油反1,25,0,25,凱基-頭份,2023-07-31,9296
00753L,中信中國50正2,24,1,23,凱基-頭份,2023-07-31,9296
00900,富邦特選高股息30,25,2,23,凱基-頭份,2023-07-31,9296
3338,泰碩,23,0,23,凱基-頭份,2023-07-31,9296
2329,華泰,37,15,22,凱基-頭份,2023-07-31,9296
00905,FT臺灣Smart,21,0,21,凱基-頭份,2023-07-31,9296
00665L,富邦�琤肭磪囓�2,227,207,20,凱基-頭份,2023-07-31,9296
1409,新纖,20,0,20,凱基-頭份,2023-07-31,9296
1503,士電,20,0,20,凱基-頭份,2023-07-31,9296
2606,裕民,20,1,19,凱基-頭份,2023-07-31,9296
0056,元大高股息,28,10,18,凱基-頭份,2023-07-31,9296
3363,上詮,17,0,17,凱基-頭份,2023-07-31,9296
3481,群創,24,7,17,凱基-頭份,2023-07-31,9296
3051,力特,16,0,16,凱基-頭份,2023-07-31,9296
6138,茂達,16,0,16,凱基-頭份,2023-07-31,9296
6589,台康生技,16,0,16,凱基-頭份,2023-07-31,9296
1101,台泥,20,5,15,凱基-頭份,2023-07-31,9296
2382,廣達,30,16,14,凱基-頭份,2023-07-31,9296
2884,玉山金,14,0,14,凱基-頭份,2023-07-31,9296
4919,新唐,16,3,13,凱基-頭份,2023-07-31,9296
2887,台新金,11,0,11,凱基-頭份,2023-07-31,9296
2402,毅嘉,18,7,11,凱基-頭份,2023-07-31,9296
2882,國泰金,11,0,11,凱基-頭份,2023-07-31,9296
3013,晟銘電,16,5,11,凱基-頭份,2023-07-31,9296
4960,誠美材,11,0,11,凱基-頭份,2023-07-31,9296
2340,台亞,15,4,11,凱基-頭份,2023-07-31,9296
00882,中信中國高股息,11,1,10,凱基-頭份,2023-07-31,9296
1102,亞泥,10,0,10,凱基-頭份,2023-07-31,9296
3033,威健,10,0,10,凱基-頭份,2023-07-31,9296
6570,維田,10,0,10,凱基-頭份,2023-07-31,9296
9927,泰銘,12,2,10,凱基-頭份,2023-07-31,9296
8028,昇陽半導體,9,0,9,凱基-頭份,2023-07-31,9296
1815,富喬,11,3,8,凱基-頭份,2023-07-31,9296
2324,仁寶,10,2,8,凱基-頭份,2023-07-31,9296
2634,漢翔,13,5,8,凱基-頭份,2023-07-31,9296
6552,易華電,8,0,8,凱基-頭份,2023-07-31,9296
1513,中興電,24,16,8,凱基-頭份,2023-07-31,9296
2206,三陽工業,10,3,7,凱基-頭份,2023-07-31,9296
3324,雙鴻,15,9,6,凱基-頭份,2023-07-31,9296
3056,富華新,10,4,6,凱基-頭份,2023-07-31,9296
1532,勤美,45,0,45,凱基-頭份,2023-08-01,9296
00929,復華台灣科技優息,38,0,38,凱基-頭份,2023-08-01,9296
00715L,期街口布蘭特正2,30,0,30,凱基-頭份,2023-08-01,9296
00878,國泰永續高股息,66,45,21,凱基-頭份,2023-08-01,9296
0056,元大高股息,17,1,16,凱基-頭份,2023-08-01,9296
3013,晟銘電,14,0,14,凱基-頭份,2023-08-01,9296
2338,光罩,13,0,13,凱基-頭份,2023-08-01,9296
2913,農林,25,12,13,凱基-頭份,2023-08-01,9296
2409,友達,17,5,12,凱基-頭份,2023-08-01,9296
3231,緯創,39,28,11,凱基-頭份,2023-08-01,9296
1305,華夏,11,0,11,凱基-頭份,2023-08-01,9296
2891,中信金,10,0,10,凱基-頭份,2023-08-01,9296
00665L,富邦�琤肭磪囓�2,60,50,10,凱基-頭份,2023-08-01,9296
2426,鼎元,10,0,10,凱基-頭份,2023-08-01,9296
2748,雲品,10,0,10,凱基-頭份,2023-08-01,9296
8092,建暐,10,0,10,凱基-頭份,2023-08-01,9296
6282,康舒,19,10,9,凱基-頭份,2023-08-01,9296
2461,光群雷,13,4,9,凱基-頭份,2023-08-01,9296
2883,凱基金,10,1,9,凱基-頭份,2023-08-01,9296
3257,虹冠電,13,4,9,凱基-頭份,2023-08-01,9296
3625,西勝,15,6,9,凱基-頭份,2023-08-01,9296
6770,力積電,9,0,9,凱基-頭份,2023-08-01,9296
00919,群益台灣精選高息,8,0,8,凱基-頭份,2023-08-01,9296
1710,東聯,10,2,8,凱基-頭份,2023-08-01,9296
3591,艾笛森,8,0,8,凱基-頭份,2023-08-01,9296
2301,光寶科,13,5,8,凱基-頭份,2023-08-01,9296
00637L,元大滬深300正2,11,4,7,凱基-頭份,2023-08-01,9296
00764B,群益25年美債,7,0,7,凱基-頭份,2023-08-01,9296
00753L,中信中國50正2,10,3,7,凱基-頭份,2023-08-01,9296
2363,矽統,8,1,7,凱基-頭份,2023-08-01,9296
5328,華容,7,0,7,凱基-頭份,2023-08-01,9296
6283,淳安,7,0,7,凱基-頭份,2023-08-01,9296
6684,安格,11,4,7,凱基-頭份,2023-08-01,9296
8176,智捷,7,0,7,凱基-頭份,2023-08-01,9296
00885,富邦越南,24,18,6,凱基-頭份,2023-08-01,9296
2408,南亞科,6,0,6,凱基-頭份,2023-08-01,9296
3051,力特,6,0,6,凱基-頭份,2023-08-01,9296
3149,正達,6,0,6,凱基-頭份,2023-08-01,9296
1905,華紙,13,8,5,凱基-頭份,2023-08-01,9296
00679B,元大美債20年,5,0,5,凱基-頭份,2023-08-01,9296
6285,啟��,17,12,5,凱基-頭份,2023-08-01,9296
00891,中信關鍵半導體,5,0,5,凱基-頭份,2023-08-01,9296
00641R,富邦日本反1,5,0,5,凱基-頭份,2023-08-01,9296
00632R,元大台灣50反1,5,0,5,凱基-頭份,2023-08-01,9296
1522,堤維西,5,0,5,凱基-頭份,2023-08-01,9296
1609,大亞,7,2,5,凱基-頭份,2023-08-01,9296
2377,微星,5,0,5,凱基-頭份,2023-08-01,9296
2402,毅嘉,6,1,5,凱基-頭份,2023-08-01,9296
6443,元晶,5,0,5,凱基-頭份,2023-08-01,9296
9907,統一實,5,0,5,凱基-頭份,2023-08-01,9296
00878,國泰永續高股息,197,137,60,凱基-頭份,2023-08-02,9296
00929,復華台灣科技優息,59,0,59,凱基-頭份,2023-08-02,9296
2344,華邦電,59,6,53,凱基-頭份,2023-08-02,9296
00665L,富邦�琤肭磪囓�2,50,0,50,凱基-頭份,2023-08-02,9296
00900,富邦特選高股息30,46,2,44,凱基-頭份,2023-08-02,9296
1605,華新,82,39,43,凱基-頭份,2023-08-02,9296
1742,台蠟,23,1,22,凱基-頭份,2023-08-02,9296
1503,士電,22,1,21,凱基-頭份,2023-08-02,9296
2603,長榮,21,0,21,凱基-頭份,2023-08-02,9296
00673R,期元大S＆P原油反1,20,0,20,凱基-頭份,2023-08-02,9296
2736,富野,20,0,20,凱基-頭份,2023-08-02,9296
4168,醣聯,20,0,20,凱基-頭份,2023-08-02,9296
4967,十銓,20,0,20,凱基-頭份,2023-08-02,9296
3481,群創,35,15,20,凱基-頭份,2023-08-02,9296
2382,廣達,55,41,14,凱基-頭份,2023-08-02,9296
00679B,元大美債20年,13,0,13,凱基-頭份,2023-08-02,9296
00923,群益台ESG低碳50,14,1,13,凱基-頭份,2023-08-02,9296
3363,上詮,13,0,13,凱基-頭份,2023-08-02,9296
2338,光罩,12,0,12,凱基-頭份,2023-08-02,9296
3035,智原,12,0,12,凱基-頭份,2023-08-02,9296
2301,光寶科,18,6,12,凱基-頭份,2023-08-02,9296
2457,飛宏,11,0,11,凱基-頭份,2023-08-02,9296
2888,新光金,12,1,11,凱基-頭份,2023-08-02,9296
2303,聯電,10,0,10,凱基-頭份,2023-08-02,9296
1217,愛之味,10,0,10,凱基-頭份,2023-08-02,9296
1612,宏泰,20,10,10,凱基-頭份,2023-08-02,9296
2208,台船,10,0,10,凱基-頭份,2023-08-02,9296
2890,永豐金,10,0,10,凱基-頭份,2023-08-02,9296
4123,晟德,10,0,10,凱基-頭份,2023-08-02,9296
9921,巨大,10,0,10,凱基-頭份,2023-08-02,9296
3231,緯創,31,22,9,凱基-頭份,2023-08-02,9296
6499,益安,9,0,9,凱基-頭份,2023-08-02,9296
6590,普鴻,9,0,9,凱基-頭份,2023-08-02,9296
8215,明基材,8,0,8,凱基-頭份,2023-08-02,9296
2886,兆豐金,7,0,7,凱基-頭份,2023-08-02,9296
00688L,國泰20年美債正2,7,0,7,凱基-頭份,2023-08-02,9296
1514,亞力,8,1,7,凱基-頭份,2023-08-02,9296
2887,台新金,7,0,7,凱基-頭份,2023-08-02,9296
6182,合晶,7,0,7,凱基-頭份,2023-08-02,9296
8011,台通,7,0,7,凱基-頭份,2023-08-02,9296
8028,昇陽半導體,7,0,7,凱基-頭份,2023-08-02,9296
2317,鴻海,6,0,6,凱基-頭份,2023-08-02,9296
2376,技嘉,6,0,6,凱基-頭份,2023-08-02,9296
00888,永豐台灣ESG,6,0,6,凱基-頭份,2023-08-02,9296
00795B,中信美國公債20年,6,0,6,凱基-頭份,2023-08-02,9296
6218,豪勉,6,0,6,凱基-頭份,2023-08-02,9296
2002,中鋼,5,0,5,凱基-頭份,2023-08-02,9296
00687B,國泰20年美債,5,0,5,凱基-頭份,2023-08-02,9296
00857B,永豐20年美公債,10,5,5,凱基-頭份,2023-08-02,9296
00753L,中信中國50正2,8,3,5,凱基-頭份,2023-08-02,9296
2363,矽統,76,1,75,凱基-頭份,2023-08-04,9296
2344,華邦電,81,19,62,凱基-頭份,2023-08-04,9296
00680L,元大美債20正2,42,0,42,凱基-頭份,2023-08-04,9296
1532,勤美,30,0,30,凱基-頭份,2023-08-04,9296
2020,美亞,30,0,30,凱基-頭份,2023-08-04,9296
00679B,元大美債20年,36,9,27,凱基-頭份,2023-08-04,9296
6276,安鈦克,31,5,26,凱基-頭份,2023-08-04,9296
00929,復華台灣科技優息,23,0,23,凱基-頭份,2023-08-04,9296
1721,三晃,23,0,23,凱基-頭份,2023-08-04,9296
2440,太空梭,21,0,21,凱基-頭份,2023-08-04,9296
2104,國際中橡,20,2,18,凱基-頭份,2023-08-04,9296
1609,大亞,40,24,16,凱基-頭份,2023-08-04,9296
3149,正達,15,0,15,凱基-頭份,2023-08-04,9296
2891,中信金,19,5,14,凱基-頭份,2023-08-04,9296
00795B,中信美國公債20年,13,0,13,凱基-頭份,2023-08-04,9296
4123,晟德,20,7,13,凱基-頭份,2023-08-04,9296
1789,神隆,12,0,12,凱基-頭份,2023-08-04,9296
2890,永豐金,12,0,12,凱基-頭份,2023-08-04,9296
00715L,期街口布蘭特正2,11,0,11,凱基-頭份,2023-08-04,9296
00673R,期元大S＆P原油反1,11,0,11,凱基-頭份,2023-08-04,9296
2303,聯電,10,0,10,凱基-頭份,2023-08-04,9296
5871,中租-KY,11,1,10,凱基-頭份,2023-08-04,9296
1216,統一,10,0,10,凱基-頭份,2023-08-04,9296
00764B,群益25年美債,10,0,10,凱基-頭份,2023-08-04,9296
00895,富邦未來車,10,0,10,凱基-頭份,2023-08-04,9296
1314,中石化,10,0,10,凱基-頭份,2023-08-04,9296
1608,華榮,10,0,10,凱基-頭份,2023-08-04,9296
2633,台灣高鐵,10,0,10,凱基-頭份,2023-08-04,9296
2897,王道銀行,10,0,10,凱基-頭份,2023-08-04,9296
3013,晟銘電,20,10,10,凱基-頭份,2023-08-04,9296
4207,環泰,10,0,10,凱基-頭份,2023-08-04,9296
00857B,永豐20年美公債,9,0,9,凱基-頭份,2023-08-04,9296
2014,中鴻,16,7,9,凱基-頭份,2023-08-04,9296
2884,玉山金,9,0,9,凱基-頭份,2023-08-04,9296
1503,士電,10,2,8,凱基-頭份,2023-08-04,9296
2913,農林,38,30,8,凱基-頭份,2023-08-04,9296
4714,永捷,8,0,8,凱基-頭份,2023-08-04,9296
00687B,國泰20年美債,7,0,7,凱基-頭份,2023-08-04,9296
5258,虹堡,7,1,6,凱基-頭份,2023-08-04,9296
3706,神達,15,9,6,凱基-頭份,2023-08-04,9296
00900,富邦特選高股息30,9,3,6,凱基-頭份,2023-08-04,9296
1904,正隆,7,1,6,凱基-頭份,2023-08-04,9296
2402,毅嘉,11,5,6,凱基-頭份,2023-08-04,9296
3363,上詮,6,0,6,凱基-頭份,2023-08-04,9296
3707,漢磊,6,0,6,凱基-頭份,2023-08-04,9296
3231,緯創,32,26,6,凱基-頭份,2023-08-04,9296
2352,佳世達,12,7,5,凱基-頭份,2023-08-04,9296
9927,泰銘,5,0,5,凱基-頭份,2023-08-04,9296
00891,中信關鍵半導體,5,0,5,凱基-頭份,2023-08-04,9296
00905,FT臺灣Smart,5,0,5,凱基-頭份,2023-08-04,9296
00637L,元大滬深300正2,60,0,60,凱基-頭份,2023-08-07,9296
0056,元大高股息,42,12,30,凱基-頭份,2023-08-07,9296
3149,正達,28,0,28,凱基-頭份,2023-08-07,9296
00931B,統一美債20年,36,9,27,凱基-頭份,2023-08-07,9296
1108,幸福,25,0,25,凱基-頭份,2023-08-07,9296
00882,中信中國高股息,26,1,25,凱基-頭份,2023-08-07,9296
00673R,期元大S＆P原油反1,20,0,20,凱基-頭份,2023-08-07,9296
00664R,國泰臺灣加權反1,20,0,20,凱基-頭份,2023-08-07,9296
00632R,元大台灣50反1,20,0,20,凱基-頭份,2023-08-07,9296
1789,神隆,20,0,20,凱基-頭份,2023-08-07,9296
4105,東洋,20,0,20,凱基-頭份,2023-08-07,9296
4967,十銓,20,0,20,凱基-頭份,2023-08-07,9296
8390,金益鼎,17,3,14,凱基-頭份,2023-08-07,9296
1905,華紙,26,13,13,凱基-頭份,2023-08-07,9296
2610,華航,13,0,13,凱基-頭份,2023-08-07,9296
3491,昇達科,12,0,12,凱基-頭份,2023-08-07,9296
5452,佶優,12,0,12,凱基-頭份,2023-08-07,9296
6770,力積電,11,0,11,凱基-頭份,2023-08-07,9296
5213,亞昕,10,0,10,凱基-頭份,2023-08-07,9296
00895,富邦未來車,10,0,10,凱基-頭份,2023-08-07,9296
1609,大亞,33,23,10,凱基-頭份,2023-08-07,9296
2344,華邦電,14,4,10,凱基-頭份,2023-08-07,9296
2618,長榮航,10,0,10,凱基-頭份,2023-08-07,9296
2891,中信金,10,0,10,凱基-頭份,2023-08-07,9296
4126,太醫,10,0,10,凱基-頭份,2023-08-07,9296
2405,輔信,8,0,8,凱基-頭份,2023-08-07,9296
5009,榮剛,8,0,8,凱基-頭份,2023-08-07,9296
00929,復華台灣科技優息,9,1,8,凱基-頭份,2023-08-07,9296
6116,彩晶,7,0,7,凱基-頭份,2023-08-07,9296
00907,永豐優息存股,6,0,6,凱基-頭份,2023-08-07,9296
4563,百德,7,1,6,凱基-頭份,2023-08-07,9296
00679B,元大美債20年,6,0,6,凱基-頭份,2023-08-07,9296
2301,光寶科,19,14,5,凱基-頭份,2023-08-07,9296
00916,國泰全球品牌50,5,0,5,凱基-頭份,2023-08-07,9296
1504,東元,5,0,5,凱基-頭份,2023-08-07,9296
2734,易飛網,5,0,5,凱基-頭份,2023-08-07,9296
3213,茂訊,7,2,5,凱基-頭份,2023-08-07,9296
3289,宜特,5,0,5,凱基-頭份,2023-08-07,9296
3481,群創,7,2,5,凱基-頭份,2023-08-07,9296
3540,曜越,5,0,5,凱基-頭份,2023-08-07,9296
4157,太景*-KY,5,0,5,凱基-頭份,2023-08-07,9296
00687B,國泰20年美債,5,1,4,凱基-頭份,2023-08-07,9296
5871,中租-KY,4,0,4,凱基-頭份,2023-08-07,9296
00720B,元大投資級公司債,4,0,4,凱基-頭份,2023-08-07,9296
00710B,復華彭博非投等債,4,0,4,凱基-頭份,2023-08-07,9296
1459,聯發,4,0,4,凱基-頭份,2023-08-07,9296
2379,瑞昱,4,0,4,凱基-頭份,2023-08-07,9296
2609,陽明,4,0,4,凱基-頭份,2023-08-07,9296
2634,漢翔,4,0,4,凱基-頭份,2023-08-07,9296
2888,新光金,4,0,4,凱基-頭份,2023-08-07,9296
00929,復華台灣科技優息,118,0,118,凱基-頭份,2023-08-08,9296
1101,台泥,51,0,51,凱基-頭份,2023-08-08,9296
00900,富邦特選高股息30,51,0,51,凱基-頭份,2023-08-08,9296
2303,聯電,36,0,36,凱基-頭份,2023-08-08,9296
2344,華邦電,48,13,35,凱基-頭份,2023-08-08,9296
00878,國泰永續高股息,35,3,32,凱基-頭份,2023-08-08,9296
2009,第一銅,18,0,18,凱基-頭份,2023-08-08,9296
2329,華泰,25,9,16,凱基-頭份,2023-08-08,9296
8930,青鋼,16,0,16,凱基-頭份,2023-08-08,9296
2884,玉山金,14,0,14,凱基-頭份,2023-08-08,9296
2890,永豐金,13,0,13,凱基-頭份,2023-08-08,9296
6770,力積電,13,1,12,凱基-頭份,2023-08-08,9296
2356,英業達,34,23,11,凱基-頭份,2023-08-08,9296
2338,光罩,10,0,10,凱基-頭份,2023-08-08,9296
2377,微星,10,0,10,凱基-頭份,2023-08-08,9296
00923,群益台ESG低碳50,9,0,9,凱基-頭份,2023-08-08,9296
3032,偉訓,10,1,9,凱基-頭份,2023-08-08,9296
00673R,期元大S＆P原油反1,8,0,8,凱基-頭份,2023-08-08,9296
1503,士電,8,0,8,凱基-頭份,2023-08-08,9296
2834,臺企銀,8,0,8,凱基-頭份,2023-08-08,9296
2301,光寶科,14,7,7,凱基-頭份,2023-08-08,9296
0056,元大高股息,7,0,7,凱基-頭份,2023-08-08,9296
00902,中信電池及儲能,7,0,7,凱基-頭份,2023-08-08,9296
2201,裕隆,6,0,6,凱基-頭份,2023-08-08,9296
2516,新建,6,0,6,凱基-頭份,2023-08-08,9296
3308,聯德,6,0,6,凱基-頭份,2023-08-08,9296
3481,群創,32,26,6,凱基-頭份,2023-08-08,9296
5009,榮剛,6,0,6,凱基-頭份,2023-08-08,9296
6499,益安,6,0,6,凱基-頭份,2023-08-08,9296
2330,台積電,6,0,6,凱基-頭份,2023-08-08,9296
2886,兆豐金,5,0,5,凱基-頭份,2023-08-08,9296
1210,大成,5,0,5,凱基-頭份,2023-08-08,9296
00891,中信關鍵半導體,5,0,5,凱基-頭份,2023-08-08,9296
00633L,富邦上証正2,5,0,5,凱基-頭份,2023-08-08,9296
00930,永豐ESG低碳高息,5,0,5,凱基-頭份,2023-08-08,9296
1216,統一,5,0,5,凱基-頭份,2023-08-08,9296
1305,華夏,5,0,5,凱基-頭份,2023-08-08,9296
1314,中石化,5,0,5,凱基-頭份,2023-08-08,9296
2010,春源,5,0,5,凱基-頭份,2023-08-08,9296
3325,旭品,22,17,5,凱基-頭份,2023-08-08,9296
6125,廣運,10,5,5,凱基-頭份,2023-08-08,9296
6203,海韻電,6,1,5,凱基-頭份,2023-08-08,9296
5880,合庫金,6,1,5,凱基-頭份,2023-08-08,9296
6188,廣明,4,0,4,凱基-頭份,2023-08-08,9296
1217,愛之味,14,10,4,凱基-頭份,2023-08-08,9296
00665L,富邦�琤肭磪囓�2,4,0,4,凱基-頭份,2023-08-08,9296
1529,樂事綠能,9,5,4,凱基-頭份,2023-08-08,9296
2442,新美齊,4,0,4,凱基-頭份,2023-08-08,9296
4945,陞達科技,4,0,4,凱基-頭份,2023-08-08,9296
5371,中光電,16,12,4,凱基-頭份,2023-08-08,9296
2610,華航,171,30,141,凱基-頭份,2023-08-09,9296
00900,富邦特選高股息30,66,3,63,凱基-頭份,2023-08-09,9296
9907,統一實,50,0,50,凱基-頭份,2023-08-09,9296
00929,復華台灣科技優息,38,0,38,凱基-頭份,2023-08-09,9296
00878,國泰永續高股息,41,7,34,凱基-頭份,2023-08-09,9296
2344,華邦電,47,15,32,凱基-頭份,2023-08-09,9296
1305,華夏,30,0,30,凱基-頭份,2023-08-09,9296
2353,宏��,48,18,30,凱基-頭份,2023-08-09,9296
2002,中鋼,32,7,25,凱基-頭份,2023-08-09,9296
1532,勤美,25,0,25,凱基-頭份,2023-08-09,9296
2520,冠德,25,0,25,凱基-頭份,2023-08-09,9296
4105,東洋,25,0,25,凱基-頭份,2023-08-09,9296
5880,合庫金,21,0,21,凱基-頭份,2023-08-09,9296
2606,裕民,20,0,20,凱基-頭份,2023-08-09,9296
2363,矽統,51,33,18,凱基-頭份,2023-08-09,9296
3149,正達,17,0,17,凱基-頭份,2023-08-09,9296
3231,緯創,28,13,15,凱基-頭份,2023-08-09,9296
3363,上詮,14,0,14,凱基-頭份,2023-08-09,9296
8937,合騏,14,0,14,凱基-頭份,2023-08-09,9296
2609,陽明,14,1,13,凱基-頭份,2023-08-09,9296
1905,華紙,13,0,13,凱基-頭份,2023-08-09,9296
3588,通嘉,13,0,13,凱基-頭份,2023-08-09,9296
2812,台中銀,17,4,13,凱基-頭份,2023-08-09,9296
3038,全台,23,11,12,凱基-頭份,2023-08-09,9296
00706L,期元大S＆P日圓正2,10,0,10,凱基-頭份,2023-08-09,9296
1710,東聯,10,0,10,凱基-頭份,2023-08-09,9296
2516,新建,10,0,10,凱基-頭份,2023-08-09,9296
5521,工信,10,0,10,凱基-頭份,2023-08-09,9296
6139,亞翔,10,0,10,凱基-頭份,2023-08-09,9296
6156,松上,10,0,10,凱基-頭份,2023-08-09,9296
3346,麗清,10,1,9,凱基-頭份,2023-08-09,9296
00923,群益台ESG低碳50,8,0,8,凱基-頭份,2023-08-09,9296
00631L,元大台灣50正2,8,0,8,凱基-頭份,2023-08-09,9296
3689,湧德,8,0,8,凱基-頭份,2023-08-09,9296
6213,聯茂,8,0,8,凱基-頭份,2023-08-09,9296
9927,泰銘,7,0,7,凱基-頭份,2023-08-09,9296
00687B,國泰20年美債,7,0,7,凱基-頭份,2023-08-09,9296
2376,技嘉,23,16,7,凱基-頭份,2023-08-09,9296
2834,臺企銀,10,3,7,凱基-頭份,2023-08-09,9296
1217,愛之味,11,5,6,凱基-頭份,2023-08-09,9296
00931B,統一美債20年,15,9,6,凱基-頭份,2023-08-09,9296
1616,億泰,6,0,6,凱基-頭份,2023-08-09,9296
3520,華盈,7,1,6,凱基-頭份,2023-08-09,9296
2382,廣達,19,14,5,凱基-頭份,2023-08-09,9296
5213,亞昕,5,0,5,凱基-頭份,2023-08-09,9296
00895,富邦未來車,5,0,5,凱基-頭份,2023-08-09,9296
00636,國泰中國A50,5,0,5,凱基-頭份,2023-08-09,9296
3701,大眾控,5,0,5,凱基-頭份,2023-08-09,9296
6185,幃翔,7,2,5,凱基-頭份,2023-08-09,9296
8110,華東,5,0,5,凱基-頭份,2023-08-09,9296
00878,國泰永續高股息,117,14,103,凱基-頭份,2023-08-10,9296
2369,菱生,50,0,50,凱基-頭份,2023-08-10,9296
00929,復華台灣科技優息,40,0,40,凱基-頭份,2023-08-10,9296
2002,中鋼,30,1,29,凱基-頭份,2023-08-10,9296
1905,華紙,24,0,24,凱基-頭份,2023-08-10,9296
1503,士電,23,1,22,凱基-頭份,2023-08-10,9296
4123,晟德,22,1,21,凱基-頭份,2023-08-10,9296
6443,元晶,21,0,21,凱基-頭份,2023-08-10,9296
00753L,中信中國50正2,20,0,20,凱基-頭份,2023-08-10,9296
1533,車王電,20,0,20,凱基-頭份,2023-08-10,9296
2382,廣達,40,21,19,凱基-頭份,2023-08-10,9296
5880,合庫金,17,1,16,凱基-頭份,2023-08-10,9296
2009,第一銅,15,0,15,凱基-頭份,2023-08-10,9296
2324,仁寶,15,0,15,凱基-頭份,2023-08-10,9296
00900,富邦特選高股息30,14,0,14,凱基-頭份,2023-08-10,9296
0056,元大高股息,14,1,13,凱基-頭份,2023-08-10,9296
9927,泰銘,20,7,13,凱基-頭份,2023-08-10,9296
1532,勤美,13,0,13,凱基-頭份,2023-08-10,9296
3013,晟銘電,16,3,13,凱基-頭份,2023-08-10,9296
3231,緯創,46,33,13,凱基-頭份,2023-08-10,9296
00931B,統一美債20年,13,1,12,凱基-頭份,2023-08-10,9296
2801,彰銀,12,0,12,凱基-頭份,2023-08-10,9296
9955,佳龍,12,0,12,凱基-頭份,2023-08-10,9296
6217,中探針,11,0,11,凱基-頭份,2023-08-10,9296
2323,中環,10,0,10,凱基-頭份,2023-08-10,9296
00882,中信中國高股息,20,10,10,凱基-頭份,2023-08-10,9296
00891,中信關鍵半導體,10,0,10,凱基-頭份,2023-08-10,9296
2516,新建,10,0,10,凱基-頭份,2023-08-10,9296
3363,上詮,13,3,10,凱基-頭份,2023-08-10,9296
8105,凌巨,10,0,10,凱基-頭份,2023-08-10,9296
2886,兆豐金,9,0,9,凱基-頭份,2023-08-10,9296
2457,飛宏,10,2,8,凱基-頭份,2023-08-10,9296
3213,茂訊,8,0,8,凱基-頭份,2023-08-10,9296
5309,系統電,8,0,8,凱基-頭份,2023-08-10,9296
00919,群益台灣精選高息,6,0,6,凱基-頭份,2023-08-10,9296
00888,永豐台灣ESG,6,0,6,凱基-頭份,2023-08-10,9296
00895,富邦未來車,10,4,6,凱基-頭份,2023-08-10,9296
00923,群益台ESG低碳50,6,0,6,凱基-頭份,2023-08-10,9296
1609,大亞,8,2,6,凱基-頭份,2023-08-10,9296
2352,佳世達,9,3,6,凱基-頭份,2023-08-10,9296
4510,高鋒,6,0,6,凱基-頭份,2023-08-10,9296
6112,邁達特,5,0,5,凱基-頭份,2023-08-10,9296
00715L,期街口布蘭特正2,15,10,5,凱基-頭份,2023-08-10,9296
1339,昭輝,5,0,5,凱基-頭份,2023-08-10,9296
1514,亞力,5,0,5,凱基-頭份,2023-08-10,9296
2329,華泰,5,0,5,凱基-頭份,2023-08-10,9296
2482,連宇,5,0,5,凱基-頭份,2023-08-10,9296
2892,第一金,7,2,5,凱基-頭份,2023-08-10,9296
3055,蔚華科,7,2,5,凱基-頭份,2023-08-10,9296
3057,喬鼎,5,0,5,凱基-頭份,2023-08-10,9296
00931B,統一美債20年,129,7,122,凱基-頭份,2023-08-11,9296
2892,第一金,42,0,42,凱基-頭份,2023-08-11,9296
00929,復華台灣科技優息,38,6,32,凱基-頭份,2023-08-11,9296
2516,新建,30,1,29,凱基-頭份,2023-08-11,9296
2888,新光金,25,1,24,凱基-頭份,2023-08-11,9296
3149,正達,21,0,21,凱基-頭份,2023-08-11,9296
1532,勤美,18,0,18,凱基-頭份,2023-08-11,9296
8093,保銳,15,0,15,凱基-頭份,2023-08-11,9296
00687B,國泰20年美債,14,0,14,凱基-頭份,2023-08-11,9296
3049,精金,14,0,14,凱基-頭份,2023-08-11,9296
1609,大亞,13,0,13,凱基-頭份,2023-08-11,9296
2913,農林,14,1,13,凱基-頭份,2023-08-11,9296
00772B,中信高評級公司債,11,0,11,凱基-頭份,2023-08-11,9296
2440,太空梭,11,0,11,凱基-頭份,2023-08-11,9296
00715L,期街口布蘭特正2,10,0,10,凱基-頭份,2023-08-11,9296
00680L,元大美債20正2,10,0,10,凱基-頭份,2023-08-11,9296
1528,恩德,10,0,10,凱基-頭份,2023-08-11,9296
3363,上詮,14,4,10,凱基-頭份,2023-08-11,9296
4168,醣聯,10,0,10,凱基-頭份,2023-08-11,9296
2323,中環,10,0,10,凱基-頭份,2023-08-11,9296
1101,台泥,10,1,9,凱基-頭份,2023-08-11,9296
6116,彩晶,9,0,9,凱基-頭份,2023-08-11,9296
00679B,元大美債20年,9,0,9,凱基-頭份,2023-08-11,9296
2329,華泰,10,2,8,凱基-頭份,2023-08-11,9296
3213,茂訊,11,3,8,凱基-頭份,2023-08-11,9296
3322,建舜電,7,0,7,凱基-頭份,2023-08-11,9296
4916,事欣科,7,0,7,凱基-頭份,2023-08-11,9296
5871,中租-KY,6,0,6,凱基-頭份,2023-08-11,9296
2317,鴻海,6,0,6,凱基-頭份,2023-08-11,9296
00927,群益半導體收益,6,0,6,凱基-頭份,2023-08-11,9296
00641R,富邦日本反1,5,0,5,凱基-頭份,2023-08-11,9296
00882,中信中國高股息,5,0,5,凱基-頭份,2023-08-11,9296
2460,建通,14,9,5,凱基-頭份,2023-08-11,9296
3325,旭品,7,2,5,凱基-頭份,2023-08-11,9296
3711,日月光投控,5,0,5,凱基-頭份,2023-08-11,9296
4157,太景*-KY,5,0,5,凱基-頭份,2023-08-11,9296
5309,系統電,5,0,5,凱基-頭份,2023-08-11,9296
6605,帝寶,5,0,5,凱基-頭份,2023-08-11,9296
8076,伍豐,5,0,5,凱基-頭份,2023-08-11,9296
2886,兆豐金,7,2,5,凱基-頭份,2023-08-11,9296
2356,英業達,7,3,4,凱基-頭份,2023-08-11,9296
00795B,中信美國公債20年,4,0,4,凱基-頭份,2023-08-11,9296
00722B,群益投資級電信債,4,0,4,凱基-頭份,2023-08-11,9296
3055,蔚華科,4,0,4,凱基-頭份,2023-08-11,9296
3324,雙鴻,6,2,4,凱基-頭份,2023-08-11,9296
3483,力致,6,2,4,凱基-頭份,2023-08-11,9296
3518,柏騰,4,0,4,凱基-頭份,2023-08-11,9296
6770,力積電,5,1,4,凱基-頭份,2023-08-11,9296
2454,聯發科,4,0,4,凱基-頭份,2023-08-11,9296
2376,技嘉,15,12,3,凱基-頭份,2023-08-11,9296
00878,國泰永續高股息,127,4,123,凱基-頭份,2023-08-14,9296
00900,富邦特選高股息30,71,3,68,凱基-頭份,2023-08-14,9296
2888,新光金,69,5,64,凱基-頭份,2023-08-14,9296
2344,華邦電,65,7,58,凱基-頭份,2023-08-14,9296
00929,復華台灣科技優息,55,2,53,凱基-頭份,2023-08-14,9296
2834,臺企銀,52,0,52,凱基-頭份,2023-08-14,9296
2605,新興,51,0,51,凱基-頭份,2023-08-14,9296
3704,合勤控,45,0,45,凱基-頭份,2023-08-14,9296
4168,醣聯,35,0,35,凱基-頭份,2023-08-14,9296
2633,台灣高鐵,32,0,32,凱基-頭份,2023-08-14,9296
2328,廣宇,29,0,29,凱基-頭份,2023-08-14,9296
2886,兆豐金,27,0,27,凱基-頭份,2023-08-14,9296
4123,晟德,25,0,25,凱基-頭份,2023-08-14,9296
2303,聯電,21,0,21,凱基-頭份,2023-08-14,9296
2618,長榮航,31,10,21,凱基-頭份,2023-08-14,9296
1304,台聚,20,0,20,凱基-頭份,2023-08-14,9296
00637L,元大滬深300正2,20,2,18,凱基-頭份,2023-08-14,9296
3005,神基,16,0,16,凱基-頭份,2023-08-14,9296
2801,彰銀,15,0,15,凱基-頭份,2023-08-14,9296
00923,群益台ESG低碳50,14,0,14,凱基-頭份,2023-08-14,9296
0050,元大台灣50,13,0,13,凱基-頭份,2023-08-14,9296
00882,中信中國高股息,18,6,12,凱基-頭份,2023-08-14,9296
3149,正達,12,0,12,凱基-頭份,2023-08-14,9296
2883,凱基金,13,2,11,凱基-頭份,2023-08-14,9296
2897,王道銀行,16,5,11,凱基-頭份,2023-08-14,9296
00680L,元大美債20正2,10,0,10,凱基-頭份,2023-08-14,9296
2014,中鴻,19,9,10,凱基-頭份,2023-08-14,9296
2331,精英,10,0,10,凱基-頭份,2023-08-14,9296
2851,中再保,10,0,10,凱基-頭份,2023-08-14,9296
3363,上詮,10,0,10,凱基-頭份,2023-08-14,9296
1905,華紙,22,13,9,凱基-頭份,2023-08-14,9296
2206,三陽工業,8,0,8,凱基-頭份,2023-08-14,9296
2603,長榮,17,9,8,凱基-頭份,2023-08-14,9296
3715,定穎投控,10,2,8,凱基-頭份,2023-08-14,9296
2892,第一金,7,0,7,凱基-頭份,2023-08-14,9296
2402,毅嘉,7,0,7,凱基-頭份,2023-08-14,9296
2516,新建,7,0,7,凱基-頭份,2023-08-14,9296
3322,建舜電,7,0,7,凱基-頭份,2023-08-14,9296
1609,大亞,6,0,6,凱基-頭份,2023-08-14,9296
5511,德昌,6,0,6,凱基-頭份,2023-08-14,9296
2027,大成鋼,7,2,5,凱基-頭份,2023-08-14,9296
3576,聯合再生,5,0,5,凱基-頭份,2023-08-14,9296
1513,中興電,5,0,5,凱基-頭份,2023-08-14,9296
1527,鑽全,5,0,5,凱基-頭份,2023-08-14,9296
2017,官田鋼,10,5,5,凱基-頭份,2023-08-14,9296
2313,華通,8,3,5,凱基-頭份,2023-08-14,9296
2388,威盛,6,1,5,凱基-頭份,2023-08-14,9296
2482,連宇,5,0,5,凱基-頭份,2023-08-14,9296
2881,富邦金,5,0,5,凱基-頭份,2023-08-14,9296
2890,永豐金,30,25,5,凱基-頭份,2023-08-14,9296
00929,復華台灣科技優息,114,0,114,凱基-頭份,2023-08-15,9296
00900,富邦特選高股息30,55,1,54,凱基-頭份,2023-08-15,9296
3481,群創,67,24,43,凱基-頭份,2023-08-15,9296
00637L,元大滬深300正2,40,13,27,凱基-頭份,2023-08-15,9296
1734,杏輝,25,0,25,凱基-頭份,2023-08-15,9296
2363,矽統,44,22,22,凱基-頭份,2023-08-15,9296
2834,臺企銀,21,0,21,凱基-頭份,2023-08-15,9296
3149,正達,20,0,20,凱基-頭份,2023-08-15,9296
3706,神達,26,6,20,凱基-頭份,2023-08-15,9296
6166,凌華,20,0,20,凱基-頭份,2023-08-15,9296
2002,中鋼,15,0,15,凱基-頭份,2023-08-15,9296
2892,第一金,12,0,12,凱基-頭份,2023-08-15,9296
1102,亞泥,12,0,12,凱基-頭份,2023-08-15,9296
00923,群益台ESG低碳50,12,0,12,凱基-頭份,2023-08-15,9296
2515,中工,12,0,12,凱基-頭份,2023-08-15,9296
2891,中信金,11,0,11,凱基-頭份,2023-08-15,9296
00688L,國泰20年美債正2,11,0,11,凱基-頭份,2023-08-15,9296
2890,永豐金,11,0,11,凱基-頭份,2023-08-15,9296
3704,合勤控,11,0,11,凱基-頭份,2023-08-15,9296
2897,王道銀行,11,0,11,凱基-頭份,2023-08-15,9296
3694,海華,10,0,10,凱基-頭份,2023-08-15,9296
00632R,元大台灣50反1,10,1,9,凱基-頭份,2023-08-15,9296
2884,玉山金,9,0,9,凱基-頭份,2023-08-15,9296
00679B,元大美債20年,9,0,9,凱基-頭份,2023-08-15,9296
3231,緯創,32,24,8,凱基-頭份,2023-08-15,9296
2888,新光金,8,0,8,凱基-頭份,2023-08-15,9296
3322,建舜電,8,0,8,凱基-頭份,2023-08-15,9296
6125,廣運,12,4,8,凱基-頭份,2023-08-15,9296
00795B,中信美國公債20年,7,0,7,凱基-頭份,2023-08-15,9296
4123,晟德,6,0,6,凱基-頭份,2023-08-15,9296
00931B,統一美債20年,6,0,6,凱基-頭份,2023-08-15,9296
1710,東聯,6,0,6,凱基-頭份,2023-08-15,9296
2442,新美齊,6,0,6,凱基-頭份,2023-08-15,9296
2317,鴻海,8,3,5,凱基-頭份,2023-08-15,9296
1326,台化,5,0,5,凱基-頭份,2023-08-15,9296
6472,保瑞,6,1,5,凱基-頭份,2023-08-15,9296
1314,中石化,5,0,5,凱基-頭份,2023-08-15,9296
00891,中信關鍵半導體,5,0,5,凱基-頭份,2023-08-15,9296
1513,中興電,5,0,5,凱基-頭份,2023-08-15,9296
2377,微星,5,0,5,凱基-頭份,2023-08-15,9296
2801,彰銀,5,0,5,凱基-頭份,2023-08-15,9296
4126,太醫,5,0,5,凱基-頭份,2023-08-15,9296
4533,協易機,5,0,5,凱基-頭份,2023-08-15,9296
8930,青鋼,5,0,5,凱基-頭份,2023-08-15,9296
3325,旭品,5,0,5,凱基-頭份,2023-08-15,9296
1789,神隆,4,0,4,凱基-頭份,2023-08-15,9296
2457,飛宏,5,1,4,凱基-頭份,2023-08-15,9296
2609,陽明,4,0,4,凱基-頭份,2023-08-15,9296
2887,台新金,4,0,4,凱基-頭份,2023-08-15,9296
3006,晶豪科,4,0,4,凱基-頭份,2023-08-15,9296
00929,復華台灣科技優息,83,5,78,凱基-頭份,2023-08-16,9296
6788,華景電,61,1,60,凱基-頭份,2023-08-16,9296
3704,合勤控,55,0,55,凱基-頭份,2023-08-16,9296
2548,華固,40,0,40,凱基-頭份,2023-08-16,9296
00923,群益台ESG低碳50,34,0,34,凱基-頭份,2023-08-16,9296
00878,國泰永續高股息,37,6,31,凱基-頭份,2023-08-16,9296
2891,中信金,22,0,22,凱基-頭份,2023-08-16,9296
1304,台聚,20,1,19,凱基-頭份,2023-08-16,9296
2515,中工,19,0,19,凱基-頭份,2023-08-16,9296
2610,華航,31,12,19,凱基-頭份,2023-08-16,9296
6122,擎邦,18,0,18,凱基-頭份,2023-08-16,9296
3149,正達,17,0,17,凱基-頭份,2023-08-16,9296
2834,臺企銀,15,0,15,凱基-頭份,2023-08-16,9296
2352,佳世達,15,0,15,凱基-頭份,2023-08-16,9296
2303,聯電,27,14,13,凱基-頭份,2023-08-16,9296
1314,中石化,13,0,13,凱基-頭份,2023-08-16,9296
2516,新建,13,0,13,凱基-頭份,2023-08-16,9296
2618,長榮航,30,17,13,凱基-頭份,2023-08-16,9296
2332,友訊,17,6,11,凱基-頭份,2023-08-16,9296
00637L,元大滬深300正2,10,0,10,凱基-頭份,2023-08-16,9296
3481,群創,15,5,10,凱基-頭份,2023-08-16,9296
6142,友勁,10,0,10,凱基-頭份,2023-08-16,9296
6179,亞通,10,0,10,凱基-頭份,2023-08-16,9296
00900,富邦特選高股息30,9,0,9,凱基-頭份,2023-08-16,9296
9925,新保,9,0,9,凱基-頭份,2023-08-16,9296
00706L,期元大S＆P日圓正2,10,2,8,凱基-頭份,2023-08-16,9296
2884,玉山金,10,2,8,凱基-頭份,2023-08-16,9296
2812,台中銀,7,0,7,凱基-頭份,2023-08-16,9296
0050,元大台灣50,8,1,7,凱基-頭份,2023-08-16,9296
00720B,元大投資級公司債,7,0,7,凱基-頭份,2023-08-16,9296
2356,英業達,24,17,7,凱基-頭份,2023-08-16,9296
6197,佳必琪,7,0,7,凱基-頭份,2023-08-16,9296
6275,元山,8,1,7,凱基-頭份,2023-08-16,9296
6492,生華科,7,0,7,凱基-頭份,2023-08-16,9296
2104,國際中橡,6,0,6,凱基-頭份,2023-08-16,9296
4533,協易機,14,8,6,凱基-頭份,2023-08-16,9296
2881,富邦金,5,0,5,凱基-頭份,2023-08-16,9296
2323,中環,5,0,5,凱基-頭份,2023-08-16,9296
2344,華邦電,10,5,5,凱基-頭份,2023-08-16,9296
3019,亞光,5,0,5,凱基-頭份,2023-08-16,9296
3706,神達,6,1,5,凱基-頭份,2023-08-16,9296
4563,百德,5,0,5,凱基-頭份,2023-08-16,9296
6191,精成科,5,0,5,凱基-頭份,2023-08-16,9296
2002,中鋼,7,3,4,凱基-頭份,2023-08-16,9296
9945,潤泰新,4,0,4,凱基-頭份,2023-08-16,9296
00772B,中信高評級公司債,4,0,4,凱基-頭份,2023-08-16,9296
1609,大亞,5,1,4,凱基-頭份,2023-08-16,9296
2897,王道銀行,4,0,4,凱基-頭份,2023-08-16,9296
3035,智原,13,9,4,凱基-頭份,2023-08-16,9296
8215,明基材,4,0,4,凱基-頭份,2023-08-16,9296
00929,復華台灣科技優息,72,0,72,凱基-頭份,2023-08-17,9296
1101,台泥,57,0,57,凱基-頭份,2023-08-17,9296
00878,國泰永續高股息,59,12,47,凱基-頭份,2023-08-17,9296
2867,三商壽,40,0,40,凱基-頭份,2023-08-17,9296
6788,華景電,40,1,39,凱基-頭份,2023-08-17,9296
00753L,中信中國50正2,30,0,30,凱基-頭份,2023-08-17,9296
00673R,期元大S＆P原油反1,20,0,20,凱基-頭份,2023-08-17,9296
6274,台燿,20,0,20,凱基-頭份,2023-08-17,9296
00882,中信中國高股息,16,0,16,凱基-頭份,2023-08-17,9296
5871,中租-KY,16,1,15,凱基-頭份,2023-08-17,9296
2516,新建,15,0,15,凱基-頭份,2023-08-17,9296
00679B,元大美債20年,15,0,15,凱基-頭份,2023-08-17,9296
1609,大亞,18,4,14,凱基-頭份,2023-08-17,9296
2891,中信金,14,1,13,凱基-頭份,2023-08-17,9296
4746,台耀,14,1,13,凱基-頭份,2023-08-17,9296
2812,台中銀,12,0,12,凱基-頭份,2023-08-17,9296
1802,台玻,11,0,11,凱基-頭份,2023-08-17,9296
2344,華邦電,20,9,11,凱基-頭份,2023-08-17,9296
2002,中鋼,11,1,10,凱基-頭份,2023-08-17,9296
2303,聯電,33,23,10,凱基-頭份,2023-08-17,9296
00895,富邦未來車,10,0,10,凱基-頭份,2023-08-17,9296
00923,群益台ESG低碳50,10,0,10,凱基-頭份,2023-08-17,9296
00641R,富邦日本反1,20,10,10,凱基-頭份,2023-08-17,9296
1319,東陽,20,10,10,凱基-頭份,2023-08-17,9296
6191,精成科,10,0,10,凱基-頭份,2023-08-17,9296
8021,尖點,10,0,10,凱基-頭份,2023-08-17,9296
2324,仁寶,112,103,9,凱基-頭份,2023-08-17,9296
00722B,群益投資級電信債,8,0,8,凱基-頭份,2023-08-17,9296
2329,華泰,41,33,8,凱基-頭份,2023-08-17,9296
2618,長榮航,20,12,8,凱基-頭份,2023-08-17,9296
6116,彩晶,8,0,8,凱基-頭份,2023-08-17,9296
3231,緯創,59,51,8,凱基-頭份,2023-08-17,9296
00632R,元大台灣50反1,7,0,7,凱基-頭份,2023-08-17,9296
00772B,中信高評級公司債,6,0,6,凱基-頭份,2023-08-17,9296
00688L,國泰20年美債正2,6,0,6,凱基-頭份,2023-08-17,9296
3032,偉訓,13,7,6,凱基-頭份,2023-08-17,9296
2880,華南金,5,0,5,凱基-頭份,2023-08-17,9296
2352,佳世達,5,0,5,凱基-頭份,2023-08-17,9296
00712,復華富時不動產,5,0,5,凱基-頭份,2023-08-17,9296
00891,中信關鍵半導體,5,0,5,凱基-頭份,2023-08-17,9296
00931B,統一美債20年,5,0,5,凱基-頭份,2023-08-17,9296
2440,太空梭,5,0,5,凱基-頭份,2023-08-17,9296
2548,華固,5,0,5,凱基-頭份,2023-08-17,9296
5315,光聯,5,0,5,凱基-頭份,2023-08-17,9296
6153,嘉聯益,5,0,5,凱基-頭份,2023-08-17,9296
6609,瀧澤科,5,0,5,凱基-頭份,2023-08-17,9296
8034,榮群,5,0,5,凱基-頭份,2023-08-17,9296
2883,凱基金,4,0,4,凱基-頭份,2023-08-17,9296
2892,第一金,6,2,4,凱基-頭份,2023-08-17,9296
00919,群益台灣精選高息,4,0,4,凱基-頭份,2023-08-17,9296
00929,復華台灣科技優息,60,7,53,凱基-頭份,2023-08-18,9296
00882,中信中國高股息,57,7,50,凱基-頭份,2023-08-18,9296
00878,國泰永續高股息,93,52,41,凱基-頭份,2023-08-18,9296
1101,台泥,41,0,41,凱基-頭份,2023-08-18,9296
3704,合勤控,43,8,35,凱基-頭份,2023-08-18,9296
8034,榮群,19,2,17,凱基-頭份,2023-08-18,9296
1789,神隆,16,0,16,凱基-頭份,2023-08-18,9296
9934,成霖,15,0,15,凱基-頭份,2023-08-18,9296
1459,聯發,15,1,14,凱基-頭份,2023-08-18,9296
2324,仁寶,21,7,14,凱基-頭份,2023-08-18,9296
2436,偉詮電,15,1,14,凱基-頭份,2023-08-18,9296
1319,東陽,20,10,10,凱基-頭份,2023-08-18,9296
2520,冠德,10,0,10,凱基-頭份,2023-08-18,9296
2618,長榮航,11,1,10,凱基-頭份,2023-08-18,9296
6125,廣運,13,4,9,凱基-頭份,2023-08-18,9296
00795B,中信美國公債20年,8,0,8,凱基-頭份,2023-08-18,9296
1609,大亞,8,0,8,凱基-頭份,2023-08-18,9296
2363,矽統,62,54,8,凱基-頭份,2023-08-18,9296
2388,威盛,9,1,8,凱基-頭份,2023-08-18,9296
3706,神達,17,9,8,凱基-頭份,2023-08-18,9296
00720B,元大投資級公司債,7,0,7,凱基-頭份,2023-08-18,9296
2548,華固,7,0,7,凱基-頭份,2023-08-18,9296
00673R,期元大S＆P原油反1,7,0,7,凱基-頭份,2023-08-18,9296
2606,裕民,7,0,7,凱基-頭份,2023-08-18,9296
3078,僑威,67,60,7,凱基-頭份,2023-08-18,9296
2603,長榮,23,16,7,凱基-頭份,2023-08-18,9296
3056,富華新,12,5,7,凱基-頭份,2023-08-18,9296
6285,啟��,9,3,6,凱基-頭份,2023-08-18,9296
3149,正達,6,0,6,凱基-頭份,2023-08-18,9296
6282,康舒,17,11,6,凱基-頭份,2023-08-18,9296
9921,巨大,6,0,6,凱基-頭份,2023-08-18,9296
2330,台積電,5,0,5,凱基-頭份,2023-08-18,9296
2882,國泰金,5,0,5,凱基-頭份,2023-08-18,9296
1504,東元,9,4,5,凱基-頭份,2023-08-18,9296
00632R,元大台灣50反1,5,0,5,凱基-頭份,2023-08-18,9296
00892,富邦台灣半導體,5,0,5,凱基-頭份,2023-08-18,9296
00891,中信關鍵半導體,5,0,5,凱基-頭份,2023-08-18,9296
1734,杏輝,5,0,5,凱基-頭份,2023-08-18,9296
1802,台玻,5,0,5,凱基-頭份,2023-08-18,9296
2009,第一銅,5,0,5,凱基-頭份,2023-08-18,9296
2329,華泰,40,35,5,凱基-頭份,2023-08-18,9296
2449,京元電子,5,0,5,凱基-頭份,2023-08-18,9296
2883,凱基金,5,0,5,凱基-頭份,2023-08-18,9296
2888,新光金,5,0,5,凱基-頭份,2023-08-18,9296
3035,智原,20,15,5,凱基-頭份,2023-08-18,9296
4581,光隆精密-KY,5,0,5,凱基-頭份,2023-08-18,9296
8936,國統,5,0,5,凱基-頭份,2023-08-18,9296
00900,富邦特選高股息30,4,0,4,凱基-頭份,2023-08-18,9296
0056,元大高股息,4,0,4,凱基-頭份,2023-08-18,9296
2317,鴻海,4,0,4,凱基-頭份,2023-08-18,9296
2363,矽統,269,50,219,凱基-頭份,2023-08-21,9296
2516,新建,55,0,55,凱基-頭份,2023-08-21,9296
00882,中信中國高股息,66,19,47,凱基-頭份,2023-08-21,9296
2883B,凱基金乙特,30,0,30,凱基-頭份,2023-08-21,9296
00931B,統一美債20年,26,0,26,凱基-頭份,2023-08-21,9296
2344,華邦電,31,7,24,凱基-頭份,2023-08-21,9296
2610,華航,30,6,24,凱基-頭份,2023-08-21,9296
00878,國泰永續高股息,24,1,23,凱基-頭份,2023-08-21,9296
00712,復華富時不動產,11,0,11,凱基-頭份,2023-08-21,9296
5608,四維航,11,0,11,凱基-頭份,2023-08-21,9296
1734,杏輝,10,0,10,凱基-頭份,2023-08-21,9296
00919,群益台灣精選高息,7,0,7,凱基-頭份,2023-08-21,9296
2605,新興,7,0,7,凱基-頭份,2023-08-21,9296
2637,慧洋-KY,7,0,7,凱基-頭份,2023-08-21,9296
2324,仁寶,45,38,7,凱基-頭份,2023-08-21,9296
1451,年興,6,0,6,凱基-頭份,2023-08-21,9296
2884,玉山金,7,1,6,凱基-頭份,2023-08-21,9296
3051,力特,6,0,6,凱基-頭份,2023-08-21,9296
6282,康舒,6,1,5,凱基-頭份,2023-08-21,9296
00715L,期街口布蘭特正2,5,0,5,凱基-頭份,2023-08-21,9296
2609,陽明,6,1,5,凱基-頭份,2023-08-21,9296
4105,東洋,5,0,5,凱基-頭份,2023-08-21,9296
4581,光隆精密-KY,5,0,5,凱基-頭份,2023-08-21,9296
6116,彩晶,5,0,5,凱基-頭份,2023-08-21,9296
6139,亞翔,7,2,5,凱基-頭份,2023-08-21,9296
6770,力積電,20,15,5,凱基-頭份,2023-08-21,9296
9924,福興,5,0,5,凱基-頭份,2023-08-21,9296
2886,兆豐金,5,1,4,凱基-頭份,2023-08-21,9296
2457,飛宏,8,4,4,凱基-頭份,2023-08-21,9296
1471,首利,4,0,4,凱基-頭份,2023-08-21,9296
2399,映泰,4,0,4,凱基-頭份,2023-08-21,9296
4126,太醫,4,0,4,凱基-頭份,2023-08-21,9296
5410,國眾,4,0,4,凱基-頭份,2023-08-21,9296
6235,華孚,11,7,4,凱基-頭份,2023-08-21,9296
1513,中興電,15,11,4,凱基-頭份,2023-08-21,9296
00751B,元大AAA至A公司債,3,0,3,凱基-頭份,2023-08-21,9296
2330,台積電,3,0,3,凱基-頭份,2023-08-21,9296
00679B,元大美債20年,3,0,3,凱基-頭份,2023-08-21,9296
00637L,元大滬深300正2,5,2,3,凱基-頭份,2023-08-21,9296
2303,聯電,3,0,3,凱基-頭份,2023-08-21,9296
2331,精英,3,0,3,凱基-頭份,2023-08-21,9296
3013,晟銘電,6,3,3,凱基-頭份,2023-08-21,9296
3062,建漢,3,0,3,凱基-頭份,2023-08-21,9296
3689,湧德,14,11,3,凱基-頭份,2023-08-21,9296
5425,台半,3,0,3,凱基-頭份,2023-08-21,9296
3035,智原,13,11,2,凱基-頭份,2023-08-21,9296
0050,元大台灣50,2,0,2,凱基-頭份,2023-08-21,9296
2881,富邦金,2,0,2,凱基-頭份,2023-08-21,9296
3213,茂訊,2,0,2,凱基-頭份,2023-08-21,9296
2601,益航,2,0,2,凱基-頭份,2023-08-21,9296
2516,新建,110,0,110,凱基-頭份,2023-08-22,9296
00878,國泰永續高股息,57,4,53,凱基-頭份,2023-08-22,9296
00929,復華台灣科技優息,34,0,34,凱基-頭份,2023-08-22,9296
1905,華紙,31,0,31,凱基-頭份,2023-08-22,9296
2883B,凱基金乙特,30,0,30,凱基-頭份,2023-08-22,9296
3149,正達,30,0,30,凱基-頭份,2023-08-22,9296
00882,中信中國高股息,25,0,25,凱基-頭份,2023-08-22,9296
2913,農林,25,0,25,凱基-頭份,2023-08-22,9296
0056,元大高股息,20,0,20,凱基-頭份,2023-08-22,9296
6122,擎邦,21,3,18,凱基-頭份,2023-08-22,9296
1734,杏輝,12,0,12,凱基-頭份,2023-08-22,9296
2017,官田鋼,10,0,10,凱基-頭份,2023-08-22,9296
00665L,富邦�琤肭磪囓�2,10,0,10,凱基-頭份,2023-08-22,9296
3325,旭品,13,3,10,凱基-頭份,2023-08-22,9296
6770,力積電,10,0,10,凱基-頭份,2023-08-22,9296
8034,榮群,11,1,10,凱基-頭份,2023-08-22,9296
2356,英業達,32,23,9,凱基-頭份,2023-08-22,9296
2419,仲琦,9,0,9,凱基-頭份,2023-08-22,9296
2344,華邦電,12,4,8,凱基-頭份,2023-08-22,9296
2382,廣達,24,17,7,凱基-頭份,2023-08-22,9296
00915,凱基優選高股息30,7,0,7,凱基-頭份,2023-08-22,9296
2897,王道銀行,7,0,7,凱基-頭份,2023-08-22,9296
3312,弘憶股,7,0,7,凱基-頭份,2023-08-22,9296
8201,無敵,7,0,7,凱基-頭份,2023-08-22,9296
2812,台中銀,7,0,7,凱基-頭份,2023-08-22,9296
5511,德昌,6,0,6,凱基-頭份,2023-08-22,9296
6116,彩晶,6,0,6,凱基-頭份,2023-08-22,9296
1101,台泥,6,0,6,凱基-頭份,2023-08-22,9296
3032,偉訓,7,2,5,凱基-頭份,2023-08-22,9296
2884,玉山金,5,0,5,凱基-頭份,2023-08-22,9296
2891,中信金,6,1,5,凱基-頭份,2023-08-22,9296
2002,中鋼,5,0,5,凱基-頭份,2023-08-22,9296
4161,聿新科,5,0,5,凱基-頭份,2023-08-22,9296
1339,昭輝,5,0,5,凱基-頭份,2023-08-22,9296
00923,群益台ESG低碳50,10,5,5,凱基-頭份,2023-08-22,9296
00891,中信關鍵半導體,5,0,5,凱基-頭份,2023-08-22,9296
2542,興富發,5,0,5,凱基-頭份,2023-08-22,9296
2641,正德,5,0,5,凱基-頭份,2023-08-22,9296
6188,廣明,6,1,5,凱基-頭份,2023-08-22,9296
6609,瀧澤科,5,0,5,凱基-頭份,2023-08-22,9296
3231,緯創,24,19,5,凱基-頭份,2023-08-22,9296
00679B,元大美債20年,5,0,5,凱基-頭份,2023-08-22,9296
00720B,元大投資級公司債,4,0,4,凱基-頭份,2023-08-22,9296
6282,康舒,8,4,4,凱基-頭份,2023-08-22,9296
00795B,中信美國公債20年,4,0,4,凱基-頭份,2023-08-22,9296
00907,永豐優息存股,4,0,4,凱基-頭份,2023-08-22,9296
00885,富邦越南,24,20,4,凱基-頭份,2023-08-22,9296
2355,敬鵬,4,0,4,凱基-頭份,2023-08-22,9296
2388,威盛,6,2,4,凱基-頭份,2023-08-22,9296
2409,友達,6,2,4,凱基-頭份,2023-08-22,9296
00929,復華台灣科技優息,125,0,125,凱基-頭份,2023-08-23,9296
00712,復華富時不動產,107,3,104,凱基-頭份,2023-08-23,9296
4906,正文,65,3,62,凱基-頭份,2023-08-23,9296
2516,新建,37,0,37,凱基-頭份,2023-08-23,9296
00753L,中信中國50正2,28,0,28,凱基-頭份,2023-08-23,9296
00931B,統一美債20年,26,0,26,凱基-頭份,2023-08-23,9296
1734,杏輝,25,0,25,凱基-頭份,2023-08-23,9296
3149,正達,23,0,23,凱基-頭份,2023-08-23,9296
5426,振發,20,0,20,凱基-頭份,2023-08-23,9296
3567,逸昌,24,7,17,凱基-頭份,2023-08-23,9296
00923,群益台ESG低碳50,16,0,16,凱基-頭份,2023-08-23,9296
2634,漢翔,23,8,15,凱基-頭份,2023-08-23,9296
2329,華泰,19,7,12,凱基-頭份,2023-08-23,9296
4167,松瑞藥,11,0,11,凱基-頭份,2023-08-23,9296
5880,合庫金,11,0,11,凱基-頭份,2023-08-23,9296
00632R,元大台灣50反1,10,0,10,凱基-頭份,2023-08-23,9296
00664R,國泰臺灣加權反1,10,0,10,凱基-頭份,2023-08-23,9296
2834,臺企銀,10,0,10,凱基-頭份,2023-08-23,9296
6116,彩晶,10,0,10,凱基-頭份,2023-08-23,9296
1513,中興電,19,12,7,凱基-頭份,2023-08-23,9296
00922,國泰台灣領袖50,7,0,7,凱基-頭份,2023-08-23,9296
00878,國泰永續高股息,20,13,7,凱基-頭份,2023-08-23,9296
3051,力特,15,9,6,凱基-頭份,2023-08-23,9296
6829,千附精密,6,0,6,凱基-頭份,2023-08-23,9296
3056,富華新,5,0,5,凱基-頭份,2023-08-23,9296
00637L,元大滬深300正2,10,5,5,凱基-頭份,2023-08-23,9296
00701,國泰股利精選30,5,0,5,凱基-頭份,2023-08-23,9296
2313,華通,5,0,5,凱基-頭份,2023-08-23,9296
3363,上詮,10,5,5,凱基-頭份,2023-08-23,9296
3622,洋華,5,0,5,凱基-頭份,2023-08-23,9296
6122,擎邦,8,3,5,凱基-頭份,2023-08-23,9296
2883,凱基金,4,0,4,凱基-頭份,2023-08-23,9296
00900,富邦特選高股息30,4,0,4,凱基-頭份,2023-08-23,9296
2002,中鋼,5,1,4,凱基-頭份,2023-08-23,9296
2429,銘旺科,4,0,4,凱基-頭份,2023-08-23,9296
2637,慧洋-KY,7,3,4,凱基-頭份,2023-08-23,9296
3715,定穎投控,7,3,4,凱基-頭份,2023-08-23,9296
6125,廣運,12,8,4,凱基-頭份,2023-08-23,9296
8201,無敵,4,0,4,凱基-頭份,2023-08-23,9296
2881,富邦金,4,0,4,凱基-頭份,2023-08-23,9296
00679B,元大美債20年,4,0,4,凱基-頭份,2023-08-23,9296
3035,智原,10,7,3,凱基-頭份,2023-08-23,9296
1471,首利,9,6,3,凱基-頭份,2023-08-23,9296
2890,永豐金,3,0,3,凱基-頭份,2023-08-23,9296
3043,科風,5,2,3,凱基-頭份,2023-08-23,9296
3689,湧德,10,7,3,凱基-頭份,2023-08-23,9296
4157,太景*-KY,3,0,3,凱基-頭份,2023-08-23,9296
5871,中租-KY,5,2,3,凱基-頭份,2023-08-23,9296
6128,上福,3,0,3,凱基-頭份,2023-08-23,9296
6170,統振,3,0,3,凱基-頭份,2023-08-23,9296
00712,復華富時不動產,107,1,106,凱基-頭份,2023-08-24,9296
912000,晨訊科-DR,65,0,65,凱基-頭份,2023-08-24,9296
00919,群益台灣精選高息,59,0,59,凱基-頭份,2023-08-24,9296
9934,成霖,35,0,35,凱基-頭份,2023-08-24,9296
3231,緯創,92,60,32,凱基-頭份,2023-08-24,9296
2449,京元電子,34,17,17,凱基-頭份,2023-08-24,9296
00931B,統一美債20年,15,0,15,凱基-頭份,2023-08-24,9296
2883,凱基金,16,2,14,凱基-頭份,2023-08-24,9296
2376,技嘉,30,16,14,凱基-頭份,2023-08-24,9296
2516,新建,14,0,14,凱基-頭份,2023-08-24,9296
4960,誠美材,14,0,14,凱基-頭份,2023-08-24,9296
2363,矽統,82,69,13,凱基-頭份,2023-08-24,9296
3710,連展投控,13,0,13,凱基-頭份,2023-08-24,9296
2409,友達,15,3,12,凱基-頭份,2023-08-24,9296
6418,詠昇,12,0,12,凱基-頭份,2023-08-24,9296
00923,群益台ESG低碳50,16,5,11,凱基-頭份,2023-08-24,9296
4543,萬在,14,3,11,凱基-頭份,2023-08-24,9296
6170,統振,12,1,11,凱基-頭份,2023-08-24,9296
00664R,國泰臺灣加權反1,10,0,10,凱基-頭份,2023-08-24,9296
1319,東陽,10,0,10,凱基-頭份,2023-08-24,9296
1568,倉佑,10,0,10,凱基-頭份,2023-08-24,9296
2344,華邦電,17,7,10,凱基-頭份,2023-08-24,9296
2441,超豐,13,3,10,凱基-頭份,2023-08-24,9296
3021,鴻名,25,16,9,凱基-頭份,2023-08-24,9296
1734,杏輝,8,0,8,凱基-頭份,2023-08-24,9296
2436,偉詮電,16,8,8,凱基-頭份,2023-08-24,9296
3704,合勤控,7,0,7,凱基-頭份,2023-08-24,9296
2329,華泰,23,16,7,凱基-頭份,2023-08-24,9296
2399,映泰,12,6,6,凱基-頭份,2023-08-24,9296
2890,永豐金,6,0,6,凱基-頭份,2023-08-24,9296
3706,神達,6,0,6,凱基-頭份,2023-08-24,9296
00891,中信關鍵半導體,5,0,5,凱基-頭份,2023-08-24,9296
1710,東聯,5,0,5,凱基-頭份,2023-08-24,9296
1905,華紙,5,0,5,凱基-頭份,2023-08-24,9296
2618,長榮航,7,2,5,凱基-頭份,2023-08-24,9296
2888,新光金,10,5,5,凱基-頭份,2023-08-24,9296
3564,其陽,5,0,5,凱基-頭份,2023-08-24,9296
3694,海華,6,1,5,凱基-頭份,2023-08-24,9296
4532,瑞智,5,0,5,凱基-頭份,2023-08-24,9296
5348,正能量智能,5,0,5,凱基-頭份,2023-08-24,9296
8358,金居,5,0,5,凱基-頭份,2023-08-24,9296
1471,首利,7,3,4,凱基-頭份,2023-08-24,9296
2408,南亞科,4,0,4,凱基-頭份,2023-08-24,9296
3308,聯德,4,0,4,凱基-頭份,2023-08-24,9296
3715,定穎投控,20,16,4,凱基-頭份,2023-08-24,9296
4162,智擎,5,1,4,凱基-頭份,2023-08-24,9296
5215,科嘉-KY,6,2,4,凱基-頭份,2023-08-24,9296
2880,華南金,4,0,4,凱基-頭份,2023-08-24,9296
00679B,元大美債20年,4,0,4,凱基-頭份,2023-08-24,9296
6188,廣明,3,0,3,凱基-頭份,2023-08-24,9296
00929,復華台灣科技優息,104,7,97,凱基-頭份,2023-08-25,9296
00878,國泰永續高股息,93,13,80,凱基-頭份,2023-08-25,9296
00919,群益台灣精選高息,30,0,30,凱基-頭份,2023-08-25,9296
2399,映泰,23,0,23,凱基-頭份,2023-08-25,9296
3231,緯創,43,21,22,凱基-頭份,2023-08-25,9296
6218,豪勉,22,0,22,凱基-頭份,2023-08-25,9296
2363,矽統,79,58,21,凱基-頭份,2023-08-25,9296
4906,正文,26,5,21,凱基-頭份,2023-08-25,9296
00923,群益台ESG低碳50,19,0,19,凱基-頭份,2023-08-25,9296
3060,銘異,20,1,19,凱基-頭份,2023-08-25,9296
2634,漢翔,20,2,18,凱基-頭份,2023-08-25,9296
2608,嘉里大榮,15,0,15,凱基-頭份,2023-08-25,9296
2485,兆赫,28,14,14,凱基-頭份,2023-08-25,9296
2330,台積電,13,0,13,凱基-頭份,2023-08-25,9296
3149,正達,12,0,12,凱基-頭份,2023-08-25,9296
3706,神達,13,1,12,凱基-頭份,2023-08-25,9296
00664R,國泰臺灣加權反1,10,0,10,凱基-頭份,2023-08-25,9296
3013,晟銘電,17,7,10,凱基-頭份,2023-08-25,9296
2353,宏��,10,1,9,凱基-頭份,2023-08-25,9296
2888,新光金,10,1,9,凱基-頭份,2023-08-25,9296
2618,長榮航,14,6,8,凱基-頭份,2023-08-25,9296
00641R,富邦日本反1,8,0,8,凱基-頭份,2023-08-25,9296
6016,康和證,8,0,8,凱基-頭份,2023-08-25,9296
00882,中信中國高股息,8,2,6,凱基-頭份,2023-08-25,9296
00931B,統一美債20年,6,0,6,凱基-頭份,2023-08-25,9296
2382,廣達,17,11,6,凱基-頭份,2023-08-25,9296
2884,玉山金,6,0,6,凱基-頭份,2023-08-25,9296
0050,元大台灣50,5,0,5,凱基-頭份,2023-08-25,9296
2002,中鋼,5,0,5,凱基-頭份,2023-08-25,9296
2301,光寶科,5,0,5,凱基-頭份,2023-08-25,9296
2329,華泰,11,6,5,凱基-頭份,2023-08-25,9296
2520,冠德,5,0,5,凱基-頭份,2023-08-25,9296
3694,海華,5,0,5,凱基-頭份,2023-08-25,9296
5309,系統電,5,0,5,凱基-頭份,2023-08-25,9296
5381,合正,5,0,5,凱基-頭份,2023-08-25,9296
5880,合庫金,5,0,5,凱基-頭份,2023-08-25,9296
6170,統振,5,0,5,凱基-頭份,2023-08-25,9296
8033,雷虎,5,0,5,凱基-頭份,2023-08-25,9296
1101,台泥,4,0,4,凱基-頭份,2023-08-25,9296
00665L,富邦�琤肭磪囓�2,4,0,4,凱基-頭份,2023-08-25,9296
00712,復華富時不動產,5,1,4,凱基-頭份,2023-08-25,9296
1309,台達化,4,0,4,凱基-頭份,2023-08-25,9296
3017,奇鋐,4,0,4,凱基-頭份,2023-08-25,9296
3372,典範,4,0,4,凱基-頭份,2023-08-25,9296
3406,玉晶光,4,0,4,凱基-頭份,2023-08-25,9296
3455,由田,4,0,4,凱基-頭份,2023-08-25,9296
6108,競國,4,0,4,凱基-頭份,2023-08-25,9296
6233,旺玖,4,0,4,凱基-頭份,2023-08-25,9296
00881,國泰台灣5G+,4,0,4,凱基-頭份,2023-08-25,9296
2345,智邦,3,0,3,凱基-頭份,2023-08-25,9296
00712,復華富時不動產,105,0,105,凱基-頭份,2023-08-28,9296
00753L,中信中國50正2,50,0,50,凱基-頭份,2023-08-28,9296
00929,復華台灣科技優息,44,0,44,凱基-頭份,2023-08-28,9296
00637L,元大滬深300正2,73,32,41,凱基-頭份,2023-08-28,9296
00632R,元大台灣50反1,36,0,36,凱基-頭份,2023-08-28,9296
00878,國泰永續高股息,39,6,33,凱基-頭份,2023-08-28,9296
2883B,凱基金乙特,30,0,30,凱基-頭份,2023-08-28,9296
00900,富邦特選高股息30,21,0,21,凱基-頭份,2023-08-28,9296
3234,光環,17,0,17,凱基-頭份,2023-08-28,9296
00919,群益台灣精選高息,15,0,15,凱基-頭份,2023-08-28,9296
2449,京元電子,25,11,14,凱基-頭份,2023-08-28,9296
00882,中信中國高股息,48,34,14,凱基-頭份,2023-08-28,9296
3149,正達,14,0,14,凱基-頭份,2023-08-28,9296
2618,長榮航,22,9,13,凱基-頭份,2023-08-28,9296
2405,輔信,13,1,12,凱基-頭份,2023-08-28,9296
00664R,國泰臺灣加權反1,10,0,10,凱基-頭份,2023-08-28,9296
2888,新光金,10,0,10,凱基-頭份,2023-08-28,9296
4123,晟德,10,0,10,凱基-頭份,2023-08-28,9296
4906,正文,16,6,10,凱基-頭份,2023-08-28,9296
5309,系統電,10,0,10,凱基-頭份,2023-08-28,9296
6265,方土昶,10,0,10,凱基-頭份,2023-08-28,9296
9934,成霖,10,0,10,凱基-頭份,2023-08-28,9296
2329,華泰,18,9,9,凱基-頭份,2023-08-28,9296
3227,原相,12,3,9,凱基-頭份,2023-08-28,9296
2332,友訊,8,0,8,凱基-頭份,2023-08-28,9296
3710,連展投控,8,0,8,凱基-頭份,2023-08-28,9296
6492,生華科,8,0,8,凱基-頭份,2023-08-28,9296
2834,臺企銀,7,0,7,凱基-頭份,2023-08-28,9296
1737,臺鹽,6,0,6,凱基-頭份,2023-08-28,9296
3479,安勤,6,0,6,凱基-頭份,2023-08-28,9296
2409,友達,8,2,6,凱基-頭份,2023-08-28,9296
2388,威盛,12,6,6,凱基-頭份,2023-08-28,9296
2312,金寶,5,0,5,凱基-頭份,2023-08-28,9296
00902,中信電池及儲能,5,0,5,凱基-頭份,2023-08-28,9296
00715L,期街口布蘭特正2,5,0,5,凱基-頭份,2023-08-28,9296
2482,連宇,5,0,5,凱基-頭份,2023-08-28,9296
3416,融程電,5,0,5,凱基-頭份,2023-08-28,9296
4167,松瑞藥,5,0,5,凱基-頭份,2023-08-28,9296
5880,合庫金,5,0,5,凱基-頭份,2023-08-28,9296
6167,久正,5,0,5,凱基-頭份,2023-08-28,9296
6218,豪勉,5,0,5,凱基-頭份,2023-08-28,9296
1444,力麗,4,0,4,凱基-頭份,2023-08-28,9296
2601,益航,4,0,4,凱基-頭份,2023-08-28,9296
4909,新復興,4,0,4,凱基-頭份,2023-08-28,9296
6168,宏齊,5,1,4,凱基-頭份,2023-08-28,9296
8103,瀚荃,4,0,4,凱基-頭份,2023-08-28,9296
00720B,元大投資級公司債,3,0,3,凱基-頭份,2023-08-28,9296
2022,聚亨,3,0,3,凱基-頭份,2023-08-28,9296
2706,第一店,3,0,3,凱基-頭份,2023-08-28,9296
3011,今皓,5,2,3,凱基-頭份,2023-08-28,9296
00929,復華台灣科技優息,131,0,131,凱基-頭份,2023-08-29,9296
2888,新光金,55,8,47,凱基-頭份,2023-08-29,9296
00664R,國泰臺灣加權反1,40,0,40,凱基-頭份,2023-08-29,9296
3231,緯創,30,10,20,凱基-頭份,2023-08-29,9296
00878,國泰永續高股息,26,7,19,凱基-頭份,2023-08-29,9296
00900,富邦特選高股息30,16,0,16,凱基-頭份,2023-08-29,9296
4906,正文,17,1,16,凱基-頭份,2023-08-29,9296
2363,矽統,31,18,13,凱基-頭份,2023-08-29,9296
5880,合庫金,13,0,13,凱基-頭份,2023-08-29,9296
2002,中鋼,12,0,12,凱基-頭份,2023-08-29,9296
2329,華泰,24,13,11,凱基-頭份,2023-08-29,9296
2516,新建,11,0,11,凱基-頭份,2023-08-29,9296
6265,方土昶,10,0,10,凱基-頭份,2023-08-29,9296
2303,聯電,11,2,9,凱基-頭份,2023-08-29,9296
8034,榮群,10,1,9,凱基-頭份,2023-08-29,9296
00919,群益台灣精選高息,8,0,8,凱基-頭份,2023-08-29,9296
1612,宏泰,8,0,8,凱基-頭份,2023-08-29,9296
3234,光環,8,0,8,凱基-頭份,2023-08-29,9296
2618,長榮航,13,6,7,凱基-頭份,2023-08-29,9296
6213,聯茂,13,6,7,凱基-頭份,2023-08-29,9296
2388,威盛,9,3,6,凱基-頭份,2023-08-29,9296
006208,富邦台50,5,0,5,凱基-頭份,2023-08-29,9296
2106,建大,5,0,5,凱基-頭份,2023-08-29,9296
2399,映泰,5,0,5,凱基-頭份,2023-08-29,9296
2409,友達,7,2,5,凱基-頭份,2023-08-29,9296
2515,中工,5,0,5,凱基-頭份,2023-08-29,9296
2601,益航,5,0,5,凱基-頭份,2023-08-29,9296
2317,鴻海,4,0,4,凱基-頭份,2023-08-29,9296
2468,華經,4,0,4,凱基-頭份,2023-08-29,9296
3372,典範,4,0,4,凱基-頭份,2023-08-29,9296
6285,啟��,6,2,4,凱基-頭份,2023-08-29,9296
6770,力積電,4,0,4,凱基-頭份,2023-08-29,9296
3481,群創,6,2,4,凱基-頭份,2023-08-29,9296
0051,元大中型100,4,0,4,凱基-頭份,2023-08-29,9296
2449,京元電子,8,5,3,凱基-頭份,2023-08-29,9296
2892,第一金,3,0,3,凱基-頭份,2023-08-29,9296
9946,三發地產,3,0,3,凱基-頭份,2023-08-29,9296
1711,永光,2,0,2,凱基-頭份,2023-08-29,9296
1434,福懋,2,0,2,凱基-頭份,2023-08-29,9296
1342,八貫,2,0,2,凱基-頭份,2023-08-29,9296
1802,台玻,2,0,2,凱基-頭份,2023-08-29,9296
2105,正新,2,0,2,凱基-頭份,2023-08-29,9296
2107,厚生,2,0,2,凱基-頭份,2023-08-29,9296
2330,台積電,2,0,2,凱基-頭份,2023-08-29,9296
2352,佳世達,2,0,2,凱基-頭份,2023-08-29,9296
2362,藍天,8,6,2,凱基-頭份,2023-08-29,9296
2405,輔信,2,0,2,凱基-頭份,2023-08-29,9296
2419,仲琦,2,0,2,凱基-頭份,2023-08-29,9296
2462,良得電,2,0,2,凱基-頭份,2023-08-29,9296
2615,萬海,70,68,2,凱基-頭份,2023-08-29,9296
00712,復華富時不動產,52,0,52,凱基-頭份,2023-08-30,9296
2106,建大,45,0,45,凱基-頭份,2023-08-30,9296
00929,復華台灣科技優息,41,0,41,凱基-頭份,2023-08-30,9296
3149,正達,39,0,39,凱基-頭份,2023-08-30,9296
00637L,元大滬深300正2,37,5,32,凱基-頭份,2023-08-30,9296
00931B,統一美債20年,29,0,29,凱基-頭份,2023-08-30,9296
00900,富邦特選高股息30,21,0,21,凱基-頭份,2023-08-30,9296
00885,富邦越南,18,2,16,凱基-頭份,2023-08-30,9296
2886,兆豐金,15,0,15,凱基-頭份,2023-08-30,9296
00795B,中信美國公債20年,20,5,15,凱基-頭份,2023-08-30,9296
3015,全漢,12,0,12,凱基-頭份,2023-08-30,9296
1463,強盛新,10,0,10,凱基-頭份,2023-08-30,9296
00753L,中信中國50正2,10,0,10,凱基-頭份,2023-08-30,9296
2618,長榮航,19,10,9,凱基-頭份,2023-08-30,9296
2816,旺旺保,11,2,9,凱基-頭份,2023-08-30,9296
2301,光寶科,15,7,8,凱基-頭份,2023-08-30,9296
3567,逸昌,12,4,8,凱基-頭份,2023-08-30,9296
4543,萬在,8,0,8,凱基-頭份,2023-08-30,9296
2206,三陽工業,9,2,7,凱基-頭份,2023-08-30,9296
00715L,期街口布蘭特正2,6,0,6,凱基-頭份,2023-08-30,9296
1309,台達化,10,4,6,凱基-頭份,2023-08-30,9296
3306,鼎天,7,1,6,凱基-頭份,2023-08-30,9296
6456,GIS-KY,6,0,6,凱基-頭份,2023-08-30,9296
2884,玉山金,5,0,5,凱基-頭份,2023-08-30,9296
1451,年興,5,0,5,凱基-頭份,2023-08-30,9296
2340,台亞,5,0,5,凱基-頭份,2023-08-30,9296
2834,臺企銀,5,0,5,凱基-頭份,2023-08-30,9296
3006,晶豪科,5,0,5,凱基-頭份,2023-08-30,9296
3051,力特,6,1,5,凱基-頭份,2023-08-30,9296
4147,中裕,8,3,5,凱基-頭份,2023-08-30,9296
6116,彩晶,5,0,5,凱基-頭份,2023-08-30,9296
6492,生華科,5,0,5,凱基-頭份,2023-08-30,9296
2890,永豐金,5,1,4,凱基-頭份,2023-08-30,9296
00919,群益台灣精選高息,4,0,4,凱基-頭份,2023-08-30,9296
00633L,富邦上証正2,4,0,4,凱基-頭份,2023-08-30,9296
1737,臺鹽,4,0,4,凱基-頭份,2023-08-30,9296
2355,敬鵬,4,0,4,凱基-頭份,2023-08-30,9296
2421,建準,5,1,4,凱基-頭份,2023-08-30,9296
00713,元大台灣高息低波,3,0,3,凱基-頭份,2023-08-30,9296
1525,江申,3,0,3,凱基-頭份,2023-08-30,9296
3308,聯德,6,3,3,凱基-頭份,2023-08-30,9296
3587,閎康,6,3,3,凱基-頭份,2023-08-30,9296
3710,連展投控,3,0,3,凱基-頭份,2023-08-30,9296
5347,世界,3,0,3,凱基-頭份,2023-08-30,9296
6176,瑞儀,3,0,3,凱基-頭份,2023-08-30,9296
6285,啟��,8,5,3,凱基-頭份,2023-08-30,9296
6841,長佳智能,3,0,3,凱基-頭份,2023-08-30,9296
6282,康舒,4,2,2,凱基-頭份,2023-08-30,9296
2881,富邦金,2,0,2,凱基-頭份,2023-08-30,9296
1459,聯發,3,1,2,凱基-頭份,2023-08-30,9296
2834,臺企銀,56,2,54,凱基-頭份,2023-08-31,9296
2618,長榮航,38,6,32,凱基-頭份,2023-08-31,9296
2106,建大,25,0,25,凱基-頭份,2023-08-31,9296
2887,台新金,22,0,22,凱基-頭份,2023-08-31,9296
2337,旺宏,125,105,20,凱基-頭份,2023-08-31,9296
00641R,富邦日本反1,20,0,20,凱基-頭份,2023-08-31,9296
00919,群益台灣精選高息,25,9,16,凱基-頭份,2023-08-31,9296
1802,台玻,17,2,15,凱基-頭份,2023-08-31,9296
2888,新光金,15,0,15,凱基-頭份,2023-08-31,9296
3060,銘異,17,2,15,凱基-頭份,2023-08-31,9296
9103,美德醫療-DR,15,0,15,凱基-頭份,2023-08-31,9296
00878,國泰永續高股息,14,0,14,凱基-頭份,2023-08-31,9296
2344,華邦電,19,7,12,凱基-頭份,2023-08-31,9296
00687B,國泰20年美債,11,0,11,凱基-頭份,2023-08-31,9296
2630,亞航,14,3,11,凱基-頭份,2023-08-31,9296
00922,國泰台灣領袖50,10,0,10,凱基-頭份,2023-08-31,9296
00916,國泰全球品牌50,10,0,10,凱基-頭份,2023-08-31,9296
0056,元大高股息,10,0,10,凱基-頭份,2023-08-31,9296
1785,光洋科,10,0,10,凱基-頭份,2023-08-31,9296
3311,閎暉,10,0,10,凱基-頭份,2023-08-31,9296
3323,加百裕,10,0,10,凱基-頭份,2023-08-31,9296
2323,中環,10,0,10,凱基-頭份,2023-08-31,9296
0050,元大台灣50,12,4,8,凱基-頭份,2023-08-31,9296
2880,華南金,7,0,7,凱基-頭份,2023-08-31,9296
2610,華航,16,9,7,凱基-頭份,2023-08-31,9296
5880,合庫金,7,0,7,凱基-頭份,2023-08-31,9296
1568,倉佑,10,4,6,凱基-頭份,2023-08-31,9296
2355,敬鵬,6,0,6,凱基-頭份,2023-08-31,9296
2436,偉詮電,9,3,6,凱基-頭份,2023-08-31,9296
4543,萬在,6,0,6,凱基-頭份,2023-08-31,9296
1101,台泥,6,0,6,凱基-頭份,2023-08-31,9296
2892,第一金,6,1,5,凱基-頭份,2023-08-31,9296
00913,兆豐台灣晶圓製造,5,0,5,凱基-頭份,2023-08-31,9296
2353,宏��,5,0,5,凱基-頭份,2023-08-31,9296
8277,商丞,5,0,5,凱基-頭份,2023-08-31,9296
9929,秋雨,5,0,5,凱基-頭份,2023-08-31,9296
2330,台積電,4,0,4,凱基-頭份,2023-08-31,9296
2324,仁寶,7,3,4,凱基-頭份,2023-08-31,9296
3011,今皓,5,1,4,凱基-頭份,2023-08-31,9296
3058,立德,4,0,4,凱基-頭份,2023-08-31,9296
3363,上詮,5,1,4,凱基-頭份,2023-08-31,9296
5425,台半,4,0,4,凱基-頭份,2023-08-31,9296
6170,統振,5,1,4,凱基-頭份,2023-08-31,9296
8222,寶一,16,12,4,凱基-頭份,2023-08-31,9296
8446,華研,4,0,4,凱基-頭份,2023-08-31,9296
2891,中信金,4,1,3,凱基-頭份,2023-08-31,9296
2364,倫飛,3,0,3,凱基-頭份,2023-08-31,9296
2405,輔信,3,0,3,凱基-頭份,2023-08-31,9296
2414,精技,4,1,3,凱基-頭份,2023-08-31,9296
2929,淘帝-KY,5,2,3,凱基-頭份,2023-08-31,9296
00931B,統一美債20年,242,15,227,凱基-頭份,2023-09-01,9296
00712,復華富時不動產,200,5,195,凱基-頭份,2023-09-01,9296
1802,台玻,100,23,77,凱基-頭份,2023-09-01,9296
2520,冠德,50,0,50,凱基-頭份,2023-09-01,9296
2882,國泰金,50,3,47,凱基-頭份,2023-09-01,9296
2369,菱生,62,17,45,凱基-頭份,2023-09-01,9296
00932,兆豐永續高息等權,46,7,39,凱基-頭份,2023-09-01,9296
3706,神達,35,0,35,凱基-頭份,2023-09-01,9296
00878,國泰永續高股息,32,0,32,凱基-頭份,2023-09-01,9296
00929,復華台灣科技優息,37,5,32,凱基-頭份,2023-09-01,9296
3149,正達,35,5,30,凱基-頭份,2023-09-01,9296
4746,台耀,31,1,30,凱基-頭份,2023-09-01,9296
1459,聯發,21,0,21,凱基-頭份,2023-09-01,9296
2402,毅嘉,51,30,21,凱基-頭份,2023-09-01,9296
3051,力特,23,2,21,凱基-頭份,2023-09-01,9296
2838,聯邦銀,20,0,20,凱基-頭份,2023-09-01,9296
00673R,期元大S＆P原油反1,15,0,15,凱基-頭份,2023-09-01,9296
2367,燿華,15,1,14,凱基-頭份,2023-09-01,9296
1605,華新,15,2,13,凱基-頭份,2023-09-01,9296
3231,緯創,33,21,12,凱基-頭份,2023-09-01,9296
1609,大亞,33,21,12,凱基-頭份,2023-09-01,9296
00919,群益台灣精選高息,11,0,11,凱基-頭份,2023-09-01,9296
2329,華泰,16,5,11,凱基-頭份,2023-09-01,9296
00641R,富邦日本反1,10,0,10,凱基-頭份,2023-09-01,9296
00632R,元大台灣50反1,10,0,10,凱基-頭份,2023-09-01,9296
5347,世界,10,0,10,凱基-頭份,2023-09-01,9296
6125,廣運,11,1,10,凱基-頭份,2023-09-01,9296
1309,台達化,9,0,9,凱基-頭份,2023-09-01,9296
8034,榮群,10,1,9,凱基-頭份,2023-09-01,9296
2331,精英,35,27,8,凱基-頭份,2023-09-01,9296
2344,華邦電,24,16,8,凱基-頭份,2023-09-01,9296
2886,兆豐金,8,0,8,凱基-頭份,2023-09-01,9296
3011,今皓,10,3,7,凱基-頭份,2023-09-01,9296
3059,華晶科,7,0,7,凱基-頭份,2023-09-01,9296
6547,高端疫苗,11,4,7,凱基-頭份,2023-09-01,9296
2376,技嘉,13,7,6,凱基-頭份,2023-09-01,9296
2415,錩新,6,0,6,凱基-頭份,2023-09-01,9296
3630,新鉅科,6,0,6,凱基-頭份,2023-09-01,9296
9929,秋雨,6,0,6,凱基-頭份,2023-09-01,9296
9950,萬國通,6,0,6,凱基-頭份,2023-09-01,9296
00720B,元大投資級公司債,5,0,5,凱基-頭份,2023-09-01,9296
1603,華電,6,1,5,凱基-頭份,2023-09-01,9296
2374,佳能,5,0,5,凱基-頭份,2023-09-01,9296
2409,友達,8,3,5,凱基-頭份,2023-09-01,9296
2485,兆赫,11,6,5,凱基-頭份,2023-09-01,9296
2609,陽明,5,0,5,凱基-頭份,2023-09-01,9296
3013,晟銘電,11,6,5,凱基-頭份,2023-09-01,9296
8076,伍豐,5,0,5,凱基-頭份,2023-09-01,9296
3583,辛耘,5,1,4,凱基-頭份,2023-09-01,9296
8210,勤誠,10,6,4,凱基-頭份,2023-09-01,9296
00712,復華富時不動產,50,0,50,凱基-頭份,2023-09-04,9296
00915,凱基優選高股息30,50,0,50,凱基-頭份,2023-09-04,9296
00929,復華台灣科技優息,52,2,50,凱基-頭份,2023-09-04,9296
2520,冠德,23,0,23,凱基-頭份,2023-09-04,9296
2002,中鋼,20,1,19,凱基-頭份,2023-09-04,9296
00931B,統一美債20年,17,0,17,凱基-頭份,2023-09-04,9296
2363,矽統,32,16,16,凱基-頭份,2023-09-04,9296
5009,榮剛,22,7,15,凱基-頭份,2023-09-04,9296
2371,大同,14,0,14,凱基-頭份,2023-09-04,9296
1584,精剛,14,0,14,凱基-頭份,2023-09-04,9296
2022,聚亨,14,0,14,凱基-頭份,2023-09-04,9296
5381,合正,19,5,14,凱基-頭份,2023-09-04,9296
00632R,元大台灣50反1,12,0,12,凱基-頭份,2023-09-04,9296
3294,英濟,12,0,12,凱基-頭份,2023-09-04,9296
2323,中環,15,4,11,凱基-頭份,2023-09-04,9296
3149,正達,11,0,11,凱基-頭份,2023-09-04,9296
3481,群創,15,4,11,凱基-頭份,2023-09-04,9296
2883,凱基金,10,0,10,凱基-頭份,2023-09-04,9296
2009,第一銅,10,0,10,凱基-頭份,2023-09-04,9296
2023,燁輝,10,0,10,凱基-頭份,2023-09-04,9296
3167,大量,10,0,10,凱基-頭份,2023-09-04,9296
3234,光環,10,0,10,凱基-頭份,2023-09-04,9296
5328,華容,10,0,10,凱基-頭份,2023-09-04,9296
5347,世界,12,2,10,凱基-頭份,2023-09-04,9296
00720B,元大投資級公司債,9,0,9,凱基-頭份,2023-09-04,9296
6173,信昌電,9,0,9,凱基-頭份,2023-09-04,9296
9950,萬國通,15,6,9,凱基-頭份,2023-09-04,9296
1603,華電,14,7,7,凱基-頭份,2023-09-04,9296
1802,台玻,29,22,7,凱基-頭份,2023-09-04,9296
2301,光寶科,8,1,7,凱基-頭份,2023-09-04,9296
2369,菱生,10,3,7,凱基-頭份,2023-09-04,9296
2618,長榮航,8,1,7,凱基-頭份,2023-09-04,9296
00878,國泰永續高股息,18,11,7,凱基-頭份,2023-09-04,9296
2488,漢平,6,0,6,凱基-頭份,2023-09-04,9296
3043,科風,6,0,6,凱基-頭份,2023-09-04,9296
3290,東浦,8,2,6,凱基-頭份,2023-09-04,9296
2402,毅嘉,37,32,5,凱基-頭份,2023-09-04,9296
00679B,元大美債20年,5,0,5,凱基-頭份,2023-09-04,9296
00922,國泰台灣領袖50,5,0,5,凱基-頭份,2023-09-04,9296
1616,億泰,5,0,5,凱基-頭份,2023-09-04,9296
2409,友達,8,3,5,凱基-頭份,2023-09-04,9296
2472,立隆電,5,0,5,凱基-頭份,2023-09-04,9296
3704,合勤控,5,0,5,凱基-頭份,2023-09-04,9296
6290,良維,5,0,5,凱基-頭份,2023-09-04,9296
00706L,期元大S＆P日圓正2,4,0,4,凱基-頭份,2023-09-04,9296
1304,台聚,4,0,4,凱基-頭份,2023-09-04,9296
1402,遠東新,4,0,4,凱基-頭份,2023-09-04,9296
2352,佳世達,4,0,4,凱基-頭份,2023-09-04,9296
3260,威剛,4,0,4,凱基-頭份,2023-09-04,9296
4123,晟德,4,0,4,凱基-頭份,2023-09-04,9296
2443,昶虹,82,0,82,凱基-頭份,2023-09-05,9296
00712,復華富時不動產,51,0,51,凱基-頭份,2023-09-05,9296
00919,群益台灣精選高息,41,0,41,凱基-頭份,2023-09-05,9296
1734,杏輝,40,0,40,凱基-頭份,2023-09-05,9296
00915,凱基優選高股息30,39,0,39,凱基-頭份,2023-09-05,9296
3149,正達,30,0,30,凱基-頭份,2023-09-05,9296
00878,國泰永續高股息,24,3,21,凱基-頭份,2023-09-05,9296
2801,彰銀,18,0,18,凱基-頭份,2023-09-05,9296
2603,長榮,15,0,15,凱基-頭份,2023-09-05,9296
2363,矽統,44,32,12,凱基-頭份,2023-09-05,9296
4989,榮科,12,0,12,凱基-頭份,2023-09-05,9296
2331,精英,17,7,10,凱基-頭份,2023-09-05,9296
1304,台聚,10,0,10,凱基-頭份,2023-09-05,9296
00662,富邦NASDAQ,10,0,10,凱基-頭份,2023-09-05,9296
2337,旺宏,54,46,8,凱基-頭份,2023-09-05,9296
2891,中信金,8,0,8,凱基-頭份,2023-09-05,9296
3260,威剛,10,2,8,凱基-頭份,2023-09-05,9296
00720B,元大投資級公司債,7,0,7,凱基-頭份,2023-09-05,9296
2388,威盛,12,5,7,凱基-頭份,2023-09-05,9296
00929,復華台灣科技優息,68,61,7,凱基-頭份,2023-09-05,9296
2402,毅嘉,29,23,6,凱基-頭份,2023-09-05,9296
00900,富邦特選高股息30,6,0,6,凱基-頭份,2023-09-05,9296
2492,華新科,13,7,6,凱基-頭份,2023-09-05,9296
2515,中工,6,0,6,凱基-頭份,2023-09-05,9296
2618,長榮航,6,0,6,凱基-頭份,2023-09-05,9296
3715,定穎投控,14,8,6,凱基-頭份,2023-09-05,9296
6016,康和證,6,0,6,凱基-頭份,2023-09-05,9296
1449,佳和,5,0,5,凱基-頭份,2023-09-05,9296
2634,漢翔,5,0,5,凱基-頭份,2023-09-05,9296
2886,兆豐金,5,0,5,凱基-頭份,2023-09-05,9296
4933,友輝,5,0,5,凱基-頭份,2023-09-05,9296
6841,長佳智能,5,0,5,凱基-頭份,2023-09-05,9296
9950,萬國通,5,0,5,凱基-頭份,2023-09-05,9296
4168,醣聯,5,0,5,凱基-頭份,2023-09-05,9296
2352,佳世達,5,0,5,凱基-頭份,2023-09-05,9296
0056,元大高股息,5,1,4,凱基-頭份,2023-09-05,9296
2201,裕隆,5,1,4,凱基-頭份,2023-09-05,9296
6213,聯茂,4,0,4,凱基-頭份,2023-09-05,9296
1471,首利,5,1,4,凱基-頭份,2023-09-05,9296
4123,晟德,4,1,3,凱基-頭份,2023-09-05,9296
1519,華城,8,5,3,凱基-頭份,2023-09-05,9296
1525,江申,3,0,3,凱基-頭份,2023-09-05,9296
2633,台灣高鐵,3,0,3,凱基-頭份,2023-09-05,9296
2892,第一金,3,0,3,凱基-頭份,2023-09-05,9296
3014,聯陽,3,0,3,凱基-頭份,2023-09-05,9296
3042,晶技,3,0,3,凱基-頭份,2023-09-05,9296
3231,緯創,11,8,3,凱基-頭份,2023-09-05,9296
3548,兆利,3,0,3,凱基-頭份,2023-09-05,9296
3588,通嘉,10,7,3,凱基-頭份,2023-09-05,9296
4542,科嶠,3,0,3,凱基-頭份,2023-09-05,9296
00929,復華台灣科技優息,246,45,201,凱基-頭份,2023-09-06,9296
00919,群益台灣精選高息,31,0,31,凱基-頭份,2023-09-06,9296
2409,友達,28,3,25,凱基-頭份,2023-09-06,9296
3481,群創,35,11,24,凱基-頭份,2023-09-06,9296
00878,國泰永續高股息,29,7,22,凱基-頭份,2023-09-06,9296
5880,合庫金,20,0,20,凱基-頭份,2023-09-06,9296
00673R,期元大S＆P原油反1,20,0,20,凱基-頭份,2023-09-06,9296
1734,杏輝,20,0,20,凱基-頭份,2023-09-06,9296
2344,華邦電,31,14,17,凱基-頭份,2023-09-06,9296
2888,新光金,17,0,17,凱基-頭份,2023-09-06,9296
2891,中信金,16,0,16,凱基-頭份,2023-09-06,9296
00921,兆豐龍頭等權重,16,0,16,凱基-頭份,2023-09-06,9296
1449,佳和,15,0,15,凱基-頭份,2023-09-06,9296
3567,逸昌,22,9,13,凱基-頭份,2023-09-06,9296
5381,合正,16,3,13,凱基-頭份,2023-09-06,9296
3715,定穎投控,22,11,11,凱基-頭份,2023-09-06,9296
00641R,富邦日本反1,20,10,10,凱基-頭份,2023-09-06,9296
2009,第一銅,10,0,10,凱基-頭份,2023-09-06,9296
2401,凌陽,20,11,9,凱基-頭份,2023-09-06,9296
00882,中信中國高股息,11,2,9,凱基-頭份,2023-09-06,9296
2886,兆豐金,8,0,8,凱基-頭份,2023-09-06,9296
00915,凱基優選高股息30,7,0,7,凱基-頭份,2023-09-06,9296
1409,新纖,7,0,7,凱基-頭份,2023-09-06,9296
00931B,統一美債20年,6,0,6,凱基-頭份,2023-09-06,9296
3017,奇鋐,6,0,6,凱基-頭份,2023-09-06,9296
3043,科風,9,3,6,凱基-頭份,2023-09-06,9296
1784,訊聯,6,0,6,凱基-頭份,2023-09-06,9296
2609,陽明,8,2,6,凱基-頭份,2023-09-06,9296
3025,星通,11,5,6,凱基-頭份,2023-09-06,9296
3060,銘異,6,0,6,凱基-頭份,2023-09-06,9296
2356,英業達,12,6,6,凱基-頭份,2023-09-06,9296
2834,臺企銀,5,0,5,凱基-頭份,2023-09-06,9296
1324,地球,5,0,5,凱基-頭份,2023-09-06,9296
1710,東聯,5,0,5,凱基-頭份,2023-09-06,9296
3325,旭品,5,0,5,凱基-頭份,2023-09-06,9296
4977,眾達-KY,5,0,5,凱基-頭份,2023-09-06,9296
8011,台通,5,0,5,凱基-頭份,2023-09-06,9296
9929,秋雨,5,0,5,凱基-頭份,2023-09-06,9296
2892,第一金,5,0,5,凱基-頭份,2023-09-06,9296
2884,玉山金,4,0,4,凱基-頭份,2023-09-06,9296
2301,光寶科,5,1,4,凱基-頭份,2023-09-06,9296
2887,台新金,5,0,5,凱基-頭份,2023-09-06,9296
00720B,元大投資級公司債,4,0,4,凱基-頭份,2023-09-06,9296
2449,京元電子,64,60,4,凱基-頭份,2023-09-06,9296
00888,永豐台灣ESG,4,0,4,凱基-頭份,2023-09-06,9296
3011,今皓,5,1,4,凱基-頭份,2023-09-06,9296
3372,典範,4,0,4,凱基-頭份,2023-09-06,9296
4542,科嶠,4,0,4,凱基-頭份,2023-09-06,9296
4909,新復興,5,1,4,凱基-頭份,2023-09-06,9296
6016,康和證,4,0,4,凱基-頭份,2023-09-06,9296
00929,復華台灣科技優息,94,13,81,凱基-頭份,2023-09-07,9296
911868,同方友友-DR,49,0,49,凱基-頭份,2023-09-07,9296
4906,正文,41,8,33,凱基-頭份,2023-09-07,9296
00919,群益台灣精選高息,38,9,29,凱基-頭份,2023-09-07,9296
3704,合勤控,25,3,22,凱基-頭份,2023-09-07,9296
2409,友達,27,6,21,凱基-頭份,2023-09-07,9296
1734,杏輝,20,0,20,凱基-頭份,2023-09-07,9296
00878,國泰永續高股息,16,0,16,凱基-頭份,2023-09-07,9296
2443,昶虹,15,0,15,凱基-頭份,2023-09-07,9296
2303,聯電,14,1,13,凱基-頭份,2023-09-07,9296
2883,凱基金,11,0,11,凱基-頭份,2023-09-07,9296
8112,至上,20,9,11,凱基-頭份,2023-09-07,9296
2485,兆赫,21,10,11,凱基-頭份,2023-09-07,9296
2492,華新科,13,2,11,凱基-頭份,2023-09-07,9296
3231,緯創,17,6,11,凱基-頭份,2023-09-07,9296
00665L,富邦�琤肭磪囓�2,10,0,10,凱基-頭份,2023-09-07,9296
2884,玉山金,9,0,9,凱基-頭份,2023-09-07,9296
6182,合晶,9,1,8,凱基-頭份,2023-09-07,9296
00915,凱基優選高股息30,7,0,7,凱基-頭份,2023-09-07,9296
1101,台泥,8,1,7,凱基-頭份,2023-09-07,9296
00896,中信綠能及電動車,6,0,6,凱基-頭份,2023-09-07,9296
3042,晶技,5,0,5,凱基-頭份,2023-09-07,9296
1319,東陽,5,0,5,凱基-頭份,2023-09-07,9296
1449,佳和,5,0,5,凱基-頭份,2023-09-07,9296
2356,英業達,13,8,5,凱基-頭份,2023-09-07,9296
2460,建通,5,0,5,凱基-頭份,2023-09-07,9296
2486,一詮,9,4,5,凱基-頭份,2023-09-07,9296
2609,陽明,5,0,5,凱基-頭份,2023-09-07,9296
6127,九豪,5,0,5,凱基-頭份,2023-09-07,9296
9928,中視,5,0,5,凱基-頭份,2023-09-07,9296
3481,群創,7,3,4,凱基-頭份,2023-09-07,9296
2002,中鋼,4,0,4,凱基-頭份,2023-09-07,9296
6191,精成科,6,2,4,凱基-頭份,2023-09-07,9296
4915,致伸,7,3,4,凱基-頭份,2023-09-07,9296
1471,首利,5,1,4,凱基-頭份,2023-09-07,9296
2614,東森,4,0,4,凱基-頭份,2023-09-07,9296
5225,東科-KY,5,1,4,凱基-頭份,2023-09-07,9296
5348,正能量智能,4,0,4,凱基-頭份,2023-09-07,9296
6016,康和證,4,0,4,凱基-頭份,2023-09-07,9296
6689,伊雲谷,4,0,4,凱基-頭份,2023-09-07,9296
00712,復華富時不動產,3,0,3,凱基-頭份,2023-09-07,9296
00902,中信電池及儲能,3,0,3,凱基-頭份,2023-09-07,9296
00931B,統一美債20年,3,0,3,凱基-頭份,2023-09-07,9296
1616,億泰,3,0,3,凱基-頭份,2023-09-07,9296
1785,光洋科,3,0,3,凱基-頭份,2023-09-07,9296
1802,台玻,3,0,3,凱基-頭份,2023-09-07,9296
2390,云辰,43,40,3,凱基-頭份,2023-09-07,9296
2834,臺企銀,3,0,3,凱基-頭份,2023-09-07,9296
3005,神基,3,0,3,凱基-頭份,2023-09-07,9296
3011,今皓,3,0,3,凱基-頭份,2023-09-07,9296
00919,群益台灣精選高息,51,10,41,凱基-頭份,2023-09-08,9296
00915,凱基優選高股息30,28,0,28,凱基-頭份,2023-09-08,9296
00931B,統一美債20年,22,1,21,凱基-頭份,2023-09-08,9296
00715L,期街口布蘭特正2,20,0,20,凱基-頭份,2023-09-08,9296
9105,泰金寶-DR,25,5,20,凱基-頭份,2023-09-08,9296
2323,中環,15,0,15,凱基-頭份,2023-09-08,9296
8034,榮群,15,0,15,凱基-頭份,2023-09-08,9296
2457,飛宏,13,0,13,凱基-頭份,2023-09-08,9296
2358,廷鑫,12,0,12,凱基-頭份,2023-09-08,9296
2390,云辰,15,3,12,凱基-頭份,2023-09-08,9296
00753L,中信中國50正2,10,0,10,凱基-頭份,2023-09-08,9296
4944,兆遠,11,1,10,凱基-頭份,2023-09-08,9296
00632R,元大台灣50反1,9,0,9,凱基-頭份,2023-09-08,9296
2344,華邦電,16,8,8,凱基-頭份,2023-09-08,9296
8432,東生華,8,0,8,凱基-頭份,2023-09-08,9296
00878,國泰永續高股息,9,2,7,凱基-頭份,2023-09-08,9296
1313,聯成,7,0,7,凱基-頭份,2023-09-08,9296
1339,昭輝,7,0,7,凱基-頭份,2023-09-08,9296
3178,公準,9,2,7,凱基-頭份,2023-09-08,9296
2002,中鋼,5,0,5,凱基-頭份,2023-09-08,9296
2382,廣達,8,3,5,凱基-頭份,2023-09-08,9296
2412,中華電,5,0,5,凱基-頭份,2023-09-08,9296
2482,連宇,5,0,5,凱基-頭份,2023-09-08,9296
3011,今皓,5,0,5,凱基-頭份,2023-09-08,9296
3046,建��,12,7,5,凱基-頭份,2023-09-08,9296
3416,融程電,5,0,5,凱基-頭份,2023-09-08,9296
3483,力致,8,3,5,凱基-頭份,2023-09-08,9296
5410,國眾,5,0,5,凱基-頭份,2023-09-08,9296
2884,玉山金,5,0,5,凱基-頭份,2023-09-08,9296
1513,中興電,4,0,4,凱基-頭份,2023-09-08,9296
1618,合機,5,1,4,凱基-頭份,2023-09-08,9296
2301,光寶科,4,0,4,凱基-頭份,2023-09-08,9296
2374,佳能,4,0,4,凱基-頭份,2023-09-08,9296
3051,力特,4,0,4,凱基-頭份,2023-09-08,9296
3588,通嘉,11,7,4,凱基-頭份,2023-09-08,9296
4746,台耀,4,0,4,凱基-頭份,2023-09-08,9296
1101,台泥,3,0,3,凱基-頭份,2023-09-08,9296
6282,康舒,3,0,3,凱基-頭份,2023-09-08,9296
5880,合庫金,3,0,3,凱基-頭份,2023-09-08,9296
2376,技嘉,7,4,3,凱基-頭份,2023-09-08,9296
00916,國泰全球品牌50,5,2,3,凱基-頭份,2023-09-08,9296
00923,群益台ESG低碳50,3,0,3,凱基-頭份,2023-09-08,9296
1736,喬山,12,9,3,凱基-頭份,2023-09-08,9296
1786,科妍,3,0,3,凱基-頭份,2023-09-08,9296
2027,大成鋼,3,0,3,凱基-頭份,2023-09-08,9296
2029,盛餘,3,0,3,凱基-頭份,2023-09-08,9296
2204,中華,3,0,3,凱基-頭份,2023-09-08,9296
2313,華通,4,1,3,凱基-頭份,2023-09-08,9296
2329,華泰,4,1,3,凱基-頭份,2023-09-08,9296
2520,冠德,3,0,3,凱基-頭份,2023-09-08,9296
00712,復華富時不動產,110,2,108,凱基-頭份,2023-09-11,9296
00919,群益台灣精選高息,90,0,90,凱基-頭份,2023-09-11,9296
00878,國泰永續高股息,68,11,57,凱基-頭份,2023-09-11,9296
00915,凱基優選高股息30,48,1,47,凱基-頭份,2023-09-11,9296
1734,杏輝,35,0,35,凱基-頭份,2023-09-11,9296
00929,復華台灣科技優息,87,60,27,凱基-頭份,2023-09-11,9296
3323,加百裕,15,0,15,凱基-頭份,2023-09-11,9296
8112,至上,15,0,15,凱基-頭份,2023-09-11,9296
2204,中華,14,1,13,凱基-頭份,2023-09-11,9296
2388,威盛,22,9,13,凱基-頭份,2023-09-11,9296
2401,凌陽,12,0,12,凱基-頭份,2023-09-11,9296
2405,輔信,12,0,12,凱基-頭份,2023-09-11,9296
2888,新光金,12,0,12,凱基-頭份,2023-09-11,9296
3013,晟銘電,12,0,12,凱基-頭份,2023-09-11,9296
6191,精成科,12,0,12,凱基-頭份,2023-09-11,9296
3149,正達,12,0,12,凱基-頭份,2023-09-11,9296
00922,國泰台灣領袖50,11,0,11,凱基-頭份,2023-09-11,9296
2884,玉山金,13,2,11,凱基-頭份,2023-09-11,9296
2363,矽統,27,16,11,凱基-頭份,2023-09-11,9296
2886,兆豐金,11,0,11,凱基-頭份,2023-09-11,9296
3363,上詮,13,2,11,凱基-頭份,2023-09-11,9296
8088,品安,11,0,11,凱基-頭份,2023-09-11,9296
2402,毅嘉,11,0,11,凱基-頭份,2023-09-11,9296
00753L,中信中國50正2,10,0,10,凱基-頭份,2023-09-11,9296
00895,富邦未來車,10,0,10,凱基-頭份,2023-09-11,9296
00931B,統一美債20年,10,0,10,凱基-頭份,2023-09-11,9296
2025,千興,10,0,10,凱基-頭份,2023-09-11,9296
2630,亞航,17,7,10,凱基-頭份,2023-09-11,9296
3704,合勤控,11,1,10,凱基-頭份,2023-09-11,9296
4543,萬在,10,0,10,凱基-頭份,2023-09-11,9296
6770,力積電,10,0,10,凱基-頭份,2023-09-11,9296
1101,台泥,9,0,9,凱基-頭份,2023-09-11,9296
4906,正文,20,11,9,凱基-頭份,2023-09-11,9296
9907,統一實,10,1,9,凱基-頭份,2023-09-11,9296
00900,富邦特選高股息30,8,0,8,凱基-頭份,2023-09-11,9296
00918,大華優利高填息30,7,0,7,凱基-頭份,2023-09-11,9296
6122,擎邦,7,0,7,凱基-頭份,2023-09-11,9296
4142,國光生,6,0,6,凱基-頭份,2023-09-11,9296
3346,麗清,6,0,6,凱基-頭份,2023-09-11,9296
00923,群益台ESG低碳50,5,0,5,凱基-頭份,2023-09-11,9296
00921,兆豐龍頭等權重,5,0,5,凱基-頭份,2023-09-11,9296
00907,永豐優息存股,5,0,5,凱基-頭份,2023-09-11,9296
1737,臺鹽,5,0,5,凱基-頭份,2023-09-11,9296
2634,漢翔,10,5,5,凱基-頭份,2023-09-11,9296
2816,旺旺保,10,5,5,凱基-頭份,2023-09-11,9296
3176,基亞,5,0,5,凱基-頭份,2023-09-11,9296
4944,兆遠,5,0,5,凱基-頭份,2023-09-11,9296
6285,啟��,8,3,5,凱基-頭份,2023-09-11,9296
9928,中視,5,0,5,凱基-頭份,2023-09-11,9296
2317,鴻海,4,0,4,凱基-頭份,2023-09-11,9296
00919,群益台灣精選高息,68,0,68,凱基-頭份,2023-09-12,9296
00637L,元大滬深300正2,45,0,45,凱基-頭份,2023-09-12,9296
00878,國泰永續高股息,41,11,30,凱基-頭份,2023-09-12,9296
00918,大華優利高填息30,30,0,30,凱基-頭份,2023-09-12,9296
3149,正達,30,0,30,凱基-頭份,2023-09-12,9296
00929,復華台灣科技優息,51,26,25,凱基-頭份,2023-09-12,9296
3078,僑威,27,4,23,凱基-頭份,2023-09-12,9296
6125,廣運,24,1,23,凱基-頭份,2023-09-12,9296
00632R,元大台灣50反1,20,0,20,凱基-頭份,2023-09-12,9296
2330,台積電,15,0,15,凱基-頭份,2023-09-12,9296
00712,復華富時不動產,11,0,11,凱基-頭份,2023-09-12,9296
00673R,期元大S＆P原油反1,10,0,10,凱基-頭份,2023-09-12,9296
2883B,凱基金乙特,10,0,10,凱基-頭份,2023-09-12,9296
2929,淘帝-KY,10,0,10,凱基-頭份,2023-09-12,9296
0056,元大高股息,10,1,9,凱基-頭份,2023-09-12,9296
5880,合庫金,9,0,9,凱基-頭份,2023-09-12,9296
1471,首利,7,0,7,凱基-頭份,2023-09-12,9296
2618,長榮航,9,2,7,凱基-頭份,2023-09-12,9296
00915,凱基優選高股息30,7,0,7,凱基-頭份,2023-09-12,9296
3346,麗清,12,6,6,凱基-頭份,2023-09-12,9296
8081,致新,5,0,5,凱基-頭份,2023-09-12,9296
00902,中信電池及儲能,5,0,5,凱基-頭份,2023-09-12,9296
2855,統一證,5,0,5,凱基-頭份,2023-09-12,9296
3042,晶技,5,0,5,凱基-頭份,2023-09-12,9296
3213,茂訊,7,2,5,凱基-頭份,2023-09-12,9296
3276,宇環,5,0,5,凱基-頭份,2023-09-12,9296
3545,敦泰,9,4,5,凱基-頭份,2023-09-12,9296
3231,緯創,12,8,4,凱基-頭份,2023-09-12,9296
8222,寶一,4,0,4,凱基-頭份,2023-09-12,9296
8930,青鋼,6,2,4,凱基-頭份,2023-09-12,9296
8069,元太,3,0,3,凱基-頭份,2023-09-12,9296
1319,東陽,8,5,3,凱基-頭份,2023-09-12,9296
00636,國泰中國A50,3,0,3,凱基-頭份,2023-09-12,9296
00891,中信關鍵半導體,3,0,3,凱基-頭份,2023-09-12,9296
00882,中信中國高股息,3,0,3,凱基-頭份,2023-09-12,9296
2402,毅嘉,4,1,3,凱基-頭份,2023-09-12,9296
2476,鉅祥,3,0,3,凱基-頭份,2023-09-12,9296
3088,艾訊,3,0,3,凱基-頭份,2023-09-12,9296
3305,昇貿,6,3,3,凱基-頭份,2023-09-12,9296
3581,博磊,3,0,3,凱基-頭份,2023-09-12,9296
6451,訊芯-KY,4,1,3,凱基-頭份,2023-09-12,9296
9958,世紀鋼,3,0,3,凱基-頭份,2023-09-12,9296
3481,群創,10,8,2,凱基-頭份,2023-09-12,9296
00932,兆豐永續高息等權,2,0,2,凱基-頭份,2023-09-12,9296
00710B,復華彭博非投等債,2,0,2,凱基-頭份,2023-09-12,9296
00679B,元大美債20年,2,0,2,凱基-頭份,2023-09-12,9296
00756B,群益投等新興公債,2,0,2,凱基-頭份,2023-09-12,9296
1526,日馳,2,0,2,凱基-頭份,2023-09-12,9296
2329,華泰,7,5,2,凱基-頭份,2023-09-12,9296
2905,三商,2,0,2,凱基-頭份,2023-09-12,9296
00919,群益台灣精選高息,278,0,278,凱基-頭份,2023-09-13,9296
2363,矽統,235,25,210,凱基-頭份,2023-09-13,9296
00929,復華台灣科技優息,107,0,107,凱基-頭份,2023-09-13,9296
911868,同方友友-DR,99,0,99,凱基-頭份,2023-09-13,9296
1524,耿鼎,44,11,33,凱基-頭份,2023-09-13,9296
1319,東陽,39,12,27,凱基-頭份,2023-09-13,9296
1305,華夏,24,0,24,凱基-頭份,2023-09-13,9296
00878,國泰永續高股息,21,0,21,凱基-頭份,2023-09-13,9296
8150,南茂,17,2,15,凱基-頭份,2023-09-13,9296
1736,喬山,12,0,12,凱基-頭份,2023-09-13,9296
2029,盛餘,11,0,11,凱基-頭份,2023-09-13,9296
00712,復華富時不動產,10,0,10,凱基-頭份,2023-09-13,9296
1308,亞聚,10,0,10,凱基-頭份,2023-09-13,9296
3059,華晶科,10,0,10,凱基-頭份,2023-09-13,9296
00753L,中信中國50正2,10,0,10,凱基-頭份,2023-09-13,9296
00715L,期街口布蘭特正2,10,0,10,凱基-頭份,2023-09-13,9296
1402,遠東新,10,0,10,凱基-頭份,2023-09-13,9296
1504,東元,10,0,10,凱基-頭份,2023-09-13,9296
1616,億泰,10,0,10,凱基-頭份,2023-09-13,9296
1717,長興,10,0,10,凱基-頭份,2023-09-13,9296
3694,海華,10,0,10,凱基-頭份,2023-09-13,9296
6509,聚和,10,0,10,凱基-頭份,2023-09-13,9296
9103,美德醫療-DR,10,0,10,凱基-頭份,2023-09-13,9296
3481,群創,16,7,9,凱基-頭份,2023-09-13,9296
6182,合晶,8,0,8,凱基-頭份,2023-09-13,9296
00902,中信電池及儲能,8,0,8,凱基-頭份,2023-09-13,9296
2542,興富發,8,0,8,凱基-頭份,2023-09-13,9296
00900,富邦特選高股息30,7,0,7,凱基-頭份,2023-09-13,9296
4915,致伸,9,3,6,凱基-頭份,2023-09-13,9296
00931B,統一美債20年,6,0,6,凱基-頭份,2023-09-13,9296
2030,彰源,6,0,6,凱基-頭份,2023-09-13,9296
2886,兆豐金,6,0,6,凱基-頭份,2023-09-13,9296
1785,光洋科,5,0,5,凱基-頭份,2023-09-13,9296
2913,農林,5,0,5,凱基-頭份,2023-09-13,9296
00930,永豐ESG低碳高息,5,0,5,凱基-頭份,2023-09-13,9296
1612,宏泰,5,0,5,凱基-頭份,2023-09-13,9296
2206,三陽工業,6,1,5,凱基-頭份,2023-09-13,9296
2634,漢翔,8,3,5,凱基-頭份,2023-09-13,9296
9934,成霖,5,0,5,凱基-頭份,2023-09-13,9296
2883,凱基金,4,0,4,凱基-頭份,2023-09-13,9296
1101,台泥,4,0,4,凱基-頭份,2023-09-13,9296
1471,首利,4,0,4,凱基-頭份,2023-09-13,9296
2371,大同,4,0,4,凱基-頭份,2023-09-13,9296
2405,輔信,4,0,4,凱基-頭份,2023-09-13,9296
1102,亞泥,4,0,4,凱基-頭份,2023-09-13,9296
00923,群益台ESG低碳50,4,0,4,凱基-頭份,2023-09-13,9296
3701,大眾控,4,0,4,凱基-頭份,2023-09-13,9296
4919,新唐,67,63,4,凱基-頭份,2023-09-13,9296
5309,系統電,4,0,4,凱基-頭份,2023-09-13,9296
5871,中租-KY,4,0,4,凱基-頭份,2023-09-13,9296
00632R,元大台灣50反1,175,8,167,凱基-頭份,2023-09-14,9296
00712,復華富時不動產,110,0,110,凱基-頭份,2023-09-14,9296
00919,群益台灣精選高息,67,3,64,凱基-頭份,2023-09-14,9296
2610,華航,28,1,27,凱基-頭份,2023-09-14,9296
00929,復華台灣科技優息,33,16,17,凱基-頭份,2023-09-14,9296
2634,漢翔,12,0,12,凱基-頭份,2023-09-14,9296
2618,長榮航,12,0,12,凱基-頭份,2023-09-14,9296
00885,富邦越南,11,0,11,凱基-頭份,2023-09-14,9296
2371,大同,14,3,11,凱基-頭份,2023-09-14,9296
00641R,富邦日本反1,10,0,10,凱基-頭份,2023-09-14,9296
00664R,國泰臺灣加權反1,10,0,10,凱基-頭份,2023-09-14,9296
00673R,期元大S＆P原油反1,10,0,10,凱基-頭份,2023-09-14,9296
3056,富華新,10,0,10,凱基-頭份,2023-09-14,9296
8088,品安,10,0,10,凱基-頭份,2023-09-14,9296
1471,首利,10,1,9,凱基-頭份,2023-09-14,9296
1522,堤維西,27,18,9,凱基-頭份,2023-09-14,9296
5880,合庫金,8,0,8,凱基-頭份,2023-09-14,9296
3032,偉訓,8,0,8,凱基-頭份,2023-09-14,9296
4916,事欣科,8,0,8,凱基-頭份,2023-09-14,9296
3588,通嘉,9,2,7,凱基-頭份,2023-09-14,9296
2402,毅嘉,6,0,6,凱基-頭份,2023-09-14,9296
2611,志信,6,0,6,凱基-頭份,2023-09-14,9296
4979,華星光,14,8,6,凱基-頭份,2023-09-14,9296
3035,智原,23,18,5,凱基-頭份,2023-09-14,9296
1444,力麗,5,0,5,凱基-頭份,2023-09-14,9296
1611,中電,5,0,5,凱基-頭份,2023-09-14,9296
2206,三陽工業,6,1,5,凱基-頭份,2023-09-14,9296
2390,云辰,10,5,5,凱基-頭份,2023-09-14,9296
2801,彰銀,5,0,5,凱基-頭份,2023-09-14,9296
3060,銘異,5,0,5,凱基-頭份,2023-09-14,9296
3322,建舜電,5,0,5,凱基-頭份,2023-09-14,9296
3324,雙鴻,6,1,5,凱基-頭份,2023-09-14,9296
3709,鑫聯大投控,5,0,5,凱基-頭份,2023-09-14,9296
6122,擎邦,5,0,5,凱基-頭份,2023-09-14,9296
6179,亞通,5,0,5,凱基-頭份,2023-09-14,9296
9927,泰銘,4,0,4,凱基-頭份,2023-09-14,9296
00932,兆豐永續高息等權,4,0,4,凱基-頭份,2023-09-14,9296
1605,華新,5,1,4,凱基-頭份,2023-09-14,9296
2405,輔信,4,0,4,凱基-頭份,2023-09-14,9296
3338,泰碩,4,0,4,凱基-頭份,2023-09-14,9296
3005,神基,8,5,3,凱基-頭份,2023-09-14,9296
1319,東陽,20,17,3,凱基-頭份,2023-09-14,9296
00891,中信關鍵半導體,3,0,3,凱基-頭份,2023-09-14,9296
1727,中華化,3,0,3,凱基-頭份,2023-09-14,9296
2392,正崴,3,0,3,凱基-頭份,2023-09-14,9296
2449,京元電子,4,1,3,凱基-頭份,2023-09-14,9296
2890,永豐金,3,0,3,凱基-頭份,2023-09-14,9296
3380,明泰,4,1,3,凱基-頭份,2023-09-14,9296
3581,博磊,3,0,3,凱基-頭份,2023-09-14,9296
3694,海華,5,2,3,凱基-頭份,2023-09-14,9296
00919,群益台灣精選高息,109,12,97,凱基-頭份,2023-09-15,9296
00632R,元大台灣50反1,50,0,50,凱基-頭份,2023-09-15,9296
00929,復華台灣科技優息,68,21,47,凱基-頭份,2023-09-15,9296
4906,正文,27,0,27,凱基-頭份,2023-09-15,9296
2611,志信,22,0,22,凱基-頭份,2023-09-15,9296
1709,和益,20,0,20,凱基-頭份,2023-09-15,9296
2897,王道銀行,20,0,20,凱基-頭份,2023-09-15,9296
2610,華航,20,1,19,凱基-頭份,2023-09-15,9296
00915,凱基優選高股息30,20,2,18,凱基-頭份,2023-09-15,9296
3363,上詮,39,21,18,凱基-頭份,2023-09-15,9296
00930,永豐ESG低碳高息,19,2,17,凱基-頭份,2023-09-15,9296
00637L,元大滬深300正2,21,4,17,凱基-頭份,2023-09-15,9296
2405,輔信,23,6,17,凱基-頭份,2023-09-15,9296
2618,長榮航,28,12,16,凱基-頭份,2023-09-15,9296
00878,國泰永續高股息,18,2,16,凱基-頭份,2023-09-15,9296
00931B,統一美債20年,15,0,15,凱基-頭份,2023-09-15,9296
3149,正達,15,0,15,凱基-頭份,2023-09-15,9296
5347,世界,15,0,15,凱基-頭份,2023-09-15,9296
00655L,國泰中國A50正2,13,0,13,凱基-頭份,2023-09-15,9296
2891,中信金,13,2,11,凱基-頭份,2023-09-15,9296
00900,富邦特選高股息30,11,0,11,凱基-頭份,2023-09-15,9296
00712,復華富時不動產,11,0,11,凱基-頭份,2023-09-15,9296
1319,東陽,13,3,10,凱基-頭份,2023-09-15,9296
00673R,期元大S＆P原油反1,10,0,10,凱基-頭份,2023-09-15,9296
00753L,中信中國50正2,10,0,10,凱基-頭份,2023-09-15,9296
2486,一詮,36,26,10,凱基-頭份,2023-09-15,9296
2516,新建,10,0,10,凱基-頭份,2023-09-15,9296
2520,冠德,10,0,10,凱基-頭份,2023-09-15,9296
2607,榮運,10,0,10,凱基-頭份,2023-09-15,9296
3325,旭品,10,0,10,凱基-頭份,2023-09-15,9296
4529,淳紳,10,0,10,凱基-頭份,2023-09-15,9296
2329,華泰,14,5,9,凱基-頭份,2023-09-15,9296
2884,玉山金,8,0,8,凱基-頭份,2023-09-15,9296
2636,台驊控股,7,0,7,凱基-頭份,2023-09-15,9296
5880,合庫金,6,0,6,凱基-頭份,2023-09-15,9296
00882,中信中國高股息,8,2,6,凱基-頭份,2023-09-15,9296
2023,燁輝,6,0,6,凱基-頭份,2023-09-15,9296
3049,精金,6,0,6,凱基-頭份,2023-09-15,9296
8071,能率網通,6,0,6,凱基-頭份,2023-09-15,9296
1444,力麗,5,0,5,凱基-頭份,2023-09-15,9296
1459,聯發,5,0,5,凱基-頭份,2023-09-15,9296
2332,友訊,6,1,5,凱基-頭份,2023-09-15,9296
3013,晟銘電,6,1,5,凱基-頭份,2023-09-15,9296
3322,建舜電,5,0,5,凱基-頭份,2023-09-15,9296
3567,逸昌,5,0,5,凱基-頭份,2023-09-15,9296
4154,樂威科-KY,5,0,5,凱基-頭份,2023-09-15,9296
5315,光聯,5,0,5,凱基-頭份,2023-09-15,9296
5609,中菲行,5,0,5,凱基-頭份,2023-09-15,9296
8358,金居,14,9,5,凱基-頭份,2023-09-15,9296
00751B,元大AAA至A公司債,4,0,4,凱基-頭份,2023-09-15,9296
911608,明輝-DR,91,0,91,凱基-頭份,2023-09-18,9296
00919,群益台灣精選高息,51,2,49,凱基-頭份,2023-09-18,9296
00878,國泰永續高股息,43,14,29,凱基-頭份,2023-09-18,9296
00931B,統一美債20年,25,0,25,凱基-頭份,2023-09-18,9296
1444,力麗,20,0,20,凱基-頭份,2023-09-18,9296
00929,復華台灣科技優息,113,100,13,凱基-頭份,2023-09-18,9296
00673R,期元大S＆P原油反1,12,0,12,凱基-頭份,2023-09-18,9296
2363,矽統,43,31,12,凱基-頭份,2023-09-18,9296
2630,亞航,12,0,12,凱基-頭份,2023-09-18,9296
2618,長榮航,11,0,11,凱基-頭份,2023-09-18,9296
3704,合勤控,11,0,11,凱基-頭份,2023-09-18,9296
1316,上曜,10,0,10,凱基-頭份,2023-09-18,9296
2367,燿華,30,20,10,凱基-頭份,2023-09-18,9296
2538,基泰,10,0,10,凱基-頭份,2023-09-18,9296
2883B,凱基金乙特,10,0,10,凱基-頭份,2023-09-18,9296
3043,科風,10,0,10,凱基-頭份,2023-09-18,9296
00915,凱基優選高股息30,10,1,9,凱基-頭份,2023-09-18,9296
6274,台燿,11,2,9,凱基-頭份,2023-09-18,9296
2330,台積電,13,5,8,凱基-頭份,2023-09-18,9296
2516,新建,8,0,8,凱基-頭份,2023-09-18,9296
3011,今皓,8,0,8,凱基-頭份,2023-09-18,9296
3231,緯創,10,3,7,凱基-頭份,2023-09-18,9296
2427,三商電,7,0,7,凱基-頭份,2023-09-18,9296
6451,訊芯-KY,9,2,7,凱基-頭份,2023-09-18,9296
6282,康舒,7,0,7,凱基-頭份,2023-09-18,9296
00679B,元大美債20年,6,0,6,凱基-頭份,2023-09-18,9296
3037,欣興,6,0,6,凱基-頭份,2023-09-18,9296
2354,鴻準,6,1,5,凱基-頭份,2023-09-18,9296
00923,群益台ESG低碳50,5,0,5,凱基-頭份,2023-09-18,9296
00918,大華優利高填息30,5,0,5,凱基-頭份,2023-09-18,9296
2337,旺宏,6,1,5,凱基-頭份,2023-09-18,9296
2353,宏��,5,0,5,凱基-頭份,2023-09-18,9296
2388,威盛,14,9,5,凱基-頭份,2023-09-18,9296
2603,長榮,74,69,5,凱基-頭份,2023-09-18,9296
2610,華航,6,1,5,凱基-頭份,2023-09-18,9296
2897,王道銀行,5,0,5,凱基-頭份,2023-09-18,9296
3221,台嘉碩,5,0,5,凱基-頭份,2023-09-18,9296
6271,同欣電,5,0,5,凱基-頭份,2023-09-18,9296
00720B,元大投資級公司債,4,0,4,凱基-頭份,2023-09-18,9296
0050,元大台灣50,4,0,4,凱基-頭份,2023-09-18,9296
00772B,中信高評級公司債,4,0,4,凱基-頭份,2023-09-18,9296
00795B,中信美國公債20年,4,0,4,凱基-頭份,2023-09-18,9296
00751B,元大AAA至A公司債,4,0,4,凱基-頭份,2023-09-18,9296
00713,元大台灣高息低波,5,1,4,凱基-頭份,2023-09-18,9296
2301,光寶科,8,4,4,凱基-頭份,2023-09-18,9296
2425,承啟,4,0,4,凱基-頭份,2023-09-18,9296
2609,陽明,114,110,4,凱基-頭份,2023-09-18,9296
0056,元大高股息,4,0,4,凱基-頭份,2023-09-18,9296
00900,富邦特選高股息30,3,0,3,凱基-頭份,2023-09-18,9296
00637L,元大滬深300正2,5,2,3,凱基-頭份,2023-09-18,9296
00919,群益台灣精選高息,133,4,129,凱基-頭份,2023-09-19,9296
1316,上曜,31,0,31,凱基-頭份,2023-09-19,9296
3694,海華,23,2,21,凱基-頭份,2023-09-19,9296
1802,台玻,20,0,20,凱基-頭份,2023-09-19,9296
6168,宏齊,20,0,20,凱基-頭份,2023-09-19,9296
3013,晟銘電,20,2,18,凱基-頭份,2023-09-19,9296
5348,正能量智能,18,0,18,凱基-頭份,2023-09-19,9296
2356,英業達,13,0,13,凱基-頭份,2023-09-19,9296
00929,復華台灣科技優息,44,33,11,凱基-頭份,2023-09-19,9296
3704,合勤控,11,0,11,凱基-頭份,2023-09-19,9296
6182,合晶,11,0,11,凱基-頭份,2023-09-19,9296
00895,富邦未來車,10,0,10,凱基-頭份,2023-09-19,9296
1736,喬山,10,0,10,凱基-頭份,2023-09-19,9296
2390,云辰,20,10,10,凱基-頭份,2023-09-19,9296
2834,臺企銀,10,0,10,凱基-頭份,2023-09-19,9296
4746,台耀,10,0,10,凱基-頭份,2023-09-19,9296
00712,復華富時不動產,9,0,9,凱基-頭份,2023-09-19,9296
2344,華邦電,15,6,9,凱基-頭份,2023-09-19,9296
2427,三商電,9,0,9,凱基-頭份,2023-09-19,9296
4944,兆遠,9,0,9,凱基-頭份,2023-09-19,9296
1313,聯成,8,0,8,凱基-頭份,2023-09-19,9296
1717,長興,8,0,8,凱基-頭份,2023-09-19,9296
2538,基泰,20,12,8,凱基-頭份,2023-09-19,9296
6274,台燿,12,4,8,凱基-頭份,2023-09-19,9296
6901,鑽石投資,11,3,8,凱基-頭份,2023-09-19,9296
8401,白紗科,8,0,8,凱基-頭份,2023-09-19,9296
1711,永光,7,0,7,凱基-頭份,2023-09-19,9296
2520,冠德,7,0,7,凱基-頭份,2023-09-19,9296
3035,智原,15,8,7,凱基-頭份,2023-09-19,9296
2363,矽統,14,8,6,凱基-頭份,2023-09-19,9296
00902,中信電池及儲能,6,0,6,凱基-頭份,2023-09-19,9296
6285,啟��,9,4,5,凱基-頭份,2023-09-19,9296
00888,永豐台灣ESG,5,0,5,凱基-頭份,2023-09-19,9296
2609,陽明,56,51,5,凱基-頭份,2023-09-19,9296
1532,勤美,5,0,5,凱基-頭份,2023-09-19,9296
1522,堤維西,5,0,5,凱基-頭份,2023-09-19,9296
00923,群益台ESG低碳50,5,0,5,凱基-頭份,2023-09-19,9296
00673R,期元大S＆P原油反1,5,0,5,凱基-頭份,2023-09-19,9296
3025,星通,5,0,5,凱基-頭份,2023-09-19,9296
3520,華盈,5,0,5,凱基-頭份,2023-09-19,9296
6226,光鼎,5,0,5,凱基-頭份,2023-09-19,9296
8410,森田,5,0,5,凱基-頭份,2023-09-19,9296
2634,漢翔,5,1,4,凱基-頭份,2023-09-19,9296
00637L,元大滬深300正2,5,1,4,凱基-頭份,2023-09-19,9296
2376,技嘉,8,4,4,凱基-頭份,2023-09-19,9296
2401,凌陽,4,0,4,凱基-頭份,2023-09-19,9296
2618,長榮航,7,3,4,凱基-頭份,2023-09-19,9296
2891,中信金,4,0,4,凱基-頭份,2023-09-19,9296
3033,威健,4,0,4,凱基-頭份,2023-09-19,9296
3325,旭品,4,0,4,凱基-頭份,2023-09-19,9296
00929,復華台灣科技優息,125,27,98,凱基-頭份,2023-09-20,9296
00919,群益台灣精選高息,102,13,89,凱基-頭份,2023-09-20,9296
2603,長榮,46,2,44,凱基-頭份,2023-09-20,9296
8403,盛弘,35,0,35,凱基-頭份,2023-09-20,9296
3276,宇環,42,12,30,凱基-頭份,2023-09-20,9296
6139,亞翔,26,0,26,凱基-頭份,2023-09-20,9296
6197,佳必琪,22,0,22,凱基-頭份,2023-09-20,9296
2618,長榮航,24,6,18,凱基-頭份,2023-09-20,9296
00931B,統一美債20年,18,0,18,凱基-頭份,2023-09-20,9296
3231,緯創,34,16,18,凱基-頭份,2023-09-20,9296
00922,國泰台灣領袖50,16,0,16,凱基-頭份,2023-09-20,9296
2363,矽統,20,5,15,凱基-頭份,2023-09-20,9296
4945,陞達科技,15,0,15,凱基-頭份,2023-09-20,9296
2449,京元電子,26,13,13,凱基-頭份,2023-09-20,9296
1605,華新,13,1,12,凱基-頭份,2023-09-20,9296
2401,凌陽,12,0,12,凱基-頭份,2023-09-20,9296
2834,臺企銀,10,0,10,凱基-頭份,2023-09-20,9296
3043,科風,10,0,10,凱基-頭份,2023-09-20,9296
3078,僑威,10,0,10,凱基-頭份,2023-09-20,9296
3149,正達,10,0,10,凱基-頭份,2023-09-20,9296
00637L,元大滬深300正2,10,1,9,凱基-頭份,2023-09-20,9296
00893,國泰智能電動車,9,0,9,凱基-頭份,2023-09-20,9296
3704,合勤控,10,2,8,凱基-頭份,2023-09-20,9296
00932,兆豐永續高息等權,8,0,8,凱基-頭份,2023-09-20,9296
2390,云辰,11,3,8,凱基-頭份,2023-09-20,9296
00923,群益台ESG低碳50,7,0,7,凱基-頭份,2023-09-20,9296
00679B,元大美債20年,7,0,7,凱基-頭份,2023-09-20,9296
2888,新光金,7,0,7,凱基-頭份,2023-09-20,9296
6684,安格,7,0,7,凱基-頭份,2023-09-20,9296
2316,楠梓電,6,0,6,凱基-頭份,2023-09-20,9296
1532,勤美,5,0,5,凱基-頭份,2023-09-20,9296
2340,台亞,6,1,5,凱基-頭份,2023-09-20,9296
2520,冠德,5,0,5,凱基-頭份,2023-09-20,9296
2606,裕民,9,4,5,凱基-頭份,2023-09-20,9296
3257,虹冠電,5,0,5,凱基-頭份,2023-09-20,9296
6231,系微,5,0,5,凱基-頭份,2023-09-20,9296
6449,鈺邦,5,0,5,凱基-頭份,2023-09-20,9296
00878,國泰永續高股息,6,1,5,凱基-頭份,2023-09-20,9296
1795,美時,5,1,4,凱基-頭份,2023-09-20,9296
6213,聯茂,4,0,4,凱基-頭份,2023-09-20,9296
0050,元大台灣50,4,0,4,凱基-頭份,2023-09-20,9296
2206,三陽工業,6,2,4,凱基-頭份,2023-09-20,9296
2344,華邦電,19,15,4,凱基-頭份,2023-09-20,9296
2409,友達,6,2,4,凱基-頭份,2023-09-20,9296
2431,聯昌,4,0,4,凱基-頭份,2023-09-20,9296
3037,欣興,5,1,4,凱基-頭份,2023-09-20,9296
6168,宏齊,4,0,4,凱基-頭份,2023-09-20,9296
2330,台積電,3,0,3,凱基-頭份,2023-09-20,9296
3481,群創,11,8,3,凱基-頭份,2023-09-20,9296
1504,東元,3,0,3,凱基-頭份,2023-09-20,9296
00929,復華台灣科技優息,121,4,117,凱基-頭份,2023-09-21,9296
00637L,元大滬深300正2,51,1,50,凱基-頭份,2023-09-21,9296
6139,亞翔,40,0,40,凱基-頭份,2023-09-21,9296
00919,群益台灣精選高息,35,0,35,凱基-頭份,2023-09-21,9296
2834,臺企銀,35,0,35,凱基-頭份,2023-09-21,9296
6218,豪勉,34,0,34,凱基-頭份,2023-09-21,9296
00878,國泰永續高股息,24,1,23,凱基-頭份,2023-09-21,9296
00679B,元大美債20年,23,0,23,凱基-頭份,2023-09-21,9296
2888,新光金,23,0,23,凱基-頭份,2023-09-21,9296
3450,聯鈞,23,2,21,凱基-頭份,2023-09-21,9296
00895,富邦未來車,20,0,20,凱基-頭份,2023-09-21,9296
1584,精剛,22,2,20,凱基-頭份,2023-09-21,9296
8034,榮群,20,0,20,凱基-頭份,2023-09-21,9296
8403,盛弘,20,0,20,凱基-頭份,2023-09-21,9296
0050,元大台灣50,19,0,19,凱基-頭份,2023-09-21,9296
00902,中信電池及儲能,17,0,17,凱基-頭份,2023-09-21,9296
2344,華邦電,19,2,17,凱基-頭份,2023-09-21,9296
4173,久裕,16,0,16,凱基-頭份,2023-09-21,9296
1409,新纖,14,0,14,凱基-頭份,2023-09-21,9296
2605,新興,16,3,13,凱基-頭份,2023-09-21,9296
2838,聯邦銀,13,0,13,凱基-頭份,2023-09-21,9296
2002,中鋼,12,0,12,凱基-頭份,2023-09-21,9296
2892,第一金,12,0,12,凱基-頭份,2023-09-21,9296
2330,台積電,12,0,12,凱基-頭份,2023-09-21,9296
0056,元大高股息,17,5,12,凱基-頭份,2023-09-21,9296
3231,緯創,32,20,12,凱基-頭份,2023-09-21,9296
2401,凌陽,11,0,11,凱基-頭份,2023-09-21,9296
6217,中探針,11,1,10,凱基-頭份,2023-09-21,9296
00931B,統一美債20年,10,0,10,凱基-頭份,2023-09-21,9296
2208,台船,10,0,10,凱基-頭份,2023-09-21,9296
3704,合勤控,10,0,10,凱基-頭份,2023-09-21,9296
6282,康舒,10,0,10,凱基-頭份,2023-09-21,9296
9928,中視,10,0,10,凱基-頭份,2023-09-21,9296
9929,秋雨,10,0,10,凱基-頭份,2023-09-21,9296
5880,合庫金,10,0,10,凱基-頭份,2023-09-21,9296
2312,金寶,10,2,8,凱基-頭份,2023-09-21,9296
00923,群益台ESG低碳50,8,0,8,凱基-頭份,2023-09-21,9296
00680L,元大美債20正2,7,0,7,凱基-頭份,2023-09-21,9296
2548,華固,6,0,6,凱基-頭份,2023-09-21,9296
2883,凱基金,6,0,6,凱基-頭份,2023-09-21,9296
2891,中信金,6,0,6,凱基-頭份,2023-09-21,9296
00928,中信上櫃ESG30,5,0,5,凱基-頭份,2023-09-21,9296
1305,華夏,5,0,5,凱基-頭份,2023-09-21,9296
1444,力麗,5,0,5,凱基-頭份,2023-09-21,9296
1532,勤美,5,0,5,凱基-頭份,2023-09-21,9296
2105,正新,5,0,5,凱基-頭份,2023-09-21,9296
2211,長榮鋼,5,0,5,凱基-頭份,2023-09-21,9296
2374,佳能,5,0,5,凱基-頭份,2023-09-21,9296
2482,連宇,5,0,5,凱基-頭份,2023-09-21,9296
2520,冠德,5,0,5,凱基-頭份,2023-09-21,9296
00929,復華台灣科技優息,144,61,83,凱基-頭份,2023-09-22,9296
5388,中磊,50,0,50,凱基-頭份,2023-09-22,9296
5498,凱崴,40,0,40,凱基-頭份,2023-09-22,9296
00679B,元大美債20年,39,4,35,凱基-頭份,2023-09-22,9296
2882,國泰金,23,0,23,凱基-頭份,2023-09-22,9296
2834,臺企銀,22,0,22,凱基-頭份,2023-09-22,9296
00921,兆豐龍頭等權重,21,0,21,凱基-頭份,2023-09-22,9296
00720B,元大投資級公司債,20,0,20,凱基-頭份,2023-09-22,9296
00753L,中信中國50正2,20,0,20,凱基-頭份,2023-09-22,9296
00885,富邦越南,80,60,20,凱基-頭份,2023-09-22,9296
00895,富邦未來車,20,0,20,凱基-頭份,2023-09-22,9296
3622,洋華,20,0,20,凱基-頭份,2023-09-22,9296
2002,中鋼,17,1,16,凱基-頭份,2023-09-22,9296
1444,力麗,16,0,16,凱基-頭份,2023-09-22,9296
3092,鴻碩,14,0,14,凱基-頭份,2023-09-22,9296
2883,凱基金,12,0,12,凱基-頭份,2023-09-22,9296
00919,群益台灣精選高息,12,0,12,凱基-頭份,2023-09-22,9296
2303,聯電,11,0,11,凱基-頭份,2023-09-22,9296
2891,中信金,11,0,11,凱基-頭份,2023-09-22,9296
00900,富邦特選高股息30,10,0,10,凱基-頭份,2023-09-22,9296
00932,兆豐永續高息等權,10,0,10,凱基-頭份,2023-09-22,9296
00637L,元大滬深300正2,10,0,10,凱基-頭份,2023-09-22,9296
00795B,中信美國公債20年,10,0,10,凱基-頭份,2023-09-22,9296
2816,旺旺保,10,0,10,凱基-頭份,2023-09-22,9296
2883B,凱基金乙特,10,0,10,凱基-頭份,2023-09-22,9296
8403,盛弘,10,0,10,凱基-頭份,2023-09-22,9296
2618,長榮航,9,0,9,凱基-頭份,2023-09-22,9296
2929,淘帝-KY,9,0,9,凱基-頭份,2023-09-22,9296
2634,漢翔,12,4,8,凱基-頭份,2023-09-22,9296
2344,華邦電,11,3,8,凱基-頭份,2023-09-22,9296
2363,矽統,26,18,8,凱基-頭份,2023-09-22,9296
2867,三商壽,8,0,8,凱基-頭份,2023-09-22,9296
2905,三商,8,0,8,凱基-頭份,2023-09-22,9296
2330,台積電,9,1,8,凱基-頭份,2023-09-22,9296
00915,凱基優選高股息30,7,0,7,凱基-頭份,2023-09-22,9296
1584,精剛,7,0,7,凱基-頭份,2023-09-22,9296
3013,晟銘電,12,5,7,凱基-頭份,2023-09-22,9296
00687B,國泰20年美債,7,0,7,凱基-頭份,2023-09-22,9296
2641,正德,6,0,6,凱基-頭份,2023-09-22,9296
2820,華票,6,0,6,凱基-頭份,2023-09-22,9296
6257,矽格,6,0,6,凱基-頭份,2023-09-22,9296
00751B,元大AAA至A公司債,5,0,5,凱基-頭份,2023-09-22,9296
1519,華城,9,4,5,凱基-頭份,2023-09-22,9296
2388,威盛,8,3,5,凱基-頭份,2023-09-22,9296
2520,冠德,5,0,5,凱基-頭份,2023-09-22,9296
2801,彰銀,5,0,5,凱基-頭份,2023-09-22,9296
3043,科風,5,0,5,凱基-頭份,2023-09-22,9296
9929,秋雨,5,0,5,凱基-頭份,2023-09-22,9296
00878,國泰永續高股息,9,5,4,凱基-頭份,2023-09-22,9296
00772B,中信高評級公司債,4,0,4,凱基-頭份,2023-09-22,9296
3231,緯創,106,7,99,凱基-頭份,2023-09-25,9296
3149,正達,45,0,45,凱基-頭份,2023-09-25,9296
1815,富喬,46,9,37,凱基-頭份,2023-09-25,9296
8403,盛弘,35,0,35,凱基-頭份,2023-09-25,9296
00919,群益台灣精選高息,36,2,34,凱基-頭份,2023-09-25,9296
6108,競國,30,0,30,凱基-頭份,2023-09-25,9296
00679B,元大美債20年,22,0,22,凱基-頭份,2023-09-25,9296
00720B,元大投資級公司債,21,0,21,凱基-頭份,2023-09-25,9296
2332,友訊,20,0,20,凱基-頭份,2023-09-25,9296
3083,網龍,17,0,17,凱基-頭份,2023-09-25,9296
3567,逸昌,15,0,15,凱基-頭份,2023-09-25,9296
2303,聯電,17,3,14,凱基-頭份,2023-09-25,9296
00929,復華台灣科技優息,46,35,11,凱基-頭份,2023-09-25,9296
5258,虹堡,12,1,11,凱基-頭份,2023-09-25,9296
2885,元大金,10,0,10,凱基-頭份,2023-09-25,9296
3005,神基,11,1,10,凱基-頭份,2023-09-25,9296
00878,國泰永續高股息,17,7,10,凱基-頭份,2023-09-25,9296
1734,杏輝,10,0,10,凱基-頭份,2023-09-25,9296
2105,正新,10,0,10,凱基-頭份,2023-09-25,9296
2801,彰銀,10,0,10,凱基-頭份,2023-09-25,9296
2363,矽統,19,9,10,凱基-頭份,2023-09-25,9296
2888,新光金,10,1,9,凱基-頭份,2023-09-25,9296
2367,燿華,9,0,9,凱基-頭份,2023-09-25,9296
1229,聯華,8,0,8,凱基-頭份,2023-09-25,9296
2905,三商,8,0,8,凱基-頭份,2023-09-25,9296
2838,聯邦銀,7,0,7,凱基-頭份,2023-09-25,9296
3481,群創,9,2,7,凱基-頭份,2023-09-25,9296
4956,光鋐,7,0,7,凱基-頭份,2023-09-25,9296
5880,合庫金,7,0,7,凱基-頭份,2023-09-25,9296
6684,安格,8,1,7,凱基-頭份,2023-09-25,9296
1101,台泥,7,0,7,凱基-頭份,2023-09-25,9296
3037,欣興,6,0,6,凱基-頭份,2023-09-25,9296
00885,富邦越南,5,0,5,凱基-頭份,2023-09-25,9296
1737,臺鹽,5,0,5,凱基-頭份,2023-09-25,9296
2344,華邦電,11,6,5,凱基-頭份,2023-09-25,9296
2409,友達,7,2,5,凱基-頭份,2023-09-25,9296
2417,圓剛,5,0,5,凱基-頭份,2023-09-25,9296
2468,華經,5,0,5,凱基-頭份,2023-09-25,9296
2618,長榮航,7,2,5,凱基-頭份,2023-09-25,9296
3615,安可,6,1,5,凱基-頭份,2023-09-25,9296
6533,晶心科,5,0,5,凱基-頭份,2023-09-25,9296
2382,廣達,5,1,4,凱基-頭份,2023-09-25,9296
1605,華新,4,0,4,凱基-頭份,2023-09-25,9296
2392,正崴,4,0,4,凱基-頭份,2023-09-25,9296
2608,嘉里大榮,4,0,4,凱基-頭份,2023-09-25,9296
3044,健鼎,6,2,4,凱基-頭份,2023-09-25,9296
3163,波若威,11,7,4,凱基-頭份,2023-09-25,9296
6451,訊芯-KY,7,3,4,凱基-頭份,2023-09-25,9296
8011,台通,4,0,4,凱基-頭份,2023-09-25,9296
8261,富鼎,4,0,4,凱基-頭份,2023-09-25,9296
2614,東森,77,0,77,凱基-頭份,2023-09-26,9296
00929,復華台灣科技優息,64,3,61,凱基-頭份,2023-09-26,9296
00919,群益台灣精選高息,60,0,60,凱基-頭份,2023-09-26,9296
9934,成霖,48,0,48,凱基-頭份,2023-09-26,9296
00632R,元大台灣50反1,60,20,40,凱基-頭份,2023-09-26,9296
00878,國泰永續高股息,39,2,37,凱基-頭份,2023-09-26,9296
1513,中興電,35,0,35,凱基-頭份,2023-09-26,9296
00931B,統一美債20年,18,0,18,凱基-頭份,2023-09-26,9296
1101,台泥,16,0,16,凱基-頭份,2023-09-26,9296
00637L,元大滬深300正2,15,0,15,凱基-頭份,2023-09-26,9296
1522,堤維西,19,6,13,凱基-頭份,2023-09-26,9296
2888,新光金,13,0,13,凱基-頭份,2023-09-26,9296
2892,第一金,12,0,12,凱基-頭份,2023-09-26,9296
00720B,元大投資級公司債,12,0,12,凱基-頭份,2023-09-26,9296
00665L,富邦�琤肭磪囓�2,10,0,10,凱基-頭份,2023-09-26,9296
0056,元大高股息,10,0,10,凱基-頭份,2023-09-26,9296
00680L,元大美債20正2,10,0,10,凱基-頭份,2023-09-26,9296
2516,新建,10,0,10,凱基-頭份,2023-09-26,9296
3704,合勤控,11,1,10,凱基-頭份,2023-09-26,9296
6265,方土昶,10,0,10,凱基-頭份,2023-09-26,9296
6533,晶心科,10,0,10,凱基-頭份,2023-09-26,9296
2618,長榮航,9,0,9,凱基-頭份,2023-09-26,9296
3149,正達,9,0,9,凱基-頭份,2023-09-26,9296
1815,富喬,23,15,8,凱基-頭份,2023-09-26,9296
9927,泰銘,12,4,8,凱基-頭份,2023-09-26,9296
2206,三陽工業,12,4,8,凱基-頭份,2023-09-26,9296
2330,台積電,9,1,8,凱基-頭份,2023-09-26,9296
00923,群益台ESG低碳50,7,0,7,凱基-頭份,2023-09-26,9296
00679B,元大美債20年,10,4,6,凱基-頭份,2023-09-26,9296
3481,群創,12,6,6,凱基-頭份,2023-09-26,9296
00772B,中信高評級公司債,6,0,6,凱基-頭份,2023-09-26,9296
1584,精剛,6,0,6,凱基-頭份,2023-09-26,9296
2313,華通,7,1,6,凱基-頭份,2023-09-26,9296
2493,揚博,6,0,6,凱基-頭份,2023-09-26,9296
5381,合正,6,0,6,凱基-頭份,2023-09-26,9296
00751B,元大AAA至A公司債,5,0,5,凱基-頭份,2023-09-26,9296
1532,勤美,5,0,5,凱基-頭份,2023-09-26,9296
3013,晟銘電,16,11,5,凱基-頭份,2023-09-26,9296
3035,智原,5,0,5,凱基-頭份,2023-09-26,9296
6530,創威,5,0,5,凱基-頭份,2023-09-26,9296
8410,森田,5,0,5,凱基-頭份,2023-09-26,9296
2882,國泰金,6,2,4,凱基-頭份,2023-09-26,9296
1229,聯華,4,0,4,凱基-頭份,2023-09-26,9296
1339,昭輝,5,1,4,凱基-頭份,2023-09-26,9296
00795B,中信美國公債20年,4,0,4,凱基-頭份,2023-09-26,9296
00888,永豐台灣ESG,4,0,4,凱基-頭份,2023-09-26,9296
2303,聯電,9,5,4,凱基-頭份,2023-09-26,9296
2340,台亞,5,1,4,凱基-頭份,2023-09-26,9296
2392,正崴,4,0,4,凱基-頭份,2023-09-26,9296
2413,環科,4,0,4,凱基-頭份,2023-09-26,9296
5388,中磊,100,0,100,凱基-頭份,2023-09-27,9296
6770,力積電,44,13,31,凱基-頭份,2023-09-27,9296
00632R,元大台灣50反1,30,0,30,凱基-頭份,2023-09-27,9296
00929,復華台灣科技優息,38,10,28,凱基-頭份,2023-09-27,9296
1734,杏輝,20,0,20,凱基-頭份,2023-09-27,9296
2618,長榮航,21,1,20,凱基-頭份,2023-09-27,9296
00919,群益台灣精選高息,25,9,16,凱基-頭份,2023-09-27,9296
2883,凱基金,16,0,16,凱基-頭份,2023-09-27,9296
3704,合勤控,16,2,14,凱基-頭份,2023-09-27,9296
1101,台泥,15,1,14,凱基-頭份,2023-09-27,9296
6274,台燿,16,4,12,凱基-頭份,2023-09-27,9296
2002,中鋼,11,0,11,凱基-頭份,2023-09-27,9296
1815,富喬,14,3,11,凱基-頭份,2023-09-27,9296
00895,富邦未來車,10,0,10,凱基-頭份,2023-09-27,9296
00753L,中信中國50正2,10,0,10,凱基-頭份,2023-09-27,9296
2014,中鴻,16,6,10,凱基-頭份,2023-09-27,9296
3294,英濟,10,0,10,凱基-頭份,2023-09-27,9296
6197,佳必琪,11,1,10,凱基-頭份,2023-09-27,9296
8930,青鋼,10,1,9,凱基-頭份,2023-09-27,9296
00712,復華富時不動產,9,0,9,凱基-頭份,2023-09-27,9296
5465,富驊,11,2,9,凱基-頭份,2023-09-27,9296
3025,星通,13,5,8,凱基-頭份,2023-09-27,9296
2516,新建,7,0,7,凱基-頭份,2023-09-27,9296
2520,冠德,7,0,7,凱基-頭份,2023-09-27,9296
1471,首利,9,3,6,凱基-頭份,2023-09-27,9296
00900,富邦特選高股息30,6,0,6,凱基-頭份,2023-09-27,9296
2303,聯電,6,0,6,凱基-頭份,2023-09-27,9296
5410,國眾,6,0,6,凱基-頭份,2023-09-27,9296
6235,華孚,8,2,6,凱基-頭份,2023-09-27,9296
6492,生華科,6,0,6,凱基-頭份,2023-09-27,9296
00720B,元大投資級公司債,5,0,5,凱基-頭份,2023-09-27,9296
1339,昭輝,6,1,5,凱基-頭份,2023-09-27,9296
1584,精剛,5,0,5,凱基-頭份,2023-09-27,9296
1608,華榮,5,0,5,凱基-頭份,2023-09-27,9296
1711,永光,5,0,5,凱基-頭份,2023-09-27,9296
2449,京元電子,5,0,5,凱基-頭份,2023-09-27,9296
2605,新興,5,0,5,凱基-頭份,2023-09-27,9296
3043,科風,5,0,5,凱基-頭份,2023-09-27,9296
5880,合庫金,5,0,5,凱基-頭份,2023-09-27,9296
6533,晶心科,5,0,5,凱基-頭份,2023-09-27,9296
0050,元大台灣50,4,0,4,凱基-頭份,2023-09-27,9296
3481,群創,8,4,4,凱基-頭份,2023-09-27,9296
6122,擎邦,5,1,4,凱基-頭份,2023-09-27,9296
6451,訊芯-KY,9,5,4,凱基-頭份,2023-09-27,9296
2886,兆豐金,4,0,4,凱基-頭份,2023-09-27,9296
00878,國泰永續高股息,7,3,4,凱基-頭份,2023-09-27,9296
00885,富邦越南,3,0,3,凱基-頭份,2023-09-27,9296
00795B,中信美國公債20年,3,0,3,凱基-頭份,2023-09-27,9296
00907,永豐優息存股,3,0,3,凱基-頭份,2023-09-27,9296
00932,兆豐永續高息等權,3,0,3,凱基-頭份,2023-09-27,9296
2890,永豐金,201,61,140,凱基-頭份,2023-09-28,9296
3322,建舜電,60,5,55,凱基-頭份,2023-09-28,9296
00637L,元大滬深300正2,52,2,50,凱基-頭份,2023-09-28,9296
00929,復華台灣科技優息,42,9,33,凱基-頭份,2023-09-28,9296
00712,復華富時不動產,32,1,31,凱基-頭份,2023-09-28,9296
00715L,期街口布蘭特正2,24,0,24,凱基-頭份,2023-09-28,9296
2610,華航,23,0,23,凱基-頭份,2023-09-28,9296
1734,杏輝,20,0,20,凱基-頭份,2023-09-28,9296
2882,國泰金,20,0,20,凱基-頭份,2023-09-28,9296
1101,台泥,19,0,19,凱基-頭份,2023-09-28,9296
2344,華邦電,22,8,14,凱基-頭份,2023-09-28,9296
6770,力積電,14,0,14,凱基-頭份,2023-09-28,9296
3710,連展投控,12,0,12,凱基-頭份,2023-09-28,9296
00931B,統一美債20年,10,0,10,凱基-頭份,2023-09-28,9296
00902,中信電池及儲能,10,0,10,凱基-頭份,2023-09-28,9296
00665L,富邦�琤肭磪囓�2,10,0,10,凱基-頭份,2023-09-28,9296
1720,生達,10,0,10,凱基-頭份,2023-09-28,9296
2603,長榮,30,20,10,凱基-頭份,2023-09-28,9296
3058,立德,10,0,10,凱基-頭份,2023-09-28,9296
3706,神達,10,0,10,凱基-頭份,2023-09-28,9296
00720B,元大投資級公司債,9,0,9,凱基-頭份,2023-09-28,9296
2002,中鋼,11,2,9,凱基-頭份,2023-09-28,9296
8996,高力,9,0,9,凱基-頭份,2023-09-28,9296
00680L,元大美債20正2,6,0,6,凱基-頭份,2023-09-28,9296
1809,中釉,6,0,6,凱基-頭份,2023-09-28,9296
2363,矽統,13,7,6,凱基-頭份,2023-09-28,9296
3013,晟銘電,15,9,6,凱基-頭份,2023-09-28,9296
3056,富華新,6,0,6,凱基-頭份,2023-09-28,9296
1319,東陽,5,0,5,凱基-頭份,2023-09-28,9296
00673R,期元大S＆P原油反1,5,0,5,凱基-頭份,2023-09-28,9296
1618,合機,8,3,5,凱基-頭份,2023-09-28,9296
2211,長榮鋼,5,0,5,凱基-頭份,2023-09-28,9296
2376,技嘉,10,5,5,凱基-頭份,2023-09-28,9296
5880,合庫金,5,0,5,凱基-頭份,2023-09-28,9296
2382,廣達,20,15,5,凱基-頭份,2023-09-28,9296
3231,緯創,16,12,4,凱基-頭份,2023-09-28,9296
2317,鴻海,4,0,4,凱基-頭份,2023-09-28,9296
00916,國泰全球品牌50,4,0,4,凱基-頭份,2023-09-28,9296
1584,精剛,9,5,4,凱基-頭份,2023-09-28,9296
2618,長榮航,5,1,4,凱基-頭份,2023-09-28,9296
3338,泰碩,4,0,4,凱基-頭份,2023-09-28,9296
3596,智易,4,0,4,凱基-頭份,2023-09-28,9296
4726,永昕,4,0,4,凱基-頭份,2023-09-28,9296
5225,東科-KY,4,0,4,凱基-頭份,2023-09-28,9296
8071,能率網通,4,0,4,凱基-頭份,2023-09-28,9296
1522,堤維西,3,0,3,凱基-頭份,2023-09-28,9296
00919,群益台灣精選高息,203,200,3,凱基-頭份,2023-09-28,9296
00891,中信關鍵半導體,3,0,3,凱基-頭份,2023-09-28,9296
2408,南亞科,3,0,3,凱基-頭份,2023-09-28,9296
3630,新鉅科,3,0,3,凱基-頭份,2023-09-28,9296
2356,英業達,320,17,303,凱基-頭份,2023-10-02,9296
2618,長榮航,49,0,49,凱基-頭份,2023-10-02,9296
2409,友達,46,3,43,凱基-頭份,2023-10-02,9296
2002,中鋼,39,1,38,凱基-頭份,2023-10-02,9296
3630,新鉅科,31,0,31,凱基-頭份,2023-10-02,9296
2605,新興,24,0,24,凱基-頭份,2023-10-02,9296
2344,華邦電,25,3,22,凱基-頭份,2023-10-02,9296
2376,技嘉,33,11,22,凱基-頭份,2023-10-02,9296
00632R,元大台灣50反1,20,0,20,凱基-頭份,2023-10-02,9296
2382,廣達,18,1,17,凱基-頭份,2023-10-02,9296
3481,群創,19,4,15,凱基-頭份,2023-10-02,9296
1305,華夏,14,0,14,凱基-頭份,2023-10-02,9296
2887,台新金,14,0,14,凱基-頭份,2023-10-02,9296
4543,萬在,11,0,11,凱基-頭份,2023-10-02,9296
00931B,統一美債20年,10,0,10,凱基-頭份,2023-10-02,9296
00664R,國泰臺灣加權反1,10,0,10,凱基-頭份,2023-10-02,9296
00924,復華S＆P500成長,10,0,10,凱基-頭份,2023-10-02,9296
2367,燿華,10,0,10,凱基-頭份,2023-10-02,9296
1609,大亞,10,2,8,凱基-頭份,2023-10-02,9296
2603,長榮,9,2,7,凱基-頭份,2023-10-02,9296
3325,旭品,9,2,7,凱基-頭份,2023-10-02,9296
2884,玉山金,6,0,6,凱基-頭份,2023-10-02,9296
3015,全漢,5,0,5,凱基-頭份,2023-10-02,9296
3694,海華,6,1,5,凱基-頭份,2023-10-02,9296
5452,佶優,7,2,5,凱基-頭份,2023-10-02,9296
6108,競國,5,0,5,凱基-頭份,2023-10-02,9296
6218,豪勉,5,0,5,凱基-頭份,2023-10-02,9296
6585,鼎基,5,0,5,凱基-頭份,2023-10-02,9296
9938,百和,5,0,5,凱基-頭份,2023-10-02,9296
1102,亞泥,4,0,4,凱基-頭份,2023-10-02,9296
2363,矽統,23,19,4,凱基-頭份,2023-10-02,9296
2888,新光金,4,0,4,凱基-頭份,2023-10-02,9296
3324,雙鴻,4,0,4,凱基-頭份,2023-10-02,9296
5355,佳總,4,0,4,凱基-頭份,2023-10-02,9296
2206,三陽工業,5,2,3,凱基-頭份,2023-10-02,9296
00795B,中信美國公債20年,3,0,3,凱基-頭份,2023-10-02,9296
00772B,中信高評級公司債,3,0,3,凱基-頭份,2023-10-02,9296
2301,光寶科,4,1,3,凱基-頭份,2023-10-02,9296
2881,富邦金,3,0,3,凱基-頭份,2023-10-02,9296
2886,兆豐金,3,0,3,凱基-頭份,2023-10-02,9296
3276,宇環,5,2,3,凱基-頭份,2023-10-02,9296
3669,圓展,3,0,3,凱基-頭份,2023-10-02,9296
3709,鑫聯大投控,3,0,3,凱基-頭份,2023-10-02,9296
5258,虹堡,3,0,3,凱基-頭份,2023-10-02,9296
6117,迎廣,4,1,3,凱基-頭份,2023-10-02,9296
6122,擎邦,3,0,3,凱基-頭份,2023-10-02,9296
6266,泰詠,3,0,3,凱基-頭份,2023-10-02,9296
6605,帝寶,3,0,3,凱基-頭份,2023-10-02,9296
8358,金居,4,1,3,凱基-頭份,2023-10-02,9296
00720B,元大投資級公司債,2,0,2,凱基-頭份,2023-10-02,9296
00929,復華台灣科技優息,97,3,94,凱基-頭份,2023-10-03,9296
00919,群益台灣精選高息,82,0,82,凱基-頭份,2023-10-03,9296
0056,元大高股息,87,7,80,凱基-頭份,2023-10-03,9296
00637L,元大滬深300正2,56,0,56,凱基-頭份,2023-10-03,9296
6485,點序,51,1,50,凱基-頭份,2023-10-03,9296
00900,富邦特選高股息30,48,0,48,凱基-頭份,2023-10-03,9296
911868,同方友友-DR,46,0,46,凱基-頭份,2023-10-03,9296
2409,友達,46,16,30,凱基-頭份,2023-10-03,9296
5864,致和證,30,0,30,凱基-頭份,2023-10-03,9296
2888,新光金,28,0,28,凱基-頭份,2023-10-03,9296
3149,正達,28,0,28,凱基-頭份,2023-10-03,9296
3276,宇環,24,3,21,凱基-頭份,2023-10-03,9296
00720B,元大投資級公司債,20,0,20,凱基-頭份,2023-10-03,9296
1815,富喬,32,12,20,凱基-頭份,2023-10-03,9296
00878,國泰永續高股息,20,3,17,凱基-頭份,2023-10-03,9296
1612,宏泰,21,4,17,凱基-頭份,2023-10-03,9296
3704,合勤控,15,0,15,凱基-頭份,2023-10-03,9296
00712,復華富時不動產,14,0,14,凱基-頭份,2023-10-03,9296
8050,廣積,14,0,14,凱基-頭份,2023-10-03,9296
2816,旺旺保,12,0,12,凱基-頭份,2023-10-03,9296
5880,合庫金,12,1,11,凱基-頭份,2023-10-03,9296
3032,偉訓,17,6,11,凱基-頭份,2023-10-03,9296
2356,英業達,23,13,10,凱基-頭份,2023-10-03,9296
6265,方土昶,10,0,10,凱基-頭份,2023-10-03,9296
2388,威盛,17,8,9,凱基-頭份,2023-10-03,9296
2882,國泰金,13,5,8,凱基-頭份,2023-10-03,9296
2345,智邦,8,0,8,凱基-頭份,2023-10-03,9296
2408,南亞科,71,63,8,凱基-頭份,2023-10-03,9296
3013,晟銘電,14,6,8,凱基-頭份,2023-10-03,9296
6188,廣明,8,1,7,凱基-頭份,2023-10-03,9296
9958,世紀鋼,9,2,7,凱基-頭份,2023-10-03,9296
00931B,統一美債20年,6,0,6,凱基-頭份,2023-10-03,9296
2618,長榮航,14,8,6,凱基-頭份,2023-10-03,9296
2880,華南金,6,0,6,凱基-頭份,2023-10-03,9296
3363,上詮,17,11,6,凱基-頭份,2023-10-03,9296
2884,玉山金,6,0,6,凱基-頭份,2023-10-03,9296
00915,凱基優選高股息30,5,0,5,凱基-頭份,2023-10-03,9296
00922,國泰台灣領袖50,5,0,5,凱基-頭份,2023-10-03,9296
00665L,富邦�琤肭磪囓�2,5,0,5,凱基-頭份,2023-10-03,9296
00642U,期元大S＆P石油,5,0,5,凱基-頭份,2023-10-03,9296
1605,華新,5,0,5,凱基-頭份,2023-10-03,9296
2337,旺宏,5,0,5,凱基-頭份,2023-10-03,9296
2457,飛宏,5,0,5,凱基-頭份,2023-10-03,9296
2614,東森,5,0,5,凱基-頭份,2023-10-03,9296
5328,華容,5,0,5,凱基-頭份,2023-10-03,9296
6276,安鈦克,5,0,5,凱基-頭份,2023-10-03,9296
6585,鼎基,10,5,5,凱基-頭份,2023-10-03,9296
2382,廣達,66,62,4,凱基-頭份,2023-10-03,9296
3163,波若威,6,2,4,凱基-頭份,2023-10-03,9296
00633L,富邦上証正2,4,0,4,凱基-頭份,2023-10-03,9296
2867,三商壽,100,0,100,凱基-頭份,2023-10-04,9296
00929,復華台灣科技優息,50,5,45,凱基-頭份,2023-10-04,9296
2344,華邦電,32,8,24,凱基-頭份,2023-10-04,9296
2374,佳能,24,0,24,凱基-頭份,2023-10-04,9296
2884,玉山金,23,0,23,凱基-頭份,2023-10-04,9296
2002,中鋼,21,0,21,凱基-頭份,2023-10-04,9296
2883,凱基金,21,0,21,凱基-頭份,2023-10-04,9296
00919,群益台灣精選高息,21,1,20,凱基-頭份,2023-10-04,9296
5880,合庫金,14,0,14,凱基-頭份,2023-10-04,9296
1815,富喬,23,10,13,凱基-頭份,2023-10-04,9296
3694,海華,35,24,11,凱基-頭份,2023-10-04,9296
00888,永豐台灣ESG,10,0,10,凱基-頭份,2023-10-04,9296
00931B,統一美債20年,20,10,10,凱基-頭份,2023-10-04,9296
00922,國泰台灣領袖50,10,0,10,凱基-頭份,2023-10-04,9296
00895,富邦未來車,10,0,10,凱基-頭份,2023-10-04,9296
2105,正新,10,0,10,凱基-頭份,2023-10-04,9296
3704,合勤控,10,0,10,凱基-頭份,2023-10-04,9296
6288,聯嘉,13,3,10,凱基-頭份,2023-10-04,9296
2888,新光金,9,0,9,凱基-頭份,2023-10-04,9296
3276,宇環,13,4,9,凱基-頭份,2023-10-04,9296
6605,帝寶,9,0,9,凱基-頭份,2023-10-04,9296
2801,彰銀,8,1,7,凱基-頭份,2023-10-04,9296
1301,台塑,7,0,7,凱基-頭份,2023-10-04,9296
2892,第一金,7,0,7,凱基-頭份,2023-10-04,9296
5434,崇越,7,0,7,凱基-頭份,2023-10-04,9296
00772B,中信高評級公司債,6,0,6,凱基-頭份,2023-10-04,9296
2353,宏��,6,0,6,凱基-頭份,2023-10-04,9296
2388,威盛,6,0,6,凱基-頭份,2023-10-04,9296
4123,晟德,6,0,6,凱基-頭份,2023-10-04,9296
8050,廣積,6,0,6,凱基-頭份,2023-10-04,9296
8086,宏捷科,6,0,6,凱基-頭份,2023-10-04,9296
2454,聯發科,6,0,6,凱基-頭份,2023-10-04,9296
6188,廣明,6,1,5,凱基-頭份,2023-10-04,9296
00885,富邦越南,5,0,5,凱基-頭份,2023-10-04,9296
2634,漢翔,5,0,5,凱基-頭份,2023-10-04,9296
00892,富邦台灣半導體,5,0,5,凱基-頭份,2023-10-04,9296
00665L,富邦�琤肭磪囓�2,5,0,5,凱基-頭份,2023-10-04,9296
00642U,期元大S＆P石油,5,0,5,凱基-頭份,2023-10-04,9296
1104,環泥,5,0,5,凱基-頭份,2023-10-04,9296
2516,新建,5,0,5,凱基-頭份,2023-10-04,9296
2538,基泰,7,2,5,凱基-頭份,2023-10-04,9296
2897,王道銀行,5,0,5,凱基-頭份,2023-10-04,9296
3081,聯亞,6,1,5,凱基-頭份,2023-10-04,9296
4726,永昕,5,0,5,凱基-頭份,2023-10-04,9296
5328,華容,5,0,5,凱基-頭份,2023-10-04,9296
6190,萬泰科,5,0,5,凱基-頭份,2023-10-04,9296
3231,緯創,11,7,4,凱基-頭份,2023-10-04,9296
1216,統一,4,0,4,凱基-頭份,2023-10-04,9296
0056,元大高股息,4,0,4,凱基-頭份,2023-10-04,9296
00680L,元大美債20正2,4,0,4,凱基-頭份,2023-10-04,9296
00712,復華富時不動產,132,1,131,凱基-頭份,2023-10-05,9296
4564,元翎,52,0,52,凱基-頭份,2023-10-05,9296
0056,元大高股息,26,4,22,凱基-頭份,2023-10-05,9296
4414,如興,18,0,18,凱基-頭份,2023-10-05,9296
1815,富喬,20,4,16,凱基-頭份,2023-10-05,9296
3596,智易,14,0,14,凱基-頭份,2023-10-05,9296
3694,海華,15,1,14,凱基-頭份,2023-10-05,9296
8011,台通,14,1,13,凱基-頭份,2023-10-05,9296
2329,華泰,17,5,12,凱基-頭份,2023-10-05,9296
00915,凱基優選高股息30,12,0,12,凱基-頭份,2023-10-05,9296
00642U,期元大S＆P石油,10,0,10,凱基-頭份,2023-10-05,9296
00637L,元大滬深300正2,10,0,10,凱基-頭份,2023-10-05,9296
00922,國泰台灣領袖50,10,0,10,凱基-頭份,2023-10-05,9296
00916,國泰全球品牌50,10,0,10,凱基-頭份,2023-10-05,9296
2358,廷鑫,10,0,10,凱基-頭份,2023-10-05,9296
2367,燿華,10,0,10,凱基-頭份,2023-10-05,9296
2867,三商壽,10,0,10,凱基-頭份,2023-10-05,9296
2885,元大金,10,0,10,凱基-頭份,2023-10-05,9296
3149,正達,10,0,10,凱基-頭份,2023-10-05,9296
3260,威剛,15,6,9,凱基-頭份,2023-10-05,9296
8054,安國,9,0,9,凱基-頭份,2023-10-05,9296
8930,青鋼,9,0,9,凱基-頭份,2023-10-05,9296
2888,新光金,8,0,8,凱基-頭份,2023-10-05,9296
5258,虹堡,69,61,8,凱基-頭份,2023-10-05,9296
00885,富邦越南,7,0,7,凱基-頭份,2023-10-05,9296
00882,中信中國高股息,7,0,7,凱基-頭份,2023-10-05,9296
5272,笙科,7,0,7,凱基-頭份,2023-10-05,9296
6288,聯嘉,10,3,7,凱基-頭份,2023-10-05,9296
00720B,元大投資級公司債,6,0,6,凱基-頭份,2023-10-05,9296
3450,聯鈞,9,3,6,凱基-頭份,2023-10-05,9296
2363,矽統,24,18,6,凱基-頭份,2023-10-05,9296
00664R,國泰臺灣加權反1,5,0,5,凱基-頭份,2023-10-05,9296
00931B,統一美債20年,6,1,5,凱基-頭份,2023-10-05,9296
00893,國泰智能電動車,5,0,5,凱基-頭份,2023-10-05,9296
1326,台化,5,0,5,凱基-頭份,2023-10-05,9296
1736,喬山,5,0,5,凱基-頭份,2023-10-05,9296
3078,僑威,6,1,5,凱基-頭份,2023-10-05,9296
2812,台中銀,4,0,4,凱基-頭份,2023-10-05,9296
1612,宏泰,4,0,4,凱基-頭份,2023-10-05,9296
3092,鴻碩,4,0,4,凱基-頭份,2023-10-05,9296
3715,定穎投控,34,30,4,凱基-頭份,2023-10-05,9296
4979,華星光,10,6,4,凱基-頭份,2023-10-05,9296
8271,宇瞻,3,0,3,凱基-頭份,2023-10-05,9296
6285,啟��,3,0,3,凱基-頭份,2023-10-05,9296
1471,首利,5,2,3,凱基-頭份,2023-10-05,9296
00891,中信關鍵半導體,3,0,3,凱基-頭份,2023-10-05,9296
00795B,中信美國公債20年,3,0,3,凱基-頭份,2023-10-05,9296
2355,敬鵬,8,5,3,凱基-頭份,2023-10-05,9296
2520,冠德,3,0,3,凱基-頭份,2023-10-05,9296
2530,華建,3,0,3,凱基-頭份,2023-10-05,9296
00929,復華台灣科技優息,144,3,141,凱基-頭份,2023-10-06,9296
2812,台中銀,100,0,100,凱基-頭份,2023-10-06,9296
00712,復華富時不動產,97,0,97,凱基-頭份,2023-10-06,9296
2610,華航,40,0,40,凱基-頭份,2023-10-06,9296
00919,群益台灣精選高息,38,0,38,凱基-頭份,2023-10-06,9296
3694,海華,25,0,25,凱基-頭份,2023-10-06,9296
00900,富邦特選高股息30,22,0,22,凱基-頭份,2023-10-06,9296
9105,泰金寶-DR,30,10,20,凱基-頭份,2023-10-06,9296
3481,群創,16,2,14,凱基-頭份,2023-10-06,9296
2618,長榮航,13,0,13,凱基-頭份,2023-10-06,9296
3596,智易,19,6,13,凱基-頭份,2023-10-06,9296
0056,元大高股息,11,1,10,凱基-頭份,2023-10-06,9296
00878,國泰永續高股息,13,2,11,凱基-頭份,2023-10-06,9296
1316,上曜,10,0,10,凱基-頭份,2023-10-06,9296
00687B,國泰20年美債,10,0,10,凱基-頭份,2023-10-06,9296
1808,潤隆,10,0,10,凱基-頭份,2023-10-06,9296
6684,安格,10,0,10,凱基-頭份,2023-10-06,9296
2399,映泰,9,0,9,凱基-頭份,2023-10-06,9296
1101,台泥,8,0,8,凱基-頭份,2023-10-06,9296
2415,錩新,8,0,8,凱基-頭份,2023-10-06,9296
4933,友輝,8,0,8,凱基-頭份,2023-10-06,9296
2303,聯電,7,0,7,凱基-頭份,2023-10-06,9296
1305,華夏,7,0,7,凱基-頭份,2023-10-06,9296
2425,承啟,7,0,7,凱基-頭份,2023-10-06,9296
9950,萬國通,7,0,7,凱基-頭份,2023-10-06,9296
3450,聯鈞,11,5,6,凱基-頭份,2023-10-06,9296
3576,聯合再生,6,0,6,凱基-頭份,2023-10-06,9296
5880,合庫金,10,4,6,凱基-頭份,2023-10-06,9296
00679B,元大美債20年,5,0,5,凱基-頭份,2023-10-06,9296
2409,友達,7,2,5,凱基-頭份,2023-10-06,9296
00632R,元大台灣50反1,5,0,5,凱基-頭份,2023-10-06,9296
3013,晟銘電,31,26,5,凱基-頭份,2023-10-06,9296
3672,康聯訊,5,0,5,凱基-頭份,2023-10-06,9296
6164,華興,5,0,5,凱基-頭份,2023-10-06,9296
3011,今皓,5,1,4,凱基-頭份,2023-10-06,9296
6122,擎邦,4,0,4,凱基-頭份,2023-10-06,9296
00720B,元大投資級公司債,3,0,3,凱基-頭份,2023-10-06,9296
1514,亞力,15,12,3,凱基-頭份,2023-10-06,9296
2374,佳能,3,0,3,凱基-頭份,2023-10-06,9296
3032,偉訓,3,0,3,凱基-頭份,2023-10-06,9296
3051,力特,4,1,3,凱基-頭份,2023-10-06,9296
8341,日友,3,0,3,凱基-頭份,2023-10-06,9296
8446,華研,4,1,3,凱基-頭份,2023-10-06,9296
1519,華城,7,5,2,凱基-頭份,2023-10-06,9296
00931B,統一美債20年,2,0,2,凱基-頭份,2023-10-06,9296
1904,正隆,2,0,2,凱基-頭份,2023-10-06,9296
2102,泰豐,2,0,2,凱基-頭份,2023-10-06,9296
2316,楠梓電,2,0,2,凱基-頭份,2023-10-06,9296
2365,昆盈,2,0,2,凱基-頭份,2023-10-06,9296
00922,國泰台灣領袖50,2,0,2,凱基-頭份,2023-10-06,9296
00632R,元大台灣50反1,200,20,180,凱基-頭份,2023-10-11,9296
00712,復華富時不動產,50,0,50,凱基-頭份,2023-10-11,9296
3694,海華,77,30,47,凱基-頭份,2023-10-11,9296
00900,富邦特選高股息30,36,0,36,凱基-頭份,2023-10-11,9296
0056,元大高股息,39,9,30,凱基-頭份,2023-10-11,9296
2618,長榮航,41,12,29,凱基-頭份,2023-10-11,9296
00919,群益台灣精選高息,29,0,29,凱基-頭份,2023-10-11,9296
3149,正達,20,0,20,凱基-頭份,2023-10-11,9296
3231,緯創,28,12,16,凱基-頭份,2023-10-11,9296
2025,千興,17,2,15,凱基-頭份,2023-10-11,9296
00772B,中信高評級公司債,12,0,12,凱基-頭份,2023-10-11,9296
3567,逸昌,11,1,10,凱基-頭份,2023-10-11,9296
3014,聯陽,13,3,10,凱基-頭份,2023-10-11,9296
6182,合晶,10,0,10,凱基-頭份,2023-10-11,9296
6284,佳邦,10,0,10,凱基-頭份,2023-10-11,9296
8105,凌巨,10,0,10,凱基-頭份,2023-10-11,9296
3481,群創,16,7,9,凱基-頭份,2023-10-11,9296
1471,首利,14,5,9,凱基-頭份,2023-10-11,9296
1603,華電,10,1,9,凱基-頭份,2023-10-11,9296
2365,昆盈,11,2,9,凱基-頭份,2023-10-11,9296
2603,長榮,12,4,8,凱基-頭份,2023-10-11,9296
6139,亞翔,8,0,8,凱基-頭份,2023-10-11,9296
00679B,元大美債20年,7,0,7,凱基-頭份,2023-10-11,9296
3356,奇偶,7,0,7,凱基-頭份,2023-10-11,9296
4162,智擎,12,5,7,凱基-頭份,2023-10-11,9296
1609,大亞,20,13,7,凱基-頭份,2023-10-11,9296
9917,中保科,7,0,7,凱基-頭份,2023-10-11,9296
1307,三芳,6,0,6,凱基-頭份,2023-10-11,9296
2356,英業達,8,2,6,凱基-頭份,2023-10-11,9296
2367,燿華,6,0,6,凱基-頭份,2023-10-11,9296
6125,廣運,7,1,6,凱基-頭份,2023-10-11,9296
6218,豪勉,11,5,6,凱基-頭份,2023-10-11,9296
3005,神基,12,7,5,凱基-頭份,2023-10-11,9296
1447,力鵬,5,0,5,凱基-頭份,2023-10-11,9296
1326,台化,5,0,5,凱基-頭份,2023-10-11,9296
2002,中鋼,8,3,5,凱基-頭份,2023-10-11,9296
5328,華容,5,0,5,凱基-頭份,2023-10-11,9296
6170,統振,6,1,5,凱基-頭份,2023-10-11,9296
8011,台通,5,0,5,凱基-頭份,2023-10-11,9296
9105,泰金寶-DR,5,0,5,凱基-頭份,2023-10-11,9296
3363,上詮,7,3,4,凱基-頭份,2023-10-11,9296
1815,富喬,4,0,4,凱基-頭份,2023-10-11,9296
2390,云辰,4,0,4,凱基-頭份,2023-10-11,9296
2608,嘉里大榮,4,0,4,凱基-頭份,2023-10-11,9296
5864,致和證,4,0,4,凱基-頭份,2023-10-11,9296
5880,合庫金,4,0,4,凱基-頭份,2023-10-11,9296
8034,榮群,4,0,4,凱基-頭份,2023-10-11,9296
3006,晶豪科,9,5,4,凱基-頭份,2023-10-11,9296
3027,盛達,3,0,3,凱基-頭份,2023-10-11,9296
3176,基亞,3,0,3,凱基-頭份,2023-10-11,9296
00632R,元大台灣50反1,165,0,165,凱基-頭份,2023-10-12,9296
3694,海華,57,0,57,凱基-頭份,2023-10-12,9296
00929,復華台灣科技優息,60,15,45,凱基-頭份,2023-10-12,9296
3322,建舜電,47,2,45,凱基-頭份,2023-10-12,9296
00919,群益台灣精選高息,40,0,40,凱基-頭份,2023-10-12,9296
2816,旺旺保,35,0,35,凱基-頭份,2023-10-12,9296
2409,友達,32,2,30,凱基-頭份,2023-10-12,9296
2812,台中銀,25,0,25,凱基-頭份,2023-10-12,9296
00857B,永豐20年美公債,20,0,20,凱基-頭份,2023-10-12,9296
2402,毅嘉,20,1,19,凱基-頭份,2023-10-12,9296
2417,圓剛,16,0,16,凱基-頭份,2023-10-12,9296
8034,榮群,15,0,15,凱基-頭份,2023-10-12,9296
1603,華電,21,7,14,凱基-頭份,2023-10-12,9296
3260,威剛,19,5,14,凱基-頭份,2023-10-12,9296
3149,正達,13,0,13,凱基-頭份,2023-10-12,9296
3013,晟銘電,18,6,12,凱基-頭份,2023-10-12,9296
00720B,元大投資級公司債,11,0,11,凱基-頭份,2023-10-12,9296
2352,佳世達,10,0,10,凱基-頭份,2023-10-12,9296
00664R,國泰臺灣加權反1,10,0,10,凱基-頭份,2023-10-12,9296
2845,遠東銀,10,0,10,凱基-頭份,2023-10-12,9296
00915,凱基優選高股息30,9,0,9,凱基-頭份,2023-10-12,9296
6170,統振,11,2,9,凱基-頭份,2023-10-12,9296
2356,英業達,15,7,8,凱基-頭份,2023-10-12,9296
00710B,復華彭博非投等債,7,0,7,凱基-頭份,2023-10-12,9296
1736,喬山,7,0,7,凱基-頭份,2023-10-12,9296
1584,精剛,7,1,6,凱基-頭份,2023-10-12,9296
3060,銘異,6,0,6,凱基-頭份,2023-10-12,9296
2002,中鋼,8,3,5,凱基-頭份,2023-10-12,9296
00715L,期街口布蘭特正2,5,0,5,凱基-頭份,2023-10-12,9296
3044,健鼎,5,0,5,凱基-頭份,2023-10-12,9296
3346,麗清,7,2,5,凱基-頭份,2023-10-12,9296
3704,合勤控,5,0,5,凱基-頭份,2023-10-12,9296
6197,佳必琪,6,1,5,凱基-頭份,2023-10-12,9296
6451,訊芯-KY,9,4,5,凱基-頭份,2023-10-12,9296
2376,技嘉,7,3,4,凱基-頭份,2023-10-12,9296
5530,龍巖,4,0,4,凱基-頭份,2023-10-12,9296
6209,今國光,4,0,4,凱基-頭份,2023-10-12,9296
00719B,元大美債1-3,3,0,3,凱基-頭份,2023-10-12,9296
1305,華夏,3,0,3,凱基-頭份,2023-10-12,9296
1402,遠東新,3,0,3,凱基-頭份,2023-10-12,9296
1522,堤維西,8,5,3,凱基-頭份,2023-10-12,9296
2313,華通,7,4,3,凱基-頭份,2023-10-12,9296
3122,笙泉,10,7,3,凱基-頭份,2023-10-12,9296
3162,精確,3,0,3,凱基-頭份,2023-10-12,9296
3530,晶相光,3,0,3,凱基-頭份,2023-10-12,9296
4934,太極,3,0,3,凱基-頭份,2023-10-12,9296
6235,華孚,5,2,3,凱基-頭份,2023-10-12,9296
2454,聯發科,3,0,3,凱基-頭份,2023-10-12,9296
6472,保瑞,2,0,2,凱基-頭份,2023-10-12,9296
00756B,群益投等新興公債,2,0,2,凱基-頭份,2023-10-12,9296
00878,國泰永續高股息,123,54,69,凱基-頭份,2023-10-13,9296
2344,華邦電,196,133,63,凱基-頭份,2023-10-13,9296
2618,長榮航,35,3,32,凱基-頭份,2023-10-13,9296
2888,新光金,27,0,27,凱基-頭份,2023-10-13,9296
0056,元大高股息,42,16,26,凱基-頭份,2023-10-13,9296
2363,矽統,184,159,25,凱基-頭份,2023-10-13,9296
00720B,元大投資級公司債,21,0,21,凱基-頭份,2023-10-13,9296
00919,群益台灣精選高息,20,1,19,凱基-頭份,2023-10-13,9296
6257,矽格,20,1,19,凱基-頭份,2023-10-13,9296
3694,海華,19,0,19,凱基-頭份,2023-10-13,9296
00931B,統一美債20年,18,0,18,凱基-頭份,2023-10-13,9296
2816,旺旺保,15,0,15,凱基-頭份,2023-10-13,9296
1319,東陽,13,1,12,凱基-頭份,2023-10-13,9296
1603,華電,12,0,12,凱基-頭份,2023-10-13,9296
00857B,永豐20年美公債,11,0,11,凱基-頭份,2023-10-13,9296
00772B,中信高評級公司債,10,0,10,凱基-頭份,2023-10-13,9296
00924,復華S＆P500成長,10,0,10,凱基-頭份,2023-10-13,9296
6139,亞翔,10,0,10,凱基-頭份,2023-10-13,9296
2883,凱基金,10,1,9,凱基-頭份,2023-10-13,9296
3060,銘異,9,0,9,凱基-頭份,2023-10-13,9296
2382,廣達,14,6,8,凱基-頭份,2023-10-13,9296
3567,逸昌,8,0,8,凱基-頭份,2023-10-13,9296
6282,康舒,13,6,7,凱基-頭份,2023-10-13,9296
00922,國泰台灣領袖50,7,0,7,凱基-頭份,2023-10-13,9296
2417,圓剛,7,0,7,凱基-頭份,2023-10-13,9296
2426,鼎元,7,0,7,凱基-頭份,2023-10-13,9296
00679B,元大美債20年,6,0,6,凱基-頭份,2023-10-13,9296
1504,東元,6,0,6,凱基-頭份,2023-10-13,9296
2834,臺企銀,6,0,6,凱基-頭份,2023-10-13,9296
2892,第一金,6,0,6,凱基-頭份,2023-10-13,9296
3011,今皓,6,0,6,凱基-頭份,2023-10-13,9296
3325,旭品,6,0,6,凱基-頭份,2023-10-13,9296
3715,定穎投控,16,10,6,凱基-頭份,2023-10-13,9296
4526,東台,7,2,5,凱基-頭份,2023-10-13,9296
00633L,富邦上証正2,5,0,5,凱基-頭份,2023-10-13,9296
2402,毅嘉,11,6,5,凱基-頭份,2023-10-13,9296
3058,立德,5,0,5,凱基-頭份,2023-10-13,9296
4162,智擎,6,1,5,凱基-頭份,2023-10-13,9296
6285,啟��,6,1,5,凱基-頭份,2023-10-13,9296
9958,世紀鋼,6,1,5,凱基-頭份,2023-10-13,9296
1815,富喬,36,31,5,凱基-頭份,2023-10-13,9296
8358,金居,114,110,4,凱基-頭份,2023-10-13,9296
8996,高力,4,0,4,凱基-頭份,2023-10-13,9296
9945,潤泰新,4,0,4,凱基-頭份,2023-10-13,9296
4979,華星光,6,3,3,凱基-頭份,2023-10-13,9296
00923,群益台ESG低碳50,13,10,3,凱基-頭份,2023-10-13,9296
1618,合機,5,2,3,凱基-頭份,2023-10-13,9296
1736,喬山,3,0,3,凱基-頭份,2023-10-13,9296
2206,三陽工業,3,0,3,凱基-頭份,2023-10-13,9296
2313,華通,12,9,3,凱基-頭份,2023-10-13,9296
00929,復華台灣科技優息,106,0,106,凱基-頭份,2023-10-16,9296
00715L,期街口布蘭特正2,102,0,102,凱基-頭份,2023-10-16,9296
00637L,元大滬深300正2,100,1,99,凱基-頭份,2023-10-16,9296
00919,群益台灣精選高息,37,0,37,凱基-頭份,2023-10-16,9296
2344,華邦電,53,16,37,凱基-頭份,2023-10-16,9296
2618,長榮航,47,12,35,凱基-頭份,2023-10-16,9296
3694,海華,25,1,24,凱基-頭份,2023-10-16,9296
00720B,元大投資級公司債,22,0,22,凱基-頭份,2023-10-16,9296
00857B,永豐20年美公債,20,1,19,凱基-頭份,2023-10-16,9296
2367,燿華,17,0,17,凱基-頭份,2023-10-16,9296
00878,國泰永續高股息,23,6,17,凱基-頭份,2023-10-16,9296
3025,星通,15,1,14,凱基-頭份,2023-10-16,9296
2409,友達,14,1,13,凱基-頭份,2023-10-16,9296
0056,元大高股息,15,2,13,凱基-頭份,2023-10-16,9296
3231,緯創,14,2,12,凱基-頭份,2023-10-16,9296
8390,金益鼎,11,0,11,凱基-頭份,2023-10-16,9296
00895,富邦未來車,10,0,10,凱基-頭份,2023-10-16,9296
2323,中環,10,0,10,凱基-頭份,2023-10-16,9296
2369,菱生,10,0,10,凱基-頭份,2023-10-16,9296
2888,新光金,10,0,10,凱基-頭份,2023-10-16,9296
3221,台嘉碩,10,0,10,凱基-頭份,2023-10-16,9296
6274,台燿,11,1,10,凱基-頭份,2023-10-16,9296
6405,悅城,10,0,10,凱基-頭份,2023-10-16,9296
1314,中石化,34,25,9,凱基-頭份,2023-10-16,9296
2201,裕隆,12,4,8,凱基-頭份,2023-10-16,9296
00915,凱基優選高股息30,8,0,8,凱基-頭份,2023-10-16,9296
00641R,富邦日本反1,8,0,8,凱基-頭份,2023-10-16,9296
2610,華航,8,0,8,凱基-頭份,2023-10-16,9296
5009,榮剛,10,2,8,凱基-頭份,2023-10-16,9296
6284,佳邦,7,0,7,凱基-頭份,2023-10-16,9296
1605,華新,6,0,6,凱基-頭份,2023-10-16,9296
2353,宏��,6,0,6,凱基-頭份,2023-10-16,9296
6244,茂迪,10,4,6,凱基-頭份,2023-10-16,9296
2892,第一金,5,0,5,凱基-頭份,2023-10-16,9296
00633L,富邦上証正2,5,0,5,凱基-頭份,2023-10-16,9296
3481,群創,6,1,5,凱基-頭份,2023-10-16,9296
3704,合勤控,5,0,5,凱基-頭份,2023-10-16,9296
3715,定穎投控,23,18,5,凱基-頭份,2023-10-16,9296
4526,東台,5,0,5,凱基-頭份,2023-10-16,9296
6446,藥華藥,5,0,5,凱基-頭份,2023-10-16,9296
2542,興富發,5,0,5,凱基-頭份,2023-10-16,9296
3105,穩懋,5,1,4,凱基-頭份,2023-10-16,9296
2885,元大金,5,1,4,凱基-頭份,2023-10-16,9296
2206,三陽工業,11,7,4,凱基-頭份,2023-10-16,9296
2382,廣達,6,2,4,凱基-頭份,2023-10-16,9296
2890,永豐金,6,2,4,凱基-頭份,2023-10-16,9296
3669,圓展,5,1,4,凱基-頭份,2023-10-16,9296
6186,新潤,4,0,4,凱基-頭份,2023-10-16,9296
1712,興農,3,0,3,凱基-頭份,2023-10-16,9296
2377,微星,3,0,3,凱基-頭份,2023-10-16,9296
0056,元大高股息,53,1,52,凱基-頭份,2023-10-17,9296
2618,長榮航,56,13,43,凱基-頭份,2023-10-17,9296
2303,聯電,42,15,27,凱基-頭份,2023-10-17,9296
00878,國泰永續高股息,23,0,23,凱基-頭份,2023-10-17,9296
5324,士開,20,0,20,凱基-頭份,2023-10-17,9296
00772B,中信高評級公司債,17,0,17,凱基-頭份,2023-10-17,9296
0050,元大台灣50,14,0,14,凱基-頭份,2023-10-17,9296
00929,復華台灣科技優息,46,33,13,凱基-頭份,2023-10-17,9296
3363,上詮,21,9,12,凱基-頭份,2023-10-17,9296
6442,光聖,14,2,12,凱基-頭份,2023-10-17,9296
2356,英業達,24,13,11,凱基-頭份,2023-10-17,9296
00728,第一金工業30,10,0,10,凱基-頭份,2023-10-17,9296
2449,京元電子,42,32,10,凱基-頭份,2023-10-17,9296
8034,榮群,10,0,10,凱基-頭份,2023-10-17,9296
5608,四維航,10,0,10,凱基-頭份,2023-10-17,9296
00922,國泰台灣領袖50,10,0,10,凱基-頭份,2023-10-17,9296
2349,錸德,9,0,9,凱基-頭份,2023-10-17,9296
3036,文曄,10,1,9,凱基-頭份,2023-10-17,9296
3231,緯創,26,19,7,凱基-頭份,2023-10-17,9296
00919,群益台灣精選高息,7,0,7,凱基-頭份,2023-10-17,9296
1609,大亞,7,0,7,凱基-頭份,2023-10-17,9296
2425,承啟,7,0,7,凱基-頭份,2023-10-17,9296
3025,星通,7,0,7,凱基-頭份,2023-10-17,9296
3346,麗清,8,1,7,凱基-頭份,2023-10-17,9296
00679B,元大美債20年,7,0,7,凱基-頭份,2023-10-17,9296
6213,聯茂,6,1,5,凱基-頭份,2023-10-17,9296
2888,新光金,5,0,5,凱基-頭份,2023-10-17,9296
2897,王道銀行,5,0,5,凱基-頭份,2023-10-17,9296
3058,立德,5,0,5,凱基-頭份,2023-10-17,9296
3083,網龍,5,0,5,凱基-頭份,2023-10-17,9296
3094,聯傑,25,20,5,凱基-頭份,2023-10-17,9296
3264,欣銓,6,1,5,凱基-頭份,2023-10-17,9296
3694,海華,5,0,5,凱基-頭份,2023-10-17,9296
4979,華星光,8,3,5,凱基-頭份,2023-10-17,9296
5439,高技,11,6,5,凱基-頭份,2023-10-17,9296
6577,勁豐,5,0,5,凱基-頭份,2023-10-17,9296
00931B,統一美債20年,4,0,4,凱基-頭份,2023-10-17,9296
8996,高力,4,0,4,凱基-頭份,2023-10-17,9296
00905,FT臺灣Smart,4,0,4,凱基-頭份,2023-10-17,9296
3483,力致,5,1,4,凱基-頭份,2023-10-17,9296
1789,神隆,4,0,4,凱基-頭份,2023-10-17,9296
2369,菱生,6,2,4,凱基-頭份,2023-10-17,9296
2376,技嘉,7,3,4,凱基-頭份,2023-10-17,9296
2543,皇昌,4,0,4,凱基-頭份,2023-10-17,9296
2892,第一金,4,0,4,凱基-頭份,2023-10-17,9296
3592,瑞鼎,4,0,4,凱基-頭份,2023-10-17,9296
6125,廣運,14,10,4,凱基-頭份,2023-10-17,9296
6695,芯鼎,28,24,4,凱基-頭份,2023-10-17,9296
2382,廣達,5,2,3,凱基-頭份,2023-10-17,9296
1305,華夏,3,0,3,凱基-頭份,2023-10-17,9296
00919,群益台灣精選高息,239,0,239,凱基-頭份,2023-10-18,9296
2515,中工,200,2,198,凱基-頭份,2023-10-18,9296
00929,復華台灣科技優息,109,5,104,凱基-頭份,2023-10-18,9296
0056,元大高股息,59,0,59,凱基-頭份,2023-10-18,9296
00878,國泰永續高股息,61,5,56,凱基-頭份,2023-10-18,9296
6770,力積電,44,0,44,凱基-頭份,2023-10-18,9296
1101,台泥,27,2,25,凱基-頭份,2023-10-18,9296
2388,威盛,42,21,21,凱基-頭份,2023-10-18,9296
00922,國泰台灣領袖50,21,0,21,凱基-頭份,2023-10-18,9296
00882,中信中國高股息,21,0,21,凱基-頭份,2023-10-18,9296
00895,富邦未來車,20,0,20,凱基-頭份,2023-10-18,9296
2002,中鋼,18,0,18,凱基-頭份,2023-10-18,9296
3032,偉訓,16,0,16,凱基-頭份,2023-10-18,9296
2344,華邦電,16,2,14,凱基-頭份,2023-10-18,9296
2618,長榮航,17,3,14,凱基-頭份,2023-10-18,9296
00772B,中信高評級公司債,13,0,13,凱基-頭份,2023-10-18,9296
3013,晟銘電,13,0,13,凱基-頭份,2023-10-18,9296
3231,緯創,40,27,13,凱基-頭份,2023-10-18,9296
6233,旺玖,11,0,11,凱基-頭份,2023-10-18,9296
1802,台玻,10,0,10,凱基-頭份,2023-10-18,9296
5608,四維航,10,0,10,凱基-頭份,2023-10-18,9296
6113,亞矽,10,0,10,凱基-頭份,2023-10-18,9296
8093,保銳,10,0,10,凱基-頭份,2023-10-18,9296
00679B,元大美債20年,9,0,9,凱基-頭份,2023-10-18,9296
2345,智邦,9,1,8,凱基-頭份,2023-10-18,9296
2630,亞航,8,0,8,凱基-頭份,2023-10-18,9296
6213,聯茂,8,0,8,凱基-頭份,2023-10-18,9296
2204,中華,7,0,7,凱基-頭份,2023-10-18,9296
2329,華泰,7,0,7,凱基-頭份,2023-10-18,9296
3704,合勤控,7,0,7,凱基-頭份,2023-10-18,9296
6426,統新,10,3,7,凱基-頭份,2023-10-18,9296
1609,大亞,7,0,7,凱基-頭份,2023-10-18,9296
00931B,統一美債20年,8,2,6,凱基-頭份,2023-10-18,9296
1102,亞泥,6,0,6,凱基-頭份,2023-10-18,9296
00728,第一金工業30,6,0,6,凱基-頭份,2023-10-18,9296
00715L,期街口布蘭特正2,106,100,6,凱基-頭份,2023-10-18,9296
1504,東元,7,1,6,凱基-頭份,2023-10-18,9296
2457,飛宏,7,1,6,凱基-頭份,2023-10-18,9296
2401,凌陽,6,0,6,凱基-頭份,2023-10-18,9296
2206,三陽工業,12,6,6,凱基-頭份,2023-10-18,9296
6274,台燿,17,11,6,凱基-頭份,2023-10-18,9296
00720B,元大投資級公司債,5,0,5,凱基-頭份,2023-10-18,9296
00927,群益半導體收益,5,0,5,凱基-頭份,2023-10-18,9296
2891,中信金,5,0,5,凱基-頭份,2023-10-18,9296
3006,晶豪科,5,0,5,凱基-頭份,2023-10-18,9296
6684,安格,5,0,5,凱基-頭份,2023-10-18,9296
00680L,元大美債20正2,4,0,4,凱基-頭份,2023-10-18,9296
2425,承啟,5,1,4,凱基-頭份,2023-10-18,9296
2612,中航,5,1,4,凱基-頭份,2023-10-18,9296
6125,廣運,4,0,4,凱基-頭份,2023-10-18,9296
00919,群益台灣精選高息,59,0,59,凱基-頭份,2023-10-19,9296
0056,元大高股息,52,0,52,凱基-頭份,2023-10-19,9296
00878,國泰永續高股息,81,31,50,凱基-頭份,2023-10-19,9296
1101,台泥,41,0,41,凱基-頭份,2023-10-19,9296
00637L,元大滬深300正2,31,0,31,凱基-頭份,2023-10-19,9296
00895,富邦未來車,20,0,20,凱基-頭份,2023-10-19,9296
00715L,期街口布蘭特正2,20,0,20,凱基-頭份,2023-10-19,9296
00933B,國泰10Y+金融債,24,5,19,凱基-頭份,2023-10-19,9296
00633L,富邦上証正2,19,0,19,凱基-頭份,2023-10-19,9296
2344,華邦電,23,4,19,凱基-頭份,2023-10-19,9296
2883,凱基金,16,0,16,凱基-頭份,2023-10-19,9296
2409,友達,18,3,15,凱基-頭份,2023-10-19,9296
2605,新興,15,1,14,凱基-頭份,2023-10-19,9296
00931B,統一美債20年,20,7,13,凱基-頭份,2023-10-19,9296
2002,中鋼,12,0,12,凱基-頭份,2023-10-19,9296
00772B,中信高評級公司債,14,4,10,凱基-頭份,2023-10-19,9296
1444,力麗,10,0,10,凱基-頭份,2023-10-19,9296
5328,華容,10,0,10,凱基-頭份,2023-10-19,9296
2317,鴻海,11,2,9,凱基-頭份,2023-10-19,9296
00720B,元大投資級公司債,9,0,9,凱基-頭份,2023-10-19,9296
1305,華夏,8,0,8,凱基-頭份,2023-10-19,9296
00902,中信電池及儲能,8,0,8,凱基-頭份,2023-10-19,9296
2388,威盛,17,9,8,凱基-頭份,2023-10-19,9296
5483,中美晶,8,0,8,凱基-頭份,2023-10-19,9296
1524,耿鼎,7,0,7,凱基-頭份,2023-10-19,9296
2369,菱生,9,2,7,凱基-頭份,2023-10-19,9296
6213,聯茂,7,0,7,凱基-頭份,2023-10-19,9296
2349,錸德,6,0,6,凱基-頭份,2023-10-19,9296
2356,英業達,22,16,6,凱基-頭份,2023-10-19,9296
3231,緯創,20,14,6,凱基-頭份,2023-10-19,9296
00679B,元大美債20年,5,0,5,凱基-頭份,2023-10-19,9296
00773B,中信優先金融債,5,0,5,凱基-頭份,2023-10-19,9296
00751B,元大AAA至A公司債,5,0,5,凱基-頭份,2023-10-19,9296
00665L,富邦�琤肭磪囓�2,5,0,5,凱基-頭份,2023-10-19,9296
00680L,元大美債20正2,5,0,5,凱基-頭份,2023-10-19,9296
00896,中信綠能及電動車,5,0,5,凱基-頭份,2023-10-19,9296
1736,喬山,5,0,5,凱基-頭份,2023-10-19,9296
2892,第一金,5,0,5,凱基-頭份,2023-10-19,9296
3694,海華,6,1,5,凱基-頭份,2023-10-19,9296
5272,笙科,5,0,5,凱基-頭份,2023-10-19,9296
6114,久威,5,0,5,凱基-頭份,2023-10-19,9296
6257,矽格,14,9,5,凱基-頭份,2023-10-19,9296
9950,萬國通,5,0,5,凱基-頭份,2023-10-19,9296
3491,昇達科,10,5,5,凱基-頭份,2023-10-19,9296
00915,凱基優選高股息30,6,2,4,凱基-頭份,2023-10-19,9296
2376,技嘉,6,2,4,凱基-頭份,2023-10-19,9296
3094,聯傑,10,6,4,凱基-頭份,2023-10-19,9296
6204,艾華,4,0,4,凱基-頭份,2023-10-19,9296
00687B,國泰20年美債,4,0,4,凱基-頭份,2023-10-19,9296
00712,復華富時不動產,3,0,3,凱基-頭份,2023-10-19,9296
0056,元大高股息,49,1,48,凱基-頭份,2023-10-20,9296
00929,復華台灣科技優息,35,0,35,凱基-頭份,2023-10-20,9296
2888,新光金,34,2,32,凱基-頭份,2023-10-20,9296
00919,群益台灣精選高息,28,0,28,凱基-頭份,2023-10-20,9296
3481,群創,29,4,25,凱基-頭份,2023-10-20,9296
2002,中鋼,28,4,24,凱基-頭份,2023-10-20,9296
2344,華邦電,23,1,22,凱基-頭份,2023-10-20,9296
3176,基亞,22,0,22,凱基-頭份,2023-10-20,9296
3025,星通,54,33,21,凱基-頭份,2023-10-20,9296
00720B,元大投資級公司債,17,0,17,凱基-頭份,2023-10-20,9296
2883,凱基金,17,2,15,凱基-頭份,2023-10-20,9296
2834,臺企銀,16,1,15,凱基-頭份,2023-10-20,9296
00878,國泰永續高股息,54,40,14,凱基-頭份,2023-10-20,9296
4526,東台,16,4,12,凱基-頭份,2023-10-20,9296
2892,第一金,12,0,12,凱基-頭份,2023-10-20,9296
00712,復華富時不動產,12,0,12,凱基-頭份,2023-10-20,9296
00751B,元大AAA至A公司債,11,0,11,凱基-頭份,2023-10-20,9296
00922,國泰台灣領袖50,11,0,11,凱基-頭份,2023-10-20,9296
00895,富邦未來車,10,0,10,凱基-頭份,2023-10-20,9296
2417,圓剛,9,0,9,凱基-頭份,2023-10-20,9296
3450,聯鈞,10,2,8,凱基-頭份,2023-10-20,9296
00715L,期街口布蘭特正2,7,0,7,凱基-頭份,2023-10-20,9296
2520,冠德,7,0,7,凱基-頭份,2023-10-20,9296
2889,國票金,6,0,6,凱基-頭份,2023-10-20,9296
2886,兆豐金,5,0,5,凱基-頭份,2023-10-20,9296
2618,長榮航,5,0,5,凱基-頭份,2023-10-20,9296
6114,久威,7,2,5,凱基-頭份,2023-10-20,9296
2317,鴻海,4,0,4,凱基-頭份,2023-10-20,9296
2885,元大金,4,0,4,凱基-頭份,2023-10-20,9296
1471,首利,4,0,4,凱基-頭份,2023-10-20,9296
00633L,富邦上証正2,4,0,4,凱基-頭份,2023-10-20,9296
00713,元大台灣高息低波,4,0,4,凱基-頭份,2023-10-20,9296
1802,台玻,4,0,4,凱基-頭份,2023-10-20,9296
2201,裕隆,6,2,4,凱基-頭份,2023-10-20,9296
2845,遠東銀,4,0,4,凱基-頭份,2023-10-20,9296
3694,海華,4,0,4,凱基-頭份,2023-10-20,9296
00679B,元大美債20年,3,0,3,凱基-頭份,2023-10-20,9296
00931B,統一美債20年,3,0,3,凱基-頭份,2023-10-20,9296
00915,凱基優選高股息30,6,3,3,凱基-頭份,2023-10-20,9296
6112,邁達特,3,0,3,凱基-頭份,2023-10-20,9296
2884,玉山金,3,0,3,凱基-頭份,2023-10-20,9296
2605,新興,5,2,3,凱基-頭份,2023-10-20,9296
3363,上詮,29,26,3,凱基-頭份,2023-10-20,9296
00885,富邦越南,3,0,3,凱基-頭份,2023-10-20,9296
00882,中信中國高股息,3,0,3,凱基-頭份,2023-10-20,9296
2347,聯強,3,0,3,凱基-頭份,2023-10-20,9296
2388,威盛,11,8,3,凱基-頭份,2023-10-20,9296
2408,南亞科,3,0,3,凱基-頭份,2023-10-20,9296
2606,裕民,5,2,3,凱基-頭份,2023-10-20,9296
5225,東科-KY,3,0,3,凱基-頭份,2023-10-20,9296
2515,中工,200,10,190,凱基-頭份,2023-10-23,9296
00919,群益台灣精選高息,98,0,98,凱基-頭份,2023-10-23,9296
00929,復華台灣科技優息,58,5,53,凱基-頭份,2023-10-23,9296
00712,復華富時不動產,50,0,50,凱基-頭份,2023-10-23,9296
3481,群創,37,0,37,凱基-頭份,2023-10-23,9296
00878,國泰永續高股息,26,3,23,凱基-頭份,2023-10-23,9296
2002,中鋼,22,0,22,凱基-頭份,2023-10-23,9296
00720B,元大投資級公司債,19,0,19,凱基-頭份,2023-10-23,9296
0056,元大高股息,16,0,16,凱基-頭份,2023-10-23,9296
00751B,元大AAA至A公司債,14,0,14,凱基-頭份,2023-10-23,9296
2409,友達,14,1,13,凱基-頭份,2023-10-23,9296
00857B,永豐20年美公債,11,0,11,凱基-頭份,2023-10-23,9296
2610,華航,11,0,11,凱基-頭份,2023-10-23,9296
2883,凱基金,26,15,11,凱基-頭份,2023-10-23,9296
00895,富邦未來車,10,0,10,凱基-頭份,2023-10-23,9296
00772B,中信高評級公司債,10,0,10,凱基-頭份,2023-10-23,9296
00642U,期元大S＆P石油,10,0,10,凱基-頭份,2023-10-23,9296
0050,元大台灣50,7,0,7,凱基-頭份,2023-10-23,9296
1231,聯華食,6,0,6,凱基-頭份,2023-10-23,9296
1101,台泥,6,0,6,凱基-頭份,2023-10-23,9296
00701,國泰股利精選30,6,0,6,凱基-頭份,2023-10-23,9296
2344,華邦電,8,2,6,凱基-頭份,2023-10-23,9296
1337,再生-KY,5,0,5,凱基-頭份,2023-10-23,9296
2388,威盛,10,5,5,凱基-頭份,2023-10-23,9296
2888,新光金,5,0,5,凱基-頭份,2023-10-23,9296
3032,偉訓,11,6,5,凱基-頭份,2023-10-23,9296
00773B,中信優先金融債,4,0,4,凱基-頭份,2023-10-23,9296
2891,中信金,4,0,4,凱基-頭份,2023-10-23,9296
00795B,中信美國公債20年,4,0,4,凱基-頭份,2023-10-23,9296
2516,新建,4,0,4,凱基-頭份,2023-10-23,9296
3122,笙泉,11,7,4,凱基-頭份,2023-10-23,9296
00900,富邦特選高股息30,3,0,3,凱基-頭份,2023-10-23,9296
6235,華孚,8,5,3,凱基-頭份,2023-10-23,9296
3443,創意,4,1,3,凱基-頭份,2023-10-23,9296
1609,大亞,5,2,3,凱基-頭份,2023-10-23,9296
2356,英業達,3,0,3,凱基-頭份,2023-10-23,9296
2379,瑞昱,3,0,3,凱基-頭份,2023-10-23,9296
2701,萬企,3,0,3,凱基-頭份,2023-10-23,9296
3363,上詮,11,8,3,凱基-頭份,2023-10-23,9296
5215,科嘉-KY,8,5,3,凱基-頭份,2023-10-23,9296
00923,群益台ESG低碳50,3,0,3,凱基-頭份,2023-10-23,9296
00679B,元大美債20年,3,0,3,凱基-頭份,2023-10-23,9296
2363,矽統,4,2,2,凱基-頭份,2023-10-23,9296
00687B,國泰20年美債,2,0,2,凱基-頭份,2023-10-23,9296
2884,玉山金,2,0,2,凱基-頭份,2023-10-23,9296
6213,聯茂,3,1,2,凱基-頭份,2023-10-23,9296
2882,國泰金,2,0,2,凱基-頭份,2023-10-23,9296
1216,統一,2,0,2,凱基-頭份,2023-10-23,9296
1301,台塑,2,0,2,凱基-頭份,2023-10-23,9296
1324,地球,2,0,2,凱基-頭份,2023-10-23,9296
00929,復華台灣科技優息,68,6,62,凱基-頭份,2023-10-24,9296
2460,建通,36,0,36,凱基-頭份,2023-10-24,9296
00712,復華富時不動產,33,0,33,凱基-頭份,2023-10-24,9296
5521,工信,29,0,29,凱基-頭份,2023-10-24,9296
2605,新興,25,5,20,凱基-頭份,2023-10-24,9296
2369,菱生,64,45,19,凱基-頭份,2023-10-24,9296
5215,科嘉-KY,18,1,17,凱基-頭份,2023-10-24,9296
2002,中鋼,16,0,16,凱基-頭份,2023-10-24,9296
2317,鴻海,22,8,14,凱基-頭份,2023-10-24,9296
1528,恩德,11,0,11,凱基-頭份,2023-10-24,9296
3041,揚智,13,2,11,凱基-頭份,2023-10-24,9296
2883,凱基金,16,5,11,凱基-頭份,2023-10-24,9296
6288,聯嘉,10,0,10,凱基-頭份,2023-10-24,9296
2312,金寶,10,0,10,凱基-頭份,2023-10-24,9296
4944,兆遠,10,0,10,凱基-頭份,2023-10-24,9296
1503,士電,9,0,9,凱基-頭份,2023-10-24,9296
2363,矽統,14,5,9,凱基-頭份,2023-10-24,9296
2887,台新金,8,0,8,凱基-頭份,2023-10-24,9296
8183,精星,8,0,8,凱基-頭份,2023-10-24,9296
006208,富邦台50,7,0,7,凱基-頭份,2023-10-24,9296
00878,國泰永續高股息,14,7,7,凱基-頭份,2023-10-24,9296
2233,宇隆,8,1,7,凱基-頭份,2023-10-24,9296
2888,新光金,7,0,7,凱基-頭份,2023-10-24,9296
00857B,永豐20年美公債,6,0,6,凱基-頭份,2023-10-24,9296
2303,聯電,10,4,6,凱基-頭份,2023-10-24,9296
3715,定穎投控,9,3,6,凱基-頭份,2023-10-24,9296
6176,瑞儀,6,0,6,凱基-頭份,2023-10-24,9296
4564,元翎,5,0,5,凱基-頭份,2023-10-24,9296
2892,第一金,5,0,5,凱基-頭份,2023-10-24,9296
00893,國泰智能電動車,5,0,5,凱基-頭份,2023-10-24,9296
00722B,群益投資級電信債,5,0,5,凱基-頭份,2023-10-24,9296
2409,友達,7,2,5,凱基-頭份,2023-10-24,9296
2441,超豐,5,0,5,凱基-頭份,2023-10-24,9296
2891,中信金,5,0,5,凱基-頭份,2023-10-24,9296
2884,玉山金,4,0,4,凱基-頭份,2023-10-24,9296
2345,智邦,8,4,4,凱基-頭份,2023-10-24,9296
2402,毅嘉,4,0,4,凱基-頭份,2023-10-24,9296
6113,亞矽,6,2,4,凱基-頭份,2023-10-24,9296
6684,安格,4,0,4,凱基-頭份,2023-10-24,9296
8111,立��,4,0,4,凱基-頭份,2023-10-24,9296
0050,元大台灣50,4,0,4,凱基-頭份,2023-10-24,9296
2352,佳世達,3,0,3,凱基-頭份,2023-10-24,9296
2330,台積電,4,1,3,凱基-頭份,2023-10-24,9296
00633L,富邦上証正2,3,0,3,凱基-頭份,2023-10-24,9296
00891,中信關鍵半導體,3,0,3,凱基-頭份,2023-10-24,9296
1471,首利,5,2,3,凱基-頭份,2023-10-24,9296
1711,永光,3,0,3,凱基-頭份,2023-10-24,9296
2388,威盛,10,7,3,凱基-頭份,2023-10-24,9296
3042,晶技,3,0,3,凱基-頭份,2023-10-24,9296
3055,蔚華科,5,2,3,凱基-頭份,2023-10-24,9296
00673R,期元大S＆P原油反1,100,0,100,凱基-頭份,2023-10-25,9296
00712,復華富時不動產,78,0,78,凱基-頭份,2023-10-25,9296
2409,友達,85,13,72,凱基-頭份,2023-10-25,9296
00857B,永豐20年美公債,30,0,30,凱基-頭份,2023-10-25,9296
2328,廣宇,28,0,28,凱基-頭份,2023-10-25,9296
00720B,元大投資級公司債,22,0,22,凱基-頭份,2023-10-25,9296
00898,國泰基因免疫革命,20,0,20,凱基-頭份,2023-10-25,9296
2460,建通,20,0,20,凱基-頭份,2023-10-25,9296
00919,群益台灣精選高息,15,0,15,凱基-頭份,2023-10-25,9296
2337,旺宏,15,0,15,凱基-頭份,2023-10-25,9296
2317,鴻海,16,3,13,凱基-頭份,2023-10-25,9296
0056,元大高股息,13,0,13,凱基-頭份,2023-10-25,9296
2002,中鋼,14,2,12,凱基-頭份,2023-10-25,9296
00642U,期元大S＆P石油,11,0,11,凱基-頭份,2023-10-25,9296
00637L,元大滬深300正2,41,30,11,凱基-頭份,2023-10-25,9296
2886,兆豐金,10,0,10,凱基-頭份,2023-10-25,9296
1326,台化,10,0,10,凱基-頭份,2023-10-25,9296
1102,亞泥,10,0,10,凱基-頭份,2023-10-25,9296
00931B,統一美債20年,10,0,10,凱基-頭份,2023-10-25,9296
3149,正達,10,0,10,凱基-頭份,2023-10-25,9296
4979,華星光,13,3,10,凱基-頭份,2023-10-25,9296
2888,新光金,10,1,9,凱基-頭份,2023-10-25,9296
6129,普誠,11,2,9,凱基-頭份,2023-10-25,9296
6231,系微,10,1,9,凱基-頭份,2023-10-25,9296
2618,長榮航,9,1,8,凱基-頭份,2023-10-25,9296
6282,康舒,8,0,8,凱基-頭份,2023-10-25,9296
00679B,元大美債20年,7,0,7,凱基-頭份,2023-10-25,9296
00885,富邦越南,7,0,7,凱基-頭份,2023-10-25,9296
1514,亞力,7,0,7,凱基-頭份,2023-10-25,9296
1568,倉佑,7,0,7,凱基-頭份,2023-10-25,9296
2329,華泰,8,1,7,凱基-頭份,2023-10-25,9296
6213,聯茂,6,0,6,凱基-頭份,2023-10-25,9296
00915,凱基優選高股息30,6,0,6,凱基-頭份,2023-10-25,9296
00878,國泰永續高股息,5,0,5,凱基-頭份,2023-10-25,9296
00664R,國泰臺灣加權反1,5,0,5,凱基-頭份,2023-10-25,9296
2344,華邦電,7,2,5,凱基-頭份,2023-10-25,9296
2405,輔信,7,2,5,凱基-頭份,2023-10-25,9296
2449,京元電子,178,173,5,凱基-頭份,2023-10-25,9296
3380,明泰,5,0,5,凱基-頭份,2023-10-25,9296
3530,晶相光,5,0,5,凱基-頭份,2023-10-25,9296
4121,優盛,5,0,5,凱基-頭份,2023-10-25,9296
2610,華航,5,1,4,凱基-頭份,2023-10-25,9296
3374,精材,4,0,4,凱基-頭份,2023-10-25,9296
4906,正文,4,0,4,凱基-頭份,2023-10-25,9296
2892,第一金,3,0,3,凱基-頭份,2023-10-25,9296
3035,智原,18,15,3,凱基-頭份,2023-10-25,9296
3051,力特,4,1,3,凱基-頭份,2023-10-25,9296
00788B,元大10年IG電能債,3,0,3,凱基-頭份,2023-10-25,9296
00764B,群益25年美債,3,0,3,凱基-頭份,2023-10-25,9296
2313,華通,3,0,3,凱基-頭份,2023-10-25,9296
00929,復華台灣科技優息,138,0,138,凱基-頭份,2023-10-26,9296
2344,華邦電,74,1,73,凱基-頭份,2023-10-26,9296
00919,群益台灣精選高息,41,0,41,凱基-頭份,2023-10-26,9296
2601,益航,40,0,40,凱基-頭份,2023-10-26,9296
00878,國泰永續高股息,33,3,30,凱基-頭份,2023-10-26,9296
2485,兆赫,30,0,30,凱基-頭份,2023-10-26,9296
00712,復華富時不動產,29,0,29,凱基-頭份,2023-10-26,9296
00637L,元大滬深300正2,25,0,25,凱基-頭份,2023-10-26,9296
0056,元大高股息,23,0,23,凱基-頭份,2023-10-26,9296
00679B,元大美債20年,22,0,22,凱基-頭份,2023-10-26,9296
2303,聯電,33,13,20,凱基-頭份,2023-10-26,9296
00885,富邦越南,17,0,17,凱基-頭份,2023-10-26,9296
2883,凱基金,16,0,16,凱基-頭份,2023-10-26,9296
00751B,元大AAA至A公司債,14,0,14,凱基-頭份,2023-10-26,9296
6122,擎邦,24,10,14,凱基-頭份,2023-10-26,9296
2882,國泰金,12,0,12,凱基-頭份,2023-10-26,9296
2449,京元電子,103,91,12,凱基-頭份,2023-10-26,9296
2337,旺宏,23,11,12,凱基-頭份,2023-10-26,9296
2884,玉山金,11,0,11,凱基-頭份,2023-10-26,9296
2633,台灣高鐵,11,0,11,凱基-頭份,2023-10-26,9296
00720B,元大投資級公司債,10,0,10,凱基-頭份,2023-10-26,9296
00895,富邦未來車,10,0,10,凱基-頭份,2023-10-26,9296
2801,彰銀,10,0,10,凱基-頭份,2023-10-26,9296
6198,瑞築,10,0,10,凱基-頭份,2023-10-26,9296
6197,佳必琪,10,1,9,凱基-頭份,2023-10-26,9296
6233,旺玖,9,0,9,凱基-頭份,2023-10-26,9296
6290,良維,16,7,9,凱基-頭份,2023-10-26,9296
00893,國泰智能電動車,8,0,8,凱基-頭份,2023-10-26,9296
00902,中信電池及儲能,8,0,8,凱基-頭份,2023-10-26,9296
3055,蔚華科,11,3,8,凱基-頭份,2023-10-26,9296
3037,欣興,14,6,8,凱基-頭份,2023-10-26,9296
2886,兆豐金,7,0,7,凱基-頭份,2023-10-26,9296
00931B,統一美債20年,10,3,7,凱基-頭份,2023-10-26,9296
2313,華通,8,1,7,凱基-頭份,2023-10-26,9296
3094,聯傑,7,0,7,凱基-頭份,2023-10-26,9296
6168,宏齊,7,0,7,凱基-頭份,2023-10-26,9296
6213,聯茂,7,0,7,凱基-頭份,2023-10-26,9296
2834,臺企銀,7,0,7,凱基-頭份,2023-10-26,9296
0050,元大台灣50,6,0,6,凱基-頭份,2023-10-26,9296
2465,麗臺,7,1,6,凱基-頭份,2023-10-26,9296
2888,新光金,6,0,6,凱基-頭份,2023-10-26,9296
00900,富邦特選高股息30,5,0,5,凱基-頭份,2023-10-26,9296
00915,凱基優選高股息30,6,1,5,凱基-頭份,2023-10-26,9296
1324,地球,13,8,5,凱基-頭份,2023-10-26,9296
1727,中華化,5,0,5,凱基-頭份,2023-10-26,9296
2345,智邦,6,1,5,凱基-頭份,2023-10-26,9296
3213,茂訊,5,0,5,凱基-頭份,2023-10-26,9296
6592,和潤企業,5,0,5,凱基-頭份,2023-10-26,9296
8438,昶昕,5,0,5,凱基-頭份,2023-10-26,9296
00922,國泰台灣領袖50,4,0,4,凱基-頭份,2023-10-26,9296
00680L,元大美債20正2,70,0,70,凱基-頭份,2023-10-27,9296
00715L,期街口布蘭特正2,50,0,50,凱基-頭份,2023-10-27,9296
00929,復華台灣科技優息,38,6,32,凱基-頭份,2023-10-27,9296
2369,菱生,41,16,25,凱基-頭份,2023-10-27,9296
2337,旺宏,23,0,23,凱基-頭份,2023-10-27,9296
2363,矽統,21,2,19,凱基-頭份,2023-10-27,9296
00885,富邦越南,12,0,12,凱基-頭份,2023-10-27,9296
2457,飛宏,12,0,12,凱基-頭份,2023-10-27,9296
8937,合騏,12,0,12,凱基-頭份,2023-10-27,9296
2605,新興,10,0,10,凱基-頭份,2023-10-27,9296
2317,鴻海,12,3,9,凱基-頭份,2023-10-27,9296
00687B,國泰20年美債,9,0,9,凱基-頭份,2023-10-27,9296
2303,聯電,8,0,8,凱基-頭份,2023-10-27,9296
2401,凌陽,8,0,8,凱基-頭份,2023-10-27,9296
2886,兆豐金,7,0,7,凱基-頭份,2023-10-27,9296
2388,威盛,8,2,6,凱基-頭份,2023-10-27,9296
3346,麗清,6,0,6,凱基-頭份,2023-10-27,9296
8093,保銳,6,0,6,凱基-頭份,2023-10-27,9296
0056,元大高股息,6,1,5,凱基-頭份,2023-10-27,9296
3083,網龍,5,0,5,凱基-頭份,2023-10-27,9296
2329,華泰,4,0,4,凱基-頭份,2023-10-27,9296
3078,僑威,17,13,4,凱基-頭份,2023-10-27,9296
3276,宇環,27,23,4,凱基-頭份,2023-10-27,9296
3035,智原,4,1,3,凱基-頭份,2023-10-27,9296
2883,凱基金,3,0,3,凱基-頭份,2023-10-27,9296
00712,復華富時不動產,3,0,3,凱基-頭份,2023-10-27,9296
1504,東元,3,0,3,凱基-頭份,2023-10-27,9296
2462,良得電,3,0,3,凱基-頭份,2023-10-27,9296
2464,盟立,3,0,3,凱基-頭份,2023-10-27,9296
2734,易飛網,3,0,3,凱基-頭份,2023-10-27,9296
3260,威剛,5,2,3,凱基-頭份,2023-10-27,9296
5351,鈺創,3,0,3,凱基-頭份,2023-10-27,9296
2884,玉山金,2,0,2,凱基-頭份,2023-10-27,9296
1524,耿鼎,4,2,2,凱基-頭份,2023-10-27,9296
2313,華通,3,1,2,凱基-頭份,2023-10-27,9296
2323,中環,2,0,2,凱基-頭份,2023-10-27,9296
2328,廣宇,2,0,2,凱基-頭份,2023-10-27,9296
2340,台亞,6,4,2,凱基-頭份,2023-10-27,9296
2379,瑞昱,2,0,2,凱基-頭份,2023-10-27,9296
2405,輔信,4,2,2,凱基-頭份,2023-10-27,9296
2409,友達,3,1,2,凱基-頭份,2023-10-27,9296
2486,一詮,2,0,2,凱基-頭份,2023-10-27,9296
2516,新建,2,0,2,凱基-頭份,2023-10-27,9296
3005,神基,2,0,2,凱基-頭份,2023-10-27,9296
3122,笙泉,5,3,2,凱基-頭份,2023-10-27,9296
3715,定穎投控,9,7,2,凱基-頭份,2023-10-27,9296
6150,撼訊,2,0,2,凱基-頭份,2023-10-27,9296
6182,合晶,2,0,2,凱基-頭份,2023-10-27,9296
6186,新潤,2,0,2,凱基-頭份,2023-10-27,9296
6187,萬潤,2,0,2,凱基-頭份,2023-10-27,9296
00673R,期元大S＆P原油反1,100,0,100,凱基-頭份,2023-10-30,9296
00878,國泰永續高股息,35,0,35,凱基-頭份,2023-10-30,9296
2462,良得電,30,0,30,凱基-頭份,2023-10-30,9296
2337,旺宏,28,0,28,凱基-頭份,2023-10-30,9296
2886,兆豐金,24,0,24,凱基-頭份,2023-10-30,9296
2882,國泰金,21,0,21,凱基-頭份,2023-10-30,9296
00857B,永豐20年美公債,20,0,20,凱基-頭份,2023-10-30,9296
2515,中工,20,0,20,凱基-頭份,2023-10-30,9296
1721,三晃,20,1,19,凱基-頭份,2023-10-30,9296
8937,合騏,17,0,17,凱基-頭份,2023-10-30,9296
2485,兆赫,67,51,16,凱基-頭份,2023-10-30,9296
00922,國泰台灣領袖50,15,0,15,凱基-頭份,2023-10-30,9296
2390,云辰,25,11,14,凱基-頭份,2023-10-30,9296
6117,迎廣,13,1,12,凱基-頭份,2023-10-30,9296
2618,長榮航,12,0,12,凱基-頭份,2023-10-30,9296
00773B,中信優先金融債,10,0,10,凱基-頭份,2023-10-30,9296
00885,富邦越南,10,0,10,凱基-頭份,2023-10-30,9296
1528,恩德,10,0,10,凱基-頭份,2023-10-30,9296
2356,英業達,20,10,10,凱基-頭份,2023-10-30,9296
2605,新興,10,0,10,凱基-頭份,2023-10-30,9296
2887,台新金,10,0,10,凱基-頭份,2023-10-30,9296
3032,偉訓,15,5,10,凱基-頭份,2023-10-30,9296
4960,誠美材,10,0,10,凱基-頭份,2023-10-30,9296
5302,太欣,10,0,10,凱基-頭份,2023-10-30,9296
0056,元大高股息,9,0,9,凱基-頭份,2023-10-30,9296
9958,世紀鋼,8,0,8,凱基-頭份,2023-10-30,9296
0050,元大台灣50,7,0,7,凱基-頭份,2023-10-30,9296
2201,裕隆,9,2,7,凱基-頭份,2023-10-30,9296
3231,緯創,17,10,7,凱基-頭份,2023-10-30,9296
5272,笙科,7,0,7,凱基-頭份,2023-10-30,9296
2883,凱基金,6,0,6,凱基-頭份,2023-10-30,9296
2915,潤泰全,6,0,6,凱基-頭份,2023-10-30,9296
1312,國喬,5,0,5,凱基-頭份,2023-10-30,9296
00662,富邦NASDAQ,5,0,5,凱基-頭份,2023-10-30,9296
2374,佳能,5,0,5,凱基-頭份,2023-10-30,9296
2838,聯邦銀,5,0,5,凱基-頭份,2023-10-30,9296
00679B,元大美債20年,4,0,4,凱基-頭份,2023-10-30,9296
4128,中天,4,0,4,凱基-頭份,2023-10-30,9296
5258,虹堡,5,1,4,凱基-頭份,2023-10-30,9296
6442,光聖,7,3,4,凱基-頭份,2023-10-30,9296
00919,群益台灣精選高息,3,0,3,凱基-頭份,2023-10-30,9296
2890,永豐金,18,15,3,凱基-頭份,2023-10-30,9296
2884,玉山金,3,0,3,凱基-頭份,2023-10-30,9296
00751B,元大AAA至A公司債,3,0,3,凱基-頭份,2023-10-30,9296
00720B,元大投資級公司債,3,0,3,凱基-頭份,2023-10-30,9296
2401,凌陽,3,0,3,凱基-頭份,2023-10-30,9296
2449,京元電子,8,5,3,凱基-頭份,2023-10-30,9296
2457,飛宏,3,0,3,凱基-頭份,2023-10-30,9296
2610,華航,353,350,3,凱基-頭份,2023-10-30,9296
2892,第一金,3,0,3,凱基-頭份,2023-10-30,9296
00878,國泰永續高股息,79,0,79,凱基-頭份,2023-10-31,9296
00929,復華台灣科技優息,127,51,76,凱基-頭份,2023-10-31,9296
00680L,元大美債20正2,50,0,50,凱基-頭份,2023-10-31,9296
0056,元大高股息,36,0,36,凱基-頭份,2023-10-31,9296
2344,華邦電,38,7,31,凱基-頭份,2023-10-31,9296
2409,友達,32,9,23,凱基-頭份,2023-10-31,9296
3122,笙泉,40,19,21,凱基-頭份,2023-10-31,9296
00857B,永豐20年美公債,20,1,19,凱基-頭份,2023-10-31,9296
2515,中工,15,0,15,凱基-頭份,2023-10-31,9296
2109,華豐,13,0,13,凱基-頭份,2023-10-31,9296
00919,群益台灣精選高息,12,0,12,凱基-頭份,2023-10-31,9296
00885,富邦越南,12,0,12,凱基-頭份,2023-10-31,9296
8937,合騏,12,0,12,凱基-頭份,2023-10-31,9296
3094,聯傑,16,5,11,凱基-頭份,2023-10-31,9296
3363,上詮,11,0,11,凱基-頭份,2023-10-31,9296
4979,華星光,15,4,11,凱基-頭份,2023-10-31,9296
1319,東陽,10,0,10,凱基-頭份,2023-10-31,9296
2338,光罩,10,0,10,凱基-頭份,2023-10-31,9296
3322,建舜電,11,1,10,凱基-頭份,2023-10-31,9296
6757,台灣虎航,10,0,10,凱基-頭份,2023-10-31,9296
0050,元大台灣50,9,0,9,凱基-頭份,2023-10-31,9296
2317,鴻海,13,3,10,凱基-頭份,2023-10-31,9296
1524,耿鼎,12,3,9,凱基-頭份,2023-10-31,9296
1815,富喬,13,4,9,凱基-頭份,2023-10-31,9296
6443,元晶,13,5,8,凱基-頭份,2023-10-31,9296
2417,圓剛,25,18,7,凱基-頭份,2023-10-31,9296
00893,國泰智能電動車,10,4,6,凱基-頭份,2023-10-31,9296
00642U,期元大S＆P石油,6,0,6,凱基-頭份,2023-10-31,9296
2340,台亞,16,10,6,凱基-頭份,2023-10-31,9296
5469,瀚宇博,6,0,6,凱基-頭份,2023-10-31,9296
6213,聯茂,6,0,6,凱基-頭份,2023-10-31,9296
9958,世紀鋼,6,0,6,凱基-頭份,2023-10-31,9296
1316,上曜,5,0,5,凱基-頭份,2023-10-31,9296
3088,艾訊,5,0,5,凱基-頭份,2023-10-31,9296
3576,聯合再生,12,7,5,凱基-頭份,2023-10-31,9296
4563,百德,5,0,5,凱基-頭份,2023-10-31,9296
4934,太極,5,0,5,凱基-頭份,2023-10-31,9296
6138,茂達,5,0,5,凱基-頭份,2023-10-31,9296
8021,尖點,5,0,5,凱基-頭份,2023-10-31,9296
2330,台積電,4,0,4,凱基-頭份,2023-10-31,9296
00923,群益台ESG低碳50,4,0,4,凱基-頭份,2023-10-31,9296
2408,南亞科,4,0,4,凱基-頭份,2023-10-31,9296
2449,京元電子,6,2,4,凱基-頭份,2023-10-31,9296
5302,太欣,4,0,4,凱基-頭份,2023-10-31,9296
6271,同欣電,4,0,4,凱基-頭份,2023-10-31,9296
6605,帝寶,4,0,4,凱基-頭份,2023-10-31,9296
6684,安格,4,0,4,凱基-頭份,2023-10-31,9296
00896,中信綠能及電動車,3,0,3,凱基-頭份,2023-10-31,9296
1305,華夏,3,0,3,凱基-頭份,2023-10-31,9296
00679B,元大美債20年,3,0,3,凱基-頭份,2023-10-31,9296
00929,復華台灣科技優息,195,0,195,凱基-頭份,2023-11-01,9296
00712,復華富時不動產,61,0,61,凱基-頭份,2023-11-01,9296
1101,台泥,40,0,40,凱基-頭份,2023-11-01,9296
00679B,元大美債20年,24,0,24,凱基-頭份,2023-11-01,9296
00857B,永豐20年美公債,24,0,24,凱基-頭份,2023-11-01,9296
1721,三晃,20,0,20,凱基-頭份,2023-11-01,9296
2890,永豐金,20,0,20,凱基-頭份,2023-11-01,9296
00878,國泰永續高股息,20,6,14,凱基-頭份,2023-11-01,9296
3707,漢磊,13,1,12,凱基-頭份,2023-11-01,9296
4915,致伸,15,3,12,凱基-頭份,2023-11-01,9296
00919,群益台灣精選高息,12,1,11,凱基-頭份,2023-11-01,9296
00632R,元大台灣50反1,10,0,10,凱基-頭份,2023-11-01,9296
2002,中鋼,10,0,10,凱基-頭份,2023-11-01,9296
2409,友達,263,253,10,凱基-頭份,2023-11-01,9296
2543,皇昌,10,0,10,凱基-頭份,2023-11-01,9296
2891,中信金,10,0,10,凱基-頭份,2023-11-01,9296
4102,永日,10,0,10,凱基-頭份,2023-11-01,9296
00885,富邦越南,9,0,9,凱基-頭份,2023-11-01,9296
3025,星通,12,3,9,凱基-頭份,2023-11-01,9296
00687B,國泰20年美債,8,0,8,凱基-頭份,2023-11-01,9296
2883,凱基金,8,0,8,凱基-頭份,2023-11-01,9296
6191,精成科,8,0,8,凱基-頭份,2023-11-01,9296
6657,華安,8,0,8,凱基-頭份,2023-11-01,9296
8112,至上,10,2,8,凱基-頭份,2023-11-01,9296
2337,旺宏,8,1,7,凱基-頭份,2023-11-01,9296
0056,元大高股息,8,1,7,凱基-頭份,2023-11-01,9296
3122,笙泉,9,3,6,凱基-頭份,2023-11-01,9296
3450,聯鈞,6,0,6,凱基-頭份,2023-11-01,9296
2317,鴻海,7,1,6,凱基-頭份,2023-11-01,9296
00934,中信成長高股息,6,1,5,凱基-頭份,2023-11-01,9296
00642U,期元大S＆P石油,5,0,5,凱基-頭份,2023-11-01,9296
1909,榮成,5,0,5,凱基-頭份,2023-11-01,9296
2425,承啟,5,0,5,凱基-頭份,2023-11-01,9296
2605,新興,5,0,5,凱基-頭份,2023-11-01,9296
3094,聯傑,5,0,5,凱基-頭份,2023-11-01,9296
3227,原相,5,0,5,凱基-頭份,2023-11-01,9296
3491,昇達科,6,1,5,凱基-頭份,2023-11-01,9296
3541,西柏,5,0,5,凱基-頭份,2023-11-01,9296
3694,海華,9,4,5,凱基-頭份,2023-11-01,9296
8429,金麗-KY,5,0,5,凱基-頭份,2023-11-01,9296
2402,毅嘉,5,1,4,凱基-頭份,2023-11-01,9296
2449,京元電子,5,1,4,凱基-頭份,2023-11-01,9296
3035,智原,8,4,4,凱基-頭份,2023-11-01,9296
4973,廣穎,4,0,4,凱基-頭份,2023-11-01,9296
3231,緯創,4,1,3,凱基-頭份,2023-11-01,9296
1519,華城,12,9,3,凱基-頭份,2023-11-01,9296
00751B,元大AAA至A公司債,3,0,3,凱基-頭份,2023-11-01,9296
1605,華新,11,8,3,凱基-頭份,2023-11-01,9296
2369,菱生,3,0,3,凱基-頭份,2023-11-01,9296
2376,技嘉,3,0,3,凱基-頭份,2023-11-01,9296
00712,復華富時不動產,155,0,155,凱基-頭份,2023-11-02,9296
00857B,永豐20年美公債,123,0,123,凱基-頭份,2023-11-02,9296
00680L,元大美債20正2,50,0,50,凱基-頭份,2023-11-02,9296
00878,國泰永續高股息,54,12,42,凱基-頭份,2023-11-02,9296
1721,三晃,40,0,40,凱基-頭份,2023-11-02,9296
2356,英業達,38,5,33,凱基-頭份,2023-11-02,9296
00664R,國泰臺灣加權反1,30,0,30,凱基-頭份,2023-11-02,9296
00632R,元大台灣50反1,30,0,30,凱基-頭份,2023-11-02,9296
00720B,元大投資級公司債,30,0,30,凱基-頭份,2023-11-02,9296
8927,北基,30,0,30,凱基-頭份,2023-11-02,9296
2610,華航,30,1,29,凱基-頭份,2023-11-02,9296
00929,復華台灣科技優息,108,90,18,凱基-頭份,2023-11-02,9296
6191,精成科,17,0,17,凱基-頭份,2023-11-02,9296
00687B,國泰20年美債,14,1,13,凱基-頭份,2023-11-02,9296
1314,中石化,10,0,10,凱基-頭份,2023-11-02,9296
2515,中工,10,0,10,凱基-頭份,2023-11-02,9296
4906,正文,10,0,10,凱基-頭份,2023-11-02,9296
0056,元大高股息,10,1,9,凱基-頭份,2023-11-02,9296
2885,元大金,9,0,9,凱基-頭份,2023-11-02,9296
2317,鴻海,9,0,9,凱基-頭份,2023-11-02,9296
3346,麗清,8,0,8,凱基-頭份,2023-11-02,9296
5425,台半,8,0,8,凱基-頭份,2023-11-02,9296
3322,建舜電,6,0,6,凱基-頭份,2023-11-02,9296
00673R,期元大S＆P原油反1,5,0,5,凱基-頭份,2023-11-02,9296
4533,協易機,5,0,5,凱基-頭份,2023-11-02,9296
4915,致伸,7,2,5,凱基-頭份,2023-11-02,9296
9105,泰金寶-DR,10,5,5,凱基-頭份,2023-11-02,9296
9928,中視,5,0,5,凱基-頭份,2023-11-02,9296
3587,閎康,6,2,4,凱基-頭份,2023-11-02,9296
5703,亞都,4,0,4,凱基-頭份,2023-11-02,9296
6168,宏齊,4,0,4,凱基-頭份,2023-11-02,9296
8176,智捷,4,0,4,凱基-頭份,2023-11-02,9296
2465,麗臺,3,0,3,凱基-頭份,2023-11-02,9296
3178,公準,3,0,3,凱基-頭份,2023-11-02,9296
6491,晶碩,3,0,3,凱基-頭份,2023-11-02,9296
6684,安格,3,0,3,凱基-頭份,2023-11-02,9296
8043,蜜望實,3,0,3,凱基-頭份,2023-11-02,9296
8409,商之器,3,0,3,凱基-頭份,2023-11-02,9296
6841,長佳智能,2,0,2,凱基-頭份,2023-11-02,9296
3037,欣興,4,2,2,凱基-頭份,2023-11-02,9296
00919,群益台灣精選高息,2,0,2,凱基-頭份,2023-11-02,9296
00877,復華中國5G,2,0,2,凱基-頭份,2023-11-02,9296
00764B,群益25年美債,2,0,2,凱基-頭份,2023-11-02,9296
1795,美時,5,3,2,凱基-頭份,2023-11-02,9296
2022,聚亨,2,0,2,凱基-頭份,2023-11-02,9296
2357,華碩,2,0,2,凱基-頭份,2023-11-02,9296
2362,藍天,2,0,2,凱基-頭份,2023-11-02,9296
2399,映泰,2,0,2,凱基-頭份,2023-11-02,9296
3689,湧德,2,0,2,凱基-頭份,2023-11-02,9296
4401,東隆興,2,0,2,凱基-頭份,2023-11-02,9296
1815,富喬,82,5,77,凱基-頭份,2023-11-03,9296
00632R,元大台灣50反1,60,0,60,凱基-頭份,2023-11-03,9296
2363,矽統,87,44,43,凱基-頭份,2023-11-03,9296
00664R,國泰臺灣加權反1,40,0,40,凱基-頭份,2023-11-03,9296
00712,復華富時不動產,34,0,34,凱基-頭份,2023-11-03,9296
2344,華邦電,55,24,31,凱基-頭份,2023-11-03,9296
6770,力積電,58,33,25,凱基-頭份,2023-11-03,9296
00878,國泰永續高股息,43,22,21,凱基-頭份,2023-11-03,9296
00900,富邦特選高股息30,20,0,20,凱基-頭份,2023-11-03,9296
00857B,永豐20年美公債,20,0,20,凱基-頭份,2023-11-03,9296
2515,中工,20,0,20,凱基-頭份,2023-11-03,9296
00931B,統一美債20年,16,0,16,凱基-頭份,2023-11-03,9296
00688L,國泰20年美債正2,20,7,13,凱基-頭份,2023-11-03,9296
3380,明泰,12,0,12,凱基-頭份,2023-11-03,9296
2317,鴻海,22,10,12,凱基-頭份,2023-11-03,9296
00904,新光臺灣半導體30,10,0,10,凱基-頭份,2023-11-03,9296
1449,佳和,10,0,10,凱基-頭份,2023-11-03,9296
2329,華泰,10,0,10,凱基-頭份,2023-11-03,9296
2884,玉山金,13,3,10,凱基-頭份,2023-11-03,9296
6156,松上,8,0,8,凱基-頭份,2023-11-03,9296
3322,建舜電,7,0,7,凱基-頭份,2023-11-03,9296
4401,東隆興,6,0,6,凱基-頭份,2023-11-03,9296
6233,旺玖,6,0,6,凱基-頭份,2023-11-03,9296
1514,亞力,5,0,5,凱基-頭份,2023-11-03,9296
2358,廷鑫,5,0,5,凱基-頭份,2023-11-03,9296
3264,欣銓,7,2,5,凱基-頭份,2023-11-03,9296
5880,合庫金,5,0,5,凱基-頭份,2023-11-03,9296
8088,品安,5,0,5,凱基-頭份,2023-11-03,9296
8927,北基,5,0,5,凱基-頭份,2023-11-03,9296
9928,中視,4,0,4,凱基-頭份,2023-11-03,9296
3044,健鼎,4,0,4,凱基-頭份,2023-11-03,9296
6592,和潤企業,4,0,4,凱基-頭份,2023-11-03,9296
00673R,期元大S＆P原油反1,3,0,3,凱基-頭份,2023-11-03,9296
2421,建準,3,0,3,凱基-頭份,2023-11-03,9296
2615,萬海,3,0,3,凱基-頭份,2023-11-03,9296
3093,港建*,3,0,3,凱基-頭份,2023-11-03,9296
3231,緯創,12,9,3,凱基-頭份,2023-11-03,9296
3491,昇達科,3,0,3,凱基-頭份,2023-11-03,9296
3567,逸昌,3,0,3,凱基-頭份,2023-11-03,9296
6284,佳邦,3,0,3,凱基-頭份,2023-11-03,9296
2609,陽明,3,0,3,凱基-頭份,2023-11-03,9296
2441,超豐,2,0,2,凱基-頭份,2023-11-03,9296
00725B,國泰投資級公司債,2,0,2,凱基-頭份,2023-11-03,9296
00715L,期街口布蘭特正2,2,0,2,凱基-頭份,2023-11-03,9296
2367,燿華,2,0,2,凱基-頭份,2023-11-03,9296
2382,廣達,4,2,2,凱基-頭份,2023-11-03,9296
3050,鈺德,2,0,2,凱基-頭份,2023-11-03,9296
3088,艾訊,2,0,2,凱基-頭份,2023-11-03,9296
3122,笙泉,6,4,2,凱基-頭份,2023-11-03,9296
3324,雙鴻,2,0,2,凱基-頭份,2023-11-03,9296
00632R,元大台灣50反1,125,0,125,凱基-頭份,2023-11-06,9296
2618,長榮航,125,20,105,凱基-頭份,2023-11-06,9296
1101,台泥,36,7,29,凱基-頭份,2023-11-06,9296
00934,中信成長高股息,24,0,24,凱基-頭份,2023-11-06,9296
00680L,元大美債20正2,20,0,20,凱基-頭份,2023-11-06,9296
4157,太景*-KY,20,0,20,凱基-頭份,2023-11-06,9296
1721,三晃,30,15,15,凱基-頭份,2023-11-06,9296
5521,工信,15,0,15,凱基-頭份,2023-11-06,9296
00715L,期街口布蘭特正2,11,0,11,凱基-頭份,2023-11-06,9296
00885,富邦越南,10,0,10,凱基-頭份,2023-11-06,9296
00664R,國泰臺灣加權反1,10,0,10,凱基-頭份,2023-11-06,9296
1802,台玻,10,0,10,凱基-頭份,2023-11-06,9296
2417,圓剛,10,0,10,凱基-頭份,2023-11-06,9296
8927,北基,10,0,10,凱基-頭份,2023-11-06,9296
1609,大亞,11,2,9,凱基-頭份,2023-11-06,9296
3715,定穎投控,11,2,9,凱基-頭份,2023-11-06,9296
6233,旺玖,9,0,9,凱基-頭份,2023-11-06,9296
6243,迅杰,12,4,8,凱基-頭份,2023-11-06,9296
2376,技嘉,12,5,7,凱基-頭份,2023-11-06,9296
00642U,期元大S＆P石油,6,0,6,凱基-頭份,2023-11-06,9296
1809,中釉,14,8,6,凱基-頭份,2023-11-06,9296
00679B,元大美債20年,5,0,5,凱基-頭份,2023-11-06,9296
2408,南亞科,5,0,5,凱基-頭份,2023-11-06,9296
2430,燦坤,5,0,5,凱基-頭份,2023-11-06,9296
2888,新光金,5,0,5,凱基-頭份,2023-11-06,9296
3094,聯傑,6,1,5,凱基-頭份,2023-11-06,9296
5706,鳳凰,5,0,5,凱基-頭份,2023-11-06,9296
8426,紅木-KY,5,0,5,凱基-頭份,2023-11-06,9296
00878,國泰永續高股息,15,10,5,凱基-頭份,2023-11-06,9296
2317,鴻海,4,0,4,凱基-頭份,2023-11-06,9296
1308,亞聚,4,0,4,凱基-頭份,2023-11-06,9296
2486,一詮,6,2,4,凱基-頭份,2023-11-06,9296
2610,華航,9,5,4,凱基-頭份,2023-11-06,9296
3450,聯鈞,9,5,4,凱基-頭份,2023-11-06,9296
6229,研通,4,0,4,凱基-頭份,2023-11-06,9296
00772B,中信高評級公司債,3,0,3,凱基-頭份,2023-11-06,9296
2409,友達,6,3,3,凱基-頭份,2023-11-06,9296
2838,聯邦銀,3,0,3,凱基-頭份,2023-11-06,9296
3006,晶豪科,103,100,3,凱基-頭份,2023-11-06,9296
4726,永昕,3,0,3,凱基-頭份,2023-11-06,9296
2301,光寶科,2,0,2,凱基-頭份,2023-11-06,9296
3037,欣興,6,4,2,凱基-頭份,2023-11-06,9296
00935,野村臺灣新科技50,2,0,2,凱基-頭份,2023-11-06,9296
1314,中石化,2,0,2,凱基-頭份,2023-11-06,9296
00795B,中信美國公債20年,2,0,2,凱基-頭份,2023-11-06,9296
00710B,復華彭博非投等債,2,0,2,凱基-頭份,2023-11-06,9296
00756B,群益投等新興公債,2,0,2,凱基-頭份,2023-11-06,9296
00720B,元大投資級公司債,2,0,2,凱基-頭份,2023-11-06,9296
1529,樂事綠能,2,0,2,凱基-頭份,2023-11-06,9296
3088,艾訊,2,0,2,凱基-頭份,2023-11-06,9296
3704,合勤控,116,0,116,凱基-頭份,2023-11-07,9296
00878,國泰永續高股息,73,0,73,凱基-頭份,2023-11-07,9296
2812,台中銀,53,0,53,凱基-頭份,2023-11-07,9296
3380,明泰,30,3,27,凱基-頭份,2023-11-07,9296
00679B,元大美債20年,25,0,25,凱基-頭份,2023-11-07,9296
3276,宇環,31,9,22,凱基-頭份,2023-11-07,9296
4533,協易機,22,0,22,凱基-頭份,2023-11-07,9296
8927,北基,19,0,19,凱基-頭份,2023-11-07,9296
2363,矽統,35,18,17,凱基-頭份,2023-11-07,9296
6290,良維,16,1,15,凱基-頭份,2023-11-07,9296
6197,佳必琪,14,0,14,凱基-頭份,2023-11-07,9296
2634,漢翔,13,0,13,凱基-頭份,2023-11-07,9296
2352,佳世達,13,0,13,凱基-頭份,2023-11-07,9296
1314,中石化,10,0,10,凱基-頭份,2023-11-07,9296
2888,新光金,10,0,10,凱基-頭份,2023-11-07,9296
3374,精材,10,0,10,凱基-頭份,2023-11-07,9296
00929,復華台灣科技優息,19,10,9,凱基-頭份,2023-11-07,9296
00882,中信中國高股息,8,0,8,凱基-頭份,2023-11-07,9296
5301,寶得利,8,0,8,凱基-頭份,2023-11-07,9296
2344,華邦電,9,2,7,凱基-頭份,2023-11-07,9296
2618,長榮航,14,7,7,凱基-頭份,2023-11-07,9296
4108,懷特,10,3,7,凱基-頭份,2023-11-07,9296
00931B,統一美債20年,6,0,6,凱基-頭份,2023-11-07,9296
2356,英業達,11,5,6,凱基-頭份,2023-11-07,9296
3088,艾訊,6,0,6,凱基-頭份,2023-11-07,9296
5302,太欣,6,0,6,凱基-頭份,2023-11-07,9296
2408,南亞科,5,0,5,凱基-頭份,2023-11-07,9296
2417,圓剛,5,0,5,凱基-頭份,2023-11-07,9296
2838,聯邦銀,5,0,5,凱基-頭份,2023-11-07,9296
3056,富華新,5,0,5,凱基-頭份,2023-11-07,9296
6901,鑽石投資,5,0,5,凱基-頭份,2023-11-07,9296
1101,台泥,4,0,4,凱基-頭份,2023-11-07,9296
00687B,國泰20年美債,4,0,4,凱基-頭份,2023-11-07,9296
00919,群益台灣精選高息,4,0,4,凱基-頭份,2023-11-07,9296
2377,微星,4,0,4,凱基-頭份,2023-11-07,9296
2388,威盛,16,12,4,凱基-頭份,2023-11-07,9296
4168,醣聯,4,0,4,凱基-頭份,2023-11-07,9296
2317,鴻海,4,0,4,凱基-頭份,2023-11-07,9296
1301,台塑,3,0,3,凱基-頭份,2023-11-07,9296
1312,國喬,3,0,3,凱基-頭份,2023-11-07,9296
00930,永豐ESG低碳高息,3,0,3,凱基-頭份,2023-11-07,9296
00902,中信電池及儲能,13,10,3,凱基-頭份,2023-11-07,9296
00891,中信關鍵半導體,3,0,3,凱基-頭份,2023-11-07,9296
2457,飛宏,3,0,3,凱基-頭份,2023-11-07,9296
3541,西柏,3,0,3,凱基-頭份,2023-11-07,9296
3545,敦泰,7,4,3,凱基-頭份,2023-11-07,9296
4933,友輝,3,0,3,凱基-頭份,2023-11-07,9296
4945,陞達科技,3,0,3,凱基-頭份,2023-11-07,9296
6139,亞翔,7,4,3,凱基-頭份,2023-11-07,9296
6282,康舒,3,0,3,凱基-頭份,2023-11-07,9296
00706L,期元大S＆P日圓正2,150,0,150,凱基-頭份,2023-11-08,9296
00936,台新永續高息中小,71,2,69,凱基-頭份,2023-11-08,9296
00680L,元大美債20正2,52,0,52,凱基-頭份,2023-11-08,9296
2618,長榮航,43,7,36,凱基-頭份,2023-11-08,9296
00885,富邦越南,35,0,35,凱基-頭份,2023-11-08,9296
1515,力山,36,3,33,凱基-頭份,2023-11-08,9296
00857B,永豐20年美公債,30,0,30,凱基-頭份,2023-11-08,9296
2324,仁寶,31,1,30,凱基-頭份,2023-11-08,9296
4167,松瑞藥,29,0,29,凱基-頭份,2023-11-08,9296
00751B,元大AAA至A公司債,20,0,20,凱基-頭份,2023-11-08,9296
2891,中信金,20,0,20,凱基-頭份,2023-11-08,9296
2515,中工,49,30,19,凱基-頭份,2023-11-08,9296
00632R,元大台灣50反1,17,0,17,凱基-頭份,2023-11-08,9296
6148,驊宏資,15,0,15,凱基-頭份,2023-11-08,9296
00919,群益台灣精選高息,14,0,14,凱基-頭份,2023-11-08,9296
00900,富邦特選高股息30,12,0,12,凱基-頭份,2023-11-08,9296
6290,良維,12,0,12,凱基-頭份,2023-11-08,9296
8927,北基,11,0,11,凱基-頭份,2023-11-08,9296
00923,群益台ESG低碳50,10,0,10,凱基-頭份,2023-11-08,9296
00898,國泰基因免疫革命,10,0,10,凱基-頭份,2023-11-08,9296
1612,宏泰,10,0,10,凱基-頭份,2023-11-08,9296
2883,凱基金,10,0,10,凱基-頭份,2023-11-08,9296
3346,麗清,10,0,10,凱基-頭份,2023-11-08,9296
3540,曜越,10,0,10,凱基-頭份,2023-11-08,9296
3622,洋華,10,0,10,凱基-頭份,2023-11-08,9296
3006,晶豪科,8,0,8,凱基-頭份,2023-11-08,9296
00642U,期元大S＆P石油,7,0,7,凱基-頭份,2023-11-08,9296
2388,威盛,12,5,7,凱基-頭份,2023-11-08,9296
5014,建錩,6,0,6,凱基-頭份,2023-11-08,9296
6770,力積電,270,264,6,凱基-頭份,2023-11-08,9296
2303,聯電,8,3,5,凱基-頭份,2023-11-08,9296
1402,遠東新,5,0,5,凱基-頭份,2023-11-08,9296
2313,華通,8,3,5,凱基-頭份,2023-11-08,9296
2609,陽明,5,0,5,凱基-頭份,2023-11-08,9296
2820,華票,5,0,5,凱基-頭份,2023-11-08,9296
3024,憶聲,5,0,5,凱基-頭份,2023-11-08,9296
3710,連展投控,5,0,5,凱基-頭份,2023-11-08,9296
2401,凌陽,4,0,4,凱基-頭份,2023-11-08,9296
3032,偉訓,20,16,4,凱基-頭份,2023-11-08,9296
3041,揚智,4,0,4,凱基-頭份,2023-11-08,9296
3706,神達,4,0,4,凱基-頭份,2023-11-08,9296
4168,醣聯,4,0,4,凱基-頭份,2023-11-08,9296
2337,旺宏,4,0,4,凱基-頭份,2023-11-08,9296
1524,耿鼎,3,0,3,凱基-頭份,2023-11-08,9296
1808,潤隆,3,0,3,凱基-頭份,2023-11-08,9296
2402,毅嘉,3,0,3,凱基-頭份,2023-11-08,9296
2409,友達,6,3,3,凱基-頭份,2023-11-08,9296
2739,寒舍,3,0,3,凱基-頭份,2023-11-08,9296
3325,旭品,3,0,3,凱基-頭份,2023-11-08,9296
4533,協易機,3,0,3,凱基-頭份,2023-11-08,9296
00857B,永豐20年美公債,70,0,70,凱基-頭份,2023-11-09,9296
00878,國泰永續高股息,54,0,54,凱基-頭份,2023-11-09,9296
00680L,元大美債20正2,52,0,52,凱基-頭份,2023-11-09,9296
2329,華泰,37,3,34,凱基-頭份,2023-11-09,9296
00632R,元大台灣50反1,25,0,25,凱基-頭份,2023-11-09,9296
2610,華航,22,0,22,凱基-頭份,2023-11-09,9296
5347,世界,20,0,20,凱基-頭份,2023-11-09,9296
2324,仁寶,18,0,18,凱基-頭份,2023-11-09,9296
3380,明泰,15,0,15,凱基-頭份,2023-11-09,9296
3704,合勤控,16,1,15,凱基-頭份,2023-11-09,9296
8927,北基,15,0,15,凱基-頭份,2023-11-09,9296
2363,矽統,45,32,13,凱基-頭份,2023-11-09,9296
2313,華通,19,6,13,凱基-頭份,2023-11-09,9296
00715L,期街口布蘭特正2,12,0,12,凱基-頭份,2023-11-09,9296
2338,光罩,12,0,12,凱基-頭份,2023-11-09,9296
3041,揚智,15,3,12,凱基-頭份,2023-11-09,9296
2390,云辰,13,2,11,凱基-頭份,2023-11-09,9296
2462,良得電,12,1,11,凱基-頭份,2023-11-09,9296
3032,偉訓,31,20,11,凱基-頭份,2023-11-09,9296
1101,台泥,10,0,10,凱基-頭份,2023-11-09,9296
1762,中化生,10,0,10,凱基-頭份,2023-11-09,9296
2352,佳世達,11,1,10,凱基-頭份,2023-11-09,9296
3062,建漢,10,0,10,凱基-頭份,2023-11-09,9296
3491,昇達科,10,1,9,凱基-頭份,2023-11-09,9296
1305,華夏,8,0,8,凱基-頭份,2023-11-09,9296
2388,威盛,15,7,8,凱基-頭份,2023-11-09,9296
3088,艾訊,8,0,8,凱基-頭份,2023-11-09,9296
5309,系統電,8,0,8,凱基-頭份,2023-11-09,9296
4967,十銓,15,7,8,凱基-頭份,2023-11-09,9296
2888,新光金,10,3,7,凱基-頭份,2023-11-09,9296
1314,中石化,16,10,6,凱基-頭份,2023-11-09,9296
2421,建準,7,1,6,凱基-頭份,2023-11-09,9296
2520,冠德,6,0,6,凱基-頭份,2023-11-09,9296
6733,博晟生醫,6,0,6,凱基-頭份,2023-11-09,9296
8176,智捷,6,0,6,凱基-頭份,2023-11-09,9296
00720B,元大投資級公司債,7,2,5,凱基-頭份,2023-11-09,9296
00642U,期元大S＆P石油,5,0,5,凱基-頭份,2023-11-09,9296
1815,富喬,5,0,5,凱基-頭份,2023-11-09,9296
2406,國碩,5,0,5,凱基-頭份,2023-11-09,9296
2495,普安,5,0,5,凱基-頭份,2023-11-09,9296
2609,陽明,109,104,5,凱基-頭份,2023-11-09,9296
2617,台航,5,0,5,凱基-頭份,2023-11-09,9296
4167,松瑞藥,6,1,5,凱基-頭份,2023-11-09,9296
1308,亞聚,4,0,4,凱基-頭份,2023-11-09,9296
00891,中信關鍵半導體,4,0,4,凱基-頭份,2023-11-09,9296
1721,三晃,5,1,4,凱基-頭份,2023-11-09,9296
2344,華邦電,9,5,4,凱基-頭份,2023-11-09,9296
2303,聯電,4,0,4,凱基-頭份,2023-11-09,9296
2317,鴻海,5,2,3,凱基-頭份,2023-11-09,9296
00679B,元大美債20年,5,2,3,凱基-頭份,2023-11-09,9296
2363,矽統,265,22,243,凱基-頭份,2023-11-10,9296
00680L,元大美債20正2,57,0,57,凱基-頭份,2023-11-10,9296
2887,台新金,50,0,50,凱基-頭份,2023-11-10,9296
2387,精元,30,0,30,凱基-頭份,2023-11-10,9296
00885,富邦越南,18,0,18,凱基-頭份,2023-11-10,9296
6116,彩晶,18,0,18,凱基-頭份,2023-11-10,9296
4128,中天,22,4,18,凱基-頭份,2023-11-10,9296
00679B,元大美債20年,16,0,16,凱基-頭份,2023-11-10,9296
6197,佳必琪,15,0,15,凱基-頭份,2023-11-10,9296
00687B,國泰20年美債,15,1,14,凱基-頭份,2023-11-10,9296
5258,虹堡,18,4,14,凱基-頭份,2023-11-10,9296
2520,冠德,12,0,12,凱基-頭份,2023-11-10,9296
2313,華通,49,38,11,凱基-頭份,2023-11-10,9296
00929,復華台灣科技優息,14,4,10,凱基-頭份,2023-11-10,9296
00665L,富邦�琤肭磪囓�2,10,0,10,凱基-頭份,2023-11-10,9296
00720B,元大投資級公司債,10,0,10,凱基-頭份,2023-11-10,9296
2888,新光金,10,0,10,凱基-頭份,2023-11-10,9296
3041,揚智,12,2,10,凱基-頭份,2023-11-10,9296
2883,凱基金,10,1,9,凱基-頭份,2023-11-10,9296
3704,合勤控,10,1,9,凱基-頭份,2023-11-10,9296
1760,寶齡富錦,8,0,8,凱基-頭份,2023-11-10,9296
3710,連展投控,8,0,8,凱基-頭份,2023-11-10,9296
5386,青雲,8,0,8,凱基-頭份,2023-11-10,9296
2345,智邦,9,2,7,凱基-頭份,2023-11-10,9296
2409,友達,8,1,7,凱基-頭份,2023-11-10,9296
00751B,元大AAA至A公司債,6,0,6,凱基-頭份,2023-11-10,9296
2105,正新,6,0,6,凱基-頭份,2023-11-10,9296
6122,擎邦,10,4,6,凱基-頭份,2023-11-10,9296
00673R,期元大S＆P原油反1,5,0,5,凱基-頭份,2023-11-10,9296
00642U,期元大S＆P石油,5,0,5,凱基-頭份,2023-11-10,9296
00715L,期街口布蘭特正2,5,0,5,凱基-頭份,2023-11-10,9296
1815,富喬,7,2,5,凱基-頭份,2023-11-10,9296
2390,云辰,5,0,5,凱基-頭份,2023-11-10,9296
2417,圓剛,5,0,5,凱基-頭份,2023-11-10,9296
2516,新建,5,0,5,凱基-頭份,2023-11-10,9296
3312,弘憶股,5,0,5,凱基-頭份,2023-11-10,9296
3380,明泰,5,0,5,凱基-頭份,2023-11-10,9296
4563,百德,5,0,5,凱基-頭份,2023-11-10,9296
8926,台汽電,5,0,5,凱基-頭份,2023-11-10,9296
00919,群益台灣精選高息,5,0,5,凱基-頭份,2023-11-10,9296
6901,鑽石投資,11,6,5,凱基-頭份,2023-11-10,9296
2317,鴻海,5,0,5,凱基-頭份,2023-11-10,9296
1734,杏輝,4,0,4,凱基-頭份,2023-11-10,9296
2399,映泰,4,0,4,凱基-頭份,2023-11-10,9296
6291,沛亨,4,0,4,凱基-頭份,2023-11-10,9296
6770,力積電,4,0,4,凱基-頭份,2023-11-10,9296
2376,技嘉,6,3,3,凱基-頭份,2023-11-10,9296
1609,大亞,5,2,3,凱基-頭份,2023-11-10,9296
00690,兆豐藍籌30,3,0,3,凱基-頭份,2023-11-10,9296
1727,中華化,3,0,3,凱基-頭份,2023-11-10,9296
2317,鴻海,53,4,49,凱基-頭份,2023-11-13,9296
00931B,統一美債20年,48,0,48,凱基-頭份,2023-11-13,9296
2884,玉山金,25,0,25,凱基-頭份,2023-11-13,9296
00878,國泰永續高股息,35,10,25,凱基-頭份,2023-11-13,9296
4123,晟德,23,0,23,凱基-頭份,2023-11-13,9296
1513,中興電,24,4,20,凱基-頭份,2023-11-13,9296
00664R,國泰臺灣加權反1,20,0,20,凱基-頭份,2023-11-13,9296
00919,群益台灣精選高息,17,0,17,凱基-頭份,2023-11-13,9296
2618,長榮航,16,1,15,凱基-頭份,2023-11-13,9296
8429,金麗-KY,15,0,15,凱基-頭份,2023-11-13,9296
8940,新天地,15,1,14,凱基-頭份,2023-11-13,9296
2387,精元,14,2,12,凱基-頭份,2023-11-13,9296
00632R,元大台灣50反1,10,0,10,凱基-頭份,2023-11-13,9296
00679B,元大美債20年,10,0,10,凱基-頭份,2023-11-13,9296
3038,全台,10,0,10,凱基-頭份,2023-11-13,9296
4533,協易機,10,0,10,凱基-頭份,2023-11-13,9296
6290,良維,10,0,10,凱基-頭份,2023-11-13,9296
1762,中化生,10,1,9,凱基-頭份,2023-11-13,9296
2353,宏��,8,0,8,凱基-頭份,2023-11-13,9296
00687B,國泰20年美債,7,0,7,凱基-頭份,2023-11-13,9296
3710,連展投控,7,0,7,凱基-頭份,2023-11-13,9296
4938,和碩,7,0,7,凱基-頭份,2023-11-13,9296
2739,寒舍,7,1,6,凱基-頭份,2023-11-13,9296
6197,佳必琪,11,5,6,凱基-頭份,2023-11-13,9296
2345,智邦,6,1,5,凱基-頭份,2023-11-13,9296
2382,廣達,5,0,5,凱基-頭份,2023-11-13,9296
2358,廷鑫,5,0,5,凱基-頭份,2023-11-13,9296
2702,華園,5,0,5,凱基-頭份,2023-11-13,9296
6182,合晶,5,0,5,凱基-頭份,2023-11-13,9296
8112,至上,5,0,5,凱基-頭份,2023-11-13,9296
2885,元大金,6,1,5,凱基-頭份,2023-11-13,9296
00795B,中信美國公債20年,4,0,4,凱基-頭份,2023-11-13,9296
00751B,元大AAA至A公司債,4,0,4,凱基-頭份,2023-11-13,9296
00720B,元大投資級公司債,4,0,4,凱基-頭份,2023-11-13,9296
2377,微星,4,0,4,凱基-頭份,2023-11-13,9296
2462,良得電,4,0,4,凱基-頭份,2023-11-13,9296
3088,艾訊,5,1,4,凱基-頭份,2023-11-13,9296
5880,合庫金,4,0,4,凱基-頭份,2023-11-13,9296
8358,金居,6,2,4,凱基-頭份,2023-11-13,9296
4128,中天,6,2,4,凱基-頭份,2023-11-13,9296
1909,榮成,3,0,3,凱基-頭份,2023-11-13,9296
2363,矽統,17,14,3,凱基-頭份,2023-11-13,9296
2417,圓剛,8,5,3,凱基-頭份,2023-11-13,9296
3583,辛耘,4,1,3,凱基-頭份,2023-11-13,9296
5328,華容,3,0,3,凱基-頭份,2023-11-13,9296
6282,康舒,4,1,3,凱基-頭份,2023-11-13,9296
6531,愛普*,5,2,3,凱基-頭份,2023-11-13,9296
6770,力積電,3,0,3,凱基-頭份,2023-11-13,9296
0056,元大高股息,3,0,3,凱基-頭份,2023-11-13,9296
4763,材料-KY,2,0,2,凱基-頭份,2023-11-13,9296
00632R,元大台灣50反1,92,0,92,凱基-頭份,2023-11-14,9296
2618,長榮航,53,8,45,凱基-頭份,2023-11-14,9296
00715L,期街口布蘭特正2,38,2,36,凱基-頭份,2023-11-14,9296
00919,群益台灣精選高息,33,0,33,凱基-頭份,2023-11-14,9296
2883,凱基金,27,0,27,凱基-頭份,2023-11-14,9296
6118,建達,21,0,21,凱基-頭份,2023-11-14,9296
6901,鑽石投資,23,6,17,凱基-頭份,2023-11-14,9296
1313,聯成,12,0,12,凱基-頭份,2023-11-14,9296
2888,新光金,15,3,12,凱基-頭份,2023-11-14,9296
2515,中工,11,0,11,凱基-頭份,2023-11-14,9296
00890B,凱基ESG BBB債,10,0,10,凱基-頭份,2023-11-14,9296
1612,宏泰,10,0,10,凱基-頭份,2023-11-14,9296
2369,菱生,11,1,10,凱基-頭份,2023-11-14,9296
8110,華東,10,0,10,凱基-頭份,2023-11-14,9296
1584,精剛,10,1,9,凱基-頭份,2023-11-14,9296
3231,緯創,13,4,9,凱基-頭份,2023-11-14,9296
2377,微星,8,0,8,凱基-頭份,2023-11-14,9296
2363,矽統,46,38,8,凱基-頭份,2023-11-14,9296
2395,研華,7,0,7,凱基-頭份,2023-11-14,9296
2401,凌陽,7,0,7,凱基-頭份,2023-11-14,9296
3041,揚智,12,5,7,凱基-頭份,2023-11-14,9296
6116,彩晶,7,0,7,凱基-頭份,2023-11-14,9296
1609,大亞,6,0,6,凱基-頭份,2023-11-14,9296
2025,千興,6,0,6,凱基-頭份,2023-11-14,9296
2347,聯強,6,0,6,凱基-頭份,2023-11-14,9296
4123,晟德,6,0,6,凱基-頭份,2023-11-14,9296
0056,元大高股息,15,9,6,凱基-頭份,2023-11-14,9296
2886,兆豐金,5,0,5,凱基-頭份,2023-11-14,9296
2002,中鋼,5,0,5,凱基-頭份,2023-11-14,9296
2065,世豐,5,0,5,凱基-頭份,2023-11-14,9296
2345,智邦,5,0,5,凱基-頭份,2023-11-14,9296
2606,裕民,5,0,5,凱基-頭份,2023-11-14,9296
3689,湧德,5,0,5,凱基-頭份,2023-11-14,9296
4908,前鼎,6,1,5,凱基-頭份,2023-11-14,9296
9921,巨大,5,0,5,凱基-頭份,2023-11-14,9296
00712,復華富時不動產,6,2,4,凱基-頭份,2023-11-14,9296
9927,泰銘,6,2,4,凱基-頭份,2023-11-14,9296
1568,倉佑,6,2,4,凱基-頭份,2023-11-14,9296
2462,良得電,4,0,4,凱基-頭份,2023-11-14,9296
3169,亞信,5,1,4,凱基-頭份,2023-11-14,9296
8429,金麗-KY,4,0,4,凱基-頭份,2023-11-14,9296
00900,富邦特選高股息30,3,0,3,凱基-頭份,2023-11-14,9296
1514,亞力,3,0,3,凱基-頭份,2023-11-14,9296
00679B,元大美債20年,3,0,3,凱基-頭份,2023-11-14,9296
1524,耿鼎,3,0,3,凱基-頭份,2023-11-14,9296
2303,聯電,3,0,3,凱基-頭份,2023-11-14,9296
2355,敬鵬,3,0,3,凱基-頭份,2023-11-14,9296
2634,漢翔,3,0,3,凱基-頭份,2023-11-14,9296
2637,慧洋-KY,3,0,3,凱基-頭份,2023-11-14,9296
2743,山富,4,1,3,凱基-頭份,2023-11-14,9296
00919,群益台灣精選高息,117,2,115,凱基-頭份,2023-11-15,9296
00632R,元大台灣50反1,115,0,115,凱基-頭份,2023-11-15,9296
00712,復華富時不動產,104,17,87,凱基-頭份,2023-11-15,9296
00878,國泰永續高股息,118,68,50,凱基-頭份,2023-11-15,9296
00929,復華台灣科技優息,66,23,43,凱基-頭份,2023-11-15,9296
1721,三晃,24,2,22,凱基-頭份,2023-11-15,9296
2324,仁寶,22,0,22,凱基-頭份,2023-11-15,9296
00664R,國泰臺灣加權反1,20,0,20,凱基-頭份,2023-11-15,9296
2356,英業達,20,1,19,凱基-頭份,2023-11-15,9296
6456,GIS-KY,20,5,15,凱基-頭份,2023-11-15,9296
00679B,元大美債20年,17,2,15,凱基-頭份,2023-11-15,9296
5521,工信,12,0,12,凱基-頭份,2023-11-15,9296
2449,京元電子,151,140,11,凱基-頭份,2023-11-15,9296
8110,華東,11,0,11,凱基-頭份,2023-11-15,9296
00922,國泰台灣領袖50,10,0,10,凱基-頭份,2023-11-15,9296
00924,復華S＆P500成長,10,0,10,凱基-頭份,2023-11-15,9296
4533,協易機,10,0,10,凱基-頭份,2023-11-15,9296
4933,友輝,10,0,10,凱基-頭份,2023-11-15,9296
5225,東科-KY,11,1,10,凱基-頭份,2023-11-15,9296
6672,騰輝電子-KY,10,0,10,凱基-頭份,2023-11-15,9296
4183,福永生技,8,0,8,凱基-頭份,2023-11-15,9296
2465,麗臺,10,3,7,凱基-頭份,2023-11-15,9296
2353,宏��,7,0,7,凱基-頭份,2023-11-15,9296
6104,創惟,11,4,7,凱基-頭份,2023-11-15,9296
00895,富邦未來車,10,4,6,凱基-頭份,2023-11-15,9296
1731,美吾華,6,0,6,凱基-頭份,2023-11-15,9296
2337,旺宏,6,0,6,凱基-頭份,2023-11-15,9296
3588,通嘉,8,2,6,凱基-頭份,2023-11-15,9296
8112,至上,6,0,6,凱基-頭份,2023-11-15,9296
3545,敦泰,7,1,6,凱基-頭份,2023-11-15,9296
1605,華新,11,6,5,凱基-頭份,2023-11-15,9296
00720B,元大投資級公司債,5,0,5,凱基-頭份,2023-11-15,9296
1524,耿鼎,8,3,5,凱基-頭份,2023-11-15,9296
2243,宏旭-KY,6,1,5,凱基-頭份,2023-11-15,9296
2493,揚博,5,0,5,凱基-頭份,2023-11-15,9296
2505,國揚,5,0,5,凱基-頭份,2023-11-15,9296
2543,皇昌,5,0,5,凱基-頭份,2023-11-15,9296
3035,智原,5,0,5,凱基-頭份,2023-11-15,9296
4563,百德,5,0,5,凱基-頭份,2023-11-15,9296
4967,十銓,17,12,5,凱基-頭份,2023-11-15,9296
8011,台通,5,0,5,凱基-頭份,2023-11-15,9296
2357,華碩,4,0,4,凱基-頭份,2023-11-15,9296
3094,聯傑,4,0,4,凱基-頭份,2023-11-15,9296
6266,泰詠,4,0,4,凱基-頭份,2023-11-15,9296
2317,鴻海,8,5,3,凱基-頭份,2023-11-15,9296
2348,海悅,3,0,3,凱基-頭份,2023-11-15,9296
3006,晶豪科,195,192,3,凱基-頭份,2023-11-15,9296
00936,台新永續高息中小,3,0,3,凱基-頭份,2023-11-15,9296
00885,富邦越南,5,2,3,凱基-頭份,2023-11-15,9296
1540,喬福,3,0,3,凱基-頭份,2023-11-15,9296
00637L,元大滬深300正2,65,1,64,凱基-頭份,2023-11-16,9296
00680L,元大美債20正2,50,0,50,凱基-頭份,2023-11-16,9296
3149,正達,90,46,44,凱基-頭份,2023-11-16,9296
00679B,元大美債20年,39,0,39,凱基-頭份,2023-11-16,9296
00712,復華富時不動產,50,12,38,凱基-頭份,2023-11-16,9296
00878,國泰永續高股息,36,0,36,凱基-頭份,2023-11-16,9296
00921,兆豐龍頭等權重,29,0,29,凱基-頭份,2023-11-16,9296
3147,大綜,26,1,25,凱基-頭份,2023-11-16,9296
2374,佳能,22,0,22,凱基-頭份,2023-11-16,9296
00857B,永豐20年美公債,20,0,20,凱基-頭份,2023-11-16,9296
2736,富野,13,0,13,凱基-頭份,2023-11-16,9296
6282,康舒,12,0,12,凱基-頭份,2023-11-16,9296
00895,富邦未來車,10,0,10,凱基-頭份,2023-11-16,9296
1609,大亞,10,0,10,凱基-頭份,2023-11-16,9296
1618,合機,13,3,10,凱基-頭份,2023-11-16,9296
1721,三晃,10,0,10,凱基-頭份,2023-11-16,9296
2358,廷鑫,10,0,10,凱基-頭份,2023-11-16,9296
8234,新漢,10,0,10,凱基-頭份,2023-11-16,9296
00632R,元大台灣50反1,7,0,7,凱基-頭份,2023-11-16,9296
00935,野村臺灣新科技50,7,0,7,凱基-頭份,2023-11-16,9296
00933B,國泰10Y+金融債,7,0,7,凱基-頭份,2023-11-16,9296
00715L,期街口布蘭特正2,7,0,7,凱基-頭份,2023-11-16,9296
2610,華航,10,3,7,凱基-頭份,2023-11-16,9296
4967,十銓,24,18,6,凱基-頭份,2023-11-16,9296
6799,來頡,6,0,6,凱基-頭份,2023-11-16,9296
00753L,中信中國50正2,5,0,5,凱基-頭份,2023-11-16,9296
00890B,凱基ESG BBB債,5,0,5,凱基-頭份,2023-11-16,9296
1584,精剛,5,0,5,凱基-頭份,2023-11-16,9296
1605,華新,5,0,5,凱基-頭份,2023-11-16,9296
2345,智邦,9,4,5,凱基-頭份,2023-11-16,9296
3088,艾訊,5,0,5,凱基-頭份,2023-11-16,9296
3545,敦泰,5,0,5,凱基-頭份,2023-11-16,9296
4183,福永生技,5,0,5,凱基-頭份,2023-11-16,9296
6451,訊芯-KY,9,4,5,凱基-頭份,2023-11-16,9296
9904,寶成,5,0,5,凱基-頭份,2023-11-16,9296
00936,台新永續高息中小,4,0,4,凱基-頭份,2023-11-16,9296
00885,富邦越南,5,1,4,凱基-頭份,2023-11-16,9296
2303,聯電,4,0,4,凱基-頭份,2023-11-16,9296
2348,海悅,4,0,4,凱基-頭份,2023-11-16,9296
2356,英業達,11,7,4,凱基-頭份,2023-11-16,9296
3094,聯傑,4,0,4,凱基-頭份,2023-11-16,9296
3169,亞信,6,2,4,凱基-頭份,2023-11-16,9296
3615,安可,4,0,4,凱基-頭份,2023-11-16,9296
8213,志超,4,0,4,凱基-頭份,2023-11-16,9296
00795B,中信美國公債20年,3,0,3,凱基-頭份,2023-11-16,9296
1101,台泥,3,0,3,凱基-頭份,2023-11-16,9296
00891,中信關鍵半導體,3,0,3,凱基-頭份,2023-11-16,9296
00913,兆豐台灣晶圓製造,3,0,3,凱基-頭份,2023-11-16,9296
2421,建準,5,2,3,凱基-頭份,2023-11-16,9296
2498,宏達電,3,0,3,凱基-頭份,2023-11-16,9296
00929,復華台灣科技優息,258,82,176,凱基-頭份,2023-11-17,9296
00632R,元大台灣50反1,134,0,134,凱基-頭份,2023-11-17,9296
6282,康舒,29,0,29,凱基-頭份,2023-11-17,9296
1736,喬山,24,0,24,凱基-頭份,2023-11-17,9296
00637L,元大滬深300正2,21,0,21,凱基-頭份,2023-11-17,9296
2371,大同,22,2,20,凱基-頭份,2023-11-17,9296
2353,宏��,14,0,14,凱基-頭份,2023-11-17,9296
4157,太景*-KY,13,0,13,凱基-頭份,2023-11-17,9296
00900,富邦特選高股息30,13,1,12,凱基-頭份,2023-11-17,9296
2356,英業達,23,12,11,凱基-頭份,2023-11-17,9296
2610,華航,11,0,11,凱基-頭份,2023-11-17,9296
00642U,期元大S＆P石油,10,0,10,凱基-頭份,2023-11-17,9296
00664R,國泰臺灣加權反1,10,0,10,凱基-頭份,2023-11-17,9296
00936,台新永續高息中小,10,0,10,凱基-頭份,2023-11-17,9296
1312,國喬,10,0,10,凱基-頭份,2023-11-17,9296
1802,台玻,10,0,10,凱基-頭份,2023-11-17,9296
2515,中工,10,0,10,凱基-頭份,2023-11-17,9296
2888,新光金,10,0,10,凱基-頭份,2023-11-17,9296
4720,德淵,10,0,10,凱基-頭份,2023-11-17,9296
6456,GIS-KY,10,0,10,凱基-頭份,2023-11-17,9296
8111,立��,10,0,10,凱基-頭份,2023-11-17,9296
00933B,國泰10Y+金融債,10,0,10,凱基-頭份,2023-11-17,9296
2417,圓剛,9,0,9,凱基-頭份,2023-11-17,9296
8213,志超,8,0,8,凱基-頭份,2023-11-17,9296
2605,新興,7,0,7,凱基-頭份,2023-11-17,9296
5425,台半,7,0,7,凱基-頭份,2023-11-17,9296
3041,揚智,88,82,6,凱基-頭份,2023-11-17,9296
00671R,富邦NASDAQ反1,5,0,5,凱基-頭份,2023-11-17,9296
00934,中信成長高股息,5,0,5,凱基-頭份,2023-11-17,9296
00930,永豐ESG低碳高息,5,0,5,凱基-頭份,2023-11-17,9296
00902,中信電池及儲能,5,0,5,凱基-頭份,2023-11-17,9296
2328,廣宇,5,0,5,凱基-頭份,2023-11-17,9296
2329,華泰,10,5,5,凱基-頭份,2023-11-17,9296
4934,太極,5,0,5,凱基-頭份,2023-11-17,9296
5344,立衛,6,1,5,凱基-頭份,2023-11-17,9296
6104,創惟,5,0,5,凱基-頭份,2023-11-17,9296
8936,國統,12,7,5,凱基-頭份,2023-11-17,9296
00919,群益台灣精選高息,4,0,4,凱基-頭份,2023-11-17,9296
1503,士電,4,0,4,凱基-頭份,2023-11-17,9296
1609,大亞,5,1,4,凱基-頭份,2023-11-17,9296
2367,燿華,4,0,4,凱基-頭份,2023-11-17,9296
2462,良得電,4,0,4,凱基-頭份,2023-11-17,9296
8112,至上,6,2,4,凱基-頭份,2023-11-17,9296
1504,東元,4,1,3,凱基-頭份,2023-11-17,9296
1815,富喬,5,2,3,凱基-頭份,2023-11-17,9296
2498,宏達電,3,0,3,凱基-頭份,2023-11-17,9296
3260,威剛,3,0,3,凱基-頭份,2023-11-17,9296
3576,聯合再生,3,0,3,凱基-頭份,2023-11-17,9296
4945,陞達科技,5,2,3,凱基-頭份,2023-11-17,9296
5258,虹堡,3,0,3,凱基-頭份,2023-11-17,9296
2363,矽統,230,5,225,凱基-頭份,2023-11-20,9296
2344,華邦電,97,3,94,凱基-頭份,2023-11-20,9296
5864,致和證,34,0,34,凱基-頭份,2023-11-20,9296
1736,喬山,32,0,32,凱基-頭份,2023-11-20,9296
00900,富邦特選高股息30,28,1,27,凱基-頭份,2023-11-20,9296
2353,宏��,23,0,23,凱基-頭份,2023-11-20,9296
00936,台新永續高息中小,20,0,20,凱基-頭份,2023-11-20,9296
00680L,元大美債20正2,70,50,20,凱基-頭份,2023-11-20,9296
2887,台新金,20,0,20,凱基-頭份,2023-11-20,9296
5903,全家,15,0,15,凱基-頭份,2023-11-20,9296
00690,兆豐藍籌30,14,0,14,凱基-頭份,2023-11-20,9296
00931B,統一美債20年,11,0,11,凱基-頭份,2023-11-20,9296
3078,僑威,11,0,11,凱基-頭份,2023-11-20,9296
1326,台化,10,0,10,凱基-頭份,2023-11-20,9296
1720,生達,10,0,10,凱基-頭份,2023-11-20,9296
2493,揚博,10,0,10,凱基-頭份,2023-11-20,9296
00933B,國泰10Y+金融債,9,0,9,凱基-頭份,2023-11-20,9296
0056,元大高股息,22,13,9,凱基-頭份,2023-11-20,9296
2543,皇昌,11,2,9,凱基-頭份,2023-11-20,9296
2801,彰銀,10,1,9,凱基-頭份,2023-11-20,9296
8111,立��,10,1,9,凱基-頭份,2023-11-20,9296
00885,富邦越南,8,0,8,凱基-頭份,2023-11-20,9296
6770,力積電,12,4,8,凱基-頭份,2023-11-20,9296
2355,敬鵬,7,0,7,凱基-頭份,2023-11-20,9296
8213,志超,7,0,7,凱基-頭份,2023-11-20,9296
2356,英業達,17,11,6,凱基-頭份,2023-11-20,9296
3094,聯傑,7,1,6,凱基-頭份,2023-11-20,9296
3706,神達,12,6,6,凱基-頭份,2023-11-20,9296
5009,榮剛,8,2,6,凱基-頭份,2023-11-20,9296
6108,競國,6,0,6,凱基-頭份,2023-11-20,9296
1104,環泥,5,0,5,凱基-頭份,2023-11-20,9296
2314,台揚,5,0,5,凱基-頭份,2023-11-20,9296
2505,國揚,5,0,5,凱基-頭份,2023-11-20,9296
3013,晟銘電,5,0,5,凱基-頭份,2023-11-20,9296
3036,文曄,6,1,5,凱基-頭份,2023-11-20,9296
3147,大綜,5,0,5,凱基-頭份,2023-11-20,9296
3645,達邁,5,0,5,凱基-頭份,2023-11-20,9296
4934,太極,15,10,5,凱基-頭份,2023-11-20,9296
5512,力麒,5,0,5,凱基-頭份,2023-11-20,9296
6799,來頡,5,0,5,凱基-頭份,2023-11-20,9296
2492,華新科,4,0,4,凱基-頭份,2023-11-20,9296
2610,華航,5,1,4,凱基-頭份,2023-11-20,9296
6235,華孚,4,0,4,凱基-頭份,2023-11-20,9296
6462,神盾,4,0,4,凱基-頭份,2023-11-20,9296
6589,台康生技,4,0,4,凱基-頭份,2023-11-20,9296
2449,京元電子,134,130,4,凱基-頭份,2023-11-20,9296
3228,金麗科,3,0,3,凱基-頭份,2023-11-20,9296
00934,中信成長高股息,3,0,3,凱基-頭份,2023-11-20,9296
2347,聯強,3,0,3,凱基-頭份,2023-11-20,9296
2417,圓剛,4,1,3,凱基-頭份,2023-11-20,9296
00632R,元大台灣50反1,310,0,310,凱基-頭份,2023-11-21,9296
2537,聯上發,80,0,80,凱基-頭份,2023-11-21,9296
00929,復華台灣科技優息,82,26,56,凱基-頭份,2023-11-21,9296
1616,億泰,47,0,47,凱基-頭份,2023-11-21,9296
00664R,國泰臺灣加權反1,40,0,40,凱基-頭份,2023-11-21,9296
00934,中信成長高股息,34,0,34,凱基-頭份,2023-11-21,9296
0056,元大高股息,31,4,27,凱基-頭份,2023-11-21,9296
2363,矽統,40,18,22,凱基-頭份,2023-11-21,9296
5347,世界,162,141,21,凱基-頭份,2023-11-21,9296
6125,廣運,27,7,20,凱基-頭份,2023-11-21,9296
6104,創惟,16,0,16,凱基-頭份,2023-11-21,9296
3707,漢磊,16,1,15,凱基-頭份,2023-11-21,9296
00679B,元大美債20年,15,0,15,凱基-頭份,2023-11-21,9296
3032,偉訓,13,0,13,凱基-頭份,2023-11-21,9296
2618,長榮航,12,2,10,凱基-頭份,2023-11-21,9296
00671R,富邦NASDAQ反1,10,0,10,凱基-頭份,2023-11-21,9296
00895,富邦未來車,10,0,10,凱基-頭份,2023-11-21,9296
2527,宏璟,20,10,10,凱基-頭份,2023-11-21,9296
5521,工信,10,0,10,凱基-頭份,2023-11-21,9296
9933,中鼎,10,0,10,凱基-頭份,2023-11-21,9296
1736,喬山,9,0,9,凱基-頭份,2023-11-21,9296
2344,華邦電,17,8,9,凱基-頭份,2023-11-21,9296
2390,云辰,10,1,9,凱基-頭份,2023-11-21,9296
2355,敬鵬,10,2,8,凱基-頭份,2023-11-21,9296
6111,大宇資,8,0,8,凱基-頭份,2023-11-21,9296
6168,宏齊,7,0,7,凱基-頭份,2023-11-21,9296
6901,鑽石投資,7,0,7,凱基-頭份,2023-11-21,9296
8213,志超,7,0,7,凱基-頭份,2023-11-21,9296
1101,台泥,10,4,6,凱基-頭份,2023-11-21,9296
1524,耿鼎,6,0,6,凱基-頭份,2023-11-21,9296
3231,緯創,18,13,5,凱基-頭份,2023-11-21,9296
00933B,國泰10Y+金融債,5,0,5,凱基-頭份,2023-11-21,9296
00928,中信上櫃ESG30,5,0,5,凱基-頭份,2023-11-21,9296
1721,三晃,6,1,5,凱基-頭份,2023-11-21,9296
2516,新建,5,0,5,凱基-頭份,2023-11-21,9296
4720,德淵,5,0,5,凱基-頭份,2023-11-21,9296
6148,驊宏資,5,0,5,凱基-頭份,2023-11-21,9296
6189,豐藝,5,0,5,凱基-頭份,2023-11-21,9296
6197,佳必琪,5,0,5,凱基-頭份,2023-11-21,9296
6275,元山,5,0,5,凱基-頭份,2023-11-21,9296
8021,尖點,5,0,5,凱基-頭份,2023-11-21,9296
8358,金居,5,0,5,凱基-頭份,2023-11-21,9296
2367,燿華,10,6,4,凱基-頭份,2023-11-21,9296
2888,新光金,9,5,4,凱基-頭份,2023-11-21,9296
3105,穩懋,4,0,4,凱基-頭份,2023-11-21,9296
6603,富強鑫,4,0,4,凱基-頭份,2023-11-21,9296
8069,元太,4,0,4,凱基-頭份,2023-11-21,9296
2313,華通,7,3,4,凱基-頭份,2023-11-21,9296
2204,中華,3,0,3,凱基-頭份,2023-11-21,9296
1504,東元,3,0,3,凱基-頭份,2023-11-21,9296
5533,皇鼎,28,0,28,凱基-頭份,2023-11-22,9296
1762,中化生,25,0,25,凱基-頭份,2023-11-22,9296
00637L,元大滬深300正2,24,0,24,凱基-頭份,2023-11-22,9296
3090,日電貿,23,0,23,凱基-頭份,2023-11-22,9296
00679B,元大美債20年,21,0,21,凱基-頭份,2023-11-22,9296
2537,聯上發,20,0,20,凱基-頭份,2023-11-22,9296
3710,連展投控,20,0,20,凱基-頭份,2023-11-22,9296
911608,明輝-DR,20,0,20,凱基-頭份,2023-11-22,9296
2356,英業達,33,14,19,凱基-頭份,2023-11-22,9296
00931B,統一美債20年,17,0,17,凱基-頭份,2023-11-22,9296
00919,群益台灣精選高息,16,0,16,凱基-頭份,2023-11-22,9296
2353,宏��,14,0,14,凱基-頭份,2023-11-22,9296
00934,中信成長高股息,12,0,12,凱基-頭份,2023-11-22,9296
2401,凌陽,13,1,12,凱基-頭份,2023-11-22,9296
3285,微端,12,0,12,凱基-頭份,2023-11-22,9296
3289,宜特,12,0,12,凱基-頭份,2023-11-22,9296
3491,昇達科,13,1,12,凱基-頭份,2023-11-22,9296
3521,鴻翊,12,0,12,凱基-頭份,2023-11-22,9296
6104,創惟,17,5,12,凱基-頭份,2023-11-22,9296
00936,台新永續高息中小,11,0,11,凱基-頭份,2023-11-22,9296
00795B,中信美國公債20年,11,0,11,凱基-頭份,2023-11-22,9296
2376,技嘉,11,0,11,凱基-頭份,2023-11-22,9296
00753L,中信中國50正2,10,0,10,凱基-頭份,2023-11-22,9296
00898,國泰基因免疫革命,10,0,10,凱基-頭份,2023-11-22,9296
2349,錸德,10,0,10,凱基-頭份,2023-11-22,9296
2801,彰銀,10,0,10,凱基-頭份,2023-11-22,9296
6558,興能高,11,1,10,凱基-頭份,2023-11-22,9296
5351,鈺創,17,8,9,凱基-頭份,2023-11-22,9296
00923,群益台ESG低碳50,10,1,9,凱基-頭份,2023-11-22,9296
2344,華邦電,13,4,9,凱基-頭份,2023-11-22,9296
1736,喬山,12,4,8,凱基-頭份,2023-11-22,9296
3231,緯創,20,12,8,凱基-頭份,2023-11-22,9296
1504,東元,8,1,7,凱基-頭份,2023-11-22,9296
2425,承啟,7,0,7,凱基-頭份,2023-11-22,9296
00720B,元大投資級公司債,6,0,6,凱基-頭份,2023-11-22,9296
2002,中鋼,13,7,6,凱基-頭份,2023-11-22,9296
2023,燁輝,6,0,6,凱基-頭份,2023-11-22,9296
2105,正新,6,0,6,凱基-頭份,2023-11-22,9296
3706,神達,6,0,6,凱基-頭份,2023-11-22,9296
00933B,國泰10Y+金融債,6,0,6,凱基-頭份,2023-11-22,9296
00878,國泰永續高股息,6,0,6,凱基-頭份,2023-11-22,9296
2449,京元電子,7,2,5,凱基-頭份,2023-11-22,9296
2881,富邦金,5,0,5,凱基-頭份,2023-11-22,9296
6488,環球晶,5,0,5,凱基-頭份,2023-11-22,9296
00915,凱基優選高股息30,5,0,5,凱基-頭份,2023-11-22,9296
00890B,凱基ESG BBB債,5,0,5,凱基-頭份,2023-11-22,9296
00751B,元大AAA至A公司債,5,0,5,凱基-頭份,2023-11-22,9296
1524,耿鼎,5,0,5,凱基-頭份,2023-11-22,9296
2515,中工,5,0,5,凱基-頭份,2023-11-22,9296
2884,玉山金,13,8,5,凱基-頭份,2023-11-22,9296
911608,明輝-DR,291,0,291,凱基-頭份,2023-11-23,9296
00933B,國泰10Y+金融債,137,0,137,凱基-頭份,2023-11-23,9296
2838,聯邦銀,50,0,50,凱基-頭份,2023-11-23,9296
00637L,元大滬深300正2,41,0,41,凱基-頭份,2023-11-23,9296
00923,群益台ESG低碳50,33,1,32,凱基-頭份,2023-11-23,9296
2516,新建,30,0,30,凱基-頭份,2023-11-23,9296
2537,聯上發,29,0,29,凱基-頭份,2023-11-23,9296
2303,聯電,22,0,22,凱基-頭份,2023-11-23,9296
00929,復華台灣科技優息,40,21,19,凱基-頭份,2023-11-23,9296
1612,宏泰,18,0,18,凱基-頭份,2023-11-23,9296
2201,裕隆,19,2,17,凱基-頭份,2023-11-23,9296
5512,力麒,15,0,15,凱基-頭份,2023-11-23,9296
6282,康舒,48,34,14,凱基-頭份,2023-11-23,9296
2801,彰銀,13,0,13,凱基-頭份,2023-11-23,9296
2493,揚博,12,0,12,凱基-頭份,2023-11-23,9296
3078,僑威,43,31,12,凱基-頭份,2023-11-23,9296
2345,智邦,12,0,12,凱基-頭份,2023-11-23,9296
6901,鑽石投資,13,2,11,凱基-頭份,2023-11-23,9296
2352,佳世達,11,1,10,凱基-頭份,2023-11-23,9296
2913,農林,10,0,10,凱基-頭份,2023-11-23,9296
8011,台通,10,0,10,凱基-頭份,2023-11-23,9296
1609,大亞,10,1,9,凱基-頭份,2023-11-23,9296
3032,偉訓,38,29,9,凱基-頭份,2023-11-23,9296
3231,緯創,16,8,8,凱基-頭份,2023-11-23,9296
8227,巨有科技,10,2,8,凱基-頭份,2023-11-23,9296
9904,寶成,8,0,8,凱基-頭份,2023-11-23,9296
2455,全新,10,3,7,凱基-頭份,2023-11-23,9296
2476,鉅祥,13,6,7,凱基-頭份,2023-11-23,9296
3715,定穎投控,17,10,7,凱基-頭份,2023-11-23,9296
2891,中信金,6,0,6,凱基-頭份,2023-11-23,9296
3669,圓展,7,1,6,凱基-頭份,2023-11-23,9296
5465,富驊,7,1,6,凱基-頭份,2023-11-23,9296
2883,凱基金,5,0,5,凱基-頭份,2023-11-23,9296
00905,FT臺灣Smart,5,0,5,凱基-頭份,2023-11-23,9296
2007,燁興,5,0,5,凱基-頭份,2023-11-23,9296
2402,毅嘉,9,4,5,凱基-頭份,2023-11-23,9296
2702,華園,5,0,5,凱基-頭份,2023-11-23,9296
2812,台中銀,5,0,5,凱基-頭份,2023-11-23,9296
3481,群創,8,3,5,凱基-頭份,2023-11-23,9296
0056,元大高股息,4,0,4,凱基-頭份,2023-11-23,9296
2367,燿華,4,0,4,凱基-頭份,2023-11-23,9296
3055,蔚華科,4,0,4,凱基-頭份,2023-11-23,9296
6462,神盾,4,0,4,凱基-頭份,2023-11-23,9296
6530,創威,8,4,4,凱基-頭份,2023-11-23,9296
8054,安國,16,12,4,凱基-頭份,2023-11-23,9296
5236,凌陽創新,3,0,3,凱基-頭份,2023-11-23,9296
1101,台泥,3,0,3,凱基-頭份,2023-11-23,9296
00633L,富邦上証正2,3,0,3,凱基-頭份,2023-11-23,9296
00715L,期街口布蘭特正2,3,0,3,凱基-頭份,2023-11-23,9296
2344,華邦電,9,6,3,凱基-頭份,2023-11-23,9296
00679B,元大美債20年,45,0,45,凱基-頭份,2023-11-24,9296
2838,聯邦銀,45,0,45,凱基-頭份,2023-11-24,9296
3032,偉訓,26,0,26,凱基-頭份,2023-11-24,9296
00929,復華台灣科技優息,30,10,20,凱基-頭份,2023-11-24,9296
2618,長榮航,24,5,19,凱基-頭份,2023-11-24,9296
3006,晶豪科,136,121,15,凱基-頭份,2023-11-24,9296
3024,憶聲,15,0,15,凱基-頭份,2023-11-24,9296
5351,鈺創,27,13,14,凱基-頭份,2023-11-24,9296
3710,連展投控,13,0,13,凱基-頭份,2023-11-24,9296
6901,鑽石投資,18,7,11,凱基-頭份,2023-11-24,9296
00632R,元大台灣50反1,10,0,10,凱基-頭份,2023-11-24,9296
00905,FT臺灣Smart,10,0,10,凱基-頭份,2023-11-24,9296
2390,云辰,10,0,10,凱基-頭份,2023-11-24,9296
2498,宏達電,10,0,10,凱基-頭份,2023-11-24,9296
3325,旭品,17,7,10,凱基-頭份,2023-11-24,9296
5309,系統電,10,0,10,凱基-頭份,2023-11-24,9296
1316,上曜,9,0,9,凱基-頭份,2023-11-24,9296
2344,華邦電,18,10,8,凱基-頭份,2023-11-24,9296
2002,中鋼,42,35,7,凱基-頭份,2023-11-24,9296
2345,智邦,8,1,7,凱基-頭份,2023-11-24,9296
2515,中工,6,0,6,凱基-頭份,2023-11-24,9296
3521,鴻翊,6,0,6,凱基-頭份,2023-11-24,9296
6282,康舒,8,2,6,凱基-頭份,2023-11-24,9296
8033,雷虎,6,0,6,凱基-頭份,2023-11-24,9296
00935,野村臺灣新科技50,5,0,5,凱基-頭份,2023-11-24,9296
1104,環泥,5,0,5,凱基-頭份,2023-11-24,9296
3031,佰鴻,5,0,5,凱基-頭份,2023-11-24,9296
3088,艾訊,5,0,5,凱基-頭份,2023-11-24,9296
3234,光環,6,1,5,凱基-頭份,2023-11-24,9296
3437,榮創,8,3,5,凱基-頭份,2023-11-24,9296
5471,松翰,5,0,5,凱基-頭份,2023-11-24,9296
6186,新潤,5,0,5,凱基-頭份,2023-11-24,9296
6288,聯嘉,5,0,5,凱基-頭份,2023-11-24,9296
2449,京元電子,5,0,5,凱基-頭份,2023-11-24,9296
2323,中環,4,0,4,凱基-頭份,2023-11-24,9296
2392,正崴,5,1,4,凱基-頭份,2023-11-24,9296
3285,微端,4,0,4,凱基-頭份,2023-11-24,9296
3706,神達,7,3,4,凱基-頭份,2023-11-24,9296
6603,富強鑫,4,0,4,凱基-頭份,2023-11-24,9296
6695,芯鼎,5,1,4,凱基-頭份,2023-11-24,9296
1513,中興電,11,7,4,凱基-頭份,2023-11-24,9296
2382,廣達,3,0,3,凱基-頭份,2023-11-24,9296
1760,寶齡富錦,3,0,3,凱基-頭份,2023-11-24,9296
1795,美時,3,0,3,凱基-頭份,2023-11-24,9296
1815,富喬,3,0,3,凱基-頭份,2023-11-24,9296
2356,英業達,3,0,3,凱基-頭份,2023-11-24,9296
2367,燿華,3,0,3,凱基-頭份,2023-11-24,9296
2371,大同,3,0,3,凱基-頭份,2023-11-24,9296
2401,凌陽,4,1,3,凱基-頭份,2023-11-24,9296
3025,星通,9,6,3,凱基-頭份,2023-11-24,9296
2884,玉山金,45,0,45,凱基-頭份,2023-11-27,9296
5347,世界,256,215,41,凱基-頭份,2023-11-27,9296
00679B,元大美債20年,40,2,38,凱基-頭份,2023-11-27,9296
00931B,統一美債20年,34,0,34,凱基-頭份,2023-11-27,9296
1618,合機,30,0,30,凱基-頭份,2023-11-27,9296
00751B,元大AAA至A公司債,24,0,24,凱基-頭份,2023-11-27,9296
00637L,元大滬深300正2,21,0,21,凱基-頭份,2023-11-27,9296
4167,松瑞藥,42,21,21,凱基-頭份,2023-11-27,9296
00632R,元大台灣50反1,20,0,20,凱基-頭份,2023-11-27,9296
2883,凱基金,54,37,17,凱基-頭份,2023-11-27,9296
2457,飛宏,18,1,17,凱基-頭份,2023-11-27,9296
3231,緯創,23,8,15,凱基-頭份,2023-11-27,9296
00929,復華台灣科技優息,25,10,15,凱基-頭份,2023-11-27,9296
3706,神達,13,0,13,凱基-頭份,2023-11-27,9296
2801,彰銀,12,0,12,凱基-頭份,2023-11-27,9296
00648R,元大S＆P500反1,11,0,11,凱基-頭份,2023-11-27,9296
1605,華新,12,1,11,凱基-頭份,2023-11-27,9296
2495,普安,11,0,11,凱基-頭份,2023-11-27,9296
2303,聯電,21,10,11,凱基-頭份,2023-11-27,9296
3081,聯亞,10,0,10,凱基-頭份,2023-11-27,9296
00671R,富邦NASDAQ反1,10,0,10,凱基-頭份,2023-11-27,9296
00895,富邦未來車,10,0,10,凱基-頭份,2023-11-27,9296
2359,所羅門,10,0,10,凱基-頭份,2023-11-27,9296
2888,新光金,12,2,10,凱基-頭份,2023-11-27,9296
3088,艾訊,10,0,10,凱基-頭份,2023-11-27,9296
3583,辛耘,10,0,10,凱基-頭份,2023-11-27,9296
4746,台耀,11,1,10,凱基-頭份,2023-11-27,9296
1101,台泥,10,1,9,凱基-頭份,2023-11-27,9296
3094,聯傑,11,2,9,凱基-頭份,2023-11-27,9296
00680L,元大美債20正2,10,2,8,凱基-頭份,2023-11-27,9296
2606,裕民,14,6,8,凱基-頭份,2023-11-27,9296
6901,鑽石投資,9,1,8,凱基-頭份,2023-11-27,9296
2330,台積電,10,2,8,凱基-頭份,2023-11-27,9296
2345,智邦,10,3,7,凱基-頭份,2023-11-27,9296
1734,杏輝,7,0,7,凱基-頭份,2023-11-27,9296
5351,鈺創,12,6,6,凱基-頭份,2023-11-27,9296
2356,英業達,6,0,6,凱基-頭份,2023-11-27,9296
3289,宜特,6,0,6,凱基-頭份,2023-11-27,9296
8390,金益鼎,6,0,6,凱基-頭份,2023-11-27,9296
2344,華邦電,18,12,6,凱基-頭份,2023-11-27,9296
2317,鴻海,6,1,5,凱基-頭份,2023-11-27,9296
00922,國泰台灣領袖50,5,0,5,凱基-頭份,2023-11-27,9296
2547,日勝生,5,0,5,凱基-頭份,2023-11-27,9296
3694,海華,5,0,5,凱基-頭份,2023-11-27,9296
6122,擎邦,5,0,5,凱基-頭份,2023-11-27,9296
6202,盛群,5,0,5,凱基-頭份,2023-11-27,9296
9958,世紀鋼,6,1,5,凱基-頭份,2023-11-27,9296
2201,裕隆,4,0,4,凱基-頭份,2023-11-27,9296
2352,佳世達,4,0,4,凱基-頭份,2023-11-27,9296
2401,凌陽,9,5,4,凱基-頭份,2023-11-27,9296
2363,矽統,230,4,226,凱基-頭份,2023-11-28,9296
00632R,元大台灣50反1,127,3,124,凱基-頭份,2023-11-28,9296
1449,佳和,53,2,51,凱基-頭份,2023-11-28,9296
2801,彰銀,41,1,40,凱基-頭份,2023-11-28,9296
6770,力積電,56,25,31,凱基-頭份,2023-11-28,9296
00931B,統一美債20年,30,0,30,凱基-頭份,2023-11-28,9296
2637,慧洋-KY,30,0,30,凱基-頭份,2023-11-28,9296
5483,中美晶,21,0,21,凱基-頭份,2023-11-28,9296
00664R,國泰臺灣加權反1,20,0,20,凱基-頭份,2023-11-28,9296
1605,華新,24,4,20,凱基-頭份,2023-11-28,9296
2897,王道銀行,20,1,19,凱基-頭份,2023-11-28,9296
2014,中鴻,16,1,15,凱基-頭份,2023-11-28,9296
1732,毛寶,13,0,13,凱基-頭份,2023-11-28,9296
2313,華通,40,27,13,凱基-頭份,2023-11-28,9296
3402,漢科,13,0,13,凱基-頭份,2023-11-28,9296
1229,聯華,11,0,11,凱基-頭份,2023-11-28,9296
2884,玉山金,11,0,11,凱基-頭份,2023-11-28,9296
00637L,元大滬深300正2,10,0,10,凱基-頭份,2023-11-28,9296
00936,台新永續高息中小,10,0,10,凱基-頭份,2023-11-28,9296
6241,易通展,9,0,9,凱基-頭份,2023-11-28,9296
00919,群益台灣精選高息,8,0,8,凱基-頭份,2023-11-28,9296
00893,國泰智能電動車,10,2,8,凱基-頭份,2023-11-28,9296
0056,元大高股息,7,0,7,凱基-頭份,2023-11-28,9296
00934,中信成長高股息,7,0,7,凱基-頭份,2023-11-28,9296
2417,圓剛,7,0,7,凱基-頭份,2023-11-28,9296
6219,富旺,7,0,7,凱基-頭份,2023-11-28,9296
6237,驊訊,9,2,7,凱基-頭份,2023-11-28,9296
2617,台航,8,2,6,凱基-頭份,2023-11-28,9296
5351,鈺創,14,8,6,凱基-頭份,2023-11-28,9296
1515,力山,5,0,5,凱基-頭份,2023-11-28,9296
1718,中纖,5,0,5,凱基-頭份,2023-11-28,9296
3167,大量,5,0,5,凱基-頭份,2023-11-28,9296
3701,大眾控,5,0,5,凱基-頭份,2023-11-28,9296
6233,旺玖,5,0,5,凱基-頭份,2023-11-28,9296
8277,商丞,5,0,5,凱基-頭份,2023-11-28,9296
6104,創惟,5,0,5,凱基-頭份,2023-11-28,9296
1514,亞力,14,9,5,凱基-頭份,2023-11-28,9296
5347,世界,274,270,4,凱基-頭份,2023-11-28,9296
2383,台光電,6,2,4,凱基-頭份,2023-11-28,9296
1227,佳格,4,0,4,凱基-頭份,2023-11-28,9296
3017,奇鋐,5,1,4,凱基-頭份,2023-11-28,9296
3231,緯創,8,4,4,凱基-頭份,2023-11-28,9296
3576,聯合再生,4,0,4,凱基-頭份,2023-11-28,9296
3437,榮創,10,6,4,凱基-頭份,2023-11-28,9296
00915,凱基優選高股息30,4,0,4,凱基-頭份,2023-11-28,9296
1598,岱宇,3,0,3,凱基-頭份,2023-11-28,9296
2390,云辰,6,3,3,凱基-頭份,2023-11-28,9296
2476,鉅祥,3,0,3,凱基-頭份,2023-11-28,9296
2542,興富發,3,0,3,凱基-頭份,2023-11-28,9296
3705,永信,3,0,3,凱基-頭份,2023-11-28,9296
2618,長榮航,35,3,32,凱基-頭份,2023-11-29,9296
00680L,元大美債20正2,30,0,30,凱基-頭份,2023-11-29,9296
2887,台新金,50,20,30,凱基-頭份,2023-11-29,9296
3322,建舜電,30,0,30,凱基-頭份,2023-11-29,9296
1762,中化生,24,0,24,凱基-頭份,2023-11-29,9296
3051,力特,24,0,24,凱基-頭份,2023-11-29,9296
1618,合機,24,1,23,凱基-頭份,2023-11-29,9296
00773B,中信優先金融債,20,0,20,凱基-頭份,2023-11-29,9296
9904,寶成,20,2,18,凱基-頭份,2023-11-29,9296
00632R,元大台灣50反1,16,0,16,凱基-頭份,2023-11-29,9296
00919,群益台灣精選高息,16,0,16,凱基-頭份,2023-11-29,9296
00882,中信中國高股息,15,0,15,凱基-頭份,2023-11-29,9296
00936,台新永續高息中小,14,0,14,凱基-頭份,2023-11-29,9296
0056,元大高股息,16,3,13,凱基-頭份,2023-11-29,9296
2371,大同,15,2,13,凱基-頭份,2023-11-29,9296
9103,美德醫療-DR,13,0,13,凱基-頭份,2023-11-29,9296
2401,凌陽,12,1,11,凱基-頭份,2023-11-29,9296
6770,力積電,19,8,11,凱基-頭份,2023-11-29,9296
00923,群益台ESG低碳50,10,0,10,凱基-頭份,2023-11-29,9296
00895,富邦未來車,10,0,10,凱基-頭份,2023-11-29,9296
1513,中興電,10,0,10,凱基-頭份,2023-11-29,9296
2606,裕民,10,0,10,凱基-頭份,2023-11-29,9296
4743,合一,10,0,10,凱基-頭份,2023-11-29,9296
4956,光鋐,30,20,10,凱基-頭份,2023-11-29,9296
6016,康和證,10,0,10,凱基-頭份,2023-11-29,9296
2376,技嘉,13,4,9,凱基-頭份,2023-11-29,9296
2377,微星,11,3,8,凱基-頭份,2023-11-29,9296
6282,康舒,10,2,8,凱基-頭份,2023-11-29,9296
00878,國泰永續高股息,18,11,7,凱基-頭份,2023-11-29,9296
1616,億泰,7,0,7,凱基-頭份,2023-11-29,9296
3037,欣興,11,4,7,凱基-頭份,2023-11-29,9296
3266,昇陽,7,0,7,凱基-頭份,2023-11-29,9296
4442,竣邦-KY,7,0,7,凱基-頭份,2023-11-29,9296
8054,安國,27,21,6,凱基-頭份,2023-11-29,9296
2382,廣達,11,5,6,凱基-頭份,2023-11-29,9296
1522,堤維西,6,0,6,凱基-頭份,2023-11-29,9296
2356,英業達,7,1,6,凱基-頭份,2023-11-29,9296
3122,笙泉,6,0,6,凱基-頭份,2023-11-29,9296
6173,信昌電,7,1,6,凱基-頭份,2023-11-29,9296
3694,海華,5,0,5,凱基-頭份,2023-11-29,9296
8277,商丞,5,0,5,凱基-頭份,2023-11-29,9296
8358,金居,6,1,5,凱基-頭份,2023-11-29,9296
00673R,期元大S＆P原油反1,4,0,4,凱基-頭份,2023-11-29,9296
00931B,統一美債20年,9,5,4,凱基-頭份,2023-11-29,9296
1603,華電,4,0,4,凱基-頭份,2023-11-29,9296
2891,中信金,4,0,4,凱基-頭份,2023-11-29,9296
3176,基亞,4,0,4,凱基-頭份,2023-11-29,9296
3325,旭品,4,0,4,凱基-頭份,2023-11-29,9296
4114,健喬,9,5,4,凱基-頭份,2023-11-29,9296
5351,鈺創,8,4,4,凱基-頭份,2023-11-29,9296
00933B,國泰10Y+金融債,106,0,106,凱基-頭份,2023-11-30,9296
2883,凱基金,105,0,105,凱基-頭份,2023-11-30,9296
2812,台中銀,100,0,100,凱基-頭份,2023-11-30,9296
00929,復華台灣科技優息,116,16,100,凱基-頭份,2023-11-30,9296
00712,復華富時不動產,50,0,50,凱基-頭份,2023-11-30,9296
2344,華邦電,52,6,46,凱基-頭份,2023-11-30,9296
2606,裕民,44,2,42,凱基-頭份,2023-11-30,9296
00680L,元大美債20正2,41,0,41,凱基-頭份,2023-11-30,9296
2834,臺企銀,40,0,40,凱基-頭份,2023-11-30,9296
2329,華泰,63,32,31,凱基-頭份,2023-11-30,9296
00857B,永豐20年美公債,25,0,25,凱基-頭份,2023-11-30,9296
2369,菱生,29,5,24,凱基-頭份,2023-11-30,9296
9940,信義,20,0,20,凱基-頭份,2023-11-30,9296
4968,立積,20,1,19,凱基-頭份,2023-11-30,9296
2363,矽統,17,2,15,凱基-頭份,2023-11-30,9296
6188,廣明,15,0,15,凱基-頭份,2023-11-30,9296
2409,友達,16,3,13,凱基-頭份,2023-11-30,9296
1618,合機,15,2,13,凱基-頭份,2023-11-30,9296
5434,崇越,12,0,12,凱基-頭份,2023-11-30,9296
2374,佳能,11,0,11,凱基-頭份,2023-11-30,9296
8034,榮群,15,4,11,凱基-頭份,2023-11-30,9296
00878,國泰永續高股息,20,10,10,凱基-頭份,2023-11-30,9296
00637L,元大滬深300正2,10,0,10,凱基-頭份,2023-11-30,9296
2358,廷鑫,10,0,10,凱基-頭份,2023-11-30,9296
2387,精元,10,0,10,凱基-頭份,2023-11-30,9296
3051,力特,10,0,10,凱基-頭份,2023-11-30,9296
8271,宇瞻,10,0,10,凱基-頭份,2023-11-30,9296
3231,緯創,12,4,8,凱基-頭份,2023-11-30,9296
00690,兆豐藍籌30,8,0,8,凱基-頭份,2023-11-30,9296
3013,晟銘電,8,0,8,凱基-頭份,2023-11-30,9296
2618,長榮航,7,0,7,凱基-頭份,2023-11-30,9296
00882,中信中國高股息,7,0,7,凱基-頭份,2023-11-30,9296
2201,裕隆,8,1,7,凱基-頭份,2023-11-30,9296
2465,麗臺,8,1,7,凱基-頭份,2023-11-30,9296
2605,新興,7,0,7,凱基-頭份,2023-11-30,9296
2353,宏��,21,15,6,凱基-頭份,2023-11-30,9296
3317,尼克森,14,8,6,凱基-頭份,2023-11-30,9296
4967,十銓,12,7,5,凱基-頭份,2023-11-30,9296
2345,智邦,5,0,5,凱基-頭份,2023-11-30,9296
1732,毛寶,5,0,5,凱基-頭份,2023-11-30,9296
2303,聯電,5,0,5,凱基-頭份,2023-11-30,9296
2401,凌陽,7,2,5,凱基-頭份,2023-11-30,9296
2443,昶虹,5,0,5,凱基-頭份,2023-11-30,9296
2888,新光金,5,0,5,凱基-頭份,2023-11-30,9296
3050,鈺德,5,0,5,凱基-頭份,2023-11-30,9296
5483,中美晶,13,8,5,凱基-頭份,2023-11-30,9296
6173,信昌電,7,2,5,凱基-頭份,2023-11-30,9296
9928,中視,5,0,5,凱基-頭份,2023-11-30,9296
9938,百和,5,0,5,凱基-頭份,2023-11-30,9296
5347,世界,76,71,5,凱基-頭份,2023-11-30,9296
1701,中化,110,0,110,凱基-頭份,2023-12-01,9296
2002,中鋼,72,9,63,凱基-頭份,2023-12-01,9296
2344,華邦電,62,1,61,凱基-頭份,2023-12-01,9296
00690,兆豐藍籌30,42,0,42,凱基-頭份,2023-12-01,9296
00878,國泰永續高股息,40,3,37,凱基-頭份,2023-12-01,9296
00679B,元大美債20年,26,0,26,凱基-頭份,2023-12-01,9296
1101,台泥,55,30,25,凱基-頭份,2023-12-01,9296
2886,兆豐金,24,0,24,凱基-頭份,2023-12-01,9296
5351,鈺創,25,4,21,凱基-頭份,2023-12-01,9296
00713,元大台灣高息低波,21,0,21,凱基-頭份,2023-12-01,9296
00919,群益台灣精選高息,23,7,16,凱基-頭份,2023-12-01,9296
2367,燿華,18,2,16,凱基-頭份,2023-12-01,9296
00633L,富邦上証正2,14,0,14,凱基-頭份,2023-12-01,9296
8927,北基,14,1,13,凱基-頭份,2023-12-01,9296
1339,昭輝,13,1,12,凱基-頭份,2023-12-01,9296
00637L,元大滬深300正2,11,0,11,凱基-頭份,2023-12-01,9296
00895,富邦未來車,10,0,10,凱基-頭份,2023-12-01,9296
2356,英業達,12,2,10,凱基-頭份,2023-12-01,9296
6108,競國,10,0,10,凱基-頭份,2023-12-01,9296
6284,佳邦,10,0,10,凱基-頭份,2023-12-01,9296
2317,鴻海,9,0,9,凱基-頭份,2023-12-01,9296
2413,環科,8,0,8,凱基-頭份,2023-12-01,9296
2832,台產,8,0,8,凱基-頭份,2023-12-01,9296
3545,敦泰,9,1,8,凱基-頭份,2023-12-01,9296
3706,神達,16,8,8,凱基-頭份,2023-12-01,9296
5258,虹堡,8,0,8,凱基-頭份,2023-12-01,9296
4960,誠美材,7,0,7,凱基-頭份,2023-12-01,9296
00632R,元大台灣50反1,10,3,7,凱基-頭份,2023-12-01,9296
2371,大同,7,0,7,凱基-頭份,2023-12-01,9296
3094,聯傑,7,0,7,凱基-頭份,2023-12-01,9296
3489,森寶,7,0,7,凱基-頭份,2023-12-01,9296
2376,技嘉,7,1,6,凱基-頭份,2023-12-01,9296
1582,信錦,10,4,6,凱基-頭份,2023-12-01,9296
1762,中化生,6,0,6,凱基-頭份,2023-12-01,9296
6526,達發,6,0,6,凱基-頭份,2023-12-01,9296
2390,云辰,5,0,5,凱基-頭份,2023-12-01,9296
00934,中信成長高股息,5,0,5,凱基-頭份,2023-12-01,9296
00664R,國泰臺灣加權反1,5,0,5,凱基-頭份,2023-12-01,9296
1514,亞力,6,1,5,凱基-頭份,2023-12-01,9296
4442,竣邦-KY,5,0,5,凱基-頭份,2023-12-01,9296
5328,華容,24,19,5,凱基-頭份,2023-12-01,9296
9928,中視,5,0,5,凱基-頭份,2023-12-01,9296
3481,群創,7,2,5,凱基-頭份,2023-12-01,9296
00696B,富邦美債20年,5,0,5,凱基-頭份,2023-12-01,9296
3231,緯創,16,12,4,凱基-頭份,2023-12-01,9296
6282,康舒,4,0,4,凱基-頭份,2023-12-01,9296
00931B,統一美債20年,4,0,4,凱基-頭份,2023-12-01,9296
1618,合機,4,0,4,凱基-頭份,2023-12-01,9296
2402,毅嘉,4,0,4,凱基-頭份,2023-12-01,9296
3051,力特,4,0,4,凱基-頭份,2023-12-01,9296
2883,凱基金,254,0,254,凱基-頭份,2023-12-04,9296
00764B,群益25年美債,101,0,101,凱基-頭份,2023-12-04,9296
1701,中化,100,0,100,凱基-頭份,2023-12-04,9296
2834,臺企銀,100,0,100,凱基-頭份,2023-12-04,9296
2812,台中銀,99,0,99,凱基-頭份,2023-12-04,9296
00857B,永豐20年美公債,95,1,94,凱基-頭份,2023-12-04,9296
00680L,元大美債20正2,73,0,73,凱基-頭份,2023-12-04,9296
4114,健喬,65,3,62,凱基-頭份,2023-12-04,9296
00632R,元大台灣50反1,55,0,55,凱基-頭份,2023-12-04,9296
2313,華通,63,15,48,凱基-頭份,2023-12-04,9296
00918,大華優利高填息30,46,0,46,凱基-頭份,2023-12-04,9296
3710,連展投控,46,0,46,凱基-頭份,2023-12-04,9296
3704,合勤控,45,5,40,凱基-頭份,2023-12-04,9296
1611,中電,35,3,32,凱基-頭份,2023-12-04,9296
2609,陽明,173,144,29,凱基-頭份,2023-12-04,9296
2105,正新,42,15,27,凱基-頭份,2023-12-04,9296
1762,中化生,22,0,22,凱基-頭份,2023-12-04,9296
1609,大亞,21,0,21,凱基-頭份,2023-12-04,9296
4533,協易機,52,31,21,凱基-頭份,2023-12-04,9296
2867,三商壽,20,0,20,凱基-頭份,2023-12-04,9296
00919,群益台灣精選高息,21,3,18,凱基-頭份,2023-12-04,9296
00933B,國泰10Y+金融債,17,0,17,凱基-頭份,2023-12-04,9296
1909,榮成,15,0,15,凱基-頭份,2023-12-04,9296
2409,友達,30,15,15,凱基-頭份,2023-12-04,9296
1524,耿鼎,13,0,13,凱基-頭份,2023-12-04,9296
1708,東鹼,13,0,13,凱基-頭份,2023-12-04,9296
2345,智邦,14,1,13,凱基-頭份,2023-12-04,9296
2614,東森,14,2,12,凱基-頭份,2023-12-04,9296
00665L,富邦�琤肭磪囓�2,12,1,11,凱基-頭份,2023-12-04,9296
00642U,期元大S＆P石油,10,0,10,凱基-頭份,2023-12-04,9296
2462,良得電,11,1,10,凱基-頭份,2023-12-04,9296
8034,榮群,10,0,10,凱基-頭份,2023-12-04,9296
1582,信錦,10,1,9,凱基-頭份,2023-12-04,9296
2027,大成鋼,11,2,9,凱基-頭份,2023-12-04,9296
9919,康那香,35,27,8,凱基-頭份,2023-12-04,9296
2390,云辰,8,0,8,凱基-頭份,2023-12-04,9296
9103,美德醫療-DR,13,5,8,凱基-頭份,2023-12-04,9296
1101,台泥,7,0,7,凱基-頭份,2023-12-04,9296
1442,名軒,7,0,7,凱基-頭份,2023-12-04,9296
00878,國泰永續高股息,10,3,7,凱基-頭份,2023-12-04,9296
3715,定穎投控,16,10,6,凱基-頭份,2023-12-04,9296
8076,伍豐,6,0,6,凱基-頭份,2023-12-04,9296
00715L,期街口布蘭特正2,6,0,6,凱基-頭份,2023-12-04,9296
1605,華新,6,0,6,凱基-頭份,2023-12-04,9296
1616,億泰,6,0,6,凱基-頭份,2023-12-04,9296
3227,原相,7,1,6,凱基-頭份,2023-12-04,9296
4157,太景*-KY,10,4,6,凱基-頭份,2023-12-04,9296
6117,迎廣,10,4,6,凱基-頭份,2023-12-04,9296
6271,同欣電,6,0,6,凱基-頭份,2023-12-04,9296
00655L,國泰中國A50正2,5,0,5,凱基-頭份,2023-12-04,9296
00937B,群益ESG投等債20,197,10,187,凱基-頭份,2023-12-05,9296
00935,野村臺灣新科技50,90,1,89,凱基-頭份,2023-12-05,9296
00919,群益台灣精選高息,74,9,65,凱基-頭份,2023-12-05,9296
2891,中信金,59,0,59,凱基-頭份,2023-12-05,9296
4167,松瑞藥,56,15,41,凱基-頭份,2023-12-05,9296
2344,華邦電,46,7,39,凱基-頭份,2023-12-05,9296
00918,大華優利高填息30,34,0,34,凱基-頭份,2023-12-05,9296
00936,台新永續高息中小,32,0,32,凱基-頭份,2023-12-05,9296
2637,慧洋-KY,37,15,22,凱基-頭份,2023-12-05,9296
00632R,元大台灣50反1,20,0,20,凱基-頭份,2023-12-05,9296
00650L,復華香港正2,20,0,20,凱基-頭份,2023-12-05,9296
3450,聯鈞,20,0,20,凱基-頭份,2023-12-05,9296
2606,裕民,36,17,19,凱基-頭份,2023-12-05,9296
2641,正德,49,32,17,凱基-頭份,2023-12-05,9296
00882,中信中國高股息,12,0,12,凱基-頭份,2023-12-05,9296
00878,國泰永續高股息,28,16,12,凱基-頭份,2023-12-05,9296
6742,澤米,12,1,11,凱基-頭份,2023-12-05,9296
3481,群創,25,14,11,凱基-頭份,2023-12-05,9296
00637L,元大滬深300正2,11,1,10,凱基-頭份,2023-12-05,9296
2609,陽明,161,151,10,凱基-頭份,2023-12-05,9296
3231,緯創,11,1,10,凱基-頭份,2023-12-05,9296
5347,世界,100,91,9,凱基-頭份,2023-12-05,9296
1513,中興電,24,16,8,凱基-頭份,2023-12-05,9296
1605,華新,10,2,8,凱基-頭份,2023-12-05,9296
00680L,元大美債20正2,7,0,7,凱基-頭份,2023-12-05,9296
2888,新光金,26,19,7,凱基-頭份,2023-12-05,9296
1524,耿鼎,6,0,6,凱基-頭份,2023-12-05,9296
1781,合世,6,0,6,凱基-頭份,2023-12-05,9296
2356,英業達,7,1,6,凱基-頭份,2023-12-05,9296
3380,明泰,6,0,6,凱基-頭份,2023-12-05,9296
4533,協易機,8,2,6,凱基-頭份,2023-12-05,9296
00929,復華台灣科技優息,31,26,5,凱基-頭份,2023-12-05,9296
3693,營邦,7,2,5,凱基-頭份,2023-12-05,9296
4967,十銓,12,7,5,凱基-頭份,2023-12-05,9296
00679B,元大美債20年,6,1,5,凱基-頭份,2023-12-05,9296
00671R,富邦NASDAQ反1,5,0,5,凱基-頭份,2023-12-05,9296
00664R,國泰臺灣加權反1,5,0,5,凱基-頭份,2023-12-05,9296
1789,神隆,5,0,5,凱基-頭份,2023-12-05,9296
2105,正新,5,0,5,凱基-頭份,2023-12-05,9296
2618,長榮航,20,15,5,凱基-頭份,2023-12-05,9296
3083,網龍,5,0,5,凱基-頭份,2023-12-05,9296
3325,旭品,5,0,5,凱基-頭份,2023-12-05,9296
3491,昇達科,5,0,5,凱基-頭份,2023-12-05,9296
3710,連展投控,5,0,5,凱基-頭份,2023-12-05,9296
8028,昇陽半導體,5,0,5,凱基-頭份,2023-12-05,9296
9928,中視,5,0,5,凱基-頭份,2023-12-05,9296
9938,百和,5,0,5,凱基-頭份,2023-12-05,9296
2330,台積電,5,0,5,凱基-頭份,2023-12-05,9296
3035,智原,4,0,4,凱基-頭份,2023-12-05,9296
1314,中石化,4,0,4,凱基-頭份,2023-12-05,9296
00857B,永豐20年美公債,107,0,107,凱基-頭份,2023-12-06,9296
00937B,群益ESG投等債20,113,10,103,凱基-頭份,2023-12-06,9296
00929,復華台灣科技優息,78,4,74,凱基-頭份,2023-12-06,9296
00933B,國泰10Y+金融債,73,7,66,凱基-頭份,2023-12-06,9296
6770,力積電,50,4,46,凱基-頭份,2023-12-06,9296
00636,國泰中國A50,40,0,40,凱基-頭份,2023-12-06,9296
00687B,國泰20年美債,27,0,27,凱基-頭份,2023-12-06,9296
00919,群益台灣精選高息,27,1,26,凱基-頭份,2023-12-06,9296
00680L,元大美債20正2,26,0,26,凱基-頭份,2023-12-06,9296
00679B,元大美債20年,23,0,23,凱基-頭份,2023-12-06,9296
2417,圓剛,22,1,21,凱基-頭份,2023-12-06,9296
2606,裕民,21,3,18,凱基-頭份,2023-12-06,9296
6148,驊宏資,20,2,18,凱基-頭份,2023-12-06,9296
00936,台新永續高息中小,17,0,17,凱基-頭份,2023-12-06,9296
2363,矽統,13,0,13,凱基-頭份,2023-12-06,9296
00923,群益台ESG低碳50,11,0,11,凱基-頭份,2023-12-06,9296
1325,恆大,11,0,11,凱基-頭份,2023-12-06,9296
6117,迎廣,50,39,11,凱基-頭份,2023-12-06,9296
8068,全達,11,0,11,凱基-頭份,2023-12-06,9296
00931B,統一美債20年,11,1,10,凱基-頭份,2023-12-06,9296
00878,國泰永續高股息,10,0,10,凱基-頭份,2023-12-06,9296
00918,大華優利高填息30,10,0,10,凱基-頭份,2023-12-06,9296
00885,富邦越南,10,0,10,凱基-頭份,2023-12-06,9296
1324,地球,10,0,10,凱基-頭份,2023-12-06,9296
1326,台化,10,0,10,凱基-頭份,2023-12-06,9296
1616,億泰,9,0,9,凱基-頭份,2023-12-06,9296
3481,群創,18,9,9,凱基-頭份,2023-12-06,9296
00892,富邦台灣半導體,10,2,8,凱基-頭份,2023-12-06,9296
2329,華泰,25,17,8,凱基-頭份,2023-12-06,9296
00633L,富邦上証正2,6,0,6,凱基-頭份,2023-12-06,9296
1532,勤美,6,0,6,凱基-頭份,2023-12-06,9296
2324,仁寶,11,5,6,凱基-頭份,2023-12-06,9296
2355,敬鵬,9,3,6,凱基-頭份,2023-12-06,9296
5426,振發,7,1,6,凱基-頭份,2023-12-06,9296
00648R,元大S＆P500反1,5,0,5,凱基-頭份,2023-12-06,9296
1785,光洋科,5,0,5,凱基-頭份,2023-12-06,9296
1815,富喬,5,0,5,凱基-頭份,2023-12-06,9296
2349,錸德,5,0,5,凱基-頭份,2023-12-06,9296
2371,大同,5,0,5,凱基-頭份,2023-12-06,9296
3083,網龍,5,0,5,凱基-頭份,2023-12-06,9296
4952,凌通,5,0,5,凱基-頭份,2023-12-06,9296
6108,競國,5,0,5,凱基-頭份,2023-12-06,9296
6116,彩晶,5,0,5,凱基-頭份,2023-12-06,9296
6278,台表科,5,0,5,凱基-頭份,2023-12-06,9296
6509,聚和,5,0,5,凱基-頭份,2023-12-06,9296
6742,澤米,7,2,5,凱基-頭份,2023-12-06,9296
2344,華邦電,5,1,4,凱基-頭份,2023-12-06,9296
2313,華通,15,11,4,凱基-頭份,2023-12-06,9296
00722B,群益投資級電信債,4,0,4,凱基-頭份,2023-12-06,9296
00740B,富邦全球投等債,4,0,4,凱基-頭份,2023-12-06,9296
00919,群益台灣精選高息,147,3,144,凱基-頭份,2023-12-07,9296
4414,如興,69,0,69,凱基-頭份,2023-12-07,9296
00915,凱基優選高股息30,31,0,31,凱基-頭份,2023-12-07,9296
00857B,永豐20年美公債,30,1,29,凱基-頭份,2023-12-07,9296
00918,大華優利高填息30,27,0,27,凱基-頭份,2023-12-07,9296
00680L,元大美債20正2,76,50,26,凱基-頭份,2023-12-07,9296
00679B,元大美債20年,48,23,25,凱基-頭份,2023-12-07,9296
00650L,復華香港正2,25,0,25,凱基-頭份,2023-12-07,9296
00720B,元大投資級公司債,24,0,24,凱基-頭份,2023-12-07,9296
2419,仲琦,21,0,21,凱基-頭份,2023-12-07,9296
00642U,期元大S＆P石油,20,0,20,凱基-頭份,2023-12-07,9296
1513,中興電,31,11,20,凱基-頭份,2023-12-07,9296
2009,第一銅,20,0,20,凱基-頭份,2023-12-07,9296
2537,聯上發,20,0,20,凱基-頭份,2023-12-07,9296
3450,聯鈞,20,0,20,凱基-頭份,2023-12-07,9296
2345,智邦,18,0,18,凱基-頭份,2023-12-07,9296
2610,華航,39,23,16,凱基-頭份,2023-12-07,9296
3481,群創,19,3,16,凱基-頭份,2023-12-07,9296
00715L,期街口布蘭特正2,15,0,15,凱基-頭份,2023-12-07,9296
8086,宏捷科,15,0,15,凱基-頭份,2023-12-07,9296
00929,復華台灣科技優息,15,1,14,凱基-頭份,2023-12-07,9296
3050,鈺德,15,1,14,凱基-頭份,2023-12-07,9296
00882,中信中國高股息,13,0,13,凱基-頭份,2023-12-07,9296
00931B,統一美債20年,11,0,11,凱基-頭份,2023-12-07,9296
2462,良得電,11,0,11,凱基-頭份,2023-12-07,9296
00636,國泰中國A50,10,0,10,凱基-頭份,2023-12-07,9296
00895,富邦未來車,10,0,10,凱基-頭份,2023-12-07,9296
1762,中化生,10,0,10,凱基-頭份,2023-12-07,9296
4167,松瑞藥,10,0,10,凱基-頭份,2023-12-07,9296
1101,台泥,10,1,9,凱基-頭份,2023-12-07,9296
00665L,富邦�琤肭磪囓�2,10,1,9,凱基-頭份,2023-12-07,9296
1522,堤維西,18,9,9,凱基-頭份,2023-12-07,9296
2329,華泰,19,10,9,凱基-頭份,2023-12-07,9296
8942,森鉅,9,0,9,凱基-頭份,2023-12-07,9296
00688L,國泰20年美債正2,8,0,8,凱基-頭份,2023-12-07,9296
1736,喬山,8,0,8,凱基-頭份,2023-12-07,9296
2337,旺宏,8,0,8,凱基-頭份,2023-12-07,9296
6126,信音,8,0,8,凱基-頭份,2023-12-07,9296
3051,力特,8,0,8,凱基-頭份,2023-12-07,9296
2882,國泰金,7,0,7,凱基-頭份,2023-12-07,9296
1319,東陽,8,1,7,凱基-頭份,2023-12-07,9296
2528,皇普,7,0,7,凱基-頭份,2023-12-07,9296
2611,志信,9,2,7,凱基-頭份,2023-12-07,9296
3499,環天科,7,0,7,凱基-頭份,2023-12-07,9296
3540,曜越,7,0,7,凱基-頭份,2023-12-07,9296
5009,榮剛,6,0,6,凱基-頭份,2023-12-07,9296
2371,大同,6,1,5,凱基-頭份,2023-12-07,9296
00935,野村臺灣新科技50,5,0,5,凱基-頭份,2023-12-07,9296
00687B,國泰20年美債,6,1,5,凱基-頭份,2023-12-07,9296
00891,中信關鍵半導體,5,0,5,凱基-頭份,2023-12-07,9296
00929,復華台灣科技優息,87,11,76,凱基-頭份,2023-12-08,9296
00937B,群益ESG投等債20,53,0,53,凱基-頭份,2023-12-08,9296
3149,正達,40,0,40,凱基-頭份,2023-12-08,9296
2313,華通,38,1,37,凱基-頭份,2023-12-08,9296
00905,FT臺灣Smart,30,0,30,凱基-頭份,2023-12-08,9296
1709,和益,30,0,30,凱基-頭份,2023-12-08,9296
00878,國泰永續高股息,31,2,29,凱基-頭份,2023-12-08,9296
1101,台泥,20,0,20,凱基-頭份,2023-12-08,9296
2312,金寶,25,5,20,凱基-頭份,2023-12-08,9296
00687B,國泰20年美債,14,0,14,凱基-頭份,2023-12-08,9296
1762,中化生,13,0,13,凱基-頭份,2023-12-08,9296
2520,冠德,13,0,13,凱基-頭份,2023-12-08,9296
2618,長榮航,33,20,13,凱基-頭份,2023-12-08,9296
2101,南港,12,0,12,凱基-頭份,2023-12-08,9296
5202,力新,12,0,12,凱基-頭份,2023-12-08,9296
3231,緯創,17,6,11,凱基-頭份,2023-12-08,9296
2367,燿華,11,0,11,凱基-頭份,2023-12-08,9296
2377,微星,11,0,11,凱基-頭份,2023-12-08,9296
1514,亞力,39,28,11,凱基-頭份,2023-12-08,9296
00636,國泰中國A50,10,0,10,凱基-頭份,2023-12-08,9296
2358,廷鑫,20,10,10,凱基-頭份,2023-12-08,9296
2375,凱美,10,0,10,凱基-頭份,2023-12-08,9296
2609,陽明,15,5,10,凱基-頭份,2023-12-08,9296
2889,國票金,10,0,10,凱基-頭份,2023-12-08,9296
1324,地球,10,1,9,凱基-頭份,2023-12-08,9296
2605,新興,27,18,9,凱基-頭份,2023-12-08,9296
2637,慧洋-KY,9,1,8,凱基-頭份,2023-12-08,9296
1513,中興電,18,12,6,凱基-頭份,2023-12-08,9296
00751B,元大AAA至A公司債,6,0,6,凱基-頭份,2023-12-08,9296
1736,喬山,6,0,6,凱基-頭份,2023-12-08,9296
2606,裕民,6,0,6,凱基-頭份,2023-12-08,9296
2610,華航,8,2,6,凱基-頭份,2023-12-08,9296
3042,晶技,6,0,6,凱基-頭份,2023-12-08,9296
3481,群創,8,2,6,凱基-頭份,2023-12-08,9296
6703,軒郁,7,1,6,凱基-頭份,2023-12-08,9296
00918,大華優利高填息30,6,0,6,凱基-頭份,2023-12-08,9296
00933B,國泰10Y+金融債,5,0,5,凱基-頭份,2023-12-08,9296
2881,富邦金,6,1,5,凱基-頭份,2023-12-08,9296
00936,台新永續高息中小,5,0,5,凱基-頭份,2023-12-08,9296
00934,中信成長高股息,5,0,5,凱基-頭份,2023-12-08,9296
00650L,復華香港正2,5,0,5,凱基-頭份,2023-12-08,9296
2417,圓剛,8,3,5,凱基-頭份,2023-12-08,9296
2485,兆赫,5,0,5,凱基-頭份,2023-12-08,9296
6125,廣運,6,1,5,凱基-頭份,2023-12-08,9296
6219,富旺,5,0,5,凱基-頭份,2023-12-08,9296
00679B,元大美債20年,19,15,4,凱基-頭份,2023-12-08,9296
00915,凱基優選高股息30,4,0,4,凱基-頭份,2023-12-08,9296
1815,富喬,4,0,4,凱基-頭份,2023-12-08,9296
2376,技嘉,18,14,4,凱基-頭份,2023-12-08,9296
3234,光環,4,0,4,凱基-頭份,2023-12-08,9296
00706L,期元大S＆P日圓正2,100,0,100,凱基-頭份,2023-12-11,9296
00934,中信成長高股息,75,10,65,凱基-頭份,2023-12-11,9296
00882,中信中國高股息,49,0,49,凱基-頭份,2023-12-11,9296
00919,群益台灣精選高息,43,0,43,凱基-頭份,2023-12-11,9296
00937B,群益ESG投等債20,40,1,39,凱基-頭份,2023-12-11,9296
2313,華通,34,3,31,凱基-頭份,2023-12-11,9296
00918,大華優利高填息30,30,0,30,凱基-頭份,2023-12-11,9296
4167,松瑞藥,26,0,26,凱基-頭份,2023-12-11,9296
2618,長榮航,26,5,21,凱基-頭份,2023-12-11,9296
2323,中環,20,0,20,凱基-頭份,2023-12-11,9296
4414,如興,19,0,19,凱基-頭份,2023-12-11,9296
2610,華航,23,5,18,凱基-頭份,2023-12-11,9296
00680L,元大美債20正2,16,0,16,凱基-頭份,2023-12-11,9296
00929,復華台灣科技優息,42,30,12,凱基-頭份,2023-12-11,9296
2611,志信,12,0,12,凱基-頭份,2023-12-11,9296
2002,中鋼,82,71,11,凱基-頭份,2023-12-11,9296
1568,倉佑,10,0,10,凱基-頭份,2023-12-11,9296
2314,台揚,10,0,10,凱基-頭份,2023-12-11,9296
2537,聯上發,10,0,10,凱基-頭份,2023-12-11,9296
3346,麗清,10,0,10,凱基-頭份,2023-12-11,9296
4401,東隆興,10,0,10,凱基-頭份,2023-12-11,9296
5426,振發,10,0,10,凱基-頭份,2023-12-11,9296
8101,華冠,10,0,10,凱基-頭份,2023-12-11,9296
2329,華泰,10,1,9,凱基-頭份,2023-12-11,9296
2356,英業達,17,8,9,凱基-頭份,2023-12-11,9296
1609,大亞,34,26,8,凱基-頭份,2023-12-11,9296
2606,裕民,8,0,8,凱基-頭份,2023-12-11,9296
2888,新光金,45,37,8,凱基-頭份,2023-12-11,9296
2388,威盛,8,1,7,凱基-頭份,2023-12-11,9296
1524,耿鼎,11,4,7,凱基-頭份,2023-12-11,9296
2401,凌陽,10,3,7,凱基-頭份,2023-12-11,9296
00915,凱基優選高股息30,6,0,6,凱基-頭份,2023-12-11,9296
1727,中華化,6,0,6,凱基-頭份,2023-12-11,9296
2520,冠德,6,0,6,凱基-頭份,2023-12-11,9296
9919,康那香,6,0,6,凱基-頭份,2023-12-11,9296
3231,緯創,6,1,5,凱基-頭份,2023-12-11,9296
00679B,元大美債20年,7,2,5,凱基-頭份,2023-12-11,9296
00687B,國泰20年美債,6,1,5,凱基-頭份,2023-12-11,9296
6668,中揚光,9,4,5,凱基-頭份,2023-12-11,9296
00921,兆豐龍頭等權重,5,0,5,凱基-頭份,2023-12-11,9296
1736,喬山,5,0,5,凱基-頭份,2023-12-11,9296
2243,宏旭-KY,5,0,5,凱基-頭份,2023-12-11,9296
2349,錸德,5,0,5,凱基-頭份,2023-12-11,9296
2354,鴻準,5,0,5,凱基-頭份,2023-12-11,9296
2425,承啟,5,0,5,凱基-頭份,2023-12-11,9296
3630,新鉅科,5,0,5,凱基-頭份,2023-12-11,9296
6005,群益證,5,0,5,凱基-頭份,2023-12-11,9296
6603,富強鑫,5,0,5,凱基-頭份,2023-12-11,9296
3032,偉訓,4,0,4,凱基-頭份,2023-12-11,9296
3038,全台,4,0,4,凱基-頭份,2023-12-11,9296
00679B,元大美債20年,55,0,55,凱基-頭份,2023-12-12,9296
00929,復華台灣科技優息,89,39,50,凱基-頭份,2023-12-12,9296
00918,大華優利高填息30,42,1,41,凱基-頭份,2023-12-12,9296
2615,萬海,110,78,32,凱基-頭份,2023-12-12,9296
3704,合勤控,34,9,25,凱基-頭份,2023-12-12,9296
2618,長榮航,24,0,24,凱基-頭份,2023-12-12,9296
00915,凱基優選高股息30,27,3,24,凱基-頭份,2023-12-12,9296
2313,華通,41,19,22,凱基-頭份,2023-12-12,9296
6122,擎邦,22,0,22,凱基-頭份,2023-12-12,9296
00878,國泰永續高股息,20,0,20,凱基-頭份,2023-12-12,9296
00706L,期元大S＆P日圓正2,20,0,20,凱基-頭份,2023-12-12,9296
1316,上曜,20,0,20,凱基-頭份,2023-12-12,9296
1514,亞力,26,8,18,凱基-頭份,2023-12-12,9296
2345,智邦,23,5,18,凱基-頭份,2023-12-12,9296
1432,大魯閣,14,0,14,凱基-頭份,2023-12-12,9296
1618,合機,27,15,12,凱基-頭份,2023-12-12,9296
4414,如興,11,0,11,凱基-頭份,2023-12-12,9296
8054,安國,17,6,11,凱基-頭份,2023-12-12,9296
00933B,國泰10Y+金融債,10,0,10,凱基-頭份,2023-12-12,9296
00900,富邦特選高股息30,10,0,10,凱基-頭份,2023-12-12,9296
00671R,富邦NASDAQ反1,10,0,10,凱基-頭份,2023-12-12,9296
00664R,國泰臺灣加權反1,10,0,10,凱基-頭份,2023-12-12,9296
1301,台塑,10,0,10,凱基-頭份,2023-12-12,9296
1905,華紙,10,0,10,凱基-頭份,2023-12-12,9296
2376,技嘉,14,4,10,凱基-頭份,2023-12-12,9296
6226,光鼎,10,0,10,凱基-頭份,2023-12-12,9296
8201,無敵,10,0,10,凱基-頭份,2023-12-12,9296
1612,宏泰,10,2,8,凱基-頭份,2023-12-12,9296
6209,今國光,8,0,8,凱基-頭份,2023-12-12,9296
00882,中信中國高股息,17,10,7,凱基-頭份,2023-12-12,9296
00830,國泰費城半導體,8,1,7,凱基-頭份,2023-12-12,9296
2314,台揚,21,14,7,凱基-頭份,2023-12-12,9296
2002,中鋼,12,6,6,凱基-頭份,2023-12-12,9296
4401,東隆興,9,3,6,凱基-頭份,2023-12-12,9296
6285,啟��,17,12,5,凱基-頭份,2023-12-12,9296
2204,中華,6,1,5,凱基-頭份,2023-12-12,9296
1324,地球,6,1,5,凱基-頭份,2023-12-12,9296
2390,云辰,5,0,5,凱基-頭份,2023-12-12,9296
3276,宇環,5,0,5,凱基-頭份,2023-12-12,9296
3499,環天科,5,0,5,凱基-頭份,2023-12-12,9296
4105,東洋,5,0,5,凱基-頭份,2023-12-12,9296
6668,中揚光,29,24,5,凱基-頭份,2023-12-12,9296
8112,至上,15,10,5,凱基-頭份,2023-12-12,9296
2401,凌陽,6,2,4,凱基-頭份,2023-12-12,9296
00891,中信關鍵半導體,4,0,4,凱基-頭份,2023-12-12,9296
00772B,中信高評級公司債,4,0,4,凱基-頭份,2023-12-12,9296
00740B,富邦全球投等債,4,0,4,凱基-頭份,2023-12-12,9296
00722B,群益投資級電信債,4,0,4,凱基-頭份,2023-12-12,9296
00720B,元大投資級公司債,4,0,4,凱基-頭份,2023-12-12,9296
1305,華夏,4,0,4,凱基-頭份,2023-12-12,9296
00936,台新永續高息中小,130,0,130,凱基-頭份,2023-12-13,9296
00918,大華優利高填息30,102,0,102,凱基-頭份,2023-12-13,9296
00919,群益台灣精選高息,75,8,67,凱基-頭份,2023-12-13,9296
00929,復華台灣科技優息,70,5,65,凱基-頭份,2023-12-13,9296
2886,兆豐金,27,0,27,凱基-頭份,2023-12-13,9296
2353,宏��,36,11,25,凱基-頭份,2023-12-13,9296
00715L,期街口布蘭特正2,22,0,22,凱基-頭份,2023-12-13,9296
1609,大亞,22,0,22,凱基-頭份,2023-12-13,9296
3019,亞光,35,15,20,凱基-頭份,2023-12-13,9296
6122,擎邦,20,1,19,凱基-頭份,2023-12-13,9296
3712,永崴投控,16,0,16,凱基-頭份,2023-12-13,9296
00933B,國泰10Y+金融債,15,0,15,凱基-頭份,2023-12-13,9296
00753L,中信中國50正2,15,0,15,凱基-頭份,2023-12-13,9296
00650L,復華香港正2,15,0,15,凱基-頭份,2023-12-13,9296
4183,福永生技,15,0,15,凱基-頭份,2023-12-13,9296
00882,中信中國高股息,14,0,14,凱基-頭份,2023-12-13,9296
00891,中信關鍵半導體,15,2,13,凱基-頭份,2023-12-13,9296
2888,新光金,23,10,13,凱基-頭份,2023-12-13,9296
5347,世界,13,0,13,凱基-頭份,2023-12-13,9296
2355,敬鵬,14,2,12,凱基-頭份,2023-12-13,9296
3499,環天科,11,0,11,凱基-頭份,2023-12-13,9296
6156,松上,14,3,11,凱基-頭份,2023-12-13,9296
00900,富邦特選高股息30,13,3,10,凱基-頭份,2023-12-13,9296
00895,富邦未來車,10,0,10,凱基-頭份,2023-12-13,9296
00642U,期元大S＆P石油,10,0,10,凱基-頭份,2023-12-13,9296
3287,廣寰科,10,0,10,凱基-頭份,2023-12-13,9296
3703,欣陸,10,0,10,凱基-頭份,2023-12-13,9296
5515,建國,10,0,10,凱基-頭份,2023-12-13,9296
8112,至上,21,11,10,凱基-頭份,2023-12-13,9296
2344,華邦電,12,3,9,凱基-頭份,2023-12-13,9296
2201,裕隆,8,0,8,凱基-頭份,2023-12-13,9296
3058,立德,9,1,8,凱基-頭份,2023-12-13,9296
00751B,元大AAA至A公司債,7,0,7,凱基-頭份,2023-12-13,9296
00937B,群益ESG投等債20,7,0,7,凱基-頭份,2023-12-13,9296
2002,中鋼,7,0,7,凱基-頭份,2023-12-13,9296
2419,仲琦,20,13,7,凱基-頭份,2023-12-13,9296
2606,裕民,7,0,7,凱基-頭份,2023-12-13,9296
3006,晶豪科,87,80,7,凱基-頭份,2023-12-13,9296
6126,信音,7,0,7,凱基-頭份,2023-12-13,9296
3035,智原,10,4,6,凱基-頭份,2023-12-13,9296
2882,國泰金,6,0,6,凱基-頭份,2023-12-13,9296
2371,大同,6,0,6,凱基-頭份,2023-12-13,9296
3234,光環,6,0,6,凱基-頭份,2023-12-13,9296
00679B,元大美債20年,5,0,5,凱基-頭份,2023-12-13,9296
00680L,元大美債20正2,5,0,5,凱基-頭份,2023-12-13,9296
2338,光罩,5,0,5,凱基-頭份,2023-12-13,9296
2465,麗臺,5,0,5,凱基-頭份,2023-12-13,9296
2482,連宇,5,0,5,凱基-頭份,2023-12-13,9296
3374,精材,5,0,5,凱基-頭份,2023-12-13,9296
3622,洋華,8,3,5,凱基-頭份,2023-12-13,9296
00929,復華台灣科技優息,277,12,265,凱基-頭份,2023-12-14,9296
00632R,元大台灣50反1,165,0,165,凱基-頭份,2023-12-14,9296
2369,菱生,50,0,50,凱基-頭份,2023-12-14,9296
6122,擎邦,42,2,40,凱基-頭份,2023-12-14,9296
00687B,國泰20年美債,45,7,38,凱基-頭份,2023-12-14,9296
5351,鈺創,28,4,24,凱基-頭份,2023-12-14,9296
2609,陽明,223,201,22,凱基-頭份,2023-12-14,9296
00937B,群益ESG投等債20,21,0,21,凱基-頭份,2023-12-14,9296
00664R,國泰臺灣加權反1,20,0,20,凱基-頭份,2023-12-14,9296
3290,東浦,20,0,20,凱基-頭份,2023-12-14,9296
2002,中鋼,20,1,19,凱基-頭份,2023-12-14,9296
2390,云辰,18,1,17,凱基-頭份,2023-12-14,9296
2365,昆盈,22,5,17,凱基-頭份,2023-12-14,9296
1736,喬山,16,0,16,凱基-頭份,2023-12-14,9296
00722B,群益投資級電信債,13,0,13,凱基-頭份,2023-12-14,9296
00679B,元大美債20年,25,13,12,凱基-頭份,2023-12-14,9296
3499,環天科,18,6,12,凱基-頭份,2023-12-14,9296
5498,凱崴,12,0,12,凱基-頭份,2023-12-14,9296
00936,台新永續高息中小,16,5,11,凱基-頭份,2023-12-14,9296
00637L,元大滬深300正2,12,1,11,凱基-頭份,2023-12-14,9296
3622,洋華,11,0,11,凱基-頭份,2023-12-14,9296
2367,燿華,13,2,11,凱基-頭份,2023-12-14,9296
00671R,富邦NASDAQ反1,10,0,10,凱基-頭份,2023-12-14,9296
2063,世鎧,10,0,10,凱基-頭份,2023-12-14,9296
3050,鈺德,10,0,10,凱基-頭份,2023-12-14,9296
6288,聯嘉,10,0,10,凱基-頭份,2023-12-14,9296
00934,中信成長高股息,11,1,10,凱基-頭份,2023-12-14,9296
2344,華邦電,15,6,9,凱基-頭份,2023-12-14,9296
00933B,國泰10Y+金融債,9,0,9,凱基-頭份,2023-12-14,9296
3231,緯創,17,9,8,凱基-頭份,2023-12-14,9296
2425,承啟,12,4,8,凱基-頭份,2023-12-14,9296
6209,今國光,20,12,8,凱基-頭份,2023-12-14,9296
00662,富邦NASDAQ,7,0,7,凱基-頭份,2023-12-14,9296
2387,精元,7,0,7,凱基-頭份,2023-12-14,9296
2313,華通,25,19,6,凱基-頭份,2023-12-14,9296
2605,新興,8,2,6,凱基-頭份,2023-12-14,9296
3023,信邦,6,0,6,凱基-頭份,2023-12-14,9296
3491,昇達科,6,0,6,凱基-頭份,2023-12-14,9296
3712,永崴投控,21,15,6,凱基-頭份,2023-12-14,9296
8054,安國,10,4,6,凱基-頭份,2023-12-14,9296
2812,台中銀,6,0,6,凱基-頭份,2023-12-14,9296
2408,南亞科,6,1,5,凱基-頭份,2023-12-14,9296
00751B,元大AAA至A公司債,5,0,5,凱基-頭份,2023-12-14,9296
00795B,中信美國公債20年,5,0,5,凱基-頭份,2023-12-14,9296
2482,連宇,5,0,5,凱基-頭份,2023-12-14,9296
3276,宇環,5,0,5,凱基-頭份,2023-12-14,9296
3545,敦泰,5,0,5,凱基-頭份,2023-12-14,9296
3605,宏致,5,0,5,凱基-頭份,2023-12-14,9296
3706,神達,11,6,5,凱基-頭份,2023-12-14,9296
6265,方土昶,5,0,5,凱基-頭份,2023-12-14,9296
00712,復華富時不動產,263,2,261,凱基-頭份,2023-12-15,9296
00919,群益台灣精選高息,198,90,108,凱基-頭份,2023-12-15,9296
00937B,群益ESG投等債20,75,5,70,凱基-頭份,2023-12-15,9296
00929,復華台灣科技優息,223,167,56,凱基-頭份,2023-12-15,9296
3710,連展投控,54,0,54,凱基-頭份,2023-12-15,9296
3380,明泰,45,2,43,凱基-頭份,2023-12-15,9296
00650L,復華香港正2,50,10,40,凱基-頭份,2023-12-15,9296
6191,精成科,37,0,37,凱基-頭份,2023-12-15,9296
5521,工信,35,3,32,凱基-頭份,2023-12-15,9296
2425,承啟,30,2,28,凱基-頭份,2023-12-15,9296
00687B,國泰20年美債,38,13,25,凱基-頭份,2023-12-15,9296
2887,台新金,22,0,22,凱基-頭份,2023-12-15,9296
2002,中鋼,28,10,18,凱基-頭份,2023-12-15,9296
00933B,國泰10Y+金融債,17,0,17,凱基-頭份,2023-12-15,9296
2345,智邦,18,1,17,凱基-頭份,2023-12-15,9296
00679B,元大美債20年,16,0,16,凱基-頭份,2023-12-15,9296
00664R,國泰臺灣加權反1,15,0,15,凱基-頭份,2023-12-15,9296
3149,正達,16,2,14,凱基-頭份,2023-12-15,9296
00882,中信中國高股息,14,1,13,凱基-頭份,2023-12-15,9296
2493,揚博,13,0,13,凱基-頭份,2023-12-15,9296
3011,今皓,14,1,13,凱基-頭份,2023-12-15,9296
3231,緯創,21,9,12,凱基-頭份,2023-12-15,9296
6122,擎邦,16,4,12,凱基-頭份,2023-12-15,9296
00795B,中信美國公債20年,11,0,11,凱基-頭份,2023-12-15,9296
00857B,永豐20年美公債,10,0,10,凱基-頭份,2023-12-15,9296
00934,中信成長高股息,11,1,10,凱基-頭份,2023-12-15,9296
1701,中化,10,0,10,凱基-頭份,2023-12-15,9296
6226,光鼎,10,0,10,凱基-頭份,2023-12-15,9296
2913,農林,10,1,9,凱基-頭份,2023-12-15,9296
5465,富驊,9,0,9,凱基-頭份,2023-12-15,9296
9103,美德醫療-DR,8,0,8,凱基-頭份,2023-12-15,9296
2363,矽統,69,62,7,凱基-頭份,2023-12-15,9296
2610,華航,8,1,7,凱基-頭份,2023-12-15,9296
3325,旭品,7,0,7,凱基-頭份,2023-12-15,9296
3499,環天科,13,6,7,凱基-頭份,2023-12-15,9296
5347,世界,7,0,7,凱基-頭份,2023-12-15,9296
6153,嘉聯益,7,0,7,凱基-頭份,2023-12-15,9296
6202,盛群,7,0,7,凱基-頭份,2023-12-15,9296
9958,世紀鋼,8,1,7,凱基-頭份,2023-12-15,9296
00931B,統一美債20年,7,1,6,凱基-頭份,2023-12-15,9296
00927,群益半導體收益,6,0,6,凱基-頭份,2023-12-15,9296
2359,所羅門,6,0,6,凱基-頭份,2023-12-15,9296
2371,大同,6,0,6,凱基-頭份,2023-12-15,9296
2520,冠德,6,0,6,凱基-頭份,2023-12-15,9296
8213,志超,6,0,6,凱基-頭份,2023-12-15,9296
1584,精剛,15,10,5,凱基-頭份,2023-12-15,9296
00885,富邦越南,5,0,5,凱基-頭份,2023-12-15,9296
2388,威盛,6,1,5,凱基-頭份,2023-12-15,9296
2317,鴻海,5,0,5,凱基-頭份,2023-12-15,9296
00772B,中信高評級公司債,5,0,5,凱基-頭份,2023-12-15,9296
00919,群益台灣精選高息,129,2,127,凱基-頭份,2023-12-18,9296
00687B,國泰20年美債,84,0,84,凱基-頭份,2023-12-18,9296
2603,長榮,82,40,42,凱基-頭份,2023-12-18,9296
3710,連展投控,36,0,36,凱基-頭份,2023-12-18,9296
00680L,元大美債20正2,35,0,35,凱基-頭份,2023-12-18,9296
2610,華航,55,20,35,凱基-頭份,2023-12-18,9296
00830,國泰費城半導體,33,0,33,凱基-頭份,2023-12-18,9296
2618,長榮航,61,30,31,凱基-頭份,2023-12-18,9296
2002,中鋼,41,17,24,凱基-頭份,2023-12-18,9296
00706L,期元大S＆P日圓正2,20,0,20,凱基-頭份,2023-12-18,9296
1802,台玻,17,0,17,凱基-頭份,2023-12-18,9296
00882,中信中國高股息,14,0,14,凱基-頭份,2023-12-18,9296
00929,復華台灣科技優息,53,40,13,凱基-頭份,2023-12-18,9296
2615,萬海,18,5,13,凱基-頭份,2023-12-18,9296
3149,正達,22,10,12,凱基-頭份,2023-12-18,9296
6179,亞通,12,0,12,凱基-頭份,2023-12-18,9296
00915,凱基優選高股息30,11,0,11,凱基-頭份,2023-12-18,9296
9945,潤泰新,10,0,10,凱基-頭份,2023-12-18,9296
00931B,統一美債20年,22,13,9,凱基-頭份,2023-12-18,9296
3260,威剛,9,0,9,凱基-頭份,2023-12-18,9296
00720B,元大投資級公司債,8,0,8,凱基-頭份,2023-12-18,9296
2884,玉山金,9,1,8,凱基-頭份,2023-12-18,9296
6274,台燿,13,5,8,凱基-頭份,2023-12-18,9296
0056,元大高股息,7,0,7,凱基-頭份,2023-12-18,9296
00688L,國泰20年美債正2,7,0,7,凱基-頭份,2023-12-18,9296
2031,新光鋼,10,3,7,凱基-頭份,2023-12-18,9296
3019,亞光,7,0,7,凱基-頭份,2023-12-18,9296
00773B,中信優先金融債,6,0,6,凱基-頭份,2023-12-18,9296
00713,元大台灣高息低波,6,0,6,凱基-頭份,2023-12-18,9296
1736,喬山,6,0,6,凱基-頭份,2023-12-18,9296
2349,錸德,6,0,6,凱基-頭份,2023-12-18,9296
6278,台表科,6,0,6,凱基-頭份,2023-12-18,9296
00933B,國泰10Y+金融債,6,0,6,凱基-頭份,2023-12-18,9296
00648R,元大S＆P500反1,5,0,5,凱基-頭份,2023-12-18,9296
2017,官田鋼,5,0,5,凱基-頭份,2023-12-18,9296
2303,聯電,12,7,5,凱基-頭份,2023-12-18,9296
2352,佳世達,7,2,5,凱基-頭份,2023-12-18,9296
2365,昆盈,5,0,5,凱基-頭份,2023-12-18,9296
2367,燿華,5,0,5,凱基-頭份,2023-12-18,9296
2449,京元電子,12,7,5,凱基-頭份,2023-12-18,9296
3011,今皓,6,1,5,凱基-頭份,2023-12-18,9296
3305,昇貿,6,1,5,凱基-頭份,2023-12-18,9296
3663,鑫科,5,0,5,凱基-頭份,2023-12-18,9296
5355,佳總,5,0,5,凱基-頭份,2023-12-18,9296
5469,瀚宇博,5,0,5,凱基-頭份,2023-12-18,9296
6284,佳邦,5,0,5,凱基-頭份,2023-12-18,9296
00751B,元大AAA至A公司債,4,0,4,凱基-頭份,2023-12-18,9296
00772B,中信高評級公司債,4,0,4,凱基-頭份,2023-12-18,9296
2023,燁輝,14,10,4,凱基-頭份,2023-12-18,9296
2408,南亞科,4,0,4,凱基-頭份,2023-12-18,9296
00929,復華台灣科技優息,96,5,91,凱基-頭份,2023-12-19,9296
00919,群益台灣精選高息,106,20,86,凱基-頭份,2023-12-19,9296
00937B,群益ESG投等債20,100,43,57,凱基-頭份,2023-12-19,9296
6443,元晶,48,1,47,凱基-頭份,2023-12-19,9296
2618,長榮航,65,33,32,凱基-頭份,2023-12-19,9296
2887,台新金,31,0,31,凱基-頭份,2023-12-19,9296
4414,如興,26,0,26,凱基-頭份,2023-12-19,9296
2610,華航,25,0,25,凱基-頭份,2023-12-19,9296
2014,中鴻,49,26,23,凱基-頭份,2023-12-19,9296
00637L,元大滬深300正2,22,2,20,凱基-頭份,2023-12-19,9296
6226,光鼎,20,0,20,凱基-頭份,2023-12-19,9296
2344,華邦電,22,3,19,凱基-頭份,2023-12-19,9296
00687B,國泰20年美債,19,2,17,凱基-頭份,2023-12-19,9296
6188,廣明,16,0,16,凱基-頭份,2023-12-19,9296
2611,志信,14,0,14,凱基-頭份,2023-12-19,9296
00923,群益台ESG低碳50,12,0,12,凱基-頭份,2023-12-19,9296
4167,松瑞藥,14,3,11,凱基-頭份,2023-12-19,9296
2388,威盛,12,2,10,凱基-頭份,2023-12-19,9296
2329,華泰,10,0,10,凱基-頭份,2023-12-19,9296
4142,國光生,10,0,10,凱基-頭份,2023-12-19,9296
0056,元大高股息,11,2,9,凱基-頭份,2023-12-19,9296
00878,國泰永續高股息,9,0,9,凱基-頭份,2023-12-19,9296
3710,連展投控,9,0,9,凱基-頭份,2023-12-19,9296
3645,達邁,9,0,9,凱基-頭份,2023-12-19,9296
4133,亞諾法,10,1,9,凱基-頭份,2023-12-19,9296
1102,亞泥,8,0,8,凱基-頭份,2023-12-19,9296
8213,志超,9,1,8,凱基-頭份,2023-12-19,9296
00915,凱基優選高股息30,7,0,7,凱基-頭份,2023-12-19,9296
2607,榮運,8,1,7,凱基-頭份,2023-12-19,9296
00900,富邦特選高股息30,6,0,6,凱基-頭份,2023-12-19,9296
2103,台橡,6,0,6,凱基-頭份,2023-12-19,9296
3041,揚智,6,0,6,凱基-頭份,2023-12-19,9296
4563,百德,6,0,6,凱基-頭份,2023-12-19,9296
5608,四維航,6,0,6,凱基-頭份,2023-12-19,9296
6492,生華科,6,0,6,凱基-頭份,2023-12-19,9296
6668,中揚光,5,0,5,凱基-頭份,2023-12-19,9296
3105,穩懋,5,0,5,凱基-頭份,2023-12-19,9296
00772B,中信高評級公司債,5,0,5,凱基-頭份,2023-12-19,9296
1605,華新,6,1,5,凱基-頭份,2023-12-19,9296
2402,毅嘉,5,0,5,凱基-頭份,2023-12-19,9296
2312,金寶,4,0,4,凱基-頭份,2023-12-19,9296
2355,敬鵬,11,7,4,凱基-頭份,2023-12-19,9296
2633,台灣高鐵,4,0,4,凱基-頭份,2023-12-19,9296
2636,台驊控股,13,9,4,凱基-頭份,2023-12-19,9296
2913,農林,4,0,4,凱基-頭份,2023-12-19,9296
2376,技嘉,6,2,4,凱基-頭份,2023-12-19,9296
00713,元大台灣高息低波,3,0,3,凱基-頭份,2023-12-19,9296
00918,大華優利高填息30,4,1,3,凱基-頭份,2023-12-19,9296
00932,兆豐永續高息等權,3,0,3,凱基-頭份,2023-12-19,9296
1736,喬山,3,0,3,凱基-頭份,2023-12-19,9296
00929,復華台灣科技優息,79,2,77,凱基-頭份,2023-12-20,9296
2886,兆豐金,46,0,46,凱基-頭份,2023-12-20,9296
00919,群益台灣精選高息,40,3,37,凱基-頭份,2023-12-20,9296
2101,南港,30,0,30,凱基-頭份,2023-12-20,9296
2515,中工,43,15,28,凱基-頭份,2023-12-20,9296
00905,FT臺灣Smart,20,0,20,凱基-頭份,2023-12-20,9296
00830,國泰費城半導體,19,0,19,凱基-頭份,2023-12-20,9296
2887,台新金,30,12,18,凱基-頭份,2023-12-20,9296
4414,如興,14,0,14,凱基-頭份,2023-12-20,9296
2421,建準,12,0,12,凱基-頭份,2023-12-20,9296
00679B,元大美債20年,12,1,11,凱基-頭份,2023-12-20,9296
00937B,群益ESG投等債20,14,3,11,凱基-頭份,2023-12-20,9296
6477,安集,16,5,11,凱基-頭份,2023-12-20,9296
00930,永豐ESG低碳高息,10,0,10,凱基-頭份,2023-12-20,9296
00898,國泰基因免疫革命,10,0,10,凱基-頭份,2023-12-20,9296
2105,正新,10,0,10,凱基-頭份,2023-12-20,9296
2892,第一金,9,0,9,凱基-頭份,2023-12-20,9296
2636,台驊控股,11,2,9,凱基-頭份,2023-12-20,9296
3051,力特,9,0,9,凱基-頭份,2023-12-20,9296
2801,彰銀,9,0,9,凱基-頭份,2023-12-20,9296
2891,中信金,10,2,8,凱基-頭份,2023-12-20,9296
3011,今皓,10,2,8,凱基-頭份,2023-12-20,9296
2365,昆盈,8,1,7,凱基-頭份,2023-12-20,9296
2493,揚博,7,0,7,凱基-頭份,2023-12-20,9296
00927,群益半導體收益,6,0,6,凱基-頭份,2023-12-20,9296
2387,精元,6,0,6,凱基-頭份,2023-12-20,9296
4164,承業醫,6,0,6,凱基-頭份,2023-12-20,9296
6179,亞通,6,0,6,凱基-頭份,2023-12-20,9296
00720B,元大投資級公司債,6,1,5,凱基-頭份,2023-12-20,9296
1210,大成,5,0,5,凱基-頭份,2023-12-20,9296
1524,耿鼎,5,0,5,凱基-頭份,2023-12-20,9296
1710,東聯,5,0,5,凱基-頭份,2023-12-20,9296
2328,廣宇,5,0,5,凱基-頭份,2023-12-20,9296
2618,長榮航,7,2,5,凱基-頭份,2023-12-20,9296
2880,華南金,5,0,5,凱基-頭份,2023-12-20,9296
3147,大綜,5,0,5,凱基-頭份,2023-12-20,9296
3526,凡甲,5,0,5,凱基-頭份,2023-12-20,9296
5251,天鉞電,5,0,5,凱基-頭份,2023-12-20,9296
1905,華紙,5,0,5,凱基-頭份,2023-12-20,9296
2345,智邦,7,3,4,凱基-頭份,2023-12-20,9296
3006,晶豪科,4,0,4,凱基-頭份,2023-12-20,9296
00936,台新永續高息中小,4,0,4,凱基-頭份,2023-12-20,9296
00900,富邦特選高股息30,5,1,4,凱基-頭份,2023-12-20,9296
2303,聯電,6,2,4,凱基-頭份,2023-12-20,9296
4746,台耀,4,0,4,凱基-頭份,2023-12-20,9296
5328,華容,4,0,4,凱基-頭份,2023-12-20,9296
6122,擎邦,4,0,4,凱基-頭份,2023-12-20,9296
00918,大華優利高填息30,5,1,4,凱基-頭份,2023-12-20,9296
2353,宏��,34,30,4,凱基-頭份,2023-12-20,9296
6274,台燿,5,2,3,凱基-頭份,2023-12-20,9296
00929,復華台灣科技優息,53,0,53,凱基-頭份,2023-12-21,9296
00680L,元大美債20正2,51,0,51,凱基-頭份,2023-12-21,9296
00919,群益台灣精選高息,55,9,46,凱基-頭份,2023-12-21,9296
2363,矽統,45,4,41,凱基-頭份,2023-12-21,9296
2606,裕民,38,0,38,凱基-頭份,2023-12-21,9296
1732,毛寶,52,15,37,凱基-頭份,2023-12-21,9296
9105,泰金寶-DR,30,1,29,凱基-頭份,2023-12-21,9296
2324,仁寶,43,16,27,凱基-頭份,2023-12-21,9296
9103,美德醫療-DR,24,0,24,凱基-頭份,2023-12-21,9296
2886,兆豐金,22,0,22,凱基-頭份,2023-12-21,9296
2362,藍天,24,2,22,凱基-頭份,2023-12-21,9296
2887,台新金,21,0,21,凱基-頭份,2023-12-21,9296
5608,四維航,40,20,20,凱基-頭份,2023-12-21,9296
2303,聯電,19,0,19,凱基-頭份,2023-12-21,9296
910861,神州-DR,18,0,18,凱基-頭份,2023-12-21,9296
00637L,元大滬深300正2,15,0,15,凱基-頭份,2023-12-21,9296
9933,中鼎,15,0,15,凱基-頭份,2023-12-21,9296
0056,元大高股息,14,0,14,凱基-頭份,2023-12-21,9296
1325,恆大,16,3,13,凱基-頭份,2023-12-21,9296
2634,漢翔,12,0,12,凱基-頭份,2023-12-21,9296
1101,台泥,11,0,11,凱基-頭份,2023-12-21,9296
2352,佳世達,13,2,11,凱基-頭份,2023-12-21,9296
00688L,國泰20年美債正2,10,0,10,凱基-頭份,2023-12-21,9296
1736,喬山,10,0,10,凱基-頭份,2023-12-21,9296
2801,彰銀,10,0,10,凱基-頭份,2023-12-21,9296
2883,凱基金,10,0,10,凱基-頭份,2023-12-21,9296
5439,高技,11,1,10,凱基-頭份,2023-12-21,9296
6461,益得,10,0,10,凱基-頭份,2023-12-21,9296
2014,中鴻,13,4,9,凱基-頭份,2023-12-21,9296
6219,富旺,10,1,9,凱基-頭份,2023-12-21,9296
00878,國泰永續高股息,13,5,8,凱基-頭份,2023-12-21,9296
2006,東和鋼鐵,12,5,7,凱基-頭份,2023-12-21,9296
2337,旺宏,7,0,7,凱基-頭份,2023-12-21,9296
2330,台積電,8,1,7,凱基-頭份,2023-12-21,9296
00933B,國泰10Y+金融債,6,0,6,凱基-頭份,2023-12-21,9296
3704,合勤控,12,6,6,凱基-頭份,2023-12-21,9296
5351,鈺創,8,2,6,凱基-頭份,2023-12-21,9296
8034,榮群,6,0,6,凱基-頭份,2023-12-21,9296
00664R,國泰臺灣加權反1,5,0,5,凱基-頭份,2023-12-21,9296
1210,大成,5,0,5,凱基-頭份,2023-12-21,9296
1504,東元,5,0,5,凱基-頭份,2023-12-21,9296
2338,光罩,5,0,5,凱基-頭份,2023-12-21,9296
3521,鴻翊,5,0,5,凱基-頭份,2023-12-21,9296
6117,迎廣,5,0,5,凱基-頭份,2023-12-21,9296
6140,訊達,5,0,5,凱基-頭份,2023-12-21,9296
6265,方土昶,5,0,5,凱基-頭份,2023-12-21,9296
2376,技嘉,4,0,4,凱基-頭份,2023-12-21,9296
2412,中華電,4,0,4,凱基-頭份,2023-12-21,9296
2630,亞航,7,3,4,凱基-頭份,2023-12-21,9296
2897,王道銀行,4,0,4,凱基-頭份,2023-12-21,9296
4414,如興,44,0,44,凱基-頭份,2023-12-22,9296
1301,台塑,22,0,22,凱基-頭份,2023-12-22,9296
2886,兆豐金,22,0,22,凱基-頭份,2023-12-22,9296
2105,正新,26,5,21,凱基-頭份,2023-12-22,9296
6226,光鼎,20,0,20,凱基-頭份,2023-12-22,9296
2301,光寶科,20,1,19,凱基-頭份,2023-12-22,9296
00937B,群益ESG投等債20,19,1,18,凱基-頭份,2023-12-22,9296
2313,華通,21,3,18,凱基-頭份,2023-12-22,9296
00878,國泰永續高股息,19,3,16,凱基-頭份,2023-12-22,9296
2887,台新金,13,0,13,凱基-頭份,2023-12-22,9296
2633,台灣高鐵,13,0,13,凱基-頭份,2023-12-22,9296
3013,晟銘電,15,2,13,凱基-頭份,2023-12-22,9296
5351,鈺創,15,3,12,凱基-頭份,2023-12-22,9296
8110,華東,14,2,12,凱基-頭份,2023-12-22,9296
2409,友達,24,13,11,凱基-頭份,2023-12-22,9296
2888,新光金,11,0,11,凱基-頭份,2023-12-22,9296
6742,澤米,14,3,11,凱基-頭份,2023-12-22,9296
8076,伍豐,10,0,10,凱基-頭份,2023-12-22,9296
2547,日勝生,10,0,10,凱基-頭份,2023-12-22,9296
2641,正德,30,20,10,凱基-頭份,2023-12-22,9296
3041,揚智,10,0,10,凱基-頭份,2023-12-22,9296
00882,中信中國高股息,10,0,10,凱基-頭份,2023-12-22,9296
00650L,復華香港正2,10,0,10,凱基-頭份,2023-12-22,9296
00923,群益台ESG低碳50,10,0,10,凱基-頭份,2023-12-22,9296
1905,華紙,10,0,10,凱基-頭份,2023-12-22,9296
2362,藍天,10,0,10,凱基-頭份,2023-12-22,9296
2363,矽統,12,2,10,凱基-頭份,2023-12-22,9296
00919,群益台灣精選高息,12,3,9,凱基-頭份,2023-12-22,9296
6191,精成科,8,0,8,凱基-頭份,2023-12-22,9296
1609,大亞,10,2,8,凱基-頭份,2023-12-22,9296
2014,中鴻,8,0,8,凱基-頭份,2023-12-22,9296
0056,元大高股息,8,0,8,凱基-頭份,2023-12-22,9296
1303,南亞,7,0,7,凱基-頭份,2023-12-22,9296
00713,元大台灣高息低波,6,0,6,凱基-頭份,2023-12-22,9296
2323,中環,6,0,6,凱基-頭份,2023-12-22,9296
3149,正達,6,0,6,凱基-頭份,2023-12-22,9296
8926,台汽電,6,0,6,凱基-頭份,2023-12-22,9296
1326,台化,5,0,5,凱基-頭份,2023-12-22,9296
2338,光罩,5,0,5,凱基-頭份,2023-12-22,9296
3363,上詮,5,0,5,凱基-頭份,2023-12-22,9296
2324,仁寶,13,8,5,凱基-頭份,2023-12-22,9296
2449,京元電子,8,3,5,凱基-頭份,2023-12-22,9296
4167,松瑞藥,5,0,5,凱基-頭份,2023-12-22,9296
5388,中磊,5,0,5,凱基-頭份,2023-12-22,9296
2890,永豐金,4,0,4,凱基-頭份,2023-12-22,9296
3276,宇環,5,1,4,凱基-頭份,2023-12-22,9296
1524,耿鼎,4,0,4,凱基-頭份,2023-12-22,9296
2201,裕隆,6,2,4,凱基-頭份,2023-12-22,9296
2516,新建,4,0,4,凱基-頭份,2023-12-22,9296
4174,浩鼎,4,0,4,凱基-頭份,2023-12-22,9296
00931B,統一美債20年,434,0,434,凱基-頭份,2023-12-25,9296
2609,陽明,151,86,65,凱基-頭份,2023-12-25,9296
912000,晨訊科-DR,64,0,64,凱基-頭份,2023-12-25,9296
00919,群益台灣精選高息,75,13,62,凱基-頭份,2023-12-25,9296
00929,復華台灣科技優息,28,0,28,凱基-頭份,2023-12-25,9296
4123,晟德,21,0,21,凱基-頭份,2023-12-25,9296
2636,台驊控股,19,1,18,凱基-頭份,2023-12-25,9296
1514,亞力,17,0,17,凱基-頭份,2023-12-25,9296
0056,元大高股息,33,19,14,凱基-頭份,2023-12-25,9296
00687B,國泰20年美債,13,0,13,凱基-頭份,2023-12-25,9296
8101,華冠,13,0,13,凱基-頭份,2023-12-25,9296
00937B,群益ESG投等債20,12,0,12,凱基-頭份,2023-12-25,9296
00936,台新永續高息中小,12,0,12,凱基-頭份,2023-12-25,9296
00882,中信中國高股息,12,0,12,凱基-頭份,2023-12-25,9296
4973,廣穎,11,0,11,凱基-頭份,2023-12-25,9296
3540,曜越,11,0,11,凱基-頭份,2023-12-25,9296
2603,長榮,76,66,10,凱基-頭份,2023-12-25,9296
00878,國泰永續高股息,45,35,10,凱基-頭份,2023-12-25,9296
1589,永冠-KY,10,0,10,凱基-頭份,2023-12-25,9296
2017,官田鋼,20,10,10,凱基-頭份,2023-12-25,9296
2888,新光金,10,0,10,凱基-頭份,2023-12-25,9296
3450,聯鈞,10,0,10,凱基-頭份,2023-12-25,9296
6535,順藥,10,0,10,凱基-頭份,2023-12-25,9296
2105,正新,10,1,9,凱基-頭份,2023-12-25,9296
2610,華航,12,3,9,凱基-頭份,2023-12-25,9296
6196,帆宣,9,0,9,凱基-頭份,2023-12-25,9296
2405,輔信,8,0,8,凱基-頭份,2023-12-25,9296
2611,志信,10,2,8,凱基-頭份,2023-12-25,9296
6117,迎廣,21,13,8,凱基-頭份,2023-12-25,9296
2516,新建,7,0,7,凱基-頭份,2023-12-25,9296
8088,品安,15,8,7,凱基-頭份,2023-12-25,9296
1795,美時,6,0,6,凱基-頭份,2023-12-25,9296
00679B,元大美債20年,6,0,6,凱基-頭份,2023-12-25,9296
6492,生華科,6,0,6,凱基-頭份,2023-12-25,9296
3521,鴻翊,6,0,6,凱基-頭份,2023-12-25,9296
5469,瀚宇博,6,0,6,凱基-頭份,2023-12-25,9296
9105,泰金寶-DR,16,10,6,凱基-頭份,2023-12-25,9296
00671R,富邦NASDAQ反1,5,0,5,凱基-頭份,2023-12-25,9296
00720B,元大投資級公司債,5,0,5,凱基-頭份,2023-12-25,9296
00788B,元大10年IG電能債,5,0,5,凱基-頭份,2023-12-25,9296
1609,大亞,10,5,5,凱基-頭份,2023-12-25,9296
2027,大成鋼,5,0,5,凱基-頭份,2023-12-25,9296
2409,友達,7,2,5,凱基-頭份,2023-12-25,9296
2884,玉山金,5,0,5,凱基-頭份,2023-12-25,9296
3652,精聯,5,0,5,凱基-頭份,2023-12-25,9296
4726,永昕,5,0,5,凱基-頭份,2023-12-25,9296
6237,驊訊,6,1,5,凱基-頭份,2023-12-25,9296
6668,中揚光,5,0,5,凱基-頭份,2023-12-25,9296
2014,中鴻,10,6,4,凱基-頭份,2023-12-25,9296
2388,威盛,8,4,4,凱基-頭份,2023-12-25,9296
00931B,統一美債20年,506,0,506,凱基-頭份,2023-12-26,9296
00632R,元大台灣50反1,105,0,105,凱基-頭份,2023-12-26,9296
8088,品安,50,0,50,凱基-頭份,2023-12-26,9296
3710,連展投控,45,0,45,凱基-頭份,2023-12-26,9296
4414,如興,44,0,44,凱基-頭份,2023-12-26,9296
3051,力特,41,0,41,凱基-頭份,2023-12-26,9296
5608,四維航,40,0,40,凱基-頭份,2023-12-26,9296
00679B,元大美債20年,32,0,32,凱基-頭份,2023-12-26,9296
00934,中信成長高股息,32,0,32,凱基-頭份,2023-12-26,9296
2353,宏��,37,13,24,凱基-頭份,2023-12-26,9296
8101,華冠,21,0,21,凱基-頭份,2023-12-26,9296
00929,復華台灣科技優息,36,17,19,凱基-頭份,2023-12-26,9296
00933B,國泰10Y+金融債,16,0,16,凱基-頭份,2023-12-26,9296
2610,華航,33,21,12,凱基-頭份,2023-12-26,9296
00687B,國泰20年美債,10,0,10,凱基-頭份,2023-12-26,9296
00673R,期元大S＆P原油反1,10,0,10,凱基-頭份,2023-12-26,9296
2399,映泰,10,0,10,凱基-頭份,2023-12-26,9296
6442,光聖,10,0,10,凱基-頭份,2023-12-26,9296
2630,亞航,7,0,7,凱基-頭份,2023-12-26,9296
00937B,群益ESG投等債20,8,2,6,凱基-頭份,2023-12-26,9296
6117,迎廣,14,8,6,凱基-頭份,2023-12-26,9296
6285,啟��,6,0,6,凱基-頭份,2023-12-26,9296
1325,恆大,5,0,5,凱基-頭份,2023-12-26,9296
1529,樂事綠能,5,0,5,凱基-頭份,2023-12-26,9296
1522,堤維西,5,0,5,凱基-頭份,2023-12-26,9296
00664R,國泰臺灣加權反1,5,0,5,凱基-頭份,2023-12-26,9296
2402,毅嘉,5,0,5,凱基-頭份,2023-12-26,9296
2633,台灣高鐵,5,0,5,凱基-頭份,2023-12-26,9296
2739,寒舍,5,0,5,凱基-頭份,2023-12-26,9296
3540,曜越,5,0,5,凱基-頭份,2023-12-26,9296
6756,威鋒電子,7,2,5,凱基-頭份,2023-12-26,9296
2382,廣達,65,60,5,凱基-頭份,2023-12-26,9296
00919,群益台灣精選高息,11,6,5,凱基-頭份,2023-12-26,9296
1519,華城,7,3,4,凱基-頭份,2023-12-26,9296
2603,長榮,12,8,4,凱基-頭份,2023-12-26,9296
2634,漢翔,5,1,4,凱基-頭份,2023-12-26,9296
2801,彰銀,4,0,4,凱基-頭份,2023-12-26,9296
6147,頎邦,5,1,4,凱基-頭份,2023-12-26,9296
5478,智冠,5,2,3,凱基-頭份,2023-12-26,9296
00788B,元大10年IG電能債,3,0,3,凱基-頭份,2023-12-26,9296
3006,晶豪科,73,70,3,凱基-頭份,2023-12-26,9296
3016,嘉晶,3,0,3,凱基-頭份,2023-12-26,9296
3380,明泰,3,0,3,凱基-頭份,2023-12-26,9296
3437,榮創,3,0,3,凱基-頭份,2023-12-26,9296
4953,緯軟,3,0,3,凱基-頭份,2023-12-26,9296
9103,美德醫療-DR,3,0,3,凱基-頭份,2023-12-26,9296
5328,華容,3,0,3,凱基-頭份,2023-12-26,9296
6237,驊訊,3,1,2,凱基-頭份,2023-12-26,9296
1568,倉佑,2,0,2,凱基-頭份,2023-12-26,9296
2324,仁寶,37,35,2,凱基-頭份,2023-12-26,9296
00937B,群益ESG投等債20,69,0,69,凱基-頭份,2023-12-27,9296
00632R,元大台灣50反1,67,0,67,凱基-頭份,2023-12-27,9296
3149,正達,60,0,60,凱基-頭份,2023-12-27,9296
2867,三商壽,60,0,60,凱基-頭份,2023-12-27,9296
2353,宏��,104,53,51,凱基-頭份,2023-12-27,9296
8088,品安,52,6,46,凱基-頭份,2023-12-27,9296
4939,亞電,40,0,40,凱基-頭份,2023-12-27,9296
00795B,中信美國公債20年,38,0,38,凱基-頭份,2023-12-27,9296
2610,華航,35,4,31,凱基-頭份,2023-12-27,9296
2101,南港,30,0,30,凱基-頭份,2023-12-27,9296
1609,大亞,30,2,28,凱基-頭份,2023-12-27,9296
00931B,統一美債20年,23,0,23,凱基-頭份,2023-12-27,9296
00720B,元大投資級公司債,22,0,22,凱基-頭份,2023-12-27,9296
00929,復華台灣科技優息,20,0,20,凱基-頭份,2023-12-27,9296
1101,台泥,20,0,20,凱基-頭份,2023-12-27,9296
2618,長榮航,27,10,17,凱基-頭份,2023-12-27,9296
3051,力特,15,0,15,凱基-頭份,2023-12-27,9296
2374,佳能,14,0,14,凱基-頭份,2023-12-27,9296
00882,中信中國高股息,12,0,12,凱基-頭份,2023-12-27,9296
2369,菱生,15,3,12,凱基-頭份,2023-12-27,9296
2636,台驊控股,13,1,12,凱基-頭份,2023-12-27,9296
00919,群益台灣精選高息,17,6,11,凱基-頭份,2023-12-27,9296
00712,復華富時不動產,10,0,10,凱基-頭份,2023-12-27,9296
4960,誠美材,10,0,10,凱基-頭份,2023-12-27,9296
00637L,元大滬深300正2,10,0,10,凱基-頭份,2023-12-27,9296
1733,五鼎,13,3,10,凱基-頭份,2023-12-27,9296
00675L,富邦臺灣加權正2,9,0,9,凱基-頭份,2023-12-27,9296
4743,合一,9,0,9,凱基-頭份,2023-12-27,9296
00687B,國泰20年美債,8,0,8,凱基-頭份,2023-12-27,9296
912000,晨訊科-DR,8,0,8,凱基-頭份,2023-12-27,9296
3592,瑞鼎,8,1,7,凱基-頭份,2023-12-27,9296
3704,合勤控,37,30,7,凱基-頭份,2023-12-27,9296
5302,太欣,9,2,7,凱基-頭份,2023-12-27,9296
6139,亞翔,10,4,6,凱基-頭份,2023-12-27,9296
8110,華東,7,1,6,凱基-頭份,2023-12-27,9296
2633,台灣高鐵,5,0,5,凱基-頭份,2023-12-27,9296
1436,華友聯,5,0,5,凱基-頭份,2023-12-27,9296
00915,凱基優選高股息30,5,0,5,凱基-頭份,2023-12-27,9296
1513,中興電,5,0,5,凱基-頭份,2023-12-27,9296
4162,智擎,7,2,5,凱基-頭份,2023-12-27,9296
00877,復華中國5G,4,0,4,凱基-頭份,2023-12-27,9296
00788B,元大10年IG電能債,4,0,4,凱基-頭份,2023-12-27,9296
2367,燿華,4,0,4,凱基-頭份,2023-12-27,9296
3078,僑威,4,0,4,凱基-頭份,2023-12-27,9296
6133,金橋,4,0,4,凱基-頭份,2023-12-27,9296
8059,凱碩,5,1,4,凱基-頭份,2023-12-27,9296
8926,台汽電,4,0,4,凱基-頭份,2023-12-27,9296
5351,鈺創,6,2,4,凱基-頭份,2023-12-27,9296
00679B,元大美債20年,3,0,3,凱基-頭份,2023-12-27,9296
6770,力積電,3,0,3,凱基-頭份,2023-12-27,9296
2337,旺宏,200,0,200,凱基-頭份,2023-12-28,9296
2882,國泰金,50,0,50,凱基-頭份,2023-12-28,9296
00719B,元大美債1-3,50,0,50,凱基-頭份,2023-12-28,9296
2101,南港,41,2,39,凱基-頭份,2023-12-28,9296
1513,中興電,61,22,39,凱基-頭份,2023-12-28,9296
3706,神達,45,17,28,凱基-頭份,2023-12-28,9296
00919,群益台灣精選高息,26,0,26,凱基-頭份,2023-12-28,9296
00933B,國泰10Y+金融債,26,0,26,凱基-頭份,2023-12-28,9296
00937B,群益ESG投等債20,65,40,25,凱基-頭份,2023-12-28,9296
2515,中工,27,2,25,凱基-頭份,2023-12-28,9296
2353,宏��,83,60,23,凱基-頭份,2023-12-28,9296
00634R,富邦上証反1,20,0,20,凱基-頭份,2023-12-28,9296
6523,達爾膚,20,0,20,凱基-頭份,2023-12-28,9296
00637L,元大滬深300正2,26,11,15,凱基-頭份,2023-12-28,9296
3149,正達,15,0,15,凱基-頭份,2023-12-28,9296
9105,泰金寶-DR,14,0,14,凱基-頭份,2023-12-28,9296
5608,四維航,13,0,13,凱基-頭份,2023-12-28,9296
00882,中信中國高股息,12,0,12,凱基-頭份,2023-12-28,9296
2610,華航,12,0,12,凱基-頭份,2023-12-28,9296
00900,富邦特選高股息30,12,0,12,凱基-頭份,2023-12-28,9296
2324,仁寶,33,22,11,凱基-頭份,2023-12-28,9296
2812,台中銀,12,1,11,凱基-頭份,2023-12-28,9296
3701,大眾控,15,4,11,凱基-頭份,2023-12-28,9296
6125,廣運,14,3,11,凱基-頭份,2023-12-28,9296
00931B,統一美債20年,10,0,10,凱基-頭份,2023-12-28,9296
00665L,富邦�琤肭磪囓�2,10,0,10,凱基-頭份,2023-12-28,9296
3491,昇達科,10,0,10,凱基-頭份,2023-12-28,9296
3704,合勤控,11,1,10,凱基-頭份,2023-12-28,9296
6179,亞通,15,5,10,凱基-頭份,2023-12-28,9296
8110,華東,10,0,10,凱基-頭份,2023-12-28,9296
3231,緯創,26,16,10,凱基-頭份,2023-12-28,9296
1514,亞力,14,5,9,凱基-頭份,2023-12-28,9296
2611,志信,8,0,8,凱基-頭份,2023-12-28,9296
6276,安鈦克,8,1,7,凱基-頭份,2023-12-28,9296
2409,友達,10,4,6,凱基-頭份,2023-12-28,9296
2436,偉詮電,10,4,6,凱基-頭份,2023-12-28,9296
6285,啟��,6,0,6,凱基-頭份,2023-12-28,9296
00902,中信電池及儲能,5,0,5,凱基-頭份,2023-12-28,9296
2547,日勝生,5,0,5,凱基-頭份,2023-12-28,9296
2633,台灣高鐵,5,0,5,凱基-頭份,2023-12-28,9296
3035,智原,5,0,5,凱基-頭份,2023-12-28,9296
6226,光鼎,5,0,5,凱基-頭份,2023-12-28,9296
8926,台汽電,5,0,5,凱基-頭份,2023-12-28,9296
00772B,中信高評級公司債,4,0,4,凱基-頭份,2023-12-28,9296
2331,精英,20,16,4,凱基-頭份,2023-12-28,9296
2367,燿華,4,0,4,凱基-頭份,2023-12-28,9296
2609,陽明,16,12,4,凱基-頭份,2023-12-28,9296
3205,佰研,4,0,4,凱基-頭份,2023-12-28,9296
4979,華星光,9,5,4,凱基-頭份,2023-12-28,9296
5425,台半,5,1,4,凱基-頭份,2023-12-28,9296
2344,華邦電,329,209,120,凱基-頭份,2023-12-29,9296
00882,中信中國高股息,72,0,72,凱基-頭份,2023-12-29,9296
00679B,元大美債20年,53,0,53,凱基-頭份,2023-12-29,9296
00687B,國泰20年美債,49,0,49,凱基-頭份,2023-12-29,9296
00931B,統一美債20年,41,0,41,凱基-頭份,2023-12-29,9296
1909,榮成,33,0,33,凱基-頭份,2023-12-29,9296
00929,復華台灣科技優息,31,0,31,凱基-頭份,2023-12-29,9296
6125,廣運,33,6,27,凱基-頭份,2023-12-29,9296
2105,正新,21,0,21,凱基-頭份,2023-12-29,9296
2888,新光金,20,0,20,凱基-頭份,2023-12-29,9296
3450,聯鈞,20,0,20,凱基-頭份,2023-12-29,9296
5011,久陽,20,0,20,凱基-頭份,2023-12-29,9296
1609,大亞,21,2,19,凱基-頭份,2023-12-29,9296
2352,佳世達,28,10,18,凱基-頭份,2023-12-29,9296
00937B,群益ESG投等債20,27,13,14,凱基-頭份,2023-12-29,9296
1589,永冠-KY,13,0,13,凱基-頭份,2023-12-29,9296
2345,智邦,15,3,12,凱基-頭份,2023-12-29,9296
3094,聯傑,11,0,11,凱基-頭份,2023-12-29,9296
1503,士電,11,1,10,凱基-頭份,2023-12-29,9296
00642U,期元大S＆P石油,10,0,10,凱基-頭份,2023-12-29,9296
2615,萬海,10,0,10,凱基-頭份,2023-12-29,9296
8076,伍豐,9,0,9,凱基-頭份,2023-12-29,9296
2605,新興,10,1,9,凱基-頭份,2023-12-29,9296
2421,建準,11,3,8,凱基-頭份,2023-12-29,9296
8011,台通,12,4,8,凱基-頭份,2023-12-29,9296
00680L,元大美債20正2,7,0,7,凱基-頭份,2023-12-29,9296
1519,華城,12,5,7,凱基-頭份,2023-12-29,9296
2401,凌陽,7,0,7,凱基-頭份,2023-12-29,9296
2610,華航,7,0,7,凱基-頭份,2023-12-29,9296
5469,瀚宇博,10,3,7,凱基-頭份,2023-12-29,9296
2356,英業達,26,20,6,凱基-頭份,2023-12-29,9296
6443,元晶,6,0,6,凱基-頭份,2023-12-29,9296
2883,凱基金,6,1,5,凱基-頭份,2023-12-29,9296
1447,力鵬,5,0,5,凱基-頭份,2023-12-29,9296
00905,FT臺灣Smart,5,0,5,凱基-頭份,2023-12-29,9296
00924,復華S＆P500成長,5,0,5,凱基-頭份,2023-12-29,9296
00671R,富邦NASDAQ反1,5,0,5,凱基-頭份,2023-12-29,9296
2547,日勝生,5,0,5,凱基-頭份,2023-12-29,9296
2880,華南金,5,0,5,凱基-頭份,2023-12-29,9296
3588,通嘉,5,0,5,凱基-頭份,2023-12-29,9296
5244,弘凱,5,0,5,凱基-頭份,2023-12-29,9296
8096,擎亞,6,1,5,凱基-頭份,2023-12-29,9296
00752,中信中國50,4,0,4,凱基-頭份,2023-12-29,9296
2331,精英,19,15,4,凱基-頭份,2023-12-29,9296
2748,雲品,19,15,4,凱基-頭份,2023-12-29,9296
3706,神達,9,5,4,凱基-頭份,2023-12-29,9296
6233,旺玖,5,1,4,凱基-頭份,2023-12-29,9296
6742,澤米,5,1,4,凱基-頭份,2023-12-29,9296
3006,晶豪科,13,10,3,凱基-頭份,2023-12-29,9296
00637L,元大滬深300正2,15,12,3,凱基-頭份,2023-12-29,9296
00937B,群益ESG投等債20,90,0,90,凱基-頭份,2024-01-02,9296
4414,如興,62,0,62,凱基-頭份,2024-01-02,9296
2515,中工,54,2,52,凱基-頭份,2024-01-02,9296
00929,復華台灣科技優息,40,0,40,凱基-頭份,2024-01-02,9296
1325,恆大,36,0,36,凱基-頭份,2024-01-02,9296
00720B,元大投資級公司債,29,0,29,凱基-頭份,2024-01-02,9296
2615,萬海,26,1,25,凱基-頭份,2024-01-02,9296
3231,緯創,49,26,23,凱基-頭份,2024-01-02,9296
2345,智邦,22,0,22,凱基-頭份,2024-01-02,9296
2888,新光金,22,0,22,凱基-頭份,2024-01-02,9296
3710,連展投控,22,0,22,凱基-頭份,2024-01-02,9296
00751B,元大AAA至A公司債,16,0,16,凱基-頭份,2024-01-02,9296
00923,群益台ESG低碳50,12,0,12,凱基-頭份,2024-01-02,9296
8110,華東,12,0,12,凱基-頭份,2024-01-02,9296
2449,京元電子,16,5,11,凱基-頭份,2024-01-02,9296
5515,建國,12,1,11,凱基-頭份,2024-01-02,9296
2883,凱基金,10,0,10,凱基-頭份,2024-01-02,9296
2317,鴻海,13,3,10,凱基-頭份,2024-01-02,9296
1337,再生-KY,10,0,10,凱基-頭份,2024-01-02,9296
00898,國泰基因免疫革命,10,0,10,凱基-頭份,2024-01-02,9296
00637L,元大滬深300正2,11,1,10,凱基-頭份,2024-01-02,9296
00687B,國泰20年美債,10,0,10,凱基-頭份,2024-01-02,9296
3024,憶聲,10,0,10,凱基-頭份,2024-01-02,9296
3450,聯鈞,10,0,10,凱基-頭份,2024-01-02,9296
4726,永昕,9,0,9,凱基-頭份,2024-01-02,9296
5351,鈺創,11,2,9,凱基-頭份,2024-01-02,9296
6196,帆宣,9,1,8,凱基-頭份,2024-01-02,9296
6438,迅得,8,0,8,凱基-頭份,2024-01-02,9296
9945,潤泰新,10,3,7,凱基-頭份,2024-01-02,9296
5347,世界,6,0,6,凱基-頭份,2024-01-02,9296
00680L,元大美債20正2,7,2,5,凱基-頭份,2024-01-02,9296
00671R,富邦NASDAQ反1,5,0,5,凱基-頭份,2024-01-02,9296
2417,圓剛,5,0,5,凱基-頭份,2024-01-02,9296
5321,美而快,5,0,5,凱基-頭份,2024-01-02,9296
6770,力積電,5,0,5,凱基-頭份,2024-01-02,9296
8112,至上,7,2,5,凱基-頭份,2024-01-02,9296
2303,聯電,6,2,4,凱基-頭份,2024-01-02,9296
2812,台中銀,5,1,4,凱基-頭份,2024-01-02,9296
00921,兆豐龍頭等權重,4,0,4,凱基-頭份,2024-01-02,9296
3005,神基,4,0,4,凱基-頭份,2024-01-02,9296
3051,力特,5,1,4,凱基-頭份,2024-01-02,9296
4161,聿新科,4,0,4,凱基-頭份,2024-01-02,9296
4915,致伸,8,4,4,凱基-頭份,2024-01-02,9296
00918,大華優利高填息30,10,7,3,凱基-頭份,2024-01-02,9296
00905,FT臺灣Smart,3,0,3,凱基-頭份,2024-01-02,9296
00764B,群益25年美債,3,0,3,凱基-頭份,2024-01-02,9296
00696B,富邦美債20年,3,0,3,凱基-頭份,2024-01-02,9296
1905,華紙,3,0,3,凱基-頭份,2024-01-02,9296
2609,陽明,54,51,3,凱基-頭份,2024-01-02,9296
5425,台半,5,2,3,凱基-頭份,2024-01-02,9296
00929,復華台灣科技優息,215,4,211,凱基-頭份,2024-01-03,9296
00919,群益台灣精選高息,93,6,87,凱基-頭份,2024-01-03,9296
2344,華邦電,66,7,59,凱基-頭份,2024-01-03,9296
00882,中信中國高股息,46,0,46,凱基-頭份,2024-01-03,9296
2618,長榮航,98,55,43,凱基-頭份,2024-01-03,9296
00934,中信成長高股息,34,0,34,凱基-頭份,2024-01-03,9296
2363,矽統,34,2,32,凱基-頭份,2024-01-03,9296
00637L,元大滬深300正2,30,0,30,凱基-頭份,2024-01-03,9296
3481,群創,32,2,30,凱基-頭份,2024-01-03,9296
00915,凱基優選高股息30,27,0,27,凱基-頭份,2024-01-03,9296
9925,新保,26,0,26,凱基-頭份,2024-01-03,9296
0056,元大高股息,33,10,23,凱基-頭份,2024-01-03,9296
2886,兆豐金,23,0,23,凱基-頭份,2024-01-03,9296
2323,中環,20,0,20,凱基-頭份,2024-01-03,9296
2332,友訊,20,0,20,凱基-頭份,2024-01-03,9296
00937B,群益ESG投等債20,15,0,15,凱基-頭份,2024-01-03,9296
00679B,元大美債20年,15,0,15,凱基-頭份,2024-01-03,9296
00918,大華優利高填息30,16,4,12,凱基-頭份,2024-01-03,9296
00753L,中信中國50正2,12,0,12,凱基-頭份,2024-01-03,9296
00636,國泰中國A50,12,0,12,凱基-頭份,2024-01-03,9296
4726,永昕,12,0,12,凱基-頭份,2024-01-03,9296
5880,合庫金,12,0,12,凱基-頭份,2024-01-03,9296
2883,凱基金,11,0,11,凱基-頭份,2024-01-03,9296
2362,藍天,26,15,11,凱基-頭份,2024-01-03,9296
2888,新光金,11,0,11,凱基-頭份,2024-01-03,9296
3450,聯鈞,10,0,10,凱基-頭份,2024-01-03,9296
2009,第一銅,10,0,10,凱基-頭份,2024-01-03,9296
2356,英業達,23,13,10,凱基-頭份,2024-01-03,9296
3664,安瑞-KY,10,0,10,凱基-頭份,2024-01-03,9296
4123,晟德,15,5,10,凱基-頭份,2024-01-03,9296
2330,台積電,9,1,8,凱基-頭份,2024-01-03,9296
9105,泰金寶-DR,8,0,8,凱基-頭份,2024-01-03,9296
00680L,元大美債20正2,6,0,6,凱基-頭份,2024-01-03,9296
5388,中磊,8,2,6,凱基-頭份,2024-01-03,9296
6184,大豐電,6,0,6,凱基-頭份,2024-01-03,9296
00881,國泰台灣5G+,5,0,5,凱基-頭份,2024-01-03,9296
2376,技嘉,9,4,5,凱基-頭份,2024-01-03,9296
3005,神基,5,0,5,凱基-頭份,2024-01-03,9296
00720B,元大投資級公司債,5,0,5,凱基-頭份,2024-01-03,9296
00641R,富邦日本反1,5,0,5,凱基-頭份,2024-01-03,9296
2101,南港,5,0,5,凱基-頭份,2024-01-03,9296
2102,泰豐,5,0,5,凱基-頭份,2024-01-03,9296
2338,光罩,5,0,5,凱基-頭份,2024-01-03,9296
2340,台亞,5,0,5,凱基-頭份,2024-01-03,9296
2845,遠東銀,5,0,5,凱基-頭份,2024-01-03,9296
4532,瑞智,5,0,5,凱基-頭份,2024-01-03,9296
5381,合正,5,0,5,凱基-頭份,2024-01-03,9296
8070,長華*,5,0,5,凱基-頭份,2024-01-03,9296
8110,華東,5,0,5,凱基-頭份,2024-01-03,9296
2206,三陽工業,8,4,4,凱基-頭份,2024-01-03,9296
00929,復華台灣科技優息,126,4,122,凱基-頭份,2024-01-04,9296
00641R,富邦日本反1,30,0,30,凱基-頭份,2024-01-04,9296
00937B,群益ESG投等債20,29,0,29,凱基-頭份,2024-01-04,9296
00878,國泰永續高股息,26,1,25,凱基-頭份,2024-01-04,9296
2352,佳世達,30,6,24,凱基-頭份,2024-01-04,9296
4123,晟德,25,2,23,凱基-頭份,2024-01-04,9296
0056,元大高股息,25,3,22,凱基-頭份,2024-01-04,9296
2887,台新金,22,0,22,凱基-頭份,2024-01-04,9296
2101,南港,20,2,18,凱基-頭份,2024-01-04,9296
00919,群益台灣精選高息,14,0,14,凱基-頭份,2024-01-04,9296
00720B,元大投資級公司債,13,0,13,凱基-頭份,2024-01-04,9296
6122,擎邦,13,0,13,凱基-頭份,2024-01-04,9296
2641,正德,13,1,12,凱基-頭份,2024-01-04,9296
2344,華邦電,194,183,11,凱基-頭份,2024-01-04,9296
3260,威剛,11,0,11,凱基-頭份,2024-01-04,9296
00636,國泰中國A50,10,0,10,凱基-頭份,2024-01-04,9296
2834,臺企銀,10,0,10,凱基-頭份,2024-01-04,9296
6443,元晶,10,0,10,凱基-頭份,2024-01-04,9296
2618,長榮航,28,19,9,凱基-頭份,2024-01-04,9296
2883,凱基金,10,2,8,凱基-頭份,2024-01-04,9296
00753L,中信中國50正2,8,0,8,凱基-頭份,2024-01-04,9296
00927,群益半導體收益,7,0,7,凱基-頭份,2024-01-04,9296
00882,中信中國高股息,7,0,7,凱基-頭份,2024-01-04,9296
3694,海華,7,0,7,凱基-頭份,2024-01-04,9296
3704,合勤控,11,4,7,凱基-頭份,2024-01-04,9296
6693,廣閎科,7,0,7,凱基-頭份,2024-01-04,9296
8110,華東,7,0,7,凱基-頭份,2024-01-04,9296
2317,鴻海,6,0,6,凱基-頭份,2024-01-04,9296
00687B,國泰20年美債,6,0,6,凱基-頭份,2024-01-04,9296
1736,喬山,6,0,6,凱基-頭份,2024-01-04,9296
3083,網龍,6,0,6,凱基-頭份,2024-01-04,9296
4967,十銓,10,4,6,凱基-頭份,2024-01-04,9296
9919,康那香,7,1,6,凱基-頭份,2024-01-04,9296
00680L,元大美債20正2,5,0,5,凱基-頭份,2024-01-04,9296
3450,聯鈞,5,0,5,凱基-頭份,2024-01-04,9296
00632R,元大台灣50反1,5,0,5,凱基-頭份,2024-01-04,9296
2014,中鴻,5,0,5,凱基-頭份,2024-01-04,9296
2031,新光鋼,5,0,5,凱基-頭份,2024-01-04,9296
2314,台揚,5,0,5,凱基-頭份,2024-01-04,9296
2547,日勝生,5,0,5,凱基-頭份,2024-01-04,9296
2612,中航,10,5,5,凱基-頭份,2024-01-04,9296
2613,中櫃,5,0,5,凱基-頭份,2024-01-04,9296
3380,明泰,5,0,5,凱基-頭份,2024-01-04,9296
3701,大眾控,5,0,5,凱基-頭份,2024-01-04,9296
5483,中美晶,6,1,5,凱基-頭份,2024-01-04,9296
6156,松上,5,0,5,凱基-頭份,2024-01-04,9296
6163,華電網,10,5,5,凱基-頭份,2024-01-04,9296
6201,亞弘電,5,0,5,凱基-頭份,2024-01-04,9296
6523,達爾膚,5,0,5,凱基-頭份,2024-01-04,9296
2449,京元電子,7,3,4,凱基-頭份,2024-01-04,9296
00929,復華台灣科技優息,51,3,48,凱基-頭份,2024-01-05,9296
00919,群益台灣精選高息,46,0,46,凱基-頭份,2024-01-05,9296
00679B,元大美債20年,30,0,30,凱基-頭份,2024-01-05,9296
2352,佳世達,36,6,30,凱基-頭份,2024-01-05,9296
2618,長榮航,45,16,29,凱基-頭份,2024-01-05,9296
00641R,富邦日本反1,20,0,20,凱基-頭份,2024-01-05,9296
2101,南港,20,0,20,凱基-頭份,2024-01-05,9296
3030,德律,25,6,19,凱基-頭份,2024-01-05,9296
00878,國泰永續高股息,19,1,18,凱基-頭份,2024-01-05,9296
3066,李洲,12,0,12,凱基-頭份,2024-01-05,9296
2324,仁寶,13,2,11,凱基-頭份,2024-01-05,9296
1720,生達,10,0,10,凱基-頭份,2024-01-05,9296
2332,友訊,10,0,10,凱基-頭份,2024-01-05,9296
00885,富邦越南,10,0,10,凱基-頭份,2024-01-05,9296
2611,志信,10,1,9,凱基-頭份,2024-01-05,9296
6770,力積電,43,34,9,凱基-頭份,2024-01-05,9296
00937B,群益ESG投等債20,28,20,8,凱基-頭份,2024-01-05,9296
2363,矽統,8,0,8,凱基-頭份,2024-01-05,9296
6274,台燿,8,0,8,凱基-頭份,2024-01-05,9296
00882,中信中國高股息,10,3,7,凱基-頭份,2024-01-05,9296
2613,中櫃,7,0,7,凱基-頭份,2024-01-05,9296
3706,神達,14,7,7,凱基-頭份,2024-01-05,9296
8033,雷虎,7,0,7,凱基-頭份,2024-01-05,9296
00687B,國泰20年美債,7,1,6,凱基-頭份,2024-01-05,9296
00770,國泰北美科技,6,0,6,凱基-頭份,2024-01-05,9296
2736,富野,6,0,6,凱基-頭份,2024-01-05,9296
9103,美德醫療-DR,6,0,6,凱基-頭份,2024-01-05,9296
00923,群益台ESG低碳50,6,1,5,凱基-頭份,2024-01-05,9296
00665L,富邦�琤肭磪囓�2,5,0,5,凱基-頭份,2024-01-05,9296
1733,五鼎,5,0,5,凱基-頭份,2024-01-05,9296
1736,喬山,5,0,5,凱基-頭份,2024-01-05,9296
2603,長榮,88,83,5,凱基-頭份,2024-01-05,9296
6108,競國,5,0,5,凱基-頭份,2024-01-05,9296
6117,迎廣,10,5,5,凱基-頭份,2024-01-05,9296
6164,華興,5,0,5,凱基-頭份,2024-01-05,9296
5425,台半,4,0,4,凱基-頭份,2024-01-05,9296
00713,元大台灣高息低波,3,0,3,凱基-頭份,2024-01-05,9296
00757,統一FANG+,3,0,3,凱基-頭份,2024-01-05,9296
8046,南電,3,0,3,凱基-頭份,2024-01-05,9296
6233,旺玖,3,0,3,凱基-頭份,2024-01-05,9296
2505,國揚,3,0,3,凱基-頭份,2024-01-05,9296
00933B,國泰10Y+金融債,3,0,3,凱基-頭份,2024-01-05,9296
1605,華新,3,0,3,凱基-頭份,2024-01-05,9296
2329,華泰,5,2,3,凱基-頭份,2024-01-05,9296
2331,精英,9,6,3,凱基-頭份,2024-01-05,9296
2349,錸德,3,0,3,凱基-頭份,2024-01-05,9296
2409,友達,5,2,3,凱基-頭份,2024-01-05,9296
3673,TPK-KY,3,0,3,凱基-頭份,2024-01-05,9296
4161,聿新科,3,0,3,凱基-頭份,2024-01-05,9296
4979,華星光,7,4,3,凱基-頭份,2024-01-05,9296
00929,復華台灣科技優息,301,0,301,凱基-頭份,2024-01-08,9296
2890,永豐金,265,0,265,凱基-頭份,2024-01-08,9296
2834,臺企銀,264,1,263,凱基-頭份,2024-01-08,9296
2855,統一證,200,1,199,凱基-頭份,2024-01-08,9296
6005,群益證,200,2,198,凱基-頭份,2024-01-08,9296
2337,旺宏,39,4,35,凱基-頭份,2024-01-08,9296
00679B,元大美債20年,32,0,32,凱基-頭份,2024-01-08,9296
2344,華邦電,37,5,32,凱基-頭份,2024-01-08,9296
00650L,復華香港正2,30,0,30,凱基-頭份,2024-01-08,9296
00858,永豐美國500大,20,0,20,凱基-頭份,2024-01-08,9296
2489,瑞軒,21,3,18,凱基-頭份,2024-01-08,9296
00637L,元大滬深300正2,17,0,17,凱基-頭份,2024-01-08,9296
00680L,元大美債20正2,17,1,16,凱基-頭份,2024-01-08,9296
3231,緯創,30,14,16,凱基-頭份,2024-01-08,9296
00687B,國泰20年美債,15,0,15,凱基-頭份,2024-01-08,9296
2014,中鴻,15,0,15,凱基-頭份,2024-01-08,9296
00937B,群益ESG投等債20,15,0,15,凱基-頭份,2024-01-08,9296
2610,華航,21,6,15,凱基-頭份,2024-01-08,9296
2543,皇昌,14,0,14,凱基-頭份,2024-01-08,9296
00933B,國泰10Y+金融債,12,0,12,凱基-頭份,2024-01-08,9296
00712,復華富時不動產,26,14,12,凱基-頭份,2024-01-08,9296
2101,南港,31,20,11,凱基-頭份,2024-01-08,9296
00636,國泰中國A50,10,0,10,凱基-頭份,2024-01-08,9296
00632R,元大台灣50反1,10,0,10,凱基-頭份,2024-01-08,9296
6118,建達,10,0,10,凱基-頭份,2024-01-08,9296
6443,元晶,9,0,9,凱基-頭份,2024-01-08,9296
8034,榮群,10,1,9,凱基-頭份,2024-01-08,9296
0056,元大高股息,9,0,9,凱基-頭份,2024-01-08,9296
6274,台燿,9,0,9,凱基-頭份,2024-01-08,9296
8112,至上,9,1,8,凱基-頭份,2024-01-08,9296
5410,國眾,7,0,7,凱基-頭份,2024-01-08,9296
3706,神達,13,6,7,凱基-頭份,2024-01-08,9296
00918,大華優利高填息30,6,0,6,凱基-頭份,2024-01-08,9296
00720B,元大投資級公司債,5,0,5,凱基-頭份,2024-01-08,9296
3704,合勤控,11,6,5,凱基-頭份,2024-01-08,9296
00665L,富邦�琤肭磪囓�2,5,0,5,凱基-頭份,2024-01-08,9296
00664R,國泰臺灣加權反1,5,0,5,凱基-頭份,2024-01-08,9296
00770,國泰北美科技,5,0,5,凱基-頭份,2024-01-08,9296
2607,榮運,5,0,5,凱基-頭份,2024-01-08,9296
2888,新光金,6,1,5,凱基-頭份,2024-01-08,9296
5383,金利,5,0,5,凱基-頭份,2024-01-08,9296
5531,鄉林,5,0,5,凱基-頭份,2024-01-08,9296
8033,雷虎,4,0,4,凱基-頭份,2024-01-08,9296
2408,南亞科,4,0,4,凱基-頭份,2024-01-08,9296
3086,華義,4,0,4,凱基-頭份,2024-01-08,9296
6282,康舒,4,0,4,凱基-頭份,2024-01-08,9296
6485,點序,10,6,4,凱基-頭份,2024-01-08,9296
3017,奇鋐,3,0,3,凱基-頭份,2024-01-08,9296
00878,國泰永續高股息,11,8,3,凱基-頭份,2024-01-08,9296
3046,建��,3,0,3,凱基-頭份,2024-01-08,9296
00919,群益台灣精選高息,175,2,173,凱基-頭份,2024-01-09,9296
2883,凱基金,52,0,52,凱基-頭份,2024-01-09,9296
2609,陽明,70,22,48,凱基-頭份,2024-01-09,9296
1736,喬山,45,0,45,凱基-頭份,2024-01-09,9296
00878,國泰永續高股息,34,1,33,凱基-頭份,2024-01-09,9296
2610,華航,31,0,31,凱基-頭份,2024-01-09,9296
00929,復華台灣科技優息,41,10,31,凱基-頭份,2024-01-09,9296
2344,華邦電,227,205,22,凱基-頭份,2024-01-09,9296
1316,上曜,20,0,20,凱基-頭份,2024-01-09,9296
2338,光罩,35,15,20,凱基-頭份,2024-01-09,9296
2634,漢翔,13,0,13,凱基-頭份,2024-01-09,9296
00918,大華優利高填息30,12,0,12,凱基-頭份,2024-01-09,9296
6116,彩晶,12,0,12,凱基-頭份,2024-01-09,9296
2615,萬海,14,3,11,凱基-頭份,2024-01-09,9296
00881,國泰台灣5G+,11,0,11,凱基-頭份,2024-01-09,9296
2323,中環,11,0,11,凱基-頭份,2024-01-09,9296
0056,元大高股息,13,2,11,凱基-頭份,2024-01-09,9296
3025,星通,29,19,10,凱基-頭份,2024-01-09,9296
00671R,富邦NASDAQ反1,10,0,10,凱基-頭份,2024-01-09,9296
00927,群益半導體收益,10,0,10,凱基-頭份,2024-01-09,9296
2303,聯電,10,0,10,凱基-頭份,2024-01-09,9296
5608,四維航,10,0,10,凱基-頭份,2024-01-09,9296
6757,台灣虎航,10,0,10,凱基-頭份,2024-01-09,9296
00931B,統一美債20年,9,0,9,凱基-頭份,2024-01-09,9296
00937B,群益ESG投等債20,9,0,9,凱基-頭份,2024-01-09,9296
1612,宏泰,9,0,9,凱基-頭份,2024-01-09,9296
2023,燁輝,9,0,9,凱基-頭份,2024-01-09,9296
4123,晟德,10,1,9,凱基-頭份,2024-01-09,9296
1732,毛寶,11,3,8,凱基-頭份,2024-01-09,9296
2349,錸德,8,0,8,凱基-頭份,2024-01-09,9296
3704,合勤控,21,13,8,凱基-頭份,2024-01-09,9296
8011,台通,8,0,8,凱基-頭份,2024-01-09,9296
2498,宏達電,16,9,7,凱基-頭份,2024-01-09,9296
2002,中鋼,7,0,7,凱基-頭份,2024-01-09,9296
2324,仁寶,26,19,7,凱基-頭份,2024-01-09,9296
2603,長榮,12,5,7,凱基-頭份,2024-01-09,9296
1721,三晃,6,0,6,凱基-頭份,2024-01-09,9296
2025,千興,6,0,6,凱基-頭份,2024-01-09,9296
2101,南港,6,0,6,凱基-頭份,2024-01-09,9296
2543,皇昌,6,0,6,凱基-頭份,2024-01-09,9296
00770,國泰北美科技,5,0,5,凱基-頭份,2024-01-09,9296
2363,矽統,30,25,5,凱基-頭份,2024-01-09,9296
00885,富邦越南,5,0,5,凱基-頭份,2024-01-09,9296
00632R,元大台灣50反1,5,0,5,凱基-頭份,2024-01-09,9296
2102,泰豐,5,0,5,凱基-頭份,2024-01-09,9296
2390,云辰,5,0,5,凱基-頭份,2024-01-09,9296
2409,友達,12,7,5,凱基-頭份,2024-01-09,9296
2486,一詮,6,1,5,凱基-頭份,2024-01-09,9296
00712,復華富時不動產,17,13,4,凱基-頭份,2024-01-09,9296
2211,長榮鋼,5,1,4,凱基-頭份,2024-01-09,9296
00929,復華台灣科技優息,65,3,62,凱基-頭份,2024-01-10,9296
00937B,群益ESG投等債20,62,0,62,凱基-頭份,2024-01-10,9296
00919,群益台灣精選高息,56,2,54,凱基-頭份,2024-01-10,9296
2609,陽明,62,9,53,凱基-頭份,2024-01-10,9296
00933B,國泰10Y+金融債,28,0,28,凱基-頭份,2024-01-10,9296
3704,合勤控,26,1,25,凱基-頭份,2024-01-10,9296
00650L,復華香港正2,40,20,20,凱基-頭份,2024-01-10,9296
00712,復華富時不動產,20,0,20,凱基-頭份,2024-01-10,9296
2887,台新金,15,0,15,凱基-頭份,2024-01-10,9296
5450,南良,15,0,15,凱基-頭份,2024-01-10,9296
00687B,國泰20年美債,13,0,13,凱基-頭份,2024-01-10,9296
3491,昇達科,12,0,12,凱基-頭份,2024-01-10,9296
3499,環天科,12,1,11,凱基-頭份,2024-01-10,9296
0056,元大高股息,13,2,11,凱基-頭份,2024-01-10,9296
1312,國喬,10,0,10,凱基-頭份,2024-01-10,9296
00905,FT臺灣Smart,10,0,10,凱基-頭份,2024-01-10,9296
00857B,永豐20年美公債,10,0,10,凱基-頭份,2024-01-10,9296
00641R,富邦日本反1,15,5,10,凱基-頭份,2024-01-10,9296
2388,威盛,9,1,8,凱基-頭份,2024-01-10,9296
5328,華容,8,0,8,凱基-頭份,2024-01-10,9296
00679B,元大美債20年,7,0,7,凱基-頭份,2024-01-10,9296
3025,星通,10,3,7,凱基-頭份,2024-01-10,9296
2630,亞航,8,1,7,凱基-頭份,2024-01-10,9296
00770,國泰北美科技,7,0,7,凱基-頭份,2024-01-10,9296
2345,智邦,6,0,6,凱基-頭份,2024-01-10,9296
2409,友達,8,2,6,凱基-頭份,2024-01-10,9296
8112,至上,6,0,6,凱基-頭份,2024-01-10,9296
00924,復華S＆P500成長,5,0,5,凱基-頭份,2024-01-10,9296
00885,富邦越南,5,0,5,凱基-頭份,2024-01-10,9296
2023,燁輝,5,0,5,凱基-頭份,2024-01-10,9296
2344,華邦電,8,3,5,凱基-頭份,2024-01-10,9296
2610,華航,5,0,5,凱基-頭份,2024-01-10,9296
2637,慧洋-KY,5,0,5,凱基-頭份,2024-01-10,9296
3031,佰鴻,5,0,5,凱基-頭份,2024-01-10,9296
3176,基亞,5,0,5,凱基-頭份,2024-01-10,9296
5426,振發,14,9,5,凱基-頭份,2024-01-10,9296
8096,擎亞,33,28,5,凱基-頭份,2024-01-10,9296
2618,長榮航,5,0,5,凱基-頭份,2024-01-10,9296
2603,長榮,5,0,5,凱基-頭份,2024-01-10,9296
2317,鴻海,4,0,4,凱基-頭份,2024-01-10,9296
2891,中信金,4,0,4,凱基-頭份,2024-01-10,9296
8227,巨有科技,6,2,4,凱基-頭份,2024-01-10,9296
00877,復華中國5G,4,0,4,凱基-頭份,2024-01-10,9296
1325,恆大,11,7,4,凱基-頭份,2024-01-10,9296
2402,毅嘉,4,0,4,凱基-頭份,2024-01-10,9296
2498,宏達電,6,2,4,凱基-頭份,2024-01-10,9296
3363,上詮,4,0,4,凱基-頭份,2024-01-10,9296
6112,邁達特,4,0,4,凱基-頭份,2024-01-10,9296
00907,永豐優息存股,3,0,3,凱基-頭份,2024-01-10,9296
1540,喬福,3,0,3,凱基-頭份,2024-01-10,9296
00929,復華台灣科技優息,353,1,352,凱基-頭份,2024-01-11,9296
6005,群益證,160,0,160,凱基-頭份,2024-01-11,9296
00933B,國泰10Y+金融債,100,0,100,凱基-頭份,2024-01-11,9296
2609,陽明,91,64,27,凱基-頭份,2024-01-11,9296
2002,中鋼,27,0,27,凱基-頭份,2024-01-11,9296
00937B,群益ESG投等債20,25,0,25,凱基-頭份,2024-01-11,9296
3694,海華,21,0,21,凱基-頭份,2024-01-11,9296
2344,華邦電,23,4,19,凱基-頭份,2024-01-11,9296
00919,群益台灣精選高息,15,0,15,凱基-頭份,2024-01-11,9296
6219,富旺,14,0,14,凱基-頭份,2024-01-11,9296
2610,華航,14,2,12,凱基-頭份,2024-01-11,9296
2356,英業達,14,3,11,凱基-頭份,2024-01-11,9296
2303,聯電,10,0,10,凱基-頭份,2024-01-11,9296
2542,興富發,10,0,10,凱基-頭份,2024-01-11,9296
00641R,富邦日本反1,10,0,10,凱基-頭份,2024-01-11,9296
2105,正新,10,0,10,凱基-頭份,2024-01-11,9296
2338,光罩,10,0,10,凱基-頭份,2024-01-11,9296
3491,昇達科,10,0,10,凱基-頭份,2024-01-11,9296
2453,凌群,19,11,8,凱基-頭份,2024-01-11,9296
00770,國泰北美科技,7,0,7,凱基-頭份,2024-01-11,9296
2449,京元電子,7,0,7,凱基-頭份,2024-01-11,9296
2867,三商壽,6,0,6,凱基-頭份,2024-01-11,9296
6139,亞翔,10,4,6,凱基-頭份,2024-01-11,9296
8937,合騏,6,0,6,凱基-頭份,2024-01-11,9296
00671R,富邦NASDAQ反1,5,0,5,凱基-頭份,2024-01-11,9296
1447,力鵬,5,0,5,凱基-頭份,2024-01-11,9296
4198,欣大健康,5,0,5,凱基-頭份,2024-01-11,9296
8054,安國,5,0,5,凱基-頭份,2024-01-11,9296
2409,友達,26,22,4,凱基-頭份,2024-01-11,9296
2890,永豐金,4,0,4,凱基-頭份,2024-01-11,9296
00881,國泰台灣5G+,4,0,4,凱基-頭份,2024-01-11,9296
1504,東元,4,0,4,凱基-頭份,2024-01-11,9296
2023,燁輝,4,0,4,凱基-頭份,2024-01-11,9296
2329,華泰,7,3,4,凱基-頭份,2024-01-11,9296
2362,藍天,4,0,4,凱基-頭份,2024-01-11,9296
2421,建準,7,3,4,凱基-頭份,2024-01-11,9296
4183,福永生技,4,0,4,凱基-頭份,2024-01-11,9296
6170,統振,4,0,4,凱基-頭份,2024-01-11,9296
00637L,元大滬深300正2,3,0,3,凱基-頭份,2024-01-11,9296
2101,南港,3,0,3,凱基-頭份,2024-01-11,9296
2882,國泰金,3,0,3,凱基-頭份,2024-01-11,9296
3287,廣寰科,8,5,3,凱基-頭份,2024-01-11,9296
4162,智擎,3,0,3,凱基-頭份,2024-01-11,9296
6188,廣明,3,0,3,凱基-頭份,2024-01-11,9296
6282,康舒,3,0,3,凱基-頭份,2024-01-11,9296
3055,蔚華科,3,0,3,凱基-頭份,2024-01-11,9296
1519,華城,9,7,2,凱基-頭份,2024-01-11,9296
9927,泰銘,2,0,2,凱基-頭份,2024-01-11,9296
2408,南亞科,4,2,2,凱基-頭份,2024-01-11,9296
1436,華友聯,2,0,2,凱基-頭份,2024-01-11,9296
00929,復華台灣科技優息,121,32,89,凱基-頭份,2024-01-12,9296
2101,南港,33,0,33,凱基-頭份,2024-01-12,9296
3066,李洲,23,2,21,凱基-頭份,2024-01-12,9296
00680L,元大美債20正2,20,0,20,凱基-頭份,2024-01-12,9296
3704,合勤控,20,0,20,凱基-頭份,2024-01-12,9296
1316,上曜,20,0,20,凱基-頭份,2024-01-12,9296
00753L,中信中國50正2,17,0,17,凱基-頭份,2024-01-12,9296
0056,元大高股息,20,4,16,凱基-頭份,2024-01-12,9296
2353,宏��,32,16,16,凱基-頭份,2024-01-12,9296
00725B,國泰投資級公司債,17,2,15,凱基-頭份,2024-01-12,9296
6209,今國光,15,0,15,凱基-頭份,2024-01-12,9296
00712,復華富時不動產,13,0,13,凱基-頭份,2024-01-12,9296
1324,地球,13,0,13,凱基-頭份,2024-01-12,9296
00919,群益台灣精選高息,12,0,12,凱基-頭份,2024-01-12,9296
00641R,富邦日本反1,20,10,10,凱基-頭份,2024-01-12,9296
00637L,元大滬深300正2,10,0,10,凱基-頭份,2024-01-12,9296
00650L,復華香港正2,20,10,10,凱基-頭份,2024-01-12,9296
00687B,國泰20年美債,10,0,10,凱基-頭份,2024-01-12,9296
2328,廣宇,10,0,10,凱基-頭份,2024-01-12,9296
2888,新光金,10,0,10,凱基-頭份,2024-01-12,9296
3013,晟銘電,10,0,10,凱基-頭份,2024-01-12,9296
3213,茂訊,11,1,10,凱基-頭份,2024-01-12,9296
6219,富旺,10,0,10,凱基-頭份,2024-01-12,9296
8201,無敵,10,0,10,凱基-頭份,2024-01-12,9296
00878,國泰永續高股息,14,5,9,凱基-頭份,2024-01-12,9296
00770,國泰北美科技,8,0,8,凱基-頭份,2024-01-12,9296
00679B,元大美債20年,8,0,8,凱基-頭份,2024-01-12,9296
2345,智邦,22,14,8,凱基-頭份,2024-01-12,9296
00937B,群益ESG投等債20,8,1,7,凱基-頭份,2024-01-12,9296
2884,玉山金,7,0,7,凱基-頭份,2024-01-12,9296
8096,擎亞,34,27,7,凱基-頭份,2024-01-12,9296
00936,台新永續高息中小,6,0,6,凱基-頭份,2024-01-12,9296
5425,台半,6,0,6,凱基-頭份,2024-01-12,9296
6799,來頡,6,0,6,凱基-頭份,2024-01-12,9296
2329,華泰,7,1,6,凱基-頭份,2024-01-12,9296
00671R,富邦NASDAQ反1,5,0,5,凱基-頭份,2024-01-12,9296
00701,國泰股利精選30,5,0,5,凱基-頭份,2024-01-12,9296
00715L,期街口布蘭特正2,5,0,5,凱基-頭份,2024-01-12,9296
2355,敬鵬,5,0,5,凱基-頭份,2024-01-12,9296
2801,彰銀,5,0,5,凱基-頭份,2024-01-12,9296
3041,揚智,5,0,5,凱基-頭份,2024-01-12,9296
3078,僑威,5,0,5,凱基-頭份,2024-01-12,9296
3588,通嘉,5,0,5,凱基-頭份,2024-01-12,9296
6112,邁達特,6,1,5,凱基-頭份,2024-01-12,9296
6290,良維,5,0,5,凱基-頭份,2024-01-12,9296
2887,台新金,5,1,4,凱基-頭份,2024-01-12,9296
00896,中信綠能及電動車,4,0,4,凱基-頭份,2024-01-12,9296
2303,聯電,4,0,4,凱基-頭份,2024-01-12,9296
2515,中工,5,1,4,凱基-頭份,2024-01-12,9296
5328,華容,4,0,4,凱基-頭份,2024-01-12,9296
00929,復華台灣科技優息,409,2,407,凱基-頭份,2024-01-15,9296
2618,長榮航,80,5,75,凱基-頭份,2024-01-15,9296
2882,國泰金,51,0,51,凱基-頭份,2024-01-15,9296
2363,矽統,30,0,30,凱基-頭份,2024-01-15,9296
2610,華航,27,2,25,凱基-頭份,2024-01-15,9296
2356,英業達,18,0,18,凱基-頭份,2024-01-15,9296
2888,新光金,22,6,16,凱基-頭份,2024-01-15,9296
1301,台塑,16,0,16,凱基-頭份,2024-01-15,9296
00650L,復華香港正2,15,0,15,凱基-頭份,2024-01-15,9296
2002,中鋼,16,1,15,凱基-頭份,2024-01-15,9296
0056,元大高股息,13,1,12,凱基-頭份,2024-01-15,9296
3231,緯創,26,15,11,凱基-頭份,2024-01-15,9296
2371,大同,11,0,11,凱基-頭份,2024-01-15,9296
00664R,國泰臺灣加權反1,10,0,10,凱基-頭份,2024-01-15,9296
2634,漢翔,14,4,10,凱基-頭份,2024-01-15,9296
6290,良維,10,0,10,凱基-頭份,2024-01-15,9296
8403,盛弘,10,0,10,凱基-頭份,2024-01-15,9296
00680L,元大美債20正2,8,0,8,凱基-頭份,2024-01-15,9296
00928,中信上櫃ESG30,8,0,8,凱基-頭份,2024-01-15,9296
3481,群創,10,3,7,凱基-頭份,2024-01-15,9296
8201,無敵,7,0,7,凱基-頭份,2024-01-15,9296
2353,宏��,17,11,6,凱基-頭份,2024-01-15,9296
00927,群益半導體收益,6,0,6,凱基-頭份,2024-01-15,9296
2025,千興,6,0,6,凱基-頭份,2024-01-15,9296
2324,仁寶,10,4,6,凱基-頭份,2024-01-15,9296
00679B,元大美債20年,5,0,5,凱基-頭份,2024-01-15,9296
2449,京元電子,8,3,5,凱基-頭份,2024-01-15,9296
00937B,群益ESG投等債20,11,6,5,凱基-頭份,2024-01-15,9296
00632R,元大台灣50反1,5,0,5,凱基-頭份,2024-01-15,9296
1503,士電,6,1,5,凱基-頭份,2024-01-15,9296
2611,志信,5,0,5,凱基-頭份,2024-01-15,9296
3213,茂訊,10,5,5,凱基-頭份,2024-01-15,9296
3556,禾瑞亞,5,0,5,凱基-頭份,2024-01-15,9296
6125,廣運,7,2,5,凱基-頭份,2024-01-15,9296
00770,國泰北美科技,6,1,5,凱基-頭份,2024-01-15,9296
1326,台化,4,0,4,凱基-頭份,2024-01-15,9296
2317,鴻海,4,0,4,凱基-頭份,2024-01-15,9296
00896,中信綠能及電動車,4,0,4,凱基-頭份,2024-01-15,9296
00904,新光臺灣半導體30,4,0,4,凱基-頭份,2024-01-15,9296
2312,金寶,5,1,4,凱基-頭份,2024-01-15,9296
2352,佳世達,4,0,4,凱基-頭份,2024-01-15,9296
6799,來頡,4,0,4,凱基-頭份,2024-01-15,9296
00688L,國泰20年美債正2,3,0,3,凱基-頭份,2024-01-15,9296
1305,華夏,3,0,3,凱基-頭份,2024-01-15,9296
1519,華城,10,7,3,凱基-頭份,2024-01-15,9296
2101,南港,3,0,3,凱基-頭份,2024-01-15,9296
2301,光寶科,3,0,3,凱基-頭份,2024-01-15,9296
2377,微星,3,0,3,凱基-頭份,2024-01-15,9296
2421,建準,6,3,3,凱基-頭份,2024-01-15,9296
2607,榮運,3,0,3,凱基-頭份,2024-01-15,9296
00929,復華台灣科技優息,146,0,146,凱基-頭份,2024-01-16,9296
0056,元大高股息,55,0,55,凱基-頭份,2024-01-16,9296
2344,華邦電,54,1,53,凱基-頭份,2024-01-16,9296
00881,國泰台灣5G+,52,0,52,凱基-頭份,2024-01-16,9296
00919,群益台灣精選高息,32,0,32,凱基-頭份,2024-01-16,9296
00937B,群益ESG投等債20,29,2,27,凱基-頭份,2024-01-16,9296
00650L,復華香港正2,55,30,25,凱基-頭份,2024-01-16,9296
2892,第一金,24,0,24,凱基-頭份,2024-01-16,9296
1316,上曜,21,0,21,凱基-頭份,2024-01-16,9296
2486,一詮,22,2,20,凱基-頭份,2024-01-16,9296
6117,迎廣,20,0,20,凱基-頭份,2024-01-16,9296
2883,凱基金,19,1,18,凱基-頭份,2024-01-16,9296
2887,台新金,18,0,18,凱基-頭份,2024-01-16,9296
2002,中鋼,17,0,17,凱基-頭份,2024-01-16,9296
8403,盛弘,16,0,16,凱基-頭份,2024-01-16,9296
00680L,元大美債20正2,15,0,15,凱基-頭份,2024-01-16,9296
00712,復華富時不動產,20,5,15,凱基-頭份,2024-01-16,9296
1714,和桐,15,0,15,凱基-頭份,2024-01-16,9296
1326,台化,13,0,13,凱基-頭份,2024-01-16,9296
1101,台泥,13,0,13,凱基-頭份,2024-01-16,9296
2610,華航,25,12,13,凱基-頭份,2024-01-16,9296
2618,長榮航,16,3,13,凱基-頭份,2024-01-16,9296
2884,玉山金,13,0,13,凱基-頭份,2024-01-16,9296
00687B,國泰20年美債,12,0,12,凱基-頭份,2024-01-16,9296
2401,凌陽,12,0,12,凱基-頭份,2024-01-16,9296
2834,臺企銀,11,0,11,凱基-頭份,2024-01-16,9296
00931B,統一美債20年,10,0,10,凱基-頭份,2024-01-16,9296
1513,中興電,20,10,10,凱基-頭份,2024-01-16,9296
00720B,元大投資級公司債,11,1,10,凱基-頭份,2024-01-16,9296
00857B,永豐20年美公債,10,0,10,凱基-頭份,2024-01-16,9296
1609,大亞,12,2,10,凱基-頭份,2024-01-16,9296
2009,第一銅,10,0,10,凱基-頭份,2024-01-16,9296
2801,彰銀,10,0,10,凱基-頭份,2024-01-16,9296
3149,正達,10,0,10,凱基-頭份,2024-01-16,9296
6290,良維,10,0,10,凱基-頭份,2024-01-16,9296
6442,光聖,10,0,10,凱基-頭份,2024-01-16,9296
8937,合騏,10,0,10,凱基-頭份,2024-01-16,9296
2405,輔信,14,5,9,凱基-頭份,2024-01-16,9296
6834,天二科技,9,0,9,凱基-頭份,2024-01-16,9296
3025,星通,25,17,8,凱基-頭份,2024-01-16,9296
6451,訊芯-KY,37,30,7,凱基-頭份,2024-01-16,9296
6695,芯鼎,35,28,7,凱基-頭份,2024-01-16,9296
1618,合機,7,0,7,凱基-頭份,2024-01-16,9296
2324,仁寶,7,0,7,凱基-頭份,2024-01-16,9296
1301,台塑,7,0,7,凱基-頭份,2024-01-16,9296
00878,國泰永續高股息,24,18,6,凱基-頭份,2024-01-16,9296
2886,兆豐金,6,0,6,凱基-頭份,2024-01-16,9296
2201,裕隆,7,1,6,凱基-頭份,2024-01-16,9296
2303,聯電,7,1,6,凱基-頭份,2024-01-16,9296
3455,由田,6,0,6,凱基-頭份,2024-01-16,9296
00632R,元大台灣50反1,151,10,141,凱基-頭份,2024-01-17,9296
00919,群益台灣精選高息,136,1,135,凱基-頭份,2024-01-17,9296
00929,復華台灣科技優息,184,50,134,凱基-頭份,2024-01-17,9296
00882,中信中國高股息,112,15,97,凱基-頭份,2024-01-17,9296
0056,元大高股息,85,0,85,凱基-頭份,2024-01-17,9296
00665L,富邦�琤肭磪囓�2,70,0,70,凱基-頭份,2024-01-17,9296
2344,華邦電,63,9,54,凱基-頭份,2024-01-17,9296
2888,新光金,48,0,48,凱基-頭份,2024-01-17,9296
00878,國泰永續高股息,48,1,47,凱基-頭份,2024-01-17,9296
2887,台新金,26,0,26,凱基-頭份,2024-01-17,9296
00637L,元大滬深300正2,24,4,20,凱基-頭份,2024-01-17,9296
1316,上曜,20,0,20,凱基-頭份,2024-01-17,9296
2002,中鋼,20,0,20,凱基-頭份,2024-01-17,9296
2303,聯電,22,4,18,凱基-頭份,2024-01-17,9296
2610,華航,27,10,17,凱基-頭份,2024-01-17,9296
3030,德律,16,0,16,凱基-頭份,2024-01-17,9296
00679B,元大美債20年,15,0,15,凱基-頭份,2024-01-17,9296
00881,國泰台灣5G+,13,0,13,凱基-頭份,2024-01-17,9296
2379,瑞昱,12,0,12,凱基-頭份,2024-01-17,9296
00680L,元大美債20正2,12,0,12,凱基-頭份,2024-01-17,9296
1732,毛寶,12,0,12,凱基-頭份,2024-01-17,9296
3025,星通,19,7,12,凱基-頭份,2024-01-17,9296
2371,大同,12,0,12,凱基-頭份,2024-01-17,9296
2892,第一金,11,0,11,凱基-頭份,2024-01-17,9296
2834,臺企銀,11,0,11,凱基-頭份,2024-01-17,9296
1528,恩德,17,6,11,凱基-頭份,2024-01-17,9296
2886,兆豐金,12,1,11,凱基-頭份,2024-01-17,9296
00898,國泰基因免疫革命,10,0,10,凱基-頭份,2024-01-17,9296
1513,中興電,17,7,10,凱基-頭份,2024-01-17,9296
8403,盛弘,10,0,10,凱基-頭份,2024-01-17,9296
2324,仁寶,9,0,9,凱基-頭份,2024-01-17,9296
2609,陽明,9,0,9,凱基-頭份,2024-01-17,9296
5425,台半,9,0,9,凱基-頭份,2024-01-17,9296
2377,微星,8,0,8,凱基-頭份,2024-01-17,9296
2409,友達,12,4,8,凱基-頭份,2024-01-17,9296
2547,日勝生,8,0,8,凱基-頭份,2024-01-17,9296
6695,芯鼎,13,5,8,凱基-頭份,2024-01-17,9296
2891,中信金,10,2,8,凱基-頭份,2024-01-17,9296
2884,玉山金,7,0,7,凱基-頭份,2024-01-17,9296
5351,鈺創,7,0,7,凱基-頭份,2024-01-17,9296
00918,大華優利高填息30,7,0,7,凱基-頭份,2024-01-17,9296
2449,京元電子,27,20,7,凱基-頭份,2024-01-17,9296
3034,聯詠,7,0,7,凱基-頭份,2024-01-17,9296
3055,蔚華科,7,0,7,凱基-頭份,2024-01-17,9296
3491,昇達科,8,1,7,凱基-頭份,2024-01-17,9296
00937B,群益ESG投等債20,6,0,6,凱基-頭份,2024-01-17,9296
1325,恆大,8,2,6,凱基-頭份,2024-01-17,9296
2338,光罩,6,0,6,凱基-頭份,2024-01-17,9296
3707,漢磊,7,1,6,凱基-頭份,2024-01-17,9296
2388,威盛,15,9,6,凱基-頭份,2024-01-17,9296
00929,復華台灣科技優息,141,20,121,凱基-頭份,2024-01-18,9296
6120,達運,191,122,69,凱基-頭份,2024-01-18,9296
00882,中信中國高股息,38,0,38,凱基-頭份,2024-01-18,9296
6770,力積電,38,0,38,凱基-頭份,2024-01-18,9296
00878,國泰永續高股息,28,2,26,凱基-頭份,2024-01-18,9296
00632R,元大台灣50反1,20,0,20,凱基-頭份,2024-01-18,9296
1609,大亞,20,0,20,凱基-頭份,2024-01-18,9296
00679B,元大美債20年,12,0,12,凱基-頭份,2024-01-18,9296
00885,富邦越南,12,0,12,凱基-頭份,2024-01-18,9296
2449,京元電子,103,91,12,凱基-頭份,2024-01-18,9296
2105,正新,11,0,11,凱基-頭份,2024-01-18,9296
5450,南良,11,0,11,凱基-頭份,2024-01-18,9296
2883,凱基金,10,0,10,凱基-頭份,2024-01-18,9296
2382,廣達,50,40,10,凱基-頭份,2024-01-18,9296
00720B,元大投資級公司債,10,0,10,凱基-頭份,2024-01-18,9296
00636,國泰中國A50,10,0,10,凱基-頭份,2024-01-18,9296
00633L,富邦上証正2,10,0,10,凱基-頭份,2024-01-18,9296
00680L,元大美債20正2,10,0,10,凱基-頭份,2024-01-18,9296
5439,高技,10,0,10,凱基-頭份,2024-01-18,9296
8403,盛弘,10,0,10,凱基-頭份,2024-01-18,9296
9907,統一實,10,0,10,凱基-頭份,2024-01-18,9296
00637L,元大滬深300正2,17,8,9,凱基-頭份,2024-01-18,9296
8034,榮群,11,2,9,凱基-頭份,2024-01-18,9296
2888,新光金,8,0,8,凱基-頭份,2024-01-18,9296
4960,誠美材,9,1,8,凱基-頭份,2024-01-18,9296
0056,元大高股息,25,18,7,凱基-頭份,2024-01-18,9296
2421,建準,11,5,6,凱基-頭份,2024-01-18,9296
00937B,群益ESG投等債20,13,7,6,凱基-頭份,2024-01-18,9296
2884,玉山金,6,0,6,凱基-頭份,2024-01-18,9296
00650L,復華香港正2,6,0,6,凱基-頭份,2024-01-18,9296
00918,大華優利高填息30,6,0,6,凱基-頭份,2024-01-18,9296
2727,王品,6,0,6,凱基-頭份,2024-01-18,9296
1444,力麗,6,0,6,凱基-頭份,2024-01-18,9296
2303,聯電,8,2,6,凱基-頭份,2024-01-18,9296
2892,第一金,5,0,5,凱基-頭份,2024-01-18,9296
00857B,永豐20年美公債,5,0,5,凱基-頭份,2024-01-18,9296
3056,富華新,5,0,5,凱基-頭份,2024-01-18,9296
3437,榮創,5,0,5,凱基-頭份,2024-01-18,9296
4121,優盛,5,0,5,凱基-頭份,2024-01-18,9296
9103,美德醫療-DR,5,0,5,凱基-頭份,2024-01-18,9296
9945,潤泰新,5,0,5,凱基-頭份,2024-01-18,9296
2609,陽明,16,11,5,凱基-頭份,2024-01-18,9296
2317,鴻海,4,0,4,凱基-頭份,2024-01-18,9296
5347,世界,4,0,4,凱基-頭份,2024-01-18,9296
2376,技嘉,4,0,4,凱基-頭份,2024-01-18,9296
2886,兆豐金,5,1,4,凱基-頭份,2024-01-18,9296
8096,擎亞,24,20,4,凱基-頭份,2024-01-18,9296
00915,凱基優選高股息30,3,0,3,凱基-頭份,2024-01-18,9296
2890,永豐金,3,0,3,凱基-頭份,2024-01-18,9296
00713,元大台灣高息低波,3,0,3,凱基-頭份,2024-01-18,9296
00882,中信中國高股息,102,0,102,凱基-頭份,2024-01-19,9296
00632R,元大台灣50反1,90,0,90,凱基-頭份,2024-01-19,9296
00936,台新永續高息中小,67,0,67,凱基-頭份,2024-01-19,9296
00664R,國泰臺灣加權反1,60,0,60,凱基-頭份,2024-01-19,9296
00715L,期街口布蘭特正2,52,0,52,凱基-頭份,2024-01-19,9296
3149,正達,82,32,50,凱基-頭份,2024-01-19,9296
3706,神達,33,1,32,凱基-頭份,2024-01-19,9296
2002,中鋼,28,0,28,凱基-頭份,2024-01-19,9296
00680L,元大美債20正2,28,0,28,凱基-頭份,2024-01-19,9296
00687B,國泰20年美債,26,0,26,凱基-頭份,2024-01-19,9296
00937B,群益ESG投等債20,22,0,22,凱基-頭份,2024-01-19,9296
00772B,中信高評級公司債,20,0,20,凱基-頭份,2024-01-19,9296
00679B,元大美債20年,20,0,20,凱基-頭份,2024-01-19,9296
2344,華邦電,21,3,18,凱基-頭份,2024-01-19,9296
6196,帆宣,15,0,15,凱基-頭份,2024-01-19,9296
2303,聯電,16,2,14,凱基-頭份,2024-01-19,9296
00929,復華台灣科技優息,20,7,13,凱基-頭份,2024-01-19,9296
2888,新光金,12,0,12,凱基-頭份,2024-01-19,9296
00712,復華富時不動產,11,0,11,凱基-頭份,2024-01-19,9296
00934,中信成長高股息,10,0,10,凱基-頭份,2024-01-19,9296
00650L,復華香港正2,30,20,10,凱基-頭份,2024-01-19,9296
1736,喬山,10,0,10,凱基-頭份,2024-01-19,9296
2101,南港,10,0,10,凱基-頭份,2024-01-19,9296
2353,宏��,12,2,10,凱基-頭份,2024-01-19,9296
2520,冠德,10,0,10,凱基-頭份,2024-01-19,9296
2611,志信,10,0,10,凱基-頭份,2024-01-19,9296
6005,群益證,10,0,10,凱基-頭份,2024-01-19,9296
00751B,元大AAA至A公司債,9,0,9,凱基-頭份,2024-01-19,9296
0056,元大高股息,7,0,7,凱基-頭份,2024-01-19,9296
00857B,永豐20年美公債,7,0,7,凱基-頭份,2024-01-19,9296
2405,輔信,7,0,7,凱基-頭份,2024-01-19,9296
6695,芯鼎,11,5,6,凱基-頭份,2024-01-19,9296
4960,誠美材,9,3,6,凱基-頭份,2024-01-19,9296
1303,南亞,5,0,5,凱基-頭份,2024-01-19,9296
6285,啟��,8,3,5,凱基-頭份,2024-01-19,9296
2610,華航,7,2,5,凱基-頭份,2024-01-19,9296
2356,英業達,39,34,5,凱基-頭份,2024-01-19,9296
3031,佰鴻,5,0,5,凱基-頭份,2024-01-19,9296
3264,欣銓,5,0,5,凱基-頭份,2024-01-19,9296
3450,聯鈞,5,0,5,凱基-頭份,2024-01-19,9296
5880,合庫金,5,0,5,凱基-頭份,2024-01-19,9296
6799,來頡,5,0,5,凱基-頭份,2024-01-19,9296
00720B,元大投資級公司債,4,0,4,凱基-頭份,2024-01-19,9296
00927,群益半導體收益,4,0,4,凱基-頭份,2024-01-19,9296
00713,元大台灣高息低波,6,2,4,凱基-頭份,2024-01-19,9296
1528,恩德,4,0,4,凱基-頭份,2024-01-19,9296
2486,一詮,19,15,4,凱基-頭份,2024-01-19,9296
2606,裕民,7,3,4,凱基-頭份,2024-01-19,9296
3032,偉訓,4,0,4,凱基-頭份,2024-01-19,9296
4306,炎洲,4,0,4,凱基-頭份,2024-01-19,9296
00929,復華台灣科技優息,116,2,114,凱基-頭份,2024-01-22,9296
2353,宏��,57,13,44,凱基-頭份,2024-01-22,9296
00882,中信中國高股息,43,4,39,凱基-頭份,2024-01-22,9296
2618,長榮航,50,15,35,凱基-頭份,2024-01-22,9296
4956,光鋐,35,2,33,凱基-頭份,2024-01-22,9296
00680L,元大美債20正2,28,0,28,凱基-頭份,2024-01-22,9296
2331,精英,27,0,27,凱基-頭份,2024-01-22,9296
00650L,復華香港正2,40,20,20,凱基-頭份,2024-01-22,9296
2344,華邦電,24,4,20,凱基-頭份,2024-01-22,9296
2329,華泰,41,23,18,凱基-頭份,2024-01-22,9296
8937,合騏,15,0,15,凱基-頭份,2024-01-22,9296
00632R,元大台灣50反1,12,0,12,凱基-頭份,2024-01-22,9296
5426,振發,14,2,12,凱基-頭份,2024-01-22,9296
2101,南港,11,0,11,凱基-頭份,2024-01-22,9296
2887,台新金,11,0,11,凱基-頭份,2024-01-22,9296
00919,群益台灣精選高息,12,2,10,凱基-頭份,2024-01-22,9296
00664R,國泰臺灣加權反1,10,0,10,凱基-頭份,2024-01-22,9296
2371,大同,10,0,10,凱基-頭份,2024-01-22,9296
2417,圓剛,10,0,10,凱基-頭份,2024-01-22,9296
2890,永豐金,10,0,10,凱基-頭份,2024-01-22,9296
3706,神達,27,17,10,凱基-頭份,2024-01-22,9296
5452,佶優,10,0,10,凱基-頭份,2024-01-22,9296
6005,群益證,10,0,10,凱基-頭份,2024-01-22,9296
6198,瑞築,10,0,10,凱基-頭份,2024-01-22,9296
2834,臺企銀,9,0,9,凱基-頭份,2024-01-22,9296
2379,瑞昱,8,0,8,凱基-頭份,2024-01-22,9296
6668,中揚光,10,2,8,凱基-頭份,2024-01-22,9296
00918,大華優利高填息30,7,0,7,凱基-頭份,2024-01-22,9296
00900,富邦特選高股息30,7,0,7,凱基-頭份,2024-01-22,9296
3306,鼎天,7,0,7,凱基-頭份,2024-01-22,9296
00706L,期元大S＆P日圓正2,6,0,6,凱基-頭份,2024-01-22,9296
1605,華新,6,0,6,凱基-頭份,2024-01-22,9296
2002,中鋼,6,1,5,凱基-頭份,2024-01-22,9296
2313,華通,5,0,5,凱基-頭份,2024-01-22,9296
2355,敬鵬,5,0,5,凱基-頭份,2024-01-22,9296
3031,佰鴻,5,0,5,凱基-頭份,2024-01-22,9296
6117,迎廣,7,2,5,凱基-頭份,2024-01-22,9296
6226,光鼎,5,0,5,凱基-頭份,2024-01-22,9296
6592,和潤企業,5,0,5,凱基-頭份,2024-01-22,9296
8011,台通,5,0,5,凱基-頭份,2024-01-22,9296
8059,凱碩,5,0,5,凱基-頭份,2024-01-22,9296
00712,復華富時不動產,5,1,4,凱基-頭份,2024-01-22,9296
00895,富邦未來車,10,6,4,凱基-頭份,2024-01-22,9296
2317,鴻海,4,0,4,凱基-頭份,2024-01-22,9296
2609,陽明,331,327,4,凱基-頭份,2024-01-22,9296
3339,泰谷,4,0,4,凱基-頭份,2024-01-22,9296
6113,亞矽,5,1,4,凱基-頭份,2024-01-22,9296
00799B,國泰A級醫療債,3,0,3,凱基-頭份,2024-01-22,9296
1514,亞力,4,1,3,凱基-頭份,2024-01-22,9296
2308,台達電,3,0,3,凱基-頭份,2024-01-22,9296
00882,中信中國高股息,88,18,70,凱基-頭份,2024-01-23,9296
3059,華晶科,39,1,38,凱基-頭份,2024-01-23,9296
3044,健鼎,31,0,31,凱基-頭份,2024-01-23,9296
2353,宏��,29,8,21,凱基-頭份,2024-01-23,9296
2365,昆盈,20,0,20,凱基-頭份,2024-01-23,9296
2460,建通,20,0,20,凱基-頭份,2024-01-23,9296
2888,新光金,20,0,20,凱基-頭份,2024-01-23,9296
6442,光聖,29,9,20,凱基-頭份,2024-01-23,9296
6005,群益證,18,0,18,凱基-頭份,2024-01-23,9296
8403,盛弘,16,0,16,凱基-頭份,2024-01-23,9296
1305,華夏,15,0,15,凱基-頭份,2024-01-23,9296
2736,富野,15,0,15,凱基-頭份,2024-01-23,9296
00918,大華優利高填息30,13,0,13,凱基-頭份,2024-01-23,9296
00679B,元大美債20年,11,0,11,凱基-頭份,2024-01-23,9296
00687B,國泰20年美債,11,0,11,凱基-頭份,2024-01-23,9296
2363,矽統,11,0,11,凱基-頭份,2024-01-23,9296
3231,緯創,30,20,10,凱基-頭份,2024-01-23,9296
1447,力鵬,10,0,10,凱基-頭份,2024-01-23,9296
6462,神盾,10,1,9,凱基-頭份,2024-01-23,9296
00715L,期街口布蘭特正2,8,0,8,凱基-頭份,2024-01-23,9296
2486,一詮,11,3,8,凱基-頭份,2024-01-23,9296
3363,上詮,11,3,8,凱基-頭份,2024-01-23,9296
2002,中鋼,7,0,7,凱基-頭份,2024-01-23,9296
2610,華航,8,1,7,凱基-頭份,2024-01-23,9296
6140,訊達,20,13,7,凱基-頭份,2024-01-23,9296
8034,榮群,11,4,7,凱基-頭份,2024-01-23,9296
00937B,群益ESG投等債20,7,0,7,凱基-頭份,2024-01-23,9296
2401,凌陽,6,0,6,凱基-頭份,2024-01-23,9296
2609,陽明,10,4,6,凱基-頭份,2024-01-23,9296
00673R,期元大S＆P原油反1,5,0,5,凱基-頭份,2024-01-23,9296
2886,兆豐金,5,0,5,凱基-頭份,2024-01-23,9296
3025,星通,8,3,5,凱基-頭份,2024-01-23,9296
3645,達邁,5,0,5,凱基-頭份,2024-01-23,9296
6120,達運,5,0,5,凱基-頭份,2024-01-23,9296
2362,藍天,4,0,4,凱基-頭份,2024-01-23,9296
6276,安鈦克,5,1,4,凱基-頭份,2024-01-23,9296
6695,芯鼎,9,5,4,凱基-頭份,2024-01-23,9296
2880,華南金,7,4,3,凱基-頭份,2024-01-23,9296
5880,合庫金,3,0,3,凱基-頭份,2024-01-23,9296
2014,中鴻,3,0,3,凱基-頭份,2024-01-23,9296
2313,華通,5,2,3,凱基-頭份,2024-01-23,9296
2377,微星,3,0,3,凱基-頭份,2024-01-23,9296
3437,榮創,3,0,3,凱基-頭份,2024-01-23,9296
5213,亞昕,3,0,3,凱基-頭份,2024-01-23,9296
6530,創威,3,0,3,凱基-頭份,2024-01-23,9296
2465,麗臺,3,0,3,凱基-頭份,2024-01-23,9296
6113,亞矽,8,6,2,凱基-頭份,2024-01-23,9296
2892,第一金,2,0,2,凱基-頭份,2024-01-23,9296
00900,富邦特選高股息30,3,1,2,凱基-頭份,2024-01-23,9296
1513,中興電,3,1,2,凱基-頭份,2024-01-23,9296
6005,群益證,108,0,108,凱基-頭份,2024-01-24,9296
00882,中信中國高股息,86,10,76,凱基-頭份,2024-01-24,9296
2324,仁寶,34,1,33,凱基-頭份,2024-01-24,9296
3706,神達,37,6,31,凱基-頭份,2024-01-24,9296
2356,英業達,41,13,28,凱基-頭份,2024-01-24,9296
00937B,群益ESG投等債20,23,0,23,凱基-頭份,2024-01-24,9296
1709,和益,20,0,20,凱基-頭份,2024-01-24,9296
3615,安可,33,13,20,凱基-頭份,2024-01-24,9296
8034,榮群,25,6,19,凱基-頭份,2024-01-24,9296
1201,味全,15,0,15,凱基-頭份,2024-01-24,9296
00650L,復華香港正2,30,15,15,凱基-頭份,2024-01-24,9296
3055,蔚華科,25,10,15,凱基-頭份,2024-01-24,9296
00680L,元大美債20正2,12,0,12,凱基-頭份,2024-01-24,9296
00679B,元大美債20年,12,0,12,凱基-頭份,2024-01-24,9296
00712,復華富時不動產,11,0,11,凱基-頭份,2024-01-24,9296
3114,好德,11,0,11,凱基-頭份,2024-01-24,9296
3622,洋華,13,2,11,凱基-頭份,2024-01-24,9296
1736,喬山,10,0,10,凱基-頭份,2024-01-24,9296
3363,上詮,20,10,10,凱基-頭份,2024-01-24,9296
4157,太景*-KY,10,0,10,凱基-頭份,2024-01-24,9296
6120,達運,10,0,10,凱基-頭份,2024-01-24,9296
6185,幃翔,10,0,10,凱基-頭份,2024-01-24,9296
2409,友達,13,3,10,凱基-頭份,2024-01-24,9296
00637L,元大滬深300正2,8,1,7,凱基-頭份,2024-01-24,9296
2606,裕民,10,3,7,凱基-頭份,2024-01-24,9296
4188,安克,7,0,7,凱基-頭份,2024-01-24,9296
00857B,永豐20年美公債,6,0,6,凱基-頭份,2024-01-24,9296
00931B,統一美債20年,11,5,6,凱基-頭份,2024-01-24,9296
2369,菱生,42,36,6,凱基-頭份,2024-01-24,9296
2520,冠德,6,0,6,凱基-頭份,2024-01-24,9296
00929,復華台灣科技優息,9,4,5,凱基-頭份,2024-01-24,9296
00877,復華中國5G,5,0,5,凱基-頭份,2024-01-24,9296
00633L,富邦上証正2,5,0,5,凱基-頭份,2024-01-24,9296
2883B,凱基金乙特,5,0,5,凱基-頭份,2024-01-24,9296
3413,京鼎,5,0,5,凱基-頭份,2024-01-24,9296
3521,鴻翊,5,0,5,凱基-頭份,2024-01-24,9296
6112,邁達特,5,0,5,凱基-頭份,2024-01-24,9296
6799,來頡,5,0,5,凱基-頭份,2024-01-24,9296
00687B,國泰20年美債,5,0,5,凱基-頭份,2024-01-24,9296
2884,玉山金,4,0,4,凱基-頭份,2024-01-24,9296
2027,大成鋼,4,0,4,凱基-頭份,2024-01-24,9296
2301,光寶科,4,0,4,凱基-頭份,2024-01-24,9296
1528,恩德,4,0,4,凱基-頭份,2024-01-24,9296
3437,榮創,7,3,4,凱基-頭份,2024-01-24,9296
6164,華興,4,0,4,凱基-頭份,2024-01-24,9296
00799B,國泰A級醫療債,3,0,3,凱基-頭份,2024-01-24,9296
00918,大華優利高填息30,3,0,3,凱基-頭份,2024-01-24,9296
3066,李洲,3,0,3,凱基-頭份,2024-01-24,9296
3438,類比科,3,0,3,凱基-頭份,2024-01-24,9296
3504,揚明光,9,6,3,凱基-頭份,2024-01-24,9296
00720B,元大投資級公司債,240,0,240,凱基-頭份,2024-01-25,9296
6005,群益證,160,0,160,凱基-頭份,2024-01-25,9296
00882,中信中國高股息,101,0,101,凱基-頭份,2024-01-25,9296
2542,興富發,25,0,25,凱基-頭份,2024-01-25,9296
3704,合勤控,21,0,21,凱基-頭份,2024-01-25,9296
00671R,富邦NASDAQ反1,20,0,20,凱基-頭份,2024-01-25,9296
2345,智邦,21,1,20,凱基-頭份,2024-01-25,9296
8403,盛弘,20,0,20,凱基-頭份,2024-01-25,9296
00687B,國泰20年美債,17,0,17,凱基-頭份,2024-01-25,9296
00680L,元大美債20正2,16,0,16,凱基-頭份,2024-01-25,9296
00857B,永豐20年美公債,16,0,16,凱基-頭份,2024-01-25,9296
8111,立��,20,4,16,凱基-頭份,2024-01-25,9296
1201,味全,15,0,15,凱基-頭份,2024-01-25,9296
2369,菱生,40,25,15,凱基-頭份,2024-01-25,9296
00937B,群益ESG投等債20,31,16,15,凱基-頭份,2024-01-25,9296
5443,均豪,14,0,14,凱基-頭份,2024-01-25,9296
00679B,元大美債20年,12,0,12,凱基-頭份,2024-01-25,9296
6535,順藥,12,1,11,凱基-頭份,2024-01-25,9296
8096,擎亞,30,19,11,凱基-頭份,2024-01-25,9296
00664R,國泰臺灣加權反1,10,0,10,凱基-頭份,2024-01-25,9296
00895,富邦未來車,10,0,10,凱基-頭份,2024-01-25,9296
2317,鴻海,10,0,10,凱基-頭份,2024-01-25,9296
2365,昆盈,15,5,10,凱基-頭份,2024-01-25,9296
3363,上詮,11,1,10,凱基-頭份,2024-01-25,9296
3576,聯合再生,10,0,10,凱基-頭份,2024-01-25,9296
6116,彩晶,10,1,9,凱基-頭份,2024-01-25,9296
00900,富邦特選高股息30,8,0,8,凱基-頭份,2024-01-25,9296
00712,復華富時不動產,15,8,7,凱基-頭份,2024-01-25,9296
2382,廣達,38,31,7,凱基-頭份,2024-01-25,9296
2103,台橡,6,0,6,凱基-頭份,2024-01-25,9296
2486,一詮,21,15,6,凱基-頭份,2024-01-25,9296
5351,鈺創,6,0,6,凱基-頭份,2024-01-25,9296
1101,台泥,5,0,5,凱基-頭份,2024-01-25,9296
3490,單井,6,1,5,凱基-頭份,2024-01-25,9296
00673R,期元大S＆P原油反1,5,0,5,凱基-頭份,2024-01-25,9296
00648R,元大S＆P500反1,5,0,5,凱基-頭份,2024-01-25,9296
1723,中碳,5,0,5,凱基-頭份,2024-01-25,9296
1736,喬山,5,0,5,凱基-頭份,2024-01-25,9296
2101,南港,5,0,5,凱基-頭份,2024-01-25,9296
2363,矽統,5,0,5,凱基-頭份,2024-01-25,9296
2399,映泰,5,0,5,凱基-頭份,2024-01-25,9296
3176,基亞,5,0,5,凱基-頭份,2024-01-25,9296
3211,順達,5,0,5,凱基-頭份,2024-01-25,9296
5425,台半,5,0,5,凱基-頭份,2024-01-25,9296
5478,智冠,5,0,5,凱基-頭份,2024-01-25,9296
5608,四維航,5,0,5,凱基-頭份,2024-01-25,9296
6153,嘉聯益,5,0,5,凱基-頭份,2024-01-25,9296
8071,能率網通,5,0,5,凱基-頭份,2024-01-25,9296
2356,英業達,26,22,4,凱基-頭份,2024-01-25,9296
2376,技嘉,6,2,4,凱基-頭份,2024-01-25,9296
6005,群益證,201,1,200,凱基-頭份,2024-01-26,9296
00929,復華台灣科技優息,36,4,32,凱基-頭份,2024-01-26,9296
9105,泰金寶-DR,31,0,31,凱基-頭份,2024-01-26,9296
00918,大華優利高填息30,23,0,23,凱基-頭份,2024-01-26,9296
2303,聯電,26,5,21,凱基-頭份,2024-01-26,9296
3704,合勤控,20,0,20,凱基-頭份,2024-01-26,9296
2353,宏��,30,12,18,凱基-頭份,2024-01-26,9296
00650L,復華香港正2,20,5,15,凱基-頭份,2024-01-26,9296
2542,興富發,15,0,15,凱基-頭份,2024-01-26,9296
3033,威健,15,0,15,凱基-頭份,2024-01-26,9296
00919,群益台灣精選高息,14,1,13,凱基-頭份,2024-01-26,9296
00937B,群益ESG投等債20,24,11,13,凱基-頭份,2024-01-26,9296
00712,復華富時不動產,12,0,12,凱基-頭份,2024-01-26,9296
2324,仁寶,16,4,12,凱基-頭份,2024-01-26,9296
2379,瑞昱,12,0,12,凱基-頭份,2024-01-26,9296
00680L,元大美債20正2,11,0,11,凱基-頭份,2024-01-26,9296
00895,富邦未來車,10,0,10,凱基-頭份,2024-01-26,9296
00664R,國泰臺灣加權反1,10,0,10,凱基-頭份,2024-01-26,9296
1618,合機,10,0,10,凱基-頭份,2024-01-26,9296
2356,英業達,21,11,10,凱基-頭份,2024-01-26,9296
3362,先進光,10,0,10,凱基-頭份,2024-01-26,9296
3363,上詮,10,0,10,凱基-頭份,2024-01-26,9296
3037,欣興,12,5,7,凱基-頭份,2024-01-26,9296
5603,陸海,7,0,7,凱基-頭份,2024-01-26,9296
8390,金益鼎,7,0,7,凱基-頭份,2024-01-26,9296
2618,長榮航,11,5,6,凱基-頭份,2024-01-26,9296
6237,驊訊,6,0,6,凱基-頭份,2024-01-26,9296
00637L,元大滬深300正2,5,0,5,凱基-頭份,2024-01-26,9296
00673R,期元大S＆P原油反1,5,0,5,凱基-頭份,2024-01-26,9296
00671R,富邦NASDAQ反1,5,0,5,凱基-頭份,2024-01-26,9296
2331,精英,7,2,5,凱基-頭份,2024-01-26,9296
2338,光罩,5,0,5,凱基-頭份,2024-01-26,9296
4168,醣聯,5,0,5,凱基-頭份,2024-01-26,9296
6164,華興,5,0,5,凱基-頭份,2024-01-26,9296
6219,富旺,6,1,5,凱基-頭份,2024-01-26,9296
9103,美德醫療-DR,5,0,5,凱基-頭份,2024-01-26,9296
2376,技嘉,6,2,4,凱基-頭份,2024-01-26,9296
3354,律勝,8,4,4,凱基-頭份,2024-01-26,9296
5489,彩富,4,0,4,凱基-頭份,2024-01-26,9296
5536,聖暉*,4,0,4,凱基-頭份,2024-01-26,9296
6229,研通,6,2,4,凱基-頭份,2024-01-26,9296
9919,康那香,4,0,4,凱基-頭份,2024-01-26,9296
00687B,國泰20年美債,3,0,3,凱基-頭份,2024-01-26,9296
00934,中信成長高股息,3,0,3,凱基-頭份,2024-01-26,9296
2345,智邦,3,0,3,凱基-頭份,2024-01-26,9296
3030,德律,3,0,3,凱基-頭份,2024-01-26,9296
3694,海華,14,11,3,凱基-頭份,2024-01-26,9296
3706,神達,5,2,3,凱基-頭份,2024-01-26,9296
6140,訊達,6,3,3,凱基-頭份,2024-01-26,9296
6173,信昌電,3,0,3,凱基-頭份,2024-01-26,9296
00632R,元大台灣50反1,100,0,100,凱基-頭份,2024-01-29,9296
2882,國泰金,50,0,50,凱基-頭份,2024-01-29,9296
8110,華東,22,0,22,凱基-頭份,2024-01-29,9296
00679B,元大美債20年,21,0,21,凱基-頭份,2024-01-29,9296
8011,台通,20,0,20,凱基-頭份,2024-01-29,9296
00929,復華台灣科技優息,28,9,19,凱基-頭份,2024-01-29,9296
3490,單井,18,2,16,凱基-頭份,2024-01-29,9296
2892,第一金,15,0,15,凱基-頭份,2024-01-29,9296
00664R,國泰臺灣加權反1,15,0,15,凱基-頭份,2024-01-29,9296
00919,群益台灣精選高息,13,0,13,凱基-頭份,2024-01-29,9296
4739,康普,12,0,12,凱基-頭份,2024-01-29,9296
00680L,元大美債20正2,11,0,11,凱基-頭份,2024-01-29,9296
00857B,永豐20年美公債,11,0,11,凱基-頭份,2024-01-29,9296
4402,郡都開發,11,0,11,凱基-頭份,2024-01-29,9296
4529,淳紳,11,0,11,凱基-頭份,2024-01-29,9296
8050,廣積,15,4,11,凱基-頭份,2024-01-29,9296
1309,台達化,10,0,10,凱基-頭份,2024-01-29,9296
1608,華榮,10,0,10,凱基-頭份,2024-01-29,9296
3033,威健,10,0,10,凱基-頭份,2024-01-29,9296
3712,永崴投控,10,0,10,凱基-頭份,2024-01-29,9296
6799,來頡,10,0,10,凱基-頭份,2024-01-29,9296
00937B,群益ESG投等債20,10,0,10,凱基-頭份,2024-01-29,9296
2356,英業達,26,18,8,凱基-頭份,2024-01-29,9296
6499,益安,8,0,8,凱基-頭份,2024-01-29,9296
1736,喬山,7,0,7,凱基-頭份,2024-01-29,9296
9105,泰金寶-DR,8,1,7,凱基-頭份,2024-01-29,9296
2520,冠德,6,0,6,凱基-頭份,2024-01-29,9296
3066,李洲,6,0,6,凱基-頭份,2024-01-29,9296
8096,擎亞,6,0,6,凱基-頭份,2024-01-29,9296
00877,復華中國5G,5,0,5,凱基-頭份,2024-01-29,9296
00642U,期元大S＆P石油,5,0,5,凱基-頭份,2024-01-29,9296
1326,台化,5,0,5,凱基-頭份,2024-01-29,9296
2498,宏達電,5,0,5,凱基-頭份,2024-01-29,9296
3376,新日興,6,1,5,凱基-頭份,2024-01-29,9296
3645,達邁,5,0,5,凱基-頭份,2024-01-29,9296
5536,聖暉*,5,0,5,凱基-頭份,2024-01-29,9296
6117,迎廣,5,0,5,凱基-頭份,2024-01-29,9296
2303,聯電,4,0,4,凱基-頭份,2024-01-29,9296
0056,元大高股息,4,0,4,凱基-頭份,2024-01-29,9296
2731,雄獅,4,0,4,凱基-頭份,2024-01-29,9296
6140,訊達,4,0,4,凱基-頭份,2024-01-29,9296
6153,嘉聯益,4,0,4,凱基-頭份,2024-01-29,9296
6223,旺矽,4,0,4,凱基-頭份,2024-01-29,9296
6695,芯鼎,5,1,4,凱基-頭份,2024-01-29,9296
8064,東捷,4,0,4,凱基-頭份,2024-01-29,9296
8390,金益鼎,4,0,4,凱基-頭份,2024-01-29,9296
00687B,國泰20年美債,5,2,3,凱基-頭份,2024-01-29,9296
00720B,元大投資級公司債,3,0,3,凱基-頭份,2024-01-29,9296
00795B,中信美國公債20年,3,0,3,凱基-頭份,2024-01-29,9296
2486,一詮,8,5,3,凱基-頭份,2024-01-29,9296
00687B,國泰20年美債,78,1,77,凱基-頭份,2024-01-30,9296
4804,大略-KY,77,10,67,凱基-頭份,2024-01-30,9296
00680L,元大美債20正2,63,0,63,凱基-頭份,2024-01-30,9296
1702,南僑,50,0,50,凱基-頭份,2024-01-30,9296
2880,華南金,50,0,50,凱基-頭份,2024-01-30,9296
3694,海華,40,0,40,凱基-頭份,2024-01-30,9296
00857B,永豐20年美公債,30,0,30,凱基-頭份,2024-01-30,9296
00929,復華台灣科技優息,47,20,27,凱基-頭份,2024-01-30,9296
2365,昆盈,31,5,26,凱基-頭份,2024-01-30,9296
2514,龍邦,26,0,26,凱基-頭份,2024-01-30,9296
2888,新光金,23,0,23,凱基-頭份,2024-01-30,9296
00650L,復華香港正2,20,0,20,凱基-頭份,2024-01-30,9296
00937B,群益ESG投等債20,28,10,18,凱基-頭份,2024-01-30,9296
00637L,元大滬深300正2,30,14,16,凱基-頭份,2024-01-30,9296
2324,仁寶,18,2,16,凱基-頭份,2024-01-30,9296
00632R,元大台灣50反1,14,0,14,凱基-頭份,2024-01-30,9296
2303,聯電,13,0,13,凱基-頭份,2024-01-30,9296
1514,亞力,13,1,12,凱基-頭份,2024-01-30,9296
2421,建準,26,14,12,凱基-頭份,2024-01-30,9296
3498,陽程,11,0,11,凱基-頭份,2024-01-30,9296
6217,中探針,11,0,11,凱基-頭份,2024-01-30,9296
00882,中信中國高股息,22,12,10,凱基-頭份,2024-01-30,9296
6799,來頡,10,0,10,凱基-頭份,2024-01-30,9296
2892,第一金,10,0,10,凱基-頭份,2024-01-30,9296
2609,陽明,11,1,10,凱基-頭份,2024-01-30,9296
8064,東捷,10,0,10,凱基-頭份,2024-01-30,9296
1560,中砂,11,1,10,凱基-頭份,2024-01-30,9296
3623,富晶通,14,6,8,凱基-頭份,2024-01-30,9296
3481,群創,25,17,8,凱基-頭份,2024-01-30,9296
3036,文曄,12,4,8,凱基-頭份,2024-01-30,9296
2345,智邦,9,2,7,凱基-頭份,2024-01-30,9296
3052,夆典,7,0,7,凱基-頭份,2024-01-30,9296
5426,振發,7,0,7,凱基-頭份,2024-01-30,9296
6535,順藥,7,0,7,凱基-頭份,2024-01-30,9296
00878,國泰永續高股息,9,3,6,凱基-頭份,2024-01-30,9296
00919,群益台灣精選高息,8,2,6,凱基-頭份,2024-01-30,9296
8926,台汽電,6,0,6,凱基-頭份,2024-01-30,9296
1101,台泥,5,0,5,凱基-頭份,2024-01-30,9296
5871,中租-KY,5,0,5,凱基-頭份,2024-01-30,9296
1712,興農,5,0,5,凱基-頭份,2024-01-30,9296
2611,志信,5,0,5,凱基-頭份,2024-01-30,9296
6125,廣運,88,83,5,凱基-頭份,2024-01-30,9296
6185,幃翔,5,0,5,凱基-頭份,2024-01-30,9296
2890,永豐金,20,15,5,凱基-頭份,2024-01-30,9296
00933B,國泰10Y+金融債,4,0,4,凱基-頭份,2024-01-30,9296
00679B,元大美債20年,4,0,4,凱基-頭份,2024-01-30,9296
00799B,國泰A級醫療債,4,0,4,凱基-頭份,2024-01-30,9296
2615,萬海,4,0,4,凱基-頭份,2024-01-30,9296
3548,兆利,6,2,4,凱基-頭份,2024-01-30,9296
5213,亞昕,4,0,4,凱基-頭份,2024-01-30,9296
00632R,元大台灣50反1,100,14,86,凱基-頭份,2024-01-31,9296
00687B,國泰20年美債,64,0,64,凱基-頭份,2024-01-31,9296
00665L,富邦�琤肭磪囓�2,52,0,52,凱基-頭份,2024-01-31,9296
00680L,元大美債20正2,30,0,30,凱基-頭份,2024-01-31,9296
00641R,富邦日本反1,30,0,30,凱基-頭份,2024-01-31,9296
00637L,元大滬深300正2,31,6,25,凱基-頭份,2024-01-31,9296
2888,新光金,23,0,23,凱基-頭份,2024-01-31,9296
2337,旺宏,23,1,22,凱基-頭份,2024-01-31,9296
00650L,復華香港正2,20,0,20,凱基-頭份,2024-01-31,9296
3041,揚智,20,0,20,凱基-頭份,2024-01-31,9296
2514,龍邦,19,0,19,凱基-頭份,2024-01-31,9296
2344,華邦電,16,2,14,凱基-頭份,2024-01-31,9296
00882,中信中國高股息,12,0,12,凱基-頭份,2024-01-31,9296
2002,中鋼,12,0,12,凱基-頭份,2024-01-31,9296
00857B,永豐20年美公債,11,0,11,凱基-頭份,2024-01-31,9296
3704,合勤控,12,1,11,凱基-頭份,2024-01-31,9296
00636,國泰中國A50,10,0,10,凱基-頭份,2024-01-31,9296
2355,敬鵬,10,0,10,凱基-頭份,2024-01-31,9296
6229,研通,10,0,10,凱基-頭份,2024-01-31,9296
2609,陽明,12,3,9,凱基-頭份,2024-01-31,9296
1513,中興電,27,19,8,凱基-頭份,2024-01-31,9296
6270,倍微,14,6,8,凱基-頭份,2024-01-31,9296
3231,緯創,11,4,7,凱基-頭份,2024-01-31,9296
00929,復華台灣科技優息,13,6,7,凱基-頭份,2024-01-31,9296
2025,千興,6,0,6,凱基-頭份,2024-01-31,9296
6695,芯鼎,21,15,6,凱基-頭份,2024-01-31,9296
00931B,統一美債20年,5,0,5,凱基-頭份,2024-01-31,9296
2308,台達電,5,0,5,凱基-頭份,2024-01-31,9296
6165,浪凡,5,0,5,凱基-頭份,2024-01-31,9296
2409,友達,7,2,5,凱基-頭份,2024-01-31,9296
2882,國泰金,5,0,5,凱基-頭份,2024-01-31,9296
3033,威健,10,5,5,凱基-頭份,2024-01-31,9296
8064,東捷,5,0,5,凱基-頭份,2024-01-31,9296
8076,伍豐,5,0,5,凱基-頭份,2024-01-31,9296
8403,盛弘,5,0,5,凱基-頭份,2024-01-31,9296
2352,佳世達,5,0,5,凱基-頭份,2024-01-31,9296
00922,國泰台灣領袖50,4,0,4,凱基-頭份,2024-01-31,9296
3052,夆典,4,0,4,凱基-頭份,2024-01-31,9296
6116,彩晶,4,0,4,凱基-頭份,2024-01-31,9296
8092,建暐,4,0,4,凱基-頭份,2024-01-31,9296
8096,擎亞,31,27,4,凱基-頭份,2024-01-31,9296
2449,京元電子,35,31,4,凱基-頭份,2024-01-31,9296
2382,廣達,74,71,3,凱基-頭份,2024-01-31,9296
00712,復華富時不動產,3,0,3,凱基-頭份,2024-01-31,9296
2324,仁寶,5,2,3,凱基-頭份,2024-01-31,9296
2329,華泰,5,2,3,凱基-頭份,2024-01-31,9296
2331,精英,3,0,3,凱基-頭份,2024-01-31,9296
4960,誠美材,3,0,3,凱基-頭份,2024-01-31,9296
6112,邁達特,3,0,3,凱基-頭份,2024-01-31,9296
6237,驊訊,5,2,3,凱基-頭份,2024-01-31,9296
00919,群益台灣精選高息,140,1,139,凱基-頭份,2024-02-01,9296
00665L,富邦�琤肭磪囓�2,130,10,120,凱基-頭份,2024-02-01,9296
00687B,國泰20年美債,111,0,111,凱基-頭份,2024-02-01,9296
3694,海華,33,3,30,凱基-頭份,2024-02-01,9296
9105,泰金寶-DR,26,0,26,凱基-頭份,2024-02-01,9296
5244,弘凱,20,0,20,凱基-頭份,2024-02-01,9296
00902,中信電池及儲能,19,0,19,凱基-頭份,2024-02-01,9296
2409,友達,21,2,19,凱基-頭份,2024-02-01,9296
3230,錦明,18,1,17,凱基-頭份,2024-02-01,9296
2356,英業達,15,0,15,凱基-頭份,2024-02-01,9296
00937B,群益ESG投等債20,14,1,13,凱基-頭份,2024-02-01,9296
5443,均豪,12,0,12,凱基-頭份,2024-02-01,9296
6530,創威,16,4,12,凱基-頭份,2024-02-01,9296
3354,律勝,36,25,11,凱基-頭份,2024-02-01,9296
3520,華盈,11,0,11,凱基-頭份,2024-02-01,9296
8936,國統,19,8,11,凱基-頭份,2024-02-01,9296
2101,南港,10,0,10,凱基-頭份,2024-02-01,9296
2105,正新,10,0,10,凱基-頭份,2024-02-01,9296
3704,合勤控,13,3,10,凱基-頭份,2024-02-01,9296
3231,緯創,12,2,10,凱基-頭份,2024-02-01,9296
2812,台中銀,314,305,9,凱基-頭份,2024-02-01,9296
2867,三商壽,9,0,9,凱基-頭份,2024-02-01,9296
6451,訊芯-KY,81,73,8,凱基-頭份,2024-02-01,9296
6243,迅杰,16,9,7,凱基-頭份,2024-02-01,9296
2633,台灣高鐵,6,0,6,凱基-頭份,2024-02-01,9296
2480,敦陽科,6,0,6,凱基-頭份,2024-02-01,9296
6275,元山,6,0,6,凱基-頭份,2024-02-01,9296
2330,台積電,7,2,5,凱基-頭份,2024-02-01,9296
00664R,國泰臺灣加權反1,5,0,5,凱基-頭份,2024-02-01,9296
2338,光罩,5,0,5,凱基-頭份,2024-02-01,9296
4729,熒茂,12,7,5,凱基-頭份,2024-02-01,9296
5284,jpp-KY,5,0,5,凱基-頭份,2024-02-01,9296
6505,台塑化,5,0,5,凱基-頭份,2024-02-01,9296
6695,芯鼎,38,33,5,凱基-頭份,2024-02-01,9296
2457,飛宏,7,2,5,凱基-頭份,2024-02-01,9296
00712,復華富時不動產,9,5,4,凱基-頭份,2024-02-01,9296
1784,訊聯,4,0,4,凱基-頭份,2024-02-01,9296
2465,麗臺,6,2,4,凱基-頭份,2024-02-01,9296
3360,尚立,5,1,4,凱基-頭份,2024-02-01,9296
8011,台通,6,2,4,凱基-頭份,2024-02-01,9296
6202,盛群,5,1,4,凱基-頭份,2024-02-01,9296
0050,元大台灣50,3,0,3,凱基-頭份,2024-02-01,9296
3450,聯鈞,3,0,3,凱基-頭份,2024-02-01,9296
3035,智原,6,3,3,凱基-頭份,2024-02-01,9296
00680L,元大美債20正2,3,0,3,凱基-頭份,2024-02-01,9296
2303,聯電,5,2,3,凱基-頭份,2024-02-01,9296
2401,凌陽,3,0,3,凱基-頭份,2024-02-01,9296
2615,萬海,4,1,3,凱基-頭份,2024-02-01,9296
3376,新日興,4,1,3,凱基-頭份,2024-02-01,9296
4909,新復興,9,6,3,凱基-頭份,2024-02-01,9296
2883,凱基金,102,10,92,凱基-頭份,2024-02-02,9296
00882,中信中國高股息,89,0,89,凱基-頭份,2024-02-02,9296
4534,慶騰,32,0,32,凱基-頭份,2024-02-02,9296
4906,正文,35,4,31,凱基-頭份,2024-02-02,9296
8403,盛弘,28,0,28,凱基-頭份,2024-02-02,9296
00857B,永豐20年美公債,24,0,24,凱基-頭份,2024-02-02,9296
00642U,期元大S＆P石油,22,0,22,凱基-頭份,2024-02-02,9296
00687B,國泰20年美債,22,0,22,凱基-頭份,2024-02-02,9296
00641R,富邦日本反1,20,0,20,凱基-頭份,2024-02-02,9296
00680L,元大美債20正2,20,0,20,凱基-頭份,2024-02-02,9296
2363,矽統,20,0,20,凱基-頭份,2024-02-02,9296
00933B,國泰10Y+金融債,22,3,19,凱基-頭份,2024-02-02,9296
6282,康舒,17,0,17,凱基-頭份,2024-02-02,9296
1514,亞力,17,2,15,凱基-頭份,2024-02-02,9296
1324,地球,15,0,15,凱基-頭份,2024-02-02,9296
3694,海華,17,2,15,凱基-頭份,2024-02-02,9296
8936,國統,13,0,13,凱基-頭份,2024-02-02,9296
2609,陽明,125,114,11,凱基-頭份,2024-02-02,9296
00671R,富邦NASDAQ反1,10,0,10,凱基-頭份,2024-02-02,9296
1608,華榮,10,0,10,凱基-頭份,2024-02-02,9296
1736,喬山,10,0,10,凱基-頭份,2024-02-02,9296
00690,兆豐藍籌30,9,0,9,凱基-頭份,2024-02-02,9296
4157,太景*-KY,9,0,9,凱基-頭份,2024-02-02,9296
00937B,群益ESG投等債20,12,4,8,凱基-頭份,2024-02-02,9296
2356,英業達,17,9,8,凱基-頭份,2024-02-02,9296
2379,瑞昱,14,6,8,凱基-頭份,2024-02-02,9296
3055,蔚華科,11,3,8,凱基-頭份,2024-02-02,9296
00929,復華台灣科技優息,8,0,8,凱基-頭份,2024-02-02,9296
2303,聯電,10,3,7,凱基-頭份,2024-02-02,9296
4183,福永生技,7,0,7,凱基-頭份,2024-02-02,9296
6442,光聖,10,3,7,凱基-頭份,2024-02-02,9296
8926,台汽電,7,0,7,凱基-頭份,2024-02-02,9296
00712,復華富時不動產,6,0,6,凱基-頭份,2024-02-02,9296
2812,台中銀,8,2,6,凱基-頭份,2024-02-02,9296
00799B,國泰A級醫療債,6,0,6,凱基-頭份,2024-02-02,9296
00918,大華優利高填息30,6,0,6,凱基-頭份,2024-02-02,9296
2002,中鋼,11,5,6,凱基-頭份,2024-02-02,9296
2324,仁寶,7,1,6,凱基-頭份,2024-02-02,9296
8277,商丞,6,0,6,凱基-頭份,2024-02-02,9296
6165,浪凡,5,0,5,凱基-頭份,2024-02-02,9296
3490,單井,5,0,5,凱基-頭份,2024-02-02,9296
2308,台達電,5,0,5,凱基-頭份,2024-02-02,9296
3041,揚智,15,10,5,凱基-頭份,2024-02-02,9296
3481,群創,6,1,5,凱基-頭份,2024-02-02,9296
5403,中菲,5,0,5,凱基-頭份,2024-02-02,9296
6465,威潤,5,0,5,凱基-頭份,2024-02-02,9296
2603,長榮,104,100,4,凱基-頭份,2024-02-02,9296
2633,台灣高鐵,4,0,4,凱基-頭份,2024-02-02,9296
3013,晟銘電,16,12,4,凱基-頭份,2024-02-02,9296
3058,立德,4,0,4,凱基-頭份,2024-02-02,9296
2812,台中銀,269,0,269,凱基-頭份,2024-02-05,9296
3710,連展投控,98,0,98,凱基-頭份,2024-02-05,9296
00706L,期元大S＆P日圓正2,50,0,50,凱基-頭份,2024-02-05,9296
4414,如興,50,0,50,凱基-頭份,2024-02-05,9296
912000,晨訊科-DR,50,0,50,凱基-頭份,2024-02-05,9296
2884,玉山金,42,1,41,凱基-頭份,2024-02-05,9296
00680L,元大美債20正2,40,0,40,凱基-頭份,2024-02-05,9296
00687B,國泰20年美債,38,0,38,凱基-頭份,2024-02-05,9296
00937B,群益ESG投等債20,35,0,35,凱基-頭份,2024-02-05,9296
3704,合勤控,28,1,27,凱基-頭份,2024-02-05,9296
2401,凌陽,26,1,25,凱基-頭份,2024-02-05,9296
00929,復華台灣科技優息,24,2,22,凱基-頭份,2024-02-05,9296
00642U,期元大S＆P石油,21,0,21,凱基-頭份,2024-02-05,9296
2886,兆豐金,21,1,20,凱基-頭份,2024-02-05,9296
1316,上曜,20,0,20,凱基-頭份,2024-02-05,9296
8354,冠好,20,0,20,凱基-頭份,2024-02-05,9296
00882,中信中國高股息,21,2,19,凱基-頭份,2024-02-05,9296
1609,大亞,20,2,18,凱基-頭份,2024-02-05,9296
1732,毛寶,15,0,15,凱基-頭份,2024-02-05,9296
00919,群益台灣精選高息,37,23,14,凱基-頭份,2024-02-05,9296
00878,國泰永續高股息,20,6,14,凱基-頭份,2024-02-05,9296
3530,晶相光,13,0,13,凱基-頭份,2024-02-05,9296
4989,榮科,13,0,13,凱基-頭份,2024-02-05,9296
00931B,統一美債20年,12,0,12,凱基-頭份,2024-02-05,9296
6120,達運,31,20,11,凱基-頭份,2024-02-05,9296
00679B,元大美債20年,13,3,10,凱基-頭份,2024-02-05,9296
2356,英業達,15,5,10,凱基-頭份,2024-02-05,9296
00715L,期街口布蘭特正2,10,0,10,凱基-頭份,2024-02-05,9296
00632R,元大台灣50反1,10,0,10,凱基-頭份,2024-02-05,9296
3593,力銘,10,0,10,凱基-頭份,2024-02-05,9296
3694,海華,10,0,10,凱基-頭份,2024-02-05,9296
6122,擎邦,10,0,10,凱基-頭份,2024-02-05,9296
6442,光聖,10,0,10,凱基-頭份,2024-02-05,9296
8064,東捷,10,0,10,凱基-頭份,2024-02-05,9296
0056,元大高股息,11,4,7,凱基-頭份,2024-02-05,9296
2352,佳世達,7,0,7,凱基-頭份,2024-02-05,9296
8926,台汽電,7,0,7,凱基-頭份,2024-02-05,9296
00860B,群益1-5Y投資級債,6,0,6,凱基-頭份,2024-02-05,9296
00857B,永豐20年美公債,6,0,6,凱基-頭份,2024-02-05,9296
3041,揚智,6,0,6,凱基-頭份,2024-02-05,9296
8111,立��,6,0,6,凱基-頭份,2024-02-05,9296
00650L,復華香港正2,20,15,5,凱基-頭份,2024-02-05,9296
00641R,富邦日本反1,5,0,5,凱基-頭份,2024-02-05,9296
6243,迅杰,8,3,5,凱基-頭份,2024-02-05,9296
6695,芯鼎,12,7,5,凱基-頭份,2024-02-05,9296
00751B,元大AAA至A公司債,4,0,4,凱基-頭份,2024-02-05,9296
1905,華紙,4,0,4,凱基-頭份,2024-02-05,9296
1909,榮成,4,0,4,凱基-頭份,2024-02-05,9296
2329,華泰,8,4,4,凱基-頭份,2024-02-05,9296
2527,宏璟,4,0,4,凱基-頭份,2024-02-05,9296
00632R,元大台灣50反1,87,0,87,凱基-頭份,2024-02-15,9296
2344,華邦電,85,6,79,凱基-頭份,2024-02-15,9296
00937B,群益ESG投等債20,74,0,74,凱基-頭份,2024-02-15,9296
2801,彰銀,69,0,69,凱基-頭份,2024-02-15,9296
00929,復華台灣科技優息,96,34,62,凱基-頭份,2024-02-15,9296
00680L,元大美債20正2,58,0,58,凱基-頭份,2024-02-15,9296
00712,復華富時不動產,60,6,54,凱基-頭份,2024-02-15,9296
2887,台新金,50,0,50,凱基-頭份,2024-02-15,9296
912000,晨訊科-DR,50,0,50,凱基-頭份,2024-02-15,9296
2610,華航,41,0,41,凱基-頭份,2024-02-15,9296
00687B,國泰20年美債,41,2,39,凱基-頭份,2024-02-15,9296
3014,聯陽,41,5,36,凱基-頭份,2024-02-15,9296
4162,智擎,35,2,33,凱基-頭份,2024-02-15,9296
2387,精元,30,0,30,凱基-頭份,2024-02-15,9296
00919,群益台灣精選高息,46,16,30,凱基-頭份,2024-02-15,9296
00786B,元大10年IG銀行債,26,0,26,凱基-頭份,2024-02-15,9296
00679B,元大美債20年,25,0,25,凱基-頭份,2024-02-15,9296
00918,大華優利高填息30,23,0,23,凱基-頭份,2024-02-15,9296
2618,長榮航,23,0,23,凱基-頭份,2024-02-15,9296
5905,南仁湖,22,0,22,凱基-頭份,2024-02-15,9296
00857B,永豐20年美公債,20,0,20,凱基-頭份,2024-02-15,9296
00664R,國泰臺灣加權反1,20,0,20,凱基-頭份,2024-02-15,9296
6122,擎邦,20,1,19,凱基-頭份,2024-02-15,9296
00753L,中信中國50正2,20,3,17,凱基-頭份,2024-02-15,9296
2885,元大金,15,1,14,凱基-頭份,2024-02-15,9296
4303,信立,15,1,14,凱基-頭份,2024-02-15,9296
6223,旺矽,13,0,13,凱基-頭份,2024-02-15,9296
8110,華東,12,0,12,凱基-頭份,2024-02-15,9296
00882,中信中國高股息,18,7,11,凱基-頭份,2024-02-15,9296
1102,亞泥,11,0,11,凱基-頭份,2024-02-15,9296
2002,中鋼,12,1,11,凱基-頭份,2024-02-15,9296
1514,亞力,11,1,10,凱基-頭份,2024-02-15,9296
2345,智邦,19,9,10,凱基-頭份,2024-02-15,9296
00904,新光臺灣半導體30,10,0,10,凱基-頭份,2024-02-15,9296
2880,華南金,10,0,10,凱基-頭份,2024-02-15,9296
3664,安瑞-KY,10,0,10,凱基-頭份,2024-02-15,9296
3694,海華,10,0,10,凱基-頭份,2024-02-15,9296
6742,澤米,11,1,10,凱基-頭份,2024-02-15,9296
3548,兆利,12,3,9,凱基-頭份,2024-02-15,9296
2891,中信金,10,1,9,凱基-頭份,2024-02-15,9296
3710,連展投控,9,0,9,凱基-頭份,2024-02-15,9296
00933B,國泰10Y+金融債,9,0,9,凱基-頭份,2024-02-15,9296
6770,力積電,16,7,9,凱基-頭份,2024-02-15,9296
2809,京城銀,8,0,8,凱基-頭份,2024-02-15,9296
2408,南亞科,8,0,8,凱基-頭份,2024-02-15,9296
4109,加捷生醫,10,2,8,凱基-頭份,2024-02-15,9296
8068,全達,8,0,8,凱基-頭份,2024-02-15,9296
00795B,中信美國公債20年,7,0,7,凱基-頭份,2024-02-15,9296
2369,菱生,10,3,7,凱基-頭份,2024-02-15,9296
2421,建準,12,6,6,凱基-頭份,2024-02-15,9296
00688L,國泰20年美債正2,350,0,350,凱基-頭份,2024-02-16,9296
00650L,復華香港正2,200,25,175,凱基-頭份,2024-02-16,9296
00882,中信中國高股息,40,0,40,凱基-頭份,2024-02-16,9296
2352,佳世達,44,5,39,凱基-頭份,2024-02-16,9296
00680L,元大美債20正2,31,0,31,凱基-頭份,2024-02-16,9296
1616,億泰,30,0,30,凱基-頭份,2024-02-16,9296
2888,新光金,26,0,26,凱基-頭份,2024-02-16,9296
00933B,國泰10Y+金融債,24,0,24,凱基-頭份,2024-02-16,9296
6219,富旺,21,1,20,凱基-頭份,2024-02-16,9296
00712,復華富時不動產,20,2,18,凱基-頭份,2024-02-16,9296
00679B,元大美債20年,17,0,17,凱基-頭份,2024-02-16,9296
6770,力積電,23,6,17,凱基-頭份,2024-02-16,9296
6451,訊芯-KY,78,63,15,凱基-頭份,2024-02-16,9296
3312,弘憶股,17,3,14,凱基-頭份,2024-02-16,9296
6733,博晟生醫,13,0,13,凱基-頭份,2024-02-16,9296
0056,元大高股息,22,10,12,凱基-頭份,2024-02-16,9296
1609,大亞,12,0,12,凱基-頭份,2024-02-16,9296
2387,精元,20,8,12,凱基-頭份,2024-02-16,9296
6672,騰輝電子-KY,13,1,12,凱基-頭份,2024-02-16,9296
2413,環科,10,0,10,凱基-頭份,2024-02-16,9296
3038,全台,10,0,10,凱基-頭份,2024-02-16,9296
6122,擎邦,10,0,10,凱基-頭份,2024-02-16,9296
6223,旺矽,10,0,10,凱基-頭份,2024-02-16,9296
6742,澤米,10,0,10,凱基-頭份,2024-02-16,9296
8112,至上,10,0,10,凱基-頭份,2024-02-16,9296
8403,盛弘,10,0,10,凱基-頭份,2024-02-16,9296
2367,燿華,12,3,9,凱基-頭份,2024-02-16,9296
2812,台中銀,11,2,9,凱基-頭份,2024-02-16,9296
5278,尚凡*,9,0,9,凱基-頭份,2024-02-16,9296
00687B,國泰20年美債,10,2,8,凱基-頭份,2024-02-16,9296
1522,堤維西,17,9,8,凱基-頭份,2024-02-16,9296
8201,無敵,8,0,8,凱基-頭份,2024-02-16,9296
00936,台新永續高息中小,7,0,7,凱基-頭份,2024-02-16,9296
1560,中砂,7,0,7,凱基-頭份,2024-02-16,9296
3081,聯亞,8,1,7,凱基-頭份,2024-02-16,9296
2884,玉山金,7,0,7,凱基-頭份,2024-02-16,9296
3005,神基,7,1,6,凱基-頭份,2024-02-16,9296
00641R,富邦日本反1,6,0,6,凱基-頭份,2024-02-16,9296
3346,麗清,6,0,6,凱基-頭份,2024-02-16,9296
2007,燁興,5,0,5,凱基-頭份,2024-02-16,9296
2457,飛宏,6,1,5,凱基-頭份,2024-02-16,9296
3268,海德威,5,0,5,凱基-頭份,2024-02-16,9296
4129,聯合,5,0,5,凱基-頭份,2024-02-16,9296
6126,信音,5,0,5,凱基-頭份,2024-02-16,9296
8070,長華*,9,4,5,凱基-頭份,2024-02-16,9296
2382,廣達,7,3,4,凱基-頭份,2024-02-16,9296
1220,台榮,4,0,4,凱基-頭份,2024-02-16,9296
3035,智原,6,2,4,凱基-頭份,2024-02-16,9296
4306,炎洲,4,0,4,凱基-頭份,2024-02-16,9296
5244,弘凱,4,0,4,凱基-頭份,2024-02-16,9296
1714,和桐,169,0,169,凱基-頭份,2024-02-19,9296
00900,富邦特選高股息30,150,0,150,凱基-頭份,2024-02-19,9296
00878,國泰永續高股息,66,4,62,凱基-頭份,2024-02-19,9296
00919,群益台灣精選高息,57,4,53,凱基-頭份,2024-02-19,9296
1201,味全,50,0,50,凱基-頭份,2024-02-19,9296
2867,三商壽,36,0,36,凱基-頭份,2024-02-19,9296
2365,昆盈,41,7,34,凱基-頭份,2024-02-19,9296
00937B,群益ESG投等債20,30,0,30,凱基-頭份,2024-02-19,9296
00882,中信中國高股息,28,0,28,凱基-頭份,2024-02-19,9296
0056,元大高股息,28,0,28,凱基-頭份,2024-02-19,9296
2329,華泰,34,8,26,凱基-頭份,2024-02-19,9296
00679B,元大美債20年,22,0,22,凱基-頭份,2024-02-19,9296
00641R,富邦日本反1,20,0,20,凱基-頭份,2024-02-19,9296
2409,友達,18,1,17,凱基-頭份,2024-02-19,9296
00687B,國泰20年美債,25,10,15,凱基-頭份,2024-02-19,9296
5465,富驊,15,0,15,凱基-頭份,2024-02-19,9296
00680L,元大美債20正2,14,0,14,凱基-頭份,2024-02-19,9296
00933B,國泰10Y+金融債,15,2,13,凱基-頭份,2024-02-19,9296
1503,士電,18,5,13,凱基-頭份,2024-02-19,9296
2337,旺宏,12,0,12,凱基-頭份,2024-02-19,9296
2374,佳能,12,0,12,凱基-頭份,2024-02-19,9296
3437,榮創,23,11,12,凱基-頭份,2024-02-19,9296
00688L,國泰20年美債正2,11,0,11,凱基-頭份,2024-02-19,9296
3046,建��,11,0,11,凱基-頭份,2024-02-19,9296
2884,玉山金,11,1,10,凱基-頭份,2024-02-19,9296
2489,瑞軒,11,1,10,凱基-頭份,2024-02-19,9296
2515,中工,10,0,10,凱基-頭份,2024-02-19,9296
3664,安瑞-KY,10,0,10,凱基-頭份,2024-02-19,9296
3694,海華,10,0,10,凱基-頭份,2024-02-19,9296
5426,振發,20,10,10,凱基-頭份,2024-02-19,9296
2353,宏��,23,13,10,凱基-頭份,2024-02-19,9296
3450,聯鈞,21,12,9,凱基-頭份,2024-02-19,9296
6125,廣運,17,8,9,凱基-頭份,2024-02-19,9296
6742,澤米,10,1,9,凱基-頭份,2024-02-19,9296
00637L,元大滬深300正2,24,16,8,凱基-頭份,2024-02-19,9296
2547,日勝生,8,0,8,凱基-頭份,2024-02-19,9296
6224,聚鼎,9,1,8,凱基-頭份,2024-02-19,9296
3035,智原,9,1,8,凱基-頭份,2024-02-19,9296
2356,英業達,23,16,7,凱基-頭份,2024-02-19,9296
3322,建舜電,7,0,7,凱基-頭份,2024-02-19,9296
00786B,元大10年IG銀行債,6,0,6,凱基-頭份,2024-02-19,9296
1733,五鼎,6,0,6,凱基-頭份,2024-02-19,9296
2355,敬鵬,7,1,6,凱基-頭份,2024-02-19,9296
2390,云辰,6,0,6,凱基-頭份,2024-02-19,9296
2421,建準,7,1,6,凱基-頭份,2024-02-19,9296
6183,關貿,6,0,6,凱基-頭份,2024-02-19,9296
8081,致新,6,0,6,凱基-頭份,2024-02-19,9296
3231,緯創,7,2,5,凱基-頭份,2024-02-19,9296
00671R,富邦NASDAQ反1,5,0,5,凱基-頭份,2024-02-19,9296
00931B,統一美債20年,5,0,5,凱基-頭份,2024-02-19,9296
00933B,國泰10Y+金融債,507,0,507,凱基-頭份,2024-02-20,9296
3049,精金,360,0,360,凱基-頭份,2024-02-20,9296
2834,臺企銀,240,0,240,凱基-頭份,2024-02-20,9296
2409,友達,202,3,199,凱基-頭份,2024-02-20,9296
912000,晨訊科-DR,100,0,100,凱基-頭份,2024-02-20,9296
2344,華邦電,92,1,91,凱基-頭份,2024-02-20,9296
2514,龍邦,55,0,55,凱基-頭份,2024-02-20,9296
2027,大成鋼,50,0,50,凱基-頭份,2024-02-20,9296
4804,大略-KY,38,0,38,凱基-頭份,2024-02-20,9296
6126,信音,30,0,30,凱基-頭份,2024-02-20,9296
00680L,元大美債20正2,28,0,28,凱基-頭份,2024-02-20,9296
3057,喬鼎,27,0,27,凱基-頭份,2024-02-20,9296
00929,復華台灣科技優息,46,24,22,凱基-頭份,2024-02-20,9296
2886,兆豐金,20,0,20,凱基-頭份,2024-02-20,9296
2356,英業達,25,5,20,凱基-頭份,2024-02-20,9296
1513,中興電,22,4,18,凱基-頭份,2024-02-20,9296
3704,合勤控,24,7,17,凱基-頭份,2024-02-20,9296
2349,錸德,14,0,14,凱基-頭份,2024-02-20,9296
3037,欣興,16,2,14,凱基-頭份,2024-02-20,9296
2884,玉山金,15,2,13,凱基-頭份,2024-02-20,9296
2489,瑞軒,15,2,13,凱基-頭份,2024-02-20,9296
8110,華東,18,5,13,凱基-頭份,2024-02-20,9296
00712,復華富時不動產,11,0,11,凱基-頭份,2024-02-20,9296
00632R,元大台灣50反1,10,0,10,凱基-頭份,2024-02-20,9296
2002,中鋼,10,0,10,凱基-頭份,2024-02-20,9296
6284,佳邦,10,0,10,凱基-頭份,2024-02-20,9296
2405,輔信,17,8,9,凱基-頭份,2024-02-20,9296
2615,萬海,10,1,9,凱基-頭份,2024-02-20,9296
4561,健椿,9,0,9,凱基-頭份,2024-02-20,9296
8011,台通,9,0,9,凱基-頭份,2024-02-20,9296
3231,緯創,10,2,8,凱基-頭份,2024-02-20,9296
5465,富驊,8,1,7,凱基-頭份,2024-02-20,9296
6243,迅杰,11,4,7,凱基-頭份,2024-02-20,9296
2363,矽統,6,0,6,凱基-頭份,2024-02-20,9296
1514,亞力,6,0,6,凱基-頭份,2024-02-20,9296
2633,台灣高鐵,6,0,6,凱基-頭份,2024-02-20,9296
2888,新光金,6,0,6,凱基-頭份,2024-02-20,9296
3260,威剛,6,0,6,凱基-頭份,2024-02-20,9296
6742,澤米,7,1,6,凱基-頭份,2024-02-20,9296
3035,智原,7,2,5,凱基-頭份,2024-02-20,9296
00637L,元大滬深300正2,5,0,5,凱基-頭份,2024-02-20,9296
00897,富邦基因免疫生技,5,0,5,凱基-頭份,2024-02-20,9296
1905,華紙,5,0,5,凱基-頭份,2024-02-20,9296
2025,千興,5,0,5,凱基-頭份,2024-02-20,9296
2367,燿華,5,0,5,凱基-頭份,2024-02-20,9296
2436,偉詮電,7,2,5,凱基-頭份,2024-02-20,9296
2867,三商壽,5,0,5,凱基-頭份,2024-02-20,9296
3048,益登,5,0,5,凱基-頭份,2024-02-20,9296
3052,夆典,5,0,5,凱基-頭份,2024-02-20,9296
3664,安瑞-KY,5,0,5,凱基-頭份,2024-02-20,9296
00882,中信中國高股息,524,12,512,凱基-頭份,2024-02-21,9296
00919,群益台灣精選高息,159,5,154,凱基-頭份,2024-02-21,9296
00878,國泰永續高股息,148,0,148,凱基-頭份,2024-02-21,9296
2834,臺企銀,55,0,55,凱基-頭份,2024-02-21,9296
00795B,中信美國公債20年,39,0,39,凱基-頭份,2024-02-21,9296
00933B,國泰10Y+金融債,36,0,36,凱基-頭份,2024-02-21,9296
2344,華邦電,40,6,34,凱基-頭份,2024-02-21,9296
2609,陽明,281,250,31,凱基-頭份,2024-02-21,9296
1608,華榮,30,0,30,凱基-頭份,2024-02-21,9296
2618,長榮航,30,0,30,凱基-頭份,2024-02-21,9296
2886,兆豐金,30,0,30,凱基-頭份,2024-02-21,9296
00937B,群益ESG投等債20,23,0,23,凱基-頭份,2024-02-21,9296
3005,神基,29,7,22,凱基-頭份,2024-02-21,9296
00680L,元大美債20正2,22,0,22,凱基-頭份,2024-02-21,9296
1316,上曜,27,5,22,凱基-頭份,2024-02-21,9296
2610,華航,18,0,18,凱基-頭份,2024-02-21,9296
2637,慧洋-KY,22,4,18,凱基-頭份,2024-02-21,9296
2884,玉山金,16,0,16,凱基-頭份,2024-02-21,9296
2641,正德,15,0,15,凱基-頭份,2024-02-21,9296
00687B,國泰20年美債,14,0,14,凱基-頭份,2024-02-21,9296
6116,彩晶,14,0,14,凱基-頭份,2024-02-21,9296
3374,精材,14,1,13,凱基-頭份,2024-02-21,9296
00725B,國泰投資級公司債,11,0,11,凱基-頭份,2024-02-21,9296
2887,台新金,11,0,11,凱基-頭份,2024-02-21,9296
00923,群益台ESG低碳50,10,0,10,凱基-頭份,2024-02-21,9296
00930,永豐ESG低碳高息,10,0,10,凱基-頭份,2024-02-21,9296
00641R,富邦日本反1,10,0,10,凱基-頭份,2024-02-21,9296
00664R,國泰臺灣加權反1,10,0,10,凱基-頭份,2024-02-21,9296
1615,大山,10,0,10,凱基-頭份,2024-02-21,9296
2105,正新,10,0,10,凱基-頭份,2024-02-21,9296
2369,菱生,10,0,10,凱基-頭份,2024-02-21,9296
2390,云辰,10,0,10,凱基-頭份,2024-02-21,9296
2514,龍邦,10,0,10,凱基-頭份,2024-02-21,9296
3390,旭軟,10,0,10,凱基-頭份,2024-02-21,9296
3694,海華,10,0,10,凱基-頭份,2024-02-21,9296
3706,神達,15,5,10,凱基-頭份,2024-02-21,9296
5452,佶優,10,0,10,凱基-頭份,2024-02-21,9296
6265,方土昶,10,0,10,凱基-頭份,2024-02-21,9296
9902,台火,10,0,10,凱基-頭份,2024-02-21,9296
6535,順藥,13,3,10,凱基-頭份,2024-02-21,9296
6282,康舒,11,2,9,凱基-頭份,2024-02-21,9296
00918,大華優利高填息30,9,0,9,凱基-頭份,2024-02-21,9296
3041,揚智,17,8,9,凱基-頭份,2024-02-21,9296
3047,訊舟,10,1,9,凱基-頭份,2024-02-21,9296
3372,典範,12,3,9,凱基-頭份,2024-02-21,9296
00712,復華富時不動產,8,0,8,凱基-頭份,2024-02-21,9296
2303,聯電,10,2,8,凱基-頭份,2024-02-21,9296
6219,富旺,8,0,8,凱基-頭份,2024-02-21,9296
6742,澤米,8,1,7,凱基-頭份,2024-02-21,9296
2376,技嘉,6,0,6,凱基-頭份,2024-02-21,9296
2882,國泰金,351,51,300,凱基-頭份,2024-02-22,9296
911868,同方友友-DR,100,0,100,凱基-頭份,2024-02-22,9296
1714,和桐,31,0,31,凱基-頭份,2024-02-22,9296
1201,味全,30,0,30,凱基-頭份,2024-02-22,9296
00687B,國泰20年美債,29,2,27,凱基-頭份,2024-02-22,9296
2801,彰銀,27,0,27,凱基-頭份,2024-02-22,9296
6438,迅得,26,0,26,凱基-頭份,2024-02-22,9296
9105,泰金寶-DR,35,10,25,凱基-頭份,2024-02-22,9296
2484,希華,20,0,20,凱基-頭份,2024-02-22,9296
00919,群益台灣精選高息,31,11,20,凱基-頭份,2024-02-22,9296
5347,世界,20,3,17,凱基-頭份,2024-02-22,9296
00878,國泰永續高股息,18,2,16,凱基-頭份,2024-02-22,9296
2887,台新金,15,0,15,凱基-頭份,2024-02-22,9296
1447,力鵬,15,0,15,凱基-頭份,2024-02-22,9296
2884,玉山金,15,0,15,凱基-頭份,2024-02-22,9296
6451,訊芯-KY,46,32,14,凱基-頭份,2024-02-22,9296
2460,建通,16,2,14,凱基-頭份,2024-02-22,9296
6770,力積電,17,4,13,凱基-頭份,2024-02-22,9296
5880,合庫金,13,0,13,凱基-頭份,2024-02-22,9296
00753L,中信中國50正2,12,0,12,凱基-頭份,2024-02-22,9296
1736,喬山,12,0,12,凱基-頭份,2024-02-22,9296
2303,聯電,12,0,12,凱基-頭份,2024-02-22,9296
00712,復華富時不動產,11,0,11,凱基-頭份,2024-02-22,9296
00680L,元大美債20正2,11,0,11,凱基-頭份,2024-02-22,9296
2409,友達,14,3,11,凱基-頭份,2024-02-22,9296
2371,大同,10,0,10,凱基-頭份,2024-02-22,9296
00762,元大全球AI,10,0,10,凱基-頭份,2024-02-22,9296
00632R,元大台灣50反1,10,0,10,凱基-頭份,2024-02-22,9296
00665L,富邦�琤肭磪囓�2,10,0,10,凱基-頭份,2024-02-22,9296
3498,陽程,10,0,10,凱基-頭份,2024-02-22,9296
3645,達邁,10,0,10,凱基-頭份,2024-02-22,9296
6156,松上,10,0,10,凱基-頭份,2024-02-22,9296
8289,泰藝,10,0,10,凱基-頭份,2024-02-22,9296
00688L,國泰20年美債正2,9,0,9,凱基-頭份,2024-02-22,9296
6219,富旺,9,0,9,凱基-頭份,2024-02-22,9296
6668,中揚光,11,2,9,凱基-頭份,2024-02-22,9296
3231,緯創,27,18,9,凱基-頭份,2024-02-22,9296
00897,富邦基因免疫生技,8,0,8,凱基-頭份,2024-02-22,9296
4977,眾達-KY,8,0,8,凱基-頭份,2024-02-22,9296
6116,彩晶,8,0,8,凱基-頭份,2024-02-22,9296
2329,華泰,40,33,7,凱基-頭份,2024-02-22,9296
2344,華邦電,11,4,7,凱基-頭份,2024-02-22,9296
3548,兆利,10,3,7,凱基-頭份,2024-02-22,9296
4909,新復興,9,2,7,凱基-頭份,2024-02-22,9296
00751B,元大AAA至A公司債,6,0,6,凱基-頭份,2024-02-22,9296
00725B,國泰投資級公司債,6,0,6,凱基-頭份,2024-02-22,9296
2547,日勝生,6,0,6,凱基-頭份,2024-02-22,9296
3312,弘憶股,6,0,6,凱基-頭份,2024-02-22,9296
3504,揚明光,6,0,6,凱基-頭份,2024-02-22,9296
00671R,富邦NASDAQ反1,5,0,5,凱基-頭份,2024-02-22,9296
2887,台新金,518,0,518,凱基-頭份,2024-02-23,9296
2834,臺企銀,353,0,353,凱基-頭份,2024-02-23,9296
2882,國泰金,326,11,315,凱基-頭份,2024-02-23,9296
2514,龍邦,73,0,73,凱基-頭份,2024-02-23,9296
00878,國泰永續高股息,52,2,50,凱基-頭份,2024-02-23,9296
3049,精金,50,0,50,凱基-頭份,2024-02-23,9296
911868,同方友友-DR,48,0,48,凱基-頭份,2024-02-23,9296
9105,泰金寶-DR,40,0,40,凱基-頭份,2024-02-23,9296
00891,中信關鍵半導體,28,0,28,凱基-頭份,2024-02-23,9296
00937B,群益ESG投等債20,26,0,26,凱基-頭份,2024-02-23,9296
2363,矽統,25,1,24,凱基-頭份,2024-02-23,9296
0056,元大高股息,37,13,24,凱基-頭份,2024-02-23,9296
00919,群益台灣精選高息,69,46,23,凱基-頭份,2024-02-23,9296
2025,千興,20,0,20,凱基-頭份,2024-02-23,9296
2101,南港,20,0,20,凱基-頭份,2024-02-23,9296
2369,菱生,21,1,20,凱基-頭份,2024-02-23,9296
2618,長榮航,23,3,20,凱基-頭份,2024-02-23,9296
00687B,國泰20年美債,19,0,19,凱基-頭份,2024-02-23,9296
1316,上曜,24,5,19,凱基-頭份,2024-02-23,9296
2313,華通,41,23,18,凱基-頭份,2024-02-23,9296
1305,華夏,16,0,16,凱基-頭份,2024-02-23,9296
2884,玉山金,15,0,15,凱基-頭份,2024-02-23,9296
00706L,期元大S＆P日圓正2,15,0,15,凱基-頭份,2024-02-23,9296
3372,典範,15,0,15,凱基-頭份,2024-02-23,9296
2610,華航,15,0,15,凱基-頭份,2024-02-23,9296
2002,中鋼,13,0,13,凱基-頭份,2024-02-23,9296
00680L,元大美債20正2,13,0,13,凱基-頭份,2024-02-23,9296
00795B,中信美國公債20年,12,0,12,凱基-頭份,2024-02-23,9296
2883,凱基金,11,0,11,凱基-頭份,2024-02-23,9296
3481,群創,34,23,11,凱基-頭份,2024-02-23,9296
00753L,中信中國50正2,11,0,11,凱基-頭份,2024-02-23,9296
3037,欣興,14,3,11,凱基-頭份,2024-02-23,9296
00720B,元大投資級公司債,10,0,10,凱基-頭份,2024-02-23,9296
00632R,元大台灣50反1,20,10,10,凱基-頭份,2024-02-23,9296
00665L,富邦�琤肭磪囓�2,10,0,10,凱基-頭份,2024-02-23,9296
1528,恩德,10,0,10,凱基-頭份,2024-02-23,9296
2401,凌陽,10,0,10,凱基-頭份,2024-02-23,9296
2405,輔信,16,6,10,凱基-頭份,2024-02-23,9296
3057,喬鼎,10,0,10,凱基-頭份,2024-02-23,9296
3694,海華,10,0,10,凱基-頭份,2024-02-23,9296
6126,信音,15,6,9,凱基-頭份,2024-02-23,9296
2353,宏��,20,11,9,凱基-頭份,2024-02-23,9296
2888,新光金,12,4,8,凱基-頭份,2024-02-23,9296
3605,宏致,8,0,8,凱基-頭份,2024-02-23,9296
4714,永捷,10,2,8,凱基-頭份,2024-02-23,9296
4804,大略-KY,8,0,8,凱基-頭份,2024-02-23,9296
4726,永昕,8,0,8,凱基-頭份,2024-02-23,9296
2303,聯電,8,1,7,凱基-頭份,2024-02-23,9296
8249,菱光,8,1,7,凱基-頭份,2024-02-23,9296
00751B,元大AAA至A公司債,6,0,6,凱基-頭份,2024-02-23,9296
2882,國泰金,107,0,107,凱基-頭份,2024-02-26,9296
00931B,統一美債20年,105,9,96,凱基-頭份,2024-02-26,9296
911868,同方友友-DR,93,0,93,凱基-頭份,2024-02-26,9296
2888,新光金,54,0,54,凱基-頭份,2024-02-26,9296
4526,東台,54,3,51,凱基-頭份,2024-02-26,9296
00878,國泰永續高股息,76,33,43,凱基-頭份,2024-02-26,9296
00712,復華富時不動產,40,0,40,凱基-頭份,2024-02-26,9296
00937B,群益ESG投等債20,40,0,40,凱基-頭份,2024-02-26,9296
2371,大同,42,2,40,凱基-頭份,2024-02-26,9296
6219,富旺,30,0,30,凱基-頭份,2024-02-26,9296
00933B,國泰10Y+金融債,22,0,22,凱基-頭份,2024-02-26,9296
2609,陽明,91,70,21,凱基-頭份,2024-02-26,9296
2329,華泰,19,1,18,凱基-頭份,2024-02-26,9296
8088,品安,18,0,18,凱基-頭份,2024-02-26,9296
8112,至上,17,0,17,凱基-頭份,2024-02-26,9296
00637L,元大滬深300正2,16,0,16,凱基-頭份,2024-02-26,9296
2449,京元電子,208,194,14,凱基-頭份,2024-02-26,9296
00706L,期元大S＆P日圓正2,15,2,13,凱基-頭份,2024-02-26,9296
2405,輔信,29,16,13,凱基-頭份,2024-02-26,9296
8110,華東,13,0,13,凱基-頭份,2024-02-26,9296
00679B,元大美債20年,13,2,11,凱基-頭份,2024-02-26,9296
6179,亞通,11,0,11,凱基-頭份,2024-02-26,9296
6207,雷科,12,1,11,凱基-頭份,2024-02-26,9296
6215,和椿,11,0,11,凱基-頭份,2024-02-26,9296
8201,無敵,11,0,11,凱基-頭份,2024-02-26,9296
00786B,元大10年IG銀行債,10,0,10,凱基-頭份,2024-02-26,9296
00642U,期元大S＆P石油,10,0,10,凱基-頭份,2024-02-26,9296
2812,台中銀,10,0,10,凱基-頭份,2024-02-26,9296
3025,星通,10,0,10,凱基-頭份,2024-02-26,9296
00934,中信成長高股息,10,1,9,凱基-頭份,2024-02-26,9296
6257,矽格,12,4,8,凱基-頭份,2024-02-26,9296
5880,合庫金,7,0,7,凱基-頭份,2024-02-26,9296
3047,訊舟,7,0,7,凱基-頭份,2024-02-26,9296
1503,士電,18,12,6,凱基-頭份,2024-02-26,9296
00633L,富邦上証正2,6,0,6,凱基-頭份,2024-02-26,9296
2101,南港,6,0,6,凱基-頭份,2024-02-26,9296
00680L,元大美債20正2,5,0,5,凱基-頭份,2024-02-26,9296
1536,和大,8,3,5,凱基-頭份,2024-02-26,9296
1609,大亞,6,1,5,凱基-頭份,2024-02-26,9296
1905,華紙,5,0,5,凱基-頭份,2024-02-26,9296
2025,千興,8,3,5,凱基-頭份,2024-02-26,9296
2355,敬鵬,5,0,5,凱基-頭份,2024-02-26,9296
2605,新興,5,0,5,凱基-頭份,2024-02-26,9296
2845,遠東銀,5,0,5,凱基-頭份,2024-02-26,9296
3038,全台,5,0,5,凱基-頭份,2024-02-26,9296
5490,同亨,5,0,5,凱基-頭份,2024-02-26,9296
2345,智邦,4,0,4,凱基-頭份,2024-02-26,9296
2892,第一金,4,0,4,凱基-頭份,2024-02-26,9296
00753L,中信中國50正2,4,0,4,凱基-頭份,2024-02-26,9296
2337,旺宏,4,0,4,凱基-頭份,2024-02-26,9296
00878,國泰永續高股息,193,55,138,凱基-頭份,2024-02-27,9296
00929,復華台灣科技優息,143,37,106,凱基-頭份,2024-02-27,9296
2887,台新金,60,1,59,凱基-頭份,2024-02-27,9296
2405,輔信,63,8,55,凱基-頭份,2024-02-27,9296
2359,所羅門,52,2,50,凱基-頭份,2024-02-27,9296
00937B,群益ESG投等債20,49,1,48,凱基-頭份,2024-02-27,9296
6603,富強鑫,31,0,31,凱基-頭份,2024-02-27,9296
00919,群益台灣精選高息,58,33,25,凱基-頭份,2024-02-27,9296
00933B,國泰10Y+金融債,28,4,24,凱基-頭份,2024-02-27,9296
1316,上曜,29,6,23,凱基-頭份,2024-02-27,9296
4716,大立,22,0,22,凱基-頭份,2024-02-27,9296
2324,仁寶,28,8,20,凱基-頭份,2024-02-27,9296
6733,博晟生醫,20,0,20,凱基-頭份,2024-02-27,9296
2637,慧洋-KY,20,1,19,凱基-頭份,2024-02-27,9296
6122,擎邦,20,2,18,凱基-頭份,2024-02-27,9296
3231,緯創,19,2,17,凱基-頭份,2024-02-27,9296
6125,廣運,104,87,17,凱基-頭份,2024-02-27,9296
2888,新光金,20,4,16,凱基-頭份,2024-02-27,9296
00687B,國泰20年美債,17,3,14,凱基-頭份,2024-02-27,9296
00795B,中信美國公債20年,14,0,14,凱基-頭份,2024-02-27,9296
8096,擎亞,24,11,13,凱基-頭份,2024-02-27,9296
6668,中揚光,18,5,13,凱基-頭份,2024-02-27,9296
00679B,元大美債20年,12,0,12,凱基-頭份,2024-02-27,9296
6196,帆宣,13,1,12,凱基-頭份,2024-02-27,9296
2344,華邦電,19,8,11,凱基-頭份,2024-02-27,9296
4915,致伸,12,1,11,凱基-頭份,2024-02-27,9296
3037,欣興,30,20,10,凱基-頭份,2024-02-27,9296
00720B,元大投資級公司債,10,0,10,凱基-頭份,2024-02-27,9296
2367,燿華,10,0,10,凱基-頭份,2024-02-27,9296
3167,大量,10,0,10,凱基-頭份,2024-02-27,9296
3313,斐成,10,0,10,凱基-頭份,2024-02-27,9296
3567,逸昌,10,0,10,凱基-頭份,2024-02-27,9296
3701,大眾控,10,0,10,凱基-頭份,2024-02-27,9296
4303,信立,11,1,10,凱基-頭份,2024-02-27,9296
8926,台汽電,10,0,10,凱基-頭份,2024-02-27,9296
00632R,元大台灣50反1,40,31,9,凱基-頭份,2024-02-27,9296
00637L,元大滬深300正2,10,1,9,凱基-頭份,2024-02-27,9296
2609,陽明,10,1,9,凱基-頭份,2024-02-27,9296
3354,律勝,15,6,9,凱基-頭份,2024-02-27,9296
6226,光鼎,10,1,9,凱基-頭份,2024-02-27,9296
6265,方土昶,8,0,8,凱基-頭份,2024-02-27,9296
4909,新復興,8,1,7,凱基-頭份,2024-02-27,9296
8936,國統,10,3,7,凱基-頭份,2024-02-27,9296
00712,復華富時不動產,6,0,6,凱基-頭份,2024-02-27,9296
2618,長榮航,6,0,6,凱基-頭份,2024-02-27,9296
3615,安可,6,0,6,凱基-頭份,2024-02-27,9296
6695,芯鼎,6,0,6,凱基-頭份,2024-02-27,9296
00885,富邦越南,5,0,5,凱基-頭份,2024-02-27,9296
00701,國泰股利精選30,5,0,5,凱基-頭份,2024-02-27,9296
2206,三陽工業,6,1,5,凱基-頭份,2024-02-27,9296
2367,燿華,91,7,84,凱基-頭份,2024-02-29,9296
00885,富邦越南,80,0,80,凱基-頭份,2024-02-29,9296
2547,日勝生,80,0,80,凱基-頭份,2024-02-29,9296
1101,台泥,69,1,68,凱基-頭份,2024-02-29,9296
5452,佶優,78,18,60,凱基-頭份,2024-02-29,9296
00919,群益台灣精選高息,65,7,58,凱基-頭份,2024-02-29,9296
2880,華南金,50,1,49,凱基-頭份,2024-02-29,9296
00878,國泰永續高股息,32,0,32,凱基-頭份,2024-02-29,9296
0056,元大高股息,33,3,30,凱基-頭份,2024-02-29,9296
3030,德律,31,1,30,凱基-頭份,2024-02-29,9296
2371,大同,53,26,27,凱基-頭份,2024-02-29,9296
6165,浪凡,27,1,26,凱基-頭份,2024-02-29,9296
00687B,國泰20年美債,26,2,24,凱基-頭份,2024-02-29,9296
00632R,元大台灣50反1,20,0,20,凱基-頭份,2024-02-29,9296
3708,上緯投控,20,0,20,凱基-頭份,2024-02-29,9296
5351,鈺創,27,7,20,凱基-頭份,2024-02-29,9296
3049,精金,18,0,18,凱基-頭份,2024-02-29,9296
2888,新光金,19,2,17,凱基-頭份,2024-02-29,9296
6219,富旺,16,0,16,凱基-頭份,2024-02-29,9296
00679B,元大美債20年,14,0,14,凱基-頭份,2024-02-29,9296
3231,緯創,14,0,14,凱基-頭份,2024-02-29,9296
2887,台新金,13,0,13,凱基-頭份,2024-02-29,9296
6270,倍微,14,1,13,凱基-頭份,2024-02-29,9296
5443,均豪,12,0,12,凱基-頭份,2024-02-29,9296
8047,星雲,13,1,12,凱基-頭份,2024-02-29,9296
2356,英業達,13,2,11,凱基-頭份,2024-02-29,9296
3313,斐成,11,0,11,凱基-頭份,2024-02-29,9296
00710B,復華彭博非投等債,10,0,10,凱基-頭份,2024-02-29,9296
2353,宏��,14,4,10,凱基-頭份,2024-02-29,9296
3058,立德,10,0,10,凱基-頭份,2024-02-29,9296
8383,千附,10,0,10,凱基-頭份,2024-02-29,9296
1711,永光,14,5,9,凱基-頭份,2024-02-29,9296
2337,旺宏,14,5,9,凱基-頭份,2024-02-29,9296
6288,聯嘉,15,6,9,凱基-頭份,2024-02-29,9296
1809,中釉,8,0,8,凱基-頭份,2024-02-29,9296
2101,南港,8,0,8,凱基-頭份,2024-02-29,9296
6184,大豐電,8,0,8,凱基-頭份,2024-02-29,9296
1503,士電,18,11,7,凱基-頭份,2024-02-29,9296
2352,佳世達,7,0,7,凱基-頭份,2024-02-29,9296
2476,鉅祥,7,0,7,凱基-頭份,2024-02-29,9296
2812,台中銀,7,0,7,凱基-頭份,2024-02-29,9296
6426,統新,7,0,7,凱基-頭份,2024-02-29,9296
2412,中華電,6,0,6,凱基-頭份,2024-02-29,9296
6275,元山,6,0,6,凱基-頭份,2024-02-29,9296
6465,威潤,6,0,6,凱基-頭份,2024-02-29,9296
2421,建準,11,5,6,凱基-頭份,2024-02-29,9296
1103,嘉泥,5,0,5,凱基-頭份,2024-02-29,9296
00637L,元大滬深300正2,5,0,5,凱基-頭份,2024-02-29,9296
1522,堤維西,20,15,5,凱基-頭份,2024-02-29,9296
2023,燁輝,10,5,5,凱基-頭份,2024-02-29,9296
00919,群益台灣精選高息,215,7,208,凱基-頭份,2024-03-01,9296
2367,燿華,60,2,58,凱基-頭份,2024-03-01,9296
00918,大華優利高填息30,39,0,39,凱基-頭份,2024-03-01,9296
00885,富邦越南,40,3,37,凱基-頭份,2024-03-01,9296
00882,中信中國高股息,46,10,36,凱基-頭份,2024-03-01,9296
9945,潤泰新,36,0,36,凱基-頭份,2024-03-01,9296
00712,復華富時不動產,32,0,32,凱基-頭份,2024-03-01,9296
00937B,群益ESG投等債20,31,0,31,凱基-頭份,2024-03-01,9296
00751B,元大AAA至A公司債,24,0,24,凱基-頭份,2024-03-01,9296
2303,聯電,24,2,22,凱基-頭份,2024-03-01,9296
2888,新光金,21,0,21,凱基-頭份,2024-03-01,9296
3049,精金,20,0,20,凱基-頭份,2024-03-01,9296
00929,復華台灣科技優息,22,6,16,凱基-頭份,2024-03-01,9296
0056,元大高股息,16,1,15,凱基-頭份,2024-03-01,9296
00687B,國泰20年美債,16,1,15,凱基-頭份,2024-03-01,9296
5351,鈺創,24,9,15,凱基-頭份,2024-03-01,9296
9904,寶成,15,0,15,凱基-頭份,2024-03-01,9296
3708,上緯投控,37,23,14,凱基-頭份,2024-03-01,9296
2329,華泰,20,7,13,凱基-頭份,2024-03-01,9296
2495,普安,18,5,13,凱基-頭份,2024-03-01,9296
3071,協禧,13,0,13,凱基-頭份,2024-03-01,9296
2603,長榮,46,33,13,凱基-頭份,2024-03-01,9296
2365,昆盈,15,3,12,凱基-頭份,2024-03-01,9296
00637L,元大滬深300正2,11,1,10,凱基-頭份,2024-03-01,9296
00903,富邦元宇宙,10,0,10,凱基-頭份,2024-03-01,9296
1459,聯發,10,0,10,凱基-頭份,2024-03-01,9296
1815,富喬,10,0,10,凱基-頭份,2024-03-01,9296
2014,中鴻,10,0,10,凱基-頭份,2024-03-01,9296
2025,千興,10,0,10,凱基-頭份,2024-03-01,9296
5347,世界,10,0,10,凱基-頭份,2024-03-01,9296
6112,邁達特,10,0,10,凱基-頭份,2024-03-01,9296
6182,合晶,10,0,10,凱基-頭份,2024-03-01,9296
00933B,國泰10Y+金融債,10,2,8,凱基-頭份,2024-03-01,9296
2883,凱基金,8,0,8,凱基-頭份,2024-03-01,9296
00686R,群益臺灣加權反1,8,0,8,凱基-頭份,2024-03-01,9296
1503,士電,19,11,8,凱基-頭份,2024-03-01,9296
2399,映泰,9,1,8,凱基-頭份,2024-03-01,9296
2609,陽明,189,181,8,凱基-頭份,2024-03-01,9296
6829,千附精密,9,1,8,凱基-頭份,2024-03-01,9296
1316,上曜,51,44,7,凱基-頭份,2024-03-01,9296
2618,長榮航,8,1,7,凱基-頭份,2024-03-01,9296
3360,尚立,12,5,7,凱基-頭份,2024-03-01,9296
2610,華航,6,0,6,凱基-頭份,2024-03-01,9296
3380,明泰,6,0,6,凱基-頭份,2024-03-01,9296
8034,榮群,6,0,6,凱基-頭份,2024-03-01,9296
1342,八貫,5,0,5,凱基-頭份,2024-03-01,9296
00679B,元大美債20年,5,0,5,凱基-頭份,2024-03-01,9296
00715L,期街口布蘭特正2,5,0,5,凱基-頭份,2024-03-01,9296
3025,星通,13,8,5,凱基-頭份,2024-03-01,9296
3325,旭品,7,2,5,凱基-頭份,2024-03-01,9296
00919,群益台灣精選高息,154,2,152,凱基-頭份,2024-03-04,9296
9105,泰金寶-DR,70,0,70,凱基-頭份,2024-03-04,9296
00918,大華優利高填息30,54,0,54,凱基-頭份,2024-03-04,9296
00915,凱基優選高股息30,53,8,45,凱基-頭份,2024-03-04,9296
00882,中信中國高股息,40,7,33,凱基-頭份,2024-03-04,9296
00857B,永豐20年美公債,32,0,32,凱基-頭份,2024-03-04,9296
00885,富邦越南,30,1,29,凱基-頭份,2024-03-04,9296
00929,復華台灣科技優息,45,18,27,凱基-頭份,2024-03-04,9296
6770,力積電,28,1,27,凱基-頭份,2024-03-04,9296
3704,合勤控,25,0,25,凱基-頭份,2024-03-04,9296
2547,日勝生,22,0,22,凱基-頭份,2024-03-04,9296
00664R,國泰臺灣加權反1,40,20,20,凱基-頭份,2024-03-04,9296
00712,復華富時不動產,20,0,20,凱基-頭份,2024-03-04,9296
2106,建大,20,0,20,凱基-頭份,2024-03-04,9296
6015,宏遠證,20,0,20,凱基-頭份,2024-03-04,9296
4543,萬在,21,2,19,凱基-頭份,2024-03-04,9296
2892,第一金,16,0,16,凱基-頭份,2024-03-04,9296
6156,松上,17,2,15,凱基-頭份,2024-03-04,9296
9904,寶成,15,0,15,凱基-頭份,2024-03-04,9296
2002,中鋼,21,7,14,凱基-頭份,2024-03-04,9296
2329,華泰,26,14,12,凱基-頭份,2024-03-04,9296
2882,國泰金,14,2,12,凱基-頭份,2024-03-04,9296
2353,宏��,12,2,10,凱基-頭份,2024-03-04,9296
2431,聯昌,10,0,10,凱基-頭份,2024-03-04,9296
2464,盟立,12,2,10,凱基-頭份,2024-03-04,9296
3308,聯德,10,0,10,凱基-頭份,2024-03-04,9296
5251,天鉞電,10,0,10,凱基-頭份,2024-03-04,9296
8034,榮群,10,0,10,凱基-頭份,2024-03-04,9296
1101,台泥,10,1,9,凱基-頭份,2024-03-04,9296
2014,中鴻,11,2,9,凱基-頭份,2024-03-04,9296
2314,台揚,11,3,8,凱基-頭份,2024-03-04,9296
2609,陽明,14,6,8,凱基-頭份,2024-03-04,9296
3049,精金,8,0,8,凱基-頭份,2024-03-04,9296
3481,群創,13,6,7,凱基-頭份,2024-03-04,9296
4968,立積,7,0,7,凱基-頭份,2024-03-04,9296
1513,中興電,15,8,7,凱基-頭份,2024-03-04,9296
2801,彰銀,7,0,7,凱基-頭份,2024-03-04,9296
1727,中華化,14,7,7,凱基-頭份,2024-03-04,9296
2356,英業達,9,2,7,凱基-頭份,2024-03-04,9296
3006,晶豪科,15,8,7,凱基-頭份,2024-03-04,9296
3147,大綜,7,0,7,凱基-頭份,2024-03-04,9296
3356,奇偶,13,6,7,凱基-頭份,2024-03-04,9296
6120,達運,7,0,7,凱基-頭份,2024-03-04,9296
1305,華夏,6,0,6,凱基-頭份,2024-03-04,9296
6695,芯鼎,6,0,6,凱基-頭份,2024-03-04,9296
3231,緯創,13,7,6,凱基-頭份,2024-03-04,9296
2888,新光金,5,0,5,凱基-頭份,2024-03-04,9296
2301,光寶科,7,2,5,凱基-頭份,2024-03-04,9296
00713,元大台灣高息低波,6,1,5,凱基-頭份,2024-03-04,9296
00933B,國泰10Y+金融債,5,0,5,凱基-頭份,2024-03-04,9296
2897,王道銀行,1277,1,1276,凱基-頭份,2024-03-05,9296
00929,復華台灣科技優息,257,12,245,凱基-頭份,2024-03-05,9296
00933B,國泰10Y+金融債,200,0,200,凱基-頭份,2024-03-05,9296
911868,同方友友-DR,100,0,100,凱基-頭份,2024-03-05,9296
2883B,凱基金乙特,77,0,77,凱基-頭份,2024-03-05,9296
2367,燿華,86,28,58,凱基-頭份,2024-03-05,9296
00882,中信中國高股息,53,0,53,凱基-頭份,2024-03-05,9296
2882,國泰金,51,11,40,凱基-頭份,2024-03-05,9296
1503,士電,42,4,38,凱基-頭份,2024-03-05,9296
3339,泰谷,28,0,28,凱基-頭份,2024-03-05,9296
3356,奇偶,30,2,28,凱基-頭份,2024-03-05,9296
6217,中探針,30,5,25,凱基-頭份,2024-03-05,9296
00918,大華優利高填息30,23,1,22,凱基-頭份,2024-03-05,9296
00937B,群益ESG投等債20,18,0,18,凱基-頭份,2024-03-05,9296
00706L,期元大S＆P日圓正2,15,0,15,凱基-頭份,2024-03-05,9296
00679B,元大美債20年,16,1,15,凱基-頭份,2024-03-05,9296
2892,第一金,15,0,15,凱基-頭份,2024-03-05,9296
3481,群創,16,4,12,凱基-頭份,2024-03-05,9296
2338,光罩,12,0,12,凱基-頭份,2024-03-05,9296
00680L,元大美債20正2,11,0,11,凱基-頭份,2024-03-05,9296
1409,新纖,21,10,11,凱基-頭份,2024-03-05,9296
2618,長榮航,16,5,11,凱基-頭份,2024-03-05,9296
00712,復華富時不動產,16,5,11,凱基-頭份,2024-03-05,9296
020041,兆豐半導體氣候N,10,0,10,凱基-頭份,2024-03-05,9296
00632R,元大台灣50反1,10,0,10,凱基-頭份,2024-03-05,9296
6142,友勁,10,0,10,凱基-頭份,2024-03-05,9296
6156,松上,10,0,10,凱基-頭份,2024-03-05,9296
9904,寶成,10,0,10,凱基-頭份,2024-03-05,9296
5351,鈺創,12,3,9,凱基-頭份,2024-03-05,9296
6127,九豪,10,1,9,凱基-頭份,2024-03-05,9296
6269,台郡,8,0,8,凱基-頭份,2024-03-05,9296
1305,華夏,8,0,8,凱基-頭份,2024-03-05,9296
2377,微星,8,0,8,凱基-頭份,2024-03-05,9296
6188,廣明,9,1,8,凱基-頭份,2024-03-05,9296
6125,廣運,20,13,7,凱基-頭份,2024-03-05,9296
3402,漢科,7,0,7,凱基-頭份,2024-03-05,9296
6770,力積電,13,6,7,凱基-頭份,2024-03-05,9296
5880,合庫金,6,0,6,凱基-頭份,2024-03-05,9296
00650L,復華香港正2,5,0,5,凱基-頭份,2024-03-05,9296
00673R,期元大S＆P原油反1,10,5,5,凱基-頭份,2024-03-05,9296
1474,弘裕,5,0,5,凱基-頭份,2024-03-05,9296
2025,千興,10,5,5,凱基-頭份,2024-03-05,9296
2332,友訊,5,0,5,凱基-頭份,2024-03-05,9296
2906,高林,5,0,5,凱基-頭份,2024-03-05,9296
3071,協禧,6,1,5,凱基-頭份,2024-03-05,9296
3338,泰碩,5,0,5,凱基-頭份,2024-03-05,9296
3450,聯鈞,5,0,5,凱基-頭份,2024-03-05,9296
5347,世界,5,0,5,凱基-頭份,2024-03-05,9296
5439,高技,8,3,5,凱基-頭份,2024-03-05,9296
6470,宇智,5,0,5,凱基-頭份,2024-03-05,9296
2812,台中銀,232,0,232,凱基-頭份,2024-03-06,9296
2882,國泰金,220,0,220,凱基-頭份,2024-03-06,9296
00857B,永豐20年美公債,101,0,101,凱基-頭份,2024-03-06,9296
00885,富邦越南,50,1,49,凱基-頭份,2024-03-06,9296
2534,宏盛,49,0,49,凱基-頭份,2024-03-06,9296
00918,大華優利高填息30,38,0,38,凱基-頭份,2024-03-06,9296
2883B,凱基金乙特,37,0,37,凱基-頭份,2024-03-06,9296
2206,三陽工業,35,5,30,凱基-頭份,2024-03-06,9296
00632R,元大台灣50反1,31,5,26,凱基-頭份,2024-03-06,9296
2352,佳世達,24,5,19,凱基-頭份,2024-03-06,9296
2002,中鋼,16,0,16,凱基-頭份,2024-03-06,9296
1455,集盛,15,0,15,凱基-頭份,2024-03-06,9296
3710,連展投控,15,0,15,凱基-頭份,2024-03-06,9296
00641R,富邦日本反1,14,0,14,凱基-頭份,2024-03-06,9296
8011,台通,25,11,14,凱基-頭份,2024-03-06,9296
6189,豐藝,14,1,13,凱基-頭份,2024-03-06,9296
5443,均豪,12,0,12,凱基-頭份,2024-03-06,9296
6776,展�眥篕�,12,0,12,凱基-頭份,2024-03-06,9296
00922,國泰台灣領袖50,11,0,11,凱基-頭份,2024-03-06,9296
5465,富驊,11,0,11,凱基-頭份,2024-03-06,9296
00637L,元大滬深300正2,10,0,10,凱基-頭份,2024-03-06,9296
00664R,國泰臺灣加權反1,10,0,10,凱基-頭份,2024-03-06,9296
1409,新纖,23,13,10,凱基-頭份,2024-03-06,9296
2483,百容,10,0,10,凱基-頭份,2024-03-06,9296
2618,長榮航,10,0,10,凱基-頭份,2024-03-06,9296
2838,聯邦銀,10,0,10,凱基-頭份,2024-03-06,9296
3372,典範,14,4,10,凱基-頭份,2024-03-06,9296
3664,安瑞-KY,10,0,10,凱基-頭份,2024-03-06,9296
6163,華電網,11,1,10,凱基-頭份,2024-03-06,9296
6229,研通,10,0,10,凱基-頭份,2024-03-06,9296
00937B,群益ESG投等債20,9,0,9,凱基-頭份,2024-03-06,9296
1503,士電,10,1,9,凱基-頭份,2024-03-06,9296
6117,迎廣,48,39,9,凱基-頭份,2024-03-06,9296
6233,旺玖,11,2,9,凱基-頭份,2024-03-06,9296
6742,澤米,10,1,9,凱基-頭份,2024-03-06,9296
2317,鴻海,12,3,9,凱基-頭份,2024-03-06,9296
00929,復華台灣科技優息,25,17,8,凱基-頭份,2024-03-06,9296
2303,聯電,11,3,8,凱基-頭份,2024-03-06,9296
2609,陽明,9,1,8,凱基-頭份,2024-03-06,9296
6282,康舒,8,0,8,凱基-頭份,2024-03-06,9296
00715L,期街口布蘭特正2,7,0,7,凱基-頭份,2024-03-06,9296
2104,國際中橡,7,0,7,凱基-頭份,2024-03-06,9296
2324,仁寶,8,1,7,凱基-頭份,2024-03-06,9296
2845,遠東銀,7,0,7,凱基-頭份,2024-03-06,9296
1432,大魯閣,6,0,6,凱基-頭份,2024-03-06,9296
2528,皇普,6,0,6,凱基-頭份,2024-03-06,9296
3049,精金,6,0,6,凱基-頭份,2024-03-06,9296
3689,湧德,6,0,6,凱基-頭份,2024-03-06,9296
1815,富喬,9,4,5,凱基-頭份,2024-03-06,9296
2332,友訊,5,0,5,凱基-頭份,2024-03-06,9296
2897,王道銀行,499,3,496,凱基-頭份,2024-03-07,9296
00919,群益台灣精選高息,143,26,117,凱基-頭份,2024-03-07,9296
2845,遠東銀,94,2,92,凱基-頭份,2024-03-07,9296
2106,建大,65,0,65,凱基-頭份,2024-03-07,9296
6016,康和證,40,2,38,凱基-頭份,2024-03-07,9296
6770,力積電,40,2,38,凱基-頭份,2024-03-07,9296
1101,台泥,41,10,31,凱基-頭份,2024-03-07,9296
8088,品安,30,0,30,凱基-頭份,2024-03-07,9296
4534,慶騰,25,0,25,凱基-頭份,2024-03-07,9296
00632R,元大台灣50反1,44,20,24,凱基-頭份,2024-03-07,9296
1815,富喬,30,6,24,凱基-頭份,2024-03-07,9296
3052,夆典,28,4,24,凱基-頭份,2024-03-07,9296
2329,華泰,26,3,23,凱基-頭份,2024-03-07,9296
2105,正新,22,0,22,凱基-頭份,2024-03-07,9296
2303,聯電,56,34,22,凱基-頭份,2024-03-07,9296
2520,冠德,21,0,21,凱基-頭份,2024-03-07,9296
2883,凱基金,45,24,21,凱基-頭份,2024-03-07,9296
00857B,永豐20年美公債,20,0,20,凱基-頭份,2024-03-07,9296
3356,奇偶,21,1,20,凱基-頭份,2024-03-07,9296
8201,無敵,20,0,20,凱基-頭份,2024-03-07,9296
00665L,富邦�琤肭磪囓�2,15,0,15,凱基-頭份,2024-03-07,9296
3481,群創,18,3,15,凱基-頭份,2024-03-07,9296
4726,永昕,15,0,15,凱基-頭份,2024-03-07,9296
3664,安瑞-KY,13,0,13,凱基-頭份,2024-03-07,9296
3710,連展投控,13,0,13,凱基-頭份,2024-03-07,9296
5521,工信,17,4,13,凱基-頭份,2024-03-07,9296
00915,凱基優選高股息30,14,1,13,凱基-頭份,2024-03-07,9296
4114,健喬,14,2,12,凱基-頭份,2024-03-07,9296
6117,迎廣,37,25,12,凱基-頭份,2024-03-07,9296
6265,方土昶,12,0,12,凱基-頭份,2024-03-07,9296
6591,動力-KY,13,1,12,凱基-頭份,2024-03-07,9296
9904,寶成,13,1,12,凱基-頭份,2024-03-07,9296
2880,華南金,11,0,11,凱基-頭份,2024-03-07,9296
00680L,元大美債20正2,10,0,10,凱基-頭份,2024-03-07,9296
6505,台塑化,10,0,10,凱基-頭份,2024-03-07,9296
00664R,國泰臺灣加權反1,10,0,10,凱基-頭份,2024-03-07,9296
00641R,富邦日本反1,20,10,10,凱基-頭份,2024-03-07,9296
00904,新光臺灣半導體30,10,0,10,凱基-頭份,2024-03-07,9296
2316,楠梓電,11,1,10,凱基-頭份,2024-03-07,9296
2332,友訊,10,0,10,凱基-頭份,2024-03-07,9296
6015,宏遠證,10,0,10,凱基-頭份,2024-03-07,9296
2417,圓剛,16,6,10,凱基-頭份,2024-03-07,9296
6275,元山,13,4,9,凱基-頭份,2024-03-07,9296
3338,泰碩,16,7,9,凱基-頭份,2024-03-07,9296
3402,漢科,9,0,9,凱基-頭份,2024-03-07,9296
4533,協易機,9,0,9,凱基-頭份,2024-03-07,9296
6113,亞矽,9,0,9,凱基-頭份,2024-03-07,9296
3005,神基,9,1,8,凱基-頭份,2024-03-07,9296
00715L,期街口布蘭特正2,8,0,8,凱基-頭份,2024-03-07,9296
00905,FT臺灣Smart,8,0,8,凱基-頭份,2024-03-07,9296
6016,康和證,334,0,334,凱基-頭份,2024-03-08,9296
00919,群益台灣精選高息,348,134,214,凱基-頭份,2024-03-08,9296
2409,友達,102,2,100,凱基-頭份,2024-03-08,9296
2337,旺宏,62,2,60,凱基-頭份,2024-03-08,9296
3706,神達,55,0,55,凱基-頭份,2024-03-08,9296
2609,陽明,53,9,44,凱基-頭份,2024-03-08,9296
00680L,元大美債20正2,43,0,43,凱基-頭份,2024-03-08,9296
4198,欣大健康,32,0,32,凱基-頭份,2024-03-08,9296
00882,中信中國高股息,35,4,31,凱基-頭份,2024-03-08,9296
6219,富旺,29,0,29,凱基-頭份,2024-03-08,9296
2109,華豐,28,0,28,凱基-頭份,2024-03-08,9296
2845,遠東銀,110,82,28,凱基-頭份,2024-03-08,9296
1609,大亞,29,2,27,凱基-頭份,2024-03-08,9296
8112,至上,27,2,25,凱基-頭份,2024-03-08,9296
8937,合騏,23,0,23,凱基-頭份,2024-03-08,9296
8088,品安,21,0,21,凱基-頭份,2024-03-08,9296
9105,泰金寶-DR,20,0,20,凱基-頭份,2024-03-08,9296
00687B,國泰20年美債,19,1,18,凱基-頭份,2024-03-08,9296
6275,元山,18,1,17,凱基-頭份,2024-03-08,9296
3052,夆典,16,0,16,凱基-頭份,2024-03-08,9296
00641R,富邦日本反1,15,0,15,凱基-頭份,2024-03-08,9296
2338,光罩,15,0,15,凱基-頭份,2024-03-08,9296
3339,泰谷,15,0,15,凱基-頭份,2024-03-08,9296
2812,台中銀,15,1,14,凱基-頭份,2024-03-08,9296
6841,長佳智能,13,0,13,凱基-頭份,2024-03-08,9296
00918,大華優利高填息30,14,1,13,凱基-頭份,2024-03-08,9296
2002,中鋼,12,0,12,凱基-頭份,2024-03-08,9296
6117,迎廣,13,1,12,凱基-頭份,2024-03-08,9296
6197,佳必琪,13,1,12,凱基-頭份,2024-03-08,9296
00857B,永豐20年美公債,12,0,12,凱基-頭份,2024-03-08,9296
00934,中信成長高股息,11,0,11,凱基-頭份,2024-03-08,9296
00891,中信關鍵半導體,12,1,11,凱基-頭份,2024-03-08,9296
2358,廷鑫,12,1,11,凱基-頭份,2024-03-08,9296
8076,伍豐,10,0,10,凱基-頭份,2024-03-08,9296
00671R,富邦NASDAQ反1,10,0,10,凱基-頭份,2024-03-08,9296
1582,信錦,10,0,10,凱基-頭份,2024-03-08,9296
2356,英業達,13,3,10,凱基-頭份,2024-03-08,9296
3491,昇達科,10,0,10,凱基-頭份,2024-03-08,9296
8443,阿瘦,10,0,10,凱基-頭份,2024-03-08,9296
2887,台新金,11,2,9,凱基-頭份,2024-03-08,9296
00645,富邦日本,8,0,8,凱基-頭份,2024-03-08,9296
1455,集盛,8,0,8,凱基-頭份,2024-03-08,9296
3356,奇偶,10,2,8,凱基-頭份,2024-03-08,9296
6127,九豪,8,0,8,凱基-頭份,2024-03-08,9296
2891,中信金,11,3,8,凱基-頭份,2024-03-08,9296
00679B,元大美債20年,11,4,7,凱基-頭份,2024-03-08,9296
6126,信音,7,0,7,凱基-頭份,2024-03-08,9296
6285,啟��,16,9,7,凱基-頭份,2024-03-08,9296
1513,中興電,38,31,7,凱基-頭份,2024-03-08,9296
00712,復華富時不動產,7,0,7,凱基-頭份,2024-03-08,9296
00900,富邦特選高股息30,55,0,55,凱基-頭份,2024-03-11,9296
00919,群益台灣精選高息,73,24,49,凱基-頭份,2024-03-11,9296
00632R,元大台灣50反1,47,0,47,凱基-頭份,2024-03-11,9296
3706,神達,43,0,43,凱基-頭份,2024-03-11,9296
6770,力積電,51,10,41,凱基-頭份,2024-03-11,9296
2883,凱基金,44,12,32,凱基-頭份,2024-03-11,9296
8112,至上,34,2,32,凱基-頭份,2024-03-11,9296
2812,台中銀,29,0,29,凱基-頭份,2024-03-11,9296
5483,中美晶,37,8,29,凱基-頭份,2024-03-11,9296
00679B,元大美債20年,22,0,22,凱基-頭份,2024-03-11,9296
6219,富旺,20,0,20,凱基-頭份,2024-03-11,9296
2634,漢翔,20,1,19,凱基-頭份,2024-03-11,9296
2303,聯電,29,11,18,凱基-頭份,2024-03-11,9296
2609,陽明,25,7,18,凱基-頭份,2024-03-11,9296
2449,京元電子,18,3,15,凱基-頭份,2024-03-11,9296
00934,中信成長高股息,13,0,13,凱基-頭份,2024-03-11,9296
2887,台新金,12,0,12,凱基-頭份,2024-03-11,9296
00857B,永豐20年美公債,12,0,12,凱基-頭份,2024-03-11,9296
5209,新鼎,11,0,11,凱基-頭份,2024-03-11,9296
00937B,群益ESG投等債20,21,10,11,凱基-頭份,2024-03-11,9296
00642U,期元大S＆P石油,10,0,10,凱基-頭份,2024-03-11,9296
8390,金益鼎,12,2,10,凱基-頭份,2024-03-11,9296
2543,皇昌,9,0,9,凱基-頭份,2024-03-11,9296
5386,青雲,9,0,9,凱基-頭份,2024-03-11,9296
6288,聯嘉,8,0,8,凱基-頭份,2024-03-11,9296
00687B,國泰20年美債,10,2,8,凱基-頭份,2024-03-11,9296
8011,台通,10,2,8,凱基-頭份,2024-03-11,9296
8096,擎亞,16,8,8,凱基-頭份,2024-03-11,9296
00918,大華優利高填息30,21,14,7,凱基-頭份,2024-03-11,9296
2337,旺宏,10,3,7,凱基-頭份,2024-03-11,9296
6277,宏正,6,0,6,凱基-頭份,2024-03-11,9296
1815,富喬,10,4,6,凱基-頭份,2024-03-11,9296
2367,燿華,22,16,6,凱基-頭份,2024-03-11,9296
2603,長榮,9,3,6,凱基-頭份,2024-03-11,9296
3664,安瑞-KY,6,0,6,凱基-頭份,2024-03-11,9296
2353,宏��,6,0,6,凱基-頭份,2024-03-11,9296
6799,來頡,6,1,5,凱基-頭份,2024-03-11,9296
1444,力麗,5,0,5,凱基-頭份,2024-03-11,9296
2025,千興,7,2,5,凱基-頭份,2024-03-11,9296
2516,新建,5,0,5,凱基-頭份,2024-03-11,9296
3413,京鼎,5,0,5,凱基-頭份,2024-03-11,9296
5213,亞昕,5,0,5,凱基-頭份,2024-03-11,9296
6742,澤米,5,0,5,凱基-頭份,2024-03-11,9296
00885,富邦越南,5,1,4,凱基-頭份,2024-03-11,9296
2618,長榮航,4,0,4,凱基-頭份,2024-03-11,9296
2369,菱生,6,3,3,凱基-頭份,2024-03-11,9296
8110,華東,3,0,3,凱基-頭份,2024-03-11,9296
00911,兆豐洲際半導體,3,0,3,凱基-頭份,2024-03-11,9296
1316,上曜,4,1,3,凱基-頭份,2024-03-11,9296
1535,中宇,3,0,3,凱基-頭份,2024-03-11,9296
2882,國泰金,128,3,125,凱基-頭份,2024-03-12,9296
00650L,復華香港正2,100,3,97,凱基-頭份,2024-03-12,9296
00918,大華優利高填息30,68,1,67,凱基-頭份,2024-03-12,9296
3706,神達,57,10,47,凱基-頭份,2024-03-12,9296
00882,中信中國高股息,40,0,40,凱基-頭份,2024-03-12,9296
3051,力特,50,10,40,凱基-頭份,2024-03-12,9296
00897,富邦基因免疫生技,30,0,30,凱基-頭份,2024-03-12,9296
00919,群益台灣精選高息,50,30,20,凱基-頭份,2024-03-12,9296
1305,華夏,20,0,20,凱基-頭份,2024-03-12,9296
6219,富旺,20,0,20,凱基-頭份,2024-03-12,9296
00857B,永豐20年美公債,17,0,17,凱基-頭份,2024-03-12,9296
2897,王道銀行,14,0,14,凱基-頭份,2024-03-12,9296
2609,陽明,16,3,13,凱基-頭份,2024-03-12,9296
00937B,群益ESG投等債20,13,0,13,凱基-頭份,2024-03-12,9296
2888,新光金,12,0,12,凱基-頭份,2024-03-12,9296
1905,華紙,12,1,11,凱基-頭份,2024-03-12,9296
2353,宏��,15,4,11,凱基-頭份,2024-03-12,9296
6770,力積電,11,0,11,凱基-頭份,2024-03-12,9296
2002,中鋼,10,0,10,凱基-頭份,2024-03-12,9296
00936,台新永續高息中小,10,0,10,凱基-頭份,2024-03-12,9296
00648R,元大S＆P500反1,10,0,10,凱基-頭份,2024-03-12,9296
1459,聯發,10,0,10,凱基-頭份,2024-03-12,9296
4420,光明,10,0,10,凱基-頭份,2024-03-12,9296
00679B,元大美債20年,12,2,10,凱基-頭份,2024-03-12,9296
00687B,國泰20年美債,10,1,9,凱基-頭份,2024-03-12,9296
2367,燿華,13,5,8,凱基-頭份,2024-03-12,9296
6591,動力-KY,8,0,8,凱基-頭份,2024-03-12,9296
1316,上曜,7,0,7,凱基-頭份,2024-03-12,9296
1432,大魯閣,7,0,7,凱基-頭份,2024-03-12,9296
2597,潤弘,7,0,7,凱基-頭份,2024-03-12,9296
4726,永昕,7,0,7,凱基-頭份,2024-03-12,9296
5452,佶優,10,3,7,凱基-頭份,2024-03-12,9296
6235,華孚,7,1,6,凱基-頭份,2024-03-12,9296
3016,嘉晶,8,2,6,凱基-頭份,2024-03-12,9296
2371,大同,7,1,6,凱基-頭份,2024-03-12,9296
2801,彰銀,5,0,5,凱基-頭份,2024-03-12,9296
5272,笙科,6,1,5,凱基-頭份,2024-03-12,9296
1504,東元,5,0,5,凱基-頭份,2024-03-12,9296
2342,茂矽,5,0,5,凱基-頭份,2024-03-12,9296
3045,台灣大,5,0,5,凱基-頭份,2024-03-12,9296
3052,夆典,5,0,5,凱基-頭份,2024-03-12,9296
3372,典範,5,0,5,凱基-頭份,2024-03-12,9296
3707,漢磊,9,4,5,凱基-頭份,2024-03-12,9296
6281,全國電,5,0,5,凱基-頭份,2024-03-12,9296
6596,寬宏藝術,7,2,5,凱基-頭份,2024-03-12,9296
9933,中鼎,5,0,5,凱基-頭份,2024-03-12,9296
6165,浪凡,4,0,4,凱基-頭份,2024-03-12,9296
00787B,元大10年IG醫療債,4,0,4,凱基-頭份,2024-03-12,9296
2313,華通,28,24,4,凱基-頭份,2024-03-12,9296
2324,仁寶,10,6,4,凱基-頭份,2024-03-12,9296
2883,凱基金,353,45,308,凱基-頭份,2024-03-13,9296
6016,康和證,249,0,249,凱基-頭份,2024-03-13,9296
00919,群益台灣精選高息,227,10,217,凱基-頭份,2024-03-13,9296
2890,永豐金,100,1,99,凱基-頭份,2024-03-13,9296
4904,遠傳,89,1,88,凱基-頭份,2024-03-13,9296
00918,大華優利高填息30,79,2,77,凱基-頭份,2024-03-13,9296
00679B,元大美債20年,75,4,71,凱基-頭份,2024-03-13,9296
2344,華邦電,62,4,58,凱基-頭份,2024-03-13,9296
6219,富旺,50,0,50,凱基-頭份,2024-03-13,9296
3706,神達,47,1,46,凱基-頭份,2024-03-13,9296
3049,精金,41,0,41,凱基-頭份,2024-03-13,9296
00882,中信中國高股息,47,10,37,凱基-頭份,2024-03-13,9296
1442,名軒,38,3,35,凱基-頭份,2024-03-13,9296
3045,台灣大,36,5,31,凱基-頭份,2024-03-13,9296
2812,台中銀,30,0,30,凱基-頭份,2024-03-13,9296
1305,華夏,27,0,27,凱基-頭份,2024-03-13,9296
4123,晟德,25,0,25,凱基-頭份,2024-03-13,9296
00637L,元大滬深300正2,23,0,23,凱基-頭份,2024-03-13,9296
00632R,元大台灣50反1,21,0,21,凱基-頭份,2024-03-13,9296
3231,緯創,20,1,19,凱基-頭份,2024-03-13,9296
5243,乙盛-KY,22,3,19,凱基-頭份,2024-03-13,9296
3265,台星科,17,0,17,凱基-頭份,2024-03-13,9296
2412,中華電,20,4,16,凱基-頭份,2024-03-13,9296
1616,億泰,15,0,15,凱基-頭份,2024-03-13,9296
2365,昆盈,22,7,15,凱基-頭份,2024-03-13,9296
2520,冠德,15,0,15,凱基-頭份,2024-03-13,9296
00857B,永豐20年美公債,15,0,15,凱基-頭份,2024-03-13,9296
5483,中美晶,21,7,14,凱基-頭份,2024-03-13,9296
2371,大同,16,2,14,凱基-頭份,2024-03-13,9296
2002,中鋼,25,13,12,凱基-頭份,2024-03-13,9296
2401,凌陽,12,0,12,凱基-頭份,2024-03-13,9296
3325,旭品,12,1,11,凱基-頭份,2024-03-13,9296
2330,台積電,12,2,10,凱基-頭份,2024-03-13,9296
8096,擎亞,10,0,10,凱基-頭份,2024-03-13,9296
00648R,元大S＆P500反1,10,0,10,凱基-頭份,2024-03-13,9296
00795B,中信美國公債20年,10,0,10,凱基-頭份,2024-03-13,9296
1718,中纖,10,0,10,凱基-頭份,2024-03-13,9296
2313,華通,16,6,10,凱基-頭份,2024-03-13,9296
2331,精英,10,0,10,凱基-頭份,2024-03-13,9296
2413,環科,10,0,10,凱基-頭份,2024-03-13,9296
00897,富邦基因免疫生技,9,0,9,凱基-頭份,2024-03-13,9296
2405,輔信,9,0,9,凱基-頭份,2024-03-13,9296
3257,虹冠電,9,0,9,凱基-頭份,2024-03-13,9296
6217,中探針,21,12,9,凱基-頭份,2024-03-13,9296
2352,佳世達,13,5,8,凱基-頭份,2024-03-13,9296
00937B,群益ESG投等債20,9,1,8,凱基-頭份,2024-03-13,9296
2376,技嘉,17,10,7,凱基-頭份,2024-03-13,9296
1815,富喬,11,4,7,凱基-頭份,2024-03-13,9296
1514,亞力,10,4,6,凱基-頭份,2024-03-13,9296
3234,光環,6,0,6,凱基-頭份,2024-03-13,9296
6016,康和證,469,0,469,凱基-頭份,2024-03-14,9296
2882,國泰金,292,37,255,凱基-頭份,2024-03-14,9296
00919,群益台灣精選高息,205,78,127,凱基-頭份,2024-03-14,9296
2367,燿華,102,4,98,凱基-頭份,2024-03-14,9296
2106,建大,60,0,60,凱基-頭份,2024-03-14,9296
2303,聯電,62,5,57,凱基-頭份,2024-03-14,9296
00679B,元大美債20年,53,0,53,凱基-頭份,2024-03-14,9296
9945,潤泰新,43,0,43,凱基-頭份,2024-03-14,9296
6217,中探針,43,5,38,凱基-頭份,2024-03-14,9296
00664R,國泰臺灣加權反1,35,0,35,凱基-頭份,2024-03-14,9296
00632R,元大台灣50反1,30,0,30,凱基-頭份,2024-03-14,9296
00915,凱基優選高股息30,41,14,27,凱基-頭份,2024-03-14,9296
3339,泰谷,22,0,22,凱基-頭份,2024-03-14,9296
2845,遠東銀,21,0,21,凱基-頭份,2024-03-14,9296
2031,新光鋼,20,0,20,凱基-頭份,2024-03-14,9296
00687B,國泰20年美債,15,0,15,凱基-頭份,2024-03-14,9296
1455,集盛,15,0,15,凱基-頭份,2024-03-14,9296
2356,英業達,17,2,15,凱基-頭份,2024-03-14,9296
2887,台新金,15,2,13,凱基-頭份,2024-03-14,9296
00680L,元大美債20正2,11,0,11,凱基-頭份,2024-03-14,9296
3706,神達,22,11,11,凱基-頭份,2024-03-14,9296
1513,中興電,53,42,11,凱基-頭份,2024-03-14,9296
1319,東陽,24,14,10,凱基-頭份,2024-03-14,9296
1609,大亞,23,13,10,凱基-頭份,2024-03-14,9296
4198,欣大健康,10,0,10,凱基-頭份,2024-03-14,9296
1608,華榮,25,17,8,凱基-頭份,2024-03-14,9296
3050,鈺德,8,0,8,凱基-頭份,2024-03-14,9296
5347,世界,11,3,8,凱基-頭份,2024-03-14,9296
2417,圓剛,7,0,7,凱基-頭份,2024-03-14,9296
8011,台通,12,5,7,凱基-頭份,2024-03-14,9296
2618,長榮航,17,11,6,凱基-頭份,2024-03-14,9296
00720B,元大投資級公司債,6,0,6,凱基-頭份,2024-03-14,9296
00795B,中信美國公債20年,6,0,6,凱基-頭份,2024-03-14,9296
6197,佳必琪,6,0,6,凱基-頭份,2024-03-14,9296
6596,寬宏藝術,6,0,6,凱基-頭份,2024-03-14,9296
3017,奇鋐,7,1,6,凱基-頭份,2024-03-14,9296
6186,新潤,5,0,5,凱基-頭份,2024-03-14,9296
00688L,國泰20年美債正2,10,5,5,凱基-頭份,2024-03-14,9296
2014,中鴻,5,0,5,凱基-頭份,2024-03-14,9296
2313,華通,10,5,5,凱基-頭份,2024-03-14,9296
2408,南亞科,5,0,5,凱基-頭份,2024-03-14,9296
3010,華立,5,0,5,凱基-頭份,2024-03-14,9296
3013,晟銘電,5,0,5,凱基-頭份,2024-03-14,9296
6591,動力-KY,5,0,5,凱基-頭份,2024-03-14,9296
9105,泰金寶-DR,5,0,5,凱基-頭份,2024-03-14,9296
2376,技嘉,5,1,4,凱基-頭份,2024-03-14,9296
6139,亞翔,4,0,4,凱基-頭份,2024-03-14,9296
2636,台驊控股,4,0,4,凱基-頭份,2024-03-14,9296
3325,旭品,4,0,4,凱基-頭份,2024-03-14,9296
4207,環泰,4,0,4,凱基-頭份,2024-03-14,9296
00712,復華富時不動產,106,10,96,凱基-頭份,2024-03-15,9296
2834,臺企銀,85,12,73,凱基-頭份,2024-03-15,9296
00664R,國泰臺灣加權反1,60,0,60,凱基-頭份,2024-03-15,9296
00919,群益台灣精選高息,151,95,56,凱基-頭份,2024-03-15,9296
2618,長榮航,68,13,55,凱基-頭份,2024-03-15,9296
6226,光鼎,35,0,35,凱基-頭份,2024-03-15,9296
2344,華邦電,37,2,35,凱基-頭份,2024-03-15,9296
3051,力特,28,0,28,凱基-頭份,2024-03-15,9296
2889,國票金,34,7,27,凱基-頭份,2024-03-15,9296
1532,勤美,24,0,24,凱基-頭份,2024-03-15,9296
2883,凱基金,53,31,22,凱基-頭份,2024-03-15,9296
00687B,國泰20年美債,26,5,21,凱基-頭份,2024-03-15,9296
6139,亞翔,31,10,21,凱基-頭份,2024-03-15,9296
00680L,元大美債20正2,21,0,21,凱基-頭份,2024-03-15,9296
00941,中信上游半導體,38,18,20,凱基-頭份,2024-03-15,9296
2609,陽明,91,72,19,凱基-頭份,2024-03-15,9296
3663,鑫科,18,0,18,凱基-頭份,2024-03-15,9296
00720B,元大投資級公司債,15,0,15,凱基-頭份,2024-03-15,9296
2338,光罩,15,0,15,凱基-頭份,2024-03-15,9296
00679B,元大美債20年,15,2,13,凱基-頭份,2024-03-15,9296
2303,聯電,22,9,13,凱基-頭份,2024-03-15,9296
00857B,永豐20年美公債,13,0,13,凱基-頭份,2024-03-15,9296
2530,華建,12,0,12,凱基-頭份,2024-03-15,9296
2845,遠東銀,12,0,12,凱基-頭份,2024-03-15,9296
2603,長榮,53,42,11,凱基-頭份,2024-03-15,9296
1514,亞力,11,0,11,凱基-頭份,2024-03-15,9296
2323,中環,11,0,11,凱基-頭份,2024-03-15,9296
00665L,富邦�琤肭磪囓�2,10,0,10,凱基-頭份,2024-03-15,9296
00931B,統一美債20年,10,0,10,凱基-頭份,2024-03-15,9296
1718,中纖,10,0,10,凱基-頭份,2024-03-15,9296
2637,慧洋-KY,20,10,10,凱基-頭份,2024-03-15,9296
3045,台灣大,10,0,10,凱基-頭份,2024-03-15,9296
4904,遠傳,10,0,10,凱基-頭份,2024-03-15,9296
5213,亞昕,10,0,10,凱基-頭份,2024-03-15,9296
5905,南仁湖,10,0,10,凱基-頭份,2024-03-15,9296
6168,宏齊,10,0,10,凱基-頭份,2024-03-15,9296
6577,勁豐,10,0,10,凱基-頭份,2024-03-15,9296
1513,中興電,40,31,9,凱基-頭份,2024-03-15,9296
00933B,國泰10Y+金融債,9,0,9,凱基-頭份,2024-03-15,9296
2812,台中銀,9,0,9,凱基-頭份,2024-03-15,9296
5452,佶優,11,3,8,凱基-頭份,2024-03-15,9296
6275,元山,12,4,8,凱基-頭份,2024-03-15,9296
3706,神達,12,5,7,凱基-頭份,2024-03-15,9296
6239,力成,7,0,7,凱基-頭份,2024-03-15,9296
2887,台新金,12,5,7,凱基-頭份,2024-03-15,9296
00937B,群益ESG投等債20,11,5,6,凱基-頭份,2024-03-15,9296
1436,華友聯,6,0,6,凱基-頭份,2024-03-15,9296
4123,晟德,6,0,6,凱基-頭份,2024-03-15,9296
4207,環泰,6,0,6,凱基-頭份,2024-03-15,9296
3710,連展投控,6,0,6,凱基-頭份,2024-03-15,9296
2367,燿華,164,2,162,凱基-頭份,2024-03-18,9296
00919,群益台灣精選高息,102,10,92,凱基-頭份,2024-03-18,9296
2317,鴻海,80,16,64,凱基-頭份,2024-03-18,9296
4414,如興,50,0,50,凱基-頭份,2024-03-18,9296
00896,中信綠能及電動車,31,0,31,凱基-頭份,2024-03-18,9296
00918,大華優利高填息30,32,3,29,凱基-頭份,2024-03-18,9296
1609,大亞,30,3,27,凱基-頭份,2024-03-18,9296
2834,臺企銀,26,0,26,凱基-頭份,2024-03-18,9296
00941,中信上游半導體,26,4,22,凱基-頭份,2024-03-18,9296
00679B,元大美債20年,20,0,20,凱基-頭份,2024-03-18,9296
2303,聯電,30,10,20,凱基-頭份,2024-03-18,9296
00664R,國泰臺灣加權反1,20,0,20,凱基-頭份,2024-03-18,9296
1339,昭輝,20,0,20,凱基-頭份,2024-03-18,9296
2337,旺宏,21,2,19,凱基-頭份,2024-03-18,9296
2002,中鋼,20,5,15,凱基-頭份,2024-03-18,9296
00641R,富邦日本反1,15,0,15,凱基-頭份,2024-03-18,9296
00706L,期元大S＆P日圓正2,15,0,15,凱基-頭份,2024-03-18,9296
1416,廣豐,15,0,15,凱基-頭份,2024-03-18,9296
2486,一詮,20,7,13,凱基-頭份,2024-03-18,9296
6016,康和證,13,0,13,凱基-頭份,2024-03-18,9296
00751B,元大AAA至A公司債,11,0,11,凱基-頭份,2024-03-18,9296
00937B,群益ESG投等債20,11,0,11,凱基-頭份,2024-03-18,9296
00687B,國泰20年美債,12,1,11,凱基-頭份,2024-03-18,9296
1457,宜進,10,0,10,凱基-頭份,2024-03-18,9296
3045,台灣大,10,0,10,凱基-頭份,2024-03-18,9296
2344,華邦電,11,2,9,凱基-頭份,2024-03-18,9296
5351,鈺創,10,1,9,凱基-頭份,2024-03-18,9296
2609,陽明,13,5,8,凱基-頭份,2024-03-18,9296
2887,台新金,10,2,8,凱基-頭份,2024-03-18,9296
00885,富邦越南,7,0,7,凱基-頭份,2024-03-18,9296
1714,和桐,7,0,7,凱基-頭份,2024-03-18,9296
2809,京城銀,6,0,6,凱基-頭份,2024-03-18,9296
7402,邑錡,6,0,6,凱基-頭份,2024-03-18,9296
8011,台通,6,1,5,凱基-頭份,2024-03-18,9296
6005,群益證,6,1,5,凱基-頭份,2024-03-18,9296
1809,中釉,5,0,5,凱基-頭份,2024-03-18,9296
4207,環泰,5,0,5,凱基-頭份,2024-03-18,9296
9904,寶成,5,0,5,凱基-頭份,2024-03-18,9296
2603,長榮,4,0,4,凱基-頭份,2024-03-18,9296
6505,台塑化,4,0,4,凱基-頭份,2024-03-18,9296
3564,其陽,5,1,4,凱基-頭份,2024-03-18,9296
6233,旺玖,5,1,4,凱基-頭份,2024-03-18,9296
6591,動力-KY,5,1,4,凱基-頭份,2024-03-18,9296
8109,博大,4,0,4,凱基-頭份,2024-03-18,9296
9945,潤泰新,3,0,3,凱基-頭份,2024-03-18,9296
00882,中信中國高股息,3,0,3,凱基-頭份,2024-03-18,9296
00646,元大S＆P500,3,0,3,凱基-頭份,2024-03-18,9296
00753L,中信中國50正2,3,0,3,凱基-頭份,2024-03-18,9296
2357,華碩,4,1,3,凱基-頭份,2024-03-18,9296
2501,國建,3,0,3,凱基-頭份,2024-03-18,9296
2891,中信金,200,1,199,凱基-頭份,2024-03-19,9296
00706L,期元大S＆P日圓正2,50,0,50,凱基-頭份,2024-03-19,9296
00930,永豐ESG低碳高息,46,0,46,凱基-頭份,2024-03-19,9296
8028,昇陽半導體,36,0,36,凱基-頭份,2024-03-19,9296
2834,臺企銀,31,0,31,凱基-頭份,2024-03-19,9296
00900,富邦特選高股息30,50,25,25,凱基-頭份,2024-03-19,9296
00919,群益台灣精選高息,59,37,22,凱基-頭份,2024-03-19,9296
3032,偉訓,22,1,21,凱基-頭份,2024-03-19,9296
1316,上曜,30,10,20,凱基-頭份,2024-03-19,9296
00673R,期元大S＆P原油反1,20,0,20,凱基-頭份,2024-03-19,9296
4414,如興,20,0,20,凱基-頭份,2024-03-19,9296
00680L,元大美債20正2,18,0,18,凱基-頭份,2024-03-19,9296
1504,東元,33,18,15,凱基-頭份,2024-03-19,9296
2344,華邦電,14,1,13,凱基-頭份,2024-03-19,9296
8011,台通,15,2,13,凱基-頭份,2024-03-19,9296
2002,中鋼,12,0,12,凱基-頭份,2024-03-19,9296
2515,中工,13,1,12,凱基-頭份,2024-03-19,9296
3051,力特,12,0,12,凱基-頭份,2024-03-19,9296
00937B,群益ESG投等債20,12,0,12,凱基-頭份,2024-03-19,9296
2609,陽明,204,192,12,凱基-頭份,2024-03-19,9296
00915,凱基優選高股息30,26,14,12,凱基-頭份,2024-03-19,9296
00720B,元大投資級公司債,11,0,11,凱基-頭份,2024-03-19,9296
00687B,國泰20年美債,11,0,11,凱基-頭份,2024-03-19,9296
2105,正新,10,0,10,凱基-頭份,2024-03-19,9296
2486,一詮,20,10,10,凱基-頭份,2024-03-19,9296
00641R,富邦日本反1,10,0,10,凱基-頭份,2024-03-19,9296
00664R,國泰臺灣加權反1,10,0,10,凱基-頭份,2024-03-19,9296
1616,億泰,12,2,10,凱基-頭份,2024-03-19,9296
2637,慧洋-KY,10,0,10,凱基-頭份,2024-03-19,9296
4958,臻鼎-KY,12,2,10,凱基-頭份,2024-03-19,9296
2467,志聖,10,1,9,凱基-頭份,2024-03-19,9296
2888,新光金,8,0,8,凱基-頭份,2024-03-19,9296
00679B,元大美債20年,8,0,8,凱基-頭份,2024-03-19,9296
1101,台泥,25,17,8,凱基-頭份,2024-03-19,9296
2883,凱基金,10,2,8,凱基-頭份,2024-03-19,9296
6770,力積電,10,2,8,凱基-頭份,2024-03-19,9296
2449,京元電子,10,3,7,凱基-頭份,2024-03-19,9296
2886,兆豐金,7,0,7,凱基-頭份,2024-03-19,9296
5609,中菲行,7,0,7,凱基-頭份,2024-03-19,9296
1809,中釉,11,5,6,凱基-頭份,2024-03-19,9296
2211,長榮鋼,6,0,6,凱基-頭份,2024-03-19,9296
2329,華泰,9,3,6,凱基-頭份,2024-03-19,9296
6191,精成科,6,0,6,凱基-頭份,2024-03-19,9296
1319,東陽,19,13,6,凱基-頭份,2024-03-19,9296
2528,皇普,6,0,6,凱基-頭份,2024-03-19,9296
3324,雙鴻,7,1,6,凱基-頭份,2024-03-19,9296
3481,群創,28,22,6,凱基-頭份,2024-03-19,9296
6217,中探針,5,0,5,凱基-頭份,2024-03-19,9296
2323,中環,5,0,5,凱基-頭份,2024-03-19,9296
2353,宏��,15,10,5,凱基-頭份,2024-03-19,9296
00939,統一台灣高息動能,614,40,574,凱基-頭份,2024-03-20,9296
5905,南仁湖,90,0,90,凱基-頭份,2024-03-20,9296
4938,和碩,93,15,78,凱基-頭份,2024-03-20,9296
00919,群益台灣精選高息,140,84,56,凱基-頭份,2024-03-20,9296
2354,鴻準,60,8,52,凱基-頭份,2024-03-20,9296
2344,華邦電,38,2,36,凱基-頭份,2024-03-20,9296
00706L,期元大S＆P日圓正2,30,0,30,凱基-頭份,2024-03-20,9296
2834,臺企銀,32,3,29,凱基-頭份,2024-03-20,9296
2888,新光金,25,0,25,凱基-頭份,2024-03-20,9296
00930,永豐ESG低碳高息,31,6,25,凱基-頭份,2024-03-20,9296
00673R,期元大S＆P原油反1,22,0,22,凱基-頭份,2024-03-20,9296
8076,伍豐,20,0,20,凱基-頭份,2024-03-20,9296
00929,復華台灣科技優息,20,3,17,凱基-頭份,2024-03-20,9296
00878,國泰永續高股息,17,1,16,凱基-頭份,2024-03-20,9296
1513,中興電,19,4,15,凱基-頭份,2024-03-20,9296
00751B,元大AAA至A公司債,15,0,15,凱基-頭份,2024-03-20,9296
2611,志信,15,0,15,凱基-頭份,2024-03-20,9296
1736,喬山,16,1,15,凱基-頭份,2024-03-20,9296
2356,英業達,21,6,15,凱基-頭份,2024-03-20,9296
6147,頎邦,15,0,15,凱基-頭份,2024-03-20,9296
2323,中環,14,0,14,凱基-頭份,2024-03-20,9296
2367,燿華,16,4,12,凱基-頭份,2024-03-20,9296
3234,光環,12,0,12,凱基-頭份,2024-03-20,9296
9933,中鼎,12,0,12,凱基-頭份,2024-03-20,9296
00915,凱基優選高股息30,22,11,11,凱基-頭份,2024-03-20,9296
2013,中鋼構,11,0,11,凱基-頭份,2024-03-20,9296
2027,大成鋼,11,0,11,凱基-頭份,2024-03-20,9296
2457,飛宏,11,0,11,凱基-頭份,2024-03-20,9296
2501,國建,11,0,11,凱基-頭份,2024-03-20,9296
6770,力積電,13,2,11,凱基-頭份,2024-03-20,9296
00665L,富邦�琤肭磪囓�2,10,0,10,凱基-頭份,2024-03-20,9296
00715L,期街口布蘭特正2,10,0,10,凱基-頭份,2024-03-20,9296
2444,兆勁,10,0,10,凱基-頭份,2024-03-20,9296
2606,裕民,10,0,10,凱基-頭份,2024-03-20,9296
3543,州巧,10,0,10,凱基-頭份,2024-03-20,9296
1504,東元,24,15,9,凱基-頭份,2024-03-20,9296
6217,中探針,9,1,8,凱基-頭份,2024-03-20,9296
00795B,中信美國公債20年,8,0,8,凱基-頭份,2024-03-20,9296
4563,百德,8,0,8,凱基-頭份,2024-03-20,9296
2885,元大金,7,0,7,凱基-頭份,2024-03-20,9296
2520,冠德,7,0,7,凱基-頭份,2024-03-20,9296
3051,力特,7,0,7,凱基-頭份,2024-03-20,9296
5443,均豪,8,1,7,凱基-頭份,2024-03-20,9296
5483,中美晶,16,9,7,凱基-頭份,2024-03-20,9296
3702,大聯大,6,0,6,凱基-頭份,2024-03-20,9296
1315,達新,6,0,6,凱基-頭份,2024-03-20,9296
2609,陽明,107,101,6,凱基-頭份,2024-03-20,9296
2812,台中銀,7,1,6,凱基-頭份,2024-03-20,9296
2897,王道銀行,6,0,6,凱基-頭份,2024-03-20,9296
3481,群創,11,5,6,凱基-頭份,2024-03-20,9296
4938,和碩,164,19,145,凱基-頭份,2024-03-21,9296
00650L,復華香港正2,50,0,50,凱基-頭份,2024-03-21,9296
2834,臺企銀,42,0,42,凱基-頭份,2024-03-21,9296
6189,豐藝,37,0,37,凱基-頭份,2024-03-21,9296
00679B,元大美債20年,32,0,32,凱基-頭份,2024-03-21,9296
2363,矽統,30,0,30,凱基-頭份,2024-03-21,9296
2354,鴻準,29,4,25,凱基-頭份,2024-03-21,9296
4960,誠美材,21,0,21,凱基-頭份,2024-03-21,9296
00720B,元大投資級公司債,18,0,18,凱基-頭份,2024-03-21,9296
2358,廷鑫,28,10,18,凱基-頭份,2024-03-21,9296
00927,群益半導體收益,16,0,16,凱基-頭份,2024-03-21,9296
00941,中信上游半導體,29,15,14,凱基-頭份,2024-03-21,9296
00857B,永豐20年美公債,11,0,11,凱基-頭份,2024-03-21,9296
4934,太極,11,0,11,凱基-頭份,2024-03-21,9296
5452,佶優,10,0,10,凱基-頭份,2024-03-21,9296
00641R,富邦日本反1,10,0,10,凱基-頭份,2024-03-21,9296
6197,佳必琪,13,3,10,凱基-頭份,2024-03-21,9296
6219,富旺,10,0,10,凱基-頭份,2024-03-21,9296
8234,新漢,10,0,10,凱基-頭份,2024-03-21,9296
5483,中美晶,14,4,10,凱基-頭份,2024-03-21,9296
00830,國泰費城半導體,10,1,9,凱基-頭份,2024-03-21,9296
2379,瑞昱,9,0,9,凱基-頭份,2024-03-21,9296
2323,中環,13,5,8,凱基-頭份,2024-03-21,9296
0056,元大高股息,10,2,8,凱基-頭份,2024-03-21,9296
1522,堤維西,8,1,7,凱基-頭份,2024-03-21,9296
2329,華泰,9,2,7,凱基-頭份,2024-03-21,9296
2855,統一證,9,2,7,凱基-頭份,2024-03-21,9296
1785,光洋科,8,1,7,凱基-頭份,2024-03-21,9296
00687B,國泰20年美債,8,1,7,凱基-頭份,2024-03-21,9296
5443,均豪,10,3,7,凱基-頭份,2024-03-21,9296
2606,裕民,8,2,6,凱基-頭份,2024-03-21,9296
1736,喬山,7,1,6,凱基-頭份,2024-03-21,9296
2002,中鋼,6,0,6,凱基-頭份,2024-03-21,9296
2352,佳世達,6,0,6,凱基-頭份,2024-03-21,9296
3052,夆典,6,0,6,凱基-頭份,2024-03-21,9296
3260,威剛,10,4,6,凱基-頭份,2024-03-21,9296
3673,TPK-KY,6,0,6,凱基-頭份,2024-03-21,9296
6235,華孚,7,1,6,凱基-頭份,2024-03-21,9296
3362,先進光,5,0,5,凱基-頭份,2024-03-21,9296
2888,新光金,5,0,5,凱基-頭份,2024-03-21,9296
00648R,元大S＆P500反1,5,0,5,凱基-頭份,2024-03-21,9296
1447,力鵬,5,0,5,凱基-頭份,2024-03-21,9296
1587,吉茂,10,5,5,凱基-頭份,2024-03-21,9296
9105,泰金寶-DR,5,0,5,凱基-頭份,2024-03-21,9296
2376,技嘉,5,0,5,凱基-頭份,2024-03-21,9296
3041,揚智,46,42,4,凱基-頭份,2024-03-21,9296
00680L,元大美債20正2,4,0,4,凱基-頭份,2024-03-21,9296
1616,億泰,4,0,4,凱基-頭份,2024-03-21,9296
3030,德律,4,0,4,凱基-頭份,2024-03-21,9296
4533,協易機,5,1,4,凱基-頭份,2024-03-21,9296
00941,中信上游半導體,91,5,86,凱基-頭份,2024-03-22,9296
00712,復華富時不動產,103,18,85,凱基-頭份,2024-03-22,9296
2353,宏��,73,15,58,凱基-頭份,2024-03-22,9296
00939,統一台灣高息動能,58,6,52,凱基-頭份,2024-03-22,9296
3576,聯合再生,40,2,38,凱基-頭份,2024-03-22,9296
2344,華邦電,53,15,38,凱基-頭份,2024-03-22,9296
00919,群益台灣精選高息,72,48,24,凱基-頭份,2024-03-22,9296
00688L,國泰20年美債正2,20,0,20,凱基-頭份,2024-03-22,9296
00937B,群益ESG投等債20,19,0,19,凱基-頭份,2024-03-22,9296
3710,連展投控,18,0,18,凱基-頭份,2024-03-22,9296
2885,元大金,18,0,18,凱基-頭份,2024-03-22,9296
5483,中美晶,18,2,16,凱基-頭份,2024-03-22,9296
2367,燿華,24,8,16,凱基-頭份,2024-03-22,9296
6147,頎邦,14,0,14,凱基-頭份,2024-03-22,9296
2324,仁寶,14,2,12,凱基-頭份,2024-03-22,9296
2464,盟立,25,14,11,凱基-頭份,2024-03-22,9296
2408,南亞科,18,8,10,凱基-頭份,2024-03-22,9296
6219,富旺,10,0,10,凱基-頭份,2024-03-22,9296
2356,英業達,74,64,10,凱基-頭份,2024-03-22,9296
3706,神達,39,29,10,凱基-頭份,2024-03-22,9296
2882,國泰金,100,91,9,凱基-頭份,2024-03-22,9296
2834,臺企銀,23,14,9,凱基-頭份,2024-03-22,9296
00673R,期元大S＆P原油反1,10,2,8,凱基-頭份,2024-03-22,9296
1319,東陽,22,14,8,凱基-頭份,2024-03-22,9296
2006,東和鋼鐵,8,0,8,凱基-頭份,2024-03-22,9296
3052,夆典,8,0,8,凱基-頭份,2024-03-22,9296
6243,迅杰,8,0,8,凱基-頭份,2024-03-22,9296
8403,盛弘,8,0,8,凱基-頭份,2024-03-22,9296
3498,陽程,7,0,7,凱基-頭份,2024-03-22,9296
2492,華新科,6,0,6,凱基-頭份,2024-03-22,9296
2317,鴻海,39,33,6,凱基-頭份,2024-03-22,9296
1736,喬山,5,0,5,凱基-頭份,2024-03-22,9296
2634,漢翔,5,0,5,凱基-頭份,2024-03-22,9296
2912,統一超,5,0,5,凱基-頭份,2024-03-22,9296
4123,晟德,5,0,5,凱基-頭份,2024-03-22,9296
5508,永信建,5,0,5,凱基-頭份,2024-03-22,9296
6122,擎邦,5,0,5,凱基-頭份,2024-03-22,9296
0056,元大高股息,4,0,4,凱基-頭份,2024-03-22,9296
2379,瑞昱,5,1,4,凱基-頭份,2024-03-22,9296
00720B,元大投資級公司債,5,1,4,凱基-頭份,2024-03-22,9296
1522,堤維西,4,0,4,凱基-頭份,2024-03-22,9296
1785,光洋科,5,1,4,凱基-頭份,2024-03-22,9296
2377,微星,5,1,4,凱基-頭份,2024-03-22,9296
2498,宏達電,4,0,4,凱基-頭份,2024-03-22,9296
2630,亞航,8,4,4,凱基-頭份,2024-03-22,9296
3037,欣興,7,3,4,凱基-頭份,2024-03-22,9296
3234,光環,4,0,4,凱基-頭份,2024-03-22,9296
3622,洋華,4,0,4,凱基-頭份,2024-03-22,9296
4938,和碩,13,9,4,凱基-頭份,2024-03-22,9296
8011,台通,4,0,4,凱基-頭份,2024-03-22,9296
2882,國泰金,261,0,261,凱基-頭份,2024-03-25,9296
00680L,元大美債20正2,111,30,81,凱基-頭份,2024-03-25,9296
4938,和碩,78,14,64,凱基-頭份,2024-03-25,9296
2356,英業達,85,26,59,凱基-頭份,2024-03-25,9296
2834,臺企銀,60,1,59,凱基-頭份,2024-03-25,9296
00937B,群益ESG投等債20,51,0,51,凱基-頭份,2024-03-25,9296
5608,四維航,50,2,48,凱基-頭份,2024-03-25,9296
00919,群益台灣精選高息,51,14,37,凱基-頭份,2024-03-25,9296
2464,盟立,109,76,33,凱基-頭份,2024-03-25,9296
00941,中信上游半導體,90,58,32,凱基-頭份,2024-03-25,9296
1609,大亞,57,36,21,凱基-頭份,2024-03-25,9296
00939,統一台灣高息動能,51,30,21,凱基-頭份,2024-03-25,9296
3704,合勤控,34,14,20,凱基-頭份,2024-03-25,9296
00764B,群益25年美債,20,0,20,凱基-頭份,2024-03-25,9296
2883,凱基金,20,2,18,凱基-頭份,2024-03-25,9296
3052,夆典,17,0,17,凱基-頭份,2024-03-25,9296
00715L,期街口布蘭特正2,15,0,15,凱基-頭份,2024-03-25,9296
00665L,富邦�琤肭磪囓�2,15,0,15,凱基-頭份,2024-03-25,9296
00664R,國泰臺灣加權反1,15,0,15,凱基-頭份,2024-03-25,9296
3706,神達,18,4,14,凱基-頭份,2024-03-25,9296
2002,中鋼,13,0,13,凱基-頭份,2024-03-25,9296
2405,輔信,13,0,13,凱基-頭份,2024-03-25,9296
6189,豐藝,23,12,11,凱基-頭份,2024-03-25,9296
2867,三商壽,11,0,11,凱基-頭份,2024-03-25,9296
1785,光洋科,10,0,10,凱基-頭份,2024-03-25,9296
1718,中纖,10,0,10,凱基-頭份,2024-03-25,9296
8936,國統,10,0,10,凱基-頭份,2024-03-25,9296
00896,中信綠能及電動車,10,0,10,凱基-頭份,2024-03-25,9296
2630,亞航,11,1,10,凱基-頭份,2024-03-25,9296
2308,台達電,11,1,10,凱基-頭份,2024-03-25,9296
00929,復華台灣科技優息,31,21,10,凱基-頭份,2024-03-25,9296
2884,玉山金,9,0,9,凱基-頭份,2024-03-25,9296
2303,聯電,20,11,9,凱基-頭份,2024-03-25,9296
1301,台塑,10,1,9,凱基-頭份,2024-03-25,9296
1582,信錦,10,1,9,凱基-頭份,2024-03-25,9296
00922,國泰台灣領袖50,8,0,8,凱基-頭份,2024-03-25,9296
6117,迎廣,24,16,8,凱基-頭份,2024-03-25,9296
6613,朋億*,8,0,8,凱基-頭份,2024-03-25,9296
9907,統一實,8,0,8,凱基-頭份,2024-03-25,9296
6770,力積電,9,1,8,凱基-頭份,2024-03-25,9296
00878,國泰永續高股息,12,5,7,凱基-頭份,2024-03-25,9296
2402,毅嘉,7,0,7,凱基-頭份,2024-03-25,9296
4306,炎洲,7,0,7,凱基-頭份,2024-03-25,9296
2352,佳世達,7,0,7,凱基-頭份,2024-03-25,9296
2329,華泰,6,0,6,凱基-頭份,2024-03-25,9296
2610,華航,6,0,6,凱基-頭份,2024-03-25,9296
3234,光環,7,1,6,凱基-頭份,2024-03-25,9296
5508,永信建,6,0,6,凱基-頭份,2024-03-25,9296
3545,敦泰,6,1,5,凱基-頭份,2024-03-25,9296
6214,精誠,5,0,5,凱基-頭份,2024-03-25,9296
00632R,元大台灣50反1,110,0,110,凱基-頭份,2024-03-26,9296
2882,國泰金,100,5,95,凱基-頭份,2024-03-26,9296
2845,遠東銀,92,0,92,凱基-頭份,2024-03-26,9296
00919,群益台灣精選高息,127,47,80,凱基-頭份,2024-03-26,9296
00929,復華台灣科技優息,135,55,80,凱基-頭份,2024-03-26,9296
00680L,元大美債20正2,60,0,60,凱基-頭份,2024-03-26,9296
4938,和碩,48,0,48,凱基-頭份,2024-03-26,9296
00939,統一台灣高息動能,103,68,35,凱基-頭份,2024-03-26,9296
2101,南港,25,0,25,凱基-頭份,2024-03-26,9296
00937B,群益ESG投等債20,23,2,21,凱基-頭份,2024-03-26,9296
2027,大成鋼,20,1,19,凱基-頭份,2024-03-26,9296
911608,明輝-DR,19,0,19,凱基-頭份,2024-03-26,9296
2609,陽明,18,0,18,凱基-頭份,2024-03-26,9296
3704,合勤控,19,2,17,凱基-頭份,2024-03-26,9296
1301,台塑,14,0,14,凱基-頭份,2024-03-26,9296
6219,富旺,14,0,14,凱基-頭份,2024-03-26,9296
1587,吉茂,18,5,13,凱基-頭份,2024-03-26,9296
2359,所羅門,23,11,12,凱基-頭份,2024-03-26,9296
00679B,元大美債20年,12,0,12,凱基-頭份,2024-03-26,9296
3026,禾伸堂,10,0,10,凱基-頭份,2024-03-26,9296
1809,中釉,20,10,10,凱基-頭份,2024-03-26,9296
2498,宏達電,10,0,10,凱基-頭份,2024-03-26,9296
4306,炎洲,10,0,10,凱基-頭份,2024-03-26,9296
4804,大略-KY,10,0,10,凱基-頭份,2024-03-26,9296
6120,達運,10,0,10,凱基-頭份,2024-03-26,9296
00900,富邦特選高股息30,10,1,9,凱基-頭份,2024-03-26,9296
2379,瑞昱,9,0,9,凱基-頭份,2024-03-26,9296
00751B,元大AAA至A公司債,9,0,9,凱基-頭份,2024-03-26,9296
1618,合機,11,2,9,凱基-頭份,2024-03-26,9296
8271,宇瞻,13,4,9,凱基-頭份,2024-03-26,9296
1616,億泰,18,10,8,凱基-頭份,2024-03-26,9296
2331,精英,10,2,8,凱基-頭份,2024-03-26,9296
6176,瑞儀,8,0,8,凱基-頭份,2024-03-26,9296
1785,光洋科,8,0,8,凱基-頭份,2024-03-26,9296
00720B,元大投資級公司債,7,0,7,凱基-頭份,2024-03-26,9296
2303,聯電,21,14,7,凱基-頭份,2024-03-26,9296
1305,華夏,7,0,7,凱基-頭份,2024-03-26,9296
2405,輔信,13,6,7,凱基-頭份,2024-03-26,9296
6215,和椿,10,3,7,凱基-頭份,2024-03-26,9296
8033,雷虎,7,0,7,凱基-頭份,2024-03-26,9296
00692,富邦公司治理,6,0,6,凱基-頭份,2024-03-26,9296
2617,台航,6,0,6,凱基-頭份,2024-03-26,9296
3052,夆典,6,0,6,凱基-頭份,2024-03-26,9296
3706,神達,7,1,6,凱基-頭份,2024-03-26,9296
6117,迎廣,15,9,6,凱基-頭份,2024-03-26,9296
6668,中揚光,6,0,6,凱基-頭份,2024-03-26,9296
5483,中美晶,7,2,5,凱基-頭份,2024-03-26,9296
00927,群益半導體收益,28,23,5,凱基-頭份,2024-03-26,9296
2603,長榮,5,0,5,凱基-頭份,2024-03-26,9296
6613,朋億*,5,0,5,凱基-頭份,2024-03-26,9296
2630,亞航,47,5,42,凱基-頭份,2024-03-27,9296
2002,中鋼,33,0,33,凱基-頭份,2024-03-27,9296
00937B,群益ESG投等債20,27,0,27,凱基-頭份,2024-03-27,9296
00939,統一台灣高息動能,25,0,25,凱基-頭份,2024-03-27,9296
8033,雷虎,21,0,21,凱基-頭份,2024-03-27,9296
1316,上曜,33,13,20,凱基-頭份,2024-03-27,9296
6189,豐藝,21,2,19,凱基-頭份,2024-03-27,9296
00713,元大台灣高息低波,20,1,19,凱基-頭份,2024-03-27,9296
2464,盟立,25,8,17,凱基-頭份,2024-03-27,9296
00929,復華台灣科技優息,30,15,15,凱基-頭份,2024-03-27,9296
2887,台新金,14,0,14,凱基-頭份,2024-03-27,9296
6788,華景電,13,0,13,凱基-頭份,2024-03-27,9296
1305,華夏,20,8,12,凱基-頭份,2024-03-27,9296
2303,聯電,21,9,12,凱基-頭份,2024-03-27,9296
5880,合庫金,12,0,12,凱基-頭份,2024-03-27,9296
2371,大同,54,43,11,凱基-頭份,2024-03-27,9296
00706L,期元大S＆P日圓正2,10,0,10,凱基-頭份,2024-03-27,9296
4306,炎洲,10,0,10,凱基-頭份,2024-03-27,9296
1513,中興電,23,14,9,凱基-頭份,2024-03-27,9296
1504,東元,10,2,8,凱基-頭份,2024-03-27,9296
6613,朋億*,8,0,8,凱基-頭份,2024-03-27,9296
1721,三晃,7,0,7,凱基-頭份,2024-03-27,9296
5315,光聯,7,0,7,凱基-頭份,2024-03-27,9296
6191,精成科,7,0,7,凱基-頭份,2024-03-27,9296
2884,玉山金,6,0,6,凱基-頭份,2024-03-27,9296
1307,三芳,6,0,6,凱基-頭份,2024-03-27,9296
00715L,期街口布蘭特正2,6,0,6,凱基-頭份,2024-03-27,9296
1612,宏泰,6,0,6,凱基-頭份,2024-03-27,9296
1616,億泰,16,10,6,凱基-頭份,2024-03-27,9296
2301,光寶科,6,0,6,凱基-頭份,2024-03-27,9296
2356,英業達,15,9,6,凱基-頭份,2024-03-27,9296
4157,太景*-KY,6,0,6,凱基-頭份,2024-03-27,9296
6113,亞矽,7,1,6,凱基-頭份,2024-03-27,9296
00637L,元大滬深300正2,5,0,5,凱基-頭份,2024-03-27,9296
00909,國泰數位支付服務,5,0,5,凱基-頭份,2024-03-27,9296
00927,群益半導體收益,5,0,5,凱基-頭份,2024-03-27,9296
2603,長榮,6,1,5,凱基-頭份,2024-03-27,9296
3006,晶豪科,5,0,5,凱基-頭份,2024-03-27,9296
3043,科風,5,0,5,凱基-頭份,2024-03-27,9296
3234,光環,5,0,5,凱基-頭份,2024-03-27,9296
4503,金雨,5,0,5,凱基-頭份,2024-03-27,9296
6117,迎廣,5,0,5,凱基-頭份,2024-03-27,9296
6125,廣運,11,6,5,凱基-頭份,2024-03-27,9296
2417,圓剛,8,3,5,凱基-頭份,2024-03-27,9296
00919,群益台灣精選高息,38,33,5,凱基-頭份,2024-03-27,9296
2363,矽統,4,0,4,凱基-頭份,2024-03-27,9296
9945,潤泰新,4,0,4,凱基-頭份,2024-03-27,9296
3622,洋華,7,3,4,凱基-頭份,2024-03-27,9296
00757,統一FANG+,4,0,4,凱基-頭份,2024-03-27,9296
00720B,元大投資級公司債,4,0,4,凱基-頭份,2024-03-27,9296
5880,合庫金,100,0,100,凱基-頭份,2024-03-28,9296
4306,炎洲,63,1,62,凱基-頭份,2024-03-28,9296
6443,元晶,57,2,55,凱基-頭份,2024-03-28,9296
2883,凱基金,52,0,52,凱基-頭份,2024-03-28,9296
4714,永捷,38,9,29,凱基-頭份,2024-03-28,9296
00882,中信中國高股息,28,0,28,凱基-頭份,2024-03-28,9296
2301,光寶科,26,0,26,凱基-頭份,2024-03-28,9296
3706,神達,30,5,25,凱基-頭份,2024-03-28,9296
00919,群益台灣精選高息,44,21,23,凱基-頭份,2024-03-28,9296
00937B,群益ESG投等債20,25,2,23,凱基-頭份,2024-03-28,9296
3704,合勤控,36,13,23,凱基-頭份,2024-03-28,9296
6117,迎廣,24,1,23,凱基-頭份,2024-03-28,9296
2337,旺宏,20,0,20,凱基-頭份,2024-03-28,9296
2354,鴻準,36,19,17,凱基-頭份,2024-03-28,9296
00941,中信上游半導體,19,6,13,凱基-頭份,2024-03-28,9296
2328,廣宇,13,0,13,凱基-頭份,2024-03-28,9296
2547,日勝生,13,0,13,凱基-頭份,2024-03-28,9296
2834,臺企銀,15,2,13,凱基-頭份,2024-03-28,9296
00857B,永豐20年美公債,11,0,11,凱基-頭份,2024-03-28,9296
1714,和桐,10,0,10,凱基-頭份,2024-03-28,9296
2637,慧洋-KY,10,0,10,凱基-頭份,2024-03-28,9296
8926,台汽電,10,0,10,凱基-頭份,2024-03-28,9296
6215,和椿,9,0,9,凱基-頭份,2024-03-28,9296
2344,華邦電,12,4,8,凱基-頭份,2024-03-28,9296
3576,聯合再生,8,0,8,凱基-頭份,2024-03-28,9296
9938,百和,8,0,8,凱基-頭份,2024-03-28,9296
6285,啟��,10,2,8,凱基-頭份,2024-03-28,9296
00939,統一台灣高息動能,14,7,7,凱基-頭份,2024-03-28,9296
1603,華電,9,2,7,凱基-頭份,2024-03-28,9296
1303,南亞,6,0,6,凱基-頭份,2024-03-28,9296
1582,信錦,9,3,6,凱基-頭份,2024-03-28,9296
2329,華泰,6,0,6,凱基-頭份,2024-03-28,9296
3312,弘憶股,7,1,6,凱基-頭份,2024-03-28,9296
1513,中興電,10,4,6,凱基-頭份,2024-03-28,9296
3622,洋華,5,0,5,凱基-頭份,2024-03-28,9296
2332,友訊,5,0,5,凱基-頭份,2024-03-28,9296
2342,茂矽,5,0,5,凱基-頭份,2024-03-28,9296
2412,中華電,6,1,5,凱基-頭份,2024-03-28,9296
2888,新光金,5,0,5,凱基-頭份,2024-03-28,9296
3019,亞光,5,0,5,凱基-頭份,2024-03-28,9296
5351,鈺創,5,0,5,凱基-頭份,2024-03-28,9296
6120,達運,9,4,5,凱基-頭份,2024-03-28,9296
6668,中揚光,5,0,5,凱基-頭份,2024-03-28,9296
2889,國票金,5,0,5,凱基-頭份,2024-03-28,9296
00891,中信關鍵半導體,4,0,4,凱基-頭份,2024-03-28,9296
1316,上曜,18,14,4,凱基-頭份,2024-03-28,9296
1608,華榮,12,8,4,凱基-頭份,2024-03-28,9296
3016,嘉晶,4,0,4,凱基-頭份,2024-03-28,9296
3498,陽程,4,0,4,凱基-頭份,2024-03-28,9296
3583,辛耘,6,2,4,凱基-頭份,2024-03-28,9296
00937B,群益ESG投等債20,1958,16,1942,凱基-頭份,2024-03-29,9296
00941,中信上游半導體,138,45,93,凱基-頭份,2024-03-29,9296
5386,青雲,55,9,46,凱基-頭份,2024-03-29,9296
00712,復華富時不動產,50,5,45,凱基-頭份,2024-03-29,9296
2027,大成鋼,31,0,31,凱基-頭份,2024-03-29,9296
5880,合庫金,40,10,30,凱基-頭份,2024-03-29,9296
2354,鴻準,35,8,27,凱基-頭份,2024-03-29,9296
8110,華東,31,5,26,凱基-頭份,2024-03-29,9296
00919,群益台灣精選高息,33,11,22,凱基-頭份,2024-03-29,9296
00632R,元大台灣50反1,20,0,20,凱基-頭份,2024-03-29,9296
911608,明輝-DR,20,0,20,凱基-頭份,2024-03-29,9296
3704,合勤控,18,0,18,凱基-頭份,2024-03-29,9296
00679B,元大美債20年,19,3,16,凱基-頭份,2024-03-29,9296
2323,中環,13,0,13,凱基-頭份,2024-03-29,9296
6443,元晶,12,0,12,凱基-頭份,2024-03-29,9296
3706,神達,14,2,12,凱基-頭份,2024-03-29,9296
6120,達運,16,4,12,凱基-頭份,2024-03-29,9296
2324,仁寶,11,0,11,凱基-頭份,2024-03-29,9296
00939,統一台灣高息動能,15,4,11,凱基-頭份,2024-03-29,9296
00918,大華優利高填息30,10,0,10,凱基-頭份,2024-03-29,9296
2101,南港,10,0,10,凱基-頭份,2024-03-29,9296
9105,泰金寶-DR,10,0,10,凱基-頭份,2024-03-29,9296
00929,復華台灣科技優息,15,6,9,凱基-頭份,2024-03-29,9296
2367,燿華,112,103,9,凱基-頭份,2024-03-29,9296
3005,神基,18,10,8,凱基-頭份,2024-03-29,9296
3025,星通,8,0,8,凱基-頭份,2024-03-29,9296
1736,喬山,9,1,8,凱基-頭份,2024-03-29,9296
1220,台榮,7,0,7,凱基-頭份,2024-03-29,9296
4303,信立,9,2,7,凱基-頭份,2024-03-29,9296
2371,大同,12,5,7,凱基-頭份,2024-03-29,9296
3004,豐達科,6,0,6,凱基-頭份,2024-03-29,9296
3587,閎康,6,0,6,凱基-頭份,2024-03-29,9296
2301,光寶科,11,5,6,凱基-頭份,2024-03-29,9296
5425,台半,5,0,5,凱基-頭份,2024-03-29,9296
00909,國泰數位支付服務,5,0,5,凱基-頭份,2024-03-29,9296
1616,億泰,5,0,5,凱基-頭份,2024-03-29,9296
3013,晟銘電,14,9,5,凱基-頭份,2024-03-29,9296
4157,太景*-KY,5,0,5,凱基-頭份,2024-03-29,9296
6217,中探針,4,0,4,凱基-頭份,2024-03-29,9296
8390,金益鼎,4,0,4,凱基-頭份,2024-03-29,9296
2441,超豐,5,1,4,凱基-頭份,2024-03-29,9296
3257,虹冠電,4,0,4,凱基-頭份,2024-03-29,9296
5381,合正,4,0,4,凱基-頭份,2024-03-29,9296
8050,廣積,6,2,4,凱基-頭份,2024-03-29,9296
8054,安國,7,4,3,凱基-頭份,2024-03-29,9296
6596,寬宏藝術,4,1,3,凱基-頭份,2024-03-29,9296
6125,廣運,4,1,3,凱基-頭份,2024-03-29,9296
8086,宏捷科,3,0,3,凱基-頭份,2024-03-29,9296
00882,中信中國高股息,3,0,3,凱基-頭份,2024-03-29,9296
2617,台航,3,0,3,凱基-頭份,2024-03-29,9296
00937B,群益ESG投等債20,1646,15,1631,凱基-頭份,2024-04-01,9296
00940,元大台灣價值高息,755,162,593,凱基-頭份,2024-04-01,9296
911868,同方友友-DR,116,0,116,凱基-頭份,2024-04-01,9296
4414,如興,100,0,100,凱基-頭份,2024-04-01,9296
00919,群益台灣精選高息,51,4,47,凱基-頭份,2024-04-01,9296
3555,博士旺,30,0,30,凱基-頭份,2024-04-01,9296
2634,漢翔,35,13,22,凱基-頭份,2024-04-01,9296
8054,安國,22,1,21,凱基-頭份,2024-04-01,9296
00632R,元大台灣50反1,21,0,21,凱基-頭份,2024-04-01,9296
6788,華景電,20,0,20,凱基-頭份,2024-04-01,9296
2308,台達電,20,1,19,凱基-頭份,2024-04-01,9296
1504,東元,21,4,17,凱基-頭份,2024-04-01,9296
2547,日勝生,20,4,16,凱基-頭份,2024-04-01,9296
00915,凱基優選高股息30,16,0,16,凱基-頭份,2024-04-01,9296
2101,南港,15,0,15,凱基-頭份,2024-04-01,9296
00878,國泰永續高股息,67,52,15,凱基-頭份,2024-04-01,9296
00939,統一台灣高息動能,15,1,14,凱基-頭份,2024-04-01,9296
00753L,中信中國50正2,11,0,11,凱基-頭份,2024-04-01,9296
2356,英業達,19,8,11,凱基-頭份,2024-04-01,9296
4541,晟田,10,0,10,凱基-頭份,2024-04-01,9296
00857B,永豐20年美公債,10,0,10,凱基-頭份,2024-04-01,9296
3622,洋華,10,0,10,凱基-頭份,2024-04-01,9296
2009,第一銅,14,5,9,凱基-頭份,2024-04-01,9296
2363,矽統,10,1,9,凱基-頭份,2024-04-01,9296
3694,海華,9,0,9,凱基-頭份,2024-04-01,9296
4562,穎漢,9,0,9,凱基-頭份,2024-04-01,9296
00679B,元大美債20年,15,7,8,凱基-頭份,2024-04-01,9296
2303,聯電,8,0,8,凱基-頭份,2024-04-01,9296
2542,興富發,9,1,8,凱基-頭份,2024-04-01,9296
2382,廣達,75,68,7,凱基-頭份,2024-04-01,9296
3231,緯創,10,3,7,凱基-頭份,2024-04-01,9296
2887,台新金,7,0,7,凱基-頭份,2024-04-01,9296
3032,偉訓,8,1,7,凱基-頭份,2024-04-01,9296
3088,艾訊,7,0,7,凱基-頭份,2024-04-01,9296
2002,中鋼,6,0,6,凱基-頭份,2024-04-01,9296
2449,京元電子,7,1,6,凱基-頭份,2024-04-01,9296
6462,神盾,8,2,6,凱基-頭份,2024-04-01,9296
2609,陽明,6,1,5,凱基-頭份,2024-04-01,9296
0056,元大高股息,7,2,5,凱基-頭份,2024-04-01,9296
3052,夆典,5,0,5,凱基-頭份,2024-04-01,9296
00635U,期元大S＆P黃金,5,0,5,凱基-頭份,2024-04-01,9296
00710B,復華彭博非投等債,5,0,5,凱基-頭份,2024-04-01,9296
1605,華新,5,0,5,凱基-頭份,2024-04-01,9296
2344,華邦電,15,10,5,凱基-頭份,2024-04-01,9296
2441,超豐,5,0,5,凱基-頭份,2024-04-01,9296
3511,矽瑪,5,0,5,凱基-頭份,2024-04-01,9296
6120,達運,7,2,5,凱基-頭份,2024-04-01,9296
6672,騰輝電子-KY,5,0,5,凱基-頭份,2024-04-01,9296
2603,長榮,6,1,5,凱基-頭份,2024-04-01,9296
2330,台積電,4,0,4,凱基-頭份,2024-04-01,9296
00940,元大台灣價值高息,278,120,158,凱基-頭份,2024-04-02,9296
00929,復華台灣科技優息,95,18,77,凱基-頭份,2024-04-02,9296
00941,中信上游半導體,53,0,53,凱基-頭份,2024-04-02,9296
2323,中環,41,0,41,凱基-頭份,2024-04-02,9296
5905,南仁湖,40,0,40,凱基-頭份,2024-04-02,9296
3494,誠研,38,0,38,凱基-頭份,2024-04-02,9296
8101,華冠,37,0,37,凱基-頭份,2024-04-02,9296
00937B,群益ESG投等債20,35,0,35,凱基-頭份,2024-04-02,9296
00919,群益台灣精選高息,46,14,32,凱基-頭份,2024-04-02,9296
00733,富邦臺灣中小,27,0,27,凱基-頭份,2024-04-02,9296
3231,緯創,30,7,23,凱基-頭份,2024-04-02,9296
3481,群創,49,26,23,凱基-頭份,2024-04-02,9296
1504,東元,26,4,22,凱基-頭份,2024-04-02,9296
6219,富旺,20,0,20,凱基-頭份,2024-04-02,9296
2610,華航,19,0,19,凱基-頭份,2024-04-02,9296
00933B,國泰10Y+金融債,15,0,15,凱基-頭份,2024-04-02,9296
00673R,期元大S＆P原油反1,14,0,14,凱基-頭份,2024-04-02,9296
2317,鴻海,22,8,14,凱基-頭份,2024-04-02,9296
00679B,元大美債20年,13,0,13,凱基-頭份,2024-04-02,9296
2515,中工,20,8,12,凱基-頭份,2024-04-02,9296
4414,如興,11,0,11,凱基-頭份,2024-04-02,9296
6217,中探針,10,0,10,凱基-頭份,2024-04-02,9296
00927,群益半導體收益,10,0,10,凱基-頭份,2024-04-02,9296
00753L,中信中國50正2,10,0,10,凱基-頭份,2024-04-02,9296
00665L,富邦�琤肭磪囓�2,10,0,10,凱基-頭份,2024-04-02,9296
1444,力麗,10,0,10,凱基-頭份,2024-04-02,9296
2356,英業達,12,2,10,凱基-頭份,2024-04-02,9296
2408,南亞科,10,0,10,凱基-頭份,2024-04-02,9296
2618,長榮航,13,3,10,凱基-頭份,2024-04-02,9296
1809,中釉,13,3,10,凱基-頭份,2024-04-02,9296
00687B,國泰20年美債,12,2,10,凱基-頭份,2024-04-02,9296
00882,中信中國高股息,19,10,9,凱基-頭份,2024-04-02,9296
1612,宏泰,10,1,9,凱基-頭份,2024-04-02,9296
3466,德晉,9,0,9,凱基-頭份,2024-04-02,9296
8028,昇陽半導體,10,1,9,凱基-頭份,2024-04-02,9296
2327,國巨,8,0,8,凱基-頭份,2024-04-02,9296
4123,晟德,10,2,8,凱基-頭份,2024-04-02,9296
3499,環天科,7,0,7,凱基-頭份,2024-04-02,9296
6577,勁豐,7,0,7,凱基-頭份,2024-04-02,9296
1618,合機,8,2,6,凱基-頭份,2024-04-02,9296
8271,宇瞻,8,2,6,凱基-頭份,2024-04-02,9296
2301,光寶科,6,1,5,凱基-頭份,2024-04-02,9296
2344,華邦電,8,3,5,凱基-頭份,2024-04-02,9296
2405,輔信,5,0,5,凱基-頭份,2024-04-02,9296
2633,台灣高鐵,5,0,5,凱基-頭份,2024-04-02,9296
3083,網龍,5,0,5,凱基-頭份,2024-04-02,9296
3122,笙泉,10,5,5,凱基-頭份,2024-04-02,9296
3704,合勤控,5,0,5,凱基-頭份,2024-04-02,9296
6231,系微,5,0,5,凱基-頭份,2024-04-02,9296
6517,保勝光學,5,0,5,凱基-頭份,2024-04-02,9296
00929,復華台灣科技優息,1950,15,1935,凱基-頭份,2024-04-03,9296
6895,宏碩系統,32,0,32,凱基-頭份,2024-04-03,9296
00941,中信上游半導體,32,3,29,凱基-頭份,2024-04-03,9296
2486,一詮,42,15,27,凱基-頭份,2024-04-03,9296
00673R,期元大S＆P原油反1,22,0,22,凱基-頭份,2024-04-03,9296
00905,FT臺灣Smart,20,0,20,凱基-頭份,2024-04-03,9296
6577,勁豐,20,0,20,凱基-頭份,2024-04-03,9296
00687B,國泰20年美債,19,0,19,凱基-頭份,2024-04-03,9296
2327,國巨,17,0,17,凱基-頭份,2024-04-03,9296
2354,鴻準,27,10,17,凱基-頭份,2024-04-03,9296
2618,長榮航,22,5,17,凱基-頭份,2024-04-03,9296
3312,弘憶股,16,0,16,凱基-頭份,2024-04-03,9296
1316,上曜,16,0,16,凱基-頭份,2024-04-03,9296
2892,第一金,15,0,15,凱基-頭份,2024-04-03,9296
00720B,元大投資級公司債,18,3,15,凱基-頭份,2024-04-03,9296
1101,台泥,22,8,14,凱基-頭份,2024-04-03,9296
2002,中鋼,26,12,14,凱基-頭份,2024-04-03,9296
2440,太空梭,13,0,13,凱基-頭份,2024-04-03,9296
8033,雷虎,14,1,13,凱基-頭份,2024-04-03,9296
00679B,元大美債20年,12,0,12,凱基-頭份,2024-04-03,9296
2301,光寶科,13,1,12,凱基-頭份,2024-04-03,9296
2489,瑞軒,12,0,12,凱基-頭份,2024-04-03,9296
5443,均豪,26,14,12,凱基-頭份,2024-04-03,9296
00919,群益台灣精選高息,12,1,11,凱基-頭份,2024-04-03,9296
2884,玉山金,10,0,10,凱基-頭份,2024-04-03,9296
00878,國泰永續高股息,11,1,10,凱基-頭份,2024-04-03,9296
2317,鴻海,16,6,10,凱基-頭份,2024-04-03,9296
1582,信錦,13,3,10,凱基-頭份,2024-04-03,9296
2332,友訊,10,0,10,凱基-頭份,2024-04-03,9296
2888,新光金,10,0,10,凱基-頭份,2024-04-03,9296
00665L,富邦�琤肭磪囓�2,10,0,10,凱基-頭份,2024-04-03,9296
00753L,中信中國50正2,10,0,10,凱基-頭份,2024-04-03,9296
1809,中釉,20,10,10,凱基-頭份,2024-04-03,9296
3036,文曄,10,0,10,凱基-頭份,2024-04-03,9296
4157,太景*-KY,10,0,10,凱基-頭份,2024-04-03,9296
4906,正文,9,0,9,凱基-頭份,2024-04-03,9296
8112,至上,10,1,9,凱基-頭份,2024-04-03,9296
2809,京城銀,13,4,9,凱基-頭份,2024-04-03,9296
00751B,元大AAA至A公司債,8,0,8,凱基-頭份,2024-04-03,9296
2382,廣達,15,9,6,凱基-頭份,2024-04-03,9296
00927,群益半導體收益,6,0,6,凱基-頭份,2024-04-03,9296
00772B,中信高評級公司債,6,0,6,凱基-頭份,2024-04-03,9296
4953,緯軟,6,0,6,凱基-頭份,2024-04-03,9296
6271,同欣電,6,0,6,凱基-頭份,2024-04-03,9296
3025,星通,7,2,5,凱基-頭份,2024-04-03,9296
1514,亞力,5,0,5,凱基-頭份,2024-04-03,9296
2417,圓剛,5,0,5,凱基-頭份,2024-04-03,9296
00712,復華富時不動產,5,0,5,凱基-頭份,2024-04-03,9296
2845,遠東銀,5,0,5,凱基-頭份,2024-04-03,9296
6214,精誠,5,0,5,凱基-頭份,2024-04-03,9296
00929,復華台灣科技優息,895,1,894,凱基-頭份,2024-04-08,9296
00712,復華富時不動產,120,0,120,凱基-頭份,2024-04-08,9296
2520,冠德,110,0,110,凱基-頭份,2024-04-08,9296
00919,群益台灣精選高息,64,6,58,凱基-頭份,2024-04-08,9296
00680L,元大美債20正2,41,0,41,凱基-頭份,2024-04-08,9296
00940,元大台灣價值高息,90,55,35,凱基-頭份,2024-04-08,9296
8054,安國,34,2,32,凱基-頭份,2024-04-08,9296
00679B,元大美債20年,31,1,30,凱基-頭份,2024-04-08,9296
6189,豐藝,29,1,28,凱基-頭份,2024-04-08,9296
00941,中信上游半導體,27,0,27,凱基-頭份,2024-04-08,9296
3710,連展投控,20,0,20,凱基-頭份,2024-04-08,9296
2031,新光鋼,20,0,20,凱基-頭份,2024-04-08,9296
00939,統一台灣高息動能,20,0,20,凱基-頭份,2024-04-08,9296
2356,英業達,23,6,17,凱基-頭份,2024-04-08,9296
2354,鴻準,15,2,13,凱基-頭份,2024-04-08,9296
2516,新建,12,0,12,凱基-頭份,2024-04-08,9296
6120,達運,44,32,12,凱基-頭份,2024-04-08,9296
5426,振發,18,7,11,凱基-頭份,2024-04-08,9296
00857B,永豐20年美公債,11,0,11,凱基-頭份,2024-04-08,9296
00733,富邦臺灣中小,11,0,11,凱基-頭份,2024-04-08,9296
2371,大同,13,3,10,凱基-頭份,2024-04-08,9296
00673R,期元大S＆P原油反1,10,0,10,凱基-頭份,2024-04-08,9296
00878,國泰永續高股息,12,2,10,凱基-頭份,2024-04-08,9296
6451,訊芯-KY,9,0,9,凱基-頭份,2024-04-08,9296
4960,誠美材,10,1,9,凱基-頭份,2024-04-08,9296
3032,偉訓,20,11,9,凱基-頭份,2024-04-08,9296
6492,生華科,8,0,8,凱基-頭份,2024-04-08,9296
6026,福邦證,7,0,7,凱基-頭份,2024-04-08,9296
2492,華新科,11,4,7,凱基-頭份,2024-04-08,9296
2359,所羅門,15,8,7,凱基-頭份,2024-04-08,9296
2025,千興,6,0,6,凱基-頭份,2024-04-08,9296
5230,雷笛克光學,6,0,6,凱基-頭份,2024-04-08,9296
2501,國建,7,1,6,凱基-頭份,2024-04-08,9296
3707,漢磊,8,2,6,凱基-頭份,2024-04-08,9296
8096,擎亞,9,4,5,凱基-頭份,2024-04-08,9296
00713,元大台灣高息低波,5,0,5,凱基-頭份,2024-04-08,9296
3176,基亞,5,0,5,凱基-頭份,2024-04-08,9296
3311,閎暉,5,0,5,凱基-頭份,2024-04-08,9296
4979,華星光,5,0,5,凱基-頭份,2024-04-08,9296
4561,健椿,5,0,5,凱基-頭份,2024-04-08,9296
6173,信昌電,5,0,5,凱基-頭份,2024-04-08,9296
1513,中興電,20,15,5,凱基-頭份,2024-04-08,9296
2888,新光金,9,5,4,凱基-頭份,2024-04-08,9296
2401,凌陽,4,0,4,凱基-頭份,2024-04-08,9296
4714,永捷,7,3,4,凱基-頭份,2024-04-08,9296
6462,神盾,7,3,4,凱基-頭份,2024-04-08,9296
8064,東捷,15,11,4,凱基-頭份,2024-04-08,9296
00632R,元大台灣50反1,4,0,4,凱基-頭份,2024-04-08,9296
1608,華榮,4,0,4,凱基-頭份,2024-04-08,9296
2063,世鎧,4,0,4,凱基-頭份,2024-04-08,9296
00940,元大台灣價值高息,133,0,133,凱基-頭份,2024-04-09,9296
00680L,元大美債20正2,70,0,70,凱基-頭份,2024-04-09,9296
6219,富旺,60,0,60,凱基-頭份,2024-04-09,9296
00941,中信上游半導體,60,6,54,凱基-頭份,2024-04-09,9296
00929,復華台灣科技優息,50,0,50,凱基-頭份,2024-04-09,9296
4414,如興,39,0,39,凱基-頭份,2024-04-09,9296
3049,精金,38,0,38,凱基-頭份,2024-04-09,9296
6189,豐藝,37,1,36,凱基-頭份,2024-04-09,9296
8054,安國,36,2,34,凱基-頭份,2024-04-09,9296
4306,炎洲,31,0,31,凱基-頭份,2024-04-09,9296
8093,保銳,26,0,26,凱基-頭份,2024-04-09,9296
00939,統一台灣高息動能,22,0,22,凱基-頭份,2024-04-09,9296
2363,矽統,76,57,19,凱基-頭份,2024-04-09,9296
00673R,期元大S＆P原油反1,18,0,18,凱基-頭份,2024-04-09,9296
2371,大同,19,4,15,凱基-頭份,2024-04-09,9296
3064,泰偉,15,0,15,凱基-頭份,2024-04-09,9296
3555,博士旺,14,0,14,凱基-頭份,2024-04-09,9296
2303,聯電,16,3,13,凱基-頭份,2024-04-09,9296
4960,誠美材,15,2,13,凱基-頭份,2024-04-09,9296
5347,世界,13,0,13,凱基-頭份,2024-04-09,9296
2547,日勝生,12,0,12,凱基-頭份,2024-04-09,9296
00664R,國泰臺灣加權反1,12,0,12,凱基-頭份,2024-04-09,9296
1608,華榮,13,1,12,凱基-頭份,2024-04-09,9296
00937B,群益ESG投等債20,13,1,12,凱基-頭份,2024-04-09,9296
2516,新建,16,5,11,凱基-頭份,2024-04-09,9296
3052,夆典,10,0,10,凱基-頭份,2024-04-09,9296
3576,聯合再生,10,0,10,凱基-頭份,2024-04-09,9296
4714,永捷,16,6,10,凱基-頭份,2024-04-09,9296
6188,廣明,15,5,10,凱基-頭份,2024-04-09,9296
00898,國泰基因免疫革命,10,0,10,凱基-頭份,2024-04-09,9296
00922,國泰台灣領袖50,10,0,10,凱基-頭份,2024-04-09,9296
2915,潤泰全,10,0,10,凱基-頭份,2024-04-09,9296
6733,博晟生醫,10,0,10,凱基-頭份,2024-04-09,9296
2201,裕隆,10,0,10,凱基-頭份,2024-04-09,9296
3231,緯創,20,10,10,凱基-頭份,2024-04-09,9296
00919,群益台灣精選高息,12,3,9,凱基-頭份,2024-04-09,9296
2464,盟立,10,1,9,凱基-頭份,2024-04-09,9296
00878,國泰永續高股息,15,6,9,凱基-頭份,2024-04-09,9296
6213,聯茂,10,1,9,凱基-頭份,2024-04-09,9296
2313,華通,11,3,8,凱基-頭份,2024-04-09,9296
5230,雷笛克光學,8,0,8,凱基-頭份,2024-04-09,9296
3014,聯陽,8,0,8,凱基-頭份,2024-04-09,9296
6546,正基,10,2,8,凱基-頭份,2024-04-09,9296
2329,華泰,7,0,7,凱基-頭份,2024-04-09,9296
2367,燿華,8,1,7,凱基-頭份,2024-04-09,9296
2374,佳能,7,0,7,凱基-頭份,2024-04-09,9296
8011,台通,7,0,7,凱基-頭份,2024-04-09,9296
1733,五鼎,9,2,7,凱基-頭份,2024-04-09,9296
00733,富邦臺灣中小,7,0,7,凱基-頭份,2024-04-09,9296
1305,華夏,6,0,6,凱基-頭份,2024-04-09,9296
2890,永豐金,40,0,40,凱基-頭份,2024-04-10,9296
00927,群益半導體收益,34,0,34,凱基-頭份,2024-04-10,9296
3576,聯合再生,42,8,34,凱基-頭份,2024-04-10,9296
3597,映興,32,0,32,凱基-頭份,2024-04-10,9296
2014,中鴻,33,5,28,凱基-頭份,2024-04-10,9296
00919,群益台灣精選高息,28,2,26,凱基-頭份,2024-04-10,9296
2303,聯電,41,15,26,凱基-頭份,2024-04-10,9296
6443,元晶,30,7,23,凱基-頭份,2024-04-10,9296
2834,臺企銀,23,2,21,凱基-頭份,2024-04-10,9296
2882,國泰金,20,1,19,凱基-頭份,2024-04-10,9296
6016,康和證,18,0,18,凱基-頭份,2024-04-10,9296
2881,富邦金,16,0,16,凱基-頭份,2024-04-10,9296
1316,上曜,16,0,16,凱基-頭份,2024-04-10,9296
3704,合勤控,16,0,16,凱基-頭份,2024-04-10,9296
2427,三商電,21,8,13,凱基-頭份,2024-04-10,9296
2887,台新金,13,0,13,凱基-頭份,2024-04-10,9296
8033,雷虎,17,4,13,凱基-頭份,2024-04-10,9296
6125,廣運,20,8,12,凱基-頭份,2024-04-10,9296
8403,盛弘,12,0,12,凱基-頭份,2024-04-10,9296
0056,元大高股息,26,14,12,凱基-頭份,2024-04-10,9296
00937B,群益ESG投等債20,17,7,10,凱基-頭份,2024-04-10,9296
1459,聯發,10,0,10,凱基-頭份,2024-04-10,9296
2542,興富發,10,0,10,凱基-頭份,2024-04-10,9296
3294,英濟,17,7,10,凱基-頭份,2024-04-10,9296
4402,郡都開發,10,0,10,凱基-頭份,2024-04-10,9296
8358,金居,10,0,10,凱基-頭份,2024-04-10,9296
8383,千附,10,0,10,凱基-頭份,2024-04-10,9296
2515,中工,11,2,9,凱基-頭份,2024-04-10,9296
2540,愛山林,17,8,9,凱基-頭份,2024-04-10,9296
2516,新建,10,2,8,凱基-頭份,2024-04-10,9296
4979,華星光,11,3,8,凱基-頭份,2024-04-10,9296
2883,凱基金,8,0,8,凱基-頭份,2024-04-10,9296
6668,中揚光,7,0,7,凱基-頭份,2024-04-10,9296
00878,國泰永續高股息,12,5,7,凱基-頭份,2024-04-10,9296
1608,華榮,19,13,6,凱基-頭份,2024-04-10,9296
6188,廣明,8,2,6,凱基-頭份,2024-04-10,9296
6189,豐藝,6,0,6,凱基-頭份,2024-04-10,9296
1808,潤隆,5,0,5,凱基-頭份,2024-04-10,9296
2402,毅嘉,5,0,5,凱基-頭份,2024-04-10,9296
2417,圓剛,5,0,5,凱基-頭份,2024-04-10,9296
2441,超豐,5,0,5,凱基-頭份,2024-04-10,9296
3088,艾訊,5,0,5,凱基-頭份,2024-04-10,9296
8155,博智,5,0,5,凱基-頭份,2024-04-10,9296
2308,台達電,4,0,4,凱基-頭份,2024-04-10,9296
6215,和椿,12,8,4,凱基-頭份,2024-04-10,9296
1535,中宇,4,0,4,凱基-頭份,2024-04-10,9296
1609,大亞,27,23,4,凱基-頭份,2024-04-10,9296
1615,大山,4,0,4,凱基-頭份,2024-04-10,9296
1734,杏輝,4,0,4,凱基-頭份,2024-04-10,9296
8069,元太,6,2,4,凱基-頭份,2024-04-10,9296
3049,精金,150,0,150,凱基-頭份,2024-04-11,9296
00687B,國泰20年美債,58,0,58,凱基-頭份,2024-04-11,9296
3481,群創,55,1,54,凱基-頭份,2024-04-11,9296
00650L,復華香港正2,50,0,50,凱基-頭份,2024-04-11,9296
2031,新光鋼,50,0,50,凱基-頭份,2024-04-11,9296
00940,元大台灣價值高息,61,12,49,凱基-頭份,2024-04-11,9296
2630,亞航,46,6,40,凱基-頭份,2024-04-11,9296
00680L,元大美債20正2,34,0,34,凱基-頭份,2024-04-11,9296
00679B,元大美債20年,30,0,30,凱基-頭份,2024-04-11,9296
2888,新光金,30,0,30,凱基-頭份,2024-04-11,9296
6117,迎廣,34,4,30,凱基-頭份,2024-04-11,9296
00929,復華台灣科技優息,47,21,26,凱基-頭份,2024-04-11,9296
00939,統一台灣高息動能,31,7,24,凱基-頭份,2024-04-11,9296
2605,新興,21,0,21,凱基-頭份,2024-04-11,9296
0056,元大高股息,28,8,20,凱基-頭份,2024-04-11,9296
00937B,群益ESG投等債20,19,0,19,凱基-頭份,2024-04-11,9296
3013,晟銘電,23,6,17,凱基-頭份,2024-04-11,9296
00878,國泰永續高股息,19,4,15,凱基-頭份,2024-04-11,9296
2501,國建,28,13,15,凱基-頭份,2024-04-11,9296
3597,映興,14,0,14,凱基-頭份,2024-04-11,9296
00919,群益台灣精選高息,23,10,13,凱基-頭份,2024-04-11,9296
00751B,元大AAA至A公司債,12,0,12,凱基-頭份,2024-04-11,9296
00715L,期街口布蘭特正2,12,0,12,凱基-頭份,2024-04-11,9296
3686,達能,12,0,12,凱基-頭份,2024-04-11,9296
6120,達運,12,0,12,凱基-頭份,2024-04-11,9296
6125,廣運,12,0,12,凱基-頭份,2024-04-11,9296
00882,中信中國高股息,13,2,11,凱基-頭份,2024-04-11,9296
00720B,元大投資級公司債,11,0,11,凱基-頭份,2024-04-11,9296
1316,上曜,12,1,11,凱基-頭份,2024-04-11,9296
1605,華新,13,2,11,凱基-頭份,2024-04-11,9296
3704,合勤控,11,0,11,凱基-頭份,2024-04-11,9296
8926,台汽電,10,0,10,凱基-頭份,2024-04-11,9296
00632R,元大台灣50反1,10,0,10,凱基-頭份,2024-04-11,9296
1467,南緯,10,0,10,凱基-頭份,2024-04-11,9296
1702,南僑,10,0,10,凱基-頭份,2024-04-11,9296
2431,聯昌,10,0,10,凱基-頭份,2024-04-11,9296
4167,松瑞藥,10,0,10,凱基-頭份,2024-04-11,9296
3167,大量,9,0,9,凱基-頭份,2024-04-11,9296
00673R,期元大S＆P原油反1,9,0,9,凱基-頭份,2024-04-11,9296
2634,漢翔,10,1,9,凱基-頭份,2024-04-11,9296
6742,澤米,9,0,9,凱基-頭份,2024-04-11,9296
5534,長虹,10,1,9,凱基-頭份,2024-04-11,9296
9958,世紀鋼,8,0,8,凱基-頭份,2024-04-11,9296
3231,緯創,20,12,8,凱基-頭份,2024-04-11,9296
2301,光寶科,10,2,8,凱基-頭份,2024-04-11,9296
2464,盟立,10,2,8,凱基-頭份,2024-04-11,9296
3052,夆典,8,0,8,凱基-頭份,2024-04-11,9296
3260,威剛,13,5,8,凱基-頭份,2024-04-11,9296
3712,永崴投控,10,2,8,凱基-頭份,2024-04-11,9296
3321,同泰,11,4,7,凱基-頭份,2024-04-11,9296
2501,國建,124,16,108,凱基-頭份,2024-04-12,9296
00940,元大台灣價值高息,91,8,83,凱基-頭份,2024-04-12,9296
3481,群創,56,12,44,凱基-頭份,2024-04-12,9296
00937B,群益ESG投等債20,41,0,41,凱基-頭份,2024-04-12,9296
2527,宏璟,40,0,40,凱基-頭份,2024-04-12,9296
00941,中信上游半導體,34,0,34,凱基-頭份,2024-04-12,9296
3287,廣寰科,31,0,31,凱基-頭份,2024-04-12,9296
2882,國泰金,28,0,28,凱基-頭份,2024-04-12,9296
00687B,國泰20年美債,26,2,24,凱基-頭份,2024-04-12,9296
8054,安國,29,8,21,凱基-頭份,2024-04-12,9296
2363,矽統,138,117,21,凱基-頭份,2024-04-12,9296
1314,中石化,20,0,20,凱基-頭份,2024-04-12,9296
1809,中釉,20,0,20,凱基-頭份,2024-04-12,9296
6120,達運,20,0,20,凱基-頭份,2024-04-12,9296
2883,凱基金,18,0,18,凱基-頭份,2024-04-12,9296
0056,元大高股息,16,0,16,凱基-頭份,2024-04-12,9296
00680L,元大美債20正2,16,0,16,凱基-頭份,2024-04-12,9296
00679B,元大美債20年,16,0,16,凱基-頭份,2024-04-12,9296
2888,新光金,14,0,14,凱基-頭份,2024-04-12,9296
2427,三商電,12,0,12,凱基-頭份,2024-04-12,9296
00665L,富邦�琤肭磪囓�2,11,0,11,凱基-頭份,2024-04-12,9296
6770,力積電,13,2,11,凱基-頭份,2024-04-12,9296
3033,威健,10,0,10,凱基-頭份,2024-04-12,9296
00753L,中信中國50正2,10,0,10,凱基-頭份,2024-04-12,9296
00923,群益台ESG低碳50,10,0,10,凱基-頭份,2024-04-12,9296
2353,宏��,12,2,10,凱基-頭份,2024-04-12,9296
2441,超豐,10,0,10,凱基-頭份,2024-04-12,9296
6015,宏遠證,10,0,10,凱基-頭份,2024-04-12,9296
8105,凌巨,10,0,10,凱基-頭份,2024-04-12,9296
00915,凱基優選高股息30,11,2,9,凱基-頭份,2024-04-12,9296
2101,南港,9,0,9,凱基-頭份,2024-04-12,9296
2329,華泰,11,2,9,凱基-頭份,2024-04-12,9296
2344,華邦電,9,0,9,凱基-頭份,2024-04-12,9296
2515,中工,9,0,9,凱基-頭份,2024-04-12,9296
2618,長榮航,10,1,9,凱基-頭份,2024-04-12,9296
00933B,國泰10Y+金融債,8,0,8,凱基-頭份,2024-04-12,9296
2892,第一金,7,0,7,凱基-頭份,2024-04-12,9296
5381,合正,7,0,7,凱基-頭份,2024-04-12,9296
5443,均豪,7,0,7,凱基-頭份,2024-04-12,9296
00751B,元大AAA至A公司債,6,0,6,凱基-頭份,2024-04-12,9296
1618,合機,16,10,6,凱基-頭份,2024-04-12,9296
2105,正新,6,0,6,凱基-頭份,2024-04-12,9296
2610,華航,11,5,6,凱基-頭份,2024-04-12,9296
3706,神達,6,0,6,凱基-頭份,2024-04-12,9296
5534,長虹,6,0,6,凱基-頭份,2024-04-12,9296
2317,鴻海,8,2,6,凱基-頭份,2024-04-12,9296
2409,友達,9,4,5,凱基-頭份,2024-04-12,9296
2002,中鋼,7,2,5,凱基-頭份,2024-04-12,9296
1447,力鵬,5,0,5,凱基-頭份,2024-04-12,9296
2328,廣宇,5,0,5,凱基-頭份,2024-04-12,9296
00940,元大台灣價值高息,115,1,114,凱基-頭份,2024-04-15,9296
00715L,期街口布蘭特正2,111,5,106,凱基-頭份,2024-04-15,9296
1504,東元,134,36,98,凱基-頭份,2024-04-15,9296
00939,統一台灣高息動能,96,2,94,凱基-頭份,2024-04-15,9296
2867,三商壽,64,0,64,凱基-頭份,2024-04-15,9296
2103,台橡,40,0,40,凱基-頭份,2024-04-15,9296
2605,新興,40,1,39,凱基-頭份,2024-04-15,9296
2371,大同,112,75,37,凱基-頭份,2024-04-15,9296
0056,元大高股息,36,5,31,凱基-頭份,2024-04-15,9296
6505,台塑化,30,0,30,凱基-頭份,2024-04-15,9296
3576,聯合再生,22,0,22,凱基-頭份,2024-04-15,9296
00632R,元大台灣50反1,25,4,21,凱基-頭份,2024-04-15,9296
1809,中釉,20,0,20,凱基-頭份,2024-04-15,9296
1605,華新,171,153,18,凱基-頭份,2024-04-15,9296
2442,新美齊,18,0,18,凱基-頭份,2024-04-15,9296
2501,國建,21,3,18,凱基-頭份,2024-04-15,9296
2101,南港,20,4,16,凱基-頭份,2024-04-15,9296
1609,大亞,40,24,16,凱基-頭份,2024-04-15,9296
2836,高雄銀,15,0,15,凱基-頭份,2024-04-15,9296
00919,群益台灣精選高息,34,19,15,凱基-頭份,2024-04-15,9296
2634,漢翔,17,4,13,凱基-頭份,2024-04-15,9296
1513,中興電,74,61,13,凱基-頭份,2024-04-15,9296
5425,台半,12,0,12,凱基-頭份,2024-04-15,9296
2009,第一銅,15,4,11,凱基-頭份,2024-04-15,9296
00909,國泰數位支付服務,11,0,11,凱基-頭份,2024-04-15,9296
00878,國泰永續高股息,12,1,11,凱基-頭份,2024-04-15,9296
00710B,復華彭博非投等債,10,0,10,凱基-頭份,2024-04-15,9296
00680L,元大美債20正2,10,0,10,凱基-頭份,2024-04-15,9296
00665L,富邦�琤肭磪囓�2,10,0,10,凱基-頭份,2024-04-15,9296
00753L,中信中國50正2,10,0,10,凱基-頭份,2024-04-15,9296
00900,富邦特選高股息30,10,0,10,凱基-頭份,2024-04-15,9296
2038,海光,10,0,10,凱基-頭份,2024-04-15,9296
2367,燿華,11,1,10,凱基-頭份,2024-04-15,9296
2527,宏璟,10,0,10,凱基-頭份,2024-04-15,9296
2630,亞航,16,6,10,凱基-頭份,2024-04-15,9296
6117,迎廣,11,1,10,凱基-頭份,2024-04-15,9296
6189,豐藝,10,0,10,凱基-頭份,2024-04-15,9296
2348,海悅,9,0,9,凱基-頭份,2024-04-15,9296
00891,中信關鍵半導體,8,0,8,凱基-頭份,2024-04-15,9296
1612,宏泰,13,5,8,凱基-頭份,2024-04-15,9296
2636,台驊控股,20,12,8,凱基-頭份,2024-04-15,9296
2834,臺企銀,12,4,8,凱基-頭份,2024-04-15,9296
6120,達運,8,0,8,凱基-頭份,2024-04-15,9296
2882,國泰金,7,0,7,凱基-頭份,2024-04-15,9296
00918,大華優利高填息30,12,5,7,凱基-頭份,2024-04-15,9296
00934,中信成長高股息,15,8,7,凱基-頭份,2024-04-15,9296
2618,長榮航,7,0,7,凱基-頭份,2024-04-15,9296
3704,合勤控,8,1,7,凱基-頭份,2024-04-15,9296
5351,鈺創,10,3,7,凱基-頭份,2024-04-15,9296
8096,擎亞,8,1,7,凱基-頭份,2024-04-15,9296
2867,三商壽,2008,8,2000,凱基-頭份,2024-04-16,9296
00919,群益台灣精選高息,220,25,195,凱基-頭份,2024-04-16,9296
00940,元大台灣價值高息,192,98,94,凱基-頭份,2024-04-16,9296
00878,國泰永續高股息,89,1,88,凱基-頭份,2024-04-16,9296
0056,元大高股息,77,14,63,凱基-頭份,2024-04-16,9296
2888,新光金,62,0,62,凱基-頭份,2024-04-16,9296
2323,中環,61,0,61,凱基-頭份,2024-04-16,9296
00939,統一台灣高息動能,75,20,55,凱基-頭份,2024-04-16,9296
2101,南港,55,3,52,凱基-頭份,2024-04-16,9296
00937B,群益ESG投等債20,51,0,51,凱基-頭份,2024-04-16,9296
1314,中石化,50,0,50,凱基-頭份,2024-04-16,9296
1101,台泥,45,5,40,凱基-頭份,2024-04-16,9296
00680L,元大美債20正2,39,0,39,凱基-頭份,2024-04-16,9296
2303,聯電,37,2,35,凱基-頭份,2024-04-16,9296
2527,宏璟,30,0,30,凱基-頭份,2024-04-16,9296
2834,臺企銀,25,0,25,凱基-頭份,2024-04-16,9296
3013,晟銘電,26,1,25,凱基-頭份,2024-04-16,9296
6288,聯嘉,25,0,25,凱基-頭份,2024-04-16,9296
2883,凱基金,25,1,24,凱基-頭份,2024-04-16,9296
00941,中信上游半導體,23,0,23,凱基-頭份,2024-04-16,9296
00687B,國泰20年美債,24,2,22,凱基-頭份,2024-04-16,9296
6120,達運,22,0,22,凱基-頭份,2024-04-16,9296
2402,毅嘉,22,2,20,凱基-頭份,2024-04-16,9296
6219,富旺,20,0,20,凱基-頭份,2024-04-16,9296
1504,東元,25,7,18,凱基-頭份,2024-04-16,9296
2009,第一銅,17,1,16,凱基-頭份,2024-04-16,9296
2105,正新,36,20,16,凱基-頭份,2024-04-16,9296
6186,新潤,15,0,15,凱基-頭份,2024-04-16,9296
8112,至上,15,1,14,凱基-頭份,2024-04-16,9296
00733,富邦臺灣中小,13,0,13,凱基-頭份,2024-04-16,9296
2890,永豐金,14,2,12,凱基-頭份,2024-04-16,9296
3704,合勤控,12,1,11,凱基-頭份,2024-04-16,9296
00712,復華富時不動產,11,0,11,凱基-頭份,2024-04-16,9296
5871,中租-KY,11,0,11,凱基-頭份,2024-04-16,9296
2440,太空梭,11,0,11,凱基-頭份,2024-04-16,9296
3231,緯創,12,1,11,凱基-頭份,2024-04-16,9296
3706,神達,13,2,11,凱基-頭份,2024-04-16,9296
5425,台半,11,0,11,凱基-頭份,2024-04-16,9296
2329,華泰,12,1,11,凱基-頭份,2024-04-16,9296
2884,玉山金,11,1,10,凱基-頭份,2024-04-16,9296
00637L,元大滬深300正2,10,0,10,凱基-頭份,2024-04-16,9296
1584,精剛,11,1,10,凱基-頭份,2024-04-16,9296
1905,華紙,10,0,10,凱基-頭份,2024-04-16,9296
00933B,國泰10Y+金融債,11,2,9,凱基-頭份,2024-04-16,9296
1612,宏泰,15,6,9,凱基-頭份,2024-04-16,9296
5880,合庫金,8,0,8,凱基-頭份,2024-04-16,9296
2885,元大金,8,0,8,凱基-頭份,2024-04-16,9296
2836,高雄銀,10,2,8,凱基-頭份,2024-04-16,9296
2892,第一金,7,0,7,凱基-頭份,2024-04-16,9296
2886,兆豐金,7,0,7,凱基-頭份,2024-04-16,9296
2867,三商壽,915,3,912,凱基-頭份,2024-04-17,9296
2501,國建,401,124,277,凱基-頭份,2024-04-17,9296
00632R,元大台灣50反1,252,15,237,凱基-頭份,2024-04-17,9296
2882,國泰金,212,100,112,凱基-頭份,2024-04-17,9296
00929,復華台灣科技優息,95,4,91,凱基-頭份,2024-04-17,9296
00712,復華富時不動產,58,0,58,凱基-頭份,2024-04-17,9296
6188,廣明,50,0,50,凱基-頭份,2024-04-17,9296
0056,元大高股息,49,0,49,凱基-頭份,2024-04-17,9296
00905,FT臺灣Smart,35,0,35,凱基-頭份,2024-04-17,9296
00878,國泰永續高股息,34,3,31,凱基-頭份,2024-04-17,9296
2610,華航,31,0,31,凱基-頭份,2024-04-17,9296
00857B,永豐20年美公債,27,0,27,凱基-頭份,2024-04-17,9296
4534,慶騰,25,0,25,凱基-頭份,2024-04-17,9296
00937B,群益ESG投等債20,25,0,25,凱基-頭份,2024-04-17,9296
00941,中信上游半導體,24,0,24,凱基-頭份,2024-04-17,9296
1605,華新,30,7,23,凱基-頭份,2024-04-17,9296
2371,大同,48,26,22,凱基-頭份,2024-04-17,9296
2401,凌陽,22,1,21,凱基-頭份,2024-04-17,9296
00720B,元大投資級公司債,19,0,19,凱基-頭份,2024-04-17,9296
00687B,國泰20年美債,37,20,17,凱基-頭份,2024-04-17,9296
2459,敦吉,16,0,16,凱基-頭份,2024-04-17,9296
00679B,元大美債20年,14,1,13,凱基-頭份,2024-04-17,9296
1305,華夏,13,0,13,凱基-頭份,2024-04-17,9296
2356,英業達,17,4,13,凱基-頭份,2024-04-17,9296
2630,亞航,22,9,13,凱基-頭份,2024-04-17,9296
2317,鴻海,22,10,12,凱基-頭份,2024-04-17,9296
1802,台玻,12,0,12,凱基-頭份,2024-04-17,9296
2330,台積電,12,1,11,凱基-頭份,2024-04-17,9296
00923,群益台ESG低碳50,10,0,10,凱基-頭份,2024-04-17,9296
2379,瑞昱,10,0,10,凱基-頭份,2024-04-17,9296
3481,群創,10,0,10,凱基-頭份,2024-04-17,9296
4303,信立,11,1,10,凱基-頭份,2024-04-17,9296
6219,富旺,10,0,10,凱基-頭份,2024-04-17,9296
8064,東捷,20,10,10,凱基-頭份,2024-04-17,9296
1785,光洋科,11,2,9,凱基-頭份,2024-04-17,9296
2634,漢翔,13,4,9,凱基-頭份,2024-04-17,9296
00933B,國泰10Y+金融債,6,0,6,凱基-頭份,2024-04-17,9296
1587,吉茂,11,5,6,凱基-頭份,2024-04-17,9296
5434,崇越,8,2,6,凱基-頭份,2024-04-17,9296
6285,啟��,6,0,6,凱基-頭份,2024-04-17,9296
6788,華景電,7,1,6,凱基-頭份,2024-04-17,9296
3704,合勤控,13,7,6,凱基-頭份,2024-04-17,9296
6117,迎廣,5,0,5,凱基-頭份,2024-04-17,9296
00680L,元大美債20正2,5,0,5,凱基-頭份,2024-04-17,9296
1316,上曜,10,5,5,凱基-頭份,2024-04-17,9296
2405,輔信,8,3,5,凱基-頭份,2024-04-17,9296
2464,盟立,6,1,5,凱基-頭份,2024-04-17,9296
2486,一詮,6,1,5,凱基-頭份,2024-04-17,9296
3689,湧德,5,0,5,凱基-頭份,2024-04-17,9296
6275,元山,5,0,5,凱基-頭份,2024-04-17,9296
3481,群創,220,5,215,凱基-頭份,2024-04-18,9296
2371,大同,86,48,38,凱基-頭份,2024-04-18,9296
2317,鴻海,45,7,38,凱基-頭份,2024-04-18,9296
2515,中工,59,27,32,凱基-頭份,2024-04-18,9296
2882,國泰金,30,0,30,凱基-頭份,2024-04-18,9296
2308,台達電,27,2,25,凱基-頭份,2024-04-18,9296
2504,國產,43,20,23,凱基-頭份,2024-04-18,9296
2374,佳能,30,10,20,凱基-頭份,2024-04-18,9296
6226,光鼎,20,0,20,凱基-頭份,2024-04-18,9296
3707,漢磊,23,4,19,凱基-頭份,2024-04-18,9296
1504,東元,79,61,18,凱基-頭份,2024-04-18,9296
3015,全漢,18,0,18,凱基-頭份,2024-04-18,9296
0056,元大高股息,17,0,17,凱基-頭份,2024-04-18,9296
00712,復華富時不動產,15,0,15,凱基-頭份,2024-04-18,9296
2834,臺企銀,12,0,12,凱基-頭份,2024-04-18,9296
00679B,元大美債20年,12,0,12,凱基-頭份,2024-04-18,9296
8054,安國,21,9,12,凱基-頭份,2024-04-18,9296
00687B,國泰20年美債,11,0,11,凱基-頭份,2024-04-18,9296
2103,台橡,11,0,11,凱基-頭份,2024-04-18,9296
2337,旺宏,11,0,11,凱基-頭份,2024-04-18,9296
2367,燿華,16,5,11,凱基-頭份,2024-04-18,9296
00632R,元大台灣50反1,10,0,10,凱基-頭份,2024-04-18,9296
00857B,永豐20年美公債,10,0,10,凱基-頭份,2024-04-18,9296
1528,恩德,10,0,10,凱基-頭份,2024-04-18,9296
2101,南港,10,0,10,凱基-頭份,2024-04-18,9296
2105,正新,10,0,10,凱基-頭份,2024-04-18,9296
4934,太極,10,0,10,凱基-頭份,2024-04-18,9296
00878,國泰永續高股息,9,0,9,凱基-頭份,2024-04-18,9296
3413,京鼎,10,1,9,凱基-頭份,2024-04-18,9296
5388,中磊,10,1,9,凱基-頭份,2024-04-18,9296
00941,中信上游半導體,28,20,8,凱基-頭份,2024-04-18,9296
2329,華泰,22,14,8,凱基-頭份,2024-04-18,9296
2382,廣達,12,4,8,凱基-頭份,2024-04-18,9296
2442,新美齊,8,0,8,凱基-頭份,2024-04-18,9296
1609,大亞,25,18,7,凱基-頭份,2024-04-18,9296
3294,英濟,8,1,7,凱基-頭份,2024-04-18,9296
3706,神達,7,0,7,凱基-頭份,2024-04-18,9296
4142,國光生,10,3,7,凱基-頭份,2024-04-18,9296
6274,台燿,8,1,7,凱基-頭份,2024-04-18,9296
3231,緯創,18,11,7,凱基-頭份,2024-04-18,9296
00733,富邦臺灣中小,7,0,7,凱基-頭份,2024-04-18,9296
1513,中興電,31,25,6,凱基-頭份,2024-04-18,9296
2028,威致,6,0,6,凱基-頭份,2024-04-18,9296
2017,官田鋼,10,5,5,凱基-頭份,2024-04-18,9296
2409,友達,5,0,5,凱基-頭份,2024-04-18,9296
2505,國揚,5,0,5,凱基-頭份,2024-04-18,9296
2530,華建,5,0,5,凱基-頭份,2024-04-18,9296
2889,國票金,5,0,5,凱基-頭份,2024-04-18,9296
3083,網龍,5,0,5,凱基-頭份,2024-04-18,9296
3704,合勤控,14,9,5,凱基-頭份,2024-04-18,9296
00929,復華台灣科技優息,782,256,526,凱基-頭份,2024-04-19,9296
5515,建國,160,0,160,凱基-頭份,2024-04-19,9296
00878,國泰永續高股息,116,2,114,凱基-頭份,2024-04-19,9296
3703,欣陸,91,2,89,凱基-頭份,2024-04-19,9296
00940,元大台灣價值高息,112,23,89,凱基-頭份,2024-04-19,9296
0056,元大高股息,86,2,84,凱基-頭份,2024-04-19,9296
2427,三商電,97,19,78,凱基-頭份,2024-04-19,9296
00919,群益台灣精選高息,82,9,73,凱基-頭份,2024-04-19,9296
2630,亞航,69,4,65,凱基-頭份,2024-04-19,9296
2303,聯電,83,23,60,凱基-頭份,2024-04-19,9296
2520,冠德,59,10,49,凱基-頭份,2024-04-19,9296
2527,宏璟,47,0,47,凱基-頭份,2024-04-19,9296
2449,京元電子,48,3,45,凱基-頭份,2024-04-19,9296
2371,大同,227,194,33,凱基-頭份,2024-04-19,9296
2515,中工,81,51,30,凱基-頭份,2024-04-19,9296
2330,台積電,47,18,29,凱基-頭份,2024-04-19,9296
2548,華固,27,1,26,凱基-頭份,2024-04-19,9296
2338,光罩,25,0,25,凱基-頭份,2024-04-19,9296
4726,永昕,23,0,23,凱基-頭份,2024-04-19,9296
2547,日勝生,37,15,22,凱基-頭份,2024-04-19,9296
00715L,期街口布蘭特正2,30,9,21,凱基-頭份,2024-04-19,9296
2409,友達,22,1,21,凱基-頭份,2024-04-19,9296
2504,國產,25,4,21,凱基-頭份,2024-04-19,9296
00939,統一台灣高息動能,29,10,19,凱基-頭份,2024-04-19,9296
1612,宏泰,42,23,19,凱基-頭份,2024-04-19,9296
2610,華航,19,0,19,凱基-頭份,2024-04-19,9296
2887,台新金,14,0,14,凱基-頭份,2024-04-19,9296
00931B,統一美債20年,15,1,14,凱基-頭份,2024-04-19,9296
1608,華榮,186,172,14,凱基-頭份,2024-04-19,9296
5512,力麒,43,30,13,凱基-頭份,2024-04-19,9296
3030,德律,16,4,12,凱基-頭份,2024-04-19,9296
5230,雷笛克光學,18,6,12,凱基-頭份,2024-04-19,9296
1605,華新,20,9,11,凱基-頭份,2024-04-19,9296
3032,偉訓,11,0,11,凱基-頭份,2024-04-19,9296
00898,國泰基因免疫革命,10,0,10,凱基-頭份,2024-04-19,9296
00706L,期元大S＆P日圓正2,10,0,10,凱基-頭份,2024-04-19,9296
00941,中信上游半導體,10,0,10,凱基-頭份,2024-04-19,9296
2344,華邦電,15,5,10,凱基-頭份,2024-04-19,9296
3372,典範,10,0,10,凱基-頭份,2024-04-19,9296
00712,復華富時不動產,9,0,9,凱基-頭份,2024-04-19,9296
2331,精英,10,1,9,凱基-頭份,2024-04-19,9296
2401,凌陽,11,2,9,凱基-頭份,2024-04-19,9296
2388,威盛,10,2,8,凱基-頭份,2024-04-19,9296
1101,台泥,10,2,8,凱基-頭份,2024-04-19,9296
4906,正文,8,0,8,凱基-頭份,2024-04-19,9296
1326,台化,8,0,8,凱基-頭份,2024-04-19,9296
2886,兆豐金,7,0,7,凱基-頭份,2024-04-19,9296
00927,群益半導體收益,7,0,7,凱基-頭份,2024-04-19,9296
5425,台半,7,0,7,凱基-頭份,2024-04-19,9296
5529,鉅陞,7,0,7,凱基-頭份,2024-04-19,9296
00929,復華台灣科技優息,425,85,340,凱基-頭份,2024-04-22,9296
1608,華榮,222,93,129,凱基-頭份,2024-04-22,9296
3703,欣陸,163,47,116,凱基-頭份,2024-04-22,9296
00919,群益台灣精選高息,107,37,70,凱基-頭份,2024-04-22,9296
5515,建國,53,1,52,凱基-頭份,2024-04-22,9296
2520,冠德,50,1,49,凱基-頭份,2024-04-22,9296
00939,統一台灣高息動能,45,5,40,凱基-頭份,2024-04-22,9296
2427,三商電,31,5,26,凱基-頭份,2024-04-22,9296
3284,太普高,25,0,25,凱基-頭份,2024-04-22,9296
1504,東元,25,2,23,凱基-頭份,2024-04-22,9296
5230,雷笛克光學,39,17,22,凱基-頭份,2024-04-22,9296
2344,華邦電,24,6,18,凱基-頭份,2024-04-22,9296
5324,士開,18,0,18,凱基-頭份,2024-04-22,9296
5009,榮剛,17,0,17,凱基-頭份,2024-04-22,9296
3481,群創,18,1,17,凱基-頭份,2024-04-22,9296
0056,元大高股息,22,7,15,凱基-頭份,2024-04-22,9296
2409,友達,19,4,15,凱基-頭份,2024-04-22,9296
6541,泰福-KY,16,1,15,凱基-頭份,2024-04-22,9296
2303,聯電,15,2,13,凱基-頭份,2024-04-22,9296
2317,鴻海,13,0,13,凱基-頭份,2024-04-22,9296
1609,大亞,26,14,12,凱基-頭份,2024-04-22,9296
2537,聯上發,12,0,12,凱基-頭份,2024-04-22,9296
2548,華固,14,4,10,凱基-頭份,2024-04-22,9296
4532,瑞智,10,0,10,凱基-頭份,2024-04-22,9296
5529,鉅陞,10,0,10,凱基-頭份,2024-04-22,9296
6191,精成科,9,0,9,凱基-頭份,2024-04-22,9296
8438,昶昕,9,0,9,凱基-頭份,2024-04-22,9296
1612,宏泰,9,1,8,凱基-頭份,2024-04-22,9296
2543,皇昌,10,2,8,凱基-頭份,2024-04-22,9296
6189,豐藝,11,3,8,凱基-頭份,2024-04-22,9296
3231,緯創,13,6,7,凱基-頭份,2024-04-22,9296
8111,立��,6,0,6,凱基-頭份,2024-04-22,9296
6770,力積電,7,1,6,凱基-頭份,2024-04-22,9296
2338,光罩,5,0,5,凱基-頭份,2024-04-22,9296
2464,盟立,11,6,5,凱基-頭份,2024-04-22,9296
2505,國揚,5,0,5,凱基-頭份,2024-04-22,9296
8068,全達,5,0,5,凱基-頭份,2024-04-22,9296
8463,潤泰材,6,1,5,凱基-頭份,2024-04-22,9296
9935,慶豐富,5,0,5,凱基-頭份,2024-04-22,9296
00937B,群益ESG投等債20,4,0,4,凱基-頭份,2024-04-22,9296
00857B,永豐20年美公債,4,0,4,凱基-頭份,2024-04-22,9296
00752,中信中國50,5,1,4,凱基-頭份,2024-04-22,9296
1618,合機,9,5,4,凱基-頭份,2024-04-22,9296
2337,旺宏,4,0,4,凱基-頭份,2024-04-22,9296
2367,燿華,9,5,4,凱基-頭份,2024-04-22,9296
2379,瑞昱,5,1,4,凱基-頭份,2024-04-22,9296
3615,安可,4,0,4,凱基-頭份,2024-04-22,9296
3666,光耀,4,0,4,凱基-頭份,2024-04-22,9296
8027,鈦昇,4,0,4,凱基-頭份,2024-04-22,9296
1617,榮星,30,27,3,凱基-頭份,2024-04-22,9296
6264,富裔,65,0,65,凱基-頭份,2024-04-23,9296
00937B,群益ESG投等債20,57,0,57,凱基-頭份,2024-04-23,9296
00929,復華台灣科技優息,57,9,48,凱基-頭份,2024-04-23,9296
1504,東元,40,1,39,凱基-頭份,2024-04-23,9296
1101,台泥,31,0,31,凱基-頭份,2024-04-23,9296
2371,大同,70,39,31,凱基-頭份,2024-04-23,9296
2317,鴻海,26,0,26,凱基-頭份,2024-04-23,9296
2449,京元電子,29,3,26,凱基-頭份,2024-04-23,9296
2509,全坤建,21,0,21,凱基-頭份,2024-04-23,9296
00878,國泰永續高股息,20,6,14,凱基-頭份,2024-04-23,9296
2427,三商電,14,0,14,凱基-頭份,2024-04-23,9296
2515,中工,44,31,13,凱基-頭份,2024-04-23,9296
00919,群益台灣精選高息,10,0,10,凱基-頭份,2024-04-23,9296
00830,國泰費城半導體,10,0,10,凱基-頭份,2024-04-23,9296
1584,精剛,10,0,10,凱基-頭份,2024-04-23,9296
2002,中鋼,10,0,10,凱基-頭份,2024-04-23,9296
2323,中環,10,0,10,凱基-頭份,2024-04-23,9296
2409,友達,10,0,10,凱基-頭份,2024-04-23,9296
2520,冠德,10,0,10,凱基-頭份,2024-04-23,9296
4157,太景*-KY,10,0,10,凱基-頭份,2024-04-23,9296
5009,榮剛,33,23,10,凱基-頭份,2024-04-23,9296
6198,瑞築,10,0,10,凱基-頭份,2024-04-23,9296
3715,定穎投控,9,0,9,凱基-頭份,2024-04-23,9296
1513,中興電,32,23,9,凱基-頭份,2024-04-23,9296
2374,佳能,13,5,8,凱基-頭份,2024-04-23,9296
3535,晶彩科,7,0,7,凱基-頭份,2024-04-23,9296
6451,訊芯-KY,6,0,6,凱基-頭份,2024-04-23,9296
1605,華新,6,0,6,凱基-頭份,2024-04-23,9296
1316,上曜,55,50,5,凱基-頭份,2024-04-23,9296
1721,三晃,5,0,5,凱基-頭份,2024-04-23,9296
2105,正新,5,0,5,凱基-頭份,2024-04-23,9296
2459,敦吉,5,0,5,凱基-頭份,2024-04-23,9296
3024,憶聲,5,0,5,凱基-頭份,2024-04-23,9296
6120,達運,5,0,5,凱基-頭份,2024-04-23,9296
8222,寶一,5,0,5,凱基-頭份,2024-04-23,9296
9935,慶豐富,5,0,5,凱基-頭份,2024-04-23,9296
2801,彰銀,4,0,4,凱基-頭份,2024-04-23,9296
3231,緯創,4,0,4,凱基-頭份,2024-04-23,9296
2348,海悅,4,0,4,凱基-頭份,2024-04-23,9296
2605,新興,4,0,4,凱基-頭份,2024-04-23,9296
2731,雄獅,5,1,4,凱基-頭份,2024-04-23,9296
3615,安可,4,0,4,凱基-頭份,2024-04-23,9296
6189,豐藝,6,2,4,凱基-頭份,2024-04-23,9296
00891,中信關鍵半導體,3,0,3,凱基-頭份,2024-04-23,9296
2610,華航,10,7,3,凱基-頭份,2024-04-23,9296
00674R,期元大S＆P黃金反1,3,0,3,凱基-頭份,2024-04-23,9296
1608,華榮,24,21,3,凱基-頭份,2024-04-23,9296
2382,廣達,5,2,3,凱基-頭份,2024-04-23,9296
2618,長榮航,23,20,3,凱基-頭份,2024-04-23,9296
2643,捷迅,3,0,3,凱基-頭份,2024-04-23,9296
2867,三商壽,325,0,325,凱基-頭份,2024-04-24,9296
3481,群創,93,0,93,凱基-頭份,2024-04-24,9296
2317,鴻海,85,12,73,凱基-頭份,2024-04-24,9296
1314,中石化,66,0,66,凱基-頭份,2024-04-24,9296
2509,全坤建,60,0,60,凱基-頭份,2024-04-24,9296
00637L,元大滬深300正2,50,0,50,凱基-頭份,2024-04-24,9296
8069,元太,50,0,50,凱基-頭份,2024-04-24,9296
00632R,元大台灣50反1,43,0,43,凱基-頭份,2024-04-24,9296
2105,正新,40,0,40,凱基-頭份,2024-04-24,9296
2618,長榮航,75,40,35,凱基-頭份,2024-04-24,9296
2027,大成鋼,33,0,33,凱基-頭份,2024-04-24,9296
3703,欣陸,30,0,30,凱基-頭份,2024-04-24,9296
5515,建國,30,0,30,凱基-頭份,2024-04-24,9296
2886,兆豐金,26,0,26,凱基-頭份,2024-04-24,9296
6264,富裔,25,0,25,凱基-頭份,2024-04-24,9296
00706L,期元大S＆P日圓正2,20,0,20,凱基-頭份,2024-04-24,9296
00942B,台新美A公司債20+,20,0,20,凱基-頭份,2024-04-24,9296
2014,中鴻,20,0,20,凱基-頭份,2024-04-24,9296
2547,日勝生,20,0,20,凱基-頭份,2024-04-24,9296
2332,友訊,19,0,19,凱基-頭份,2024-04-24,9296
3231,緯創,33,14,19,凱基-頭份,2024-04-24,9296
4510,高鋒,17,0,17,凱基-頭份,2024-04-24,9296
5864,致和證,15,0,15,凱基-頭份,2024-04-24,9296
1616,億泰,13,0,13,凱基-頭份,2024-04-24,9296
2501,國建,15,2,13,凱基-頭份,2024-04-24,9296
2520,冠德,13,0,13,凱基-頭份,2024-04-24,9296
2427,三商電,12,0,12,凱基-頭份,2024-04-24,9296
5351,鈺創,12,0,12,凱基-頭份,2024-04-24,9296
6770,力積電,12,0,12,凱基-頭份,2024-04-24,9296
00898,國泰基因免疫革命,10,0,10,凱基-頭份,2024-04-24,9296
00664R,國泰臺灣加權反1,10,0,10,凱基-頭份,2024-04-24,9296
2634,漢翔,10,0,10,凱基-頭份,2024-04-24,9296
5371,中光電,10,0,10,凱基-頭份,2024-04-24,9296
0056,元大高股息,11,2,9,凱基-頭份,2024-04-24,9296
00687B,國泰20年美債,8,0,8,凱基-頭份,2024-04-24,9296
5009,榮剛,10,2,8,凱基-頭份,2024-04-24,9296
5434,崇越,7,0,7,凱基-頭份,2024-04-24,9296
00679B,元大美債20年,8,1,7,凱基-頭份,2024-04-24,9296
2330,台積電,11,5,6,凱基-頭份,2024-04-24,9296
00878,國泰永續高股息,6,0,6,凱基-頭份,2024-04-24,9296
00937B,群益ESG投等債20,6,0,6,凱基-頭份,2024-04-24,9296
1608,華榮,283,277,6,凱基-頭份,2024-04-24,9296
4726,永昕,10,4,6,凱基-頭份,2024-04-24,9296
1101,台泥,5,0,5,凱基-頭份,2024-04-24,9296
00919,群益台灣精選高息,10,5,5,凱基-頭份,2024-04-24,9296
2476,鉅祥,5,0,5,凱基-頭份,2024-04-24,9296
2527,宏璟,5,0,5,凱基-頭份,2024-04-24,9296
6799,來頡,11,6,5,凱基-頭份,2024-04-24,9296
2610,華航,19,15,4,凱基-頭份,2024-04-24,9296
00931B,統一美債20年,5,1,4,凱基-頭份,2024-04-24,9296
2882,國泰金,104,0,104,凱基-頭份,2024-04-25,9296
00650L,復華香港正2,100,0,100,凱基-頭份,2024-04-25,9296
8054,安國,92,0,92,凱基-頭份,2024-04-25,9296
2501,國建,168,88,80,凱基-頭份,2024-04-25,9296
6177,達麗,61,0,61,凱基-頭份,2024-04-25,9296
00878,國泰永續高股息,47,1,46,凱基-頭份,2024-04-25,9296
3013,晟銘電,45,1,44,凱基-頭份,2024-04-25,9296
5515,建國,60,28,32,凱基-頭份,2024-04-25,9296
3706,神達,31,1,30,凱基-頭份,2024-04-25,9296
1504,東元,30,2,28,凱基-頭份,2024-04-25,9296
2610,華航,30,7,23,凱基-頭份,2024-04-25,9296
6125,廣運,97,76,21,凱基-頭份,2024-04-25,9296
2913,農林,20,0,20,凱基-頭份,2024-04-25,9296
6770,力積電,21,2,19,凱基-頭份,2024-04-25,9296
00940,元大台灣價值高息,18,1,17,凱基-頭份,2024-04-25,9296
3703,欣陸,15,1,14,凱基-頭份,2024-04-25,9296
00939,統一台灣高息動能,13,0,13,凱基-頭份,2024-04-25,9296
1467,南緯,20,7,13,凱基-頭份,2024-04-25,9296
00679B,元大美債20年,12,0,12,凱基-頭份,2024-04-25,9296
2618,長榮航,57,45,12,凱基-頭份,2024-04-25,9296
3704,合勤控,12,0,12,凱基-頭份,2024-04-25,9296
1440,南紡,13,2,11,凱基-頭份,2024-04-25,9296
2892,第一金,10,0,10,凱基-頭份,2024-04-25,9296
00930,永豐ESG低碳高息,10,0,10,凱基-頭份,2024-04-25,9296
2461,光群雷,11,1,10,凱基-頭份,2024-04-25,9296
2547,日勝生,10,0,10,凱基-頭份,2024-04-25,9296
3710,連展投控,10,0,10,凱基-頭份,2024-04-25,9296
6264,富裔,10,0,10,凱基-頭份,2024-04-25,9296
2371,大同,57,48,9,凱基-頭份,2024-04-25,9296
6213,聯茂,9,0,9,凱基-頭份,2024-04-25,9296
1609,大亞,55,47,8,凱基-頭份,2024-04-25,9296
00680L,元大美債20正2,8,0,8,凱基-頭份,2024-04-25,9296
2427,三商電,9,1,8,凱基-頭份,2024-04-25,9296
5511,德昌,9,1,8,凱基-頭份,2024-04-25,9296
6190,萬泰科,6,0,6,凱基-頭份,2024-04-25,9296
8299,群聯,10,5,5,凱基-頭份,2024-04-25,9296
3715,定穎投控,6,1,5,凱基-頭份,2024-04-25,9296
00941,中信上游半導體,5,0,5,凱基-頭份,2024-04-25,9296
00710B,復華彭博非投等債,5,0,5,凱基-頭份,2024-04-25,9296
1444,力麗,5,0,5,凱基-頭份,2024-04-25,9296
2421,建準,5,0,5,凱基-頭份,2024-04-25,9296
2548,華固,8,3,5,凱基-頭份,2024-04-25,9296
2615,萬海,56,51,5,凱基-頭份,2024-04-25,9296
3051,力特,5,0,5,凱基-頭份,2024-04-25,9296
3231,緯創,6,1,5,凱基-頭份,2024-04-25,9296
6282,康舒,5,0,5,凱基-頭份,2024-04-25,9296
8222,寶一,5,0,5,凱基-頭份,2024-04-25,9296
0056,元大高股息,5,0,5,凱基-頭份,2024-04-25,9296
00915,凱基優選高股息30,5,1,4,凱基-頭份,2024-04-25,9296
6139,亞翔,6,2,4,凱基-頭份,2024-04-25,9296
00929,復華台灣科技優息,140,16,124,凱基-頭份,2024-04-26,9296
2515,中工,120,19,101,凱基-頭份,2024-04-26,9296
2317,鴻海,76,23,53,凱基-頭份,2024-04-26,9296
2505,國揚,43,5,38,凱基-頭份,2024-04-26,9296
00632R,元大台灣50反1,56,20,36,凱基-頭份,2024-04-26,9296
2371,大同,131,96,35,凱基-頭份,2024-04-26,9296
2363,矽統,49,17,32,凱基-頭份,2024-04-26,9296
00937B,群益ESG投等債20,30,1,29,凱基-頭份,2024-04-26,9296
8234,新漢,31,2,29,凱基-頭份,2024-04-26,9296
00679B,元大美債20年,26,2,24,凱基-頭份,2024-04-26,9296
5534,長虹,21,0,21,凱基-頭份,2024-04-26,9296
00885,富邦越南,20,0,20,凱基-頭份,2024-04-26,9296
4726,永昕,23,4,19,凱基-頭份,2024-04-26,9296
3284,太普高,30,13,17,凱基-頭份,2024-04-26,9296
3666,光耀,16,0,16,凱基-頭份,2024-04-26,9296
2359,所羅門,33,18,15,凱基-頭份,2024-04-26,9296
5251,天鉞電,13,0,13,凱基-頭份,2024-04-26,9296
0056,元大高股息,17,4,13,凱基-頭份,2024-04-26,9296
1503,士電,16,4,12,凱基-頭份,2024-04-26,9296
1618,合機,25,14,11,凱基-頭份,2024-04-26,9296
00664R,國泰臺灣加權反1,20,10,10,凱基-頭份,2024-04-26,9296
1609,大亞,24,14,10,凱基-頭份,2024-04-26,9296
1815,富喬,10,0,10,凱基-頭份,2024-04-26,9296
2530,華建,10,0,10,凱基-頭份,2024-04-26,9296
3710,連展投控,10,0,10,凱基-頭份,2024-04-26,9296
5529,鉅陞,10,0,10,凱基-頭份,2024-04-26,9296
9935,慶豐富,10,0,10,凱基-頭份,2024-04-26,9296
3363,上詮,15,6,9,凱基-頭份,2024-04-26,9296
1504,東元,60,51,9,凱基-頭份,2024-04-26,9296
2524,京城,9,0,9,凱基-頭份,2024-04-26,9296
2634,漢翔,10,1,9,凱基-頭份,2024-04-26,9296
2457,飛宏,8,0,8,凱基-頭份,2024-04-26,9296
1514,亞力,7,0,7,凱基-頭份,2024-04-26,9296
00942B,台新美A公司債20+,7,0,7,凱基-頭份,2024-04-26,9296
1736,喬山,7,0,7,凱基-頭份,2024-04-26,9296
00857B,永豐20年美公債,6,0,6,凱基-頭份,2024-04-26,9296
1339,昭輝,9,3,6,凱基-頭份,2024-04-26,9296
3027,盛達,6,0,6,凱基-頭份,2024-04-26,9296
3402,漢科,10,4,6,凱基-頭份,2024-04-26,9296
2102,泰豐,5,0,5,凱基-頭份,2024-04-26,9296
2504,國產,5,0,5,凱基-頭份,2024-04-26,9296
2701,萬企,5,0,5,凱基-頭份,2024-04-26,9296
2888,新光金,5,0,5,凱基-頭份,2024-04-26,9296
3645,達邁,5,0,5,凱基-頭份,2024-04-26,9296
4526,東台,5,0,5,凱基-頭份,2024-04-26,9296
4942,嘉彰,5,0,5,凱基-頭份,2024-04-26,9296
6153,嘉聯益,5,0,5,凱基-頭份,2024-04-26,9296
6213,聯茂,5,0,5,凱基-頭份,2024-04-26,9296
9946,三發地產,10,5,5,凱基-頭份,2024-04-26,9296
00878,國泰永續高股息,10,6,4,凱基-頭份,2024-04-26,9296
6177,達麗,120,0,120,凱基-頭份,2024-04-29,9296
2509,全坤建,111,0,111,凱基-頭份,2024-04-29,9296
2363,矽統,88,13,75,凱基-頭份,2024-04-29,9296
5515,建國,72,0,72,凱基-頭份,2024-04-29,9296
2505,國揚,64,0,64,凱基-頭份,2024-04-29,9296
1718,中纖,60,0,60,凱基-頭份,2024-04-29,9296
00650L,復華香港正2,50,0,50,凱基-頭份,2024-04-29,9296
00936,台新永續高息中小,50,0,50,凱基-頭份,2024-04-29,9296
1714,和桐,50,0,50,凱基-頭份,2024-04-29,9296
2515,中工,172,122,50,凱基-頭份,2024-04-29,9296
00929,復華台灣科技優息,66,24,42,凱基-頭份,2024-04-29,9296
2537,聯上發,33,4,29,凱基-頭份,2024-04-29,9296
00632R,元大台灣50反1,27,0,27,凱基-頭份,2024-04-29,9296
3234,光環,32,10,22,凱基-頭份,2024-04-29,9296
00664R,國泰臺灣加權反1,20,0,20,凱基-頭份,2024-04-29,9296
00706L,期元大S＆P日圓正2,60,40,20,凱基-頭份,2024-04-29,9296
2349,錸德,20,0,20,凱基-頭份,2024-04-29,9296
00939,統一台灣高息動能,20,1,19,凱基-頭份,2024-04-29,9296
2367,燿華,19,0,19,凱基-頭份,2024-04-29,9296
00940,元大台灣價值高息,19,3,16,凱基-頭份,2024-04-29,9296
4306,炎洲,16,0,16,凱基-頭份,2024-04-29,9296
2547,日勝生,34,20,14,凱基-頭份,2024-04-29,9296
2472,立隆電,13,0,13,凱基-頭份,2024-04-29,9296
2486,一詮,18,7,11,凱基-頭份,2024-04-29,9296
2605,新興,14,3,11,凱基-頭份,2024-04-29,9296
2887,台新金,11,0,11,凱基-頭份,2024-04-29,9296
3583,辛耘,16,5,11,凱基-頭份,2024-04-29,9296
00641R,富邦日本反1,10,0,10,凱基-頭份,2024-04-29,9296
1440,南紡,10,0,10,凱基-頭份,2024-04-29,9296
1467,南緯,10,0,10,凱基-頭份,2024-04-29,9296
1815,富喬,10,0,10,凱基-頭份,2024-04-29,9296
2701,萬企,10,0,10,凱基-頭份,2024-04-29,9296
2889,國票金,10,0,10,凱基-頭份,2024-04-29,9296
6264,富裔,10,0,10,凱基-頭份,2024-04-29,9296
4401,東隆興,8,0,8,凱基-頭份,2024-04-29,9296
8438,昶昕,8,0,8,凱基-頭份,2024-04-29,9296
3013,晟銘電,9,2,7,凱基-頭份,2024-04-29,9296
3491,昇達科,9,2,7,凱基-頭份,2024-04-29,9296
00919,群益台灣精選高息,7,1,6,凱基-頭份,2024-04-29,9296
2913,農林,6,0,6,凱基-頭份,2024-04-29,9296
3557,嘉威,6,0,6,凱基-頭份,2024-04-29,9296
6257,矽格,6,0,6,凱基-頭份,2024-04-29,9296
1413,宏洲,5,0,5,凱基-頭份,2024-04-29,9296
1603,華電,5,0,5,凱基-頭份,2024-04-29,9296
2009,第一銅,5,0,5,凱基-頭份,2024-04-29,9296
2338,光罩,5,0,5,凱基-頭份,2024-04-29,9296
3051,力特,5,0,5,凱基-頭份,2024-04-29,9296
6743,安普新,5,0,5,凱基-頭份,2024-04-29,9296
8110,華東,5,0,5,凱基-頭份,2024-04-29,9296
00679B,元大美債20年,5,1,4,凱基-頭份,2024-04-29,9296
2501,國建,387,37,350,凱基-頭份,2024-04-30,9296
2363,矽統,282,114,168,凱基-頭份,2024-04-30,9296
5522,遠雄,157,0,157,凱基-頭份,2024-04-30,9296
2509,全坤建,100,0,100,凱基-頭份,2024-04-30,9296
2515,中工,172,116,56,凱基-頭份,2024-04-30,9296
2344,華邦電,50,1,49,凱基-頭份,2024-04-30,9296
3305,昇貿,30,1,29,凱基-頭份,2024-04-30,9296
6122,擎邦,28,0,28,凱基-頭份,2024-04-30,9296
2317,鴻海,30,7,23,凱基-頭份,2024-04-30,9296
1316,上曜,25,3,22,凱基-頭份,2024-04-30,9296
00878,國泰永續高股息,30,9,21,凱基-頭份,2024-04-30,9296
00919,群益台灣精選高息,23,3,20,凱基-頭份,2024-04-30,9296
2547,日勝生,20,0,20,凱基-頭份,2024-04-30,9296
1815,富喬,29,10,19,凱基-頭份,2024-04-30,9296
2337,旺宏,20,3,17,凱基-頭份,2024-04-30,9296
2449,京元電子,16,0,16,凱基-頭份,2024-04-30,9296
2913,農林,20,6,14,凱基-頭份,2024-04-30,9296
6790,永豐實,14,0,14,凱基-頭份,2024-04-30,9296
1504,東元,12,0,12,凱基-頭份,2024-04-30,9296
5388,中磊,11,0,11,凱基-頭份,2024-04-30,9296
00632R,元大台灣50反1,41,30,11,凱基-頭份,2024-04-30,9296
3055,蔚華科,12,1,11,凱基-頭份,2024-04-30,9296
2701,萬企,10,0,10,凱基-頭份,2024-04-30,9296
3052,夆典,10,0,10,凱基-頭份,2024-04-30,9296
4167,松瑞藥,10,0,10,凱基-頭份,2024-04-30,9296
2610,華航,10,0,10,凱基-頭份,2024-04-30,9296
2472,立隆電,14,7,7,凱基-頭份,2024-04-30,9296
2605,新興,7,0,7,凱基-頭份,2024-04-30,9296
00679B,元大美債20年,6,0,6,凱基-頭份,2024-04-30,9296
00940,元大台灣價值高息,6,0,6,凱基-頭份,2024-04-30,9296
1808,潤隆,6,0,6,凱基-頭份,2024-04-30,9296
2611,志信,6,0,6,凱基-頭份,2024-04-30,9296
5227,立凱-KY,6,0,6,凱基-頭份,2024-04-30,9296
8210,勤誠,6,0,6,凱基-頭份,2024-04-30,9296
2441,超豐,7,1,6,凱基-頭份,2024-04-30,9296
1609,大亞,12,7,5,凱基-頭份,2024-04-30,9296
6239,力成,7,2,5,凱基-頭份,2024-04-30,9296
2025,千興,5,0,5,凱基-頭份,2024-04-30,9296
2427,三商電,23,18,5,凱基-頭份,2024-04-30,9296
2506,太設,5,0,5,凱基-頭份,2024-04-30,9296
2888,新光金,13,8,5,凱基-頭份,2024-04-30,9296
3707,漢磊,6,1,5,凱基-頭份,2024-04-30,9296
5531,鄉林,5,0,5,凱基-頭份,2024-04-30,9296
6120,達運,5,0,5,凱基-頭份,2024-04-30,9296
8222,寶一,5,0,5,凱基-頭份,2024-04-30,9296
2891,中信金,11,7,4,凱基-頭份,2024-04-30,9296
00939,統一台灣高息動能,4,0,4,凱基-頭份,2024-04-30,9296
00923,群益台ESG低碳50,4,0,4,凱基-頭份,2024-04-30,9296
1605,華新,4,0,4,凱基-頭份,2024-04-30,9296
1616,億泰,5,1,4,凱基-頭份,2024-04-30,9296
00878,國泰永續高股息,60,2,58,凱基-頭份,2024-05-02,9296
2101,南港,60,3,57,凱基-頭份,2024-05-02,9296
00650L,復華香港正2,50,0,50,凱基-頭份,2024-05-02,9296
00632R,元大台灣50反1,60,15,45,凱基-頭份,2024-05-02,9296
3481,群創,36,0,36,凱基-頭份,2024-05-02,9296
1314,中石化,72,39,33,凱基-頭份,2024-05-02,9296
6264,富裔,30,0,30,凱基-頭份,2024-05-02,9296
00937B,群益ESG投等債20,20,0,20,凱基-頭份,2024-05-02,9296
00923,群益台ESG低碳50,20,0,20,凱基-頭份,2024-05-02,9296
00882,中信中國高股息,20,0,20,凱基-頭份,2024-05-02,9296
00706L,期元大S＆P日圓正2,20,0,20,凱基-頭份,2024-05-02,9296
2634,漢翔,21,1,20,凱基-頭份,2024-05-02,9296
3305,昇貿,20,0,20,凱基-頭份,2024-05-02,9296
8064,東捷,18,2,16,凱基-頭份,2024-05-02,9296
2409,友達,16,1,15,凱基-頭份,2024-05-02,9296
1725,元禎,15,1,14,凱基-頭份,2024-05-02,9296
00941,中信上游半導體,13,0,13,凱基-頭份,2024-05-02,9296
2017,官田鋼,13,0,13,凱基-頭份,2024-05-02,9296
6026,福邦證,13,0,13,凱基-頭份,2024-05-02,9296
2611,志信,33,21,12,凱基-頭份,2024-05-02,9296
00940,元大台灣價值高息,13,1,12,凱基-頭份,2024-05-02,9296
2801,彰銀,10,0,10,凱基-頭份,2024-05-02,9296
00642U,期元大S＆P石油,10,0,10,凱基-頭份,2024-05-02,9296
1436,華友聯,10,0,10,凱基-頭份,2024-05-02,9296
2324,仁寶,10,0,10,凱基-頭份,2024-05-02,9296
2344,華邦電,11,1,10,凱基-頭份,2024-05-02,9296
2371,大同,19,9,10,凱基-頭份,2024-05-02,9296
2442,新美齊,10,0,10,凱基-頭份,2024-05-02,9296
6198,瑞築,10,0,10,凱基-頭份,2024-05-02,9296
2427,三商電,12,3,9,凱基-頭份,2024-05-02,9296
2009,第一銅,10,2,8,凱基-頭份,2024-05-02,9296
2888,新光金,10,2,8,凱基-頭份,2024-05-02,9296
6116,彩晶,8,0,8,凱基-頭份,2024-05-02,9296
2431,聯昌,7,0,7,凱基-頭份,2024-05-02,9296
6177,達麗,8,1,7,凱基-頭份,2024-05-02,9296
2337,旺宏,6,0,6,凱基-頭份,2024-05-02,9296
4716,大立,6,0,6,凱基-頭份,2024-05-02,9296
2330,台積電,6,1,5,凱基-頭份,2024-05-02,9296
00919,群益台灣精選高息,12,7,5,凱基-頭份,2024-05-02,9296
1609,大亞,11,6,5,凱基-頭份,2024-05-02,9296
1809,中釉,6,1,5,凱基-頭份,2024-05-02,9296
2867,三商壽,5,0,5,凱基-頭份,2024-05-02,9296
5388,中磊,10,5,5,凱基-頭份,2024-05-02,9296
6239,力成,5,0,5,凱基-頭份,2024-05-02,9296
9105,泰金寶-DR,5,0,5,凱基-頭份,2024-05-02,9296
6125,廣運,6,1,5,凱基-頭份,2024-05-02,9296
00939,統一台灣高息動能,6,2,4,凱基-頭份,2024-05-02,9296
2401,凌陽,5,1,4,凱基-頭份,2024-05-02,9296
2701,萬企,4,0,4,凱基-頭份,2024-05-02,9296
2913,農林,4,0,4,凱基-頭份,2024-05-02,9296
2882,國泰金,150,0,150,凱基-頭份,2024-05-03,9296
2855,統一證,150,8,142,凱基-頭份,2024-05-03,9296
00878,國泰永續高股息,65,7,58,凱基-頭份,2024-05-03,9296
00937B,群益ESG投等債20,55,0,55,凱基-頭份,2024-05-03,9296
00882,中信中國高股息,60,8,52,凱基-頭份,2024-05-03,9296
3481,群創,51,1,50,凱基-頭份,2024-05-03,9296
2891,中信金,62,13,49,凱基-頭份,2024-05-03,9296
5522,遠雄,129,89,40,凱基-頭份,2024-05-03,9296
5488,松普,38,0,38,凱基-頭份,2024-05-03,9296
2344,華邦電,40,10,30,凱基-頭份,2024-05-03,9296
2834,臺企銀,31,1,30,凱基-頭份,2024-05-03,9296
6198,瑞築,30,0,30,凱基-頭份,2024-05-03,9296
6264,富裔,22,1,21,凱基-頭份,2024-05-03,9296
2027,大成鋼,20,0,20,凱基-頭份,2024-05-03,9296
2509,全坤建,20,0,20,凱基-頭份,2024-05-03,9296
6122,擎邦,20,0,20,凱基-頭份,2024-05-03,9296
2520,冠德,21,2,19,凱基-頭份,2024-05-03,9296
2610,華航,21,2,19,凱基-頭份,2024-05-03,9296
9933,中鼎,17,1,16,凱基-頭份,2024-05-03,9296
4102,永日,12,0,12,凱基-頭份,2024-05-03,9296
00679B,元大美債20年,11,0,11,凱基-頭份,2024-05-03,9296
3293,鈊象,11,0,11,凱基-頭份,2024-05-03,9296
2511,太子,23,12,11,凱基-頭份,2024-05-03,9296
6120,達運,11,0,11,凱基-頭份,2024-05-03,9296
00664R,國泰臺灣加權反1,10,0,10,凱基-頭份,2024-05-03,9296
00632R,元大台灣50反1,10,0,10,凱基-頭份,2024-05-03,9296
00936,台新永續高息中小,10,0,10,凱基-頭份,2024-05-03,9296
1504,東元,11,1,10,凱基-頭份,2024-05-03,9296
1714,和桐,10,0,10,凱基-頭份,2024-05-03,9296
2449,京元電子,14,4,10,凱基-頭份,2024-05-03,9296
2498,宏達電,11,1,10,凱基-頭份,2024-05-03,9296
2497,怡利電,9,0,9,凱基-頭份,2024-05-03,9296
2363,矽統,227,219,8,凱基-頭份,2024-05-03,9296
1305,華夏,8,0,8,凱基-頭份,2024-05-03,9296
2883,凱基金,10,2,8,凱基-頭份,2024-05-03,9296
8163,達方,8,0,8,凱基-頭份,2024-05-03,9296
9945,潤泰新,38,31,7,凱基-頭份,2024-05-03,9296
1608,華榮,8,1,7,凱基-頭份,2024-05-03,9296
6770,力積電,52,46,6,凱基-頭份,2024-05-03,9296
00919,群益台灣精選高息,6,0,6,凱基-頭份,2024-05-03,9296
2345,智邦,8,2,6,凱基-頭份,2024-05-03,9296
3231,緯創,9,3,6,凱基-頭份,2024-05-03,9296
00772B,中信高評級公司債,6,0,6,凱基-頭份,2024-05-03,9296
1339,昭輝,6,0,6,凱基-頭份,2024-05-03,9296
1436,華友聯,6,0,6,凱基-頭份,2024-05-03,9296
2705,六福,6,0,6,凱基-頭份,2024-05-03,9296
6239,力成,6,0,6,凱基-頭份,2024-05-03,9296
6271,同欣電,7,1,6,凱基-頭份,2024-05-03,9296
00720B,元大投資級公司債,6,0,6,凱基-頭份,2024-05-03,9296
00715L,期街口布蘭特正2,5,0,5,凱基-頭份,2024-05-03,9296
2511,太子,590,1,589,凱基-頭份,2024-05-06,9296
00679B,元大美債20年,414,0,414,凱基-頭份,2024-05-06,9296
5522,遠雄,124,0,124,凱基-頭份,2024-05-06,9296
00937B,群益ESG投等債20,106,0,106,凱基-頭份,2024-05-06,9296
00680L,元大美債20正2,100,24,76,凱基-頭份,2024-05-06,9296
00632R,元大台灣50反1,70,14,56,凱基-頭份,2024-05-06,9296
2855,統一證,100,50,50,凱基-頭份,2024-05-06,9296
6264,富裔,50,0,50,凱基-頭份,2024-05-06,9296
00929,復華台灣科技優息,70,21,49,凱基-頭份,2024-05-06,9296
1314,中石化,50,11,39,凱基-頭份,2024-05-06,9296
00939,統一台灣高息動能,36,1,35,凱基-頭份,2024-05-06,9296
2548,華固,48,15,33,凱基-頭份,2024-05-06,9296
00650L,復華香港正2,30,0,30,凱基-頭份,2024-05-06,9296
6122,擎邦,30,0,30,凱基-頭份,2024-05-06,9296
00932,兆豐永續高息等權,26,0,26,凱基-頭份,2024-05-06,9296
00940,元大台灣價值高息,24,1,23,凱基-頭份,2024-05-06,9296
1432,大魯閣,20,0,20,凱基-頭份,2024-05-06,9296
6177,達麗,19,0,19,凱基-頭份,2024-05-06,9296
2527,宏璟,20,2,18,凱基-頭份,2024-05-06,9296
1337,再生-KY,16,0,16,凱基-頭份,2024-05-06,9296
2440,太空梭,20,5,15,凱基-頭份,2024-05-06,9296
00857B,永豐20年美公債,14,0,14,凱基-頭份,2024-05-06,9296
2501,國建,18,5,13,凱基-頭份,2024-05-06,9296
2538,基泰,20,7,13,凱基-頭份,2024-05-06,9296
3234,光環,15,2,13,凱基-頭份,2024-05-06,9296
2887,台新金,23,10,13,凱基-頭份,2024-05-06,9296
00919,群益台灣精選高息,12,0,12,凱基-頭份,2024-05-06,9296
2618,長榮航,28,17,11,凱基-頭份,2024-05-06,9296
2913,農林,11,0,11,凱基-頭份,2024-05-06,9296
2449,京元電子,30,19,11,凱基-頭份,2024-05-06,9296
1304,台聚,10,0,10,凱基-頭份,2024-05-06,9296
3025,星通,11,1,10,凱基-頭份,2024-05-06,9296
00664R,國泰臺灣加權反1,9,0,9,凱基-頭份,2024-05-06,9296
2337,旺宏,11,2,9,凱基-頭份,2024-05-06,9296
2633,台灣高鐵,9,0,9,凱基-頭份,2024-05-06,9296
3052,夆典,9,0,9,凱基-頭份,2024-05-06,9296
3537,堡達,13,4,9,凱基-頭份,2024-05-06,9296
1409,新纖,10,2,8,凱基-頭份,2024-05-06,9296
2520,冠德,44,36,8,凱基-頭份,2024-05-06,9296
8088,品安,8,0,8,凱基-頭份,2024-05-06,9296
8096,擎亞,11,3,8,凱基-頭份,2024-05-06,9296
1616,億泰,6,0,6,凱基-頭份,2024-05-06,9296
2867,三商壽,6,0,6,凱基-頭份,2024-05-06,9296
6117,迎廣,11,5,6,凱基-頭份,2024-05-06,9296
8111,立��,6,0,6,凱基-頭份,2024-05-06,9296
0056,元大高股息,9,3,6,凱基-頭份,2024-05-06,9296
00715L,期街口布蘭特正2,5,0,5,凱基-頭份,2024-05-06,9296
2528,皇普,5,0,5,凱基-頭份,2024-05-06,9296
00936,台新永續高息中小,5,0,5,凱基-頭份,2024-05-06,9296
2409,友達,5,0,5,凱基-頭份,2024-05-06,9296
00679B,元大美債20年,1244,260,984,凱基-頭份,2024-05-07,9296
00632R,元大台灣50反1,132,0,132,凱基-頭份,2024-05-07,9296
2527,宏璟,56,0,56,凱基-頭份,2024-05-07,9296
00878,國泰永續高股息,48,4,44,凱基-頭份,2024-05-07,9296
6198,瑞築,35,0,35,凱基-頭份,2024-05-07,9296
00900,富邦特選高股息30,30,0,30,凱基-頭份,2024-05-07,9296
1609,大亞,34,8,26,凱基-頭份,2024-05-07,9296
2363,矽統,24,0,24,凱基-頭份,2024-05-07,9296
2101,南港,30,6,24,凱基-頭份,2024-05-07,9296
3704,合勤控,22,0,22,凱基-頭份,2024-05-07,9296
2031,新光鋼,20,0,20,凱基-頭份,2024-05-07,9296
2547,日勝生,20,0,20,凱基-頭份,2024-05-07,9296
00919,群益台灣精選高息,20,1,19,凱基-頭份,2024-05-07,9296
00857B,永豐20年美公債,18,0,18,凱基-頭份,2024-05-07,9296
00929,復華台灣科技優息,26,10,16,凱基-頭份,2024-05-07,9296
2834,臺企銀,16,0,16,凱基-頭份,2024-05-07,9296
00932,兆豐永續高息等權,15,0,15,凱基-頭份,2024-05-07,9296
1453,大將,22,8,14,凱基-頭份,2024-05-07,9296
2515,中工,33,20,13,凱基-頭份,2024-05-07,9296
8033,雷虎,13,0,13,凱基-頭份,2024-05-07,9296
00753L,中信中國50正2,12,0,12,凱基-頭份,2024-05-07,9296
2356,英業達,12,0,12,凱基-頭份,2024-05-07,9296
2501,國建,21,9,12,凱基-頭份,2024-05-07,9296
5009,榮剛,14,2,12,凱基-頭份,2024-05-07,9296
2374,佳能,14,3,11,凱基-頭份,2024-05-07,9296
2913,農林,11,0,11,凱基-頭份,2024-05-07,9296
00752,中信中國50,10,0,10,凱基-頭份,2024-05-07,9296
00641R,富邦日本反1,10,0,10,凱基-頭份,2024-05-07,9296
00635U,期元大S＆P黃金,10,0,10,凱基-頭份,2024-05-07,9296
2612,中航,11,1,10,凱基-頭份,2024-05-07,9296
8222,寶一,10,0,10,凱基-頭份,2024-05-07,9296
2317,鴻海,27,18,9,凱基-頭份,2024-05-07,9296
2516,新建,9,0,9,凱基-頭份,2024-05-07,9296
3033,威健,15,6,9,凱基-頭份,2024-05-07,9296
6541,泰福-KY,9,0,9,凱基-頭份,2024-05-07,9296
6177,達麗,36,28,8,凱基-頭份,2024-05-07,9296
2882,國泰金,10,3,7,凱基-頭份,2024-05-07,9296
2883,凱基金,6,0,6,凱基-頭份,2024-05-07,9296
1305,華夏,6,0,6,凱基-頭份,2024-05-07,9296
2486,一詮,52,46,6,凱基-頭份,2024-05-07,9296
3338,泰碩,6,0,6,凱基-頭份,2024-05-07,9296
0056,元大高股息,5,0,5,凱基-頭份,2024-05-07,9296
00940,元大台灣價值高息,8,3,5,凱基-頭份,2024-05-07,9296
00891,中信關鍵半導體,5,0,5,凱基-頭份,2024-05-07,9296
1446,宏和,6,1,5,凱基-頭份,2024-05-07,9296
1708,東鹼,6,1,5,凱基-頭份,2024-05-07,9296
2385,群光,5,0,5,凱基-頭份,2024-05-07,9296
2409,友達,5,0,5,凱基-頭份,2024-05-07,9296
2449,京元電子,5,0,5,凱基-頭份,2024-05-07,9296
2530,華建,5,0,5,凱基-頭份,2024-05-07,9296
2891,中信金,320,3,317,凱基-頭份,2024-05-08,9296
2371,大同,154,29,125,凱基-頭份,2024-05-08,9296
5009,榮剛,101,0,101,凱基-頭份,2024-05-08,9296
00680L,元大美債20正2,100,0,100,凱基-頭份,2024-05-08,9296
2363,矽統,112,36,76,凱基-頭份,2024-05-08,9296
2892,第一金,70,3,67,凱基-頭份,2024-05-08,9296
5871,中租-KY,60,0,60,凱基-頭份,2024-05-08,9296
00937B,群益ESG投等債20,42,0,42,凱基-頭份,2024-05-08,9296
00878,國泰永續高股息,39,2,37,凱基-頭份,2024-05-08,9296
1618,合機,49,14,35,凱基-頭份,2024-05-08,9296
00919,群益台灣精選高息,27,1,26,凱基-頭份,2024-05-08,9296
6189,豐藝,23,1,22,凱基-頭份,2024-05-08,9296
00940,元大台灣價值高息,21,0,21,凱基-頭份,2024-05-08,9296
2882,國泰金,20,0,20,凱基-頭份,2024-05-08,9296
00857B,永豐20年美公債,18,0,18,凱基-頭份,2024-05-08,9296
2641,正德,23,5,18,凱基-頭份,2024-05-08,9296
3060,銘異,18,0,18,凱基-頭份,2024-05-08,9296
2365,昆盈,22,7,15,凱基-頭份,2024-05-08,9296
2603,長榮,14,0,14,凱基-頭份,2024-05-08,9296
5608,四維航,25,12,13,凱基-頭份,2024-05-08,9296
00932,兆豐永續高息等權,12,0,12,凱基-頭份,2024-05-08,9296
00637L,元大滬深300正2,12,0,12,凱基-頭份,2024-05-08,9296
3293,鈊象,12,0,12,凱基-頭份,2024-05-08,9296
00795B,中信美國公債20年,11,0,11,凱基-頭份,2024-05-08,9296
1616,億泰,11,0,11,凱基-頭份,2024-05-08,9296
2338,光罩,11,0,11,凱基-頭份,2024-05-08,9296
00665L,富邦�琤肭磪囓�2,10,0,10,凱基-頭份,2024-05-08,9296
00706L,期元大S＆P日圓正2,10,0,10,凱基-頭份,2024-05-08,9296
2332,友訊,10,0,10,凱基-頭份,2024-05-08,9296
2534,宏盛,10,0,10,凱基-頭份,2024-05-08,9296
2547,日勝生,20,10,10,凱基-頭份,2024-05-08,9296
4303,信立,10,0,10,凱基-頭份,2024-05-08,9296
1608,華榮,11,2,9,凱基-頭份,2024-05-08,9296
2888,新光金,10,1,9,凱基-頭份,2024-05-08,9296
2354,鴻準,13,5,8,凱基-頭份,2024-05-08,9296
3338,泰碩,9,1,8,凱基-頭份,2024-05-08,9296
2367,燿華,28,21,7,凱基-頭份,2024-05-08,9296
6114,久威,7,0,7,凱基-頭份,2024-05-08,9296
3013,晟銘電,20,13,7,凱基-頭份,2024-05-08,9296
00931B,統一美債20年,7,1,6,凱基-頭份,2024-05-08,9296
2520,冠德,7,1,6,凱基-頭份,2024-05-08,9296
6165,浪凡,6,0,6,凱基-頭份,2024-05-08,9296
00891,中信關鍵半導體,5,0,5,凱基-頭份,2024-05-08,9296
2352,佳世達,5,0,5,凱基-頭份,2024-05-08,9296
3036,文曄,6,1,5,凱基-頭份,2024-05-08,9296
1314,中石化,11,6,5,凱基-頭份,2024-05-08,9296
6770,力積電,5,0,5,凱基-頭份,2024-05-08,9296
00936,台新永續高息中小,5,0,5,凱基-頭份,2024-05-08,9296
1733,五鼎,5,0,5,凱基-頭份,2024-05-08,9296
2618,長榮航,10,5,5,凱基-頭份,2024-05-08,9296
2891,中信金,210,0,210,凱基-頭份,2024-05-09,9296
2892,第一金,164,2,162,凱基-頭份,2024-05-09,9296
00940,元大台灣價值高息,72,1,71,凱基-頭份,2024-05-09,9296
00929,復華台灣科技優息,79,13,66,凱基-頭份,2024-05-09,9296
2609,陽明,262,198,64,凱基-頭份,2024-05-09,9296
00937B,群益ESG投等債20,55,4,51,凱基-頭份,2024-05-09,9296
00932,兆豐永續高息等權,43,0,43,凱基-頭份,2024-05-09,9296
2489,瑞軒,40,2,38,凱基-頭份,2024-05-09,9296
4967,十銓,43,10,33,凱基-頭份,2024-05-09,9296
2834,臺企銀,26,0,26,凱基-頭份,2024-05-09,9296
2520,冠德,37,18,19,凱基-頭份,2024-05-09,9296
2889,國票金,19,0,19,凱基-頭份,2024-05-09,9296
2449,京元電子,20,2,18,凱基-頭份,2024-05-09,9296
3706,神達,17,0,17,凱基-頭份,2024-05-09,9296
1815,富喬,18,2,16,凱基-頭份,2024-05-09,9296
2409,友達,15,1,14,凱基-頭份,2024-05-09,9296
2603,長榮,24,10,14,凱基-頭份,2024-05-09,9296
00942B,台新美A公司債20+,13,0,13,凱基-頭份,2024-05-09,9296
1785,光洋科,12,0,12,凱基-頭份,2024-05-09,9296
2402,毅嘉,11,0,11,凱基-頭份,2024-05-09,9296
4960,誠美材,11,0,11,凱基-頭份,2024-05-09,9296
00664R,國泰臺灣加權反1,10,0,10,凱基-頭份,2024-05-09,9296
00706L,期元大S＆P日圓正2,10,0,10,凱基-頭份,2024-05-09,9296
2511,太子,10,0,10,凱基-頭份,2024-05-09,9296
00687B,國泰20年美債,10,1,9,凱基-頭份,2024-05-09,9296
2362,藍天,9,0,9,凱基-頭份,2024-05-09,9296
3583,辛耘,19,10,9,凱基-頭份,2024-05-09,9296
00882,中信中國高股息,9,2,7,凱基-頭份,2024-05-09,9296
2890,永豐金,28,21,7,凱基-頭份,2024-05-09,9296
3041,揚智,8,1,7,凱基-頭份,2024-05-09,9296
00637L,元大滬深300正2,6,0,6,凱基-頭份,2024-05-09,9296
1314,中石化,7,1,6,凱基-頭份,2024-05-09,9296
1612,宏泰,6,0,6,凱基-頭份,2024-05-09,9296
2115,六暉-KY,6,0,6,凱基-頭份,2024-05-09,9296
2344,華邦電,7,1,6,凱基-頭份,2024-05-09,9296
2515,中工,13,7,6,凱基-頭份,2024-05-09,9296
3027,盛達,6,0,6,凱基-頭份,2024-05-09,9296
6577,勁豐,6,0,6,凱基-頭份,2024-05-09,9296
3231,緯創,6,1,5,凱基-頭份,2024-05-09,9296
00891,中信關鍵半導體,5,0,5,凱基-頭份,2024-05-09,9296
1301,台塑,5,0,5,凱基-頭份,2024-05-09,9296
00857B,永豐20年美公債,5,0,5,凱基-頭份,2024-05-09,9296
00650L,復華香港正2,5,0,5,凱基-頭份,2024-05-09,9296
1416,廣豐,5,0,5,凱基-頭份,2024-05-09,9296
1725,元禎,6,1,5,凱基-頭份,2024-05-09,9296
2365,昆盈,11,6,5,凱基-頭份,2024-05-09,9296
5519,隆大,8,3,5,凱基-頭份,2024-05-09,9296
6472,保瑞,6,1,5,凱基-頭份,2024-05-09,9296
9105,泰金寶-DR,5,0,5,凱基-頭份,2024-05-09,9296
9946,三發地產,5,0,5,凱基-頭份,2024-05-09,9296
2882,國泰金,383,35,348,凱基-頭份,2024-05-10,9296
00679B,元大美債20年,359,66,293,凱基-頭份,2024-05-10,9296
2887,台新金,95,0,95,凱基-頭份,2024-05-10,9296
00929,復華台灣科技優息,109,23,86,凱基-頭份,2024-05-10,9296
00932,兆豐永續高息等權,35,1,34,凱基-頭份,2024-05-10,9296
2324,仁寶,70,40,30,凱基-頭份,2024-05-10,9296
00715L,期街口布蘭特正2,24,1,23,凱基-頭份,2024-05-10,9296
2704,國賓,30,8,22,凱基-頭份,2024-05-10,9296
00632R,元大台灣50反1,22,0,22,凱基-頭份,2024-05-10,9296
4967,十銓,71,49,22,凱基-頭份,2024-05-10,9296
2101,南港,21,0,21,凱基-頭份,2024-05-10,9296
1314,中石化,40,20,20,凱基-頭份,2024-05-10,9296
00687B,國泰20年美債,30,10,20,凱基-頭份,2024-05-10,9296
2601,益航,20,0,20,凱基-頭份,2024-05-10,9296
2633,台灣高鐵,20,0,20,凱基-頭份,2024-05-10,9296
5508,永信建,40,20,20,凱基-頭份,2024-05-10,9296
00946,群益科技高息成長,19,0,19,凱基-頭份,2024-05-10,9296
3706,神達,25,8,17,凱基-頭份,2024-05-10,9296
2641,正德,41,25,16,凱基-頭份,2024-05-10,9296
6177,達麗,16,0,16,凱基-頭份,2024-05-10,9296
2605,新興,25,12,13,凱基-頭份,2024-05-10,9296
00706L,期元大S＆P日圓正2,12,0,12,凱基-頭份,2024-05-10,9296
4960,誠美材,16,4,12,凱基-頭份,2024-05-10,9296
2457,飛宏,11,0,11,凱基-頭份,2024-05-10,9296
2412,中華電,10,0,10,凱基-頭份,2024-05-10,9296
00933B,國泰10Y+金融債,10,0,10,凱基-頭份,2024-05-10,9296
1616,億泰,10,0,10,凱基-頭份,2024-05-10,9296
2363,矽統,23,13,10,凱基-頭份,2024-05-10,9296
2509,全坤建,10,0,10,凱基-頭份,2024-05-10,9296
2547,日勝生,10,0,10,凱基-頭份,2024-05-10,9296
3356,奇偶,26,16,10,凱基-頭份,2024-05-10,9296
6198,瑞築,10,0,10,凱基-頭份,2024-05-10,9296
2317,鴻海,13,5,8,凱基-頭份,2024-05-10,9296
00857B,永豐20年美公債,13,5,8,凱基-頭份,2024-05-10,9296
1815,富喬,21,13,8,凱基-頭份,2024-05-10,9296
3376,新日興,12,4,8,凱基-頭份,2024-05-10,9296
2367,燿華,42,35,7,凱基-頭份,2024-05-10,9296
2379,瑞昱,7,0,7,凱基-頭份,2024-05-10,9296
2402,毅嘉,7,0,7,凱基-頭份,2024-05-10,9296
8440,綠電,7,0,7,凱基-頭份,2024-05-10,9296
00940,元大台灣價值高息,8,2,6,凱基-頭份,2024-05-10,9296
1503,士電,9,3,6,凱基-頭份,2024-05-10,9296
3481,群創,7,1,6,凱基-頭份,2024-05-10,9296
3666,光耀,6,0,6,凱基-頭份,2024-05-10,9296
4906,正文,6,0,6,凱基-頭份,2024-05-10,9296
1227,佳格,6,0,6,凱基-頭份,2024-05-10,9296
6451,訊芯-KY,5,0,5,凱基-頭份,2024-05-10,9296
2409,友達,5,0,5,凱基-頭份,2024-05-10,9296
1316,上曜,5,0,5,凱基-頭份,2024-05-10,9296
00650L,復華香港正2,5,0,5,凱基-頭份,2024-05-10,9296
2606,裕民,272,24,248,凱基-頭份,2024-05-13,9296
2603,長榮,119,9,110,凱基-頭份,2024-05-13,9296
2609,陽明,143,76,67,凱基-頭份,2024-05-13,9296
2888,新光金,60,0,60,凱基-頭份,2024-05-13,9296
2630,亞航,45,0,45,凱基-頭份,2024-05-13,9296
2367,燿華,61,24,37,凱基-頭份,2024-05-13,9296
2867,三商壽,35,0,35,凱基-頭份,2024-05-13,9296
2615,萬海,103,71,32,凱基-頭份,2024-05-13,9296
00650L,復華香港正2,30,0,30,凱基-頭份,2024-05-13,9296
8906,花王,27,0,27,凱基-頭份,2024-05-13,9296
00882,中信中國高股息,34,10,24,凱基-頭份,2024-05-13,9296
2449,京元電子,24,0,24,凱基-頭份,2024-05-13,9296
6264,富裔,20,0,20,凱基-頭份,2024-05-13,9296
2618,長榮航,28,11,17,凱基-頭份,2024-05-13,9296
2317,鴻海,20,5,15,凱基-頭份,2024-05-13,9296
00946,群益科技高息成長,15,0,15,凱基-頭份,2024-05-13,9296
2915,潤泰全,20,6,14,凱基-頭份,2024-05-13,9296
2371,大同,35,23,12,凱基-頭份,2024-05-13,9296
00878,國泰永續高股息,21,9,12,凱基-頭份,2024-05-13,9296
6257,矽格,12,0,12,凱基-頭份,2024-05-13,9296
1906,寶隆,12,0,12,凱基-頭份,2024-05-13,9296
1503,士電,17,6,11,凱基-頭份,2024-05-13,9296
1504,東元,20,9,11,凱基-頭份,2024-05-13,9296
3372,典範,10,0,10,凱基-頭份,2024-05-13,9296
2476,鉅祥,10,0,10,凱基-頭份,2024-05-13,9296
2509,全坤建,10,0,10,凱基-頭份,2024-05-13,9296
3597,映興,10,0,10,凱基-頭份,2024-05-13,9296
5871,中租-KY,12,2,10,凱基-頭份,2024-05-13,9296
00940,元大台灣價值高息,19,10,9,凱基-頭份,2024-05-13,9296
1101,台泥,9,0,9,凱基-頭份,2024-05-13,9296
2891,中信金,9,0,9,凱基-頭份,2024-05-13,9296
00937B,群益ESG投等債20,10,1,9,凱基-頭份,2024-05-13,9296
2241,艾姆勒,9,0,9,凱基-頭份,2024-05-13,9296
0056,元大高股息,17,9,8,凱基-頭份,2024-05-13,9296
00673R,期元大S＆P原油反1,10,2,8,凱基-頭份,2024-05-13,9296
3231,緯創,19,11,8,凱基-頭份,2024-05-13,9296
00857B,永豐20年美公債,7,0,7,凱基-頭份,2024-05-13,9296
1444,力麗,7,0,7,凱基-頭份,2024-05-13,9296
2362,藍天,20,13,7,凱基-頭份,2024-05-13,9296
8210,勤誠,13,6,7,凱基-頭份,2024-05-13,9296
1513,中興電,8,2,6,凱基-頭份,2024-05-13,9296
6274,台燿,7,1,6,凱基-頭份,2024-05-13,9296
2486,一詮,8,2,6,凱基-頭份,2024-05-13,9296
3024,憶聲,6,0,6,凱基-頭份,2024-05-13,9296
00715L,期街口布蘭特正2,6,0,6,凱基-頭份,2024-05-13,9296
00942B,台新美A公司債20+,6,0,6,凱基-頭份,2024-05-13,9296
00932,兆豐永續高息等權,6,0,6,凱基-頭份,2024-05-13,9296
1785,光洋科,5,0,5,凱基-頭份,2024-05-13,9296
4167,松瑞藥,5,0,5,凱基-頭份,2024-05-13,9296
00706L,期元大S＆P日圓正2,5,0,5,凱基-頭份,2024-05-13,9296
2882,國泰金,129,21,108,凱基-頭份,2024-05-14,9296
00632R,元大台灣50反1,118,10,108,凱基-頭份,2024-05-14,9296
5009,榮剛,99,0,99,凱基-頭份,2024-05-14,9296
1714,和桐,55,0,55,凱基-頭份,2024-05-14,9296
00929,復華台灣科技優息,50,0,50,凱基-頭份,2024-05-14,9296
2317,鴻海,82,36,46,凱基-頭份,2024-05-14,9296
2331,精英,36,1,35,凱基-頭份,2024-05-14,9296
2615,萬海,189,157,32,凱基-頭份,2024-05-14,9296
1815,富喬,47,17,30,凱基-頭份,2024-05-14,9296
8906,花王,29,0,29,凱基-頭份,2024-05-14,9296
2641,正德,47,20,27,凱基-頭份,2024-05-14,9296
00679B,元大美債20年,28,2,26,凱基-頭份,2024-05-14,9296
2489,瑞軒,23,0,23,凱基-頭份,2024-05-14,9296
2867,三商壽,20,0,20,凱基-頭份,2024-05-14,9296
2605,新興,56,38,18,凱基-頭份,2024-05-14,9296
1522,堤維西,19,4,15,凱基-頭份,2024-05-14,9296
2601,益航,15,0,15,凱基-頭份,2024-05-14,9296
00637L,元大滬深300正2,14,0,14,凱基-頭份,2024-05-14,9296
8299,群聯,27,13,14,凱基-頭份,2024-05-14,9296
5871,中租-KY,13,0,13,凱基-頭份,2024-05-14,9296
3706,神達,17,4,13,凱基-頭份,2024-05-14,9296
1437,勤益控,12,0,12,凱基-頭份,2024-05-14,9296
00933B,國泰10Y+金融債,12,0,12,凱基-頭份,2024-05-14,9296
2028,威致,12,0,12,凱基-頭份,2024-05-14,9296
2634,漢翔,13,1,12,凱基-頭份,2024-05-14,9296
2542,興富發,11,0,11,凱基-頭份,2024-05-14,9296
2208,台船,11,0,11,凱基-頭份,2024-05-14,9296
2313,華通,11,0,11,凱基-頭份,2024-05-14,9296
2618,長榮航,20,9,11,凱基-頭份,2024-05-14,9296
00664R,國泰臺灣加權反1,10,0,10,凱基-頭份,2024-05-14,9296
1416,廣豐,10,0,10,凱基-頭份,2024-05-14,9296
2344,華邦電,12,2,10,凱基-頭份,2024-05-14,9296
2888,新光金,10,0,10,凱基-頭份,2024-05-14,9296
6264,富裔,10,0,10,凱基-頭份,2024-05-14,9296
1906,寶隆,9,0,9,凱基-頭份,2024-05-14,9296
2371,大同,33,24,9,凱基-頭份,2024-05-14,9296
4976,佳凌,9,0,9,凱基-頭份,2024-05-14,9296
9906,欣巴巴,9,0,9,凱基-頭份,2024-05-14,9296
1101,台泥,8,0,8,凱基-頭份,2024-05-14,9296
1312,國喬,11,3,8,凱基-頭份,2024-05-14,9296
1326,台化,8,0,8,凱基-頭份,2024-05-14,9296
6177,達麗,17,9,8,凱基-頭份,2024-05-14,9296
3605,宏致,8,1,7,凱基-頭份,2024-05-14,9296
2461,光群雷,6,0,6,凱基-頭份,2024-05-14,9296
9945,潤泰新,9,3,6,凱基-頭份,2024-05-14,9296
1301,台塑,5,0,5,凱基-頭份,2024-05-14,9296
00940,元大台灣價值高息,9,4,5,凱基-頭份,2024-05-14,9296
00882,中信中國高股息,40,35,5,凱基-頭份,2024-05-14,9296
2915,潤泰全,5,0,5,凱基-頭份,2024-05-14,9296
3666,光耀,5,0,5,凱基-頭份,2024-05-14,9296
4306,炎洲,100,0,100,凱基-頭份,2024-05-15,9296
00712,復華富時不動產,100,23,77,凱基-頭份,2024-05-15,9296
2371,大同,120,59,61,凱基-頭份,2024-05-15,9296
2603,長榮,68,10,58,凱基-頭份,2024-05-15,9296
00929,復華台灣科技優息,91,34,57,凱基-頭份,2024-05-15,9296
00919,群益台灣精選高息,37,3,34,凱基-頭份,2024-05-15,9296
2609,陽明,84,50,34,凱基-頭份,2024-05-15,9296
2449,京元電子,33,1,32,凱基-頭份,2024-05-15,9296
00632R,元大台灣50反1,86,55,31,凱基-頭份,2024-05-15,9296
00945B,凱基美國非投等債,31,0,31,凱基-頭份,2024-05-15,9296
1714,和桐,30,0,30,凱基-頭份,2024-05-15,9296
8906,花王,29,0,29,凱基-頭份,2024-05-15,9296
00937B,群益ESG投等債20,28,1,27,凱基-頭份,2024-05-15,9296
2605,新興,32,11,21,凱基-頭份,2024-05-15,9296
00680L,元大美債20正2,20,0,20,凱基-頭份,2024-05-15,9296
2547,日勝生,20,0,20,凱基-頭份,2024-05-15,9296
2606,裕民,21,1,20,凱基-頭份,2024-05-15,9296
5522,遠雄,30,10,20,凱基-頭份,2024-05-15,9296
00679B,元大美債20年,20,1,19,凱基-頭份,2024-05-15,9296
2615,萬海,64,45,19,凱基-頭份,2024-05-15,9296
2618,長榮航,26,9,17,凱基-頭份,2024-05-15,9296
2356,英業達,18,2,16,凱基-頭份,2024-05-15,9296
1312,國喬,15,0,15,凱基-頭份,2024-05-15,9296
4726,永昕,15,0,15,凱基-頭份,2024-05-15,9296
00940,元大台灣價值高息,20,6,14,凱基-頭份,2024-05-15,9296
2363,矽統,38,24,14,凱基-頭份,2024-05-15,9296
6217,中探針,21,8,13,凱基-頭份,2024-05-15,9296
6184,大豐電,12,0,12,凱基-頭份,2024-05-15,9296
8101,華冠,12,0,12,凱基-頭份,2024-05-15,9296
4903,聯光通,14,3,11,凱基-頭份,2024-05-15,9296
6219,富旺,11,0,11,凱基-頭份,2024-05-15,9296
2884,玉山金,10,0,10,凱基-頭份,2024-05-15,9296
5871,中租-KY,10,0,10,凱基-頭份,2024-05-15,9296
00706L,期元大S＆P日圓正2,10,0,10,凱基-頭份,2024-05-15,9296
00664R,國泰臺灣加權反1,10,0,10,凱基-頭份,2024-05-15,9296
1529,樂事綠能,13,3,10,凱基-頭份,2024-05-15,9296
2208,台船,10,0,10,凱基-頭份,2024-05-15,9296
2538,基泰,10,0,10,凱基-頭份,2024-05-15,9296
00637L,元大滬深300正2,9,0,9,凱基-頭份,2024-05-15,9296
2344,華邦電,14,5,9,凱基-頭份,2024-05-15,9296
8112,至上,12,3,9,凱基-頭份,2024-05-15,9296
1437,勤益控,8,0,8,凱基-頭份,2024-05-15,9296
2376,技嘉,8,0,8,凱基-頭份,2024-05-15,9296
2486,一詮,15,7,8,凱基-頭份,2024-05-15,9296
4533,協易機,15,7,8,凱基-頭份,2024-05-15,9296
6753,龍德造船,8,0,8,凱基-頭份,2024-05-15,9296
00857B,永豐20年美公債,7,0,7,凱基-頭份,2024-05-15,9296
1326,台化,7,0,7,凱基-頭份,2024-05-15,9296
3230,錦明,12,5,7,凱基-頭份,2024-05-15,9296
4543,萬在,11,4,7,凱基-頭份,2024-05-15,9296
00937B,群益ESG投等債20,545,10,535,凱基-頭份,2024-05-16,9296
2882,國泰金,313,102,211,凱基-頭份,2024-05-16,9296
00632R,元大台灣50反1,105,0,105,凱基-頭份,2024-05-16,9296
9945,潤泰新,121,38,83,凱基-頭份,2024-05-16,9296
00929,復華台灣科技優息,104,26,78,凱基-頭份,2024-05-16,9296
00687B,國泰20年美債,57,3,54,凱基-頭份,2024-05-16,9296
2367,燿華,176,131,45,凱基-頭份,2024-05-16,9296
2867,三商壽,52,11,41,凱基-頭份,2024-05-16,9296
2613,中櫃,35,1,34,凱基-頭份,2024-05-16,9296
2331,精英,33,2,31,凱基-頭份,2024-05-16,9296
1714,和桐,30,0,30,凱基-頭份,2024-05-16,9296
2495,普安,31,1,30,凱基-頭份,2024-05-16,9296
2834,臺企銀,20,0,20,凱基-頭份,2024-05-16,9296
2344,華邦電,24,5,19,凱基-頭份,2024-05-16,9296
6269,台郡,17,0,17,凱基-頭份,2024-05-16,9296
1303,南亞,16,0,16,凱基-頭份,2024-05-16,9296
2382,廣達,24,11,13,凱基-頭份,2024-05-16,9296
00940,元大台灣價值高息,20,8,12,凱基-頭份,2024-05-16,9296
8299,群聯,12,0,12,凱基-頭份,2024-05-16,9296
5531,鄉林,11,0,11,凱基-頭份,2024-05-16,9296
00898,國泰基因免疫革命,10,0,10,凱基-頭份,2024-05-16,9296
2020,美亞,10,0,10,凱基-頭份,2024-05-16,9296
2323,中環,10,0,10,凱基-頭份,2024-05-16,9296
2329,華泰,11,1,10,凱基-頭份,2024-05-16,9296
2538,基泰,10,0,10,凱基-頭份,2024-05-16,9296
2888,新光金,10,0,10,凱基-頭份,2024-05-16,9296
4726,永昕,10,0,10,凱基-頭份,2024-05-16,9296
6168,宏齊,10,0,10,凱基-頭份,2024-05-16,9296
6266,泰詠,10,0,10,凱基-頭份,2024-05-16,9296
3231,緯創,14,5,9,凱基-頭份,2024-05-16,9296
1616,億泰,12,3,9,凱基-頭份,2024-05-16,9296
1733,五鼎,9,0,9,凱基-頭份,2024-05-16,9296
2736,富野,9,0,9,凱基-頭份,2024-05-16,9296
2897,王道銀行,14,5,9,凱基-頭份,2024-05-16,9296
3363,上詮,11,2,9,凱基-頭份,2024-05-16,9296
6591,動力-KY,9,0,9,凱基-頭份,2024-05-16,9296
1532,勤美,8,0,8,凱基-頭份,2024-05-16,9296
00715L,期街口布蘭特正2,8,0,8,凱基-頭份,2024-05-16,9296
2101,南港,8,0,8,凱基-頭份,2024-05-16,9296
3230,錦明,10,2,8,凱基-頭份,2024-05-16,9296
2363,矽統,24,16,8,凱基-頭份,2024-05-16,9296
6770,力積電,32,24,8,凱基-頭份,2024-05-16,9296
00882,中信中國高股息,10,4,6,凱基-頭份,2024-05-16,9296
3059,華晶科,18,12,6,凱基-頭份,2024-05-16,9296
3064,泰偉,7,1,6,凱基-頭份,2024-05-16,9296
8210,勤誠,7,1,6,凱基-頭份,2024-05-16,9296
2206,三陽工業,6,0,6,凱基-頭份,2024-05-16,9296
00679B,元大美債20年,5,0,5,凱基-頭份,2024-05-16,9296
1437,勤益控,5,0,5,凱基-頭份,2024-05-16,9296
1529,樂事綠能,5,0,5,凱基-頭份,2024-05-16,9296
2867,三商壽,306,92,214,凱基-頭份,2024-05-17,9296
00929,復華台灣科技優息,167,20,147,凱基-頭份,2024-05-17,9296
2882,國泰金,101,10,91,凱基-頭份,2024-05-17,9296
00936,台新永續高息中小,77,0,77,凱基-頭份,2024-05-17,9296
00878,國泰永續高股息,100,26,74,凱基-頭份,2024-05-17,9296
00680L,元大美債20正2,70,0,70,凱基-頭份,2024-05-17,9296
2609,陽明,71,6,65,凱基-頭份,2024-05-17,9296
2374,佳能,84,28,56,凱基-頭份,2024-05-17,9296
2349,錸德,51,0,51,凱基-頭份,2024-05-17,9296
2615,萬海,48,2,46,凱基-頭份,2024-05-17,9296
00919,群益台灣精選高息,42,0,42,凱基-頭份,2024-05-17,9296
00637L,元大滬深300正2,30,0,30,凱基-頭份,2024-05-17,9296
2606,裕民,31,4,27,凱基-頭份,2024-05-17,9296
00706L,期元大S＆P日圓正2,25,0,25,凱基-頭份,2024-05-17,9296
00946,群益科技高息成長,24,0,24,凱基-頭份,2024-05-17,9296
2605,新興,23,0,23,凱基-頭份,2024-05-17,9296
3481,群創,25,4,21,凱基-頭份,2024-05-17,9296
1104,環泥,20,0,20,凱基-頭份,2024-05-17,9296
2603,長榮,25,7,18,凱基-頭份,2024-05-17,9296
2520,冠德,35,20,15,凱基-頭份,2024-05-17,9296
8906,花王,14,0,14,凱基-頭份,2024-05-17,9296
00940,元大台灣價值高息,15,3,12,凱基-頭份,2024-05-17,9296
1459,聯發,12,0,12,凱基-頭份,2024-05-17,9296
4934,太極,12,0,12,凱基-頭份,2024-05-17,9296
1514,亞力,11,0,11,凱基-頭份,2024-05-17,9296
2905,三商,21,10,11,凱基-頭份,2024-05-17,9296
6257,矽格,46,35,11,凱基-頭份,2024-05-17,9296
2356,英業達,10,0,10,凱基-頭份,2024-05-17,9296
00632R,元大台灣50反1,10,0,10,凱基-頭份,2024-05-17,9296
1457,宜進,10,0,10,凱基-頭份,2024-05-17,9296
1582,信錦,10,0,10,凱基-頭份,2024-05-17,9296
2618,長榮航,20,10,10,凱基-頭份,2024-05-17,9296
2701,萬企,10,0,10,凱基-頭份,2024-05-17,9296
3230,錦明,10,0,10,凱基-頭份,2024-05-17,9296
4952,凌通,21,11,10,凱基-頭份,2024-05-17,9296
00687B,國泰20年美債,10,0,10,凱基-頭份,2024-05-17,9296
5392,能率,12,3,9,凱基-頭份,2024-05-17,9296
1326,台化,8,0,8,凱基-頭份,2024-05-17,9296
1608,華榮,10,2,8,凱基-頭份,2024-05-17,9296
1785,光洋科,11,4,7,凱基-頭份,2024-05-17,9296
00931B,統一美債20年,7,0,7,凱基-頭份,2024-05-17,9296
2331,精英,10,3,7,凱基-頭份,2024-05-17,9296
2489,瑞軒,18,11,7,凱基-頭份,2024-05-17,9296
2504,國產,7,0,7,凱基-頭份,2024-05-17,9296
3712,永崴投控,7,0,7,凱基-頭份,2024-05-17,9296
00795B,中信美國公債20年,6,0,6,凱基-頭份,2024-05-17,9296
2002,中鋼,20,14,6,凱基-頭份,2024-05-17,9296
2641,正德,6,0,6,凱基-頭份,2024-05-17,9296
3231,緯創,6,0,6,凱基-頭份,2024-05-17,9296
2317,鴻海,31,25,6,凱基-頭份,2024-05-17,9296
00929,復華台灣科技優息,978,39,939,凱基-頭份,2024-05-20,9296
1608,華榮,106,5,101,凱基-頭份,2024-05-20,9296
2618,長榮航,66,13,53,凱基-頭份,2024-05-20,9296
6116,彩晶,34,0,34,凱基-頭份,2024-05-20,9296
6166,凌華,33,0,33,凱基-頭份,2024-05-20,9296
00918,大華優利高填息30,28,0,28,凱基-頭份,2024-05-20,9296
3535,晶彩科,29,5,24,凱基-頭份,2024-05-20,9296
5392,能率,21,0,21,凱基-頭份,2024-05-20,9296
5009,榮剛,21,0,21,凱基-頭份,2024-05-20,9296
1752,南光,19,0,19,凱基-頭份,2024-05-20,9296
1906,寶隆,19,0,19,凱基-頭份,2024-05-20,9296
4533,協易機,30,11,19,凱基-頭份,2024-05-20,9296
4960,誠美材,20,1,19,凱基-頭份,2024-05-20,9296
1104,環泥,18,0,18,凱基-頭份,2024-05-20,9296
2634,漢翔,21,3,18,凱基-頭份,2024-05-20,9296
00632R,元大台灣50反1,14,0,14,凱基-頭份,2024-05-20,9296
2317,鴻海,33,21,12,凱基-頭份,2024-05-20,9296
8070,長華*,14,2,12,凱基-頭份,2024-05-20,9296
9945,潤泰新,17,5,12,凱基-頭份,2024-05-20,9296
3059,華晶科,21,10,11,凱基-頭份,2024-05-20,9296
4906,正文,14,3,11,凱基-頭份,2024-05-20,9296
2359,所羅門,35,25,10,凱基-頭份,2024-05-20,9296
00641R,富邦日本反1,10,0,10,凱基-頭份,2024-05-20,9296
00679B,元大美債20年,11,1,10,凱基-頭份,2024-05-20,9296
00664R,國泰臺灣加權反1,10,0,10,凱基-頭份,2024-05-20,9296
1815,富喬,10,0,10,凱基-頭份,2024-05-20,9296
2905,三商,10,0,10,凱基-頭份,2024-05-20,9296
3234,光環,12,2,10,凱基-頭份,2024-05-20,9296
6264,富裔,10,0,10,凱基-頭份,2024-05-20,9296
6443,元晶,10,0,10,凱基-頭份,2024-05-20,9296
2406,國碩,10,1,9,凱基-頭份,2024-05-20,9296
2353,宏��,10,2,8,凱基-頭份,2024-05-20,9296
2605,新興,8,0,8,凱基-頭份,2024-05-20,9296
6202,盛群,9,1,8,凱基-頭份,2024-05-20,9296
8906,花王,8,0,8,凱基-頭份,2024-05-20,9296
3010,華立,8,0,8,凱基-頭份,2024-05-20,9296
2884,玉山金,16,8,8,凱基-頭份,2024-05-20,9296
3712,永崴投控,7,0,7,凱基-頭份,2024-05-20,9296
4976,佳凌,7,0,7,凱基-頭份,2024-05-20,9296
00878,國泰永續高股息,35,29,6,凱基-頭份,2024-05-20,9296
3051,力特,6,0,6,凱基-頭份,2024-05-20,9296
2206,三陽工業,8,2,6,凱基-頭份,2024-05-20,9296
3231,緯創,13,7,6,凱基-頭份,2024-05-20,9296
3005,神基,8,2,6,凱基-頭份,2024-05-20,9296
00715L,期街口布蘭特正2,6,0,6,凱基-頭份,2024-05-20,9296
00857B,永豐20年美公債,6,0,6,凱基-頭份,2024-05-20,9296
00946,群益科技高息成長,6,0,6,凱基-頭份,2024-05-20,9296
2449,京元電子,12,6,6,凱基-頭份,2024-05-20,9296
2476,鉅祥,9,3,6,凱基-頭份,2024-05-20,9296
3666,光耀,6,0,6,凱基-頭份,2024-05-20,9296
00679B,元大美債20年,601,0,601,凱基-頭份,2024-05-21,9296
2892,第一金,431,5,426,凱基-頭份,2024-05-21,9296
2884,玉山金,253,47,206,凱基-頭份,2024-05-21,9296
2890,永豐金,241,42,199,凱基-頭份,2024-05-21,9296
3666,光耀,70,0,70,凱基-頭份,2024-05-21,9296
2367,燿華,134,68,66,凱基-頭份,2024-05-21,9296
00882,中信中國高股息,64,20,44,凱基-頭份,2024-05-21,9296
00941,中信上游半導體,45,3,42,凱基-頭份,2024-05-21,9296
6166,凌華,35,2,33,凱基-頭份,2024-05-21,9296
2891,中信金,31,0,31,凱基-頭份,2024-05-21,9296
00878,國泰永續高股息,33,5,28,凱基-頭份,2024-05-21,9296
00937B,群益ESG投等債20,27,0,27,凱基-頭份,2024-05-21,9296
3338,泰碩,57,31,26,凱基-頭份,2024-05-21,9296
2606,裕民,25,0,25,凱基-頭份,2024-05-21,9296
2547,日勝生,25,0,25,凱基-頭份,2024-05-21,9296
00940,元大台灣價值高息,27,4,23,凱基-頭份,2024-05-21,9296
1714,和桐,21,0,21,凱基-頭份,2024-05-21,9296
2888,新光金,30,9,21,凱基-頭份,2024-05-21,9296
3033,威健,15,0,15,凱基-頭份,2024-05-21,9296
2618,長榮航,39,26,13,凱基-頭份,2024-05-21,9296
00944,野村趨勢動能高息,13,0,13,凱基-頭份,2024-05-21,9296
4977,眾達-KY,13,0,13,凱基-頭份,2024-05-21,9296
8028,昇陽半導體,13,0,13,凱基-頭份,2024-05-21,9296
5903,全家,12,0,12,凱基-頭份,2024-05-21,9296
2701,萬企,11,0,11,凱基-頭份,2024-05-21,9296
5009,榮剛,11,0,11,凱基-頭份,2024-05-21,9296
00942B,台新美A公司債20+,10,0,10,凱基-頭份,2024-05-21,9296
1906,寶隆,10,0,10,凱基-頭份,2024-05-21,9296
2331,精英,10,0,10,凱基-頭份,2024-05-21,9296
2344,華邦電,10,0,10,凱基-頭份,2024-05-21,9296
2353,宏��,11,1,10,凱基-頭份,2024-05-21,9296
2402,毅嘉,10,0,10,凱基-頭份,2024-05-21,9296
4111,濟生,10,0,10,凱基-頭份,2024-05-21,9296
4174,浩鼎,10,0,10,凱基-頭份,2024-05-21,9296
5608,四維航,10,0,10,凱基-頭份,2024-05-21,9296
1504,東元,10,1,9,凱基-頭份,2024-05-21,9296
2515,中工,11,2,9,凱基-頭份,2024-05-21,9296
3450,聯鈞,10,1,9,凱基-頭份,2024-05-21,9296
4960,誠美材,11,2,9,凱基-頭份,2024-05-21,9296
00753L,中信中國50正2,7,0,7,凱基-頭份,2024-05-21,9296
5392,能率,16,9,7,凱基-頭份,2024-05-21,9296
00919,群益台灣精選高息,7,1,6,凱基-頭份,2024-05-21,9296
00715L,期街口布蘭特正2,6,0,6,凱基-頭份,2024-05-21,9296
2371,大同,6,0,6,凱基-頭份,2024-05-21,9296
2610,華航,6,0,6,凱基-頭份,2024-05-21,9296
3230,錦明,6,0,6,凱基-頭份,2024-05-21,9296
6274,台燿,6,0,6,凱基-頭份,2024-05-21,9296
8110,華東,11,5,6,凱基-頭份,2024-05-21,9296
1310,台苯,5,0,5,凱基-頭份,2024-05-21,9296
00706L,期元大S＆P日圓正2,5,0,5,凱基-頭份,2024-05-21,9296
00937B,群益ESG投等債20,668,0,668,凱基-頭份,2024-05-22,9296
3481,群創,640,104,536,凱基-頭份,2024-05-22,9296
00929,復華台灣科技優息,268,64,204,凱基-頭份,2024-05-22,9296
00882,中信中國高股息,151,1,150,凱基-頭份,2024-05-22,9296
2617,台航,73,0,73,凱基-頭份,2024-05-22,9296
2618,長榮航,66,2,64,凱基-頭份,2024-05-22,9296
2369,菱生,55,0,55,凱基-頭份,2024-05-22,9296
2812,台中銀,36,0,36,凱基-頭份,2024-05-22,9296
3666,光耀,30,0,30,凱基-頭份,2024-05-22,9296
2515,中工,26,1,25,凱基-頭份,2024-05-22,9296
6116,彩晶,21,0,21,凱基-頭份,2024-05-22,9296
2884,玉山金,30,10,20,凱基-頭份,2024-05-22,9296
2031,新光鋼,20,0,20,凱基-頭份,2024-05-22,9296
2520,冠德,25,5,20,凱基-頭份,2024-05-22,9296
00632R,元大台灣50反1,19,0,19,凱基-頭份,2024-05-22,9296
2316,楠梓電,15,0,15,凱基-頭份,2024-05-22,9296
5392,能率,30,18,12,凱基-頭份,2024-05-22,9296
2486,一詮,27,15,12,凱基-頭份,2024-05-22,9296
3338,泰碩,46,35,11,凱基-頭份,2024-05-22,9296
2605,新興,11,0,11,凱基-頭份,2024-05-22,9296
00664R,國泰臺灣加權反1,10,0,10,凱基-頭份,2024-05-22,9296
2363,矽統,16,6,10,凱基-頭份,2024-05-22,9296
4111,濟生,30,20,10,凱基-頭份,2024-05-22,9296
4533,協易機,12,2,10,凱基-頭份,2024-05-22,9296
3686,達能,10,1,9,凱基-頭份,2024-05-22,9296
8222,寶一,9,0,9,凱基-頭份,2024-05-22,9296
5291,邑昇,8,0,8,凱基-頭份,2024-05-22,9296
00940,元大台灣價值高息,8,0,8,凱基-頭份,2024-05-22,9296
2002,中鋼,8,0,8,凱基-頭份,2024-05-22,9296
2417,圓剛,13,5,8,凱基-頭份,2024-05-22,9296
2352,佳世達,7,0,7,凱基-頭份,2024-05-22,9296
2409,友達,23,16,7,凱基-頭份,2024-05-22,9296
2834,臺企銀,7,0,7,凱基-頭份,2024-05-22,9296
8438,昶昕,8,1,7,凱基-頭份,2024-05-22,9296
2504,國產,10,4,6,凱基-頭份,2024-05-22,9296
3051,力特,6,0,6,凱基-頭份,2024-05-22,9296
4909,新復興,6,0,6,凱基-頭份,2024-05-22,9296
6264,富裔,6,0,6,凱基-頭份,2024-05-22,9296
8284,三竹,5,0,5,凱基-頭份,2024-05-22,9296
2101,南港,5,0,5,凱基-頭份,2024-05-22,9296
2206,三陽工業,9,4,5,凱基-頭份,2024-05-22,9296
2613,中櫃,6,1,5,凱基-頭份,2024-05-22,9296
4961,天鈺,6,1,5,凱基-頭份,2024-05-22,9296
6546,正基,5,0,5,凱基-頭份,2024-05-22,9296
2915,潤泰全,5,1,4,凱基-頭份,2024-05-22,9296
3360,尚立,4,0,4,凱基-頭份,2024-05-22,9296
4956,光鋐,4,0,4,凱基-頭份,2024-05-22,9296
5347,世界,7,3,4,凱基-頭份,2024-05-22,9296
6231,系微,4,0,4,凱基-頭份,2024-05-22,9296
1447,力鵬,3,0,3,凱基-頭份,2024-05-22,9296
2630,亞航,98,1,97,凱基-頭份,2024-05-23,9296
00665L,富邦�琤肭磪囓�2,66,2,64,凱基-頭份,2024-05-23,9296
1815,富喬,170,109,61,凱基-頭份,2024-05-23,9296
2618,長榮航,62,3,59,凱基-頭份,2024-05-23,9296
2002,中鋼,56,5,51,凱基-頭份,2024-05-23,9296
2882,國泰金,49,0,49,凱基-頭份,2024-05-23,9296
00679B,元大美債20年,46,0,46,凱基-頭份,2024-05-23,9296
5452,佶優,50,4,46,凱基-頭份,2024-05-23,9296
2888,新光金,40,0,40,凱基-頭份,2024-05-23,9296
5443,均豪,57,20,37,凱基-頭份,2024-05-23,9296
00751B,元大AAA至A公司債,36,0,36,凱基-頭份,2024-05-23,9296
00664R,國泰臺灣加權反1,35,0,35,凱基-頭份,2024-05-23,9296
6257,矽格,35,0,35,凱基-頭份,2024-05-23,9296
2303,聯電,65,32,33,凱基-頭份,2024-05-23,9296
2353,宏��,44,16,28,凱基-頭份,2024-05-23,9296
00632R,元大台灣50反1,35,10,25,凱基-頭份,2024-05-23,9296
2887,台新金,25,0,25,凱基-頭份,2024-05-23,9296
3049,精金,24,0,24,凱基-頭份,2024-05-23,9296
3059,華晶科,24,0,24,凱基-頭份,2024-05-23,9296
3013,晟銘電,31,9,22,凱基-頭份,2024-05-23,9296
2845,遠東銀,21,0,21,凱基-頭份,2024-05-23,9296
2606,裕民,21,1,20,凱基-頭份,2024-05-23,9296
2031,新光鋼,20,0,20,凱基-頭份,2024-05-23,9296
6264,富裔,20,0,20,凱基-頭份,2024-05-23,9296
2009,第一銅,25,5,20,凱基-頭份,2024-05-23,9296
2331,精英,20,3,17,凱基-頭份,2024-05-23,9296
5009,榮剛,14,0,14,凱基-頭份,2024-05-23,9296
8096,擎亞,20,6,14,凱基-頭份,2024-05-23,9296
6770,力積電,25,11,14,凱基-頭份,2024-05-23,9296
2515,中工,13,0,13,凱基-頭份,2024-05-23,9296
6877,鏵友益,12,0,12,凱基-頭份,2024-05-23,9296
6217,中探針,11,0,11,凱基-頭份,2024-05-23,9296
8070,長華*,11,0,11,凱基-頭份,2024-05-23,9296
00940,元大台灣價值高息,13,2,11,凱基-頭份,2024-05-23,9296
2421,建準,12,1,11,凱基-頭份,2024-05-23,9296
00946,群益科技高息成長,12,2,10,凱基-頭份,2024-05-23,9296
00931B,統一美債20年,10,0,10,凱基-頭份,2024-05-23,9296
00642U,期元大S＆P石油,10,0,10,凱基-頭份,2024-05-23,9296
1416,廣豐,10,0,10,凱基-頭份,2024-05-23,9296
2367,燿華,15,5,10,凱基-頭份,2024-05-23,9296
2441,超豐,10,0,10,凱基-頭份,2024-05-23,9296
4513,福裕,10,0,10,凱基-頭份,2024-05-23,9296
5498,凱崴,10,0,10,凱基-頭份,2024-05-23,9296
2891,中信金,12,3,9,凱基-頭份,2024-05-23,9296
6005,群益證,9,0,9,凱基-頭份,2024-05-23,9296
9945,潤泰新,9,0,9,凱基-頭份,2024-05-23,9296
2101,南港,9,1,8,凱基-頭份,2024-05-23,9296
2409,友達,9,1,8,凱基-頭份,2024-05-23,9296
2324,仁寶,14,7,7,凱基-頭份,2024-05-23,9296
2405,輔信,9,2,7,凱基-頭份,2024-05-23,9296
2353,宏��,258,98,160,凱基-頭份,2024-05-24,9296
00929,復華台灣科技優息,86,1,85,凱基-頭份,2024-05-24,9296
00937B,群益ESG投等債20,67,0,67,凱基-頭份,2024-05-24,9296
6177,達麗,53,1,52,凱基-頭份,2024-05-24,9296
2303,聯電,61,21,40,凱基-頭份,2024-05-24,9296
8906,花王,31,0,31,凱基-頭份,2024-05-24,9296
2365,昆盈,54,27,27,凱基-頭份,2024-05-24,9296
00712,復華富時不動產,26,0,26,凱基-頭份,2024-05-24,9296
2891,中信金,25,0,25,凱基-頭份,2024-05-24,9296
2362,藍天,19,0,19,凱基-頭份,2024-05-24,9296
2377,微星,27,10,17,凱基-頭份,2024-05-24,9296
2002,中鋼,16,0,16,凱基-頭份,2024-05-24,9296
00940,元大台灣價值高息,18,3,15,凱基-頭份,2024-05-24,9296
00919,群益台灣精選高息,17,2,15,凱基-頭份,2024-05-24,9296
6147,頎邦,14,0,14,凱基-頭份,2024-05-24,9296
2884,玉山金,13,1,12,凱基-頭份,2024-05-24,9296
00933B,國泰10Y+金融債,11,0,11,凱基-頭份,2024-05-24,9296
4967,十銓,18,7,11,凱基-頭份,2024-05-24,9296
4979,華星光,17,6,11,凱基-頭份,2024-05-24,9296
6770,力積電,12,1,11,凱基-頭份,2024-05-24,9296
1218,泰山,10,0,10,凱基-頭份,2024-05-24,9296
1809,中釉,20,10,10,凱基-頭份,2024-05-24,9296
2417,圓剛,10,0,10,凱基-頭份,2024-05-24,9296
4960,誠美材,10,0,10,凱基-頭份,2024-05-24,9296
6269,台郡,10,0,10,凱基-頭份,2024-05-24,9296
6505,台塑化,9,0,9,凱基-頭份,2024-05-24,9296
3060,銘異,11,2,9,凱基-頭份,2024-05-24,9296
6877,鏵友益,9,0,9,凱基-頭份,2024-05-24,9296
1906,寶隆,8,0,8,凱基-頭份,2024-05-24,9296
3652,精聯,14,6,8,凱基-頭份,2024-05-24,9296
6152,百一,8,0,8,凱基-頭份,2024-05-24,9296
2206,三陽工業,7,0,7,凱基-頭份,2024-05-24,9296
2357,華碩,7,0,7,凱基-頭份,2024-05-24,9296
00936,台新永續高息中小,7,0,7,凱基-頭份,2024-05-24,9296
2888,新光金,11,4,7,凱基-頭份,2024-05-24,9296
1609,大亞,10,4,6,凱基-頭份,2024-05-24,9296
2515,中工,7,1,6,凱基-頭份,2024-05-24,9296
3545,敦泰,6,0,6,凱基-頭份,2024-05-24,9296
6451,訊芯-KY,6,0,6,凱基-頭份,2024-05-24,9296
3017,奇鋐,11,5,6,凱基-頭份,2024-05-24,9296
2486,一詮,27,22,5,凱基-頭份,2024-05-24,9296
00701,國泰股利精選30,5,0,5,凱基-頭份,2024-05-24,9296
00946,群益科技高息成長,5,0,5,凱基-頭份,2024-05-24,9296
2441,超豐,5,0,5,凱基-頭份,2024-05-24,9296
2444,兆勁,5,0,5,凱基-頭份,2024-05-24,9296
3176,基亞,5,0,5,凱基-頭份,2024-05-24,9296
3321,同泰,5,0,5,凱基-頭份,2024-05-24,9296
3576,聯合再生,5,0,5,凱基-頭份,2024-05-24,9296
5603,陸海,5,0,5,凱基-頭份,2024-05-24,9296
6264,富裔,5,0,5,凱基-頭份,2024-05-24,9296
2303,聯電,663,206,457,凱基-頭份,2024-05-27,9296
911868,同方友友-DR,300,0,300,凱基-頭份,2024-05-27,9296
2369,菱生,54,1,53,凱基-頭份,2024-05-27,9296
9105,泰金寶-DR,57,15,42,凱基-頭份,2024-05-27,9296
2377,微星,71,29,42,凱基-頭份,2024-05-27,9296
1815,富喬,63,22,41,凱基-頭份,2024-05-27,9296
2534,宏盛,40,0,40,凱基-頭份,2024-05-27,9296
3481,群創,42,7,35,凱基-頭份,2024-05-27,9296
00706L,期元大S＆P日圓正2,30,0,30,凱基-頭份,2024-05-27,9296
00712,復華富時不動產,29,0,29,凱基-頭份,2024-05-27,9296
2611,志信,30,1,29,凱基-頭份,2024-05-27,9296
2376,技嘉,36,7,29,凱基-頭份,2024-05-27,9296
00918,大華優利高填息30,26,0,26,凱基-頭份,2024-05-27,9296
2363,矽統,65,43,22,凱基-頭份,2024-05-27,9296
00945B,凱基美國非投等債,21,0,21,凱基-頭份,2024-05-27,9296
3202,樺晟,21,0,21,凱基-頭份,2024-05-27,9296
2317,鴻海,34,16,18,凱基-頭份,2024-05-27,9296
5452,佶優,20,2,18,凱基-頭份,2024-05-27,9296
8110,華東,18,0,18,凱基-頭份,2024-05-27,9296
6292,迅德,16,0,16,凱基-頭份,2024-05-27,9296
2615,萬海,16,1,15,凱基-頭份,2024-05-27,9296
2605,新興,14,0,14,凱基-頭份,2024-05-27,9296
2002,中鋼,14,0,14,凱基-頭份,2024-05-27,9296
2371,大同,13,0,13,凱基-頭份,2024-05-27,9296
2539,櫻花建,12,0,12,凱基-頭份,2024-05-27,9296
4906,正文,11,0,11,凱基-頭份,2024-05-27,9296
2609,陽明,25,15,10,凱基-頭份,2024-05-27,9296
00664R,國泰臺灣加權反1,10,0,10,凱基-頭份,2024-05-27,9296
2324,仁寶,12,2,10,凱基-頭份,2024-05-27,9296
2897,王道銀行,10,0,10,凱基-頭份,2024-05-27,9296
4532,瑞智,10,0,10,凱基-頭份,2024-05-27,9296
8112,至上,12,2,10,凱基-頭份,2024-05-27,9296
3213,茂訊,9,0,9,凱基-頭份,2024-05-27,9296
4533,協易機,16,7,9,凱基-頭份,2024-05-27,9296
6209,今國光,10,1,9,凱基-頭份,2024-05-27,9296
8054,安國,11,2,9,凱基-頭份,2024-05-27,9296
2338,光罩,15,7,8,凱基-頭份,2024-05-27,9296
2352,佳世達,9,1,8,凱基-頭份,2024-05-27,9296
6024,群益期,8,0,8,凱基-頭份,2024-05-27,9296
2464,盟立,10,2,8,凱基-頭份,2024-05-27,9296
9945,潤泰新,7,0,7,凱基-頭份,2024-05-27,9296
2337,旺宏,8,1,7,凱基-頭份,2024-05-27,9296
6147,頎邦,11,4,7,凱基-頭份,2024-05-27,9296
00942B,台新美A公司債20+,6,0,6,凱基-頭份,2024-05-27,9296
3234,光環,6,0,6,凱基-頭份,2024-05-27,9296
8222,寶一,6,0,6,凱基-頭份,2024-05-27,9296
2359,所羅門,6,0,6,凱基-頭份,2024-05-27,9296
2362,藍天,5,0,5,凱基-頭份,2024-05-27,9296
2637,慧洋-KY,5,0,5,凱基-頭份,2024-05-27,9296
3083,網龍,5,0,5,凱基-頭份,2024-05-27,9296
00650L,復華香港正2,170,0,170,凱基-頭份,2024-05-28,9296
5880,合庫金,100,0,100,凱基-頭份,2024-05-28,9296
00940,元大台灣價值高息,76,19,57,凱基-頭份,2024-05-28,9296
5426,振發,57,4,53,凱基-頭份,2024-05-28,9296
2617,台航,54,2,52,凱基-頭份,2024-05-28,9296
2606,裕民,51,3,48,凱基-頭份,2024-05-28,9296
2520,冠德,51,5,46,凱基-頭份,2024-05-28,9296
8299,群聯,42,0,42,凱基-頭份,2024-05-28,9296
00946,群益科技高息成長,32,0,32,凱基-頭份,2024-05-28,9296
2845,遠東銀,30,0,30,凱基-頭份,2024-05-28,9296
1815,富喬,56,32,24,凱基-頭份,2024-05-28,9296
2363,矽統,54,32,22,凱基-頭份,2024-05-28,9296
00632R,元大台灣50反1,20,0,20,凱基-頭份,2024-05-28,9296
00665L,富邦�琤肭磪囓�2,85,65,20,凱基-頭份,2024-05-28,9296
2206,三陽工業,25,5,20,凱基-頭份,2024-05-28,9296
00937B,群益ESG投等債20,43,24,19,凱基-頭份,2024-05-28,9296
3057,喬鼎,19,0,19,凱基-頭份,2024-05-28,9296
00918,大華優利高填息30,17,0,17,凱基-頭份,2024-05-28,9296
2353,宏��,36,22,14,凱基-頭份,2024-05-28,9296
00679B,元大美債20年,13,0,13,凱基-頭份,2024-05-28,9296
2538,基泰,13,0,13,凱基-頭份,2024-05-28,9296
00929,復華台灣科技優息,51,39,12,凱基-頭份,2024-05-28,9296
2417,圓剛,25,13,12,凱基-頭份,2024-05-28,9296
6166,凌華,12,0,12,凱基-頭份,2024-05-28,9296
8064,東捷,21,9,12,凱基-頭份,2024-05-28,9296
00712,復華富時不動產,12,0,12,凱基-頭份,2024-05-28,9296
4533,協易機,11,0,11,凱基-頭份,2024-05-28,9296
2401,凌陽,39,29,10,凱基-頭份,2024-05-28,9296
3105,穩懋,10,0,10,凱基-頭份,2024-05-28,9296
3293,鈊象,10,0,10,凱基-頭份,2024-05-28,9296
3673,TPK-KY,10,0,10,凱基-頭份,2024-05-28,9296
4503,金雨,10,0,10,凱基-頭份,2024-05-28,9296
4909,新復興,10,0,10,凱基-頭份,2024-05-28,9296
2317,鴻海,17,8,9,凱基-頭份,2024-05-28,9296
8210,勤誠,22,13,9,凱基-頭份,2024-05-28,9296
2301,光寶科,10,1,9,凱基-頭份,2024-05-28,9296
6005,群益證,9,0,9,凱基-頭份,2024-05-28,9296
3372,典範,8,0,8,凱基-頭份,2024-05-28,9296
6770,力積電,10,2,8,凱基-頭份,2024-05-28,9296
3035,智原,13,5,8,凱基-頭份,2024-05-28,9296
2337,旺宏,10,3,7,凱基-頭份,2024-05-28,9296
2371,大同,7,0,7,凱基-頭份,2024-05-28,9296
3234,光環,13,6,7,凱基-頭份,2024-05-28,9296
3594,磐儀,7,0,7,凱基-頭份,2024-05-28,9296
00933B,國泰10Y+金融債,6,0,6,凱基-頭份,2024-05-28,9296
2352,佳世達,6,0,6,凱基-頭份,2024-05-28,9296
5498,凱崴,6,0,6,凱基-頭份,2024-05-28,9296
2603,長榮,9,3,6,凱基-頭份,2024-05-28,9296
00942B,台新美A公司債20+,5,0,5,凱基-頭份,2024-05-28,9296
00647L,元大S＆P500正2,5,0,5,凱基-頭份,2024-05-28,9296
00937B,群益ESG投等債20,406,13,393,凱基-頭份,2024-05-29,9296
2401,凌陽,175,43,132,凱基-頭份,2024-05-29,9296
00632R,元大台灣50反1,85,0,85,凱基-頭份,2024-05-29,9296
2887,台新金,76,0,76,凱基-頭份,2024-05-29,9296
2520,冠德,55,0,55,凱基-頭份,2024-05-29,9296
1808,潤隆,40,0,40,凱基-頭份,2024-05-29,9296
2501,國建,88,48,40,凱基-頭份,2024-05-29,9296
5522,遠雄,36,0,36,凱基-頭份,2024-05-29,9296
2489,瑞軒,48,16,32,凱基-頭份,2024-05-29,9296
00650L,復華香港正2,30,0,30,凱基-頭份,2024-05-29,9296
2614,東森,28,0,28,凱基-頭份,2024-05-29,9296
00878,國泰永續高股息,24,0,24,凱基-頭份,2024-05-29,9296
2317,鴻海,23,0,23,凱基-頭份,2024-05-29,9296
2353,宏��,28,6,22,凱基-頭份,2024-05-29,9296
2890,永豐金,22,0,22,凱基-頭份,2024-05-29,9296
00915,凱基優選高股息30,21,0,21,凱基-頭份,2024-05-29,9296
2884,玉山金,20,0,20,凱基-頭份,2024-05-29,9296
2023,燁輝,20,0,20,凱基-頭份,2024-05-29,9296
2031,新光鋼,20,0,20,凱基-頭份,2024-05-29,9296
3090,日電貿,20,0,20,凱基-頭份,2024-05-29,9296
00942B,台新美A公司債20+,18,0,18,凱基-頭份,2024-05-29,9296
1618,合機,17,0,17,凱基-頭份,2024-05-29,9296
00857B,永豐20年美公債,15,0,15,凱基-頭份,2024-05-29,9296
2897,王道銀行,15,0,15,凱基-頭份,2024-05-29,9296
00772B,中信高評級公司債,14,0,14,凱基-頭份,2024-05-29,9296
4945,陞達科技,15,1,14,凱基-頭份,2024-05-29,9296
5521,工信,14,0,14,凱基-頭份,2024-05-29,9296
6005,群益證,14,0,14,凱基-頭份,2024-05-29,9296
00918,大華優利高填息30,13,0,13,凱基-頭份,2024-05-29,9296
1471,首利,16,3,13,凱基-頭份,2024-05-29,9296
5880,合庫金,12,0,12,凱基-頭份,2024-05-29,9296
00935,野村臺灣新科技50,12,0,12,凱基-頭份,2024-05-29,9296
1303,南亞,12,0,12,凱基-頭份,2024-05-29,9296
2344,華邦電,12,0,12,凱基-頭份,2024-05-29,9296
2409,友達,12,0,12,凱基-頭份,2024-05-29,9296
3710,連展投控,12,0,12,凱基-頭份,2024-05-29,9296
9945,潤泰新,12,0,12,凱基-頭份,2024-05-29,9296
3231,緯創,13,2,11,凱基-頭份,2024-05-29,9296
2002,中鋼,11,0,11,凱基-頭份,2024-05-29,9296
00933B,國泰10Y+金融債,10,0,10,凱基-頭份,2024-05-29,9296
00896,中信綠能及電動車,10,0,10,凱基-頭份,2024-05-29,9296
2362,藍天,10,0,10,凱基-頭份,2024-05-29,9296
3031,佰鴻,10,0,10,凱基-頭份,2024-05-29,9296
3202,樺晟,10,0,10,凱基-頭份,2024-05-29,9296
6264,富裔,10,0,10,凱基-頭份,2024-05-29,9296
3537,堡達,10,0,10,凱基-頭份,2024-05-29,9296
2476,鉅祥,10,1,9,凱基-頭份,2024-05-29,9296
2641,正德,11,2,9,凱基-頭份,2024-05-29,9296
3047,訊舟,10,1,9,凱基-頭份,2024-05-29,9296
4588,玖鼎電力,10,1,9,凱基-頭份,2024-05-29,9296
2405,輔信,132,0,132,凱基-頭份,2024-05-30,9296
00632R,元大台灣50反1,113,0,113,凱基-頭份,2024-05-30,9296
2892,第一金,102,0,102,凱基-頭份,2024-05-30,9296
2887,台新金,77,0,77,凱基-頭份,2024-05-30,9296
5876,上海商銀,51,0,51,凱基-頭份,2024-05-30,9296
00929,復華台灣科技優息,58,10,48,凱基-頭份,2024-05-30,9296
00937B,群益ESG投等債20,39,0,39,凱基-頭份,2024-05-30,9296
00878,國泰永續高股息,40,1,39,凱基-頭份,2024-05-30,9296
1815,富喬,105,71,34,凱基-頭份,2024-05-30,9296
3313,斐成,27,2,25,凱基-頭份,2024-05-30,9296
6152,百一,25,0,25,凱基-頭份,2024-05-30,9296
2886,兆豐金,24,0,24,凱基-頭份,2024-05-30,9296
00715L,期街口布蘭特正2,23,0,23,凱基-頭份,2024-05-30,9296
2379,瑞昱,45,22,23,凱基-頭份,2024-05-30,9296
3033,威健,28,6,22,凱基-頭份,2024-05-30,9296
6239,力成,21,0,21,凱基-頭份,2024-05-30,9296
2031,新光鋼,20,0,20,凱基-頭份,2024-05-30,9296
4967,十銓,27,7,20,凱基-頭份,2024-05-30,9296
00712,復華富時不動產,17,0,17,凱基-頭份,2024-05-30,9296
3059,華晶科,22,6,16,凱基-頭份,2024-05-30,9296
9945,潤泰新,16,0,16,凱基-頭份,2024-05-30,9296
00679B,元大美債20年,15,0,15,凱基-頭份,2024-05-30,9296
2408,南亞科,15,0,15,凱基-頭份,2024-05-30,9296
2002,中鋼,13,0,13,凱基-頭份,2024-05-30,9296
1589,永冠-KY,12,0,12,凱基-頭份,2024-05-30,9296
2344,華邦電,13,1,12,凱基-頭份,2024-05-30,9296
2514,龍邦,12,0,12,凱基-頭份,2024-05-30,9296
2701,萬企,12,0,12,凱基-頭份,2024-05-30,9296
2834,臺企銀,11,0,11,凱基-頭份,2024-05-30,9296
2009,第一銅,11,0,11,凱基-頭份,2024-05-30,9296
2537,聯上發,13,2,11,凱基-頭份,2024-05-30,9296
2888,新光金,14,3,11,凱基-頭份,2024-05-30,9296
5880,合庫金,11,0,11,凱基-頭份,2024-05-30,9296
2884,玉山金,11,0,11,凱基-頭份,2024-05-30,9296
3017,奇鋐,17,7,10,凱基-頭份,2024-05-30,9296
00673R,期元大S＆P原油反1,10,0,10,凱基-頭份,2024-05-30,9296
00918,大華優利高填息30,10,0,10,凱基-頭份,2024-05-30,9296
2438,翔耀,10,0,10,凱基-頭份,2024-05-30,9296
4157,太景*-KY,10,0,10,凱基-頭份,2024-05-30,9296
4945,陞達科技,10,0,10,凱基-頭份,2024-05-30,9296
3406,玉晶光,11,1,10,凱基-頭份,2024-05-30,9296
3441,聯一光,9,0,9,凱基-頭份,2024-05-30,9296
2353,宏��,27,19,8,凱基-頭份,2024-05-30,9296
1303,南亞,12,4,8,凱基-頭份,2024-05-30,9296
3230,錦明,8,0,8,凱基-頭份,2024-05-30,9296
3231,緯創,18,11,7,凱基-頭份,2024-05-30,9296
2328,廣宇,8,1,7,凱基-頭份,2024-05-30,9296
2489,瑞軒,7,0,7,凱基-頭份,2024-05-30,9296
6605,帝寶,10,3,7,凱基-頭份,2024-05-30,9296
2354,鴻準,12,5,7,凱基-頭份,2024-05-30,9296
00937B,群益ESG投等債20,2864,262,2602,凱基-頭份,2024-05-31,9296
1314,中石化,91,0,91,凱基-頭份,2024-05-31,9296
00929,復華台灣科技優息,72,0,72,凱基-頭份,2024-05-31,9296
6770,力積電,75,4,71,凱基-頭份,2024-05-31,9296
8906,花王,45,0,45,凱基-頭份,2024-05-31,9296
00680L,元大美債20正2,30,0,30,凱基-頭份,2024-05-31,9296
2609,陽明,351,324,27,凱基-頭份,2024-05-31,9296
00919,群益台灣精選高息,27,0,27,凱基-頭份,2024-05-31,9296
5608,四維航,24,1,23,凱基-頭份,2024-05-31,9296
00946,群益科技高息成長,21,0,21,凱基-頭份,2024-05-31,9296
3167,大量,20,0,20,凱基-頭份,2024-05-31,9296
00753L,中信中國50正2,18,0,18,凱基-頭份,2024-05-31,9296
00940,元大台灣價值高息,19,2,17,凱基-頭份,2024-05-31,9296
1301,台塑,16,0,16,凱基-頭份,2024-05-31,9296
3231,緯創,23,8,15,凱基-頭份,2024-05-31,9296
2344,華邦電,14,0,14,凱基-頭份,2024-05-31,9296
2486,一詮,17,4,13,凱基-頭份,2024-05-31,9296
3047,訊舟,13,1,12,凱基-頭份,2024-05-31,9296
2382,廣達,11,0,11,凱基-頭份,2024-05-31,9296
00642U,期元大S＆P石油,10,0,10,凱基-頭份,2024-05-31,9296
2066,世德,10,0,10,凱基-頭份,2024-05-31,9296
2618,長榮航,30,20,10,凱基-頭份,2024-05-31,9296
2801,彰銀,10,0,10,凱基-頭份,2024-05-31,9296
5469,瀚宇博,10,0,10,凱基-頭份,2024-05-31,9296
9919,康那香,10,0,10,凱基-頭份,2024-05-31,9296
00878,國泰永續高股息,10,1,9,凱基-頭份,2024-05-31,9296
00882,中信中國高股息,10,1,9,凱基-頭份,2024-05-31,9296
2028,威致,9,0,9,凱基-頭份,2024-05-31,9296
2606,裕民,10,1,9,凱基-頭份,2024-05-31,9296
2610,華航,10,1,9,凱基-頭份,2024-05-31,9296
3013,晟銘電,51,42,9,凱基-頭份,2024-05-31,9296
006208,富邦台50,9,0,9,凱基-頭份,2024-05-31,9296
2317,鴻海,25,17,8,凱基-頭份,2024-05-31,9296
0056,元大高股息,18,10,8,凱基-頭份,2024-05-31,9296
3051,力特,8,0,8,凱基-頭份,2024-05-31,9296
2002,中鋼,7,0,7,凱基-頭份,2024-05-31,9296
2489,瑞軒,7,0,7,凱基-頭份,2024-05-31,9296
2501,國建,28,21,7,凱基-頭份,2024-05-31,9296
2615,萬海,17,10,7,凱基-頭份,2024-05-31,9296
6147,頎邦,8,1,7,凱基-頭份,2024-05-31,9296
6461,益得,7,0,7,凱基-頭份,2024-05-31,9296
8227,巨有科技,8,1,7,凱基-頭份,2024-05-31,9296
2228,劍麟,7,1,6,凱基-頭份,2024-05-31,9296
1536,和大,7,1,6,凱基-頭份,2024-05-31,9296
2886,兆豐金,6,0,6,凱基-頭份,2024-05-31,9296
6005,群益證,6,0,6,凱基-頭份,2024-05-31,9296
6482,弘煜科,6,0,6,凱基-頭份,2024-05-31,9296
2330,台積電,16,10,6,凱基-頭份,2024-05-31,9296
00679B,元大美債20年,6,1,5,凱基-頭份,2024-05-31,9296
00939,統一台灣高息動能,5,0,5,凱基-頭份,2024-05-31,9296
00680L,元大美債20正2,220,0,220,凱基-頭份,2024-06-03,9296
00937B,群益ESG投等債20,180,11,169,凱基-頭份,2024-06-03,9296
4105,東洋,65,0,65,凱基-頭份,2024-06-03,9296
6895,宏碩系統,62,1,61,凱基-頭份,2024-06-03,9296
2363,矽統,67,10,57,凱基-頭份,2024-06-03,9296
2605,新興,39,2,37,凱基-頭份,2024-06-03,9296
00664R,國泰臺灣加權反1,30,0,30,凱基-頭份,2024-06-03,9296
00919,群益台灣精選高息,32,5,27,凱基-頭份,2024-06-03,9296
00946,群益科技高息成長,26,0,26,凱基-頭份,2024-06-03,9296
1314,中石化,22,0,22,凱基-頭份,2024-06-03,9296
2409,友達,20,0,20,凱基-頭份,2024-06-03,9296
2889,國票金,20,1,19,凱基-頭份,2024-06-03,9296
00720B,元大投資級公司債,19,0,19,凱基-頭份,2024-06-03,9296
3047,訊舟,21,2,19,凱基-頭份,2024-06-03,9296
1618,合機,18,0,18,凱基-頭份,2024-06-03,9296
3059,華晶科,21,3,18,凱基-頭份,2024-06-03,9296
6257,矽格,19,4,15,凱基-頭份,2024-06-03,9296
3450,聯鈞,15,1,14,凱基-頭份,2024-06-03,9296
2353,宏��,15,2,13,凱基-頭份,2024-06-03,9296
6163,華電網,20,7,13,凱基-頭份,2024-06-03,9296
1316,上曜,11,0,11,凱基-頭份,2024-06-03,9296
00923,群益台ESG低碳50,10,0,10,凱基-頭份,2024-06-03,9296
1711,永光,10,0,10,凱基-頭份,2024-06-03,9296
2312,金寶,10,0,10,凱基-頭份,2024-06-03,9296
00918,大華優利高填息30,11,2,9,凱基-頭份,2024-06-03,9296
2464,盟立,13,4,9,凱基-頭份,2024-06-03,9296
2330,台積電,11,2,9,凱基-頭份,2024-06-03,9296
3176,基亞,8,0,8,凱基-頭份,2024-06-03,9296
3481,群創,8,0,8,凱基-頭份,2024-06-03,9296
6179,亞通,8,0,8,凱基-頭份,2024-06-03,9296
00692,富邦公司治理,7,0,7,凱基-頭份,2024-06-03,9296
2615,萬海,59,52,7,凱基-頭份,2024-06-03,9296
6695,芯鼎,12,5,7,凱基-頭份,2024-06-03,9296
2317,鴻海,14,7,7,凱基-頭份,2024-06-03,9296
2002,中鋼,6,0,6,凱基-頭份,2024-06-03,9296
2303,聯電,7,1,6,凱基-頭份,2024-06-03,9296
3051,力特,6,0,6,凱基-頭份,2024-06-03,9296
3219,倚強科,6,0,6,凱基-頭份,2024-06-03,9296
3437,榮創,6,0,6,凱基-頭份,2024-06-03,9296
6535,順藥,6,0,6,凱基-頭份,2024-06-03,9296
00712,復華富時不動產,5,0,5,凱基-頭份,2024-06-03,9296
3265,台星科,5,0,5,凱基-頭份,2024-06-03,9296
2031,新光鋼,5,0,5,凱基-頭份,2024-06-03,9296
2880,華南金,5,0,5,凱基-頭份,2024-06-03,9296
3306,鼎天,5,0,5,凱基-頭份,2024-06-03,9296
4562,穎漢,7,2,5,凱基-頭份,2024-06-03,9296
6170,統振,5,0,5,凱基-頭份,2024-06-03,9296
00942B,台新美A公司債20+,5,1,4,凱基-頭份,2024-06-03,9296
2201,裕隆,4,0,4,凱基-頭份,2024-06-03,9296
6217,中探針,4,0,4,凱基-頭份,2024-06-03,9296
2888,新光金,120,12,108,凱基-頭份,2024-06-04,9296
00919,群益台灣精選高息,84,10,74,凱基-頭份,2024-06-04,9296
2312,金寶,48,1,47,凱基-頭份,2024-06-04,9296
3694,海華,41,1,40,凱基-頭份,2024-06-04,9296
00720B,元大投資級公司債,37,0,37,凱基-頭份,2024-06-04,9296
6133,金橋,39,2,37,凱基-頭份,2024-06-04,9296
2344,華邦電,37,1,36,凱基-頭份,2024-06-04,9296
00641R,富邦日本反1,30,0,30,凱基-頭份,2024-06-04,9296
00915,凱基優選高股息30,30,0,30,凱基-頭份,2024-06-04,9296
2002,中鋼,29,0,29,凱基-頭份,2024-06-04,9296
2337,旺宏,34,5,29,凱基-頭份,2024-06-04,9296
2889,國票金,23,0,23,凱基-頭份,2024-06-04,9296
4526,東台,23,2,21,凱基-頭份,2024-06-04,9296
3481,群創,24,3,21,凱基-頭份,2024-06-04,9296
1815,富喬,33,13,20,凱基-頭份,2024-06-04,9296
1906,寶隆,20,0,20,凱基-頭份,2024-06-04,9296
4566,時碩工業,24,4,20,凱基-頭份,2024-06-04,9296
00929,復華台灣科技優息,32,13,19,凱基-頭份,2024-06-04,9296
3706,神達,19,0,19,凱基-頭份,2024-06-04,9296
8234,新漢,14,0,14,凱基-頭份,2024-06-04,9296
5880,合庫金,13,0,13,凱基-頭份,2024-06-04,9296
3354,律勝,12,0,12,凱基-頭份,2024-06-04,9296
2317,鴻海,16,5,11,凱基-頭份,2024-06-04,9296
6125,廣運,28,17,11,凱基-頭份,2024-06-04,9296
2027,大成鋼,11,0,11,凱基-頭份,2024-06-04,9296
00642U,期元大S＆P石油,10,0,10,凱基-頭份,2024-06-04,9296
00722B,群益投資級電信債,10,0,10,凱基-頭份,2024-06-04,9296
00726B,國泰新興投等債,10,0,10,凱基-頭份,2024-06-04,9296
1714,和桐,10,0,10,凱基-頭份,2024-06-04,9296
2905,三商,10,0,10,凱基-頭份,2024-06-04,9296
3051,力特,10,0,10,凱基-頭份,2024-06-04,9296
8403,盛弘,10,0,10,凱基-頭份,2024-06-04,9296
3017,奇鋐,12,2,10,凱基-頭份,2024-06-04,9296
1522,堤維西,11,1,10,凱基-頭份,2024-06-04,9296
2324,仁寶,9,0,9,凱基-頭份,2024-06-04,9296
6290,良維,9,0,9,凱基-頭份,2024-06-04,9296
00878,國泰永續高股息,15,6,9,凱基-頭份,2024-06-04,9296
4967,十銓,16,7,9,凱基-頭份,2024-06-04,9296
00940,元大台灣價值高息,11,3,8,凱基-頭份,2024-06-04,9296
2886,兆豐金,8,0,8,凱基-頭份,2024-06-04,9296
2367,燿華,11,4,7,凱基-頭份,2024-06-04,9296
5291,邑昇,7,0,7,凱基-頭份,2024-06-04,9296
00713,元大台灣高息低波,6,0,6,凱基-頭份,2024-06-04,9296
1789,神隆,6,0,6,凱基-頭份,2024-06-04,9296
3013,晟銘電,7,1,6,凱基-頭份,2024-06-04,9296
5608,四維航,6,0,6,凱基-頭份,2024-06-04,9296
006208,富邦台50,5,0,5,凱基-頭份,2024-06-04,9296
2379,瑞昱,8,3,5,凱基-頭份,2024-06-04,9296
8936,國統,6,1,5,凱基-頭份,2024-06-04,9296
00712,復華富時不動產,5,0,5,凱基-頭份,2024-06-04,9296
00936,台新永續高息中小,160,50,110,凱基-頭份,2024-06-05,9296
00680L,元大美債20正2,101,0,101,凱基-頭份,2024-06-05,9296
00878,國泰永續高股息,75,2,73,凱基-頭份,2024-06-05,9296
2888,新光金,67,3,64,凱基-頭份,2024-06-05,9296
2605,新興,64,13,51,凱基-頭份,2024-06-05,9296
8069,元太,51,0,51,凱基-頭份,2024-06-05,9296
00937B,群益ESG投等債20,40,0,40,凱基-頭份,2024-06-05,9296
2537,聯上發,41,2,39,凱基-頭份,2024-06-05,9296
1455,集盛,38,0,38,凱基-頭份,2024-06-05,9296
8906,花王,34,0,34,凱基-頭份,2024-06-05,9296
00929,復華台灣科技優息,50,19,31,凱基-頭份,2024-06-05,9296
00706L,期元大S＆P日圓正2,31,0,31,凱基-頭份,2024-06-05,9296
6177,達麗,32,2,30,凱基-頭份,2024-06-05,9296
2331,精英,33,7,26,凱基-頭份,2024-06-05,9296
2105,正新,24,0,24,凱基-頭份,2024-06-05,9296
00919,群益台灣精選高息,25,2,23,凱基-頭份,2024-06-05,9296
00715L,期街口布蘭特正2,22,0,22,凱基-頭份,2024-06-05,9296
1413,宏洲,22,0,22,凱基-頭份,2024-06-05,9296
2356,英業達,22,0,22,凱基-頭份,2024-06-05,9296
00933B,國泰10Y+金融債,20,0,20,凱基-頭份,2024-06-05,9296
00898,國泰基因免疫革命,20,0,20,凱基-頭份,2024-06-05,9296
2886,兆豐金,20,0,20,凱基-頭份,2024-06-05,9296
6257,矽格,20,0,20,凱基-頭份,2024-06-05,9296
2337,旺宏,21,2,19,凱基-頭份,2024-06-05,9296
4116,明基醫,18,0,18,凱基-頭份,2024-06-05,9296
6895,宏碩系統,18,0,18,凱基-頭份,2024-06-05,9296
2002,中鋼,17,0,17,凱基-頭份,2024-06-05,9296
3694,海華,17,0,17,凱基-頭份,2024-06-05,9296
2610,華航,15,0,15,凱基-頭份,2024-06-05,9296
4566,時碩工業,15,0,15,凱基-頭份,2024-06-05,9296
3049,精金,13,0,13,凱基-頭份,2024-06-05,9296
2441,超豐,12,0,12,凱基-頭份,2024-06-05,9296
00679B,元大美債20年,16,5,11,凱基-頭份,2024-06-05,9296
3372,典範,14,3,11,凱基-頭份,2024-06-05,9296
00720B,元大投資級公司債,10,0,10,凱基-頭份,2024-06-05,9296
00710B,復華彭博非投等債,10,0,10,凱基-頭份,2024-06-05,9296
00726B,國泰新興投等債,10,0,10,凱基-頭份,2024-06-05,9296
2892,第一金,10,0,10,凱基-頭份,2024-06-05,9296
4303,信立,10,0,10,凱基-頭份,2024-06-05,9296
2312,金寶,10,1,9,凱基-頭份,2024-06-05,9296
2887,台新金,8,0,8,凱基-頭份,2024-06-05,9296
00918,大華優利高填息30,7,0,7,凱基-頭份,2024-06-05,9296
2303,聯電,19,12,7,凱基-頭份,2024-06-05,9296
4532,瑞智,7,0,7,凱基-頭份,2024-06-05,9296
4945,陞達科技,7,0,7,凱基-頭份,2024-06-05,9296
5371,中光電,8,1,7,凱基-頭份,2024-06-05,9296
1785,光洋科,7,0,7,凱基-頭份,2024-06-05,9296
2354,鴻準,16,10,6,凱基-頭份,2024-06-05,9296
2314,台揚,6,0,6,凱基-頭份,2024-06-05,9296
2369,菱生,6,0,6,凱基-頭份,2024-06-05,9296
00918,大華優利高填息30,1849,1,1848,凱基-頭份,2024-06-06,9296
00936,台新永續高息中小,54,20,34,凱基-頭份,2024-06-06,9296
2105,正新,25,0,25,凱基-頭份,2024-06-06,9296
5608,四維航,29,5,24,凱基-頭份,2024-06-06,9296
00664R,國泰臺灣加權反1,20,0,20,凱基-頭份,2024-06-06,9296
2611,志信,20,0,20,凱基-頭份,2024-06-06,9296
1815,富喬,34,15,19,凱基-頭份,2024-06-06,9296
00687B,國泰20年美債,17,0,17,凱基-頭份,2024-06-06,9296
2101,南港,18,2,16,凱基-頭份,2024-06-06,9296
2331,精英,17,2,15,凱基-頭份,2024-06-06,9296
2377,微星,16,2,14,凱基-頭份,2024-06-06,9296
2634,漢翔,15,1,14,凱基-頭份,2024-06-06,9296
1326,台化,14,0,14,凱基-頭份,2024-06-06,9296
00632R,元大台灣50反1,42,31,11,凱基-頭份,2024-06-06,9296
5347,世界,33,22,11,凱基-頭份,2024-06-06,9296
1305,華夏,16,6,10,凱基-頭份,2024-06-06,9296
00665L,富邦�琤肭磪囓�2,10,0,10,凱基-頭份,2024-06-06,9296
1413,宏洲,10,0,10,凱基-頭份,2024-06-06,9296
1714,和桐,10,0,10,凱基-頭份,2024-06-06,9296
1809,中釉,10,0,10,凱基-頭份,2024-06-06,9296
2314,台揚,10,0,10,凱基-頭份,2024-06-06,9296
2323,中環,10,0,10,凱基-頭份,2024-06-06,9296
2367,燿華,149,139,10,凱基-頭份,2024-06-06,9296
5302,太欣,12,2,10,凱基-頭份,2024-06-06,9296
6138,茂達,16,6,10,凱基-頭份,2024-06-06,9296
6189,豐藝,10,0,10,凱基-頭份,2024-06-06,9296
1101,台泥,10,0,10,凱基-頭份,2024-06-06,9296
00942B,台新美A公司債20+,9,0,9,凱基-頭份,2024-06-06,9296
2495,普安,9,0,9,凱基-頭份,2024-06-06,9296
3694,海華,9,0,9,凱基-頭份,2024-06-06,9296
00679B,元大美債20年,10,2,8,凱基-頭份,2024-06-06,9296
4438,廣越,8,0,8,凱基-頭份,2024-06-06,9296
6570,維田,8,0,8,凱基-頭份,2024-06-06,9296
2427,三商電,13,6,7,凱基-頭份,2024-06-06,9296
6505,台塑化,7,0,7,凱基-頭份,2024-06-06,9296
2613,中櫃,21,14,7,凱基-頭份,2024-06-06,9296
2356,英業達,6,0,6,凱基-頭份,2024-06-06,9296
2605,新興,16,10,6,凱基-頭份,2024-06-06,9296
6165,浪凡,6,0,6,凱基-頭份,2024-06-06,9296
6257,矽格,26,20,6,凱基-頭份,2024-06-06,9296
6451,訊芯-KY,8,2,6,凱基-頭份,2024-06-06,9296
00946,群益科技高息成長,12,7,5,凱基-頭份,2024-06-06,9296
1444,力麗,5,0,5,凱基-頭份,2024-06-06,9296
1906,寶隆,5,0,5,凱基-頭份,2024-06-06,9296
2440,太空梭,5,0,5,凱基-頭份,2024-06-06,9296
2462,良得電,5,0,5,凱基-頭份,2024-06-06,9296
2501,國建,6,1,5,凱基-頭份,2024-06-06,9296
2537,聯上發,28,23,5,凱基-頭份,2024-06-06,9296
2851,中再保,5,0,5,凱基-頭份,2024-06-06,9296
4960,誠美材,5,0,5,凱基-頭份,2024-06-06,9296
00929,復華台灣科技優息,191,0,191,凱基-頭份,2024-06-07,9296
9105,泰金寶-DR,60,0,60,凱基-頭份,2024-06-07,9296
2609,陽明,130,89,41,凱基-頭份,2024-06-07,9296
1609,大亞,36,10,26,凱基-頭份,2024-06-07,9296
2317,鴻海,24,0,24,凱基-頭份,2024-06-07,9296
8906,花王,22,0,22,凱基-頭份,2024-06-07,9296
2537,聯上發,42,22,20,凱基-頭份,2024-06-07,9296
1314,中石化,68,50,18,凱基-頭份,2024-06-07,9296
00941,中信上游半導體,17,0,17,凱基-頭份,2024-06-07,9296
3481,群創,30,13,17,凱基-頭份,2024-06-07,9296
00882,中信中國高股息,18,2,16,凱基-頭份,2024-06-07,9296
1714,和桐,25,10,15,凱基-頭份,2024-06-07,9296
4571,鈞興-KY,18,3,15,凱基-頭份,2024-06-07,9296
2615,萬海,34,21,13,凱基-頭份,2024-06-07,9296
2009,第一銅,13,0,13,凱基-頭份,2024-06-07,9296
3029,零壹,13,0,13,凱基-頭份,2024-06-07,9296
8064,東捷,17,4,13,凱基-頭份,2024-06-07,9296
2605,新興,31,20,11,凱基-頭份,2024-06-07,9296
2613,中櫃,17,6,11,凱基-頭份,2024-06-07,9296
4906,正文,12,1,11,凱基-頭份,2024-06-07,9296
6213,聯茂,12,1,11,凱基-頭份,2024-06-07,9296
00687B,國泰20年美債,11,1,10,凱基-頭份,2024-06-07,9296
00936,台新永續高息中小,10,0,10,凱基-頭份,2024-06-07,9296
1906,寶隆,10,0,10,凱基-頭份,2024-06-07,9296
2020,美亞,10,0,10,凱基-頭份,2024-06-07,9296
3694,海華,10,0,10,凱基-頭份,2024-06-07,9296
4960,誠美材,10,0,10,凱基-頭份,2024-06-07,9296
5603,陸海,10,0,10,凱基-頭份,2024-06-07,9296
1616,億泰,12,3,9,凱基-頭份,2024-06-07,9296
1316,上曜,10,2,8,凱基-頭份,2024-06-07,9296
2371,大同,41,33,8,凱基-頭份,2024-06-07,9296
00937B,群益ESG投等債20,13,6,7,凱基-頭份,2024-06-07,9296
2547,日勝生,10,3,7,凱基-頭份,2024-06-07,9296
6016,康和證,7,0,7,凱基-頭份,2024-06-07,9296
1710,東聯,6,0,6,凱基-頭份,2024-06-07,9296
2353,宏��,9,3,6,凱基-頭份,2024-06-07,9296
2641,正德,6,0,6,凱基-頭份,2024-06-07,9296
3508,位速,6,0,6,凱基-頭份,2024-06-07,9296
6239,力成,6,0,6,凱基-頭份,2024-06-07,9296
8033,雷虎,6,0,6,凱基-頭份,2024-06-07,9296
1582,信錦,5,0,5,凱基-頭份,2024-06-07,9296
2105,正新,5,0,5,凱基-頭份,2024-06-07,9296
2324,仁寶,5,0,5,凱基-頭份,2024-06-07,9296
2701,萬企,5,0,5,凱基-頭份,2024-06-07,9296
3321,同泰,5,0,5,凱基-頭份,2024-06-07,9296
5529,鉅陞,5,0,5,凱基-頭份,2024-06-07,9296
5871,中租-KY,5,0,5,凱基-頭份,2024-06-07,9296
6125,廣運,6,1,5,凱基-頭份,2024-06-07,9296
912000,晨訊科-DR,5,0,5,凱基-頭份,2024-06-07,9296
4123,晟德,15,11,4,凱基-頭份,2024-06-07,9296
1714,和桐,67,5,62,凱基-頭份,2024-06-11,9296
00929,復華台灣科技優息,58,1,57,凱基-頭份,2024-06-11,9296
5876,上海商銀,50,0,50,凱基-頭份,2024-06-11,9296
00937B,群益ESG投等債20,66,20,46,凱基-頭份,2024-06-11,9296
00918,大華優利高填息30,41,0,41,凱基-頭份,2024-06-11,9296
2609,陽明,134,93,41,凱基-頭份,2024-06-11,9296
2027,大成鋼,40,0,40,凱基-頭份,2024-06-11,9296
2516,新建,40,0,40,凱基-頭份,2024-06-11,9296
00936,台新永續高息中小,39,0,39,凱基-頭份,2024-06-11,9296
3047,訊舟,61,26,35,凱基-頭份,2024-06-11,9296
1618,合機,79,46,33,凱基-頭份,2024-06-11,9296
2888,新光金,30,0,30,凱基-頭份,2024-06-11,9296
1101,台泥,30,2,28,凱基-頭份,2024-06-11,9296
00687B,國泰20年美債,28,1,27,凱基-頭份,2024-06-11,9296
2867,三商壽,44,17,27,凱基-頭份,2024-06-11,9296
5608,四維航,29,5,24,凱基-頭份,2024-06-11,9296
00919,群益台灣精選高息,30,7,23,凱基-頭份,2024-06-11,9296
3234,光環,22,0,22,凱基-頭份,2024-06-11,9296
2031,新光鋼,20,0,20,凱基-頭份,2024-06-11,9296
4960,誠美材,20,0,20,凱基-頭份,2024-06-11,9296
9105,泰金寶-DR,20,0,20,凱基-頭份,2024-06-11,9296
1513,中興電,29,9,20,凱基-頭份,2024-06-11,9296
912000,晨訊科-DR,18,0,18,凱基-頭份,2024-06-11,9296
9946,三發地產,18,0,18,凱基-頭份,2024-06-11,9296
1316,上曜,17,1,16,凱基-頭份,2024-06-11,9296
1815,富喬,36,20,16,凱基-頭份,2024-06-11,9296
00939,統一台灣高息動能,15,0,15,凱基-頭份,2024-06-11,9296
00679B,元大美債20年,14,0,14,凱基-頭份,2024-06-11,9296
00882,中信中國高股息,21,7,14,凱基-頭份,2024-06-11,9296
3481,群創,13,0,13,凱基-頭份,2024-06-11,9296
2367,燿華,17,4,13,凱基-頭份,2024-06-11,9296
2501,國建,18,5,13,凱基-頭份,2024-06-11,9296
2002,中鋼,16,4,12,凱基-頭份,2024-06-11,9296
2449,京元電子,11,0,11,凱基-頭份,2024-06-11,9296
00713,元大台灣高息低波,13,2,11,凱基-頭份,2024-06-11,9296
2489,瑞軒,11,0,11,凱基-頭份,2024-06-11,9296
6125,廣運,13,3,10,凱基-頭份,2024-06-11,9296
1314,中石化,10,0,10,凱基-頭份,2024-06-11,9296
1455,集盛,10,0,10,凱基-頭份,2024-06-11,9296
2023,燁輝,10,0,10,凱基-頭份,2024-06-11,9296
2323,中環,10,0,10,凱基-頭份,2024-06-11,9296
3694,海華,10,0,10,凱基-頭份,2024-06-11,9296
6163,華電網,10,0,10,凱基-頭份,2024-06-11,9296
6213,聯茂,10,0,10,凱基-頭份,2024-06-11,9296
6219,富旺,10,0,10,凱基-頭份,2024-06-11,9296
6456,GIS-KY,9,0,9,凱基-頭份,2024-06-11,9296
2312,金寶,8,0,8,凱基-頭份,2024-06-11,9296
2353,宏��,8,0,8,凱基-頭份,2024-06-11,9296
3715,定穎投控,9,1,8,凱基-頭份,2024-06-11,9296
9945,潤泰新,12,4,8,凱基-頭份,2024-06-11,9296
00712,復華富時不動產,212,0,212,凱基-頭份,2024-06-12,9296
2888,新光金,155,13,142,凱基-頭份,2024-06-12,9296
2303,聯電,61,2,59,凱基-頭份,2024-06-12,9296
00929,復華台灣科技優息,33,1,32,凱基-頭份,2024-06-12,9296
4956,光鋐,31,0,31,凱基-頭份,2024-06-12,9296
00948B,中信優息投資級債,30,0,30,凱基-頭份,2024-06-12,9296
00936,台新永續高息中小,29,0,29,凱基-頭份,2024-06-12,9296
2606,裕民,31,4,27,凱基-頭份,2024-06-12,9296
2344,華邦電,30,4,26,凱基-頭份,2024-06-12,9296
2027,大成鋼,24,0,24,凱基-頭份,2024-06-12,9296
3694,海華,18,0,18,凱基-頭份,2024-06-12,9296
2486,一詮,25,9,16,凱基-頭份,2024-06-12,9296
9945,潤泰新,122,106,16,凱基-頭份,2024-06-12,9296
00878,國泰永續高股息,15,0,15,凱基-頭份,2024-06-12,9296
4123,晟德,15,0,15,凱基-頭份,2024-06-12,9296
2002,中鋼,18,4,14,凱基-頭份,2024-06-12,9296
00919,群益台灣精選高息,15,1,14,凱基-頭份,2024-06-12,9296
6177,達麗,15,2,13,凱基-頭份,2024-06-12,9296
2515,中工,12,0,12,凱基-頭份,2024-06-12,9296
3231,緯創,23,12,11,凱基-頭份,2024-06-12,9296
6456,GIS-KY,11,0,11,凱基-頭份,2024-06-12,9296
00674R,期元大S＆P黃金反1,10,0,10,凱基-頭份,2024-06-12,9296
1503,士電,10,0,10,凱基-頭份,2024-06-12,9296
1603,華電,10,0,10,凱基-頭份,2024-06-12,9296
1714,和桐,10,0,10,凱基-頭份,2024-06-12,9296
3455,由田,10,0,10,凱基-頭份,2024-06-12,9296
3645,達邁,10,0,10,凱基-頭份,2024-06-12,9296
6219,富旺,10,0,10,凱基-頭份,2024-06-12,9296
6264,富裔,10,0,10,凱基-頭份,2024-06-12,9296
2603,長榮,9,0,9,凱基-頭份,2024-06-12,9296
00632R,元大台灣50反1,8,0,8,凱基-頭份,2024-06-12,9296
2460,建通,8,0,8,凱基-頭份,2024-06-12,9296
4906,正文,11,3,8,凱基-頭份,2024-06-12,9296
6179,亞通,8,0,8,凱基-頭份,2024-06-12,9296
2412,中華電,7,0,7,凱基-頭份,2024-06-12,9296
3706,神達,7,0,7,凱基-頭份,2024-06-12,9296
4952,凌通,8,1,7,凱基-頭份,2024-06-12,9296
1514,亞力,10,4,6,凱基-頭份,2024-06-12,9296
1504,東元,11,5,6,凱基-頭份,2024-06-12,9296
5392,能率,14,8,6,凱基-頭份,2024-06-12,9296
3356,奇偶,6,1,5,凱基-頭份,2024-06-12,9296
00947,台新臺灣IC設計,5,0,5,凱基-頭份,2024-06-12,9296
1909,榮成,5,0,5,凱基-頭份,2024-06-12,9296
2353,宏��,5,0,5,凱基-頭份,2024-06-12,9296
3016,嘉晶,5,0,5,凱基-頭份,2024-06-12,9296
5498,凱崴,5,0,5,凱基-頭份,2024-06-12,9296
5871,中租-KY,5,0,5,凱基-頭份,2024-06-12,9296
6290,良維,8,3,5,凱基-頭份,2024-06-12,9296
8104,錸寶,5,0,5,凱基-頭份,2024-06-12,9296
2352,佳世達,13,9,4,凱基-頭份,2024-06-12,9296
00937B,群益ESG投等債20,153,0,153,凱基-頭份,2024-06-13,9296
00637L,元大滬深300正2,52,3,49,凱基-頭份,2024-06-13,9296
00680L,元大美債20正2,200,153,47,凱基-頭份,2024-06-13,9296
2888,新光金,40,0,40,凱基-頭份,2024-06-13,9296
00936,台新永續高息中小,74,37,37,凱基-頭份,2024-06-13,9296
8403,盛弘,30,0,30,凱基-頭份,2024-06-13,9296
3229,晟鈦,21,0,21,凱基-頭份,2024-06-13,9296
4960,誠美材,21,0,21,凱基-頭份,2024-06-13,9296
00664R,國泰臺灣加權反1,20,0,20,凱基-頭份,2024-06-13,9296
1714,和桐,20,0,20,凱基-頭份,2024-06-13,9296
2312,金寶,22,3,19,凱基-頭份,2024-06-13,9296
6877,鏵友益,16,0,16,凱基-頭份,2024-06-13,9296
6456,GIS-KY,15,0,15,凱基-頭份,2024-06-13,9296
2367,燿華,20,6,14,凱基-頭份,2024-06-13,9296
2605,新興,19,6,13,凱基-頭份,2024-06-13,9296
6546,正基,14,1,13,凱基-頭份,2024-06-13,9296
6216,居易,12,0,12,凱基-頭份,2024-06-13,9296
00947,台新臺灣IC設計,12,1,11,凱基-頭份,2024-06-13,9296
00882,中信中國高股息,11,0,11,凱基-頭份,2024-06-13,9296
2618,長榮航,14,3,11,凱基-頭份,2024-06-13,9296
00712,復華富時不動產,10,0,10,凱基-頭份,2024-06-13,9296
5388,中磊,10,0,10,凱基-頭份,2024-06-13,9296
00706L,期元大S＆P日圓正2,10,0,10,凱基-頭份,2024-06-13,9296
1455,集盛,10,0,10,凱基-頭份,2024-06-13,9296
2421,建準,10,0,10,凱基-頭份,2024-06-13,9296
3360,尚立,10,0,10,凱基-頭份,2024-06-13,9296
3535,晶彩科,10,0,10,凱基-頭份,2024-06-13,9296
3645,達邁,10,0,10,凱基-頭份,2024-06-13,9296
6125,廣運,13,3,10,凱基-頭份,2024-06-13,9296
8086,宏捷科,9,0,9,凱基-頭份,2024-06-13,9296
1608,華榮,9,1,8,凱基-頭份,2024-06-13,9296
4956,光鋐,8,0,8,凱基-頭份,2024-06-13,9296
6264,富裔,8,0,8,凱基-頭份,2024-06-13,9296
6733,博晟生醫,8,0,8,凱基-頭份,2024-06-13,9296
1617,榮星,39,31,8,凱基-頭份,2024-06-13,9296
1616,億泰,7,0,7,凱基-頭份,2024-06-13,9296
2365,昆盈,14,7,7,凱基-頭份,2024-06-13,9296
2615,萬海,20,13,7,凱基-頭份,2024-06-13,9296
2401,凌陽,7,1,6,凱基-頭份,2024-06-13,9296
3694,海華,6,0,6,凱基-頭份,2024-06-13,9296
1582,信錦,5,0,5,凱基-頭份,2024-06-13,9296
1806,冠軍,5,0,5,凱基-頭份,2024-06-13,9296
2066,世德,5,0,5,凱基-頭份,2024-06-13,9296
2101,南港,5,0,5,凱基-頭份,2024-06-13,9296
2105,正新,5,0,5,凱基-頭份,2024-06-13,9296
2457,飛宏,5,0,5,凱基-頭份,2024-06-13,9296
2534,宏盛,5,0,5,凱基-頭份,2024-06-13,9296
2603,長榮,10,5,5,凱基-頭份,2024-06-13,9296
2613,中櫃,22,17,5,凱基-頭份,2024-06-13,9296
3284,太普高,5,0,5,凱基-頭份,2024-06-13,9296
00929,復華台灣科技優息,121,30,91,凱基-頭份,2024-06-14,9296
2371,大同,109,35,74,凱基-頭份,2024-06-14,9296
00937B,群益ESG投等債20,83,46,37,凱基-頭份,2024-06-14,9296
4960,誠美材,34,0,34,凱基-頭份,2024-06-14,9296
00878,國泰永續高股息,44,13,31,凱基-頭份,2024-06-14,9296
2605,新興,34,5,29,凱基-頭份,2024-06-14,9296
2547,日勝生,25,0,25,凱基-頭份,2024-06-14,9296
00909,國泰數位支付服務,22,0,22,凱基-頭份,2024-06-14,9296
2520,冠德,22,1,21,凱基-頭份,2024-06-14,9296
2027,大成鋼,20,0,20,凱基-頭份,2024-06-14,9296
6456,GIS-KY,21,1,20,凱基-頭份,2024-06-14,9296
2537,聯上發,22,3,19,凱基-頭份,2024-06-14,9296
6138,茂達,17,0,17,凱基-頭份,2024-06-14,9296
4956,光鋐,16,0,16,凱基-頭份,2024-06-14,9296
8277,商丞,16,0,16,凱基-頭份,2024-06-14,9296
00674R,期元大S＆P黃金反1,20,5,15,凱基-頭份,2024-06-14,9296
00936,台新永續高息中小,14,0,14,凱基-頭份,2024-06-14,9296
00687B,國泰20年美債,16,2,14,凱基-頭份,2024-06-14,9296
1609,大亞,26,14,12,凱基-頭份,2024-06-14,9296
00947,台新臺灣IC設計,12,0,12,凱基-頭份,2024-06-14,9296
3032,偉訓,12,0,12,凱基-頭份,2024-06-14,9296
4976,佳凌,12,0,12,凱基-頭份,2024-06-14,9296
00946,群益科技高息成長,11,0,11,凱基-頭份,2024-06-14,9296
00673R,期元大S＆P原油反1,10,0,10,凱基-頭份,2024-06-14,9296
00713,元大台灣高息低波,10,0,10,凱基-頭份,2024-06-14,9296
1474,弘裕,10,0,10,凱基-頭份,2024-06-14,9296
1802,台玻,10,0,10,凱基-頭份,2024-06-14,9296
6895,宏碩系統,10,0,10,凱基-頭份,2024-06-14,9296
2014,中鴻,10,1,9,凱基-頭份,2024-06-14,9296
2363,矽統,58,49,9,凱基-頭份,2024-06-14,9296
6264,富裔,9,0,9,凱基-頭份,2024-06-14,9296
2609,陽明,30,22,8,凱基-頭份,2024-06-14,9296
2501,國建,9,1,8,凱基-頭份,2024-06-14,9296
2855,統一證,8,0,8,凱基-頭份,2024-06-14,9296
6877,鏵友益,8,0,8,凱基-頭份,2024-06-14,9296
2301,光寶科,7,0,7,凱基-頭份,2024-06-14,9296
6274,台燿,7,0,7,凱基-頭份,2024-06-14,9296
9105,泰金寶-DR,12,5,7,凱基-頭份,2024-06-14,9296
1815,富喬,7,1,6,凱基-頭份,2024-06-14,9296
1513,中興電,19,13,6,凱基-頭份,2024-06-14,9296
1504,東元,11,5,6,凱基-頭份,2024-06-14,9296
1612,宏泰,8,2,6,凱基-頭份,2024-06-14,9296
2002,中鋼,6,0,6,凱基-頭份,2024-06-14,9296
2353,宏��,7,1,6,凱基-頭份,2024-06-14,9296
2486,一詮,10,4,6,凱基-頭份,2024-06-14,9296
8906,花王,6,0,6,凱基-頭份,2024-06-14,9296
9933,中鼎,8,2,6,凱基-頭份,2024-06-14,9296
6488,環球晶,6,0,6,凱基-頭份,2024-06-14,9296
00706L,期元大S＆P日圓正2,5,0,5,凱基-頭份,2024-06-14,9296
00692,富邦公司治理,5,0,5,凱基-頭份,2024-06-14,9296
00929,復華台灣科技優息,185,93,92,凱基-頭份,2024-06-17,9296
1718,中纖,90,0,90,凱基-頭份,2024-06-17,9296
00918,大華優利高填息30,75,1,74,凱基-頭份,2024-06-17,9296
1906,寶隆,70,0,70,凱基-頭份,2024-06-17,9296
00937B,群益ESG投等債20,43,3,40,凱基-頭份,2024-06-17,9296
1616,億泰,44,5,39,凱基-頭份,2024-06-17,9296
9919,康那香,32,0,32,凱基-頭份,2024-06-17,9296
00936,台新永續高息中小,100,76,24,凱基-頭份,2024-06-17,9296
2352,佳世達,22,0,22,凱基-頭份,2024-06-17,9296
4956,光鋐,23,1,22,凱基-頭份,2024-06-17,9296
00933B,國泰10Y+金融債,21,0,21,凱基-頭份,2024-06-17,9296
9105,泰金寶-DR,87,67,20,凱基-頭份,2024-06-17,9296
2605,新興,20,0,20,凱基-頭份,2024-06-17,9296
3032,偉訓,20,0,20,凱基-頭份,2024-06-17,9296
2515,中工,22,4,18,凱基-頭份,2024-06-17,9296
00919,群益台灣精選高息,19,2,17,凱基-頭份,2024-06-17,9296
00687B,國泰20年美債,20,3,17,凱基-頭份,2024-06-17,9296
2888,新光金,15,0,15,凱基-頭份,2024-06-17,9296
1609,大亞,27,13,14,凱基-頭份,2024-06-17,9296
9946,三發地產,14,0,14,凱基-頭份,2024-06-17,9296
1608,華榮,17,4,13,凱基-頭份,2024-06-17,9296
5880,合庫金,13,0,13,凱基-頭份,2024-06-17,9296
2884,玉山金,12,1,11,凱基-頭份,2024-06-17,9296
00751B,元大AAA至A公司債,10,0,10,凱基-頭份,2024-06-17,9296
00722B,群益投資級電信債,10,0,10,凱基-頭份,2024-06-17,9296
1732,毛寶,10,0,10,凱基-頭份,2024-06-17,9296
2101,南港,11,1,10,凱基-頭份,2024-06-17,9296
2438,翔耀,10,0,10,凱基-頭份,2024-06-17,9296
2485,兆赫,10,0,10,凱基-頭份,2024-06-17,9296
3694,海華,10,0,10,凱基-頭份,2024-06-17,9296
2615,萬海,20,11,9,凱基-頭份,2024-06-17,9296
00878,國泰永續高股息,9,0,9,凱基-頭份,2024-06-17,9296
1618,合機,23,14,9,凱基-頭份,2024-06-17,9296
6877,鏵友益,9,0,9,凱基-頭份,2024-06-17,9296
6290,良維,12,3,9,凱基-頭份,2024-06-17,9296
1532,勤美,8,0,8,凱基-頭份,2024-06-17,9296
3374,精材,9,1,8,凱基-頭份,2024-06-17,9296
2501,國建,9,1,8,凱基-頭份,2024-06-17,9296
2897,王道銀行,8,0,8,凱基-頭份,2024-06-17,9296
6153,嘉聯益,8,0,8,凱基-頭份,2024-06-17,9296
1734,杏輝,8,1,7,凱基-頭份,2024-06-17,9296
4967,十銓,7,0,7,凱基-頭份,2024-06-17,9296
00713,元大台灣高息低波,8,1,7,凱基-頭份,2024-06-17,9296
1514,亞力,19,13,6,凱基-頭份,2024-06-17,9296
2356,英業達,6,0,6,凱基-頭份,2024-06-17,9296
2616,山隆,6,0,6,凱基-頭份,2024-06-17,9296
8027,鈦昇,6,0,6,凱基-頭份,2024-06-17,9296
00674R,期元大S＆P黃金反1,5,0,5,凱基-頭份,2024-06-17,9296
1445,大宇,5,0,5,凱基-頭份,2024-06-17,9296
2066,世德,5,0,5,凱基-頭份,2024-06-17,9296
2883,凱基金,3168,0,3168,凱基-頭份,2024-06-18,9296
00680L,元大美債20正2,100,2,98,凱基-頭份,2024-06-18,9296
00937B,群益ESG投等債20,70,11,59,凱基-頭份,2024-06-18,9296
00948B,中信優息投資級債,57,0,57,凱基-頭份,2024-06-18,9296
00713,元大台灣高息低波,43,0,43,凱基-頭份,2024-06-18,9296
2371,大同,53,15,38,凱基-頭份,2024-06-18,9296
2605,新興,36,0,36,凱基-頭份,2024-06-18,9296
2881,富邦金,30,1,29,凱基-頭份,2024-06-18,9296
00637L,元大滬深300正2,28,1,27,凱基-頭份,2024-06-18,9296
00882,中信中國高股息,22,0,22,凱基-頭份,2024-06-18,9296
00632R,元大台灣50反1,22,0,22,凱基-頭份,2024-06-18,9296
3535,晶彩科,24,2,22,凱基-頭份,2024-06-18,9296
2472,立隆電,20,0,20,凱基-頭份,2024-06-18,9296
1326,台化,16,2,14,凱基-頭份,2024-06-18,9296
4977,眾達-KY,13,0,13,凱基-頭份,2024-06-18,9296
6116,彩晶,13,0,13,凱基-頭份,2024-06-18,9296
3481,群創,13,0,13,凱基-頭份,2024-06-18,9296
00929,復華台灣科技優息,23,11,12,凱基-頭份,2024-06-18,9296
2002,中鋼,12,0,12,凱基-頭份,2024-06-18,9296
5490,同亨,18,6,12,凱基-頭份,2024-06-18,9296
00673R,期元大S＆P原油反1,10,0,10,凱基-頭份,2024-06-18,9296
00722B,群益投資級電信債,20,10,10,凱基-頭份,2024-06-18,9296
1474,弘裕,10,0,10,凱基-頭份,2024-06-18,9296
1701,中化,10,0,10,凱基-頭份,2024-06-18,9296
2312,金寶,10,0,10,凱基-頭份,2024-06-18,9296
2323,中環,10,0,10,凱基-頭份,2024-06-18,9296
4105,東洋,10,0,10,凱基-頭份,2024-06-18,9296
6895,宏碩系統,13,3,10,凱基-頭份,2024-06-18,9296
00941,中信上游半導體,10,1,9,凱基-頭份,2024-06-18,9296
2489,瑞軒,9,0,9,凱基-頭份,2024-06-18,9296
00909,國泰數位支付服務,8,0,8,凱基-頭份,2024-06-18,9296
5880,合庫金,9,1,8,凱基-頭份,2024-06-18,9296
4526,東台,8,0,8,凱基-頭份,2024-06-18,9296
00710B,復華彭博非投等債,7,0,7,凱基-頭份,2024-06-18,9296
6166,凌華,7,0,7,凱基-頭份,2024-06-18,9296
2392,正崴,9,3,6,凱基-頭份,2024-06-18,9296
00631L,元大台灣50正2,6,0,6,凱基-頭份,2024-06-18,9296
00830,國泰費城半導體,6,0,6,凱基-頭份,2024-06-18,9296
1325,恆大,6,0,6,凱基-頭份,2024-06-18,9296
2385,群光,6,0,6,凱基-頭份,2024-06-18,9296
8096,擎亞,30,24,6,凱基-頭份,2024-06-18,9296
00891,中信關鍵半導體,5,0,5,凱基-頭份,2024-06-18,9296
2867,三商壽,5,0,5,凱基-頭份,2024-06-18,9296
4142,國光生,10,5,5,凱基-頭份,2024-06-18,9296
4566,時碩工業,12,7,5,凱基-頭份,2024-06-18,9296
9945,潤泰新,6,1,5,凱基-頭份,2024-06-18,9296
1514,亞力,14,9,5,凱基-頭份,2024-06-18,9296
6546,正基,7,3,4,凱基-頭份,2024-06-18,9296
00921,兆豐龍頭等權重,4,0,4,凱基-頭份,2024-06-18,9296
1609,大亞,4,0,4,凱基-頭份,2024-06-18,9296
2812,台中銀,220,0,220,凱基-頭份,2024-06-19,9296
2303,聯電,47,3,44,凱基-頭份,2024-06-19,9296
00937B,群益ESG投等債20,31,0,31,凱基-頭份,2024-06-19,9296
2353,宏��,29,0,29,凱基-頭份,2024-06-19,9296
00919,群益台灣精選高息,37,16,21,凱基-頭份,2024-06-19,9296
00637L,元大滬深300正2,20,0,20,凱基-頭份,2024-06-19,9296
00664R,國泰臺灣加權反1,20,0,20,凱基-頭份,2024-06-19,9296
2027,大成鋼,21,1,20,凱基-頭份,2024-06-19,9296
5871,中租-KY,20,0,20,凱基-頭份,2024-06-19,9296
00712,復華富時不動產,19,0,19,凱基-頭份,2024-06-19,9296
2365,昆盈,32,14,18,凱基-頭份,2024-06-19,9296
3062,建漢,19,3,16,凱基-頭份,2024-06-19,9296
00940,元大台灣價值高息,51,35,16,凱基-頭份,2024-06-19,9296
00882,中信中國高股息,18,2,16,凱基-頭份,2024-06-19,9296
2337,旺宏,21,5,16,凱基-頭份,2024-06-19,9296
00710B,復華彭博非投等債,15,0,15,凱基-頭份,2024-06-19,9296
9105,泰金寶-DR,14,1,13,凱基-頭份,2024-06-19,9296
8112,至上,13,0,13,凱基-頭份,2024-06-19,9296
00885,富邦越南,12,0,12,凱基-頭份,2024-06-19,9296
4726,永昕,15,3,12,凱基-頭份,2024-06-19,9296
6465,威潤,12,0,12,凱基-頭份,2024-06-19,9296
3325,旭品,11,0,11,凱基-頭份,2024-06-19,9296
00713,元大台灣高息低波,11,0,11,凱基-頭份,2024-06-19,9296
00751B,元大AAA至A公司債,10,0,10,凱基-頭份,2024-06-19,9296
00918,大華優利高填息30,28,18,10,凱基-頭份,2024-06-19,9296
1616,億泰,10,0,10,凱基-頭份,2024-06-19,9296
2323,中環,10,0,10,凱基-頭份,2024-06-19,9296
4566,時碩工業,18,8,10,凱基-頭份,2024-06-19,9296
6160,欣技,10,0,10,凱基-頭份,2024-06-19,9296
00946,群益科技高息成長,10,0,10,凱基-頭份,2024-06-19,9296
6770,力積電,40,31,9,凱基-頭份,2024-06-19,9296
2354,鴻準,10,2,8,凱基-頭份,2024-06-19,9296
2355,敬鵬,8,0,8,凱基-頭份,2024-06-19,9296
6558,興能高,8,0,8,凱基-頭份,2024-06-19,9296
1815,富喬,11,3,8,凱基-頭份,2024-06-19,9296
2412,中華電,7,0,7,凱基-頭份,2024-06-19,9296
2915,潤泰全,7,0,7,凱基-頭份,2024-06-19,9296
00900,富邦特選高股息30,6,0,6,凱基-頭份,2024-06-19,9296
2392,正崴,7,1,6,凱基-頭份,2024-06-19,9296
2408,南亞科,9,3,6,凱基-頭份,2024-06-19,9296
4956,光鋐,8,2,6,凱基-頭份,2024-06-19,9296
5340,建榮,7,1,6,凱基-頭份,2024-06-19,9296
8021,尖點,6,0,6,凱基-頭份,2024-06-19,9296
4533,協易機,5,0,5,凱基-頭份,2024-06-19,9296
00679B,元大美債20年,8,3,5,凱基-頭份,2024-06-19,9296
00915,凱基優選高股息30,5,0,5,凱基-頭份,2024-06-19,9296
1806,冠軍,5,0,5,凱基-頭份,2024-06-19,9296
2002,中鋼,5,0,5,凱基-頭份,2024-06-19,9296
2401,凌陽,5,0,5,凱基-頭份,2024-06-19,9296
2511,太子,5,0,5,凱基-頭份,2024-06-19,9296
00940,元大台灣價值高息,227,2,225,凱基-頭份,2024-06-20,9296
00878,國泰永續高股息,118,9,109,凱基-頭份,2024-06-20,9296
2812,台中銀,83,0,83,凱基-頭份,2024-06-20,9296
00937B,群益ESG投等債20,80,0,80,凱基-頭份,2024-06-20,9296
00929,復華台灣科技優息,68,12,56,凱基-頭份,2024-06-20,9296
2888,新光金,32,0,32,凱基-頭份,2024-06-20,9296
2363,矽統,85,56,29,凱基-頭份,2024-06-20,9296
00680L,元大美債20正2,24,0,24,凱基-頭份,2024-06-20,9296
2459,敦吉,24,0,24,凱基-頭份,2024-06-20,9296
00915,凱基優選高股息30,22,0,22,凱基-頭份,2024-06-20,9296
2634,漢翔,20,0,20,凱基-頭份,2024-06-20,9296
3374,精材,26,8,18,凱基-頭份,2024-06-20,9296
6190,萬泰科,20,3,17,凱基-頭份,2024-06-20,9296
5880,合庫金,16,0,16,凱基-頭份,2024-06-20,9296
00751B,元大AAA至A公司債,15,0,15,凱基-頭份,2024-06-20,9296
00632R,元大台灣50反1,20,5,15,凱基-頭份,2024-06-20,9296
00900,富邦特選高股息30,15,0,15,凱基-頭份,2024-06-20,9296
2609,陽明,26,11,15,凱基-頭份,2024-06-20,9296
2353,宏��,16,2,14,凱基-頭份,2024-06-20,9296
2440,太空梭,15,2,13,凱基-頭份,2024-06-20,9296
2618,長榮航,18,5,13,凱基-頭份,2024-06-20,9296
2352,佳世達,13,2,11,凱基-頭份,2024-06-20,9296
1455,集盛,10,0,10,凱基-頭份,2024-06-20,9296
1906,寶隆,10,0,10,凱基-頭份,2024-06-20,9296
00891,中信關鍵半導體,10,0,10,凱基-頭份,2024-06-20,9296
2324,仁寶,11,2,9,凱基-頭份,2024-06-20,9296
3623,富晶通,9,0,9,凱基-頭份,2024-06-20,9296
00882,中信中國高股息,8,0,8,凱基-頭份,2024-06-20,9296
6456,GIS-KY,10,2,8,凱基-頭份,2024-06-20,9296
8096,擎亞,14,6,8,凱基-頭份,2024-06-20,9296
00919,群益台灣精選高息,22,15,7,凱基-頭份,2024-06-20,9296
00679B,元大美債20年,7,0,7,凱基-頭份,2024-06-20,9296
00945B,凱基美國非投等債,7,0,7,凱基-頭份,2024-06-20,9296
2515,中工,8,1,7,凱基-頭份,2024-06-20,9296
2002,中鋼,10,4,6,凱基-頭份,2024-06-20,9296
1301,台塑,6,0,6,凱基-頭份,2024-06-20,9296
1409,新纖,6,0,6,凱基-頭份,2024-06-20,9296
2613,中櫃,6,0,6,凱基-頭份,2024-06-20,9296
2836,高雄銀,6,0,6,凱基-頭份,2024-06-20,9296
2889,國票金,6,0,6,凱基-頭份,2024-06-20,9296
3234,光環,6,0,6,凱基-頭份,2024-06-20,9296
1514,亞力,20,14,6,凱基-頭份,2024-06-20,9296
006208,富邦台50,5,0,5,凱基-頭份,2024-06-20,9296
1513,中興電,8,3,5,凱基-頭份,2024-06-20,9296
1326,台化,5,0,5,凱基-頭份,2024-06-20,9296
1737,臺鹽,5,0,5,凱基-頭份,2024-06-20,9296
1815,富喬,13,8,5,凱基-頭份,2024-06-20,9296
3306,鼎天,5,0,5,凱基-頭份,2024-06-20,9296
3372,典範,5,0,5,凱基-頭份,2024-06-20,9296
3694,海華,5,0,5,凱基-頭份,2024-06-20,9296
00936,台新永續高息中小,144,0,144,凱基-頭份,2024-06-21,9296
00947,台新臺灣IC設計,100,0,100,凱基-頭份,2024-06-21,9296
00679B,元大美債20年,98,0,98,凱基-頭份,2024-06-21,9296
00937B,群益ESG投等債20,90,0,90,凱基-頭份,2024-06-21,9296
00919,群益台灣精選高息,72,16,56,凱基-頭份,2024-06-21,9296
2363,矽統,48,2,46,凱基-頭份,2024-06-21,9296
00881,國泰台灣5G+,27,0,27,凱基-頭份,2024-06-21,9296
2317,鴻海,55,28,27,凱基-頭份,2024-06-21,9296
00673R,期元大S＆P原油反1,22,0,22,凱基-頭份,2024-06-21,9296
6219,富旺,20,0,20,凱基-頭份,2024-06-21,9296
00931B,統一美債20年,19,0,19,凱基-頭份,2024-06-21,9296
3163,波若威,19,0,19,凱基-頭份,2024-06-21,9296
00933B,國泰10Y+金融債,19,2,17,凱基-頭份,2024-06-21,9296
1618,合機,29,12,17,凱基-頭份,2024-06-21,9296
5452,佶優,16,0,16,凱基-頭份,2024-06-21,9296
2537,聯上發,15,0,15,凱基-頭份,2024-06-21,9296
3694,海華,12,0,12,凱基-頭份,2024-06-21,9296
8105,凌巨,12,0,12,凱基-頭份,2024-06-21,9296
00885,富邦越南,11,0,11,凱基-頭份,2024-06-21,9296
2498,宏達電,16,5,11,凱基-頭份,2024-06-21,9296
8054,安國,11,0,11,凱基-頭份,2024-06-21,9296
00915,凱基優選高股息30,10,0,10,凱基-頭份,2024-06-21,9296
3712,永崴投控,10,0,10,凱基-頭份,2024-06-21,9296
2392,正崴,13,3,10,凱基-頭份,2024-06-21,9296
00712,復華富時不動產,14,5,9,凱基-頭份,2024-06-21,9296
00882,中信中國高股息,10,1,9,凱基-頭份,2024-06-21,9296
4526,東台,15,6,9,凱基-頭份,2024-06-21,9296
00946,群益科技高息成長,8,0,8,凱基-頭份,2024-06-21,9296
2412,中華電,8,0,8,凱基-頭份,2024-06-21,9296
00713,元大台灣高息低波,8,1,7,凱基-頭份,2024-06-21,9296
6499,益安,7,0,7,凱基-頭份,2024-06-21,9296
2515,中工,9,3,6,凱基-頭份,2024-06-21,9296
1603,華電,6,0,6,凱基-頭份,2024-06-21,9296
2356,英業達,13,7,6,凱基-頭份,2024-06-21,9296
2516,新建,6,0,6,凱基-頭份,2024-06-21,9296
5468,凱鈺,6,0,6,凱基-頭份,2024-06-21,9296
5871,中租-KY,9,3,6,凱基-頭份,2024-06-21,9296
8906,花王,6,0,6,凱基-頭份,2024-06-21,9296
2492,華新科,7,1,6,凱基-頭份,2024-06-21,9296
1560,中砂,6,1,5,凱基-頭份,2024-06-21,9296
00902,中信電池及儲能,5,0,5,凱基-頭份,2024-06-21,9296
00900,富邦特選高股息30,5,0,5,凱基-頭份,2024-06-21,9296
00722B,群益投資級電信債,5,0,5,凱基-頭份,2024-06-21,9296
1906,寶隆,5,0,5,凱基-頭份,2024-06-21,9296
2324,仁寶,5,0,5,凱基-頭份,2024-06-21,9296
2385,群光,5,0,5,凱基-頭份,2024-06-21,9296
2402,毅嘉,5,0,5,凱基-頭份,2024-06-21,9296
2520,冠德,6,1,5,凱基-頭份,2024-06-21,9296
3305,昇貿,12,7,5,凱基-頭份,2024-06-21,9296
6112,邁達特,5,0,5,凱基-頭份,2024-06-21,9296
2812,台中銀,200,1,199,凱基-頭份,2024-06-24,9296
3481,群創,218,62,156,凱基-頭份,2024-06-24,9296
00929,復華台灣科技優息,101,14,87,凱基-頭份,2024-06-24,9296
00919,群益台灣精選高息,94,10,84,凱基-頭份,2024-06-24,9296
2888,新光金,60,1,59,凱基-頭份,2024-06-24,9296
00937B,群益ESG投等債20,35,0,35,凱基-頭份,2024-06-24,9296
2409,友達,55,25,30,凱基-頭份,2024-06-24,9296
2615,萬海,51,22,29,凱基-頭份,2024-06-24,9296
1785,光洋科,33,8,25,凱基-頭份,2024-06-24,9296
00878,國泰永續高股息,25,2,23,凱基-頭份,2024-06-24,9296
00909,國泰數位支付服務,22,0,22,凱基-頭份,2024-06-24,9296
2324,仁寶,21,0,21,凱基-頭份,2024-06-24,9296
2889,國票金,20,0,20,凱基-頭份,2024-06-24,9296
4956,光鋐,20,0,20,凱基-頭份,2024-06-24,9296
1752,南光,19,0,19,凱基-頭份,2024-06-24,9296
3062,建漢,60,42,18,凱基-頭份,2024-06-24,9296
8277,商丞,20,3,17,凱基-頭份,2024-06-24,9296
3588,通嘉,16,0,16,凱基-頭份,2024-06-24,9296
1101,台泥,14,0,14,凱基-頭份,2024-06-24,9296
4111,濟生,15,1,14,凱基-頭份,2024-06-24,9296
00923,群益台ESG低碳50,13,0,13,凱基-頭份,2024-06-24,9296
2353,宏��,13,0,13,凱基-頭份,2024-06-24,9296
8906,花王,13,0,13,凱基-頭份,2024-06-24,9296
2352,佳世達,12,1,11,凱基-頭份,2024-06-24,9296
0056,元大高股息,10,0,10,凱基-頭份,2024-06-24,9296
00881,國泰台灣5G+,10,0,10,凱基-頭份,2024-06-24,9296
1809,中釉,10,0,10,凱基-頭份,2024-06-24,9296
2369,菱生,28,18,10,凱基-頭份,2024-06-24,9296
2515,中工,11,1,10,凱基-頭份,2024-06-24,9296
4402,郡都開發,10,0,10,凱基-頭份,2024-06-24,9296
6127,九豪,10,0,10,凱基-頭份,2024-06-24,9296
8054,安國,10,0,10,凱基-頭份,2024-06-24,9296
3149,正達,9,0,9,凱基-頭份,2024-06-24,9296
3694,海華,9,0,9,凱基-頭份,2024-06-24,9296
6499,益安,10,1,9,凱基-頭份,2024-06-24,9296
00940,元大台灣價值高息,39,30,9,凱基-頭份,2024-06-24,9296
2609,陽明,33,25,8,凱基-頭份,2024-06-24,9296
5468,凱鈺,8,0,8,凱基-頭份,2024-06-24,9296
00931B,統一美債20年,7,0,7,凱基-頭份,2024-06-24,9296
00900,富邦特選高股息30,7,0,7,凱基-頭份,2024-06-24,9296
3706,神達,7,0,7,凱基-頭份,2024-06-24,9296
4526,東台,14,7,7,凱基-頭份,2024-06-24,9296
2317,鴻海,21,15,6,凱基-頭份,2024-06-24,9296
1452,宏益,6,0,6,凱基-頭份,2024-06-24,9296
2314,台揚,6,0,6,凱基-頭份,2024-06-24,9296
2379,瑞昱,6,0,6,凱基-頭份,2024-06-24,9296
2492,華新科,6,0,6,凱基-頭份,2024-06-24,9296
2850,新產,6,0,6,凱基-頭份,2024-06-24,9296
3704,合勤控,6,0,6,凱基-頭份,2024-06-24,9296
6546,正基,9,3,6,凱基-頭份,2024-06-24,9296
2883,凱基金,404,100,304,凱基-頭份,2024-06-25,9296
00929,復華台灣科技優息,71,6,65,凱基-頭份,2024-06-25,9296
5608,四維航,45,0,45,凱基-頭份,2024-06-25,9296
00632R,元大台灣50反1,80,40,40,凱基-頭份,2024-06-25,9296
00919,群益台灣精選高息,38,2,36,凱基-頭份,2024-06-25,9296
00946,群益科技高息成長,32,3,29,凱基-頭份,2024-06-25,9296
00673R,期元大S＆P原油反1,21,0,21,凱基-頭份,2024-06-25,9296
00641R,富邦日本反1,20,0,20,凱基-頭份,2024-06-25,9296
1815,富喬,61,45,16,凱基-頭份,2024-06-25,9296
00878,國泰永續高股息,27,15,12,凱基-頭份,2024-06-25,9296
1785,光洋科,26,14,12,凱基-頭份,2024-06-25,9296
00687B,國泰20年美債,12,0,12,凱基-頭份,2024-06-25,9296
3481,群創,121,110,11,凱基-頭份,2024-06-25,9296
4168,醣聯,11,0,11,凱基-頭份,2024-06-25,9296
2331,精英,11,0,11,凱基-頭份,2024-06-25,9296
1304,台聚,10,0,10,凱基-頭份,2024-06-25,9296
00751B,元大AAA至A公司債,10,0,10,凱基-頭份,2024-06-25,9296
2605,新興,10,0,10,凱基-頭份,2024-06-25,9296
8054,安國,13,3,10,凱基-頭份,2024-06-25,9296
6770,力積電,10,1,9,凱基-頭份,2024-06-25,9296
6806,森崴能源,13,5,8,凱基-頭份,2024-06-25,9296
2317,鴻海,18,10,8,凱基-頭份,2024-06-25,9296
2464,盟立,14,6,8,凱基-頭份,2024-06-25,9296
00902,中信電池及儲能,7,0,7,凱基-頭份,2024-06-25,9296
00881,國泰台灣5G+,6,0,6,凱基-頭份,2024-06-25,9296
2439,美律,6,0,6,凱基-頭份,2024-06-25,9296
2489,瑞軒,6,0,6,凱基-頭份,2024-06-25,9296
4526,東台,13,7,6,凱基-頭份,2024-06-25,9296
4907,富宇,6,0,6,凱基-頭份,2024-06-25,9296
5871,中租-KY,5,0,5,凱基-頭份,2024-06-25,9296
00726B,國泰新興投等債,5,0,5,凱基-頭份,2024-06-25,9296
1309,台達化,5,0,5,凱基-頭份,2024-06-25,9296
1440,南紡,5,0,5,凱基-頭份,2024-06-25,9296
2105,正新,6,1,5,凱基-頭份,2024-06-25,9296
2406,國碩,5,0,5,凱基-頭份,2024-06-25,9296
4960,誠美材,5,0,5,凱基-頭份,2024-06-25,9296
6217,中探針,5,0,5,凱基-頭份,2024-06-25,9296
8906,花王,5,0,5,凱基-頭份,2024-06-25,9296
2354,鴻準,9,4,5,凱基-頭份,2024-06-25,9296
2303,聯電,7,3,4,凱基-頭份,2024-06-25,9296
2401,凌陽,4,0,4,凱基-頭份,2024-06-25,9296
2409,友達,4,0,4,凱基-頭份,2024-06-25,9296
2867,三商壽,10,6,4,凱基-頭份,2024-06-25,9296
3025,星通,7,3,4,凱基-頭份,2024-06-25,9296
8940,新天地,4,0,4,凱基-頭份,2024-06-25,9296
9105,泰金寶-DR,4,0,4,凱基-頭份,2024-06-25,9296
912000,晨訊科-DR,5,1,4,凱基-頭份,2024-06-25,9296
3037,欣興,4,0,4,凱基-頭份,2024-06-25,9296
1303,南亞,3,0,3,凱基-頭份,2024-06-25,9296
3218,大學光,3,0,3,凱基-頭份,2024-06-25,9296
00940,元大台灣價值高息,72,0,72,凱基-頭份,2024-06-26,9296
2812,台中銀,71,0,71,凱基-頭份,2024-06-26,9296
3481,群創,113,67,46,凱基-頭份,2024-06-26,9296
2515,中工,44,0,44,凱基-頭份,2024-06-26,9296
1701,中化,51,11,40,凱基-頭份,2024-06-26,9296
00929,復華台灣科技優息,40,1,39,凱基-頭份,2024-06-26,9296
00632R,元大台灣50反1,30,0,30,凱基-頭份,2024-06-26,9296
2331,精英,30,0,30,凱基-頭份,2024-06-26,9296
2888,新光金,30,0,30,凱基-頭份,2024-06-26,9296
00937B,群益ESG投等債20,30,0,30,凱基-頭份,2024-06-26,9296
00919,群益台灣精選高息,31,2,29,凱基-頭份,2024-06-26,9296
2516,新建,29,0,29,凱基-頭份,2024-06-26,9296
4526,東台,77,49,28,凱基-頭份,2024-06-26,9296
2409,友達,26,2,24,凱基-頭份,2024-06-26,9296
4956,光鋐,22,0,22,凱基-頭份,2024-06-26,9296
2392,正崴,24,3,21,凱基-頭份,2024-06-26,9296
6217,中探針,21,0,21,凱基-頭份,2024-06-26,9296
1305,華夏,20,0,20,凱基-頭份,2024-06-26,9296
00664R,國泰臺灣加權反1,20,0,20,凱基-頭份,2024-06-26,9296
2301,光寶科,21,1,20,凱基-頭份,2024-06-26,9296
2509,全坤建,20,0,20,凱基-頭份,2024-06-26,9296
3047,訊舟,21,1,20,凱基-頭份,2024-06-26,9296
3535,晶彩科,20,1,19,凱基-頭份,2024-06-26,9296
8906,花王,21,2,19,凱基-頭份,2024-06-26,9296
1802,台玻,18,1,17,凱基-頭份,2024-06-26,9296
6163,華電網,20,3,17,凱基-頭份,2024-06-26,9296
2303,聯電,16,0,16,凱基-頭份,2024-06-26,9296
2330,台積電,16,1,15,凱基-頭份,2024-06-26,9296
2356,英業達,14,0,14,凱基-頭份,2024-06-26,9296
3122,笙泉,14,0,14,凱基-頭份,2024-06-26,9296
8064,東捷,17,3,14,凱基-頭份,2024-06-26,9296
00878,國泰永續高股息,13,0,13,凱基-頭份,2024-06-26,9296
2002,中鋼,13,0,13,凱基-頭份,2024-06-26,9296
3580,友威科,14,1,13,凱基-頭份,2024-06-26,9296
2884,玉山金,12,0,12,凱基-頭份,2024-06-26,9296
5392,能率,11,0,11,凱基-頭份,2024-06-26,9296
2025,千興,10,0,10,凱基-頭份,2024-06-26,9296
2547,日勝生,10,0,10,凱基-頭份,2024-06-26,9296
2609,陽明,35,25,10,凱基-頭份,2024-06-26,9296
3312,弘憶股,11,1,10,凱基-頭份,2024-06-26,9296
2344,華邦電,10,1,9,凱基-頭份,2024-06-26,9296
2353,宏��,9,0,9,凱基-頭份,2024-06-26,9296
6207,雷科,30,21,9,凱基-頭份,2024-06-26,9296
3231,緯創,17,9,8,凱基-頭份,2024-06-26,9296
0056,元大高股息,36,28,8,凱基-頭份,2024-06-26,9296
00946,群益科技高息成長,8,0,8,凱基-頭份,2024-06-26,9296
2887,台新金,8,0,8,凱基-頭份,2024-06-26,9296
8110,華東,8,0,8,凱基-頭份,2024-06-26,9296
00936,台新永續高息中小,7,0,7,凱基-頭份,2024-06-26,9296
2442,新美齊,7,0,7,凱基-頭份,2024-06-26,9296
00680L,元大美債20正2,102,0,102,凱基-頭份,2024-06-27,9296
00929,復華台灣科技優息,52,0,52,凱基-頭份,2024-06-27,9296
00632R,元大台灣50反1,40,2,38,凱基-頭份,2024-06-27,9296
9105,泰金寶-DR,38,5,33,凱基-頭份,2024-06-27,9296
2812,台中銀,32,0,32,凱基-頭份,2024-06-27,9296
00674R,期元大S＆P黃金反1,30,0,30,凱基-頭份,2024-06-27,9296
00937B,群益ESG投等債20,30,1,29,凱基-頭份,2024-06-27,9296
2883,凱基金,35,10,25,凱基-頭份,2024-06-27,9296
3481,群創,36,13,23,凱基-頭份,2024-06-27,9296
00687B,國泰20年美債,24,1,23,凱基-頭份,2024-06-27,9296
1762,中化生,20,0,20,凱基-頭份,2024-06-27,9296
2606,裕民,21,1,20,凱基-頭份,2024-06-27,9296
4956,光鋐,20,0,20,凱基-頭份,2024-06-27,9296
6443,元晶,23,4,19,凱基-頭份,2024-06-27,9296
00919,群益台灣精選高息,18,0,18,凱基-頭份,2024-06-27,9296
00878,國泰永續高股息,15,0,15,凱基-頭份,2024-06-27,9296
8421,旭源,15,0,15,凱基-頭份,2024-06-27,9296
00936,台新永續高息中小,12,0,12,凱基-頭份,2024-06-27,9296
00946,群益科技高息成長,12,0,12,凱基-頭份,2024-06-27,9296
2331,精英,12,0,12,凱基-頭份,2024-06-27,9296
2888,新光金,11,0,11,凱基-頭份,2024-06-27,9296
00713,元大台灣高息低波,11,0,11,凱基-頭份,2024-06-27,9296
1449,佳和,12,1,11,凱基-頭份,2024-06-27,9296
2371,大同,11,0,11,凱基-頭份,2024-06-27,9296
4526,東台,11,0,11,凱基-頭份,2024-06-27,9296
00664R,國泰臺灣加權反1,10,0,10,凱基-頭份,2024-06-27,9296
00900,富邦特選高股息30,10,0,10,凱基-頭份,2024-06-27,9296
1714,和桐,10,0,10,凱基-頭份,2024-06-27,9296
2303,聯電,11,1,10,凱基-頭份,2024-06-27,9296
2509,全坤建,10,0,10,凱基-頭份,2024-06-27,9296
3048,益登,10,0,10,凱基-頭份,2024-06-27,9296
3576,聯合再生,49,39,10,凱基-頭份,2024-06-27,9296
4935,茂林-KY,10,0,10,凱基-頭份,2024-06-27,9296
911868,同方友友-DR,10,0,10,凱基-頭份,2024-06-27,9296
1447,力鵬,9,0,9,凱基-頭份,2024-06-27,9296
3580,友威科,11,2,9,凱基-頭份,2024-06-27,9296
6190,萬泰科,9,0,9,凱基-頭份,2024-06-27,9296
00882,中信中國高股息,10,2,8,凱基-頭份,2024-06-27,9296
8906,花王,8,0,8,凱基-頭份,2024-06-27,9296
00679B,元大美債20年,9,1,8,凱基-頭份,2024-06-27,9296
5871,中租-KY,11,4,7,凱基-頭份,2024-06-27,9296
00942B,台新美A公司債20+,7,0,7,凱基-頭份,2024-06-27,9296
2349,錸德,9,2,7,凱基-頭份,2024-06-27,9296
2439,美律,7,0,7,凱基-頭份,2024-06-27,9296
3036,文曄,8,1,7,凱基-頭份,2024-06-27,9296
4167,松瑞藥,13,6,7,凱基-頭份,2024-06-27,9296
8076,伍豐,23,16,7,凱基-頭份,2024-06-27,9296
2486,一詮,6,0,6,凱基-頭份,2024-06-27,9296
3055,蔚華科,9,3,6,凱基-頭份,2024-06-27,9296
2317,鴻海,9,3,6,凱基-頭份,2024-06-27,9296
3591,艾笛森,59,0,59,凱基-頭份,2024-06-28,9296
00929,復華台灣科技優息,53,1,52,凱基-頭份,2024-06-28,9296
2349,錸德,50,0,50,凱基-頭份,2024-06-28,9296
00936,台新永續高息中小,48,0,48,凱基-頭份,2024-06-28,9296
2801,彰銀,47,0,47,凱基-頭份,2024-06-28,9296
00940,元大台灣價值高息,69,25,44,凱基-頭份,2024-06-28,9296
4956,光鋐,40,0,40,凱基-頭份,2024-06-28,9296
1609,大亞,31,4,27,凱基-頭份,2024-06-28,9296
00673R,期元大S＆P原油反1,22,0,22,凱基-頭份,2024-06-28,9296
2618,長榮航,23,1,22,凱基-頭份,2024-06-28,9296
00946,群益科技高息成長,20,0,20,凱基-頭份,2024-06-28,9296
00885,富邦越南,20,0,20,凱基-頭份,2024-06-28,9296
6244,茂迪,25,5,20,凱基-頭份,2024-06-28,9296
3481,群創,22,3,19,凱基-頭份,2024-06-28,9296
2605,新興,20,1,19,凱基-頭份,2024-06-28,9296
00919,群益台灣精選高息,19,2,17,凱基-頭份,2024-06-28,9296
2489,瑞軒,17,0,17,凱基-頭份,2024-06-28,9296
2537,聯上發,16,1,15,凱基-頭份,2024-06-28,9296
3652,精聯,15,0,15,凱基-頭份,2024-06-28,9296
2610,華航,15,1,14,凱基-頭份,2024-06-28,9296
4726,永昕,15,1,14,凱基-頭份,2024-06-28,9296
00674R,期元大S＆P黃金反1,12,0,12,凱基-頭份,2024-06-28,9296
00679B,元大美債20年,11,0,11,凱基-頭份,2024-06-28,9296
2354,鴻準,14,3,11,凱基-頭份,2024-06-28,9296
9946,三發地產,11,0,11,凱基-頭份,2024-06-28,9296
1101,台泥,10,0,10,凱基-頭份,2024-06-28,9296
00923,群益台ESG低碳50,10,0,10,凱基-頭份,2024-06-28,9296
00664R,國泰臺灣加權反1,10,0,10,凱基-頭份,2024-06-28,9296
2509,全坤建,10,0,10,凱基-頭份,2024-06-28,9296
4526,東台,10,0,10,凱基-頭份,2024-06-28,9296
2451,創見,9,0,9,凱基-頭份,2024-06-28,9296
6169,昱泉,9,0,9,凱基-頭份,2024-06-28,9296
6207,雷科,10,1,9,凱基-頭份,2024-06-28,9296
2337,旺宏,11,3,8,凱基-頭份,2024-06-28,9296
4306,炎洲,8,0,8,凱基-頭份,2024-06-28,9296
2883,凱基金,17,10,7,凱基-頭份,2024-06-28,9296
3122,笙泉,7,0,7,凱基-頭份,2024-06-28,9296
00712,復華富時不動產,6,0,6,凱基-頭份,2024-06-28,9296
1734,杏輝,6,0,6,凱基-頭份,2024-06-28,9296
2352,佳世達,6,0,6,凱基-頭份,2024-06-28,9296
3707,漢磊,6,0,6,凱基-頭份,2024-06-28,9296
8110,華東,8,2,6,凱基-頭份,2024-06-28,9296
5392,能率,7,1,6,凱基-頭份,2024-06-28,9296
6442,光聖,10,5,5,凱基-頭份,2024-06-28,9296
2417,圓剛,8,3,5,凱基-頭份,2024-06-28,9296
3048,益登,7,2,5,凱基-頭份,2024-06-28,9296
4157,太景*-KY,5,0,5,凱基-頭份,2024-06-28,9296
4707,磐亞,5,0,5,凱基-頭份,2024-06-28,9296
5381,合正,5,0,5,凱基-頭份,2024-06-28,9296
8028,昇陽半導體,20,15,5,凱基-頭份,2024-06-28,9296
3710,連展投控,98,0,98,凱基-頭份,2024-07-01,9296
1802,台玻,67,1,66,凱基-頭份,2024-07-01,9296
00937B,群益ESG投等債20,61,0,61,凱基-頭份,2024-07-01,9296
00885,富邦越南,50,0,50,凱基-頭份,2024-07-01,9296
00929,復華台灣科技優息,41,5,36,凱基-頭份,2024-07-01,9296
3481,群創,39,5,34,凱基-頭份,2024-07-01,9296
00687B,國泰20年美債,32,0,32,凱基-頭份,2024-07-01,9296
2303,聯電,41,12,29,凱基-頭份,2024-07-01,9296
00679B,元大美債20年,33,7,26,凱基-頭份,2024-07-01,9296
5871,中租-KY,25,0,25,凱基-頭份,2024-07-01,9296
2609,陽明,28,7,21,凱基-頭份,2024-07-01,9296
00919,群益台灣精選高息,28,7,21,凱基-頭份,2024-07-01,9296
6168,宏齊,20,0,20,凱基-頭份,2024-07-01,9296
4956,光鋐,18,0,18,凱基-頭份,2024-07-01,9296
2313,華通,16,0,16,凱基-頭份,2024-07-01,9296
6189,豐藝,19,3,16,凱基-頭份,2024-07-01,9296
8096,擎亞,17,1,16,凱基-頭份,2024-07-01,9296
2352,佳世達,15,0,15,凱基-頭份,2024-07-01,9296
8076,伍豐,15,0,15,凱基-頭份,2024-07-01,9296
6120,達運,15,0,15,凱基-頭份,2024-07-01,9296
1785,光洋科,13,0,13,凱基-頭份,2024-07-01,9296
2406,國碩,20,7,13,凱基-頭份,2024-07-01,9296
1504,東元,11,0,11,凱基-頭份,2024-07-01,9296
00674R,期元大S＆P黃金反1,10,0,10,凱基-頭份,2024-07-01,9296
00664R,國泰臺灣加權反1,10,0,10,凱基-頭份,2024-07-01,9296
00641R,富邦日本反1,10,0,10,凱基-頭份,2024-07-01,9296
2023,燁輝,10,0,10,凱基-頭份,2024-07-01,9296
3202,樺晟,10,0,10,凱基-頭份,2024-07-01,9296
3607,谷崧,10,0,10,凱基-頭份,2024-07-01,9296
5530,龍巖,10,0,10,凱基-頭份,2024-07-01,9296
6164,華興,10,0,10,凱基-頭份,2024-07-01,9296
8034,榮群,10,0,10,凱基-頭份,2024-07-01,9296
00936,台新永續高息中小,10,0,10,凱基-頭份,2024-07-01,9296
00907,永豐優息存股,9,0,9,凱基-頭份,2024-07-01,9296
00945B,凱基美國非投等債,9,0,9,凱基-頭份,2024-07-01,9296
2605,新興,8,0,8,凱基-頭份,2024-07-01,9296
3050,鈺德,8,0,8,凱基-頭份,2024-07-01,9296
3576,聯合再生,10,2,8,凱基-頭份,2024-07-01,9296
4306,炎洲,8,0,8,凱基-頭份,2024-07-01,9296
6668,中揚光,10,2,8,凱基-頭份,2024-07-01,9296
2883,凱基金,12,5,7,凱基-頭份,2024-07-01,9296
00948B,中信優息投資級債,6,0,6,凱基-頭份,2024-07-01,9296
2337,旺宏,9,3,6,凱基-頭份,2024-07-01,9296
2476,鉅祥,6,0,6,凱基-頭份,2024-07-01,9296
6578,達邦蛋白,6,0,6,凱基-頭份,2024-07-01,9296
6770,力積電,9,3,6,凱基-頭份,2024-07-01,9296
00942B,台新美A公司債20+,6,1,5,凱基-頭份,2024-07-01,9296
2385,群光,5,0,5,凱基-頭份,2024-07-01,9296
6890,來億-KY,5,0,5,凱基-頭份,2024-07-01,9296
00772B,中信高評級公司債,5,0,5,凱基-頭份,2024-07-01,9296
00936,台新永續高息中小,125,0,125,凱基-頭份,2024-07-02,9296
00929,復華台灣科技優息,119,33,86,凱基-頭份,2024-07-02,9296
00934,中信成長高股息,63,0,63,凱基-頭份,2024-07-02,9296
2303,聯電,62,0,62,凱基-頭份,2024-07-02,9296
8926,台汽電,55,0,55,凱基-頭份,2024-07-02,9296
2614,東森,28,0,28,凱基-頭份,2024-07-02,9296
1785,光洋科,28,1,27,凱基-頭份,2024-07-02,9296
00937B,群益ESG投等債20,24,0,24,凱基-頭份,2024-07-02,9296
0056,元大高股息,28,7,21,凱基-頭份,2024-07-02,9296
1616,億泰,20,0,20,凱基-頭份,2024-07-02,9296
8028,昇陽半導體,29,9,20,凱基-頭份,2024-07-02,9296
2317,鴻海,32,13,19,凱基-頭份,2024-07-02,9296
2002,中鋼,14,0,14,凱基-頭份,2024-07-02,9296
8085,福華,12,0,12,凱基-頭份,2024-07-02,9296
8935,邦泰,12,0,12,凱基-頭份,2024-07-02,9296
00679B,元大美債20年,13,2,11,凱基-頭份,2024-07-02,9296
3051,力特,11,0,11,凱基-頭份,2024-07-02,9296
00915,凱基優選高股息30,11,0,11,凱基-頭份,2024-07-02,9296
00751B,元大AAA至A公司債,11,0,11,凱基-頭份,2024-07-02,9296
2618,長榮航,11,0,11,凱基-頭份,2024-07-02,9296
6122,擎邦,11,0,11,凱基-頭份,2024-07-02,9296
00687B,國泰20年美債,10,0,10,凱基-頭份,2024-07-02,9296
00946,群益科技高息成長,10,0,10,凱基-頭份,2024-07-02,9296
00885,富邦越南,10,0,10,凱基-頭份,2024-07-02,9296
1905,華紙,10,0,10,凱基-頭份,2024-07-02,9296
3702,大聯大,10,0,10,凱基-頭份,2024-07-02,9296
5603,陸海,10,0,10,凱基-頭份,2024-07-02,9296
2809,京城銀,11,1,10,凱基-頭份,2024-07-02,9296
2371,大同,10,0,10,凱基-頭份,2024-07-02,9296
2359,所羅門,17,8,9,凱基-頭份,2024-07-02,9296
3535,晶彩科,21,12,9,凱基-頭份,2024-07-02,9296
6115,鎰勝,8,0,8,凱基-頭份,2024-07-02,9296
6285,啟��,8,0,8,凱基-頭份,2024-07-02,9296
00918,大華優利高填息30,7,0,7,凱基-頭份,2024-07-02,9296
2353,宏��,6,0,6,凱基-頭份,2024-07-02,9296
6139,亞翔,13,7,6,凱基-頭份,2024-07-02,9296
2344,華邦電,7,1,6,凱基-頭份,2024-07-02,9296
2406,國碩,9,3,6,凱基-頭份,2024-07-02,9296
2476,鉅祥,6,0,6,凱基-頭份,2024-07-02,9296
6207,雷科,6,0,6,凱基-頭份,2024-07-02,9296
6443,元晶,9,3,6,凱基-頭份,2024-07-02,9296
9105,泰金寶-DR,36,30,6,凱基-頭份,2024-07-02,9296
6869,雲豹能源,7,1,6,凱基-頭份,2024-07-02,9296
1449,佳和,5,0,5,凱基-頭份,2024-07-02,9296
2023,燁輝,5,0,5,凱基-頭份,2024-07-02,9296
2388,威盛,5,0,5,凱基-頭份,2024-07-02,9296
2509,全坤建,5,0,5,凱基-頭份,2024-07-02,9296
2915,潤泰全,5,0,5,凱基-頭份,2024-07-02,9296
3002,歐格,5,0,5,凱基-頭份,2024-07-02,9296
3006,晶豪科,5,0,5,凱基-頭份,2024-07-02,9296
00680L,元大美債20正2,100,0,100,凱基-頭份,2024-07-03,9296
00929,復華台灣科技優息,73,18,55,凱基-頭份,2024-07-03,9296
3576,聯合再生,58,9,49,凱基-頭份,2024-07-03,9296
00934,中信成長高股息,41,0,41,凱基-頭份,2024-07-03,9296
00679B,元大美債20年,41,2,39,凱基-頭份,2024-07-03,9296
6177,達麗,35,0,35,凱基-頭份,2024-07-03,9296
00915,凱基優選高股息30,33,0,33,凱基-頭份,2024-07-03,9296
6443,元晶,48,24,24,凱基-頭份,2024-07-03,9296
00664R,國泰臺灣加權反1,20,0,20,凱基-頭份,2024-07-03,9296
4167,松瑞藥,29,10,19,凱基-頭份,2024-07-03,9296
3491,昇達科,18,0,18,凱基-頭份,2024-07-03,9296
00882,中信中國高股息,30,14,16,凱基-頭份,2024-07-03,9296
00632R,元大台灣50反1,40,25,15,凱基-頭份,2024-07-03,9296
2605,新興,39,24,15,凱基-頭份,2024-07-03,9296
00937B,群益ESG投等債20,60,46,14,凱基-頭份,2024-07-03,9296
2610,華航,13,0,13,凱基-頭份,2024-07-03,9296
2303,聯電,14,2,12,凱基-頭份,2024-07-03,9296
2482,連宇,12,0,12,凱基-頭份,2024-07-03,9296
1608,華榮,11,0,11,凱基-頭份,2024-07-03,9296
2317,鴻海,10,0,10,凱基-頭份,2024-07-03,9296
00751B,元大AAA至A公司債,10,0,10,凱基-頭份,2024-07-03,9296
2105,正新,10,0,10,凱基-頭份,2024-07-03,9296
2509,全坤建,10,0,10,凱基-頭份,2024-07-03,9296
3481,群創,33,23,10,凱基-頭份,2024-07-03,9296
9946,三發地產,10,0,10,凱基-頭份,2024-07-03,9296
2614,東森,10,0,10,凱基-頭份,2024-07-03,9296
1101,台泥,10,1,9,凱基-頭份,2024-07-03,9296
1514,亞力,13,4,9,凱基-頭份,2024-07-03,9296
1540,喬福,9,0,9,凱基-頭份,2024-07-03,9296
2495,普安,9,0,9,凱基-頭份,2024-07-03,9296
2609,陽明,17,8,9,凱基-頭份,2024-07-03,9296
8277,商丞,10,1,9,凱基-頭份,2024-07-03,9296
1802,台玻,10,2,8,凱基-頭份,2024-07-03,9296
6283,淳安,8,0,8,凱基-頭份,2024-07-03,9296
3231,緯創,20,13,7,凱基-頭份,2024-07-03,9296
3689,湧德,6,0,6,凱基-頭份,2024-07-03,9296
5443,均豪,59,53,6,凱基-頭份,2024-07-03,9296
6216,居易,6,0,6,凱基-頭份,2024-07-03,9296
00931B,統一美債20年,5,0,5,凱基-頭份,2024-07-03,9296
00943,兆豐電子高息等權,5,0,5,凱基-頭份,2024-07-03,9296
00673R,期元大S＆P原油反1,5,0,5,凱基-頭份,2024-07-03,9296
1504,東元,5,0,5,凱基-頭份,2024-07-03,9296
2331,精英,5,0,5,凱基-頭份,2024-07-03,9296
3047,訊舟,28,23,5,凱基-頭份,2024-07-03,9296
3057,喬鼎,5,0,5,凱基-頭份,2024-07-03,9296
3356,奇偶,5,0,5,凱基-頭份,2024-07-03,9296
3580,友威科,5,0,5,凱基-頭份,2024-07-03,9296
3686,達能,5,0,5,凱基-頭份,2024-07-03,9296
5009,榮剛,5,0,5,凱基-頭份,2024-07-03,9296
6282,康舒,9,4,5,凱基-頭份,2024-07-03,9296
1718,中纖,766,0,766,凱基-頭份,2024-07-04,9296
9105,泰金寶-DR,349,0,349,凱基-頭份,2024-07-04,9296
2888,新光金,104,14,90,凱基-頭份,2024-07-04,9296
2617,台航,50,1,49,凱基-頭份,2024-07-04,9296
00937B,群益ESG投等債20,44,0,44,凱基-頭份,2024-07-04,9296
00891,中信關鍵半導體,23,0,23,凱基-頭份,2024-07-04,9296
2323,中環,22,0,22,凱基-頭份,2024-07-04,9296
00893,國泰智能電動車,20,0,20,凱基-頭份,2024-07-04,9296
00664R,國泰臺灣加權反1,20,0,20,凱基-頭份,2024-07-04,9296
3047,訊舟,22,3,19,凱基-頭份,2024-07-04,9296
2412,中華電,15,0,15,凱基-頭份,2024-07-04,9296
1906,寶隆,15,0,15,凱基-頭份,2024-07-04,9296
2405,輔信,27,12,15,凱基-頭份,2024-07-04,9296
4109,加捷生醫,14,0,14,凱基-頭份,2024-07-04,9296
1316,上曜,13,0,13,凱基-頭份,2024-07-04,9296
3615,安可,18,6,12,凱基-頭份,2024-07-04,9296
8906,花王,12,0,12,凱基-頭份,2024-07-04,9296
1444,力麗,11,0,11,凱基-頭份,2024-07-04,9296
2353,宏��,11,0,11,凱基-頭份,2024-07-04,9296
2618,長榮航,13,2,11,凱基-頭份,2024-07-04,9296
3481,群創,59,48,11,凱基-頭份,2024-07-04,9296
00751B,元大AAA至A公司債,10,0,10,凱基-頭份,2024-07-04,9296
2401,凌陽,10,0,10,凱基-頭份,2024-07-04,9296
2509,全坤建,10,0,10,凱基-頭份,2024-07-04,9296
2520,冠德,15,5,10,凱基-頭份,2024-07-04,9296
2614,東森,10,0,10,凱基-頭份,2024-07-04,9296
3450,聯鈞,35,25,10,凱基-頭份,2024-07-04,9296
9904,寶成,10,0,10,凱基-頭份,2024-07-04,9296
2359,所羅門,20,11,9,凱基-頭份,2024-07-04,9296
2367,燿華,12,3,9,凱基-頭份,2024-07-04,9296
2637,慧洋-KY,10,1,9,凱基-頭份,2024-07-04,9296
3689,湧德,10,1,9,凱基-頭份,2024-07-04,9296
4167,松瑞藥,9,0,9,凱基-頭份,2024-07-04,9296
6169,昱泉,10,1,9,凱基-頭份,2024-07-04,9296
8071,能率網通,25,16,9,凱基-頭份,2024-07-04,9296
00936,台新永續高息中小,9,0,9,凱基-頭份,2024-07-04,9296
2486,一詮,12,3,9,凱基-頭份,2024-07-04,9296
00934,中信成長高股息,8,0,8,凱基-頭份,2024-07-04,9296
2891,中信金,10,2,8,凱基-頭份,2024-07-04,9296
6244,茂迪,10,2,8,凱基-頭份,2024-07-04,9296
8110,華東,10,2,8,凱基-頭份,2024-07-04,9296
00946,群益科技高息成長,7,0,7,凱基-頭份,2024-07-04,9296
2369,菱生,7,0,7,凱基-頭份,2024-07-04,9296
00713,元大台灣高息低波,7,0,7,凱基-頭份,2024-07-04,9296
00919,群益台灣精選高息,6,0,6,凱基-頭份,2024-07-04,9296
1815,富喬,11,5,6,凱基-頭份,2024-07-04,9296
2417,圓剛,17,11,6,凱基-頭份,2024-07-04,9296
2634,漢翔,6,0,6,凱基-頭份,2024-07-04,9296
3050,鈺德,9,3,6,凱基-頭份,2024-07-04,9296
3338,泰碩,7,1,6,凱基-頭份,2024-07-04,9296
00934,中信成長高股息,147,0,147,凱基-頭份,2024-07-05,9296
00673R,期元大S＆P原油反1,55,0,55,凱基-頭份,2024-07-05,9296
2520,冠德,55,0,55,凱基-頭份,2024-07-05,9296
9103,美德醫療-DR,52,0,52,凱基-頭份,2024-07-05,9296
6177,達麗,50,0,50,凱基-頭份,2024-07-05,9296
2363,矽統,79,36,43,凱基-頭份,2024-07-05,9296
2888,新光金,42,1,41,凱基-頭份,2024-07-05,9296
00948B,中信優息投資級債,29,0,29,凱基-頭份,2024-07-05,9296
2614,東森,24,0,24,凱基-頭份,2024-07-05,9296
00885,富邦越南,20,0,20,凱基-頭份,2024-07-05,9296
3050,鈺德,21,1,20,凱基-頭份,2024-07-05,9296
6219,富旺,20,0,20,凱基-頭份,2024-07-05,9296
911868,同方友友-DR,17,0,17,凱基-頭份,2024-07-05,9296
2312,金寶,21,5,16,凱基-頭份,2024-07-05,9296
5347,世界,17,1,16,凱基-頭份,2024-07-05,9296
3048,益登,34,19,15,凱基-頭份,2024-07-05,9296
1815,富喬,29,15,14,凱基-頭份,2024-07-05,9296
3260,威剛,13,0,13,凱基-頭份,2024-07-05,9296
00937B,群益ESG投等債20,13,0,13,凱基-頭份,2024-07-05,9296
4956,光鋐,12,0,12,凱基-頭份,2024-07-05,9296
5202,力新,13,1,12,凱基-頭份,2024-07-05,9296
00878,國泰永續高股息,17,5,12,凱基-頭份,2024-07-05,9296
2618,長榮航,12,1,11,凱基-頭份,2024-07-05,9296
00633L,富邦上証正2,11,0,11,凱基-頭份,2024-07-05,9296
2610,華航,11,0,11,凱基-頭份,2024-07-05,9296
00945B,凱基美國非投等債,10,0,10,凱基-頭份,2024-07-05,9296
00641R,富邦日本反1,10,0,10,凱基-頭份,2024-07-05,9296
3372,典範,10,0,10,凱基-頭份,2024-07-05,9296
3450,聯鈞,33,23,10,凱基-頭份,2024-07-05,9296
6116,彩晶,10,0,10,凱基-頭份,2024-07-05,9296
6209,今國光,10,0,10,凱基-頭份,2024-07-05,9296
5392,能率,22,12,10,凱基-頭份,2024-07-05,9296
2374,佳能,14,5,9,凱基-頭份,2024-07-05,9296
2444,兆勁,9,0,9,凱基-頭份,2024-07-05,9296
6163,華電網,10,1,9,凱基-頭份,2024-07-05,9296
2884,玉山金,12,4,8,凱基-頭份,2024-07-05,9296
3712,永崴投控,9,1,8,凱基-頭份,2024-07-05,9296
5871,中租-KY,10,2,8,凱基-頭份,2024-07-05,9296
6548,長科*,8,0,8,凱基-頭份,2024-07-05,9296
1515,力山,14,7,7,凱基-頭份,2024-07-05,9296
2387,精元,7,0,7,凱基-頭份,2024-07-05,9296
6005,群益證,7,0,7,凱基-頭份,2024-07-05,9296
2615,萬海,10,3,7,凱基-頭份,2024-07-05,9296
2049,上銀,7,1,6,凱基-頭份,2024-07-05,9296
6189,豐藝,10,4,6,凱基-頭份,2024-07-05,9296
6753,龍德造船,6,0,6,凱基-頭份,2024-07-05,9296
1618,合機,17,11,6,凱基-頭份,2024-07-05,9296
1785,光洋科,16,11,5,凱基-頭份,2024-07-05,9296
1459,聯發,5,0,5,凱基-頭份,2024-07-05,9296
3231,緯創,6,1,5,凱基-頭份,2024-07-05,9296
2025,千興,270,0,270,凱基-頭份,2024-07-08,9296
3313,斐成,62,1,61,凱基-頭份,2024-07-08,9296
2371,大同,82,24,58,凱基-頭份,2024-07-08,9296
2312,金寶,50,0,50,凱基-頭份,2024-07-08,9296
2323,中環,35,0,35,凱基-頭份,2024-07-08,9296
6278,台表科,38,5,33,凱基-頭份,2024-07-08,9296
2520,冠德,30,0,30,凱基-頭份,2024-07-08,9296
3673,TPK-KY,41,11,30,凱基-頭份,2024-07-08,9296
8906,花王,30,0,30,凱基-頭份,2024-07-08,9296
00934,中信成長高股息,129,100,29,凱基-頭份,2024-07-08,9296
00687B,國泰20年美債,31,2,29,凱基-頭份,2024-07-08,9296
2417,圓剛,44,15,29,凱基-頭份,2024-07-08,9296
2547,日勝生,28,0,28,凱基-頭份,2024-07-08,9296
9103,美德醫療-DR,25,0,25,凱基-頭份,2024-07-08,9296
2618,長榮航,25,3,22,凱基-頭份,2024-07-08,9296
2367,燿華,47,25,22,凱基-頭份,2024-07-08,9296
2401,凌陽,23,1,22,凱基-頭份,2024-07-08,9296
00895,富邦未來車,21,0,21,凱基-頭份,2024-07-08,9296
2324,仁寶,21,0,21,凱基-頭份,2024-07-08,9296
3062,建漢,23,2,21,凱基-頭份,2024-07-08,9296
4526,東台,28,7,21,凱基-頭份,2024-07-08,9296
00664R,國泰臺灣加權反1,20,0,20,凱基-頭份,2024-07-08,9296
2104,國際中橡,20,0,20,凱基-頭份,2024-07-08,9296
2614,東森,20,0,20,凱基-頭份,2024-07-08,9296
1815,富喬,16,0,16,凱基-頭份,2024-07-08,9296
9946,三發地產,18,2,16,凱基-頭份,2024-07-08,9296
3048,益登,26,11,15,凱基-頭份,2024-07-08,9296
00927,群益半導體收益,15,0,15,凱基-頭份,2024-07-08,9296
00936,台新永續高息中小,14,0,14,凱基-頭份,2024-07-08,9296
6152,百一,14,0,14,凱基-頭份,2024-07-08,9296
2609,陽明,37,25,12,凱基-頭份,2024-07-08,9296
3481,群創,27,15,12,凱基-頭份,2024-07-08,9296
3715,定穎投控,13,1,12,凱基-頭份,2024-07-08,9296
6133,金橋,12,0,12,凱基-頭份,2024-07-08,9296
8112,至上,13,1,12,凱基-頭份,2024-07-08,9296
6217,中探針,35,23,12,凱基-頭份,2024-07-08,9296
2365,昆盈,41,29,12,凱基-頭份,2024-07-08,9296
00735,國泰臺韓科技,11,0,11,凱基-頭份,2024-07-08,9296
00720B,元大投資級公司債,11,0,11,凱基-頭份,2024-07-08,9296
6282,康舒,11,0,11,凱基-頭份,2024-07-08,9296
2603,長榮,14,4,10,凱基-頭份,2024-07-08,9296
00937B,群益ESG投等債20,12,2,10,凱基-頭份,2024-07-08,9296
00751B,元大AAA至A公司債,10,0,10,凱基-頭份,2024-07-08,9296
1569,濱川,10,0,10,凱基-頭份,2024-07-08,9296
2303,聯電,22,12,10,凱基-頭份,2024-07-08,9296
2509,全坤建,10,0,10,凱基-頭份,2024-07-08,9296
2516,新建,10,0,10,凱基-頭份,2024-07-08,9296
3083,網龍,10,0,10,凱基-頭份,2024-07-08,9296
3176,基亞,10,0,10,凱基-頭份,2024-07-08,9296
4956,光鋐,10,0,10,凱基-頭份,2024-07-08,9296
2888,新光金,903,134,769,凱基-頭份,2024-07-09,9296
2883,凱基金,421,15,406,凱基-頭份,2024-07-09,9296
3050,鈺德,108,7,101,凱基-頭份,2024-07-09,9296
00712,復華富時不動產,100,0,100,凱基-頭份,2024-07-09,9296
4414,如興,100,0,100,凱基-頭份,2024-07-09,9296
1727,中華化,67,0,67,凱基-頭份,2024-07-09,9296
00680L,元大美債20正2,55,0,55,凱基-頭份,2024-07-09,9296
2834,臺企銀,47,2,45,凱基-頭份,2024-07-09,9296
2889,國票金,31,1,30,凱基-頭份,2024-07-09,9296
2353,宏��,30,0,30,凱基-頭份,2024-07-09,9296
2609,陽明,32,5,27,凱基-頭份,2024-07-09,9296
00945B,凱基美國非投等債,27,0,27,凱基-頭份,2024-07-09,9296
9946,三發地產,37,10,27,凱基-頭份,2024-07-09,9296
2606,裕民,26,1,25,凱基-頭份,2024-07-09,9296
00929,復華台灣科技優息,81,58,23,凱基-頭份,2024-07-09,9296
00936,台新永續高息中小,23,0,23,凱基-頭份,2024-07-09,9296
2317,鴻海,65,45,20,凱基-頭份,2024-07-09,9296
2367,燿華,65,48,17,凱基-頭份,2024-07-09,9296
2349,錸德,20,4,16,凱基-頭份,2024-07-09,9296
3047,訊舟,85,69,16,凱基-頭份,2024-07-09,9296
4533,協易機,19,3,16,凱基-頭份,2024-07-09,9296
2344,華邦電,29,13,16,凱基-頭份,2024-07-09,9296
8096,擎亞,15,0,15,凱基-頭份,2024-07-09,9296
00735,國泰臺韓科技,15,0,15,凱基-頭份,2024-07-09,9296
1618,合機,29,14,15,凱基-頭份,2024-07-09,9296
6456,GIS-KY,15,0,15,凱基-頭份,2024-07-09,9296
6788,華景電,17,2,15,凱基-頭份,2024-07-09,9296
8064,東捷,23,8,15,凱基-頭份,2024-07-09,9296
8222,寶一,15,0,15,凱基-頭份,2024-07-09,9296
1608,華榮,17,4,13,凱基-頭份,2024-07-09,9296
2610,華航,13,0,13,凱基-頭份,2024-07-09,9296
1316,上曜,12,0,12,凱基-頭份,2024-07-09,9296
2401,凌陽,15,3,12,凱基-頭份,2024-07-09,9296
6282,康舒,12,0,12,凱基-頭份,2024-07-09,9296
1504,東元,12,1,11,凱基-頭份,2024-07-09,9296
2323,中環,11,0,11,凱基-頭份,2024-07-09,9296
5202,力新,11,0,11,凱基-頭份,2024-07-09,9296
6770,力積電,13,2,11,凱基-頭份,2024-07-09,9296
8076,伍豐,11,0,11,凱基-頭份,2024-07-09,9296
1305,華夏,10,0,10,凱基-頭份,2024-07-09,9296
1340,勝悅-KY,10,0,10,凱基-頭份,2024-07-09,9296
2301,光寶科,10,0,10,凱基-頭份,2024-07-09,9296
4739,康普,10,0,10,凱基-頭份,2024-07-09,9296
6163,華電網,10,0,10,凱基-頭份,2024-07-09,9296
8277,商丞,10,0,10,凱基-頭份,2024-07-09,9296
0056,元大高股息,16,7,9,凱基-頭份,2024-07-09,9296
1609,大亞,12,2,10,凱基-頭份,2024-07-09,9296
2331,精英,9,0,9,凱基-頭份,2024-07-09,9296
2405,輔信,31,22,9,凱基-頭份,2024-07-09,9296
3060,銘異,10,1,9,凱基-頭份,2024-07-09,9296
2867,三商壽,621,8,613,凱基-頭份,2024-07-10,9296
00933B,國泰10Y+金融債,200,0,200,凱基-頭份,2024-07-10,9296
2855,統一證,135,0,135,凱基-頭份,2024-07-10,9296
2888,新光金,799,717,82,凱基-頭份,2024-07-10,9296
2834,臺企銀,40,0,40,凱基-頭份,2024-07-10,9296
00929,復華台灣科技優息,36,0,36,凱基-頭份,2024-07-10,9296
2367,燿華,44,15,29,凱基-頭份,2024-07-10,9296
3050,鈺德,125,100,25,凱基-頭份,2024-07-10,9296
00885,富邦越南,21,0,21,凱基-頭份,2024-07-10,9296
2606,裕民,20,0,20,凱基-頭份,2024-07-10,9296
4953,緯軟,19,0,19,凱基-頭份,2024-07-10,9296
00934,中信成長高股息,18,0,18,凱基-頭份,2024-07-10,9296
2406,國碩,17,0,17,凱基-頭份,2024-07-10,9296
00950B,凱基A級公司債,16,0,16,凱基-頭份,2024-07-10,9296
2002,中鋼,15,0,15,凱基-頭份,2024-07-10,9296
1608,華榮,15,0,15,凱基-頭份,2024-07-10,9296
6456,GIS-KY,20,5,15,凱基-頭份,2024-07-10,9296
9105,泰金寶-DR,15,0,15,凱基-頭份,2024-07-10,9296
00725B,國泰投資級公司債,14,0,14,凱基-頭份,2024-07-10,9296
5460,同協,13,0,13,凱基-頭份,2024-07-10,9296
2330,台積電,15,2,13,凱基-頭份,2024-07-10,9296
00878,國泰永續高股息,12,0,12,凱基-頭份,2024-07-10,9296
2352,佳世達,12,0,12,凱基-頭份,2024-07-10,9296
3673,TPK-KY,14,2,12,凱基-頭份,2024-07-10,9296
1514,亞力,34,22,12,凱基-頭份,2024-07-10,9296
4979,華星光,12,1,11,凱基-頭份,2024-07-10,9296
2489,瑞軒,10,0,10,凱基-頭份,2024-07-10,9296
3083,網龍,10,0,10,凱基-頭份,2024-07-10,9296
3272,東碩,10,0,10,凱基-頭份,2024-07-10,9296
4532,瑞智,10,0,10,凱基-頭份,2024-07-10,9296
00936,台新永續高息中小,9,0,9,凱基-頭份,2024-07-10,9296
00940,元大台灣價值高息,30,21,9,凱基-頭份,2024-07-10,9296
2495,普安,9,0,9,凱基-頭份,2024-07-10,9296
4967,十銓,9,0,9,凱基-頭份,2024-07-10,9296
2845,遠東銀,18,10,8,凱基-頭份,2024-07-10,9296
5876,上海商銀,8,0,8,凱基-頭份,2024-07-10,9296
6235,華孚,9,1,8,凱基-頭份,2024-07-10,9296
6443,元晶,10,2,8,凱基-頭份,2024-07-10,9296
2356,英業達,11,3,8,凱基-頭份,2024-07-10,9296
00679B,元大美債20年,7,0,7,凱基-頭份,2024-07-10,9296
2889,國票金,7,0,7,凱基-頭份,2024-07-10,9296
6188,廣明,10,3,7,凱基-頭份,2024-07-10,9296
2412,中華電,6,0,6,凱基-頭份,2024-07-10,9296
00937B,群益ESG投等債20,6,0,6,凱基-頭份,2024-07-10,9296
1308,亞聚,6,0,6,凱基-頭份,2024-07-10,9296
2905,三商,6,0,6,凱基-頭份,2024-07-10,9296
3047,訊舟,10,4,6,凱基-頭份,2024-07-10,9296
5272,笙科,6,0,6,凱基-頭份,2024-07-10,9296
5371,中光電,7,1,6,凱基-頭份,2024-07-10,9296
6218,豪勉,27,21,6,凱基-頭份,2024-07-10,9296
2888,新光金,1101,1,1100,凱基-頭份,2024-07-11,9296
2867,三商壽,191,0,191,凱基-頭份,2024-07-11,9296
00712,復華富時不動產,101,8,93,凱基-頭份,2024-07-11,9296
3051,力特,61,0,61,凱基-頭份,2024-07-11,9296
2618,長榮航,57,0,57,凱基-頭份,2024-07-11,9296
6177,達麗,50,0,50,凱基-頭份,2024-07-11,9296
00937B,群益ESG投等債20,49,1,48,凱基-頭份,2024-07-11,9296
9105,泰金寶-DR,47,1,46,凱基-頭份,2024-07-11,9296
00673R,期元大S＆P原油反1,45,0,45,凱基-頭份,2024-07-11,9296
00950B,凱基A級公司債,30,0,30,凱基-頭份,2024-07-11,9296
1569,濱川,30,0,30,凱基-頭份,2024-07-11,9296
1815,富喬,27,4,23,凱基-頭份,2024-07-11,9296
6264,富裔,23,0,23,凱基-頭份,2024-07-11,9296
1785,光洋科,27,6,21,凱基-頭份,2024-07-11,9296
2349,錸德,20,0,20,凱基-頭份,2024-07-11,9296
00751B,元大AAA至A公司債,20,0,20,凱基-頭份,2024-07-11,9296
00664R,國泰臺灣加權反1,20,0,20,凱基-頭份,2024-07-11,9296
2886,兆豐金,20,0,20,凱基-頭份,2024-07-11,9296
8906,花王,20,0,20,凱基-頭份,2024-07-11,9296
00929,復華台灣科技優息,18,1,17,凱基-頭份,2024-07-11,9296
2427,三商電,16,1,15,凱基-頭份,2024-07-11,9296
2515,中工,17,2,15,凱基-頭份,2024-07-11,9296
2353,宏��,15,0,15,凱基-頭份,2024-07-11,9296
0056,元大高股息,17,2,15,凱基-頭份,2024-07-11,9296
2317,鴻海,15,2,13,凱基-頭份,2024-07-11,9296
4960,誠美材,13,0,13,凱基-頭份,2024-07-11,9296
3048,益登,13,1,12,凱基-頭份,2024-07-11,9296
4532,瑞智,12,0,12,凱基-頭份,2024-07-11,9296
6005,群益證,12,0,12,凱基-頭份,2024-07-11,9296
00946,群益科技高息成長,11,0,11,凱基-頭份,2024-07-11,9296
1101,台泥,11,0,11,凱基-頭份,2024-07-11,9296
2548,華固,11,0,11,凱基-頭份,2024-07-11,9296
3032,偉訓,11,0,11,凱基-頭份,2024-07-11,9296
5202,力新,19,8,11,凱基-頭份,2024-07-11,9296
6877,鏵友益,11,0,11,凱基-頭份,2024-07-11,9296
1514,亞力,36,26,10,凱基-頭份,2024-07-11,9296
3689,湧德,10,0,10,凱基-頭份,2024-07-11,9296
6227,茂綸,10,0,10,凱基-頭份,2024-07-11,9296
8111,立��,10,0,10,凱基-頭份,2024-07-11,9296
00934,中信成長高股息,16,7,9,凱基-頭份,2024-07-11,9296
3029,零壹,9,0,9,凱基-頭份,2024-07-11,9296
00725B,國泰投資級公司債,9,0,9,凱基-頭份,2024-07-11,9296
2417,圓剛,10,1,9,凱基-頭份,2024-07-11,9296
4306,炎洲,9,0,9,凱基-頭份,2024-07-11,9296
2405,輔信,13,5,8,凱基-頭份,2024-07-11,9296
6603,富強鑫,8,0,8,凱基-頭份,2024-07-11,9296
9906,欣巴巴,8,0,8,凱基-頭份,2024-07-11,9296
1609,大亞,7,0,7,凱基-頭份,2024-07-11,9296
2002,中鋼,7,0,7,凱基-頭份,2024-07-11,9296
8110,華東,7,0,7,凱基-頭份,2024-07-11,9296
2412,中華電,468,1,467,凱基-頭份,2024-07-12,9296
00929,復華台灣科技優息,171,15,156,凱基-頭份,2024-07-12,9296
00940,元大台灣價值高息,112,11,101,凱基-頭份,2024-07-12,9296
00919,群益台灣精選高息,109,18,91,凱基-頭份,2024-07-12,9296
00712,復華富時不動產,105,17,88,凱基-頭份,2024-07-12,9296
9946,三發地產,77,0,77,凱基-頭份,2024-07-12,9296
00934,中信成長高股息,111,60,51,凱基-頭份,2024-07-12,9296
2025,千興,50,0,50,凱基-頭份,2024-07-12,9296
2371,大同,57,7,50,凱基-頭份,2024-07-12,9296
6177,達麗,50,0,50,凱基-頭份,2024-07-12,9296
2303,聯電,51,5,46,凱基-頭份,2024-07-12,9296
2509,全坤建,35,0,35,凱基-頭份,2024-07-12,9296
3050,鈺德,52,21,31,凱基-頭份,2024-07-12,9296
2317,鴻海,33,2,31,凱基-頭份,2024-07-12,9296
1301,台塑,30,0,30,凱基-頭份,2024-07-12,9296
2367,燿華,31,4,27,凱基-頭份,2024-07-12,9296
00688L,國泰20年美債正2,25,0,25,凱基-頭份,2024-07-12,9296
6264,富裔,24,0,24,凱基-頭份,2024-07-12,9296
2393,億光,21,0,21,凱基-頭份,2024-07-12,9296
2606,裕民,20,0,20,凱基-頭份,2024-07-12,9296
00753L,中信中國50正2,20,0,20,凱基-頭份,2024-07-12,9296
00950B,凱基A級公司債,20,0,20,凱基-頭份,2024-07-12,9296
00637L,元大滬深300正2,20,2,18,凱基-頭份,2024-07-12,9296
6005,群益證,18,0,18,凱基-頭份,2024-07-12,9296
00882,中信中國高股息,19,2,17,凱基-頭份,2024-07-12,9296
1569,濱川,22,5,17,凱基-頭份,2024-07-12,9296
2349,錸德,20,3,17,凱基-頭份,2024-07-12,9296
00927,群益半導體收益,15,0,15,凱基-頭份,2024-07-12,9296
2313,華通,16,2,14,凱基-頭份,2024-07-12,9296
4807,日成-KY,13,0,13,凱基-頭份,2024-07-12,9296
0056,元大高股息,18,5,13,凱基-頭份,2024-07-12,9296
00936,台新永續高息中小,17,5,12,凱基-頭份,2024-07-12,9296
00923,群益台ESG低碳50,22,10,12,凱基-頭份,2024-07-12,9296
00725B,國泰投資級公司債,12,0,12,凱基-頭份,2024-07-12,9296
00696B,富邦美債20年,12,0,12,凱基-頭份,2024-07-12,9296
00878,國泰永續高股息,13,1,12,凱基-頭份,2024-07-12,9296
00939,統一台灣高息動能,11,0,11,凱基-頭份,2024-07-12,9296
2610,華航,12,1,11,凱基-頭份,2024-07-12,9296
2337,旺宏,11,1,10,凱基-頭份,2024-07-12,9296
1447,力鵬,11,1,10,凱基-頭份,2024-07-12,9296
2417,圓剛,11,1,10,凱基-頭份,2024-07-12,9296
2516,新建,10,0,10,凱基-頭份,2024-07-12,9296
3689,湧德,10,0,10,凱基-頭份,2024-07-12,9296
00881,國泰台灣5G+,13,4,9,凱基-頭份,2024-07-12,9296
2915,潤泰全,13,4,9,凱基-頭份,2024-07-12,9296
8028,昇陽半導體,12,3,9,凱基-頭份,2024-07-12,9296
3013,晟銘電,11,3,8,凱基-頭份,2024-07-12,9296
3060,銘異,8,0,8,凱基-頭份,2024-07-12,9296
3231,緯創,7,0,7,凱基-頭份,2024-07-12,9296
00632R,元大台灣50反1,7,0,7,凱基-頭份,2024-07-12,9296
00937B,群益ESG投等債20,151,0,151,凱基-頭份,2024-07-15,9296
00934,中信成長高股息,131,0,131,凱基-頭份,2024-07-15,9296
00929,復華台灣科技優息,122,0,122,凱基-頭份,2024-07-15,9296
2867,三商壽,114,1,113,凱基-頭份,2024-07-15,9296
2888,新光金,95,1,94,凱基-頭份,2024-07-15,9296
00712,復華富時不動產,101,8,93,凱基-頭份,2024-07-15,9296
9946,三發地產,59,0,59,凱基-頭份,2024-07-15,9296
2025,千興,50,0,50,凱基-頭份,2024-07-15,9296
2609,陽明,48,1,47,凱基-頭份,2024-07-15,9296
2618,長榮航,43,0,43,凱基-頭份,2024-07-15,9296
00919,群益台灣精選高息,40,1,39,凱基-頭份,2024-07-15,9296
2891,中信金,37,1,36,凱基-頭份,2024-07-15,9296
00927,群益半導體收益,35,0,35,凱基-頭份,2024-07-15,9296
2365,昆盈,42,10,32,凱基-頭份,2024-07-15,9296
00878,國泰永續高股息,25,3,22,凱基-頭份,2024-07-15,9296
2845,遠東銀,21,0,21,凱基-頭份,2024-07-15,9296
9945,潤泰新,21,0,21,凱基-頭份,2024-07-15,9296
3593,力銘,20,0,20,凱基-頭份,2024-07-15,9296
2606,裕民,20,0,20,凱基-頭份,2024-07-15,9296
0056,元大高股息,17,1,16,凱基-頭份,2024-07-15,9296
6219,富旺,16,1,15,凱基-頭份,2024-07-15,9296
2349,錸德,15,1,14,凱基-頭份,2024-07-15,9296
1612,宏泰,14,0,14,凱基-頭份,2024-07-15,9296
2356,英業達,47,33,14,凱基-頭份,2024-07-15,9296
00936,台新永續高息中小,13,0,13,凱基-頭份,2024-07-15,9296
00899,FT潔淨能源,12,0,12,凱基-頭份,2024-07-15,9296
6005,群益證,16,4,12,凱基-頭份,2024-07-15,9296
8105,凌巨,12,0,12,凱基-頭份,2024-07-15,9296
2889,國票金,13,2,11,凱基-頭份,2024-07-15,9296
5443,均豪,13,2,11,凱基-頭份,2024-07-15,9296
2344,華邦電,11,1,10,凱基-頭份,2024-07-15,9296
00939,統一台灣高息動能,10,0,10,凱基-頭份,2024-07-15,9296
00696B,富邦美債20年,10,0,10,凱基-頭份,2024-07-15,9296
00950B,凱基A級公司債,10,0,10,凱基-頭份,2024-07-15,9296
2393,億光,10,0,10,凱基-頭份,2024-07-15,9296
6264,富裔,10,0,10,凱基-頭份,2024-07-15,9296
8096,擎亞,15,5,10,凱基-頭份,2024-07-15,9296
911868,同方友友-DR,10,0,10,凱基-頭份,2024-07-15,9296
2243,宏旭-KY,24,15,9,凱基-頭份,2024-07-15,9296
1727,中華化,10,2,8,凱基-頭份,2024-07-15,9296
2915,潤泰全,8,0,8,凱基-頭份,2024-07-15,9296
5381,合正,11,3,8,凱基-頭份,2024-07-15,9296
3379,彬台,7,0,7,凱基-頭份,2024-07-15,9296
00673R,期元大S＆P原油反1,6,0,6,凱基-頭份,2024-07-15,9296
00935,野村臺灣新科技50,6,0,6,凱基-頭份,2024-07-15,9296
1608,華榮,54,48,6,凱基-頭份,2024-07-15,9296
2312,金寶,28,22,6,凱基-頭份,2024-07-15,9296
2329,華泰,6,0,6,凱基-頭份,2024-07-15,9296
3312,弘憶股,9,3,6,凱基-頭份,2024-07-15,9296
3535,晶彩科,31,25,6,凱基-頭份,2024-07-15,9296
00632R,元大台灣50反1,460,0,460,凱基-頭份,2024-07-16,9296
2007,燁興,100,0,100,凱基-頭份,2024-07-16,9296
00712,復華富時不動產,100,11,89,凱基-頭份,2024-07-16,9296
2888,新光金,82,23,59,凱基-頭份,2024-07-16,9296
00929,復華台灣科技優息,56,6,50,凱基-頭份,2024-07-16,9296
00905,FT臺灣Smart,44,0,44,凱基-頭份,2024-07-16,9296
00919,群益台灣精選高息,39,0,39,凱基-頭份,2024-07-16,9296
00934,中信成長高股息,33,0,33,凱基-頭份,2024-07-16,9296
2426,鼎元,31,0,31,凱基-頭份,2024-07-16,9296
9906,欣巴巴,30,0,30,凱基-頭份,2024-07-16,9296
0056,元大高股息,28,0,28,凱基-頭份,2024-07-16,9296
2409,友達,29,3,26,凱基-頭份,2024-07-16,9296
00936,台新永續高息中小,24,0,24,凱基-頭份,2024-07-16,9296
1608,華榮,21,0,21,凱基-頭份,2024-07-16,9296
3163,波若威,23,3,20,凱基-頭份,2024-07-16,9296
2548,華固,20,0,20,凱基-頭份,2024-07-16,9296
1316,上曜,43,23,20,凱基-頭份,2024-07-16,9296
2867,三商壽,26,7,19,凱基-頭份,2024-07-16,9296
00882,中信中國高股息,19,0,19,凱基-頭份,2024-07-16,9296
00878,國泰永續高股息,18,0,18,凱基-頭份,2024-07-16,9296
1109,信大,18,0,18,凱基-頭份,2024-07-16,9296
2489,瑞軒,18,2,16,凱基-頭份,2024-07-16,9296
00923,群益台ESG低碳50,15,0,15,凱基-頭份,2024-07-16,9296
3050,鈺德,15,0,15,凱基-頭份,2024-07-16,9296
2303,聯電,14,0,14,凱基-頭份,2024-07-16,9296
2312,金寶,28,14,14,凱基-頭份,2024-07-16,9296
6877,鏵友益,13,1,12,凱基-頭份,2024-07-16,9296
8028,昇陽半導體,15,3,12,凱基-頭份,2024-07-16,9296
2478,大毅,12,1,11,凱基-頭份,2024-07-16,9296
1785,光洋科,13,3,10,凱基-頭份,2024-07-16,9296
6530,創威,13,3,10,凱基-頭份,2024-07-16,9296
9902,台火,10,0,10,凱基-頭份,2024-07-16,9296
2317,鴻海,18,8,10,凱基-頭份,2024-07-16,9296
1513,中興電,17,8,9,凱基-頭份,2024-07-16,9296
2379,瑞昱,9,0,9,凱基-頭份,2024-07-16,9296
2393,億光,10,1,9,凱基-頭份,2024-07-16,9296
2618,長榮航,11,2,9,凱基-頭份,2024-07-16,9296
3122,笙泉,10,1,9,凱基-頭份,2024-07-16,9296
2365,昆盈,25,17,8,凱基-頭份,2024-07-16,9296
2538,基泰,11,3,8,凱基-頭份,2024-07-16,9296
2834,臺企銀,8,0,8,凱基-頭份,2024-07-16,9296
3520,華盈,9,1,8,凱基-頭份,2024-07-16,9296
4967,十銓,9,1,8,凱基-頭份,2024-07-16,9296
6127,九豪,10,2,8,凱基-頭份,2024-07-16,9296
1616,億泰,7,0,7,凱基-頭份,2024-07-16,9296
2515,中工,8,1,7,凱基-頭份,2024-07-16,9296
2354,鴻準,6,0,6,凱基-頭份,2024-07-16,9296
5309,系統電,6,0,6,凱基-頭份,2024-07-16,9296
00900,富邦特選高股息30,5,0,5,凱基-頭份,2024-07-16,9296
00912,中信臺灣智慧50,5,0,5,凱基-頭份,2024-07-16,9296
00937B,群益ESG投等債20,206,0,206,凱基-頭份,2024-07-17,9296
00929,復華台灣科技優息,211,38,173,凱基-頭份,2024-07-17,9296
00632R,元大台灣50反1,105,0,105,凱基-頭份,2024-07-17,9296
9906,欣巴巴,68,3,65,凱基-頭份,2024-07-17,9296
1802,台玻,60,1,59,凱基-頭份,2024-07-17,9296
00919,群益台灣精選高息,56,0,56,凱基-頭份,2024-07-17,9296
6770,力積電,62,11,51,凱基-頭份,2024-07-17,9296
00680L,元大美債20正2,40,0,40,凱基-頭份,2024-07-17,9296
6116,彩晶,42,2,40,凱基-頭份,2024-07-17,9296
00878,國泰永續高股息,37,0,37,凱基-頭份,2024-07-17,9296
2007,燁興,35,0,35,凱基-頭份,2024-07-17,9296
2312,金寶,48,13,35,凱基-頭份,2024-07-17,9296
00931B,統一美債20年,34,0,34,凱基-頭份,2024-07-17,9296
6698,旭暉應材,31,0,31,凱基-頭份,2024-07-17,9296
8099,大世科,30,0,30,凱基-頭份,2024-07-17,9296
9105,泰金寶-DR,31,3,28,凱基-頭份,2024-07-17,9296
2888,新光金,30,3,27,凱基-頭份,2024-07-17,9296
0056,元大高股息,27,2,25,凱基-頭份,2024-07-17,9296
9946,三發地產,95,71,24,凱基-頭份,2024-07-17,9296
2406,國碩,21,0,21,凱基-頭份,2024-07-17,9296
00933B,國泰10Y+金融債,32,11,21,凱基-頭份,2024-07-17,9296
6282,康舒,20,2,18,凱基-頭份,2024-07-17,9296
00934,中信成長高股息,21,4,17,凱基-頭份,2024-07-17,9296
2609,陽明,23,6,17,凱基-頭份,2024-07-17,9296
2845,遠東銀,16,0,16,凱基-頭份,2024-07-17,9296
3294,英濟,25,9,16,凱基-頭份,2024-07-17,9296
00905,FT臺灣Smart,15,0,15,凱基-頭份,2024-07-17,9296
00940,元大台灣價值高息,30,15,15,凱基-頭份,2024-07-17,9296
2393,億光,15,0,15,凱基-頭份,2024-07-17,9296
1609,大亞,30,15,15,凱基-頭份,2024-07-17,9296
00936,台新永續高息中小,14,0,14,凱基-頭份,2024-07-17,9296
2538,基泰,13,0,13,凱基-頭份,2024-07-17,9296
6264,富裔,21,8,13,凱基-頭份,2024-07-17,9296
2881A,富邦特,12,0,12,凱基-頭份,2024-07-17,9296
5871,中租-KY,12,0,12,凱基-頭份,2024-07-17,9296
2489,瑞軒,17,5,12,凱基-頭份,2024-07-17,9296
00885,富邦越南,11,0,11,凱基-頭份,2024-07-17,9296
2537,聯上發,47,36,11,凱基-頭份,2024-07-17,9296
00751B,元大AAA至A公司債,10,0,10,凱基-頭份,2024-07-17,9296
00948B,中信優息投資級債,10,0,10,凱基-頭份,2024-07-17,9296
00949,復華日本龍頭,15,5,10,凱基-頭份,2024-07-17,9296
2515,中工,24,14,10,凱基-頭份,2024-07-17,9296
6155,鈞寶,10,0,10,凱基-頭份,2024-07-17,9296
8937,合騏,10,0,10,凱基-頭份,2024-07-17,9296
3050,鈺德,21,12,9,凱基-頭份,2024-07-17,9296
6546,正基,17,8,9,凱基-頭份,2024-07-17,9296
2330,台積電,8,0,8,凱基-頭份,2024-07-17,9296
2542,興富發,9,1,8,凱基-頭份,2024-07-17,9296
00735,國泰臺韓科技,8,0,8,凱基-頭份,2024-07-17,9296
2354,鴻準,8,0,8,凱基-頭份,2024-07-17,9296
00937B,群益ESG投等債20,238,8,230,凱基-頭份,2024-07-18,9296
00929,復華台灣科技優息,144,9,135,凱基-頭份,2024-07-18,9296
00632R,元大台灣50反1,129,25,104,凱基-頭份,2024-07-18,9296
2888,新光金,69,0,69,凱基-頭份,2024-07-18,9296
00919,群益台灣精選高息,90,30,60,凱基-頭份,2024-07-18,9296
2025,千興,59,11,48,凱基-頭份,2024-07-18,9296
1314,中石化,58,11,47,凱基-頭份,2024-07-18,9296
9946,三發地產,46,0,46,凱基-頭份,2024-07-18,9296
2867,三商壽,45,5,40,凱基-頭份,2024-07-18,9296
4960,誠美材,40,0,40,凱基-頭份,2024-07-18,9296
8099,大世科,31,0,31,凱基-頭份,2024-07-18,9296
00918,大華優利高填息30,22,0,22,凱基-頭份,2024-07-18,9296
3689,湧德,23,1,22,凱基-頭份,2024-07-18,9296
9906,欣巴巴,22,0,22,凱基-頭份,2024-07-18,9296
2449,京元電子,20,1,19,凱基-頭份,2024-07-18,9296
2331,精英,17,0,17,凱基-頭份,2024-07-18,9296
00927,群益半導體收益,17,0,17,凱基-頭份,2024-07-18,9296
00936,台新永續高息中小,16,0,16,凱基-頭份,2024-07-18,9296
00934,中信成長高股息,14,0,14,凱基-頭份,2024-07-18,9296
2548,華固,19,6,13,凱基-頭份,2024-07-18,9296
00878,國泰永續高股息,42,29,13,凱基-頭份,2024-07-18,9296
1316,上曜,15,3,12,凱基-頭份,2024-07-18,9296
2330,台積電,14,3,11,凱基-頭份,2024-07-18,9296
2356,英業達,11,0,11,凱基-頭份,2024-07-18,9296
2537,聯上發,13,2,11,凱基-頭份,2024-07-18,9296
3231,緯創,12,1,11,凱基-頭份,2024-07-18,9296
8227,巨有科技,12,1,11,凱基-頭份,2024-07-18,9296
00941,中信上游半導體,15,5,10,凱基-頭份,2024-07-18,9296
00881,國泰台灣5G+,11,1,10,凱基-頭份,2024-07-18,9296
1309,台達化,10,0,10,凱基-頭份,2024-07-18,9296
1402,遠東新,10,0,10,凱基-頭份,2024-07-18,9296
1432,大魯閣,10,0,10,凱基-頭份,2024-07-18,9296
2023,燁輝,10,0,10,凱基-頭份,2024-07-18,9296
2845,遠東銀,10,0,10,凱基-頭份,2024-07-18,9296
3037,欣興,13,3,10,凱基-頭份,2024-07-18,9296
6227,茂綸,10,0,10,凱基-頭份,2024-07-18,9296
8111,立��,10,0,10,凱基-頭份,2024-07-18,9296
2362,藍天,11,1,10,凱基-頭份,2024-07-18,9296
0056,元大高股息,19,9,10,凱基-頭份,2024-07-18,9296
00939,統一台灣高息動能,21,12,9,凱基-頭份,2024-07-18,9296
2547,日勝生,10,2,8,凱基-頭份,2024-07-18,9296
6282,康舒,8,0,8,凱基-頭份,2024-07-18,9296
1611,中電,7,0,7,凱基-頭份,2024-07-18,9296
2883,凱基金,12,5,7,凱基-頭份,2024-07-18,9296
5530,龍巖,10,3,7,凱基-頭份,2024-07-18,9296
5871,中租-KY,7,0,7,凱基-頭份,2024-07-18,9296
1609,大亞,38,32,6,凱基-頭份,2024-07-18,9296
00923,群益台ESG低碳50,16,10,6,凱基-頭份,2024-07-18,9296
2367,燿華,7,1,6,凱基-頭份,2024-07-18,9296
8011,台通,6,0,6,凱基-頭份,2024-07-18,9296
00929,復華台灣科技優息,145,0,145,凱基-頭份,2024-07-19,9296
00632R,元大台灣50反1,110,7,103,凱基-頭份,2024-07-19,9296
00933B,國泰10Y+金融債,101,1,100,凱基-頭份,2024-07-19,9296
00919,群益台灣精選高息,68,10,58,凱基-頭份,2024-07-19,9296
00878,國泰永續高股息,53,0,53,凱基-頭份,2024-07-19,9296
2371,大同,51,0,51,凱基-頭份,2024-07-19,9296
8069,元太,50,0,50,凱基-頭份,2024-07-19,9296
1504,東元,50,0,50,凱基-頭份,2024-07-19,9296
1312,國喬,41,0,41,凱基-頭份,2024-07-19,9296
2515,中工,42,3,39,凱基-頭份,2024-07-19,9296
00946,群益科技高息成長,36,0,36,凱基-頭份,2024-07-19,9296
0056,元大高股息,36,2,34,凱基-頭份,2024-07-19,9296
2891,中信金,34,0,34,凱基-頭份,2024-07-19,9296
3234,光環,35,1,34,凱基-頭份,2024-07-19,9296
9945,潤泰新,38,6,32,凱基-頭份,2024-07-19,9296
2618,長榮航,31,0,31,凱基-頭份,2024-07-19,9296
3481,群創,78,49,29,凱基-頭份,2024-07-19,9296
00940,元大台灣價值高息,55,26,29,凱基-頭份,2024-07-19,9296
2883,凱基金,27,1,26,凱基-頭份,2024-07-19,9296
2834,臺企銀,23,0,23,凱基-頭份,2024-07-19,9296
00881,國泰台灣5G+,20,0,20,凱基-頭份,2024-07-19,9296
2913,農林,20,0,20,凱基-頭份,2024-07-19,9296
1326,台化,20,0,20,凱基-頭份,2024-07-19,9296
2330,台積電,26,6,20,凱基-頭份,2024-07-19,9296
2509,全坤建,19,0,19,凱基-頭份,2024-07-19,9296
00918,大華優利高填息30,18,0,18,凱基-頭份,2024-07-19,9296
2303,聯電,17,0,17,凱基-頭份,2024-07-19,9296
2365,昆盈,60,44,16,凱基-頭份,2024-07-19,9296
00671R,富邦NASDAQ反1,15,0,15,凱基-頭份,2024-07-19,9296
00885,富邦越南,15,0,15,凱基-頭份,2024-07-19,9296
00939,統一台灣高息動能,23,8,15,凱基-頭份,2024-07-19,9296
8028,昇陽半導體,17,2,15,凱基-頭份,2024-07-19,9296
00936,台新永續高息中小,26,12,14,凱基-頭份,2024-07-19,9296
2025,千興,14,0,14,凱基-頭份,2024-07-19,9296
2426,鼎元,14,0,14,凱基-頭份,2024-07-19,9296
2867,三商壽,24,10,14,凱基-頭份,2024-07-19,9296
1785,光洋科,15,3,12,凱基-頭份,2024-07-19,9296
3706,神達,12,0,12,凱基-頭份,2024-07-19,9296
2243,宏旭-KY,12,1,11,凱基-頭份,2024-07-19,9296
2105,正新,10,0,10,凱基-頭份,2024-07-19,9296
2481,強茂,10,0,10,凱基-頭份,2024-07-19,9296
2538,基泰,10,0,10,凱基-頭份,2024-07-19,9296
2548,華固,10,0,10,凱基-頭份,2024-07-19,9296
2845,遠東銀,10,0,10,凱基-頭份,2024-07-19,9296
6016,康和證,10,0,10,凱基-頭份,2024-07-19,9296
6264,富裔,31,21,10,凱基-頭份,2024-07-19,9296
1609,大亞,32,22,10,凱基-頭份,2024-07-19,9296
1605,華新,10,1,9,凱基-頭份,2024-07-19,9296
00949,復華日本龍頭,8,0,8,凱基-頭份,2024-07-19,9296
3580,友威科,9,1,8,凱基-頭份,2024-07-19,9296
00929,復華台灣科技優息,255,21,234,凱基-頭份,2024-07-22,9296
00919,群益台灣精選高息,149,9,140,凱基-頭份,2024-07-22,9296
00940,元大台灣價值高息,78,6,72,凱基-頭份,2024-07-22,9296
00946,群益科技高息成長,78,10,68,凱基-頭份,2024-07-22,9296
00937B,群益ESG投等債20,67,13,54,凱基-頭份,2024-07-22,9296
1314,中石化,52,0,52,凱基-頭份,2024-07-22,9296
2312,金寶,52,0,52,凱基-頭份,2024-07-22,9296
00632R,元大台灣50反1,80,30,50,凱基-頭份,2024-07-22,9296
00878,國泰永續高股息,48,2,46,凱基-頭份,2024-07-22,9296
2845,遠東銀,38,0,38,凱基-頭份,2024-07-22,9296
2548,華固,38,0,38,凱基-頭份,2024-07-22,9296
911868,同方友友-DR,30,0,30,凱基-頭份,2024-07-22,9296
2328,廣宇,28,0,28,凱基-頭份,2024-07-22,9296
8111,立��,25,0,25,凱基-頭份,2024-07-22,9296
2883,凱基金,32,12,20,凱基-頭份,2024-07-22,9296
2913,農林,20,0,20,凱基-頭份,2024-07-22,9296
3290,東浦,20,0,20,凱基-頭份,2024-07-22,9296
6177,達麗,20,1,19,凱基-頭份,2024-07-22,9296
00950B,凱基A級公司債,20,3,17,凱基-頭份,2024-07-22,9296
0056,元大高股息,39,23,16,凱基-頭份,2024-07-22,9296
00939,統一台灣高息動能,18,2,16,凱基-頭份,2024-07-22,9296
00936,台新永續高息中小,14,1,13,凱基-頭份,2024-07-22,9296
6264,富裔,13,0,13,凱基-頭份,2024-07-22,9296
00905,FT臺灣Smart,12,0,12,凱基-頭份,2024-07-22,9296
8028,昇陽半導體,13,1,12,凱基-頭份,2024-07-22,9296
8222,寶一,12,0,12,凱基-頭份,2024-07-22,9296
8150,南茂,12,0,12,凱基-頭份,2024-07-22,9296
00934,中信成長高股息,26,15,11,凱基-頭份,2024-07-22,9296
2887,台新金,20,9,11,凱基-頭份,2024-07-22,9296
2303,聯電,16,5,11,凱基-頭份,2024-07-22,9296
2344,華邦電,20,9,11,凱基-頭份,2024-07-22,9296
4534,慶騰,11,0,11,凱基-頭份,2024-07-22,9296
2314,台揚,10,0,10,凱基-頭份,2024-07-22,9296
2605,新興,10,0,10,凱基-頭份,2024-07-22,9296
5236,凌陽創新,10,0,10,凱基-頭份,2024-07-22,9296
2104,國際中橡,9,0,9,凱基-頭份,2024-07-22,9296
2371,大同,9,0,9,凱基-頭份,2024-07-22,9296
6139,亞翔,10,1,9,凱基-頭份,2024-07-22,9296
9945,潤泰新,12,4,8,凱基-頭份,2024-07-22,9296
2317,鴻海,25,17,8,凱基-頭份,2024-07-22,9296
2393,億光,8,0,8,凱基-頭份,2024-07-22,9296
2498,宏達電,8,0,8,凱基-頭份,2024-07-22,9296
8046,南電,8,0,8,凱基-頭份,2024-07-22,9296
00927,群益半導體收益,8,0,8,凱基-頭份,2024-07-22,9296
00713,元大台灣高息低波,7,0,7,凱基-頭份,2024-07-22,9296
3019,亞光,14,7,7,凱基-頭份,2024-07-22,9296
6806,森崴能源,28,21,7,凱基-頭份,2024-07-22,9296
3583,辛耘,10,3,7,凱基-頭份,2024-07-22,9296
2330,台積電,11,5,6,凱基-頭份,2024-07-22,9296
1597,直得,9,3,6,凱基-頭份,2024-07-22,9296
3049,精金,280,0,280,凱基-頭份,2024-07-23,9296
2812,台中銀,204,0,204,凱基-頭份,2024-07-23,9296
2891,中信金,116,5,111,凱基-頭份,2024-07-23,9296
00664R,國泰臺灣加權反1,50,0,50,凱基-頭份,2024-07-23,9296
3481,群創,99,53,46,凱基-頭份,2024-07-23,9296
00929,復華台灣科技優息,74,39,35,凱基-頭份,2024-07-23,9296
00919,群益台灣精選高息,33,1,32,凱基-頭份,2024-07-23,9296
00937B,群益ESG投等債20,30,0,30,凱基-頭份,2024-07-23,9296
00878,國泰永續高股息,29,0,29,凱基-頭份,2024-07-23,9296
2426,鼎元,24,0,24,凱基-頭份,2024-07-23,9296
9105,泰金寶-DR,24,0,24,凱基-頭份,2024-07-23,9296
00934,中信成長高股息,23,0,23,凱基-頭份,2024-07-23,9296
5425,台半,20,0,20,凱基-頭份,2024-07-23,9296
2331,精英,20,2,18,凱基-頭份,2024-07-23,9296
0056,元大高股息,16,0,16,凱基-頭份,2024-07-23,9296
00933B,國泰10Y+金融債,15,0,15,凱基-頭份,2024-07-23,9296
2603,長榮,19,6,13,凱基-頭份,2024-07-23,9296
2408,南亞科,13,0,13,凱基-頭份,2024-07-23,9296
2406,國碩,12,0,12,凱基-頭份,2024-07-23,9296
00881,國泰台灣5G+,11,0,11,凱基-頭份,2024-07-23,9296
3520,華盈,11,0,11,凱基-頭份,2024-07-23,9296
00946,群益科技高息成長,12,2,10,凱基-頭份,2024-07-23,9296
1727,中華化,10,0,10,凱基-頭份,2024-07-23,9296
5443,均豪,16,6,10,凱基-頭份,2024-07-23,9296
6270,倍微,10,0,10,凱基-頭份,2024-07-23,9296
8277,商丞,10,0,10,凱基-頭份,2024-07-23,9296
2506,太設,10,1,9,凱基-頭份,2024-07-23,9296
9945,潤泰新,23,15,8,凱基-頭份,2024-07-23,9296
00940,元大台灣價值高息,9,2,7,凱基-頭份,2024-07-23,9296
1785,光洋科,8,1,7,凱基-頭份,2024-07-23,9296
00945B,凱基美國非投等債,7,0,7,凱基-頭份,2024-07-23,9296
2489,瑞軒,8,1,7,凱基-頭份,2024-07-23,9296
5519,隆大,7,0,7,凱基-頭份,2024-07-23,9296
3037,欣興,10,3,7,凱基-頭份,2024-07-23,9296
2881,富邦金,6,0,6,凱基-頭份,2024-07-23,9296
6147,頎邦,5,0,5,凱基-頭份,2024-07-23,9296
6869,雲豹能源,6,1,5,凱基-頭份,2024-07-23,9296
00795B,中信美國公債20年,5,0,5,凱基-頭份,2024-07-23,9296
00915,凱基優選高股息30,5,0,5,凱基-頭份,2024-07-23,9296
2393,億光,5,0,5,凱基-頭份,2024-07-23,9296
2409,友達,5,0,5,凱基-頭份,2024-07-23,9296
2617,台航,5,0,5,凱基-頭份,2024-07-23,9296
3704,合勤控,5,0,5,凱基-頭份,2024-07-23,9296
4303,信立,6,1,5,凱基-頭份,2024-07-23,9296
5474,聰泰,5,0,5,凱基-頭份,2024-07-23,9296
5529,鉅陞,5,0,5,凱基-頭份,2024-07-23,9296
6770,力積電,5,0,5,凱基-頭份,2024-07-23,9296
2002,中鋼,4,0,4,凱基-頭份,2024-07-23,9296
1447,力鵬,4,0,4,凱基-頭份,2024-07-23,9296
1451,年興,4,0,4,凱基-頭份,2024-07-23,9296
00933B,國泰10Y+金融債,200,10,190,凱基-頭份,2024-07-26,9296
00929,復華台灣科技優息,154,18,136,凱基-頭份,2024-07-26,9296
00940,元大台灣價值高息,85,5,80,凱基-頭份,2024-07-26,9296
00937B,群益ESG投等債20,74,1,73,凱基-頭份,2024-07-26,9296
3211,順達,50,0,50,凱基-頭份,2024-07-26,9296
2891,中信金,42,1,41,凱基-頭份,2024-07-26,9296
1570,力肯,39,0,39,凱基-頭份,2024-07-26,9296
9906,欣巴巴,43,5,38,凱基-頭份,2024-07-26,9296
00878,國泰永續高股息,41,6,35,凱基-頭份,2024-07-26,9296
2845,遠東銀,33,0,33,凱基-頭份,2024-07-26,9296
00919,群益台灣精選高息,31,0,31,凱基-頭份,2024-07-26,9296
00948B,中信優息投資級債,30,0,30,凱基-頭份,2024-07-26,9296
2838,聯邦銀,30,0,30,凱基-頭份,2024-07-26,9296
2486,一詮,33,4,29,凱基-頭份,2024-07-26,9296
9105,泰金寶-DR,28,0,28,凱基-頭份,2024-07-26,9296
2303,聯電,34,7,27,凱基-頭份,2024-07-26,9296
0056,元大高股息,28,1,27,凱基-頭份,2024-07-26,9296
00946,群益科技高息成長,26,0,26,凱基-頭份,2024-07-26,9296
00720B,元大投資級公司債,20,0,20,凱基-頭份,2024-07-26,9296
2344,華邦電,19,0,19,凱基-頭份,2024-07-26,9296
2330,台積電,20,2,18,凱基-頭份,2024-07-26,9296
00927,群益半導體收益,18,0,18,凱基-頭份,2024-07-26,9296
1229,聯華,17,0,17,凱基-頭份,2024-07-26,9296
6550,北極星藥業-KY,15,0,15,凱基-頭份,2024-07-26,9296
2884,玉山金,15,0,15,凱基-頭份,2024-07-26,9296
1314,中石化,13,0,13,凱基-頭份,2024-07-26,9296
00923,群益台ESG低碳50,12,0,12,凱基-頭份,2024-07-26,9296
6658,聯策,11,0,11,凱基-頭份,2024-07-26,9296
2331,精英,10,0,10,凱基-頭份,2024-07-26,9296
2444,兆勁,10,0,10,凱基-頭份,2024-07-26,9296
2509,全坤建,10,0,10,凱基-頭份,2024-07-26,9296
2538,基泰,10,0,10,凱基-頭份,2024-07-26,9296
3689,湧德,10,0,10,凱基-頭份,2024-07-26,9296
1608,華榮,16,8,8,凱基-頭份,2024-07-26,9296
2353,宏��,10,2,8,凱基-頭份,2024-07-26,9296
6139,亞翔,8,0,8,凱基-頭份,2024-07-26,9296
0050,元大台灣50,8,0,8,凱基-頭份,2024-07-26,9296
00941,中信上游半導體,7,0,7,凱基-頭份,2024-07-26,9296
2409,友達,9,2,7,凱基-頭份,2024-07-26,9296
00931B,統一美債20年,6,0,6,凱基-頭份,2024-07-26,9296
00881,國泰台灣5G+,6,0,6,凱基-頭份,2024-07-26,9296
2340,台亞,6,0,6,凱基-頭份,2024-07-26,9296
2887,台新金,6,0,6,凱基-頭份,2024-07-26,9296
3230,錦明,6,0,6,凱基-頭份,2024-07-26,9296
00757,統一FANG+,5,0,5,凱基-頭份,2024-07-26,9296
00882,中信中國高股息,5,0,5,凱基-頭份,2024-07-26,9296
00795B,中信美國公債20年,5,0,5,凱基-頭份,2024-07-26,9296
2349,錸德,57,52,5,凱基-頭份,2024-07-26,9296
2616,山隆,5,0,5,凱基-頭份,2024-07-26,9296
4533,協易機,5,0,5,凱基-頭份,2024-07-26,9296
00945B,凱基美國非投等債,3652,0,3652,凱基-頭份,2024-07-29,9296
00929,復華台灣科技優息,92,13,79,凱基-頭份,2024-07-29,9296
3703,欣陸,46,0,46,凱基-頭份,2024-07-29,9296
0056,元大高股息,33,3,30,凱基-頭份,2024-07-29,9296
00757,統一FANG+,29,0,29,凱基-頭份,2024-07-29,9296
00662,富邦NASDAQ,25,0,25,凱基-頭份,2024-07-29,9296
2845,遠東銀,21,0,21,凱基-頭份,2024-07-29,9296
2365,昆盈,91,71,20,凱基-頭份,2024-07-29,9296
00680L,元大美債20正2,20,0,20,凱基-頭份,2024-07-29,9296
00940,元大台灣價值高息,22,2,20,凱基-頭份,2024-07-29,9296
00878,國泰永續高股息,17,1,16,凱基-頭份,2024-07-29,9296
2356,英業達,20,5,15,凱基-頭份,2024-07-29,9296
3224,三顧,15,0,15,凱基-頭份,2024-07-29,9296
3481,群創,46,31,15,凱基-頭份,2024-07-29,9296
2353,宏��,14,0,14,凱基-頭份,2024-07-29,9296
2515,中工,25,12,13,凱基-頭份,2024-07-29,9296
00919,群益台灣精選高息,14,3,11,凱基-頭份,2024-07-29,9296
00946,群益科技高息成長,11,0,11,凱基-頭份,2024-07-29,9296
2301,光寶科,11,0,11,凱基-頭份,2024-07-29,9296
2891,中信金,10,0,10,凱基-頭份,2024-07-29,9296
00637L,元大滬深300正2,10,0,10,凱基-頭份,2024-07-29,9296
1570,力肯,10,0,10,凱基-頭份,2024-07-29,9296
6264,富裔,10,0,10,凱基-頭份,2024-07-29,9296
8150,南茂,10,0,10,凱基-頭份,2024-07-29,9296
9906,欣巴巴,22,12,10,凱基-頭份,2024-07-29,9296
8096,擎亞,10,1,9,凱基-頭份,2024-07-29,9296
2426,鼎元,9,0,9,凱基-頭份,2024-07-29,9296
2834,臺企銀,9,0,9,凱基-頭份,2024-07-29,9296
2884,玉山金,13,4,9,凱基-頭份,2024-07-29,9296
6179,亞通,8,0,8,凱基-頭份,2024-07-29,9296
00923,群益台ESG低碳50,7,0,7,凱基-頭份,2024-07-29,9296
1513,中興電,7,0,7,凱基-頭份,2024-07-29,9296
9945,潤泰新,14,7,7,凱基-頭份,2024-07-29,9296
3163,波若威,15,9,6,凱基-頭份,2024-07-29,9296
00882,中信中國高股息,6,0,6,凱基-頭份,2024-07-29,9296
2324,仁寶,6,0,6,凱基-頭份,2024-07-29,9296
2915,潤泰全,6,0,6,凱基-頭份,2024-07-29,9296
3231,緯創,11,5,6,凱基-頭份,2024-07-29,9296
3294,英濟,6,0,6,凱基-頭份,2024-07-29,9296
5512,力麒,6,0,6,凱基-頭份,2024-07-29,9296
8054,安國,15,10,5,凱基-頭份,2024-07-29,9296
6550,北極星藥業-KY,5,0,5,凱基-頭份,2024-07-29,9296
2548,華固,5,0,5,凱基-頭份,2024-07-29,9296
2605,新興,5,0,5,凱基-頭份,2024-07-29,9296
3338,泰碩,5,0,5,凱基-頭份,2024-07-29,9296
5309,系統電,5,0,5,凱基-頭份,2024-07-29,9296
5474,聰泰,5,0,5,凱基-頭份,2024-07-29,9296
2486,一詮,5,0,5,凱基-頭份,2024-07-29,9296
00936,台新永續高息中小,4,0,4,凱基-頭份,2024-07-29,9296
2379,瑞昱,4,0,4,凱基-頭份,2024-07-29,9296
00632R,元大台灣50反1,670,70,600,凱基-頭份,2024-07-30,9296
00929,復華台灣科技優息,214,42,172,凱基-頭份,2024-07-30,9296
00919,群益台灣精選高息,112,11,101,凱基-頭份,2024-07-30,9296
00940,元大台灣價值高息,91,10,81,凱基-頭份,2024-07-30,9296
2801,彰銀,41,0,41,凱基-頭份,2024-07-30,9296
2884,玉山金,34,0,34,凱基-頭份,2024-07-30,9296
9946,三發地產,33,0,33,凱基-頭份,2024-07-30,9296
00665L,富邦�琤肭磪囓�2,30,0,30,凱基-頭份,2024-07-30,9296
3024,憶聲,31,1,30,凱基-頭份,2024-07-30,9296
2891,中信金,29,0,29,凱基-頭份,2024-07-30,9296
3663,鑫科,27,1,26,凱基-頭份,2024-07-30,9296
2867,三商壽,23,0,23,凱基-頭份,2024-07-30,9296
0056,元大高股息,25,4,21,凱基-頭份,2024-07-30,9296
00878,國泰永續高股息,21,0,21,凱基-頭份,2024-07-30,9296
00946,群益科技高息成長,19,0,19,凱基-頭份,2024-07-30,9296
2344,華邦電,28,9,19,凱基-頭份,2024-07-30,9296
4123,晟德,18,0,18,凱基-頭份,2024-07-30,9296
3710,連展投控,18,2,16,凱基-頭份,2024-07-30,9296
1316,上曜,15,0,15,凱基-頭份,2024-07-30,9296
2417,圓剛,13,0,13,凱基-頭份,2024-07-30,9296
00795B,中信美國公債20年,13,0,13,凱基-頭份,2024-07-30,9296
006208,富邦台50,12,0,12,凱基-頭份,2024-07-30,9296
00937B,群益ESG投等債20,11,0,11,凱基-頭份,2024-07-30,9296
2409,友達,13,2,11,凱基-頭份,2024-07-30,9296
00931B,統一美債20年,10,0,10,凱基-頭份,2024-07-30,9296
00715L,期街口布蘭特正2,10,0,10,凱基-頭份,2024-07-30,9296
00950B,凱基A級公司債,10,0,10,凱基-頭份,2024-07-30,9296
2331,精英,10,0,10,凱基-頭份,2024-07-30,9296
2489,瑞軒,11,1,10,凱基-頭份,2024-07-30,9296
2605,新興,10,0,10,凱基-頭份,2024-07-30,9296
6182,合晶,10,0,10,凱基-頭份,2024-07-30,9296
2363,矽統,12,3,9,凱基-頭份,2024-07-30,9296
2834,臺企銀,9,0,9,凱基-頭份,2024-07-30,9296
4906,正文,10,1,9,凱基-頭份,2024-07-30,9296
6177,達麗,6,0,6,凱基-頭份,2024-07-30,9296
6219,富旺,6,0,6,凱基-頭份,2024-07-30,9296
00637L,元大滬深300正2,10,5,5,凱基-頭份,2024-07-30,9296
00688L,國泰20年美債正2,5,0,5,凱基-頭份,2024-07-30,9296
1314,中石化,5,0,5,凱基-頭份,2024-07-30,9296
2548,華固,5,0,5,凱基-頭份,2024-07-30,9296
3027,盛達,5,0,5,凱基-頭份,2024-07-30,9296
5512,力麒,9,4,5,凱基-頭份,2024-07-30,9296
2317,鴻海,6,2,4,凱基-頭份,2024-07-30,9296
2330,台積電,6,1,5,凱基-頭份,2024-07-30,9296
00713,元大台灣高息低波,4,0,4,凱基-頭份,2024-07-30,9296
2395,研華,4,0,4,凱基-頭份,2024-07-30,9296
00918,大華優利高填息30,4,0,4,凱基-頭份,2024-07-30,9296
00951,台新日本半導體,4,0,4,凱基-頭份,2024-07-30,9296
1409,新纖,4,0,4,凱基-頭份,2024-07-30,9296
2449,京元電子,4,0,4,凱基-頭份,2024-07-30,9296
00712,復華富時不動產,100,2,98,凱基-頭份,2024-07-31,9296
00937B,群益ESG投等債20,92,1,91,凱基-頭份,2024-07-31,9296
00945B,凱基美國非投等債,82,0,82,凱基-頭份,2024-07-31,9296
00940,元大台灣價值高息,70,0,70,凱基-頭份,2024-07-31,9296
00929,復華台灣科技優息,53,1,52,凱基-頭份,2024-07-31,9296
9105,泰金寶-DR,45,5,40,凱基-頭份,2024-07-31,9296
2442,新美齊,31,0,31,凱基-頭份,2024-07-31,9296
3481,群創,92,64,28,凱基-頭份,2024-07-31,9296
6264,富裔,23,0,23,凱基-頭份,2024-07-31,9296
2834,臺企銀,34,12,22,凱基-頭份,2024-07-31,9296
2838,聯邦銀,20,0,20,凱基-頭份,2024-07-31,9296
3224,三顧,20,0,20,凱基-頭份,2024-07-31,9296
9906,欣巴巴,18,0,18,凱基-頭份,2024-07-31,9296
2316,楠梓電,15,0,15,凱基-頭份,2024-07-31,9296
6770,力積電,16,1,15,凱基-頭份,2024-07-31,9296
00919,群益台灣精選高息,16,4,12,凱基-頭份,2024-07-31,9296
2353,宏��,12,0,12,凱基-頭份,2024-07-31,9296
00946,群益科技高息成長,11,0,11,凱基-頭份,2024-07-31,9296
3047,訊舟,39,29,10,凱基-頭份,2024-07-31,9296
2382,廣達,11,1,10,凱基-頭份,2024-07-31,9296
00931B,統一美債20年,10,0,10,凱基-頭份,2024-07-31,9296
1316,上曜,10,0,10,凱基-頭份,2024-07-31,9296
2883,凱基金,11,1,10,凱基-頭份,2024-07-31,9296
5469,瀚宇博,10,0,10,凱基-頭份,2024-07-31,9296
00936,台新永續高息中小,9,1,8,凱基-頭份,2024-07-31,9296
2444,兆勁,8,0,8,凱基-頭份,2024-07-31,9296
4532,瑞智,10,2,8,凱基-頭份,2024-07-31,9296
00939,統一台灣高息動能,8,2,6,凱基-頭份,2024-07-31,9296
00882,中信中國高股息,8,2,6,凱基-頭份,2024-07-31,9296
3312,弘憶股,6,0,6,凱基-頭份,2024-07-31,9296
4128,中天,6,0,6,凱基-頭份,2024-07-31,9296
4513,福裕,6,0,6,凱基-頭份,2024-07-31,9296
4563,百德,6,0,6,凱基-頭份,2024-07-31,9296
6116,彩晶,24,18,6,凱基-頭份,2024-07-31,9296
8936,國統,6,0,6,凱基-頭份,2024-07-31,9296
2449,京元電子,7,2,5,凱基-頭份,2024-07-31,9296
6187,萬潤,6,1,5,凱基-頭份,2024-07-31,9296
2393,億光,5,0,5,凱基-頭份,2024-07-31,9296
5425,台半,5,0,5,凱基-頭份,2024-07-31,9296
5443,均豪,14,9,5,凱基-頭份,2024-07-31,9296
8440,綠電,9,4,5,凱基-頭份,2024-07-31,9296
2881,富邦金,6,2,4,凱基-頭份,2024-07-31,9296
2362,藍天,5,1,4,凱基-頭份,2024-07-31,9296
2486,一詮,8,4,4,凱基-頭份,2024-07-31,9296
2515,中工,8,4,4,凱基-頭份,2024-07-31,9296
3686,達能,4,0,4,凱基-頭份,2024-07-31,9296
4526,東台,5,1,4,凱基-頭份,2024-07-31,9296
8110,華東,4,0,4,凱基-頭份,2024-07-31,9296
00878,國泰永續高股息,6,2,4,凱基-頭份,2024-07-31,9296
8028,昇陽半導體,26,22,4,凱基-頭份,2024-07-31,9296
00632R,元大台灣50反1,100,0,100,凱基-頭份,2024-08-01,9296
00751B,元大AAA至A公司債,50,0,50,凱基-頭份,2024-08-01,9296
00673R,期元大S＆P原油反1,50,0,50,凱基-頭份,2024-08-01,9296
2538,基泰,50,0,50,凱基-頭份,2024-08-01,9296
9934,成霖,50,0,50,凱基-頭份,2024-08-01,9296
00679B,元大美債20年,45,1,44,凱基-頭份,2024-08-01,9296
00929,復華台灣科技優息,50,9,41,凱基-頭份,2024-08-01,9296
9946,三發地產,33,0,33,凱基-頭份,2024-08-01,9296
00881,國泰台灣5G+,34,2,32,凱基-頭份,2024-08-01,9296
2891,中信金,30,0,30,凱基-頭份,2024-08-01,9296
2409,友達,32,2,30,凱基-頭份,2024-08-01,9296
2477,美隆電,30,0,30,凱基-頭份,2024-08-01,9296
00878,國泰永續高股息,34,5,29,凱基-頭份,2024-08-01,9296
00753L,中信中國50正2,25,0,25,凱基-頭份,2024-08-01,9296
00687B,國泰20年美債,24,2,22,凱基-頭份,2024-08-01,9296
00720B,元大投資級公司債,40,20,20,凱基-頭份,2024-08-01,9296
00919,群益台灣精選高息,22,3,19,凱基-頭份,2024-08-01,9296
3673,TPK-KY,18,0,18,凱基-頭份,2024-08-01,9296
2356,英業達,18,2,16,凱基-頭份,2024-08-01,9296
1513,中興電,17,4,13,凱基-頭份,2024-08-01,9296
00680L,元大美債20正2,12,0,12,凱基-頭份,2024-08-01,9296
00950B,凱基A級公司債,10,0,10,凱基-頭份,2024-08-01,9296
3491,昇達科,10,0,10,凱基-頭份,2024-08-01,9296
2442,新美齊,11,2,9,凱基-頭份,2024-08-01,9296
00945B,凱基美國非投等債,8,0,8,凱基-頭份,2024-08-01,9296
1906,寶隆,8,0,8,凱基-頭份,2024-08-01,9296
2002,中鋼,10,2,8,凱基-頭份,2024-08-01,9296
2887,台新金,8,0,8,凱基-頭份,2024-08-01,9296
8096,擎亞,10,2,8,凱基-頭份,2024-08-01,9296
2363,矽統,11,5,6,凱基-頭份,2024-08-01,9296
00631L,元大台灣50正2,6,0,6,凱基-頭份,2024-08-01,9296
3019,亞光,10,4,6,凱基-頭份,2024-08-01,9296
3231,緯創,6,0,6,凱基-頭份,2024-08-01,9296
6206,飛捷,6,0,6,凱基-頭份,2024-08-01,9296
2353,宏��,7,1,6,凱基-頭份,2024-08-01,9296
1582,信錦,5,0,5,凱基-頭份,2024-08-01,9296
1711,永光,5,0,5,凱基-頭份,2024-08-01,9296
3027,盛達,5,0,5,凱基-頭份,2024-08-01,9296
6227,茂綸,5,0,5,凱基-頭份,2024-08-01,9296
00934,中信成長高股息,6,2,4,凱基-頭份,2024-08-01,9296
2382,廣達,4,0,4,凱基-頭份,2024-08-01,9296
00933B,國泰10Y+金融債,4,0,4,凱基-頭份,2024-08-01,9296
00949,復華日本龍頭,4,0,4,凱基-頭份,2024-08-01,9296
00891,中信關鍵半導體,4,0,4,凱基-頭份,2024-08-01,9296
2383,台光電,5,1,4,凱基-頭份,2024-08-01,9296
2884,玉山金,5,1,4,凱基-頭份,2024-08-01,9296
3686,達能,4,0,4,凱基-頭份,2024-08-01,9296
4107,邦特,4,0,4,凱基-頭份,2024-08-01,9296
6239,力成,4,0,4,凱基-頭份,2024-08-01,9296
3037,欣興,7,3,4,凱基-頭份,2024-08-01,9296
00679B,元大美債20年,1967,52,1915,凱基-頭份,2024-08-02,9296
00929,復華台灣科技優息,199,1,198,凱基-頭份,2024-08-02,9296
00878,國泰永續高股息,145,0,145,凱基-頭份,2024-08-02,9296
00919,群益台灣精選高息,127,1,126,凱基-頭份,2024-08-02,9296
00680L,元大美債20正2,110,0,110,凱基-頭份,2024-08-02,9296
00940,元大台灣價值高息,104,1,103,凱基-頭份,2024-08-02,9296
00881,國泰台灣5G+,103,0,103,凱基-頭份,2024-08-02,9296
9946,三發地產,84,0,84,凱基-頭份,2024-08-02,9296
00937B,群益ESG投等債20,75,12,63,凱基-頭份,2024-08-02,9296
2618,長榮航,52,1,51,凱基-頭份,2024-08-02,9296
00632R,元大台灣50反1,50,0,50,凱基-頭份,2024-08-02,9296
2891,中信金,42,0,42,凱基-頭份,2024-08-02,9296
0056,元大高股息,44,3,41,凱基-頭份,2024-08-02,9296
00673R,期元大S＆P原油反1,90,50,40,凱基-頭份,2024-08-02,9296
2317,鴻海,36,1,35,凱基-頭份,2024-08-02,9296
00857B,永豐20年美公債,30,0,30,凱基-頭份,2024-08-02,9296
2442,新美齊,30,0,30,凱基-頭份,2024-08-02,9296
2330,台積電,29,0,29,凱基-頭份,2024-08-02,9296
2834,臺企銀,36,10,26,凱基-頭份,2024-08-02,9296
2477,美隆電,25,0,25,凱基-頭份,2024-08-02,9296
9906,欣巴巴,27,2,25,凱基-頭份,2024-08-02,9296
00715L,期街口布蘭特正2,22,0,22,凱基-頭份,2024-08-02,9296
00948B,中信優息投資級債,20,0,20,凱基-頭份,2024-08-02,9296
2417,圓剛,20,0,20,凱基-頭份,2024-08-02,9296
2444,兆勁,20,0,20,凱基-頭份,2024-08-02,9296
9945,潤泰新,28,8,20,凱基-頭份,2024-08-02,9296
006208,富邦台50,20,0,20,凱基-頭份,2024-08-02,9296
00923,群益台ESG低碳50,16,0,16,凱基-頭份,2024-08-02,9296
2449,京元電子,17,3,14,凱基-頭份,2024-08-02,9296
2337,旺宏,24,11,13,凱基-頭份,2024-08-02,9296
2845,遠東銀,13,0,13,凱基-頭份,2024-08-02,9296
0050,元大台灣50,13,1,12,凱基-頭份,2024-08-02,9296
00751B,元大AAA至A公司債,12,0,12,凱基-頭份,2024-08-02,9296
2344,華邦電,23,12,11,凱基-頭份,2024-08-02,9296
00888,永豐台灣ESG,11,0,11,凱基-頭份,2024-08-02,9296
00665L,富邦�琤肭磪囓�2,10,0,10,凱基-頭份,2024-08-02,9296
00946,群益科技高息成長,10,0,10,凱基-頭份,2024-08-02,9296
2363,矽統,12,2,10,凱基-頭份,2024-08-02,9296
2516,新建,10,0,10,凱基-頭份,2024-08-02,9296
5493,三聯,10,0,10,凱基-頭份,2024-08-02,9296
00918,大華優利高填息30,9,0,9,凱基-頭份,2024-08-02,9296
2392,正崴,10,1,9,凱基-頭份,2024-08-02,9296
2609,陽明,12,3,9,凱基-頭份,2024-08-02,9296
3535,晶彩科,16,7,9,凱基-頭份,2024-08-02,9296
2352,佳世達,8,0,8,凱基-頭份,2024-08-02,9296
5443,均豪,21,13,8,凱基-頭份,2024-08-02,9296
8028,昇陽半導體,9,1,8,凱基-頭份,2024-08-02,9296
00900,富邦特選高股息30,8,0,8,凱基-頭份,2024-08-02,9296
3037,欣興,7,0,7,凱基-頭份,2024-08-02,9296
2303,聯電,20,13,7,凱基-頭份,2024-08-02,9296
00929,復華台灣科技優息,359,52,307,凱基-頭份,2024-08-05,9296
00680L,元大美債20正2,259,1,258,凱基-頭份,2024-08-05,9296
00940,元大台灣價值高息,221,21,200,凱基-頭份,2024-08-05,9296
00878,國泰永續高股息,170,59,111,凱基-頭份,2024-08-05,9296
2365,昆盈,76,8,68,凱基-頭份,2024-08-05,9296
00679B,元大美債20年,70,14,56,凱基-頭份,2024-08-05,9296
2883,凱基金,57,10,47,凱基-頭份,2024-08-05,9296
00937B,群益ESG投等債20,67,22,45,凱基-頭份,2024-08-05,9296
00712,復華富時不動產,53,8,45,凱基-頭份,2024-08-05,9296
00919,群益台灣精選高息,85,42,43,凱基-頭份,2024-08-05,9296
6177,達麗,72,30,42,凱基-頭份,2024-08-05,9296
00946,群益科技高息成長,39,0,39,凱基-頭份,2024-08-05,9296
2834,臺企銀,99,62,37,凱基-頭份,2024-08-05,9296
00923,群益台ESG低碳50,36,0,36,凱基-頭份,2024-08-05,9296
2002,中鋼,40,10,30,凱基-頭份,2024-08-05,9296
2312,金寶,31,2,29,凱基-頭份,2024-08-05,9296
00631L,元大台灣50正2,31,3,28,凱基-頭份,2024-08-05,9296
2884,玉山金,39,12,27,凱基-頭份,2024-08-05,9296
2845,遠東銀,26,1,25,凱基-頭份,2024-08-05,9296
0056,元大高股息,71,47,24,凱基-頭份,2024-08-05,9296
9105,泰金寶-DR,35,11,24,凱基-頭份,2024-08-05,9296
00857B,永豐20年美公債,22,0,22,凱基-頭份,2024-08-05,9296
4919,新唐,20,0,20,凱基-頭份,2024-08-05,9296
00715L,期街口布蘭特正2,29,10,19,凱基-頭份,2024-08-05,9296
3481,群創,107,89,18,凱基-頭份,2024-08-05,9296
2353,宏��,21,4,17,凱基-頭份,2024-08-05,9296
2442,新美齊,21,5,16,凱基-頭份,2024-08-05,9296
2477,美隆電,15,0,15,凱基-頭份,2024-08-05,9296
2303,聯電,32,18,14,凱基-頭份,2024-08-05,9296
00915,凱基優選高股息30,18,4,14,凱基-頭份,2024-08-05,9296
2887,台新金,14,1,13,凱基-頭份,2024-08-05,9296
0050,元大台灣50,16,3,13,凱基-頭份,2024-08-05,9296
2330,台積電,25,13,12,凱基-頭份,2024-08-05,9296
3062,建漢,12,0,12,凱基-頭份,2024-08-05,9296
9906,欣巴巴,18,6,12,凱基-頭份,2024-08-05,9296
006208,富邦台50,15,4,11,凱基-頭份,2024-08-05,9296
00687B,國泰20年美債,12,1,11,凱基-頭份,2024-08-05,9296
2892,第一金,11,0,11,凱基-頭份,2024-08-05,9296
3046,建��,11,0,11,凱基-頭份,2024-08-05,9296
6290,良維,11,0,11,凱基-頭份,2024-08-05,9296
2363,矽統,16,6,10,凱基-頭份,2024-08-05,9296
00665L,富邦�琤肭磪囓�2,10,0,10,凱基-頭份,2024-08-05,9296
00931B,統一美債20年,12,2,10,凱基-頭份,2024-08-05,9296
2009,第一銅,10,0,10,凱基-頭份,2024-08-05,9296
2025,千興,10,0,10,凱基-頭份,2024-08-05,9296
2066,世德,10,0,10,凱基-頭份,2024-08-05,9296
2417,圓剛,10,0,10,凱基-頭份,2024-08-05,9296
2444,兆勁,10,0,10,凱基-頭份,2024-08-05,9296
3290,東浦,10,0,10,凱基-頭份,2024-08-05,9296
4510,高鋒,16,6,10,凱基-頭份,2024-08-05,9296
2882,國泰金,1059,14,1045,凱基-頭份,2024-08-06,9296
00680L,元大美債20正2,530,333,197,凱基-頭份,2024-08-06,9296
911868,同方友友-DR,150,0,150,凱基-頭份,2024-08-06,9296
6219,富旺,59,1,58,凱基-頭份,2024-08-06,9296
00632R,元大台灣50反1,93,40,53,凱基-頭份,2024-08-06,9296
00674R,期元大S＆P黃金反1,52,0,52,凱基-頭份,2024-08-06,9296
6177,達麗,48,2,46,凱基-頭份,2024-08-06,9296
00940,元大台灣價值高息,82,37,45,凱基-頭份,2024-08-06,9296
00919,群益台灣精選高息,51,22,29,凱基-頭份,2024-08-06,9296
00934,中信成長高股息,41,12,29,凱基-頭份,2024-08-06,9296
2337,旺宏,42,13,29,凱基-頭份,2024-08-06,9296
2442,新美齊,25,0,25,凱基-頭份,2024-08-06,9296
1540,喬福,57,32,25,凱基-頭份,2024-08-06,9296
2324,仁寶,20,0,20,凱基-頭份,2024-08-06,9296
3050,鈺德,20,0,20,凱基-頭份,2024-08-06,9296
3481,群創,119,100,19,凱基-頭份,2024-08-06,9296
2002,中鋼,19,2,17,凱基-頭份,2024-08-06,9296
2426,鼎元,17,0,17,凱基-頭份,2024-08-06,9296
00929,復華台灣科技優息,42,25,17,凱基-頭份,2024-08-06,9296
2887,台新金,30,13,17,凱基-頭份,2024-08-06,9296
2516,新建,15,0,15,凱基-頭份,2024-08-06,9296
5521,工信,15,0,15,凱基-頭份,2024-08-06,9296
5871,中租-KY,12,0,12,凱基-頭份,2024-08-06,9296
6282,康舒,23,11,12,凱基-頭份,2024-08-06,9296
6239,力成,11,0,11,凱基-頭份,2024-08-06,9296
00931B,統一美債20年,10,0,10,凱基-頭份,2024-08-06,9296
00664R,國泰臺灣加權反1,10,0,10,凱基-頭份,2024-08-06,9296
1711,永光,10,0,10,凱基-頭份,2024-08-06,9296
2834,臺企銀,25,15,10,凱基-頭份,2024-08-06,9296
3576,聯合再生,10,0,10,凱基-頭份,2024-08-06,9296
4956,光鋐,10,0,10,凱基-頭份,2024-08-06,9296
6213,聯茂,11,1,10,凱基-頭份,2024-08-06,9296
8150,南茂,10,0,10,凱基-頭份,2024-08-06,9296
00878,國泰永續高股息,74,66,8,凱基-頭份,2024-08-06,9296
00795B,中信美國公債20年,8,0,8,凱基-頭份,2024-08-06,9296
00933B,國泰10Y+金融債,9,1,8,凱基-頭份,2024-08-06,9296
2880,華南金,8,0,8,凱基-頭份,2024-08-06,9296
00692,富邦公司治理,8,0,8,凱基-頭份,2024-08-06,9296
00915,凱基優選高股息30,7,0,7,凱基-頭份,2024-08-06,9296
3037,欣興,12,5,7,凱基-頭份,2024-08-06,9296
6743,安普新,7,0,7,凱基-頭份,2024-08-06,9296
8043,蜜望實,7,0,7,凱基-頭份,2024-08-06,9296
00918,大華優利高填息30,6,0,6,凱基-頭份,2024-08-06,9296
0050,元大台灣50,9,3,6,凱基-頭份,2024-08-06,9296
2610,華航,6,0,6,凱基-頭份,2024-08-06,9296
8438,昶昕,6,0,6,凱基-頭份,2024-08-06,9296
2365,昆盈,26,21,5,凱基-頭份,2024-08-06,9296
00891,中信關鍵半導體,5,0,5,凱基-頭份,2024-08-06,9296
1101,台泥,5,0,5,凱基-頭份,2024-08-06,9296
9945,潤泰新,5,0,5,凱基-頭份,2024-08-06,9296
00664R,國泰臺灣加權反1,200,0,200,凱基-頭份,2024-08-07,9296
00937B,群益ESG投等債20,200,3,197,凱基-頭份,2024-08-07,9296
00940,元大台灣價值高息,195,21,174,凱基-頭份,2024-08-07,9296
00929,復華台灣科技優息,81,16,65,凱基-頭份,2024-08-07,9296
3043,科風,64,0,64,凱基-頭份,2024-08-07,9296
00632R,元大台灣50反1,52,1,51,凱基-頭份,2024-08-07,9296
2442,新美齊,50,0,50,凱基-頭份,2024-08-07,9296
00680L,元大美債20正2,45,3,42,凱基-頭份,2024-08-07,9296
3481,群創,65,31,34,凱基-頭份,2024-08-07,9296
00679B,元大美債20年,40,12,28,凱基-頭份,2024-08-07,9296
00674R,期元大S＆P黃金反1,24,0,24,凱基-頭份,2024-08-07,9296
3024,憶聲,24,0,24,凱基-頭份,2024-08-07,9296
4198,欣大健康,24,0,24,凱基-頭份,2024-08-07,9296
00753L,中信中國50正2,20,0,20,凱基-頭份,2024-08-07,9296
2887,台新金,19,0,19,凱基-頭份,2024-08-07,9296
1314,中石化,21,4,17,凱基-頭份,2024-08-07,9296
00715L,期街口布蘭特正2,16,0,16,凱基-頭份,2024-08-07,9296
6198,瑞築,15,0,15,凱基-頭份,2024-08-07,9296
2317,鴻海,25,11,14,凱基-頭份,2024-08-07,9296
00941,中信上游半導體,12,0,12,凱基-頭份,2024-08-07,9296
2891,中信金,12,0,12,凱基-頭份,2024-08-07,9296
00637L,元大滬深300正2,11,0,11,凱基-頭份,2024-08-07,9296
2337,旺宏,11,0,11,凱基-頭份,2024-08-07,9296
00731,復華富時高息低波,10,0,10,凱基-頭份,2024-08-07,9296
00686R,群益臺灣加權反1,10,0,10,凱基-頭份,2024-08-07,9296
2406,國碩,10,0,10,凱基-頭份,2024-08-07,9296
2457,飛宏,11,1,10,凱基-頭份,2024-08-07,9296
3023,信邦,10,1,9,凱基-頭份,2024-08-07,9296
2441,超豐,9,0,9,凱基-頭份,2024-08-07,9296
2867,三商壽,20,11,9,凱基-頭份,2024-08-07,9296
3037,欣興,11,2,9,凱基-頭份,2024-08-07,9296
2409,友達,9,1,8,凱基-頭份,2024-08-07,9296
6261,久元,8,0,8,凱基-頭份,2024-08-07,9296
6877,鏵友益,9,1,8,凱基-頭份,2024-08-07,9296
2382,廣達,8,1,7,凱基-頭份,2024-08-07,9296
9902,台火,7,0,7,凱基-頭份,2024-08-07,9296
00687B,國泰20年美債,7,0,7,凱基-頭份,2024-08-07,9296
00688L,國泰20年美債正2,7,2,5,凱基-頭份,2024-08-07,9296
1316,上曜,5,0,5,凱基-頭份,2024-08-07,9296
2534,宏盛,5,0,5,凱基-頭份,2024-08-07,9296
2636,台驊控股,5,0,5,凱基-頭份,2024-08-07,9296
2812,台中銀,5,0,5,凱基-頭份,2024-08-07,9296
2888,新光金,5,0,5,凱基-頭份,2024-08-07,9296
3376,新日興,5,0,5,凱基-頭份,2024-08-07,9296
6005,群益證,5,0,5,凱基-頭份,2024-08-07,9296
6257,矽格,15,10,5,凱基-頭份,2024-08-07,9296
8438,昶昕,5,0,5,凱基-頭份,2024-08-07,9296
9934,成霖,5,0,5,凱基-頭份,2024-08-07,9296
2542,興富發,6,1,5,凱基-頭份,2024-08-07,9296
00878,國泰永續高股息,20,15,5,凱基-頭份,2024-08-07,9296
00937B,群益ESG投等債20,209,1,208,凱基-頭份,2024-08-08,9296
00664R,國泰臺灣加權反1,200,0,200,凱基-頭份,2024-08-08,9296
8105,凌巨,91,0,91,凱基-頭份,2024-08-08,9296
00929,復華台灣科技優息,59,4,55,凱基-頭份,2024-08-08,9296
2845,遠東銀,50,0,50,凱基-頭份,2024-08-08,9296
00680L,元大美債20正2,40,0,40,凱基-頭份,2024-08-08,9296
00632R,元大台灣50反1,80,50,30,凱基-頭份,2024-08-08,9296
6177,達麗,31,1,30,凱基-頭份,2024-08-08,9296
2409,友達,39,11,28,凱基-頭份,2024-08-08,9296
4566,時碩工業,27,2,25,凱基-頭份,2024-08-08,9296
00687B,國泰20年美債,31,10,21,凱基-頭份,2024-08-08,9296
2442,新美齊,20,0,20,凱基-頭份,2024-08-08,9296
00878,國泰永續高股息,35,15,20,凱基-頭份,2024-08-08,9296
00933B,國泰10Y+金融債,20,1,19,凱基-頭份,2024-08-08,9296
6550,北極星藥業-KY,17,0,17,凱基-頭份,2024-08-08,9296
00679B,元大美債20年,16,0,16,凱基-頭份,2024-08-08,9296
0056,元大高股息,16,1,15,凱基-頭份,2024-08-08,9296
00720B,元大投資級公司債,15,0,15,凱基-頭份,2024-08-08,9296
00725B,國泰投資級公司債,15,0,15,凱基-頭份,2024-08-08,9296
00945B,凱基美國非投等債,15,0,15,凱基-頭份,2024-08-08,9296
2892,第一金,13,0,13,凱基-頭份,2024-08-08,9296
00936,台新永續高息中小,12,0,12,凱基-頭份,2024-08-08,9296
2489,瑞軒,12,0,12,凱基-頭份,2024-08-08,9296
2317,鴻海,26,14,12,凱基-頭份,2024-08-08,9296
00940,元大台灣價值高息,12,1,11,凱基-頭份,2024-08-08,9296
5443,均豪,26,15,11,凱基-頭份,2024-08-08,9296
2886,兆豐金,10,0,10,凱基-頭份,2024-08-08,9296
2344,華邦電,10,0,10,凱基-頭份,2024-08-08,9296
2542,興富發,10,0,10,凱基-頭份,2024-08-08,9296
2615,萬海,110,100,10,凱基-頭份,2024-08-08,9296
6770,力積電,10,0,10,凱基-頭份,2024-08-08,9296
8277,商丞,10,0,10,凱基-頭份,2024-08-08,9296
2834,臺企銀,11,2,9,凱基-頭份,2024-08-08,9296
2338,光罩,10,1,9,凱基-頭份,2024-08-08,9296
00715L,期街口布蘭特正2,8,0,8,凱基-頭份,2024-08-08,9296
9945,潤泰新,7,0,7,凱基-頭份,2024-08-08,9296
2881,富邦金,7,0,7,凱基-頭份,2024-08-08,9296
00830,國泰費城半導體,6,0,6,凱基-頭份,2024-08-08,9296
1714,和桐,6,0,6,凱基-頭份,2024-08-08,9296
4510,高鋒,13,7,6,凱基-頭份,2024-08-08,9296
6446,藥華藥,6,0,6,凱基-頭份,2024-08-08,9296
2891,中信金,5,0,5,凱基-頭份,2024-08-08,9296
00931B,統一美債20年,5,0,5,凱基-頭份,2024-08-08,9296
2516,新建,5,0,5,凱基-頭份,2024-08-08,9296
2530,華建,5,0,5,凱基-頭份,2024-08-08,9296
2884,玉山金,5,0,5,凱基-頭份,2024-08-08,9296
3025,星通,6,1,5,凱基-頭份,2024-08-08,9296
2359,所羅門,16,12,4,凱基-頭份,2024-08-08,9296
3037,欣興,4,0,4,凱基-頭份,2024-08-08,9296
00918,大華優利高填息30,4,0,4,凱基-頭份,2024-08-08,9296
00632R,元大台灣50反1,1783,12,1771,凱基-頭份,2024-08-09,9296
00664R,國泰臺灣加權反1,140,0,140,凱基-頭份,2024-08-09,9296
00937B,群益ESG投等債20,106,0,106,凱基-頭份,2024-08-09,9296
2883,凱基金,100,17,83,凱基-頭份,2024-08-09,9296
00929,復華台灣科技優息,100,29,71,凱基-頭份,2024-08-09,9296
6264,富裔,45,0,45,凱基-頭份,2024-08-09,9296
9906,欣巴巴,56,15,41,凱基-頭份,2024-08-09,9296
00948B,中信優息投資級債,40,0,40,凱基-頭份,2024-08-09,9296
00795B,中信美國公債20年,34,3,31,凱基-頭份,2024-08-09,9296
00725B,國泰投資級公司債,28,0,28,凱基-頭份,2024-08-09,9296
2243,宏旭-KY,33,5,28,凱基-頭份,2024-08-09,9296
3163,波若威,24,2,22,凱基-頭份,2024-08-09,9296
2365,昆盈,54,33,21,凱基-頭份,2024-08-09,9296
8096,擎亞,18,2,16,凱基-頭份,2024-08-09,9296
00882,中信中國高股息,13,0,13,凱基-頭份,2024-08-09,9296
5202,力新,15,2,13,凱基-頭份,2024-08-09,9296
2353,宏��,14,2,12,凱基-頭份,2024-08-09,9296
3260,威剛,11,0,11,凱基-頭份,2024-08-09,9296
8021,尖點,12,1,11,凱基-頭份,2024-08-09,9296
00687B,國泰20年美債,11,1,10,凱基-頭份,2024-08-09,9296
00686R,群益臺灣加權反1,10,0,10,凱基-頭份,2024-08-09,9296
00950B,凱基A級公司債,10,0,10,凱基-頭份,2024-08-09,9296
2027,大成鋼,10,0,10,凱基-頭份,2024-08-09,9296
2399,映泰,10,0,10,凱基-頭份,2024-08-09,9296
3051,力特,10,0,10,凱基-頭份,2024-08-09,9296
00720B,元大投資級公司債,9,0,9,凱基-頭份,2024-08-09,9296
00945B,凱基美國非投等債,9,0,9,凱基-頭份,2024-08-09,9296
2349,錸德,12,3,9,凱基-頭份,2024-08-09,9296
3047,訊舟,27,18,9,凱基-頭份,2024-08-09,9296
2317,鴻海,17,8,9,凱基-頭份,2024-08-09,9296
6770,力積電,10,2,8,凱基-頭份,2024-08-09,9296
00941,中信上游半導體,10,2,8,凱基-頭份,2024-08-09,9296
00685L,群益臺灣加權正2,8,0,8,凱基-頭份,2024-08-09,9296
6877,鏵友益,8,0,8,凱基-頭份,2024-08-09,9296
2344,華邦電,17,10,7,凱基-頭份,2024-08-09,9296
00688L,國泰20年美債正2,6,0,6,凱基-頭份,2024-08-09,9296
00637L,元大滬深300正2,6,0,6,凱基-頭份,2024-08-09,9296
1540,喬福,6,0,6,凱基-頭份,2024-08-09,9296
1714,和桐,6,0,6,凱基-頭份,2024-08-09,9296
1815,富喬,6,0,6,凱基-頭份,2024-08-09,9296
2392,正崴,6,0,6,凱基-頭份,2024-08-09,9296
2812,台中銀,5,0,5,凱基-頭份,2024-08-09,9296
00731,復華富時高息低波,5,0,5,凱基-頭份,2024-08-09,9296
1529,樂事綠能,5,0,5,凱基-頭份,2024-08-09,9296
1570,力肯,5,0,5,凱基-頭份,2024-08-09,9296
2305,全友,5,0,5,凱基-頭份,2024-08-09,9296
2486,一詮,15,10,5,凱基-頭份,2024-08-09,9296
2530,華建,5,0,5,凱基-頭份,2024-08-09,9296
5425,台半,5,0,5,凱基-頭份,2024-08-09,9296
6005,群益證,5,0,5,凱基-頭份,2024-08-09,9296
00679B,元大美債20年,2039,0,2039,凱基-頭份,2024-08-12,9296
00632R,元大台灣50反1,263,3,260,凱基-頭份,2024-08-12,9296
00929,復華台灣科技優息,208,2,206,凱基-頭份,2024-08-12,9296
2845,遠東銀,60,0,60,凱基-頭份,2024-08-12,9296
2891,中信金,50,0,50,凱基-頭份,2024-08-12,9296
00878,國泰永續高股息,58,15,43,凱基-頭份,2024-08-12,9296
00664R,國泰臺灣加權反1,40,0,40,凱基-頭份,2024-08-12,9296
8043,蜜望實,41,4,37,凱基-頭份,2024-08-12,9296
00687B,國泰20年美債,36,1,35,凱基-頭份,2024-08-12,9296
2520,冠德,23,1,22,凱基-頭份,2024-08-12,9296
1906,寶隆,20,0,20,凱基-頭份,2024-08-12,9296
3481,群創,44,26,18,凱基-頭份,2024-08-12,9296
8096,擎亞,19,1,18,凱基-頭份,2024-08-12,9296
1314,中石化,17,0,17,凱基-頭份,2024-08-12,9296
00680L,元大美債20正2,17,0,17,凱基-頭份,2024-08-12,9296
2409,友達,31,14,17,凱基-頭份,2024-08-12,9296
00933B,國泰10Y+金融債,15,0,15,凱基-頭份,2024-08-12,9296
1597,直得,20,6,14,凱基-頭份,2024-08-12,9296
00686R,群益臺灣加權反1,10,0,10,凱基-頭份,2024-08-12,9296
2812,台中銀,10,0,10,凱基-頭份,2024-08-12,9296
3555,博士旺,10,0,10,凱基-頭份,2024-08-12,9296
2367,燿華,11,2,9,凱基-頭份,2024-08-12,9296
3167,大量,20,11,9,凱基-頭份,2024-08-12,9296
2359,所羅門,15,7,8,凱基-頭份,2024-08-12,9296
3047,訊舟,8,0,8,凱基-頭份,2024-08-12,9296
2312,金寶,17,10,7,凱基-頭份,2024-08-12,9296
4562,穎漢,22,15,7,凱基-頭份,2024-08-12,9296
2603,長榮,50,43,7,凱基-頭份,2024-08-12,9296
00923,群益台ESG低碳50,7,0,7,凱基-頭份,2024-08-12,9296
00950B,凱基A級公司債,6,0,6,凱基-頭份,2024-08-12,9296
2337,旺宏,7,1,6,凱基-頭份,2024-08-12,9296
2489,瑞軒,6,0,6,凱基-頭份,2024-08-12,9296
3593,力銘,6,0,6,凱基-頭份,2024-08-12,9296
4198,欣大健康,6,0,6,凱基-頭份,2024-08-12,9296
5880,合庫金,6,0,6,凱基-頭份,2024-08-12,9296
8064,東捷,9,3,6,凱基-頭份,2024-08-12,9296
2363,矽統,6,0,6,凱基-頭份,2024-08-12,9296
1785,光洋科,6,1,5,凱基-頭份,2024-08-12,9296
00731,復華富時高息低波,5,0,5,凱基-頭份,2024-08-12,9296
00706L,期元大S＆P日圓正2,5,0,5,凱基-頭份,2024-08-12,9296
00940,元大台灣價值高息,24,19,5,凱基-頭份,2024-08-12,9296
2442,新美齊,5,0,5,凱基-頭份,2024-08-12,9296
3013,晟銘電,5,0,5,凱基-頭份,2024-08-12,9296
3706,神達,8,3,5,凱基-頭份,2024-08-12,9296
6505,台塑化,5,0,5,凱基-頭份,2024-08-12,9296
8222,寶一,5,0,5,凱基-頭份,2024-08-12,9296
1503,士電,9,5,4,凱基-頭份,2024-08-12,9296
00946,群益科技高息成長,4,0,4,凱基-頭份,2024-08-12,9296
1605,華新,4,0,4,凱基-頭份,2024-08-12,9296
2243,宏旭-KY,4,0,4,凱基-頭份,2024-08-12,9296
00929,復華台灣科技優息,212,1,211,凱基-頭份,2024-08-13,9296
00940,元大台灣價值高息,91,23,68,凱基-頭份,2024-08-13,9296
2609,陽明,171,121,50,凱基-頭份,2024-08-13,9296
00632R,元大台灣50反1,40,0,40,凱基-頭份,2024-08-13,9296
2880,華南金,39,0,39,凱基-頭份,2024-08-13,9296
6219,富旺,31,0,31,凱基-頭份,2024-08-13,9296
2886,兆豐金,29,0,29,凱基-頭份,2024-08-13,9296
00937B,群益ESG投等債20,32,7,25,凱基-頭份,2024-08-13,9296
3051,力特,20,0,20,凱基-頭份,2024-08-13,9296
3706,神達,20,0,20,凱基-頭份,2024-08-13,9296
6264,富裔,20,0,20,凱基-頭份,2024-08-13,9296
00936,台新永續高息中小,21,2,19,凱基-頭份,2024-08-13,9296
2208,台船,20,5,15,凱基-頭份,2024-08-13,9296
3489,森寶,15,0,15,凱基-頭份,2024-08-13,9296
9945,潤泰新,22,9,13,凱基-頭份,2024-08-13,9296
3062,建漢,20,9,11,凱基-頭份,2024-08-13,9296
1314,中石化,10,0,10,凱基-頭份,2024-08-13,9296
1513,中興電,20,10,10,凱基-頭份,2024-08-13,9296
00687B,國泰20年美債,10,0,10,凱基-頭份,2024-08-13,9296
00885,富邦越南,10,0,10,凱基-頭份,2024-08-13,9296
2429,銘旺科,10,0,10,凱基-頭份,2024-08-13,9296
2548,華固,10,0,10,凱基-頭份,2024-08-13,9296
3376,新日興,10,0,10,凱基-頭份,2024-08-13,9296
6026,福邦證,10,0,10,凱基-頭份,2024-08-13,9296
6548,長科*,10,0,10,凱基-頭份,2024-08-13,9296
00857B,永豐20年美公債,10,1,9,凱基-頭份,2024-08-13,9296
2317,鴻海,17,8,9,凱基-頭份,2024-08-13,9296
1301,台塑,9,1,8,凱基-頭份,2024-08-13,9296
00712,復華富時不動產,11,3,8,凱基-頭份,2024-08-13,9296
00706L,期元大S＆P日圓正2,8,0,8,凱基-頭份,2024-08-13,9296
00881,國泰台灣5G+,9,1,8,凱基-頭份,2024-08-13,9296
2603,長榮,63,55,8,凱基-頭份,2024-08-13,9296
2892,第一金,11,3,8,凱基-頭份,2024-08-13,9296
2834,臺企銀,7,0,7,凱基-頭份,2024-08-13,9296
3231,緯創,7,0,7,凱基-頭份,2024-08-13,9296
8403,盛弘,7,0,7,凱基-頭份,2024-08-13,9296
3522,御嵿,6,0,6,凱基-頭份,2024-08-13,9296
3663,鑫科,12,6,6,凱基-頭份,2024-08-13,9296
3715,定穎投控,14,8,6,凱基-頭份,2024-08-13,9296
00948B,中信優息投資級債,5,0,5,凱基-頭份,2024-08-13,9296
00731,復華富時高息低波,5,0,5,凱基-頭份,2024-08-13,9296
00738U,期元大道瓊白銀,5,0,5,凱基-頭份,2024-08-13,9296
4128,中天,5,0,5,凱基-頭份,2024-08-13,9296
4198,欣大健康,5,0,5,凱基-頭份,2024-08-13,9296
4306,炎洲,5,0,5,凱基-頭份,2024-08-13,9296
2382,廣達,8,4,4,凱基-頭份,2024-08-13,9296
00679B,元大美債20年,4,0,4,凱基-頭份,2024-08-13,9296
1326,台化,4,0,4,凱基-頭份,2024-08-13,9296
1436,華友聯,4,0,4,凱基-頭份,2024-08-13,9296
1721,三晃,4,0,4,凱基-頭份,2024-08-13,9296
00680L,元大美債20正2,63,0,63,凱基-頭份,2024-08-14,9296
00936,台新永續高息中小,63,8,55,凱基-頭份,2024-08-14,9296
00632R,元大台灣50反1,60,10,50,凱基-頭份,2024-08-14,9296
912000,晨訊科-DR,50,0,50,凱基-頭份,2024-08-14,9296
2442,新美齊,30,0,30,凱基-頭份,2024-08-14,9296
2427,三商電,29,0,29,凱基-頭份,2024-08-14,9296
6177,達麗,33,5,28,凱基-頭份,2024-08-14,9296
00679B,元大美債20年,26,2,24,凱基-頭份,2024-08-14,9296
1101,台泥,34,12,22,凱基-頭份,2024-08-14,9296
2393,億光,20,0,20,凱基-頭份,2024-08-14,9296
2892,第一金,20,0,20,凱基-頭份,2024-08-14,9296
00929,復華台灣科技優息,24,6,18,凱基-頭份,2024-08-14,9296
00795B,中信美國公債20年,18,0,18,凱基-頭份,2024-08-14,9296
3481,群創,41,23,18,凱基-頭份,2024-08-14,9296
6219,富旺,32,15,17,凱基-頭份,2024-08-14,9296
2801,彰銀,15,0,15,凱基-頭份,2024-08-14,9296
3591,艾笛森,15,0,15,凱基-頭份,2024-08-14,9296
3312,弘憶股,12,0,12,凱基-頭份,2024-08-14,9296
00686R,群益臺灣加權反1,10,0,10,凱基-頭份,2024-08-14,9296
00664R,國泰臺灣加權反1,10,0,10,凱基-頭份,2024-08-14,9296
1316,上曜,10,0,10,凱基-頭份,2024-08-14,9296
1570,力肯,10,0,10,凱基-頭份,2024-08-14,9296
2392,正崴,10,0,10,凱基-頭份,2024-08-14,9296
6257,矽格,10,0,10,凱基-頭份,2024-08-14,9296
00631L,元大台灣50正2,10,0,10,凱基-頭份,2024-08-14,9296
00687B,國泰20年美債,12,3,9,凱基-頭份,2024-08-14,9296
6215,和椿,11,3,8,凱基-頭份,2024-08-14,9296
8076,伍豐,8,0,8,凱基-頭份,2024-08-14,9296
8096,擎亞,34,26,8,凱基-頭份,2024-08-14,9296
00931B,統一美債20年,8,1,7,凱基-頭份,2024-08-14,9296
00881,國泰台灣5G+,7,0,7,凱基-頭份,2024-08-14,9296
2367,燿華,10,3,7,凱基-頭份,2024-08-14,9296
3030,德律,7,0,7,凱基-頭份,2024-08-14,9296
4956,光鋐,7,0,7,凱基-頭份,2024-08-14,9296
5880,合庫金,11,5,6,凱基-頭份,2024-08-14,9296
00757,統一FANG+,6,0,6,凱基-頭份,2024-08-14,9296
2344,華邦電,22,16,6,凱基-頭份,2024-08-14,9296
2880,華南金,6,0,6,凱基-頭份,2024-08-14,9296
4534,慶騰,8,2,6,凱基-頭份,2024-08-14,9296
6877,鏵友益,6,0,6,凱基-頭份,2024-08-14,9296
00731,復華富時高息低波,5,0,5,凱基-頭份,2024-08-14,9296
1540,喬福,8,3,5,凱基-頭份,2024-08-14,9296
2007,燁興,5,0,5,凱基-頭份,2024-08-14,9296
2359,所羅門,12,7,5,凱基-頭份,2024-08-14,9296
3450,聯鈞,8,3,5,凱基-頭份,2024-08-14,9296
4807,日成-KY,10,5,5,凱基-頭份,2024-08-14,9296
5425,台半,5,0,5,凱基-頭份,2024-08-14,9296
6472,保瑞,5,0,5,凱基-頭份,2024-08-14,9296
2337,旺宏,4,0,4,凱基-頭份,2024-08-14,9296
2356,英業達,11,7,4,凱基-頭份,2024-08-14,9296
00900,富邦特選高股息30,302,0,302,凱基-頭份,2024-08-15,9296
00632R,元大台灣50反1,106,0,106,凱基-頭份,2024-08-15,9296
4931,新盛力,77,15,62,凱基-頭份,2024-08-15,9296
6219,富旺,61,1,60,凱基-頭份,2024-08-15,9296
00878,國泰永續高股息,68,9,59,凱基-頭份,2024-08-15,9296
00936,台新永續高息中小,56,0,56,凱基-頭份,2024-08-15,9296
00937B,群益ESG投等債20,64,20,44,凱基-頭份,2024-08-15,9296
00907,永豐優息存股,35,0,35,凱基-頭份,2024-08-15,9296
2886,兆豐金,27,0,27,凱基-頭份,2024-08-15,9296
4306,炎洲,25,0,25,凱基-頭份,2024-08-15,9296
00929,復華台灣科技優息,26,1,25,凱基-頭份,2024-08-15,9296
2539,櫻花建,22,0,22,凱基-頭份,2024-08-15,9296
0056,元大高股息,22,1,21,凱基-頭份,2024-08-15,9296
3050,鈺德,21,0,21,凱基-頭份,2024-08-15,9296
2603,長榮,36,16,20,凱基-頭份,2024-08-15,9296
2801,彰銀,20,0,20,凱基-頭份,2024-08-15,9296
00679B,元大美債20年,18,0,18,凱基-頭份,2024-08-15,9296
00712,復華富時不動產,20,2,18,凱基-頭份,2024-08-15,9296
00923,群益台ESG低碳50,13,0,13,凱基-頭份,2024-08-15,9296
00945B,凱基美國非投等債,11,0,11,凱基-頭份,2024-08-15,9296
00687B,國泰20年美債,10,0,10,凱基-頭份,2024-08-15,9296
00706L,期元大S＆P日圓正2,10,0,10,凱基-頭份,2024-08-15,9296
00915,凱基優選高股息30,10,0,10,凱基-頭份,2024-08-15,9296
00857B,永豐20年美公債,10,0,10,凱基-頭份,2024-08-15,9296
1570,力肯,10,0,10,凱基-頭份,2024-08-15,9296
2427,三商電,10,0,10,凱基-頭份,2024-08-15,9296
00891,中信關鍵半導體,8,0,8,凱基-頭份,2024-08-15,9296
00932,兆豐永續高息等權,9,1,8,凱基-頭份,2024-08-15,9296
3234,光環,8,0,8,凱基-頭份,2024-08-15,9296
1609,大亞,7,0,7,凱基-頭份,2024-08-15,9296
00919,群益台灣精選高息,15,8,7,凱基-頭份,2024-08-15,9296
3013,晟銘電,6,0,6,凱基-頭份,2024-08-15,9296
8011,台通,6,0,6,凱基-頭份,2024-08-15,9296
9946,三發地產,6,0,6,凱基-頭份,2024-08-15,9296
00701,國泰股利精選30,5,0,5,凱基-頭份,2024-08-15,9296
00931B,統一美債20年,5,0,5,凱基-頭份,2024-08-15,9296
00948B,中信優息投資級債,6,1,5,凱基-頭份,2024-08-15,9296
2417,圓剛,5,0,5,凱基-頭份,2024-08-15,9296
3376,新日興,5,0,5,凱基-頭份,2024-08-15,9296
3663,鑫科,20,15,5,凱基-頭份,2024-08-15,9296
4198,欣大健康,5,0,5,凱基-頭份,2024-08-15,9296
1301,台塑,5,0,5,凱基-頭份,2024-08-15,9296
6505,台塑化,5,0,5,凱基-頭份,2024-08-15,9296
00939,統一台灣高息動能,4,0,4,凱基-頭份,2024-08-15,9296
00942B,台新美A公司債20+,8,4,4,凱基-頭份,2024-08-15,9296
00881,國泰台灣5G+,4,0,4,凱基-頭份,2024-08-15,9296
2504,國產,4,0,4,凱基-頭份,2024-08-15,9296
2834,臺企銀,5,1,4,凱基-頭份,2024-08-15,9296
2344,華邦電,5,2,3,凱基-頭份,2024-08-15,9296
6419,京晨科,3,0,3,凱基-頭份,2024-08-15,9296
00687B,國泰20年美債,1959,15,1944,凱基-頭份,2024-08-16,9296
00664R,國泰臺灣加權反1,120,0,120,凱基-頭份,2024-08-16,9296
00680L,元大美債20正2,66,0,66,凱基-頭份,2024-08-16,9296
00712,復華富時不動產,50,3,47,凱基-頭份,2024-08-16,9296
00878,國泰永續高股息,48,2,46,凱基-頭份,2024-08-16,9296
2317,鴻海,38,9,29,凱基-頭份,2024-08-16,9296
2905,三商,29,1,28,凱基-頭份,2024-08-16,9296
00641R,富邦日本反1,25,0,25,凱基-頭份,2024-08-16,9296
8277,商丞,25,0,25,凱基-頭份,2024-08-16,9296
3232,昱捷,23,0,23,凱基-頭份,2024-08-16,9296
00706L,期元大S＆P日圓正2,22,0,22,凱基-頭份,2024-08-16,9296
00950B,凱基A級公司債,20,0,20,凱基-頭份,2024-08-16,9296
8096,擎亞,23,4,19,凱基-頭份,2024-08-16,9296
8064,東捷,13,0,13,凱基-頭份,2024-08-16,9296
00900,富邦特選高股息30,12,0,12,凱基-頭份,2024-08-16,9296
3537,堡達,12,0,12,凱基-頭份,2024-08-16,9296
8105,凌巨,12,0,12,凱基-頭份,2024-08-16,9296
4540,全球傳動,13,2,11,凱基-頭份,2024-08-16,9296
00642U,期元大S＆P石油,10,0,10,凱基-頭份,2024-08-16,9296
2392,正崴,10,0,10,凱基-頭份,2024-08-16,9296
4807,日成-KY,10,0,10,凱基-頭份,2024-08-16,9296
6770,力積電,10,0,10,凱基-頭份,2024-08-16,9296
2323,中環,11,2,9,凱基-頭份,2024-08-16,9296
4306,炎洲,9,0,9,凱基-頭份,2024-08-16,9296
4562,穎漢,15,7,8,凱基-頭份,2024-08-16,9296
2349,錸德,12,4,8,凱基-頭份,2024-08-16,9296
3167,大量,19,11,8,凱基-頭份,2024-08-16,9296
00857B,永豐20年美公債,7,0,7,凱基-頭份,2024-08-16,9296
1906,寶隆,7,0,7,凱基-頭份,2024-08-16,9296
2348,海悅,7,0,7,凱基-頭份,2024-08-16,9296
3048,益登,7,0,7,凱基-頭份,2024-08-16,9296
2489,瑞軒,6,0,6,凱基-頭份,2024-08-16,9296
2801,彰銀,6,0,6,凱基-頭份,2024-08-16,9296
2867,三商壽,6,0,6,凱基-頭份,2024-08-16,9296
00713,元大台灣高息低波,6,1,5,凱基-頭份,2024-08-16,9296
2002,中鋼,4,0,4,凱基-頭份,2024-08-16,9296
00882,中信中國高股息,4,0,4,凱基-頭份,2024-08-16,9296
00795B,中信美國公債20年,4,0,4,凱基-頭份,2024-08-16,9296
2393,億光,4,0,4,凱基-頭份,2024-08-16,9296
2397,友通,4,0,4,凱基-頭份,2024-08-16,9296
2515,中工,4,0,4,凱基-頭份,2024-08-16,9296
2845,遠東銀,5,1,4,凱基-頭份,2024-08-16,9296
5474,聰泰,4,0,4,凱基-頭份,2024-08-16,9296
6026,福邦證,4,0,4,凱基-頭份,2024-08-16,9296
8111,立��,4,0,4,凱基-頭份,2024-08-16,9296
9906,欣巴巴,15,11,4,凱基-頭份,2024-08-16,9296
6505,台塑化,4,0,4,凱基-頭份,2024-08-16,9296
4576,大銀微系統,5,2,3,凱基-頭份,2024-08-16,9296
00927,群益半導體收益,3,0,3,凱基-頭份,2024-08-16,9296
1785,光洋科,6,3,3,凱基-頭份,2024-08-16,9296
1316,上曜,202,0,202,凱基-頭份,2024-08-19,9296
00929,復華台灣科技優息,69,7,62,凱基-頭份,2024-08-19,9296
2609,陽明,164,121,43,凱基-頭份,2024-08-19,9296
00687B,國泰20年美債,55,15,40,凱基-頭份,2024-08-19,9296
2887,台新金,103,65,38,凱基-頭份,2024-08-19,9296
00882,中信中國高股息,35,7,28,凱基-頭份,2024-08-19,9296
2505,國揚,28,0,28,凱基-頭份,2024-08-19,9296
2886,兆豐金,25,0,25,凱基-頭份,2024-08-19,9296
2845,遠東銀,23,0,23,凱基-頭份,2024-08-19,9296
00725B,國泰投資級公司債,22,0,22,凱基-頭份,2024-08-19,9296
00731,復華富時高息低波,20,1,19,凱基-頭份,2024-08-19,9296
3047,訊舟,24,5,19,凱基-頭份,2024-08-19,9296
2365,昆盈,40,22,18,凱基-頭份,2024-08-19,9296
1314,中石化,39,22,17,凱基-頭份,2024-08-19,9296
00679B,元大美債20年,17,0,17,凱基-頭份,2024-08-19,9296
2442,新美齊,17,0,17,凱基-頭份,2024-08-19,9296
2888,新光金,30,14,16,凱基-頭份,2024-08-19,9296
00664R,國泰臺灣加權反1,15,0,15,凱基-頭份,2024-08-19,9296
00753L,中信中國50正2,15,0,15,凱基-頭份,2024-08-19,9296
1570,力肯,15,0,15,凱基-頭份,2024-08-19,9296
6219,富旺,15,1,14,凱基-頭份,2024-08-19,9296
3231,緯創,13,0,13,凱基-頭份,2024-08-19,9296
4906,正文,14,1,13,凱基-頭份,2024-08-19,9296
00931B,統一美債20年,12,0,12,凱基-頭份,2024-08-19,9296
2062,橋椿,15,3,12,凱基-頭份,2024-08-19,9296
00942B,台新美A公司債20+,11,0,11,凱基-頭份,2024-08-19,9296
2892,第一金,11,0,11,凱基-頭份,2024-08-19,9296
1802,台玻,10,0,10,凱基-頭份,2024-08-19,9296
4198,欣大健康,10,0,10,凱基-頭份,2024-08-19,9296
00795B,中信美國公債20年,9,0,9,凱基-頭份,2024-08-19,9296
4576,大銀微系統,11,2,9,凱基-頭份,2024-08-19,9296
2359,所羅門,20,11,9,凱基-頭份,2024-08-19,9296
2393,億光,8,0,8,凱基-頭份,2024-08-19,9296
3013,晟銘電,10,2,8,凱基-頭份,2024-08-19,9296
2376,技嘉,10,3,7,凱基-頭份,2024-08-19,9296
8028,昇陽半導體,30,23,7,凱基-頭份,2024-08-19,9296
8043,蜜望實,11,4,7,凱基-頭份,2024-08-19,9296
2002,中鋼,6,0,6,凱基-頭份,2024-08-19,9296
00688L,國泰20年美債正2,6,0,6,凱基-頭份,2024-08-19,9296
1905,華紙,6,0,6,凱基-頭份,2024-08-19,9296
2354,鴻準,7,1,6,凱基-頭份,2024-08-19,9296
3037,欣興,6,0,6,凱基-頭份,2024-08-19,9296
00701,國泰股利精選30,5,0,5,凱基-頭份,2024-08-19,9296
00933B,國泰10Y+金融債,5,0,5,凱基-頭份,2024-08-19,9296
2305,全友,5,0,5,凱基-頭份,2024-08-19,9296
2464,盟立,12,7,5,凱基-頭份,2024-08-19,9296
3607,谷崧,5,0,5,凱基-頭份,2024-08-19,9296
3615,安可,5,0,5,凱基-頭份,2024-08-19,9296
4807,日成-KY,5,0,5,凱基-頭份,2024-08-19,9296
6546,正基,7,2,5,凱基-頭份,2024-08-19,9296
00937B,群益ESG投等債20,3862,3,3859,凱基-頭份,2024-08-20,9296
00688L,國泰20年美債正2,50,0,50,凱基-頭份,2024-08-20,9296
00955,中信日本商社,50,0,50,凱基-頭份,2024-08-20,9296
00956,中信日經高股息,50,0,50,凱基-頭份,2024-08-20,9296
00945B,凱基美國非投等債,50,7,43,凱基-頭份,2024-08-20,9296
2547,日勝生,40,0,40,凱基-頭份,2024-08-20,9296
00881,國泰台灣5G+,41,2,39,凱基-頭份,2024-08-20,9296
00907,永豐優息存股,35,0,35,凱基-頭份,2024-08-20,9296
3706,神達,25,1,24,凱基-頭份,2024-08-20,9296
00637L,元大滬深300正2,21,0,21,凱基-頭份,2024-08-20,9296
8064,東捷,35,14,21,凱基-頭份,2024-08-20,9296
9946,三發地產,27,6,21,凱基-頭份,2024-08-20,9296
1101,台泥,20,0,20,凱基-頭份,2024-08-20,9296
1714,和桐,20,0,20,凱基-頭份,2024-08-20,9296
2514,龍邦,20,0,20,凱基-頭份,2024-08-20,9296
00706L,期元大S＆P日圓正2,19,0,19,凱基-頭份,2024-08-20,9296
2002,中鋼,21,2,19,凱基-頭份,2024-08-20,9296
00929,復華台灣科技優息,19,0,19,凱基-頭份,2024-08-20,9296
00715L,期街口布蘭特正2,17,0,17,凱基-頭份,2024-08-20,9296
5392,能率,17,0,17,凱基-頭份,2024-08-20,9296
2317,鴻海,18,3,15,凱基-頭份,2024-08-20,9296
00753L,中信中國50正2,15,0,15,凱基-頭份,2024-08-20,9296
3047,訊舟,19,5,14,凱基-頭份,2024-08-20,9296
2374,佳能,15,3,12,凱基-頭份,2024-08-20,9296
9945,潤泰新,12,0,12,凱基-頭份,2024-08-20,9296
00919,群益台灣精選高息,21,10,11,凱基-頭份,2024-08-20,9296
3234,光環,11,0,11,凱基-頭份,2024-08-20,9296
5371,中光電,12,1,11,凱基-頭份,2024-08-20,9296
1301,台塑,14,3,11,凱基-頭份,2024-08-20,9296
2883,凱基金,10,0,10,凱基-頭份,2024-08-20,9296
00882,中信中國高股息,10,0,10,凱基-頭份,2024-08-20,9296
3376,新日興,10,0,10,凱基-頭份,2024-08-20,9296
6219,富旺,10,0,10,凱基-頭份,2024-08-20,9296
6548,長科*,10,0,10,凱基-頭份,2024-08-20,9296
2359,所羅門,22,13,9,凱基-頭份,2024-08-20,9296
00679B,元大美債20年,9,0,9,凱基-頭份,2024-08-20,9296
00713,元大台灣高息低波,8,0,8,凱基-頭份,2024-08-20,9296
00942B,台新美A公司債20+,8,0,8,凱基-頭份,2024-08-20,9296
1717,長興,8,0,8,凱基-頭份,2024-08-20,9296
1314,中石化,7,0,7,凱基-頭份,2024-08-20,9296
6156,松上,7,0,7,凱基-頭份,2024-08-20,9296
5443,均豪,46,40,6,凱基-頭份,2024-08-20,9296
2062,橋椿,7,1,6,凱基-頭份,2024-08-20,9296
2820,華票,6,0,6,凱基-頭份,2024-08-20,9296
2889,國票金,6,0,6,凱基-頭份,2024-08-20,9296
3339,泰谷,8,2,6,凱基-頭份,2024-08-20,9296
2884,玉山金,6,1,5,凱基-頭份,2024-08-20,9296
1785,光洋科,8,3,5,凱基-頭份,2024-08-20,9296
1326,台化,5,0,5,凱基-頭份,2024-08-20,9296
00664R,國泰臺灣加權反1,5,0,5,凱基-頭份,2024-08-20,9296
2891,中信金,1860,1,1859,凱基-頭份,2024-08-21,9296
2867,三商壽,543,14,529,凱基-頭份,2024-08-21,9296
2888,新光金,202,149,53,凱基-頭份,2024-08-21,9296
00929,復華台灣科技優息,49,4,45,凱基-頭份,2024-08-21,9296
00953B,群益優選非投等債,52,10,42,凱基-頭份,2024-08-21,9296
3050,鈺德,40,0,40,凱基-頭份,2024-08-21,9296
00934,中信成長高股息,30,0,30,凱基-頭份,2024-08-21,9296
1737,臺鹽,30,0,30,凱基-頭份,2024-08-21,9296
00919,群益台灣精選高息,32,3,29,凱基-頭份,2024-08-21,9296
5905,南仁湖,24,2,22,凱基-頭份,2024-08-21,9296
00688L,國泰20年美債正2,30,10,20,凱基-頭份,2024-08-21,9296
5880,合庫金,20,0,20,凱基-頭份,2024-08-21,9296
0056,元大高股息,20,1,19,凱基-頭份,2024-08-21,9296
00878,國泰永續高股息,26,8,18,凱基-頭份,2024-08-21,9296
3057,喬鼎,15,0,15,凱基-頭份,2024-08-21,9296
6770,力積電,15,1,14,凱基-頭份,2024-08-21,9296
2317,鴻海,14,0,14,凱基-頭份,2024-08-21,9296
00918,大華優利高填息30,13,0,13,凱基-頭份,2024-08-21,9296
00915,凱基優選高股息30,13,0,13,凱基-頭份,2024-08-21,9296
00687B,國泰20年美債,18,5,13,凱基-頭份,2024-08-21,9296
6264,富裔,13,0,13,凱基-頭份,2024-08-21,9296
2603,長榮,19,7,12,凱基-頭份,2024-08-21,9296
8054,安國,22,10,12,凱基-頭份,2024-08-21,9296
8064,東捷,29,17,12,凱基-頭份,2024-08-21,9296
00715L,期街口布蘭特正2,11,0,11,凱基-頭份,2024-08-21,9296
2845,遠東銀,11,0,11,凱基-頭份,2024-08-21,9296
6219,富旺,11,0,11,凱基-頭份,2024-08-21,9296
8099,大世科,11,0,11,凱基-頭份,2024-08-21,9296
2609,陽明,12,2,10,凱基-頭份,2024-08-21,9296
3374,精材,16,6,10,凱基-頭份,2024-08-21,9296
4995,晶達,10,0,10,凱基-頭份,2024-08-21,9296
6213,聯茂,10,0,10,凱基-頭份,2024-08-21,9296
9907,統一實,10,0,10,凱基-頭份,2024-08-21,9296
2890,永豐金,14,5,9,凱基-頭份,2024-08-21,9296
00935,野村臺灣新科技50,8,0,8,凱基-頭份,2024-08-21,9296
2883,凱基金,7,0,7,凱基-頭份,2024-08-21,9296
2610,華航,7,0,7,凱基-頭份,2024-08-21,9296
6869,雲豹能源,11,4,7,凱基-頭份,2024-08-21,9296
8104,錸寶,8,1,7,凱基-頭份,2024-08-21,9296
00923,群益台ESG低碳50,6,0,6,凱基-頭份,2024-08-21,9296
2489,瑞軒,6,0,6,凱基-頭份,2024-08-21,9296
6177,達麗,7,1,6,凱基-頭份,2024-08-21,9296
2305,全友,6,0,6,凱基-頭份,2024-08-21,9296
00722B,群益投資級電信債,5,0,5,凱基-頭份,2024-08-21,9296
00753L,中信中國50正2,5,0,5,凱基-頭份,2024-08-21,9296
1513,中興電,6,1,5,凱基-頭份,2024-08-21,9296
2017,官田鋼,5,0,5,凱基-頭份,2024-08-21,9296
2344,華邦電,8,3,5,凱基-頭份,2024-08-21,9296
2365,昆盈,9,4,5,凱基-頭份,2024-08-21,9296
3013,晟銘電,7,2,5,凱基-頭份,2024-08-21,9296
00687B,國泰20年美債,1932,0,1932,凱基-頭份,2024-08-22,9296
00919,群益台灣精選高息,69,2,67,凱基-頭份,2024-08-22,9296
00715L,期街口布蘭特正2,43,0,43,凱基-頭份,2024-08-22,9296
00885,富邦越南,30,0,30,凱基-頭份,2024-08-22,9296
2442,新美齊,24,0,24,凱基-頭份,2024-08-22,9296
00907,永豐優息存股,20,0,20,凱基-頭份,2024-08-22,9296
00680L,元大美債20正2,20,0,20,凱基-頭份,2024-08-22,9296
6116,彩晶,20,0,20,凱基-頭份,2024-08-22,9296
3047,訊舟,27,11,16,凱基-頭份,2024-08-22,9296
2845,遠東銀,15,0,15,凱基-頭份,2024-08-22,9296
9907,統一實,15,0,15,凱基-頭份,2024-08-22,9296
00706L,期元大S＆P日圓正2,13,0,13,凱基-頭份,2024-08-22,9296
2349,錸德,79,67,12,凱基-頭份,2024-08-22,9296
4306,炎洲,12,0,12,凱基-頭份,2024-08-22,9296
6219,富旺,12,0,12,凱基-頭份,2024-08-22,9296
9955,佳龍,17,6,11,凱基-頭份,2024-08-22,9296
00940,元大台灣價值高息,12,1,11,凱基-頭份,2024-08-22,9296
00878,國泰永續高股息,10,0,10,凱基-頭份,2024-08-22,9296
2201,裕隆,10,0,10,凱基-頭份,2024-08-22,9296
2392,正崴,10,0,10,凱基-頭份,2024-08-22,9296
4303,信立,10,0,10,凱基-頭份,2024-08-22,9296
6548,長科*,10,0,10,凱基-頭份,2024-08-22,9296
2365,昆盈,20,11,9,凱基-頭份,2024-08-22,9296
5534,長虹,8,0,8,凱基-頭份,2024-08-22,9296
1570,力肯,8,0,8,凱基-頭份,2024-08-22,9296
6442,光聖,11,3,8,凱基-頭份,2024-08-22,9296
2603,長榮,7,0,7,凱基-頭份,2024-08-22,9296
2801,彰銀,7,0,7,凱基-頭份,2024-08-22,9296
6235,華孚,14,7,7,凱基-頭份,2024-08-22,9296
3374,精材,21,14,7,凱基-頭份,2024-08-22,9296
00953B,群益優選非投等債,6,0,6,凱基-頭份,2024-08-22,9296
6449,鈺邦,7,1,6,凱基-頭份,2024-08-22,9296
9946,三發地產,6,0,6,凱基-頭份,2024-08-22,9296
1785,光洋科,8,3,5,凱基-頭份,2024-08-22,9296
00949,復華日本龍頭,5,0,5,凱基-頭份,2024-08-22,9296
1584,精剛,7,2,5,凱基-頭份,2024-08-22,9296
1711,永光,6,1,5,凱基-頭份,2024-08-22,9296
2393,億光,5,0,5,凱基-頭份,2024-08-22,9296
2534,宏盛,5,0,5,凱基-頭份,2024-08-22,9296
2820,華票,5,0,5,凱基-頭份,2024-08-22,9296
3019,亞光,8,3,5,凱基-頭份,2024-08-22,9296
4956,光鋐,5,0,5,凱基-頭份,2024-08-22,9296
6125,廣運,5,0,5,凱基-頭份,2024-08-22,9296
2317,鴻海,11,6,5,凱基-頭份,2024-08-22,9296
1514,亞力,5,1,4,凱基-頭份,2024-08-22,9296
2337,旺宏,4,0,4,凱基-頭份,2024-08-22,9296
3028,增你強,4,0,4,凱基-頭份,2024-08-22,9296
3163,波若威,4,0,4,凱基-頭份,2024-08-22,9296
3518,柏騰,10,6,4,凱基-頭份,2024-08-22,9296
6492,生華科,4,0,4,凱基-頭份,2024-08-22,9296
00688L,國泰20年美債正2,65,0,65,凱基-頭份,2024-08-23,9296
6895,宏碩系統,53,3,50,凱基-頭份,2024-08-23,9296
2801,彰銀,38,0,38,凱基-頭份,2024-08-23,9296
2845,遠東銀,35,0,35,凱基-頭份,2024-08-23,9296
5871,中租-KY,33,1,32,凱基-頭份,2024-08-23,9296
00919,群益台灣精選高息,22,0,22,凱基-頭份,2024-08-23,9296
8021,尖點,25,3,22,凱基-頭份,2024-08-23,9296
00664R,國泰臺灣加權反1,20,0,20,凱基-頭份,2024-08-23,9296
2472,立隆電,28,8,20,凱基-頭份,2024-08-23,9296
00937B,群益ESG投等債20,19,0,19,凱基-頭份,2024-08-23,9296
2887,台新金,21,2,19,凱基-頭份,2024-08-23,9296
00687B,國泰20年美債,17,0,17,凱基-頭份,2024-08-23,9296
2317,鴻海,19,2,17,凱基-頭份,2024-08-23,9296
00946,群益科技高息成長,16,0,16,凱基-頭份,2024-08-23,9296
8937,合騏,16,0,16,凱基-頭份,2024-08-23,9296
1711,永光,21,6,15,凱基-頭份,2024-08-23,9296
2349,錸德,64,51,13,凱基-頭份,2024-08-23,9296
2891,中信金,15,5,10,凱基-頭份,2024-08-23,9296
2890,永豐金,10,0,10,凱基-頭份,2024-08-23,9296
2201,裕隆,10,0,10,凱基-頭份,2024-08-23,9296
4931,新盛力,10,0,10,凱基-頭份,2024-08-23,9296
5227,立凱-KY,10,0,10,凱基-頭份,2024-08-23,9296
0056,元大高股息,9,0,9,凱基-頭份,2024-08-23,9296
6770,力積電,14,6,8,凱基-頭份,2024-08-23,9296
00878,國泰永續高股息,7,0,7,凱基-頭份,2024-08-23,9296
00931B,統一美債20年,7,0,7,凱基-頭份,2024-08-23,9296
00706L,期元大S＆P日圓正2,7,0,7,凱基-頭份,2024-08-23,9296
1708,東鹼,7,0,7,凱基-頭份,2024-08-23,9296
8107,大億金茂,7,0,7,凱基-頭份,2024-08-23,9296
2344,華邦電,7,0,7,凱基-頭份,2024-08-23,9296
00680L,元大美債20正2,6,0,6,凱基-頭份,2024-08-23,9296
00932,兆豐永續高息等權,6,0,6,凱基-頭份,2024-08-23,9296
3163,波若威,9,3,6,凱基-頭份,2024-08-23,9296
3189,景碩,16,10,6,凱基-頭份,2024-08-23,9296
3528,安馳,6,0,6,凱基-頭份,2024-08-23,9296
6219,富旺,7,1,6,凱基-頭份,2024-08-23,9296
8438,昶昕,6,0,6,凱基-頭份,2024-08-23,9296
00641R,富邦日本反1,5,0,5,凱基-頭份,2024-08-23,9296
1326,台化,5,0,5,凱基-頭份,2024-08-23,9296
3450,聯鈞,7,2,5,凱基-頭份,2024-08-23,9296
4167,松瑞藥,5,0,5,凱基-頭份,2024-08-23,9296
4513,福裕,8,3,5,凱基-頭份,2024-08-23,9296
6733,博晟生醫,5,0,5,凱基-頭份,2024-08-23,9296
8099,大世科,5,0,5,凱基-頭份,2024-08-23,9296
9925,新保,5,0,5,凱基-頭份,2024-08-23,9296
2348,海悅,4,0,4,凱基-頭份,2024-08-23,9296
2347,聯強,4,0,4,凱基-頭份,2024-08-23,9296
6133,金橋,4,0,4,凱基-頭份,2024-08-23,9296
00933B,國泰10Y+金融債,3,0,3,凱基-頭份,2024-08-23,9296
1702,南僑,3,0,3,凱基-頭份,2024-08-23,9296
00712,復華富時不動產,151,0,151,凱基-頭份,2024-08-26,9296
00664R,國泰臺灣加權反1,100,0,100,凱基-頭份,2024-08-26,9296
00919,群益台灣精選高息,86,2,84,凱基-頭份,2024-08-26,9296
2409,友達,114,63,51,凱基-頭份,2024-08-26,9296
2303,聯電,33,0,33,凱基-頭份,2024-08-26,9296
8070,長華*,36,9,27,凱基-頭份,2024-08-26,9296
2891,中信金,22,0,22,凱基-頭份,2024-08-26,9296
00680L,元大美債20正2,22,2,20,凱基-頭份,2024-08-26,9296
00929,復華台灣科技優息,16,2,14,凱基-頭份,2024-08-26,9296
00687B,國泰20年美債,14,0,14,凱基-頭份,2024-08-26,9296
00937B,群益ESG投等債20,28,15,13,凱基-頭份,2024-08-26,9296
2890,永豐金,12,0,12,凱基-頭份,2024-08-26,9296
2392,正崴,11,0,11,凱基-頭份,2024-08-26,9296
4967,十銓,11,0,11,凱基-頭份,2024-08-26,9296
00946,群益科技高息成長,10,0,10,凱基-頭份,2024-08-26,9296
2441,超豐,10,0,10,凱基-頭份,2024-08-26,9296
6005,群益證,10,0,10,凱基-頭份,2024-08-26,9296
8039,台虹,12,2,10,凱基-頭份,2024-08-26,9296
2331,精英,9,0,9,凱基-頭份,2024-08-26,9296
3260,威剛,11,2,9,凱基-頭份,2024-08-26,9296
5905,南仁湖,10,1,9,凱基-頭份,2024-08-26,9296
6609,瀧澤科,10,1,9,凱基-頭份,2024-08-26,9296
2417,圓剛,8,0,8,凱基-頭份,2024-08-26,9296
9935,慶豐富,8,0,8,凱基-頭份,2024-08-26,9296
00706L,期元大S＆P日圓正2,7,0,7,凱基-頭份,2024-08-26,9296
2515,中工,8,1,7,凱基-頭份,2024-08-26,9296
3390,旭軟,7,0,7,凱基-頭份,2024-08-26,9296
3615,安可,10,3,7,凱基-頭份,2024-08-26,9296
3645,達邁,7,0,7,凱基-頭份,2024-08-26,9296
4555,氣立,7,0,7,凱基-頭份,2024-08-26,9296
00936,台新永續高息中小,6,0,6,凱基-頭份,2024-08-26,9296
00679B,元大美債20年,6,0,6,凱基-頭份,2024-08-26,9296
2610,華航,8,2,6,凱基-頭份,2024-08-26,9296
2889,國票金,6,0,6,凱基-頭份,2024-08-26,9296
3047,訊舟,9,3,6,凱基-頭份,2024-08-26,9296
2376,技嘉,12,7,5,凱基-頭份,2024-08-26,9296
9927,泰銘,5,0,5,凱基-頭份,2024-08-26,9296
3583,辛耘,29,24,5,凱基-頭份,2024-08-26,9296
00942B,台新美A公司債20+,5,0,5,凱基-頭份,2024-08-26,9296
1522,堤維西,5,0,5,凱基-頭份,2024-08-26,9296
2388,威盛,6,1,5,凱基-頭份,2024-08-26,9296
2884,玉山金,9,4,5,凱基-頭份,2024-08-26,9296
5880,合庫金,5,0,5,凱基-頭份,2024-08-26,9296
6153,嘉聯益,5,0,5,凱基-頭份,2024-08-26,9296
6207,雷科,7,2,5,凱基-頭份,2024-08-26,9296
6219,富旺,36,31,5,凱基-頭份,2024-08-26,9296
8033,雷虎,5,0,5,凱基-頭份,2024-08-26,9296
00857B,永豐20年美公債,4,0,4,凱基-頭份,2024-08-26,9296
8028,昇陽半導體,19,15,4,凱基-頭份,2024-08-26,9296
00642U,期元大S＆P石油,5,1,4,凱基-頭份,2024-08-26,9296
00712,復華富時不動產,150,3,147,凱基-頭份,2024-08-27,9296
3481,群創,112,68,44,凱基-頭份,2024-08-27,9296
2891,中信金,39,0,39,凱基-頭份,2024-08-27,9296
2303,聯電,36,0,36,凱基-頭份,2024-08-27,9296
00688L,國泰20年美債正2,25,0,25,凱基-頭份,2024-08-27,9296
00937B,群益ESG投等債20,23,0,23,凱基-頭份,2024-08-27,9296
2610,華航,23,0,23,凱基-頭份,2024-08-27,9296
00919,群益台灣精選高息,26,7,19,凱基-頭份,2024-08-27,9296
3033,威健,21,2,19,凱基-頭份,2024-08-27,9296
9946,三發地產,19,0,19,凱基-頭份,2024-08-27,9296
00918,大華優利高填息30,16,0,16,凱基-頭份,2024-08-27,9296
2889,國票金,15,0,15,凱基-頭份,2024-08-27,9296
2884,玉山金,15,0,15,凱基-頭份,2024-08-27,9296
3019,亞光,19,6,13,凱基-頭份,2024-08-27,9296
8039,台虹,26,13,13,凱基-頭份,2024-08-27,9296
2890,永豐金,12,0,12,凱基-頭份,2024-08-27,9296
2062,橋椿,22,11,11,凱基-頭份,2024-08-27,9296
00929,復華台灣科技優息,15,5,10,凱基-頭份,2024-08-27,9296
00687B,國泰20年美債,10,0,10,凱基-頭份,2024-08-27,9296
4931,新盛力,10,0,10,凱基-頭份,2024-08-27,9296
00940,元大台灣價值高息,14,5,9,凱基-頭份,2024-08-27,9296
2476,鉅祥,8,0,8,凱基-頭份,2024-08-27,9296
00946,群益科技高息成長,7,0,7,凱基-頭份,2024-08-27,9296
2340,台亞,7,0,7,凱基-頭份,2024-08-27,9296
8927,北基,7,0,7,凱基-頭份,2024-08-27,9296
1301,台塑,7,1,6,凱基-頭份,2024-08-27,9296
00706L,期元大S＆P日圓正2,6,0,6,凱基-頭份,2024-08-27,9296
1513,中興電,6,0,6,凱基-頭份,2024-08-27,9296
1609,大亞,12,6,6,凱基-頭份,2024-08-27,9296
00936,台新永續高息中小,5,0,5,凱基-頭份,2024-08-27,9296
2201,裕隆,5,0,5,凱基-頭份,2024-08-27,9296
2023,燁輝,5,0,5,凱基-頭份,2024-08-27,9296
2634,漢翔,5,0,5,凱基-頭份,2024-08-27,9296
2867,三商壽,5,0,5,凱基-頭份,2024-08-27,9296
3006,晶豪科,5,0,5,凱基-頭份,2024-08-27,9296
3149,正達,5,0,5,凱基-頭份,2024-08-27,9296
3615,安可,6,1,5,凱基-頭份,2024-08-27,9296
5425,台半,5,0,5,凱基-頭份,2024-08-27,9296
6197,佳必琪,5,0,5,凱基-頭份,2024-08-27,9296
6877,鏵友益,5,0,5,凱基-頭份,2024-08-27,9296
2330,台積電,4,0,4,凱基-頭份,2024-08-27,9296
2887,台新金,6,2,4,凱基-頭份,2024-08-27,9296
00951,台新日本半導體,4,0,4,凱基-頭份,2024-08-27,9296
00933B,國泰10Y+金融債,4,0,4,凱基-頭份,2024-08-27,9296
1618,合機,4,0,4,凱基-頭份,2024-08-27,9296
2344,華邦電,4,0,4,凱基-頭份,2024-08-27,9296
2377,微星,6,2,4,凱基-頭份,2024-08-27,9296
2441,超豐,4,0,4,凱基-頭份,2024-08-27,9296
3550,聯穎,4,0,4,凱基-頭份,2024-08-27,9296
3652,精聯,4,0,4,凱基-頭份,2024-08-27,9296
2409,友達,318,106,212,凱基-頭份,2024-08-28,9296
2891,中信金,103,50,53,凱基-頭份,2024-08-28,9296
00940,元大台灣價值高息,40,10,30,凱基-頭份,2024-08-28,9296
6451,訊芯-KY,31,3,28,凱基-頭份,2024-08-28,9296
2349,錸德,55,33,22,凱基-頭份,2024-08-28,9296
2606,裕民,20,0,20,凱基-頭份,2024-08-28,9296
4714,永捷,20,0,20,凱基-頭份,2024-08-28,9296
3037,欣興,19,0,19,凱基-頭份,2024-08-28,9296
8039,台虹,20,4,16,凱基-頭份,2024-08-28,9296
4438,廣越,14,0,14,凱基-頭份,2024-08-28,9296
00919,群益台灣精選高息,13,0,13,凱基-頭份,2024-08-28,9296
2888,新光金,38,25,13,凱基-頭份,2024-08-28,9296
3312,弘憶股,19,6,13,凱基-頭份,2024-08-28,9296
00929,復華台灣科技優息,14,2,12,凱基-頭份,2024-08-28,9296
00933B,國泰10Y+金融債,11,0,11,凱基-頭份,2024-08-28,9296
3550,聯穎,11,0,11,凱基-頭份,2024-08-28,9296
4562,穎漢,15,4,11,凱基-頭份,2024-08-28,9296
00688L,國泰20年美債正2,10,0,10,凱基-頭份,2024-08-28,9296
3062,建漢,18,8,10,凱基-頭份,2024-08-28,9296
8277,商丞,10,0,10,凱基-頭份,2024-08-28,9296
2317,鴻海,11,2,9,凱基-頭份,2024-08-28,9296
2367,燿華,16,7,9,凱基-頭份,2024-08-28,9296
8111,立��,29,20,9,凱基-頭份,2024-08-28,9296
8121,越峰,10,1,9,凱基-頭份,2024-08-28,9296
00631L,元大台灣50正2,9,1,8,凱基-頭份,2024-08-28,9296
3522,御嵿,7,0,7,凱基-頭份,2024-08-28,9296
5345,天揚,7,0,7,凱基-頭份,2024-08-28,9296
2368,金像電,6,0,6,凱基-頭份,2024-08-28,9296
2615,萬海,8,2,6,凱基-頭份,2024-08-28,9296
00632R,元大台灣50反1,6,0,6,凱基-頭份,2024-08-28,9296
2515,中工,7,1,6,凱基-頭份,2024-08-28,9296
3710,連展投控,6,0,6,凱基-頭份,2024-08-28,9296
5905,南仁湖,6,0,6,凱基-頭份,2024-08-28,9296
6505,台塑化,6,0,6,凱基-頭份,2024-08-28,9296
5871,中租-KY,5,0,5,凱基-頭份,2024-08-28,9296
00878,國泰永續高股息,9,4,5,凱基-頭份,2024-08-28,9296
3293,鈊象,5,0,5,凱基-頭份,2024-08-28,9296
00706L,期元大S＆P日圓正2,5,0,5,凱基-頭份,2024-08-28,9296
00664R,國泰臺灣加權反1,5,0,5,凱基-頭份,2024-08-28,9296
1446,宏和,5,0,5,凱基-頭份,2024-08-28,9296
4513,福裕,9,4,5,凱基-頭份,2024-08-28,9296
4561,健椿,5,0,5,凱基-頭份,2024-08-28,9296
4927,泰鼎-KY,5,0,5,凱基-頭份,2024-08-28,9296
6218,豪勉,5,0,5,凱基-頭份,2024-08-28,9296
6284,佳邦,6,1,5,凱基-頭份,2024-08-28,9296
8064,東捷,11,6,5,凱基-頭份,2024-08-28,9296
1513,中興電,14,10,4,凱基-頭份,2024-08-28,9296
2029,盛餘,4,0,4,凱基-頭份,2024-08-28,9296
2243,宏旭-KY,4,0,4,凱基-頭份,2024-08-28,9296
2312,金寶,5,1,4,凱基-頭份,2024-08-28,9296
2891,中信金,1968,0,1968,凱基-頭份,2024-08-29,9296
00632R,元大台灣50反1,285,110,175,凱基-頭份,2024-08-29,9296
1540,喬福,44,15,29,凱基-頭份,2024-08-29,9296
00937B,群益ESG投等債20,28,0,28,凱基-頭份,2024-08-29,9296
00679B,元大美債20年,23,0,23,凱基-頭份,2024-08-29,9296
00720B,元大投資級公司債,21,0,21,凱基-頭份,2024-08-29,9296
00885,富邦越南,20,0,20,凱基-頭份,2024-08-29,9296
00942B,台新美A公司債20+,16,0,16,凱基-頭份,2024-08-29,9296
00688L,國泰20年美債正2,15,0,15,凱基-頭份,2024-08-29,9296
3710,連展投控,15,0,15,凱基-頭份,2024-08-29,9296
8028,昇陽半導體,15,2,13,凱基-頭份,2024-08-29,9296
2312,金寶,20,7,13,凱基-頭份,2024-08-29,9296
00935,野村臺灣新科技50,12,0,12,凱基-頭份,2024-08-29,9296
1721,三晃,19,7,12,凱基-頭份,2024-08-29,9296
2812,台中銀,12,0,12,凱基-頭份,2024-08-29,9296
00680L,元大美債20正2,11,0,11,凱基-頭份,2024-08-29,9296
00641R,富邦日本反1,10,0,10,凱基-頭份,2024-08-29,9296
5410,國眾,10,0,10,凱基-頭份,2024-08-29,9296
6895,宏碩系統,10,0,10,凱基-頭份,2024-08-29,9296
00919,群益台灣精選高息,9,0,9,凱基-頭份,2024-08-29,9296
1314,中石化,8,0,8,凱基-頭份,2024-08-29,9296
4909,新復興,21,13,8,凱基-頭份,2024-08-29,9296
6257,矽格,11,3,8,凱基-頭份,2024-08-29,9296
6770,力積電,8,0,8,凱基-頭份,2024-08-29,9296
1905,華紙,7,0,7,凱基-頭份,2024-08-29,9296
3550,聯穎,48,41,7,凱基-頭份,2024-08-29,9296
8011,台通,7,0,7,凱基-頭份,2024-08-29,9296
2801,彰銀,7,1,6,凱基-頭份,2024-08-29,9296
00959B,大華投等美債15Y+,6,0,6,凱基-頭份,2024-08-29,9296
3498,陽程,6,0,6,凱基-頭份,2024-08-29,9296
00931B,統一美債20年,5,0,5,凱基-頭份,2024-08-29,9296
00706L,期元大S＆P日圓正2,5,0,5,凱基-頭份,2024-08-29,9296
2417,圓剛,5,0,5,凱基-頭份,2024-08-29,9296
2436,偉詮電,5,0,5,凱基-頭份,2024-08-29,9296
2867,三商壽,5,0,5,凱基-頭份,2024-08-29,9296
6197,佳必琪,5,0,5,凱基-頭份,2024-08-29,9296
8076,伍豐,6,1,5,凱基-頭份,2024-08-29,9296
8222,寶一,5,0,5,凱基-頭份,2024-08-29,9296
2330,台積電,7,2,5,凱基-頭份,2024-08-29,9296
00918,大華優利高填息30,4,0,4,凱基-頭份,2024-08-29,9296
00891,中信關鍵半導體,5,1,4,凱基-頭份,2024-08-29,9296
2890,永豐金,6,2,4,凱基-頭份,2024-08-29,9296
3293,鈊象,4,0,4,凱基-頭份,2024-08-29,9296
00940,元大台灣價值高息,4,0,4,凱基-頭份,2024-08-29,9296
2610,華航,4,0,4,凱基-頭份,2024-08-29,9296
0050,元大台灣50,3,0,3,凱基-頭份,2024-08-29,9296
00933B,國泰10Y+金融債,3,0,3,凱基-頭份,2024-08-29,9296
1776,展宇,5,2,3,凱基-頭份,2024-08-29,9296
2313,華通,7,4,3,凱基-頭份,2024-08-29,9296
2442,新美齊,8,5,3,凱基-頭份,2024-08-29,9296
2845,遠東銀,100,13,87,凱基-頭份,2024-08-30,9296
00632R,元大台灣50反1,80,0,80,凱基-頭份,2024-08-30,9296
4526,東台,61,5,56,凱基-頭份,2024-08-30,9296
00959B,大華投等美債15Y+,45,0,45,凱基-頭份,2024-08-30,9296
6264,富裔,38,0,38,凱基-頭份,2024-08-30,9296
8111,立��,45,8,37,凱基-頭份,2024-08-30,9296
00929,復華台灣科技優息,48,13,35,凱基-頭份,2024-08-30,9296
00953B,群益優選非投等債,30,0,30,凱基-頭份,2024-08-30,9296
2886,兆豐金,27,0,27,凱基-頭份,2024-08-30,9296
1540,喬福,23,1,22,凱基-頭份,2024-08-30,9296
1711,永光,36,15,21,凱基-頭份,2024-08-30,9296
00665L,富邦�琤肭磪囓�2,20,0,20,凱基-頭份,2024-08-30,9296
2897,王道銀行,20,0,20,凱基-頭份,2024-08-30,9296
2891,中信金,19,0,19,凱基-頭份,2024-08-30,9296
8070,長華*,22,5,17,凱基-頭份,2024-08-30,9296
00680L,元大美債20正2,16,0,16,凱基-頭份,2024-08-30,9296
2314,台揚,15,0,15,凱基-頭份,2024-08-30,9296
2887,台新金,13,0,13,凱基-頭份,2024-08-30,9296
2426,鼎元,13,0,13,凱基-頭份,2024-08-30,9296
00915,凱基優選高股息30,11,0,11,凱基-頭份,2024-08-30,9296
2610,華航,11,0,11,凱基-頭份,2024-08-30,9296
1314,中石化,10,0,10,凱基-頭份,2024-08-30,9296
00664R,國泰臺灣加權反1,10,0,10,凱基-頭份,2024-08-30,9296
00688L,國泰20年美債正2,10,0,10,凱基-頭份,2024-08-30,9296
2838,聯邦銀,10,0,10,凱基-頭份,2024-08-30,9296
4303,信立,11,1,10,凱基-頭份,2024-08-30,9296
6213,聯茂,13,3,10,凱基-頭份,2024-08-30,9296
6670,復盛應用,10,0,10,凱基-頭份,2024-08-30,9296
00937B,群益ESG投等債20,19,10,9,凱基-頭份,2024-08-30,9296
3689,湧德,9,0,9,凱基-頭份,2024-08-30,9296
3710,連展投控,9,0,9,凱基-頭份,2024-08-30,9296
00690,兆豐藍籌30,8,0,8,凱基-頭份,2024-08-30,9296
2312,金寶,8,0,8,凱基-頭份,2024-08-30,9296
1733,五鼎,7,0,7,凱基-頭份,2024-08-30,9296
2367,燿華,23,16,7,凱基-頭份,2024-08-30,9296
2542,興富發,8,1,7,凱基-頭份,2024-08-30,9296
3615,安可,7,0,7,凱基-頭份,2024-08-30,9296
8028,昇陽半導體,6,0,6,凱基-頭份,2024-08-30,9296
00942B,台新美A公司債20+,6,0,6,凱基-頭份,2024-08-30,9296
5410,國眾,6,0,6,凱基-頭份,2024-08-30,9296
6224,聚鼎,6,0,6,凱基-頭份,2024-08-30,9296
00687B,國泰20年美債,5,0,5,凱基-頭份,2024-08-30,9296
0056,元大高股息,6,1,5,凱基-頭份,2024-08-30,9296
2477,美隆電,5,0,5,凱基-頭份,2024-08-30,9296
2489,瑞軒,5,0,5,凱基-頭份,2024-08-30,9296
4198,欣大健康,5,0,5,凱基-頭份,2024-08-30,9296
6156,松上,9,4,5,凱基-頭份,2024-08-30,9296
6197,佳必琪,5,0,5,凱基-頭份,2024-08-30,9296
9902,台火,5,0,5,凱基-頭份,2024-08-30,9296
3374,精材,5,1,4,凱基-頭份,2024-08-30,9296
00687B,國泰20年美債,1799,0,1799,凱基-頭份,2024-09-02,9296
1217,愛之味,127,0,127,凱基-頭份,2024-09-02,9296
3673,TPK-KY,72,11,61,凱基-頭份,2024-09-02,9296
2641,正德,51,0,51,凱基-頭份,2024-09-02,9296
00937B,群益ESG投等債20,45,0,45,凱基-頭份,2024-09-02,9296
6264,富裔,40,0,40,凱基-頭份,2024-09-02,9296
00959B,大華投等美債15Y+,37,0,37,凱基-頭份,2024-09-02,9296
00946,群益科技高息成長,30,0,30,凱基-頭份,2024-09-02,9296
1522,堤維西,35,5,30,凱基-頭份,2024-09-02,9296
8043,蜜望實,30,3,27,凱基-頭份,2024-09-02,9296
00942B,台新美A公司債20+,23,0,23,凱基-頭份,2024-09-02,9296
5519,隆大,20,0,20,凱基-頭份,2024-09-02,9296
9946,三發地產,20,0,20,凱基-頭份,2024-09-02,9296
00688L,國泰20年美債正2,19,0,19,凱基-頭份,2024-09-02,9296
00929,復華台灣科技優息,17,0,17,凱基-頭份,2024-09-02,9296
1584,精剛,13,0,13,凱基-頭份,2024-09-02,9296
2897,王道銀行,13,0,13,凱基-頭份,2024-09-02,9296
911868,同方友友-DR,13,0,13,凱基-頭份,2024-09-02,9296
00919,群益台灣精選高息,28,15,13,凱基-頭份,2024-09-02,9296
5345,天揚,12,0,12,凱基-頭份,2024-09-02,9296
5443,均豪,49,37,12,凱基-頭份,2024-09-02,9296
1436,華友聯,11,0,11,凱基-頭份,2024-09-02,9296
9906,欣巴巴,14,3,11,凱基-頭份,2024-09-02,9296
00679B,元大美債20年,12,2,10,凱基-頭份,2024-09-02,9296
00939,統一台灣高息動能,10,0,10,凱基-頭份,2024-09-02,9296
2314,台揚,10,0,10,凱基-頭份,2024-09-02,9296
2812,台中銀,10,0,10,凱基-頭份,2024-09-02,9296
1513,中興電,10,1,9,凱基-頭份,2024-09-02,9296
00715L,期街口布蘭特正2,9,0,9,凱基-頭份,2024-09-02,9296
1314,中石化,11,2,9,凱基-頭份,2024-09-02,9296
3047,訊舟,12,4,8,凱基-頭份,2024-09-02,9296
3294,英濟,9,1,8,凱基-頭份,2024-09-02,9296
5481,新華,8,0,8,凱基-頭份,2024-09-02,9296
00795B,中信美國公債20年,7,0,7,凱基-頭份,2024-09-02,9296
00878,國泰永續高股息,7,0,7,凱基-頭份,2024-09-02,9296
2426,鼎元,17,10,7,凱基-頭份,2024-09-02,9296
3037,欣興,8,1,7,凱基-頭份,2024-09-02,9296
3710,連展投控,7,0,7,凱基-頭份,2024-09-02,9296
4306,炎洲,9,2,7,凱基-頭份,2024-09-02,9296
6451,訊芯-KY,9,2,7,凱基-頭份,2024-09-02,9296
00713,元大台灣高息低波,8,1,7,凱基-頭份,2024-09-02,9296
2887,台新金,7,0,7,凱基-頭份,2024-09-02,9296
2317,鴻海,7,1,6,凱基-頭份,2024-09-02,9296
00690,兆豐藍籌30,6,0,6,凱基-頭份,2024-09-02,9296
00882,中信中國高股息,6,0,6,凱基-頭份,2024-09-02,9296
00650L,復華香港正2,6,0,6,凱基-頭份,2024-09-02,9296
6151,晉倫,10,4,6,凱基-頭份,2024-09-02,9296
2889,國票金,6,0,6,凱基-頭份,2024-09-02,9296
2442,新美齊,5,0,5,凱基-頭份,2024-09-02,9296
0056,元大高股息,10,5,5,凱基-頭份,2024-09-02,9296
00687B,國泰20年美債,283,0,283,凱基-頭份,2024-09-03,9296
00680L,元大美債20正2,113,0,113,凱基-頭份,2024-09-03,9296
00933B,國泰10Y+金融債,100,0,100,凱基-頭份,2024-09-03,9296
00937B,群益ESG投等債20,43,0,43,凱基-頭份,2024-09-03,9296
00929,復華台灣科技優息,48,6,42,凱基-頭份,2024-09-03,9296
2442,新美齊,31,0,31,凱基-頭份,2024-09-03,9296
00953B,群益優選非投等債,30,0,30,凱基-頭份,2024-09-03,9296
2606,裕民,20,0,20,凱基-頭份,2024-09-03,9296
2027,大成鋼,20,1,19,凱基-頭份,2024-09-03,9296
3047,訊舟,30,11,19,凱基-頭份,2024-09-03,9296
1785,光洋科,19,0,19,凱基-頭份,2024-09-03,9296
00706L,期元大S＆P日圓正2,16,0,16,凱基-頭份,2024-09-03,9296
4566,時碩工業,16,0,16,凱基-頭份,2024-09-03,9296
8076,伍豐,21,5,16,凱基-頭份,2024-09-03,9296
2312,金寶,15,0,15,凱基-頭份,2024-09-03,9296
2610,華航,15,0,15,凱基-頭份,2024-09-03,9296
00919,群益台灣精選高息,19,5,14,凱基-頭份,2024-09-03,9296
00918,大華優利高填息30,14,0,14,凱基-頭份,2024-09-03,9296
6219,富旺,15,1,14,凱基-頭份,2024-09-03,9296
00878,國泰永續高股息,11,0,11,凱基-頭份,2024-09-03,9296
00642U,期元大S＆P石油,10,0,10,凱基-頭份,2024-09-03,9296
2393,億光,10,0,10,凱基-頭份,2024-09-03,9296
3312,弘憶股,10,0,10,凱基-頭份,2024-09-03,9296
2417,圓剛,12,4,8,凱基-頭份,2024-09-03,9296
2609,陽明,8,0,8,凱基-頭份,2024-09-03,9296
00720B,元大投資級公司債,7,0,7,凱基-頭份,2024-09-03,9296
1301,台塑,7,1,6,凱基-頭份,2024-09-03,9296
2002,中鋼,6,0,6,凱基-頭份,2024-09-03,9296
1717,長興,6,0,6,凱基-頭份,2024-09-03,9296
2062,橋椿,10,4,6,凱基-頭份,2024-09-03,9296
3006,晶豪科,6,0,6,凱基-頭份,2024-09-03,9296
3689,湧德,6,0,6,凱基-頭份,2024-09-03,9296
911868,同方友友-DR,6,0,6,凱基-頭份,2024-09-03,9296
5443,均豪,21,15,6,凱基-頭份,2024-09-03,9296
6505,台塑化,5,0,5,凱基-頭份,2024-09-03,9296
00940,元大台灣價值高息,5,0,5,凱基-頭份,2024-09-03,9296
1446,宏和,5,0,5,凱基-頭份,2024-09-03,9296
1475,業旺,5,0,5,凱基-頭份,2024-09-03,9296
2355,敬鵬,5,0,5,凱基-頭份,2024-09-03,9296
2489,瑞軒,5,0,5,凱基-頭份,2024-09-03,9296
2634,漢翔,5,0,5,凱基-頭份,2024-09-03,9296
3048,益登,5,0,5,凱基-頭份,2024-09-03,9296
3092,鴻碩,5,0,5,凱基-頭份,2024-09-03,9296
3710,連展投控,5,0,5,凱基-頭份,2024-09-03,9296
4726,永昕,5,0,5,凱基-頭份,2024-09-03,9296
4807,日成-KY,5,0,5,凱基-頭份,2024-09-03,9296
8070,長華*,9,4,5,凱基-頭份,2024-09-03,9296
9935,慶豐富,5,0,5,凱基-頭份,2024-09-03,9296
9945,潤泰新,5,0,5,凱基-頭份,2024-09-03,9296
6177,達麗,5,0,5,凱基-頭份,2024-09-03,9296
2883,凱基金,4060,0,4060,凱基-頭份,2024-09-04,9296
00878,國泰永續高股息,84,0,84,凱基-頭份,2024-09-04,9296
00919,群益台灣精選高息,128,46,82,凱基-頭份,2024-09-04,9296
00929,復華台灣科技優息,87,6,81,凱基-頭份,2024-09-04,9296
00918,大華優利高填息30,63,0,63,凱基-頭份,2024-09-04,9296
00940,元大台灣價值高息,54,2,52,凱基-頭份,2024-09-04,9296
00680L,元大美債20正2,54,5,49,凱基-頭份,2024-09-04,9296
00931B,統一美債20年,50,1,49,凱基-頭份,2024-09-04,9296
2891,中信金,45,0,45,凱基-頭份,2024-09-04,9296
2106,建大,41,0,41,凱基-頭份,2024-09-04,9296
2834,臺企銀,30,0,30,凱基-頭份,2024-09-04,9296
2890,永豐金,25,0,25,凱基-頭份,2024-09-04,9296
00950B,凱基A級公司債,30,5,25,凱基-頭份,2024-09-04,9296
2610,華航,25,1,24,凱基-頭份,2024-09-04,9296
2605,新興,21,0,21,凱基-頭份,2024-09-04,9296
2027,大成鋼,21,1,20,凱基-頭份,2024-09-04,9296
2002,中鋼,20,0,20,凱基-頭份,2024-09-04,9296
2897,王道銀行,20,0,20,凱基-頭份,2024-09-04,9296
2330,台積電,28,10,18,凱基-頭份,2024-09-04,9296
6177,達麗,18,0,18,凱基-頭份,2024-09-04,9296
00713,元大台灣高息低波,18,0,18,凱基-頭份,2024-09-04,9296
00915,凱基優選高股息30,18,2,16,凱基-頭份,2024-09-04,9296
00923,群益台ESG低碳50,14,1,13,凱基-頭份,2024-09-04,9296
1609,大亞,13,0,13,凱基-頭份,2024-09-04,9296
00930,永豐ESG低碳高息,13,0,13,凱基-頭份,2024-09-04,9296
0050,元大台灣50,12,0,12,凱基-頭份,2024-09-04,9296
00679B,元大美債20年,13,1,12,凱基-頭份,2024-09-04,9296
2382,廣達,72,61,11,凱基-頭份,2024-09-04,9296
00946,群益科技高息成長,11,0,11,凱基-頭份,2024-09-04,9296
2353,宏��,11,0,11,凱基-頭份,2024-09-04,9296
2820,華票,11,0,11,凱基-頭份,2024-09-04,9296
00898,國泰基因免疫革命,10,0,10,凱基-頭份,2024-09-04,9296
00650L,復華香港正2,10,0,10,凱基-頭份,2024-09-04,9296
00951,台新日本半導體,10,0,10,凱基-頭份,2024-09-04,9296
1536,和大,10,0,10,凱基-頭份,2024-09-04,9296
2442,新美齊,10,0,10,凱基-頭份,2024-09-04,9296
4510,高鋒,16,6,10,凱基-頭份,2024-09-04,9296
4960,誠美材,10,0,10,凱基-頭份,2024-09-04,9296
1326,台化,9,0,9,凱基-頭份,2024-09-04,9296
3231,緯創,12,3,9,凱基-頭份,2024-09-04,9296
5880,合庫金,9,0,9,凱基-頭份,2024-09-04,9296
00881,國泰台灣5G+,8,0,8,凱基-頭份,2024-09-04,9296
00726B,國泰新興投等債,8,0,8,凱基-頭份,2024-09-04,9296
1785,光洋科,8,0,8,凱基-頭份,2024-09-04,9296
2412,中華電,8,0,8,凱基-頭份,2024-09-04,9296
3047,訊舟,12,4,8,凱基-頭份,2024-09-04,9296
4807,日成-KY,10,2,8,凱基-頭份,2024-09-04,9296
4931,新盛力,8,0,8,凱基-頭份,2024-09-04,9296
1314,中石化,15,7,8,凱基-頭份,2024-09-04,9296
1513,中興電,8,1,7,凱基-頭份,2024-09-04,9296
00687B,國泰20年美債,1991,15,1976,凱基-頭份,2024-09-05,9296
00664R,國泰臺灣加權反1,65,0,65,凱基-頭份,2024-09-05,9296
00929,復華台灣科技優息,51,5,46,凱基-頭份,2024-09-05,9296
00919,群益台灣精選高息,56,12,44,凱基-頭份,2024-09-05,9296
2888,新光金,65,25,40,凱基-頭份,2024-09-05,9296
00632R,元大台灣50反1,39,0,39,凱基-頭份,2024-09-05,9296
2891,中信金,31,2,29,凱基-頭份,2024-09-05,9296
6264,富裔,25,0,25,凱基-頭份,2024-09-05,9296
00642U,期元大S＆P石油,20,0,20,凱基-頭份,2024-09-05,9296
2392,正崴,20,0,20,凱基-頭份,2024-09-05,9296
2838,聯邦銀,20,0,20,凱基-頭份,2024-09-05,9296
2845,遠東銀,20,0,20,凱基-頭份,2024-09-05,9296
2897,王道銀行,20,0,20,凱基-頭份,2024-09-05,9296
3049,精金,20,0,20,凱基-頭份,2024-09-05,9296
3339,泰谷,20,0,20,凱基-頭份,2024-09-05,9296
6219,富旺,20,0,20,凱基-頭份,2024-09-05,9296
2303,聯電,19,1,18,凱基-頭份,2024-09-05,9296
2442,新美齊,15,0,15,凱基-頭份,2024-09-05,9296
8105,凌巨,15,0,15,凱基-頭份,2024-09-05,9296
00918,大華優利高填息30,14,0,14,凱基-頭份,2024-09-05,9296
1314,中石化,13,0,13,凱基-頭份,2024-09-05,9296
1609,大亞,13,1,12,凱基-頭份,2024-09-05,9296
00712,復華富時不動產,11,0,11,凱基-頭份,2024-09-05,9296
0056,元大高股息,15,4,11,凱基-頭份,2024-09-05,9296
00940,元大台灣價值高息,11,0,11,凱基-頭份,2024-09-05,9296
00720B,元大投資級公司債,10,0,10,凱基-頭份,2024-09-05,9296
1312,國喬,10,0,10,凱基-頭份,2024-09-05,9296
2495,普安,13,3,10,凱基-頭份,2024-09-05,9296
9934,成霖,15,5,10,凱基-頭份,2024-09-05,9296
1316,上曜,8,0,8,凱基-頭份,2024-09-05,9296
8374,羅昇,26,18,8,凱基-頭份,2024-09-05,9296
3481,群創,8,1,7,凱基-頭份,2024-09-05,9296
00713,元大台灣高息低波,7,0,7,凱基-頭份,2024-09-05,9296
6505,台塑化,7,0,7,凱基-頭份,2024-09-05,9296
3037,欣興,14,7,7,凱基-頭份,2024-09-05,9296
5347,世界,8,1,7,凱基-頭份,2024-09-05,9296
5880,合庫金,7,0,7,凱基-頭份,2024-09-05,9296
00878,國泰永續高股息,16,10,6,凱基-頭份,2024-09-05,9296
2317,鴻海,9,3,6,凱基-頭份,2024-09-05,9296
00715L,期街口布蘭特正2,6,0,6,凱基-頭份,2024-09-05,9296
2368,金像電,6,0,6,凱基-頭份,2024-09-05,9296
2476,鉅祥,6,0,6,凱基-頭份,2024-09-05,9296
3689,湧德,6,0,6,凱基-頭份,2024-09-05,9296
2312,金寶,5,0,5,凱基-頭份,2024-09-05,9296
2412,中華電,5,0,5,凱基-頭份,2024-09-05,9296
3027,盛達,5,0,5,凱基-頭份,2024-09-05,9296
3149,正達,5,0,5,凱基-頭份,2024-09-05,9296
3710,連展投控,5,0,5,凱基-頭份,2024-09-05,9296
4576,大銀微系統,11,6,5,凱基-頭份,2024-09-05,9296
4714,永捷,5,0,5,凱基-頭份,2024-09-05,9296
00632R,元大台灣50反1,110,0,110,凱基-頭份,2024-09-06,9296
2303,聯電,55,1,54,凱基-頭份,2024-09-06,9296
00687B,國泰20年美債,45,0,45,凱基-頭份,2024-09-06,9296
2610,華航,20,0,20,凱基-頭份,2024-09-06,9296
2618,長榮航,20,0,20,凱基-頭份,2024-09-06,9296
8070,長華*,27,7,20,凱基-頭份,2024-09-06,9296
00878,國泰永續高股息,23,5,18,凱基-頭份,2024-09-06,9296
00664R,國泰臺灣加權反1,15,0,15,凱基-頭份,2024-09-06,9296
00680L,元大美債20正2,13,0,13,凱基-頭份,2024-09-06,9296
00918,大華優利高填息30,12,0,12,凱基-頭份,2024-09-06,9296
2241,艾姆勒,12,0,12,凱基-頭份,2024-09-06,9296
00929,復華台灣科技優息,24,13,11,凱基-頭份,2024-09-06,9296
00946,群益科技高息成長,10,0,10,凱基-頭份,2024-09-06,9296
00885,富邦越南,10,0,10,凱基-頭份,2024-09-06,9296
3047,訊舟,34,24,10,凱基-頭份,2024-09-06,9296
2888,新光金,10,0,10,凱基-頭份,2024-09-06,9296
00919,群益台灣精選高息,12,3,9,凱基-頭份,2024-09-06,9296
2002,中鋼,8,0,8,凱基-頭份,2024-09-06,9296
00915,凱基優選高股息30,7,0,7,凱基-頭份,2024-09-06,9296
00690,兆豐藍籌30,7,0,7,凱基-頭份,2024-09-06,9296
1609,大亞,7,0,7,凱基-頭份,2024-09-06,9296
6770,力積電,12,5,7,凱基-頭份,2024-09-06,9296
00937B,群益ESG投等債20,10,4,6,凱基-頭份,2024-09-06,9296
9933,中鼎,6,0,6,凱基-頭份,2024-09-06,9296
00679B,元大美債20年,6,1,5,凱基-頭份,2024-09-06,9296
00715L,期街口布蘭特正2,5,0,5,凱基-頭份,2024-09-06,9296
1718,中纖,5,0,5,凱基-頭份,2024-09-06,9296
1815,富喬,5,0,5,凱基-頭份,2024-09-06,9296
2027,大成鋼,7,2,5,凱基-頭份,2024-09-06,9296
2441,超豐,5,0,5,凱基-頭份,2024-09-06,9296
6219,富旺,5,0,5,凱基-頭份,2024-09-06,9296
3019,亞光,6,1,5,凱基-頭份,2024-09-06,9296
9941,裕融,4,0,4,凱基-頭份,2024-09-06,9296
00939,統一台灣高息動能,4,0,4,凱基-頭份,2024-09-06,9296
2313,華通,5,1,4,凱基-頭份,2024-09-06,9296
4956,光鋐,5,1,4,凱基-頭份,2024-09-06,9296
6156,松上,4,0,4,凱基-頭份,2024-09-06,9296
6270,倍微,4,0,4,凱基-頭份,2024-09-06,9296
9906,欣巴巴,13,9,4,凱基-頭份,2024-09-06,9296
2609,陽明,3,0,3,凱基-頭份,2024-09-06,9296
00949,復華日本龍頭,3,0,3,凱基-頭份,2024-09-06,9296
2382,廣達,5,2,3,凱基-頭份,2024-09-06,9296
00951,台新日本半導體,3,0,3,凱基-頭份,2024-09-06,9296
00650L,復華香港正2,3,0,3,凱基-頭份,2024-09-06,9296
2365,昆盈,14,11,3,凱基-頭份,2024-09-06,9296
2369,菱生,5,2,3,凱基-頭份,2024-09-06,9296
2408,南亞科,3,0,3,凱基-頭份,2024-09-06,9296
2464,盟立,13,10,3,凱基-頭份,2024-09-06,9296
2542,興富發,3,0,3,凱基-頭份,2024-09-06,9296
3037,欣興,3,0,3,凱基-頭份,2024-09-06,9296
00919,群益台灣精選高息,88,3,85,凱基-頭份,2024-09-09,9296
00929,復華台灣科技優息,90,17,73,凱基-頭份,2024-09-09,9296
00637L,元大滬深300正2,52,2,50,凱基-頭份,2024-09-09,9296
00878,國泰永續高股息,48,2,46,凱基-頭份,2024-09-09,9296
00665L,富邦�琤肭磪囓�2,30,0,30,凱基-頭份,2024-09-09,9296
2891,中信金,29,0,29,凱基-頭份,2024-09-09,9296
00632R,元大台灣50反1,160,134,26,凱基-頭份,2024-09-09,9296
00679B,元大美債20年,32,10,22,凱基-頭份,2024-09-09,9296
4162,智擎,21,0,21,凱基-頭份,2024-09-09,9296
2382,廣達,92,72,20,凱基-頭份,2024-09-09,9296
1540,喬福,24,4,20,凱基-頭份,2024-09-09,9296
3545,敦泰,20,0,20,凱基-頭份,2024-09-09,9296
0056,元大高股息,20,1,19,凱基-頭份,2024-09-09,9296
00940,元大台灣價值高息,18,0,18,凱基-頭份,2024-09-09,9296
2615,萬海,38,22,16,凱基-頭份,2024-09-09,9296
00650L,復華香港正2,15,0,15,凱基-頭份,2024-09-09,9296
00713,元大台灣高息低波,14,0,14,凱基-頭份,2024-09-09,9296
6151,晉倫,14,0,14,凱基-頭份,2024-09-09,9296
00918,大華優利高填息30,18,5,13,凱基-頭份,2024-09-09,9296
00795B,中信美國公債20年,12,0,12,凱基-頭份,2024-09-09,9296
00772B,中信高評級公司債,10,0,10,凱基-頭份,2024-09-09,9296
00642U,期元大S＆P石油,10,0,10,凱基-頭份,2024-09-09,9296
2106,建大,10,0,10,凱基-頭份,2024-09-09,9296
3290,東浦,10,0,10,凱基-頭份,2024-09-09,9296
3380,明泰,10,0,10,凱基-頭份,2024-09-09,9296
8112,至上,11,1,10,凱基-頭份,2024-09-09,9296
00680L,元大美債20正2,11,2,9,凱基-頭份,2024-09-09,9296
00952,凱基台灣AI50,9,0,9,凱基-頭份,2024-09-09,9296
00915,凱基優選高股息30,9,0,9,凱基-頭份,2024-09-09,9296
00948B,中信優息投資級債,8,0,8,凱基-頭份,2024-09-09,9296
2892,第一金,8,0,8,凱基-頭份,2024-09-09,9296
1314,中石化,13,6,7,凱基-頭份,2024-09-09,9296
2603,長榮,28,21,7,凱基-頭份,2024-09-09,9296
00881,國泰台灣5G+,7,0,7,凱基-頭份,2024-09-09,9296
6505,台塑化,8,2,6,凱基-頭份,2024-09-09,9296
2330,台積電,7,0,7,凱基-頭份,2024-09-09,9296
00688L,國泰20年美債正2,6,0,6,凱基-頭份,2024-09-09,9296
00934,中信成長高股息,6,0,6,凱基-頭份,2024-09-09,9296
9945,潤泰新,6,0,6,凱基-頭份,2024-09-09,9296
2881,富邦金,5,0,5,凱基-頭份,2024-09-09,9296
2002,中鋼,5,0,5,凱基-頭份,2024-09-09,9296
2442,新美齊,5,0,5,凱基-頭份,2024-09-09,9296
2820,華票,5,0,5,凱基-頭份,2024-09-09,9296
3580,友威科,5,0,5,凱基-頭份,2024-09-09,9296
6217,中探針,5,0,5,凱基-頭份,2024-09-09,9296
6274,台燿,5,0,5,凱基-頭份,2024-09-09,9296
6763,綠界科技*,5,0,5,凱基-頭份,2024-09-09,9296
2317,鴻海,10,5,5,凱基-頭份,2024-09-09,9296
2542,興富發,4,0,4,凱基-頭份,2024-09-09,9296
00949,復華日本龍頭,4,0,4,凱基-頭份,2024-09-09,9296
00632R,元大台灣50反1,110,10,100,凱基-頭份,2024-09-10,9296
00929,復華台灣科技優息,99,3,96,凱基-頭份,2024-09-10,9296
00687B,國泰20年美債,74,6,68,凱基-頭份,2024-09-10,9296
00919,群益台灣精選高息,35,6,29,凱基-頭份,2024-09-10,9296
3491,昇達科,31,2,29,凱基-頭份,2024-09-10,9296
1305,華夏,28,0,28,凱基-頭份,2024-09-10,9296
1326,台化,23,0,23,凱基-頭份,2024-09-10,9296
2002,中鋼,23,2,21,凱基-頭份,2024-09-10,9296
00959B,大華投等美債15Y+,20,0,20,凱基-頭份,2024-09-10,9296
1809,中釉,20,0,20,凱基-頭份,2024-09-10,9296
2489,瑞軒,20,0,20,凱基-頭份,2024-09-10,9296
6264,富裔,20,0,20,凱基-頭份,2024-09-10,9296
3294,英濟,18,0,18,凱基-頭份,2024-09-10,9296
00878,國泰永續高股息,20,3,17,凱基-頭份,2024-09-10,9296
2367,燿華,17,0,17,凱基-頭份,2024-09-10,9296
00688L,國泰20年美債正2,16,0,16,凱基-頭份,2024-09-10,9296
00940,元大台灣價值高息,17,2,15,凱基-頭份,2024-09-10,9296
9946,三發地產,15,0,15,凱基-頭份,2024-09-10,9296
2891,中信金,14,0,14,凱基-頭份,2024-09-10,9296
5443,均豪,53,39,14,凱基-頭份,2024-09-10,9296
0056,元大高股息,16,2,14,凱基-頭份,2024-09-10,9296
00918,大華優利高填息30,21,8,13,凱基-頭份,2024-09-10,9296
1776,展宇,12,0,12,凱基-頭份,2024-09-10,9296
3645,達邁,12,0,12,凱基-頭份,2024-09-10,9296
2515,中工,12,1,11,凱基-頭份,2024-09-10,9296
6763,綠界科技*,10,0,10,凱基-頭份,2024-09-10,9296
8038,長園科,10,0,10,凱基-頭份,2024-09-10,9296
00952,凱基台灣AI50,9,0,9,凱基-頭份,2024-09-10,9296
4931,新盛力,19,10,9,凱基-頭份,2024-09-10,9296
00690,兆豐藍籌30,7,0,7,凱基-頭份,2024-09-10,9296
00715L,期街口布蘭特正2,7,0,7,凱基-頭份,2024-09-10,9296
00946,群益科技高息成長,7,0,7,凱基-頭份,2024-09-10,9296
2610,華航,7,0,7,凱基-頭份,2024-09-10,9296
3028,增你強,7,0,7,凱基-頭份,2024-09-10,9296
2317,鴻海,14,7,7,凱基-頭份,2024-09-10,9296
00706L,期元大S＆P日圓正2,6,0,6,凱基-頭份,2024-09-10,9296
2344,華邦電,7,1,6,凱基-頭份,2024-09-10,9296
2368,金像電,6,0,6,凱基-頭份,2024-09-10,9296
3062,建漢,12,6,6,凱基-頭份,2024-09-10,9296
6156,松上,6,0,6,凱基-頭份,2024-09-10,9296
9906,欣巴巴,6,0,6,凱基-頭份,2024-09-10,9296
2313,華通,8,3,5,凱基-頭份,2024-09-10,9296
2379,瑞昱,5,0,5,凱基-頭份,2024-09-10,9296
3032,偉訓,5,0,5,凱基-頭份,2024-09-10,9296
3708,上緯投控,5,0,5,凱基-頭份,2024-09-10,9296
5905,南仁湖,5,0,5,凱基-頭份,2024-09-10,9296
6218,豪勉,5,0,5,凱基-頭份,2024-09-10,9296
6715,嘉基,5,0,5,凱基-頭份,2024-09-10,9296
6733,博晟生醫,5,0,5,凱基-頭份,2024-09-10,9296
00891,中信關鍵半導體,4,0,4,凱基-頭份,2024-09-10,9296
1718,中纖,137,3,134,凱基-頭份,2024-09-11,9296
00712,復華富時不動產,100,0,100,凱基-頭份,2024-09-11,9296
00632R,元大台灣50反1,177,100,77,凱基-頭份,2024-09-11,9296
00937B,群益ESG投等債20,38,0,38,凱基-頭份,2024-09-11,9296
2867,三商壽,57,21,36,凱基-頭份,2024-09-11,9296
00665L,富邦�琤肭磪囓�2,30,0,30,凱基-頭份,2024-09-11,9296
2891,中信金,28,0,28,凱基-頭份,2024-09-11,9296
2363,矽統,26,0,26,凱基-頭份,2024-09-11,9296
00882,中信中國高股息,25,1,24,凱基-頭份,2024-09-11,9296
00959B,大華投等美債15Y+,20,0,20,凱基-頭份,2024-09-11,9296
00715L,期街口布蘭特正2,16,0,16,凱基-頭份,2024-09-11,9296
00720B,元大投資級公司債,15,0,15,凱基-頭份,2024-09-11,9296
6743,安普新,16,2,14,凱基-頭份,2024-09-11,9296
5475,德宏,12,0,12,凱基-頭份,2024-09-11,9296
00878,國泰永續高股息,14,2,12,凱基-頭份,2024-09-11,9296
00929,復華台灣科技優息,11,0,11,凱基-頭份,2024-09-11,9296
00642U,期元大S＆P石油,10,0,10,凱基-頭份,2024-09-11,9296
00957B,兆豐US優選投等債,10,0,10,凱基-頭份,2024-09-11,9296
1101,台泥,10,0,10,凱基-頭份,2024-09-11,9296
1603,華電,10,0,10,凱基-頭份,2024-09-11,9296
2495,普安,10,0,10,凱基-頭份,2024-09-11,9296
3062,建漢,21,11,10,凱基-頭份,2024-09-11,9296
2002,中鋼,10,1,9,凱基-頭份,2024-09-11,9296
00650L,復華香港正2,15,7,8,凱基-頭份,2024-09-11,9296
00946,群益科技高息成長,7,0,7,凱基-頭份,2024-09-11,9296
9907,統一實,7,0,7,凱基-頭份,2024-09-11,9296
00919,群益台灣精選高息,6,0,6,凱基-頭份,2024-09-11,9296
2883,凱基金,6,0,6,凱基-頭份,2024-09-11,9296
00900,富邦特選高股息30,6,0,6,凱基-頭份,2024-09-11,9296
00690,兆豐藍籌30,6,0,6,凱基-頭份,2024-09-11,9296
00940,元大台灣價值高息,9,4,5,凱基-頭份,2024-09-11,9296
00679B,元大美債20年,6,1,5,凱基-頭份,2024-09-11,9296
2441,超豐,5,0,5,凱基-頭份,2024-09-11,9296
2497,怡利電,7,2,5,凱基-頭份,2024-09-11,9296
3027,盛達,5,0,5,凱基-頭份,2024-09-11,9296
4538,大詠城,5,0,5,凱基-頭份,2024-09-11,9296
2317,鴻海,4,0,4,凱基-頭份,2024-09-11,9296
0056,元大高股息,4,0,4,凱基-頭份,2024-09-11,9296
6139,亞翔,5,1,4,凱基-頭份,2024-09-11,9296
2027,大成鋼,4,0,4,凱基-頭份,2024-09-11,9296
2314,台揚,4,0,4,凱基-頭份,2024-09-11,9296
2388,威盛,19,15,4,凱基-頭份,2024-09-11,9296
4510,高鋒,26,22,4,凱基-頭份,2024-09-11,9296
8074,鉅橡,4,0,4,凱基-頭份,2024-09-11,9296
2609,陽明,3,0,3,凱基-頭份,2024-09-11,9296
2881,富邦金,3,0,3,凱基-頭份,2024-09-11,9296
00945B,凱基美國非投等債,3,0,3,凱基-頭份,2024-09-11,9296
1301,台塑,6,3,3,凱基-頭份,2024-09-11,9296
1444,力麗,3,0,3,凱基-頭份,2024-09-11,9296
1471,首利,3,0,3,凱基-頭份,2024-09-11,9296
00921,兆豐龍頭等權重,3677,30,3647,凱基-頭份,2024-09-12,9296
00632R,元大台灣50反1,176,100,76,凱基-頭份,2024-09-12,9296
00915,凱基優選高股息30,40,0,40,凱基-頭份,2024-09-12,9296
00664R,國泰臺灣加權反1,40,0,40,凱基-頭份,2024-09-12,9296
2891,中信金,38,8,30,凱基-頭份,2024-09-12,9296
00940,元大台灣價值高息,30,0,30,凱基-頭份,2024-09-12,9296
00937B,群益ESG投等債20,24,0,24,凱基-頭份,2024-09-12,9296
2887,台新金,19,0,19,凱基-頭份,2024-09-12,9296
00720B,元大投資級公司債,16,1,15,凱基-頭份,2024-09-12,9296
4931,新盛力,15,0,15,凱基-頭份,2024-09-12,9296
00919,群益台灣精選高息,25,10,15,凱基-頭份,2024-09-12,9296
00950B,凱基A級公司債,12,0,12,凱基-頭份,2024-09-12,9296
00918,大華優利高填息30,24,13,11,凱基-頭份,2024-09-12,9296
00688L,國泰20年美債正2,10,0,10,凱基-頭份,2024-09-12,9296
00686R,群益臺灣加權反1,10,0,10,凱基-頭份,2024-09-12,9296
3149,正達,15,5,10,凱基-頭份,2024-09-12,9296
5534,長虹,10,0,10,凱基-頭份,2024-09-12,9296
3550,聯穎,9,0,9,凱基-頭份,2024-09-12,9296
3491,昇達科,12,4,8,凱基-頭份,2024-09-12,9296
2364,倫飛,8,1,7,凱基-頭份,2024-09-12,9296
00931B,統一美債20年,6,0,6,凱基-頭份,2024-09-12,9296
3290,東浦,5,0,5,凱基-頭份,2024-09-12,9296
8096,擎亞,14,9,5,凱基-頭份,2024-09-12,9296
8111,立��,5,0,5,凱基-頭份,2024-09-12,9296
1584,精剛,5,1,4,凱基-頭份,2024-09-12,9296
2208,台船,4,0,4,凱基-頭份,2024-09-12,9296
3227,原相,7,3,4,凱基-頭份,2024-09-12,9296
5425,台半,5,1,4,凱基-頭份,2024-09-12,9296
9907,統一實,4,0,4,凱基-頭份,2024-09-12,9296
00878,國泰永續高股息,5,1,4,凱基-頭份,2024-09-12,9296
00891,中信關鍵半導體,3,0,3,凱基-頭份,2024-09-12,9296
2417,圓剛,3,0,3,凱基-頭份,2024-09-12,9296
2441,超豐,3,0,3,凱基-頭份,2024-09-12,9296
2449,京元電子,58,55,3,凱基-頭份,2024-09-12,9296
2867,三商壽,3,0,3,凱基-頭份,2024-09-12,9296
3189,景碩,3,0,3,凱基-頭份,2024-09-12,9296
3312,弘憶股,9,6,3,凱基-頭份,2024-09-12,9296
3360,尚立,3,0,3,凱基-頭份,2024-09-12,9296
3624,光頡,4,1,3,凱基-頭份,2024-09-12,9296
4935,茂林-KY,3,0,3,凱基-頭份,2024-09-12,9296
5345,天揚,3,0,3,凱基-頭份,2024-09-12,9296
6111,大宇資,3,0,3,凱基-頭份,2024-09-12,9296
6525,捷敏-KY,3,0,3,凱基-頭份,2024-09-12,9296
8249,菱光,5,2,3,凱基-頭份,2024-09-12,9296
1314,中石化,2,0,2,凱基-頭份,2024-09-12,9296
00751B,元大AAA至A公司債,2,0,2,凱基-頭份,2024-09-12,9296
2327,國巨,2,0,2,凱基-頭份,2024-09-12,9296
00933B,國泰10Y+金融債,2,0,2,凱基-頭份,2024-09-12,9296
00932,兆豐永續高息等權,2,0,2,凱基-頭份,2024-09-12,9296
1301,台塑,3,1,2,凱基-頭份,2024-09-12,9296
00937B,群益ESG投等債20,151,0,151,凱基-頭份,2024-09-13,9296
00918,大華優利高填息30,63,0,63,凱基-頭份,2024-09-13,9296
00929,復華台灣科技優息,72,10,62,凱基-頭份,2024-09-13,9296
00945B,凱基美國非投等債,40,0,40,凱基-頭份,2024-09-13,9296
3706,神達,60,32,28,凱基-頭份,2024-09-13,9296
2328,廣宇,27,0,27,凱基-頭份,2024-09-13,9296
2618,長榮航,30,4,26,凱基-頭份,2024-09-13,9296
00632R,元大台灣50反1,25,0,25,凱基-頭份,2024-09-13,9296
00959B,大華投等美債15Y+,20,0,20,凱基-頭份,2024-09-13,9296
2488,漢平,20,0,20,凱基-頭份,2024-09-13,9296
00687B,國泰20年美債,16,0,16,凱基-頭份,2024-09-13,9296
00637L,元大滬深300正2,17,2,15,凱基-頭份,2024-09-13,9296
00715L,期街口布蘭特正2,12,0,12,凱基-頭份,2024-09-13,9296
1305,華夏,20,8,12,凱基-頭份,2024-09-13,9296
00679B,元大美債20年,11,0,11,凱基-頭份,2024-09-13,9296
00946,群益科技高息成長,10,0,10,凱基-頭份,2024-09-13,9296
00919,群益台灣精選高息,9,0,9,凱基-頭份,2024-09-13,9296
9945,潤泰新,10,1,9,凱基-頭份,2024-09-13,9296
1708,東鹼,8,0,8,凱基-頭份,2024-09-13,9296
2609,陽明,9,1,8,凱基-頭份,2024-09-13,9296
5345,天揚,7,0,7,凱基-頭份,2024-09-13,9296
00878,國泰永續高股息,7,1,6,凱基-頭份,2024-09-13,9296
6532,瑞耘,6,0,6,凱基-頭份,2024-09-13,9296
2365,昆盈,11,6,5,凱基-頭份,2024-09-13,9296
1101,台泥,5,0,5,凱基-頭份,2024-09-13,9296
8937,合騏,6,1,5,凱基-頭份,2024-09-13,9296
1314,中石化,4,0,4,凱基-頭份,2024-09-13,9296
0056,元大高股息,5,1,4,凱基-頭份,2024-09-13,9296
00713,元大台灣高息低波,4,0,4,凱基-頭份,2024-09-13,9296
00692,富邦公司治理,4,0,4,凱基-頭份,2024-09-13,9296
00882,中信中國高股息,4,0,4,凱基-頭份,2024-09-13,9296
2383,台光電,4,0,4,凱基-頭份,2024-09-13,9296
3013,晟銘電,42,38,4,凱基-頭份,2024-09-13,9296
3230,錦明,4,0,4,凱基-頭份,2024-09-13,9296
6114,久威,4,0,4,凱基-頭份,2024-09-13,9296
6929,佑全,4,0,4,凱基-頭份,2024-09-13,9296
8070,長華*,4,0,4,凱基-頭份,2024-09-13,9296
2382,廣達,3,0,3,凱基-頭份,2024-09-13,9296
1584,精剛,3,0,3,凱基-頭份,2024-09-13,9296
2360,致茂,3,0,3,凱基-頭份,2024-09-13,9296
2515,中工,4,1,3,凱基-頭份,2024-09-13,9296
3550,聯穎,7,4,3,凱基-頭份,2024-09-13,9296
3605,宏致,3,0,3,凱基-頭份,2024-09-13,9296
4510,高鋒,6,3,3,凱基-頭份,2024-09-13,9296
4566,時碩工業,4,1,3,凱基-頭份,2024-09-13,9296
5534,長虹,6,3,3,凱基-頭份,2024-09-13,9296
6456,GIS-KY,3,0,3,凱基-頭份,2024-09-13,9296
6530,創威,4,1,3,凱基-頭份,2024-09-13,9296
6625,必應,3,0,3,凱基-頭份,2024-09-13,9296
8076,伍豐,3,0,3,凱基-頭份,2024-09-13,9296
00937B,群益ESG投等債20,123,4,119,凱基-頭份,2024-09-16,9296
00712,復華富時不動產,105,0,105,凱基-頭份,2024-09-16,9296
00929,復華台灣科技優息,79,19,60,凱基-頭份,2024-09-16,9296
00632R,元大台灣50反1,56,0,56,凱基-頭份,2024-09-16,9296
00688L,國泰20年美債正2,47,0,47,凱基-頭份,2024-09-16,9296
00687B,國泰20年美債,42,0,42,凱基-頭份,2024-09-16,9296
00942B,台新美A公司債20+,29,0,29,凱基-頭份,2024-09-16,9296
2515,中工,30,2,28,凱基-頭份,2024-09-16,9296
6116,彩晶,25,0,25,凱基-頭份,2024-09-16,9296
00952,凱基台灣AI50,20,0,20,凱基-頭份,2024-09-16,9296
00919,群益台灣精選高息,18,3,15,凱基-頭份,2024-09-16,9296
2382,廣達,14,0,14,凱基-頭份,2024-09-16,9296
2379,瑞昱,12,2,10,凱基-頭份,2024-09-16,9296
2442,新美齊,10,0,10,凱基-頭份,2024-09-16,9296
2618,長榮航,10,0,10,凱基-頭份,2024-09-16,9296
6133,金橋,11,1,10,凱基-頭份,2024-09-16,9296
00679B,元大美債20年,10,0,10,凱基-頭份,2024-09-16,9296
4989,榮科,9,0,9,凱基-頭份,2024-09-16,9296
6168,宏齊,8,0,8,凱基-頭份,2024-09-16,9296
2401,凌陽,7,0,7,凱基-頭份,2024-09-16,9296
5345,天揚,7,0,7,凱基-頭份,2024-09-16,9296
6530,創威,11,4,7,凱基-頭份,2024-09-16,9296
9906,欣巴巴,7,0,7,凱基-頭份,2024-09-16,9296
00936,台新永續高息中小,6,0,6,凱基-頭份,2024-09-16,9296
00713,元大台灣高息低波,6,0,6,凱基-頭份,2024-09-16,9296
00751B,元大AAA至A公司債,6,0,6,凱基-頭份,2024-09-16,9296
1540,喬福,10,4,6,凱基-頭份,2024-09-16,9296
2409,友達,18,12,6,凱基-頭份,2024-09-16,9296
3002,歐格,10,4,6,凱基-頭份,2024-09-16,9296
8054,安國,7,1,6,凱基-頭份,2024-09-16,9296
00933B,國泰10Y+金融債,5,0,5,凱基-頭份,2024-09-16,9296
3290,東浦,8,3,5,凱基-頭份,2024-09-16,9296
3484,崧騰,5,0,5,凱基-頭份,2024-09-16,9296
3673,TPK-KY,5,0,5,凱基-頭份,2024-09-16,9296
6108,競國,6,1,5,凱基-頭份,2024-09-16,9296
00857B,永豐20年美公債,4,0,4,凱基-頭份,2024-09-16,9296
2070,精湛,4,0,4,凱基-頭份,2024-09-16,9296
2337,旺宏,4,0,4,凱基-頭份,2024-09-16,9296
2349,錸德,15,11,4,凱基-頭份,2024-09-16,9296
4510,高鋒,46,42,4,凱基-頭份,2024-09-16,9296
4513,福裕,12,8,4,凱基-頭份,2024-09-16,9296
5230,雷笛克光學,4,0,4,凱基-頭份,2024-09-16,9296
00915,凱基優選高股息30,3,0,3,凱基-頭份,2024-09-16,9296
3491,昇達科,9,6,3,凱基-頭份,2024-09-16,9296
1444,力麗,3,0,3,凱基-頭份,2024-09-16,9296
1449,佳和,3,0,3,凱基-頭份,2024-09-16,9296
1608,華榮,3,0,3,凱基-頭份,2024-09-16,9296
1710,東聯,3,0,3,凱基-頭份,2024-09-16,9296
2360,致茂,3,0,3,凱基-頭份,2024-09-16,9296
2497,怡利電,5,2,3,凱基-頭份,2024-09-16,9296
00919,群益台灣精選高息,78,15,63,凱基-頭份,2024-09-18,9296
2887,台新金,36,0,36,凱基-頭份,2024-09-18,9296
00687B,國泰20年美債,33,0,33,凱基-頭份,2024-09-18,9296
00878,國泰永續高股息,32,0,32,凱基-頭份,2024-09-18,9296
00946,群益科技高息成長,35,7,28,凱基-頭份,2024-09-18,9296
3707,漢磊,14,1,13,凱基-頭份,2024-09-18,9296
2317,鴻海,12,0,12,凱基-頭份,2024-09-18,9296
00713,元大台灣高息低波,12,0,12,凱基-頭份,2024-09-18,9296
00918,大華優利高填息30,11,0,11,凱基-頭份,2024-09-18,9296
2367,燿華,12,1,11,凱基-頭份,2024-09-18,9296
8111,立��,14,3,11,凱基-頭份,2024-09-18,9296
0056,元大高股息,10,0,10,凱基-頭份,2024-09-18,9296
2486,一詮,25,15,10,凱基-頭份,2024-09-18,9296
00665L,富邦�琤肭磪囓�2,10,0,10,凱基-頭份,2024-09-18,9296
2338,光罩,10,0,10,凱基-頭份,2024-09-18,9296
2392,正崴,10,0,10,凱基-頭份,2024-09-18,9296
6264,富裔,10,0,10,凱基-頭份,2024-09-18,9296
8937,合騏,10,0,10,凱基-頭份,2024-09-18,9296
9105,泰金寶-DR,10,0,10,凱基-頭份,2024-09-18,9296
00937B,群益ESG投等債20,22,13,9,凱基-頭份,2024-09-18,9296
2344,華邦電,9,0,9,凱基-頭份,2024-09-18,9296
00915,凱基優選高股息30,8,0,8,凱基-頭份,2024-09-18,9296
00752,中信中國50,8,0,8,凱基-頭份,2024-09-18,9296
00881,國泰台灣5G+,8,0,8,凱基-頭份,2024-09-18,9296
4931,新盛力,8,0,8,凱基-頭份,2024-09-18,9296
2481,強茂,7,0,7,凱基-頭份,2024-09-18,9296
00679B,元大美債20年,6,0,6,凱基-頭份,2024-09-18,9296
00921,兆豐龍頭等權重,6,0,6,凱基-頭份,2024-09-18,9296
2374,佳能,6,0,6,凱基-頭份,2024-09-18,9296
2449,京元電子,6,0,6,凱基-頭份,2024-09-18,9296
2634,漢翔,6,0,6,凱基-頭份,2024-09-18,9296
5230,雷笛克光學,6,0,6,凱基-頭份,2024-09-18,9296
6492,生華科,6,0,6,凱基-頭份,2024-09-18,9296
00936,台新永續高息中小,5,0,5,凱基-頭份,2024-09-18,9296
1522,堤維西,5,0,5,凱基-頭份,2024-09-18,9296
1582,信錦,8,3,5,凱基-頭份,2024-09-18,9296
2323,中環,5,0,5,凱基-頭份,2024-09-18,9296
2356,英業達,5,0,5,凱基-頭份,2024-09-18,9296
4540,全球傳動,5,0,5,凱基-頭份,2024-09-18,9296
5243,乙盛-KY,9,4,5,凱基-頭份,2024-09-18,9296
6274,台燿,5,0,5,凱基-頭份,2024-09-18,9296
00891,中信關鍵半導體,4,0,4,凱基-頭份,2024-09-18,9296
00706L,期元大S＆P日圓正2,4,0,4,凱基-頭份,2024-09-18,9296
00688L,國泰20年美債正2,4,0,4,凱基-頭份,2024-09-18,9296
00952,凱基台灣AI50,4,0,4,凱基-頭份,2024-09-18,9296
1444,力麗,4,0,4,凱基-頭份,2024-09-18,9296
2417,圓剛,4,0,4,凱基-頭份,2024-09-18,9296
2603,長榮,6,2,4,凱基-頭份,2024-09-18,9296
3260,威剛,4,0,4,凱基-頭份,2024-09-18,9296
3607,谷崧,4,0,4,凱基-頭份,2024-09-18,9296
00857B,永豐20年美公債,2496,100,2396,凱基-頭份,2024-09-19,9296
00632R,元大台灣50反1,362,101,261,凱基-頭份,2024-09-19,9296
00929,復華台灣科技優息,162,2,160,凱基-頭份,2024-09-19,9296
00712,復華富時不動產,100,0,100,凱基-頭份,2024-09-19,9296
00650L,復華香港正2,50,0,50,凱基-頭份,2024-09-19,9296
00687B,國泰20年美債,69,20,49,凱基-頭份,2024-09-19,9296
00882,中信中國高股息,47,1,46,凱基-頭份,2024-09-19,9296
00688L,國泰20年美債正2,39,0,39,凱基-頭份,2024-09-19,9296
00679B,元大美債20年,34,1,33,凱基-頭份,2024-09-19,9296
00706L,期元大S＆P日圓正2,29,0,29,凱基-頭份,2024-09-19,9296
2891,中信金,28,0,28,凱基-頭份,2024-09-19,9296
00915,凱基優選高股息30,26,0,26,凱基-頭份,2024-09-19,9296
8070,長華*,30,8,22,凱基-頭份,2024-09-19,9296
00942B,台新美A公司債20+,20,0,20,凱基-頭份,2024-09-19,9296
2312,金寶,20,0,20,凱基-頭份,2024-09-19,9296
2610,華航,20,2,18,凱基-頭份,2024-09-19,9296
00671R,富邦NASDAQ反1,15,0,15,凱基-頭份,2024-09-19,9296
00669R,國泰美國道瓊反1,15,0,15,凱基-頭份,2024-09-19,9296
00664R,國泰臺灣加權反1,15,0,15,凱基-頭份,2024-09-19,9296
2349,錸德,15,1,14,凱基-頭份,2024-09-19,9296
1776,展宇,11,0,11,凱基-頭份,2024-09-19,9296
3049,精金,19,8,11,凱基-頭份,2024-09-19,9296
4726,永昕,11,0,11,凱基-頭份,2024-09-19,9296
2399,映泰,21,11,10,凱基-頭份,2024-09-19,9296
3663,鑫科,10,0,10,凱基-頭份,2024-09-19,9296
6530,創威,14,4,10,凱基-頭份,2024-09-19,9296
3149,正達,12,3,9,凱基-頭份,2024-09-19,9296
6264,富裔,8,0,8,凱基-頭份,2024-09-19,9296
00878,國泰永續高股息,7,0,7,凱基-頭份,2024-09-19,9296
2449,京元電子,9,2,7,凱基-頭份,2024-09-19,9296
3013,晟銘電,28,21,7,凱基-頭份,2024-09-19,9296
5460,同協,7,0,7,凱基-頭份,2024-09-19,9296
00713,元大台灣高息低波,11,5,6,凱基-頭份,2024-09-19,9296
5234,達興材料,14,8,6,凱基-頭份,2024-09-19,9296
1514,亞力,6,0,6,凱基-頭份,2024-09-19,9296
00927,群益半導體收益,7,2,5,凱基-頭份,2024-09-19,9296
00948B,中信優息投資級債,5,0,5,凱基-頭份,2024-09-19,9296
00958B,永豐ESG銀行債15,5,0,5,凱基-頭份,2024-09-19,9296
1301,台塑,5,0,5,凱基-頭份,2024-09-19,9296
5425,台半,5,0,5,凱基-頭份,2024-09-19,9296
6698,旭暉應材,7,2,5,凱基-頭份,2024-09-19,9296
6416,瑞祺電通,5,0,5,凱基-頭份,2024-09-19,9296
6770,力積電,5,0,5,凱基-頭份,2024-09-19,9296
2542,興富發,4,0,4,凱基-頭份,2024-09-19,9296
3550,聯穎,10,6,4,凱基-頭份,2024-09-19,9296
4903,聯光通,15,11,4,凱基-頭份,2024-09-19,9296
5345,天揚,4,0,4,凱基-頭份,2024-09-19,9296
6215,和椿,5,1,4,凱基-頭份,2024-09-19,9296
6605,帝寶,4,0,4,凱基-頭份,2024-09-19,9296
8028,昇陽半導體,8,4,4,凱基-頭份,2024-09-19,9296
00764B,群益25年美債,1947,0,1947,凱基-頭份,2024-09-20,9296
00650L,復華香港正2,200,0,200,凱基-頭份,2024-09-20,9296
2349,錸德,131,34,97,凱基-頭份,2024-09-20,9296
6264,富裔,40,0,40,凱基-頭份,2024-09-20,9296
2464,盟立,61,23,38,凱基-頭份,2024-09-20,9296
00882,中信中國高股息,35,2,33,凱基-頭份,2024-09-20,9296
00929,復華台灣科技優息,35,8,27,凱基-頭份,2024-09-20,9296
00878,國泰永續高股息,23,3,20,凱基-頭份,2024-09-20,9296
2606,裕民,20,0,20,凱基-頭份,2024-09-20,9296
00720B,元大投資級公司債,18,0,18,凱基-頭份,2024-09-20,9296
5213,亞昕,23,5,18,凱基-頭份,2024-09-20,9296
00679B,元大美債20年,17,0,17,凱基-頭份,2024-09-20,9296
4707,磐亞,20,5,15,凱基-頭份,2024-09-20,9296
00637L,元大滬深300正2,12,0,12,凱基-頭份,2024-09-20,9296
00664R,國泰臺灣加權反1,10,0,10,凱基-頭份,2024-09-20,9296
00958B,永豐ESG銀行債15,10,0,10,凱基-頭份,2024-09-20,9296
1618,合機,10,0,10,凱基-頭份,2024-09-20,9296
3306,鼎天,10,0,10,凱基-頭份,2024-09-20,9296
00687B,國泰20年美債,14,5,9,凱基-頭份,2024-09-20,9296
2515,中工,9,0,9,凱基-頭份,2024-09-20,9296
5905,南仁湖,9,0,9,凱基-頭份,2024-09-20,9296
6125,廣運,10,1,9,凱基-頭份,2024-09-20,9296
1539,巨庭,10,2,8,凱基-頭份,2024-09-20,9296
2545,皇翔,7,0,7,凱基-頭份,2024-09-20,9296
4513,福裕,16,9,7,凱基-頭份,2024-09-20,9296
4526,東台,15,8,7,凱基-頭份,2024-09-20,9296
4924,欣厚-KY,7,0,7,凱基-頭份,2024-09-20,9296
4977,眾達-KY,10,3,7,凱基-頭份,2024-09-20,9296
8064,東捷,10,3,7,凱基-頭份,2024-09-20,9296
00915,凱基優選高股息30,9,3,6,凱基-頭份,2024-09-20,9296
3491,昇達科,16,10,6,凱基-頭份,2024-09-20,9296
2303,聯電,6,0,6,凱基-頭份,2024-09-20,9296
2867,三商壽,14,8,6,凱基-頭份,2024-09-20,9296
3049,精金,8,2,6,凱基-頭份,2024-09-20,9296
3511,矽瑪,6,0,6,凱基-頭份,2024-09-20,9296
5243,乙盛-KY,6,0,6,凱基-頭份,2024-09-20,9296
6219,富旺,6,0,6,凱基-頭份,2024-09-20,9296
00713,元大台灣高息低波,8,2,6,凱基-頭份,2024-09-20,9296
6104,創惟,15,10,5,凱基-頭份,2024-09-20,9296
00927,群益半導體收益,5,0,5,凱基-頭份,2024-09-20,9296
00673R,期元大S＆P原油反1,5,0,5,凱基-頭份,2024-09-20,9296
00669R,國泰美國道瓊反1,5,0,5,凱基-頭份,2024-09-20,9296
00942B,台新美A公司債20+,5,0,5,凱基-頭份,2024-09-20,9296
1589,永冠-KY,5,0,5,凱基-頭份,2024-09-20,9296
2539,櫻花建,5,0,5,凱基-頭份,2024-09-20,9296
5465,富驊,5,0,5,凱基-頭份,2024-09-20,9296
006208,富邦台50,5,0,5,凱基-頭份,2024-09-20,9296
5880,合庫金,4,0,4,凱基-頭份,2024-09-20,9296
00919,群益台灣精選高息,10,6,4,凱基-頭份,2024-09-20,9296
1314,中石化,5,1,4,凱基-頭份,2024-09-20,9296
2883,凱基金,3810,0,3810,凱基-頭份,2024-09-23,9296
00650L,復華香港正2,210,0,210,凱基-頭份,2024-09-23,9296
00933B,國泰10Y+金融債,103,6,97,凱基-頭份,2024-09-23,9296
00919,群益台灣精選高息,63,1,62,凱基-頭份,2024-09-23,9296
00940,元大台灣價值高息,61,6,55,凱基-頭份,2024-09-23,9296
2888,新光金,59,4,55,凱基-頭份,2024-09-23,9296
00929,復華台灣科技優息,143,102,41,凱基-頭份,2024-09-23,9296
00878,國泰永續高股息,39,2,37,凱基-頭份,2024-09-23,9296
2477,美隆電,30,0,30,凱基-頭份,2024-09-23,9296
6770,力積電,30,1,29,凱基-頭份,2024-09-23,9296
00942B,台新美A公司債20+,25,0,25,凱基-頭份,2024-09-23,9296
00687B,國泰20年美債,23,1,22,凱基-頭份,2024-09-23,9296
4931,新盛力,22,0,22,凱基-頭份,2024-09-23,9296
00937B,群益ESG投等債20,53,32,21,凱基-頭份,2024-09-23,9296
00632R,元大台灣50反1,20,0,20,凱基-頭份,2024-09-23,9296
3356,奇偶,20,0,20,凱基-頭份,2024-09-23,9296
00706L,期元大S＆P日圓正2,19,0,19,凱基-頭份,2024-09-23,9296
2007,燁興,19,0,19,凱基-頭份,2024-09-23,9296
00679B,元大美債20年,20,2,18,凱基-頭份,2024-09-23,9296
2867,三商壽,14,0,14,凱基-頭份,2024-09-23,9296
2425,承啟,12,0,12,凱基-頭份,2024-09-23,9296
1314,中石化,12,1,11,凱基-頭份,2024-09-23,9296
4909,新復興,13,2,11,凱基-頭份,2024-09-23,9296
00664R,國泰臺灣加權反1,10,0,10,凱基-頭份,2024-09-23,9296
8064,東捷,32,22,10,凱基-頭份,2024-09-23,9296
2399,映泰,11,2,9,凱基-頭份,2024-09-23,9296
8033,雷虎,8,0,8,凱基-頭份,2024-09-23,9296
2312,金寶,10,2,8,凱基-頭份,2024-09-23,9296
00882,中信中國高股息,10,3,7,凱基-頭份,2024-09-23,9296
2609,陽明,8,1,7,凱基-頭份,2024-09-23,9296
00715L,期街口布蘭特正2,6,0,6,凱基-頭份,2024-09-23,9296
00960,野村全球航運龍頭,6,0,6,凱基-頭份,2024-09-23,9296
1582,信錦,7,1,6,凱基-頭份,2024-09-23,9296
2317,鴻海,7,1,6,凱基-頭份,2024-09-23,9296
3491,昇達科,9,3,6,凱基-頭份,2024-09-23,9296
1785,光洋科,7,1,6,凱基-頭份,2024-09-23,9296
3227,原相,6,1,5,凱基-頭份,2024-09-23,9296
4157,太景*-KY,5,0,5,凱基-頭份,2024-09-23,9296
6139,亞翔,5,0,5,凱基-頭份,2024-09-23,9296
6177,達麗,5,0,5,凱基-頭份,2024-09-23,9296
00930,永豐ESG低碳高息,4,0,4,凱基-頭份,2024-09-23,9296
1721,三晃,16,12,4,凱基-頭份,2024-09-23,9296
2349,錸德,16,12,4,凱基-頭份,2024-09-23,9296
4162,智擎,4,0,4,凱基-頭份,2024-09-23,9296
4526,東台,4,0,4,凱基-頭份,2024-09-23,9296
4562,穎漢,6,2,4,凱基-頭份,2024-09-23,9296
4924,欣厚-KY,4,0,4,凱基-頭份,2024-09-23,9296
9958,世紀鋼,8,4,4,凱基-頭份,2024-09-23,9296
2449,京元電子,4,1,3,凱基-頭份,2024-09-23,9296
3450,聯鈞,14,11,3,凱基-頭份,2024-09-23,9296
2801,彰銀,101,0,101,凱基-頭份,2024-09-24,9296
00650L,復華香港正2,30,0,30,凱基-頭份,2024-09-24,9296
00937B,群益ESG投等債20,36,11,25,凱基-頭份,2024-09-24,9296
1714,和桐,20,0,20,凱基-頭份,2024-09-24,9296
2641,正德,20,0,20,凱基-頭份,2024-09-24,9296
00632R,元大台灣50反1,16,0,16,凱基-頭份,2024-09-24,9296
2867,三商壽,14,0,14,凱基-頭份,2024-09-24,9296
6264,富裔,14,0,14,凱基-頭份,2024-09-24,9296
2913,農林,12,0,12,凱基-頭份,2024-09-24,9296
0056,元大高股息,12,1,11,凱基-頭份,2024-09-24,9296
3062,建漢,11,0,11,凱基-頭份,2024-09-24,9296
3234,光環,11,0,11,凱基-頭份,2024-09-24,9296
00679B,元大美債20年,10,0,10,凱基-頭份,2024-09-24,9296
00942B,台新美A公司債20+,10,0,10,凱基-頭份,2024-09-24,9296
1514,亞力,10,0,10,凱基-頭份,2024-09-24,9296
2441,超豐,10,0,10,凱基-頭份,2024-09-24,9296
4989,榮科,10,0,10,凱基-頭份,2024-09-24,9296
6698,旭暉應材,10,0,10,凱基-頭份,2024-09-24,9296
9946,三發地產,10,0,10,凱基-頭份,2024-09-24,9296
00919,群益台灣精選高息,11,1,10,凱基-頭份,2024-09-24,9296
2481,強茂,11,2,9,凱基-頭份,2024-09-24,9296
2891,中信金,11,3,8,凱基-頭份,2024-09-24,9296
1727,中華化,8,0,8,凱基-頭份,2024-09-24,9296
2388,威盛,10,3,7,凱基-頭份,2024-09-24,9296
00687B,國泰20年美債,8,1,7,凱基-頭份,2024-09-24,9296
00712,復華富時不動產,7,0,7,凱基-頭份,2024-09-24,9296
1539,巨庭,6,0,6,凱基-頭份,2024-09-24,9296
2349,錸德,13,7,6,凱基-頭份,2024-09-24,9296
2497,怡利電,8,2,6,凱基-頭份,2024-09-24,9296
3149,正達,11,5,6,凱基-頭份,2024-09-24,9296
5460,同協,6,0,6,凱基-頭份,2024-09-24,9296
6104,創惟,6,0,6,凱基-頭份,2024-09-24,9296
6492,生華科,6,0,6,凱基-頭份,2024-09-24,9296
2356,英業達,16,10,6,凱基-頭份,2024-09-24,9296
3374,精材,21,16,5,凱基-頭份,2024-09-24,9296
00945B,凱基美國非投等債,5,0,5,凱基-頭份,2024-09-24,9296
00752,中信中國50,5,0,5,凱基-頭份,2024-09-24,9296
00669R,國泰美國道瓊反1,5,0,5,凱基-頭份,2024-09-24,9296
1304,台聚,5,0,5,凱基-頭份,2024-09-24,9296
1582,信錦,7,2,5,凱基-頭份,2024-09-24,9296
3037,欣興,5,0,5,凱基-頭份,2024-09-24,9296
9958,世紀鋼,6,1,5,凱基-頭份,2024-09-24,9296
00690,兆豐藍籌30,4,0,4,凱基-頭份,2024-09-24,9296
1513,中興電,5,1,4,凱基-頭份,2024-09-24,9296
2062,橋椿,5,1,4,凱基-頭份,2024-09-24,9296
2915,潤泰全,4,0,4,凱基-頭份,2024-09-24,9296
3673,TPK-KY,5,1,4,凱基-頭份,2024-09-24,9296
4526,東台,10,6,4,凱基-頭份,2024-09-24,9296
4909,新復興,9,5,4,凱基-頭份,2024-09-24,9296
8027,鈦昇,6,2,4,凱基-頭份,2024-09-24,9296
2609,陽明,130,49,81,凱基-頭份,2024-09-25,9296
00650L,復華香港正2,57,2,55,凱基-頭份,2024-09-25,9296
3062,建漢,50,3,47,凱基-頭份,2024-09-25,9296
00665L,富邦�琤肭磪囓�2,122,80,42,凱基-頭份,2024-09-25,9296
00664R,國泰臺灣加權反1,25,0,25,凱基-頭份,2024-09-25,9296
00795B,中信美國公債20年,20,0,20,凱基-頭份,2024-09-25,9296
2641,正德,20,0,20,凱基-頭份,2024-09-25,9296
00753L,中信中國50正2,18,0,18,凱基-頭份,2024-09-25,9296
5871,中租-KY,20,3,17,凱基-頭份,2024-09-25,9296
0056,元大高股息,18,2,16,凱基-頭份,2024-09-25,9296
00669R,國泰美國道瓊反1,15,0,15,凱基-頭份,2024-09-25,9296
3356,奇偶,15,0,15,凱基-頭份,2024-09-25,9296
3047,訊舟,22,9,13,凱基-頭份,2024-09-25,9296
6215,和椿,18,6,12,凱基-頭份,2024-09-25,9296
1584,精剛,12,1,11,凱基-頭份,2024-09-25,9296
3710,連展投控,11,0,11,凱基-頭份,2024-09-25,9296
00687B,國泰20年美債,10,0,10,凱基-頭份,2024-09-25,9296
00715L,期街口布蘭特正2,10,0,10,凱基-頭份,2024-09-25,9296
1301,台塑,10,0,10,凱基-頭份,2024-09-25,9296
2426,鼎元,10,0,10,凱基-頭份,2024-09-25,9296
2636,台驊控股,10,0,10,凱基-頭份,2024-09-25,9296
00679B,元大美債20年,13,3,10,凱基-頭份,2024-09-25,9296
00927,群益半導體收益,8,0,8,凱基-頭份,2024-09-25,9296
6733,博晟生醫,8,0,8,凱基-頭份,2024-09-25,9296
00931B,統一美債20年,6,0,6,凱基-頭份,2024-09-25,9296
1524,耿鼎,8,2,6,凱基-頭份,2024-09-25,9296
2388,威盛,6,0,6,凱基-頭份,2024-09-25,9296
2449,京元電子,9,3,6,凱基-頭份,2024-09-25,9296
4977,眾達-KY,7,1,6,凱基-頭份,2024-09-25,9296
6279,胡連,6,0,6,凱基-頭份,2024-09-25,9296
00919,群益台灣精選高息,6,0,6,凱基-頭份,2024-09-25,9296
1319,東陽,5,0,5,凱基-頭份,2024-09-25,9296
2243,宏旭-KY,5,0,5,凱基-頭份,2024-09-25,9296
2355,敬鵬,5,0,5,凱基-頭份,2024-09-25,9296
2613,中櫃,5,0,5,凱基-頭份,2024-09-25,9296
2809,京城銀,6,1,5,凱基-頭份,2024-09-25,9296
2867,三商壽,5,0,5,凱基-頭份,2024-09-25,9296
3045,台灣大,5,0,5,凱基-頭份,2024-09-25,9296
3518,柏騰,5,0,5,凱基-頭份,2024-09-25,9296
3548,兆利,6,1,5,凱基-頭份,2024-09-25,9296
4510,高鋒,15,10,5,凱基-頭份,2024-09-25,9296
9904,寶成,5,0,5,凱基-頭份,2024-09-25,9296
00960,野村全球航運龍頭,6,2,4,凱基-頭份,2024-09-25,9296
2353,宏��,5,1,4,凱基-頭份,2024-09-25,9296
2542,興富發,5,1,4,凱基-頭份,2024-09-25,9296
3522,御嵿,4,0,4,凱基-頭份,2024-09-25,9296
6213,聯茂,4,0,4,凱基-頭份,2024-09-25,9296
6139,亞翔,3,0,3,凱基-頭份,2024-09-25,9296
00923,群益台ESG低碳50,3,0,3,凱基-頭份,2024-09-25,9296
00692,富邦公司治理,3,0,3,凱基-頭份,2024-09-25,9296
2891,中信金,249,13,236,凱基-頭份,2024-09-26,9296
00665L,富邦�琤肭磪囓�2,200,42,158,凱基-頭份,2024-09-26,9296
00882,中信中國高股息,133,1,132,凱基-頭份,2024-09-26,9296
00650L,復華香港正2,101,0,101,凱基-頭份,2024-09-26,9296
00937B,群益ESG投等債20,96,27,69,凱基-頭份,2024-09-26,9296
3706,神達,65,0,65,凱基-頭份,2024-09-26,9296
1909,榮成,40,0,40,凱基-頭份,2024-09-26,9296
00690,兆豐藍籌30,32,0,32,凱基-頭份,2024-09-26,9296
2317,鴻海,31,3,28,凱基-頭份,2024-09-26,9296
2344,華邦電,137,110,27,凱基-頭份,2024-09-26,9296
00960,野村全球航運龍頭,130,105,25,凱基-頭份,2024-09-26,9296
2867,三商壽,54,31,23,凱基-頭份,2024-09-26,9296
2062,橋椿,20,0,20,凱基-頭份,2024-09-26,9296
3710,連展投控,20,0,20,凱基-頭份,2024-09-26,9296
3047,訊舟,26,10,16,凱基-頭份,2024-09-26,9296
00671R,富邦NASDAQ反1,15,0,15,凱基-頭份,2024-09-26,9296
00942B,台新美A公司債20+,15,0,15,凱基-頭份,2024-09-26,9296
1785,光洋科,13,0,13,凱基-頭份,2024-09-26,9296
00679B,元大美債20年,13,1,12,凱基-頭份,2024-09-26,9296
0056,元大高股息,15,3,12,凱基-頭份,2024-09-26,9296
00688L,國泰20年美債正2,12,0,12,凱基-頭份,2024-09-26,9296
00948B,中信優息投資級債,11,0,11,凱基-頭份,2024-09-26,9296
2352,佳世達,10,0,10,凱基-頭份,2024-09-26,9296
3209,全科,10,0,10,凱基-頭份,2024-09-26,9296
6163,華電網,10,0,10,凱基-頭份,2024-09-26,9296
8076,伍豐,13,3,10,凱基-頭份,2024-09-26,9296
3715,定穎投控,17,8,9,凱基-頭份,2024-09-26,9296
6923,中台,9,0,9,凱基-頭份,2024-09-26,9296
00687B,國泰20年美債,22,13,9,凱基-頭份,2024-09-26,9296
00885,富邦越南,10,2,8,凱基-頭份,2024-09-26,9296
00933B,國泰10Y+金融債,8,0,8,凱基-頭份,2024-09-26,9296
00795B,中信美國公債20年,7,0,7,凱基-頭份,2024-09-26,9296
4909,新復興,12,5,7,凱基-頭份,2024-09-26,9296
2436,偉詮電,9,2,7,凱基-頭份,2024-09-26,9296
1805,寶徠,7,0,7,凱基-頭份,2024-09-26,9296
2356,英業達,14,7,7,凱基-頭份,2024-09-26,9296
3062,建漢,7,0,7,凱基-頭份,2024-09-26,9296
6763,綠界科技*,6,0,6,凱基-頭份,2024-09-26,9296
3048,益登,6,0,6,凱基-頭份,2024-09-26,9296
6257,矽格,6,0,6,凱基-頭份,2024-09-26,9296
4968,立積,8,3,5,凱基-頭份,2024-09-26,9296
2365,昆盈,43,38,5,凱基-頭份,2024-09-26,9296
2368,金像電,15,10,5,凱基-頭份,2024-09-26,9296
2441,超豐,5,0,5,凱基-頭份,2024-09-26,9296
4931,新盛力,5,0,5,凱基-頭份,2024-09-26,9296
5345,天揚,5,0,5,凱基-頭份,2024-09-26,9296
6125,廣運,5,0,5,凱基-頭份,2024-09-26,9296
8021,尖點,5,0,5,凱基-頭份,2024-09-26,9296
00929,復華台灣科技優息,11,7,4,凱基-頭份,2024-09-26,9296
00931B,統一美債20年,4,0,4,凱基-頭份,2024-09-26,9296
2014,中鴻,306,1,305,凱基-頭份,2024-09-27,9296
5871,中租-KY,301,27,274,凱基-頭份,2024-09-27,9296
00752,中信中國50,226,4,222,凱基-頭份,2024-09-27,9296
00878,國泰永續高股息,141,1,140,凱基-頭份,2024-09-27,9296
2344,華邦電,90,6,84,凱基-頭份,2024-09-27,9296
00665L,富邦�琤肭磪囓�2,240,160,80,凱基-頭份,2024-09-27,9296
00687B,國泰20年美債,71,10,61,凱基-頭份,2024-09-27,9296
00715L,期街口布蘭特正2,53,0,53,凱基-頭份,2024-09-27,9296
00706L,期元大S＆P日圓正2,46,0,46,凱基-頭份,2024-09-27,9296
00937B,群益ESG投等債20,62,20,42,凱基-頭份,2024-09-27,9296
6573,虹揚-KY,18,0,18,凱基-頭份,2024-09-27,9296
00933B,國泰10Y+金融債,20,3,17,凱基-頭份,2024-09-27,9296
00942B,台新美A公司債20+,17,0,17,凱基-頭份,2024-09-27,9296
3706,神達,17,0,17,凱基-頭份,2024-09-27,9296
4903,聯光通,16,0,16,凱基-頭份,2024-09-27,9296
6125,廣運,54,38,16,凱基-頭份,2024-09-27,9296
00631L,元大台灣50正2,15,0,15,凱基-頭份,2024-09-27,9296
00919,群益台灣精選高息,15,2,13,凱基-頭份,2024-09-27,9296
1733,五鼎,12,0,12,凱基-頭份,2024-09-27,9296
4909,新復興,17,5,12,凱基-頭份,2024-09-27,9296
4532,瑞智,11,0,11,凱基-頭份,2024-09-27,9296
2613,中櫃,11,0,11,凱基-頭份,2024-09-27,9296
00642U,期元大S＆P石油,10,0,10,凱基-頭份,2024-09-27,9296
00891,中信關鍵半導體,10,0,10,凱基-頭份,2024-09-27,9296
2515,中工,10,0,10,凱基-頭份,2024-09-27,9296
0056,元大高股息,12,3,9,凱基-頭份,2024-09-27,9296
3605,宏致,7,0,7,凱基-頭份,2024-09-27,9296
00881,國泰台灣5G+,7,0,7,凱基-頭份,2024-09-27,9296
2388,威盛,9,3,6,凱基-頭份,2024-09-27,9296
1762,中化生,6,0,6,凱基-頭份,2024-09-27,9296
4198,欣大健康,6,0,6,凱基-頭份,2024-09-27,9296
4542,科嶠,6,0,6,凱基-頭份,2024-09-27,9296
4979,華星光,12,6,6,凱基-頭份,2024-09-27,9296
5243,乙盛-KY,6,0,6,凱基-頭份,2024-09-27,9296
8937,合騏,6,0,6,凱基-頭份,2024-09-27,9296
00712,復華富時不動產,5,0,5,凱基-頭份,2024-09-27,9296
2486,一詮,6,1,5,凱基-頭份,2024-09-27,9296
1540,喬福,6,1,5,凱基-頭份,2024-09-27,9296
2313,華通,5,0,5,凱基-頭份,2024-09-27,9296
3019,亞光,24,19,5,凱基-頭份,2024-09-27,9296
3356,奇偶,6,1,5,凱基-頭份,2024-09-27,9296
6733,博晟生醫,5,0,5,凱基-頭份,2024-09-27,9296
6873,泓德能源,15,10,5,凱基-頭份,2024-09-27,9296
8054,安國,6,1,5,凱基-頭份,2024-09-27,9296
8076,伍豐,5,0,5,凱基-頭份,2024-09-27,9296
00915,凱基優選高股息30,5,0,5,凱基-頭份,2024-09-27,9296
2605,新興,15,11,4,凱基-頭份,2024-09-27,9296
1539,巨庭,4,0,4,凱基-頭份,2024-09-27,9296
2070,精湛,5,1,4,凱基-頭份,2024-09-27,9296
2609,陽明,35,31,4,凱基-頭份,2024-09-27,9296
2867,三商壽,58,0,58,凱基-頭份,2024-09-30,9296
00937B,群益ESG投等債20,57,0,57,凱基-頭份,2024-09-30,9296
00929,復華台灣科技優息,55,1,54,凱基-頭份,2024-09-30,9296
2349,錸德,45,3,42,凱基-頭份,2024-09-30,9296
00882,中信中國高股息,74,40,34,凱基-頭份,2024-09-30,9296
3706,神達,31,0,31,凱基-頭份,2024-09-30,9296
00952,凱基台灣AI50,24,0,24,凱基-頭份,2024-09-30,9296
1909,榮成,25,1,24,凱基-頭份,2024-09-30,9296
00878,國泰永續高股息,28,4,24,凱基-頭份,2024-09-30,9296
2323,中環,20,0,20,凱基-頭份,2024-09-30,9296
2615,萬海,33,16,17,凱基-頭份,2024-09-30,9296
0056,元大高股息,16,0,16,凱基-頭份,2024-09-30,9296
2382,廣達,23,8,15,凱基-頭份,2024-09-30,9296
2312,金寶,15,0,15,凱基-頭份,2024-09-30,9296
2330,台積電,15,0,15,凱基-頭份,2024-09-30,9296
00687B,國泰20年美債,20,6,14,凱基-頭份,2024-09-30,9296
006207,復華滬深,13,0,13,凱基-頭份,2024-09-30,9296
00891,中信關鍵半導體,12,0,12,凱基-頭份,2024-09-30,9296
00881,國泰台灣5G+,12,0,12,凱基-頭份,2024-09-30,9296
00700,富邦�琤肭磪�,12,0,12,凱基-頭份,2024-09-30,9296
4532,瑞智,11,0,11,凱基-頭份,2024-09-30,9296
00919,群益台灣精選高息,49,38,11,凱基-頭份,2024-09-30,9296
00720B,元大投資級公司債,10,0,10,凱基-頭份,2024-09-30,9296
00636,國泰中國A50,10,0,10,凱基-頭份,2024-09-30,9296
00932,兆豐永續高息等權,10,0,10,凱基-頭份,2024-09-30,9296
00953B,群益優選非投等債,10,0,10,凱基-頭份,2024-09-30,9296
6505,台塑化,10,0,10,凱基-頭份,2024-09-30,9296
6530,創威,24,14,10,凱基-頭份,2024-09-30,9296
8403,盛弘,10,0,10,凱基-頭份,2024-09-30,9296
006208,富邦台50,9,0,9,凱基-頭份,2024-09-30,9296
2362,藍天,9,0,9,凱基-頭份,2024-09-30,9296
2344,華邦電,18,10,8,凱基-頭份,2024-09-30,9296
1733,五鼎,8,0,8,凱基-頭份,2024-09-30,9296
2313,華通,8,1,7,凱基-頭份,2024-09-30,9296
6733,博晟生醫,7,0,7,凱基-頭份,2024-09-30,9296
6838,台新藥,7,0,7,凱基-頭份,2024-09-30,9296
2353,宏��,6,0,6,凱基-頭份,2024-09-30,9296
2464,盟立,11,5,6,凱基-頭份,2024-09-30,9296
4906,正文,6,0,6,凱基-頭份,2024-09-30,9296
5905,南仁湖,6,0,6,凱基-頭份,2024-09-30,9296
6125,廣運,6,0,6,凱基-頭份,2024-09-30,9296
00692,富邦公司治理,6,0,6,凱基-頭份,2024-09-30,9296
00795B,中信美國公債20年,5,0,5,凱基-頭份,2024-09-30,9296
00669R,國泰美國道瓊反1,5,0,5,凱基-頭份,2024-09-30,9296
00923,群益台ESG低碳50,5,0,5,凱基-頭份,2024-09-30,9296
2009,第一銅,5,0,5,凱基-頭份,2024-09-30,9296
2368,金像電,5,0,5,凱基-頭份,2024-09-30,9296
2547,日勝生,5,0,5,凱基-頭份,2024-09-30,9296
2613,中櫃,5,0,5,凱基-頭份,2024-09-30,9296
2897B,王道銀乙特,5,0,5,凱基-頭份,2024-09-30,9296
00650L,復華香港正2,149,0,149,凱基-頭份,2024-10-01,9296
00665L,富邦�琤肭磪囓�2,162,80,82,凱基-頭份,2024-10-01,9296
00929,復華台灣科技優息,71,0,71,凱基-頭份,2024-10-01,9296
00687B,國泰20年美債,71,0,71,凱基-頭份,2024-10-01,9296
2025,千興,50,0,50,凱基-頭份,2024-10-01,9296
2388,威盛,51,2,49,凱基-頭份,2024-10-01,9296
0056,元大高股息,47,0,47,凱基-頭份,2024-10-01,9296
8068,全達,35,0,35,凱基-頭份,2024-10-01,9296
00706L,期元大S＆P日圓正2,31,0,31,凱基-頭份,2024-10-01,9296
2344,華邦電,26,3,23,凱基-頭份,2024-10-01,9296
1909,榮成,20,0,20,凱基-頭份,2024-10-01,9296
3481,群創,25,6,19,凱基-頭份,2024-10-01,9296
2867,三商壽,13,0,13,凱基-頭份,2024-10-01,9296
00878,國泰永續高股息,12,0,12,凱基-頭份,2024-10-01,9296
6770,力積電,15,4,11,凱基-頭份,2024-10-01,9296
00922,國泰台灣領袖50,11,0,11,凱基-頭份,2024-10-01,9296
00946,群益科技高息成長,10,0,10,凱基-頭份,2024-10-01,9296
00931B,統一美債20年,10,0,10,凱基-頭份,2024-10-01,9296
00887,永豐中國科技50大,10,0,10,凱基-頭份,2024-10-01,9296
6548,長科*,10,0,10,凱基-頭份,2024-10-01,9296
8110,華東,10,0,10,凱基-頭份,2024-10-01,9296
8937,合騏,10,0,10,凱基-頭份,2024-10-01,9296
1733,五鼎,8,0,8,凱基-頭份,2024-10-01,9296
2363,矽統,8,0,8,凱基-頭份,2024-10-01,9296
4164,承業醫,8,0,8,凱基-頭份,2024-10-01,9296
4977,眾達-KY,8,0,8,凱基-頭份,2024-10-01,9296
6505,台塑化,9,1,8,凱基-頭份,2024-10-01,9296
3545,敦泰,10,3,7,凱基-頭份,2024-10-01,9296
3715,定穎投控,13,6,7,凱基-頭份,2024-10-01,9296
2317,鴻海,7,0,7,凱基-頭份,2024-10-01,9296
00919,群益台灣精選高息,7,0,7,凱基-頭份,2024-10-01,9296
1309,台達化,6,0,6,凱基-頭份,2024-10-01,9296
3706,神達,6,0,6,凱基-頭份,2024-10-01,9296
8111,立��,11,5,6,凱基-頭份,2024-10-01,9296
1582,信錦,5,0,5,凱基-頭份,2024-10-01,9296
1725,元禎,5,0,5,凱基-頭份,2024-10-01,9296
2105,正新,5,0,5,凱基-頭份,2024-10-01,9296
2393,億光,5,0,5,凱基-頭份,2024-10-01,9296
3037,欣興,5,0,5,凱基-頭份,2024-10-01,9296
4510,高鋒,5,0,5,凱基-頭份,2024-10-01,9296
5425,台半,5,0,5,凱基-頭份,2024-10-01,9296
6169,昱泉,5,0,5,凱基-頭份,2024-10-01,9296
1565,精華,4,0,4,凱基-頭份,2024-10-01,9296
3622,洋華,4,0,4,凱基-頭份,2024-10-01,9296
8104,錸寶,5,1,4,凱基-頭份,2024-10-01,9296
5871,中租-KY,5,1,4,凱基-頭份,2024-10-01,9296
4909,新復興,7,3,4,凱基-頭份,2024-10-01,9296
00713,元大台灣高息低波,3,0,3,凱基-頭份,2024-10-01,9296
00753L,中信中國50正2,3,0,3,凱基-頭份,2024-10-01,9296
00720B,元大投資級公司債,3,0,3,凱基-頭份,2024-10-01,9296
00752,中信中國50,2338,7,2331,凱基-頭份,2024-10-04,9296
00929,復華台灣科技優息,180,8,172,凱基-頭份,2024-10-04,9296
00680L,元大美債20正2,93,0,93,凱基-頭份,2024-10-04,9296
0056,元大高股息,80,1,79,凱基-頭份,2024-10-04,9296
00919,群益台灣精選高息,59,6,53,凱基-頭份,2024-10-04,9296
1326,台化,40,0,40,凱基-頭份,2024-10-04,9296
6505,台塑化,35,2,33,凱基-頭份,2024-10-04,9296
6151,晉倫,33,0,33,凱基-頭份,2024-10-04,9296
2344,華邦電,33,2,31,凱基-頭份,2024-10-04,9296
00650L,復華香港正2,34,4,30,凱基-頭份,2024-10-04,9296
00706L,期元大S＆P日圓正2,26,0,26,凱基-頭份,2024-10-04,9296
00918,大華優利高填息30,23,0,23,凱基-頭份,2024-10-04,9296
1909,榮成,20,0,20,凱基-頭份,2024-10-04,9296
6733,博晟生醫,20,0,20,凱基-頭份,2024-10-04,9296
00687B,國泰20年美債,19,0,19,凱基-頭份,2024-10-04,9296
00937B,群益ESG投等債20,19,0,19,凱基-頭份,2024-10-04,9296
2615,萬海,20,3,17,凱基-頭份,2024-10-04,9296
2609,陽明,81,66,15,凱基-頭份,2024-10-04,9296
2867,三商壽,20,5,15,凱基-頭份,2024-10-04,9296
4745,合富-KY,15,0,15,凱基-頭份,2024-10-04,9296
00878,國泰永續高股息,18,4,14,凱基-頭份,2024-10-04,9296
00700,富邦�琤肭磪�,13,0,13,凱基-頭份,2024-10-04,9296
3550,聯穎,13,0,13,凱基-頭份,2024-10-04,9296
00712,復華富時不動產,12,0,12,凱基-頭份,2024-10-04,9296
2610,華航,12,0,12,凱基-頭份,2024-10-04,9296
00940,元大台灣價值高息,30,18,12,凱基-頭份,2024-10-04,9296
2457,飛宏,11,0,11,凱基-頭份,2024-10-04,9296
3710,連展投控,11,0,11,凱基-頭份,2024-10-04,9296
3706,神達,11,0,11,凱基-頭份,2024-10-04,9296
00948B,中信優息投資級債,10,0,10,凱基-頭份,2024-10-04,9296
2014,中鴻,10,0,10,凱基-頭份,2024-10-04,9296
00882,中信中國高股息,43,34,9,凱基-頭份,2024-10-04,9296
00648R,元大S＆P500反1,9,0,9,凱基-頭份,2024-10-04,9296
2489,瑞軒,8,0,8,凱基-頭份,2024-10-04,9296
5345,天揚,7,0,7,凱基-頭份,2024-10-04,9296
00688L,國泰20年美債正2,6,0,6,凱基-頭份,2024-10-04,9296
2603,長榮,28,22,6,凱基-頭份,2024-10-04,9296
2618,長榮航,8,2,6,凱基-頭份,2024-10-04,9296
2892,第一金,6,0,6,凱基-頭份,2024-10-04,9296
5230,雷笛克光學,6,0,6,凱基-頭份,2024-10-04,9296
2324,仁寶,6,0,6,凱基-頭份,2024-10-04,9296
00922,國泰台灣領袖50,5,0,5,凱基-頭份,2024-10-04,9296
00900,富邦特選高股息30,5,0,5,凱基-頭份,2024-10-04,9296
00952,凱基台灣AI50,5,0,5,凱基-頭份,2024-10-04,9296
1582,信錦,5,0,5,凱基-頭份,2024-10-04,9296
2353,宏��,7,2,5,凱基-頭份,2024-10-04,9296
2426,鼎元,5,0,5,凱基-頭份,2024-10-04,9296
2498,宏達電,5,0,5,凱基-頭份,2024-10-04,9296
3122,笙泉,5,0,5,凱基-頭份,2024-10-04,9296
3581,博磊,5,0,5,凱基-頭份,2024-10-04,9296
2801,彰銀,227,4,223,凱基-頭份,2024-10-07,9296
2477,美隆電,100,20,80,凱基-頭份,2024-10-07,9296
00940,元大台灣價值高息,65,12,53,凱基-頭份,2024-10-07,9296
00700,富邦�琤肭磪�,50,3,47,凱基-頭份,2024-10-07,9296
00706L,期元大S＆P日圓正2,38,0,38,凱基-頭份,2024-10-07,9296
00636,國泰中國A50,33,0,33,凱基-頭份,2024-10-07,9296
00679B,元大美債20年,35,2,33,凱基-頭份,2024-10-07,9296
00887,永豐中國科技50大,32,2,30,凱基-頭份,2024-10-07,9296
00882,中信中國高股息,80,52,28,凱基-頭份,2024-10-07,9296
2363,矽統,30,3,27,凱基-頭份,2024-10-07,9296
00664R,國泰臺灣加權反1,25,0,25,凱基-頭份,2024-10-07,9296
00753L,中信中國50正2,37,13,24,凱基-頭份,2024-10-07,9296
2344,華邦電,24,0,24,凱基-頭份,2024-10-07,9296
6875,國邑*,24,0,24,凱基-頭份,2024-10-07,9296
2317,鴻海,28,7,21,凱基-頭份,2024-10-07,9296
00922,國泰台灣領袖50,21,0,21,凱基-頭份,2024-10-07,9296
00946,群益科技高息成長,20,0,20,凱基-頭份,2024-10-07,9296
3321,同泰,20,0,20,凱基-頭份,2024-10-07,9296
0056,元大高股息,22,2,20,凱基-頭份,2024-10-07,9296
00795B,中信美國公債20年,19,0,19,凱基-頭份,2024-10-07,9296
00720B,元大投資級公司債,18,0,18,凱基-頭份,2024-10-07,9296
00632R,元大台灣50反1,15,0,15,凱基-頭份,2024-10-07,9296
1721,三晃,13,0,13,凱基-頭份,2024-10-07,9296
2515,中工,14,1,13,凱基-頭份,2024-10-07,9296
3706,神達,38,26,12,凱基-頭份,2024-10-07,9296
00923,群益台ESG低碳50,12,0,12,凱基-頭份,2024-10-07,9296
8111,立��,122,111,11,凱基-頭份,2024-10-07,9296
00688L,國泰20年美債正2,11,0,11,凱基-頭份,2024-10-07,9296
2892,第一金,11,0,11,凱基-頭份,2024-10-07,9296
00915,凱基優選高股息30,10,0,10,凱基-頭份,2024-10-07,9296
2883,凱基金,10,0,10,凱基-頭份,2024-10-07,9296
1540,喬福,8,1,7,凱基-頭份,2024-10-07,9296
1802,台玻,8,1,7,凱基-頭份,2024-10-07,9296
8074,鉅橡,7,0,7,凱基-頭份,2024-10-07,9296
00713,元大台灣高息低波,6,0,6,凱基-頭份,2024-10-07,9296
006206,元大上證50,6,0,6,凱基-頭份,2024-10-07,9296
00877,復華中國5G,6,0,6,凱基-頭份,2024-10-07,9296
00919,群益台灣精選高息,21,15,6,凱基-頭份,2024-10-07,9296
00680L,元大美債20正2,5,0,5,凱基-頭份,2024-10-07,9296
1506,正道,5,0,5,凱基-頭份,2024-10-07,9296
2426,鼎元,5,0,5,凱基-頭份,2024-10-07,9296
3006,晶豪科,5,0,5,凱基-頭份,2024-10-07,9296
3710,連展投控,11,6,5,凱基-頭份,2024-10-07,9296
2313,華通,5,1,4,凱基-頭份,2024-10-07,9296
00850,元大臺灣ESG永續,4,0,4,凱基-頭份,2024-10-07,9296
2353,宏��,4,0,4,凱基-頭份,2024-10-07,9296
2412,中華電,4,0,4,凱基-頭份,2024-10-07,9296
2495,普安,7,3,4,凱基-頭份,2024-10-07,9296
4306,炎洲,4,0,4,凱基-頭份,2024-10-07,9296
4510,高鋒,4,0,4,凱基-頭份,2024-10-07,9296
00665L,富邦�琤肭磪囓�2,223,133,90,凱基-頭份,2024-10-08,9296
0056,元大高股息,58,0,58,凱基-頭份,2024-10-08,9296
00680L,元大美債20正2,51,0,51,凱基-頭份,2024-10-08,9296
00637L,元大滬深300正2,76,26,50,凱基-頭份,2024-10-08,9296
00753L,中信中國50正2,48,4,44,凱基-頭份,2024-10-08,9296
00919,群益台灣精選高息,42,1,41,凱基-頭份,2024-10-08,9296
1326,台化,20,0,20,凱基-頭份,2024-10-08,9296
00929,復華台灣科技優息,51,32,19,凱基-頭份,2024-10-08,9296
6152,百一,19,0,19,凱基-頭份,2024-10-08,9296
1314,中石化,18,0,18,凱基-頭份,2024-10-08,9296
00878,國泰永續高股息,18,0,18,凱基-頭份,2024-10-08,9296
00679B,元大美債20年,15,0,15,凱基-頭份,2024-10-08,9296
2349,錸德,25,10,15,凱基-頭份,2024-10-08,9296
2892,第一金,15,0,15,凱基-頭份,2024-10-08,9296
00687B,國泰20年美債,14,1,13,凱基-頭份,2024-10-08,9296
1815,富喬,13,1,12,凱基-頭份,2024-10-08,9296
4903,聯光通,18,6,12,凱基-頭份,2024-10-08,9296
3481,群創,19,7,12,凱基-頭份,2024-10-08,9296
00942B,台新美A公司債20+,11,0,11,凱基-頭份,2024-10-08,9296
2338,光罩,11,0,11,凱基-頭份,2024-10-08,9296
2845,遠東銀,11,0,11,凱基-頭份,2024-10-08,9296
6733,博晟生醫,11,0,11,凱基-頭份,2024-10-08,9296
00891,中信關鍵半導體,10,0,10,凱基-頭份,2024-10-08,9296
00930,永豐ESG低碳高息,10,0,10,凱基-頭份,2024-10-08,9296
2344,華邦電,11,1,10,凱基-頭份,2024-10-08,9296
2392,正崴,10,0,10,凱基-頭份,2024-10-08,9296
4726,永昕,10,0,10,凱基-頭份,2024-10-08,9296
6838,台新藥,9,0,9,凱基-頭份,2024-10-08,9296
00887,永豐中國科技50大,15,7,8,凱基-頭份,2024-10-08,9296
3037,欣興,7,0,7,凱基-頭份,2024-10-08,9296
00935,野村臺灣新科技50,7,0,7,凱基-頭份,2024-10-08,9296
1721,三晃,7,0,7,凱基-頭份,2024-10-08,9296
2337,旺宏,7,0,7,凱基-頭份,2024-10-08,9296
4306,炎洲,7,0,7,凱基-頭份,2024-10-08,9296
5345,天揚,7,0,7,凱基-頭份,2024-10-08,9296
2382,廣達,6,0,6,凱基-頭份,2024-10-08,9296
00725B,國泰投資級公司債,6,0,6,凱基-頭份,2024-10-08,9296
00960,野村全球航運龍頭,6,0,6,凱基-頭份,2024-10-08,9296
1909,榮成,6,0,6,凱基-頭份,2024-10-08,9296
00940,元大台灣價值高息,7,2,5,凱基-頭份,2024-10-08,9296
00752,中信中國50,13,8,5,凱基-頭份,2024-10-08,9296
00688L,國泰20年美債正2,5,0,5,凱基-頭份,2024-10-08,9296
00922,國泰台灣領袖50,5,0,5,凱基-頭份,2024-10-08,9296
00946,群益科技高息成長,5,0,5,凱基-頭份,2024-10-08,9296
5880,合庫金,5,0,5,凱基-頭份,2024-10-08,9296
6005,群益證,5,0,5,凱基-頭份,2024-10-08,9296
6742,澤米,5,0,5,凱基-頭份,2024-10-08,9296
00713,元大台灣高息低波,4,0,4,凱基-頭份,2024-10-08,9296
00915,凱基優選高股息30,4,0,4,凱基-頭份,2024-10-08,9296
3227,原相,4,0,4,凱基-頭份,2024-10-08,9296
2888,新光金,1497,0,1497,凱基-頭份,2024-10-09,9296
2867,三商壽,1128,50,1078,凱基-頭份,2024-10-09,9296
2883,凱基金,1008,0,1008,凱基-頭份,2024-10-09,9296
9105,泰金寶-DR,401,5,396,凱基-頭份,2024-10-09,9296
3019,亞光,101,3,98,凱基-頭份,2024-10-09,9296
00633L,富邦上証正2,80,11,69,凱基-頭份,2024-10-09,9296
1314,中石化,66,10,56,凱基-頭份,2024-10-09,9296
00937B,群益ESG投等債20,41,0,41,凱基-頭份,2024-10-09,9296
2025,千興,38,2,36,凱基-頭份,2024-10-09,9296
2547,日勝生,30,0,30,凱基-頭份,2024-10-09,9296
8271,宇瞻,27,0,27,凱基-頭份,2024-10-09,9296
00650L,復華香港正2,30,4,26,凱基-頭份,2024-10-09,9296
00943,兆豐電子高息等權,25,0,25,凱基-頭份,2024-10-09,9296
2887,台新金,25,3,22,凱基-頭份,2024-10-09,9296
00878,國泰永續高股息,21,0,21,凱基-頭份,2024-10-09,9296
00919,群益台灣精選高息,28,7,21,凱基-頭份,2024-10-09,9296
3481,群創,31,11,20,凱基-頭份,2024-10-09,9296
00696B,富邦美債20年,19,0,19,凱基-頭份,2024-10-09,9296
00637L,元大滬深300正2,48,29,19,凱基-頭份,2024-10-09,9296
00934,中信成長高股息,20,1,19,凱基-頭份,2024-10-09,9296
0056,元大高股息,18,0,18,凱基-頭份,2024-10-09,9296
3290,東浦,18,0,18,凱基-頭份,2024-10-09,9296
00687B,國泰20年美債,19,2,17,凱基-頭份,2024-10-09,9296
00665L,富邦�琤肭磪囓�2,17,0,17,凱基-頭份,2024-10-09,9296
6192,巨路,15,0,15,凱基-頭份,2024-10-09,9296
00725B,國泰投資級公司債,14,0,14,凱基-頭份,2024-10-09,9296
3550,聯穎,22,10,12,凱基-頭份,2024-10-09,9296
6530,創威,44,32,12,凱基-頭份,2024-10-09,9296
2349,錸德,11,0,11,凱基-頭份,2024-10-09,9296
00643,群益深証中小,10,0,10,凱基-頭份,2024-10-09,9296
00639,富邦深100,10,0,10,凱基-頭份,2024-10-09,9296
00669R,國泰美國道瓊反1,10,0,10,凱基-頭份,2024-10-09,9296
00712,復華富時不動產,10,0,10,凱基-頭份,2024-10-09,9296
00922,國泰台灣領袖50,25,15,10,凱基-頭份,2024-10-09,9296
1304,台聚,10,0,10,凱基-頭份,2024-10-09,9296
1308,亞聚,10,0,10,凱基-頭份,2024-10-09,9296
2337,旺宏,10,0,10,凱基-頭份,2024-10-09,9296
2356,英業達,12,2,10,凱基-頭份,2024-10-09,9296
6108,競國,10,0,10,凱基-頭份,2024-10-09,9296
1309,台達化,9,0,9,凱基-頭份,2024-10-09,9296
6134,萬旭,10,1,9,凱基-頭份,2024-10-09,9296
00912,中信臺灣智慧50,8,0,8,凱基-頭份,2024-10-09,9296
5443,均豪,17,9,8,凱基-頭份,2024-10-09,9296
6207,雷科,8,0,8,凱基-頭份,2024-10-09,9296
00688L,國泰20年美債正2,7,0,7,凱基-頭份,2024-10-09,9296
2601,益航,10,3,7,凱基-頭份,2024-10-09,9296
3706,神達,7,0,7,凱基-頭份,2024-10-09,9296
4979,華星光,27,20,7,凱基-頭份,2024-10-09,9296
5483,中美晶,7,0,7,凱基-頭份,2024-10-09,9296
6492,生華科,7,0,7,凱基-頭份,2024-10-09,9296
2883,凱基金,1860,5,1855,凱基-頭份,2024-10-11,9296
8039,台虹,77,0,77,凱基-頭份,2024-10-11,9296
3049,精金,60,10,50,凱基-頭份,2024-10-11,9296
2317,鴻海,48,14,34,凱基-頭份,2024-10-11,9296
00882,中信中國高股息,33,0,33,凱基-頭份,2024-10-11,9296
2449,京元電子,46,18,28,凱基-頭份,2024-10-11,9296
00922,國泰台灣領袖50,53,27,26,凱基-頭份,2024-10-11,9296
00650L,復華香港正2,24,0,24,凱基-頭份,2024-10-11,9296
00687B,國泰20年美債,23,0,23,凱基-頭份,2024-10-11,9296
8271,宇瞻,23,0,23,凱基-頭份,2024-10-11,9296
00688L,國泰20年美債正2,21,0,21,凱基-頭份,2024-10-11,9296
00937B,群益ESG投等債20,20,3,17,凱基-頭份,2024-10-11,9296
4903,聯光通,44,28,16,凱基-頭份,2024-10-11,9296
3710,連展投控,22,6,16,凱基-頭份,2024-10-11,9296
2363,矽統,20,5,15,凱基-頭份,2024-10-11,9296
00633L,富邦上証正2,24,10,14,凱基-頭份,2024-10-11,9296
2356,英業達,13,0,13,凱基-頭份,2024-10-11,9296
3062,建漢,12,0,12,凱基-頭份,2024-10-11,9296
00690,兆豐藍籌30,13,2,11,凱基-頭份,2024-10-11,9296
00665L,富邦�琤肭磪囓�2,10,0,10,凱基-頭份,2024-10-11,9296
1809,中釉,10,0,10,凱基-頭份,2024-10-11,9296
2105,正新,10,0,10,凱基-頭份,2024-10-11,9296
2392,正崴,10,0,10,凱基-頭份,2024-10-11,9296
4729,熒茂,10,0,10,凱基-頭份,2024-10-11,9296
4956,光鋐,24,14,10,凱基-頭份,2024-10-11,9296
6142,友勁,10,0,10,凱基-頭份,2024-10-11,9296
6743,安普新,10,0,10,凱基-頭份,2024-10-11,9296
00931B,統一美債20年,9,1,8,凱基-頭份,2024-10-11,9296
0056,元大高股息,11,4,7,凱基-頭份,2024-10-11,9296
00712,復華富時不動產,7,0,7,凱基-頭份,2024-10-11,9296
00915,凱基優選高股息30,8,2,6,凱基-頭份,2024-10-11,9296
00637L,元大滬深300正2,16,10,6,凱基-頭份,2024-10-11,9296
00753L,中信中國50正2,545,539,6,凱基-頭份,2024-10-11,9296
1714,和桐,6,0,6,凱基-頭份,2024-10-11,9296
1802,台玻,6,0,6,凱基-頭份,2024-10-11,9296
4306,炎洲,6,0,6,凱基-頭份,2024-10-11,9296
6241,易通展,7,1,6,凱基-頭份,2024-10-11,9296
6788,華景電,7,1,6,凱基-頭份,2024-10-11,9296
2344,華邦電,10,5,5,凱基-頭份,2024-10-11,9296
00927,群益半導體收益,5,0,5,凱基-頭份,2024-10-11,9296
2609,陽明,8,3,5,凱基-頭份,2024-10-11,9296
3209,全科,5,0,5,凱基-頭份,2024-10-11,9296
5345,天揚,5,0,5,凱基-頭份,2024-10-11,9296
6218,豪勉,5,0,5,凱基-頭份,2024-10-11,9296
6456,GIS-KY,5,0,5,凱基-頭份,2024-10-11,9296
6733,博晟生醫,5,0,5,凱基-頭份,2024-10-11,9296
6875,國邑*,5,0,5,凱基-頭份,2024-10-11,9296
9935,慶豐富,5,0,5,凱基-頭份,2024-10-11,9296
5871,中租-KY,5,0,5,凱基-頭份,2024-10-11,9296
2489,瑞軒,5,0,5,凱基-頭份,2024-10-11,9296
2412,中華電,443,0,443,凱基-頭份,2024-10-14,9296
8011,台通,43,1,42,凱基-頭份,2024-10-14,9296
2867,三商壽,35,0,35,凱基-頭份,2024-10-14,9296
00887,永豐中國科技50大,28,0,28,凱基-頭份,2024-10-14,9296
00922,國泰台灣領袖50,25,0,25,凱基-頭份,2024-10-14,9296
2615,萬海,21,0,21,凱基-頭份,2024-10-14,9296
1314,中石化,20,0,20,凱基-頭份,2024-10-14,9296
3049,精金,23,6,17,凱基-頭份,2024-10-14,9296
00633L,富邦上証正2,20,7,13,凱基-頭份,2024-10-14,9296
00687B,國泰20年美債,25,13,12,凱基-頭份,2024-10-14,9296
00943,兆豐電子高息等權,12,0,12,凱基-頭份,2024-10-14,9296
4903,聯光通,13,1,12,凱基-頭份,2024-10-14,9296
8111,立��,12,0,12,凱基-頭份,2024-10-14,9296
00937B,群益ESG投等債20,15,4,11,凱基-頭份,2024-10-14,9296
00725B,國泰投資級公司債,13,2,11,凱基-頭份,2024-10-14,9296
2312,金寶,44,33,11,凱基-頭份,2024-10-14,9296
3550,聯穎,11,0,11,凱基-頭份,2024-10-14,9296
00688L,國泰20年美債正2,10,0,10,凱基-頭份,2024-10-14,9296
2349,錸德,10,0,10,凱基-頭份,2024-10-14,9296
6733,博晟生醫,10,0,10,凱基-頭份,2024-10-14,9296
00919,群益台灣精選高息,10,3,7,凱基-頭份,2024-10-14,9296
1326,台化,7,0,7,凱基-頭份,2024-10-14,9296
6492,生華科,7,0,7,凱基-頭份,2024-10-14,9296
8097,常珵,6,0,6,凱基-頭份,2024-10-14,9296
00675L,富邦臺灣加權正2,5,0,5,凱基-頭份,2024-10-14,9296
2882,國泰金,5,0,5,凱基-頭份,2024-10-14,9296
00712,復華富時不動產,5,0,5,凱基-頭份,2024-10-14,9296
2429,銘旺科,5,0,5,凱基-頭份,2024-10-14,9296
2845,遠東銀,5,0,5,凱基-頭份,2024-10-14,9296
6202,盛群,11,6,5,凱基-頭份,2024-10-14,9296
2421,建準,10,6,4,凱基-頭份,2024-10-14,9296
3511,矽瑪,6,2,4,凱基-頭份,2024-10-14,9296
6224,聚鼎,4,0,4,凱基-頭份,2024-10-14,9296
6838,台新藥,4,0,4,凱基-頭份,2024-10-14,9296
0056,元大高股息,20,16,4,凱基-頭份,2024-10-14,9296
00713,元大台灣高息低波,4,1,3,凱基-頭份,2024-10-14,9296
00679B,元大美債20年,19,16,3,凱基-頭份,2024-10-14,9296
006208,富邦台50,3,0,3,凱基-頭份,2024-10-14,9296
3289,宜特,4,1,3,凱基-頭份,2024-10-14,9296
2344,華邦電,3,0,3,凱基-頭份,2024-10-14,9296
00933B,國泰10Y+金融債,3,0,3,凱基-頭份,2024-10-14,9296
1215,卜蜂,3,0,3,凱基-頭份,2024-10-14,9296
2324,仁寶,3,0,3,凱基-頭份,2024-10-14,9296
2543,皇昌,6,3,3,凱基-頭份,2024-10-14,9296
3150,鈺寶-創,3,0,3,凱基-頭份,2024-10-14,9296
3312,弘憶股,3,0,3,凱基-頭份,2024-10-14,9296
5905,南仁湖,3,0,3,凱基-頭份,2024-10-14,9296
8076,伍豐,3,0,3,凱基-頭份,2024-10-14,9296
8099,大世科,3,0,3,凱基-頭份,2024-10-14,9296
2482,連宇,3,0,3,凱基-頭份,2024-10-14,9296
00943,兆豐電子高息等權,306,0,306,凱基-頭份,2024-10-15,9296
6005,群益證,50,0,50,凱基-頭份,2024-10-15,9296
00679B,元大美債20年,35,0,35,凱基-頭份,2024-10-15,9296
3062,建漢,68,34,34,凱基-頭份,2024-10-15,9296
0056,元大高股息,36,3,33,凱基-頭份,2024-10-15,9296
00636,國泰中國A50,30,0,30,凱基-頭份,2024-10-15,9296
00680L,元大美債20正2,25,0,25,凱基-頭份,2024-10-15,9296
1314,中石化,45,21,24,凱基-頭份,2024-10-15,9296
2027,大成鋼,20,0,20,凱基-頭份,2024-10-15,9296
2426,鼎元,21,1,20,凱基-頭份,2024-10-15,9296
00919,群益台灣精選高息,37,18,19,凱基-頭份,2024-10-15,9296
00753L,中信中國50正2,18,0,18,凱基-頭份,2024-10-15,9296
4919,新唐,15,0,15,凱基-頭份,2024-10-15,9296
00639,富邦深100,16,1,15,凱基-頭份,2024-10-15,9296
1316,上曜,15,0,15,凱基-頭份,2024-10-15,9296
00961,FT臺灣永續高息,14,0,14,凱基-頭份,2024-10-15,9296
4532,瑞智,14,1,13,凱基-頭份,2024-10-15,9296
00665L,富邦�琤肭磪囓�2,11,0,11,凱基-頭份,2024-10-15,9296
2399,映泰,27,16,11,凱基-頭份,2024-10-15,9296
2606,裕民,10,0,10,凱基-頭份,2024-10-15,9296
00922,國泰台灣領袖50,10,0,10,凱基-頭份,2024-10-15,9296
1528,恩德,10,0,10,凱基-頭份,2024-10-15,9296
2888,新光金,13,3,10,凱基-頭份,2024-10-15,9296
3149,正達,39,29,10,凱基-頭份,2024-10-15,9296
2884,玉山金,13,3,10,凱基-頭份,2024-10-15,9296
2363,矽統,22,13,9,凱基-頭份,2024-10-15,9296
00887,永豐中國科技50大,18,9,9,凱基-頭份,2024-10-15,9296
2605,新興,10,1,9,凱基-頭份,2024-10-15,9296
2887,台新金,12,3,9,凱基-頭份,2024-10-15,9296
3231,緯創,13,4,9,凱基-頭份,2024-10-15,9296
8054,安國,10,1,9,凱基-頭份,2024-10-15,9296
4960,誠美材,8,0,8,凱基-頭份,2024-10-15,9296
00946,群益科技高息成長,7,0,7,凱基-頭份,2024-10-15,9296
1721,三晃,7,0,7,凱基-頭份,2024-10-15,9296
5345,天揚,7,0,7,凱基-頭份,2024-10-15,9296
1301,台塑,7,1,6,凱基-頭份,2024-10-15,9296
2303,聯電,7,1,6,凱基-頭份,2024-10-15,9296
3209,全科,6,0,6,凱基-頭份,2024-10-15,9296
00713,元大台灣高息低波,6,1,5,凱基-頭份,2024-10-15,9296
00687B,國泰20年美債,5,0,5,凱基-頭份,2024-10-15,9296
2615,萬海,7,2,5,凱基-頭份,2024-10-15,9296
00931B,統一美債20年,5,0,5,凱基-頭份,2024-10-15,9296
2402,毅嘉,5,0,5,凱基-頭份,2024-10-15,9296
2493,揚博,5,0,5,凱基-頭份,2024-10-15,9296
2515,中工,5,0,5,凱基-頭份,2024-10-15,9296
3013,晟銘電,14,9,5,凱基-頭份,2024-10-15,9296
3025,星通,12,7,5,凱基-頭份,2024-10-15,9296
6451,訊芯-KY,10,5,5,凱基-頭份,2024-10-15,9296
8028,昇陽半導體,11,6,5,凱基-頭份,2024-10-15,9296
9958,世紀鋼,5,0,5,凱基-頭份,2024-10-15,9296
00696B,富邦美債20年,1672,0,1672,凱基-頭份,2024-10-16,9296
1802,台玻,102,5,97,凱基-頭份,2024-10-16,9296
0056,元大高股息,82,0,82,凱基-頭份,2024-10-16,9296
00632R,元大台灣50反1,80,1,79,凱基-頭份,2024-10-16,9296
00637L,元大滬深300正2,84,7,77,凱基-頭份,2024-10-16,9296
00877,復華中國5G,50,0,50,凱基-頭份,2024-10-16,9296
00929,復華台灣科技優息,57,12,45,凱基-頭份,2024-10-16,9296
00680L,元大美債20正2,35,0,35,凱基-頭份,2024-10-16,9296
00675L,富邦臺灣加權正2,35,0,35,凱基-頭份,2024-10-16,9296
00830,國泰費城半導體,23,0,23,凱基-頭份,2024-10-16,9296
00887,永豐中國科技50大,26,4,22,凱基-頭份,2024-10-16,9296
00679B,元大美債20年,21,1,20,凱基-頭份,2024-10-16,9296
1436,華友聯,19,0,19,凱基-頭份,2024-10-16,9296
00878,國泰永續高股息,21,3,18,凱基-頭份,2024-10-16,9296
2887,台新金,18,0,18,凱基-頭份,2024-10-16,9296
2891,中信金,20,2,18,凱基-頭份,2024-10-16,9296
00948B,中信優息投資級債,16,0,16,凱基-頭份,2024-10-16,9296
2892,第一金,16,0,16,凱基-頭份,2024-10-16,9296
00922,國泰台灣領袖50,15,0,15,凱基-頭份,2024-10-16,9296
1314,中石化,14,0,14,凱基-頭份,2024-10-16,9296
1808,潤隆,14,0,14,凱基-頭份,2024-10-16,9296
00633L,富邦上証正2,22,10,12,凱基-頭份,2024-10-16,9296
00923,群益台ESG低碳50,12,1,11,凱基-頭份,2024-10-16,9296
00639,富邦深100,11,0,11,凱基-頭份,2024-10-16,9296
5443,均豪,22,11,11,凱基-頭份,2024-10-16,9296
00706L,期元大S＆P日圓正2,10,0,10,凱基-頭份,2024-10-16,9296
00725B,國泰投資級公司債,10,0,10,凱基-頭份,2024-10-16,9296
00642U,期元大S＆P石油,10,0,10,凱基-頭份,2024-10-16,9296
00946,群益科技高息成長,10,0,10,凱基-頭份,2024-10-16,9296
2338,光罩,10,0,10,凱基-頭份,2024-10-16,9296
5225,東科-KY,10,0,10,凱基-頭份,2024-10-16,9296
00918,大華優利高填息30,10,2,8,凱基-頭份,2024-10-16,9296
00636,國泰中國A50,7,0,7,凱基-頭份,2024-10-16,9296
2392,正崴,7,0,7,凱基-頭份,2024-10-16,9296
00921,兆豐龍頭等權重,6,0,6,凱基-頭份,2024-10-16,9296
2363,矽統,7,2,5,凱基-頭份,2024-10-16,9296
00915,凱基優選高股息30,5,0,5,凱基-頭份,2024-10-16,9296
2359,所羅門,7,2,5,凱基-頭份,2024-10-16,9296
4908,前鼎,5,0,5,凱基-頭份,2024-10-16,9296
00960,野村全球航運龍頭,6,1,5,凱基-頭份,2024-10-16,9296
1714,和桐,5,0,5,凱基-頭份,2024-10-16,9296
2489,瑞軒,5,0,5,凱基-頭份,2024-10-16,9296
3264,欣銓,5,0,5,凱基-頭份,2024-10-16,9296
6438,迅得,5,0,5,凱基-頭份,2024-10-16,9296
8404,百和興業-KY,5,0,5,凱基-頭份,2024-10-16,9296
2330,台積電,5,0,5,凱基-頭份,2024-10-16,9296
2371,大同,5,1,4,凱基-頭份,2024-10-16,9296
2337,旺宏,4,0,4,凱基-頭份,2024-10-16,9296
2356,英業達,5,1,4,凱基-頭份,2024-10-16,9296
2881,富邦金,4,0,4,凱基-頭份,2024-10-16,9296
00712,復華富時不動產,100,1,99,凱基-頭份,2024-10-17,9296
1314,中石化,61,8,53,凱基-頭份,2024-10-17,9296
00632R,元大台灣50反1,40,0,40,凱基-頭份,2024-10-17,9296
00922,國泰台灣領袖50,46,10,36,凱基-頭份,2024-10-17,9296
0056,元大高股息,35,0,35,凱基-頭份,2024-10-17,9296
00887,永豐中國科技50大,28,0,28,凱基-頭份,2024-10-17,9296
1528,恩德,50,27,23,凱基-頭份,2024-10-17,9296
00637L,元大滬深300正2,95,73,22,凱基-頭份,2024-10-17,9296
2845,遠東銀,20,0,20,凱基-頭份,2024-10-17,9296
2367,燿華,16,0,16,凱基-頭份,2024-10-17,9296
2613,中櫃,17,2,15,凱基-頭份,2024-10-17,9296
2867,三商壽,15,0,15,凱基-頭份,2024-10-17,9296
9938,百和,13,0,13,凱基-頭份,2024-10-17,9296
3437,榮創,12,0,12,凱基-頭份,2024-10-17,9296
3710,連展投控,12,0,12,凱基-頭份,2024-10-17,9296
2399,映泰,32,21,11,凱基-頭份,2024-10-17,9296
4903,聯光通,18,7,11,凱基-頭份,2024-10-17,9296
00730,富邦臺灣優質高息,10,0,10,凱基-頭份,2024-10-17,9296
2010,春源,10,0,10,凱基-頭份,2024-10-17,9296
4564,元翎,10,0,10,凱基-頭份,2024-10-17,9296
5202,力新,11,1,10,凱基-頭份,2024-10-17,9296
2303,聯電,8,0,8,凱基-頭份,2024-10-17,9296
2344,華邦電,14,6,8,凱基-頭份,2024-10-17,9296
6264,富裔,8,0,8,凱基-頭份,2024-10-17,9296
6829,千附精密,8,0,8,凱基-頭份,2024-10-17,9296
3060,銘異,7,0,7,凱基-頭份,2024-10-17,9296
00929,復華台灣科技優息,24,18,6,凱基-頭份,2024-10-17,9296
6241,易通展,6,0,6,凱基-頭份,2024-10-17,9296
00951,台新日本半導體,5,0,5,凱基-頭份,2024-10-17,9296
00706L,期元大S＆P日圓正2,5,0,5,凱基-頭份,2024-10-17,9296
2211,長榮鋼,5,0,5,凱基-頭份,2024-10-17,9296
2421,建準,7,2,5,凱基-頭份,2024-10-17,9296
2426,鼎元,5,0,5,凱基-頭份,2024-10-17,9296
3312,弘憶股,11,6,5,凱基-頭份,2024-10-17,9296
3511,矽瑪,11,6,5,凱基-頭份,2024-10-17,9296
6215,和椿,6,1,5,凱基-頭份,2024-10-17,9296
8374,羅昇,7,2,5,凱基-頭份,2024-10-17,9296
00680L,元大美債20正2,5,0,5,凱基-頭份,2024-10-17,9296
2634,漢翔,6,2,4,凱基-頭份,2024-10-17,9296
5452,佶優,10,6,4,凱基-頭份,2024-10-17,9296
6763,綠界科技*,6,2,4,凱基-頭份,2024-10-17,9296
2882,國泰金,4,0,4,凱基-頭份,2024-10-17,9296
00655L,國泰中國A50正2,3,0,3,凱基-頭份,2024-10-17,9296
00687B,國泰20年美債,7,4,3,凱基-頭份,2024-10-17,9296
1721,三晃,6,3,3,凱基-頭份,2024-10-17,9296
1795,美時,3,0,3,凱基-頭份,2024-10-17,9296
2464,盟立,11,8,3,凱基-頭份,2024-10-17,9296
3025,星通,5,2,3,凱基-頭份,2024-10-17,9296
3122,笙泉,3,0,3,凱基-頭份,2024-10-17,9296
3466,德晉,4,1,3,凱基-頭份,2024-10-17,9296
00933B,國泰10Y+金融債,105,0,105,凱基-頭份,2024-10-18,9296
2023,燁輝,101,0,101,凱基-頭份,2024-10-18,9296
00950B,凱基A級公司債,100,0,100,凱基-頭份,2024-10-18,9296
00712,復華富時不動產,100,1,99,凱基-頭份,2024-10-18,9296
00679B,元大美債20年,98,5,93,凱基-頭份,2024-10-18,9296
6770,力積電,69,4,65,凱基-頭份,2024-10-18,9296
2303,聯電,35,0,35,凱基-頭份,2024-10-18,9296
00680L,元大美債20正2,34,0,34,凱基-頭份,2024-10-18,9296
00688L,國泰20年美債正2,28,0,28,凱基-頭份,2024-10-18,9296
2367,燿華,27,0,27,凱基-頭份,2024-10-18,9296
00937B,群益ESG投等債20,23,0,23,凱基-頭份,2024-10-18,9296
1314,中石化,33,11,22,凱基-頭份,2024-10-18,9296
2312,金寶,37,17,20,凱基-頭份,2024-10-18,9296
00919,群益台灣精選高息,21,2,19,凱基-頭份,2024-10-18,9296
00887,永豐中國科技50大,17,1,16,凱基-頭份,2024-10-18,9296
3149,正達,17,1,16,凱基-頭份,2024-10-18,9296
9945,潤泰新,13,0,13,凱基-頭份,2024-10-18,9296
8937,合騏,12,0,12,凱基-頭份,2024-10-18,9296
5347,世界,12,0,12,凱基-頭份,2024-10-18,9296
5452,佶優,13,2,11,凱基-頭份,2024-10-18,9296
00690,兆豐藍籌30,11,0,11,凱基-頭份,2024-10-18,9296
2371,大同,12,1,11,凱基-頭份,2024-10-18,9296
2374,佳能,12,1,11,凱基-頭份,2024-10-18,9296
2489,瑞軒,11,0,11,凱基-頭份,2024-10-18,9296
4566,時碩工業,17,6,11,凱基-頭份,2024-10-18,9296
00687B,國泰20年美債,30,20,10,凱基-頭份,2024-10-18,9296
1514,亞力,12,2,10,凱基-頭份,2024-10-18,9296
2845,遠東銀,10,0,10,凱基-頭份,2024-10-18,9296
2449,京元電子,11,2,9,凱基-頭份,2024-10-18,9296
2888,新光金,8,0,8,凱基-頭份,2024-10-18,9296
6405,悅城,6,0,6,凱基-頭份,2024-10-18,9296
6763,綠界科技*,12,6,6,凱基-頭份,2024-10-18,9296
3374,精材,12,6,6,凱基-頭份,2024-10-18,9296
2887,台新金,10,4,6,凱基-頭份,2024-10-18,9296
3583,辛耘,5,0,5,凱基-頭份,2024-10-18,9296
00931B,統一美債20年,5,0,5,凱基-頭份,2024-10-18,9296
00932,兆豐永續高息等權,5,0,5,凱基-頭份,2024-10-18,9296
00706L,期元大S＆P日圓正2,5,0,5,凱基-頭份,2024-10-18,9296
1316,上曜,5,0,5,凱基-頭份,2024-10-18,9296
3714,富采,5,0,5,凱基-頭份,2024-10-18,9296
5202,力新,5,0,5,凱基-頭份,2024-10-18,9296
3491,昇達科,4,0,4,凱基-頭份,2024-10-18,9296
00753L,中信中國50正2,4,0,4,凱基-頭份,2024-10-18,9296
1784,訊聯,4,0,4,凱基-頭份,2024-10-18,9296
3031,佰鴻,12,8,4,凱基-頭份,2024-10-18,9296
3035,智原,4,0,4,凱基-頭份,2024-10-18,9296
3051,力特,4,0,4,凱基-頭份,2024-10-18,9296
3062,建漢,4,0,4,凱基-頭份,2024-10-18,9296
3209,全科,4,0,4,凱基-頭份,2024-10-18,9296
3450,聯鈞,15,11,4,凱基-頭份,2024-10-18,9296
00642U,期元大S＆P石油,509,0,509,凱基-頭份,2024-10-21,9296
00905,FT臺灣Smart,150,1,149,凱基-頭份,2024-10-21,9296
00943,兆豐電子高息等權,129,2,127,凱基-頭份,2024-10-21,9296
00712,復華富時不動產,50,0,50,凱基-頭份,2024-10-21,9296
2201,裕隆,50,0,50,凱基-頭份,2024-10-21,9296
2357,華碩,37,0,37,凱基-頭份,2024-10-21,9296
2891,中信金,31,0,31,凱基-頭份,2024-10-21,9296
5871,中租-KY,30,0,30,凱基-頭份,2024-10-21,9296
2883,凱基金,30,0,30,凱基-頭份,2024-10-21,9296
00950B,凱基A級公司債,27,0,27,凱基-頭份,2024-10-21,9296
4526,東台,18,1,17,凱基-頭份,2024-10-21,9296
00929,復華台灣科技優息,21,7,14,凱基-頭份,2024-10-21,9296
00687B,國泰20年美債,12,0,12,凱基-頭份,2024-10-21,9296
00751B,元大AAA至A公司債,12,0,12,凱基-頭份,2024-10-21,9296
2376,技嘉,11,0,11,凱基-頭份,2024-10-21,9296
2867,三商壽,11,0,11,凱基-頭份,2024-10-21,9296
4763,材料-KY,10,0,10,凱基-頭份,2024-10-21,9296
00633L,富邦上証正2,15,5,10,凱基-頭份,2024-10-21,9296
6125,廣運,13,3,10,凱基-頭份,2024-10-21,9296
8111,立��,10,0,10,凱基-頭份,2024-10-21,9296
1314,中石化,9,0,9,凱基-頭份,2024-10-21,9296
1540,喬福,15,6,9,凱基-頭份,2024-10-21,9296
2227,裕日車,9,0,9,凱基-頭份,2024-10-21,9296
2371,大同,10,1,9,凱基-頭份,2024-10-21,9296
3010,華立,9,0,9,凱基-頭份,2024-10-21,9296
00680L,元大美債20正2,10,2,8,凱基-頭份,2024-10-21,9296
4903,聯光通,9,1,8,凱基-頭份,2024-10-21,9296
6127,九豪,11,3,8,凱基-頭份,2024-10-21,9296
00948B,中信優息投資級債,8,0,8,凱基-頭份,2024-10-21,9296
00881,國泰台灣5G+,10,3,7,凱基-頭份,2024-10-21,9296
3231,緯創,11,4,7,凱基-頭份,2024-10-21,9296
6763,綠界科技*,9,2,7,凱基-頭份,2024-10-21,9296
00679B,元大美債20年,7,0,7,凱基-頭份,2024-10-21,9296
2303,聯電,17,11,6,凱基-頭份,2024-10-21,9296
2402,毅嘉,6,0,6,凱基-頭份,2024-10-21,9296
2344,華邦電,10,4,6,凱基-頭份,2024-10-21,9296
00900,富邦特選高股息30,5,0,5,凱基-頭份,2024-10-21,9296
1721,三晃,7,2,5,凱基-頭份,2024-10-21,9296
2327,國巨,5,0,5,凱基-頭份,2024-10-21,9296
6264,富裔,5,0,5,凱基-頭份,2024-10-21,9296
6505,台塑化,5,0,5,凱基-頭份,2024-10-21,9296
2881,富邦金,4,0,4,凱基-頭份,2024-10-21,9296
00639,富邦深100,4,0,4,凱基-頭份,2024-10-21,9296
00919,群益台灣精選高息,5,1,4,凱基-頭份,2024-10-21,9296
2409,友達,4,0,4,凱基-頭份,2024-10-21,9296
2634,漢翔,4,0,4,凱基-頭份,2024-10-21,9296
3209,全科,4,0,4,凱基-頭份,2024-10-21,9296
3303,岱稜,4,0,4,凱基-頭份,2024-10-21,9296
00931B,統一美債20年,3,0,3,凱基-頭份,2024-10-21,9296
00655L,國泰中國A50正2,7,4,3,凱基-頭份,2024-10-21,9296
00679B,元大美債20年,69,0,69,凱基-頭份,2024-10-22,9296
00687B,國泰20年美債,67,0,67,凱基-頭份,2024-10-22,9296
00937B,群益ESG投等債20,71,10,61,凱基-頭份,2024-10-22,9296
00795B,中信美國公債20年,30,0,30,凱基-頭份,2024-10-22,9296
00688L,國泰20年美債正2,26,0,26,凱基-頭份,2024-10-22,9296
00720B,元大投資級公司債,24,0,24,凱基-頭份,2024-10-22,9296
2883,凱基金,20,0,20,凱基-頭份,2024-10-22,9296
3715,定穎投控,24,5,19,凱基-頭份,2024-10-22,9296
6264,富裔,21,2,19,凱基-頭份,2024-10-22,9296
00948B,中信優息投資級債,16,0,16,凱基-頭份,2024-10-22,9296
00706L,期元大S＆P日圓正2,15,0,15,凱基-頭份,2024-10-22,9296
00772B,中信高評級公司債,14,0,14,凱基-頭份,2024-10-22,9296
2363,矽統,17,3,14,凱基-頭份,2024-10-22,9296
3114,好德,13,0,13,凱基-頭份,2024-10-22,9296
4903,聯光通,53,40,13,凱基-頭份,2024-10-22,9296
2317,鴻海,24,12,12,凱基-頭份,2024-10-22,9296
00942B,台新美A公司債20+,12,0,12,凱基-頭份,2024-10-22,9296
1815,富喬,15,3,12,凱基-頭份,2024-10-22,9296
2399,映泰,29,18,11,凱基-頭份,2024-10-22,9296
1301,台塑,11,0,11,凱基-頭份,2024-10-22,9296
3491,昇達科,16,6,10,凱基-頭份,2024-10-22,9296
1514,亞力,10,0,10,凱基-頭份,2024-10-22,9296
00665L,富邦�琤肭磪囓�2,10,0,10,凱基-頭份,2024-10-22,9296
1742,台蠟,10,0,10,凱基-頭份,2024-10-22,9296
2010,春源,10,0,10,凱基-頭份,2024-10-22,9296
2329,華泰,10,0,10,凱基-頭份,2024-10-22,9296
2888,新光金,11,1,10,凱基-頭份,2024-10-22,9296
4532,瑞智,10,0,10,凱基-頭份,2024-10-22,9296
6139,亞翔,12,2,10,凱基-頭份,2024-10-22,9296
8043,蜜望實,11,1,10,凱基-頭份,2024-10-22,9296
00712,復華富時不動產,9,0,9,凱基-頭份,2024-10-22,9296
2344,華邦電,44,35,9,凱基-頭份,2024-10-22,9296
00715L,期街口布蘭特正2,9,0,9,凱基-頭份,2024-10-22,9296
00931B,統一美債20年,9,0,9,凱基-頭份,2024-10-22,9296
3019,亞光,9,0,9,凱基-頭份,2024-10-22,9296
3149,正達,12,3,9,凱基-頭份,2024-10-22,9296
4729,熒茂,12,3,9,凱基-頭份,2024-10-22,9296
8027,鈦昇,11,2,9,凱基-頭份,2024-10-22,9296
2603,長榮,10,1,9,凱基-頭份,2024-10-22,9296
3189,景碩,10,2,8,凱基-頭份,2024-10-22,9296
2371,大同,8,0,8,凱基-頭份,2024-10-22,9296
2637,慧洋-KY,8,0,8,凱基-頭份,2024-10-22,9296
3167,大量,7,0,7,凱基-頭份,2024-10-22,9296
1711,永光,7,0,7,凱基-頭份,2024-10-22,9296
8111,立��,7,0,7,凱基-頭份,2024-10-22,9296
2890,永豐金,6,0,6,凱基-頭份,2024-10-22,9296
00725B,國泰投資級公司債,6,0,6,凱基-頭份,2024-10-22,9296
2352,佳世達,6,0,6,凱基-頭份,2024-10-22,9296
2543,皇昌,6,0,6,凱基-頭份,2024-10-22,9296
3615,安可,14,8,6,凱基-頭份,2024-10-22,9296
00937B,群益ESG投等債20,165,8,157,凱基-頭份,2024-10-23,9296
00679B,元大美債20年,55,0,55,凱基-頭份,2024-10-23,9296
2886,兆豐金,55,0,55,凱基-頭份,2024-10-23,9296
0056,元大高股息,54,1,53,凱基-頭份,2024-10-23,9296
8110,華東,50,0,50,凱基-頭份,2024-10-23,9296
2302,麗正,41,1,40,凱基-頭份,2024-10-23,9296
00715L,期街口布蘭特正2,26,2,24,凱基-頭份,2024-10-23,9296
2329,華泰,30,6,24,凱基-頭份,2024-10-23,9296
2303,聯電,23,0,23,凱基-頭份,2024-10-23,9296
00878,國泰永續高股息,68,47,21,凱基-頭份,2024-10-23,9296
00887,永豐中國科技50大,21,1,20,凱基-頭份,2024-10-23,9296
00706L,期元大S＆P日圓正2,20,0,20,凱基-頭份,2024-10-23,9296
2027,大成鋼,20,0,20,凱基-頭份,2024-10-23,9296
2363,矽統,21,4,17,凱基-頭份,2024-10-23,9296
00687B,國泰20年美債,17,0,17,凱基-頭份,2024-10-23,9296
3019,亞光,16,1,15,凱基-頭份,2024-10-23,9296
4167,松瑞藥,15,0,15,凱基-頭份,2024-10-23,9296
6264,富裔,15,0,15,凱基-頭份,2024-10-23,9296
8429,金麗-KY,15,0,15,凱基-頭份,2024-10-23,9296
2313,華通,13,1,12,凱基-頭份,2024-10-23,9296
1314,中石化,12,0,12,凱基-頭份,2024-10-23,9296
2891,中信金,12,0,12,凱基-頭份,2024-10-23,9296
2883,凱基金,12,1,11,凱基-頭份,2024-10-23,9296
00772B,中信高評級公司債,11,0,11,凱基-頭份,2024-10-23,9296
2890,永豐金,25,15,10,凱基-頭份,2024-10-23,9296
00961,FT臺灣永續高息,10,0,10,凱基-頭份,2024-10-23,9296
00902,中信電池及儲能,10,0,10,凱基-頭份,2024-10-23,9296
00918,大華優利高填息30,13,3,10,凱基-頭份,2024-10-23,9296
1609,大亞,10,0,10,凱基-頭份,2024-10-23,9296
2312,金寶,10,0,10,凱基-頭份,2024-10-23,9296
2426,鼎元,18,8,10,凱基-頭份,2024-10-23,9296
2892,第一金,10,0,10,凱基-頭份,2024-10-23,9296
3094,聯傑,10,0,10,凱基-頭份,2024-10-23,9296
3535,晶彩科,14,4,10,凱基-頭份,2024-10-23,9296
4532,瑞智,10,0,10,凱基-頭份,2024-10-23,9296
6151,晉倫,21,11,10,凱基-頭份,2024-10-23,9296
6233,旺玖,10,0,10,凱基-頭份,2024-10-23,9296
3149,正達,9,0,9,凱基-頭份,2024-10-23,9296
4903,聯光通,14,5,9,凱基-頭份,2024-10-23,9296
3011,今皓,8,0,8,凱基-頭份,2024-10-23,9296
00915,凱基優選高股息30,10,2,8,凱基-頭份,2024-10-23,9296
3037,欣興,14,7,7,凱基-頭份,2024-10-23,9296
00919,群益台灣精選高息,11,4,7,凱基-頭份,2024-10-23,9296
3715,定穎投控,10,3,7,凱基-頭份,2024-10-23,9296
4533,協易機,10,3,7,凱基-頭份,2024-10-23,9296
6202,盛群,7,0,7,凱基-頭份,2024-10-23,9296
3481,群創,16,9,7,凱基-頭份,2024-10-23,9296
00938,凱基優選30,7,1,6,凱基-頭份,2024-10-23,9296
2464,盟立,9,3,6,凱基-頭份,2024-10-23,9296
2867,三商壽,6,0,6,凱基-頭份,2024-10-23,9296
00679B,元大美債20年,1000,12,988,凱基-頭份,2024-10-24,9296
2354,鴻準,319,22,297,凱基-頭份,2024-10-24,9296
6770,力積電,86,0,86,凱基-頭份,2024-10-24,9296
00877,復華中國5G,50,0,50,凱基-頭份,2024-10-24,9296
00937B,群益ESG投等債20,66,21,45,凱基-頭份,2024-10-24,9296
00753L,中信中國50正2,43,0,43,凱基-頭份,2024-10-24,9296
1314,中石化,45,5,40,凱基-頭份,2024-10-24,9296
00878,國泰永續高股息,41,2,39,凱基-頭份,2024-10-24,9296
00665L,富邦�琤肭磪囓�2,35,0,35,凱基-頭份,2024-10-24,9296
2303,聯電,30,0,30,凱基-頭份,2024-10-24,9296
2892,第一金,27,0,27,凱基-頭份,2024-10-24,9296
00929,復華台灣科技優息,47,24,23,凱基-頭份,2024-10-24,9296
00942B,台新美A公司債20+,20,0,20,凱基-頭份,2024-10-24,9296
2436,偉詮電,20,0,20,凱基-頭份,2024-10-24,9296
1528,恩德,124,106,18,凱基-頭份,2024-10-24,9296
2312,金寶,16,0,16,凱基-頭份,2024-10-24,9296
1721,三晃,24,8,16,凱基-頭份,2024-10-24,9296
2369,菱生,24,8,16,凱基-頭份,2024-10-24,9296
00690,兆豐藍籌30,15,0,15,凱基-頭份,2024-10-24,9296
1316,上曜,15,0,15,凱基-頭份,2024-10-24,9296
00882,中信中國高股息,14,0,14,凱基-頭份,2024-10-24,9296
8937,合騏,14,0,14,凱基-頭份,2024-10-24,9296
2489,瑞軒,20,7,13,凱基-頭份,2024-10-24,9296
3167,大量,11,0,11,凱基-頭份,2024-10-24,9296
2388,威盛,11,0,11,凱基-頭份,2024-10-24,9296
00715L,期街口布蘭特正2,11,0,11,凱基-頭份,2024-10-24,9296
6763,綠界科技*,11,1,10,凱基-頭份,2024-10-24,9296
00952,凱基台灣AI50,10,0,10,凱基-頭份,2024-10-24,9296
2338,光罩,10,0,10,凱基-頭份,2024-10-24,9296
3489,森寶,10,0,10,凱基-頭份,2024-10-24,9296
3491,昇達科,10,0,10,凱基-頭份,2024-10-24,9296
5880,合庫金,10,0,10,凱基-頭份,2024-10-24,9296
8404,百和興業-KY,15,5,10,凱基-頭份,2024-10-24,9296
00931B,統一美債20年,9,0,9,凱基-頭份,2024-10-24,9296
00946,群益科技高息成長,9,0,9,凱基-頭份,2024-10-24,9296
6104,創惟,10,1,9,凱基-頭份,2024-10-24,9296
8070,長華*,10,1,9,凱基-頭份,2024-10-24,9296
00919,群益台灣精選高息,10,1,9,凱基-頭份,2024-10-24,9296
2399,映泰,20,12,8,凱基-頭份,2024-10-24,9296
00938,凱基優選30,7,0,7,凱基-頭份,2024-10-24,9296
1609,大亞,7,0,7,凱基-頭份,2024-10-24,9296
00633L,富邦上証正2,6,0,6,凱基-頭份,2024-10-24,9296
3021,鴻名,6,0,6,凱基-頭份,2024-10-24,9296
3430,奇鈦科,7,1,6,凱基-頭份,2024-10-24,9296
3545,敦泰,6,0,6,凱基-頭份,2024-10-24,9296
3615,安可,14,8,6,凱基-頭份,2024-10-24,9296
2891,中信金,7,2,5,凱基-頭份,2024-10-24,9296
2609,陽明,5,0,5,凱基-頭份,2024-10-24,9296
2890,永豐金,5,0,5,凱基-頭份,2024-10-24,9296
3051,力特,5,0,5,凱基-頭份,2024-10-24,9296
2610,華航,501,0,501,凱基-頭份,2024-10-25,9296
00943,兆豐電子高息等權,378,0,378,凱基-頭份,2024-10-25,9296
5202,力新,215,16,199,凱基-頭份,2024-10-25,9296
2605,新興,172,0,172,凱基-頭份,2024-10-25,9296
5243,乙盛-KY,144,0,144,凱基-頭份,2024-10-25,9296
2739,寒舍,110,7,103,凱基-頭份,2024-10-25,9296
1314,中石化,92,9,83,凱基-頭份,2024-10-25,9296
3715,定穎投控,68,7,61,凱基-頭份,2024-10-25,9296
6288,聯嘉,56,2,54,凱基-頭份,2024-10-25,9296
00680L,元大美債20正2,50,0,50,凱基-頭份,2024-10-25,9296
00712,復華富時不動產,50,0,50,凱基-頭份,2024-10-25,9296
8069,元太,50,0,50,凱基-頭份,2024-10-25,9296
1536,和大,42,3,39,凱基-頭份,2024-10-25,9296
2303,聯電,27,1,26,凱基-頭份,2024-10-25,9296
00887,永豐中國科技50大,55,30,25,凱基-頭份,2024-10-25,9296
2399,映泰,26,1,25,凱基-頭份,2024-10-25,9296
00915,凱基優選高股息30,20,0,20,凱基-頭份,2024-10-25,9296
2363,矽統,20,2,18,凱基-頭份,2024-10-25,9296
00937B,群益ESG投等債20,27,10,17,凱基-頭份,2024-10-25,9296
6770,力積電,19,7,12,凱基-頭份,2024-10-25,9296
2867,三商壽,11,0,11,凱基-頭份,2024-10-25,9296
3062,建漢,11,0,11,凱基-頭份,2024-10-25,9296
3284,太普高,20,9,11,凱基-頭份,2024-10-25,9296
6177,達麗,11,0,11,凱基-頭份,2024-10-25,9296
00753L,中信中國50正2,10,0,10,凱基-頭份,2024-10-25,9296
3550,聯穎,10,0,10,凱基-頭份,2024-10-25,9296
3710,連展投控,13,4,9,凱基-頭份,2024-10-25,9296
6264,富裔,9,0,9,凱基-頭份,2024-10-25,9296
8021,尖點,15,6,9,凱基-頭份,2024-10-25,9296
2344,華邦電,11,3,8,凱基-頭份,2024-10-25,9296
00929,復華台灣科技優息,31,23,8,凱基-頭份,2024-10-25,9296
00960,野村全球航運龍頭,6,0,6,凱基-頭份,2024-10-25,9296
00639,富邦深100,6,0,6,凱基-頭份,2024-10-25,9296
2489,瑞軒,7,1,6,凱基-頭份,2024-10-25,9296
5871,中租-KY,6,0,6,凱基-頭份,2024-10-25,9296
0056,元大高股息,7,2,5,凱基-頭份,2024-10-25,9296
1529,樂事綠能,5,0,5,凱基-頭份,2024-10-25,9296
1809,中釉,5,0,5,凱基-頭份,2024-10-25,9296
2025,千興,5,0,5,凱基-頭份,2024-10-25,9296
2516,新建,5,0,5,凱基-頭份,2024-10-25,9296
2608,嘉里大榮,5,0,5,凱基-頭份,2024-10-25,9296
3025,星通,5,0,5,凱基-頭份,2024-10-25,9296
3581,博磊,5,0,5,凱基-頭份,2024-10-25,9296
6456,GIS-KY,5,0,5,凱基-頭份,2024-10-25,9296
00940,元大台灣價值高息,4,0,4,凱基-頭份,2024-10-25,9296
3013,晟銘電,20,16,4,凱基-頭份,2024-10-25,9296
6742,澤米,4,0,4,凱基-頭份,2024-10-25,9296
8096,擎亞,4,0,4,凱基-頭份,2024-10-25,9296
3037,欣興,5,2,3,凱基-頭份,2024-10-25,9296
00941,中信上游半導體,3,0,3,凱基-頭份,2024-10-25,9296
00943,兆豐電子高息等權,150,0,150,凱基-頭份,2024-10-28,9296
2354,鴻準,132,2,130,凱基-頭份,2024-10-28,9296
2103,台橡,108,0,108,凱基-頭份,2024-10-28,9296
00878,國泰永續高股息,50,0,50,凱基-頭份,2024-10-28,9296
00877,復華中國5G,50,0,50,凱基-頭份,2024-10-28,9296
2731,雄獅,34,0,34,凱基-頭份,2024-10-28,9296
2867,三商壽,30,0,30,凱基-頭份,2024-10-28,9296
00919,群益台灣精選高息,29,1,28,凱基-頭份,2024-10-28,9296
3710,連展投控,27,0,27,凱基-頭份,2024-10-28,9296
00950B,凱基A級公司債,25,0,25,凱基-頭份,2024-10-28,9296
2646,星宇航空,27,3,24,凱基-頭份,2024-10-28,9296
00706L,期元大S＆P日圓正2,20,0,20,凱基-頭份,2024-10-28,9296
2206,三陽工業,20,0,20,凱基-頭份,2024-10-28,9296
00937B,群益ESG投等債20,19,0,19,凱基-頭份,2024-10-28,9296
2367,燿華,17,0,17,凱基-頭份,2024-10-28,9296
00688L,國泰20年美債正2,15,0,15,凱基-頭份,2024-10-28,9296
00915,凱基優選高股息30,13,0,13,凱基-頭份,2024-10-28,9296
2891,中信金,13,0,13,凱基-頭份,2024-10-28,9296
6283,淳安,13,1,12,凱基-頭份,2024-10-28,9296
00665L,富邦�琤肭磪囓�2,11,0,11,凱基-頭份,2024-10-28,9296
00679B,元大美債20年,27,16,11,凱基-頭份,2024-10-28,9296
00929,復華台灣科技優息,13,3,10,凱基-頭份,2024-10-28,9296
0056,元大高股息,10,0,10,凱基-頭份,2024-10-28,9296
3661,世芯-KY,10,0,10,凱基-頭份,2024-10-28,9296
00959B,大華投等美債15Y+,10,0,10,凱基-頭份,2024-10-28,9296
1714,和桐,10,0,10,凱基-頭份,2024-10-28,9296
2023,燁輝,10,0,10,凱基-頭份,2024-10-28,9296
2707,晶華,10,0,10,凱基-頭份,2024-10-28,9296
3645,達邁,10,1,9,凱基-頭份,2024-10-28,9296
2356,英業達,14,6,8,凱基-頭份,2024-10-28,9296
2489,瑞軒,11,3,8,凱基-頭份,2024-10-28,9296
2303,聯電,10,2,8,凱基-頭份,2024-10-28,9296
2883,凱基金,7,0,7,凱基-頭份,2024-10-28,9296
00725B,國泰投資級公司債,6,0,6,凱基-頭份,2024-10-28,9296
00955,中信日本商社,6,0,6,凱基-頭份,2024-10-28,9296
2312,金寶,20,14,6,凱基-頭份,2024-10-28,9296
2365,昆盈,6,0,6,凱基-頭份,2024-10-28,9296
2393,億光,7,1,6,凱基-頭份,2024-10-28,9296
2317,鴻海,30,24,6,凱基-頭份,2024-10-28,9296
00905,FT臺灣Smart,9,4,5,凱基-頭份,2024-10-28,9296
1605,華新,5,0,5,凱基-頭份,2024-10-28,9296
2706,第一店,5,0,5,凱基-頭份,2024-10-28,9296
3114,好德,5,0,5,凱基-頭份,2024-10-28,9296
00687B,國泰20年美債,8,4,4,凱基-頭份,2024-10-28,9296
1307,三芳,7,3,4,凱基-頭份,2024-10-28,9296
1608,華榮,4,0,4,凱基-頭份,2024-10-28,9296
2014,中鴻,4,0,4,凱基-頭份,2024-10-28,9296
2345,智邦,10,6,4,凱基-頭份,2024-10-28,9296
3049,精金,4,0,4,凱基-頭份,2024-10-28,9296
3209,全科,4,0,4,凱基-頭份,2024-10-28,9296
00943,兆豐電子高息等權,1533,0,1533,凱基-頭份,2024-10-29,9296
00878,國泰永續高股息,82,2,80,凱基-頭份,2024-10-29,9296
00919,群益台灣精選高息,63,0,63,凱基-頭份,2024-10-29,9296
00929,復華台灣科技優息,65,6,59,凱基-頭份,2024-10-29,9296
2371,大同,53,0,53,凱基-頭份,2024-10-29,9296
00887,永豐中國科技50大,50,0,50,凱基-頭份,2024-10-29,9296
0056,元大高股息,45,5,40,凱基-頭份,2024-10-29,9296
5488,松普,38,3,35,凱基-頭份,2024-10-29,9296
00905,FT臺灣Smart,45,12,33,凱基-頭份,2024-10-29,9296
00639,富邦深100,26,0,26,凱基-頭份,2024-10-29,9296
00713,元大台灣高息低波,20,0,20,凱基-頭份,2024-10-29,9296
2303,聯電,29,11,18,凱基-頭份,2024-10-29,9296
00882,中信中國高股息,20,3,17,凱基-頭份,2024-10-29,9296
2834,臺企銀,21,4,17,凱基-頭份,2024-10-29,9296
6133,金橋,17,0,17,凱基-頭份,2024-10-29,9296
6109,亞元,16,0,16,凱基-頭份,2024-10-29,9296
2489,瑞軒,15,0,15,凱基-頭份,2024-10-29,9296
4745,合富-KY,15,0,15,凱基-頭份,2024-10-29,9296
00918,大華優利高填息30,10,0,10,凱基-頭份,2024-10-29,9296
3037,欣興,10,0,10,凱基-頭份,2024-10-29,9296
00881,國泰台灣5G+,11,1,10,凱基-頭份,2024-10-29,9296
00642U,期元大S＆P石油,10,0,10,凱基-頭份,2024-10-29,9296
00690,兆豐藍籌30,10,0,10,凱基-頭份,2024-10-29,9296
2883,凱基金,10,0,10,凱基-頭份,2024-10-29,9296
8429,金麗-KY,10,0,10,凱基-頭份,2024-10-29,9296
00632R,元大台灣50反1,21,11,10,凱基-頭份,2024-10-29,9296
00687B,國泰20年美債,10,1,9,凱基-頭份,2024-10-29,9296
6239,力成,9,0,9,凱基-頭份,2024-10-29,9296
2393,億光,9,0,9,凱基-頭份,2024-10-29,9296
00923,群益台ESG低碳50,8,0,8,凱基-頭份,2024-10-29,9296
5880,合庫金,8,0,8,凱基-頭份,2024-10-29,9296
00940,元大台灣價值高息,116,108,8,凱基-頭份,2024-10-29,9296
2646,星宇航空,8,0,8,凱基-頭份,2024-10-29,9296
00915,凱基優選高股息30,7,0,7,凱基-頭份,2024-10-29,9296
00934,中信成長高股息,7,0,7,凱基-頭份,2024-10-29,9296
2405,輔信,7,0,7,凱基-頭份,2024-10-29,9296
2891,中信金,8,1,7,凱基-頭份,2024-10-29,9296
006208,富邦台50,7,0,7,凱基-頭份,2024-10-29,9296
00891,中信關鍵半導體,6,0,6,凱基-頭份,2024-10-29,9296
00947,台新臺灣IC設計,6,0,6,凱基-頭份,2024-10-29,9296
00960,野村全球航運龍頭,6,0,6,凱基-頭份,2024-10-29,9296
2417,圓剛,6,0,6,凱基-頭份,2024-10-29,9296
2498,宏達電,6,0,6,凱基-頭份,2024-10-29,9296
3511,矽瑪,6,0,6,凱基-頭份,2024-10-29,9296
4545,銘鈺,6,0,6,凱基-頭份,2024-10-29,9296
5443,均豪,6,0,6,凱基-頭份,2024-10-29,9296
1301,台塑,6,1,5,凱基-頭份,2024-10-29,9296
00885,富邦越南,5,0,5,凱基-頭份,2024-10-29,9296
00715L,期街口布蘭特正2,5,0,5,凱基-頭份,2024-10-29,9296
2543,皇昌,6,1,5,凱基-頭份,2024-10-29,9296
00937B,群益ESG投等債20,102,0,102,凱基-頭份,2024-10-30,9296
1314,中石化,100,0,100,凱基-頭份,2024-10-30,9296
00919,群益台灣精選高息,32,0,32,凱基-頭份,2024-10-30,9296
00929,復華台灣科技優息,24,0,24,凱基-頭份,2024-10-30,9296
4763,材料-KY,26,4,22,凱基-頭份,2024-10-30,9296
00882,中信中國高股息,21,0,21,凱基-頭份,2024-10-30,9296
00680L,元大美債20正2,20,0,20,凱基-頭份,2024-10-30,9296
00633L,富邦上証正2,21,3,18,凱基-頭份,2024-10-30,9296
00639,富邦深100,18,0,18,凱基-頭份,2024-10-30,9296
00690,兆豐藍籌30,14,0,14,凱基-頭份,2024-10-30,9296
2303,聯電,13,0,13,凱基-頭份,2024-10-30,9296
2419,仲琦,13,0,13,凱基-頭份,2024-10-30,9296
8044,網家,15,2,13,凱基-頭份,2024-10-30,9296
2357,華碩,11,0,11,凱基-頭份,2024-10-30,9296
5347,世界,10,0,10,凱基-頭份,2024-10-30,9296
00726B,國泰新興投等債,10,0,10,凱基-頭份,2024-10-30,9296
1528,恩德,33,23,10,凱基-頭份,2024-10-30,9296
2062,橋椿,10,0,10,凱基-頭份,2024-10-30,9296
2106,建大,10,0,10,凱基-頭份,2024-10-30,9296
2337,旺宏,25,15,10,凱基-頭份,2024-10-30,9296
2892,第一金,10,0,10,凱基-頭份,2024-10-30,9296
6133,金橋,10,0,10,凱基-頭份,2024-10-30,9296
0056,元大高股息,10,1,9,凱基-頭份,2024-10-30,9296
00878,國泰永續高股息,9,0,9,凱基-頭份,2024-10-30,9296
6264,富裔,9,0,9,凱基-頭份,2024-10-30,9296
3550,聯穎,8,0,8,凱基-頭份,2024-10-30,9296
5222,全訊,8,0,8,凱基-頭份,2024-10-30,9296
6229,研通,11,3,8,凱基-頭份,2024-10-30,9296
6284,佳邦,8,0,8,凱基-頭份,2024-10-30,9296
2887,台新金,7,0,7,凱基-頭份,2024-10-30,9296
2330,台積電,6,0,6,凱基-頭份,2024-10-30,9296
00947,台新臺灣IC設計,7,1,6,凱基-頭份,2024-10-30,9296
00753L,中信中國50正2,6,0,6,凱基-頭份,2024-10-30,9296
3481,群創,33,27,6,凱基-頭份,2024-10-30,9296
3551,世禾,6,0,6,凱基-頭份,2024-10-30,9296
4903,聯光通,23,17,6,凱基-頭份,2024-10-30,9296
6283,淳安,6,0,6,凱基-頭份,2024-10-30,9296
2891,中信金,8,2,6,凱基-頭份,2024-10-30,9296
6257,矽格,5,0,5,凱基-頭份,2024-10-30,9296
00887,永豐中國科技50大,5,0,5,凱基-頭份,2024-10-30,9296
1616,億泰,5,0,5,凱基-頭份,2024-10-30,9296
2393,億光,5,0,5,凱基-頭份,2024-10-30,9296
2605,新興,5,0,5,凱基-頭份,2024-10-30,9296
3229,晟鈦,5,0,5,凱基-頭份,2024-10-30,9296
8033,雷虎,5,0,5,凱基-頭份,2024-10-30,9296
2646,星宇航空,5,1,4,凱基-頭份,2024-10-30,9296
00688L,國泰20年美債正2,4,0,4,凱基-頭份,2024-10-30,9296
3231,緯創,4,0,4,凱基-頭份,2024-10-30,9296
4545,銘鈺,4,0,4,凱基-頭份,2024-10-30,9296
6743,安普新,4,0,4,凱基-頭份,2024-10-30,9296
00632R,元大台灣50反1,160,21,139,凱基-頭份,2024-11-01,9296
00929,復華台灣科技優息,123,3,120,凱基-頭份,2024-11-01,9296
2886,兆豐金,53,0,53,凱基-頭份,2024-11-01,9296
2303,聯電,52,1,51,凱基-頭份,2024-11-01,9296
00878,國泰永續高股息,55,5,50,凱基-頭份,2024-11-01,9296
2317,鴻海,48,2,46,凱基-頭份,2024-11-01,9296
2891,中信金,37,2,35,凱基-頭份,2024-11-01,9296
0056,元大高股息,29,0,29,凱基-頭份,2024-11-01,9296
00919,群益台灣精選高息,29,0,29,凱基-頭份,2024-11-01,9296
00915,凱基優選高股息30,28,0,28,凱基-頭份,2024-11-01,9296
2884,玉山金,27,0,27,凱基-頭份,2024-11-01,9296
00713,元大台灣高息低波,27,3,24,凱基-頭份,2024-11-01,9296
2354,鴻準,53,29,24,凱基-頭份,2024-11-01,9296
6164,華興,18,0,18,凱基-頭份,2024-11-01,9296
2646,星宇航空,15,0,15,凱基-頭份,2024-11-01,9296
3481,群創,15,2,13,凱基-頭份,2024-11-01,9296
4906,正文,12,0,12,凱基-頭份,2024-11-01,9296
00941,中信上游半導體,12,0,12,凱基-頭份,2024-11-01,9296
2881,富邦金,11,0,11,凱基-頭份,2024-11-01,9296
00885,富邦越南,10,0,10,凱基-頭份,2024-11-01,9296
00891,中信關鍵半導體,13,3,10,凱基-頭份,2024-11-01,9296
6264,富裔,10,0,10,凱基-頭份,2024-11-01,9296
00940,元大台灣價值高息,10,0,10,凱基-頭份,2024-11-01,9296
00887,永豐中國科技50大,10,1,9,凱基-頭份,2024-11-01,9296
00937B,群益ESG投等債20,12,5,7,凱基-頭份,2024-11-01,9296
2543,皇昌,7,1,6,凱基-頭份,2024-11-01,9296
2887,台新金,6,0,6,凱基-頭份,2024-11-01,9296
5243,乙盛-KY,7,1,6,凱基-頭份,2024-11-01,9296
2890,永豐金,5,0,5,凱基-頭份,2024-11-01,9296
2330,台積電,5,0,5,凱基-頭份,2024-11-01,9296
00690,兆豐藍籌30,5,0,5,凱基-頭份,2024-11-01,9296
2413,環科,6,1,5,凱基-頭份,2024-11-01,9296
2449,京元電子,7,2,5,凱基-頭份,2024-11-01,9296
3552,同致,5,0,5,凱基-頭份,2024-11-01,9296
8069,元太,5,0,5,凱基-頭份,2024-11-01,9296
00946,群益科技高息成長,4,0,4,凱基-頭份,2024-11-01,9296
1301,台塑,5,1,4,凱基-頭份,2024-11-01,9296
00675L,富邦臺灣加權正2,4,0,4,凱基-頭份,2024-11-01,9296
00959B,大華投等美債15Y+,4,0,4,凱基-頭份,2024-11-01,9296
1569,濱川,4,0,4,凱基-頭份,2024-11-01,9296
2328,廣宇,9,5,4,凱基-頭份,2024-11-01,9296
3209,全科,5,1,4,凱基-頭份,2024-11-01,9296
0050,元大台灣50,4,0,4,凱基-頭份,2024-11-01,9296
1785,光洋科,5,1,4,凱基-頭份,2024-11-01,9296
6257,矽格,3,0,3,凱基-頭份,2024-11-01,9296
3324,雙鴻,3,0,3,凱基-頭份,2024-11-01,9296
2344,華邦電,7,4,3,凱基-頭份,2024-11-01,9296
00712,復華富時不動產,3,0,3,凱基-頭份,2024-11-01,9296
006208,富邦台50,3,0,3,凱基-頭份,2024-11-01,9296
00932,兆豐永續高息等權,3,0,3,凱基-頭份,2024-11-01,9296
00937B,群益ESG投等債20,122,0,122,凱基-頭份,2024-11-04,9296
00953B,群益優選非投等債,50,0,50,凱基-頭份,2024-11-04,9296
3706,神達,50,6,44,凱基-頭份,2024-11-04,9296
2303,聯電,36,0,36,凱基-頭份,2024-11-04,9296
00878,國泰永續高股息,35,8,27,凱基-頭份,2024-11-04,9296
00687B,國泰20年美債,28,3,25,凱基-頭份,2024-11-04,9296
00919,群益台灣精選高息,31,7,24,凱基-頭份,2024-11-04,9296
00680L,元大美債20正2,20,0,20,凱基-頭份,2024-11-04,9296
00679B,元大美債20年,18,1,17,凱基-頭份,2024-11-04,9296
2495,普安,15,0,15,凱基-頭份,2024-11-04,9296
6669,緯穎,15,0,15,凱基-頭份,2024-11-04,9296
00720B,元大投資級公司債,14,0,14,凱基-頭份,2024-11-04,9296
6770,力積電,19,5,14,凱基-頭份,2024-11-04,9296
00665L,富邦�琤肭磪囓�2,12,0,12,凱基-頭份,2024-11-04,9296
2646,星宇航空,14,3,11,凱基-頭份,2024-11-04,9296
00751B,元大AAA至A公司債,11,0,11,凱基-頭份,2024-11-04,9296
00945B,凱基美國非投等債,11,0,11,凱基-頭份,2024-11-04,9296
00943,兆豐電子高息等權,10,0,10,凱基-頭份,2024-11-04,9296
5347,世界,10,0,10,凱基-頭份,2024-11-04,9296
2344,華邦電,11,3,8,凱基-頭份,2024-11-04,9296
00712,復華富時不動產,8,0,8,凱基-頭份,2024-11-04,9296
00941,中信上游半導體,8,1,7,凱基-頭份,2024-11-04,9296
00713,元大台灣高息低波,7,0,7,凱基-頭份,2024-11-04,9296
00882,中信中國高股息,7,0,7,凱基-頭份,2024-11-04,9296
2369,菱生,12,5,7,凱基-頭份,2024-11-04,9296
2609,陽明,14,7,7,凱基-頭份,2024-11-04,9296
6226,光鼎,6,0,6,凱基-頭份,2024-11-04,9296
6264,富裔,6,0,6,凱基-頭份,2024-11-04,9296
00931B,統一美債20年,5,0,5,凱基-頭份,2024-11-04,9296
00923,群益台ESG低碳50,5,0,5,凱基-頭份,2024-11-04,9296
00915,凱基優選高股息30,5,0,5,凱基-頭份,2024-11-04,9296
00731,復華富時高息低波,5,0,5,凱基-頭份,2024-11-04,9296
1735,日勝化,5,0,5,凱基-頭份,2024-11-04,9296
2489,瑞軒,5,0,5,凱基-頭份,2024-11-04,9296
3481,群創,5,0,5,凱基-頭份,2024-11-04,9296
6125,廣運,5,0,5,凱基-頭份,2024-11-04,9296
6218,豪勉,5,0,5,凱基-頭份,2024-11-04,9296
6838,台新藥,5,0,5,凱基-頭份,2024-11-04,9296
1616,億泰,4,0,4,凱基-頭份,2024-11-04,9296
2493,揚博,10,6,4,凱基-頭份,2024-11-04,9296
3321,同泰,4,0,4,凱基-頭份,2024-11-04,9296
4763,材料-KY,4,0,4,凱基-頭份,2024-11-04,9296
8111,立��,6,2,4,凱基-頭份,2024-11-04,9296
8429,金麗-KY,4,0,4,凱基-頭份,2024-11-04,9296
00690,兆豐藍籌30,3,0,3,凱基-頭份,2024-11-04,9296
2388,威盛,5,2,3,凱基-頭份,2024-11-04,9296
2390,云辰,3,0,3,凱基-頭份,2024-11-04,9296
2477,美隆電,13,10,3,凱基-頭份,2024-11-04,9296
3150,鈺寶-創,3,0,3,凱基-頭份,2024-11-04,9296
3162,精確,3,0,3,凱基-頭份,2024-11-04,9296
00731,復華富時高息低波,305,0,305,凱基-頭份,2024-11-05,9296
2477,美隆電,115,3,112,凱基-頭份,2024-11-05,9296
2912,統一超,109,0,109,凱基-頭份,2024-11-05,9296
2303,聯電,30,3,27,凱基-頭份,2024-11-05,9296
3062,建漢,26,1,25,凱基-頭份,2024-11-05,9296
00919,群益台灣精選高息,24,0,24,凱基-頭份,2024-11-05,9296
6770,力積電,21,2,19,凱基-頭份,2024-11-05,9296
00952,凱基台灣AI50,13,0,13,凱基-頭份,2024-11-05,9296
00915,凱基優選高股息30,12,0,12,凱基-頭份,2024-11-05,9296
00953B,群益優選非投等債,12,0,12,凱基-頭份,2024-11-05,9296
4745,合富-KY,13,1,12,凱基-頭份,2024-11-05,9296
00929,復華台灣科技優息,24,13,11,凱基-頭份,2024-11-05,9296
4956,光鋐,11,0,11,凱基-頭份,2024-11-05,9296
00673R,期元大S＆P原油反1,10,0,10,凱基-頭份,2024-11-05,9296
00882,中信中國高股息,10,0,10,凱基-頭份,2024-11-05,9296
3149,正達,14,4,10,凱基-頭份,2024-11-05,9296
6257,矽格,10,0,10,凱基-頭份,2024-11-05,9296
00878,國泰永續高股息,21,11,10,凱基-頭份,2024-11-05,9296
3481,群創,14,5,9,凱基-頭份,2024-11-05,9296
6264,富裔,9,0,9,凱基-頭份,2024-11-05,9296
2481,強茂,8,0,8,凱基-頭份,2024-11-05,9296
2515,中工,8,0,8,凱基-頭份,2024-11-05,9296
3049,精金,10,2,8,凱基-頭份,2024-11-05,9296
3162,精確,8,0,8,凱基-頭份,2024-11-05,9296
4977,眾達-KY,10,2,8,凱基-頭份,2024-11-05,9296
00941,中信上游半導體,7,0,7,凱基-頭份,2024-11-05,9296
6133,金橋,10,3,7,凱基-頭份,2024-11-05,9296
00937B,群益ESG投等債20,11,5,6,凱基-頭份,2024-11-05,9296
6177,達麗,6,0,6,凱基-頭份,2024-11-05,9296
6284,佳邦,6,0,6,凱基-頭份,2024-11-05,9296
00946,群益科技高息成長,5,0,5,凱基-頭份,2024-11-05,9296
00639,富邦深100,5,0,5,凱基-頭份,2024-11-05,9296
00690,兆豐藍籌30,5,0,5,凱基-頭份,2024-11-05,9296
00900,富邦特選高股息30,5,0,5,凱基-頭份,2024-11-05,9296
00887,永豐中國科技50大,5,0,5,凱基-頭份,2024-11-05,9296
2888,新光金,5,0,5,凱基-頭份,2024-11-05,9296
3702,大聯大,5,0,5,凱基-頭份,2024-11-05,9296
1449,佳和,8,4,4,凱基-頭份,2024-11-05,9296
3645,達邁,4,0,4,凱基-頭份,2024-11-05,9296
6768,志強-KY,4,0,4,凱基-頭份,2024-11-05,9296
9904,寶成,4,0,4,凱基-頭份,2024-11-05,9296
2615,萬海,6,3,3,凱基-頭份,2024-11-05,9296
2351,順德,3,0,3,凱基-頭份,2024-11-05,9296
00922,國泰台灣領袖50,3,0,3,凱基-頭份,2024-11-05,9296
1595,川寶,3,0,3,凱基-頭份,2024-11-05,9296
2399,映泰,8,5,3,凱基-頭份,2024-11-05,9296
2441,超豐,3,0,3,凱基-頭份,2024-11-05,9296
2458,義隆,3,0,3,凱基-頭份,2024-11-05,9296
2543,皇昌,3,0,3,凱基-頭份,2024-11-05,9296
2610,華航,3,0,3,凱基-頭份,2024-11-05,9296
00665L,富邦�琤肭磪囓�2,188,48,140,凱基-頭份,2024-11-06,9296
00937B,群益ESG投等債20,80,5,75,凱基-頭份,2024-11-06,9296
00687B,國泰20年美債,46,0,46,凱基-頭份,2024-11-06,9296
00688L,國泰20年美債正2,42,0,42,凱基-頭份,2024-11-06,9296
00943,兆豐電子高息等權,42,0,42,凱基-頭份,2024-11-06,9296
00882,中信中國高股息,39,2,37,凱基-頭份,2024-11-06,9296
3706,神達,30,0,30,凱基-頭份,2024-11-06,9296
00878,國泰永續高股息,29,0,29,凱基-頭份,2024-11-06,9296
2929,淘帝-KY,27,2,25,凱基-頭份,2024-11-06,9296
2409,友達,43,21,22,凱基-頭份,2024-11-06,9296
00960,野村全球航運龍頭,22,0,22,凱基-頭份,2024-11-06,9296
2363,矽統,23,3,20,凱基-頭份,2024-11-06,9296
2431,聯昌,18,1,17,凱基-頭份,2024-11-06,9296
00690,兆豐藍籌30,15,0,15,凱基-頭份,2024-11-06,9296
00639,富邦深100,14,0,14,凱基-頭份,2024-11-06,9296
00919,群益台灣精選高息,12,0,12,凱基-頭份,2024-11-06,9296
3035,智原,12,1,11,凱基-頭份,2024-11-06,9296
6505,台塑化,11,0,11,凱基-頭份,2024-11-06,9296
1305,華夏,21,10,11,凱基-頭份,2024-11-06,9296
3443,創意,12,1,11,凱基-頭份,2024-11-06,9296
00631L,元大台灣50正2,10,0,10,凱基-頭份,2024-11-06,9296
00706L,期元大S＆P日圓正2,10,0,10,凱基-頭份,2024-11-06,9296
2634,漢翔,10,0,10,凱基-頭份,2024-11-06,9296
3264,欣銓,10,0,10,凱基-頭份,2024-11-06,9296
00936,台新永續高息中小,9,0,9,凱基-頭份,2024-11-06,9296
1609,大亞,10,2,8,凱基-頭份,2024-11-06,9296
2867,三商壽,8,0,8,凱基-頭份,2024-11-06,9296
4956,光鋐,14,6,8,凱基-頭份,2024-11-06,9296
6264,富裔,8,0,8,凱基-頭份,2024-11-06,9296
4763,材料-KY,7,0,7,凱基-頭份,2024-11-06,9296
2441,超豐,7,0,7,凱基-頭份,2024-11-06,9296
3013,晟銘電,22,15,7,凱基-頭份,2024-11-06,9296
3481,群創,7,0,7,凱基-頭份,2024-11-06,9296
6139,亞翔,7,0,7,凱基-頭份,2024-11-06,9296
6530,創威,11,4,7,凱基-頭份,2024-11-06,9296
8249,菱光,12,6,6,凱基-頭份,2024-11-06,9296
1569,濱川,5,0,5,凱基-頭份,2024-11-06,9296
1595,川寶,5,0,5,凱基-頭份,2024-11-06,9296
2243,宏旭-KY,5,0,5,凱基-頭份,2024-11-06,9296
2301,光寶科,5,0,5,凱基-頭份,2024-11-06,9296
2399,映泰,22,17,5,凱基-頭份,2024-11-06,9296
2609,陽明,8,3,5,凱基-頭份,2024-11-06,9296
3615,安可,9,4,5,凱基-頭份,2024-11-06,9296
3704,合勤控,9,4,5,凱基-頭份,2024-11-06,9296
00751B,元大AAA至A公司債,4,0,4,凱基-頭份,2024-11-06,9296
2305,全友,7,3,4,凱基-頭份,2024-11-06,9296
3490,單井,5,1,4,凱基-頭份,2024-11-06,9296
3705,永信,4,0,4,凱基-頭份,2024-11-06,9296
4746,台耀,4,0,4,凱基-頭份,2024-11-06,9296
3019,亞光,3,0,3,凱基-頭份,2024-11-06,9296
00680L,元大美債20正2,40,0,40,凱基-頭份,2024-11-07,9296
2031,新光鋼,40,0,40,凱基-頭份,2024-11-07,9296
00943,兆豐電子高息等權,31,0,31,凱基-頭份,2024-11-07,9296
9105,泰金寶-DR,26,1,25,凱基-頭份,2024-11-07,9296
00919,群益台灣精選高息,26,3,23,凱基-頭份,2024-11-07,9296
00690,兆豐藍籌30,21,0,21,凱基-頭份,2024-11-07,9296
2891,中信金,20,0,20,凱基-頭份,2024-11-07,9296
00878,國泰永續高股息,23,6,17,凱基-頭份,2024-11-07,9296
2337,旺宏,21,6,15,凱基-頭份,2024-11-07,9296
8043,蜜望實,15,0,15,凱基-頭份,2024-11-07,9296
00692,富邦公司治理,14,0,14,凱基-頭份,2024-11-07,9296
00915,凱基優選高股息30,12,0,12,凱基-頭份,2024-11-07,9296
2646,星宇航空,15,4,11,凱基-頭份,2024-11-07,9296
5014,建錩,11,0,11,凱基-頭份,2024-11-07,9296
6669,緯穎,12,1,11,凱基-頭份,2024-11-07,9296
00922,國泰台灣領袖50,11,1,10,凱基-頭份,2024-11-07,9296
1802,台玻,11,1,10,凱基-頭份,2024-11-07,9296
2017,官田鋼,10,0,10,凱基-頭份,2024-11-07,9296
2062,橋椿,10,0,10,凱基-頭份,2024-11-07,9296
3008,大立光,10,0,10,凱基-頭份,2024-11-07,9296
2365,昆盈,10,1,9,凱基-頭份,2024-11-07,9296
2312,金寶,57,49,8,凱基-頭份,2024-11-07,9296
3706,神達,11,3,8,凱基-頭份,2024-11-07,9296
2327,國巨,7,0,7,凱基-頭份,2024-11-07,9296
1522,堤維西,6,0,6,凱基-頭份,2024-11-07,9296
4956,光鋐,7,1,6,凱基-頭份,2024-11-07,9296
6224,聚鼎,6,0,6,凱基-頭份,2024-11-07,9296
00679B,元大美債20年,6,0,6,凱基-頭份,2024-11-07,9296
2356,英業達,16,11,5,凱基-頭份,2024-11-07,9296
00673R,期元大S＆P原油反1,5,0,5,凱基-頭份,2024-11-07,9296
00669R,國泰美國道瓊反1,5,0,5,凱基-頭份,2024-11-07,9296
6133,金橋,10,5,5,凱基-頭份,2024-11-07,9296
6664,群翊,5,0,5,凱基-頭份,2024-11-07,9296
3413,京鼎,5,0,5,凱基-頭份,2024-11-07,9296
00632R,元大台灣50反1,5,1,4,凱基-頭份,2024-11-07,9296
2014,中鴻,5,1,4,凱基-頭份,2024-11-07,9296
2399,映泰,14,10,4,凱基-頭份,2024-11-07,9296
2850,新產,4,0,4,凱基-頭份,2024-11-07,9296
3580,友威科,4,0,4,凱基-頭份,2024-11-07,9296
6873,泓德能源,6,2,4,凱基-頭份,2024-11-07,9296
8011,台通,4,0,4,凱基-頭份,2024-11-07,9296
3231,緯創,7,3,4,凱基-頭份,2024-11-07,9296
2441,超豐,6,3,3,凱基-頭份,2024-11-07,9296
00635U,期元大S＆P黃金,3,0,3,凱基-頭份,2024-11-07,9296
00642U,期元大S＆P石油,3,0,3,凱基-頭份,2024-11-07,9296
00959B,大華投等美債15Y+,3,0,3,凱基-頭份,2024-11-07,9296
1449,佳和,6,3,3,凱基-頭份,2024-11-07,9296
2115,六暉-KY,3,0,3,凱基-頭份,2024-11-07,9296
2421,建準,3,0,3,凱基-頭份,2024-11-07,9296
3149,正達,3,0,3,凱基-頭份,2024-11-07,9296
00632R,元大台灣50反1,155,1,154,凱基-頭份,2024-11-08,9296
00891,中信關鍵半導體,120,20,100,凱基-頭份,2024-11-08,9296
2399,映泰,75,3,72,凱基-頭份,2024-11-08,9296
3062,建漢,43,5,38,凱基-頭份,2024-11-08,9296
2312,金寶,36,13,23,凱基-頭份,2024-11-08,9296
2392,正崴,40,18,22,凱基-頭份,2024-11-08,9296
2489,瑞軒,20,0,20,凱基-頭份,2024-11-08,9296
9105,泰金寶-DR,20,0,20,凱基-頭份,2024-11-08,9296
9946,三發地產,20,0,20,凱基-頭份,2024-11-08,9296
3704,合勤控,20,4,16,凱基-頭份,2024-11-08,9296
6669,緯穎,16,0,16,凱基-頭份,2024-11-08,9296
8096,擎亞,30,14,16,凱基-頭份,2024-11-08,9296
00637L,元大滬深300正2,16,4,12,凱基-頭份,2024-11-08,9296
2388,威盛,12,0,12,凱基-頭份,2024-11-08,9296
6151,晉倫,11,0,11,凱基-頭份,2024-11-08,9296
00933B,國泰10Y+金融債,17,7,10,凱基-頭份,2024-11-08,9296
00631L,元大台灣50正2,10,0,10,凱基-頭份,2024-11-08,9296
00945B,凱基美國非投等債,10,0,10,凱基-頭份,2024-11-08,9296
2468,華經,10,0,10,凱基-頭份,2024-11-08,9296
3710,連展投控,12,2,10,凱基-頭份,2024-11-08,9296
4958,臻鼎-KY,10,0,10,凱基-頭份,2024-11-08,9296
2314,台揚,10,0,10,凱基-頭份,2024-11-08,9296
2328,廣宇,20,11,9,凱基-頭份,2024-11-08,9296
2353,宏��,9,0,9,凱基-頭份,2024-11-08,9296
6235,華孚,9,0,9,凱基-頭份,2024-11-08,9296
8150,南茂,9,0,9,凱基-頭份,2024-11-08,9296
2409,友達,8,0,8,凱基-頭份,2024-11-08,9296
00639,富邦深100,8,0,8,凱基-頭份,2024-11-08,9296
3715,定穎投控,13,5,8,凱基-頭份,2024-11-08,9296
2354,鴻準,21,13,8,凱基-頭份,2024-11-08,9296
2324,仁寶,10,3,7,凱基-頭份,2024-11-08,9296
3013,晟銘電,9,2,7,凱基-頭份,2024-11-08,9296
2344,華邦電,8,1,7,凱基-頭份,2024-11-08,9296
1802,台玻,10,4,6,凱基-頭份,2024-11-08,9296
2646,星宇航空,7,1,6,凱基-頭份,2024-11-08,9296
3303,岱稜,6,0,6,凱基-頭份,2024-11-08,9296
4526,東台,6,0,6,凱基-頭份,2024-11-08,9296
2892,第一金,5,0,5,凱基-頭份,2024-11-08,9296
00885,富邦越南,5,0,5,凱基-頭份,2024-11-08,9296
00700,富邦�琤肭磪�,5,0,5,凱基-頭份,2024-11-08,9296
00930,永豐ESG低碳高息,5,0,5,凱基-頭份,2024-11-08,9296
1785,光洋科,5,0,5,凱基-頭份,2024-11-08,9296
3701,大眾控,5,0,5,凱基-頭份,2024-11-08,9296
4971,IET-KY,5,0,5,凱基-頭份,2024-11-08,9296
6733,博晟生醫,5,0,5,凱基-頭份,2024-11-08,9296
00919,群益台灣精選高息,6,2,4,凱基-頭份,2024-11-08,9296
00679B,元大美債20年,4,0,4,凱基-頭份,2024-11-08,9296
6139,亞翔,4,0,4,凱基-頭份,2024-11-08,9296
1616,億泰,4,0,4,凱基-頭份,2024-11-08,9296
2022,聚亨,4,0,4,凱基-頭份,2024-11-08,9296
9105,泰金寶-DR,65,0,65,凱基-頭份,2024-11-11,9296
00937B,群益ESG投等債20,54,4,50,凱基-頭份,2024-11-11,9296
00878,國泰永續高股息,48,0,48,凱基-頭份,2024-11-11,9296
00639,富邦深100,30,0,30,凱基-頭份,2024-11-11,9296
00665L,富邦�琤肭磪囓�2,41,16,25,凱基-頭份,2024-11-11,9296
00713,元大台灣高息低波,25,1,24,凱基-頭份,2024-11-11,9296
00929,復華台灣科技優息,52,29,23,凱基-頭份,2024-11-11,9296
2357,華碩,81,60,21,凱基-頭份,2024-11-11,9296
00919,群益台灣精選高息,19,0,19,凱基-頭份,2024-11-11,9296
2883,凱基金,18,0,18,凱基-頭份,2024-11-11,9296
4903,聯光通,20,5,15,凱基-頭份,2024-11-11,9296
1326,台化,14,0,14,凱基-頭份,2024-11-11,9296
00637L,元大滬深300正2,20,7,13,凱基-頭份,2024-11-11,9296
1809,中釉,13,0,13,凱基-頭份,2024-11-11,9296
2515,中工,13,0,13,凱基-頭份,2024-11-11,9296
5434,崇越,20,8,12,凱基-頭份,2024-11-11,9296
2392,正崴,23,12,11,凱基-頭份,2024-11-11,9296
3062,建漢,11,0,11,凱基-頭份,2024-11-11,9296
1308,亞聚,11,0,11,凱基-頭份,2024-11-11,9296
2022,聚亨,11,0,11,凱基-頭份,2024-11-11,9296
00915,凱基優選高股息30,10,0,10,凱基-頭份,2024-11-11,9296
3264,欣銓,10,0,10,凱基-頭份,2024-11-11,9296
00945B,凱基美國非投等債,10,0,10,凱基-頭份,2024-11-11,9296
00887,永豐中國科技50大,10,0,10,凱基-頭份,2024-11-11,9296
00633L,富邦上証正2,10,0,10,凱基-頭份,2024-11-11,9296
2014,中鴻,10,0,10,凱基-頭份,2024-11-11,9296
3419,譁裕,10,0,10,凱基-頭份,2024-11-11,9296
6134,萬旭,10,0,10,凱基-頭份,2024-11-11,9296
6733,博晟生醫,10,0,10,凱基-頭份,2024-11-11,9296
6139,亞翔,11,2,9,凱基-頭份,2024-11-11,9296
00687B,國泰20年美債,9,0,9,凱基-頭份,2024-11-11,9296
3162,精確,9,0,9,凱基-頭份,2024-11-11,9296
6770,力積電,10,1,9,凱基-頭份,2024-11-11,9296
2353,宏��,8,0,8,凱基-頭份,2024-11-11,9296
2812,台中銀,8,0,8,凱基-頭份,2024-11-11,9296
3303,岱稜,9,1,8,凱基-頭份,2024-11-11,9296
3481,群創,9,1,8,凱基-頭份,2024-11-11,9296
8249,菱光,8,0,8,凱基-頭份,2024-11-11,9296
2449,京元電子,12,5,7,凱基-頭份,2024-11-11,9296
00901,永豐智能車供應鏈,7,0,7,凱基-頭份,2024-11-11,9296
2327,國巨,7,0,7,凱基-頭份,2024-11-11,9296
2609,陽明,17,10,7,凱基-頭份,2024-11-11,9296
2610,華航,8,1,7,凱基-頭份,2024-11-11,9296
6560,欣普羅,7,0,7,凱基-頭份,2024-11-11,9296
8150,南茂,7,0,7,凱基-頭份,2024-11-11,9296
6277,宏正,6,0,6,凱基-頭份,2024-11-11,9296
4989,榮科,6,0,6,凱基-頭份,2024-11-11,9296
00679B,元大美債20年,6,1,5,凱基-頭份,2024-11-11,9296
1314,中石化,10,5,5,凱基-頭份,2024-11-11,9296
2354,鴻準,20,15,5,凱基-頭份,2024-11-11,9296
00878,國泰永續高股息,184,5,179,凱基-頭份,2024-11-12,9296
00671R,富邦NASDAQ反1,155,0,155,凱基-頭份,2024-11-12,9296
0056,元大高股息,60,3,57,凱基-頭份,2024-11-12,9296
00712,復華富時不動產,50,0,50,凱基-頭份,2024-11-12,9296
00715L,期街口布蘭特正2,47,0,47,凱基-頭份,2024-11-12,9296
2357,華碩,153,109,44,凱基-頭份,2024-11-12,9296
00909,國泰數位支付服務,43,1,42,凱基-頭份,2024-11-12,9296
2349,錸德,52,12,40,凱基-頭份,2024-11-12,9296
00919,群益台灣精選高息,40,1,39,凱基-頭份,2024-11-12,9296
00953B,群益優選非投等債,30,0,30,凱基-頭份,2024-11-12,9296
3481,群創,30,3,27,凱基-頭份,2024-11-12,9296
1314,中石化,25,0,25,凱基-頭份,2024-11-12,9296
3710,連展投控,25,0,25,凱基-頭份,2024-11-12,9296
00945B,凱基美國非投等債,22,0,22,凱基-頭份,2024-11-12,9296
5871,中租-KY,21,0,21,凱基-頭份,2024-11-12,9296
00915,凱基優選高股息30,22,2,20,凱基-頭份,2024-11-12,9296
00930,永豐ESG低碳高息,22,2,20,凱基-頭份,2024-11-12,9296
2376,技嘉,14,0,14,凱基-頭份,2024-11-12,9296
6560,欣普羅,13,0,13,凱基-頭份,2024-11-12,9296
2887,台新金,12,0,12,凱基-頭份,2024-11-12,9296
2892,第一金,12,0,12,凱基-頭份,2024-11-12,9296
00893,國泰智能電動車,12,1,11,凱基-頭份,2024-11-12,9296
00895,富邦未來車,10,0,10,凱基-頭份,2024-11-12,9296
2106,建大,10,0,10,凱基-頭份,2024-11-12,9296
2365,昆盈,11,1,10,凱基-頭份,2024-11-12,9296
2888,新光金,10,0,10,凱基-頭份,2024-11-12,9296
6116,彩晶,10,0,10,凱基-頭份,2024-11-12,9296
8103,瀚荃,10,0,10,凱基-頭份,2024-11-12,9296
8249,菱光,11,1,10,凱基-頭份,2024-11-12,9296
3062,建漢,11,2,9,凱基-頭份,2024-11-12,9296
00753L,中信中國50正2,10,1,9,凱基-頭份,2024-11-12,9296
1101,台泥,15,6,9,凱基-頭份,2024-11-12,9296
2399,映泰,13,4,9,凱基-頭份,2024-11-12,9296
1736,喬山,8,0,8,凱基-頭份,2024-11-12,9296
2356,英業達,92,84,8,凱基-頭份,2024-11-12,9296
2348,海悅,9,1,8,凱基-頭份,2024-11-12,9296
2330,台積電,8,0,8,凱基-頭份,2024-11-12,9296
2313,華通,9,2,7,凱基-頭份,2024-11-12,9296
5880,合庫金,7,0,7,凱基-頭份,2024-11-12,9296
6733,博晟生醫,7,0,7,凱基-頭份,2024-11-12,9296
00881,國泰台灣5G+,6,0,6,凱基-頭份,2024-11-12,9296
00713,元大台灣高息低波,6,0,6,凱基-頭份,2024-11-12,9296
2317,鴻海,7,1,6,凱基-頭份,2024-11-12,9296
2884,玉山金,6,0,6,凱基-頭份,2024-11-12,9296
2834,臺企銀,7,1,6,凱基-頭份,2024-11-12,9296
3231,緯創,8,2,6,凱基-頭份,2024-11-12,9296
4977,眾達-KY,6,0,6,凱基-頭份,2024-11-12,9296
5258,虹堡,6,0,6,凱基-頭份,2024-11-12,9296
8032,光菱,11,5,6,凱基-頭份,2024-11-12,9296
9945,潤泰新,6,0,6,凱基-頭份,2024-11-12,9296
00943,兆豐電子高息等權,154,0,154,凱基-頭份,2024-11-13,9296
00878,國泰永續高股息,101,0,101,凱基-頭份,2024-11-13,9296
4763,材料-KY,39,0,39,凱基-頭份,2024-11-13,9296
0056,元大高股息,38,0,38,凱基-頭份,2024-11-13,9296
8162,微矽電子-創,38,0,38,凱基-頭份,2024-11-13,9296
00919,群益台灣精選高息,30,1,29,凱基-頭份,2024-11-13,9296
2363,矽統,28,0,28,凱基-頭份,2024-11-13,9296
00932,兆豐永續高息等權,24,0,24,凱基-頭份,2024-11-13,9296
00937B,群益ESG投等債20,37,15,22,凱基-頭份,2024-11-13,9296
9105,泰金寶-DR,22,0,22,凱基-頭份,2024-11-13,9296
00909,國泰數位支付服務,21,0,21,凱基-頭份,2024-11-13,9296
2883,凱基金,18,0,18,凱基-頭份,2024-11-13,9296
00632R,元大台灣50反1,20,3,17,凱基-頭份,2024-11-13,9296
1449,佳和,18,2,16,凱基-頭份,2024-11-13,9296
00713,元大台灣高息低波,15,0,15,凱基-頭份,2024-11-13,9296
2609,陽明,16,4,12,凱基-頭份,2024-11-13,9296
8089,康全電訊,13,1,12,凱基-頭份,2024-11-13,9296
2324,仁寶,26,15,11,凱基-頭份,2024-11-13,9296
00905,FT臺灣Smart,10,0,10,凱基-頭份,2024-11-13,9296
1308,亞聚,25,15,10,凱基-頭份,2024-11-13,9296
2106,建大,10,0,10,凱基-頭份,2024-11-13,9296
2834,臺企銀,10,1,9,凱基-頭份,2024-11-13,9296
2303,聯電,8,0,8,凱基-頭份,2024-11-13,9296
2392,正崴,15,7,8,凱基-頭份,2024-11-13,9296
5871,中租-KY,8,0,8,凱基-頭份,2024-11-13,9296
2449,京元電子,8,1,7,凱基-頭份,2024-11-13,9296
2317,鴻海,8,2,6,凱基-頭份,2024-11-13,9296
00946,群益科技高息成長,6,0,6,凱基-頭份,2024-11-13,9296
1714,和桐,6,0,6,凱基-頭份,2024-11-13,9296
5434,崇越,6,0,6,凱基-頭份,2024-11-13,9296
2882,國泰金,5,0,5,凱基-頭份,2024-11-13,9296
00915,凱基優選高股息30,5,0,5,凱基-頭份,2024-11-13,9296
3450,聯鈞,8,3,5,凱基-頭份,2024-11-13,9296
00900,富邦特選高股息30,5,0,5,凱基-頭份,2024-11-13,9296
1524,耿鼎,18,13,5,凱基-頭份,2024-11-13,9296
1809,中釉,5,0,5,凱基-頭份,2024-11-13,9296
2103,台橡,5,0,5,凱基-頭份,2024-11-13,9296
2489,瑞軒,5,0,5,凱基-頭份,2024-11-13,9296
3710,連展投控,5,0,5,凱基-頭份,2024-11-13,9296
6669,緯穎,12,7,5,凱基-頭份,2024-11-13,9296
2344,華邦電,7,3,4,凱基-頭份,2024-11-13,9296
2387,精元,4,0,4,凱基-頭份,2024-11-13,9296
3013,晟銘電,7,3,4,凱基-頭份,2024-11-13,9296
3607,谷崧,4,0,4,凱基-頭份,2024-11-13,9296
4562,穎漢,6,2,4,凱基-頭份,2024-11-13,9296
5202,力新,12,8,4,凱基-頭份,2024-11-13,9296
6695,芯鼎,6,2,4,凱基-頭份,2024-11-13,9296
9904,寶成,5,1,4,凱基-頭份,2024-11-13,9296
3583,辛耘,10,6,4,凱基-頭份,2024-11-13,9296
5880,合庫金,3,0,3,凱基-頭份,2024-11-13,9296
00878,國泰永續高股息,166,0,166,凱基-頭份,2024-11-14,9296
00632R,元大台灣50反1,160,4,156,凱基-頭份,2024-11-14,9296
6288,聯嘉,53,0,53,凱基-頭份,2024-11-14,9296
0056,元大高股息,39,1,38,凱基-頭份,2024-11-14,9296
00680L,元大美債20正2,33,0,33,凱基-頭份,2024-11-14,9296
00937B,群益ESG投等債20,29,0,29,凱基-頭份,2024-11-14,9296
8064,東捷,108,79,29,凱基-頭份,2024-11-14,9296
2027,大成鋼,22,0,22,凱基-頭份,2024-11-14,9296
00953B,群益優選非投等債,20,0,20,凱基-頭份,2024-11-14,9296
2101,南港,20,0,20,凱基-頭份,2024-11-14,9296
9946,三發地產,20,0,20,凱基-頭份,2024-11-14,9296
00738U,期元大道瓊白銀,18,0,18,凱基-頭份,2024-11-14,9296
5434,崇越,18,0,18,凱基-頭份,2024-11-14,9296
00919,群益台灣精選高息,18,0,18,凱基-頭份,2024-11-14,9296
3628,盈正,16,0,16,凱基-頭份,2024-11-14,9296
9904,寶成,22,6,16,凱基-頭份,2024-11-14,9296
6669,緯穎,19,3,16,凱基-頭份,2024-11-14,9296
00932,兆豐永續高息等權,15,0,15,凱基-頭份,2024-11-14,9296
8089,康全電訊,16,2,14,凱基-頭份,2024-11-14,9296
2312,金寶,27,14,13,凱基-頭份,2024-11-14,9296
00923,群益台ESG低碳50,12,0,12,凱基-頭份,2024-11-14,9296
00687B,國泰20年美債,14,2,12,凱基-頭份,2024-11-14,9296
2883,凱基金,12,0,12,凱基-頭份,2024-11-14,9296
00945B,凱基美國非投等債,12,0,12,凱基-頭份,2024-11-14,9296
00963,中信全球高股息,12,0,12,凱基-頭份,2024-11-14,9296
6770,力積電,13,2,11,凱基-頭份,2024-11-14,9296
2376,技嘉,11,0,11,凱基-頭份,2024-11-14,9296
2409,友達,10,0,10,凱基-頭份,2024-11-14,9296
2812,台中銀,10,0,10,凱基-頭份,2024-11-14,9296
8011,台通,10,0,10,凱基-頭份,2024-11-14,9296
00881,國泰台灣5G+,10,0,10,凱基-頭份,2024-11-14,9296
00950B,凱基A級公司債,10,0,10,凱基-頭份,2024-11-14,9296
2241,艾姆勒,10,0,10,凱基-頭份,2024-11-14,9296
2392,正崴,13,3,10,凱基-頭份,2024-11-14,9296
2303,聯電,13,4,9,凱基-頭份,2024-11-14,9296
2356,英業達,13,4,9,凱基-頭份,2024-11-14,9296
3597,映興,11,2,9,凱基-頭份,2024-11-14,9296
2317,鴻海,11,2,9,凱基-頭份,2024-11-14,9296
5488,松普,9,1,8,凱基-頭份,2024-11-14,9296
2892,第一金,7,0,7,凱基-頭份,2024-11-14,9296
3211,順達,11,4,7,凱基-頭份,2024-11-14,9296
00922,國泰台灣領袖50,7,0,7,凱基-頭份,2024-11-14,9296
00882,中信中國高股息,9,2,7,凱基-頭份,2024-11-14,9296
00891,中信關鍵半導體,6,0,6,凱基-頭份,2024-11-14,9296
1314,中石化,6,0,6,凱基-頭份,2024-11-14,9296
2349,錸德,9,3,6,凱基-頭份,2024-11-14,9296
8409,商之器,6,0,6,凱基-頭份,2024-11-14,9296
00713,元大台灣高息低波,6,0,6,凱基-頭份,2024-11-14,9296
2382,廣達,5,0,5,凱基-頭份,2024-11-14,9296
2884,玉山金,5,0,5,凱基-頭份,2024-11-14,9296
2357,華碩,87,5,82,凱基-頭份,2024-11-15,9296
00929,復華台灣科技優息,63,8,55,凱基-頭份,2024-11-15,9296
00712,復華富時不動產,50,0,50,凱基-頭份,2024-11-15,9296
00878,國泰永續高股息,98,52,46,凱基-頭份,2024-11-15,9296
3710,連展投控,41,0,41,凱基-頭份,2024-11-15,9296
2027,大成鋼,40,0,40,凱基-頭份,2024-11-15,9296
2883,凱基金,42,10,32,凱基-頭份,2024-11-15,9296
2317,鴻海,82,54,28,凱基-頭份,2024-11-15,9296
00950B,凱基A級公司債,25,0,25,凱基-頭份,2024-11-15,9296
2204,中華,25,5,20,凱基-頭份,2024-11-15,9296
5324,士開,20,0,20,凱基-頭份,2024-11-15,9296
00738U,期元大道瓊白銀,18,0,18,凱基-頭份,2024-11-15,9296
3015,全漢,17,0,17,凱基-頭份,2024-11-15,9296
6153,嘉聯益,16,0,16,凱基-頭份,2024-11-15,9296
1815,富喬,15,0,15,凱基-頭份,2024-11-15,9296
00887,永豐中國科技50大,23,9,14,凱基-頭份,2024-11-15,9296
00731,復華富時高息低波,14,0,14,凱基-頭份,2024-11-15,9296
0056,元大高股息,13,0,13,凱基-頭份,2024-11-15,9296
00637L,元大滬深300正2,19,8,11,凱基-頭份,2024-11-15,9296
00963,中信全球高股息,11,0,11,凱基-頭份,2024-11-15,9296
00898,國泰基因免疫革命,10,0,10,凱基-頭份,2024-11-15,9296
00646,元大S＆P500,10,0,10,凱基-頭份,2024-11-15,9296
6462,神盾,10,1,9,凱基-頭份,2024-11-15,9296
2382,廣達,10,1,9,凱基-頭份,2024-11-15,9296
6217,中探針,8,0,8,凱基-頭份,2024-11-15,9296
1528,恩德,9,2,7,凱基-頭份,2024-11-15,9296
3706,神達,39,33,6,凱基-頭份,2024-11-15,9296
1702,南僑,6,0,6,凱基-頭份,2024-11-15,9296
5880,合庫金,6,0,6,凱基-頭份,2024-11-15,9296
8033,雷虎,6,0,6,凱基-頭份,2024-11-15,9296
8076,伍豐,6,0,6,凱基-頭份,2024-11-15,9296
2303,聯電,7,1,6,凱基-頭份,2024-11-15,9296
3481,群創,11,5,6,凱基-頭份,2024-11-15,9296
2409,友達,5,0,5,凱基-頭份,2024-11-15,9296
3027,盛達,5,0,5,凱基-頭份,2024-11-15,9296
6282,康舒,6,1,5,凱基-頭份,2024-11-15,9296
2542,興富發,6,1,5,凱基-頭份,2024-11-15,9296
6456,GIS-KY,5,0,5,凱基-頭份,2024-11-15,9296
6530,創威,19,14,5,凱基-頭份,2024-11-15,9296
5452,佶優,4,0,4,凱基-頭份,2024-11-15,9296
00679B,元大美債20年,6,2,4,凱基-頭份,2024-11-15,9296
2356,英業達,4,0,4,凱基-頭份,2024-11-15,9296
2489,瑞軒,4,0,4,凱基-頭份,2024-11-15,9296
5388,中磊,4,0,4,凱基-頭份,2024-11-15,9296
2330,台積電,4,1,3,凱基-頭份,2024-11-15,9296
2887,台新金,3,0,3,凱基-頭份,2024-11-15,9296
2493,揚博,3,0,3,凱基-頭份,2024-11-15,9296
4746,台耀,3,0,3,凱基-頭份,2024-11-15,9296
4931,新盛力,3,0,3,凱基-頭份,2024-11-15,9296
6485,點序,3,0,3,凱基-頭份,2024-11-15,9296
9904,寶成,171,3,168,凱基-頭份,2024-11-18,9296
00878,國泰永續高股息,124,0,124,凱基-頭份,2024-11-18,9296
3704,合勤控,46,1,45,凱基-頭份,2024-11-18,9296
00632R,元大台灣50反1,40,1,39,凱基-頭份,2024-11-18,9296
00932,兆豐永續高息等權,36,0,36,凱基-頭份,2024-11-18,9296
0056,元大高股息,36,0,36,凱基-頭份,2024-11-18,9296
1446,宏和,22,0,22,凱基-頭份,2024-11-18,9296
00665L,富邦�琤肭磪囓�2,21,0,21,凱基-頭份,2024-11-18,9296
2718,全心投控,21,0,21,凱基-頭份,2024-11-18,9296
1605,華新,20,0,20,凱基-頭份,2024-11-18,9296
00738U,期元大道瓊白銀,16,0,16,凱基-頭份,2024-11-18,9296
2204,中華,15,0,15,凱基-頭份,2024-11-18,9296
00937B,群益ESG投等債20,12,0,12,凱基-頭份,2024-11-18,9296
3406,玉晶光,12,0,12,凱基-頭份,2024-11-18,9296
00918,大華優利高填息30,11,0,11,凱基-頭份,2024-11-18,9296
2312,金寶,20,10,10,凱基-頭份,2024-11-18,9296
2405,輔信,10,0,10,凱基-頭份,2024-11-18,9296
2504,國產,10,0,10,凱基-頭份,2024-11-18,9296
00959B,大華投等美債15Y+,10,0,10,凱基-頭份,2024-11-18,9296
2520,冠德,20,10,10,凱基-頭份,2024-11-18,9296
3491,昇達科,10,0,10,凱基-頭份,2024-11-18,9296
9105,泰金寶-DR,12,2,10,凱基-頭份,2024-11-18,9296
00731,復華富時高息低波,8,0,8,凱基-頭份,2024-11-18,9296
00887,永豐中國科技50大,14,6,8,凱基-頭份,2024-11-18,9296
2353,宏��,8,0,8,凱基-頭份,2024-11-18,9296
00919,群益台灣精選高息,10,2,8,凱基-頭份,2024-11-18,9296
6462,神盾,7,0,7,凱基-頭份,2024-11-18,9296
6153,嘉聯益,6,0,6,凱基-頭份,2024-11-18,9296
00637L,元大滬深300正2,15,9,6,凱基-頭份,2024-11-18,9296
8028,昇陽半導體,6,0,6,凱基-頭份,2024-11-18,9296
8044,網家,75,69,6,凱基-頭份,2024-11-18,9296
00891,中信關鍵半導體,5,0,5,凱基-頭份,2024-11-18,9296
3090,日電貿,25,20,5,凱基-頭份,2024-11-18,9296
3209,全科,5,0,5,凱基-頭份,2024-11-18,9296
6282,康舒,5,0,5,凱基-頭份,2024-11-18,9296
00690,兆豐藍籌30,5,0,5,凱基-頭份,2024-11-18,9296
1457,宜進,5,0,5,凱基-頭份,2024-11-18,9296
2408,南亞科,5,0,5,凱基-頭份,2024-11-18,9296
2413,環科,5,0,5,凱基-頭份,2024-11-18,9296
3597,映興,5,0,5,凱基-頭份,2024-11-18,9296
5876,上海商銀,5,0,5,凱基-頭份,2024-11-18,9296
00713,元大台灣高息低波,4,0,4,凱基-頭份,2024-11-18,9296
2646,星宇航空,4,0,4,凱基-頭份,2024-11-18,9296
3645,達邁,4,0,4,凱基-頭份,2024-11-18,9296
5608,四維航,4,0,4,凱基-頭份,2024-11-18,9296
00881,國泰台灣5G+,4,0,4,凱基-頭份,2024-11-18,9296
00898,國泰基因免疫革命,4,0,4,凱基-頭份,2024-11-18,9296
3689,湧德,4,0,4,凱基-頭份,2024-11-18,9296
4919,新唐,4,1,3,凱基-頭份,2024-11-18,9296
3374,精材,5,2,3,凱基-頭份,2024-11-18,9296
2883,凱基金,1080,0,1080,凱基-頭份,2024-11-19,9296
00637L,元大滬深300正2,102,5,97,凱基-頭份,2024-11-19,9296
00632R,元大台灣50反1,60,1,59,凱基-頭份,2024-11-19,9296
00878,國泰永續高股息,58,2,56,凱基-頭份,2024-11-19,9296
00951,台新日本半導體,40,0,40,凱基-頭份,2024-11-19,9296
00915,凱基優選高股息30,39,1,38,凱基-頭份,2024-11-19,9296
00932,兆豐永續高息等權,36,0,36,凱基-頭份,2024-11-19,9296
1229,聯華,33,0,33,凱基-頭份,2024-11-19,9296
0056,元大高股息,35,4,31,凱基-頭份,2024-11-19,9296
3032,偉訓,34,6,28,凱基-頭份,2024-11-19,9296
2317,鴻海,39,12,27,凱基-頭份,2024-11-19,9296
2363,矽統,36,12,24,凱基-頭份,2024-11-19,9296
2027,大成鋼,22,1,21,凱基-頭份,2024-11-19,9296
4763,材料-KY,16,0,16,凱基-頭份,2024-11-19,9296
00887,永豐中國科技50大,16,0,16,凱基-頭份,2024-11-19,9296
1446,宏和,17,1,16,凱基-頭份,2024-11-19,9296
3481,群創,21,6,15,凱基-頭份,2024-11-19,9296
3406,玉晶光,11,0,11,凱基-頭份,2024-11-19,9296
3450,聯鈞,18,7,11,凱基-頭份,2024-11-19,9296
00947,台新臺灣IC設計,10,0,10,凱基-頭份,2024-11-19,9296
5531,鄉林,10,0,10,凱基-頭份,2024-11-19,9296
2332,友訊,10,1,9,凱基-頭份,2024-11-19,9296
3128,昇銳,9,0,9,凱基-頭份,2024-11-19,9296
9105,泰金寶-DR,40,31,9,凱基-頭份,2024-11-19,9296
2349,錸德,30,22,8,凱基-頭份,2024-11-19,9296
2382,廣達,7,1,6,凱基-頭份,2024-11-19,9296
00679B,元大美債20年,11,5,6,凱基-頭份,2024-11-19,9296
00953B,群益優選非投等債,6,0,6,凱基-頭份,2024-11-19,9296
2392,正崴,38,32,6,凱基-頭份,2024-11-19,9296
1314,中石化,5,0,5,凱基-頭份,2024-11-19,9296
1301,台塑,5,0,5,凱基-頭份,2024-11-19,9296
2206,三陽工業,6,1,5,凱基-頭份,2024-11-19,9296
2312,金寶,24,19,5,凱基-頭份,2024-11-19,9296
2355,敬鵬,5,0,5,凱基-頭份,2024-11-19,9296
2718,全心投控,5,0,5,凱基-頭份,2024-11-19,9296
3710,連展投控,5,0,5,凱基-頭份,2024-11-19,9296
6133,金橋,5,0,5,凱基-頭份,2024-11-19,9296
6220,岳豐,5,0,5,凱基-頭份,2024-11-19,9296
2337,旺宏,4,0,4,凱基-頭份,2024-11-19,9296
2405,輔信,4,0,4,凱基-頭份,2024-11-19,9296
2605,新興,7,3,4,凱基-頭份,2024-11-19,9296
8213,志超,4,0,4,凱基-頭份,2024-11-19,9296
2449,京元電子,6,2,4,凱基-頭份,2024-11-19,9296
2356,英業達,3,0,3,凱基-頭份,2024-11-19,9296
2399,映泰,3,0,3,凱基-頭份,2024-11-19,9296
2409,友達,6,3,3,凱基-頭份,2024-11-19,9296
2615,萬海,4,1,3,凱基-頭份,2024-11-19,9296
2891,中信金,3,0,3,凱基-頭份,2024-11-19,9296
3006,晶豪科,4,1,3,凱基-頭份,2024-11-19,9296
3025,星通,4,1,3,凱基-頭份,2024-11-19,9296
2392,正崴,121,0,121,凱基-頭份,2024-11-20,9296
00687B,國泰20年美債,101,0,101,凱基-頭份,2024-11-20,9296
2344,華邦電,104,12,92,凱基-頭份,2024-11-20,9296
9904,寶成,389,340,49,凱基-頭份,2024-11-20,9296
2354,鴻準,45,7,38,凱基-頭份,2024-11-20,9296
00919,群益台灣精選高息,53,16,37,凱基-頭份,2024-11-20,9296
00878,國泰永續高股息,38,11,27,凱基-頭份,2024-11-20,9296
00937B,群益ESG投等債20,22,0,22,凱基-頭份,2024-11-20,9296
3231,緯創,22,1,21,凱基-頭份,2024-11-20,9296
00881,國泰台灣5G+,21,0,21,凱基-頭份,2024-11-20,9296
5519,隆大,19,0,19,凱基-頭份,2024-11-20,9296
2312,金寶,17,1,16,凱基-頭份,2024-11-20,9296
0056,元大高股息,26,12,14,凱基-頭份,2024-11-20,9296
00639,富邦深100,20,7,13,凱基-頭份,2024-11-20,9296
2605,新興,12,0,12,凱基-頭份,2024-11-20,9296
2367,燿華,11,0,11,凱基-頭份,2024-11-20,9296
2330,台積電,11,0,11,凱基-頭份,2024-11-20,9296
2308,台達電,10,0,10,凱基-頭份,2024-11-20,9296
3322,建舜電,10,0,10,凱基-頭份,2024-11-20,9296
5009,榮剛,10,0,10,凱基-頭份,2024-11-20,9296
00898,國泰基因免疫革命,10,0,10,凱基-頭份,2024-11-20,9296
2303,聯電,10,0,10,凱基-頭份,2024-11-20,9296
2357,華碩,42,32,10,凱基-頭份,2024-11-20,9296
6264,富裔,10,0,10,凱基-頭份,2024-11-20,9296
2882,國泰金,8,0,8,凱基-頭份,2024-11-20,9296
5315,光聯,8,0,8,凱基-頭份,2024-11-20,9296
2409,友達,7,0,7,凱基-頭份,2024-11-20,9296
00951,台新日本半導體,7,0,7,凱基-頭份,2024-11-20,9296
00631L,元大台灣50正2,7,0,7,凱基-頭份,2024-11-20,9296
9906,欣巴巴,7,0,7,凱基-頭份,2024-11-20,9296
3628,盈正,7,0,7,凱基-頭份,2024-11-20,9296
2002,中鋼,6,0,6,凱基-頭份,2024-11-20,9296
00708L,期元大S＆P黃金正2,6,0,6,凱基-頭份,2024-11-20,9296
2718,全心投控,6,0,6,凱基-頭份,2024-11-20,9296
3167,大量,6,0,6,凱基-頭份,2024-11-20,9296
5243,乙盛-KY,6,0,6,凱基-頭份,2024-11-20,9296
2887,台新金,5,0,5,凱基-頭份,2024-11-20,9296
2834,臺企銀,5,0,5,凱基-頭份,2024-11-20,9296
4746,台耀,5,0,5,凱基-頭份,2024-11-20,9296
5309,系統電,6,1,5,凱基-頭份,2024-11-20,9296
1301,台塑,5,0,5,凱基-頭份,2024-11-20,9296
2105,正新,5,0,5,凱基-頭份,2024-11-20,9296
2353,宏��,5,0,5,凱基-頭份,2024-11-20,9296
3293,鈊象,4,0,4,凱基-頭份,2024-11-20,9296
2337,旺宏,4,0,4,凱基-頭份,2024-11-20,9296
3290,東浦,4,0,4,凱基-頭份,2024-11-20,9296
4979,華星光,9,5,4,凱基-頭份,2024-11-20,9296
6104,創惟,4,0,4,凱基-頭份,2024-11-20,9296
1569,濱川,11,7,4,凱基-頭份,2024-11-20,9296
3406,玉晶光,4,0,4,凱基-頭份,2024-11-20,9296
2882,國泰金,121,5,116,凱基-頭份,2024-11-21,9296
00948B,中信優息投資級債,62,0,62,凱基-頭份,2024-11-21,9296
0056,元大高股息,40,0,40,凱基-頭份,2024-11-21,9296
00918,大華優利高填息30,23,0,23,凱基-頭份,2024-11-21,9296
2027,大成鋼,21,0,21,凱基-頭份,2024-11-21,9296
00878,國泰永續高股息,25,5,20,凱基-頭份,2024-11-21,9296
00664R,國泰臺灣加權反1,20,0,20,凱基-頭份,2024-11-21,9296
00632R,元大台灣50反1,20,8,12,凱基-頭份,2024-11-21,9296
2204,中華,34,22,12,凱基-頭份,2024-11-21,9296
1569,濱川,36,25,11,凱基-頭份,2024-11-21,9296
00909,國泰數位支付服務,10,0,10,凱基-頭份,2024-11-21,9296
2317,鴻海,10,0,10,凱基-頭份,2024-11-21,9296
00950B,凱基A級公司債,10,1,9,凱基-頭份,2024-11-21,9296
3373,熱映,8,0,8,凱基-頭份,2024-11-21,9296
3625,西勝,10,2,8,凱基-頭份,2024-11-21,9296
2353,宏��,10,2,8,凱基-頭份,2024-11-21,9296
3005,神基,8,0,8,凱基-頭份,2024-11-21,9296
2357,華碩,10,3,7,凱基-頭份,2024-11-21,9296
2345,智邦,19,12,7,凱基-頭份,2024-11-21,9296
2886,兆豐金,7,0,7,凱基-頭份,2024-11-21,9296
0050,元大台灣50,7,0,7,凱基-頭份,2024-11-21,9296
00915,凱基優選高股息30,6,0,6,凱基-頭份,2024-11-21,9296
2105,正新,6,0,6,凱基-頭份,2024-11-21,9296
00712,復華富時不動產,5,0,5,凱基-頭份,2024-11-21,9296
2890,永豐金,11,6,5,凱基-頭份,2024-11-21,9296
1536,和大,5,0,5,凱基-頭份,2024-11-21,9296
3710,連展投控,5,0,5,凱基-頭份,2024-11-21,9296
6530,創威,10,5,5,凱基-頭份,2024-11-21,9296
8011,台通,4,0,4,凱基-頭份,2024-11-21,9296
1301,台塑,4,0,4,凱基-頭份,2024-11-21,9296
2387,精元,4,0,4,凱基-頭份,2024-11-21,9296
4123,晟德,7,3,4,凱基-頭份,2024-11-21,9296
6139,亞翔,7,3,4,凱基-頭份,2024-11-21,9296
3264,欣銓,3,0,3,凱基-頭份,2024-11-21,9296
00713,元大台灣高息低波,3,0,3,凱基-頭份,2024-11-21,9296
2881,富邦金,3,0,3,凱基-頭份,2024-11-21,9296
1904,正隆,3,0,3,凱基-頭份,2024-11-21,9296
6282,康舒,3,0,3,凱基-頭份,2024-11-21,9296
00881,國泰台灣5G+,3,0,3,凱基-頭份,2024-11-21,9296
00922,國泰台灣領袖50,3,0,3,凱基-頭份,2024-11-21,9296
1305,華夏,3,0,3,凱基-頭份,2024-11-21,9296
2349,錸德,9,6,3,凱基-頭份,2024-11-21,9296
2354,鴻準,15,12,3,凱基-頭份,2024-11-21,9296
2615,萬海,10,7,3,凱基-頭份,2024-11-21,9296
6757,台灣虎航,3,0,3,凱基-頭份,2024-11-21,9296
6187,萬潤,3,0,3,凱基-頭份,2024-11-21,9296
006208,富邦台50,3,0,3,凱基-頭份,2024-11-21,9296
2330,台積電,3,0,3,凱基-頭份,2024-11-21,9296
2603,長榮,3,1,2,凱基-頭份,2024-11-21,9296
2002,中鋼,2,0,2,凱基-頭份,2024-11-21,9296
9904,寶成,185,1,184,凱基-頭份,2024-11-22,9296
00637L,元大滬深300正2,89,5,84,凱基-頭份,2024-11-22,9296
9105,泰金寶-DR,68,6,62,凱基-頭份,2024-11-22,9296
2357,華碩,53,1,52,凱基-頭份,2024-11-22,9296
00878,國泰永續高股息,52,7,45,凱基-頭份,2024-11-22,9296
00919,群益台灣精選高息,31,1,30,凱基-頭份,2024-11-22,9296
00664R,國泰臺灣加權反1,30,0,30,凱基-頭份,2024-11-22,9296
00632R,元大台灣50反1,30,1,29,凱基-頭份,2024-11-22,9296
2303,聯電,27,0,27,凱基-頭份,2024-11-22,9296
9945,潤泰新,25,0,25,凱基-頭份,2024-11-22,9296
1605,華新,24,0,24,凱基-頭份,2024-11-22,9296
3511,矽瑪,127,103,24,凱基-頭份,2024-11-22,9296
2881,富邦金,12,0,12,凱基-頭份,2024-11-22,9296
2605,新興,10,0,10,凱基-頭份,2024-11-22,9296
2801,彰銀,10,0,10,凱基-頭份,2024-11-22,9296
00915,凱基優選高股息30,10,0,10,凱基-頭份,2024-11-22,9296
3047,訊舟,8,0,8,凱基-頭份,2024-11-22,9296
6213,聯茂,8,0,8,凱基-頭份,2024-11-22,9296
2204,中華,7,0,7,凱基-頭份,2024-11-22,9296
3025,星通,8,1,7,凱基-頭份,2024-11-22,9296
3264,欣銓,7,0,7,凱基-頭份,2024-11-22,9296
3227,原相,6,0,6,凱基-頭份,2024-11-22,9296
1781,合世,5,0,5,凱基-頭份,2024-11-22,9296
1301,台塑,5,0,5,凱基-頭份,2024-11-22,9296
4534,慶騰,5,0,5,凱基-頭份,2024-11-22,9296
6153,嘉聯益,5,0,5,凱基-頭份,2024-11-22,9296
6456,GIS-KY,5,0,5,凱基-頭份,2024-11-22,9296
8044,網家,5,0,5,凱基-頭份,2024-11-22,9296
2317,鴻海,7,2,5,凱基-頭份,2024-11-22,9296
3005,神基,4,0,4,凱基-頭份,2024-11-22,9296
6128,上福,4,0,4,凱基-頭份,2024-11-22,9296
8163,達方,5,1,4,凱基-頭份,2024-11-22,9296
6763,綠界科技*,3,0,3,凱基-頭份,2024-11-22,9296
006208,富邦台50,3,0,3,凱基-頭份,2024-11-22,9296
00679B,元大美債20年,3,0,3,凱基-頭份,2024-11-22,9296
1504,東元,3,0,3,凱基-頭份,2024-11-22,9296
2371,大同,7,4,3,凱基-頭份,2024-11-22,9296
3090,日電貿,5,2,3,凱基-頭份,2024-11-22,9296
3189,景碩,4,1,3,凱基-頭份,2024-11-22,9296
3580,友威科,3,0,3,凱基-頭份,2024-11-22,9296
5345,天揚,3,0,3,凱基-頭份,2024-11-22,9296
8096,擎亞,3,0,3,凱基-頭份,2024-11-22,9296
2890,永豐金,3,0,3,凱基-頭份,2024-11-22,9296
2409,友達,4,2,2,凱基-頭份,2024-11-22,9296
4128,中天,2,0,2,凱基-頭份,2024-11-22,9296
8171,天宇,2,0,2,凱基-頭份,2024-11-22,9296
00932,兆豐永續高息等權,2,0,2,凱基-頭份,2024-11-22,9296
1216,統一,2,0,2,凱基-頭份,2024-11-22,9296
006205,富邦上証,2,0,2,凱基-頭份,2024-11-22,9296
00633L,富邦上証正2,2,0,2,凱基-頭份,2024-11-22,9296
00712,復華富時不動產,100,0,100,凱基-頭份,2024-11-25,9296
00930,永豐ESG低碳高息,84,0,84,凱基-頭份,2024-11-25,9296
00671R,富邦NASDAQ反1,35,0,35,凱基-頭份,2024-11-25,9296
3003,健和興,21,0,21,凱基-頭份,2024-11-25,9296
2402,毅嘉,20,0,20,凱基-頭份,2024-11-25,9296
2444,兆勁,20,0,20,凱基-頭份,2024-11-25,9296
3032,偉訓,20,0,20,凱基-頭份,2024-11-25,9296
2405,輔信,18,0,18,凱基-頭份,2024-11-25,9296
00918,大華優利高填息30,17,0,17,凱基-頭份,2024-11-25,9296
2603,長榮,17,1,16,凱基-頭份,2024-11-25,9296
6167,久正,15,0,15,凱基-頭份,2024-11-25,9296
2615,萬海,14,0,14,凱基-頭份,2024-11-25,9296
2495,普安,19,5,14,凱基-頭份,2024-11-25,9296
1569,濱川,13,0,13,凱基-頭份,2024-11-25,9296
5347,世界,13,0,13,凱基-頭份,2024-11-25,9296
3450,聯鈞,13,2,11,凱基-頭份,2024-11-25,9296
6125,廣運,11,0,11,凱基-頭份,2024-11-25,9296
00950B,凱基A級公司債,10,0,10,凱基-頭份,2024-11-25,9296
00664R,國泰臺灣加權反1,10,0,10,凱基-頭份,2024-11-25,9296
2605,新興,10,0,10,凱基-頭份,2024-11-25,9296
9105,泰金寶-DR,16,6,10,凱基-頭份,2024-11-25,9296
00919,群益台灣精選高息,11,1,10,凱基-頭份,2024-11-25,9296
2312,金寶,44,35,9,凱基-頭份,2024-11-25,9296
3114,好德,9,0,9,凱基-頭份,2024-11-25,9296
2867,三商壽,7,0,7,凱基-頭份,2024-11-25,9296
3015,全漢,7,0,7,凱基-頭份,2024-11-25,9296
3380,明泰,7,0,7,凱基-頭份,2024-11-25,9296
2027,大成鋼,11,5,6,凱基-頭份,2024-11-25,9296
6005,群益證,6,0,6,凱基-頭份,2024-11-25,9296
6173,信昌電,6,0,6,凱基-頭份,2024-11-25,9296
8213,志超,6,0,6,凱基-頭份,2024-11-25,9296
3374,精材,8,3,5,凱基-頭份,2024-11-25,9296
00679B,元大美債20年,6,1,5,凱基-頭份,2024-11-25,9296
1809,中釉,7,2,5,凱基-頭份,2024-11-25,9296
2105,正新,13,8,5,凱基-頭份,2024-11-25,9296
2449,京元電子,6,1,5,凱基-頭份,2024-11-25,9296
3149,正達,5,0,5,凱基-頭份,2024-11-25,9296
3625,西勝,5,0,5,凱基-頭份,2024-11-25,9296
4960,誠美材,5,0,5,凱基-頭份,2024-11-25,9296
6133,金橋,5,0,5,凱基-頭份,2024-11-25,9296
6282,康舒,6,1,5,凱基-頭份,2024-11-25,9296
00637L,元大滬深300正2,34,30,4,凱基-頭份,2024-11-25,9296
2332,友訊,10,6,4,凱基-頭份,2024-11-25,9296
2349,錸德,4,0,4,凱基-頭份,2024-11-25,9296
2371,大同,5,1,4,凱基-頭份,2024-11-25,9296
2889,國票金,4,0,4,凱基-頭份,2024-11-25,9296
6288,聯嘉,5,1,4,凱基-頭份,2024-11-25,9296
00937B,群益ESG投等債20,3,0,3,凱基-頭份,2024-11-25,9296
3706,神達,39,36,3,凱基-頭份,2024-11-25,9296
2344,華邦電,4,1,3,凱基-頭份,2024-11-25,9296
0056,元大高股息,67,12,55,凱基-頭份,2024-11-26,9296
9105,泰金寶-DR,78,25,53,凱基-頭份,2024-11-26,9296
00712,復華富時不動產,50,0,50,凱基-頭份,2024-11-26,9296
2303,聯電,54,7,47,凱基-頭份,2024-11-26,9296
8415,大國鋼,30,0,30,凱基-頭份,2024-11-26,9296
00951,台新日本半導體,26,0,26,凱基-頭份,2024-11-26,9296
2317,鴻海,31,7,24,凱基-頭份,2024-11-26,9296
2426,鼎元,19,0,19,凱基-頭份,2024-11-26,9296
2444,兆勁,18,0,18,凱基-頭份,2024-11-26,9296
2392,正崴,21,5,16,凱基-頭份,2024-11-26,9296
2887,台新金,12,0,12,凱基-頭份,2024-11-26,9296
2312,金寶,23,11,12,凱基-頭份,2024-11-26,9296
6264,富裔,12,0,12,凱基-頭份,2024-11-26,9296
00690,兆豐藍籌30,11,0,11,凱基-頭份,2024-11-26,9296
3231,緯創,11,1,10,凱基-頭份,2024-11-26,9296
3704,合勤控,10,0,10,凱基-頭份,2024-11-26,9296
00706L,期元大S＆P日圓正2,10,0,10,凱基-頭份,2024-11-26,9296
1618,合機,12,2,10,凱基-頭份,2024-11-26,9296
3167,大量,10,0,10,凱基-頭份,2024-11-26,9296
00878,國泰永續高股息,19,10,9,凱基-頭份,2024-11-26,9296
2615,萬海,9,1,8,凱基-頭份,2024-11-26,9296
3597,映興,11,3,8,凱基-頭份,2024-11-26,9296
2867,三商壽,6,0,6,凱基-頭份,2024-11-26,9296
3712,永崴投控,8,2,6,凱基-頭份,2024-11-26,9296
00891,中信關鍵半導體,6,0,6,凱基-頭份,2024-11-26,9296
00919,群益台灣精選高息,10,5,5,凱基-頭份,2024-11-26,9296
2344,華邦電,7,2,5,凱基-頭份,2024-11-26,9296
1785,光洋科,5,0,5,凱基-頭份,2024-11-26,9296
1504,東元,12,7,5,凱基-頭份,2024-11-26,9296
2498,宏達電,5,0,5,凱基-頭份,2024-11-26,9296
3710,連展投控,5,0,5,凱基-頭份,2024-11-26,9296
6005,群益證,5,0,5,凱基-頭份,2024-11-26,9296
00950B,凱基A級公司債,5,0,5,凱基-頭份,2024-11-26,9296
1595,川寶,5,0,5,凱基-頭份,2024-11-26,9296
006208,富邦台50,5,0,5,凱基-頭份,2024-11-26,9296
3293,鈊象,5,0,5,凱基-頭份,2024-11-26,9296
00675L,富邦臺灣加權正2,4,0,4,凱基-頭份,2024-11-26,9296
00915,凱基優選高股息30,4,0,4,凱基-頭份,2024-11-26,9296
4716,大立,4,0,4,凱基-頭份,2024-11-26,9296
6174,安��,4,0,4,凱基-頭份,2024-11-26,9296
2449,京元電子,4,1,3,凱基-頭份,2024-11-26,9296
1527,鑽全,3,0,3,凱基-頭份,2024-11-26,9296
2002,中鋼,3,0,3,凱基-頭份,2024-11-26,9296
2233,宇隆,3,0,3,凱基-頭份,2024-11-26,9296
2889,國票金,3,0,3,凱基-頭份,2024-11-26,9296
3707,漢磊,3,0,3,凱基-頭份,2024-11-26,9296
00930,永豐ESG低碳高息,3,0,3,凱基-頭份,2024-11-26,9296
00922,國泰台灣領袖50,3,0,3,凱基-頭份,2024-11-26,9296
00887,永豐中國科技50大,3,0,3,凱基-頭份,2024-11-26,9296
1449,佳和,3,0,3,凱基-頭份,2024-11-26,9296
00632R,元大台灣50反1,100,1,99,凱基-頭份,2024-11-27,9296
6288,聯嘉,51,0,51,凱基-頭份,2024-11-27,9296
2426,鼎元,49,0,49,凱基-頭份,2024-11-27,9296
00922,國泰台灣領袖50,45,0,45,凱基-頭份,2024-11-27,9296
1605,華新,42,0,42,凱基-頭份,2024-11-27,9296
00919,群益台灣精選高息,44,10,34,凱基-頭份,2024-11-27,9296
0056,元大高股息,34,2,32,凱基-頭份,2024-11-27,9296
6264,富裔,31,0,31,凱基-頭份,2024-11-27,9296
8415,大國鋼,30,0,30,凱基-頭份,2024-11-27,9296
9946,三發地產,30,0,30,凱基-頭份,2024-11-27,9296
00878,國泰永續高股息,29,0,29,凱基-頭份,2024-11-27,9296
00639,富邦深100,20,0,20,凱基-頭份,2024-11-27,9296
00950B,凱基A級公司債,18,0,18,凱基-頭份,2024-11-27,9296
1536,和大,18,2,16,凱基-頭份,2024-11-27,9296
2303,聯電,30,15,15,凱基-頭份,2024-11-27,9296
2444,兆勁,15,0,15,凱基-頭份,2024-11-27,9296
3090,日電貿,14,0,14,凱基-頭份,2024-11-27,9296
2609,陽明,16,3,13,凱基-頭份,2024-11-27,9296
2881,富邦金,13,0,13,凱基-頭份,2024-11-27,9296
3481,群創,11,0,11,凱基-頭份,2024-11-27,9296
00930,永豐ESG低碳高息,10,0,10,凱基-頭份,2024-11-27,9296
1326,台化,9,0,9,凱基-頭份,2024-11-27,9296
2371,大同,10,1,9,凱基-頭份,2024-11-27,9296
2888,新光金,9,0,9,凱基-頭份,2024-11-27,9296
6134,萬旭,9,0,9,凱基-頭份,2024-11-27,9296
9105,泰金寶-DR,10,1,9,凱基-頭份,2024-11-27,9296
1449,佳和,10,2,8,凱基-頭份,2024-11-27,9296
2615,萬海,9,1,8,凱基-頭份,2024-11-27,9296
2905,三商,8,0,8,凱基-頭份,2024-11-27,9296
00915,凱基優選高股息30,13,5,8,凱基-頭份,2024-11-27,9296
00940,元大台灣價值高息,7,0,7,凱基-頭份,2024-11-27,9296
2344,華邦電,10,3,7,凱基-頭份,2024-11-27,9296
6104,創惟,8,1,7,凱基-頭份,2024-11-27,9296
2887Z1,台新己特,6,0,6,凱基-頭份,2024-11-27,9296
3062,建漢,17,11,6,凱基-頭份,2024-11-27,9296
00918,大華優利高填息30,6,0,6,凱基-頭份,2024-11-27,9296
3710,連展投控,6,0,6,凱基-頭份,2024-11-27,9296
00637L,元大滬深300正2,8,2,6,凱基-頭份,2024-11-27,9296
2328,廣宇,8,2,6,凱基-頭份,2024-11-27,9296
00929,復華台灣科技優息,11,6,5,凱基-頭份,2024-11-27,9296
00675L,富邦臺灣加權正2,5,0,5,凱基-頭份,2024-11-27,9296
2603,長榮,6,1,5,凱基-頭份,2024-11-27,9296
00891,中信關鍵半導體,5,0,5,凱基-頭份,2024-11-27,9296
00921,兆豐龍頭等權重,5,0,5,凱基-頭份,2024-11-27,9296
00881,國泰台灣5G+,5,0,5,凱基-頭份,2024-11-27,9296
00936,台新永續高息中小,5,0,5,凱基-頭份,2024-11-27,9296
2915,潤泰全,5,0,5,凱基-頭份,2024-11-27,9296
2330,台積電,4,0,4,凱基-頭份,2024-11-27,9296
00687B,國泰20年美債,8,4,4,凱基-頭份,2024-11-27,9296
2834,臺企銀,4,0,4,凱基-頭份,2024-11-27,9296
00878,國泰永續高股息,64,1,63,凱基-頭份,2024-11-28,9296
00919,群益台灣精選高息,32,0,32,凱基-頭份,2024-11-28,9296
00922,國泰台灣領袖50,31,0,31,凱基-頭份,2024-11-28,9296
00632R,元大台灣50反1,45,17,28,凱基-頭份,2024-11-28,9296
0056,元大高股息,24,0,24,凱基-頭份,2024-11-28,9296
1305,華夏,24,2,22,凱基-頭份,2024-11-28,9296
2409,友達,21,0,21,凱基-頭份,2024-11-28,9296
2345,智邦,21,1,20,凱基-頭份,2024-11-28,9296
00664R,國泰臺灣加權反1,20,0,20,凱基-頭份,2024-11-28,9296
2444,兆勁,18,0,18,凱基-頭份,2024-11-28,9296
00915,凱基優選高股息30,16,0,16,凱基-頭份,2024-11-28,9296
3706,神達,63,47,16,凱基-頭份,2024-11-28,9296
2392,正崴,13,1,12,凱基-頭份,2024-11-28,9296
4510,高鋒,44,33,11,凱基-頭份,2024-11-28,9296
00887,永豐中國科技50大,10,0,10,凱基-頭份,2024-11-28,9296
2323,中環,10,0,10,凱基-頭份,2024-11-28,9296
2363,矽統,10,0,10,凱基-頭份,2024-11-28,9296
3521,鴻翊,10,0,10,凱基-頭份,2024-11-28,9296
8027,鈦昇,10,0,10,凱基-頭份,2024-11-28,9296
00655L,國泰中國A50正2,9,0,9,凱基-頭份,2024-11-28,9296
3625,西勝,9,0,9,凱基-頭份,2024-11-28,9296
2354,鴻準,10,2,8,凱基-頭份,2024-11-28,9296
00881,國泰台灣5G+,8,0,8,凱基-頭份,2024-11-28,9296
2884,玉山金,7,0,7,凱基-頭份,2024-11-28,9296
2834,臺企銀,6,0,6,凱基-頭份,2024-11-28,9296
00918,大華優利高填息30,6,0,6,凱基-頭份,2024-11-28,9296
1504,東元,6,0,6,凱基-頭份,2024-11-28,9296
2820,華票,6,0,6,凱基-頭份,2024-11-28,9296
2867,三商壽,6,0,6,凱基-頭份,2024-11-28,9296
00669R,國泰美國道瓊反1,5,0,5,凱基-頭份,2024-11-28,9296
00905,FT臺灣Smart,5,0,5,凱基-頭份,2024-11-28,9296
00882,中信中國高股息,5,0,5,凱基-頭份,2024-11-28,9296
2105,正新,5,0,5,凱基-頭份,2024-11-28,9296
2204,中華,5,0,5,凱基-頭份,2024-11-28,9296
2887Z1,台新己特,5,0,5,凱基-頭份,2024-11-28,9296
3027,盛達,5,0,5,凱基-頭份,2024-11-28,9296
00940,元大台灣價值高息,10,6,4,凱基-頭份,2024-11-28,9296
00900,富邦特選高股息30,4,0,4,凱基-頭份,2024-11-28,9296
2891,中信金,10,6,4,凱基-頭份,2024-11-28,9296
5234,達興材料,4,0,4,凱基-頭份,2024-11-28,9296
2330,台積電,5,1,4,凱基-頭份,2024-11-28,9296
00936,台新永續高息中小,4,0,4,凱基-頭份,2024-11-28,9296
1605,華新,4,0,4,凱基-頭份,2024-11-28,9296
2340,台亞,4,0,4,凱基-頭份,2024-11-28,9296
2501,國建,4,0,4,凱基-頭份,2024-11-28,9296
3430,奇鈦科,4,0,4,凱基-頭份,2024-11-28,9296
4562,穎漢,5,1,4,凱基-頭份,2024-11-28,9296
6184,大豐電,4,0,4,凱基-頭份,2024-11-28,9296
9925,新保,4,0,4,凱基-頭份,2024-11-28,9296
4977,眾達-KY,4,1,3,凱基-頭份,2024-11-28,9296
00632R,元大台灣50反1,140,20,120,凱基-頭份,2024-11-29,9296
2363,矽統,29,1,28,凱基-頭份,2024-11-29,9296
00953B,群益優選非投等債,20,0,20,凱基-頭份,2024-11-29,9296
00948B,中信優息投資級債,20,0,20,凱基-頭份,2024-11-29,9296
00919,群益台灣精選高息,21,2,19,凱基-頭份,2024-11-29,9296
0056,元大高股息,14,2,12,凱基-頭份,2024-11-29,9296
2002,中鋼,11,0,11,凱基-頭份,2024-11-29,9296
3481,群創,14,3,11,凱基-頭份,2024-11-29,9296
2354,鴻準,23,13,10,凱基-頭份,2024-11-29,9296
2323,中環,10,0,10,凱基-頭份,2024-11-29,9296
3499,環天科,10,0,10,凱基-頭份,2024-11-29,9296
4807,日成-KY,10,0,10,凱基-頭份,2024-11-29,9296
8027,鈦昇,11,1,10,凱基-頭份,2024-11-29,9296
1301,台塑,9,0,9,凱基-頭份,2024-11-29,9296
2344,華邦電,11,2,9,凱基-頭份,2024-11-29,9296
3211,順達,14,5,9,凱基-頭份,2024-11-29,9296
00878,國泰永續高股息,19,11,8,凱基-頭份,2024-11-29,9296
2405,輔信,8,0,8,凱基-頭份,2024-11-29,9296
2444,兆勁,7,0,7,凱基-頭份,2024-11-29,9296
00915,凱基優選高股息30,6,0,6,凱基-頭份,2024-11-29,9296
6264,富裔,6,0,6,凱基-頭份,2024-11-29,9296
2105,正新,5,0,5,凱基-頭份,2024-11-29,9296
2615,萬海,9,4,5,凱基-頭份,2024-11-29,9296
3090,日電貿,15,10,5,凱基-頭份,2024-11-29,9296
6560,欣普羅,5,0,5,凱基-頭份,2024-11-29,9296
1305,華夏,4,0,4,凱基-頭份,2024-11-29,9296
2330,台積電,5,1,4,凱基-頭份,2024-11-29,9296
1449,佳和,4,0,4,凱基-頭份,2024-11-29,9296
1605,華新,4,0,4,凱基-頭份,2024-11-29,9296
2303,聯電,14,10,4,凱基-頭份,2024-11-29,9296
5452,佶優,4,0,4,凱基-頭份,2024-11-29,9296
3231,緯創,4,1,3,凱基-頭份,2024-11-29,9296
00690,兆豐藍籌30,8,5,3,凱基-頭份,2024-11-29,9296
2337,旺宏,3,0,3,凱基-頭份,2024-11-29,9296
2399,映泰,4,1,3,凱基-頭份,2024-11-29,9296
2603,長榮,3,0,3,凱基-頭份,2024-11-29,9296
2867,三商壽,3,0,3,凱基-頭份,2024-11-29,9296
3030,德律,3,0,3,凱基-頭份,2024-11-29,9296
3037,欣興,3,0,3,凱基-頭份,2024-11-29,9296
5345,天揚,3,0,3,凱基-頭份,2024-11-29,9296
5443,均豪,3,0,3,凱基-頭份,2024-11-29,9296
6174,安��,3,0,3,凱基-頭份,2024-11-29,9296
6265,方土昶,3,0,3,凱基-頭份,2024-11-29,9296
006208,富邦台50,3,0,3,凱基-頭份,2024-11-29,9296
00751B,元大AAA至A公司債,2,0,2,凱基-頭份,2024-11-29,9296
00715L,期街口布蘭特正2,2,0,2,凱基-頭份,2024-11-29,9296
1513,中興電,2,0,2,凱基-頭份,2024-11-29,9296
1808,潤隆,2,0,2,凱基-頭份,2024-11-29,9296
2014,中鴻,2,0,2,凱基-頭份,2024-11-29,9296
2023,燁輝,2,0,2,凱基-頭份,2024-11-29,9296
1314,中石化,106,0,106,凱基-頭份,2024-12-02,9296
00712,復華富時不動產,50,0,50,凱基-頭份,2024-12-02,9296
2867,三商壽,29,0,29,凱基-頭份,2024-12-02,9296
1708,東鹼,19,0,19,凱基-頭份,2024-12-02,9296
8929,富堡,16,0,16,凱基-頭份,2024-12-02,9296
2317,鴻海,14,0,14,凱基-頭份,2024-12-02,9296
00929,復華台灣科技優息,12,0,12,凱基-頭份,2024-12-02,9296
6770,力積電,13,2,11,凱基-頭份,2024-12-02,9296
4123,晟德,15,4,11,凱基-頭份,2024-12-02,9296
00637L,元大滬深300正2,27,17,10,凱基-頭份,2024-12-02,9296
00885,富邦越南,20,10,10,凱基-頭份,2024-12-02,9296
5880,合庫金,10,0,10,凱基-頭份,2024-12-02,9296
2312,金寶,11,2,9,凱基-頭份,2024-12-02,9296
6127,九豪,9,0,9,凱基-頭份,2024-12-02,9296
2444,兆勁,10,3,7,凱基-頭份,2024-12-02,9296
6174,安��,7,0,7,凱基-頭份,2024-12-02,9296
1308,亞聚,5,0,5,凱基-頭份,2024-12-02,9296
00882,中信中國高股息,5,0,5,凱基-頭份,2024-12-02,9296
00686R,群益臺灣加權反1,5,0,5,凱基-頭份,2024-12-02,9296
00738U,期元大道瓊白銀,5,0,5,凱基-頭份,2024-12-02,9296
1605,華新,6,1,5,凱基-頭份,2024-12-02,9296
2204,中華,5,0,5,凱基-頭份,2024-12-02,9296
2516,新建,5,0,5,凱基-頭份,2024-12-02,9296
3027,盛達,5,0,5,凱基-頭份,2024-12-02,9296
3303,岱稜,7,2,5,凱基-頭份,2024-12-02,9296
3511,矽瑪,5,0,5,凱基-頭份,2024-12-02,9296
5425,台半,5,0,5,凱基-頭份,2024-12-02,9296
6456,GIS-KY,5,0,5,凱基-頭份,2024-12-02,9296
3211,順達,8,4,4,凱基-頭份,2024-12-02,9296
1528,恩德,5,1,4,凱基-頭份,2024-12-02,9296
1540,喬福,4,0,4,凱基-頭份,2024-12-02,9296
2354,鴻準,16,12,4,凱基-頭份,2024-12-02,9296
3548,兆利,6,2,4,凱基-頭份,2024-12-02,9296
4726,永昕,4,0,4,凱基-頭份,2024-12-02,9296
5371,中光電,6,2,4,凱基-頭份,2024-12-02,9296
6668,中揚光,4,0,4,凱基-頭份,2024-12-02,9296
6838,台新藥,4,0,4,凱基-頭份,2024-12-02,9296
8937,合騏,4,0,4,凱基-頭份,2024-12-02,9296
00633L,富邦上証正2,3,0,3,凱基-頭份,2024-12-02,9296
00655L,國泰中國A50正2,5,2,3,凱基-頭份,2024-12-02,9296
1815,富喬,3,0,3,凱基-頭份,2024-12-02,9296
2337,旺宏,3,0,3,凱基-頭份,2024-12-02,9296
2429,銘旺科,8,5,3,凱基-頭份,2024-12-02,9296
2489,瑞軒,3,0,3,凱基-頭份,2024-12-02,9296
2609,陽明,6,3,3,凱基-頭份,2024-12-02,9296
2615,萬海,4,1,3,凱基-頭份,2024-12-02,9296
1301,台塑,5,2,3,凱基-頭份,2024-12-02,9296
6535,順藥,2,0,2,凱基-頭份,2024-12-02,9296
0056,元大高股息,3,1,2,凱基-頭份,2024-12-02,9296
00915,凱基優選高股息30,2,0,2,凱基-頭份,2024-12-02,9296
00919,群益台灣精選高息,140,3,137,凱基-頭份,2024-12-03,9296
00712,復華富時不動產,83,1,82,凱基-頭份,2024-12-03,9296
0056,元大高股息,36,1,35,凱基-頭份,2024-12-03,9296
00953B,群益優選非投等債,33,0,33,凱基-頭份,2024-12-03,9296
00947,台新臺灣IC設計,28,0,28,凱基-頭份,2024-12-03,9296
00948B,中信優息投資級債,25,1,24,凱基-頭份,2024-12-03,9296
00915,凱基優選高股息30,32,8,24,凱基-頭份,2024-12-03,9296
5439,高技,22,2,20,凱基-頭份,2024-12-03,9296
2887,台新金,21,2,19,凱基-頭份,2024-12-03,9296
2312,金寶,22,4,18,凱基-頭份,2024-12-03,9296
00950B,凱基A級公司債,15,0,15,凱基-頭份,2024-12-03,9296
2929,淘帝-KY,17,3,14,凱基-頭份,2024-12-03,9296
00878,國泰永續高股息,18,5,13,凱基-頭份,2024-12-03,9296
2357,華碩,14,2,12,凱基-頭份,2024-12-03,9296
8213,志超,12,0,12,凱基-頭份,2024-12-03,9296
00933B,國泰10Y+金融債,11,0,11,凱基-頭份,2024-12-03,9296
3450,聯鈞,14,3,11,凱基-頭份,2024-12-03,9296
00945B,凱基美國非投等債,10,0,10,凱基-頭份,2024-12-03,9296
3040,遠見,10,0,10,凱基-頭份,2024-12-03,9296
9946,三發地產,10,0,10,凱基-頭份,2024-12-03,9296
8028,昇陽半導體,9,0,9,凱基-頭份,2024-12-03,9296
2317,鴻海,11,2,9,凱基-頭份,2024-12-03,9296
2353,宏��,11,3,8,凱基-頭份,2024-12-03,9296
8171,天宇,6,0,6,凱基-頭份,2024-12-03,9296
2867,三商壽,6,0,6,凱基-頭份,2024-12-03,9296
00937B,群益ESG投等債20,15,9,6,凱基-頭份,2024-12-03,9296
3710,連展投控,5,0,5,凱基-頭份,2024-12-03,9296
00713,元大台灣高息低波,5,0,5,凱基-頭份,2024-12-03,9296
00650L,復華香港正2,5,0,5,凱基-頭份,2024-12-03,9296
2387,精元,6,1,5,凱基-頭份,2024-12-03,9296
4991,環宇-KY,10,5,5,凱基-頭份,2024-12-03,9296
8043,蜜望實,5,0,5,凱基-頭份,2024-12-03,9296
2886,兆豐金,5,0,5,凱基-頭份,2024-12-03,9296
2375,凱美,11,7,4,凱基-頭份,2024-12-03,9296
3019,亞光,4,0,4,凱基-頭份,2024-12-03,9296
3372,典範,5,1,4,凱基-頭份,2024-12-03,9296
2303,聯電,4,0,4,凱基-頭份,2024-12-03,9296
2392,正崴,5,1,4,凱基-頭份,2024-12-03,9296
3031,佰鴻,4,0,4,凱基-頭份,2024-12-03,9296
3231,緯創,7,4,3,凱基-頭份,2024-12-03,9296
1540,喬福,3,0,3,凱基-頭份,2024-12-03,9296
2834,臺企銀,5,2,3,凱基-頭份,2024-12-03,9296
3025,星通,7,4,3,凱基-頭份,2024-12-03,9296
3043,科風,3,0,3,凱基-頭份,2024-12-03,9296
3149,正達,3,0,3,凱基-頭份,2024-12-03,9296
5315,光聯,3,0,3,凱基-頭份,2024-12-03,9296
6770,力積電,15,12,3,凱基-頭份,2024-12-03,9296
1808,潤隆,3,0,3,凱基-頭份,2024-12-03,9296
2385,群光,3,0,3,凱基-頭份,2024-12-03,9296
3227,原相,3,0,3,凱基-頭份,2024-12-03,9296
00919,群益台灣精選高息,59,6,53,凱基-頭份,2024-12-04,9296
00878,國泰永續高股息,53,4,49,凱基-頭份,2024-12-04,9296
00953B,群益優選非投等債,43,0,43,凱基-頭份,2024-12-04,9296
3694,海華,35,5,30,凱基-頭份,2024-12-04,9296
9946,三發地產,30,0,30,凱基-頭份,2024-12-04,9296
2444,兆勁,31,2,29,凱基-頭份,2024-12-04,9296
2605,新興,24,0,24,凱基-頭份,2024-12-04,9296
00713,元大台灣高息低波,22,0,22,凱基-頭份,2024-12-04,9296
1605,華新,21,0,21,凱基-頭份,2024-12-04,9296
0056,元大高股息,17,0,17,凱基-頭份,2024-12-04,9296
2891,中信金,16,1,15,凱基-頭份,2024-12-04,9296
00915,凱基優選高股息30,15,0,15,凱基-頭份,2024-12-04,9296
1303,南亞,14,0,14,凱基-頭份,2024-12-04,9296
2312,金寶,14,3,11,凱基-頭份,2024-12-04,9296
5009,榮剛,10,0,10,凱基-頭份,2024-12-04,9296
6174,安��,10,0,10,凱基-頭份,2024-12-04,9296
6192,巨路,10,0,10,凱基-頭份,2024-12-04,9296
8121,越峰,10,0,10,凱基-頭份,2024-12-04,9296
3005,神基,10,1,9,凱基-頭份,2024-12-04,9296
00918,大華優利高填息30,9,0,9,凱基-頭份,2024-12-04,9296
5490,同亨,9,1,8,凱基-頭份,2024-12-04,9296
00887,永豐中國科技50大,7,0,7,凱基-頭份,2024-12-04,9296
2062,橋椿,7,0,7,凱基-頭份,2024-12-04,9296
6202,盛群,7,0,7,凱基-頭份,2024-12-04,9296
8213,志超,7,0,7,凱基-頭份,2024-12-04,9296
2615,萬海,7,1,6,凱基-頭份,2024-12-04,9296
1449,佳和,5,0,5,凱基-頭份,2024-12-04,9296
00945B,凱基美國非投等債,5,0,5,凱基-頭份,2024-12-04,9296
1714,和桐,5,0,5,凱基-頭份,2024-12-04,9296
3025,星通,14,9,5,凱基-頭份,2024-12-04,9296
3167,大量,5,0,5,凱基-頭份,2024-12-04,9296
3521,鴻翊,5,0,5,凱基-頭份,2024-12-04,9296
8043,蜜望實,5,0,5,凱基-頭份,2024-12-04,9296
2382,廣達,8,4,4,凱基-頭份,2024-12-04,9296
2353,宏��,6,2,4,凱基-頭份,2024-12-04,9296
6235,華孚,4,0,4,凱基-頭份,2024-12-04,9296
8038,長園科,4,0,4,凱基-頭份,2024-12-04,9296
9945,潤泰新,4,0,4,凱基-頭份,2024-12-04,9296
00679B,元大美債20年,11,8,3,凱基-頭份,2024-12-04,9296
00751B,元大AAA至A公司債,3,0,3,凱基-頭份,2024-12-04,9296
2449,京元電子,5,2,3,凱基-頭份,2024-12-04,9296
3706,神達,36,33,3,凱基-頭份,2024-12-04,9296
5309,系統電,8,5,3,凱基-頭份,2024-12-04,9296
2399,映泰,3,0,3,凱基-頭份,2024-12-04,9296
2464,盟立,3,0,3,凱基-頭份,2024-12-04,9296
4726,永昕,3,0,3,凱基-頭份,2024-12-04,9296
4904,遠傳,3,0,3,凱基-頭份,2024-12-04,9296
6757,台灣虎航,7,4,3,凱基-頭份,2024-12-04,9296
8176,智捷,3,0,3,凱基-頭份,2024-12-04,9296
2408,南亞科,3,0,3,凱基-頭份,2024-12-04,9296
00919,群益台灣精選高息,28,2,26,凱基-頭份,2024-12-05,9296
1708,東鹼,21,0,21,凱基-頭份,2024-12-05,9296
2337,旺宏,20,0,20,凱基-頭份,2024-12-05,9296
2206,三陽工業,16,0,16,凱基-頭份,2024-12-05,9296
00923,群益台ESG低碳50,17,2,15,凱基-頭份,2024-12-05,9296
1605,華新,15,0,15,凱基-頭份,2024-12-05,9296
4726,永昕,16,1,15,凱基-頭份,2024-12-05,9296
9105,泰金寶-DR,23,8,15,凱基-頭份,2024-12-05,9296
2392,正崴,16,2,14,凱基-頭份,2024-12-05,9296
5328,華容,12,0,12,凱基-頭份,2024-12-05,9296
3290,東浦,10,0,10,凱基-頭份,2024-12-05,9296
2312,金寶,14,5,9,凱基-頭份,2024-12-05,9296
5243,乙盛-KY,10,1,9,凱基-頭份,2024-12-05,9296
6558,興能高,18,9,9,凱基-頭份,2024-12-05,9296
8213,志超,9,0,9,凱基-頭份,2024-12-05,9296
00900,富邦特選高股息30,8,0,8,凱基-頭份,2024-12-05,9296
00953B,群益優選非投等債,8,0,8,凱基-頭份,2024-12-05,9296
6770,力積電,10,2,8,凱基-頭份,2024-12-05,9296
2344,華邦電,10,3,7,凱基-頭份,2024-12-05,9296
3450,聯鈞,17,10,7,凱基-頭份,2024-12-05,9296
2382,廣達,7,0,7,凱基-頭份,2024-12-05,9296
2317,鴻海,8,1,7,凱基-頭份,2024-12-05,9296
00915,凱基優選高股息30,6,0,6,凱基-頭份,2024-12-05,9296
2345,智邦,6,0,6,凱基-頭份,2024-12-05,9296
3548,兆利,15,9,6,凱基-頭份,2024-12-05,9296
2413,環科,6,0,6,凱基-頭份,2024-12-05,9296
3005,神基,6,1,5,凱基-頭份,2024-12-05,9296
2328,廣宇,5,0,5,凱基-頭份,2024-12-05,9296
3025,星通,17,12,5,凱基-頭份,2024-12-05,9296
4510,高鋒,5,0,5,凱基-頭份,2024-12-05,9296
6530,創威,12,7,5,凱基-頭份,2024-12-05,9296
8021,尖點,5,0,5,凱基-頭份,2024-12-05,9296
2449,京元電子,7,3,4,凱基-頭份,2024-12-05,9296
1326,台化,4,0,4,凱基-頭份,2024-12-05,9296
2363,矽統,4,0,4,凱基-頭份,2024-12-05,9296
6104,創惟,9,5,4,凱基-頭份,2024-12-05,9296
6163,華電網,4,0,4,凱基-頭份,2024-12-05,9296
00909,國泰數位支付服務,4,0,4,凱基-頭份,2024-12-05,9296
1319,東陽,4,0,4,凱基-頭份,2024-12-05,9296
1595,川寶,6,2,4,凱基-頭份,2024-12-05,9296
1802,台玻,4,0,4,凱基-頭份,2024-12-05,9296
2301,光寶科,4,0,4,凱基-頭份,2024-12-05,9296
6127,九豪,4,0,4,凱基-頭份,2024-12-05,9296
8111,立��,12,8,4,凱基-頭份,2024-12-05,9296
0056,元大高股息,4,0,4,凱基-頭份,2024-12-05,9296
2409,友達,3,0,3,凱基-頭份,2024-12-05,9296
3035,智原,3,0,3,凱基-頭份,2024-12-05,9296
3537,堡達,3,0,3,凱基-頭份,2024-12-05,9296
3710,連展投控,10,7,3,凱基-頭份,2024-12-05,9296
00738U,期元大道瓊白銀,3,0,3,凱基-頭份,2024-12-05,9296
00919,群益台灣精選高息,59,0,59,凱基-頭份,2024-12-06,9296
2344,華邦電,54,12,42,凱基-頭份,2024-12-06,9296
2610,華航,31,3,28,凱基-頭份,2024-12-06,9296
6264,富裔,26,0,26,凱基-頭份,2024-12-06,9296
00930,永豐ESG低碳高息,20,0,20,凱基-頭份,2024-12-06,9296
6218,豪勉,20,0,20,凱基-頭份,2024-12-06,9296
00953B,群益優選非投等債,16,0,16,凱基-頭份,2024-12-06,9296
2887E,台新戊特,16,0,16,凱基-頭份,2024-12-06,9296
00646,元大S＆P500,13,0,13,凱基-頭份,2024-12-06,9296
1464,得力,12,0,12,凱基-頭份,2024-12-06,9296
00882,中信中國高股息,11,0,11,凱基-頭份,2024-12-06,9296
8042,金山電,15,4,11,凱基-頭份,2024-12-06,9296
2415,錩新,10,0,10,凱基-頭份,2024-12-06,9296
2834,臺企銀,10,0,10,凱基-頭份,2024-12-06,9296
4909,新復興,13,4,9,凱基-頭份,2024-12-06,9296
9105,泰金寶-DR,10,1,9,凱基-頭份,2024-12-06,9296
00950B,凱基A級公司債,10,2,8,凱基-頭份,2024-12-06,9296
1815,富喬,10,2,8,凱基-頭份,2024-12-06,9296
8937,合騏,8,0,8,凱基-頭份,2024-12-06,9296
2542,興富發,8,1,7,凱基-頭份,2024-12-06,9296
3491,昇達科,7,0,7,凱基-頭份,2024-12-06,9296
2354,鴻準,26,20,6,凱基-頭份,2024-12-06,9296
2615,萬海,9,3,6,凱基-頭份,2024-12-06,9296
3088,艾訊,6,0,6,凱基-頭份,2024-12-06,9296
1605,華新,5,0,5,凱基-頭份,2024-12-06,9296
2312,金寶,9,4,5,凱基-頭份,2024-12-06,9296
2405,輔信,5,0,5,凱基-頭份,2024-12-06,9296
3711,日月光投控,5,0,5,凱基-頭份,2024-12-06,9296
6288,聯嘉,5,0,5,凱基-頭份,2024-12-06,9296
8429,金麗-KY,5,0,5,凱基-頭份,2024-12-06,9296
6703,軒郁,9,4,5,凱基-頭份,2024-12-06,9296
2345,智邦,7,3,4,凱基-頭份,2024-12-06,9296
00905,FT臺灣Smart,4,0,4,凱基-頭份,2024-12-06,9296
3591,艾笛森,5,1,4,凱基-頭份,2024-12-06,9296
8069,元太,4,0,4,凱基-頭份,2024-12-06,9296
1309,台達化,3,0,3,凱基-頭份,2024-12-06,9296
2062,橋椿,3,0,3,凱基-頭份,2024-12-06,9296
2204,中華,3,0,3,凱基-頭份,2024-12-06,9296
2362,藍天,3,0,3,凱基-頭份,2024-12-06,9296
2441,超豐,3,0,3,凱基-頭份,2024-12-06,9296
2634,漢翔,3,0,3,凱基-頭份,2024-12-06,9296
2867,三商壽,3,0,3,凱基-頭份,2024-12-06,9296
4956,光鋐,5,2,3,凱基-頭份,2024-12-06,9296
4966,譜瑞-KY,4,1,3,凱基-頭份,2024-12-06,9296
5345,天揚,3,0,3,凱基-頭份,2024-12-06,9296
6151,晉倫,3,0,3,凱基-頭份,2024-12-06,9296
6720,久昌,3,0,3,凱基-頭份,2024-12-06,9296
8213,志超,3,0,3,凱基-頭份,2024-12-06,9296
00909,國泰數位支付服務,3,0,3,凱基-頭份,2024-12-06,9296
00922,國泰台灣領袖50,2,0,2,凱基-頭份,2024-12-06,9296
00712,復華富時不動產,1673,0,1673,凱基-頭份,2024-12-09,9296
2801,彰銀,648,1,647,凱基-頭份,2024-12-09,9296
2880,華南金,198,0,198,凱基-頭份,2024-12-09,9296
2888,新光金,199,22,177,凱基-頭份,2024-12-09,9296
5876,上海商銀,128,0,128,凱基-頭份,2024-12-09,9296
00918,大華優利高填息30,84,0,84,凱基-頭份,2024-12-09,9296
1504,東元,83,0,83,凱基-頭份,2024-12-09,9296
00915,凱基優選高股息30,67,2,65,凱基-頭份,2024-12-09,9296
00878,國泰永續高股息,62,2,60,凱基-頭份,2024-12-09,9296
2542,興富發,59,6,53,凱基-頭份,2024-12-09,9296
00953B,群益優選非投等債,50,0,50,凱基-頭份,2024-12-09,9296
00919,群益台灣精選高息,29,0,29,凱基-頭份,2024-12-09,9296
0056,元大高股息,23,0,23,凱基-頭份,2024-12-09,9296
3593,力銘,20,0,20,凱基-頭份,2024-12-09,9296
2449,京元電子,15,1,14,凱基-頭份,2024-12-09,9296
2405,輔信,13,0,13,凱基-頭份,2024-12-09,9296
00951,台新日本半導體,12,0,12,凱基-頭份,2024-12-09,9296
3706,神達,31,19,12,凱基-頭份,2024-12-09,9296
2317,鴻海,11,0,11,凱基-頭份,2024-12-09,9296
00646,元大S＆P500,10,0,10,凱基-頭份,2024-12-09,9296
00642U,期元大S＆P石油,10,0,10,凱基-頭份,2024-12-09,9296
00926,凱基全球菁英55,10,0,10,凱基-頭份,2024-12-09,9296
8121,越峰,10,0,10,凱基-頭份,2024-12-09,9296
8358,金居,10,0,10,凱基-頭份,2024-12-09,9296
00922,國泰台灣領袖50,9,0,9,凱基-頭份,2024-12-09,9296
2409,友達,8,0,8,凱基-頭份,2024-12-09,9296
3450,聯鈞,12,4,8,凱基-頭份,2024-12-09,9296
9105,泰金寶-DR,10,2,8,凱基-頭份,2024-12-09,9296
4977,眾達-KY,8,1,7,凱基-頭份,2024-12-09,9296
6214,精誠,7,0,7,凱基-頭份,2024-12-09,9296
1308,亞聚,6,0,6,凱基-頭份,2024-12-09,9296
2324,仁寶,13,7,6,凱基-頭份,2024-12-09,9296
8937,合騏,6,0,6,凱基-頭份,2024-12-09,9296
2002,中鋼,5,0,5,凱基-頭份,2024-12-09,9296
0050,元大台灣50,5,0,5,凱基-頭份,2024-12-09,9296
1301,台塑,5,0,5,凱基-頭份,2024-12-09,9296
1447,力鵬,5,0,5,凱基-頭份,2024-12-09,9296
1464,得力,5,0,5,凱基-頭份,2024-12-09,9296
3303,岱稜,5,0,5,凱基-頭份,2024-12-09,9296
5443,均豪,5,0,5,凱基-頭份,2024-12-09,9296
6470,宇智,5,0,5,凱基-頭份,2024-12-09,9296
00757,統一FANG+,4,0,4,凱基-頭份,2024-12-09,9296
4979,華星光,10,6,4,凱基-頭份,2024-12-09,9296
00679B,元大美債20年,11,7,4,凱基-頭份,2024-12-09,9296
3234,光環,5,1,4,凱基-頭份,2024-12-09,9296
3481,群創,6,2,4,凱基-頭份,2024-12-09,9296
2453,凌群,4,1,3,凱基-頭份,2024-12-09,9296
2472,立隆電,3,0,3,凱基-頭份,2024-12-09,9296
00924,復華S＆P500成長,3,0,3,凱基-頭份,2024-12-09,9296
1785,光洋科,11,8,3,凱基-頭份,2024-12-09,9296
00918,大華優利高填息30,153,0,153,凱基-頭份,2024-12-10,9296
2888,新光金,99,1,98,凱基-頭份,2024-12-10,9296
1449,佳和,61,1,60,凱基-頭份,2024-12-10,9296
2887,台新金,47,1,46,凱基-頭份,2024-12-10,9296
0056,元大高股息,42,0,42,凱基-頭份,2024-12-10,9296
00948B,中信優息投資級債,35,0,35,凱基-頭份,2024-12-10,9296
00665L,富邦�琤肭磪囓�2,41,13,28,凱基-頭份,2024-12-10,9296
3706,神達,70,46,24,凱基-頭份,2024-12-10,9296
00915,凱基優選高股息30,27,4,23,凱基-頭份,2024-12-10,9296
1314,中石化,20,0,20,凱基-頭份,2024-12-10,9296
00937B,群益ESG投等債20,13,0,13,凱基-頭份,2024-12-10,9296
00919,群益台灣精選高息,18,6,12,凱基-頭份,2024-12-10,9296
5244,弘凱,12,0,12,凱基-頭份,2024-12-10,9296
5871,中租-KY,13,1,12,凱基-頭份,2024-12-10,9296
2515,中工,11,0,11,凱基-頭份,2024-12-10,9296
00646,元大S＆P500,10,0,10,凱基-頭份,2024-12-10,9296
00715L,期街口布蘭特正2,10,0,10,凱基-頭份,2024-12-10,9296
00953B,群益優選非投等債,10,0,10,凱基-頭份,2024-12-10,9296
2444,兆勁,10,0,10,凱基-頭份,2024-12-10,9296
3694,海華,14,4,10,凱基-頭份,2024-12-10,9296
3481,群創,51,41,10,凱基-頭份,2024-12-10,9296
2547,日勝生,8,0,8,凱基-頭份,2024-12-10,9296
5880,合庫金,8,0,8,凱基-頭份,2024-12-10,9296
2363,矽統,37,30,7,凱基-頭份,2024-12-10,9296
2313,華通,11,4,7,凱基-頭份,2024-12-10,9296
2867,三商壽,6,0,6,凱基-頭份,2024-12-10,9296
6438,迅得,6,0,6,凱基-頭份,2024-12-10,9296
2317,鴻海,7,2,5,凱基-頭份,2024-12-10,9296
3293,鈊象,5,0,5,凱基-頭份,2024-12-10,9296
00713,元大台灣高息低波,5,0,5,凱基-頭份,2024-12-10,9296
00753L,中信中國50正2,12,7,5,凱基-頭份,2024-12-10,9296
2105,正新,5,0,5,凱基-頭份,2024-12-10,9296
3011,今皓,5,0,5,凱基-頭份,2024-12-10,9296
3019,亞光,5,0,5,凱基-頭份,2024-12-10,9296
4960,誠美材,5,0,5,凱基-頭份,2024-12-10,9296
6456,GIS-KY,5,0,5,凱基-頭份,2024-12-10,9296
1301,台塑,11,6,5,凱基-頭份,2024-12-10,9296
2330,台積電,5,1,4,凱基-頭份,2024-12-10,9296
00936,台新永續高息中小,4,0,4,凱基-頭份,2024-12-10,9296
3036,文曄,4,0,4,凱基-頭份,2024-12-10,9296
6962,ITH-KY,4,0,4,凱基-頭份,2024-12-10,9296
8096,擎亞,7,3,4,凱基-頭份,2024-12-10,9296
00909,國泰數位支付服務,4,0,4,凱基-頭份,2024-12-10,9296
00922,國泰台灣領袖50,3,0,3,凱基-頭份,2024-12-10,9296
1446,宏和,3,0,3,凱基-頭份,2024-12-10,9296
1524,耿鼎,5,2,3,凱基-頭份,2024-12-10,9296
2462,良得電,3,0,3,凱基-頭份,2024-12-10,9296
2609,陽明,44,41,3,凱基-頭份,2024-12-10,9296
3025,星通,3,0,3,凱基-頭份,2024-12-10,9296
8936,國統,3,0,3,凱基-頭份,2024-12-10,9296
6770,力積電,125,15,110,凱基-頭份,2024-12-11,9296
00918,大華優利高填息30,48,0,48,凱基-頭份,2024-12-11,9296
1815,富喬,48,3,45,凱基-頭份,2024-12-11,9296
00919,群益台灣精選高息,30,0,30,凱基-頭份,2024-12-11,9296
5371,中光電,45,15,30,凱基-頭份,2024-12-11,9296
00878,國泰永續高股息,34,7,27,凱基-頭份,2024-12-11,9296
1316,上曜,25,0,25,凱基-頭份,2024-12-11,9296
00937B,群益ESG投等債20,24,0,24,凱基-頭份,2024-12-11,9296
3593,力銘,24,0,24,凱基-頭份,2024-12-11,9296
3710,連展投控,23,0,23,凱基-頭份,2024-12-11,9296
00915,凱基優選高股息30,19,0,19,凱基-頭份,2024-12-11,9296
3706,神達,41,27,14,凱基-頭份,2024-12-11,9296
6558,興能高,15,3,12,凱基-頭份,2024-12-11,9296
2002,中鋼,11,0,11,凱基-頭份,2024-12-11,9296
2609,陽明,25,14,11,凱基-頭份,2024-12-11,9296
6139,亞翔,12,1,11,凱基-頭份,2024-12-11,9296
00633L,富邦上証正2,10,0,10,凱基-頭份,2024-12-11,9296
1217,愛之味,10,0,10,凱基-頭份,2024-12-11,9296
2338,光罩,10,0,10,凱基-頭份,2024-12-11,9296
2605,新興,10,0,10,凱基-頭份,2024-12-11,9296
9946,三發地產,10,0,10,凱基-頭份,2024-12-11,9296
2317,鴻海,14,5,9,凱基-頭份,2024-12-11,9296
3323,加百裕,15,6,9,凱基-頭份,2024-12-11,9296
2303,聯電,8,0,8,凱基-頭份,2024-12-11,9296
8213,志超,8,0,8,凱基-頭份,2024-12-11,9296
1301,台塑,7,0,7,凱基-頭份,2024-12-11,9296
00953B,群益優選非投等債,7,0,7,凱基-頭份,2024-12-11,9296
2204,中華,8,1,7,凱基-頭份,2024-12-11,9296
2316,楠梓電,7,0,7,凱基-頭份,2024-12-11,9296
6742,澤米,7,0,7,凱基-頭份,2024-12-11,9296
8027,鈦昇,7,0,7,凱基-頭份,2024-12-11,9296
00713,元大台灣高息低波,7,0,7,凱基-頭份,2024-12-11,9296
00900,富邦特選高股息30,6,0,6,凱基-頭份,2024-12-11,9296
8068,全達,6,0,6,凱基-頭份,2024-12-11,9296
00761B,國泰A級公司債,5,0,5,凱基-頭份,2024-12-11,9296
1305,華夏,5,0,5,凱基-頭份,2024-12-11,9296
1734,杏輝,5,0,5,凱基-頭份,2024-12-11,9296
2105,正新,5,0,5,凱基-頭份,2024-12-11,9296
2340,台亞,5,0,5,凱基-頭份,2024-12-11,9296
3234,光環,6,1,5,凱基-頭份,2024-12-11,9296
6223,旺矽,5,0,5,凱基-頭份,2024-12-11,9296
00922,國泰台灣領袖50,4,0,4,凱基-頭份,2024-12-11,9296
2312,金寶,7,3,4,凱基-頭份,2024-12-11,9296
4746,台耀,4,0,4,凱基-頭份,2024-12-11,9296
0056,元大高股息,9,5,4,凱基-頭份,2024-12-11,9296
8028,昇陽半導體,3,0,3,凱基-頭份,2024-12-11,9296
1303,南亞,3,0,3,凱基-頭份,2024-12-11,9296
00637L,元大滬深300正2,3,0,3,凱基-頭份,2024-12-11,9296
00940,元大台灣價值高息,3,0,3,凱基-頭份,2024-12-11,9296
00936,台新永續高息中小,3,0,3,凱基-頭份,2024-12-11,9296
2834,臺企銀,500,0,500,凱基-頭份,2024-12-12,9296
00687B,國泰20年美債,115,46,69,凱基-頭份,2024-12-12,9296
5344,立衛,40,0,40,凱基-頭份,2024-12-12,9296
4909,新復興,32,0,32,凱基-頭份,2024-12-12,9296
00948B,中信優息投資級債,24,0,24,凱基-頭份,2024-12-12,9296
3694,海華,26,3,23,凱基-頭份,2024-12-12,9296
3593,力銘,21,0,21,凱基-頭份,2024-12-12,9296
6741,91APP*-KY,21,0,21,凱基-頭份,2024-12-12,9296
1815,富喬,20,0,20,凱基-頭份,2024-12-12,9296
2027,大成鋼,20,0,20,凱基-頭份,2024-12-12,9296
5871,中租-KY,20,0,20,凱基-頭份,2024-12-12,9296
00937B,群益ESG投等債20,22,2,20,凱基-頭份,2024-12-12,9296
2891,中信金,21,4,17,凱基-頭份,2024-12-12,9296
00919,群益台灣精選高息,19,4,15,凱基-頭份,2024-12-12,9296
2609,陽明,23,10,13,凱基-頭份,2024-12-12,9296
00915,凱基優選高股息30,15,2,13,凱基-頭份,2024-12-12,9296
00882,中信中國高股息,15,2,13,凱基-頭份,2024-12-12,9296
1817,凱撒衛,10,0,10,凱基-頭份,2024-12-12,9296
2323,中環,10,0,10,凱基-頭份,2024-12-12,9296
4934,太極,10,0,10,凱基-頭份,2024-12-12,9296
6192,巨路,10,0,10,凱基-頭份,2024-12-12,9296
3706,神達,113,104,9,凱基-頭份,2024-12-12,9296
1303,南亞,9,0,9,凱基-頭份,2024-12-12,9296
00918,大華優利高填息30,9,0,9,凱基-頭份,2024-12-12,9296
2002,中鋼,10,1,9,凱基-頭份,2024-12-12,9296
00857B,永豐20年美公債,8,0,8,凱基-頭份,2024-12-12,9296
0056,元大高股息,9,1,8,凱基-頭份,2024-12-12,9296
2353,宏��,7,0,7,凱基-頭份,2024-12-12,9296
2354,鴻準,18,11,7,凱基-頭份,2024-12-12,9296
6962,ITH-KY,7,0,7,凱基-頭份,2024-12-12,9296
2382,廣達,9,2,7,凱基-頭份,2024-12-12,9296
2362,藍天,6,0,6,凱基-頭份,2024-12-12,9296
3356,奇偶,5,0,5,凱基-頭份,2024-12-12,9296
2312,金寶,24,19,5,凱基-頭份,2024-12-12,9296
3490,單井,5,0,5,凱基-頭份,2024-12-12,9296
3665,貿聯-KY,5,0,5,凱基-頭份,2024-12-12,9296
2317,鴻海,10,5,5,凱基-頭份,2024-12-12,9296
00679B,元大美債20年,8,4,4,凱基-頭份,2024-12-12,9296
4977,眾達-KY,7,3,4,凱基-頭份,2024-12-12,9296
3041,揚智,5,1,4,凱基-頭份,2024-12-12,9296
2359,所羅門,5,1,4,凱基-頭份,2024-12-12,9296
3014,聯陽,6,2,4,凱基-頭份,2024-12-12,9296
4953,緯軟,4,0,4,凱基-頭份,2024-12-12,9296
6877,鏵友益,5,1,4,凱基-頭份,2024-12-12,9296
1301,台塑,5,1,4,凱基-頭份,2024-12-12,9296
2345,智邦,4,0,4,凱基-頭份,2024-12-12,9296
2449,京元電子,4,1,3,凱基-頭份,2024-12-12,9296
00932,兆豐永續高息等權,3,0,3,凱基-頭份,2024-12-12,9296
1708,東鹼,3,0,3,凱基-頭份,2024-12-12,9296
2352,佳世達,4,1,3,凱基-頭份,2024-12-12,9296
2520,冠德,145,1,144,凱基-頭份,2024-12-13,9296
00687B,國泰20年美債,116,2,114,凱基-頭份,2024-12-13,9296
00918,大華優利高填息30,91,0,91,凱基-頭份,2024-12-13,9296
00915,凱基優選高股息30,57,0,57,凱基-頭份,2024-12-13,9296
3706,神達,87,42,45,凱基-頭份,2024-12-13,9296
1316,上曜,41,0,41,凱基-頭份,2024-12-13,9296
9904,寶成,39,0,39,凱基-頭份,2024-12-13,9296
2371,大同,35,0,35,凱基-頭份,2024-12-13,9296
00937B,群益ESG投等債20,31,0,31,凱基-頭份,2024-12-13,9296
4931,新盛力,27,1,26,凱基-頭份,2024-12-13,9296
1815,富喬,22,0,22,凱基-頭份,2024-12-13,9296
2409,友達,23,2,21,凱基-頭份,2024-12-13,9296
00948B,中信優息投資級債,20,0,20,凱基-頭份,2024-12-13,9296
1314,中石化,16,0,16,凱基-頭份,2024-12-13,9296
2515,中工,16,0,16,凱基-頭份,2024-12-13,9296
3481,群創,23,8,15,凱基-頭份,2024-12-13,9296
2002,中鋼,16,1,15,凱基-頭份,2024-12-13,9296
00878,國泰永續高股息,15,0,15,凱基-頭份,2024-12-13,9296
2332,友訊,14,0,14,凱基-頭份,2024-12-13,9296
2883,凱基金,13,0,13,凱基-頭份,2024-12-13,9296
2887E,台新戊特,13,0,13,凱基-頭份,2024-12-13,9296
1305,華夏,11,0,11,凱基-頭份,2024-12-13,9296
5880,合庫金,11,0,11,凱基-頭份,2024-12-13,9296
3260,威剛,11,0,11,凱基-頭份,2024-12-13,9296
4909,新復興,11,0,11,凱基-頭份,2024-12-13,9296
00633L,富邦上証正2,11,0,11,凱基-頭份,2024-12-13,9296
0056,元大高股息,11,0,11,凱基-頭份,2024-12-13,9296
3710,連展投控,10,0,10,凱基-頭份,2024-12-13,9296
2363,矽統,72,62,10,凱基-頭份,2024-12-13,9296
4576,大銀微系統,10,0,10,凱基-頭份,2024-12-13,9296
4729,熒茂,10,0,10,凱基-頭份,2024-12-13,9296
6121,新普,10,0,10,凱基-頭份,2024-12-13,9296
2891,中信金,11,2,9,凱基-頭份,2024-12-13,9296
2618,長榮航,9,0,9,凱基-頭份,2024-12-13,9296
2313,華通,7,0,7,凱基-頭份,2024-12-13,9296
2328,廣宇,7,0,7,凱基-頭份,2024-12-13,9296
3029,零壹,6,0,6,凱基-頭份,2024-12-13,9296
2362,藍天,6,0,6,凱基-頭份,2024-12-13,9296
00929,復華台灣科技優息,8,2,6,凱基-頭份,2024-12-13,9296
2382,廣達,6,1,5,凱基-頭份,2024-12-13,9296
3034,聯詠,5,0,5,凱基-頭份,2024-12-13,9296
6153,嘉聯益,5,0,5,凱基-頭份,2024-12-13,9296
00738U,期元大道瓊白銀,5,0,5,凱基-頭份,2024-12-13,9296
1414,東和,5,0,5,凱基-頭份,2024-12-13,9296
1449,佳和,5,0,5,凱基-頭份,2024-12-13,9296
2105,正新,5,0,5,凱基-頭份,2024-12-13,9296
6670,復盛應用,5,0,5,凱基-頭份,2024-12-13,9296
1301,台塑,7,3,4,凱基-頭份,2024-12-13,9296
3231,緯創,4,0,4,凱基-頭份,2024-12-13,9296
2312,金寶,4,0,4,凱基-頭份,2024-12-13,9296
2609,陽明,152,1,151,凱基-頭份,2024-12-16,9296
00665L,富邦�琤肭磪囓�2,75,0,75,凱基-頭份,2024-12-16,9296
00918,大華優利高填息30,70,2,68,凱基-頭份,2024-12-16,9296
3706,神達,81,33,48,凱基-頭份,2024-12-16,9296
00919,群益台灣精選高息,49,2,47,凱基-頭份,2024-12-16,9296
2317,鴻海,44,8,36,凱基-頭份,2024-12-16,9296
00937B,群益ESG投等債20,36,0,36,凱基-頭份,2024-12-16,9296
00633L,富邦上証正2,32,0,32,凱基-頭份,2024-12-16,9296
00950B,凱基A級公司債,30,0,30,凱基-頭份,2024-12-16,9296
00680L,元大美債20正2,25,0,25,凱基-頭份,2024-12-16,9296
0056,元大高股息,29,6,23,凱基-頭份,2024-12-16,9296
00878,國泰永續高股息,23,1,22,凱基-頭份,2024-12-16,9296
00926,凱基全球菁英55,22,0,22,凱基-頭份,2024-12-16,9296
2002,中鋼,27,5,22,凱基-頭份,2024-12-16,9296
2472,立隆電,21,0,21,凱基-頭份,2024-12-16,9296
1304,台聚,20,0,20,凱基-頭份,2024-12-16,9296
3290,東浦,20,0,20,凱基-頭份,2024-12-16,9296
00948B,中信優息投資級債,20,0,20,凱基-頭份,2024-12-16,9296
2883,凱基金,20,2,18,凱基-頭份,2024-12-16,9296
6180,橘子,17,0,17,凱基-頭份,2024-12-16,9296
3231,緯創,17,2,15,凱基-頭份,2024-12-16,9296
3491,昇達科,15,0,15,凱基-頭份,2024-12-16,9296
2449,京元電子,15,1,14,凱基-頭份,2024-12-16,9296
3293,鈊象,12,0,12,凱基-頭份,2024-12-16,9296
00637L,元大滬深300正2,14,2,12,凱基-頭份,2024-12-16,9296
00922,國泰台灣領袖50,11,0,11,凱基-頭份,2024-12-16,9296
2323,中環,10,0,10,凱基-頭份,2024-12-16,9296
2367,燿華,10,0,10,凱基-頭份,2024-12-16,9296
8358,金居,10,0,10,凱基-頭份,2024-12-16,9296
00688L,國泰20年美債正2,10,0,10,凱基-頭份,2024-12-16,9296
00968B,元大優息投等債,10,0,10,凱基-頭份,2024-12-16,9296
3229,晟鈦,10,0,10,凱基-頭份,2024-12-16,9296
2884,玉山金,10,0,10,凱基-頭份,2024-12-16,9296
00915,凱基優選高股息30,9,0,9,凱基-頭份,2024-12-16,9296
2891,中信金,10,1,9,凱基-頭份,2024-12-16,9296
4956,光鋐,12,3,9,凱基-頭份,2024-12-16,9296
6715,嘉基,9,0,9,凱基-頭份,2024-12-16,9296
6885,全福生技,13,4,9,凱基-頭份,2024-12-16,9296
1101,台泥,10,2,8,凱基-頭份,2024-12-16,9296
00946,群益科技高息成長,8,0,8,凱基-頭份,2024-12-16,9296
4974,亞泰,27,20,7,凱基-頭份,2024-12-16,9296
6215,和椿,7,0,7,凱基-頭份,2024-12-16,9296
00900,富邦特選高股息30,6,0,6,凱基-頭份,2024-12-16,9296
2382,廣達,6,0,6,凱基-頭份,2024-12-16,9296
6282,康舒,5,0,5,凱基-頭份,2024-12-16,9296
1301,台塑,5,0,5,凱基-頭份,2024-12-16,9296
1605,華新,6,1,5,凱基-頭份,2024-12-16,9296
3025,星通,7,2,5,凱基-頭份,2024-12-16,9296
8249,菱光,7,2,5,凱基-頭份,2024-12-16,9296
00960,野村全球航運龍頭,5,0,5,凱基-頭份,2024-12-16,9296
00918,大華優利高填息30,82,1,81,凱基-頭份,2024-12-17,9296
3481,群創,47,0,47,凱基-頭份,2024-12-17,9296
2613,中櫃,40,0,40,凱基-頭份,2024-12-17,9296
2317,鴻海,30,1,29,凱基-頭份,2024-12-17,9296
00915,凱基優選高股息30,21,0,21,凱基-頭份,2024-12-17,9296
2464,盟立,27,8,19,凱基-頭份,2024-12-17,9296
3706,神達,37,26,11,凱基-頭份,2024-12-17,9296
2363,矽統,52,41,11,凱基-頭份,2024-12-17,9296
0056,元大高股息,12,1,11,凱基-頭份,2024-12-17,9296
2891,中信金,11,1,10,凱基-頭份,2024-12-17,9296
1708,東鹼,10,0,10,凱基-頭份,2024-12-17,9296
2301,光寶科,11,1,10,凱基-頭份,2024-12-17,9296
6531,愛普*,12,2,10,凱基-頭份,2024-12-17,9296
00713,元大台灣高息低波,9,0,9,凱基-頭份,2024-12-17,9296
00665L,富邦�琤肭磪囓�2,9,0,9,凱基-頭份,2024-12-17,9296
2633,台灣高鐵,8,0,8,凱基-頭份,2024-12-17,9296
6180,橘子,8,0,8,凱基-頭份,2024-12-17,9296
2834,臺企銀,8,0,8,凱基-頭份,2024-12-17,9296
5880,合庫金,7,0,7,凱基-頭份,2024-12-17,9296
00679B,元大美債20年,7,0,7,凱基-頭份,2024-12-17,9296
2409,友達,7,0,7,凱基-頭份,2024-12-17,9296
2886,兆豐金,7,0,7,凱基-頭份,2024-12-17,9296
5484,慧友,7,0,7,凱基-頭份,2024-12-17,9296
00960,野村全球航運龍頭,6,0,6,凱基-頭份,2024-12-17,9296
2885,元大金,6,0,6,凱基-頭份,2024-12-17,9296
4931,新盛力,8,2,6,凱基-頭份,2024-12-17,9296
6139,亞翔,6,0,6,凱基-頭份,2024-12-17,9296
2890,永豐金,5,0,5,凱基-頭份,2024-12-17,9296
00940,元大台灣價值高息,5,0,5,凱基-頭份,2024-12-17,9296
1475,業旺,5,0,5,凱基-頭份,2024-12-17,9296
2105,正新,5,0,5,凱基-頭份,2024-12-17,9296
2382,廣達,4,0,4,凱基-頭份,2024-12-17,9296
2449,京元電子,4,0,4,凱基-頭份,2024-12-17,9296
1609,大亞,4,0,4,凱基-頭份,2024-12-17,9296
3027,盛達,4,0,4,凱基-頭份,2024-12-17,9296
00900,富邦特選高股息30,3,0,3,凱基-頭份,2024-12-17,9296
1326,台化,3,0,3,凱基-頭份,2024-12-17,9296
00933B,國泰10Y+金融債,3,0,3,凱基-頭份,2024-12-17,9296
00751B,元大AAA至A公司債,3,0,3,凱基-頭份,2024-12-17,9296
00680L,元大美債20正2,3,0,3,凱基-頭份,2024-12-17,9296
2002,中鋼,6,3,3,凱基-頭份,2024-12-17,9296
2332,友訊,5,2,3,凱基-頭份,2024-12-17,9296
2883,凱基金,3,0,3,凱基-頭份,2024-12-17,9296
3303,岱稜,7,4,3,凱基-頭份,2024-12-17,9296
4953,緯軟,3,0,3,凱基-頭份,2024-12-17,9296
5425,台半,3,0,3,凱基-頭份,2024-12-17,9296
6239,力成,3,0,3,凱基-頭份,2024-12-17,9296
6530,創威,3,0,3,凱基-頭份,2024-12-17,9296
6877,鏵友益,3,0,3,凱基-頭份,2024-12-17,9296
2368,金像電,3,0,3,凱基-頭份,2024-12-17,9296
2303,聯電,73,24,49,凱基-頭份,2024-12-18,9296
00918,大華優利高填息30,38,0,38,凱基-頭份,2024-12-18,9296
2520,冠德,36,0,36,凱基-頭份,2024-12-18,9296
00950B,凱基A級公司債,35,0,35,凱基-頭份,2024-12-18,9296
3029,零壹,41,10,31,凱基-頭份,2024-12-18,9296
2605,新興,30,0,30,凱基-頭份,2024-12-18,9296
9904,寶成,30,0,30,凱基-頭份,2024-12-18,9296
2613,中櫃,27,0,27,凱基-頭份,2024-12-18,9296
3706,神達,55,32,23,凱基-頭份,2024-12-18,9296
9105,泰金寶-DR,31,10,21,凱基-頭份,2024-12-18,9296
3019,亞光,39,21,18,凱基-頭份,2024-12-18,9296
1314,中石化,15,0,15,凱基-頭份,2024-12-18,9296
00970B,新光BBB投等債20,18,3,15,凱基-頭份,2024-12-18,9296
1303,南亞,19,4,15,凱基-頭份,2024-12-18,9296
2892,第一金,14,0,14,凱基-頭份,2024-12-18,9296
3356,奇偶,12,0,12,凱基-頭份,2024-12-18,9296
4974,亞泰,11,0,11,凱基-頭份,2024-12-18,9296
2881,富邦金,10,0,10,凱基-頭份,2024-12-18,9296
00924,復華S＆P500成長,10,0,10,凱基-頭份,2024-12-18,9296
2436,偉詮電,10,0,10,凱基-頭份,2024-12-18,9296
4967,十銓,10,0,10,凱基-頭份,2024-12-18,9296
6209,今國光,10,0,10,凱基-頭份,2024-12-18,9296
6531,愛普*,22,12,10,凱基-頭份,2024-12-18,9296
9946,三發地產,10,0,10,凱基-頭份,2024-12-18,9296
5484,慧友,8,0,8,凱基-頭份,2024-12-18,9296
2618,長榮航,16,9,7,凱基-頭份,2024-12-18,9296
3041,揚智,18,10,8,凱基-頭份,2024-12-18,9296
2204,中華,8,1,7,凱基-頭份,2024-12-18,9296
3481,群創,17,10,7,凱基-頭份,2024-12-18,9296
2354,鴻準,8,2,6,凱基-頭份,2024-12-18,9296
2834,臺企銀,5,0,5,凱基-頭份,2024-12-18,9296
8042,金山電,5,0,5,凱基-頭份,2024-12-18,9296
3443,創意,5,0,5,凱基-頭份,2024-12-18,9296
2886,兆豐金,4,0,4,凱基-頭份,2024-12-18,9296
4510,高鋒,5,1,4,凱基-頭份,2024-12-18,9296
6197,佳必琪,4,0,4,凱基-頭份,2024-12-18,9296
2313,華通,4,0,4,凱基-頭份,2024-12-18,9296
006208,富邦台50,3,0,3,凱基-頭份,2024-12-18,9296
00937B,群益ESG投等債20,11,8,3,凱基-頭份,2024-12-18,9296
00909,國泰數位支付服務,3,0,3,凱基-頭份,2024-12-18,9296
1605,華新,3,0,3,凱基-頭份,2024-12-18,9296
2002,中鋼,3,0,3,凱基-頭份,2024-12-18,9296
2312,金寶,4,1,3,凱基-頭份,2024-12-18,9296
3520,華盈,3,0,3,凱基-頭份,2024-12-18,9296
4906,正文,3,0,3,凱基-頭份,2024-12-18,9296
4977,眾達-KY,8,5,3,凱基-頭份,2024-12-18,9296
5386,青雲,3,0,3,凱基-頭份,2024-12-18,9296
6426,統新,3,0,3,凱基-頭份,2024-12-18,9296
6715,嘉基,3,0,3,凱基-頭份,2024-12-18,9296
2891,中信金,3,0,3,凱基-頭份,2024-12-18,9296
2363,矽統,100,0,100,凱基-頭份,2024-12-19,9296
00918,大華優利高填息30,53,1,52,凱基-頭份,2024-12-19,9296
1101,台泥,50,0,50,凱基-頭份,2024-12-19,9296
6770,力積電,45,3,42,凱基-頭份,2024-12-19,9296
2845,遠東銀,41,0,41,凱基-頭份,2024-12-19,9296
00937B,群益ESG投等債20,40,0,40,凱基-頭份,2024-12-19,9296
9904,寶成,33,0,33,凱基-頭份,2024-12-19,9296
8027,鈦昇,27,0,27,凱基-頭份,2024-12-19,9296
2891,中信金,22,0,22,凱基-頭份,2024-12-19,9296
00915,凱基優選高股息30,22,0,22,凱基-頭份,2024-12-19,9296
3481,群創,22,1,21,凱基-頭份,2024-12-19,9296
00953B,群益優選非投等債,20,0,20,凱基-頭份,2024-12-19,9296
2408,南亞科,20,0,20,凱基-頭份,2024-12-19,9296
00687B,國泰20年美債,18,0,18,凱基-頭份,2024-12-19,9296
6152,百一,16,0,16,凱基-頭份,2024-12-19,9296
00679B,元大美債20年,15,0,15,凱基-頭份,2024-12-19,9296
2317,鴻海,15,1,14,凱基-頭份,2024-12-19,9296
2002,中鋼,15,1,14,凱基-頭份,2024-12-19,9296
5880,合庫金,13,0,13,凱基-頭份,2024-12-19,9296
1314,中石化,11,0,11,凱基-頭份,2024-12-19,9296
8341,日友,11,0,11,凱基-頭份,2024-12-19,9296
00795B,中信美國公債20年,10,0,10,凱基-頭份,2024-12-19,9296
1809,中釉,10,0,10,凱基-頭份,2024-12-19,9296
3037,欣興,10,0,10,凱基-頭份,2024-12-19,9296
6224,聚鼎,10,0,10,凱基-頭份,2024-12-19,9296
0056,元大高股息,26,17,9,凱基-頭份,2024-12-19,9296
2344,華邦電,15,7,8,凱基-頭份,2024-12-19,9296
00708L,期元大S＆P黃金正2,8,0,8,凱基-頭份,2024-12-19,9296
00726B,國泰新興投等債,8,0,8,凱基-頭份,2024-12-19,9296
00922,國泰台灣領袖50,8,0,8,凱基-頭份,2024-12-19,9296
1815,富喬,11,3,8,凱基-頭份,2024-12-19,9296
2332,友訊,12,4,8,凱基-頭份,2024-12-19,9296
2520,冠德,50,42,8,凱基-頭份,2024-12-19,9296
4726,永昕,7,0,7,凱基-頭份,2024-12-19,9296
6209,今國光,7,0,7,凱基-頭份,2024-12-19,9296
6558,興能高,13,6,7,凱基-頭份,2024-12-19,9296
2890,永豐金,6,0,6,凱基-頭份,2024-12-19,9296
6742,澤米,6,0,6,凱基-頭份,2024-12-19,9296
00926,凱基全球菁英55,6,0,6,凱基-頭份,2024-12-19,9296
3443,創意,11,5,6,凱基-頭份,2024-12-19,9296
4979,華星光,8,3,5,凱基-頭份,2024-12-19,9296
00924,復華S＆P500成長,5,0,5,凱基-頭份,2024-12-19,9296
2485,兆赫,5,0,5,凱基-頭份,2024-12-19,9296
2547,日勝生,5,0,5,凱基-頭份,2024-12-19,9296
3548,兆利,5,0,5,凱基-頭份,2024-12-19,9296
6462,神盾,5,0,5,凱基-頭份,2024-12-19,9296
6733,博晟生醫,5,0,5,凱基-頭份,2024-12-19,9296
8042,金山電,5,0,5,凱基-頭份,2024-12-19,9296
2886,兆豐金,5,0,5,凱基-頭份,2024-12-19,9296
00948B,中信優息投資級債,5,0,5,凱基-頭份,2024-12-19,9296
