Ticker,Name,buy,sell,diff,Branch,Date,Branch_Code
2412,中華電,333,0,333,華南永昌-民權,2023-01-03,9312
8927,北基,25,0,25,華南永昌-民權,2023-01-03,9312
00773B,中信優先金融債,21,0,21,華南永昌-民權,2023-01-03,9312
9103,美德醫療-DR,15,0,15,華南永昌-民權,2023-01-03,9312
2634,漢翔,16,5,11,華南永昌-民權,2023-01-03,9312
2609,陽明,15,5,10,華南永昌-民權,2023-01-03,9312
1104,環泥,10,0,10,華南永昌-民權,2023-01-03,9312
2615,萬海,15,5,10,華南永昌-民權,2023-01-03,9312
5009,榮剛,10,0,10,華南永昌-民權,2023-01-03,9312
2317,鴻海,46,38,8,華南永昌-民權,2023-01-03,9312
6180,橘子,11,3,8,華南永昌-民權,2023-01-03,9312
1605,華新,28,20,8,華南永昌-民權,2023-01-03,9312
1467,南緯,21,15,6,華南永昌-民權,2023-01-03,9312
00637L,元大滬深300正2,11,5,6,華南永昌-民權,2023-01-03,9312
3176,基亞,6,0,6,華南永昌-民權,2023-01-03,9312
4167,松瑞藥,6,0,6,華南永昌-民權,2023-01-03,9312
8933,愛地雅,6,0,6,華南永昌-民權,2023-01-03,9312
2892,第一金,6,0,6,華南永昌-民權,2023-01-03,9312
6806,森崴能源,6,0,6,華南永昌-民權,2023-01-03,9312
00772B,中信高評級公司債,5,0,5,華南永昌-民權,2023-01-03,9312
1313,聯成,5,0,5,華南永昌-民權,2023-01-03,9312
1701,中化,14,9,5,華南永昌-民權,2023-01-03,9312
4130,健亞,5,0,5,華南永昌-民權,2023-01-03,9312
6142,友勁,5,0,5,華南永昌-民權,2023-01-03,9312
2603,長榮,8,4,4,華南永昌-民權,2023-01-03,9312
2882,國泰金,8,4,4,華南永昌-民權,2023-01-03,9312
6111,大宇資,6,2,4,華南永昌-民權,2023-01-03,9312
3594,磐儀,4,0,4,華南永昌-民權,2023-01-03,9312
2331,精英,4,0,4,華南永昌-民權,2023-01-03,9312
2867,三商壽,4,0,4,華南永昌-民權,2023-01-03,9312
5258,虹堡,5,1,4,華南永昌-民權,2023-01-03,9312
2515,中工,3,0,3,華南永昌-民權,2023-01-03,9312
2606,裕民,3,0,3,華南永昌-民權,2023-01-03,9312
2707,晶華,8,5,3,華南永昌-民權,2023-01-03,9312
4931,新盛力,3,0,3,華南永昌-民權,2023-01-03,9312
4171,瑞基,6,3,3,華南永昌-民權,2023-01-03,9312
1760,寶齡富錦,13,11,2,華南永昌-民權,2023-01-03,9312
1529,樂事綠能,2,0,2,華南永昌-民權,2023-01-03,9312
0050,元大台灣50,3,1,2,華南永昌-民權,2023-01-03,9312
2033,佳大,2,0,2,華南永昌-民權,2023-01-03,9312
3032,偉訓,2,0,2,華南永昌-民權,2023-01-03,9312
3444,利機,2,0,2,華南永昌-民權,2023-01-03,9312
3479,安勤,3,1,2,華南永昌-民權,2023-01-03,9312
5425,台半,2,0,2,華南永昌-民權,2023-01-03,9312
5607,遠雄港,2,0,2,華南永昌-民權,2023-01-03,9312
6196,帆宣,3,1,2,華南永昌-民權,2023-01-03,9312
6282,康舒,3,1,2,華南永昌-民權,2023-01-03,9312
6284,佳邦,2,0,2,華南永昌-民權,2023-01-03,9312
9904,寶成,2,0,2,華南永昌-民權,2023-01-03,9312
00679B,元大美債20年,4,2,2,華南永昌-民權,2023-01-03,9312
00706L,期元大S＆P日圓正2,218,0,218,華南永昌-民權,2023-01-04,9312
00772B,中信高評級公司債,30,0,30,華南永昌-民權,2023-01-04,9312
2465,麗臺,22,0,22,華南永昌-民權,2023-01-04,9312
4979,華星光,16,0,16,華南永昌-民權,2023-01-04,9312
2359,所羅門,15,0,15,華南永昌-民權,2023-01-04,9312
2884,玉山金,13,0,13,華南永昌-民權,2023-01-04,9312
00773B,中信優先金融債,14,3,11,華南永昌-民權,2023-01-04,9312
1444,力麗,11,0,11,華南永昌-民權,2023-01-04,9312
2609,陽明,16,6,10,華南永昌-民權,2023-01-04,9312
00673R,期元大S＆P原油反1,11,1,10,華南永昌-民權,2023-01-04,9312
1217,愛之味,10,0,10,華南永昌-民權,2023-01-04,9312
1565,精華,10,0,10,華南永昌-民權,2023-01-04,9312
3481,群創,11,1,10,華南永昌-民權,2023-01-04,9312
4977,眾達-KY,10,0,10,華南永昌-民權,2023-01-04,9312
1536,和大,27,18,9,華南永昌-民權,2023-01-04,9312
00893,國泰智能電動車,9,0,9,華南永昌-民權,2023-01-04,9312
1513,中興電,31,23,8,華南永昌-民權,2023-01-04,9312
2317,鴻海,22,14,8,華南永昌-民權,2023-01-04,9312
00715L,期街口布蘭特正2,8,0,8,華南永昌-民權,2023-01-04,9312
1514,亞力,16,9,7,華南永昌-民權,2023-01-04,9312
3027,盛達,10,3,7,華南永昌-民權,2023-01-04,9312
2002,中鋼,7,1,6,華南永昌-民權,2023-01-04,9312
2007,燁興,6,0,6,華南永昌-民權,2023-01-04,9312
3013,晟銘電,6,0,6,華南永昌-民權,2023-01-04,9312
3380,明泰,6,0,6,華南永昌-民權,2023-01-04,9312
3491,昇達科,6,0,6,華南永昌-民權,2023-01-04,9312
3515,華擎,6,0,6,華南永昌-民權,2023-01-04,9312
4942,嘉彰,6,0,6,華南永昌-民權,2023-01-04,9312
00678,群益那斯達克生技,5,0,5,華南永昌-民權,2023-01-04,9312
00862B,中信投資級公司債,5,0,5,華南永昌-民權,2023-01-04,9312
3594,磐儀,5,0,5,華南永昌-民權,2023-01-04,9312
5608,四維航,7,2,5,華南永昌-民權,2023-01-04,9312
6143,振曜,7,2,5,華南永昌-民權,2023-01-04,9312
00878,國泰永續高股息,5,1,4,華南永昌-民權,2023-01-04,9312
1720,生達,4,0,4,華南永昌-民權,2023-01-04,9312
3592,瑞鼎,4,0,4,華南永昌-民權,2023-01-04,9312
6116,彩晶,5,1,4,華南永昌-民權,2023-01-04,9312
2603,長榮,5,1,4,華南永昌-民權,2023-01-04,9312
2615,萬海,8,5,3,華南永昌-民權,2023-01-04,9312
4167,松瑞藥,8,5,3,華南永昌-民權,2023-01-04,9312
2014,中鴻,3,0,3,華南永昌-民權,2023-01-04,9312
2481,強茂,3,0,3,華南永昌-民權,2023-01-04,9312
2886,兆豐金,3,0,3,華南永昌-民權,2023-01-04,9312
3122,笙泉,4,1,3,華南永昌-民權,2023-01-04,9312
3479,安勤,4,1,3,華南永昌-民權,2023-01-04,9312
4961,天鈺,7,4,3,華南永昌-民權,2023-01-04,9312
6235,華孚,13,10,3,華南永昌-民權,2023-01-04,9312
3228,金麗科,2,0,2,華南永昌-民權,2023-01-04,9312
1519,華城,3,1,2,華南永昌-民權,2023-01-04,9312
1609,大亞,14,12,2,華南永昌-民權,2023-01-04,9312
00706L,期元大S＆P日圓正2,553,1,552,華南永昌-民權,2023-01-05,9312
00772B,中信高評級公司債,246,0,246,華南永昌-民權,2023-01-05,9312
00878,國泰永續高股息,200,0,200,華南永昌-民權,2023-01-05,9312
2208,台船,102,0,102,華南永昌-民權,2023-01-05,9312
00753L,中信中國50正2,45,17,28,華南永昌-民權,2023-01-05,9312
00773B,中信優先金融債,23,0,23,華南永昌-民權,2023-01-05,9312
2610,華航,21,0,21,華南永昌-民權,2023-01-05,9312
5014,建錩,21,1,20,華南永昌-民權,2023-01-05,9312
3083,網龍,23,4,19,華南永昌-民權,2023-01-05,9312
2915,潤泰全,17,0,17,華南永昌-民權,2023-01-05,9312
8358,金居,20,4,16,華南永昌-民權,2023-01-05,9312
00882,中信中國高股息,16,3,13,華南永昌-民權,2023-01-05,9312
5009,榮剛,12,0,12,華南永昌-民權,2023-01-05,9312
2363,矽統,10,0,10,華南永昌-民權,2023-01-05,9312
2444,兆勁,10,0,10,華南永昌-民權,2023-01-05,9312
2852,第一保,10,0,10,華南永昌-民權,2023-01-05,9312
8927,北基,10,0,10,華南永昌-民權,2023-01-05,9312
1305,華夏,10,1,9,華南永昌-民權,2023-01-05,9312
3272,東碩,10,1,9,華南永昌-民權,2023-01-05,9312
5351,鈺創,10,1,9,華南永昌-民權,2023-01-05,9312
00715L,期街口布蘭特正2,8,0,8,華南永昌-民權,2023-01-05,9312
2460,建通,14,6,8,華南永昌-民權,2023-01-05,9312
2303,聯電,7,0,7,華南永昌-民權,2023-01-05,9312
1467,南緯,30,25,5,華南永昌-民權,2023-01-05,9312
2425,承啟,5,0,5,華南永昌-民權,2023-01-05,9312
3491,昇達科,6,1,5,華南永昌-民權,2023-01-05,9312
6443,元晶,8,3,5,華南永昌-民權,2023-01-05,9312
2419,仲琦,40,36,4,華南永昌-民權,2023-01-05,9312
2641,正德,4,0,4,華南永昌-民權,2023-01-05,9312
3037,欣興,7,3,4,華南永昌-民權,2023-01-05,9312
3228,金麗科,21,17,4,華南永昌-民權,2023-01-05,9312
4162,智擎,4,0,4,華南永昌-民權,2023-01-05,9312
6139,亞翔,4,0,4,華南永昌-民權,2023-01-05,9312
00632R,元大台灣50反1,3,0,3,華南永昌-民權,2023-01-05,9312
2206,三陽工業,3,0,3,華南永昌-民權,2023-01-05,9312
2308,台達電,3,0,3,華南永昌-民權,2023-01-05,9312
2375,凱美,3,0,3,華南永昌-民權,2023-01-05,9312
3479,安勤,5,2,3,華南永昌-民權,2023-01-05,9312
3661,世芯-KY,3,0,3,華南永昌-民權,2023-01-05,9312
4174,浩鼎,3,0,3,華南永昌-民權,2023-01-05,9312
6197,佳必琪,3,0,3,華南永昌-民權,2023-01-05,9312
8076,伍豐,4,1,3,華南永昌-民權,2023-01-05,9312
1101,台泥,3,0,3,華南永昌-民權,2023-01-05,9312
1504,東元,3,1,2,華南永昌-民權,2023-01-05,9312
1475,業旺,2,0,2,華南永昌-民權,2023-01-05,9312
1722,台肥,2,0,2,華南永昌-民權,2023-01-05,9312
2014,中鴻,2,0,2,華南永昌-民權,2023-01-05,9312
2108,南帝,2,0,2,華南永昌-民權,2023-01-05,9312
2368,金像電,2,0,2,華南永昌-民權,2023-01-05,9312
3062,建漢,2,0,2,華南永昌-民權,2023-01-05,9312
8046,南電,51,0,51,華南永昌-民權,2023-01-06,9312
2208,台船,50,0,50,華南永昌-民權,2023-01-06,9312
2101,南港,30,0,30,華南永昌-民權,2023-01-06,9312
2883,凱基金,30,0,30,華南永昌-民權,2023-01-06,9312
5876,上海商銀,30,0,30,華南永昌-民權,2023-01-06,9312
1519,華城,38,11,27,華南永昌-民權,2023-01-06,9312
1701,中化,26,11,15,華南永昌-民權,2023-01-06,9312
3346,麗清,14,0,14,華南永昌-民權,2023-01-06,9312
1609,大亞,21,10,11,華南永昌-民權,2023-01-06,9312
00632R,元大台灣50反1,10,0,10,華南永昌-民權,2023-01-06,9312
00900,富邦特選高股息30,10,0,10,華南永昌-民權,2023-01-06,9312
1785,光洋科,10,0,10,華南永昌-民權,2023-01-06,9312
2359,所羅門,11,1,10,華南永昌-民權,2023-01-06,9312
2641,正德,10,0,10,華南永昌-民權,2023-01-06,9312
2888,新光金,10,0,10,華南永昌-民權,2023-01-06,9312
2881,富邦金,9,0,9,華南永昌-民權,2023-01-06,9312
6182,合晶,9,0,9,華南永昌-民權,2023-01-06,9312
2002,中鋼,8,0,8,華南永昌-民權,2023-01-06,9312
00773B,中信優先金融債,9,1,8,華南永昌-民權,2023-01-06,9312
00720B,元大投資級公司債,10,2,8,華南永昌-民權,2023-01-06,9312
00878,國泰永續高股息,7,0,7,華南永昌-民權,2023-01-06,9312
5508,永信建,6,0,6,華南永昌-民權,2023-01-06,9312
2615,萬海,7,2,5,華南永昌-民權,2023-01-06,9312
00882,中信中國高股息,5,0,5,華南永昌-民權,2023-01-06,9312
00679B,元大美債20年,5,0,5,華南永昌-民權,2023-01-06,9312
1314,中石化,5,0,5,華南永昌-民權,2023-01-06,9312
3356,奇偶,5,0,5,華南永昌-民權,2023-01-06,9312
4114,健喬,15,10,5,華南永昌-民權,2023-01-06,9312
4720,德淵,5,0,5,華南永昌-民權,2023-01-06,9312
8215,明基材,5,0,5,華南永昌-民權,2023-01-06,9312
1513,中興電,12,7,5,華南永昌-民權,2023-01-06,9312
1777,生泰,4,0,4,華南永昌-民權,2023-01-06,9312
2108,南帝,7,3,4,華南永昌-民權,2023-01-06,9312
2317,鴻海,4,0,4,華南永昌-民權,2023-01-06,9312
2419,仲琦,4,0,4,華南永昌-民權,2023-01-06,9312
2609,陽明,5,1,4,華南永昌-民權,2023-01-06,9312
2915,潤泰全,4,0,4,華南永昌-民權,2023-01-06,9312
3443,創意,4,0,4,華南永昌-民權,2023-01-06,9312
3704,合勤控,5,1,4,華南永昌-民權,2023-01-06,9312
2006,東和鋼鐵,3,0,3,華南永昌-民權,2023-01-06,9312
1722,台肥,3,0,3,華南永昌-民權,2023-01-06,9312
1447,力鵬,3,0,3,華南永昌-民權,2023-01-06,9312
2354,鴻準,4,1,3,華南永昌-民權,2023-01-06,9312
2375,凱美,4,1,3,華南永昌-民權,2023-01-06,9312
2486,一詮,3,0,3,華南永昌-民權,2023-01-06,9312
2489,瑞軒,3,0,3,華南永昌-民權,2023-01-06,9312
2707,晶華,3,0,3,華南永昌-民權,2023-01-06,9312
4147,中裕,3,0,3,華南永昌-民權,2023-01-06,9312
4157,太景*-KY,4,1,3,華南永昌-民權,2023-01-06,9312
5236,凌陽創新,3,0,3,華南永昌-民權,2023-01-06,9312
00706L,期元大S＆P日圓正2,238,0,238,華南永昌-民權,2023-01-09,9312
2885,元大金,50,1,49,華南永昌-民權,2023-01-09,9312
3481,群創,52,11,41,華南永昌-民權,2023-01-09,9312
00720B,元大投資級公司債,33,4,29,華南永昌-民權,2023-01-09,9312
2609,陽明,34,11,23,華南永昌-民權,2023-01-09,9312
00885,富邦越南,20,0,20,華南永昌-民權,2023-01-09,9312
00632R,元大台灣50反1,25,5,20,華南永昌-民權,2023-01-09,9312
1609,大亞,20,0,20,華南永昌-民權,2023-01-09,9312
2610,華航,21,1,20,華南永昌-民權,2023-01-09,9312
6168,宏齊,20,0,20,華南永昌-民權,2023-01-09,9312
00772B,中信高評級公司債,16,0,16,華南永昌-民權,2023-01-09,9312
2385,群光,15,0,15,華南永昌-民權,2023-01-09,9312
4979,華星光,23,8,15,華南永昌-民權,2023-01-09,9312
8046,南電,21,6,15,華南永昌-民權,2023-01-09,9312
00773B,中信優先金融債,15,1,14,華南永昌-民權,2023-01-09,9312
3083,網龍,12,0,12,華南永昌-民權,2023-01-09,9312
5009,榮剛,11,0,11,華南永昌-民權,2023-01-09,9312
2007,燁興,11,1,10,華南永昌-民權,2023-01-09,9312
4968,立積,11,1,10,華南永昌-民權,2023-01-09,9312
6274,台燿,11,1,10,華南永昌-民權,2023-01-09,9312
1443,立益物流,9,0,9,華南永昌-民權,2023-01-09,9312
2606,裕民,10,2,8,華南永昌-民權,2023-01-09,9312
2409,友達,10,4,6,華南永昌-民權,2023-01-09,9312
6024,群益期,6,0,6,華南永昌-民權,2023-01-09,9312
8069,元太,7,1,6,華南永昌-民權,2023-01-09,9312
1605,華新,13,8,5,華南永昌-民權,2023-01-09,9312
2317,鴻海,6,1,5,華南永昌-民權,2023-01-09,9312
2451,創見,5,0,5,華南永昌-民權,2023-01-09,9312
3189,景碩,5,0,5,華南永昌-民權,2023-01-09,9312
3231,緯創,11,6,5,華南永昌-民權,2023-01-09,9312
2812,台中銀,5,0,5,華南永昌-民權,2023-01-09,9312
1519,華城,6,2,4,華南永昌-民權,2023-01-09,9312
3034,聯詠,4,0,4,華南永昌-民權,2023-01-09,9312
2314,台揚,4,0,4,華南永昌-民權,2023-01-09,9312
2344,華邦電,6,2,4,華南永昌-民權,2023-01-09,9312
2460,建通,4,0,4,華南永昌-民權,2023-01-09,9312
1722,台肥,3,0,3,華南永昌-民權,2023-01-09,9312
2022,聚亨,3,0,3,華南永昌-民權,2023-01-09,9312
2498,宏達電,3,0,3,華南永昌-民權,2023-01-09,9312
5425,台半,6,3,3,華南永昌-民權,2023-01-09,9312
6118,建達,3,0,3,華南永昌-民權,2023-01-09,9312
6414,樺漢,6,3,3,華南永昌-民權,2023-01-09,9312
6451,訊芯-KY,3,0,3,華南永昌-民權,2023-01-09,9312
1720,生達,2,0,2,華南永昌-民權,2023-01-09,9312
2033,佳大,3,1,2,華南永昌-民權,2023-01-09,9312
2038,海光,2,0,2,華南永昌-民權,2023-01-09,9312
2208,台船,2,0,2,華南永昌-民權,2023-01-09,9312
2364,倫飛,2,0,2,華南永昌-民權,2023-01-09,9312
2365,昆盈,2,0,2,華南永昌-民權,2023-01-09,9312
2367,燿華,2,0,2,華南永昌-民權,2023-01-09,9312
2883,凱基金,350,0,350,華南永昌-民權,2023-01-10,9312
2881,富邦金,220,0,220,華南永昌-民權,2023-01-10,9312
00632R,元大台灣50反1,102,0,102,華南永昌-民權,2023-01-10,9312
00706L,期元大S＆P日圓正2,101,0,101,華南永昌-民權,2023-01-10,9312
2633,台灣高鐵,100,5,95,華南永昌-民權,2023-01-10,9312
2867,三商壽,60,0,60,華南永昌-民權,2023-01-10,9312
8938,明安,20,0,20,華南永昌-民權,2023-01-10,9312
00885,富邦越南,19,1,18,華南永昌-民權,2023-01-10,9312
1605,華新,30,13,17,華南永昌-民權,2023-01-10,9312
2882,國泰金,23,7,16,華南永昌-民權,2023-01-10,9312
1609,大亞,45,33,12,華南永昌-民權,2023-01-10,9312
3680,家登,12,1,11,華南永昌-民權,2023-01-10,9312
6558,興能高,11,0,11,華南永昌-民權,2023-01-10,9312
3013,晟銘電,13,3,10,華南永昌-民權,2023-01-10,9312
1722,台肥,9,0,9,華南永昌-民權,2023-01-10,9312
00720B,元大投資級公司債,10,2,8,華南永昌-民權,2023-01-10,9312
8105,凌巨,41,33,8,華南永昌-民權,2023-01-10,9312
1513,中興電,21,14,7,華南永昌-民權,2023-01-10,9312
1760,寶齡富錦,6,0,6,華南永昌-民權,2023-01-10,9312
00753L,中信中國50正2,27,21,6,華南永昌-民權,2023-01-10,9312
3576,聯合再生,6,0,6,華南永昌-民權,2023-01-10,9312
2615,萬海,7,1,6,華南永昌-民權,2023-01-10,9312
2344,華邦電,7,2,5,華南永昌-民權,2023-01-10,9312
8046,南電,9,4,5,華南永昌-民權,2023-01-10,9312
2062,橋椿,5,0,5,華南永昌-民權,2023-01-10,9312
2605,新興,5,0,5,華南永昌-民權,2023-01-10,9312
2637,慧洋-KY,6,1,5,華南永昌-民權,2023-01-10,9312
6129,普誠,5,0,5,華南永昌-民權,2023-01-10,9312
6443,元晶,19,14,5,華南永昌-民權,2023-01-10,9312
00679B,元大美債20年,4,0,4,華南永昌-民權,2023-01-10,9312
1802,台玻,4,0,4,華南永昌-民權,2023-01-10,9312
1810,和成,4,0,4,華南永昌-民權,2023-01-10,9312
2460,建通,5,1,4,華南永昌-民權,2023-01-10,9312
3693,營邦,6,2,4,華南永昌-民權,2023-01-10,9312
4747,強生,4,0,4,華南永昌-民權,2023-01-10,9312
6104,創惟,7,3,4,華南永昌-民權,2023-01-10,9312
00882,中信中國高股息,3,0,3,華南永昌-民權,2023-01-10,9312
00772B,中信高評級公司債,3,0,3,華南永昌-民權,2023-01-10,9312
2359,所羅門,3,0,3,華南永昌-民權,2023-01-10,9312
2409,友達,4,1,3,華南永昌-民權,2023-01-10,9312
2515,中工,3,0,3,華南永昌-民權,2023-01-10,9312
2607,榮運,3,0,3,華南永昌-民權,2023-01-10,9312
4114,健喬,6,3,3,華南永昌-民權,2023-01-10,9312
4726,永昕,3,0,3,華南永昌-民權,2023-01-10,9312
5508,永信建,3,0,3,華南永昌-民權,2023-01-10,9312
8033,雷虎,3,0,3,華南永昌-民權,2023-01-10,9312
8171,天宇,3,1,2,華南永昌-民權,2023-01-10,9312
1304,台聚,3,1,2,華南永昌-民權,2023-01-10,9312
1565,精華,2,0,2,華南永昌-民權,2023-01-10,9312
1720,生達,2,0,2,華南永昌-民權,2023-01-10,9312
3443,創意,31,0,31,華南永昌-民權,2023-01-11,9312
6150,撼訊,30,10,20,華南永昌-民權,2023-01-11,9312
3093,港建*,15,0,15,華南永昌-民權,2023-01-11,9312
1467,南緯,24,10,14,華南永昌-民權,2023-01-11,9312
5465,富驊,12,0,12,華南永昌-民權,2023-01-11,9312
2409,友達,14,3,11,華南永昌-民權,2023-01-11,9312
2884,玉山金,11,0,11,華南永昌-民權,2023-01-11,9312
9933,中鼎,11,0,11,華南永昌-民權,2023-01-11,9312
3704,合勤控,13,3,10,華南永昌-民權,2023-01-11,9312
3047,訊舟,10,0,10,華南永昌-民權,2023-01-11,9312
8420,明揚,11,1,10,華南永昌-民權,2023-01-11,9312
1305,華夏,20,10,10,華南永昌-民權,2023-01-11,9312
2607,榮運,9,0,9,華南永昌-民權,2023-01-11,9312
8933,愛地雅,11,3,8,華南永昌-民權,2023-01-11,9312
1701,中化,7,0,7,華南永昌-民權,2023-01-11,9312
2382,廣達,7,0,7,華南永昌-民權,2023-01-11,9312
1722,台肥,6,0,6,華南永昌-民權,2023-01-11,9312
8050,廣積,6,0,6,華南永昌-民權,2023-01-11,9312
2634,漢翔,8,3,5,華南永昌-民權,2023-01-11,9312
4162,智擎,5,0,5,華南永昌-民權,2023-01-11,9312
4979,華星光,9,4,5,華南永昌-民權,2023-01-11,9312
6248,沛波,5,0,5,華南永昌-民權,2023-01-11,9312
1560,中砂,5,0,5,華南永昌-民權,2023-01-11,9312
00878,國泰永續高股息,6,2,4,華南永昌-民權,2023-01-11,9312
1314,中石化,5,1,4,華南永昌-民權,2023-01-11,9312
2359,所羅門,4,0,4,華南永昌-民權,2023-01-11,9312
5263,智崴,4,0,4,華南永昌-民權,2023-01-11,9312
6770,力積電,10,6,4,華南永昌-民權,2023-01-11,9312
1612,宏泰,3,0,3,華南永昌-民權,2023-01-11,9312
1760,寶齡富錦,9,6,3,華南永昌-民權,2023-01-11,9312
2413,環科,3,0,3,華南永昌-民權,2023-01-11,9312
3587,閎康,3,0,3,華南永昌-民權,2023-01-11,9312
4174,浩鼎,3,0,3,華南永昌-民權,2023-01-11,9312
5425,台半,4,1,3,華南永昌-民權,2023-01-11,9312
5508,永信建,3,0,3,華南永昌-民權,2023-01-11,9312
6186,新潤,3,0,3,華南永昌-民權,2023-01-11,9312
6215,和椿,3,0,3,華南永昌-民權,2023-01-11,9312
6649,台生材,3,0,3,華南永昌-民權,2023-01-11,9312
6865,偉康科技,3,0,3,華南永昌-民權,2023-01-11,9312
8069,元太,4,1,3,華南永昌-民權,2023-01-11,9312
8222,寶一,3,0,3,華南永昌-民權,2023-01-11,9312
3207,耀勝,3,0,3,華南永昌-民權,2023-01-11,9312
6533,晶心科,4,2,2,華南永昌-民權,2023-01-11,9312
1584,精剛,9,7,2,華南永昌-民權,2023-01-11,9312
00751B,元大AAA至A公司債,2,0,2,華南永昌-民權,2023-01-11,9312
2028,威致,2,0,2,華南永昌-民權,2023-01-11,9312
2338,光罩,2,0,2,華南永昌-民權,2023-01-11,9312
2618,長榮航,7,5,2,華南永昌-民權,2023-01-11,9312
3059,華晶科,2,0,2,華南永昌-民權,2023-01-11,9312
3227,原相,2,0,2,華南永昌-民權,2023-01-11,9312
00772B,中信高評級公司債,100,0,100,華南永昌-民權,2023-01-12,9312
6024,群益期,31,0,31,華南永昌-民權,2023-01-12,9312
00706L,期元大S＆P日圓正2,30,0,30,華南永昌-民權,2023-01-12,9312
00753L,中信中國50正2,44,15,29,華南永昌-民權,2023-01-12,9312
5009,榮剛,26,4,22,華南永昌-民權,2023-01-12,9312
2610,華航,27,11,16,華南永昌-民權,2023-01-12,9312
00878,國泰永續高股息,15,0,15,華南永昌-民權,2023-01-12,9312
2609,陽明,15,1,14,華南永昌-民權,2023-01-12,9312
2498,宏達電,31,19,12,華南永昌-民權,2023-01-12,9312
00673R,期元大S＆P原油反1,11,0,11,華南永昌-民權,2023-01-12,9312
00882,中信中國高股息,11,0,11,華南永昌-民權,2023-01-12,9312
6788,華景電,10,0,10,華南永昌-民權,2023-01-12,9312
5371,中光電,10,0,10,華南永昌-民權,2023-01-12,9312
1795,美時,14,5,9,華南永昌-民權,2023-01-12,9312
2201,裕隆,11,2,9,華南永昌-民權,2023-01-12,9312
5876,上海商銀,11,2,9,華南永昌-民權,2023-01-12,9312
1409,新纖,7,0,7,華南永昌-民權,2023-01-12,9312
1760,寶齡富錦,6,0,6,華南永昌-民權,2023-01-12,9312
2458,義隆,6,0,6,華南永昌-民權,2023-01-12,9312
6104,創惟,7,1,6,華南永昌-民權,2023-01-12,9312
2603,長榮,7,1,6,華南永昌-民權,2023-01-12,9312
1101,台泥,7,2,5,華南永昌-民權,2023-01-12,9312
00773B,中信優先金融債,5,0,5,華南永昌-民權,2023-01-12,9312
1471,首利,5,0,5,華南永昌-民權,2023-01-12,9312
2324,仁寶,5,0,5,華南永昌-民權,2023-01-12,9312
3306,鼎天,5,0,5,華南永昌-民權,2023-01-12,9312
6269,台郡,5,0,5,華南永昌-民權,2023-01-12,9312
2607,榮運,4,0,4,華南永昌-民權,2023-01-12,9312
3454,晶睿,6,2,4,華南永昌-民權,2023-01-12,9312
6451,訊芯-KY,4,0,4,華南永昌-民權,2023-01-12,9312
6865,偉康科技,4,0,4,華南永昌-民權,2023-01-12,9312
9958,世紀鋼,7,3,4,華南永昌-民權,2023-01-12,9312
1447,力鵬,3,0,3,華南永昌-民權,2023-01-12,9312
2038,海光,3,0,3,華南永昌-民權,2023-01-12,9312
2419,仲琦,3,0,3,華南永昌-民權,2023-01-12,9312
2891,中信金,3,0,3,華南永昌-民權,2023-01-12,9312
4106,雃博,3,0,3,華南永昌-民權,2023-01-12,9312
4128,中天,4,1,3,華南永昌-民權,2023-01-12,9312
4157,太景*-KY,5,2,3,華南永昌-民權,2023-01-12,9312
6182,合晶,3,0,3,華南永昌-民權,2023-01-12,9312
6235,華孚,3,0,3,華南永昌-民權,2023-01-12,9312
6248,沛波,3,0,3,華南永昌-民權,2023-01-12,9312
6472,保瑞,3,0,3,華南永昌-民權,2023-01-12,9312
1605,華新,13,10,3,華南永昌-民權,2023-01-12,9312
2723,美食-KY,3,0,3,華南永昌-民權,2023-01-12,9312
2409,友達,2,0,2,華南永昌-民權,2023-01-12,9312
5880,合庫金,2,0,2,華南永昌-民權,2023-01-12,9312
1513,中興電,2,0,2,華南永昌-民權,2023-01-12,9312
1477,聚陽,2,0,2,華南永昌-民權,2023-01-12,9312
00752,中信中國50,2,0,2,華南永昌-民權,2023-01-12,9312
2881,富邦金,102,0,102,華南永昌-民權,2023-01-13,9312
2498,宏達電,56,5,51,華南永昌-民權,2023-01-13,9312
8046,南電,24,1,23,華南永昌-民權,2023-01-13,9312
2208,台船,12,0,12,華南永昌-民權,2023-01-13,9312
4113,聯上,11,0,11,華南永昌-民權,2023-01-13,9312
3081,聯亞,10,0,10,華南永昌-民權,2023-01-13,9312
6189,豐藝,10,0,10,華南永昌-民權,2023-01-13,9312
2609,陽明,11,2,9,華南永昌-民權,2023-01-13,9312
1609,大亞,6,0,6,華南永昌-民權,2023-01-13,9312
5258,虹堡,6,0,6,華南永昌-民權,2023-01-13,9312
8087,麗升能源,6,0,6,華南永昌-民權,2023-01-13,9312
1514,亞力,5,0,5,華南永昌-民權,2023-01-13,9312
1314,中石化,5,0,5,華南永昌-民權,2023-01-13,9312
00701,國泰股利精選30,5,0,5,華南永昌-民權,2023-01-13,9312
0056,元大高股息,5,0,5,華南永昌-民權,2023-01-13,9312
1795,美時,5,0,5,華南永昌-民權,2023-01-13,9312
3322,建舜電,5,0,5,華南永昌-民權,2023-01-13,9312
5371,中光電,5,0,5,華南永昌-民權,2023-01-13,9312
2468,華經,11,7,4,華南永昌-民權,2023-01-13,9312
2885,元大金,4,0,4,華南永昌-民權,2023-01-13,9312
3406,玉晶光,3,0,3,華南永昌-民權,2023-01-13,9312
2313,華通,3,0,3,華南永昌-民權,2023-01-13,9312
2460,建通,3,0,3,華南永昌-民權,2023-01-13,9312
5425,台半,3,0,3,華南永昌-民權,2023-01-13,9312
6770,力積電,4,1,3,華南永昌-民權,2023-01-13,9312
8411,福貞-KY,3,0,3,華南永昌-民權,2023-01-13,9312
9911,櫻花,3,0,3,華南永昌-民權,2023-01-13,9312
8112A,至上甲特,2,0,2,華南永昌-民權,2023-01-13,9312
00878,國泰永續高股息,2,0,2,華南永昌-民權,2023-01-13,9312
6274,台燿,3,1,2,華南永昌-民權,2023-01-13,9312
1612,宏泰,2,0,2,華南永昌-民權,2023-01-13,9312
1718,中纖,2,0,2,華南永昌-民權,2023-01-13,9312
1605,華新,9,7,2,華南永昌-民權,2023-01-13,9312
2009,第一銅,2,0,2,華南永昌-民權,2023-01-13,9312
2105,正新,2,0,2,華南永昌-民權,2023-01-13,9312
2358,廷鑫,11,9,2,華南永昌-民權,2023-01-13,9312
2419,仲琦,3,1,2,華南永昌-民權,2023-01-13,9312
2891,中信金,2,0,2,華南永昌-民權,2023-01-13,9312
3346,麗清,3,1,2,華南永昌-民權,2023-01-13,9312
3481,群創,2,0,2,華南永昌-民權,2023-01-13,9312
3711,日月光投控,5,3,2,華南永昌-民權,2023-01-13,9312
4164,承業醫,2,0,2,華南永昌-民權,2023-01-13,9312
4966,譜瑞-KY,2,0,2,華南永昌-民權,2023-01-13,9312
6245,立端,2,0,2,華南永昌-民權,2023-01-13,9312
6248,沛波,2,0,2,華南永昌-民權,2023-01-13,9312
8038,長園科,2,0,2,華南永昌-民權,2023-01-13,9312
8171,天宇,2,0,2,華南永昌-民權,2023-01-13,9312
6472,保瑞,1,0,1,華南永昌-民權,2023-01-13,9312
4167,松瑞藥,1,0,1,華南永昌-民權,2023-01-13,9312
2454,聯發科,1,0,1,華南永昌-民權,2023-01-13,9312
2881,富邦金,67,2,65,華南永昌-民權,2023-01-16,9312
2915,潤泰全,43,0,43,華南永昌-民權,2023-01-16,9312
2330,台積電,40,7,33,華南永昌-民權,2023-01-16,9312
2634,漢翔,24,3,21,華南永昌-民權,2023-01-16,9312
4747,強生,20,0,20,華南永昌-民權,2023-01-16,9312
2208,台船,18,1,17,華南永昌-民權,2023-01-16,9312
2609,陽明,18,3,15,華南永昌-民權,2023-01-16,9312
2498,宏達電,14,0,14,華南永昌-民權,2023-01-16,9312
3037,欣興,15,1,14,華南永昌-民權,2023-01-16,9312
2618,長榮航,16,3,13,華南永昌-民權,2023-01-16,9312
2371,大同,10,0,10,華南永昌-民權,2023-01-16,9312
3027,盛達,10,0,10,華南永昌-民權,2023-01-16,9312
3710,連展投控,10,0,10,華南永昌-民權,2023-01-16,9312
6152,百一,10,0,10,華南永昌-民權,2023-01-16,9312
5284,jpp-KY,12,3,9,華南永昌-民權,2023-01-16,9312
3189,景碩,8,0,8,華南永昌-民權,2023-01-16,9312
00679B,元大美債20年,6,0,6,華南永昌-民權,2023-01-16,9312
2317,鴻海,6,0,6,華南永昌-民權,2023-01-16,9312
9938,百和,7,2,5,華南永昌-民權,2023-01-16,9312
00773B,中信優先金融債,5,0,5,華南永昌-民權,2023-01-16,9312
00881,國泰台灣5G+,5,0,5,華南永昌-民權,2023-01-16,9312
1536,和大,5,0,5,華南永昌-民權,2023-01-16,9312
2399,映泰,5,0,5,華南永昌-民權,2023-01-16,9312
9907,統一實,5,0,5,華南永昌-民權,2023-01-16,9312
2882,國泰金,7,2,5,華南永昌-民權,2023-01-16,9312
00885,富邦越南,4,0,4,華南永昌-民權,2023-01-16,9312
00701,國泰股利精選30,4,0,4,華南永昌-民權,2023-01-16,9312
2486,一詮,4,0,4,華南永昌-民權,2023-01-16,9312
3504,揚明光,4,0,4,華南永昌-民權,2023-01-16,9312
6213,聯茂,4,0,4,華南永昌-民權,2023-01-16,9312
1605,華新,3,0,3,華南永昌-民權,2023-01-16,9312
0056,元大高股息,3,1,2,華南永昌-民權,2023-01-16,9312
1471,首利,2,0,2,華南永昌-民權,2023-01-16,9312
2063,世鎧,2,0,2,華南永昌-民權,2023-01-16,9312
2331,精英,2,0,2,華南永昌-民權,2023-01-16,9312
2365,昆盈,2,0,2,華南永昌-民權,2023-01-16,9312
2511,太子,2,0,2,華南永昌-民權,2023-01-16,9312
2637,慧洋-KY,2,0,2,華南永昌-民權,2023-01-16,9312
2732,六角,2,0,2,華南永昌-民權,2023-01-16,9312
2883,凱基金,2,0,2,華南永昌-民權,2023-01-16,9312
3071,協禧,2,0,2,華南永昌-民權,2023-01-16,9312
3205,佰研,2,0,2,華南永昌-民權,2023-01-16,9312
4162,智擎,3,1,2,華南永昌-民權,2023-01-16,9312
4164,承業醫,2,0,2,華南永昌-民權,2023-01-16,9312
5608,四維航,3,1,2,華南永昌-民權,2023-01-16,9312
8420,明揚,3,1,2,華南永昌-民權,2023-01-16,9312
3680,家登,2,0,2,華南永昌-民權,2023-01-16,9312
2303,聯電,7,5,2,華南永昌-民權,2023-01-16,9312
2884,玉山金,1,0,1,華南永昌-民權,2023-01-16,9312
2104,國際中橡,1,0,1,華南永昌-民權,2023-01-16,9312
00706L,期元大S＆P日圓正2,70,0,70,華南永昌-民權,2023-01-17,9312
2884,玉山金,46,3,43,華南永昌-民權,2023-01-17,9312
1536,和大,25,0,25,華南永昌-民權,2023-01-17,9312
6770,力積電,20,0,20,華南永昌-民權,2023-01-17,9312
1101,台泥,18,0,18,華南永昌-民權,2023-01-17,9312
00753L,中信中國50正2,42,25,17,華南永昌-民權,2023-01-17,9312
3013,晟銘電,23,10,13,華南永昌-民權,2023-01-17,9312
2618,長榮航,11,0,11,華南永昌-民權,2023-01-17,9312
2881,富邦金,14,3,11,華南永昌-民權,2023-01-17,9312
1760,寶齡富錦,10,0,10,華南永昌-民權,2023-01-17,9312
2009,第一銅,10,0,10,華南永昌-民權,2023-01-17,9312
2305,全友,10,0,10,華南永昌-民權,2023-01-17,9312
2371,大同,10,0,10,華南永昌-民權,2023-01-17,9312
6152,百一,10,0,10,華南永昌-民權,2023-01-17,9312
3693,營邦,26,18,8,華南永昌-民權,2023-01-17,9312
3704,合勤控,6,0,6,華南永昌-民權,2023-01-17,9312
2614,東森,8,2,6,華南永昌-民權,2023-01-17,9312
8436,大江,5,0,5,華南永昌-民權,2023-01-17,9312
00720B,元大投資級公司債,5,0,5,華南永昌-民權,2023-01-17,9312
00772B,中信高評級公司債,5,0,5,華南永昌-民權,2023-01-17,9312
1711,永光,5,0,5,華南永昌-民權,2023-01-17,9312
2497,怡利電,5,0,5,華南永昌-民權,2023-01-17,9312
4128,中天,5,0,5,華南永昌-民權,2023-01-17,9312
6548,長科*,5,0,5,華南永昌-民權,2023-01-17,9312
1467,南緯,15,11,4,華南永昌-民權,2023-01-17,9312
5880,合庫金,4,0,4,華南永昌-民權,2023-01-17,9312
00673R,期元大S＆P原油反1,3,0,3,華南永昌-民權,2023-01-17,9312
5508,永信建,4,1,3,華南永昌-民權,2023-01-17,9312
6235,華孚,3,0,3,華南永昌-民權,2023-01-17,9312
2609,陽明,4,1,3,華南永昌-民權,2023-01-17,9312
8171,天宇,6,4,2,華南永昌-民權,2023-01-17,9312
8040,九暘,2,0,2,華南永昌-民權,2023-01-17,9312
4763,材料-KY,15,13,2,華南永昌-民權,2023-01-17,9312
1227,佳格,2,0,2,華南永昌-民權,2023-01-17,9312
00752,中信中國50,2,0,2,華南永昌-民權,2023-01-17,9312
1612,宏泰,2,0,2,華南永昌-民權,2023-01-17,9312
2063,世鎧,2,0,2,華南永昌-民權,2023-01-17,9312
2312,金寶,2,0,2,華南永昌-民權,2023-01-17,9312
2812,台中銀,2,0,2,華南永昌-民權,2023-01-17,9312
3010,華立,2,0,2,華南永昌-民權,2023-01-17,9312
3454,晶睿,16,14,2,華南永昌-民權,2023-01-17,9312
3481,群創,3,1,2,華南永昌-民權,2023-01-17,9312
6104,創惟,3,1,2,華南永昌-民權,2023-01-17,9312
6609,瀧澤科,4,2,2,華南永昌-民權,2023-01-17,9312
8050,廣積,2,0,2,華南永昌-民權,2023-01-17,9312
2882,國泰金,3,1,2,華南永昌-民權,2023-01-17,9312
00770,國泰北美科技,2,1,1,華南永昌-民權,2023-01-17,9312
1471,首利,1,0,1,華南永昌-民權,2023-01-17,9312
0050,元大台灣50,1,0,1,華南永昌-民權,2023-01-17,9312
00664R,國泰臺灣加權反1,1,0,1,華南永昌-民權,2023-01-17,9312
2881,富邦金,323,5,318,華南永昌-民權,2023-01-30,9312
3481,群創,136,24,112,華南永昌-民權,2023-01-30,9312
1423,利華,30,0,30,華南永昌-民權,2023-01-30,9312
6235,華孚,40,12,28,華南永昌-民權,2023-01-30,9312
2634,漢翔,23,2,21,華南永昌-民權,2023-01-30,9312
2317,鴻海,23,3,20,華南永昌-民權,2023-01-30,9312
1109,信大,20,0,20,華南永昌-民權,2023-01-30,9312
2014,中鴻,23,5,18,華南永昌-民權,2023-01-30,9312
8069,元太,15,2,13,華南永昌-民權,2023-01-30,9312
2363,矽統,10,0,10,華南永昌-民權,2023-01-30,9312
2444,兆勁,10,0,10,華南永昌-民權,2023-01-30,9312
2867,三商壽,10,0,10,華南永昌-民權,2023-01-30,9312
3013,晟銘電,10,0,10,華南永昌-民權,2023-01-30,9312
4114,健喬,11,1,10,華南永昌-民權,2023-01-30,9312
6244,茂迪,10,0,10,華南永昌-民權,2023-01-30,9312
2892,第一金,8,0,8,華南永昌-民權,2023-01-30,9312
2428,興勤,10,2,8,華南永昌-民權,2023-01-30,9312
3693,營邦,29,21,8,華南永昌-民權,2023-01-30,9312
6279,胡連,10,3,7,華南永昌-民權,2023-01-30,9312
2609,陽明,21,14,7,華南永昌-民權,2023-01-30,9312
1519,華城,44,38,6,華南永昌-民權,2023-01-30,9312
2230,泰茂,6,0,6,華南永昌-民權,2023-01-30,9312
2732,六角,6,0,6,華南永昌-民權,2023-01-30,9312
1314,中石化,5,0,5,華南永昌-民權,2023-01-30,9312
00878,國泰永續高股息,16,11,5,華南永昌-民權,2023-01-30,9312
3594,磐儀,5,0,5,華南永昌-民權,2023-01-30,9312
6269,台郡,5,0,5,華南永昌-民權,2023-01-30,9312
6288,聯嘉,5,0,5,華南永昌-民權,2023-01-30,9312
3324,雙鴻,5,0,5,華南永昌-民權,2023-01-30,9312
1514,亞力,4,0,4,華南永昌-民權,2023-01-30,9312
2497,怡利電,4,0,4,華南永昌-民權,2023-01-30,9312
6257,矽格,4,0,4,華南永昌-民權,2023-01-30,9312
2603,長榮,3,0,3,華南永昌-民權,2023-01-30,9312
00720B,元大投資級公司債,3,0,3,華南永昌-民權,2023-01-30,9312
00671R,富邦NASDAQ反1,3,0,3,華南永昌-民權,2023-01-30,9312
1701,中化,5,2,3,華南永昌-民權,2023-01-30,9312
1722,台肥,3,0,3,華南永昌-民權,2023-01-30,9312
2033,佳大,4,1,3,華南永昌-民權,2023-01-30,9312
2368,金像電,3,0,3,華南永昌-民權,2023-01-30,9312
2702,華園,3,0,3,華南永昌-民權,2023-01-30,9312
4747,強生,3,0,3,華南永昌-民權,2023-01-30,9312
6138,茂達,3,0,3,華南永昌-民權,2023-01-30,9312
8033,雷虎,3,0,3,華南永昌-民權,2023-01-30,9312
2610,華航,6,3,3,華南永昌-民權,2023-01-30,9312
1608,華榮,4,1,3,華南永昌-民權,2023-01-30,9312
3661,世芯-KY,2,0,2,華南永昌-民權,2023-01-30,9312
1477,聚陽,2,0,2,華南永昌-民權,2023-01-30,9312
1471,首利,2,0,2,華南永昌-民權,2023-01-30,9312
00633L,富邦上証正2,2,0,2,華南永昌-民權,2023-01-30,9312
00632R,元大台灣50反1,3,1,2,華南永昌-民權,2023-01-30,9312
2412,中華電,50,0,50,華南永昌-民權,2023-01-31,9312
2465,麗臺,72,30,42,華南永昌-民權,2023-01-31,9312
6182,合晶,35,1,34,華南永昌-民權,2023-01-31,9312
1536,和大,30,0,30,華南永昌-民權,2023-01-31,9312
00893,國泰智能電動車,28,2,26,華南永昌-民權,2023-01-31,9312
2330,台積電,30,8,22,華南永昌-民權,2023-01-31,9312
3576,聯合再生,20,0,20,華南永昌-民權,2023-01-31,9312
6570,維田,20,0,20,華南永昌-民權,2023-01-31,9312
00878,國泰永續高股息,23,7,16,華南永昌-民權,2023-01-31,9312
3481,群創,18,3,15,華南永昌-民權,2023-01-31,9312
00637L,元大滬深300正2,20,5,15,華南永昌-民權,2023-01-31,9312
1305,華夏,15,0,15,華南永昌-民權,2023-01-31,9312
2887,台新金,17,2,15,華南永昌-民權,2023-01-31,9312
1467,南緯,20,8,12,華南永昌-民權,2023-01-31,9312
00720B,元大投資級公司債,12,1,11,華南永昌-民權,2023-01-31,9312
8415,大國鋼,11,0,11,華南永昌-民權,2023-01-31,9312
00679B,元大美債20年,10,0,10,華南永昌-民權,2023-01-31,9312
1616,億泰,10,0,10,華南永昌-民權,2023-01-31,9312
1612,宏泰,20,10,10,華南永昌-民權,2023-01-31,9312
3711,日月光投控,9,0,9,華南永昌-民權,2023-01-31,9312
2615,萬海,9,0,9,華南永昌-民權,2023-01-31,9312
2880,華南金,9,0,9,華南永昌-民權,2023-01-31,9312
2883,凱基金,11,2,9,華南永昌-民權,2023-01-31,9312
2892,第一金,9,0,9,華南永昌-民權,2023-01-31,9312
2324,仁寶,10,2,8,華南永昌-民權,2023-01-31,9312
1608,華榮,10,2,8,華南永昌-民權,2023-01-31,9312
2317,鴻海,151,143,8,華南永昌-民權,2023-01-31,9312
00632R,元大台灣50反1,7,0,7,華南永昌-民權,2023-01-31,9312
1524,耿鼎,10,3,7,華南永昌-民權,2023-01-31,9312
3045,台灣大,7,0,7,華南永昌-民權,2023-01-31,9312
3264,欣銓,7,0,7,華南永昌-民權,2023-01-31,9312
6150,撼訊,7,0,7,華南永昌-民權,2023-01-31,9312
00753L,中信中國50正2,14,8,6,華南永昌-民權,2023-01-31,9312
00905,FT臺灣Smart,6,0,6,華南永昌-民權,2023-01-31,9312
2208,台船,6,0,6,華南永昌-民權,2023-01-31,9312
3088,艾訊,6,0,6,華南永昌-民權,2023-01-31,9312
6213,聯茂,8,2,6,華南永昌-民權,2023-01-31,9312
6266,泰詠,6,0,6,華南永昌-民權,2023-01-31,9312
1423,利華,5,0,5,華南永昌-民權,2023-01-31,9312
1795,美時,15,10,5,華南永昌-民權,2023-01-31,9312
1809,中釉,5,0,5,華南永昌-民權,2023-01-31,9312
2380,虹光,5,0,5,華南永昌-民權,2023-01-31,9312
2406,國碩,8,3,5,華南永昌-民權,2023-01-31,9312
3413,京鼎,5,0,5,華南永昌-民權,2023-01-31,9312
3535,晶彩科,5,0,5,華南永昌-民權,2023-01-31,9312
4513,福裕,5,0,5,華南永昌-民權,2023-01-31,9312
5014,建錩,6,1,5,華南永昌-民權,2023-01-31,9312
6152,百一,5,0,5,華南永昌-民權,2023-01-31,9312
6155,鈞寶,5,0,5,華南永昌-民權,2023-01-31,9312
2368,金像電,5,1,4,華南永昌-民權,2023-01-31,9312
4927,泰鼎-KY,112,0,112,華南永昌-民權,2023-02-01,9312
00725B,國泰投資級公司債,100,0,100,華南永昌-民權,2023-02-01,9312
2891,中信金,40,0,40,華南永昌-民權,2023-02-01,9312
00882,中信中國高股息,27,0,27,華南永昌-民權,2023-02-01,9312
2303,聯電,40,20,20,華南永昌-民權,2023-02-01,9312
1584,精剛,92,72,20,華南永昌-民權,2023-02-01,9312
3443,創意,20,0,20,華南永昌-民權,2023-02-01,9312
2890,永豐金,22,3,19,華南永昌-民權,2023-02-01,9312
2329,華泰,15,0,15,華南永昌-民權,2023-02-01,9312
1785,光洋科,20,6,14,華南永昌-民權,2023-02-01,9312
1513,中興電,17,6,11,華南永昌-民權,2023-02-01,9312
2634,漢翔,19,8,11,華南永昌-民權,2023-02-01,9312
2880,華南金,11,0,11,華南永昌-民權,2023-02-01,9312
3552,同致,11,0,11,華南永昌-民權,2023-02-01,9312
8046,南電,30,20,10,華南永昌-民權,2023-02-01,9312
5009,榮剛,22,12,10,華南永昌-民權,2023-02-01,9312
1301,台塑,10,0,10,華南永昌-民權,2023-02-01,9312
3030,德律,10,0,10,華南永昌-民權,2023-02-01,9312
5014,建錩,10,0,10,華南永昌-民權,2023-02-01,9312
6147,頎邦,10,0,10,華南永昌-民權,2023-02-01,9312
6570,維田,10,0,10,華南永昌-民權,2023-02-01,9312
6830,汎銓,10,0,10,華南永昌-民權,2023-02-01,9312
2412,中華電,10,1,9,華南永昌-民權,2023-02-01,9312
6118,建達,12,3,9,華南永昌-民權,2023-02-01,9312
8478,東哥遊艇,9,1,8,華南永昌-民權,2023-02-01,9312
2369,菱生,8,0,8,華南永昌-民權,2023-02-01,9312
2887,台新金,8,0,8,華南永昌-民權,2023-02-01,9312
6505,台塑化,8,0,8,華南永昌-民權,2023-02-01,9312
2317,鴻海,8,1,7,華南永昌-民權,2023-02-01,9312
3576,聯合再生,8,1,7,華南永昌-民權,2023-02-01,9312
5347,世界,7,0,7,華南永昌-民權,2023-02-01,9312
6109,亞元,7,0,7,華南永昌-民權,2023-02-01,9312
2884,玉山金,21,15,6,華南永昌-民權,2023-02-01,9312
3693,營邦,41,35,6,華南永昌-民權,2023-02-01,9312
8927,北基,6,0,6,華南永昌-民權,2023-02-01,9312
1760,寶齡富錦,5,0,5,華南永昌-民權,2023-02-01,9312
00905,FT臺灣Smart,5,0,5,華南永昌-民權,2023-02-01,9312
00650L,復華香港正2,5,0,5,華南永昌-民權,2023-02-01,9312
00637L,元大滬深300正2,5,0,5,華南永昌-民權,2023-02-01,9312
1722,台肥,5,0,5,華南永昌-民權,2023-02-01,9312
1752,南光,5,0,5,華南永昌-民權,2023-02-01,9312
2409,友達,8,3,5,華南永昌-民權,2023-02-01,9312
2906,高林,5,0,5,華南永昌-民權,2023-02-01,9312
3535,晶彩科,5,0,5,華南永昌-民權,2023-02-01,9312
6150,撼訊,5,0,5,華南永昌-民權,2023-02-01,9312
6266,泰詠,5,0,5,華南永昌-民權,2023-02-01,9312
9938,百和,5,0,5,華南永昌-民權,2023-02-01,9312
3141,晶宏,5,0,5,華南永昌-民權,2023-02-01,9312
4905,台聯電,4,0,4,華南永昌-民權,2023-02-01,9312
1524,耿鼎,11,7,4,華南永昌-民權,2023-02-01,9312
4927,泰鼎-KY,390,0,390,華南永昌-民權,2023-02-02,9312
00632R,元大台灣50反1,370,0,370,華南永昌-民權,2023-02-02,9312
1536,和大,174,3,171,華南永昌-民權,2023-02-02,9312
2732,六角,41,0,41,華南永昌-民權,2023-02-02,9312
6269,台郡,40,0,40,華南永昌-民權,2023-02-02,9312
2618,長榮航,34,5,29,華南永昌-民權,2023-02-02,9312
00885,富邦越南,27,0,27,華南永昌-民權,2023-02-02,9312
8150,南茂,27,0,27,華南永昌-民權,2023-02-02,9312
4915,致伸,26,1,25,華南永昌-民權,2023-02-02,9312
2929,淘帝-KY,21,0,21,華南永昌-民權,2023-02-02,9312
6643,M31,21,0,21,華南永昌-民權,2023-02-02,9312
2317,鴻海,219,200,19,華南永昌-民權,2023-02-02,9312
4905,台聯電,16,0,16,華南永昌-民權,2023-02-02,9312
6488,環球晶,15,0,15,華南永昌-民權,2023-02-02,9312
9938,百和,15,0,15,華南永昌-民權,2023-02-02,9312
00715L,期街口布蘭特正2,13,0,13,華南永昌-民權,2023-02-02,9312
8463,潤泰材,13,0,13,華南永昌-民權,2023-02-02,9312
00637L,元大滬深300正2,12,0,12,華南永昌-民權,2023-02-02,9312
00720B,元大投資級公司債,11,0,11,華南永昌-民權,2023-02-02,9312
1809,中釉,11,0,11,華南永昌-民權,2023-02-02,9312
4919,新唐,16,5,11,華南永昌-民權,2023-02-02,9312
2489,瑞軒,10,0,10,華南永昌-民權,2023-02-02,9312
4720,德淵,10,0,10,華南永昌-民權,2023-02-02,9312
1519,華城,10,1,9,華南永昌-民權,2023-02-02,9312
3037,欣興,11,2,9,華南永昌-民權,2023-02-02,9312
3712,永崴投控,8,0,8,華南永昌-民權,2023-02-02,9312
2358,廷鑫,8,1,7,華南永昌-民權,2023-02-02,9312
6116,彩晶,10,3,7,華南永昌-民權,2023-02-02,9312
6541,泰福-KY,8,1,7,華南永昌-民權,2023-02-02,9312
2413,環科,8,2,6,華南永昌-民權,2023-02-02,9312
1609,大亞,18,12,6,華南永昌-民權,2023-02-02,9312
2201,裕隆,7,2,5,華南永昌-民權,2023-02-02,9312
00706L,期元大S＆P日圓正2,5,0,5,華南永昌-民權,2023-02-02,9312
1760,寶齡富錦,5,0,5,華南永昌-民權,2023-02-02,9312
3032,偉訓,5,0,5,華南永昌-民權,2023-02-02,9312
4906,正文,5,0,5,華南永昌-民權,2023-02-02,9312
4908,前鼎,10,5,5,華南永昌-民權,2023-02-02,9312
8033,雷虎,7,2,5,華南永昌-民權,2023-02-02,9312
2399,映泰,4,0,4,華南永昌-民權,2023-02-02,9312
2702,華園,4,0,4,華南永昌-民權,2023-02-02,9312
2887,台新金,4,0,4,華南永昌-民權,2023-02-02,9312
3027,盛達,4,0,4,華南永昌-民權,2023-02-02,9312
6111,大宇資,4,0,4,華南永昌-民權,2023-02-02,9312
6231,系微,4,0,4,華南永昌-民權,2023-02-02,9312
3293,鈊象,6,3,3,華南永昌-民權,2023-02-02,9312
00903,富邦元宇宙,3,0,3,華南永昌-民權,2023-02-02,9312
1529,樂事綠能,3,0,3,華南永昌-民權,2023-02-02,9312
1514,亞力,3,0,3,華南永昌-民權,2023-02-02,9312
1537,廣隆,3,0,3,華南永昌-民權,2023-02-02,9312
2634,漢翔,10,7,3,華南永昌-民權,2023-02-02,9312
00632R,元大台灣50反1,373,0,373,華南永昌-民權,2023-02-03,9312
4927,泰鼎-KY,119,0,119,華南永昌-民權,2023-02-03,9312
2881,富邦金,103,1,102,華南永昌-民權,2023-02-03,9312
00679B,元大美債20年,105,5,100,華南永昌-民權,2023-02-03,9312
2102,泰豐,80,0,80,華南永昌-民權,2023-02-03,9312
2610,華航,66,2,64,華南永昌-民權,2023-02-03,9312
00903,富邦元宇宙,50,10,40,華南永昌-民權,2023-02-03,9312
2388,威盛,41,5,36,華南永昌-民權,2023-02-03,9312
2101,南港,30,0,30,華南永昌-民權,2023-02-03,9312
00753L,中信中國50正2,55,29,26,華南永昌-民權,2023-02-03,9312
2371,大同,20,0,20,華南永昌-民權,2023-02-03,9312
3047,訊舟,20,0,20,華南永昌-民權,2023-02-03,9312
2103,台橡,12,0,12,華南永昌-民權,2023-02-03,9312
2363,矽統,12,0,12,華南永昌-民權,2023-02-03,9312
2338,光罩,11,0,11,華南永昌-民權,2023-02-03,9312
00878,國泰永續高股息,13,2,11,華南永昌-民權,2023-02-03,9312
9945,潤泰新,10,0,10,華南永昌-民權,2023-02-03,9312
1513,中興電,12,2,10,華南永昌-民權,2023-02-03,9312
2484,希華,11,1,10,華南永昌-民權,2023-02-03,9312
00895,富邦未來車,10,0,10,華南永昌-民權,2023-02-03,9312
00893,國泰智能電動車,10,0,10,華南永昌-民權,2023-02-03,9312
3231,緯創,10,0,10,華南永昌-民權,2023-02-03,9312
3535,晶彩科,10,0,10,華南永昌-民權,2023-02-03,9312
8068,全達,10,0,10,華南永昌-民權,2023-02-03,9312
9105,泰金寶-DR,10,0,10,華南永昌-民權,2023-02-03,9312
2812,台中銀,10,0,10,華南永昌-民權,2023-02-03,9312
2409,友達,10,1,9,華南永昌-民權,2023-02-03,9312
2498,宏達電,28,19,9,華南永昌-民權,2023-02-03,9312
2880,華南金,9,0,9,華南永昌-民權,2023-02-03,9312
4114,健喬,29,21,8,華南永昌-民權,2023-02-03,9312
5608,四維航,9,1,8,華南永昌-民權,2023-02-03,9312
3037,欣興,8,0,8,華南永昌-民權,2023-02-03,9312
00715L,期街口布蘭特正2,7,0,7,華南永昌-民權,2023-02-03,9312
2497,怡利電,8,1,7,華南永昌-民權,2023-02-03,9312
5351,鈺創,10,3,7,華南永昌-民權,2023-02-03,9312
00882,中信中國高股息,7,1,6,華南永昌-民權,2023-02-03,9312
2356,英業達,6,0,6,華南永昌-民權,2023-02-03,9312
2364,倫飛,8,2,6,華南永昌-民權,2023-02-03,9312
2888,新光金,6,0,6,華南永昌-民權,2023-02-03,9312
2929,淘帝-KY,6,0,6,華南永昌-民權,2023-02-03,9312
6104,創惟,37,31,6,華南永昌-民權,2023-02-03,9312
00885,富邦越南,5,0,5,華南永昌-民權,2023-02-03,9312
00902,中信電池及儲能,5,0,5,華南永昌-民權,2023-02-03,9312
2481,強茂,7,2,5,華南永昌-民權,2023-02-03,9312
2809,京城銀,9,4,5,華南永昌-民權,2023-02-03,9312
3041,揚智,6,1,5,華南永昌-民權,2023-02-03,9312
3221,台嘉碩,5,0,5,華南永昌-民權,2023-02-03,9312
5258,虹堡,9,4,5,華南永昌-民權,2023-02-03,9312
5706,鳳凰,5,0,5,華南永昌-民權,2023-02-03,9312
0056,元大高股息,4,0,4,華南永昌-民權,2023-02-03,9312
00878,國泰永續高股息,94,0,94,華南永昌-民權,2023-02-06,9312
4927,泰鼎-KY,80,0,80,華南永昌-民權,2023-02-06,9312
0056,元大高股息,66,0,66,華南永昌-民權,2023-02-06,9312
2208,台船,70,11,59,華南永昌-民權,2023-02-06,9312
1605,華新,78,20,58,華南永昌-民權,2023-02-06,9312
2330,台積電,48,2,46,華南永昌-民權,2023-02-06,9312
2884,玉山金,53,17,36,華南永昌-民權,2023-02-06,9312
5425,台半,30,1,29,華南永昌-民權,2023-02-06,9312
2102,泰豐,23,0,23,華南永昌-民權,2023-02-06,9312
2101,南港,20,0,20,華南永昌-民權,2023-02-06,9312
2303,聯電,23,5,18,華南永昌-民權,2023-02-06,9312
2915,潤泰全,13,0,13,華南永昌-民權,2023-02-06,9312
2609,陽明,14,2,12,華南永昌-民權,2023-02-06,9312
2352,佳世達,12,0,12,華南永昌-民權,2023-02-06,9312
2888,新光金,11,0,11,華南永昌-民權,2023-02-06,9312
00715L,期街口布蘭特正2,10,0,10,華南永昌-民權,2023-02-06,9312
6213,聯茂,16,6,10,華南永昌-民權,2023-02-06,9312
2317,鴻海,29,19,10,華南永昌-民權,2023-02-06,9312
2607,榮運,9,0,9,華南永昌-民權,2023-02-06,9312
00885,富邦越南,9,1,8,華南永昌-民權,2023-02-06,9312
2204,中華,8,0,8,華南永昌-民權,2023-02-06,9312
4746,台耀,15,7,8,華南永昌-民權,2023-02-06,9312
6589,台康生技,10,2,8,華南永昌-民權,2023-02-06,9312
2344,華邦電,8,1,7,華南永昌-民權,2023-02-06,9312
3037,欣興,11,4,7,華南永昌-民權,2023-02-06,9312
00752,中信中國50,7,0,7,華南永昌-民權,2023-02-06,9312
2610,華航,8,1,7,華南永昌-民權,2023-02-06,9312
2880,華南金,7,0,7,華南永昌-民權,2023-02-06,9312
3481,群創,7,0,7,華南永昌-民權,2023-02-06,9312
2615,萬海,10,4,6,華南永昌-民權,2023-02-06,9312
5347,世界,6,0,6,華南永昌-民權,2023-02-06,9312
5426,振發,6,0,6,華南永昌-民權,2023-02-06,9312
6274,台燿,6,0,6,華南永昌-民權,2023-02-06,9312
6789,采鈺,6,0,6,華南永昌-民權,2023-02-06,9312
0050,元大台灣50,6,1,5,華南永昌-民權,2023-02-06,9312
2892,第一金,11,6,5,華南永昌-民權,2023-02-06,9312
00637L,元大滬深300正2,5,0,5,華南永昌-民權,2023-02-06,9312
3189,景碩,6,1,5,華南永昌-民權,2023-02-06,9312
3548,兆利,5,0,5,華南永昌-民權,2023-02-06,9312
4919,新唐,5,0,5,華南永昌-民權,2023-02-06,9312
5880,合庫金,5,0,5,華南永昌-民權,2023-02-06,9312
2201,裕隆,4,0,4,華南永昌-民權,2023-02-06,9312
3293,鈊象,8,4,4,華南永昌-民權,2023-02-06,9312
2358,廷鑫,4,0,4,華南永昌-民權,2023-02-06,9312
3454,晶睿,37,33,4,華南永昌-民權,2023-02-06,9312
3704,合勤控,6,2,4,華南永昌-民權,2023-02-06,9312
5284,jpp-KY,4,0,4,華南永昌-民權,2023-02-06,9312
5536,聖暉*,4,0,4,華南永昌-民權,2023-02-06,9312
6231,系微,4,0,4,華南永昌-民權,2023-02-06,9312
8215,明基材,4,0,4,華南永昌-民權,2023-02-06,9312
4927,泰鼎-KY,300,0,300,華南永昌-民權,2023-02-07,9312
2610,華航,92,0,92,華南永昌-民權,2023-02-07,9312
2607,榮運,42,1,41,華南永昌-民權,2023-02-07,9312
1605,華新,39,1,38,華南永昌-民權,2023-02-07,9312
6770,力積電,34,4,30,華南永昌-民權,2023-02-07,9312
2312,金寶,20,0,20,華南永昌-民權,2023-02-07,9312
2890,永豐金,17,0,17,華南永昌-民權,2023-02-07,9312
2344,華邦電,15,1,14,華南永昌-民權,2023-02-07,9312
00679B,元大美債20年,16,4,12,華南永昌-民權,2023-02-07,9312
2303,聯電,18,7,11,華南永昌-民權,2023-02-07,9312
5371,中光電,11,0,11,華南永昌-民權,2023-02-07,9312
00878,國泰永續高股息,10,0,10,華南永昌-民權,2023-02-07,9312
1513,中興電,10,0,10,華南永昌-民權,2023-02-07,9312
2371,大同,10,0,10,華南永昌-民權,2023-02-07,9312
2498,宏達電,13,3,10,華南永昌-民權,2023-02-07,9312
8033,雷虎,10,0,10,華南永昌-民權,2023-02-07,9312
2618,長榮航,13,4,9,華南永昌-民權,2023-02-07,9312
2330,台積電,8,1,7,華南永昌-民權,2023-02-07,9312
1109,信大,7,0,7,華南永昌-民權,2023-02-07,9312
00882,中信中國高股息,7,0,7,華南永昌-民權,2023-02-07,9312
1817,凱撒衛,8,1,7,華南永昌-民權,2023-02-07,9312
2834,臺企銀,7,0,7,華南永昌-民權,2023-02-07,9312
4763,材料-KY,8,2,6,華南永昌-民權,2023-02-07,9312
00900,富邦特選高股息30,6,0,6,華南永昌-民權,2023-02-07,9312
00637L,元大滬深300正2,6,0,6,華南永昌-民權,2023-02-07,9312
6531,愛普*,7,2,5,華南永昌-民權,2023-02-07,9312
1536,和大,7,2,5,華南永昌-民權,2023-02-07,9312
1760,寶齡富錦,25,20,5,華南永昌-民權,2023-02-07,9312
2884,玉山金,10,5,5,華南永昌-民權,2023-02-07,9312
1785,光洋科,8,3,5,華南永昌-民權,2023-02-07,9312
00650L,復華香港正2,4,0,4,華南永昌-民權,2023-02-07,9312
1733,五鼎,4,0,4,華南永昌-民權,2023-02-07,9312
2009,第一銅,12,8,4,華南永昌-民權,2023-02-07,9312
2243,宏旭-KY,4,0,4,華南永昌-民權,2023-02-07,9312
2460,建通,4,0,4,華南永昌-民權,2023-02-07,9312
2891,中信金,4,0,4,華南永昌-民權,2023-02-07,9312
3035,智原,5,1,4,華南永昌-民權,2023-02-07,9312
6213,聯茂,4,0,4,華南永昌-民權,2023-02-07,9312
6235,華孚,7,3,4,華南永昌-民權,2023-02-07,9312
6443,元晶,11,7,4,華南永昌-民權,2023-02-07,9312
2317,鴻海,4,1,3,華南永昌-民權,2023-02-07,9312
1218,泰山,3,0,3,華南永昌-民權,2023-02-07,9312
1609,大亞,3,0,3,華南永昌-民權,2023-02-07,9312
2014,中鴻,5,2,3,華南永昌-民權,2023-02-07,9312
2375,凱美,3,0,3,華南永昌-民權,2023-02-07,9312
2633,台灣高鐵,3,0,3,華南永昌-民權,2023-02-07,9312
3406,玉晶光,3,0,3,華南永昌-民權,2023-02-07,9312
4739,康普,4,1,3,華南永昌-民權,2023-02-07,9312
4979,華星光,6,3,3,華南永昌-民權,2023-02-07,9312
5258,虹堡,4,1,3,華南永昌-民權,2023-02-07,9312
4927,泰鼎-KY,140,2,138,華南永昌-民權,2023-02-08,9312
00878,國泰永續高股息,99,3,96,華南永昌-民權,2023-02-08,9312
3715,定穎投控,70,0,70,華南永昌-民權,2023-02-08,9312
1605,華新,74,22,52,華南永昌-民權,2023-02-08,9312
00632R,元大台灣50反1,25,0,25,華南永昌-民權,2023-02-08,9312
1109,信大,22,0,22,華南永昌-民權,2023-02-08,9312
00673R,期元大S＆P原油反1,21,0,21,華南永昌-民權,2023-02-08,9312
6213,聯茂,15,0,15,華南永昌-民權,2023-02-08,9312
00679B,元大美債20年,19,5,14,華南永昌-民權,2023-02-08,9312
2419,仲琦,13,0,13,華南永昌-民權,2023-02-08,9312
2367,燿華,11,0,11,華南永昌-民權,2023-02-08,9312
1611,中電,10,0,10,華南永昌-民權,2023-02-08,9312
1817,凱撒衛,10,0,10,華南永昌-民權,2023-02-08,9312
2888,新光金,13,3,10,華南永昌-民權,2023-02-08,9312
3017,奇鋐,10,1,9,華南永昌-民權,2023-02-08,9312
6546,正基,10,1,9,華南永昌-民權,2023-02-08,9312
3293,鈊象,7,0,7,華南永昌-民權,2023-02-08,9312
2027,大成鋼,10,3,7,華南永昌-民權,2023-02-08,9312
3357,臺慶科,7,0,7,華南永昌-民權,2023-02-08,9312
8936,國統,7,0,7,華南永昌-民權,2023-02-08,9312
2453,凌群,6,0,6,華南永昌-民權,2023-02-08,9312
3710,連展投控,6,0,6,華南永昌-民權,2023-02-08,9312
5234,達興材料,6,0,6,華南永昌-民權,2023-02-08,9312
4128,中天,56,51,5,華南永昌-民權,2023-02-08,9312
1438,三地開發,5,0,5,華南永昌-民權,2023-02-08,9312
1453,大將,7,2,5,華南永昌-民權,2023-02-08,9312
1722,台肥,5,0,5,華南永昌-民權,2023-02-08,9312
1809,中釉,5,0,5,華南永昌-民權,2023-02-08,9312
2472,立隆電,5,0,5,華南永昌-民權,2023-02-08,9312
2615,萬海,6,1,5,華南永昌-民權,2023-02-08,9312
2812,台中銀,5,0,5,華南永昌-民權,2023-02-08,9312
3049,精金,5,0,5,華南永昌-民權,2023-02-08,9312
4168,醣聯,5,0,5,華南永昌-民權,2023-02-08,9312
8033,雷虎,6,1,5,華南永昌-民權,2023-02-08,9312
2886,兆豐金,5,1,4,華南永昌-民權,2023-02-08,9312
1609,大亞,5,1,4,華南永昌-民權,2023-02-08,9312
1514,亞力,4,0,4,華南永昌-民權,2023-02-08,9312
2204,中華,4,0,4,華南永昌-民權,2023-02-08,9312
2354,鴻準,5,1,4,華南永昌-民權,2023-02-08,9312
2405,輔信,4,0,4,華南永昌-民權,2023-02-08,9312
2609,陽明,5,1,4,華南永昌-民權,2023-02-08,9312
2884,玉山金,8,4,4,華南永昌-民權,2023-02-08,9312
2891,中信金,4,0,4,華南永昌-民權,2023-02-08,9312
3041,揚智,10,6,4,華南永昌-民權,2023-02-08,9312
4911,德英,5,1,4,華南永昌-民權,2023-02-08,9312
4931,新盛力,4,0,4,華南永昌-民權,2023-02-08,9312
4763,材料-KY,6,2,4,華南永昌-民權,2023-02-08,9312
00900,富邦特選高股息30,4,0,4,華南永昌-民權,2023-02-08,9312
1101,台泥,3,0,3,華南永昌-民權,2023-02-08,9312
00751B,元大AAA至A公司債,3,0,3,華南永昌-民權,2023-02-08,9312
6282,康舒,220,112,108,華南永昌-民權,2023-02-09,9312
1301,台塑,105,2,103,華南永昌-民權,2023-02-09,9312
2102,泰豐,100,3,97,華南永昌-民權,2023-02-09,9312
00878,國泰永續高股息,65,0,65,華南永昌-民權,2023-02-09,9312
1536,和大,35,0,35,華南永昌-民權,2023-02-09,9312
6138,茂達,45,15,30,華南永昌-民權,2023-02-09,9312
2915,潤泰全,27,1,26,華南永昌-民權,2023-02-09,9312
4927,泰鼎-KY,25,0,25,華南永昌-民權,2023-02-09,9312
1409,新纖,27,3,24,華南永昌-民權,2023-02-09,9312
2303,聯電,33,10,23,華南永昌-民權,2023-02-09,9312
2614,東森,21,0,21,華南永昌-民權,2023-02-09,9312
2101,南港,40,20,20,華南永昌-民權,2023-02-09,9312
3661,世芯-KY,18,0,18,華南永昌-民權,2023-02-09,9312
3357,臺慶科,16,0,16,華南永昌-民權,2023-02-09,9312
3481,群創,20,4,16,華南永昌-民權,2023-02-09,9312
1519,華城,27,12,15,華南永昌-民權,2023-02-09,9312
00632R,元大台灣50反1,15,0,15,華南永昌-民權,2023-02-09,9312
4906,正文,15,0,15,華南永昌-民權,2023-02-09,9312
3128,昇銳,15,1,14,華南永昌-民權,2023-02-09,9312
1795,美時,16,3,13,華南永昌-民權,2023-02-09,9312
6443,元晶,14,2,12,華南永昌-民權,2023-02-09,9312
6182,合晶,15,3,12,華南永昌-民權,2023-02-09,9312
2425,承啟,12,1,11,華南永昌-民權,2023-02-09,9312
5014,建錩,11,0,11,華南永昌-民權,2023-02-09,9312
1603,華電,10,0,10,華南永昌-民權,2023-02-09,9312
00673R,期元大S＆P原油反1,10,0,10,華南永昌-民權,2023-02-09,9312
00701,國泰股利精選30,10,0,10,華南永昌-民權,2023-02-09,9312
2103,台橡,10,0,10,華南永昌-民權,2023-02-09,9312
3617,碩天,10,0,10,華南永昌-民權,2023-02-09,9312
6227,茂綸,10,0,10,華南永昌-民權,2023-02-09,9312
3027,盛達,10,1,9,華南永昌-民權,2023-02-09,9312
1109,信大,8,0,8,華南永昌-民權,2023-02-09,9312
2609,陽明,7,0,7,華南永昌-民權,2023-02-09,9312
2484,希華,7,0,7,華南永昌-民權,2023-02-09,9312
4919,新唐,10,4,6,華南永昌-民權,2023-02-09,9312
00885,富邦越南,6,0,6,華南永昌-民權,2023-02-09,9312
00679B,元大美債20年,6,0,6,華南永昌-民權,2023-02-09,9312
2038,海光,6,0,6,華南永昌-民權,2023-02-09,9312
2498,宏達電,15,9,6,華南永昌-民權,2023-02-09,9312
1609,大亞,10,5,5,華南永昌-民權,2023-02-09,9312
1760,寶齡富錦,37,32,5,華南永昌-民權,2023-02-09,9312
2312,金寶,5,0,5,華南永昌-民權,2023-02-09,9312
2317,鴻海,5,0,5,華南永昌-民權,2023-02-09,9312
3297,杭特,5,0,5,華南永昌-民權,2023-02-09,9312
6411,晶焱,7,2,5,華南永昌-民權,2023-02-09,9312
6589,台康生技,9,4,5,華南永昌-民權,2023-02-09,9312
6129,普誠,4,0,4,華南永昌-民權,2023-02-09,9312
2419,仲琦,8,4,4,華南永昌-民權,2023-02-09,9312
2731,雄獅,4,0,4,華南永昌-民權,2023-02-09,9312
3708,上緯投控,4,0,4,華南永昌-民權,2023-02-09,9312
4927,泰鼎-KY,135,0,135,華南永昌-民權,2023-02-10,9312
2618,長榮航,91,5,86,華南永昌-民權,2023-02-10,9312
2614,東森,60,0,60,華南永昌-民權,2023-02-10,9312
0056,元大高股息,56,3,53,華南永昌-民權,2023-02-10,9312
1513,中興電,58,14,44,華南永昌-民權,2023-02-10,9312
2371,大同,30,0,30,華南永昌-民權,2023-02-10,9312
2610,華航,30,0,30,華南永昌-民權,2023-02-10,9312
2330,台積電,40,16,24,華南永昌-民權,2023-02-10,9312
1536,和大,28,4,24,華南永昌-民權,2023-02-10,9312
8227,巨有科技,25,4,21,華南永昌-民權,2023-02-10,9312
00878,國泰永續高股息,20,1,19,華南永昌-民權,2023-02-10,9312
1584,精剛,19,2,17,華南永昌-民權,2023-02-10,9312
00637L,元大滬深300正2,16,0,16,華南永昌-民權,2023-02-10,9312
00713,元大台灣高息低波,14,0,14,華南永昌-民權,2023-02-10,9312
2453,凌群,18,5,13,華南永昌-民權,2023-02-10,9312
5258,虹堡,13,0,13,華南永昌-民權,2023-02-10,9312
5014,建錩,14,2,12,華南永昌-民權,2023-02-10,9312
5876,上海商銀,15,3,12,華南永昌-民權,2023-02-10,9312
6182,合晶,12,0,12,華南永昌-民權,2023-02-10,9312
6213,聯茂,12,0,12,華南永昌-民權,2023-02-10,9312
00903,富邦元宇宙,10,0,10,華南永昌-民權,2023-02-10,9312
1603,華電,10,0,10,華南永昌-民權,2023-02-10,9312
2023,燁輝,10,0,10,華南永昌-民權,2023-02-10,9312
8404,百和興業-KY,10,0,10,華南永昌-民權,2023-02-10,9312
1605,華新,11,1,10,華南永昌-民權,2023-02-10,9312
2409,友達,9,0,9,華南永昌-民權,2023-02-10,9312
4915,致伸,10,1,9,華南永昌-民權,2023-02-10,9312
6269,台郡,9,0,9,華南永昌-民權,2023-02-10,9312
00885,富邦越南,8,0,8,華南永昌-民權,2023-02-10,9312
1598,岱宇,7,0,7,華南永昌-民權,2023-02-10,9312
3035,智原,8,1,7,華南永昌-民權,2023-02-10,9312
3357,臺慶科,7,0,7,華南永昌-民權,2023-02-10,9312
2468,華經,9,3,6,華南永昌-民權,2023-02-10,9312
2890,永豐金,6,0,6,華南永昌-民權,2023-02-10,9312
6550,北極星藥業-KY,7,1,6,華南永昌-民權,2023-02-10,9312
6770,力積電,6,0,6,華南永昌-民權,2023-02-10,9312
3481,群創,20,14,6,華南永昌-民權,2023-02-10,9312
1437,勤益控,5,0,5,華南永昌-民權,2023-02-10,9312
1312,國喬,5,0,5,華南永昌-民權,2023-02-10,9312
1817,凱撒衛,5,0,5,華南永昌-民權,2023-02-10,9312
2460,建通,6,1,5,華南永昌-民權,2023-02-10,9312
2498,宏達電,11,6,5,華南永昌-民權,2023-02-10,9312
3032,偉訓,5,0,5,華南永昌-民權,2023-02-10,9312
3207,耀勝,9,4,5,華南永昌-民權,2023-02-10,9312
3297,杭特,5,0,5,華南永昌-民權,2023-02-10,9312
4747,強生,5,0,5,華南永昌-民權,2023-02-10,9312
4979,華星光,132,127,5,華南永昌-民權,2023-02-10,9312
6546,正基,6,1,5,華南永昌-民權,2023-02-10,9312
2915,潤泰全,4,0,4,華南永昌-民權,2023-02-10,9312
3037,欣興,4,0,4,華南永昌-民權,2023-02-10,9312
00671R,富邦NASDAQ反1,400,0,400,華南永昌-民權,2023-02-13,9312
2102,泰豐,315,131,184,華南永昌-民權,2023-02-13,9312
2610,華航,58,8,50,華南永昌-民權,2023-02-13,9312
3715,定穎投控,50,1,49,華南永昌-民權,2023-02-13,9312
0056,元大高股息,34,3,31,華南永昌-民權,2023-02-13,9312
6182,合晶,29,0,29,華南永昌-民權,2023-02-13,9312
00878,國泰永續高股息,26,1,25,華南永昌-民權,2023-02-13,9312
2641,正德,24,0,24,華南永昌-民權,2023-02-13,9312
2888,新光金,23,0,23,華南永昌-民權,2023-02-13,9312
2609,陽明,24,2,22,華南永昌-民權,2023-02-13,9312
8033,雷虎,24,3,21,華南永昌-民權,2023-02-13,9312
1711,永光,20,0,20,華南永昌-民權,2023-02-13,9312
5340,建榮,20,0,20,華南永昌-民權,2023-02-13,9312
00648R,元大S＆P500反1,15,0,15,華南永昌-民權,2023-02-13,9312
2607,榮運,15,0,15,華南永昌-民權,2023-02-13,9312
6213,聯茂,15,0,15,華南永昌-民權,2023-02-13,9312
8936,國統,15,0,15,華南永昌-民權,2023-02-13,9312
00720B,元大投資級公司債,14,0,14,華南永昌-民權,2023-02-13,9312
5009,榮剛,15,3,12,華南永昌-民權,2023-02-13,9312
5371,中光電,12,0,12,華南永昌-民權,2023-02-13,9312
2618,長榮航,11,0,11,華南永昌-民權,2023-02-13,9312
1217,愛之味,10,0,10,華南永昌-民權,2023-02-13,9312
4114,健喬,205,196,9,華南永昌-民權,2023-02-13,9312
3494,誠研,10,2,8,華南永昌-民權,2023-02-13,9312
1701,中化,12,4,8,華南永昌-民權,2023-02-13,9312
2204,中華,8,0,8,華南永昌-民權,2023-02-13,9312
00679B,元大美債20年,7,0,7,華南永昌-民權,2023-02-13,9312
3013,晟銘電,9,2,7,華南永昌-民權,2023-02-13,9312
3209,全科,7,0,7,華南永昌-民權,2023-02-13,9312
6609,瀧澤科,7,0,7,華南永昌-民權,2023-02-13,9312
2303,聯電,10,4,6,華南永昌-民權,2023-02-13,9312
00900,富邦特選高股息30,6,0,6,華南永昌-民權,2023-02-13,9312
6142,友勁,6,0,6,華南永昌-民權,2023-02-13,9312
6589,台康生技,12,6,6,華南永昌-民權,2023-02-13,9312
1817,凱撒衛,5,0,5,華南永昌-民權,2023-02-13,9312
2399,映泰,5,0,5,華南永昌-民權,2023-02-13,9312
3357,臺慶科,5,0,5,華南永昌-民權,2023-02-13,9312
6116,彩晶,5,0,5,華南永昌-民權,2023-02-13,9312
8068,全達,5,0,5,華南永昌-民權,2023-02-13,9312
1101,台泥,4,0,4,華南永昌-民權,2023-02-13,9312
3105,穩懋,5,1,4,華南永昌-民權,2023-02-13,9312
1785,光洋科,4,0,4,華南永昌-民權,2023-02-13,9312
1326,台化,4,0,4,華南永昌-民權,2023-02-13,9312
1609,大亞,4,0,4,華南永昌-民權,2023-02-13,9312
2340,台亞,4,0,4,華南永昌-民權,2023-02-13,9312
2460,建通,4,0,4,華南永昌-民權,2023-02-13,9312
3508,位速,4,0,4,華南永昌-民權,2023-02-13,9312
3576,聯合再生,4,0,4,華南永昌-民權,2023-02-13,9312
4113,聯上,4,0,4,華南永昌-民權,2023-02-13,9312
6227,茂綸,4,0,4,華南永昌-民權,2023-02-13,9312
00878,國泰永續高股息,249,5,244,華南永昌-民權,2023-02-14,9312
00671R,富邦NASDAQ反1,90,0,90,華南永昌-民權,2023-02-14,9312
00648R,元大S＆P500反1,65,0,65,華南永昌-民權,2023-02-14,9312
00679B,元大美債20年,45,0,45,華南永昌-民權,2023-02-14,9312
00680L,元大美債20正2,42,0,42,華南永昌-民權,2023-02-14,9312
00632R,元大台灣50反1,38,0,38,華南永昌-民權,2023-02-14,9312
1701,中化,30,3,27,華南永昌-民權,2023-02-14,9312
2453,凌群,47,25,22,華南永昌-民權,2023-02-14,9312
3710,連展投控,30,10,20,華南永昌-民權,2023-02-14,9312
00637L,元大滬深300正2,15,0,15,華南永昌-民權,2023-02-14,9312
2027,大成鋼,15,0,15,華南永昌-民權,2023-02-14,9312
6541,泰福-KY,13,1,12,華南永昌-民權,2023-02-14,9312
6690,安�硌穈T,11,0,11,華南永昌-民權,2023-02-14,9312
00720B,元大投資級公司債,10,0,10,華南永昌-民權,2023-02-14,9312
3704,合勤控,10,0,10,華南永昌-民權,2023-02-14,9312
6269,台郡,12,3,9,華南永昌-民權,2023-02-14,9312
2314,台揚,8,0,8,華南永昌-民權,2023-02-14,9312
2498,宏達電,9,1,8,華南永昌-民權,2023-02-14,9312
4919,新唐,8,0,8,華南永昌-民權,2023-02-14,9312
00900,富邦特選高股息30,7,0,7,華南永昌-民權,2023-02-14,9312
1795,美時,11,4,7,華南永昌-民權,2023-02-14,9312
3027,盛達,10,3,7,華南永昌-民權,2023-02-14,9312
2009,第一銅,16,10,6,華南永昌-民權,2023-02-14,9312
00633L,富邦上証正2,6,0,6,華南永昌-民權,2023-02-14,9312
2204,中華,5,0,5,華南永昌-民權,2023-02-14,9312
4953,緯軟,5,0,5,華南永昌-民權,2023-02-14,9312
8068,全達,5,0,5,華南永昌-民權,2023-02-14,9312
2201,裕隆,5,1,4,華南永昌-民權,2023-02-14,9312
3661,世芯-KY,4,0,4,華南永昌-民權,2023-02-14,9312
1467,南緯,6,2,4,華南永昌-民權,2023-02-14,9312
2486,一詮,7,3,4,華南永昌-民權,2023-02-14,9312
3081,聯亞,5,1,4,華南永昌-民權,2023-02-14,9312
6235,華孚,5,1,4,華南永昌-民權,2023-02-14,9312
6806,森崴能源,4,0,4,華南永昌-民權,2023-02-14,9312
8222,寶一,7,3,4,華南永昌-民權,2023-02-14,9312
2634,漢翔,5,1,4,華南永昌-民權,2023-02-14,9312
5425,台半,4,0,4,華南永昌-民權,2023-02-14,9312
2409,友達,15,11,4,華南永昌-民權,2023-02-14,9312
1109,信大,3,0,3,華南永昌-民權,2023-02-14,9312
1584,精剛,4,1,3,華南永昌-民權,2023-02-14,9312
2883,凱基金,3,0,3,華南永昌-民權,2023-02-14,9312
2885,元大金,3,0,3,華南永昌-民權,2023-02-14,9312
3357,臺慶科,3,0,3,華南永昌-民權,2023-02-14,9312
3583,辛耘,3,0,3,華南永昌-民權,2023-02-14,9312
4979,華星光,4,1,3,華南永昌-民權,2023-02-14,9312
6112,邁達特,6,3,3,華南永昌-民權,2023-02-14,9312
6116,彩晶,6,3,3,華南永昌-民權,2023-02-14,9312
6226,光鼎,3,0,3,華南永昌-民權,2023-02-14,9312
6517,保勝光學,3,0,3,華南永昌-民權,2023-02-14,9312
6643,M31,5,2,3,華南永昌-民權,2023-02-14,9312
00679B,元大美債20年,106,0,106,華南永昌-民權,2023-02-15,9312
2102,泰豐,100,0,100,華南永昌-民權,2023-02-15,9312
00772B,中信高評級公司債,51,0,51,華南永昌-民權,2023-02-15,9312
00878,國泰永續高股息,48,4,44,華南永昌-民權,2023-02-15,9312
4114,健喬,43,2,41,華南永昌-民權,2023-02-15,9312
2884,玉山金,50,10,40,華南永昌-民權,2023-02-15,9312
1701,中化,21,0,21,華南永昌-民權,2023-02-15,9312
6213,聯茂,17,0,17,華南永昌-民權,2023-02-15,9312
2027,大成鋼,20,8,12,華南永昌-民權,2023-02-15,9312
1514,亞力,13,2,11,華南永昌-民權,2023-02-15,9312
1301,台塑,11,0,11,華南永昌-民權,2023-02-15,9312
00918,大華優利高填息30,11,0,11,華南永昌-民權,2023-02-15,9312
3027,盛達,14,3,11,華南永昌-民權,2023-02-15,9312
2409,友達,11,1,10,華南永昌-民權,2023-02-15,9312
00633L,富邦上証正2,11,1,10,華南永昌-民權,2023-02-15,9312
2353,宏��,10,0,10,華南永昌-民權,2023-02-15,9312
5340,建榮,10,0,10,華南永昌-民權,2023-02-15,9312
5347,世界,11,1,10,華南永昌-民權,2023-02-15,9312
6116,彩晶,11,1,10,華南永昌-民權,2023-02-15,9312
6152,百一,10,0,10,華南永昌-民權,2023-02-15,9312
2609,陽明,10,2,8,華南永昌-民權,2023-02-15,9312
00891,中信關鍵半導體,7,0,7,華南永昌-民權,2023-02-15,9312
0056,元大高股息,12,5,7,華南永昌-民權,2023-02-15,9312
2303,聯電,14,7,7,華南永昌-民權,2023-02-15,9312
0050,元大台灣50,6,0,6,華南永昌-民權,2023-02-15,9312
2603,長榮,6,0,6,華南永昌-民權,2023-02-15,9312
3680,家登,6,0,6,華南永昌-民權,2023-02-15,9312
00900,富邦特選高股息30,6,0,6,華南永昌-民權,2023-02-15,9312
00752,中信中國50,6,0,6,華南永昌-民權,2023-02-15,9312
6215,和椿,6,0,6,華南永昌-民權,2023-02-15,9312
3665,貿聯-KY,8,2,6,華南永昌-民權,2023-02-15,9312
1227,佳格,5,0,5,華南永昌-民權,2023-02-15,9312
1101,台泥,6,1,5,華南永昌-民權,2023-02-15,9312
00701,國泰股利精選30,5,0,5,華南永昌-民權,2023-02-15,9312
1611,中電,5,0,5,華南永昌-民權,2023-02-15,9312
2607,榮運,5,0,5,華南永昌-民權,2023-02-15,9312
3209,全科,6,1,5,華南永昌-民權,2023-02-15,9312
3231,緯創,5,0,5,華南永昌-民權,2023-02-15,9312
3357,臺慶科,5,0,5,華南永昌-民權,2023-02-15,9312
5285,界霖,5,0,5,華南永昌-民權,2023-02-15,9312
6752,叡揚,5,0,5,華南永昌-民權,2023-02-15,9312
2364,倫飛,4,0,4,華南永昌-民權,2023-02-15,9312
3221,台嘉碩,7,3,4,華南永昌-民權,2023-02-15,9312
3479,安勤,4,0,4,華南永昌-民權,2023-02-15,9312
5211,蒙恬,4,0,4,華南永昌-民權,2023-02-15,9312
2351,順德,4,1,3,華南永昌-民權,2023-02-15,9312
006208,富邦台50,3,0,3,華南永昌-民權,2023-02-15,9312
2317,鴻海,7,4,3,華南永昌-民權,2023-02-15,9312
2498,宏達電,12,9,3,華南永昌-民權,2023-02-15,9312
3704,合勤控,3,0,3,華南永昌-民權,2023-02-15,9312
4927,泰鼎-KY,110,0,110,華南永昌-民權,2023-02-16,9312
1513,中興電,71,11,60,華南永昌-民權,2023-02-16,9312
00878,國泰永續高股息,37,0,37,華南永昌-民權,2023-02-16,9312
2030,彰源,35,0,35,華南永昌-民權,2023-02-16,9312
9938,百和,30,0,30,華南永昌-民權,2023-02-16,9312
00893,國泰智能電動車,40,10,30,華南永昌-民權,2023-02-16,9312
6213,聯茂,27,1,26,華南永昌-民權,2023-02-16,9312
2884,玉山金,40,16,24,華南永昌-民權,2023-02-16,9312
8927,北基,20,0,20,華南永昌-民權,2023-02-16,9312
2002,中鋼,20,2,18,華南永昌-民權,2023-02-16,9312
1784,訊聯,17,1,16,華南永昌-民權,2023-02-16,9312
00679B,元大美債20年,26,13,13,華南永昌-民權,2023-02-16,9312
1524,耿鼎,13,0,13,華南永昌-民權,2023-02-16,9312
2014,中鴻,13,0,13,華南永昌-民權,2023-02-16,9312
00664R,國泰臺灣加權反1,12,0,12,華南永昌-民權,2023-02-16,9312
1503,士電,12,0,12,華南永昌-民權,2023-02-16,9312
2312,金寶,10,0,10,華南永昌-民權,2023-02-16,9312
5328,華容,12,2,10,華南永昌-民權,2023-02-16,9312
4439,冠星-KY,9,0,9,華南永昌-民權,2023-02-16,9312
1467,南緯,28,20,8,華南永昌-民權,2023-02-16,9312
3037,欣興,9,3,6,華南永昌-民權,2023-02-16,9312
1609,大亞,11,5,6,華南永昌-民權,2023-02-16,9312
2498,宏達電,8,2,6,華南永昌-民權,2023-02-16,9312
8255,朋程,30,25,5,華南永昌-民權,2023-02-16,9312
3380,明泰,5,0,5,華南永昌-民權,2023-02-16,9312
5222,全訊,5,0,5,華南永昌-民權,2023-02-16,9312
6770,力積電,5,0,5,華南永昌-民權,2023-02-16,9312
1611,中電,4,0,4,華南永昌-民權,2023-02-16,9312
00882,中信中國高股息,4,0,4,華南永昌-民權,2023-02-16,9312
00715L,期街口布蘭特正2,4,0,4,華南永昌-民權,2023-02-16,9312
1529,樂事綠能,4,0,4,華南永昌-民權,2023-02-16,9312
2368,金像電,4,0,4,華南永昌-民權,2023-02-16,9312
2406,國碩,4,0,4,華南永昌-民權,2023-02-16,9312
8936,國統,4,0,4,華南永昌-民權,2023-02-16,9312
5880,合庫金,4,1,3,華南永昌-民權,2023-02-16,9312
2497,怡利電,3,0,3,華南永昌-民權,2023-02-16,9312
3189,景碩,6,3,3,華南永昌-民權,2023-02-16,9312
3624,光頡,13,10,3,華南永昌-民權,2023-02-16,9312
3711,日月光投控,3,0,3,華南永昌-民權,2023-02-16,9312
6235,華孚,12,9,3,華南永昌-民權,2023-02-16,9312
8222,寶一,5,2,3,華南永昌-民權,2023-02-16,9312
8234,新漢,4,1,3,華南永昌-民權,2023-02-16,9312
9958,世紀鋼,4,1,3,華南永昌-民權,2023-02-16,9312
8046,南電,2,0,2,華南永昌-民權,2023-02-16,9312
9945,潤泰新,2,0,2,華南永昌-民權,2023-02-16,9312
1301,台塑,2,0,2,華南永昌-民權,2023-02-16,9312
00708L,期元大S＆P黃金正2,2,0,2,華南永昌-民權,2023-02-16,9312
00751B,元大AAA至A公司債,2,0,2,華南永昌-民權,2023-02-16,9312
00720B,元大投資級公司債,2,0,2,華南永昌-民權,2023-02-16,9312
1527,鑽全,2,0,2,華南永昌-民權,2023-02-16,9312
00632R,元大台灣50反1,100,0,100,華南永昌-民權,2023-02-17,9312
6282,康舒,68,3,65,華南永昌-民權,2023-02-17,9312
4549,桓達,62,1,61,華南永昌-民權,2023-02-17,9312
4927,泰鼎-KY,51,0,51,華南永昌-民權,2023-02-17,9312
3163,波若威,38,1,37,華南永昌-民權,2023-02-17,9312
3591,艾笛森,32,1,31,華南永昌-民權,2023-02-17,9312
2535,達欣工,30,0,30,華南永昌-民權,2023-02-17,9312
2618,長榮航,35,10,25,華南永昌-民權,2023-02-17,9312
2610,華航,35,10,25,華南永昌-民權,2023-02-17,9312
2880,華南金,25,5,20,華南永昌-民權,2023-02-17,9312
00772B,中信高評級公司債,18,0,18,華南永昌-民權,2023-02-17,9312
6213,聯茂,15,0,15,華南永昌-民權,2023-02-17,9312
00882,中信中國高股息,14,0,14,華南永昌-民權,2023-02-17,9312
2027,大成鋼,14,0,14,華南永昌-民權,2023-02-17,9312
6138,茂達,15,3,12,華南永昌-民權,2023-02-17,9312
6266,泰詠,11,0,11,華南永昌-民權,2023-02-17,9312
1210,大成,10,0,10,華南永昌-民權,2023-02-17,9312
4102,永日,11,1,10,華南永昌-民權,2023-02-17,9312
4768,晶呈科技,10,0,10,華南永昌-民權,2023-02-17,9312
6142,友勁,10,0,10,華南永昌-民權,2023-02-17,9312
2002,中鋼,21,11,10,華南永昌-民權,2023-02-17,9312
8358,金居,10,1,9,華南永昌-民權,2023-02-17,9312
5203,訊連,8,0,8,華南永昌-民權,2023-02-17,9312
00633L,富邦上証正2,12,4,8,華南永昌-民權,2023-02-17,9312
6187,萬潤,11,3,8,華南永昌-民權,2023-02-17,9312
1609,大亞,11,4,7,華南永昌-民權,2023-02-17,9312
8050,廣積,7,0,7,華南永昌-民權,2023-02-17,9312
00893,國泰智能電動車,6,0,6,華南永昌-民權,2023-02-17,9312
6164,華興,6,0,6,華南永昌-民權,2023-02-17,9312
2317,鴻海,8,3,5,華南永昌-民權,2023-02-17,9312
00877,復華中國5G,5,0,5,華南永昌-民權,2023-02-17,9312
1760,寶齡富錦,6,1,5,華南永昌-民權,2023-02-17,9312
3035,智原,5,0,5,華南永昌-民權,2023-02-17,9312
3607,谷崧,5,0,5,華南永昌-民權,2023-02-17,9312
6226,光鼎,5,0,5,華南永昌-民權,2023-02-17,9312
6796,晉弘,6,1,5,華南永昌-民權,2023-02-17,9312
00680L,元大美債20正2,5,1,4,華南永昌-民權,2023-02-17,9312
3071,協禧,4,0,4,華南永昌-民權,2023-02-17,9312
5351,鈺創,4,0,4,華南永昌-民權,2023-02-17,9312
6265,方土昶,4,0,4,華南永昌-民權,2023-02-17,9312
4919,新唐,3,0,3,華南永昌-民權,2023-02-17,9312
00895,富邦未來車,3,0,3,華南永昌-民權,2023-02-17,9312
00919,群益台灣精選高息,3,0,3,華南永昌-民權,2023-02-17,9312
00637L,元大滬深300正2,8,5,3,華南永昌-民權,2023-02-17,9312
00720B,元大投資級公司債,3,0,3,華南永昌-民權,2023-02-17,9312
1709,和益,3,0,3,華南永昌-民權,2023-02-17,9312
1784,訊聯,3,0,3,華南永昌-民權,2023-02-17,9312
2206,三陽工業,3,0,3,華南永昌-民權,2023-02-17,9312
2885,元大金,3,0,3,華南永昌-民權,2023-02-17,9312
4716,大立,3,0,3,華南永昌-民權,2023-02-17,9312
2834,臺企銀,963,34,929,華南永昌-民權,2023-02-20,9312
4927,泰鼎-KY,341,1,340,華南永昌-民權,2023-02-20,9312
1536,和大,105,0,105,華南永昌-民權,2023-02-20,9312
8046,南電,60,1,59,華南永昌-民權,2023-02-20,9312
2884,玉山金,121,66,55,華南永昌-民權,2023-02-20,9312
1529,樂事綠能,152,105,47,華南永昌-民權,2023-02-20,9312
2329,華泰,44,0,44,華南永昌-民權,2023-02-20,9312
4168,醣聯,35,1,34,華南永昌-民權,2023-02-20,9312
6116,彩晶,36,4,32,華南永昌-民權,2023-02-20,9312
5512,力麒,82,54,28,華南永昌-民權,2023-02-20,9312
1503,士電,31,5,26,華南永昌-民權,2023-02-20,9312
2610,華航,38,13,25,華南永昌-民權,2023-02-20,9312
6835,圓裕,20,0,20,華南永昌-民權,2023-02-20,9312
8033,雷虎,28,9,19,華南永昌-民權,2023-02-20,9312
0056,元大高股息,15,0,15,華南永昌-民權,2023-02-20,9312
2504,國產,15,0,15,華南永昌-民權,2023-02-20,9312
2748,雲品,45,31,14,華南永昌-民權,2023-02-20,9312
00715L,期街口布蘭特正2,13,0,13,華南永昌-民權,2023-02-20,9312
00905,FT臺灣Smart,11,0,11,華南永昌-民權,2023-02-20,9312
2317,鴻海,11,0,11,華南永昌-民權,2023-02-20,9312
00670L,富邦NASDAQ正2,10,0,10,華南永昌-民權,2023-02-20,9312
00772B,中信高評級公司債,10,0,10,華南永昌-民權,2023-02-20,9312
00891,中信關鍵半導體,10,0,10,華南永昌-民權,2023-02-20,9312
4549,桓達,10,0,10,華南永昌-民權,2023-02-20,9312
6205,詮欣,10,0,10,華南永昌-民權,2023-02-20,9312
1795,美時,11,2,9,華南永昌-民權,2023-02-20,9312
4128,中天,9,0,9,華南永昌-民權,2023-02-20,9312
4526,東台,9,0,9,華南永昌-民權,2023-02-20,9312
2457,飛宏,18,10,8,華南永昌-民權,2023-02-20,9312
00902,中信電池及儲能,10,3,7,華南永昌-民權,2023-02-20,9312
1438,三地開發,7,0,7,華南永昌-民權,2023-02-20,9312
4402,郡都開發,7,0,7,華南永昌-民權,2023-02-20,9312
4744,皇將,7,0,7,華南永昌-民權,2023-02-20,9312
6126,信音,7,0,7,華南永昌-民權,2023-02-20,9312
8171,天宇,6,0,6,華南永昌-民權,2023-02-20,9312
1441,大東,6,0,6,華南永昌-民權,2023-02-20,9312
1434,福懋,6,0,6,華南永昌-民權,2023-02-20,9312
2014,中鴻,6,0,6,華南永昌-民權,2023-02-20,9312
2731,雄獅,9,3,6,華南永昌-民權,2023-02-20,9312
2881,富邦金,8,2,6,華南永昌-民權,2023-02-20,9312
4768,晶呈科技,5,0,5,華南永昌-民權,2023-02-20,9312
00751B,元大AAA至A公司債,5,0,5,華南永昌-民權,2023-02-20,9312
1702,南僑,5,0,5,華南永昌-民權,2023-02-20,9312
1760,寶齡富錦,5,0,5,華南永昌-民權,2023-02-20,9312
1785,光洋科,5,0,5,華南永昌-民權,2023-02-20,9312
2705,六福,57,52,5,華南永昌-民權,2023-02-20,9312
3593,力銘,5,0,5,華南永昌-民權,2023-02-20,9312
8215,明基材,6,1,5,華南永昌-民權,2023-02-20,9312
2603,長榮,5,0,5,華南永昌-民權,2023-02-20,9312
5706,鳳凰,4,0,4,華南永昌-民權,2023-02-20,9312
2884,玉山金,1286,187,1099,華南永昌-民權,2023-02-21,9312
2834,臺企銀,389,0,389,華南永昌-民權,2023-02-21,9312
00632R,元大台灣50反1,200,0,200,華南永昌-民權,2023-02-21,9312
4927,泰鼎-KY,142,0,142,華南永昌-民權,2023-02-21,9312
2618,長榮航,113,2,111,華南永昌-民權,2023-02-21,9312
2887,台新金,70,1,69,華南永昌-民權,2023-02-21,9312
1536,和大,50,0,50,華南永昌-民權,2023-02-21,9312
1810,和成,43,1,42,華南永昌-民權,2023-02-21,9312
1605,華新,43,2,41,華南永昌-民權,2023-02-21,9312
2208,台船,37,5,32,華南永昌-民權,2023-02-21,9312
6213,聯茂,30,0,30,華南永昌-民權,2023-02-21,9312
9105,泰金寶-DR,29,0,29,華南永昌-民權,2023-02-21,9312
8936,國統,28,2,26,華南永昌-民權,2023-02-21,9312
4915,致伸,26,1,25,華南永昌-民權,2023-02-21,9312
00725B,國泰投資級公司債,19,0,19,華南永昌-民權,2023-02-21,9312
1108,幸福,21,2,19,華南永昌-民權,2023-02-21,9312
00878,國泰永續高股息,17,0,17,華南永昌-民權,2023-02-21,9312
2038,海光,15,0,15,華南永昌-民權,2023-02-21,9312
6227,茂綸,14,0,14,華南永昌-民權,2023-02-21,9312
1513,中興電,20,7,13,華南永昌-民權,2023-02-21,9312
00772B,中信高評級公司債,11,0,11,華南永昌-民權,2023-02-21,9312
4942,嘉彰,12,1,11,華南永昌-民權,2023-02-21,9312
1324,地球,10,0,10,華南永昌-民權,2023-02-21,9312
1103,嘉泥,11,1,10,華南永昌-民權,2023-02-21,9312
1817,凱撒衛,10,0,10,華南永昌-民權,2023-02-21,9312
3548,兆利,10,0,10,華南永昌-民權,2023-02-21,9312
4768,晶呈科技,10,0,10,華南永昌-民權,2023-02-21,9312
6568,宏觀,9,0,9,華南永昌-民權,2023-02-21,9312
3535,晶彩科,8,0,8,華南永昌-民權,2023-02-21,9312
6126,信音,8,0,8,華南永昌-民權,2023-02-21,9312
6834,天二科技,8,0,8,華南永昌-民權,2023-02-21,9312
2303,聯電,15,7,8,華南永昌-民權,2023-02-21,9312
2481,強茂,7,0,7,華南永昌-民權,2023-02-21,9312
2485,兆赫,7,0,7,華南永昌-民權,2023-02-21,9312
3090,日電貿,7,0,7,華南永昌-民權,2023-02-21,9312
4712,福格創新,7,0,7,華南永昌-民權,2023-02-21,9312
3236,千如,6,0,6,華南永昌-民權,2023-02-21,9312
9958,世紀鋼,7,1,6,華南永昌-民權,2023-02-21,9312
2882,國泰金,7,1,6,華南永昌-民權,2023-02-21,9312
00902,中信電池及儲能,5,0,5,華南永昌-民權,2023-02-21,9312
1527,鑽全,5,0,5,華南永昌-民權,2023-02-21,9312
2352,佳世達,5,0,5,華南永昌-民權,2023-02-21,9312
2393,億光,5,0,5,華南永昌-民權,2023-02-21,9312
3675,德微,12,7,5,華南永昌-民權,2023-02-21,9312
3689,湧德,5,0,5,華南永昌-民權,2023-02-21,9312
4102,永日,11,6,5,華南永昌-民權,2023-02-21,9312
4306,炎洲,5,0,5,華南永昌-民權,2023-02-21,9312
4968,立積,5,0,5,華南永昌-民權,2023-02-21,9312
6245,立端,6,1,5,華南永昌-民權,2023-02-21,9312
8358,金居,8,3,5,華南永昌-民權,2023-02-21,9312
00671R,富邦NASDAQ反1,260,0,260,華南永昌-民權,2023-02-22,9312
4927,泰鼎-KY,223,5,218,華南永昌-民權,2023-02-22,9312
2618,長榮航,103,1,102,華南永昌-民權,2023-02-22,9312
2884,玉山金,120,36,84,華南永昌-民權,2023-02-22,9312
8069,元太,66,0,66,華南永昌-民權,2023-02-22,9312
6234,高僑,50,0,50,華南永昌-民權,2023-02-22,9312
2049,上銀,40,0,40,華南永昌-民權,2023-02-22,9312
00878,國泰永續高股息,36,0,36,華南永昌-民權,2023-02-22,9312
2610,華航,35,2,33,華南永昌-民權,2023-02-22,9312
2471,資通,113,81,32,華南永昌-民權,2023-02-22,9312
3035,智原,37,6,31,華南永昌-民權,2023-02-22,9312
3710,連展投控,30,0,30,華南永昌-民權,2023-02-22,9312
4433,興采,30,0,30,華南永昌-民權,2023-02-22,9312
2303,聯電,32,3,29,華南永昌-民權,2023-02-22,9312
6282,康舒,59,35,24,華南永昌-民權,2023-02-22,9312
00751B,元大AAA至A公司債,21,0,21,華南永昌-民權,2023-02-22,9312
00902,中信電池及儲能,16,0,16,華南永昌-民權,2023-02-22,9312
4768,晶呈科技,21,6,15,華南永昌-民權,2023-02-22,9312
00885,富邦越南,13,1,12,華南永昌-民權,2023-02-22,9312
2388,威盛,14,3,11,華南永昌-民權,2023-02-22,9312
1423,利華,10,0,10,華南永昌-民權,2023-02-22,9312
1609,大亞,11,1,10,華南永昌-民權,2023-02-22,9312
1795,美時,16,6,10,華南永昌-民權,2023-02-22,9312
2022,聚亨,10,0,10,華南永昌-民權,2023-02-22,9312
2353,宏��,10,0,10,華南永昌-民權,2023-02-22,9312
1506,正道,10,0,10,華南永昌-民權,2023-02-22,9312
1584,精剛,18,9,9,華南永昌-民權,2023-02-22,9312
4960,誠美材,10,1,9,華南永昌-民權,2023-02-22,9312
5351,鈺創,9,0,9,華南永昌-民權,2023-02-22,9312
2617,台航,8,0,8,華南永昌-民權,2023-02-22,9312
4979,華星光,8,0,8,華南永昌-民權,2023-02-22,9312
6116,彩晶,8,0,8,華南永昌-民權,2023-02-22,9312
8478,東哥遊艇,11,3,8,華南永昌-民權,2023-02-22,9312
1519,華城,28,21,7,華南永昌-民權,2023-02-22,9312
6556,勝品,8,1,7,華南永昌-民權,2023-02-22,9312
3037,欣興,11,4,7,華南永昌-民權,2023-02-22,9312
0050,元大台灣50,6,0,6,華南永昌-民權,2023-02-22,9312
1783,和康生,7,1,6,華南永昌-民權,2023-02-22,9312
2206,三陽工業,10,4,6,華南永昌-民權,2023-02-22,9312
3689,湧德,6,0,6,華南永昌-民權,2023-02-22,9312
5272,笙科,6,0,6,華南永昌-民權,2023-02-22,9312
1784,訊聯,5,0,5,華南永昌-民權,2023-02-22,9312
1809,中釉,5,0,5,華南永昌-民權,2023-02-22,9312
2328,廣宇,5,0,5,華南永昌-民權,2023-02-22,9312
3083,網龍,5,0,5,華南永昌-民權,2023-02-22,9312
3209,全科,5,0,5,華南永昌-民權,2023-02-22,9312
3704,合勤控,5,0,5,華南永昌-民權,2023-02-22,9312
4526,東台,11,6,5,華南永昌-民權,2023-02-22,9312
4919,新唐,7,2,5,華南永昌-民權,2023-02-22,9312
6109,亞元,5,0,5,華南永昌-民權,2023-02-22,9312
2102,泰豐,200,0,200,華南永昌-民權,2023-02-23,9312
00632R,元大台灣50反1,101,0,101,華南永昌-民權,2023-02-23,9312
6282,康舒,64,6,58,華南永昌-民權,2023-02-23,9312
8936,國統,55,5,50,華南永昌-民權,2023-02-23,9312
00885,富邦越南,47,0,47,華南永昌-民權,2023-02-23,9312
6140,訊達,45,0,45,華南永昌-民權,2023-02-23,9312
00679B,元大美債20年,41,3,38,華南永昌-民權,2023-02-23,9312
2867,三商壽,30,0,30,華南永昌-民權,2023-02-23,9312
2317,鴻海,39,12,27,華南永昌-民權,2023-02-23,9312
2884,玉山金,42,18,24,華南永昌-民權,2023-02-23,9312
00902,中信電池及儲能,23,0,23,華南永昌-民權,2023-02-23,9312
00664R,國泰臺灣加權反1,20,0,20,華南永昌-民權,2023-02-23,9312
1560,中砂,20,0,20,華南永昌-民權,2023-02-23,9312
5512,力麒,25,6,19,華南永昌-民權,2023-02-23,9312
00720B,元大投資級公司債,17,0,17,華南永昌-民權,2023-02-23,9312
1444,力麗,71,56,15,華南永昌-民權,2023-02-23,9312
4989,榮科,15,0,15,華南永昌-民權,2023-02-23,9312
00715L,期街口布蘭特正2,13,0,13,華南永昌-民權,2023-02-23,9312
6248,沛波,30,17,13,華南永昌-民權,2023-02-23,9312
1514,亞力,15,3,12,華南永昌-民權,2023-02-23,9312
4114,健喬,12,1,11,華南永昌-民權,2023-02-23,9312
2409,友達,18,8,10,華南永昌-民權,2023-02-23,9312
00903,富邦元宇宙,10,0,10,華南永昌-民權,2023-02-23,9312
1220,台榮,10,0,10,華南永昌-民權,2023-02-23,9312
00637L,元大滬深300正2,18,8,10,華南永昌-民權,2023-02-23,9312
2390,云辰,10,0,10,華南永昌-民權,2023-02-23,9312
2482,連宇,10,0,10,華南永昌-民權,2023-02-23,9312
2889,國票金,10,0,10,華南永昌-民權,2023-02-23,9312
4979,華星光,29,19,10,華南永昌-民權,2023-02-23,9312
4960,誠美材,14,5,9,華南永昌-民權,2023-02-23,9312
6235,華孚,13,5,8,華南永昌-民權,2023-02-23,9312
3481,群創,11,4,7,華南永昌-民權,2023-02-23,9312
2610,華航,10,3,7,華南永昌-民權,2023-02-23,9312
00633L,富邦上証正2,12,6,6,華南永昌-民權,2023-02-23,9312
2457,飛宏,16,10,6,華南永昌-民權,2023-02-23,9312
4536,拓凱,7,1,6,華南永昌-民權,2023-02-23,9312
6269,台郡,6,0,6,華南永昌-民權,2023-02-23,9312
2883,凱基金,6,1,5,華南永昌-民權,2023-02-23,9312
2023,燁輝,5,0,5,華南永昌-民權,2023-02-23,9312
2208,台船,19,14,5,華南永昌-民權,2023-02-23,9312
2313,華通,6,1,5,華南永昌-民權,2023-02-23,9312
2617,台航,5,0,5,華南永昌-民權,2023-02-23,9312
2641,正德,12,7,5,華南永昌-民權,2023-02-23,9312
2705,六福,5,0,5,華南永昌-民權,2023-02-23,9312
5905,南仁湖,55,50,5,華南永昌-民權,2023-02-23,9312
6508,惠光,5,0,5,華南永昌-民權,2023-02-23,9312
5880,合庫金,5,0,5,華南永昌-民權,2023-02-23,9312
1524,耿鼎,5,0,5,華南永昌-民權,2023-02-23,9312
1438,三地開發,4,0,4,華南永昌-民權,2023-02-23,9312
1810,和成,9,5,4,華南永昌-民權,2023-02-23,9312
2317,鴻海,142,0,142,華南永昌-民權,2023-02-24,9312
00772B,中信高評級公司債,101,0,101,華南永昌-民權,2023-02-24,9312
2618,長榮航,91,0,91,華南永昌-民權,2023-02-24,9312
4942,嘉彰,74,0,74,華南永昌-民權,2023-02-24,9312
1514,亞力,55,6,49,華南永昌-民權,2023-02-24,9312
8069,元太,43,3,40,華南永昌-民權,2023-02-24,9312
2915,潤泰全,32,0,32,華南永昌-民權,2023-02-24,9312
00878,國泰永續高股息,28,2,26,華南永昌-民權,2023-02-24,9312
5512,力麒,41,17,24,華南永昌-民權,2023-02-24,9312
2641,正德,113,89,24,華南永昌-民權,2023-02-24,9312
00885,富邦越南,22,0,22,華南永昌-民權,2023-02-24,9312
00632R,元大台灣50反1,25,4,21,華南永昌-民權,2023-02-24,9312
2888,新光金,22,2,20,華南永昌-民權,2023-02-24,9312
00725B,國泰投資級公司債,20,0,20,華南永昌-民權,2023-02-24,9312
6174,安��,20,0,20,華南永昌-民權,2023-02-24,9312
1809,中釉,15,0,15,華南永昌-民權,2023-02-24,9312
8289,泰藝,15,0,15,華南永昌-民權,2023-02-24,9312
6109,亞元,14,0,14,華南永昌-民權,2023-02-24,9312
8936,國統,17,3,14,華南永昌-民權,2023-02-24,9312
2388,威盛,118,104,14,華南永昌-民權,2023-02-24,9312
4927,泰鼎-KY,16,3,13,華南永昌-民權,2023-02-24,9312
4960,誠美材,13,1,12,華南永昌-民權,2023-02-24,9312
2601,益航,28,17,11,華南永昌-民權,2023-02-24,9312
1319,東陽,10,0,10,華南永昌-民權,2023-02-24,9312
00633L,富邦上証正2,10,0,10,華南永昌-民權,2023-02-24,9312
3625,西勝,10,0,10,華南永昌-民權,2023-02-24,9312
3037,欣興,15,6,9,華南永昌-民權,2023-02-24,9312
00637L,元大滬深300正2,9,0,9,華南永昌-民權,2023-02-24,9312
00882,中信中國高股息,9,0,9,華南永昌-民權,2023-02-24,9312
2607,榮運,10,1,9,華南永昌-民權,2023-02-24,9312
6147,頎邦,10,1,9,華南永昌-民權,2023-02-24,9312
2836,高雄銀,12,3,9,華南永昌-民權,2023-02-24,9312
8033,雷虎,9,1,8,華南永昌-民權,2023-02-24,9312
6589,台康生技,9,1,8,華南永昌-民權,2023-02-24,9312
2367,燿華,7,0,7,華南永昌-民權,2023-02-24,9312
1108,幸福,6,0,6,華南永昌-民權,2023-02-24,9312
1760,寶齡富錦,6,0,6,華南永昌-民權,2023-02-24,9312
2634,漢翔,7,1,6,華南永昌-民權,2023-02-24,9312
2748,雲品,6,0,6,華南永昌-民權,2023-02-24,9312
8046,南電,6,0,6,華南永昌-民權,2023-02-24,9312
00679B,元大美債20年,15,10,5,華南永昌-民權,2023-02-24,9312
00752,中信中國50,5,0,5,華南永昌-民權,2023-02-24,9312
1795,美時,5,0,5,華南永昌-民權,2023-02-24,9312
2353,宏��,5,0,5,華南永昌-民權,2023-02-24,9312
2460,建通,7,2,5,華南永昌-民權,2023-02-24,9312
3162,精確,5,0,5,華南永昌-民權,2023-02-24,9312
3306,鼎天,5,0,5,華南永昌-民權,2023-02-24,9312
8028,昇陽半導體,5,0,5,華南永昌-民權,2023-02-24,9312
8068,全達,8,3,5,華南永昌-民權,2023-02-24,9312
8478,東哥遊艇,9,4,5,華南永昌-民權,2023-02-24,9312
2834,臺企銀,711,10,701,華南永昌-民權,2023-03-01,9312
4927,泰鼎-KY,430,20,410,華南永昌-民權,2023-03-01,9312
1609,大亞,132,1,131,華南永昌-民權,2023-03-01,9312
00878,國泰永續高股息,52,10,42,華南永昌-民權,2023-03-01,9312
2408,南亞科,33,0,33,華南永昌-民權,2023-03-01,9312
2618,長榮航,32,0,32,華南永昌-民權,2023-03-01,9312
3029,零壹,32,0,32,華南永昌-民權,2023-03-01,9312
1605,華新,40,10,30,華南永昌-民權,2023-03-01,9312
3058,立德,27,0,27,華南永昌-民權,2023-03-01,9312
6669,緯穎,24,0,24,華南永昌-民權,2023-03-01,9312
2614,東森,20,0,20,華南永昌-民權,2023-03-01,9312
3413,京鼎,21,1,20,華南永昌-民權,2023-03-01,9312
8033,雷虎,22,3,19,華南永昌-民權,2023-03-01,9312
2884,玉山金,23,5,18,華南永昌-民權,2023-03-01,9312
2606,裕民,18,1,17,華南永昌-民權,2023-03-01,9312
2892,第一金,15,2,13,華南永昌-民權,2023-03-01,9312
1514,亞力,13,0,13,華南永昌-民權,2023-03-01,9312
3059,華晶科,12,0,12,華南永昌-民權,2023-03-01,9312
3617,碩天,12,0,12,華南永昌-民權,2023-03-01,9312
2027,大成鋼,12,0,12,華南永昌-民權,2023-03-01,9312
2605,新興,16,5,11,華南永昌-民權,2023-03-01,9312
1210,大成,53,42,11,華南永昌-民權,2023-03-01,9312
1342,八貫,10,0,10,華南永昌-民權,2023-03-01,9312
00773B,中信優先金融債,10,0,10,華南永昌-民權,2023-03-01,9312
6139,亞翔,11,1,10,華南永昌-民權,2023-03-01,9312
2002,中鋼,30,21,9,華南永昌-民權,2023-03-01,9312
1584,精剛,10,1,9,華南永昌-民權,2023-03-01,9312
2641,正德,62,53,9,華南永昌-民權,2023-03-01,9312
2204,中華,8,0,8,華南永昌-民權,2023-03-01,9312
2421,建準,8,0,8,華南永昌-民權,2023-03-01,9312
2610,華航,11,3,8,華南永昌-民權,2023-03-01,9312
6269,台郡,8,0,8,華南永昌-民權,2023-03-01,9312
8069,元太,9,2,7,華南永昌-民權,2023-03-01,9312
2014,中鴻,9,2,7,華南永昌-民權,2023-03-01,9312
2883,凱基金,7,0,7,華南永昌-民權,2023-03-01,9312
3380,明泰,10,3,7,華南永昌-民權,2023-03-01,9312
6182,合晶,10,3,7,華南永昌-民權,2023-03-01,9312
8227,巨有科技,8,1,7,華南永昌-民權,2023-03-01,9312
2388,威盛,30,23,7,華南永昌-民權,2023-03-01,9312
2637,慧洋-KY,10,3,7,華南永昌-民權,2023-03-01,9312
3545,敦泰,9,2,7,華南永昌-民權,2023-03-01,9312
2344,華邦電,8,2,6,華南永昌-民權,2023-03-01,9312
3481,群創,8,2,6,華南永昌-民權,2023-03-01,9312
8367,建新國際,28,22,6,華南永昌-民權,2023-03-01,9312
8936,國統,14,8,6,華南永昌-民權,2023-03-01,9312
0056,元大高股息,6,0,6,華南永昌-民權,2023-03-01,9312
2882,國泰金,5,0,5,華南永昌-民權,2023-03-01,9312
1795,美時,5,0,5,華南永昌-民權,2023-03-01,9312
2460,建通,6,1,5,華南永昌-民權,2023-03-01,9312
2867,三商壽,5,0,5,華南永昌-民權,2023-03-01,9312
2834,臺企銀,406,0,406,華南永昌-民權,2023-03-02,9312
2615,萬海,100,1,99,華南永昌-民權,2023-03-02,9312
3481,群創,71,17,54,華南永昌-民權,2023-03-02,9312
2891,中信金,41,0,41,華南永昌-民權,2023-03-02,9312
00878,國泰永續高股息,31,2,29,華南永昌-民權,2023-03-02,9312
1220,台榮,27,0,27,華南永昌-民權,2023-03-02,9312
6182,合晶,26,0,26,華南永昌-民權,2023-03-02,9312
6125,廣運,25,0,25,華南永昌-民權,2023-03-02,9312
1605,華新,53,30,23,華南永昌-民權,2023-03-02,9312
3545,敦泰,20,1,19,華南永昌-民權,2023-03-02,9312
8033,雷虎,22,4,18,華南永昌-民權,2023-03-02,9312
2014,中鴻,15,1,14,華南永昌-民權,2023-03-02,9312
1467,南緯,15,3,12,華南永昌-民權,2023-03-02,9312
2884,玉山金,14,3,11,華南永昌-民權,2023-03-02,9312
2892,第一金,11,0,11,華南永昌-民權,2023-03-02,9312
2641,正德,14,3,11,華南永昌-民權,2023-03-02,9312
1513,中興電,17,7,10,華南永昌-民權,2023-03-02,9312
00673R,期元大S＆P原油反1,10,0,10,華南永昌-民權,2023-03-02,9312
1702,南僑,10,0,10,華南永昌-民權,2023-03-02,9312
1752,南光,12,2,10,華南永昌-民權,2023-03-02,9312
2442,新美齊,10,0,10,華南永昌-民權,2023-03-02,9312
4927,泰鼎-KY,20,10,10,華南永昌-民權,2023-03-02,9312
5009,榮剛,10,0,10,華南永昌-民權,2023-03-02,9312
5328,華容,10,0,10,華南永昌-民權,2023-03-02,9312
2303,聯電,10,1,9,華南永昌-民權,2023-03-02,9312
2883,凱基金,9,0,9,華南永昌-民權,2023-03-02,9312
5512,力麒,11,2,9,華南永昌-民權,2023-03-02,9312
6266,泰詠,8,0,8,華南永昌-民權,2023-03-02,9312
2201,裕隆,13,6,7,華南永昌-民權,2023-03-02,9312
2457,飛宏,11,4,7,華南永昌-民權,2023-03-02,9312
2230,泰茂,10,3,7,華南永昌-民權,2023-03-02,9312
2612,中航,7,0,7,華南永昌-民權,2023-03-02,9312
6274,台燿,7,0,7,華南永昌-民權,2023-03-02,9312
2359,所羅門,6,0,6,華南永昌-民權,2023-03-02,9312
3706,神達,6,0,6,華南永昌-民權,2023-03-02,9312
8088,品安,26,20,6,華南永昌-民權,2023-03-02,9312
3665,貿聯-KY,7,1,6,華南永昌-民權,2023-03-02,9312
1519,華城,6,1,5,華南永昌-民權,2023-03-02,9312
2363,矽統,5,0,5,華南永昌-民權,2023-03-02,9312
2701,萬企,5,0,5,華南永昌-民權,2023-03-02,9312
2890,永豐金,5,0,5,華南永昌-民權,2023-03-02,9312
3052,夆典,5,0,5,華南永昌-民權,2023-03-02,9312
3413,京鼎,5,0,5,華南永昌-民權,2023-03-02,9312
3419,譁裕,7,2,5,華南永昌-民權,2023-03-02,9312
5426,振發,5,0,5,華南永昌-民權,2023-03-02,9312
5464,霖宏,5,0,5,華南永昌-民權,2023-03-02,9312
6142,友勁,7,2,5,華南永昌-民權,2023-03-02,9312
6288,聯嘉,5,0,5,華南永昌-民權,2023-03-02,9312
1584,精剛,5,1,4,華南永昌-民權,2023-03-02,9312
00637L,元大滬深300正2,6,2,4,華南永昌-民權,2023-03-02,9312
2834,臺企銀,687,50,637,華南永昌-民權,2023-03-03,9312
00671R,富邦NASDAQ反1,120,0,120,華南永昌-民權,2023-03-03,9312
00878,國泰永續高股息,74,2,72,華南永昌-民權,2023-03-03,9312
2915,潤泰全,59,4,55,華南永昌-民權,2023-03-03,9312
2637,慧洋-KY,49,4,45,華南永昌-民權,2023-03-03,9312
4927,泰鼎-KY,40,0,40,華南永昌-民權,2023-03-03,9312
4763,材料-KY,53,18,35,華南永昌-民權,2023-03-03,9312
8215,明基材,30,2,28,華南永昌-民權,2023-03-03,9312
1605,華新,27,2,25,華南永昌-民權,2023-03-03,9312
00632R,元大台灣50反1,23,0,23,華南永昌-民權,2023-03-03,9312
6470,宇智,20,0,20,華南永昌-民權,2023-03-03,9312
2498,宏達電,20,1,19,華南永昌-民權,2023-03-03,9312
2891,中信金,19,0,19,華南永昌-民權,2023-03-03,9312
2388,威盛,29,15,14,華南永昌-民權,2023-03-03,9312
2002,中鋼,13,1,12,華南永昌-民權,2023-03-03,9312
1519,華城,14,2,12,華南永昌-民權,2023-03-03,9312
2419,仲琦,12,0,12,華南永昌-民權,2023-03-03,9312
5608,四維航,23,11,12,華南永昌-民權,2023-03-03,9312
1584,精剛,11,0,11,華南永昌-民權,2023-03-03,9312
1219,福壽,13,3,10,華南永昌-民權,2023-03-03,9312
2441,超豐,10,0,10,華南永昌-民權,2023-03-03,9312
2701,萬企,10,0,10,華南永昌-民權,2023-03-03,9312
3625,西勝,10,0,10,華南永昌-民權,2023-03-03,9312
4960,誠美材,11,1,10,華南永昌-民權,2023-03-03,9312
6248,沛波,15,5,10,華南永昌-民權,2023-03-03,9312
5512,力麒,13,4,9,華南永昌-民權,2023-03-03,9312
2892,第一金,8,0,8,華南永昌-民權,2023-03-03,9312
2618,長榮航,8,0,8,華南永昌-民權,2023-03-03,9312
2460,建通,7,0,7,華南永昌-民權,2023-03-03,9312
6576,逸達,7,0,7,華南永昌-民權,2023-03-03,9312
8924,大田,8,1,7,華南永昌-民權,2023-03-03,9312
2884,玉山金,12,6,6,華南永昌-民權,2023-03-03,9312
8050,廣積,6,0,6,華南永昌-民權,2023-03-03,9312
4916,事欣科,7,1,6,華南永昌-民權,2023-03-03,9312
2201,裕隆,6,1,5,華南永昌-民權,2023-03-03,9312
1218,泰山,5,0,5,華南永昌-民權,2023-03-03,9312
00885,富邦越南,5,0,5,華南永昌-民權,2023-03-03,9312
1702,南僑,5,0,5,華南永昌-民權,2023-03-03,9312
1795,美時,5,0,5,華南永昌-民權,2023-03-03,9312
3710,連展投控,5,0,5,華南永昌-民權,2023-03-03,9312
4961,天鈺,6,1,5,華南永昌-民權,2023-03-03,9312
6235,華孚,8,3,5,華南永昌-民權,2023-03-03,9312
6288,聯嘉,5,0,5,華南永昌-民權,2023-03-03,9312
6411,晶焱,5,0,5,華南永昌-民權,2023-03-03,9312
8227,巨有科技,35,30,5,華南永昌-民權,2023-03-03,9312
2880,華南金,4,0,4,華南永昌-民權,2023-03-03,9312
1609,大亞,4,0,4,華南永昌-民權,2023-03-03,9312
3706,神達,4,0,4,華南永昌-民權,2023-03-03,9312
4915,致伸,6,2,4,華南永昌-民權,2023-03-03,9312
6118,建達,4,0,4,華南永昌-民權,2023-03-03,9312
00878,國泰永續高股息,206,7,199,華南永昌-民權,2023-03-06,9312
2890,永豐金,80,1,79,華南永昌-民權,2023-03-06,9312
1536,和大,50,0,50,華南永昌-民權,2023-03-06,9312
2801,彰銀,30,0,30,華南永昌-民權,2023-03-06,9312
2915,潤泰全,20,1,19,華南永昌-民權,2023-03-06,9312
4763,材料-KY,22,3,19,華南永昌-民權,2023-03-06,9312
00673R,期元大S＆P原油反1,12,0,12,華南永昌-民權,2023-03-06,9312
1220,台榮,11,0,11,華南永昌-民權,2023-03-06,9312
2208,台船,11,0,11,華南永昌-民權,2023-03-06,9312
1524,耿鼎,10,0,10,華南永昌-民權,2023-03-06,9312
2605,新興,10,0,10,華南永昌-民權,2023-03-06,9312
2867,三商壽,10,0,10,華南永昌-民權,2023-03-06,9312
3321,同泰,10,0,10,華南永昌-民權,2023-03-06,9312
6227,茂綸,10,0,10,華南永昌-民權,2023-03-06,9312
3454,晶睿,26,16,10,華南永昌-民權,2023-03-06,9312
2444,兆勁,10,1,9,華南永昌-民權,2023-03-06,9312
6116,彩晶,12,4,8,華南永昌-民權,2023-03-06,9312
2891,中信金,7,0,7,華南永昌-民權,2023-03-06,9312
3081,聯亞,7,0,7,華南永昌-民權,2023-03-06,9312
00882,中信中國高股息,6,0,6,華南永昌-民權,2023-03-06,9312
2367,燿華,6,0,6,華南永昌-民權,2023-03-06,9312
3049,精金,6,0,6,華南永昌-民權,2023-03-06,9312
3289,宜特,6,0,6,華南永昌-民權,2023-03-06,9312
5484,慧友,6,0,6,華南永昌-民權,2023-03-06,9312
5512,力麒,6,0,6,華南永昌-民權,2023-03-06,9312
00633L,富邦上証正2,5,0,5,華南永昌-民權,2023-03-06,9312
1441,大東,5,0,5,華南永昌-民權,2023-03-06,9312
1720,生達,5,0,5,華南永昌-民權,2023-03-06,9312
2313,華通,5,0,5,華南永昌-民權,2023-03-06,9312
3231,緯創,5,0,5,華南永昌-民權,2023-03-06,9312
5014,建錩,5,0,5,華南永昌-民權,2023-03-06,9312
8942,森鉅,5,0,5,華南永昌-民權,2023-03-06,9312
5608,四維航,5,0,5,華南永昌-民權,2023-03-06,9312
3027,盛達,7,2,5,華南永昌-民權,2023-03-06,9312
00715L,期街口布蘭特正2,4,0,4,華南永昌-民權,2023-03-06,9312
2481,強茂,7,3,4,華南永昌-民權,2023-03-06,9312
6470,宇智,4,0,4,華南永昌-民權,2023-03-06,9312
1434,福懋,5,1,4,華南永昌-民權,2023-03-06,9312
4915,致伸,9,6,3,華南永昌-民權,2023-03-06,9312
006208,富邦台50,3,0,3,華南永昌-民權,2023-03-06,9312
00637L,元大滬深300正2,5,2,3,華南永昌-民權,2023-03-06,9312
2344,華邦電,5,2,3,華南永昌-民權,2023-03-06,9312
2402,毅嘉,4,1,3,華南永昌-民權,2023-03-06,9312
3380,明泰,3,0,3,華南永昌-民權,2023-03-06,9312
3630,新鉅科,4,1,3,華南永昌-民權,2023-03-06,9312
4939,亞電,3,0,3,華南永昌-民權,2023-03-06,9312
6155,鈞寶,3,0,3,華南永昌-民權,2023-03-06,9312
6568,宏觀,3,0,3,華南永昌-民權,2023-03-06,9312
8112,至上,3,0,3,華南永昌-民權,2023-03-06,9312
2484,希華,3,0,3,華南永昌-民權,2023-03-06,9312
00632R,元大台灣50反1,712,0,712,華南永昌-民權,2023-03-07,9312
2834,臺企銀,200,0,200,華南永昌-民權,2023-03-07,9312
00878,國泰永續高股息,102,2,100,華南永昌-民權,2023-03-07,9312
6282,康舒,87,9,78,華南永昌-民權,2023-03-07,9312
00633L,富邦上証正2,56,3,53,華南永昌-民權,2023-03-07,9312
2030,彰源,50,0,50,華南永昌-民權,2023-03-07,9312
00715L,期街口布蘭特正2,40,6,34,華南永昌-民權,2023-03-07,9312
2867,三商壽,40,10,30,華南永昌-民權,2023-03-07,9312
1605,華新,69,43,26,華南永昌-民權,2023-03-07,9312
00648R,元大S＆P500反1,20,0,20,華南永昌-民權,2023-03-07,9312
4114,健喬,18,0,18,華南永昌-民權,2023-03-07,9312
2457,飛宏,30,12,18,華南永昌-民權,2023-03-07,9312
6234,高僑,17,0,17,華南永昌-民權,2023-03-07,9312
3536,誠創,16,0,16,華南永昌-民權,2023-03-07,9312
2486,一詮,16,1,15,華南永昌-民權,2023-03-07,9312
2344,華邦電,17,5,12,華南永昌-民權,2023-03-07,9312
6770,力積電,13,2,11,華南永昌-民權,2023-03-07,9312
0056,元大高股息,16,6,10,華南永昌-民權,2023-03-07,9312
2497,怡利電,10,0,10,華南永昌-民權,2023-03-07,9312
2614,東森,10,0,10,華南永昌-民權,2023-03-07,9312
2380,虹光,10,0,10,華南永昌-民權,2023-03-07,9312
1795,美時,20,10,10,華南永昌-民權,2023-03-07,9312
2641,正德,12,2,10,華南永昌-民權,2023-03-07,9312
5302,太欣,10,0,10,華南永昌-民權,2023-03-07,9312
6834,天二科技,10,0,10,華南永昌-民權,2023-03-07,9312
1760,寶齡富錦,11,1,10,華南永昌-民權,2023-03-07,9312
2609,陽明,14,4,10,華南永昌-民權,2023-03-07,9312
1519,華城,23,14,9,華南永昌-民權,2023-03-07,9312
1608,華榮,11,2,9,華南永昌-民權,2023-03-07,9312
5425,台半,24,15,9,華南永昌-民權,2023-03-07,9312
1220,台榮,8,0,8,華南永昌-民權,2023-03-07,9312
2881,富邦金,10,2,8,華南永昌-民權,2023-03-07,9312
5258,虹堡,8,0,8,華南永昌-民權,2023-03-07,9312
2884,玉山金,12,4,8,華南永昌-民權,2023-03-07,9312
3049,精金,7,0,7,華南永昌-民權,2023-03-07,9312
3083,網龍,7,0,7,華南永昌-民權,2023-03-07,9312
3376,新日興,7,0,7,華南永昌-民權,2023-03-07,9312
8936,國統,10,3,7,華南永昌-民權,2023-03-07,9312
1101,台泥,7,0,7,華南永昌-民權,2023-03-07,9312
1609,大亞,35,28,7,華南永昌-民權,2023-03-07,9312
3704,合勤控,6,0,6,華南永昌-民權,2023-03-07,9312
2354,鴻準,8,2,6,華南永昌-民權,2023-03-07,9312
2618,長榮航,6,0,6,華南永昌-民權,2023-03-07,9312
4942,嘉彰,6,0,6,華南永昌-民權,2023-03-07,9312
3680,家登,5,0,5,華南永昌-民權,2023-03-07,9312
1325,恆大,5,0,5,華南永昌-民權,2023-03-07,9312
2363,矽統,5,0,5,華南永昌-民權,2023-03-07,9312
2492,華新科,5,0,5,華南永昌-民權,2023-03-07,9312
2838,聯邦銀,5,0,5,華南永昌-民權,2023-03-07,9312
2845,遠東銀,5,0,5,華南永昌-民權,2023-03-07,9312
00671R,富邦NASDAQ反1,90,0,90,華南永昌-民權,2023-03-08,9312
4942,嘉彰,65,0,65,華南永昌-民權,2023-03-08,9312
2498,宏達電,44,3,41,華南永昌-民權,2023-03-08,9312
3264,欣銓,33,0,33,華南永昌-民權,2023-03-08,9312
1799,易威,26,0,26,華南永昌-民權,2023-03-08,9312
4763,材料-KY,39,14,25,華南永昌-民權,2023-03-08,9312
1504,東元,24,0,24,華南永昌-民權,2023-03-08,9312
2482,連宇,21,0,21,華南永昌-民權,2023-03-08,9312
2535,達欣工,21,0,21,華南永昌-民權,2023-03-08,9312
3661,世芯-KY,21,2,19,華南永昌-民權,2023-03-08,9312
2882,國泰金,20,2,18,華南永昌-民權,2023-03-08,9312
2460,建通,30,12,18,華南永昌-民權,2023-03-08,9312
2634,漢翔,35,19,16,華南永昌-民權,2023-03-08,9312
6285,啟��,15,1,14,華南永昌-民權,2023-03-08,9312
2359,所羅門,13,2,11,華南永昌-民權,2023-03-08,9312
2367,燿華,11,0,11,華南永昌-民權,2023-03-08,9312
0056,元大高股息,106,95,11,華南永昌-民權,2023-03-08,9312
1101,台泥,10,0,10,華南永昌-民權,2023-03-08,9312
00637L,元大滬深300正2,10,0,10,華南永昌-民權,2023-03-08,9312
1618,合機,10,0,10,華南永昌-民權,2023-03-08,9312
2302,麗正,11,1,10,華南永昌-民權,2023-03-08,9312
2845,遠東銀,10,0,10,華南永昌-民權,2023-03-08,9312
3022,威強電,10,0,10,華南永昌-民權,2023-03-08,9312
3625,西勝,10,0,10,華南永昌-民權,2023-03-08,9312
6547,高端疫苗,10,0,10,華南永昌-民權,2023-03-08,9312
3499,環天科,10,1,9,華南永昌-民權,2023-03-08,9312
8112,至上,9,0,9,華南永昌-民權,2023-03-08,9312
2049,上銀,9,0,9,華南永昌-民權,2023-03-08,9312
3419,譁裕,10,2,8,華南永昌-民權,2023-03-08,9312
6016,康和證,8,0,8,華南永昌-民權,2023-03-08,9312
6234,高僑,11,3,8,華南永昌-民權,2023-03-08,9312
2609,陽明,26,19,7,華南永昌-民權,2023-03-08,9312
2419,仲琦,15,8,7,華南永昌-民權,2023-03-08,9312
3374,精材,10,3,7,華南永昌-民權,2023-03-08,9312
8215,明基材,10,3,7,華南永昌-民權,2023-03-08,9312
00752,中信中國50,6,0,6,華南永昌-民權,2023-03-08,9312
00919,群益台灣精選高息,6,0,6,華南永昌-民權,2023-03-08,9312
1220,台榮,7,1,6,華南永昌-民權,2023-03-08,9312
8403,盛弘,6,0,6,華南永昌-民權,2023-03-08,9312
9136,巨騰-DR,6,0,6,華南永昌-民權,2023-03-08,9312
5203,訊連,5,0,5,華南永昌-民權,2023-03-08,9312
00885,富邦越南,6,1,5,華南永昌-民權,2023-03-08,9312
1324,地球,5,0,5,華南永昌-民權,2023-03-08,9312
1102,亞泥,5,0,5,華南永昌-民權,2023-03-08,9312
1702,南僑,5,0,5,華南永昌-民權,2023-03-08,9312
1742,台蠟,5,0,5,華南永昌-民權,2023-03-08,9312
1795,美時,5,0,5,華南永昌-民權,2023-03-08,9312
2328,廣宇,7,2,5,華南永昌-民權,2023-03-08,9312
2369,菱生,7,2,5,華南永昌-民權,2023-03-08,9312
2495,普安,6,1,5,華南永昌-民權,2023-03-08,9312
8046,南電,140,3,137,華南永昌-民權,2023-03-09,9312
2317,鴻海,135,20,115,華南永昌-民權,2023-03-09,9312
4114,健喬,48,1,47,華南永昌-民權,2023-03-09,9312
3047,訊舟,40,4,36,華南永昌-民權,2023-03-09,9312
1718,中纖,32,4,28,華南永昌-民權,2023-03-09,9312
1799,易威,25,0,25,華南永昌-民權,2023-03-09,9312
1616,億泰,20,0,20,華南永昌-民權,2023-03-09,9312
3710,連展投控,20,0,20,華南永昌-民權,2023-03-09,9312
4541,晟田,30,10,20,華南永昌-民權,2023-03-09,9312
2890,永豐金,20,3,17,華南永昌-民權,2023-03-09,9312
6161,捷波,15,0,15,華南永昌-民權,2023-03-09,9312
9942,茂順,15,0,15,華南永昌-民權,2023-03-09,9312
6129,普誠,17,2,15,華南永昌-民權,2023-03-09,9312
2347,聯強,24,10,14,華南永昌-民權,2023-03-09,9312
6443,元晶,15,2,13,華南永昌-民權,2023-03-09,9312
3231,緯創,13,0,13,華南永昌-民權,2023-03-09,9312
3236,千如,13,0,13,華南永昌-民權,2023-03-09,9312
00715L,期街口布蘭特正2,13,2,11,華南永昌-民權,2023-03-09,9312
3027,盛達,44,33,11,華南永昌-民權,2023-03-09,9312
1101,台泥,14,4,10,華南永昌-民權,2023-03-09,9312
3046,建��,30,20,10,華南永昌-民權,2023-03-09,9312
00637L,元大滬深300正2,11,1,10,華南永昌-民權,2023-03-09,9312
2023,燁輝,10,0,10,華南永昌-民權,2023-03-09,9312
2460,建通,15,5,10,華南永昌-民權,2023-03-09,9312
2605,新興,10,0,10,華南永昌-民權,2023-03-09,9312
6152,百一,10,0,10,華南永昌-民權,2023-03-09,9312
8383,千附,10,0,10,華南永昌-民權,2023-03-09,9312
3290,東浦,9,0,9,華南永昌-民權,2023-03-09,9312
6104,創惟,13,4,9,華南永昌-民權,2023-03-09,9312
2409,友達,20,11,9,華南永昌-民權,2023-03-09,9312
1614,三洋電,8,0,8,華南永昌-民權,2023-03-09,9312
2204,中華,9,1,8,華南永昌-民權,2023-03-09,9312
3708,上緯投控,8,0,8,華南永昌-民權,2023-03-09,9312
6590,普鴻,8,0,8,華南永昌-民權,2023-03-09,9312
6770,力積電,12,4,8,華南永昌-民權,2023-03-09,9312
8033,雷虎,11,3,8,華南永昌-民權,2023-03-09,9312
1513,中興電,18,10,8,華南永昌-民權,2023-03-09,9312
1609,大亞,33,26,7,華南永昌-民權,2023-03-09,9312
6451,訊芯-KY,7,0,7,華南永昌-民權,2023-03-09,9312
8112,至上,7,0,7,華南永昌-民權,2023-03-09,9312
8411,福貞-KY,7,0,7,華南永昌-民權,2023-03-09,9312
8936,國統,12,5,7,華南永昌-民權,2023-03-09,9312
6290,良維,6,0,6,華南永昌-民權,2023-03-09,9312
6834,天二科技,6,0,6,華南永昌-民權,2023-03-09,9312
2472,立隆電,6,1,5,華南永昌-民權,2023-03-09,9312
2201,裕隆,10,5,5,華南永昌-民權,2023-03-09,9312
1514,亞力,7,2,5,華南永昌-民權,2023-03-09,9312
00720B,元大投資級公司債,5,0,5,華南永昌-民權,2023-03-09,9312
1618,合機,5,0,5,華南永昌-民權,2023-03-09,9312
3059,華晶科,8,3,5,華南永昌-民權,2023-03-09,9312
2834,臺企銀,1051,41,1010,華南永昌-民權,2023-03-10,9312
2888,新光金,307,0,307,華南永昌-民權,2023-03-10,9312
2884,玉山金,115,1,114,華南永昌-民權,2023-03-10,9312
2886,兆豐金,103,1,102,華南永昌-民權,2023-03-10,9312
3652,精聯,72,0,72,華南永昌-民權,2023-03-10,9312
1799,易威,49,0,49,華南永昌-民權,2023-03-10,9312
2618,長榮航,55,7,48,華南永昌-民權,2023-03-10,9312
2302,麗正,50,5,45,華南永昌-民權,2023-03-10,9312
2610,華航,45,2,43,華南永昌-民權,2023-03-10,9312
1109,信大,41,0,41,華南永昌-民權,2023-03-10,9312
1605,華新,51,18,33,華南永昌-民權,2023-03-10,9312
2929,淘帝-KY,33,0,33,華南永昌-民權,2023-03-10,9312
2614,東森,30,0,30,華南永昌-民權,2023-03-10,9312
1609,大亞,77,52,25,華南永昌-民權,2023-03-10,9312
2049,上銀,26,3,23,華南永昌-民權,2023-03-10,9312
4942,嘉彰,22,0,22,華南永昌-民權,2023-03-10,9312
2453,凌群,41,21,20,華南永昌-民權,2023-03-10,9312
00715L,期街口布蘭特正2,19,0,19,華南永昌-民權,2023-03-10,9312
0056,元大高股息,21,6,15,華南永昌-民權,2023-03-10,9312
1503,士電,15,0,15,華南永昌-民權,2023-03-10,9312
2498,宏達電,25,10,15,華南永昌-民權,2023-03-10,9312
8069,元太,17,3,14,華南永昌-民權,2023-03-10,9312
00882,中信中國高股息,14,0,14,華南永昌-民權,2023-03-10,9312
00713,元大台灣高息低波,14,0,14,華南永昌-民權,2023-03-10,9312
2409,友達,18,5,13,華南永昌-民權,2023-03-10,9312
6269,台郡,12,0,12,華南永昌-民權,2023-03-10,9312
1522,堤維西,14,2,12,華南永昌-民權,2023-03-10,9312
6217,中探針,12,0,12,華南永昌-民權,2023-03-10,9312
00712,復華富時不動產,11,0,11,華南永昌-民權,2023-03-10,9312
1504,東元,11,0,11,華南永昌-民權,2023-03-10,9312
2634,漢翔,12,1,11,華南永昌-民權,2023-03-10,9312
3081,聯亞,11,0,11,華南永昌-民權,2023-03-10,9312
2313,華通,10,0,10,華南永昌-民權,2023-03-10,9312
00646,元大S＆P500,10,0,10,華南永昌-民權,2023-03-10,9312
1514,亞力,10,0,10,華南永昌-民權,2023-03-10,9312
1524,耿鼎,85,75,10,華南永昌-民權,2023-03-10,9312
2371,大同,10,0,10,華南永昌-民權,2023-03-10,9312
3093,港建*,11,1,10,華南永昌-民權,2023-03-10,9312
2609,陽明,93,83,10,華南永昌-民權,2023-03-10,9312
2603,長榮,30,20,10,華南永昌-民權,2023-03-10,9312
2890,永豐金,15,6,9,華南永昌-民權,2023-03-10,9312
8383,千附,9,0,9,華南永昌-民權,2023-03-10,9312
2330,台積電,10,2,8,華南永昌-民權,2023-03-10,9312
1777,生泰,8,0,8,華南永昌-民權,2023-03-10,9312
1795,美時,9,1,8,華南永昌-民權,2023-03-10,9312
2460,建通,8,0,8,華南永昌-民權,2023-03-10,9312
3715,定穎投控,10,2,8,華南永昌-民權,2023-03-10,9312
4979,華星光,14,6,8,華南永昌-民權,2023-03-10,9312
5227,立凱-KY,7,0,7,華南永昌-民權,2023-03-10,9312
2413,環科,13,6,7,華南永昌-民權,2023-03-10,9312
8046,南電,127,0,127,華南永昌-民權,2023-03-13,9312
2610,華航,119,4,115,華南永昌-民權,2023-03-13,9312
00878,國泰永續高股息,112,0,112,華南永昌-民權,2023-03-13,9312
2834,臺企銀,146,34,112,華南永昌-民權,2023-03-13,9312
2634,漢翔,65,2,63,華南永昌-民權,2023-03-13,9312
00673R,期元大S＆P原油反1,61,2,59,華南永昌-民權,2023-03-13,9312
3652,精聯,41,0,41,華南永昌-民權,2023-03-13,9312
00713,元大台灣高息低波,36,1,35,華南永昌-民權,2023-03-13,9312
1799,易威,30,0,30,華南永昌-民權,2023-03-13,9312
2204,中華,30,0,30,華南永昌-民權,2023-03-13,9312
2929,淘帝-KY,32,2,30,華南永昌-民權,2023-03-13,9312
8996,高力,29,0,29,華南永昌-民權,2023-03-13,9312
3481,群創,27,4,23,華南永昌-民權,2023-03-13,9312
2498,宏達電,25,2,23,華南永昌-民權,2023-03-13,9312
1409,新纖,27,6,21,華南永昌-民權,2023-03-13,9312
2614,東森,20,0,20,華南永昌-民權,2023-03-13,9312
2884,玉山金,24,5,19,華南永昌-民權,2023-03-13,9312
5009,榮剛,22,3,19,華南永昌-民權,2023-03-13,9312
8112,至上,16,1,15,華南永昌-民權,2023-03-13,9312
00679B,元大美債20年,13,0,13,華南永昌-民權,2023-03-13,9312
2457,飛宏,38,26,12,華南永昌-民權,2023-03-13,9312
3508,位速,12,0,12,華南永昌-民權,2023-03-13,9312
3356,奇偶,11,0,11,華南永昌-民權,2023-03-13,9312
00671R,富邦NASDAQ反1,100,90,10,華南永昌-民權,2023-03-13,9312
1536,和大,16,6,10,華南永昌-民權,2023-03-13,9312
2313,華通,10,0,10,華南永昌-民權,2023-03-13,9312
2890,永豐金,11,1,10,華南永昌-民權,2023-03-13,9312
4942,嘉彰,10,0,10,華南永昌-民權,2023-03-13,9312
6152,百一,10,0,10,華南永昌-民權,2023-03-13,9312
3046,建��,60,50,10,華南永昌-民權,2023-03-13,9312
2609,陽明,29,19,10,華南永昌-民權,2023-03-13,9312
2009,第一銅,9,0,9,華南永昌-民權,2023-03-13,9312
5230,雷笛克光學,10,1,9,華南永昌-民權,2023-03-13,9312
00903,富邦元宇宙,8,0,8,華南永昌-民權,2023-03-13,9312
6517,保勝光學,8,0,8,華南永昌-民權,2023-03-13,9312
00885,富邦越南,12,5,7,華南永昌-民權,2023-03-13,9312
4934,太極,7,0,7,華南永昌-民權,2023-03-13,9312
3083,網龍,21,15,6,華南永昌-民權,2023-03-13,9312
2882,國泰金,6,1,5,華南永昌-民權,2023-03-13,9312
6770,力積電,10,5,5,華南永昌-民權,2023-03-13,9312
0050,元大台灣50,5,0,5,華南永昌-民權,2023-03-13,9312
00901,永豐智能車供應鏈,5,0,5,華南永昌-民權,2023-03-13,9312
1618,合機,5,0,5,華南永昌-民權,2023-03-13,9312
1795,美時,5,0,5,華南永昌-民權,2023-03-13,9312
3019,亞光,5,0,5,華南永昌-民權,2023-03-13,9312
3297,杭特,5,0,5,華南永昌-民權,2023-03-13,9312
3710,連展投控,5,0,5,華南永昌-民權,2023-03-13,9312
6578,達邦蛋白,5,0,5,華南永昌-民權,2023-03-13,9312
8390,金益鼎,5,0,5,華南永昌-民權,2023-03-13,9312
8033,雷虎,6,2,4,華南永昌-民權,2023-03-13,9312
2834,臺企銀,1012,7,1005,華南永昌-民權,2023-03-14,9312
00671R,富邦NASDAQ反1,250,0,250,華南永昌-民權,2023-03-14,9312
00878,國泰永續高股息,126,2,124,華南永昌-民權,2023-03-14,9312
00669R,國泰美國道瓊反1,66,0,66,華南永昌-民權,2023-03-14,9312
2618,長榮航,78,13,65,華南永昌-民權,2023-03-14,9312
00772B,中信高評級公司債,56,0,56,華南永昌-民權,2023-03-14,9312
2515,中工,60,20,40,華南永昌-民權,2023-03-14,9312
5876,上海商銀,38,0,38,華南永昌-民權,2023-03-14,9312
4903,聯光通,22,0,22,華南永昌-民權,2023-03-14,9312
2204,中華,20,0,20,華南永昌-民權,2023-03-14,9312
3481,群創,21,2,19,華南永昌-民權,2023-03-14,9312
3209,全科,27,8,19,華南永昌-民權,2023-03-14,9312
00715L,期街口布蘭特正2,19,0,19,華南永昌-民權,2023-03-14,9312
8478,東哥遊艇,19,2,17,華南永昌-民權,2023-03-14,9312
2883,凱基金,17,0,17,華南永昌-民權,2023-03-14,9312
1605,華新,32,17,15,華南永昌-民權,2023-03-14,9312
2453,凌群,69,54,15,華南永昌-民權,2023-03-14,9312
2303,聯電,31,17,14,華南永昌-民權,2023-03-14,9312
3703,欣陸,15,2,13,華南永昌-民權,2023-03-14,9312
2880,華南金,12,0,12,華南永昌-民權,2023-03-14,9312
1513,中興電,14,2,12,華南永昌-民權,2023-03-14,9312
00893,國泰智能電動車,12,0,12,華南永昌-民權,2023-03-14,9312
00687B,國泰20年美債,13,2,11,華南永昌-民權,2023-03-14,9312
00882,中信中國高股息,11,0,11,華南永昌-民權,2023-03-14,9312
8112,至上,11,0,11,華南永昌-民權,2023-03-14,9312
2610,華航,25,15,10,華南永昌-民權,2023-03-14,9312
00632R,元大台灣50反1,10,0,10,華南永昌-民權,2023-03-14,9312
6147,頎邦,10,0,10,華南永昌-民權,2023-03-14,9312
9907,統一實,10,0,10,華南永昌-民權,2023-03-14,9312
9931,欣高,10,0,10,華南永昌-民權,2023-03-14,9312
9945,潤泰新,9,0,9,華南永昌-民權,2023-03-14,9312
2891,中信金,9,0,9,華南永昌-民權,2023-03-14,9312
1301,台塑,9,0,9,華南永昌-民權,2023-03-14,9312
2421,建準,6,0,6,華南永昌-民權,2023-03-14,9312
8049,晶采,6,0,6,華南永昌-民權,2023-03-14,9312
2615,萬海,14,8,6,華南永昌-民權,2023-03-14,9312
4114,健喬,7,2,5,華南永昌-民權,2023-03-14,9312
2359,所羅門,5,0,5,華南永昌-民權,2023-03-14,9312
00895,富邦未來車,5,0,5,華南永昌-民權,2023-03-14,9312
00885,富邦越南,6,1,5,華南永昌-民權,2023-03-14,9312
1614,三洋電,5,0,5,華南永昌-民權,2023-03-14,9312
1723,中碳,5,0,5,華南永昌-民權,2023-03-14,9312
2855,統一證,5,0,5,華南永昌-民權,2023-03-14,9312
4726,永昕,7,2,5,華南永昌-民權,2023-03-14,9312
6005,群益證,5,0,5,華南永昌-民權,2023-03-14,9312
6152,百一,5,0,5,華南永昌-民權,2023-03-14,9312
6282,康舒,15,10,5,華南永昌-民權,2023-03-14,9312
8069,元太,6,1,5,華南永昌-民權,2023-03-14,9312
8936,國統,7,2,5,華南永昌-民權,2023-03-14,9312
1409,新纖,10,6,4,華南永昌-民權,2023-03-14,9312
2204,中華,90,21,69,華南永昌-民權,2023-03-15,9312
2609,陽明,74,14,60,華南永昌-民權,2023-03-15,9312
00671R,富邦NASDAQ反1,50,0,50,華南永昌-民權,2023-03-15,9312
4938,和碩,34,0,34,華南永昌-民權,2023-03-15,9312
4927,泰鼎-KY,110,80,30,華南永昌-民權,2023-03-15,9312
00715L,期街口布蘭特正2,25,0,25,華南永昌-民權,2023-03-15,9312
2915,潤泰全,23,0,23,華南永昌-民權,2023-03-15,9312
00878,國泰永續高股息,24,1,23,華南永昌-民權,2023-03-15,9312
1517,利奇,21,0,21,華南永昌-民權,2023-03-15,9312
2603,長榮,43,27,16,華南永昌-民權,2023-03-15,9312
2890,永豐金,28,13,15,華南永昌-民權,2023-03-15,9312
3264,欣銓,15,0,15,華南永昌-民權,2023-03-15,9312
2102,泰豐,14,0,14,華南永昌-民權,2023-03-15,9312
5450,南良,14,0,14,華南永昌-民權,2023-03-15,9312
1514,亞力,12,0,12,華南永昌-民權,2023-03-15,9312
2834,臺企銀,14,2,12,華南永昌-民權,2023-03-15,9312
9955,佳龍,12,1,11,華南永昌-民權,2023-03-15,9312
3481,群創,11,0,11,華南永昌-民權,2023-03-15,9312
00751B,元大AAA至A公司債,10,0,10,華南永昌-民權,2023-03-15,9312
2885,元大金,10,0,10,華南永昌-民權,2023-03-15,9312
4532,瑞智,10,0,10,華南永昌-民權,2023-03-15,9312
2880,華南金,29,20,9,華南永昌-民權,2023-03-15,9312
00633L,富邦上証正2,17,8,9,華南永昌-民權,2023-03-15,9312
1101,台泥,11,2,9,華南永昌-民權,2023-03-15,9312
2615,萬海,22,14,8,華南永昌-民權,2023-03-15,9312
1342,八貫,8,0,8,華南永昌-民權,2023-03-15,9312
3419,譁裕,8,0,8,華南永昌-民權,2023-03-15,9312
4906,正文,11,3,8,華南永昌-民權,2023-03-15,9312
2542,興富發,7,0,7,華南永昌-民權,2023-03-15,9312
3209,全科,13,7,6,華南永昌-民權,2023-03-15,9312
2886,兆豐金,7,1,6,華南永昌-民權,2023-03-15,9312
2887,台新金,6,0,6,華南永昌-民權,2023-03-15,9312
6116,彩晶,6,0,6,華南永昌-民權,2023-03-15,9312
6234,高僑,6,0,6,華南永昌-民權,2023-03-15,9312
00720B,元大投資級公司債,5,0,5,華南永昌-民權,2023-03-15,9312
1312,國喬,5,0,5,華南永昌-民權,2023-03-15,9312
006208,富邦台50,5,0,5,華南永昌-民權,2023-03-15,9312
1799,易威,5,0,5,華南永昌-民權,2023-03-15,9312
2027,大成鋼,8,3,5,華南永昌-民權,2023-03-15,9312
3013,晟銘電,5,0,5,華南永昌-民權,2023-03-15,9312
3624,光頡,7,2,5,華南永昌-民權,2023-03-15,9312
3711,日月光投控,5,0,5,華南永昌-民權,2023-03-15,9312
4960,誠美材,5,0,5,華南永昌-民權,2023-03-15,9312
6191,精成科,5,0,5,華南永昌-民權,2023-03-15,9312
2884,玉山金,14,9,5,華南永昌-民權,2023-03-15,9312
5880,合庫金,5,1,4,華南永昌-民權,2023-03-15,9312
2614,東森,14,10,4,華南永昌-民權,2023-03-15,9312
1608,華榮,4,0,4,華南永昌-民權,2023-03-15,9312
2002,中鋼,14,10,4,華南永昌-民權,2023-03-15,9312
2739,寒舍,4,0,4,華南永昌-民權,2023-03-15,9312
2834,臺企銀,396,279,117,華南永昌-民權,2023-03-16,9312
3652,精聯,70,2,68,華南永昌-民權,2023-03-16,9312
00671R,富邦NASDAQ反1,50,0,50,華南永昌-民權,2023-03-16,9312
2634,漢翔,35,2,33,華南永昌-民權,2023-03-16,9312
00878,國泰永續高股息,82,50,32,華南永昌-民權,2023-03-16,9312
4927,泰鼎-KY,30,0,30,華南永昌-民權,2023-03-16,9312
2618,長榮航,48,21,27,華南永昌-民權,2023-03-16,9312
2313,華通,24,0,24,華南永昌-民權,2023-03-16,9312
3356,奇偶,20,0,20,華南永昌-民權,2023-03-16,9312
5258,虹堡,21,1,20,華南永昌-民權,2023-03-16,9312
2890,永豐金,33,14,19,華南永昌-民權,2023-03-16,9312
2609,陽明,30,13,17,華南永昌-民權,2023-03-16,9312
2102,泰豐,16,0,16,華南永昌-民權,2023-03-16,9312
00712,復華富時不動產,15,0,15,華南永昌-民權,2023-03-16,9312
00715L,期街口布蘭特正2,12,0,12,華南永昌-民權,2023-03-16,9312
2882,國泰金,13,1,12,華南永昌-民權,2023-03-16,9312
3056,富華新,12,0,12,華南永昌-民權,2023-03-16,9312
4934,太極,15,3,12,華南永昌-民權,2023-03-16,9312
5009,榮剛,12,0,12,華南永昌-民權,2023-03-16,9312
00679B,元大美債20年,11,0,11,華南永昌-民權,2023-03-16,9312
2208,台船,12,1,11,華南永昌-民權,2023-03-16,9312
4306,炎洲,12,2,10,華南永昌-民權,2023-03-16,9312
00903,富邦元宇宙,10,0,10,華南永昌-民權,2023-03-16,9312
00882,中信中國高股息,10,0,10,華南永昌-民權,2023-03-16,9312
1319,東陽,10,0,10,華南永昌-民權,2023-03-16,9312
00632R,元大台灣50反1,20,10,10,華南永昌-民權,2023-03-16,9312
2337,旺宏,10,0,10,華南永昌-民權,2023-03-16,9312
2614,東森,10,0,10,華南永昌-民權,2023-03-16,9312
3710,連展投控,10,0,10,華南永昌-民權,2023-03-16,9312
5515,建國,10,0,10,華南永昌-民權,2023-03-16,9312
2603,長榮,29,20,9,華南永昌-民權,2023-03-16,9312
6443,元晶,21,12,9,華南永昌-民權,2023-03-16,9312
00713,元大台灣高息低波,9,0,9,華南永昌-民權,2023-03-16,9312
1517,利奇,8,0,8,華南永昌-民權,2023-03-16,9312
1314,中石化,8,0,8,華南永昌-民權,2023-03-16,9312
2801,彰銀,8,0,8,華南永昌-民權,2023-03-16,9312
3027,盛達,18,10,8,華南永昌-民權,2023-03-16,9312
8033,雷虎,8,0,8,華南永昌-民權,2023-03-16,9312
2880,華南金,18,10,8,華南永昌-民權,2023-03-16,9312
0050,元大台灣50,7,0,7,華南永昌-民權,2023-03-16,9312
1605,華新,10,3,7,華南永昌-民權,2023-03-16,9312
1609,大亞,14,7,7,華南永昌-民權,2023-03-16,9312
00642U,期元大S＆P石油,6,0,6,華南永昌-民權,2023-03-16,9312
3162,精確,7,1,6,華南永昌-民權,2023-03-16,9312
6125,廣運,13,7,6,華南永昌-民權,2023-03-16,9312
8069,元太,7,1,6,華南永昌-民權,2023-03-16,9312
2884,玉山金,15,9,6,華南永昌-民權,2023-03-16,9312
0056,元大高股息,6,1,5,華南永昌-民權,2023-03-16,9312
2888,新光金,5,0,5,華南永昌-民權,2023-03-16,9312
2886,兆豐金,8,3,5,華南永昌-民權,2023-03-16,9312
3045,台灣大,100,5,95,華南永昌-民權,2023-03-17,9312
2834,臺企銀,124,37,87,華南永昌-民權,2023-03-17,9312
00671R,富邦NASDAQ反1,50,0,50,華南永昌-民權,2023-03-17,9312
3038,全台,50,0,50,華南永昌-民權,2023-03-17,9312
9904,寶成,45,1,44,華南永昌-民權,2023-03-17,9312
4927,泰鼎-KY,40,0,40,華南永昌-民權,2023-03-17,9312
8046,南電,40,0,40,華南永昌-民權,2023-03-17,9312
2891,中信金,30,0,30,華南永昌-民權,2023-03-17,9312
2409,友達,24,3,21,華南永昌-民權,2023-03-17,9312
2889,國票金,20,2,18,華南永昌-民權,2023-03-17,9312
00632R,元大台灣50反1,22,6,16,華南永昌-民權,2023-03-17,9312
6282,康舒,22,9,13,華南永昌-民權,2023-03-17,9312
2402,毅嘉,10,0,10,華南永昌-民權,2023-03-17,9312
2482,連宇,11,1,10,華南永昌-民權,2023-03-17,9312
2601,益航,10,0,10,華南永昌-民權,2023-03-17,9312
2634,漢翔,14,4,10,華南永昌-民權,2023-03-17,9312
2641,正德,14,4,10,華南永昌-民權,2023-03-17,9312
5258,虹堡,10,0,10,華南永昌-民權,2023-03-17,9312
6233,旺玖,10,0,10,華南永昌-民權,2023-03-17,9312
1101,台泥,8,0,8,華南永昌-民權,2023-03-17,9312
2014,中鴻,8,0,8,華南永昌-民權,2023-03-17,9312
5608,四維航,8,0,8,華南永昌-民權,2023-03-17,9312
6164,華興,8,0,8,華南永昌-民權,2023-03-17,9312
6443,元晶,28,20,8,華南永昌-民權,2023-03-17,9312
0056,元大高股息,9,1,8,華南永昌-民權,2023-03-17,9312
00637L,元大滬深300正2,8,1,7,華南永昌-民權,2023-03-17,9312
2457,飛宏,12,5,7,華南永昌-民權,2023-03-17,9312
2880,華南金,9,2,7,華南永昌-民權,2023-03-17,9312
1316,上曜,6,0,6,華南永昌-民權,2023-03-17,9312
1467,南緯,12,6,6,華南永昌-民權,2023-03-17,9312
2883,凱基金,6,0,6,華南永昌-民權,2023-03-17,9312
3712,永崴投控,6,0,6,華南永昌-民權,2023-03-17,9312
3481,群創,11,6,5,華南永昌-民權,2023-03-17,9312
1609,大亞,18,13,5,華南永昌-民權,2023-03-17,9312
1785,光洋科,5,0,5,華南永昌-民權,2023-03-17,9312
2359,所羅門,5,0,5,華南永昌-民權,2023-03-17,9312
3704,合勤控,5,0,5,華南永昌-民權,2023-03-17,9312
3624,光頡,9,5,4,華南永昌-民權,2023-03-17,9312
2027,大成鋼,4,0,4,華南永昌-民權,2023-03-17,9312
2610,華航,4,0,4,華南永昌-民權,2023-03-17,9312
5452,佶優,6,2,4,華南永昌-民權,2023-03-17,9312
8033,雷虎,5,1,4,華南永昌-民權,2023-03-17,9312
2603,長榮,3,0,3,華南永昌-民權,2023-03-17,9312
2892,第一金,3,0,3,華南永昌-民權,2023-03-17,9312
00687B,國泰20年美債,4,1,3,華南永昌-民權,2023-03-17,9312
2406,國碩,7,4,3,華南永昌-民權,2023-03-17,9312
2884,玉山金,3,0,3,華南永昌-民權,2023-03-17,9312
3088,艾訊,5,2,3,華南永昌-民權,2023-03-17,9312
3228,金麗科,3,0,3,華南永昌-民權,2023-03-17,9312
3419,譁裕,3,0,3,華南永昌-民權,2023-03-17,9312
2834,臺企銀,412,14,398,華南永昌-民權,2023-03-20,9312
4927,泰鼎-KY,100,0,100,華南永昌-民權,2023-03-20,9312
00878,國泰永續高股息,58,3,55,華南永昌-民權,2023-03-20,9312
3037,欣興,50,5,45,華南永昌-民權,2023-03-20,9312
2615,萬海,26,5,21,華南永昌-民權,2023-03-20,9312
1799,易威,20,0,20,華南永昌-民權,2023-03-20,9312
2915,潤泰全,21,1,20,華南永昌-民權,2023-03-20,9312
8033,雷虎,19,0,19,華南永昌-民權,2023-03-20,9312
6244,茂迪,24,10,14,華南永昌-民權,2023-03-20,9312
0056,元大高股息,14,1,13,華南永昌-民權,2023-03-20,9312
2481,強茂,15,5,10,華南永昌-民權,2023-03-20,9312
5009,榮剛,10,0,10,華南永昌-民權,2023-03-20,9312
5015,華祺,10,0,10,華南永昌-民權,2023-03-20,9312
5227,立凱-KY,10,0,10,華南永昌-民權,2023-03-20,9312
9907,統一實,10,0,10,華南永昌-民權,2023-03-20,9312
2402,毅嘉,10,1,9,華南永昌-民權,2023-03-20,9312
2636,台驊控股,9,0,9,華南永昌-民權,2023-03-20,9312
00712,復華富時不動產,8,0,8,華南永昌-民權,2023-03-20,9312
00751B,元大AAA至A公司債,8,0,8,華南永昌-民權,2023-03-20,9312
00857B,永豐20年美公債,7,2,5,華南永昌-民權,2023-03-20,9312
2885,元大金,10,5,5,華南永昌-民權,2023-03-20,9312
3686,達能,5,0,5,華南永昌-民權,2023-03-20,9312
00752,中信中國50,5,0,5,華南永昌-民權,2023-03-20,9312
1709,和益,5,0,5,華南永昌-民權,2023-03-20,9312
1795,美時,5,0,5,華南永昌-民權,2023-03-20,9312
1817,凱撒衛,5,0,5,華南永昌-民權,2023-03-20,9312
2002,中鋼,17,12,5,華南永昌-民權,2023-03-20,9312
2929,淘帝-KY,5,0,5,華南永昌-民權,2023-03-20,9312
6220,岳豐,5,0,5,華南永昌-民權,2023-03-20,9312
6235,華孚,6,1,5,華南永昌-民權,2023-03-20,9312
4906,正文,5,0,5,華南永昌-民權,2023-03-20,9312
3046,建��,11,7,4,華南永昌-民權,2023-03-20,9312
00885,富邦越南,5,1,4,華南永昌-民權,2023-03-20,9312
00715L,期街口布蘭特正2,14,10,4,華南永昌-民權,2023-03-20,9312
1609,大亞,7,3,4,華南永昌-民權,2023-03-20,9312
2014,中鴻,4,0,4,華南永昌-民權,2023-03-20,9312
2468,華經,4,0,4,華南永昌-民權,2023-03-20,9312
2883,凱基金,12,8,4,華南永昌-民權,2023-03-20,9312
3035,智原,5,1,4,華南永昌-民權,2023-03-20,9312
4979,華星光,5,1,4,華南永昌-民權,2023-03-20,9312
6506,雙邦,4,0,4,華南永昌-民權,2023-03-20,9312
6770,力積電,5,1,4,華南永昌-民權,2023-03-20,9312
2603,長榮,15,11,4,華南永昌-民權,2023-03-20,9312
2880,華南金,6,2,4,華南永昌-民權,2023-03-20,9312
00916,國泰全球品牌50,4,0,4,華南永昌-民權,2023-03-20,9312
8046,南電,6,3,3,華南永昌-民權,2023-03-20,9312
2881,富邦金,3,0,3,華南永昌-民權,2023-03-20,9312
3481,群創,6,3,3,華南永昌-民權,2023-03-20,9312
00905,FT臺灣Smart,3,0,3,華南永昌-民權,2023-03-20,9312
2103,台橡,3,0,3,華南永昌-民權,2023-03-20,9312
3037,欣興,142,14,128,華南永昌-民權,2023-03-21,9312
3029,零壹,57,6,51,華南永昌-民權,2023-03-21,9312
2302,麗正,50,7,43,華南永昌-民權,2023-03-21,9312
1799,易威,40,0,40,華南永昌-民權,2023-03-21,9312
1326,台化,35,0,35,華南永昌-民權,2023-03-21,9312
2402,毅嘉,30,6,24,華南永昌-民權,2023-03-21,9312
2834,臺企銀,33,11,22,華南永昌-民權,2023-03-21,9312
1312,國喬,20,0,20,華南永昌-民權,2023-03-21,9312
2406,國碩,31,12,19,華南永昌-民權,2023-03-21,9312
8046,南電,23,5,18,華南永昌-民權,2023-03-21,9312
5009,榮剛,17,2,15,華南永昌-民權,2023-03-21,9312
2409,友達,20,5,15,華南永昌-民權,2023-03-21,9312
8033,雷虎,19,7,12,華南永昌-民權,2023-03-21,9312
1513,中興電,13,1,12,華南永昌-民權,2023-03-21,9312
3362,先進光,12,1,11,華南永昌-民權,2023-03-21,9312
1432,大魯閣,10,0,10,華南永昌-民權,2023-03-21,9312
1220,台榮,10,0,10,華南永昌-民權,2023-03-21,9312
2484,希華,10,0,10,華南永昌-民權,2023-03-21,9312
6788,華景電,10,0,10,華南永昌-民權,2023-03-21,9312
00878,國泰永續高股息,39,31,8,華南永昌-民權,2023-03-21,9312
00715L,期街口布蘭特正2,17,10,7,華南永昌-民權,2023-03-21,9312
6443,元晶,40,33,7,華南永昌-民權,2023-03-21,9312
2609,陽明,7,1,6,華南永昌-民權,2023-03-21,9312
2359,所羅門,6,0,6,華南永昌-民權,2023-03-21,9312
2462,良得電,14,8,6,華南永昌-民權,2023-03-21,9312
2615,萬海,6,0,6,華南永昌-民權,2023-03-21,9312
2449,京元電子,6,1,5,華南永昌-民權,2023-03-21,9312
2504,國產,5,0,5,華南永昌-民權,2023-03-21,9312
3236,千如,12,7,5,華南永昌-民權,2023-03-21,9312
4960,誠美材,10,5,5,華南永昌-民權,2023-03-21,9312
5015,華祺,5,0,5,華南永昌-民權,2023-03-21,9312
6155,鈞寶,5,0,5,華南永昌-民權,2023-03-21,9312
6770,力積電,6,1,5,華南永昌-民權,2023-03-21,9312
8383,千附,5,0,5,華南永昌-民權,2023-03-21,9312
4967,十銓,6,2,4,華南永昌-民權,2023-03-21,9312
2231,為升,4,0,4,華南永昌-民權,2023-03-21,9312
2344,華邦電,4,0,4,華南永昌-民權,2023-03-21,9312
4175,杏一,4,0,4,華南永昌-民權,2023-03-21,9312
6290,良維,4,0,4,華南永昌-民權,2023-03-21,9312
6547,高端疫苗,6,2,4,華南永昌-民權,2023-03-21,9312
8926,台汽電,4,0,4,華南永昌-民權,2023-03-21,9312
2880,華南金,3,0,3,華南永昌-民權,2023-03-21,9312
1101,台泥,4,1,3,華南永昌-民權,2023-03-21,9312
6235,華孚,5,2,3,華南永昌-民權,2023-03-21,9312
1309,台達化,3,0,3,華南永昌-民權,2023-03-21,9312
00753L,中信中國50正2,3,0,3,華南永昌-民權,2023-03-21,9312
1584,精剛,5,2,3,華南永昌-民權,2023-03-21,9312
2492,華新科,3,0,3,華南永昌-民權,2023-03-21,9312
3056,富華新,3,0,3,華南永昌-民權,2023-03-21,9312
3432,台端,18,15,3,華南永昌-民權,2023-03-21,9312
2834,臺企銀,356,0,356,華南永昌-民權,2023-03-22,9312
00632R,元大台灣50反1,68,0,68,華南永昌-民權,2023-03-22,9312
3037,欣興,62,6,56,華南永昌-民權,2023-03-22,9312
00664R,國泰臺灣加權反1,30,0,30,華南永昌-民權,2023-03-22,9312
2888,新光金,20,0,20,華南永昌-民權,2023-03-22,9312
1522,堤維西,20,0,20,華南永昌-民權,2023-03-22,9312
8048,德勝,20,0,20,華南永昌-民權,2023-03-22,9312
1760,寶齡富錦,15,0,15,華南永昌-民權,2023-03-22,9312
5009,榮剛,13,0,13,華南永昌-民權,2023-03-22,9312
2457,飛宏,14,1,13,華南永昌-民權,2023-03-22,9312
2449,京元電子,13,1,12,華南永昌-民權,2023-03-22,9312
6227,茂綸,16,5,11,華南永昌-民權,2023-03-22,9312
9955,佳龍,11,1,10,華南永昌-民權,2023-03-22,9312
00902,中信電池及儲能,10,0,10,華南永昌-民權,2023-03-22,9312
2441,超豐,10,0,10,華南永昌-民權,2023-03-22,9312
2453,凌群,22,12,10,華南永昌-民權,2023-03-22,9312
2915,潤泰全,10,0,10,華南永昌-民權,2023-03-22,9312
3088,艾訊,10,0,10,華南永昌-民權,2023-03-22,9312
6233,旺玖,10,0,10,華南永昌-民權,2023-03-22,9312
6235,華孚,15,5,10,華南永昌-民權,2023-03-22,9312
6266,泰詠,12,2,10,華南永昌-民權,2023-03-22,9312
3576,聯合再生,10,1,9,華南永昌-民權,2023-03-22,9312
00679B,元大美債20年,12,3,9,華南永昌-民權,2023-03-22,9312
2302,麗正,12,3,9,華南永昌-民權,2023-03-22,9312
2427,三商電,14,5,9,華南永昌-民權,2023-03-22,9312
2618,長榮航,10,2,8,華南永昌-民權,2023-03-22,9312
2883,凱基金,8,0,8,華南永昌-民權,2023-03-22,9312
3349,寶德,8,0,8,華南永昌-民權,2023-03-22,9312
4931,新盛力,8,0,8,華南永昌-民權,2023-03-22,9312
6443,元晶,9,2,7,華南永昌-民權,2023-03-22,9312
1514,亞力,10,3,7,華南永昌-民權,2023-03-22,9312
2482,連宇,28,21,7,華南永昌-民權,2023-03-22,9312
2634,漢翔,11,4,7,華南永昌-民權,2023-03-22,9312
3209,全科,7,0,7,華南永昌-民權,2023-03-22,9312
8112,至上,7,0,7,華南永昌-民權,2023-03-22,9312
2883B,凱基金乙特,6,0,6,華南永昌-民權,2023-03-22,9312
1785,光洋科,6,0,6,華南永昌-民權,2023-03-22,9312
2204,中華,9,3,6,華南永昌-民權,2023-03-22,9312
2486,一詮,8,2,6,華南永昌-民權,2023-03-22,9312
2637,慧洋-KY,6,0,6,華南永昌-民權,2023-03-22,9312
4550,長佳,6,0,6,華南永昌-民權,2023-03-22,9312
6191,精成科,6,0,6,華南永昌-民權,2023-03-22,9312
3013,晟銘電,6,1,5,華南永昌-民權,2023-03-22,9312
3049,精金,5,0,5,華南永昌-民權,2023-03-22,9312
6153,嘉聯益,5,0,5,華南永昌-民權,2023-03-22,9312
6288,聯嘉,5,0,5,華南永昌-民權,2023-03-22,9312
1609,大亞,4,0,4,華南永昌-民權,2023-03-22,9312
1809,中釉,5,1,4,華南永昌-民權,2023-03-22,9312
2201,裕隆,9,5,4,華南永昌-民權,2023-03-22,9312
2359,所羅門,7,3,4,華南永昌-民權,2023-03-22,9312
00632R,元大台灣50反1,752,0,752,華南永昌-民權,2023-03-23,9312
00671R,富邦NASDAQ反1,83,0,83,華南永昌-民權,2023-03-23,9312
6182,合晶,38,1,37,華南永昌-民權,2023-03-23,9312
2332,友訊,15,0,15,華南永昌-民權,2023-03-23,9312
8358,金居,15,0,15,華南永昌-民權,2023-03-23,9312
3059,華晶科,14,2,12,華南永昌-民權,2023-03-23,9312
2471,資通,11,0,11,華南永昌-民權,2023-03-23,9312
2612,中航,11,0,11,華南永昌-民權,2023-03-23,9312
8048,德勝,11,0,11,華南永昌-民權,2023-03-23,9312
3037,欣興,20,9,11,華南永昌-民權,2023-03-23,9312
2882,國泰金,10,0,10,華南永昌-民權,2023-03-23,9312
3576,聯合再生,10,0,10,華南永昌-民權,2023-03-23,9312
00713,元大台灣高息低波,10,0,10,華南永昌-民權,2023-03-23,9312
2409,友達,11,2,9,華南永昌-民權,2023-03-23,9312
3322,建舜電,13,5,8,華南永昌-民權,2023-03-23,9312
00885,富邦越南,7,0,7,華南永昌-民權,2023-03-23,9312
3481,群創,15,8,7,華南永昌-民權,2023-03-23,9312
6282,康舒,14,8,6,華南永昌-民權,2023-03-23,9312
8069,元太,6,0,6,華南永昌-民權,2023-03-23,9312
1432,大魯閣,6,0,6,華南永昌-民權,2023-03-23,9312
3441,聯一光,8,2,6,華南永昌-民權,2023-03-23,9312
2355,敬鵬,5,0,5,華南永昌-民權,2023-03-23,9312
2888,新光金,5,0,5,華南永昌-民權,2023-03-23,9312
1605,華新,6,1,5,華南永昌-民權,2023-03-23,9312
1799,易威,5,0,5,華南永昌-民權,2023-03-23,9312
1809,中釉,5,0,5,華南永昌-民權,2023-03-23,9312
2374,佳能,5,0,5,華南永昌-民權,2023-03-23,9312
3454,晶睿,5,0,5,華南永昌-民權,2023-03-23,9312
5272,笙科,5,0,5,華南永昌-民權,2023-03-23,9312
6244,茂迪,7,2,5,華南永昌-民權,2023-03-23,9312
6767,台微醫,5,0,5,華南永昌-民權,2023-03-23,9312
8176,智捷,5,0,5,華南永昌-民權,2023-03-23,9312
0056,元大高股息,10,6,4,華南永昌-民權,2023-03-23,9312
2603,長榮,17,13,4,華南永昌-民權,2023-03-23,9312
2605,新興,12,8,4,華南永昌-民權,2023-03-23,9312
1467,南緯,4,0,4,華南永昌-民權,2023-03-23,9312
2402,毅嘉,19,15,4,華南永昌-民權,2023-03-23,9312
2486,一詮,4,0,4,華南永昌-民權,2023-03-23,9312
3217,優群,4,0,4,華南永昌-民權,2023-03-23,9312
3706,神達,4,0,4,華南永昌-民權,2023-03-23,9312
5009,榮剛,5,1,4,華南永昌-民權,2023-03-23,9312
8936,國統,4,0,4,華南永昌-民權,2023-03-23,9312
2609,陽明,9,6,3,華南永昌-民權,2023-03-23,9312
00679B,元大美債20年,5,2,3,華南永昌-民權,2023-03-23,9312
1591,駿吉-KY,3,0,3,華南永昌-民權,2023-03-23,9312
2302,麗正,3,0,3,華南永昌-民權,2023-03-23,9312
2462,良得電,4,1,3,華南永昌-民權,2023-03-23,9312
2617,台航,3,0,3,華南永昌-民權,2023-03-23,9312
2641,正德,3,0,3,華南永昌-民權,2023-03-23,9312
3260,威剛,4,1,3,華南永昌-民權,2023-03-23,9312
6223,旺矽,89,0,89,華南永昌-民權,2023-03-24,9312
3038,全台,50,0,50,華南永昌-民權,2023-03-24,9312
1709,和益,20,0,20,華南永昌-民權,2023-03-24,9312
2312,金寶,20,1,19,華南永昌-民權,2023-03-24,9312
00679B,元大美債20年,17,0,17,華南永昌-民權,2023-03-24,9312
2723,美食-KY,30,15,15,華南永昌-民權,2023-03-24,9312
6182,合晶,13,1,12,華南永昌-民權,2023-03-24,9312
6834,天二科技,12,0,12,華南永昌-民權,2023-03-24,9312
00715L,期街口布蘭特正2,11,0,11,華南永昌-民權,2023-03-24,9312
6180,橘子,11,0,11,華南永昌-民權,2023-03-24,9312
2340,台亞,10,0,10,華南永昌-民權,2023-03-24,9312
1455,集盛,10,0,10,華南永昌-民權,2023-03-24,9312
00673R,期元大S＆P原油反1,10,0,10,華南永昌-民權,2023-03-24,9312
00772B,中信高評級公司債,10,0,10,華南永昌-民權,2023-03-24,9312
00751B,元大AAA至A公司債,10,0,10,華南永昌-民權,2023-03-24,9312
1611,中電,11,1,10,華南永昌-民權,2023-03-24,9312
1799,易威,10,0,10,華南永昌-民權,2023-03-24,9312
2027,大成鋼,11,1,10,華南永昌-民權,2023-03-24,9312
3189,景碩,15,6,9,華南永昌-民權,2023-03-24,9312
00720B,元大投資級公司債,9,0,9,華南永昌-民權,2023-03-24,9312
4960,誠美材,10,1,9,華南永昌-民權,2023-03-24,9312
8048,德勝,8,0,8,華南永昌-民權,2023-03-24,9312
8033,雷虎,8,0,8,華南永昌-民權,2023-03-24,9312
2105,正新,10,3,7,華南永昌-民權,2023-03-24,9312
2402,毅嘉,20,13,7,華南永昌-民權,2023-03-24,9312
6109,亞元,7,0,7,華南永昌-民權,2023-03-24,9312
2834,臺企銀,28,21,7,華南永昌-民權,2023-03-24,9312
1722,台肥,6,0,6,華南永昌-民權,2023-03-24,9312
3499,環天科,6,0,6,華南永昌-民權,2023-03-24,9312
4976,佳凌,6,0,6,華南永昌-民權,2023-03-24,9312
8401,白紗科,6,0,6,華南永昌-民權,2023-03-24,9312
5425,台半,5,0,5,華南永昌-民權,2023-03-24,9312
00713,元大台灣高息低波,5,0,5,華南永昌-民權,2023-03-24,9312
2615,萬海,5,0,5,華南永昌-民權,2023-03-24,9312
3094,聯傑,5,0,5,華南永昌-民權,2023-03-24,9312
3236,千如,7,2,5,華南永昌-民權,2023-03-24,9312
5009,榮剛,5,0,5,華南永昌-民權,2023-03-24,9312
5508,永信建,5,0,5,華南永昌-民權,2023-03-24,9312
8383,千附,6,1,5,華南永昌-民權,2023-03-24,9312
8171,天宇,6,1,5,華南永昌-民權,2023-03-24,9312
2891,中信金,4,0,4,華南永昌-民權,2023-03-24,9312
00633L,富邦上証正2,4,0,4,華南永昌-民權,2023-03-24,9312
2014,中鴻,6,2,4,華南永昌-民權,2023-03-24,9312
8249,菱光,4,0,4,華南永昌-民權,2023-03-24,9312
1467,南緯,5,2,3,華南永昌-民權,2023-03-24,9312
1517,利奇,3,0,3,華南永昌-民權,2023-03-24,9312
1438,三地開發,3,0,3,華南永昌-民權,2023-03-24,9312
00725B,國泰投資級公司債,3,0,3,華南永昌-民權,2023-03-24,9312
1583,程泰,3,0,3,華南永昌-民權,2023-03-24,9312
2883,凱基金,3,0,3,華南永昌-民權,2023-03-24,9312
8069,元太,200,101,99,華南永昌-民權,2023-03-27,9312
6223,旺矽,98,0,98,華南永昌-民權,2023-03-27,9312
6116,彩晶,50,0,50,華南永昌-民權,2023-03-27,9312
1605,華新,39,3,36,華南永昌-民權,2023-03-27,9312
2476,鉅祥,20,1,19,華南永昌-民權,2023-03-27,9312
6288,聯嘉,38,19,19,華南永昌-民權,2023-03-27,9312
1504,東元,20,4,16,華南永昌-民權,2023-03-27,9312
2883,凱基金,16,0,16,華南永昌-民權,2023-03-27,9312
1513,中興電,16,0,16,華南永昌-民權,2023-03-27,9312
4417,金洲,15,0,15,華南永昌-民權,2023-03-27,9312
5508,永信建,15,0,15,華南永昌-民權,2023-03-27,9312
00882,中信中國高股息,14,0,14,華南永昌-民權,2023-03-27,9312
0056,元大高股息,12,0,12,華南永昌-民權,2023-03-27,9312
8048,德勝,12,0,12,華南永昌-民權,2023-03-27,9312
2457,飛宏,15,4,11,華南永昌-民權,2023-03-27,9312
1609,大亞,21,11,10,華南永昌-民權,2023-03-27,9312
2027,大成鋼,10,0,10,華南永昌-民權,2023-03-27,9312
3576,聯合再生,10,0,10,華南永昌-民權,2023-03-27,9312
3715,定穎投控,11,1,10,華南永昌-民權,2023-03-27,9312
4562,穎漢,10,0,10,華南永昌-民權,2023-03-27,9312
6164,華興,10,0,10,華南永昌-民權,2023-03-27,9312
1519,華城,9,0,9,華南永昌-民權,2023-03-27,9312
2883B,凱基金乙特,9,0,9,華南永昌-民權,2023-03-27,9312
2317,鴻海,74,66,8,華南永昌-民權,2023-03-27,9312
00687B,國泰20年美債,8,0,8,華南永昌-民權,2023-03-27,9312
6180,橘子,8,0,8,華南永昌-民權,2023-03-27,9312
6244,茂迪,30,22,8,華南永昌-民權,2023-03-27,9312
6770,力積電,9,1,8,華南永昌-民權,2023-03-27,9312
00712,復華富時不動產,12,5,7,華南永昌-民權,2023-03-27,9312
5225,東科-KY,8,1,7,華南永昌-民權,2023-03-27,9312
5521,工信,6,0,6,華南永昌-民權,2023-03-27,9312
1432,大魯閣,6,0,6,華南永昌-民權,2023-03-27,9312
2312,金寶,6,0,6,華南永昌-民權,2023-03-27,9312
5351,鈺創,7,1,6,華南永昌-民權,2023-03-27,9312
6465,威潤,6,0,6,華南永昌-民權,2023-03-27,9312
6443,元晶,13,8,5,華南永昌-民權,2023-03-27,9312
3413,京鼎,5,0,5,華南永昌-民權,2023-03-27,9312
1451,年興,5,0,5,華南永昌-民權,2023-03-27,9312
1795,美時,5,0,5,華南永昌-民權,2023-03-27,9312
2302,麗正,5,0,5,華南永昌-民權,2023-03-27,9312
2331,精英,5,0,5,華南永昌-民權,2023-03-27,9312
2867,三商壽,5,0,5,華南永昌-民權,2023-03-27,9312
3056,富華新,5,0,5,華南永昌-民權,2023-03-27,9312
3704,合勤控,5,0,5,華南永昌-民權,2023-03-27,9312
5284,jpp-KY,7,2,5,華南永昌-民權,2023-03-27,9312
6834,天二科技,5,0,5,華南永昌-民權,2023-03-27,9312
2356,英業達,5,0,5,華南永昌-民權,2023-03-27,9312
2201,裕隆,10,6,4,華南永昌-民權,2023-03-27,9312
3035,智原,9,5,4,華南永昌-民權,2023-03-27,9312
1471,首利,4,0,4,華南永昌-民權,2023-03-27,9312
3047,訊舟,62,2,60,華南永昌-民權,2023-03-28,9312
8996,高力,56,0,56,華南永昌-民權,2023-03-28,9312
1609,大亞,55,11,44,華南永昌-民權,2023-03-28,9312
1605,華新,55,21,34,華南永昌-民權,2023-03-28,9312
6226,光鼎,31,0,31,華南永昌-民權,2023-03-28,9312
1109,信大,25,0,25,華南永昌-民權,2023-03-28,9312
00720B,元大投資級公司債,25,0,25,華南永昌-民權,2023-03-28,9312
2317,鴻海,24,1,23,華南永昌-民權,2023-03-28,9312
00687B,國泰20年美債,23,1,22,華南永昌-民權,2023-03-28,9312
2303,聯電,24,2,22,華南永昌-民權,2023-03-28,9312
8112,至上,22,0,22,華南永昌-民權,2023-03-28,9312
1702,南僑,20,0,20,華南永昌-民權,2023-03-28,9312
3710,連展投控,20,0,20,華南永昌-民權,2023-03-28,9312
2478,大毅,18,0,18,華南永昌-民權,2023-03-28,9312
00878,國泰永續高股息,17,0,17,華南永昌-民權,2023-03-28,9312
1410,南染,15,0,15,華南永昌-民權,2023-03-28,9312
2027,大成鋼,13,0,13,華南永昌-民權,2023-03-28,9312
2460,建通,13,0,13,華南永昌-民權,2023-03-28,9312
00679B,元大美債20年,12,0,12,華南永昌-民權,2023-03-28,9312
00751B,元大AAA至A公司債,11,0,11,華南永昌-民權,2023-03-28,9312
1519,華城,11,0,11,華南永昌-民權,2023-03-28,9312
3052,夆典,10,0,10,華南永昌-民權,2023-03-28,9312
4113,聯上,10,0,10,華南永昌-民權,2023-03-28,9312
6266,泰詠,10,0,10,華南永昌-民權,2023-03-28,9312
6570,維田,10,0,10,華南永昌-民權,2023-03-28,9312
6589,台康生技,11,2,9,華南永昌-民權,2023-03-28,9312
2887,台新金,10,2,8,華南永昌-民權,2023-03-28,9312
1471,首利,8,0,8,華南永昌-民權,2023-03-28,9312
5483,中美晶,8,0,8,華南永昌-民權,2023-03-28,9312
3037,欣興,12,4,8,華南永昌-民權,2023-03-28,9312
2312,金寶,10,3,7,華南永昌-民權,2023-03-28,9312
6770,力積電,7,0,7,華南永昌-民權,2023-03-28,9312
3035,智原,9,3,6,華南永昌-民權,2023-03-28,9312
2449,京元電子,6,0,6,華南永昌-民權,2023-03-28,9312
2605,新興,8,2,6,華南永昌-民權,2023-03-28,9312
3707,漢磊,7,1,6,華南永昌-民權,2023-03-28,9312
6122,擎邦,6,0,6,華南永昌-民權,2023-03-28,9312
8383,千附,6,0,6,華南永昌-民權,2023-03-28,9312
2208,台船,6,0,6,華南永昌-民權,2023-03-28,9312
00772B,中信高評級公司債,5,0,5,華南永昌-民權,2023-03-28,9312
1709,和益,5,0,5,華南永昌-民權,2023-03-28,9312
1760,寶齡富錦,7,2,5,華南永昌-民權,2023-03-28,9312
1817,凱撒衛,5,0,5,華南永昌-民權,2023-03-28,9312
2330,台積電,5,0,5,華南永昌-民權,2023-03-28,9312
2402,毅嘉,7,2,5,華南永昌-民權,2023-03-28,9312
2427,三商電,11,6,5,華南永昌-民權,2023-03-28,9312
2634,漢翔,9,4,5,華南永昌-民權,2023-03-28,9312
3413,京鼎,5,0,5,華南永昌-民權,2023-03-28,9312
3682,亞太電,5,0,5,華南永昌-民權,2023-03-28,9312
6124,業強,5,0,5,華南永昌-民權,2023-03-28,9312
2303,聯電,59,2,57,華南永昌-民權,2023-03-29,9312
00632R,元大台灣50反1,40,1,39,華南永昌-民權,2023-03-29,9312
2380,虹光,30,0,30,華南永昌-民權,2023-03-29,9312
8069,元太,31,1,30,華南永昌-民權,2023-03-29,9312
8046,南電,25,5,20,華南永昌-民權,2023-03-29,9312
6226,光鼎,20,0,20,華南永昌-民權,2023-03-29,9312
2371,大同,20,0,20,華南永昌-民權,2023-03-29,9312
4113,聯上,20,0,20,華南永昌-民權,2023-03-29,9312
2342,茂矽,21,4,17,華南永昌-民權,2023-03-29,9312
2331,精英,17,1,16,華南永昌-民權,2023-03-29,9312
1605,華新,12,1,11,華南永昌-民權,2023-03-29,9312
2312,金寶,11,0,11,華南永昌-民權,2023-03-29,9312
1799,易威,10,0,10,華南永昌-民權,2023-03-29,9312
4532,瑞智,10,0,10,華南永昌-民權,2023-03-29,9312
2329,華泰,9,0,9,華南永昌-民權,2023-03-29,9312
8088,品安,9,0,9,華南永昌-民權,2023-03-29,9312
2426,鼎元,18,10,8,華南永昌-民權,2023-03-29,9312
2455,全新,8,1,7,華南永昌-民權,2023-03-29,9312
2618,長榮航,9,2,7,華南永昌-民權,2023-03-29,9312
5258,虹堡,6,0,6,華南永昌-民權,2023-03-29,9312
6220,岳豐,6,0,6,華南永昌-民權,2023-03-29,9312
1712,興農,5,0,5,華南永昌-民權,2023-03-29,9312
3019,亞光,5,0,5,華南永昌-民權,2023-03-29,9312
3236,千如,11,6,5,華南永昌-民權,2023-03-29,9312
3413,京鼎,5,0,5,華南永昌-民權,2023-03-29,9312
3593,力銘,5,0,5,華南永昌-民權,2023-03-29,9312
3682,亞太電,10,5,5,華南永昌-民權,2023-03-29,9312
6152,百一,5,0,5,華南永昌-民權,2023-03-29,9312
6204,艾華,5,0,5,華南永昌-民權,2023-03-29,9312
6449,鈺邦,5,0,5,華南永昌-民權,2023-03-29,9312
8176,智捷,5,0,5,華南永昌-民權,2023-03-29,9312
8222,寶一,6,1,5,華南永昌-民權,2023-03-29,9312
3035,智原,16,11,5,華南永昌-民權,2023-03-29,9312
8033,雷虎,5,1,4,華南永昌-民權,2023-03-29,9312
3443,創意,4,0,4,華南永昌-民權,2023-03-29,9312
2027,大成鋼,4,0,4,華南永昌-民權,2023-03-29,9312
2204,中華,4,0,4,華南永昌-民權,2023-03-29,9312
2348A,海悅甲特,4,0,4,華南永昌-民權,2023-03-29,9312
2355,敬鵬,4,0,4,華南永昌-民權,2023-03-29,9312
3081,聯亞,9,5,4,華南永昌-民權,2023-03-29,9312
6242,立康,4,0,4,華南永昌-民權,2023-03-29,9312
8289,泰藝,5,1,4,華南永昌-民權,2023-03-29,9312
2890,永豐金,4,0,4,華南永昌-民權,2023-03-29,9312
00679B,元大美債20年,3,0,3,華南永昌-民權,2023-03-29,9312
00878,國泰永續高股息,4,1,3,華南永昌-民權,2023-03-29,9312
6223,旺矽,8,5,3,華南永昌-民權,2023-03-29,9312
8171,天宇,3,0,3,華南永昌-民權,2023-03-29,9312
1101,台泥,3,0,3,華南永昌-民權,2023-03-29,9312
1513,中興電,3,0,3,華南永昌-民權,2023-03-29,9312
2641,正德,3,0,3,華南永昌-民權,2023-03-29,9312
00673R,期元大S＆P原油反1,91,0,91,華南永昌-民權,2023-03-30,9312
00632R,元大台灣50反1,40,0,40,華南永昌-民權,2023-03-30,9312
4927,泰鼎-KY,36,6,30,華南永昌-民權,2023-03-30,9312
1799,易威,25,0,25,華南永昌-民權,2023-03-30,9312
2027,大成鋼,20,0,20,華南永昌-民權,2023-03-30,9312
2426,鼎元,12,0,12,華南永昌-民權,2023-03-30,9312
2108,南帝,12,1,11,華南永昌-民權,2023-03-30,9312
3624,光頡,10,0,10,華南永昌-民權,2023-03-30,9312
2342,茂矽,10,0,10,華南永昌-民權,2023-03-30,9312
1609,大亞,12,3,9,華南永昌-民權,2023-03-30,9312
6651,全宇昕,9,0,9,華南永昌-民權,2023-03-30,9312
8069,元太,10,1,9,華南永昌-民權,2023-03-30,9312
6125,廣運,18,10,8,華南永昌-民權,2023-03-30,9312
6443,元晶,10,2,8,華南永昌-民權,2023-03-30,9312
1752,南光,7,0,7,華南永昌-民權,2023-03-30,9312
2331,精英,8,1,7,華南永昌-民權,2023-03-30,9312
00882,中信中國高股息,6,0,6,華南永昌-民權,2023-03-30,9312
2453,凌群,6,1,5,華南永昌-民權,2023-03-30,9312
3162,精確,5,0,5,華南永昌-民權,2023-03-30,9312
3322,建舜電,10,5,5,華南永昌-民權,2023-03-30,9312
3419,譁裕,5,0,5,華南永昌-民權,2023-03-30,9312
3441,聯一光,5,0,5,華南永昌-民權,2023-03-30,9312
6152,百一,5,0,5,華南永昌-民權,2023-03-30,9312
8111,立��,5,0,5,華南永昌-民權,2023-03-30,9312
2344,華邦電,11,7,4,華南永昌-民權,2023-03-30,9312
6233,旺玖,8,4,4,華南永昌-民權,2023-03-30,9312
1760,寶齡富錦,8,4,4,華南永昌-民權,2023-03-30,9312
3483,力致,9,5,4,華南永昌-民權,2023-03-30,9312
4164,承業醫,5,1,4,華南永昌-民權,2023-03-30,9312
2330,台積電,5,1,4,華南永昌-民權,2023-03-30,9312
2609,陽明,3,0,3,華南永昌-民權,2023-03-30,9312
6472,保瑞,3,0,3,華南永昌-民權,2023-03-30,9312
2880,華南金,3,0,3,華南永昌-民權,2023-03-30,9312
2890,永豐金,9,6,3,華南永昌-民權,2023-03-30,9312
00679B,元大美債20年,3,0,3,華南永昌-民權,2023-03-30,9312
2460,建通,3,0,3,華南永昌-民權,2023-03-30,9312
2498,宏達電,3,0,3,華南永昌-民權,2023-03-30,9312
2891,中信金,3,0,3,華南永昌-民權,2023-03-30,9312
3518,柏騰,3,0,3,華南永昌-民權,2023-03-30,9312
3704,合勤控,3,0,3,華南永昌-民權,2023-03-30,9312
5258,虹堡,3,0,3,華南永昌-民權,2023-03-30,9312
5475,德宏,3,0,3,華南永昌-民權,2023-03-30,9312
6175,立敦,3,0,3,華南永昌-民權,2023-03-30,9312
6589,台康生技,4,1,3,華南永昌-民權,2023-03-30,9312
8222,寶一,3,0,3,華南永昌-民權,2023-03-30,9312
8358,金居,3,0,3,華南永昌-民權,2023-03-30,9312
1603,華電,2,0,2,華南永昌-民權,2023-03-30,9312
1513,中興電,2,0,2,華南永昌-民權,2023-03-30,9312
2002,中鋼,2,0,2,華南永昌-民權,2023-03-30,9312
1708,東鹼,2,0,2,華南永昌-民權,2023-03-30,9312
00632R,元大台灣50反1,314,0,314,華南永昌-民權,2023-03-31,9312
00650L,復華香港正2,55,0,55,華南永昌-民權,2023-03-31,9312
1605,華新,50,17,33,華南永昌-民權,2023-03-31,9312
1702,南僑,20,0,20,華南永昌-民權,2023-03-31,9312
2010,春源,20,0,20,華南永昌-民權,2023-03-31,9312
3682,亞太電,20,0,20,華南永昌-民權,2023-03-31,9312
2330,台積電,20,1,19,華南永昌-民權,2023-03-31,9312
4927,泰鼎-KY,20,2,18,華南永昌-民權,2023-03-31,9312
8936,國統,13,0,13,華南永昌-民權,2023-03-31,9312
6125,廣運,12,1,11,華南永昌-民權,2023-03-31,9312
00712,復華富時不動產,11,0,11,華南永昌-民權,2023-03-31,9312
8069,元太,11,0,11,華南永昌-民權,2023-03-31,9312
1760,寶齡富錦,11,4,7,華南永昌-民權,2023-03-31,9312
2722,夏都,7,0,7,華南永昌-民權,2023-03-31,9312
3711,日月光投控,7,0,7,華南永昌-民權,2023-03-31,9312
3231,緯創,9,2,7,華南永昌-民權,2023-03-31,9312
1795,美時,6,0,6,華南永昌-民權,2023-03-31,9312
3071,協禧,6,0,6,華南永昌-民權,2023-03-31,9312
4915,致伸,6,0,6,華南永昌-民權,2023-03-31,9312
2302,麗正,5,0,5,華南永昌-民權,2023-03-31,9312
2426,鼎元,5,0,5,華南永昌-民權,2023-03-31,9312
2427,三商電,5,0,5,華南永昌-民權,2023-03-31,9312
2882,國泰金,6,1,5,華南永昌-民權,2023-03-31,9312
3481,群創,6,1,5,華南永昌-民權,2023-03-31,9312
4950,牧東,5,0,5,華南永昌-民權,2023-03-31,9312
6233,旺玖,5,0,5,華南永昌-民權,2023-03-31,9312
2609,陽明,6,1,5,華南永昌-民權,2023-03-31,9312
1504,東元,9,5,4,華南永昌-民權,2023-03-31,9312
3017,奇鋐,4,0,4,華南永昌-民權,2023-03-31,9312
4979,華星光,5,1,4,華南永昌-民權,2023-03-31,9312
2634,漢翔,6,3,3,華南永昌-民權,2023-03-31,9312
6285,啟��,4,1,3,華南永昌-民權,2023-03-31,9312
1710,東聯,3,0,3,華南永昌-民權,2023-03-31,9312
2449,京元電子,4,1,3,華南永昌-民權,2023-03-31,9312
2457,飛宏,5,2,3,華南永昌-民權,2023-03-31,9312
2472,立隆電,3,0,3,華南永昌-民權,2023-03-31,9312
3035,智原,5,2,3,華南永昌-民權,2023-03-31,9312
3162,精確,3,0,3,華南永昌-民權,2023-03-31,9312
3483,力致,5,2,3,華南永昌-民權,2023-03-31,9312
6122,擎邦,5,2,3,華南永昌-民權,2023-03-31,9312
6213,聯茂,3,0,3,華南永昌-民權,2023-03-31,9312
6576,逸達,3,0,3,華南永昌-民權,2023-03-31,9312
8182,加高,3,0,3,華南永昌-民權,2023-03-31,9312
9907,統一實,3,0,3,華南永昌-民權,2023-03-31,9312
4743,合一,3,0,3,華南永昌-民權,2023-03-31,9312
3706,神達,3,0,3,華南永昌-民權,2023-03-31,9312
1513,中興電,3,1,2,華南永昌-民權,2023-03-31,9312
3540,曜越,3,1,2,華南永昌-民權,2023-03-31,9312
8050,廣積,2,0,2,華南永昌-民權,2023-03-31,9312
1467,南緯,2,0,2,華南永昌-民權,2023-03-31,9312
2317,鴻海,33,6,27,華南永昌-民權,2023-04-06,9312
2344,華邦電,26,1,25,華南永昌-民權,2023-04-06,9312
5426,振發,25,0,25,華南永昌-民權,2023-04-06,9312
00673R,期元大S＆P原油反1,12,0,12,華南永昌-民權,2023-04-06,9312
2618,長榮航,12,0,12,華南永昌-民權,2023-04-06,9312
00713,元大台灣高息低波,11,0,11,華南永昌-民權,2023-04-06,9312
2867,三商壽,11,0,11,華南永昌-民權,2023-04-06,9312
3202,樺晟,11,0,11,華南永昌-民權,2023-04-06,9312
1817,凱撒衛,10,0,10,華南永昌-民權,2023-04-06,9312
2458,義隆,10,0,10,華南永昌-民權,2023-04-06,9312
8926,台汽電,10,0,10,華南永昌-民權,2023-04-06,9312
00679B,元大美債20年,10,1,9,華南永昌-民權,2023-04-06,9312
1605,華新,17,8,9,華南永昌-民權,2023-04-06,9312
2002,中鋼,19,10,9,華南永昌-民權,2023-04-06,9312
00712,復華富時不動產,9,0,9,華南永昌-民權,2023-04-06,9312
4130,健亞,9,0,9,華南永昌-民權,2023-04-06,9312
6182,合晶,9,0,9,華南永昌-民權,2023-04-06,9312
0056,元大高股息,11,4,7,華南永昌-民權,2023-04-06,9312
6770,力積電,7,0,7,華南永昌-民權,2023-04-06,9312
2891,中信金,6,0,6,華南永昌-民權,2023-04-06,9312
00916,國泰全球品牌50,6,0,6,華南永昌-民權,2023-04-06,9312
3027,盛達,9,3,6,華南永昌-民權,2023-04-06,9312
3680,家登,6,0,6,華南永昌-民權,2023-04-06,9312
5328,華容,6,0,6,華南永昌-民權,2023-04-06,9312
6180,橘子,6,0,6,華南永昌-民權,2023-04-06,9312
1802,台玻,8,3,5,華南永昌-民權,2023-04-06,9312
00882,中信中國高股息,5,0,5,華南永昌-民權,2023-04-06,9312
00922,國泰台灣領袖50,5,0,5,華南永昌-民權,2023-04-06,9312
2108,南帝,5,0,5,華南永昌-民權,2023-04-06,9312
2338,光罩,5,0,5,華南永昌-民權,2023-04-06,9312
2915,潤泰全,5,0,5,華南永昌-民權,2023-04-06,9312
3607,谷崧,5,0,5,華南永昌-民權,2023-04-06,9312
3715,定穎投控,5,0,5,華南永昌-民權,2023-04-06,9312
5353,台林,5,0,5,華南永昌-民權,2023-04-06,9312
6161,捷波,5,0,5,華南永昌-民權,2023-04-06,9312
6282,康舒,9,4,5,華南永昌-民權,2023-04-06,9312
6548,長科*,6,1,5,華南永昌-民權,2023-04-06,9312
8088,品安,5,0,5,華南永昌-民權,2023-04-06,9312
2889,國票金,5,0,5,華南永昌-民權,2023-04-06,9312
1308,亞聚,4,0,4,華南永昌-民權,2023-04-06,9312
2495,普安,5,1,4,華南永昌-民權,2023-04-06,9312
2342,茂矽,6,2,4,華南永昌-民權,2023-04-06,9312
3013,晟銘電,4,0,4,華南永昌-民權,2023-04-06,9312
3037,欣興,8,4,4,華南永昌-民權,2023-04-06,9312
3703,欣陸,4,0,4,華南永昌-民權,2023-04-06,9312
1560,中砂,3,0,3,華南永昌-民權,2023-04-06,9312
2347,聯強,3,0,3,華南永昌-民權,2023-04-06,9312
2460,建通,5,2,3,華南永昌-民權,2023-04-06,9312
3324,雙鴻,9,6,3,華南永昌-民權,2023-04-06,9312
6163,華電網,3,0,3,華南永昌-民權,2023-04-06,9312
2886,兆豐金,50,0,50,華南永昌-民權,2023-04-07,9312
6226,光鼎,21,0,21,華南永昌-民權,2023-04-07,9312
3027,盛達,17,1,16,華南永昌-民權,2023-04-07,9312
3038,全台,15,0,15,華南永昌-民權,2023-04-07,9312
2609,陽明,20,9,11,華南永昌-民權,2023-04-07,9312
00664R,國泰臺灣加權反1,10,0,10,華南永昌-民權,2023-04-07,9312
1817,凱撒衛,10,0,10,華南永昌-民權,2023-04-07,9312
6235,華孚,12,2,10,華南永昌-民權,2023-04-07,9312
8383,千附,15,5,10,華南永昌-民權,2023-04-07,9312
00637L,元大滬深300正2,10,2,8,華南永昌-民權,2023-04-07,9312
00885,富邦越南,8,0,8,華南永昌-民權,2023-04-07,9312
6770,力積電,11,4,7,華南永昌-民權,2023-04-07,9312
2208,台船,8,1,7,華南永昌-民權,2023-04-07,9312
2364,倫飛,7,0,7,華南永昌-民權,2023-04-07,9312
2484,希華,6,0,6,華南永昌-民權,2023-04-07,9312
4979,華星光,10,4,6,華南永昌-民權,2023-04-07,9312
1513,中興電,5,0,5,華南永昌-民權,2023-04-07,9312
1504,東元,8,3,5,華南永昌-民權,2023-04-07,9312
1308,亞聚,5,0,5,華南永昌-民權,2023-04-07,9312
1717,長興,7,2,5,華南永昌-民權,2023-04-07,9312
1809,中釉,5,0,5,華南永昌-民權,2023-04-07,9312
2388,威盛,5,0,5,華南永昌-民權,2023-04-07,9312
2486,一詮,5,0,5,華南永昌-民權,2023-04-07,9312
2618,長榮航,5,0,5,華南永昌-民權,2023-04-07,9312
6197,佳必琪,5,0,5,華南永昌-民權,2023-04-07,9312
6603,富強鑫,5,0,5,華南永昌-民權,2023-04-07,9312
6829,千附精密,5,0,5,華南永昌-民權,2023-04-07,9312
2867,三商壽,14,10,4,華南永昌-民權,2023-04-07,9312
00919,群益台灣精選高息,5,1,4,華南永昌-民權,2023-04-07,9312
4130,健亞,4,0,4,華南永昌-民權,2023-04-07,9312
4916,事欣科,5,1,4,華南永昌-民權,2023-04-07,9312
8227,巨有科技,5,1,4,華南永昌-民權,2023-04-07,9312
1314,中石化,3,0,3,華南永昌-民權,2023-04-07,9312
1605,華新,16,13,3,華南永昌-民權,2023-04-07,9312
2352,佳世達,5,2,3,華南永昌-民權,2023-04-07,9312
2369,菱生,3,0,3,華南永昌-民權,2023-04-07,9312
2382,廣達,4,1,3,華南永昌-民權,2023-04-07,9312
3338,泰碩,3,0,3,華南永昌-民權,2023-04-07,9312
4167,松瑞藥,3,0,3,華南永昌-民權,2023-04-07,9312
5222,全訊,48,45,3,華南永昌-民權,2023-04-07,9312
5309,系統電,3,0,3,華南永昌-民權,2023-04-07,9312
8936,國統,3,0,3,華南永昌-民權,2023-04-07,9312
9955,佳龍,3,0,3,華南永昌-民權,2023-04-07,9312
4977,眾達-KY,7,4,3,華南永昌-民權,2023-04-07,9312
00679B,元大美債20年,3,0,3,華南永昌-民權,2023-04-07,9312
6104,創惟,3,0,3,華南永昌-民權,2023-04-07,9312
2498,宏達電,3,1,2,華南永昌-民權,2023-04-07,9312
6753,龍德造船,3,1,2,華南永昌-民權,2023-04-07,9312
3006,晶豪科,7,5,2,華南永昌-民權,2023-04-07,9312
1560,中砂,3,1,2,華南永昌-民權,2023-04-07,9312
3432,台端,30,0,30,華南永昌-民權,2023-04-10,9312
2027,大成鋼,21,0,21,華南永昌-民權,2023-04-10,9312
2330,台積電,25,7,18,華南永昌-民權,2023-04-10,9312
00687B,國泰20年美債,22,6,16,華南永昌-民權,2023-04-10,9312
3441,聯一光,29,16,13,華南永昌-民權,2023-04-10,9312
1584,精剛,13,2,11,華南永昌-民權,2023-04-10,9312
2425,承啟,10,0,10,華南永昌-民權,2023-04-10,9312
2535,達欣工,10,0,10,華南永昌-民權,2023-04-10,9312
6147,頎邦,10,0,10,華南永昌-民權,2023-04-10,9312
2204,中華,10,1,9,華南永昌-民權,2023-04-10,9312
00882,中信中國高股息,10,1,9,華南永昌-民權,2023-04-10,9312
5258,虹堡,9,0,9,華南永昌-民權,2023-04-10,9312
00679B,元大美債20年,13,5,8,華南永昌-民權,2023-04-10,9312
6285,啟��,8,0,8,華南永昌-民權,2023-04-10,9312
1717,長興,100,92,8,華南永昌-民權,2023-04-10,9312
6589,台康生技,9,1,8,華南永昌-民權,2023-04-10,9312
6770,力積電,8,0,8,華南永昌-民權,2023-04-10,9312
2313,華通,9,1,8,華南永昌-民權,2023-04-10,9312
2344,華邦電,48,41,7,華南永昌-民權,2023-04-10,9312
1609,大亞,7,0,7,華南永昌-民權,2023-04-10,9312
1513,中興電,23,17,6,華南永昌-民權,2023-04-10,9312
6461,益得,6,0,6,華南永昌-民權,2023-04-10,9312
8069,元太,16,11,5,華南永昌-民權,2023-04-10,9312
6274,台燿,6,1,5,華南永昌-民權,2023-04-10,9312
1319,東陽,5,0,5,華南永昌-民權,2023-04-10,9312
1795,美時,6,1,5,華南永昌-民權,2023-04-10,9312
2442,新美齊,6,1,5,華南永昌-民權,2023-04-10,9312
3694,海華,5,0,5,華南永昌-民權,2023-04-10,9312
5465,富驊,5,0,5,華南永昌-民權,2023-04-10,9312
2002,中鋼,4,0,4,華南永昌-民權,2023-04-10,9312
00751B,元大AAA至A公司債,4,0,4,華南永昌-民權,2023-04-10,9312
3005,神基,4,0,4,華南永昌-民權,2023-04-10,9312
3062,建漢,5,1,4,華南永昌-民權,2023-04-10,9312
3202,樺晟,4,0,4,華南永昌-民權,2023-04-10,9312
2603,長榮,8,5,3,華南永昌-民權,2023-04-10,9312
00632R,元大台灣50反1,3,0,3,華南永昌-民權,2023-04-10,9312
00893,國泰智能電動車,3,0,3,華南永昌-民權,2023-04-10,9312
1527,鑽全,3,0,3,華南永昌-民權,2023-04-10,9312
2478,大毅,3,0,3,華南永昌-民權,2023-04-10,9312
3050,鈺德,3,0,3,華南永昌-民權,2023-04-10,9312
3447,展達,3,0,3,華南永昌-民權,2023-04-10,9312
4968,立積,23,20,3,華南永昌-民權,2023-04-10,9312
5315,光聯,3,0,3,華南永昌-民權,2023-04-10,9312
6270,倍微,3,0,3,華南永昌-民權,2023-04-10,9312
6550,北極星藥業-KY,6,3,3,華南永昌-民權,2023-04-10,9312
6672,騰輝電子-KY,3,0,3,華南永昌-民權,2023-04-10,9312
6751,智聯服務,3,0,3,華南永昌-民權,2023-04-10,9312
2888,新光金,3,0,3,華南永昌-民權,2023-04-10,9312
2884,玉山金,13,10,3,華南永昌-民權,2023-04-10,9312
2615,萬海,2,0,2,華南永昌-民權,2023-04-10,9312
00632R,元大台灣50反1,301,9,292,華南永昌-民權,2023-04-11,9312
00679B,元大美債20年,34,6,28,華南永昌-民權,2023-04-11,9312
2443,昶虹,20,0,20,華南永昌-民權,2023-04-11,9312
3682,亞太電,20,2,18,華南永昌-民權,2023-04-11,9312
1504,東元,29,12,17,華南永昌-民權,2023-04-11,9312
1584,精剛,17,1,16,華南永昌-民權,2023-04-11,9312
3704,合勤控,11,0,11,華南永昌-民權,2023-04-11,9312
9958,世紀鋼,11,0,11,華南永昌-民權,2023-04-11,9312
1589,永冠-KY,10,0,10,華南永昌-民權,2023-04-11,9312
3576,聯合再生,10,0,10,華南永昌-民權,2023-04-11,9312
00888,永豐台灣ESG,10,0,10,華南永昌-民權,2023-04-11,9312
6834,天二科技,10,0,10,華南永昌-民權,2023-04-11,9312
6282,康舒,11,2,9,華南永昌-民權,2023-04-11,9312
2208,台船,25,17,8,華南永昌-民權,2023-04-11,9312
2302,麗正,11,3,8,華南永昌-民權,2023-04-11,9312
6245,立端,7,0,7,華南永昌-民權,2023-04-11,9312
1314,中石化,10,3,7,華南永昌-民權,2023-04-11,9312
6266,泰詠,7,1,6,華南永昌-民權,2023-04-11,9312
1609,大亞,8,2,6,華南永昌-民權,2023-04-11,9312
4915,致伸,6,0,6,華南永昌-民權,2023-04-11,9312
5227,立凱-KY,6,0,6,華南永昌-民權,2023-04-11,9312
0056,元大高股息,16,11,5,華南永昌-民權,2023-04-11,9312
2303,聯電,5,0,5,華南永昌-民權,2023-04-11,9312
6233,旺玖,5,0,5,華南永昌-民權,2023-04-11,9312
00713,元大台灣高息低波,5,0,5,華南永昌-民權,2023-04-11,9312
2419,仲琦,6,1,5,華南永昌-民權,2023-04-11,9312
2478,大毅,5,0,5,華南永昌-民權,2023-04-11,9312
2515,中工,10,5,5,華南永昌-民權,2023-04-11,9312
2609,陽明,9,4,5,華南永昌-民權,2023-04-11,9312
3236,千如,6,1,5,華南永昌-民權,2023-04-11,9312
3430,奇鈦科,5,0,5,華南永昌-民權,2023-04-11,9312
6216,居易,5,0,5,華南永昌-民權,2023-04-11,9312
6265,方土昶,5,0,5,華南永昌-民權,2023-04-11,9312
8033,雷虎,4,0,4,華南永昌-民權,2023-04-11,9312
2457,飛宏,7,3,4,華南永昌-民權,2023-04-11,9312
2618,長榮航,5,1,4,華南永昌-民權,2023-04-11,9312
2883,凱基金,8,4,4,華南永昌-民權,2023-04-11,9312
4916,事欣科,7,3,4,華南永昌-民權,2023-04-11,9312
6139,亞翔,4,0,4,華南永昌-民權,2023-04-11,9312
6285,啟��,4,0,4,華南永昌-民權,2023-04-11,9312
9933,中鼎,4,0,4,華南永昌-民權,2023-04-11,9312
6753,龍德造船,4,0,4,華南永昌-民權,2023-04-11,9312
6194,育富,5,1,4,華南永昌-民權,2023-04-11,9312
4541,晟田,3,0,3,華南永昌-民權,2023-04-11,9312
6182,合晶,3,0,3,華南永昌-民權,2023-04-11,9312
6698,旭暉應材,3,0,3,華南永昌-民權,2023-04-11,9312
2312,金寶,3,0,3,華南永昌-民權,2023-04-11,9312
3013,晟銘電,3,0,3,華南永昌-民權,2023-04-11,9312
3323,加百裕,3,0,3,華南永昌-民權,2023-04-11,9312
3380,明泰,3,0,3,華南永昌-民權,2023-04-11,9312
1609,大亞,111,50,61,華南永昌-民權,2023-04-12,9312
4114,健喬,42,2,40,華南永昌-民權,2023-04-12,9312
2614,東森,30,0,30,華南永昌-民權,2023-04-12,9312
9962,有益,26,0,26,華南永昌-民權,2023-04-12,9312
2883,凱基金,24,0,24,華南永昌-民權,2023-04-12,9312
5328,華容,22,0,22,華南永昌-民權,2023-04-12,9312
2317,鴻海,20,0,20,華南永昌-民權,2023-04-12,9312
2027,大成鋼,19,0,19,華南永昌-民權,2023-04-12,9312
4139,馬光-KY,16,0,16,華南永昌-民權,2023-04-12,9312
6449,鈺邦,15,0,15,華南永昌-民權,2023-04-12,9312
2313,華通,13,0,13,華南永昌-民權,2023-04-12,9312
00679B,元大美債20年,13,0,13,華南永昌-民權,2023-04-12,9312
3202,樺晟,12,0,12,華南永昌-民權,2023-04-12,9312
1589,永冠-KY,10,0,10,華南永昌-民權,2023-04-12,9312
2535,達欣工,11,1,10,華南永昌-民權,2023-04-12,9312
3680,家登,11,1,10,華南永昌-民權,2023-04-12,9312
6163,華電網,11,1,10,華南永昌-民權,2023-04-12,9312
6265,方土昶,10,0,10,華南永昌-民權,2023-04-12,9312
2330,台積電,20,11,9,華南永昌-民權,2023-04-12,9312
3081,聯亞,11,2,9,華南永昌-民權,2023-04-12,9312
4905,台聯電,9,0,9,華南永昌-民權,2023-04-12,9312
8033,雷虎,10,1,9,華南永昌-民權,2023-04-12,9312
8069,元太,8,0,8,華南永昌-民權,2023-04-12,9312
00687B,國泰20年美債,8,0,8,華南永昌-民權,2023-04-12,9312
1611,中電,8,0,8,華南永昌-民權,2023-04-12,9312
2332,友訊,9,1,8,華南永昌-民權,2023-04-12,9312
2369,菱生,8,0,8,華南永昌-民權,2023-04-12,9312
6205,詮欣,8,0,8,華南永昌-民權,2023-04-12,9312
1584,精剛,65,58,7,華南永昌-民權,2023-04-12,9312
2344,華邦電,47,40,7,華南永昌-民權,2023-04-12,9312
2367,燿華,12,5,7,華南永昌-民權,2023-04-12,9312
3005,神基,8,1,7,華南永昌-民權,2023-04-12,9312
3037,欣興,7,1,6,華南永昌-民權,2023-04-12,9312
1616,億泰,6,0,6,華南永昌-民權,2023-04-12,9312
2427,三商電,7,1,6,華南永昌-民權,2023-04-12,9312
2615,萬海,6,0,6,華南永昌-民權,2023-04-12,9312
2888,新光金,6,0,6,華南永昌-民權,2023-04-12,9312
4915,致伸,6,0,6,華南永昌-民權,2023-04-12,9312
1438,三地開發,9,4,5,華南永昌-民權,2023-04-12,9312
2002,中鋼,5,0,5,華南永昌-民權,2023-04-12,9312
2206,三陽工業,5,0,5,華南永昌-民權,2023-04-12,9312
2457,飛宏,6,1,5,華南永昌-民權,2023-04-12,9312
2483,百容,5,0,5,華南永昌-民權,2023-04-12,9312
3338,泰碩,5,0,5,華南永昌-民權,2023-04-12,9312
5426,振發,5,0,5,華南永昌-民權,2023-04-12,9312
6244,茂迪,30,25,5,華南永昌-民權,2023-04-12,9312
6509,聚和,5,0,5,華南永昌-民權,2023-04-12,9312
8049,晶采,5,0,5,華南永昌-民權,2023-04-12,9312
8222,寶一,11,6,5,華南永昌-民權,2023-04-12,9312
6285,啟��,4,0,4,華南永昌-民權,2023-04-12,9312
2358,廷鑫,40,0,40,華南永昌-民權,2023-04-13,9312
2457,飛宏,44,7,37,華南永昌-民權,2023-04-13,9312
2344,華邦電,57,23,34,華南永昌-民權,2023-04-13,9312
4979,華星光,44,12,32,華南永昌-民權,2023-04-13,9312
6834,天二科技,26,0,26,華南永昌-民權,2023-04-13,9312
8046,南電,24,0,24,華南永昌-民權,2023-04-13,9312
5465,富驊,22,2,20,華南永昌-民權,2023-04-13,9312
2330,台積電,24,5,19,華南永昌-民權,2023-04-13,9312
3231,緯創,21,2,19,華南永昌-民權,2023-04-13,9312
00878,國泰永續高股息,17,0,17,華南永昌-民權,2023-04-13,9312
2453,凌群,15,0,15,華南永昌-民權,2023-04-13,9312
0056,元大高股息,36,21,15,華南永昌-民權,2023-04-13,9312
2027,大成鋼,14,1,13,華南永昌-民權,2023-04-13,9312
1609,大亞,43,31,12,華南永昌-民權,2023-04-13,9312
1504,東元,20,8,12,華南永昌-民權,2023-04-13,9312
2402,毅嘉,16,4,12,華南永昌-民權,2023-04-13,9312
5009,榮剛,28,16,12,華南永昌-民權,2023-04-13,9312
2614,東森,11,0,11,華南永昌-民權,2023-04-13,9312
6126,信音,11,0,11,華南永昌-民權,2023-04-13,9312
1605,華新,11,1,10,華南永昌-民權,2023-04-13,9312
1303,南亞,10,0,10,華南永昌-民權,2023-04-13,9312
00665L,富邦�琤肭磪囓�2,10,0,10,華南永昌-民權,2023-04-13,9312
00753L,中信中國50正2,10,0,10,華南永昌-民權,2023-04-13,9312
00701,國泰股利精選30,10,0,10,華南永昌-民權,2023-04-13,9312
00893,國泰智能電動車,10,0,10,華南永昌-民權,2023-04-13,9312
1417,嘉裕,10,0,10,華南永昌-民權,2023-04-13,9312
1785,光洋科,10,0,10,華南永昌-民權,2023-04-13,9312
2329,華泰,10,0,10,華南永昌-民權,2023-04-13,9312
3711,日月光投控,10,0,10,華南永昌-民權,2023-04-13,9312
9103,美德醫療-DR,10,0,10,華南永昌-民權,2023-04-13,9312
2883,凱基金,9,1,8,華南永昌-民權,2023-04-13,9312
6285,啟��,8,0,8,華南永昌-民權,2023-04-13,9312
1519,華城,15,7,8,華南永昌-民權,2023-04-13,9312
1707,葡萄王,8,0,8,華南永昌-民權,2023-04-13,9312
1810,和成,9,1,8,華南永昌-民權,2023-04-13,9312
3078,僑威,9,1,8,華南永昌-民權,2023-04-13,9312
6235,華孚,34,26,8,華南永昌-民權,2023-04-13,9312
00895,富邦未來車,7,0,7,華南永昌-民權,2023-04-13,9312
00712,復華富時不動產,7,0,7,華南永昌-民權,2023-04-13,9312
6242,立康,7,0,7,華南永昌-民權,2023-04-13,9312
6282,康舒,8,1,7,華南永昌-民權,2023-04-13,9312
3118,進階,6,0,6,華南永昌-民權,2023-04-13,9312
3499,環天科,7,1,6,華南永昌-民權,2023-04-13,9312
6148,驊宏資,8,2,6,華南永昌-民權,2023-04-13,9312
6179,亞通,6,0,6,華南永昌-民權,2023-04-13,9312
6290,良維,6,0,6,華南永昌-民權,2023-04-13,9312
00687B,國泰20年美債,6,0,6,華南永昌-民權,2023-04-13,9312
2399,映泰,5,0,5,華南永昌-民權,2023-04-13,9312
1611,中電,7,2,5,華南永昌-民權,2023-04-13,9312
3624,光頡,5,0,5,華南永昌-民權,2023-04-13,9312
00632R,元大台灣50反1,712,0,712,華南永昌-民權,2023-04-14,9312
2834,臺企銀,510,0,510,華南永昌-民權,2023-04-14,9312
2845,遠東銀,351,0,351,華南永昌-民權,2023-04-14,9312
1609,大亞,132,18,114,華南永昌-民權,2023-04-14,9312
00713,元大台灣高息低波,99,0,99,華南永昌-民權,2023-04-14,9312
2634,漢翔,113,53,60,華南永昌-民權,2023-04-14,9312
4747,強生,35,0,35,華南永昌-民權,2023-04-14,9312
4905,台聯電,25,0,25,華南永昌-民權,2023-04-14,9312
1513,中興電,41,17,24,華南永昌-民權,2023-04-14,9312
2208,台船,39,18,21,華南永昌-民權,2023-04-14,9312
3624,光頡,20,0,20,華南永昌-民權,2023-04-14,9312
6284,佳邦,18,0,18,華南永昌-民權,2023-04-14,9312
3441,聯一光,16,0,16,華南永昌-民權,2023-04-14,9312
2303,聯電,15,0,15,華南永昌-民權,2023-04-14,9312
3013,晟銘電,35,20,15,華南永昌-民權,2023-04-14,9312
5009,榮剛,13,0,13,華南永昌-民權,2023-04-14,9312
4979,華星光,14,2,12,華南永昌-民權,2023-04-14,9312
5465,富驊,19,7,12,華南永昌-民權,2023-04-14,9312
2002,中鋼,22,11,11,華南永昌-民權,2023-04-14,9312
2388,威盛,11,0,11,華南永昌-民權,2023-04-14,9312
00670L,富邦NASDAQ正2,10,0,10,華南永昌-民權,2023-04-14,9312
3323,加百裕,10,0,10,華南永昌-民權,2023-04-14,9312
6163,華電網,10,0,10,華南永昌-民權,2023-04-14,9312
6432,今展科,10,0,10,華南永昌-民權,2023-04-14,9312
2027,大成鋼,14,4,10,華南永昌-民權,2023-04-14,9312
3481,群創,45,36,9,華南永昌-民權,2023-04-14,9312
2302,麗正,8,0,8,華南永昌-民權,2023-04-14,9312
6120,達運,8,0,8,華南永昌-民權,2023-04-14,9312
6835,圓裕,8,0,8,華南永昌-民權,2023-04-14,9312
00679B,元大美債20年,7,0,7,華南永昌-民權,2023-04-14,9312
3545,敦泰,8,1,7,華南永昌-民權,2023-04-14,9312
2201,裕隆,11,5,6,華南永昌-民權,2023-04-14,9312
00687B,國泰20年美債,20,14,6,華南永昌-民權,2023-04-14,9312
3714,富采,9,3,6,華南永昌-民權,2023-04-14,9312
5309,系統電,8,2,6,華南永昌-民權,2023-04-14,9312
8936,國統,8,2,6,華南永昌-民權,2023-04-14,9312
9105,泰金寶-DR,6,0,6,華南永昌-民權,2023-04-14,9312
2382,廣達,6,1,5,華南永昌-民權,2023-04-14,9312
4128,中天,5,0,5,華南永昌-民權,2023-04-14,9312
00885,富邦越南,5,0,5,華南永昌-民權,2023-04-14,9312
1437,勤益控,5,0,5,華南永昌-民權,2023-04-14,9312
1795,美時,5,0,5,華南永昌-民權,2023-04-14,9312
2406,國碩,5,0,5,華南永昌-民權,2023-04-14,9312
2883,凱基金,7,2,5,華南永昌-民權,2023-04-14,9312
3027,盛達,7,2,5,華南永昌-民權,2023-04-14,9312
3178,公準,5,0,5,華南永昌-民權,2023-04-14,9312
3576,聯合再生,5,0,5,華南永昌-民權,2023-04-14,9312
3663,鑫科,8,3,5,華南永昌-民權,2023-04-14,9312
4164,承業醫,6,1,5,華南永昌-民權,2023-04-14,9312
6127,九豪,6,1,5,華南永昌-民權,2023-04-14,9312
2845,遠東銀,400,250,150,華南永昌-民權,2023-04-17,9312
2887,台新金,103,0,103,華南永昌-民權,2023-04-17,9312
1417,嘉裕,100,0,100,華南永昌-民權,2023-04-17,9312
2603,長榮,100,20,80,華南永昌-民權,2023-04-17,9312
3027,盛達,80,19,61,華南永昌-民權,2023-04-17,9312
2002,中鋼,61,12,49,華南永昌-民權,2023-04-17,9312
2017,官田鋼,30,0,30,華南永昌-民權,2023-04-17,9312
2344,華邦電,40,10,30,華南永昌-民權,2023-04-17,9312
3481,群創,32,4,28,華南永昌-民權,2023-04-17,9312
00679B,元大美債20年,26,0,26,華南永昌-民權,2023-04-17,9312
5371,中光電,26,2,24,華南永昌-民權,2023-04-17,9312
00680L,元大美債20正2,21,0,21,華南永昌-民權,2023-04-17,9312
2329,華泰,30,10,20,華南永昌-民權,2023-04-17,9312
3682,亞太電,20,0,20,華南永昌-民權,2023-04-17,9312
2371,大同,18,0,18,華南永昌-民權,2023-04-17,9312
5258,虹堡,19,3,16,華南永昌-民權,2023-04-17,9312
4543,萬在,15,0,15,華南永昌-民權,2023-04-17,9312
4580,捷流閥業,12,0,12,華南永昌-民權,2023-04-17,9312
2609,陽明,12,1,11,華南永昌-民權,2023-04-17,9312
2303,聯電,16,5,11,華南永昌-民權,2023-04-17,9312
1589,永冠-KY,10,0,10,華南永昌-民權,2023-04-17,9312
1611,中電,10,0,10,華南永昌-民權,2023-04-17,9312
3323,加百裕,10,0,10,華南永昌-民權,2023-04-17,9312
3704,合勤控,10,0,10,華南永昌-民權,2023-04-17,9312
6770,力積電,14,4,10,華南永昌-民權,2023-04-17,9312
2748,雲品,10,1,9,華南永昌-民權,2023-04-17,9312
6167,久正,10,1,9,華南永昌-民權,2023-04-17,9312
6235,華孚,23,14,9,華南永昌-民權,2023-04-17,9312
6242,立康,9,0,9,華南永昌-民權,2023-04-17,9312
00712,復華富時不動產,17,9,8,華南永昌-民權,2023-04-17,9312
00885,富邦越南,9,1,8,華南永昌-民權,2023-04-17,9312
6282,康舒,69,61,8,華南永昌-民權,2023-04-17,9312
3680,家登,10,2,8,華南永昌-民權,2023-04-17,9312
6547,高端疫苗,23,15,8,華南永昌-民權,2023-04-17,9312
1319,東陽,7,0,7,華南永昌-民權,2023-04-17,9312
5212,凌網,7,0,7,華南永昌-民權,2023-04-17,9312
8103,瀚荃,7,0,7,華南永昌-民權,2023-04-17,9312
1503,士電,28,22,6,華南永昌-民權,2023-04-17,9312
2402,毅嘉,6,0,6,華南永昌-民權,2023-04-17,9312
8289,泰藝,6,0,6,華南永昌-民權,2023-04-17,9312
8299,群聯,6,0,6,華南永昌-民權,2023-04-17,9312
2454,聯發科,5,0,5,華南永昌-民權,2023-04-17,9312
3419,譁裕,5,0,5,華南永昌-民權,2023-04-17,9312
3094,聯傑,5,0,5,華南永昌-民權,2023-04-17,9312
3236,千如,5,0,5,華南永昌-民權,2023-04-17,9312
3260,威剛,5,0,5,華南永昌-民權,2023-04-17,9312
4905,台聯電,5,0,5,華南永昌-民權,2023-04-17,9312
5328,華容,5,0,5,華南永昌-民權,2023-04-17,9312
6126,信音,5,0,5,華南永昌-民權,2023-04-17,9312
6470,宇智,5,0,5,華南永昌-民權,2023-04-17,9312
6282,康舒,245,133,112,華南永昌-民權,2023-04-18,9312
1444,力麗,63,10,53,華南永昌-民權,2023-04-18,9312
3037,欣興,53,4,49,華南永昌-民權,2023-04-18,9312
3047,訊舟,30,1,29,華南永昌-民權,2023-04-18,9312
4934,太極,31,2,29,華南永昌-民權,2023-04-18,9312
2610,華航,31,5,26,華南永昌-民權,2023-04-18,9312
00680L,元大美債20正2,31,5,26,華南永昌-民權,2023-04-18,9312
1589,永冠-KY,25,0,25,華南永昌-民權,2023-04-18,9312
6669,緯穎,25,1,24,華南永昌-民權,2023-04-18,9312
5009,榮剛,23,1,22,華南永昌-民權,2023-04-18,9312
2457,飛宏,44,23,21,華南永昌-民權,2023-04-18,9312
5222,全訊,20,0,20,華南永昌-民權,2023-04-18,9312
5403,中菲,20,0,20,華南永昌-民權,2023-04-18,9312
1720,生達,22,3,19,華南永昌-民權,2023-04-18,9312
2312,金寶,51,32,19,華南永昌-民權,2023-04-18,9312
1519,華城,76,58,18,華南永昌-民權,2023-04-18,9312
6269,台郡,20,2,18,華南永昌-民權,2023-04-18,9312
2634,漢翔,56,39,17,華南永昌-民權,2023-04-18,9312
5488,松普,15,0,15,華南永昌-民權,2023-04-18,9312
00891,中信關鍵半導體,13,0,13,華南永昌-民權,2023-04-18,9312
4171,瑞基,13,0,13,華南永昌-民權,2023-04-18,9312
1101,台泥,13,0,13,華南永昌-民權,2023-04-18,9312
00687B,國泰20年美債,20,8,12,華南永昌-民權,2023-04-18,9312
1809,中釉,12,0,12,華南永昌-民權,2023-04-18,9312
6242,立康,12,1,11,華南永昌-民權,2023-04-18,9312
2329,華泰,30,20,10,華南永昌-民權,2023-04-18,9312
2430,燦坤,10,0,10,華南永昌-民權,2023-04-18,9312
2443,昶虹,10,0,10,華南永昌-民權,2023-04-18,9312
3305,昇貿,10,0,10,華南永昌-民權,2023-04-18,9312
8046,南電,10,0,10,華南永昌-民權,2023-04-18,9312
8069,元太,10,0,10,華南永昌-民權,2023-04-18,9312
2236,百達-KY,9,0,9,華南永昌-民權,2023-04-18,9312
2371,大同,10,1,9,華南永昌-民權,2023-04-18,9312
1609,大亞,72,64,8,華南永昌-民權,2023-04-18,9312
00878,國泰永續高股息,8,0,8,華南永昌-民權,2023-04-18,9312
1109,信大,8,0,8,華南永昌-民權,2023-04-18,9312
6470,宇智,11,3,8,華南永昌-民權,2023-04-18,9312
8383,千附,8,0,8,華南永昌-民權,2023-04-18,9312
00679B,元大美債20年,7,0,7,華南永昌-民權,2023-04-18,9312
3413,京鼎,7,0,7,華南永昌-民權,2023-04-18,9312
4905,台聯電,7,0,7,華南永昌-民權,2023-04-18,9312
8996,高力,8,1,7,華南永昌-民權,2023-04-18,9312
3481,群創,9,2,7,華南永昌-民權,2023-04-18,9312
2330,台積電,16,10,6,華南永昌-民權,2023-04-18,9312
1471,首利,8,2,6,華南永昌-民權,2023-04-18,9312
1529,樂事綠能,7,1,6,華南永昌-民權,2023-04-18,9312
2515,中工,6,0,6,華南永昌-民權,2023-04-18,9312
3025,星通,11,5,6,華南永昌-民權,2023-04-18,9312
3221,台嘉碩,6,0,6,華南永昌-民權,2023-04-18,9312
00900,富邦特選高股息30,5,0,5,華南永昌-民權,2023-04-18,9312
2834,臺企銀,501,3,498,華南永昌-民權,2023-04-19,9312
1717,長興,210,0,210,華南永昌-民權,2023-04-19,9312
6139,亞翔,115,0,115,華南永昌-民權,2023-04-19,9312
00671R,富邦NASDAQ反1,100,0,100,華南永昌-民權,2023-04-19,9312
0056,元大高股息,24,0,24,華南永昌-民權,2023-04-19,9312
1312,國喬,20,0,20,華南永昌-民權,2023-04-19,9312
00713,元大台灣高息低波,20,0,20,華南永昌-民權,2023-04-19,9312
3710,連展投控,20,0,20,華南永昌-民權,2023-04-19,9312
4171,瑞基,20,0,20,華南永昌-民權,2023-04-19,9312
6770,力積電,20,1,19,華南永昌-民權,2023-04-19,9312
6282,康舒,51,33,18,華南永昌-民權,2023-04-19,9312
2344,華邦電,17,0,17,華南永昌-民權,2023-04-19,9312
2478,大毅,16,0,16,華南永昌-民權,2023-04-19,9312
00772B,中信高評級公司債,15,0,15,華南永昌-民權,2023-04-19,9312
2208,台船,17,2,15,華南永昌-民權,2023-04-19,9312
2347,聯強,15,0,15,華南永昌-民權,2023-04-19,9312
00891,中信關鍵半導體,13,0,13,華南永昌-民權,2023-04-19,9312
2317,鴻海,13,1,12,華南永昌-民權,2023-04-19,9312
5512,力麒,14,2,12,華南永昌-民權,2023-04-19,9312
00679B,元大美債20年,12,0,12,華南永昌-民權,2023-04-19,9312
1101,台泥,11,0,11,華南永昌-民權,2023-04-19,9312
2331,精英,12,1,11,華南永昌-民權,2023-04-19,9312
6148,驊宏資,13,2,11,華南永昌-民權,2023-04-19,9312
00637L,元大滬深300正2,10,0,10,華南永昌-民權,2023-04-19,9312
1519,華城,25,15,10,華南永昌-民權,2023-04-19,9312
1809,中釉,10,0,10,華南永昌-民權,2023-04-19,9312
3323,加百裕,10,0,10,華南永昌-民權,2023-04-19,9312
3356,奇偶,10,0,10,華南永昌-民權,2023-04-19,9312
6185,幃翔,10,0,10,華南永昌-民權,2023-04-19,9312
2201,裕隆,13,5,8,華南永昌-民權,2023-04-19,9312
2609,陽明,11,3,8,華南永昌-民權,2023-04-19,9312
4967,十銓,7,0,7,華南永昌-民權,2023-04-19,9312
6589,台康生技,7,0,7,華南永昌-民權,2023-04-19,9312
2314,台揚,8,1,7,華南永昌-民權,2023-04-19,9312
00712,復華富時不動產,7,0,7,華南永昌-民權,2023-04-19,9312
1514,亞力,6,0,6,華南永昌-民權,2023-04-19,9312
3322,建舜電,6,0,6,華南永昌-民權,2023-04-19,9312
8289,泰藝,6,0,6,華南永昌-民權,2023-04-19,9312
8478,東哥遊艇,7,1,6,華南永昌-民權,2023-04-19,9312
5009,榮剛,15,9,6,華南永昌-民權,2023-04-19,9312
1536,和大,5,0,5,華南永昌-民權,2023-04-19,9312
2369,菱生,5,0,5,華南永昌-民權,2023-04-19,9312
2515,中工,45,40,5,華南永昌-民權,2023-04-19,9312
2542,興富發,5,0,5,華南永昌-民權,2023-04-19,9312
3419,譁裕,10,5,5,華南永昌-民權,2023-04-19,9312
5381,合正,5,0,5,華南永昌-民權,2023-04-19,9312
5488,松普,5,0,5,華南永昌-民權,2023-04-19,9312
2303,聯電,16,12,4,華南永昌-民權,2023-04-19,9312
6163,華電網,6,2,4,華南永昌-民權,2023-04-19,9312
2884,玉山金,5,1,4,華南永昌-民權,2023-04-19,9312
2834,臺企銀,326,15,311,華南永昌-民權,2023-04-20,9312
4905,台聯電,71,0,71,華南永昌-民權,2023-04-20,9312
1101,台泥,52,1,51,華南永昌-民權,2023-04-20,9312
9904,寶成,50,0,50,華南永昌-民權,2023-04-20,9312
2380,虹光,47,0,47,華南永昌-民權,2023-04-20,9312
1321,大洋,46,0,46,華南永昌-民權,2023-04-20,9312
2515,中工,44,1,43,華南永昌-民權,2023-04-20,9312
2634,漢翔,88,50,38,華南永昌-民權,2023-04-20,9312
6282,康舒,53,16,37,華南永昌-民權,2023-04-20,9312
00664R,國泰臺灣加權反1,30,0,30,華南永昌-民權,2023-04-20,9312
6770,力積電,20,0,20,華南永昌-民權,2023-04-20,9312
1589,永冠-KY,29,9,20,華南永昌-民權,2023-04-20,9312
00715L,期街口布蘭特正2,19,0,19,華南永昌-民權,2023-04-20,9312
1710,東聯,18,0,18,華南永昌-民權,2023-04-20,9312
3047,訊舟,20,3,17,華南永昌-民權,2023-04-20,9312
6288,聯嘉,18,1,17,華南永昌-民權,2023-04-20,9312
0056,元大高股息,16,0,16,華南永昌-民權,2023-04-20,9312
6443,元晶,17,2,15,華南永昌-民權,2023-04-20,9312
5465,富驊,40,28,12,華南永昌-民權,2023-04-20,9312
00633L,富邦上証正2,12,0,12,華南永昌-民權,2023-04-20,9312
2478,大毅,12,0,12,華南永昌-民權,2023-04-20,9312
2498,宏達電,12,0,12,華南永昌-民權,2023-04-20,9312
1616,億泰,11,0,11,華南永昌-民權,2023-04-20,9312
2344,華邦電,11,0,11,華南永昌-民權,2023-04-20,9312
3363,上詮,11,0,11,華南永昌-民權,2023-04-20,9312
00878,國泰永續高股息,10,0,10,華南永昌-民權,2023-04-20,9312
6245,立端,10,0,10,華南永昌-民權,2023-04-20,9312
00632R,元大台灣50反1,46,36,10,華南永昌-民權,2023-04-20,9312
2362,藍天,10,0,10,華南永昌-民權,2023-04-20,9312
3704,合勤控,10,0,10,華南永昌-民權,2023-04-20,9312
3710,連展投控,10,0,10,華南永昌-民權,2023-04-20,9312
3356,奇偶,9,0,9,華南永昌-民權,2023-04-20,9312
2406,國碩,8,0,8,華南永昌-民權,2023-04-20,9312
4931,新盛力,11,3,8,華南永昌-民權,2023-04-20,9312
1760,寶齡富錦,36,29,7,華南永昌-民權,2023-04-20,9312
2359,所羅門,13,6,7,華南永昌-民權,2023-04-20,9312
2457,飛宏,15,8,7,華南永昌-民權,2023-04-20,9312
6535,順藥,7,0,7,華南永昌-民權,2023-04-20,9312
8086,宏捷科,7,0,7,華南永昌-民權,2023-04-20,9312
8996,高力,8,1,7,華南永昌-民權,2023-04-20,9312
1609,大亞,38,32,6,華南永昌-民權,2023-04-20,9312
1909,榮成,98,92,6,華南永昌-民權,2023-04-20,9312
3027,盛達,8,2,6,華南永昌-民權,2023-04-20,9312
1409,新纖,6,1,5,華南永昌-民權,2023-04-20,9312
1432,大魯閣,5,0,5,華南永昌-民權,2023-04-20,9312
00671R,富邦NASDAQ反1,5,0,5,華南永昌-民權,2023-04-20,9312
00637L,元大滬深300正2,5,0,5,華南永昌-民權,2023-04-20,9312
1568,倉佑,5,0,5,華南永昌-民權,2023-04-20,9312
3028,增你強,5,0,5,華南永昌-民權,2023-04-20,9312
3094,聯傑,8,3,5,華南永昌-民權,2023-04-20,9312
3652,精聯,120,0,120,華南永昌-民權,2023-04-21,9312
4905,台聯電,90,0,90,華南永昌-民權,2023-04-21,9312
2303,聯電,84,3,81,華南永昌-民權,2023-04-21,9312
3704,合勤控,105,73,32,華南永昌-民權,2023-04-21,9312
8936,國統,32,1,31,華南永昌-民權,2023-04-21,9312
2820,華票,30,0,30,華南永昌-民權,2023-04-21,9312
3047,訊舟,30,0,30,華南永昌-民權,2023-04-21,9312
6226,光鼎,30,0,30,華南永昌-民權,2023-04-21,9312
6535,順藥,23,0,23,華南永昌-民權,2023-04-21,9312
1611,中電,23,4,19,華南永昌-民權,2023-04-21,9312
1513,中興電,14,0,14,華南永昌-民權,2023-04-21,9312
2609,陽明,17,3,14,華南永昌-民權,2023-04-21,9312
1605,華新,16,2,14,華南永昌-民權,2023-04-21,9312
2027,大成鋼,14,1,13,華南永昌-民權,2023-04-21,9312
0056,元大高股息,14,2,12,華南永昌-民權,2023-04-21,9312
00900,富邦特選高股息30,11,0,11,華南永昌-民權,2023-04-21,9312
00919,群益台灣精選高息,11,0,11,華南永昌-民權,2023-04-21,9312
3356,奇偶,11,0,11,華南永昌-民權,2023-04-21,9312
4934,太極,11,0,11,華南永昌-民權,2023-04-21,9312
00888,永豐台灣ESG,10,0,10,華南永昌-民權,2023-04-21,9312
00753L,中信中國50正2,10,0,10,華南永昌-民權,2023-04-21,9312
00632R,元大台灣50反1,10,0,10,華南永昌-民權,2023-04-21,9312
1589,永冠-KY,10,0,10,華南永昌-民權,2023-04-21,9312
2369,菱生,10,0,10,華南永昌-民權,2023-04-21,9312
2460,建通,16,6,10,華南永昌-民權,2023-04-21,9312
2498,宏達電,10,0,10,華南永昌-民權,2023-04-21,9312
4175,杏一,10,0,10,華南永昌-民權,2023-04-21,9312
5488,松普,10,0,10,華南永昌-民權,2023-04-21,9312
8284,三竹,10,0,10,華南永昌-民權,2023-04-21,9312
1616,億泰,10,1,9,華南永昌-民權,2023-04-21,9312
1907,永豐餘,12,3,9,華南永昌-民權,2023-04-21,9312
6589,台康生技,12,3,9,華南永昌-民權,2023-04-21,9312
1909,榮成,21,13,8,華南永昌-民權,2023-04-21,9312
1760,寶齡富錦,22,14,8,華南永昌-民權,2023-04-21,9312
1795,美時,9,2,7,華南永昌-民權,2023-04-21,9312
3032,偉訓,8,1,7,華南永昌-民權,2023-04-21,9312
3710,連展投控,7,0,7,華南永昌-民權,2023-04-21,9312
6129,普誠,7,0,7,華南永昌-民權,2023-04-21,9312
8016,矽創,7,0,7,華南永昌-民權,2023-04-21,9312
2603,長榮,10,4,6,華南永昌-民權,2023-04-21,9312
1609,大亞,47,41,6,華南永昌-民權,2023-04-21,9312
2457,飛宏,7,1,6,華南永昌-民權,2023-04-21,9312
00679B,元大美債20年,6,0,6,華南永昌-民權,2023-04-21,9312
2002,中鋼,15,10,5,華南永昌-民權,2023-04-21,9312
6613,朋億*,5,0,5,華南永昌-民權,2023-04-21,9312
00715L,期街口布蘭特正2,5,0,5,華南永昌-民權,2023-04-21,9312
1313,聯成,5,0,5,華南永昌-民權,2023-04-21,9312
2313,華通,5,0,5,華南永昌-民權,2023-04-21,9312
2328,廣宇,5,0,5,華南永昌-民權,2023-04-21,9312
2347,聯強,5,0,5,華南永昌-民權,2023-04-21,9312
00632R,元大台灣50反1,300,5,295,華南永昌-民權,2023-04-24,9312
00706L,期元大S＆P日圓正2,110,0,110,華南永昌-民權,2023-04-24,9312
4905,台聯電,84,0,84,華南永昌-民權,2023-04-24,9312
2845,遠東銀,250,199,51,華南永昌-民權,2023-04-24,9312
2412,中華電,30,0,30,華南永昌-民權,2023-04-24,9312
4979,華星光,26,0,26,華南永昌-民權,2023-04-24,9312
8996,高力,42,16,26,華南永昌-民權,2023-04-24,9312
1101,台泥,33,12,21,華南永昌-民權,2023-04-24,9312
3207,耀勝,20,0,20,華南永昌-民權,2023-04-24,9312
2303,聯電,15,0,15,華南永昌-民權,2023-04-24,9312
2206,三陽工業,14,0,14,華南永昌-民權,2023-04-24,9312
2208,台船,12,0,12,華南永昌-民權,2023-04-24,9312
3071,協禧,17,5,12,華南永昌-民權,2023-04-24,9312
8033,雷虎,12,0,12,華南永昌-民權,2023-04-24,9312
2313,華通,13,2,11,華南永昌-民權,2023-04-24,9312
2419,仲琦,11,0,11,華南永昌-民權,2023-04-24,9312
5426,振發,11,0,11,華南永昌-民權,2023-04-24,9312
2344,華邦電,10,0,10,華南永昌-民權,2023-04-24,9312
2515,中工,10,0,10,華南永昌-民權,2023-04-24,9312
3227,原相,10,0,10,華南永昌-民權,2023-04-24,9312
3591,艾笛森,10,0,10,華南永昌-民權,2023-04-24,9312
6542,隆中,10,0,10,華南永昌-民權,2023-04-24,9312
9902,台火,10,0,10,華南永昌-民權,2023-04-24,9312
2337,旺宏,12,2,10,華南永昌-民權,2023-04-24,9312
2409,友達,9,0,9,華南永昌-民權,2023-04-24,9312
3081,聯亞,9,0,9,華南永昌-民權,2023-04-24,9312
8085,福華,9,0,9,華南永昌-民權,2023-04-24,9312
8222,寶一,18,10,8,華南永昌-民權,2023-04-24,9312
6770,力積電,7,0,7,華南永昌-民權,2023-04-24,9312
1310,台苯,7,0,7,華南永昌-民權,2023-04-24,9312
1108,幸福,8,1,7,華南永昌-民權,2023-04-24,9312
00637L,元大滬深300正2,12,5,7,華南永昌-民權,2023-04-24,9312
4510,高鋒,12,5,7,華南永昌-民權,2023-04-24,9312
6523,達爾膚,7,0,7,華南永昌-民權,2023-04-24,9312
2002,中鋼,6,0,6,華南永昌-民權,2023-04-24,9312
00772B,中信高評級公司債,6,0,6,華南永昌-民權,2023-04-24,9312
00708L,期元大S＆P黃金正2,6,0,6,華南永昌-民權,2023-04-24,9312
1611,中電,9,3,6,華南永昌-民權,2023-04-24,9312
1907,永豐餘,117,111,6,華南永昌-民權,2023-04-24,9312
2464,盟立,6,0,6,華南永昌-民權,2023-04-24,9312
3017,奇鋐,5,0,5,華南永昌-民權,2023-04-24,9312
00900,富邦特選高股息30,5,0,5,華南永昌-民權,2023-04-24,9312
2312,金寶,5,0,5,華南永昌-民權,2023-04-24,9312
2324,仁寶,5,0,5,華南永昌-民權,2023-04-24,9312
3038,全台,5,0,5,華南永昌-民權,2023-04-24,9312
3528,安馳,5,0,5,華南永昌-民權,2023-04-24,9312
6803,崑鼎,5,0,5,華南永昌-民權,2023-04-24,9312
8111,立��,5,0,5,華南永昌-民權,2023-04-24,9312
9935,慶豐富,5,0,5,華南永昌-民權,2023-04-24,9312
2027,大成鋼,6,1,5,華南永昌-民權,2023-04-24,9312
00632R,元大台灣50反1,115,0,115,華南永昌-民權,2023-04-25,9312
4905,台聯電,103,0,103,華南永昌-民權,2023-04-25,9312
0056,元大高股息,44,0,44,華南永昌-民權,2023-04-25,9312
8927,北基,69,29,40,華南永昌-民權,2023-04-25,9312
00671R,富邦NASDAQ反1,35,0,35,華南永昌-民權,2023-04-25,9312
2303,聯電,33,7,26,華南永昌-民權,2023-04-25,9312
3035,智原,25,0,25,華南永昌-民權,2023-04-25,9312
1314,中石化,26,4,22,華南永昌-民權,2023-04-25,9312
3652,精聯,20,0,20,華南永昌-民權,2023-04-25,9312
1515,力山,18,0,18,華南永昌-民權,2023-04-25,9312
00637L,元大滬深300正2,17,0,17,華南永昌-民權,2023-04-25,9312
6269,台郡,27,10,17,華南永昌-民權,2023-04-25,9312
8383,千附,27,10,17,華南永昌-民權,2023-04-25,9312
00893,國泰智能電動車,15,0,15,華南永昌-民權,2023-04-25,9312
2498,宏達電,13,0,13,華南永昌-民權,2023-04-25,9312
1504,東元,24,11,13,華南永昌-民權,2023-04-25,9312
2834,臺企銀,262,250,12,華南永昌-民權,2023-04-25,9312
1312,國喬,10,0,10,華南永昌-民權,2023-04-25,9312
00795B,中信美國公債20年,10,0,10,華南永昌-民權,2023-04-25,9312
1589,永冠-KY,10,0,10,華南永昌-民權,2023-04-25,9312
2010,春源,10,0,10,華南永昌-民權,2023-04-25,9312
3591,艾笛森,10,0,10,華南永昌-民權,2023-04-25,9312
1809,中釉,10,1,9,華南永昌-民權,2023-04-25,9312
5009,榮剛,14,5,9,華南永昌-民權,2023-04-25,9312
00900,富邦特選高股息30,8,0,8,華南永昌-民權,2023-04-25,9312
2002,中鋼,28,20,8,華南永昌-民權,2023-04-25,9312
1720,生達,13,5,8,華南永昌-民權,2023-04-25,9312
2027,大成鋼,10,2,8,華南永昌-民權,2023-04-25,9312
2108,南帝,8,0,8,華南永昌-民權,2023-04-25,9312
2618,長榮航,10,2,8,華南永昌-民權,2023-04-25,9312
3221,台嘉碩,8,0,8,華南永昌-民權,2023-04-25,9312
2313,華通,10,2,8,華南永昌-民權,2023-04-25,9312
2419,仲琦,7,0,7,華南永昌-民權,2023-04-25,9312
2486,一詮,10,3,7,華南永昌-民權,2023-04-25,9312
3083,網龍,7,0,7,華南永昌-民權,2023-04-25,9312
3209,全科,10,3,7,華南永昌-民權,2023-04-25,9312
3548,兆利,7,0,7,華南永昌-民權,2023-04-25,9312
3624,光頡,10,3,7,華南永昌-民權,2023-04-25,9312
8358,金居,15,8,7,華南永昌-民權,2023-04-25,9312
006208,富邦台50,7,0,7,華南永昌-民權,2023-04-25,9312
2409,友達,6,0,6,華南永昌-民權,2023-04-25,9312
00713,元大台灣高息低波,6,0,6,華南永昌-民權,2023-04-25,9312
00895,富邦未來車,8,2,6,華南永昌-民權,2023-04-25,9312
1711,永光,6,0,6,華南永昌-民權,2023-04-25,9312
1752,南光,7,1,6,華南永昌-民權,2023-04-25,9312
3081,聯亞,6,0,6,華南永昌-民權,2023-04-25,9312
3617,碩天,6,0,6,華南永昌-民權,2023-04-25,9312
6542,隆中,6,0,6,華南永昌-民權,2023-04-25,9312
2457,飛宏,32,26,6,華南永昌-民權,2023-04-25,9312
3481,群創,6,0,6,華南永昌-民權,2023-04-25,9312
00676R,富邦臺灣加權反1,100,0,100,華南永昌-民權,2023-04-26,9312
4905,台聯電,91,0,91,華南永昌-民權,2023-04-26,9312
2834,臺企銀,74,0,74,華南永昌-民權,2023-04-26,9312
8996,高力,50,0,50,華南永昌-民權,2023-04-26,9312
3652,精聯,21,0,21,華南永昌-民權,2023-04-26,9312
1312,國喬,20,0,20,華南永昌-民權,2023-04-26,9312
2614,東森,20,0,20,華南永昌-民權,2023-04-26,9312
2867,三商壽,20,0,20,華南永昌-民權,2023-04-26,9312
00885,富邦越南,19,0,19,華南永昌-民權,2023-04-26,9312
2412,中華電,23,9,14,華南永昌-民權,2023-04-26,9312
6770,力積電,12,0,12,華南永昌-民權,2023-04-26,9312
8222,寶一,28,16,12,華南永昌-民權,2023-04-26,9312
2337,旺宏,11,0,11,華南永昌-民權,2023-04-26,9312
2367,燿華,11,0,11,華南永昌-民權,2023-04-26,9312
2478,大毅,11,0,11,華南永昌-民權,2023-04-26,9312
1589,永冠-KY,15,5,10,華南永昌-民權,2023-04-26,9312
2618,長榮航,10,0,10,華南永昌-民權,2023-04-26,9312
3206,志豐,10,0,10,華南永昌-民權,2023-04-26,9312
4915,致伸,10,0,10,華南永昌-民權,2023-04-26,9312
6834,天二科技,10,0,10,華南永昌-民權,2023-04-26,9312
3227,原相,9,0,9,華南永昌-民權,2023-04-26,9312
2002,中鋼,12,4,8,華南永昌-民權,2023-04-26,9312
2498,宏達電,10,3,7,華南永昌-民權,2023-04-26,9312
00857B,永豐20年美公債,8,2,6,華南永昌-民權,2023-04-26,9312
2375,凱美,9,3,6,華南永昌-民權,2023-04-26,9312
2515,中工,6,0,6,華南永昌-民權,2023-04-26,9312
4979,華星光,6,0,6,華南永昌-民權,2023-04-26,9312
2317,鴻海,16,10,6,華南永昌-民權,2023-04-26,9312
3035,智原,5,0,5,華南永昌-民權,2023-04-26,9312
00720B,元大投資級公司債,5,0,5,華南永昌-民權,2023-04-26,9312
2206,三陽工業,7,2,5,華南永昌-民權,2023-04-26,9312
2329,華泰,5,0,5,華南永昌-民權,2023-04-26,9312
2344,華邦電,5,0,5,華南永昌-民權,2023-04-26,9312
3078,僑威,5,0,5,華南永昌-民權,2023-04-26,9312
3083,網龍,5,0,5,華南永昌-民權,2023-04-26,9312
5425,台半,6,1,5,華南永昌-民權,2023-04-26,9312
6191,精成科,5,0,5,華南永昌-民權,2023-04-26,9312
6470,宇智,5,0,5,華南永昌-民權,2023-04-26,9312
2609,陽明,11,7,4,華南永昌-民權,2023-04-26,9312
00902,中信電池及儲能,4,0,4,華南永昌-民權,2023-04-26,9312
0056,元大高股息,5,1,4,華南永昌-民權,2023-04-26,9312
1802,台玻,5,1,4,華南永昌-民權,2023-04-26,9312
2368,金像電,4,0,4,華南永昌-民權,2023-04-26,9312
3027,盛達,10,6,4,華南永昌-民權,2023-04-26,9312
3071,協禧,9,5,4,華南永昌-民權,2023-04-26,9312
5009,榮剛,4,0,4,華南永昌-民權,2023-04-26,9312
6234,高僑,4,0,4,華南永昌-民權,2023-04-26,9312
6542,隆中,4,0,4,華南永昌-民權,2023-04-26,9312
2303,聯電,3,0,3,華南永昌-民權,2023-04-26,9312
006208,富邦台50,3,0,3,華南永昌-民權,2023-04-26,9312
00676R,富邦臺灣加權反1,200,0,200,華南永昌-民權,2023-04-27,9312
2610,華航,98,2,96,華南永昌-民權,2023-04-27,9312
4905,台聯電,82,0,82,華南永昌-民權,2023-04-27,9312
00715L,期街口布蘭特正2,40,0,40,華南永昌-民權,2023-04-27,9312
2303,聯電,39,2,37,華南永昌-民權,2023-04-27,9312
2412,中華電,36,0,36,華南永昌-民權,2023-04-27,9312
00632R,元大台灣50反1,40,5,35,華南永昌-民權,2023-04-27,9312
2002,中鋼,33,1,32,華南永昌-民權,2023-04-27,9312
00664R,國泰臺灣加權反1,30,0,30,華南永昌-民權,2023-04-27,9312
9902,台火,30,0,30,華南永昌-民權,2023-04-27,9312
1589,永冠-KY,33,5,28,華南永昌-民權,2023-04-27,9312
1702,南僑,25,0,25,華南永昌-民權,2023-04-27,9312
2317,鴻海,40,15,25,華南永昌-民權,2023-04-27,9312
2913,農林,25,4,21,華南永昌-民權,2023-04-27,9312
1605,華新,25,5,20,華南永昌-民權,2023-04-27,9312
00885,富邦越南,15,0,15,華南永昌-民權,2023-04-27,9312
1614,三洋電,15,0,15,華南永昌-民權,2023-04-27,9312
1464,得力,10,0,10,華南永昌-民權,2023-04-27,9312
2331,精英,10,0,10,華南永昌-民權,2023-04-27,9312
3081,聯亞,10,0,10,華南永昌-民權,2023-04-27,9312
6226,光鼎,10,0,10,華南永昌-民權,2023-04-27,9312
8996,高力,10,0,10,華南永昌-民權,2023-04-27,9312
2471,資通,8,0,8,華南永昌-民權,2023-04-27,9312
6125,廣運,10,2,8,華南永昌-民權,2023-04-27,9312
6234,高僑,47,39,8,華南永昌-民權,2023-04-27,9312
1710,東聯,36,29,7,華南永昌-民權,2023-04-27,9312
1717,長興,8,1,7,華南永昌-民權,2023-04-27,9312
2834,臺企銀,17,10,7,華南永昌-民權,2023-04-27,9312
3545,敦泰,6,0,6,華南永昌-民權,2023-04-27,9312
8227,巨有科技,34,28,6,華南永昌-民權,2023-04-27,9312
006208,富邦台50,5,0,5,華南永昌-民權,2023-04-27,9312
00720B,元大投資級公司債,5,0,5,華南永昌-民權,2023-04-27,9312
1711,永光,73,68,5,華南永昌-民權,2023-04-27,9312
2208,台船,11,6,5,華南永昌-民權,2023-04-27,9312
2344,華邦電,6,1,5,華南永昌-民權,2023-04-27,9312
2609,陽明,13,8,5,華南永昌-民權,2023-04-27,9312
6182,合晶,5,0,5,華南永昌-民權,2023-04-27,9312
6288,聯嘉,10,5,5,華南永昌-民權,2023-04-27,9312
0050,元大台灣50,4,0,4,華南永昌-民權,2023-04-27,9312
00772B,中信高評級公司債,4,0,4,華南永昌-民權,2023-04-27,9312
1514,亞力,5,1,4,華南永昌-民權,2023-04-27,9312
1101,台泥,4,0,4,華南永昌-民權,2023-04-27,9312
1108,幸福,4,0,4,華南永昌-民權,2023-04-27,9312
1709,和益,54,50,4,華南永昌-民權,2023-04-27,9312
2419,仲琦,4,0,4,華南永昌-民權,2023-04-27,9312
4720,德淵,4,0,4,華南永昌-民權,2023-04-27,9312
6282,康舒,10,6,4,華南永昌-民權,2023-04-27,9312
2330,台積電,3,0,3,華南永昌-民權,2023-04-27,9312
2707,晶華,4,1,3,華南永昌-民權,2023-04-27,9312
6770,力積電,3,0,3,華南永昌-民權,2023-04-27,9312
00706L,期元大S＆P日圓正2,100,0,100,華南永昌-民權,2023-04-28,9312
4905,台聯電,84,0,84,華南永昌-民權,2023-04-28,9312
5880,合庫金,56,1,55,華南永昌-民權,2023-04-28,9312
3004,豐達科,43,3,40,華南永昌-民權,2023-04-28,9312
2409,友達,30,0,30,華南永昌-民權,2023-04-28,9312
3029,零壹,32,11,21,華南永昌-民權,2023-04-28,9312
2634,漢翔,37,19,18,華南永昌-民權,2023-04-28,9312
3481,群創,19,1,18,華南永昌-民權,2023-04-28,9312
3081,聯亞,17,2,15,華南永昌-民權,2023-04-28,9312
6266,泰詠,15,1,14,華南永昌-民權,2023-04-28,9312
5009,榮剛,50,36,14,華南永昌-民權,2023-04-28,9312
2605,新興,16,3,13,華南永昌-民權,2023-04-28,9312
2458,義隆,12,1,11,華南永昌-民權,2023-04-28,9312
1710,東聯,14,4,10,華南永昌-民權,2023-04-28,9312
4128,中天,10,0,10,華南永昌-民權,2023-04-28,9312
6244,茂迪,11,1,10,華南永昌-民權,2023-04-28,9312
2419,仲琦,11,2,9,華南永昌-民權,2023-04-28,9312
2453,凌群,80,71,9,華南永昌-民權,2023-04-28,9312
6179,亞通,9,0,9,華南永昌-民權,2023-04-28,9312
1727,中華化,52,44,8,華南永昌-民權,2023-04-28,9312
6234,高僑,17,10,7,華南永昌-民權,2023-04-28,9312
8383,千附,21,14,7,華南永昌-民權,2023-04-28,9312
3374,精材,6,0,6,華南永昌-民權,2023-04-28,9312
00679B,元大美債20年,6,0,6,華南永昌-民權,2023-04-28,9312
1519,華城,9,3,6,華南永昌-民權,2023-04-28,9312
2337,旺宏,6,0,6,華南永昌-民權,2023-04-28,9312
6114,久威,6,0,6,華南永昌-民權,2023-04-28,9312
3047,訊舟,6,0,6,華南永昌-民權,2023-04-28,9312
2208,台船,5,0,5,華南永昌-民權,2023-04-28,9312
2359,所羅門,5,0,5,華南永昌-民權,2023-04-28,9312
2478,大毅,5,0,5,華南永昌-民權,2023-04-28,9312
2890,永豐金,5,0,5,華南永昌-民權,2023-04-28,9312
3232,昱捷,5,0,5,華南永昌-民權,2023-04-28,9312
5388,中磊,5,0,5,華南永昌-民權,2023-04-28,9312
6282,康舒,8,3,5,華南永昌-民權,2023-04-28,9312
6834,天二科技,5,0,5,華南永昌-民權,2023-04-28,9312
8996,高力,14,9,5,華南永昌-民權,2023-04-28,9312
2301,光寶科,4,0,4,華南永昌-民權,2023-04-28,9312
2609,陽明,8,4,4,華南永昌-民權,2023-04-28,9312
4906,正文,4,0,4,華南永昌-民權,2023-04-28,9312
4916,事欣科,13,9,4,華南永昌-民權,2023-04-28,9312
4987,科誠,4,0,4,華南永昌-民權,2023-04-28,9312
6712,長聖,5,1,4,華南永昌-民權,2023-04-28,9312
3624,光頡,5,2,3,華南永昌-民權,2023-04-28,9312
5608,四維航,4,1,3,華南永昌-民權,2023-04-28,9312
1514,亞力,3,0,3,華南永昌-民權,2023-04-28,9312
2303,聯電,24,21,3,華南永昌-民權,2023-04-28,9312
3324,雙鴻,4,1,3,華南永昌-民權,2023-04-28,9312
3491,昇達科,3,0,3,華南永昌-民權,2023-04-28,9312
3707,漢磊,3,0,3,華南永昌-民權,2023-04-28,9312
2881,富邦金,202,0,202,華南永昌-民權,2023-05-02,9312
1314,中石化,50,0,50,華南永昌-民權,2023-05-02,9312
2102,泰豐,50,0,50,華南永昌-民權,2023-05-02,9312
3037,欣興,58,17,41,華南永昌-民權,2023-05-02,9312
2412,中華電,34,1,33,華南永昌-民權,2023-05-02,9312
2880,華南金,32,1,31,華南永昌-民權,2023-05-02,9312
1809,中釉,32,1,31,華南永昌-民權,2023-05-02,9312
2344,華邦電,41,10,31,華南永昌-民權,2023-05-02,9312
9902,台火,30,0,30,華南永昌-民權,2023-05-02,9312
1702,南僑,25,0,25,華南永昌-民權,2023-05-02,9312
3029,零壹,58,35,23,華南永昌-民權,2023-05-02,9312
4927,泰鼎-KY,22,0,22,華南永昌-民權,2023-05-02,9312
8383,千附,32,10,22,華南永昌-民權,2023-05-02,9312
1536,和大,20,0,20,華南永昌-民權,2023-05-02,9312
2331,精英,20,6,14,華南永昌-民權,2023-05-02,9312
5009,榮剛,27,13,14,華南永昌-民權,2023-05-02,9312
00772B,中信高評級公司債,12,0,12,華南永昌-民權,2023-05-02,9312
4747,強生,12,0,12,華南永昌-民權,2023-05-02,9312
2603,長榮,14,4,10,華南永昌-民權,2023-05-02,9312
1312,國喬,10,0,10,華南永昌-民權,2023-05-02,9312
2610,華航,10,0,10,華南永昌-民權,2023-05-02,9312
3062,建漢,10,0,10,華南永昌-民權,2023-05-02,9312
4549,桓達,10,0,10,華南永昌-民權,2023-05-02,9312
6288,聯嘉,10,0,10,華南永昌-民權,2023-05-02,9312
00687B,國泰20年美債,13,3,10,華南永昌-民權,2023-05-02,9312
1717,長興,10,1,9,華南永昌-民權,2023-05-02,9312
2609,陽明,12,3,9,華南永昌-民權,2023-05-02,9312
5222,全訊,10,1,9,華南永昌-民權,2023-05-02,9312
1721,三晃,8,0,8,華南永昌-民權,2023-05-02,9312
3357,臺慶科,8,0,8,華南永昌-民權,2023-05-02,9312
2887,台新金,10,3,7,華南永昌-民權,2023-05-02,9312
4174,浩鼎,7,0,7,華南永昌-民權,2023-05-02,9312
6148,驊宏資,12,5,7,華南永昌-民權,2023-05-02,9312
6669,緯穎,8,1,7,華南永昌-民權,2023-05-02,9312
2884,玉山金,36,30,6,華南永昌-民權,2023-05-02,9312
00679B,元大美債20年,6,0,6,華南永昌-民權,2023-05-02,9312
1611,中電,8,2,6,華南永昌-民權,2023-05-02,9312
3027,盛達,19,13,6,華南永昌-民權,2023-05-02,9312
4541,晟田,23,17,6,華南永昌-民權,2023-05-02,9312
8358,金居,12,6,6,華南永昌-民權,2023-05-02,9312
8222,寶一,8,2,6,華南永昌-民權,2023-05-02,9312
1701,中化,5,0,5,華南永昌-民權,2023-05-02,9312
1789,神隆,5,0,5,華南永昌-民權,2023-05-02,9312
2020,美亞,5,0,5,華南永昌-民權,2023-05-02,9312
2022,聚亨,6,1,5,華南永昌-民權,2023-05-02,9312
2369,菱生,5,0,5,華南永昌-民權,2023-05-02,9312
3013,晟銘電,5,0,5,華南永昌-民權,2023-05-02,9312
3374,精材,5,0,5,華南永昌-民權,2023-05-02,9312
4121,優盛,6,1,5,華南永昌-民權,2023-05-02,9312
4566,時碩工業,5,0,5,華南永昌-民權,2023-05-02,9312
2897,王道銀行,104,54,50,華南永昌-民權,2023-05-03,9312
5222,全訊,41,16,25,華南永昌-民權,2023-05-03,9312
00715L,期街口布蘭特正2,24,0,24,華南永昌-民權,2023-05-03,9312
00712,復華富時不動產,24,0,24,華南永昌-民權,2023-05-03,9312
2417,圓剛,38,15,23,華南永昌-民權,2023-05-03,9312
6188,廣明,20,0,20,華南永昌-民權,2023-05-03,9312
2609,陽明,23,4,19,華南永昌-民權,2023-05-03,9312
8046,南電,18,1,17,華南永昌-民權,2023-05-03,9312
00878,國泰永續高股息,19,3,16,華南永昌-民權,2023-05-03,9312
8927,北基,25,10,15,華南永昌-民權,2023-05-03,9312
8033,雷虎,15,1,14,華南永昌-民權,2023-05-03,9312
1101,台泥,14,1,13,華南永昌-民權,2023-05-03,9312
3357,臺慶科,12,0,12,華南永昌-民權,2023-05-03,9312
2002,中鋼,13,1,12,華南永昌-民權,2023-05-03,9312
5009,榮剛,13,1,12,華南永昌-民權,2023-05-03,9312
1721,三晃,10,0,10,華南永昌-民權,2023-05-03,9312
1312,國喬,10,0,10,華南永昌-民權,2023-05-03,9312
1702,南僑,10,0,10,華南永昌-民權,2023-05-03,9312
2530,華建,11,1,10,華南永昌-民權,2023-05-03,9312
3029,零壹,20,10,10,華南永昌-民權,2023-05-03,9312
3624,光頡,10,0,10,華南永昌-民權,2023-05-03,9312
00753L,中信中國50正2,9,0,9,華南永昌-民權,2023-05-03,9312
6269,台郡,9,0,9,華南永昌-民權,2023-05-03,9312
00885,富邦越南,11,2,9,華南永昌-民權,2023-05-03,9312
1514,亞力,12,4,8,華南永昌-民權,2023-05-03,9312
2880,華南金,9,1,8,華南永昌-民權,2023-05-03,9312
4979,華星光,12,4,8,華南永昌-民權,2023-05-03,9312
4541,晟田,38,31,7,華南永昌-民權,2023-05-03,9312
4942,嘉彰,7,0,7,華南永昌-民權,2023-05-03,9312
2330,台積電,12,5,7,華南永昌-民權,2023-05-03,9312
2615,萬海,7,0,7,華南永昌-民權,2023-05-03,9312
1785,光洋科,6,0,6,華南永昌-民權,2023-05-03,9312
2208,台船,7,1,6,華南永昌-民權,2023-05-03,9312
2453,凌群,6,0,6,華南永昌-民權,2023-05-03,9312
2484,希華,6,0,6,華南永昌-民權,2023-05-03,9312
2867,三商壽,6,0,6,華南永昌-民權,2023-05-03,9312
3025,星通,6,0,6,華南永昌-民權,2023-05-03,9312
3081,聯亞,6,0,6,華南永昌-民權,2023-05-03,9312
00690,兆豐藍籌30,5,0,5,華南永昌-民權,2023-05-03,9312
00670L,富邦NASDAQ正2,5,0,5,華南永昌-民權,2023-05-03,9312
2402,毅嘉,5,0,5,華南永昌-民權,2023-05-03,9312
2478,大毅,5,0,5,華南永昌-民權,2023-05-03,9312
8011,台通,5,0,5,華南永昌-民權,2023-05-03,9312
8383,千附,11,6,5,華南永昌-民權,2023-05-03,9312
3231,緯創,6,2,4,華南永昌-民權,2023-05-03,9312
00642U,期元大S＆P石油,4,0,4,華南永昌-民權,2023-05-03,9312
2317,鴻海,6,2,4,華南永昌-民權,2023-05-03,9312
3363,上詮,4,0,4,華南永昌-民權,2023-05-03,9312
3558,神準,12,8,4,華南永昌-民權,2023-05-03,9312
4746,台耀,17,13,4,華南永昌-民權,2023-05-03,9312
2834,臺企銀,302,0,302,華南永昌-民權,2023-05-04,9312
2208,台船,114,0,114,華南永昌-民權,2023-05-04,9312
2897,王道銀行,153,50,103,華南永昌-民權,2023-05-04,9312
5222,全訊,71,0,71,華南永昌-民權,2023-05-04,9312
2102,泰豐,50,0,50,華南永昌-民權,2023-05-04,9312
00715L,期街口布蘭特正2,22,0,22,華南永昌-民權,2023-05-04,9312
3231,緯創,23,1,22,華南永昌-民權,2023-05-04,9312
1514,亞力,27,6,21,華南永昌-民權,2023-05-04,9312
2881,富邦金,21,0,21,華南永昌-民權,2023-05-04,9312
2330,台積電,25,10,15,華南永昌-民權,2023-05-04,9312
1337,再生-KY,15,0,15,華南永昌-民權,2023-05-04,9312
4111,濟生,15,0,15,華南永昌-民權,2023-05-04,9312
00878,國泰永續高股息,16,1,15,華南永昌-民權,2023-05-04,9312
6163,華電網,15,1,14,華南永昌-民權,2023-05-04,9312
3013,晟銘電,14,2,12,華南永昌-民權,2023-05-04,9312
00772B,中信高評級公司債,11,0,11,華南永昌-民權,2023-05-04,9312
3419,譁裕,11,0,11,華南永昌-民權,2023-05-04,9312
00885,富邦越南,10,0,10,華南永昌-民權,2023-05-04,9312
00900,富邦特選高股息30,10,0,10,華南永昌-民權,2023-05-04,9312
1702,南僑,10,0,10,華南永昌-民權,2023-05-04,9312
1711,永光,10,0,10,華南永昌-民權,2023-05-04,9312
4942,嘉彰,10,0,10,華南永昌-民權,2023-05-04,9312
8033,雷虎,10,0,10,華南永昌-民權,2023-05-04,9312
2314,台揚,9,0,9,華南永昌-民權,2023-05-04,9312
4162,智擎,9,0,9,華南永昌-民權,2023-05-04,9312
2634,漢翔,10,2,8,華南永昌-民權,2023-05-04,9312
2478,大毅,8,0,8,華南永昌-民權,2023-05-04,9312
3548,兆利,7,0,7,華南永昌-民權,2023-05-04,9312
3624,光頡,7,0,7,華南永昌-民權,2023-05-04,9312
6269,台郡,7,0,7,華南永昌-民權,2023-05-04,9312
2317,鴻海,12,6,6,華南永昌-民權,2023-05-04,9312
1101,台泥,7,1,6,華南永昌-民權,2023-05-04,9312
00706L,期元大S＆P日圓正2,6,0,6,華南永昌-民權,2023-05-04,9312
2419,仲琦,6,0,6,華南永昌-民權,2023-05-04,9312
4760,勤凱,6,0,6,華南永昌-民權,2023-05-04,9312
1414,東和,5,0,5,華南永昌-民權,2023-05-04,9312
00670L,富邦NASDAQ正2,5,0,5,華南永昌-民權,2023-05-04,9312
00646,元大S＆P500,5,0,5,華南永昌-民權,2023-05-04,9312
00642U,期元大S＆P石油,5,0,5,華南永昌-民權,2023-05-04,9312
1809,中釉,5,0,5,華南永昌-民權,2023-05-04,9312
1810,和成,5,0,5,華南永昌-民權,2023-05-04,9312
2382,廣達,5,0,5,華南永昌-民權,2023-05-04,9312
6164,華興,5,0,5,華南永昌-民權,2023-05-04,9312
8111,立��,5,0,5,華南永昌-民權,2023-05-04,9312
8222,寶一,55,50,5,華南永昌-民權,2023-05-04,9312
3005,神基,5,1,4,華南永昌-民權,2023-05-04,9312
2002,中鋼,5,1,4,華南永昌-民權,2023-05-04,9312
2453,凌群,7,3,4,華南永昌-民權,2023-05-04,9312
00679B,元大美債20年,4,0,4,華南永昌-民權,2023-05-04,9312
1717,長興,4,0,4,華南永昌-民權,2023-05-04,9312
2881,富邦金,101,0,101,華南永昌-民權,2023-05-05,9312
3689,湧德,65,1,64,華南永昌-民權,2023-05-05,9312
1101,台泥,60,3,57,華南永昌-民權,2023-05-05,9312
1514,亞力,48,2,46,華南永昌-民權,2023-05-05,9312
8046,南電,42,1,41,華南永昌-民權,2023-05-05,9312
1783,和康生,19,2,17,華南永昌-民權,2023-05-05,9312
5009,榮剛,16,0,16,華南永昌-民權,2023-05-05,9312
4927,泰鼎-KY,15,0,15,華南永昌-民權,2023-05-05,9312
1504,東元,16,2,14,華南永昌-民權,2023-05-05,9312
2344,華邦電,16,4,12,華南永昌-民權,2023-05-05,9312
2482,連宇,11,0,11,華南永昌-民權,2023-05-05,9312
8072,陞泰,11,0,11,華南永昌-民權,2023-05-05,9312
8215,明基材,11,0,11,華南永昌-民權,2023-05-05,9312
2352,佳世達,12,1,11,華南永昌-民權,2023-05-05,9312
6443,元晶,17,7,10,華南永昌-民權,2023-05-05,9312
1310,台苯,10,0,10,華南永昌-民權,2023-05-05,9312
1536,和大,10,0,10,華南永昌-民權,2023-05-05,9312
4942,嘉彰,10,0,10,華南永昌-民權,2023-05-05,9312
00687B,國泰20年美債,10,1,9,華南永昌-民權,2023-05-05,9312
1721,三晃,63,54,9,華南永昌-民權,2023-05-05,9312
2464,盟立,9,0,9,華南永昌-民權,2023-05-05,9312
00772B,中信高評級公司債,8,0,8,華南永昌-民權,2023-05-05,9312
3006,晶豪科,8,0,8,華南永昌-民權,2023-05-05,9312
3624,光頡,8,0,8,華南永昌-民權,2023-05-05,9312
3680,家登,8,0,8,華南永昌-民權,2023-05-05,9312
2002,中鋼,8,1,7,華南永昌-民權,2023-05-05,9312
1529,樂事綠能,7,0,7,華南永昌-民權,2023-05-05,9312
1752,南光,7,0,7,華南永昌-民權,2023-05-05,9312
2453,凌群,6,0,6,華南永昌-民權,2023-05-05,9312
3027,盛達,11,5,6,華南永昌-民權,2023-05-05,9312
6160,欣技,7,1,6,華南永昌-民權,2023-05-05,9312
1337,再生-KY,5,0,5,華南永昌-民權,2023-05-05,9312
1110,東泥,5,0,5,華南永昌-民權,2023-05-05,9312
00637L,元大滬深300正2,5,0,5,華南永昌-民權,2023-05-05,9312
1710,東聯,5,0,5,華南永昌-民權,2023-05-05,9312
1760,寶齡富錦,5,0,5,華南永昌-民權,2023-05-05,9312
2801,彰銀,5,0,5,華南永昌-民權,2023-05-05,9312
3013,晟銘電,20,15,5,華南永昌-民權,2023-05-05,9312
3576,聯合再生,6,1,5,華南永昌-民權,2023-05-05,9312
4111,濟生,5,0,5,華南永昌-民權,2023-05-05,9312
4510,高鋒,5,0,5,華南永昌-民權,2023-05-05,9312
6167,久正,5,0,5,華南永昌-民權,2023-05-05,9312
6472,保瑞,11,6,5,華南永昌-民權,2023-05-05,9312
8155,博智,5,0,5,華南永昌-民權,2023-05-05,9312
9933,中鼎,5,0,5,華南永昌-民權,2023-05-05,9312
6129,普誠,4,0,4,華南永昌-民權,2023-05-05,9312
1905,華紙,5,1,4,華南永昌-民權,2023-05-05,9312
2314,台揚,4,0,4,華南永昌-民權,2023-05-05,9312
2460,建通,10,6,4,華南永昌-民權,2023-05-05,9312
3363,上詮,7,3,4,華南永昌-民權,2023-05-05,9312
2881,富邦金,150,1,149,華南永昌-民權,2023-05-08,9312
1605,華新,58,4,54,華南永昌-民權,2023-05-08,9312
2206,三陽工業,38,1,37,華南永昌-民權,2023-05-08,9312
6290,良維,27,0,27,華南永昌-民權,2023-05-08,9312
2883B,凱基金乙特,30,6,24,華南永昌-民權,2023-05-08,9312
3481,群創,25,3,22,華南永昌-民權,2023-05-08,9312
1762,中化生,20,0,20,華南永昌-民權,2023-05-08,9312
4123,晟德,20,0,20,華南永昌-民權,2023-05-08,9312
2834,臺企銀,16,0,16,華南永昌-民權,2023-05-08,9312
00882,中信中國高股息,15,1,14,華南永昌-民權,2023-05-08,9312
2884,玉山金,30,17,13,華南永昌-民權,2023-05-08,9312
6125,廣運,12,0,12,華南永昌-民權,2023-05-08,9312
00720B,元大投資級公司債,10,0,10,華南永昌-民權,2023-05-08,9312
1777,生泰,10,0,10,華南永昌-民權,2023-05-08,9312
2314,台揚,11,1,10,華南永昌-民權,2023-05-08,9312
2801,彰銀,10,0,10,華南永昌-民權,2023-05-08,9312
3652,精聯,10,0,10,華南永昌-民權,2023-05-08,9312
1722,台肥,10,1,9,華南永昌-民權,2023-05-08,9312
2330,台積電,10,1,9,華南永昌-民權,2023-05-08,9312
3419,譁裕,8,0,8,華南永昌-民權,2023-05-08,9312
1783,和康生,10,3,7,華南永昌-民權,2023-05-08,9312
2464,盟立,6,0,6,華南永昌-民權,2023-05-08,9312
3703,欣陸,6,0,6,華南永昌-民權,2023-05-08,9312
6589,台康生技,6,0,6,華南永昌-民權,2023-05-08,9312
2609,陽明,10,5,5,華南永昌-民權,2023-05-08,9312
3714,富采,6,1,5,華南永昌-民權,2023-05-08,9312
1616,億泰,5,0,5,華南永昌-民權,2023-05-08,9312
2413,環科,8,3,5,華南永昌-民權,2023-05-08,9312
3666,光耀,5,0,5,華南永昌-民權,2023-05-08,9312
4111,濟生,5,0,5,華南永昌-民權,2023-05-08,9312
4760,勤凱,5,0,5,華南永昌-民權,2023-05-08,9312
9933,中鼎,6,1,5,華南永昌-民權,2023-05-08,9312
1419,新紡,4,0,4,華南永昌-民權,2023-05-08,9312
00687B,國泰20年美債,4,0,4,華南永昌-民權,2023-05-08,9312
2344,華邦電,6,2,4,華南永昌-民權,2023-05-08,9312
3035,智原,5,1,4,華南永昌-民權,2023-05-08,9312
3338,泰碩,4,0,4,華南永昌-民權,2023-05-08,9312
4121,優盛,5,1,4,華南永昌-民權,2023-05-08,9312
4129,聯合,4,0,4,華南永昌-民權,2023-05-08,9312
4919,新唐,4,0,4,華南永昌-民權,2023-05-08,9312
6163,華電網,4,0,4,華南永昌-民權,2023-05-08,9312
3014,聯陽,4,1,3,華南永昌-民權,2023-05-08,9312
3207,耀勝,4,1,3,華南永昌-民權,2023-05-08,9312
1218,泰山,10,7,3,華南永昌-民權,2023-05-08,9312
2020,美亞,3,0,3,華南永昌-民權,2023-05-08,9312
2489,瑞軒,3,0,3,華南永昌-民權,2023-05-08,9312
2492,華新科,3,0,3,華南永昌-民權,2023-05-08,9312
2610,華航,3,0,3,華南永昌-民權,2023-05-08,9312
3038,全台,4,1,3,華南永昌-民權,2023-05-08,9312
3049,精金,3,0,3,華南永昌-民權,2023-05-08,9312
2897,王道銀行,100,0,100,華南永昌-民權,2023-05-09,9312
1785,光洋科,50,0,50,華南永昌-民權,2023-05-09,9312
1605,華新,106,60,46,華南永昌-民權,2023-05-09,9312
1101,台泥,37,3,34,華南永昌-民權,2023-05-09,9312
3029,零壹,42,13,29,華南永昌-民權,2023-05-09,9312
2413,環科,24,0,24,華南永昌-民權,2023-05-09,9312
3715,定穎投控,28,4,24,華南永昌-民權,2023-05-09,9312
6290,良維,23,0,23,華南永昌-民權,2023-05-09,9312
3652,精聯,21,0,21,華南永昌-民權,2023-05-09,9312
1799,易威,20,0,20,華南永昌-民權,2023-05-09,9312
00885,富邦越南,20,1,19,華南永昌-民權,2023-05-09,9312
6112,邁達特,18,1,17,華南永昌-民權,2023-05-09,9312
2515,中工,15,0,15,華南永昌-民權,2023-05-09,9312
6163,華電網,121,106,15,華南永昌-民權,2023-05-09,9312
1504,東元,21,9,12,華南永昌-民權,2023-05-09,9312
2457,飛宏,22,10,12,華南永昌-民權,2023-05-09,9312
2460,建通,13,1,12,華南永昌-民權,2023-05-09,9312
2913,農林,62,51,11,華南永昌-民權,2023-05-09,9312
4967,十銓,10,0,10,華南永昌-民權,2023-05-09,9312
1519,華城,17,7,10,華南永昌-民權,2023-05-09,9312
3356,奇偶,10,0,10,華南永昌-民權,2023-05-09,9312
4123,晟德,10,0,10,華南永昌-民權,2023-05-09,9312
5009,榮剛,19,9,10,華南永昌-民權,2023-05-09,9312
2888,新光金,9,0,9,華南永昌-民權,2023-05-09,9312
3058,立德,10,1,9,華南永昌-民權,2023-05-09,9312
6153,嘉聯益,9,0,9,華南永昌-民權,2023-05-09,9312
6266,泰詠,9,0,9,華南永昌-民權,2023-05-09,9312
2609,陽明,9,1,8,華南永昌-民權,2023-05-09,9312
2478,大毅,8,0,8,華南永昌-民權,2023-05-09,9312
3049,精金,8,0,8,華南永昌-民權,2023-05-09,9312
3624,光頡,13,5,8,華南永昌-民權,2023-05-09,9312
8358,金居,21,13,8,華南永昌-民權,2023-05-09,9312
2330,台積電,10,2,8,華南永昌-民權,2023-05-09,9312
00679B,元大美債20年,7,0,7,華南永昌-民權,2023-05-09,9312
4919,新唐,6,0,6,華南永昌-民權,2023-05-09,9312
3025,星通,16,10,6,華南永昌-民權,2023-05-09,9312
4153,鈺緯,6,0,6,華南永昌-民權,2023-05-09,9312
5315,光聯,6,0,6,華南永昌-民權,2023-05-09,9312
00920,富邦ESG綠色電力,5,0,5,華南永昌-民權,2023-05-09,9312
00751B,元大AAA至A公司債,5,0,5,華南永昌-民權,2023-05-09,9312
1438,三地開發,5,0,5,華南永昌-民權,2023-05-09,9312
1905,華紙,137,132,5,華南永昌-民權,2023-05-09,9312
2208,台船,8,3,5,華南永昌-民權,2023-05-09,9312
2453,凌群,5,0,5,華南永昌-民權,2023-05-09,9312
3027,盛達,19,14,5,華南永昌-民權,2023-05-09,9312
4968,立積,21,16,5,華南永昌-民權,2023-05-09,9312
6244,茂迪,6,1,5,華南永昌-民權,2023-05-09,9312
8478,東哥遊艇,5,0,5,華南永昌-民權,2023-05-09,9312
9933,中鼎,4,0,4,華南永昌-民權,2023-05-09,9312
2634,漢翔,10,6,4,華南永昌-民權,2023-05-09,9312
00885,富邦越南,421,201,220,華南永昌-民權,2023-05-10,9312
2344,華邦電,82,7,75,華南永昌-民權,2023-05-10,9312
2883B,凱基金乙特,41,8,33,華南永昌-民權,2023-05-10,9312
00878,國泰永續高股息,31,0,31,華南永昌-民權,2023-05-10,9312
1312,國喬,31,0,31,華南永昌-民權,2023-05-10,9312
2317,鴻海,31,2,29,華南永昌-民權,2023-05-10,9312
0056,元大高股息,27,1,26,華南永昌-民權,2023-05-10,9312
4906,正文,21,0,21,華南永昌-民權,2023-05-10,9312
3231,緯創,21,3,18,華南永昌-民權,2023-05-10,9312
3545,敦泰,16,0,16,華南永昌-民權,2023-05-10,9312
00680L,元大美債20正2,15,0,15,華南永昌-民權,2023-05-10,9312
2102,泰豐,15,0,15,華南永昌-民權,2023-05-10,9312
3652,精聯,12,0,12,華南永昌-民權,2023-05-10,9312
00882,中信中國高股息,11,0,11,華南永昌-民權,2023-05-10,9312
6235,華孚,14,3,11,華南永昌-民權,2023-05-10,9312
9904,寶成,11,0,11,華南永昌-民權,2023-05-10,9312
00637L,元大滬深300正2,10,0,10,華南永昌-民權,2023-05-10,9312
8096,擎亞,10,0,10,華南永昌-民權,2023-05-10,9312
8927,北基,30,20,10,華南永昌-民權,2023-05-10,9312
2352,佳世達,20,10,10,華南永昌-民權,2023-05-10,9312
2882,國泰金,12,3,9,華南永昌-民權,2023-05-10,9312
4162,智擎,8,0,8,華南永昌-民權,2023-05-10,9312
6160,欣技,32,24,8,華南永昌-民權,2023-05-10,9312
00633L,富邦上証正2,9,2,7,華南永昌-民權,2023-05-10,9312
4763,材料-KY,12,5,7,華南永昌-民權,2023-05-10,9312
1609,大亞,12,6,6,華南永昌-民權,2023-05-10,9312
00687B,國泰20年美債,8,2,6,華南永昌-民權,2023-05-10,9312
00920,富邦ESG綠色電力,5,0,5,華南永昌-民權,2023-05-10,9312
00706L,期元大S＆P日圓正2,5,0,5,華南永昌-民權,2023-05-10,9312
1905,華紙,5,0,5,華南永昌-民權,2023-05-10,9312
2449,京元電子,5,0,5,華南永昌-民權,2023-05-10,9312
6125,廣運,8,3,5,華南永昌-民權,2023-05-10,9312
6191,精成科,5,0,5,華南永昌-民權,2023-05-10,9312
8996,高力,10,5,5,華南永昌-民權,2023-05-10,9312
00713,元大台灣高息低波,4,0,4,華南永昌-民權,2023-05-10,9312
2303,聯電,4,0,4,華南永昌-民權,2023-05-10,9312
1101,台泥,4,0,4,華南永昌-民權,2023-05-10,9312
1326,台化,4,0,4,華南永昌-民權,2023-05-10,9312
2457,飛宏,19,15,4,華南永昌-民權,2023-05-10,9312
2618,長榮航,6,2,4,華南永昌-民權,2023-05-10,9312
3027,盛達,17,13,4,華南永昌-民權,2023-05-10,9312
3483,力致,5,1,4,華南永昌-民權,2023-05-10,9312
4746,台耀,15,11,4,華南永昌-民權,2023-05-10,9312
6863,永道-KY,4,0,4,華南永昌-民權,2023-05-10,9312
00679B,元大美債20年,4,1,3,華南永昌-民權,2023-05-10,9312
00670L,富邦NASDAQ正2,3,0,3,華南永昌-民權,2023-05-10,9312
00877,復華中國5G,3,0,3,華南永昌-民權,2023-05-10,9312
1584,精剛,4,1,3,華南永昌-民權,2023-05-10,9312
1799,易威,3,0,3,華南永昌-民權,2023-05-10,9312
2345,智邦,3,0,3,華南永昌-民權,2023-05-10,9312
00878,國泰永續高股息,89,6,83,華南永昌-民權,2023-05-11,9312
3652,精聯,58,0,58,華南永昌-民權,2023-05-11,9312
6122,擎邦,71,21,50,華南永昌-民權,2023-05-11,9312
9904,寶成,41,0,41,華南永昌-民權,2023-05-11,9312
1609,大亞,49,12,37,華南永昌-民權,2023-05-11,9312
2102,泰豐,30,0,30,華南永昌-民權,2023-05-11,9312
1909,榮成,30,2,28,華南永昌-民權,2023-05-11,9312
2610,華航,31,3,28,華南永昌-民權,2023-05-11,9312
1799,易威,25,0,25,華南永昌-民權,2023-05-11,9312
00679B,元大美債20年,22,0,22,華南永昌-民權,2023-05-11,9312
00632R,元大台灣50反1,20,0,20,華南永昌-民權,2023-05-11,9312
4939,亞電,18,2,16,華南永昌-民權,2023-05-11,9312
1514,亞力,14,0,14,華南永昌-民權,2023-05-11,9312
2208,台船,24,10,14,華南永昌-民權,2023-05-11,9312
1419,新紡,13,0,13,華南永昌-民權,2023-05-11,9312
3673,TPK-KY,13,0,13,華南永昌-民權,2023-05-11,9312
6143,振曜,13,0,13,華南永昌-民權,2023-05-11,9312
2014,中鴻,12,0,12,華南永昌-民權,2023-05-11,9312
9907,統一實,11,0,11,華南永昌-民權,2023-05-11,9312
4130,健亞,11,0,11,華南永昌-民權,2023-05-11,9312
1752,南光,11,0,11,華南永昌-民權,2023-05-11,9312
2329,華泰,11,0,11,華南永昌-民權,2023-05-11,9312
2413,環科,11,0,11,華南永昌-民權,2023-05-11,9312
2890,永豐金,11,0,11,華南永昌-民權,2023-05-11,9312
3715,定穎投控,11,0,11,華南永昌-民權,2023-05-11,9312
1605,華新,12,2,10,華南永昌-民權,2023-05-11,9312
1312,國喬,10,0,10,華南永昌-民權,2023-05-11,9312
2614,東森,10,0,10,華南永昌-民權,2023-05-11,9312
2706,第一店,10,0,10,華南永昌-民權,2023-05-11,9312
2851,中再保,10,0,10,華南永昌-民權,2023-05-11,9312
3356,奇偶,10,0,10,華南永昌-民權,2023-05-11,9312
8284,三竹,10,0,10,華南永昌-民權,2023-05-11,9312
8463,潤泰材,10,0,10,華南永昌-民權,2023-05-11,9312
2834,臺企銀,9,0,9,華南永昌-民權,2023-05-11,9312
3118,進階,9,0,9,華南永昌-民權,2023-05-11,9312
3209,全科,13,5,8,華南永昌-民權,2023-05-11,9312
2358,廷鑫,16,8,8,華南永昌-民權,2023-05-11,9312
2609,陽明,7,0,7,華南永昌-民權,2023-05-11,9312
2542,興富發,10,3,7,華南永昌-民權,2023-05-11,9312
2409,友達,12,5,7,華南永昌-民權,2023-05-11,9312
2478,大毅,7,0,7,華南永昌-民權,2023-05-11,9312
3689,湧德,7,0,7,華南永昌-民權,2023-05-11,9312
8403,盛弘,7,0,7,華南永昌-民權,2023-05-11,9312
4958,臻鼎-KY,7,1,6,華南永昌-民權,2023-05-11,9312
6180,橘子,6,0,6,華南永昌-民權,2023-05-11,9312
2464,盟立,6,0,6,華南永昌-民權,2023-05-11,9312
2485,兆赫,6,0,6,華南永昌-民權,2023-05-11,9312
6270,倍微,6,0,6,華南永昌-民權,2023-05-11,9312
6290,良維,6,0,6,華南永昌-民權,2023-05-11,9312
2330,台積電,16,11,5,華南永昌-民權,2023-05-11,9312
2888,新光金,198,51,147,華南永昌-民權,2023-05-12,9312
00676R,富邦臺灣加權反1,130,0,130,華南永昌-民權,2023-05-12,9312
00878,國泰永續高股息,60,14,46,華南永昌-民權,2023-05-12,9312
2412,中華電,35,1,34,華南永昌-民權,2023-05-12,9312
2102,泰豐,29,0,29,華南永昌-民權,2023-05-12,9312
3032,偉訓,15,0,15,華南永昌-民權,2023-05-12,9312
1605,華新,34,20,14,華南永昌-民權,2023-05-12,9312
4130,健亞,13,0,13,華南永昌-民權,2023-05-12,9312
1312,國喬,11,0,11,華南永昌-民權,2023-05-12,9312
2317,鴻海,137,127,10,華南永昌-民權,2023-05-12,9312
00706L,期元大S＆P日圓正2,10,0,10,華南永昌-民權,2023-05-12,9312
1727,中華化,13,3,10,華南永昌-民權,2023-05-12,9312
2464,盟立,10,0,10,華南永昌-民權,2023-05-12,9312
2618,長榮航,10,0,10,華南永昌-民權,2023-05-12,9312
2736,富野,10,0,10,華南永昌-民權,2023-05-12,9312
4927,泰鼎-KY,10,0,10,華南永昌-民權,2023-05-12,9312
2913,農林,8,0,8,華南永昌-民權,2023-05-12,9312
6160,欣技,68,60,8,華南永昌-民權,2023-05-12,9312
00893,國泰智能電動車,9,2,7,華南永昌-民權,2023-05-12,9312
2482,連宇,7,0,7,華南永昌-民權,2023-05-12,9312
2484,希華,7,0,7,華南永昌-民權,2023-05-12,9312
4566,時碩工業,7,0,7,華南永昌-民權,2023-05-12,9312
2883,凱基金,7,1,6,華南永昌-民權,2023-05-12,9312
1101,台泥,7,1,6,華南永昌-民權,2023-05-12,9312
2880,華南金,6,0,6,華南永昌-民權,2023-05-12,9312
1707,葡萄王,6,0,6,華南永昌-民權,2023-05-12,9312
3202,樺晟,6,0,6,華南永昌-民權,2023-05-12,9312
3376,新日興,6,0,6,華南永昌-民權,2023-05-12,9312
3481,群創,7,1,6,華南永昌-民權,2023-05-12,9312
6182,合晶,6,0,6,華南永昌-民權,2023-05-12,9312
00679B,元大美債20年,8,2,6,華南永昌-民權,2023-05-12,9312
00882,中信中國高股息,5,0,5,華南永昌-民權,2023-05-12,9312
1504,東元,8,3,5,華南永昌-民權,2023-05-12,9312
4743,合一,5,0,5,華南永昌-民權,2023-05-12,9312
1464,得力,5,0,5,華南永昌-民權,2023-05-12,9312
1314,中石化,6,1,5,華南永昌-民權,2023-05-12,9312
00712,復華富時不動產,5,0,5,華南永昌-民權,2023-05-12,9312
006208,富邦台50,5,0,5,華南永昌-民權,2023-05-12,9312
1589,永冠-KY,6,1,5,華南永昌-民權,2023-05-12,9312
2014,中鴻,5,0,5,華南永昌-民權,2023-05-12,9312
5488,松普,5,0,5,華南永昌-民權,2023-05-12,9312
0056,元大高股息,4,0,4,華南永昌-民權,2023-05-12,9312
1609,大亞,12,8,4,華南永昌-民權,2023-05-12,9312
2303,聯電,7,3,4,華南永昌-民權,2023-05-12,9312
4911,德英,4,0,4,華南永昌-民權,2023-05-12,9312
5291,邑昇,4,0,4,華南永昌-民權,2023-05-12,9312
2002,中鋼,3,0,3,華南永昌-民權,2023-05-12,9312
00887,永豐中國科技50大,3,0,3,華南永昌-民權,2023-05-12,9312
1503,士電,8,5,3,華南永昌-民權,2023-05-12,9312
1460,宏遠,3,0,3,華南永昌-民權,2023-05-12,9312
2101,南港,49,0,49,華南永昌-民權,2023-05-15,9312
1101,台泥,63,14,49,華南永昌-民權,2023-05-15,9312
2915,潤泰全,42,0,42,華南永昌-民權,2023-05-15,9312
3231,緯創,26,0,26,華南永昌-民權,2023-05-15,9312
2371,大同,60,35,25,華南永昌-民權,2023-05-15,9312
1419,新紡,23,0,23,華南永昌-民權,2023-05-15,9312
4130,健亞,21,0,21,華南永昌-民權,2023-05-15,9312
00676R,富邦臺灣加權反1,20,0,20,華南永昌-民權,2023-05-15,9312
3652,精聯,20,0,20,華南永昌-民權,2023-05-15,9312
2409,友達,20,3,17,華南永昌-民權,2023-05-15,9312
2349,錸德,17,1,16,華南永昌-民權,2023-05-15,9312
2887,台新金,17,5,12,華南永昌-民權,2023-05-15,9312
1337,再生-KY,14,2,12,華南永昌-民權,2023-05-15,9312
6122,擎邦,25,13,12,華南永昌-民權,2023-05-15,9312
4303,信立,11,0,11,華南永昌-民權,2023-05-15,9312
1310,台苯,10,0,10,華南永昌-民權,2023-05-15,9312
00652,富邦印度,18,8,10,華南永昌-民權,2023-05-15,9312
2412,中華電,10,0,10,華南永昌-民權,2023-05-15,9312
2614,東森,10,0,10,華南永昌-民權,2023-05-15,9312
3380,明泰,10,0,10,華南永昌-民權,2023-05-15,9312
3715,定穎投控,20,10,10,華南永昌-民權,2023-05-15,9312
4123,晟德,10,0,10,華南永昌-民權,2023-05-15,9312
3202,樺晟,8,0,8,華南永昌-民權,2023-05-15,9312
3017,奇鋐,8,1,7,華南永昌-民權,2023-05-15,9312
6180,橘子,7,0,7,華南永昌-民權,2023-05-15,9312
2102,泰豐,6,0,6,華南永昌-民權,2023-05-15,9312
2344,華邦電,8,2,6,華南永昌-民權,2023-05-15,9312
4111,濟生,6,0,6,華南永昌-民權,2023-05-15,9312
9943,好樂迪,6,0,6,華南永昌-民權,2023-05-15,9312
3105,穩懋,5,0,5,華南永昌-民權,2023-05-15,9312
2002,中鋼,6,1,5,華南永昌-民權,2023-05-15,9312
00715L,期街口布蘭特正2,5,0,5,華南永昌-民權,2023-05-15,9312
00706L,期元大S＆P日圓正2,5,0,5,華南永昌-民權,2023-05-15,9312
1587,吉茂,5,0,5,華南永昌-民權,2023-05-15,9312
1710,東聯,5,0,5,華南永昌-民權,2023-05-15,9312
1907,永豐餘,5,0,5,華南永昌-民權,2023-05-15,9312
2303,聯電,5,0,5,華南永昌-民權,2023-05-15,9312
2453,凌群,5,0,5,華南永昌-民權,2023-05-15,9312
3049,精金,5,0,5,華南永昌-民權,2023-05-15,9312
5531,鄉林,5,0,5,華南永昌-民權,2023-05-15,9312
8284,三竹,5,0,5,華南永昌-民權,2023-05-15,9312
9933,中鼎,5,0,5,華南永昌-民權,2023-05-15,9312
00679B,元大美債20年,5,0,5,華南永昌-民權,2023-05-15,9312
2331,精英,4,0,4,華南永昌-民權,2023-05-15,9312
2464,盟立,4,0,4,華南永昌-民權,2023-05-15,9312
2883,凱基金,4,0,4,華南永昌-民權,2023-05-15,9312
3224,三顧,7,3,4,華南永昌-民權,2023-05-15,9312
3374,精材,4,0,4,華南永昌-民權,2023-05-15,9312
4915,致伸,4,0,4,華南永昌-民權,2023-05-15,9312
5258,虹堡,7,3,4,華南永昌-民權,2023-05-15,9312
2101,南港,270,0,270,華南永昌-民權,2023-05-16,9312
3017,奇鋐,104,5,99,華南永昌-民權,2023-05-16,9312
2317,鴻海,77,1,76,華南永昌-民權,2023-05-16,9312
00632R,元大台灣50反1,60,0,60,華南永昌-民權,2023-05-16,9312
1419,新紡,35,0,35,華南永昌-民權,2023-05-16,9312
5531,鄉林,22,0,22,華南永昌-民權,2023-05-16,9312
2102,泰豐,20,0,20,華南永昌-民權,2023-05-16,9312
2323,中環,16,0,16,華南永昌-民權,2023-05-16,9312
00679B,元大美債20年,12,0,12,華南永昌-民權,2023-05-16,9312
1101,台泥,11,1,10,華南永昌-民權,2023-05-16,9312
2331,精英,20,10,10,華南永昌-民權,2023-05-16,9312
1609,大亞,21,12,9,華南永昌-民權,2023-05-16,9312
2736,富野,14,5,9,華南永昌-民權,2023-05-16,9312
2409,友達,8,0,8,華南永昌-民權,2023-05-16,9312
00772B,中信高評級公司債,6,0,6,華南永昌-民權,2023-05-16,9312
2337,旺宏,6,0,6,華南永昌-民權,2023-05-16,9312
4763,材料-KY,11,5,6,華南永昌-民權,2023-05-16,9312
1324,地球,5,0,5,華南永昌-民權,2023-05-16,9312
1110,東泥,5,0,5,華南永昌-民權,2023-05-16,9312
00687B,國泰20年美債,5,0,5,華南永昌-民權,2023-05-16,9312
00720B,元大投資級公司債,5,0,5,華南永昌-民權,2023-05-16,9312
2208,台船,5,0,5,華南永昌-民權,2023-05-16,9312
3206,志豐,5,0,5,華南永昌-民權,2023-05-16,9312
4581,光隆精密-KY,5,0,5,華南永昌-民權,2023-05-16,9312
6125,廣運,5,0,5,華南永昌-民權,2023-05-16,9312
6405,悅城,5,0,5,華南永昌-民權,2023-05-16,9312
6712,長聖,33,28,5,華南永昌-民權,2023-05-16,9312
2421,建準,4,0,4,華南永昌-民權,2023-05-16,9312
2359,所羅門,4,0,4,華南永昌-民權,2023-05-16,9312
2482,連宇,5,1,4,華南永昌-民權,2023-05-16,9312
4908,前鼎,5,1,4,華南永昌-民權,2023-05-16,9312
5009,榮剛,9,5,4,華南永昌-民權,2023-05-16,9312
5706,鳳凰,9,5,4,華南永昌-民權,2023-05-16,9312
7402,邑錡,4,0,4,華南永昌-民權,2023-05-16,9312
1905,華紙,3,0,3,華南永昌-民權,2023-05-16,9312
00751B,元大AAA至A公司債,3,0,3,華南永昌-民權,2023-05-16,9312
00725B,國泰投資級公司債,3,0,3,華南永昌-民權,2023-05-16,9312
1529,樂事綠能,6,3,3,華南永昌-民權,2023-05-16,9312
1789,神隆,3,0,3,華南永昌-民權,2023-05-16,9312
2451,創見,3,0,3,華南永昌-民權,2023-05-16,9312
2867,三商壽,3,0,3,華南永昌-民權,2023-05-16,9312
3062,建漢,3,0,3,華南永昌-民權,2023-05-16,9312
3202,樺晟,7,4,3,華南永昌-民權,2023-05-16,9312
4905,台聯電,3,0,3,華南永昌-民權,2023-05-16,9312
6270,倍微,3,0,3,華南永昌-民權,2023-05-16,9312
6470,宇智,3,0,3,華南永昌-民權,2023-05-16,9312
8403,盛弘,3,0,3,華南永昌-民權,2023-05-16,9312
8996,高力,8,5,3,華南永昌-民權,2023-05-16,9312
1504,東元,10,7,3,華南永昌-民權,2023-05-16,9312
4967,十銓,9,6,3,華南永昌-民權,2023-05-16,9312
00632R,元大台灣50反1,309,0,309,華南永昌-民權,2023-05-17,9312
00706L,期元大S＆P日圓正2,190,0,190,華南永昌-民權,2023-05-17,9312
3017,奇鋐,63,2,61,華南永昌-民權,2023-05-17,9312
00680L,元大美債20正2,41,0,41,華南永昌-民權,2023-05-17,9312
00878,國泰永續高股息,44,4,40,華南永昌-民權,2023-05-17,9312
3715,定穎投控,35,4,31,華南永昌-民權,2023-05-17,9312
2443,昶虹,30,0,30,華南永昌-民權,2023-05-17,9312
8222,寶一,28,2,26,華南永昌-民權,2023-05-17,9312
2884,玉山金,32,9,23,華南永昌-民權,2023-05-17,9312
00713,元大台灣高息低波,22,3,19,華南永昌-民權,2023-05-17,9312
00885,富邦越南,17,0,17,華南永昌-民權,2023-05-17,9312
4129,聯合,20,3,17,華南永昌-民權,2023-05-17,9312
00633L,富邦上証正2,15,0,15,華南永昌-民權,2023-05-17,9312
1612,宏泰,13,0,13,華南永昌-民權,2023-05-17,9312
0056,元大高股息,20,7,13,華南永昌-民權,2023-05-17,9312
2449,京元電子,12,0,12,華南永昌-民權,2023-05-17,9312
2371,大同,19,9,10,華南永昌-民權,2023-05-17,9312
2882,國泰金,10,0,10,華南永昌-民權,2023-05-17,9312
2883B,凱基金乙特,10,0,10,華南永昌-民權,2023-05-17,9312
3652,精聯,10,0,10,華南永昌-民權,2023-05-17,9312
3693,營邦,10,0,10,華南永昌-民權,2023-05-17,9312
2359,所羅門,9,0,9,華南永昌-民權,2023-05-17,9312
2402,毅嘉,12,4,8,華南永昌-民權,2023-05-17,9312
3694,海華,10,3,7,華南永昌-民權,2023-05-17,9312
4543,萬在,8,1,7,華南永昌-民權,2023-05-17,9312
1419,新紡,6,0,6,華南永昌-民權,2023-05-17,9312
5531,鄉林,6,0,6,華南永昌-民權,2023-05-17,9312
6214,精誠,6,0,6,華南永昌-民權,2023-05-17,9312
6282,康舒,9,3,6,華南永昌-民權,2023-05-17,9312
8076,伍豐,8,2,6,華南永昌-民權,2023-05-17,9312
1605,華新,6,0,6,華南永昌-民權,2023-05-17,9312
1809,中釉,5,0,5,華南永昌-民權,2023-05-17,9312
3010,華立,6,1,5,華南永昌-民權,2023-05-17,9312
3022,威強電,7,2,5,華南永昌-民權,2023-05-17,9312
3207,耀勝,11,6,5,華南永昌-民權,2023-05-17,9312
3576,聯合再生,5,0,5,華南永昌-民權,2023-05-17,9312
5498,凱崴,5,0,5,華南永昌-民權,2023-05-17,9312
6116,彩晶,5,0,5,華南永昌-民權,2023-05-17,9312
6770,力積電,5,0,5,華南永昌-民權,2023-05-17,9312
2337,旺宏,5,1,4,華南永昌-民權,2023-05-17,9312
2352,佳世達,5,1,4,華南永昌-民權,2023-05-17,9312
4966,譜瑞-KY,4,0,4,華南永昌-民權,2023-05-17,9312
2382,廣達,6,2,4,華南永昌-民權,2023-05-17,9312
2915,潤泰全,4,0,4,華南永昌-民權,2023-05-17,9312
3046,建��,8,4,4,華南永昌-民權,2023-05-17,9312
6535,順藥,4,0,4,華南永昌-民權,2023-05-17,9312
00924,復華S＆P500成長,4,1,3,華南永昌-民權,2023-05-17,9312
00637L,元大滬深300正2,3,0,3,華南永昌-民權,2023-05-17,9312
00712,復華富時不動產,3,0,3,華南永昌-民權,2023-05-17,9312
00751B,元大AAA至A公司債,3,0,3,華南永昌-民權,2023-05-17,9312
00680L,元大美債20正2,65,0,65,華南永昌-民權,2023-05-18,9312
2377,微星,40,0,40,華南永昌-民權,2023-05-18,9312
4108,懷特,38,0,38,華南永昌-民權,2023-05-18,9312
3017,奇鋐,45,10,35,華南永昌-民權,2023-05-18,9312
5324,士開,30,0,30,華南永昌-民權,2023-05-18,9312
2881,富邦金,30,2,28,華南永昌-民權,2023-05-18,9312
00632R,元大台灣50反1,53,27,26,華南永昌-民權,2023-05-18,9312
2736,富野,20,0,20,華南永昌-民權,2023-05-18,9312
3652,精聯,20,0,20,華南永昌-民權,2023-05-18,9312
1609,大亞,37,22,15,華南永昌-民權,2023-05-18,9312
1584,精剛,14,0,14,華南永昌-民權,2023-05-18,9312
2834,臺企銀,11,0,11,華南永昌-民權,2023-05-18,9312
00687B,國泰20年美債,10,0,10,華南永昌-民權,2023-05-18,9312
4123,晟德,10,0,10,華南永昌-民權,2023-05-18,9312
1905,華紙,14,5,9,華南永昌-民權,2023-05-18,9312
8076,伍豐,13,4,9,華南永昌-民權,2023-05-18,9312
5498,凱崴,8,0,8,華南永昌-民權,2023-05-18,9312
3664,安瑞-KY,7,0,7,華南永昌-民權,2023-05-18,9312
4916,事欣科,7,0,7,華南永昌-民權,2023-05-18,9312
2409,友達,12,6,6,華南永昌-民權,2023-05-18,9312
2634,漢翔,8,2,6,華南永昌-民權,2023-05-18,9312
1589,永冠-KY,6,0,6,華南永昌-民權,2023-05-18,9312
1709,和益,6,0,6,華南永昌-民權,2023-05-18,9312
2468,華經,9,3,6,華南永昌-民權,2023-05-18,9312
8467,波力-KY,6,0,6,華南永昌-民權,2023-05-18,9312
1303,南亞,5,0,5,華南永昌-民權,2023-05-18,9312
00670L,富邦NASDAQ正2,5,0,5,華南永昌-民權,2023-05-18,9312
2845,遠東銀,5,0,5,華南永昌-民權,2023-05-18,9312
8271,宇瞻,5,0,5,華南永昌-民權,2023-05-18,9312
3034,聯詠,4,0,4,華南永昌-民權,2023-05-18,9312
3013,晟銘電,4,0,4,華南永昌-民權,2023-05-18,9312
6472,保瑞,4,0,4,華南永昌-民權,2023-05-18,9312
6753,龍德造船,4,0,4,華南永昌-民權,2023-05-18,9312
2630,亞航,35,32,3,華南永昌-民權,2023-05-18,9312
00720B,元大投資級公司債,3,0,3,華南永昌-民權,2023-05-18,9312
2449,京元電子,7,4,3,華南永昌-民權,2023-05-18,9312
3059,華晶科,3,0,3,華南永昌-民權,2023-05-18,9312
3466,德晉,3,0,3,華南永昌-民權,2023-05-18,9312
5425,台半,13,10,3,華南永昌-民權,2023-05-18,9312
6143,振曜,3,0,3,華南永昌-民權,2023-05-18,9312
6176,瑞儀,3,0,3,華南永昌-民權,2023-05-18,9312
8011,台通,3,0,3,華南永昌-民權,2023-05-18,9312
6770,力積電,3,0,3,華南永昌-民權,2023-05-18,9312
1605,華新,6,4,2,華南永昌-民權,2023-05-18,9312
6282,康舒,6,4,2,華南永昌-民權,2023-05-18,9312
1513,中興電,23,21,2,華南永昌-民權,2023-05-18,9312
2451,創見,2,0,2,華南永昌-民權,2023-05-18,9312
1301,台塑,2,0,2,華南永昌-民權,2023-05-18,9312
00751B,元大AAA至A公司債,2,0,2,華南永昌-民權,2023-05-18,9312
2314,台揚,2,0,2,華南永昌-民權,2023-05-18,9312
00632R,元大台灣50反1,315,0,315,華南永昌-民權,2023-05-19,9312
00706L,期元大S＆P日圓正2,110,0,110,華南永昌-民權,2023-05-19,9312
3652,精聯,65,0,65,華南永昌-民權,2023-05-19,9312
2610,華航,84,24,60,華南永昌-民權,2023-05-19,9312
00885,富邦越南,55,0,55,華南永昌-民權,2023-05-19,9312
2376,技嘉,50,0,50,華南永昌-民權,2023-05-19,9312
00680L,元大美債20正2,46,0,46,華南永昌-民權,2023-05-19,9312
3710,連展投控,43,0,43,華南永昌-民權,2023-05-19,9312
2881,富邦金,50,13,37,華南永昌-民權,2023-05-19,9312
3029,零壹,61,37,24,華南永昌-民權,2023-05-19,9312
2453,凌群,33,9,24,華南永昌-民權,2023-05-19,9312
4931,新盛力,21,1,20,華南永昌-民權,2023-05-19,9312
1605,華新,19,1,18,華南永昌-民權,2023-05-19,9312
8358,金居,22,6,16,華南永昌-民權,2023-05-19,9312
1101,台泥,17,2,15,華南永昌-民權,2023-05-19,9312
2317,鴻海,16,1,15,華南永昌-民權,2023-05-19,9312
2883,凱基金,15,0,15,華南永昌-民權,2023-05-19,9312
2471,資通,11,0,11,華南永昌-民權,2023-05-19,9312
2834,臺企銀,11,0,11,華南永昌-民權,2023-05-19,9312
1312,國喬,10,0,10,華南永昌-民權,2023-05-19,9312
4111,濟生,10,0,10,華南永昌-民權,2023-05-19,9312
00679B,元大美債20年,9,0,9,華南永昌-民權,2023-05-19,9312
1905,華紙,13,4,9,華南永昌-民權,2023-05-19,9312
2515,中工,10,1,9,華南永昌-民權,2023-05-19,9312
2634,漢翔,24,15,9,華南永昌-民權,2023-05-19,9312
00637L,元大滬深300正2,22,15,7,華南永昌-民權,2023-05-19,9312
1419,新紡,7,0,7,華南永昌-民權,2023-05-19,9312
1752,南光,7,0,7,華南永昌-民權,2023-05-19,9312
4967,十銓,8,1,7,華南永昌-民權,2023-05-19,9312
6235,華孚,9,3,6,華南永昌-民權,2023-05-19,9312
1513,中興電,10,4,6,華南永昌-民權,2023-05-19,9312
3704,合勤控,15,9,6,華南永昌-民權,2023-05-19,9312
5289,宜鼎,6,0,6,華南永昌-民權,2023-05-19,9312
6245,立端,7,1,6,華南永昌-民權,2023-05-19,9312
6288,聯嘉,7,1,6,華南永昌-民權,2023-05-19,9312
2633,台灣高鐵,10,5,5,華南永昌-民權,2023-05-19,9312
3363,上詮,12,7,5,華南永昌-民權,2023-05-19,9312
6167,久正,5,0,5,華南永昌-民權,2023-05-19,9312
6290,良維,5,0,5,華南永昌-民權,2023-05-19,9312
6589,台康生技,5,0,5,華南永昌-民權,2023-05-19,9312
8213,志超,5,0,5,華南永昌-民權,2023-05-19,9312
3443,創意,10,5,5,華南永昌-民權,2023-05-19,9312
3017,奇鋐,18,14,4,華南永昌-民權,2023-05-19,9312
00882,中信中國高股息,4,0,4,華南永昌-民權,2023-05-19,9312
00772B,中信高評級公司債,4,0,4,華南永昌-民權,2023-05-19,9312
1514,亞力,10,6,4,華南永昌-民權,2023-05-19,9312
1735,日勝化,4,0,4,華南永昌-民權,2023-05-19,9312
2731,雄獅,9,5,4,華南永昌-民權,2023-05-19,9312
3038,全台,6,2,4,華南永昌-民權,2023-05-19,9312
3491,昇達科,7,3,4,華南永昌-民權,2023-05-19,9312
2101,南港,180,0,180,華南永昌-民權,2023-05-22,9312
2376,技嘉,60,0,60,華南永昌-民權,2023-05-22,9312
00680L,元大美債20正2,48,0,48,華南永昌-民權,2023-05-22,9312
2323,中環,34,2,32,華南永昌-民權,2023-05-22,9312
3481,群創,44,17,27,華南永昌-民權,2023-05-22,9312
1101,台泥,41,16,25,華南永昌-民權,2023-05-22,9312
2303,聯電,25,2,23,華南永昌-民權,2023-05-22,9312
00706L,期元大S＆P日圓正2,20,0,20,華南永昌-民權,2023-05-22,9312
2739,寒舍,20,0,20,華南永昌-民權,2023-05-22,9312
6188,廣明,19,2,17,華南永昌-民權,2023-05-22,9312
1419,新紡,16,0,16,華南永昌-民權,2023-05-22,9312
3443,創意,16,0,16,華南永昌-民權,2023-05-22,9312
2867,三商壽,15,0,15,華南永昌-民權,2023-05-22,9312
1605,華新,14,0,14,華南永昌-民權,2023-05-22,9312
1312,國喬,14,0,14,華南永昌-民權,2023-05-22,9312
9943,好樂迪,14,0,14,華南永昌-民權,2023-05-22,9312
006208,富邦台50,13,0,13,華南永昌-民權,2023-05-22,9312
00712,復華富時不動產,11,0,11,華南永昌-民權,2023-05-22,9312
6167,久正,14,3,11,華南永昌-民權,2023-05-22,9312
00885,富邦越南,11,1,10,華南永昌-民權,2023-05-22,9312
2915,潤泰全,10,0,10,華南永昌-民權,2023-05-22,9312
00687B,國泰20年美債,10,0,10,華南永昌-民權,2023-05-22,9312
1806,冠軍,10,0,10,華南永昌-民權,2023-05-22,9312
2332,友訊,10,0,10,華南永昌-民權,2023-05-22,9312
6148,驊宏資,14,4,10,華南永昌-民權,2023-05-22,9312
6165,浪凡,10,0,10,華南永昌-民權,2023-05-22,9312
8021,尖點,10,0,10,華南永昌-民權,2023-05-22,9312
8935,邦泰,10,0,10,華南永昌-民權,2023-05-22,9312
3037,欣興,11,2,9,華南永昌-民權,2023-05-22,9312
00715L,期街口布蘭特正2,6,0,6,華南永昌-民權,2023-05-22,9312
6243,迅杰,6,0,6,華南永昌-民權,2023-05-22,9312
8046,南電,5,0,5,華南永昌-民權,2023-05-22,9312
00882,中信中國高股息,5,0,5,華南永昌-民權,2023-05-22,9312
1611,中電,5,0,5,華南永昌-民權,2023-05-22,9312
2402,毅嘉,5,0,5,華南永昌-民權,2023-05-22,9312
3221,台嘉碩,5,0,5,華南永昌-民權,2023-05-22,9312
6152,百一,5,0,5,華南永昌-民權,2023-05-22,9312
6509,聚和,5,0,5,華南永昌-民權,2023-05-22,9312
6535,順藥,5,0,5,華南永昌-民權,2023-05-22,9312
1618,合機,5,1,4,華南永昌-民權,2023-05-22,9312
1314,中石化,4,0,4,華南永昌-民權,2023-05-22,9312
00751B,元大AAA至A公司債,4,0,4,華南永昌-民權,2023-05-22,9312
00772B,中信高評級公司債,4,0,4,華南永昌-民權,2023-05-22,9312
3081,聯亞,14,10,4,華南永昌-民權,2023-05-22,9312
5243,乙盛-KY,5,2,3,華南永昌-民權,2023-05-22,9312
00670L,富邦NASDAQ正2,3,0,3,華南永昌-民權,2023-05-22,9312
1504,東元,23,20,3,華南永昌-民權,2023-05-22,9312
1529,樂事綠能,3,0,3,華南永昌-民權,2023-05-22,9312
1799,易威,3,0,3,華南永昌-民權,2023-05-22,9312
2009,第一銅,3,0,3,華南永昌-民權,2023-05-22,9312
3682,亞太電,60,0,60,華南永昌-民權,2023-05-23,9312
5531,鄉林,59,6,53,華南永昌-民權,2023-05-23,9312
1514,亞力,60,10,50,華南永昌-民權,2023-05-23,9312
3324,雙鴻,30,0,30,華南永昌-民權,2023-05-23,9312
2101,南港,30,0,30,華南永昌-民權,2023-05-23,9312
2634,漢翔,23,4,19,華南永昌-民權,2023-05-23,9312
00679B,元大美債20年,14,0,14,華南永昌-民權,2023-05-23,9312
4763,材料-KY,14,0,14,華南永昌-民權,2023-05-23,9312
2438,翔耀,13,0,13,華南永昌-民權,2023-05-23,9312
00882,中信中國高股息,11,0,11,華南永昌-民權,2023-05-23,9312
00713,元大台灣高息低波,11,0,11,華南永昌-民權,2023-05-23,9312
00773B,中信優先金融債,11,0,11,華南永昌-民權,2023-05-23,9312
00680L,元大美債20正2,61,50,11,華南永昌-民權,2023-05-23,9312
3481,群創,15,5,10,華南永昌-民權,2023-05-23,9312
2478,大毅,10,0,10,華南永昌-民權,2023-05-23,9312
2482,連宇,10,0,10,華南永昌-民權,2023-05-23,9312
6148,驊宏資,21,11,10,華南永昌-民權,2023-05-23,9312
2457,飛宏,20,11,9,華南永昌-民權,2023-05-23,9312
5236,凌陽創新,10,1,9,華南永昌-民權,2023-05-23,9312
4934,太極,8,0,8,華南永昌-民權,2023-05-23,9312
3363,上詮,12,5,7,華南永昌-民權,2023-05-23,9312
0056,元大高股息,8,1,7,華南永昌-民權,2023-05-23,9312
00632R,元大台灣50反1,6,0,6,華南永昌-民權,2023-05-23,9312
2731,雄獅,16,10,6,華南永昌-民權,2023-05-23,9312
5258,虹堡,7,1,6,華南永昌-民權,2023-05-23,9312
6535,順藥,10,4,6,華南永昌-民權,2023-05-23,9312
1605,華新,26,20,6,華南永昌-民權,2023-05-23,9312
1419,新紡,5,0,5,華南永昌-民權,2023-05-23,9312
1513,中興電,18,13,5,華南永昌-民權,2023-05-23,9312
2105,正新,5,0,5,華南永昌-民權,2023-05-23,9312
2208,台船,5,0,5,華南永昌-民權,2023-05-23,9312
2393,億光,5,0,5,華南永昌-民權,2023-05-23,9312
3413,京鼎,5,0,5,華南永昌-民權,2023-05-23,9312
4129,聯合,5,0,5,華南永昌-民權,2023-05-23,9312
6282,康舒,10,5,5,華南永昌-民權,2023-05-23,9312
8358,金居,6,1,5,華南永昌-民權,2023-05-23,9312
2603,長榮,19,15,4,華南永昌-民權,2023-05-23,9312
8099,大世科,7,3,4,華南永昌-民權,2023-05-23,9312
1785,光洋科,5,1,4,華南永昌-民權,2023-05-23,9312
1904,正隆,4,0,4,華南永昌-民權,2023-05-23,9312
2250,IKKA-KY,4,0,4,華南永昌-民權,2023-05-23,9312
2609,陽明,6,2,4,華南永昌-民權,2023-05-23,9312
2748,雲品,27,23,4,華南永昌-民權,2023-05-23,9312
3022,威強電,4,0,4,華南永昌-民權,2023-05-23,9312
3357,臺慶科,4,0,4,華南永昌-民權,2023-05-23,9312
3491,昇達科,4,0,4,華南永昌-民權,2023-05-23,9312
3518,柏騰,4,0,4,華南永昌-民權,2023-05-23,9312
3557,嘉威,4,0,4,華南永昌-民權,2023-05-23,9312
4909,新復興,4,0,4,華南永昌-民權,2023-05-23,9312
6470,宇智,4,0,4,華南永昌-民權,2023-05-23,9312
2317,鴻海,65,5,60,華南永昌-民權,2023-05-24,9312
00885,富邦越南,52,0,52,華南永昌-民權,2023-05-24,9312
2610,華航,41,5,36,華南永昌-民權,2023-05-24,9312
00713,元大台灣高息低波,25,0,25,華南永昌-民權,2023-05-24,9312
0056,元大高股息,25,3,22,華南永昌-民權,2023-05-24,9312
00679B,元大美債20年,22,1,21,華南永昌-民權,2023-05-24,9312
2892,第一金,20,0,20,華南永昌-民權,2023-05-24,9312
00888,永豐台灣ESG,20,0,20,華南永昌-民權,2023-05-24,9312
00878,國泰永續高股息,34,17,17,華南永昌-民權,2023-05-24,9312
2515,中工,16,0,16,華南永昌-民權,2023-05-24,9312
00637L,元大滬深300正2,14,0,14,華南永昌-民權,2023-05-24,9312
3078,僑威,13,0,13,華南永昌-民權,2023-05-24,9312
1419,新紡,12,0,12,華南永昌-民權,2023-05-24,9312
3652,精聯,12,0,12,華南永昌-民權,2023-05-24,9312
2344,華邦電,13,2,11,華南永昌-民權,2023-05-24,9312
2352,佳世達,11,0,11,華南永昌-民權,2023-05-24,9312
5009,榮剛,13,2,11,華南永昌-民權,2023-05-24,9312
6148,驊宏資,16,5,11,華南永昌-民權,2023-05-24,9312
00696B,富邦美債20年,10,0,10,華南永昌-民權,2023-05-24,9312
00671R,富邦NASDAQ反1,10,0,10,華南永昌-民權,2023-05-24,9312
1799,易威,10,0,10,華南永昌-民權,2023-05-24,9312
2913,農林,11,1,10,華南永昌-民權,2023-05-24,9312
1513,中興電,14,5,9,華南永昌-民權,2023-05-24,9312
00882,中信中國高股息,9,0,9,華南永昌-民權,2023-05-24,9312
3205,佰研,10,1,9,華南永昌-民權,2023-05-24,9312
2498,宏達電,10,1,9,華南永昌-民權,2023-05-24,9312
3324,雙鴻,26,18,8,華南永昌-民權,2023-05-24,9312
1101,台泥,21,13,8,華南永昌-民權,2023-05-24,9312
2362,藍天,8,0,8,華南永昌-民權,2023-05-24,9312
4564,元翎,9,1,8,華南永昌-民權,2023-05-24,9312
1504,東元,8,2,6,華南永昌-民權,2023-05-24,9312
3363,上詮,9,3,6,華南永昌-民權,2023-05-24,9312
2634,漢翔,19,14,5,華南永昌-民權,2023-05-24,9312
2883,凱基金,5,0,5,華南永昌-民權,2023-05-24,9312
00670L,富邦NASDAQ正2,5,0,5,華南永昌-民權,2023-05-24,9312
4120,友華,5,0,5,華南永昌-民權,2023-05-24,9312
5284,jpp-KY,6,1,5,華南永昌-民權,2023-05-24,9312
5512,力麒,27,22,5,華南永昌-民權,2023-05-24,9312
8021,尖點,5,0,5,華南永昌-民權,2023-05-24,9312
2399,映泰,7,2,5,華南永昌-民權,2023-05-24,9312
5324,士開,4,0,4,華南永昌-民權,2023-05-24,9312
6509,聚和,9,5,4,華南永昌-民權,2023-05-24,9312
8358,金居,5,1,4,華南永昌-民權,2023-05-24,9312
2201,裕隆,4,1,3,華南永昌-民權,2023-05-24,9312
00687B,國泰20年美債,3,0,3,華南永昌-民權,2023-05-24,9312
1608,華榮,4,1,3,華南永昌-民權,2023-05-24,9312
2301,光寶科,3,0,3,華南永昌-民權,2023-05-24,9312
2609,陽明,4,1,3,華南永昌-民權,2023-05-24,9312
3287,廣寰科,3,0,3,華南永昌-民權,2023-05-24,9312
4916,事欣科,4,1,3,華南永昌-民權,2023-05-24,9312
2610,華航,90,37,53,華南永昌-民權,2023-05-25,9312
3045,台灣大,50,0,50,華南永昌-民權,2023-05-25,9312
4541,晟田,42,0,42,華南永昌-民權,2023-05-25,9312
00882,中信中國高股息,41,1,40,華南永昌-民權,2023-05-25,9312
3661,世芯-KY,31,3,28,華南永昌-民權,2023-05-25,9312
2344,華邦電,36,11,25,華南永昌-民權,2023-05-25,9312
4108,懷特,24,0,24,華南永昌-民權,2023-05-25,9312
2352,佳世達,23,0,23,華南永昌-民權,2023-05-25,9312
3652,精聯,22,0,22,華南永昌-民權,2023-05-25,9312
00637L,元大滬深300正2,26,5,21,華南永昌-民權,2023-05-25,9312
00680L,元大美債20正2,21,0,21,華南永昌-民權,2023-05-25,9312
3419,譁裕,20,0,20,華南永昌-民權,2023-05-25,9312
2630,亞航,27,8,19,華南永昌-民權,2023-05-25,9312
00916,國泰全球品牌50,19,0,19,華南永昌-民權,2023-05-25,9312
2382,廣達,18,0,18,華南永昌-民權,2023-05-25,9312
00679B,元大美債20年,17,0,17,華南永昌-民權,2023-05-25,9312
2201,裕隆,16,1,15,華南永昌-民權,2023-05-25,9312
1101,台泥,14,0,14,華南永昌-民權,2023-05-25,9312
2108,南帝,14,0,14,華南永昌-民權,2023-05-25,9312
2706,第一店,11,0,11,華南永昌-民權,2023-05-25,9312
00893,國泰智能電動車,20,9,11,華南永昌-民權,2023-05-25,9312
00687B,國泰20年美債,11,0,11,華南永昌-民權,2023-05-25,9312
2498,宏達電,11,0,11,華南永昌-民權,2023-05-25,9312
6164,華興,11,0,11,華南永昌-民權,2023-05-25,9312
2890,永豐金,14,4,10,華南永昌-民權,2023-05-25,9312
1310,台苯,12,2,10,華南永昌-民權,2023-05-25,9312
00633L,富邦上証正2,10,0,10,華南永昌-民權,2023-05-25,9312
2027,大成鋼,10,0,10,華南永昌-民權,2023-05-25,9312
2101,南港,10,0,10,華南永昌-民權,2023-05-25,9312
2419,仲琦,10,0,10,華南永昌-民權,2023-05-25,9312
2701,萬企,11,1,10,華南永昌-民權,2023-05-25,9312
2867,三商壽,10,0,10,華南永昌-民權,2023-05-25,9312
8048,德勝,10,0,10,華南永昌-民權,2023-05-25,9312
2002,中鋼,9,0,9,華南永昌-民權,2023-05-25,9312
2891,中信金,10,1,9,華南永昌-民權,2023-05-25,9312
2834,臺企銀,8,0,8,華南永昌-民權,2023-05-25,9312
00772B,中信高評級公司債,13,5,8,華南永昌-民權,2023-05-25,9312
1609,大亞,43,35,8,華南永昌-民權,2023-05-25,9312
2302,麗正,10,2,8,華南永昌-民權,2023-05-25,9312
2887,台新金,8,0,8,華南永昌-民權,2023-05-25,9312
8358,金居,15,7,8,華南永昌-民權,2023-05-25,9312
8046,南電,12,5,7,華南永昌-民權,2023-05-25,9312
1110,東泥,7,0,7,華南永昌-民權,2023-05-25,9312
2331,精英,7,0,7,華南永昌-民權,2023-05-25,9312
4716,大立,7,0,7,華南永昌-民權,2023-05-25,9312
1513,中興電,20,13,7,華南永昌-民權,2023-05-25,9312
00752,中信中國50,6,0,6,華南永昌-民權,2023-05-25,9312
00751B,元大AAA至A公司債,6,0,6,華南永昌-民權,2023-05-25,9312
1618,合機,6,0,6,華南永昌-民權,2023-05-25,9312
1799,易威,6,0,6,華南永昌-民權,2023-05-25,9312
2883,凱基金,105,5,100,華南永昌-民權,2023-05-26,9312
2103,台橡,52,0,52,華南永昌-民權,2023-05-26,9312
2881,富邦金,52,0,52,華南永昌-民權,2023-05-26,9312
2498,宏達電,40,0,40,華南永昌-民權,2023-05-26,9312
2108,南帝,39,0,39,華南永昌-民權,2023-05-26,9312
2915,潤泰全,36,0,36,華南永昌-民權,2023-05-26,9312
3652,精聯,32,0,32,華南永昌-民權,2023-05-26,9312
2101,南港,30,0,30,華南永昌-民權,2023-05-26,9312
8048,德勝,30,0,30,華南永昌-民權,2023-05-26,9312
00893,國泰智能電動車,30,3,27,華南永昌-民權,2023-05-26,9312
3205,佰研,20,0,20,華南永昌-民權,2023-05-26,9312
5531,鄉林,17,0,17,華南永昌-民權,2023-05-26,9312
1609,大亞,15,0,15,華南永昌-民權,2023-05-26,9312
3481,群創,13,0,13,華南永昌-民權,2023-05-26,9312
1101,台泥,13,0,13,華南永昌-民權,2023-05-26,9312
00679B,元大美債20年,18,5,13,華南永昌-民權,2023-05-26,9312
1589,永冠-KY,14,2,12,華南永昌-民權,2023-05-26,9312
2027,大成鋼,12,0,12,華南永昌-民權,2023-05-26,9312
3264,欣銓,48,36,12,華南永昌-民權,2023-05-26,9312
2409,友達,11,0,11,華南永昌-民權,2023-05-26,9312
2845,遠東銀,10,0,10,華南永昌-民權,2023-05-26,9312
00712,復華富時不動產,10,0,10,華南永昌-民權,2023-05-26,9312
00882,中信中國高股息,10,0,10,華南永昌-民權,2023-05-26,9312
2614,東森,10,0,10,華南永昌-民權,2023-05-26,9312
3356,奇偶,10,0,10,華南永昌-民權,2023-05-26,9312
6164,華興,10,0,10,華南永昌-民權,2023-05-26,9312
6569,醫揚,9,0,9,華南永昌-民權,2023-05-26,9312
4108,懷特,8,0,8,華南永昌-民權,2023-05-26,9312
6109,亞元,8,0,8,華南永昌-民權,2023-05-26,9312
1905,華紙,7,0,7,華南永昌-民權,2023-05-26,9312
1319,東陽,7,0,7,華南永昌-民權,2023-05-26,9312
1419,新紡,7,0,7,華南永昌-民權,2023-05-26,9312
3693,營邦,7,0,7,華南永昌-民權,2023-05-26,9312
00885,富邦越南,6,0,6,華南永昌-民權,2023-05-26,9312
2890,永豐金,6,0,6,華南永昌-民權,2023-05-26,9312
3715,定穎投控,8,2,6,華南永昌-民權,2023-05-26,9312
6148,驊宏資,12,6,6,華南永昌-民權,2023-05-26,9312
6276,安鈦克,6,0,6,華南永昌-民權,2023-05-26,9312
8150,南茂,6,0,6,華南永昌-民權,2023-05-26,9312
00687B,國泰20年美債,6,1,5,華南永昌-民權,2023-05-26,9312
00715L,期街口布蘭特正2,6,1,5,華南永昌-民權,2023-05-26,9312
1760,寶齡富錦,5,0,5,華南永昌-民權,2023-05-26,9312
2034,允強,5,0,5,華南永昌-民權,2023-05-26,9312
2356,英業達,12,7,5,華南永昌-民權,2023-05-26,9312
2809,京城銀,5,0,5,華南永昌-民權,2023-05-26,9312
2888,新光金,5,0,5,華南永昌-民權,2023-05-26,9312
3078,僑威,5,0,5,華南永昌-民權,2023-05-26,9312
5512,力麒,5,0,5,華南永昌-民權,2023-05-26,9312
6125,廣運,10,5,5,華南永昌-民權,2023-05-26,9312
00757,統一FANG+,6,1,5,華南永昌-民權,2023-05-26,9312
2371,大同,107,2,105,華南永昌-民權,2023-05-29,9312
2323,中環,78,6,72,華南永昌-民權,2023-05-29,9312
2101,南港,70,0,70,華南永昌-民權,2023-05-29,9312
2401,凌陽,50,0,50,華南永昌-民權,2023-05-29,9312
2897,王道銀行,101,55,46,華南永昌-民權,2023-05-29,9312
00882,中信中國高股息,32,0,32,華南永昌-民權,2023-05-29,9312
00680L,元大美債20正2,31,0,31,華南永昌-民權,2023-05-29,9312
4927,泰鼎-KY,30,0,30,華南永昌-民權,2023-05-29,9312
00713,元大台灣高息低波,27,1,26,華南永昌-民權,2023-05-29,9312
5531,鄉林,23,0,23,華南永昌-民權,2023-05-29,9312
1419,新紡,17,0,17,華南永昌-民權,2023-05-29,9312
3515,華擎,18,4,14,華南永昌-民權,2023-05-29,9312
8222,寶一,19,5,14,華南永昌-民權,2023-05-29,9312
00687B,國泰20年美債,14,2,12,華南永昌-民權,2023-05-29,9312
1312,國喬,10,0,10,華南永昌-民權,2023-05-29,9312
1727,中華化,10,0,10,華南永昌-民權,2023-05-29,9312
2313,華通,20,10,10,華南永昌-民權,2023-05-29,9312
6142,友勁,10,0,10,華南永昌-民權,2023-05-29,9312
00773B,中信優先金融債,9,0,9,華南永昌-民權,2023-05-29,9312
2303,聯電,34,25,9,華南永昌-民權,2023-05-29,9312
00670L,富邦NASDAQ正2,9,0,9,華南永昌-民權,2023-05-29,9312
00891,中信關鍵半導體,7,0,7,華南永昌-民權,2023-05-29,9312
00632R,元大台灣50反1,7,0,7,華南永昌-民權,2023-05-29,9312
1789,神隆,7,0,7,華南永昌-民權,2023-05-29,9312
2867,三商壽,7,0,7,華南永昌-民權,2023-05-29,9312
3708,上緯投控,7,0,7,華南永昌-民權,2023-05-29,9312
6288,聯嘉,12,5,7,華南永昌-民權,2023-05-29,9312
2002,中鋼,8,1,7,華南永昌-民權,2023-05-29,9312
2748,雲品,7,1,6,華南永昌-民權,2023-05-29,9312
3265,台星科,12,6,6,華南永昌-民權,2023-05-29,9312
3624,光頡,6,0,6,華南永昌-民權,2023-05-29,9312
6233,旺玖,6,0,6,華南永昌-民權,2023-05-29,9312
3037,欣興,11,5,6,華南永昌-民權,2023-05-29,9312
00637L,元大滬深300正2,5,0,5,華南永昌-民權,2023-05-29,9312
2382,廣達,8,3,5,華南永昌-民權,2023-05-29,9312
2461,光群雷,5,0,5,華南永昌-民權,2023-05-29,9312
3264,欣銓,7,2,5,華南永昌-民權,2023-05-29,9312
3498,陽程,5,0,5,華南永昌-民權,2023-05-29,9312
6165,浪凡,5,0,5,華南永昌-民權,2023-05-29,9312
6223,旺矽,5,0,5,華南永昌-民權,2023-05-29,9312
8040,九暘,5,0,5,華南永昌-民權,2023-05-29,9312
8926,台汽電,4,0,4,華南永昌-民權,2023-05-29,9312
1307,三芳,4,0,4,華南永昌-民權,2023-05-29,9312
00635U,期元大S＆P黃金,4,0,4,華南永昌-民權,2023-05-29,9312
1460,宏遠,4,0,4,華南永昌-民權,2023-05-29,9312
1525,江申,4,0,4,華南永昌-民權,2023-05-29,9312
2637,慧洋-KY,4,0,4,華南永昌-民權,2023-05-29,9312
3234,光環,4,0,4,華南永昌-民權,2023-05-29,9312
3380,明泰,4,0,4,華南永昌-民權,2023-05-29,9312
6112,邁達特,5,1,4,華南永昌-民權,2023-05-29,9312
2101,南港,210,0,210,華南永昌-民權,2023-05-30,9312
00753L,中信中國50正2,170,0,170,華南永昌-民權,2023-05-30,9312
2102,泰豐,100,0,100,華南永昌-民權,2023-05-30,9312
4927,泰鼎-KY,70,0,70,華南永昌-民權,2023-05-30,9312
2103,台橡,59,0,59,華南永昌-民權,2023-05-30,9312
6269,台郡,50,0,50,華南永昌-民權,2023-05-30,9312
3017,奇鋐,47,1,46,華南永昌-民權,2023-05-30,9312
00688L,國泰20年美債正2,45,0,45,華南永昌-民權,2023-05-30,9312
00882,中信中國高股息,38,0,38,華南永昌-民權,2023-05-30,9312
3406,玉晶光,28,0,28,華南永昌-民權,2023-05-30,9312
1419,新紡,27,0,27,華南永昌-民權,2023-05-30,9312
3515,華擎,27,1,26,華南永昌-民權,2023-05-30,9312
00637L,元大滬深300正2,33,10,23,華南永昌-民權,2023-05-30,9312
00680L,元大美債20正2,20,0,20,華南永昌-民權,2023-05-30,9312
2610,華航,57,40,17,華南永昌-民權,2023-05-30,9312
2883,凱基金,17,0,17,華南永昌-民權,2023-05-30,9312
2425,承啟,37,23,14,華南永昌-民權,2023-05-30,9312
2356,英業達,26,12,14,華南永昌-民權,2023-05-30,9312
4942,嘉彰,13,0,13,華南永昌-民權,2023-05-30,9312
2371,大同,44,31,13,華南永昌-民權,2023-05-30,9312
2368,金像電,16,4,12,華南永昌-民權,2023-05-30,9312
2634,漢翔,27,15,12,華南永昌-民權,2023-05-30,9312
6188,廣明,44,32,12,華南永昌-民權,2023-05-30,9312
2201,裕隆,16,5,11,華南永昌-民權,2023-05-30,9312
3481,群創,11,0,11,華南永昌-民權,2023-05-30,9312
1217,愛之味,10,0,10,華南永昌-民權,2023-05-30,9312
00679B,元大美債20年,10,0,10,華南永昌-民權,2023-05-30,9312
1799,易威,10,0,10,華南永昌-民權,2023-05-30,9312
8215,明基材,10,0,10,華南永昌-民權,2023-05-30,9312
2002,中鋼,29,20,9,華南永昌-民權,2023-05-30,9312
3715,定穎投控,11,2,9,華南永昌-民權,2023-05-30,9312
8033,雷虎,17,8,9,華南永昌-民權,2023-05-30,9312
2637,慧洋-KY,8,0,8,華南永昌-民權,2023-05-30,9312
3706,神達,11,3,8,華南永昌-民權,2023-05-30,9312
3029,零壹,28,20,8,華南永昌-民權,2023-05-30,9312
2337,旺宏,7,0,7,華南永昌-民權,2023-05-30,9312
6125,廣運,27,20,7,華南永昌-民權,2023-05-30,9312
8222,寶一,10,3,7,華南永昌-民權,2023-05-30,9312
00633L,富邦上証正2,6,0,6,華南永昌-民權,2023-05-30,9312
1789,神隆,6,0,6,華南永昌-民權,2023-05-30,9312
2453,凌群,10,4,6,華南永昌-民權,2023-05-30,9312
3704,合勤控,11,6,5,華南永昌-民權,2023-05-30,9312
00888,永豐台灣ESG,5,0,5,華南永昌-民權,2023-05-30,9312
1618,合機,5,0,5,華南永昌-民權,2023-05-30,9312
1760,寶齡富錦,5,0,5,華南永昌-民權,2023-05-30,9312
2329,華泰,15,10,5,華南永昌-民權,2023-05-30,9312
2457,飛宏,23,18,5,華南永昌-民權,2023-05-30,9312
2736,富野,5,0,5,華南永昌-民權,2023-05-30,9312
2748,雲品,5,0,5,華南永昌-民權,2023-05-30,9312
2897,王道銀行,100,95,5,華南永昌-民權,2023-05-30,9312
1609,大亞,401,104,297,華南永昌-民權,2023-05-31,9312
00632R,元大台灣50反1,290,0,290,華南永昌-民權,2023-05-31,9312
2845,遠東銀,111,0,111,華南永昌-民權,2023-05-31,9312
2367,燿華,78,0,78,華南永昌-民權,2023-05-31,9312
8011,台通,66,2,64,華南永昌-民權,2023-05-31,9312
4904,遠傳,50,0,50,華南永昌-民權,2023-05-31,9312
00637L,元大滬深300正2,63,15,48,華南永昌-民權,2023-05-31,9312
2461,光群雷,34,0,34,華南永昌-民權,2023-05-31,9312
1419,新紡,30,0,30,華南永昌-民權,2023-05-31,9312
3017,奇鋐,23,0,23,華南永昌-民權,2023-05-31,9312
00882,中信中國高股息,28,8,20,華南永昌-民權,2023-05-31,9312
00715L,期街口布蘭特正2,20,0,20,華南永昌-民權,2023-05-31,9312
2014,中鴻,20,0,20,華南永昌-民權,2023-05-31,9312
2101,南港,20,0,20,華南永昌-民權,2023-05-31,9312
6470,宇智,20,0,20,華南永昌-民權,2023-05-31,9312
2371,大同,40,22,18,華南永昌-民權,2023-05-31,9312
4108,懷特,14,0,14,華南永昌-民權,2023-05-31,9312
00642U,期元大S＆P石油,12,0,12,華南永昌-民權,2023-05-31,9312
2376,技嘉,16,5,11,華南永昌-民權,2023-05-31,9312
2614,東森,11,0,11,華南永昌-民權,2023-05-31,9312
4931,新盛力,11,0,11,華南永昌-民權,2023-05-31,9312
2457,飛宏,42,31,11,華南永昌-民權,2023-05-31,9312
00679B,元大美債20年,10,0,10,華南永昌-民權,2023-05-31,9312
2356,英業達,25,15,10,華南永昌-民權,2023-05-31,9312
4121,優盛,10,0,10,華南永昌-民權,2023-05-31,9312
4973,廣穎,40,30,10,華南永昌-民權,2023-05-31,9312
8358,金居,18,8,10,華南永昌-民權,2023-05-31,9312
00893,國泰智能電動車,15,7,8,華南永昌-民權,2023-05-31,9312
00633L,富邦上証正2,7,0,7,華南永昌-民權,2023-05-31,9312
1608,華榮,10,3,7,華南永昌-民權,2023-05-31,9312
2449,京元電子,24,17,7,華南永昌-民權,2023-05-31,9312
2891,中信金,7,0,7,華南永昌-民權,2023-05-31,9312
3231,緯創,11,4,7,華南永昌-民權,2023-05-31,9312
6441,廣錠,7,0,7,華南永昌-民權,2023-05-31,9312
2382,廣達,13,7,6,華南永昌-民權,2023-05-31,9312
3025,星通,7,1,6,華南永昌-民權,2023-05-31,9312
3059,華晶科,6,0,6,華南永昌-民權,2023-05-31,9312
9945,潤泰新,6,0,6,華南永昌-民權,2023-05-31,9312
00725B,國泰投資級公司債,6,0,6,華南永昌-民權,2023-05-31,9312
3037,欣興,12,7,5,華南永昌-民權,2023-05-31,9312
6180,橘子,5,0,5,華南永昌-民權,2023-05-31,9312
3661,世芯-KY,5,0,5,華南永昌-民權,2023-05-31,9312
1503,士電,7,2,5,華南永昌-民權,2023-05-31,9312
1438,三地開發,5,0,5,華南永昌-民權,2023-05-31,9312
1312,國喬,5,0,5,華南永昌-民權,2023-05-31,9312
1809,中釉,5,0,5,華南永昌-民權,2023-05-31,9312
2419,仲琦,5,0,5,華南永昌-民權,2023-05-31,9312
2530,華建,5,0,5,華南永昌-民權,2023-05-31,9312
2706,第一店,6,1,5,華南永昌-民權,2023-05-31,9312
3011,今皓,5,0,5,華南永昌-民權,2023-05-31,9312
2618,長榮航,533,117,416,華南永昌-民權,2023-06-01,9312
3231,緯創,208,19,189,華南永昌-民權,2023-06-01,9312
0056,元大高股息,103,15,88,華南永昌-民權,2023-06-01,9312
2421,建準,95,22,73,華南永昌-民權,2023-06-01,9312
2101,南港,69,0,69,華南永昌-民權,2023-06-01,9312
2897,王道銀行,50,1,49,華南永昌-民權,2023-06-01,9312
2344,華邦電,60,13,47,華南永昌-民權,2023-06-01,9312
2323,中環,202,164,38,華南永昌-民權,2023-06-01,9312
2515,中工,49,14,35,華南永昌-民權,2023-06-01,9312
1101,台泥,24,0,24,華南永昌-民權,2023-06-01,9312
2302,麗正,34,10,24,華南永昌-民權,2023-06-01,9312
3706,神達,31,7,24,華南永昌-民權,2023-06-01,9312
2903,遠百,20,0,20,華南永昌-民權,2023-06-01,9312
3324,雙鴻,22,2,20,華南永昌-民權,2023-06-01,9312
6269,台郡,30,10,20,華南永昌-民權,2023-06-01,9312
2449,京元電子,22,4,18,華南永昌-民權,2023-06-01,9312
4942,嘉彰,16,0,16,華南永昌-民權,2023-06-01,9312
1310,台苯,16,1,15,華南永昌-民權,2023-06-01,9312
2614,東森,11,0,11,華南永昌-民權,2023-06-01,9312
1524,耿鼎,10,0,10,華南永昌-民權,2023-06-01,9312
1795,美時,10,0,10,華南永昌-民權,2023-06-01,9312
2329,華泰,10,0,10,華南永昌-民權,2023-06-01,9312
3264,欣銓,10,0,10,華南永昌-民權,2023-06-01,9312
5351,鈺創,10,0,10,華南永昌-民權,2023-06-01,9312
5706,鳳凰,17,8,9,華南永昌-民權,2023-06-01,9312
1514,亞力,11,2,9,華南永昌-民權,2023-06-01,9312
8088,品安,10,1,9,華南永昌-民權,2023-06-01,9312
00642U,期元大S＆P石油,8,0,8,華南永昌-民權,2023-06-01,9312
6535,順藥,8,0,8,華南永昌-民權,2023-06-01,9312
2371,大同,11,3,8,華南永昌-民權,2023-06-01,9312
00878,國泰永續高股息,10,3,7,華南永昌-民權,2023-06-01,9312
1760,寶齡富錦,7,0,7,華南永昌-民權,2023-06-01,9312
2883,凱基金,7,0,7,華南永昌-民權,2023-06-01,9312
8033,雷虎,9,2,7,華南永昌-民權,2023-06-01,9312
1909,榮成,6,0,6,華南永昌-民權,2023-06-01,9312
00715L,期街口布蘭特正2,6,0,6,華南永昌-民權,2023-06-01,9312
1419,新紡,6,0,6,華南永昌-民權,2023-06-01,9312
2888,新光金,6,0,6,華南永昌-民權,2023-06-01,9312
2915,潤泰全,6,0,6,華南永昌-民權,2023-06-01,9312
8021,尖點,5,0,5,華南永昌-民權,2023-06-01,9312
1219,福壽,5,0,5,華南永昌-民權,2023-06-01,9312
00885,富邦越南,5,0,5,華南永昌-民權,2023-06-01,9312
2208,台船,5,0,5,華南永昌-民權,2023-06-01,9312
2250,IKKA-KY,5,0,5,華南永昌-民權,2023-06-01,9312
6148,驊宏資,6,1,5,華南永昌-民權,2023-06-01,9312
6161,捷波,5,0,5,華南永昌-民權,2023-06-01,9312
6732,昇佳電子,5,0,5,華南永昌-民權,2023-06-01,9312
8059,凱碩,9,4,5,華南永昌-民權,2023-06-01,9312
2630,亞航,26,21,5,華南永昌-民權,2023-06-01,9312
2359,所羅門,4,0,4,華南永昌-民權,2023-06-01,9312
00919,群益台灣精選高息,168,0,168,華南永昌-民權,2023-06-02,9312
2618,長榮航,174,46,128,華南永昌-民權,2023-06-02,9312
2101,南港,121,0,121,華南永昌-民權,2023-06-02,9312
3481,群創,100,13,87,華南永昌-民權,2023-06-02,9312
1419,新紡,66,0,66,華南永昌-民權,2023-06-02,9312
2412,中華電,65,0,65,華南永昌-民權,2023-06-02,9312
3017,奇鋐,57,0,57,華南永昌-民權,2023-06-02,9312
1905,華紙,235,180,55,華南永昌-民權,2023-06-02,9312
00882,中信中國高股息,43,1,42,華南永昌-民權,2023-06-02,9312
2610,華航,101,63,38,華南永昌-民權,2023-06-02,9312
2903,遠百,35,0,35,華南永昌-民權,2023-06-02,9312
1806,冠軍,27,2,25,華南永昌-民權,2023-06-02,9312
2614,東森,22,0,22,華南永昌-民權,2023-06-02,9312
2349,錸德,22,0,22,華南永昌-民權,2023-06-02,9312
2457,飛宏,41,19,22,華南永昌-民權,2023-06-02,9312
3661,世芯-KY,26,5,21,華南永昌-民權,2023-06-02,9312
1513,中興電,43,22,21,華南永昌-民權,2023-06-02,9312
2371,大同,73,53,20,華南永昌-民權,2023-06-02,9312
2347,聯強,20,0,20,華南永昌-民權,2023-06-02,9312
00722B,群益投資級電信債,20,0,20,華南永昌-民權,2023-06-02,9312
4128,中天,49,30,19,華南永昌-民權,2023-06-02,9312
2515,中工,20,2,18,華南永昌-民權,2023-06-02,9312
6732,昇佳電子,17,1,16,華南永昌-民權,2023-06-02,9312
3652,精聯,15,0,15,華南永昌-民權,2023-06-02,9312
3363,上詮,18,3,15,華南永昌-民權,2023-06-02,9312
1909,榮成,20,6,14,華南永昌-民權,2023-06-02,9312
1504,東元,32,20,12,華南永昌-民權,2023-06-02,9312
1710,東聯,12,0,12,華南永昌-民權,2023-06-02,9312
3706,神達,14,2,12,華南永昌-民權,2023-06-02,9312
3205,佰研,10,0,10,華南永昌-民權,2023-06-02,9312
4942,嘉彰,10,0,10,華南永昌-民權,2023-06-02,9312
5009,榮剛,10,0,10,華南永昌-民權,2023-06-02,9312
6275,元山,8,0,8,華南永昌-民權,2023-06-02,9312
4763,材料-KY,7,0,7,華南永昌-民權,2023-06-02,9312
2460,建通,7,0,7,華南永昌-民權,2023-06-02,9312
2890,永豐金,7,0,7,華南永昌-民權,2023-06-02,9312
3059,華晶科,7,0,7,華南永昌-民權,2023-06-02,9312
6269,台郡,10,3,7,華南永昌-民權,2023-06-02,9312
6753,龍德造船,8,1,7,華南永昌-民權,2023-06-02,9312
4564,元翎,7,1,6,華南永昌-民權,2023-06-02,9312
5243,乙盛-KY,16,10,6,華南永昌-民權,2023-06-02,9312
6163,華電網,6,0,6,華南永昌-民權,2023-06-02,9312
8201,無敵,6,0,6,華南永昌-民權,2023-06-02,9312
3006,晶豪科,7,1,6,華南永昌-民權,2023-06-02,9312
3443,創意,6,1,5,華南永昌-民權,2023-06-02,9312
2329,華泰,8,3,5,華南永昌-民權,2023-06-02,9312
3058,立德,5,0,5,華南永昌-民權,2023-06-02,9312
3305,昇貿,9,4,5,華南永昌-民權,2023-06-02,9312
6168,宏齊,6,1,5,華南永昌-民權,2023-06-02,9312
6215,和椿,5,0,5,華南永昌-民權,2023-06-02,9312
2618,長榮航,299,32,267,華南永昌-民權,2023-06-05,9312
2349,錸德,160,22,138,華南永昌-民權,2023-06-05,9312
1717,長興,111,0,111,華南永昌-民權,2023-06-05,9312
2888,新光金,91,25,66,華南永昌-民權,2023-06-05,9312
2610,華航,68,19,49,華南永昌-民權,2023-06-05,9312
4108,懷特,35,1,34,華南永昌-民權,2023-06-05,9312
1513,中興電,32,4,28,華南永昌-民權,2023-06-05,9312
2903,遠百,25,0,25,華南永昌-民權,2023-06-05,9312
3162,精確,35,10,25,華南永昌-民權,2023-06-05,9312
2344,華邦電,41,19,22,華南永昌-民權,2023-06-05,9312
00680L,元大美債20正2,20,0,20,華南永昌-民權,2023-06-05,9312
00919,群益台灣精選高息,19,0,19,華南永昌-民權,2023-06-05,9312
00878,國泰永續高股息,24,6,18,華南永昌-民權,2023-06-05,9312
3081,聯亞,20,3,17,華南永昌-民權,2023-06-05,9312
4942,嘉彰,16,0,16,華南永昌-民權,2023-06-05,9312
6167,久正,15,0,15,華南永昌-民權,2023-06-05,9312
2105,正新,15,1,14,華南永昌-民權,2023-06-05,9312
00720B,元大投資級公司債,13,0,13,華南永昌-民權,2023-06-05,9312
2353,宏��,17,4,13,華南永昌-民權,2023-06-05,9312
00637L,元大滬深300正2,47,35,12,華南永昌-民權,2023-06-05,9312
2722,夏都,13,1,12,華南永昌-民權,2023-06-05,9312
1314,中石化,11,0,11,華南永昌-民權,2023-06-05,9312
00795B,中信美國公債20年,11,0,11,華南永昌-民權,2023-06-05,9312
00712,復華富時不動產,10,0,10,華南永昌-民權,2023-06-05,9312
1337,再生-KY,10,0,10,華南永昌-民權,2023-06-05,9312
1410,南染,10,0,10,華南永昌-民權,2023-06-05,9312
1519,華城,14,4,10,華南永昌-民權,2023-06-05,9312
1524,耿鼎,10,0,10,華南永昌-民權,2023-06-05,9312
2701,萬企,10,0,10,華南永昌-民權,2023-06-05,9312
4564,元翎,10,0,10,華南永昌-民權,2023-06-05,9312
4927,泰鼎-KY,10,0,10,華南永昌-民權,2023-06-05,9312
6142,友勁,10,0,10,華南永昌-民權,2023-06-05,9312
9945,潤泰新,14,4,10,華南永昌-民權,2023-06-05,9312
00893,國泰智能電動車,11,1,10,華南永昌-民權,2023-06-05,9312
00882,中信中國高股息,9,0,9,華南永昌-民權,2023-06-05,9312
1104,環泥,10,2,8,華南永昌-民權,2023-06-05,9312
1419,新紡,8,0,8,華南永昌-民權,2023-06-05,9312
2340,台亞,9,1,8,華南永昌-民權,2023-06-05,9312
6589,台康生技,8,0,8,華南永昌-民權,2023-06-05,9312
8182,加高,8,0,8,華南永昌-民權,2023-06-05,9312
2449,京元電子,22,15,7,華南永昌-民權,2023-06-05,9312
2457,飛宏,35,28,7,華南永昌-民權,2023-06-05,9312
3029,零壹,10,3,7,華南永昌-民權,2023-06-05,9312
6120,達運,8,1,7,華南永昌-民權,2023-06-05,9312
2009,第一銅,6,0,6,華南永昌-民權,2023-06-05,9312
3630,新鉅科,6,0,6,華南永昌-民權,2023-06-05,9312
4967,十銓,6,0,6,華南永昌-民權,2023-06-05,9312
6456,GIS-KY,7,1,6,華南永昌-民權,2023-06-05,9312
2634,漢翔,9,4,5,華南永昌-民權,2023-06-05,9312
00772B,中信高評級公司債,7,2,5,華南永昌-民權,2023-06-05,9312
00919,群益台灣精選高息,1161,0,1161,華南永昌-民權,2023-06-06,9312
00927,群益半導體收益,206,0,206,華南永昌-民權,2023-06-06,9312
2101,南港,140,0,140,華南永昌-民權,2023-06-06,9312
3081,聯亞,111,5,106,華南永昌-民權,2023-06-06,9312
00632R,元大台灣50反1,90,0,90,華南永昌-民權,2023-06-06,9312
2323,中環,50,8,42,華南永昌-民權,2023-06-06,9312
1419,新紡,39,0,39,華南永昌-民權,2023-06-06,9312
2618,長榮航,34,6,28,華南永昌-民權,2023-06-06,9312
2303,聯電,26,2,24,華南永昌-民權,2023-06-06,9312
2903,遠百,24,0,24,華南永昌-民權,2023-06-06,9312
2468,華經,20,0,20,華南永昌-民權,2023-06-06,9312
2402,毅嘉,18,3,15,華南永昌-民權,2023-06-06,9312
2427,三商電,16,1,15,華南永昌-民權,2023-06-06,9312
2461,光群雷,21,7,14,華南永昌-民權,2023-06-06,9312
2634,漢翔,17,5,12,華南永昌-民權,2023-06-06,9312
1513,中興電,15,3,12,華南永昌-民權,2023-06-06,9312
1711,永光,12,1,11,華南永昌-民權,2023-06-06,9312
3483,力致,21,10,11,華南永昌-民權,2023-06-06,9312
6244,茂迪,14,3,11,華南永昌-民權,2023-06-06,9312
3047,訊舟,11,0,11,華南永昌-民權,2023-06-06,9312
1524,耿鼎,10,0,10,華南永昌-民權,2023-06-06,9312
1806,冠軍,32,22,10,華南永昌-民權,2023-06-06,9312
4533,協易機,11,1,10,華南永昌-民權,2023-06-06,9312
5222,全訊,10,0,10,華南永昌-民權,2023-06-06,9312
6152,百一,10,0,10,華南永昌-民權,2023-06-06,9312
8064,東捷,10,0,10,華南永昌-民權,2023-06-06,9312
00679B,元大美債20年,9,0,9,華南永昌-民權,2023-06-06,9312
6282,康舒,12,3,9,華南永昌-民權,2023-06-06,9312
8403,盛弘,12,3,9,華南永昌-民權,2023-06-06,9312
00773B,中信優先金融債,10,2,8,華南永昌-民權,2023-06-06,9312
3058,立德,13,5,8,華南永昌-民權,2023-06-06,9312
6288,聯嘉,14,6,8,華南永昌-民權,2023-06-06,9312
2882,國泰金,7,0,7,華南永昌-民權,2023-06-06,9312
3664,安瑞-KY,7,0,7,華南永昌-民權,2023-06-06,9312
3704,合勤控,9,2,7,華南永昌-民權,2023-06-06,9312
4967,十銓,8,1,7,華南永昌-民權,2023-06-06,9312
1905,華紙,69,62,7,華南永昌-民權,2023-06-06,9312
3037,欣興,6,0,6,華南永昌-民權,2023-06-06,9312
0056,元大高股息,12,6,6,華南永昌-民權,2023-06-06,9312
3661,世芯-KY,6,0,6,華南永昌-民權,2023-06-06,9312
4906,正文,13,7,6,華南永昌-民權,2023-06-06,9312
6446,藥華藥,14,8,6,華南永昌-民權,2023-06-06,9312
3363,上詮,8,2,6,華南永昌-民權,2023-06-06,9312
00713,元大台灣高息低波,5,0,5,華南永昌-民權,2023-06-06,9312
00687B,國泰20年美債,5,0,5,華南永昌-民權,2023-06-06,9312
00712,復華富時不動產,5,0,5,華南永昌-民權,2023-06-06,9312
00921,兆豐龍頭等權重,5,0,5,華南永昌-民權,2023-06-06,9312
00892,富邦台灣半導體,5,0,5,華南永昌-民權,2023-06-06,9312
1324,地球,5,0,5,華南永昌-民權,2023-06-06,9312
1440,南紡,5,0,5,華南永昌-民權,2023-06-06,9312
00919,群益台灣精選高息,953,0,953,華南永昌-民權,2023-06-07,9312
00632R,元大台灣50反1,338,2,336,華南永昌-民權,2023-06-07,9312
2101,南港,100,0,100,華南永昌-民權,2023-06-07,9312
1419,新紡,80,0,80,華南永昌-民權,2023-06-07,9312
2412,中華電,65,0,65,華南永昌-民權,2023-06-07,9312
2413,環科,50,10,40,華南永昌-民權,2023-06-07,9312
2610,華航,65,27,38,華南永昌-民權,2023-06-07,9312
2427,三商電,33,0,33,華南永昌-民權,2023-06-07,9312
2903,遠百,30,0,30,華南永昌-民權,2023-06-07,9312
3481,群創,31,1,30,華南永昌-民權,2023-06-07,9312
1514,亞力,28,2,26,華南永昌-民權,2023-06-07,9312
2353,宏��,32,6,26,華南永昌-民權,2023-06-07,9312
3231,緯創,30,5,25,華南永昌-民權,2023-06-07,9312
5009,榮剛,25,0,25,華南永昌-民權,2023-06-07,9312
2888,新光金,56,34,22,華南永昌-民權,2023-06-07,9312
00927,群益半導體收益,21,0,21,華南永昌-民權,2023-06-07,9312
00637L,元大滬深300正2,20,0,20,華南永昌-民權,2023-06-07,9312
3272,東碩,20,0,20,華南永昌-民權,2023-06-07,9312
6270,倍微,26,6,20,華南永昌-民權,2023-06-07,9312
2402,毅嘉,17,1,16,華南永昌-民權,2023-06-07,9312
4942,嘉彰,16,0,16,華南永昌-民權,2023-06-07,9312
8426,紅木-KY,16,0,16,華南永昌-民權,2023-06-07,9312
3037,欣興,19,5,14,華南永昌-民權,2023-06-07,9312
2323,中環,86,75,11,華南永昌-民權,2023-06-07,9312
1605,華新,12,1,11,華南永昌-民權,2023-06-07,9312
6188,廣明,12,1,11,華南永昌-民權,2023-06-07,9312
8040,九暘,10,0,10,華南永昌-民權,2023-06-07,9312
1410,南染,10,0,10,華南永昌-民權,2023-06-07,9312
1536,和大,30,20,10,華南永昌-民權,2023-06-07,9312
1589,永冠-KY,13,3,10,華南永昌-民權,2023-06-07,9312
1711,永光,10,0,10,華南永昌-民權,2023-06-07,9312
2108,南帝,10,0,10,華南永昌-民權,2023-06-07,9312
2468,華經,10,0,10,華南永昌-民權,2023-06-07,9312
3491,昇達科,10,0,10,華南永昌-民權,2023-06-07,9312
8105,凌巨,10,0,10,華南永昌-民權,2023-06-07,9312
2247,汎德永業,9,0,9,華南永昌-民權,2023-06-07,9312
2329,華泰,15,6,9,華南永昌-民權,2023-06-07,9312
6290,良維,10,1,9,華南永昌-民權,2023-06-07,9312
00882,中信中國高股息,8,0,8,華南永昌-民權,2023-06-07,9312
2250,IKKA-KY,7,0,7,華南永昌-民權,2023-06-07,9312
2486,一詮,24,17,7,華南永昌-民權,2023-06-07,9312
3094,聯傑,7,0,7,華南永昌-民權,2023-06-07,9312
3413,京鼎,7,0,7,華南永昌-民權,2023-06-07,9312
1101,台泥,7,0,7,華南永昌-民權,2023-06-07,9312
00715L,期街口布蘭特正2,6,0,6,華南永昌-民權,2023-06-07,9312
6125,廣運,6,0,6,華南永昌-民權,2023-06-07,9312
8240,華宏,6,0,6,華南永昌-民權,2023-06-07,9312
4960,誠美材,5,0,5,華南永昌-民權,2023-06-07,9312
2489,瑞軒,5,0,5,華南永昌-民權,2023-06-07,9312
2347,聯強,5,0,5,華南永昌-民權,2023-06-07,9312
2323,中環,114,13,101,華南永昌-民權,2023-06-08,9312
2352,佳世達,74,4,70,華南永昌-民權,2023-06-08,9312
00919,群益台灣精選高息,48,0,48,華南永昌-民權,2023-06-08,9312
1609,大亞,109,71,38,華南永昌-民權,2023-06-08,9312
00680L,元大美債20正2,35,0,35,華南永昌-民權,2023-06-08,9312
5905,南仁湖,37,2,35,華南永昌-民權,2023-06-08,9312
2427,三商電,29,1,28,華南永昌-民權,2023-06-08,9312
00679B,元大美債20年,26,0,26,華南永昌-民權,2023-06-08,9312
00713,元大台灣高息低波,26,0,26,華南永昌-民權,2023-06-08,9312
3081,聯亞,25,0,25,華南永昌-民權,2023-06-08,9312
0056,元大高股息,31,6,25,華南永昌-民權,2023-06-08,9312
2605,新興,24,1,23,華南永昌-民權,2023-06-08,9312
2344,華邦電,32,10,22,華南永昌-民權,2023-06-08,9312
3037,欣興,49,28,21,華南永昌-民權,2023-06-08,9312
2883,凱基金,20,0,20,華南永昌-民權,2023-06-08,9312
3715,定穎投控,20,0,20,華南永昌-民權,2023-06-08,9312
2337,旺宏,19,0,19,華南永昌-民權,2023-06-08,9312
2313,華通,18,0,18,華南永昌-民權,2023-06-08,9312
2402,毅嘉,19,1,18,華南永昌-民權,2023-06-08,9312
2359,所羅門,20,3,17,華南永昌-民權,2023-06-08,9312
2615,萬海,19,3,16,華南永昌-民權,2023-06-08,9312
5706,鳳凰,29,14,15,華南永昌-民權,2023-06-08,9312
1536,和大,15,0,15,華南永昌-民權,2023-06-08,9312
1605,華新,34,20,14,華南永昌-民權,2023-06-08,9312
4960,誠美材,13,0,13,華南永昌-民權,2023-06-08,9312
00927,群益半導體收益,11,0,11,華南永昌-民權,2023-06-08,9312
2610,華航,104,93,11,華南永昌-民權,2023-06-08,9312
4564,元翎,11,0,11,華南永昌-民權,2023-06-08,9312
00720B,元大投資級公司債,10,0,10,華南永昌-民權,2023-06-08,9312
2453,凌群,10,0,10,華南永昌-民權,2023-06-08,9312
4121,優盛,10,0,10,華南永昌-民權,2023-06-08,9312
4167,松瑞藥,10,0,10,華南永昌-民權,2023-06-08,9312
6138,茂達,10,0,10,華南永昌-民權,2023-06-08,9312
6285,啟��,10,0,10,華南永昌-民權,2023-06-08,9312
00687B,國泰20年美債,9,0,9,華南永昌-民權,2023-06-08,9312
3545,敦泰,9,0,9,華南永昌-民權,2023-06-08,9312
5512,力麒,10,1,9,華南永昌-民權,2023-06-08,9312
2888,新光金,20,12,8,華南永昌-民權,2023-06-08,9312
2701,萬企,11,3,8,華南永昌-民權,2023-06-08,9312
2903,遠百,8,0,8,華南永昌-民權,2023-06-08,9312
00772B,中信高評級公司債,10,3,7,華南永昌-民權,2023-06-08,9312
00712,復華富時不動產,7,0,7,華南永昌-民權,2023-06-08,9312
2312,金寶,10,3,7,華南永昌-民權,2023-06-08,9312
3356,奇偶,7,0,7,華南永昌-民權,2023-06-08,9312
3576,聯合再生,7,0,7,華南永昌-民權,2023-06-08,9312
8084,巨虹,7,0,7,華南永昌-民權,2023-06-08,9312
8086,宏捷科,12,5,7,華南永昌-民權,2023-06-08,9312
8421,旭源,9,2,7,華南永昌-民權,2023-06-08,9312
2247,汎德永業,6,0,6,華南永昌-民權,2023-06-08,9312
00751B,元大AAA至A公司債,6,0,6,華南永昌-民權,2023-06-08,9312
3231,緯創,451,27,424,華南永昌-民權,2023-06-09,9312
2897,王道銀行,100,0,100,華南永昌-民權,2023-06-09,9312
3081,聯亞,50,0,50,華南永昌-民權,2023-06-09,9312
3037,欣興,52,9,43,華南永昌-民權,2023-06-09,9312
1609,大亞,80,38,42,華南永昌-民權,2023-06-09,9312
00712,復華富時不動產,39,0,39,華南永昌-民權,2023-06-09,9312
1312,國喬,30,0,30,華南永昌-民權,2023-06-09,9312
2610,華航,42,14,28,華南永昌-民權,2023-06-09,9312
1536,和大,26,1,25,華南永昌-民權,2023-06-09,9312
00929,復華台灣科技優息,38,15,23,華南永昌-民權,2023-06-09,9312
6269,台郡,43,20,23,華南永昌-民權,2023-06-09,9312
2515,中工,27,6,21,華南永昌-民權,2023-06-09,9312
3272,東碩,21,0,21,華南永昌-民權,2023-06-09,9312
5009,榮剛,21,0,21,華南永昌-民權,2023-06-09,9312
3324,雙鴻,21,0,21,華南永昌-民權,2023-06-09,9312
1519,華城,24,4,20,華南永昌-民權,2023-06-09,9312
2371,大同,22,2,20,華南永昌-民權,2023-06-09,9312
2427,三商電,26,7,19,華南永昌-民權,2023-06-09,9312
00725B,國泰投資級公司債,18,0,18,華南永昌-民權,2023-06-09,9312
6215,和椿,17,3,14,華南永昌-民權,2023-06-09,9312
6191,精成科,13,0,13,華南永昌-民權,2023-06-09,9312
4942,嘉彰,12,0,12,華南永昌-民權,2023-06-09,9312
00679B,元大美債20年,12,1,11,華南永昌-民權,2023-06-09,9312
1752,南光,18,7,11,華南永昌-民權,2023-06-09,9312
1101,台泥,20,10,10,華南永昌-民權,2023-06-09,9312
1809,中釉,10,0,10,華南永昌-民權,2023-06-09,9312
2377,微星,10,0,10,華南永昌-民權,2023-06-09,9312
2888,新光金,15,5,10,華南永昌-民權,2023-06-09,9312
6138,茂達,10,0,10,華南永昌-民權,2023-06-09,9312
6152,百一,10,0,10,華南永昌-民權,2023-06-09,9312
1504,東元,14,4,10,華南永昌-民權,2023-06-09,9312
2352,佳世達,14,5,9,華南永昌-民權,2023-06-09,9312
2425,承啟,29,20,9,華南永昌-民權,2023-06-09,9312
3046,建��,46,38,8,華南永昌-民權,2023-06-09,9312
1605,華新,9,1,8,華南永昌-民權,2023-06-09,9312
2916,滿心,8,0,8,華南永昌-民權,2023-06-09,9312
2882,國泰金,12,5,7,華南永昌-民權,2023-06-09,9312
2337,旺宏,7,0,7,華南永昌-民權,2023-06-09,9312
2482,連宇,29,22,7,華南永昌-民權,2023-06-09,9312
3202,樺晟,7,0,7,華南永昌-民權,2023-06-09,9312
8038,長園科,7,0,7,華南永昌-民權,2023-06-09,9312
8403,盛弘,12,5,7,華南永昌-民權,2023-06-09,9312
6477,安集,6,0,6,華南永昌-民權,2023-06-09,9312
1608,華榮,22,16,6,華南永昌-民權,2023-06-09,9312
2460,建通,10,4,6,華南永昌-民權,2023-06-09,9312
3013,晟銘電,8,2,6,華南永昌-民權,2023-06-09,9312
4927,泰鼎-KY,6,0,6,華南永昌-民權,2023-06-09,9312
1802,台玻,5,0,5,華南永昌-民權,2023-06-09,9312
3025,星通,8,3,5,華南永昌-民權,2023-06-09,9312
4754,國碳科,5,0,5,華南永昌-民權,2023-06-09,9312
2897,王道銀行,250,100,150,華南永昌-民權,2023-06-12,9312
2101,南港,100,0,100,華南永昌-民權,2023-06-12,9312
2312,金寶,66,4,62,華南永昌-民權,2023-06-12,9312
2323,中環,73,15,58,華南永昌-民權,2023-06-12,9312
3081,聯亞,55,0,55,華南永昌-民權,2023-06-12,9312
1536,和大,52,0,52,華南永昌-民權,2023-06-12,9312
00712,復華富時不動產,50,0,50,華南永昌-民權,2023-06-12,9312
3045,台灣大,100,50,50,華南永昌-民權,2023-06-12,9312
6139,亞翔,31,0,31,華南永昌-民權,2023-06-12,9312
2409,友達,30,0,30,華南永昌-民權,2023-06-12,9312
00929,復華台灣科技優息,28,0,28,華南永昌-民權,2023-06-12,9312
2356,英業達,30,4,26,華南永昌-民權,2023-06-12,9312
2610,華航,47,21,26,華南永昌-民權,2023-06-12,9312
00632R,元大台灣50反1,25,0,25,華南永昌-民權,2023-06-12,9312
2331,精英,25,0,25,華南永昌-民權,2023-06-12,9312
00919,群益台灣精選高息,24,0,24,華南永昌-民權,2023-06-12,9312
00679B,元大美債20年,25,2,23,華南永昌-民權,2023-06-12,9312
00885,富邦越南,32,10,22,華南永昌-民權,2023-06-12,9312
2383,台光電,20,0,20,華南永昌-民權,2023-06-12,9312
2701,萬企,20,0,20,華南永昌-民權,2023-06-12,9312
6592,和潤企業,20,0,20,華南永昌-民權,2023-06-12,9312
2903,遠百,20,1,19,華南永昌-民權,2023-06-12,9312
2618,長榮航,27,9,18,華南永昌-民權,2023-06-12,9312
4171,瑞基,18,0,18,華南永昌-民權,2023-06-12,9312
00642U,期元大S＆P石油,16,0,16,華南永昌-民權,2023-06-12,9312
6179,亞通,16,0,16,華南永昌-民權,2023-06-12,9312
2915,潤泰全,13,0,13,華南永昌-民權,2023-06-12,9312
2478,大毅,12,0,12,華南永昌-民權,2023-06-12,9312
3715,定穎投控,30,18,12,華南永昌-民權,2023-06-12,9312
9935,慶豐富,12,0,12,華南永昌-民權,2023-06-12,9312
5512,力麒,12,1,11,華南永昌-民權,2023-06-12,9312
2706,第一店,11,0,11,華南永昌-民權,2023-06-12,9312
5475,德宏,11,0,11,華南永昌-民權,2023-06-12,9312
2889,國票金,10,0,10,華南永昌-民權,2023-06-12,9312
00725B,國泰投資級公司債,10,0,10,華南永昌-民權,2023-06-12,9312
00715L,期街口布蘭特正2,10,0,10,華南永昌-民權,2023-06-12,9312
1227,佳格,10,0,10,華南永昌-民權,2023-06-12,9312
1752,南光,10,0,10,華南永昌-民權,2023-06-12,9312
4121,優盛,10,0,10,華南永昌-民權,2023-06-12,9312
5258,虹堡,16,6,10,華南永昌-民權,2023-06-12,9312
6142,友勁,10,0,10,華南永昌-民權,2023-06-12,9312
6269,台郡,10,0,10,華南永昌-民權,2023-06-12,9312
2603,長榮,14,6,8,華南永昌-民權,2023-06-12,9312
3323,加百裕,8,0,8,華南永昌-民權,2023-06-12,9312
6417,韋僑,11,3,8,華南永昌-民權,2023-06-12,9312
2382,廣達,18,10,8,華南永昌-民權,2023-06-12,9312
2427,三商電,7,0,7,華南永昌-民權,2023-06-12,9312
6443,元晶,7,0,7,華南永昌-民權,2023-06-12,9312
2888,新光金,58,51,7,華南永昌-民權,2023-06-12,9312
1809,中釉,6,0,6,華南永昌-民權,2023-06-12,9312
5425,台半,135,1,134,華南永昌-民權,2023-06-13,9312
1536,和大,100,0,100,華南永昌-民權,2023-06-13,9312
2101,南港,100,0,100,華南永昌-民權,2023-06-13,9312
3356,奇偶,60,4,56,華南永昌-民權,2023-06-13,9312
2482,連宇,63,8,55,華南永昌-民權,2023-06-13,9312
00919,群益台灣精選高息,47,0,47,華南永昌-民權,2023-06-13,9312
3324,雙鴻,35,5,30,華南永昌-民權,2023-06-13,9312
2903,遠百,29,0,29,華南永昌-民權,2023-06-13,9312
6592,和潤企業,22,0,22,華南永昌-民權,2023-06-13,9312
2371,大同,24,2,22,華南永昌-民權,2023-06-13,9312
00927,群益半導體收益,20,0,20,華南永昌-民權,2023-06-13,9312
2347,聯強,30,10,20,華南永昌-民權,2023-06-13,9312
3081,聯亞,20,0,20,華南永昌-民權,2023-06-13,9312
00715L,期街口布蘭特正2,19,0,19,華南永昌-民權,2023-06-13,9312
2881,富邦金,18,0,18,華南永昌-民權,2023-06-13,9312
2027,大成鋼,18,0,18,華南永昌-民權,2023-06-13,9312
6270,倍微,16,0,16,華南永昌-民權,2023-06-13,9312
2323,中環,81,66,15,華南永昌-民權,2023-06-13,9312
3013,晟銘電,15,0,15,華南永昌-民權,2023-06-13,9312
2376,技嘉,22,8,14,華南永昌-民權,2023-06-13,9312
1609,大亞,20,6,14,華南永昌-民權,2023-06-13,9312
00642U,期元大S＆P石油,13,0,13,華南永昌-民權,2023-06-13,9312
2882,國泰金,12,0,12,華南永昌-民權,2023-06-13,9312
8358,金居,11,0,11,華南永昌-民權,2023-06-13,9312
2331,精英,10,0,10,華南永昌-民權,2023-06-13,9312
3048,益登,10,0,10,華南永昌-民權,2023-06-13,9312
3078,僑威,22,12,10,華南永昌-民權,2023-06-13,9312
3551,世禾,10,0,10,華南永昌-民權,2023-06-13,9312
3607,谷崧,10,0,10,華南永昌-民權,2023-06-13,9312
6288,聯嘉,12,2,10,華南永昌-民權,2023-06-13,9312
1612,宏泰,8,1,7,華南永昌-民權,2023-06-13,9312
00882,中信中國高股息,7,0,7,華南永昌-民權,2023-06-13,9312
2915,潤泰全,7,0,7,華南永昌-民權,2023-06-13,9312
3715,定穎投控,11,4,7,華南永昌-民權,2023-06-13,9312
00885,富邦越南,22,16,6,華南永昌-民權,2023-06-13,9312
3094,聯傑,6,0,6,華南永昌-民權,2023-06-13,9312
3363,上詮,11,5,6,華南永昌-民權,2023-06-13,9312
00757,統一FANG+,7,1,6,華南永昌-民權,2023-06-13,9312
00633L,富邦上証正2,5,0,5,華南永昌-民權,2023-06-13,9312
00900,富邦特選高股息30,5,0,5,華南永昌-民權,2023-06-13,9312
1802,台玻,5,0,5,華南永昌-民權,2023-06-13,9312
1809,中釉,5,0,5,華南永昌-民權,2023-06-13,9312
3029,零壹,5,0,5,華南永昌-民權,2023-06-13,9312
3062,建漢,5,0,5,華南永昌-民權,2023-06-13,9312
3704,合勤控,9,4,5,華南永昌-民權,2023-06-13,9312
4945,陞達科技,5,0,5,華南永昌-民權,2023-06-13,9312
5475,德宏,5,0,5,華南永昌-民權,2023-06-13,9312
6160,欣技,5,0,5,華南永昌-民權,2023-06-13,9312
6244,茂迪,5,0,5,華南永昌-民權,2023-06-13,9312
8021,尖點,5,0,5,華南永昌-民權,2023-06-13,9312
2101,南港,105,0,105,華南永昌-民權,2023-06-14,9312
00632R,元大台灣50反1,73,1,72,華南永昌-民權,2023-06-14,9312
3324,雙鴻,70,3,67,華南永昌-民權,2023-06-14,9312
2888,新光金,68,5,63,華南永昌-民權,2023-06-14,9312
2367,燿華,44,0,44,華南永昌-民權,2023-06-14,9312
3481,群創,55,14,41,華南永昌-民權,2023-06-14,9312
6167,久正,45,5,40,華南永昌-民權,2023-06-14,9312
00919,群益台灣精選高息,39,5,34,華南永昌-民權,2023-06-14,9312
8926,台汽電,37,5,32,華南永昌-民權,2023-06-14,9312
2402,毅嘉,32,0,32,華南永昌-民權,2023-06-14,9312
00929,復華台灣科技優息,30,0,30,華南永昌-民權,2023-06-14,9312
2515,中工,30,0,30,華南永昌-民權,2023-06-14,9312
00680L,元大美債20正2,24,0,24,華南永昌-民權,2023-06-14,9312
3037,欣興,52,28,24,華南永昌-民權,2023-06-14,9312
2356,英業達,47,24,23,華南永昌-民權,2023-06-14,9312
3048,益登,20,0,20,華南永昌-民權,2023-06-14,9312
6472,保瑞,20,0,20,華南永昌-民權,2023-06-14,9312
2504,國產,18,0,18,華南永昌-民權,2023-06-14,9312
00679B,元大美債20年,17,0,17,華南永昌-民權,2023-06-14,9312
00687B,國泰20年美債,15,0,15,華南永昌-民權,2023-06-14,9312
2108,南帝,15,0,15,華南永昌-民權,2023-06-14,9312
6142,友勁,15,0,15,華南永昌-民權,2023-06-14,9312
6282,康舒,16,4,12,華南永昌-民權,2023-06-14,9312
1402,遠東新,11,0,11,華南永昌-民權,2023-06-14,9312
00712,復華富時不動產,10,0,10,華南永昌-民權,2023-06-14,9312
2331,精英,10,0,10,華南永昌-民權,2023-06-14,9312
2405,輔信,24,14,10,華南永昌-民權,2023-06-14,9312
5706,鳳凰,35,25,10,華南永昌-民權,2023-06-14,9312
6143,振曜,10,0,10,華南永昌-民權,2023-06-14,9312
6603,富強鑫,10,0,10,華南永昌-民權,2023-06-14,9312
2107,厚生,8,0,8,華南永昌-民權,2023-06-14,9312
00882,中信中國高股息,8,0,8,華南永昌-民權,2023-06-14,9312
1438,三地開發,8,0,8,華南永昌-民權,2023-06-14,9312
2208,台船,8,0,8,華南永昌-民權,2023-06-14,9312
3033,威健,14,6,8,華南永昌-民權,2023-06-14,9312
3711,日月光投控,8,0,8,華南永昌-民權,2023-06-14,9312
4123,晟德,8,0,8,華南永昌-民權,2023-06-14,9312
00720B,元大投資級公司債,7,0,7,華南永昌-民權,2023-06-14,9312
1806,冠軍,18,11,7,華南永昌-民權,2023-06-14,9312
2427,三商電,7,0,7,華南永昌-民權,2023-06-14,9312
1101,台泥,10,3,7,華南永昌-民權,2023-06-14,9312
5439,高技,7,1,6,華南永昌-民權,2023-06-14,9312
6550,北極星藥業-KY,7,1,6,華南永昌-民權,2023-06-14,9312
2743,山富,31,26,5,華南永昌-民權,2023-06-14,9312
1419,新紡,5,0,5,華南永昌-民權,2023-06-14,9312
1799,易威,5,0,5,華南永昌-民權,2023-06-14,9312
2368,金像電,5,0,5,華南永昌-民權,2023-06-14,9312
2382,廣達,26,21,5,華南永昌-民權,2023-06-14,9312
2388,威盛,5,0,5,華南永昌-民權,2023-06-14,9312
2705,六福,9,4,5,華南永昌-民權,2023-06-14,9312
2101,南港,395,0,395,華南永昌-民權,2023-06-15,9312
3037,欣興,175,9,166,華南永昌-民權,2023-06-15,9312
2888,新光金,67,0,67,華南永昌-民權,2023-06-15,9312
2618,長榮航,196,151,45,華南永昌-民權,2023-06-15,9312
3081,聯亞,40,3,37,華南永昌-民權,2023-06-15,9312
00632R,元大台灣50反1,35,0,35,華南永昌-民權,2023-06-15,9312
00919,群益台灣精選高息,30,1,29,華南永昌-民權,2023-06-15,9312
00885,富邦越南,28,1,27,華南永昌-民權,2023-06-15,9312
3033,威健,25,0,25,華南永昌-民權,2023-06-15,9312
1419,新紡,20,0,20,華南永昌-民權,2023-06-15,9312
2605,新興,20,0,20,華南永昌-民權,2023-06-15,9312
3715,定穎投控,21,3,18,華南永昌-民權,2023-06-15,9312
2705,六福,17,0,17,華南永昌-民權,2023-06-15,9312
2382,廣達,27,11,16,華南永昌-民權,2023-06-15,9312
3231,緯創,24,8,16,華南永昌-民權,2023-06-15,9312
00712,復華富時不動產,26,10,16,華南永昌-民權,2023-06-15,9312
3045,台灣大,80,65,15,華南永昌-民權,2023-06-15,9312
2332,友訊,17,3,14,華南永昌-民權,2023-06-15,9312
4533,協易機,29,16,13,華南永昌-民權,2023-06-15,9312
00882,中信中國高股息,12,0,12,華南永昌-民權,2023-06-15,9312
6472,保瑞,11,0,11,華南永昌-民權,2023-06-15,9312
2471,資通,64,53,11,華南永昌-民權,2023-06-15,9312
3324,雙鴻,14,3,11,華南永昌-民權,2023-06-15,9312
3209,全科,11,1,10,華南永昌-民權,2023-06-15,9312
1313,聯成,10,0,10,華南永昌-民權,2023-06-15,9312
00642U,期元大S＆P石油,10,0,10,華南永昌-民權,2023-06-15,9312
1589,永冠-KY,10,0,10,華南永昌-民權,2023-06-15,9312
2103,台橡,10,0,10,華南永昌-民權,2023-06-15,9312
2356,英業達,44,36,8,華南永昌-民權,2023-06-15,9312
00715L,期街口布蘭特正2,11,3,8,華南永昌-民權,2023-06-15,9312
2313,華通,8,0,8,華南永昌-民權,2023-06-15,9312
2401,凌陽,25,17,8,華南永昌-民權,2023-06-15,9312
2609,陽明,10,3,7,華南永昌-民權,2023-06-15,9312
1609,大亞,31,24,7,華南永昌-民權,2023-06-15,9312
2891,中信金,8,1,7,華南永昌-民權,2023-06-15,9312
3287,廣寰科,7,0,7,華南永昌-民權,2023-06-15,9312
8358,金居,8,1,7,華南永昌-民權,2023-06-15,9312
6269,台郡,7,0,7,華南永昌-民權,2023-06-15,9312
8076,伍豐,14,7,7,華南永昌-民權,2023-06-15,9312
2603,長榮,14,7,7,華南永昌-民權,2023-06-15,9312
2329,華泰,6,0,6,華南永昌-民權,2023-06-15,9312
2399,映泰,17,11,6,華南永昌-民權,2023-06-15,9312
2706,第一店,11,5,6,華南永昌-民權,2023-06-15,9312
3707,漢磊,6,0,6,華南永昌-民權,2023-06-15,9312
5425,台半,6,0,6,華南永昌-民權,2023-06-15,9312
3481,群創,17,12,5,華南永昌-民權,2023-06-15,9312
00915,凱基優選高股息30,5,0,5,華南永昌-民權,2023-06-15,9312
00929,復華台灣科技優息,9,4,5,華南永昌-民權,2023-06-15,9312
2419,仲琦,5,0,5,華南永昌-民權,2023-06-15,9312
2457,飛宏,5,0,5,華南永昌-民權,2023-06-15,9312
00919,群益台灣精選高息,162,0,162,華南永昌-民權,2023-06-16,9312
2897,王道銀行,200,50,150,華南永昌-民權,2023-06-16,9312
2101,南港,101,0,101,華南永昌-民權,2023-06-16,9312
2356,英業達,123,45,78,華南永昌-民權,2023-06-16,9312
2903,遠百,40,0,40,華南永昌-民權,2023-06-16,9312
1419,新紡,35,0,35,華南永昌-民權,2023-06-16,9312
4904,遠傳,30,0,30,華南永昌-民權,2023-06-16,9312
2371,大同,158,131,27,華南永昌-民權,2023-06-16,9312
2834,臺企銀,28,2,26,華南永昌-民權,2023-06-16,9312
2457,飛宏,28,5,23,華南永昌-民權,2023-06-16,9312
8926,台汽電,44,21,23,華南永昌-民權,2023-06-16,9312
3324,雙鴻,24,2,22,華南永昌-民權,2023-06-16,9312
4534,慶騰,23,2,21,華南永昌-民權,2023-06-16,9312
5880,合庫金,20,0,20,華南永昌-民權,2023-06-16,9312
1101,台泥,24,4,20,華南永昌-民權,2023-06-16,9312
1611,中電,21,1,20,華南永昌-民權,2023-06-16,9312
3081,聯亞,23,3,20,華南永昌-民權,2023-06-16,9312
4513,福裕,20,0,20,華南永昌-民權,2023-06-16,9312
9907,統一實,16,0,16,華南永昌-民權,2023-06-16,9312
1608,華榮,18,3,15,華南永昌-民權,2023-06-16,9312
2331,精英,21,6,15,華南永昌-民權,2023-06-16,9312
4510,高鋒,15,3,12,華南永昌-民權,2023-06-16,9312
6282,康舒,15,3,12,華南永昌-民權,2023-06-16,9312
3706,神達,95,85,10,華南永昌-民權,2023-06-16,9312
1337,再生-KY,10,0,10,華南永昌-民權,2023-06-16,9312
1799,易威,10,0,10,華南永昌-民權,2023-06-16,9312
2702,華園,10,0,10,華南永昌-民權,2023-06-16,9312
3479,安勤,10,0,10,華南永昌-民權,2023-06-16,9312
3576,聯合再生,11,1,10,華南永昌-民權,2023-06-16,9312
3607,谷崧,10,0,10,華南永昌-民權,2023-06-16,9312
3673,TPK-KY,10,0,10,華南永昌-民權,2023-06-16,9312
4712,福格創新,10,0,10,華南永昌-民權,2023-06-16,9312
5371,中光電,10,0,10,華南永昌-民權,2023-06-16,9312
6138,茂達,10,0,10,華南永昌-民權,2023-06-16,9312
6265,方土昶,20,10,10,華南永昌-民權,2023-06-16,9312
2885,元大金,10,0,10,華南永昌-民權,2023-06-16,9312
4967,十銓,10,0,10,華南永昌-民權,2023-06-16,9312
1609,大亞,72,63,9,華南永昌-民權,2023-06-16,9312
006208,富邦台50,9,0,9,華南永昌-民權,2023-06-16,9312
4533,協易機,22,13,9,華南永昌-民權,2023-06-16,9312
6770,力積電,10,1,9,華南永昌-民權,2023-06-16,9312
1802,台玻,9,0,9,華南永昌-民權,2023-06-16,9312
1514,亞力,26,18,8,華南永昌-民權,2023-06-16,9312
3481,群創,61,53,8,華南永昌-民權,2023-06-16,9312
3024,憶聲,8,0,8,華南永昌-民權,2023-06-16,9312
3380,明泰,11,3,8,華南永昌-民權,2023-06-16,9312
2889,國票金,9,2,7,華南永昌-民權,2023-06-16,9312
3189,景碩,7,0,7,華南永昌-民權,2023-06-16,9312
4916,事欣科,12,5,7,華南永昌-民權,2023-06-16,9312
2888,新光金,7,0,7,華南永昌-民權,2023-06-16,9312
2101,南港,200,0,200,華南永昌-民權,2023-06-19,9312
6116,彩晶,191,18,173,華南永昌-民權,2023-06-19,9312
2888,新光金,118,5,113,華南永昌-民權,2023-06-19,9312
2367,燿華,50,0,50,華南永昌-民權,2023-06-19,9312
1101,台泥,48,5,43,華南永昌-民權,2023-06-19,9312
00893,國泰智能電動車,40,5,35,華南永昌-民權,2023-06-19,9312
1611,中電,34,0,34,華南永昌-民權,2023-06-19,9312
2609,陽明,32,2,30,華南永昌-民權,2023-06-19,9312
3673,TPK-KY,26,0,26,華南永昌-民權,2023-06-19,9312
00919,群益台灣精選高息,23,0,23,華南永昌-民權,2023-06-19,9312
2867,三商壽,22,0,22,華南永昌-民權,2023-06-19,9312
4942,嘉彰,20,0,20,華南永昌-民權,2023-06-19,9312
00885,富邦越南,18,0,18,華南永昌-民權,2023-06-19,9312
2834,臺企銀,15,0,15,華南永昌-民權,2023-06-19,9312
1513,中興電,24,9,15,華南永昌-民權,2023-06-19,9312
1419,新紡,14,0,14,華南永昌-民權,2023-06-19,9312
3682,亞太電,20,6,14,華南永昌-民權,2023-06-19,9312
2353,宏��,15,2,13,華南永昌-民權,2023-06-19,9312
2882,國泰金,13,1,12,華南永昌-民權,2023-06-19,9312
3479,安勤,15,3,12,華南永昌-民權,2023-06-19,9312
3706,神達,24,12,12,華南永昌-民權,2023-06-19,9312
1307,三芳,24,12,12,華南永昌-民權,2023-06-19,9312
1802,台玻,14,3,11,華南永昌-民權,2023-06-19,9312
2405,輔信,11,0,11,華南永昌-民權,2023-06-19,9312
2324,仁寶,62,52,10,華南永昌-民權,2023-06-19,9312
1326,台化,10,0,10,華南永昌-民權,2023-06-19,9312
1815,富喬,13,3,10,華南永昌-民權,2023-06-19,9312
3576,聯合再生,10,0,10,華南永昌-民權,2023-06-19,9312
5512,力麒,10,0,10,華南永昌-民權,2023-06-19,9312
6160,欣技,10,0,10,華南永昌-民權,2023-06-19,9312
8105,凌巨,11,1,10,華南永昌-民權,2023-06-19,9312
6535,順藥,12,3,9,華南永昌-民權,2023-06-19,9312
1301,台塑,10,1,9,華南永昌-民權,2023-06-19,9312
2323,中環,15,6,9,華南永昌-民權,2023-06-19,9312
00679B,元大美債20年,9,1,8,華南永昌-民權,2023-06-19,9312
2369,菱生,8,0,8,華南永昌-民權,2023-06-19,9312
2883,凱基金,9,2,7,華南永昌-民權,2023-06-19,9312
2303,聯電,7,0,7,華南永昌-民權,2023-06-19,9312
4541,晟田,43,36,7,華南永昌-民權,2023-06-19,9312
4927,泰鼎-KY,7,0,7,華南永昌-民權,2023-06-19,9312
2603,長榮,13,7,6,華南永昌-民權,2023-06-19,9312
2356,英業達,11,4,7,華南永昌-民權,2023-06-19,9312
1810,和成,8,2,6,華南永昌-民權,2023-06-19,9312
2344,華邦電,7,1,6,華南永昌-民權,2023-06-19,9312
3264,欣銓,6,0,6,華南永昌-民權,2023-06-19,9312
3652,精聯,10,4,6,華南永昌-民權,2023-06-19,9312
4526,東台,6,0,6,華南永昌-民權,2023-06-19,9312
4979,華星光,7,1,6,華南永昌-民權,2023-06-19,9312
8358,金居,6,0,6,華南永昌-民權,2023-06-19,9312
3231,緯創,59,53,6,華南永昌-民權,2023-06-19,9312
3481,群創,183,5,178,華南永昌-民權,2023-06-20,9312
4927,泰鼎-KY,108,12,96,華南永昌-民權,2023-06-20,9312
3045,台灣大,80,15,65,華南永昌-民權,2023-06-20,9312
2888,新光金,62,0,62,華南永昌-民權,2023-06-20,9312
2634,漢翔,133,81,52,華南永昌-民權,2023-06-20,9312
9904,寶成,50,0,50,華南永昌-民權,2023-06-20,9312
8043,蜜望實,30,0,30,華南永昌-民權,2023-06-20,9312
3264,欣銓,26,1,25,華南永昌-民權,2023-06-20,9312
2618,長榮航,24,0,24,華南永昌-民權,2023-06-20,9312
00919,群益台灣精選高息,22,0,22,華南永昌-民權,2023-06-20,9312
2883,凱基金,21,0,21,華南永昌-民權,2023-06-20,9312
00680L,元大美債20正2,21,0,21,華南永昌-民權,2023-06-20,9312
1514,亞力,27,6,21,華南永昌-民權,2023-06-20,9312
2313,華通,21,0,21,華南永昌-民權,2023-06-20,9312
00633L,富邦上証正2,22,2,20,華南永昌-民權,2023-06-20,9312
3682,亞太電,20,0,20,華南永昌-民權,2023-06-20,9312
8046,南電,20,1,19,華南永昌-民權,2023-06-20,9312
2882,國泰金,18,1,17,華南永昌-民權,2023-06-20,9312
1611,中電,20,5,15,華南永昌-民權,2023-06-20,9312
5905,南仁湖,156,143,13,華南永昌-民權,2023-06-20,9312
5876,上海商銀,12,1,11,華南永昌-民權,2023-06-20,9312
1471,首利,21,10,11,華南永昌-民權,2023-06-20,9312
3178,公準,10,0,10,華南永昌-民權,2023-06-20,9312
3419,譁裕,15,5,10,華南永昌-民權,2023-06-20,9312
6152,百一,10,0,10,華南永昌-民權,2023-06-20,9312
1760,寶齡富錦,9,0,9,華南永昌-民權,2023-06-20,9312
2027,大成鋼,11,2,9,華南永昌-民權,2023-06-20,9312
1612,宏泰,11,3,8,華南永昌-民權,2023-06-20,9312
2454,聯發科,9,2,7,華南永昌-民權,2023-06-20,9312
1504,東元,9,2,7,華南永昌-民權,2023-06-20,9312
1904,正隆,7,0,7,華南永昌-民權,2023-06-20,9312
3324,雙鴻,9,2,7,華南永昌-民權,2023-06-20,9312
3380,明泰,7,0,7,華南永昌-民權,2023-06-20,9312
9955,佳龍,7,0,7,華南永昌-民權,2023-06-20,9312
00878,國泰永續高股息,14,7,7,華南永昌-民權,2023-06-20,9312
2337,旺宏,7,1,6,華南永昌-民權,2023-06-20,9312
2520,冠德,6,0,6,華南永昌-民權,2023-06-20,9312
2913,農林,7,1,6,華南永昌-民權,2023-06-20,9312
6443,元晶,19,13,6,華南永昌-民權,2023-06-20,9312
6235,華孚,6,1,5,華南永昌-民權,2023-06-20,9312
1314,中石化,5,0,5,華南永昌-民權,2023-06-20,9312
00712,復華富時不動產,5,0,5,華南永昌-民權,2023-06-20,9312
1438,三地開發,5,0,5,華南永昌-民權,2023-06-20,9312
2376,技嘉,12,7,5,華南永昌-民權,2023-06-20,9312
2515,中工,5,0,5,華南永昌-民權,2023-06-20,9312
4106,雃博,5,0,5,華南永昌-民權,2023-06-20,9312
4950,牧東,5,0,5,華南永昌-民權,2023-06-20,9312
5371,中光電,5,0,5,華南永昌-民權,2023-06-20,9312
6877,鏵友益,5,0,5,華南永昌-民權,2023-06-20,9312
8021,尖點,5,0,5,華南永昌-民權,2023-06-20,9312
2101,南港,200,0,200,華南永昌-民權,2023-06-21,9312
00753L,中信中國50正2,136,0,136,華南永昌-民權,2023-06-21,9312
2618,長榮航,133,6,127,華南永昌-民權,2023-06-21,9312
3013,晟銘電,106,10,96,華南永昌-民權,2023-06-21,9312
2323,中環,88,15,73,華南永昌-民權,2023-06-21,9312
6120,達運,77,8,69,華南永昌-民權,2023-06-21,9312
00927,群益半導體收益,60,0,60,華南永昌-民權,2023-06-21,9312
3051,力特,50,0,50,華南永昌-民權,2023-06-21,9312
2706,第一店,37,3,34,華南永昌-民權,2023-06-21,9312
2017,官田鋼,30,0,30,華南永昌-民權,2023-06-21,9312
3045,台灣大,29,0,29,華南永昌-民權,2023-06-21,9312
00713,元大台灣高息低波,25,1,24,華南永昌-民權,2023-06-21,9312
2609,陽明,33,13,20,華南永昌-民權,2023-06-21,9312
1734,杏輝,20,0,20,華南永昌-民權,2023-06-21,9312
2312,金寶,24,6,18,華南永昌-民權,2023-06-21,9312
00919,群益台灣精選高息,15,1,14,華南永昌-民權,2023-06-21,9312
4106,雃博,14,0,14,華南永昌-民權,2023-06-21,9312
8105,凌巨,20,6,14,華南永昌-民權,2023-06-21,9312
2313,華通,12,0,12,華南永昌-民權,2023-06-21,9312
2736,富野,88,76,12,華南永昌-民權,2023-06-21,9312
3706,神達,22,10,12,華南永昌-民權,2023-06-21,9312
6877,鏵友益,13,1,12,華南永昌-民權,2023-06-21,9312
2634,漢翔,65,53,12,華南永昌-民權,2023-06-21,9312
2201,裕隆,12,1,11,華南永昌-民權,2023-06-21,9312
1504,東元,17,7,10,華南永昌-民權,2023-06-21,9312
1528,恩德,18,8,10,華南永昌-民權,2023-06-21,9312
2359,所羅門,11,1,10,華南永昌-民權,2023-06-21,9312
2903,遠百,10,0,10,華南永昌-民權,2023-06-21,9312
5009,榮剛,10,0,10,華南永昌-民權,2023-06-21,9312
00679B,元大美債20年,10,0,10,華南永昌-民權,2023-06-21,9312
1337,再生-KY,10,0,10,華南永昌-民權,2023-06-21,9312
2337,旺宏,9,0,9,華南永昌-民權,2023-06-21,9312
3443,創意,8,0,8,華南永昌-民權,2023-06-21,9312
2603,長榮,10,2,8,華南永昌-民權,2023-06-21,9312
1609,大亞,17,9,8,華南永昌-民權,2023-06-21,9312
4916,事欣科,18,10,8,華南永昌-民權,2023-06-21,9312
4904,遠傳,7,0,7,華南永昌-民權,2023-06-21,9312
2615,萬海,9,2,7,華南永昌-民權,2023-06-21,9312
00882,中信中國高股息,7,0,7,華南永昌-民權,2023-06-21,9312
1513,中興電,18,12,6,華南永昌-民權,2023-06-21,9312
1611,中電,6,0,6,華南永昌-民權,2023-06-21,9312
00725B,國泰投資級公司債,5,0,5,華南永昌-民權,2023-06-21,9312
1419,新紡,5,0,5,華南永昌-民權,2023-06-21,9312
1802,台玻,5,0,5,華南永昌-民權,2023-06-21,9312
2489,瑞軒,5,0,5,華南永昌-民權,2023-06-21,9312
2492,華新科,6,1,5,華南永昌-民權,2023-06-21,9312
3264,欣銓,10,5,5,華南永昌-民權,2023-06-21,9312
3661,世芯-KY,5,0,5,華南永昌-民權,2023-06-21,9312
6138,茂達,5,0,5,華南永昌-民權,2023-06-21,9312
6235,華孚,5,0,5,華南永昌-民權,2023-06-21,9312
2023,燁輝,106,6,100,華南永昌-民權,2023-06-26,9312
2371,大同,97,8,89,華南永昌-民權,2023-06-26,9312
1536,和大,61,3,58,華南永昌-民權,2023-06-26,9312
00637L,元大滬深300正2,48,15,33,華南永昌-民權,2023-06-26,9312
2303,聯電,33,3,30,華南永昌-民權,2023-06-26,9312
2701,萬企,31,1,30,華南永昌-民權,2023-06-26,9312
2352,佳世達,30,0,30,華南永昌-民權,2023-06-26,9312
2302,麗正,27,0,27,華南永昌-民權,2023-06-26,9312
1419,新紡,20,0,20,華南永昌-民權,2023-06-26,9312
2504,國產,20,0,20,華南永昌-民權,2023-06-26,9312
4927,泰鼎-KY,20,0,20,華南永昌-民權,2023-06-26,9312
6282,康舒,21,3,18,華南永昌-民權,2023-06-26,9312
1611,中電,18,0,18,華南永昌-民權,2023-06-26,9312
1802,台玻,18,0,18,華南永昌-民權,2023-06-26,9312
2705,六福,18,0,18,華南永昌-民權,2023-06-26,9312
3037,欣興,17,1,16,華南永昌-民權,2023-06-26,9312
2609,陽明,13,1,12,華南永昌-民權,2023-06-26,9312
2317,鴻海,19,7,12,華南永昌-民權,2023-06-26,9312
2344,華邦電,31,20,11,華南永昌-民權,2023-06-26,9312
00642U,期元大S＆P石油,11,0,11,華南永昌-民權,2023-06-26,9312
5512,力麒,14,3,11,華南永昌-民權,2023-06-26,9312
2323,中環,86,75,11,華南永昌-民權,2023-06-26,9312
00929,復華台灣科技優息,10,0,10,華南永昌-民權,2023-06-26,9312
2108,南帝,10,0,10,華南永昌-民權,2023-06-26,9312
2356,英業達,41,31,10,華南永昌-民權,2023-06-26,9312
2442,新美齊,10,0,10,華南永昌-民權,2023-06-26,9312
2702,華園,10,0,10,華南永昌-民權,2023-06-26,9312
2888,新光金,10,0,10,華南永昌-民權,2023-06-26,9312
3576,聯合再生,10,0,10,華南永昌-民權,2023-06-26,9312
1710,東聯,9,0,9,華南永昌-民權,2023-06-26,9312
3479,安勤,9,0,9,華南永昌-民權,2023-06-26,9312
2355,敬鵬,8,0,8,華南永昌-民權,2023-06-26,9312
3491,昇達科,8,0,8,華南永昌-民權,2023-06-26,9312
1301,台塑,9,2,7,華南永昌-民權,2023-06-26,9312
1605,華新,67,60,7,華南永昌-民權,2023-06-26,9312
8916,光隆,7,0,7,華南永昌-民權,2023-06-26,9312
2376,技嘉,7,1,6,華南永昌-民權,2023-06-26,9312
2881,富邦金,7,1,6,華南永昌-民權,2023-06-26,9312
8072,陞泰,6,0,6,華南永昌-民權,2023-06-26,9312
2834,臺企銀,8,2,6,華南永昌-民權,2023-06-26,9312
1711,永光,5,0,5,華南永昌-民權,2023-06-26,9312
00632R,元大台灣50反1,5,0,5,華南永昌-民權,2023-06-26,9312
00665L,富邦�琤肭磪囓�2,5,0,5,華南永昌-民權,2023-06-26,9312
00919,群益台灣精選高息,6,1,5,華南永昌-民權,2023-06-26,9312
2313,華通,5,0,5,華南永昌-民權,2023-06-26,9312
2453,凌群,5,0,5,華南永昌-民權,2023-06-26,9312
2498,宏達電,5,0,5,華南永昌-民權,2023-06-26,9312
2645,長榮航太,5,0,5,華南永昌-民權,2023-06-26,9312
3013,晟銘電,8,3,5,華南永昌-民權,2023-06-26,9312
3715,定穎投控,10,5,5,華南永昌-民權,2023-06-26,9312
2323,中環,162,17,145,華南永昌-民權,2023-06-27,9312
2618,長榮航,99,16,83,華南永昌-民權,2023-06-27,9312
3652,精聯,57,0,57,華南永昌-民權,2023-06-27,9312
3481,群創,63,11,52,華南永昌-民權,2023-06-27,9312
2367,燿華,50,0,50,華南永昌-民權,2023-06-27,9312
2610,華航,75,33,42,華南永昌-民權,2023-06-27,9312
5315,光聯,35,0,35,華南永昌-民權,2023-06-27,9312
00929,復華台灣科技優息,54,20,34,華南永昌-民權,2023-06-27,9312
6188,廣明,46,23,23,華南永昌-民權,2023-06-27,9312
3715,定穎投控,23,0,23,華南永昌-民權,2023-06-27,9312
1310,台苯,22,0,22,華南永昌-民權,2023-06-27,9312
1605,華新,131,110,21,華南永昌-民權,2023-06-27,9312
2883,凱基金,21,0,21,華南永昌-民權,2023-06-27,9312
1905,華紙,20,0,20,華南永昌-民權,2023-06-27,9312
1438,三地開發,20,0,20,華南永昌-民權,2023-06-27,9312
1734,杏輝,26,7,19,華南永昌-民權,2023-06-27,9312
1101,台泥,19,0,19,華南永昌-民權,2023-06-27,9312
2344,華邦電,33,15,18,華南永昌-民權,2023-06-27,9312
3037,欣興,20,3,17,華南永昌-民權,2023-06-27,9312
2303,聯電,18,2,16,華南永昌-民權,2023-06-27,9312
3033,威健,16,0,16,華南永昌-民權,2023-06-27,9312
2453,凌群,15,0,15,華南永昌-民權,2023-06-27,9312
3071,協禧,13,0,13,華南永昌-民權,2023-06-27,9312
2498,宏達電,12,0,12,華南永昌-民權,2023-06-27,9312
2204,中華,16,5,11,華南永昌-民權,2023-06-27,9312
2460,建通,11,0,11,華南永昌-民權,2023-06-27,9312
00895,富邦未來車,10,0,10,華南永昌-民權,2023-06-27,9312
00751B,元大AAA至A公司債,10,0,10,華南永昌-民權,2023-06-27,9312
1785,光洋科,10,0,10,華南永昌-民權,2023-06-27,9312
2313,華通,11,1,10,華南永昌-民權,2023-06-27,9312
2349,錸德,10,0,10,華南永昌-民權,2023-06-27,9312
2419,仲琦,10,0,10,華南永昌-民權,2023-06-27,9312
2484,希華,10,0,10,華南永昌-民權,2023-06-27,9312
8926,台汽電,9,0,9,華南永昌-民權,2023-06-27,9312
0056,元大高股息,12,4,8,華南永昌-民權,2023-06-27,9312
00679B,元大美債20年,8,0,8,華南永昌-民權,2023-06-27,9312
1471,首利,8,0,8,華南永昌-民權,2023-06-27,9312
5353,台林,8,0,8,華南永昌-民權,2023-06-27,9312
2405,輔信,7,0,7,華南永昌-民權,2023-06-27,9312
3038,全台,10,3,7,華南永昌-民權,2023-06-27,9312
3051,力特,7,0,7,華南永昌-民權,2023-06-27,9312
5478,智冠,8,1,7,華南永昌-民權,2023-06-27,9312
1301,台塑,6,0,6,華南永昌-民權,2023-06-27,9312
00757,統一FANG+,6,0,6,華南永昌-民權,2023-06-27,9312
3479,安勤,6,0,6,華南永昌-民權,2023-06-27,9312
2201,裕隆,6,1,5,華南永昌-民權,2023-06-27,9312
4207,環泰,5,0,5,華南永昌-民權,2023-06-27,9312
6235,華孚,5,0,5,華南永昌-民權,2023-06-27,9312
2332,友訊,5,0,5,華南永昌-民權,2023-06-27,9312
2371,大同,19,14,5,華南永昌-民權,2023-06-27,9312
1605,華新,93,5,88,華南永昌-民權,2023-06-28,9312
1611,中電,60,1,59,華南永昌-民權,2023-06-28,9312
2323,中環,159,103,56,華南永昌-民權,2023-06-28,9312
2801,彰銀,52,0,52,華南永昌-民權,2023-06-28,9312
2482,連宇,44,0,44,華南永昌-民權,2023-06-28,9312
2883,凱基金,42,0,42,華南永昌-民權,2023-06-28,9312
00715L,期街口布蘭特正2,42,0,42,華南永昌-民權,2023-06-28,9312
2888,新光金,37,0,37,華南永昌-民權,2023-06-28,9312
1101,台泥,43,20,23,華南永昌-民權,2023-06-28,9312
6120,達運,20,0,20,華南永昌-民權,2023-06-28,9312
3481,群創,16,0,16,華南永昌-民權,2023-06-28,9312
2609,陽明,18,3,15,華南永昌-民權,2023-06-28,9312
2615,萬海,16,4,12,華南永昌-民權,2023-06-28,9312
3546,宇峻,11,0,11,華南永昌-民權,2023-06-28,9312
2330,台積電,11,0,11,華南永昌-民權,2023-06-28,9312
2317,鴻海,13,3,10,華南永昌-民權,2023-06-28,9312
2887,台新金,10,0,10,華南永昌-民權,2023-06-28,9312
3047,訊舟,10,0,10,華南永昌-民權,2023-06-28,9312
3592,瑞鼎,10,0,10,華南永昌-民權,2023-06-28,9312
4510,高鋒,20,10,10,華南永昌-民權,2023-06-28,9312
1471,首利,11,2,9,華南永昌-民權,2023-06-28,9312
00642U,期元大S＆P石油,9,0,9,華南永昌-民權,2023-06-28,9312
2002,中鋼,10,1,9,華南永昌-民權,2023-06-28,9312
3033,威健,9,1,8,華南永昌-民權,2023-06-28,9312
2303,聯電,8,0,8,華南永昌-民權,2023-06-28,9312
3260,威剛,8,0,8,華南永昌-民權,2023-06-28,9312
4919,新唐,18,10,8,華南永昌-民權,2023-06-28,9312
2356,英業達,11,3,8,華南永昌-民權,2023-06-28,9312
2736,富野,14,7,7,華南永昌-民權,2023-06-28,9312
3252,海灣,7,0,7,華南永昌-民權,2023-06-28,9312
8222,寶一,27,20,7,華南永昌-民權,2023-06-28,9312
2371,大同,64,57,7,華南永昌-民權,2023-06-28,9312
1608,華榮,7,1,6,華南永昌-民權,2023-06-28,9312
3287,廣寰科,6,0,6,華南永昌-民權,2023-06-28,9312
00882,中信中國高股息,5,0,5,華南永昌-民權,2023-06-28,9312
2313,華通,5,0,5,華南永昌-民權,2023-06-28,9312
2425,承啟,5,0,5,華南永昌-民權,2023-06-28,9312
2904,匯僑,5,0,5,華南永昌-民權,2023-06-28,9312
3013,晟銘電,7,2,5,華南永昌-民權,2023-06-28,9312
3049,精金,5,0,5,華南永昌-民權,2023-06-28,9312
3071,協禧,5,0,5,華南永昌-民權,2023-06-28,9312
4906,正文,5,0,5,華南永昌-民權,2023-06-28,9312
2382,廣達,7,2,5,華南永昌-民權,2023-06-28,9312
0056,元大高股息,6,2,4,華南永昌-民權,2023-06-28,9312
00919,群益台灣精選高息,4,0,4,華南永昌-民權,2023-06-28,9312
1785,光洋科,4,0,4,華南永昌-民權,2023-06-28,9312
2344,華邦電,8,4,4,華南永昌-民權,2023-06-28,9312
2368,金像電,8,4,4,華南永昌-民權,2023-06-28,9312
2376,技嘉,4,0,4,華南永昌-民權,2023-06-28,9312
3704,合勤控,9,5,4,華南永昌-民權,2023-06-28,9312
2610,華航,60,1,59,華南永昌-民權,2023-06-29,9312
1605,華新,85,52,33,華南永昌-民權,2023-06-29,9312
5426,振發,30,2,28,華南永昌-民權,2023-06-29,9312
5009,榮剛,26,1,25,華南永昌-民權,2023-06-29,9312
2303,聯電,23,0,23,華南永昌-民權,2023-06-29,9312
00896,中信綠能及電動車,20,0,20,華南永昌-民權,2023-06-29,9312
6470,宇智,20,2,18,華南永昌-民權,2023-06-29,9312
00893,國泰智能電動車,20,3,17,華南永昌-民權,2023-06-29,9312
2630,亞航,60,45,15,華南永昌-民權,2023-06-29,9312
3661,世芯-KY,16,1,15,華南永昌-民權,2023-06-29,9312
1471,首利,12,0,12,華南永昌-民權,2023-06-29,9312
2834,臺企銀,17,5,12,華南永昌-民權,2023-06-29,9312
2323,中環,21,10,11,華南永昌-民權,2023-06-29,9312
8163,達方,11,0,11,華南永昌-民權,2023-06-29,9312
2891,中信金,10,0,10,華南永昌-民權,2023-06-29,9312
00753L,中信中國50正2,10,0,10,華南永昌-民權,2023-06-29,9312
1307,三芳,10,0,10,華南永昌-民權,2023-06-29,9312
2618,長榮航,30,20,10,華南永昌-民權,2023-06-29,9312
2888,新光金,10,0,10,華南永昌-民權,2023-06-29,9312
7402,邑錡,10,0,10,華南永昌-民權,2023-06-29,9312
2427,三商電,15,6,9,華南永昌-民權,2023-06-29,9312
2460,建通,10,1,9,華南永昌-民權,2023-06-29,9312
2609,陽明,21,12,9,華南永昌-民權,2023-06-29,9312
2317,鴻海,11,2,9,華南永昌-民權,2023-06-29,9312
1310,台苯,8,0,8,華南永昌-民權,2023-06-29,9312
1303,南亞,8,0,8,華南永昌-民權,2023-06-29,9312
1802,台玻,10,3,7,華南永昌-民權,2023-06-29,9312
8210,勤誠,9,2,7,華南永昌-民權,2023-06-29,9312
2313,華通,8,1,7,華南永昌-民權,2023-06-29,9312
2883B,凱基金乙特,6,0,6,華南永昌-民權,2023-06-29,9312
3715,定穎投控,7,1,6,華南永昌-民權,2023-06-29,9312
4157,太景*-KY,20,14,6,華南永昌-民權,2023-06-29,9312
4174,浩鼎,7,1,6,華南永昌-民權,2023-06-29,9312
6173,信昌電,6,0,6,華南永昌-民權,2023-06-29,9312
2002,中鋼,7,1,6,華南永昌-民權,2023-06-29,9312
2634,漢翔,6,1,5,華南永昌-民權,2023-06-29,9312
6160,欣技,7,2,5,華南永昌-民權,2023-06-29,9312
00637L,元大滬深300正2,20,15,5,華南永昌-民權,2023-06-29,9312
3380,明泰,17,12,5,華南永昌-民權,2023-06-29,9312
3413,京鼎,5,0,5,華南永昌-民權,2023-06-29,9312
4915,致伸,5,0,5,華南永昌-民權,2023-06-29,9312
6116,彩晶,7,2,5,華南永昌-民權,2023-06-29,9312
8271,宇瞻,6,1,5,華南永昌-民權,2023-06-29,9312
2353,宏��,6,1,5,華南永昌-民權,2023-06-29,9312
00900,富邦特選高股息30,4,0,4,華南永昌-民權,2023-06-29,9312
00919,群益台灣精選高息,4,0,4,華南永昌-民權,2023-06-29,9312
1528,恩德,21,17,4,華南永昌-民權,2023-06-29,9312
2204,中華,9,5,4,華南永昌-民權,2023-06-29,9312
2359,所羅門,4,0,4,華南永昌-民權,2023-06-29,9312
3374,精材,4,0,4,華南永昌-民權,2023-06-29,9312
2610,華航,135,57,78,華南永昌-民權,2023-06-30,9312
2344,華邦電,74,3,71,華南永昌-民權,2023-06-30,9312
2888,新光金,54,4,50,華南永昌-民權,2023-06-30,9312
00680L,元大美債20正2,47,0,47,華南永昌-民權,2023-06-30,9312
2605,新興,45,5,40,華南永昌-民權,2023-06-30,9312
00885,富邦越南,26,1,25,華南永昌-民權,2023-06-30,9312
2371,大同,51,29,22,華南永昌-民權,2023-06-30,9312
2002,中鋼,17,0,17,華南永昌-民權,2023-06-30,9312
2845,遠東銀,16,0,16,華南永昌-民權,2023-06-30,9312
00929,復華台灣科技優息,22,6,16,華南永昌-民權,2023-06-30,9312
4155,訊映,16,1,15,華南永昌-民權,2023-06-30,9312
6153,嘉聯益,20,5,15,華南永昌-民權,2023-06-30,9312
8050,廣積,25,11,14,華南永昌-民權,2023-06-30,9312
1301,台塑,14,1,13,華南永昌-民權,2023-06-30,9312
3624,光頡,12,0,12,華南永昌-民權,2023-06-30,9312
2883,凱基金,28,16,12,華南永昌-民權,2023-06-30,9312
1419,新紡,10,0,10,華南永昌-民權,2023-06-30,9312
2329,華泰,11,1,10,華南永昌-民權,2023-06-30,9312
2611,志信,10,0,10,華南永昌-民權,2023-06-30,9312
4533,協易機,10,0,10,華南永昌-民權,2023-06-30,9312
6197,佳必琪,11,1,10,華南永昌-民權,2023-06-30,9312
3661,世芯-KY,9,0,9,華南永昌-民權,2023-06-30,9312
6285,啟��,7,0,7,華南永昌-民權,2023-06-30,9312
00679B,元大美債20年,7,0,7,華南永昌-民權,2023-06-30,9312
1528,恩德,8,1,7,華南永昌-民權,2023-06-30,9312
3231,緯創,17,10,7,華南永昌-民權,2023-06-30,9312
8110,華東,6,0,6,華南永昌-民權,2023-06-30,9312
00900,富邦特選高股息30,6,1,5,華南永昌-民權,2023-06-30,9312
2332,友訊,11,6,5,華南永昌-民權,2023-06-30,9312
4162,智擎,5,0,5,華南永昌-民權,2023-06-30,9312
4526,東台,5,0,5,華南永昌-民權,2023-06-30,9312
6117,迎廣,7,2,5,華南永昌-民權,2023-06-30,9312
6173,信昌電,5,0,5,華南永昌-民權,2023-06-30,9312
2634,漢翔,5,1,4,華南永昌-民權,2023-06-30,9312
1605,華新,5,1,4,華南永昌-民權,2023-06-30,9312
1101,台泥,5,1,4,華南永昌-民權,2023-06-30,9312
00720B,元大投資級公司債,4,0,4,華南永昌-民權,2023-06-30,9312
1783,和康生,4,0,4,華南永昌-民權,2023-06-30,9312
2301,光寶科,5,1,4,華南永昌-民權,2023-06-30,9312
2352,佳世達,4,0,4,華南永昌-民權,2023-06-30,9312
2492,華新科,4,0,4,華南永昌-民權,2023-06-30,9312
2884,玉山金,4,0,4,華南永昌-民權,2023-06-30,9312
6550,北極星藥業-KY,8,4,4,華南永昌-民權,2023-06-30,9312
6743,安普新,4,0,4,華南永昌-民權,2023-06-30,9312
2323,中環,14,10,4,華南永昌-民權,2023-06-30,9312
1533,車王電,4,1,3,華南永昌-民權,2023-06-30,9312
1589,永冠-KY,3,0,3,華南永昌-民權,2023-06-30,9312
1612,宏泰,3,0,3,華南永昌-民權,2023-06-30,9312
2331,精英,3,0,3,華南永昌-民權,2023-06-30,9312
2405,輔信,3,0,3,華南永昌-民權,2023-06-30,9312
2303,聯電,51,1,50,華南永昌-民權,2023-07-03,9312
1609,大亞,49,3,46,華南永昌-民權,2023-07-03,9312
2302,麗正,30,0,30,華南永昌-民權,2023-07-03,9312
1504,東元,30,4,26,華南永昌-民權,2023-07-03,9312
6138,茂達,22,0,22,華南永昌-民權,2023-07-03,9312
3481,群創,33,12,21,華南永昌-民權,2023-07-03,9312
3047,訊舟,20,0,20,華南永昌-民權,2023-07-03,9312
1513,中興電,22,4,18,華南永昌-民權,2023-07-03,9312
1605,華新,25,7,18,華南永昌-民權,2023-07-03,9312
2610,華航,235,218,17,華南永昌-民權,2023-07-03,9312
2356,英業達,99,83,16,華南永昌-民權,2023-07-03,9312
4106,雃博,15,0,15,華南永昌-民權,2023-07-03,9312
6220,岳豐,15,0,15,華南永昌-民權,2023-07-03,9312
3704,合勤控,17,3,14,華南永昌-民權,2023-07-03,9312
1528,恩德,35,22,13,華南永昌-民權,2023-07-03,9312
6148,驊宏資,53,42,11,華南永昌-民權,2023-07-03,9312
5315,光聯,11,0,11,華南永昌-民權,2023-07-03,9312
2344,華邦電,17,6,11,華南永昌-民權,2023-07-03,9312
2736,富野,53,42,11,華南永昌-民權,2023-07-03,9312
4155,訊映,11,0,11,華南永昌-民權,2023-07-03,9312
4906,正文,30,19,11,華南永昌-民權,2023-07-03,9312
5512,力麒,11,0,11,華南永昌-民權,2023-07-03,9312
00905,FT臺灣Smart,10,0,10,華南永昌-民權,2023-07-03,9312
3363,上詮,10,0,10,華南永昌-民權,2023-07-03,9312
3413,京鼎,10,0,10,華南永昌-民權,2023-07-03,9312
4968,立積,10,0,10,華南永昌-民權,2023-07-03,9312
3128,昇銳,10,1,9,華南永昌-民權,2023-07-03,9312
6834,天二科技,9,0,9,華南永昌-民權,2023-07-03,9312
8059,凱碩,9,0,9,華南永昌-民權,2023-07-03,9312
2892,第一金,9,0,9,華南永昌-民權,2023-07-03,9312
3078,僑威,14,6,8,華南永昌-民權,2023-07-03,9312
2371,大同,58,50,8,華南永昌-民權,2023-07-03,9312
3652,精聯,30,22,8,華南永昌-民權,2023-07-03,9312
00882,中信中國高股息,7,0,7,華南永昌-民權,2023-07-03,9312
3346,麗清,7,0,7,華南永昌-民權,2023-07-03,9312
1710,東聯,6,0,6,華南永昌-民權,2023-07-03,9312
2474,可成,6,0,6,華南永昌-民權,2023-07-03,9312
4533,協易機,6,0,6,華南永昌-民權,2023-07-03,9312
4541,晟田,9,3,6,華南永昌-民權,2023-07-03,9312
8048,德勝,7,1,6,華南永昌-民權,2023-07-03,9312
3231,緯創,48,42,6,華南永昌-民權,2023-07-03,9312
5608,四維航,5,0,5,華南永昌-民權,2023-07-03,9312
1612,宏泰,6,1,5,華南永昌-民權,2023-07-03,9312
4915,致伸,5,0,5,華南永昌-民權,2023-07-03,9312
6532,瑞耘,5,0,5,華南永昌-民權,2023-07-03,9312
2382,廣達,10,5,5,華南永昌-民權,2023-07-03,9312
2880,華南金,5,1,4,華南永昌-民權,2023-07-03,9312
2618,長榮航,16,12,4,華南永昌-民權,2023-07-03,9312
2889,國票金,4,0,4,華南永昌-民權,2023-07-03,9312
3027,盛達,5,1,4,華南永昌-民權,2023-07-03,9312
2897,王道銀行,200,12,188,華南永昌-民權,2023-07-04,9312
1603,華電,149,0,149,華南永昌-民權,2023-07-04,9312
3706,神達,110,30,80,華南永昌-民權,2023-07-04,9312
2883,凱基金,58,10,48,華南永昌-民權,2023-07-04,9312
4155,訊映,45,16,29,華南永昌-民權,2023-07-04,9312
1799,易威,27,0,27,華南永昌-民權,2023-07-04,9312
0056,元大高股息,40,17,23,華南永昌-民權,2023-07-04,9312
3025,星通,74,51,23,華南永昌-民權,2023-07-04,9312
6168,宏齊,20,0,20,華南永昌-民權,2023-07-04,9312
6269,台郡,20,0,20,華南永昌-民權,2023-07-04,9312
3498,陽程,17,0,17,華南永昌-民權,2023-07-04,9312
1314,中石化,16,0,16,華南永昌-民權,2023-07-04,9312
1905,華紙,24,10,14,華南永昌-民權,2023-07-04,9312
2603,長榮,51,37,14,華南永昌-民權,2023-07-04,9312
2340,台亞,144,131,13,華南永昌-民權,2023-07-04,9312
00929,復華台灣科技優息,12,0,12,華南永昌-民權,2023-07-04,9312
2331,精英,12,1,11,華南永昌-民權,2023-07-04,9312
2888,新光金,11,0,11,華南永昌-民權,2023-07-04,9312
5426,振發,43,32,11,華南永昌-民權,2023-07-04,9312
2421,建準,23,12,11,華南永昌-民權,2023-07-04,9312
00885,富邦越南,10,0,10,華南永昌-民權,2023-07-04,9312
2027,大成鋼,10,0,10,華南永昌-民權,2023-07-04,9312
3049,精金,10,0,10,華南永昌-民權,2023-07-04,9312
3652,精聯,11,1,10,華南永昌-民權,2023-07-04,9312
4726,永昕,13,3,10,華南永昌-民權,2023-07-04,9312
6138,茂達,12,2,10,華南永昌-民權,2023-07-04,9312
6220,岳豐,9,0,9,華南永昌-民權,2023-07-04,9312
1612,宏泰,8,0,8,華南永昌-民權,2023-07-04,9312
2419,仲琦,19,11,8,華南永昌-民權,2023-07-04,9312
6776,展�眥篕�,8,0,8,華南永昌-民權,2023-07-04,9312
1303,南亞,7,0,7,華南永昌-民權,2023-07-04,9312
3483,力致,7,0,7,華南永昌-民權,2023-07-04,9312
3704,合勤控,8,1,7,華南永昌-民權,2023-07-04,9312
2317,鴻海,8,2,6,華南永昌-民權,2023-07-04,9312
1609,大亞,10,4,6,華南永昌-民權,2023-07-04,9312
1802,台玻,6,0,6,華南永昌-民權,2023-07-04,9312
2353,宏��,8,2,6,華南永昌-民權,2023-07-04,9312
5425,台半,6,0,6,華南永昌-民權,2023-07-04,9312
6191,精成科,7,1,6,華南永昌-民權,2023-07-04,9312
2301,光寶科,11,5,6,華南永昌-民權,2023-07-04,9312
2615,萬海,35,30,5,華南永昌-民權,2023-07-04,9312
1815,富喬,5,0,5,華南永昌-民權,2023-07-04,9312
2486,一詮,12,7,5,華南永昌-民權,2023-07-04,9312
3308,聯德,5,0,5,華南永昌-民權,2023-07-04,9312
3576,聯合再生,5,0,5,華南永昌-民權,2023-07-04,9312
3712,永崴投控,5,0,5,華南永昌-民權,2023-07-04,9312
4904,遠傳,5,0,5,華南永昌-民權,2023-07-04,9312
6153,嘉聯益,6,1,5,華南永昌-民權,2023-07-04,9312
8150,南茂,6,1,5,華南永昌-民權,2023-07-04,9312
6789,采鈺,9,5,4,華南永昌-民權,2023-07-04,9312
2888,新光金,530,16,514,華南永昌-民權,2023-07-05,9312
2303,聯電,39,0,39,華南永昌-民權,2023-07-05,9312
1514,亞力,37,2,35,華南永昌-民權,2023-07-05,9312
3706,神達,32,1,31,華南永昌-民權,2023-07-05,9312
4760,勤凱,31,0,31,華南永昌-民權,2023-07-05,9312
00858,永豐美國500大,30,0,30,華南永昌-民權,2023-07-05,9312
2883,凱基金,30,0,30,華南永昌-民權,2023-07-05,9312
3205,佰研,30,0,30,華南永昌-民權,2023-07-05,9312
1905,華紙,31,3,28,華南永昌-民權,2023-07-05,9312
00885,富邦越南,26,1,25,華南永昌-民權,2023-07-05,9312
4927,泰鼎-KY,45,20,25,華南永昌-民權,2023-07-05,9312
2356,英業達,83,59,24,華南永昌-民權,2023-07-05,9312
6191,精成科,24,0,24,華南永昌-民權,2023-07-05,9312
00673R,期元大S＆P原油反1,20,0,20,華南永昌-民權,2023-07-05,9312
2609,陽明,63,44,19,華南永昌-民權,2023-07-05,9312
2610,華航,289,271,18,華南永昌-民權,2023-07-05,9312
1584,精剛,16,0,16,華南永昌-民權,2023-07-05,9312
3231,緯創,18,2,16,華南永昌-民權,2023-07-05,9312
8112,至上,15,0,15,華南永昌-民權,2023-07-05,9312
2419,仲琦,24,11,13,華南永昌-民權,2023-07-05,9312
2301,光寶科,13,0,13,華南永昌-民權,2023-07-05,9312
6257,矽格,14,1,13,華南永昌-民權,2023-07-05,9312
1605,華新,14,2,12,華南永昌-民權,2023-07-05,9312
00929,復華台灣科技優息,12,0,12,華南永昌-民權,2023-07-05,9312
2344,華邦電,20,8,12,華南永昌-民權,2023-07-05,9312
2460,建通,15,4,11,華南永昌-民權,2023-07-05,9312
2705,六福,11,0,11,華南永昌-民權,2023-07-05,9312
3624,光頡,11,0,11,華南永昌-民權,2023-07-05,9312
3682,亞太電,11,0,11,華南永昌-民權,2023-07-05,9312
6129,普誠,11,0,11,華南永昌-民權,2023-07-05,9312
3363,上詮,16,6,10,華南永昌-民權,2023-07-05,9312
2380,虹光,10,0,10,華南永昌-民權,2023-07-05,9312
3011,今皓,10,0,10,華南永昌-民權,2023-07-05,9312
3362,先進光,21,11,10,華南永昌-民權,2023-07-05,9312
4167,松瑞藥,10,0,10,華南永昌-民權,2023-07-05,9312
9907,統一實,10,0,10,華南永昌-民權,2023-07-05,9312
6285,啟��,12,2,10,華南永昌-民權,2023-07-05,9312
3372,典範,9,0,9,華南永昌-民權,2023-07-05,9312
1536,和大,10,1,9,華南永昌-民權,2023-07-05,9312
1714,和桐,10,1,9,華南永昌-民權,2023-07-05,9312
2449,京元電子,9,0,9,華南永昌-民權,2023-07-05,9312
3025,星通,33,24,9,華南永昌-民權,2023-07-05,9312
5508,永信建,9,0,9,華南永昌-民權,2023-07-05,9312
4919,新唐,9,1,8,華南永昌-民權,2023-07-05,9312
6477,安集,10,2,8,華南永昌-民權,2023-07-05,9312
2317,鴻海,9,2,7,華南永昌-民權,2023-07-05,9312
2230,泰茂,7,0,7,華南永昌-民權,2023-07-05,9312
2337,旺宏,8,1,7,華南永昌-民權,2023-07-05,9312
6180,橘子,7,0,7,華南永昌-民權,2023-07-05,9312
8358,金居,8,1,7,華南永昌-民權,2023-07-05,9312
3481,群創,145,51,94,華南永昌-民權,2023-07-06,9312
2888,新光金,66,1,65,華南永昌-民權,2023-07-06,9312
00858,永豐美國500大,51,0,51,華南永昌-民權,2023-07-06,9312
2883,凱基金,50,4,46,華南永昌-民權,2023-07-06,9312
2887,台新金,43,0,43,華南永昌-民權,2023-07-06,9312
2303,聯電,43,3,40,華南永昌-民權,2023-07-06,9312
6152,百一,40,0,40,華南永昌-民權,2023-07-06,9312
00929,復華台灣科技優息,39,1,38,華南永昌-民權,2023-07-06,9312
3037,欣興,44,9,35,華南永昌-民權,2023-07-06,9312
00680L,元大美債20正2,38,10,28,華南永昌-民權,2023-07-06,9312
00900,富邦特選高股息30,27,0,27,華南永昌-民權,2023-07-06,9312
2880,華南金,32,8,24,華南永昌-民權,2023-07-06,9312
1303,南亞,23,0,23,華南永昌-民權,2023-07-06,9312
3362,先進光,26,3,23,華南永昌-民權,2023-07-06,9312
5009,榮剛,23,0,23,華南永昌-民權,2023-07-06,9312
1471,首利,23,1,22,華南永昌-民權,2023-07-06,9312
8215,明基材,22,1,21,華南永昌-民權,2023-07-06,9312
2603,長榮,26,5,21,華南永昌-民權,2023-07-06,9312
00881,國泰台灣5G+,20,0,20,華南永昌-民權,2023-07-06,9312
3576,聯合再生,20,0,20,華南永昌-民權,2023-07-06,9312
4720,德淵,20,0,20,華南永昌-民權,2023-07-06,9312
00882,中信中國高股息,18,0,18,華南永昌-民權,2023-07-06,9312
4155,訊映,22,5,17,華南永昌-民權,2023-07-06,9312
2630,亞航,38,22,16,華南永昌-民權,2023-07-06,9312
2812,台中銀,19,4,15,華南永昌-民權,2023-07-06,9312
2317,鴻海,14,0,14,華南永昌-民權,2023-07-06,9312
1101,台泥,114,100,14,華南永昌-民權,2023-07-06,9312
00679B,元大美債20年,14,0,14,華南永昌-民權,2023-07-06,9312
1326,台化,14,0,14,華南永昌-民權,2023-07-06,9312
2634,漢翔,22,8,14,華南永昌-民權,2023-07-06,9312
00885,富邦越南,13,0,13,華南永昌-民權,2023-07-06,9312
00922,國泰台灣領袖50,13,0,13,華南永昌-民權,2023-07-06,9312
2371,大同,66,53,13,華南永昌-民權,2023-07-06,9312
2882,國泰金,12,0,12,華南永昌-民權,2023-07-06,9312
2618,長榮航,26,14,12,華南永昌-民權,2023-07-06,9312
2002,中鋼,12,0,12,華南永昌-民權,2023-07-06,9312
00673R,期元大S＆P原油反1,11,0,11,華南永昌-民權,2023-07-06,9312
2380,虹光,11,0,11,華南永昌-民權,2023-07-06,9312
2890,永豐金,11,0,11,華南永昌-民權,2023-07-06,9312
00637L,元大滬深300正2,10,0,10,華南永昌-民權,2023-07-06,9312
00753L,中信中國50正2,10,0,10,華南永昌-民權,2023-07-06,9312
00916,國泰全球品牌50,10,0,10,華南永昌-民權,2023-07-06,9312
1410,南染,10,0,10,華南永昌-民權,2023-07-06,9312
2402,毅嘉,10,0,10,華南永昌-民權,2023-07-06,9312
3682,亞太電,10,0,10,華南永昌-民權,2023-07-06,9312
4414,如興,10,0,10,華南永昌-民權,2023-07-06,9312
00919,群益台灣精選高息,9,0,9,華南永昌-民權,2023-07-06,9312
1536,和大,10,1,9,華南永昌-民權,2023-07-06,9312
2382,廣達,35,26,9,華南永昌-民權,2023-07-06,9312
3025,星通,10,1,9,華南永昌-民權,2023-07-06,9312
3481,群創,81,5,76,華南永昌-民權,2023-07-07,9312
6282,康舒,41,5,36,華南永昌-民權,2023-07-07,9312
00929,復華台灣科技優息,35,0,35,華南永昌-民權,2023-07-07,9312
00885,富邦越南,37,5,32,華南永昌-民權,2023-07-07,9312
00680L,元大美債20正2,31,0,31,華南永昌-民權,2023-07-07,9312
1799,易威,27,0,27,華南永昌-民權,2023-07-07,9312
8039,台虹,24,2,22,華南永昌-民權,2023-07-07,9312
2706,第一店,20,0,20,華南永昌-民權,2023-07-07,9312
3713,新晶投控,20,0,20,華南永昌-民權,2023-07-07,9312
0056,元大高股息,27,10,17,華南永昌-民權,2023-07-07,9312
6116,彩晶,17,0,17,華南永昌-民權,2023-07-07,9312
2453,凌群,17,1,16,華南永昌-民權,2023-07-07,9312
3661,世芯-KY,21,6,15,華南永昌-民權,2023-07-07,9312
2882,國泰金,14,0,14,華南永昌-民權,2023-07-07,9312
8358,金居,17,3,14,華南永昌-民權,2023-07-07,9312
1314,中石化,12,0,12,華南永昌-民權,2023-07-07,9312
8299,群聯,12,0,12,華南永昌-民權,2023-07-07,9312
2344,華邦電,21,9,12,華南永昌-民權,2023-07-07,9312
2633,台灣高鐵,12,0,12,華南永昌-民權,2023-07-07,9312
00893,國泰智能電動車,11,0,11,華南永昌-民權,2023-07-07,9312
3071,協禧,11,0,11,華南永昌-民權,2023-07-07,9312
3363,上詮,35,24,11,華南永昌-民權,2023-07-07,9312
6182,合晶,15,4,11,華南永昌-民權,2023-07-07,9312
1410,南染,10,0,10,華南永昌-民權,2023-07-07,9312
00922,國泰台灣領袖50,10,0,10,華南永昌-民權,2023-07-07,9312
4968,立積,12,2,10,華南永昌-民權,2023-07-07,9312
6220,岳豐,10,0,10,華南永昌-民權,2023-07-07,9312
2887,台新金,37,28,9,華南永昌-民權,2023-07-07,9312
3163,波若威,9,0,9,華南永昌-民權,2023-07-07,9312
5347,世界,9,0,9,華南永昌-民權,2023-07-07,9312
6443,元晶,13,4,9,華南永昌-民權,2023-07-07,9312
3362,先進光,11,3,8,華南永昌-民權,2023-07-07,9312
8050,廣積,8,0,8,華南永昌-民權,2023-07-07,9312
3189,景碩,8,0,8,華南永昌-民權,2023-07-07,9312
00878,國泰永續高股息,15,8,7,華南永昌-民權,2023-07-07,9312
2340,台亞,25,18,7,華南永昌-民權,2023-07-07,9312
2603,長榮,15,8,7,華南永昌-民權,2023-07-07,9312
2002,中鋼,10,3,7,華南永昌-民權,2023-07-07,9312
3029,零壹,7,0,7,華南永昌-民權,2023-07-07,9312
3081,聯亞,10,3,7,華南永昌-民權,2023-07-07,9312
3707,漢磊,7,0,7,華南永昌-民權,2023-07-07,9312
6138,茂達,12,5,7,華南永昌-民權,2023-07-07,9312
2880,華南金,16,10,6,華南永昌-民權,2023-07-07,9312
4510,高鋒,10,4,6,華南永昌-民權,2023-07-07,9312
4526,東台,6,0,6,華南永昌-民權,2023-07-07,9312
6188,廣明,8,2,6,華南永昌-民權,2023-07-07,9312
1301,台塑,6,0,6,華南永昌-民權,2023-07-07,9312
00882,中信中國高股息,5,0,5,華南永昌-民權,2023-07-07,9312
00679B,元大美債20年,5,0,5,華南永昌-民權,2023-07-07,9312
00753L,中信中國50正2,5,0,5,華南永昌-民權,2023-07-07,9312
00878,國泰永續高股息,73,2,71,華南永昌-民權,2023-07-10,9312
0056,元大高股息,65,4,61,華南永昌-民權,2023-07-10,9312
8163,達方,40,0,40,華南永昌-民權,2023-07-10,9312
3661,世芯-KY,40,0,40,華南永昌-民權,2023-07-10,9312
2504,國產,35,0,35,華南永昌-民權,2023-07-10,9312
1799,易威,30,0,30,華南永昌-民權,2023-07-10,9312
2359,所羅門,28,0,28,華南永昌-民權,2023-07-10,9312
00713,元大台灣高息低波,25,0,25,華南永昌-民權,2023-07-10,9312
1101,台泥,38,15,23,華南永昌-民權,2023-07-10,9312
00680L,元大美債20正2,21,0,21,華南永昌-民權,2023-07-10,9312
6138,茂達,28,7,21,華南永昌-民權,2023-07-10,9312
00893,國泰智能電動車,31,11,20,華南永昌-民權,2023-07-10,9312
3045,台灣大,19,0,19,華南永昌-民權,2023-07-10,9312
00929,復華台灣科技優息,16,1,15,華南永昌-民權,2023-07-10,9312
2436,偉詮電,16,1,15,華南永昌-民權,2023-07-10,9312
6152,百一,15,0,15,華南永昌-民權,2023-07-10,9312
2886,兆豐金,15,1,14,華南永昌-民權,2023-07-10,9312
4532,瑞智,18,4,14,華南永昌-民權,2023-07-10,9312
1504,東元,35,21,14,華南永昌-民權,2023-07-10,9312
6770,力積電,12,0,12,華南永昌-民權,2023-07-10,9312
2419,仲琦,249,238,11,華南永昌-民權,2023-07-10,9312
2027,大成鋼,12,2,10,華南永昌-民權,2023-07-10,9312
1109,信大,10,0,10,華南永昌-民權,2023-07-10,9312
2618,長榮航,17,7,10,華南永昌-民權,2023-07-10,9312
3081,聯亞,10,0,10,華南永昌-民權,2023-07-10,9312
4173,久裕,10,0,10,華南永昌-民權,2023-07-10,9312
8411,福貞-KY,10,0,10,華南永昌-民權,2023-07-10,9312
1611,中電,10,1,9,華南永昌-民權,2023-07-10,9312
2402,毅嘉,10,1,9,華南永昌-民權,2023-07-10,9312
2460,建通,12,3,9,華南永昌-民權,2023-07-10,9312
3047,訊舟,15,6,9,華南永昌-民權,2023-07-10,9312
00919,群益台灣精選高息,8,0,8,華南永昌-民權,2023-07-10,9312
2303,聯電,10,2,8,華南永昌-民權,2023-07-10,9312
2801,彰銀,7,0,7,華南永昌-民權,2023-07-10,9312
4927,泰鼎-KY,10,3,7,華南永昌-民權,2023-07-10,9312
2615,萬海,8,1,7,華南永昌-民權,2023-07-10,9312
2884,玉山金,7,1,6,華南永昌-民權,2023-07-10,9312
00751B,元大AAA至A公司債,6,0,6,華南永昌-民權,2023-07-10,9312
1711,永光,6,0,6,華南永昌-民權,2023-07-10,9312
2105,正新,6,0,6,華南永昌-民權,2023-07-10,9312
8070,長華*,6,0,6,華南永昌-民權,2023-07-10,9312
2634,漢翔,8,2,6,華南永昌-民權,2023-07-10,9312
00900,富邦特選高股息30,5,0,5,華南永昌-民權,2023-07-10,9312
00905,FT臺灣Smart,5,0,5,華南永昌-民權,2023-07-10,9312
00720B,元大投資級公司債,5,0,5,華南永昌-民權,2023-07-10,9312
00753L,中信中國50正2,5,0,5,華南永昌-民權,2023-07-10,9312
00891,中信關鍵半導體,5,0,5,華南永昌-民權,2023-07-10,9312
00673R,期元大S＆P原油反1,5,0,5,華南永昌-民權,2023-07-10,9312
2331,精英,5,0,5,華南永昌-民權,2023-07-10,9312
2731,雄獅,5,0,5,華南永昌-民權,2023-07-10,9312
2371,大同,81,16,65,華南永昌-民權,2023-07-11,9312
2323,中環,53,7,46,華南永昌-民權,2023-07-11,9312
6138,茂達,45,4,41,華南永昌-民權,2023-07-11,9312
8927,北基,40,0,40,華南永昌-民權,2023-07-11,9312
2457,飛宏,106,81,25,華南永昌-民權,2023-07-11,9312
00688L,國泰20年美債正2,24,0,24,華南永昌-民權,2023-07-11,9312
6182,合晶,24,3,21,華南永昌-民權,2023-07-11,9312
1471,首利,20,0,20,華南永昌-民權,2023-07-11,9312
00858,永豐美國500大,20,0,20,華南永昌-民權,2023-07-11,9312
6234,高僑,22,2,20,華南永昌-民權,2023-07-11,9312
1799,易威,19,0,19,華南永昌-民權,2023-07-11,9312
2312,金寶,21,4,17,華南永昌-民權,2023-07-11,9312
4532,瑞智,20,3,17,華南永昌-民權,2023-07-11,9312
8916,光隆,15,0,15,華南永昌-民權,2023-07-11,9312
9904,寶成,15,0,15,華南永昌-民權,2023-07-11,9312
3034,聯詠,13,0,13,華南永昌-民權,2023-07-11,9312
1777,生泰,13,0,13,華南永昌-民權,2023-07-11,9312
2340,台亞,23,10,13,華南永昌-民權,2023-07-11,9312
3231,緯創,29,17,12,華南永昌-民權,2023-07-11,9312
1109,信大,12,0,12,華南永昌-民權,2023-07-11,9312
3652,精聯,12,0,12,華南永昌-民權,2023-07-11,9312
2887,台新金,14,4,10,華南永昌-民權,2023-07-11,9312
00924,復華S＆P500成長,10,0,10,華南永昌-民權,2023-07-11,9312
2027,大成鋼,10,0,10,華南永昌-民權,2023-07-11,9312
2385,群光,10,0,10,華南永昌-民權,2023-07-11,9312
00679B,元大美債20年,10,1,9,華南永昌-民權,2023-07-11,9312
1434,福懋,16,7,9,華南永昌-民權,2023-07-11,9312
1608,華榮,16,8,8,華南永昌-民權,2023-07-11,9312
3498,陽程,8,0,8,華南永昌-民權,2023-07-11,9312
5309,系統電,8,0,8,華南永昌-民權,2023-07-11,9312
00640L,富邦日本正2,10,3,7,華南永昌-民權,2023-07-11,9312
2301,光寶科,14,7,7,華南永昌-民權,2023-07-11,9312
8358,金居,7,0,7,華南永昌-民權,2023-07-11,9312
3704,合勤控,7,0,7,華南永昌-民權,2023-07-11,9312
1609,大亞,22,16,6,華南永昌-民權,2023-07-11,9312
3052,夆典,6,0,6,華南永昌-民權,2023-07-11,9312
9907,統一實,6,0,6,華南永昌-民權,2023-07-11,9312
3035,智原,12,6,6,華南永昌-民權,2023-07-11,9312
00632R,元大台灣50反1,5,0,5,華南永昌-民權,2023-07-11,9312
1905,華紙,5,0,5,華南永昌-民權,2023-07-11,9312
2367,燿華,5,0,5,華南永昌-民權,2023-07-11,9312
2453,凌群,5,0,5,華南永昌-民權,2023-07-11,9312
2460,建通,7,2,5,華南永昌-民權,2023-07-11,9312
2504,國產,5,0,5,華南永昌-民權,2023-07-11,9312
3205,佰研,5,0,5,華南永昌-民權,2023-07-11,9312
4720,德淵,5,0,5,華南永昌-民權,2023-07-11,9312
4989,榮科,5,0,5,華南永昌-民權,2023-07-11,9312
8101,華冠,5,0,5,華南永昌-民權,2023-07-11,9312
8201,無敵,5,0,5,華南永昌-民權,2023-07-11,9312
8093,保銳,5,0,5,華南永昌-民權,2023-07-11,9312
2897,王道銀行,500,0,500,華南永昌-民權,2023-07-12,9312
6187,萬潤,260,10,250,華南永昌-民權,2023-07-12,9312
2409,友達,136,4,132,華南永昌-民權,2023-07-12,9312
2330,台積電,70,0,70,華南永昌-民權,2023-07-12,9312
00878,國泰永續高股息,83,28,55,華南永昌-民權,2023-07-12,9312
8411,福貞-KY,50,0,50,華南永昌-民權,2023-07-12,9312
3037,欣興,50,4,46,華南永昌-民權,2023-07-12,9312
2303,聯電,41,0,41,華南永昌-民權,2023-07-12,9312
2618,長榮航,54,19,35,華南永昌-民權,2023-07-12,9312
3652,精聯,36,2,34,華南永昌-民權,2023-07-12,9312
2347,聯強,30,1,29,華南永昌-民權,2023-07-12,9312
2881,富邦金,30,2,28,華南永昌-民權,2023-07-12,9312
2481,強茂,40,15,25,華南永昌-民權,2023-07-12,9312
0056,元大高股息,43,18,25,華南永昌-民權,2023-07-12,9312
3081,聯亞,20,0,20,華南永昌-民權,2023-07-12,9312
1513,中興電,30,15,15,華南永昌-民權,2023-07-12,9312
2504,國產,15,0,15,華南永昌-民權,2023-07-12,9312
4414,如興,15,0,15,華南永昌-民權,2023-07-12,9312
6477,安集,15,1,14,華南永昌-民權,2023-07-12,9312
6548,長科*,24,10,14,華南永昌-民權,2023-07-12,9312
1301,台塑,13,0,13,華南永昌-民權,2023-07-12,9312
2027,大成鋼,13,0,13,華南永昌-民權,2023-07-12,9312
5258,虹堡,17,5,12,華南永昌-民權,2023-07-12,9312
4916,事欣科,12,0,12,華南永昌-民權,2023-07-12,9312
8038,長園科,12,0,12,華南永昌-民權,2023-07-12,9312
00673R,期元大S＆P原油反1,11,0,11,華南永昌-民權,2023-07-12,9312
1536,和大,12,1,11,華南永昌-民權,2023-07-12,9312
2302,麗正,11,0,11,華南永昌-民權,2023-07-12,9312
1410,南染,10,0,10,華南永昌-民權,2023-07-12,9312
2464,盟立,10,0,10,華南永昌-民權,2023-07-12,9312
2468,華經,10,0,10,華南永昌-民權,2023-07-12,9312
5519,隆大,10,0,10,華南永昌-民權,2023-07-12,9312
6167,久正,11,1,10,華南永昌-民權,2023-07-12,9312
6265,方土昶,10,0,10,華南永昌-民權,2023-07-12,9312
6550,北極星藥業-KY,29,19,10,華南永昌-民權,2023-07-12,9312
1314,中石化,9,0,9,華南永昌-民權,2023-07-12,9312
3508,位速,10,1,9,華南永昌-民權,2023-07-12,9312
2317,鴻海,9,1,8,華南永昌-民權,2023-07-12,9312
00733,富邦臺灣中小,8,0,8,華南永昌-民權,2023-07-12,9312
2312,金寶,10,2,8,華南永昌-民權,2023-07-12,9312
2324,仁寶,16,8,8,華南永昌-民權,2023-07-12,9312
2607,榮運,8,0,8,華南永昌-民權,2023-07-12,9312
3045,台灣大,8,0,8,華南永昌-民權,2023-07-12,9312
4111,濟生,8,0,8,華南永昌-民權,2023-07-12,9312
6414,樺漢,8,0,8,華南永昌-民權,2023-07-12,9312
4532,瑞智,9,1,8,華南永昌-民權,2023-07-12,9312
6282,康舒,12,5,7,華南永昌-民權,2023-07-12,9312
3128,昇銳,7,0,7,華南永昌-民權,2023-07-12,9312
3163,波若威,9,2,7,華南永昌-民權,2023-07-12,9312
5608,四維航,7,0,7,華南永昌-民權,2023-07-12,9312
2618,長榮航,816,56,760,華南永昌-民權,2023-07-13,9312
2449,京元電子,171,41,130,華南永昌-民權,2023-07-13,9312
1410,南染,125,0,125,華南永昌-民權,2023-07-13,9312
5258,虹堡,105,4,101,華南永昌-民權,2023-07-13,9312
00858,永豐美國500大,100,0,100,華南永昌-民權,2023-07-13,9312
6187,萬潤,100,10,90,華南永昌-民權,2023-07-13,9312
2610,華航,76,8,68,華南永昌-民權,2023-07-13,9312
2347,聯強,50,0,50,華南永昌-民權,2023-07-13,9312
2329,華泰,369,336,33,華南永昌-民權,2023-07-13,9312
4953,緯軟,31,0,31,華南永昌-民權,2023-07-13,9312
2312,金寶,47,18,29,華南永昌-民權,2023-07-13,9312
2834,臺企銀,45,20,25,華南永昌-民權,2023-07-13,9312
3652,精聯,24,0,24,華南永昌-民權,2023-07-13,9312
1609,大亞,28,6,22,華南永昌-民權,2023-07-13,9312
6152,百一,20,0,20,華南永昌-民權,2023-07-13,9312
2331,精英,31,13,18,華南永昌-民權,2023-07-13,9312
4532,瑞智,19,1,18,華南永昌-民權,2023-07-13,9312
1905,華紙,18,2,16,華南永昌-民權,2023-07-13,9312
8070,長華*,20,5,15,華南永昌-民權,2023-07-13,9312
00632R,元大台灣50反1,15,1,14,華南永昌-民權,2023-07-13,9312
4533,協易機,20,6,14,華南永昌-民權,2023-07-13,9312
2609,陽明,21,7,14,華南永昌-民權,2023-07-13,9312
5009,榮剛,13,0,13,華南永昌-民權,2023-07-13,9312
8033,雷虎,14,1,13,華南永昌-民權,2023-07-13,9312
00930,永豐ESG低碳高息,14,2,12,華南永昌-民權,2023-07-13,9312
2303,聯電,13,1,12,華南永昌-民權,2023-07-13,9312
2101,南港,11,0,11,華南永昌-民權,2023-07-13,9312
2882,國泰金,12,1,11,華南永昌-民權,2023-07-13,9312
2324,仁寶,25,15,10,華南永昌-民權,2023-07-13,9312
00637L,元大滬深300正2,10,0,10,華南永昌-民權,2023-07-13,9312
2105,正新,10,0,10,華南永昌-民權,2023-07-13,9312
2705,六福,10,0,10,華南永昌-民權,2023-07-13,9312
8411,福貞-KY,10,0,10,華南永昌-民權,2023-07-13,9312
9904,寶成,10,0,10,華南永昌-民權,2023-07-13,9312
00929,復華台灣科技優息,9,0,9,華南永昌-民權,2023-07-13,9312
2352,佳世達,52,43,9,華南永昌-民權,2023-07-13,9312
4916,事欣科,10,1,9,華南永昌-民權,2023-07-13,9312
6235,華孚,22,13,9,華南永昌-民權,2023-07-13,9312
6414,樺漢,9,0,9,華南永昌-民權,2023-07-13,9312
6509,聚和,10,1,9,華南永昌-民權,2023-07-13,9312
1471,首利,8,0,8,華南永昌-民權,2023-07-13,9312
2883,凱基金,10,3,7,華南永昌-民權,2023-07-13,9312
6548,長科*,13,6,7,華南永昌-民權,2023-07-13,9312
6282,康舒,16,9,7,華南永昌-民權,2023-07-13,9312
00679B,元大美債20年,16,10,6,華南永昌-民權,2023-07-13,9312
1536,和大,6,0,6,華南永昌-民權,2023-07-13,9312
2360,致茂,6,0,6,華南永昌-民權,2023-07-13,9312
2719,燦星旅,6,0,6,華南永昌-民權,2023-07-13,9312
3576,聯合再生,6,0,6,華南永昌-民權,2023-07-13,9312
3710,連展投控,6,0,6,華南永昌-民權,2023-07-13,9312
2382,廣達,299,48,251,華南永昌-民權,2023-07-14,9312
00858,永豐美國500大,80,0,80,華南永昌-民權,2023-07-14,9312
2208,台船,80,0,80,華南永昌-民權,2023-07-14,9312
00712,復華富時不動產,54,3,51,華南永昌-民權,2023-07-14,9312
2328,廣宇,53,2,51,華南永昌-民權,2023-07-14,9312
00878,國泰永續高股息,153,112,41,華南永昌-民權,2023-07-14,9312
2371,大同,66,33,33,華南永昌-民權,2023-07-14,9312
3540,曜越,44,11,33,華南永昌-民權,2023-07-14,9312
00788B,元大10年IG電能債,27,0,27,華南永昌-民權,2023-07-14,9312
3704,合勤控,25,3,22,華南永昌-民權,2023-07-14,9312
1514,亞力,26,5,21,華南永昌-民權,2023-07-14,9312
2302,麗正,20,0,20,華南永昌-民權,2023-07-14,9312
00632R,元大台灣50反1,16,1,15,華南永昌-民權,2023-07-14,9312
3362,先進光,15,0,15,華南永昌-民權,2023-07-14,9312
8039,台虹,15,0,15,華南永昌-民權,2023-07-14,9312
2340,台亞,18,3,15,華南永昌-民權,2023-07-14,9312
2329,華泰,18,4,14,華南永昌-民權,2023-07-14,9312
1722,台肥,15,1,14,華南永昌-民權,2023-07-14,9312
2460,建通,14,0,14,華南永昌-民權,2023-07-14,9312
1609,大亞,22,10,12,華南永昌-民權,2023-07-14,9312
00930,永豐ESG低碳高息,10,0,10,華南永昌-民權,2023-07-14,9312
00893,國泰智能電動車,10,0,10,華南永昌-民權,2023-07-14,9312
2380,虹光,10,0,10,華南永昌-民權,2023-07-14,9312
2867,三商壽,10,0,10,華南永昌-民權,2023-07-14,9312
3652,精聯,10,0,10,華南永昌-民權,2023-07-14,9312
4510,高鋒,10,0,10,華南永昌-民權,2023-07-14,9312
5426,振發,10,0,10,華南永昌-民權,2023-07-14,9312
6834,天二科技,10,0,10,華南永昌-民權,2023-07-14,9312
8411,福貞-KY,10,0,10,華南永昌-民權,2023-07-14,9312
2331,精英,11,2,9,華南永昌-民權,2023-07-14,9312
6187,萬潤,11,2,9,華南永昌-民權,2023-07-14,9312
8358,金居,10,1,9,華南永昌-民權,2023-07-14,9312
2609,陽明,15,7,8,華南永昌-民權,2023-07-14,9312
00882,中信中國高股息,8,1,7,華南永昌-民權,2023-07-14,9312
8028,昇陽半導體,8,1,7,華南永昌-民權,2023-07-14,9312
2324,仁寶,109,102,7,華南永昌-民權,2023-07-14,9312
1101,台泥,6,0,6,華南永昌-民權,2023-07-14,9312
6531,愛普*,6,0,6,華南永昌-民權,2023-07-14,9312
5443,均豪,6,0,6,華南永昌-民權,2023-07-14,9312
00929,復華台灣科技優息,5,0,5,華南永昌-民權,2023-07-14,9312
1503,士電,17,12,5,華南永昌-民權,2023-07-14,9312
2478,大毅,5,0,5,華南永昌-民權,2023-07-14,9312
2633,台灣高鐵,5,0,5,華南永昌-民權,2023-07-14,9312
3032,偉訓,6,1,5,華南永昌-民權,2023-07-14,9312
5222,全訊,15,10,5,華南永昌-民權,2023-07-14,9312
8070,長華*,5,0,5,華南永昌-民權,2023-07-14,9312
8210,勤誠,15,10,5,華南永昌-民權,2023-07-14,9312
2603,長榮,5,0,5,華南永昌-民權,2023-07-14,9312
2618,長榮航,288,284,4,華南永昌-民權,2023-07-14,9312
1301,台塑,7,3,4,華南永昌-民權,2023-07-14,9312
6187,萬潤,300,1,299,華南永昌-民權,2023-07-17,9312
8011,台通,60,4,56,華南永昌-民權,2023-07-17,9312
8933,愛地雅,50,0,50,華南永昌-民權,2023-07-17,9312
3380,明泰,84,39,45,華南永昌-民權,2023-07-17,9312
4167,松瑞藥,40,0,40,華南永昌-民權,2023-07-17,9312
1513,中興電,62,30,32,華南永昌-民權,2023-07-17,9312
00892,富邦台灣半導體,32,0,32,華南永昌-民權,2023-07-17,9312
3673,TPK-KY,28,0,28,華南永昌-民權,2023-07-17,9312
00929,復華台灣科技優息,26,0,26,華南永昌-民權,2023-07-17,9312
2402,毅嘉,24,0,24,華南永昌-民權,2023-07-17,9312
3038,全台,22,1,21,華南永昌-民權,2023-07-17,9312
1514,亞力,37,16,21,華南永昌-民權,2023-07-17,9312
2468,華經,20,0,20,華南永昌-民權,2023-07-17,9312
2618,長榮航,73,54,19,華南永昌-民權,2023-07-17,9312
2023,燁輝,15,0,15,華南永昌-民權,2023-07-17,9312
2331,精英,33,18,15,華南永昌-民權,2023-07-17,9312
2453,凌群,13,0,13,華南永昌-民權,2023-07-17,9312
00724B,群益投資級金融債,12,0,12,華南永昌-民權,2023-07-17,9312
1402,遠東新,12,0,12,華南永昌-民權,2023-07-17,9312
3048,益登,12,0,12,華南永昌-民權,2023-07-17,9312
5258,虹堡,16,5,11,華南永昌-民權,2023-07-17,9312
6235,華孚,37,26,11,華南永昌-民權,2023-07-17,9312
2014,中鴻,11,0,11,華南永昌-民權,2023-07-17,9312
00882,中信中國高股息,10,0,10,華南永昌-民權,2023-07-17,9312
1101,台泥,11,1,10,華南永昌-民權,2023-07-17,9312
020022,元大電動車N,10,0,10,華南永昌-民權,2023-07-17,9312
00673R,期元大S＆P原油反1,10,0,10,華南永昌-民權,2023-07-17,9312
00733,富邦臺灣中小,10,0,10,華南永昌-民權,2023-07-17,9312
2208,台船,10,0,10,華南永昌-民權,2023-07-17,9312
3128,昇銳,10,0,10,華南永昌-民權,2023-07-17,9312
4532,瑞智,127,117,10,華南永昌-民權,2023-07-17,9312
5371,中光電,10,0,10,華南永昌-民權,2023-07-17,9312
2892,第一金,20,10,10,華南永昌-民權,2023-07-17,9312
2360,致茂,9,0,9,華南永昌-民權,2023-07-17,9312
2388,威盛,27,18,9,華南永昌-民權,2023-07-17,9312
3652,精聯,13,4,9,華南永昌-民權,2023-07-17,9312
6548,長科*,14,5,9,華南永昌-民權,2023-07-17,9312
00722B,群益投資級電信債,12,4,8,華南永昌-民權,2023-07-17,9312
00893,國泰智能電動車,10,2,8,華南永昌-民權,2023-07-17,9312
3704,合勤控,33,25,8,華南永昌-民權,2023-07-17,9312
8155,博智,9,1,8,華南永昌-民權,2023-07-17,9312
3583,辛耘,10,2,8,華南永昌-民權,2023-07-17,9312
00930,永豐ESG低碳高息,7,0,7,華南永昌-民權,2023-07-17,9312
2312,金寶,133,126,7,華南永昌-民權,2023-07-17,9312
3013,晟銘電,23,17,6,華南永昌-民權,2023-07-17,9312
6188,廣明,10,4,6,華南永昌-民權,2023-07-17,9312
1229,聯華,5,0,5,華南永昌-民權,2023-07-17,9312
1506,正道,5,0,5,華南永昌-民權,2023-07-17,9312
2481,強茂,9,4,5,華南永昌-民權,2023-07-17,9312
3545,敦泰,5,0,5,華南永昌-民權,2023-07-17,9312
9105,泰金寶-DR,142,0,142,華南永昌-民權,2023-07-18,9312
2312,金寶,130,38,92,華南永昌-民權,2023-07-18,9312
2371,大同,75,13,62,華南永昌-民權,2023-07-18,9312
2352,佳世達,72,13,59,華南永昌-民權,2023-07-18,9312
00882,中信中國高股息,51,0,51,華南永昌-民權,2023-07-18,9312
2323,中環,58,15,43,華南永昌-民權,2023-07-18,9312
2324,仁寶,63,23,40,華南永昌-民權,2023-07-18,9312
1609,大亞,37,1,36,華南永昌-民權,2023-07-18,9312
3706,神達,50,16,34,華南永昌-民權,2023-07-18,9312
00929,復華台灣科技優息,33,0,33,華南永昌-民權,2023-07-18,9312
3652,精聯,30,1,29,華南永昌-民權,2023-07-18,9312
3363,上詮,55,29,26,華南永昌-民權,2023-07-18,9312
2302,麗正,26,0,26,華南永昌-民權,2023-07-18,9312
1513,中興電,25,2,23,華南永昌-民權,2023-07-18,9312
2401,凌陽,22,0,22,華南永昌-民權,2023-07-18,9312
2329,華泰,155,134,21,華南永昌-民權,2023-07-18,9312
2605,新興,21,0,21,華南永昌-民權,2023-07-18,9312
1101,台泥,20,0,20,華南永昌-民權,2023-07-18,9312
00715L,期街口布蘭特正2,20,0,20,華南永昌-民權,2023-07-18,9312
2701,萬企,20,0,20,華南永昌-民權,2023-07-18,9312
3607,谷崧,20,0,20,華南永昌-民權,2023-07-18,9312
3013,晟銘電,20,1,19,華南永昌-民權,2023-07-18,9312
3081,聯亞,21,2,19,華南永昌-民權,2023-07-18,9312
0056,元大高股息,21,5,16,華南永昌-民權,2023-07-18,9312
3682,亞太電,16,0,16,華南永昌-民權,2023-07-18,9312
4916,事欣科,17,1,16,華南永昌-民權,2023-07-18,9312
3047,訊舟,12,0,12,華南永昌-民權,2023-07-18,9312
6188,廣明,20,8,12,華南永昌-民權,2023-07-18,9312
6477,安集,11,0,11,華南永昌-民權,2023-07-18,9312
3323,加百裕,11,0,11,華南永昌-民權,2023-07-18,9312
1314,中石化,11,0,11,華南永昌-民權,2023-07-18,9312
00930,永豐ESG低碳高息,10,0,10,華南永昌-民權,2023-07-18,9312
00680L,元大美債20正2,10,0,10,華南永昌-民權,2023-07-18,9312
2355,敬鵬,10,0,10,華南永昌-民權,2023-07-18,9312
2820,華票,10,0,10,華南永昌-民權,2023-07-18,9312
4712,福格創新,10,0,10,華南永昌-民權,2023-07-18,9312
4950,牧東,10,0,10,華南永昌-民權,2023-07-18,9312
4968,立積,10,0,10,華南永昌-民權,2023-07-18,9312
8404,百和興業-KY,10,0,10,華南永昌-民權,2023-07-18,9312
3704,合勤控,11,2,9,華南永昌-民權,2023-07-18,9312
4743,合一,10,1,9,華南永昌-民權,2023-07-18,9312
4938,和碩,23,14,9,華南永昌-民權,2023-07-18,9312
6218,豪勉,13,4,9,華南永昌-民權,2023-07-18,9312
8059,凱碩,9,0,9,華南永昌-民權,2023-07-18,9312
3078,僑威,43,34,9,華南永昌-民權,2023-07-18,9312
6182,合晶,12,3,9,華南永昌-民權,2023-07-18,9312
4121,優盛,8,0,8,華南永昌-民權,2023-07-18,9312
1711,永光,20,13,7,華南永昌-民權,2023-07-18,9312
6282,康舒,23,16,7,華南永昌-民權,2023-07-18,9312
1907,永豐餘,7,0,7,華南永昌-民權,2023-07-18,9312
2618,長榮航,121,4,117,華南永昌-民權,2023-07-19,9312
5258,虹堡,122,18,104,華南永昌-民權,2023-07-19,9312
2449,京元電子,102,1,101,華南永昌-民權,2023-07-19,9312
6274,台燿,90,0,90,華南永昌-民權,2023-07-19,9312
2610,華航,78,10,68,華南永昌-民權,2023-07-19,9312
2313,華通,65,0,65,華南永昌-民權,2023-07-19,9312
2367,燿華,62,0,62,華南永昌-民權,2023-07-19,9312
2515,中工,60,0,60,華南永昌-民權,2023-07-19,9312
6138,茂達,47,0,47,華南永昌-民權,2023-07-19,9312
2371,大同,45,1,44,華南永昌-民權,2023-07-19,9312
2605,新興,40,0,40,華南永昌-民權,2023-07-19,9312
3652,精聯,40,0,40,華南永昌-民權,2023-07-19,9312
6120,達運,45,5,40,華南永昌-民權,2023-07-19,9312
00893,國泰智能電動車,51,12,39,華南永昌-民權,2023-07-19,9312
2303,聯電,37,0,37,華南永昌-民權,2023-07-19,9312
2347,聯強,30,0,30,華南永昌-民權,2023-07-19,9312
4938,和碩,30,2,28,華南永昌-民權,2023-07-19,9312
4927,泰鼎-KY,27,0,27,華南永昌-民權,2023-07-19,9312
2903,遠百,25,0,25,華南永昌-民權,2023-07-19,9312
2329,華泰,33,9,24,華南永昌-民權,2023-07-19,9312
3051,力特,21,1,20,華南永昌-民權,2023-07-19,9312
2356,英業達,165,147,18,華南永昌-民權,2023-07-19,9312
00929,復華台灣科技優息,21,4,17,華南永昌-民權,2023-07-19,9312
3033,威健,18,2,16,華南永昌-民權,2023-07-19,9312
5009,榮剛,16,0,16,華南永昌-民權,2023-07-19,9312
2461,光群雷,67,54,13,華南永昌-民權,2023-07-19,9312
3481,群創,23,11,12,華南永昌-民權,2023-07-19,9312
2888,新光金,12,0,12,華南永昌-民權,2023-07-19,9312
8048,德勝,12,0,12,華南永昌-民權,2023-07-19,9312
9941,裕融,12,0,12,華南永昌-民權,2023-07-19,9312
2302,麗正,11,0,11,華南永昌-民權,2023-07-19,9312
2402,毅嘉,15,4,11,華南永昌-民權,2023-07-19,9312
2498,宏達電,11,0,11,華南永昌-民權,2023-07-19,9312
1504,東元,13,3,10,華南永昌-民權,2023-07-19,9312
1799,易威,10,0,10,華南永昌-民權,2023-07-19,9312
2353,宏��,16,6,10,華南永昌-民權,2023-07-19,9312
5703,亞都,10,0,10,華南永昌-民權,2023-07-19,9312
2915,潤泰全,9,0,9,華南永昌-民權,2023-07-19,9312
6124,業強,10,1,9,華南永昌-民權,2023-07-19,9312
6125,廣運,9,0,9,華南永昌-民權,2023-07-19,9312
8201,無敵,8,1,7,華南永昌-民權,2023-07-19,9312
1229,聯華,11,4,7,華南永昌-民權,2023-07-19,9312
2867,三商壽,7,0,7,華南永昌-民權,2023-07-19,9312
3189,景碩,8,1,7,華南永昌-民權,2023-07-19,9312
6546,正基,15,8,7,華南永昌-民權,2023-07-19,9312
1609,大亞,26,20,6,華南永昌-民權,2023-07-19,9312
2340,台亞,10,4,6,華南永昌-民權,2023-07-19,9312
3325,旭品,21,15,6,華南永昌-民權,2023-07-19,9312
6160,欣技,6,0,6,華南永昌-民權,2023-07-19,9312
8926,台汽電,6,0,6,華南永昌-民權,2023-07-19,9312
00680L,元大美債20正2,104,11,93,華南永昌-民權,2023-07-20,9312
6120,達運,61,30,31,華南永昌-民權,2023-07-20,9312
3057,喬鼎,30,0,30,華南永昌-民權,2023-07-20,9312
2352,佳世達,27,1,26,華南永昌-民權,2023-07-20,9312
6770,力積電,23,0,23,華南永昌-民權,2023-07-20,9312
2303,聯電,24,2,22,華南永昌-民權,2023-07-20,9312
2337,旺宏,20,0,20,華南永昌-民權,2023-07-20,9312
2206,三陽工業,19,2,17,華南永昌-民權,2023-07-20,9312
2347,聯強,21,4,17,華南永昌-民權,2023-07-20,9312
2413,環科,17,0,17,華南永昌-民權,2023-07-20,9312
2881,富邦金,16,0,16,華南永昌-民權,2023-07-20,9312
00908,富邦入息REITs+,15,0,15,華南永昌-民權,2023-07-20,9312
8426,紅木-KY,15,0,15,華南永昌-民權,2023-07-20,9312
00878,國泰永續高股息,38,26,12,華南永昌-民權,2023-07-20,9312
1102,亞泥,12,0,12,華南永昌-民權,2023-07-20,9312
00885,富邦越南,12,0,12,華南永昌-民權,2023-07-20,9312
2330,台積電,11,0,11,華南永昌-民權,2023-07-20,9312
00713,元大台灣高息低波,11,0,11,華南永昌-民權,2023-07-20,9312
2313,華通,18,7,11,華南永昌-民權,2023-07-20,9312
2705,六福,11,0,11,華南永昌-民權,2023-07-20,9312
00929,復華台灣科技優息,11,1,10,華南永昌-民權,2023-07-20,9312
00927,群益半導體收益,10,0,10,華南永昌-民權,2023-07-20,9312
00632R,元大台灣50反1,10,0,10,華南永昌-民權,2023-07-20,9312
2328,廣宇,12,2,10,華南永昌-民權,2023-07-20,9312
6116,彩晶,10,0,10,華南永昌-民權,2023-07-20,9312
0056,元大高股息,18,10,8,華南永昌-民權,2023-07-20,9312
2478,大毅,8,0,8,華南永昌-民權,2023-07-20,9312
2324,仁寶,11,3,8,華南永昌-民權,2023-07-20,9312
5871,中租-KY,7,0,7,華南永昌-民權,2023-07-20,9312
1742,台蠟,7,0,7,華南永昌-民權,2023-07-20,9312
1789,神隆,7,0,7,華南永昌-民權,2023-07-20,9312
4726,永昕,9,2,7,華南永昌-民權,2023-07-20,9312
6101,寬魚國際,7,0,7,華南永昌-民權,2023-07-20,9312
6248,沛波,7,0,7,華南永昌-民權,2023-07-20,9312
3363,上詮,10,4,6,華南永昌-民權,2023-07-20,9312
4566,時碩工業,6,0,6,華南永昌-民權,2023-07-20,9312
4760,勤凱,6,0,6,華南永昌-民權,2023-07-20,9312
5386,青雲,6,0,6,華南永昌-民權,2023-07-20,9312
4977,眾達-KY,7,1,6,華南永昌-民權,2023-07-20,9312
1101,台泥,6,1,5,華南永昌-民權,2023-07-20,9312
2065,世豐,5,0,5,華南永昌-民權,2023-07-20,9312
2331,精英,7,2,5,華南永昌-民權,2023-07-20,9312
3607,谷崧,5,0,5,華南永昌-民權,2023-07-20,9312
3693,營邦,5,0,5,華南永昌-民權,2023-07-20,9312
4105,東洋,5,0,5,華南永昌-民權,2023-07-20,9312
4114,健喬,7,2,5,華南永昌-民權,2023-07-20,9312
6124,業強,5,0,5,華南永昌-民權,2023-07-20,9312
6596,寬宏藝術,5,0,5,華南永昌-民權,2023-07-20,9312
6834,天二科技,5,0,5,華南永昌-民權,2023-07-20,9312
8049,晶采,5,0,5,華南永昌-民權,2023-07-20,9312
2382,廣達,189,89,100,華南永昌-民權,2023-07-21,9312
00632R,元大台灣50反1,100,23,77,華南永昌-民權,2023-07-21,9312
2357,華碩,80,20,60,華南永昌-民權,2023-07-21,9312
6274,台燿,41,0,41,華南永昌-民權,2023-07-21,9312
2303,聯電,34,0,34,華南永昌-民權,2023-07-21,9312
2405,輔信,29,0,29,華南永昌-民權,2023-07-21,9312
2324,仁寶,29,2,27,華南永昌-民權,2023-07-21,9312
2498,宏達電,20,0,20,華南永昌-民權,2023-07-21,9312
3652,精聯,20,0,20,華南永昌-民權,2023-07-21,9312
1702,南僑,20,0,20,華南永昌-民權,2023-07-21,9312
2634,漢翔,26,7,19,華南永昌-民權,2023-07-21,9312
1101,台泥,19,2,17,華南永昌-民權,2023-07-21,9312
00680L,元大美債20正2,16,0,16,華南永昌-民權,2023-07-21,9312
3037,欣興,19,7,12,華南永昌-民權,2023-07-21,9312
00929,復華台灣科技優息,12,1,11,華南永昌-民權,2023-07-21,9312
6235,華孚,104,94,10,華南永昌-民權,2023-07-21,9312
3706,神達,17,7,10,華南永昌-民權,2023-07-21,9312
1533,車王電,10,0,10,華南永昌-民權,2023-07-21,9312
1799,易威,10,0,10,華南永昌-民權,2023-07-21,9312
2515,中工,30,20,10,華南永昌-民權,2023-07-21,9312
2707,晶華,11,1,10,華南永昌-民權,2023-07-21,9312
5009,榮剛,10,0,10,華南永昌-民權,2023-07-21,9312
6550,北極星藥業-KY,16,6,10,華南永昌-民權,2023-07-21,9312
8299,群聯,10,0,10,華南永昌-民權,2023-07-21,9312
6548,長科*,11,2,9,華南永昌-民權,2023-07-21,9312
8426,紅木-KY,11,2,9,華南永昌-民權,2023-07-21,9312
2610,華航,17,8,9,華南永昌-民權,2023-07-21,9312
2633,台灣高鐵,11,3,8,華南永昌-民權,2023-07-21,9312
6770,力積電,9,1,8,華南永昌-民權,2023-07-21,9312
2330,台積電,8,1,7,華南永昌-民權,2023-07-21,9312
1301,台塑,7,0,7,華南永昌-民權,2023-07-21,9312
1102,亞泥,9,2,7,華南永昌-民權,2023-07-21,9312
2344,華邦電,7,0,7,華南永昌-民權,2023-07-21,9312
00891,中信關鍵半導體,6,0,6,華南永昌-民權,2023-07-21,9312
2601,益航,8,2,6,華南永昌-民權,2023-07-21,9312
2731,雄獅,11,5,6,華南永昌-民權,2023-07-21,9312
4129,聯合,7,1,6,華南永昌-民權,2023-07-21,9312
5263,智崴,6,0,6,華南永昌-民權,2023-07-21,9312
5706,鳳凰,8,2,6,華南永昌-民權,2023-07-21,9312
6767,台微醫,6,0,6,華南永昌-民權,2023-07-21,9312
1312,國喬,5,0,5,華南永昌-民權,2023-07-21,9312
1104,環泥,5,0,5,華南永昌-民權,2023-07-21,9312
00712,復華富時不動產,6,1,5,華南永昌-民權,2023-07-21,9312
2204,中華,5,0,5,華南永昌-民權,2023-07-21,9312
2409,友達,9,4,5,華南永昌-民權,2023-07-21,9312
2478,大毅,5,0,5,華南永昌-民權,2023-07-21,9312
2887,台新金,5,0,5,華南永昌-民權,2023-07-21,9312
3221,台嘉碩,5,0,5,華南永昌-民權,2023-07-21,9312
3413,京鼎,5,0,5,華南永昌-民權,2023-07-21,9312
3680,家登,5,0,5,華南永昌-民權,2023-07-21,9312
2409,友達,1008,13,995,華南永昌-民權,2023-07-24,9312
6138,茂達,174,3,171,華南永昌-民權,2023-07-24,9312
2323,中環,104,0,104,華南永昌-民權,2023-07-24,9312
2461,光群雷,65,1,64,華南永昌-民權,2023-07-24,9312
3081,聯亞,50,0,50,華南永昌-民權,2023-07-24,9312
1101,台泥,50,2,48,華南永昌-民權,2023-07-24,9312
2887,台新金,47,0,47,華南永昌-民權,2023-07-24,9312
2352,佳世達,37,1,36,華南永昌-民權,2023-07-24,9312
2634,漢翔,40,9,31,華南永昌-民權,2023-07-24,9312
3483,力致,30,0,30,華南永昌-民權,2023-07-24,9312
2330,台積電,23,1,22,華南永昌-民權,2023-07-24,9312
3652,精聯,20,0,20,華南永昌-民權,2023-07-24,9312
6770,力積電,20,0,20,華南永昌-民權,2023-07-24,9312
2356,英業達,47,28,19,華南永昌-民權,2023-07-24,9312
4906,正文,27,11,16,華南永昌-民權,2023-07-24,9312
6023,元大期,16,0,16,華南永昌-民權,2023-07-24,9312
6168,宏齊,16,0,16,華南永昌-民權,2023-07-24,9312
3231,緯創,19,3,16,華南永昌-民權,2023-07-24,9312
2903,遠百,15,0,15,華南永昌-民權,2023-07-24,9312
4938,和碩,22,7,15,華南永昌-民權,2023-07-24,9312
3682,亞太電,14,0,14,華南永昌-民權,2023-07-24,9312
4942,嘉彰,14,0,14,華南永昌-民權,2023-07-24,9312
1504,東元,16,3,13,華南永昌-民權,2023-07-24,9312
2230,泰茂,14,2,12,華南永昌-民權,2023-07-24,9312
2883,凱基金,12,0,12,華南永昌-民權,2023-07-24,9312
2897,王道銀行,50,38,12,華南永昌-民權,2023-07-24,9312
3013,晟銘電,196,184,12,華南永昌-民權,2023-07-24,9312
3338,泰碩,26,14,12,華南永昌-民權,2023-07-24,9312
5258,虹堡,13,1,12,華南永昌-民權,2023-07-24,9312
2630,亞航,12,1,11,華南永昌-民權,2023-07-24,9312
00929,復華台灣科技優息,10,0,10,華南永昌-民權,2023-07-24,9312
1305,華夏,10,0,10,華南永昌-民權,2023-07-24,9312
2618,長榮航,100,90,10,華南永昌-民權,2023-07-24,9312
3607,谷崧,10,0,10,華南永昌-民權,2023-07-24,9312
3037,欣興,18,8,10,華南永昌-民權,2023-07-24,9312
2890,永豐金,9,0,9,華南永昌-民權,2023-07-24,9312
3548,兆利,9,0,9,華南永昌-民權,2023-07-24,9312
8255,朋程,10,1,9,華南永昌-民權,2023-07-24,9312
9103,美德醫療-DR,9,0,9,華南永昌-民權,2023-07-24,9312
3481,群創,10,1,9,華南永昌-民權,2023-07-24,9312
1513,中興電,16,8,8,華南永昌-民權,2023-07-24,9312
2881,富邦金,8,0,8,華南永昌-民權,2023-07-24,9312
3025,星通,9,1,8,華南永昌-民權,2023-07-24,9312
6282,康舒,9,1,8,華南永昌-民權,2023-07-24,9312
2421,建準,38,30,8,華南永昌-民權,2023-07-24,9312
1529,樂事綠能,8,1,7,華南永昌-民權,2023-07-24,9312
2457,飛宏,7,0,7,華南永昌-民權,2023-07-24,9312
1434,福懋,8,1,7,華南永昌-民權,2023-07-24,9312
8996,高力,9,3,6,華南永昌-民權,2023-07-24,9312
2031,新光鋼,7,1,6,華南永昌-民權,2023-07-24,9312
1513,中興電,367,16,351,華南永昌-民權,2023-07-25,9312
3081,聯亞,60,8,52,華南永昌-民權,2023-07-25,9312
6138,茂達,91,52,39,華南永昌-民權,2023-07-25,9312
2610,華航,42,9,33,華南永昌-民權,2023-07-25,9312
2903,遠百,33,0,33,華南永昌-民權,2023-07-25,9312
1905,華紙,40,8,32,華南永昌-民權,2023-07-25,9312
2359,所羅門,35,6,29,華南永昌-民權,2023-07-25,9312
3013,晟銘電,81,57,24,華南永昌-民權,2023-07-25,9312
2367,燿華,22,0,22,華南永昌-民權,2023-07-25,9312
2103,台橡,20,0,20,華南永昌-民權,2023-07-25,9312
1101,台泥,28,12,16,華南永昌-民權,2023-07-25,9312
8182,加高,13,0,13,華南永昌-民權,2023-07-25,9312
00679B,元大美債20年,12,0,12,華南永昌-民權,2023-07-25,9312
6120,達運,23,11,12,華南永昌-民權,2023-07-25,9312
2353,宏��,16,4,12,華南永昌-民權,2023-07-25,9312
2312,金寶,11,0,11,華南永昌-民權,2023-07-25,9312
2867,三商壽,10,0,10,華南永昌-民權,2023-07-25,9312
2881,富邦金,10,0,10,華南永昌-民權,2023-07-25,9312
4989,榮科,10,0,10,華南永昌-民權,2023-07-25,9312
5703,亞都,10,0,10,華南永昌-民權,2023-07-25,9312
6156,松上,10,0,10,華南永昌-民權,2023-07-25,9312
6168,宏齊,10,0,10,華南永昌-民權,2023-07-25,9312
9938,百和,10,0,10,華南永昌-民權,2023-07-25,9312
1434,福懋,14,5,9,華南永昌-民權,2023-07-25,9312
8046,南電,9,0,9,華南永昌-民權,2023-07-25,9312
6125,廣運,88,79,9,華南永昌-民權,2023-07-25,9312
2886,兆豐金,10,1,9,華南永昌-民權,2023-07-25,9312
2880,華南金,9,0,9,華南永昌-民權,2023-07-25,9312
4119,旭富,8,0,8,華南永昌-民權,2023-07-25,9312
2449,京元電子,15,7,8,華南永昌-民權,2023-07-25,9312
2882,國泰金,10,2,8,華南永昌-民權,2023-07-25,9312
6023,元大期,8,0,8,華南永昌-民權,2023-07-25,9312
6282,康舒,14,6,8,華南永昌-民權,2023-07-25,9312
8927,北基,8,0,8,華南永昌-民權,2023-07-25,9312
2303,聯電,10,2,8,華南永昌-民權,2023-07-25,9312
1603,華電,7,0,7,華南永昌-民權,2023-07-25,9312
1605,華新,10,3,7,華南永昌-民權,2023-07-25,9312
2460,建通,10,3,7,華南永昌-民權,2023-07-25,9312
3380,明泰,20,13,7,華南永昌-民權,2023-07-25,9312
8049,晶采,7,0,7,華南永昌-民權,2023-07-25,9312
00929,復華台灣科技優息,6,0,6,華南永昌-民權,2023-07-25,9312
2515,中工,6,0,6,華南永昌-民權,2023-07-25,9312
4129,聯合,7,1,6,華南永昌-民權,2023-07-25,9312
2454,聯發科,5,0,5,華南永昌-民權,2023-07-25,9312
6285,啟��,5,0,5,華南永昌-民權,2023-07-25,9312
00882,中信中國高股息,5,0,5,華南永昌-民權,2023-07-25,9312
00673R,期元大S＆P原油反1,5,0,5,華南永昌-民權,2023-07-25,9312
1314,中石化,5,0,5,華南永昌-民權,2023-07-25,9312
1702,南僑,5,0,5,華南永昌-民權,2023-07-25,9312
2374,佳能,5,0,5,華南永昌-民權,2023-07-25,9312
3481,群創,158,14,144,華南永昌-民權,2023-07-26,9312
00882,中信中國高股息,104,0,104,華南永昌-民權,2023-07-26,9312
2913,農林,51,0,51,華南永昌-民權,2023-07-26,9312
8358,金居,46,7,39,華南永昌-民權,2023-07-26,9312
2329,華泰,136,105,31,華南永昌-民權,2023-07-26,9312
3652,精聯,30,0,30,華南永昌-民權,2023-07-26,9312
4154,樂威科-KY,30,0,30,華南永昌-民權,2023-07-26,9312
1609,大亞,30,1,29,華南永昌-民權,2023-07-26,9312
6235,華孚,25,2,23,華南永昌-民權,2023-07-26,9312
00929,復華台灣科技優息,20,0,20,華南永昌-民權,2023-07-26,9312
1702,南僑,20,0,20,華南永昌-民權,2023-07-26,9312
2323,中環,33,13,20,華南永昌-民權,2023-07-26,9312
2344,華邦電,20,1,19,華南永昌-民權,2023-07-26,9312
00679B,元大美債20年,18,0,18,華南永昌-民權,2023-07-26,9312
00720B,元大投資級公司債,17,0,17,華南永昌-民權,2023-07-26,9312
2425,承啟,16,0,16,華南永昌-民權,2023-07-26,9312
2337,旺宏,15,0,15,華南永昌-民權,2023-07-26,9312
1905,華紙,26,12,14,華南永昌-民權,2023-07-26,9312
2002,中鋼,14,0,14,華南永昌-民權,2023-07-26,9312
2402,毅嘉,17,6,11,華南永昌-民權,2023-07-26,9312
00680L,元大美債20正2,10,0,10,華南永昌-民權,2023-07-26,9312
1513,中興電,20,10,10,華南永昌-民權,2023-07-26,9312
1711,永光,10,0,10,華南永昌-民權,2023-07-26,9312
1799,易威,10,0,10,華南永昌-民權,2023-07-26,9312
5258,虹堡,12,2,10,華南永昌-民權,2023-07-26,9312
5703,亞都,10,0,10,華南永昌-民權,2023-07-26,9312
2887,台新金,9,0,9,華南永昌-民權,2023-07-26,9312
8403,盛弘,9,0,9,華南永昌-民權,2023-07-26,9312
1760,寶齡富錦,8,0,8,華南永昌-民權,2023-07-26,9312
1504,東元,54,46,8,華南永昌-民權,2023-07-26,9312
2405,輔信,43,36,7,華南永昌-民權,2023-07-26,9312
3680,家登,7,0,7,華南永昌-民權,2023-07-26,9312
5388,中磊,7,0,7,華南永昌-民權,2023-07-26,9312
6214,精誠,11,4,7,華南永昌-民權,2023-07-26,9312
6275,元山,8,1,7,華南永昌-民權,2023-07-26,9312
1434,福懋,14,8,6,華南永昌-民權,2023-07-26,9312
1618,合機,11,5,6,華南永昌-民權,2023-07-26,9312
2352,佳世達,17,11,6,華南永昌-民權,2023-07-26,9312
2371,大同,6,0,6,華南永昌-民權,2023-07-26,9312
3706,神達,20,14,6,華南永昌-民權,2023-07-26,9312
2449,京元電子,13,8,5,華南永昌-民權,2023-07-26,9312
1217,愛之味,7,2,5,華南永昌-民權,2023-07-26,9312
1815,富喬,6,1,5,華南永昌-民權,2023-07-26,9312
2478,大毅,5,0,5,華南永昌-民權,2023-07-26,9312
3059,華晶科,18,13,5,華南永昌-民權,2023-07-26,9312
3081,聯亞,6,1,5,華南永昌-民權,2023-07-26,9312
4414,如興,5,0,5,華南永昌-民權,2023-07-26,9312
6156,松上,5,0,5,華南永昌-民權,2023-07-26,9312
6213,聯茂,6,1,5,華南永昌-民權,2023-07-26,9312
6187,萬潤,8,3,5,華南永昌-民權,2023-07-26,9312
2409,友達,202,55,147,華南永昌-民權,2023-07-27,9312
2382,廣達,193,51,142,華南永昌-民權,2023-07-27,9312
6187,萬潤,102,3,99,華南永昌-民權,2023-07-27,9312
00632R,元大台灣50反1,30,0,30,華南永昌-民權,2023-07-27,9312
2405,輔信,52,22,30,華南永昌-民權,2023-07-27,9312
4155,訊映,30,0,30,華南永昌-民權,2023-07-27,9312
4188,安克,29,0,29,華南永昌-民權,2023-07-27,9312
00885,富邦越南,30,2,28,華南永昌-民權,2023-07-27,9312
1618,合機,30,2,28,華南永昌-民權,2023-07-27,9312
3481,群創,216,190,26,華南永昌-民權,2023-07-27,9312
1815,富喬,77,53,24,華南永昌-民權,2023-07-27,9312
2468,華經,44,21,23,華南永昌-民權,2023-07-27,9312
1109,信大,20,0,20,華南永昌-民權,2023-07-27,9312
3673,TPK-KY,19,0,19,華南永昌-民權,2023-07-27,9312
5508,永信建,19,0,19,華南永昌-民權,2023-07-27,9312
2882,國泰金,24,5,19,華南永昌-民權,2023-07-27,9312
2301,光寶科,20,1,19,華南永昌-民權,2023-07-27,9312
6841,長佳智能,29,11,18,華南永昌-民權,2023-07-27,9312
2442,新美齊,15,0,15,華南永昌-民權,2023-07-27,9312
3706,神達,21,6,15,華南永昌-民權,2023-07-27,9312
8112,至上,15,0,15,華南永昌-民權,2023-07-27,9312
2883,凱基金,14,2,12,華南永昌-民權,2023-07-27,9312
3715,定穎投控,14,2,12,華南永昌-民權,2023-07-27,9312
1802,台玻,12,1,11,華南永昌-民權,2023-07-27,9312
3051,力特,12,1,11,華南永昌-民權,2023-07-27,9312
6129,普誠,11,0,11,華南永昌-民權,2023-07-27,9312
2002,中鋼,11,0,11,華南永昌-民權,2023-07-27,9312
2312,金寶,17,7,10,華南永昌-民權,2023-07-27,9312
2340,台亞,16,6,10,華南永昌-民權,2023-07-27,9312
6188,廣明,23,14,9,華南永昌-民權,2023-07-27,9312
1711,永光,10,1,9,華南永昌-民權,2023-07-27,9312
2609,陽明,13,4,9,華南永昌-民權,2023-07-27,9312
5452,佶優,11,2,9,華南永昌-民權,2023-07-27,9312
1467,南緯,18,10,8,華南永昌-民權,2023-07-27,9312
2353,宏��,11,3,8,華南永昌-民權,2023-07-27,9312
1110,東泥,7,0,7,華南永昌-民權,2023-07-27,9312
1522,堤維西,7,0,7,華南永昌-民權,2023-07-27,9312
1727,中華化,8,1,7,華南永昌-民權,2023-07-27,9312
1605,華新,7,0,7,華南永昌-民權,2023-07-27,9312
2354,鴻準,7,1,6,華南永昌-民權,2023-07-27,9312
1907,永豐餘,18,12,6,華南永昌-民權,2023-07-27,9312
00902,中信電池及儲能,6,0,6,華南永昌-民權,2023-07-27,9312
1536,和大,6,0,6,華南永昌-民權,2023-07-27,9312
3498,陽程,6,0,6,華南永昌-民權,2023-07-27,9312
3702,大聯大,6,0,6,華南永昌-民權,2023-07-27,9312
3037,欣興,13,7,6,華南永昌-民權,2023-07-27,9312
1504,東元,7,2,5,華南永昌-民權,2023-07-27,9312
2887,台新金,32,27,5,華南永昌-民權,2023-07-27,9312
1471,首利,5,0,5,華南永昌-民權,2023-07-27,9312
2331,精英,5,0,5,華南永昌-民權,2023-07-27,9312
3231,緯創,135,30,105,華南永昌-民權,2023-07-28,9312
2610,華航,57,3,54,華南永昌-民權,2023-07-28,9312
2888,新光金,68,20,48,華南永昌-民權,2023-07-28,9312
3481,群創,73,27,46,華南永昌-民權,2023-07-28,9312
2323,中環,54,15,39,華南永昌-民權,2023-07-28,9312
2027,大成鋼,33,0,33,華南永昌-民權,2023-07-28,9312
2405,輔信,33,5,28,華南永昌-民權,2023-07-28,9312
1905,華紙,85,58,27,華南永昌-民權,2023-07-28,9312
00680L,元大美債20正2,26,0,26,華南永昌-民權,2023-07-28,9312
5508,永信建,26,0,26,華南永昌-民權,2023-07-28,9312
00712,復華富時不動產,24,0,24,華南永昌-民權,2023-07-28,9312
6190,萬泰科,22,3,19,華南永昌-民權,2023-07-28,9312
6548,長科*,33,15,18,華南永昌-民權,2023-07-28,9312
2618,長榮航,67,50,17,華南永昌-民權,2023-07-28,9312
2609,陽明,23,9,14,華南永昌-民權,2023-07-28,9312
5009,榮剛,13,0,13,華南永昌-民權,2023-07-28,9312
4121,優盛,12,0,12,華南永昌-民權,2023-07-28,9312
00720B,元大投資級公司債,10,0,10,華南永昌-民權,2023-07-28,9312
1785,光洋科,10,0,10,華南永昌-民權,2023-07-28,9312
2329,華泰,79,69,10,華南永昌-民權,2023-07-28,9312
2369,菱生,13,3,10,華南永昌-民權,2023-07-28,9312
2641,正德,10,0,10,華南永昌-民權,2023-07-28,9312
2884,玉山金,10,0,10,華南永昌-民權,2023-07-28,9312
3494,誠研,10,0,10,華南永昌-民權,2023-07-28,9312
4188,安克,10,0,10,華南永昌-民權,2023-07-28,9312
4712,福格創新,10,0,10,華南永昌-民權,2023-07-28,9312
5703,亞都,10,0,10,華南永昌-民權,2023-07-28,9312
6449,鈺邦,10,0,10,華南永昌-民權,2023-07-28,9312
2002,中鋼,10,0,10,華南永昌-民權,2023-07-28,9312
8033,雷虎,8,0,8,華南永昌-民權,2023-07-28,9312
4906,正文,11,3,8,華南永昌-民權,2023-07-28,9312
8234,新漢,8,0,8,華南永昌-民權,2023-07-28,9312
2615,萬海,10,2,8,華南永昌-民權,2023-07-28,9312
5443,均豪,28,21,7,華南永昌-民權,2023-07-28,9312
6770,力積電,7,0,7,華南永昌-民權,2023-07-28,9312
2356,英業達,8,2,6,華南永昌-民權,2023-07-28,9312
00679B,元大美債20年,6,0,6,華南永昌-民權,2023-07-28,9312
1609,大亞,7,1,6,華南永昌-民權,2023-07-28,9312
2208,台船,6,0,6,華南永昌-民權,2023-07-28,9312
3033,威健,6,0,6,華南永昌-民權,2023-07-28,9312
4726,永昕,11,5,6,華南永昌-民權,2023-07-28,9312
5236,凌陽創新,7,1,6,華南永昌-民權,2023-07-28,9312
6150,撼訊,6,0,6,華南永昌-民權,2023-07-28,9312
8076,伍豐,6,0,6,華南永昌-民權,2023-07-28,9312
2204,中華,6,0,6,華南永昌-民權,2023-07-28,9312
6274,台燿,21,16,5,華南永昌-民權,2023-07-28,9312
00900,富邦特選高股息30,5,0,5,華南永昌-民權,2023-07-28,9312
00919,群益台灣精選高息,5,0,5,華南永昌-民權,2023-07-28,9312
00915,凱基優選高股息30,5,0,5,華南永昌-民權,2023-07-28,9312
1603,華電,5,0,5,華南永昌-民權,2023-07-28,9312
6187,萬潤,281,21,260,華南永昌-民權,2023-07-31,9312
1410,南染,50,0,50,華南永昌-民權,2023-07-31,9312
2897,王道銀行,50,0,50,華南永昌-民權,2023-07-31,9312
4155,訊映,45,0,45,華南永昌-民權,2023-07-31,9312
2610,華航,45,5,40,華南永昌-民權,2023-07-31,9312
0056,元大高股息,40,8,32,華南永昌-民權,2023-07-31,9312
3652,精聯,30,0,30,華南永昌-民權,2023-07-31,9312
2882,國泰金,43,14,29,華南永昌-民權,2023-07-31,9312
1714,和桐,26,0,26,華南永昌-民權,2023-07-31,9312
00929,復華台灣科技優息,90,65,25,華南永昌-民權,2023-07-31,9312
2903,遠百,23,0,23,華南永昌-民權,2023-07-31,9312
00795B,中信美國公債20年,21,1,20,華南永昌-民權,2023-07-31,9312
00712,復華富時不動產,20,0,20,華南永昌-民權,2023-07-31,9312
3083,網龍,20,0,20,華南永昌-民權,2023-07-31,9312
6138,茂達,20,0,20,華南永昌-民權,2023-07-31,9312
6136,富爾特,16,0,16,華南永昌-民權,2023-07-31,9312
2329,華泰,47,32,15,華南永昌-民權,2023-07-31,9312
00680L,元大美債20正2,25,10,15,華南永昌-民權,2023-07-31,9312
6269,台郡,16,2,14,華南永昌-民權,2023-07-31,9312
1907,永豐餘,15,1,14,華南永昌-民權,2023-07-31,9312
00900,富邦特選高股息30,16,3,13,華南永昌-民權,2023-07-31,9312
2603,長榮,17,4,13,華南永昌-民權,2023-07-31,9312
3024,憶聲,15,2,13,華南永昌-民權,2023-07-31,9312
6148,驊宏資,14,1,13,華南永昌-民權,2023-07-31,9312
6147,頎邦,12,0,12,華南永昌-民權,2023-07-31,9312
2891,中信金,11,0,11,華南永昌-民權,2023-07-31,9312
3227,原相,11,0,11,華南永昌-民權,2023-07-31,9312
3037,欣興,11,1,10,華南永昌-民權,2023-07-31,9312
2478,大毅,10,0,10,華南永昌-民權,2023-07-31,9312
3715,定穎投控,10,0,10,華南永昌-民權,2023-07-31,9312
2002,中鋼,12,3,9,華南永昌-民權,2023-07-31,9312
9917,中保科,9,0,9,華南永昌-民權,2023-07-31,9312
2352,佳世達,11,2,9,華南永昌-民權,2023-07-31,9312
2356,英業達,10,1,9,華南永昌-民權,2023-07-31,9312
8358,金居,28,20,8,華南永昌-民權,2023-07-31,9312
2405,輔信,9,1,8,華南永昌-民權,2023-07-31,9312
8059,凱碩,7,0,7,華南永昌-民權,2023-07-31,9312
2353,宏��,10,3,7,華南永昌-民權,2023-07-31,9312
2330,台積電,37,30,7,華南永昌-民權,2023-07-31,9312
00679B,元大美債20年,37,31,6,華南永昌-民權,2023-07-31,9312
4306,炎洲,6,0,6,華南永昌-民權,2023-07-31,9312
4968,立積,6,0,6,華南永昌-民權,2023-07-31,9312
5443,均豪,7,1,6,華南永昌-民權,2023-07-31,9312
8426,紅木-KY,6,0,6,華南永昌-民權,2023-07-31,9312
1229,聯華,5,0,5,華南永昌-民權,2023-07-31,9312
1809,中釉,6,1,5,華南永昌-民權,2023-07-31,9312
2368,金像電,11,6,5,華南永昌-民權,2023-07-31,9312
2457,飛宏,5,0,5,華南永昌-民權,2023-07-31,9312
4960,誠美材,5,0,5,華南永昌-民權,2023-07-31,9312
6188,廣明,10,5,5,華南永昌-民權,2023-07-31,9312
1513,中興電,167,13,154,華南永昌-民權,2023-08-01,9312
2301,光寶科,217,73,144,華南永昌-民權,2023-08-01,9312
00680L,元大美債20正2,65,0,65,華南永昌-民權,2023-08-01,9312
3652,精聯,50,0,50,華南永昌-民權,2023-08-01,9312
00795B,中信美國公債20年,40,0,40,華南永昌-民權,2023-08-01,9312
2358,廷鑫,40,0,40,華南永昌-民權,2023-08-01,9312
00919,群益台灣精選高息,26,0,26,華南永昌-民權,2023-08-01,9312
2367,燿華,26,0,26,華南永昌-民權,2023-08-01,9312
2352,佳世達,24,0,24,華南永昌-民權,2023-08-01,9312
2363,矽統,25,1,24,華南永昌-民權,2023-08-01,9312
00885,富邦越南,38,15,23,華南永昌-民權,2023-08-01,9312
2313,華通,22,0,22,華南永昌-民權,2023-08-01,9312
2913,農林,196,175,21,華南永昌-民權,2023-08-01,9312
2892,第一金,20,0,20,華南永昌-民權,2023-08-01,9312
6187,萬潤,37,17,20,華南永昌-民權,2023-08-01,9312
00929,復華台灣科技優息,18,3,15,華南永昌-民權,2023-08-01,9312
8093,保銳,15,0,15,華南永昌-民權,2023-08-01,9312
00923,群益台ESG低碳50,11,0,11,華南永昌-民權,2023-08-01,9312
5443,均豪,12,1,11,華南永昌-民權,2023-08-01,9312
3033,威健,13,3,10,華南永昌-民權,2023-08-01,9312
2449,京元電子,17,7,10,華南永昌-民權,2023-08-01,9312
6449,鈺邦,10,0,10,華南永昌-民權,2023-08-01,9312
8049,晶采,10,0,10,華南永昌-民權,2023-08-01,9312
1101,台泥,10,1,9,華南永昌-民權,2023-08-01,9312
3105,穩懋,9,0,9,華南永昌-民權,2023-08-01,9312
1434,福懋,10,2,8,華南永昌-民權,2023-08-01,9312
2312,金寶,16,9,7,華南永昌-民權,2023-08-01,9312
6148,驊宏資,7,0,7,華南永昌-民權,2023-08-01,9312
6257,矽格,7,0,7,華南永昌-民權,2023-08-01,9312
6509,聚和,7,0,7,華南永昌-民權,2023-08-01,9312
2002,中鋼,9,3,6,華南永昌-民權,2023-08-01,9312
00679B,元大美債20年,6,0,6,華南永昌-民權,2023-08-01,9312
2399,映泰,6,0,6,華南永昌-民權,2023-08-01,9312
3025,星通,18,12,6,華南永昌-民權,2023-08-01,9312
3029,零壹,16,10,6,華南永昌-民權,2023-08-01,9312
3221,台嘉碩,6,0,6,華南永昌-民權,2023-08-01,9312
3380,明泰,7,1,6,華南永昌-民權,2023-08-01,9312
5388,中磊,13,7,6,華南永昌-民權,2023-08-01,9312
6417,韋僑,6,0,6,華南永昌-民權,2023-08-01,9312
1326,台化,10,5,5,華南永昌-民權,2023-08-01,9312
00632R,元大台灣50反1,5,0,5,華南永昌-民權,2023-08-01,9312
2498,宏達電,5,0,5,華南永昌-民權,2023-08-01,9312
3049,精金,5,0,5,華南永昌-民權,2023-08-01,9312
3059,華晶科,5,0,5,華南永昌-民權,2023-08-01,9312
3081,聯亞,9,4,5,華南永昌-民權,2023-08-01,9312
3088,艾訊,5,0,5,華南永昌-民權,2023-08-01,9312
3205,佰研,5,0,5,華南永昌-民權,2023-08-01,9312
3339,泰谷,5,0,5,華南永昌-民權,2023-08-01,9312
3682,亞太電,5,0,5,華南永昌-民權,2023-08-01,9312
4162,智擎,5,0,5,華南永昌-民權,2023-08-01,9312
6187,萬潤,330,14,316,華南永昌-民權,2023-08-02,9312
00712,復華富時不動產,182,0,182,華南永昌-民權,2023-08-02,9312
00900,富邦特選高股息30,239,81,158,華南永昌-民權,2023-08-02,9312
2618,長榮航,195,108,87,華南永昌-民權,2023-08-02,9312
6274,台燿,87,15,72,華南永昌-民權,2023-08-02,9312
00680L,元大美債20正2,67,0,67,華南永昌-民權,2023-08-02,9312
0056,元大高股息,59,4,55,華南永昌-民權,2023-08-02,9312
00923,群益台ESG低碳50,46,0,46,華南永昌-民權,2023-08-02,9312
00885,富邦越南,55,11,44,華南永昌-民權,2023-08-02,9312
00929,復華台灣科技優息,45,2,43,華南永昌-民權,2023-08-02,9312
3481,群創,50,7,43,華南永昌-民權,2023-08-02,9312
2610,華航,37,4,33,華南永昌-民權,2023-08-02,9312
1616,億泰,30,0,30,華南永昌-民權,2023-08-02,9312
3652,精聯,30,0,30,華南永昌-民權,2023-08-02,9312
1314,中石化,35,11,24,華南永昌-民權,2023-08-02,9312
3231,緯創,52,28,24,華南永昌-民權,2023-08-02,9312
2882,國泰金,26,3,23,華南永昌-民權,2023-08-02,9312
00670L,富邦NASDAQ正2,23,0,23,華南永昌-民權,2023-08-02,9312
2498,宏達電,21,1,20,華南永昌-民權,2023-08-02,9312
1905,華紙,267,249,18,華南永昌-民權,2023-08-02,9312
2002,中鋼,17,0,17,華南永昌-民權,2023-08-02,9312
00919,群益台灣精選高息,16,0,16,華南永昌-民權,2023-08-02,9312
00679B,元大美債20年,16,0,16,華南永昌-民權,2023-08-02,9312
2884,玉山金,15,1,14,華南永昌-民權,2023-08-02,9312
2402,毅嘉,21,8,13,華南永昌-民權,2023-08-02,9312
00878,國泰永續高股息,91,78,13,華南永昌-民權,2023-08-02,9312
6282,康舒,14,2,12,華南永昌-民權,2023-08-02,9312
2312,金寶,22,10,12,華南永昌-民權,2023-08-02,9312
2353,宏��,13,1,12,華南永昌-民權,2023-08-02,9312
5443,均豪,11,0,11,華南永昌-民權,2023-08-02,9312
00720B,元大投資級公司債,10,0,10,華南永昌-民權,2023-08-02,9312
1319,東陽,11,1,10,華南永昌-民權,2023-08-02,9312
2313,華通,10,0,10,華南永昌-民權,2023-08-02,9312
3149,正達,10,0,10,華南永昌-民權,2023-08-02,9312
6129,普誠,10,0,10,華南永昌-民權,2023-08-02,9312
3545,敦泰,10,1,9,華南永昌-民權,2023-08-02,9312
6188,廣明,40,32,8,華南永昌-民權,2023-08-02,9312
2360,致茂,18,10,8,華南永昌-民權,2023-08-02,9312
3044,健鼎,14,6,8,華南永昌-民權,2023-08-02,9312
3312,弘憶股,8,0,8,華南永昌-民權,2023-08-02,9312
5519,隆大,8,0,8,華南永昌-民權,2023-08-02,9312
8926,台汽電,8,0,8,華南永昌-民權,2023-08-02,9312
2892,第一金,7,0,7,華南永昌-民權,2023-08-02,9312
1513,中興電,28,21,7,華南永昌-民權,2023-08-02,9312
1799,易威,7,0,7,華南永昌-民權,2023-08-02,9312
3071,協禧,7,0,7,華南永昌-民權,2023-08-02,9312
3035,智原,6,0,6,華南永昌-民權,2023-08-02,9312
1617,榮星,8,2,6,華南永昌-民權,2023-08-02,9312
2337,旺宏,6,0,6,華南永昌-民權,2023-08-02,9312
2363,矽統,6,0,6,華南永昌-民權,2023-08-02,9312
6187,萬潤,160,51,109,華南永昌-民權,2023-08-04,9312
2382,廣達,220,161,59,華南永昌-民權,2023-08-04,9312
3044,健鼎,61,8,53,華南永昌-民權,2023-08-04,9312
3583,辛耘,82,30,52,華南永昌-民權,2023-08-04,9312
9955,佳龍,51,0,51,華南永昌-民權,2023-08-04,9312
2344,華邦電,78,28,50,華南永昌-民權,2023-08-04,9312
0056,元大高股息,56,7,49,華南永昌-民權,2023-08-04,9312
00680L,元大美債20正2,191,151,40,華南永昌-民權,2023-08-04,9312
3661,世芯-KY,30,0,30,華南永昌-民權,2023-08-04,9312
3580,友威科,30,0,30,華南永昌-民權,2023-08-04,9312
00929,復華台灣科技優息,29,0,29,華南永昌-民權,2023-08-04,9312
2891,中信金,28,0,28,華南永昌-民權,2023-08-04,9312
2367,燿華,26,0,26,華南永昌-民權,2023-08-04,9312
00712,復華富時不動產,24,0,24,華南永昌-民權,2023-08-04,9312
2323,中環,28,4,24,華南永昌-民權,2023-08-04,9312
00900,富邦特選高股息30,21,0,21,華南永昌-民權,2023-08-04,9312
2356,英業達,35,14,21,華南永昌-民權,2023-08-04,9312
1785,光洋科,22,5,17,華南永昌-民權,2023-08-04,9312
00878,國泰永續高股息,18,2,16,華南永昌-民權,2023-08-04,9312
1609,大亞,19,4,15,華南永昌-民權,2023-08-04,9312
2913,農林,364,350,14,華南永昌-民權,2023-08-04,9312
6548,長科*,13,0,13,華南永昌-民權,2023-08-04,9312
3652,精聯,12,0,12,華南永昌-民權,2023-08-04,9312
2610,華航,17,6,11,華南永昌-民權,2023-08-04,9312
00923,群益台ESG低碳50,11,0,11,華南永昌-民權,2023-08-04,9312
2884,玉山金,10,0,10,華南永昌-民權,2023-08-04,9312
1410,南染,10,0,10,華南永昌-民權,2023-08-04,9312
2498,宏達電,10,0,10,華南永昌-民權,2023-08-04,9312
4414,如興,10,0,10,華南永昌-民權,2023-08-04,9312
8046,南電,12,2,10,華南永昌-民權,2023-08-04,9312
00679B,元大美債20年,10,0,10,華南永昌-民權,2023-08-04,9312
1605,華新,11,2,9,華南永昌-民權,2023-08-04,9312
2881,富邦金,9,0,9,華南永昌-民權,2023-08-04,9312
2460,建通,20,11,9,華南永昌-民權,2023-08-04,9312
2464,盟立,9,0,9,華南永昌-民權,2023-08-04,9312
00772B,中信高評級公司債,8,0,8,華南永昌-民權,2023-08-04,9312
1216,統一,8,0,8,華南永昌-民權,2023-08-04,9312
1608,華榮,8,0,8,華南永昌-民權,2023-08-04,9312
00891,中信關鍵半導體,8,1,7,華南永昌-民權,2023-08-04,9312
00687B,國泰20年美債,7,0,7,華南永昌-民權,2023-08-04,9312
3035,智原,7,0,7,華南永昌-民權,2023-08-04,9312
2376,技嘉,11,5,6,華南永昌-民權,2023-08-04,9312
00751B,元大AAA至A公司債,6,0,6,華南永昌-民權,2023-08-04,9312
1301,台塑,6,0,6,華南永昌-民權,2023-08-04,9312
2405,輔信,8,2,6,華南永昌-民權,2023-08-04,9312
2618,長榮航,22,16,6,華南永昌-民權,2023-08-04,9312
2834,臺企銀,6,0,6,華南永昌-民權,2023-08-04,9312
2330,台積電,6,1,5,華南永昌-民權,2023-08-04,9312
2009,第一銅,5,0,5,華南永昌-民權,2023-08-04,9312
00724B,群益投資級金融債,11,6,5,華南永昌-民權,2023-08-04,9312
2888,新光金,84,4,80,華南永昌-民權,2023-08-07,9312
4155,訊映,50,1,49,華南永昌-民權,2023-08-07,9312
3081,聯亞,36,0,36,華南永昌-民權,2023-08-07,9312
2630,亞航,62,31,31,華南永昌-民權,2023-08-07,9312
00902,中信電池及儲能,30,0,30,華南永昌-民權,2023-08-07,9312
00929,復華台灣科技優息,30,5,25,華南永昌-民權,2023-08-07,9312
2618,長榮航,140,116,24,華南永昌-民權,2023-08-07,9312
2352,佳世達,23,2,21,華南永昌-民權,2023-08-07,9312
2891,中信金,21,0,21,華南永昌-民權,2023-08-07,9312
2610,華航,22,2,20,華南永昌-民權,2023-08-07,9312
00733,富邦臺灣中小,20,0,20,華南永昌-民權,2023-08-07,9312
1313,聯成,20,0,20,華南永昌-民權,2023-08-07,9312
2903,遠百,20,0,20,華南永昌-民權,2023-08-07,9312
1799,易威,16,0,16,華南永昌-民權,2023-08-07,9312
00923,群益台ESG低碳50,15,0,15,華南永昌-民權,2023-08-07,9312
00931B,統一美債20年,15,0,15,華南永昌-民權,2023-08-07,9312
3306,鼎天,11,0,11,華南永昌-民權,2023-08-07,9312
8930,青鋼,11,0,11,華南永昌-民權,2023-08-07,9312
2303,聯電,10,0,10,華南永昌-民權,2023-08-07,9312
00632R,元大台灣50反1,10,0,10,華南永昌-民權,2023-08-07,9312
1809,中釉,10,0,10,華南永昌-民權,2023-08-07,9312
5009,榮剛,10,0,10,華南永昌-民權,2023-08-07,9312
5328,華容,10,0,10,華南永昌-民權,2023-08-07,9312
3033,威健,10,1,9,華南永昌-民權,2023-08-07,9312
00720B,元大投資級公司債,8,0,8,華南永昌-民權,2023-08-07,9312
6138,茂達,8,0,8,華南永昌-民權,2023-08-07,9312
6269,台郡,8,0,8,華南永昌-民權,2023-08-07,9312
2913,農林,22,14,8,華南永昌-民權,2023-08-07,9312
2301,光寶科,30,23,7,華南永昌-民權,2023-08-07,9312
2206,三陽工業,13,6,7,華南永昌-民權,2023-08-07,9312
2609,陽明,14,7,7,華南永昌-民權,2023-08-07,9312
00900,富邦特選高股息30,14,7,7,華南永昌-民權,2023-08-07,9312
2421,建準,6,0,6,華南永昌-民權,2023-08-07,9312
1467,南緯,8,2,6,華南永昌-民權,2023-08-07,9312
1609,大亞,6,0,6,華南永昌-民權,2023-08-07,9312
3265,台星科,6,0,6,華南永昌-民權,2023-08-07,9312
2371,大同,5,0,5,華南永昌-民權,2023-08-07,9312
3205,佰研,5,0,5,華南永昌-民權,2023-08-07,9312
4167,松瑞藥,5,0,5,華南永昌-民權,2023-08-07,9312
6488,環球晶,5,0,5,華南永昌-民權,2023-08-07,9312
8050,廣積,10,5,5,華南永昌-民權,2023-08-07,9312
8299,群聯,5,0,5,華南永昌-民權,2023-08-07,9312
2357,華碩,5,0,5,華南永昌-民權,2023-08-07,9312
2883,凱基金,5,0,5,華南永昌-民權,2023-08-07,9312
2317,鴻海,9,5,4,華南永昌-民權,2023-08-07,9312
4953,緯軟,5,1,4,華南永昌-民權,2023-08-07,9312
9955,佳龍,4,0,4,華南永昌-民權,2023-08-07,9312
1102,亞泥,3,0,3,華南永昌-民權,2023-08-07,9312
1723,中碳,3,0,3,華南永昌-民權,2023-08-07,9312
2413,環科,3,0,3,華南永昌-民權,2023-08-07,9312
6138,茂達,209,7,202,華南永昌-民權,2023-08-08,9312
5519,隆大,83,0,83,華南永昌-民權,2023-08-08,9312
00900,富邦特選高股息30,76,0,76,華南永昌-民權,2023-08-08,9312
4927,泰鼎-KY,51,1,50,華南永昌-民權,2023-08-08,9312
2382,廣達,50,19,31,華南永昌-民權,2023-08-08,9312
2891,中信金,28,0,28,華南永昌-民權,2023-08-08,9312
2371,大同,56,29,27,華南永昌-民權,2023-08-08,9312
2323,中環,92,66,26,華南永昌-民權,2023-08-08,9312
00929,復華台灣科技優息,24,0,24,華南永昌-民權,2023-08-08,9312
2883,凱基金,33,10,23,華南永昌-民權,2023-08-08,9312
00931B,統一美債20年,22,0,22,華南永昌-民權,2023-08-08,9312
2388,威盛,22,0,22,華南永昌-民權,2023-08-08,9312
3325,旭品,25,4,21,華南永昌-民權,2023-08-08,9312
00891,中信關鍵半導體,20,5,15,華南永昌-民權,2023-08-08,9312
2344,華邦電,17,2,15,華南永昌-民權,2023-08-08,9312
3306,鼎天,34,21,13,華南永昌-民權,2023-08-08,9312
8155,博智,17,4,13,華南永昌-民權,2023-08-08,9312
1101,台泥,13,0,13,華南永昌-民權,2023-08-08,9312
2913,農林,17,5,12,華南永昌-民權,2023-08-08,9312
00923,群益台ESG低碳50,10,0,10,華南永昌-民權,2023-08-08,9312
00892,富邦台灣半導體,10,0,10,華南永昌-民權,2023-08-08,9312
6188,廣明,48,38,10,華南永昌-民權,2023-08-08,9312
8996,高力,10,0,10,華南永昌-民權,2023-08-08,9312
2301,光寶科,28,20,8,華南永昌-民權,2023-08-08,9312
2834,臺企銀,8,0,8,華南永昌-民權,2023-08-08,9312
2890,永豐金,8,0,8,華南永昌-民權,2023-08-08,9312
3231,緯創,36,30,6,華南永昌-民權,2023-08-08,9312
00712,復華富時不動產,10,4,6,華南永昌-民權,2023-08-08,9312
1609,大亞,6,0,6,華南永昌-民權,2023-08-08,9312
2338,光罩,7,1,6,華南永昌-民權,2023-08-08,9312
2880,華南金,6,0,6,華南永昌-民權,2023-08-08,9312
3051,力特,6,0,6,華南永昌-民權,2023-08-08,9312
3680,家登,7,1,6,華南永昌-民權,2023-08-08,9312
5347,世界,5,0,5,華南永昌-民權,2023-08-08,9312
6285,啟��,26,21,5,華南永昌-民權,2023-08-08,9312
1410,南染,5,0,5,華南永昌-民權,2023-08-08,9312
1336,台翰,5,0,5,華南永昌-民權,2023-08-08,9312
00850,元大臺灣ESG永續,5,0,5,華南永昌-民權,2023-08-08,9312
00795B,中信美國公債20年,5,0,5,華南永昌-民權,2023-08-08,9312
00722B,群益投資級電信債,5,0,5,華南永昌-民權,2023-08-08,9312
00720B,元大投資級公司債,5,0,5,華南永昌-民權,2023-08-08,9312
2014,中鴻,5,0,5,華南永昌-民權,2023-08-08,9312
2352,佳世達,7,2,5,華南永昌-民權,2023-08-08,9312
2425,承啟,5,0,5,華南永昌-民權,2023-08-08,9312
2884,玉山金,5,0,5,華南永昌-民權,2023-08-08,9312
3017,奇鋐,15,10,5,華南永昌-民權,2023-08-08,9312
3515,華擎,15,10,5,華南永昌-民權,2023-08-08,9312
4532,瑞智,5,0,5,華南永昌-民權,2023-08-08,9312
4945,陞達科技,5,0,5,華南永昌-民權,2023-08-08,9312
4989,榮科,5,0,5,華南永昌-民權,2023-08-08,9312
6187,萬潤,131,1,130,華南永昌-民權,2023-08-09,9312
2890,永豐金,106,21,85,華南永昌-民權,2023-08-09,9312
5519,隆大,72,0,72,華南永昌-民權,2023-08-09,9312
3483,力致,113,52,61,華南永昌-民權,2023-08-09,9312
2382,廣達,69,13,56,華南永昌-民權,2023-08-09,9312
6274,台燿,55,1,54,華南永昌-民權,2023-08-09,9312
1609,大亞,39,4,35,華南永昌-民權,2023-08-09,9312
3652,精聯,30,0,30,華南永昌-民權,2023-08-09,9312
6152,百一,30,0,30,華南永昌-民權,2023-08-09,9312
00900,富邦特選高股息30,24,0,24,華南永昌-民權,2023-08-09,9312
00795B,中信美國公債20年,20,0,20,華南永昌-民權,2023-08-09,9312
00680L,元大美債20正2,20,0,20,華南永昌-民權,2023-08-09,9312
3715,定穎投控,20,0,20,華南永昌-民權,2023-08-09,9312
9934,成霖,20,0,20,華南永昌-民權,2023-08-09,9312
2888,新光金,20,1,19,華南永昌-民權,2023-08-09,9312
3481,群創,19,4,15,華南永昌-民權,2023-08-09,9312
5880,合庫金,14,0,14,華南永昌-民權,2023-08-09,9312
2367,燿華,14,0,14,華南永昌-民權,2023-08-09,9312
00923,群益台ESG低碳50,12,0,12,華南永昌-民權,2023-08-09,9312
2002,中鋼,21,10,11,華南永昌-民權,2023-08-09,9312
2324,仁寶,14,3,11,華南永昌-民權,2023-08-09,9312
1410,南染,10,0,10,華南永昌-民權,2023-08-09,9312
00931B,統一美債20年,10,0,10,華南永昌-民權,2023-08-09,9312
1722,台肥,10,0,10,華南永昌-民權,2023-08-09,9312
3231,緯創,25,15,10,華南永昌-民權,2023-08-09,9312
00679B,元大美債20年,9,0,9,華南永昌-民權,2023-08-09,9312
3312,弘憶股,9,0,9,華南永昌-民權,2023-08-09,9312
8255,朋程,12,3,9,華南永昌-民權,2023-08-09,9312
2882,國泰金,9,0,9,華南永昌-民權,2023-08-09,9312
1210,大成,9,1,8,華南永昌-民權,2023-08-09,9312
3363,上詮,7,0,7,華南永昌-民權,2023-08-09,9312
6789,采鈺,10,3,7,華南永昌-民權,2023-08-09,9312
00929,復華台灣科技優息,16,10,6,華南永昌-民權,2023-08-09,9312
2801,彰銀,11,5,6,華南永昌-民權,2023-08-09,9312
00882,中信中國高股息,6,0,6,華南永昌-民權,2023-08-09,9312
1734,杏輝,6,0,6,華南永昌-民權,2023-08-09,9312
1802,台玻,17,11,6,華南永昌-民權,2023-08-09,9312
1809,中釉,6,0,6,華南永昌-民權,2023-08-09,9312
2449,京元電子,7,1,6,華南永昌-民權,2023-08-09,9312
3049,精金,6,0,6,華南永昌-民權,2023-08-09,9312
3325,旭品,23,17,6,華南永昌-民權,2023-08-09,9312
3661,世芯-KY,6,0,6,華南永昌-民權,2023-08-09,9312
5469,瀚宇博,26,20,6,華南永昌-民權,2023-08-09,9312
6239,力成,6,0,6,華南永昌-民權,2023-08-09,9312
2884,玉山金,5,0,5,華南永昌-民權,2023-08-09,9312
00885,富邦越南,25,20,5,華南永昌-民權,2023-08-09,9312
2344,華邦電,15,10,5,華南永昌-民權,2023-08-09,9312
2453,凌群,5,0,5,華南永昌-民權,2023-08-09,9312
5608,四維航,10,5,5,華南永昌-民權,2023-08-09,9312
6120,達運,25,20,5,華南永昌-民權,2023-08-09,9312
3483,力致,117,38,79,華南永昌-民權,2023-08-10,9312
00900,富邦特選高股息30,82,4,78,華南永昌-民權,2023-08-10,9312
2002,中鋼,89,21,68,華南永昌-民權,2023-08-10,9312
2323,中環,73,6,67,華南永昌-民權,2023-08-10,9312
1513,中興電,71,15,56,華南永昌-民權,2023-08-10,9312
2801,彰銀,50,0,50,華南永昌-民權,2023-08-10,9312
2892,第一金,49,8,41,華南永昌-民權,2023-08-10,9312
2610,華航,49,8,41,華南永昌-民權,2023-08-10,9312
5243,乙盛-KY,35,0,35,華南永昌-民權,2023-08-10,9312
00929,復華台灣科技優息,33,0,33,華南永昌-民權,2023-08-10,9312
1609,大亞,33,0,33,華南永昌-民權,2023-08-10,9312
2208,台船,25,2,23,華南永昌-民權,2023-08-10,9312
2303,聯電,23,0,23,華南永昌-民權,2023-08-10,9312
2886,兆豐金,22,0,22,華南永昌-民權,2023-08-10,9312
3652,精聯,22,0,22,華南永昌-民權,2023-08-10,9312
0056,元大高股息,44,24,20,華南永昌-民權,2023-08-10,9312
4927,泰鼎-KY,21,2,19,華南永昌-民權,2023-08-10,9312
00878,國泰永續高股息,21,3,18,華南永昌-民權,2023-08-10,9312
1799,易威,18,0,18,華南永昌-民權,2023-08-10,9312
2609,陽明,21,3,18,華南永昌-民權,2023-08-10,9312
2409,友達,17,0,17,華南永昌-民權,2023-08-10,9312
2504,國產,16,0,16,華南永昌-民權,2023-08-10,9312
2516,新建,15,2,13,華南永昌-民權,2023-08-10,9312
3038,全台,13,0,13,華南永昌-民權,2023-08-10,9312
3231,緯創,28,15,13,華南永昌-民權,2023-08-10,9312
2324,仁寶,13,1,12,華南永昌-民權,2023-08-10,9312
8155,博智,12,0,12,華南永昌-民權,2023-08-10,9312
1802,台玻,11,0,11,華南永昌-民權,2023-08-10,9312
2313,華通,11,0,11,華南永昌-民權,2023-08-10,9312
2402,毅嘉,11,0,11,華南永昌-民權,2023-08-10,9312
3071,協禧,11,0,11,華南永昌-民權,2023-08-10,9312
00637L,元大滬深300正2,10,0,10,華南永昌-民權,2023-08-10,9312
2380,虹光,10,0,10,華南永昌-民權,2023-08-10,9312
3715,定穎投控,10,0,10,華南永昌-民權,2023-08-10,9312
5508,永信建,10,0,10,華南永昌-民權,2023-08-10,9312
3661,世芯-KY,9,0,9,華南永昌-民權,2023-08-10,9312
6770,力積電,10,2,8,華南永昌-民權,2023-08-10,9312
00850,元大臺灣ESG永續,7,0,7,華南永昌-民權,2023-08-10,9312
2331,精英,10,3,7,華南永昌-民權,2023-08-10,9312
3029,零壹,7,1,6,華南永昌-民權,2023-08-10,9312
4111,濟生,6,0,6,華南永昌-民權,2023-08-10,9312
5452,佶優,6,0,6,華南永昌-民權,2023-08-10,9312
5608,四維航,6,0,6,華南永昌-民權,2023-08-10,9312
6116,彩晶,6,0,6,華南永昌-民權,2023-08-10,9312
6269,台郡,6,0,6,華南永昌-民權,2023-08-10,9312
8924,大田,6,0,6,華南永昌-民權,2023-08-10,9312
3037,欣興,9,4,5,華南永昌-民權,2023-08-10,9312
2371,大同,7,2,5,華南永昌-民權,2023-08-10,9312
2834,臺企銀,5,0,5,華南永昌-民權,2023-08-10,9312
2356,英業達,20,15,5,華南永昌-民權,2023-08-10,9312
00673R,期元大S＆P原油反1,200,0,200,華南永昌-民權,2023-08-11,9312
2801,彰銀,128,0,128,華南永昌-民權,2023-08-11,9312
00712,復華富時不動產,75,0,75,華南永昌-民權,2023-08-11,9312
00680L,元大美債20正2,43,0,43,華南永昌-民權,2023-08-11,9312
00929,復華台灣科技優息,41,3,38,華南永昌-民權,2023-08-11,9312
00795B,中信美國公債20年,38,0,38,華南永昌-民權,2023-08-11,9312
6257,矽格,34,0,34,華南永昌-民權,2023-08-11,9312
6120,達運,30,2,28,華南永昌-民權,2023-08-11,9312
2892,第一金,27,0,27,華南永昌-民權,2023-08-11,9312
2352,佳世達,27,0,27,華南永昌-民權,2023-08-11,9312
8038,長園科,34,10,24,華南永昌-民權,2023-08-11,9312
6187,萬潤,26,4,22,華南永昌-民權,2023-08-11,9312
2382,廣達,70,51,19,華南永昌-民權,2023-08-11,9312
00900,富邦特選高股息30,18,0,18,華南永昌-民權,2023-08-11,9312
1711,永光,20,3,17,華南永昌-民權,2023-08-11,9312
1609,大亞,17,1,16,華南永昌-民權,2023-08-11,9312
2405,輔信,16,0,16,華南永昌-民權,2023-08-11,9312
6138,茂達,28,12,16,華南永昌-民權,2023-08-11,9312
2609,陽明,21,6,15,華南永昌-民權,2023-08-11,9312
2002,中鋼,14,0,14,華南永昌-民權,2023-08-11,9312
3231,緯創,20,9,11,華南永昌-民權,2023-08-11,9312
3363,上詮,11,0,11,華南永昌-民權,2023-08-11,9312
1799,易威,10,0,10,華南永昌-民權,2023-08-11,9312
2883,凱基金,12,2,10,華南永昌-民權,2023-08-11,9312
2915,潤泰全,10,0,10,華南永昌-民權,2023-08-11,9312
3491,昇達科,10,0,10,華南永昌-民權,2023-08-11,9312
3706,神達,18,8,10,華南永昌-民權,2023-08-11,9312
00931B,統一美債20年,9,0,9,華南永昌-民權,2023-08-11,9312
3038,全台,10,1,9,華南永昌-民權,2023-08-11,9312
3707,漢磊,9,0,9,華南永昌-民權,2023-08-11,9312
2615,萬海,10,2,8,華南永昌-民權,2023-08-11,9312
1717,長興,7,0,7,華南永昌-民權,2023-08-11,9312
2014,中鴻,7,0,7,華南永昌-民權,2023-08-11,9312
2331,精英,7,0,7,華南永昌-民權,2023-08-11,9312
2363,矽統,19,12,7,華南永昌-民權,2023-08-11,9312
3479,安勤,7,0,7,華南永昌-民權,2023-08-11,9312
5608,四維航,7,0,7,華南永昌-民權,2023-08-11,9312
8043,蜜望實,7,0,7,華南永昌-民權,2023-08-11,9312
6770,力積電,8,2,6,華南永昌-民權,2023-08-11,9312
2886,兆豐金,6,0,6,華南永昌-民權,2023-08-11,9312
00715L,期街口布蘭特正2,6,0,6,華南永昌-民權,2023-08-11,9312
3081,聯亞,10,4,6,華南永昌-民權,2023-08-11,9312
4541,晟田,6,0,6,華南永昌-民權,2023-08-11,9312
4942,嘉彰,6,0,6,華南永昌-民權,2023-08-11,9312
6182,合晶,6,0,6,華南永昌-民權,2023-08-11,9312
6269,台郡,6,0,6,華南永昌-民權,2023-08-11,9312
8358,金居,7,1,6,華南永昌-民權,2023-08-11,9312
1410,南染,5,0,5,華南永昌-民權,2023-08-11,9312
3049,精金,5,0,5,華南永昌-民權,2023-08-11,9312
3163,波若威,6,1,5,華南永昌-民權,2023-08-11,9312
4906,正文,200,2,198,華南永昌-民權,2023-08-14,9312
00882,中信中國高股息,104,0,104,華南永昌-民權,2023-08-14,9312
2801,彰銀,100,0,100,華南永昌-民權,2023-08-14,9312
00900,富邦特選高股息30,98,0,98,華南永昌-民權,2023-08-14,9312
1312,國喬,80,0,80,華南永昌-民權,2023-08-14,9312
1513,中興電,86,9,77,華南永昌-民權,2023-08-14,9312
00929,復華台灣科技優息,74,1,73,華南永昌-民權,2023-08-14,9312
2883,凱基金,59,2,57,華南永昌-民權,2023-08-14,9312
2002,中鋼,45,0,45,華南永昌-民權,2023-08-14,9312
5483,中美晶,45,0,45,華南永昌-民權,2023-08-14,9312
2344,華邦電,67,26,41,華南永昌-民權,2023-08-14,9312
2610,華航,41,1,40,華南永昌-民權,2023-08-14,9312
6257,矽格,43,3,40,華南永昌-民權,2023-08-14,9312
2886,兆豐金,37,0,37,華南永昌-民權,2023-08-14,9312
4927,泰鼎-KY,36,0,36,華南永昌-民權,2023-08-14,9312
3049,精金,30,0,30,華南永昌-民權,2023-08-14,9312
2834,臺企銀,27,0,27,華南永昌-民權,2023-08-14,9312
3231,緯創,34,8,26,華南永昌-民權,2023-08-14,9312
3481,群創,30,6,24,華南永昌-民權,2023-08-14,9312
2888,新光金,21,0,21,華南永昌-民權,2023-08-14,9312
2017,官田鋼,20,0,20,華南永昌-民權,2023-08-14,9312
3016,嘉晶,20,0,20,華南永昌-民權,2023-08-14,9312
2618,長榮航,172,153,19,華南永昌-民權,2023-08-14,9312
3706,神達,22,4,18,華南永昌-民權,2023-08-14,9312
2897A,王道銀甲特,16,0,16,華南永昌-民權,2023-08-14,9312
6274,台燿,17,2,15,華南永昌-民權,2023-08-14,9312
00907,永豐優息存股,14,0,14,華南永昌-民權,2023-08-14,9312
6770,力積電,14,0,14,華南永昌-民權,2023-08-14,9312
00878,國泰永續高股息,32,20,12,華南永昌-民權,2023-08-14,9312
2027,大成鋼,11,0,11,華南永昌-民權,2023-08-14,9312
1717,長興,11,0,11,華南永昌-民權,2023-08-14,9312
3715,定穎投控,22,11,11,華南永昌-民權,2023-08-14,9312
00923,群益台ESG低碳50,10,0,10,華南永昌-民權,2023-08-14,9312
1227,佳格,10,0,10,華南永昌-民權,2023-08-14,9312
2208,台船,10,0,10,華南永昌-民權,2023-08-14,9312
2504,國產,10,0,10,華南永昌-民權,2023-08-14,9312
3652,精聯,10,0,10,華南永昌-民權,2023-08-14,9312
9955,佳龍,14,4,10,華南永昌-民權,2023-08-14,9312
00753L,中信中國50正2,9,0,9,華南永昌-民權,2023-08-14,9312
2891,中信金,10,1,9,華南永昌-民權,2023-08-14,9312
3081,聯亞,9,0,9,華南永昌-民權,2023-08-14,9312
6188,廣明,21,12,9,華南永昌-民權,2023-08-14,9312
2303,聯電,8,0,8,華南永昌-民權,2023-08-14,9312
2324,仁寶,28,20,8,華南永昌-民權,2023-08-14,9312
6282,康舒,8,0,8,華南永昌-民權,2023-08-14,9312
2460,建通,12,4,8,華南永昌-民權,2023-08-14,9312
4162,智擎,8,0,8,華南永昌-民權,2023-08-14,9312
1605,華新,7,0,7,華南永昌-民權,2023-08-14,9312
2356,英業達,15,8,7,華南永昌-民權,2023-08-14,9312
3189,景碩,7,0,7,華南永昌-民權,2023-08-14,9312
3483,力致,100,20,80,華南永昌-民權,2023-08-15,9312
00632R,元大台灣50反1,60,0,60,華南永昌-民權,2023-08-15,9312
00923,群益台ESG低碳50,45,0,45,華南永昌-民權,2023-08-15,9312
2706,第一店,40,0,40,華南永昌-民權,2023-08-15,9312
00713,元大台灣高息低波,39,0,39,華南永昌-民權,2023-08-15,9312
00900,富邦特選高股息30,31,0,31,華南永昌-民權,2023-08-15,9312
2357,華碩,30,3,27,華南永昌-民權,2023-08-15,9312
2303,聯電,27,2,25,華南永昌-民權,2023-08-15,9312
6187,萬潤,26,1,25,華南永昌-民權,2023-08-15,9312
00929,復華台灣科技優息,24,1,23,華南永昌-民權,2023-08-15,9312
2834,臺企銀,21,0,21,華南永昌-民權,2023-08-15,9312
1312,國喬,21,0,21,華南永昌-民權,2023-08-15,9312
4927,泰鼎-KY,92,77,15,華南永昌-民權,2023-08-15,9312
2618,長榮航,14,1,13,華南永昌-民權,2023-08-15,9312
00679B,元大美債20年,11,0,11,華南永昌-民權,2023-08-15,9312
2913,農林,12,1,11,華南永昌-民權,2023-08-15,9312
6669,緯穎,11,0,11,華南永昌-民權,2023-08-15,9312
2883B,凱基金乙特,10,0,10,華南永昌-民權,2023-08-15,9312
2317,鴻海,17,8,9,華南永昌-民權,2023-08-15,9312
3481,群創,19,10,9,華南永昌-民權,2023-08-15,9312
00907,永豐優息存股,10,1,9,華南永昌-民權,2023-08-15,9312
2880,華南金,8,0,8,華南永昌-民權,2023-08-15,9312
8039,台虹,8,0,8,華南永昌-民權,2023-08-15,9312
00751B,元大AAA至A公司債,7,0,7,華南永昌-民權,2023-08-15,9312
1402,遠東新,6,0,6,華南永昌-民權,2023-08-15,9312
00931B,統一美債20年,6,0,6,華南永昌-民權,2023-08-15,9312
00712,復華富時不動產,6,0,6,華南永昌-民權,2023-08-15,9312
00720B,元大投資級公司債,6,0,6,華南永昌-民權,2023-08-15,9312
00773B,中信優先金融債,6,0,6,華南永昌-民權,2023-08-15,9312
2881,富邦金,6,0,6,華南永昌-民權,2023-08-15,9312
2002,中鋼,5,0,5,華南永昌-民權,2023-08-15,9312
1410,南染,5,0,5,華南永昌-民權,2023-08-15,9312
2115,六暉-KY,5,0,5,華南永昌-民權,2023-08-15,9312
2337,旺宏,5,0,5,華南永昌-民權,2023-08-15,9312
2836,高雄銀,5,0,5,華南永昌-民權,2023-08-15,9312
3056,富華新,5,0,5,華南永昌-民權,2023-08-15,9312
3105,穩懋,5,0,5,華南永昌-民權,2023-08-15,9312
8215,明基材,5,0,5,華南永昌-民權,2023-08-15,9312
9955,佳龍,5,0,5,華南永昌-民權,2023-08-15,9312
6274,台燿,14,10,4,華南永昌-民權,2023-08-15,9312
00752,中信中國50,4,0,4,華南永昌-民權,2023-08-15,9312
1605,華新,4,0,4,華南永昌-民權,2023-08-15,9312
1609,大亞,5,1,4,華南永昌-民權,2023-08-15,9312
2329,華泰,18,14,4,華南永昌-民權,2023-08-15,9312
2428,興勤,4,0,4,華南永昌-民權,2023-08-15,9312
2449,京元電子,5,1,4,華南永昌-民權,2023-08-15,9312
2892,第一金,4,0,4,華南永昌-民權,2023-08-15,9312
3162,精確,4,0,4,華南永昌-民權,2023-08-15,9312
6531,愛普*,4,0,4,華南永昌-民權,2023-08-15,9312
2886,兆豐金,4,0,4,華南永昌-民權,2023-08-15,9312
4906,正文,257,5,252,華南永昌-民權,2023-08-16,9312
2323,中環,75,0,75,華南永昌-民權,2023-08-16,9312
2801,彰銀,51,0,51,華南永昌-民權,2023-08-16,9312
00929,復華台灣科技優息,42,1,41,華南永昌-民權,2023-08-16,9312
2002,中鋼,45,10,35,華南永昌-民權,2023-08-16,9312
2618,長榮航,82,60,22,華南永昌-民權,2023-08-16,9312
3481,群創,20,0,20,華南永昌-民權,2023-08-16,9312
00923,群益台ESG低碳50,17,0,17,華南永昌-民權,2023-08-16,9312
2303,聯電,18,1,17,華南永昌-民權,2023-08-16,9312
1312,國喬,20,4,16,華南永昌-民權,2023-08-16,9312
1410,南染,15,0,15,華南永昌-民權,2023-08-16,9312
3049,精金,15,0,15,華南永昌-民權,2023-08-16,9312
6187,萬潤,15,0,15,華南永昌-民權,2023-08-16,9312
2886,兆豐金,13,0,13,華南永昌-民權,2023-08-16,9312
00753L,中信中國50正2,13,0,13,華南永昌-民權,2023-08-16,9312
6138,茂達,13,0,13,華南永昌-民權,2023-08-16,9312
1513,中興電,25,13,12,華南永昌-民權,2023-08-16,9312
2915,潤泰全,12,0,12,華南永昌-民權,2023-08-16,9312
8210,勤誠,17,5,12,華南永昌-民權,2023-08-16,9312
00907,永豐優息存股,14,2,12,華南永昌-民權,2023-08-16,9312
2312,金寶,10,0,10,華南永昌-民權,2023-08-16,9312
2891,中信金,10,0,10,華南永昌-民權,2023-08-16,9312
3689,湧德,13,3,10,華南永昌-民權,2023-08-16,9312
6129,普誠,10,0,10,華南永昌-民權,2023-08-16,9312
6235,華孚,10,0,10,華南永昌-民權,2023-08-16,9312
2913,農林,10,1,9,華南永昌-民權,2023-08-16,9312
2880,華南金,9,0,9,華南永昌-民權,2023-08-16,9312
2356,英業達,48,40,8,華南永昌-民權,2023-08-16,9312
2332,友訊,21,13,8,華南永昌-民權,2023-08-16,9312
2330,台積電,9,1,8,華南永昌-民權,2023-08-16,9312
2834,臺企銀,7,0,7,華南永昌-民權,2023-08-16,9312
00751B,元大AAA至A公司債,7,0,7,華南永昌-民權,2023-08-16,9312
2363,矽統,172,165,7,華南永昌-民權,2023-08-16,9312
8426,紅木-KY,9,2,7,華南永昌-民權,2023-08-16,9312
00878,國泰永續高股息,16,10,6,華南永昌-民權,2023-08-16,9312
00772B,中信高評級公司債,6,0,6,華南永昌-民權,2023-08-16,9312
00720B,元大投資級公司債,7,1,6,華南永昌-民權,2023-08-16,9312
00882,中信中國高股息,6,0,6,華南永昌-民權,2023-08-16,9312
1717,長興,6,0,6,華南永昌-民權,2023-08-16,9312
2014,中鴻,7,1,6,華南永昌-民權,2023-08-16,9312
2317,鴻海,8,3,5,華南永昌-民權,2023-08-16,9312
00900,富邦特選高股息30,5,0,5,華南永昌-民權,2023-08-16,9312
00687B,國泰20年美債,5,0,5,華南永昌-民權,2023-08-16,9312
1319,東陽,6,1,5,華南永昌-民權,2023-08-16,9312
1799,易威,5,0,5,華南永昌-民權,2023-08-16,9312
3017,奇鋐,7,2,5,華南永昌-民權,2023-08-16,9312
3051,力特,12,7,5,華南永昌-民權,2023-08-16,9312
3663,鑫科,5,0,5,華南永昌-民權,2023-08-16,9312
3035,智原,10,5,5,華南永昌-民權,2023-08-16,9312
2884,玉山金,8,4,4,華南永昌-民權,2023-08-16,9312
2834,臺企銀,223,0,223,華南永昌-民權,2023-08-17,9312
4906,正文,355,157,198,華南永昌-民權,2023-08-17,9312
2890,永豐金,111,11,100,華南永昌-民權,2023-08-17,9312
1101,台泥,80,11,69,華南永昌-民權,2023-08-17,9312
2356,英業達,60,7,53,華南永昌-民權,2023-08-17,9312
2002,中鋼,58,30,28,華南永昌-民權,2023-08-17,9312
6669,緯穎,37,16,21,華南永昌-民權,2023-08-17,9312
3694,海華,22,1,21,華南永昌-民權,2023-08-17,9312
2880,華南金,17,0,17,華南永昌-民權,2023-08-17,9312
2610,華航,23,7,16,華南永昌-民權,2023-08-17,9312
1301,台塑,16,0,16,華南永昌-民權,2023-08-17,9312
3231,緯創,36,21,15,華南永昌-民權,2023-08-17,9312
2312,金寶,27,14,13,華南永昌-民權,2023-08-17,9312
2324,仁寶,89,76,13,華南永昌-民權,2023-08-17,9312
6770,力積電,11,0,11,華南永昌-民權,2023-08-17,9312
00753L,中信中國50正2,11,0,11,華南永昌-民權,2023-08-17,9312
2301,光寶科,53,42,11,華南永昌-民權,2023-08-17,9312
00679B,元大美債20年,10,0,10,華南永昌-民權,2023-08-17,9312
2615,萬海,11,1,10,華南永昌-民權,2023-08-17,9312
2903,遠百,10,0,10,華南永昌-民權,2023-08-17,9312
4155,訊映,10,0,10,華南永昌-民權,2023-08-17,9312
6414,樺漢,11,1,10,華南永昌-民權,2023-08-17,9312
8050,廣積,13,3,10,華南永昌-民權,2023-08-17,9312
2887,台新金,39,29,10,華南永昌-民權,2023-08-17,9312
2886,兆豐金,9,0,9,華南永昌-民權,2023-08-17,9312
2535,達欣工,9,0,9,華南永昌-民權,2023-08-17,9312
2881,富邦金,9,0,9,華南永昌-民權,2023-08-17,9312
6126,信音,11,2,9,華南永昌-民權,2023-08-17,9312
2303,聯電,9,0,9,華南永昌-民權,2023-08-17,9312
1609,大亞,13,5,8,華南永昌-民權,2023-08-17,9312
2915,潤泰全,10,2,8,華南永昌-民權,2023-08-17,9312
2884,玉山金,11,4,7,華南永昌-民權,2023-08-17,9312
8069,元太,7,0,7,華南永昌-民權,2023-08-17,9312
00882,中信中國高股息,7,0,7,華南永昌-民權,2023-08-17,9312
00878,國泰永續高股息,9,2,7,華南永昌-民權,2023-08-17,9312
00857B,永豐20年美公債,7,0,7,華南永昌-民權,2023-08-17,9312
3715,定穎投控,48,41,7,華南永昌-民權,2023-08-17,9312
00751B,元大AAA至A公司債,7,0,7,華南永昌-民權,2023-08-17,9312
1314,中石化,6,0,6,華南永昌-民權,2023-08-17,9312
2419,仲琦,6,0,6,華南永昌-民權,2023-08-17,9312
3013,晟銘電,6,0,6,華南永昌-民權,2023-08-17,9312
3051,力特,28,22,6,華南永昌-民權,2023-08-17,9312
00923,群益台ESG低碳50,5,0,5,華南永昌-民權,2023-08-17,9312
1513,中興電,26,21,5,華南永昌-民權,2023-08-17,9312
1785,光洋科,5,0,5,華南永昌-民權,2023-08-17,9312
1799,易威,5,0,5,華南永昌-民權,2023-08-17,9312
2892,第一金,5,0,5,華南永昌-民權,2023-08-17,9312
6147,頎邦,5,0,5,華南永昌-民權,2023-08-17,9312
1795,美時,4,0,4,華南永昌-民權,2023-08-17,9312
2618,長榮航,5,1,4,華南永昌-民權,2023-08-17,9312
00673R,期元大S＆P原油反1,200,0,200,華南永昌-民權,2023-08-18,9312
00929,復華台灣科技優息,103,0,103,華南永昌-民權,2023-08-18,9312
3324,雙鴻,94,2,92,華南永昌-民權,2023-08-18,9312
3231,緯創,71,30,41,華南永昌-民權,2023-08-18,9312
2880,華南金,29,0,29,華南永昌-民權,2023-08-18,9312
00878,國泰永續高股息,29,1,28,華南永昌-民權,2023-08-18,9312
2329,華泰,110,84,26,華南永昌-民權,2023-08-18,9312
00885,富邦越南,25,0,25,華南永昌-民權,2023-08-18,9312
6187,萬潤,33,9,24,華南永昌-民權,2023-08-18,9312
1471,首利,24,2,22,華南永昌-民權,2023-08-18,9312
2363,矽統,47,26,21,華南永昌-民權,2023-08-18,9312
2610,華航,22,3,19,華南永昌-民權,2023-08-18,9312
2313,華通,22,5,17,華南永昌-民權,2023-08-18,9312
3037,欣興,18,1,17,華南永昌-民權,2023-08-18,9312
3056,富華新,20,5,15,華南永昌-民權,2023-08-18,9312
00733,富邦臺灣中小,14,0,14,華南永昌-民權,2023-08-18,9312
6672,騰輝電子-KY,25,11,14,華南永昌-民權,2023-08-18,9312
2303,聯電,19,6,13,華南永昌-民權,2023-08-18,9312
2609,陽明,65,52,13,華南永昌-民權,2023-08-18,9312
2618,長榮航,102,90,12,華南永昌-民權,2023-08-18,9312
3035,智原,29,18,11,華南永昌-民權,2023-08-18,9312
2883,凱基金,11,0,11,華南永昌-民權,2023-08-18,9312
00893,國泰智能電動車,13,2,11,華南永昌-民權,2023-08-18,9312
0050,元大台灣50,10,0,10,華南永昌-民權,2023-08-18,9312
2317,鴻海,11,1,10,華南永昌-民權,2023-08-18,9312
2388,威盛,13,3,10,華南永昌-民權,2023-08-18,9312
2453,凌群,10,0,10,華南永昌-民權,2023-08-18,9312
3081,聯亞,10,0,10,華南永昌-民權,2023-08-18,9312
00640L,富邦日本正2,9,0,9,華南永昌-民權,2023-08-18,9312
2457,飛宏,12,3,9,華南永昌-民權,2023-08-18,9312
3078,僑威,10,1,9,華南永昌-民權,2023-08-18,9312
3363,上詮,10,1,9,華南永昌-民權,2023-08-18,9312
6125,廣運,11,3,8,華南永昌-民權,2023-08-18,9312
6282,康舒,10,2,8,華南永昌-民權,2023-08-18,9312
2405,輔信,10,2,8,華南永昌-民權,2023-08-18,9312
6005,群益證,8,0,8,華南永昌-民權,2023-08-18,9312
2887,台新金,15,8,7,華南永昌-民權,2023-08-18,9312
2382,廣達,36,29,7,華南永昌-民權,2023-08-18,9312
2374,佳能,6,0,6,華南永昌-民權,2023-08-18,9312
2915,潤泰全,6,0,6,華南永昌-民權,2023-08-18,9312
6176,瑞儀,6,0,6,華南永昌-民權,2023-08-18,9312
9904,寶成,6,0,6,華南永昌-民權,2023-08-18,9312
9927,泰銘,6,0,6,華南永昌-民權,2023-08-18,9312
1609,大亞,5,0,5,華南永昌-民權,2023-08-18,9312
00773B,中信優先金融債,5,0,5,華南永昌-民權,2023-08-18,9312
1907,永豐餘,5,0,5,華南永昌-民權,2023-08-18,9312
2308,台達電,6,1,5,華南永昌-民權,2023-08-18,9312
2344,華邦電,17,12,5,華南永昌-民權,2023-08-18,9312
2495,普安,5,0,5,華南永昌-民權,2023-08-18,9312
3362,先進光,16,11,5,華南永昌-民權,2023-08-18,9312
4906,正文,821,317,504,華南永昌-民權,2023-08-21,9312
1513,中興電,71,17,54,華南永昌-民權,2023-08-21,9312
00929,復華台灣科技優息,42,6,36,華南永昌-民權,2023-08-21,9312
6187,萬潤,32,0,32,華南永昌-民權,2023-08-21,9312
3706,神達,40,12,28,華南永昌-民權,2023-08-21,9312
2605,新興,28,0,28,華南永昌-民權,2023-08-21,9312
3042,晶技,22,0,22,華南永昌-民權,2023-08-21,9312
00673R,期元大S＆P原油反1,20,0,20,華南永昌-民權,2023-08-21,9312
3324,雙鴻,15,0,15,華南永昌-民權,2023-08-21,9312
00885,富邦越南,16,1,15,華南永昌-民權,2023-08-21,9312
2354,鴻準,15,0,15,華南永昌-民權,2023-08-21,9312
2882,國泰金,20,6,14,華南永昌-民權,2023-08-21,9312
3483,力致,45,33,12,華南永昌-民權,2023-08-21,9312
6188,廣明,17,5,12,華南永昌-民權,2023-08-21,9312
5608,四維航,14,3,11,華南永昌-民權,2023-08-21,9312
1312,國喬,10,0,10,華南永昌-民權,2023-08-21,9312
2312,金寶,11,1,10,華南永昌-民權,2023-08-21,9312
2313,華通,10,0,10,華南永昌-民權,2023-08-21,9312
4439,冠星-KY,10,0,10,華南永昌-民權,2023-08-21,9312
2303,聯電,10,1,9,華南永昌-民權,2023-08-21,9312
2618,長榮航,35,26,9,華南永昌-民權,2023-08-21,9312
00878,國泰永續高股息,9,1,8,華南永昌-民權,2023-08-21,9312
2382,廣達,23,15,8,華南永昌-民權,2023-08-21,9312
2603,長榮,8,0,8,華南永昌-民權,2023-08-21,9312
1467,南緯,23,16,7,華南永昌-民權,2023-08-21,9312
6176,瑞儀,6,0,6,華南永昌-民權,2023-08-21,9312
00712,復華富時不動產,6,0,6,華南永昌-民權,2023-08-21,9312
3037,欣興,8,2,6,華南永昌-民權,2023-08-21,9312
6417,韋僑,10,4,6,華南永昌-民權,2023-08-21,9312
1905,華紙,5,0,5,華南永昌-民權,2023-08-21,9312
2014,中鴻,5,0,5,華南永昌-民權,2023-08-21,9312
2324,仁寶,5,0,5,華南永昌-民權,2023-08-21,9312
3306,鼎天,16,11,5,華南永昌-民權,2023-08-21,9312
3622,洋華,5,0,5,華南永昌-民權,2023-08-21,9312
5258,虹堡,5,0,5,華南永昌-民權,2023-08-21,9312
2338,光罩,4,0,4,華南永昌-民權,2023-08-21,9312
2344,華邦電,12,8,4,華南永昌-民權,2023-08-21,9312
2609,陽明,4,0,4,華南永昌-民權,2023-08-21,9312
3338,泰碩,4,0,4,華南永昌-民權,2023-08-21,9312
3583,辛耘,6,2,4,華南永昌-民權,2023-08-21,9312
4167,松瑞藥,5,1,4,華南永昌-民權,2023-08-21,9312
6672,騰輝電子-KY,5,1,4,華南永昌-民權,2023-08-21,9312
1605,華新,3,0,3,華南永昌-民權,2023-08-21,9312
1410,南染,3,0,3,華南永昌-民權,2023-08-21,9312
2301,光寶科,14,11,3,華南永昌-民權,2023-08-21,9312
2478,大毅,3,0,3,華南永昌-民權,2023-08-21,9312
2516,新建,3,0,3,華南永昌-民權,2023-08-21,9312
2880,華南金,3,0,3,華南永昌-民權,2023-08-21,9312
3051,力特,7,4,3,華南永昌-民權,2023-08-21,9312
3205,佰研,3,0,3,華南永昌-民權,2023-08-21,9312
1419,新紡,60,0,60,華南永昌-民權,2023-08-22,9312
1609,大亞,51,0,51,華南永昌-民權,2023-08-22,9312
2337,旺宏,54,4,50,華南永昌-民權,2023-08-22,9312
3483,力致,45,17,28,華南永昌-民權,2023-08-22,9312
2401,凌陽,54,31,23,華南永昌-民權,2023-08-22,9312
2402,毅嘉,23,0,23,華南永昌-民權,2023-08-22,9312
1312,國喬,21,0,21,華南永昌-民權,2023-08-22,9312
4927,泰鼎-KY,28,8,20,華南永昌-民權,2023-08-22,9312
2002,中鋼,18,0,18,華南永昌-民權,2023-08-22,9312
2324,仁寶,19,3,16,華南永昌-民權,2023-08-22,9312
6235,華孚,18,5,13,華南永昌-民權,2023-08-22,9312
6548,長科*,12,0,12,華南永昌-民權,2023-08-22,9312
00633L,富邦上証正2,26,15,11,華南永昌-民權,2023-08-22,9312
6191,精成科,11,0,11,華南永昌-民權,2023-08-22,9312
2460,建通,11,1,10,華南永昌-民權,2023-08-22,9312
3081,聯亞,11,1,10,華南永昌-民權,2023-08-22,9312
4532,瑞智,10,0,10,華南永昌-民權,2023-08-22,9312
3004,豐達科,9,0,9,華南永昌-民權,2023-08-22,9312
3042,晶技,20,12,8,華南永昌-民權,2023-08-22,9312
2421,建準,17,9,8,華南永昌-民權,2023-08-22,9312
1504,東元,8,1,7,華南永昌-民權,2023-08-22,9312
2887,台新金,7,0,7,華南永昌-民權,2023-08-22,9312
3308,聯德,7,0,7,華南永昌-民權,2023-08-22,9312
3363,上詮,7,0,7,華南永昌-民權,2023-08-22,9312
6116,彩晶,7,0,7,華南永昌-民權,2023-08-22,9312
2014,中鴻,6,0,6,華南永昌-民權,2023-08-22,9312
1513,中興電,22,16,6,華南永昌-民權,2023-08-22,9312
2329,華泰,58,52,6,華南永昌-民權,2023-08-22,9312
2884,玉山金,11,5,6,華南永昌-民權,2023-08-22,9312
4979,華星光,32,26,6,華南永昌-民權,2023-08-22,9312
00753L,中信中國50正2,5,0,5,華南永昌-民權,2023-08-22,9312
2405,輔信,5,0,5,華南永昌-民權,2023-08-22,9312
2428,興勤,5,0,5,華南永昌-民權,2023-08-22,9312
2453,凌群,5,0,5,華南永昌-民權,2023-08-22,9312
3051,力特,5,0,5,華南永昌-民權,2023-08-22,9312
3491,昇達科,5,0,5,華南永昌-民權,2023-08-22,9312
5351,鈺創,5,0,5,華南永昌-民權,2023-08-22,9312
6005,群益證,5,0,5,華南永昌-民權,2023-08-22,9312
3324,雙鴻,5,0,5,華南永昌-民權,2023-08-22,9312
2449,京元電子,15,10,5,華南永昌-民權,2023-08-22,9312
2637,慧洋-KY,4,0,4,華南永昌-民權,2023-08-22,9312
1795,美時,4,0,4,華南永昌-民權,2023-08-22,9312
2303,聯電,4,0,4,華南永昌-民權,2023-08-22,9312
3078,僑威,5,1,4,華南永昌-民權,2023-08-22,9312
3094,聯傑,4,0,4,華南永昌-民權,2023-08-22,9312
5222,全訊,5,1,4,華南永昌-民權,2023-08-22,9312
6167,久正,4,0,4,華南永昌-民權,2023-08-22,9312
2332,友訊,13,10,3,華南永昌-民權,2023-08-22,9312
2368,金像電,7,4,3,華南永昌-民權,2023-08-22,9312
2883,凱基金,4,1,3,華南永昌-民權,2023-08-22,9312
1419,新紡,140,0,140,華南永昌-民權,2023-08-23,9312
00632R,元大台灣50反1,110,0,110,華南永昌-民權,2023-08-23,9312
5519,隆大,55,0,55,華南永昌-民權,2023-08-23,9312
2618,長榮航,128,75,53,華南永昌-民權,2023-08-23,9312
1513,中興電,59,8,51,華南永昌-民權,2023-08-23,9312
00929,復華台灣科技優息,30,0,30,華南永昌-民權,2023-08-23,9312
3081,聯亞,30,0,30,華南永昌-民權,2023-08-23,9312
2355,敬鵬,31,1,30,華南永昌-民權,2023-08-23,9312
6672,騰輝電子-KY,30,1,29,華南永昌-民權,2023-08-23,9312
2323,中環,27,0,27,華南永昌-民權,2023-08-23,9312
2332,友訊,27,5,22,華南永昌-民權,2023-08-23,9312
4532,瑞智,20,0,20,華南永昌-民權,2023-08-23,9312
2103,台橡,18,0,18,華南永昌-民權,2023-08-23,9312
3652,精聯,17,0,17,華南永昌-民權,2023-08-23,9312
4927,泰鼎-KY,19,3,16,華南永昌-民權,2023-08-23,9312
2382,廣達,18,5,13,華南永昌-民權,2023-08-23,9312
00713,元大台灣高息低波,13,0,13,華南永昌-民權,2023-08-23,9312
1609,大亞,13,0,13,華南永昌-民權,2023-08-23,9312
3689,湧德,22,10,12,華南永昌-民權,2023-08-23,9312
3029,零壹,11,0,11,華南永昌-民權,2023-08-23,9312
6187,萬潤,13,2,11,華南永昌-民權,2023-08-23,9312
2002,中鋼,11,0,11,華南永昌-民權,2023-08-23,9312
9934,成霖,10,0,10,華南永昌-民權,2023-08-23,9312
2615,萬海,14,5,9,華南永昌-民權,2023-08-23,9312
6282,康舒,11,3,8,華南永昌-民權,2023-08-23,9312
2301,光寶科,25,18,7,華南永昌-民權,2023-08-23,9312
2888,新光金,7,0,7,華南永昌-民權,2023-08-23,9312
2887,台新金,18,12,6,華南永昌-民權,2023-08-23,9312
2617,台航,5,0,5,華南永昌-民權,2023-08-23,9312
00637L,元大滬深300正2,5,0,5,華南永昌-民權,2023-08-23,9312
6126,信音,5,0,5,華南永昌-民權,2023-08-23,9312
6188,廣明,9,4,5,華南永昌-民權,2023-08-23,9312
9103,美德醫療-DR,5,0,5,華南永昌-民權,2023-08-23,9312
2892,第一金,5,0,5,華南永昌-民權,2023-08-23,9312
3035,智原,23,19,4,華南永昌-民權,2023-08-23,9312
1467,南緯,4,0,4,華南永昌-民權,2023-08-23,9312
2324,仁寶,6,2,4,華南永昌-民權,2023-08-23,9312
2329,華泰,106,102,4,華南永昌-民權,2023-08-23,9312
2542,興富發,4,0,4,華南永昌-民權,2023-08-23,9312
3042,晶技,4,0,4,華南永昌-民權,2023-08-23,9312
6177,達麗,4,0,4,華南永昌-民權,2023-08-23,9312
8150,南茂,4,0,4,華南永昌-民權,2023-08-23,9312
2208,台船,5,1,4,華南永昌-民權,2023-08-23,9312
3583,辛耘,19,16,3,華南永昌-民權,2023-08-23,9312
3013,晟銘電,46,43,3,華南永昌-民權,2023-08-23,9312
2353,宏��,3,0,3,華南永昌-民權,2023-08-23,9312
2457,飛宏,3,0,3,華南永昌-民權,2023-08-23,9312
3380,明泰,3,0,3,華南永昌-民權,2023-08-23,9312
8426,紅木-KY,3,0,3,華南永昌-民權,2023-08-23,9312
2880,華南金,2,0,2,華南永昌-民權,2023-08-23,9312
6187,萬潤,225,64,161,華南永昌-民權,2023-08-24,9312
2337,旺宏,53,1,52,華南永昌-民權,2023-08-24,9312
3231,緯創,111,68,43,華南永昌-民權,2023-08-24,9312
5519,隆大,30,2,28,華南永昌-民權,2023-08-24,9312
2323,中環,21,0,21,華南永昌-民權,2023-08-24,9312
4906,正文,29,10,19,華南永昌-民權,2023-08-24,9312
00632R,元大台灣50反1,20,5,15,華南永昌-民權,2023-08-24,9312
3702,大聯大,15,0,15,華南永昌-民權,2023-08-24,9312
4533,協易機,14,1,13,華南永昌-民權,2023-08-24,9312
2609,陽明,12,0,12,華南永昌-民權,2023-08-24,9312
2002,中鋼,12,0,12,華南永昌-民權,2023-08-24,9312
1467,南緯,12,0,12,華南永昌-民權,2023-08-24,9312
2409,友達,12,0,12,華南永昌-民權,2023-08-24,9312
00882,中信中國高股息,11,0,11,華南永昌-民權,2023-08-24,9312
1609,大亞,15,4,11,華南永昌-民權,2023-08-24,9312
2419,仲琦,18,7,11,華南永昌-民權,2023-08-24,9312
2618,長榮航,11,0,11,華南永昌-民權,2023-08-24,9312
2363,矽統,229,218,11,華南永昌-民權,2023-08-24,9312
2374,佳能,11,1,10,華南永昌-民權,2023-08-24,9312
2401,凌陽,20,10,10,華南永昌-民權,2023-08-24,9312
2886,兆豐金,10,1,9,華南永昌-民權,2023-08-24,9312
3363,上詮,12,3,9,華南永昌-民權,2023-08-24,9312
1519,華城,9,1,8,華南永昌-民權,2023-08-24,9312
2324,仁寶,18,10,8,華南永昌-民權,2023-08-24,9312
2352,佳世達,7,0,7,華南永昌-民權,2023-08-24,9312
2615,萬海,7,0,7,華南永昌-民權,2023-08-24,9312
2884,玉山金,9,2,7,華南永昌-民權,2023-08-24,9312
4581,光隆精密-KY,6,0,6,華南永昌-民權,2023-08-24,9312
9943,好樂迪,6,0,6,華南永昌-民權,2023-08-24,9312
00919,群益台灣精選高息,9,3,6,華南永昌-民權,2023-08-24,9312
1419,新紡,5,0,5,華南永昌-民權,2023-08-24,9312
00637L,元大滬深300正2,10,5,5,華南永昌-民權,2023-08-24,9312
2340,台亞,5,0,5,華南永昌-民權,2023-08-24,9312
2883,凱基金,5,0,5,華南永昌-民權,2023-08-24,9312
3033,威健,5,0,5,華南永昌-民權,2023-08-24,9312
3308,聯德,9,4,5,華南永昌-民權,2023-08-24,9312
3583,辛耘,70,65,5,華南永昌-民權,2023-08-24,9312
6245,立端,5,0,5,華南永昌-民權,2023-08-24,9312
8050,廣積,10,5,5,華南永昌-民權,2023-08-24,9312
2880,華南金,5,0,5,華南永昌-民權,2023-08-24,9312
2312,金寶,4,0,4,華南永昌-民權,2023-08-24,9312
2388,威盛,5,1,4,華南永昌-民權,2023-08-24,9312
2607,榮運,4,0,4,華南永昌-民權,2023-08-24,9312
3078,僑威,5,1,4,華南永昌-民權,2023-08-24,9312
6167,久正,4,0,4,華南永昌-民權,2023-08-24,9312
6799,來頡,4,0,4,華南永昌-民權,2023-08-24,9312
6285,啟��,7,3,4,華南永昌-民權,2023-08-24,9312
2356,英業達,46,43,3,華南永昌-民權,2023-08-24,9312
00931B,統一美債20年,3,0,3,華南永昌-民權,2023-08-24,9312
1109,信大,3,0,3,華南永昌-民權,2023-08-24,9312
3231,緯創,129,24,105,華南永昌-民權,2023-08-25,9312
00878,國泰永續高股息,90,3,87,華南永昌-民權,2023-08-25,9312
6108,競國,50,0,50,華南永昌-民權,2023-08-25,9312
2468,華經,31,0,31,華南永昌-民權,2023-08-25,9312
5519,隆大,20,0,20,華南永昌-民權,2023-08-25,9312
4532,瑞智,20,1,19,華南永昌-民權,2023-08-25,9312
2382,廣達,29,11,18,華南永昌-民權,2023-08-25,9312
2363,矽統,53,37,16,華南永昌-民權,2023-08-25,9312
00632R,元大台灣50反1,20,5,15,華南永昌-民權,2023-08-25,9312
2356,英業達,16,1,15,華南永昌-民權,2023-08-25,9312
2002,中鋼,14,0,14,華南永昌-民權,2023-08-25,9312
6177,達麗,14,0,14,華南永昌-民權,2023-08-25,9312
2324,仁寶,18,5,13,華南永昌-民權,2023-08-25,9312
2353,宏��,13,2,11,華南永昌-民權,2023-08-25,9312
2634,漢翔,22,11,11,華南永昌-民權,2023-08-25,9312
9934,成霖,13,2,11,華南永昌-民權,2023-08-25,9312
00923,群益台ESG低碳50,10,0,10,華南永昌-民權,2023-08-25,9312
2618,長榮航,75,65,10,華南永昌-民權,2023-08-25,9312
3305,昇貿,10,0,10,華南永昌-民權,2023-08-25,9312
3682,亞太電,10,0,10,華南永昌-民權,2023-08-25,9312
3689,湧德,10,0,10,華南永昌-民權,2023-08-25,9312
8087,麗升能源,10,0,10,華南永昌-民權,2023-08-25,9312
6672,騰輝電子-KY,9,0,9,華南永昌-民權,2023-08-25,9312
00929,復華台灣科技優息,8,0,8,華南永昌-民權,2023-08-25,9312
2880,華南金,8,0,8,華南永昌-民權,2023-08-25,9312
3363,上詮,8,0,8,華南永昌-民權,2023-08-25,9312
0056,元大高股息,9,1,8,華南永昌-民權,2023-08-25,9312
3037,欣興,8,1,7,華南永昌-民權,2023-08-25,9312
2317,鴻海,9,2,7,華南永昌-民權,2023-08-25,9312
5347,世界,7,0,7,華南永昌-民權,2023-08-25,9312
2355,敬鵬,15,8,7,華南永昌-民權,2023-08-25,9312
2485,兆赫,14,7,7,華南永昌-民權,2023-08-25,9312
6187,萬潤,9,2,7,華南永昌-民權,2023-08-25,9312
6282,康舒,7,0,7,華南永昌-民權,2023-08-25,9312
00919,群益台灣精選高息,8,2,6,華南永昌-民權,2023-08-25,9312
2731,雄獅,16,10,6,華南永昌-民權,2023-08-25,9312
2301,光寶科,10,5,5,華南永昌-民權,2023-08-25,9312
1584,精剛,10,5,5,華南永昌-民權,2023-08-25,9312
2105,正新,5,0,5,華南永昌-民權,2023-08-25,9312
3081,聯亞,5,0,5,華南永昌-民權,2023-08-25,9312
3149,正達,5,0,5,華南永昌-民權,2023-08-25,9312
3711,日月光投控,6,1,5,華南永昌-民權,2023-08-25,9312
4167,松瑞藥,5,0,5,華南永昌-民權,2023-08-25,9312
4188,安克,5,0,5,華南永昌-民權,2023-08-25,9312
6290,良維,5,0,5,華南永昌-民權,2023-08-25,9312
8046,南電,5,0,5,華南永昌-民權,2023-08-25,9312
1303,南亞,4,0,4,華南永昌-民權,2023-08-25,9312
2329,華泰,5,1,4,華南永昌-民權,2023-08-25,9312
3704,合勤控,5,1,4,華南永昌-民權,2023-08-25,9312
2891,中信金,3,0,3,華南永昌-民權,2023-08-25,9312
00929,復華台灣科技優息,109,1,108,華南永昌-民權,2023-08-28,9312
3035,智原,54,3,51,華南永昌-民權,2023-08-28,9312
2618,長榮航,423,397,26,華南永昌-民權,2023-08-28,9312
4908,前鼎,24,4,20,華南永昌-民權,2023-08-28,9312
2610,華航,23,5,18,華南永昌-民權,2023-08-28,9312
2324,仁寶,20,3,17,華南永昌-民權,2023-08-28,9312
2460,建通,20,3,17,華南永昌-民權,2023-08-28,9312
6187,萬潤,16,0,16,華南永昌-民權,2023-08-28,9312
00878,國泰永續高股息,20,4,16,華南永昌-民權,2023-08-28,9312
2388,威盛,29,14,15,華南永昌-民權,2023-08-28,9312
4927,泰鼎-KY,16,1,15,華南永昌-民權,2023-08-28,9312
2303,聯電,23,10,13,華南永昌-民權,2023-08-28,9312
2409,友達,13,1,12,華南永昌-民權,2023-08-28,9312
1609,大亞,12,1,11,華南永昌-民權,2023-08-28,9312
2401,凌陽,14,4,10,華南永昌-民權,2023-08-28,9312
3081,聯亞,10,0,10,華南永昌-民權,2023-08-28,9312
3652,精聯,10,0,10,華南永昌-民權,2023-08-28,9312
1513,中興電,11,3,8,華南永昌-民權,2023-08-28,9312
3308,聯德,15,7,8,華南永昌-民權,2023-08-28,9312
3481,群創,17,9,8,華南永昌-民權,2023-08-28,9312
2748,雲品,9,2,7,華南永昌-民權,2023-08-28,9312
0050,元大台灣50,15,8,7,華南永昌-民權,2023-08-28,9312
2331,精英,55,49,6,華南永昌-民權,2023-08-28,9312
2743,山富,9,3,6,華南永昌-民權,2023-08-28,9312
3078,僑威,7,1,6,華南永昌-民權,2023-08-28,9312
3037,欣興,7,1,6,華南永昌-民權,2023-08-28,9312
2301,光寶科,13,8,5,華南永昌-民權,2023-08-28,9312
6282,康舒,5,0,5,華南永昌-民權,2023-08-28,9312
1558,伸興,5,0,5,華南永昌-民權,2023-08-28,9312
1809,中釉,5,0,5,華南永昌-民權,2023-08-28,9312
2105,正新,5,0,5,華南永昌-民權,2023-08-28,9312
2354,鴻準,5,0,5,華南永昌-民權,2023-08-28,9312
2405,輔信,5,0,5,華南永昌-民權,2023-08-28,9312
2478,大毅,5,0,5,華南永昌-民權,2023-08-28,9312
3051,力特,7,2,5,華南永昌-民權,2023-08-28,9312
3622,洋華,10,5,5,華南永昌-民權,2023-08-28,9312
3714,富采,5,0,5,華南永昌-民權,2023-08-28,9312
4154,樂威科-KY,5,0,5,華南永昌-民權,2023-08-28,9312
6120,達運,5,0,5,華南永昌-民權,2023-08-28,9312
6505,台塑化,5,0,5,華南永昌-民權,2023-08-28,9312
2382,廣達,17,12,5,華南永昌-民權,2023-08-28,9312
2606,裕民,4,0,4,華南永昌-民權,2023-08-28,9312
4909,新復興,4,0,4,華南永昌-民權,2023-08-28,9312
6672,騰輝電子-KY,5,1,4,華南永昌-民權,2023-08-28,9312
1101,台泥,6,2,4,華南永昌-民權,2023-08-28,9312
2317,鴻海,8,5,3,華南永昌-民權,2023-08-28,9312
2880,華南金,4,1,3,華南永昌-民權,2023-08-28,9312
3665,貿聯-KY,7,4,3,華南永昌-民權,2023-08-28,9312
4763,材料-KY,5,2,3,華南永昌-民權,2023-08-28,9312
00882,中信中國高股息,3,0,3,華南永昌-民權,2023-08-28,9312
3035,智原,42,0,42,華南永昌-民權,2023-08-29,9312
5519,隆大,25,0,25,華南永昌-民權,2023-08-29,9312
2329,華泰,49,26,23,華南永昌-民權,2023-08-29,9312
2027,大成鋼,21,0,21,華南永昌-民權,2023-08-29,9312
1905,華紙,15,0,15,華南永昌-民權,2023-08-29,9312
3308,聯德,15,0,15,華南永昌-民權,2023-08-29,9312
3231,緯創,24,11,13,華南永昌-民權,2023-08-29,9312
2303,聯電,28,16,12,華南永昌-民權,2023-08-29,9312
2634,漢翔,18,6,12,華南永昌-民權,2023-08-29,9312
2614,東森,11,0,11,華南永昌-民權,2023-08-29,9312
8112,至上,14,3,11,華南永昌-民權,2023-08-29,9312
1504,東元,10,0,10,華南永昌-民權,2023-08-29,9312
2014,中鴻,10,0,10,華南永昌-民權,2023-08-29,9312
4944,兆遠,10,0,10,華南永昌-民權,2023-08-29,9312
2312,金寶,11,2,9,華南永昌-民權,2023-08-29,9312
2880,華南金,9,0,9,華南永昌-民權,2023-08-29,9312
2891,中信金,8,0,8,華南永昌-民權,2023-08-29,9312
2002,中鋼,9,1,8,華南永昌-民權,2023-08-29,9312
2485,兆赫,8,0,8,華南永昌-民權,2023-08-29,9312
00878,國泰永續高股息,9,2,7,華南永昌-民權,2023-08-29,9312
3289,宜特,7,0,7,華南永昌-民權,2023-08-29,9312
5009,榮剛,8,1,7,華南永昌-民權,2023-08-29,9312
6443,元晶,7,0,7,華南永昌-民權,2023-08-29,9312
2363,矽統,150,144,6,華南永昌-民權,2023-08-29,9312
3652,精聯,6,0,6,華南永昌-民權,2023-08-29,9312
6187,萬潤,6,0,6,華南永昌-民權,2023-08-29,9312
8210,勤誠,6,0,6,華南永昌-民權,2023-08-29,9312
8222,寶一,10,4,6,華南永昌-民權,2023-08-29,9312
6168,宏齊,5,0,5,華南永昌-民權,2023-08-29,9312
5880,合庫金,5,0,5,華南永昌-民權,2023-08-29,9312
2374,佳能,5,0,5,華南永昌-民權,2023-08-29,9312
2399,映泰,8,3,5,華南永昌-民權,2023-08-29,9312
00632R,元大台灣50反1,4,0,4,華南永昌-民權,2023-08-29,9312
2425,承啟,4,0,4,華南永昌-民權,2023-08-29,9312
2457,飛宏,4,0,4,華南永昌-民權,2023-08-29,9312
2484,希華,4,0,4,華南永昌-民權,2023-08-29,9312
3004,豐達科,5,1,4,華南永昌-民權,2023-08-29,9312
8358,金居,7,3,4,華南永昌-民權,2023-08-29,9312
8996,高力,4,0,4,華南永昌-民權,2023-08-29,9312
9917,中保科,4,0,4,華南永昌-民權,2023-08-29,9312
2317,鴻海,14,11,3,華南永昌-民權,2023-08-29,9312
00893,國泰智能電動車,10,7,3,華南永昌-民權,2023-08-29,9312
1802,台玻,3,0,3,華南永昌-民權,2023-08-29,9312
2301,光寶科,5,2,3,華南永昌-民權,2023-08-29,9312
2401,凌陽,5,2,3,華南永昌-民權,2023-08-29,9312
2442,新美齊,3,0,3,華南永昌-民權,2023-08-29,9312
2882,國泰金,3,0,3,華南永昌-民權,2023-08-29,9312
2913,農林,3,0,3,華南永昌-民權,2023-08-29,9312
3094,聯傑,3,0,3,華南永昌-民權,2023-08-29,9312
4541,晟田,14,11,3,華南永昌-民權,2023-08-29,9312
4532,瑞智,160,0,160,華南永昌-民權,2023-08-30,9312
00929,復華台灣科技優息,36,1,35,華南永昌-民權,2023-08-30,9312
5876,上海商銀,30,0,30,華南永昌-民權,2023-08-30,9312
00713,元大台灣高息低波,30,0,30,華南永昌-民權,2023-08-30,9312
2618,長榮航,577,553,24,華南永昌-民權,2023-08-30,9312
3035,智原,38,14,24,華南永昌-民權,2023-08-30,9312
2882,國泰金,20,0,20,華南永昌-民權,2023-08-30,9312
1609,大亞,15,1,14,華南永昌-民權,2023-08-30,9312
3443,創意,16,2,14,華南永昌-民權,2023-08-30,9312
2301,光寶科,15,4,11,華南永昌-民權,2023-08-30,9312
2332,友訊,11,0,11,華南永昌-民權,2023-08-30,9312
4967,十銓,21,10,11,華南永昌-民權,2023-08-30,9312
2399,映泰,11,1,10,華南永昌-民權,2023-08-30,9312
00706L,期元大S＆P日圓正2,10,0,10,華南永昌-民權,2023-08-30,9312
2609,陽明,14,4,10,華南永昌-民權,2023-08-30,9312
5519,隆大,10,0,10,華南永昌-民權,2023-08-30,9312
3706,神達,12,4,8,華南永昌-民權,2023-08-30,9312
8069,元太,10,2,8,華南永昌-民權,2023-08-30,9312
6282,康舒,8,1,7,華南永昌-民權,2023-08-30,9312
1467,南緯,8,2,6,華南永昌-民權,2023-08-30,9312
2105,正新,6,0,6,華南永昌-民權,2023-08-30,9312
2356,英業達,22,16,6,華南永昌-民權,2023-08-30,9312
3051,力特,21,15,6,華南永昌-民權,2023-08-30,9312
5009,榮剛,6,0,6,華南永昌-民權,2023-08-30,9312
1419,新紡,5,0,5,華南永昌-民權,2023-08-30,9312
00633L,富邦上証正2,5,0,5,華南永昌-民權,2023-08-30,9312
1101,台泥,5,0,5,華南永昌-民權,2023-08-30,9312
00931B,統一美債20年,5,0,5,華南永昌-民權,2023-08-30,9312
1799,易威,5,0,5,華南永昌-民權,2023-08-30,9312
2367,燿華,5,0,5,華南永昌-民權,2023-08-30,9312
2405,輔信,5,0,5,華南永昌-民權,2023-08-30,9312
3221,台嘉碩,5,0,5,華南永昌-民權,2023-08-30,9312
4167,松瑞藥,5,0,5,華南永昌-民權,2023-08-30,9312
6443,元晶,5,0,5,華南永昌-民權,2023-08-30,9312
2449,京元電子,4,0,4,華南永昌-民權,2023-08-30,9312
2324,仁寶,4,0,4,華南永昌-民權,2023-08-30,9312
6176,瑞儀,5,1,4,華南永昌-民權,2023-08-30,9312
6585,鼎基,4,0,4,華南永昌-民權,2023-08-30,9312
6799,來頡,4,0,4,華南永昌-民權,2023-08-30,9312
8210,勤誠,8,4,4,華南永昌-民權,2023-08-30,9312
2834,臺企銀,3,0,3,華南永昌-民權,2023-08-30,9312
3231,緯創,23,20,3,華南永昌-民權,2023-08-30,9312
2610,華航,8,5,3,華南永昌-民權,2023-08-30,9312
00900,富邦特選高股息30,3,0,3,華南永昌-民權,2023-08-30,9312
1795,美時,3,0,3,華南永昌-民權,2023-08-30,9312
3163,波若威,6,3,3,華南永昌-民權,2023-08-30,9312
8112,至上,4,1,3,華南永昌-民權,2023-08-30,9312
2883,凱基金,3,0,3,華南永昌-民權,2023-08-30,9312
3481,群創,14,12,2,華南永昌-民權,2023-08-30,9312
3483,力致,2,0,2,華南永昌-民權,2023-08-30,9312
2101,南港,100,0,100,華南永昌-民權,2023-08-31,9312
4532,瑞智,90,0,90,華南永昌-民權,2023-08-31,9312
2337,旺宏,85,37,48,華南永昌-民權,2023-08-31,9312
2323,中環,36,4,32,華南永昌-民權,2023-08-31,9312
2884,玉山金,26,0,26,華南永昌-民權,2023-08-31,9312
2436,偉詮電,50,29,21,華南永昌-民權,2023-08-31,9312
5876,上海商銀,20,0,20,華南永昌-民權,2023-08-31,9312
2882,國泰金,20,0,20,華南永昌-民權,2023-08-31,9312
2324,仁寶,20,2,18,華南永昌-民權,2023-08-31,9312
2610,華航,18,0,18,華南永昌-民權,2023-08-31,9312
5519,隆大,15,0,15,華南永昌-民權,2023-08-31,9312
2355,敬鵬,16,2,14,華南永昌-民權,2023-08-31,9312
5907,大洋-KY,13,0,13,華南永昌-民權,2023-08-31,9312
00680L,元大美債20正2,12,0,12,華南永昌-民權,2023-08-31,9312
00878,國泰永續高股息,11,0,11,華南永昌-民權,2023-08-31,9312
2330,台積電,12,2,10,華南永昌-民權,2023-08-31,9312
1101,台泥,10,0,10,華南永昌-民權,2023-08-31,9312
1536,和大,10,0,10,華南永昌-民權,2023-08-31,9312
2105,正新,10,0,10,華南永昌-民權,2023-08-31,9312
3324,雙鴻,10,0,10,華南永昌-民權,2023-08-31,9312
1409,新纖,10,1,9,華南永昌-民權,2023-08-31,9312
2634,漢翔,18,9,9,華南永昌-民權,2023-08-31,9312
1303,南亞,7,0,7,華南永昌-民權,2023-08-31,9312
00919,群益台灣精選高息,7,0,7,華南永昌-民權,2023-08-31,9312
3481,群創,7,0,7,華南永昌-民權,2023-08-31,9312
2880,華南金,6,0,6,華南永昌-民權,2023-08-31,9312
1905,華紙,6,0,6,華南永昌-民權,2023-08-31,9312
2367,燿華,7,1,6,華南永昌-民權,2023-08-31,9312
3228,金麗科,7,1,6,華南永昌-民權,2023-08-31,9312
3443,創意,8,2,6,華南永昌-民權,2023-08-31,9312
3680,家登,6,0,6,華南永昌-民權,2023-08-31,9312
3706,神達,12,6,6,華南永昌-民權,2023-08-31,9312
4906,正文,6,0,6,華南永昌-民權,2023-08-31,9312
6417,韋僑,6,0,6,華南永昌-民權,2023-08-31,9312
6841,長佳智能,7,1,6,華南永昌-民權,2023-08-31,9312
3037,欣興,9,3,6,華南永昌-民權,2023-08-31,9312
2449,京元電子,17,12,5,華南永昌-民權,2023-08-31,9312
1584,精剛,5,0,5,華南永昌-民權,2023-08-31,9312
2834,臺企銀,5,0,5,華南永昌-民權,2023-08-31,9312
3682,亞太電,5,0,5,華南永昌-民權,2023-08-31,9312
4760,勤凱,5,0,5,華南永昌-民權,2023-08-31,9312
4933,友輝,5,0,5,華南永昌-民權,2023-08-31,9312
6126,信音,21,16,5,華南永昌-民權,2023-08-31,9312
6168,宏齊,7,2,5,華南永昌-民權,2023-08-31,9312
6187,萬潤,7,2,5,華南永昌-民權,2023-08-31,9312
8908,欣雄,5,0,5,華南永昌-民權,2023-08-31,9312
9934,成霖,5,0,5,華南永昌-民權,2023-08-31,9312
2303,聯電,4,0,4,華南永昌-民權,2023-08-31,9312
3011,今皓,7,3,4,華南永昌-民權,2023-08-31,9312
4979,華星光,4,0,4,華南永昌-民權,2023-08-31,9312
2101,南港,100,0,100,華南永昌-民權,2023-09-01,9312
6187,萬潤,57,2,55,華南永昌-民權,2023-09-01,9312
3035,智原,36,3,33,華南永昌-民權,2023-09-01,9312
2329,華泰,41,9,32,華南永昌-民權,2023-09-01,9312
1799,易威,30,0,30,華南永昌-民權,2023-09-01,9312
00929,復華台灣科技優息,30,1,29,華南永昌-民權,2023-09-01,9312
2201,裕隆,30,6,24,華南永昌-民權,2023-09-01,9312
3037,欣興,25,2,23,華南永昌-民權,2023-09-01,9312
3231,緯創,43,20,23,華南永昌-民權,2023-09-01,9312
00919,群益台灣精選高息,19,0,19,華南永昌-民權,2023-09-01,9312
3706,神達,23,5,18,華南永昌-民權,2023-09-01,9312
2634,漢翔,21,4,17,華南永昌-民權,2023-09-01,9312
6213,聯茂,20,4,16,華南永昌-民權,2023-09-01,9312
6282,康舒,15,0,15,華南永昌-民權,2023-09-01,9312
2301,光寶科,19,5,14,華南永昌-民權,2023-09-01,9312
3363,上詮,14,1,13,華南永昌-民權,2023-09-01,9312
2376,技嘉,26,14,12,華南永昌-民權,2023-09-01,9312
00900,富邦特選高股息30,11,0,11,華南永昌-民權,2023-09-01,9312
2363,矽統,91,80,11,華南永昌-民權,2023-09-01,9312
1419,新紡,10,0,10,華南永昌-民權,2023-09-01,9312
1519,華城,10,0,10,華南永昌-民權,2023-09-01,9312
5519,隆大,10,0,10,華南永昌-民權,2023-09-01,9312
8210,勤誠,14,4,10,華南永昌-民權,2023-09-01,9312
1471,首利,9,0,9,華南永昌-民權,2023-09-01,9312
2027,大成鋼,9,0,9,華南永昌-民權,2023-09-01,9312
2457,飛宏,9,0,9,華南永昌-民權,2023-09-01,9312
1905,華紙,10,1,9,華南永昌-民權,2023-09-01,9312
2382,廣達,16,7,9,華南永昌-民權,2023-09-01,9312
5469,瀚宇博,8,0,8,華南永昌-民權,2023-09-01,9312
2419,仲琦,8,1,7,華南永昌-民權,2023-09-01,9312
5328,華容,9,2,7,華南永昌-民權,2023-09-01,9312
2603,長榮,10,4,6,華南永昌-民權,2023-09-01,9312
1109,信大,6,0,6,華南永昌-民權,2023-09-01,9312
2355,敬鵬,6,0,6,華南永昌-民權,2023-09-01,9312
5907,大洋-KY,6,0,6,華南永昌-民權,2023-09-01,9312
1410,南染,5,0,5,華南永昌-民權,2023-09-01,9312
2105,正新,8,3,5,華南永昌-民權,2023-09-01,9312
2352,佳世達,5,0,5,華南永昌-民權,2023-09-01,9312
2374,佳能,5,0,5,華南永昌-民權,2023-09-01,9312
2405,輔信,5,0,5,華南永昌-民權,2023-09-01,9312
2485,兆赫,218,213,5,華南永昌-民權,2023-09-01,9312
2630,亞航,5,0,5,華南永昌-民權,2023-09-01,9312
3051,力特,8,3,5,華南永昌-民權,2023-09-01,9312
3443,創意,6,1,5,華南永昌-民權,2023-09-01,9312
8390,金益鼎,5,0,5,華南永昌-民權,2023-09-01,9312
6547,高端疫苗,13,9,4,華南永昌-民權,2023-09-01,9312
00878,國泰永續高股息,11,7,4,華南永昌-民權,2023-09-01,9312
1513,中興電,144,140,4,華南永昌-民權,2023-09-01,9312
00850,元大臺灣ESG永續,4,0,4,華南永昌-民權,2023-09-01,9312
1528,恩德,4,0,4,華南永昌-民權,2023-09-01,9312
2101,南港,100,0,100,華南永昌-民權,2023-09-04,9312
00929,復華台灣科技優息,48,3,45,華南永昌-民權,2023-09-04,9312
1802,台玻,35,6,29,華南永昌-民權,2023-09-04,9312
00878,國泰永續高股息,23,1,22,華南永昌-民權,2023-09-04,9312
2312,金寶,23,2,21,華南永昌-民權,2023-09-04,9312
2460,建通,19,0,19,華南永昌-民權,2023-09-04,9312
2329,華泰,31,13,18,華南永昌-民權,2023-09-04,9312
2880,華南金,20,4,16,華南永昌-民權,2023-09-04,9312
00931B,統一美債20年,14,0,14,華南永昌-民權,2023-09-04,9312
6213,聯茂,14,0,14,華南永昌-民權,2023-09-04,9312
2537,聯上發,12,0,12,華南永昌-民權,2023-09-04,9312
2323,中環,15,3,12,華南永昌-民權,2023-09-04,9312
1522,堤維西,11,0,11,華南永昌-民權,2023-09-04,9312
00915,凱基優選高股息30,11,1,10,華南永昌-民權,2023-09-04,9312
1445,大宇,10,0,10,華南永昌-民權,2023-09-04,9312
1524,耿鼎,20,10,10,華南永昌-民權,2023-09-04,9312
2363,矽統,332,322,10,華南永昌-民權,2023-09-04,9312
2374,佳能,10,0,10,華南永昌-民權,2023-09-04,9312
4977,眾達-KY,10,0,10,華南永昌-民權,2023-09-04,9312
2618,長榮航,9,0,9,華南永昌-民權,2023-09-04,9312
3035,智原,12,3,9,華南永昌-民權,2023-09-04,9312
3481,群創,9,0,9,華南永昌-民權,2023-09-04,9312
2369,菱生,14,5,9,華南永昌-民權,2023-09-04,9312
4706,大恭,9,0,9,華南永昌-民權,2023-09-04,9312
5381,合正,13,5,8,華南永昌-民權,2023-09-04,9312
2634,漢翔,9,2,7,華南永昌-民權,2023-09-04,9312
00751B,元大AAA至A公司債,7,0,7,華南永昌-民權,2023-09-04,9312
3483,力致,7,0,7,華南永昌-民權,2023-09-04,9312
3652,精聯,7,0,7,華南永昌-民權,2023-09-04,9312
8069,元太,9,2,7,華南永昌-民權,2023-09-04,9312
2409,友達,6,0,6,華南永昌-民權,2023-09-04,9312
00919,群益台灣精選高息,7,1,6,華南永昌-民權,2023-09-04,9312
1101,台泥,6,0,6,華南永昌-民權,2023-09-04,9312
1618,合機,6,0,6,華南永昌-民權,2023-09-04,9312
3045,台灣大,6,0,6,華南永昌-民權,2023-09-04,9312
5289,宜鼎,6,0,6,華南永昌-民權,2023-09-04,9312
00882,中信中國高股息,5,0,5,華南永昌-民權,2023-09-04,9312
00706L,期元大S＆P日圓正2,5,0,5,華南永昌-民權,2023-09-04,9312
2399,映泰,5,0,5,華南永昌-民權,2023-09-04,9312
2504,國產,5,0,5,華南永昌-民權,2023-09-04,9312
2743,山富,5,0,5,華南永昌-民權,2023-09-04,9312
2382,廣達,9,5,4,華南永昌-民權,2023-09-04,9312
1513,中興電,27,23,4,華南永昌-民權,2023-09-04,9312
1815,富喬,5,1,4,華南永昌-民權,2023-09-04,9312
2340,台亞,6,2,4,華南永昌-民權,2023-09-04,9312
3588,通嘉,24,20,4,華南永昌-民權,2023-09-04,9312
3689,湧德,4,0,4,華南永昌-民權,2023-09-04,9312
4908,前鼎,4,0,4,華南永昌-民權,2023-09-04,9312
5009,榮剛,5,1,4,華南永昌-民權,2023-09-04,9312
2890,永豐金,3,0,3,華南永昌-民權,2023-09-04,9312
2101,南港,250,50,200,華南永昌-民權,2023-09-05,9312
00919,群益台灣精選高息,125,0,125,華南永昌-民權,2023-09-05,9312
2337,旺宏,101,4,97,華南永昌-民權,2023-09-05,9312
00929,復華台灣科技優息,57,1,56,華南永昌-民權,2023-09-05,9312
2323,中環,25,1,24,華南永昌-民權,2023-09-05,9312
00878,國泰永續高股息,22,0,22,華南永昌-民權,2023-09-05,9312
2630,亞航,21,0,21,華南永昌-民權,2023-09-05,9312
2354,鴻準,20,0,20,華南永昌-民權,2023-09-05,9312
2344,華邦電,18,2,16,華南永昌-民權,2023-09-05,9312
8358,金居,33,18,15,華南永昌-民權,2023-09-05,9312
1310,台苯,13,0,13,華南永昌-民權,2023-09-05,9312
2405,輔信,15,2,13,華南永昌-民權,2023-09-05,9312
3706,神達,27,14,13,華南永昌-民權,2023-09-05,9312
3035,智原,25,13,12,華南永昌-民權,2023-09-05,9312
3652,精聯,12,0,12,華南永昌-民權,2023-09-05,9312
1519,華城,16,5,11,華南永昌-民權,2023-09-05,9312
2388,威盛,11,0,11,華南永昌-民權,2023-09-05,9312
2363,矽統,336,326,10,華南永昌-民權,2023-09-05,9312
3481,群創,11,1,10,華南永昌-民權,2023-09-05,9312
00915,凱基優選高股息30,10,0,10,華南永昌-民權,2023-09-05,9312
1409,新纖,10,0,10,華南永昌-民權,2023-09-05,9312
6187,萬潤,10,0,10,華南永昌-民權,2023-09-05,9312
9934,成霖,15,5,10,華南永昌-民權,2023-09-05,9312
2881,富邦金,9,0,9,華南永昌-民權,2023-09-05,9312
1471,首利,9,0,9,華南永昌-民權,2023-09-05,9312
2485,兆赫,13,4,9,華南永昌-民權,2023-09-05,9312
3051,力特,33,24,9,華南永昌-民權,2023-09-05,9312
3483,力致,25,17,8,華南永昌-民權,2023-09-05,9312
2436,偉詮電,19,11,8,華南永昌-民權,2023-09-05,9312
2367,燿華,7,0,7,華南永昌-民權,2023-09-05,9312
3231,緯創,15,8,7,華南永昌-民權,2023-09-05,9312
00751B,元大AAA至A公司債,6,0,6,華南永昌-民權,2023-09-05,9312
3037,欣興,9,3,6,華南永昌-民權,2023-09-05,9312
6191,精成科,7,1,6,華南永昌-民權,2023-09-05,9312
0050,元大台灣50,5,0,5,華南永昌-民權,2023-09-05,9312
00637L,元大滬深300正2,5,0,5,華南永昌-民權,2023-09-05,9312
00720B,元大投資級公司債,5,0,5,華南永昌-民權,2023-09-05,9312
2891,中信金,5,0,5,華南永昌-民權,2023-09-05,9312
3257,虹冠電,9,4,5,華南永昌-民權,2023-09-05,9312
4915,致伸,10,5,5,華南永昌-民權,2023-09-05,9312
5381,合正,5,0,5,華南永昌-民權,2023-09-05,9312
6284,佳邦,5,0,5,華南永昌-民權,2023-09-05,9312
1568,倉佑,4,0,4,華南永昌-民權,2023-09-05,9312
2888,新光金,4,0,4,華南永昌-民權,2023-09-05,9312
6531,愛普*,5,1,4,華南永昌-民權,2023-09-05,9312
2330,台積電,3,0,3,華南永昌-民權,2023-09-05,9312
3163,波若威,5,2,3,華南永昌-民權,2023-09-05,9312
3205,佰研,3,0,3,華南永昌-民權,2023-09-05,9312
3680,家登,3,0,3,華南永昌-民權,2023-09-05,9312
4906,正文,3,0,3,華南永昌-民權,2023-09-05,9312
2409,友達,515,3,512,華南永昌-民權,2023-09-06,9312
00673R,期元大S＆P原油反1,240,0,240,華南永昌-民權,2023-09-06,9312
3264,欣銓,105,0,105,華南永昌-民權,2023-09-06,9312
2101,南港,100,0,100,華南永昌-民權,2023-09-06,9312
00929,復華台灣科技優息,71,33,38,華南永昌-民權,2023-09-06,9312
00919,群益台灣精選高息,35,0,35,華南永昌-民權,2023-09-06,9312
1109,信大,27,0,27,華南永昌-民權,2023-09-06,9312
2891,中信金,24,0,24,華南永昌-民權,2023-09-06,9312
2504,國產,22,0,22,華南永昌-民權,2023-09-06,9312
2377,微星,21,0,21,華南永昌-民權,2023-09-06,9312
00753L,中信中國50正2,20,0,20,華南永昌-民權,2023-09-06,9312
1409,新纖,20,0,20,華南永昌-民權,2023-09-06,9312
2324,仁寶,19,0,19,華南永昌-民權,2023-09-06,9312
8069,元太,21,2,19,華南永昌-民權,2023-09-06,9312
00878,國泰永續高股息,18,0,18,華南永昌-民權,2023-09-06,9312
5381,合正,37,19,18,華南永昌-民權,2023-09-06,9312
3163,波若威,25,9,16,華南永昌-民權,2023-09-06,9312
00915,凱基優選高股息30,16,0,16,華南永昌-民權,2023-09-06,9312
3481,群創,21,5,16,華南永昌-民權,2023-09-06,9312
1799,易威,15,0,15,華南永昌-民權,2023-09-06,9312
2363,矽統,487,472,15,華南永昌-民權,2023-09-06,9312
3483,力致,15,0,15,華南永昌-民權,2023-09-06,9312
00932,兆豐永續高息等權,15,1,14,華南永昌-民權,2023-09-06,9312
2402,毅嘉,19,5,14,華南永昌-民權,2023-09-06,9312
0056,元大高股息,15,4,11,華南永昌-民權,2023-09-06,9312
4927,泰鼎-KY,17,6,11,華南永昌-民權,2023-09-06,9312
1444,力麗,10,0,10,華南永昌-民權,2023-09-06,9312
1524,耿鼎,10,0,10,華南永昌-民權,2023-09-06,9312
3149,正達,10,0,10,華南永昌-民權,2023-09-06,9312
4712,福格創新,10,0,10,華南永昌-民權,2023-09-06,9312
2401,凌陽,13,4,9,華南永昌-民權,2023-09-06,9312
8358,金居,14,5,9,華南永昌-民權,2023-09-06,9312
2883,凱基金,10,2,8,華南永昌-民權,2023-09-06,9312
3078,僑威,8,0,8,華南永昌-民權,2023-09-06,9312
4968,立積,10,2,8,華南永昌-民權,2023-09-06,9312
5880,合庫金,8,0,8,華南永昌-民權,2023-09-06,9312
2201,裕隆,7,0,7,華南永昌-民權,2023-09-06,9312
2340,台亞,7,0,7,華南永昌-民權,2023-09-06,9312
2344,華邦電,13,6,7,華南永昌-民權,2023-09-06,9312
6164,華興,7,0,7,華南永昌-民權,2023-09-06,9312
2457,飛宏,8,2,6,華南永昌-民權,2023-09-06,9312
2440,太空梭,5,0,5,華南永昌-民權,2023-09-06,9312
1802,台玻,5,0,5,華南永昌-民權,2023-09-06,9312
00706L,期元大S＆P日圓正2,5,0,5,華南永昌-民權,2023-09-06,9312
2105,正新,5,0,5,華南永昌-民權,2023-09-06,9312
2834,臺企銀,5,0,5,華南永昌-民權,2023-09-06,9312
2886,兆豐金,5,0,5,華南永昌-民權,2023-09-06,9312
3221,台嘉碩,5,0,5,華南永昌-民權,2023-09-06,9312
3652,精聯,5,0,5,華南永昌-民權,2023-09-06,9312
6143,振曜,5,0,5,華南永昌-民權,2023-09-06,9312
2603,長榮,100,1,99,華南永昌-民權,2023-09-07,9312
2313,華通,100,12,88,華南永昌-民權,2023-09-07,9312
6187,萬潤,87,2,85,華南永昌-民權,2023-09-07,9312
00919,群益台灣精選高息,60,5,55,華南永昌-民權,2023-09-07,9312
2101,南港,50,0,50,華南永昌-民權,2023-09-07,9312
2371,大同,50,0,50,華南永昌-民權,2023-09-07,9312
00929,復華台灣科技優息,108,68,40,華南永昌-民權,2023-09-07,9312
2324,仁寶,29,1,28,華南永昌-民權,2023-09-07,9312
3693,營邦,30,4,26,華南永昌-民權,2023-09-07,9312
3481,群創,27,2,25,華南永昌-民權,2023-09-07,9312
2323,中環,25,0,25,華南永昌-民權,2023-09-07,9312
00915,凱基優選高股息30,21,0,21,華南永昌-民權,2023-09-07,9312
3652,精聯,20,0,20,華南永昌-民權,2023-09-07,9312
1513,中興電,52,33,19,華南永昌-民權,2023-09-07,9312
2801,彰銀,18,0,18,華南永昌-民權,2023-09-07,9312
00753L,中信中國50正2,15,0,15,華南永昌-民權,2023-09-07,9312
2377,微星,14,0,14,華南永昌-民權,2023-09-07,9312
6282,康舒,14,0,14,華南永昌-民權,2023-09-07,9312
2618,長榮航,13,0,13,華南永昌-民權,2023-09-07,9312
00918,大華優利高填息30,12,0,12,華南永昌-民權,2023-09-07,9312
2460,建通,39,27,12,華南永昌-民權,2023-09-07,9312
4906,正文,33,21,12,華南永昌-民權,2023-09-07,9312
8069,元太,11,0,11,華南永昌-民權,2023-09-07,9312
00923,群益台ESG低碳50,11,0,11,華南永昌-民權,2023-09-07,9312
00631L,元大台灣50正2,11,0,11,華南永昌-民權,2023-09-07,9312
2401,凌陽,13,2,11,華南永昌-民權,2023-09-07,9312
3704,合勤控,19,8,11,華南永昌-民權,2023-09-07,9312
00679B,元大美債20年,10,0,10,華南永昌-民權,2023-09-07,9312
2504,國產,10,0,10,華南永昌-民權,2023-09-07,9312
3037,欣興,11,1,10,華南永昌-民權,2023-09-07,9312
3680,家登,10,0,10,華南永昌-民權,2023-09-07,9312
6449,鈺邦,11,1,10,華南永昌-民權,2023-09-07,9312
8426,紅木-KY,10,0,10,華南永昌-民權,2023-09-07,9312
3231,緯創,12,3,9,華南永昌-民權,2023-09-07,9312
8112,至上,14,5,9,華南永昌-民權,2023-09-07,9312
2498,宏達電,10,1,9,華南永昌-民權,2023-09-07,9312
1802,台玻,13,5,8,華南永昌-民權,2023-09-07,9312
2356,英業達,8,0,8,華南永昌-民權,2023-09-07,9312
2358,廷鑫,10,2,8,華南永昌-民權,2023-09-07,9312
4908,前鼎,8,0,8,華南永昌-民權,2023-09-07,9312
6101,寬魚國際,8,0,8,華南永昌-民權,2023-09-07,9312
2002,中鋼,7,0,7,華南永昌-民權,2023-09-07,9312
2027,大成鋼,8,1,7,華南永昌-民權,2023-09-07,9312
2486,一詮,12,6,6,華南永昌-民權,2023-09-07,9312
4147,中裕,18,12,6,華南永昌-民權,2023-09-07,9312
00932,兆豐永續高息等權,7,2,5,華南永昌-民權,2023-09-07,9312
1799,易威,5,0,5,華南永昌-民權,2023-09-07,9312
2316,楠梓電,5,0,5,華南永昌-民權,2023-09-07,9312
2380,虹光,5,0,5,華南永昌-民權,2023-09-07,9312
2492,華新科,8,3,5,華南永昌-民權,2023-09-07,9312
00919,群益台灣精選高息,249,0,249,華南永昌-民權,2023-09-08,9312
00673R,期元大S＆P原油反1,201,0,201,華南永昌-民權,2023-09-08,9312
2409,友達,101,1,100,華南永昌-民權,2023-09-08,9312
2884,玉山金,104,6,98,華南永昌-民權,2023-09-08,9312
3014,聯陽,104,36,68,華南永昌-民權,2023-09-08,9312
2834,臺企銀,32,0,32,華南永昌-民權,2023-09-08,9312
3363,上詮,39,9,30,華南永昌-民權,2023-09-08,9312
2313,華通,34,5,29,華南永昌-民權,2023-09-08,9312
00918,大華優利高填息30,23,0,23,華南永昌-民權,2023-09-08,9312
00929,復華台灣科技優息,41,21,20,華南永昌-民權,2023-09-08,9312
2105,正新,50,30,20,華南永昌-民權,2023-09-08,9312
00631L,元大台灣50正2,19,0,19,華南永昌-民權,2023-09-08,9312
2915,潤泰全,16,0,16,華南永昌-民權,2023-09-08,9312
2002,中鋼,15,0,15,華南永昌-民權,2023-09-08,9312
4550,長佳,15,0,15,華南永昌-民權,2023-09-08,9312
2618,長榮航,13,0,13,華南永昌-民權,2023-09-08,9312
3711,日月光投控,12,0,12,華南永昌-民權,2023-09-08,9312
2382,廣達,14,2,12,華南永昌-民權,2023-09-08,9312
2330,台積電,11,0,11,華南永昌-民權,2023-09-08,9312
3231,緯創,16,5,11,華南永昌-民權,2023-09-08,9312
6191,精成科,14,3,11,華南永昌-民權,2023-09-08,9312
8069,元太,10,0,10,華南永昌-民權,2023-09-08,9312
00753L,中信中國50正2,10,0,10,華南永昌-民權,2023-09-08,9312
1618,合機,15,5,10,華南永昌-民權,2023-09-08,9312
2329,華泰,12,2,10,華南永昌-民權,2023-09-08,9312
2419,仲琦,11,1,10,華南永昌-民權,2023-09-08,9312
2453,凌群,10,0,10,華南永昌-民權,2023-09-08,9312
6175,立敦,10,0,10,華南永昌-民權,2023-09-08,9312
6548,長科*,10,0,10,華南永昌-民權,2023-09-08,9312
5302,太欣,9,0,9,華南永昌-民權,2023-09-08,9312
2204,中華,11,4,7,華南永昌-民權,2023-09-08,9312
2331,精英,12,5,7,華南永昌-民權,2023-09-08,9312
2486,一詮,13,6,7,華南永昌-民權,2023-09-08,9312
3049,精金,7,0,7,華南永昌-民權,2023-09-08,9312
3306,鼎天,7,0,7,華南永昌-民權,2023-09-08,9312
6235,華孚,7,0,7,華南永昌-民權,2023-09-08,9312
6417,韋僑,11,4,7,華南永昌-民權,2023-09-08,9312
2634,漢翔,13,6,7,華南永昌-民權,2023-09-08,9312
2376,技嘉,8,2,6,華南永昌-民權,2023-09-08,9312
2356,英業達,7,1,6,華南永昌-民權,2023-09-08,9312
6269,台郡,6,0,6,華南永昌-民權,2023-09-08,9312
6274,台燿,6,0,6,華南永昌-民權,2023-09-08,9312
3481,群創,6,1,5,華南永昌-民權,2023-09-08,9312
00712,復華富時不動產,5,0,5,華南永昌-民權,2023-09-08,9312
00882,中信中國高股息,5,0,5,華南永昌-民權,2023-09-08,9312
1109,信大,5,0,5,華南永昌-民權,2023-09-08,9312
2405,輔信,8,3,5,華南永昌-民權,2023-09-08,9312
3652,精聯,5,0,5,華南永昌-民權,2023-09-08,9312
4167,松瑞藥,5,0,5,華南永昌-民權,2023-09-08,9312
6197,佳必琪,8,3,5,華南永昌-民權,2023-09-08,9312
2409,友達,251,4,247,華南永昌-民權,2023-09-11,9312
3324,雙鴻,115,5,110,華南永昌-民權,2023-09-11,9312
00919,群益台灣精選高息,63,0,63,華南永昌-民權,2023-09-11,9312
2330,台積電,45,1,44,華南永昌-民權,2023-09-11,9312
3652,精聯,35,0,35,華南永昌-民權,2023-09-11,9312
3231,緯創,63,30,33,華南永昌-民權,2023-09-11,9312
2312,金寶,47,16,31,華南永昌-民權,2023-09-11,9312
5483,中美晶,31,0,31,華南永昌-民權,2023-09-11,9312
2105,正新,20,0,20,華南永昌-民權,2023-09-11,9312
8038,長園科,30,10,20,華南永昌-民權,2023-09-11,9312
2363,矽統,46,27,19,華南永昌-民權,2023-09-11,9312
2376,技嘉,20,3,17,華南永昌-民權,2023-09-11,9312
2329,華泰,19,3,16,華南永昌-民權,2023-09-11,9312
00915,凱基優選高股息30,16,1,15,華南永昌-民權,2023-09-11,9312
00632R,元大台灣50反1,20,5,15,華南永昌-民權,2023-09-11,9312
1109,信大,14,0,14,華南永昌-民權,2023-09-11,9312
2886,兆豐金,12,0,12,華南永昌-民權,2023-09-11,9312
4766,南寶,12,0,12,華南永昌-民權,2023-09-11,9312
6187,萬潤,17,6,11,華南永昌-民權,2023-09-11,9312
3481,群創,25,14,11,華南永昌-民權,2023-09-11,9312
2618,長榮航,15,4,11,華南永昌-民權,2023-09-11,9312
2002,中鋼,10,0,10,華南永昌-民權,2023-09-11,9312
1419,新紡,10,0,10,華南永昌-民權,2023-09-11,9312
00687B,國泰20年美債,10,0,10,華南永昌-民權,2023-09-11,9312
2101,南港,10,0,10,華南永昌-民權,2023-09-11,9312
2359,所羅門,10,0,10,華南永昌-民權,2023-09-11,9312
2498,宏達電,11,1,10,華南永昌-民權,2023-09-11,9312
3028,增你強,10,0,10,華南永昌-民權,2023-09-11,9312
6505,台塑化,10,0,10,華南永昌-民權,2023-09-11,9312
8069,元太,10,0,10,華南永昌-民權,2023-09-11,9312
2880,華南金,12,3,9,華南永昌-民權,2023-09-11,9312
2324,仁寶,10,1,9,華南永昌-民權,2023-09-11,9312
6269,台郡,10,1,9,華南永昌-民權,2023-09-11,9312
2208,台船,8,0,8,華南永昌-民權,2023-09-11,9312
2382,廣達,25,18,7,華南永昌-民權,2023-09-11,9312
00679B,元大美債20年,8,1,7,華南永昌-民權,2023-09-11,9312
1618,合機,24,17,7,華南永昌-民權,2023-09-11,9312
2352,佳世達,11,4,7,華南永昌-民權,2023-09-11,9312
0056,元大高股息,29,23,6,華南永昌-民權,2023-09-11,9312
00932,兆豐永續高息等權,6,0,6,華南永昌-民權,2023-09-11,9312
2316,楠梓電,6,0,6,華南永昌-民權,2023-09-11,9312
2344,華邦電,8,2,6,華南永昌-民權,2023-09-11,9312
2356,英業達,16,10,6,華南永昌-民權,2023-09-11,9312
2371,大同,6,0,6,華南永昌-民權,2023-09-11,9312
2402,毅嘉,6,0,6,華南永昌-民權,2023-09-11,9312
3081,聯亞,6,0,6,華南永昌-民權,2023-09-11,9312
3178,公準,7,1,6,華南永昌-民權,2023-09-11,9312
4938,和碩,6,0,6,華南永昌-民權,2023-09-11,9312
2884,玉山金,5,0,5,華南永昌-民權,2023-09-11,9312
00900,富邦特選高股息30,5,0,5,華南永昌-民權,2023-09-11,9312
00929,復華台灣科技優息,49,2,47,華南永昌-民權,2023-09-12,9312
1316,上曜,30,0,30,華南永昌-民權,2023-09-12,9312
2105,正新,30,0,30,華南永昌-民權,2023-09-12,9312
00631L,元大台灣50正2,22,0,22,華南永昌-民權,2023-09-12,9312
00915,凱基優選高股息30,21,1,20,華南永昌-民權,2023-09-12,9312
6187,萬潤,24,4,20,華南永昌-民權,2023-09-12,9312
2609,陽明,20,6,14,華南永昌-民權,2023-09-12,9312
2382,廣達,21,9,12,華南永昌-民權,2023-09-12,9312
2330,台積電,12,1,11,華南永昌-民權,2023-09-12,9312
2301,光寶科,14,3,11,華南永昌-民權,2023-09-12,9312
00670L,富邦NASDAQ正2,11,0,11,華南永昌-民權,2023-09-12,9312
1799,易威,11,0,11,華南永昌-民權,2023-09-12,9312
2002,中鋼,11,0,11,華南永昌-民權,2023-09-12,9312
00900,富邦特選高股息30,10,0,10,華南永昌-民權,2023-09-12,9312
4561,健椿,10,0,10,華南永昌-民權,2023-09-12,9312
6117,迎廣,11,1,10,華南永昌-民權,2023-09-12,9312
6505,台塑化,10,0,10,華南永昌-民權,2023-09-12,9312
9950,萬國通,10,0,10,華南永昌-民權,2023-09-12,9312
00918,大華優利高填息30,9,0,9,華南永昌-民權,2023-09-12,9312
2883,凱基金,8,0,8,華南永昌-民權,2023-09-12,9312
2882,國泰金,10,2,8,華南永昌-民權,2023-09-12,9312
3652,精聯,8,0,8,華南永昌-民權,2023-09-12,9312
00919,群益台灣精選高息,8,1,7,華南永昌-民權,2023-09-12,9312
1609,大亞,7,0,7,華南永昌-民權,2023-09-12,9312
2363,矽統,76,69,7,華南永昌-民權,2023-09-12,9312
2460,建通,14,7,7,華南永昌-民權,2023-09-12,9312
6269,台郡,7,0,7,華南永昌-民權,2023-09-12,9312
1802,台玻,6,0,6,華南永昌-民權,2023-09-12,9312
00720B,元大投資級公司債,6,0,6,華南永昌-民權,2023-09-12,9312
1471,首利,10,4,6,華南永昌-民權,2023-09-12,9312
2485,兆赫,8,2,6,華南永昌-民權,2023-09-12,9312
6274,台燿,7,1,6,華南永昌-民權,2023-09-12,9312
1905,華紙,5,0,5,華南永昌-民權,2023-09-12,9312
3231,緯創,14,9,5,華南永昌-民權,2023-09-12,9312
6472,保瑞,5,0,5,華南永昌-民權,2023-09-12,9312
00923,群益台ESG低碳50,5,0,5,華南永昌-民權,2023-09-12,9312
00753L,中信中國50正2,5,0,5,華南永昌-民權,2023-09-12,9312
00907,永豐優息存股,5,0,5,華南永昌-民權,2023-09-12,9312
00891,中信關鍵半導體,5,0,5,華南永昌-民權,2023-09-12,9312
2374,佳能,5,0,5,華南永昌-民權,2023-09-12,9312
2601,益航,5,0,5,華南永昌-民權,2023-09-12,9312
2743,山富,5,0,5,華南永昌-民權,2023-09-12,9312
3308,聯德,5,0,5,華南永昌-民權,2023-09-12,9312
4304,勝昱,5,0,5,華南永昌-民權,2023-09-12,9312
6508,惠光,5,0,5,華南永昌-民權,2023-09-12,9312
00885,富邦越南,4,0,4,華南永昌-民權,2023-09-12,9312
3346,麗清,4,0,4,華南永昌-民權,2023-09-12,9312
3363,上詮,11,7,4,華南永昌-民權,2023-09-12,9312
6120,達運,18,14,4,華南永昌-民權,2023-09-12,9312
2427,三商電,13,9,4,華南永昌-民權,2023-09-12,9312
00929,復華台灣科技優息,226,1,225,華南永昌-民權,2023-09-13,9312
00919,群益台灣精選高息,54,0,54,華南永昌-民權,2023-09-13,9312
5340,建榮,50,0,50,華南永昌-民權,2023-09-13,9312
3035,智原,78,52,26,華南永昌-民權,2023-09-13,9312
00878,國泰永續高股息,19,0,19,華南永昌-民權,2023-09-13,9312
4532,瑞智,17,0,17,華南永昌-民權,2023-09-13,9312
3481,群創,20,4,16,華南永昌-民權,2023-09-13,9312
0056,元大高股息,14,0,14,華南永昌-民權,2023-09-13,9312
9917,中保科,13,0,13,華南永昌-民權,2023-09-13,9312
00923,群益台ESG低碳50,12,0,12,華南永昌-民權,2023-09-13,9312
2329,華泰,13,1,12,華南永昌-民權,2023-09-13,9312
00633L,富邦上証正2,11,0,11,華南永昌-民權,2023-09-13,9312
00915,凱基優選高股息30,20,10,10,華南永昌-民權,2023-09-13,9312
00679B,元大美債20年,10,0,10,華南永昌-民權,2023-09-13,9312
1524,耿鼎,36,26,10,華南永昌-民權,2023-09-13,9312
3682,亞太電,10,0,10,華南永昌-民權,2023-09-13,9312
6187,萬潤,15,5,10,華南永昌-民權,2023-09-13,9312
2317,鴻海,14,5,9,華南永昌-民權,2023-09-13,9312
2618,長榮航,9,0,9,華南永昌-民權,2023-09-13,9312
00751B,元大AAA至A公司債,7,0,7,華南永昌-民權,2023-09-13,9312
00712,復華富時不動產,7,0,7,華南永昌-民權,2023-09-13,9312
1799,易威,7,0,7,華南永昌-民權,2023-09-13,9312
3043,科風,7,0,7,華南永昌-民權,2023-09-13,9312
2355,敬鵬,10,4,6,華南永昌-民權,2023-09-13,9312
2485,兆赫,10,4,6,華南永昌-民權,2023-09-13,9312
3051,力特,94,88,6,華南永昌-民權,2023-09-13,9312
3294,英濟,6,0,6,華南永昌-民權,2023-09-13,9312
00918,大華優利高填息30,6,0,6,華南永昌-民權,2023-09-13,9312
2634,漢翔,9,3,6,華南永昌-民權,2023-09-13,9312
00632R,元大台灣50反1,5,0,5,華南永昌-民權,2023-09-13,9312
2369,菱生,6,1,5,華南永昌-民權,2023-09-13,9312
3036A,文曄甲特,5,0,5,華南永昌-民權,2023-09-13,9312
3264,欣銓,7,2,5,華南永昌-民權,2023-09-13,9312
4561,健椿,5,0,5,華南永昌-民權,2023-09-13,9312
4564,元翎,5,0,5,華南永昌-民權,2023-09-13,9312
4712,福格創新,5,0,5,華南永昌-民權,2023-09-13,9312
4938,和碩,5,0,5,華南永昌-民權,2023-09-13,9312
8222,寶一,5,0,5,華南永昌-民權,2023-09-13,9312
3231,緯創,10,5,5,華南永昌-民權,2023-09-13,9312
4707,磐亞,5,1,4,華南永昌-民權,2023-09-13,9312
00930,永豐ESG低碳高息,5,1,4,華南永昌-民權,2023-09-13,9312
1301,台塑,4,0,4,華南永昌-民權,2023-09-13,9312
1609,大亞,5,1,4,華南永昌-民權,2023-09-13,9312
2615,萬海,4,0,4,華南永昌-民權,2023-09-13,9312
6550,北極星藥業-KY,5,1,4,華南永昌-民權,2023-09-13,9312
8150,南茂,4,0,4,華南永昌-民權,2023-09-13,9312
2376,技嘉,27,23,4,華南永昌-民權,2023-09-13,9312
00932,兆豐永續高息等權,3,0,3,華南永昌-民權,2023-09-13,9312
1319,東陽,4,1,3,華南永昌-民權,2023-09-13,9312
00887,永豐中國科技50大,3,0,3,華南永昌-民權,2023-09-13,9312
8112,至上,170,2,168,華南永昌-民權,2023-09-14,9312
2385,群光,81,1,80,華南永昌-民權,2023-09-14,9312
6176,瑞儀,50,1,49,華南永昌-民權,2023-09-14,9312
2101,南港,47,0,47,華南永昌-民權,2023-09-14,9312
00632R,元大台灣50反1,35,0,35,華南永昌-民權,2023-09-14,9312
5340,建榮,30,0,30,華南永昌-民權,2023-09-14,9312
00885,富邦越南,28,0,28,華南永昌-民權,2023-09-14,9312
00915,凱基優選高股息30,28,0,28,華南永昌-民權,2023-09-14,9312
3014,聯陽,61,34,27,華南永昌-民權,2023-09-14,9312
3682,亞太電,25,0,25,華南永昌-民權,2023-09-14,9312
2641,正德,23,0,23,華南永昌-民權,2023-09-14,9312
00919,群益台灣精選高息,23,0,23,華南永昌-民權,2023-09-14,9312
1717,長興,20,0,20,華南永昌-民權,2023-09-14,9312
8081,致新,20,0,20,華南永昌-民權,2023-09-14,9312
2421,建準,33,13,20,華南永昌-民權,2023-09-14,9312
1524,耿鼎,36,19,17,華南永昌-民權,2023-09-14,9312
00900,富邦特選高股息30,17,0,17,華南永昌-民權,2023-09-14,9312
2371,大同,27,11,16,華南永昌-民權,2023-09-14,9312
2324,仁寶,15,1,14,華南永昌-民權,2023-09-14,9312
00631L,元大台灣50正2,12,0,12,華南永昌-民權,2023-09-14,9312
1522,堤維西,91,79,12,華南永昌-民權,2023-09-14,9312
00932,兆豐永續高息等權,12,1,11,華南永昌-民權,2023-09-14,9312
00751B,元大AAA至A公司債,10,0,10,華南永昌-民權,2023-09-14,9312
1419,新紡,10,0,10,華南永昌-民權,2023-09-14,9312
1799,易威,10,0,10,華南永昌-民權,2023-09-14,9312
3652,精聯,10,0,10,華南永昌-民權,2023-09-14,9312
4712,福格創新,10,0,10,華南永昌-民權,2023-09-14,9312
3209,全科,9,0,9,華南永昌-民權,2023-09-14,9312
4533,協易機,9,0,9,華南永昌-民權,2023-09-14,9312
6197,佳必琪,9,0,9,華南永昌-民權,2023-09-14,9312
00712,復華富時不動產,8,0,8,華南永昌-民權,2023-09-14,9312
3380,明泰,11,3,8,華南永昌-民權,2023-09-14,9312
2486,一詮,13,6,7,華南永昌-民權,2023-09-14,9312
2601,益航,7,0,7,華南永昌-民權,2023-09-14,9312
2002,中鋼,7,1,6,華南永昌-民權,2023-09-14,9312
2449,京元電子,6,0,6,華南永昌-民權,2023-09-14,9312
4155,訊映,6,0,6,華南永昌-民權,2023-09-14,9312
2630,亞航,56,51,5,華南永昌-民權,2023-09-14,9312
2317,鴻海,10,5,5,華南永昌-民權,2023-09-14,9312
2401,凌陽,11,6,5,華南永昌-民權,2023-09-14,9312
2880,華南金,5,0,5,華南永昌-民權,2023-09-14,9312
3149,正達,5,0,5,華南永昌-民權,2023-09-14,9312
9950,萬國通,5,0,5,華南永昌-民權,2023-09-14,9312
6231,系微,14,10,4,華南永昌-民權,2023-09-14,9312
2332,友訊,4,0,4,華南永昌-民權,2023-09-14,9312
2353,宏��,4,0,4,華南永昌-民權,2023-09-14,9312
2402,毅嘉,5,1,4,華南永昌-民權,2023-09-14,9312
2460,建通,10,6,4,華南永昌-民權,2023-09-14,9312
3257,虹冠電,4,0,4,華南永昌-民權,2023-09-14,9312
3689,湧德,4,0,4,華南永昌-民權,2023-09-14,9312
00929,復華台灣科技優息,166,10,156,華南永昌-民權,2023-09-15,9312
2603,長榮,303,156,147,華南永昌-民權,2023-09-15,9312
00919,群益台灣精選高息,66,8,58,華南永昌-民權,2023-09-15,9312
3481,群創,59,2,57,華南永昌-民權,2023-09-15,9312
8046,南電,54,10,44,華南永昌-民權,2023-09-15,9312
3163,波若威,57,14,43,華南永昌-民權,2023-09-15,9312
2486,一詮,34,4,30,華南永昌-民權,2023-09-15,9312
2915,潤泰全,25,0,25,華南永昌-民權,2023-09-15,9312
2363,矽統,47,25,22,華南永昌-民權,2023-09-15,9312
2002,中鋼,23,2,21,華南永昌-民權,2023-09-15,9312
2025,千興,20,0,20,華南永昌-民權,2023-09-15,9312
2618,長榮航,20,0,20,華南永昌-民權,2023-09-15,9312
3652,精聯,20,0,20,華南永昌-民權,2023-09-15,9312
5340,建榮,22,2,20,華南永昌-民權,2023-09-15,9312
2103,台橡,19,0,19,華南永昌-民權,2023-09-15,9312
00885,富邦越南,18,2,16,華南永昌-民權,2023-09-15,9312
2409,友達,20,4,16,華南永昌-民權,2023-09-15,9312
6834,天二科技,16,0,16,華南永昌-民權,2023-09-15,9312
1525,江申,15,0,15,華南永昌-民權,2023-09-15,9312
2324,仁寶,17,4,13,華南永昌-民權,2023-09-15,9312
00713,元大台灣高息低波,18,5,13,華南永昌-民權,2023-09-15,9312
00753L,中信中國50正2,17,5,12,華南永昌-民權,2023-09-15,9312
2332,友訊,13,1,12,華南永昌-民權,2023-09-15,9312
2884,玉山金,19,7,12,華南永昌-民權,2023-09-15,9312
5371,中光電,13,2,11,華南永昌-民權,2023-09-15,9312
2314,台揚,11,1,10,華南永昌-民權,2023-09-15,9312
2425,承啟,10,0,10,華南永昌-民權,2023-09-15,9312
2889,國票金,10,0,10,華南永昌-民權,2023-09-15,9312
3290,東浦,10,0,10,華南永昌-民權,2023-09-15,9312
6244,茂迪,10,0,10,華南永昌-民權,2023-09-15,9312
00679B,元大美債20年,8,0,8,華南永昌-民權,2023-09-15,9312
1471,首利,8,0,8,華南永昌-民權,2023-09-15,9312
2601,益航,19,11,8,華南永昌-民權,2023-09-15,9312
00720B,元大投資級公司債,7,0,7,華南永昌-民權,2023-09-15,9312
00751B,元大AAA至A公司債,7,0,7,華南永昌-民權,2023-09-15,9312
2462,良得電,7,0,7,華南永昌-民權,2023-09-15,9312
8240,華宏,9,2,7,華南永昌-民權,2023-09-15,9312
2317,鴻海,17,10,7,華南永昌-民權,2023-09-15,9312
1799,易威,6,0,6,華南永昌-民權,2023-09-15,9312
2312,金寶,10,4,6,華南永昌-民權,2023-09-15,9312
2610,華航,9,3,6,華南永昌-民權,2023-09-15,9312
3004,豐達科,6,0,6,華南永昌-民權,2023-09-15,9312
3049,精金,6,0,6,華南永昌-民權,2023-09-15,9312
6672,騰輝電子-KY,6,0,6,華南永昌-民權,2023-09-15,9312
3035,智原,7,2,5,華南永昌-民權,2023-09-15,9312
1522,堤維西,10,5,5,華南永昌-民權,2023-09-15,9312
2836,高雄銀,5,0,5,華南永昌-民權,2023-09-15,9312
3711,日月光投控,5,0,5,華南永昌-民權,2023-09-15,9312
4167,松瑞藥,5,0,5,華南永昌-民權,2023-09-15,9312
5483,中美晶,5,0,5,華南永昌-民權,2023-09-15,9312
00919,群益台灣精選高息,70,5,65,華南永昌-民權,2023-09-18,9312
00929,復華台灣科技優息,94,37,57,華南永昌-民權,2023-09-18,9312
00857B,永豐20年美公債,34,0,34,華南永昌-民權,2023-09-18,9312
2363,矽統,64,34,30,華南永昌-民權,2023-09-18,9312
00885,富邦越南,27,0,27,華南永昌-民權,2023-09-18,9312
1522,堤維西,30,4,26,華南永昌-民權,2023-09-18,9312
2324,仁寶,25,1,24,華南永昌-民權,2023-09-18,9312
3231,緯創,26,6,20,華南永昌-民權,2023-09-18,9312
00878,國泰永續高股息,16,0,16,華南永昌-民權,2023-09-18,9312
3481,群創,15,0,15,華南永昌-民權,2023-09-18,9312
2399,映泰,15,0,15,華南永昌-民權,2023-09-18,9312
1732,毛寶,15,0,15,華南永昌-民權,2023-09-18,9312
2382,廣達,15,1,14,華南永昌-民權,2023-09-18,9312
00680L,元大美債20正2,13,0,13,華南永昌-民權,2023-09-18,9312
5225,東科-KY,12,0,12,華南永昌-民權,2023-09-18,9312
3363,上詮,38,26,12,華南永昌-民權,2023-09-18,9312
2002,中鋼,11,1,10,華南永昌-民權,2023-09-18,9312
1605,華新,40,30,10,華南永昌-民權,2023-09-18,9312
6152,百一,10,0,10,華南永昌-民權,2023-09-18,9312
6187,萬潤,10,0,10,華南永昌-民權,2023-09-18,9312
3305,昇貿,9,0,9,華南永昌-民權,2023-09-18,9312
6834,天二科技,9,0,9,華南永昌-民權,2023-09-18,9312
2605,新興,211,203,8,華南永昌-民權,2023-09-18,9312
2376,技嘉,17,9,8,華南永昌-民權,2023-09-18,9312
00679B,元大美債20年,8,0,8,華南永昌-民權,2023-09-18,9312
2504,國產,8,0,8,華南永昌-民權,2023-09-18,9312
2889,國票金,10,2,8,華南永昌-民權,2023-09-18,9312
3652,精聯,8,0,8,華南永昌-民權,2023-09-18,9312
2317,鴻海,11,4,7,華南永昌-民權,2023-09-18,9312
00751B,元大AAA至A公司債,7,0,7,華南永昌-民權,2023-09-18,9312
00687B,國泰20年美債,7,0,7,華南永昌-民權,2023-09-18,9312
8358,金居,7,0,7,華南永昌-民權,2023-09-18,9312
4979,華星光,8,2,6,華南永昌-民權,2023-09-18,9312
2356,英業達,8,2,6,華南永昌-民權,2023-09-18,9312
3308,聯德,6,0,6,華南永昌-民權,2023-09-18,9312
2330,台積電,55,50,5,華南永昌-民權,2023-09-18,9312
2301,光寶科,8,3,5,華南永昌-民權,2023-09-18,9312
00932,兆豐永續高息等權,5,0,5,華南永昌-民權,2023-09-18,9312
00753L,中信中國50正2,5,0,5,華南永昌-民權,2023-09-18,9312
2369,菱生,5,0,5,華南永昌-民權,2023-09-18,9312
2838,聯邦銀,5,0,5,華南永昌-民權,2023-09-18,9312
3715,定穎投控,14,9,5,華南永昌-民權,2023-09-18,9312
4943,康控-KY,5,0,5,華南永昌-民權,2023-09-18,9312
5234,達興材料,5,0,5,華南永昌-民權,2023-09-18,9312
6279,胡連,5,0,5,華南永昌-民權,2023-09-18,9312
8069,元太,5,0,5,華南永昌-民權,2023-09-18,9312
3037,欣興,9,4,5,華南永昌-民權,2023-09-18,9312
1799,易威,5,1,4,華南永昌-民權,2023-09-18,9312
2353,宏��,5,1,4,華南永昌-民權,2023-09-18,9312
2402,毅嘉,5,1,4,華南永昌-民權,2023-09-18,9312
4961,天鈺,80,6,74,華南永昌-民權,2023-09-19,9312
2330,台積電,56,0,56,華南永昌-民權,2023-09-19,9312
2838,聯邦銀,50,2,48,華南永昌-民權,2023-09-19,9312
3481,群創,46,9,37,華南永昌-民權,2023-09-19,9312
1529,樂事綠能,32,0,32,華南永昌-民權,2023-09-19,9312
3231,緯創,32,12,20,華南永昌-民權,2023-09-19,9312
00919,群益台灣精選高息,43,24,19,華南永昌-民權,2023-09-19,9312
2609,陽明,25,7,18,華南永昌-民權,2023-09-19,9312
2618,長榮航,17,0,17,華南永昌-民權,2023-09-19,9312
2915,潤泰全,17,0,17,華南永昌-民權,2023-09-19,9312
3652,精聯,17,0,17,華南永昌-民權,2023-09-19,9312
4171,瑞基,17,0,17,華南永昌-民權,2023-09-19,9312
5871,中租-KY,15,0,15,華南永昌-民權,2023-09-19,9312
00932,兆豐永續高息等權,22,8,14,華南永昌-民權,2023-09-19,9312
1809,中釉,16,2,14,華南永昌-民權,2023-09-19,9312
00772B,中信高評級公司債,11,0,11,華南永昌-民權,2023-09-19,9312
2603,長榮,18,7,11,華南永昌-民權,2023-09-19,9312
2615,萬海,10,0,10,華南永昌-民權,2023-09-19,9312
1471,首利,10,0,10,華南永昌-民權,2023-09-19,9312
5340,建榮,10,0,10,華南永昌-民權,2023-09-19,9312
6187,萬潤,12,2,10,華南永昌-民權,2023-09-19,9312
8081,致新,10,0,10,華南永昌-民權,2023-09-19,9312
00878,國泰永續高股息,10,1,9,華南永昌-民權,2023-09-19,9312
2369,菱生,9,0,9,華南永昌-民權,2023-09-19,9312
2605,新興,27,18,9,華南永昌-民權,2023-09-19,9312
5009,榮剛,19,10,9,華南永昌-民權,2023-09-19,9312
6120,達運,8,0,8,華南永昌-民權,2023-09-19,9312
5225,東科-KY,8,0,8,華南永昌-民權,2023-09-19,9312
2312,金寶,10,3,7,華南永昌-民權,2023-09-19,9312
2601,益航,14,7,7,華南永昌-民權,2023-09-19,9312
3013,晟銘電,7,0,7,華南永昌-民權,2023-09-19,9312
8358,金居,7,0,7,華南永昌-民權,2023-09-19,9312
1101,台泥,7,0,7,華南永昌-民權,2023-09-19,9312
2880,華南金,6,0,6,華南永昌-民權,2023-09-19,9312
4944,兆遠,9,3,6,華南永昌-民權,2023-09-19,9312
2634,漢翔,5,0,5,華南永昌-民權,2023-09-19,9312
1419,新紡,5,0,5,華南永昌-民權,2023-09-19,9312
00712,復華富時不動產,5,0,5,華南永昌-民權,2023-09-19,9312
2388,威盛,10,5,5,華南永昌-民權,2023-09-19,9312
2409,友達,8,3,5,華南永昌-民權,2023-09-19,9312
2834,臺企銀,5,0,5,華南永昌-民權,2023-09-19,9312
3045,台灣大,5,0,5,華南永昌-民權,2023-09-19,9312
3308,聯德,5,0,5,華南永昌-民權,2023-09-19,9312
3419,譁裕,5,0,5,華南永昌-民權,2023-09-19,9312
4533,協易機,5,0,5,華南永昌-民權,2023-09-19,9312
4979,華星光,6,1,5,華南永昌-民權,2023-09-19,9312
6235,華孚,6,1,5,華南永昌-民權,2023-09-19,9312
6491,晶碩,5,0,5,華南永昌-民權,2023-09-19,9312
9917,中保科,5,0,5,華南永昌-民權,2023-09-19,9312
9919,康那香,6,1,5,華南永昌-民權,2023-09-19,9312
00929,復華台灣科技優息,169,2,167,華南永昌-民權,2023-09-20,9312
00919,群益台灣精選高息,88,0,88,華南永昌-民權,2023-09-20,9312
2838,聯邦銀,51,0,51,華南永昌-民權,2023-09-20,9312
2603,長榮,50,5,45,華南永昌-民權,2023-09-20,9312
5340,建榮,40,0,40,華南永昌-民權,2023-09-20,9312
2324,仁寶,37,0,37,華南永昌-民權,2023-09-20,9312
6117,迎廣,30,0,30,華南永昌-民權,2023-09-20,9312
00680L,元大美債20正2,27,0,27,華南永昌-民權,2023-09-20,9312
8358,金居,26,1,25,華南永昌-民權,2023-09-20,9312
2883,凱基金,22,0,22,華南永昌-民權,2023-09-20,9312
00932,兆豐永續高息等權,22,0,22,華南永昌-民權,2023-09-20,9312
2634,漢翔,20,0,20,華南永昌-民權,2023-09-20,9312
2208,台船,35,15,20,華南永昌-民權,2023-09-20,9312
2461,光群雷,20,0,20,華南永昌-民權,2023-09-20,9312
4133,亞諾法,19,0,19,華南永昌-民權,2023-09-20,9312
2330,台積電,16,0,16,華南永昌-民權,2023-09-20,9312
2537,聯上發,14,0,14,華南永昌-民權,2023-09-20,9312
2618,長榮航,16,4,12,華南永昌-民權,2023-09-20,9312
5871,中租-KY,13,2,11,華南永昌-民權,2023-09-20,9312
2344,華邦電,14,3,11,華南永昌-民權,2023-09-20,9312
2409,友達,12,2,10,華南永昌-民權,2023-09-20,9312
2354,鴻準,10,0,10,華南永昌-民權,2023-09-20,9312
3004,豐達科,10,0,10,華南永昌-民權,2023-09-20,9312
3652,精聯,10,0,10,華南永昌-民權,2023-09-20,9312
5475,德宏,10,0,10,華南永昌-民權,2023-09-20,9312
5515,建國,10,0,10,華南永昌-民權,2023-09-20,9312
6449,鈺邦,11,1,10,華南永昌-民權,2023-09-20,9312
8081,致新,11,1,10,華南永昌-民權,2023-09-20,9312
9919,康那香,10,0,10,華南永昌-民權,2023-09-20,9312
1513,中興電,17,9,8,華南永昌-民權,2023-09-20,9312
00878,國泰永續高股息,10,2,8,華南永昌-民權,2023-09-20,9312
2401,凌陽,10,2,8,華南永昌-民權,2023-09-20,9312
3265,台星科,17,9,8,華南永昌-民權,2023-09-20,9312
8046,南電,10,2,8,華南永昌-民權,2023-09-20,9312
00679B,元大美債20年,8,0,8,華南永昌-民權,2023-09-20,9312
1723,中碳,7,0,7,華南永昌-民權,2023-09-20,9312
2388,威盛,10,3,7,華南永昌-民權,2023-09-20,9312
3363,上詮,37,30,7,華南永昌-民權,2023-09-20,9312
4171,瑞基,7,0,7,華南永昌-民權,2023-09-20,9312
5258,虹堡,8,1,7,華南永昌-民權,2023-09-20,9312
2449,京元電子,7,2,5,華南永昌-民權,2023-09-20,9312
00753L,中信中國50正2,5,0,5,華南永昌-民權,2023-09-20,9312
1605,華新,46,41,5,華南永昌-民權,2023-09-20,9312
2382,廣達,15,10,5,華南永昌-民權,2023-09-20,9312
4533,協易機,5,0,5,華南永昌-民權,2023-09-20,9312
6235,華孚,5,0,5,華南永昌-民權,2023-09-20,9312
5225,東科-KY,5,0,5,華南永昌-民權,2023-09-20,9312
2884,玉山金,6,2,4,華南永昌-民權,2023-09-20,9312
00687B,國泰20年美債,4,0,4,華南永昌-民權,2023-09-20,9312
2340,台亞,4,0,4,華南永昌-民權,2023-09-20,9312
2838,聯邦銀,87,0,87,華南永昌-民權,2023-09-21,9312
00929,復華台灣科技優息,50,5,45,華南永昌-民權,2023-09-21,9312
2367,燿華,35,1,34,華南永昌-民權,2023-09-21,9312
2002,中鋼,32,0,32,華南永昌-民權,2023-09-21,9312
2515,中工,30,0,30,華南永昌-民權,2023-09-21,9312
00878,國泰永續高股息,29,2,27,華南永昌-民權,2023-09-21,9312
2618,長榮航,24,0,24,華南永昌-民權,2023-09-21,9312
0056,元大高股息,20,0,20,華南永昌-民權,2023-09-21,9312
3652,精聯,20,0,20,華南永昌-民權,2023-09-21,9312
1513,中興電,22,3,19,華南永昌-民權,2023-09-21,9312
2330,台積電,19,0,19,華南永昌-民權,2023-09-21,9312
00932,兆豐永續高息等權,15,0,15,華南永昌-民權,2023-09-21,9312
2313,華通,41,26,15,華南永昌-民權,2023-09-21,9312
6187,萬潤,15,0,15,華南永昌-民權,2023-09-21,9312
2537,聯上發,13,0,13,華南永昌-民權,2023-09-21,9312
3014,聯陽,13,0,13,華南永昌-民權,2023-09-21,9312
00919,群益台灣精選高息,15,3,12,華南永昌-民權,2023-09-21,9312
1519,華城,14,2,12,華南永昌-民權,2023-09-21,9312
2884,玉山金,14,2,12,華南永昌-民權,2023-09-21,9312
2890,永豐金,12,1,11,華南永昌-民權,2023-09-21,9312
5340,建榮,11,0,11,華南永昌-民權,2023-09-21,9312
6223,旺矽,11,0,11,華南永昌-民權,2023-09-21,9312
2478,大毅,10,0,10,華南永昌-民權,2023-09-21,9312
2498,宏達電,10,0,10,華南永昌-民權,2023-09-21,9312
3373,熱映,11,1,10,華南永昌-民權,2023-09-21,9312
3622,洋華,10,0,10,華南永昌-民權,2023-09-21,9312
8064,東捷,10,0,10,華南永昌-民權,2023-09-21,9312
2834,臺企銀,8,0,8,華南永昌-民權,2023-09-21,9312
6269,台郡,8,0,8,華南永昌-民權,2023-09-21,9312
8467,波力-KY,8,0,8,華南永昌-民權,2023-09-21,9312
9927,泰銘,8,0,8,華南永昌-民權,2023-09-21,9312
5880,合庫金,8,0,8,華南永昌-民權,2023-09-21,9312
2323,中環,10,3,7,華南永昌-民權,2023-09-21,9312
2425,承啟,7,0,7,華南永昌-民權,2023-09-21,9312
2428,興勤,7,0,7,華南永昌-民權,2023-09-21,9312
3032,偉訓,9,2,7,華南永昌-民權,2023-09-21,9312
5371,中光電,7,0,7,華南永昌-民權,2023-09-21,9312
2363,矽統,18,12,6,華南永昌-民權,2023-09-21,9312
3013,晟銘電,6,0,6,華南永昌-民權,2023-09-21,9312
3380,明泰,6,0,6,華南永昌-民權,2023-09-21,9312
8150,南茂,6,0,6,華南永昌-民權,2023-09-21,9312
8299,群聯,6,0,6,華南永昌-民權,2023-09-21,9312
2891,中信金,5,0,5,華南永昌-民權,2023-09-21,9312
00857B,永豐20年美公債,5,0,5,華南永昌-民權,2023-09-21,9312
00631L,元大台灣50正2,5,0,5,華南永昌-民權,2023-09-21,9312
1712,興農,5,0,5,華南永昌-民權,2023-09-21,9312
1799,易威,5,0,5,華南永昌-民權,2023-09-21,9312
2409,友達,6,1,5,華南永昌-民權,2023-09-21,9312
3033,威健,13,8,5,華南永昌-民權,2023-09-21,9312
3147,大綜,5,0,5,華南永昌-民權,2023-09-21,9312
00673R,期元大S＆P原油反1,202,0,202,華南永昌-民權,2023-09-22,9312
3617,碩天,55,0,55,華南永昌-民權,2023-09-22,9312
3014,聯陽,35,0,35,華南永昌-民權,2023-09-22,9312
2105,正新,50,20,30,華南永昌-民權,2023-09-22,9312
3324,雙鴻,57,27,30,華南永昌-民權,2023-09-22,9312
00857B,永豐20年美公債,27,0,27,華南永昌-民權,2023-09-22,9312
00712,復華富時不動產,25,0,25,華南永昌-民權,2023-09-22,9312
2462,良得電,23,0,23,華南永昌-民權,2023-09-22,9312
6417,韋僑,28,5,23,華南永昌-民權,2023-09-22,9312
3231,緯創,27,6,21,華南永昌-民權,2023-09-22,9312
00679B,元大美債20年,21,0,21,華南永昌-民權,2023-09-22,9312
00929,復華台灣科技優息,21,2,19,華南永昌-民權,2023-09-22,9312
00885,富邦越南,21,2,19,華南永昌-民權,2023-09-22,9312
00680L,元大美債20正2,18,0,18,華南永昌-民權,2023-09-22,9312
2637,慧洋-KY,21,3,18,華南永昌-民權,2023-09-22,9312
2537,聯上發,17,0,17,華南永昌-民權,2023-09-22,9312
00919,群益台灣精選高息,15,0,15,華南永昌-民權,2023-09-22,9312
00795B,中信美國公債20年,14,0,14,華南永昌-民權,2023-09-22,9312
00932,兆豐永續高息等權,13,0,13,華南永昌-民權,2023-09-22,9312
00751B,元大AAA至A公司債,12,0,12,華南永昌-民權,2023-09-22,9312
1519,華城,11,0,11,華南永昌-民權,2023-09-22,9312
2402,毅嘉,13,2,11,華南永昌-民權,2023-09-22,9312
2834,臺企銀,11,0,11,華南永昌-民權,2023-09-22,9312
00893,國泰智能電動車,10,0,10,華南永昌-民權,2023-09-22,9312
2405,輔信,11,1,10,華南永昌-民權,2023-09-22,9312
3481,群創,25,15,10,華南永昌-民權,2023-09-22,9312
4712,福格創新,10,0,10,華南永昌-民權,2023-09-22,9312
4927,泰鼎-KY,12,2,10,華南永昌-民權,2023-09-22,9312
2609,陽明,13,3,10,華南永昌-民權,2023-09-22,9312
1444,力麗,12,2,10,華南永昌-民權,2023-09-22,9312
00637L,元大滬深300正2,10,1,9,華南永昌-民權,2023-09-22,9312
1522,堤維西,10,1,9,華南永昌-民權,2023-09-22,9312
2002,中鋼,9,0,9,華南永昌-民權,2023-09-22,9312
2356,英業達,13,4,9,華南永昌-民權,2023-09-22,9312
6125,廣運,15,6,9,華南永昌-民權,2023-09-22,9312
2887,台新金,22,13,9,華南永昌-民權,2023-09-22,9312
2355,敬鵬,13,5,8,華南永昌-民權,2023-09-22,9312
2605,新興,10,2,8,華南永昌-民權,2023-09-22,9312
2618,長榮航,8,0,8,華南永昌-民權,2023-09-22,9312
1584,精剛,16,8,8,華南永昌-民權,2023-09-22,9312
00753L,中信中國50正2,7,0,7,華南永昌-民權,2023-09-22,9312
1467,南緯,9,2,7,華南永昌-民權,2023-09-22,9312
3652,精聯,7,0,7,華南永昌-民權,2023-09-22,9312
8034,榮群,7,0,7,華南永昌-民權,2023-09-22,9312
8085,福華,7,0,7,華南永昌-民權,2023-09-22,9312
1101,台泥,6,0,6,華南永昌-民權,2023-09-22,9312
00687B,國泰20年美債,6,0,6,華南永昌-民權,2023-09-22,9312
00772B,中信高評級公司債,6,0,6,華南永昌-民權,2023-09-22,9312
00926,凱基全球菁英55,6,0,6,華南永昌-民權,2023-09-22,9312
2313,華通,15,9,6,華南永昌-民權,2023-09-22,9312
2605,新興,50,4,46,華南永昌-民權,2023-09-25,9312
00919,群益台灣精選高息,27,0,27,華南永昌-民權,2023-09-25,9312
00929,復華台灣科技優息,23,0,23,華南永昌-民權,2023-09-25,9312
2915,潤泰全,27,4,23,華南永昌-民權,2023-09-25,9312
3324,雙鴻,25,2,23,華南永昌-民權,2023-09-25,9312
2344,華邦電,22,2,20,華南永昌-民權,2023-09-25,9312
2382,廣達,19,0,19,華南永昌-民權,2023-09-25,9312
2313,華通,19,1,18,華南永昌-民權,2023-09-25,9312
2017,官田鋼,17,0,17,華南永昌-民權,2023-09-25,9312
5371,中光電,15,0,15,華南永昌-民權,2023-09-25,9312
9927,泰銘,16,4,12,華南永昌-民權,2023-09-25,9312
6188,廣明,11,0,11,華南永昌-民權,2023-09-25,9312
2618,長榮航,14,4,10,華南永昌-民權,2023-09-25,9312
6282,康舒,11,1,10,華南永昌-民權,2023-09-25,9312
6418,詠昇,10,0,10,華南永昌-民權,2023-09-25,9312
1314,中石化,11,2,9,華南永昌-民權,2023-09-25,9312
00753L,中信中國50正2,8,0,8,華南永昌-民權,2023-09-25,9312
2543,皇昌,8,0,8,華南永昌-民權,2023-09-25,9312
00679B,元大美債20年,7,0,7,華南永昌-民權,2023-09-25,9312
1101,台泥,7,0,7,華南永昌-民權,2023-09-25,9312
1809,中釉,7,0,7,華南永昌-民權,2023-09-25,9312
00931B,統一美債20年,6,0,6,華南永昌-民權,2023-09-25,9312
1442,名軒,6,0,6,華南永昌-民權,2023-09-25,9312
2363,矽統,44,38,6,華南永昌-民權,2023-09-25,9312
2401,凌陽,8,2,6,華南永昌-民權,2023-09-25,9312
3003,健和興,6,0,6,華南永昌-民權,2023-09-25,9312
6443,元晶,6,0,6,華南永昌-民權,2023-09-25,9312
8210,勤誠,11,5,6,華南永昌-民權,2023-09-25,9312
2330,台積電,8,3,5,華南永昌-民權,2023-09-25,9312
2891,中信金,5,0,5,華南永昌-民權,2023-09-25,9312
2115,六暉-KY,5,0,5,華南永昌-民權,2023-09-25,9312
2374,佳能,5,0,5,華南永昌-民權,2023-09-25,9312
2468,華經,5,0,5,華南永昌-民權,2023-09-25,9312
4167,松瑞藥,5,0,5,華南永昌-民權,2023-09-25,9312
3363,上詮,175,170,5,華南永昌-民權,2023-09-25,9312
1799,易威,5,1,4,華南永昌-民權,2023-09-25,9312
3004,豐達科,4,0,4,華南永昌-民權,2023-09-25,9312
3265,台星科,5,1,4,華南永昌-民權,2023-09-25,9312
3380,明泰,4,0,4,華南永昌-民權,2023-09-25,9312
3576,聯合再生,5,1,4,華南永昌-民權,2023-09-25,9312
6197,佳必琪,4,0,4,華南永昌-民權,2023-09-25,9312
8182,加高,4,0,4,華南永昌-民權,2023-09-25,9312
1319,東陽,3,0,3,華南永昌-民權,2023-09-25,9312
00893,國泰智能電動車,3,0,3,華南永昌-民權,2023-09-25,9312
00715L,期街口布蘭特正2,3,0,3,華南永昌-民權,2023-09-25,9312
3264,欣銓,3,0,3,華南永昌-民權,2023-09-25,9312
3305,昇貿,3,0,3,華南永昌-民權,2023-09-25,9312
3622,洋華,7,4,3,華南永昌-民權,2023-09-25,9312
5302,太欣,3,0,3,華南永昌-民權,2023-09-25,9312
6770,力積電,3,0,3,華南永昌-民權,2023-09-25,9312
1524,耿鼎,59,5,54,華南永昌-民權,2023-09-26,9312
2313,華通,42,1,41,華南永昌-民權,2023-09-26,9312
2603,長榮,39,2,37,華南永昌-民權,2023-09-26,9312
6531,愛普*,50,15,35,華南永昌-民權,2023-09-26,9312
2317,鴻海,21,1,20,華南永昌-民權,2023-09-26,9312
00929,復華台灣科技優息,58,41,17,華南永昌-民權,2023-09-26,9312
00679B,元大美債20年,16,0,16,華南永昌-民權,2023-09-26,9312
1815,富喬,19,7,12,華南永昌-民權,2023-09-26,9312
2330,台積電,12,0,12,華南永昌-民權,2023-09-26,9312
2618,長榮航,11,0,11,華南永昌-民權,2023-09-26,9312
3652,精聯,11,0,11,華南永昌-民權,2023-09-26,9312
5009,榮剛,11,0,11,華南永昌-民權,2023-09-26,9312
1339,昭輝,12,2,10,華南永昌-民權,2023-09-26,9312
00753L,中信中國50正2,10,0,10,華南永昌-民權,2023-09-26,9312
00712,復華富時不動產,10,0,10,華南永昌-民權,2023-09-26,9312
2405,輔信,12,2,10,華南永昌-民權,2023-09-26,9312
2486,一詮,14,4,10,華南永昌-民權,2023-09-26,9312
2498,宏達電,10,0,10,華南永昌-民權,2023-09-26,9312
2888,新光金,10,0,10,華南永昌-民權,2023-09-26,9312
2915,潤泰全,10,0,10,華南永昌-民權,2023-09-26,9312
3128,昇銳,10,0,10,華南永昌-民權,2023-09-26,9312
5371,中光電,10,0,10,華南永昌-民權,2023-09-26,9312
6188,廣明,10,0,10,華南永昌-民權,2023-09-26,9312
2382,廣達,10,0,10,華南永昌-民權,2023-09-26,9312
00885,富邦越南,11,2,9,華南永昌-民權,2023-09-26,9312
2634,漢翔,10,1,9,華南永昌-民權,2023-09-26,9312
1310,台苯,8,0,8,華南永昌-民權,2023-09-26,9312
3715,定穎投控,27,19,8,華南永昌-民權,2023-09-26,9312
5347,世界,9,1,8,華南永昌-民權,2023-09-26,9312
2303,聯電,8,1,7,華南永昌-民權,2023-09-26,9312
00878,國泰永續高股息,9,2,7,華南永昌-民權,2023-09-26,9312
3324,雙鴻,13,6,7,華南永昌-民權,2023-09-26,9312
1101,台泥,7,1,6,華南永昌-民權,2023-09-26,9312
00900,富邦特選高股息30,6,0,6,華南永昌-民權,2023-09-26,9312
2352,佳世達,7,1,6,華南永昌-民權,2023-09-26,9312
3231,緯創,11,5,6,華南永昌-民權,2023-09-26,9312
4944,兆遠,5,0,5,華南永昌-民權,2023-09-26,9312
2887,台新金,16,11,5,華南永昌-民權,2023-09-26,9312
1608,華榮,8,3,5,華南永昌-民權,2023-09-26,9312
2002,中鋼,6,1,5,華南永昌-民權,2023-09-26,9312
2449,京元電子,5,0,5,華南永昌-民權,2023-09-26,9312
2516,新建,5,0,5,華南永昌-民權,2023-09-26,9312
2537,聯上發,5,0,5,華南永昌-民權,2023-09-26,9312
2867,三商壽,5,0,5,華南永昌-民權,2023-09-26,9312
3004,豐達科,5,0,5,華南永昌-民權,2023-09-26,9312
6282,康舒,6,1,5,華南永昌-民權,2023-09-26,9312
5880,合庫金,5,1,4,華南永昌-民權,2023-09-26,9312
2880,華南金,4,0,4,華南永昌-民權,2023-09-26,9312
0055,元大MSCI金融,4,0,4,華南永昌-民權,2023-09-26,9312
2409,友達,3,0,3,華南永昌-民權,2023-09-26,9312
3036,文曄,136,4,132,華南永昌-民權,2023-09-27,9312
2002,中鋼,77,34,43,華南永昌-民權,2023-09-27,9312
00929,復華台灣科技優息,36,0,36,華南永昌-民權,2023-09-27,9312
2367,燿華,30,0,30,華南永昌-民權,2023-09-27,9312
00932,兆豐永續高息等權,21,0,21,華南永昌-民權,2023-09-27,9312
2313,華通,20,0,20,華南永昌-民權,2023-09-27,9312
6531,愛普*,20,1,19,華南永昌-民權,2023-09-27,9312
1524,耿鼎,17,2,15,華南永昌-民權,2023-09-27,9312
00919,群益台灣精選高息,12,0,12,華南永昌-民權,2023-09-27,9312
2355,敬鵬,13,1,12,華南永昌-民權,2023-09-27,9312
2537,聯上發,12,0,12,華南永昌-民權,2023-09-27,9312
00712,復華富時不動產,11,0,11,華南永昌-民權,2023-09-27,9312
1618,合機,18,7,11,華南永昌-民權,2023-09-27,9312
00679B,元大美債20年,10,0,10,華南永昌-民權,2023-09-27,9312
3481,群創,11,3,8,華南永昌-民權,2023-09-27,9312
2105,正新,8,0,8,華南永昌-民權,2023-09-27,9312
1612,宏泰,13,6,7,華南永昌-民權,2023-09-27,9312
2637,慧洋-KY,7,0,7,華南永昌-民權,2023-09-27,9312
0056,元大高股息,6,0,6,華南永昌-民權,2023-09-27,9312
00893,國泰智能電動車,10,4,6,華南永昌-民權,2023-09-27,9312
1809,中釉,6,0,6,華南永昌-民權,2023-09-27,9312
3051,力特,6,0,6,華南永昌-民權,2023-09-27,9312
2883,凱基金,9,3,6,華南永昌-民權,2023-09-27,9312
00931B,統一美債20年,5,0,5,華南永昌-民權,2023-09-27,9312
00895,富邦未來車,5,0,5,華南永昌-民權,2023-09-27,9312
2332,友訊,5,0,5,華南永昌-民權,2023-09-27,9312
2478,大毅,5,0,5,華南永昌-民權,2023-09-27,9312
2542,興富發,5,0,5,華南永昌-民權,2023-09-27,9312
3049,精金,5,0,5,華南永昌-民權,2023-09-27,9312
6117,迎廣,9,4,5,華南永昌-民權,2023-09-27,9312
8028,昇陽半導體,5,0,5,華南永昌-民權,2023-09-27,9312
1312,國喬,4,0,4,華南永昌-民權,2023-09-27,9312
5432,新門,4,0,4,華南永昌-民權,2023-09-27,9312
3450,聯鈞,5,2,3,華南永昌-民權,2023-09-27,9312
1326,台化,3,0,3,華南永昌-民權,2023-09-27,9312
1608,華榮,5,2,3,華南永昌-民權,2023-09-27,9312
2323,中環,3,0,3,華南永昌-民權,2023-09-27,9312
2324,仁寶,3,0,3,華南永昌-民權,2023-09-27,9312
2344,華邦電,16,13,3,華南永昌-民權,2023-09-27,9312
2880,華南金,3,0,3,華南永昌-民權,2023-09-27,9312
4542,科嶠,14,11,3,華南永昌-民權,2023-09-27,9312
5227,立凱-KY,3,0,3,華南永昌-民權,2023-09-27,9312
5469,瀚宇博,3,0,3,華南永昌-民權,2023-09-27,9312
6126,信音,3,0,3,華南永昌-民權,2023-09-27,9312
6191,精成科,3,0,3,華南永昌-民權,2023-09-27,9312
6288,聯嘉,3,0,3,華南永昌-民權,2023-09-27,9312
6442,光聖,30,27,3,華南永昌-民權,2023-09-27,9312
1402,遠東新,2,0,2,華南永昌-民權,2023-09-27,9312
00720B,元大投資級公司債,2,0,2,華南永昌-民權,2023-09-27,9312
00772B,中信高評級公司債,2,0,2,華南永昌-民權,2023-09-27,9312
00632R,元大台灣50反1,50,0,50,華南永昌-民權,2023-09-28,9312
3324,雙鴻,50,0,50,華南永昌-民權,2023-09-28,9312
3011,今皓,42,0,42,華南永昌-民權,2023-09-28,9312
2002,中鋼,46,5,41,華南永昌-民權,2023-09-28,9312
00929,復華台灣科技優息,40,2,38,華南永昌-民權,2023-09-28,9312
2880,華南金,35,0,35,華南永昌-民權,2023-09-28,9312
2313,華通,35,2,33,華南永昌-民權,2023-09-28,9312
00878,國泰永續高股息,32,0,32,華南永昌-民權,2023-09-28,9312
00907,永豐優息存股,30,0,30,華南永昌-民權,2023-09-28,9312
8112,至上,30,0,30,華南永昌-民權,2023-09-28,9312
2915,潤泰全,16,0,16,華南永昌-民權,2023-09-28,9312
2618,長榮航,14,1,13,華南永昌-民權,2023-09-28,9312
00882,中信中國高股息,12,0,12,華南永昌-民權,2023-09-28,9312
00712,復華富時不動產,12,0,12,華南永昌-民權,2023-09-28,9312
2344,華邦電,213,202,11,華南永昌-民權,2023-09-28,9312
6125,廣運,62,51,11,華南永昌-民權,2023-09-28,9312
3481,群創,10,0,10,華南永昌-民權,2023-09-28,9312
00669R,國泰美國道瓊反1,10,0,10,華南永昌-民權,2023-09-28,9312
2498,宏達電,10,0,10,華南永昌-民權,2023-09-28,9312
3231,緯創,23,13,10,華南永昌-民權,2023-09-28,9312
3325,旭品,13,3,10,華南永昌-民權,2023-09-28,9312
2105,正新,9,0,9,華南永昌-民權,2023-09-28,9312
2816,旺旺保,9,0,9,華南永昌-民權,2023-09-28,9312
6509,聚和,9,0,9,華南永昌-民權,2023-09-28,9312
2417,圓剛,8,0,8,華南永昌-民權,2023-09-28,9312
3058,立德,8,0,8,華南永昌-民權,2023-09-28,9312
5371,中光電,8,0,8,華南永昌-民權,2023-09-28,9312
00713,元大台灣高息低波,7,0,7,華南永昌-民權,2023-09-28,9312
2201,裕隆,7,0,7,華南永昌-民權,2023-09-28,9312
8930,青鋼,8,1,7,華南永昌-民權,2023-09-28,9312
00679B,元大美債20年,6,0,6,華南永昌-民權,2023-09-28,9312
2478,大毅,6,0,6,華南永昌-民權,2023-09-28,9312
3306,鼎天,26,20,6,華南永昌-民權,2023-09-28,9312
4908,前鼎,13,7,6,華南永昌-民權,2023-09-28,9312
2324,仁寶,26,20,6,華南永昌-民權,2023-09-28,9312
2356,英業達,6,1,5,華南永昌-民權,2023-09-28,9312
1313,聯成,5,0,5,華南永昌-民權,2023-09-28,9312
00795B,中信美國公債20年,5,0,5,華南永昌-民權,2023-09-28,9312
00733,富邦臺灣中小,5,0,5,華南永昌-民權,2023-09-28,9312
00633L,富邦上証正2,5,0,5,華南永昌-民權,2023-09-28,9312
2399,映泰,5,0,5,華南永昌-民權,2023-09-28,9312
2408,南亞科,5,0,5,華南永昌-民權,2023-09-28,9312
6269,台郡,5,0,5,華南永昌-民權,2023-09-28,9312
9958,世紀鋼,5,0,5,華南永昌-民權,2023-09-28,9312
0056,元大高股息,20,16,4,華南永昌-民權,2023-09-28,9312
00891,中信關鍵半導體,4,0,4,華南永昌-民權,2023-09-28,9312
00772B,中信高評級公司債,4,0,4,華南永昌-民權,2023-09-28,9312
2369,菱生,4,0,4,華南永昌-民權,2023-09-28,9312
3483,力致,5,1,4,華南永昌-民權,2023-09-28,9312
3034,聯詠,3,0,3,華南永昌-民權,2023-09-28,9312
3036,文曄,133,22,111,華南永昌-民權,2023-10-02,9312
2515,中工,100,0,100,華南永昌-民權,2023-10-02,9312
00929,復華台灣科技優息,72,8,64,華南永昌-民權,2023-10-02,9312
8147,正淩,38,0,38,華南永昌-民權,2023-10-02,9312
6120,達運,33,1,32,華南永昌-民權,2023-10-02,9312
3324,雙鴻,36,6,30,華南永昌-民權,2023-10-02,9312
3630,新鉅科,30,0,30,華南永昌-民權,2023-10-02,9312
2363,矽統,32,7,25,華南永昌-民權,2023-10-02,9312
1524,耿鼎,21,1,20,華南永昌-民權,2023-10-02,9312
9103,美德醫療-DR,17,0,17,華南永昌-民權,2023-10-02,9312
5465,富驊,25,10,15,華南永昌-民權,2023-10-02,9312
2618,長榮航,17,3,14,華南永昌-民權,2023-10-02,9312
2457,飛宏,12,0,12,華南永昌-民權,2023-10-02,9312
1515,力山,12,1,11,華南永昌-民權,2023-10-02,9312
2421,建準,11,0,11,華南永昌-民權,2023-10-02,9312
3014,聯陽,11,0,11,華南永昌-民權,2023-10-02,9312
1440,南紡,10,0,10,華南永昌-民權,2023-10-02,9312
3071,協禧,10,0,10,華南永昌-民權,2023-10-02,9312
5009,榮剛,10,0,10,華南永昌-民權,2023-10-02,9312
6152,百一,10,0,10,華南永昌-民權,2023-10-02,9312
6418,詠昇,10,0,10,華南永昌-民權,2023-10-02,9312
00679B,元大美債20年,8,0,8,華南永昌-民權,2023-10-02,9312
2535,達欣工,8,0,8,華南永昌-民權,2023-10-02,9312
3264,欣銓,8,0,8,華南永昌-民權,2023-10-02,9312
00878,國泰永續高股息,13,5,8,華南永昌-民權,2023-10-02,9312
2002,中鋼,17,10,7,華南永昌-民權,2023-10-02,9312
1618,合機,11,4,7,華南永昌-民權,2023-10-02,9312
2883,凱基金,7,0,7,華南永昌-民權,2023-10-02,9312
8112,至上,7,0,7,華南永昌-民權,2023-10-02,9312
2603,長榮,6,0,6,華南永昌-民權,2023-10-02,9312
00931B,統一美債20年,6,0,6,華南永昌-民權,2023-10-02,9312
00687B,國泰20年美債,6,0,6,華南永昌-民權,2023-10-02,9312
1584,精剛,9,3,6,華南永昌-民權,2023-10-02,9312
2355,敬鵬,8,2,6,華南永昌-民權,2023-10-02,9312
2401,凌陽,13,7,6,華南永昌-民權,2023-10-02,9312
2485,兆赫,6,0,6,華南永昌-民權,2023-10-02,9312
2891,中信金,6,0,6,華南永昌-民權,2023-10-02,9312
3483,力致,21,15,6,華南永昌-民權,2023-10-02,9312
5227,立凱-KY,6,0,6,華南永昌-民權,2023-10-02,9312
4542,科嶠,6,1,5,華南永昌-民權,2023-10-02,9312
00713,元大台灣高息低波,5,0,5,華南永昌-民權,2023-10-02,9312
00706L,期元大S＆P日圓正2,5,0,5,華南永昌-民權,2023-10-02,9312
2206,三陽工業,5,0,5,華南永昌-民權,2023-10-02,9312
2816,旺旺保,5,0,5,華南永昌-民權,2023-10-02,9312
5469,瀚宇博,5,0,5,華南永昌-民權,2023-10-02,9312
6167,久正,5,0,5,華南永昌-民權,2023-10-02,9312
6176,瑞儀,5,0,5,華南永昌-民權,2023-10-02,9312
6417,韋僑,5,0,5,華南永昌-民權,2023-10-02,9312
00772B,中信高評級公司債,4,0,4,華南永昌-民權,2023-10-02,9312
2542,興富發,4,0,4,華南永昌-民權,2023-10-02,9312
2888,新光金,113,0,113,華南永昌-民權,2023-10-03,9312
00882,中信中國高股息,57,0,57,華南永昌-民權,2023-10-03,9312
0056,元大高股息,56,1,55,華南永昌-民權,2023-10-03,9312
00897,富邦基因免疫生技,50,0,50,華南永昌-民權,2023-10-03,9312
00919,群益台灣精選高息,36,0,36,華南永昌-民權,2023-10-03,9312
3481,群創,58,29,29,華南永昌-民權,2023-10-03,9312
2002,中鋼,35,10,25,華南永昌-民權,2023-10-03,9312
2409,友達,31,7,24,華南永昌-民權,2023-10-03,9312
2637,慧洋-KY,22,0,22,華南永昌-民權,2023-10-03,9312
00931B,統一美債20年,20,0,20,華南永昌-民權,2023-10-03,9312
00633L,富邦上証正2,20,0,20,華南永昌-民權,2023-10-03,9312
5426,振發,24,4,20,華南永昌-民權,2023-10-03,9312
3231,緯創,32,15,17,華南永昌-民權,2023-10-03,9312
1514,亞力,40,23,17,華南永昌-民權,2023-10-03,9312
2402,毅嘉,15,0,15,華南永昌-民權,2023-10-03,9312
3325,旭品,18,3,15,華南永昌-民權,2023-10-03,9312
00712,復華富時不動產,14,0,14,華南永昌-民權,2023-10-03,9312
00680L,元大美債20正2,13,0,13,華南永昌-民權,2023-10-03,9312
2618,長榮航,18,6,12,華南永昌-民權,2023-10-03,9312
00720B,元大投資級公司債,12,0,12,華南永昌-民權,2023-10-03,9312
2313,華通,17,6,11,華南永昌-民權,2023-10-03,9312
2329,華泰,13,2,11,華南永昌-民權,2023-10-03,9312
00878,國泰永續高股息,10,0,10,華南永昌-民權,2023-10-03,9312
1409,新纖,11,1,10,華南永昌-民權,2023-10-03,9312
1440,南紡,10,0,10,華南永昌-民權,2023-10-03,9312
2610,華航,11,1,10,華南永昌-民權,2023-10-03,9312
3032,偉訓,11,1,10,華南永昌-民權,2023-10-03,9312
4543,萬在,10,0,10,華南永昌-民權,2023-10-03,9312
00753L,中信中國50正2,9,0,9,華南永昌-民權,2023-10-03,9312
3013,晟銘電,12,4,8,華南永昌-民權,2023-10-03,9312
2457,飛宏,9,1,8,華南永昌-民權,2023-10-03,9312
5521,工信,8,0,8,華南永昌-民權,2023-10-03,9312
6117,迎廣,9,1,8,華南永昌-民權,2023-10-03,9312
6535,順藥,6,0,6,華南永昌-民權,2023-10-03,9312
2376,技嘉,12,7,5,華南永昌-民權,2023-10-03,9312
00930,永豐ESG低碳高息,5,0,5,華南永昌-民權,2023-10-03,9312
1419,新紡,5,0,5,華南永昌-民權,2023-10-03,9312
2352,佳世達,5,0,5,華南永昌-民權,2023-10-03,9312
2405,輔信,5,0,5,華南永昌-民權,2023-10-03,9312
2603,長榮,5,0,5,華南永昌-民權,2023-10-03,9312
2702,華園,5,0,5,華南永昌-民權,2023-10-03,9312
6418,詠昇,5,0,5,華南永昌-民權,2023-10-03,9312
8210,勤誠,21,16,5,華南永昌-民權,2023-10-03,9312
8271,宇瞻,5,0,5,華南永昌-民權,2023-10-03,9312
00772B,中信高評級公司債,4,0,4,華南永昌-民權,2023-10-03,9312
2887,台新金,7,3,4,華南永昌-民權,2023-10-03,9312
1565,精華,4,0,4,華南永昌-民權,2023-10-03,9312
2353,宏��,5,1,4,華南永昌-民權,2023-10-03,9312
2367,燿華,4,0,4,華南永昌-民權,2023-10-03,9312
3406,玉晶光,5,1,4,華南永昌-民權,2023-10-03,9312
00885,富邦越南,209,102,107,華南永昌-民權,2023-10-04,9312
00919,群益台灣精選高息,54,0,54,華南永昌-民權,2023-10-04,9312
3231,緯創,42,6,36,華南永昌-民權,2023-10-04,9312
2618,長榮航,36,3,33,華南永昌-民權,2023-10-04,9312
00782B,國泰A級公用債,30,0,30,華南永昌-民權,2023-10-04,9312
1514,亞力,34,7,27,華南永昌-民權,2023-10-04,9312
00687B,國泰20年美債,24,0,24,華南永昌-民權,2023-10-04,9312
1605,華新,21,0,21,華南永昌-民權,2023-10-04,9312
2002,中鋼,42,22,20,華南永昌-民權,2023-10-04,9312
2329,華泰,21,2,19,華南永昌-民權,2023-10-04,9312
3045,台灣大,16,0,16,華南永昌-民權,2023-10-04,9312
2324,仁寶,15,0,15,華南永昌-民權,2023-10-04,9312
1584,精剛,16,2,14,華南永昌-民權,2023-10-04,9312
00679B,元大美債20年,13,0,13,華南永昌-民權,2023-10-04,9312
00878,國泰永續高股息,13,0,13,華南永昌-民權,2023-10-04,9312
2884,玉山金,14,1,13,華南永昌-民權,2023-10-04,9312
2881,富邦金,13,1,12,華南永昌-民權,2023-10-04,9312
2382,廣達,15,3,12,華南永昌-民權,2023-10-04,9312
2014,中鴻,11,0,11,華南永昌-民權,2023-10-04,9312
00720B,元大投資級公司債,12,1,11,華南永昌-民權,2023-10-04,9312
5880,合庫金,15,5,10,華南永昌-民權,2023-10-04,9312
00929,復華台灣科技優息,10,0,10,華南永昌-民權,2023-10-04,9312
3071,協禧,10,0,10,華南永昌-民權,2023-10-04,9312
00922,國泰台灣領袖50,9,0,9,華南永昌-民權,2023-10-04,9312
3006,晶豪科,61,52,9,華南永昌-民權,2023-10-04,9312
3013,晟銘電,14,5,9,華南永昌-民權,2023-10-04,9312
2303,聯電,9,0,9,華南永昌-民權,2023-10-04,9312
00931B,統一美債20年,8,0,8,華南永昌-民權,2023-10-04,9312
3624,光頡,8,0,8,華南永昌-民權,2023-10-04,9312
00680L,元大美債20正2,27,20,7,華南永昌-民權,2023-10-04,9312
00713,元大台灣高息低波,7,0,7,華南永昌-民權,2023-10-04,9312
6269,台郡,7,0,7,華南永昌-民權,2023-10-04,9312
2330,台積電,6,0,6,華南永昌-民權,2023-10-04,9312
00725B,國泰投資級公司債,6,0,6,華南永昌-民權,2023-10-04,9312
6125,廣運,8,2,6,華南永昌-民權,2023-10-04,9312
6417,韋僑,10,4,6,華南永昌-民權,2023-10-04,9312
1303,南亞,5,0,5,華南永昌-民權,2023-10-04,9312
2399,映泰,5,0,5,華南永昌-民權,2023-10-04,9312
2449,京元電子,5,0,5,華南永昌-民權,2023-10-04,9312
2542,興富發,5,0,5,華南永昌-民權,2023-10-04,9312
2816,旺旺保,7,2,5,華南永昌-民權,2023-10-04,9312
2887,台新金,18,13,5,華南永昌-民權,2023-10-04,9312
3373,熱映,5,0,5,華南永昌-民權,2023-10-04,9312
4192,杏國,5,0,5,華南永昌-民權,2023-10-04,9312
4543,萬在,5,0,5,華南永昌-民權,2023-10-04,9312
8147,正淩,5,0,5,華南永昌-民權,2023-10-04,9312
2880,華南金,4,0,4,華南永昌-民權,2023-10-04,9312
2633,台灣高鐵,4,0,4,華南永昌-民權,2023-10-04,9312
2892,第一金,6,2,4,華南永昌-民權,2023-10-04,9312
00907,永豐優息存股,6,2,4,華南永昌-民權,2023-10-04,9312
2367,燿華,113,1,112,華南永昌-民權,2023-10-05,9312
00712,復華富時不動產,26,4,22,華南永昌-民權,2023-10-05,9312
3325,旭品,43,22,21,華南永昌-民權,2023-10-05,9312
4744,皇將,20,0,20,華南永昌-民權,2023-10-05,9312
2002,中鋼,21,2,19,華南永昌-民權,2023-10-05,9312
8147,正淩,18,0,18,華南永昌-民權,2023-10-05,9312
6156,松上,21,6,15,華南永昌-民權,2023-10-05,9312
1301,台塑,15,0,15,華南永昌-民權,2023-10-05,9312
00671R,富邦NASDAQ反1,13,0,13,華南永昌-民權,2023-10-05,9312
2884,玉山金,11,0,11,華南永昌-民權,2023-10-05,9312
3481,群創,13,3,10,華南永昌-民權,2023-10-05,9312
3032,偉訓,11,3,8,華南永昌-民權,2023-10-05,9312
3231,緯創,32,25,7,華南永昌-民權,2023-10-05,9312
3289,宜特,7,0,7,華南永昌-民權,2023-10-05,9312
2637,慧洋-KY,7,0,7,華南永昌-民權,2023-10-05,9312
2382,廣達,18,12,6,華南永昌-民權,2023-10-05,9312
2313,華通,7,1,6,華南永昌-民權,2023-10-05,9312
4942,嘉彰,6,0,6,華南永昌-民權,2023-10-05,9312
6417,韋僑,6,0,6,華南永昌-民權,2023-10-05,9312
1785,光洋科,5,0,5,華南永昌-民權,2023-10-05,9312
2457,飛宏,8,3,5,華南永昌-民權,2023-10-05,9312
2882,國泰金,5,0,5,華南永昌-民權,2023-10-05,9312
3450,聯鈞,7,2,5,華南永昌-民權,2023-10-05,9312
6126,信音,5,0,5,華南永昌-民權,2023-10-05,9312
6167,久正,5,0,5,華南永昌-民權,2023-10-05,9312
6269,台郡,5,0,5,華南永昌-民權,2023-10-05,9312
6288,聯嘉,8,3,5,華南永昌-民權,2023-10-05,9312
2834,臺企銀,4,0,4,華南永昌-民權,2023-10-05,9312
00715L,期街口布蘭特正2,4,0,4,華南永昌-民權,2023-10-05,9312
00919,群益台灣精選高息,4,0,4,華南永昌-民權,2023-10-05,9312
3260,威剛,4,0,4,華南永昌-民權,2023-10-05,9312
2303,聯電,8,5,3,華南永昌-民權,2023-10-05,9312
1101,台泥,5,2,3,華南永昌-民權,2023-10-05,9312
3006,晶豪科,3,0,3,華南永昌-民權,2023-10-05,9312
00929,復華台灣科技優息,4,1,3,華南永昌-民權,2023-10-05,9312
2201,裕隆,3,0,3,華南永昌-民權,2023-10-05,9312
2301,光寶科,5,2,3,華南永昌-民權,2023-10-05,9312
2603,長榮,3,0,3,華南永昌-民權,2023-10-05,9312
2641,正德,3,0,3,華南永昌-民權,2023-10-05,9312
3265,台星科,3,0,3,華南永昌-民權,2023-10-05,9312
4933,友輝,3,0,3,華南永昌-民權,2023-10-05,9312
5403,中菲,3,0,3,華南永昌-民權,2023-10-05,9312
6120,達運,103,100,3,華南永昌-民權,2023-10-05,9312
8011,台通,7,4,3,華南永昌-民權,2023-10-05,9312
9919,康那香,3,0,3,華南永昌-民權,2023-10-05,9312
6451,訊芯-KY,3,0,3,華南永昌-民權,2023-10-05,9312
2883,凱基金,3,0,3,華南永昌-民權,2023-10-05,9312
4967,十銓,2,0,2,華南永昌-民權,2023-10-05,9312
2887,台新金,25,23,2,華南永昌-民權,2023-10-05,9312
2609,陽明,2,0,2,華南永昌-民權,2023-10-05,9312
3702,大聯大,90,0,90,華南永昌-民權,2023-10-06,9312
2329,華泰,93,16,77,華南永昌-民權,2023-10-06,9312
4927,泰鼎-KY,72,1,71,華南永昌-民權,2023-10-06,9312
3324,雙鴻,51,1,50,華南永昌-民權,2023-10-06,9312
8147,正淩,42,0,42,華南永昌-民權,2023-10-06,9312
6187,萬潤,30,0,30,華南永昌-民權,2023-10-06,9312
2618,長榮航,27,0,27,華南永昌-民權,2023-10-06,9312
2324,仁寶,29,4,25,華南永昌-民權,2023-10-06,9312
00919,群益台灣精選高息,23,0,23,華南永昌-民權,2023-10-06,9312
5880,合庫金,21,0,21,華南永昌-民權,2023-10-06,9312
6122,擎邦,16,0,16,華南永昌-民權,2023-10-06,9312
3617,碩天,35,20,15,華南永昌-民權,2023-10-06,9312
00929,復華台灣科技優息,14,1,13,華南永昌-民權,2023-10-06,9312
0056,元大高股息,13,0,13,華南永昌-民權,2023-10-06,9312
9105,泰金寶-DR,76,63,13,華南永昌-民權,2023-10-06,9312
00878,國泰永續高股息,12,0,12,華南永昌-民權,2023-10-06,9312
2365,昆盈,14,3,11,華南永昌-民權,2023-10-06,9312
2312,金寶,10,0,10,華南永昌-民權,2023-10-06,9312
9802,鈺齊-KY,10,0,10,華南永昌-民權,2023-10-06,9312
00915,凱基優選高股息30,8,0,8,華南永昌-民權,2023-10-06,9312
2485,兆赫,8,0,8,華南永昌-民權,2023-10-06,9312
4942,嘉彰,8,0,8,華南永昌-民權,2023-10-06,9312
3481,群創,19,11,8,華南永昌-民權,2023-10-06,9312
5351,鈺創,11,4,7,華南永昌-民權,2023-10-06,9312
3231,緯創,21,14,7,華南永昌-民權,2023-10-06,9312
2449,京元電子,9,3,6,華南永昌-民權,2023-10-06,9312
6274,台燿,7,1,6,華南永昌-民權,2023-10-06,9312
1101,台泥,7,1,6,華南永昌-民權,2023-10-06,9312
00918,大華優利高填息30,6,0,6,華南永昌-民權,2023-10-06,9312
00679B,元大美債20年,6,0,6,華南永昌-民權,2023-10-06,9312
3017,奇鋐,11,5,6,華南永昌-民權,2023-10-06,9312
3059,華晶科,6,0,6,華南永昌-民權,2023-10-06,9312
9919,康那香,7,1,6,華南永昌-民權,2023-10-06,9312
4763,材料-KY,12,7,5,華南永昌-民權,2023-10-06,9312
00922,國泰台灣領袖50,5,0,5,華南永昌-民權,2023-10-06,9312
00712,復華富時不動產,12,7,5,華南永昌-民權,2023-10-06,9312
2460,建通,5,0,5,華南永昌-民權,2023-10-06,9312
3380,明泰,5,0,5,華南永昌-民權,2023-10-06,9312
4743,合一,5,0,5,華南永昌-民權,2023-10-06,9312
4968,立積,5,0,5,華南永昌-民權,2023-10-06,9312
5258,虹堡,5,0,5,華南永昌-民權,2023-10-06,9312
6126,信音,5,0,5,華南永昌-民權,2023-10-06,9312
6417,韋僑,6,1,5,華南永昌-民權,2023-10-06,9312
00885,富邦越南,4,0,4,華南永昌-民權,2023-10-06,9312
3260,威剛,5,1,4,華南永昌-民權,2023-10-06,9312
00751B,元大AAA至A公司債,3,0,3,華南永昌-民權,2023-10-06,9312
2409,友達,6,3,3,華南永昌-民權,2023-10-06,9312
1513,中興電,3,0,3,華南永昌-民權,2023-10-06,9312
1305,華夏,3,0,3,華南永昌-民權,2023-10-06,9312
00772B,中信高評級公司債,3,0,3,華南永昌-民權,2023-10-06,9312
00878,國泰永續高股息,91,0,91,華南永昌-民權,2023-10-11,9312
3231,緯創,73,11,62,華南永昌-民權,2023-10-11,9312
0056,元大高股息,61,0,61,華南永昌-民權,2023-10-11,9312
00919,群益台灣精選高息,50,0,50,華南永昌-民權,2023-10-11,9312
6672,騰輝電子-KY,27,0,27,華南永昌-民權,2023-10-11,9312
00713,元大台灣高息低波,22,0,22,華南永昌-民權,2023-10-11,9312
6138,茂達,21,0,21,華南永昌-民權,2023-10-11,9312
1524,耿鼎,20,0,20,華南永昌-民權,2023-10-11,9312
3652,精聯,20,0,20,華南永昌-民權,2023-10-11,9312
00679B,元大美債20年,17,2,15,華南永昌-民權,2023-10-11,9312
2405,輔信,13,0,13,華南永昌-民權,2023-10-11,9312
3715,定穎投控,34,22,12,華南永昌-民權,2023-10-11,9312
2002,中鋼,12,0,12,華南永昌-民權,2023-10-11,9312
1471,首利,11,0,11,華南永昌-民權,2023-10-11,9312
2388,威盛,11,0,11,華南永昌-民權,2023-10-11,9312
6901,鑽石投資,11,1,10,華南永昌-民權,2023-10-11,9312
5340,建榮,10,0,10,華南永昌-民權,2023-10-11,9312
6417,韋僑,14,4,10,華南永昌-民權,2023-10-11,9312
8147,正淩,13,3,10,華南永昌-民權,2023-10-11,9312
8215,明基材,10,0,10,華南永昌-民權,2023-10-11,9312
2208,台船,10,1,9,華南永昌-民權,2023-10-11,9312
4931,新盛力,9,0,9,華南永昌-民權,2023-10-11,9312
5351,鈺創,10,1,9,華南永昌-民權,2023-10-11,9312
2329,華泰,11,3,8,華南永昌-民權,2023-10-11,9312
2542,興富發,8,0,8,華南永昌-民權,2023-10-11,9312
4533,協易機,8,0,8,華南永昌-民權,2023-10-11,9312
2603,長榮,9,2,7,華南永昌-民權,2023-10-11,9312
2707,晶華,7,0,7,華南永昌-民權,2023-10-11,9312
2376,技嘉,7,0,7,華南永昌-民權,2023-10-11,9312
1513,中興電,7,0,7,華南永昌-民權,2023-10-11,9312
1609,大亞,8,1,7,華南永昌-民權,2023-10-11,9312
2610,華航,6,0,6,華南永昌-民權,2023-10-11,9312
00715L,期街口布蘭特正2,9,3,6,華南永昌-民權,2023-10-11,9312
1752,南光,8,2,6,華南永昌-民權,2023-10-11,9312
2743,山富,6,0,6,華南永昌-民權,2023-10-11,9312
3118,進階,6,0,6,華南永昌-民權,2023-10-11,9312
6120,達運,6,0,6,華南永昌-民權,2023-10-11,9312
3675,德微,5,0,5,華南永昌-民權,2023-10-11,9312
1565,精華,5,0,5,華南永昌-民權,2023-10-11,9312
2618,長榮航,13,8,5,華南永昌-民權,2023-10-11,9312
3078,僑威,5,0,5,華南永昌-民權,2023-10-11,9312
3622,洋華,5,0,5,華南永昌-民權,2023-10-11,9312
6187,萬潤,70,65,5,華南永昌-民權,2023-10-11,9312
00772B,中信高評級公司債,4,0,4,華南永昌-民權,2023-10-11,9312
1305,華夏,4,0,4,華南永昌-民權,2023-10-11,9312
1777,生泰,4,0,4,華南永昌-民權,2023-10-11,9312
2425,承啟,9,5,4,華南永昌-民權,2023-10-11,9312
2607,榮運,4,0,4,華南永昌-民權,2023-10-11,9312
3025,星通,5,1,4,華南永昌-民權,2023-10-11,9312
3706,神達,5,1,4,華南永昌-民權,2023-10-11,9312
3078,僑威,100,9,91,華南永昌-民權,2023-10-12,9312
2883,凱基金,80,3,77,華南永昌-民權,2023-10-12,9312
00919,群益台灣精選高息,72,10,62,華南永昌-民權,2023-10-12,9312
2376,技嘉,94,42,52,華南永昌-民權,2023-10-12,9312
2610,華航,36,3,33,華南永昌-民權,2023-10-12,9312
2402,毅嘉,31,0,31,華南永昌-民權,2023-10-12,9312
00679B,元大美債20年,22,0,22,華南永昌-民權,2023-10-12,9312
2324,仁寶,20,0,20,華南永昌-民權,2023-10-12,9312
3617,碩天,31,12,19,華南永昌-民權,2023-10-12,9312
0056,元大高股息,18,0,18,華南永昌-民權,2023-10-12,9312
2605,新興,12,1,11,華南永昌-民權,2023-10-12,9312
00715L,期街口布蘭特正2,11,0,11,華南永昌-民權,2023-10-12,9312
3014,聯陽,12,1,11,華南永昌-民權,2023-10-12,9312
5608,四維航,10,0,10,華南永昌-民權,2023-10-12,9312
2609,陽明,12,2,10,華南永昌-民權,2023-10-12,9312
1514,亞力,9,0,9,華南永昌-民權,2023-10-12,9312
2105,正新,10,1,9,華南永昌-民權,2023-10-12,9312
2356,英業達,8,0,8,華南永昌-民權,2023-10-12,9312
6417,韋僑,7,0,7,華南永昌-民權,2023-10-12,9312
2337,旺宏,8,2,6,華南永昌-民權,2023-10-12,9312
3325,旭品,17,11,6,華南永昌-民權,2023-10-12,9312
6156,松上,8,3,5,華南永昌-民權,2023-10-12,9312
2449,京元電子,6,1,5,華南永昌-民權,2023-10-12,9312
1219,福壽,5,0,5,華南永昌-民權,2023-10-12,9312
00923,群益台ESG低碳50,5,0,5,華南永昌-民權,2023-10-12,9312
1809,中釉,5,0,5,華南永昌-民權,2023-10-12,9312
2208,台船,5,0,5,華南永昌-民權,2023-10-12,9312
2885,元大金,5,0,5,華南永昌-民權,2023-10-12,9312
3051,力特,7,2,5,華南永昌-民權,2023-10-12,9312
3236,千如,5,0,5,華南永昌-民權,2023-10-12,9312
4171,瑞基,5,0,5,華南永昌-民權,2023-10-12,9312
6288,聯嘉,5,0,5,華南永昌-民權,2023-10-12,9312
8147,正淩,5,0,5,華南永昌-民權,2023-10-12,9312
1319,東陽,11,7,4,華南永昌-民權,2023-10-12,9312
2323,中環,4,0,4,華南永昌-民權,2023-10-12,9312
4714,永捷,4,0,4,華南永昌-民權,2023-10-12,9312
4927,泰鼎-KY,5,1,4,華南永昌-民權,2023-10-12,9312
8085,福華,12,8,4,華南永昌-民權,2023-10-12,9312
00922,國泰台灣領袖50,3,0,3,華南永昌-民權,2023-10-12,9312
2243,宏旭-KY,3,0,3,華南永昌-民權,2023-10-12,9312
2413,環科,3,0,3,華南永昌-民權,2023-10-12,9312
2468,華經,24,21,3,華南永昌-民權,2023-10-12,9312
2887,台新金,15,12,3,華南永昌-民權,2023-10-12,9312
3227,原相,3,0,3,華南永昌-民權,2023-10-12,9312
3264,欣銓,3,0,3,華南永昌-民權,2023-10-12,9312
3303,岱稜,3,0,3,華南永昌-民權,2023-10-12,9312
6122,擎邦,3,0,3,華南永昌-民權,2023-10-12,9312
6231,系微,4,1,3,華南永昌-民權,2023-10-12,9312
2382,廣達,24,21,3,華南永昌-民權,2023-10-12,9312
2881,富邦金,2,0,2,華南永昌-民權,2023-10-12,9312
2618,長榮航,54,0,54,華南永昌-民權,2023-10-13,9312
2363,矽統,60,21,39,華南永昌-民權,2023-10-13,9312
3231,緯創,40,10,30,華南永昌-民權,2023-10-13,9312
6550,北極星藥業-KY,30,1,29,華南永昌-民權,2023-10-13,9312
00931B,統一美債20年,26,0,26,華南永昌-民權,2023-10-13,9312
00922,國泰台灣領袖50,22,0,22,華南永昌-民權,2023-10-13,9312
2002,中鋼,24,2,22,華南永昌-民權,2023-10-13,9312
3450,聯鈞,28,6,22,華南永昌-民權,2023-10-13,9312
3324,雙鴻,50,30,20,華南永昌-民權,2023-10-13,9312
6005,群益證,20,0,20,華南永昌-民權,2023-10-13,9312
2331,精英,20,1,19,華南永昌-民權,2023-10-13,9312
6138,茂達,18,0,18,華南永昌-民權,2023-10-13,9312
4927,泰鼎-KY,17,0,17,華南永昌-民權,2023-10-13,9312
00878,國泰永續高股息,19,3,16,華南永昌-民權,2023-10-13,9312
2301,光寶科,23,8,15,華南永昌-民權,2023-10-13,9312
1414,東和,15,0,15,華南永昌-民權,2023-10-13,9312
2324,仁寶,15,0,15,華南永昌-民權,2023-10-13,9312
2329,華泰,15,0,15,華南永昌-民權,2023-10-13,9312
00680L,元大美債20正2,14,0,14,華南永昌-民權,2023-10-13,9312
3652,精聯,13,0,13,華南永昌-民權,2023-10-13,9312
3706,神達,15,2,13,華南永昌-民權,2023-10-13,9312
3037,欣興,18,5,13,華南永昌-民權,2023-10-13,9312
1905,華紙,12,0,12,華南永昌-民權,2023-10-13,9312
00900,富邦特選高股息30,11,0,11,華南永昌-民權,2023-10-13,9312
6417,韋僑,13,2,11,華南永昌-民權,2023-10-13,9312
2014,中鴻,10,0,10,華南永昌-民權,2023-10-13,9312
00722B,群益投資級電信債,20,10,10,華南永昌-民權,2023-10-13,9312
2382,廣達,20,11,9,華南永昌-民權,2023-10-13,9312
00679B,元大美債20年,9,0,9,華南永昌-民權,2023-10-13,9312
3013,晟銘電,8,0,8,華南永昌-民權,2023-10-13,9312
00772B,中信高評級公司債,8,0,8,華南永昌-民權,2023-10-13,9312
1504,東元,8,0,8,華南永昌-民權,2023-10-13,9312
1524,耿鼎,17,10,7,華南永昌-民權,2023-10-13,9312
3014,聯陽,7,0,7,華南永昌-民權,2023-10-13,9312
3406,玉晶光,7,0,7,華南永昌-民權,2023-10-13,9312
00671R,富邦NASDAQ反1,8,2,6,華南永昌-民權,2023-10-13,9312
00720B,元大投資級公司債,11,5,6,華南永昌-民權,2023-10-13,9312
1568,倉佑,6,0,6,華南永昌-民權,2023-10-13,9312
3305,昇貿,6,0,6,華南永昌-民權,2023-10-13,9312
00795B,中信美國公債20年,5,0,5,華南永昌-民權,2023-10-13,9312
1815,富喬,7,2,5,華南永昌-民權,2023-10-13,9312
2405,輔信,8,3,5,華南永昌-民權,2023-10-13,9312
2426,鼎元,5,0,5,華南永昌-民權,2023-10-13,9312
5371,中光電,5,0,5,華南永昌-民權,2023-10-13,9312
5469,瀚宇博,5,0,5,華南永昌-民權,2023-10-13,9312
6288,聯嘉,5,0,5,華南永昌-民權,2023-10-13,9312
00751B,元大AAA至A公司債,4,0,4,華南永昌-民權,2023-10-13,9312
1909,榮成,4,0,4,華南永昌-民權,2023-10-13,9312
2323,中環,7,3,4,華南永昌-民權,2023-10-13,9312
2488,漢平,4,0,4,華南永昌-民權,2023-10-13,9312
00720B,元大投資級公司債,703,2,701,華南永昌-民權,2023-10-16,9312
00712,復華富時不動產,112,4,108,華南永昌-民權,2023-10-16,9312
6187,萬潤,60,0,60,華南永昌-民權,2023-10-16,9312
2515,中工,79,20,59,華南永昌-民權,2023-10-16,9312
00929,復華台灣科技優息,51,0,51,華南永昌-民權,2023-10-16,9312
00922,國泰台灣領袖50,42,0,42,華南永昌-民權,2023-10-16,9312
2344,華邦電,36,11,25,華南永昌-民權,2023-10-16,9312
8112,至上,21,0,21,華南永昌-民權,2023-10-16,9312
2323,中環,23,3,20,華南永昌-民權,2023-10-16,9312
2605,新興,20,0,20,華南永昌-民權,2023-10-16,9312
0056,元大高股息,21,1,20,華南永昌-民權,2023-10-16,9312
3652,精聯,17,0,17,華南永昌-民權,2023-10-16,9312
1314,中石化,135,119,16,華南永昌-民權,2023-10-16,9312
1524,耿鼎,20,4,16,華南永昌-民權,2023-10-16,9312
6417,韋僑,18,2,16,華南永昌-民權,2023-10-16,9312
00878,國泰永續高股息,16,2,14,華南永昌-民權,2023-10-16,9312
6274,台燿,14,1,13,華南永昌-民權,2023-10-16,9312
5347,世界,11,0,11,華南永昌-民權,2023-10-16,9312
3706,神達,19,8,11,華南永昌-民權,2023-10-16,9312
5521,工信,10,0,10,華南永昌-民權,2023-10-16,9312
2867,三商壽,9,0,9,華南永昌-民權,2023-10-16,9312
3014,聯陽,10,1,9,華南永昌-民權,2023-10-16,9312
3483,力致,10,1,9,華南永昌-民權,2023-10-16,9312
2201,裕隆,14,6,8,華南永昌-民權,2023-10-16,9312
2108,南帝,8,0,8,華南永昌-民權,2023-10-16,9312
00671R,富邦NASDAQ反1,10,3,7,華南永昌-民權,2023-10-16,9312
2382,廣達,7,0,7,華南永昌-民權,2023-10-16,9312
2317,鴻海,15,8,7,華南永昌-民權,2023-10-16,9312
1605,華新,8,2,6,華南永昌-民權,2023-10-16,9312
00919,群益台灣精選高息,6,0,6,華南永昌-民權,2023-10-16,9312
2002,中鋼,8,2,6,華南永昌-民權,2023-10-16,9312
2107,厚生,6,0,6,華南永昌-民權,2023-10-16,9312
2743,山富,6,0,6,華南永昌-民權,2023-10-16,9312
4908,前鼎,23,17,6,華南永昌-民權,2023-10-16,9312
2204,中華,5,0,5,華南永昌-民權,2023-10-16,9312
6282,康舒,5,0,5,華南永昌-民權,2023-10-16,9312
2338,光罩,5,0,5,華南永昌-民權,2023-10-16,9312
3260,威剛,5,0,5,華南永昌-民權,2023-10-16,9312
3325,旭品,47,42,5,華南永昌-民權,2023-10-16,9312
6535,順藥,5,0,5,華南永昌-民權,2023-10-16,9312
3231,緯創,40,36,4,華南永昌-民權,2023-10-16,9312
3013,晟銘電,4,0,4,華南永昌-民權,2023-10-16,9312
8996,高力,4,0,4,華南永昌-民權,2023-10-16,9312
00888,永豐台灣ESG,4,0,4,華南永昌-民權,2023-10-16,9312
3305,昇貿,4,0,4,華南永昌-民權,2023-10-16,9312
4714,永捷,4,0,4,華南永昌-民權,2023-10-16,9312
8182,加高,5,1,4,華南永昌-民權,2023-10-16,9312
2330,台積電,3,0,3,華南永昌-民權,2023-10-16,9312
2834,臺企銀,4,1,3,華南永昌-民權,2023-10-16,9312
1301,台塑,3,0,3,華南永昌-民權,2023-10-16,9312
00715L,期街口布蘭特正2,112,0,112,華南永昌-民權,2023-10-17,9312
0056,元大高股息,66,3,63,華南永昌-民權,2023-10-17,9312
6417,韋僑,41,1,40,華南永昌-民權,2023-10-17,9312
3231,緯創,185,154,31,華南永昌-民權,2023-10-17,9312
8437,大地-KY,23,0,23,華南永昌-民權,2023-10-17,9312
2208,台船,20,0,20,華南永昌-民權,2023-10-17,9312
2103,台橡,20,0,20,華南永昌-民權,2023-10-17,9312
2374,佳能,20,0,20,華南永昌-民權,2023-10-17,9312
3652,精聯,20,0,20,華南永昌-民權,2023-10-17,9312
8112,至上,20,0,20,華南永昌-民權,2023-10-17,9312
00878,國泰永續高股息,19,0,19,華南永昌-民權,2023-10-17,9312
2618,長榮航,27,11,16,華南永昌-民權,2023-10-17,9312
9928,中視,16,0,16,華南永昌-民權,2023-10-17,9312
2367,燿華,20,5,15,華南永昌-民權,2023-10-17,9312
8390,金益鼎,15,0,15,華南永昌-民權,2023-10-17,9312
2002,中鋼,34,20,14,華南永昌-民權,2023-10-17,9312
00631L,元大台灣50正2,13,0,13,華南永昌-民權,2023-10-17,9312
2352,佳世達,13,0,13,華南永昌-民權,2023-10-17,9312
00679B,元大美債20年,12,0,12,華南永昌-民權,2023-10-17,9312
2317,鴻海,22,10,12,華南永昌-民權,2023-10-17,9312
2634,漢翔,12,0,12,華南永昌-民權,2023-10-17,9312
00687B,國泰20年美債,11,0,11,華南永昌-民權,2023-10-17,9312
2313,華通,11,0,11,華南永昌-民權,2023-10-17,9312
2891,中信金,12,1,11,華南永昌-民權,2023-10-17,9312
6530,創威,11,0,11,華南永昌-民權,2023-10-17,9312
00633L,富邦上証正2,11,1,10,華南永昌-民權,2023-10-17,9312
2362,藍天,10,0,10,華南永昌-民權,2023-10-17,9312
2369,菱生,14,4,10,華南永昌-民權,2023-10-17,9312
00680L,元大美債20正2,9,0,9,華南永昌-民權,2023-10-17,9312
2457,飛宏,9,0,9,華南永昌-民權,2023-10-17,9312
00922,國泰台灣領袖50,8,0,8,華南永昌-民權,2023-10-17,9312
3376,新日興,8,0,8,華南永昌-民權,2023-10-17,9312
2301,光寶科,15,8,7,華南永昌-民權,2023-10-17,9312
2329,華泰,8,1,7,華南永昌-民權,2023-10-17,9312
3483,力致,9,2,7,華南永昌-民權,2023-10-17,9312
8996,高力,24,17,7,華南永昌-民權,2023-10-17,9312
2610,華航,9,3,6,華南永昌-民權,2023-10-17,9312
3025,星通,10,4,6,華南永昌-民權,2023-10-17,9312
8054,安國,6,0,6,華南永昌-民權,2023-10-17,9312
3078,僑威,6,0,6,華南永昌-民權,2023-10-17,9312
3029,零壹,7,2,5,華南永昌-民權,2023-10-17,9312
00772B,中信高評級公司債,5,0,5,華南永昌-民權,2023-10-17,9312
00726B,國泰新興投等債,5,0,5,華南永昌-民權,2023-10-17,9312
1905,華紙,5,0,5,華南永昌-民權,2023-10-17,9312
2478,大毅,5,0,5,華南永昌-民權,2023-10-17,9312
3062,建漢,5,0,5,華南永昌-民權,2023-10-17,9312
3289,宜特,5,0,5,華南永昌-民權,2023-10-17,9312
3617,碩天,5,0,5,華南永昌-民權,2023-10-17,9312
3701,大眾控,5,0,5,華南永昌-民權,2023-10-17,9312
6187,萬潤,5,0,5,華南永昌-民權,2023-10-17,9312
0056,元大高股息,82,6,76,華南永昌-民權,2023-10-18,9312
00929,復華台灣科技優息,72,0,72,華南永昌-民權,2023-10-18,9312
00922,國泰台灣領袖50,63,0,63,華南永昌-民權,2023-10-18,9312
2610,華航,65,11,54,華南永昌-民權,2023-10-18,9312
00919,群益台灣精選高息,36,0,36,華南永昌-民權,2023-10-18,9312
2388,威盛,35,4,31,華南永昌-民權,2023-10-18,9312
00878,國泰永續高股息,30,0,30,華南永昌-民權,2023-10-18,9312
6417,韋僑,28,2,26,華南永昌-民權,2023-10-18,9312
2618,長榮航,26,3,23,華南永昌-民權,2023-10-18,9312
2201,裕隆,26,4,22,華南永昌-民權,2023-10-18,9312
3481,群創,38,17,21,華南永昌-民權,2023-10-18,9312
3652,精聯,20,0,20,華南永昌-民權,2023-10-18,9312
5340,建榮,20,0,20,華南永昌-民權,2023-10-18,9312
3588,通嘉,22,4,18,華南永昌-民權,2023-10-18,9312
4905,台聯電,17,0,17,華南永昌-民權,2023-10-18,9312
2344,華邦電,28,12,16,華南永昌-民權,2023-10-18,9312
00753L,中信中國50正2,15,0,15,華南永昌-民權,2023-10-18,9312
00720B,元大投資級公司債,14,0,14,華南永昌-民權,2023-10-18,9312
2313,華通,13,0,13,華南永昌-民權,2023-10-18,9312
6274,台燿,13,0,13,華南永昌-民權,2023-10-18,9312
2330,台積電,13,0,13,華南永昌-民權,2023-10-18,9312
1815,富喬,13,1,12,華南永昌-民權,2023-10-18,9312
2367,燿華,12,0,12,華南永昌-民權,2023-10-18,9312
2915,潤泰全,12,0,12,華南永昌-民權,2023-10-18,9312
4908,前鼎,18,6,12,華南永昌-民權,2023-10-18,9312
2382,廣達,27,16,11,華南永昌-民權,2023-10-18,9312
00885,富邦越南,12,1,11,華南永昌-民權,2023-10-18,9312
3231,緯創,48,37,11,華南永昌-民權,2023-10-18,9312
1513,中興電,11,1,10,華南永昌-民權,2023-10-18,9312
2359,所羅門,10,0,10,華南永昌-民權,2023-10-18,9312
8076,伍豐,10,0,10,華南永昌-民權,2023-10-18,9312
8112,至上,10,0,10,華南永昌-民權,2023-10-18,9312
1419,新紡,9,0,9,華南永昌-民權,2023-10-18,9312
8028,昇陽半導體,10,1,9,華南永昌-民權,2023-10-18,9312
00932,兆豐永續高息等權,8,0,8,華南永昌-民權,2023-10-18,9312
00931B,統一美債20年,8,0,8,華南永昌-民權,2023-10-18,9312
2884,玉山金,8,0,8,華南永昌-民權,2023-10-18,9312
2002,中鋼,28,20,8,華南永昌-民權,2023-10-18,9312
00687B,國泰20年美債,7,0,7,華南永昌-民權,2023-10-18,9312
1609,大亞,8,1,7,華南永昌-民權,2023-10-18,9312
3305,昇貿,6,0,6,華南永昌-民權,2023-10-18,9312
3317,尼克森,6,0,6,華南永昌-民權,2023-10-18,9312
4174,浩鼎,6,0,6,華南永昌-民權,2023-10-18,9312
8210,勤誠,17,11,6,華南永昌-民權,2023-10-18,9312
1414,東和,5,0,5,華南永昌-民權,2023-10-18,9312
1713,國化,5,0,5,華南永昌-民權,2023-10-18,9312
2457,飛宏,7,2,5,華南永昌-民權,2023-10-18,9312
2478,大毅,5,0,5,華南永昌-民權,2023-10-18,9312
3289,宜特,5,0,5,華南永昌-民權,2023-10-18,9312
3483,力致,5,0,5,華南永昌-民權,2023-10-18,9312
3481,群創,307,8,299,華南永昌-民權,2023-10-19,9312
0056,元大高股息,59,5,54,華南永昌-民權,2023-10-19,9312
2317,鴻海,129,86,43,華南永昌-民權,2023-10-19,9312
2515,中工,38,6,32,華南永昌-民權,2023-10-19,9312
1314,中石化,31,2,29,華南永昌-民權,2023-10-19,9312
00878,國泰永續高股息,48,26,22,華南永昌-民權,2023-10-19,9312
00885,富邦越南,22,0,22,華南永昌-民權,2023-10-19,9312
00719B,元大美債1-3,20,0,20,華南永昌-民權,2023-10-19,9312
1618,合機,20,0,20,華南永昌-民權,2023-10-19,9312
2103,台橡,20,0,20,華南永昌-民權,2023-10-19,9312
00929,復華台灣科技優息,22,5,17,華南永昌-民權,2023-10-19,9312
00893,國泰智能電動車,17,0,17,華南永昌-民權,2023-10-19,9312
00720B,元大投資級公司債,18,7,11,華南永昌-民權,2023-10-19,9312
00633L,富邦上証正2,11,0,11,華南永昌-民權,2023-10-19,9312
1568,倉佑,11,0,11,華南永昌-民權,2023-10-19,9312
4128,中天,11,0,11,華南永昌-民權,2023-10-19,9312
00687B,國泰20年美債,13,3,10,華南永昌-民權,2023-10-19,9312
2014,中鴻,10,0,10,華南永昌-民權,2023-10-19,9312
2915,潤泰全,10,0,10,華南永昌-民權,2023-10-19,9312
4919,新唐,10,0,10,華南永昌-民權,2023-10-19,9312
1101,台泥,11,2,9,華南永昌-民權,2023-10-19,9312
00680L,元大美債20正2,16,7,9,華南永昌-民權,2023-10-19,9312
2388,威盛,21,13,8,華南永昌-民權,2023-10-19,9312
2301,光寶科,9,1,8,華南永昌-民權,2023-10-19,9312
00919,群益台灣精選高息,7,0,7,華南永昌-民權,2023-10-19,9312
2402,毅嘉,9,2,7,華南永昌-民權,2023-10-19,9312
2888,新光金,7,0,7,華南永昌-民權,2023-10-19,9312
3305,昇貿,7,0,7,華南永昌-民權,2023-10-19,9312
8150,南茂,7,0,7,華南永昌-民權,2023-10-19,9312
5483,中美晶,7,0,7,華南永昌-民權,2023-10-19,9312
00679B,元大美債20年,6,0,6,華南永昌-民權,2023-10-19,9312
6187,萬潤,6,0,6,華南永昌-民權,2023-10-19,9312
00922,國泰台灣領袖50,6,0,6,華南永昌-民權,2023-10-19,9312
3617,碩天,16,10,6,華南永昌-民權,2023-10-19,9312
6417,韋僑,6,0,6,華南永昌-民權,2023-10-19,9312
2891,中信金,5,0,5,華南永昌-民權,2023-10-19,9312
00888,永豐台灣ESG,5,0,5,華南永昌-民權,2023-10-19,9312
00751B,元大AAA至A公司債,5,0,5,華南永昌-民權,2023-10-19,9312
1809,中釉,5,0,5,華南永昌-民權,2023-10-19,9312
3209,全科,5,0,5,華南永昌-民權,2023-10-19,9312
6799,來頡,5,0,5,華南永昌-民權,2023-10-19,9312
6835,圓裕,5,0,5,華南永昌-民權,2023-10-19,9312
8069,元太,5,0,5,華南永昌-民權,2023-10-19,9312
6526,達發,4,0,4,華南永昌-民權,2023-10-19,9312
00795B,中信美國公債20年,4,0,4,華南永昌-民權,2023-10-19,9312
1736,喬山,4,0,4,華南永昌-民權,2023-10-19,9312
1815,富喬,4,0,4,華南永昌-民權,2023-10-19,9312
2884,玉山金,4,0,4,華南永昌-民權,2023-10-19,9312
3376,新日興,4,0,4,華南永昌-民權,2023-10-19,9312
6168,宏齊,7,3,4,華南永昌-民權,2023-10-19,9312
00877,復華中國5G,100,0,100,華南永昌-民權,2023-10-20,9312
6187,萬潤,68,3,65,華南永昌-民權,2023-10-20,9312
00712,復華富時不動產,46,1,45,華南永昌-民權,2023-10-20,9312
3081,聯亞,45,5,40,華南永昌-民權,2023-10-20,9312
2014,中鴻,32,0,32,華南永昌-民權,2023-10-20,9312
4927,泰鼎-KY,29,0,29,華南永昌-民權,2023-10-20,9312
2888,新光金,26,0,26,華南永昌-民權,2023-10-20,9312
00878,國泰永續高股息,31,7,24,華南永昌-民權,2023-10-20,9312
2344,華邦電,26,3,23,華南永昌-民權,2023-10-20,9312
2883,凱基金,29,6,23,華南永昌-民權,2023-10-20,9312
2363,矽統,22,0,22,華南永昌-民權,2023-10-20,9312
00893,國泰智能電動車,20,0,20,華南永昌-民權,2023-10-20,9312
5340,建榮,20,0,20,華南永昌-民權,2023-10-20,9312
2324,仁寶,20,1,19,華南永昌-民權,2023-10-20,9312
2610,華航,26,7,19,華南永昌-民權,2023-10-20,9312
2408,南亞科,16,0,16,華南永昌-民權,2023-10-20,9312
00670L,富邦NASDAQ正2,13,0,13,華南永昌-民權,2023-10-20,9312
6281,全國電,12,0,12,華南永昌-民權,2023-10-20,9312
00679B,元大美債20年,13,1,12,華南永昌-民權,2023-10-20,9312
1101,台泥,12,1,11,華南永昌-民權,2023-10-20,9312
00687B,國泰20年美債,11,0,11,華南永昌-民權,2023-10-20,9312
2204,中華,16,5,11,華南永昌-民權,2023-10-20,9312
2516,新建,11,0,11,華南永昌-民權,2023-10-20,9312
2618,長榮航,11,0,11,華南永昌-民權,2023-10-20,9312
6901,鑽石投資,11,0,11,華南永昌-民權,2023-10-20,9312
6235,華孚,20,10,10,華南永昌-民權,2023-10-20,9312
00895,富邦未來車,10,0,10,華南永昌-民權,2023-10-20,9312
00680L,元大美債20正2,10,0,10,華南永昌-民權,2023-10-20,9312
1524,耿鼎,21,11,10,華南永昌-民權,2023-10-20,9312
6417,韋僑,11,1,10,華南永昌-民權,2023-10-20,9312
8028,昇陽半導體,10,0,10,華南永昌-民權,2023-10-20,9312
2002,中鋼,10,0,10,華南永昌-民權,2023-10-20,9312
0056,元大高股息,10,1,9,華南永昌-民權,2023-10-20,9312
3617,碩天,10,1,9,華南永昌-民權,2023-10-20,9312
00932,兆豐永續高息等權,8,0,8,華南永昌-民權,2023-10-20,9312
2353,宏��,8,0,8,華南永昌-民權,2023-10-20,9312
3715,定穎投控,41,33,8,華南永昌-民權,2023-10-20,9312
00922,國泰台灣領袖50,7,0,7,華南永昌-民權,2023-10-20,9312
8069,元太,7,0,7,華南永昌-民權,2023-10-20,9312
8076,伍豐,7,0,7,華南永昌-民權,2023-10-20,9312
2881,富邦金,8,1,7,華南永昌-民權,2023-10-20,9312
00722B,群益投資級電信債,6,0,6,華南永昌-民權,2023-10-20,9312
2891,中信金,5,0,5,華南永昌-民權,2023-10-20,9312
2897,王道銀行,5,0,5,華南永昌-民權,2023-10-20,9312
3491,昇達科,7,2,5,華南永昌-民權,2023-10-20,9312
4123,晟德,5,0,5,華南永昌-民權,2023-10-20,9312
4905,台聯電,5,0,5,華南永昌-民權,2023-10-20,9312
00631L,元大台灣50正2,4,0,4,華南永昌-民權,2023-10-20,9312
00931B,統一美債20年,4,0,4,華南永昌-民權,2023-10-20,9312
2405,輔信,4,0,4,華南永昌-民權,2023-10-20,9312
3081,聯亞,60,0,60,華南永昌-民權,2023-10-23,9312
6187,萬潤,75,21,54,華南永昌-民權,2023-10-23,9312
1513,中興電,66,22,44,華南永昌-民權,2023-10-23,9312
00712,復華富時不動產,43,0,43,華南永昌-民權,2023-10-23,9312
2317,鴻海,232,193,39,華南永昌-民權,2023-10-23,9312
00933B,國泰10Y+金融債,33,0,33,華南永昌-民權,2023-10-23,9312
00772B,中信高評級公司債,31,0,31,華南永昌-民權,2023-10-23,9312
2002,中鋼,49,20,29,華南永昌-民權,2023-10-23,9312
3363,上詮,55,34,21,華南永昌-民權,2023-10-23,9312
00929,復華台灣科技優息,67,46,21,華南永昌-民權,2023-10-23,9312
00715L,期街口布蘭特正2,126,110,16,華南永昌-民權,2023-10-23,9312
3483,力致,16,0,16,華南永昌-民權,2023-10-23,9312
8069,元太,18,2,16,華南永昌-民權,2023-10-23,9312
2891,中信金,15,0,15,華南永昌-民權,2023-10-23,9312
3481,群創,13,0,13,華南永昌-民權,2023-10-23,9312
2603,長榮,14,1,13,華南永昌-民權,2023-10-23,9312
1314,中石化,12,0,12,華南永昌-民權,2023-10-23,9312
00893,國泰智能電動車,12,0,12,華南永昌-民權,2023-10-23,9312
4944,兆遠,11,0,11,華南永昌-民權,2023-10-23,9312
9955,佳龍,22,11,11,華南永昌-民權,2023-10-23,9312
00679B,元大美債20年,13,3,10,華南永昌-民權,2023-10-23,9312
00633L,富邦上証正2,10,0,10,華南永昌-民權,2023-10-23,9312
2367,燿華,10,0,10,華南永昌-民權,2023-10-23,9312
2605,新興,10,0,10,華南永昌-民權,2023-10-23,9312
6417,韋僑,11,1,10,華南永昌-民權,2023-10-23,9312
3032,偉訓,44,35,9,華南永昌-民權,2023-10-23,9312
2376,技嘉,38,31,7,華南永昌-民權,2023-10-23,9312
2401,凌陽,16,9,7,華南永昌-民權,2023-10-23,9312
2881,富邦金,6,0,6,華南永昌-民權,2023-10-23,9312
2610,華航,7,1,6,華南永昌-民權,2023-10-23,9312
8147,正淩,6,0,6,華南永昌-民權,2023-10-23,9312
1110,東泥,5,0,5,華南永昌-民權,2023-10-23,9312
1809,中釉,5,0,5,華南永昌-民權,2023-10-23,9312
00687B,國泰20年美債,4,0,4,華南永昌-民權,2023-10-23,9312
3276,宇環,4,0,4,華南永昌-民權,2023-10-23,9312
6284,佳邦,4,0,4,華南永昌-民權,2023-10-23,9312
8086,宏捷科,4,0,4,華南永昌-民權,2023-10-23,9312
1301,台塑,3,0,3,華南永昌-民權,2023-10-23,9312
2885,元大金,3,0,3,華南永昌-民權,2023-10-23,9312
3234,光環,3,0,3,華南永昌-民權,2023-10-23,9312
1303,南亞,3,0,3,華南永昌-民權,2023-10-23,9312
00924,復華S＆P500成長,3,0,3,華南永昌-民權,2023-10-23,9312
2363,矽統,10,7,3,華南永昌-民權,2023-10-23,9312
2425,承啟,8,5,3,華南永昌-民權,2023-10-23,9312
2468,華經,3,0,3,華南永昌-民權,2023-10-23,9312
3311,閎暉,3,0,3,華南永昌-民權,2023-10-23,9312
4905,台聯電,3,0,3,華南永昌-民權,2023-10-23,9312
5227,立凱-KY,3,0,3,華南永昌-民權,2023-10-23,9312
2883,凱基金,3,0,3,華南永昌-民權,2023-10-23,9312
00922,國泰台灣領袖50,2,0,2,華南永昌-民權,2023-10-23,9312
2834,臺企銀,504,2,502,華南永昌-民權,2023-10-24,9312
1609,大亞,69,0,69,華南永昌-民權,2023-10-24,9312
9105,泰金寶-DR,50,0,50,華南永昌-民權,2023-10-24,9312
2317,鴻海,75,35,40,華南永昌-民權,2023-10-24,9312
0056,元大高股息,40,2,38,華南永昌-民權,2023-10-24,9312
00712,復華富時不動產,30,0,30,華南永昌-民權,2023-10-24,9312
2883,凱基金,34,6,28,華南永昌-民權,2023-10-24,9312
2405,輔信,30,6,24,華南永昌-民權,2023-10-24,9312
2002,中鋼,43,20,23,華南永昌-民權,2023-10-24,9312
2369,菱生,55,33,22,華南永昌-民權,2023-10-24,9312
3163,波若威,52,31,21,華南永昌-民權,2023-10-24,9312
00751B,元大AAA至A公司債,20,0,20,華南永昌-民權,2023-10-24,9312
00931B,統一美債20年,11,0,11,華南永昌-民權,2023-10-24,9312
00929,復華台灣科技優息,11,0,11,華南永昌-民權,2023-10-24,9312
2312,金寶,11,0,11,華南永昌-民權,2023-10-24,9312
4927,泰鼎-KY,11,0,11,華南永昌-民權,2023-10-24,9312
6233,旺玖,14,3,11,華南永昌-民權,2023-10-24,9312
00753L,中信中國50正2,10,0,10,華南永昌-民權,2023-10-24,9312
1314,中石化,10,0,10,華南永昌-民權,2023-10-24,9312
00933B,國泰10Y+金融債,10,0,10,華南永昌-民權,2023-10-24,9312
3617,碩天,10,0,10,華南永昌-民權,2023-10-24,9312
6117,迎廣,10,0,10,華南永昌-民權,2023-10-24,9312
6901,鑽石投資,10,0,10,華南永昌-民權,2023-10-24,9312
1101,台泥,9,0,9,華南永昌-民權,2023-10-24,9312
2891,中信金,9,0,9,華南永昌-民權,2023-10-24,9312
00878,國泰永續高股息,8,0,8,華南永昌-民權,2023-10-24,9312
2344,華邦電,10,2,8,華南永昌-民權,2023-10-24,9312
1514,亞力,7,0,7,華南永昌-民權,2023-10-24,9312
1513,中興電,8,1,7,華南永昌-民權,2023-10-24,9312
00919,群益台灣精選高息,8,1,7,華南永昌-民權,2023-10-24,9312
3483,力致,8,1,7,華南永昌-民權,2023-10-24,9312
2409,友達,6,0,6,華南永昌-民權,2023-10-24,9312
3715,定穎投控,26,20,6,華南永昌-民權,2023-10-24,9312
00637L,元大滬深300正2,6,0,6,華南永昌-民權,2023-10-24,9312
5386,青雲,6,0,6,華南永昌-民權,2023-10-24,9312
6187,萬潤,6,0,6,華南永昌-民權,2023-10-24,9312
8358,金居,6,0,6,華南永昌-民權,2023-10-24,9312
4905,台聯電,5,0,5,華南永昌-民權,2023-10-24,9312
00688L,國泰20年美債正2,5,0,5,華南永昌-民權,2023-10-24,9312
00646,元大S＆P500,5,0,5,華南永昌-民權,2023-10-24,9312
2371,大同,8,3,5,華南永昌-民權,2023-10-24,9312
2618,長榮航,8,3,5,華南永昌-民權,2023-10-24,9312
6530,創威,5,0,5,華南永昌-民權,2023-10-24,9312
9950,萬國通,8,3,5,華南永昌-民權,2023-10-24,9312
5347,世界,6,2,4,華南永昌-民權,2023-10-24,9312
6113,亞矽,6,2,4,華南永昌-民權,2023-10-24,9312
6568,宏觀,10,6,4,華南永昌-民權,2023-10-24,9312
1519,華城,3,0,3,華南永昌-民權,2023-10-24,9312
1725,元禎,3,0,3,華南永昌-民權,2023-10-24,9312
2356,英業達,3,0,3,華南永昌-民權,2023-10-24,9312
3481,群創,65,2,63,華南永昌-民權,2023-10-25,9312
00878,國泰永續高股息,46,0,46,華南永昌-民權,2023-10-25,9312
4123,晟德,50,20,30,華南永昌-民權,2023-10-25,9312
3231,緯創,36,10,26,華南永昌-民權,2023-10-25,9312
1419,新紡,26,1,25,華南永昌-民權,2023-10-25,9312
00715L,期街口布蘭特正2,20,0,20,華南永昌-民權,2023-10-25,9312
6168,宏齊,20,0,20,華南永昌-民權,2023-10-25,9312
2002,中鋼,20,0,20,華南永昌-民權,2023-10-25,9312
1524,耿鼎,129,113,16,華南永昌-民權,2023-10-25,9312
00687B,國泰20年美債,13,0,13,華南永昌-民權,2023-10-25,9312
1522,堤維西,13,1,12,華南永昌-民權,2023-10-25,9312
6125,廣運,12,0,12,華南永昌-民權,2023-10-25,9312
1612,宏泰,11,0,11,華南永昌-民權,2023-10-25,9312
2883,凱基金,11,0,11,華南永昌-民權,2023-10-25,9312
6417,韋僑,10,0,10,華南永昌-民權,2023-10-25,9312
6550,北極星藥業-KY,11,2,9,華南永昌-民權,2023-10-25,9312
3078,僑威,13,4,9,華南永昌-民權,2023-10-25,9312
9919,康那香,8,0,8,華南永昌-民權,2023-10-25,9312
2486,一詮,10,3,7,華南永昌-民權,2023-10-25,9312
6235,華孚,7,0,7,華南永昌-民權,2023-10-25,9312
00712,復華富時不動產,6,0,6,華南永昌-民權,2023-10-25,9312
00929,復華台灣科技優息,6,0,6,華南永昌-民權,2023-10-25,9312
2408,南亞科,8,2,6,華南永昌-民權,2023-10-25,9312
3483,力致,7,1,6,華南永昌-民權,2023-10-25,9312
5386,青雲,6,0,6,華南永昌-民權,2023-10-25,9312
1301,台塑,5,0,5,華南永昌-民權,2023-10-25,9312
6188,廣明,5,0,5,華南永昌-民權,2023-10-25,9312
2399,映泰,5,0,5,華南永昌-民權,2023-10-25,9312
3025,星通,10,5,5,華南永昌-民權,2023-10-25,9312
1514,亞力,6,1,5,華南永昌-民權,2023-10-25,9312
1101,台泥,5,0,5,華南永昌-民權,2023-10-25,9312
2731,雄獅,5,0,5,華南永昌-民權,2023-10-25,9312
3051,力特,5,0,5,華南永昌-民權,2023-10-25,9312
3532,台勝科,5,0,5,華南永昌-民權,2023-10-25,9312
6167,久正,5,0,5,華南永昌-民權,2023-10-25,9312
3372,典範,4,0,4,華南永昌-民權,2023-10-25,9312
1519,華城,6,2,4,華南永昌-民權,2023-10-25,9312
2465,麗臺,4,0,4,華南永昌-民權,2023-10-25,9312
2492,華新科,4,0,4,華南永昌-民權,2023-10-25,9312
4108,懷特,4,0,4,華南永昌-民權,2023-10-25,9312
4763,材料-KY,5,1,4,華南永昌-民權,2023-10-25,9312
4927,泰鼎-KY,12,8,4,華南永昌-民權,2023-10-25,9312
6197,佳必琪,5,1,4,華南永昌-民權,2023-10-25,9312
1303,南亞,3,0,3,華南永昌-民權,2023-10-25,9312
0056,元大高股息,4,1,3,華南永昌-民權,2023-10-25,9312
3189,景碩,3,0,3,華南永昌-民權,2023-10-25,9312
1618,合機,8,5,3,華南永昌-民權,2023-10-25,9312
00772B,中信高評級公司債,3,0,3,華南永昌-民權,2023-10-25,9312
2413,環科,3,0,3,華南永昌-民權,2023-10-25,9312
2468,華經,3,0,3,華南永昌-民權,2023-10-25,9312
00712,復華富時不動產,53,0,53,華南永昌-民權,2023-10-26,9312
00919,群益台灣精選高息,47,10,37,華南永昌-民權,2023-10-26,9312
6187,萬潤,36,1,35,華南永昌-民權,2023-10-26,9312
00929,復華台灣科技優息,44,9,35,華南永昌-民權,2023-10-26,9312
00679B,元大美債20年,34,0,34,華南永昌-民權,2023-10-26,9312
2330,台積電,33,0,33,華南永昌-民權,2023-10-26,9312
2303,聯電,34,3,31,華南永昌-民權,2023-10-26,9312
00878,國泰永續高股息,26,0,26,華南永昌-民權,2023-10-26,9312
00885,富邦越南,25,2,23,華南永昌-民權,2023-10-26,9312
00933B,國泰10Y+金融債,21,0,21,華南永昌-民權,2023-10-26,9312
00893,國泰智能電動車,20,0,20,華南永昌-民權,2023-10-26,9312
4123,晟德,20,0,20,華南永昌-民權,2023-10-26,9312
3305,昇貿,16,0,16,華南永昌-民權,2023-10-26,9312
0056,元大高股息,18,3,15,華南永昌-民權,2023-10-26,9312
3025,星通,14,1,13,華南永昌-民權,2023-10-26,9312
2883,凱基金,14,1,13,華南永昌-民權,2023-10-26,9312
00687B,國泰20年美債,12,0,12,華南永昌-民權,2023-10-26,9312
6237,驊訊,15,4,11,華南永昌-民權,2023-10-26,9312
00830,國泰費城半導體,11,0,11,華南永昌-民權,2023-10-26,9312
2369,菱生,11,0,11,華南永昌-民權,2023-10-26,9312
2610,華航,17,7,10,華南永昌-民權,2023-10-26,9312
2323,中環,10,0,10,華南永昌-民權,2023-10-26,9312
2485,兆赫,10,0,10,華南永昌-民權,2023-10-26,9312
2538,基泰,10,0,10,華南永昌-民權,2023-10-26,9312
2637,慧洋-KY,10,0,10,華南永昌-民權,2023-10-26,9312
3532,台勝科,10,0,10,華南永昌-民權,2023-10-26,9312
6418,詠昇,10,0,10,華南永昌-民權,2023-10-26,9312
2344,華邦電,26,17,9,華南永昌-民權,2023-10-26,9312
2409,友達,10,1,9,華南永昌-民權,2023-10-26,9312
3680,家登,9,0,9,華南永昌-民權,2023-10-26,9312
3037,欣興,11,3,8,華南永昌-民權,2023-10-26,9312
2002,中鋼,8,0,8,華南永昌-民權,2023-10-26,9312
6233,旺玖,8,0,8,華南永昌-民權,2023-10-26,9312
6274,台燿,8,0,8,華南永昌-民權,2023-10-26,9312
5347,世界,8,0,8,華南永昌-民權,2023-10-26,9312
1609,大亞,7,0,7,華南永昌-民權,2023-10-26,9312
2337,旺宏,10,3,7,華南永昌-民權,2023-10-26,9312
1101,台泥,12,6,6,華南永昌-民權,2023-10-26,9312
2439,美律,6,0,6,華南永昌-民權,2023-10-26,9312
2606,裕民,7,1,6,華南永昌-民權,2023-10-26,9312
3675,德微,6,0,6,華南永昌-民權,2023-10-26,9312
3363,上詮,8,3,5,華南永昌-民權,2023-10-26,9312
00895,富邦未來車,5,0,5,華南永昌-民權,2023-10-26,9312
00772B,中信高評級公司債,5,0,5,華南永昌-民權,2023-10-26,9312
2897,王道銀行,5,0,5,華南永昌-民權,2023-10-26,9312
6415,矽力*-KY,5,0,5,華南永昌-民權,2023-10-26,9312
6535,順藥,5,0,5,華南永昌-民權,2023-10-26,9312
2363,矽統,6,1,5,華南永昌-民權,2023-10-26,9312
2634,漢翔,8,3,5,華南永昌-民權,2023-10-26,9312
1301,台塑,4,0,4,華南永昌-民權,2023-10-26,9312
00715L,期街口布蘭特正2,118,0,118,華南永昌-民權,2023-10-27,9312
4960,誠美材,91,0,91,華南永昌-民權,2023-10-27,9312
00929,復華台灣科技優息,34,1,33,華南永昌-民權,2023-10-27,9312
0056,元大高股息,24,0,24,華南永昌-民權,2023-10-27,9312
2454,聯發科,23,0,23,華南永昌-民權,2023-10-27,9312
3481,群創,45,30,15,華南永昌-民權,2023-10-27,9312
2371,大同,15,0,15,華南永昌-民權,2023-10-27,9312
2369,菱生,32,20,12,華南永昌-民權,2023-10-27,9312
00687B,國泰20年美債,12,1,11,華南永昌-民權,2023-10-27,9312
2002,中鋼,11,0,11,華南永昌-民權,2023-10-27,9312
2618,長榮航,12,1,11,華南永昌-民權,2023-10-27,9312
2201,裕隆,13,3,10,華南永昌-民權,2023-10-27,9312
00885,富邦越南,12,2,10,華南永昌-民權,2023-10-27,9312
00751B,元大AAA至A公司債,10,0,10,華南永昌-民權,2023-10-27,9312
00919,群益台灣精選高息,10,0,10,華南永昌-民權,2023-10-27,9312
6182,合晶,10,0,10,華南永昌-民權,2023-10-27,9312
2363,矽統,12,3,9,華南永昌-民權,2023-10-27,9312
2884,玉山金,9,0,9,華南永昌-民權,2023-10-27,9312
2883,凱基金,14,5,9,華南永昌-民權,2023-10-27,9312
2388,威盛,8,0,8,華南永昌-民權,2023-10-27,9312
3715,定穎投控,28,20,8,華南永昌-民權,2023-10-27,9312
8358,金居,8,0,8,華南永昌-民權,2023-10-27,9312
8437,大地-KY,7,0,7,華南永昌-民權,2023-10-27,9312
8110,華東,6,0,6,華南永昌-民權,2023-10-27,9312
2409,友達,6,0,6,華南永昌-民權,2023-10-27,9312
2476,鉅祥,6,0,6,華南永昌-民權,2023-10-27,9312
3675,德微,6,0,6,華南永昌-民權,2023-10-27,9312
4763,材料-KY,10,5,5,華南永昌-民權,2023-10-27,9312
1905,華紙,5,0,5,華南永昌-民權,2023-10-27,9312
2006,東和鋼鐵,5,0,5,華南永昌-民權,2023-10-27,9312
2402,毅嘉,5,0,5,華南永昌-民權,2023-10-27,9312
2405,輔信,10,5,5,華南永昌-民權,2023-10-27,9312
2460,建通,11,6,5,華南永昌-民權,2023-10-27,9312
4304,勝昱,5,0,5,華南永昌-民權,2023-10-27,9312
4712,福格創新,5,0,5,華南永昌-民權,2023-10-27,9312
5258,虹堡,7,2,5,華南永昌-民權,2023-10-27,9312
6176,瑞儀,5,0,5,華南永昌-民權,2023-10-27,9312
6269,台郡,5,0,5,華南永昌-民權,2023-10-27,9312
6288,聯嘉,5,0,5,華南永昌-民權,2023-10-27,9312
3122,笙泉,20,15,5,華南永昌-民權,2023-10-27,9312
1815,富喬,5,1,4,華南永昌-民權,2023-10-27,9312
2329,華泰,4,0,4,華南永昌-民權,2023-10-27,9312
2399,映泰,8,4,4,華南永昌-民權,2023-10-27,9312
4927,泰鼎-KY,6,2,4,華南永昌-民權,2023-10-27,9312
1795,美時,5,1,4,華南永昌-民權,2023-10-27,9312
2382,廣達,5,1,4,華南永昌-民權,2023-10-27,9312
00878,國泰永續高股息,3,0,3,華南永昌-民權,2023-10-27,9312
1909,榮成,3,0,3,華南永昌-民權,2023-10-27,9312
2324,仁寶,3,0,3,華南永昌-民權,2023-10-27,9312
2340,台亞,4,1,3,華南永昌-民權,2023-10-27,9312
2317,鴻海,287,198,89,華南永昌-民權,2023-10-30,9312
2458,義隆,63,2,61,華南永昌-民權,2023-10-30,9312
3014,聯陽,60,1,59,華南永昌-民權,2023-10-30,9312
6187,萬潤,51,0,51,華南永昌-民權,2023-10-30,9312
6120,達運,42,0,42,華南永昌-民權,2023-10-30,9312
4905,台聯電,30,0,30,華南永昌-民權,2023-10-30,9312
0056,元大高股息,22,0,22,華南永昌-民權,2023-10-30,9312
3669,圓展,35,13,22,華南永昌-民權,2023-10-30,9312
3443,創意,17,1,16,華南永昌-民權,2023-10-30,9312
1419,新紡,15,0,15,華南永昌-民權,2023-10-30,9312
00712,復華富時不動產,13,0,13,華南永昌-民權,2023-10-30,9312
3051,力特,14,1,13,華南永昌-民權,2023-10-30,9312
2485,兆赫,29,17,12,華南永昌-民權,2023-10-30,9312
1303,南亞,10,0,10,華南永昌-民權,2023-10-30,9312
3704,合勤控,11,1,10,華南永昌-民權,2023-10-30,9312
6418,詠昇,10,0,10,華南永昌-民權,2023-10-30,9312
6670,復盛應用,10,0,10,華南永昌-民權,2023-10-30,9312
8069,元太,10,0,10,華南永昌-民權,2023-10-30,9312
2002,中鋼,10,0,10,華南永昌-民權,2023-10-30,9312
00878,國泰永續高股息,8,0,8,華南永昌-民權,2023-10-30,9312
2390,云辰,73,65,8,華南永昌-民權,2023-10-30,9312
8150,南茂,10,2,8,華南永昌-民權,2023-10-30,9312
5876,上海商銀,7,0,7,華南永昌-民權,2023-10-30,9312
2887,台新金,38,32,6,華南永昌-民權,2023-10-30,9312
1609,大亞,7,1,6,華南永昌-民權,2023-10-30,9312
2401,凌陽,7,1,6,華南永昌-民權,2023-10-30,9312
2634,漢翔,6,0,6,華南永昌-民權,2023-10-30,9312
3290,東浦,6,0,6,華南永昌-民權,2023-10-30,9312
4908,前鼎,9,3,6,華南永昌-民權,2023-10-30,9312
00885,富邦越南,7,2,5,華南永昌-民權,2023-10-30,9312
00687B,國泰20年美債,5,0,5,華南永昌-民權,2023-10-30,9312
00751B,元大AAA至A公司債,5,0,5,華南永昌-民權,2023-10-30,9312
2369,菱生,7,2,5,華南永昌-民權,2023-10-30,9312
8011,台通,5,0,5,華南永昌-民權,2023-10-30,9312
8089,康全電訊,5,0,5,華南永昌-民權,2023-10-30,9312
8436,大江,5,0,5,華南永昌-民權,2023-10-30,9312
3122,笙泉,7,3,4,華南永昌-民權,2023-10-30,9312
3206,志豐,4,0,4,華南永昌-民權,2023-10-30,9312
8054,安國,38,34,4,華南永昌-民權,2023-10-30,9312
1605,華新,3,0,3,華南永昌-民權,2023-10-30,9312
1101,台泥,3,0,3,華南永昌-民權,2023-10-30,9312
00882,中信中國高股息,3,0,3,華南永昌-民權,2023-10-30,9312
2025,千興,3,0,3,華南永昌-民權,2023-10-30,9312
2363,矽統,9,6,3,華南永昌-民權,2023-10-30,9312
2457,飛宏,3,0,3,華南永昌-民權,2023-10-30,9312
2897,王道銀行,3,0,3,華南永昌-民權,2023-10-30,9312
3231,緯創,11,8,3,華南永昌-民權,2023-10-30,9312
3272,東碩,3,0,3,華南永昌-民權,2023-10-30,9312
3576,聯合再生,10,7,3,華南永昌-民權,2023-10-30,9312
3652,精聯,3,0,3,華南永昌-民權,2023-10-30,9312
00715L,期街口布蘭特正2,115,0,115,華南永昌-民權,2023-10-31,9312
00929,復華台灣科技優息,65,0,65,華南永昌-民權,2023-10-31,9312
2915,潤泰全,52,0,52,華南永昌-民權,2023-10-31,9312
6187,萬潤,115,65,50,華南永昌-民權,2023-10-31,9312
2317,鴻海,74,26,48,華南永昌-民權,2023-10-31,9312
4123,晟德,42,0,42,華南永昌-民權,2023-10-31,9312
00878,國泰永續高股息,39,0,39,華南永昌-民權,2023-10-31,9312
6168,宏齊,32,0,32,華南永昌-民權,2023-10-31,9312
8436,大江,25,0,25,華南永昌-民權,2023-10-31,9312
2101,南港,20,0,20,華南永昌-民權,2023-10-31,9312
2344,華邦電,25,5,20,華南永昌-民權,2023-10-31,9312
3652,精聯,20,0,20,華南永昌-民權,2023-10-31,9312
00918,大華優利高填息30,18,0,18,華南永昌-民權,2023-10-31,9312
3380,明泰,16,2,14,華南永昌-民權,2023-10-31,9312
6235,華孚,16,2,14,華南永昌-民權,2023-10-31,9312
6443,元晶,21,7,14,華南永昌-民權,2023-10-31,9312
0056,元大高股息,16,3,13,華南永昌-民權,2023-10-31,9312
4905,台聯電,13,0,13,華南永昌-民權,2023-10-31,9312
2301,光寶科,20,8,12,華南永昌-民權,2023-10-31,9312
3523,迎輝,12,0,12,華南永昌-民權,2023-10-31,9312
3702,大聯大,14,3,11,華南永昌-民權,2023-10-31,9312
2313,華通,12,1,11,華南永昌-民權,2023-10-31,9312
2498,宏達電,11,0,11,華南永昌-民權,2023-10-31,9312
8028,昇陽半導體,11,0,11,華南永昌-民權,2023-10-31,9312
00919,群益台灣精選高息,10,0,10,華南永昌-民權,2023-10-31,9312
00893,國泰智能電動車,10,0,10,華南永昌-民權,2023-10-31,9312
6126,信音,12,2,10,華南永昌-民權,2023-10-31,9312
2409,友達,12,3,9,華南永昌-民權,2023-10-31,9312
2449,京元電子,11,2,9,華南永昌-民權,2023-10-31,9312
3231,緯創,25,17,8,華南永昌-民權,2023-10-31,9312
00895,富邦未來車,8,0,8,華南永昌-民權,2023-10-31,9312
2303,聯電,12,4,8,華南永昌-民權,2023-10-31,9312
6269,台郡,8,0,8,華南永昌-民權,2023-10-31,9312
006208,富邦台50,7,0,7,華南永昌-民權,2023-10-31,9312
00932,兆豐永續高息等權,7,0,7,華南永昌-民權,2023-10-31,9312
8437,大地-KY,7,0,7,華南永昌-民權,2023-10-31,9312
2356,英業達,6,0,6,華南永昌-民權,2023-10-31,9312
2887,台新金,9,3,6,華南永昌-民權,2023-10-31,9312
2330,台積電,6,0,6,華南永昌-民權,2023-10-31,9312
1605,華新,10,5,5,華南永昌-民權,2023-10-31,9312
1301,台塑,7,2,5,華南永昌-民權,2023-10-31,9312
8040,九暘,5,0,5,華南永昌-民權,2023-10-31,9312
6271,同欣電,5,0,5,華南永昌-民權,2023-10-31,9312
1419,新紡,5,0,5,華南永昌-民權,2023-10-31,9312
1342,八貫,5,0,5,華南永昌-民權,2023-10-31,9312
2880,華南金,5,0,5,華南永昌-民權,2023-10-31,9312
5258,虹堡,5,0,5,華南永昌-民權,2023-10-31,9312
5425,台半,5,0,5,華南永昌-民權,2023-10-31,9312
6789,采鈺,7,3,4,華南永昌-民權,2023-10-31,9312
4979,華星光,8,4,4,華南永昌-民權,2023-10-31,9312
1513,中興電,82,32,50,華南永昌-民權,2023-11-01,9312
00679B,元大美債20年,35,0,35,華南永昌-民權,2023-11-01,9312
00929,復華台灣科技優息,34,2,32,華南永昌-民權,2023-11-01,9312
00878,國泰永續高股息,28,5,23,華南永昌-民權,2023-11-01,9312
3231,緯創,66,45,21,華南永昌-民權,2023-11-01,9312
2367,燿華,15,1,14,華南永昌-民權,2023-11-01,9312
2605,新興,13,0,13,華南永昌-民權,2023-11-01,9312
2369,菱生,11,0,11,華南永昌-民權,2023-11-01,9312
6187,萬潤,11,0,11,華南永昌-民權,2023-11-01,9312
6191,精成科,38,27,11,華南永昌-民權,2023-11-01,9312
00935,野村臺灣新科技50,10,0,10,華南永昌-民權,2023-11-01,9312
1314,中石化,13,3,10,華南永昌-民權,2023-11-01,9312
3037,欣興,10,0,10,華南永昌-民權,2023-11-01,9312
3268,海德威,10,0,10,華南永昌-民權,2023-11-01,9312
4908,前鼎,11,1,10,華南永昌-民權,2023-11-01,9312
5328,華容,10,0,10,華南永昌-民權,2023-11-01,9312
6142,友勁,10,0,10,華南永昌-民權,2023-11-01,9312
9105,泰金寶-DR,10,0,10,華南永昌-民權,2023-11-01,9312
3189,景碩,10,1,9,華南永昌-民權,2023-11-01,9312
6127,九豪,10,1,9,華南永昌-民權,2023-11-01,9312
4915,致伸,11,3,8,華南永昌-民權,2023-11-01,9312
1605,華新,9,1,8,華南永昌-民權,2023-11-01,9312
6269,台郡,8,0,8,華南永昌-民權,2023-11-01,9312
1609,大亞,7,0,7,華南永昌-民權,2023-11-01,9312
2915,潤泰全,8,1,7,華南永昌-民權,2023-11-01,9312
4114,健喬,6,0,6,華南永昌-民權,2023-11-01,9312
3338,泰碩,6,0,6,華南永昌-民權,2023-11-01,9312
3481,群創,7,1,6,華南永昌-民權,2023-11-01,9312
2887,台新金,5,0,5,華南永昌-民權,2023-11-01,9312
2382,廣達,6,1,5,華南永昌-民權,2023-11-01,9312
0056,元大高股息,8,3,5,華南永昌-民權,2023-11-01,9312
2883,凱基金,5,0,5,華南永昌-民權,2023-11-01,9312
4304,勝昱,5,0,5,華南永昌-民權,2023-11-01,9312
4905,台聯電,5,0,5,華南永昌-民權,2023-11-01,9312
6235,華孚,14,9,5,華南永昌-民權,2023-11-01,9312
8437,大地-KY,5,0,5,華南永昌-民權,2023-11-01,9312
9919,康那香,5,0,5,華南永昌-民權,2023-11-01,9312
5469,瀚宇博,4,0,4,華南永昌-民權,2023-11-01,9312
3027,盛達,4,0,4,華南永昌-民權,2023-11-01,9312
3122,笙泉,7,3,4,華南永昌-民權,2023-11-01,9312
3704,合勤控,5,1,4,華南永昌-民權,2023-11-01,9312
00885,富邦越南,5,2,3,華南永昌-民權,2023-11-01,9312
00687B,國泰20年美債,3,0,3,華南永昌-民權,2023-11-01,9312
2401,凌陽,5,2,3,華南永昌-民權,2023-11-01,9312
2449,京元電子,5,2,3,華南永昌-民權,2023-11-01,9312
2492,華新科,4,1,3,華南永昌-民權,2023-11-01,9312
2543,皇昌,4,1,3,華南永昌-民權,2023-11-01,9312
3548,兆利,5,2,3,華南永昌-民權,2023-11-01,9312
2409,友達,6,3,3,華南永昌-民權,2023-11-01,9312
2330,台積電,4,2,2,華南永昌-民權,2023-11-01,9312
2834,臺企銀,501,0,501,華南永昌-民權,2023-11-02,9312
00680L,元大美債20正2,150,1,149,華南永昌-民權,2023-11-02,9312
6488,環球晶,35,3,32,華南永昌-民權,2023-11-02,9312
3034,聯詠,40,12,28,華南永昌-民權,2023-11-02,9312
00919,群益台灣精選高息,21,0,21,華南永昌-民權,2023-11-02,9312
0056,元大高股息,21,0,21,華南永昌-民權,2023-11-02,9312
00935,野村臺灣新科技50,15,0,15,華南永昌-民權,2023-11-02,9312
3293,鈊象,15,0,15,華南永昌-民權,2023-11-02,9312
3715,定穎投控,37,22,15,華南永昌-民權,2023-11-02,9312
3663,鑫科,12,0,12,華南永昌-民權,2023-11-02,9312
2356,英業達,12,1,11,華南永昌-民權,2023-11-02,9312
00915,凱基優選高股息30,10,0,10,華南永昌-民權,2023-11-02,9312
00922,國泰台灣領袖50,10,0,10,華南永昌-民權,2023-11-02,9312
3163,波若威,11,1,10,華南永昌-民權,2023-11-02,9312
6191,精成科,33,23,10,華南永昌-民權,2023-11-02,9312
4915,致伸,10,1,9,華南永昌-民權,2023-11-02,9312
2025,千興,8,0,8,華南永昌-民權,2023-11-02,9312
6213,聯茂,7,0,7,華南永昌-民權,2023-11-02,9312
6125,廣運,8,2,6,華南永昌-民權,2023-11-02,9312
5272,笙科,6,0,6,華南永昌-民權,2023-11-02,9312
1304,台聚,5,0,5,華南永昌-民權,2023-11-02,9312
00934,中信成長高股息,5,0,5,華南永昌-民權,2023-11-02,9312
8044,網家,6,1,5,華南永昌-民權,2023-11-02,9312
2419,仲琦,15,10,5,華南永昌-民權,2023-11-02,9312
00931B,統一美債20年,4,0,4,華南永昌-民權,2023-11-02,9312
2352,佳世達,5,1,4,華南永昌-民權,2023-11-02,9312
2363,矽統,10,6,4,華南永昌-民權,2023-11-02,9312
2743,山富,4,0,4,華南永昌-民權,2023-11-02,9312
6173,信昌電,4,0,4,華南永昌-民權,2023-11-02,9312
00679B,元大美債20年,6,3,3,華南永昌-民權,2023-11-02,9312
00719B,元大美債1-3,3,0,3,華南永昌-民權,2023-11-02,9312
3122,笙泉,9,6,3,華南永昌-民權,2023-11-02,9312
6282,康舒,3,0,3,華南永昌-民權,2023-11-02,9312
8150,南茂,4,1,3,華南永昌-民權,2023-11-02,9312
8176,智捷,3,0,3,華南永昌-民權,2023-11-02,9312
8358,金居,3,0,3,華南永昌-民權,2023-11-02,9312
2637,慧洋-KY,3,0,3,華南永昌-民權,2023-11-02,9312
2883,凱基金,5,3,2,華南永昌-民權,2023-11-02,9312
1463,強盛新,2,0,2,華南永昌-民權,2023-11-02,9312
1605,華新,2,0,2,華南永昌-民權,2023-11-02,9312
1752,南光,2,0,2,華南永昌-民權,2023-11-02,9312
2312,金寶,2,0,2,華南永昌-民權,2023-11-02,9312
2367,燿華,5,3,2,華南永昌-民權,2023-11-02,9312
2486,一詮,3,1,2,華南永昌-民權,2023-11-02,9312
2492,華新科,5,3,2,華南永昌-民權,2023-11-02,9312
3176,基亞,2,0,2,華南永昌-民權,2023-11-02,9312
3290,東浦,2,0,2,華南永昌-民權,2023-11-02,9312
3362,先進光,2,0,2,華南永昌-民權,2023-11-02,9312
4953,緯軟,2,0,2,華南永昌-民權,2023-11-02,9312
6197,佳必琪,2,0,2,華南永昌-民權,2023-11-02,9312
6187,萬潤,479,4,475,華南永昌-民權,2023-11-03,9312
6285,啟��,91,5,86,華南永昌-民權,2023-11-03,9312
00929,復華台灣科技優息,51,0,51,華南永昌-民權,2023-11-03,9312
5483,中美晶,51,0,51,華南永昌-民權,2023-11-03,9312
1609,大亞,40,1,39,華南永昌-民權,2023-11-03,9312
2367,燿華,36,0,36,華南永昌-民權,2023-11-03,9312
9105,泰金寶-DR,30,0,30,華南永昌-民權,2023-11-03,9312
2323,中環,23,3,20,華南永昌-民權,2023-11-03,9312
2801,彰銀,20,0,20,華南永昌-民權,2023-11-03,9312
00878,國泰永續高股息,14,0,14,華南永昌-民權,2023-11-03,9312
00679B,元大美債20年,14,0,14,華南永昌-民權,2023-11-03,9312
3652,精聯,12,0,12,華南永昌-民權,2023-11-03,9312
00935,野村臺灣新科技50,11,0,11,華南永昌-民權,2023-11-03,9312
8150,南茂,11,0,11,華南永昌-民權,2023-11-03,9312
6418,詠昇,20,10,10,華南永昌-民權,2023-11-03,9312
00931B,統一美債20年,10,1,9,華南永昌-民權,2023-11-03,9312
5347,世界,9,0,9,華南永昌-民權,2023-11-03,9312
00751B,元大AAA至A公司債,11,3,8,華南永昌-民權,2023-11-03,9312
4133,亞諾法,8,0,8,華南永昌-民權,2023-11-03,9312
6191,精成科,9,2,7,華南永昌-民權,2023-11-03,9312
3231,緯創,11,5,6,華南永昌-民權,2023-11-03,9312
2460,建通,8,2,6,華南永昌-民權,2023-11-03,9312
2537,聯上發,8,2,6,華南永昌-民權,2023-11-03,9312
3032,偉訓,38,32,6,華南永昌-民權,2023-11-03,9312
3041,揚智,14,8,6,華南永昌-民權,2023-11-03,9312
4939,亞電,6,0,6,華南永昌-民權,2023-11-03,9312
6530,創威,7,1,6,華南永昌-民權,2023-11-03,9312
8046,南電,7,1,6,華南永昌-民權,2023-11-03,9312
8182,加高,7,1,6,華南永昌-民權,2023-11-03,9312
2317,鴻海,16,10,6,華南永昌-民權,2023-11-03,9312
1467,南緯,9,4,5,華南永昌-民權,2023-11-03,9312
1514,亞力,5,0,5,華南永昌-民權,2023-11-03,9312
00773B,中信優先金融債,5,0,5,華南永昌-民權,2023-11-03,9312
00688L,國泰20年美債正2,5,0,5,華南永昌-民權,2023-11-03,9312
2014,中鴻,5,0,5,華南永昌-民權,2023-11-03,9312
2324,仁寶,5,0,5,華南永昌-民權,2023-11-03,9312
3322,建舜電,6,1,5,華南永昌-民權,2023-11-03,9312
4960,誠美材,11,6,5,華南永昌-民權,2023-11-03,9312
1301,台塑,4,0,4,華南永昌-民權,2023-11-03,9312
6269,台郡,4,0,4,華南永昌-民權,2023-11-03,9312
8176,智捷,4,0,4,華南永昌-民權,2023-11-03,9312
8086,宏捷科,4,1,3,華南永昌-民權,2023-11-03,9312
5269,祥碩,3,0,3,華南永昌-民權,2023-11-03,9312
6125,廣運,5,2,3,華南永昌-民權,2023-11-03,9312
00671R,富邦NASDAQ反1,3,0,3,華南永昌-民權,2023-11-03,9312
00934,中信成長高股息,3,0,3,華南永昌-民權,2023-11-03,9312
2233,宇隆,13,10,3,華南永昌-民權,2023-11-03,9312
2376,技嘉,12,9,3,華南永昌-民權,2023-11-03,9312
2458,義隆,3,0,3,華南永昌-民權,2023-11-03,9312
2609,陽明,3,0,3,華南永昌-民權,2023-11-03,9312
00680L,元大美債20正2,200,0,200,華南永昌-民權,2023-11-06,9312
2303,聯電,227,32,195,華南永昌-民權,2023-11-06,9312
00929,復華台灣科技優息,204,38,166,華南永昌-民權,2023-11-06,9312
00751B,元大AAA至A公司債,100,0,100,華南永昌-民權,2023-11-06,9312
2603,長榮,103,18,85,華南永昌-民權,2023-11-06,9312
3105,穩懋,60,0,60,華南永昌-民權,2023-11-06,9312
00679B,元大美債20年,58,0,58,華南永昌-民權,2023-11-06,9312
00933B,國泰10Y+金融債,40,0,40,華南永昌-民權,2023-11-06,9312
3363,上詮,32,2,30,華南永昌-民權,2023-11-06,9312
8163,達方,29,0,29,華南永昌-民權,2023-11-06,9312
4123,晟德,22,0,22,華南永昌-民權,2023-11-06,9312
00935,野村臺灣新科技50,21,0,21,華南永昌-民權,2023-11-06,9312
9105,泰金寶-DR,20,0,20,華南永昌-民權,2023-11-06,9312
4171,瑞基,21,3,18,華南永昌-民權,2023-11-06,9312
2388,威盛,26,12,14,華南永昌-民權,2023-11-06,9312
3443,創意,15,2,13,華南永昌-民權,2023-11-06,9312
2618,長榮航,11,0,11,華南永昌-民權,2023-11-06,9312
00632R,元大台灣50反1,10,0,10,華南永昌-民權,2023-11-06,9312
3652,精聯,10,0,10,華南永昌-民權,2023-11-06,9312
8442,威宏-KY,10,0,10,華南永昌-民權,2023-11-06,9312
2352,佳世達,10,0,10,華南永昌-民權,2023-11-06,9312
00902,中信電池及儲能,10,1,9,華南永昌-民權,2023-11-06,9312
6770,力積電,12,3,9,華南永昌-民權,2023-11-06,9312
1609,大亞,9,2,7,華南永昌-民權,2023-11-06,9312
2206,三陽工業,8,1,7,華南永昌-民權,2023-11-06,9312
2731,雄獅,7,0,7,華南永昌-民權,2023-11-06,9312
00715L,期街口布蘭特正2,6,0,6,華南永昌-民權,2023-11-06,9312
2358,廷鑫,6,0,6,華南永昌-民權,2023-11-06,9312
3617,碩天,16,10,6,華南永昌-民權,2023-11-06,9312
8358,金居,6,0,6,華南永昌-民權,2023-11-06,9312
2405,輔信,6,1,5,華南永昌-民權,2023-11-06,9312
3032,偉訓,5,0,5,華南永昌-民權,2023-11-06,9312
3322,建舜電,6,1,5,華南永昌-民權,2023-11-06,9312
4973,廣穎,5,0,5,華南永昌-民權,2023-11-06,9312
8069,元太,6,1,5,華南永昌-民權,2023-11-06,9312
9907,統一實,5,0,5,華南永昌-民權,2023-11-06,9312
8112,至上,5,0,5,華南永昌-民權,2023-11-06,9312
00922,國泰台灣領袖50,4,0,4,華南永昌-民權,2023-11-06,9312
2314,台揚,4,0,4,華南永昌-民權,2023-11-06,9312
2419,仲琦,7,3,4,華南永昌-民權,2023-11-06,9312
4906,正文,4,0,4,華南永昌-民權,2023-11-06,9312
2356,英業達,4,1,3,華南永昌-民權,2023-11-06,9312
1471,首利,3,0,3,華南永昌-民權,2023-11-06,9312
2460,建通,3,0,3,華南永昌-民權,2023-11-06,9312
3013,晟銘電,24,21,3,華南永昌-民權,2023-11-06,9312
3094,聯傑,4,1,3,華南永昌-民權,2023-11-06,9312
4961,天鈺,8,5,3,華南永昌-民權,2023-11-06,9312
6112,邁達特,7,4,3,華南永昌-民權,2023-11-06,9312
6139,亞翔,6,3,3,華南永昌-民權,2023-11-06,9312
6535,順藥,3,0,3,華南永昌-民權,2023-11-06,9312
6187,萬潤,100,0,100,華南永昌-民權,2023-11-07,9312
00671R,富邦NASDAQ反1,50,0,50,華南永昌-民權,2023-11-07,9312
2610,華航,47,5,42,華南永昌-民權,2023-11-07,9312
8436,大江,40,0,40,華南永昌-民權,2023-11-07,9312
2408,南亞科,30,0,30,華南永昌-民權,2023-11-07,9312
2515,中工,50,24,26,華南永昌-民權,2023-11-07,9312
8069,元太,20,0,20,華南永昌-民權,2023-11-07,9312
3481,群創,21,1,20,華南永昌-民權,2023-11-07,9312
00753L,中信中國50正2,18,0,18,華南永昌-民權,2023-11-07,9312
00680L,元大美債20正2,22,8,14,華南永昌-民權,2023-11-07,9312
0056,元大高股息,14,1,13,華南永昌-民權,2023-11-07,9312
9955,佳龍,13,0,13,華南永昌-民權,2023-11-07,9312
00929,復華台灣科技優息,20,8,12,華南永昌-民權,2023-11-07,9312
2353,宏��,12,1,11,華南永昌-民權,2023-11-07,9312
2634,漢翔,10,0,10,華南永昌-民權,2023-11-07,9312
00931B,統一美債20年,10,0,10,華南永昌-民權,2023-11-07,9312
3060,銘異,10,0,10,華南永昌-民權,2023-11-07,9312
4712,福格創新,10,0,10,華南永昌-民權,2023-11-07,9312
2313,華通,10,1,9,華南永昌-民權,2023-11-07,9312
00679B,元大美債20年,14,6,8,華南永昌-民權,2023-11-07,9312
1301,台塑,8,0,8,華南永昌-民權,2023-11-07,9312
1514,亞力,10,2,8,華南永昌-民權,2023-11-07,9312
2618,長榮航,9,1,8,華南永昌-民權,2023-11-07,9312
5258,虹堡,8,0,8,華南永昌-民權,2023-11-07,9312
2367,燿華,8,1,7,華南永昌-民權,2023-11-07,9312
2002,中鋼,7,2,5,華南永昌-民權,2023-11-07,9312
1504,東元,7,2,5,華南永昌-民權,2023-11-07,9312
1471,首利,5,0,5,華南永昌-民權,2023-11-07,9312
3443,創意,5,0,5,華南永昌-民權,2023-11-07,9312
6191,精成科,5,0,5,華南永昌-民權,2023-11-07,9312
6139,亞翔,4,0,4,華南永昌-民權,2023-11-07,9312
00720B,元大投資級公司債,13,9,4,華南永昌-民權,2023-11-07,9312
2421,建準,10,6,4,華南永昌-民權,2023-11-07,9312
4167,松瑞藥,6,2,4,華南永昌-民權,2023-11-07,9312
4915,致伸,4,0,4,華南永昌-民權,2023-11-07,9312
2344,華邦電,7,4,3,華南永昌-民權,2023-11-07,9312
3122,笙泉,3,0,3,華南永昌-民權,2023-11-07,9312
3666,光耀,3,0,3,華南永昌-民權,2023-11-07,9312
3704,合勤控,3,0,3,華南永昌-民權,2023-11-07,9312
4550,長佳,3,0,3,華南永昌-民權,2023-11-07,9312
4908,前鼎,6,3,3,華南永昌-民權,2023-11-07,9312
4927,泰鼎-KY,5,2,3,華南永昌-民權,2023-11-07,9312
8176,智捷,3,0,3,華南永昌-民權,2023-11-07,9312
1326,台化,2,0,2,華南永昌-民權,2023-11-07,9312
1268,漢來美食,2,0,2,華南永昌-民權,2023-11-07,9312
00665L,富邦�琤肭磪囓�2,2,0,2,華南永昌-民權,2023-11-07,9312
00687B,國泰20年美債,2,0,2,華南永昌-民權,2023-11-07,9312
00878,國泰永續高股息,2,0,2,華南永昌-民權,2023-11-07,9312
1760,寶齡富錦,2,0,2,華南永昌-民權,2023-11-07,9312
2401,凌陽,7,5,2,華南永昌-民權,2023-11-07,9312
00753L,中信中國50正2,70,0,70,華南永昌-民權,2023-11-08,9312
2002,中鋼,69,5,64,華南永昌-民權,2023-11-08,9312
00936,台新永續高息中小,33,4,29,華南永昌-民權,2023-11-08,9312
2515,中工,31,5,26,華南永昌-民權,2023-11-08,9312
2618,長榮航,29,4,25,華南永昌-民權,2023-11-08,9312
9105,泰金寶-DR,20,0,20,華南永昌-民權,2023-11-08,9312
1721,三晃,17,1,16,華南永昌-民權,2023-11-08,9312
00885,富邦越南,15,0,15,華南永昌-民權,2023-11-08,9312
1609,大亞,16,1,15,華南永昌-民權,2023-11-08,9312
2369,菱生,14,0,14,華南永昌-民權,2023-11-08,9312
2382,廣達,29,17,12,華南永昌-民權,2023-11-08,9312
2609,陽明,13,2,11,華南永昌-民權,2023-11-08,9312
5521,工信,11,0,11,華南永昌-民權,2023-11-08,9312
2312,金寶,10,0,10,華南永昌-民權,2023-11-08,9312
3666,光耀,10,0,10,華南永昌-民權,2023-11-08,9312
3443,創意,10,0,10,華南永昌-民權,2023-11-08,9312
5347,世界,14,4,10,華南永昌-民權,2023-11-08,9312
8110,華東,14,5,9,華南永昌-民權,2023-11-08,9312
2504,國產,9,0,9,華南永昌-民權,2023-11-08,9312
3548,兆利,12,3,9,華南永昌-民權,2023-11-08,9312
8936,國統,10,1,9,華南永昌-民權,2023-11-08,9312
6117,迎廣,15,8,7,華南永昌-民權,2023-11-08,9312
00934,中信成長高股息,6,0,6,華南永昌-民權,2023-11-08,9312
1795,美時,8,2,6,華南永昌-民權,2023-11-08,9312
2303,聯電,8,2,6,華南永昌-民權,2023-11-08,9312
2367,燿華,6,0,6,華南永昌-民權,2023-11-08,9312
3570,大塚,6,0,6,華南永昌-民權,2023-11-08,9312
3363,上詮,6,1,5,華南永昌-民權,2023-11-08,9312
3317,尼克森,8,3,5,華南永昌-民權,2023-11-08,9312
6732,昇佳電子,7,2,5,華南永昌-民權,2023-11-08,9312
00882,中信中國高股息,5,0,5,華南永昌-民權,2023-11-08,9312
00715L,期街口布蘭特正2,5,0,5,華南永昌-民權,2023-11-08,9312
3014,聯陽,9,4,5,華南永昌-民權,2023-11-08,9312
3060,銘異,5,0,5,華南永昌-民權,2023-11-08,9312
4167,松瑞藥,12,7,5,華南永昌-民權,2023-11-08,9312
4958,臻鼎-KY,5,0,5,華南永昌-民權,2023-11-08,9312
6122,擎邦,8,3,5,華南永昌-民權,2023-11-08,9312
6770,力積電,11,6,5,華南永昌-民權,2023-11-08,9312
8163,達方,5,0,5,華南永昌-民權,2023-11-08,9312
5351,鈺創,7,2,5,華南永昌-民權,2023-11-08,9312
1815,富喬,21,17,4,華南永昌-民權,2023-11-08,9312
2388,威盛,10,6,4,華南永昌-民權,2023-11-08,9312
2610,華航,8,4,4,華南永昌-民權,2023-11-08,9312
8046,南電,4,1,3,華南永昌-民權,2023-11-08,9312
00679B,元大美債20年,3,0,3,華南永昌-民權,2023-11-08,9312
2356,英業達,7,4,3,華南永昌-民權,2023-11-08,9312
00935,野村臺灣新科技50,3,0,3,華南永昌-民權,2023-11-08,9312
1582,信錦,3,0,3,華南永昌-民權,2023-11-08,9312
1802,台玻,3,0,3,華南永昌-民權,2023-11-08,9312
2460,建通,3,0,3,華南永昌-民權,2023-11-08,9312
00720B,元大投資級公司債,88,0,88,華南永昌-民權,2023-11-09,9312
5465,富驊,40,0,40,華南永昌-民權,2023-11-09,9312
3105,穩懋,71,40,31,華南永昌-民權,2023-11-09,9312
00687B,國泰20年美債,20,0,20,華南永昌-民權,2023-11-09,9312
00753L,中信中國50正2,20,0,20,華南永昌-民權,2023-11-09,9312
6418,詠昇,20,0,20,華南永昌-民權,2023-11-09,9312
2023,燁輝,19,0,19,華南永昌-民權,2023-11-09,9312
2486,一詮,17,0,17,華南永昌-民權,2023-11-09,9312
3013,晟銘電,17,0,17,華南永昌-民權,2023-11-09,9312
1324,地球,15,0,15,華南永昌-民權,2023-11-09,9312
1519,華城,15,2,13,華南永昌-民權,2023-11-09,9312
00935,野村臺灣新科技50,11,0,11,華南永昌-民權,2023-11-09,9312
2329,華泰,37,26,11,華南永昌-民權,2023-11-09,9312
6167,久正,11,0,11,華南永昌-民權,2023-11-09,9312
00632R,元大台灣50反1,10,0,10,華南永昌-民權,2023-11-09,9312
1524,耿鼎,10,0,10,華南永昌-民權,2023-11-09,9312
5521,工信,11,1,10,華南永昌-民權,2023-11-09,9312
00688L,國泰20年美債正2,9,0,9,華南永昌-民權,2023-11-09,9312
2449,京元電子,9,0,9,華南永昌-民權,2023-11-09,9312
2363,矽統,13,4,9,華南永昌-民權,2023-11-09,9312
3041,揚智,18,10,8,華南永昌-民權,2023-11-09,9312
4942,嘉彰,8,0,8,華南永昌-民權,2023-11-09,9312
5347,世界,7,0,7,華南永昌-民權,2023-11-09,9312
1582,信錦,7,0,7,華南永昌-民權,2023-11-09,9312
2464,盟立,7,0,7,華南永昌-民權,2023-11-09,9312
2880,華南金,7,0,7,華南永昌-民權,2023-11-09,9312
8054,安國,7,0,7,華南永昌-民權,2023-11-09,9312
9955,佳龍,7,0,7,華南永昌-民權,2023-11-09,9312
1314,中石化,6,0,6,華南永昌-民權,2023-11-09,9312
00715L,期街口布蘭特正2,6,0,6,華南永昌-民權,2023-11-09,9312
00934,中信成長高股息,6,0,6,華南永昌-民權,2023-11-09,9312
2331,精英,16,10,6,華南永昌-民權,2023-11-09,9312
2641,正德,6,0,6,華南永昌-民權,2023-11-09,9312
6292,迅德,6,0,6,華南永昌-民權,2023-11-09,9312
1319,東陽,7,1,6,華南永昌-民權,2023-11-09,9312
00936,台新永續高息中小,5,0,5,華南永昌-民權,2023-11-09,9312
2313,華通,6,1,5,華南永昌-民權,2023-11-09,9312
1515,力山,6,1,5,華南永昌-民權,2023-11-09,9312
00882,中信中國高股息,5,0,5,華南永昌-民權,2023-11-09,9312
2405,輔信,5,0,5,華南永昌-民權,2023-11-09,9312
2460,建通,5,0,5,華南永昌-民權,2023-11-09,9312
3078,僑威,5,0,5,華南永昌-民權,2023-11-09,9312
3189,景碩,5,0,5,華南永昌-民權,2023-11-09,9312
3287,廣寰科,5,0,5,華南永昌-民權,2023-11-09,9312
4171,瑞基,5,0,5,華南永昌-民權,2023-11-09,9312
4549,桓達,5,0,5,華南永昌-民權,2023-11-09,9312
5244,弘凱,5,0,5,華南永昌-民權,2023-11-09,9312
5439,高技,5,0,5,華南永昌-民權,2023-11-09,9312
9907,統一實,5,0,5,華南永昌-民權,2023-11-09,9312
2634,漢翔,4,0,4,華南永昌-民權,2023-11-09,9312
6187,萬潤,200,10,190,華南永昌-民權,2023-11-10,9312
00753L,中信中國50正2,50,0,50,華南永昌-民權,2023-11-10,9312
3645,達邁,30,0,30,華南永昌-民權,2023-11-10,9312
00878,國泰永續高股息,26,0,26,華南永昌-民權,2023-11-10,9312
00936,台新永續高息中小,20,0,20,華南永昌-民權,2023-11-10,9312
2323,中環,20,0,20,華南永昌-民權,2023-11-10,9312
2002,中鋼,41,22,19,華南永昌-民權,2023-11-10,9312
00929,復華台灣科技優息,39,21,18,華南永昌-民權,2023-11-10,9312
3652,精聯,17,0,17,華南永昌-民權,2023-11-10,9312
8034,榮群,17,1,16,華南永昌-民權,2023-11-10,9312
8436,大江,44,30,14,華南永昌-民權,2023-11-10,9312
8927,北基,13,1,12,華南永昌-民權,2023-11-10,9312
1312,國喬,11,0,11,華南永昌-民權,2023-11-10,9312
00919,群益台灣精選高息,11,0,11,華南永昌-民權,2023-11-10,9312
00720B,元大投資級公司債,10,0,10,華南永昌-民權,2023-11-10,9312
00713,元大台灣高息低波,10,0,10,華南永昌-民權,2023-11-10,9312
3443,創意,17,7,10,華南永昌-民權,2023-11-10,9312
00671R,富邦NASDAQ反1,10,0,10,華南永昌-民權,2023-11-10,9312
00637L,元大滬深300正2,10,0,10,華南永昌-民權,2023-11-10,9312
00632R,元大台灣50反1,10,0,10,華南永昌-民權,2023-11-10,9312
2634,漢翔,15,5,10,華南永昌-民權,2023-11-10,9312
5009,榮剛,10,0,10,華南永昌-民權,2023-11-10,9312
6418,詠昇,10,0,10,華南永昌-民權,2023-11-10,9312
3209,全科,8,0,8,華南永昌-民權,2023-11-10,9312
4904,遠傳,8,0,8,華南永昌-民權,2023-11-10,9312
1609,大亞,8,0,8,華南永昌-民權,2023-11-10,9312
4743,合一,22,14,8,華南永昌-民權,2023-11-10,9312
3231,緯創,16,9,7,華南永昌-民權,2023-11-10,9312
0056,元大高股息,9,2,7,華南永昌-民權,2023-11-10,9312
6290,良維,8,1,7,華南永昌-民權,2023-11-10,9312
2105,正新,12,6,6,華南永昌-民權,2023-11-10,9312
2504,國產,6,0,6,華南永昌-民權,2023-11-10,9312
4128,中天,51,45,6,華南永昌-民權,2023-11-10,9312
6417,韋僑,7,1,6,華南永昌-民權,2023-11-10,9312
00931B,統一美債20年,5,0,5,華南永昌-民權,2023-11-10,9312
00679B,元大美債20年,5,0,5,華南永昌-民權,2023-11-10,9312
2352,佳世達,5,0,5,華南永昌-民權,2023-11-10,9312
2369,菱生,5,0,5,華南永昌-民權,2023-11-10,9312
2409,友達,5,0,5,華南永昌-民權,2023-11-10,9312
2478,大毅,5,0,5,華南永昌-民權,2023-11-10,9312
3062,建漢,5,0,5,華南永昌-民權,2023-11-10,9312
4162,智擎,6,1,5,華南永昌-民權,2023-11-10,9312
6117,迎廣,49,44,5,華南永昌-民權,2023-11-10,9312
6133,金橋,5,0,5,華南永昌-民權,2023-11-10,9312
6841,長佳智能,6,1,5,華南永昌-民權,2023-11-10,9312
00680L,元大美債20正2,5,1,4,華南永昌-民權,2023-11-10,9312
3038,全台,4,0,4,華南永昌-民權,2023-11-10,9312
3041,揚智,17,13,4,華南永昌-民權,2023-11-10,9312
3205,佰研,4,0,4,華南永昌-民權,2023-11-10,9312
6494,九齊,4,0,4,華南永昌-民權,2023-11-10,9312
00680L,元大美債20正2,115,0,115,華南永昌-民權,2023-11-13,9312
00706L,期元大S＆P日圓正2,100,0,100,華南永昌-民權,2023-11-13,9312
2603,長榮,70,0,70,華南永昌-民權,2023-11-13,9312
00679B,元大美債20年,69,0,69,華南永昌-民權,2023-11-13,9312
2367,燿華,57,0,57,華南永昌-民權,2023-11-13,9312
4905,台聯電,29,0,29,華南永昌-民權,2023-11-13,9312
6276,安鈦克,21,1,20,華南永昌-民權,2023-11-13,9312
4129,聯合,18,0,18,華南永昌-民權,2023-11-13,9312
6901,鑽石投資,18,0,18,華南永昌-民權,2023-11-13,9312
00935,野村臺灣新科技50,16,0,16,華南永昌-民權,2023-11-13,9312
8176,智捷,15,0,15,華南永昌-民權,2023-11-13,9312
00929,復華台灣科技優息,26,14,12,華南永昌-民權,2023-11-13,9312
2303,聯電,30,19,11,華南永昌-民權,2023-11-13,9312
00933B,國泰10Y+金融債,10,0,10,華南永昌-民權,2023-11-13,9312
2633,台灣高鐵,10,0,10,華南永昌-民權,2023-11-13,9312
2812,台中銀,10,0,10,華南永昌-民權,2023-11-13,9312
4712,福格創新,10,0,10,華南永昌-民權,2023-11-13,9312
4987,科誠,10,0,10,華南永昌-民權,2023-11-13,9312
5011,久陽,10,0,10,華南永昌-民權,2023-11-13,9312
6292,迅德,10,0,10,華南永昌-民權,2023-11-13,9312
8076,伍豐,10,0,10,華南永昌-民權,2023-11-13,9312
1815,富喬,23,16,7,華南永昌-民權,2023-11-13,9312
2104,國際中橡,7,0,7,華南永昌-民權,2023-11-13,9312
00772B,中信高評級公司債,6,0,6,華南永昌-民權,2023-11-13,9312
00637L,元大滬深300正2,6,0,6,華南永昌-民權,2023-11-13,9312
4417,金洲,6,0,6,華南永昌-民權,2023-11-13,9312
9927,泰銘,6,0,6,華南永昌-民權,2023-11-13,9312
00687B,國泰20年美債,5,0,5,華南永昌-民權,2023-11-13,9312
00751B,元大AAA至A公司債,5,0,5,華南永昌-民權,2023-11-13,9312
3645,達邁,5,0,5,華南永昌-民權,2023-11-13,9312
3652,精聯,5,0,5,華南永昌-民權,2023-11-13,9312
4105,東洋,5,0,5,華南永昌-民權,2023-11-13,9312
4904,遠傳,5,0,5,華南永昌-民權,2023-11-13,9312
4931,新盛力,5,0,5,華南永昌-民權,2023-11-13,9312
6117,迎廣,12,7,5,華南永昌-民權,2023-11-13,9312
8110,華東,5,0,5,華南永昌-民權,2023-11-13,9312
1568,倉佑,4,0,4,華南永昌-民權,2023-11-13,9312
2439,美律,7,3,4,華南永昌-民權,2023-11-13,9312
4113,聯上,4,0,4,華南永昌-民權,2023-11-13,9312
4128,中天,4,0,4,華南永昌-民權,2023-11-13,9312
6202,盛群,4,0,4,華南永昌-民權,2023-11-13,9312
6530,創威,5,1,4,華南永昌-民權,2023-11-13,9312
8255,朋程,4,0,4,華南永昌-民權,2023-11-13,9312
2324,仁寶,3,0,3,華南永昌-民權,2023-11-13,9312
00919,群益台灣精選高息,3,0,3,華南永昌-民權,2023-11-13,9312
00885,富邦越南,5,2,3,華南永昌-民權,2023-11-13,9312
1307,三芳,3,0,3,華南永昌-民權,2023-11-13,9312
2241,艾姆勒,3,0,3,華南永昌-民權,2023-11-13,9312
2515,中工,7,4,3,華南永昌-民權,2023-11-13,9312
2543,皇昌,3,0,3,華南永昌-民權,2023-11-13,9312
6139,亞翔,80,0,80,華南永昌-民權,2023-11-14,9312
1301,台塑,40,2,38,華南永昌-民權,2023-11-14,9312
0056,元大高股息,43,6,37,華南永昌-民權,2023-11-14,9312
2637,慧洋-KY,30,0,30,華南永昌-民權,2023-11-14,9312
2002,中鋼,32,3,29,華南永昌-民權,2023-11-14,9312
00929,復華台灣科技優息,40,12,28,華南永昌-民權,2023-11-14,9312
5483,中美晶,23,0,23,華南永昌-民權,2023-11-14,9312
1721,三晃,20,0,20,華南永昌-民權,2023-11-14,9312
6418,詠昇,20,0,20,華南永昌-民權,2023-11-14,9312
2405,輔信,16,0,16,華南永昌-民權,2023-11-14,9312
5009,榮剛,16,0,16,華南永昌-民權,2023-11-14,9312
00900,富邦特選高股息30,16,0,16,華南永昌-民權,2023-11-14,9312
2605,新興,13,0,13,華南永昌-民權,2023-11-14,9312
2462,良得電,12,0,12,華南永昌-民權,2023-11-14,9312
00671R,富邦NASDAQ反1,10,0,10,華南永昌-民權,2023-11-14,9312
2465,麗臺,10,0,10,華南永昌-民權,2023-11-14,9312
2812,台中銀,10,0,10,華南永昌-民權,2023-11-14,9312
3652,精聯,10,0,10,華南永昌-民權,2023-11-14,9312
4510,高鋒,10,0,10,華南永昌-民權,2023-11-14,9312
5434,崇越,10,0,10,華南永昌-民權,2023-11-14,9312
8163,達方,10,0,10,華南永昌-民權,2023-11-14,9312
4171,瑞基,9,0,9,華南永昌-民權,2023-11-14,9312
3231,緯創,16,8,8,華南永昌-民權,2023-11-14,9312
1565,精華,8,0,8,華南永昌-民權,2023-11-14,9312
00878,國泰永續高股息,10,2,8,華南永昌-民權,2023-11-14,9312
2634,漢翔,11,4,7,華南永昌-民權,2023-11-14,9312
4743,合一,9,2,7,華南永昌-民權,2023-11-14,9312
3078,僑威,9,2,7,華南永昌-民權,2023-11-14,9312
4128,中天,7,0,7,華南永昌-民權,2023-11-14,9312
9945,潤泰新,7,0,7,華南永昌-民權,2023-11-14,9312
1815,富喬,14,8,6,華南永昌-民權,2023-11-14,9312
2206,三陽工業,6,0,6,華南永昌-民權,2023-11-14,9312
2427,三商電,6,1,5,華南永昌-民權,2023-11-14,9312
1504,東元,6,1,5,華南永昌-民權,2023-11-14,9312
1104,環泥,5,0,5,華南永昌-民權,2023-11-14,9312
1584,精剛,5,0,5,華南永昌-民權,2023-11-14,9312
1907,永豐餘,5,0,5,華南永昌-民權,2023-11-14,9312
4766,南寶,5,0,5,華南永昌-民權,2023-11-14,9312
5386,青雲,5,0,5,華南永昌-民權,2023-11-14,9312
2485,兆赫,7,2,5,華南永昌-民權,2023-11-14,9312
1101,台泥,4,0,4,華南永昌-民權,2023-11-14,9312
00680L,元大美債20正2,4,0,4,華南永昌-民權,2023-11-14,9312
2243,宏旭-KY,4,0,4,華南永昌-民權,2023-11-14,9312
2633,台灣高鐵,4,0,4,華南永昌-民權,2023-11-14,9312
2801,彰銀,5,1,4,華南永昌-民權,2023-11-14,9312
3041,揚智,34,30,4,華南永昌-民權,2023-11-14,9312
6112,邁達特,4,0,4,華南永昌-民權,2023-11-14,9312
1537,廣隆,3,0,3,華南永昌-民權,2023-11-14,9312
1467,南緯,9,6,3,華南永昌-民權,2023-11-14,9312
00632R,元大台灣50反1,3,0,3,華南永昌-民權,2023-11-14,9312
6187,萬潤,195,46,149,華南永昌-民權,2023-11-15,9312
2367,燿華,101,1,100,華南永昌-民權,2023-11-15,9312
2317,鴻海,95,1,94,華南永昌-民權,2023-11-15,9312
8086,宏捷科,51,0,51,華南永昌-民權,2023-11-15,9312
3276,宇環,51,1,50,華南永昌-民權,2023-11-15,9312
5483,中美晶,50,0,50,華南永昌-民權,2023-11-15,9312
00878,國泰永續高股息,48,2,46,華南永昌-民權,2023-11-15,9312
2313,華通,33,3,30,華南永昌-民權,2023-11-15,9312
00687B,國泰20年美債,21,0,21,華南永昌-民權,2023-11-15,9312
00632R,元大台灣50反1,20,0,20,華南永昌-民權,2023-11-15,9312
2801,彰銀,20,0,20,華南永昌-民權,2023-11-15,9312
2387,精元,19,1,18,華南永昌-民權,2023-11-15,9312
2402,毅嘉,14,0,14,華南永昌-民權,2023-11-15,9312
3481,群創,15,1,14,華南永昌-民權,2023-11-15,9312
4561,健椿,13,0,13,華南永昌-民權,2023-11-15,9312
2356,英業達,14,3,11,華南永昌-民權,2023-11-15,9312
8358,金居,11,0,11,華南永昌-民權,2023-11-15,9312
00720B,元大投資級公司債,13,3,10,華南永昌-民權,2023-11-15,9312
3306,鼎天,10,0,10,華南永昌-民權,2023-11-15,9312
4904,遠傳,10,0,10,華南永昌-民權,2023-11-15,9312
3443,創意,23,13,10,華南永昌-民權,2023-11-15,9312
2329,華泰,12,4,8,華南永昌-民權,2023-11-15,9312
6667,信紘科,10,2,8,華南永昌-民權,2023-11-15,9312
8034,榮群,11,3,8,華南永昌-民權,2023-11-15,9312
00923,群益台ESG低碳50,7,0,7,華南永昌-民權,2023-11-15,9312
00773B,中信優先金融債,7,0,7,華南永昌-民權,2023-11-15,9312
3652,精聯,7,0,7,華南永昌-民權,2023-11-15,9312
6593,台灣銘板,10,3,7,華南永昌-民權,2023-11-15,9312
00935,野村臺灣新科技50,6,0,6,華南永昌-民權,2023-11-15,9312
1718,中纖,8,2,6,華南永昌-民權,2023-11-15,9312
1815,富喬,16,10,6,華南永昌-民權,2023-11-15,9312
2359,所羅門,8,2,6,華南永昌-民權,2023-11-15,9312
3264,欣銓,6,0,6,華南永昌-民權,2023-11-15,9312
2358,廷鑫,5,0,5,華南永昌-民權,2023-11-15,9312
2468,華經,5,0,5,華南永昌-民權,2023-11-15,9312
2537,聯上發,5,0,5,華南永昌-民權,2023-11-15,9312
5471,松翰,5,0,5,華南永昌-民權,2023-11-15,9312
6125,廣運,8,3,5,華南永昌-民權,2023-11-15,9312
6182,合晶,5,0,5,華南永昌-民權,2023-11-15,9312
1609,大亞,8,3,5,華南永昌-民權,2023-11-15,9312
2485,兆赫,6,2,4,華南永昌-民權,2023-11-15,9312
2409,友達,5,1,4,華南永昌-民權,2023-11-15,9312
2607,榮運,4,0,4,華南永昌-民權,2023-11-15,9312
3217,優群,4,0,4,華南永昌-民權,2023-11-15,9312
00934,中信成長高股息,4,0,4,華南永昌-民權,2023-11-15,9312
2360,致茂,4,0,4,華南永昌-民權,2023-11-15,9312
3078,僑威,4,0,4,華南永昌-民權,2023-11-15,9312
6271,同欣電,4,0,4,華南永昌-民權,2023-11-15,9312
8112,至上,4,0,4,華南永昌-民權,2023-11-15,9312
3661,世芯-KY,4,1,3,華南永昌-民權,2023-11-15,9312
00680L,元大美債20正2,115,0,115,華南永昌-民權,2023-11-16,9312
2603,長榮,100,1,99,華南永昌-民權,2023-11-16,9312
00679B,元大美債20年,66,0,66,華南永昌-民權,2023-11-16,9312
00878,國泰永續高股息,47,5,42,華南永昌-民權,2023-11-16,9312
2317,鴻海,34,3,31,華南永昌-民權,2023-11-16,9312
2516,新建,33,4,29,華南永昌-民權,2023-11-16,9312
8927,北基,28,0,28,華南永昌-民權,2023-11-16,9312
00687B,國泰20年美債,25,0,25,華南永昌-民權,2023-11-16,9312
00933B,國泰10Y+金融債,21,0,21,華南永昌-民權,2023-11-16,9312
00632R,元大台灣50反1,20,0,20,華南永昌-民權,2023-11-16,9312
3276,宇環,16,0,16,華南永昌-民權,2023-11-16,9312
5512,力麒,17,1,16,華南永昌-民權,2023-11-16,9312
00753L,中信中國50正2,15,0,15,華南永昌-民權,2023-11-16,9312
2607,榮運,13,0,13,華南永昌-民權,2023-11-16,9312
5521,工信,15,2,13,華南永昌-民權,2023-11-16,9312
2313,華通,13,1,12,華南永昌-民權,2023-11-16,9312
00637L,元大滬深300正2,11,0,11,華南永昌-民權,2023-11-16,9312
00934,中信成長高股息,10,0,10,華南永昌-民權,2023-11-16,9312
2104,國際中橡,10,0,10,華南永昌-民權,2023-11-16,9312
2363,矽統,18,8,10,華南永昌-民權,2023-11-16,9312
3689,湧德,10,0,10,華南永昌-民權,2023-11-16,9312
6417,韋僑,10,0,10,華南永昌-民權,2023-11-16,9312
3481,群創,12,3,9,華南永昌-民權,2023-11-16,9312
00715L,期街口布蘭特正2,8,0,8,華南永昌-民權,2023-11-16,9312
3078,僑威,7,0,7,華南永昌-民權,2023-11-16,9312
00773B,中信優先金融債,6,0,6,華南永昌-民權,2023-11-16,9312
00919,群益台灣精選高息,6,0,6,華南永昌-民權,2023-11-16,9312
2344,華邦電,16,10,6,華南永昌-民權,2023-11-16,9312
00885,富邦越南,5,0,5,華南永昌-民權,2023-11-16,9312
00882,中信中國高股息,5,0,5,華南永昌-民權,2023-11-16,9312
1609,大亞,7,2,5,華南永昌-民權,2023-11-16,9312
2358,廷鑫,5,0,5,華南永昌-民權,2023-11-16,9312
2369,菱生,9,4,5,華南永昌-民權,2023-11-16,9312
2705,六福,5,0,5,華南永昌-民權,2023-11-16,9312
3545,敦泰,8,3,5,華南永昌-民權,2023-11-16,9312
4147,中裕,5,0,5,華南永昌-民權,2023-11-16,9312
5258,虹堡,5,0,5,華南永昌-民權,2023-11-16,9312
6235,華孚,10,5,5,華南永昌-民權,2023-11-16,9312
2883,凱基金,10,6,4,華南永昌-民權,2023-11-16,9312
3443,創意,7,3,4,華南永昌-民權,2023-11-16,9312
1514,亞力,5,1,4,華南永昌-民權,2023-11-16,9312
1605,華新,5,1,4,華南永昌-民權,2023-11-16,9312
2888B,新光金乙特,6,2,4,華南永昌-民權,2023-11-16,9312
6535,順藥,4,0,4,華南永昌-民權,2023-11-16,9312
6672,騰輝電子-KY,5,1,4,華南永昌-民權,2023-11-16,9312
6790,永豐實,4,0,4,華南永昌-民權,2023-11-16,9312
4967,十銓,10,7,3,華南永昌-民權,2023-11-16,9312
1504,東元,3,0,3,華南永昌-民權,2023-11-16,9312
5880,合庫金,3,0,3,華南永昌-民權,2023-11-16,9312
2355,敬鵬,7,4,3,華南永昌-民權,2023-11-16,9312
00680L,元大美債20正2,202,0,202,華南永昌-民權,2023-11-17,9312
2337,旺宏,51,0,51,華南永昌-民權,2023-11-17,9312
3030,德律,30,0,30,華南永昌-民權,2023-11-17,9312
4123,晟德,30,0,30,華南永昌-民權,2023-11-17,9312
2498,宏達電,30,1,29,華南永昌-民權,2023-11-17,9312
6269,台郡,24,0,24,華南永昌-民權,2023-11-17,9312
00933B,國泰10Y+金融債,20,0,20,華南永昌-民權,2023-11-17,9312
00753L,中信中國50正2,20,0,20,華南永昌-民權,2023-11-17,9312
2702,華園,25,5,20,華南永昌-民權,2023-11-17,9312
1815,富喬,49,30,19,華南永昌-民權,2023-11-17,9312
00679B,元大美債20年,16,0,16,華南永昌-民權,2023-11-17,9312
00715L,期街口布蘭特正2,16,0,16,華南永昌-民權,2023-11-17,9312
2388,威盛,84,68,16,華南永昌-民權,2023-11-17,9312
0056,元大高股息,15,0,15,華南永昌-民權,2023-11-17,9312
1515,力山,13,0,13,華南永昌-民權,2023-11-17,9312
00725B,國泰投資級公司債,12,0,12,華南永昌-民權,2023-11-17,9312
2607,榮運,10,0,10,華南永昌-民權,2023-11-17,9312
00637L,元大滬深300正2,10,0,10,華南永昌-民權,2023-11-17,9312
00632R,元大台灣50反1,10,0,10,華南永昌-民權,2023-11-17,9312
2344,華邦電,20,10,10,華南永昌-民權,2023-11-17,9312
2888B,新光金乙特,10,0,10,華南永昌-民權,2023-11-17,9312
3276,宇環,11,1,10,華南永昌-民權,2023-11-17,9312
5608,四維航,10,0,10,華南永昌-民權,2023-11-17,9312
6187,萬潤,10,0,10,華南永昌-民權,2023-11-17,9312
8436,大江,10,0,10,華南永昌-民權,2023-11-17,9312
2412,中華電,10,0,10,華南永昌-民權,2023-11-17,9312
00712,復華富時不動產,8,0,8,華南永昌-民權,2023-11-17,9312
3081,聯亞,9,1,8,華南永昌-民權,2023-11-17,9312
5706,鳳凰,9,1,8,華南永昌-民權,2023-11-17,9312
00687B,國泰20年美債,7,0,7,華南永昌-民權,2023-11-17,9312
3041,揚智,13,7,6,華南永昌-民權,2023-11-17,9312
1504,東元,7,2,5,華南永昌-民權,2023-11-17,9312
4543,萬在,5,0,5,華南永昌-民權,2023-11-17,9312
5439,高技,6,1,5,華南永昌-民權,2023-11-17,9312
00633L,富邦上証正2,5,0,5,華南永昌-民權,2023-11-17,9312
00918,大華優利高填息30,8,3,5,華南永昌-民權,2023-11-17,9312
00864B,中信美國公債0-1,5,0,5,華南永昌-民權,2023-11-17,9312
1514,亞力,5,0,5,華南永昌-民權,2023-11-17,9312
2736,富野,13,8,5,華南永昌-民權,2023-11-17,9312
3515,華擎,5,0,5,華南永昌-民權,2023-11-17,9312
4712,福格創新,5,0,5,華南永昌-民權,2023-11-17,9312
2399,映泰,5,1,4,華南永昌-民權,2023-11-17,9312
3094,聯傑,4,0,4,華南永昌-民權,2023-11-17,9312
3450,聯鈞,4,0,4,華南永昌-民權,2023-11-17,9312
4174,浩鼎,4,0,4,華南永昌-民權,2023-11-17,9312
8936,國統,6,2,4,華南永昌-民權,2023-11-17,9312
00936,台新永續高息中小,3,0,3,華南永昌-民權,2023-11-17,9312
00850,元大臺灣ESG永續,3,0,3,華南永昌-民權,2023-11-17,9312
1582,信錦,4,1,3,華南永昌-民權,2023-11-17,9312
2605,新興,34,31,3,華南永昌-民權,2023-11-17,9312
00933B,國泰10Y+金融債,301,0,301,華南永昌-民權,2023-11-20,9312
00679B,元大美債20年,127,0,127,華南永昌-民權,2023-11-20,9312
2610,華航,115,6,109,華南永昌-民權,2023-11-20,9312
00680L,元大美債20正2,107,0,107,華南永昌-民權,2023-11-20,9312
5258,虹堡,100,12,88,華南永昌-民權,2023-11-20,9312
00772B,中信高評級公司債,26,0,26,華南永昌-民權,2023-11-20,9312
3011,今皓,26,0,26,華南永昌-民權,2023-11-20,9312
3652,精聯,23,0,23,華南永昌-民權,2023-11-20,9312
2317,鴻海,22,0,22,華南永昌-民權,2023-11-20,9312
1605,華新,21,0,21,華南永昌-民權,2023-11-20,9312
2312,金寶,21,0,21,華南永昌-民權,2023-11-20,9312
4938,和碩,22,1,21,華南永昌-民權,2023-11-20,9312
00934,中信成長高股息,16,0,16,華南永昌-民權,2023-11-20,9312
1565,精華,15,0,15,華南永昌-民權,2023-11-20,9312
6168,宏齊,18,6,12,華南永昌-民權,2023-11-20,9312
3481,群創,16,4,12,華南永昌-民權,2023-11-20,9312
00882,中信中國高股息,11,0,11,華南永昌-民權,2023-11-20,9312
00935,野村臺灣新科技50,11,0,11,華南永昌-民權,2023-11-20,9312
2748,雲品,11,0,11,華南永昌-民權,2023-11-20,9312
1809,中釉,10,0,10,華南永昌-民權,2023-11-20,9312
2208,台船,10,0,10,華南永昌-民權,2023-11-20,9312
4960,誠美材,10,0,10,華南永昌-民權,2023-11-20,9312
00929,復華台灣科技優息,29,21,8,華南永昌-民權,2023-11-20,9312
2743,山富,8,0,8,華南永昌-民權,2023-11-20,9312
2356,英業達,10,2,8,華南永昌-民權,2023-11-20,9312
6472,保瑞,7,0,7,華南永昌-民權,2023-11-20,9312
6417,韋僑,8,1,7,華南永昌-民權,2023-11-20,9312
3035,智原,14,7,7,華南永昌-民權,2023-11-20,9312
2344,華邦電,12,6,6,華南永昌-民權,2023-11-20,9312
2369,菱生,14,8,6,華南永昌-民權,2023-11-20,9312
00632R,元大台灣50反1,15,10,5,華南永昌-民權,2023-11-20,9312
1582,信錦,8,3,5,華南永昌-民權,2023-11-20,9312
3025,星通,10,5,5,華南永昌-民權,2023-11-20,9312
3357,臺慶科,5,0,5,華南永昌-民權,2023-11-20,9312
3363,上詮,5,0,5,華南永昌-民權,2023-11-20,9312
5381,合正,5,0,5,華南永昌-民權,2023-11-20,9312
6127,九豪,6,1,5,華南永昌-民權,2023-11-20,9312
6270,倍微,5,0,5,華南永昌-民權,2023-11-20,9312
9950,萬國通,5,0,5,華南永昌-民權,2023-11-20,9312
3036A,文曄甲特,5,0,5,華南永昌-民權,2023-11-20,9312
3231,緯創,7,3,4,華南永昌-民權,2023-11-20,9312
6443,元晶,7,3,4,華南永昌-民權,2023-11-20,9312
2324,仁寶,10,6,4,華南永昌-民權,2023-11-20,9312
3380,明泰,5,1,4,華南永昌-民權,2023-11-20,9312
4905,台聯電,4,0,4,華南永昌-民權,2023-11-20,9312
6235,華孚,4,0,4,華南永昌-民權,2023-11-20,9312
6282,康舒,5,1,4,華南永昌-民權,2023-11-20,9312
6531,愛普*,3,0,3,華南永昌-民權,2023-11-20,9312
00687B,國泰20年美債,3,0,3,華南永昌-民權,2023-11-20,9312
2201,裕隆,5,2,3,華南永昌-民權,2023-11-20,9312
2337,旺宏,157,0,157,華南永昌-民權,2023-11-21,9312
00933B,國泰10Y+金融債,100,0,100,華南永昌-民權,2023-11-21,9312
6139,亞翔,61,1,60,華南永昌-民權,2023-11-21,9312
00632R,元大台灣50反1,45,0,45,華南永昌-民權,2023-11-21,9312
2380,虹光,50,10,40,華南永昌-民權,2023-11-21,9312
2313,華通,186,159,27,華南永昌-民權,2023-11-21,9312
2363,矽統,36,10,26,華南永昌-民權,2023-11-21,9312
00671R,富邦NASDAQ反1,20,0,20,華南永昌-民權,2023-11-21,9312
1419,新紡,20,0,20,華南永昌-民權,2023-11-21,9312
1612,宏泰,20,0,20,華南永昌-民權,2023-11-21,9312
8147,正淩,20,0,20,華南永昌-民權,2023-11-21,9312
00712,復華富時不動產,21,3,18,華南永昌-民權,2023-11-21,9312
1321,大洋,17,0,17,華南永昌-民權,2023-11-21,9312
2329,華泰,27,11,16,華南永昌-民權,2023-11-21,9312
00679B,元大美債20年,15,0,15,華南永昌-民權,2023-11-21,9312
6449,鈺邦,15,0,15,華南永昌-民權,2023-11-21,9312
1565,精華,12,0,12,華南永昌-民權,2023-11-21,9312
3652,精聯,12,0,12,華南永昌-民權,2023-11-21,9312
2605,新興,11,0,11,華南永昌-民權,2023-11-21,9312
00725B,國泰投資級公司債,10,0,10,華南永昌-民權,2023-11-21,9312
00720B,元大投資級公司債,10,0,10,華南永昌-民權,2023-11-21,9312
2027,大成鋼,12,2,10,華南永昌-民權,2023-11-21,9312
3285,微端,10,0,10,華南永昌-民權,2023-11-21,9312
3715,定穎投控,13,3,10,華南永昌-民權,2023-11-21,9312
9105,泰金寶-DR,10,0,10,華南永昌-民權,2023-11-21,9312
00900,富邦特選高股息30,10,1,9,華南永昌-民權,2023-11-21,9312
2537,聯上發,18,10,8,華南永昌-民權,2023-11-21,9312
8936,國統,9,1,8,華南永昌-民權,2023-11-21,9312
1519,華城,7,0,7,華南永昌-民權,2023-11-21,9312
4543,萬在,15,8,7,華南永昌-民權,2023-11-21,9312
6535,順藥,10,3,7,華南永昌-民權,2023-11-21,9312
8034,榮群,7,0,7,華南永昌-民權,2023-11-21,9312
2362,藍天,6,0,6,華南永昌-民權,2023-11-21,9312
2382,廣達,8,2,6,華南永昌-民權,2023-11-21,9312
3032,偉訓,6,0,6,華南永昌-民權,2023-11-21,9312
3512,皇龍,6,0,6,華南永昌-民權,2023-11-21,9312
4938,和碩,9,3,6,華南永昌-民權,2023-11-21,9312
6158,禾昌,6,0,6,華南永昌-民權,2023-11-21,9312
3062,建漢,5,0,5,華南永昌-民權,2023-11-21,9312
3059,華晶科,8,3,5,華南永昌-民權,2023-11-21,9312
00878,國泰永續高股息,11,6,5,華南永昌-民權,2023-11-21,9312
1582,信錦,7,2,5,華南永昌-民權,2023-11-21,9312
2014,中鴻,7,2,5,華南永昌-民權,2023-11-21,9312
2402,毅嘉,9,4,5,華南永昌-民權,2023-11-21,9312
2504,國產,5,0,5,華南永昌-民權,2023-11-21,9312
3363,上詮,10,5,5,華南永昌-民權,2023-11-21,9312
6188,廣明,6,1,5,華南永昌-民權,2023-11-21,9312
6417,韋僑,5,0,5,華南永昌-民權,2023-11-21,9312
3443,創意,6,1,5,華南永昌-民權,2023-11-21,9312
2367,燿華,49,44,5,華南永昌-民權,2023-11-21,9312
00680L,元大美債20正2,117,0,117,華南永昌-民權,2023-11-22,9312
2027,大成鋼,102,12,90,華南永昌-民權,2023-11-22,9312
8034,榮群,60,0,60,華南永昌-民權,2023-11-22,9312
2905,三商,35,0,35,華南永昌-民權,2023-11-22,9312
4953,緯軟,31,0,31,華南永昌-民權,2023-11-22,9312
2402,毅嘉,31,0,31,華南永昌-民權,2023-11-22,9312
1702,南僑,30,0,30,華南永昌-民權,2023-11-22,9312
00753L,中信中國50正2,25,0,25,華南永昌-民權,2023-11-22,9312
4712,福格創新,20,0,20,華南永昌-民權,2023-11-22,9312
3231,緯創,31,11,20,華南永昌-民權,2023-11-22,9312
00929,復華台灣科技優息,22,4,18,華南永昌-民權,2023-11-22,9312
0056,元大高股息,17,1,16,華南永昌-民權,2023-11-22,9312
2618,長榮航,26,10,16,華南永昌-民權,2023-11-22,9312
2101,南港,15,0,15,華南永昌-民權,2023-11-22,9312
1342,八貫,15,0,15,華南永昌-民權,2023-11-22,9312
2002,中鋼,40,26,14,華南永昌-民權,2023-11-22,9312
5258,虹堡,26,13,13,華南永昌-民權,2023-11-22,9312
2883,凱基金,12,0,12,華南永昌-民權,2023-11-22,9312
6235,華孚,12,0,12,華南永昌-民權,2023-11-22,9312
00934,中信成長高股息,10,0,10,華南永昌-民權,2023-11-22,9312
2356,英業達,11,1,10,華南永昌-民權,2023-11-22,9312
2884,玉山金,8,0,8,華南永昌-民權,2023-11-22,9312
2250,IKKA-KY,8,0,8,華南永昌-民權,2023-11-22,9312
00905,FT臺灣Smart,7,0,7,華南永昌-民權,2023-11-22,9312
2537,聯上發,7,0,7,華南永昌-民權,2023-11-22,9312
4927,泰鼎-KY,8,1,7,華南永昌-民權,2023-11-22,9312
5521,工信,13,6,7,華南永昌-民權,2023-11-22,9312
6125,廣運,10,3,7,華南永昌-民權,2023-11-22,9312
2330,台積電,6,0,6,華南永昌-民權,2023-11-22,9312
00633L,富邦上証正2,9,3,6,華南永昌-民權,2023-11-22,9312
2014,中鴻,7,1,6,華南永昌-民權,2023-11-22,9312
2405,輔信,11,5,6,華南永昌-民權,2023-11-22,9312
2736,富野,35,29,6,華南永昌-民權,2023-11-22,9312
6418,詠昇,9,3,6,華南永昌-民權,2023-11-22,9312
2449,京元電子,6,1,5,華南永昌-民權,2023-11-22,9312
2399,映泰,5,0,5,華南永昌-民權,2023-11-22,9312
1809,中釉,5,0,5,華南永昌-民權,2023-11-22,9312
2610,華航,9,4,5,華南永昌-民權,2023-11-22,9312
3062,建漢,5,0,5,華南永昌-民權,2023-11-22,9312
3483,力致,8,3,5,華南永昌-民權,2023-11-22,9312
6127,九豪,5,0,5,華南永昌-民權,2023-11-22,9312
6133,金橋,5,0,5,華南永昌-民權,2023-11-22,9312
8147,正淩,5,0,5,華南永昌-民權,2023-11-22,9312
8927,北基,5,0,5,華南永昌-民權,2023-11-22,9312
3041,揚智,50,46,4,華南永昌-民權,2023-11-22,9312
00662,富邦NASDAQ,4,0,4,華南永昌-民權,2023-11-22,9312
00915,凱基優選高股息30,4,0,4,華南永昌-民權,2023-11-22,9312
3504,揚明光,6,2,4,華南永昌-民權,2023-11-22,9312
5533,皇鼎,4,0,4,華南永昌-民權,2023-11-22,9312
6274,台燿,5,1,4,華南永昌-民權,2023-11-22,9312
6187,萬潤,503,2,501,華南永昌-民權,2023-11-23,9312
00929,復華台灣科技優息,86,2,84,華南永昌-民權,2023-11-23,9312
5521,工信,93,20,73,華南永昌-民權,2023-11-23,9312
3078,僑威,52,24,28,華南永昌-民權,2023-11-23,9312
00900,富邦特選高股息30,28,0,28,華南永昌-民權,2023-11-23,9312
3006,晶豪科,26,3,23,華南永昌-民權,2023-11-23,9312
9105,泰金寶-DR,22,0,22,華南永昌-民權,2023-11-23,9312
00878,國泰永續高股息,22,2,20,華南永昌-民權,2023-11-23,9312
00905,FT臺灣Smart,20,0,20,華南永昌-民權,2023-11-23,9312
2516,新建,17,0,17,華南永昌-民權,2023-11-23,9312
8927,北基,17,0,17,華南永昌-民權,2023-11-23,9312
3322,建舜電,15,0,15,華南永昌-民權,2023-11-23,9312
5009,榮剛,15,0,15,華南永昌-民權,2023-11-23,9312
00919,群益台灣精選高息,12,0,12,華南永昌-民權,2023-11-23,9312
3013,晟銘電,62,50,12,華南永昌-民權,2023-11-23,9312
00882,中信中國高股息,11,0,11,華南永昌-民權,2023-11-23,9312
2388,威盛,44,33,11,華南永昌-民權,2023-11-23,9312
2888B,新光金乙特,11,0,11,華南永昌-民權,2023-11-23,9312
00892,富邦台灣半導體,10,0,10,華南永昌-民權,2023-11-23,9312
00891,中信關鍵半導體,10,0,10,華南永昌-民權,2023-11-23,9312
00632R,元大台灣50反1,10,0,10,華南永昌-民權,2023-11-23,9312
3652,精聯,10,0,10,華南永昌-民權,2023-11-23,9312
5515,建國,11,1,10,華南永昌-民權,2023-11-23,9312
6125,廣運,27,17,10,華南永昌-民權,2023-11-23,9312
3483,力致,14,5,9,華南永昌-民權,2023-11-23,9312
2367,燿華,9,1,8,華南永昌-民權,2023-11-23,9312
00915,凱基優選高股息30,8,0,8,華南永昌-民權,2023-11-23,9312
2462,良得電,11,3,8,華南永昌-民權,2023-11-23,9312
2313,華通,23,15,8,華南永昌-民權,2023-11-23,9312
3231,緯創,25,18,7,華南永昌-民權,2023-11-23,9312
2458,義隆,13,6,7,華南永昌-民權,2023-11-23,9312
6138,茂達,6,1,5,華南永昌-民權,2023-11-23,9312
00679B,元大美債20年,5,0,5,華南永昌-民權,2023-11-23,9312
00637L,元大滬深300正2,5,0,5,華南永昌-民權,2023-11-23,9312
1337,再生-KY,5,0,5,華南永昌-民權,2023-11-23,9312
1717,長興,5,0,5,華南永昌-民權,2023-11-23,9312
2363,矽統,11,6,5,華南永昌-民權,2023-11-23,9312
2607,榮運,5,0,5,華南永昌-民權,2023-11-23,9312
2618,長榮航,12,7,5,華南永昌-民權,2023-11-23,9312
4549,桓達,5,0,5,華南永昌-民權,2023-11-23,9312
4960,誠美材,5,0,5,華南永昌-民權,2023-11-23,9312
5272,笙科,5,0,5,華南永昌-民權,2023-11-23,9312
2329,華泰,10,5,5,華南永昌-民權,2023-11-23,9312
6282,康舒,32,27,5,華南永昌-民權,2023-11-23,9312
6285,啟��,4,0,4,華南永昌-民權,2023-11-23,9312
00934,中信成長高股息,4,0,4,華南永昌-民權,2023-11-23,9312
3694,海華,8,4,4,華南永昌-民權,2023-11-23,9312
4726,永昕,6,2,4,華南永昌-民權,2023-11-23,9312
4927,泰鼎-KY,4,0,4,華南永昌-民權,2023-11-23,9312
6517,保勝光學,5,1,4,華南永昌-民權,2023-11-23,9312
2888,新光金,418,0,418,華南永昌-民權,2023-11-24,9312
2610,華航,143,4,139,華南永昌-民權,2023-11-24,9312
00680L,元大美債20正2,113,0,113,華南永昌-民權,2023-11-24,9312
2603,長榮,50,1,49,華南永昌-民權,2023-11-24,9312
2888B,新光金乙特,30,0,30,華南永昌-民權,2023-11-24,9312
2014,中鴻,31,4,27,華南永昌-民權,2023-11-24,9312
5340,建榮,27,0,27,華南永昌-民權,2023-11-24,9312
4171,瑞基,25,0,25,華南永昌-民權,2023-11-24,9312
1519,華城,25,4,21,華南永昌-民權,2023-11-24,9312
1608,華榮,20,0,20,華南永昌-民權,2023-11-24,9312
6168,宏齊,15,3,12,華南永昌-民權,2023-11-24,9312
6477,安集,12,0,12,華南永昌-民權,2023-11-24,9312
1568,倉佑,10,0,10,華南永昌-民權,2023-11-24,9312
2380,虹光,10,0,10,華南永昌-民權,2023-11-24,9312
3652,精聯,10,0,10,華南永昌-民權,2023-11-24,9312
6245,立端,24,14,10,華南永昌-民權,2023-11-24,9312
5521,工信,9,0,9,華南永昌-民權,2023-11-24,9312
00878,國泰永續高股息,9,1,8,華南永昌-民權,2023-11-24,9312
2618,長榮航,17,9,8,華南永昌-民權,2023-11-24,9312
8210,勤誠,8,0,8,華南永昌-民權,2023-11-24,9312
2492,華新科,11,4,7,華南永昌-民權,2023-11-24,9312
6834,天二科技,7,0,7,華南永昌-民權,2023-11-24,9312
6173,信昌電,8,1,7,華南永昌-民權,2023-11-24,9312
00933B,國泰10Y+金融債,6,0,6,華南永昌-民權,2023-11-24,9312
2329,華泰,8,2,6,華南永昌-民權,2023-11-24,9312
2331,精英,6,0,6,華南永昌-民權,2023-11-24,9312
2605,新興,10,4,6,華南永昌-民權,2023-11-24,9312
3094,聯傑,20,14,6,華南永昌-民權,2023-11-24,9312
8069,元太,6,0,6,華南永昌-民權,2023-11-24,9312
3443,創意,5,0,5,華南永昌-民權,2023-11-24,9312
4763,材料-KY,7,2,5,華南永昌-民權,2023-11-24,9312
00885,富邦越南,5,0,5,華南永昌-民權,2023-11-24,9312
00720B,元大投資級公司債,5,0,5,華南永昌-民權,2023-11-24,9312
00772B,中信高評級公司債,5,0,5,華南永昌-民權,2023-11-24,9312
2408,南亞科,5,0,5,華南永昌-民權,2023-11-24,9312
2427,三商電,5,0,5,華南永昌-民權,2023-11-24,9312
2506,太設,5,0,5,華南永昌-民權,2023-11-24,9312
3062,建漢,5,0,5,華南永昌-民權,2023-11-24,9312
3437,榮創,12,7,5,華南永昌-民權,2023-11-24,9312
2337,旺宏,4,0,4,華南永昌-民權,2023-11-24,9312
3706,神達,7,3,4,華南永昌-民權,2023-11-24,9312
4549,桓達,4,0,4,華南永昌-民權,2023-11-24,9312
5706,鳳凰,7,3,4,華南永昌-民權,2023-11-24,9312
8183,精星,4,0,4,華南永昌-民權,2023-11-24,9312
1609,大亞,40,37,3,華南永昌-民權,2023-11-24,9312
4909,新復興,3,0,3,華南永昌-民權,2023-11-24,9312
1449,佳和,3,0,3,華南永昌-民權,2023-11-24,9312
1584,精剛,6,3,3,華南永昌-民權,2023-11-24,9312
1718,中纖,3,0,3,華南永昌-民權,2023-11-24,9312
1815,富喬,4,1,3,華南永昌-民權,2023-11-24,9312
00680L,元大美債20正2,105,0,105,華南永昌-民權,2023-11-27,9312
00919,群益台灣精選高息,86,0,86,華南永昌-民權,2023-11-27,9312
00679B,元大美債20年,31,0,31,華南永昌-民權,2023-11-27,9312
2883,凱基金,39,10,29,華南永昌-民權,2023-11-27,9312
3231,緯創,31,6,25,華南永昌-民權,2023-11-27,9312
2634,漢翔,28,3,25,華南永昌-民權,2023-11-27,9312
6901,鑽石投資,25,0,25,華南永昌-民權,2023-11-27,9312
2461,光群雷,20,0,20,華南永昌-民權,2023-11-27,9312
3652,精聯,20,0,20,華南永昌-民權,2023-11-27,9312
6139,亞翔,20,0,20,華南永昌-民權,2023-11-27,9312
3105,穩懋,15,2,13,華南永昌-民權,2023-11-27,9312
00934,中信成長高股息,12,0,12,華南永昌-民權,2023-11-27,9312
6173,信昌電,12,0,12,華南永昌-民權,2023-11-27,9312
6494,九齊,12,0,12,華南永昌-民權,2023-11-27,9312
9919,康那香,12,0,12,華南永昌-民權,2023-11-27,9312
00932,兆豐永續高息等權,11,0,11,華南永昌-民權,2023-11-27,9312
1701,中化,11,0,11,華南永昌-民權,2023-11-27,9312
3221,台嘉碩,11,0,11,華南永昌-民權,2023-11-27,9312
4167,松瑞藥,11,0,11,華南永昌-民權,2023-11-27,9312
2382,廣達,11,1,10,華南永昌-民權,2023-11-27,9312
00637L,元大滬深300正2,10,0,10,華南永昌-民權,2023-11-27,9312
00633L,富邦上証正2,12,2,10,華南永昌-民權,2023-11-27,9312
1612,宏泰,10,0,10,華南永昌-民權,2023-11-27,9312
2498,宏達電,10,0,10,華南永昌-民權,2023-11-27,9312
8927,北基,10,0,10,華南永昌-民權,2023-11-27,9312
00632R,元大台灣50反1,10,1,9,華南永昌-民權,2023-11-27,9312
1815,富喬,23,14,9,華南永昌-民權,2023-11-27,9312
3078,僑威,8,0,8,華南永昌-民權,2023-11-27,9312
4533,協易機,8,0,8,華南永昌-民權,2023-11-27,9312
1514,亞力,14,6,8,華南永昌-民權,2023-11-27,9312
2890,永豐金,13,6,7,華南永昌-民權,2023-11-27,9312
2329,華泰,20,13,7,華南永昌-民權,2023-11-27,9312
2353,宏��,7,0,7,華南永昌-民權,2023-11-27,9312
00878,國泰永續高股息,17,11,6,華南永昌-民權,2023-11-27,9312
5351,鈺創,12,6,6,華南永昌-民權,2023-11-27,9312
2405,輔信,6,0,6,華南永昌-民權,2023-11-27,9312
2543,皇昌,8,2,6,華南永昌-民權,2023-11-27,9312
3176,基亞,6,0,6,華南永昌-民權,2023-11-27,9312
3545,敦泰,8,2,6,華南永昌-民權,2023-11-27,9312
3682,亞太電,8,2,6,華南永昌-民權,2023-11-27,9312
4157,太景*-KY,6,0,6,華南永昌-民權,2023-11-27,9312
5439,高技,7,1,6,華南永昌-民權,2023-11-27,9312
6282,康舒,16,11,5,華南永昌-民權,2023-11-27,9312
00877,復華中國5G,5,0,5,華南永昌-民權,2023-11-27,9312
00902,中信電池及儲能,5,0,5,華南永昌-民權,2023-11-27,9312
00725B,國泰投資級公司債,5,0,5,華南永昌-民權,2023-11-27,9312
00772B,中信高評級公司債,6,1,5,華南永昌-民權,2023-11-27,9312
00706L,期元大S＆P日圓正2,5,0,5,華南永昌-民權,2023-11-27,9312
00720B,元大投資級公司債,5,0,5,華南永昌-民權,2023-11-27,9312
1731,美吾華,5,0,5,華南永昌-民權,2023-11-27,9312
1514,亞力,253,7,246,華南永昌-民權,2023-11-28,9312
1217,愛之味,150,0,150,華南永昌-民權,2023-11-28,9312
3036,文曄,100,0,100,華南永昌-民權,2023-11-28,9312
3652,精聯,70,0,70,華南永昌-民權,2023-11-28,9312
1616,億泰,40,0,40,華南永昌-民權,2023-11-28,9312
1312,國喬,31,0,31,華南永昌-民權,2023-11-28,9312
1419,新紡,20,0,20,華南永昌-民權,2023-11-28,9312
5258,虹堡,20,1,19,華南永昌-民權,2023-11-28,9312
3041,揚智,21,5,16,華南永昌-民權,2023-11-28,9312
2606,裕民,15,1,14,華南永昌-民權,2023-11-28,9312
2014,中鴻,15,3,12,華南永昌-民權,2023-11-28,9312
00885,富邦越南,11,0,11,華南永昌-民權,2023-11-28,9312
9802,鈺齊-KY,11,0,11,華南永昌-民權,2023-11-28,9312
1529,樂事綠能,10,0,10,華南永昌-民權,2023-11-28,9312
1731,美吾華,10,0,10,華南永昌-民權,2023-11-28,9312
1732,毛寶,10,0,10,華南永昌-民權,2023-11-28,9312
3231,緯創,11,1,10,華南永昌-民權,2023-11-28,9312
2303,聯電,10,0,10,華南永昌-民權,2023-11-28,9312
4973,廣穎,12,3,9,華南永昌-民權,2023-11-28,9312
1101,台泥,14,6,8,華南永昌-民權,2023-11-28,9312
5347,世界,8,0,8,華南永昌-民權,2023-11-28,9312
2356,英業達,11,4,7,華南永昌-民權,2023-11-28,9312
2888B,新光金乙特,7,0,7,華南永昌-民權,2023-11-28,9312
8043,蜜望實,7,0,7,華南永昌-民權,2023-11-28,9312
4114,健喬,8,1,7,華南永昌-民權,2023-11-28,9312
1316,上曜,6,0,6,華南永昌-民權,2023-11-28,9312
2425,承啟,6,0,6,華南永昌-民權,2023-11-28,9312
4905,台聯電,6,0,6,華南永昌-民權,2023-11-28,9312
00679B,元大美債20年,6,0,6,華南永昌-民權,2023-11-28,9312
2108,南帝,5,0,5,華南永昌-民權,2023-11-28,9312
2301,光寶科,6,1,5,華南永昌-民權,2023-11-28,9312
2734,易飛網,5,0,5,華南永昌-民權,2023-11-28,9312
4113,聯上,5,0,5,華南永昌-民權,2023-11-28,9312
8927,北基,5,0,5,華南永昌-民權,2023-11-28,9312
2027,大成鋼,25,21,4,華南永昌-民權,2023-11-28,9312
00633L,富邦上証正2,4,0,4,華南永昌-民權,2023-11-28,9312
1324,地球,4,0,4,華南永昌-民權,2023-11-28,9312
1565,精華,4,0,4,華南永昌-民權,2023-11-28,9312
1701,中化,6,2,4,華南永昌-民權,2023-11-28,9312
1760,寶齡富錦,4,0,4,華南永昌-民權,2023-11-28,9312
2482,連宇,4,0,4,華南永昌-民權,2023-11-28,9312
3163,波若威,4,0,4,華南永昌-民權,2023-11-28,9312
3646,艾恩特,4,0,4,華南永昌-民權,2023-11-28,9312
6243,迅杰,7,3,4,華南永昌-民權,2023-11-28,9312
8054,安國,5,1,4,華南永昌-民權,2023-11-28,9312
8358,金居,6,2,4,華南永昌-民權,2023-11-28,9312
9919,康那香,5,2,3,華南永昌-民權,2023-11-28,9312
2641,正德,4,1,3,華南永昌-民權,2023-11-28,9312
2360,致茂,3,0,3,華南永昌-民權,2023-11-28,9312
2462,良得電,3,0,3,華南永昌-民權,2023-11-28,9312
00919,群益台灣精選高息,202,0,202,華南永昌-民權,2023-11-29,9312
00882,中信中國高股息,105,0,105,華南永昌-民權,2023-11-29,9312
2610,華航,87,2,85,華南永昌-民權,2023-11-29,9312
00878,國泰永續高股息,51,2,49,華南永昌-民權,2023-11-29,9312
00772B,中信高評級公司債,47,3,44,華南永昌-民權,2023-11-29,9312
5608,四維航,50,12,38,華南永昌-民權,2023-11-29,9312
3437,榮創,36,0,36,華南永昌-民權,2023-11-29,9312
2618,長榮航,36,1,35,華南永昌-民權,2023-11-29,9312
2313,華通,75,41,34,華南永昌-民權,2023-11-29,9312
1752,南光,33,0,33,華南永昌-民權,2023-11-29,9312
2399,映泰,30,0,30,華南永昌-民權,2023-11-29,9312
9955,佳龍,41,13,28,華南永昌-民權,2023-11-29,9312
00753L,中信中國50正2,25,0,25,華南永昌-民權,2023-11-29,9312
00637L,元大滬深300正2,23,0,23,華南永昌-民權,2023-11-29,9312
6282,康舒,28,6,22,華南永昌-民權,2023-11-29,9312
00720B,元大投資級公司債,23,7,16,華南永昌-民權,2023-11-29,9312
8147,正淩,15,0,15,華南永昌-民權,2023-11-29,9312
2883B,凱基金乙特,11,0,11,華南永昌-民權,2023-11-29,9312
4953,緯軟,11,0,11,華南永昌-民權,2023-11-29,9312
2002,中鋼,13,2,11,華南永昌-民權,2023-11-29,9312
2367,燿華,17,7,10,華南永昌-民權,2023-11-29,9312
2383,台光電,10,0,10,華南永昌-民權,2023-11-29,9312
3652,精聯,10,0,10,華南永昌-民權,2023-11-29,9312
6150,撼訊,10,0,10,華南永昌-民權,2023-11-29,9312
2014,中鴻,10,1,9,華南永昌-民權,2023-11-29,9312
4114,健喬,9,0,9,華南永昌-民權,2023-11-29,9312
6834,天二科技,9,0,9,華南永昌-民權,2023-11-29,9312
1303,南亞,9,1,8,華南永昌-民權,2023-11-29,9312
2468,華經,8,0,8,華南永昌-民權,2023-11-29,9312
00712,復華富時不動產,7,0,7,華南永昌-民權,2023-11-29,9312
00687B,國泰20年美債,7,0,7,華南永昌-民權,2023-11-29,9312
1795,美時,8,1,7,華南永昌-民權,2023-11-29,9312
2401,凌陽,10,3,7,華南永昌-民權,2023-11-29,9312
2460,建通,12,5,7,華南永昌-民權,2023-11-29,9312
8054,安國,49,42,7,華南永昌-民權,2023-11-29,9312
3044,健鼎,6,0,6,華南永昌-民權,2023-11-29,9312
5351,鈺創,16,10,6,華南永昌-民權,2023-11-29,9312
2013,中鋼構,6,0,6,華南永昌-民權,2023-11-29,9312
2369,菱生,20,14,6,華南永昌-民權,2023-11-29,9312
2634,漢翔,6,0,6,華南永昌-民權,2023-11-29,9312
3041,揚智,38,32,6,華南永昌-民權,2023-11-29,9312
3094,聯傑,17,11,6,華南永昌-民權,2023-11-29,9312
3360,尚立,6,0,6,華南永昌-民權,2023-11-29,9312
8110,華東,14,8,6,華南永昌-民權,2023-11-29,9312
4967,十銓,5,0,5,華南永昌-民權,2023-11-29,9312
3138,耀登,7,2,5,華南永昌-民權,2023-11-29,9312
1513,中興電,11,6,5,華南永昌-民權,2023-11-29,9312
2314,台揚,5,0,5,華南永昌-民權,2023-11-29,9312
2478,大毅,5,0,5,華南永昌-民權,2023-11-29,9312
2736,富野,6,1,5,華南永昌-民權,2023-11-29,9312
1513,中興電,213,15,198,華南永昌-民權,2023-11-30,9312
00688L,國泰20年美債正2,180,2,178,華南永昌-民權,2023-11-30,9312
00720B,元大投資級公司債,92,10,82,華南永昌-民權,2023-11-30,9312
1316,上曜,56,0,56,華南永昌-民權,2023-11-30,9312
00885,富邦越南,55,0,55,華南永昌-民權,2023-11-30,9312
3652,精聯,50,0,50,華南永昌-民權,2023-11-30,9312
2498,宏達電,40,0,40,華南永昌-民權,2023-11-30,9312
00680L,元大美債20正2,32,0,32,華南永昌-民權,2023-11-30,9312
2618,長榮航,32,0,32,華南永昌-民權,2023-11-30,9312
3437,榮創,33,2,31,華南永昌-民權,2023-11-30,9312
2419,仲琦,30,0,30,華南永昌-民權,2023-11-30,9312
2313,華通,43,23,20,華南永昌-民權,2023-11-30,9312
00669R,國泰美國道瓊反1,20,0,20,華南永昌-民權,2023-11-30,9312
00632R,元大台灣50反1,25,5,20,華南永昌-民權,2023-11-30,9312
2614,東森,20,0,20,華南永昌-民權,2023-11-30,9312
00924,復華S＆P500成長,19,0,19,華南永昌-民權,2023-11-30,9312
2472,立隆電,17,0,17,華南永昌-民權,2023-11-30,9312
6150,撼訊,16,0,16,華南永昌-民權,2023-11-30,9312
6834,天二科技,16,0,16,華南永昌-民權,2023-11-30,9312
1101,台泥,16,2,14,華南永昌-民權,2023-11-30,9312
00919,群益台灣精選高息,15,1,14,華南永昌-民權,2023-11-30,9312
2409,友達,13,0,13,華南永昌-民權,2023-11-30,9312
3374,精材,13,0,13,華南永昌-民權,2023-11-30,9312
2303,聯電,12,0,12,華南永昌-民權,2023-11-30,9312
5272,笙科,14,3,11,華南永昌-民權,2023-11-30,9312
1605,華新,30,20,10,華南永昌-民權,2023-11-30,9312
2317,鴻海,20,10,10,華南永昌-民權,2023-11-30,9312
2617,台航,10,0,10,華南永昌-民權,2023-11-30,9312
3062,建漢,10,0,10,華南永昌-民權,2023-11-30,9312
5439,高技,13,3,10,華南永昌-民權,2023-11-30,9312
8011,台通,10,0,10,華南永昌-民權,2023-11-30,9312
00934,中信成長高股息,9,0,9,華南永昌-民權,2023-11-30,9312
5469,瀚宇博,10,1,9,華南永昌-民權,2023-11-30,9312
6243,迅杰,11,2,9,華南永昌-民權,2023-11-30,9312
00878,國泰永續高股息,10,2,8,華南永昌-民權,2023-11-30,9312
8147,正淩,8,0,8,華南永昌-民權,2023-11-30,9312
3231,緯創,14,7,7,華南永昌-民權,2023-11-30,9312
1519,華城,31,24,7,華南永昌-民權,2023-11-30,9312
1717,長興,7,0,7,華南永昌-民權,2023-11-30,9312
2481,強茂,8,1,7,華南永昌-民權,2023-11-30,9312
00726B,國泰新興投等債,6,0,6,華南永昌-民權,2023-11-30,9312
2363,矽統,6,0,6,華南永昌-民權,2023-11-30,9312
3032,偉訓,7,1,6,華南永昌-民權,2023-11-30,9312
3059,華晶科,17,11,6,華南永昌-民權,2023-11-30,9312
4114,健喬,7,1,6,華南永昌-民權,2023-11-30,9312
6276,安鈦克,6,0,6,華南永昌-民權,2023-11-30,9312
00915,凱基優選高股息30,10,5,5,華南永昌-民權,2023-11-30,9312
1438,三地開發,5,0,5,華南永昌-民權,2023-11-30,9312
1701,中化,5,0,5,華南永昌-民權,2023-11-30,9312
2332,友訊,8,3,5,華南永昌-民權,2023-11-30,9312
00680L,元大美債20正2,215,0,215,華南永昌-民權,2023-12-01,9312
00679B,元大美債20年,40,1,39,華南永昌-民權,2023-12-01,9312
8927,北基,52,21,31,華南永昌-民權,2023-12-01,9312
3036,文曄,30,0,30,華南永昌-民權,2023-12-01,9312
2382,廣達,38,10,28,華南永昌-民權,2023-12-01,9312
3481,群創,37,10,27,華南永昌-民權,2023-12-01,9312
1605,華新,21,0,21,華南永昌-民權,2023-12-01,9312
2884,玉山金,23,3,20,華南永昌-民權,2023-12-01,9312
2002,中鋼,23,3,20,華南永昌-民權,2023-12-01,9312
2888B,新光金乙特,20,0,20,華南永昌-民權,2023-12-01,9312
2883,凱基金,20,1,19,華南永昌-民權,2023-12-01,9312
00637L,元大滬深300正2,20,1,19,華南永昌-民權,2023-12-01,9312
2313,華通,22,7,15,華南永昌-民權,2023-12-01,9312
8096,擎亞,15,0,15,華南永昌-民權,2023-12-01,9312
3483,力致,16,2,14,華南永昌-民權,2023-12-01,9312
5351,鈺創,34,21,13,華南永昌-民權,2023-12-01,9312
00687B,國泰20年美債,17,5,12,華南永昌-民權,2023-12-01,9312
2317,鴻海,17,5,12,華南永昌-民權,2023-12-01,9312
00929,復華台灣科技優息,22,12,10,華南永昌-民權,2023-12-01,9312
00919,群益台灣精選高息,11,1,10,華南永昌-民權,2023-12-01,9312
1419,新紡,10,0,10,華南永昌-民權,2023-12-01,9312
2543,皇昌,14,4,10,華南永昌-民權,2023-12-01,9312
2867,三商壽,10,0,10,華南永昌-民權,2023-12-01,9312
3491,昇達科,10,0,10,華南永昌-民權,2023-12-01,9312
6187,萬潤,10,0,10,華南永昌-民權,2023-12-01,9312
8021,尖點,10,0,10,華南永昌-民權,2023-12-01,9312
2601,益航,10,1,9,華南永昌-民權,2023-12-01,9312
5328,華容,15,6,9,華南永昌-民權,2023-12-01,9312
5347,世界,15,6,9,華南永昌-民權,2023-12-01,9312
2892,第一金,9,0,9,華南永昌-民權,2023-12-01,9312
2405,輔信,12,5,7,華南永昌-民權,2023-12-01,9312
00715L,期街口布蘭特正2,7,0,7,華南永昌-民權,2023-12-01,9312
3545,敦泰,7,0,7,華南永昌-民權,2023-12-01,9312
00795B,中信美國公債20年,6,0,6,華南永昌-民權,2023-12-01,9312
2363,矽統,12,6,6,華南永昌-民權,2023-12-01,9312
3050,鈺德,7,1,6,華南永昌-民權,2023-12-01,9312
4768,晶呈科技,6,0,6,華南永昌-民權,2023-12-01,9312
8936,國統,6,0,6,華南永昌-民權,2023-12-01,9312
00725B,國泰投資級公司債,5,0,5,華南永昌-民權,2023-12-01,9312
3062,建漢,5,0,5,華南永昌-民權,2023-12-01,9312
3673,TPK-KY,5,0,5,華南永昌-民權,2023-12-01,9312
3707,漢磊,5,0,5,華南永昌-民權,2023-12-01,9312
5340,建榮,5,0,5,華南永昌-民權,2023-12-01,9312
8147,正淩,5,0,5,華南永昌-民權,2023-12-01,9312
8201,無敵,5,0,5,華南永昌-民權,2023-12-01,9312
9950,萬國通,5,0,5,華南永昌-民權,2023-12-01,9312
1101,台泥,5,1,4,華南永昌-民權,2023-12-01,9312
2014,中鴻,4,0,4,華南永昌-民權,2023-12-01,9312
2208,台船,4,0,4,華南永昌-民權,2023-12-01,9312
2352,佳世達,9,5,4,華南永昌-民權,2023-12-01,9312
2637,慧洋-KY,162,38,124,華南永昌-民權,2023-12-04,9312
6187,萬潤,101,0,101,華南永昌-民權,2023-12-04,9312
1514,亞力,133,55,78,華南永昌-民權,2023-12-04,9312
1316,上曜,70,0,70,華南永昌-民權,2023-12-04,9312
2883,凱基金,60,0,60,華南永昌-民權,2023-12-04,9312
2537,聯上發,41,14,27,華南永昌-民權,2023-12-04,9312
2402,毅嘉,24,0,24,華南永昌-民權,2023-12-04,9312
9919,康那香,49,28,21,華南永昌-民權,2023-12-04,9312
2374,佳能,20,0,20,華南永昌-民權,2023-12-04,9312
5703,亞都,20,0,20,華南永昌-民權,2023-12-04,9312
4953,緯軟,20,1,19,華南永昌-民權,2023-12-04,9312
2905,三商,18,0,18,華南永昌-民權,2023-12-04,9312
00715L,期街口布蘭特正2,16,0,16,華南永昌-民權,2023-12-04,9312
2641,正德,25,9,16,華南永昌-民權,2023-12-04,9312
1815,富喬,21,6,15,華南永昌-民權,2023-12-04,9312
2702,華園,15,0,15,華南永昌-民權,2023-12-04,9312
2881,富邦金,15,0,15,華南永昌-民權,2023-12-04,9312
6271,同欣電,15,0,15,華南永昌-民權,2023-12-04,9312
2355,敬鵬,21,7,14,華南永昌-民權,2023-12-04,9312
2417,圓剛,14,0,14,華南永昌-民權,2023-12-04,9312
00632R,元大台灣50反1,13,0,13,華南永昌-民權,2023-12-04,9312
2388,威盛,14,1,13,華南永昌-民權,2023-12-04,9312
3041,揚智,14,2,12,華南永昌-民權,2023-12-04,9312
4909,新復興,16,4,12,華南永昌-民權,2023-12-04,9312
00918,大華優利高填息30,11,0,11,華南永昌-民權,2023-12-04,9312
3652,精聯,21,10,11,華南永昌-民權,2023-12-04,9312
5340,建榮,11,0,11,華南永昌-民權,2023-12-04,9312
6138,茂達,11,0,11,華南永昌-民權,2023-12-04,9312
00773B,中信優先金融債,10,0,10,華南永昌-民權,2023-12-04,9312
00878,國泰永續高股息,11,1,10,華南永昌-民權,2023-12-04,9312
00921,兆豐龍頭等權重,10,0,10,華南永昌-民權,2023-12-04,9312
2867,三商壽,10,0,10,華南永昌-民權,2023-12-04,9312
3276,宇環,10,0,10,華南永昌-民權,2023-12-04,9312
4414,如興,10,0,10,華南永昌-民權,2023-12-04,9312
3231,緯創,12,3,9,華南永昌-民權,2023-12-04,9312
2472,立隆電,10,1,9,華南永昌-民權,2023-12-04,9312
2618,長榮航,14,5,9,華南永昌-民權,2023-12-04,9312
6116,彩晶,10,1,9,華南永昌-民權,2023-12-04,9312
3032,偉訓,21,12,9,華南永昌-民權,2023-12-04,9312
1701,中化,10,2,8,華南永昌-民權,2023-12-04,9312
1809,中釉,15,7,8,華南永昌-民權,2023-12-04,9312
3483,力致,9,1,8,華南永昌-民權,2023-12-04,9312
3545,敦泰,9,1,8,華南永昌-民權,2023-12-04,9312
9945,潤泰新,9,1,8,華南永昌-民權,2023-12-04,9312
5351,鈺創,9,2,7,華南永昌-民權,2023-12-04,9312
1799,易威,7,0,7,華南永昌-民權,2023-12-04,9312
2369,菱生,7,0,7,華南永昌-民權,2023-12-04,9312
3303,岱稜,7,0,7,華南永昌-民權,2023-12-04,9312
3706,神達,7,0,7,華南永昌-民權,2023-12-04,9312
6150,撼訊,9,2,7,華南永昌-民權,2023-12-04,9312
00937B,群益ESG投等債20,253,50,203,華南永昌-民權,2023-12-05,9312
1513,中興電,203,79,124,華南永昌-民權,2023-12-05,9312
00650L,復華香港正2,120,0,120,華南永昌-民權,2023-12-05,9312
3036,文曄,80,0,80,華南永昌-民權,2023-12-05,9312
6187,萬潤,60,0,60,華南永昌-民權,2023-12-05,9312
2337,旺宏,53,0,53,華南永昌-民權,2023-12-05,9312
1503,士電,50,5,45,華南永昌-民權,2023-12-05,9312
2601,益航,70,28,42,華南永昌-民權,2023-12-05,9312
1419,新紡,40,0,40,華南永昌-民權,2023-12-05,9312
4171,瑞基,49,9,40,華南永昌-民權,2023-12-05,9312
00642U,期元大S＆P石油,30,0,30,華南永昌-民權,2023-12-05,9312
2014,中鴻,22,0,22,華南永昌-民權,2023-12-05,9312
3013,晟銘電,24,2,22,華南永昌-民權,2023-12-05,9312
2367,燿華,36,15,21,華南永昌-民權,2023-12-05,9312
2105,正新,20,0,20,華南永昌-民權,2023-12-05,9312
1608,華榮,21,1,20,華南永昌-民權,2023-12-05,9312
00772B,中信高評級公司債,15,0,15,華南永昌-民權,2023-12-05,9312
3231,緯創,19,6,13,華南永昌-民權,2023-12-05,9312
3059,華晶科,18,5,13,華南永昌-民權,2023-12-05,9312
2888B,新光金乙特,13,0,13,華南永昌-民權,2023-12-05,9312
00687B,國泰20年美債,12,0,12,華南永昌-民權,2023-12-05,9312
9955,佳龍,12,0,12,華南永昌-民權,2023-12-05,9312
00918,大華優利高填息30,12,0,12,華南永昌-民權,2023-12-05,9312
2417,圓剛,11,0,11,華南永昌-民權,2023-12-05,9312
00753L,中信中國50正2,10,0,10,華南永昌-民權,2023-12-05,9312
00934,中信成長高股息,10,0,10,華南永昌-民權,2023-12-05,9312
1504,東元,10,0,10,華南永昌-民權,2023-12-05,9312
1612,宏泰,10,0,10,華南永昌-民權,2023-12-05,9312
1616,億泰,12,2,10,華南永昌-民權,2023-12-05,9312
2374,佳能,10,0,10,華南永昌-民權,2023-12-05,9312
2641,正德,30,20,10,華南永昌-民權,2023-12-05,9312
5347,世界,10,0,10,華南永昌-民權,2023-12-05,9312
3481,群創,13,4,9,華南永昌-民權,2023-12-05,9312
6143,振曜,11,2,9,華南永昌-民權,2023-12-05,9312
9103,美德醫療-DR,9,0,9,華南永昌-民權,2023-12-05,9312
00935,野村臺灣新科技50,9,0,9,華南永昌-民權,2023-12-05,9312
1781,合世,12,4,8,華南永昌-民權,2023-12-05,9312
5340,建榮,8,0,8,華南永昌-民權,2023-12-05,9312
8033,雷虎,8,0,8,華南永昌-民權,2023-12-05,9312
2630,亞航,7,0,7,華南永昌-民權,2023-12-05,9312
3265,台星科,9,2,7,華南永昌-民權,2023-12-05,9312
2308,台達電,7,0,7,華南永昌-民權,2023-12-05,9312
2332,友訊,8,2,6,華南永昌-民權,2023-12-05,9312
3035,智原,12,6,6,華南永昌-民權,2023-12-05,9312
2614,東森,6,0,6,華南永昌-民權,2023-12-05,9312
2376,技嘉,6,0,6,華南永昌-民權,2023-12-05,9312
4763,材料-KY,7,1,6,華南永昌-民權,2023-12-05,9312
00882,中信中國高股息,6,0,6,華南永昌-民權,2023-12-05,9312
1471,首利,6,0,6,華南永昌-民權,2023-12-05,9312
1717,長興,6,0,6,華南永昌-民權,2023-12-05,9312
00937B,群益ESG投等債20,133,60,73,華南永昌-民權,2023-12-06,9312
2537,聯上發,41,0,41,華南永昌-民權,2023-12-06,9312
2367,燿華,50,15,35,華南永昌-民權,2023-12-06,9312
2313,華通,37,8,29,華南永昌-民權,2023-12-06,9312
3481,群創,29,0,29,華南永昌-民權,2023-12-06,9312
00687B,國泰20年美債,26,0,26,華南永昌-民權,2023-12-06,9312
2462,良得電,22,0,22,華南永昌-民權,2023-12-06,9312
4171,瑞基,21,0,21,華南永昌-民權,2023-12-06,9312
2888B,新光金乙特,20,0,20,華南永昌-民權,2023-12-06,9312
00680L,元大美債20正2,25,6,19,華南永昌-民權,2023-12-06,9312
2614,東森,15,0,15,華南永昌-民權,2023-12-06,9312
2882,國泰金,15,0,15,華南永昌-民權,2023-12-06,9312
1517,利奇,14,0,14,華南永昌-民權,2023-12-06,9312
2542,興富發,14,0,14,華南永昌-民權,2023-12-06,9312
2887,台新金,14,1,13,華南永昌-民權,2023-12-06,9312
1504,東元,18,6,12,華南永昌-民權,2023-12-06,9312
2417,圓剛,12,0,12,華南永昌-民權,2023-12-06,9312
00642U,期元大S＆P石油,11,0,11,華南永昌-民權,2023-12-06,9312
6417,韋僑,11,0,11,華南永昌-民權,2023-12-06,9312
2208,台船,10,0,10,華南永昌-民權,2023-12-06,9312
00905,FT臺灣Smart,10,0,10,華南永昌-民權,2023-12-06,9312
2605,新興,22,12,10,華南永昌-民權,2023-12-06,9312
2913,農林,10,0,10,華南永昌-民權,2023-12-06,9312
00935,野村臺灣新科技50,9,0,9,華南永昌-民權,2023-12-06,9312
00918,大華優利高填息30,12,3,9,華南永昌-民權,2023-12-06,9312
3264,欣銓,12,3,9,華南永昌-民權,2023-12-06,9312
4113,聯上,9,0,9,華南永昌-民權,2023-12-06,9312
2421,建準,12,3,9,華南永昌-民權,2023-12-06,9312
3706,神達,8,0,8,華南永昌-民權,2023-12-06,9312
2344,華邦電,8,1,7,華南永昌-民權,2023-12-06,9312
4167,松瑞藥,15,8,7,華南永昌-民權,2023-12-06,9312
2355,敬鵬,15,8,7,華南永昌-民權,2023-12-06,9312
2356,英業達,8,2,6,華南永昌-民權,2023-12-06,9312
00927,群益半導體收益,6,0,6,華南永昌-民權,2023-12-06,9312
00921,兆豐龍頭等權重,6,0,6,華南永昌-民權,2023-12-06,9312
00715L,期街口布蘭特正2,6,0,6,華南永昌-民權,2023-12-06,9312
00632R,元大台灣50反1,6,0,6,華南永昌-民權,2023-12-06,9312
2348A,海悅甲特,6,0,6,華南永昌-民權,2023-12-06,9312
2611,志信,16,10,6,華南永昌-民權,2023-12-06,9312
6213,聯茂,6,0,6,華南永昌-民權,2023-12-06,9312
00679B,元大美債20年,6,1,5,華南永昌-民權,2023-12-06,9312
3035,智原,6,1,5,華南永昌-民權,2023-12-06,9312
00933B,國泰10Y+金融債,5,0,5,華南永昌-民權,2023-12-06,9312
00637L,元大滬深300正2,5,0,5,華南永昌-民權,2023-12-06,9312
1319,東陽,11,6,5,華南永昌-民權,2023-12-06,9312
1419,新紡,5,0,5,華南永昌-民權,2023-12-06,9312
1467,南緯,5,0,5,華南永昌-民權,2023-12-06,9312
1522,堤維西,7,2,5,華南永昌-民權,2023-12-06,9312
1616,億泰,5,0,5,華南永昌-民權,2023-12-06,9312
3630,新鉅科,5,0,5,華南永昌-民權,2023-12-06,9312
00679B,元大美債20年,109,5,104,華南永昌-民權,2023-12-07,9312
2376,技嘉,131,27,104,華南永昌-民權,2023-12-07,9312
6139,亞翔,94,4,90,華南永昌-民權,2023-12-07,9312
00937B,群益ESG投等債20,163,101,62,華南永昌-民權,2023-12-07,9312
00650L,復華香港正2,50,0,50,華南永昌-民權,2023-12-07,9312
00936,台新永續高息中小,50,0,50,華南永昌-民權,2023-12-07,9312
4744,皇將,50,0,50,華南永昌-民權,2023-12-07,9312
2382,廣達,55,7,48,華南永昌-民權,2023-12-07,9312
1419,新紡,40,0,40,華南永昌-民權,2023-12-07,9312
00680L,元大美債20正2,43,6,37,華南永昌-民權,2023-12-07,9312
00933B,國泰10Y+金融債,36,0,36,華南永昌-民權,2023-12-07,9312
00919,群益台灣精選高息,32,0,32,華南永昌-民權,2023-12-07,9312
00633L,富邦上証正2,28,5,23,華南永昌-民權,2023-12-07,9312
4533,協易機,29,7,22,華南永昌-民權,2023-12-07,9312
2399,映泰,22,2,20,華南永昌-民權,2023-12-07,9312
00715L,期街口布蘭特正2,19,2,17,華南永昌-民權,2023-12-07,9312
2402,毅嘉,15,0,15,華南永昌-民權,2023-12-07,9312
3059,華晶科,34,19,15,華南永昌-民權,2023-12-07,9312
8033,雷虎,15,0,15,華南永昌-民權,2023-12-07,9312
00918,大華優利高填息30,14,0,14,華南永昌-民權,2023-12-07,9312
1618,合機,14,0,14,華南永昌-民權,2023-12-07,9312
6150,撼訊,15,1,14,華南永昌-民權,2023-12-07,9312
00934,中信成長高股息,13,0,13,華南永昌-民權,2023-12-07,9312
00687B,國泰20年美債,13,0,13,華南永昌-民權,2023-12-07,9312
1504,東元,15,3,12,華南永昌-民權,2023-12-07,9312
00882,中信中國高股息,13,2,11,華南永昌-民權,2023-12-07,9312
2611,志信,11,0,11,華南永昌-民權,2023-12-07,9312
2344,華邦電,11,1,10,華南永昌-民權,2023-12-07,9312
00688L,國泰20年美債正2,20,10,10,華南永昌-民權,2023-12-07,9312
2369,菱生,10,0,10,華南永昌-民權,2023-12-07,9312
2537,聯上發,10,0,10,華南永昌-民權,2023-12-07,9312
3083,網龍,11,1,10,華南永昌-民權,2023-12-07,9312
5515,建國,10,0,10,華南永昌-民權,2023-12-07,9312
6108,競國,10,0,10,華南永昌-民權,2023-12-07,9312
6418,詠昇,10,0,10,華南永昌-民權,2023-12-07,9312
8054,安國,11,1,10,華南永昌-民權,2023-12-07,9312
00712,復華富時不動產,10,1,9,華南永昌-民權,2023-12-07,9312
00665L,富邦�琤肭磪囓�2,9,0,9,華南永昌-民權,2023-12-07,9312
1529,樂事綠能,12,3,9,華南永昌-民權,2023-12-07,9312
3013,晟銘電,12,3,9,華南永昌-民權,2023-12-07,9312
8046,南電,9,0,9,華南永昌-民權,2023-12-07,9312
1608,華榮,10,2,8,華南永昌-民權,2023-12-07,9312
2367,燿華,72,64,8,華南永昌-民權,2023-12-07,9312
1609,大亞,16,8,8,華南永昌-民權,2023-12-07,9312
3374,精材,7,0,7,華南永昌-民權,2023-12-07,9312
00642U,期元大S＆P石油,7,0,7,華南永昌-民權,2023-12-07,9312
3105,穩懋,8,1,7,華南永昌-民權,2023-12-07,9312
3390,旭軟,8,1,7,華南永昌-民權,2023-12-07,9312
3588,通嘉,7,0,7,華南永昌-民權,2023-12-07,9312
6126,信音,8,1,7,華南永昌-民權,2023-12-07,9312
00882,中信中國高股息,207,0,207,華南永昌-民權,2023-12-08,9312
2603,長榮,101,1,100,華南永昌-民權,2023-12-08,9312
3035,智原,145,54,91,華南永昌-民權,2023-12-08,9312
00918,大華優利高填息30,65,0,65,華南永昌-民權,2023-12-08,9312
00937B,群益ESG投等債20,56,0,56,華南永昌-民權,2023-12-08,9312
6005,群益證,48,1,47,華南永昌-民權,2023-12-08,9312
2634,漢翔,41,0,41,華南永昌-民權,2023-12-08,9312
1217,愛之味,40,0,40,華南永昌-民權,2023-12-08,9312
2614,東森,30,0,30,華南永昌-民權,2023-12-08,9312
4543,萬在,27,3,24,華南永昌-民權,2023-12-08,9312
3481,群創,21,0,21,華南永昌-民權,2023-12-08,9312
2367,燿華,19,4,15,華南永昌-民權,2023-12-08,9312
4167,松瑞藥,13,0,13,華南永昌-民權,2023-12-08,9312
00632R,元大台灣50反1,23,12,11,華南永昌-民權,2023-12-08,9312
00642U,期元大S＆P石油,10,0,10,華南永昌-民權,2023-12-08,9312
00688L,國泰20年美債正2,15,5,10,華南永昌-民權,2023-12-08,9312
3652,精聯,10,0,10,華南永昌-民權,2023-12-08,9312
1524,耿鼎,28,18,10,華南永昌-民權,2023-12-08,9312
2605,新興,51,42,9,華南永昌-民權,2023-12-08,9312
2606,裕民,10,1,9,華南永昌-民權,2023-12-08,9312
4939,亞電,9,0,9,華南永昌-民權,2023-12-08,9312
3078,僑威,17,8,9,華南永昌-民權,2023-12-08,9312
2882,國泰金,8,0,8,華南永昌-民權,2023-12-08,9312
00687B,國泰20年美債,13,5,8,華南永昌-民權,2023-12-08,9312
3694,海華,7,0,7,華南永昌-民權,2023-12-08,9312
6834,天二科技,7,0,7,華南永昌-民權,2023-12-08,9312
00919,群益台灣精選高息,6,0,6,華南永昌-民權,2023-12-08,9312
9955,佳龍,10,4,6,華南永昌-民權,2023-12-08,9312
6233,旺玖,6,0,6,華南永昌-民權,2023-12-08,9312
2208,台船,5,0,5,華南永昌-民權,2023-12-08,9312
2607,榮運,5,0,5,華南永昌-民權,2023-12-08,9312
2867,三商壽,5,0,5,華南永昌-民權,2023-12-08,9312
5302,太欣,5,0,5,華南永昌-民權,2023-12-08,9312
8147,正淩,5,0,5,華南永昌-民權,2023-12-08,9312
1301,台塑,4,0,4,華南永昌-民權,2023-12-08,9312
2312,金寶,6,2,4,華南永昌-民權,2023-12-08,9312
2353,宏��,5,1,4,華南永昌-民權,2023-12-08,9312
2641,正德,5,1,4,華南永昌-民權,2023-12-08,9312
2888,新光金,4,0,4,華南永昌-民權,2023-12-08,9312
3390,旭軟,4,0,4,華南永昌-民權,2023-12-08,9312
3532,台勝科,5,1,4,華南永昌-民權,2023-12-08,9312
6167,久正,4,0,4,華南永昌-民權,2023-12-08,9312
6752,叡揚,4,0,4,華南永昌-民權,2023-12-08,9312
8261,富鼎,4,0,4,華南永昌-民權,2023-12-08,9312
2888B,新光金乙特,5,1,4,華南永昌-民權,2023-12-08,9312
9919,康那香,5,2,3,華南永昌-民權,2023-12-08,9312
2887,台新金,3,0,3,華南永昌-民權,2023-12-08,9312
1101,台泥,3,0,3,華南永昌-民權,2023-12-08,9312
00933B,國泰10Y+金融債,4,1,3,華南永昌-民權,2023-12-08,9312
00712,復華富時不動產,3,0,3,華南永昌-民權,2023-12-08,9312
2603,長榮,161,16,145,華南永昌-民權,2023-12-11,9312
6005,群益證,95,0,95,華南永昌-民權,2023-12-11,9312
4123,晟德,50,0,50,華南永昌-民權,2023-12-11,9312
2888B,新光金乙特,45,2,43,華南永昌-民權,2023-12-11,9312
2888,新光金,42,8,34,華南永昌-民權,2023-12-11,9312
00878,國泰永續高股息,27,2,25,華南永昌-民權,2023-12-11,9312
1419,新紡,25,0,25,華南永昌-民權,2023-12-11,9312
00919,群益台灣精選高息,23,2,21,華南永昌-民權,2023-12-11,9312
1471,首利,20,0,20,華南永昌-民權,2023-12-11,9312
2905,三商,20,0,20,華南永昌-民權,2023-12-11,9312
8436,大江,25,5,20,華南永昌-民權,2023-12-11,9312
2376,技嘉,33,14,19,華南永昌-民權,2023-12-11,9312
1524,耿鼎,51,35,16,華南永昌-民權,2023-12-11,9312
00882,中信中國高股息,15,0,15,華南永昌-民權,2023-12-11,9312
00753L,中信中國50正2,15,0,15,華南永昌-民權,2023-12-11,9312
00637L,元大滬深300正2,13,0,13,華南永昌-民權,2023-12-11,9312
00929,復華台灣科技優息,25,13,12,華南永昌-民權,2023-12-11,9312
2301,光寶科,19,7,12,華南永昌-民權,2023-12-11,9312
2388,威盛,22,10,12,華南永昌-民權,2023-12-11,9312
2913,農林,12,0,12,華南永昌-民權,2023-12-11,9312
3443,創意,12,1,11,華南永昌-民權,2023-12-11,9312
00680L,元大美債20正2,16,5,11,華南永昌-民權,2023-12-11,9312
00633L,富邦上証正2,11,0,11,華南永昌-民權,2023-12-11,9312
2614,東森,11,0,11,華南永昌-民權,2023-12-11,9312
2886,兆豐金,11,0,11,華南永昌-民權,2023-12-11,9312
3035,智原,58,47,11,華南永昌-民權,2023-12-11,9312
1218,泰山,10,0,10,華南永昌-民權,2023-12-11,9312
1616,億泰,10,0,10,華南永昌-民權,2023-12-11,9312
1701,中化,10,0,10,華南永昌-民權,2023-12-11,9312
1799,易威,10,0,10,華南永昌-民權,2023-12-11,9312
2208,台船,10,0,10,華南永昌-民權,2023-12-11,9312
5340,建榮,10,0,10,華南永昌-民權,2023-12-11,9312
6684,安格,10,0,10,華南永昌-民權,2023-12-11,9312
1314,中石化,9,0,9,華南永昌-民權,2023-12-11,9312
00934,中信成長高股息,9,0,9,華南永昌-民權,2023-12-11,9312
1608,華榮,11,2,9,華南永昌-民權,2023-12-11,9312
00937B,群益ESG投等債20,32,24,8,華南永昌-民權,2023-12-11,9312
2360,致茂,8,0,8,華南永昌-民權,2023-12-11,9312
2884,玉山金,10,2,8,華南永昌-民權,2023-12-11,9312
2615,萬海,11,3,8,華南永昌-民權,2023-12-11,9312
6125,廣運,7,0,7,華南永昌-民權,2023-12-11,9312
8076,伍豐,7,0,7,華南永昌-民權,2023-12-11,9312
2002,中鋼,27,21,6,華南永昌-民權,2023-12-11,9312
2739,寒舍,6,0,6,華南永昌-民權,2023-12-11,9312
2882,國泰金,6,0,6,華南永昌-民權,2023-12-11,9312
5515,建國,6,0,6,華南永昌-民權,2023-12-11,9312
6443,元晶,6,0,6,華南永昌-民權,2023-12-11,9312
00773B,中信優先金融債,6,0,6,華南永昌-民權,2023-12-11,9312
1104,環泥,5,0,5,華南永昌-民權,2023-12-11,9312
00932,兆豐永續高息等權,5,0,5,華南永昌-民權,2023-12-11,9312
2603,長榮,133,2,131,華南永昌-民權,2023-12-12,9312
5483,中美晶,70,0,70,華南永昌-民權,2023-12-12,9312
2882,國泰金,54,0,54,華南永昌-民權,2023-12-12,9312
3652,精聯,50,0,50,華南永昌-民權,2023-12-12,9312
00919,群益台灣精選高息,57,20,37,華南永昌-民權,2023-12-12,9312
2610,華航,38,2,36,華南永昌-民權,2023-12-12,9312
00937B,群益ESG投等債20,41,6,35,華南永昌-民權,2023-12-12,9312
2888,新光金,36,1,35,華南永昌-民權,2023-12-12,9312
2905,三商,30,0,30,華南永昌-民權,2023-12-12,9312
2506,太設,30,0,30,華南永昌-民權,2023-12-12,9312
2754,亞洲藏壽司,30,0,30,華南永昌-民權,2023-12-12,9312
0056,元大高股息,29,0,29,華南永昌-民權,2023-12-12,9312
00680L,元大美債20正2,23,0,23,華南永昌-民權,2023-12-12,9312
2618,長榮航,30,7,23,華南永昌-民權,2023-12-12,9312
00878,國泰永續高股息,24,3,21,華南永昌-民權,2023-12-12,9312
4171,瑞基,29,12,17,華南永昌-民權,2023-12-12,9312
6127,九豪,17,0,17,華南永昌-民權,2023-12-12,9312
2888B,新光金乙特,16,0,16,華南永昌-民權,2023-12-12,9312
1314,中石化,18,6,12,華南永昌-民權,2023-12-12,9312
2614,東森,12,0,12,華南永昌-民權,2023-12-12,9312
9950,萬國通,12,0,12,華南永昌-民權,2023-12-12,9312
00934,中信成長高股息,11,0,11,華南永昌-民權,2023-12-12,9312
6488,環球晶,20,9,11,華南永昌-民權,2023-12-12,9312
1609,大亞,15,4,11,華南永昌-民權,2023-12-12,9312
4967,十銓,15,5,10,華南永昌-民權,2023-12-12,9312
5381,合正,11,1,10,華南永昌-民權,2023-12-12,9312
6154,順發,10,0,10,華南永昌-民權,2023-12-12,9312
6834,天二科技,10,0,10,華南永昌-民權,2023-12-12,9312
9105,泰金寶-DR,10,0,10,華南永昌-民權,2023-12-12,9312
8011,台通,16,6,10,華南永昌-民權,2023-12-12,9312
2308,台達電,10,1,9,華南永昌-民權,2023-12-12,9312
00720B,元大投資級公司債,9,0,9,華南永昌-民權,2023-12-12,9312
1524,耿鼎,28,19,9,華南永昌-民權,2023-12-12,9312
2392,正崴,12,3,9,華南永昌-民權,2023-12-12,9312
6139,亞翔,14,5,9,華南永昌-民權,2023-12-12,9312
8927,北基,9,0,9,華南永昌-民權,2023-12-12,9312
3005,神基,10,2,8,華南永昌-民權,2023-12-12,9312
4707,磐亞,8,0,8,華南永昌-民權,2023-12-12,9312
00764B,群益25年美債,7,0,7,華南永昌-民權,2023-12-12,9312
1815,富喬,16,9,7,華南永昌-民權,2023-12-12,9312
2367,燿華,34,27,7,華南永昌-民權,2023-12-12,9312
2360,致茂,6,0,6,華南永昌-民權,2023-12-12,9312
2388,威盛,9,3,6,華南永昌-民權,2023-12-12,9312
2498,宏達電,6,0,6,華南永昌-民權,2023-12-12,9312
6173,信昌電,6,0,6,華南永昌-民權,2023-12-12,9312
3481,群創,17,12,5,華南永昌-民權,2023-12-12,9312
1218,泰山,5,0,5,華南永昌-民權,2023-12-12,9312
00932,兆豐永續高息等權,5,0,5,華南永昌-民權,2023-12-12,9312
00688L,國泰20年美債正2,5,0,5,華南永昌-民權,2023-12-12,9312
00795B,中信美國公債20年,5,0,5,華南永昌-民權,2023-12-12,9312
6139,亞翔,122,0,122,華南永昌-民權,2023-12-13,9312
4123,晟德,50,0,50,華南永昌-民權,2023-12-13,9312
3035,智原,49,3,46,華南永昌-民權,2023-12-13,9312
2618,長榮航,43,0,43,華南永昌-民權,2023-12-13,9312
00919,群益台灣精選高息,71,30,41,華南永昌-民權,2023-12-13,9312
5011,久陽,39,0,39,華南永昌-民權,2023-12-13,9312
2888B,新光金乙特,37,0,37,華南永昌-民權,2023-12-13,9312
3265,台星科,32,0,32,華南永昌-民權,2023-12-13,9312
00687B,國泰20年美債,31,0,31,華南永昌-民權,2023-12-13,9312
2610,華航,29,0,29,華南永昌-民權,2023-12-13,9312
00650L,復華香港正2,30,2,28,華南永昌-民權,2023-12-13,9312
5340,建榮,26,0,26,華南永昌-民權,2023-12-13,9312
1504,東元,21,0,21,華南永昌-民權,2023-12-13,9312
2634,漢翔,25,4,21,華南永昌-民權,2023-12-13,9312
00934,中信成長高股息,20,0,20,華南永昌-民權,2023-12-13,9312
1419,新紡,20,0,20,華南永昌-民權,2023-12-13,9312
1608,華榮,20,0,20,華南永昌-民權,2023-12-13,9312
6550,北極星藥業-KY,20,1,19,華南永昌-民權,2023-12-13,9312
2630,亞航,17,1,16,華南永昌-民權,2023-12-13,9312
8927,北基,15,0,15,華南永昌-民權,2023-12-13,9312
2250,IKKA-KY,13,0,13,華南永昌-民權,2023-12-13,9312
2363,矽統,23,10,13,華南永昌-民權,2023-12-13,9312
1584,精剛,25,13,12,華南永昌-民權,2023-12-13,9312
2367,燿華,19,7,12,華南永昌-民權,2023-12-13,9312
2002,中鋼,13,2,11,華南永昌-民權,2023-12-13,9312
1519,華城,12,1,11,華南永昌-民權,2023-12-13,9312
4909,新復興,13,2,11,華南永昌-民權,2023-12-13,9312
6147,頎邦,13,3,10,華南永昌-民權,2023-12-13,9312
00922,國泰台灣領袖50,10,0,10,華南永昌-民權,2023-12-13,9312
00715L,期街口布蘭特正2,10,0,10,華南永昌-民權,2023-12-13,9312
00637L,元大滬深300正2,10,0,10,華南永昌-民權,2023-12-13,9312
1799,易威,10,0,10,華南永昌-民權,2023-12-13,9312
2601,益航,14,4,10,華南永昌-民權,2023-12-13,9312
2614,東森,10,0,10,華南永昌-民權,2023-12-13,9312
3045,台灣大,10,0,10,華南永昌-民權,2023-12-13,9312
6226,光鼎,10,0,10,華南永昌-民權,2023-12-13,9312
9105,泰金寶-DR,10,0,10,華南永昌-民權,2023-12-13,9312
00918,大華優利高填息30,9,0,9,華南永昌-民權,2023-12-13,9312
9919,康那香,25,16,9,華南永昌-民權,2023-12-13,9312
3481,群創,12,4,8,華南永昌-民權,2023-12-13,9312
6173,信昌電,8,0,8,華南永昌-民權,2023-12-13,9312
3694,海華,23,16,7,華南永昌-民權,2023-12-13,9312
1609,大亞,7,0,7,華南永昌-民權,2023-12-13,9312
3527,聚積,7,0,7,華南永昌-民權,2023-12-13,9312
6282,康舒,19,12,7,華南永昌-民權,2023-12-13,9312
2385,群光,6,0,6,華南永昌-民權,2023-12-13,9312
00690,兆豐藍籌30,5,0,5,華南永昌-民權,2023-12-13,9312
00642U,期元大S＆P石油,5,0,5,華南永昌-民權,2023-12-13,9312
1220,台榮,5,0,5,華南永昌-民權,2023-12-13,9312
2887,台新金,5,0,5,華南永昌-民權,2023-12-13,9312
00687B,國泰20年美債,166,0,166,華南永昌-民權,2023-12-14,9312
00933B,國泰10Y+金融債,76,0,76,華南永昌-民權,2023-12-14,9312
2002,中鋼,65,5,60,華南永昌-民權,2023-12-14,9312
2888B,新光金乙特,51,0,51,華南永昌-民權,2023-12-14,9312
4973,廣穎,50,0,50,華南永昌-民權,2023-12-14,9312
2313,華通,84,36,48,華南永昌-民權,2023-12-14,9312
2027,大成鋼,41,0,41,華南永昌-民權,2023-12-14,9312
8112,至上,53,16,37,華南永昌-民權,2023-12-14,9312
3652,精聯,30,0,30,華南永昌-民權,2023-12-14,9312
6488,環球晶,30,0,30,華南永昌-民權,2023-12-14,9312
00936,台新永續高息中小,27,0,27,華南永昌-民權,2023-12-14,9312
2618,長榮航,29,6,23,華南永昌-民權,2023-12-14,9312
2419,仲琦,23,1,22,華南永昌-民權,2023-12-14,9312
3138,耀登,24,2,22,華南永昌-民權,2023-12-14,9312
2387,精元,24,2,22,華南永昌-民權,2023-12-14,9312
1503,士電,65,45,20,華南永昌-民權,2023-12-14,9312
1701,中化,20,0,20,華南永昌-民權,2023-12-14,9312
2867,三商壽,20,0,20,華南永昌-民權,2023-12-14,9312
2606,裕民,18,1,17,華南永昌-民權,2023-12-14,9312
6209,今國光,17,1,16,華南永昌-民權,2023-12-14,9312
00934,中信成長高股息,15,0,15,華南永昌-民權,2023-12-14,9312
2493,揚博,15,0,15,華南永昌-民權,2023-12-14,9312
2498,宏達電,16,2,14,華南永昌-民權,2023-12-14,9312
00937B,群益ESG投等債20,14,2,12,華南永昌-民權,2023-12-14,9312
6265,方土昶,12,0,12,華南永昌-民權,2023-12-14,9312
2329,華泰,18,8,10,華南永昌-民權,2023-12-14,9312
2888,新光金,12,2,10,華南永昌-民權,2023-12-14,9312
00882,中信中國高股息,10,0,10,華南永昌-民權,2023-12-14,9312
1815,富喬,10,0,10,華南永昌-民權,2023-12-14,9312
2801,彰銀,10,0,10,華南永昌-民權,2023-12-14,9312
3593,力銘,10,0,10,華南永昌-民權,2023-12-14,9312
6449,鈺邦,10,0,10,華南永昌-民權,2023-12-14,9312
2834,臺企銀,10,1,9,華南永昌-民權,2023-12-14,9312
00919,群益台灣精選高息,30,21,9,華南永昌-民權,2023-12-14,9312
2365,昆盈,13,4,9,華南永昌-民權,2023-12-14,9312
4931,新盛力,9,0,9,華南永昌-民權,2023-12-14,9312
6770,力積電,12,5,7,華南永昌-民權,2023-12-14,9312
00885,富邦越南,6,0,6,華南永昌-民權,2023-12-14,9312
3213,茂訊,9,3,6,華南永昌-民權,2023-12-14,9312
6290,良維,7,1,6,華南永昌-民權,2023-12-14,9312
8201,無敵,6,0,6,華南永昌-民權,2023-12-14,9312
00679B,元大美債20年,7,2,5,華南永昌-民權,2023-12-14,9312
2615,萬海,5,0,5,華南永昌-民權,2023-12-14,9312
00915,凱基優選高股息30,5,0,5,華南永昌-民權,2023-12-14,9312
00633L,富邦上証正2,5,0,5,華南永昌-民權,2023-12-14,9312
1312,國喬,5,0,5,華南永昌-民權,2023-12-14,9312
2537,聯上發,5,0,5,華南永昌-民權,2023-12-14,9312
2617,台航,5,0,5,華南永昌-民權,2023-12-14,9312
2633,台灣高鐵,5,0,5,華南永昌-民權,2023-12-14,9312
2641,正德,5,0,5,華南永昌-民權,2023-12-14,9312
6187,萬潤,105,0,105,華南永昌-民權,2023-12-15,9312
00680L,元大美債20正2,116,18,98,華南永昌-民權,2023-12-15,9312
5483,中美晶,100,10,90,華南永昌-民權,2023-12-15,9312
00687B,國泰20年美債,117,30,87,華南永昌-民權,2023-12-15,9312
00933B,國泰10Y+金融債,70,10,60,華南永昌-民權,2023-12-15,9312
2888B,新光金乙特,50,0,50,華南永昌-民權,2023-12-15,9312
6139,亞翔,50,2,48,華南永昌-民權,2023-12-15,9312
00679B,元大美債20年,58,13,45,華南永昌-民權,2023-12-15,9312
2356,英業達,73,32,41,華南永昌-民權,2023-12-15,9312
6127,九豪,38,0,38,華南永昌-民權,2023-12-15,9312
2363,矽統,45,10,35,華南永昌-民權,2023-12-15,9312
00720B,元大投資級公司債,43,8,35,華南永昌-民權,2023-12-15,9312
00929,復華台灣科技優息,45,12,33,華南永昌-民權,2023-12-15,9312
00918,大華優利高填息30,33,1,32,華南永昌-民權,2023-12-15,9312
5512,力麒,30,1,29,華南永昌-民權,2023-12-15,9312
2030,彰源,24,2,22,華南永昌-民權,2023-12-15,9312
00919,群益台灣精選高息,94,73,21,華南永昌-民權,2023-12-15,9312
2367,燿華,33,14,19,華南永昌-民權,2023-12-15,9312
4939,亞電,17,1,16,華南永昌-民權,2023-12-15,9312
4533,協易機,15,0,15,華南永昌-民權,2023-12-15,9312
00934,中信成長高股息,24,10,14,華南永昌-民權,2023-12-15,9312
8112,至上,14,0,14,華南永昌-民權,2023-12-15,9312
00722B,群益投資級電信債,13,0,13,華南永昌-民權,2023-12-15,9312
1799,易威,13,0,13,華南永昌-民權,2023-12-15,9312
2388,威盛,16,4,12,華南永昌-民權,2023-12-15,9312
5426,振發,12,0,12,華南永昌-民權,2023-12-15,9312
2383,台光電,12,1,11,華南永昌-民權,2023-12-15,9312
8054,安國,13,2,11,華南永昌-民權,2023-12-15,9312
2481,強茂,17,7,10,華南永昌-民權,2023-12-15,9312
3372,典範,13,3,10,華南永昌-民權,2023-12-15,9312
00633L,富邦上証正2,10,0,10,華南永昌-民權,2023-12-15,9312
1419,新紡,10,0,10,華南永昌-民權,2023-12-15,9312
1711,永光,10,0,10,華南永昌-民權,2023-12-15,9312
2010,春源,10,0,10,華南永昌-民權,2023-12-15,9312
2025,千興,10,0,10,華南永昌-民權,2023-12-15,9312
2412,中華電,10,0,10,華南永昌-民權,2023-12-15,9312
00936,台新永續高息中小,12,3,9,華南永昌-民權,2023-12-15,9312
1101,台泥,13,5,8,華南永昌-民權,2023-12-15,9312
00878,國泰永續高股息,71,63,8,華南永昌-民權,2023-12-15,9312
00676R,富邦臺灣加權反1,8,0,8,華南永昌-民權,2023-12-15,9312
2404,漢唐,8,0,8,華南永昌-民權,2023-12-15,9312
3035,智原,7,0,7,華南永昌-民權,2023-12-15,9312
2382,廣達,8,1,7,華南永昌-民權,2023-12-15,9312
2949,欣新網,6,0,6,華南永昌-民權,2023-12-15,9312
8249,菱光,6,0,6,華南永昌-民權,2023-12-15,9312
00632R,元大台灣50反1,5,0,5,華南永昌-民權,2023-12-15,9312
00688L,國泰20年美債正2,5,0,5,華南永昌-民權,2023-12-15,9312
1432,大魯閣,5,0,5,華南永昌-民權,2023-12-15,9312
1604,聲寶,5,0,5,華南永昌-民權,2023-12-15,9312
1609,大亞,6,1,5,華南永昌-民權,2023-12-15,9312
2609,陽明,226,24,202,華南永昌-民權,2023-12-18,9312
2023,燁輝,137,3,134,華南永昌-民權,2023-12-18,9312
00919,群益台灣精選高息,146,32,114,華南永昌-民權,2023-12-18,9312
00937B,群益ESG投等債20,146,46,100,華南永昌-民權,2023-12-18,9312
3437,榮創,65,0,65,華南永昌-民權,2023-12-18,9312
3055,蔚華科,50,0,50,華南永昌-民權,2023-12-18,9312
2382,廣達,50,2,48,華南永昌-民權,2023-12-18,9312
3231,緯創,52,7,45,華南永昌-民權,2023-12-18,9312
2618,長榮航,46,4,42,華南永昌-民權,2023-12-18,9312
00929,復華台灣科技優息,47,6,41,華南永昌-民權,2023-12-18,9312
2867,三商壽,40,0,40,華南永昌-民權,2023-12-18,9312
2615,萬海,98,66,32,華南永昌-民權,2023-12-18,9312
8112,至上,31,0,31,華南永昌-民權,2023-12-18,9312
2612,中航,34,4,30,華南永昌-民權,2023-12-18,9312
2610,華航,29,0,29,華南永昌-民權,2023-12-18,9312
00687B,國泰20年美債,31,4,27,華南永昌-民權,2023-12-18,9312
2515,中工,23,0,23,華南永昌-民權,2023-12-18,9312
6187,萬潤,21,0,21,華南永昌-民權,2023-12-18,9312
2356,英業達,32,12,20,華南永昌-民權,2023-12-18,9312
1608,華榮,20,0,20,華南永昌-民權,2023-12-18,9312
6265,方土昶,20,0,20,華南永昌-民權,2023-12-18,9312
2605,新興,19,2,17,華南永昌-民權,2023-12-18,9312
00882,中信中國高股息,20,4,16,華南永昌-民權,2023-12-18,9312
5425,台半,25,9,16,華南永昌-民權,2023-12-18,9312
00712,復華富時不動產,16,0,16,華南永昌-民權,2023-12-18,9312
8240,華宏,15,0,15,華南永昌-民權,2023-12-18,9312
6770,力積電,13,0,13,華南永昌-民權,2023-12-18,9312
00679B,元大美債20年,13,2,11,華南永昌-民權,2023-12-18,9312
00933B,國泰10Y+金融債,11,0,11,華南永昌-民權,2023-12-18,9312
2637,慧洋-KY,11,0,11,華南永昌-民權,2023-12-18,9312
8046,南電,12,1,11,華南永昌-民權,2023-12-18,9312
4109,加捷生醫,10,0,10,華南永昌-民權,2023-12-18,9312
5340,建榮,10,0,10,華南永昌-民權,2023-12-18,9312
6127,九豪,10,0,10,華南永昌-民權,2023-12-18,9312
2387,精元,10,1,9,華南永昌-民權,2023-12-18,9312
8467,波力-KY,10,1,9,華南永昌-民權,2023-12-18,9312
1314,中石化,8,0,8,華南永昌-民權,2023-12-18,9312
2888,新光金,8,0,8,華南永昌-民權,2023-12-18,9312
3454,晶睿,8,0,8,華南永昌-民權,2023-12-18,9312
6449,鈺邦,8,0,8,華南永昌-民權,2023-12-18,9312
00934,中信成長高股息,7,0,7,華南永昌-民權,2023-12-18,9312
00633L,富邦上証正2,7,0,7,華南永昌-民權,2023-12-18,9312
2204,中華,7,0,7,華南永昌-民權,2023-12-18,9312
2030,彰源,6,0,6,華南永昌-民權,2023-12-18,9312
00915,凱基優選高股息30,10,4,6,華南永昌-民權,2023-12-18,9312
00885,富邦越南,6,0,6,華南永昌-民權,2023-12-18,9312
2514,龍邦,6,0,6,華南永昌-民權,2023-12-18,9312
4909,新復興,7,1,6,華南永昌-民權,2023-12-18,9312
00891,中信關鍵半導體,5,0,5,華南永昌-民權,2023-12-18,9312
1503,士電,5,0,5,華南永昌-民權,2023-12-18,9312
2834,臺企銀,1000,0,1000,華南永昌-民權,2023-12-19,9312
4123,晟德,111,0,111,華南永昌-民權,2023-12-19,9312
6005,群益證,59,0,59,華南永昌-民權,2023-12-19,9312
00633L,富邦上証正2,55,0,55,華南永昌-民權,2023-12-19,9312
1616,億泰,50,0,50,華南永昌-民權,2023-12-19,9312
6187,萬潤,50,0,50,華南永昌-民權,2023-12-19,9312
6016,康和證,40,0,40,華南永昌-民權,2023-12-19,9312
6901,鑽石投資,40,0,40,華南永昌-民權,2023-12-19,9312
8436,大江,35,0,35,華南永昌-民權,2023-12-19,9312
2313,華通,33,3,30,華南永昌-民權,2023-12-19,9312
5864,致和證,30,0,30,華南永昌-民權,2023-12-19,9312
6026,福邦證,30,0,30,華南永昌-民權,2023-12-19,9312
00937B,群益ESG投等債20,24,2,22,華南永昌-民權,2023-12-19,9312
2634,漢翔,22,0,22,華南永昌-民權,2023-12-19,9312
2618,長榮航,58,38,20,華南永昌-民權,2023-12-19,9312
2888B,新光金乙特,20,0,20,華南永昌-民權,2023-12-19,9312
3715,定穎投控,41,21,20,華南永昌-民權,2023-12-19,9312
6290,良維,20,0,20,華南永昌-民權,2023-12-19,9312
8432,東生華,20,0,20,華南永昌-民權,2023-12-19,9312
5876,上海商銀,35,17,18,華南永昌-民權,2023-12-19,9312
5340,建榮,16,0,16,華南永昌-民權,2023-12-19,9312
8046,南電,15,0,15,華南永昌-民權,2023-12-19,9312
4939,亞電,14,0,14,華南永昌-民權,2023-12-19,9312
00878,國泰永續高股息,39,25,14,華南永昌-民權,2023-12-19,9312
2204,中華,13,0,13,華南永昌-民權,2023-12-19,9312
1471,首利,12,0,12,華南永昌-民權,2023-12-19,9312
1815,富喬,43,31,12,華南永昌-民權,2023-12-19,9312
2038,海光,13,1,12,華南永昌-民權,2023-12-19,9312
00688L,國泰20年美債正2,11,0,11,華南永昌-民權,2023-12-19,9312
2308,台達電,11,0,11,華南永昌-民權,2023-12-19,9312
3706,神達,12,1,11,華南永昌-民權,2023-12-19,9312
2344,華邦電,23,12,11,華南永昌-民權,2023-12-19,9312
020040,元大上櫃ESG龍頭N,10,0,10,華南永昌-民權,2023-12-19,9312
00751B,元大AAA至A公司債,10,0,10,華南永昌-民權,2023-12-19,9312
00882,中信中國高股息,10,0,10,華南永昌-民權,2023-12-19,9312
1301,台塑,10,0,10,華南永昌-民權,2023-12-19,9312
1453,大將,10,0,10,華南永昌-民權,2023-12-19,9312
1799,易威,10,0,10,華南永昌-民權,2023-12-19,9312
2324,仁寶,10,0,10,華南永昌-民權,2023-12-19,9312
2374,佳能,10,0,10,華南永昌-民權,2023-12-19,9312
2478,大毅,10,0,10,華南永昌-民權,2023-12-19,9312
3532,台勝科,11,1,10,華南永昌-民權,2023-12-19,9312
5347,世界,10,0,10,華南永昌-民權,2023-12-19,9312
6129,普誠,10,0,10,華南永昌-民權,2023-12-19,9312
2888,新光金,9,0,9,華南永昌-民權,2023-12-19,9312
2610,華航,8,0,8,華南永昌-民權,2023-12-19,9312
6449,鈺邦,8,0,8,華南永昌-民權,2023-12-19,9312
2356,英業達,26,19,7,華南永昌-民權,2023-12-19,9312
6147,頎邦,10,3,7,華南永昌-民權,2023-12-19,9312
2409,友達,6,0,6,華南永昌-民權,2023-12-19,9312
2603,長榮,111,13,98,華南永昌-民權,2023-12-20,9312
00936,台新永續高息中小,60,0,60,華南永昌-民權,2023-12-20,9312
00929,復華台灣科技優息,49,1,48,華南永昌-民權,2023-12-20,9312
00919,群益台灣精選高息,35,0,35,華南永昌-民權,2023-12-20,9312
2887,台新金,31,5,26,華南永昌-民權,2023-12-20,9312
2515,中工,63,39,24,華南永昌-民權,2023-12-20,9312
2888B,新光金乙特,24,0,24,華南永昌-民權,2023-12-20,9312
3706,神達,34,13,21,華南永昌-民權,2023-12-20,9312
00680L,元大美債20正2,20,0,20,華南永昌-民權,2023-12-20,9312
00934,中信成長高股息,14,0,14,華南永昌-民權,2023-12-20,9312
2387,精元,15,3,12,華南永昌-民權,2023-12-20,9312
3062,建漢,11,0,11,華南永昌-民權,2023-12-20,9312
00679B,元大美債20年,10,0,10,華南永昌-民權,2023-12-20,9312
2313,華通,12,3,9,華南永昌-民權,2023-12-20,9312
2834,臺企銀,8,0,8,華南永昌-民權,2023-12-20,9312
5876,上海商銀,10,2,8,華南永昌-民權,2023-12-20,9312
6684,安格,8,0,8,華南永昌-民權,2023-12-20,9312
3576,聯合再生,7,0,7,華南永昌-民權,2023-12-20,9312
1519,華城,21,14,7,華南永昌-民權,2023-12-20,9312
6140,訊達,7,1,6,華南永昌-民權,2023-12-20,9312
1799,易威,6,0,6,華南永昌-民權,2023-12-20,9312
2913,農林,6,0,6,華南永昌-民權,2023-12-20,9312
1612,宏泰,5,0,5,華南永昌-民權,2023-12-20,9312
2312,金寶,31,26,5,華南永昌-民權,2023-12-20,9312
2884,玉山金,5,0,5,華南永昌-民權,2023-12-20,9312
5328,華容,5,0,5,華南永昌-民權,2023-12-20,9312
5515,建國,6,1,5,華南永昌-民權,2023-12-20,9312
5608,四維航,5,0,5,華南永昌-民權,2023-12-20,9312
6147,頎邦,5,0,5,華南永昌-民權,2023-12-20,9312
6239,力成,5,0,5,華南永昌-民權,2023-12-20,9312
6874,倍力,5,0,5,華南永昌-民權,2023-12-20,9312
6901,鑽石投資,5,0,5,華南永昌-民權,2023-12-20,9312
3030,德律,5,0,5,華南永昌-民權,2023-12-20,9312
1905,華紙,11,7,4,華南永昌-民權,2023-12-20,9312
2344,華邦電,5,1,4,華南永昌-民權,2023-12-20,9312
5469,瀚宇博,4,0,4,華南永昌-民權,2023-12-20,9312
9105,泰金寶-DR,30,26,4,華南永昌-民權,2023-12-20,9312
1217,愛之味,3,0,3,華南永昌-民權,2023-12-20,9312
00887,永豐中國科技50大,3,0,3,華南永昌-民權,2023-12-20,9312
00681R,元大美債20反1,3,0,3,華南永昌-民權,2023-12-20,9312
1582,信錦,3,0,3,華南永昌-民權,2023-12-20,9312
2301,光寶科,3,0,3,華南永昌-民權,2023-12-20,9312
2303,聯電,4,1,3,華南永昌-民權,2023-12-20,9312
2442,新美齊,3,0,3,華南永昌-民權,2023-12-20,9312
2816,旺旺保,3,0,3,華南永昌-民權,2023-12-20,9312
2886,兆豐金,4,1,3,華南永昌-民權,2023-12-20,9312
3035,智原,16,13,3,華南永昌-民權,2023-12-20,9312
3260,威剛,3,0,3,華南永昌-民權,2023-12-20,9312
5521,工信,5,2,3,華南永昌-民權,2023-12-20,9312
6142,友勁,3,0,3,華南永昌-民權,2023-12-20,9312
00632R,元大台灣50反1,400,15,385,華南永昌-民權,2023-12-21,9312
2615,萬海,334,181,153,華南永昌-民權,2023-12-21,9312
9105,泰金寶-DR,216,98,118,華南永昌-民權,2023-12-21,9312
2515,中工,107,24,83,華南永昌-民權,2023-12-21,9312
00679B,元大美債20年,53,0,53,華南永昌-民權,2023-12-21,9312
3652,精聯,50,0,50,華南永昌-民權,2023-12-21,9312
2324,仁寶,85,37,48,華南永昌-民權,2023-12-21,9312
00680L,元大美債20正2,44,0,44,華南永昌-民權,2023-12-21,9312
2412,中華電,40,0,40,華南永昌-民權,2023-12-21,9312
00919,群益台灣精選高息,37,0,37,華南永昌-民權,2023-12-21,9312
2337,旺宏,34,1,33,華南永昌-民權,2023-12-21,9312
1101,台泥,23,0,23,華南永昌-民權,2023-12-21,9312
2303,聯電,25,4,21,華南永昌-民權,2023-12-21,9312
2105,正新,21,0,21,華南永昌-民權,2023-12-21,9312
1410,南染,20,0,20,華南永昌-民權,2023-12-21,9312
1616,億泰,20,0,20,華南永昌-民權,2023-12-21,9312
2887,台新金,22,3,19,華南永昌-民權,2023-12-21,9312
2506,太設,15,0,15,華南永昌-民權,2023-12-21,9312
3706,神達,19,4,15,華南永昌-民權,2023-12-21,9312
3552,同致,14,0,14,華南永昌-民權,2023-12-21,9312
2331,精英,15,2,13,華南永昌-民權,2023-12-21,9312
3035,智原,18,7,11,華南永昌-民權,2023-12-21,9312
2365,昆盈,13,2,11,華南永昌-民權,2023-12-21,9312
00720B,元大投資級公司債,10,0,10,華南永昌-民權,2023-12-21,9312
00891,中信關鍵半導體,15,5,10,華南永昌-民權,2023-12-21,9312
00773B,中信優先金融債,10,0,10,華南永昌-民權,2023-12-21,9312
00857B,永豐20年美公債,10,0,10,華南永昌-民權,2023-12-21,9312
00932,兆豐永續高息等權,10,0,10,華南永昌-民權,2023-12-21,9312
2605,新興,11,1,10,華南永昌-民權,2023-12-21,9312
2312,金寶,14,5,9,華南永昌-民權,2023-12-21,9312
2542,興富發,9,0,9,華南永昌-民權,2023-12-21,9312
8927,北基,19,10,9,華南永昌-民權,2023-12-21,9312
3047,訊舟,8,0,8,華南永昌-民權,2023-12-21,9312
3038,全台,8,0,8,華南永昌-民權,2023-12-21,9312
00929,復華台灣科技優息,28,20,8,華南永昌-民權,2023-12-21,9312
00878,國泰永續高股息,7,0,7,華南永昌-民權,2023-12-21,9312
2641,正德,95,88,7,華南永昌-民權,2023-12-21,9312
3287,廣寰科,7,0,7,華南永昌-民權,2023-12-21,9312
2613,中櫃,6,0,6,華南永昌-民權,2023-12-21,9312
00753L,中信中國50正2,5,0,5,華南永昌-民權,2023-12-21,9312
00633L,富邦上証正2,5,0,5,華南永昌-民權,2023-12-21,9312
00915,凱基優選高股息30,5,0,5,華南永昌-民權,2023-12-21,9312
1504,東元,7,2,5,華南永昌-民權,2023-12-21,9312
2371,大同,5,0,5,華南永昌-民權,2023-12-21,9312
2388,威盛,10,5,5,華南永昌-民權,2023-12-21,9312
2495,普安,5,0,5,華南永昌-民權,2023-12-21,9312
2612,中航,6,1,5,華南永昌-民權,2023-12-21,9312
2816,旺旺保,5,0,5,華南永昌-民權,2023-12-21,9312
4174,浩鼎,16,11,5,華南永昌-民權,2023-12-21,9312
4561,健椿,5,0,5,華南永昌-民權,2023-12-21,9312
00919,群益台灣精選高息,119,2,117,華南永昌-民權,2023-12-22,9312
2603,長榮,112,6,106,華南永昌-民權,2023-12-22,9312
2618,長榮航,116,47,69,華南永昌-民權,2023-12-22,9312
00878,國泰永續高股息,79,11,68,華南永昌-民權,2023-12-22,9312
2882,國泰金,51,2,49,華南永昌-民權,2023-12-22,9312
3622,洋華,45,0,45,華南永昌-民權,2023-12-22,9312
2356,英業達,58,16,42,華南永昌-民權,2023-12-22,9312
1799,易威,37,0,37,華南永昌-民權,2023-12-22,9312
00933B,國泰10Y+金融債,32,4,28,華南永昌-民權,2023-12-22,9312
00688L,國泰20年美債正2,26,0,26,華南永昌-民權,2023-12-22,9312
00931B,統一美債20年,25,0,25,華南永昌-民權,2023-12-22,9312
3652,精聯,35,10,25,華南永昌-民權,2023-12-22,9312
00857B,永豐20年美公債,20,0,20,華南永昌-民權,2023-12-22,9312
2461,光群雷,20,0,20,華南永昌-民權,2023-12-22,9312
2641,正德,20,0,20,華南永昌-民權,2023-12-22,9312
4939,亞電,22,3,19,華南永昌-民權,2023-12-22,9312
2014,中鴻,16,0,16,華南永昌-民權,2023-12-22,9312
1722,台肥,15,0,15,華南永昌-民權,2023-12-22,9312
8354,冠好,15,0,15,華南永昌-民權,2023-12-22,9312
5009,榮剛,48,35,13,華南永昌-民權,2023-12-22,9312
2027,大成鋼,13,0,13,華南永昌-民權,2023-12-22,9312
2324,仁寶,17,5,12,華南永昌-民權,2023-12-22,9312
2367,燿華,11,0,11,華南永昌-民權,2023-12-22,9312
00937B,群益ESG投等債20,12,2,10,華南永昌-民權,2023-12-22,9312
00753L,中信中國50正2,10,0,10,華南永昌-民權,2023-12-22,9312
00637L,元大滬深300正2,10,0,10,華南永昌-民權,2023-12-22,9312
4116,明基醫,10,0,10,華南永昌-民權,2023-12-22,9312
5608,四維航,10,0,10,華南永昌-民權,2023-12-22,9312
00680L,元大美債20正2,167,160,7,華南永昌-民權,2023-12-22,9312
00687B,國泰20年美債,7,0,7,華南永昌-民權,2023-12-22,9312
00929,復華台灣科技優息,20,13,7,華南永昌-民權,2023-12-22,9312
1326,台化,8,1,7,華南永昌-民權,2023-12-22,9312
2105,正新,22,15,7,華南永昌-民權,2023-12-22,9312
2353,宏��,49,42,7,華南永昌-民權,2023-12-22,9312
2460,建通,9,2,7,華南永昌-民權,2023-12-22,9312
2516,新建,8,1,7,華南永昌-民權,2023-12-22,9312
5426,振發,7,0,7,華南永昌-民權,2023-12-22,9312
6142,友勁,7,0,7,華南永昌-民權,2023-12-22,9312
6257,矽格,7,0,7,華南永昌-民權,2023-12-22,9312
00795B,中信美國公債20年,6,0,6,華南永昌-民權,2023-12-22,9312
2344,華邦電,46,40,6,華南永昌-民權,2023-12-22,9312
2355,敬鵬,7,1,6,華南永昌-民權,2023-12-22,9312
3059,華晶科,6,0,6,華南永昌-民權,2023-12-22,9312
6282,康舒,7,1,6,華南永昌-民權,2023-12-22,9312
00773B,中信優先金融債,5,0,5,華南永昌-民權,2023-12-22,9312
00772B,中信高評級公司債,18,13,5,華南永昌-民權,2023-12-22,9312
1504,東元,5,0,5,華南永昌-民權,2023-12-22,9312
1714,和桐,5,0,5,華南永昌-民權,2023-12-22,9312
2537,聯上發,5,0,5,華南永昌-民權,2023-12-22,9312
2886,兆豐金,5,0,5,華南永昌-民權,2023-12-22,9312
00919,群益台灣精選高息,528,61,467,華南永昌-民權,2023-12-25,9312
6187,萬潤,170,2,168,華南永昌-民權,2023-12-25,9312
2412,中華電,110,0,110,華南永昌-民權,2023-12-25,9312
00878,國泰永續高股息,84,6,78,華南永昌-民權,2023-12-25,9312
00680L,元大美債20正2,61,8,53,華南永昌-民權,2023-12-25,9312
2374,佳能,40,0,40,華南永昌-民權,2023-12-25,9312
1799,易威,30,1,29,華南永昌-民權,2023-12-25,9312
2382,廣達,28,0,28,華南永昌-民權,2023-12-25,9312
3083,網龍,32,7,25,華南永昌-民權,2023-12-25,9312
2324,仁寶,36,15,21,華南永昌-民權,2023-12-25,9312
2006,東和鋼鐵,21,0,21,華南永昌-民權,2023-12-25,9312
2609,陽明,62,42,20,華南永昌-民權,2023-12-25,9312
2614,東森,20,0,20,華南永昌-民權,2023-12-25,9312
8112,至上,45,25,20,華南永昌-民權,2023-12-25,9312
00857B,永豐20年美公債,20,0,20,華南永昌-民權,2023-12-25,9312
00687B,國泰20年美債,20,0,20,華南永昌-民權,2023-12-25,9312
8432,東生華,15,0,15,華南永昌-民權,2023-12-25,9312
1605,華新,14,0,14,華南永昌-民權,2023-12-25,9312
6117,迎廣,15,2,13,華南永昌-民權,2023-12-25,9312
2601,益航,20,8,12,華南永昌-民權,2023-12-25,9312
2606,裕民,11,0,11,華南永昌-民權,2023-12-25,9312
3622,洋華,11,0,11,華南永昌-民權,2023-12-25,9312
3706,神達,11,0,11,華南永昌-民權,2023-12-25,9312
2610,華航,12,1,11,華南永昌-民權,2023-12-25,9312
00632R,元大台灣50反1,10,0,10,華南永昌-民權,2023-12-25,9312
1305,華夏,10,0,10,華南永昌-民權,2023-12-25,9312
1304,台聚,10,0,10,華南永昌-民權,2023-12-25,9312
2022,聚亨,11,1,10,華南永昌-民權,2023-12-25,9312
5512,力麒,10,0,10,華南永昌-民權,2023-12-25,9312
6290,良維,10,0,10,華南永昌-民權,2023-12-25,9312
00937B,群益ESG投等債20,9,0,9,華南永昌-民權,2023-12-25,9312
2007,燁興,11,2,9,華南永昌-民權,2023-12-25,9312
2329,華泰,11,2,9,華南永昌-民權,2023-12-25,9312
3276,宇環,10,1,9,華南永昌-民權,2023-12-25,9312
5398,慕康生醫,9,0,9,華南永昌-民權,2023-12-25,9312
2377,微星,8,0,8,華南永昌-民權,2023-12-25,9312
1308,亞聚,7,0,7,華南永昌-民權,2023-12-25,9312
2337,旺宏,7,0,7,華南永昌-民權,2023-12-25,9312
2393,億光,7,0,7,華南永昌-民權,2023-12-25,9312
00934,中信成長高股息,6,0,6,華南永昌-民權,2023-12-25,9312
00772B,中信高評級公司債,6,0,6,華南永昌-民權,2023-12-25,9312
2464,盟立,6,0,6,華南永昌-民權,2023-12-25,9312
00770,國泰北美科技,6,0,6,華南永昌-民權,2023-12-25,9312
00900,富邦特選高股息30,10,5,5,華南永昌-民權,2023-12-25,9312
2615,萬海,23,18,5,華南永昌-民權,2023-12-25,9312
00933B,國泰10Y+金融債,5,0,5,華南永昌-民權,2023-12-25,9312
1314,中石化,5,0,5,華南永昌-民權,2023-12-25,9312
1582,信錦,5,0,5,華南永昌-民權,2023-12-25,9312
2023,燁輝,6,1,5,華南永昌-民權,2023-12-25,9312
2369,菱生,6,1,5,華南永昌-民權,2023-12-25,9312
2603,長榮,455,3,452,華南永昌-民權,2023-12-26,9312
2618,長榮航,213,4,209,華南永昌-民權,2023-12-26,9312
6187,萬潤,201,3,198,華南永昌-民權,2023-12-26,9312
00929,復華台灣科技優息,218,25,193,華南永昌-民權,2023-12-26,9312
2609,陽明,217,29,188,華南永昌-民權,2023-12-26,9312
9105,泰金寶-DR,85,0,85,華南永昌-民權,2023-12-26,9312
00900,富邦特選高股息30,100,16,84,華南永昌-民權,2023-12-26,9312
3402,漢科,46,1,45,華南永昌-民權,2023-12-26,9312
2615,萬海,53,13,40,華南永昌-民權,2023-12-26,9312
4123,晟德,40,0,40,華南永昌-民權,2023-12-26,9312
1799,易威,35,0,35,華南永昌-民權,2023-12-26,9312
2468,華經,30,0,30,華南永昌-民權,2023-12-26,9312
2645,長榮航太,30,0,30,華南永昌-民權,2023-12-26,9312
0056,元大高股息,33,7,26,華南永昌-民權,2023-12-26,9312
00919,群益台灣精選高息,22,0,22,華南永昌-民權,2023-12-26,9312
2610,華航,23,1,22,華南永昌-民權,2023-12-26,9312
2472,立隆電,19,0,19,華南永昌-民權,2023-12-26,9312
2331,精英,21,5,16,華南永昌-民權,2023-12-26,9312
00937B,群益ESG投等債20,13,0,13,華南永昌-民權,2023-12-26,9312
00687B,國泰20年美債,13,0,13,華南永昌-民權,2023-12-26,9312
2498,宏達電,12,0,12,華南永昌-民權,2023-12-26,9312
2382,廣達,20,9,11,華南永昌-民權,2023-12-26,9312
1312,國喬,10,0,10,華南永昌-民權,2023-12-26,9312
00751B,元大AAA至A公司債,10,0,10,華南永昌-民權,2023-12-26,9312
0050,元大台灣50,10,0,10,華南永昌-民權,2023-12-26,9312
2402,毅嘉,10,0,10,華南永昌-民權,2023-12-26,9312
2405,輔信,62,52,10,華南永昌-民權,2023-12-26,9312
2732,六角,10,0,10,華南永昌-民權,2023-12-26,9312
2887,台新金,10,0,10,華南永昌-民權,2023-12-26,9312
2891,中信金,10,0,10,華南永昌-民權,2023-12-26,9312
2903,遠百,10,0,10,華南永昌-民權,2023-12-26,9312
3706,神達,10,0,10,華南永昌-民權,2023-12-26,9312
6290,良維,10,0,10,華南永昌-民權,2023-12-26,9312
8046,南電,10,1,9,華南永昌-民權,2023-12-26,9312
3231,緯創,10,2,8,華南永昌-民權,2023-12-26,9312
1519,華城,21,14,7,華南永昌-民權,2023-12-26,9312
2014,中鴻,7,0,7,華南永昌-民權,2023-12-26,9312
6533,晶心科,9,2,7,華南永昌-民權,2023-12-26,9312
2367,燿華,6,0,6,華南永昌-民權,2023-12-26,9312
2457,飛宏,6,0,6,華南永昌-民權,2023-12-26,9312
2421,建準,7,1,6,華南永昌-民權,2023-12-26,9312
1471,首利,5,0,5,華南永昌-民權,2023-12-26,9312
2515,中工,4,0,4,華南永昌-民權,2023-12-26,9312
00882,中信中國高股息,4,0,4,華南永昌-民權,2023-12-26,9312
00679B,元大美債20年,4,0,4,華南永昌-民權,2023-12-26,9312
2363,矽統,4,0,4,華南永昌-民權,2023-12-26,9312
3264,欣銓,4,0,4,華南永昌-民權,2023-12-26,9312
6237,驊訊,4,0,4,華南永昌-民權,2023-12-26,9312
2330,台積電,10,6,4,華南永昌-民權,2023-12-26,9312
2369,菱生,43,40,3,華南永昌-民權,2023-12-26,9312
00937B,群益ESG投等債20,164,32,132,華南永昌-民權,2023-12-27,9312
00934,中信成長高股息,112,0,112,華南永昌-民權,2023-12-27,9312
00680L,元大美債20正2,100,0,100,華南永昌-民權,2023-12-27,9312
2369,菱生,69,4,65,華南永昌-民權,2023-12-27,9312
3402,漢科,40,0,40,華南永昌-民權,2023-12-27,9312
3338,泰碩,70,40,30,華南永昌-民權,2023-12-27,9312
00929,復華台灣科技優息,25,1,24,華南永昌-民權,2023-12-27,9312
1316,上曜,38,18,20,華南永昌-民權,2023-12-27,9312
1582,信錦,41,21,20,華南永昌-民權,2023-12-27,9312
2903,遠百,20,0,20,華南永昌-民權,2023-12-27,9312
2618,長榮航,21,1,20,華南永昌-民權,2023-12-27,9312
2356,英業達,21,4,17,華南永昌-民權,2023-12-27,9312
00632R,元大台灣50反1,15,0,15,華南永昌-民權,2023-12-27,9312
2888B,新光金乙特,15,0,15,華南永昌-民權,2023-12-27,9312
00687B,國泰20年美債,14,0,14,華南永昌-民權,2023-12-27,9312
8112,至上,15,2,13,華南永昌-民權,2023-12-27,9312
00679B,元大美債20年,11,0,11,華南永昌-民權,2023-12-27,9312
2014,中鴻,11,0,11,華南永昌-民權,2023-12-27,9312
3380,明泰,11,0,11,華南永昌-民權,2023-12-27,9312
1732,毛寶,10,0,10,華南永昌-民權,2023-12-27,9312
2007,燁興,10,0,10,華南永昌-民權,2023-12-27,9312
2359,所羅門,10,0,10,華南永昌-民權,2023-12-27,9312
3152,璟德,10,0,10,華南永昌-民權,2023-12-27,9312
2722,夏都,9,0,9,華南永昌-民權,2023-12-27,9312
2006,東和鋼鐵,8,0,8,華南永昌-民權,2023-12-27,9312
5521,工信,28,20,8,華南永昌-民權,2023-12-27,9312
2376,技嘉,7,0,7,華南永昌-民權,2023-12-27,9312
8105,凌巨,7,0,7,華南永昌-民權,2023-12-27,9312
8147,正淩,7,0,7,華南永昌-民權,2023-12-27,9312
00919,群益台灣精選高息,6,0,6,華南永昌-民權,2023-12-27,9312
1815,富喬,9,3,6,華南永昌-民權,2023-12-27,9312
2323,中環,6,0,6,華南永昌-民權,2023-12-27,9312
00936,台新永續高息中小,5,0,5,華南永昌-民權,2023-12-27,9312
1419,新紡,5,0,5,華南永昌-民權,2023-12-27,9312
2312,金寶,13,8,5,華南永昌-民權,2023-12-27,9312
2460,建通,5,0,5,華南永昌-民權,2023-12-27,9312
2915,潤泰全,5,0,5,華南永昌-民權,2023-12-27,9312
4945,陞達科技,5,0,5,華南永昌-民權,2023-12-27,9312
5340,建榮,5,0,5,華南永昌-民權,2023-12-27,9312
6127,九豪,5,0,5,華南永昌-民權,2023-12-27,9312
8034,榮群,7,2,5,華南永昌-民權,2023-12-27,9312
8110,華東,5,0,5,華南永昌-民權,2023-12-27,9312
2363,矽統,9,4,5,華南永昌-民權,2023-12-27,9312
1504,東元,4,0,4,華南永昌-民權,2023-12-27,9312
00673R,期元大S＆P原油反1,4,0,4,華南永昌-民權,2023-12-27,9312
1612,宏泰,4,0,4,華南永昌-民權,2023-12-27,9312
1733,五鼎,7,3,4,華南永昌-民權,2023-12-27,9312
2382,廣達,5,1,4,華南永昌-民權,2023-12-27,9312
2605,新興,4,0,4,華南永昌-民權,2023-12-27,9312
2634,漢翔,20,16,4,華南永昌-民權,2023-12-27,9312
00919,群益台灣精選高息,140,0,140,華南永昌-民權,2023-12-28,9312
00937B,群益ESG投等債20,99,20,79,華南永昌-民權,2023-12-28,9312
2356,英業達,70,15,55,華南永昌-民權,2023-12-28,9312
3402,漢科,50,0,50,華南永昌-民權,2023-12-28,9312
6120,達運,50,0,50,華南永昌-民權,2023-12-28,9312
6290,良維,50,1,49,華南永昌-民權,2023-12-28,9312
2317,鴻海,55,16,39,華南永昌-民權,2023-12-28,9312
00915,凱基優選高股息30,35,0,35,華南永昌-民權,2023-12-28,9312
3338,泰碩,50,23,27,華南永昌-民權,2023-12-28,9312
8436,大江,26,0,26,華南永昌-民權,2023-12-28,9312
8112,至上,22,1,21,華南永昌-民權,2023-12-28,9312
8039,台虹,41,22,19,華南永昌-民權,2023-12-28,9312
00692,富邦公司治理,18,0,18,華南永昌-民權,2023-12-28,9312
00933B,國泰10Y+金融債,17,0,17,華南永昌-民權,2023-12-28,9312
2303,聯電,22,5,17,華南永昌-民權,2023-12-28,9312
3652,精聯,16,0,16,華南永昌-民權,2023-12-28,9312
00929,復華台灣科技優息,15,0,15,華南永昌-民權,2023-12-28,9312
2903,遠百,15,0,15,華南永昌-民權,2023-12-28,9312
3006,晶豪科,15,0,15,華南永昌-民權,2023-12-28,9312
1513,中興電,17,3,14,華南永昌-民權,2023-12-28,9312
9105,泰金寶-DR,12,0,12,華南永昌-民權,2023-12-28,9312
00891,中信關鍵半導體,11,0,11,華南永昌-民權,2023-12-28,9312
1514,亞力,13,3,10,華南永昌-民權,2023-12-28,9312
1809,中釉,10,0,10,華南永昌-民權,2023-12-28,9312
2421,建準,12,2,10,華南永昌-民權,2023-12-28,9312
2498,宏達電,10,0,10,華南永昌-民權,2023-12-28,9312
3694,海華,14,4,10,華南永昌-民權,2023-12-28,9312
6257,矽格,10,0,10,華南永昌-民權,2023-12-28,9312
8927,北基,10,0,10,華南永昌-民權,2023-12-28,9312
4174,浩鼎,9,0,9,華南永昌-民權,2023-12-28,9312
6799,來頡,9,0,9,華南永昌-民權,2023-12-28,9312
4979,華星光,30,21,9,華南永昌-民權,2023-12-28,9312
00679B,元大美債20年,8,0,8,華南永昌-民權,2023-12-28,9312
2308,台達電,9,1,8,華南永昌-民權,2023-12-28,9312
8096,擎亞,16,8,8,華南永昌-民權,2023-12-28,9312
5351,鈺創,35,27,8,華南永昌-民權,2023-12-28,9312
1325,恆大,6,0,6,華南永昌-民權,2023-12-28,9312
1584,精剛,9,3,6,華南永昌-民權,2023-12-28,9312
1701,中化,6,0,6,華南永昌-民權,2023-12-28,9312
2204,中華,6,0,6,華南永昌-民權,2023-12-28,9312
2436,偉詮電,6,0,6,華南永昌-民權,2023-12-28,9312
2618,長榮航,7,1,6,華南永昌-民權,2023-12-28,9312
3041,揚智,11,5,6,華南永昌-民權,2023-12-28,9312
6715,嘉基,6,0,6,華南永昌-民權,2023-12-28,9312
2353,宏��,64,59,5,華南永昌-民權,2023-12-28,9312
00724B,群益投資級金融債,5,0,5,華南永昌-民權,2023-12-28,9312
00773B,中信優先金融債,5,0,5,華南永昌-民權,2023-12-28,9312
2405,輔信,5,0,5,華南永昌-民權,2023-12-28,9312
2612,中航,5,0,5,華南永昌-民權,2023-12-28,9312
5340,建榮,5,0,5,華南永昌-民權,2023-12-28,9312
00915,凱基優選高股息30,151,10,141,華南永昌-民權,2023-12-29,9312
8916,光隆,117,0,117,華南永昌-民權,2023-12-29,9312
2382,廣達,152,55,97,華南永昌-民權,2023-12-29,9312
2615,萬海,56,0,56,華南永昌-民權,2023-12-29,9312
4123,晟德,50,0,50,華南永昌-民權,2023-12-29,9312
00937B,群益ESG投等債20,63,18,45,華南永昌-民權,2023-12-29,9312
1437,勤益控,30,0,30,華南永昌-民權,2023-12-29,9312
1101,台泥,24,0,24,華南永昌-民權,2023-12-29,9312
3622,洋華,25,1,24,華南永昌-民權,2023-12-29,9312
2903,遠百,21,0,21,華南永昌-民權,2023-12-29,9312
3652,精聯,20,0,20,華南永昌-民權,2023-12-29,9312
2353,宏��,40,24,16,華南永昌-民權,2023-12-29,9312
00933B,國泰10Y+金融債,16,0,16,華南永昌-民權,2023-12-29,9312
00919,群益台灣精選高息,17,1,16,華南永昌-民權,2023-12-29,9312
2888B,新光金乙特,16,0,16,華南永昌-民權,2023-12-29,9312
1503,士電,19,4,15,華南永昌-民權,2023-12-29,9312
2472,立隆電,15,0,15,華南永昌-民權,2023-12-29,9312
3402,漢科,15,0,15,華南永昌-民權,2023-12-29,9312
1701,中化,14,0,14,華南永昌-民權,2023-12-29,9312
8147,正淩,11,0,11,華南永昌-民權,2023-12-29,9312
00688L,國泰20年美債正2,10,0,10,華南永昌-民權,2023-12-29,9312
1616,億泰,10,0,10,華南永昌-民權,2023-12-29,9312
2498,宏達電,10,0,10,華南永昌-民權,2023-12-29,9312
2537,聯上發,10,0,10,華南永昌-民權,2023-12-29,9312
5512,力麒,10,0,10,華南永昌-民權,2023-12-29,9312
8432,東生華,10,0,10,華南永昌-民權,2023-12-29,9312
9924,福興,10,0,10,華南永昌-民權,2023-12-29,9312
1519,華城,11,2,9,華南永昌-民權,2023-12-29,9312
3006,晶豪科,20,11,9,華南永昌-民權,2023-12-29,9312
00885,富邦越南,7,0,7,華南永昌-民權,2023-12-29,9312
2303,聯電,17,10,7,華南永昌-民權,2023-12-29,9312
5340,建榮,7,0,7,華南永昌-民權,2023-12-29,9312
6187,萬潤,13,7,6,華南永昌-民權,2023-12-29,9312
00772B,中信高評級公司債,6,0,6,華南永昌-民權,2023-12-29,9312
2355,敬鵬,6,0,6,華南永昌-民權,2023-12-29,9312
2605,新興,6,0,6,華南永昌-民權,2023-12-29,9312
2618,長榮航,6,0,6,華南永昌-民權,2023-12-29,9312
4908,前鼎,10,4,6,華南永昌-民權,2023-12-29,9312
00637L,元大滬深300正2,10,5,5,華南永昌-民權,2023-12-29,9312
2461,光群雷,5,0,5,華南永昌-民權,2023-12-29,9312
2478,大毅,5,0,5,華南永昌-民權,2023-12-29,9312
2637,慧洋-KY,5,0,5,華南永昌-民權,2023-12-29,9312
2641,正德,6,1,5,華南永昌-民權,2023-12-29,9312
2888,新光金,5,0,5,華南永昌-民權,2023-12-29,9312
5014,建錩,5,0,5,華南永昌-民權,2023-12-29,9312
8436,大江,5,0,5,華南永昌-民權,2023-12-29,9312
8927,北基,9,4,5,華南永昌-民權,2023-12-29,9312
00679B,元大美債20年,4,0,4,華南永昌-民權,2023-12-29,9312
2393,億光,4,0,4,華南永昌-民權,2023-12-29,9312
2506,太設,4,0,4,華南永昌-民權,2023-12-29,9312
00937B,群益ESG投等債20,201,0,201,華南永昌-民權,2024-01-02,9312
8916,光隆,200,0,200,華南永昌-民權,2024-01-02,9312
2603,長榮,156,11,145,華南永昌-民權,2024-01-02,9312
00915,凱基優選高股息30,135,1,134,華南永昌-民權,2024-01-02,9312
00680L,元大美債20正2,106,0,106,華南永昌-民權,2024-01-02,9312
3706,神達,50,4,46,華南永昌-民權,2024-01-02,9312
00882,中信中國高股息,37,0,37,華南永昌-民權,2024-01-02,9312
2303,聯電,38,3,35,華南永昌-民權,2024-01-02,9312
0056,元大高股息,34,3,31,華南永昌-民權,2024-01-02,9312
5469,瀚宇博,30,0,30,華南永昌-民權,2024-01-02,9312
3481,群創,31,4,27,華南永昌-民權,2024-01-02,9312
2313,華通,24,0,24,華南永昌-民權,2024-01-02,9312
00930,永豐ESG低碳高息,20,0,20,華南永昌-民權,2024-01-02,9312
5009,榮剛,21,1,20,華南永昌-民權,2024-01-02,9312
9924,福興,20,0,20,華南永昌-民權,2024-01-02,9312
3264,欣銓,19,0,19,華南永昌-民權,2024-01-02,9312
2356,英業達,22,5,17,華南永昌-民權,2024-01-02,9312
00687B,國泰20年美債,22,6,16,華南永昌-民權,2024-01-02,9312
00751B,元大AAA至A公司債,15,0,15,華南永昌-民權,2024-01-02,9312
00712,復華富時不動產,17,2,15,華南永昌-民權,2024-01-02,9312
1785,光洋科,15,0,15,華南永昌-民權,2024-01-02,9312
00934,中信成長高股息,13,0,13,華南永昌-民權,2024-01-02,9312
00679B,元大美債20年,14,1,13,華南永昌-民權,2024-01-02,9312
2607,榮運,12,0,12,華南永昌-民權,2024-01-02,9312
2498,宏達電,12,0,12,華南永昌-民權,2024-01-02,9312
2352,佳世達,13,2,11,華南永昌-民權,2024-01-02,9312
6233,旺玖,11,0,11,華南永昌-民權,2024-01-02,9312
00919,群益台灣精選高息,21,11,10,華南永昌-民權,2024-01-02,9312
00907,永豐優息存股,10,0,10,華南永昌-民權,2024-01-02,9312
1712,興農,10,0,10,華南永昌-民權,2024-01-02,9312
2417,圓剛,10,0,10,華南永昌-民權,2024-01-02,9312
2882,國泰金,10,0,10,華南永昌-民權,2024-01-02,9312
2888,新光金,10,0,10,華南永昌-民權,2024-01-02,9312
2903,遠百,10,0,10,華南永昌-民權,2024-01-02,9312
4549,桓達,10,0,10,華南永昌-民權,2024-01-02,9312
00688L,國泰20年美債正2,8,0,8,華南永昌-民權,2024-01-02,9312
2462,良得電,8,0,8,華南永昌-民權,2024-01-02,9312
3044,健鼎,8,0,8,華南永昌-民權,2024-01-02,9312
1312,國喬,10,3,7,華南永昌-民權,2024-01-02,9312
1217,愛之味,8,2,6,華南永昌-民權,2024-01-02,9312
00921,兆豐龍頭等權重,6,0,6,華南永昌-民權,2024-01-02,9312
00891,中信關鍵半導體,6,0,6,華南永昌-民權,2024-01-02,9312
2615,萬海,15,9,6,華南永昌-民權,2024-01-02,9312
5425,台半,7,1,6,華南永昌-民權,2024-01-02,9312
6715,嘉基,6,0,6,華南永昌-民權,2024-01-02,9312
6901,鑽石投資,7,1,6,華南永昌-民權,2024-01-02,9312
00642U,期元大S＆P石油,5,0,5,華南永昌-民權,2024-01-02,9312
2455,全新,5,0,5,華南永昌-民權,2024-01-02,9312
2605,新興,14,9,5,華南永昌-民權,2024-01-02,9312
2636,台驊控股,5,0,5,華南永昌-民權,2024-01-02,9312
8916,光隆,494,0,494,華南永昌-民權,2024-01-03,9312
00929,復華台灣科技優息,295,10,285,華南永昌-民權,2024-01-03,9312
00881,國泰台灣5G+,123,0,123,華南永昌-民權,2024-01-03,9312
00919,群益台灣精選高息,96,0,96,華南永昌-民權,2024-01-03,9312
2618,長榮航,101,17,84,華南永昌-民權,2024-01-03,9312
5483,中美晶,62,0,62,華南永昌-民權,2024-01-03,9312
3652,精聯,50,0,50,華南永昌-民權,2024-01-03,9312
00934,中信成長高股息,47,6,41,華南永昌-民權,2024-01-03,9312
6187,萬潤,41,0,41,華南永昌-民權,2024-01-03,9312
1605,華新,39,0,39,華南永昌-民權,2024-01-03,9312
00937B,群益ESG投等債20,33,0,33,華南永昌-民權,2024-01-03,9312
9924,福興,30,0,30,華南永昌-民權,2024-01-03,9312
1301,台塑,25,0,25,華南永昌-民權,2024-01-03,9312
2610,華航,25,4,21,華南永昌-民權,2024-01-03,9312
1773,勝一,20,0,20,華南永昌-民權,2024-01-03,9312
2331,精英,30,10,20,華南永昌-民權,2024-01-03,9312
2905,三商,20,0,20,華南永昌-民權,2024-01-03,9312
2324,仁寶,18,1,17,華南永昌-民權,2024-01-03,9312
2882,國泰金,17,0,17,華南永昌-民權,2024-01-03,9312
2641,正德,28,12,16,華南永昌-民權,2024-01-03,9312
3231,緯創,17,2,15,華南永昌-民權,2024-01-03,9312
5426,振發,25,10,15,華南永昌-民權,2024-01-03,9312
2723,美食-KY,14,0,14,華南永昌-民權,2024-01-03,9312
00715L,期街口布蘭特正2,13,0,13,華南永昌-民權,2024-01-03,9312
8059,凱碩,13,0,13,華南永昌-民權,2024-01-03,9312
00905,FT臺灣Smart,12,0,12,華南永昌-民權,2024-01-03,9312
1785,光洋科,12,0,12,華南永昌-民權,2024-01-03,9312
2421,建準,11,0,11,華南永昌-民權,2024-01-03,9312
00892,富邦台灣半導體,10,0,10,華南永昌-民權,2024-01-03,9312
1616,億泰,10,0,10,華南永昌-民權,2024-01-03,9312
2637,慧洋-KY,10,0,10,華南永昌-民權,2024-01-03,9312
3706,神達,18,8,10,華南永昌-民權,2024-01-03,9312
2313,華通,11,2,9,華南永昌-民權,2024-01-03,9312
2344,華邦電,10,1,9,華南永昌-民權,2024-01-03,9312
3390,旭軟,37,28,9,華南永昌-民權,2024-01-03,9312
2356,英業達,13,5,8,華南永昌-民權,2024-01-03,9312
00688L,國泰20年美債正2,8,0,8,華南永昌-民權,2024-01-03,9312
6417,韋僑,10,2,8,華南永昌-民權,2024-01-03,9312
8039,台虹,8,0,8,華南永昌-民權,2024-01-03,9312
00679B,元大美債20年,8,0,8,華南永昌-民權,2024-01-03,9312
3276,宇環,7,0,7,華南永昌-民權,2024-01-03,9312
2884,玉山金,6,0,6,華南永昌-民權,2024-01-03,9312
3522,御嵿,6,0,6,華南永昌-民權,2024-01-03,9312
4174,浩鼎,6,0,6,華南永昌-民權,2024-01-03,9312
4714,永捷,6,0,6,華南永昌-民權,2024-01-03,9312
6116,彩晶,7,1,6,華南永昌-民權,2024-01-03,9312
3481,群創,7,2,5,華南永昌-民權,2024-01-03,9312
00891,中信關鍵半導體,5,0,5,華南永昌-民權,2024-01-03,9312
00770,國泰北美科技,5,0,5,華南永昌-民權,2024-01-03,9312
1712,興農,5,0,5,華南永昌-民權,2024-01-03,9312
2609,陽明,535,363,172,華南永昌-民權,2024-01-04,9312
9924,福興,125,0,125,華南永昌-民權,2024-01-04,9312
2905,三商,60,0,60,華南永昌-民權,2024-01-04,9312
00637L,元大滬深300正2,60,10,50,華南永昌-民權,2024-01-04,9312
00929,復華台灣科技優息,51,1,50,華南永昌-民權,2024-01-04,9312
1217,愛之味,50,2,48,華南永昌-民權,2024-01-04,9312
00937B,群益ESG投等債20,44,0,44,華南永昌-民權,2024-01-04,9312
1313,聯成,40,0,40,華南永昌-民權,2024-01-04,9312
3706,神達,39,1,38,華南永昌-民權,2024-01-04,9312
2618,長榮航,44,11,33,華南永昌-民權,2024-01-04,9312
3652,精聯,32,0,32,華南永昌-民權,2024-01-04,9312
00934,中信成長高股息,21,0,21,華南永昌-民權,2024-01-04,9312
0056,元大高股息,20,1,19,華南永昌-民權,2024-01-04,9312
2324,仁寶,23,4,19,華南永昌-民權,2024-01-04,9312
00919,群益台灣精選高息,18,0,18,華南永昌-民權,2024-01-04,9312
00712,復華富時不動產,17,0,17,華南永昌-民權,2024-01-04,9312
5521,工信,38,22,16,華南永昌-民權,2024-01-04,9312
00725B,國泰投資級公司債,15,0,15,華南永昌-民權,2024-01-04,9312
2353,宏��,34,19,15,華南永昌-民權,2024-01-04,9312
3402,漢科,30,15,15,華南永昌-民權,2024-01-04,9312
3607,谷崧,15,0,15,華南永昌-民權,2024-01-04,9312
2363,矽統,15,1,14,華南永昌-民權,2024-01-04,9312
9919,康那香,28,14,14,華南永昌-民權,2024-01-04,9312
2617,台航,16,3,13,華南永昌-民權,2024-01-04,9312
00927,群益半導體收益,13,0,13,華南永昌-民權,2024-01-04,9312
2498,宏達電,13,0,13,華南永昌-民權,2024-01-04,9312
1101,台泥,13,2,11,華南永昌-民權,2024-01-04,9312
2883,凱基金,11,0,11,華南永昌-民權,2024-01-04,9312
6140,訊達,14,4,10,華南永昌-民權,2024-01-04,9312
2614,東森,10,0,10,華南永昌-民權,2024-01-04,9312
3231,緯創,12,3,9,華南永昌-民權,2024-01-04,9312
6269,台郡,8,0,8,華南永昌-民權,2024-01-04,9312
1514,亞力,59,51,8,華南永昌-民權,2024-01-04,9312
00882,中信中國高股息,7,0,7,華南永昌-民權,2024-01-04,9312
2331,精英,12,5,7,華南永昌-民權,2024-01-04,9312
00932,兆豐永續高息等權,6,0,6,華南永昌-民權,2024-01-04,9312
1519,華城,16,10,6,華南永昌-民權,2024-01-04,9312
2038,海光,6,0,6,華南永昌-民權,2024-01-04,9312
2312,金寶,9,3,6,華南永昌-民權,2024-01-04,9312
2888,新光金,6,0,6,華南永昌-民權,2024-01-04,9312
6113,亞矽,25,19,6,華南永昌-民權,2024-01-04,9312
8046,南電,12,6,6,華南永昌-民權,2024-01-04,9312
2611,志信,8,2,6,華南永昌-民權,2024-01-04,9312
2344,華邦電,6,1,5,華南永昌-民權,2024-01-04,9312
1419,新紡,5,0,5,華南永昌-民權,2024-01-04,9312
2478,大毅,5,0,5,華南永昌-民權,2024-01-04,9312
3013,晟銘電,6,1,5,華南永昌-民權,2024-01-04,9312
3033,威健,6,1,5,華南永昌-民權,2024-01-04,9312
3047,訊舟,5,0,5,華南永昌-民權,2024-01-04,9312
3217,優群,5,0,5,華南永昌-民權,2024-01-04,9312
00643,群益深証中小,220,0,220,華南永昌-民權,2024-01-05,9312
00680L,元大美債20正2,251,60,191,華南永昌-民權,2024-01-05,9312
2609,陽明,374,184,190,華南永昌-民權,2024-01-05,9312
3402,漢科,107,0,107,華南永昌-民權,2024-01-05,9312
00929,復華台灣科技優息,85,0,85,華南永昌-民權,2024-01-05,9312
1217,愛之味,70,0,70,華南永昌-民權,2024-01-05,9312
2603,長榮,54,4,50,華南永昌-民權,2024-01-05,9312
8916,光隆,45,0,45,華南永昌-民權,2024-01-05,9312
2303,聯電,39,3,36,華南永昌-民權,2024-01-05,9312
9924,福興,26,0,26,華南永昌-民權,2024-01-05,9312
00878,國泰永續高股息,31,8,23,華南永昌-民權,2024-01-05,9312
3652,精聯,23,0,23,華南永昌-民權,2024-01-05,9312
2344,華邦電,23,3,20,華南永昌-民權,2024-01-05,9312
1451,年興,20,0,20,華南永昌-民權,2024-01-05,9312
2031,新光鋼,20,0,20,華南永昌-民權,2024-01-05,9312
6120,達運,16,1,15,華南永昌-民權,2024-01-05,9312
00919,群益台灣精選高息,14,0,14,華南永昌-民權,2024-01-05,9312
2356,英業達,21,8,13,華南永昌-民權,2024-01-05,9312
3232,昱捷,13,0,13,華南永昌-民權,2024-01-05,9312
1514,亞力,12,0,12,華南永昌-民權,2024-01-05,9312
2409,友達,24,13,11,華南永昌-民權,2024-01-05,9312
0056,元大高股息,21,11,10,華南永昌-民權,2024-01-05,9312
00892,富邦台灣半導體,10,0,10,華南永昌-民權,2024-01-05,9312
2329,華泰,14,4,10,華南永昌-民權,2024-01-05,9312
2885,元大金,8,0,8,華南永昌-民權,2024-01-05,9312
2601,益航,18,10,8,華南永昌-民權,2024-01-05,9312
2610,華航,10,3,7,華南永昌-民權,2024-01-05,9312
00927,群益半導體收益,7,0,7,華南永昌-民權,2024-01-05,9312
00687B,國泰20年美債,6,0,6,華南永昌-民權,2024-01-05,9312
2313,華通,6,0,6,華南永昌-民權,2024-01-05,9312
2317,鴻海,56,50,6,華南永昌-民權,2024-01-05,9312
2362,藍天,21,15,6,華南永昌-民權,2024-01-05,9312
4584,君帆,6,0,6,華南永昌-民權,2024-01-05,9312
2421,建準,5,0,5,華南永昌-民權,2024-01-05,9312
6276,安鈦克,6,1,5,華南永昌-民權,2024-01-05,9312
00888,永豐台灣ESG,5,0,5,華南永昌-民權,2024-01-05,9312
00795B,中信美國公債20年,5,0,5,華南永昌-民權,2024-01-05,9312
00706L,期元大S＆P日圓正2,5,0,5,華南永昌-民權,2024-01-05,9312
1605,華新,5,0,5,華南永昌-民權,2024-01-05,9312
2369,菱生,5,0,5,華南永昌-民權,2024-01-05,9312
2888,新光金,105,100,5,華南永昌-民權,2024-01-05,9312
6233,旺玖,5,0,5,華南永昌-民權,2024-01-05,9312
8210,勤誠,16,11,5,華南永昌-民權,2024-01-05,9312
00751B,元大AAA至A公司債,5,1,4,華南永昌-民權,2024-01-05,9312
2505,國揚,4,0,4,華南永昌-民權,2024-01-05,9312
2543,皇昌,4,0,4,華南永昌-民權,2024-01-05,9312
8163,達方,4,0,4,華南永昌-民權,2024-01-05,9312
00772B,中信高評級公司債,3,0,3,華南永昌-民權,2024-01-05,9312
00900,富邦特選高股息30,3,0,3,華南永昌-民權,2024-01-05,9312
1325,恆大,3,0,3,華南永昌-民權,2024-01-05,9312
00680L,元大美債20正2,251,0,251,華南永昌-民權,2024-01-08,9312
00637L,元大滬深300正2,200,50,150,華南永昌-民權,2024-01-08,9312
8916,光隆,145,0,145,華南永昌-民權,2024-01-08,9312
00632R,元大台灣50反1,110,0,110,華南永昌-民權,2024-01-08,9312
00753L,中信中國50正2,100,0,100,華南永昌-民權,2024-01-08,9312
3402,漢科,88,0,88,華南永昌-民權,2024-01-08,9312
00929,復華台灣科技優息,61,1,60,華南永昌-民權,2024-01-08,9312
2353,宏��,64,11,53,華南永昌-民權,2024-01-08,9312
00882,中信中國高股息,52,0,52,華南永昌-民權,2024-01-08,9312
2603,長榮,73,22,51,華南永昌-民權,2024-01-08,9312
2884,玉山金,50,5,45,華南永昌-民權,2024-01-08,9312
9924,福興,39,0,39,華南永昌-民權,2024-01-08,9312
6120,達運,35,0,35,華南永昌-民權,2024-01-08,9312
1217,愛之味,30,0,30,華南永昌-民權,2024-01-08,9312
2812,台中銀,30,0,30,華南永昌-民權,2024-01-08,9312
00919,群益台灣精選高息,30,6,24,華南永昌-民權,2024-01-08,9312
1519,華城,33,9,24,華南永昌-民權,2024-01-08,9312
1410,南染,20,0,20,華南永昌-民權,2024-01-08,9312
2486,一詮,20,2,18,華南永昌-民權,2024-01-08,9312
00679B,元大美債20年,21,4,17,華南永昌-民權,2024-01-08,9312
00725B,國泰投資級公司債,15,0,15,華南永昌-民權,2024-01-08,9312
6113,亞矽,15,1,14,華南永昌-民權,2024-01-08,9312
00933B,國泰10Y+金融債,13,0,13,華南永昌-民權,2024-01-08,9312
00915,凱基優選高股息30,13,1,12,華南永昌-民權,2024-01-08,9312
2352,佳世達,11,0,11,華南永昌-民權,2024-01-08,9312
6239,力成,11,0,11,華南永昌-民權,2024-01-08,9312
0056,元大高股息,10,0,10,華南永昌-民權,2024-01-08,9312
2108,南帝,10,0,10,華南永昌-民權,2024-01-08,9312
2530,華建,10,0,10,華南永昌-民權,2024-01-08,9312
2630,亞航,11,1,10,華南永昌-民權,2024-01-08,9312
2903,遠百,10,0,10,華南永昌-民權,2024-01-08,9312
3706,神達,11,1,10,華南永昌-民權,2024-01-08,9312
5340,建榮,10,0,10,華南永昌-民權,2024-01-08,9312
6168,宏齊,10,0,10,華南永昌-民權,2024-01-08,9312
8054,安國,10,0,10,華南永昌-民權,2024-01-08,9312
00795B,中信美國公債20年,9,0,9,華南永昌-民權,2024-01-08,9312
1721,三晃,10,1,9,華南永昌-民權,2024-01-08,9312
3515,華擎,10,1,9,華南永昌-民權,2024-01-08,9312
6269,台郡,11,2,9,華南永昌-民權,2024-01-08,9312
3231,緯創,18,10,8,華南永昌-民權,2024-01-08,9312
00687B,國泰20年美債,10,2,8,華南永昌-民權,2024-01-08,9312
1815,富喬,34,26,8,華南永昌-民權,2024-01-08,9312
2388,威盛,13,5,8,華南永昌-民權,2024-01-08,9312
00713,元大台灣高息低波,7,0,7,華南永昌-民權,2024-01-08,9312
2618,長榮航,9,2,7,華南永昌-民權,2024-01-08,9312
6770,力積電,10,3,7,華南永昌-民權,2024-01-08,9312
2421,建準,7,1,6,華南永昌-民權,2024-01-08,9312
5498,凱崴,6,0,6,華南永昌-民權,2024-01-08,9312
6274,台燿,6,0,6,華南永昌-民權,2024-01-08,9312
6719,力智,6,0,6,華南永昌-民權,2024-01-08,9312
00919,群益台灣精選高息,127,0,127,華南永昌-民權,2024-01-09,9312
1605,華新,79,0,79,華南永昌-民權,2024-01-09,9312
3652,精聯,60,0,60,華南永昌-民權,2024-01-09,9312
2603,長榮,66,7,59,華南永昌-民權,2024-01-09,9312
2610,華航,55,0,55,華南永昌-民權,2024-01-09,9312
9924,福興,50,0,50,華南永昌-民權,2024-01-09,9312
00934,中信成長高股息,30,0,30,華南永昌-民權,2024-01-09,9312
2324,仁寶,29,7,22,華南永昌-民權,2024-01-09,9312
2634,漢翔,22,1,21,華南永昌-民權,2024-01-09,9312
4956,光鋐,24,3,21,華南永昌-民權,2024-01-09,9312
1316,上曜,20,0,20,華南永昌-民權,2024-01-09,9312
1616,億泰,20,0,20,華南永昌-民權,2024-01-09,9312
2337,旺宏,21,1,20,華南永昌-民權,2024-01-09,9312
2421,建準,26,6,20,華南永昌-民權,2024-01-09,9312
5340,建榮,16,0,16,華南永昌-民權,2024-01-09,9312
1301,台塑,14,0,14,華南永昌-民權,2024-01-09,9312
00725B,國泰投資級公司債,14,0,14,華南永昌-民權,2024-01-09,9312
2312,金寶,26,12,14,華南永昌-民權,2024-01-09,9312
2609,陽明,35,21,14,華南永昌-民權,2024-01-09,9312
00929,復華台灣科技優息,18,6,12,華南永昌-民權,2024-01-09,9312
2313,華通,13,1,12,華南永昌-民權,2024-01-09,9312
2614,東森,12,0,12,華南永昌-民權,2024-01-09,9312
6120,達運,12,0,12,華南永昌-民權,2024-01-09,9312
00680L,元大美債20正2,11,1,10,華南永昌-民權,2024-01-09,9312
00918,大華優利高填息30,10,0,10,華南永昌-民權,2024-01-09,9312
2303,聯電,12,2,10,華南永昌-民權,2024-01-09,9312
2612,中航,10,0,10,華南永昌-民權,2024-01-09,9312
4533,協易機,11,1,10,華南永昌-民權,2024-01-09,9312
9105,泰金寶-DR,11,1,10,華南永昌-民權,2024-01-09,9312
2002,中鋼,61,52,9,華南永昌-民權,2024-01-09,9312
3078,僑威,10,1,9,華南永昌-民權,2024-01-09,9312
4174,浩鼎,9,0,9,華南永昌-民權,2024-01-09,9312
3481,群創,16,8,8,華南永昌-民權,2024-01-09,9312
2601,益航,10,2,8,華南永昌-民權,2024-01-09,9312
2618,長榮航,21,13,8,華南永昌-民權,2024-01-09,9312
3046,建��,13,5,8,華南永昌-民權,2024-01-09,9312
6125,廣運,8,0,8,華南永昌-民權,2024-01-09,9312
6770,力積電,12,4,8,華南永昌-民權,2024-01-09,9312
9919,康那香,8,0,8,華南永昌-民權,2024-01-09,9312
2317,鴻海,7,0,7,華南永昌-民權,2024-01-09,9312
00927,群益半導體收益,7,0,7,華南永昌-民權,2024-01-09,9312
3357,臺慶科,7,0,7,華南永昌-民權,2024-01-09,9312
5309,系統電,9,2,7,華南永昌-民權,2024-01-09,9312
6462,神盾,10,3,7,華南永昌-民權,2024-01-09,9312
0056,元大高股息,7,1,6,華南永昌-民權,2024-01-09,9312
2362,藍天,8,2,6,華南永昌-民權,2024-01-09,9312
6116,彩晶,6,0,6,華南永昌-民權,2024-01-09,9312
00679B,元大美債20年,6,0,6,華南永昌-民權,2024-01-09,9312
2615,萬海,16,11,5,華南永昌-民權,2024-01-09,9312
1220,台榮,5,0,5,華南永昌-民權,2024-01-09,9312
00720B,元大投資級公司債,150,0,150,華南永昌-民權,2024-01-10,9312
9924,福興,55,0,55,華南永昌-民權,2024-01-10,9312
2610,華航,61,7,54,華南永昌-民權,2024-01-10,9312
00929,復華台灣科技優息,50,0,50,華南永昌-民權,2024-01-10,9312
1616,億泰,40,0,40,華南永昌-民權,2024-01-10,9312
2905,三商,40,0,40,華南永昌-民權,2024-01-10,9312
2618,長榮航,37,0,37,華南永昌-民權,2024-01-10,9312
3652,精聯,34,0,34,華南永昌-民權,2024-01-10,9312
1605,華新,35,2,33,華南永昌-民權,2024-01-10,9312
2537,聯上發,30,0,30,華南永昌-民權,2024-01-10,9312
3402,漢科,25,0,25,華南永昌-民權,2024-01-10,9312
00935,野村臺灣新科技50,21,0,21,華南永昌-民權,2024-01-10,9312
2498,宏達電,35,14,21,華南永昌-民權,2024-01-10,9312
2301,光寶科,21,1,20,華南永昌-民權,2024-01-10,9312
1316,上曜,20,0,20,華南永昌-民權,2024-01-10,9312
00753L,中信中國50正2,30,10,20,華南永昌-民權,2024-01-10,9312
00919,群益台灣精選高息,26,8,18,華南永昌-民權,2024-01-10,9312
3049,精金,15,1,14,華南永昌-民權,2024-01-10,9312
6239,力成,13,0,13,華南永昌-民權,2024-01-10,9312
0056,元大高股息,16,4,12,華南永昌-民權,2024-01-10,9312
1799,易威,13,1,12,華南永昌-民權,2024-01-10,9312
8096,擎亞,29,17,12,華南永昌-民權,2024-01-10,9312
2313,華通,11,0,11,華南永昌-民權,2024-01-10,9312
2388,威盛,10,0,10,華南永昌-民權,2024-01-10,9312
2614,東森,10,0,10,華南永昌-民權,2024-01-10,9312
6127,九豪,10,0,10,華南永昌-民權,2024-01-10,9312
8916,光隆,10,0,10,華南永昌-民權,2024-01-10,9312
2478,大毅,9,0,9,華南永昌-民權,2024-01-10,9312
3078,僑威,9,0,9,華南永昌-民權,2024-01-10,9312
00679B,元大美債20年,8,0,8,華南永昌-民權,2024-01-10,9312
2324,仁寶,7,0,7,華南永昌-民權,2024-01-10,9312
8182,加高,8,1,7,華南永昌-民權,2024-01-10,9312
2362,藍天,26,20,6,華南永昌-民權,2024-01-10,9312
2371,大同,19,13,6,華南永昌-民權,2024-01-10,9312
8942,森鉅,6,0,6,華南永昌-民權,2024-01-10,9312
3481,群創,6,1,5,華南永昌-民權,2024-01-10,9312
00927,群益半導體收益,5,0,5,華南永昌-民權,2024-01-10,9312
1301,台塑,5,0,5,華南永昌-民權,2024-01-10,9312
1612,宏泰,5,0,5,華南永昌-民權,2024-01-10,9312
2009,第一銅,5,0,5,華南永昌-民權,2024-01-10,9312
2104,國際中橡,5,0,5,華南永昌-民權,2024-01-10,9312
2607,榮運,5,0,5,華南永昌-民權,2024-01-10,9312
5876,上海商銀,5,0,5,華南永昌-民權,2024-01-10,9312
6215,和椿,5,0,5,華南永昌-民權,2024-01-10,9312
8147,正淩,5,0,5,華南永昌-民權,2024-01-10,9312
9105,泰金寶-DR,5,0,5,華南永昌-民權,2024-01-10,9312
9910,豐泰,5,0,5,華南永昌-民權,2024-01-10,9312
2885,元大金,5,1,4,華南永昌-民權,2024-01-10,9312
2892,第一金,5,1,4,華南永昌-民權,2024-01-10,9312
1314,中石化,4,0,4,華南永昌-民權,2024-01-10,9312
9924,福興,185,3,182,華南永昌-民權,2024-01-11,9312
00929,復華台灣科技優息,67,0,67,華南永昌-民權,2024-01-11,9312
8916,光隆,60,0,60,華南永昌-民權,2024-01-11,9312
00688L,國泰20年美債正2,30,0,30,華南永昌-民權,2024-01-11,9312
1301,台塑,25,1,24,華南永昌-民權,2024-01-11,9312
2610,華航,20,0,20,華南永昌-民權,2024-01-11,9312
2812,台中銀,40,20,20,華南永昌-民權,2024-01-11,9312
3652,精聯,20,0,20,華南永昌-民權,2024-01-11,9312
00919,群益台灣精選高息,17,0,17,華南永昌-民權,2024-01-11,9312
00679B,元大美債20年,16,0,16,華南永昌-民權,2024-01-11,9312
3025,星通,30,16,14,華南永昌-民權,2024-01-11,9312
2353,宏��,42,28,14,華南永昌-民權,2024-01-11,9312
2618,長榮航,13,1,12,華南永昌-民權,2024-01-11,9312
0056,元大高股息,13,1,12,華南永昌-民權,2024-01-11,9312
2388,威盛,12,1,11,華南永昌-民權,2024-01-11,9312
2449,京元電子,11,0,11,華南永昌-民權,2024-01-11,9312
00770,國泰北美科技,13,2,11,華南永昌-民權,2024-01-11,9312
00671R,富邦NASDAQ反1,10,0,10,華南永昌-民權,2024-01-11,9312
00904,新光臺灣半導體30,10,0,10,華南永昌-民權,2024-01-11,9312
1313,聯成,10,0,10,華南永昌-民權,2024-01-11,9312
1809,中釉,10,0,10,華南永昌-民權,2024-01-11,9312
2890,永豐金,11,1,10,華南永昌-民權,2024-01-11,9312
5340,建榮,10,0,10,華南永昌-民權,2024-01-11,9312
6164,華興,12,2,10,華南永昌-民權,2024-01-11,9312
6281,全國電,10,0,10,華南永昌-民權,2024-01-11,9312
6695,芯鼎,52,42,10,華南永昌-民權,2024-01-11,9312
8111,立��,10,0,10,華南永昌-民權,2024-01-11,9312
00927,群益半導體收益,9,0,9,華南永昌-民權,2024-01-11,9312
3138,耀登,9,1,8,華南永昌-民權,2024-01-11,9312
00891,中信關鍵半導體,7,0,7,華南永昌-民權,2024-01-11,9312
1326,台化,7,0,7,華南永昌-民權,2024-01-11,9312
2498,宏達電,10,3,7,華南永昌-民權,2024-01-11,9312
2887,台新金,7,0,7,華南永昌-民權,2024-01-11,9312
4533,協易機,7,0,7,華南永昌-民權,2024-01-11,9312
1519,華城,12,6,6,華南永昌-民權,2024-01-11,9312
2409,友達,9,3,6,華南永昌-民權,2024-01-11,9312
6166,凌華,6,0,6,華南永昌-民權,2024-01-11,9312
8299,群聯,6,0,6,華南永昌-民權,2024-01-11,9312
1303,南亞,5,0,5,華南永昌-民權,2024-01-11,9312
1742,台蠟,5,0,5,華南永昌-民權,2024-01-11,9312
2478,大毅,5,0,5,華南永昌-民權,2024-01-11,9312
2543,皇昌,5,0,5,華南永昌-民權,2024-01-11,9312
2637,慧洋-KY,5,0,5,華南永昌-民權,2024-01-11,9312
3051,力特,5,0,5,華南永昌-民權,2024-01-11,9312
3357,臺慶科,5,0,5,華南永昌-民權,2024-01-11,9312
4909,新復興,6,1,5,華南永昌-民權,2024-01-11,9312
6127,九豪,5,0,5,華南永昌-民權,2024-01-11,9312
9912,偉聯,5,0,5,華南永昌-民權,2024-01-11,9312
00713,元大台灣高息低波,5,1,4,華南永昌-民權,2024-01-11,9312
2377,微星,5,1,4,華南永昌-民權,2024-01-11,9312
2834,臺企銀,650,1,649,華南永昌-民權,2024-01-12,9312
00929,復華台灣科技優息,382,0,382,華南永昌-民權,2024-01-12,9312
00919,群益台灣精選高息,111,0,111,華南永昌-民權,2024-01-12,9312
00679B,元大美債20年,103,0,103,華南永昌-民權,2024-01-12,9312
9924,福興,64,0,64,華南永昌-民權,2024-01-12,9312
00720B,元大投資級公司債,55,0,55,華南永昌-民權,2024-01-12,9312
8916,光隆,40,0,40,華南永昌-民權,2024-01-12,9312
2002,中鋼,30,0,30,華南永昌-民權,2024-01-12,9312
3652,精聯,30,0,30,華南永昌-民權,2024-01-12,9312
00753L,中信中國50正2,20,0,20,華南永昌-民權,2024-01-12,9312
5483,中美晶,21,1,20,華南永昌-民權,2024-01-12,9312
6530,創威,20,0,20,華南永昌-民權,2024-01-12,9312
2208,台船,50,32,18,華南永昌-民權,2024-01-12,9312
00795B,中信美國公債20年,15,0,15,華南永昌-民權,2024-01-12,9312
8034,榮群,17,2,15,華南永昌-民權,2024-01-12,9312
00885,富邦越南,14,0,14,華南永昌-民權,2024-01-12,9312
2537,聯上發,13,0,13,華南永昌-民權,2024-01-12,9312
2454,聯發科,11,1,10,華南永昌-民權,2024-01-12,9312
1773,勝一,10,0,10,華南永昌-民權,2024-01-12,9312
2374,佳能,10,0,10,華南永昌-民權,2024-01-12,9312
3711,日月光投控,10,0,10,華南永昌-民權,2024-01-12,9312
6269,台郡,10,0,10,華南永昌-民權,2024-01-12,9312
8096,擎亞,21,11,10,華南永昌-民權,2024-01-12,9312
8111,立��,10,0,10,華南永昌-民權,2024-01-12,9312
9950,萬國通,10,0,10,華南永昌-民權,2024-01-12,9312
1325,恆大,10,1,9,華南永昌-民權,2024-01-12,9312
00927,群益半導體收益,9,0,9,華南永昌-民權,2024-01-12,9312
2353,宏��,22,13,9,華南永昌-民權,2024-01-12,9312
2915,潤泰全,9,0,9,華南永昌-民權,2024-01-12,9312
3287,廣寰科,12,3,9,華南永昌-民權,2024-01-12,9312
1528,恩德,14,6,8,華南永昌-民權,2024-01-12,9312
3481,群創,24,17,7,華南永昌-民權,2024-01-12,9312
2329,華泰,23,16,7,華南永昌-民權,2024-01-12,9312
00878,國泰永續高股息,6,0,6,華南永昌-民權,2024-01-12,9312
2633,台灣高鐵,6,0,6,華南永昌-民權,2024-01-12,9312
2883,凱基金,6,0,6,華南永昌-民權,2024-01-12,9312
4903,聯光通,7,1,6,華南永昌-民權,2024-01-12,9312
6237,驊訊,6,0,6,華南永昌-民權,2024-01-12,9312
1905,華紙,5,0,5,華南永昌-民權,2024-01-12,9312
00934,中信成長高股息,5,0,5,華南永昌-民權,2024-01-12,9312
1608,華榮,5,0,5,華南永昌-民權,2024-01-12,9312
2027,大成鋼,5,0,5,華南永昌-民權,2024-01-12,9312
2313,華通,10,5,5,華南永昌-民權,2024-01-12,9312
2362,藍天,5,0,5,華南永昌-民權,2024-01-12,9312
2460,建通,7,2,5,華南永昌-民權,2024-01-12,9312
4552,力達-KY,5,0,5,華南永昌-民權,2024-01-12,9312
6127,九豪,5,0,5,華南永昌-民權,2024-01-12,9312
00770,國泰北美科技,6,2,4,華南永昌-民權,2024-01-12,9312
4956,光鋐,5,1,4,華南永昌-民權,2024-01-12,9312
6140,訊達,8,4,4,華南永昌-民權,2024-01-12,9312
00679B,元大美債20年,281,0,281,華南永昌-民權,2024-01-15,9312
00929,復華台灣科技優息,257,5,252,華南永昌-民權,2024-01-15,9312
2881,富邦金,102,0,102,華南永昌-民權,2024-01-15,9312
8936,國統,70,5,65,華南永昌-民權,2024-01-15,9312
2618,長榮航,54,2,52,華南永昌-民權,2024-01-15,9312
00919,群益台灣精選高息,25,0,25,華南永昌-民權,2024-01-15,9312
4905,台聯電,25,0,25,華南永昌-民權,2024-01-15,9312
8916,光隆,25,0,25,華南永昌-民權,2024-01-15,9312
2356,英業達,28,5,23,華南永昌-民權,2024-01-15,9312
00881,國泰台灣5G+,20,0,20,華南永昌-民權,2024-01-15,9312
00688L,國泰20年美債正2,20,0,20,華南永昌-民權,2024-01-15,9312
5340,建榮,20,0,20,華南永昌-民權,2024-01-15,9312
3576,聯合再生,22,3,19,華南永昌-民權,2024-01-15,9312
2363,矽統,17,0,17,華南永昌-民權,2024-01-15,9312
2367,燿華,15,0,15,華南永昌-民權,2024-01-15,9312
2883,凱基金,15,1,14,華南永昌-民權,2024-01-15,9312
2429,銘旺科,13,0,13,華南永昌-民權,2024-01-15,9312
2353,宏��,19,7,12,華南永昌-民權,2024-01-15,9312
0056,元大高股息,22,11,11,華南永昌-民權,2024-01-15,9312
2834,臺企銀,11,0,11,華南永昌-民權,2024-01-15,9312
00671R,富邦NASDAQ反1,10,0,10,華南永昌-民權,2024-01-15,9312
00915,凱基優選高股息30,10,0,10,華南永昌-民權,2024-01-15,9312
9924,福興,10,0,10,華南永昌-民權,2024-01-15,9312
2324,仁寶,9,0,9,華南永昌-民權,2024-01-15,9312
1519,華城,14,5,9,華南永昌-民權,2024-01-15,9312
2478,大毅,8,0,8,華南永昌-民權,2024-01-15,9312
6125,廣運,10,2,8,華南永昌-民權,2024-01-15,9312
1584,精剛,12,5,7,華南永昌-民權,2024-01-15,9312
2317,鴻海,7,0,7,華南永昌-民權,2024-01-15,9312
2887,台新金,10,3,7,華南永昌-民權,2024-01-15,9312
6684,安格,7,0,7,華南永昌-民權,2024-01-15,9312
00937B,群益ESG投等債20,9,3,6,華南永昌-民權,2024-01-15,9312
2892,第一金,6,0,6,華南永昌-民權,2024-01-15,9312
00904,新光臺灣半導體30,5,0,5,華南永昌-民權,2024-01-15,9312
00891,中信關鍵半導體,5,0,5,華南永昌-民權,2024-01-15,9312
2382,廣達,6,1,5,華南永昌-民權,2024-01-15,9312
2634,漢翔,8,3,5,華南永昌-民權,2024-01-15,9312
2707,晶華,5,0,5,華南永昌-民權,2024-01-15,9312
3443,創意,4,0,4,華南永昌-民權,2024-01-15,9312
2468,華經,4,0,4,華南永昌-民權,2024-01-15,9312
3041,揚智,21,17,4,華南永昌-民權,2024-01-15,9312
3362,先進光,5,1,4,華南永昌-民權,2024-01-15,9312
3231,緯創,7,3,4,華南永昌-民權,2024-01-15,9312
6531,愛普*,4,0,4,華南永昌-民權,2024-01-15,9312
6415,矽力*-KY,5,2,3,華南永昌-民權,2024-01-15,9312
00770,國泰北美科技,7,4,3,華南永昌-民權,2024-01-15,9312
00857B,永豐20年美公債,3,0,3,華南永昌-民權,2024-01-15,9312
00687B,國泰20年美債,3,0,3,華南永昌-民權,2024-01-15,9312
1605,華新,3,0,3,華南永昌-民權,2024-01-15,9312
2337,旺宏,3,0,3,華南永昌-民權,2024-01-15,9312
2881,富邦金,326,0,326,華南永昌-民權,2024-01-16,9312
9924,福興,235,0,235,華南永昌-民權,2024-01-16,9312
8916,光隆,140,0,140,華南永昌-民權,2024-01-16,9312
8436,大江,100,0,100,華南永昌-民權,2024-01-16,9312
4123,晟德,105,5,100,華南永昌-民權,2024-01-16,9312
00919,群益台灣精選高息,83,2,81,華南永昌-民權,2024-01-16,9312
0056,元大高股息,71,2,69,華南永昌-民權,2024-01-16,9312
2801,彰銀,57,0,57,華南永昌-民權,2024-01-16,9312
00753L,中信中國50正2,60,20,40,華南永昌-民權,2024-01-16,9312
00937B,群益ESG投等債20,35,5,30,華南永昌-民權,2024-01-16,9312
5483,中美晶,30,0,30,華南永昌-民權,2024-01-16,9312
2405,輔信,42,13,29,華南永昌-民權,2024-01-16,9312
00878,國泰永續高股息,28,1,27,華南永昌-民權,2024-01-16,9312
1528,恩德,34,7,27,華南永昌-民權,2024-01-16,9312
1101,台泥,25,0,25,華南永昌-民權,2024-01-16,9312
9927,泰銘,25,0,25,華南永昌-民權,2024-01-16,9312
2610,華航,25,2,23,華南永昌-民權,2024-01-16,9312
3652,精聯,23,0,23,華南永昌-民權,2024-01-16,9312
00929,復華台灣科技優息,22,1,21,華南永昌-民權,2024-01-16,9312
1326,台化,40,19,21,華南永昌-民權,2024-01-16,9312
00637L,元大滬深300正2,20,0,20,華南永昌-民權,2024-01-16,9312
2486,一詮,33,13,20,華南永昌-民權,2024-01-16,9312
8936,國統,20,0,20,華南永昌-民權,2024-01-16,9312
6233,旺玖,21,2,19,華南永昌-民權,2024-01-16,9312
2002,中鋼,17,0,17,華南永昌-民權,2024-01-16,9312
2356,英業達,19,4,15,華南永昌-民權,2024-01-16,9312
3402,漢科,15,0,15,華南永昌-民權,2024-01-16,9312
3593,力銘,14,0,14,華南永昌-民權,2024-01-16,9312
1609,大亞,22,10,12,華南永昌-民權,2024-01-16,9312
2707,晶華,12,0,12,華南永昌-民權,2024-01-16,9312
00881,國泰台灣5G+,11,0,11,華南永昌-民權,2024-01-16,9312
2887,台新金,26,16,10,華南永昌-民權,2024-01-16,9312
2498,宏達電,10,0,10,華南永昌-民權,2024-01-16,9312
5876,上海商銀,10,0,10,華南永昌-民權,2024-01-16,9312
00633L,富邦上証正2,10,0,10,華南永昌-民權,2024-01-16,9312
00891,中信關鍵半導體,10,0,10,華南永昌-民權,2024-01-16,9312
2614,東森,10,0,10,華南永昌-民權,2024-01-16,9312
4167,松瑞藥,10,0,10,華南永昌-民權,2024-01-16,9312
5340,建榮,10,0,10,華南永昌-民權,2024-01-16,9312
5515,建國,10,0,10,華南永昌-民權,2024-01-16,9312
5880,合庫金,11,1,10,華南永昌-民權,2024-01-16,9312
1301,台塑,10,1,9,華南永昌-民權,2024-01-16,9312
2897,王道銀行,9,0,9,華南永昌-民權,2024-01-16,9312
3623,富晶通,10,1,9,華南永昌-民權,2024-01-16,9312
6443,元晶,13,4,9,華南永昌-民權,2024-01-16,9312
00770,國泰北美科技,16,8,8,華南永昌-民權,2024-01-16,9312
2344,華邦電,20,12,8,華南永昌-民權,2024-01-16,9312
2618,長榮航,13,5,8,華南永昌-民權,2024-01-16,9312
4549,桓達,8,0,8,華南永昌-民權,2024-01-16,9312
6113,亞矽,7,0,7,華南永昌-民權,2024-01-16,9312
2412,中華電,500,0,500,華南永昌-民權,2024-01-17,9312
9924,福興,472,0,472,華南永昌-民權,2024-01-17,9312
00882,中信中國高股息,360,0,360,華南永昌-民權,2024-01-17,9312
00919,群益台灣精選高息,213,2,211,華南永昌-民權,2024-01-17,9312
00929,復華台灣科技優息,168,0,168,華南永昌-民權,2024-01-17,9312
2344,華邦電,149,22,127,華南永昌-民權,2024-01-17,9312
00753L,中信中國50正2,90,0,90,華南永昌-民權,2024-01-17,9312
2618,長榮航,87,1,86,華南永昌-民權,2024-01-17,9312
8916,光隆,85,0,85,華南永昌-民權,2024-01-17,9312
2303,聯電,84,0,84,華南永昌-民權,2024-01-17,9312
5488,松普,80,0,80,華南永昌-民權,2024-01-17,9312
0056,元大高股息,51,0,51,華南永昌-民權,2024-01-17,9312
2329,華泰,64,14,50,華南永昌-民權,2024-01-17,9312
00878,國泰永續高股息,40,1,39,華南永昌-民權,2024-01-17,9312
3652,精聯,30,0,30,華南永昌-民權,2024-01-17,9312
1605,華新,26,0,26,華南永昌-民權,2024-01-17,9312
4905,台聯電,21,0,21,華南永昌-民權,2024-01-17,9312
1101,台泥,20,0,20,華南永昌-民權,2024-01-17,9312
1603,華電,20,0,20,華南永昌-民權,2024-01-17,9312
2903,遠百,20,0,20,華南永昌-民權,2024-01-17,9312
8936,國統,22,2,20,華南永昌-民權,2024-01-17,9312
2886,兆豐金,19,0,19,華南永昌-民權,2024-01-17,9312
00918,大華優利高填息30,18,0,18,華南永昌-民權,2024-01-17,9312
1301,台塑,17,1,16,華南永昌-民權,2024-01-17,9312
2609,陽明,25,10,15,華南永昌-民權,2024-01-17,9312
2002,中鋼,13,0,13,華南永昌-民權,2024-01-17,9312
00927,群益半導體收益,12,0,12,華南永昌-民權,2024-01-17,9312
2317,鴻海,13,1,12,華南永昌-民權,2024-01-17,9312
2356,英業達,26,15,11,華南永昌-民權,2024-01-17,9312
2376,技嘉,12,1,11,華南永昌-民權,2024-01-17,9312
6770,力積電,11,1,10,華南永昌-民權,2024-01-17,9312
00637L,元大滬深300正2,10,0,10,華南永昌-民權,2024-01-17,9312
00632R,元大台灣50反1,20,10,10,華南永昌-民權,2024-01-17,9312
1809,中釉,10,0,10,華南永昌-民權,2024-01-17,9312
2498,宏達電,10,0,10,華南永昌-民權,2024-01-17,9312
2504,國產,10,0,10,華南永昌-民權,2024-01-17,9312
2614,東森,10,0,10,華南永昌-民權,2024-01-17,9312
8111,立��,10,0,10,華南永昌-民權,2024-01-17,9312
2108,南帝,9,0,9,華南永昌-民權,2024-01-17,9312
2371,大同,10,1,9,華南永昌-民權,2024-01-17,9312
6127,九豪,31,22,9,華南永昌-民權,2024-01-17,9312
2883,凱基金,10,2,8,華南永昌-民權,2024-01-17,9312
4533,協易機,8,0,8,華南永昌-民權,2024-01-17,9312
2353,宏��,12,5,7,華南永昌-民權,2024-01-17,9312
2308,台達電,7,1,6,華南永昌-民權,2024-01-17,9312
2457,飛宏,6,0,6,華南永昌-民權,2024-01-17,9312
2537,聯上發,6,0,6,華南永昌-民權,2024-01-17,9312
2801,彰銀,6,0,6,華南永昌-民權,2024-01-17,9312
2888,新光金,6,0,6,華南永昌-民權,2024-01-17,9312
2890,永豐金,7,1,6,華南永昌-民權,2024-01-17,9312
00929,復華台灣科技優息,134,0,134,華南永昌-民權,2024-01-18,9312
2884,玉山金,108,1,107,華南永昌-民權,2024-01-18,9312
00904,新光臺灣半導體30,75,0,75,華南永昌-民權,2024-01-18,9312
9924,福興,63,0,63,華南永昌-民權,2024-01-18,9312
00637L,元大滬深300正2,130,70,60,華南永昌-民權,2024-01-18,9312
00633L,富邦上証正2,60,0,60,華南永昌-民權,2024-01-18,9312
8916,光隆,50,0,50,華南永昌-民權,2024-01-18,9312
3402,漢科,40,0,40,華南永昌-民權,2024-01-18,9312
2002,中鋼,35,0,35,華南永昌-民權,2024-01-18,9312
2313,華通,30,2,28,華南永昌-民權,2024-01-18,9312
2324,仁寶,26,0,26,華南永昌-民權,2024-01-18,9312
1301,台塑,26,2,24,華南永昌-民權,2024-01-18,9312
8112,至上,27,3,24,華南永昌-民權,2024-01-18,9312
00919,群益台灣精選高息,27,5,22,華南永昌-民權,2024-01-18,9312
2915,潤泰全,20,0,20,華南永昌-民權,2024-01-18,9312
5340,建榮,20,0,20,華南永昌-民權,2024-01-18,9312
6120,達運,29,10,19,華南永昌-民權,2024-01-18,9312
1514,亞力,21,5,16,華南永昌-民權,2024-01-18,9312
4979,華星光,16,1,15,華南永昌-民權,2024-01-18,9312
3491,昇達科,13,0,13,華南永昌-民權,2024-01-18,9312
2882,國泰金,13,0,13,華南永昌-民權,2024-01-18,9312
2303,聯電,12,0,12,華南永昌-民權,2024-01-18,9312
3702,大聯大,13,1,12,華南永昌-民權,2024-01-18,9312
8936,國統,14,2,12,華南永昌-民權,2024-01-18,9312
00878,國泰永續高股息,11,0,11,華南永昌-民權,2024-01-18,9312
1603,華電,10,0,10,華南永昌-民權,2024-01-18,9312
2486,一詮,11,1,10,華南永昌-民權,2024-01-18,9312
4905,台聯電,10,0,10,華南永昌-民權,2024-01-18,9312
6117,迎廣,40,30,10,華南永昌-民權,2024-01-18,9312
1303,南亞,9,0,9,華南永昌-民權,2024-01-18,9312
2707,晶華,10,1,9,華南永昌-民權,2024-01-18,9312
2887,台新金,13,5,8,華南永昌-民權,2024-01-18,9312
8354,冠好,8,0,8,華南永昌-民權,2024-01-18,9312
00631L,元大台灣50正2,7,0,7,華南永昌-民權,2024-01-18,9312
4960,誠美材,7,0,7,華南永昌-民權,2024-01-18,9312
6233,旺玖,7,0,7,華南永昌-民權,2024-01-18,9312
00891,中信關鍵半導體,6,0,6,華南永昌-民權,2024-01-18,9312
3029,零壹,10,4,6,華南永昌-民權,2024-01-18,9312
3675,德微,5,0,5,華南永昌-民權,2024-01-18,9312
3231,緯創,16,11,5,華南永昌-民權,2024-01-18,9312
00927,群益半導體收益,5,0,5,華南永昌-民權,2024-01-18,9312
1101,台泥,5,0,5,華南永昌-民權,2024-01-18,9312
2367,燿華,5,0,5,華南永昌-民權,2024-01-18,9312
3221,台嘉碩,5,0,5,華南永昌-民權,2024-01-18,9312
5328,華容,5,0,5,華南永昌-民權,2024-01-18,9312
6668,中揚光,10,5,5,華南永昌-民權,2024-01-18,9312
8940,新天地,5,0,5,華南永昌-民權,2024-01-18,9312
2409,友達,26,22,4,華南永昌-民權,2024-01-18,9312
2105,正新,4,0,4,華南永昌-民權,2024-01-18,9312
2348A,海悅甲特,4,0,4,華南永昌-民權,2024-01-18,9312
2889,國票金,700,400,300,華南永昌-民權,2024-01-19,9312
00882,中信中國高股息,111,0,111,華南永昌-民權,2024-01-19,9312
00937B,群益ESG投等債20,77,0,77,華南永昌-民權,2024-01-19,9312
9924,福興,65,0,65,華南永昌-民權,2024-01-19,9312
2002,中鋼,63,0,63,華南永昌-民權,2024-01-19,9312
6207,雷科,60,0,60,華南永昌-民權,2024-01-19,9312
0056,元大高股息,54,0,54,華南永昌-民權,2024-01-19,9312
2883,凱基金,53,0,53,華南永昌-民權,2024-01-19,9312
00632R,元大台灣50反1,45,0,45,華南永昌-民權,2024-01-19,9312
00919,群益台灣精選高息,31,0,31,華南永昌-民權,2024-01-19,9312
8916,光隆,30,0,30,華南永昌-民權,2024-01-19,9312
2610,華航,22,0,22,華南永昌-民權,2024-01-19,9312
1101,台泥,21,0,21,華南永昌-民權,2024-01-19,9312
00753L,中信中國50正2,70,50,20,華南永昌-民權,2024-01-19,9312
2312,金寶,54,34,20,華南永昌-民權,2024-01-19,9312
4942,嘉彰,20,0,20,華南永昌-民權,2024-01-19,9312
4956,光鋐,49,30,19,華南永昌-民權,2024-01-19,9312
00929,復華台灣科技優息,18,0,18,華南永昌-民權,2024-01-19,9312
6488,環球晶,15,0,15,華南永昌-民權,2024-01-19,9312
8112,至上,15,0,15,華南永昌-民權,2024-01-19,9312
00772B,中信高評級公司債,14,0,14,華南永昌-民權,2024-01-19,9312
2329,華泰,32,18,14,華南永昌-民權,2024-01-19,9312
2409,友達,23,10,13,華南永昌-民權,2024-01-19,9312
4979,華星光,18,6,12,華南永昌-民權,2024-01-19,9312
00688L,國泰20年美債正2,11,0,11,華南永昌-民權,2024-01-19,9312
6276,安鈦克,13,2,11,華南永昌-民權,2024-01-19,9312
00934,中信成長高股息,20,10,10,華南永昌-民權,2024-01-19,9312
1603,華電,10,0,10,華南永昌-民權,2024-01-19,9312
3520,華盈,10,0,10,華南永昌-民權,2024-01-19,9312
00770,國泰北美科技,10,0,10,華南永昌-民權,2024-01-19,9312
2344,華邦電,11,2,9,華南永昌-民權,2024-01-19,9312
8034,榮群,19,10,9,華南永昌-民權,2024-01-19,9312
2618,長榮航,8,1,7,華南永昌-民權,2024-01-19,9312
2834,臺企銀,28,21,7,華南永昌-民權,2024-01-19,9312
00687B,國泰20年美債,7,0,7,華南永昌-民權,2024-01-19,9312
8936,國統,11,4,7,華南永昌-民權,2024-01-19,9312
2027,大成鋼,6,0,6,華南永昌-民權,2024-01-19,9312
2367,燿華,11,5,6,華南永昌-民權,2024-01-19,9312
6901,鑽石投資,6,0,6,華南永昌-民權,2024-01-19,9312
00773B,中信優先金融債,6,1,5,華南永昌-民權,2024-01-19,9312
1325,恆大,5,0,5,華南永昌-民權,2024-01-19,9312
2014,中鴻,5,0,5,華南永昌-民權,2024-01-19,9312
2405,輔信,5,0,5,華南永昌-民權,2024-01-19,9312
4123,晟德,15,10,5,華南永昌-民權,2024-01-19,9312
5381,合正,5,0,5,華南永昌-民權,2024-01-19,9312
6472,保瑞,5,1,4,華南永昌-民權,2024-01-19,9312
6285,啟��,5,1,4,華南永昌-民權,2024-01-19,9312
00795B,中信美國公債20年,4,0,4,華南永昌-民權,2024-01-19,9312
3515,華擎,5,1,4,華南永昌-民權,2024-01-19,9312
4960,誠美材,34,30,4,華南永昌-民權,2024-01-19,9312
00882,中信中國高股息,112,0,112,華南永昌-民權,2024-01-22,9312
6139,亞翔,61,0,61,華南永昌-民權,2024-01-22,9312
2618,長榮航,65,5,60,華南永昌-民權,2024-01-22,9312
00688L,國泰20年美債正2,40,0,40,華南永昌-民權,2024-01-22,9312
00632R,元大台灣50反1,37,0,37,華南永昌-民權,2024-01-22,9312
00919,群益台灣精選高息,35,1,34,華南永昌-民權,2024-01-22,9312
0056,元大高股息,34,0,34,華南永昌-民權,2024-01-22,9312
3481,群創,54,21,33,華南永昌-民權,2024-01-22,9312
2515,中工,30,0,30,華南永昌-民權,2024-01-22,9312
00937B,群益ESG投等債20,26,0,26,華南永昌-民權,2024-01-22,9312
2449,京元電子,31,6,25,華南永昌-民權,2024-01-22,9312
4942,嘉彰,25,0,25,華南永昌-民權,2024-01-22,9312
00753L,中信中國50正2,70,50,20,華南永昌-民權,2024-01-22,9312
00720B,元大投資級公司債,20,0,20,華南永昌-民權,2024-01-22,9312
3402,漢科,20,0,20,華南永昌-民權,2024-01-22,9312
3607,谷崧,20,0,20,華南永昌-民權,2024-01-22,9312
6116,彩晶,29,10,19,華南永昌-民權,2024-01-22,9312
3437,榮創,17,0,17,華南永昌-民權,2024-01-22,9312
00933B,國泰10Y+金融債,13,0,13,華南永昌-民權,2024-01-22,9312
3287,廣寰科,53,42,11,華南永昌-民權,2024-01-22,9312
1409,新纖,10,0,10,華南永昌-民權,2024-01-22,9312
00687B,國泰20年美債,10,0,10,華南永昌-民權,2024-01-22,9312
6142,友勁,10,0,10,華南永昌-民權,2024-01-22,9312
6829,千附精密,10,0,10,華南永昌-民權,2024-01-22,9312
8064,東捷,10,0,10,華南永昌-民權,2024-01-22,9312
8437,大地-KY,12,2,10,華南永昌-民權,2024-01-22,9312
8916,光隆,10,0,10,華南永昌-民權,2024-01-22,9312
2609,陽明,23,14,9,華南永昌-民權,2024-01-22,9312
2353,宏��,16,7,9,華南永昌-民權,2024-01-22,9312
1609,大亞,10,2,8,華南永昌-民權,2024-01-22,9312
6188,廣明,10,2,8,華南永昌-民權,2024-01-22,9312
6243,迅杰,9,1,8,華南永昌-民權,2024-01-22,9312
1528,恩德,8,1,7,華南永昌-民權,2024-01-22,9312
6113,亞矽,8,1,7,華南永昌-民權,2024-01-22,9312
1618,合機,6,0,6,華南永昌-民權,2024-01-22,9312
2601,益航,8,2,6,華南永昌-民權,2024-01-22,9312
5426,振發,9,3,6,華南永昌-民權,2024-01-22,9312
6414,樺漢,6,0,6,華南永昌-民權,2024-01-22,9312
6715,嘉基,6,0,6,華南永昌-民權,2024-01-22,9312
00885,富邦越南,5,0,5,華南永昌-民權,2024-01-22,9312
2014,中鴻,5,0,5,華南永昌-民權,2024-01-22,9312
2316,楠梓電,6,1,5,華南永昌-民權,2024-01-22,9312
2365,昆盈,5,0,5,華南永昌-民權,2024-01-22,9312
2369,菱生,5,0,5,華南永昌-民權,2024-01-22,9312
2425,承啟,5,0,5,華南永昌-民權,2024-01-22,9312
3432,台端,5,0,5,華南永昌-民權,2024-01-22,9312
4413,飛寶企業,5,0,5,華南永昌-民權,2024-01-22,9312
5439,高技,5,0,5,華南永昌-民權,2024-01-22,9312
8201,無敵,5,0,5,華南永昌-民權,2024-01-22,9312
00679B,元大美債20年,5,0,5,華南永昌-民權,2024-01-22,9312
00706L,期元大S＆P日圓正2,100,0,100,華南永昌-民權,2024-01-23,9312
9105,泰金寶-DR,55,0,55,華南永昌-民權,2024-01-23,9312
2329,華泰,55,5,50,華南永昌-民權,2024-01-23,9312
8050,廣積,50,0,50,華南永昌-民權,2024-01-23,9312
9924,福興,50,0,50,華南永昌-民權,2024-01-23,9312
8110,華東,40,1,39,華南永昌-民權,2024-01-23,9312
3380,明泰,38,3,35,華南永昌-民權,2024-01-23,9312
00933B,國泰10Y+金融債,30,0,30,華南永昌-民權,2024-01-23,9312
3443,創意,33,4,29,華南永昌-民權,2024-01-23,9312
8437,大地-KY,28,0,28,華南永昌-民權,2024-01-23,9312
00929,復華台灣科技優息,25,0,25,華南永昌-民權,2024-01-23,9312
6139,亞翔,25,0,25,華南永昌-民權,2024-01-23,9312
2618,長榮航,24,2,22,華南永昌-民權,2024-01-23,9312
4956,光鋐,23,2,21,華南永昌-民權,2024-01-23,9312
00919,群益台灣精選高息,20,0,20,華南永昌-民權,2024-01-23,9312
2208,台船,21,2,19,華南永昌-民權,2024-01-23,9312
00937B,群益ESG投等債20,27,10,17,華南永昌-民權,2024-01-23,9312
2362,藍天,31,15,16,華南永昌-民權,2024-01-23,9312
2887,台新金,23,10,13,華南永昌-民權,2024-01-23,9312
00878,國泰永續高股息,63,50,13,華南永昌-民權,2024-01-23,9312
00680L,元大美債20正2,13,0,13,華南永昌-民權,2024-01-23,9312
2388,威盛,13,1,12,華南永昌-民權,2024-01-23,9312
2449,京元電子,14,2,12,華南永昌-民權,2024-01-23,9312
1303,南亞,12,0,12,華南永昌-民權,2024-01-23,9312
2609,陽明,17,5,12,華南永昌-民權,2024-01-23,9312
3652,精聯,11,0,11,華南永昌-民權,2024-01-23,9312
4109,加捷生醫,13,2,11,華南永昌-民權,2024-01-23,9312
8011,台通,11,0,11,華南永昌-民權,2024-01-23,9312
00687B,國泰20年美債,10,0,10,華南永昌-民權,2024-01-23,9312
00772B,中信高評級公司債,10,0,10,華南永昌-民權,2024-01-23,9312
4938,和碩,10,0,10,華南永昌-民權,2024-01-23,9312
8916,光隆,10,0,10,華南永昌-民權,2024-01-23,9312
1314,中石化,10,1,9,華南永昌-民權,2024-01-23,9312
00882,中信中國高股息,7,0,7,華南永昌-民權,2024-01-23,9312
6269,台郡,6,0,6,華南永昌-民權,2024-01-23,9312
6120,達運,10,4,6,華南永昌-民權,2024-01-23,9312
8027,鈦昇,6,0,6,華南永昌-民權,2024-01-23,9312
2368,金像電,6,0,6,華南永昌-民權,2024-01-23,9312
5469,瀚宇博,5,0,5,華南永昌-民權,2024-01-23,9312
1441,大東,5,0,5,華南永昌-民權,2024-01-23,9312
00891,中信關鍵半導體,5,0,5,華南永昌-民權,2024-01-23,9312
1584,精剛,5,0,5,華南永昌-民權,2024-01-23,9312
2323,中環,5,0,5,華南永昌-民權,2024-01-23,9312
2637,慧洋-KY,5,0,5,華南永昌-民權,2024-01-23,9312
3290,東浦,5,0,5,華南永昌-民權,2024-01-23,9312
3402,漢科,5,0,5,華南永昌-民權,2024-01-23,9312
3432,台端,5,0,5,華南永昌-民權,2024-01-23,9312
3673,TPK-KY,5,0,5,華南永昌-民權,2024-01-23,9312
6125,廣運,5,0,5,華南永昌-民權,2024-01-23,9312
6138,茂達,5,0,5,華南永昌-民權,2024-01-23,9312
00877,復華中國5G,152,0,152,華南永昌-民權,2024-01-24,9312
00753L,中信中國50正2,149,70,79,華南永昌-民權,2024-01-24,9312
00637L,元大滬深300正2,180,110,70,華南永昌-民權,2024-01-24,9312
00712,復華富時不動產,45,0,45,華南永昌-民權,2024-01-24,9312
3402,漢科,40,0,40,華南永昌-民權,2024-01-24,9312
9924,福興,35,0,35,華南永昌-民權,2024-01-24,9312
2324,仁寶,35,1,34,華南永昌-民權,2024-01-24,9312
1301,台塑,21,0,21,華南永昌-民權,2024-01-24,9312
00937B,群益ESG投等債20,23,5,18,華南永昌-民權,2024-01-24,9312
00687B,國泰20年美債,18,0,18,華南永昌-民權,2024-01-24,9312
6139,亞翔,19,2,17,華南永昌-民權,2024-01-24,9312
00633L,富邦上証正2,15,0,15,華南永昌-民權,2024-01-24,9312
00929,復華台灣科技優息,20,5,15,華南永昌-民權,2024-01-24,9312
3652,精聯,13,0,13,華南永昌-民權,2024-01-24,9312
00882,中信中國高股息,12,0,12,華南永昌-民權,2024-01-24,9312
00933B,國泰10Y+金融債,11,0,11,華南永昌-民權,2024-01-24,9312
2884,玉山金,11,0,11,華南永昌-民權,2024-01-24,9312
00680L,元大美債20正2,10,0,10,華南永昌-民權,2024-01-24,9312
6276,安鈦克,11,1,10,華南永昌-民權,2024-01-24,9312
1303,南亞,10,0,10,華南永昌-民權,2024-01-24,9312
2374,佳能,11,1,10,華南永昌-民權,2024-01-24,9312
3687,歐買尬,14,4,10,華南永昌-民權,2024-01-24,9312
6120,達運,10,0,10,華南永昌-民權,2024-01-24,9312
9919,康那香,10,0,10,華南永昌-民權,2024-01-24,9312
3231,緯創,24,15,9,華南永昌-民權,2024-01-24,9312
2352,佳世達,9,0,9,華南永昌-民權,2024-01-24,9312
2419,仲琦,9,0,9,華南永昌-民權,2024-01-24,9312
00679B,元大美債20年,8,0,8,華南永昌-民權,2024-01-24,9312
2836,高雄銀,8,0,8,華南永昌-民權,2024-01-24,9312
2514,龍邦,7,0,7,華南永昌-民權,2024-01-24,9312
2915,潤泰全,6,0,6,華南永昌-民權,2024-01-24,9312
3545,敦泰,8,2,6,華南永昌-民權,2024-01-24,9312
4188,安克,6,0,6,華南永昌-民權,2024-01-24,9312
00919,群益台灣精選高息,5,0,5,華南永昌-民權,2024-01-24,9312
1718,中纖,5,0,5,華南永昌-民權,2024-01-24,9312
2344,華邦電,6,1,5,華南永昌-民權,2024-01-24,9312
2367,燿華,5,0,5,華南永昌-民權,2024-01-24,9312
3236,千如,5,0,5,華南永昌-民權,2024-01-24,9312
3714,富采,6,1,5,華南永昌-民權,2024-01-24,9312
6125,廣運,5,0,5,華南永昌-民權,2024-01-24,9312
6425,易發,5,0,5,華南永昌-民權,2024-01-24,9312
8936,國統,5,0,5,華南永昌-民權,2024-01-24,9312
3443,創意,4,0,4,華南永昌-民權,2024-01-24,9312
1799,易威,6,2,4,華南永昌-民權,2024-01-24,9312
2609,陽明,10,6,4,華南永昌-民權,2024-01-24,9312
3037,欣興,6,2,4,華南永昌-民權,2024-01-24,9312
1514,亞力,4,0,4,華南永昌-民權,2024-01-24,9312
1815,富喬,7,3,4,華南永昌-民權,2024-01-24,9312
2388,威盛,4,0,4,華南永昌-民權,2024-01-24,9312
5011,久陽,4,0,4,華南永昌-民權,2024-01-24,9312
3035,智原,118,9,109,華南永昌-民權,2024-01-25,9312
4942,嘉彰,57,2,55,華南永昌-民權,2024-01-25,9312
8916,光隆,55,0,55,華南永昌-民權,2024-01-25,9312
3622,洋華,25,2,23,華南永昌-民權,2024-01-25,9312
8105,凌巨,27,5,22,華南永昌-民權,2024-01-25,9312
8112,至上,22,0,22,華南永昌-民權,2024-01-25,9312
2356,英業達,44,29,15,華南永昌-民權,2024-01-25,9312
00687B,國泰20年美債,15,0,15,華南永昌-民權,2024-01-25,9312
9924,福興,15,0,15,華南永昌-民權,2024-01-25,9312
8096,擎亞,75,61,14,華南永昌-民權,2024-01-25,9312
3481,群創,14,1,13,華南永昌-民權,2024-01-25,9312
00937B,群益ESG投等債20,11,0,11,華南永昌-民權,2024-01-25,9312
1301,台塑,11,0,11,華南永昌-民權,2024-01-25,9312
3032,偉訓,12,1,11,華南永昌-民權,2024-01-25,9312
6274,台燿,12,2,10,華南永昌-民權,2024-01-25,9312
1303,南亞,10,0,10,華南永昌-民權,2024-01-25,9312
1618,合機,10,0,10,華南永昌-民權,2024-01-25,9312
2108,南帝,10,0,10,華南永昌-民權,2024-01-25,9312
2905,三商,10,0,10,華南永昌-民權,2024-01-25,9312
3607,谷崧,10,0,10,華南永昌-民權,2024-01-25,9312
8050,廣積,10,0,10,華南永昌-民權,2024-01-25,9312
2634,漢翔,9,0,9,華南永昌-民權,2024-01-25,9312
3033,威健,9,0,9,華南永昌-民權,2024-01-25,9312
2360,致茂,11,2,9,華南永昌-民權,2024-01-25,9312
00882,中信中國高股息,8,0,8,華南永昌-民權,2024-01-25,9312
6245,立端,8,0,8,華南永昌-民權,2024-01-25,9312
2002,中鋼,8,1,7,華南永昌-民權,2024-01-25,9312
2208,台船,7,0,7,華南永昌-民權,2024-01-25,9312
2460,建通,8,1,7,華南永昌-民權,2024-01-25,9312
2376,技嘉,7,1,6,華南永昌-民權,2024-01-25,9312
2486,一詮,6,0,6,華南永昌-民權,2024-01-25,9312
2514,龍邦,6,0,6,華南永昌-民權,2024-01-25,9312
00900,富邦特選高股息30,5,0,5,華南永昌-民權,2024-01-25,9312
1524,耿鼎,5,0,5,華南永昌-民權,2024-01-25,9312
1799,易威,5,0,5,華南永昌-民權,2024-01-25,9312
2382,廣達,6,1,5,華南永昌-民權,2024-01-25,9312
2886,兆豐金,5,0,5,華南永昌-民權,2024-01-25,9312
3088,艾訊,5,0,5,華南永昌-民權,2024-01-25,9312
3230,錦明,5,0,5,華南永昌-民權,2024-01-25,9312
3276,宇環,6,1,5,華南永昌-民權,2024-01-25,9312
3390,旭軟,5,0,5,華南永昌-民權,2024-01-25,9312
3432,台端,5,0,5,華南永昌-民權,2024-01-25,9312
3625,西勝,5,0,5,華南永昌-民權,2024-01-25,9312
8034,榮群,9,4,5,華南永昌-民權,2024-01-25,9312
6140,訊達,7,2,5,華南永昌-民權,2024-01-25,9312
2409,友達,6,2,4,華南永昌-民權,2024-01-25,9312
00902,中信電池及儲能,4,0,4,華南永昌-民權,2024-01-25,9312
2353,宏��,6,2,4,華南永昌-民權,2024-01-25,9312
3041,揚智,8,4,4,華南永昌-民權,2024-01-25,9312
3362,先進光,5,1,4,華南永昌-民權,2024-01-25,9312
2303,聯電,102,2,100,華南永昌-民權,2024-01-26,9312
00919,群益台灣精選高息,85,27,58,華南永昌-民權,2024-01-26,9312
2324,仁寶,61,4,57,華南永昌-民權,2024-01-26,9312
1217,愛之味,50,0,50,華南永昌-民權,2024-01-26,9312
00720B,元大投資級公司債,50,0,50,華南永昌-民權,2024-01-26,9312
3035,智原,35,2,33,華南永昌-民權,2024-01-26,9312
2329,華泰,81,54,27,華南永昌-民權,2024-01-26,9312
00633L,富邦上証正2,22,0,22,華南永昌-民權,2024-01-26,9312
1303,南亞,21,0,21,華南永昌-民權,2024-01-26,9312
00753L,中信中國50正2,20,0,20,華南永昌-民權,2024-01-26,9312
2353,宏��,21,4,17,華南永昌-民權,2024-01-26,9312
2363,矽統,16,0,16,華南永昌-民權,2024-01-26,9312
3025,星通,16,0,16,華南永昌-民權,2024-01-26,9312
00929,復華台灣科技優息,17,1,16,華南永昌-民權,2024-01-26,9312
8147,正淩,14,0,14,華南永昌-民權,2024-01-26,9312
00933B,國泰10Y+金融債,13,0,13,華南永昌-民權,2024-01-26,9312
3623,富晶通,34,22,12,華南永昌-民權,2024-01-26,9312
2301,光寶科,14,4,10,華南永昌-民權,2024-01-26,9312
00878,國泰永續高股息,12,2,10,華南永昌-民權,2024-01-26,9312
1301,台塑,10,0,10,華南永昌-民權,2024-01-26,9312
00935,野村臺灣新科技50,10,0,10,華南永昌-民權,2024-01-26,9312
1506,正道,10,0,10,華南永昌-民權,2024-01-26,9312
2440,太空梭,10,0,10,華南永昌-民權,2024-01-26,9312
4942,嘉彰,10,0,10,華南永昌-民權,2024-01-26,9312
5340,建榮,10,0,10,華南永昌-民權,2024-01-26,9312
8112,至上,10,0,10,華南永昌-民權,2024-01-26,9312
2457,飛宏,9,0,9,華南永昌-民權,2024-01-26,9312
6113,亞矽,10,2,8,華南永昌-民權,2024-01-26,9312
1503,士電,8,0,8,華南永昌-民權,2024-01-26,9312
00679B,元大美債20年,13,5,8,華南永昌-民權,2024-01-26,9312
2365,昆盈,10,2,8,華南永昌-民權,2024-01-26,9312
3622,洋華,10,2,8,華南永昌-民權,2024-01-26,9312
4174,浩鼎,8,0,8,華南永昌-民權,2024-01-26,9312
2002,中鋼,8,1,7,華南永昌-民權,2024-01-26,9312
00918,大華優利高填息30,7,0,7,華南永昌-民權,2024-01-26,9312
6841,長佳智能,7,0,7,華南永昌-民權,2024-01-26,9312
8105,凌巨,7,0,7,華南永昌-民權,2024-01-26,9312
2455,全新,12,6,6,華南永昌-民權,2024-01-26,9312
2356,英業達,13,8,5,華南永昌-民權,2024-01-26,9312
00937B,群益ESG投等債20,5,0,5,華南永昌-民權,2024-01-26,9312
2801,彰銀,5,0,5,華南永昌-民權,2024-01-26,9312
2887,台新金,6,1,5,華南永昌-民權,2024-01-26,9312
2897,王道銀行,5,0,5,華南永昌-民權,2024-01-26,9312
3432,台端,5,0,5,華南永昌-民權,2024-01-26,9312
3625,西勝,5,0,5,華南永昌-民權,2024-01-26,9312
8210,勤誠,7,3,4,華南永昌-民權,2024-01-26,9312
3694,海華,6,2,4,華南永昌-民權,2024-01-26,9312
00673R,期元大S＆P原油反1,4,0,4,華南永昌-民權,2024-01-26,9312
00915,凱基優選高股息30,4,0,4,華南永昌-民權,2024-01-26,9312
2344,華邦電,9,5,4,華南永昌-民權,2024-01-26,9312
00877,復華中國5G,500,0,500,華南永昌-民權,2024-01-29,9312
8436,大江,60,0,60,華南永昌-民權,2024-01-29,9312
8112,至上,50,0,50,華南永昌-民權,2024-01-29,9312
8936,國統,53,3,50,華南永昌-民權,2024-01-29,9312
8916,光隆,35,0,35,華南永昌-民權,2024-01-29,9312
2356,英業達,37,7,30,華南永昌-民權,2024-01-29,9312
2355,敬鵬,24,2,22,華南永昌-民權,2024-01-29,9312
6550,北極星藥業-KY,22,1,21,華南永昌-民權,2024-01-29,9312
3035,智原,51,31,20,華南永昌-民權,2024-01-29,9312
2369,菱生,20,0,20,華南永昌-民權,2024-01-29,9312
2884,玉山金,20,0,20,華南永昌-民權,2024-01-29,9312
6152,百一,20,0,20,華南永昌-民權,2024-01-29,9312
2313,華通,20,1,19,華南永昌-民權,2024-01-29,9312
00687B,國泰20年美債,16,0,16,華南永昌-民權,2024-01-29,9312
00933B,國泰10Y+金融債,22,6,16,華南永昌-民權,2024-01-29,9312
00931B,統一美債20年,13,0,13,華南永昌-民權,2024-01-29,9312
2376,技嘉,50,37,13,華南永昌-民權,2024-01-29,9312
2337,旺宏,13,2,11,華南永昌-民權,2024-01-29,9312
3354,律勝,11,0,11,華南永昌-民權,2024-01-29,9312
2880,華南金,11,1,10,華南永昌-民權,2024-01-29,9312
2801,彰銀,11,1,10,華南永昌-民權,2024-01-29,9312
2834,臺企銀,10,0,10,華南永昌-民權,2024-01-29,9312
2883,凱基金,10,0,10,華南永昌-民權,2024-01-29,9312
4123,晟德,10,0,10,華南永昌-民權,2024-01-29,9312
5340,建榮,10,0,10,華南永昌-民權,2024-01-29,9312
3041,揚智,17,8,9,華南永昌-民權,2024-01-29,9312
00937B,群益ESG投等債20,8,0,8,華南永昌-民權,2024-01-29,9312
1785,光洋科,12,4,8,華南永昌-民權,2024-01-29,9312
3047,訊舟,11,3,8,華南永昌-民權,2024-01-29,9312
3622,洋華,11,3,8,華南永昌-民權,2024-01-29,9312
3231,緯創,15,8,7,華南永昌-民權,2024-01-29,9312
2762,世界健身-KY,6,0,6,華南永昌-民權,2024-01-29,9312
3036,文曄,6,0,6,華南永昌-民權,2024-01-29,9312
00929,復華台灣科技優息,6,1,5,華南永昌-民權,2024-01-29,9312
00935,野村臺灣新科技50,5,0,5,華南永昌-民權,2024-01-29,9312
00885,富邦越南,11,6,5,華南永昌-民權,2024-01-29,9312
00637L,元大滬深300正2,5,0,5,華南永昌-民權,2024-01-29,9312
1325,恆大,5,0,5,華南永昌-民權,2024-01-29,9312
1582,信錦,5,0,5,華南永昌-民權,2024-01-29,9312
2344,華邦電,7,2,5,華南永昌-民權,2024-01-29,9312
2348A,海悅甲特,5,0,5,華南永昌-民權,2024-01-29,9312
2637,慧洋-KY,5,0,5,華南永昌-民權,2024-01-29,9312
3032,偉訓,5,0,5,華南永昌-民權,2024-01-29,9312
3227,原相,5,0,5,華南永昌-民權,2024-01-29,9312
4905,台聯電,5,0,5,華南永昌-民權,2024-01-29,9312
5703,亞都,5,0,5,華南永昌-民權,2024-01-29,9312
6182,合晶,5,0,5,華南永昌-民權,2024-01-29,9312
2610,華航,6,1,5,華南永昌-民權,2024-01-29,9312
2609,陽明,6,2,4,華南永昌-民權,2024-01-29,9312
3025,星通,21,17,4,華南永昌-民權,2024-01-29,9312
00753L,中信中國50正2,152,0,152,華南永昌-民權,2024-01-30,9312
4123,晟德,60,0,60,華南永昌-民權,2024-01-30,9312
5876,上海商銀,50,0,50,華南永昌-民權,2024-01-30,9312
6265,方土昶,50,0,50,華南永昌-民權,2024-01-30,9312
00937B,群益ESG投等債20,47,0,47,華南永昌-民權,2024-01-30,9312
8436,大江,90,50,40,華南永昌-民權,2024-01-30,9312
00675L,富邦臺灣加權正2,30,0,30,華南永昌-民權,2024-01-30,9312
2454,聯發科,26,2,24,華南永昌-民權,2024-01-30,9312
2337,旺宏,24,0,24,華南永昌-民權,2024-01-30,9312
6485,點序,23,0,23,華南永昌-民權,2024-01-30,9312
2498,宏達電,30,10,20,華南永昌-民權,2024-01-30,9312
8916,光隆,20,0,20,華南永昌-民權,2024-01-30,9312
3481,群創,40,21,19,華南永昌-民權,2024-01-30,9312
2324,仁寶,16,1,15,華南永昌-民權,2024-01-30,9312
5340,建榮,15,0,15,華南永昌-民權,2024-01-30,9312
8086,宏捷科,16,1,15,華南永昌-民權,2024-01-30,9312
00631L,元大台灣50正2,13,0,13,華南永昌-民權,2024-01-30,9312
8112,至上,13,0,13,華南永昌-民權,2024-01-30,9312
2884,玉山金,12,0,12,華南永昌-民權,2024-01-30,9312
1471,首利,11,0,11,華南永昌-民權,2024-01-30,9312
6117,迎廣,11,0,11,華南永昌-民權,2024-01-30,9312
8064,東捷,21,10,11,華南永昌-民權,2024-01-30,9312
3044,健鼎,12,2,10,華南永昌-民權,2024-01-30,9312
3708,上緯投控,10,0,10,華南永昌-民權,2024-01-30,9312
3652,精聯,10,1,9,華南永昌-民權,2024-01-30,9312
00725B,國泰投資級公司債,9,0,9,華南永昌-民權,2024-01-30,9312
2369,菱生,22,13,9,華南永昌-民權,2024-01-30,9312
2409,友達,9,0,9,華南永昌-民權,2024-01-30,9312
3715,定穎投控,11,2,9,華南永昌-民權,2024-01-30,9312
2365,昆盈,11,3,8,華南永昌-民權,2024-01-30,9312
2601,益航,8,0,8,華南永昌-民權,2024-01-30,9312
2867,三商壽,8,0,8,華南永昌-民權,2024-01-30,9312
8927,北基,18,10,8,華南永昌-民權,2024-01-30,9312
1506,正道,7,0,7,華南永昌-民權,2024-01-30,9312
00933B,國泰10Y+金融債,7,0,7,華南永昌-民權,2024-01-30,9312
00919,群益台灣精選高息,6,0,6,華南永昌-民權,2024-01-30,9312
1560,中砂,7,1,6,華南永昌-民權,2024-01-30,9312
6282,康舒,14,8,6,華南永昌-民權,2024-01-30,9312
9105,泰金寶-DR,6,0,6,華南永昌-民權,2024-01-30,9312
2303,聯電,7,2,5,華南永昌-民權,2024-01-30,9312
00795B,中信美國公債20年,5,0,5,華南永昌-民權,2024-01-30,9312
00764B,群益25年美債,5,0,5,華南永昌-民權,2024-01-30,9312
1612,宏泰,5,0,5,華南永昌-民權,2024-01-30,9312
2308,台達電,5,0,5,華南永昌-民權,2024-01-30,9312
2359,所羅門,5,0,5,華南永昌-民權,2024-01-30,9312
2412,中華電,5,0,5,華南永昌-民權,2024-01-30,9312
2486,一詮,5,0,5,華南永昌-民權,2024-01-30,9312
3357,臺慶科,5,0,5,華南永昌-民權,2024-01-30,9312
00882,中信中國高股息,4,0,4,華南永昌-民權,2024-01-30,9312
2355,敬鵬,4,0,4,華南永昌-民權,2024-01-30,9312
1312,國喬,196,0,196,華南永昌-民權,2024-01-31,9312
00937B,群益ESG投等債20,193,0,193,華南永昌-民權,2024-01-31,9312
00753L,中信中國50正2,52,10,42,華南永昌-民權,2024-01-31,9312
2498,宏達電,40,0,40,華南永昌-民權,2024-01-31,9312
2883,凱基金,40,0,40,華南永昌-民權,2024-01-31,9312
2610,華航,26,0,26,華南永昌-民權,2024-01-31,9312
5340,建榮,29,4,25,華南永昌-民權,2024-01-31,9312
2618,長榮航,22,1,21,華南永昌-民權,2024-01-31,9312
8081,致新,20,0,20,華南永昌-民權,2024-01-31,9312
9105,泰金寶-DR,20,0,20,華南永昌-民權,2024-01-31,9312
3231,緯創,17,0,17,華南永昌-民權,2024-01-31,9312
00935,野村臺灣新科技50,17,0,17,華南永昌-民權,2024-01-31,9312
2812,台中銀,18,2,16,華南永昌-民權,2024-01-31,9312
6485,點序,16,1,15,華南永昌-民權,2024-01-31,9312
2303,聯電,32,17,15,華南永昌-民權,2024-01-31,9312
2369,菱生,26,12,14,華南永昌-民權,2024-01-31,9312
3652,精聯,13,0,13,華南永昌-民權,2024-01-31,9312
00696B,富邦美債20年,12,0,12,華南永昌-民權,2024-01-31,9312
3041,揚智,32,21,11,華南永昌-民權,2024-01-31,9312
2330,台積電,18,8,10,華南永昌-民權,2024-01-31,9312
00725B,國泰投資級公司債,10,0,10,華南永昌-民權,2024-01-31,9312
00720B,元大投資級公司債,10,0,10,華南永昌-民權,2024-01-31,9312
00857B,永豐20年美公債,10,0,10,華南永昌-民權,2024-01-31,9312
3232,昱捷,10,0,10,華南永昌-民權,2024-01-31,9312
4543,萬在,10,0,10,華南永昌-民權,2024-01-31,9312
00795B,中信美國公債20年,9,0,9,華南永昌-民權,2024-01-31,9312
3363,上詮,9,0,9,華南永昌-民權,2024-01-31,9312
4979,華星光,10,1,9,華南永昌-民權,2024-01-31,9312
1101,台泥,12,4,8,華南永昌-民權,2024-01-31,9312
3450,聯鈞,8,0,8,華南永昌-民權,2024-01-31,9312
00764B,群益25年美債,7,0,7,華南永昌-民權,2024-01-31,9312
00877,復華中國5G,7,0,7,華南永昌-民權,2024-01-31,9312
00679B,元大美債20年,8,1,7,華南永昌-民權,2024-01-31,9312
8437,大地-KY,7,0,7,華南永昌-民權,2024-01-31,9312
2449,京元電子,8,1,7,華南永昌-民權,2024-01-31,9312
3360,尚立,8,2,6,華南永昌-民權,2024-01-31,9312
3623,富晶通,7,1,6,華南永昌-民權,2024-01-31,9312
6425,易發,22,16,6,華南永昌-民權,2024-01-31,9312
6770,力積電,36,30,6,華南永昌-民權,2024-01-31,9312
9919,康那香,7,1,6,華南永昌-民權,2024-01-31,9312
2353,宏��,8,2,6,華南永昌-民權,2024-01-31,9312
00631L,元大台灣50正2,6,1,5,華南永昌-民權,2024-01-31,9312
00929,復華台灣科技優息,5,0,5,華南永昌-民權,2024-01-31,9312
00633L,富邦上証正2,5,0,5,華南永昌-民權,2024-01-31,9312
00688L,國泰20年美債正2,5,0,5,華南永昌-民權,2024-01-31,9312
00687B,國泰20年美債,5,0,5,華南永昌-民權,2024-01-31,9312
2820,華票,5,0,5,華南永昌-民權,2024-01-31,9312
00919,群益台灣精選高息,4,0,4,華南永昌-民權,2024-01-31,9312
2356,英業達,8,4,4,華南永昌-民權,2024-01-31,9312
1301,台塑,4,0,4,華南永昌-民權,2024-01-31,9312
1312,國喬,900,0,900,華南永昌-民權,2024-02-01,9312
00937B,群益ESG投等債20,140,30,110,華南永昌-民權,2024-02-01,9312
1503,士電,80,26,54,華南永昌-民權,2024-02-01,9312
00712,復華富時不動產,50,0,50,華南永昌-民權,2024-02-01,9312
9924,福興,50,0,50,華南永昌-民權,2024-02-01,9312
00929,復華台灣科技優息,36,2,34,華南永昌-民權,2024-02-01,9312
6485,點序,31,0,31,華南永昌-民權,2024-02-01,9312
6465,威潤,20,0,20,華南永昌-民權,2024-02-01,9312
2461,光群雷,20,0,20,華南永昌-民權,2024-02-01,9312
6152,百一,20,0,20,華南永昌-民權,2024-02-01,9312
3652,精聯,19,0,19,華南永昌-民權,2024-02-01,9312
00935,野村臺灣新科技50,15,0,15,華南永昌-民權,2024-02-01,9312
00919,群益台灣精選高息,13,0,13,華南永昌-民權,2024-02-01,9312
8096,擎亞,12,0,12,華南永昌-民權,2024-02-01,9312
2834,臺企銀,12,0,12,華南永昌-民權,2024-02-01,9312
2360,致茂,11,0,11,華南永昌-民權,2024-02-01,9312
2409,友達,16,5,11,華南永昌-民權,2024-02-01,9312
5512,力麒,12,1,11,華南永昌-民權,2024-02-01,9312
8916,光隆,10,0,10,華南永昌-民權,2024-02-01,9312
2382,廣達,8,0,8,華南永昌-民權,2024-02-01,9312
2348A,海悅甲特,7,0,7,華南永昌-民權,2024-02-01,9312
3050,鈺德,7,0,7,華南永昌-民權,2024-02-01,9312
3545,敦泰,7,0,7,華南永昌-民權,2024-02-01,9312
9919,康那香,14,7,7,華南永昌-民權,2024-02-01,9312
2812,台中銀,26,19,7,華南永昌-民權,2024-02-01,9312
3481,群創,20,14,6,華南永昌-民權,2024-02-01,9312
3055,蔚華科,11,5,6,華南永昌-民權,2024-02-01,9312
00878,國泰永續高股息,5,0,5,華南永昌-民權,2024-02-01,9312
2329,華泰,7,2,5,華南永昌-民權,2024-02-01,9312
4960,誠美材,5,0,5,華南永昌-民權,2024-02-01,9312
00881,國泰台灣5G+,5,0,5,華南永昌-民權,2024-02-01,9312
2258,鴻華先進-創,5,0,5,華南永昌-民權,2024-02-01,9312
2337,旺宏,6,1,5,華南永昌-民權,2024-02-01,9312
3380,明泰,5,0,5,華南永昌-民權,2024-02-01,9312
3390,旭軟,5,0,5,華南永昌-民權,2024-02-01,9312
4712,福格創新,5,0,5,華南永昌-民權,2024-02-01,9312
6112,邁達特,5,0,5,華南永昌-民權,2024-02-01,9312
6716,應廣,16,11,5,華南永昌-民權,2024-02-01,9312
6163,華電網,5,0,5,華南永昌-民權,2024-02-01,9312
2615,萬海,4,0,4,華南永昌-民權,2024-02-01,9312
1582,信錦,4,0,4,華南永昌-民權,2024-02-01,9312
2467,志聖,4,0,4,華南永昌-民權,2024-02-01,9312
8089,康全電訊,4,0,4,華南永昌-民權,2024-02-01,9312
3615,安可,4,1,3,華南永昌-民權,2024-02-01,9312
8110,華東,3,0,3,華南永昌-民權,2024-02-01,9312
1514,亞力,3,0,3,華南永昌-民權,2024-02-01,9312
2486,一詮,3,0,3,華南永昌-民權,2024-02-01,9312
3207,耀勝,3,0,3,華南永昌-民權,2024-02-01,9312
3362,先進光,4,1,3,華南永昌-民權,2024-02-01,9312
3666,光耀,3,0,3,華南永昌-民權,2024-02-01,9312
00637L,元大滬深300正2,202,100,102,華南永昌-民權,2024-02-02,9312
9924,福興,100,0,100,華南永昌-民權,2024-02-02,9312
6139,亞翔,91,30,61,華南永昌-民權,2024-02-02,9312
2324,仁寶,60,0,60,華南永昌-民權,2024-02-02,9312
2303,聯電,47,0,47,華南永昌-民權,2024-02-02,9312
00933B,國泰10Y+金融債,46,0,46,華南永昌-民權,2024-02-02,9312
00632R,元大台灣50反1,30,0,30,華南永昌-民權,2024-02-02,9312
00753L,中信中國50正2,30,0,30,華南永昌-民權,2024-02-02,9312
1316,上曜,30,0,30,華南永昌-民權,2024-02-02,9312
2017,官田鋼,30,0,30,華南永昌-民權,2024-02-02,9312
00927,群益半導體收益,26,0,26,華南永昌-民權,2024-02-02,9312
00937B,群益ESG投等債20,33,8,25,華南永昌-民權,2024-02-02,9312
1101,台泥,22,0,22,華南永昌-民權,2024-02-02,9312
6485,點序,22,0,22,華南永昌-民權,2024-02-02,9312
8916,光隆,21,0,21,華南永昌-民權,2024-02-02,9312
4174,浩鼎,20,0,20,華南永昌-民權,2024-02-02,9312
3481,群創,30,10,20,華南永昌-民權,2024-02-02,9312
3402,漢科,20,2,18,華南永昌-民權,2024-02-02,9312
8936,國統,17,0,17,華南永昌-民權,2024-02-02,9312
2618,長榮航,17,0,17,華南永昌-民權,2024-02-02,9312
2609,陽明,15,0,15,華南永昌-民權,2024-02-02,9312
00904,新光臺灣半導體30,14,0,14,華南永昌-民權,2024-02-02,9312
00712,復華富時不動產,13,0,13,華南永昌-民權,2024-02-02,9312
8437,大地-KY,13,0,13,華南永昌-民權,2024-02-02,9312
3443,創意,15,2,13,華南永昌-民權,2024-02-02,9312
00929,復華台灣科技優息,27,17,10,華南永昌-民權,2024-02-02,9312
2103,台橡,10,0,10,華南永昌-民權,2024-02-02,9312
2537,聯上發,12,2,10,華南永昌-民權,2024-02-02,9312
2889,國票金,10,0,10,華南永昌-民權,2024-02-02,9312
3652,精聯,10,0,10,華南永昌-民權,2024-02-02,9312
4123,晟德,10,0,10,華南永昌-民權,2024-02-02,9312
5340,建榮,10,0,10,華南永昌-民權,2024-02-02,9312
8436,大江,10,0,10,華南永昌-民權,2024-02-02,9312
3338,泰碩,9,0,9,華南永昌-民權,2024-02-02,9312
5383,金利,9,0,9,華南永昌-民權,2024-02-02,9312
8074,鉅橡,9,0,9,華南永昌-民權,2024-02-02,9312
2317,鴻海,8,0,8,華南永昌-民權,2024-02-02,9312
00679B,元大美債20年,13,5,8,華南永昌-民權,2024-02-02,9312
3013,晟銘電,12,4,8,華南永昌-民權,2024-02-02,9312
4188,安克,8,0,8,華南永昌-民權,2024-02-02,9312
2313,華通,8,1,7,華南永昌-民權,2024-02-02,9312
3694,海華,7,0,7,華南永昌-民權,2024-02-02,9312
6834,天二科技,7,0,7,華南永昌-民權,2024-02-02,9312
6841,長佳智能,7,0,7,華南永昌-民權,2024-02-02,9312
8227,巨有科技,8,2,6,華南永昌-民權,2024-02-02,9312
1582,信錦,6,0,6,華南永昌-民權,2024-02-02,9312
00725B,國泰投資級公司債,5,0,5,華南永昌-民權,2024-02-02,9312
2613,中櫃,5,0,5,華南永昌-民權,2024-02-02,9312
4549,桓達,5,0,5,華南永昌-民權,2024-02-02,9312
6165,浪凡,6,1,5,華南永昌-民權,2024-02-02,9312
1312,國喬,285,16,269,華南永昌-民權,2024-02-05,9312
00929,復華台灣科技優息,224,0,224,華南永昌-民權,2024-02-05,9312
9924,福興,100,0,100,華南永昌-民權,2024-02-05,9312
3402,漢科,85,0,85,華南永昌-民權,2024-02-05,9312
00937B,群益ESG投等債20,52,0,52,華南永昌-民權,2024-02-05,9312
5340,建榮,50,0,50,華南永昌-民權,2024-02-05,9312
2881,富邦金,50,1,49,華南永昌-民權,2024-02-05,9312
00687B,國泰20年美債,59,15,44,華南永昌-民權,2024-02-05,9312
00919,群益台灣精選高息,43,0,43,華南永昌-民權,2024-02-05,9312
00753L,中信中國50正2,40,0,40,華南永昌-民權,2024-02-05,9312
8936,國統,39,0,39,華南永昌-民權,2024-02-05,9312
00878,國泰永續高股息,60,24,36,華南永昌-民權,2024-02-05,9312
00933B,國泰10Y+金融債,35,0,35,華南永昌-民權,2024-02-05,9312
2454,聯發科,31,0,31,華南永昌-民權,2024-02-05,9312
6139,亞翔,30,0,30,華南永昌-民權,2024-02-05,9312
00795B,中信美國公債20年,27,0,27,華南永昌-民權,2024-02-05,9312
4712,福格創新,20,0,20,華南永昌-民權,2024-02-05,9312
2887,台新金,23,4,19,華南永昌-民權,2024-02-05,9312
8064,東捷,22,3,19,華南永昌-民權,2024-02-05,9312
3520,華盈,17,0,17,華南永昌-民權,2024-02-05,9312
2883,凱基金,15,0,15,華南永昌-民權,2024-02-05,9312
2618,長榮航,15,1,14,華南永昌-民權,2024-02-05,9312
00680L,元大美債20正2,12,0,12,華南永昌-民權,2024-02-05,9312
6265,方土昶,12,0,12,華南永昌-民權,2024-02-05,9312
8054,安國,12,0,12,華南永昌-民權,2024-02-05,9312
00679B,元大美債20年,11,0,11,華南永昌-民權,2024-02-05,9312
00688L,國泰20年美債正2,11,0,11,華南永昌-民權,2024-02-05,9312
2915,潤泰全,11,0,11,華南永昌-民權,2024-02-05,9312
00764B,群益25年美債,10,0,10,華南永昌-民權,2024-02-05,9312
2498,宏達電,10,0,10,華南永昌-民權,2024-02-05,9312
3652,精聯,10,0,10,華南永昌-民權,2024-02-05,9312
6113,亞矽,11,1,10,華南永昌-民權,2024-02-05,9312
6179,亞通,10,0,10,華南永昌-民權,2024-02-05,9312
1618,合機,11,2,9,華南永昌-民權,2024-02-05,9312
9105,泰金寶-DR,9,0,9,華南永昌-民權,2024-02-05,9312
00696B,富邦美債20年,8,0,8,華南永昌-民權,2024-02-05,9312
1301,台塑,8,0,8,華南永昌-民權,2024-02-05,9312
2303,聯電,14,7,7,華南永昌-民權,2024-02-05,9312
4931,新盛力,7,0,7,華南永昌-民權,2024-02-05,9312
8096,擎亞,7,0,7,華南永昌-民權,2024-02-05,9312
2457,飛宏,7,1,6,華南永昌-民權,2024-02-05,9312
00715L,期街口布蘭特正2,6,0,6,華南永昌-民權,2024-02-05,9312
2537,聯上發,6,0,6,華南永昌-民權,2024-02-05,9312
2886,兆豐金,6,0,6,華南永昌-民權,2024-02-05,9312
3041,揚智,16,10,6,華南永昌-民權,2024-02-05,9312
6841,長佳智能,6,0,6,華南永昌-民權,2024-02-05,9312
1303,南亞,5,0,5,華南永昌-民權,2024-02-05,9312
8210,勤誠,7,2,5,華南永昌-民權,2024-02-05,9312
00633L,富邦上証正2,5,0,5,華南永昌-民權,2024-02-05,9312
2027,大成鋼,5,0,5,華南永昌-民權,2024-02-05,9312
2367,燿華,125,0,125,華南永昌-民權,2024-02-15,9312
2344,華邦電,118,4,114,華南永昌-民權,2024-02-15,9312
2356,英業達,276,169,107,華南永昌-民權,2024-02-15,9312
00929,復華台灣科技優息,116,15,101,華南永昌-民權,2024-02-15,9312
00937B,群益ESG投等債20,86,4,82,華南永昌-民權,2024-02-15,9312
00680L,元大美債20正2,75,0,75,華南永昌-民權,2024-02-15,9312
00631L,元大台灣50正2,69,0,69,華南永昌-民權,2024-02-15,9312
2101,南港,50,0,50,華南永昌-民權,2024-02-15,9312
00933B,國泰10Y+金融債,51,2,49,華南永昌-民權,2024-02-15,9312
00712,復華富時不動產,43,0,43,華南永昌-民權,2024-02-15,9312
2834,臺企銀,40,0,40,華南永昌-民權,2024-02-15,9312
1303,南亞,35,0,35,華南永昌-民權,2024-02-15,9312
6127,九豪,35,1,34,華南永昌-民權,2024-02-15,9312
2017,官田鋼,144,115,29,華南永昌-民權,2024-02-15,9312
3312,弘憶股,32,4,28,華南永昌-民權,2024-02-15,9312
6443,元晶,27,0,27,華南永昌-民權,2024-02-15,9312
2454,聯發科,26,1,25,華南永昌-民權,2024-02-15,9312
3481,群創,49,25,24,華南永昌-民權,2024-02-15,9312
2618,長榮航,22,2,20,華南永昌-民權,2024-02-15,9312
2324,仁寶,27,8,19,華南永昌-民權,2024-02-15,9312
00679B,元大美債20年,18,0,18,華南永昌-民權,2024-02-15,9312
00751B,元大AAA至A公司債,18,0,18,華南永昌-民權,2024-02-15,9312
2915,潤泰全,16,0,16,華南永昌-民權,2024-02-15,9312
6179,亞通,15,0,15,華南永昌-民權,2024-02-15,9312
6229,研通,29,14,15,華南永昌-民權,2024-02-15,9312
2408,南亞科,14,0,14,華南永昌-民權,2024-02-15,9312
4760,勤凱,12,0,12,華南永昌-民權,2024-02-15,9312
00725B,國泰投資級公司債,11,0,11,華南永昌-民權,2024-02-15,9312
00795B,中信美國公債20年,11,0,11,華南永昌-民權,2024-02-15,9312
3360,尚立,20,9,11,華南永昌-民權,2024-02-15,9312
00764B,群益25年美債,10,0,10,華南永昌-民權,2024-02-15,9312
00673R,期元大S＆P原油反1,10,0,10,華南永昌-民權,2024-02-15,9312
00696B,富邦美債20年,10,0,10,華南永昌-民權,2024-02-15,9312
00632R,元大台灣50反1,10,0,10,華南永昌-民權,2024-02-15,9312
1616,億泰,10,0,10,華南永昌-民權,2024-02-15,9312
1711,永光,10,0,10,華南永昌-民權,2024-02-15,9312
2515,中工,10,0,10,華南永昌-民權,2024-02-15,9312
4188,安克,10,0,10,華南永昌-民權,2024-02-15,9312
4942,嘉彰,10,0,10,華南永昌-民權,2024-02-15,9312
5521,工信,20,10,10,華南永昌-民權,2024-02-15,9312
6164,華興,11,1,10,華南永昌-民權,2024-02-15,9312
2537,聯上發,11,2,9,華南永昌-民權,2024-02-15,9312
2301,光寶科,10,1,9,華南永昌-民權,2024-02-15,9312
2002,中鋼,7,0,7,華南永昌-民權,2024-02-15,9312
6488,環球晶,7,0,7,華南永昌-民權,2024-02-15,9312
00882,中信中國高股息,7,0,7,華南永昌-民權,2024-02-15,9312
6269,台郡,7,0,7,華南永昌-民權,2024-02-15,9312
2464,盟立,26,20,6,華南永昌-民權,2024-02-15,9312
1514,亞力,6,1,5,華南永昌-民權,2024-02-15,9312
8064,東捷,5,0,5,華南永昌-民權,2024-02-15,9312
2101,南港,250,0,250,華南永昌-民權,2024-02-16,9312
2834,臺企銀,205,0,205,華南永昌-民權,2024-02-16,9312
00929,復華台灣科技優息,163,8,155,華南永昌-民權,2024-02-16,9312
9924,福興,100,0,100,華南永昌-民權,2024-02-16,9312
3715,定穎投控,51,0,51,華南永昌-民權,2024-02-16,9312
8436,大江,40,0,40,華南永昌-民權,2024-02-16,9312
2017,官田鋼,101,65,36,華南永昌-民權,2024-02-16,9312
00933B,國泰10Y+金融債,34,1,33,華南永昌-民權,2024-02-16,9312
8011,台通,31,0,31,華南永昌-民權,2024-02-16,9312
3055,蔚華科,53,33,20,華南永昌-民權,2024-02-16,9312
4123,晟德,20,0,20,華南永昌-民權,2024-02-16,9312
6113,亞矽,24,4,20,華南永昌-民權,2024-02-16,9312
00795B,中信美國公債20年,18,0,18,華南永昌-民權,2024-02-16,9312
3231,緯創,23,9,14,華南永昌-民權,2024-02-16,9312
3711,日月光投控,16,2,14,華南永昌-民權,2024-02-16,9312
6269,台郡,14,0,14,華南永昌-民權,2024-02-16,9312
3006,晶豪科,13,0,13,華南永昌-民權,2024-02-16,9312
1319,東陽,14,2,12,華南永昌-民權,2024-02-16,9312
3294,英濟,12,0,12,華南永昌-民權,2024-02-16,9312
3481,群創,28,17,11,華南永昌-民權,2024-02-16,9312
2365,昆盈,14,3,11,華南永昌-民權,2024-02-16,9312
6695,芯鼎,19,8,11,華南永昌-民權,2024-02-16,9312
0056,元大高股息,30,20,10,華南永昌-民權,2024-02-16,9312
00937B,群益ESG投等債20,13,3,10,華南永昌-民權,2024-02-16,9312
2486,一詮,12,2,10,華南永昌-民權,2024-02-16,9312
3312,弘憶股,12,2,10,華南永昌-民權,2024-02-16,9312
3402,漢科,25,15,10,華南永昌-民權,2024-02-16,9312
8112,至上,10,0,10,華南永昌-民權,2024-02-16,9312
8916,光隆,10,0,10,華南永昌-民權,2024-02-16,9312
2330,台積電,14,4,10,華南永昌-民權,2024-02-16,9312
00919,群益台灣精選高息,11,2,9,華南永昌-民權,2024-02-16,9312
00687B,國泰20年美債,9,0,9,華南永昌-民權,2024-02-16,9312
00679B,元大美債20年,9,1,8,華南永昌-民權,2024-02-16,9312
2601,益航,8,0,8,華南永昌-民權,2024-02-16,9312
6229,研通,13,5,8,華南永昌-民權,2024-02-16,9312
2371,大同,8,1,7,華南永昌-民權,2024-02-16,9312
3360,尚立,17,10,7,華南永昌-民權,2024-02-16,9312
5328,華容,7,0,7,華南永昌-民權,2024-02-16,9312
3354,律勝,6,0,6,華南永昌-民權,2024-02-16,9312
00637L,元大滬深300正2,8,2,6,華南永昌-民權,2024-02-16,9312
00688L,國泰20年美債正2,11,5,6,華南永昌-民權,2024-02-16,9312
6235,華孚,7,1,6,華南永昌-民權,2024-02-16,9312
6274,台燿,10,4,6,華南永昌-民權,2024-02-16,9312
2382,廣達,10,5,5,華南永昌-民權,2024-02-16,9312
1101,台泥,5,0,5,華南永昌-民權,2024-02-16,9312
00773B,中信優先金融債,5,0,5,華南永昌-民權,2024-02-16,9312
00764B,群益25年美債,5,0,5,華南永昌-民權,2024-02-16,9312
1587,吉茂,5,0,5,華南永昌-民權,2024-02-16,9312
2206,三陽工業,6,1,5,華南永昌-民權,2024-02-16,9312
2633,台灣高鐵,5,0,5,華南永昌-民權,2024-02-16,9312
00929,復華台灣科技優息,202,19,183,華南永昌-民權,2024-02-19,9312
00650L,復華香港正2,70,0,70,華南永昌-民權,2024-02-19,9312
3715,定穎投控,52,3,49,華南永昌-民權,2024-02-19,9312
00937B,群益ESG投等債20,44,0,44,華南永昌-民權,2024-02-19,9312
00878,國泰永續高股息,45,5,40,華南永昌-民權,2024-02-19,9312
5457,宣德,33,1,32,華南永昌-民權,2024-02-19,9312
2355,敬鵬,51,20,31,華南永昌-民權,2024-02-19,9312
00919,群益台灣精選高息,35,4,31,華南永昌-民權,2024-02-19,9312
00687B,國泰20年美債,30,0,30,華南永昌-民權,2024-02-19,9312
8936,國統,25,0,25,華南永昌-民權,2024-02-19,9312
00753L,中信中國50正2,25,0,25,華南永昌-民權,2024-02-19,9312
2353,宏��,41,17,24,華南永昌-民權,2024-02-19,9312
3706,神達,30,7,23,華南永昌-民權,2024-02-19,9312
00936,台新永續高息中小,20,0,20,華南永昌-民權,2024-02-19,9312
1301,台塑,20,0,20,華南永昌-民權,2024-02-19,9312
1514,亞力,17,0,17,華南永昌-民權,2024-02-19,9312
00891,中信關鍵半導體,22,6,16,華南永昌-民權,2024-02-19,9312
00933B,國泰10Y+金融債,16,0,16,華南永昌-民權,2024-02-19,9312
2515,中工,22,6,16,華南永昌-民權,2024-02-19,9312
6443,元晶,18,3,15,華南永昌-民權,2024-02-19,9312
2417,圓剛,15,0,15,華南永昌-民權,2024-02-19,9312
6187,萬潤,15,0,15,華南永昌-民權,2024-02-19,9312
2329,華泰,28,13,15,華南永昌-民權,2024-02-19,9312
3268,海德威,18,4,14,華南永昌-民權,2024-02-19,9312
2610,華航,13,0,13,華南永昌-民權,2024-02-19,9312
6274,台燿,20,7,13,華南永昌-民權,2024-02-19,9312
4909,新復興,28,15,13,華南永昌-民權,2024-02-19,9312
2618,長榮航,13,1,12,華南永昌-民權,2024-02-19,9312
1616,億泰,12,0,12,華南永昌-民權,2024-02-19,9312
2356,英業達,12,1,11,華南永昌-民權,2024-02-19,9312
6668,中揚光,33,22,11,華南永昌-民權,2024-02-19,9312
2454,聯發科,30,20,10,華南永昌-民權,2024-02-19,9312
1608,華榮,10,0,10,華南永昌-民權,2024-02-19,9312
5340,建榮,10,0,10,華南永昌-民權,2024-02-19,9312
6016,康和證,10,0,10,華南永昌-民權,2024-02-19,9312
4979,華星光,16,7,9,華南永昌-民權,2024-02-19,9312
2365,昆盈,42,33,9,華南永昌-民權,2024-02-19,9312
6282,康舒,10,1,9,華南永昌-民權,2024-02-19,9312
3035,智原,9,1,8,華南永昌-民權,2024-02-19,9312
2363,矽統,10,2,8,華南永昌-民權,2024-02-19,9312
2457,飛宏,17,9,8,華南永昌-民權,2024-02-19,9312
6789,采鈺,15,8,7,華南永昌-民權,2024-02-19,9312
2303,聯電,7,0,7,華南永昌-民權,2024-02-19,9312
5347,世界,8,1,7,華南永昌-民權,2024-02-19,9312
00679B,元大美債20年,6,0,6,華南永昌-民權,2024-02-19,9312
1905,華紙,6,0,6,華南永昌-民權,2024-02-19,9312
2007,燁興,7,1,6,華南永昌-民權,2024-02-19,9312
2367,燿華,6,0,6,華南永昌-民權,2024-02-19,9312
2382,廣達,7,2,5,華南永昌-民權,2024-02-19,9312
00680L,元大美債20正2,5,0,5,華南永昌-民權,2024-02-19,9312
2610,華航,223,0,223,華南永昌-民權,2024-02-20,9312
6120,達運,83,0,83,華南永昌-民權,2024-02-20,9312
2017,官田鋼,78,0,78,華南永昌-民權,2024-02-20,9312
3715,定穎投控,60,10,50,華南永昌-民權,2024-02-20,9312
00933B,國泰10Y+金融債,32,0,32,華南永昌-民權,2024-02-20,9312
6179,亞通,30,0,30,華南永昌-民權,2024-02-20,9312
8011,台通,29,1,28,華南永昌-民權,2024-02-20,9312
1806,冠軍,27,0,27,華南永昌-民權,2024-02-20,9312
3324,雙鴻,25,0,25,華南永昌-民權,2024-02-20,9312
2887,台新金,26,3,23,華南永昌-民權,2024-02-20,9312
00891,中信關鍵半導體,22,0,22,華南永昌-民權,2024-02-20,9312
1702,南僑,20,0,20,華南永昌-民權,2024-02-20,9312
5340,建榮,20,0,20,華南永昌-民權,2024-02-20,9312
9105,泰金寶-DR,21,1,20,華南永昌-民權,2024-02-20,9312
8110,華東,24,5,19,華南永昌-民權,2024-02-20,9312
3231,緯創,29,11,18,華南永昌-民權,2024-02-20,9312
1616,億泰,18,0,18,華南永昌-民權,2024-02-20,9312
2537,聯上發,17,0,17,華南永昌-民權,2024-02-20,9312
00680L,元大美債20正2,16,0,16,華南永昌-民權,2024-02-20,9312
4714,永捷,37,21,16,華南永昌-民權,2024-02-20,9312
1503,士電,19,5,14,華南永昌-民權,2024-02-20,9312
6282,康舒,13,2,11,華南永昌-民權,2024-02-20,9312
6485,點序,13,2,11,華南永昌-民權,2024-02-20,9312
2367,燿華,21,10,11,華南永昌-民權,2024-02-20,9312
2489,瑞軒,12,2,10,華南永昌-民權,2024-02-20,9312
2317,鴻海,13,3,10,華南永昌-民權,2024-02-20,9312
2498,宏達電,10,0,10,華南永昌-民權,2024-02-20,9312
5302,太欣,10,0,10,華南永昌-民權,2024-02-20,9312
8436,大江,10,0,10,華南永昌-民權,2024-02-20,9312
2504,國產,10,0,10,華南永昌-民權,2024-02-20,9312
3048,益登,10,0,10,華南永昌-民權,2024-02-20,9312
1522,堤維西,10,1,9,華南永昌-民權,2024-02-20,9312
2376,技嘉,8,1,7,華南永昌-民權,2024-02-20,9312
1560,中砂,7,0,7,華南永昌-民權,2024-02-20,9312
1316,上曜,10,3,7,華南永昌-民權,2024-02-20,9312
2369,菱生,10,3,7,華南永昌-民權,2024-02-20,9312
8033,雷虎,7,0,7,華南永昌-民權,2024-02-20,9312
2382,廣達,9,3,6,華南永昌-民權,2024-02-20,9312
1101,台泥,6,0,6,華南永昌-民權,2024-02-20,9312
00795B,中信美國公債20年,6,0,6,華南永昌-民權,2024-02-20,9312
3227,原相,6,0,6,華南永昌-民權,2024-02-20,9312
00919,群益台灣精選高息,10,4,6,華南永昌-民權,2024-02-20,9312
2886,兆豐金,10,4,6,華南永昌-民權,2024-02-20,9312
00937B,群益ESG投等債20,26,21,5,華南永昌-民權,2024-02-20,9312
00877,復華中國5G,5,0,5,華南永昌-民權,2024-02-20,9312
00679B,元大美債20年,5,0,5,華南永昌-民權,2024-02-20,9312
1742,台蠟,5,0,5,華南永昌-民權,2024-02-20,9312
3706,神達,7,2,5,華南永昌-民權,2024-02-20,9312
5202,力新,5,0,5,華南永昌-民權,2024-02-20,9312
6142,友勁,5,0,5,華南永昌-民權,2024-02-20,9312
00933B,國泰10Y+金融債,81,0,81,華南永昌-民權,2024-02-21,9312
2609,陽明,83,14,69,華南永昌-民權,2024-02-21,9312
2017,官田鋼,66,0,66,華南永昌-民權,2024-02-21,9312
00937B,群益ESG投等債20,61,0,61,華南永昌-民權,2024-02-21,9312
9924,福興,50,0,50,華南永昌-民權,2024-02-21,9312
2353,宏��,48,1,47,華南永昌-民權,2024-02-21,9312
2537,聯上發,47,0,47,華南永昌-民權,2024-02-21,9312
00878,國泰永續高股息,35,1,34,華南永昌-民權,2024-02-21,9312
3025,星通,31,2,29,華南永昌-民權,2024-02-21,9312
3481,群創,28,1,27,華南永昌-民權,2024-02-21,9312
3231,緯創,28,4,24,華南永昌-民權,2024-02-21,9312
00929,復華台灣科技優息,36,14,22,華南永昌-民權,2024-02-21,9312
5488,松普,26,4,22,華南永昌-民權,2024-02-21,9312
3372,典範,30,8,22,華南永昌-民權,2024-02-21,9312
00680L,元大美債20正2,21,0,21,華南永昌-民權,2024-02-21,9312
2303,聯電,18,0,18,華南永昌-民權,2024-02-21,9312
2515,中工,17,0,17,華南永昌-民權,2024-02-21,9312
5443,均豪,18,2,16,華南永昌-民權,2024-02-21,9312
6116,彩晶,15,0,15,華南永昌-民權,2024-02-21,9312
6282,康舒,15,0,15,華南永昌-民權,2024-02-21,9312
2367,燿華,12,0,12,華南永昌-民權,2024-02-21,9312
3715,定穎投控,12,0,12,華南永昌-民權,2024-02-21,9312
6189,豐藝,12,0,12,華南永昌-民權,2024-02-21,9312
3035,智原,18,7,11,華南永昌-民權,2024-02-21,9312
00904,新光臺灣半導體30,10,0,10,華南永昌-民權,2024-02-21,9312
00688L,國泰20年美債正2,10,0,10,華南永昌-民權,2024-02-21,9312
1506,正道,10,0,10,華南永昌-民權,2024-02-21,9312
6152,百一,10,0,10,華南永昌-民權,2024-02-21,9312
8916,光隆,10,0,10,華南永昌-民權,2024-02-21,9312
1524,耿鼎,11,2,9,華南永昌-民權,2024-02-21,9312
8087,麗升能源,10,1,9,華南永昌-民權,2024-02-21,9312
6226,光鼎,10,1,9,華南永昌-民權,2024-02-21,9312
2312,金寶,29,21,8,華南永昌-民權,2024-02-21,9312
4979,華星光,11,3,8,華南永昌-民權,2024-02-21,9312
6170,統振,8,0,8,華南永昌-民權,2024-02-21,9312
8089,康全電訊,8,0,8,華南永昌-民權,2024-02-21,9312
2409,友達,7,0,7,華南永昌-民權,2024-02-21,9312
3041,揚智,7,0,7,華南永昌-民權,2024-02-21,9312
8171,天宇,7,0,7,華南永昌-民權,2024-02-21,9312
5381,合正,7,0,7,華南永昌-民權,2024-02-21,9312
2880,華南金,6,0,6,華南永昌-民權,2024-02-21,9312
3034,聯詠,5,0,5,華南永昌-民權,2024-02-21,9312
2401,凌陽,7,2,5,華南永昌-民權,2024-02-21,9312
00687B,國泰20年美債,5,0,5,華南永昌-民權,2024-02-21,9312
1319,東陽,5,0,5,華南永昌-民權,2024-02-21,9312
1618,合機,5,0,5,華南永昌-民權,2024-02-21,9312
1752,南光,6,1,5,華南永昌-民權,2024-02-21,9312
1815,富喬,6,1,5,華南永昌-民權,2024-02-21,9312
2723,美食-KY,5,0,5,華南永昌-民權,2024-02-21,9312
3290,東浦,5,0,5,華南永昌-民權,2024-02-21,9312
1303,南亞,48,0,48,華南永昌-民權,2024-02-22,9312
2017,官田鋼,45,0,45,華南永昌-民權,2024-02-22,9312
1337,再生-KY,44,0,44,華南永昌-民權,2024-02-22,9312
8086,宏捷科,43,1,42,華南永昌-民權,2024-02-22,9312
9105,泰金寶-DR,48,11,37,華南永昌-民權,2024-02-22,9312
6285,啟��,80,49,31,華南永昌-民權,2024-02-22,9312
2329,華泰,38,8,30,華南永昌-民權,2024-02-22,9312
8436,大江,30,0,30,華南永昌-民權,2024-02-22,9312
5340,建榮,28,1,27,華南永昌-民權,2024-02-22,9312
2618,長榮航,27,1,26,華南永昌-民權,2024-02-22,9312
1316,上曜,27,4,23,華南永昌-民權,2024-02-22,9312
00706L,期元大S＆P日圓正2,20,0,20,華南永昌-民權,2024-02-22,9312
4105,東洋,20,0,20,華南永昌-民權,2024-02-22,9312
2371,大同,45,29,16,華南永昌-民權,2024-02-22,9312
3231,緯創,20,5,15,華南永昌-民權,2024-02-22,9312
3481,群創,32,18,14,華南永昌-民權,2024-02-22,9312
2353,宏��,26,13,13,華南永昌-民權,2024-02-22,9312
00687B,國泰20年美債,15,2,13,華南永昌-民權,2024-02-22,9312
00937B,群益ESG投等債20,13,0,13,華南永昌-民權,2024-02-22,9312
3715,定穎投控,13,1,12,華南永昌-民權,2024-02-22,9312
2356,英業達,18,6,12,華南永昌-民權,2024-02-22,9312
1514,亞力,14,3,11,華南永昌-民權,2024-02-22,9312
2537,聯上發,11,0,11,華南永昌-民權,2024-02-22,9312
2027,大成鋼,10,0,10,華南永昌-民權,2024-02-22,9312
00795B,中信美國公債20年,10,0,10,華南永昌-民權,2024-02-22,9312
1312,國喬,10,0,10,華南永昌-民權,2024-02-22,9312
6116,彩晶,10,0,10,華南永昌-民權,2024-02-22,9312
8011,台通,10,0,10,華南永昌-民權,2024-02-22,9312
8112,至上,10,0,10,華南永昌-民權,2024-02-22,9312
4979,華星光,11,2,9,華南永昌-民權,2024-02-22,9312
3363,上詮,11,2,9,華南永昌-民權,2024-02-22,9312
3689,湧德,12,3,9,華南永昌-民權,2024-02-22,9312
1524,耿鼎,9,0,9,華南永昌-民權,2024-02-22,9312
3047,訊舟,8,0,8,華南永昌-民權,2024-02-22,9312
00891,中信關鍵半導體,8,1,7,華南永昌-民權,2024-02-22,9312
00927,群益半導體收益,7,0,7,華南永昌-民權,2024-02-22,9312
5443,均豪,24,17,7,華南永昌-民權,2024-02-22,9312
8936,國統,7,1,6,華南永昌-民權,2024-02-22,9312
1101,台泥,6,0,6,華南永昌-民權,2024-02-22,9312
1319,東陽,10,4,6,華南永昌-民權,2024-02-22,9312
2489,瑞軒,11,5,6,華南永昌-民權,2024-02-22,9312
3059,華晶科,7,1,6,華南永昌-民權,2024-02-22,9312
3437,榮創,6,0,6,華南永昌-民權,2024-02-22,9312
3576,聯合再生,7,1,6,華南永昌-民權,2024-02-22,9312
6451,訊芯-KY,19,13,6,華南永昌-民權,2024-02-22,9312
6530,創威,7,1,6,華南永昌-民權,2024-02-22,9312
6799,來頡,6,0,6,華南永昌-民權,2024-02-22,9312
5381,合正,12,6,6,華南永昌-民權,2024-02-22,9312
2376,技嘉,10,5,5,華南永昌-民權,2024-02-22,9312
3711,日月光投控,5,0,5,華南永昌-民權,2024-02-22,9312
00937B,群益ESG投等債20,386,0,386,華南永昌-民權,2024-02-23,9312
1303,南亞,59,0,59,華南永昌-民權,2024-02-23,9312
5340,建榮,54,2,52,華南永昌-民權,2024-02-23,9312
3715,定穎投控,51,0,51,華南永昌-民權,2024-02-23,9312
2618,長榮航,51,1,50,華南永昌-民權,2024-02-23,9312
6141,柏承,50,0,50,華南永昌-民權,2024-02-23,9312
6285,啟��,52,4,48,華南永昌-民權,2024-02-23,9312
00933B,國泰10Y+金融債,47,6,41,華南永昌-民權,2024-02-23,9312
8086,宏捷科,30,1,29,華南永昌-民權,2024-02-23,9312
8936,國統,24,2,22,華南永昌-民權,2024-02-23,9312
00650L,復華香港正2,20,0,20,華南永昌-民權,2024-02-23,9312
1312,國喬,20,0,20,華南永昌-民權,2024-02-23,9312
8436,大江,20,0,20,華南永昌-民權,2024-02-23,9312
2903,遠百,19,0,19,華南永昌-民權,2024-02-23,9312
1815,富喬,19,4,15,華南永昌-民權,2024-02-23,9312
2367,燿華,21,6,15,華南永昌-民權,2024-02-23,9312
8354,冠好,15,0,15,華南永昌-民權,2024-02-23,9312
2356,英業達,24,11,13,華南永昌-民權,2024-02-23,9312
3013,晟銘電,12,0,12,華南永昌-民權,2024-02-23,9312
00679B,元大美債20年,10,0,10,華南永昌-民權,2024-02-23,9312
00664R,國泰臺灣加權反1,10,0,10,華南永昌-民權,2024-02-23,9312
2359,所羅門,10,0,10,華南永昌-民權,2024-02-23,9312
6179,亞通,10,0,10,華南永昌-民權,2024-02-23,9312
9105,泰金寶-DR,10,0,10,華南永昌-民權,2024-02-23,9312
1301,台塑,10,0,10,華南永昌-民權,2024-02-23,9312
3231,緯創,22,12,10,華南永昌-民權,2024-02-23,9312
2498,宏達電,10,1,9,華南永昌-民權,2024-02-23,9312
4760,勤凱,9,0,9,華南永昌-民權,2024-02-23,9312
00927,群益半導體收益,9,1,8,華南永昌-民權,2024-02-23,9312
6442,光聖,13,5,8,華南永昌-民權,2024-02-23,9312
2891,中信金,8,1,7,華南永昌-民權,2024-02-23,9312
3081,聯亞,27,20,7,華南永昌-民權,2024-02-23,9312
3372,典範,7,0,7,華南永昌-民權,2024-02-23,9312
6257,矽格,10,3,7,華南永昌-民權,2024-02-23,9312
5388,中磊,13,7,6,華南永昌-民權,2024-02-23,9312
1536,和大,8,2,6,華南永昌-民權,2024-02-23,9312
2002,中鋼,7,1,6,華南永昌-民權,2024-02-23,9312
2601,益航,12,6,6,華南永昌-民權,2024-02-23,9312
2609,陽明,15,9,6,華南永昌-民權,2024-02-23,9312
2884,玉山金,6,0,6,華南永昌-民權,2024-02-23,9312
4939,亞電,6,0,6,華南永昌-民權,2024-02-23,9312
1752,南光,5,0,5,華南永昌-民權,2024-02-23,9312
2489,瑞軒,8,3,5,華南永昌-民權,2024-02-23,9312
2491,吉祥全,5,0,5,華南永昌-民權,2024-02-23,9312
2530,華建,5,0,5,華南永昌-民權,2024-02-23,9312
2610,華航,5,0,5,華南永昌-民權,2024-02-23,9312
3380,明泰,6,1,5,華南永昌-民權,2024-02-23,9312
3413,京鼎,6,1,5,華南永昌-民權,2024-02-23,9312
3483,力致,5,0,5,華南永昌-民權,2024-02-23,9312
4105,東洋,5,0,5,華南永昌-民權,2024-02-23,9312
2101,南港,250,0,250,華南永昌-民權,2024-02-26,9312
00937B,群益ESG投等債20,110,2,108,華南永昌-民權,2024-02-26,9312
2882,國泰金,63,0,63,華南永昌-民權,2024-02-26,9312
00915,凱基優選高股息30,50,0,50,華南永昌-民權,2024-02-26,9312
2845,遠東銀,50,0,50,華南永昌-民權,2024-02-26,9312
00891,中信關鍵半導體,51,3,48,華南永昌-民權,2024-02-26,9312
00929,復華台灣科技優息,71,23,48,華南永昌-民權,2024-02-26,9312
00919,群益台灣精選高息,56,15,41,華南永昌-民權,2024-02-26,9312
3715,定穎投控,42,1,41,華南永昌-民權,2024-02-26,9312
2492,華新科,30,0,30,華南永昌-民權,2024-02-26,9312
2836,高雄銀,30,0,30,華南永昌-民權,2024-02-26,9312
6179,亞通,30,0,30,華南永昌-民權,2024-02-26,9312
5452,佶優,26,2,24,華南永昌-民權,2024-02-26,9312
00878,國泰永續高股息,51,30,21,華南永昌-民權,2024-02-26,9312
00923,群益台ESG低碳50,20,0,20,華南永昌-民權,2024-02-26,9312
1471,首利,18,0,18,華南永昌-民權,2024-02-26,9312
2405,輔信,16,2,14,華南永昌-民權,2024-02-26,9312
2610,華航,12,0,12,華南永昌-民權,2024-02-26,9312
2892,第一金,12,0,12,華南永昌-民權,2024-02-26,9312
3607,谷崧,15,3,12,華南永昌-民權,2024-02-26,9312
8069,元太,11,0,11,華南永昌-民權,2024-02-26,9312
1101,台泥,12,1,11,華南永昌-民權,2024-02-26,9312
2303,聯電,12,1,11,華南永昌-民權,2024-02-26,9312
1513,中興電,19,8,11,華南永昌-民權,2024-02-26,9312
6164,華興,10,0,10,華南永昌-民權,2024-02-26,9312
00857B,永豐20年美公債,10,0,10,華南永昌-民權,2024-02-26,9312
00650L,復華香港正2,10,0,10,華南永昌-民權,2024-02-26,9312
2534,宏盛,10,0,10,華南永昌-民權,2024-02-26,9312
6411,晶焱,10,0,10,華南永昌-民權,2024-02-26,9312
00679B,元大美債20年,11,1,10,華南永昌-民權,2024-02-26,9312
1303,南亞,11,2,9,華南永昌-民權,2024-02-26,9312
2344,華邦電,10,1,9,華南永昌-民權,2024-02-26,9312
3706,神達,10,1,9,華南永昌-民權,2024-02-26,9312
6197,佳必琪,10,1,9,華南永昌-民權,2024-02-26,9312
8086,宏捷科,8,0,8,華南永昌-民權,2024-02-26,9312
00885,富邦越南,11,3,8,華南永昌-民權,2024-02-26,9312
4927,泰鼎-KY,12,4,8,華南永昌-民權,2024-02-26,9312
2301,光寶科,7,0,7,華南永昌-民權,2024-02-26,9312
2460,建通,10,3,7,華南永昌-民權,2024-02-26,9312
6770,力積電,7,0,7,華南永昌-民權,2024-02-26,9312
8299,群聯,7,0,7,華南永昌-民權,2024-02-26,9312
2449,京元電子,8,2,6,華南永昌-民權,2024-02-26,9312
2313,華通,9,3,6,華南永昌-民權,2024-02-26,9312
2888,新光金,6,0,6,華南永昌-民權,2024-02-26,9312
3234,光環,8,2,6,華南永昌-民權,2024-02-26,9312
3296,勝德,14,8,6,華南永昌-民權,2024-02-26,9312
4908,前鼎,16,10,6,華南永昌-民權,2024-02-26,9312
5236,凌陽創新,6,0,6,華南永昌-民權,2024-02-26,9312
6215,和椿,6,0,6,華南永昌-民權,2024-02-26,9312
6485,點序,6,0,6,華南永昌-民權,2024-02-26,9312
3078,僑威,305,4,301,華南永昌-民權,2024-02-27,9312
4123,晟德,200,0,200,華南永昌-民權,2024-02-27,9312
8916,光隆,80,0,80,華南永昌-民權,2024-02-27,9312
4105,東洋,75,0,75,華南永昌-民權,2024-02-27,9312
2301,光寶科,71,5,66,華南永昌-民權,2024-02-27,9312
00687B,國泰20年美債,64,0,64,華南永昌-民權,2024-02-27,9312
9924,福興,50,0,50,華南永昌-民權,2024-02-27,9312
2002,中鋼,43,1,42,華南永昌-民權,2024-02-27,9312
3265,台星科,44,4,40,華南永昌-民權,2024-02-27,9312
00878,國泰永續高股息,44,7,37,華南永昌-民權,2024-02-27,9312
8432,東生華,30,0,30,華南永昌-民權,2024-02-27,9312
00933B,國泰10Y+金融債,28,0,28,華南永昌-民權,2024-02-27,9312
3715,定穎投控,31,3,28,華南永昌-民權,2024-02-27,9312
00937B,群益ESG投等債20,24,0,24,華南永昌-民權,2024-02-27,9312
1727,中華化,26,5,21,華南永昌-民權,2024-02-27,9312
3037,欣興,27,7,20,華南永昌-民權,2024-02-27,9312
8011,台通,20,0,20,華南永昌-民權,2024-02-27,9312
8050,廣積,20,0,20,華南永昌-民權,2024-02-27,9312
00679B,元大美債20年,20,0,20,華南永昌-民權,2024-02-27,9312
00929,復華台灣科技優息,47,33,14,華南永昌-民權,2024-02-27,9312
00935,野村臺灣新科技50,27,13,14,華南永昌-民權,2024-02-27,9312
6113,亞矽,15,1,14,華南永昌-民權,2024-02-27,9312
1711,永光,27,14,13,華南永昌-民權,2024-02-27,9312
2618,長榮航,13,0,13,華南永昌-民權,2024-02-27,9312
00795B,中信美國公債20年,12,0,12,華南永昌-民權,2024-02-27,9312
1303,南亞,12,0,12,華南永昌-民權,2024-02-27,9312
2365,昆盈,13,1,12,華南永昌-民權,2024-02-27,9312
2303,聯電,13,1,12,華南永昌-民權,2024-02-27,9312
2498,宏達電,11,0,11,華南永昌-民權,2024-02-27,9312
5381,合正,11,0,11,華南永昌-民權,2024-02-27,9312
6274,台燿,10,0,10,華南永昌-民權,2024-02-27,9312
00680L,元大美債20正2,10,0,10,華南永昌-民權,2024-02-27,9312
00650L,復華香港正2,10,0,10,華南永昌-民權,2024-02-27,9312
1616,億泰,10,0,10,華南永昌-民權,2024-02-27,9312
3354,律勝,10,0,10,華南永昌-民權,2024-02-27,9312
3450,聯鈞,10,0,10,華南永昌-民權,2024-02-27,9312
8358,金居,10,0,10,華南永昌-民權,2024-02-27,9312
1319,東陽,10,1,9,華南永昌-民權,2024-02-27,9312
1717,長興,9,0,9,華南永昌-民權,2024-02-27,9312
8046,南電,9,1,8,華南永昌-民權,2024-02-27,9312
1316,上曜,9,2,7,華南永昌-民權,2024-02-27,9312
3231,緯創,18,11,7,華南永昌-民權,2024-02-27,9312
3033,威健,6,0,6,華南永昌-民權,2024-02-27,9312
5426,振發,6,0,6,華南永昌-民權,2024-02-27,9312
6488,環球晶,6,0,6,華南永昌-民權,2024-02-27,9312
6770,力積電,6,0,6,華南永昌-民權,2024-02-27,9312
5272,笙科,9,4,5,華南永昌-民權,2024-02-27,9312
00927,群益半導體收益,5,0,5,華南永昌-民權,2024-02-27,9312
1503,士電,8,3,5,華南永昌-民權,2024-02-27,9312
2312,金寶,11,6,5,華南永昌-民權,2024-02-27,9312
4123,晟德,201,0,201,華南永昌-民權,2024-02-29,9312
8432,東生華,85,0,85,華南永昌-民權,2024-02-29,9312
3715,定穎投控,62,1,61,華南永昌-民權,2024-02-29,9312
2454,聯發科,60,0,60,華南永昌-民權,2024-02-29,9312
00664R,國泰臺灣加權反1,50,0,50,華南永昌-民權,2024-02-29,9312
8916,光隆,40,0,40,華南永昌-民權,2024-02-29,9312
9105,泰金寶-DR,37,0,37,華南永昌-民權,2024-02-29,9312
2329,華泰,36,3,33,華南永昌-民權,2024-02-29,9312
2303,聯電,46,14,32,華南永昌-民權,2024-02-29,9312
2836,高雄銀,60,30,30,華南永昌-民權,2024-02-29,9312
3390,旭軟,50,21,29,華南永昌-民權,2024-02-29,9312
2845,遠東銀,28,0,28,華南永昌-民權,2024-02-29,9312
8926,台汽電,24,2,22,華南永昌-民權,2024-02-29,9312
00933B,國泰10Y+金融債,21,0,21,華南永昌-民權,2024-02-29,9312
2887,台新金,21,1,20,華南永昌-民權,2024-02-29,9312
00686R,群益臺灣加權反1,20,0,20,華南永昌-民權,2024-02-29,9312
1410,南染,20,0,20,華南永昌-民權,2024-02-29,9312
4549,桓達,20,0,20,華南永昌-民權,2024-02-29,9312
8927,北基,22,2,20,華南永昌-民權,2024-02-29,9312
2363,矽統,28,9,19,華南永昌-民權,2024-02-29,9312
6668,中揚光,18,1,17,華南永昌-民權,2024-02-29,9312
3363,上詮,52,37,15,華南永昌-民權,2024-02-29,9312
6417,韋僑,15,1,14,華南永昌-民權,2024-02-29,9312
6806,森崴能源,23,10,13,華南永昌-民權,2024-02-29,9312
2356,英業達,14,1,13,華南永昌-民權,2024-02-29,9312
6532,瑞耘,14,1,13,華南永昌-民權,2024-02-29,9312
5508,永信建,11,0,11,華南永昌-民權,2024-02-29,9312
2605,新興,11,1,10,華南永昌-民權,2024-02-29,9312
00902,中信電池及儲能,10,0,10,華南永昌-民權,2024-02-29,9312
00650L,復華香港正2,10,0,10,華南永昌-民權,2024-02-29,9312
00632R,元大台灣50反1,10,0,10,華南永昌-民權,2024-02-29,9312
1321,大洋,10,0,10,華南永昌-民權,2024-02-29,9312
1540,喬福,10,0,10,華南永昌-民權,2024-02-29,9312
1785,光洋科,10,0,10,華南永昌-民權,2024-02-29,9312
2367,燿華,12,2,10,華南永昌-民權,2024-02-29,9312
2431,聯昌,25,15,10,華南永昌-民權,2024-02-29,9312
3287,廣寰科,10,0,10,華南永昌-民權,2024-02-29,9312
9103,美德醫療-DR,10,0,10,華南永昌-民權,2024-02-29,9312
9904,寶成,10,0,10,華南永昌-民權,2024-02-29,9312
1101,台泥,11,1,10,華南永昌-民權,2024-02-29,9312
1303,南亞,10,0,10,華南永昌-民權,2024-02-29,9312
00918,大華優利高填息30,9,0,9,華南永昌-民權,2024-02-29,9312
3081,聯亞,9,0,9,華南永昌-民權,2024-02-29,9312
5443,均豪,9,0,9,華南永昌-民權,2024-02-29,9312
6288,聯嘉,24,15,9,華南永昌-民權,2024-02-29,9312
2495,普安,9,1,8,華南永昌-民權,2024-02-29,9312
2543,皇昌,8,0,8,華南永昌-民權,2024-02-29,9312
4543,萬在,10,2,8,華南永昌-民權,2024-02-29,9312
8011,台通,8,0,8,華南永昌-民權,2024-02-29,9312
4968,立積,7,0,7,華南永昌-民權,2024-02-29,9312
00919,群益台灣精選高息,174,22,152,華南永昌-民權,2024-03-01,9312
00918,大華優利高填息30,145,6,139,華南永昌-民權,2024-03-01,9312
5905,南仁湖,110,0,110,華南永昌-民權,2024-03-01,9312
00679B,元大美債20年,57,1,56,華南永昌-民權,2024-03-01,9312
00937B,群益ESG投等債20,47,0,47,華南永昌-民權,2024-03-01,9312
6285,啟��,46,0,46,華南永昌-民權,2024-03-01,9312
00680L,元大美債20正2,40,0,40,華南永昌-民權,2024-03-01,9312
1303,南亞,40,0,40,華南永昌-民權,2024-03-01,9312
00650L,復華香港正2,30,0,30,華南永昌-民權,2024-03-01,9312
00706L,期元大S＆P日圓正2,30,0,30,華南永昌-民權,2024-03-01,9312
2316,楠梓電,30,0,30,華南永昌-民權,2024-03-01,9312
8432,東生華,30,0,30,華南永昌-民權,2024-03-01,9312
2903,遠百,25,0,25,華南永昌-民權,2024-03-01,9312
5340,建榮,25,0,25,華南永昌-民權,2024-03-01,9312
2845,遠東銀,22,0,22,華南永昌-民權,2024-03-01,9312
3715,定穎投控,22,0,22,華南永昌-民權,2024-03-01,9312
2356,英業達,32,11,21,華南永昌-民權,2024-03-01,9312
00891,中信關鍵半導體,20,0,20,華南永昌-民權,2024-03-01,9312
2399,映泰,21,1,20,華南永昌-民權,2024-03-01,9312
1609,大亞,21,5,16,華南永昌-民權,2024-03-01,9312
1540,喬福,15,0,15,華南永昌-民權,2024-03-01,9312
2884,玉山金,18,3,15,華南永昌-民權,2024-03-01,9312
3066,李洲,15,0,15,華南永昌-民權,2024-03-01,9312
2355,敬鵬,12,0,12,華南永昌-民權,2024-03-01,9312
2369,菱生,22,10,12,華南永昌-民權,2024-03-01,9312
8011,台通,12,0,12,華南永昌-民權,2024-03-01,9312
2002,中鋼,20,9,11,華南永昌-民權,2024-03-01,9312
1605,華新,11,0,11,華南永昌-民權,2024-03-01,9312
2303,聯電,14,3,11,華南永昌-民權,2024-03-01,9312
00687B,國泰20年美債,10,0,10,華南永昌-民權,2024-03-01,9312
2506,太設,10,0,10,華南永昌-民權,2024-03-01,9312
2913,農林,10,0,10,華南永昌-民權,2024-03-01,9312
4108,懷特,10,0,10,華南永昌-民權,2024-03-01,9312
6143,振曜,10,0,10,華南永昌-民權,2024-03-01,9312
8916,光隆,10,0,10,華南永昌-民權,2024-03-01,9312
8927,北基,14,4,10,華南永昌-民權,2024-03-01,9312
3037,欣興,9,0,9,華南永昌-民權,2024-03-01,9312
6126,信音,21,13,8,華南永昌-民權,2024-03-01,9312
3265,台星科,14,6,8,華南永昌-民權,2024-03-01,9312
2609,陽明,12,5,7,華南永昌-民權,2024-03-01,9312
2727,王品,7,0,7,華南永昌-民權,2024-03-01,9312
6443,元晶,27,20,7,華南永昌-民權,2024-03-01,9312
2330,台積電,8,2,6,華南永昌-民權,2024-03-01,9312
3221,台嘉碩,6,0,6,華南永昌-民權,2024-03-01,9312
3264,欣銓,6,0,6,華南永昌-民權,2024-03-01,9312
6668,中揚光,6,0,6,華南永昌-民權,2024-03-01,9312
8105,凌巨,10,4,6,華南永昌-民權,2024-03-01,9312
1504,東元,8,2,6,華南永昌-民權,2024-03-01,9312
2707,晶華,5,0,5,華南永昌-民權,2024-03-01,9312
2313,華通,5,0,5,華南永昌-民權,2024-03-01,9312
2101,南港,150,0,150,華南永昌-民權,2024-03-04,9312
00918,大華優利高填息30,100,0,100,華南永昌-民權,2024-03-04,9312
5905,南仁湖,80,0,80,華南永昌-民權,2024-03-04,9312
6179,亞通,80,1,79,華南永昌-民權,2024-03-04,9312
5340,建榮,69,4,65,華南永昌-民權,2024-03-04,9312
0056,元大高股息,68,6,62,華南永昌-民權,2024-03-04,9312
00919,群益台灣精選高息,230,181,49,華南永昌-民權,2024-03-04,9312
4906,正文,56,8,48,華南永昌-民權,2024-03-04,9312
2845,遠東銀,42,0,42,華南永昌-民權,2024-03-04,9312
1410,南染,40,0,40,華南永昌-民權,2024-03-04,9312
2356,英業達,52,12,40,華南永昌-民權,2024-03-04,9312
00937B,群益ESG投等債20,38,0,38,華南永昌-民權,2024-03-04,9312
2002,中鋼,52,20,32,華南永昌-民權,2024-03-04,9312
00632R,元大台灣50反1,31,0,31,華南永昌-民權,2024-03-04,9312
2355,敬鵬,31,0,31,華南永昌-民權,2024-03-04,9312
00915,凱基優選高股息30,33,4,29,華南永昌-民權,2024-03-04,9312
6290,良維,32,9,23,華南永昌-民權,2024-03-04,9312
00687B,國泰20年美債,21,0,21,華南永昌-民權,2024-03-04,9312
2887,台新金,20,0,20,華南永昌-民權,2024-03-04,9312
4526,東台,17,0,17,華南永昌-民權,2024-03-04,9312
2301,光寶科,42,26,16,華南永昌-民權,2024-03-04,9312
2889,國票金,16,0,16,華南永昌-民權,2024-03-04,9312
3051,力特,13,0,13,華南永昌-民權,2024-03-04,9312
2312,金寶,16,3,13,華南永昌-民權,2024-03-04,9312
3062,建漢,13,0,13,華南永昌-民權,2024-03-04,9312
8926,台汽電,13,0,13,華南永昌-民權,2024-03-04,9312
1513,中興電,21,9,12,華南永昌-民權,2024-03-04,9312
2882,國泰金,12,0,12,華南永昌-民權,2024-03-04,9312
3044,健鼎,12,0,12,華南永昌-民權,2024-03-04,9312
00631L,元大台灣50正2,12,1,11,華南永昌-民權,2024-03-04,9312
9945,潤泰新,11,0,11,華南永昌-民權,2024-03-04,9312
3006,晶豪科,14,3,11,華南永昌-民權,2024-03-04,9312
00664R,國泰臺灣加權反1,10,0,10,華南永昌-民權,2024-03-04,9312
2601,益航,10,0,10,華南永昌-民權,2024-03-04,9312
3071,協禧,10,0,10,華南永昌-民權,2024-03-04,9312
3491,昇達科,12,2,10,華南永昌-民權,2024-03-04,9312
4956,光鋐,10,0,10,華南永昌-民權,2024-03-04,9312
5306,桂盟,10,0,10,華南永昌-民權,2024-03-04,9312
9103,美德醫療-DR,10,0,10,華南永昌-民權,2024-03-04,9312
1587,吉茂,9,0,9,華南永昌-民權,2024-03-04,9312
5388,中磊,15,7,8,華南永昌-民權,2024-03-04,9312
3356,奇偶,9,1,8,華南永昌-民權,2024-03-04,9312
2014,中鴻,7,0,7,華南永昌-民權,2024-03-04,9312
2460,建通,7,0,7,華南永昌-民權,2024-03-04,9312
3264,欣銓,11,4,7,華南永昌-民權,2024-03-04,9312
3625,西勝,7,0,7,華南永昌-民權,2024-03-04,9312
6015,宏遠證,7,0,7,華南永昌-民權,2024-03-04,9312
8401,白紗科,7,0,7,華南永昌-民權,2024-03-04,9312
00878,國泰永續高股息,11,5,6,華南永昌-民權,2024-03-04,9312
00679B,元大美債20年,6,0,6,華南永昌-民權,2024-03-04,9312
5905,南仁湖,145,0,145,華南永昌-民權,2024-03-05,9312
2356,英業達,160,43,117,華南永昌-民權,2024-03-05,9312
00882,中信中國高股息,111,0,111,華南永昌-民權,2024-03-05,9312
2355,敬鵬,83,0,83,華南永昌-民權,2024-03-05,9312
8916,光隆,65,0,65,華南永昌-民權,2024-03-05,9312
6443,元晶,71,10,61,華南永昌-民權,2024-03-05,9312
6179,亞通,59,0,59,華南永昌-民權,2024-03-05,9312
00687B,國泰20年美債,46,0,46,華南永昌-民權,2024-03-05,9312
2883,凱基金,45,0,45,華南永昌-民權,2024-03-05,9312
1409,新纖,55,11,44,華南永昌-民權,2024-03-05,9312
00929,復華台灣科技優息,45,12,33,華南永昌-民權,2024-03-05,9312
2365,昆盈,37,5,32,華南永昌-民權,2024-03-05,9312
00885,富邦越南,32,2,30,華南永昌-民權,2024-03-05,9312
1303,南亞,30,1,29,華南永昌-民權,2024-03-05,9312
00915,凱基優選高股息30,27,0,27,華南永昌-民權,2024-03-05,9312
00878,國泰永續高股息,31,6,25,華南永昌-民權,2024-03-05,9312
5340,建榮,25,0,25,華南永昌-民權,2024-03-05,9312
00919,群益台灣精選高息,37,13,24,華南永昌-民權,2024-03-05,9312
1326,台化,23,0,23,華南永昌-民權,2024-03-05,9312
00712,復華富時不動產,22,0,22,華南永昌-民權,2024-03-05,9312
8936,國統,24,2,22,華南永昌-民權,2024-03-05,9312
00688L,國泰20年美債正2,26,5,21,華南永昌-民權,2024-03-05,9312
2905,三商,20,0,20,華南永昌-民權,2024-03-05,9312
1410,南染,20,0,20,華南永昌-民權,2024-03-05,9312
3715,定穎投控,21,1,20,華南永昌-民權,2024-03-05,9312
8432,東生華,20,0,20,華南永昌-民權,2024-03-05,9312
2605,新興,19,1,18,華南永昌-民權,2024-03-05,9312
00937B,群益ESG投等債20,19,1,18,華南永昌-民權,2024-03-05,9312
2880,華南金,17,0,17,華南永昌-民權,2024-03-05,9312
6127,九豪,20,4,16,華南永昌-民權,2024-03-05,9312
8040,九暘,14,0,14,華南永昌-民權,2024-03-05,9312
8176,智捷,14,0,14,華南永昌-民權,2024-03-05,9312
8054,安國,14,1,13,華南永昌-民權,2024-03-05,9312
2834,臺企銀,12,0,12,華南永昌-民權,2024-03-05,9312
4973,廣穎,11,0,11,華南永昌-民權,2024-03-05,9312
00907,永豐優息存股,10,0,10,華南永昌-民權,2024-03-05,9312
00664R,國泰臺灣加權反1,10,0,10,華南永昌-民權,2024-03-05,9312
1718,中纖,10,0,10,華南永昌-民權,2024-03-05,9312
2359,所羅門,10,0,10,華南永昌-民權,2024-03-05,9312
3372,典範,22,12,10,華南永昌-民權,2024-03-05,9312
4105,東洋,10,0,10,華南永昌-民權,2024-03-05,9312
5315,光聯,10,0,10,華南永昌-民權,2024-03-05,9312
8926,台汽電,14,4,10,華南永昌-民權,2024-03-05,9312
3260,威剛,9,0,9,華南永昌-民權,2024-03-05,9312
8105,凌巨,10,1,9,華南永昌-民權,2024-03-05,9312
2888,新光金,8,0,8,華南永昌-民權,2024-03-05,9312
6505,台塑化,8,0,8,華南永昌-民權,2024-03-05,9312
2455,全新,9,1,8,華南永昌-民權,2024-03-05,9312
1503,士電,22,15,7,華南永昌-民權,2024-03-05,9312
1752,南光,7,0,7,華南永昌-民權,2024-03-05,9312
2834,臺企銀,500,2,498,華南永昌-民權,2024-03-06,9312
2356,英業達,414,59,355,華南永昌-民權,2024-03-06,9312
3005,神基,175,4,171,華南永昌-民權,2024-03-06,9312
5905,南仁湖,105,0,105,華南永昌-民權,2024-03-06,9312
00919,群益台灣精選高息,123,27,96,華南永昌-民權,2024-03-06,9312
00915,凱基優選高股息30,80,0,80,華南永昌-民權,2024-03-06,9312
6179,亞通,71,0,71,華南永昌-民權,2024-03-06,9312
1702,南僑,50,0,50,華南永昌-民權,2024-03-06,9312
1303,南亞,46,1,45,華南永昌-民權,2024-03-06,9312
2892,第一金,41,0,41,華南永昌-民權,2024-03-06,9312
2009,第一銅,35,0,35,華南永昌-民權,2024-03-06,9312
5340,建榮,35,0,35,華南永昌-民權,2024-03-06,9312
8011,台通,44,11,33,華南永昌-民權,2024-03-06,9312
8432,東生華,40,10,30,華南永昌-民權,2024-03-06,9312
00935,野村臺灣新科技50,28,0,28,華南永昌-民權,2024-03-06,9312
2324,仁寶,29,1,28,華南永昌-民權,2024-03-06,9312
00918,大華優利高填息30,33,6,27,華南永昌-民權,2024-03-06,9312
2102,泰豐,25,0,25,華南永昌-民權,2024-03-06,9312
3715,定穎投控,20,0,20,華南永昌-民權,2024-03-06,9312
3481,群創,23,3,20,華南永昌-民權,2024-03-06,9312
1409,新纖,19,0,19,華南永昌-民權,2024-03-06,9312
00933B,國泰10Y+金融債,18,0,18,華南永昌-民權,2024-03-06,9312
1589,永冠-KY,20,2,18,華南永昌-民權,2024-03-06,9312
00936,台新永續高息中小,16,0,16,華南永昌-民權,2024-03-06,9312
4549,桓達,13,0,13,華南永昌-民權,2024-03-06,9312
2883,凱基金,23,10,13,華南永昌-民權,2024-03-06,9312
4908,前鼎,43,31,12,華南永昌-民權,2024-03-06,9312
00904,新光臺灣半導體30,12,0,12,華南永昌-民權,2024-03-06,9312
2014,中鴻,11,0,11,華南永昌-民權,2024-03-06,9312
3231,緯創,18,7,11,華南永昌-民權,2024-03-06,9312
1101,台泥,12,1,11,華南永昌-民權,2024-03-06,9312
00632R,元大台灣50反1,10,0,10,華南永昌-民權,2024-03-06,9312
2408,南亞科,12,2,10,華南永昌-民權,2024-03-06,9312
3049,精金,10,0,10,華南永昌-民權,2024-03-06,9312
6127,九豪,10,0,10,華南永昌-民權,2024-03-06,9312
6168,宏齊,10,0,10,華南永昌-民權,2024-03-06,9312
8105,凌巨,10,0,10,華南永昌-民權,2024-03-06,9312
8916,光隆,10,0,10,華南永昌-民權,2024-03-06,9312
6112,邁達特,9,0,9,華南永昌-民權,2024-03-06,9312
8047,星雲,9,0,9,華南永昌-民權,2024-03-06,9312
3147,大綜,9,1,8,華南永昌-民權,2024-03-06,9312
4188,安克,9,1,8,華南永昌-民權,2024-03-06,9312
00902,中信電池及儲能,7,0,7,華南永昌-民權,2024-03-06,9312
00753L,中信中國50正2,7,0,7,華南永昌-民權,2024-03-06,9312
6005,群益證,7,0,7,華南永昌-民權,2024-03-06,9312
8040,九暘,7,0,7,華南永昌-民權,2024-03-06,9312
2889,國票金,7,0,7,華南永昌-民權,2024-03-06,9312
8046,南電,8,2,6,華南永昌-民權,2024-03-06,9312
2609,陽明,8,2,6,華南永昌-民權,2024-03-06,9312
00762,元大全球AI,6,0,6,華南永昌-民權,2024-03-06,9312
2356,英業達,1264,760,504,華南永昌-民權,2024-03-07,9312
2101,南港,125,0,125,華南永昌-民權,2024-03-07,9312
5905,南仁湖,100,0,100,華南永昌-民權,2024-03-07,9312
00937B,群益ESG投等債20,72,0,72,華南永昌-民權,2024-03-07,9312
8916,光隆,55,0,55,華南永昌-民權,2024-03-07,9312
3481,群創,31,0,31,華南永昌-民權,2024-03-07,9312
00680L,元大美債20正2,30,0,30,華南永昌-民權,2024-03-07,9312
6550,北極星藥業-KY,31,2,29,華南永昌-民權,2024-03-07,9312
2369,菱生,23,0,23,華南永昌-民權,2024-03-07,9312
8054,安國,27,5,22,華南永昌-民權,2024-03-07,9312
4113,聯上,21,0,21,華南永昌-民權,2024-03-07,9312
00892,富邦台灣半導體,20,0,20,華南永昌-民權,2024-03-07,9312
1410,南染,20,0,20,華南永昌-民權,2024-03-07,9312
1605,華新,19,1,18,華南永昌-民權,2024-03-07,9312
3694,海華,32,15,17,華南永昌-民權,2024-03-07,9312
6290,良維,16,0,16,華南永昌-民權,2024-03-07,9312
6274,台燿,26,11,15,華南永昌-民權,2024-03-07,9312
00633L,富邦上証正2,15,0,15,華南永昌-民權,2024-03-07,9312
00915,凱基優選高股息30,15,0,15,華南永昌-民權,2024-03-07,9312
2324,仁寶,23,8,15,華南永昌-民權,2024-03-07,9312
4714,永捷,19,4,15,華南永昌-民權,2024-03-07,9312
8432,東生華,15,0,15,華南永昌-民權,2024-03-07,9312
2486,一詮,24,10,14,華南永昌-民權,2024-03-07,9312
2002,中鋼,15,1,14,華南永昌-民權,2024-03-07,9312
2618,長榮航,15,2,13,華南永昌-民權,2024-03-07,9312
2609,陽明,26,14,12,華南永昌-民權,2024-03-07,9312
00929,復華台灣科技優息,54,44,10,華南永昌-民權,2024-03-07,9312
2515,中工,15,5,10,華南永昌-民權,2024-03-07,9312
2537,聯上發,10,0,10,華南永昌-民權,2024-03-07,9312
2613,中櫃,10,0,10,華南永昌-民權,2024-03-07,9312
2836,高雄銀,70,60,10,華南永昌-民權,2024-03-07,9312
3038,全台,10,0,10,華南永昌-民權,2024-03-07,9312
5498,凱崴,10,0,10,華南永昌-民權,2024-03-07,9312
00918,大華優利高填息30,10,0,10,華南永昌-民權,2024-03-07,9312
2607,榮運,10,1,9,華南永昌-民權,2024-03-07,9312
00631L,元大台灣50正2,10,1,9,華南永昌-民權,2024-03-07,9312
3105,穩懋,14,5,9,華南永昌-民權,2024-03-07,9312
00632R,元大台灣50反1,8,0,8,華南永昌-民權,2024-03-07,9312
2484,希華,8,0,8,華南永昌-民權,2024-03-07,9312
3540,曜越,11,3,8,華南永昌-民權,2024-03-07,9312
3702,大聯大,10,2,8,華南永昌-民權,2024-03-07,9312
6233,旺玖,9,1,8,華南永昌-民權,2024-03-07,9312
2834,臺企銀,7,0,7,華南永昌-民權,2024-03-07,9312
3576,聯合再生,7,0,7,華南永昌-民權,2024-03-07,9312
9907,統一實,11,4,7,華南永昌-民權,2024-03-07,9312
00878,國泰永續高股息,10,3,7,華南永昌-民權,2024-03-07,9312
2337,旺宏,7,1,6,華南永昌-民權,2024-03-07,9312
2368,金像電,7,1,6,華南永昌-民權,2024-03-07,9312
1785,光洋科,12,6,6,華南永昌-民權,2024-03-07,9312
2353,宏��,8,2,6,華南永昌-民權,2024-03-07,9312
2356,英業達,264,15,249,華南永昌-民權,2024-03-08,9312
5905,南仁湖,180,0,180,華南永昌-民權,2024-03-08,9312
3078,僑威,81,0,81,華南永昌-民權,2024-03-08,9312
00632R,元大台灣50反1,85,10,75,華南永昌-民權,2024-03-08,9312
8011,台通,75,0,75,華南永昌-民權,2024-03-08,9312
1301,台塑,87,15,72,華南永昌-民權,2024-03-08,9312
00915,凱基優選高股息30,76,13,63,華南永昌-民權,2024-03-08,9312
00680L,元大美債20正2,57,7,50,華南永昌-民權,2024-03-08,9312
3265,台星科,53,5,48,華南永昌-民權,2024-03-08,9312
6177,達麗,45,0,45,華南永昌-民權,2024-03-08,9312
3481,群創,41,0,41,華南永昌-民權,2024-03-08,9312
2645,長榮航太,50,12,38,華南永昌-民權,2024-03-08,9312
3652,精聯,34,0,34,華南永昌-民權,2024-03-08,9312
00919,群益台灣精選高息,86,53,33,華南永昌-民權,2024-03-08,9312
3293,鈊象,32,1,31,華南永昌-民權,2024-03-08,9312
00676R,富邦臺灣加權反1,30,0,30,華南永昌-民權,2024-03-08,9312
6139,亞翔,31,1,30,華南永昌-民權,2024-03-08,9312
8936,國統,34,4,30,華南永昌-民權,2024-03-08,9312
00918,大華優利高填息30,29,4,25,華南永昌-民權,2024-03-08,9312
00935,野村臺灣新科技50,25,0,25,華南永昌-民權,2024-03-08,9312
2465,麗臺,26,1,25,華南永昌-民權,2024-03-08,9312
8069,元太,23,0,23,華南永昌-民權,2024-03-08,9312
1589,永冠-KY,23,0,23,華南永昌-民權,2024-03-08,9312
00931B,統一美債20年,20,0,20,華南永昌-民權,2024-03-08,9312
3081,聯亞,20,0,20,華南永昌-民權,2024-03-08,9312
6179,亞通,20,0,20,華南永昌-民權,2024-03-08,9312
8916,光隆,20,0,20,華南永昌-民權,2024-03-08,9312
5880,合庫金,20,0,20,華南永昌-民權,2024-03-08,9312
3231,緯創,33,13,20,華南永昌-民權,2024-03-08,9312
2360,致茂,18,0,18,華南永昌-民權,2024-03-08,9312
3264,欣銓,18,0,18,華南永昌-民權,2024-03-08,9312
3372,典範,27,9,18,華南永昌-民權,2024-03-08,9312
3540,曜越,18,3,15,華南永昌-民權,2024-03-08,9312
2201,裕隆,22,8,14,華南永昌-民權,2024-03-08,9312
9941,裕融,12,0,12,華南永昌-民權,2024-03-08,9312
5498,凱崴,12,0,12,華南永昌-民權,2024-03-08,9312
6257,矽格,15,4,11,華南永昌-民權,2024-03-08,9312
1303,南亞,15,4,11,華南永昌-民權,2024-03-08,9312
3287,廣寰科,11,0,11,華南永昌-民權,2024-03-08,9312
6285,啟��,11,0,11,華南永昌-民權,2024-03-08,9312
00857B,永豐20年美公債,10,0,10,華南永昌-民權,2024-03-08,9312
00725B,國泰投資級公司債,10,0,10,華南永昌-民權,2024-03-08,9312
00706L,期元大S＆P日圓正2,10,0,10,華南永昌-民權,2024-03-08,9312
6143,振曜,23,13,10,華南永昌-民權,2024-03-08,9312
2834,臺企銀,10,1,9,華南永昌-民權,2024-03-08,9312
00927,群益半導體收益,9,0,9,華南永昌-民權,2024-03-08,9312
00679B,元大美債20年,59,51,8,華南永昌-民權,2024-03-08,9312
4714,永捷,8,0,8,華南永昌-民權,2024-03-08,9312
6271,同欣電,8,0,8,華南永昌-民權,2024-03-08,9312
1314,中石化,7,0,7,華南永昌-民權,2024-03-08,9312
2101,南港,125,0,125,華南永昌-民權,2024-03-11,9312
2834,臺企銀,108,0,108,華南永昌-民權,2024-03-11,9312
2367,燿華,147,43,104,華南永昌-民權,2024-03-11,9312
00929,復華台灣科技優息,126,26,100,華南永昌-民權,2024-03-11,9312
6187,萬潤,82,2,80,華南永昌-民權,2024-03-11,9312
8916,光隆,75,0,75,華南永昌-民權,2024-03-11,9312
00937B,群益ESG投等債20,54,0,54,華南永昌-民權,2024-03-11,9312
00919,群益台灣精選高息,64,11,53,華南永昌-民權,2024-03-11,9312
00935,野村臺灣新科技50,38,0,38,華南永昌-民權,2024-03-11,9312
5222,全訊,38,0,38,華南永昌-民權,2024-03-11,9312
9924,福興,36,0,36,華南永昌-民權,2024-03-11,9312
2303,聯電,85,52,33,華南永昌-民權,2024-03-11,9312
00751B,元大AAA至A公司債,31,0,31,華南永昌-民權,2024-03-11,9312
2009,第一銅,30,2,28,華南永昌-民權,2024-03-11,9312
5905,南仁湖,25,0,25,華南永昌-民權,2024-03-11,9312
00918,大華優利高填息30,24,0,24,華南永昌-民權,2024-03-11,9312
1301,台塑,27,5,22,華南永昌-民權,2024-03-11,9312
1410,南染,20,0,20,華南永昌-民權,2024-03-11,9312
2102,泰豐,20,0,20,華南永昌-民權,2024-03-11,9312
9105,泰金寶-DR,20,0,20,華南永昌-民權,2024-03-11,9312
1101,台泥,15,0,15,華南永昌-民權,2024-03-11,9312
00679B,元大美債20年,15,0,15,華南永昌-民權,2024-03-11,9312
1513,中興電,12,0,12,華南永昌-民權,2024-03-11,9312
2002,中鋼,12,1,11,華南永昌-民權,2024-03-11,9312
2634,漢翔,10,0,10,華南永昌-民權,2024-03-11,9312
00888,永豐台灣ESG,10,0,10,華南永昌-民權,2024-03-11,9312
1815,富喬,12,2,10,華南永昌-民權,2024-03-11,9312
2369,菱生,41,31,10,華南永昌-民權,2024-03-11,9312
3402,漢科,10,0,10,華南永昌-民權,2024-03-11,9312
3491,昇達科,10,0,10,華南永昌-民權,2024-03-11,9312
6179,亞通,10,0,10,華南永昌-民權,2024-03-11,9312
8936,國統,10,0,10,華南永昌-民權,2024-03-11,9312
0056,元大高股息,11,2,9,華南永昌-民權,2024-03-11,9312
3325,旭品,9,0,9,華南永昌-民權,2024-03-11,9312
6274,台燿,17,8,9,華南永昌-民權,2024-03-11,9312
4526,東台,8,0,8,華南永昌-民權,2024-03-11,9312
00885,富邦越南,8,0,8,華南永昌-民權,2024-03-11,9312
5498,凱崴,10,2,8,華南永昌-民權,2024-03-11,9312
3564,其陽,7,0,7,華南永昌-民權,2024-03-11,9312
2363,矽統,11,5,6,華南永昌-民權,2024-03-11,9312
2324,仁寶,6,0,6,華南永昌-民權,2024-03-11,9312
2329,華泰,12,6,6,華南永昌-民權,2024-03-11,9312
2337,旺宏,6,0,6,華南永昌-民權,2024-03-11,9312
5388,中磊,6,0,6,華南永昌-民權,2024-03-11,9312
5515,建國,6,0,6,華南永昌-民權,2024-03-11,9312
3293,鈊象,13,8,5,華南永昌-民權,2024-03-11,9312
00665L,富邦�琤肭磪囓�2,5,0,5,華南永昌-民權,2024-03-11,9312
4760,勤凱,5,0,5,華南永昌-民權,2024-03-11,9312
5272,笙科,5,0,5,華南永昌-民權,2024-03-11,9312
6143,振曜,15,10,5,華南永昌-民權,2024-03-11,9312
2880,華南金,180,0,180,華南永昌-民權,2024-03-12,9312
00929,復華台灣科技優息,114,12,102,華南永昌-民權,2024-03-12,9312
2356,英業達,101,4,97,華南永昌-民權,2024-03-12,9312
2101,南港,75,0,75,華南永昌-民權,2024-03-12,9312
00918,大華優利高填息30,83,14,69,華南永昌-民權,2024-03-12,9312
00919,群益台灣精選高息,68,4,64,華南永昌-民權,2024-03-12,9312
00937B,群益ESG投等債20,57,3,54,華南永昌-民權,2024-03-12,9312
2371,大同,60,13,47,華南永昌-民權,2024-03-12,9312
5222,全訊,70,28,42,華南永昌-民權,2024-03-12,9312
00680L,元大美債20正2,41,0,41,華南永昌-民權,2024-03-12,9312
0056,元大高股息,43,12,31,華南永昌-民權,2024-03-12,9312
8916,光隆,42,12,30,華南永昌-民權,2024-03-12,9312
4714,永捷,25,5,20,華南永昌-民權,2024-03-12,9312
1409,新纖,23,3,20,華南永昌-民權,2024-03-12,9312
1737,臺鹽,20,0,20,華南永昌-民權,2024-03-12,9312
9105,泰金寶-DR,20,0,20,華南永昌-民權,2024-03-12,9312
6120,達運,21,2,19,華南永昌-民權,2024-03-12,9312
2609,陽明,24,6,18,華南永昌-民權,2024-03-12,9312
00878,國泰永續高股息,61,43,18,華南永昌-民權,2024-03-12,9312
5386,青雲,25,7,18,華南永昌-民權,2024-03-12,9312
2324,仁寶,19,3,16,華南永昌-民權,2024-03-12,9312
1815,富喬,45,31,14,華南永昌-民權,2024-03-12,9312
4939,亞電,14,0,14,華南永昌-民權,2024-03-12,9312
9924,福興,25,11,14,華南永昌-民權,2024-03-12,9312
00751B,元大AAA至A公司債,12,0,12,華南永昌-民權,2024-03-12,9312
6182,合晶,11,0,11,華南永昌-民權,2024-03-12,9312
4979,華星光,11,0,11,華南永昌-民權,2024-03-12,9312
3062,建漢,15,5,10,華南永昌-民權,2024-03-12,9312
5488,松普,10,0,10,華南永昌-民權,2024-03-12,9312
9919,康那香,10,0,10,華南永昌-民權,2024-03-12,9312
6165,浪凡,10,1,9,華南永昌-民權,2024-03-12,9312
1587,吉茂,11,2,9,華南永昌-民權,2024-03-12,9312
6227,茂綸,9,0,9,華南永昌-民權,2024-03-12,9312
6111,大宇資,10,2,8,華南永昌-民權,2024-03-12,9312
00885,富邦越南,8,0,8,華南永昌-民權,2024-03-12,9312
2359,所羅門,8,0,8,華南永昌-民權,2024-03-12,9312
2002,中鋼,8,1,7,華南永昌-民權,2024-03-12,9312
3217,優群,7,0,7,華南永昌-民權,2024-03-12,9312
00687B,國泰20年美債,7,0,7,華南永昌-民權,2024-03-12,9312
2855,統一證,12,5,7,華南永昌-民權,2024-03-12,9312
1110,東泥,6,0,6,華南永昌-民權,2024-03-12,9312
3163,波若威,17,11,6,華南永昌-民權,2024-03-12,9312
3380,明泰,6,0,6,華南永昌-民權,2024-03-12,9312
3708,上緯投控,6,0,6,華南永昌-民權,2024-03-12,9312
5272,笙科,6,0,6,華南永昌-民權,2024-03-12,9312
5498,凱崴,6,0,6,華南永昌-民權,2024-03-12,9312
4956,光鋐,5,0,5,華南永昌-民權,2024-03-12,9312
00787B,元大10年IG醫療債,5,0,5,華南永昌-民權,2024-03-12,9312
00664R,國泰臺灣加權反1,5,0,5,華南永昌-民權,2024-03-12,9312
2344,華邦電,6,1,5,華南永昌-民權,2024-03-12,9312
00918,大華優利高填息30,396,10,386,華南永昌-民權,2024-03-13,9312
3078,僑威,325,0,325,華南永昌-民權,2024-03-13,9312
5905,南仁湖,205,0,205,華南永昌-民權,2024-03-13,9312
2101,南港,200,0,200,華南永昌-民權,2024-03-13,9312
00937B,群益ESG投等債20,162,5,157,華南永昌-民權,2024-03-13,9312
2356,英業達,134,31,103,華南永昌-民權,2024-03-13,9312
9902,台火,95,11,84,華南永昌-民權,2024-03-13,9312
3652,精聯,55,0,55,華南永昌-民權,2024-03-13,9312
00680L,元大美債20正2,51,0,51,華南永昌-民權,2024-03-13,9312
3231,緯創,59,10,49,華南永昌-民權,2024-03-13,9312
3081,聯亞,30,0,30,華南永昌-民權,2024-03-13,9312
8916,光隆,30,0,30,華南永昌-民權,2024-03-13,9312
1815,富喬,31,2,29,華南永昌-民權,2024-03-13,9312
3715,定穎投控,23,1,22,華南永昌-民權,2024-03-13,9312
5243,乙盛-KY,26,5,21,華南永昌-民權,2024-03-13,9312
8054,安國,37,16,21,華南永昌-民權,2024-03-13,9312
6005,群益證,22,2,20,華南永昌-民權,2024-03-13,9312
3708,上緯投控,19,0,19,華南永昌-民權,2024-03-13,9312
00687B,國泰20年美債,18,0,18,華南永昌-民權,2024-03-13,9312
2809,京城銀,16,0,16,華南永昌-民權,2024-03-13,9312
3025,星通,23,8,15,華南永昌-民權,2024-03-13,9312
1605,華新,14,0,14,華南永昌-民權,2024-03-13,9312
00751B,元大AAA至A公司債,13,0,13,華南永昌-民權,2024-03-13,9312
2344,華邦電,15,2,13,華南永昌-民權,2024-03-13,9312
4123,晟德,12,0,12,華南永昌-民權,2024-03-13,9312
00712,復華富時不動產,11,0,11,華南永昌-民權,2024-03-13,9312
2464,盟立,15,4,11,華南永昌-民權,2024-03-13,9312
3605,宏致,11,0,11,華南永昌-民權,2024-03-13,9312
4167,松瑞藥,11,0,11,華南永昌-民權,2024-03-13,9312
4939,亞電,11,0,11,華南永昌-民權,2024-03-13,9312
2836,高雄銀,10,0,10,華南永昌-民權,2024-03-13,9312
2371,大同,10,0,10,華南永昌-民權,2024-03-13,9312
00725B,國泰投資級公司債,10,0,10,華南永昌-民權,2024-03-13,9312
00665L,富邦�琤肭磪囓�2,10,0,10,華南永昌-民權,2024-03-13,9312
00905,FT臺灣Smart,10,0,10,華南永昌-民權,2024-03-13,9312
1608,華榮,15,5,10,華南永昌-民權,2024-03-13,9312
2102,泰豐,10,0,10,華南永昌-民權,2024-03-13,9312
2302,麗正,10,0,10,華南永昌-民權,2024-03-13,9312
2408,南亞科,10,0,10,華南永昌-民權,2024-03-13,9312
2506,太設,10,0,10,華南永昌-民權,2024-03-13,9312
2816,旺旺保,10,0,10,華南永昌-民權,2024-03-13,9312
4960,誠美材,10,0,10,華南永昌-民權,2024-03-13,9312
5340,建榮,10,0,10,華南永昌-民權,2024-03-13,9312
6187,萬潤,10,0,10,華南永昌-民權,2024-03-13,9312
2460,建通,10,1,9,華南永昌-民權,2024-03-13,9312
3060,銘異,9,0,9,華南永昌-民權,2024-03-13,9312
2889,國票金,9,0,9,華南永昌-民權,2024-03-13,9312
2002,中鋼,8,0,8,華南永昌-民權,2024-03-13,9312
2603,長榮,15,7,8,華南永昌-民權,2024-03-13,9312
1609,大亞,9,1,8,華南永昌-民權,2024-03-13,9312
00918,大華優利高填息30,376,0,376,華南永昌-民權,2024-03-14,9312
3078,僑威,189,14,175,華南永昌-民權,2024-03-14,9312
00929,復華台灣科技優息,174,53,121,華南永昌-民權,2024-03-14,9312
2101,南港,110,0,110,華南永昌-民權,2024-03-14,9312
2356,英業達,112,3,109,華南永昌-民權,2024-03-14,9312
5483,中美晶,105,1,104,華南永昌-民權,2024-03-14,9312
00719B,元大美債1-3,100,0,100,華南永昌-民權,2024-03-14,9312
00919,群益台灣精選高息,97,43,54,華南永昌-民權,2024-03-14,9312
00915,凱基優選高股息30,67,20,47,華南永昌-民權,2024-03-14,9312
3491,昇達科,40,0,40,華南永昌-民權,2024-03-14,9312
5222,全訊,40,0,40,華南永昌-民權,2024-03-14,9312
2105,正新,40,1,39,華南永昌-民權,2024-03-14,9312
2618,長榮航,51,13,38,華南永昌-民權,2024-03-14,9312
00680L,元大美債20正2,31,0,31,華南永昌-民權,2024-03-14,9312
2889,國票金,192,162,30,華南永昌-民權,2024-03-14,9312
00706L,期元大S＆P日圓正2,30,0,30,華南永昌-民權,2024-03-14,9312
0056,元大高股息,22,0,22,華南永昌-民權,2024-03-14,9312
2836,高雄銀,30,11,19,華南永昌-民權,2024-03-14,9312
00935,野村臺灣新科技50,19,1,18,華南永昌-民權,2024-03-14,9312
2409,友達,22,4,18,華南永昌-民權,2024-03-14,9312
00679B,元大美債20年,20,3,17,華南永昌-民權,2024-03-14,9312
00687B,國泰20年美債,16,0,16,華南永昌-民權,2024-03-14,9312
1303,南亞,16,1,15,華南永昌-民權,2024-03-14,9312
00933B,國泰10Y+金融債,16,2,14,華南永昌-民權,2024-03-14,9312
1301,台塑,20,6,14,華南永昌-民權,2024-03-14,9312
1616,億泰,20,6,14,華南永昌-民權,2024-03-14,9312
4939,亞電,14,0,14,華南永昌-民權,2024-03-14,9312
3265,台星科,17,4,13,華南永昌-民權,2024-03-14,9312
3231,緯創,20,7,13,華南永昌-民權,2024-03-14,9312
1316,上曜,26,14,12,華南永昌-民權,2024-03-14,9312
3025,星通,12,0,12,華南永昌-民權,2024-03-14,9312
3013,晟銘電,11,0,11,華南永昌-民權,2024-03-14,9312
3293,鈊象,11,1,10,華南永昌-民權,2024-03-14,9312
4417,金洲,10,0,10,華南永昌-民權,2024-03-14,9312
5498,凱崴,10,0,10,華南永昌-民權,2024-03-14,9312
2812,台中銀,10,2,8,華南永昌-民權,2024-03-14,9312
2342,茂矽,12,4,8,華南永昌-民權,2024-03-14,9312
8047,星雲,13,5,8,華南永昌-民權,2024-03-14,9312
8926,台汽電,8,0,8,華南永昌-民權,2024-03-14,9312
6488,環球晶,7,0,7,華南永昌-民權,2024-03-14,9312
3321,同泰,7,0,7,華南永昌-民權,2024-03-14,9312
1503,士電,32,25,7,華南永昌-民權,2024-03-14,9312
2324,仁寶,7,0,7,華南永昌-民權,2024-03-14,9312
2369,菱生,7,0,7,華南永昌-民權,2024-03-14,9312
4128,中天,7,0,7,華南永昌-民權,2024-03-14,9312
00937B,群益ESG投等債20,6,0,6,華南永昌-民權,2024-03-14,9312
1609,大亞,17,11,6,華南永昌-民權,2024-03-14,9312
2609,陽明,8,2,6,華南永昌-民權,2024-03-14,9312
00751B,元大AAA至A公司債,6,0,6,華南永昌-民權,2024-03-14,9312
2362,藍天,6,0,6,華南永昌-民權,2024-03-14,9312
00919,群益台灣精選高息,245,20,225,華南永昌-民權,2024-03-15,9312
2101,南港,75,5,70,華南永昌-民權,2024-03-15,9312
1303,南亞,53,4,49,華南永昌-民權,2024-03-15,9312
2515,中工,40,0,40,華南永昌-民權,2024-03-15,9312
00687B,國泰20年美債,47,8,39,華南永昌-民權,2024-03-15,9312
3715,定穎投控,32,0,32,華南永昌-民權,2024-03-15,9312
00878,國泰永續高股息,34,3,31,華南永昌-民權,2024-03-15,9312
2618,長榮航,30,0,30,華南永昌-民權,2024-03-15,9312
00937B,群益ESG投等債20,29,1,28,華南永昌-民權,2024-03-15,9312
2303,聯電,39,11,28,華南永昌-民權,2024-03-15,9312
4939,亞電,24,0,24,華南永昌-民權,2024-03-15,9312
2330,台積電,24,0,24,華南永昌-民權,2024-03-15,9312
2603,長榮,27,4,23,華南永昌-民權,2024-03-15,9312
00688L,國泰20年美債正2,21,0,21,華南永昌-民權,2024-03-15,9312
00706L,期元大S＆P日圓正2,20,0,20,華南永昌-民權,2024-03-15,9312
00676R,富邦臺灣加權反1,20,0,20,華南永昌-民權,2024-03-15,9312
4113,聯上,30,10,20,華南永昌-民權,2024-03-15,9312
4123,晟德,20,0,20,華南永昌-民權,2024-03-15,9312
2002,中鋼,17,0,17,華南永昌-民權,2024-03-15,9312
2884,玉山金,17,1,16,華南永昌-民權,2024-03-15,9312
2465,麗臺,15,0,15,華南永昌-民權,2024-03-15,9312
4905,台聯電,15,0,15,華南永昌-民權,2024-03-15,9312
8436,大江,15,0,15,華南永昌-民權,2024-03-15,9312
1210,大成,14,1,13,華南永昌-民權,2024-03-15,9312
3081,聯亞,33,20,13,華南永昌-民權,2024-03-15,9312
1314,中石化,12,0,12,華南永昌-民權,2024-03-15,9312
00857B,永豐20年美公債,11,0,11,華南永昌-民權,2024-03-15,9312
2887,台新金,11,0,11,華南永昌-民權,2024-03-15,9312
2834,臺企銀,535,525,10,華南永昌-民權,2024-03-15,9312
1616,億泰,30,20,10,華南永昌-民權,2024-03-15,9312
2115,六暉-KY,10,0,10,華南永昌-民權,2024-03-15,9312
2743,山富,10,0,10,華南永昌-民權,2024-03-15,9312
3163,波若威,14,4,10,華南永昌-民權,2024-03-15,9312
6016,康和證,10,0,10,華南永昌-民權,2024-03-15,9312
6269,台郡,10,0,10,華南永昌-民權,2024-03-15,9312
8147,正淩,10,0,10,華南永昌-民權,2024-03-15,9312
2105,正新,10,1,9,華南永昌-民權,2024-03-15,9312
2344,華邦電,12,4,8,華南永昌-民權,2024-03-15,9312
4766,南寶,8,0,8,華南永昌-民權,2024-03-15,9312
6116,彩晶,7,0,7,華南永昌-民權,2024-03-15,9312
2324,仁寶,8,1,7,華南永昌-民權,2024-03-15,9312
00885,富邦越南,7,0,7,華南永昌-民權,2024-03-15,9312
2020,美亞,6,0,6,華南永昌-民權,2024-03-15,9312
2915,潤泰全,6,0,6,華南永昌-民權,2024-03-15,9312
3622,洋華,13,7,6,華南永昌-民權,2024-03-15,9312
5009,榮剛,6,0,6,華南永昌-民權,2024-03-15,9312
6182,合晶,5,0,5,華南永昌-民權,2024-03-15,9312
2354,鴻準,8,3,5,華南永昌-民權,2024-03-15,9312
00712,復華富時不動產,5,0,5,華南永昌-民權,2024-03-15,9312
00720B,元大投資級公司債,5,0,5,華南永昌-民權,2024-03-15,9312
3481,群創,1017,2,1015,華南永昌-民權,2024-03-18,9312
00680L,元大美債20正2,155,4,151,華南永昌-民權,2024-03-18,9312
00919,群益台灣精選高息,118,0,118,華南永昌-民權,2024-03-18,9312
2356,英業達,116,24,92,華南永昌-民權,2024-03-18,9312
2101,南港,70,0,70,華南永昌-民權,2024-03-18,9312
6770,力積電,70,1,69,華南永昌-民權,2024-03-18,9312
2883,凱基金,68,3,65,華南永昌-民權,2024-03-18,9312
2801,彰銀,62,0,62,華南永昌-民權,2024-03-18,9312
2408,南亞科,102,45,57,華南永昌-民權,2024-03-18,9312
2885,元大金,42,2,40,華南永昌-民權,2024-03-18,9312
00941,中信上游半導體,37,2,35,華南永昌-民權,2024-03-18,9312
2601,益航,32,0,32,華南永昌-民權,2024-03-18,9312
8011,台通,76,48,28,華南永昌-民權,2024-03-18,9312
2009,第一銅,25,4,21,華南永昌-民權,2024-03-18,9312
4549,桓達,20,0,20,華南永昌-民權,2024-03-18,9312
2609,陽明,19,0,19,華南永昌-民權,2024-03-18,9312
00915,凱基優選高股息30,19,0,19,華南永昌-民權,2024-03-18,9312
4905,台聯電,17,0,17,華南永昌-民權,2024-03-18,9312
00679B,元大美債20年,16,0,16,華南永昌-民權,2024-03-18,9312
2324,仁寶,16,0,16,華南永昌-民權,2024-03-18,9312
3217,優群,21,6,15,華南永昌-民權,2024-03-18,9312
2409,友達,18,3,15,華南永昌-民權,2024-03-18,9312
00937B,群益ESG投等債20,34,20,14,華南永昌-民權,2024-03-18,9312
00918,大華優利高填息30,13,0,13,華南永昌-民權,2024-03-18,9312
2464,盟立,12,1,11,華南永昌-民權,2024-03-18,9312
1301,台塑,11,1,10,華南永昌-民權,2024-03-18,9312
1303,南亞,10,0,10,華南永昌-民權,2024-03-18,9312
1326,台化,10,0,10,華南永昌-民權,2024-03-18,9312
2312,金寶,10,0,10,華南永昌-民權,2024-03-18,9312
2743,山富,10,0,10,華南永昌-民權,2024-03-18,9312
4113,聯上,10,0,10,華南永昌-民權,2024-03-18,9312
5515,建國,10,0,10,華南永昌-民權,2024-03-18,9312
6275,元山,10,1,9,華南永昌-民權,2024-03-18,9312
00751B,元大AAA至A公司債,9,0,9,華南永昌-民權,2024-03-18,9312
2884,玉山金,10,1,9,華南永昌-民權,2024-03-18,9312
1314,中石化,8,0,8,華南永昌-民權,2024-03-18,9312
2882,國泰金,12,4,8,華南永昌-民權,2024-03-18,9312
00935,野村臺灣新科技50,7,0,7,華南永昌-民權,2024-03-18,9312
6488,環球晶,7,0,7,華南永昌-民權,2024-03-18,9312
9927,泰銘,8,1,7,華南永昌-民權,2024-03-18,9312
2353,宏��,11,5,6,華南永昌-民權,2024-03-18,9312
3715,定穎投控,6,1,5,華南永昌-民權,2024-03-18,9312
00923,群益台ESG低碳50,5,0,5,華南永昌-民權,2024-03-18,9312
00857B,永豐20年美公債,5,0,5,華南永昌-民權,2024-03-18,9312
1815,富喬,9,4,5,華南永昌-民權,2024-03-18,9312
2027,大成鋼,5,0,5,華南永昌-民權,2024-03-18,9312
2371,大同,10,5,5,華南永昌-民權,2024-03-18,9312
2534,宏盛,5,0,5,華南永昌-民權,2024-03-18,9312
3051,力特,5,0,5,華南永昌-民權,2024-03-18,9312
3545,敦泰,5,0,5,華南永昌-民權,2024-03-18,9312
3481,群創,1006,20,986,華南永昌-民權,2024-03-19,9312
2880,華南金,800,1,799,華南永昌-民權,2024-03-19,9312
2603,長榮,236,7,229,華南永昌-民權,2024-03-19,9312
00632R,元大台灣50反1,100,0,100,華南永昌-民權,2024-03-19,9312
2101,南港,100,0,100,華南永昌-民權,2024-03-19,9312
00725B,國泰投資級公司債,100,3,97,華南永昌-民權,2024-03-19,9312
00919,群益台灣精選高息,90,21,69,華南永昌-民權,2024-03-19,9312
1605,華新,66,3,63,華南永昌-民權,2024-03-19,9312
00795B,中信美國公債20年,54,0,54,華南永昌-民權,2024-03-19,9312
1314,中石化,40,5,35,華南永昌-民權,2024-03-19,9312
00915,凱基優選高股息30,33,0,33,華南永昌-民權,2024-03-19,9312
1616,億泰,31,0,31,華南永昌-民權,2024-03-19,9312
2471,資通,28,0,28,華南永昌-民權,2024-03-19,9312
5905,南仁湖,25,0,25,華南永昌-民權,2024-03-19,9312
3045,台灣大,23,0,23,華南永昌-民權,2024-03-19,9312
00687B,國泰20年美債,20,0,20,華南永昌-民權,2024-03-19,9312
00918,大華優利高填息30,40,22,18,華南永昌-民權,2024-03-19,9312
1513,中興電,51,34,17,華南永昌-民權,2024-03-19,9312
3081,聯亞,16,0,16,華南永昌-民權,2024-03-19,9312
5515,建國,16,0,16,華南永昌-民權,2024-03-19,9312
3390,旭軟,15,1,14,華南永昌-民權,2024-03-19,9312
00631L,元大台灣50正2,13,0,13,華南永昌-民權,2024-03-19,9312
6196,帆宣,13,0,13,華南永昌-民權,2024-03-19,9312
8927,北基,13,0,13,華南永昌-民權,2024-03-19,9312
5543,桓鼎-KY,12,0,12,華南永昌-民權,2024-03-19,9312
1785,光洋科,11,0,11,華南永昌-民權,2024-03-19,9312
2812,台中銀,11,0,11,華南永昌-民權,2024-03-19,9312
00706L,期元大S＆P日圓正2,10,0,10,華南永昌-民權,2024-03-19,9312
00931B,統一美債20年,10,0,10,華南永昌-民權,2024-03-19,9312
00935,野村臺灣新科技50,10,0,10,華南永昌-民權,2024-03-19,9312
2102,泰豐,10,0,10,華南永昌-民權,2024-03-19,9312
2353,宏��,10,0,10,華南永昌-民權,2024-03-19,9312
2601,益航,10,0,10,華南永昌-民權,2024-03-19,9312
2887,台新金,11,1,10,華南永昌-民權,2024-03-19,9312
2915,潤泰全,10,0,10,華南永昌-民權,2024-03-19,9312
2009,第一銅,11,1,10,華南永昌-民權,2024-03-19,9312
1503,士電,20,11,9,華南永昌-民權,2024-03-19,9312
4939,亞電,9,0,9,華南永昌-民權,2024-03-19,9312
4905,台聯電,8,0,8,華南永昌-民權,2024-03-19,9312
4915,致伸,11,3,8,華南永昌-民權,2024-03-19,9312
2376,技嘉,11,4,7,華南永昌-民權,2024-03-19,9312
1101,台泥,11,4,7,華南永昌-民權,2024-03-19,9312
3044,健鼎,11,4,7,華南永昌-民權,2024-03-19,9312
00941,中信上游半導體,12,5,7,華南永昌-民權,2024-03-19,9312
6270,倍微,7,0,7,華南永昌-民權,2024-03-19,9312
2105,正新,9,3,6,華南永昌-民權,2024-03-19,9312
2449,京元電子,8,2,6,華南永昌-民權,2024-03-19,9312
3055,蔚華科,29,23,6,華南永昌-民權,2024-03-19,9312
00937B,群益ESG投等債20,35,30,5,華南永昌-民權,2024-03-19,9312
00675L,富邦臺灣加權正2,5,0,5,華南永昌-民權,2024-03-19,9312
2354,鴻準,247,40,207,華南永昌-民權,2024-03-20,9312
2356,英業達,168,5,163,華南永昌-民權,2024-03-20,9312
00939,統一台灣高息動能,262,112,150,華南永昌-民權,2024-03-20,9312
00937B,群益ESG投等債20,60,6,54,華南永昌-民權,2024-03-20,9312
2367,燿華,56,12,44,華南永昌-民權,2024-03-20,9312
5340,建榮,39,0,39,華南永昌-民權,2024-03-20,9312
2618,長榮航,35,0,35,華南永昌-民權,2024-03-20,9312
2915,潤泰全,33,0,33,華南永昌-民權,2024-03-20,9312
6120,達運,32,0,32,華南永昌-民權,2024-03-20,9312
3294,英濟,36,7,29,華南永昌-民權,2024-03-20,9312
1605,華新,50,22,28,華南永昌-民權,2024-03-20,9312
2836,高雄銀,30,2,28,華南永昌-民權,2024-03-20,9312
3231,緯創,31,5,26,華南永昌-民權,2024-03-20,9312
00918,大華優利高填息30,29,3,26,華南永昌-民權,2024-03-20,9312
1410,南染,25,0,25,華南永昌-民權,2024-03-20,9312
4905,台聯電,21,0,21,華南永昌-民權,2024-03-20,9312
1616,億泰,20,0,20,華南永昌-民權,2024-03-20,9312
4549,桓達,20,0,20,華南永昌-民權,2024-03-20,9312
3081,聯亞,19,0,19,華南永昌-民權,2024-03-20,9312
3037,欣興,25,7,18,華南永昌-民權,2024-03-20,9312
5543,桓鼎-KY,18,0,18,華南永昌-民權,2024-03-20,9312
2374,佳能,18,1,17,華南永昌-民權,2024-03-20,9312
2344,華邦電,21,5,16,華南永昌-民權,2024-03-20,9312
2834,臺企銀,17,1,16,華南永昌-民權,2024-03-20,9312
1301,台塑,17,2,15,華南永昌-民權,2024-03-20,9312
00687B,國泰20年美債,14,0,14,華南永昌-民權,2024-03-20,9312
3652,精聯,13,0,13,華南永昌-民權,2024-03-20,9312
4526,東台,12,0,12,華南永昌-民權,2024-03-20,9312
3481,群創,31,20,11,華南永昌-民權,2024-03-20,9312
00891,中信關鍵半導體,11,0,11,華南永昌-民權,2024-03-20,9312
2324,仁寶,14,3,11,華南永昌-民權,2024-03-20,9312
2489,瑞軒,11,0,11,華南永昌-民權,2024-03-20,9312
3491,昇達科,13,2,11,華南永昌-民權,2024-03-20,9312
2102,泰豐,10,0,10,華南永昌-民權,2024-03-20,9312
2408,南亞科,10,0,10,華南永昌-民權,2024-03-20,9312
2461,光群雷,10,0,10,華南永昌-民權,2024-03-20,9312
1513,中興電,15,5,10,華南永昌-民權,2024-03-20,9312
00919,群益台灣精選高息,101,92,9,華南永昌-民權,2024-03-20,9312
2515,中工,10,1,9,華南永昌-民權,2024-03-20,9312
00900,富邦特選高股息30,16,7,9,華南永昌-民權,2024-03-20,9312
6005,群益證,12,4,8,華南永昌-民權,2024-03-20,9312
1101,台泥,13,6,7,華南永昌-民權,2024-03-20,9312
6274,台燿,7,0,7,華南永昌-民權,2024-03-20,9312
00934,中信成長高股息,7,0,7,華南永昌-民權,2024-03-20,9312
1303,南亞,6,0,6,華南永昌-民權,2024-03-20,9312
1326,台化,6,0,6,華南永昌-民權,2024-03-20,9312
2542,興富發,6,0,6,華南永昌-民權,2024-03-20,9312
3265,台星科,7,1,6,華南永昌-民權,2024-03-20,9312
5452,佶優,6,0,6,華南永昌-民權,2024-03-20,9312
6126,信音,7,1,6,華南永昌-民權,2024-03-20,9312
2344,華邦電,1051,24,1027,華南永昌-民權,2024-03-21,9312
00939,統一台灣高息動能,179,16,163,華南永昌-民權,2024-03-21,9312
2208,台船,116,0,116,華南永昌-民權,2024-03-21,9312
4123,晟德,80,0,80,華南永昌-民權,2024-03-21,9312
2002,中鋼,54,3,51,華南永昌-民權,2024-03-21,9312
2101,南港,50,0,50,華南永昌-民權,2024-03-21,9312
00878,國泰永續高股息,61,13,48,華南永昌-民權,2024-03-21,9312
3294,英濟,39,0,39,華南永昌-民權,2024-03-21,9312
2102,泰豐,35,0,35,華南永昌-民權,2024-03-21,9312
2303,聯電,56,25,31,華南永昌-民權,2024-03-21,9312
2836,高雄銀,30,0,30,華南永昌-民權,2024-03-21,9312
1608,華榮,34,6,28,華南永昌-民權,2024-03-21,9312
2405,輔信,27,2,25,華南永昌-民權,2024-03-21,9312
00680L,元大美債20正2,24,0,24,華南永昌-民權,2024-03-21,9312
00632R,元大台灣50反1,23,0,23,華南永昌-民權,2024-03-21,9312
2603,長榮,36,14,22,華南永昌-民權,2024-03-21,9312
00795B,中信美國公債20年,20,0,20,華南永昌-民權,2024-03-21,9312
2009,第一銅,20,0,20,華南永昌-民權,2024-03-21,9312
8436,大江,15,0,15,華南永昌-民權,2024-03-21,9312
2888,新光金,15,0,15,華南永昌-民權,2024-03-21,9312
00679B,元大美債20年,14,0,14,華南永昌-民權,2024-03-21,9312
3005,神基,23,9,14,華南永昌-民權,2024-03-21,9312
00687B,國泰20年美債,14,0,14,華南永昌-民權,2024-03-21,9312
1301,台塑,19,5,14,華南永昌-民權,2024-03-21,9312
5469,瀚宇博,25,11,14,華南永昌-民權,2024-03-21,9312
3652,精聯,13,0,13,華南永昌-民權,2024-03-21,9312
3706,神達,44,33,11,華南永昌-民權,2024-03-21,9312
2454,聯發科,10,0,10,華南永昌-民權,2024-03-21,9312
2206,三陽工業,10,0,10,華南永昌-民權,2024-03-21,9312
00713,元大台灣高息低波,10,0,10,華南永昌-民權,2024-03-21,9312
00725B,國泰投資級公司債,12,2,10,華南永昌-民權,2024-03-21,9312
1907,永豐餘,10,0,10,華南永昌-民權,2024-03-21,9312
2520,冠德,10,0,10,華南永昌-民權,2024-03-21,9312
4526,東台,10,0,10,華南永昌-民權,2024-03-21,9312
5340,建榮,10,0,10,華南永昌-民權,2024-03-21,9312
6176,瑞儀,11,2,9,華南永昌-民權,2024-03-21,9312
8210,勤誠,8,0,8,華南永昌-民權,2024-03-21,9312
3694,海華,11,4,7,華南永昌-民權,2024-03-21,9312
2409,友達,16,9,7,華南永昌-民權,2024-03-21,9312
00918,大華優利高填息30,6,0,6,華南永昌-民權,2024-03-21,9312
4958,臻鼎-KY,7,1,6,華南永昌-民權,2024-03-21,9312
1303,南亞,6,0,6,華南永昌-民權,2024-03-21,9312
2369,菱生,11,5,6,華南永昌-民權,2024-03-21,9312
2618,長榮航,6,0,6,華南永昌-民權,2024-03-21,9312
4303,信立,29,23,6,華南永昌-民權,2024-03-21,9312
00751B,元大AAA至A公司債,5,0,5,華南永昌-民權,2024-03-21,9312
00764B,群益25年美債,5,0,5,華南永昌-民權,2024-03-21,9312
00937B,群益ESG投等債20,5,0,5,華南永昌-民權,2024-03-21,9312
1409,新纖,5,0,5,華南永昌-民權,2024-03-21,9312
1733,五鼎,5,0,5,華南永昌-民權,2024-03-21,9312
3481,群創,930,46,884,華南永昌-民權,2024-03-22,9312
00937B,群益ESG投等債20,142,0,142,華南永昌-民權,2024-03-22,9312
00929,復華台灣科技優息,141,11,130,華南永昌-民權,2024-03-22,9312
2101,南港,100,0,100,華南永昌-民權,2024-03-22,9312
4123,晟德,100,0,100,華南永昌-民權,2024-03-22,9312
2002,中鋼,83,0,83,華南永昌-民權,2024-03-22,9312
00939,統一台灣高息動能,106,37,69,華南永昌-民權,2024-03-22,9312
2027,大成鋼,60,0,60,華南永昌-民權,2024-03-22,9312
2102,泰豐,55,0,55,華南永昌-民權,2024-03-22,9312
2344,華邦電,322,280,42,華南永昌-民權,2024-03-22,9312
1409,新纖,30,0,30,華南永昌-民權,2024-03-22,9312
8436,大江,30,0,30,華南永昌-民權,2024-03-22,9312
00933B,國泰10Y+金融債,29,0,29,華南永昌-民權,2024-03-22,9312
3322,建舜電,28,0,28,華南永昌-民權,2024-03-22,9312
2353,宏��,47,21,26,華南永昌-民權,2024-03-22,9312
2323,中環,42,19,23,華南永昌-民權,2024-03-22,9312
2337,旺宏,23,2,21,華南永昌-民權,2024-03-22,9312
1907,永豐餘,20,0,20,華南永昌-民權,2024-03-22,9312
3706,神達,68,48,20,華南永昌-民權,2024-03-22,9312
2369,菱生,21,3,18,華南永昌-民權,2024-03-22,9312
2303,聯電,24,7,17,華南永昌-民權,2024-03-22,9312
4939,亞電,17,0,17,華南永昌-民權,2024-03-22,9312
2461,光群雷,15,0,15,華南永昌-民權,2024-03-22,9312
5871,中租-KY,14,0,14,華南永昌-民權,2024-03-22,9312
4529,淳紳,12,0,12,華南永昌-民權,2024-03-22,9312
2317,鴻海,19,7,12,華南永昌-民權,2024-03-22,9312
00918,大華優利高填息30,30,19,11,華南永昌-民權,2024-03-22,9312
2603,長榮,12,1,11,華南永昌-民權,2024-03-22,9312
00900,富邦特選高股息30,12,1,11,華南永昌-民權,2024-03-22,9312
1210,大成,11,0,11,華南永昌-民權,2024-03-22,9312
4121,優盛,12,1,11,華南永昌-民權,2024-03-22,9312
1108,幸福,10,0,10,華南永昌-民權,2024-03-22,9312
2324,仁寶,13,3,10,華南永昌-民權,2024-03-22,9312
8027,鈦昇,10,0,10,華南永昌-民權,2024-03-22,9312
2754,亞洲藏壽司,9,0,9,華南永昌-民權,2024-03-22,9312
00941,中信上游半導體,12,4,8,華南永昌-民權,2024-03-22,9312
1513,中興電,20,12,8,華南永昌-民權,2024-03-22,9312
00712,復華富時不動產,30,22,8,華南永昌-民權,2024-03-22,9312
1101,台泥,9,1,8,華南永昌-民權,2024-03-22,9312
2329,華泰,12,4,8,華南永昌-民權,2024-03-22,9312
2449,京元電子,20,12,8,華南永昌-民權,2024-03-22,9312
3712,永崴投控,15,7,8,華南永昌-民權,2024-03-22,9312
2374,佳能,21,14,7,華南永昌-民權,2024-03-22,9312
2405,輔信,7,0,7,華南永昌-民權,2024-03-22,9312
2609,陽明,7,1,6,華南永昌-民權,2024-03-22,9312
00687B,國泰20年美債,6,0,6,華南永昌-民權,2024-03-22,9312
3083,網龍,9,3,6,華南永昌-民權,2024-03-22,9312
6477,安集,8,2,6,華南永昌-民權,2024-03-22,9312
8096,擎亞,6,0,6,華南永昌-民權,2024-03-22,9312
8110,華東,7,1,6,華南永昌-民權,2024-03-22,9312
2356,英業達,538,20,518,華南永昌-民權,2024-03-25,9312
2101,南港,500,5,495,華南永昌-民權,2024-03-25,9312
2603,長榮,252,18,234,華南永昌-民權,2024-03-25,9312
00937B,群益ESG投等債20,157,1,156,華南永昌-民權,2024-03-25,9312
1609,大亞,152,42,110,華南永昌-民權,2024-03-25,9312
2515,中工,100,10,90,華南永昌-民權,2024-03-25,9312
5340,建榮,66,0,66,華南永昌-民權,2024-03-25,9312
00919,群益台灣精選高息,100,36,64,華南永昌-民權,2024-03-25,9312
4939,亞電,67,5,62,華南永昌-民權,2024-03-25,9312
2027,大成鋼,29,0,29,華南永昌-民權,2024-03-25,9312
5905,南仁湖,25,0,25,華南永昌-民權,2024-03-25,9312
00929,復華台灣科技優息,33,8,25,華南永昌-民權,2024-03-25,9312
1584,精剛,20,0,20,華南永昌-民權,2024-03-25,9312
2836,高雄銀,20,0,20,華南永昌-民權,2024-03-25,9312
6152,百一,20,0,20,華南永昌-民權,2024-03-25,9312
3294,英濟,28,9,19,華南永昌-民權,2024-03-25,9312
1612,宏泰,18,0,18,華南永昌-民權,2024-03-25,9312
3706,神達,24,6,18,華南永昌-民權,2024-03-25,9312
4960,誠美材,16,0,16,華南永昌-民權,2024-03-25,9312
2208,台船,15,0,15,華南永昌-民權,2024-03-25,9312
2409,友達,25,11,14,華南永昌-民權,2024-03-25,9312
1504,東元,13,0,13,華南永昌-民權,2024-03-25,9312
8926,台汽電,12,0,12,華南永昌-民權,2024-03-25,9312
1409,新纖,10,0,10,華南永昌-民權,2024-03-25,9312
3567,逸昌,10,0,10,華南永昌-民權,2024-03-25,9312
5498,凱崴,10,0,10,華南永昌-民權,2024-03-25,9312
4979,華星光,11,1,10,華南永昌-民權,2024-03-25,9312
00712,復華富時不動產,13,5,8,華南永昌-民權,2024-03-25,9312
00680L,元大美債20正2,10,2,8,華南永昌-民權,2024-03-25,9312
2359,所羅門,10,2,8,華南永昌-民權,2024-03-25,9312
2408,南亞科,13,6,7,華南永昌-民權,2024-03-25,9312
00795B,中信美國公債20年,7,0,7,華南永昌-民權,2024-03-25,9312
3234,光環,8,1,7,華南永昌-民權,2024-03-25,9312
5347,世界,13,6,7,華南永昌-民權,2024-03-25,9312
5439,高技,18,11,7,華南永昌-民權,2024-03-25,9312
2367,燿華,16,10,6,華南永昌-民權,2024-03-25,9312
2354,鴻準,9,3,6,華南永昌-民權,2024-03-25,9312
2886,兆豐金,6,1,5,華南永昌-民權,2024-03-25,9312
2301,光寶科,7,2,5,華南永昌-民權,2024-03-25,9312
2308,台達電,8,3,5,華南永昌-民權,2024-03-25,9312
3010,華立,5,0,5,華南永昌-民權,2024-03-25,9312
3593,力銘,5,0,5,華南永昌-民權,2024-03-25,9312
3708,上緯投控,9,4,5,華南永昌-民權,2024-03-25,9312
6186,新潤,5,0,5,華南永昌-民權,2024-03-25,9312
2009,第一銅,10,5,5,華南永昌-民權,2024-03-25,9312
3231,緯創,8,4,4,華南永昌-民權,2024-03-25,9312
3163,波若威,15,11,4,華南永昌-民權,2024-03-25,9312
00725B,國泰投資級公司債,4,0,4,華南永昌-民權,2024-03-25,9312
2324,仁寶,8,4,4,華南永昌-民權,2024-03-25,9312
2337,旺宏,4,0,4,華南永昌-民權,2024-03-25,9312
2880,華南金,401,26,375,華南永昌-民權,2024-03-26,9312
2834,臺企銀,400,33,367,華南永昌-民權,2024-03-26,9312
2356,英業達,220,20,200,華南永昌-民權,2024-03-26,9312
00720B,元大投資級公司債,200,0,200,華南永昌-民權,2024-03-26,9312
5905,南仁湖,95,0,95,華南永昌-民權,2024-03-26,9312
2537,聯上發,103,11,92,華南永昌-民權,2024-03-26,9312
00937B,群益ESG投等債20,113,29,84,華南永昌-民權,2024-03-26,9312
00939,統一台灣高息動能,86,12,74,華南永昌-民權,2024-03-26,9312
2511,太子,70,0,70,華南永昌-民權,2024-03-26,9312
2618,長榮航,68,1,67,華南永昌-民權,2024-03-26,9312
2365,昆盈,67,1,66,華南永昌-民權,2024-03-26,9312
3481,群創,69,8,61,華南永昌-民權,2024-03-26,9312
8437,大地-KY,41,0,41,華南永昌-民權,2024-03-26,9312
6005,群益證,32,0,32,華南永昌-民權,2024-03-26,9312
00929,復華台灣科技優息,72,41,31,華南永昌-民權,2024-03-26,9312
2851,中再保,30,0,30,華南永昌-民權,2024-03-26,9312
4905,台聯電,30,0,30,華南永昌-民權,2024-03-26,9312
5864,致和證,30,0,30,華南永昌-民權,2024-03-26,9312
6016,康和證,30,0,30,華南永昌-民權,2024-03-26,9312
6026,福邦證,30,0,30,華南永昌-民權,2024-03-26,9312
2002,中鋼,33,6,27,華南永昌-民權,2024-03-26,9312
3265,台星科,26,0,26,華南永昌-民權,2024-03-26,9312
6290,良維,24,0,24,華南永昌-民權,2024-03-26,9312
3231,緯創,28,7,21,華南永昌-民權,2024-03-26,9312
1528,恩德,20,0,20,華南永昌-民權,2024-03-26,9312
1584,精剛,20,0,20,華南永昌-民權,2024-03-26,9312
2101,南港,20,0,20,華南永昌-民權,2024-03-26,9312
8110,華東,20,0,20,華南永昌-民權,2024-03-26,9312
6274,台燿,33,13,20,華南永昌-民權,2024-03-26,9312
00751B,元大AAA至A公司債,17,0,17,華南永昌-民權,2024-03-26,9312
1513,中興電,44,27,17,華南永昌-民權,2024-03-26,9312
2812,台中銀,24,7,17,華南永昌-民權,2024-03-26,9312
2344,華邦電,20,6,14,華南永昌-民權,2024-03-26,9312
2417,圓剛,25,12,13,華南永昌-民權,2024-03-26,9312
6770,力積電,13,0,13,華南永昌-民權,2024-03-26,9312
5483,中美晶,11,0,11,華南永昌-民權,2024-03-26,9312
2313,華通,10,0,10,華南永昌-民權,2024-03-26,9312
1409,新纖,10,0,10,華南永昌-民權,2024-03-26,9312
1529,樂事綠能,12,2,10,華南永昌-民權,2024-03-26,9312
2867,三商壽,10,0,10,華南永昌-民權,2024-03-26,9312
3260,威剛,15,5,10,華南永昌-民權,2024-03-26,9312
4513,福裕,10,0,10,華南永昌-民權,2024-03-26,9312
4906,正文,11,1,10,華南永昌-民權,2024-03-26,9312
9946,三發地產,10,0,10,華南永昌-民權,2024-03-26,9312
2883B,凱基金乙特,10,0,10,華南永昌-民權,2024-03-26,9312
8112,至上,12,3,9,華南永昌-民權,2024-03-26,9312
4938,和碩,9,1,8,華南永昌-民權,2024-03-26,9312
2605,新興,7,0,7,華南永昌-民權,2024-03-26,9312
6125,廣運,26,19,7,華南永昌-民權,2024-03-26,9312
2388,威盛,8,2,6,華南永昌-民權,2024-03-26,9312
00877,復華中國5G,202,0,202,華南永昌-民權,2024-03-27,9312
2836,高雄銀,150,1,149,華南永昌-民權,2024-03-27,9312
00680L,元大美債20正2,100,1,99,華南永昌-民權,2024-03-27,9312
2101,南港,80,0,80,華南永昌-民權,2024-03-27,9312
00939,統一台灣高息動能,70,16,54,華南永昌-民權,2024-03-27,9312
00919,群益台灣精選高息,101,54,47,華南永昌-民權,2024-03-27,9312
1609,大亞,49,14,35,華南永昌-民權,2024-03-27,9312
5905,南仁湖,35,0,35,華南永昌-民權,2024-03-27,9312
2301,光寶科,36,4,32,華南永昌-民權,2024-03-27,9312
2356,英業達,58,32,26,華南永昌-民權,2024-03-27,9312
8070,長華*,25,0,25,華南永昌-民權,2024-03-27,9312
1540,喬福,20,0,20,華南永昌-民權,2024-03-27,9312
4905,台聯電,20,0,20,華南永昌-民權,2024-03-27,9312
9933,中鼎,19,2,17,華南永昌-民權,2024-03-27,9312
1314,中石化,30,13,17,華南永昌-民權,2024-03-27,9312
1513,中興電,27,11,16,華南永昌-民權,2024-03-27,9312
2367,燿華,26,11,15,華南永昌-民權,2024-03-27,9312
2399,映泰,15,0,15,華南永昌-民權,2024-03-27,9312
00929,復華台灣科技優息,18,4,14,華南永昌-民權,2024-03-27,9312
1608,華榮,55,41,14,華南永昌-民權,2024-03-27,9312
00878,國泰永續高股息,13,1,12,華南永昌-民權,2024-03-27,9312
2354,鴻準,20,10,10,華南永昌-民權,2024-03-27,9312
3042,晶技,10,0,10,華南永昌-民權,2024-03-27,9312
2409,友達,12,3,9,華南永昌-民權,2024-03-27,9312
2464,盟立,12,3,9,華南永昌-民權,2024-03-27,9312
5340,建榮,9,0,9,華南永昌-民權,2024-03-27,9312
00933B,國泰10Y+金融債,8,0,8,華南永昌-民權,2024-03-27,9312
1808,潤隆,11,4,7,華南永昌-民權,2024-03-27,9312
6770,力積電,11,4,7,華南永昌-民權,2024-03-27,9312
2610,華航,9,2,7,華南永昌-民權,2024-03-27,9312
3163,波若威,10,3,7,華南永昌-民權,2024-03-27,9312
3494,誠研,7,0,7,華南永昌-民權,2024-03-27,9312
3231,緯創,10,4,6,華南永昌-民權,2024-03-27,9312
00679B,元大美債20年,6,0,6,華南永昌-民權,2024-03-27,9312
4906,正文,7,1,6,華南永昌-民權,2024-03-27,9312
5515,建國,12,6,6,華南永昌-民權,2024-03-27,9312
1785,光洋科,5,0,5,華南永昌-民權,2024-03-27,9312
3013,晟銘電,6,1,5,華南永昌-民權,2024-03-27,9312
3234,光環,6,1,5,華南永昌-民權,2024-03-27,9312
3625,西勝,5,0,5,華南永昌-民權,2024-03-27,9312
4561,健椿,5,0,5,華南永昌-民權,2024-03-27,9312
5351,鈺創,5,0,5,華南永昌-民權,2024-03-27,9312
2609,陽明,6,2,4,華南永昌-民權,2024-03-27,9312
6488,環球晶,6,2,4,華南永昌-民權,2024-03-27,9312
00937B,群益ESG投等債20,4,0,4,華南永昌-民權,2024-03-27,9312
00712,復華富時不動產,4,0,4,華南永昌-民權,2024-03-27,9312
1810,和成,4,0,4,華南永昌-民權,2024-03-27,9312
2412,中華電,5,1,4,華南永昌-民權,2024-03-27,9312
2887,台新金,4,0,4,華南永昌-民權,2024-03-27,9312
2465,麗臺,3,0,3,華南永昌-民權,2024-03-27,9312
2834,臺企銀,702,0,702,華南永昌-民權,2024-03-28,9312
2880,華南金,303,0,303,華南永昌-民權,2024-03-28,9312
2356,英業達,324,25,299,華南永昌-民權,2024-03-28,9312
00919,群益台灣精選高息,64,3,61,華南永昌-民權,2024-03-28,9312
2883,凱基金,46,0,46,華南永昌-民權,2024-03-28,9312
00937B,群益ESG投等債20,37,0,37,華南永昌-民權,2024-03-28,9312
00687B,國泰20年美債,31,0,31,華南永昌-民權,2024-03-28,9312
4526,東台,26,0,26,華南永昌-民權,2024-03-28,9312
8111,立��,37,11,26,華南永昌-民權,2024-03-28,9312
00933B,國泰10Y+金融債,25,0,25,華南永昌-民權,2024-03-28,9312
2367,燿華,37,12,25,華南永昌-民權,2024-03-28,9312
2301,光寶科,28,4,24,華南永昌-民權,2024-03-28,9312
4979,華星光,23,1,22,華南永昌-民權,2024-03-28,9312
00772B,中信高評級公司債,21,0,21,華南永昌-民權,2024-03-28,9312
8255,朋程,20,0,20,華南永昌-民權,2024-03-28,9312
1326,台化,20,0,20,華南永昌-民權,2024-03-28,9312
2101,南港,20,0,20,華南永昌-民權,2024-03-28,9312
3652,精聯,20,0,20,華南永昌-民權,2024-03-28,9312
2303,聯電,26,14,12,華南永昌-民權,2024-03-28,9312
2420,新巨,12,0,12,華南永昌-民權,2024-03-28,9312
2812,台中銀,12,0,12,華南永昌-民權,2024-03-28,9312
5351,鈺創,11,0,11,華南永昌-民權,2024-03-28,9312
1210,大成,10,0,10,華南永昌-民權,2024-03-28,9312
1303,南亞,10,0,10,華南永昌-民權,2024-03-28,9312
1725,元禎,10,0,10,華南永昌-民權,2024-03-28,9312
2365,昆盈,11,1,10,華南永昌-民權,2024-03-28,9312
4513,福裕,10,0,10,華南永昌-民權,2024-03-28,9312
6168,宏齊,10,0,10,華南永昌-民權,2024-03-28,9312
8150,南茂,12,2,10,華南永昌-民權,2024-03-28,9312
3005,神基,10,2,8,華南永昌-民權,2024-03-28,9312
1565,精華,8,0,8,華南永昌-民權,2024-03-28,9312
4127,天良,8,0,8,華南永昌-民權,2024-03-28,9312
00679B,元大美債20年,7,0,7,華南永昌-民權,2024-03-28,9312
1905,華紙,7,0,7,華南永昌-民權,2024-03-28,9312
2362,藍天,7,0,7,華南永昌-民權,2024-03-28,9312
2609,陽明,7,0,7,華南永昌-民權,2024-03-28,9312
1603,華電,8,2,6,華南永昌-民權,2024-03-28,9312
2353,宏��,10,4,6,華南永昌-民權,2024-03-28,9312
1612,宏泰,7,1,6,華南永昌-民權,2024-03-28,9312
2405,輔信,8,2,6,華南永昌-民權,2024-03-28,9312
2884,玉山金,6,0,6,華南永昌-民權,2024-03-28,9312
3027,盛達,6,0,6,華南永昌-民權,2024-03-28,9312
1609,大亞,27,21,6,華南永昌-民權,2024-03-28,9312
2317,鴻海,23,17,6,華南永昌-民權,2024-03-28,9312
1532,勤美,5,0,5,華南永昌-民權,2024-03-28,9312
2392,正崴,8,3,5,華南永昌-民權,2024-03-28,9312
2413,環科,5,0,5,華南永昌-民權,2024-03-28,9312
3090,日電貿,5,0,5,華南永昌-民權,2024-03-28,9312
5340,建榮,5,0,5,華南永昌-民權,2024-03-28,9312
6284,佳邦,5,0,5,華南永昌-民權,2024-03-28,9312
1101,台泥,161,4,157,華南永昌-民權,2024-03-29,9312
00939,統一台灣高息動能,61,7,54,華南永昌-民權,2024-03-29,9312
2027,大成鋼,56,4,52,華南永昌-民權,2024-03-29,9312
00933B,國泰10Y+金融債,50,10,40,華南永昌-民權,2024-03-29,9312
2887,台新金,33,0,33,華南永昌-民權,2024-03-29,9312
2303,聯電,50,20,30,華南永昌-民權,2024-03-29,9312
1513,中興電,42,12,30,華南永昌-民權,2024-03-29,9312
2836,高雄銀,60,30,30,華南永昌-民權,2024-03-29,9312
4905,台聯電,30,0,30,華南永昌-民權,2024-03-29,9312
00915,凱基優選高股息30,27,1,26,華南永昌-民權,2024-03-29,9312
2882,國泰金,26,1,25,華南永昌-民權,2024-03-29,9312
5340,建榮,25,0,25,華南永昌-民權,2024-03-29,9312
2365,昆盈,21,0,21,華南永昌-民權,2024-03-29,9312
2371,大同,29,9,20,華南永昌-民權,2024-03-29,9312
00919,群益台灣精選高息,25,7,18,華南永昌-民權,2024-03-29,9312
1616,億泰,17,0,17,華南永昌-民權,2024-03-29,9312
2312,金寶,16,0,16,華南永昌-民權,2024-03-29,9312
2408,南亞科,23,7,16,華南永昌-民權,2024-03-29,9312
00929,復華台灣科技優息,18,3,15,華南永昌-民權,2024-03-29,9312
8110,華東,36,22,14,華南永昌-民權,2024-03-29,9312
2301,光寶科,22,9,13,華南永昌-民權,2024-03-29,9312
00687B,國泰20年美債,13,0,13,華南永昌-民權,2024-03-29,9312
2324,仁寶,14,1,13,華南永昌-民權,2024-03-29,9312
4533,協易機,13,0,13,華南永昌-民權,2024-03-29,9312
2630,亞航,12,0,12,華南永昌-民權,2024-03-29,9312
3044,健鼎,12,0,12,華南永昌-民權,2024-03-29,9312
6443,元晶,11,0,11,華南永昌-民權,2024-03-29,9312
3042,晶技,11,0,11,華南永昌-民權,2024-03-29,9312
3715,定穎投控,11,0,11,華南永昌-民權,2024-03-29,9312
1316,上曜,10,0,10,華南永昌-民權,2024-03-29,9312
2328,廣宇,11,1,10,華南永昌-民權,2024-03-29,9312
2634,漢翔,11,1,10,華南永昌-民權,2024-03-29,9312
3025,星通,12,2,10,華南永昌-民權,2024-03-29,9312
3652,精聯,10,0,10,華南永昌-民權,2024-03-29,9312
6187,萬潤,10,0,10,華南永昌-民權,2024-03-29,9312
8112,至上,13,3,10,華南永昌-民權,2024-03-29,9312
4513,福裕,8,0,8,華南永昌-民權,2024-03-29,9312
2382,廣達,27,20,7,華南永昌-民權,2024-03-29,9312
2352,佳世達,23,16,7,華南永昌-民權,2024-03-29,9312
2420,新巨,7,0,7,華南永昌-民權,2024-03-29,9312
2492,華新科,7,1,6,華南永昌-民權,2024-03-29,9312
2537,聯上發,6,0,6,華南永昌-民權,2024-03-29,9312
5351,鈺創,6,0,6,華南永昌-民權,2024-03-29,9312
8033,雷虎,6,0,6,華南永昌-民權,2024-03-29,9312
00885,富邦越南,5,0,5,華南永昌-民權,2024-03-29,9312
1806,冠軍,5,0,5,華南永昌-民權,2024-03-29,9312
2363,矽統,5,0,5,華南永昌-民權,2024-03-29,9312
3041,揚智,5,0,5,華南永昌-民權,2024-03-29,9312
3090,日電貿,5,0,5,華南永昌-民權,2024-03-29,9312
3576,聯合再生,5,0,5,華南永昌-民權,2024-03-29,9312
00940,元大台灣價值高息,936,72,864,華南永昌-民權,2024-04-01,9312
1101,台泥,189,10,179,華南永昌-民權,2024-04-01,9312
5512,力麒,70,0,70,華南永昌-民權,2024-04-01,9312
0056,元大高股息,64,10,54,華南永昌-民權,2024-04-01,9312
00878,國泰永續高股息,62,11,51,華南永昌-民權,2024-04-01,9312
2027,大成鋼,41,0,41,華南永昌-民權,2024-04-01,9312
6207,雷科,41,1,40,華南永昌-民權,2024-04-01,9312
2353,宏��,38,1,37,華南永昌-民權,2024-04-01,9312
00939,統一台灣高息動能,38,5,33,華南永昌-民權,2024-04-01,9312
4905,台聯電,30,0,30,華南永昌-民權,2024-04-01,9312
5905,南仁湖,29,0,29,華南永昌-民權,2024-04-01,9312
6443,元晶,24,0,24,華南永昌-民權,2024-04-01,9312
00941,中信上游半導體,24,3,21,華南永昌-民權,2024-04-01,9312
2330,台積電,20,0,20,華南永昌-民權,2024-04-01,9312
1504,東元,16,2,14,華南永昌-民權,2024-04-01,9312
2362,藍天,16,2,14,華南永昌-民權,2024-04-01,9312
3481,群創,20,6,14,華南永昌-民權,2024-04-01,9312
2356,英業達,20,8,12,華南永昌-民權,2024-04-01,9312
00933B,國泰10Y+金融債,12,0,12,華南永昌-民權,2024-04-01,9312
2603,長榮,12,1,11,華南永昌-民權,2024-04-01,9312
00918,大華優利高填息30,11,0,11,華南永昌-民權,2024-04-01,9312
00936,台新永續高息中小,11,0,11,華南永昌-民權,2024-04-01,9312
6187,萬潤,11,0,11,華南永昌-民權,2024-04-01,9312
00752,中信中國50,10,0,10,華南永昌-民權,2024-04-01,9312
2408,南亞科,24,14,10,華南永昌-民權,2024-04-01,9312
3038,全台,10,0,10,華南永昌-民權,2024-04-01,9312
2834,臺企銀,15,6,9,華南永昌-民權,2024-04-01,9312
3372,典範,9,1,8,華南永昌-民權,2024-04-01,9312
00937B,群益ESG投等債20,7,0,7,華南永昌-民權,2024-04-01,9312
3231,緯創,19,12,7,華南永昌-民權,2024-04-01,9312
3711,日月光投控,7,1,6,華南永昌-民權,2024-04-01,9312
6488,環球晶,6,0,6,華南永昌-民權,2024-04-01,9312
2537,聯上發,10,4,6,華南永昌-民權,2024-04-01,9312
2743,山富,6,0,6,華南永昌-民權,2024-04-01,9312
3062,建漢,6,0,6,華南永昌-民權,2024-04-01,9312
3163,波若威,7,1,6,華南永昌-民權,2024-04-01,9312
3703,欣陸,6,0,6,華南永昌-民權,2024-04-01,9312
9105,泰金寶-DR,6,0,6,華南永昌-民權,2024-04-01,9312
00632R,元大台灣50反1,5,0,5,華南永昌-民權,2024-04-01,9312
4402,郡都開發,5,0,5,華南永昌-民權,2024-04-01,9312
4952,凌通,5,0,5,華南永昌-民權,2024-04-01,9312
6715,嘉基,5,0,5,華南永昌-民權,2024-04-01,9312
6284,佳邦,5,0,5,華南永昌-民權,2024-04-01,9312
00885,富邦越南,5,1,4,華南永昌-民權,2024-04-01,9312
2371,大同,15,11,4,華南永昌-民權,2024-04-01,9312
2611,志信,4,0,4,華南永昌-民權,2024-04-01,9312
2812,台中銀,4,0,4,華南永昌-民權,2024-04-01,9312
2890,永豐金,5,1,4,華南永昌-民權,2024-04-01,9312
6139,亞翔,20,16,4,華南永昌-民權,2024-04-01,9312
6505,台塑化,5,1,4,華南永昌-民權,2024-04-01,9312
00940,元大台灣價值高息,225,9,216,華南永昌-民權,2024-04-02,9312
2887,台新金,168,0,168,華南永昌-民權,2024-04-02,9312
00632R,元大台灣50反1,106,0,106,華南永昌-民權,2024-04-02,9312
5905,南仁湖,70,0,70,華南永昌-民權,2024-04-02,9312
1806,冠軍,53,0,53,華南永昌-民權,2024-04-02,9312
00733,富邦臺灣中小,52,0,52,華南永昌-民權,2024-04-02,9312
4905,台聯電,40,0,40,華南永昌-民權,2024-04-02,9312
2547,日勝生,40,2,38,華南永昌-民權,2024-04-02,9312
2408,南亞科,36,3,33,華南永昌-民權,2024-04-02,9312
00937B,群益ESG投等債20,38,6,32,華南永昌-民權,2024-04-02,9312
00929,復華台灣科技優息,76,47,29,華南永昌-民權,2024-04-02,9312
00633L,富邦上証正2,25,0,25,華南永昌-民權,2024-04-02,9312
00687B,國泰20年美債,19,0,19,華南永昌-民權,2024-04-02,9312
2354,鴻準,35,16,19,華南永昌-民權,2024-04-02,9312
2489,瑞軒,26,7,19,華南永昌-民權,2024-04-02,9312
1101,台泥,17,0,17,華南永昌-民權,2024-04-02,9312
5340,建榮,18,2,16,華南永昌-民權,2024-04-02,9312
2504,國產,20,5,15,華南永昌-民權,2024-04-02,9312
6901,鑽石投資,15,0,15,華南永昌-民權,2024-04-02,9312
2367,燿華,16,4,12,華南永昌-民權,2024-04-02,9312
6138,茂達,12,0,12,華南永昌-民權,2024-04-02,9312
2353,宏��,13,1,12,華南永昌-民權,2024-04-02,9312
2888,新光金,11,0,11,華南永昌-民權,2024-04-02,9312
00752,中信中國50,10,0,10,華南永昌-民權,2024-04-02,9312
3059,華晶科,10,0,10,華南永昌-民權,2024-04-02,9312
1905,華紙,9,0,9,華南永昌-民權,2024-04-02,9312
2883B,凱基金乙特,9,0,9,華南永昌-民權,2024-04-02,9312
3363,上詮,9,0,9,華南永昌-民權,2024-04-02,9312
2356,英業達,25,17,8,華南永昌-民權,2024-04-02,9312
00679B,元大美債20年,8,0,8,華南永昌-民權,2024-04-02,9312
00941,中信上游半導體,8,0,8,華南永昌-民權,2024-04-02,9312
3706,神達,7,0,7,華南永昌-民權,2024-04-02,9312
2812,台中銀,7,0,7,華南永昌-民權,2024-04-02,9312
2630,亞航,6,0,6,華南永昌-民權,2024-04-02,9312
3293,鈊象,6,0,6,華南永昌-民權,2024-04-02,9312
00882,中信中國高股息,5,0,5,華南永昌-民權,2024-04-02,9312
00712,復華富時不動產,5,0,5,華南永昌-民權,2024-04-02,9312
00927,群益半導體收益,5,0,5,華南永昌-民權,2024-04-02,9312
1444,力麗,5,0,5,華南永昌-民權,2024-04-02,9312
2329,華泰,5,0,5,華南永昌-民權,2024-04-02,9312
2344,華邦電,6,1,5,華南永昌-民權,2024-04-02,9312
2501,國建,5,0,5,華南永昌-民權,2024-04-02,9312
2634,漢翔,7,2,5,華南永昌-民權,2024-04-02,9312
6753,龍德造船,5,0,5,華南永昌-民權,2024-04-02,9312
2303,聯電,22,17,5,華南永昌-民權,2024-04-02,9312
6414,樺漢,4,0,4,華南永昌-民權,2024-04-02,9312
3017,奇鋐,7,3,4,華南永昌-民權,2024-04-02,9312
2368,金像電,5,1,4,華南永昌-民權,2024-04-02,9312
2363,矽統,4,0,4,華南永昌-民權,2024-04-02,9312
2603,長榮,9,5,4,華南永昌-民權,2024-04-02,9312
2880,華南金,204,0,204,華南永昌-民權,2024-04-03,9312
2887,台新金,106,5,101,華南永昌-民權,2024-04-03,9312
00940,元大台灣價值高息,114,20,94,華南永昌-民權,2024-04-03,9312
00929,復華台灣科技優息,66,4,62,華南永昌-民權,2024-04-03,9312
00939,統一台灣高息動能,55,5,50,華南永昌-民權,2024-04-03,9312
00937B,群益ESG投等債20,45,0,45,華南永昌-民權,2024-04-03,9312
4905,台聯電,32,0,32,華南永昌-民權,2024-04-03,9312
00941,中信上游半導體,22,1,21,華南永昌-民權,2024-04-03,9312
1540,喬福,20,0,20,華南永昌-民權,2024-04-03,9312
1815,富喬,20,0,20,華南永昌-民權,2024-04-03,9312
2362,藍天,20,0,20,華南永昌-民權,2024-04-03,9312
00918,大華優利高填息30,21,1,20,華南永昌-民權,2024-04-03,9312
00687B,國泰20年美債,23,4,19,華南永昌-民權,2024-04-03,9312
1616,億泰,19,0,19,華南永昌-民權,2024-04-03,9312
2014,中鴻,27,8,19,華南永昌-民權,2024-04-03,9312
2515,中工,39,22,17,華南永昌-民權,2024-04-03,9312
1609,大亞,37,21,16,華南永昌-民權,2024-04-03,9312
2892,第一金,18,2,16,華南永昌-民權,2024-04-03,9312
2330,台積電,26,10,16,華南永昌-民權,2024-04-03,9312
2601,益航,15,0,15,華南永昌-民權,2024-04-03,9312
2409,友達,17,3,14,華南永昌-民權,2024-04-03,9312
2317,鴻海,19,6,13,華南永昌-民權,2024-04-03,9312
2353,宏��,15,2,13,華南永昌-民權,2024-04-03,9312
4960,誠美材,14,2,12,華南永昌-民權,2024-04-03,9312
1101,台泥,11,0,11,華南永昌-民權,2024-04-03,9312
00712,復華富時不動產,11,0,11,華南永昌-民權,2024-04-03,9312
2382,廣達,15,5,10,華南永昌-民權,2024-04-03,9312
2420,新巨,10,0,10,華南永昌-民權,2024-04-03,9312
2486,一詮,43,33,10,華南永昌-民權,2024-04-03,9312
4513,福裕,10,0,10,華南永昌-民權,2024-04-03,9312
5880,合庫金,10,0,10,華南永昌-民權,2024-04-03,9312
8011,台通,10,0,10,華南永昌-民權,2024-04-03,9312
8112,至上,13,3,10,華南永昌-民權,2024-04-03,9312
1301,台塑,8,0,8,華南永昌-民權,2024-04-03,9312
1104,環泥,7,0,7,華南永昌-民權,2024-04-03,9312
2630,亞航,7,0,7,華南永昌-民權,2024-04-03,9312
0056,元大高股息,14,7,7,華南永昌-民權,2024-04-03,9312
2883,凱基金,7,0,7,華南永昌-民權,2024-04-03,9312
00935,野村臺灣新科技50,6,0,6,華南永昌-民權,2024-04-03,9312
00933B,國泰10Y+金融債,6,0,6,華南永昌-民權,2024-04-03,9312
00751B,元大AAA至A公司債,6,0,6,華南永昌-民權,2024-04-03,9312
2329,華泰,6,0,6,華南永昌-民權,2024-04-03,9312
4303,信立,6,0,6,華南永昌-民權,2024-04-03,9312
1524,耿鼎,22,16,6,華南永昌-民權,2024-04-03,9312
00679B,元大美債20年,5,0,5,華南永昌-民權,2024-04-03,9312
2303,聯電,9,4,5,華南永昌-民權,2024-04-03,9312
2851,中再保,5,0,5,華南永昌-民權,2024-04-03,9312
2301,光寶科,9,4,5,華南永昌-民權,2024-04-03,9312
00927,群益半導體收益,5,0,5,華南永昌-民權,2024-04-03,9312
00725B,國泰投資級公司債,5,0,5,華南永昌-民權,2024-04-03,9312
2344,華邦電,204,2,202,華南永昌-民權,2024-04-08,9312
5905,南仁湖,185,0,185,華南永昌-民權,2024-04-08,9312
00632R,元大台灣50反1,107,0,107,華南永昌-民權,2024-04-08,9312
6120,達運,136,29,107,華南永昌-民權,2024-04-08,9312
00933B,國泰10Y+金融債,103,30,73,華南永昌-民權,2024-04-08,9312
00937B,群益ESG投等債20,67,0,67,華南永昌-民權,2024-04-08,9312
2888,新光金,66,0,66,華南永昌-民權,2024-04-08,9312
00929,復華台灣科技優息,57,0,57,華南永昌-民權,2024-04-08,9312
3038,全台,50,0,50,華南永昌-民權,2024-04-08,9312
2408,南亞科,50,1,49,華南永昌-民權,2024-04-08,9312
00940,元大台灣價值高息,86,42,44,華南永昌-民權,2024-04-08,9312
00919,群益台灣精選高息,48,15,33,華南永昌-民權,2024-04-08,9312
4905,台聯電,32,0,32,華南永昌-民權,2024-04-08,9312
00687B,國泰20年美債,35,6,29,華南永昌-民權,2024-04-08,9312
6127,九豪,26,0,26,華南永昌-民權,2024-04-08,9312
00679B,元大美債20年,25,0,25,華南永昌-民權,2024-04-08,9312
9105,泰金寶-DR,22,0,22,華南永昌-民權,2024-04-08,9312
5410,國眾,21,0,21,華南永昌-民權,2024-04-08,9312
1312,國喬,20,0,20,華南永昌-民權,2024-04-08,9312
2630,亞航,20,0,20,華南永昌-民權,2024-04-08,9312
3265,台星科,22,2,20,華南永昌-民權,2024-04-08,9312
2610,華航,16,1,15,華南永昌-民權,2024-04-08,9312
2524,京城,15,0,15,華南永昌-民權,2024-04-08,9312
2851,中再保,15,0,15,華南永昌-民權,2024-04-08,9312
00927,群益半導體收益,12,0,12,華南永昌-民權,2024-04-08,9312
3481,群創,29,17,12,華南永昌-民權,2024-04-08,9312
2374,佳能,35,23,12,華南永昌-民權,2024-04-08,9312
2399,映泰,11,0,11,華南永昌-民權,2024-04-08,9312
2356,英業達,16,6,10,華南永昌-民權,2024-04-08,9312
00882,中信中國高股息,10,0,10,華南永昌-民權,2024-04-08,9312
00633L,富邦上証正2,10,0,10,華南永昌-民權,2024-04-08,9312
2314,台揚,10,0,10,華南永昌-民權,2024-04-08,9312
2353,宏��,10,0,10,華南永昌-民權,2024-04-08,9312
2867,三商壽,10,0,10,華南永昌-民權,2024-04-08,9312
6142,友勁,10,0,10,華南永昌-民權,2024-04-08,9312
3171,炎洲流通,8,0,8,華南永昌-民權,2024-04-08,9312
2371,大同,11,4,7,華南永昌-民權,2024-04-08,9312
3380,明泰,7,0,7,華南永昌-民權,2024-04-08,9312
2915,潤泰全,8,2,6,華南永昌-民權,2024-04-08,9312
4746,台耀,20,14,6,華南永昌-民權,2024-04-08,9312
6684,安格,14,8,6,華南永昌-民權,2024-04-08,9312
2382,廣達,7,1,6,華南永昌-民權,2024-04-08,9312
2362,藍天,6,1,5,華南永昌-民權,2024-04-08,9312
00637L,元大滬深300正2,85,80,5,華南永昌-民權,2024-04-08,9312
00636,國泰中國A50,5,0,5,華南永昌-民權,2024-04-08,9312
00725B,國泰投資級公司債,5,0,5,華南永昌-民權,2024-04-08,9312
1101,台泥,6,1,5,華南永昌-民權,2024-04-08,9312
1409,新纖,5,0,5,華南永昌-民權,2024-04-08,9312
1611,中電,5,0,5,華南永昌-民權,2024-04-08,9312
1612,宏泰,61,56,5,華南永昌-民權,2024-04-08,9312
3481,群創,381,27,354,華南永昌-民權,2024-04-09,9312
2880,華南金,305,3,302,華南永昌-民權,2024-04-09,9312
2344,華邦電,200,2,198,華南永昌-民權,2024-04-09,9312
3231,緯創,78,12,66,華南永昌-民權,2024-04-09,9312
00725B,國泰投資級公司債,50,0,50,華南永昌-民權,2024-04-09,9312
00940,元大台灣價值高息,55,6,49,華南永昌-民權,2024-04-09,9312
5340,建榮,46,13,33,華南永昌-民權,2024-04-09,9312
4905,台聯電,32,0,32,華南永昌-民權,2024-04-09,9312
2374,佳能,81,52,29,華南永昌-民權,2024-04-09,9312
3167,大量,22,0,22,華南永昌-民權,2024-04-09,9312
1314,中石化,77,56,21,華南永昌-民權,2024-04-09,9312
8437,大地-KY,20,0,20,華南永昌-民權,2024-04-09,9312
2915,潤泰全,19,0,19,華南永昌-民權,2024-04-09,9312
6005,群益證,21,2,19,華南永昌-民權,2024-04-09,9312
00632R,元大台灣50反1,18,0,18,華南永昌-民權,2024-04-09,9312
1608,華榮,40,23,17,華南永昌-民權,2024-04-09,9312
2515,中工,73,56,17,華南永昌-民權,2024-04-09,9312
4952,凌通,16,0,16,華南永昌-民權,2024-04-09,9312
1808,潤隆,12,0,12,華南永昌-民權,2024-04-09,9312
00937B,群益ESG投等債20,13,1,12,華南永昌-民權,2024-04-09,9312
2023,燁輝,12,0,12,華南永昌-民權,2024-04-09,9312
6163,華電網,13,1,12,華南永昌-民權,2024-04-09,9312
3037,欣興,15,4,11,華南永昌-民權,2024-04-09,9312
1616,億泰,15,4,11,華南永昌-民權,2024-04-09,9312
3576,聯合再生,10,0,10,華南永昌-民權,2024-04-09,9312
00939,統一台灣高息動能,11,1,10,華南永昌-民權,2024-04-09,9312
1312,國喬,10,0,10,華南永昌-民權,2024-04-09,9312
5864,致和證,10,0,10,華南永昌-民權,2024-04-09,9312
6016,康和證,10,0,10,華南永昌-民權,2024-04-09,9312
6026,福邦證,10,0,10,華南永昌-民權,2024-04-09,9312
6266,泰詠,10,0,10,華南永昌-民權,2024-04-09,9312
8049,晶采,10,0,10,華南永昌-民權,2024-04-09,9312
1513,中興電,39,30,9,華南永昌-民權,2024-04-09,9312
8936,國統,10,2,8,華南永昌-民權,2024-04-09,9312
2329,華泰,13,5,8,華南永昌-民權,2024-04-09,9312
8110,華東,10,2,8,華南永昌-民權,2024-04-09,9312
00929,復華台灣科技優息,20,12,8,華南永昌-民權,2024-04-09,9312
3491,昇達科,8,1,7,華南永昌-民權,2024-04-09,9312
2371,大同,16,9,7,華南永昌-民權,2024-04-09,9312
4402,郡都開發,7,0,7,華南永昌-民權,2024-04-09,9312
8112,至上,56,49,7,華南永昌-民權,2024-04-09,9312
3163,波若威,7,1,6,華南永昌-民權,2024-04-09,9312
2367,燿華,14,8,6,華南永昌-民權,2024-04-09,9312
6284,佳邦,6,0,6,華南永昌-民權,2024-04-09,9312
2501,國建,37,31,6,華南永昌-民權,2024-04-09,9312
2547,日勝生,6,0,6,華南永昌-民權,2024-04-09,9312
6542,隆中,6,0,6,華南永昌-民權,2024-04-09,9312
9955,佳龍,6,0,6,華南永昌-民權,2024-04-09,9312
00927,群益半導體收益,5,0,5,華南永昌-民權,2024-04-09,9312
3038,全台,5,0,5,華南永昌-民權,2024-04-09,9312
2303,聯電,86,21,65,華南永昌-民權,2024-04-10,9312
00929,復華台灣科技優息,56,0,56,華南永昌-民權,2024-04-10,9312
6016,康和證,43,0,43,華南永昌-民權,2024-04-10,9312
00940,元大台灣價值高息,64,22,42,華南永昌-民權,2024-04-10,9312
2002,中鋼,55,23,32,華南永昌-民權,2024-04-10,9312
2836,高雄銀,30,0,30,華南永昌-民權,2024-04-10,9312
6026,福邦證,30,0,30,華南永昌-民權,2024-04-10,9312
2897,王道銀行,40,10,30,華南永昌-民權,2024-04-10,9312
00939,統一台灣高息動能,30,3,27,華南永昌-民權,2024-04-10,9312
8011,台通,25,0,25,華南永昌-民權,2024-04-10,9312
2367,燿華,33,11,22,華南永昌-民權,2024-04-10,9312
3706,神達,22,0,22,華南永昌-民權,2024-04-10,9312
00918,大華優利高填息30,20,0,20,華南永昌-民權,2024-04-10,9312
2915,潤泰全,20,0,20,華南永昌-民權,2024-04-10,9312
3188,鑫龍騰,20,0,20,華南永昌-民權,2024-04-10,9312
6129,普誠,20,0,20,華南永昌-民權,2024-04-10,9312
2509,全坤建,15,0,15,華南永昌-民權,2024-04-10,9312
00688L,國泰20年美債正2,14,0,14,華南永昌-民權,2024-04-10,9312
2486,一詮,151,137,14,華南永昌-民權,2024-04-10,9312
3576,聯合再生,19,5,14,華南永昌-民權,2024-04-10,9312
0056,元大高股息,18,5,13,華南永昌-民權,2024-04-10,9312
6122,擎邦,12,0,12,華南永昌-民權,2024-04-10,9312
5880,合庫金,11,0,11,華南永昌-民權,2024-04-10,9312
1504,東元,15,5,10,華南永昌-民權,2024-04-10,9312
1587,吉茂,11,1,10,華南永昌-民權,2024-04-10,9312
2511,太子,10,0,10,華南永昌-民權,2024-04-10,9312
2606,裕民,10,0,10,華南永昌-民權,2024-04-10,9312
3491,昇達科,10,0,10,華南永昌-民權,2024-04-10,9312
5864,致和證,10,0,10,華南永昌-民權,2024-04-10,9312
6126,信音,10,0,10,華南永昌-民權,2024-04-10,9312
8936,國統,10,0,10,華南永昌-民權,2024-04-10,9312
2515,中工,60,50,10,華南永昌-民權,2024-04-10,9312
2382,廣達,12,3,9,華南永昌-民權,2024-04-10,9312
2885,元大金,13,4,9,華南永昌-民權,2024-04-10,9312
2369,菱生,20,11,9,華南永昌-民權,2024-04-10,9312
8112,至上,18,9,9,華南永昌-民權,2024-04-10,9312
2317,鴻海,15,7,8,華南永昌-民權,2024-04-10,9312
2383,台光電,8,0,8,華南永昌-民權,2024-04-10,9312
2354,鴻準,26,19,7,華南永昌-民權,2024-04-10,9312
2014,中鴻,7,0,7,華南永昌-民權,2024-04-10,9312
5521,工信,7,0,7,華南永昌-民權,2024-04-10,9312
2618,長榮航,6,0,6,華南永昌-民權,2024-04-10,9312
2884,玉山金,6,0,6,華南永昌-民權,2024-04-10,9312
3056,富華新,6,0,6,華南永昌-民權,2024-04-10,9312
3306,鼎天,6,0,6,華南永昌-民權,2024-04-10,9312
3437,榮創,6,0,6,華南永昌-民權,2024-04-10,9312
3710,連展投控,6,0,6,華南永昌-民權,2024-04-10,9312
1503,士電,7,2,5,華南永昌-民權,2024-04-10,9312
3293,鈊象,5,0,5,華南永昌-民權,2024-04-10,9312
2609,陽明,7,2,5,華南永昌-民權,2024-04-10,9312
00680L,元大美債20正2,166,0,166,華南永昌-民權,2024-04-11,9312
2344,華邦電,152,1,151,華南永昌-民權,2024-04-11,9312
00929,復華台灣科技優息,100,36,64,華南永昌-民權,2024-04-11,9312
2027,大成鋼,46,0,46,華南永昌-民權,2024-04-11,9312
2371,大同,58,17,41,華南永昌-民權,2024-04-11,9312
2888,新光金,40,0,40,華南永昌-民權,2024-04-11,9312
6026,福邦證,40,0,40,華南永昌-民權,2024-04-11,9312
6016,康和證,42,5,37,華南永昌-民權,2024-04-11,9312
3576,聯合再生,36,3,33,華南永昌-民權,2024-04-11,9312
3706,神達,29,0,29,華南永昌-民權,2024-04-11,9312
1301,台塑,25,0,25,華南永昌-民權,2024-04-11,9312
00937B,群益ESG投等債20,35,13,22,華南永昌-民權,2024-04-11,9312
4167,松瑞藥,22,0,22,華南永昌-民權,2024-04-11,9312
1605,華新,23,2,21,華南永昌-民權,2024-04-11,9312
00918,大華優利高填息30,20,0,20,華南永昌-民權,2024-04-11,9312
00679B,元大美債20年,21,2,19,華南永昌-民權,2024-04-11,9312
6213,聯茂,21,2,19,華南永昌-民權,2024-04-11,9312
2630,亞航,20,3,17,華南永昌-民權,2024-04-11,9312
6126,信音,15,0,15,華南永昌-民權,2024-04-11,9312
8070,長華*,15,0,15,華南永昌-民權,2024-04-11,9312
2014,中鴻,14,0,14,華南永昌-民權,2024-04-11,9312
00940,元大台灣價值高息,14,1,13,華南永昌-民權,2024-04-11,9312
00687B,國泰20年美債,14,2,12,華南永昌-民權,2024-04-11,9312
3013,晟銘電,15,3,12,華南永昌-民權,2024-04-11,9312
5386,青雲,12,0,12,華南永昌-民權,2024-04-11,9312
2601,益航,12,0,12,華南永昌-民權,2024-04-11,9312
2409,友達,44,33,11,華南永昌-民權,2024-04-11,9312
2317,鴻海,17,7,10,華南永昌-民權,2024-04-11,9312
00933B,國泰10Y+金融債,10,0,10,華南永昌-民權,2024-04-11,9312
00753L,中信中國50正2,10,0,10,華南永昌-民權,2024-04-11,9312
00637L,元大滬深300正2,10,0,10,華南永昌-民權,2024-04-11,9312
1110,東泥,10,0,10,華南永昌-民權,2024-04-11,9312
2017,官田鋼,10,0,10,華南永昌-民權,2024-04-11,9312
2423,固緯,10,0,10,華南永昌-民權,2024-04-11,9312
2458,義隆,10,0,10,華南永昌-民權,2024-04-11,9312
2897,王道銀行,10,0,10,華南永昌-民權,2024-04-11,9312
5426,振發,60,50,10,華南永昌-民權,2024-04-11,9312
4513,福裕,10,0,10,華南永昌-民權,2024-04-11,9312
2303,聯電,19,9,10,華南永昌-民權,2024-04-11,9312
3481,群創,112,103,9,華南永昌-民權,2024-04-11,9312
2609,陽明,11,3,8,華南永昌-民權,2024-04-11,9312
2382,廣達,13,5,8,華南永昌-民權,2024-04-11,9312
00712,復華富時不動產,10,2,8,華南永昌-民權,2024-04-11,9312
00773B,中信優先金融債,8,0,8,華南永昌-民權,2024-04-11,9312
1609,大亞,15,7,8,華南永昌-民權,2024-04-11,9312
2489,瑞軒,8,0,8,華南永昌-民權,2024-04-11,9312
4967,十銓,10,3,7,華南永昌-民權,2024-04-11,9312
1603,華電,8,1,7,華南永昌-民權,2024-04-11,9312
2002,中鋼,7,0,7,華南永昌-民權,2024-04-11,9312
2634,漢翔,10,3,7,華南永昌-民權,2024-04-11,9312
2889,國票金,307,2,305,華南永昌-民權,2024-04-12,9312
2637,慧洋-KY,105,0,105,華南永昌-民權,2024-04-12,9312
2027,大成鋼,52,0,52,華南永昌-民權,2024-04-12,9312
2101,南港,50,0,50,華南永昌-民權,2024-04-12,9312
2102,泰豐,50,0,50,華南永昌-民權,2024-04-12,9312
2353,宏��,83,37,46,華南永昌-民權,2024-04-12,9312
00937B,群益ESG投等債20,41,0,41,華南永昌-民權,2024-04-12,9312
2610,華航,36,3,33,華南永昌-民權,2024-04-12,9312
2002,中鋼,57,30,27,華南永昌-民權,2024-04-12,9312
2409,友達,27,3,24,華南永昌-民權,2024-04-12,9312
2303,聯電,37,15,22,華南永昌-民權,2024-04-12,9312
00753L,中信中國50正2,20,0,20,華南永昌-民權,2024-04-12,9312
2329,華泰,34,14,20,華南永昌-民權,2024-04-12,9312
6192,巨路,20,0,20,華南永昌-民權,2024-04-12,9312
5521,工信,20,0,20,華南永昌-民權,2024-04-12,9312
1301,台塑,19,0,19,華南永昌-民權,2024-04-12,9312
1605,華新,27,9,18,華南永昌-民權,2024-04-12,9312
1612,宏泰,21,3,18,華南永昌-民權,2024-04-12,9312
2630,亞航,51,33,18,華南永昌-民權,2024-04-12,9312
3706,神達,18,0,18,華南永昌-民權,2024-04-12,9312
2605,新興,31,13,18,華南永昌-民權,2024-04-12,9312
00680L,元大美債20正2,17,0,17,華南永昌-民權,2024-04-12,9312
00679B,元大美債20年,16,0,16,華南永昌-民權,2024-04-12,9312
2883,凱基金,15,0,15,華南永昌-民權,2024-04-12,9312
00940,元大台灣價值高息,28,14,14,華南永昌-民權,2024-04-12,9312
2880,華南金,14,0,14,華南永昌-民權,2024-04-12,9312
00687B,國泰20年美債,16,2,14,華南永昌-民權,2024-04-12,9312
1616,億泰,29,15,14,華南永昌-民權,2024-04-12,9312
2537,聯上發,14,0,14,華南永昌-民權,2024-04-12,9312
2105,正新,11,0,11,華南永昌-民權,2024-04-12,9312
3287,廣寰科,11,0,11,華南永昌-民權,2024-04-12,9312
5880,合庫金,11,0,11,華南永昌-民權,2024-04-12,9312
2454,聯發科,10,0,10,華南永昌-民權,2024-04-12,9312
00882,中信中國高股息,10,0,10,華南永昌-民權,2024-04-12,9312
1101,台泥,10,0,10,華南永昌-民權,2024-04-12,9312
2031,新光鋼,10,0,10,華南永昌-民權,2024-04-12,9312
2897,王道銀行,10,0,10,華南永昌-民權,2024-04-12,9312
3188,鑫龍騰,10,0,10,華南永昌-民權,2024-04-12,9312
3312,弘憶股,12,2,10,華南永昌-民權,2024-04-12,9312
1109,信大,9,0,9,華南永昌-民權,2024-04-12,9312
2356,英業達,9,1,8,華南永昌-民權,2024-04-12,9312
2886,兆豐金,8,0,8,華南永昌-民權,2024-04-12,9312
00933B,國泰10Y+金融債,8,0,8,華南永昌-民權,2024-04-12,9312
3715,定穎投控,8,1,7,華南永昌-民權,2024-04-12,9312
2495,普安,7,0,7,華南永昌-民權,2024-04-12,9312
6120,達運,9,2,7,華南永昌-民權,2024-04-12,9312
2812,台中銀,11,5,6,華南永昌-民權,2024-04-12,9312
3231,緯創,6,0,6,華南永昌-民權,2024-04-12,9312
00795B,中信美國公債20年,6,0,6,華南永昌-民權,2024-04-12,9312
1808,潤隆,6,0,6,華南永昌-民權,2024-04-12,9312
3481,群創,2523,1502,1021,華南永昌-民權,2024-04-15,9312
00929,復華台灣科技優息,101,2,99,華南永昌-民權,2024-04-15,9312
2888,新光金,85,0,85,華南永昌-民權,2024-04-15,9312
2515,中工,83,8,75,華南永昌-民權,2024-04-15,9312
00940,元大台灣價值高息,69,0,69,華南永昌-民權,2024-04-15,9312
2303,聯電,65,1,64,華南永昌-民權,2024-04-15,9312
2367,燿華,65,4,61,華南永昌-民權,2024-04-15,9312
2504,國產,53,0,53,華南永昌-民權,2024-04-15,9312
2330,台積電,47,2,45,華南永昌-民權,2024-04-15,9312
2371,大同,96,57,39,華南永昌-民權,2024-04-15,9312
2002,中鋼,25,0,25,華南永昌-民權,2024-04-15,9312
00937B,群益ESG投等債20,27,4,23,華南永昌-民權,2024-04-15,9312
4549,桓達,20,0,20,華南永昌-民權,2024-04-15,9312
5483,中美晶,20,0,20,華南永昌-民權,2024-04-15,9312
5521,工信,20,0,20,華南永昌-民權,2024-04-15,9312
6120,達運,20,0,20,華南永昌-民權,2024-04-15,9312
3060,銘異,20,2,18,華南永昌-民權,2024-04-15,9312
2344,華邦電,20,2,18,華南永昌-民權,2024-04-15,9312
4905,台聯電,17,0,17,華南永昌-民權,2024-04-15,9312
2353,宏��,24,9,15,華南永昌-民權,2024-04-15,9312
4960,誠美材,18,3,15,華南永昌-民權,2024-04-15,9312
00633L,富邦上証正2,16,2,14,華南永昌-民權,2024-04-15,9312
00941,中信上游半導體,15,1,14,華南永昌-民權,2024-04-15,9312
3027,盛達,20,6,14,華南永昌-民權,2024-04-15,9312
6901,鑽石投資,14,0,14,華南永昌-民權,2024-04-15,9312
006208,富邦台50,24,11,13,華南永昌-民權,2024-04-15,9312
2883,凱基金,13,0,13,華南永昌-民權,2024-04-15,9312
2014,中鴻,13,0,13,華南永昌-民權,2024-04-15,9312
00679B,元大美債20年,12,0,12,華南永昌-民權,2024-04-15,9312
00878,國泰永續高股息,11,0,11,華南永昌-民權,2024-04-15,9312
4714,永捷,12,1,11,華南永昌-民權,2024-04-15,9312
00919,群益台灣精選高息,10,0,10,華南永昌-民權,2024-04-15,9312
1312,國喬,10,0,10,華南永昌-民權,2024-04-15,9312
2356,英業達,15,5,10,華南永昌-民權,2024-04-15,9312
2409,友達,10,0,10,華南永昌-民權,2024-04-15,9312
2462,良得電,10,0,10,華南永昌-民權,2024-04-15,9312
2601,益航,10,0,10,華南永昌-民權,2024-04-15,9312
3016,嘉晶,10,0,10,華南永昌-民權,2024-04-15,9312
3652,精聯,10,0,10,華南永昌-民權,2024-04-15,9312
6190,萬泰科,10,0,10,華南永昌-民權,2024-04-15,9312
6417,韋僑,10,0,10,華南永昌-民權,2024-04-15,9312
8110,華東,10,0,10,華南永昌-民權,2024-04-15,9312
0056,元大高股息,32,23,9,華南永昌-民權,2024-04-15,9312
2374,佳能,11,2,9,華南永昌-民權,2024-04-15,9312
4526,東台,10,1,9,華南永昌-民權,2024-04-15,9312
5386,青雲,9,0,9,華南永昌-民權,2024-04-15,9312
1504,東元,22,14,8,華南永昌-民權,2024-04-15,9312
6547,高端疫苗,8,0,8,華南永昌-民權,2024-04-15,9312
00933B,國泰10Y+金融債,8,0,8,華南永昌-民權,2024-04-15,9312
1612,宏泰,21,13,8,華南永昌-民權,2024-04-15,9312
5905,南仁湖,281,0,281,華南永昌-民權,2024-04-16,9312
00919,群益台灣精選高息,300,55,245,華南永昌-民權,2024-04-16,9312
6488,環球晶,213,9,204,華南永昌-民權,2024-04-16,9312
2887,台新金,197,28,169,華南永昌-民權,2024-04-16,9312
00940,元大台灣價值高息,241,77,164,華南永昌-民權,2024-04-16,9312
00929,復華台灣科技優息,185,37,148,華南永昌-民權,2024-04-16,9312
2880,華南金,121,0,121,華南永昌-民權,2024-04-16,9312
4905,台聯電,92,0,92,華南永昌-民權,2024-04-16,9312
2337,旺宏,63,0,63,華南永昌-民權,2024-04-16,9312
0056,元大高股息,57,1,56,華南永昌-民權,2024-04-16,9312
2618,長榮航,44,3,41,華南永昌-民權,2024-04-16,9312
00878,國泰永續高股息,92,57,35,華南永昌-民權,2024-04-16,9312
1609,大亞,97,63,34,華南永昌-民權,2024-04-16,9312
2883,凱基金,30,0,30,華南永昌-民權,2024-04-16,9312
00753L,中信中國50正2,30,0,30,華南永昌-民權,2024-04-16,9312
3706,神達,29,0,29,華南永昌-民權,2024-04-16,9312
00680L,元大美債20正2,32,5,27,華南永昌-民權,2024-04-16,9312
2515,中工,26,1,25,華南永昌-民權,2024-04-16,9312
6901,鑽石投資,24,0,24,華南永昌-民權,2024-04-16,9312
1314,中石化,25,3,22,華南永昌-民權,2024-04-16,9312
00900,富邦特選高股息30,22,0,22,華南永昌-民權,2024-04-16,9312
2301,光寶科,28,6,22,華南永昌-民權,2024-04-16,9312
2897,王道銀行,21,0,21,華南永昌-民權,2024-04-16,9312
8011,台通,20,0,20,華南永昌-民權,2024-04-16,9312
2344,華邦電,722,704,18,華南永昌-民權,2024-04-16,9312
2534,宏盛,20,2,18,華南永昌-民權,2024-04-16,9312
4960,誠美材,26,8,18,華南永昌-民權,2024-04-16,9312
2509,全坤建,23,6,17,華南永昌-民權,2024-04-16,9312
2867,三商壽,28,11,17,華南永昌-民權,2024-04-16,9312
00918,大華優利高填息30,38,22,16,華南永昌-民權,2024-04-16,9312
1410,南染,15,0,15,華南永昌-民權,2024-04-16,9312
2017,官田鋼,15,0,15,華南永昌-民權,2024-04-16,9312
3231,緯創,18,3,15,華南永昌-民權,2024-04-16,9312
2609,陽明,18,4,14,華南永昌-民權,2024-04-16,9312
00712,復華富時不動產,14,0,14,華南永昌-民權,2024-04-16,9312
2353,宏��,15,2,13,華南永昌-民權,2024-04-16,9312
1617,榮星,13,0,13,華南永昌-民權,2024-04-16,9312
1815,富喬,19,6,13,華南永昌-民權,2024-04-16,9312
006208,富邦台50,14,1,13,華南永昌-民權,2024-04-16,9312
00751B,元大AAA至A公司債,12,0,12,華南永昌-民權,2024-04-16,9312
00937B,群益ESG投等債20,102,90,12,華南永昌-民權,2024-04-16,9312
2014,中鴻,15,3,12,華南永昌-民權,2024-04-16,9312
4716,大立,11,0,11,華南永昌-民權,2024-04-16,9312
5880,合庫金,11,1,10,華南永昌-民權,2024-04-16,9312
2601,益航,10,0,10,華南永昌-民權,2024-04-16,9312
3652,精聯,10,0,10,華南永昌-民權,2024-04-16,9312
5009,榮剛,11,1,10,華南永昌-民權,2024-04-16,9312
6417,韋僑,10,0,10,華南永昌-民權,2024-04-16,9312
8358,金居,12,2,10,華南永昌-民權,2024-04-16,9312
2009,第一銅,19,10,9,華南永昌-民權,2024-04-16,9312
2884,玉山金,189,1,188,華南永昌-民權,2024-04-17,9312
00632R,元大台灣50反1,110,0,110,華南永昌-民權,2024-04-17,9312
4905,台聯電,87,0,87,華南永昌-民權,2024-04-17,9312
00680L,元大美債20正2,65,0,65,華南永昌-民權,2024-04-17,9312
00929,復華台灣科技優息,68,5,63,華南永昌-民權,2024-04-17,9312
00940,元大台灣價值高息,60,1,59,華南永昌-民權,2024-04-17,9312
5519,隆大,46,0,46,華南永昌-民權,2024-04-17,9312
4513,福裕,43,0,43,華南永昌-民權,2024-04-17,9312
5905,南仁湖,32,0,32,華南永昌-民權,2024-04-17,9312
0056,元大高股息,31,1,30,華南永昌-民權,2024-04-17,9312
00919,群益台灣精選高息,38,10,28,華南永昌-民權,2024-04-17,9312
2618,長榮航,25,1,24,華南永昌-民權,2024-04-17,9312
6213,聯茂,25,3,22,華南永昌-民權,2024-04-17,9312
2880,華南金,20,0,20,華南永昌-民權,2024-04-17,9312
6488,環球晶,20,0,20,華南永昌-民權,2024-04-17,9312
00857B,永豐20年美公債,19,0,19,華南永昌-民權,2024-04-17,9312
2887,台新金,16,0,16,華南永昌-民權,2024-04-17,9312
6120,達運,75,60,15,華南永昌-民權,2024-04-17,9312
00712,復華富時不動產,12,0,12,華南永昌-民權,2024-04-17,9312
2301,光寶科,14,3,11,華南永昌-民權,2024-04-17,9312
2363,矽統,39,28,11,華南永昌-民權,2024-04-17,9312
2704,國賓,16,5,11,華南永昌-民權,2024-04-17,9312
3231,緯創,13,2,11,華南永昌-民權,2024-04-17,9312
3706,神達,12,1,11,華南永昌-民權,2024-04-17,9312
00753L,中信中國50正2,10,0,10,華南永昌-民權,2024-04-17,9312
1301,台塑,10,0,10,華南永昌-民權,2024-04-17,9312
2883,凱基金,11,1,10,華南永昌-民權,2024-04-17,9312
3481,群創,13,3,10,華南永昌-民權,2024-04-17,9312
6142,友勁,10,0,10,華南永昌-民權,2024-04-17,9312
6188,廣明,20,10,10,華南永昌-民權,2024-04-17,9312
8064,東捷,10,0,10,華南永昌-民權,2024-04-17,9312
2303,聯電,17,7,10,華南永昌-民權,2024-04-17,9312
00939,統一台灣高息動能,8,0,8,華南永昌-民權,2024-04-17,9312
2353,宏��,8,0,8,華南永昌-民權,2024-04-17,9312
2408,南亞科,9,1,8,華南永昌-民權,2024-04-17,9312
1410,南染,7,0,7,華南永昌-民權,2024-04-17,9312
2610,華航,7,0,7,華南永昌-民權,2024-04-17,9312
2504,國產,10,4,6,華南永昌-民權,2024-04-17,9312
3704,合勤控,6,0,6,華南永昌-民權,2024-04-17,9312
00878,國泰永續高股息,6,1,5,華南永昌-民權,2024-04-17,9312
00734B,台新JPM新興債,5,0,5,華南永昌-民權,2024-04-17,9312
3293,鈊象,6,1,5,華南永昌-民權,2024-04-17,9312
3557,嘉威,5,0,5,華南永昌-民權,2024-04-17,9312
4960,誠美材,5,0,5,華南永昌-民權,2024-04-17,9312
5876,上海商銀,5,0,5,華南永昌-民權,2024-04-17,9312
6127,九豪,5,0,5,華南永昌-民權,2024-04-17,9312
8112,至上,11,6,5,華南永昌-民權,2024-04-17,9312
2834,臺企銀,5,0,5,華南永昌-民權,2024-04-17,9312
5434,崇越,13,9,4,華南永昌-民權,2024-04-17,9312
2002,中鋼,6,2,4,華南永昌-民權,2024-04-17,9312
2887,台新金,231,1,230,華南永昌-民權,2024-04-18,9312
3481,群創,140,31,109,華南永昌-民權,2024-04-18,9312
2344,華邦電,107,0,107,華南永昌-民權,2024-04-18,9312
4905,台聯電,55,0,55,華南永昌-民權,2024-04-18,9312
00929,復華台灣科技優息,55,4,51,華南永昌-民權,2024-04-18,9312
5512,力麒,45,5,40,華南永昌-民權,2024-04-18,9312
1605,華新,72,35,37,華南永昌-民權,2024-04-18,9312
6275,元山,41,5,36,華南永昌-民權,2024-04-18,9312
2374,佳能,38,3,35,華南永昌-民權,2024-04-18,9312
3706,神達,36,1,35,華南永昌-民權,2024-04-18,9312
1216,統一,30,1,29,華南永昌-民權,2024-04-18,9312
1616,億泰,31,5,26,華南永昌-民權,2024-04-18,9312
2505,國揚,25,0,25,華南永昌-民權,2024-04-18,9312
2330,台積電,23,1,22,華南永昌-民權,2024-04-18,9312
8011,台通,20,0,20,華南永昌-民權,2024-04-18,9312
00940,元大台灣價值高息,28,10,18,華南永昌-民權,2024-04-18,9312
00679B,元大美債20年,18,0,18,華南永昌-民權,2024-04-18,9312
0056,元大高股息,17,0,17,華南永昌-民權,2024-04-18,9312
1108,幸福,18,2,16,華南永昌-民權,2024-04-18,9312
4513,福裕,15,0,15,華南永昌-民權,2024-04-18,9312
9105,泰金寶-DR,15,0,15,華南永昌-民權,2024-04-18,9312
1504,東元,22,7,15,華南永昌-民權,2024-04-18,9312
2367,燿華,40,27,13,華南永昌-民權,2024-04-18,9312
2520,冠德,53,41,12,華南永昌-民權,2024-04-18,9312
3686,達能,12,0,12,華南永昌-民權,2024-04-18,9312
2013,中鋼構,14,2,12,華南永昌-民權,2024-04-18,9312
00937B,群益ESG投等債20,11,0,11,華南永昌-民權,2024-04-18,9312
3704,合勤控,11,0,11,華南永昌-民權,2024-04-18,9312
00712,復華富時不動產,10,0,10,華南永昌-民權,2024-04-18,9312
1718,中纖,10,0,10,華南永昌-民權,2024-04-18,9312
2332,友訊,10,0,10,華南永昌-民權,2024-04-18,9312
1513,中興電,27,18,9,華南永昌-民權,2024-04-18,9312
3060,銘異,9,0,9,華南永昌-民權,2024-04-18,9312
2371,大同,61,53,8,華南永昌-民權,2024-04-18,9312
4303,信立,8,0,8,華南永昌-民權,2024-04-18,9312
2855,統一證,7,0,7,華南永昌-民權,2024-04-18,9312
3666,光耀,7,0,7,華南永昌-民權,2024-04-18,9312
5905,南仁湖,7,0,7,華南永昌-民權,2024-04-18,9312
3661,世芯-KY,9,2,7,華南永昌-民權,2024-04-18,9312
2610,華航,12,6,6,華南永昌-民權,2024-04-18,9312
2303,聯電,7,1,6,華南永昌-民權,2024-04-18,9312
2329,華泰,14,8,6,華南永昌-民權,2024-04-18,9312
8390,金益鼎,8,2,6,華南永昌-民權,2024-04-18,9312
00941,中信上游半導體,6,1,5,華南永昌-民權,2024-04-18,9312
2208,台船,5,0,5,華南永昌-民權,2024-04-18,9312
2369,菱生,5,0,5,華南永昌-民權,2024-04-18,9312
2538,基泰,37,32,5,華南永昌-民權,2024-04-18,9312
3380,明泰,5,0,5,華南永昌-民權,2024-04-18,9312
3402,漢科,20,15,5,華南永昌-民權,2024-04-18,9312
3441,聯一光,5,0,5,華南永昌-民權,2024-04-18,9312
2890,永豐金,581,0,581,華南永昌-民權,2024-04-19,9312
2880,華南金,410,0,410,華南永昌-民權,2024-04-19,9312
00929,復華台灣科技優息,446,196,250,華南永昌-民權,2024-04-19,9312
2303,聯電,137,2,135,華南永昌-民權,2024-04-19,9312
00940,元大台灣價值高息,141,32,109,華南永昌-民權,2024-04-19,9312
00919,群益台灣精選高息,138,34,104,華南永昌-民權,2024-04-19,9312
2537,聯上發,87,1,86,華南永昌-民權,2024-04-19,9312
2374,佳能,91,18,73,華南永昌-民權,2024-04-19,9312
4905,台聯電,55,0,55,華南永昌-民權,2024-04-19,9312
00918,大華優利高填息30,51,2,49,華南永昌-民權,2024-04-19,9312
00687B,國泰20年美債,50,5,45,華南永昌-民權,2024-04-19,9312
2409,友達,43,0,43,華南永昌-民權,2024-04-19,9312
6488,環球晶,62,20,42,華南永昌-民權,2024-04-19,9312
00878,國泰永續高股息,41,0,41,華南永昌-民權,2024-04-19,9312
2515,中工,91,51,40,華南永昌-民權,2024-04-19,9312
00939,統一台灣高息動能,42,3,39,華南永昌-民權,2024-04-19,9312
00891,中信關鍵半導體,36,4,32,華南永昌-民權,2024-04-19,9312
2618,長榮航,45,16,29,華南永昌-民權,2024-04-19,9312
2317,鴻海,35,9,26,華南永昌-民權,2024-04-19,9312
3714,富采,25,0,25,華南永昌-民權,2024-04-19,9312
3706,神達,27,5,22,華南永昌-民權,2024-04-19,9312
2002,中鋼,24,2,22,華南永昌-民權,2024-04-19,9312
2337,旺宏,24,2,22,華南永昌-民權,2024-04-19,9312
8011,台通,22,0,22,華南永昌-民權,2024-04-19,9312
00679B,元大美債20年,24,3,21,華南永昌-民權,2024-04-19,9312
2882,國泰金,21,2,19,華南永昌-民權,2024-04-19,9312
6901,鑽石投資,19,0,19,華南永昌-民權,2024-04-19,9312
2547,日勝生,23,7,16,華南永昌-民權,2024-04-19,9312
8936,國統,19,4,15,華南永昌-民權,2024-04-19,9312
3293,鈊象,24,9,15,華南永昌-民權,2024-04-19,9312
6213,聯茂,33,19,14,華南永昌-民權,2024-04-19,9312
2014,中鴻,13,0,13,華南永昌-民權,2024-04-19,9312
2363,矽統,16,3,13,華南永昌-民權,2024-04-19,9312
1609,大亞,149,137,12,華南永昌-民權,2024-04-19,9312
8926,台汽電,12,0,12,華南永昌-民權,2024-04-19,9312
1326,台化,12,0,12,華南永昌-民權,2024-04-19,9312
2630,亞航,52,40,12,華南永昌-民權,2024-04-19,9312
6215,和椿,16,4,12,華南永昌-民權,2024-04-19,9312
1314,中石化,20,9,11,華南永昌-民權,2024-04-19,9312
8049,晶采,11,0,11,華南永昌-民權,2024-04-19,9312
9919,康那香,12,1,11,華南永昌-民權,2024-04-19,9312
00905,FT臺灣Smart,10,0,10,華南永昌-民權,2024-04-19,9312
3049,精金,10,0,10,華南永昌-民權,2024-04-19,9312
3265,台星科,10,0,10,華南永昌-民權,2024-04-19,9312
3652,精聯,10,0,10,華南永昌-民權,2024-04-19,9312
3703,欣陸,32,22,10,華南永昌-民權,2024-04-19,9312
4513,福裕,10,0,10,華南永昌-民權,2024-04-19,9312
6142,友勁,10,0,10,華南永昌-民權,2024-04-19,9312
6284,佳邦,10,0,10,華南永昌-民權,2024-04-19,9312
3231,緯創,25,15,10,華南永昌-民權,2024-04-19,9312
2834,臺企銀,800,101,699,華南永昌-民權,2024-04-22,9312
00929,復華台灣科技優息,418,104,314,華南永昌-民權,2024-04-22,9312
2344,華邦電,307,0,307,華南永昌-民權,2024-04-22,9312
00632R,元大台灣50反1,200,0,200,華南永昌-民權,2024-04-22,9312
2374,佳能,168,13,155,華南永昌-民權,2024-04-22,9312
4905,台聯電,122,1,121,華南永昌-民權,2024-04-22,9312
2836,高雄銀,90,0,90,華南永昌-民權,2024-04-22,9312
2515,中工,75,19,56,華南永昌-民權,2024-04-22,9312
2618,長榮航,70,33,37,華南永昌-民權,2024-04-22,9312
1802,台玻,35,0,35,華南永昌-民權,2024-04-22,9312
6770,力積電,42,10,32,華南永昌-民權,2024-04-22,9312
1616,億泰,33,1,32,華南永昌-民權,2024-04-22,9312
6488,環球晶,26,0,26,華南永昌-民權,2024-04-22,9312
00937B,群益ESG投等債20,41,16,25,華南永昌-民權,2024-04-22,9312
2371,大同,104,81,23,華南永昌-民權,2024-04-22,9312
3231,緯創,31,9,22,華南永昌-民權,2024-04-22,9312
2409,友達,34,13,21,華南永昌-民權,2024-04-22,9312
1314,中石化,54,33,21,華南永昌-民權,2024-04-22,9312
00939,統一台灣高息動能,20,0,20,華南永昌-民權,2024-04-22,9312
2547,日勝生,27,7,20,華南永昌-民權,2024-04-22,9312
1609,大亞,37,19,18,華南永昌-民權,2024-04-22,9312
3312,弘憶股,16,2,14,華南永昌-民權,2024-04-22,9312
2883,凱基金,15,1,14,華南永昌-民權,2024-04-22,9312
1440,南紡,20,7,13,華南永昌-民權,2024-04-22,9312
2609,陽明,24,12,12,華南永昌-民權,2024-04-22,9312
1618,合機,18,7,11,華南永昌-民權,2024-04-22,9312
1815,富喬,11,0,11,華南永昌-民權,2024-04-22,9312
2014,中鴻,11,0,11,華南永昌-民權,2024-04-22,9312
5009,榮剛,11,0,11,華南永昌-民權,2024-04-22,9312
1513,中興電,19,9,10,華南永昌-民權,2024-04-22,9312
1903,士紙,10,0,10,華南永昌-民權,2024-04-22,9312
00688L,國泰20年美債正2,10,0,10,華南永昌-民權,2024-04-22,9312
1104,環泥,10,0,10,華南永昌-民權,2024-04-22,9312
2329,華泰,36,26,10,華南永昌-民權,2024-04-22,9312
2465,麗臺,12,2,10,華南永昌-民權,2024-04-22,9312
2851,中再保,10,0,10,華南永昌-民權,2024-04-22,9312
8064,東捷,13,3,10,華南永昌-民權,2024-04-22,9312
3287,廣寰科,32,23,9,華南永昌-民權,2024-04-22,9312
3481,群創,25,17,8,華南永昌-民權,2024-04-22,9312
2367,燿華,13,5,8,華南永昌-民權,2024-04-22,9312
5381,合正,16,8,8,華南永昌-民權,2024-04-22,9312
8358,金居,8,0,8,華南永昌-民權,2024-04-22,9312
2303,聯電,22,15,7,華南永昌-民權,2024-04-22,9312
2317,鴻海,13,6,7,華南永昌-民權,2024-04-22,9312
00919,群益台灣精選高息,61,54,7,華南永昌-民權,2024-04-22,9312
3689,湧德,7,0,7,華南永昌-民權,2024-04-22,9312
6005,群益證,13,6,7,華南永昌-民權,2024-04-22,9312
3703,欣陸,7,1,6,華南永昌-民權,2024-04-22,9312
00680L,元大美債20正2,5,0,5,華南永昌-民權,2024-04-22,9312
2369,菱生,5,0,5,華南永昌-民權,2024-04-22,9312
2374,佳能,1076,75,1001,華南永昌-民權,2024-04-23,9312
2101,南港,114,3,111,華南永昌-民權,2024-04-23,9312
2356,英業達,108,4,104,華南永昌-民權,2024-04-23,9312
00937B,群益ESG投等債20,65,0,65,華南永昌-民權,2024-04-23,9312
4905,台聯電,45,2,43,華南永昌-民權,2024-04-23,9312
2337,旺宏,30,0,30,華南永昌-民權,2024-04-23,9312
00940,元大台灣價值高息,26,1,25,華南永昌-民權,2024-04-23,9312
00929,復華台灣科技優息,40,16,24,華南永昌-民權,2024-04-23,9312
1314,中石化,24,3,21,華南永昌-民權,2024-04-23,9312
1815,富喬,20,0,20,華南永昌-民權,2024-04-23,9312
1612,宏泰,32,13,19,華南永昌-民權,2024-04-23,9312
5521,工信,19,0,19,華南永昌-民權,2024-04-23,9312
9902,台火,21,3,18,華南永昌-民權,2024-04-23,9312
2363,矽統,28,13,15,華南永昌-民權,2024-04-23,9312
0056,元大高股息,14,0,14,華南永昌-民權,2024-04-23,9312
2301,光寶科,23,9,14,華南永昌-民權,2024-04-23,9312
2367,燿華,30,16,14,華南永昌-民權,2024-04-23,9312
2009,第一銅,15,2,13,華南永昌-民權,2024-04-23,9312
2303,聯電,13,0,13,華南永昌-民權,2024-04-23,9312
2371,大同,64,52,12,華南永昌-民權,2024-04-23,9312
1440,南紡,13,2,11,華南永昌-民權,2024-04-23,9312
2885,元大金,31,20,11,華南永昌-民權,2024-04-23,9312
2505,國揚,10,0,10,華南永昌-民權,2024-04-23,9312
1608,華榮,16,7,9,華南永昌-民權,2024-04-23,9312
2884,玉山金,10,1,9,華南永昌-民權,2024-04-23,9312
1101,台泥,9,1,8,華南永昌-民權,2024-04-23,9312
3715,定穎投控,7,0,7,華南永昌-民權,2024-04-23,9312
2511,太子,10,3,7,華南永昌-民權,2024-04-23,9312
2308,台達電,6,0,6,華南永昌-民權,2024-04-23,9312
3312,弘憶股,7,1,6,華南永昌-民權,2024-04-23,9312
5251,天鉞電,14,8,6,華南永昌-民權,2024-04-23,9312
5371,中光電,7,1,6,華南永昌-民權,2024-04-23,9312
2329,華泰,7,2,5,華南永昌-民權,2024-04-23,9312
2731,雄獅,5,0,5,華南永昌-民權,2024-04-23,9312
6026,福邦證,5,0,5,華南永昌-民權,2024-04-23,9312
6192,巨路,5,0,5,華南永昌-民權,2024-04-23,9312
00878,國泰永續高股息,5,0,5,華南永昌-民權,2024-04-23,9312
00939,統一台灣高息動能,7,2,5,華南永昌-民權,2024-04-23,9312
00680L,元大美債20正2,4,0,4,華南永昌-民權,2024-04-23,9312
1722,台肥,5,1,4,華南永昌-民權,2024-04-23,9312
2369,菱生,4,0,4,華南永昌-民權,2024-04-23,9312
2460,建通,4,0,4,華南永昌-民權,2024-04-23,9312
5512,力麒,22,18,4,華南永昌-民權,2024-04-23,9312
2330,台積電,3,0,3,華南永昌-民權,2024-04-23,9312
2317,鴻海,6,3,3,華南永昌-民權,2024-04-23,9312
00905,FT臺灣Smart,3,0,3,華南永昌-民權,2024-04-23,9312
1513,中興電,12,9,3,華南永昌-民權,2024-04-23,9312
2454,聯發科,3,0,3,華南永昌-民權,2024-04-23,9312
2606,裕民,3,0,3,華南永昌-民權,2024-04-23,9312
3607,谷崧,3,0,3,華南永昌-民權,2024-04-23,9312
2374,佳能,1268,24,1244,華南永昌-民權,2024-04-24,9312
2890,永豐金,322,0,322,華南永昌-民權,2024-04-24,9312
2812,台中銀,126,3,123,華南永昌-民權,2024-04-24,9312
3715,定穎投控,116,3,113,華南永昌-民權,2024-04-24,9312
00632R,元大台灣50反1,70,0,70,華南永昌-民權,2024-04-24,9312
3481,群創,56,0,56,華南永昌-民權,2024-04-24,9312
4905,台聯電,52,0,52,華南永昌-民權,2024-04-24,9312
4123,晟德,30,0,30,華南永昌-民權,2024-04-24,9312
0056,元大高股息,31,1,30,華南永昌-民權,2024-04-24,9312
2409,友達,28,4,24,華南永昌-民權,2024-04-24,9312
00940,元大台灣價值高息,26,3,23,華南永昌-民權,2024-04-24,9312
6215,和椿,28,5,23,華南永昌-民權,2024-04-24,9312
2511,太子,30,10,20,華南永昌-民權,2024-04-24,9312
6192,巨路,20,0,20,華南永昌-民權,2024-04-24,9312
3706,神達,33,16,17,華南永昌-民權,2024-04-24,9312
00919,群益台灣精選高息,37,25,12,華南永昌-民權,2024-04-24,9312
6770,力積電,12,0,12,華南永昌-民權,2024-04-24,9312
4306,炎洲,13,2,11,華南永昌-民權,2024-04-24,9312
2105,正新,11,0,11,華南永昌-民權,2024-04-24,9312
2009,第一銅,19,9,10,華南永昌-民權,2024-04-24,9312
00939,統一台灣高息動能,12,2,10,華南永昌-民權,2024-04-24,9312
2855,統一證,10,0,10,華南永昌-民權,2024-04-24,9312
3024,憶聲,10,0,10,華南永昌-民權,2024-04-24,9312
8436,大江,10,0,10,華南永昌-民權,2024-04-24,9312
3583,辛耘,11,2,9,華南永昌-民權,2024-04-24,9312
00679B,元大美債20年,9,0,9,華南永昌-民權,2024-04-24,9312
2886,兆豐金,10,1,9,華南永昌-民權,2024-04-24,9312
2634,漢翔,10,2,8,華南永昌-民權,2024-04-24,9312
8936,國統,20,12,8,華南永昌-民權,2024-04-24,9312
1504,東元,27,19,8,華南永昌-民權,2024-04-24,9312
2617,台航,7,0,7,華南永昌-民權,2024-04-24,9312
2897A,王道銀甲特,6,0,6,華南永昌-民權,2024-04-24,9312
6288,聯嘉,8,2,6,華南永昌-民權,2024-04-24,9312
6425,易發,13,7,6,華南永昌-民權,2024-04-24,9312
1414,東和,5,0,5,華南永昌-民權,2024-04-24,9312
00687B,國泰20年美債,5,0,5,華南永昌-民權,2024-04-24,9312
1605,華新,6,1,5,華南永昌-民權,2024-04-24,9312
2426,鼎元,5,0,5,華南永昌-民權,2024-04-24,9312
2801,彰銀,5,0,5,華南永昌-民權,2024-04-24,9312
6269,台郡,5,0,5,華南永昌-民權,2024-04-24,9312
6869,雲豹能源,5,0,5,華南永昌-民權,2024-04-24,9312
8033,雷虎,6,1,5,華南永昌-民權,2024-04-24,9312
9105,泰金寶-DR,5,0,5,華南永昌-民權,2024-04-24,9312
9902,台火,5,0,5,華南永昌-民權,2024-04-24,9312
2515,中工,19,14,5,華南永昌-民權,2024-04-24,9312
3711,日月光投控,4,0,4,華南永昌-民權,2024-04-24,9312
00680L,元大美債20正2,4,0,4,華南永昌-民權,2024-04-24,9312
2367,燿華,11,7,4,華南永昌-民權,2024-04-24,9312
4939,亞電,4,0,4,華南永昌-民權,2024-04-24,9312
6443,元晶,4,0,4,華南永昌-民權,2024-04-24,9312
3481,群創,1066,3,1063,華南永昌-民權,2024-04-25,9312
2834,臺企銀,315,0,315,華南永昌-民權,2024-04-25,9312
2344,華邦電,302,1,301,華南永昌-民權,2024-04-25,9312
2356,英業達,305,5,300,華南永昌-民權,2024-04-25,9312
2882,國泰金,50,0,50,華南永昌-民權,2024-04-25,9312
4905,台聯電,46,0,46,華南永昌-民權,2024-04-25,9312
2867,三商壽,50,13,37,華南永昌-民權,2024-04-25,9312
2845,遠東銀,30,0,30,華南永昌-民權,2024-04-25,9312
00680L,元大美債20正2,26,0,26,華南永昌-民權,2024-04-25,9312
2812,台中銀,26,0,26,華南永昌-民權,2024-04-25,9312
00929,復華台灣科技優息,28,3,25,華南永昌-民權,2024-04-25,9312
6120,達運,24,0,24,華南永昌-民權,2024-04-25,9312
2515,中工,32,11,21,華南永昌-民權,2024-04-25,9312
8011,台通,21,0,21,華南永昌-民權,2024-04-25,9312
1210,大成,20,0,20,華南永昌-民權,2024-04-25,9312
2509,全坤建,20,0,20,華南永昌-民權,2024-04-25,9312
00939,統一台灣高息動能,19,0,19,華南永昌-民權,2024-04-25,9312
1440,南紡,22,3,19,華南永昌-民權,2024-04-25,9312
00882,中信中國高股息,18,2,16,華南永昌-民權,2024-04-25,9312
3081,聯亞,16,3,13,華南永昌-民權,2024-04-25,9312
5864,致和證,13,0,13,華南永昌-民權,2024-04-25,9312
2317,鴻海,12,2,10,華南永昌-民權,2024-04-25,9312
2102,泰豐,10,0,10,華南永昌-民權,2024-04-25,9312
4510,高鋒,10,0,10,華南永昌-民權,2024-04-25,9312
4306,炎洲,10,0,10,華南永昌-民權,2024-04-25,9312
2330,台積電,11,1,10,華南永昌-民權,2024-04-25,9312
2887,台新金,15,6,9,華南永昌-民權,2024-04-25,9312
1326,台化,9,0,9,華南永昌-民權,2024-04-25,9312
2524,京城,9,0,9,華南永昌-民權,2024-04-25,9312
2009,第一銅,9,0,9,華南永昌-民權,2024-04-25,9312
00687B,國泰20年美債,8,0,8,華南永昌-民權,2024-04-25,9312
2363,矽統,25,17,8,華南永昌-民權,2024-04-25,9312
2353,宏��,8,1,7,華南永昌-民權,2024-04-25,9312
00937B,群益ESG投等債20,7,0,7,華南永昌-民權,2024-04-25,9312
1529,樂事綠能,7,0,7,華南永昌-民權,2024-04-25,9312
00878,國泰永續高股息,7,1,6,華南永昌-民權,2024-04-25,9312
00891,中信關鍵半導體,6,0,6,華南永昌-民權,2024-04-25,9312
2801,彰銀,6,0,6,華南永昌-民權,2024-04-25,9312
3715,定穎投控,6,0,6,華南永昌-民權,2024-04-25,9312
4716,大立,6,0,6,華南永昌-民權,2024-04-25,9312
1303,南亞,6,1,5,華南永昌-民權,2024-04-25,9312
0056,元大高股息,5,0,5,華南永昌-民權,2024-04-25,9312
2704,國賓,5,0,5,華南永昌-民權,2024-04-25,9312
2707,晶華,6,1,5,華南永昌-民權,2024-04-25,9312
3686,達能,5,0,5,華南永昌-民權,2024-04-25,9312
6271,同欣電,5,0,5,華南永昌-民權,2024-04-25,9312
8110,華東,10,5,5,華南永昌-民權,2024-04-25,9312
2886,兆豐金,4,0,4,華南永昌-民權,2024-04-25,9312
00933B,國泰10Y+金融債,4,0,4,華南永昌-民權,2024-04-25,9312
2316,楠梓電,5,1,4,華南永昌-民權,2024-04-25,9312
2374,佳能,54,5,49,華南永昌-民權,2024-04-26,9312
5512,力麒,40,0,40,華南永昌-民權,2024-04-26,9312
4905,台聯電,40,1,39,華南永昌-民權,2024-04-26,9312
2630,亞航,74,43,31,華南永昌-民權,2024-04-26,9312
4510,高鋒,30,0,30,華南永昌-民權,2024-04-26,9312
2705,六福,31,2,29,華南永昌-民權,2024-04-26,9312
3481,群創,40,18,22,華南永昌-民權,2024-04-26,9312
00632R,元大台灣50反1,25,5,20,華南永昌-民權,2024-04-26,9312
4123,晟德,20,0,20,華南永昌-民權,2024-04-26,9312
8436,大江,20,0,20,華南永昌-民權,2024-04-26,9312
00937B,群益ESG投等債20,19,0,19,華南永昌-民權,2024-04-26,9312
3231,緯創,17,0,17,華南永昌-民權,2024-04-26,9312
3652,精聯,17,0,17,華南永昌-民權,2024-04-26,9312
2371,大同,48,32,16,華南永昌-民權,2024-04-26,9312
1785,光洋科,15,0,15,華南永昌-民權,2024-04-26,9312
8070,長華*,21,6,15,華南永昌-民權,2024-04-26,9312
2605,新興,16,2,14,華南永昌-民權,2024-04-26,9312
1314,中石化,18,6,12,華南永昌-民權,2024-04-26,9312
8046,南電,11,0,11,華南永昌-民權,2024-04-26,9312
3338,泰碩,15,4,11,華南永昌-民權,2024-04-26,9312
8033,雷虎,11,0,11,華南永昌-民權,2024-04-26,9312
2707,晶華,10,0,10,華南永昌-民權,2024-04-26,9312
1101,台泥,8,0,8,華南永昌-民權,2024-04-26,9312
9927,泰銘,8,0,8,華南永昌-民權,2024-04-26,9312
6770,力積電,7,0,7,華南永昌-民權,2024-04-26,9312
00940,元大台灣價值高息,10,3,7,華南永昌-民權,2024-04-26,9312
2367,燿華,21,14,7,華南永昌-民權,2024-04-26,9312
6197,佳必琪,7,0,7,華南永昌-民權,2024-04-26,9312
1342,八貫,6,0,6,華南永昌-民權,2024-04-26,9312
00712,復華富時不動產,6,0,6,華南永昌-民權,2024-04-26,9312
2455,全新,6,0,6,華南永昌-民權,2024-04-26,9312
3450,聯鈞,8,2,6,華南永昌-民權,2024-04-26,9312
00751B,元大AAA至A公司債,5,0,5,華南永昌-民權,2024-04-26,9312
1903,士紙,5,0,5,華南永昌-民權,2024-04-26,9312
2241,艾姆勒,41,36,5,華南永昌-民權,2024-04-26,9312
2489,瑞軒,6,1,5,華南永昌-民權,2024-04-26,9312
3675,德微,5,0,5,華南永昌-民權,2024-04-26,9312
6875,國邑*,5,0,5,華南永昌-民權,2024-04-26,9312
8064,東捷,8,3,5,華南永昌-民權,2024-04-26,9312
8105,凌巨,5,0,5,華南永昌-民權,2024-04-26,9312
8182,加高,5,0,5,華南永昌-民權,2024-04-26,9312
9919,康那香,5,0,5,華南永昌-民權,2024-04-26,9312
1467,南緯,7,2,5,華南永昌-民權,2024-04-26,9312
6425,易發,17,12,5,華南永昌-民權,2024-04-26,9312
00878,國泰永續高股息,6,2,4,華南永昌-民權,2024-04-26,9312
2880,華南金,4,0,4,華南永昌-民權,2024-04-26,9312
4533,協易機,4,0,4,華南永昌-民權,2024-04-26,9312
1504,東元,5,1,4,華南永昌-民權,2024-04-26,9312
1319,東陽,4,0,4,華南永昌-民權,2024-04-26,9312
00687B,國泰20年美債,4,0,4,華南永昌-民權,2024-04-26,9312
2374,佳能,883,51,832,華南永昌-民權,2024-04-29,9312
2603,長榮,315,12,303,華南永昌-民權,2024-04-29,9312
2897,王道銀行,150,0,150,華南永昌-民權,2024-04-29,9312
1314,中石化,238,107,131,華南永昌-民權,2024-04-29,9312
8383,千附,100,0,100,華南永昌-民權,2024-04-29,9312
2356,英業達,100,4,96,華南永昌-民權,2024-04-29,9312
1447,力鵬,42,0,42,華南永昌-民權,2024-04-29,9312
00919,群益台灣精選高息,43,4,39,華南永昌-民權,2024-04-29,9312
2017,官田鋼,60,25,35,華南永昌-民權,2024-04-29,9312
2323,中環,64,34,30,華南永昌-民權,2024-04-29,9312
00687B,國泰20年美債,28,0,28,華南永昌-民權,2024-04-29,9312
2002,中鋼,30,3,27,華南永昌-民權,2024-04-29,9312
1815,富喬,70,44,26,華南永昌-民權,2024-04-29,9312
00676R,富邦臺灣加權反1,20,0,20,華南永昌-民權,2024-04-29,9312
2820,華票,20,0,20,華南永昌-民權,2024-04-29,9312
4956,光鋐,20,0,20,華南永昌-民權,2024-04-29,9312
6129,普誠,20,0,20,華南永昌-民權,2024-04-29,9312
1605,華新,18,0,18,華南永昌-民權,2024-04-29,9312
3652,精聯,17,0,17,華南永昌-民權,2024-04-29,9312
2618,長榮航,39,24,15,華南永昌-民權,2024-04-29,9312
00937B,群益ESG投等債20,12,0,12,華南永昌-民權,2024-04-29,9312
4905,台聯電,12,0,12,華南永昌-民權,2024-04-29,9312
5340,建榮,10,0,10,華南永昌-民權,2024-04-29,9312
6226,光鼎,10,0,10,華南永昌-民權,2024-04-29,9312
00929,復華台灣科技優息,28,18,10,華南永昌-民權,2024-04-29,9312
3163,波若威,14,5,9,華南永昌-民權,2024-04-29,9312
00939,統一台灣高息動能,25,16,9,華南永昌-民權,2024-04-29,9312
2102,泰豐,9,0,9,華南永昌-民權,2024-04-29,9312
2201,裕隆,10,1,9,華南永昌-民權,2024-04-29,9312
2547,日勝生,13,4,9,華南永昌-民權,2024-04-29,9312
8110,華東,11,2,9,華南永昌-民權,2024-04-29,9312
6136,富爾特,8,0,8,華南永昌-民權,2024-04-29,9312
2615,萬海,11,3,8,華南永昌-民權,2024-04-29,9312
1609,大亞,14,6,8,華南永昌-民權,2024-04-29,9312
5608,四維航,7,0,7,華南永昌-民權,2024-04-29,9312
2464,盟立,7,0,7,華南永昌-民權,2024-04-29,9312
8070,長華*,7,0,7,華南永昌-民權,2024-04-29,9312
5706,鳳凰,9,3,6,華南永昌-民權,2024-04-29,9312
00679B,元大美債20年,9,4,5,華南永昌-民權,2024-04-29,9312
1402,遠東新,5,0,5,華南永昌-民權,2024-04-29,9312
1459,聯發,5,0,5,華南永昌-民權,2024-04-29,9312
2501,國建,10,5,5,華南永昌-民權,2024-04-29,9312
2610,華航,14,9,5,華南永昌-民權,2024-04-29,9312
4402,郡都開發,5,0,5,華南永昌-民權,2024-04-29,9312
5483,中美晶,5,0,5,華南永昌-民權,2024-04-29,9312
6165,浪凡,6,1,5,華南永昌-民權,2024-04-29,9312
6177,達麗,6,1,5,華南永昌-民權,2024-04-29,9312
6207,雷科,5,0,5,華南永昌-民權,2024-04-29,9312
6829,千附精密,5,0,5,華南永昌-民權,2024-04-29,9312
8438,昶昕,5,0,5,華南永昌-民權,2024-04-29,9312
2344,華邦電,553,51,502,華南永昌-民權,2024-04-30,9312
2374,佳能,493,1,492,華南永昌-民權,2024-04-30,9312
4905,台聯電,96,0,96,華南永昌-民權,2024-04-30,9312
3402,漢科,75,0,75,華南永昌-民權,2024-04-30,9312
2888,新光金,88,19,69,華南永昌-民權,2024-04-30,9312
00929,復華台灣科技優息,65,1,64,華南永昌-民權,2024-04-30,9312
2897,王道銀行,60,0,60,華南永昌-民權,2024-04-30,9312
6488,環球晶,55,0,55,華南永昌-民權,2024-04-30,9312
3188,鑫龍騰,87,40,47,華南永昌-民權,2024-04-30,9312
1440,南紡,43,4,39,華南永昌-民權,2024-04-30,9312
1605,華新,35,0,35,華南永昌-民權,2024-04-30,9312
2630,亞航,32,0,32,華南永昌-民權,2024-04-30,9312
2317,鴻海,40,11,29,華南永昌-民權,2024-04-30,9312
00919,群益台灣精選高息,27,0,27,華南永昌-民權,2024-04-30,9312
2812,台中銀,21,0,21,華南永昌-民權,2024-04-30,9312
5009,榮剛,24,6,18,華南永昌-民權,2024-04-30,9312
2371,大同,17,6,11,華南永昌-民權,2024-04-30,9312
00940,元大台灣價值高息,32,21,11,華南永昌-民權,2024-04-30,9312
1438,三地開發,10,0,10,華南永昌-民權,2024-04-30,9312
2641,正德,10,0,10,華南永昌-民權,2024-04-30,9312
2460,建通,8,0,8,華南永昌-民權,2024-04-30,9312
2547,日勝生,10,2,8,華南永昌-民權,2024-04-30,9312
8088,品安,8,0,8,華南永昌-民權,2024-04-30,9312
3033,威健,9,1,8,華南永昌-民權,2024-04-30,9312
8069,元太,7,0,7,華南永昌-民權,2024-04-30,9312
6139,亞翔,7,0,7,華南永昌-民權,2024-04-30,9312
2367,燿華,19,13,6,華南永昌-民權,2024-04-30,9312
1442,名軒,6,0,6,華南永昌-民權,2024-04-30,9312
3059,華晶科,5,0,5,華南永昌-民權,2024-04-30,9312
00687B,國泰20年美債,5,0,5,華南永昌-民權,2024-04-30,9312
00937B,群益ESG投等債20,5,0,5,華南永昌-民權,2024-04-30,9312
00941,中信上游半導體,6,1,5,華南永昌-民權,2024-04-30,9312
1316,上曜,21,16,5,華南永昌-民權,2024-04-30,9312
2540,愛山林,5,0,5,華南永昌-民權,2024-04-30,9312
2542,興富發,6,1,5,華南永昌-民權,2024-04-30,9312
3062,建漢,5,0,5,華南永昌-民權,2024-04-30,9312
5457,宣德,7,2,5,華南永昌-民權,2024-04-30,9312
6509,聚和,5,0,5,華南永昌-民權,2024-04-30,9312
8105,凌巨,5,0,5,華南永昌-民權,2024-04-30,9312
2609,陽明,9,5,4,華南永昌-民權,2024-04-30,9312
1560,中砂,4,0,4,華南永昌-民權,2024-04-30,9312
1319,東陽,4,0,4,華南永昌-民權,2024-04-30,9312
1447,力鵬,6,2,4,華南永昌-民權,2024-04-30,9312
3712,永崴投控,4,0,4,華南永昌-民權,2024-04-30,9312
4714,永捷,4,0,4,華南永昌-民權,2024-04-30,9312
6190,萬泰科,4,0,4,華南永昌-民權,2024-04-30,9312
6235,華孚,4,0,4,華南永昌-民權,2024-04-30,9312
6491,晶碩,4,0,4,華南永昌-民權,2024-04-30,9312
2009,第一銅,11,7,4,華南永昌-民權,2024-04-30,9312
1101,台泥,4,1,3,華南永昌-民權,2024-04-30,9312
2374,佳能,467,1,466,華南永昌-民權,2024-05-02,9312
2834,臺企銀,300,18,282,華南永昌-民權,2024-05-02,9312
3481,群創,346,129,217,華南永昌-民權,2024-05-02,9312
4905,台聯電,69,0,69,華南永昌-民權,2024-05-02,9312
2017,官田鋼,55,5,50,華南永昌-民權,2024-05-02,9312
2101,南港,38,0,38,華南永昌-民權,2024-05-02,9312
00937B,群益ESG投等債20,34,0,34,華南永昌-民權,2024-05-02,9312
9940,信義,30,0,30,華南永昌-民權,2024-05-02,9312
00878,國泰永續高股息,29,0,29,華南永昌-民權,2024-05-02,9312
2002,中鋼,30,1,29,華南永昌-民權,2024-05-02,9312
3402,漢科,26,1,25,華南永昌-民權,2024-05-02,9312
2409,友達,34,9,25,華南永昌-民權,2024-05-02,9312
5230,雷笛克光學,21,0,21,華南永昌-民權,2024-05-02,9312
1540,喬福,20,0,20,華南永昌-民權,2024-05-02,9312
2641,正德,20,0,20,華南永昌-民權,2024-05-02,9312
2610,華航,46,26,20,華南永昌-民權,2024-05-02,9312
2106,建大,20,0,20,華南永昌-民權,2024-05-02,9312
00940,元大台灣價值高息,17,1,16,華南永昌-民權,2024-05-02,9312
00919,群益台灣精選高息,16,1,15,華南永昌-民權,2024-05-02,9312
9945,潤泰新,18,3,15,華南永昌-民權,2024-05-02,9312
1101,台泥,17,5,12,華南永昌-民權,2024-05-02,9312
2401,凌陽,19,7,12,華南永昌-民權,2024-05-02,9312
2509,全坤建,12,0,12,華南永昌-民權,2024-05-02,9312
2515,中工,57,45,12,華南永昌-民權,2024-05-02,9312
6770,力積電,16,4,12,華南永昌-民權,2024-05-02,9312
2812,台中銀,11,0,11,華南永昌-民權,2024-05-02,9312
4123,晟德,11,0,11,華南永昌-民權,2024-05-02,9312
1773,勝一,10,0,10,華南永昌-民權,2024-05-02,9312
2102,泰豐,10,0,10,華南永昌-民權,2024-05-02,9312
2363,矽統,19,9,10,華南永昌-民權,2024-05-02,9312
2867,三商壽,13,3,10,華南永昌-民權,2024-05-02,9312
2330,台積電,9,0,9,華南永昌-民權,2024-05-02,9312
3287,廣寰科,20,11,9,華南永昌-民權,2024-05-02,9312
2609,陽明,30,22,8,華南永昌-民權,2024-05-02,9312
1440,南紡,60,52,8,華南永昌-民權,2024-05-02,9312
2371,大同,28,20,8,華南永昌-民權,2024-05-02,9312
2534,宏盛,10,2,8,華南永昌-民權,2024-05-02,9312
6127,九豪,8,0,8,華南永昌-民權,2024-05-02,9312
6202,盛群,8,0,8,華南永昌-民權,2024-05-02,9312
2537,聯上發,10,3,7,華南永昌-民權,2024-05-02,9312
6278,台表科,7,0,7,華南永昌-民權,2024-05-02,9312
6456,GIS-KY,6,0,6,華南永昌-民權,2024-05-02,9312
00650L,復華香港正2,6,0,6,華南永昌-民權,2024-05-02,9312
2007,燁興,6,0,6,華南永昌-民權,2024-05-02,9312
2324,仁寶,6,0,6,華南永昌-民權,2024-05-02,9312
3715,定穎投控,8,2,6,華南永昌-民權,2024-05-02,9312
5531,鄉林,7,1,6,華南永昌-民權,2024-05-02,9312
6139,亞翔,7,1,6,華南永昌-民權,2024-05-02,9312
8234,新漢,8,2,6,華南永昌-民權,2024-05-02,9312
4526,東台,10,4,6,華南永昌-民權,2024-05-02,9312
2374,佳能,346,43,303,華南永昌-民權,2024-05-03,9312
2344,華邦電,214,6,208,華南永昌-民權,2024-05-03,9312
00937B,群益ESG投等債20,151,0,151,華南永昌-民權,2024-05-03,9312
6127,九豪,100,8,92,華南永昌-民權,2024-05-03,9312
2884,玉山金,80,6,74,華南永昌-民權,2024-05-03,9312
4905,台聯電,67,0,67,華南永昌-民權,2024-05-03,9312
2002,中鋼,62,11,51,華南永昌-民權,2024-05-03,9312
2888,新光金,51,2,49,華南永昌-民權,2024-05-03,9312
2609,陽明,41,3,38,華南永昌-民權,2024-05-03,9312
00878,國泰永續高股息,33,1,32,華南永昌-民權,2024-05-03,9312
1316,上曜,82,50,32,華南永昌-民權,2024-05-03,9312
2408,南亞科,33,1,32,華南永昌-民權,2024-05-03,9312
2543,皇昌,34,13,21,華南永昌-民權,2024-05-03,9312
3501,維熹,20,0,20,華南永昌-民權,2024-05-03,9312
6668,中揚光,21,1,20,華南永昌-民權,2024-05-03,9312
2515,中工,30,11,19,華南永昌-民權,2024-05-03,9312
8033,雷虎,14,0,14,華南永昌-民權,2024-05-03,9312
3231,緯創,18,5,13,華南永昌-民權,2024-05-03,9312
6120,達運,13,0,13,華南永昌-民權,2024-05-03,9312
2009,第一銅,12,1,11,華南永昌-民權,2024-05-03,9312
2731,雄獅,11,0,11,華南永昌-民權,2024-05-03,9312
6165,浪凡,11,0,11,華南永昌-民權,2024-05-03,9312
6834,天二科技,11,0,11,華南永昌-民權,2024-05-03,9312
1216,統一,10,0,10,華南永昌-民權,2024-05-03,9312
00706L,期元大S＆P日圓正2,10,0,10,華南永昌-民權,2024-05-03,9312
2017,官田鋼,110,100,10,華南永昌-民權,2024-05-03,9312
2364,倫飛,10,0,10,華南永昌-民權,2024-05-03,9312
3652,精聯,10,0,10,華南永昌-民權,2024-05-03,9312
4123,晟德,10,0,10,華南永昌-民權,2024-05-03,9312
4167,松瑞藥,10,0,10,華南永昌-民權,2024-05-03,9312
4174,浩鼎,10,0,10,華南永昌-民權,2024-05-03,9312
5426,振發,10,0,10,華南永昌-民權,2024-05-03,9312
6190,萬泰科,10,0,10,華南永昌-民權,2024-05-03,9312
6284,佳邦,11,1,10,華南永昌-民權,2024-05-03,9312
2323,中環,15,6,9,華南永昌-民權,2024-05-03,9312
00919,群益台灣精選高息,9,0,9,華南永昌-民權,2024-05-03,9312
1605,華新,9,0,9,華南永昌-民權,2024-05-03,9312
1611,中電,9,0,9,華南永昌-民權,2024-05-03,9312
2524,京城,19,10,9,華南永昌-民權,2024-05-03,9312
2705,六福,14,5,9,華南永昌-民權,2024-05-03,9312
2611,志信,8,0,8,華南永昌-民權,2024-05-03,9312
4526,東台,10,2,8,華南永昌-民權,2024-05-03,9312
5519,隆大,19,11,8,華南永昌-民權,2024-05-03,9312
6125,廣運,10,3,7,華南永昌-民權,2024-05-03,9312
1319,東陽,7,0,7,華南永昌-民權,2024-05-03,9312
2371,大同,30,23,7,華南永昌-民權,2024-05-03,9312
2511,太子,29,22,7,華南永昌-民權,2024-05-03,9312
2630,亞航,7,0,7,華南永昌-民權,2024-05-03,9312
3033,威健,12,5,7,華南永昌-民權,2024-05-03,9312
8112,至上,14,7,7,華南永昌-民權,2024-05-03,9312
00929,復華台灣科技優息,2751,0,2751,華南永昌-民權,2024-05-06,9312
00679B,元大美債20年,333,1,332,華南永昌-民權,2024-05-06,9312
2890,永豐金,300,8,292,華南永昌-民權,2024-05-06,9312
2834,臺企銀,201,1,200,華南永昌-民權,2024-05-06,9312
2603,長榮,154,1,153,華南永昌-民權,2024-05-06,9312
00940,元大台灣價值高息,99,11,88,華南永昌-民權,2024-05-06,9312
2328,廣宇,80,1,79,華南永昌-民權,2024-05-06,9312
00937B,群益ESG投等債20,64,3,61,華南永昌-民權,2024-05-06,9312
6120,達運,120,60,60,華南永昌-民權,2024-05-06,9312
3481,群創,55,0,55,華南永昌-民權,2024-05-06,9312
3501,維熹,50,0,50,華南永昌-民權,2024-05-06,9312
5512,力麒,48,0,48,華南永昌-民權,2024-05-06,9312
4905,台聯電,41,2,39,華南永昌-民權,2024-05-06,9312
2618,長榮航,44,6,38,華南永昌-民權,2024-05-06,9312
2888,新光金,125,89,36,華南永昌-民權,2024-05-06,9312
00680L,元大美債20正2,34,0,34,華南永昌-民權,2024-05-06,9312
1409,新纖,34,0,34,華南永昌-民權,2024-05-06,9312
2884,玉山金,35,2,33,華南永昌-民權,2024-05-06,9312
2409,友達,35,3,32,華南永昌-民權,2024-05-06,9312
00936,台新永續高息中小,25,0,25,華南永昌-民權,2024-05-06,9312
9933,中鼎,50,30,20,華南永昌-民權,2024-05-06,9312
1815,富喬,20,1,19,華南永昌-民權,2024-05-06,9312
8027,鈦昇,21,2,19,華南永昌-民權,2024-05-06,9312
2371,大同,19,1,18,華南永昌-民權,2024-05-06,9312
2501,國建,42,25,17,華南永昌-民權,2024-05-06,9312
9945,潤泰新,19,2,17,華南永昌-民權,2024-05-06,9312
4303,信立,18,2,16,華南永昌-民權,2024-05-06,9312
2406,國碩,15,0,15,華南永昌-民權,2024-05-06,9312
3645,達邁,15,0,15,華南永昌-民權,2024-05-06,9312
2337,旺宏,13,0,13,華南永昌-民權,2024-05-06,9312
3287,廣寰科,17,4,13,華南永昌-民權,2024-05-06,9312
2308,台達電,13,1,12,華南永昌-民權,2024-05-06,9312
8234,新漢,16,4,12,華南永昌-民權,2024-05-06,9312
2892,第一金,20,8,12,華南永昌-民權,2024-05-06,9312
2354,鴻準,14,2,12,華南永昌-民權,2024-05-06,9312
3264,欣銓,11,0,11,華南永昌-民權,2024-05-06,9312
1514,亞力,11,0,11,華南永昌-民權,2024-05-06,9312
2449,京元電子,24,14,10,華南永昌-民權,2024-05-06,9312
2417,圓剛,11,1,10,華南永昌-民權,2024-05-06,9312
3090,日電貿,30,20,10,華南永昌-民權,2024-05-06,9312
3689,湧德,10,0,10,華南永昌-民權,2024-05-06,9312
6188,廣明,10,0,10,華南永昌-民權,2024-05-06,9312
6192,巨路,10,0,10,華南永昌-民權,2024-05-06,9312
1605,華新,11,2,9,華南永昌-民權,2024-05-06,9312
2492,華新科,9,0,9,華南永昌-民權,2024-05-06,9312
5531,鄉林,9,0,9,華南永昌-民權,2024-05-06,9312
1210,大成,8,0,8,華南永昌-民權,2024-05-06,9312
2809,京城銀,8,0,8,華南永昌-民權,2024-05-06,9312
9955,佳龍,11,3,8,華南永昌-民權,2024-05-06,9312
2374,佳能,15,8,7,華南永昌-民權,2024-05-06,9312
2344,華邦電,306,0,306,華南永昌-民權,2024-05-07,9312
2897,王道銀行,270,106,164,華南永昌-民權,2024-05-07,9312
2603,長榮,116,8,108,華南永昌-民權,2024-05-07,9312
2408,南亞科,100,0,100,華南永昌-民權,2024-05-07,9312
2356,英業達,152,54,98,華南永昌-民權,2024-05-07,9312
00937B,群益ESG投等債20,105,43,62,華南永昌-民權,2024-05-07,9312
00940,元大台灣價值高息,56,3,53,華南永昌-民權,2024-05-07,9312
2374,佳能,54,11,43,華南永昌-民權,2024-05-07,9312
2027,大成鋼,54,12,42,華南永昌-民權,2024-05-07,9312
00929,復華台灣科技優息,51,13,38,華南永昌-民權,2024-05-07,9312
1605,華新,38,0,38,華南永昌-民權,2024-05-07,9312
4905,台聯電,33,0,33,華南永昌-民權,2024-05-07,9312
8383,千附,30,0,30,華南永昌-民權,2024-05-07,9312
1303,南亞,26,0,26,華南永昌-民權,2024-05-07,9312
1316,上曜,31,8,23,華南永昌-民權,2024-05-07,9312
00878,國泰永續高股息,26,3,23,華南永昌-民權,2024-05-07,9312
2515,中工,30,7,23,華南永昌-民權,2024-05-07,9312
00891,中信關鍵半導體,21,0,21,華南永昌-民權,2024-05-07,9312
5519,隆大,32,11,21,華南永昌-民權,2024-05-07,9312
00632R,元大台灣50反1,20,0,20,華南永昌-民權,2024-05-07,9312
00936,台新永續高息中小,19,0,19,華南永昌-民權,2024-05-07,9312
3576,聯合再生,23,4,19,華南永昌-民權,2024-05-07,9312
2812,台中銀,16,0,16,華南永昌-民權,2024-05-07,9312
3141,晶宏,15,0,15,華南永昌-民權,2024-05-07,9312
6757,台灣虎航,15,0,15,華南永昌-民權,2024-05-07,9312
00752,中信中國50,12,0,12,華南永昌-民權,2024-05-07,9312
2409,友達,13,1,12,華南永昌-民權,2024-05-07,9312
2509,全坤建,14,2,12,華南永昌-民權,2024-05-07,9312
5009,榮剛,12,0,12,華南永昌-民權,2024-05-07,9312
4306,炎洲,13,2,11,華南永昌-民權,2024-05-07,9312
2017,官田鋼,60,50,10,華南永昌-民權,2024-05-07,9312
3652,精聯,10,0,10,華南永昌-民權,2024-05-07,9312
6120,達運,10,0,10,華南永昌-民權,2024-05-07,9312
6829,千附精密,10,0,10,華南永昌-民權,2024-05-07,9312
9946,三發地產,9,0,9,華南永昌-民權,2024-05-07,9312
2417,圓剛,22,13,9,華南永昌-民權,2024-05-07,9312
6284,佳邦,10,1,9,華南永昌-民權,2024-05-07,9312
6443,元晶,9,0,9,華南永昌-民權,2024-05-07,9312
8234,新漢,75,66,9,華南永昌-民權,2024-05-07,9312
2520,冠德,11,3,8,華南永昌-民權,2024-05-07,9312
3481,群創,13,5,8,華南永昌-民權,2024-05-07,9312
4526,東台,8,0,8,華南永昌-民權,2024-05-07,9312
6188,廣明,37,29,8,華南永昌-民權,2024-05-07,9312
1314,中石化,15,8,7,華南永昌-民權,2024-05-07,9312
3013,晟銘電,16,9,7,華南永昌-民權,2024-05-07,9312
5388,中磊,7,0,7,華南永昌-民權,2024-05-07,9312
3081,聯亞,6,0,6,華南永昌-民權,2024-05-07,9312
4938,和碩,6,0,6,華南永昌-民權,2024-05-07,9312
6005,群益證,13,7,6,華南永昌-民權,2024-05-07,9312
2618,長榮航,27,22,5,華南永昌-民權,2024-05-07,9312
2356,英業達,213,16,197,華南永昌-民權,2024-05-08,9312
2897,王道銀行,100,0,100,華南永昌-民權,2024-05-08,9312
2014,中鴻,92,0,92,華南永昌-民權,2024-05-08,9312
6770,力積電,50,0,50,華南永昌-民權,2024-05-08,9312
5521,工信,40,0,40,華南永昌-民權,2024-05-08,9312
3481,群創,39,0,39,華南永昌-民權,2024-05-08,9312
6488,環球晶,38,1,37,華南永昌-民權,2024-05-08,9312
00929,復華台灣科技優息,62,32,30,華南永昌-民權,2024-05-08,9312
00937B,群益ESG投等債20,31,2,29,華南永昌-民權,2024-05-08,9312
2201,裕隆,32,3,29,華南永昌-民權,2024-05-08,9312
5386,青雲,30,5,25,華南永昌-民權,2024-05-08,9312
4905,台聯電,25,1,24,華南永昌-民權,2024-05-08,9312
5519,隆大,27,4,23,華南永昌-民權,2024-05-08,9312
2618,長榮航,125,105,20,華南永昌-民權,2024-05-08,9312
2409,友達,23,5,18,華南永昌-民權,2024-05-08,9312
2605,新興,53,37,16,華南永昌-民權,2024-05-08,9312
6005,群益證,21,6,15,華南永昌-民權,2024-05-08,9312
5871,中租-KY,21,6,15,華南永昌-民權,2024-05-08,9312
00940,元大台灣價值高息,17,3,14,華南永昌-民權,2024-05-08,9312
8996,高力,15,1,14,華南永昌-民權,2024-05-08,9312
2524,京城,13,0,13,華南永昌-民權,2024-05-08,9312
2002,中鋼,14,2,12,華南永昌-民權,2024-05-08,9312
2408,南亞科,12,0,12,華南永昌-民權,2024-05-08,9312
5009,榮剛,22,10,12,華南永昌-民權,2024-05-08,9312
2883,凱基金,12,1,11,華南永昌-民權,2024-05-08,9312
00878,國泰永續高股息,12,2,10,華南永昌-民權,2024-05-08,9312
1413,宏洲,10,0,10,華南永昌-民權,2024-05-08,9312
1440,南紡,10,0,10,華南永昌-民權,2024-05-08,9312
1618,合機,18,8,10,華南永昌-民權,2024-05-08,9312
2509,全坤建,10,0,10,華南永昌-民權,2024-05-08,9312
1314,中石化,26,17,9,華南永昌-民權,2024-05-08,9312
1608,華榮,12,4,8,華南永昌-民權,2024-05-08,9312
2303,聯電,9,1,8,華南永昌-民權,2024-05-08,9312
2891,中信金,13,5,8,華南永昌-民權,2024-05-08,9312
2374,佳能,17,9,8,華南永昌-民權,2024-05-08,9312
2603,長榮,18,11,7,華南永昌-民權,2024-05-08,9312
00919,群益台灣精選高息,7,0,7,華南永昌-民權,2024-05-08,9312
1612,宏泰,10,3,7,華南永昌-民權,2024-05-08,9312
2852,第一保,7,0,7,華南永昌-民權,2024-05-08,9312
6016,康和證,10,3,7,華南永昌-民權,2024-05-08,9312
2101,南港,20,14,6,華南永昌-民權,2024-05-08,9312
2610,華航,15,9,6,華南永昌-民權,2024-05-08,9312
4306,炎洲,6,0,6,華南永昌-民權,2024-05-08,9312
5508,永信建,18,12,6,華南永昌-民權,2024-05-08,9312
1605,華新,6,1,5,華南永昌-民權,2024-05-08,9312
3163,波若威,6,1,5,華南永昌-民權,2024-05-08,9312
00923,群益台ESG低碳50,5,0,5,華南永昌-民權,2024-05-08,9312
00665L,富邦�琤肭磪囓�2,5,0,5,華南永昌-民權,2024-05-08,9312
1903,士紙,5,0,5,華南永昌-民權,2024-05-08,9312
2329,華泰,5,0,5,華南永昌-民權,2024-05-08,9312
2374,佳能,1057,57,1000,華南永昌-民權,2024-05-09,9312
2609,陽明,520,238,282,華南永昌-民權,2024-05-09,9312
00929,復華台灣科技優息,112,0,112,華南永昌-民權,2024-05-09,9312
2615,萬海,106,25,81,華南永昌-民權,2024-05-09,9312
3402,漢科,55,0,55,華南永昌-民權,2024-05-09,9312
2634,漢翔,45,0,45,華南永昌-民權,2024-05-09,9312
2836,高雄銀,45,2,43,華南永昌-民權,2024-05-09,9312
1109,信大,42,0,42,華南永昌-民權,2024-05-09,9312
0056,元大高股息,41,0,41,華南永昌-民權,2024-05-09,9312
00937B,群益ESG投等債20,41,0,41,華南永昌-民權,2024-05-09,9312
00632R,元大台灣50反1,40,0,40,華南永昌-民權,2024-05-09,9312
2515,中工,46,18,28,華南永昌-民權,2024-05-09,9312
2002,中鋼,26,0,26,華南永昌-民權,2024-05-09,9312
00944,野村趨勢動能高息,21,0,21,華南永昌-民權,2024-05-09,9312
1447,力鵬,20,0,20,華南永昌-民權,2024-05-09,9312
6168,宏齊,20,0,20,華南永昌-民權,2024-05-09,9312
8112,至上,20,3,17,華南永昌-民權,2024-05-09,9312
2834,臺企銀,17,0,17,華南永昌-民權,2024-05-09,9312
1314,中石化,18,2,16,華南永昌-民權,2024-05-09,9312
00679B,元大美債20年,16,0,16,華南永昌-民權,2024-05-09,9312
1714,和桐,15,0,15,華南永昌-民權,2024-05-09,9312
6488,環球晶,13,0,13,華南永昌-民權,2024-05-09,9312
2363,矽統,16,4,12,華南永昌-民權,2024-05-09,9312
2537,聯上發,12,0,12,華南永昌-民權,2024-05-09,9312
2409,友達,11,0,11,華南永昌-民權,2024-05-09,9312
2913,農林,11,0,11,華南永昌-民權,2024-05-09,9312
1310,台苯,10,0,10,華南永昌-民權,2024-05-09,9312
5864,致和證,10,0,10,華南永昌-民權,2024-05-09,9312
6197,佳必琪,20,10,10,華南永昌-民權,2024-05-09,9312
3231,緯創,15,6,9,華南永昌-民權,2024-05-09,9312
1612,宏泰,10,1,9,華南永昌-民權,2024-05-09,9312
2009,第一銅,14,5,9,華南永昌-民權,2024-05-09,9312
6120,達運,10,1,9,華南永昌-民權,2024-05-09,9312
9946,三發地產,8,0,8,華南永昌-民權,2024-05-09,9312
1605,華新,28,20,8,華南永昌-民權,2024-05-09,9312
2027,大成鋼,8,0,8,華南永昌-民權,2024-05-09,9312
00940,元大台灣價值高息,7,0,7,華南永昌-民權,2024-05-09,9312
1609,大亞,10,3,7,華南永昌-民權,2024-05-09,9312
2371,大同,10,3,7,華南永昌-民權,2024-05-09,9312
00934,中信成長高股息,6,0,6,華南永昌-民權,2024-05-09,9312
2501,國建,15,9,6,華南永昌-民權,2024-05-09,9312
00878,國泰永續高股息,6,0,6,華南永昌-民權,2024-05-09,9312
00933B,國泰10Y+金融債,6,0,6,華南永昌-民權,2024-05-09,9312
00932,兆豐永續高息等權,6,0,6,華南永昌-民權,2024-05-09,9312
3036,文曄,10,4,6,華南永昌-民權,2024-05-09,9312
3041,揚智,7,1,6,華南永昌-民權,2024-05-09,9312
3081,聯亞,6,0,6,華南永昌-民權,2024-05-09,9312
1104,環泥,5,0,5,華南永昌-民權,2024-05-09,9312
1101,台泥,6,1,5,華南永昌-民權,2024-05-09,9312
00927,群益半導體收益,5,0,5,華南永昌-民權,2024-05-09,9312
2606,裕民,292,183,109,華南永昌-民權,2024-05-10,9312
2884,玉山金,112,17,95,華南永昌-民權,2024-05-10,9312
00929,復華台灣科技優息,156,82,74,華南永昌-民權,2024-05-10,9312
2313,華通,70,1,69,華南永昌-民權,2024-05-10,9312
2409,友達,69,5,64,華南永昌-民權,2024-05-10,9312
00679B,元大美債20年,106,43,63,華南永昌-民權,2024-05-10,9312
00946,群益科技高息成長,47,0,47,華南永昌-民權,2024-05-10,9312
5521,工信,35,0,35,華南永昌-民權,2024-05-10,9312
2101,南港,34,0,34,華南永昌-民權,2024-05-10,9312
00940,元大台灣價值高息,41,10,31,華南永昌-民權,2024-05-10,9312
2356,英業達,59,34,25,華南永昌-民權,2024-05-10,9312
00632R,元大台灣50反1,25,0,25,華南永昌-民權,2024-05-10,9312
2634,漢翔,23,0,23,華南永昌-民權,2024-05-10,9312
1447,力鵬,21,1,20,華南永昌-民權,2024-05-10,9312
3652,精聯,20,0,20,華南永昌-民權,2024-05-10,9312
8112,至上,27,10,17,華南永昌-民權,2024-05-10,9312
5512,力麒,16,0,16,華南永昌-民權,2024-05-10,9312
2524,京城,12,0,12,華南永昌-民權,2024-05-10,9312
2371,大同,13,2,11,華南永昌-民權,2024-05-10,9312
1721,三晃,15,4,11,華南永昌-民權,2024-05-10,9312
3481,群創,14,3,11,華南永昌-民權,2024-05-10,9312
6223,旺矽,12,1,11,華南永昌-民權,2024-05-10,9312
00900,富邦特選高股息30,10,0,10,華南永昌-民權,2024-05-10,9312
1324,地球,10,0,10,華南永昌-民權,2024-05-10,9312
2509,全坤建,10,0,10,華南永昌-民權,2024-05-10,9312
3303,岱稜,10,0,10,華南永昌-民權,2024-05-10,9312
3501,維熹,10,0,10,華南永昌-民權,2024-05-10,9312
5522,遠雄,10,0,10,華南永昌-民權,2024-05-10,9312
3512,皇龍,8,0,8,華南永昌-民權,2024-05-10,9312
4303,信立,9,2,7,華南永昌-民權,2024-05-10,9312
2812,台中銀,16,10,6,華南永昌-民權,2024-05-10,9312
1319,東陽,6,0,6,華南永昌-民權,2024-05-10,9312
2852,第一保,6,0,6,華南永昌-民權,2024-05-10,9312
6239,力成,6,0,6,華南永昌-民權,2024-05-10,9312
2405,輔信,15,10,5,華南永昌-民權,2024-05-10,9312
2458,義隆,5,0,5,華南永昌-民權,2024-05-10,9312
3032,偉訓,5,0,5,華南永昌-民權,2024-05-10,9312
3217,優群,6,1,5,華南永昌-民權,2024-05-10,9312
4526,東台,5,0,5,華南永昌-民權,2024-05-10,9312
5201,凱衛,10,5,5,華南永昌-民權,2024-05-10,9312
6016,康和證,5,0,5,華南永昌-民權,2024-05-10,9312
6120,達運,5,0,5,華南永昌-民權,2024-05-10,9312
8039,台虹,5,0,5,華南永昌-民權,2024-05-10,9312
2317,鴻海,7,2,5,華南永昌-民權,2024-05-10,9312
2915,潤泰全,5,1,4,華南永昌-民權,2024-05-10,9312
00665L,富邦�琤肭磪囓�2,4,0,4,華南永昌-民權,2024-05-10,9312
1503,士電,4,0,4,華南永昌-民權,2024-05-10,9312
1608,華榮,6,2,4,華南永昌-民權,2024-05-10,9312
1609,大亞,7,3,4,華南永昌-民權,2024-05-10,9312
1815,富喬,13,9,4,華南永昌-民權,2024-05-10,9312
2356,英業達,1362,13,1349,華南永昌-民權,2024-05-13,9312
1447,力鵬,331,0,331,華南永昌-民權,2024-05-13,9312
2883,凱基金,181,19,162,華南永昌-民權,2024-05-13,9312
2603,長榮,137,26,111,華南永昌-民權,2024-05-13,9312
00929,復華台灣科技優息,96,0,96,華南永昌-民權,2024-05-13,9312
2374,佳能,121,32,89,華南永昌-民權,2024-05-13,9312
1440,南紡,50,0,50,華南永昌-民權,2024-05-13,9312
5521,工信,36,0,36,華南永昌-民權,2024-05-13,9312
5340,建榮,39,4,35,華南永昌-民權,2024-05-13,9312
2634,漢翔,35,1,34,華南永昌-民權,2024-05-13,9312
1474,弘裕,33,0,33,華南永昌-民權,2024-05-13,9312
00919,群益台灣精選高息,33,1,32,華南永昌-民權,2024-05-13,9312
1605,華新,34,2,32,華南永昌-民權,2024-05-13,9312
5519,隆大,31,0,31,華南永昌-民權,2024-05-13,9312
3188,鑫龍騰,30,0,30,華南永昌-民權,2024-05-13,9312
2610,華航,108,79,29,華南永昌-民權,2024-05-13,9312
3303,岱稜,21,0,21,華南永昌-民權,2024-05-13,9312
3501,維熹,20,0,20,華南永昌-民權,2024-05-13,9312
3652,精聯,20,0,20,華南永昌-民權,2024-05-13,9312
1314,中石化,28,9,19,華南永昌-民權,2024-05-13,9312
00937B,群益ESG投等債20,16,0,16,華南永昌-民權,2024-05-13,9312
2371,大同,57,41,16,華南永昌-民權,2024-05-13,9312
2317,鴻海,18,3,15,華南永昌-民權,2024-05-13,9312
2892,第一金,15,0,15,華南永昌-民權,2024-05-13,9312
6227,茂綸,14,0,14,華南永昌-民權,2024-05-13,9312
1608,華榮,16,3,13,華南永昌-民權,2024-05-13,9312
2601,益航,13,0,13,華南永昌-民權,2024-05-13,9312
3231,緯創,17,5,12,華南永昌-民權,2024-05-13,9312
00632R,元大台灣50反1,15,3,12,華南永昌-民權,2024-05-13,9312
2324,仁寶,12,0,12,華南永昌-民權,2024-05-13,9312
5475,德宏,12,0,12,華南永昌-民權,2024-05-13,9312
00633L,富邦上証正2,11,0,11,華南永昌-民權,2024-05-13,9312
2524,京城,11,0,11,華南永昌-民權,2024-05-13,9312
2809,京城銀,12,2,10,華南永昌-民權,2024-05-13,9312
2637,慧洋-KY,58,48,10,華南永昌-民權,2024-05-13,9312
2376,技嘉,11,1,10,華南永昌-民權,2024-05-13,9312
00637L,元大滬深300正2,70,60,10,華南永昌-民權,2024-05-13,9312
1504,東元,12,2,10,華南永昌-民權,2024-05-13,9312
1616,億泰,10,0,10,華南永昌-民權,2024-05-13,9312
3576,聯合再生,10,0,10,華南永昌-民權,2024-05-13,9312
5009,榮剛,20,10,10,華南永昌-民權,2024-05-13,9312
3060,銘異,11,2,9,華南永昌-民權,2024-05-13,9312
1513,中興電,9,1,8,華南永昌-民權,2024-05-13,9312
00927,群益半導體收益,8,0,8,華南永昌-民權,2024-05-13,9312
00944,野村趨勢動能高息,10,2,8,華南永昌-民權,2024-05-13,9312
2420,新巨,8,0,8,華南永昌-民權,2024-05-13,9312
8086,宏捷科,8,0,8,華南永昌-民權,2024-05-13,9312
1110,東泥,7,0,7,華南永昌-民權,2024-05-13,9312
2486,一詮,7,0,7,華南永昌-民權,2024-05-13,9312
3287,廣寰科,7,0,7,華南永昌-民權,2024-05-13,9312
2890,永豐金,405,1,404,華南永昌-民權,2024-05-14,9312
3481,群創,108,10,98,華南永昌-民權,2024-05-14,9312
1605,華新,59,0,59,華南永昌-民權,2024-05-14,9312
2344,華邦電,55,2,53,華南永昌-民權,2024-05-14,9312
8936,國統,44,3,41,華南永昌-民權,2024-05-14,9312
0056,元大高股息,30,5,25,華南永昌-民權,2024-05-14,9312
2615,萬海,87,66,21,華南永昌-民權,2024-05-14,9312
2009,第一銅,20,0,20,華南永昌-民權,2024-05-14,9312
2374,佳能,423,404,19,華南永昌-民權,2024-05-14,9312
2617,台航,19,1,18,華南永昌-民權,2024-05-14,9312
2371,大同,21,5,16,華南永昌-民權,2024-05-14,9312
2208,台船,15,0,15,華南永昌-民權,2024-05-14,9312
8071,能率網通,13,0,13,華南永昌-民權,2024-05-14,9312
1701,中化,22,10,12,華南永昌-民權,2024-05-14,9312
2731,雄獅,13,1,12,華南永昌-民權,2024-05-14,9312
2892,第一金,11,0,11,華南永昌-民權,2024-05-14,9312
00929,復華台灣科技優息,11,0,11,華南永昌-民權,2024-05-14,9312
3035,智原,26,15,11,華南永昌-民權,2024-05-14,9312
6177,達麗,11,0,11,華南永昌-民權,2024-05-14,9312
00915,凱基優選高股息30,10,0,10,華南永昌-民權,2024-05-14,9312
2509,全坤建,30,20,10,華南永昌-民權,2024-05-14,9312
2836,高雄銀,23,13,10,華南永昌-民權,2024-05-14,9312
2887,台新金,10,0,10,華南永昌-民權,2024-05-14,9312
6542,隆中,10,0,10,華南永昌-民權,2024-05-14,9312
5871,中租-KY,9,0,9,華南永昌-民權,2024-05-14,9312
2537,聯上發,13,4,9,華南永昌-民權,2024-05-14,9312
2867,三商壽,10,1,9,華南永昌-民權,2024-05-14,9312
1110,東泥,13,5,8,華南永昌-民權,2024-05-14,9312
2702,華園,8,0,8,華南永昌-民權,2024-05-14,9312
2852,第一保,9,1,8,華南永昌-民權,2024-05-14,9312
6153,嘉聯益,8,0,8,華南永昌-民權,2024-05-14,9312
6834,天二科技,10,2,8,華南永昌-民權,2024-05-14,9312
3005,神基,6,0,6,華南永昌-民權,2024-05-14,9312
1524,耿鼎,8,2,6,華南永昌-民權,2024-05-14,9312
1760,寶齡富錦,6,0,6,華南永昌-民權,2024-05-14,9312
2481,強茂,9,3,6,華南永昌-民權,2024-05-14,9312
2324,仁寶,22,17,5,華南永昌-民權,2024-05-14,9312
2489,瑞軒,5,0,5,華南永昌-民權,2024-05-14,9312
1453,大將,5,0,5,華南永昌-民權,2024-05-14,9312
1446,宏和,5,0,5,華南永昌-民權,2024-05-14,9312
1503,士電,9,4,5,華南永昌-民權,2024-05-14,9312
00637L,元大滬深300正2,205,200,5,華南永昌-民權,2024-05-14,9312
1723,中碳,5,0,5,華南永昌-民權,2024-05-14,9312
2385,群光,5,0,5,華南永昌-民權,2024-05-14,9312
2449,京元電子,6,1,5,華南永昌-民權,2024-05-14,9312
2501,國建,13,8,5,華南永昌-民權,2024-05-14,9312
2520,冠德,5,0,5,華南永昌-民權,2024-05-14,9312
2888,新光金,5,0,5,華南永昌-民權,2024-05-14,9312
4113,聯上,5,0,5,華南永昌-民權,2024-05-14,9312
4562,穎漢,16,11,5,華南永昌-民權,2024-05-14,9312
2356,英業達,517,150,367,華南永昌-民權,2024-05-15,9312
2344,華邦電,655,405,250,華南永昌-民權,2024-05-15,9312
00940,元大台灣價值高息,63,1,62,華南永昌-民權,2024-05-15,9312
00679B,元大美債20年,51,7,44,華南永昌-民權,2024-05-15,9312
00945B,凱基美國非投等債,40,0,40,華南永昌-民權,2024-05-15,9312
2337,旺宏,30,0,30,華南永昌-民權,2024-05-15,9312
2363,矽統,30,3,27,華南永昌-民權,2024-05-15,9312
00939,統一台灣高息動能,30,7,23,華南永昌-民權,2024-05-15,9312
2812,台中銀,37,15,22,華南永昌-民權,2024-05-15,9312
1447,力鵬,21,0,21,華南永昌-民權,2024-05-15,9312
00919,群益台灣精選高息,21,1,20,華南永昌-民權,2024-05-15,9312
2509,全坤建,20,0,20,華南永昌-民權,2024-05-15,9312
5340,建榮,20,0,20,華南永昌-民權,2024-05-15,9312
8071,能率網通,18,0,18,華南永昌-民權,2024-05-15,9312
00932,兆豐永續高息等權,18,0,18,華南永昌-民權,2024-05-15,9312
2890,永豐金,17,0,17,華南永昌-民權,2024-05-15,9312
1609,大亞,19,2,17,華南永昌-民權,2024-05-15,9312
00937B,群益ESG投等債20,15,0,15,華南永昌-民權,2024-05-15,9312
2603,長榮,35,20,15,華南永昌-民權,2024-05-15,9312
2605,新興,12,0,12,華南永昌-民權,2024-05-15,9312
3234,光環,13,1,12,華南永昌-民權,2024-05-15,9312
1303,南亞,12,1,11,華南永昌-民權,2024-05-15,9312
6120,達運,11,0,11,華南永昌-民權,2024-05-15,9312
2303,聯電,22,11,11,華南永昌-民權,2024-05-15,9312
00878,國泰永續高股息,19,9,10,華南永昌-民權,2024-05-15,9312
1722,台肥,10,0,10,華南永昌-民權,2024-05-15,9312
2524,京城,10,0,10,華南永昌-民權,2024-05-15,9312
3213,茂訊,10,0,10,華南永昌-民權,2024-05-15,9312
6177,達麗,16,6,10,華南永昌-民權,2024-05-15,9312
5608,四維航,10,1,9,華南永昌-民權,2024-05-15,9312
00680L,元大美債20正2,10,1,9,華南永昌-民權,2024-05-15,9312
2618,長榮航,14,5,9,華南永昌-民權,2024-05-15,9312
2883B,凱基金乙特,9,0,9,華南永昌-民權,2024-05-15,9312
3010,華立,10,1,9,華南永昌-民權,2024-05-15,9312
1101,台泥,10,2,8,華南永昌-民權,2024-05-15,9312
2101,南港,8,0,8,華南永昌-民權,2024-05-15,9312
4402,郡都開發,8,0,8,華南永昌-民權,2024-05-15,9312
6770,力積電,7,0,7,華南永昌-民權,2024-05-15,9312
1301,台塑,7,0,7,華南永昌-民權,2024-05-15,9312
4916,事欣科,7,0,7,華南永昌-民權,2024-05-15,9312
6443,元晶,15,8,7,華南永昌-民權,2024-05-15,9312
00929,復華台灣科技優息,6,0,6,華南永昌-民權,2024-05-15,9312
2405,輔信,22,16,6,華南永昌-民權,2024-05-15,9312
2511,太子,6,0,6,華南永昌-民權,2024-05-15,9312
2371,大同,25,19,6,華南永昌-民權,2024-05-15,9312
6125,廣運,27,21,6,華南永昌-民權,2024-05-15,9312
2313,華通,5,0,5,華南永昌-民權,2024-05-15,9312
00637L,元大滬深300正2,5,0,5,華南永昌-民權,2024-05-15,9312
1504,東元,6,1,5,華南永昌-民權,2024-05-15,9312
1905,華紙,5,0,5,華南永昌-民權,2024-05-15,9312
1447,力鵬,288,1,287,華南永昌-民權,2024-05-16,9312
2382,廣達,287,141,146,華南永昌-民權,2024-05-16,9312
3490,單井,101,0,101,華南永昌-民權,2024-05-16,9312
4123,晟德,115,15,100,華南永昌-民權,2024-05-16,9312
8436,大江,100,0,100,華南永昌-民權,2024-05-16,9312
1608,華榮,34,4,30,華南永昌-民權,2024-05-16,9312
1722,台肥,20,0,20,華南永昌-民權,2024-05-16,9312
2509,全坤建,20,0,20,華南永昌-民權,2024-05-16,9312
0056,元大高股息,27,8,19,華南永昌-民權,2024-05-16,9312
8069,元太,14,0,14,華南永昌-民權,2024-05-16,9312
2880,華南金,21,9,12,華南永昌-民權,2024-05-16,9312
00680L,元大美債20正2,13,1,12,華南永昌-民權,2024-05-16,9312
6215,和椿,79,67,12,華南永昌-民權,2024-05-16,9312
3231,緯創,25,13,12,華南永昌-民權,2024-05-16,9312
2301,光寶科,11,0,11,華南永昌-民權,2024-05-16,9312
8054,安國,26,15,11,華南永昌-民權,2024-05-16,9312
00650L,復華香港正2,10,0,10,華南永昌-民權,2024-05-16,9312
2101,南港,50,40,10,華南永昌-民權,2024-05-16,9312
2501,國建,12,2,10,華南永昌-民權,2024-05-16,9312
2913,農林,11,1,10,華南永昌-民權,2024-05-16,9312
2317,鴻海,24,15,9,華南永昌-民權,2024-05-16,9312
1503,士電,15,6,9,華南永昌-民權,2024-05-16,9312
00878,國泰永續高股息,9,1,8,華南永昌-民權,2024-05-16,9312
3047,訊舟,10,2,8,華南永昌-民權,2024-05-16,9312
5519,隆大,8,0,8,華南永昌-民權,2024-05-16,9312
2882,國泰金,10,2,8,華南永昌-民權,2024-05-16,9312
00933B,國泰10Y+金融債,7,0,7,華南永昌-民權,2024-05-16,9312
1319,東陽,7,0,7,華南永昌-民權,2024-05-16,9312
3498,陽程,8,1,7,華南永昌-民權,2024-05-16,9312
4554,橙的,7,0,7,華南永昌-民權,2024-05-16,9312
6177,達麗,8,1,7,華南永昌-民權,2024-05-16,9312
00632R,元大台灣50反1,6,0,6,華南永昌-民權,2024-05-16,9312
2359,所羅門,22,16,6,華南永昌-民權,2024-05-16,9312
2405,輔信,7,1,6,華南永昌-民權,2024-05-16,9312
6005,群益證,10,4,6,華南永昌-民權,2024-05-16,9312
8096,擎亞,7,1,6,華南永昌-民權,2024-05-16,9312
2421,建準,5,0,5,華南永昌-民權,2024-05-16,9312
1905,華紙,5,0,5,華南永昌-民權,2024-05-16,9312
2201,裕隆,5,0,5,華南永昌-民權,2024-05-16,9312
2348,海悅,11,6,5,華南永昌-民權,2024-05-16,9312
2369,菱生,5,0,5,華南永昌-民權,2024-05-16,9312
2408,南亞科,5,0,5,華南永昌-民權,2024-05-16,9312
2537,聯上發,10,5,5,華南永昌-民權,2024-05-16,9312
8110,華東,7,2,5,華南永昌-民權,2024-05-16,9312
2399,映泰,5,0,5,華南永昌-民權,2024-05-16,9312
2464,盟立,9,4,5,華南永昌-民權,2024-05-16,9312
00940,元大台灣價值高息,11,7,4,華南永昌-民權,2024-05-16,9312
2885,元大金,6,2,4,華南永昌-民權,2024-05-16,9312
5392,能率,6,2,4,華南永昌-民權,2024-05-16,9312
6834,天二科技,4,0,4,華南永昌-民權,2024-05-16,9312
2356,英業達,614,3,611,華南永昌-民權,2024-05-17,9312
2344,華邦電,200,5,195,華南永昌-民權,2024-05-17,9312
1314,中石化,73,2,71,華南永昌-民權,2024-05-17,9312
6116,彩晶,50,0,50,華南永昌-民權,2024-05-17,9312
2313,華通,60,11,49,華南永昌-民權,2024-05-17,9312
3481,群創,52,5,47,華南永昌-民權,2024-05-17,9312
00878,國泰永續高股息,40,0,40,華南永昌-民權,2024-05-17,9312
2610,華航,62,25,37,華南永昌-民權,2024-05-17,9312
5498,凱崴,31,0,31,華南永昌-民權,2024-05-17,9312
00680L,元大美債20正2,30,0,30,華南永昌-民權,2024-05-17,9312
2317,鴻海,27,2,25,華南永昌-民權,2024-05-17,9312
2409,友達,34,9,25,華南永昌-民權,2024-05-17,9312
1717,長興,23,0,23,華南永昌-民權,2024-05-17,9312
4739,康普,23,0,23,華南永昌-民權,2024-05-17,9312
2489,瑞軒,39,18,21,華南永昌-民權,2024-05-17,9312
00937B,群益ESG投等債20,22,1,21,華南永昌-民權,2024-05-17,9312
2374,佳能,77,56,21,華南永昌-民權,2024-05-17,9312
2349,錸德,20,0,20,華南永昌-民權,2024-05-17,9312
2408,南亞科,19,0,19,華南永昌-民權,2024-05-17,9312
1303,南亞,18,0,18,華南永昌-民權,2024-05-17,9312
2612,中航,18,0,18,華南永昌-民權,2024-05-17,9312
8936,國統,18,1,17,華南永昌-民權,2024-05-17,9312
00679B,元大美債20年,16,1,15,華南永昌-民權,2024-05-17,9312
3047,訊舟,34,19,15,華南永昌-民權,2024-05-17,9312
2102,泰豐,14,0,14,華南永昌-民權,2024-05-17,9312
2323,中環,20,7,13,華南永昌-民權,2024-05-17,9312
1227,佳格,12,0,12,華南永昌-民權,2024-05-17,9312
2606,裕民,14,2,12,華南永昌-民權,2024-05-17,9312
8358,金居,12,1,11,華南永昌-民權,2024-05-17,9312
00940,元大台灣價值高息,11,0,11,華南永昌-民權,2024-05-17,9312
1447,力鵬,11,0,11,華南永昌-民權,2024-05-17,9312
3024,憶聲,11,0,11,華南永昌-民權,2024-05-17,9312
3264,欣銓,11,0,11,華南永昌-民權,2024-05-17,9312
00945B,凱基美國非投等債,10,0,10,華南永昌-民權,2024-05-17,9312
00632R,元大台灣50反1,10,0,10,華南永昌-民權,2024-05-17,9312
1442,名軒,10,0,10,華南永昌-民權,2024-05-17,9312
2444,兆勁,10,0,10,華南永昌-民權,2024-05-17,9312
2449,京元電子,13,3,10,華南永昌-民權,2024-05-17,9312
2701,萬企,10,0,10,華南永昌-民權,2024-05-17,9312
1587,吉茂,18,9,9,華南永昌-民權,2024-05-17,9312
2618,長榮航,19,10,9,華南永昌-民權,2024-05-17,9312
2609,陽明,19,10,9,華南永昌-民權,2024-05-17,9312
3234,光環,8,0,8,華南永昌-民權,2024-05-17,9312
8033,雷虎,11,4,7,華南永昌-民權,2024-05-17,9312
3706,神達,11,4,7,華南永昌-民權,2024-05-17,9312
6215,和椿,68,62,6,華南永昌-民權,2024-05-17,9312
8110,華東,6,0,6,華南永昌-民權,2024-05-17,9312
6770,力積電,12,6,6,華南永昌-民權,2024-05-17,9312
2613,中櫃,5,0,5,華南永昌-民權,2024-05-17,9312
00637L,元大滬深300正2,5,0,5,華南永昌-民權,2024-05-17,9312
00720B,元大投資級公司債,605,5,600,華南永昌-民權,2024-05-20,9312
00937B,群益ESG投等債20,55,1,54,華南永昌-民權,2024-05-20,9312
2867,三商壽,47,5,42,華南永昌-民權,2024-05-20,9312
1618,合機,40,1,39,華南永昌-民權,2024-05-20,9312
4563,百德,37,0,37,華南永昌-民權,2024-05-20,9312
1312,國喬,30,0,30,華南永昌-民權,2024-05-20,9312
2102,泰豐,26,0,26,華南永昌-民權,2024-05-20,9312
00929,復華台灣科技優息,46,20,26,華南永昌-民權,2024-05-20,9312
2204,中華,25,1,24,華南永昌-民權,2024-05-20,9312
8936,國統,22,0,22,華南永昌-民權,2024-05-20,9312
1210,大成,20,0,20,華南永昌-民權,2024-05-20,9312
2618,長榮航,29,9,20,華南永昌-民權,2024-05-20,9312
8436,大江,20,0,20,華南永昌-民權,2024-05-20,9312
2547,日勝生,20,3,17,華南永昌-民權,2024-05-20,9312
8033,雷虎,17,1,16,華南永昌-民權,2024-05-20,9312
1714,和桐,16,0,16,華南永昌-民權,2024-05-20,9312
5392,能率,122,107,15,華南永昌-民權,2024-05-20,9312
5519,隆大,17,2,15,華南永昌-民權,2024-05-20,9312
2317,鴻海,23,8,15,華南永昌-民權,2024-05-20,9312
00946,群益科技高息成長,15,0,15,華南永昌-民權,2024-05-20,9312
3047,訊舟,14,0,14,華南永昌-民權,2024-05-20,9312
3231,緯創,13,0,13,華南永昌-民權,2024-05-20,9312
00679B,元大美債20年,13,0,13,華南永昌-民權,2024-05-20,9312
3689,湧德,13,0,13,華南永昌-民權,2024-05-20,9312
4562,穎漢,13,0,13,華南永昌-民權,2024-05-20,9312
1598,岱宇,11,0,11,華南永昌-民權,2024-05-20,9312
2352,佳世達,10,0,10,華南永昌-民權,2024-05-20,9312
1314,中石化,42,32,10,華南永昌-民權,2024-05-20,9312
2444,兆勁,10,0,10,華南永昌-民權,2024-05-20,9312
2461,光群雷,10,0,10,華南永昌-民權,2024-05-20,9312
2509,全坤建,10,0,10,華南永昌-民權,2024-05-20,9312
4999,鑫禾,10,0,10,華南永昌-民權,2024-05-20,9312
5498,凱崴,10,0,10,華南永昌-民權,2024-05-20,9312
6126,信音,10,0,10,華南永昌-民權,2024-05-20,9312
2101,南港,11,3,8,華南永昌-民權,2024-05-20,9312
1591,駿吉-KY,7,0,7,華南永昌-民權,2024-05-20,9312
2515,中工,36,29,7,華南永昌-民權,2024-05-20,9312
8054,安國,27,20,7,華南永昌-民權,2024-05-20,9312
1503,士電,7,0,7,華南永昌-民權,2024-05-20,9312
8358,金居,16,9,7,華南永昌-民權,2024-05-20,9312
2442,新美齊,8,1,7,華南永昌-民權,2024-05-20,9312
6415,矽力*-KY,6,0,6,華南永昌-民權,2024-05-20,9312
00918,大華優利高填息30,6,0,6,華南永昌-民權,2024-05-20,9312
2852,第一保,6,0,6,華南永昌-民權,2024-05-20,9312
5009,榮剛,16,10,6,華南永昌-民權,2024-05-20,9312
6123,上奇,9,3,6,華南永昌-民權,2024-05-20,9312
6443,元晶,12,6,6,華南永昌-民權,2024-05-20,9312
00878,國泰永續高股息,18,12,6,華南永昌-民權,2024-05-20,9312
2812,台中銀,8,3,5,華南永昌-民權,2024-05-20,9312
2211,長榮鋼,5,0,5,華南永昌-民權,2024-05-20,9312
1785,光洋科,2003,11,1992,華南永昌-民權,2024-05-21,9312
2887,台新金,370,24,346,華南永昌-民權,2024-05-21,9312
00940,元大台灣價值高息,267,0,267,華南永昌-民權,2024-05-21,9312
00929,復華台灣科技優息,124,0,124,華南永昌-民權,2024-05-21,9312
4999,鑫禾,40,0,40,華南永昌-民權,2024-05-21,9312
5521,工信,40,0,40,華南永昌-民權,2024-05-21,9312
2409,友達,32,1,31,華南永昌-民權,2024-05-21,9312
00751B,元大AAA至A公司債,30,0,30,華南永昌-民權,2024-05-21,9312
1609,大亞,25,2,23,華南永昌-民權,2024-05-21,9312
2867,三商壽,25,2,23,華南永昌-民權,2024-05-21,9312
3024,憶聲,20,1,19,華南永昌-民權,2024-05-21,9312
1303,南亞,48,30,18,華南永昌-民權,2024-05-21,9312
1815,富喬,25,9,16,華南永昌-民權,2024-05-21,9312
00919,群益台灣精選高息,15,0,15,華南永昌-民權,2024-05-21,9312
2891,中信金,15,0,15,華南永昌-民權,2024-05-21,9312
1504,東元,15,0,15,華南永昌-民權,2024-05-21,9312
3264,欣銓,12,0,12,華南永昌-民權,2024-05-21,9312
00918,大華優利高填息30,11,0,11,華南永昌-民權,2024-05-21,9312
2883,凱基金,12,1,11,華南永昌-民權,2024-05-21,9312
3481,群創,11,0,11,華南永昌-民權,2024-05-21,9312
8033,雷虎,11,0,11,華南永昌-民權,2024-05-21,9312
00878,國泰永續高股息,17,7,10,華南永昌-民權,2024-05-21,9312
1101,台泥,11,1,10,華南永昌-民權,2024-05-21,9312
3305,昇貿,10,0,10,華南永昌-民權,2024-05-21,9312
00720B,元大投資級公司債,10,0,10,華南永昌-民權,2024-05-21,9312
2444,兆勁,10,0,10,華南永昌-民權,2024-05-21,9312
2489,瑞軒,23,13,10,華南永昌-民權,2024-05-21,9312
4532,瑞智,10,0,10,華南永昌-民權,2024-05-21,9312
5498,凱崴,10,0,10,華南永昌-民權,2024-05-21,9312
2027,大成鋼,10,0,10,華南永昌-民權,2024-05-21,9312
1301,台塑,14,6,8,華南永昌-民權,2024-05-21,9312
1314,中石化,43,35,8,華南永昌-民權,2024-05-21,9312
1321,大洋,8,0,8,華南永昌-民權,2024-05-21,9312
2504,國產,8,0,8,華南永昌-民權,2024-05-21,9312
2537,聯上發,10,2,8,華南永昌-民權,2024-05-21,9312
2382,廣達,9,1,8,華南永昌-民權,2024-05-21,9312
1605,華新,67,60,7,華南永昌-民權,2024-05-21,9312
2323,中環,20,13,7,華南永昌-民權,2024-05-21,9312
2915,潤泰全,10,3,7,華南永昌-民權,2024-05-21,9312
5210,寶碩,12,5,7,華南永昌-民權,2024-05-21,9312
6425,易發,13,6,7,華南永昌-民權,2024-05-21,9312
2376,技嘉,7,0,7,華南永昌-民權,2024-05-21,9312
2467,志聖,6,0,6,華南永昌-民權,2024-05-21,9312
6834,天二科技,6,0,6,華南永昌-民權,2024-05-21,9312
6875,國邑*,6,0,6,華南永昌-民權,2024-05-21,9312
2367,燿華,45,39,6,華南永昌-民權,2024-05-21,9312
00926,凱基全球菁英55,5,0,5,華南永昌-民權,2024-05-21,9312
1789,神隆,5,0,5,華南永昌-民權,2024-05-21,9312
2419,仲琦,5,0,5,華南永昌-民權,2024-05-21,9312
2534,宏盛,5,0,5,華南永昌-民權,2024-05-21,9312
2356,英業達,546,36,510,華南永昌-民權,2024-05-22,9312
2344,華邦電,354,116,238,華南永昌-民權,2024-05-22,9312
6706,惠特,220,0,220,華南永昌-民權,2024-05-22,9312
1447,力鵬,138,0,138,華南永昌-民權,2024-05-22,9312
1303,南亞,54,0,54,華南永昌-民權,2024-05-22,9312
00929,復華台灣科技優息,57,26,31,華南永昌-民權,2024-05-22,9312
00933B,國泰10Y+金融債,55,28,27,華南永昌-民權,2024-05-22,9312
5210,寶碩,26,0,26,華南永昌-民權,2024-05-22,9312
2002,中鋼,25,0,25,華南永昌-民權,2024-05-22,9312
2467,志聖,25,0,25,華南永昌-民權,2024-05-22,9312
2630,亞航,22,0,22,華南永昌-民權,2024-05-22,9312
3346,麗清,20,0,20,華南永昌-民權,2024-05-22,9312
3520,華盈,18,0,18,華南永昌-民權,2024-05-22,9312
8033,雷虎,18,0,18,華南永昌-民權,2024-05-22,9312
00937B,群益ESG投等債20,17,0,17,華南永昌-民權,2024-05-22,9312
8936,國統,15,0,15,華南永昌-民權,2024-05-22,9312
1609,大亞,17,3,14,華南永昌-民權,2024-05-22,9312
4739,康普,19,7,12,華南永昌-民權,2024-05-22,9312
6209,今國光,14,2,12,華南永昌-民權,2024-05-22,9312
6284,佳邦,12,0,12,華南永昌-民權,2024-05-22,9312
1301,台塑,12,1,11,華南永昌-民權,2024-05-22,9312
2610,華航,15,4,11,華南永昌-民權,2024-05-22,9312
4526,東台,10,0,10,華南永昌-民權,2024-05-22,9312
00944,野村趨勢動能高息,10,0,10,華南永昌-民權,2024-05-22,9312
1612,宏泰,12,2,10,華南永昌-民權,2024-05-22,9312
2382,廣達,12,2,10,華南永昌-民權,2024-05-22,9312
2892,第一金,10,0,10,華南永昌-民權,2024-05-22,9312
4999,鑫禾,10,0,10,華南永昌-民權,2024-05-22,9312
2009,第一銅,14,4,10,華南永昌-民權,2024-05-22,9312
00919,群益台灣精選高息,10,0,10,華南永昌-民權,2024-05-22,9312
2618,長榮航,9,0,9,華南永昌-民權,2024-05-22,9312
1210,大成,9,0,9,華南永昌-民權,2024-05-22,9312
3033,威健,10,1,9,華南永昌-民權,2024-05-22,9312
1316,上曜,8,0,8,華南永昌-民權,2024-05-22,9312
00675L,富邦臺灣加權正2,8,0,8,華南永昌-民權,2024-05-22,9312
1605,華新,8,0,8,華南永昌-民權,2024-05-22,9312
3338,泰碩,8,0,8,華南永昌-民權,2024-05-22,9312
5392,能率,13,5,8,華南永昌-民權,2024-05-22,9312
9945,潤泰新,10,3,7,華南永昌-民權,2024-05-22,9312
2495,普安,13,6,7,華南永昌-民權,2024-05-22,9312
3689,湧德,7,0,7,華南永昌-民權,2024-05-22,9312
2838,聯邦銀,7,0,7,華南永昌-民權,2024-05-22,9312
2027,大成鋼,6,0,6,華南永昌-民權,2024-05-22,9312
2489,瑞軒,12,6,6,華南永昌-民權,2024-05-22,9312
2369,菱生,7,1,6,華南永昌-民權,2024-05-22,9312
3380,明泰,6,0,6,華南永昌-民權,2024-05-22,9312
3703,欣陸,6,0,6,華南永昌-民權,2024-05-22,9312
4906,正文,14,8,6,華南永昌-民權,2024-05-22,9312
8112,至上,5,0,5,華南永昌-民權,2024-05-22,9312
00885,富邦越南,10,5,5,華南永昌-民權,2024-05-22,9312
1785,光洋科,1345,45,1300,華南永昌-民權,2024-05-23,9312
00637L,元大滬深300正2,160,0,160,華南永昌-民權,2024-05-23,9312
2609,陽明,138,11,127,華南永昌-民權,2024-05-23,9312
2103,台橡,108,0,108,華南永昌-民權,2024-05-23,9312
2615,萬海,89,2,87,華南永昌-民權,2024-05-23,9312
00937B,群益ESG投等債20,72,4,68,華南永昌-民權,2024-05-23,9312
00919,群益台灣精選高息,78,11,67,華南永昌-民權,2024-05-23,9312
00679B,元大美債20年,51,0,51,華南永昌-民權,2024-05-23,9312
6147,頎邦,42,0,42,華南永昌-民權,2024-05-23,9312
8936,國統,45,3,42,華南永昌-民權,2024-05-23,9312
00669R,國泰美國道瓊反1,40,0,40,華南永昌-民權,2024-05-23,9312
2324,仁寶,43,4,39,華南永昌-民權,2024-05-23,9312
3338,泰碩,97,66,31,華南永昌-民權,2024-05-23,9312
2867,三商壽,30,1,29,華南永昌-民權,2024-05-23,9312
1504,東元,29,4,25,華南永昌-民權,2024-05-23,9312
2618,長榮航,31,6,25,華南永昌-民權,2024-05-23,9312
3346,麗清,25,0,25,華南永昌-民權,2024-05-23,9312
4739,康普,24,0,24,華南永昌-民權,2024-05-23,9312
2453,凌群,28,5,23,華南永昌-民權,2024-05-23,9312
1321,大洋,21,0,21,華南永昌-民權,2024-05-23,9312
5521,工信,20,0,20,華南永昌-民權,2024-05-23,9312
00929,復華台灣科技優息,39,20,19,華南永昌-民權,2024-05-23,9312
3059,華晶科,20,1,19,華南永昌-民權,2024-05-23,9312
00940,元大台灣價值高息,20,3,17,華南永昌-民權,2024-05-23,9312
00885,富邦越南,17,1,16,華南永昌-民權,2024-05-23,9312
2812,台中銀,38,22,16,華南永昌-民權,2024-05-23,9312
1609,大亞,15,1,14,華南永昌-民權,2024-05-23,9312
2886,兆豐金,14,0,14,華南永昌-民權,2024-05-23,9312
1319,東陽,12,0,12,華南永昌-民權,2024-05-23,9312
2409,友達,12,0,12,華南永昌-民權,2024-05-23,9312
2354,鴻準,18,7,11,華南永昌-民權,2024-05-23,9312
2834,臺企銀,11,0,11,華南永昌-民權,2024-05-23,9312
4533,協易機,13,2,11,華南永昌-民權,2024-05-23,9312
8064,東捷,16,5,11,華南永昌-民權,2024-05-23,9312
2009,第一銅,12,2,10,華南永昌-民權,2024-05-23,9312
1316,上曜,10,0,10,華南永昌-民權,2024-05-23,9312
1773,勝一,10,0,10,華南永昌-民權,2024-05-23,9312
2363,矽統,12,2,10,華南永昌-民權,2024-05-23,9312
2883B,凱基金乙特,10,0,10,華南永昌-民權,2024-05-23,9312
6207,雷科,10,0,10,華南永昌-民權,2024-05-23,9312
3189,景碩,9,0,9,華南永昌-民權,2024-05-23,9312
6215,和椿,35,26,9,華南永昌-民權,2024-05-23,9312
3231,緯創,12,4,8,華南永昌-民權,2024-05-23,9312
1529,樂事綠能,8,0,8,華南永昌-民權,2024-05-23,9312
2883,凱基金,12,4,8,華南永昌-民權,2024-05-23,9312
6177,達麗,8,0,8,華南永昌-民權,2024-05-23,9312
8924,大田,8,0,8,華南永昌-民權,2024-05-23,9312
2382,廣達,7,0,7,華南永昌-民權,2024-05-23,9312
1210,大成,7,0,7,華南永昌-民權,2024-05-23,9312
2809,京城銀,12,5,7,華南永昌-民權,2024-05-23,9312
1785,光洋科,300,0,300,華南永昌-民權,2024-05-24,9312
2609,陽明,119,6,113,華南永昌-民權,2024-05-24,9312
2603,長榮,122,14,108,華南永昌-民權,2024-05-24,9312
2101,南港,86,0,86,華南永昌-民權,2024-05-24,9312
2102,泰豐,70,0,70,華南永昌-民權,2024-05-24,9312
2344,華邦電,50,4,46,華南永昌-民權,2024-05-24,9312
00937B,群益ESG投等債20,43,0,43,華南永昌-民權,2024-05-24,9312
1447,力鵬,59,16,43,華南永昌-民權,2024-05-24,9312
00712,復華富時不動產,34,5,29,華南永昌-民權,2024-05-24,9312
2444,兆勁,29,0,29,華南永昌-民權,2024-05-24,9312
6488,環球晶,26,0,26,華南永昌-民權,2024-05-24,9312
1723,中碳,23,0,23,華南永昌-民權,2024-05-24,9312
2365,昆盈,148,127,21,華南永昌-民權,2024-05-24,9312
8033,雷虎,21,0,21,華南永昌-民權,2024-05-24,9312
00633L,富邦上証正2,20,0,20,華南永昌-民權,2024-05-24,9312
8936,國統,32,13,19,華南永昌-民權,2024-05-24,9312
00940,元大台灣價值高息,25,10,15,華南永昌-民權,2024-05-24,9312
2377,微星,15,0,15,華南永昌-民權,2024-05-24,9312
5519,隆大,15,0,15,華南永昌-民權,2024-05-24,9312
2303,聯電,21,8,13,華南永昌-民權,2024-05-24,9312
1303,南亞,13,0,13,華南永昌-民權,2024-05-24,9312
2891,中信金,12,0,12,華南永昌-民權,2024-05-24,9312
2486,一詮,25,13,12,華南永昌-民權,2024-05-24,9312
2371,大同,17,6,11,華南永昌-民權,2024-05-24,9312
3706,神達,12,1,11,華南永昌-民權,2024-05-24,9312
00679B,元大美債20年,11,1,10,華南永昌-民權,2024-05-24,9312
00664R,國泰臺灣加權反1,10,0,10,華南永昌-民權,2024-05-24,9312
2017,官田鋼,10,0,10,華南永昌-民權,2024-05-24,9312
2524,京城,10,0,10,華南永昌-民權,2024-05-24,9312
6288,聯嘉,11,1,10,華南永昌-民權,2024-05-24,9312
6573,虹揚-KY,10,0,10,華南永昌-民權,2024-05-24,9312
2809,京城銀,9,0,9,華南永昌-民權,2024-05-24,9312
1608,華榮,8,0,8,華南永昌-民權,2024-05-24,9312
2329,華泰,9,1,8,華南永昌-民權,2024-05-24,9312
00830,國泰費城半導體,7,0,7,華南永昌-民權,2024-05-24,9312
5508,永信建,10,4,6,華南永昌-民權,2024-05-24,9312
6770,力積電,11,5,6,華南永昌-民權,2024-05-24,9312
1529,樂事綠能,6,0,6,華南永昌-民權,2024-05-24,9312
6120,達運,6,0,6,華南永昌-民權,2024-05-24,9312
6505,台塑化,6,0,6,華南永昌-民權,2024-05-24,9312
3090,日電貿,11,5,6,華南永昌-民權,2024-05-24,9312
00946,群益科技高息成長,6,0,6,華南永昌-民權,2024-05-24,9312
00675L,富邦臺灣加權正2,5,0,5,華南永昌-民權,2024-05-24,9312
1312,國喬,5,0,5,華南永昌-民權,2024-05-24,9312
1449,佳和,5,0,5,華南永昌-民權,2024-05-24,9312
1459,聯發,5,0,5,華南永昌-民權,2024-05-24,9312
1605,華新,7,2,5,華南永昌-民權,2024-05-24,9312
2002,中鋼,15,10,5,華南永昌-民權,2024-05-24,9312
2399,映泰,5,0,5,華南永昌-民權,2024-05-24,9312
2460,建通,14,9,5,華南永昌-民權,2024-05-24,9312
1809,中釉,500,2,498,華南永昌-民權,2024-05-27,9312
1785,光洋科,400,0,400,華南永昌-民權,2024-05-27,9312
2897,王道銀行,300,100,200,華南永昌-民權,2024-05-27,9312
2609,陽明,103,14,89,華南永昌-民權,2024-05-27,9312
2603,長榮,113,51,62,華南永昌-民權,2024-05-27,9312
2888,新光金,60,0,60,華南永昌-民權,2024-05-27,9312
2630,亞航,41,0,41,華南永昌-民權,2024-05-27,9312
0056,元大高股息,41,1,40,華南永昌-民權,2024-05-27,9312
2330,台積電,38,2,36,華南永昌-民權,2024-05-27,9312
2002,中鋼,31,0,31,華南永昌-民權,2024-05-27,9312
1447,力鵬,26,0,26,華南永昌-民權,2024-05-27,9312
2392,正崴,28,8,20,華南永昌-民權,2024-05-27,9312
8277,商丞,20,0,20,華南永昌-民權,2024-05-27,9312
5392,能率,20,1,19,華南永昌-民權,2024-05-27,9312
3605,宏致,19,1,18,華南永昌-民權,2024-05-27,9312
2353,宏��,40,24,16,華南永昌-民權,2024-05-27,9312
3481,群創,32,18,14,華南永昌-民權,2024-05-27,9312
5498,凱崴,18,5,13,華南永昌-民權,2024-05-27,9312
3047,訊舟,16,4,12,華南永昌-民權,2024-05-27,9312
4960,誠美材,12,0,12,華南永昌-民權,2024-05-27,9312
6209,今國光,63,51,12,華南永昌-民權,2024-05-27,9312
6125,廣運,33,22,11,華南永昌-民權,2024-05-27,9312
8011,台通,11,0,11,華南永昌-民權,2024-05-27,9312
9105,泰金寶-DR,23,12,11,華南永昌-民權,2024-05-27,9312
00915,凱基優選高股息30,10,0,10,華南永昌-民權,2024-05-27,9312
00882,中信中國高股息,10,0,10,華南永昌-民權,2024-05-27,9312
1312,國喬,10,0,10,華南永昌-民權,2024-05-27,9312
00878,國泰永續高股息,20,11,9,華南永昌-民權,2024-05-27,9312
1319,東陽,10,1,9,華南永昌-民權,2024-05-27,9312
2101,南港,8,0,8,華南永昌-民權,2024-05-27,9312
2363,矽統,97,89,8,華南永昌-民權,2024-05-27,9312
3303,岱稜,8,0,8,華南永昌-民權,2024-05-27,9312
0050,元大台灣50,8,0,8,華南永昌-民權,2024-05-27,9312
00899,FT潔淨能源,7,0,7,華南永昌-民權,2024-05-27,9312
00933B,國泰10Y+金融債,7,0,7,華南永昌-民權,2024-05-27,9312
2451,創見,7,0,7,華南永昌-民權,2024-05-27,9312
6117,迎廣,15,8,7,華南永昌-民權,2024-05-27,9312
1503,士電,16,10,6,華南永昌-民權,2024-05-27,9312
00675L,富邦臺灣加權正2,6,0,6,華南永昌-民權,2024-05-27,9312
2405,輔信,18,12,6,華南永昌-民權,2024-05-27,9312
3028,增你強,6,0,6,華南永昌-民權,2024-05-27,9312
3163,波若威,9,3,6,華南永昌-民權,2024-05-27,9312
3380,明泰,6,0,6,華南永昌-民權,2024-05-27,9312
4533,協易機,7,1,6,華南永昌-民權,2024-05-27,9312
6835,圓裕,6,0,6,華南永昌-民權,2024-05-27,9312
8033,雷虎,6,0,6,華南永昌-民權,2024-05-27,9312
2887,台新金,15,10,5,華南永昌-民權,2024-05-27,9312
00637L,元大滬深300正2,35,30,5,華南永昌-民權,2024-05-27,9312
2314,台揚,5,0,5,華南永昌-民權,2024-05-27,9312
2344,華邦電,5,0,5,華南永昌-民權,2024-05-27,9312
2102,泰豐,100,0,100,華南永昌-民權,2024-05-28,9312
00937B,群益ESG投等債20,75,3,72,華南永昌-民權,2024-05-28,9312
2883,凱基金,70,1,69,華南永昌-民權,2024-05-28,9312
1608,華榮,42,3,39,華南永昌-民權,2024-05-28,9312
2603,長榮,34,2,32,華南永昌-民權,2024-05-28,9312
2367,燿華,31,1,30,華南永昌-民權,2024-05-28,9312
2303,聯電,46,18,28,華南永昌-民權,2024-05-28,9312
1605,華新,30,2,28,華南永昌-民權,2024-05-28,9312
00878,國泰永續高股息,35,9,26,華南永昌-民權,2024-05-28,9312
00940,元大台灣價值高息,26,1,25,華南永昌-民權,2024-05-28,9312
2330,台積電,22,0,22,華南永昌-民權,2024-05-28,9312
2353,宏��,36,15,21,華南永昌-民權,2024-05-28,9312
2363,矽統,27,6,21,華南永昌-民權,2024-05-28,9312
2891,中信金,20,0,20,華南永昌-民權,2024-05-28,9312
2851,中再保,20,0,20,華南永昌-民權,2024-05-28,9312
3607,谷崧,20,0,20,華南永昌-民權,2024-05-28,9312
2409,友達,19,3,16,華南永昌-民權,2024-05-28,9312
00946,群益科技高息成長,15,0,15,華南永昌-民權,2024-05-28,9312
2460,建通,18,4,14,華南永昌-民權,2024-05-28,9312
00795B,中信美國公債20年,13,0,13,華南永昌-民權,2024-05-28,9312
2362,藍天,29,16,13,華南永昌-民權,2024-05-28,9312
6834,天二科技,13,0,13,華南永昌-民權,2024-05-28,9312
2301,光寶科,12,0,12,華南永昌-民權,2024-05-28,9312
00712,復華富時不動產,12,0,12,華南永昌-民權,2024-05-28,9312
2417,圓剛,14,2,12,華南永昌-民權,2024-05-28,9312
1513,中興電,13,2,11,華南永昌-民權,2024-05-28,9312
6275,元山,11,0,11,華南永昌-民權,2024-05-28,9312
2887,台新金,13,3,10,華南永昌-民權,2024-05-28,9312
1447,力鵬,14,4,10,華南永昌-民權,2024-05-28,9312
1515,力山,10,0,10,華南永昌-民權,2024-05-28,9312
2338,光罩,11,1,10,華南永昌-民權,2024-05-28,9312
2420,新巨,10,0,10,華南永昌-民權,2024-05-28,9312
5512,力麒,21,11,10,華南永昌-民權,2024-05-28,9312
6505,台塑化,10,0,10,華南永昌-民權,2024-05-28,9312
2323,中環,23,14,9,華南永昌-民權,2024-05-28,9312
2464,盟立,22,13,9,華南永昌-民權,2024-05-28,9312
2834,臺企銀,10,1,9,華南永昌-民權,2024-05-28,9312
6215,和椿,18,9,9,華南永昌-民權,2024-05-28,9312
2331,精英,8,0,8,華南永昌-民權,2024-05-28,9312
5328,華容,8,0,8,華南永昌-民權,2024-05-28,9312
1815,富喬,19,11,8,華南永昌-民權,2024-05-28,9312
2356,英業達,111,103,8,華南永昌-民權,2024-05-28,9312
00688L,國泰20年美債正2,7,0,7,華南永昌-民權,2024-05-28,9312
3466,德晉,9,2,7,華南永昌-民權,2024-05-28,9312
6139,亞翔,7,0,7,華南永昌-民權,2024-05-28,9312
2317,鴻海,12,5,7,華南永昌-民權,2024-05-28,9312
2027,大成鋼,6,0,6,華南永昌-民權,2024-05-28,9312
1760,寶齡富錦,6,0,6,華南永昌-民權,2024-05-28,9312
2243,宏旭-KY,6,0,6,華南永昌-民權,2024-05-28,9312
2886,兆豐金,6,0,6,華南永昌-民權,2024-05-28,9312
1785,光洋科,501,5,496,華南永昌-民權,2024-05-29,9312
00937B,群益ESG投等債20,121,10,111,華南永昌-民權,2024-05-29,9312
2851,中再保,110,0,110,華南永昌-民權,2024-05-29,9312
2102,泰豐,100,0,100,華南永昌-民權,2024-05-29,9312
00878,國泰永續高股息,89,4,85,華南永昌-民權,2024-05-29,9312
2515,中工,90,22,68,華南永昌-民權,2024-05-29,9312
2329,華泰,97,32,65,華南永昌-民權,2024-05-29,9312
2630,亞航,55,0,55,華南永昌-民權,2024-05-29,9312
2801,彰銀,52,0,52,華南永昌-民權,2024-05-29,9312
6116,彩晶,50,0,50,華南永昌-民權,2024-05-29,9312
2354,鴻準,87,43,44,華南永昌-民權,2024-05-29,9312
00940,元大台灣價值高息,86,44,42,華南永昌-民權,2024-05-29,9312
00679B,元大美債20年,35,0,35,華南永昌-民權,2024-05-29,9312
2867,三商壽,47,15,32,華南永昌-民權,2024-05-29,9312
2409,友達,32,0,32,華南永昌-民權,2024-05-29,9312
00687B,國泰20年美債,29,0,29,華南永昌-民權,2024-05-29,9312
00946,群益科技高息成長,29,0,29,華南永昌-民權,2024-05-29,9312
2317,鴻海,29,4,25,華南永昌-民權,2024-05-29,9312
5328,華容,22,1,21,華南永昌-民權,2024-05-29,9312
2353,宏��,31,10,21,華南永昌-民權,2024-05-29,9312
2887,台新金,46,26,20,華南永昌-民權,2024-05-29,9312
8070,長華*,20,0,20,華南永昌-民權,2024-05-29,9312
6189,豐藝,21,3,18,華南永昌-民權,2024-05-29,9312
4714,永捷,18,0,18,華南永昌-民權,2024-05-29,9312
1723,中碳,17,0,17,華南永昌-民權,2024-05-29,9312
3481,群創,28,11,17,華南永昌-民權,2024-05-29,9312
1609,大亞,24,8,16,華南永昌-民權,2024-05-29,9312
2365,昆盈,17,2,15,華南永昌-民權,2024-05-29,9312
3607,谷崧,15,0,15,華南永昌-民權,2024-05-29,9312
2303,聯電,17,3,14,華南永昌-民權,2024-05-29,9312
5392,能率,14,0,14,華南永昌-民權,2024-05-29,9312
2363,矽統,17,4,13,華南永昌-民權,2024-05-29,9312
2618,長榮航,15,2,13,華南永昌-民權,2024-05-29,9312
3714,富采,13,0,13,華南永昌-民權,2024-05-29,9312
2376,技嘉,30,18,12,華南永昌-民權,2024-05-29,9312
6257,矽格,11,0,11,華南永昌-民權,2024-05-29,9312
2886,兆豐金,12,1,11,華南永昌-民權,2024-05-29,9312
00918,大華優利高填息30,11,0,11,華南永昌-民權,2024-05-29,9312
00933B,國泰10Y+金融債,11,0,11,華南永昌-民權,2024-05-29,9312
2610,華航,29,18,11,華南永昌-民權,2024-05-29,9312
2834,臺企銀,11,0,11,華南永昌-民權,2024-05-29,9312
2883,凱基金,11,0,11,華南永昌-民權,2024-05-29,9312
4909,新復興,11,0,11,華南永昌-民權,2024-05-29,9312
1515,力山,10,0,10,華南永昌-民權,2024-05-29,9312
1605,華新,10,0,10,華南永昌-民權,2024-05-29,9312
3048,益登,11,1,10,華南永昌-民權,2024-05-29,9312
4905,台聯電,10,0,10,華南永昌-民權,2024-05-29,9312
6005,群益證,12,2,10,華南永昌-民權,2024-05-29,9312
00895,富邦未來車,10,1,9,華南永昌-民權,2024-05-29,9312
2449,京元電子,11,2,9,華南永昌-民權,2024-05-29,9312
1809,中釉,200,0,200,華南永昌-民權,2024-05-30,9312
1101,台泥,102,1,101,華南永昌-民權,2024-05-30,9312
2101,南港,100,0,100,華南永昌-民權,2024-05-30,9312
2615,萬海,99,3,96,華南永昌-民權,2024-05-30,9312
00937B,群益ESG投等債20,96,1,95,華南永昌-民權,2024-05-30,9312
3231,緯創,56,3,53,華南永昌-民權,2024-05-30,9312
00946,群益科技高息成長,49,0,49,華南永昌-民權,2024-05-30,9312
3607,谷崧,40,0,40,華南永昌-民權,2024-05-30,9312
2609,陽明,37,5,32,華南永昌-民權,2024-05-30,9312
2883,凱基金,32,0,32,華南永昌-民權,2024-05-30,9312
2444,兆勁,30,0,30,華南永昌-民權,2024-05-30,9312
2603,長榮,31,2,29,華南永昌-民權,2024-05-30,9312
00878,國泰永續高股息,29,1,28,華南永昌-民權,2024-05-30,9312
2489,瑞軒,30,3,27,華南永昌-民權,2024-05-30,9312
00915,凱基優選高股息30,28,2,26,華南永昌-民權,2024-05-30,9312
00680L,元大美債20正2,25,0,25,華南永昌-民權,2024-05-30,9312
2367,燿華,35,11,24,華南永昌-民權,2024-05-30,9312
3047,訊舟,30,6,24,華南永昌-民權,2024-05-30,9312
2301,光寶科,26,2,24,華南永昌-民權,2024-05-30,9312
2892,第一金,23,0,23,華南永昌-民權,2024-05-30,9312
2501,國建,27,4,23,華南永昌-民權,2024-05-30,9312
2354,鴻準,28,6,22,華南永昌-民權,2024-05-30,9312
2405,輔信,30,8,22,華南永昌-民權,2024-05-30,9312
2317,鴻海,21,0,21,華南永昌-民權,2024-05-30,9312
4306,炎洲,20,0,20,華南永昌-民權,2024-05-30,9312
2612,中航,20,0,20,華南永昌-民權,2024-05-30,9312
00919,群益台灣精選高息,21,2,19,華南永昌-民權,2024-05-30,9312
5468,凱鈺,17,1,16,華南永昌-民權,2024-05-30,9312
00857B,永豐20年美公債,15,0,15,華南永昌-民權,2024-05-30,9312
1815,富喬,167,152,15,華南永昌-民權,2024-05-30,9312
4905,台聯電,15,0,15,華南永昌-民權,2024-05-30,9312
1303,南亞,36,22,14,華南永昌-民權,2024-05-30,9312
00712,復華富時不動產,13,0,13,華南永昌-民權,2024-05-30,9312
6209,今國光,19,6,13,華南永昌-民權,2024-05-30,9312
1447,力鵬,12,0,12,華南永昌-民權,2024-05-30,9312
6005,群益證,12,0,12,華南永昌-民權,2024-05-30,9312
00679B,元大美債20年,27,16,11,華南永昌-民權,2024-05-30,9312
6269,台郡,11,0,11,華南永昌-民權,2024-05-30,9312
4167,松瑞藥,11,0,11,華南永昌-民權,2024-05-30,9312
2002,中鋼,10,0,10,華南永昌-民權,2024-05-30,9312
1440,南紡,10,0,10,華南永昌-民權,2024-05-30,9312
2548,華固,11,1,10,華南永昌-民權,2024-05-30,9312
2887,台新金,10,0,10,華南永昌-民權,2024-05-30,9312
3048,益登,10,0,10,華南永昌-民權,2024-05-30,9312
3481,群創,11,1,10,華南永昌-民權,2024-05-30,9312
3512,皇龍,10,0,10,華南永昌-民權,2024-05-30,9312
4562,穎漢,10,0,10,華南永昌-民權,2024-05-30,9312
2328,廣宇,21,12,9,華南永昌-民權,2024-05-30,9312
1301,台塑,10,2,8,華南永昌-民權,2024-05-30,9312
2363,矽統,11,3,8,華南永昌-民權,2024-05-30,9312
3652,精聯,70,0,70,華南永昌-民權,2024-05-31,9312
1447,力鵬,49,1,48,華南永昌-民權,2024-05-31,9312
00929,復華台灣科技優息,42,0,42,華南永昌-民權,2024-05-31,9312
00937B,群益ESG投等債20,43,1,42,華南永昌-民權,2024-05-31,9312
2609,陽明,111,69,42,華南永昌-民權,2024-05-31,9312
00935,野村臺灣新科技50,40,0,40,華南永昌-民權,2024-05-31,9312
2851,中再保,40,0,40,華南永昌-民權,2024-05-31,9312
3231,緯創,41,2,39,華南永昌-民權,2024-05-31,9312
00946,群益科技高息成長,35,0,35,華南永昌-民權,2024-05-31,9312
2515,中工,70,36,34,華南永昌-民權,2024-05-31,9312
1110,東泥,25,0,25,華南永昌-民權,2024-05-31,9312
00939,統一台灣高息動能,49,25,24,華南永昌-民權,2024-05-31,9312
00919,群益台灣精選高息,23,2,21,華南永昌-民權,2024-05-31,9312
2444,兆勁,20,0,20,華南永昌-民權,2024-05-31,9312
9105,泰金寶-DR,30,10,20,華南永昌-民權,2024-05-31,9312
2371,大同,20,2,18,華南永昌-民權,2024-05-31,9312
2317,鴻海,22,5,17,華南永昌-民權,2024-05-31,9312
2630,亞航,20,3,17,華南永昌-民權,2024-05-31,9312
2328,廣宇,25,9,16,華南永昌-民權,2024-05-31,9312
2838,聯邦銀,16,0,16,華南永昌-民權,2024-05-31,9312
6770,力積電,24,9,15,華南永昌-民權,2024-05-31,9312
6548,長科*,15,0,15,華南永昌-民權,2024-05-31,9312
2374,佳能,13,0,13,華南永昌-民權,2024-05-31,9312
8112,至上,14,1,13,華南永昌-民權,2024-05-31,9312
1314,中石化,17,5,12,華南永昌-民權,2024-05-31,9312
3481,群創,13,1,12,華南永昌-民權,2024-05-31,9312
2382,廣達,13,2,11,華南永昌-民權,2024-05-31,9312
2353,宏��,25,15,10,華南永昌-民權,2024-05-31,9312
2548,華固,10,0,10,華南永昌-民權,2024-05-31,9312
2368,金像電,12,2,10,華南永昌-民權,2024-05-31,9312
00896,中信綠能及電動車,10,0,10,華南永昌-民權,2024-05-31,9312
1337,再生-KY,10,0,10,華南永昌-民權,2024-05-31,9312
1815,富喬,178,168,10,華南永昌-民權,2024-05-31,9312
2461,光群雷,10,0,10,華南永昌-民權,2024-05-31,9312
2913,農林,10,0,10,華南永昌-民權,2024-05-31,9312
2615,萬海,10,1,9,華南永昌-民權,2024-05-31,9312
3312,弘憶股,26,17,9,華南永昌-民權,2024-05-31,9312
6456,GIS-KY,9,0,9,華南永昌-民權,2024-05-31,9312
3287,廣寰科,8,0,8,華南永昌-民權,2024-05-31,9312
6233,旺玖,8,1,7,華南永昌-民權,2024-05-31,9312
5880,合庫金,7,0,7,華南永昌-民權,2024-05-31,9312
8210,勤誠,7,1,6,華南永昌-民權,2024-05-31,9312
2002,中鋼,6,0,6,華南永昌-民權,2024-05-31,9312
2409,友達,6,0,6,華南永昌-民權,2024-05-31,9312
2460,建通,6,0,6,華南永昌-民權,2024-05-31,9312
2462,良得電,6,0,6,華南永昌-民權,2024-05-31,9312
3594,磐儀,9,3,6,華南永昌-民權,2024-05-31,9312
5469,瀚宇博,6,0,6,華南永昌-民權,2024-05-31,9312
5519,隆大,6,0,6,華南永昌-民權,2024-05-31,9312
6257,矽格,7,1,6,華南永昌-民權,2024-05-31,9312
1785,光洋科,165,16,149,華南永昌-民權,2024-06-03,9312
2615,萬海,200,63,137,華南永昌-民權,2024-06-03,9312
2356,英業達,113,9,104,華南永昌-民權,2024-06-03,9312
00919,群益台灣精選高息,78,0,78,華南永昌-民權,2024-06-03,9312
2354,鴻準,72,7,65,華南永昌-民權,2024-06-03,9312
1447,力鵬,50,0,50,華南永昌-民權,2024-06-03,9312
00918,大華優利高填息30,44,0,44,華南永昌-民權,2024-06-03,9312
6163,華電網,38,2,36,華南永昌-民權,2024-06-03,9312
2501,國建,61,31,30,華南永昌-民權,2024-06-03,9312
00937B,群益ESG投等債20,31,2,29,華南永昌-民權,2024-06-03,9312
00946,群益科技高息成長,27,0,27,華南永昌-民權,2024-06-03,9312
2605,新興,34,8,26,華南永昌-民權,2024-06-03,9312
00939,統一台灣高息動能,20,0,20,華南永昌-民權,2024-06-03,9312
3481,群創,20,2,18,華南永昌-民權,2024-06-03,9312
00940,元大台灣價值高息,39,22,17,華南永昌-民權,2024-06-03,9312
2324,仁寶,15,1,14,華南永昌-民權,2024-06-03,9312
00929,復華台灣科技優息,15,1,14,華南永昌-民權,2024-06-03,9312
6695,芯鼎,34,20,14,華南永昌-民權,2024-06-03,9312
2489,瑞軒,24,11,13,華南永昌-民權,2024-06-03,9312
2002,中鋼,12,0,12,華南永昌-民權,2024-06-03,9312
2867,三商壽,24,12,12,華南永昌-民權,2024-06-03,9312
1609,大亞,11,0,11,華南永昌-民權,2024-06-03,9312
3264,欣銓,11,0,11,華南永昌-民權,2024-06-03,9312
2353,宏��,18,8,10,華南永昌-民權,2024-06-03,9312
3652,精聯,10,0,10,華南永昌-民權,2024-06-03,9312
3663,鑫科,10,0,10,華南永昌-民權,2024-06-03,9312
5450,南良,10,0,10,華南永昌-民權,2024-06-03,9312
6834,天二科技,10,0,10,華南永昌-民權,2024-06-03,9312
2609,陽明,48,39,9,華南永昌-民權,2024-06-03,9312
2610,華航,15,6,9,華南永昌-民權,2024-06-03,9312
3338,泰碩,10,1,9,華南永昌-民權,2024-06-03,9312
2303,聯電,27,18,9,華南永昌-民權,2024-06-03,9312
1303,南亞,8,0,8,華南永昌-民權,2024-06-03,9312
4545,銘鈺,8,0,8,華南永昌-民權,2024-06-03,9312
00679B,元大美債20年,10,3,7,華南永昌-民權,2024-06-03,9312
2027,大成鋼,7,0,7,華南永昌-民權,2024-06-03,9312
4513,福裕,8,1,7,華南永昌-民權,2024-06-03,9312
00878,國泰永續高股息,6,0,6,華南永昌-民權,2024-06-03,9312
2014,中鴻,10,4,6,華南永昌-民權,2024-06-03,9312
2365,昆盈,6,0,6,華南永昌-民權,2024-06-03,9312
3167,大量,6,0,6,華南永昌-民權,2024-06-03,9312
3356,奇偶,6,0,6,華南永昌-民權,2024-06-03,9312
4905,台聯電,6,0,6,華南永昌-民權,2024-06-03,9312
6139,亞翔,5,0,5,華南永昌-民權,2024-06-03,9312
00899,FT潔淨能源,5,0,5,華南永昌-民權,2024-06-03,9312
00882,中信中國高股息,5,0,5,華南永昌-民權,2024-06-03,9312
1455,集盛,5,0,5,華南永昌-民權,2024-06-03,9312
1714,和桐,5,0,5,華南永昌-民權,2024-06-03,9312
2344,華邦電,5,0,5,華南永昌-民權,2024-06-03,9312
3285,微端,5,0,5,華南永昌-民權,2024-06-03,9312
1785,光洋科,350,0,350,華南永昌-民權,2024-06-04,9312
1809,中釉,200,0,200,華南永昌-民權,2024-06-04,9312
2888,新光金,111,4,107,華南永昌-民權,2024-06-04,9312
2303,聯電,104,0,104,華南永昌-民權,2024-06-04,9312
2356,英業達,206,104,102,華南永昌-民權,2024-06-04,9312
2801,彰銀,100,0,100,華南永昌-民權,2024-06-04,9312
00918,大華優利高填息30,66,0,66,華南永昌-民權,2024-06-04,9312
3652,精聯,66,0,66,華南永昌-民權,2024-06-04,9312
00936,台新永續高息中小,81,25,56,華南永昌-民權,2024-06-04,9312
00929,復華台灣科技優息,66,17,49,華南永昌-民權,2024-06-04,9312
2881,富邦金,50,2,48,華南永昌-民權,2024-06-04,9312
2312,金寶,43,5,38,華南永昌-民權,2024-06-04,9312
2409,友達,35,0,35,華南永昌-民權,2024-06-04,9312
00919,群益台灣精選高息,35,0,35,華南永昌-民權,2024-06-04,9312
5512,力麒,40,10,30,華南永昌-民權,2024-06-04,9312
8070,長華*,29,0,29,華南永昌-民權,2024-06-04,9312
00946,群益科技高息成長,23,0,23,華南永昌-民權,2024-06-04,9312
6125,廣運,36,14,22,華南永昌-民權,2024-06-04,9312
2851,中再保,20,0,20,華南永昌-民權,2024-06-04,9312
2317,鴻海,23,3,20,華南永昌-民權,2024-06-04,9312
8112,至上,28,9,19,華南永昌-民權,2024-06-04,9312
2615,萬海,45,27,18,華南永昌-民權,2024-06-04,9312
3481,群創,17,0,17,華南永昌-民權,2024-06-04,9312
2002,中鋼,16,0,16,華南永昌-民權,2024-06-04,9312
2547,日勝生,26,11,15,華南永昌-民權,2024-06-04,9312
5871,中租-KY,15,0,15,華南永昌-民權,2024-06-04,9312
2834,臺企銀,13,0,13,華南永昌-民權,2024-06-04,9312
2208,台船,13,0,13,華南永昌-民權,2024-06-04,9312
2408,南亞科,13,0,13,華南永昌-民權,2024-06-04,9312
8234,新漢,20,7,13,華南永昌-民權,2024-06-04,9312
8011,台通,12,0,12,華南永昌-民權,2024-06-04,9312
2301,光寶科,12,1,11,華南永昌-民權,2024-06-04,9312
00881,國泰台灣5G+,11,0,11,華南永昌-民權,2024-06-04,9312
3231,緯創,11,0,11,華南永昌-民權,2024-06-04,9312
2354,鴻準,17,6,11,華南永昌-民權,2024-06-04,9312
5880,合庫金,11,0,11,華南永昌-民權,2024-06-04,9312
8277,商丞,11,0,11,華南永昌-民權,2024-06-04,9312
00915,凱基優選高股息30,11,0,11,華南永昌-民權,2024-06-04,9312
00932,兆豐永續高息等權,10,0,10,華南永昌-民權,2024-06-04,9312
2331,精英,64,54,10,華南永昌-民權,2024-06-04,9312
4533,協易機,82,72,10,華南永昌-民權,2024-06-04,9312
4905,台聯電,10,0,10,華南永昌-民權,2024-06-04,9312
5426,振發,11,1,10,華南永昌-民權,2024-06-04,9312
6005,群益證,15,5,10,華南永昌-民權,2024-06-04,9312
8437,大地-KY,10,0,10,華南永昌-民權,2024-06-04,9312
00921,兆豐龍頭等權重,10,0,10,華南永昌-民權,2024-06-04,9312
00713,元大台灣高息低波,10,0,10,華南永昌-民權,2024-06-04,9312
2365,昆盈,9,0,9,華南永昌-民權,2024-06-04,9312
2353,宏��,17,8,9,華南永昌-民權,2024-06-04,9312
3047,訊舟,13,4,9,華南永昌-民權,2024-06-04,9312
2374,佳能,400,109,291,華南永昌-民權,2024-06-05,9312
2888,新光金,219,0,219,華南永昌-民權,2024-06-05,9312
2354,鴻準,85,6,79,華南永昌-民權,2024-06-05,9312
00929,復華台灣科技優息,70,30,40,華南永昌-民權,2024-06-05,9312
00632R,元大台灣50反1,30,0,30,華南永昌-民權,2024-06-05,9312
2002,中鋼,25,0,25,華南永昌-民權,2024-06-05,9312
1409,新纖,25,0,25,華南永昌-民權,2024-06-05,9312
3652,精聯,25,0,25,華南永昌-民權,2024-06-05,9312
2537,聯上發,25,4,21,華南永昌-民權,2024-06-05,9312
6215,和椿,26,5,21,華南永昌-民權,2024-06-05,9312
00919,群益台灣精選高息,22,2,20,華南永昌-民權,2024-06-05,9312
2353,宏��,24,4,20,華南永昌-民權,2024-06-05,9312
2303,聯電,26,7,19,華南永昌-民權,2024-06-05,9312
2331,精英,21,2,19,華南永昌-民權,2024-06-05,9312
2605,新興,19,1,18,華南永昌-民權,2024-06-05,9312
3372,典範,22,4,18,華南永昌-民權,2024-06-05,9312
2377,微星,17,0,17,華南永昌-民權,2024-06-05,9312
3202,樺晟,18,1,17,華南永昌-民權,2024-06-05,9312
3313,斐成,15,0,15,華南永昌-民權,2024-06-05,9312
3607,谷崧,15,0,15,華南永昌-民權,2024-06-05,9312
4513,福裕,19,4,15,華南永昌-民權,2024-06-05,9312
3231,緯創,19,4,15,華南永昌-民權,2024-06-05,9312
1303,南亞,17,3,14,華南永昌-民權,2024-06-05,9312
2323,中環,19,6,13,華南永昌-民權,2024-06-05,9312
4133,亞諾法,12,0,12,華南永昌-民權,2024-06-05,9312
5315,光聯,12,0,12,華南永昌-民權,2024-06-05,9312
8039,台虹,12,0,12,華南永昌-民權,2024-06-05,9312
3481,群創,21,10,11,華南永昌-民權,2024-06-05,9312
2486,一詮,16,5,11,華南永昌-民權,2024-06-05,9312
5609,中菲行,11,0,11,華南永昌-民權,2024-06-05,9312
00932,兆豐永續高息等權,10,0,10,華南永昌-民權,2024-06-05,9312
1615,大山,10,0,10,華南永昌-民權,2024-06-05,9312
3081,聯亞,10,0,10,華南永昌-民權,2024-06-05,9312
3217,優群,10,0,10,華南永昌-民權,2024-06-05,9312
4174,浩鼎,10,0,10,華南永昌-民權,2024-06-05,9312
5498,凱崴,10,0,10,華南永昌-民權,2024-06-05,9312
6706,惠特,10,0,10,華南永昌-民權,2024-06-05,9312
6125,廣運,17,8,9,華南永昌-民權,2024-06-05,9312
00918,大華優利高填息30,9,0,9,華南永昌-民權,2024-06-05,9312
2618,長榮航,9,0,9,華南永昌-民權,2024-06-05,9312
3380,明泰,10,1,9,華南永昌-民權,2024-06-05,9312
4905,台聯電,10,1,9,華南永昌-民權,2024-06-05,9312
5469,瀚宇博,10,1,9,華南永昌-民權,2024-06-05,9312
6116,彩晶,9,0,9,華南永昌-民權,2024-06-05,9312
00713,元大台灣高息低波,8,0,8,華南永昌-民權,2024-06-05,9312
3048,益登,10,2,8,華南永昌-民權,2024-06-05,9312
1609,大亞,8,1,7,華南永昌-民權,2024-06-05,9312
8437,大地-KY,7,0,7,華南永昌-民權,2024-06-05,9312
8936,國統,7,0,7,華南永昌-民權,2024-06-05,9312
1301,台塑,9,3,6,華南永昌-民權,2024-06-05,9312
2344,華邦電,501,230,271,華南永昌-民權,2024-06-06,9312
2356,英業達,204,1,203,華南永昌-民權,2024-06-06,9312
00632R,元大台灣50反1,185,0,185,華南永昌-民權,2024-06-06,9312
2609,陽明,368,208,160,華南永昌-民權,2024-06-06,9312
6706,惠特,120,0,120,華南永昌-民權,2024-06-06,9312
2851,中再保,110,0,110,華南永昌-民權,2024-06-06,9312
00687B,國泰20年美債,101,0,101,華南永昌-民權,2024-06-06,9312
9924,福興,105,5,100,華南永昌-民權,2024-06-06,9312
8916,光隆,77,0,77,華南永昌-民權,2024-06-06,9312
3062,建漢,56,0,56,華南永昌-民權,2024-06-06,9312
2102,泰豐,50,0,50,華南永昌-民權,2024-06-06,9312
2897,王道銀行,50,0,50,華南永昌-民權,2024-06-06,9312
00942B,台新美A公司債20+,40,0,40,華南永昌-民權,2024-06-06,9312
3231,緯創,35,2,33,華南永昌-民權,2024-06-06,9312
00795B,中信美國公債20年,30,0,30,華南永昌-民權,2024-06-06,9312
00915,凱基優選高股息30,33,4,29,華南永昌-民權,2024-06-06,9312
2888,新光金,25,0,25,華南永昌-民權,2024-06-06,9312
3188,鑫龍騰,22,0,22,華南永昌-民權,2024-06-06,9312
2317,鴻海,34,13,21,華南永昌-民權,2024-06-06,9312
2524,京城,21,0,21,華南永昌-民權,2024-06-06,9312
6147,頎邦,21,0,21,華南永昌-民權,2024-06-06,9312
00919,群益台灣精選高息,26,6,20,華南永昌-民權,2024-06-06,9312
00676R,富邦臺灣加權反1,20,0,20,華南永昌-民權,2024-06-06,9312
2537,聯上發,20,0,20,華南永昌-民權,2024-06-06,9312
2732,六角,20,0,20,華南永昌-民權,2024-06-06,9312
2365,昆盈,19,0,19,華南永昌-民權,2024-06-06,9312
00946,群益科技高息成長,20,2,18,華南永昌-民權,2024-06-06,9312
1815,富喬,24,7,17,華南永昌-民權,2024-06-06,9312
00713,元大台灣高息低波,15,0,15,華南永昌-民權,2024-06-06,9312
00680L,元大美債20正2,15,0,15,華南永昌-民權,2024-06-06,9312
3481,群創,36,21,15,華南永昌-民權,2024-06-06,9312
8277,商丞,15,0,15,華南永昌-民權,2024-06-06,9312
1447,力鵬,15,1,14,華南永昌-民權,2024-06-06,9312
3434,哲固,15,1,14,華南永昌-民權,2024-06-06,9312
9105,泰金寶-DR,15,1,14,華南永昌-民權,2024-06-06,9312
2002,中鋼,12,0,12,華南永昌-民權,2024-06-06,9312
2367,燿華,31,19,12,華南永昌-民權,2024-06-06,9312
2442,新美齊,12,0,12,華南永昌-民權,2024-06-06,9312
3287,廣寰科,12,0,12,華南永昌-民權,2024-06-06,9312
3047,訊舟,15,4,11,華南永昌-民權,2024-06-06,9312
00931B,統一美債20年,10,0,10,華南永昌-民權,2024-06-06,9312
1409,新纖,10,0,10,華南永昌-民權,2024-06-06,9312
1467,南緯,10,0,10,華南永昌-民權,2024-06-06,9312
2231,為升,10,0,10,華南永昌-民權,2024-06-06,9312
3313,斐成,10,0,10,華南永昌-民權,2024-06-06,9312
4167,松瑞藥,10,0,10,華南永昌-民權,2024-06-06,9312
6197,佳必琪,17,7,10,華南永昌-民權,2024-06-06,9312
00936,台新永續高息中小,13,3,10,華南永昌-民權,2024-06-06,9312
00878,國泰永續高股息,12,3,9,華南永昌-民權,2024-06-06,9312
1326,台化,9,0,9,華南永昌-民權,2024-06-06,9312
00877,復華中國5G,200,0,200,華南永昌-民權,2024-06-07,9312
00918,大華優利高填息30,135,0,135,華南永昌-民權,2024-06-07,9312
00637L,元大滬深300正2,207,105,102,華南永昌-民權,2024-06-07,9312
2883,凱基金,131,35,96,華南永昌-民權,2024-06-07,9312
2330,台積電,70,3,67,華南永昌-民權,2024-06-07,9312
2897,王道銀行,111,50,61,華南永昌-民權,2024-06-07,9312
2374,佳能,58,0,58,華南永昌-民權,2024-06-07,9312
00929,復華台灣科技優息,51,4,47,華南永昌-民權,2024-06-07,9312
00936,台新永續高息中小,47,0,47,華南永昌-民權,2024-06-07,9312
2888,新光金,127,81,46,華南永昌-民權,2024-06-07,9312
3231,緯創,39,1,38,華南永昌-民權,2024-06-07,9312
2329,華泰,80,43,37,華南永昌-民權,2024-06-07,9312
00942B,台新美A公司債20+,20,0,20,華南永昌-民權,2024-06-07,9312
4960,誠美材,20,0,20,華南永昌-民權,2024-06-07,9312
00881,國泰台灣5G+,20,0,20,華南永昌-民權,2024-06-07,9312
1301,台塑,21,2,19,華南永昌-民權,2024-06-07,9312
2101,南港,21,2,19,華南永昌-民權,2024-06-07,9312
2371,大同,37,18,19,華南永昌-民權,2024-06-07,9312
2059,川湖,17,0,17,華南永昌-民權,2024-06-07,9312
2353,宏��,20,3,17,華南永昌-民權,2024-06-07,9312
1503,士電,20,5,15,華南永昌-民權,2024-06-07,9312
00937B,群益ESG投等債20,28,13,15,華南永昌-民權,2024-06-07,9312
2367,燿華,55,41,14,華南永昌-民權,2024-06-07,9312
2617,台航,14,0,14,華南永昌-民權,2024-06-07,9312
5302,太欣,24,10,14,華南永昌-民權,2024-06-07,9312
2834,臺企銀,23,10,13,華南永昌-民權,2024-06-07,9312
2328,廣宇,13,1,12,華南永昌-民權,2024-06-07,9312
00687B,國泰20年美債,16,4,12,華南永昌-民權,2024-06-07,9312
2331,精英,11,0,11,華南永昌-民權,2024-06-07,9312
3312,弘憶股,11,0,11,華南永昌-民權,2024-06-07,9312
3372,典範,11,1,10,華南永昌-民權,2024-06-07,9312
4906,正文,12,2,10,華南永昌-民權,2024-06-07,9312
8069,元太,10,0,10,華南永昌-民權,2024-06-07,9312
00932,兆豐永續高息等權,10,0,10,華南永昌-民權,2024-06-07,9312
2201,裕隆,8,0,8,華南永昌-民權,2024-06-07,9312
1303,南亞,7,0,7,華南永昌-民權,2024-06-07,9312
2002,中鋼,7,0,7,華南永昌-民權,2024-06-07,9312
3088,艾訊,8,1,7,華南永昌-民權,2024-06-07,9312
4113,聯上,7,0,7,華南永昌-民權,2024-06-07,9312
4157,太景*-KY,7,0,7,華南永昌-民權,2024-06-07,9312
8033,雷虎,7,0,7,華南永昌-民權,2024-06-07,9312
00882,中信中國高股息,6,0,6,華南永昌-民權,2024-06-07,9312
00946,群益科技高息成長,6,0,6,華南永昌-民權,2024-06-07,9312
2363,矽統,6,0,6,華南永昌-民權,2024-06-07,9312
2405,輔信,6,0,6,華南永昌-民權,2024-06-07,9312
2885,元大金,6,0,6,華南永昌-民權,2024-06-07,9312
8437,大地-KY,8,2,6,華南永昌-民權,2024-06-07,9312
00933B,國泰10Y+金融債,20,15,5,華南永昌-民權,2024-06-07,9312
00724B,群益投資級金融債,5,0,5,華南永昌-民權,2024-06-07,9312
1464,得力,5,0,5,華南永昌-民權,2024-06-07,9312
2356,英業達,1214,8,1206,華南永昌-民權,2024-06-11,9312
1809,中釉,300,0,300,華南永昌-民權,2024-06-11,9312
00929,復華台灣科技優息,234,1,233,華南永昌-民權,2024-06-11,9312
2344,華邦電,203,0,203,華南永昌-民權,2024-06-11,9312
00919,群益台灣精選高息,127,10,117,華南永昌-民權,2024-06-11,9312
6770,力積電,101,3,98,華南永昌-民權,2024-06-11,9312
2408,南亞科,100,11,89,華南永昌-民權,2024-06-11,9312
2101,南港,80,0,80,華南永昌-民權,2024-06-11,9312
6706,惠特,70,0,70,華南永昌-民權,2024-06-11,9312
00878,國泰永續高股息,68,1,67,華南永昌-民權,2024-06-11,9312
00936,台新永續高息中小,69,5,64,華南永昌-民權,2024-06-11,9312
2609,陽明,306,256,50,華南永昌-民權,2024-06-11,9312
00632R,元大台灣50反1,50,0,50,華南永昌-民權,2024-06-11,9312
2102,泰豐,51,1,50,華南永昌-民權,2024-06-11,9312
00918,大華優利高填息30,47,0,47,華南永昌-民權,2024-06-11,9312
2888,新光金,48,3,45,華南永昌-民權,2024-06-11,9312
2511,太子,43,0,43,華南永昌-民權,2024-06-11,9312
4533,協易機,42,0,42,華南永昌-民權,2024-06-11,9312
3652,精聯,40,0,40,華南永昌-民權,2024-06-11,9312
3481,群創,52,15,37,華南永昌-民權,2024-06-11,9312
00679B,元大美債20年,28,1,27,華南永昌-民權,2024-06-11,9312
2002,中鋼,25,0,25,華南永昌-民權,2024-06-11,9312
1615,大山,24,0,24,華南永昌-民權,2024-06-11,9312
2515,中工,29,6,23,華南永昌-民權,2024-06-11,9312
00940,元大台灣價值高息,25,3,22,華南永昌-民權,2024-06-11,9312
00937B,群益ESG投等債20,46,25,21,華南永昌-民權,2024-06-11,9312
00942B,台新美A公司債20+,23,3,20,華南永昌-民權,2024-06-11,9312
1312,國喬,20,0,20,華南永昌-民權,2024-06-11,9312
2352,佳世達,20,0,20,華南永昌-民權,2024-06-11,9312
4306,炎洲,20,0,20,華南永昌-民權,2024-06-11,9312
5302,太欣,20,0,20,華南永昌-民權,2024-06-11,9312
00633L,富邦上証正2,20,2,18,華南永昌-民權,2024-06-11,9312
2498,宏達電,17,0,17,華南永昌-民權,2024-06-11,9312
1301,台塑,16,0,16,華南永昌-民權,2024-06-11,9312
2501,國建,31,15,16,華南永昌-民權,2024-06-11,9312
00921,兆豐龍頭等權重,15,0,15,華南永昌-民權,2024-06-11,9312
1815,富喬,18,4,14,華南永昌-民權,2024-06-11,9312
2615,萬海,27,13,14,華南永昌-民權,2024-06-11,9312
2537,聯上發,18,6,12,華南永昌-民權,2024-06-11,9312
4174,浩鼎,11,0,11,華南永昌-民權,2024-06-11,9312
4967,十銓,20,9,11,華南永昌-民權,2024-06-11,9312
6139,亞翔,11,0,11,華南永昌-民權,2024-06-11,9312
1608,華榮,11,1,10,華南永昌-民權,2024-06-11,9312
1444,力麗,10,0,10,華南永昌-民權,2024-06-11,9312
1455,集盛,10,0,10,華南永昌-民權,2024-06-11,9312
2049,上銀,10,0,10,華南永昌-民權,2024-06-11,9312
2547,日勝生,10,0,10,華南永昌-民權,2024-06-11,9312
3047,訊舟,19,9,10,華南永昌-民權,2024-06-11,9312
5512,力麒,10,0,10,華南永昌-民權,2024-06-11,9312
6290,良維,11,1,10,華南永昌-民權,2024-06-11,9312
2344,華邦電,751,1,750,華南永昌-民權,2024-06-12,9312
2356,英業達,506,4,502,華南永昌-民權,2024-06-12,9312
6706,惠特,183,3,180,華南永昌-民權,2024-06-12,9312
00632R,元大台灣50反1,131,0,131,華南永昌-民權,2024-06-12,9312
1314,中石化,133,3,130,華南永昌-民權,2024-06-12,9312
2102,泰豐,110,0,110,華南永昌-民權,2024-06-12,9312
2101,南港,100,0,100,華南永昌-民權,2024-06-12,9312
2412,中華電,100,0,100,華南永昌-民權,2024-06-12,9312
00947,台新臺灣IC設計,62,0,62,華南永昌-民權,2024-06-12,9312
2897,王道銀行,50,0,50,華南永昌-民權,2024-06-12,9312
00919,群益台灣精選高息,36,0,36,華南永昌-民權,2024-06-12,9312
00940,元大台灣價值高息,30,2,28,華南永昌-民權,2024-06-12,9312
6160,欣技,24,0,24,華南永昌-民權,2024-06-12,9312
2330,台積電,36,13,23,華南永昌-民權,2024-06-12,9312
2612,中航,22,0,22,華南永昌-民權,2024-06-12,9312
3231,緯創,35,14,21,華南永昌-民權,2024-06-12,9312
00878,國泰永續高股息,21,0,21,華南永昌-民權,2024-06-12,9312
00948B,中信優息投資級債,21,0,21,華南永昌-民權,2024-06-12,9312
4960,誠美材,21,0,21,華南永昌-民權,2024-06-12,9312
2610,華航,21,2,19,華南永昌-民權,2024-06-12,9312
1612,宏泰,17,0,17,華南永昌-民權,2024-06-12,9312
3481,群創,41,24,17,華南永昌-民權,2024-06-12,9312
6456,GIS-KY,15,0,15,華南永昌-民權,2024-06-12,9312
2353,宏��,14,0,14,華南永昌-民權,2024-06-12,9312
1301,台塑,14,0,14,華南永昌-民權,2024-06-12,9312
2515,中工,24,10,14,華南永昌-民權,2024-06-12,9312
4906,正文,16,3,13,華南永昌-民權,2024-06-12,9312
2498,宏達電,13,0,13,華南永昌-民權,2024-06-12,9312
00712,復華富時不動產,13,1,12,華南永昌-民權,2024-06-12,9312
1326,台化,12,0,12,華南永昌-民權,2024-06-12,9312
2460,建通,18,6,12,華南永昌-民權,2024-06-12,9312
3047,訊舟,16,4,12,華南永昌-民權,2024-06-12,9312
3576,聯合再生,12,0,12,華南永昌-民權,2024-06-12,9312
6188,廣明,40,28,12,華南永昌-民權,2024-06-12,9312
00915,凱基優選高股息30,12,1,11,華南永昌-民權,2024-06-12,9312
00633L,富邦上証正2,11,0,11,華南永昌-民權,2024-06-12,9312
2834,臺企銀,11,0,11,華南永昌-民權,2024-06-12,9312
2880,華南金,12,1,11,華南永昌-民權,2024-06-12,9312
0052,富邦科技,10,0,10,華南永昌-民權,2024-06-12,9312
2812,台中銀,18,8,10,華南永昌-民權,2024-06-12,9312
1409,新纖,10,0,10,華南永昌-民權,2024-06-12,9312
3188,鑫龍騰,10,0,10,華南永昌-民權,2024-06-12,9312
4554,橙的,10,0,10,華南永昌-民權,2024-06-12,9312
4916,事欣科,10,0,10,華南永昌-民權,2024-06-12,9312
00939,統一台灣高息動能,12,3,9,華南永昌-民權,2024-06-12,9312
1587,吉茂,10,1,9,華南永昌-民權,2024-06-12,9312
1615,大山,10,1,9,華南永昌-民權,2024-06-12,9312
2323,中環,20,11,9,華南永昌-民權,2024-06-12,9312
2405,輔信,11,2,9,華南永昌-民權,2024-06-12,9312
00713,元大台灣高息低波,10,1,9,華南永昌-民權,2024-06-12,9312
2374,佳能,1020,23,997,華南永昌-民權,2024-06-13,9312
2356,英業達,1021,33,988,華南永昌-民權,2024-06-13,9312
2101,南港,500,0,500,華南永昌-民權,2024-06-13,9312
2881,富邦金,200,0,200,華南永昌-民權,2024-06-13,9312
2801,彰銀,100,0,100,華南永昌-民權,2024-06-13,9312
00946,群益科技高息成長,76,0,76,華南永昌-民權,2024-06-13,9312
2888,新光金,106,31,75,華南永昌-民權,2024-06-13,9312
6706,惠特,70,0,70,華南永昌-民權,2024-06-13,9312
00919,群益台灣精選高息,72,5,67,華南永昌-民權,2024-06-13,9312
00947,台新臺灣IC設計,60,0,60,華南永昌-民權,2024-06-13,9312
00878,國泰永續高股息,55,0,55,華南永昌-民權,2024-06-13,9312
6215,和椿,24,1,23,華南永昌-民權,2024-06-13,9312
2615,萬海,30,9,21,華南永昌-民權,2024-06-13,9312
1615,大山,21,0,21,華南永昌-民權,2024-06-13,9312
6147,頎邦,20,0,20,華南永昌-民權,2024-06-13,9312
6488,環球晶,20,0,20,華南永昌-民權,2024-06-13,9312
5371,中光電,19,0,19,華南永昌-民權,2024-06-13,9312
2845,遠東銀,18,0,18,華南永昌-民權,2024-06-13,9312
00941,中信上游半導體,20,3,17,華南永昌-民權,2024-06-13,9312
0056,元大高股息,26,10,16,華南永昌-民權,2024-06-13,9312
1321,大洋,15,0,15,華南永昌-民權,2024-06-13,9312
2331,精英,14,0,14,華南永昌-民權,2024-06-13,9312
2609,陽明,57,44,13,華南永昌-民權,2024-06-13,9312
1504,東元,43,31,12,華南永昌-民權,2024-06-13,9312
6187,萬潤,12,0,12,華南永昌-民權,2024-06-13,9312
2606,裕民,11,0,11,華南永昌-民權,2024-06-13,9312
2883,凱基金,21,10,11,華南永昌-民權,2024-06-13,9312
1514,亞力,18,7,11,華南永昌-民權,2024-06-13,9312
00696B,富邦美債20年,10,0,10,華南永昌-民權,2024-06-13,9312
1617,榮星,14,4,10,華南永昌-民權,2024-06-13,9312
2605,新興,11,1,10,華南永昌-民權,2024-06-13,9312
4905,台聯電,10,0,10,華南永昌-民權,2024-06-13,9312
6176,瑞儀,10,0,10,華南永昌-民權,2024-06-13,9312
4566,時碩工業,9,0,9,華南永昌-民權,2024-06-13,9312
3450,聯鈞,45,36,9,華南永昌-民權,2024-06-13,9312
2330,台積電,16,7,9,華南永昌-民權,2024-06-13,9312
2353,宏��,16,8,8,華南永昌-民權,2024-06-13,9312
5302,太欣,8,0,8,華南永昌-民權,2024-06-13,9312
1815,富喬,13,6,7,華南永昌-民權,2024-06-13,9312
2417,圓剛,7,0,7,華南永昌-民權,2024-06-13,9312
8093,保銳,7,0,7,華南永昌-民權,2024-06-13,9312
00687B,國泰20年美債,6,0,6,華南永昌-民權,2024-06-13,9312
2603,長榮,10,4,6,華南永昌-民權,2024-06-13,9312
4967,十銓,19,13,6,華南永昌-民權,2024-06-13,9312
8096,擎亞,8,2,6,華南永昌-民權,2024-06-13,9312
00933B,國泰10Y+金融債,51,46,5,華南永昌-民權,2024-06-13,9312
00948B,中信優息投資級債,15,10,5,華南永昌-民權,2024-06-13,9312
1409,新纖,5,0,5,華南永昌-民權,2024-06-13,9312
2365,昆盈,6,1,5,華南永昌-民權,2024-06-13,9312
2732,六角,5,0,5,華南永昌-民權,2024-06-13,9312
00948B,中信優息投資級債,114,10,104,華南永昌-民權,2024-06-14,9312
2344,華邦電,106,5,101,華南永昌-民權,2024-06-14,9312
2101,南港,300,200,100,華南永昌-民權,2024-06-14,9312
1440,南紡,100,0,100,華南永昌-民權,2024-06-14,9312
2888,新光金,70,7,63,華南永昌-民權,2024-06-14,9312
2367,燿華,49,0,49,華南永昌-民權,2024-06-14,9312
00929,復華台灣科技優息,153,105,48,華南永昌-民權,2024-06-14,9312
00936,台新永續高息中小,28,1,27,華南永昌-民權,2024-06-14,9312
1614,三洋電,25,0,25,華南永昌-民權,2024-06-14,9312
00919,群益台灣精選高息,28,5,23,華南永昌-民權,2024-06-14,9312
2371,大同,101,78,23,華南永昌-民權,2024-06-14,9312
2313,華通,22,0,22,華南永昌-民權,2024-06-14,9312
00632R,元大台灣50反1,20,0,20,華南永昌-民權,2024-06-14,9312
00946,群益科技高息成長,20,0,20,華南永昌-民權,2024-06-14,9312
2498,宏達電,20,0,20,華南永昌-民權,2024-06-14,9312
2630,亞航,20,0,20,華南永昌-民權,2024-06-14,9312
8070,長華*,20,0,20,華南永昌-民權,2024-06-14,9312
1615,大山,20,1,19,華南永昌-民權,2024-06-14,9312
3450,聯鈞,40,21,19,華南永昌-民權,2024-06-14,9312
3231,緯創,20,2,18,華南永昌-民權,2024-06-14,9312
3013,晟銘電,32,14,18,華南永昌-民權,2024-06-14,9312
2023,燁輝,16,0,16,華南永昌-民權,2024-06-14,9312
2427,三商電,20,5,15,華南永昌-民權,2024-06-14,9312
6173,信昌電,15,1,14,華南永昌-民權,2024-06-14,9312
00679B,元大美債20年,13,0,13,華南永昌-民權,2024-06-14,9312
1608,華榮,23,11,12,華南永昌-民權,2024-06-14,9312
2897A,王道銀甲特,12,0,12,華南永昌-民權,2024-06-14,9312
3088,艾訊,12,0,12,華南永昌-民權,2024-06-14,9312
1447,力鵬,11,0,11,華南永昌-民權,2024-06-14,9312
2610,華航,11,0,11,華南永昌-民權,2024-06-14,9312
00932,兆豐永續高息等權,10,0,10,華南永昌-民權,2024-06-14,9312
00733,富邦臺灣中小,10,0,10,華南永昌-民權,2024-06-14,9312
00942B,台新美A公司債20+,10,0,10,華南永昌-民權,2024-06-14,9312
1314,中石化,10,0,10,華南永昌-民權,2024-06-14,9312
1815,富喬,10,0,10,華南永昌-民權,2024-06-14,9312
2482,連宇,10,0,10,華南永昌-民權,2024-06-14,9312
3491,昇達科,10,0,10,華南永昌-民權,2024-06-14,9312
8215,明基材,10,0,10,華南永昌-民權,2024-06-14,9312
6188,廣明,9,0,9,華南永昌-民權,2024-06-14,9312
2754,亞洲藏壽司,9,0,9,華南永昌-民權,2024-06-14,9312
1210,大成,8,0,8,華南永昌-民權,2024-06-14,9312
1786,科妍,8,0,8,華南永昌-民權,2024-06-14,9312
2353,宏��,8,1,7,華南永昌-民權,2024-06-14,9312
1617,榮星,9,3,6,華南永昌-民權,2024-06-14,9312
2324,仁寶,6,0,6,華南永昌-民權,2024-06-14,9312
00878,國泰永續高股息,7,1,6,華南永昌-民權,2024-06-14,9312
2002,中鋼,5,0,5,華南永昌-民權,2024-06-14,9312
2049,上銀,5,0,5,華南永昌-民權,2024-06-14,9312
2501,國建,8,3,5,華南永昌-民權,2024-06-14,9312
2618,長榮航,13,8,5,華南永昌-民權,2024-06-14,9312
8916,光隆,100,0,100,華南永昌-民權,2024-06-17,9312
00948B,中信優息投資級債,82,0,82,華南永昌-民權,2024-06-17,9312
2102,泰豐,50,0,50,華南永昌-民權,2024-06-17,9312
00936,台新永續高息中小,51,19,32,華南永昌-民權,2024-06-17,9312
8039,台虹,46,15,31,華南永昌-民權,2024-06-17,9312
00933B,國泰10Y+金融債,27,0,27,華南永昌-民權,2024-06-17,9312
2314,台揚,24,0,24,華南永昌-民權,2024-06-17,9312
2365,昆盈,51,29,22,華南永昌-民權,2024-06-17,9312
4726,永昕,29,7,22,華南永昌-民權,2024-06-17,9312
00795B,中信美國公債20年,22,1,21,華南永昌-民權,2024-06-17,9312
2897A,王道銀甲特,21,0,21,華南永昌-民權,2024-06-17,9312
5009,榮剛,21,0,21,華南永昌-民權,2024-06-17,9312
3024,憶聲,20,0,20,華南永昌-民權,2024-06-17,9312
5284,jpp-KY,20,0,20,華南永昌-民權,2024-06-17,9312
2515,中工,25,6,19,華南永昌-民權,2024-06-17,9312
00929,復華台灣科技優息,48,30,18,華南永昌-民權,2024-06-17,9312
00940,元大台灣價值高息,155,137,18,華南永昌-民權,2024-06-17,9312
00885,富邦越南,18,2,16,華南永昌-民權,2024-06-17,9312
00919,群益台灣精選高息,17,1,16,華南永昌-民權,2024-06-17,9312
3081,聯亞,20,4,16,華南永昌-民權,2024-06-17,9312
3188,鑫龍騰,15,0,15,華南永昌-民權,2024-06-17,9312
3437,榮創,15,0,15,華南永昌-民權,2024-06-17,9312
8050,廣積,15,2,13,華南永昌-民權,2024-06-17,9312
1503,士電,18,7,11,華南永昌-民權,2024-06-17,9312
1445,大宇,11,0,11,華南永昌-民權,2024-06-17,9312
2548,華固,12,1,11,華南永昌-民權,2024-06-17,9312
2888,新光金,13,2,11,華南永昌-民權,2024-06-17,9312
1513,中興電,30,19,11,華南永昌-民權,2024-06-17,9312
00881,國泰台灣5G+,10,0,10,華南永昌-民權,2024-06-17,9312
00679B,元大美債20年,15,5,10,華南永昌-民權,2024-06-17,9312
00676R,富邦臺灣加權反1,10,0,10,華南永昌-民權,2024-06-17,9312
5515,建國,10,0,10,華南永昌-民權,2024-06-17,9312
6139,亞翔,10,1,9,華南永昌-民權,2024-06-17,9312
1321,大洋,9,0,9,華南永昌-民權,2024-06-17,9312
3706,神達,13,4,9,華南永昌-民權,2024-06-17,9312
1609,大亞,13,5,8,華南永昌-民權,2024-06-17,9312
00687B,國泰20年美債,10,2,8,華南永昌-民權,2024-06-17,9312
1617,榮星,10,2,8,華南永昌-民權,2024-06-17,9312
2609,陽明,26,19,7,華南永昌-民權,2024-06-17,9312
2329,華泰,7,0,7,華南永昌-民權,2024-06-17,9312
2427,三商電,9,2,7,華南永昌-民權,2024-06-17,9312
2428,興勤,11,4,7,華南永昌-民權,2024-06-17,9312
2501,國建,7,0,7,華南永昌-民權,2024-06-17,9312
5880,合庫金,7,0,7,華南永昌-民權,2024-06-17,9312
2883,凱基金,12,5,7,華南永昌-民權,2024-06-17,9312
00918,大華優利高填息30,6,0,6,華南永昌-民權,2024-06-17,9312
00728,第一金工業30,6,0,6,華南永昌-民權,2024-06-17,9312
1522,堤維西,6,0,6,華南永昌-民權,2024-06-17,9312
1528,恩德,6,0,6,華南永昌-民權,2024-06-17,9312
1808,潤隆,6,0,6,華南永昌-民權,2024-06-17,9312
00772B,中信高評級公司債,600,0,600,華南永昌-民權,2024-06-18,9312
00687B,國泰20年美債,153,0,153,華南永昌-民權,2024-06-18,9312
2371,大同,130,29,101,華南永昌-民權,2024-06-18,9312
9924,福興,100,0,100,華南永昌-民權,2024-06-18,9312
2353,宏��,85,3,82,華南永昌-民權,2024-06-18,9312
2887,台新金,63,0,63,華南永昌-民權,2024-06-18,9312
8916,光隆,50,0,50,華南永昌-民權,2024-06-18,9312
00936,台新永續高息中小,50,1,49,華南永昌-民權,2024-06-18,9312
00878,國泰永續高股息,40,2,38,華南永昌-民權,2024-06-18,9312
3081,聯亞,50,14,36,華南永昌-民權,2024-06-18,9312
00937B,群益ESG投等債20,39,3,36,華南永昌-民權,2024-06-18,9312
2408,南亞科,153,121,32,華南永昌-民權,2024-06-18,9312
3363,上詮,42,11,31,華南永昌-民權,2024-06-18,9312
00935,野村臺灣新科技50,30,1,29,華南永昌-民權,2024-06-18,9312
2317,鴻海,29,4,25,華南永昌-民權,2024-06-18,9312
00680L,元大美債20正2,24,0,24,華南永昌-民權,2024-06-18,9312
00632R,元大台灣50反1,22,0,22,華南永昌-民權,2024-06-18,9312
1409,新纖,20,0,20,華南永昌-民權,2024-06-18,9312
9105,泰金寶-DR,20,2,18,華南永昌-民權,2024-06-18,9312
8215,明基材,15,0,15,華南永昌-民權,2024-06-18,9312
1815,富喬,37,23,14,華南永昌-民權,2024-06-18,9312
00918,大華優利高填息30,14,1,13,華南永昌-民權,2024-06-18,9312
1713,國化,13,0,13,華南永昌-民權,2024-06-18,9312
2409,友達,15,2,13,華南永昌-民權,2024-06-18,9312
1802,台玻,19,7,12,華南永昌-民權,2024-06-18,9312
3294,英濟,12,1,11,華南永昌-民權,2024-06-18,9312
6125,廣運,13,2,11,華南永昌-民權,2024-06-18,9312
00946,群益科技高息成長,10,0,10,華南永昌-民權,2024-06-18,9312
2031,新光鋼,10,0,10,華南永昌-民權,2024-06-18,9312
2417,圓剛,10,0,10,華南永昌-民權,2024-06-18,9312
2601,益航,10,0,10,華南永昌-民權,2024-06-18,9312
3313,斐成,10,0,10,華南永昌-民權,2024-06-18,9312
6182,合晶,10,0,10,華南永昌-民權,2024-06-18,9312
6770,力積電,10,0,10,華南永昌-民權,2024-06-18,9312
00675L,富邦臺灣加權正2,9,0,9,華南永昌-民權,2024-06-18,9312
3041,揚智,9,0,9,華南永昌-民權,2024-06-18,9312
4967,十銓,14,5,9,華南永昌-民權,2024-06-18,9312
5490,同亨,9,0,9,華南永昌-民權,2024-06-18,9312
00631L,元大台灣50正2,9,0,9,華南永昌-民權,2024-06-18,9312
00941,中信上游半導體,10,2,8,華南永昌-民權,2024-06-18,9312
2605,新興,8,0,8,華南永昌-民權,2024-06-18,9312
3229,晟鈦,8,0,8,華南永昌-民權,2024-06-18,9312
5236,凌陽創新,8,0,8,華南永昌-民權,2024-06-18,9312
00929,復華台灣科技優息,15,8,7,華南永昌-民權,2024-06-18,9312
1605,華新,10,3,7,華南永昌-民權,2024-06-18,9312
2460,建通,7,0,7,華南永昌-民權,2024-06-18,9312
3373,熱映,7,0,7,華南永昌-民權,2024-06-18,9312
4909,新復興,8,1,7,華南永昌-民權,2024-06-18,9312
6215,和椿,9,2,7,華南永昌-民權,2024-06-18,9312
9958,世紀鋼,7,0,7,華南永昌-民權,2024-06-18,9312
2374,佳能,400,0,400,華南永昌-民權,2024-06-19,9312
2344,華邦電,231,12,219,華南永昌-民權,2024-06-19,9312
2408,南亞科,203,4,199,華南永昌-民權,2024-06-19,9312
8064,東捷,90,9,81,華南永昌-民權,2024-06-19,9312
3363,上詮,90,22,68,華南永昌-民權,2024-06-19,9312
00687B,國泰20年美債,62,0,62,華南永昌-民權,2024-06-19,9312
6706,惠特,50,0,50,華南永昌-民權,2024-06-19,9312
00946,群益科技高息成長,51,1,50,華南永昌-民權,2024-06-19,9312
1609,大亞,55,10,45,華南永昌-民權,2024-06-19,9312
3652,精聯,41,0,41,華南永昌-民權,2024-06-19,9312
2330,台積電,49,8,41,華南永昌-民權,2024-06-19,9312
00936,台新永續高息中小,46,6,40,華南永昌-民權,2024-06-19,9312
00948B,中信優息投資級債,30,0,30,華南永昌-民權,2024-06-19,9312
8050,廣積,28,0,28,華南永昌-民權,2024-06-19,9312
2409,友達,27,0,27,華南永昌-民權,2024-06-19,9312
2360,致茂,23,0,23,華南永昌-民權,2024-06-19,9312
3673,TPK-KY,21,1,20,華南永昌-民權,2024-06-19,9312
2317,鴻海,33,13,20,華南永昌-民權,2024-06-19,9312
2548,華固,20,1,19,華南永昌-民權,2024-06-19,9312
3062,建漢,31,13,18,華南永昌-民權,2024-06-19,9312
1802,台玻,23,6,17,華南永昌-民權,2024-06-19,9312
2637,慧洋-KY,15,0,15,華南永昌-民權,2024-06-19,9312
2888,新光金,21,7,14,華南永昌-民權,2024-06-19,9312
2312,金寶,17,3,14,華南永昌-民權,2024-06-19,9312
2354,鴻準,37,23,14,華南永昌-民權,2024-06-19,9312
00937B,群益ESG投等債20,24,10,14,華南永昌-民權,2024-06-19,9312
00933B,國泰10Y+金融債,13,0,13,華南永昌-民權,2024-06-19,9312
2442,新美齊,13,0,13,華南永昌-民權,2024-06-19,9312
3081,聯亞,15,2,13,華南永昌-民權,2024-06-19,9312
5443,均豪,29,17,12,華南永昌-民權,2024-06-19,9312
6770,力積電,13,1,12,華南永昌-民權,2024-06-19,9312
2328,廣宇,15,4,11,華南永昌-民權,2024-06-19,9312
4714,永捷,11,0,11,華南永昌-民權,2024-06-19,9312
4905,台聯電,11,0,11,華南永昌-民權,2024-06-19,9312
5512,力麒,11,0,11,華南永昌-民權,2024-06-19,9312
8011,台通,22,11,11,華南永昌-民權,2024-06-19,9312
5371,中光電,10,0,10,華南永昌-民權,2024-06-19,9312
00931B,統一美債20年,10,0,10,華南永昌-民權,2024-06-19,9312
00932,兆豐永續高息等權,10,0,10,華南永昌-民權,2024-06-19,9312
1409,新纖,10,0,10,華南永昌-民權,2024-06-19,9312
2506,太設,10,0,10,華南永昌-民權,2024-06-19,9312
2633,台灣高鐵,10,0,10,華南永昌-民權,2024-06-19,9312
3024,憶聲,10,0,10,華南永昌-民權,2024-06-19,9312
3047,訊舟,11,1,10,華南永昌-民權,2024-06-19,9312
6026,福邦證,10,0,10,華南永昌-民權,2024-06-19,9312
8086,宏捷科,10,0,10,華南永昌-民權,2024-06-19,9312
3481,群創,26,17,9,華南永昌-民權,2024-06-19,9312
2355,敬鵬,9,1,8,華南永昌-民權,2024-06-19,9312
2883,凱基金,11,3,8,華南永昌-民權,2024-06-19,9312
4109,加捷生醫,8,0,8,華南永昌-民權,2024-06-19,9312
2356,英業達,1255,12,1243,華南永昌-民權,2024-06-20,9312
2344,華邦電,308,164,144,華南永昌-民權,2024-06-20,9312
4306,炎洲,41,2,39,華南永昌-民權,2024-06-20,9312
1609,大亞,45,8,37,華南永昌-民權,2024-06-20,9312
0056,元大高股息,30,0,30,華南永昌-民權,2024-06-20,9312
2313,華通,35,7,28,華南永昌-民權,2024-06-20,9312
00936,台新永續高息中小,27,2,25,華南永昌-民權,2024-06-20,9312
2812,台中銀,43,22,21,華南永昌-民權,2024-06-20,9312
00945B,凱基美國非投等債,20,0,20,華南永昌-民權,2024-06-20,9312
2537,聯上發,20,0,20,華南永昌-民權,2024-06-20,9312
2883B,凱基金乙特,20,0,20,華南永昌-民權,2024-06-20,9312
2353,宏��,21,2,19,華南永昌-民權,2024-06-20,9312
5371,中光電,18,0,18,華南永昌-民權,2024-06-20,9312
2409,友達,16,0,16,華南永昌-民權,2024-06-20,9312
00929,復華台灣科技優息,18,3,15,華南永昌-民權,2024-06-20,9312
2707,晶華,15,0,15,華南永昌-民權,2024-06-20,9312
2023,燁輝,30,16,14,華南永昌-民權,2024-06-20,9312
00712,復華富時不動產,13,0,13,華南永昌-民權,2024-06-20,9312
3372,典範,15,2,13,華南永昌-民權,2024-06-20,9312
8105,凌巨,20,7,13,華南永昌-民權,2024-06-20,9312
1605,華新,12,0,12,華南永昌-民權,2024-06-20,9312
1513,中興電,12,1,11,華南永昌-民權,2024-06-20,9312
6176,瑞儀,11,0,11,華南永昌-民權,2024-06-20,9312
2382,廣達,25,14,11,華南永昌-民權,2024-06-20,9312
00935,野村臺灣新科技50,10,0,10,華南永昌-民權,2024-06-20,9312
00646,元大S＆P500,10,0,10,華南永昌-民權,2024-06-20,9312
00948B,中信優息投資級債,10,0,10,華南永昌-民權,2024-06-20,9312
1309,台達化,10,0,10,華南永昌-民權,2024-06-20,9312
3024,憶聲,10,0,10,華南永昌-民權,2024-06-20,9312
3122,笙泉,10,0,10,華南永昌-民權,2024-06-20,9312
4540,全球傳動,10,0,10,華南永昌-民權,2024-06-20,9312
911868,同方友友-DR,10,0,10,華南永昌-民權,2024-06-20,9312
00675L,富邦臺灣加權正2,9,0,9,華南永昌-民權,2024-06-20,9312
00881,國泰台灣5G+,11,2,9,華南永昌-民權,2024-06-20,9312
00937B,群益ESG投等債20,13,5,8,華南永昌-民權,2024-06-20,9312
00885,富邦越南,8,0,8,華南永昌-民權,2024-06-20,9312
2324,仁寶,10,2,8,華南永昌-民權,2024-06-20,9312
2481,強茂,7,0,7,華南永昌-民權,2024-06-20,9312
2610,華航,7,0,7,華南永昌-民權,2024-06-20,9312
6026,福邦證,7,0,7,華南永昌-民權,2024-06-20,9312
6589,台康生技,7,0,7,華南永昌-民權,2024-06-20,9312
1503,士電,35,29,6,華南永昌-民權,2024-06-20,9312
00947,台新臺灣IC設計,6,0,6,華南永昌-民權,2024-06-20,9312
2007,燁興,6,0,6,華南永昌-民權,2024-06-20,9312
2420,新巨,7,1,6,華南永昌-民權,2024-06-20,9312
6278,台表科,6,0,6,華南永昌-民權,2024-06-20,9312
2498,宏達電,55,50,5,華南永昌-民權,2024-06-20,9312
6609,瀧澤科,5,0,5,華南永昌-民權,2024-06-20,9312
2615,萬海,60,55,5,華南永昌-民權,2024-06-20,9312
00632R,元大台灣50反1,5,0,5,華南永昌-民權,2024-06-20,9312
2101,南港,300,0,300,華南永昌-民權,2024-06-21,9312
3363,上詮,335,86,249,華南永昌-民權,2024-06-21,9312
1785,光洋科,305,71,234,華南永昌-民權,2024-06-21,9312
00937B,群益ESG投等債20,187,10,177,華南永昌-民權,2024-06-21,9312
2317,鴻海,220,52,168,華南永昌-民權,2024-06-21,9312
1101,台泥,100,12,88,華南永昌-民權,2024-06-21,9312
2330,台積電,57,1,56,華南永昌-民權,2024-06-21,9312
2374,佳能,53,0,53,華南永昌-民權,2024-06-21,9312
00946,群益科技高息成長,63,11,52,華南永昌-民權,2024-06-21,9312
8916,光隆,50,0,50,華南永昌-民權,2024-06-21,9312
2382,廣達,56,10,46,華南永昌-民權,2024-06-21,9312
00942B,台新美A公司債20+,38,3,35,華南永昌-民權,2024-06-21,9312
0056,元大高股息,35,2,33,華南永昌-民權,2024-06-21,9312
1303,南亞,27,0,27,華南永昌-民權,2024-06-21,9312
00936,台新永續高息中小,23,0,23,華南永昌-民權,2024-06-21,9312
6188,廣明,21,0,21,華南永昌-民權,2024-06-21,9312
2524,京城,20,0,20,華南永昌-民權,2024-06-21,9312
6167,久正,20,0,20,華南永昌-民權,2024-06-21,9312
6603,富強鑫,20,0,20,華南永昌-民權,2024-06-21,9312
8070,長華*,20,0,20,華南永昌-民權,2024-06-21,9312
00633L,富邦上証正2,22,3,19,華南永昌-民權,2024-06-21,9312
1815,富喬,95,76,19,華南永昌-民權,2024-06-21,9312
00933B,國泰10Y+金融債,19,0,19,華南永昌-民權,2024-06-21,9312
1326,台化,19,1,18,華南永昌-民權,2024-06-21,9312
8936,國統,17,1,16,華南永昌-民權,2024-06-21,9312
2537,聯上發,18,2,16,華南永昌-民權,2024-06-21,9312
00919,群益台灣精選高息,74,58,16,華南永昌-民權,2024-06-21,9312
1711,永光,15,0,15,華南永昌-民權,2024-06-21,9312
1321,大洋,14,0,14,華南永昌-民權,2024-06-21,9312
1810,和成,14,0,14,華南永昌-民權,2024-06-21,9312
2412,中華電,14,0,14,華南永昌-民權,2024-06-21,9312
8105,凌巨,26,13,13,華南永昌-民權,2024-06-21,9312
5347,世界,12,0,12,華南永昌-民權,2024-06-21,9312
00885,富邦越南,11,0,11,華南永昌-民權,2024-06-21,9312
00773B,中信優先金融債,10,0,10,華南永昌-民權,2024-06-21,9312
1410,南染,10,0,10,華南永昌-民權,2024-06-21,9312
1440,南紡,10,0,10,華南永昌-民權,2024-06-21,9312
2891,中信金,10,0,10,華南永昌-民權,2024-06-21,9312
5703,亞都,10,0,10,華南永昌-民權,2024-06-21,9312
6176,瑞儀,10,0,10,華南永昌-民權,2024-06-21,9312
912000,晨訊科-DR,25,15,10,華南永昌-民權,2024-06-21,9312
2812,台中銀,18,9,9,華南永昌-民權,2024-06-21,9312
6125,廣運,14,5,9,華南永昌-民權,2024-06-21,9312
00881,國泰台灣5G+,8,0,8,華南永昌-民權,2024-06-21,9312
00882,中信中國高股息,10,2,8,華南永昌-民權,2024-06-21,9312
1309,台達化,9,1,8,華南永昌-民權,2024-06-21,9312
2603,長榮,14,6,8,華南永昌-民權,2024-06-21,9312
3025,星通,8,0,8,華南永昌-民權,2024-06-21,9312
00679B,元大美債20年,8,1,7,華南永昌-民權,2024-06-21,9312
3227,原相,7,0,7,華南永昌-民權,2024-06-21,9312
2356,英業達,4518,26,4492,華南永昌-民權,2024-06-24,9312
3481,群創,307,180,127,華南永昌-民權,2024-06-24,9312
2317,鴻海,143,19,124,華南永昌-民權,2024-06-24,9312
2498,宏達電,102,0,102,華南永昌-民權,2024-06-24,9312
00687B,國泰20年美債,92,0,92,華南永昌-民權,2024-06-24,9312
00929,復華台灣科技優息,88,44,44,華南永昌-民權,2024-06-24,9312
2353,宏��,45,7,38,華南永昌-民權,2024-06-24,9312
00946,群益科技高息成長,33,1,32,華南永昌-民權,2024-06-24,9312
1314,中石化,101,70,31,華南永昌-民權,2024-06-24,9312
1409,新纖,31,0,31,華南永昌-民權,2024-06-24,9312
2330,台積電,50,20,30,華南永昌-民權,2024-06-24,9312
1609,大亞,29,3,26,華南永昌-民權,2024-06-24,9312
5328,華容,37,11,26,華南永昌-民權,2024-06-24,9312
6284,佳邦,52,27,25,華南永昌-民權,2024-06-24,9312
00881,國泰台灣5G+,24,0,24,華南永昌-民權,2024-06-24,9312
00936,台新永續高息中小,24,0,24,華南永昌-民權,2024-06-24,9312
00918,大華優利高填息30,25,1,24,華南永昌-民權,2024-06-24,9312
1326,台化,23,0,23,華南永昌-民權,2024-06-24,9312
00937B,群益ESG投等債20,32,10,22,華南永昌-民權,2024-06-24,9312
2303,聯電,21,0,21,華南永昌-民權,2024-06-24,9312
2002,中鋼,22,1,21,華南永昌-民權,2024-06-24,9312
1410,南染,20,0,20,華南永昌-民權,2024-06-24,9312
1447,力鵬,20,0,20,華南永昌-民權,2024-06-24,9312
6147,頎邦,20,0,20,華南永昌-民權,2024-06-24,9312
6160,欣技,20,0,20,華南永昌-民權,2024-06-24,9312
00940,元大台灣價值高息,117,99,18,華南永昌-民權,2024-06-24,9312
4909,新復興,28,10,18,華南永昌-民權,2024-06-24,9312
1303,南亞,19,1,18,華南永昌-民權,2024-06-24,9312
6140,訊達,16,0,16,華南永昌-民權,2024-06-24,9312
2615,萬海,22,6,16,華南永昌-民權,2024-06-24,9312
2609,陽明,30,14,16,華南永昌-民權,2024-06-24,9312
3231,緯創,16,0,16,華南永昌-民權,2024-06-24,9312
00939,統一台灣高息動能,17,2,15,華南永昌-民權,2024-06-24,9312
5443,均豪,19,5,14,華南永昌-民權,2024-06-24,9312
2409,友達,22,9,13,華南永昌-民權,2024-06-24,9312
6139,亞翔,13,0,13,華南永昌-民權,2024-06-24,9312
3088,艾訊,15,2,13,華南永昌-民權,2024-06-24,9312
2382,廣達,26,15,11,華南永昌-民權,2024-06-24,9312
2369,菱生,33,22,11,華南永昌-民權,2024-06-24,9312
4306,炎洲,11,0,11,華南永昌-民權,2024-06-24,9312
00696B,富邦美債20年,10,0,10,華南永昌-民權,2024-06-24,9312
00882,中信中國高股息,10,0,10,華南永昌-民權,2024-06-24,9312
00878,國泰永續高股息,11,2,9,華南永昌-民權,2024-06-24,9312
2101,南港,10,1,9,華南永昌-民權,2024-06-24,9312
2888,新光金,12,3,9,華南永昌-民權,2024-06-24,9312
3607,谷崧,10,1,9,華南永昌-民權,2024-06-24,9312
1319,東陽,8,0,8,華南永昌-民權,2024-06-24,9312
2331,精英,8,0,8,華南永昌-民權,2024-06-24,9312
3062,建漢,60,52,8,華南永昌-民權,2024-06-24,9312
5347,世界,8,0,8,華南永昌-民權,2024-06-24,9312
2356,英業達,651,6,645,華南永昌-民權,2024-06-25,9312
6706,惠特,170,20,150,華南永昌-民權,2024-06-25,9312
2409,友達,79,3,76,華南永昌-民權,2024-06-25,9312
00946,群益科技高息成長,34,0,34,華南永昌-民權,2024-06-25,9312
2002,中鋼,29,0,29,華南永昌-民權,2024-06-25,9312
00940,元大台灣價值高息,33,5,28,華南永昌-民權,2024-06-25,9312
00929,復華台灣科技優息,24,0,24,華南永昌-民權,2024-06-25,9312
3481,群創,115,92,23,華南永昌-民權,2024-06-25,9312
1815,富喬,30,8,22,華南永昌-民權,2024-06-25,9312
2408,南亞科,23,1,22,華南永昌-民權,2024-06-25,9312
1711,永光,20,0,20,華南永昌-民權,2024-06-25,9312
2461,光群雷,20,0,20,華南永昌-民權,2024-06-25,9312
2883,凱基金,20,0,20,華南永昌-民權,2024-06-25,9312
4540,全球傳動,20,0,20,華南永昌-民權,2024-06-25,9312
1301,台塑,20,1,19,華南永昌-民權,2024-06-25,9312
00936,台新永續高息中小,17,0,17,華南永昌-民權,2024-06-25,9312
6116,彩晶,17,0,17,華南永昌-民權,2024-06-25,9312
6173,信昌電,17,1,16,華南永昌-民權,2024-06-25,9312
9105,泰金寶-DR,16,0,16,華南永昌-民權,2024-06-25,9312
5344,立衛,15,0,15,華南永昌-民權,2024-06-25,9312
1101,台泥,15,1,14,華南永昌-民權,2024-06-25,9312
2371,大同,14,1,13,華南永昌-民權,2024-06-25,9312
3576,聯合再生,15,3,12,華南永昌-民權,2024-06-25,9312
3711,日月光投控,12,1,11,華南永昌-民權,2024-06-25,9312
00881,國泰台灣5G+,11,0,11,華南永昌-民權,2024-06-25,9312
2382,廣達,14,4,10,華南永昌-民權,2024-06-25,9312
00679B,元大美債20年,10,0,10,華南永昌-民權,2024-06-25,9312
5880,合庫金,10,0,10,華南永昌-民權,2024-06-25,9312
2364,倫飛,10,0,10,華南永昌-民權,2024-06-25,9312
2406,國碩,52,42,10,華南永昌-民權,2024-06-25,9312
4905,台聯電,10,0,10,華南永昌-民權,2024-06-25,9312
6177,達麗,10,0,10,華南永昌-民權,2024-06-25,9312
6190,萬泰科,10,0,10,華南永昌-民權,2024-06-25,9312
6505,台塑化,10,0,10,華南永昌-民權,2024-06-25,9312
6603,富強鑫,10,0,10,華南永昌-民權,2024-06-25,9312
2317,鴻海,26,17,9,華南永昌-民權,2024-06-25,9312
1309,台達化,11,2,9,華南永昌-民權,2024-06-25,9312
2845,遠東銀,10,1,9,華南永昌-民權,2024-06-25,9312
6160,欣技,10,1,9,華南永昌-民權,2024-06-25,9312
00878,國泰永續高股息,8,0,8,華南永昌-民權,2024-06-25,9312
2367,燿華,12,4,8,華南永昌-民權,2024-06-25,9312
1319,東陽,7,0,7,華南永昌-民權,2024-06-25,9312
5351,鈺創,8,1,7,華南永昌-民權,2024-06-25,9312
2412,中華電,7,0,7,華南永昌-民權,2024-06-25,9312
2548,華固,6,0,6,華南永昌-民權,2024-06-25,9312
2049,上銀,6,0,6,華南永昌-民權,2024-06-25,9312
5328,華容,10,4,6,華南永昌-民權,2024-06-25,9312
8064,東捷,10,4,6,華南永昌-民權,2024-06-25,9312
00919,群益台灣精選高息,55,50,5,華南永昌-民權,2024-06-25,9312
1326,台化,5,0,5,華南永昌-民權,2024-06-25,9312
2356,英業達,2033,9,2024,華南永昌-民權,2024-06-26,9312
2812,台中銀,164,4,160,華南永昌-民權,2024-06-26,9312
3481,群創,147,39,108,華南永昌-民權,2024-06-26,9312
2354,鴻準,84,22,62,華南永昌-民權,2024-06-26,9312
1301,台塑,57,0,57,華南永昌-民權,2024-06-26,9312
6160,欣技,43,1,42,華南永昌-民權,2024-06-26,9312
2371,大同,50,12,38,華南永昌-民權,2024-06-26,9312
00936,台新永續高息中小,29,1,28,華南永昌-民權,2024-06-26,9312
2409,友達,32,5,27,華南永昌-民權,2024-06-26,9312
2406,國碩,47,26,21,華南永昌-民權,2024-06-26,9312
2883,凱基金,44,26,18,華南永昌-民權,2024-06-26,9312
2344,華邦電,57,40,17,華南永昌-民權,2024-06-26,9312
5340,建榮,17,0,17,華南永昌-民權,2024-06-26,9312
2312,金寶,27,11,16,華南永昌-民權,2024-06-26,9312
00947,台新臺灣IC設計,15,0,15,華南永昌-民權,2024-06-26,9312
00687B,國泰20年美債,15,0,15,華南永昌-民權,2024-06-26,9312
3701,大眾控,15,0,15,華南永昌-民權,2024-06-26,9312
00633L,富邦上証正2,13,0,13,華南永昌-民權,2024-06-26,9312
2401,凌陽,36,23,13,華南永昌-民權,2024-06-26,9312
1326,台化,12,1,11,華南永昌-民權,2024-06-26,9312
00919,群益台灣精選高息,11,0,11,華南永昌-民權,2024-06-26,9312
00937B,群益ESG投等債20,16,6,10,華南永昌-民權,2024-06-26,9312
00741B,富邦全球非投等債,10,0,10,華南永昌-民權,2024-06-26,9312
1215,卜蜂,10,0,10,華南永昌-民權,2024-06-26,9312
2353,宏��,15,5,10,華南永昌-民權,2024-06-26,9312
2836,高雄銀,10,0,10,華南永昌-民權,2024-06-26,9312
5328,華容,10,0,10,華南永昌-民權,2024-06-26,9312
6190,萬泰科,10,0,10,華南永昌-民權,2024-06-26,9312
6282,康舒,13,3,10,華南永昌-民權,2024-06-26,9312
2449,京元電子,26,17,9,華南永昌-民權,2024-06-26,9312
2603,長榮,10,1,9,華南永昌-民權,2024-06-26,9312
2331,精英,9,0,9,華南永昌-民權,2024-06-26,9312
0056,元大高股息,8,0,8,華南永昌-民權,2024-06-26,9312
1325,恆大,8,0,8,華南永昌-民權,2024-06-26,9312
1709,和益,10,2,8,華南永昌-民權,2024-06-26,9312
3374,精材,14,6,8,華南永昌-民權,2024-06-26,9312
00878,國泰永續高股息,7,0,7,華南永昌-民權,2024-06-26,9312
2324,仁寶,8,1,7,華南永昌-民權,2024-06-26,9312
2548,華固,7,0,7,華南永昌-民權,2024-06-26,9312
6695,芯鼎,8,1,7,華南永昌-民權,2024-06-26,9312
2412,中華電,7,0,7,華南永昌-民權,2024-06-26,9312
1609,大亞,51,45,6,華南永昌-民權,2024-06-26,9312
00918,大華優利高填息30,8,2,6,華南永昌-民權,2024-06-26,9312
00882,中信中國高股息,6,0,6,華南永昌-民權,2024-06-26,9312
1815,富喬,6,0,6,華南永昌-民權,2024-06-26,9312
2441,超豐,6,0,6,華南永昌-民權,2024-06-26,9312
2515,中工,9,3,6,華南永昌-民權,2024-06-26,9312
2903,遠百,6,0,6,華南永昌-民權,2024-06-26,9312
8033,雷虎,6,0,6,華南永昌-民權,2024-06-26,9312
1785,光洋科,21,15,6,華南永昌-民權,2024-06-26,9312
2356,英業達,913,11,902,華南永昌-民權,2024-06-27,9312
3450,聯鈞,118,6,112,華南永昌-民權,2024-06-27,9312
00939,統一台灣高息動能,61,0,61,華南永昌-民權,2024-06-27,9312
6706,惠特,60,0,60,華南永昌-民權,2024-06-27,9312
3481,群創,54,2,52,華南永昌-民權,2024-06-27,9312
00936,台新永續高息中小,53,17,36,華南永昌-民權,2024-06-27,9312
2885,元大金,38,7,31,華南永昌-民權,2024-06-27,9312
3062,建漢,26,3,23,華南永昌-民權,2024-06-27,9312
6026,福邦證,20,0,20,華南永昌-民權,2024-06-27,9312
1301,台塑,18,0,18,華南永昌-民權,2024-06-27,9312
1303,南亞,18,0,18,華南永昌-民權,2024-06-27,9312
2371,大同,31,14,17,華南永昌-民權,2024-06-27,9312
3047,訊舟,42,26,16,華南永昌-民權,2024-06-27,9312
00947,台新臺灣IC設計,15,0,15,華南永昌-民權,2024-06-27,9312
2409,友達,15,0,15,華南永昌-民權,2024-06-27,9312
1605,華新,14,0,14,華南永昌-民權,2024-06-27,9312
2324,仁寶,14,0,14,華南永昌-民權,2024-06-27,9312
2515,中工,14,0,14,華南永昌-民權,2024-06-27,9312
8358,金居,14,0,14,華南永昌-民權,2024-06-27,9312
00946,群益科技高息成長,13,0,13,華南永昌-民權,2024-06-27,9312
2883,凱基金,13,0,13,華南永昌-民權,2024-06-27,9312
8114,振樺電,12,0,12,華南永昌-民權,2024-06-27,9312
1326,台化,11,0,11,華南永昌-民權,2024-06-27,9312
1709,和益,13,2,11,華南永昌-民權,2024-06-27,9312
6152,百一,11,0,11,華南永昌-民權,2024-06-27,9312
6806,森崴能源,28,17,11,華南永昌-民權,2024-06-27,9312
4167,松瑞藥,14,3,11,華南永昌-民權,2024-06-27,9312
00882,中信中國高股息,10,0,10,華南永昌-民權,2024-06-27,9312
00637L,元大滬深300正2,10,0,10,華南永昌-民權,2024-06-27,9312
1615,大山,10,0,10,華南永昌-民權,2024-06-27,9312
2323,中環,10,0,10,華南永昌-民權,2024-06-27,9312
2836,高雄銀,10,0,10,華南永昌-民權,2024-06-27,9312
5340,建榮,10,0,10,華南永昌-民權,2024-06-27,9312
6190,萬泰科,10,0,10,華南永昌-民權,2024-06-27,9312
2303,聯電,11,1,10,華南永昌-民權,2024-06-27,9312
00679B,元大美債20年,11,2,9,華南永昌-民權,2024-06-27,9312
00919,群益台灣精選高息,10,1,9,華南永昌-民權,2024-06-27,9312
2331,精英,10,1,9,華南永昌-民權,2024-06-27,9312
1319,東陽,8,0,8,華南永昌-民權,2024-06-27,9312
3036,文曄,8,0,8,華南永昌-民權,2024-06-27,9312
4571,鈞興-KY,8,0,8,華南永昌-民權,2024-06-27,9312
6160,欣技,10,2,8,華南永昌-民權,2024-06-27,9312
8926,台汽電,10,2,8,華南永昌-民權,2024-06-27,9312
00933B,國泰10Y+金融債,7,0,7,華南永昌-民權,2024-06-27,9312
3607,谷崧,7,0,7,華南永昌-民權,2024-06-27,9312
8028,昇陽半導體,13,6,7,華南永昌-民權,2024-06-27,9312
8072,陞泰,7,0,7,華南永昌-民權,2024-06-27,9312
912000,晨訊科-DR,47,40,7,華南永昌-民權,2024-06-27,9312
9955,佳龍,7,0,7,華南永昌-民權,2024-06-27,9312
3583,辛耘,8,2,6,華南永昌-民權,2024-06-27,9312
2356,英業達,579,7,572,華南永昌-民權,2024-06-28,9312
00712,復華富時不動產,212,10,202,華南永昌-民權,2024-06-28,9312
6706,惠特,140,0,140,華南永昌-民權,2024-06-28,9312
00929,復華台灣科技優息,139,0,139,華南永昌-民權,2024-06-28,9312
00937B,群益ESG投等債20,112,6,106,華南永昌-民權,2024-06-28,9312
3062,建漢,51,5,46,華南永昌-民權,2024-06-28,9312
3450,聯鈞,61,17,44,華南永昌-民權,2024-06-28,9312
00948B,中信優息投資級債,20,0,20,華南永昌-民權,2024-06-28,9312
1440,南紡,20,0,20,華南永昌-民權,2024-06-28,9312
3576,聯合再生,51,31,20,華南永昌-民權,2024-06-28,9312
9105,泰金寶-DR,22,2,20,華南永昌-民權,2024-06-28,9312
1319,東陽,19,0,19,華南永昌-民權,2024-06-28,9312
6244,茂迪,25,7,18,華南永昌-民權,2024-06-28,9312
00936,台新永續高息中小,25,8,17,華南永昌-民權,2024-06-28,9312
8050,廣積,16,0,16,華南永昌-民權,2024-06-28,9312
3088,艾訊,15,0,15,華南永昌-民權,2024-06-28,9312
6284,佳邦,16,1,15,華南永昌-民權,2024-06-28,9312
2002,中鋼,14,0,14,華南永昌-民權,2024-06-28,9312
1815,富喬,13,1,12,華南永昌-民權,2024-06-28,9312
8112,至上,21,10,11,華南永昌-民權,2024-06-28,9312
00946,群益科技高息成長,10,0,10,華南永昌-民權,2024-06-28,9312
2408,南亞科,10,0,10,華南永昌-民權,2024-06-28,9312
5508,永信建,11,2,9,華南永昌-民權,2024-06-28,9312
6770,力積電,10,1,9,華南永昌-民權,2024-06-28,9312
2449,京元電子,11,2,9,華南永昌-民權,2024-06-28,9312
3481,群創,10,1,9,華南永昌-民權,2024-06-28,9312
00679B,元大美債20年,10,2,8,華南永昌-民權,2024-06-28,9312
6443,元晶,17,9,8,華南永昌-民權,2024-06-28,9312
1614,三洋電,8,0,8,華南永昌-民權,2024-06-28,9312
6140,訊達,8,0,8,華南永昌-民權,2024-06-28,9312
2211,長榮鋼,7,0,7,華南永昌-民權,2024-06-28,9312
2353,宏��,11,4,7,華南永昌-民權,2024-06-28,9312
6477,安集,12,5,7,華南永昌-民權,2024-06-28,9312
8064,東捷,9,2,7,華南永昌-民權,2024-06-28,9312
2609,陽明,12,6,6,華南永昌-民權,2024-06-28,9312
2883,凱基金,18,12,6,華南永昌-民權,2024-06-28,9312
00933B,國泰10Y+金融債,5,0,5,華南永昌-民權,2024-06-28,9312
1409,新纖,5,0,5,華南永昌-民權,2024-06-28,9312
1410,南染,5,0,5,華南永昌-民權,2024-06-28,9312
1522,堤維西,7,2,5,華南永昌-民權,2024-06-28,9312
2607,榮運,5,0,5,華南永昌-民權,2024-06-28,9312
3202,樺晟,5,0,5,華南永昌-民權,2024-06-28,9312
3498,陽程,6,1,5,華南永昌-民權,2024-06-28,9312
4510,高鋒,5,0,5,華南永昌-民權,2024-06-28,9312
4726,永昕,9,4,5,華南永昌-民權,2024-06-28,9312
5234,達興材料,5,0,5,華南永昌-民權,2024-06-28,9312
5302,太欣,5,0,5,華南永昌-民權,2024-06-28,9312
8210,勤誠,6,1,5,華南永昌-民權,2024-06-28,9312
2618,長榮航,8,3,5,華南永昌-民權,2024-06-28,9312
2303,聯電,9,4,5,華南永昌-民權,2024-06-28,9312
2356,英業達,1483,1,1482,華南永昌-民權,2024-07-01,9312
00639,富邦深100,200,0,200,華南永昌-民權,2024-07-01,9312
2883,凱基金,100,3,97,華南永昌-民權,2024-07-01,9312
2002,中鋼,104,22,82,華南永昌-民權,2024-07-01,9312
9925,新保,62,0,62,華南永昌-民權,2024-07-01,9312
00740B,富邦全球投等債,30,0,30,華南永昌-民權,2024-07-01,9312
00937B,群益ESG投等債20,26,0,26,華南永昌-民權,2024-07-01,9312
0056,元大高股息,25,0,25,華南永昌-民權,2024-07-01,9312
00687B,國泰20年美債,25,0,25,華南永昌-民權,2024-07-01,9312
2337,旺宏,59,36,23,華南永昌-民權,2024-07-01,9312
2820,華票,21,0,21,華南永昌-民權,2024-07-01,9312
3673,TPK-KY,20,0,20,華南永昌-民權,2024-07-01,9312
9103,美德醫療-DR,20,0,20,華南永昌-民權,2024-07-01,9312
3211,順達,19,2,17,華南永昌-民權,2024-07-01,9312
00919,群益台灣精選高息,20,4,16,華南永昌-民權,2024-07-01,9312
3081,聯亞,25,10,15,華南永昌-民權,2024-07-01,9312
3576,聯合再生,19,4,15,華南永昌-民權,2024-07-01,9312
00936,台新永續高息中小,24,11,13,華南永昌-民權,2024-07-01,9312
2368,金像電,16,3,13,華南永昌-民權,2024-07-01,9312
00679B,元大美債20年,12,0,12,華南永昌-民權,2024-07-01,9312
1609,大亞,12,0,12,華南永昌-民權,2024-07-01,9312
2374,佳能,12,0,12,華南永昌-民權,2024-07-01,9312
006208,富邦台50,11,0,11,華南永昌-民權,2024-07-01,9312
6290,良維,16,6,10,華南永昌-民權,2024-07-01,9312
00633L,富邦上証正2,10,0,10,華南永昌-民權,2024-07-01,9312
1409,新纖,10,0,10,華南永昌-民權,2024-07-01,9312
1410,南染,10,0,10,華南永昌-民權,2024-07-01,9312
2362,藍天,10,0,10,華南永昌-民權,2024-07-01,9312
2379,瑞昱,10,0,10,華南永昌-民權,2024-07-01,9312
6160,欣技,10,0,10,華南永昌-民權,2024-07-01,9312
912000,晨訊科-DR,20,10,10,華南永昌-民權,2024-07-01,9312
2324,仁寶,14,5,9,華南永昌-民權,2024-07-01,9312
2369,菱生,10,1,9,華南永昌-民權,2024-07-01,9312
3057,喬鼎,10,1,9,華南永昌-民權,2024-07-01,9312
2897A,王道銀甲特,8,0,8,華南永昌-民權,2024-07-01,9312
5534,長虹,8,0,8,華南永昌-民權,2024-07-01,9312
6284,佳邦,10,2,8,華南永昌-民權,2024-07-01,9312
6443,元晶,9,2,7,華南永昌-民權,2024-07-01,9312
00933B,國泰10Y+金融債,7,0,7,華南永昌-民權,2024-07-01,9312
1587,吉茂,8,1,7,華南永昌-民權,2024-07-01,9312
2367,燿華,13,6,7,華南永昌-民權,2024-07-01,9312
2421,建準,7,0,7,華南永昌-民權,2024-07-01,9312
6753,龍德造船,10,4,6,華南永昌-民權,2024-07-01,9312
1414,東和,11,5,6,華南永昌-民權,2024-07-01,9312
1467,南緯,6,0,6,華南永昌-民權,2024-07-01,9312
2031,新光鋼,6,0,6,華南永昌-民權,2024-07-01,9312
3419,譁裕,6,0,6,華南永昌-民權,2024-07-01,9312
6226,光鼎,10,4,6,華南永昌-民權,2024-07-01,9312
8071,能率網通,7,1,6,華南永昌-民權,2024-07-01,9312
3615,安可,6,0,6,華南永昌-民權,2024-07-01,9312
00934,中信成長高股息,157,1,156,華南永昌-民權,2024-07-02,9312
00687B,國泰20年美債,127,0,127,華南永昌-民權,2024-07-02,9312
00937B,群益ESG投等債20,74,0,74,華南永昌-民權,2024-07-02,9312
2002,中鋼,61,0,61,華南永昌-民權,2024-07-02,9312
00929,復華台灣科技優息,79,29,50,華南永昌-民權,2024-07-02,9312
9105,泰金寶-DR,47,0,47,華南永昌-民權,2024-07-02,9312
6257,矽格,41,0,41,華南永昌-民權,2024-07-02,9312
2303,聯電,42,2,40,華南永昌-民權,2024-07-02,9312
00936,台新永續高息中小,67,27,40,華南永昌-民權,2024-07-02,9312
0056,元大高股息,35,0,35,華南永昌-民權,2024-07-02,9312
6706,惠特,75,40,35,華南永昌-民權,2024-07-02,9312
2349,錸德,37,3,34,華南永昌-民權,2024-07-02,9312
00680L,元大美債20正2,32,0,32,華南永昌-民權,2024-07-02,9312
3450,聯鈞,31,1,30,華南永昌-民權,2024-07-02,9312
3481,群創,31,1,30,華南永昌-民權,2024-07-02,9312
6160,欣技,30,0,30,華南永昌-民權,2024-07-02,9312
2353,宏��,24,3,21,華南永昌-民權,2024-07-02,9312
00753L,中信中國50正2,20,0,20,華南永昌-民權,2024-07-02,9312
3673,TPK-KY,20,0,20,華南永昌-民權,2024-07-02,9312
5351,鈺創,20,0,20,華南永昌-民權,2024-07-02,9312
2408,南亞科,24,5,19,華南永昌-民權,2024-07-02,9312
2324,仁寶,16,0,16,華南永昌-民權,2024-07-02,9312
3686,達能,16,0,16,華南永昌-民權,2024-07-02,9312
00939,統一台灣高息動能,22,6,16,華南永昌-民權,2024-07-02,9312
9945,潤泰新,15,0,15,華南永昌-民權,2024-07-02,9312
3059,華晶科,15,0,15,華南永昌-民權,2024-07-02,9312
00679B,元大美債20年,15,0,15,華南永昌-民權,2024-07-02,9312
2208,台船,15,0,15,華南永昌-民權,2024-07-02,9312
2329,華泰,15,0,15,華南永昌-民權,2024-07-02,9312
2371,大同,16,1,15,華南永昌-民權,2024-07-02,9312
4526,東台,36,21,15,華南永昌-民權,2024-07-02,9312
6782,視陽,14,0,14,華南永昌-民權,2024-07-02,9312
00940,元大台灣價值高息,31,17,14,華南永昌-民權,2024-07-02,9312
1301,台塑,24,10,14,華南永昌-民權,2024-07-02,9312
1440,南紡,14,0,14,華南永昌-民權,2024-07-02,9312
1326,台化,14,1,13,華南永昌-民權,2024-07-02,9312
1215,卜蜂,12,0,12,華南永昌-民權,2024-07-02,9312
2354,鴻準,20,8,12,華南永昌-民權,2024-07-02,9312
6126,信音,12,0,12,華南永昌-民權,2024-07-02,9312
00923,群益台ESG低碳50,11,0,11,華南永昌-民權,2024-07-02,9312
1815,富喬,24,13,11,華南永昌-民權,2024-07-02,9312
6177,達麗,11,0,11,華南永昌-民權,2024-07-02,9312
3711,日月光投控,10,0,10,華南永昌-民權,2024-07-02,9312
00696B,富邦美債20年,10,0,10,華南永昌-民權,2024-07-02,9312
00795B,中信美國公債20年,10,0,10,華南永昌-民權,2024-07-02,9312
1409,新纖,10,0,10,華南永昌-民權,2024-07-02,9312
2101,南港,13,3,10,華南永昌-民權,2024-07-02,9312
3380,明泰,13,3,10,華南永昌-民權,2024-07-02,9312
5302,太欣,10,0,10,華南永昌-民權,2024-07-02,9312
5871,中租-KY,10,0,10,華南永昌-民權,2024-07-02,9312
00934,中信成長高股息,609,0,609,華南永昌-民權,2024-07-03,9312
00937B,群益ESG投等債20,341,19,322,華南永昌-民權,2024-07-03,9312
00927,群益半導體收益,207,2,205,華南永昌-民權,2024-07-03,9312
00933B,國泰10Y+金融債,122,1,121,華南永昌-民權,2024-07-03,9312
2002,中鋼,109,2,107,華南永昌-民權,2024-07-03,9312
2356,英業達,104,6,98,華南永昌-民權,2024-07-03,9312
1444,力麗,100,10,90,華南永昌-民權,2024-07-03,9312
8064,東捷,65,2,63,華南永昌-民權,2024-07-03,9312
1447,力鵬,51,0,51,華南永昌-民權,2024-07-03,9312
8927,北基,45,0,45,華南永昌-民權,2024-07-03,9312
00905,FT臺灣Smart,41,0,41,華南永昌-民權,2024-07-03,9312
6216,居易,40,0,40,華南永昌-民權,2024-07-03,9312
9105,泰金寶-DR,42,5,37,華南永昌-民權,2024-07-03,9312
2883,凱基金,116,79,37,華南永昌-民權,2024-07-03,9312
1409,新纖,35,0,35,華南永昌-民權,2024-07-03,9312
2468,華經,30,0,30,華南永昌-民權,2024-07-03,9312
6449,鈺邦,31,2,29,華南永昌-民權,2024-07-03,9312
6706,惠特,30,2,28,華南永昌-民權,2024-07-03,9312
2727,王品,24,0,24,華南永昌-民權,2024-07-03,9312
00688L,國泰20年美債正2,22,0,22,華南永昌-民權,2024-07-03,9312
4960,誠美材,20,0,20,華南永昌-民權,2024-07-03,9312
6282,康舒,26,7,19,華南永昌-民權,2024-07-03,9312
2429,銘旺科,16,0,16,華南永昌-民權,2024-07-03,9312
5230,雷笛克光學,16,0,16,華南永昌-民權,2024-07-03,9312
6244,茂迪,18,2,16,華南永昌-民權,2024-07-03,9312
6443,元晶,22,7,15,華南永昌-民權,2024-07-03,9312
3481,群創,20,5,15,華南永昌-民權,2024-07-03,9312
3047,訊舟,33,21,12,華南永昌-民權,2024-07-03,9312
3062,建漢,12,1,11,華南永昌-民權,2024-07-03,9312
00687B,國泰20年美債,19,8,11,華南永昌-民權,2024-07-03,9312
2317,鴻海,17,6,11,華南永昌-民權,2024-07-03,9312
00850,元大臺灣ESG永續,10,0,10,華南永昌-民權,2024-07-03,9312
00772B,中信高評級公司債,10,0,10,華南永昌-民權,2024-07-03,9312
00945B,凱基美國非投等債,10,0,10,華南永昌-民權,2024-07-03,9312
00947,台新臺灣IC設計,10,0,10,華南永昌-民權,2024-07-03,9312
2461,光群雷,10,0,10,華南永昌-民權,2024-07-03,9312
3059,華晶科,13,3,10,華南永昌-民權,2024-07-03,9312
8096,擎亞,10,0,10,華南永昌-民權,2024-07-03,9312
2889,國票金,16,6,10,華南永昌-民權,2024-07-03,9312
00725B,國泰投資級公司債,9,0,9,華南永昌-民權,2024-07-03,9312
00946,群益科技高息成長,9,0,9,華南永昌-民權,2024-07-03,9312
2303,聯電,9,0,9,華南永昌-民權,2024-07-03,9312
5871,中租-KY,10,2,8,華南永昌-民權,2024-07-03,9312
00918,大華優利高填息30,8,0,8,華南永昌-民權,2024-07-03,9312
2323,中環,46,38,8,華南永昌-民權,2024-07-03,9312
00679B,元大美債20年,7,0,7,華南永昌-民權,2024-07-03,9312
2915,潤泰全,12,5,7,華南永昌-民權,2024-07-03,9312
00942B,台新美A公司債20+,8,1,7,華南永昌-民權,2024-07-03,9312
2338,光罩,7,0,7,華南永昌-民權,2024-07-03,9312
2353,宏��,7,0,7,華南永昌-民權,2024-07-03,9312
6160,欣技,104,0,104,華南永昌-民權,2024-07-04,9312
6127,九豪,56,5,51,華南永昌-民權,2024-07-04,9312
8114,振樺電,130,80,50,華南永昌-民權,2024-07-04,9312
3049,精金,57,15,42,華南永昌-民權,2024-07-04,9312
00885,富邦越南,35,7,28,華南永昌-民權,2024-07-04,9312
5347,世界,33,6,27,華南永昌-民權,2024-07-04,9312
00637L,元大滬深300正2,95,70,25,華南永昌-民權,2024-07-04,9312
9105,泰金寶-DR,31,7,24,華南永昌-民權,2024-07-04,9312
3058,立德,23,0,23,華南永昌-民權,2024-07-04,9312
1447,力鵬,22,1,21,華南永昌-民權,2024-07-04,9312
2472,立隆電,21,0,21,華南永昌-民權,2024-07-04,9312
6173,信昌電,20,0,20,華南永昌-民權,2024-07-04,9312
1815,富喬,20,1,19,華南永昌-民權,2024-07-04,9312
2023,燁輝,19,0,19,華南永昌-民權,2024-07-04,9312
2405,輔信,42,25,17,華南永昌-民權,2024-07-04,9312
00919,群益台灣精選高息,16,0,16,華南永昌-民權,2024-07-04,9312
00934,中信成長高股息,18,3,15,華南永昌-民權,2024-07-04,9312
3047,訊舟,22,7,15,華南永昌-民權,2024-07-04,9312
8383,千附,15,1,14,華南永昌-民權,2024-07-04,9312
2482,連宇,19,6,13,華南永昌-民權,2024-07-04,9312
3591,艾笛森,13,0,13,華南永昌-民權,2024-07-04,9312
4906,正文,12,0,12,華南永昌-民權,2024-07-04,9312
4976,佳凌,14,2,12,華南永昌-民權,2024-07-04,9312
2401,凌陽,18,7,11,華南永昌-民權,2024-07-04,9312
2883,凱基金,18,7,11,華南永昌-民權,2024-07-04,9312
2615,萬海,30,20,10,華南永昌-民權,2024-07-04,9312
1410,南染,10,0,10,華南永昌-民權,2024-07-04,9312
2609,陽明,19,9,10,華南永昌-民權,2024-07-04,9312
3016,嘉晶,10,0,10,華南永昌-民權,2024-07-04,9312
3149,正達,10,0,10,華南永昌-民權,2024-07-04,9312
3338,泰碩,10,0,10,華南永昌-民權,2024-07-04,9312
5519,隆大,10,0,10,華南永昌-民權,2024-07-04,9312
2892,第一金,10,0,10,華南永昌-民權,2024-07-04,9312
2354,鴻準,19,10,9,華南永昌-民權,2024-07-04,9312
2302,麗正,10,1,9,華南永昌-民權,2024-07-04,9312
6182,合晶,12,3,9,華南永昌-民權,2024-07-04,9312
2617,台航,8,0,8,華南永昌-民權,2024-07-04,9312
00927,群益半導體收益,8,0,8,華南永昌-民權,2024-07-04,9312
2353,宏��,16,8,8,華南永昌-民權,2024-07-04,9312
2489,瑞軒,9,1,8,華南永昌-民權,2024-07-04,9312
1101,台泥,10,2,8,華南永昌-民權,2024-07-04,9312
4571,鈞興-KY,10,3,7,華南永昌-民權,2024-07-04,9312
6451,訊芯-KY,7,0,7,華南永昌-民權,2024-07-04,9312
2412,中華電,6,0,6,華南永昌-民權,2024-07-04,9312
3481,群創,75,69,6,華南永昌-民權,2024-07-04,9312
2349,錸德,6,0,6,華南永昌-民權,2024-07-04,9312
2888,新光金,18,12,6,華南永昌-民權,2024-07-04,9312
3312,弘憶股,10,4,6,華南永昌-民權,2024-07-04,9312
3520,華盈,6,0,6,華南永昌-民權,2024-07-04,9312
3615,安可,8,2,6,華南永昌-民權,2024-07-04,9312
2356,英業達,523,26,497,華南永昌-民權,2024-07-05,9312
00639,富邦深100,250,0,250,華南永昌-民權,2024-07-05,9312
3450,聯鈞,101,11,90,華南永昌-民權,2024-07-05,9312
6706,惠特,85,10,75,華南永昌-民權,2024-07-05,9312
3105,穩懋,62,0,62,華南永昌-民權,2024-07-05,9312
2897,王道銀行,201,153,48,華南永昌-民權,2024-07-05,9312
2615,萬海,40,0,40,華南永昌-民權,2024-07-05,9312
3652,精聯,38,0,38,華南永昌-民權,2024-07-05,9312
00679B,元大美債20年,34,0,34,華南永昌-民權,2024-07-05,9312
00946,群益科技高息成長,22,0,22,華南永昌-民權,2024-07-05,9312
0056,元大高股息,21,0,21,華南永昌-民權,2024-07-05,9312
00934,中信成長高股息,20,0,20,華南永昌-民權,2024-07-05,9312
6288,聯嘉,20,1,19,華南永昌-民權,2024-07-05,9312
2618,長榮航,21,3,18,華南永昌-民權,2024-07-05,9312
3037,欣興,19,2,17,華南永昌-民權,2024-07-05,9312
00927,群益半導體收益,16,0,16,華南永昌-民權,2024-07-05,9312
2888,新光金,17,1,16,華南永昌-民權,2024-07-05,9312
8112,至上,17,1,16,華南永昌-民權,2024-07-05,9312
5902,德記,15,0,15,華南永昌-民權,2024-07-05,9312
2609,陽明,18,5,13,華南永昌-民權,2024-07-05,9312
1447,力鵬,26,13,13,華南永昌-民權,2024-07-05,9312
2329,華泰,14,1,13,華南永昌-民權,2024-07-05,9312
6451,訊芯-KY,14,1,13,華南永昌-民權,2024-07-05,9312
1504,東元,13,1,12,華南永昌-民權,2024-07-05,9312
1809,中釉,13,1,12,華南永昌-民權,2024-07-05,9312
2472,立隆電,12,0,12,華南永昌-民權,2024-07-05,9312
6770,力積電,12,0,12,華南永昌-民權,2024-07-05,9312
2317,鴻海,16,5,11,華南永昌-民權,2024-07-05,9312
1326,台化,11,0,11,華南永昌-民權,2024-07-05,9312
3323,加百裕,11,0,11,華南永昌-民權,2024-07-05,9312
3576,聯合再生,16,5,11,華南永昌-民權,2024-07-05,9312
00905,FT臺灣Smart,10,0,10,華南永昌-民權,2024-07-05,9312
2887,台新金,10,0,10,華南永昌-民權,2024-07-05,9312
3025,星通,10,0,10,華南永昌-民權,2024-07-05,9312
3229,晟鈦,10,0,10,華南永昌-民權,2024-07-05,9312
3537,堡達,10,0,10,華南永昌-民權,2024-07-05,9312
4561,健椿,21,11,10,華南永昌-民權,2024-07-05,9312
4563,百德,10,0,10,華南永昌-民權,2024-07-05,9312
8277,商丞,10,0,10,華南永昌-民權,2024-07-05,9312
5475,德宏,10,0,10,華南永昌-民權,2024-07-05,9312
2537,聯上發,10,1,9,華南永昌-民權,2024-07-05,9312
3492,長盛,9,0,9,華南永昌-民權,2024-07-05,9312
3580,友威科,26,18,8,華南永昌-民權,2024-07-05,9312
00735,國泰臺韓科技,8,0,8,華南永昌-民權,2024-07-05,9312
3455,由田,10,2,8,華南永昌-民權,2024-07-05,9312
2867,三商壽,10,2,8,華南永昌-民權,2024-07-05,9312
2301,光寶科,13,6,7,華南永昌-民權,2024-07-05,9312
2603,長榮,11,4,7,華南永昌-民權,2024-07-05,9312
2353,宏��,13,6,7,華南永昌-民權,2024-07-05,9312
3213,茂訊,7,0,7,華南永昌-民權,2024-07-05,9312
3652,精聯,99,9,90,華南永昌-民權,2024-07-08,9312
00687B,國泰20年美債,51,0,51,華南永昌-民權,2024-07-08,9312
2618,長榮航,32,0,32,華南永昌-民權,2024-07-08,9312
3058,立德,31,0,31,華南永昌-民權,2024-07-08,9312
8039,台虹,33,2,31,華南永昌-民權,2024-07-08,9312
00680L,元大美債20正2,30,1,29,華南永昌-民權,2024-07-08,9312
1815,富喬,39,10,29,華南永昌-民權,2024-07-08,9312
912000,晨訊科-DR,67,40,27,華南永昌-民權,2024-07-08,9312
2365,昆盈,131,107,24,華南永昌-民權,2024-07-08,9312
2609,陽明,32,11,21,華南永昌-民權,2024-07-08,9312
3680,家登,20,0,20,華南永昌-民權,2024-07-08,9312
2454,聯發科,20,0,20,華南永昌-民權,2024-07-08,9312
2610,華航,26,7,19,華南永昌-民權,2024-07-08,9312
3363,上詮,45,26,19,華南永昌-民權,2024-07-08,9312
6290,良維,19,0,19,華南永昌-民權,2024-07-08,9312
3033,威健,21,3,18,華南永昌-民權,2024-07-08,9312
2101,南港,30,13,17,華南永昌-民權,2024-07-08,9312
2427,三商電,21,4,17,華南永昌-民權,2024-07-08,9312
1110,東泥,16,0,16,華南永昌-民權,2024-07-08,9312
2603,長榮,29,13,16,華南永昌-民權,2024-07-08,9312
2355,敬鵬,17,2,15,華南永昌-民權,2024-07-08,9312
3437,榮創,15,0,15,華南永昌-民權,2024-07-08,9312
3576,聯合再生,20,5,15,華南永昌-民權,2024-07-08,9312
2615,萬海,48,33,15,華南永昌-民權,2024-07-08,9312
9958,世紀鋼,12,0,12,華南永昌-民權,2024-07-08,9312
5392,能率,21,9,12,華南永昌-民權,2024-07-08,9312
2330,台積電,17,5,12,華南永昌-民權,2024-07-08,9312
1409,新纖,19,8,11,華南永昌-民權,2024-07-08,9312
2369,菱生,13,2,11,華南永昌-民權,2024-07-08,9312
00934,中信成長高股息,10,0,10,華南永昌-民權,2024-07-08,9312
1104,環泥,10,0,10,華南永昌-民權,2024-07-08,9312
2371,大同,16,6,10,華南永昌-民權,2024-07-08,9312
2501,國建,10,0,10,華南永昌-民權,2024-07-08,9312
2612,中航,10,0,10,華南永昌-民權,2024-07-08,9312
3081,聯亞,10,0,10,華南永昌-民權,2024-07-08,9312
3149,正達,10,0,10,華南永昌-民權,2024-07-08,9312
3346,麗清,10,0,10,華南永昌-民權,2024-07-08,9312
3607,谷崧,13,3,10,華南永昌-民權,2024-07-08,9312
6148,驊宏資,10,0,10,華南永昌-民權,2024-07-08,9312
6153,嘉聯益,31,21,10,華南永昌-民權,2024-07-08,9312
6451,訊芯-KY,13,3,10,華南永昌-民權,2024-07-08,9312
3491,昇達科,9,0,9,華南永昌-民權,2024-07-08,9312
4906,正文,19,10,9,華南永昌-民權,2024-07-08,9312
6126,信音,9,0,9,華南永昌-民權,2024-07-08,9312
1785,光洋科,39,30,9,華南永昌-民權,2024-07-08,9312
00919,群益台灣精選高息,14,6,8,華南永昌-民權,2024-07-08,9312
00905,FT臺灣Smart,10,2,8,華南永昌-民權,2024-07-08,9312
0056,元大高股息,8,0,8,華南永昌-民權,2024-07-08,9312
2548,華固,8,0,8,華南永昌-民權,2024-07-08,9312
5328,華容,12,4,8,華南永昌-民權,2024-07-08,9312
2888,新光金,4111,356,3755,華南永昌-民權,2024-07-09,9312
00934,中信成長高股息,1995,1,1994,華南永昌-民權,2024-07-09,9312
00632R,元大台灣50反1,400,0,400,華南永昌-民權,2024-07-09,9312
2897,王道銀行,619,250,369,華南永昌-民權,2024-07-09,9312
00918,大華優利高填息30,190,0,190,華南永昌-民權,2024-07-09,9312
2356,英業達,202,14,188,華南永昌-民權,2024-07-09,9312
6706,惠特,255,100,155,華南永昌-民權,2024-07-09,9312
2374,佳能,206,104,102,華南永昌-民權,2024-07-09,9312
8011,台通,57,1,56,華南永昌-民權,2024-07-09,9312
3019,亞光,50,0,50,華南永昌-民權,2024-07-09,9312
3652,精聯,49,8,41,華南永昌-民權,2024-07-09,9312
2317,鴻海,57,21,36,華南永昌-民權,2024-07-09,9312
1615,大山,30,0,30,華南永昌-民權,2024-07-09,9312
4563,百德,30,0,30,華南永昌-民權,2024-07-09,9312
3450,聯鈞,33,3,30,華南永昌-民權,2024-07-09,9312
00929,復華台灣科技優息,29,1,28,華南永昌-民權,2024-07-09,9312
3481,群創,78,51,27,華南永昌-民權,2024-07-09,9312
00936,台新永續高息中小,57,31,26,華南永昌-民權,2024-07-09,9312
2344,華邦電,28,2,26,華南永昌-民權,2024-07-09,9312
2303,聯電,37,11,26,華南永昌-民權,2024-07-09,9312
2349,錸德,25,0,25,華南永昌-民權,2024-07-09,9312
2889,國票金,25,0,25,華南永昌-民權,2024-07-09,9312
3363,上詮,45,20,25,華南永昌-民權,2024-07-09,9312
6163,華電網,25,0,25,華南永昌-民權,2024-07-09,9312
4306,炎洲,23,0,23,華南永昌-民權,2024-07-09,9312
00881,國泰台灣5G+,22,0,22,華南永昌-民權,2024-07-09,9312
1319,東陽,21,0,21,華南永昌-民權,2024-07-09,9312
00687B,國泰20年美債,20,0,20,華南永昌-民權,2024-07-09,9312
8110,華東,20,0,20,華南永昌-民權,2024-07-09,9312
2809,京城銀,20,0,20,華南永昌-民權,2024-07-09,9312
5328,華容,20,1,19,華南永昌-民權,2024-07-09,9312
1785,光洋科,35,18,17,華南永昌-民權,2024-07-09,9312
3062,建漢,20,3,17,華南永昌-民權,2024-07-09,9312
9105,泰金寶-DR,122,105,17,華南永昌-民權,2024-07-09,9312
2891,中信金,17,1,16,華南永昌-民權,2024-07-09,9312
2449,京元電子,33,19,14,華南永昌-民權,2024-07-09,9312
6005,群益證,13,0,13,華南永昌-民權,2024-07-09,9312
2615,萬海,20,7,13,華南永昌-民權,2024-07-09,9312
2867,三商壽,13,0,13,華南永昌-民權,2024-07-09,9312
6834,天二科技,13,0,13,華南永昌-民權,2024-07-09,9312
2610,華航,14,2,12,華南永昌-民權,2024-07-09,9312
2367,燿華,55,43,12,華南永昌-民權,2024-07-09,9312
3211,順達,11,0,11,華南永昌-民權,2024-07-09,9312
1217,愛之味,11,0,11,華南永昌-民權,2024-07-09,9312
2353,宏��,27,16,11,華南永昌-民權,2024-07-09,9312
2419,仲琦,11,0,11,華南永昌-民權,2024-07-09,9312
6153,嘉聯益,11,0,11,華南永昌-民權,2024-07-09,9312
00631L,元大台灣50正2,11,1,10,華南永昌-民權,2024-07-09,9312
00633L,富邦上証正2,10,0,10,華南永昌-民權,2024-07-09,9312
1316,上曜,10,0,10,華南永昌-民權,2024-07-09,9312
2101,南港,540,0,540,華南永昌-民權,2024-07-10,9312
2102,泰豐,160,0,160,華南永昌-民權,2024-07-10,9312
2002,中鋼,116,0,116,華南永昌-民權,2024-07-10,9312
2883,凱基金,105,29,76,華南永昌-民權,2024-07-10,9312
2884,玉山金,70,6,64,華南永昌-民權,2024-07-10,9312
6770,力積電,61,0,61,華南永昌-民權,2024-07-10,9312
00937B,群益ESG投等債20,55,11,44,華南永昌-民權,2024-07-10,9312
912000,晨訊科-DR,40,0,40,華南永昌-民權,2024-07-10,9312
2317,鴻海,40,2,38,華南永昌-民權,2024-07-10,9312
2897,王道銀行,81,50,31,華南永昌-民權,2024-07-10,9312
00878,國泰永續高股息,30,0,30,華南永昌-民權,2024-07-10,9312
8105,凌巨,30,0,30,華南永昌-民權,2024-07-10,9312
2609,陽明,34,4,30,華南永昌-民權,2024-07-10,9312
1618,合機,31,2,29,華南永昌-民權,2024-07-10,9312
6456,GIS-KY,23,0,23,華南永昌-民權,2024-07-10,9312
2509,全坤建,22,0,22,華南永昌-民權,2024-07-10,9312
4532,瑞智,20,0,20,華南永昌-民權,2024-07-10,9312
8111,立��,20,0,20,華南永昌-民權,2024-07-10,9312
2108,南帝,21,4,17,華南永昌-民權,2024-07-10,9312
1701,中化,16,0,16,華南永昌-民權,2024-07-10,9312
00934,中信成長高股息,14,0,14,華南永昌-民權,2024-07-10,9312
2489,瑞軒,29,15,14,華南永昌-民權,2024-07-10,9312
3652,精聯,30,17,13,華南永昌-民權,2024-07-10,9312
00939,統一台灣高息動能,11,0,11,華南永昌-民權,2024-07-10,9312
5340,建榮,11,0,11,華南永昌-民權,2024-07-10,9312
00679B,元大美債20年,10,0,10,華南永昌-民權,2024-07-10,9312
2887,台新金,10,0,10,華南永昌-民權,2024-07-10,9312
00927,群益半導體收益,10,0,10,華南永昌-民權,2024-07-10,9312
00950B,凱基A級公司債,10,0,10,華南永昌-民權,2024-07-10,9312
1615,大山,10,0,10,華南永昌-民權,2024-07-10,9312
2367,燿華,14,4,10,華南永昌-民權,2024-07-10,9312
2501,國建,10,0,10,華南永昌-民權,2024-07-10,9312
3019,亞光,12,2,10,華南永昌-民權,2024-07-10,9312
4707,磐亞,10,0,10,華南永昌-民權,2024-07-10,9312
4726,永昕,10,0,10,華南永昌-民權,2024-07-10,9312
6182,合晶,11,1,10,華南永昌-民權,2024-07-10,9312
2392,正崴,37,28,9,華南永昌-民權,2024-07-10,9312
2401,凌陽,13,4,9,華南永昌-民權,2024-07-10,9312
3455,由田,24,15,9,華南永昌-民權,2024-07-10,9312
4904,遠傳,9,0,9,華南永昌-民權,2024-07-10,9312
1809,中釉,11,3,8,華南永昌-民權,2024-07-10,9312
2867,三商壽,12,4,8,華南永昌-民權,2024-07-10,9312
2915,潤泰全,10,2,8,華南永昌-民權,2024-07-10,9312
3706,神達,10,2,8,華南永昌-民權,2024-07-10,9312
2834,臺企銀,8,0,8,華南永昌-民權,2024-07-10,9312
5347,世界,9,2,7,華南永昌-民權,2024-07-10,9312
2353,宏��,40,33,7,華南永昌-民權,2024-07-10,9312
1609,大亞,8,2,6,華南永昌-民權,2024-07-10,9312
5876,上海商銀,6,0,6,華南永昌-民權,2024-07-10,9312
1785,光洋科,30,24,6,華南永昌-民權,2024-07-10,9312
2888,新光金,321,120,201,華南永昌-民權,2024-07-11,9312
2374,佳能,200,60,140,華南永昌-民權,2024-07-11,9312
2356,英業達,214,81,133,華南永昌-民權,2024-07-11,9312
1314,中石化,110,60,50,華南永昌-民權,2024-07-11,9312
2867,三商壽,50,3,47,華南永昌-民權,2024-07-11,9312
2102,泰豐,42,0,42,華南永昌-民權,2024-07-11,9312
00725B,國泰投資級公司債,33,0,33,華南永昌-民權,2024-07-11,9312
5426,振發,31,1,30,華南永昌-民權,2024-07-11,9312
6282,康舒,35,10,25,華南永昌-民權,2024-07-11,9312
3356,奇偶,23,0,23,華南永昌-民權,2024-07-11,9312
1612,宏泰,24,2,22,華南永昌-民權,2024-07-11,9312
2408,南亞科,24,3,21,華南永昌-民權,2024-07-11,9312
00687B,國泰20年美債,20,0,20,華南永昌-民權,2024-07-11,9312
00934,中信成長高股息,20,0,20,華南永昌-民權,2024-07-11,9312
8112,至上,20,0,20,華南永昌-民權,2024-07-11,9312
912000,晨訊科-DR,35,15,20,華南永昌-民權,2024-07-11,9312
2371,大同,30,11,19,華南永昌-民權,2024-07-11,9312
6806,森崴能源,30,11,19,華南永昌-民權,2024-07-11,9312
1410,南染,18,0,18,華南永昌-民權,2024-07-11,9312
6127,九豪,20,3,17,華南永昌-民權,2024-07-11,9312
9105,泰金寶-DR,35,19,16,華南永昌-民權,2024-07-11,9312
1785,光洋科,30,15,15,華南永昌-民權,2024-07-11,9312
6226,光鼎,15,0,15,華南永昌-民權,2024-07-11,9312
8064,東捷,27,14,13,華南永昌-民權,2024-07-11,9312
6443,元晶,13,0,13,華南永昌-民權,2024-07-11,9312
6167,久正,11,0,11,華南永昌-民權,2024-07-11,9312
8103,瀚荃,11,0,11,華南永昌-民權,2024-07-11,9312
00676R,富邦臺灣加權反1,10,0,10,華南永昌-民權,2024-07-11,9312
00740B,富邦全球投等債,10,0,10,華南永昌-民權,2024-07-11,9312
1217,愛之味,10,0,10,華南永昌-民權,2024-07-11,9312
1532,勤美,10,0,10,華南永昌-民權,2024-07-11,9312
2419,仲琦,10,0,10,華南永昌-民權,2024-07-11,9312
3059,華晶科,10,0,10,華南永昌-民權,2024-07-11,9312
3607,谷崧,12,2,10,華南永昌-民權,2024-07-11,9312
4729,熒茂,10,0,10,華南永昌-民權,2024-07-11,9312
5328,華容,15,5,10,華南永昌-民權,2024-07-11,9312
1504,東元,9,0,9,華南永昌-民權,2024-07-11,9312
1326,台化,10,1,9,華南永昌-民權,2024-07-11,9312
1447,力鵬,22,13,9,華南永昌-民權,2024-07-11,9312
3308,聯德,9,0,9,華南永昌-民權,2024-07-11,9312
5272,笙科,14,5,9,華南永昌-民權,2024-07-11,9312
6265,方土昶,10,1,9,華南永昌-民權,2024-07-11,9312
1513,中興電,43,35,8,華南永昌-民權,2024-07-11,9312
1795,美時,9,1,8,華南永昌-民權,2024-07-11,9312
00857B,永豐20年美公債,8,0,8,華南永昌-民權,2024-07-11,9312
2402,毅嘉,8,0,8,華南永昌-民權,2024-07-11,9312
2618,長榮航,24,16,8,華南永昌-民權,2024-07-11,9312
3564,其陽,8,0,8,華南永昌-民權,2024-07-11,9312
2645,長榮航太,7,0,7,華南永昌-民權,2024-07-11,9312
3033,威健,10,3,7,華南永昌-民權,2024-07-11,9312
00772B,中信高評級公司債,500,0,500,華南永昌-民權,2024-07-12,9312
00929,復華台灣科技優息,225,0,225,華南永昌-民權,2024-07-12,9312
2374,佳能,110,0,110,華南永昌-民權,2024-07-12,9312
00934,中信成長高股息,85,0,85,華南永昌-民權,2024-07-12,9312
2102,泰豐,66,0,66,華南永昌-民權,2024-07-12,9312
00919,群益台灣精選高息,65,1,64,華南永昌-民權,2024-07-12,9312
2610,華航,62,3,59,華南永昌-民權,2024-07-12,9312
2317,鴻海,60,6,54,華南永昌-民權,2024-07-12,9312
2867,三商壽,271,236,35,華南永昌-民權,2024-07-12,9312
2356,英業達,88,56,32,華南永昌-民權,2024-07-12,9312
3363,上詮,41,10,31,華南永昌-民權,2024-07-12,9312
00918,大華優利高填息30,30,0,30,華南永昌-民權,2024-07-12,9312
00881,國泰台灣5G+,29,0,29,華南永昌-民權,2024-07-12,9312
2618,長榮航,28,0,28,華南永昌-民權,2024-07-12,9312
3652,精聯,46,19,27,華南永昌-民權,2024-07-12,9312
5905,南仁湖,27,1,26,華南永昌-民權,2024-07-12,9312
1316,上曜,34,12,22,華南永昌-民權,2024-07-12,9312
2303,聯電,22,1,21,華南永昌-民權,2024-07-12,9312
00680L,元大美債20正2,31,10,21,華南永昌-民權,2024-07-12,9312
1815,富喬,21,0,21,華南永昌-民權,2024-07-12,9312
2427,三商電,20,0,20,華南永昌-民權,2024-07-12,9312
4726,永昕,20,0,20,華南永昌-民權,2024-07-12,9312
6160,欣技,20,0,20,華南永昌-民權,2024-07-12,9312
2609,陽明,27,8,19,華南永昌-民權,2024-07-12,9312
8110,華東,20,2,18,華南永昌-民權,2024-07-12,9312
2615,萬海,21,4,17,華南永昌-民權,2024-07-12,9312
1785,光洋科,29,13,16,華南永昌-民權,2024-07-12,9312
5381,合正,15,0,15,華南永昌-民權,2024-07-12,9312
00905,FT臺灣Smart,14,0,14,華南永昌-民權,2024-07-12,9312
00946,群益科技高息成長,17,4,13,華南永昌-民權,2024-07-12,9312
00935,野村臺灣新科技50,16,5,11,華南永昌-民權,2024-07-12,9312
00939,統一台灣高息動能,12,1,11,華南永昌-民權,2024-07-12,9312
2645,長榮航太,11,0,11,華南永昌-民權,2024-07-12,9312
5519,隆大,11,0,11,華南永昌-民權,2024-07-12,9312
00895,富邦未來車,11,1,10,華南永昌-民權,2024-07-12,9312
00936,台新永續高息中小,11,1,10,華南永昌-民權,2024-07-12,9312
00632R,元大台灣50反1,10,0,10,華南永昌-民權,2024-07-12,9312
2031,新光鋼,10,0,10,華南永昌-民權,2024-07-12,9312
3231,緯創,12,2,10,華南永昌-民權,2024-07-12,9312
4939,亞電,10,0,10,華南永昌-民權,2024-07-12,9312
5522,遠雄,10,0,10,華南永昌-民權,2024-07-12,9312
6148,驊宏資,10,0,10,華南永昌-民權,2024-07-12,9312
8227,巨有科技,16,6,10,華南永昌-民權,2024-07-12,9312
2353,宏��,14,4,10,華南永昌-民權,2024-07-12,9312
00740B,富邦全球投等債,9,0,9,華南永昌-民權,2024-07-12,9312
2892,第一金,10,1,9,華南永昌-民權,2024-07-12,9312
2484,希華,10,2,8,華南永昌-民權,2024-07-12,9312
4532,瑞智,8,0,8,華南永昌-民權,2024-07-12,9312
2449,京元電子,10,3,7,華南永昌-民權,2024-07-12,9312
2023,燁輝,7,0,7,華南永昌-民權,2024-07-12,9312
2356,英業達,1503,277,1226,華南永昌-民權,2024-07-15,9312
2888,新光金,953,21,932,華南永昌-民權,2024-07-15,9312
2374,佳能,114,0,114,華南永昌-民權,2024-07-15,9312
2101,南港,105,0,105,華南永昌-民權,2024-07-15,9312
2489,瑞軒,142,51,91,華南永昌-民權,2024-07-15,9312
2312,金寶,111,25,86,華南永昌-民權,2024-07-15,9312
00934,中信成長高股息,57,0,57,華南永昌-民權,2024-07-15,9312
00918,大華優利高填息30,45,0,45,華南永昌-民權,2024-07-15,9312
6770,力積電,42,0,42,華南永昌-民權,2024-07-15,9312
1303,南亞,40,0,40,華南永昌-民權,2024-07-15,9312
2102,泰豐,40,0,40,華南永昌-民權,2024-07-15,9312
3481,群創,64,31,33,華南永昌-民權,2024-07-15,9312
2509,全坤建,30,0,30,華南永昌-民權,2024-07-15,9312
2610,華航,40,14,26,華南永昌-民權,2024-07-15,9312
3583,辛耘,25,2,23,華南永昌-民權,2024-07-15,9312
4960,誠美材,25,2,23,華南永昌-民權,2024-07-15,9312
3673,TPK-KY,26,4,22,華南永昌-民權,2024-07-15,9312
8110,華東,22,0,22,華南永昌-民權,2024-07-15,9312
2353,宏��,22,1,21,華南永昌-民權,2024-07-15,9312
00664R,國泰臺灣加權反1,20,0,20,華南永昌-民權,2024-07-15,9312
1304,台聚,20,0,20,華南永昌-民權,2024-07-15,9312
1712,興農,20,0,20,華南永昌-民權,2024-07-15,9312
2401,凌陽,46,26,20,華南永昌-民權,2024-07-15,9312
3706,神達,22,2,20,華南永昌-民權,2024-07-15,9312
5340,建榮,20,0,20,華南永昌-民權,2024-07-15,9312
0056,元大高股息,30,11,19,華南永昌-民權,2024-07-15,9312
2891,中信金,22,3,19,華南永昌-民權,2024-07-15,9312
1608,華榮,55,38,17,華南永昌-民權,2024-07-15,9312
3594,磐儀,22,5,17,華南永昌-民權,2024-07-15,9312
3037,欣興,20,3,17,華南永昌-民權,2024-07-15,9312
6163,華電網,16,0,16,華南永昌-民權,2024-07-15,9312
00740B,富邦全球投等債,15,0,15,華南永昌-民權,2024-07-15,9312
00929,復華台灣科技優息,30,16,14,華南永昌-民權,2024-07-15,9312
2409,友達,19,5,14,華南永昌-民權,2024-07-15,9312
2501,國建,16,2,14,華南永昌-民權,2024-07-15,9312
6806,森崴能源,15,1,14,華南永昌-民權,2024-07-15,9312
00919,群益台灣精選高息,14,0,14,華南永昌-民權,2024-07-15,9312
9945,潤泰新,20,6,14,華南永昌-民權,2024-07-15,9312
1721,三晃,13,0,13,華南永昌-民權,2024-07-15,9312
2332,友訊,17,4,13,華南永昌-民權,2024-07-15,9312
00927,群益半導體收益,13,1,12,華南永昌-民權,2024-07-15,9312
2337,旺宏,12,0,12,華南永昌-民權,2024-07-15,9312
3712,永崴投控,12,0,12,華南永昌-民權,2024-07-15,9312
00735,國泰臺韓科技,14,3,11,華南永昌-民權,2024-07-15,9312
3231,緯創,11,0,11,華南永昌-民權,2024-07-15,9312
5381,合正,11,0,11,華南永昌-民權,2024-07-15,9312
1309,台達化,10,0,10,華南永昌-民權,2024-07-15,9312
1532,勤美,10,0,10,華南永昌-民權,2024-07-15,9312
2201,裕隆,10,0,10,華南永昌-民權,2024-07-15,9312
2408,南亞科,12,2,10,華南永昌-民權,2024-07-15,9312
00929,復華台灣科技優息,259,0,259,華南永昌-民權,2024-07-16,9312
2897,王道銀行,250,0,250,華南永昌-民權,2024-07-16,9312
2002,中鋼,203,3,200,華南永昌-民權,2024-07-16,9312
2888,新光金,219,102,117,華南永昌-民權,2024-07-16,9312
00937B,群益ESG投等債20,110,1,109,華南永昌-民權,2024-07-16,9312
2101,南港,805,708,97,華南永昌-民權,2024-07-16,9312
2884,玉山金,70,21,49,華南永昌-民權,2024-07-16,9312
6160,欣技,40,0,40,華南永昌-民權,2024-07-16,9312
6706,惠特,135,100,35,華南永昌-民權,2024-07-16,9312
2301,光寶科,36,6,30,華南永昌-民權,2024-07-16,9312
00933B,國泰10Y+金融債,30,1,29,華南永昌-民權,2024-07-16,9312
2328,廣宇,28,0,28,華南永昌-民權,2024-07-16,9312
1210,大成,20,0,20,華南永昌-民權,2024-07-16,9312
6026,福邦證,20,0,20,華南永昌-民權,2024-07-16,9312
6438,迅得,20,0,20,華南永昌-民權,2024-07-16,9312
2312,金寶,38,18,20,華南永昌-民權,2024-07-16,9312
2610,華航,22,5,17,華南永昌-民權,2024-07-16,9312
3217,優群,17,0,17,華南永昌-民權,2024-07-16,9312
0056,元大高股息,25,9,16,華南永昌-民權,2024-07-16,9312
3380,明泰,15,0,15,華南永昌-民權,2024-07-16,9312
5522,遠雄,15,0,15,華南永昌-民權,2024-07-16,9312
00773B,中信優先金融債,21,6,15,華南永昌-民權,2024-07-16,9312
3708,上緯投控,15,1,14,華南永昌-民權,2024-07-16,9312
3481,群創,23,9,14,華南永昌-民權,2024-07-16,9312
2367,燿華,13,0,13,華南永昌-民權,2024-07-16,9312
00919,群益台灣精選高息,12,0,12,華南永昌-民權,2024-07-16,9312
6127,九豪,12,0,12,華南永昌-民權,2024-07-16,9312
6152,百一,11,0,11,華南永昌-民權,2024-07-16,9312
6695,芯鼎,13,2,11,華南永昌-民權,2024-07-16,9312
00905,FT臺灣Smart,13,3,10,華南永昌-民權,2024-07-16,9312
1617,榮星,10,0,10,華南永昌-民權,2024-07-16,9312
1618,合機,10,0,10,華南永昌-民權,2024-07-16,9312
3006,晶豪科,10,0,10,華南永昌-民權,2024-07-16,9312
3019,亞光,13,3,10,華南永昌-民權,2024-07-16,9312
3701,大眾控,10,0,10,華南永昌-民權,2024-07-16,9312
2891,中信金,9,0,9,華南永昌-民權,2024-07-16,9312
2355,敬鵬,10,1,9,華南永昌-民權,2024-07-16,9312
2615,萬海,12,3,9,華南永昌-民權,2024-07-16,9312
9105,泰金寶-DR,33,24,9,華南永昌-民權,2024-07-16,9312
2845,遠東銀,9,0,9,華南永昌-民權,2024-07-16,9312
00936,台新永續高息中小,37,29,8,華南永昌-民權,2024-07-16,9312
3617,碩天,8,0,8,華南永昌-民權,2024-07-16,9312
6179,亞通,8,0,8,華南永昌-民權,2024-07-16,9312
2399,映泰,16,8,8,華南永昌-民權,2024-07-16,9312
2371,大同,9,2,7,華南永昌-民權,2024-07-16,9312
2618,長榮航,9,2,7,華南永昌-民權,2024-07-16,9312
6139,亞翔,10,4,6,華南永昌-民權,2024-07-16,9312
00878,國泰永續高股息,7,1,6,華南永昌-民權,2024-07-16,9312
00939,統一台灣高息動能,6,0,6,華南永昌-民權,2024-07-16,9312
1612,宏泰,9,3,6,華南永昌-民權,2024-07-16,9312
00937B,群益ESG投等債20,277,0,277,華南永昌-民權,2024-07-17,9312
00882,中信中國高股息,103,0,103,華南永昌-民權,2024-07-17,9312
00929,復華台灣科技優息,97,3,94,華南永昌-民權,2024-07-17,9312
1314,中石化,398,307,91,華南永昌-民權,2024-07-17,9312
3652,精聯,83,0,83,華南永昌-民權,2024-07-17,9312
2888,新光金,136,63,73,華南永昌-民權,2024-07-17,9312
1514,亞力,54,0,54,華南永昌-民權,2024-07-17,9312
2845,遠東銀,46,7,39,華南永昌-民權,2024-07-17,9312
9105,泰金寶-DR,61,24,37,華南永昌-民權,2024-07-17,9312
3576,聯合再生,35,1,34,華南永昌-民權,2024-07-17,9312
2330,台積電,39,6,33,華南永昌-民權,2024-07-17,9312
2501,國建,101,69,32,華南永昌-民權,2024-07-17,9312
5328,華容,30,0,30,華南永昌-民權,2024-07-17,9312
6160,欣技,30,0,30,華南永昌-民權,2024-07-17,9312
2834,臺企銀,27,0,27,華南永昌-民權,2024-07-17,9312
4967,十銓,29,2,27,華南永昌-民權,2024-07-17,9312
1709,和益,25,0,25,華南永昌-民權,2024-07-17,9312
2464,盟立,36,11,25,華南永昌-民權,2024-07-17,9312
1409,新纖,36,12,24,華南永昌-民權,2024-07-17,9312
00725B,國泰投資級公司債,21,1,20,華南永昌-民權,2024-07-17,9312
00687B,國泰20年美債,20,0,20,華南永昌-民權,2024-07-17,9312
6190,萬泰科,20,1,19,華南永昌-民權,2024-07-17,9312
00712,復華富時不動產,30,12,18,華南永昌-民權,2024-07-17,9312
2317,鴻海,23,5,18,華南永昌-民權,2024-07-17,9312
3607,谷崧,21,4,17,華南永昌-民權,2024-07-17,9312
3231,緯創,30,14,16,華南永昌-民權,2024-07-17,9312
3230,錦明,15,0,15,華南永昌-民權,2024-07-17,9312
00936,台新永續高息中小,37,23,14,華南永昌-民權,2024-07-17,9312
0056,元大高股息,15,1,14,華南永昌-民權,2024-07-17,9312
00940,元大台灣價值高息,31,18,13,華南永昌-民權,2024-07-17,9312
1806,冠軍,14,2,12,華南永昌-民權,2024-07-17,9312
4513,福裕,12,0,12,華南永昌-民權,2024-07-17,9312
6770,力積電,14,2,12,華南永昌-民權,2024-07-17,9312
00927,群益半導體收益,11,0,11,華南永昌-民權,2024-07-17,9312
2867,三商壽,11,0,11,華南永昌-民權,2024-07-17,9312
1609,大亞,32,21,11,華南永昌-民權,2024-07-17,9312
2303,聯電,22,11,11,華南永昌-民權,2024-07-17,9312
2353,宏��,11,1,10,華南永昌-民權,2024-07-17,9312
2515,中工,209,199,10,華南永昌-民權,2024-07-17,9312
1342,八貫,10,0,10,華南永昌-民權,2024-07-17,9312
3006,晶豪科,10,0,10,華南永昌-民權,2024-07-17,9312
3162,精確,10,0,10,華南永昌-民權,2024-07-17,9312
3346,麗清,10,0,10,華南永昌-民權,2024-07-17,9312
4906,正文,13,3,10,華南永昌-民權,2024-07-17,9312
6139,亞翔,10,0,10,華南永昌-民權,2024-07-17,9312
2408,南亞科,12,2,10,華南永昌-民權,2024-07-17,9312
2392,正崴,10,1,9,華南永昌-民權,2024-07-17,9312
2489,瑞軒,17,8,9,華南永昌-民權,2024-07-17,9312
00680L,元大美債20正2,10,1,9,華南永昌-民權,2024-07-17,9312
2371,大同,17,8,9,華南永昌-民權,2024-07-17,9312
2002,中鋼,266,9,257,華南永昌-民權,2024-07-18,9312
2356,英業達,128,6,122,華南永昌-民權,2024-07-18,9312
00918,大華優利高填息30,183,77,106,華南永昌-民權,2024-07-18,9312
00929,復華台灣科技優息,107,17,90,華南永昌-民權,2024-07-18,9312
3652,精聯,89,0,89,華南永昌-民權,2024-07-18,9312
1402,遠東新,73,0,73,華南永昌-民權,2024-07-18,9312
2489,瑞軒,74,5,69,華南永昌-民權,2024-07-18,9312
00946,群益科技高息成長,52,0,52,華南永昌-民權,2024-07-18,9312
00919,群益台灣精選高息,67,18,49,華南永昌-民權,2024-07-18,9312
4306,炎洲,43,1,42,華南永昌-民權,2024-07-18,9312
00935,野村臺灣新科技50,40,0,40,華南永昌-民權,2024-07-18,9312
00927,群益半導體收益,52,20,32,華南永昌-民權,2024-07-18,9312
6505,台塑化,33,2,31,華南永昌-民權,2024-07-18,9312
3037,欣興,36,9,27,華南永昌-民權,2024-07-18,9312
1438,三地開發,27,0,27,華南永昌-民權,2024-07-18,9312
1612,宏泰,29,4,25,華南永昌-民權,2024-07-18,9312
1316,上曜,25,3,22,華南永昌-民權,2024-07-18,9312
2464,盟立,25,3,22,華南永昌-民權,2024-07-18,9312
1313,聯成,21,0,21,華南永昌-民權,2024-07-18,9312
2401,凌陽,22,1,21,華南永昌-民權,2024-07-18,9312
4903,聯光通,21,0,21,華南永昌-民權,2024-07-18,9312
6190,萬泰科,21,0,21,華南永昌-民權,2024-07-18,9312
2515,中工,21,1,20,華南永昌-民權,2024-07-18,9312
6488,環球晶,18,0,18,華南永昌-民權,2024-07-18,9312
00881,國泰台灣5G+,17,0,17,華南永昌-民權,2024-07-18,9312
2537,聯上發,17,2,15,華南永昌-民權,2024-07-18,9312
6706,惠特,15,0,15,華南永昌-民權,2024-07-18,9312
0056,元大高股息,25,10,15,華南永昌-民權,2024-07-18,9312
3189,景碩,19,5,14,華南永昌-民權,2024-07-18,9312
9945,潤泰新,29,16,13,華南永昌-民權,2024-07-18,9312
2344,華邦電,13,0,13,華南永昌-民權,2024-07-18,9312
00631L,元大台灣50正2,12,0,12,華南永昌-民權,2024-07-18,9312
00939,統一台灣高息動能,12,0,12,華南永昌-民權,2024-07-18,9312
1815,富喬,13,1,12,華南永昌-民權,2024-07-18,9312
3051,力特,12,0,12,華南永昌-民權,2024-07-18,9312
8011,台通,15,3,12,華南永昌-民權,2024-07-18,9312
2382,廣達,17,6,11,華南永昌-民權,2024-07-18,9312
8110,華東,11,0,11,華南永昌-民權,2024-07-18,9312
00891,中信關鍵半導體,11,0,11,華南永昌-民權,2024-07-18,9312
00675L,富邦臺灣加權正2,11,0,11,華南永昌-民權,2024-07-18,9312
3033,威健,12,1,11,華南永昌-民權,2024-07-18,9312
4960,誠美材,11,0,11,華南永昌-民權,2024-07-18,9312
8105,凌巨,17,6,11,華南永昌-民權,2024-07-18,9312
9105,泰金寶-DR,23,12,11,華南永昌-民權,2024-07-18,9312
6125,廣運,17,6,11,華南永昌-民權,2024-07-18,9312
8033,雷虎,10,0,10,華南永昌-民權,2024-07-18,9312
2867,三商壽,12,2,10,華南永昌-民權,2024-07-18,9312
5328,華容,10,0,10,華南永昌-民權,2024-07-18,9312
00936,台新永續高息中小,32,22,10,華南永昌-民權,2024-07-18,9312
1611,中電,10,0,10,華南永昌-民權,2024-07-18,9312
2888,新光金,535,235,300,華南永昌-民權,2024-07-19,9312
00918,大華優利高填息30,170,32,138,華南永昌-民權,2024-07-19,9312
00929,復華台灣科技優息,176,45,131,華南永昌-民權,2024-07-19,9312
3652,精聯,126,10,116,華南永昌-民權,2024-07-19,9312
00919,群益台灣精選高息,76,4,72,華南永昌-民權,2024-07-19,9312
00937B,群益ESG投等債20,59,0,59,華南永昌-民權,2024-07-19,9312
6706,惠特,50,0,50,華南永昌-民權,2024-07-19,9312
2884,玉山金,60,24,36,華南永昌-民權,2024-07-19,9312
6202,盛群,33,0,33,華南永昌-民權,2024-07-19,9312
0056,元大高股息,133,101,32,華南永昌-民權,2024-07-19,9312
5351,鈺創,31,0,31,華南永昌-民權,2024-07-19,9312
00878,國泰永續高股息,33,5,28,華南永昌-民權,2024-07-19,9312
2330,台積電,46,22,24,華南永昌-民權,2024-07-19,9312
2883,凱基金,25,2,23,華南永昌-民權,2024-07-19,9312
00940,元大台灣價值高息,54,32,22,華南永昌-民權,2024-07-19,9312
6770,力積電,26,4,22,華南永昌-民權,2024-07-19,9312
1709,和益,38,18,20,華南永昌-民權,2024-07-19,9312
6284,佳邦,22,2,20,華南永昌-民權,2024-07-19,9312
8437,大地-KY,44,24,20,華南永昌-民權,2024-07-19,9312
3481,群創,150,131,19,華南永昌-民權,2024-07-19,9312
00946,群益科技高息成長,18,1,17,華南永昌-民權,2024-07-19,9312
5512,力麒,85,69,16,華南永昌-民權,2024-07-19,9312
8927,北基,36,20,16,華南永昌-民權,2024-07-19,9312
2401,凌陽,17,1,16,華南永昌-民權,2024-07-19,9312
2845,遠東銀,18,2,16,華南永昌-民權,2024-07-19,9312
2838,聯邦銀,21,6,15,華南永昌-民權,2024-07-19,9312
5340,建榮,22,7,15,華南永昌-民權,2024-07-19,9312
1514,亞力,14,1,13,華南永昌-民權,2024-07-19,9312
3049,精金,23,10,13,華南永昌-民權,2024-07-19,9312
3163,波若威,19,6,13,華南永昌-民權,2024-07-19,9312
6190,萬泰科,13,0,13,華南永昌-民權,2024-07-19,9312
9945,潤泰新,24,11,13,華南永昌-民權,2024-07-19,9312
2002,中鋼,17,4,13,華南永昌-民權,2024-07-19,9312
1326,台化,12,0,12,華南永昌-民權,2024-07-19,9312
1444,力麗,16,4,12,華南永昌-民權,2024-07-19,9312
8105,凌巨,15,3,12,華南永昌-民權,2024-07-19,9312
00881,國泰台灣5G+,10,0,10,華南永昌-民權,2024-07-19,9312
00891,中信關鍵半導體,11,1,10,華南永昌-民權,2024-07-19,9312
00898,國泰基因免疫革命,10,0,10,華南永昌-民權,2024-07-19,9312
1216,統一,10,0,10,華南永昌-民權,2024-07-19,9312
1303,南亞,10,0,10,華南永昌-民權,2024-07-19,9312
1612,宏泰,11,1,10,華南永昌-民權,2024-07-19,9312
4903,聯光通,10,0,10,華南永昌-民權,2024-07-19,9312
6127,九豪,10,0,10,華南永昌-民權,2024-07-19,9312
8054,安國,16,6,10,華南永昌-民權,2024-07-19,9312
9105,泰金寶-DR,20,10,10,華南永昌-民權,2024-07-19,9312
2891,中信金,10,0,10,華南永昌-民權,2024-07-19,9312
1409,新纖,16,7,9,華南永昌-民權,2024-07-19,9312
3047,訊舟,23,15,8,華南永昌-民權,2024-07-19,9312
4157,太景*-KY,8,0,8,華南永昌-民權,2024-07-19,9312
6706,惠特,250,0,250,華南永昌-民權,2024-07-22,9312
00929,復華台灣科技優息,253,20,233,華南永昌-民權,2024-07-22,9312
2884,玉山金,220,32,188,華南永昌-民權,2024-07-22,9312
00919,群益台灣精選高息,115,17,98,華南永昌-民權,2024-07-22,9312
9924,福興,83,0,83,華南永昌-民權,2024-07-22,9312
00891,中信關鍵半導體,77,0,77,華南永昌-民權,2024-07-22,9312
00946,群益科技高息成長,82,5,77,華南永昌-民權,2024-07-22,9312
00918,大華優利高填息30,81,9,72,華南永昌-民權,2024-07-22,9312
3652,精聯,60,4,56,華南永昌-民權,2024-07-22,9312
1609,大亞,76,25,51,華南永昌-民權,2024-07-22,9312
1909,榮成,51,1,50,華南永昌-民權,2024-07-22,9312
00940,元大台灣價值高息,75,28,47,華南永昌-民權,2024-07-22,9312
3481,群創,118,71,47,華南永昌-民權,2024-07-22,9312
00934,中信成長高股息,58,16,42,華南永昌-民權,2024-07-22,9312
2888,新光金,802,763,39,華南永昌-民權,2024-07-22,9312
2401,凌陽,31,0,31,華南永昌-民權,2024-07-22,9312
00720B,元大投資級公司債,30,0,30,華南永昌-民權,2024-07-22,9312
8927,北基,30,1,29,華南永昌-民權,2024-07-22,9312
2367,燿華,30,3,27,華南永昌-民權,2024-07-22,9312
5512,力麒,29,6,23,華南永昌-民權,2024-07-22,9312
2845,遠東銀,21,1,20,華南永昌-民權,2024-07-22,9312
00878,國泰永續高股息,20,0,20,華南永昌-民權,2024-07-22,9312
3024,憶聲,20,0,20,華南永昌-民權,2024-07-22,9312
4906,正文,19,0,19,華南永昌-民權,2024-07-22,9312
00881,國泰台灣5G+,19,1,18,華南永昌-民權,2024-07-22,9312
3581,博磊,18,0,18,華南永昌-民權,2024-07-22,9312
6190,萬泰科,19,1,18,華南永昌-民權,2024-07-22,9312
2324,仁寶,17,1,16,華南永昌-民權,2024-07-22,9312
2330,台積電,28,12,16,華南永昌-民權,2024-07-22,9312
3047,訊舟,16,1,15,華南永昌-民權,2024-07-22,9312
5522,遠雄,15,0,15,華南永昌-民權,2024-07-22,9312
8916,光隆,15,0,15,華南永昌-民權,2024-07-22,9312
2603,長榮,14,1,13,華南永昌-民權,2024-07-22,9312
6834,天二科技,13,0,13,華南永昌-民權,2024-07-22,9312
2312,金寶,26,14,12,華南永昌-民權,2024-07-22,9312
2489,瑞軒,14,2,12,華南永昌-民權,2024-07-22,9312
00936,台新永續高息中小,76,64,12,華南永昌-民權,2024-07-22,9312
1605,華新,15,3,12,華南永昌-民權,2024-07-22,9312
2382,廣達,14,3,11,華南永昌-民權,2024-07-22,9312
6163,華電網,14,3,11,華南永昌-民權,2024-07-22,9312
2887,台新金,12,2,10,華南永昌-民權,2024-07-22,9312
2537,聯上發,11,1,10,華南永昌-民權,2024-07-22,9312
8437,大地-KY,10,0,10,華南永昌-民權,2024-07-22,9312
0056,元大高股息,11,1,10,華南永昌-民權,2024-07-22,9312
00631L,元大台灣50正2,21,12,9,華南永昌-民權,2024-07-22,9312
2408,南亞科,8,0,8,華南永昌-民權,2024-07-22,9312
2467,志聖,8,0,8,華南永昌-民權,2024-07-22,9312
2801,彰銀,8,0,8,華南永昌-民權,2024-07-22,9312
3032,偉訓,8,0,8,華南永昌-民權,2024-07-22,9312
8110,華東,8,0,8,華南永昌-民權,2024-07-22,9312
2356,英業達,103,1,102,華南永昌-民權,2024-07-23,9312
00929,復華台灣科技優息,73,0,73,華南永昌-民權,2024-07-23,9312
3481,群創,93,34,59,華南永昌-民權,2024-07-23,9312
2408,南亞科,57,0,57,華南永昌-民權,2024-07-23,9312
00940,元大台灣價值高息,60,7,53,華南永昌-民權,2024-07-23,9312
00946,群益科技高息成長,48,0,48,華南永昌-民權,2024-07-23,9312
6706,惠特,60,30,30,華南永昌-民權,2024-07-23,9312
1609,大亞,42,16,26,華南永昌-民權,2024-07-23,9312
00937B,群益ESG投等債20,20,0,20,華南永昌-民權,2024-07-23,9312
2317,鴻海,44,24,20,華南永昌-民權,2024-07-23,9312
1314,中石化,21,2,19,華南永昌-民權,2024-07-23,9312
2489,瑞軒,19,1,18,華南永昌-民權,2024-07-23,9312
00919,群益台灣精選高息,18,3,15,華南永昌-民權,2024-07-23,9312
3686,達能,14,0,14,華南永昌-民權,2024-07-23,9312
3652,精聯,25,11,14,華南永昌-民權,2024-07-23,9312
1815,富喬,18,7,11,華南永昌-民權,2024-07-23,9312
2344,華邦電,11,0,11,華南永昌-民權,2024-07-23,9312
00632R,元大台灣50反1,10,0,10,華南永昌-民權,2024-07-23,9312
1301,台塑,10,0,10,華南永昌-民權,2024-07-23,9312
1312,國喬,10,0,10,華南永昌-民權,2024-07-23,9312
1532,勤美,10,0,10,華南永昌-民權,2024-07-23,9312
1584,精剛,10,0,10,華南永昌-民權,2024-07-23,9312
1708,東鹼,10,0,10,華南永昌-民權,2024-07-23,9312
2406,國碩,10,0,10,華南永昌-民權,2024-07-23,9312
3081,聯亞,10,0,10,華南永昌-民權,2024-07-23,9312
5522,遠雄,10,0,10,華南永昌-民權,2024-07-23,9312
2481,強茂,18,8,10,華南永昌-民權,2024-07-23,9312
00930,永豐ESG低碳高息,10,0,10,華南永昌-民權,2024-07-23,9312
2888,新光金,282,273,9,華南永昌-民權,2024-07-23,9312
00934,中信成長高股息,8,0,8,華南永昌-民權,2024-07-23,9312
3029,零壹,18,10,8,華南永昌-民權,2024-07-23,9312
2867,三商壽,8,1,7,華南永昌-民權,2024-07-23,9312
3537,堡達,7,0,7,華南永昌-民權,2024-07-23,9312
3607,谷崧,10,3,7,華南永昌-民權,2024-07-23,9312
3712,永崴投控,7,0,7,華南永昌-民權,2024-07-23,9312
00687B,國泰20年美債,6,0,6,華南永昌-民權,2024-07-23,9312
2409,友達,6,0,6,華南永昌-民權,2024-07-23,9312
4916,事欣科,7,1,6,華南永昌-民權,2024-07-23,9312
2812,台中銀,5,0,5,華南永昌-民權,2024-07-23,9312
3231,緯創,7,2,5,華南永昌-民權,2024-07-23,9312
2312,金寶,14,9,5,華南永昌-民權,2024-07-23,9312
1303,南亞,5,0,5,華南永昌-民權,2024-07-23,9312
1447,力鵬,5,0,5,華南永昌-民權,2024-07-23,9312
2349,錸德,5,0,5,華南永昌-民權,2024-07-23,9312
2367,燿華,9,4,5,華南永昌-民權,2024-07-23,9312
2762,世界健身-KY,5,0,5,華南永昌-民權,2024-07-23,9312
3259,鑫創,5,0,5,華南永昌-民權,2024-07-23,9312
3357,臺慶科,5,0,5,華南永昌-民權,2024-07-23,9312
3580,友威科,40,35,5,華南永昌-民權,2024-07-23,9312
6213,聯茂,5,0,5,華南永昌-民權,2024-07-23,9312
2344,華邦電,300,1,299,華南永昌-民權,2024-07-26,9312
00929,復華台灣科技優息,128,27,101,華南永昌-民權,2024-07-26,9312
00918,大華優利高填息30,60,1,59,華南永昌-民權,2024-07-26,9312
2330,台積電,57,3,54,華南永昌-民權,2024-07-26,9312
00940,元大台灣價值高息,48,7,41,華南永昌-民權,2024-07-26,9312
00919,群益台灣精選高息,99,60,39,華南永昌-民權,2024-07-26,9312
00946,群益科技高息成長,33,1,32,華南永昌-民權,2024-07-26,9312
00934,中信成長高股息,26,3,23,華南永昌-民權,2024-07-26,9312
2834,臺企銀,23,0,23,華南永昌-民權,2024-07-26,9312
6177,達麗,21,1,20,華南永昌-民權,2024-07-26,9312
00933B,國泰10Y+金融債,20,0,20,華南永昌-民權,2024-07-26,9312
3711,日月光投控,18,0,18,華南永昌-民權,2024-07-26,9312
00878,國泰永續高股息,20,2,18,華南永昌-民權,2024-07-26,9312
2897A,王道銀甲特,16,0,16,華南永昌-民權,2024-07-26,9312
2349,錸德,16,0,16,華南永昌-民權,2024-07-26,9312
4906,正文,17,2,15,華南永昌-民權,2024-07-26,9312
6488,環球晶,15,0,15,華南永昌-民權,2024-07-26,9312
00679B,元大美債20年,14,0,14,華南永昌-民權,2024-07-26,9312
2317,鴻海,22,9,13,華南永昌-民權,2024-07-26,9312
1584,精剛,12,0,12,華南永昌-民權,2024-07-26,9312
2002,中鋼,43,31,12,華南永昌-民權,2024-07-26,9312
1309,台達化,11,0,11,華南永昌-民權,2024-07-26,9312
3033,威健,12,1,11,華南永昌-民權,2024-07-26,9312
3217,優群,11,0,11,華南永昌-民權,2024-07-26,9312
00927,群益半導體收益,11,0,11,華南永昌-民權,2024-07-26,9312
2838,聯邦銀,22,11,11,華南永昌-民權,2024-07-26,9312
3231,緯創,10,0,10,華南永昌-民權,2024-07-26,9312
00720B,元大投資級公司債,10,0,10,華南永昌-民權,2024-07-26,9312
1472,三洋實業,10,0,10,華南永昌-民權,2024-07-26,9312
2801,彰銀,10,0,10,華南永昌-民權,2024-07-26,9312
4726,永昕,10,0,10,華南永昌-民權,2024-07-26,9312
6269,台郡,11,1,10,華南永昌-民權,2024-07-26,9312
00631L,元大台灣50正2,9,0,9,華南永昌-民權,2024-07-26,9312
00937B,群益ESG投等債20,110,101,9,華南永昌-民權,2024-07-26,9312
2884,玉山金,8,0,8,華南永昌-民權,2024-07-26,9312
00680L,元大美債20正2,8,0,8,華南永昌-民權,2024-07-26,9312
3652,精聯,8,0,8,華南永昌-民權,2024-07-26,9312
00830,國泰費城半導體,7,0,7,華南永昌-民權,2024-07-26,9312
8299,群聯,12,5,7,華南永昌-民權,2024-07-26,9312
6770,力積電,7,0,7,華南永昌-民權,2024-07-26,9312
6005,群益證,6,0,6,華南永昌-民權,2024-07-26,9312
00891,中信關鍵半導體,11,5,6,華南永昌-民權,2024-07-26,9312
00706L,期元大S＆P日圓正2,6,0,6,華南永昌-民權,2024-07-26,9312
2353,宏��,10,4,6,華南永昌-民權,2024-07-26,9312
5474,聰泰,6,0,6,華南永昌-民權,2024-07-26,9312
2603,長榮,6,1,5,華南永昌-民權,2024-07-26,9312
00675L,富邦臺灣加權正2,10,4,6,華南永昌-民權,2024-07-26,9312
00773B,中信優先金融債,5,0,5,華南永昌-民權,2024-07-26,9312
1319,東陽,5,0,5,華南永昌-民權,2024-07-26,9312
3576,聯合再生,5,0,5,華南永昌-民權,2024-07-26,9312
6706,惠特,124,0,124,華南永昌-民權,2024-07-29,9312
00929,復華台灣科技優息,77,2,75,華南永昌-民權,2024-07-29,9312
00948B,中信優息投資級債,50,0,50,華南永昌-民權,2024-07-29,9312
00940,元大台灣價值高息,45,0,45,華南永昌-民權,2024-07-29,9312
00946,群益科技高息成長,46,1,45,華南永昌-民權,2024-07-29,9312
5905,南仁湖,45,0,45,華南永昌-民權,2024-07-29,9312
00919,群益台灣精選高息,43,1,42,華南永昌-民權,2024-07-29,9312
3652,精聯,42,1,41,華南永昌-民權,2024-07-29,9312
9945,潤泰新,52,11,41,華南永昌-民權,2024-07-29,9312
8054,安國,35,5,30,華南永昌-民權,2024-07-29,9312
6163,華電網,25,0,25,華南永昌-民權,2024-07-29,9312
00632R,元大台灣50反1,22,0,22,華南永昌-民權,2024-07-29,9312
2367,燿華,23,2,21,華南永昌-民權,2024-07-29,9312
1104,環泥,20,1,19,華南永昌-民權,2024-07-29,9312
3481,群創,104,86,18,華南永昌-民權,2024-07-29,9312
2365,昆盈,62,44,18,華南永昌-民權,2024-07-29,9312
1611,中電,16,1,15,華南永昌-民權,2024-07-29,9312
00937B,群益ESG投等債20,17,3,14,華南永昌-民權,2024-07-29,9312
2349,錸德,16,2,14,華南永昌-民權,2024-07-29,9312
0056,元大高股息,21,8,13,華南永昌-民權,2024-07-29,9312
00878,國泰永續高股息,24,11,13,華南永昌-民權,2024-07-29,9312
2356,英業達,27,15,12,華南永昌-民權,2024-07-29,9312
5443,均豪,46,35,11,華南永昌-民權,2024-07-29,9312
2427,三商電,11,0,11,華南永昌-民權,2024-07-29,9312
3163,波若威,11,0,11,華南永昌-民權,2024-07-29,9312
1503,士電,14,3,11,華南永昌-民權,2024-07-29,9312
00891,中信關鍵半導體,17,7,10,華南永昌-民權,2024-07-29,9312
00712,復華富時不動產,10,0,10,華南永昌-民權,2024-07-29,9312
5340,建榮,10,0,10,華南永昌-民權,2024-07-29,9312
1785,光洋科,10,1,9,華南永昌-民權,2024-07-29,9312
2489,瑞軒,15,6,9,華南永昌-民權,2024-07-29,9312
3712,永崴投控,11,2,9,華南永昌-民權,2024-07-29,9312
3035,智原,8,0,8,華南永昌-民權,2024-07-29,9312
2392,正崴,9,1,8,華南永昌-民權,2024-07-29,9312
3607,谷崧,8,0,8,華南永昌-民權,2024-07-29,9312
2603,長榮,7,0,7,華南永昌-民權,2024-07-29,9312
006208,富邦台50,9,2,7,華南永昌-民權,2024-07-29,9312
2371,大同,7,0,7,華南永昌-民權,2024-07-29,9312
2534,宏盛,16,9,7,華南永昌-民權,2024-07-29,9312
6269,台郡,8,1,7,華南永昌-民權,2024-07-29,9312
6806,森崴能源,24,17,7,華南永昌-民權,2024-07-29,9312
2884,玉山金,6,0,6,華南永昌-民權,2024-07-29,9312
8112,至上,6,0,6,華南永昌-民權,2024-07-29,9312
3033,威健,10,4,6,華南永昌-民權,2024-07-29,9312
1815,富喬,25,19,6,華南永昌-民權,2024-07-29,9312
2353,宏��,14,8,6,華南永昌-民權,2024-07-29,9312
2897A,王道銀甲特,6,0,6,華南永昌-民權,2024-07-29,9312
6869,雲豹能源,5,0,5,華南永昌-民權,2024-07-29,9312
00927,群益半導體收益,5,0,5,華南永昌-民權,2024-07-29,9312
00887,永豐中國科技50大,5,0,5,華南永昌-民權,2024-07-29,9312
2303,聯電,709,5,704,華南永昌-民權,2024-07-30,9312
00639,富邦深100,200,0,200,華南永昌-民權,2024-07-30,9312
00940,元大台灣價值高息,218,64,154,華南永昌-民權,2024-07-30,9312
00937B,群益ESG投等債20,122,9,113,華南永昌-民權,2024-07-30,9312
6187,萬潤,78,10,68,華南永昌-民權,2024-07-30,9312
00946,群益科技高息成長,27,0,27,華南永昌-民權,2024-07-30,9312
6579,研揚,22,0,22,華南永昌-民權,2024-07-30,9312
4306,炎洲,21,0,21,華南永昌-民權,2024-07-30,9312
00680L,元大美債20正2,20,0,20,華南永昌-民權,2024-07-30,9312
00753L,中信中國50正2,20,0,20,華南永昌-民權,2024-07-30,9312
1409,新纖,20,0,20,華南永昌-民權,2024-07-30,9312
00878,國泰永續高股息,20,0,20,華南永昌-民權,2024-07-30,9312
00951,台新日本半導體,13,0,13,華南永昌-民權,2024-07-30,9312
00891,中信關鍵半導體,11,0,11,華南永昌-民權,2024-07-30,9312
1316,上曜,12,1,11,華南永昌-民權,2024-07-30,9312
3338,泰碩,12,1,11,華南永昌-民權,2024-07-30,9312
3213,茂訊,10,0,10,華南永昌-民權,2024-07-30,9312
3673,TPK-KY,17,7,10,華南永昌-民權,2024-07-30,9312
4532,瑞智,10,0,10,華南永昌-民權,2024-07-30,9312
6449,鈺邦,10,0,10,華南永昌-民權,2024-07-30,9312
2353,宏��,19,10,9,華南永昌-民權,2024-07-30,9312
00933B,國泰10Y+金融債,10,1,9,華南永昌-民權,2024-07-30,9312
1410,南染,8,0,8,華南永昌-民權,2024-07-30,9312
2481,強茂,9,1,8,華南永昌-民權,2024-07-30,9312
2880,華南金,9,1,8,華南永昌-民權,2024-07-30,9312
00939,統一台灣高息動能,10,3,7,華南永昌-民權,2024-07-30,9312
2382,廣達,7,0,7,華南永昌-民權,2024-07-30,9312
00934,中信成長高股息,9,2,7,華南永昌-民權,2024-07-30,9312
3680,家登,7,0,7,華南永昌-民權,2024-07-30,9312
1609,大亞,16,9,7,華南永昌-民權,2024-07-30,9312
2344,華邦電,7,0,7,華南永昌-民權,2024-07-30,9312
00632R,元大台灣50反1,16,10,6,華南永昌-民權,2024-07-30,9312
1453,大將,6,0,6,華南永昌-民權,2024-07-30,9312
8028,昇陽半導體,43,37,6,華南永昌-民權,2024-07-30,9312
3189,景碩,5,0,5,華南永昌-民權,2024-07-30,9312
00725B,國泰投資級公司債,6,1,5,華南永昌-民權,2024-07-30,9312
00715L,期街口布蘭特正2,5,0,5,華南永昌-民權,2024-07-30,9312
2031,新光鋼,5,0,5,華南永昌-民權,2024-07-30,9312
2442,新美齊,6,1,5,華南永昌-民權,2024-07-30,9312
2464,盟立,6,1,5,華南永昌-民權,2024-07-30,9312
2505,國揚,5,0,5,華南永昌-民權,2024-07-30,9312
2611,志信,5,0,5,華南永昌-民權,2024-07-30,9312
3081,聯亞,5,0,5,華南永昌-民權,2024-07-30,9312
3576,聯合再生,13,8,5,華南永昌-民權,2024-07-30,9312
6026,福邦證,5,0,5,華南永昌-民權,2024-07-30,9312
00948B,中信優息投資級債,5,1,4,華南永昌-民權,2024-07-30,9312
2408,南亞科,4,0,4,華南永昌-民權,2024-07-30,9312
2834,臺企銀,4,0,4,華南永昌-民權,2024-07-30,9312
3580,友威科,45,41,4,華南永昌-民權,2024-07-30,9312
6269,台郡,4,0,4,華南永昌-民權,2024-07-30,9312
00929,復華台灣科技優息,76,4,72,華南永昌-民權,2024-07-31,9312
3481,群創,158,106,52,華南永昌-民權,2024-07-31,9312
2374,佳能,43,0,43,華南永昌-民權,2024-07-31,9312
00948B,中信優息投資級債,23,2,21,華南永昌-民權,2024-07-31,9312
1104,環泥,20,0,20,華南永昌-民權,2024-07-31,9312
6127,九豪,20,0,20,華南永昌-民權,2024-07-31,9312
9105,泰金寶-DR,20,0,20,華南永昌-民權,2024-07-31,9312
00946,群益科技高息成長,13,0,13,華南永昌-民權,2024-07-31,9312
1503,士電,13,0,13,華南永昌-民權,2024-07-31,9312
2603,長榮,13,1,12,華南永昌-民權,2024-07-31,9312
0056,元大高股息,11,1,10,華南永昌-民權,2024-07-31,9312
1532,勤美,10,0,10,華南永昌-民權,2024-07-31,9312
2406,國碩,10,0,10,華南永昌-民權,2024-07-31,9312
5519,隆大,20,10,10,華南永昌-民權,2024-07-31,9312
5512,力麒,11,2,9,華南永昌-民權,2024-07-31,9312
6177,達麗,17,8,9,華南永昌-民權,2024-07-31,9312
3081,聯亞,8,0,8,華南永昌-民權,2024-07-31,9312
3437,榮創,8,0,8,華南永昌-民權,2024-07-31,9312
00919,群益台灣精選高息,7,0,7,華南永昌-民權,2024-07-31,9312
2312,金寶,19,12,7,華南永昌-民權,2024-07-31,9312
2371,大同,9,2,7,華南永昌-民權,2024-07-31,9312
2442,新美齊,7,0,7,華南永昌-民權,2024-07-31,9312
3035,智原,10,3,7,華南永昌-民權,2024-07-31,9312
2884,玉山金,6,0,6,華南永昌-民權,2024-07-31,9312
2204,中華,6,0,6,華南永昌-民權,2024-07-31,9312
3652,精聯,9,3,6,華南永昌-民權,2024-07-31,9312
00891,中信關鍵半導體,5,0,5,華南永昌-民權,2024-07-31,9312
00885,富邦越南,5,0,5,華南永昌-民權,2024-07-31,9312
00933B,國泰10Y+金融債,5,0,5,華南永昌-民權,2024-07-31,9312
1314,中石化,5,0,5,華南永昌-民權,2024-07-31,9312
1609,大亞,8,3,5,華南永昌-民權,2024-07-31,9312
1709,和益,15,10,5,華南永昌-民權,2024-07-31,9312
2618,長榮航,7,2,5,華南永昌-民權,2024-07-31,9312
3050,鈺德,6,1,5,華南永昌-民權,2024-07-31,9312
3516,亞帝歐,5,0,5,華南永昌-民權,2024-07-31,9312
5522,遠雄,5,0,5,華南永昌-民權,2024-07-31,9312
9945,潤泰新,10,5,5,華南永昌-民權,2024-07-31,9312
2481,強茂,10,5,5,華南永昌-民權,2024-07-31,9312
00935,野村臺灣新科技50,4,0,4,華南永昌-民權,2024-07-31,9312
2401,凌陽,5,1,4,華南永昌-民權,2024-07-31,9312
2596,綠意,5,1,4,華南永昌-民權,2024-07-31,9312
3217,優群,4,0,4,華南永昌-民權,2024-07-31,9312
3535,晶彩科,10,6,4,華南永昌-民權,2024-07-31,9312
4545,銘鈺,4,0,4,華南永昌-民權,2024-07-31,9312
6233,旺玖,4,0,4,華南永昌-民權,2024-07-31,9312
6753,龍德造船,4,0,4,華南永昌-民權,2024-07-31,9312
8028,昇陽半導體,13,9,4,華南永昌-民權,2024-07-31,9312
8096,擎亞,5,1,4,華南永昌-民權,2024-07-31,9312
1514,亞力,5,2,3,華南永昌-民權,2024-07-31,9312
2348,海悅,6,3,3,華南永昌-民權,2024-07-31,9312
2615,萬海,112,18,94,華南永昌-民權,2024-08-01,9312
00929,復華台灣科技優息,106,22,84,華南永昌-民權,2024-08-01,9312
00878,國泰永續高股息,73,3,70,華南永昌-民權,2024-08-01,9312
00949,復華日本龍頭,55,4,51,華南永昌-民權,2024-08-01,9312
6187,萬潤,50,0,50,華南永昌-民權,2024-08-01,9312
8927,北基,59,28,31,華南永昌-民權,2024-08-01,9312
2542,興富發,37,15,22,華南永昌-民權,2024-08-01,9312
00885,富邦越南,20,0,20,華南永昌-民權,2024-08-01,9312
5328,華容,25,5,20,華南永昌-民權,2024-08-01,9312
6168,宏齊,20,0,20,華南永昌-民權,2024-08-01,9312
2337,旺宏,29,10,19,華南永昌-民權,2024-08-01,9312
5905,南仁湖,18,0,18,華南永昌-民權,2024-08-01,9312
3481,群創,49,34,15,華南永昌-民權,2024-08-01,9312
2204,中華,14,0,14,華南永昌-民權,2024-08-01,9312
00898,國泰基因免疫革命,10,0,10,華南永昌-民權,2024-08-01,9312
3607,谷崧,10,0,10,華南永昌-民權,2024-08-01,9312
4109,加捷生醫,13,3,10,華南永昌-民權,2024-08-01,9312
5309,系統電,14,4,10,華南永昌-民權,2024-08-01,9312
2330,台積電,14,6,8,華南永昌-民權,2024-08-01,9312
2834,臺企銀,11,3,8,華南永昌-民權,2024-08-01,9312
00933B,國泰10Y+金融債,21,14,7,華南永昌-民權,2024-08-01,9312
00675L,富邦臺灣加權正2,7,0,7,華南永昌-民權,2024-08-01,9312
0056,元大高股息,10,3,7,華南永昌-民權,2024-08-01,9312
2867,三商壽,7,0,7,華南永昌-民權,2024-08-01,9312
5443,均豪,66,59,7,華南永昌-民權,2024-08-01,9312
1514,亞力,7,0,7,華南永昌-民權,2024-08-01,9312
2371,大同,6,0,6,華南永昌-民權,2024-08-01,9312
3047,訊舟,23,17,6,華南永昌-民權,2024-08-01,9312
3624,光頡,7,1,6,華南永昌-民權,2024-08-01,9312
8064,東捷,31,25,6,華南永昌-民權,2024-08-01,9312
1216,統一,5,0,5,華南永昌-民權,2024-08-01,9312
00919,群益台灣精選高息,9,4,5,華南永昌-民權,2024-08-01,9312
1560,中砂,6,1,5,華南永昌-民權,2024-08-01,9312
00937B,群益ESG投等債20,5,0,5,華南永昌-民權,2024-08-01,9312
00948B,中信優息投資級債,56,51,5,華南永昌-民權,2024-08-01,9312
00881,國泰台灣5G+,5,0,5,華南永昌-民權,2024-08-01,9312
1905,華紙,5,0,5,華南永昌-民權,2024-08-01,9312
2101,南港,5,0,5,華南永昌-民權,2024-08-01,9312
3516,亞帝歐,7,2,5,華南永昌-民權,2024-08-01,9312
5880,合庫金,5,0,5,華南永昌-民權,2024-08-01,9312
00679B,元大美債20年,21,16,5,華南永昌-民權,2024-08-01,9312
1314,中石化,6,2,4,華南永昌-民權,2024-08-01,9312
2511,太子,6,2,4,華南永昌-民權,2024-08-01,9312
3050,鈺德,4,0,4,華南永昌-民權,2024-08-01,9312
2313,華通,17,13,4,華南永昌-民權,2024-08-01,9312
2383,台光電,3,0,3,華南永昌-民權,2024-08-01,9312
00942B,台新美A公司債20+,4,1,3,華南永昌-民權,2024-08-01,9312
1513,中興電,4,1,3,華南永昌-民權,2024-08-01,9312
2812,台中銀,8,5,3,華南永昌-民權,2024-08-01,9312
2393,億光,3,0,3,華南永昌-民權,2024-08-01,9312
00932,兆豐永續高息等權,2090,3,2087,華南永昌-民權,2024-08-02,9312
00929,復華台灣科技優息,357,2,355,華南永昌-民權,2024-08-02,9312
2303,聯電,258,21,237,華南永昌-民權,2024-08-02,9312
00878,國泰永續高股息,167,16,151,華南永昌-民權,2024-08-02,9312
2834,臺企銀,105,4,101,華南永昌-民權,2024-08-02,9312
2337,旺宏,107,16,91,華南永昌-民權,2024-08-02,9312
00679B,元大美債20年,92,7,85,華南永昌-民權,2024-08-02,9312
2317,鴻海,91,15,76,華南永昌-民權,2024-08-02,9312
00919,群益台灣精選高息,222,157,65,華南永昌-民權,2024-08-02,9312
1316,上曜,55,3,52,華南永昌-民權,2024-08-02,9312
00891,中信關鍵半導體,51,0,51,華南永昌-民權,2024-08-02,9312
00936,台新永續高息中小,63,21,42,華南永昌-民權,2024-08-02,9312
00937B,群益ESG投等債20,74,33,41,華南永昌-民權,2024-08-02,9312
00940,元大台灣價值高息,208,167,41,華南永昌-民權,2024-08-02,9312
4564,元翎,85,50,35,華南永昌-民權,2024-08-02,9312
5351,鈺創,32,0,32,華南永昌-民權,2024-08-02,9312
00675L,富邦臺灣加權正2,30,1,29,華南永昌-民權,2024-08-02,9312
2330,台積電,38,10,28,華南永昌-民權,2024-08-02,9312
0056,元大高股息,48,22,26,華南永昌-民權,2024-08-02,9312
00881,國泰台灣5G+,24,0,24,華南永昌-民權,2024-08-02,9312
00918,大華優利高填息30,25,1,24,華南永昌-民權,2024-08-02,9312
2356,英業達,26,2,24,華南永昌-民權,2024-08-02,9312
00795B,中信美國公債20年,26,3,23,華南永昌-民權,2024-08-02,9312
2103,台橡,23,0,23,華南永昌-民權,2024-08-02,9312
00949,復華日本龍頭,24,2,22,華南永昌-民權,2024-08-02,9312
4306,炎洲,21,0,21,華南永昌-民權,2024-08-02,9312
1409,新纖,23,3,20,華南永昌-民權,2024-08-02,9312
3673,TPK-KY,20,0,20,華南永昌-民權,2024-08-02,9312
2515,中工,33,14,19,華南永昌-民權,2024-08-02,9312
2520,冠德,17,1,16,華南永昌-民權,2024-08-02,9312
3049,精金,16,0,16,華南永昌-民權,2024-08-02,9312
00915,凱基優選高股息30,14,0,14,華南永昌-民權,2024-08-02,9312
00900,富邦特選高股息30,14,0,14,華南永昌-民權,2024-08-02,9312
2887,台新金,17,3,14,華南永昌-民權,2024-08-02,9312
2891,中信金,11,0,11,華南永昌-民權,2024-08-02,9312
00753L,中信中國50正2,10,0,10,華南永昌-民權,2024-08-02,9312
00898,國泰基因免疫革命,10,0,10,華南永昌-民權,2024-08-02,9312
00941,中信上游半導體,10,0,10,華南永昌-民權,2024-08-02,9312
1584,精剛,10,0,10,華南永昌-民權,2024-08-02,9312
2023,燁輝,20,10,10,華南永昌-民權,2024-08-02,9312
2347,聯強,10,0,10,華南永昌-民權,2024-08-02,9312
2427,三商電,11,1,10,華南永昌-民權,2024-08-02,9312
3231,緯創,15,6,9,華南永昌-民權,2024-08-02,9312
3715,定穎投控,12,3,9,華南永昌-民權,2024-08-02,9312
2845,遠東銀,9,1,8,華南永昌-民權,2024-08-02,9312
0050,元大台灣50,9,1,8,華南永昌-民權,2024-08-02,9312
00947,台新臺灣IC設計,8,0,8,華南永昌-民權,2024-08-02,9312
00951,台新日本半導體,8,0,8,華南永昌-民權,2024-08-02,9312
1815,富喬,17,9,8,華南永昌-民權,2024-08-02,9312
2408,南亞科,8,0,8,華南永昌-民權,2024-08-02,9312
00929,復華台灣科技優息,356,69,287,華南永昌-民權,2024-08-05,9312
00940,元大台灣價值高息,236,97,139,華南永昌-民權,2024-08-05,9312
2801,彰銀,106,0,106,華南永昌-民權,2024-08-05,9312
2812,台中銀,100,5,95,華南永昌-民權,2024-08-05,9312
2374,佳能,77,0,77,華南永昌-民權,2024-08-05,9312
00878,國泰永續高股息,96,20,76,華南永昌-民權,2024-08-05,9312
2834,臺企銀,72,2,70,華南永昌-民權,2024-08-05,9312
2002,中鋼,67,1,66,華南永昌-民權,2024-08-05,9312
1409,新纖,66,10,56,華南永昌-民權,2024-08-05,9312
2887,台新金,53,1,52,華南永昌-民權,2024-08-05,9312
4906,正文,101,50,51,華南永昌-民權,2024-08-05,9312
0056,元大高股息,64,14,50,華南永昌-民權,2024-08-05,9312
2317,鴻海,56,8,48,華南永昌-民權,2024-08-05,9312
00919,群益台灣精選高息,218,178,40,華南永昌-民權,2024-08-05,9312
00881,國泰台灣5G+,43,4,39,華南永昌-民權,2024-08-05,9312
00936,台新永續高息中小,97,59,38,華南永昌-民權,2024-08-05,9312
00680L,元大美債20正2,65,29,36,華南永昌-民權,2024-08-05,9312
8299,群聯,48,12,36,華南永昌-民權,2024-08-05,9312
2409,友達,35,0,35,華南永昌-民權,2024-08-05,9312
2330,台積電,59,25,34,華南永昌-民權,2024-08-05,9312
3673,TPK-KY,31,2,29,華南永昌-民權,2024-08-05,9312
00932,兆豐永續高息等權,37,11,26,華南永昌-民權,2024-08-05,9312
2365,昆盈,36,10,26,華南永昌-民權,2024-08-05,9312
00946,群益科技高息成長,46,21,25,華南永昌-民權,2024-08-05,9312
5340,建榮,30,5,25,華南永昌-民權,2024-08-05,9312
00918,大華優利高填息30,39,15,24,華南永昌-民權,2024-08-05,9312
00945B,凱基美國非投等債,23,0,23,華南永昌-民權,2024-08-05,9312
2618,長榮航,21,0,21,華南永昌-民權,2024-08-05,9312
2615,萬海,34,14,20,華南永昌-民權,2024-08-05,9312
4306,炎洲,23,3,20,華南永昌-民權,2024-08-05,9312
1447,力鵬,20,0,20,華南永昌-民權,2024-08-05,9312
2353,宏��,25,5,20,華南永昌-民權,2024-08-05,9312
8011,台通,20,0,20,華南永昌-民權,2024-08-05,9312
2891,中信金,21,1,20,華南永昌-民權,2024-08-05,9312
00720B,元大投資級公司債,23,4,19,華南永昌-民權,2024-08-05,9312
3049,精金,19,0,19,華南永昌-民權,2024-08-05,9312
2349,錸德,16,0,16,華南永昌-民權,2024-08-05,9312
2427,三商電,15,0,15,華南永昌-民權,2024-08-05,9312
6757,台灣虎航,15,0,15,華南永昌-民權,2024-08-05,9312
2382,廣達,15,1,14,華南永昌-民權,2024-08-05,9312
2845,遠東銀,17,3,14,華南永昌-民權,2024-08-05,9312
3576,聯合再生,14,0,14,華南永昌-民權,2024-08-05,9312
3260,威剛,13,0,13,華南永昌-民權,2024-08-05,9312
4532,瑞智,16,3,13,華南永昌-民權,2024-08-05,9312
3231,緯創,19,7,12,華南永昌-民權,2024-08-05,9312
2347,聯強,12,0,12,華南永昌-民權,2024-08-05,9312
4123,晟德,12,0,12,華南永昌-民權,2024-08-05,9312
2367,燿華,13,2,11,華南永昌-民權,2024-08-05,9312
2883,凱基金,11,0,11,華南永昌-民權,2024-08-05,9312
3047,訊舟,13,2,11,華南永昌-民權,2024-08-05,9312
00772B,中信高評級公司債,550,10,540,華南永昌-民權,2024-08-06,9312
00679B,元大美債20年,353,133,220,華南永昌-民權,2024-08-06,9312
00940,元大台灣價值高息,118,4,114,華南永昌-民權,2024-08-06,9312
00929,復華台灣科技優息,145,35,110,華南永昌-民權,2024-08-06,9312
00937B,群益ESG投等債20,75,7,68,華南永昌-民權,2024-08-06,9312
00919,群益台灣精選高息,73,9,64,華南永昌-民權,2024-08-06,9312
2337,旺宏,63,0,63,華南永昌-民權,2024-08-06,9312
00632R,元大台灣50反1,96,39,57,華南永昌-民權,2024-08-06,9312
2515,中工,67,13,54,華南永昌-民權,2024-08-06,9312
2834,臺企銀,57,4,53,華南永昌-民權,2024-08-06,9312
00951,台新日本半導體,50,0,50,華南永昌-民權,2024-08-06,9312
3481,群創,93,44,49,華南永昌-民權,2024-08-06,9312
00878,國泰永續高股息,50,3,47,華南永昌-民權,2024-08-06,9312
00637L,元大滬深300正2,45,0,45,華南永昌-民權,2024-08-06,9312
3652,精聯,45,6,39,華南永昌-民權,2024-08-06,9312
1438,三地開發,41,2,39,華南永昌-民權,2024-08-06,9312
5519,隆大,40,3,37,華南永昌-民權,2024-08-06,9312
00948B,中信優息投資級債,40,10,30,華南永昌-民權,2024-08-06,9312
2884,玉山金,33,3,30,華南永昌-民權,2024-08-06,9312
1711,永光,24,0,24,華南永昌-民權,2024-08-06,9312
1409,新纖,22,0,22,華南永昌-民權,2024-08-06,9312
00936,台新永續高息中小,29,8,21,華南永昌-民權,2024-08-06,9312
2887,台新金,55,34,21,華南永昌-民權,2024-08-06,9312
00753L,中信中國50正2,20,0,20,華南永昌-民權,2024-08-06,9312
3024,憶聲,20,0,20,華南永昌-民權,2024-08-06,9312
3516,亞帝歐,20,0,20,華南永昌-民權,2024-08-06,9312
6799,來頡,20,0,20,華南永昌-民權,2024-08-06,9312
00680L,元大美債20正2,30,11,19,華南永昌-民權,2024-08-06,9312
2383,台光電,31,12,19,華南永昌-民權,2024-08-06,9312
6187,萬潤,31,13,18,華南永昌-民權,2024-08-06,9312
006208,富邦台50,20,3,17,華南永昌-民權,2024-08-06,9312
0056,元大高股息,19,2,17,華南永昌-民權,2024-08-06,9312
1410,南染,15,0,15,華南永昌-民權,2024-08-06,9312
2374,佳能,21,7,14,華南永昌-民權,2024-08-06,9312
6770,力積電,12,0,12,華南永昌-民權,2024-08-06,9312
00949,復華日本龍頭,12,1,11,華南永昌-民權,2024-08-06,9312
8039,台虹,24,13,11,華南永昌-民權,2024-08-06,9312
5469,瀚宇博,10,0,10,華南永昌-民權,2024-08-06,9312
5508,永信建,18,9,9,華南永昌-民權,2024-08-06,9312
2409,友達,9,0,9,華南永昌-民權,2024-08-06,9312
2888,新光金,72,63,9,華南永昌-民權,2024-08-06,9312
2002,中鋼,10,2,8,華南永昌-民權,2024-08-06,9312
2388,威盛,9,1,8,華南永昌-民權,2024-08-06,9312
2597,潤弘,8,0,8,華南永昌-民權,2024-08-06,9312
3049,精金,8,0,8,華南永昌-民權,2024-08-06,9312
3163,波若威,21,13,8,華南永昌-民權,2024-08-06,9312
3374,精材,12,4,8,華南永昌-民權,2024-08-06,9312
4306,炎洲,9,2,7,華南永昌-民權,2024-08-06,9312
1514,亞力,26,19,7,華南永昌-民權,2024-08-06,9312
3033,威健,8,1,7,華南永昌-民權,2024-08-06,9312
00772B,中信高評級公司債,1111,0,1111,華南永昌-民權,2024-08-07,9312
00679B,元大美債20年,689,60,629,華南永昌-民權,2024-08-07,9312
00940,元大台灣價值高息,63,0,63,華南永昌-民權,2024-08-07,9312
00633L,富邦上証正2,46,0,46,華南永昌-民權,2024-08-07,9312
00878,國泰永續高股息,43,0,43,華南永昌-民權,2024-08-07,9312
00929,復華台灣科技優息,52,13,39,華南永昌-民權,2024-08-07,9312
6187,萬潤,33,1,32,華南永昌-民權,2024-08-07,9312
8112,至上,41,11,30,華南永昌-民權,2024-08-07,9312
3313,斐成,30,0,30,華南永昌-民權,2024-08-07,9312
00680L,元大美債20正2,30,2,28,華南永昌-民權,2024-08-07,9312
00939,統一台灣高息動能,20,0,20,華南永昌-民權,2024-08-07,9312
2812,台中銀,20,0,20,華南永昌-民權,2024-08-07,9312
6120,達運,20,0,20,華南永昌-民權,2024-08-07,9312
00900,富邦特選高股息30,20,0,20,華南永昌-民權,2024-08-07,9312
2383,台光電,25,7,18,華南永昌-民權,2024-08-07,9312
3652,精聯,20,4,16,華南永昌-民權,2024-08-07,9312
2317,鴻海,27,12,15,華南永昌-民權,2024-08-07,9312
00795B,中信美國公債20年,13,0,13,華南永昌-民權,2024-08-07,9312
00632R,元大台灣50反1,16,3,13,華南永昌-民權,2024-08-07,9312
5519,隆大,13,1,12,華南永昌-民權,2024-08-07,9312
3481,群創,38,27,11,華南永昌-民權,2024-08-07,9312
2338,光罩,10,0,10,華南永昌-民權,2024-08-07,9312
2887,台新金,14,4,10,華南永昌-民權,2024-08-07,9312
2027,大成鋼,10,0,10,華南永昌-民權,2024-08-07,9312
4113,聯上,10,0,10,華南永昌-民權,2024-08-07,9312
4904,遠傳,10,0,10,華南永昌-民權,2024-08-07,9312
5531,鄉林,13,3,10,華南永昌-民權,2024-08-07,9312
2524,京城,9,0,9,華南永昌-民權,2024-08-07,9312
3661,世芯-KY,10,1,9,華南永昌-民權,2024-08-07,9312
2002,中鋼,11,3,8,華南永昌-民權,2024-08-07,9312
5508,永信建,21,13,8,華南永昌-民權,2024-08-07,9312
00946,群益科技高息成長,7,0,7,華南永昌-民權,2024-08-07,9312
2745,五福,7,0,7,華南永昌-民權,2024-08-07,9312
6213,聯茂,9,2,7,華南永昌-民權,2024-08-07,9312
0056,元大高股息,7,0,7,華南永昌-民權,2024-08-07,9312
3034,聯詠,6,0,6,華南永昌-民權,2024-08-07,9312
9955,佳龍,10,4,6,華南永昌-民權,2024-08-07,9312
1314,中石化,24,18,6,華南永昌-民權,2024-08-07,9312
1529,樂事綠能,5,0,5,華南永昌-民權,2024-08-07,9312
1785,光洋科,15,10,5,華南永昌-民權,2024-08-07,9312
2867,三商壽,5,0,5,華南永昌-民權,2024-08-07,9312
6257,矽格,5,0,5,華南永昌-民權,2024-08-07,9312
2886,兆豐金,4,0,4,華南永昌-民權,2024-08-07,9312
00937B,群益ESG投等債20,4,0,4,華南永昌-民權,2024-08-07,9312
00715L,期街口布蘭特正2,4,0,4,華南永昌-民權,2024-08-07,9312
2363,矽統,5,1,4,華南永昌-民權,2024-08-07,9312
2408,南亞科,5,1,4,華南永昌-民權,2024-08-07,9312
3062,建漢,7,3,4,華南永昌-民權,2024-08-07,9312
6139,亞翔,6,2,4,華南永昌-民權,2024-08-07,9312
6153,嘉聯益,4,0,4,華南永昌-民權,2024-08-07,9312
00632R,元大台灣50反1,110,16,94,華南永昌-民權,2024-08-08,9312
00929,復華台灣科技優息,57,1,56,華南永昌-民權,2024-08-08,9312
2515,中工,54,0,54,華南永昌-民權,2024-08-08,9312
2888,新光金,62,10,52,華南永昌-民權,2024-08-08,9312
3481,群創,62,11,51,華南永昌-民權,2024-08-08,9312
00669R,國泰美國道瓊反1,50,0,50,華南永昌-民權,2024-08-08,9312
6269,台郡,49,2,47,華南永昌-民權,2024-08-08,9312
00679B,元大美債20年,54,12,42,華南永昌-民權,2024-08-08,9312
2897A,王道銀甲特,31,0,31,華南永昌-民權,2024-08-08,9312
4113,聯上,30,0,30,華南永昌-民權,2024-08-08,9312
8927,北基,30,0,30,華南永昌-民權,2024-08-08,9312
2834,臺企銀,57,33,24,華南永昌-民權,2024-08-08,9312
00940,元大台灣價值高息,22,0,22,華南永昌-民權,2024-08-08,9312
00687B,國泰20年美債,32,10,22,華南永昌-民權,2024-08-08,9312
2615,萬海,28,10,18,華南永昌-民權,2024-08-08,9312
2317,鴻海,30,13,17,華南永昌-民權,2024-08-08,9312
00919,群益台灣精選高息,29,13,16,華南永昌-民權,2024-08-08,9312
3581,博磊,15,0,15,華南永昌-民權,2024-08-08,9312
4566,時碩工業,16,2,14,華南永昌-民權,2024-08-08,9312
00878,國泰永續高股息,14,1,13,華南永昌-民權,2024-08-08,9312
00795B,中信美國公債20年,13,0,13,華南永昌-民權,2024-08-08,9312
00680L,元大美債20正2,12,0,12,華南永昌-民權,2024-08-08,9312
1326,台化,12,0,12,華南永昌-民權,2024-08-08,9312
00937B,群益ESG投等債20,11,0,11,華南永昌-民權,2024-08-08,9312
2892,第一金,10,0,10,華南永昌-民權,2024-08-08,9312
2610,華航,10,0,10,華南永昌-民權,2024-08-08,9312
1540,喬福,38,29,9,華南永昌-民權,2024-08-08,9312
5222,全訊,9,0,9,華南永昌-民權,2024-08-08,9312
2382,廣達,9,2,7,華南永昌-民權,2024-08-08,9312
2838,聯邦銀,7,0,7,華南永昌-民權,2024-08-08,9312
2867,三商壽,7,0,7,華南永昌-民權,2024-08-08,9312
00735,國泰臺韓科技,6,0,6,華南永昌-民權,2024-08-08,9312
006208,富邦台50,6,0,6,華南永昌-民權,2024-08-08,9312
00941,中信上游半導體,6,0,6,華南永昌-民權,2024-08-08,9312
5392,能率,6,0,6,華南永昌-民權,2024-08-08,9312
5443,均豪,6,0,6,華南永昌-民權,2024-08-08,9312
00936,台新永續高息中小,7,1,6,華南永昌-民權,2024-08-08,9312
1514,亞力,5,0,5,華南永昌-民權,2024-08-08,9312
1529,樂事綠能,6,1,5,華南永昌-民權,2024-08-08,9312
2002,中鋼,5,0,5,華南永昌-民權,2024-08-08,9312
2014,中鴻,5,0,5,華南永昌-民權,2024-08-08,9312
2324,仁寶,5,0,5,華南永昌-民權,2024-08-08,9312
2743,山富,5,0,5,華南永昌-民權,2024-08-08,9312
2851,中再保,5,0,5,華南永昌-民權,2024-08-08,9312
3516,亞帝歐,5,0,5,華南永昌-民權,2024-08-08,9312
4919,新唐,5,0,5,華南永昌-民權,2024-08-08,9312
8011,台通,5,0,5,華南永昌-民權,2024-08-08,9312
8105,凌巨,5,0,5,華南永昌-民權,2024-08-08,9312
1519,華城,7,2,5,華南永昌-民權,2024-08-08,9312
00948B,中信優息投資級債,5,0,5,華南永昌-民權,2024-08-08,9312
00719B,元大美債1-3,550,0,550,華南永昌-民權,2024-08-09,9312
00639,富邦深100,100,0,100,華南永昌-民權,2024-08-09,9312
00632R,元大台灣50反1,93,3,90,華南永昌-民權,2024-08-09,9312
00687B,國泰20年美債,74,0,74,華南永昌-民權,2024-08-09,9312
00937B,群益ESG投等債20,65,8,57,華南永昌-民權,2024-08-09,9312
00720B,元大投資級公司債,50,0,50,華南永昌-民權,2024-08-09,9312
00664R,國泰臺灣加權反1,45,0,45,華南永昌-民權,2024-08-09,9312
00933B,國泰10Y+金融債,42,0,42,華南永昌-民權,2024-08-09,9312
00679B,元大美債20年,42,2,40,華南永昌-民權,2024-08-09,9312
1609,大亞,45,6,39,華南永昌-民權,2024-08-09,9312
00680L,元大美債20正2,33,0,33,華南永昌-民權,2024-08-09,9312
2383,台光電,32,1,31,華南永昌-民權,2024-08-09,9312
6432,今展科,21,0,21,華南永昌-民權,2024-08-09,9312
8927,北基,30,10,20,華南永昌-民權,2024-08-09,9312
00940,元大台灣價值高息,37,20,17,華南永昌-民權,2024-08-09,9312
00795B,中信美國公債20年,16,0,16,華南永昌-民權,2024-08-09,9312
1540,喬福,16,0,16,華南永昌-民權,2024-08-09,9312
2897A,王道銀甲特,15,0,15,華南永昌-民權,2024-08-09,9312
2337,旺宏,17,3,14,華南永昌-民權,2024-08-09,9312
2515,中工,18,5,13,華南永昌-民權,2024-08-09,9312
8039,台虹,11,0,11,華南永昌-民權,2024-08-09,9312
2603,長榮,17,6,11,華南永昌-民權,2024-08-09,9312
00932,兆豐永續高息等權,10,0,10,華南永昌-民權,2024-08-09,9312
1529,樂事綠能,16,6,10,華南永昌-民權,2024-08-09,9312
1799,易威,10,0,10,華南永昌-民權,2024-08-09,9312
2374,佳能,11,1,10,華南永昌-民權,2024-08-09,9312
2481,強茂,15,5,10,華南永昌-民權,2024-08-09,9312
2597,潤弘,10,0,10,華南永昌-民權,2024-08-09,9312
5519,隆大,11,1,10,華南永昌-民權,2024-08-09,9312
8105,凌巨,10,0,10,華南永昌-民權,2024-08-09,9312
9105,泰金寶-DR,9,0,9,華南永昌-民權,2024-08-09,9312
00919,群益台灣精選高息,10,1,9,華南永昌-民權,2024-08-09,9312
2731,雄獅,10,2,8,華南永昌-民權,2024-08-09,9312
3047,訊舟,12,4,8,華南永昌-民權,2024-08-09,9312
3163,波若威,8,0,8,華南永昌-民權,2024-08-09,9312
3576,聯合再生,11,3,8,華南永昌-民權,2024-08-09,9312
8021,尖點,8,0,8,華南永昌-民權,2024-08-09,9312
2353,宏��,8,1,7,華南永昌-民權,2024-08-09,9312
1718,中纖,6,0,6,華南永昌-民權,2024-08-09,9312
2103,台橡,6,0,6,華南永昌-民權,2024-08-09,9312
2489,瑞軒,11,5,6,華南永昌-民權,2024-08-09,9312
4513,福裕,7,1,6,華南永昌-民權,2024-08-09,9312
8473,山林水,5,0,5,華南永昌-民權,2024-08-09,9312
00948B,中信優息投資級債,5,0,5,華南永昌-民權,2024-08-09,9312
1325,恆大,5,0,5,華南永昌-民權,2024-08-09,9312
3048,益登,27,22,5,華南永昌-民權,2024-08-09,9312
3322,建舜電,5,0,5,華南永昌-民權,2024-08-09,9312
6603,富強鑫,6,1,5,華南永昌-民權,2024-08-09,9312
8048,德勝,5,0,5,華南永昌-民權,2024-08-09,9312
3231,緯創,13,9,4,華南永昌-民權,2024-08-09,9312
00720B,元大投資級公司債,250,0,250,華南永昌-民權,2024-08-12,9312
2888,新光金,214,36,178,華南永昌-民權,2024-08-12,9312
00679B,元大美債20年,141,0,141,華南永昌-民權,2024-08-12,9312
00632R,元大台灣50反1,109,0,109,華南永昌-民權,2024-08-12,9312
00719B,元大美債1-3,100,10,90,華南永昌-民權,2024-08-12,9312
00664R,國泰臺灣加權反1,50,0,50,華南永昌-民權,2024-08-12,9312
00795B,中信美國公債20年,45,0,45,華南永昌-民權,2024-08-12,9312
2312,金寶,51,15,36,華南永昌-民權,2024-08-12,9312
3374,精材,31,0,31,華南永昌-民權,2024-08-12,9312
00900,富邦特選高股息30,23,0,23,華南永昌-民權,2024-08-12,9312
6120,達運,21,0,21,華南永昌-民權,2024-08-12,9312
00878,國泰永續高股息,27,7,20,華南永昌-民權,2024-08-12,9312
3356,奇偶,21,1,20,華南永昌-民權,2024-08-12,9312
00687B,國泰20年美債,20,2,18,華南永昌-民權,2024-08-12,9312
00937B,群益ESG投等債20,18,0,18,華南永昌-民權,2024-08-12,9312
2610,華航,22,5,17,華南永昌-民權,2024-08-12,9312
3189,景碩,28,11,17,華南永昌-民權,2024-08-12,9312
2367,燿華,16,0,16,華南永昌-民權,2024-08-12,9312
3024,憶聲,16,0,16,華南永昌-民權,2024-08-12,9312
1301,台塑,13,0,13,華南永昌-民權,2024-08-12,9312
2891,中信金,13,0,13,華南永昌-民權,2024-08-12,9312
00919,群益台灣精選高息,29,18,11,華南永昌-民權,2024-08-12,9312
2880,華南金,10,0,10,華南永昌-民權,2024-08-12,9312
00936,台新永續高息中小,11,1,10,華南永昌-民權,2024-08-12,9312
00685L,群益臺灣加權正2,10,0,10,華南永昌-民權,2024-08-12,9312
1314,中石化,45,35,10,華南永昌-民權,2024-08-12,9312
1529,樂事綠能,10,0,10,華南永昌-民權,2024-08-12,9312
2429,銘旺科,10,0,10,華南永昌-民權,2024-08-12,9312
5533,皇鼎,10,0,10,華南永昌-民權,2024-08-12,9312
4562,穎漢,33,26,7,華南永昌-民權,2024-08-12,9312
2887,台新金,13,6,7,華南永昌-民權,2024-08-12,9312
00773B,中信優先金融債,7,0,7,華南永昌-民權,2024-08-12,9312
2002,中鋼,7,0,7,華南永昌-民權,2024-08-12,9312
3665,貿聯-KY,7,0,7,華南永昌-民權,2024-08-12,9312
1514,亞力,14,8,6,華南永昌-民權,2024-08-12,9312
1795,美時,6,0,6,華南永昌-民權,2024-08-12,9312
2884,玉山金,6,0,6,華南永昌-民權,2024-08-12,9312
4523,永彰,6,0,6,華南永昌-民權,2024-08-12,9312
6499,益安,6,0,6,華南永昌-民權,2024-08-12,9312
9931,欣高,6,0,6,華南永昌-民權,2024-08-12,9312
2409,友達,6,1,5,華南永昌-民權,2024-08-12,9312
1608,華榮,5,0,5,華南永昌-民權,2024-08-12,9312
6215,和椿,6,1,5,華南永昌-民權,2024-08-12,9312
2834,臺企銀,16,11,5,華南永昌-民權,2024-08-12,9312
6609,瀧澤科,5,1,4,華南永昌-民權,2024-08-12,9312
3712,永崴投控,4,0,4,華南永昌-民權,2024-08-12,9312
5443,均豪,28,24,4,華南永昌-民權,2024-08-12,9312
3535,晶彩科,5,2,3,華南永昌-民權,2024-08-12,9312
3260,威剛,3,0,3,華南永昌-民權,2024-08-12,9312
2359,所羅門,6,3,3,華南永昌-民權,2024-08-12,9312
00720B,元大投資級公司債,510,0,510,華南永昌-民權,2024-08-13,9312
00719B,元大美債1-3,300,0,300,華南永昌-民權,2024-08-13,9312
00639,富邦深100,100,0,100,華南永昌-民權,2024-08-13,9312
00687B,國泰20年美債,54,0,54,華南永昌-民權,2024-08-13,9312
6269,台郡,40,2,38,華南永昌-民權,2024-08-13,9312
00946,群益科技高息成長,32,0,32,華南永昌-民權,2024-08-13,9312
1326,台化,23,0,23,華南永昌-民權,2024-08-13,9312
6108,競國,20,0,20,華南永昌-民權,2024-08-13,9312
1303,南亞,17,0,17,華南永昌-民權,2024-08-13,9312
00919,群益台灣精選高息,20,4,16,華南永昌-民權,2024-08-13,9312
2880,華南金,26,11,15,華南永昌-民權,2024-08-13,9312
00676R,富邦臺灣加權反1,15,0,15,華南永昌-民權,2024-08-13,9312
00948B,中信優息投資級債,15,0,15,華南永昌-民權,2024-08-13,9312
2489,瑞軒,18,3,15,華南永昌-民權,2024-08-13,9312
00937B,群益ESG投等債20,14,0,14,華南永昌-民權,2024-08-13,9312
1301,台塑,14,0,14,華南永昌-民權,2024-08-13,9312
6838,台新藥,13,1,12,華南永昌-民權,2024-08-13,9312
1436,華友聯,10,0,10,華南永昌-民權,2024-08-13,9312
2409,友達,10,0,10,華南永昌-民權,2024-08-13,9312
6438,迅得,10,0,10,華南永昌-民權,2024-08-13,9312
3661,世芯-KY,11,1,10,華南永昌-民權,2024-08-13,9312
00795B,中信美國公債20年,9,0,9,華南永昌-民權,2024-08-13,9312
6207,雷科,10,1,9,華南永昌-民權,2024-08-13,9312
00878,國泰永續高股息,9,0,9,華南永昌-民權,2024-08-13,9312
2609,陽明,19,10,9,華南永昌-民權,2024-08-13,9312
1529,樂事綠能,8,0,8,華南永昌-民權,2024-08-13,9312
2610,華航,8,0,8,華南永昌-民權,2024-08-13,9312
0050,元大台灣50,8,1,7,華南永昌-民權,2024-08-13,9312
3691,碩禾,20,13,7,華南永昌-民權,2024-08-13,9312
2615,萬海,24,17,7,華南永昌-民權,2024-08-13,9312
00715L,期街口布蘭特正2,10,4,6,華南永昌-民權,2024-08-13,9312
00632R,元大台灣50反1,6,0,6,華南永昌-民權,2024-08-13,9312
1584,精剛,10,4,6,華南永昌-民權,2024-08-13,9312
2429,銘旺科,6,0,6,華南永昌-民權,2024-08-13,9312
4960,誠美材,7,1,6,華南永昌-民權,2024-08-13,9312
9105,泰金寶-DR,6,0,6,華南永昌-民權,2024-08-13,9312
3450,聯鈞,10,5,5,華南永昌-民權,2024-08-13,9312
00900,富邦特選高股息30,5,0,5,華南永昌-民權,2024-08-13,9312
1514,亞力,12,7,5,華南永昌-民權,2024-08-13,9312
2362,藍天,6,1,5,華南永昌-民權,2024-08-13,9312
2365,昆盈,37,32,5,華南永昌-民權,2024-08-13,9312
2515,中工,5,0,5,華南永昌-民權,2024-08-13,9312
2597,潤弘,15,10,5,華南永昌-民權,2024-08-13,9312
3289,宜特,5,0,5,華南永昌-民權,2024-08-13,9312
4714,永捷,5,0,5,華南永昌-民權,2024-08-13,9312
6928,攸泰科技,5,0,5,華南永昌-民權,2024-08-13,9312
9931,欣高,5,0,5,華南永昌-民權,2024-08-13,9312
1513,中興電,15,10,5,華南永昌-民權,2024-08-13,9312
2383,台光電,5,1,4,華南永昌-民權,2024-08-13,9312
00891,中信關鍵半導體,4,0,4,華南永昌-民權,2024-08-13,9312
2801,彰銀,106,1,105,華南永昌-民權,2024-08-14,9312
00687B,國泰20年美債,54,5,49,華南永昌-民權,2024-08-14,9312
6269,台郡,44,0,44,華南永昌-民權,2024-08-14,9312
8107,大億金茂,40,0,40,華南永昌-民權,2024-08-14,9312
3037,欣興,41,3,38,華南永昌-民權,2024-08-14,9312
00795B,中信美國公債20年,56,20,36,華南永昌-民權,2024-08-14,9312
4716,大立,36,0,36,華南永昌-民權,2024-08-14,9312
1714,和桐,34,0,34,華南永昌-民權,2024-08-14,9312
00688L,國泰20年美債正2,29,0,29,華南永昌-民權,2024-08-14,9312
8096,擎亞,31,9,22,華南永昌-民權,2024-08-14,9312
3481,群創,60,40,20,華南永昌-民權,2024-08-14,9312
00720B,元大投資級公司債,20,0,20,華南永昌-民權,2024-08-14,9312
6152,百一,20,0,20,華南永昌-民權,2024-08-14,9312
8916,光隆,20,0,20,華南永昌-民權,2024-08-14,9312
2344,華邦電,120,101,19,華南永昌-民權,2024-08-14,9312
2509,全坤建,19,0,19,華南永昌-民權,2024-08-14,9312
2886,兆豐金,20,1,19,華南永昌-民權,2024-08-14,9312
00900,富邦特選高股息30,17,0,17,華南永昌-民權,2024-08-14,9312
1609,大亞,24,7,17,華南永昌-民權,2024-08-14,9312
00637L,元大滬深300正2,15,0,15,華南永昌-民權,2024-08-14,9312
3607,谷崧,15,0,15,華南永昌-民權,2024-08-14,9312
2374,佳能,15,1,14,華南永昌-民權,2024-08-14,9312
3652,精聯,12,0,12,華南永昌-民權,2024-08-14,9312
00715L,期街口布蘭特正2,11,0,11,華南永昌-民權,2024-08-14,9312
2615,萬海,17,7,10,華南永昌-民權,2024-08-14,9312
00946,群益科技高息成長,10,0,10,華南永昌-民權,2024-08-14,9312
1608,華榮,10,0,10,華南永昌-民權,2024-08-14,9312
2312,金寶,13,3,10,華南永昌-民權,2024-08-14,9312
2323,中環,10,0,10,華南永昌-民權,2024-08-14,9312
2364,倫飛,10,0,10,華南永昌-民權,2024-08-14,9312
2743,山富,10,0,10,華南永昌-民權,2024-08-14,9312
4113,聯上,10,0,10,華南永昌-民權,2024-08-14,9312
6108,競國,10,0,10,華南永昌-民權,2024-08-14,9312
9924,福興,10,0,10,華南永昌-民權,2024-08-14,9312
6126,信音,10,0,10,華南永昌-民權,2024-08-14,9312
1514,亞力,8,0,8,華南永昌-民權,2024-08-14,9312
2489,瑞軒,11,3,8,華南永昌-民權,2024-08-14,9312
2352,佳世達,7,0,7,華南永昌-民權,2024-08-14,9312
2382,廣達,8,2,6,華南永昌-民權,2024-08-14,9312
1503,士電,8,2,6,華南永昌-民權,2024-08-14,9312
2317,鴻海,14,8,6,華南永昌-民權,2024-08-14,9312
8064,東捷,16,11,5,華南永昌-民權,2024-08-14,9312
00882,中信中國高股息,5,0,5,華南永昌-民權,2024-08-14,9312
00685L,群益臺灣加權正2,5,0,5,華南永昌-民權,2024-08-14,9312
00632R,元大台灣50反1,5,0,5,華南永昌-民權,2024-08-14,9312
9912,偉聯,5,0,5,華南永昌-民權,2024-08-14,9312
00631L,元大台灣50正2,6,1,5,華南永昌-民權,2024-08-14,9312
00642U,期元大S＆P石油,4,0,4,華南永昌-民權,2024-08-14,9312
1795,美時,5,1,4,華南永昌-民權,2024-08-14,9312
2397,友通,4,0,4,華南永昌-民權,2024-08-14,9312
00720B,元大投資級公司債,1245,0,1245,華南永昌-民權,2024-08-15,9312
00632R,元大台灣50反1,360,100,260,華南永昌-民權,2024-08-15,9312
2801,彰銀,201,1,200,華南永昌-民權,2024-08-15,9312
8916,光隆,130,0,130,華南永昌-民權,2024-08-15,9312
00900,富邦特選高股息30,108,0,108,華南永昌-民權,2024-08-15,9312
6706,惠特,101,0,101,華南永昌-民權,2024-08-15,9312
3652,精聯,74,2,72,華南永昌-民權,2024-08-15,9312
00795B,中信美國公債20年,71,24,47,華南永昌-民權,2024-08-15,9312
6269,台郡,43,0,43,華南永昌-民權,2024-08-15,9312
9924,福興,40,0,40,華南永昌-民權,2024-08-15,9312
1326,台化,39,0,39,華南永昌-民權,2024-08-15,9312
2324,仁寶,41,2,39,華南永昌-民權,2024-08-15,9312
2867,三商壽,51,12,39,華南永昌-民權,2024-08-15,9312
1609,大亞,39,2,37,華南永昌-民權,2024-08-15,9312
2344,華邦電,32,0,32,華南永昌-民權,2024-08-15,9312
2905,三商,30,0,30,華南永昌-民權,2024-08-15,9312
2501,國建,30,1,29,華南永昌-民權,2024-08-15,9312
2597,潤弘,25,0,25,華南永昌-民權,2024-08-15,9312
2002,中鋼,35,12,23,華南永昌-民權,2024-08-15,9312
00937B,群益ESG投等債20,38,16,22,華南永昌-民權,2024-08-15,9312
2520,冠德,20,0,20,華南永昌-民權,2024-08-15,9312
2885,元大金,20,0,20,華南永昌-民權,2024-08-15,9312
00932,兆豐永續高息等權,18,1,17,華南永昌-民權,2024-08-15,9312
8039,台虹,15,0,15,華南永昌-民權,2024-08-15,9312
00929,復華台灣科技優息,31,17,14,華南永昌-民權,2024-08-15,9312
00715L,期街口布蘭特正2,13,0,13,華南永昌-民權,2024-08-15,9312
00688L,國泰20年美債正2,12,1,11,華南永昌-民權,2024-08-15,9312
1453,大將,11,0,11,華南永昌-民權,2024-08-15,9312
2303,聯電,11,0,11,華南永昌-民權,2024-08-15,9312
00773B,中信優先金融債,10,0,10,華南永昌-民權,2024-08-15,9312
2367,燿華,23,13,10,華南永昌-民權,2024-08-15,9312
4904,遠傳,10,0,10,華南永昌-民權,2024-08-15,9312
6492,生華科,10,0,10,華南永昌-民權,2024-08-15,9312
9105,泰金寶-DR,10,0,10,華南永昌-民權,2024-08-15,9312
2349,錸德,10,1,9,華南永昌-民權,2024-08-15,9312
00878,國泰永續高股息,10,3,7,華南永昌-民權,2024-08-15,9312
00919,群益台灣精選高息,6,0,6,華南永昌-民權,2024-08-15,9312
00927,群益半導體收益,6,0,6,華南永昌-民權,2024-08-15,9312
2889,國票金,6,0,6,華南永昌-民權,2024-08-15,9312
3711,日月光投控,7,1,6,華南永昌-民權,2024-08-15,9312
2886,兆豐金,7,2,5,華南永昌-民權,2024-08-15,9312
8374,羅昇,6,1,5,華南永昌-民權,2024-08-15,9312
00650L,復華香港正2,5,0,5,華南永昌-民權,2024-08-15,9312
1584,精剛,6,1,5,華南永昌-民權,2024-08-15,9312
2527,宏璟,5,0,5,華南永昌-民權,2024-08-15,9312
2891,中信金,5,0,5,華南永昌-民權,2024-08-15,9312
3516,亞帝歐,5,0,5,華南永昌-民權,2024-08-15,9312
5880,合庫金,5,0,5,華南永昌-民權,2024-08-15,9312
6488,環球晶,5,0,5,華南永昌-民權,2024-08-15,9312
8299,群聯,6,1,5,華南永昌-民權,2024-08-15,9312
00664R,國泰臺灣加權反1,524,0,524,華南永昌-民權,2024-08-16,9312
2344,華邦電,82,2,80,華南永昌-民權,2024-08-16,9312
00632R,元大台灣50反1,125,70,55,華南永昌-民權,2024-08-16,9312
00687B,國泰20年美債,51,4,47,華南永昌-民權,2024-08-16,9312
00679B,元大美債20年,41,0,41,華南永昌-民權,2024-08-16,9312
2383,台光電,32,0,32,華南永昌-民權,2024-08-16,9312
1303,南亞,25,1,24,華南永昌-民權,2024-08-16,9312
00795B,中信美國公債20年,24,0,24,華南永昌-民權,2024-08-16,9312
1326,台化,21,0,21,華南永昌-民權,2024-08-16,9312
00688L,國泰20年美債正2,21,0,21,華南永昌-民權,2024-08-16,9312
2905,三商,20,0,20,華南永昌-民權,2024-08-16,9312
5522,遠雄,20,0,20,華南永昌-民權,2024-08-16,9312
1611,中電,18,2,16,華南永昌-民權,2024-08-16,9312
00680L,元大美債20正2,15,0,15,華南永昌-民權,2024-08-16,9312
1609,大亞,36,21,15,華南永昌-民權,2024-08-16,9312
9955,佳龍,12,0,12,華南永昌-民權,2024-08-16,9312
3661,世芯-KY,20,9,11,華南永昌-民權,2024-08-16,9312
8096,擎亞,11,0,11,華南永昌-民權,2024-08-16,9312
2401,凌陽,10,0,10,華南永昌-民權,2024-08-16,9312
5483,中美晶,10,0,10,華南永昌-民權,2024-08-16,9312
6449,鈺邦,10,0,10,華南永昌-民權,2024-08-16,9312
2062,橋椿,25,16,9,華南永昌-民權,2024-08-16,9312
2353,宏��,9,0,9,華南永昌-民權,2024-08-16,9312
2489,瑞軒,13,6,7,華南永昌-民權,2024-08-16,9312
4561,健椿,8,1,7,華南永昌-民權,2024-08-16,9312
00878,國泰永續高股息,7,0,7,華南永昌-民權,2024-08-16,9312
0050,元大台灣50,6,0,6,華南永昌-民權,2024-08-16,9312
9958,世紀鋼,6,0,6,華南永昌-民權,2024-08-16,9312
2812,台中銀,10,4,6,華南永昌-民權,2024-08-16,9312
00900,富邦特選高股息30,6,0,6,華南永昌-民權,2024-08-16,9312
2324,仁寶,10,4,6,華南永昌-民權,2024-08-16,9312
4562,穎漢,18,13,5,華南永昌-民權,2024-08-16,9312
1711,永光,5,0,5,華南永昌-民權,2024-08-16,9312
3209,全科,5,0,5,華南永昌-民權,2024-08-16,9312
3607,谷崧,5,0,5,華南永昌-民權,2024-08-16,9312
5905,南仁湖,5,0,5,華南永昌-民權,2024-08-16,9312
1301,台塑,4,0,4,華南永昌-民權,2024-08-16,9312
00942B,台新美A公司債20+,4,0,4,華南永昌-民權,2024-08-16,9312
2208,台船,5,1,4,華南永昌-民權,2024-08-16,9312
2467,志聖,12,8,4,華南永昌-民權,2024-08-16,9312
2537,聯上發,4,0,4,華南永昌-民權,2024-08-16,9312
2834,臺企銀,4,0,4,華南永昌-民權,2024-08-16,9312
4540,全球傳動,6,2,4,華南永昌-民權,2024-08-16,9312
4905,台聯電,4,0,4,華南永昌-民權,2024-08-16,9312
6532,瑞耘,4,0,4,華南永昌-民權,2024-08-16,9312
1109,信大,3,0,3,華南永昌-民權,2024-08-16,9312
1785,光洋科,9,6,3,華南永昌-民權,2024-08-16,9312
2365,昆盈,9,6,3,華南永昌-民權,2024-08-16,9312
2367,燿華,3,0,3,華南永昌-民權,2024-08-16,9312
2455,全新,3,0,3,華南永昌-民權,2024-08-16,9312
2344,華邦電,807,3,804,華南永昌-民權,2024-08-19,9312
8916,光隆,55,0,55,華南永昌-民權,2024-08-19,9312
5483,中美晶,50,0,50,華南永昌-民權,2024-08-19,9312
9924,福興,50,0,50,華南永昌-民權,2024-08-19,9312
2002,中鋼,41,0,41,華南永昌-民權,2024-08-19,9312
00929,復華台灣科技優息,40,2,38,華南永昌-民權,2024-08-19,9312
00687B,國泰20年美債,31,0,31,華南永昌-民權,2024-08-19,9312
1540,喬福,28,0,28,華南永昌-民權,2024-08-19,9312
00948B,中信優息投資級債,20,0,20,華南永昌-民權,2024-08-19,9312
1326,台化,20,0,20,華南永昌-民權,2024-08-19,9312
00715L,期街口布蘭特正2,17,0,17,華南永昌-民權,2024-08-19,9312
5522,遠雄,15,0,15,華南永昌-民權,2024-08-19,9312
5426,振發,14,0,14,華南永昌-民權,2024-08-19,9312
00927,群益半導體收益,12,0,12,華南永昌-民權,2024-08-19,9312
00923,群益台ESG低碳50,11,0,11,華南永昌-民權,2024-08-19,9312
00907,永豐優息存股,10,0,10,華南永昌-民權,2024-08-19,9312
00680L,元大美債20正2,10,0,10,華南永昌-民權,2024-08-19,9312
00632R,元大台灣50反1,10,0,10,華南永昌-民權,2024-08-19,9312
00945B,凱基美國非投等債,10,0,10,華南永昌-民權,2024-08-19,9312
2364,倫飛,10,0,10,華南永昌-民權,2024-08-19,9312
3518,柏騰,10,0,10,華南永昌-民權,2024-08-19,9312
3607,谷崧,10,0,10,華南永昌-民權,2024-08-19,9312
4113,聯上,10,0,10,華南永昌-民權,2024-08-19,9312
6266,泰詠,10,0,10,華南永昌-民權,2024-08-19,9312
00946,群益科技高息成長,9,0,9,華南永昌-民權,2024-08-19,9312
2429,銘旺科,9,0,9,華南永昌-民權,2024-08-19,9312
3062,建漢,13,4,9,華南永昌-民權,2024-08-19,9312
0056,元大高股息,11,3,8,華南永昌-民權,2024-08-19,9312
9904,寶成,8,0,8,華南永昌-民權,2024-08-19,9312
00675L,富邦臺灣加權正2,7,0,7,華南永昌-民權,2024-08-19,9312
6148,驊宏資,7,0,7,華南永昌-民權,2024-08-19,9312
8070,長華*,9,2,7,華南永昌-民權,2024-08-19,9312
2330,台積電,9,3,6,華南永昌-民權,2024-08-19,9312
8028,昇陽半導體,6,0,6,華南永昌-民權,2024-08-19,9312
4534,慶騰,6,0,6,華南永昌-民權,2024-08-19,9312
6207,雷科,6,0,6,華南永昌-民權,2024-08-19,9312
2399,映泰,5,0,5,華南永昌-民權,2024-08-19,9312
1101,台泥,5,0,5,華南永昌-民權,2024-08-19,9312
1419,新紡,5,0,5,華南永昌-民權,2024-08-19,9312
3419,譁裕,5,0,5,華南永昌-民權,2024-08-19,9312
3663,鑫科,11,6,5,華南永昌-民權,2024-08-19,9312
6488,環球晶,5,0,5,華南永昌-民權,2024-08-19,9312
00918,大華優利高填息30,4,0,4,華南永昌-民權,2024-08-19,9312
2419,仲琦,5,1,4,華南永昌-民權,2024-08-19,9312
2615,萬海,8,4,4,華南永昌-民權,2024-08-19,9312
2845,遠東銀,4,0,4,華南永昌-民權,2024-08-19,9312
3312,弘憶股,9,5,4,華南永昌-民權,2024-08-19,9312
4513,福裕,4,0,4,華南永昌-民權,2024-08-19,9312
6117,迎廣,5,1,4,華南永昌-民權,2024-08-19,9312
6275,元山,4,0,4,華南永昌-民權,2024-08-19,9312
2356,英業達,625,415,210,華南永昌-民權,2024-08-20,9312
00632R,元大台灣50反1,200,0,200,華南永昌-民權,2024-08-20,9312
0056,元大高股息,134,0,134,華南永昌-民權,2024-08-20,9312
00675L,富邦臺灣加權正2,95,0,95,華南永昌-民權,2024-08-20,9312
00687B,國泰20年美債,108,40,68,華南永昌-民權,2024-08-20,9312
1301,台塑,69,13,56,華南永昌-民權,2024-08-20,9312
2881,富邦金,54,0,54,華南永昌-民權,2024-08-20,9312
00919,群益台灣精選高息,54,1,53,華南永昌-民權,2024-08-20,9312
3607,谷崧,59,8,51,華南永昌-民權,2024-08-20,9312
2454,聯發科,42,0,42,華南永昌-民權,2024-08-20,9312
6269,台郡,32,0,32,華南永昌-民權,2024-08-20,9312
8028,昇陽半導體,47,17,30,華南永昌-民權,2024-08-20,9312
00715L,期街口布蘭特正2,25,0,25,華南永昌-民權,2024-08-20,9312
00929,復華台灣科技優息,30,8,22,華南永昌-民權,2024-08-20,9312
1303,南亞,21,0,21,華南永昌-民權,2024-08-20,9312
1326,台化,25,5,20,華南永昌-民權,2024-08-20,9312
2801,彰銀,20,0,20,華南永昌-民權,2024-08-20,9312
3081,聯亞,20,0,20,華南永昌-民權,2024-08-20,9312
8927,北基,65,45,20,華南永昌-民權,2024-08-20,9312
00937B,群益ESG投等債20,21,2,19,華南永昌-民權,2024-08-20,9312
3673,TPK-KY,20,1,19,華南永昌-民權,2024-08-20,9312
2332,友訊,15,0,15,華南永昌-民權,2024-08-20,9312
5519,隆大,14,0,14,華南永昌-民權,2024-08-20,9312
6218,豪勉,13,0,13,華南永昌-民權,2024-08-20,9312
2401,凌陽,16,3,13,華南永昌-民權,2024-08-20,9312
00795B,中信美國公債20年,11,0,11,華南永昌-民權,2024-08-20,9312
2834,臺企銀,10,0,10,華南永昌-民權,2024-08-20,9312
2885,元大金,11,1,10,華南永昌-民權,2024-08-20,9312
00680L,元大美債20正2,20,10,10,華南永昌-民權,2024-08-20,9312
1314,中石化,10,0,10,華南永昌-民權,2024-08-20,9312
4904,遠傳,10,0,10,華南永昌-民權,2024-08-20,9312
5905,南仁湖,10,0,10,華南永昌-民權,2024-08-20,9312
2374,佳能,12,3,9,華南永昌-民權,2024-08-20,9312
4903,聯光通,9,0,9,華南永昌-民權,2024-08-20,9312
2883,凱基金,7,0,7,華南永昌-民權,2024-08-20,9312
00679B,元大美債20年,17,10,7,華南永昌-民權,2024-08-20,9312
00954,中信日本半導體,7,0,7,華南永昌-民權,2024-08-20,9312
5443,均豪,25,18,7,華南永昌-民權,2024-08-20,9312
1438,三地開發,6,0,6,華南永昌-民權,2024-08-20,9312
2365,昆盈,30,24,6,華南永昌-民權,2024-08-20,9312
3390,旭軟,9,3,6,華南永昌-民權,2024-08-20,9312
5392,能率,7,1,6,華南永昌-民權,2024-08-20,9312
8440,綠電,11,5,6,華南永昌-民權,2024-08-20,9312
2303,聯電,11,6,5,華南永昌-民權,2024-08-20,9312
2609,陽明,6,1,5,華南永昌-民權,2024-08-20,9312
1513,中興電,8,3,5,華南永昌-民權,2024-08-20,9312
00751B,元大AAA至A公司債,5,0,5,華南永昌-民權,2024-08-20,9312
00650L,復華香港正2,5,0,5,華南永昌-民權,2024-08-20,9312
1584,精剛,9,4,5,華南永昌-民權,2024-08-20,9312
2337,旺宏,5,0,5,華南永昌-民權,2024-08-20,9312
00720B,元大投資級公司債,60,0,60,華南永昌-民權,2024-08-21,9312
2312,金寶,69,9,60,華南永昌-民權,2024-08-21,9312
00772B,中信高評級公司債,50,0,50,華南永昌-民權,2024-08-21,9312
00679B,元大美債20年,61,15,46,華南永昌-民權,2024-08-21,9312
00953B,群益優選非投等債,45,0,45,華南永昌-民權,2024-08-21,9312
1609,大亞,51,10,41,華南永昌-民權,2024-08-21,9312
2401,凌陽,30,0,30,華南永昌-民權,2024-08-21,9312
3047,訊舟,61,32,29,華南永昌-民權,2024-08-21,9312
2610,華航,30,5,25,華南永昌-民權,2024-08-21,9312
2891,中信金,31,8,23,華南永昌-民權,2024-08-21,9312
5519,隆大,23,0,23,華南永昌-民權,2024-08-21,9312
1409,新纖,33,11,22,華南永昌-民權,2024-08-21,9312
1438,三地開發,20,0,20,華南永昌-民權,2024-08-21,9312
00857B,永豐20年美公債,17,0,17,華南永昌-民權,2024-08-21,9312
3081,聯亞,15,1,14,華南永昌-民權,2024-08-21,9312
2356,英業達,18,6,12,華南永昌-民權,2024-08-21,9312
1326,台化,13,1,12,華南永昌-民權,2024-08-21,9312
00918,大華優利高填息30,13,3,10,華南永昌-民權,2024-08-21,9312
00773B,中信優先金融債,10,0,10,華南永昌-民權,2024-08-21,9312
00940,元大台灣價值高息,10,0,10,華南永昌-民權,2024-08-21,9312
2618,長榮航,14,4,10,華南永昌-民權,2024-08-21,9312
3303,岱稜,9,0,9,華南永昌-民權,2024-08-21,9312
3576,聯合再生,9,0,9,華南永昌-民權,2024-08-21,9312
8054,安國,9,0,9,華南永昌-民權,2024-08-21,9312
6207,雷科,20,12,8,華南永昌-民權,2024-08-21,9312
8070,長華*,8,0,8,華南永昌-民權,2024-08-21,9312
3686,達能,7,0,7,華南永昌-民權,2024-08-21,9312
5284,jpp-KY,7,0,7,華南永昌-民權,2024-08-21,9312
2887,台新金,7,0,7,華南永昌-民權,2024-08-21,9312
00954,中信日本半導體,6,0,6,華南永昌-民權,2024-08-21,9312
00882,中信中國高股息,6,0,6,華南永昌-民權,2024-08-21,9312
4109,加捷生醫,7,1,6,華南永昌-民權,2024-08-21,9312
6269,台郡,5,0,5,華南永昌-民權,2024-08-21,9312
2540,愛山林,5,0,5,華南永昌-民權,2024-08-21,9312
8110,華東,5,0,5,華南永昌-民權,2024-08-21,9312
00795B,中信美國公債20年,5,0,5,華南永昌-民權,2024-08-21,9312
3050,鈺德,6,1,5,華南永昌-民權,2024-08-21,9312
3665,貿聯-KY,5,0,5,華南永昌-民權,2024-08-21,9312
3673,TPK-KY,5,0,5,華南永昌-民權,2024-08-21,9312
6120,達運,5,0,5,華南永昌-民權,2024-08-21,9312
6152,百一,5,0,5,華南永昌-民權,2024-08-21,9312
8107,大億金茂,5,0,5,華南永昌-民權,2024-08-21,9312
8421,旭源,6,1,5,華南永昌-民權,2024-08-21,9312
00779B,凱基美債25+,5,0,5,華南永昌-民權,2024-08-21,9312
6462,神盾,4,0,4,華南永昌-民權,2024-08-21,9312
00919,群益台灣精選高息,21,17,4,華南永昌-民權,2024-08-21,9312
5347,世界,4,0,4,華南永昌-民權,2024-08-21,9312
6869,雲豹能源,15,11,4,華南永昌-民權,2024-08-21,9312
00907,永豐優息存股,4,0,4,華南永昌-民權,2024-08-21,9312
1437,勤益控,4,0,4,華南永昌-民權,2024-08-21,9312
00772B,中信高評級公司債,450,0,450,華南永昌-民權,2024-08-22,9312
00720B,元大投資級公司債,120,1,119,華南永昌-民權,2024-08-22,9312
00675L,富邦臺灣加權正2,98,21,77,華南永昌-民權,2024-08-22,9312
2851,中再保,50,0,50,華南永昌-民權,2024-08-22,9312
6127,九豪,35,0,35,華南永昌-民權,2024-08-22,9312
2885,元大金,31,1,30,華南永昌-民權,2024-08-22,9312
00937B,群益ESG投等債20,31,1,30,華南永昌-民權,2024-08-22,9312
3047,訊舟,68,42,26,華南永昌-民權,2024-08-22,9312
2610,華航,20,0,20,華南永昌-民權,2024-08-22,9312
00935,野村臺灣新科技50,20,0,20,華南永昌-民權,2024-08-22,9312
2867,三商壽,20,0,20,華南永昌-民權,2024-08-22,9312
00631L,元大台灣50正2,18,1,17,華南永昌-民權,2024-08-22,9312
1503,士電,17,0,17,華南永昌-民權,2024-08-22,9312
2349,錸德,52,35,17,華南永昌-民權,2024-08-22,9312
6152,百一,15,0,15,華南永昌-民權,2024-08-22,9312
00929,復華台灣科技優息,15,1,14,華南永昌-民權,2024-08-22,9312
2891,中信金,25,12,13,華南永昌-民權,2024-08-22,9312
1785,光洋科,15,4,11,華南永昌-民權,2024-08-22,9312
2356,英業達,11,0,11,華南永昌-民權,2024-08-22,9312
9955,佳龍,12,1,11,華南永昌-民權,2024-08-22,9312
00632R,元大台灣50反1,10,0,10,華南永昌-民權,2024-08-22,9312
2905,三商,10,0,10,華南永昌-民權,2024-08-22,9312
5533,皇鼎,10,0,10,華南永昌-民權,2024-08-22,9312
6509,聚和,12,2,10,華南永昌-民權,2024-08-22,9312
9105,泰金寶-DR,10,0,10,華南永昌-民權,2024-08-22,9312
1513,中興電,12,3,9,華南永昌-民權,2024-08-22,9312
2354,鴻準,17,8,9,華南永昌-民權,2024-08-22,9312
6125,廣運,13,4,9,華南永昌-民權,2024-08-22,9312
8358,金居,9,0,9,華南永昌-民權,2024-08-22,9312
2455,全新,8,0,8,華南永昌-民權,2024-08-22,9312
5371,中光電,9,1,8,華南永昌-民權,2024-08-22,9312
8033,雷虎,13,5,8,華南永昌-民權,2024-08-22,9312
2347,聯強,7,0,7,華南永昌-民權,2024-08-22,9312
3037,欣興,19,12,7,華南永昌-民權,2024-08-22,9312
6505,台塑化,7,0,7,華南永昌-民權,2024-08-22,9312
2330,台積電,10,4,6,華南永昌-民權,2024-08-22,9312
00940,元大台灣價值高息,9,3,6,華南永昌-民權,2024-08-22,9312
00715L,期街口布蘭特正2,6,0,6,華南永昌-民權,2024-08-22,9312
2355,敬鵬,7,1,6,華南永昌-民權,2024-08-22,9312
2460,建通,11,5,6,華南永昌-民權,2024-08-22,9312
2317,鴻海,13,7,6,華南永昌-民權,2024-08-22,9312
8028,昇陽半導體,11,5,6,華南永昌-民權,2024-08-22,9312
1529,樂事綠能,18,13,5,華南永昌-民權,2024-08-22,9312
1809,中釉,25,20,5,華南永昌-民權,2024-08-22,9312
3607,谷崧,5,0,5,華南永昌-民權,2024-08-22,9312
4303,信立,15,10,5,華南永昌-民權,2024-08-22,9312
6609,瀧澤科,5,0,5,華南永昌-民權,2024-08-22,9312
3711,日月光投控,6,2,4,華南永昌-民權,2024-08-22,9312
1609,大亞,15,11,4,華南永昌-民權,2024-08-22,9312
2527,宏璟,4,0,4,華南永昌-民權,2024-08-22,9312
00751B,元大AAA至A公司債,900,0,900,華南永昌-民權,2024-08-23,9312
00720B,元大投資級公司債,1202,602,600,華南永昌-民權,2024-08-23,9312
1314,中石化,204,15,189,華南永昌-民權,2024-08-23,9312
2344,華邦電,65,2,63,華南永昌-民權,2024-08-23,9312
2887,台新金,141,96,45,華南永昌-民權,2024-08-23,9312
4113,聯上,45,0,45,華南永昌-民權,2024-08-23,9312
8927,北基,40,5,35,華南永昌-民權,2024-08-23,9312
00680L,元大美債20正2,30,0,30,華南永昌-民權,2024-08-23,9312
00940,元大台灣價值高息,52,25,27,華南永昌-民權,2024-08-23,9312
3037,欣興,73,49,24,華南永昌-民權,2024-08-23,9312
3374,精材,25,2,23,華南永昌-民權,2024-08-23,9312
00687B,國泰20年美債,22,0,22,華南永昌-民權,2024-08-23,9312
00931B,統一美債20年,21,0,21,華南永昌-民權,2024-08-23,9312
1447,力鵬,20,0,20,華南永昌-民權,2024-08-23,9312
2832,台產,17,0,17,華南永昌-民權,2024-08-23,9312
1326,台化,11,0,11,華南永昌-民權,2024-08-23,9312
1609,大亞,22,11,11,華南永昌-民權,2024-08-23,9312
2885,元大金,11,1,10,華南永昌-民權,2024-08-23,9312
1321,大洋,10,0,10,華南永昌-民權,2024-08-23,9312
2884,玉山金,20,10,10,華南永昌-民權,2024-08-23,9312
4513,福裕,10,0,10,華南永昌-民權,2024-08-23,9312
5011,久陽,10,0,10,華南永昌-民權,2024-08-23,9312
8011,台通,10,0,10,華南永昌-民權,2024-08-23,9312
6283,淳安,9,0,9,華南永昌-民權,2024-08-23,9312
1438,三地開發,9,1,8,華南永昌-民權,2024-08-23,9312
6509,聚和,8,0,8,華南永昌-民權,2024-08-23,9312
00795B,中信美國公債20年,7,0,7,華南永昌-民權,2024-08-23,9312
2374,佳能,10,3,7,華南永昌-民權,2024-08-23,9312
3062,建漢,14,7,7,華南永昌-民權,2024-08-23,9312
8064,東捷,107,100,7,華南永昌-民權,2024-08-23,9312
6869,雲豹能源,20,13,7,華南永昌-民權,2024-08-23,9312
1711,永光,26,20,6,華南永昌-民權,2024-08-23,9312
1717,長興,7,1,6,華南永昌-民權,2024-08-23,9312
1721,三晃,6,0,6,華南永昌-民權,2024-08-23,9312
2353,宏��,8,2,6,華南永昌-民權,2024-08-23,9312
1301,台塑,5,0,5,華南永昌-民權,2024-08-23,9312
00954,中信日本半導體,5,0,5,華南永昌-民權,2024-08-23,9312
1529,樂事綠能,5,0,5,華南永昌-民權,2024-08-23,9312
2402,毅嘉,10,5,5,華南永昌-民權,2024-08-23,9312
2484,希華,5,0,5,華南永昌-民權,2024-08-23,9312
2538,基泰,5,0,5,華南永昌-民權,2024-08-23,9312
3209,全科,5,0,5,華南永昌-民權,2024-08-23,9312
4303,信立,5,0,5,華南永昌-民權,2024-08-23,9312
6215,和椿,5,0,5,華南永昌-民權,2024-08-23,9312
2883B,凱基金乙特,4,0,4,華南永昌-民權,2024-08-23,9312
1409,新纖,11,7,4,華南永昌-民權,2024-08-23,9312
1708,東鹼,4,0,4,華南永昌-民權,2024-08-23,9312
2348,海悅,5,1,4,華南永昌-民權,2024-08-23,9312
2408,南亞科,4,0,4,華南永昌-民權,2024-08-23,9312
3081,聯亞,5,1,4,華南永昌-民權,2024-08-23,9312
00751B,元大AAA至A公司債,2100,0,2100,華南永昌-民權,2024-08-26,9312
0056,元大高股息,1000,1,999,華南永昌-民權,2024-08-26,9312
00632R,元大台灣50反1,200,0,200,華南永昌-民權,2024-08-26,9312
2101,南港,100,0,100,華南永昌-民權,2024-08-26,9312
8916,光隆,100,0,100,華南永昌-民權,2024-08-26,9312
2888,新光金,156,91,65,華南永昌-民權,2024-08-26,9312
00687B,國泰20年美債,58,0,58,華南永昌-民權,2024-08-26,9312
8927,北基,52,0,52,華南永昌-民權,2024-08-26,9312
00933B,國泰10Y+金融債,50,3,47,華南永昌-民權,2024-08-26,9312
4979,華星光,42,2,40,華南永昌-民權,2024-08-26,9312
2330,台積電,35,0,35,華南永昌-民權,2024-08-26,9312
1609,大亞,37,3,34,華南永昌-民權,2024-08-26,9312
00919,群益台灣精選高息,34,0,34,華南永昌-民權,2024-08-26,9312
00795B,中信美國公債20年,33,0,33,華南永昌-民權,2024-08-26,9312
2515,中工,31,0,31,華南永昌-民權,2024-08-26,9312
5443,均豪,51,25,26,華南永昌-民權,2024-08-26,9312
00679B,元大美債20年,32,7,25,華南永昌-民權,2024-08-26,9312
3518,柏騰,23,0,23,華南永昌-民權,2024-08-26,9312
3374,精材,28,8,20,華南永昌-民權,2024-08-26,9312
2609,陽明,23,5,18,華南永昌-民權,2024-08-26,9312
00937B,群益ESG投等債20,16,0,16,華南永昌-民權,2024-08-26,9312
2409,友達,40,24,16,華南永昌-民權,2024-08-26,9312
3062,建漢,21,5,16,華南永昌-民權,2024-08-26,9312
1436,華友聯,15,0,15,華南永昌-民權,2024-08-26,9312
5452,佶優,15,1,14,華南永昌-民權,2024-08-26,9312
2468,華經,13,0,13,華南永昌-民權,2024-08-26,9312
3047,訊舟,28,15,13,華南永昌-民權,2024-08-26,9312
3390,旭軟,16,3,13,華南永昌-民權,2024-08-26,9312
3715,定穎投控,27,15,12,華南永昌-民權,2024-08-26,9312
1570,力肯,13,2,11,華南永昌-民權,2024-08-26,9312
3607,谷崧,11,0,11,華南永昌-民權,2024-08-26,9312
3665,貿聯-KY,12,1,11,華南永昌-民權,2024-08-26,9312
3680,家登,11,0,11,華南永昌-民權,2024-08-26,9312
3189,景碩,31,20,11,華南永昌-民權,2024-08-26,9312
6789,采鈺,15,5,10,華南永昌-民權,2024-08-26,9312
2401,凌陽,10,0,10,華南永昌-民權,2024-08-26,9312
3652,精聯,10,0,10,華南永昌-民權,2024-08-26,9312
4564,元翎,10,0,10,華南永昌-民權,2024-08-26,9312
6116,彩晶,10,0,10,華南永昌-民權,2024-08-26,9312
8011,台通,10,0,10,華南永昌-民權,2024-08-26,9312
1529,樂事綠能,24,16,8,華南永昌-民權,2024-08-26,9312
2340,台亞,9,1,8,華南永昌-民權,2024-08-26,9312
6509,聚和,8,0,8,華南永昌-民權,2024-08-26,9312
3583,辛耘,7,0,7,華南永昌-民權,2024-08-26,9312
00706L,期元大S＆P日圓正2,10,3,7,華南永昌-民權,2024-08-26,9312
1316,上曜,7,0,7,華南永昌-民權,2024-08-26,9312
1717,長興,8,1,7,華南永昌-民權,2024-08-26,9312
3339,泰谷,10,4,6,華南永昌-民權,2024-08-26,9312
6133,金橋,7,1,6,華南永昌-民權,2024-08-26,9312
1506,正道,5,0,5,華南永昌-民權,2024-08-26,9312
2344,華邦電,200,0,200,華南永昌-民權,2024-08-27,9312
00877,復華中國5G,102,0,102,華南永昌-民權,2024-08-27,9312
2101,南港,100,0,100,華南永昌-民權,2024-08-27,9312
2852,第一保,51,0,51,華南永昌-民權,2024-08-27,9312
2851,中再保,50,0,50,華南永昌-民權,2024-08-27,9312
3481,群創,99,60,39,華南永昌-民權,2024-08-27,9312
2208,台船,33,0,33,華南永昌-民權,2024-08-27,9312
00937B,群益ESG投等債20,21,0,21,華南永昌-民權,2024-08-27,9312
6509,聚和,19,0,19,華南永昌-民權,2024-08-27,9312
00919,群益台灣精選高息,17,0,17,華南永昌-民權,2024-08-27,9312
2891,中信金,16,0,16,華南永昌-民權,2024-08-27,9312
2303,聯電,15,0,15,華南永昌-民權,2024-08-27,9312
2603,長榮,15,0,15,華南永昌-民權,2024-08-27,9312
6829,千附精密,14,0,14,華南永昌-民權,2024-08-27,9312
00948B,中信優息投資級債,10,0,10,華南永昌-民權,2024-08-27,9312
1409,新纖,20,10,10,華南永昌-民權,2024-08-27,9312
1584,精剛,10,0,10,華南永昌-民權,2024-08-27,9312
2102,泰豐,10,0,10,華南永昌-民權,2024-08-27,9312
2409,友達,11,1,10,華南永昌-民權,2024-08-27,9312
4123,晟德,10,0,10,華南永昌-民權,2024-08-27,9312
4953,緯軟,10,0,10,華南永昌-民權,2024-08-27,9312
6488,環球晶,10,0,10,華南永昌-民權,2024-08-27,9312
8436,大江,10,0,10,華南永昌-民權,2024-08-27,9312
00679B,元大美債20年,10,0,10,華南永昌-民權,2024-08-27,9312
2353,宏��,10,1,9,華南永昌-民權,2024-08-27,9312
2429,銘旺科,9,0,9,華南永昌-民權,2024-08-27,9312
4967,十銓,10,1,9,華南永昌-民權,2024-08-27,9312
2615,萬海,9,1,8,華南永昌-民權,2024-08-27,9312
2365,昆盈,23,16,7,華南永昌-民權,2024-08-27,9312
4510,高鋒,15,8,7,華南永昌-民權,2024-08-27,9312
8096,擎亞,8,1,7,華南永昌-民權,2024-08-27,9312
00680L,元大美債20正2,20,14,6,華南永昌-民權,2024-08-27,9312
00713,元大台灣高息低波,7,1,6,華南永昌-民權,2024-08-27,9312
8087,麗升能源,6,0,6,華南永昌-民權,2024-08-27,9312
8182,加高,6,0,6,華南永昌-民權,2024-08-27,9312
2324,仁寶,6,0,6,華南永昌-民權,2024-08-27,9312
2330,台積電,9,3,6,華南永昌-民權,2024-08-27,9312
00936,台新永續高息中小,5,0,5,華南永昌-民權,2024-08-27,9312
00953B,群益優選非投等債,5,0,5,華南永昌-民權,2024-08-27,9312
00632R,元大台灣50反1,5,0,5,華南永昌-民權,2024-08-27,9312
2356,英業達,6,1,5,華南永昌-民權,2024-08-27,9312
3450,聯鈞,7,2,5,華南永昌-民權,2024-08-27,9312
3576,聯合再生,5,0,5,華南永昌-民權,2024-08-27,9312
4532,瑞智,5,0,5,華南永昌-民權,2024-08-27,9312
5371,中光電,5,0,5,華南永昌-民權,2024-08-27,9312
6127,九豪,5,0,5,華南永昌-民權,2024-08-27,9312
6278,台表科,5,0,5,華南永昌-民權,2024-08-27,9312
6869,雲豹能源,17,12,5,華南永昌-民權,2024-08-27,9312
2317,鴻海,7,3,4,華南永昌-民權,2024-08-27,9312
3583,辛耘,4,0,4,華南永昌-民權,2024-08-27,9312
00751B,元大AAA至A公司債,475,10,465,華南永昌-民權,2024-08-28,9312
2317,鴻海,311,11,300,華南永昌-民權,2024-08-28,9312
00959B,大華投等美債15Y+,105,10,95,華南永昌-民權,2024-08-28,9312
2101,南港,50,0,50,華南永昌-民權,2024-08-28,9312
2891,中信金,26,2,24,華南永昌-民權,2024-08-28,9312
1447,力鵬,20,0,20,華南永昌-民權,2024-08-28,9312
1529,樂事綠能,20,1,19,華南永昌-民權,2024-08-28,9312
00637L,元大滬深300正2,15,0,15,華南永昌-民權,2024-08-28,9312
3673,TPK-KY,14,0,14,華南永昌-民權,2024-08-28,9312
8039,台虹,79,66,13,華南永昌-民權,2024-08-28,9312
2501,國建,12,1,11,華南永昌-民權,2024-08-28,9312
4534,慶騰,12,1,11,華南永昌-民權,2024-08-28,9312
2324,仁寶,10,0,10,華南永昌-民權,2024-08-28,9312
2353,宏��,10,0,10,華南永昌-民權,2024-08-28,9312
4989,榮科,10,0,10,華南永昌-民權,2024-08-28,9312
2392,正崴,13,4,9,華南永昌-民權,2024-08-28,9312
2409,友達,18,9,9,華南永昌-民權,2024-08-28,9312
2883B,凱基金乙特,9,0,9,華南永昌-民權,2024-08-28,9312
6269,台郡,11,2,9,華南永昌-民權,2024-08-28,9312
3665,貿聯-KY,12,3,9,華南永昌-民權,2024-08-28,9312
00929,復華台灣科技優息,8,0,8,華南永昌-民權,2024-08-28,9312
1815,富喬,15,7,8,華南永昌-民權,2024-08-28,9312
2349,錸德,10,2,8,華南永昌-民權,2024-08-28,9312
2834,臺企銀,10,2,8,華南永昌-民權,2024-08-28,9312
3455,由田,10,2,8,華南永昌-民權,2024-08-28,9312
2402,毅嘉,16,9,7,華南永昌-民權,2024-08-28,9312
2405,輔信,7,0,7,華南永昌-民權,2024-08-28,9312
8064,東捷,9,2,7,華南永昌-民權,2024-08-28,9312
00931B,統一美債20年,6,0,6,華南永昌-民權,2024-08-28,9312
2312,金寶,9,3,6,華南永昌-民權,2024-08-28,9312
4513,福裕,78,72,6,華南永昌-民權,2024-08-28,9312
5234,達興材料,7,1,6,華南永昌-民權,2024-08-28,9312
5443,均豪,31,25,6,華南永昌-民權,2024-08-28,9312
00713,元大台灣高息低波,5,0,5,華南永昌-民權,2024-08-28,9312
00631L,元大台灣50正2,5,0,5,華南永昌-民權,2024-08-28,9312
00680L,元大美債20正2,5,0,5,華南永昌-民權,2024-08-28,9312
2408,南亞科,5,0,5,華南永昌-民權,2024-08-28,9312
2481,強茂,5,0,5,華南永昌-民權,2024-08-28,9312
2489,瑞軒,5,0,5,華南永昌-民權,2024-08-28,9312
3339,泰谷,7,2,5,華南永昌-民權,2024-08-28,9312
3419,譁裕,5,0,5,華南永昌-民權,2024-08-28,9312
4562,穎漢,6,1,5,華南永昌-民權,2024-08-28,9312
2845,遠東銀,14,10,4,華南永昌-民權,2024-08-28,9312
00715L,期街口布蘭特正2,4,0,4,華南永昌-民權,2024-08-28,9312
2515,中工,4,0,4,華南永昌-民權,2024-08-28,9312
3260,威剛,4,0,4,華南永昌-民權,2024-08-28,9312
4906,正文,4,0,4,華南永昌-民權,2024-08-28,9312
8028,昇陽半導體,9,5,4,華南永昌-民權,2024-08-28,9312
00937B,群益ESG投等債20,13,10,3,華南永昌-民權,2024-08-28,9312
00936,台新永續高息中小,3,0,3,華南永昌-民權,2024-08-28,9312
00751B,元大AAA至A公司債,1400,100,1300,華南永昌-民權,2024-08-29,9312
2887,台新金,180,6,174,華南永昌-民權,2024-08-29,9312
2408,南亞科,111,0,111,華南永昌-民權,2024-08-29,9312
2880,華南金,103,0,103,華南永昌-民權,2024-08-29,9312
00753L,中信中國50正2,100,0,100,華南永昌-民權,2024-08-29,9312
00877,復華中國5G,100,0,100,華南永昌-民權,2024-08-29,9312
2305,全友,50,0,50,華南永昌-民權,2024-08-29,9312
2101,南港,50,1,49,華南永昌-民權,2024-08-29,9312
00937B,群益ESG投等債20,43,0,43,華南永昌-民權,2024-08-29,9312
00948B,中信優息投資級債,20,0,20,華南永昌-民權,2024-08-29,9312
2891,中信金,18,5,13,華南永昌-民權,2024-08-29,9312
1727,中華化,24,12,12,華南永昌-民權,2024-08-29,9312
1109,信大,11,0,11,華南永昌-民權,2024-08-29,9312
3652,精聯,11,0,11,華南永昌-民權,2024-08-29,9312
1210,大成,10,0,10,華南永昌-民權,2024-08-29,9312
00915,凱基優選高股息30,10,0,10,華南永昌-民權,2024-08-29,9312
3680,家登,10,0,10,華南永昌-民權,2024-08-29,9312
4714,永捷,10,0,10,華南永昌-民權,2024-08-29,9312
6570,維田,16,6,10,華南永昌-民權,2024-08-29,9312
8111,立��,12,3,9,華南永昌-民權,2024-08-29,9312
2330,台積電,9,0,9,華南永昌-民權,2024-08-29,9312
2365,昆盈,10,2,8,華南永昌-民權,2024-08-29,9312
1409,新纖,10,2,8,華南永昌-民權,2024-08-29,9312
2356,英業達,10,3,7,華南永昌-民權,2024-08-29,9312
2420,新巨,9,2,7,華南永昌-民權,2024-08-29,9312
2427,三商電,10,3,7,華南永昌-民權,2024-08-29,9312
3078,僑威,7,0,7,華南永昌-民權,2024-08-29,9312
4513,福裕,12,5,7,華南永昌-民權,2024-08-29,9312
6698,旭暉應材,12,5,7,華南永昌-民權,2024-08-29,9312
8374,羅昇,8,1,7,華南永昌-民權,2024-08-29,9312
3481,群創,24,17,7,華南永昌-民權,2024-08-29,9312
00878,國泰永續高股息,6,0,6,華南永昌-民權,2024-08-29,9312
4555,氣立,7,1,6,華南永昌-民權,2024-08-29,9312
3035,智原,6,1,5,華南永昌-民權,2024-08-29,9312
8096,擎亞,6,1,5,華南永昌-民權,2024-08-29,9312
1514,亞力,10,5,5,華南永昌-民權,2024-08-29,9312
3231,緯創,5,0,5,華南永昌-民權,2024-08-29,9312
00940,元大台灣價值高息,5,0,5,華南永昌-民權,2024-08-29,9312
00919,群益台灣精選高息,5,0,5,華南永昌-民權,2024-08-29,9312
00882,中信中國高股息,5,0,5,華南永昌-民權,2024-08-29,9312
00881,國泰台灣5G+,5,0,5,華南永昌-民權,2024-08-29,9312
2399,映泰,13,8,5,華南永昌-民權,2024-08-29,9312
2405,輔信,5,0,5,華南永昌-民權,2024-08-29,9312
3450,聯鈞,15,10,5,華南永昌-民權,2024-08-29,9312
4711,永純,6,1,5,華南永昌-民權,2024-08-29,9312
4989,榮科,5,0,5,華南永昌-民權,2024-08-29,9312
6829,千附精密,5,0,5,華南永昌-民權,2024-08-29,9312
00900,富邦特選高股息30,4,0,4,華南永昌-民權,2024-08-29,9312
2303,聯電,5,1,4,華南永昌-民權,2024-08-29,9312
2425,承啟,15,11,4,華南永昌-民權,2024-08-29,9312
00664R,國泰臺灣加權反1,589,0,589,華南永昌-民權,2024-08-30,9312
00751B,元大AAA至A公司債,302,102,200,華南永昌-民權,2024-08-30,9312
2509,全坤建,50,0,50,華南永昌-民權,2024-08-30,9312
00933B,國泰10Y+金融債,50,0,50,華南永昌-民權,2024-08-30,9312
0056,元大高股息,50,8,42,華南永昌-民權,2024-08-30,9312
00915,凱基優選高股息30,41,0,41,華南永昌-民權,2024-08-30,9312
2367,燿華,65,26,39,華南永昌-民權,2024-08-30,9312
2834,臺企銀,32,0,32,華南永昌-民權,2024-08-30,9312
1529,樂事綠能,34,4,30,華南永昌-民權,2024-08-30,9312
1453,大將,20,0,20,華南永昌-民權,2024-08-30,9312
1711,永光,32,12,20,華南永昌-民權,2024-08-30,9312
3481,群創,24,4,20,華南永昌-民權,2024-08-30,9312
8437,大地-KY,20,0,20,華南永昌-民權,2024-08-30,9312
1419,新紡,15,0,15,華南永昌-民權,2024-08-30,9312
00741B,富邦全球非投等債,15,0,15,華南永昌-民權,2024-08-30,9312
00688L,國泰20年美債正2,12,0,12,華南永昌-民權,2024-08-30,9312
2409,友達,16,4,12,華南永昌-民權,2024-08-30,9312
2408,南亞科,11,0,11,華南永昌-民權,2024-08-30,9312
6188,廣明,11,0,11,華南永昌-民權,2024-08-30,9312
8039,台虹,13,2,11,華南永昌-民權,2024-08-30,9312
2330,台積電,14,4,10,華南永昌-民權,2024-08-30,9312
00929,復華台灣科技優息,10,0,10,華南永昌-民權,2024-08-30,9312
00650L,復華香港正2,10,0,10,華南永昌-民權,2024-08-30,9312
00680L,元大美債20正2,10,0,10,華南永昌-民權,2024-08-30,9312
2399,映泰,10,0,10,華南永昌-民權,2024-08-30,9312
2464,盟立,13,3,10,華南永昌-民權,2024-08-30,9312
3652,精聯,10,0,10,華南永昌-民權,2024-08-30,9312
5227,立凱-KY,10,0,10,華南永昌-民權,2024-08-30,9312
6829,千附精密,10,0,10,華南永昌-民權,2024-08-30,9312
1410,南染,9,0,9,華南永昌-民權,2024-08-30,9312
2504,國產,10,1,9,華南永昌-民權,2024-08-30,9312
4526,東台,46,37,9,華南永昌-民權,2024-08-30,9312
4534,慶騰,9,0,9,華南永昌-民權,2024-08-30,9312
9946,三發地產,8,0,8,華南永昌-民權,2024-08-30,9312
00679B,元大美債20年,7,0,7,華南永昌-民權,2024-08-30,9312
4113,聯上,10,3,7,華南永昌-民權,2024-08-30,9312
3163,波若威,11,4,7,華南永昌-民權,2024-08-30,9312
3189,景碩,13,7,6,華南永昌-民權,2024-08-30,9312
2891,中信金,6,0,6,華南永昌-民權,2024-08-30,9312
3607,谷崧,6,0,6,華南永昌-民權,2024-08-30,9312
8086,宏捷科,6,0,6,華南永昌-民權,2024-08-30,9312
4561,健椿,10,4,6,華南永昌-民權,2024-08-30,9312
2845,遠東銀,5,0,5,華南永昌-民權,2024-08-30,9312
1506,正道,5,0,5,華南永昌-民權,2024-08-30,9312
2324,仁寶,5,0,5,華南永昌-民權,2024-08-30,9312
2405,輔信,5,0,5,華南永昌-民權,2024-08-30,9312
3645,達邁,7,2,5,華南永昌-民權,2024-08-30,9312
4906,正文,5,0,5,華南永昌-民權,2024-08-30,9312
5425,台半,5,0,5,華南永昌-民權,2024-08-30,9312
6282,康舒,5,0,5,華南永昌-民權,2024-08-30,9312
2888,新光金,37,2,35,華南永昌-民權,2024-09-02,9312
2352,佳世達,33,0,33,華南永昌-民權,2024-09-02,9312
00687B,國泰20年美債,28,0,28,華南永昌-民權,2024-09-02,9312
5531,鄉林,28,0,28,華南永昌-民權,2024-09-02,9312
2881,富邦金,27,2,25,華南永昌-民權,2024-09-02,9312
3390,旭軟,20,0,20,華南永昌-民權,2024-09-02,9312
9924,福興,20,0,20,華南永昌-民權,2024-09-02,9312
3673,TPK-KY,20,1,19,華南永昌-民權,2024-09-02,9312
1301,台塑,18,0,18,華南永昌-民權,2024-09-02,9312
6505,台塑化,17,0,17,華南永昌-民權,2024-09-02,9312
00637L,元大滬深300正2,15,0,15,華南永昌-民權,2024-09-02,9312
00680L,元大美債20正2,15,0,15,華南永昌-民權,2024-09-02,9312
00940,元大台灣價值高息,28,13,15,華南永昌-民權,2024-09-02,9312
00959B,大華投等美債15Y+,15,0,15,華南永昌-民權,2024-09-02,9312
00919,群益台灣精選高息,14,0,14,華南永昌-民權,2024-09-02,9312
00715L,期街口布蘭特正2,14,0,14,華南永昌-民權,2024-09-02,9312
8039,台虹,17,3,14,華南永昌-民權,2024-09-02,9312
3481,群創,72,58,14,華南永昌-民權,2024-09-02,9312
6573,虹揚-KY,12,0,12,華南永昌-民權,2024-09-02,9312
8064,東捷,12,0,12,華南永昌-民權,2024-09-02,9312
2313,華通,12,1,11,華南永昌-民權,2024-09-02,9312
00679B,元大美債20年,11,0,11,華南永昌-民權,2024-09-02,9312
00927,群益半導體收益,11,0,11,華南永昌-民權,2024-09-02,9312
2417,圓剛,11,0,11,華南永昌-民權,2024-09-02,9312
2330,台積電,12,1,11,華南永昌-民權,2024-09-02,9312
1434,福懋,10,0,10,華南永昌-民權,2024-09-02,9312
3516,亞帝歐,10,0,10,華南永昌-民權,2024-09-02,9312
4566,時碩工業,11,1,10,華南永昌-民權,2024-09-02,9312
6488,環球晶,10,0,10,華南永昌-民權,2024-09-02,9312
8927,北基,30,20,10,華南永昌-民權,2024-09-02,9312
2884,玉山金,9,0,9,華南永昌-民權,2024-09-02,9312
8182,加高,9,0,9,華南永昌-民權,2024-09-02,9312
2891,中信金,9,1,8,華南永昌-民權,2024-09-02,9312
2603,長榮,9,2,7,華南永昌-民權,2024-09-02,9312
00933B,國泰10Y+金融債,7,0,7,華南永昌-民權,2024-09-02,9312
4510,高鋒,12,5,7,華南永昌-民權,2024-09-02,9312
5443,均豪,14,7,7,華南永昌-民權,2024-09-02,9312
6188,廣明,7,0,7,華南永昌-民權,2024-09-02,9312
00878,國泰永續高股息,6,0,6,華南永昌-民權,2024-09-02,9312
2609,陽明,7,1,6,華南永昌-民權,2024-09-02,9312
2880,華南金,5,0,5,華南永昌-民權,2024-09-02,9312
6274,台燿,6,1,5,華南永昌-民權,2024-09-02,9312
1303,南亞,5,0,5,華南永昌-民權,2024-09-02,9312
1326,台化,7,2,5,華南永昌-民權,2024-09-02,9312
1503,士電,5,0,5,華南永昌-民權,2024-09-02,9312
2537,聯上發,6,1,5,華南永昌-民權,2024-09-02,9312
2905,三商,5,0,5,華南永昌-民權,2024-09-02,9312
3669,圓展,5,0,5,華南永昌-民權,2024-09-02,9312
4576,大銀微系統,5,0,5,華南永昌-民權,2024-09-02,9312
5011,久陽,5,0,5,華南永昌-民權,2024-09-02,9312
00664R,國泰臺灣加權反1,599,100,499,華南永昌-民權,2024-09-03,9312
00713,元大台灣高息低波,500,3,497,華南永昌-民權,2024-09-03,9312
0056,元大高股息,204,0,204,華南永昌-民權,2024-09-03,9312
2801,彰銀,104,0,104,華南永昌-民權,2024-09-03,9312
1815,富喬,83,15,68,華南永昌-民權,2024-09-03,9312
8927,北基,119,58,61,華南永昌-民權,2024-09-03,9312
2852,第一保,51,0,51,華南永昌-民權,2024-09-03,9312
00680L,元大美債20正2,50,0,50,華南永昌-民權,2024-09-03,9312
00687B,國泰20年美債,47,0,47,華南永昌-民權,2024-09-03,9312
00688L,國泰20年美債正2,43,0,43,華南永昌-民權,2024-09-03,9312
00919,群益台灣精選高息,82,40,42,華南永昌-民權,2024-09-03,9312
4123,晟德,40,0,40,華南永昌-民權,2024-09-03,9312
00959B,大華投等美債15Y+,20,0,20,華南永昌-民權,2024-09-03,9312
2002,中鋼,20,1,19,華南永昌-民權,2024-09-03,9312
4534,慶騰,31,13,18,華南永昌-民權,2024-09-03,9312
1301,台塑,17,1,16,華南永昌-民權,2024-09-03,9312
00741B,富邦全球非投等債,15,0,15,華南永昌-民權,2024-09-03,9312
00915,凱基優選高股息30,14,0,14,華南永昌-民權,2024-09-03,9312
00679B,元大美債20年,21,7,14,華南永昌-民權,2024-09-03,9312
6215,和椿,15,1,14,華南永昌-民權,2024-09-03,9312
2417,圓剛,13,0,13,華南永昌-民權,2024-09-03,9312
00878,國泰永續高股息,11,0,11,華南永昌-民權,2024-09-03,9312
1438,三地開發,11,0,11,華南永昌-民權,2024-09-03,9312
8182,加高,12,1,11,華南永昌-民權,2024-09-03,9312
9105,泰金寶-DR,11,0,11,華南永昌-民權,2024-09-03,9312
2887,台新金,16,6,10,華南永昌-民權,2024-09-03,9312
3680,家登,10,0,10,華南永昌-民權,2024-09-03,9312
2349,錸德,10,0,10,華南永昌-民權,2024-09-03,9312
8436,大江,10,0,10,華南永昌-民權,2024-09-03,9312
2356,英業達,12,3,9,華南永昌-民權,2024-09-03,9312
2402,毅嘉,9,0,9,華南永昌-民權,2024-09-03,9312
5519,隆大,9,0,9,華南永昌-民權,2024-09-03,9312
4960,誠美材,8,0,8,華南永昌-民權,2024-09-03,9312
6158,禾昌,8,0,8,華南永昌-民權,2024-09-03,9312
1326,台化,8,1,7,華南永昌-民權,2024-09-03,9312
6937,天虹,11,4,7,華南永昌-民權,2024-09-03,9312
2365,昆盈,19,13,6,華南永昌-民權,2024-09-03,9312
2609,陽明,8,1,7,華南永昌-民權,2024-09-03,9312
2543,皇昌,7,1,6,華南永昌-民權,2024-09-03,9312
2884,玉山金,8,3,5,華南永昌-民權,2024-09-03,9312
00918,大華優利高填息30,5,0,5,華南永昌-民權,2024-09-03,9312
1304,台聚,5,0,5,華南永昌-民權,2024-09-03,9312
2062,橋椿,5,0,5,華南永昌-民權,2024-09-03,9312
2324,仁寶,5,0,5,華南永昌-民權,2024-09-03,9312
2347,聯強,5,0,5,華南永昌-民權,2024-09-03,9312
2419,仲琦,5,0,5,華南永昌-民權,2024-09-03,9312
2460,建通,15,10,5,華南永昌-民權,2024-09-03,9312
2886,兆豐金,5,0,5,華南永昌-民權,2024-09-03,9312
3715,定穎投控,6,1,5,華南永昌-民權,2024-09-03,9312
6188,廣明,5,0,5,華南永昌-民權,2024-09-03,9312
2897,王道銀行,250,0,250,華南永昌-民權,2024-09-04,9312
00919,群益台灣精選高息,215,11,204,華南永昌-民權,2024-09-04,9312
00753L,中信中國50正2,200,0,200,華南永昌-民權,2024-09-04,9312
00945B,凱基美國非投等債,130,0,130,華南永昌-民權,2024-09-04,9312
2801,彰銀,101,0,101,華南永昌-民權,2024-09-04,9312
00929,復華台灣科技優息,89,26,63,華南永昌-民權,2024-09-04,9312
2002,中鋼,69,23,46,華南永昌-民權,2024-09-04,9312
1303,南亞,56,12,44,華南永昌-民權,2024-09-04,9312
00940,元大台灣價值高息,51,10,41,華南永昌-民權,2024-09-04,9312
00687B,國泰20年美債,68,28,40,華南永昌-民權,2024-09-04,9312
00878,國泰永續高股息,41,1,40,華南永昌-民權,2024-09-04,9312
00715L,期街口布蘭特正2,38,0,38,華南永昌-民權,2024-09-04,9312
2891,中信金,38,0,38,華南永昌-民權,2024-09-04,9312
8927,北基,51,20,31,華南永昌-民權,2024-09-04,9312
1326,台化,40,10,30,華南永昌-民權,2024-09-04,9312
1409,新纖,30,0,30,華南永昌-民權,2024-09-04,9312
6505,台塑化,28,0,28,華南永昌-民權,2024-09-04,9312
2834,臺企銀,33,5,28,華南永昌-民權,2024-09-04,9312
2330,台積電,31,4,27,華南永昌-民權,2024-09-04,9312
00915,凱基優選高股息30,29,3,26,華南永昌-民權,2024-09-04,9312
1301,台塑,41,17,24,華南永昌-民權,2024-09-04,9312
00891,中信關鍵半導體,26,3,23,華南永昌-民權,2024-09-04,9312
2303,聯電,23,1,22,華南永昌-民權,2024-09-04,9312
2344,華邦電,21,0,21,華南永昌-民權,2024-09-04,9312
2852,第一保,21,0,21,華南永昌-民權,2024-09-04,9312
4171,瑞基,20,0,20,華南永昌-民權,2024-09-04,9312
4538,大詠城,17,0,17,華南永昌-民權,2024-09-04,9312
2812,台中銀,36,20,16,華南永昌-民權,2024-09-04,9312
1109,信大,16,0,16,華南永昌-民權,2024-09-04,9312
6698,旭暉應材,16,0,16,華南永昌-民權,2024-09-04,9312
00946,群益科技高息成長,15,0,15,華南永昌-民權,2024-09-04,9312
5531,鄉林,15,0,15,華南永昌-民權,2024-09-04,9312
00918,大華優利高填息30,15,1,14,華南永昌-民權,2024-09-04,9312
3357,臺慶科,14,0,14,華南永昌-民權,2024-09-04,9312
9105,泰金寶-DR,13,0,13,華南永昌-民權,2024-09-04,9312
2887,台新金,15,3,12,華南永昌-民權,2024-09-04,9312
5340,建榮,12,0,12,華南永昌-民權,2024-09-04,9312
00943,兆豐電子高息等權,11,0,11,華南永昌-民權,2024-09-04,9312
2464,盟立,11,0,11,華南永昌-民權,2024-09-04,9312
00830,國泰費城半導體,10,0,10,華南永昌-民權,2024-09-04,9312
2317,鴻海,21,11,10,華南永昌-民權,2024-09-04,9312
2382,廣達,13,3,10,華南永昌-民權,2024-09-04,9312
9958,世紀鋼,11,1,10,華南永昌-民權,2024-09-04,9312
2486,一詮,11,1,10,華南永昌-民權,2024-09-04,9312
00948B,中信優息投資級債,10,0,10,華南永昌-民權,2024-09-04,9312
00951,台新日本半導體,10,0,10,華南永昌-民權,2024-09-04,9312
1410,南染,10,0,10,華南永昌-民權,2024-09-04,9312
6789,采鈺,12,2,10,華南永昌-民權,2024-09-04,9312
1785,光洋科,16,6,10,華南永昌-民權,2024-09-04,9312
6116,彩晶,10,0,10,華南永昌-民權,2024-09-04,9312
00751B,元大AAA至A公司債,550,5,545,華南永昌-民權,2024-09-05,9312
00919,群益台灣精選高息,112,2,110,華南永昌-民權,2024-09-05,9312
00952,凱基台灣AI50,73,20,53,華南永昌-民權,2024-09-05,9312
2102,泰豐,70,20,50,華南永昌-民權,2024-09-05,9312
00940,元大台灣價值高息,50,6,44,華南永昌-民權,2024-09-05,9312
00929,復華台灣科技優息,41,11,30,華南永昌-民權,2024-09-05,9312
00946,群益科技高息成長,30,0,30,華南永昌-民權,2024-09-05,9312
00893,國泰智能電動車,30,0,30,華南永昌-民權,2024-09-05,9312
00959B,大華投等美債15Y+,30,0,30,華南永昌-民權,2024-09-05,9312
3652,精聯,30,0,30,華南永昌-民權,2024-09-05,9312
00878,國泰永續高股息,29,0,29,華南永昌-民權,2024-09-05,9312
00715L,期街口布蘭特正2,27,0,27,華南永昌-民權,2024-09-05,9312
00918,大華優利高填息30,23,0,23,華南永昌-民權,2024-09-05,9312
00679B,元大美債20年,25,3,22,華南永昌-民權,2024-09-05,9312
00891,中信關鍵半導體,23,1,22,華南永昌-民權,2024-09-05,9312
1447,力鵬,20,0,20,華南永昌-民權,2024-09-05,9312
2408,南亞科,18,0,18,華南永昌-民權,2024-09-05,9312
1570,力肯,27,9,18,華南永昌-民權,2024-09-05,9312
00772B,中信高評級公司債,18,0,18,華南永昌-民權,2024-09-05,9312
00933B,國泰10Y+金融債,15,0,15,華南永昌-民權,2024-09-05,9312
4760,勤凱,15,0,15,華南永昌-民權,2024-09-05,9312
1109,信大,14,0,14,華南永昌-民權,2024-09-05,9312
1785,光洋科,16,2,14,華南永昌-民權,2024-09-05,9312
2317,鴻海,17,4,13,華南永昌-民權,2024-09-05,9312
2027,大成鋼,12,0,12,華南永昌-民權,2024-09-05,9312
5347,世界,12,0,12,華南永昌-民權,2024-09-05,9312
00943,兆豐電子高息等權,11,0,11,華南永昌-民權,2024-09-05,9312
1314,中石化,16,5,11,華南永昌-民權,2024-09-05,9312
4906,正文,11,0,11,華南永昌-民權,2024-09-05,9312
6509,聚和,10,0,10,華南永昌-民權,2024-09-05,9312
00930,永豐ESG低碳高息,9,0,9,華南永昌-民權,2024-09-05,9312
1438,三地開發,9,0,9,華南永昌-民權,2024-09-05,9312
4562,穎漢,51,42,9,華南永昌-民權,2024-09-05,9312
8039,台虹,33,24,9,華南永昌-民權,2024-09-05,9312
1513,中興電,8,2,6,華南永昌-民權,2024-09-05,9312
2609,陽明,10,4,6,華南永昌-民權,2024-09-05,9312
00795B,中信美國公債20年,6,0,6,華南永昌-民權,2024-09-05,9312
3213,茂訊,7,1,6,華南永昌-民權,2024-09-05,9312
4306,炎洲,6,0,6,華南永昌-民權,2024-09-05,9312
00687B,國泰20年美債,5,0,5,華南永昌-民權,2024-09-05,9312
00632R,元大台灣50反1,5,0,5,華南永昌-民權,2024-09-05,9312
1609,大亞,5,0,5,華南永昌-民權,2024-09-05,9312
1809,中釉,5,0,5,華南永昌-民權,2024-09-05,9312
2340,台亞,6,1,5,華南永昌-民權,2024-09-05,9312
2481,強茂,5,0,5,華南永昌-民權,2024-09-05,9312
2801,彰銀,5,0,5,華南永昌-民權,2024-09-05,9312
3680,家登,5,0,5,華南永昌-民權,2024-09-05,9312
4513,福裕,5,0,5,華南永昌-民權,2024-09-05,9312
6770,力積電,5,0,5,華南永昌-民權,2024-09-05,9312
8064,東捷,6,1,5,華南永昌-民權,2024-09-05,9312
00751B,元大AAA至A公司債,3500,0,3500,華南永昌-民權,2024-09-06,9312
00887,永豐中國科技50大,200,0,200,華南永昌-民權,2024-09-06,9312
00959B,大華投等美債15Y+,100,0,100,華南永昌-民權,2024-09-06,9312
2101,南港,133,58,75,華南永昌-民權,2024-09-06,9312
3652,精聯,75,0,75,華南永昌-民權,2024-09-06,9312
2851,中再保,60,0,60,華南永昌-民權,2024-09-06,9312
00687B,國泰20年美債,58,1,57,華南永昌-民權,2024-09-06,9312
00632R,元大台灣50反1,50,0,50,華南永昌-民權,2024-09-06,9312
00929,復華台灣科技優息,69,21,48,華南永昌-民權,2024-09-06,9312
2102,泰豐,40,0,40,華南永昌-民權,2024-09-06,9312
2852,第一保,40,0,40,華南永昌-民權,2024-09-06,9312
1326,台化,40,4,36,華南永昌-民權,2024-09-06,9312
2367,燿華,31,0,31,華南永昌-民權,2024-09-06,9312
5519,隆大,30,0,30,華南永昌-民權,2024-09-06,9312
00773B,中信優先金融債,22,0,22,華南永昌-民權,2024-09-06,9312
1815,富喬,24,6,18,華南永昌-民權,2024-09-06,9312
3481,群創,50,33,17,華南永昌-民權,2024-09-06,9312
00918,大華優利高填息30,16,0,16,華南永昌-民權,2024-09-06,9312
00919,群益台灣精選高息,13,1,12,華南永昌-民權,2024-09-06,9312
2812,台中銀,23,12,11,華南永昌-民權,2024-09-06,9312
00935,野村臺灣新科技50,10,0,10,華南永昌-民權,2024-09-06,9312
00795B,中信美國公債20年,20,10,10,華南永昌-民權,2024-09-06,9312
6509,聚和,10,0,10,華南永昌-民權,2024-09-06,9312
8054,安國,11,1,10,華南永昌-民權,2024-09-06,9312
00715L,期街口布蘭特正2,7,0,7,華南永昌-民權,2024-09-06,9312
1503,士電,7,0,7,華南永昌-民權,2024-09-06,9312
8027,鈦昇,12,5,7,華南永昌-民權,2024-09-06,9312
2881,富邦金,6,0,6,華南永昌-民權,2024-09-06,9312
6239,力成,6,0,6,華南永昌-民權,2024-09-06,9312
2002,中鋼,17,12,5,華南永昌-民權,2024-09-06,9312
1438,三地開發,5,0,5,華南永昌-民權,2024-09-06,9312
00637L,元大滬深300正2,5,0,5,華南永昌-民權,2024-09-06,9312
1109,信大,5,0,5,華南永昌-民權,2024-09-06,9312
2464,盟立,10,5,5,華南永昌-民權,2024-09-06,9312
2597,潤弘,5,0,5,華南永昌-民權,2024-09-06,9312
3078,僑威,5,0,5,華南永昌-民權,2024-09-06,9312
3581,博磊,5,0,5,華南永昌-民權,2024-09-06,9312
4956,光鋐,7,2,5,華南永昌-民權,2024-09-06,9312
5512,力麒,5,0,5,華南永昌-民權,2024-09-06,9312
2313,華通,5,0,5,華南永昌-民權,2024-09-06,9312
00915,凱基優選高股息30,7,3,4,華南永昌-民權,2024-09-06,9312
00712,復華富時不動產,4,0,4,華南永昌-民權,2024-09-06,9312
00878,國泰永續高股息,4,0,4,華南永昌-民權,2024-09-06,9312
2891,中信金,6,2,4,華南永昌-民權,2024-09-06,9312
3257,虹冠電,4,0,4,華南永昌-民權,2024-09-06,9312
3498,陽程,4,0,4,華南永昌-民權,2024-09-06,9312
5340,建榮,6,2,4,華南永昌-民權,2024-09-06,9312
00905,FT臺灣Smart,3,0,3,華南永昌-民權,2024-09-06,9312
00902,中信電池及儲能,3,0,3,華南永昌-民權,2024-09-06,9312
1795,美時,3,0,3,華南永昌-民權,2024-09-06,9312
00751B,元大AAA至A公司債,2050,50,2000,華南永昌-民權,2024-09-09,9312
00772B,中信高評級公司債,501,0,501,華南永昌-民權,2024-09-09,9312
2897,王道銀行,352,150,202,華南永昌-民權,2024-09-09,9312
5905,南仁湖,150,1,149,華南永昌-民權,2024-09-09,9312
2881,富邦金,108,0,108,華南永昌-民權,2024-09-09,9312
00919,群益台灣精選高息,106,0,106,華南永昌-民權,2024-09-09,9312
00680L,元大美債20正2,100,0,100,華南永昌-民權,2024-09-09,9312
00918,大華優利高填息30,72,0,72,華南永昌-民權,2024-09-09,9312
00740B,富邦全球投等債,55,0,55,華南永昌-民權,2024-09-09,9312
1303,南亞,45,5,40,華南永昌-民權,2024-09-09,9312
2891,中信金,48,11,37,華南永昌-民權,2024-09-09,9312
00915,凱基優選高股息30,32,0,32,華南永昌-民權,2024-09-09,9312
2027,大成鋼,31,0,31,華南永昌-民權,2024-09-09,9312
3652,精聯,30,0,30,華南永昌-民權,2024-09-09,9312
8927,北基,26,0,26,華南永昌-民權,2024-09-09,9312
00878,國泰永續高股息,25,0,25,華南永昌-民權,2024-09-09,9312
2101,南港,25,1,24,華南永昌-民權,2024-09-09,9312
2002,中鋼,25,2,23,華南永昌-民權,2024-09-09,9312
2303,聯電,22,1,21,華南永昌-民權,2024-09-09,9312
6405,悅城,20,0,20,華南永昌-民權,2024-09-09,9312
0056,元大高股息,17,0,17,華南永昌-民權,2024-09-09,9312
2883,凱基金,16,0,16,華南永昌-民權,2024-09-09,9312
1326,台化,30,14,16,華南永昌-民權,2024-09-09,9312
1711,永光,16,0,16,華南永昌-民權,2024-09-09,9312
6269,台郡,15,0,15,華南永昌-民權,2024-09-09,9312
2812,台中銀,41,27,14,華南永昌-民權,2024-09-09,9312
00881,國泰台灣5G+,14,0,14,華南永昌-民權,2024-09-09,9312
1109,信大,15,1,14,華南永昌-民權,2024-09-09,9312
2409,友達,14,0,14,華南永昌-民權,2024-09-09,9312
6191,精成科,14,0,14,華南永昌-民權,2024-09-09,9312
00934,中信成長高股息,16,3,13,華南永昌-民權,2024-09-09,9312
1301,台塑,22,10,12,華南永昌-民權,2024-09-09,9312
8028,昇陽半導體,12,1,11,華南永昌-民權,2024-09-09,9312
00940,元大台灣價值高息,16,6,10,華南永昌-民權,2024-09-09,9312
1447,力鵬,10,0,10,華南永昌-民權,2024-09-09,9312
2545,皇翔,10,0,10,華南永昌-民權,2024-09-09,9312
2547,日勝生,10,0,10,華南永昌-民權,2024-09-09,9312
3008,大立光,10,0,10,華南永昌-民權,2024-09-09,9312
6215,和椿,10,0,10,華南永昌-民權,2024-09-09,9312
6829,千附精密,10,0,10,華南永昌-民權,2024-09-09,9312
2486,一詮,10,0,10,華南永昌-民權,2024-09-09,9312
2330,台積電,9,0,9,華南永昌-民權,2024-09-09,9312
00882,中信中國高股息,9,0,9,華南永昌-民權,2024-09-09,9312
00715L,期街口布蘭特正2,9,0,9,華南永昌-民權,2024-09-09,9312
2888,新光金,15,6,9,華南永昌-民權,2024-09-09,9312
2834,臺企銀,8,0,8,華南永昌-民權,2024-09-09,9312
6770,力積電,10,2,8,華南永昌-民權,2024-09-09,9312
00713,元大台灣高息低波,8,0,8,華南永昌-民權,2024-09-09,9312
6290,良維,6,0,6,華南永昌-民權,2024-09-09,9312
00687B,國泰20年美債,16,10,6,華南永昌-民權,2024-09-09,9312
00772B,中信高評級公司債,2649,42,2607,華南永昌-民權,2024-09-10,9312
00751B,元大AAA至A公司債,501,0,501,華南永昌-民權,2024-09-10,9312
00664R,國泰臺灣加權反1,998,499,499,華南永昌-民權,2024-09-10,9312
00948B,中信優息投資級債,200,1,199,華南永昌-民權,2024-09-10,9312
00929,復華台灣科技優息,152,3,149,華南永昌-民權,2024-09-10,9312
00679B,元大美債20年,204,61,143,華南永昌-民權,2024-09-10,9312
00930,永豐ESG低碳高息,131,0,131,華南永昌-民權,2024-09-10,9312
2337,旺宏,105,0,105,華南永昌-民權,2024-09-10,9312
5905,南仁湖,100,0,100,華南永昌-民權,2024-09-10,9312
00919,群益台灣精選高息,75,4,71,華南永昌-民權,2024-09-10,9312
3481,群創,58,6,52,華南永昌-民權,2024-09-10,9312
2101,南港,80,30,50,華南永昌-民權,2024-09-10,9312
3652,精聯,50,0,50,華南永昌-民權,2024-09-10,9312
8927,北基,106,70,36,華南永昌-民權,2024-09-10,9312
2367,燿華,33,2,31,華南永昌-民權,2024-09-10,9312
1702,南僑,29,0,29,華南永昌-民權,2024-09-10,9312
00918,大華優利高填息30,31,4,27,華南永昌-民權,2024-09-10,9312
4538,大詠城,25,0,25,華南永昌-民權,2024-09-10,9312
2027,大成鋼,23,0,23,華南永昌-民權,2024-09-10,9312
0056,元大高股息,24,1,23,華南永昌-民權,2024-09-10,9312
00952,凱基台灣AI50,22,0,22,華南永昌-民權,2024-09-10,9312
00688L,國泰20年美債正2,20,0,20,華南永昌-民權,2024-09-10,9312
00943,兆豐電子高息等權,20,0,20,華南永昌-民權,2024-09-10,9312
2547,日勝生,20,0,20,華南永昌-民權,2024-09-10,9312
5460,同協,17,0,17,華南永昌-民權,2024-09-10,9312
2382,廣達,23,7,16,華南永昌-民權,2024-09-10,9312
6269,台郡,20,4,16,華南永昌-民權,2024-09-10,9312
1410,南染,15,0,15,華南永昌-民權,2024-09-10,9312
8112,至上,15,0,15,華南永昌-民權,2024-09-10,9312
00940,元大台灣價值高息,23,10,13,華南永昌-民權,2024-09-10,9312
6215,和椿,13,0,13,華南永昌-民權,2024-09-10,9312
2317,鴻海,20,7,13,華南永昌-民權,2024-09-10,9312
1605,華新,12,0,12,華南永昌-民權,2024-09-10,9312
5443,均豪,25,14,11,華南永昌-民權,2024-09-10,9312
00927,群益半導體收益,10,0,10,華南永昌-民權,2024-09-10,9312
3058,立德,10,0,10,華南永昌-民權,2024-09-10,9312
00739,元大MSCI A股,10,0,10,華南永昌-民權,2024-09-10,9312
1570,力肯,16,6,10,華南永昌-民權,2024-09-10,9312
2356,英業達,11,1,10,華南永昌-民權,2024-09-10,9312
2883,凱基金,12,2,10,華南永昌-民權,2024-09-10,9312
4906,正文,10,0,10,華南永昌-民權,2024-09-10,9312
6829,千附精密,10,0,10,華南永昌-民權,2024-09-10,9312
8039,台虹,15,6,9,華南永昌-民權,2024-09-10,9312
00881,國泰台灣5G+,12,3,9,華南永昌-民權,2024-09-10,9312
2497,怡利電,18,9,9,華南永昌-民權,2024-09-10,9312
1314,中石化,30,22,8,華南永昌-民權,2024-09-10,9312
00878,國泰永續高股息,8,0,8,華南永昌-民權,2024-09-10,9312
1711,永光,9,1,8,華南永昌-民權,2024-09-10,9312
8096,擎亞,8,0,8,華南永昌-民權,2024-09-10,9312
8374,羅昇,17,9,8,華南永昌-民權,2024-09-10,9312
2888,新光金,392,55,337,華南永昌-民權,2024-09-11,9312
00940,元大台灣價值高息,286,41,245,華南永昌-民權,2024-09-11,9312
00945B,凱基美國非投等債,60,0,60,華南永昌-民權,2024-09-11,9312
5398,慕康生醫,30,0,30,華南永昌-民權,2024-09-11,9312
00943,兆豐電子高息等權,26,0,26,華南永昌-民權,2024-09-11,9312
1524,耿鼎,25,0,25,華南永昌-民權,2024-09-11,9312
2867,三商壽,25,0,25,華南永昌-民權,2024-09-11,9312
3481,群創,34,9,25,華南永昌-民權,2024-09-11,9312
9927,泰銘,22,0,22,華南永昌-民權,2024-09-11,9312
00688L,國泰20年美債正2,21,1,20,華南永昌-民權,2024-09-11,9312
3652,精聯,20,0,20,華南永昌-民權,2024-09-11,9312
00952,凱基台灣AI50,18,0,18,華南永昌-民權,2024-09-11,9312
00715L,期街口布蘭特正2,17,0,17,華南永昌-民權,2024-09-11,9312
1438,三地開發,17,2,15,華南永昌-民權,2024-09-11,9312
00878,國泰永續高股息,20,6,14,華南永昌-民權,2024-09-11,9312
2834,臺企銀,13,0,13,華南永昌-民權,2024-09-11,9312
8039,台虹,38,25,13,華南永昌-民權,2024-09-11,9312
2891,中信金,13,1,12,華南永昌-民權,2024-09-11,9312
2348,海悅,11,0,11,華南永昌-民權,2024-09-11,9312
00706L,期元大S＆P日圓正2,10,0,10,華南永昌-民權,2024-09-11,9312
1436,華友聯,10,0,10,華南永昌-民權,2024-09-11,9312
5340,建榮,10,0,10,華南永昌-民權,2024-09-11,9312
6127,九豪,10,0,10,華南永昌-民權,2024-09-11,9312
6579,研揚,10,0,10,華南永昌-民權,2024-09-11,9312
00934,中信成長高股息,8,0,8,華南永昌-民權,2024-09-11,9312
0056,元大高股息,7,0,7,華南永昌-民權,2024-09-11,9312
3131,弘塑,10,3,7,華南永昌-民權,2024-09-11,9312
1522,堤維西,6,0,6,華南永昌-民權,2024-09-11,9312
8271,宇瞻,6,0,6,華南永昌-民權,2024-09-11,9312
00919,群益台灣精選高息,7,2,5,華南永昌-民權,2024-09-11,9312
00882,中信中國高股息,5,0,5,華南永昌-民權,2024-09-11,9312
1321,大洋,5,0,5,華南永昌-民權,2024-09-11,9312
1437,勤益控,5,0,5,華南永昌-民權,2024-09-11,9312
2208,台船,5,0,5,華南永昌-民權,2024-09-11,9312
2401,凌陽,5,0,5,華南永昌-民權,2024-09-11,9312
6186,新潤,5,0,5,華南永昌-民權,2024-09-11,9312
6743,安普新,6,1,5,華南永昌-民權,2024-09-11,9312
8070,長華*,7,2,5,華南永昌-民權,2024-09-11,9312
8076,伍豐,5,0,5,華南永昌-民權,2024-09-11,9312
6139,亞翔,5,0,5,華南永昌-民權,2024-09-11,9312
3711,日月光投控,4,0,4,華南永昌-民權,2024-09-11,9312
00915,凱基優選高股息30,4,0,4,華南永昌-民權,2024-09-11,9312
00642U,期元大S＆P石油,4,0,4,華南永昌-民權,2024-09-11,9312
00957B,兆豐US優選投等債,4,0,4,華南永昌-民權,2024-09-11,9312
1815,富喬,9,5,4,華南永昌-民權,2024-09-11,9312
2426,鼎元,4,0,4,華南永昌-民權,2024-09-11,9312
2442,新美齊,4,0,4,華南永昌-民權,2024-09-11,9312
3030,德律,4,0,4,華南永昌-民權,2024-09-11,9312
3049,精金,4,0,4,華南永昌-民權,2024-09-11,9312
3689,湧德,4,0,4,華南永昌-民權,2024-09-11,9312
00664R,國泰臺灣加權反1,599,0,599,華南永昌-民權,2024-09-12,9312
2887,台新金,153,2,151,華南永昌-民權,2024-09-12,9312
3481,群創,89,3,86,華南永昌-民權,2024-09-12,9312
00687B,國泰20年美債,67,15,52,華南永昌-民權,2024-09-12,9312
2888,新光金,50,6,44,華南永昌-民權,2024-09-12,9312
2845,遠東銀,32,0,32,華南永昌-民權,2024-09-12,9312
2364,倫飛,31,0,31,華南永昌-民權,2024-09-12,9312
3607,谷崧,33,3,30,華南永昌-民權,2024-09-12,9312
00937B,群益ESG投等債20,22,0,22,華南永昌-民權,2024-09-12,9312
00945B,凱基美國非投等債,21,1,20,華南永昌-民權,2024-09-12,9312
3663,鑫科,28,10,18,華南永昌-民權,2024-09-12,9312
4526,東台,18,0,18,華南永昌-民權,2024-09-12,9312
00706L,期元大S＆P日圓正2,17,0,17,華南永昌-民權,2024-09-12,9312
00688L,國泰20年美債正2,15,0,15,華南永昌-民權,2024-09-12,9312
00740B,富邦全球投等債,13,0,13,華南永昌-民權,2024-09-12,9312
2891,中信金,15,3,12,華南永昌-民權,2024-09-12,9312
6269,台郡,12,0,12,華南永昌-民權,2024-09-12,9312
00919,群益台灣精選高息,16,6,10,華南永昌-民權,2024-09-12,9312
00795B,中信美國公債20年,10,0,10,華南永昌-民權,2024-09-12,9312
2349,錸德,10,0,10,華南永昌-民權,2024-09-12,9312
2867,三商壽,10,0,10,華南永昌-民權,2024-09-12,9312
5398,慕康生醫,10,0,10,華南永昌-民權,2024-09-12,9312
6257,矽格,9,0,9,華南永昌-民權,2024-09-12,9312
1301,台塑,12,4,8,華南永昌-民權,2024-09-12,9312
2481,強茂,7,0,7,華南永昌-民權,2024-09-12,9312
3491,昇達科,8,1,7,華南永昌-民權,2024-09-12,9312
2618,長榮航,7,1,6,華南永昌-民權,2024-09-12,9312
2233,宇隆,7,1,6,華南永昌-民權,2024-09-12,9312
2399,映泰,33,27,6,華南永昌-民權,2024-09-12,9312
4763,材料-KY,17,11,6,華南永昌-民權,2024-09-12,9312
3013,晟銘電,8,3,5,華南永昌-民權,2024-09-12,9312
8069,元太,5,0,5,華南永昌-民權,2024-09-12,9312
1608,華榮,5,0,5,華南永昌-民權,2024-09-12,9312
2070,精湛,25,20,5,華南永昌-民權,2024-09-12,9312
4716,大立,5,0,5,華南永昌-民權,2024-09-12,9312
6127,九豪,5,0,5,華南永昌-民權,2024-09-12,9312
8070,長華*,30,25,5,華南永昌-民權,2024-09-12,9312
00891,中信關鍵半導體,4,0,4,華南永昌-民權,2024-09-12,9312
00915,凱基優選高股息30,4,0,4,華南永昌-民權,2024-09-12,9312
1316,上曜,5,1,4,華南永昌-民權,2024-09-12,9312
2897,王道銀行,4,0,4,華南永昌-民權,2024-09-12,9312
4967,十銓,5,1,4,華南永昌-民權,2024-09-12,9312
1410,南染,3,0,3,華南永昌-民權,2024-09-12,9312
1524,耿鼎,4,1,3,華南永昌-民權,2024-09-12,9312
1533,車王電,3,0,3,華南永昌-民權,2024-09-12,9312
1570,力肯,3,0,3,華南永昌-民權,2024-09-12,9312
2208,台船,4,1,3,華南永昌-民權,2024-09-12,9312
2344,華邦電,3,0,3,華南永昌-民權,2024-09-12,9312
2355,敬鵬,3,0,3,華南永昌-民權,2024-09-12,9312
2489,瑞軒,5,2,3,華南永昌-民權,2024-09-12,9312
00953B,群益優選非投等債,500,0,500,華南永昌-民權,2024-09-13,9312
00687B,國泰20年美債,274,10,264,華南永昌-民權,2024-09-13,9312
3209,全科,60,0,60,華南永昌-民權,2024-09-13,9312
00633L,富邦上証正2,58,0,58,華南永昌-民權,2024-09-13,9312
2312,金寶,51,6,45,華南永昌-民權,2024-09-13,9312
3652,精聯,20,0,20,華南永昌-民權,2024-09-13,9312
4113,聯上,20,0,20,華南永昌-民權,2024-09-13,9312
00940,元大台灣價值高息,20,2,18,華南永昌-民權,2024-09-13,9312
00929,復華台灣科技優息,21,4,17,華南永昌-民權,2024-09-13,9312
4306,炎洲,21,5,16,華南永昌-民權,2024-09-13,9312
00795B,中信美國公債20年,15,0,15,華南永昌-民權,2024-09-13,9312
00915,凱基優選高股息30,15,0,15,華南永昌-民權,2024-09-13,9312
8011,台通,15,0,15,華南永昌-民權,2024-09-13,9312
9946,三發地產,14,0,14,華南永昌-民權,2024-09-13,9312
00706L,期元大S＆P日圓正2,20,7,13,華南永昌-民權,2024-09-13,9312
00919,群益台灣精選高息,12,0,12,華南永昌-民權,2024-09-13,9312
2303,聯電,11,0,11,華南永昌-民權,2024-09-13,9312
5876,上海商銀,10,0,10,華南永昌-民權,2024-09-13,9312
6152,百一,10,0,10,華南永昌-民權,2024-09-13,9312
2365,昆盈,10,2,8,華南永昌-民權,2024-09-13,9312
6215,和椿,8,0,8,華南永昌-民權,2024-09-13,9312
4526,東台,18,10,8,華南永昌-民權,2024-09-13,9312
00927,群益半導體收益,7,0,7,華南永昌-民權,2024-09-13,9312
2429,銘旺科,7,0,7,華南永昌-民權,2024-09-13,9312
2497,怡利電,11,4,7,華南永昌-民權,2024-09-13,9312
4510,高鋒,10,3,7,華南永昌-民權,2024-09-13,9312
2243,宏旭-KY,7,1,6,華南永昌-民權,2024-09-13,9312
3550,聯穎,7,1,6,華南永昌-民權,2024-09-13,9312
5534,長虹,6,0,6,華南永昌-民權,2024-09-13,9312
00739,元大MSCI A股,5,0,5,華南永昌-民權,2024-09-13,9312
00637L,元大滬深300正2,85,80,5,華南永昌-民權,2024-09-13,9312
00948B,中信優息投資級債,5,0,5,華南永昌-民權,2024-09-13,9312
2332,友訊,5,0,5,華南永昌-民權,2024-09-13,9312
3049,精金,5,0,5,華南永昌-民權,2024-09-13,9312
4549,桓達,5,0,5,華南永昌-民權,2024-09-13,9312
4905,台聯電,5,0,5,華南永昌-民權,2024-09-13,9312
5398,慕康生醫,5,0,5,華南永昌-民權,2024-09-13,9312
6443,元晶,12,7,5,華南永昌-民權,2024-09-13,9312
6509,聚和,5,0,5,華南永昌-民權,2024-09-13,9312
6743,安普新,5,0,5,華南永昌-民權,2024-09-13,9312
8039,台虹,17,13,4,華南永昌-民權,2024-09-13,9312
2610,華航,5,1,4,華南永昌-民權,2024-09-13,9312
1101,台泥,5,1,4,華南永昌-民權,2024-09-13,9312
1528,恩德,4,0,4,華南永昌-民權,2024-09-13,9312
3481,群創,7,3,4,華南永昌-民權,2024-09-13,9312
3666,光耀,4,0,4,華南永昌-民權,2024-09-13,9312
3715,定穎投控,17,13,4,華南永昌-民權,2024-09-13,9312
8182,加高,4,0,4,華南永昌-民權,2024-09-13,9312
8358,金居,5,1,4,華南永昌-民權,2024-09-13,9312
8437,大地-KY,4,0,4,華南永昌-民權,2024-09-13,9312
00713,元大台灣高息低波,1553,65,1488,華南永昌-民權,2024-09-16,9312
2344,華邦電,303,0,303,華南永昌-民權,2024-09-16,9312
00937B,群益ESG投等債20,138,1,137,華南永昌-民權,2024-09-16,9312
6116,彩晶,141,11,130,華南永昌-民權,2024-09-16,9312
2408,南亞科,147,46,101,華南永昌-民權,2024-09-16,9312
0056,元大高股息,100,0,100,華南永昌-民權,2024-09-16,9312
3209,全科,40,0,40,華南永昌-民權,2024-09-16,9312
00680L,元大美債20正2,30,0,30,華南永昌-民權,2024-09-16,9312
00919,群益台灣精選高息,29,0,29,華南永昌-民權,2024-09-16,9312
8076,伍豐,30,3,27,華南永昌-民權,2024-09-16,9312
00940,元大台灣價值高息,30,4,26,華南永昌-民權,2024-09-16,9312
00687B,國泰20年美債,25,0,25,華南永昌-民權,2024-09-16,9312
8039,台虹,31,6,25,華南永昌-民權,2024-09-16,9312
00918,大華優利高填息30,23,0,23,華南永昌-民權,2024-09-16,9312
00948B,中信優息投資級債,30,10,20,華南永昌-民權,2024-09-16,9312
4306,炎洲,20,0,20,華南永昌-民權,2024-09-16,9312
8437,大地-KY,20,0,20,華南永昌-民權,2024-09-16,9312
2618,長榮航,22,3,19,華南永昌-民權,2024-09-16,9312
4513,福裕,81,65,16,華南永昌-民權,2024-09-16,9312
6509,聚和,15,0,15,華南永昌-民權,2024-09-16,9312
00952,凱基台灣AI50,14,0,14,華南永昌-民權,2024-09-16,9312
00927,群益半導體收益,13,0,13,華南永昌-民權,2024-09-16,9312
6830,汎銓,12,0,12,華南永昌-民權,2024-09-16,9312
00943,兆豐電子高息等權,11,0,11,華南永昌-民權,2024-09-16,9312
00739,元大MSCI A股,11,0,11,華南永昌-民權,2024-09-16,9312
2353,宏��,12,1,11,華南永昌-民權,2024-09-16,9312
2477,美隆電,11,0,11,華南永昌-民權,2024-09-16,9312
00929,復華台灣科技優息,13,2,11,華南永昌-民權,2024-09-16,9312
1210,大成,10,0,10,華南永昌-民權,2024-09-16,9312
00915,凱基優選高股息30,10,0,10,華南永昌-民權,2024-09-16,9312
1710,東聯,10,0,10,華南永昌-民權,2024-09-16,9312
2498,宏達電,10,0,10,華南永昌-民權,2024-09-16,9312
3673,TPK-KY,10,0,10,華南永昌-民權,2024-09-16,9312
5522,遠雄,10,0,10,華南永昌-民權,2024-09-16,9312
6152,百一,12,2,10,華南永昌-民權,2024-09-16,9312
2609,陽明,10,1,9,華南永昌-民權,2024-09-16,9312
9946,三發地產,8,0,8,華南永昌-民權,2024-09-16,9312
2481,強茂,10,3,7,華南永昌-民權,2024-09-16,9312
3062,建漢,17,11,6,華南永昌-民權,2024-09-16,9312
1609,大亞,5,0,5,華南永昌-民權,2024-09-16,9312
00715L,期街口布蘭特正2,5,0,5,華南永昌-民權,2024-09-16,9312
2454,聯發科,5,0,5,華南永昌-民權,2024-09-16,9312
3434,哲固,5,0,5,華南永昌-民權,2024-09-16,9312
4113,聯上,5,0,5,華南永昌-民權,2024-09-16,9312
5398,慕康生醫,5,0,5,華南永昌-民權,2024-09-16,9312
6405,悅城,5,0,5,華南永昌-民權,2024-09-16,9312
8021,尖點,5,0,5,華南永昌-民權,2024-09-16,9312
2888B,新光金乙特,4,0,4,華南永昌-民權,2024-09-16,9312
6869,雲豹能源,11,7,4,華南永昌-民權,2024-09-16,9312
2431,聯昌,4,0,4,華南永昌-民權,2024-09-16,9312
00706L,期元大S＆P日圓正2,253,0,253,華南永昌-民權,2024-09-18,9312
00948B,中信優息投資級債,100,0,100,華南永昌-民權,2024-09-18,9312
00687B,國泰20年美債,98,5,93,華南永昌-民權,2024-09-18,9312
2888,新光金,236,161,75,華南永昌-民權,2024-09-18,9312
2344,華邦電,60,6,54,華南永昌-民權,2024-09-18,9312
00919,群益台灣精選高息,43,0,43,華南永昌-民權,2024-09-18,9312
00680L,元大美債20正2,43,1,42,華南永昌-民權,2024-09-18,9312
2887,台新金,45,5,40,華南永昌-民權,2024-09-18,9312
00688L,國泰20年美債正2,30,0,30,華南永昌-民權,2024-09-18,9312
6929,佑全,27,0,27,華南永昌-民權,2024-09-18,9312
3652,精聯,20,0,20,華南永昌-民權,2024-09-18,9312
3167,大量,51,33,18,華南永昌-民權,2024-09-18,9312
6603,富強鑫,18,0,18,華南永昌-民權,2024-09-18,9312
2317,鴻海,21,3,18,華南永昌-民權,2024-09-18,9312
00679B,元大美債20年,18,1,17,華南永昌-民權,2024-09-18,9312
00713,元大台灣高息低波,16,0,16,華南永昌-民權,2024-09-18,9312
00915,凱基優選高股息30,16,0,16,華南永昌-民權,2024-09-18,9312
2401,凌陽,16,0,16,華南永昌-民權,2024-09-18,9312
00795B,中信美國公債20年,30,15,15,華南永昌-民權,2024-09-18,9312
2002,中鋼,31,18,13,華南永昌-民權,2024-09-18,9312
2888B,新光金乙特,13,0,13,華南永昌-民權,2024-09-18,9312
6269,台郡,11,0,11,華南永昌-民權,2024-09-18,9312
1717,長興,31,20,11,華南永昌-民權,2024-09-18,9312
2489,瑞軒,11,0,11,華南永昌-民權,2024-09-18,9312
3264,欣銓,11,0,11,華南永昌-民權,2024-09-18,9312
2409,友達,10,0,10,華南永昌-民權,2024-09-18,9312
2540,愛山林,10,0,10,華南永昌-民權,2024-09-18,9312
1210,大成,10,0,10,華南永昌-民權,2024-09-18,9312
00942B,台新美A公司債20+,10,0,10,華南永昌-民權,2024-09-18,9312
2497,怡利電,10,0,10,華南永昌-民權,2024-09-18,9312
2515,中工,10,0,10,華南永昌-民權,2024-09-18,9312
1785,光洋科,22,12,10,華南永昌-民權,2024-09-18,9312
2324,仁寶,10,0,10,華南永昌-民權,2024-09-18,9312
0056,元大高股息,10,0,10,華南永昌-民權,2024-09-18,9312
3481,群創,24,15,9,華南永昌-民權,2024-09-18,9312
3062,建漢,11,2,9,華南永昌-民權,2024-09-18,9312
4906,正文,10,1,9,華南永昌-民權,2024-09-18,9312
00900,富邦特選高股息30,8,0,8,華南永昌-民權,2024-09-18,9312
9946,三發地產,8,0,8,華南永昌-民權,2024-09-18,9312
2420,新巨,8,1,7,華南永昌-民權,2024-09-18,9312
5905,南仁湖,12,5,7,華南永昌-民權,2024-09-18,9312
8111,立��,9,2,7,華南永昌-民權,2024-09-18,9312
00927,群益半導體收益,6,0,6,華南永昌-民權,2024-09-18,9312
6743,安普新,6,0,6,華南永昌-民權,2024-09-18,9312
00881,國泰台灣5G+,6,0,6,華南永昌-民權,2024-09-18,9312
2303,聯電,7,1,6,華南永昌-民權,2024-09-18,9312
2359,所羅門,7,1,6,華南永昌-民權,2024-09-18,9312
2477,美隆電,9,3,6,華南永昌-民權,2024-09-18,9312
3615,安可,6,0,6,華南永昌-民權,2024-09-18,9312
1229,聯華,5,0,5,華南永昌-民權,2024-09-18,9312
2382,廣達,153,1,152,華南永昌-民權,2024-09-19,9312
00795B,中信美國公債20年,115,6,109,華南永昌-民權,2024-09-19,9312
00958B,永豐ESG銀行債15,100,10,90,華南永昌-民權,2024-09-19,9312
5443,均豪,123,41,82,華南永昌-民權,2024-09-19,9312
00687B,國泰20年美債,92,14,78,華南永昌-民權,2024-09-19,9312
00937B,群益ESG投等債20,81,24,57,華南永昌-民權,2024-09-19,9312
2903,遠百,45,0,45,華南永昌-民權,2024-09-19,9312
00918,大華優利高填息30,41,4,37,華南永昌-民權,2024-09-19,9312
00940,元大台灣價值高息,50,13,37,華南永昌-民權,2024-09-19,9312
3163,波若威,36,0,36,華南永昌-民權,2024-09-19,9312
2891,中信金,35,0,35,華南永昌-民權,2024-09-19,9312
00706L,期元大S＆P日圓正2,25,0,25,華南永昌-民權,2024-09-19,9312
3188,鑫龍騰,20,0,20,華南永昌-民權,2024-09-19,9312
00929,復華台灣科技優息,22,4,18,華南永昌-民權,2024-09-19,9312
3049,精金,40,22,18,華南永昌-民權,2024-09-19,9312
4904,遠傳,20,2,18,華南永昌-民權,2024-09-19,9312
8112,至上,18,1,17,華南永昌-民權,2024-09-19,9312
2208,台船,18,2,16,華南永昌-民權,2024-09-19,9312
1532,勤美,15,0,15,華南永昌-民權,2024-09-19,9312
2467,志聖,25,10,15,華南永昌-民權,2024-09-19,9312
00930,永豐ESG低碳高息,14,0,14,華南永昌-民權,2024-09-19,9312
00919,群益台灣精選高息,36,23,13,華南永昌-民權,2024-09-19,9312
00764B,群益25年美債,13,0,13,華南永昌-民權,2024-09-19,9312
2349,錸德,21,11,10,華南永昌-民權,2024-09-19,9312
6603,富強鑫,10,0,10,華南永昌-民權,2024-09-19,9312
2317,鴻海,11,2,9,華南永昌-民權,2024-09-19,9312
6669,緯穎,10,1,9,華南永昌-民權,2024-09-19,9312
2062,橋椿,10,3,7,華南永昌-民權,2024-09-19,9312
2374,佳能,9,2,7,華南永昌-民權,2024-09-19,9312
00915,凱基優選高股息30,6,0,6,華南永昌-民權,2024-09-19,9312
1101,台泥,9,3,6,華南永昌-民權,2024-09-19,9312
6288,聯嘉,12,6,6,華南永昌-民權,2024-09-19,9312
8011,台通,12,6,6,華南永昌-民權,2024-09-19,9312
00740B,富邦全球投等債,5,0,5,華南永昌-民權,2024-09-19,9312
1410,南染,5,0,5,華南永昌-民權,2024-09-19,9312
1419,新紡,5,0,5,華南永昌-民權,2024-09-19,9312
2610,華航,5,0,5,華南永昌-民權,2024-09-19,9312
3033,威健,5,0,5,華南永昌-民權,2024-09-19,9312
3202,樺晟,5,0,5,華南永昌-民權,2024-09-19,9312
3374,精材,6,2,4,華南永昌-民權,2024-09-19,9312
3711,日月光投控,5,1,4,華南永昌-民權,2024-09-19,9312
4542,科嶠,6,2,4,華南永昌-民權,2024-09-19,9312
9955,佳龍,5,1,4,華南永昌-民權,2024-09-19,9312
3583,辛耘,12,8,4,華南永昌-民權,2024-09-19,9312
00713,元大台灣高息低波,3,0,3,華南永昌-民權,2024-09-19,9312
6176,瑞儀,3,0,3,華南永昌-民權,2024-09-19,9312
2477,美隆電,3,0,3,華南永昌-民權,2024-09-19,9312
1316,上曜,3,0,3,華南永昌-民權,2024-09-19,9312
2344,華邦電,16,13,3,華南永昌-民權,2024-09-19,9312
2460,建通,15,12,3,華南永昌-民權,2024-09-19,9312
2101,南港,404,8,396,華南永昌-民權,2024-09-20,9312
2102,泰豐,152,0,152,華南永昌-民權,2024-09-20,9312
2515,中工,74,0,74,華南永昌-民權,2024-09-20,9312
00953B,群益優選非投等債,60,0,60,華南永昌-民權,2024-09-20,9312
00958B,永豐ESG銀行債15,58,0,58,華南永昌-民權,2024-09-20,9312
00952,凱基台灣AI50,56,0,56,華南永昌-民權,2024-09-20,9312
00919,群益台灣精選高息,55,1,54,華南永昌-民權,2024-09-20,9312
00937B,群益ESG投等債20,51,3,48,華南永昌-民權,2024-09-20,9312
1321,大洋,44,0,44,華南永昌-民權,2024-09-20,9312
00680L,元大美債20正2,50,7,43,華南永昌-民權,2024-09-20,9312
3652,精聯,30,0,30,華南永昌-民權,2024-09-20,9312
4306,炎洲,27,3,24,華南永昌-民權,2024-09-20,9312
4903,聯光通,42,19,23,華南永昌-民權,2024-09-20,9312
2347,聯強,20,0,20,華南永昌-民權,2024-09-20,9312
2903,遠百,20,0,20,華南永昌-民權,2024-09-20,9312
8421,旭源,20,0,20,華南永昌-民權,2024-09-20,9312
8249,菱光,33,14,19,華南永昌-民權,2024-09-20,9312
9934,成霖,18,0,18,華南永昌-民權,2024-09-20,9312
2603,長榮,18,3,15,華南永昌-民權,2024-09-20,9312
4303,信立,15,0,15,華南永昌-民權,2024-09-20,9312
4534,慶騰,15,0,15,華南永昌-民權,2024-09-20,9312
2062,橋椿,46,32,14,華南永昌-民權,2024-09-20,9312
2888,新光金,34,20,14,華南永昌-民權,2024-09-20,9312
9938,百和,14,1,13,華南永昌-民權,2024-09-20,9312
2542,興富發,15,3,12,華南永昌-民權,2024-09-20,9312
00679B,元大美債20年,11,0,11,華南永昌-民權,2024-09-20,9312
00948B,中信優息投資級債,11,0,11,華南永昌-民權,2024-09-20,9312
1101,台泥,11,0,11,華南永昌-民權,2024-09-20,9312
2883,凱基金,11,0,11,華南永昌-民權,2024-09-20,9312
3049,精金,14,3,11,華南永昌-民權,2024-09-20,9312
3354,律勝,19,8,11,華南永昌-民權,2024-09-20,9312
1714,和桐,10,0,10,華南永昌-民權,2024-09-20,9312
2349,錸德,10,0,10,華南永昌-民權,2024-09-20,9312
3048,益登,10,0,10,華南永昌-民權,2024-09-20,9312
6509,聚和,16,6,10,華南永昌-民權,2024-09-20,9312
2501,國建,8,0,8,華南永昌-民權,2024-09-20,9312
3380,明泰,8,0,8,華南永昌-民權,2024-09-20,9312
1808,潤隆,7,0,7,華南永昌-民權,2024-09-20,9312
2408,南亞科,7,0,7,華南永昌-民權,2024-09-20,9312
1702,南僑,20,13,7,華南永昌-民權,2024-09-20,9312
3062,建漢,13,6,7,華南永昌-民權,2024-09-20,9312
6789,采鈺,7,0,7,華南永昌-民權,2024-09-20,9312
8039,台虹,11,4,7,華南永昌-民權,2024-09-20,9312
00713,元大台灣高息低波,6,0,6,華南永昌-民權,2024-09-20,9312
00688L,國泰20年美債正2,6,0,6,華南永昌-民權,2024-09-20,9312
6104,創惟,7,1,6,華南永昌-民權,2024-09-20,9312
00915,凱基優選高股息30,7,1,6,華南永昌-民權,2024-09-20,9312
1316,上曜,7,2,5,華南永昌-民權,2024-09-20,9312
6269,台郡,5,0,5,華南永昌-民權,2024-09-20,9312
2454,聯發科,6,1,5,華南永昌-民權,2024-09-20,9312
00772B,中信高評級公司債,1752,752,1000,華南永昌-民權,2024-09-23,9312
00687B,國泰20年美債,176,37,139,華南永昌-民權,2024-09-23,9312
00919,群益台灣精選高息,114,2,112,華南永昌-民權,2024-09-23,9312
2891,中信金,77,14,63,華南永昌-民權,2024-09-23,9312
2101,南港,162,104,58,華南永昌-民權,2024-09-23,9312
1326,台化,50,1,49,華南永昌-民權,2024-09-23,9312
00937B,群益ESG投等債20,41,0,41,華南永昌-民權,2024-09-23,9312
6509,聚和,40,0,40,華南永昌-民權,2024-09-23,9312
3481,群創,32,7,25,華南永昌-民權,2024-09-23,9312
1321,大洋,21,0,21,華南永昌-民權,2024-09-23,9312
9934,成霖,21,0,21,華南永昌-民權,2024-09-23,9312
2408,南亞科,20,1,19,華南永昌-民權,2024-09-23,9312
3498,陽程,24,6,18,華南永昌-民權,2024-09-23,9312
4538,大詠城,18,0,18,華南永昌-民權,2024-09-23,9312
5515,建國,15,0,15,華南永昌-民權,2024-09-23,9312
00915,凱基優選高股息30,12,0,12,華南永昌-民權,2024-09-23,9312
2888B,新光金乙特,12,0,12,華南永昌-民權,2024-09-23,9312
2464,盟立,12,1,11,華南永昌-民權,2024-09-23,9312
00632R,元大台灣50反1,10,0,10,華南永昌-民權,2024-09-23,9312
006208,富邦台50,10,0,10,華南永昌-民權,2024-09-23,9312
00958B,永豐ESG銀行債15,10,0,10,華南永昌-民權,2024-09-23,9312
4534,慶騰,10,0,10,華南永昌-民權,2024-09-23,9312
1711,永光,9,1,8,華南永昌-民權,2024-09-23,9312
6451,訊芯-KY,9,1,8,華南永昌-民權,2024-09-23,9312
8299,群聯,8,0,8,華南永昌-民權,2024-09-23,9312
2425,承啟,7,0,7,華南永昌-民權,2024-09-23,9312
2882,國泰金,10,3,7,華南永昌-民權,2024-09-23,9312
3049,精金,7,0,7,華南永昌-民權,2024-09-23,9312
1727,中華化,10,4,6,華南永昌-民權,2024-09-23,9312
1442,名軒,6,0,6,華南永昌-民權,2024-09-23,9312
4919,新唐,6,0,6,華南永昌-民權,2024-09-23,9312
6275,元山,6,0,6,華南永昌-民權,2024-09-23,9312
2330,台積電,5,0,5,華南永昌-民權,2024-09-23,9312
00952,凱基台灣AI50,5,0,5,華南永昌-民權,2024-09-23,9312
1722,台肥,5,0,5,華南永昌-民權,2024-09-23,9312
5315,光聯,5,0,5,華南永昌-民權,2024-09-23,9312
6015,宏遠證,5,0,5,華南永昌-民權,2024-09-23,9312
6191,精成科,5,0,5,華南永昌-民權,2024-09-23,9312
2349,錸德,11,6,5,華南永昌-民權,2024-09-23,9312
2888A,新光金甲特,5,0,5,華南永昌-民權,2024-09-23,9312
2369,菱生,4,0,4,華南永昌-民權,2024-09-23,9312
4909,新復興,9,5,4,華南永昌-民權,2024-09-23,9312
5519,隆大,8,4,4,華南永昌-民權,2024-09-23,9312
6215,和椿,4,0,4,華南永昌-民權,2024-09-23,9312
9904,寶成,4,0,4,華南永昌-民權,2024-09-23,9312
2356,英業達,6,2,4,華南永昌-民權,2024-09-23,9312
0056,元大高股息,3,0,3,華南永昌-民權,2024-09-23,9312
1815,富喬,6,3,3,華南永昌-民權,2024-09-23,9312
2105,正新,3,0,3,華南永昌-民權,2024-09-23,9312
2374,佳能,3,0,3,華南永昌-民權,2024-09-23,9312
1609,大亞,64,2,62,華南永昌-民權,2024-09-24,9312
3037,欣興,63,1,62,華南永昌-民權,2024-09-24,9312
2891,中信金,69,8,61,華南永昌-民權,2024-09-24,9312
00687B,國泰20年美債,51,0,51,華南永昌-民權,2024-09-24,9312
2101,南港,50,0,50,華南永昌-民權,2024-09-24,9312
1524,耿鼎,47,1,46,華南永昌-民權,2024-09-24,9312
3481,群創,38,7,31,華南永昌-民權,2024-09-24,9312
00632R,元大台灣50反1,38,9,29,華南永昌-民權,2024-09-24,9312
6177,達麗,30,2,28,華南永昌-民權,2024-09-24,9312
0056,元大高股息,26,0,26,華南永昌-民權,2024-09-24,9312
00633L,富邦上証正2,35,10,25,華南永昌-民權,2024-09-24,9312
00960,野村全球航運龍頭,22,0,22,華南永昌-民權,2024-09-24,9312
2888,新光金,22,0,22,華南永昌-民權,2024-09-24,9312
3652,精聯,20,0,20,華南永昌-民權,2024-09-24,9312
8111,立��,36,20,16,華南永昌-民權,2024-09-24,9312
2481,強茂,38,23,15,華南永昌-民權,2024-09-24,9312
00919,群益台灣精選高息,14,0,14,華南永昌-民權,2024-09-24,9312
00915,凱基優選高股息30,13,0,13,華南永昌-民權,2024-09-24,9312
6109,亞元,13,0,13,華南永昌-民權,2024-09-24,9312
2349,錸德,12,0,12,華南永昌-民權,2024-09-24,9312
8438,昶昕,12,0,12,華南永昌-民權,2024-09-24,9312
9945,潤泰新,11,0,11,華南永昌-民權,2024-09-24,9312
00679B,元大美債20年,11,1,10,華南永昌-民權,2024-09-24,9312
00958B,永豐ESG銀行債15,10,0,10,華南永昌-民權,2024-09-24,9312
2109,華豐,10,0,10,華南永昌-民權,2024-09-24,9312
3607,谷崧,10,0,10,華南永昌-民權,2024-09-24,9312
3715,定穎投控,24,14,10,華南永昌-民權,2024-09-24,9312
6005,群益證,10,0,10,華南永昌-民權,2024-09-24,9312
6516,勤崴國際,10,0,10,華南永昌-民權,2024-09-24,9312
2340,台亞,12,3,9,華南永昌-民權,2024-09-24,9312
3149,正達,14,6,8,華南永昌-民權,2024-09-24,9312
00712,復華富時不動產,7,0,7,華南永昌-民權,2024-09-24,9312
2498,宏達電,7,0,7,華南永昌-民權,2024-09-24,9312
2344,華邦電,6,0,6,華南永昌-民權,2024-09-24,9312
6706,惠特,54,48,6,華南永昌-民權,2024-09-24,9312
6186,新潤,5,0,5,華南永昌-民權,2024-09-24,9312
1325,恆大,5,0,5,華南永昌-民權,2024-09-24,9312
1776,展宇,10,5,5,華南永昌-民權,2024-09-24,9312
3548,兆利,6,1,5,華南永昌-民權,2024-09-24,9312
3605,宏致,17,12,5,華南永昌-民權,2024-09-24,9312
3675,德微,5,0,5,華南永昌-民權,2024-09-24,9312
4562,穎漢,6,1,5,華南永昌-民權,2024-09-24,9312
5515,建國,5,0,5,華南永昌-民權,2024-09-24,9312
5905,南仁湖,7,2,5,華南永昌-民權,2024-09-24,9312
2477,美隆電,4,0,4,華南永昌-民權,2024-09-24,9312
3583,辛耘,4,0,4,華南永昌-民權,2024-09-24,9312
00939,統一台灣高息動能,4,0,4,華南永昌-民權,2024-09-24,9312
2408,南亞科,4,0,4,華南永昌-民權,2024-09-24,9312
4987,科誠,4,0,4,華南永昌-民權,2024-09-24,9312
6290,良維,4,0,4,華南永昌-民權,2024-09-24,9312
2376,技嘉,152,2,150,華南永昌-民權,2024-09-25,9312
00940,元大台灣價值高息,150,5,145,華南永昌-民權,2024-09-25,9312
00933B,國泰10Y+金融債,122,51,71,華南永昌-民權,2024-09-25,9312
3481,群創,93,39,54,華南永昌-民權,2024-09-25,9312
00664R,國泰臺灣加權反1,100,50,50,華南永昌-民權,2024-09-25,9312
3047,訊舟,53,7,46,華南永昌-民權,2024-09-25,9312
5452,佶優,45,0,45,華南永昌-民權,2024-09-25,9312
6152,百一,35,0,35,華南永昌-民權,2024-09-25,9312
1524,耿鼎,34,1,33,華南永昌-民權,2024-09-25,9312
5272,笙科,30,0,30,華南永昌-民權,2024-09-25,9312
5519,隆大,30,0,30,華南永昌-民權,2024-09-25,9312
00960,野村全球航運龍頭,32,6,26,華南永昌-民權,2024-09-25,9312
1711,永光,26,2,24,華南永昌-民權,2024-09-25,9312
00679B,元大美債20年,22,2,20,華南永昌-民權,2024-09-25,9312
5443,均豪,20,0,20,華南永昌-民權,2024-09-25,9312
8404,百和興業-KY,20,0,20,華南永昌-民權,2024-09-25,9312
4510,高鋒,30,11,19,華南永昌-民權,2024-09-25,9312
6603,富強鑫,34,17,17,華南永昌-民權,2024-09-25,9312
1584,精剛,16,0,16,華南永昌-民權,2024-09-25,9312
00687B,國泰20年美債,15,0,15,華南永昌-民權,2024-09-25,9312
1597,直得,15,1,14,華南永昌-民權,2024-09-25,9312
00632R,元大台灣50反1,11,0,11,華南永昌-民權,2024-09-25,9312
6405,悅城,11,0,11,華南永昌-民權,2024-09-25,9312
2454,聯發科,20,10,10,華南永昌-民權,2024-09-25,9312
00739,元大MSCI A股,30,20,10,華南永昌-民權,2024-09-25,9312
2520,冠德,10,0,10,華南永昌-民權,2024-09-25,9312
2903,遠百,10,0,10,華南永昌-民權,2024-09-25,9312
3038,全台,10,0,10,華南永昌-民權,2024-09-25,9312
5398,慕康生醫,10,0,10,華南永昌-民權,2024-09-25,9312
8064,東捷,10,0,10,華南永昌-民權,2024-09-25,9312
2356,英業達,9,1,8,華南永昌-民權,2024-09-25,9312
00680L,元大美債20正2,12,4,8,華南永昌-民權,2024-09-25,9312
4566,時碩工業,10,2,8,華南永昌-民權,2024-09-25,9312
8249,菱光,29,21,8,華南永昌-民權,2024-09-25,9312
6785,昱展新藥,7,0,7,華南永昌-民權,2024-09-25,9312
2228,劍麟,6,0,6,華南永昌-民權,2024-09-25,9312
2354,鴻準,6,0,6,華南永昌-民權,2024-09-25,9312
2537,聯上發,6,0,6,華南永昌-民權,2024-09-25,9312
6923,中台,6,0,6,華南永昌-民權,2024-09-25,9312
00937B,群益ESG投等債20,14,9,5,華南永昌-民權,2024-09-25,9312
1438,三地開發,5,0,5,華南永昌-民權,2024-09-25,9312
2303,聯電,17,12,5,華南永昌-民權,2024-09-25,9312
2495,普安,8,3,5,華南永昌-民權,2024-09-25,9312
6177,達麗,7,2,5,華南永昌-民權,2024-09-25,9312
6488,環球晶,5,0,5,華南永昌-民權,2024-09-25,9312
8438,昶昕,5,0,5,華南永昌-民權,2024-09-25,9312
5460,同協,4,0,4,華南永昌-民權,2024-09-25,9312
1528,恩德,4,0,4,華南永昌-民權,2024-09-25,9312
1809,中釉,16,12,4,華南永昌-民權,2024-09-25,9312
2399,映泰,4,0,4,華南永昌-民權,2024-09-25,9312
00632R,元大台灣50反1,207,8,199,華南永昌-民權,2024-09-26,9312
2376,技嘉,112,0,112,華南永昌-民權,2024-09-26,9312
00680L,元大美債20正2,80,0,80,華南永昌-民權,2024-09-26,9312
00937B,群益ESG投等債20,77,20,57,華南永昌-民權,2024-09-26,9312
4968,立積,58,2,56,華南永昌-民權,2024-09-26,9312
1524,耿鼎,32,0,32,華南永昌-民權,2024-09-26,9312
00669R,國泰美國道瓊反1,30,0,30,華南永昌-民權,2024-09-26,9312
2349,錸德,30,0,30,華南永昌-民權,2024-09-26,9312
3652,精聯,30,0,30,華南永昌-民權,2024-09-26,9312
9927,泰銘,25,0,25,華南永昌-民權,2024-09-26,9312
00687B,國泰20年美債,24,0,24,華南永昌-民權,2024-09-26,9312
00960,野村全球航運龍頭,30,10,20,華南永昌-民權,2024-09-26,9312
00915,凱基優選高股息30,18,0,18,華南永昌-民權,2024-09-26,9312
3019,亞光,19,3,16,華南永昌-民權,2024-09-26,9312
00679B,元大美債20年,16,0,16,華南永昌-民權,2024-09-26,9312
2356,英業達,15,0,15,華南永昌-民權,2024-09-26,9312
00952,凱基台灣AI50,15,0,15,華南永昌-民權,2024-09-26,9312
2208,台船,14,0,14,華南永昌-民權,2024-09-26,9312
2344,華邦電,26,12,14,華南永昌-民權,2024-09-26,9312
2436,偉詮電,14,0,14,華南永昌-民權,2024-09-26,9312
2481,強茂,19,5,14,華南永昌-民權,2024-09-26,9312
3042,晶技,12,0,12,華南永昌-民權,2024-09-26,9312
1808,潤隆,11,0,11,華南永昌-民權,2024-09-26,9312
00946,群益科技高息成長,11,0,11,華南永昌-民權,2024-09-26,9312
1584,精剛,12,1,11,華南永昌-民權,2024-09-26,9312
2393,億光,11,0,11,華南永昌-民權,2024-09-26,9312
2888,新光金,11,0,11,華南永昌-民權,2024-09-26,9312
5272,笙科,11,0,11,華南永昌-民權,2024-09-26,9312
00933B,國泰10Y+金融債,10,0,10,華南永昌-民權,2024-09-26,9312
6190,萬泰科,10,0,10,華南永昌-民權,2024-09-26,9312
3005,神基,11,2,9,華南永昌-民權,2024-09-26,9312
4905,台聯電,8,0,8,華南永昌-民權,2024-09-26,9312
00715L,期街口布蘭特正2,7,0,7,華南永昌-民權,2024-09-26,9312
2312,金寶,12,5,7,華南永昌-民權,2024-09-26,9312
3605,宏致,23,16,7,華南永昌-民權,2024-09-26,9312
6104,創惟,11,4,7,華南永昌-民權,2024-09-26,9312
2365,昆盈,6,0,6,華南永昌-民權,2024-09-26,9312
8249,菱光,6,0,6,華南永昌-民權,2024-09-26,9312
00948B,中信優息投資級債,5,0,5,華南永昌-民權,2024-09-26,9312
1773,勝一,5,0,5,華南永昌-民權,2024-09-26,9312
1904,正隆,5,0,5,華南永昌-民權,2024-09-26,9312
2247,汎德永業,5,0,5,華南永昌-民權,2024-09-26,9312
6152,百一,5,0,5,華南永昌-民權,2024-09-26,9312
8201,無敵,5,0,5,華南永昌-民權,2024-09-26,9312
2371,大同,8,3,5,華南永昌-民權,2024-09-26,9312
1717,長興,5,1,4,華南永昌-民權,2024-09-26,9312
00919,群益台灣精選高息,4,0,4,華南永昌-民權,2024-09-26,9312
3710,連展投控,4,0,4,華南永昌-民權,2024-09-26,9312
2421,建準,5,1,4,華南永昌-民權,2024-09-26,9312
3231,緯創,4,0,4,華南永昌-民權,2024-09-26,9312
3715,定穎投控,167,22,145,華南永昌-民權,2024-09-27,9312
00632R,元大台灣50反1,100,0,100,華南永昌-民權,2024-09-27,9312
00687B,國泰20年美債,99,12,87,華南永昌-民權,2024-09-27,9312
00939,統一台灣高息動能,78,17,61,華南永昌-民權,2024-09-27,9312
2344,華邦電,48,9,39,華南永昌-民權,2024-09-27,9312
1702,南僑,36,0,36,華南永昌-民權,2024-09-27,9312
00665L,富邦�琤肭磪囓�2,22,0,22,華南永昌-民權,2024-09-27,9312
00919,群益台灣精選高息,22,1,21,華南永昌-民權,2024-09-27,9312
2023,燁輝,21,1,20,華南永昌-民權,2024-09-27,9312
8076,伍豐,18,0,18,華南永昌-民權,2024-09-27,9312
2030,彰源,15,0,15,華南永昌-民權,2024-09-27,9312
9927,泰銘,13,0,13,華南永昌-民權,2024-09-27,9312
2641,正德,16,3,13,華南永昌-民權,2024-09-27,9312
3605,宏致,23,11,12,華南永昌-民權,2024-09-27,9312
6582,申豐,12,0,12,華南永昌-民權,2024-09-27,9312
00937B,群益ESG投等債20,14,2,12,華南永昌-民權,2024-09-27,9312
2891,中信金,18,7,11,華南永昌-民權,2024-09-27,9312
4979,華星光,32,21,11,華南永昌-民權,2024-09-27,9312
6869,雲豹能源,16,6,10,華南永昌-民權,2024-09-27,9312
00706L,期元大S＆P日圓正2,10,0,10,華南永昌-民權,2024-09-27,9312
2634,漢翔,10,0,10,華南永昌-民權,2024-09-27,9312
5014,建錩,10,0,10,華南永昌-民權,2024-09-27,9312
6190,萬泰科,10,0,10,華南永昌-民權,2024-09-27,9312
9962,有益,10,0,10,華南永昌-民權,2024-09-27,9312
1809,中釉,23,14,9,華南永昌-民權,2024-09-27,9312
2882,國泰金,12,3,9,華南永昌-民權,2024-09-27,9312
2356,英業達,8,0,8,華南永昌-民權,2024-09-27,9312
2348,海悅,8,0,8,華南永昌-民權,2024-09-27,9312
4566,時碩工業,10,2,8,華南永昌-民權,2024-09-27,9312
00753L,中信中國50正2,7,0,7,華南永昌-民權,2024-09-27,9312
1455,集盛,7,0,7,華南永昌-民權,2024-09-27,9312
3711,日月光投控,8,2,6,華南永昌-民權,2024-09-27,9312
00948B,中信優息投資級債,6,0,6,華南永昌-民權,2024-09-27,9312
1905,華紙,6,0,6,華南永昌-民權,2024-09-27,9312
2415,錩新,6,0,6,華南永昌-民權,2024-09-27,9312
6202,盛群,7,1,6,華南永昌-民權,2024-09-27,9312
6215,和椿,8,2,6,華南永昌-民權,2024-09-27,9312
3019,亞光,8,3,5,華南永昌-民權,2024-09-27,9312
3293,鈊象,7,2,5,華南永昌-民權,2024-09-27,9312
00891,中信關鍵半導體,5,0,5,華南永昌-民權,2024-09-27,9312
1522,堤維西,5,0,5,華南永昌-民權,2024-09-27,9312
6104,創惟,6,1,5,華南永昌-民權,2024-09-27,9312
6207,雷科,5,0,5,華南永昌-民權,2024-09-27,9312
006208,富邦台50,4,0,4,華南永昌-民權,2024-09-27,9312
00679B,元大美債20年,22,18,4,華南永昌-民權,2024-09-27,9312
00795B,中信美國公債20年,5,1,4,華南永昌-民權,2024-09-27,9312
00959B,大華投等美債15Y+,4,0,4,華南永昌-民權,2024-09-27,9312
1711,永光,6,2,4,華南永昌-民權,2024-09-27,9312
2340,台亞,11,7,4,華南永昌-民權,2024-09-27,9312
2488,漢平,4,0,4,華南永昌-民權,2024-09-27,9312
00929,復華台灣科技優息,107,4,103,華南永昌-民權,2024-09-30,9312
00919,群益台灣精選高息,94,0,94,華南永昌-民權,2024-09-30,9312
00687B,國泰20年美債,82,0,82,華南永昌-民權,2024-09-30,9312
00665L,富邦�琤肭磪囓�2,55,2,53,華南永昌-民權,2024-09-30,9312
1410,南染,50,0,50,華南永昌-民權,2024-09-30,9312
3715,定穎投控,52,3,49,華南永昌-民權,2024-09-30,9312
00948B,中信優息投資級債,33,0,33,華南永昌-民權,2024-09-30,9312
00927,群益半導體收益,31,0,31,華南永昌-民權,2024-09-30,9312
00952,凱基台灣AI50,30,0,30,華南永昌-民權,2024-09-30,9312
1721,三晃,37,8,29,華南永昌-民權,2024-09-30,9312
00918,大華優利高填息30,31,3,28,華南永昌-民權,2024-09-30,9312
2609,陽明,45,17,28,華南永昌-民權,2024-09-30,9312
00940,元大台灣價值高息,25,1,24,華南永昌-民權,2024-09-30,9312
2312,金寶,26,3,23,華南永昌-民權,2024-09-30,9312
1609,大亞,27,5,22,華南永昌-民權,2024-09-30,9312
2101,南港,140,120,20,華南永昌-民權,2024-09-30,9312
1319,東陽,20,1,19,華南永昌-民權,2024-09-30,9312
00637L,元大滬深300正2,44,26,18,華南永昌-民權,2024-09-30,9312
1326,台化,18,3,15,華南永昌-民權,2024-09-30,9312
9927,泰銘,13,0,13,華南永昌-民權,2024-09-30,9312
2615,萬海,15,3,12,華南永昌-民權,2024-09-30,9312
2382,廣達,11,0,11,華南永昌-民權,2024-09-30,9312
00922,國泰台灣領袖50,10,0,10,華南永昌-民權,2024-09-30,9312
00655L,國泰中國A50正2,10,0,10,華南永昌-民權,2024-09-30,9312
00639,富邦深100,10,0,10,華南永昌-民權,2024-09-30,9312
00945B,凱基美國非投等債,10,0,10,華南永昌-民權,2024-09-30,9312
2497,怡利電,14,4,10,華南永昌-民權,2024-09-30,9312
3673,TPK-KY,10,0,10,華南永昌-民權,2024-09-30,9312
2330,台積電,10,1,9,華南永昌-民權,2024-09-30,9312
1809,中釉,16,7,9,華南永昌-民權,2024-09-30,9312
00915,凱基優選高股息30,11,3,8,華南永昌-民權,2024-09-30,9312
0056,元大高股息,8,0,8,華南永昌-民權,2024-09-30,9312
1436,華友聯,8,0,8,華南永昌-民權,2024-09-30,9312
4979,華星光,12,4,8,華南永昌-民權,2024-09-30,9312
5014,建錩,10,2,8,華南永昌-民權,2024-09-30,9312
2356,英業達,20,13,7,華南永昌-民權,2024-09-30,9312
3665,貿聯-KY,10,3,7,華南永昌-民權,2024-09-30,9312
2421,建準,8,2,6,華南永昌-民權,2024-09-30,9312
1717,長興,6,0,6,華南永昌-民權,2024-09-30,9312
1808,潤隆,6,0,6,華南永昌-民權,2024-09-30,9312
8028,昇陽半導體,6,0,6,華南永昌-民權,2024-09-30,9312
8374,羅昇,6,0,6,華南永昌-民權,2024-09-30,9312
0050,元大台灣50,6,0,6,華南永昌-民權,2024-09-30,9312
2014,中鴻,44,39,5,華南永昌-民權,2024-09-30,9312
6869,雲豹能源,17,12,5,華南永昌-民權,2024-09-30,9312
3017,奇鋐,5,0,5,華南永昌-民權,2024-09-30,9312
00675L,富邦臺灣加權正2,5,0,5,華南永昌-民權,2024-09-30,9312
00752,中信中國50,10,5,5,華南永昌-民權,2024-09-30,9312
1309,台達化,5,0,5,華南永昌-民權,2024-09-30,9312
1504,東元,5,0,5,華南永昌-民權,2024-09-30,9312
0056,元大高股息,262,0,262,華南永昌-民權,2024-10-01,9312
00664R,國泰臺灣加權反1,100,0,100,華南永昌-民權,2024-10-01,9312
5443,均豪,88,0,88,華南永昌-民權,2024-10-01,9312
2884,玉山金,55,1,54,華南永昌-民權,2024-10-01,9312
00929,復華台灣科技優息,34,0,34,華南永昌-民權,2024-10-01,9312
3149,正達,91,62,29,華南永昌-民權,2024-10-01,9312
2881,富邦金,25,0,25,華南永昌-民權,2024-10-01,9312
00887,永豐中國科技50大,20,0,20,華南永昌-民權,2024-10-01,9312
00960,野村全球航運龍頭,20,0,20,華南永昌-民權,2024-10-01,9312
8437,大地-KY,20,0,20,華南永昌-民權,2024-10-01,9312
2014,中鴻,22,3,19,華南永昌-民權,2024-10-01,9312
6177,達麗,19,1,18,華南永昌-民權,2024-10-01,9312
00753L,中信中國50正2,16,0,16,華南永昌-民權,2024-10-01,9312
2497,怡利電,11,0,11,華南永昌-民權,2024-10-01,9312
3354,律勝,11,0,11,華南永昌-民權,2024-10-01,9312
4306,炎洲,11,0,11,華南永昌-民權,2024-10-01,9312
00752,中信中國50,10,0,10,華南永昌-民權,2024-10-01,9312
00639,富邦深100,10,0,10,華南永昌-民權,2024-10-01,9312
1410,南染,10,0,10,華南永昌-民權,2024-10-01,9312
2888,新光金,10,0,10,華南永昌-民權,2024-10-01,9312
2903,遠百,10,0,10,華南永昌-民權,2024-10-01,9312
3652,精聯,10,0,10,華南永昌-民權,2024-10-01,9312
6152,百一,10,0,10,華南永昌-民權,2024-10-01,9312
6138,茂達,10,1,9,華南永昌-民權,2024-10-01,9312
3576,聯合再生,10,1,9,華南永昌-民權,2024-10-01,9312
3481,群創,9,1,8,華南永昌-民權,2024-10-01,9312
00713,元大台灣高息低波,8,0,8,華南永昌-民權,2024-10-01,9312
00915,凱基優選高股息30,10,3,7,華南永昌-民權,2024-10-01,9312
00679B,元大美債20年,7,0,7,華南永昌-民權,2024-10-01,9312
4967,十銓,7,0,7,華南永昌-民權,2024-10-01,9312
00687B,國泰20年美債,20,13,7,華南永昌-民權,2024-10-01,9312
00878,國泰永續高股息,9,3,6,華南永昌-民權,2024-10-01,9312
1711,永光,6,0,6,華南永昌-民權,2024-10-01,9312
3033,威健,6,0,6,華南永昌-民權,2024-10-01,9312
00927,群益半導體收益,5,0,5,華南永昌-民權,2024-10-01,9312
1736,喬山,5,0,5,華南永昌-民權,2024-10-01,9312
2109,華豐,5,0,5,華南永昌-民權,2024-10-01,9312
2247,汎德永業,5,0,5,華南永昌-民權,2024-10-01,9312
2887,台新金,5,0,5,華南永昌-民權,2024-10-01,9312
6179,亞通,8,3,5,華南永昌-民權,2024-10-01,9312
6530,創威,53,48,5,華南永昌-民權,2024-10-01,9312
8027,鈦昇,6,1,5,華南永昌-民權,2024-10-01,9312
8097,常珵,5,0,5,華南永昌-民權,2024-10-01,9312
2399,映泰,70,65,5,華南永昌-民權,2024-10-01,9312
00919,群益台灣精選高息,18,13,5,華南永昌-民權,2024-10-01,9312
2317,鴻海,6,2,4,華南永昌-民權,2024-10-01,9312
1101,台泥,5,1,4,華南永昌-民權,2024-10-01,9312
00918,大華優利高填息30,3,0,3,華南永昌-民權,2024-10-01,9312
00637L,元大滬深300正2,3,0,3,華南永昌-民權,2024-10-01,9312
2316,楠梓電,3,0,3,華南永昌-民權,2024-10-01,9312
00919,群益台灣精選高息,177,0,177,華南永昌-民權,2024-10-04,9312
5014,建錩,109,31,78,華南永昌-民權,2024-10-04,9312
2609,陽明,67,12,55,華南永昌-民權,2024-10-04,9312
0056,元大高股息,39,0,39,華南永昌-民權,2024-10-04,9312
2610,華航,35,1,34,華南永昌-民權,2024-10-04,9312
2425,承啟,44,10,34,華南永昌-民權,2024-10-04,9312
5443,均豪,36,2,34,華南永昌-民權,2024-10-04,9312
00878,國泰永續高股息,42,11,31,華南永昌-民權,2024-10-04,9312
00639,富邦深100,31,1,30,華南永昌-民權,2024-10-04,9312
2367,燿華,28,0,28,華南永昌-民權,2024-10-04,9312
00929,復華台灣科技優息,38,11,27,華南永昌-民權,2024-10-04,9312
6706,惠特,27,0,27,華南永昌-民權,2024-10-04,9312
1609,大亞,33,7,26,華南永昌-民權,2024-10-04,9312
2897,王道銀行,50,25,25,華南永昌-民權,2024-10-04,9312
2303,聯電,23,0,23,華南永昌-民權,2024-10-04,9312
00940,元大台灣價值高息,25,2,23,華南永昌-民權,2024-10-04,9312
2353,宏��,24,1,23,華南永昌-民權,2024-10-04,9312
2904,匯僑,21,0,21,華南永昌-民權,2024-10-04,9312
3652,精聯,20,0,20,華南永昌-民權,2024-10-04,9312
2615,萬海,19,1,18,華南永昌-民權,2024-10-04,9312
1799,易威,19,2,17,華南永昌-民權,2024-10-04,9312
2454,聯發科,25,10,15,華南永昌-民權,2024-10-04,9312
2014,中鴻,14,1,13,華南永昌-民權,2024-10-04,9312
00725B,國泰投資級公司債,22,10,12,華南永昌-民權,2024-10-04,9312
00679B,元大美債20年,12,0,12,華南永昌-民權,2024-10-04,9312
00885,富邦越南,11,0,11,華南永昌-民權,2024-10-04,9312
00680L,元大美債20正2,11,0,11,華南永昌-民權,2024-10-04,9312
4904,遠傳,10,0,10,華南永昌-民權,2024-10-04,9312
2884,玉山金,12,2,10,華南永昌-民權,2024-10-04,9312
00943,兆豐電子高息等權,10,0,10,華南永昌-民權,2024-10-04,9312
2543,皇昌,10,0,10,華南永昌-民權,2024-10-04,9312
2618,長榮航,10,1,9,華南永昌-民權,2024-10-04,9312
00687B,國泰20年美債,8,0,8,華南永昌-民權,2024-10-04,9312
4979,華星光,15,7,8,華南永昌-民權,2024-10-04,9312
2603,長榮,9,1,8,華南永昌-民權,2024-10-04,9312
2867,三商壽,7,0,7,華南永昌-民權,2024-10-04,9312
00700,富邦�琤肭磪�,6,0,6,華南永昌-民權,2024-10-04,9312
3062,建漢,24,18,6,華南永昌-民權,2024-10-04,9312
3231,緯創,8,2,6,華南永昌-民權,2024-10-04,9312
00937B,群益ESG投等債20,16,10,6,華南永昌-民權,2024-10-04,9312
1595,川寶,28,23,5,華南永昌-民權,2024-10-04,9312
00949,復華日本龍頭,5,0,5,華南永昌-民權,2024-10-04,9312
2247,汎德永業,5,0,5,華南永昌-民權,2024-10-04,9312
2337,旺宏,6,1,5,華南永昌-民權,2024-10-04,9312
2891,中信金,5,0,5,華南永昌-民權,2024-10-04,9312
2903,遠百,5,0,5,華南永昌-民權,2024-10-04,9312
3149,正達,10,5,5,華南永昌-民權,2024-10-04,9312
3597,映興,5,0,5,華南永昌-民權,2024-10-04,9312
4534,慶騰,5,0,5,華南永昌-民權,2024-10-04,9312
4903,聯光通,13,8,5,華南永昌-民權,2024-10-04,9312
00882,中信中國高股息,580,75,505,華南永昌-民權,2024-10-07,9312
0056,元大高股息,158,0,158,華南永昌-民權,2024-10-07,9312
00680L,元大美債20正2,157,0,157,華南永昌-民權,2024-10-07,9312
3715,定穎投控,168,47,121,華南永昌-民權,2024-10-07,9312
00664R,國泰臺灣加權反1,100,0,100,華南永昌-民權,2024-10-07,9312
00933B,國泰10Y+金融債,95,0,95,華南永昌-民權,2024-10-07,9312
00919,群益台灣精選高息,79,0,79,華南永昌-民權,2024-10-07,9312
1714,和桐,28,0,28,華南永昌-民權,2024-10-07,9312
00688L,國泰20年美債正2,27,0,27,華南永昌-民權,2024-10-07,9312
2929,淘帝-KY,29,2,27,華南永昌-民權,2024-10-07,9312
00665L,富邦�琤肭磪囓�2,20,0,20,華南永昌-民權,2024-10-07,9312
8111,立��,69,50,19,華南永昌-民權,2024-10-07,9312
00753L,中信中國50正2,33,21,12,華南永昌-民權,2024-10-07,9312
5014,建錩,14,2,12,華南永昌-民權,2024-10-07,9312
00918,大華優利高填息30,10,0,10,華南永昌-民權,2024-10-07,9312
00655L,國泰中國A50正2,10,0,10,華南永昌-民權,2024-10-07,9312
00632R,元大台灣50反1,10,0,10,華南永昌-民權,2024-10-07,9312
006206,元大上證50,10,0,10,華南永昌-民權,2024-10-07,9312
2634,漢翔,10,0,10,華南永昌-民權,2024-10-07,9312
4523,永彰,10,0,10,華南永昌-民權,2024-10-07,9312
6546,正基,10,0,10,華南永昌-民權,2024-10-07,9312
00643,群益深証中小,10,0,10,華南永昌-民權,2024-10-07,9312
2303,聯電,14,4,10,華南永昌-民權,2024-10-07,9312
2520,冠德,9,0,9,華南永昌-民權,2024-10-07,9312
2356,英業達,12,4,8,華南永昌-民權,2024-10-07,9312
3049,精金,21,13,8,華南永昌-民權,2024-10-07,9312
1301,台塑,15,8,7,華南永昌-民權,2024-10-07,9312
00945B,凱基美國非投等債,7,0,7,華南永昌-民權,2024-10-07,9312
1711,永光,7,0,7,華南永昌-民權,2024-10-07,9312
2365,昆盈,7,0,7,華南永昌-民權,2024-10-07,9312
3430,奇鈦科,7,0,7,華南永昌-民權,2024-10-07,9312
5531,鄉林,7,0,7,華南永昌-民權,2024-10-07,9312
8473,山林水,7,0,7,華南永昌-民權,2024-10-07,9312
2886,兆豐金,7,0,7,華南永昌-民權,2024-10-07,9312
0061,元大寶滬深,6,0,6,華南永昌-民權,2024-10-07,9312
00922,國泰台灣領袖50,6,0,6,華南永昌-民權,2024-10-07,9312
2344,華邦電,7,1,6,華南永昌-民權,2024-10-07,9312
2609,陽明,32,26,6,華南永昌-民權,2024-10-07,9312
3466,德晉,6,0,6,華南永昌-民權,2024-10-07,9312
3588,通嘉,6,0,6,華南永昌-民權,2024-10-07,9312
6126,信音,16,10,6,華南永昌-民權,2024-10-07,9312
2399,映泰,7,1,6,華南永昌-民權,2024-10-07,9312
00687B,國泰20年美債,73,68,5,華南永昌-民權,2024-10-07,9312
2353,宏��,5,0,5,華南永昌-民權,2024-10-07,9312
00891,中信關鍵半導體,5,0,5,華南永昌-民權,2024-10-07,9312
00907,永豐優息存股,5,0,5,華南永昌-民權,2024-10-07,9312
00951,台新日本半導體,5,0,5,華南永昌-民權,2024-10-07,9312
2317,鴻海,23,19,4,華南永昌-民權,2024-10-07,9312
00902,中信電池及儲能,5,1,4,華南永昌-民權,2024-10-07,9312
2436,偉詮電,4,0,4,華南永昌-民權,2024-10-07,9312
00937B,群益ESG投等債20,76,0,76,華南永昌-民權,2024-10-08,9312
00687B,國泰20年美債,81,11,70,華南永昌-民權,2024-10-08,9312
00948B,中信優息投資級債,52,0,52,華南永昌-民權,2024-10-08,9312
00919,群益台灣精選高息,51,0,51,華南永昌-民權,2024-10-08,9312
2102,泰豐,50,0,50,華南永昌-民權,2024-10-08,9312
6133,金橋,50,0,50,華南永昌-民權,2024-10-08,9312
00679B,元大美債20年,55,6,49,華南永昌-民權,2024-10-08,9312
0056,元大高股息,49,0,49,華南永昌-民權,2024-10-08,9312
00680L,元大美債20正2,43,0,43,華南永昌-民權,2024-10-08,9312
00940,元大台灣價值高息,41,0,41,華南永昌-民權,2024-10-08,9312
2888,新光金,40,0,40,華南永昌-民權,2024-10-08,9312
2903,遠百,30,0,30,華南永昌-民權,2024-10-08,9312
1410,南染,25,0,25,華南永昌-民權,2024-10-08,9312
00929,復華台灣科技優息,28,4,24,華南永昌-民權,2024-10-08,9312
2399,映泰,45,24,21,華南永昌-民權,2024-10-08,9312
6405,悅城,22,1,21,華南永昌-民權,2024-10-08,9312
00933B,國泰10Y+金融債,20,0,20,華南永昌-民權,2024-10-08,9312
3049,精金,26,6,20,華南永昌-民權,2024-10-08,9312
2489,瑞軒,19,1,18,華南永昌-民權,2024-10-08,9312
00637L,元大滬深300正2,25,7,18,華南永昌-民權,2024-10-08,9312
1464,得力,18,0,18,華南永昌-民權,2024-10-08,9312
2891,中信金,25,7,18,華南永昌-民權,2024-10-08,9312
00713,元大台灣高息低波,17,0,17,華南永昌-民權,2024-10-08,9312
2454,聯發科,15,0,15,華南永昌-民權,2024-10-08,9312
1419,新紡,15,0,15,華南永昌-民權,2024-10-08,9312
2601,益航,27,12,15,華南永昌-民權,2024-10-08,9312
3652,精聯,14,0,14,華南永昌-民權,2024-10-08,9312
8039,台虹,26,12,14,華南永昌-民權,2024-10-08,9312
00878,國泰永續高股息,12,0,12,華南永昌-民權,2024-10-08,9312
3037,欣興,13,1,12,華南永昌-民權,2024-10-08,9312
1809,中釉,20,8,12,華南永昌-民權,2024-10-08,9312
2609,陽明,14,2,12,華南永昌-民權,2024-10-08,9312
00688L,國泰20年美債正2,11,0,11,華南永昌-民權,2024-10-08,9312
2023,燁輝,11,0,11,華南永昌-民權,2024-10-08,9312
2349,錸德,11,0,11,華南永昌-民權,2024-10-08,9312
2634,漢翔,11,0,11,華南永昌-民權,2024-10-08,9312
4542,科嶠,11,0,11,華南永昌-民權,2024-10-08,9312
00673R,期元大S＆P原油反1,10,0,10,華南永昌-民權,2024-10-08,9312
00943,兆豐電子高息等權,10,0,10,華南永昌-民權,2024-10-08,9312
1773,勝一,10,0,10,華南永昌-民權,2024-10-08,9312
2734,易飛網,10,0,10,華南永昌-民權,2024-10-08,9312
3264,欣銓,10,0,10,華南永昌-民權,2024-10-08,9312
3481,群創,10,0,10,華南永昌-民權,2024-10-08,9312
4306,炎洲,10,0,10,華南永昌-民權,2024-10-08,9312
6269,台郡,10,0,10,華南永昌-民權,2024-10-08,9312
8064,東捷,10,0,10,華南永昌-民權,2024-10-08,9312
1909,榮成,9,0,9,華南永昌-民權,2024-10-08,9312
00915,凱基優選高股息30,10,1,9,華南永昌-民權,2024-10-08,9312
2605,新興,12,4,8,華南永昌-民權,2024-10-08,9312
2754,亞洲藏壽司,8,0,8,華南永昌-民權,2024-10-08,9312
00919,群益台灣精選高息,128,1,127,華南永昌-民權,2024-10-09,9312
00937B,群益ESG投等債20,72,0,72,華南永昌-民權,2024-10-09,9312
00665L,富邦�琤肭磪囓�2,57,0,57,華南永昌-民權,2024-10-09,9312
00632R,元大台灣50反1,50,0,50,華南永昌-民權,2024-10-09,9312
2034,允強,50,0,50,華南永昌-民權,2024-10-09,9312
8240,華宏,50,5,45,華南永昌-民權,2024-10-09,9312
2845,遠東銀,42,0,42,華南永昌-民權,2024-10-09,9312
00715L,期街口布蘭特正2,36,0,36,華南永昌-民權,2024-10-09,9312
00687B,國泰20年美債,34,4,30,華南永昌-民權,2024-10-09,9312
00943,兆豐電子高息等權,30,0,30,華南永昌-民權,2024-10-09,9312
3652,精聯,30,0,30,華南永昌-民權,2024-10-09,9312
6108,競國,50,20,30,華南永昌-民權,2024-10-09,9312
2601,益航,24,0,24,華南永昌-民權,2024-10-09,9312
1314,中石化,74,50,24,華南永昌-民權,2024-10-09,9312
2888,新光金,41,19,22,華南永昌-民權,2024-10-09,9312
3715,定穎投控,49,27,22,華南永昌-民權,2024-10-09,9312
0056,元大高股息,20,0,20,華南永昌-民權,2024-10-09,9312
3265,台星科,20,0,20,華南永昌-民權,2024-10-09,9312
3615,安可,36,16,20,華南永昌-民權,2024-10-09,9312
00933B,國泰10Y+金融債,22,3,19,華南永昌-民權,2024-10-09,9312
1524,耿鼎,18,0,18,華南永昌-民權,2024-10-09,9312
2399,映泰,110,95,15,華南永昌-民權,2024-10-09,9312
00753L,中信中國50正2,24,10,14,華南永昌-民權,2024-10-09,9312
5531,鄉林,14,0,14,華南永昌-民權,2024-10-09,9312
5014,建錩,13,0,13,華南永昌-民權,2024-10-09,9312
00669R,國泰美國道瓊反1,12,0,12,華南永昌-民權,2024-10-09,9312
3711,日月光投控,12,0,12,華南永昌-民權,2024-10-09,9312
8039,台虹,17,5,12,華南永昌-民權,2024-10-09,9312
1109,信大,23,12,11,華南永昌-民權,2024-10-09,9312
1727,中華化,11,0,11,華南永昌-民權,2024-10-09,9312
3708,上緯投控,11,0,11,華南永昌-民權,2024-10-09,9312
2363,矽統,23,12,11,華南永昌-民權,2024-10-09,9312
1409,新纖,10,0,10,華南永昌-民權,2024-10-09,9312
1609,大亞,10,0,10,華南永昌-民權,2024-10-09,9312
2882,國泰金,10,0,10,華南永昌-民權,2024-10-09,9312
4563,百德,10,0,10,華南永昌-民權,2024-10-09,9312
6542,隆中,10,0,10,華南永昌-民權,2024-10-09,9312
3209,全科,9,1,8,華南永昌-民權,2024-10-09,9312
5871,中租-KY,8,1,7,華南永昌-民權,2024-10-09,9312
00680L,元大美債20正2,7,0,7,華南永昌-民權,2024-10-09,9312
00720B,元大投資級公司債,8,1,7,華南永昌-民權,2024-10-09,9312
2108,南帝,7,0,7,華南永昌-民權,2024-10-09,9312
2427,三商電,7,0,7,華南永昌-民權,2024-10-09,9312
2498,宏達電,7,0,7,華南永昌-民權,2024-10-09,9312
3048,益登,7,0,7,華南永昌-民權,2024-10-09,9312
6152,百一,7,0,7,華南永昌-民權,2024-10-09,9312
1909,榮成,7,1,6,華南永昌-民權,2024-10-09,9312
00643,群益深証中小,11,5,6,華南永昌-民權,2024-10-09,9312
00930,永豐ESG低碳高息,6,0,6,華南永昌-民權,2024-10-09,9312
1815,富喬,7,1,6,華南永昌-民權,2024-10-09,9312
00680L,元大美債20正2,127,0,127,華南永昌-民權,2024-10-11,9312
00918,大華優利高填息30,116,1,115,華南永昌-民權,2024-10-11,9312
00933B,國泰10Y+金融債,102,0,102,華南永昌-民權,2024-10-11,9312
2412,中華電,69,0,69,華南永昌-民權,2024-10-11,9312
2101,南港,59,9,50,華南永昌-民權,2024-10-11,9312
6187,萬潤,51,1,50,華南永昌-民權,2024-10-11,9312
6177,達麗,20,0,20,華南永昌-民權,2024-10-11,9312
00656R,國泰中國A50反1,20,0,20,華南永昌-民權,2024-10-11,9312
4977,眾達-KY,23,3,20,華南永昌-民權,2024-10-11,9312
00632R,元大台灣50反1,15,0,15,華南永昌-民權,2024-10-11,9312
6127,九豪,15,0,15,華南永昌-民權,2024-10-11,9312
8437,大地-KY,15,0,15,華南永昌-民權,2024-10-11,9312
3033,威健,23,9,14,華南永昌-民權,2024-10-11,9312
3652,精聯,14,0,14,華南永昌-民權,2024-10-11,9312
00637L,元大滬深300正2,13,0,13,華南永昌-民權,2024-10-11,9312
00679B,元大美債20年,13,0,13,華南永昌-民權,2024-10-11,9312
1815,富喬,13,0,13,華南永昌-民權,2024-10-11,9312
1584,精剛,15,3,12,華南永昌-民權,2024-10-11,9312
2109,華豐,12,0,12,華南永昌-民權,2024-10-11,9312
00688L,國泰20年美債正2,11,0,11,華南永昌-民權,2024-10-11,9312
3149,正達,88,77,11,華南永昌-民權,2024-10-11,9312
4967,十銓,13,2,11,華南永昌-民權,2024-10-11,9312
8358,金居,11,0,11,華南永昌-民權,2024-10-11,9312
2477,美隆電,10,0,10,華南永昌-民權,2024-10-11,9312
3615,安可,11,1,10,華南永昌-民權,2024-10-11,9312
6126,信音,12,2,10,華南永昌-民權,2024-10-11,9312
1314,中石化,14,5,9,華南永昌-民權,2024-10-11,9312
00937B,群益ESG投等債20,10,2,8,華南永昌-民權,2024-10-11,9312
3013,晟銘電,17,9,8,華南永昌-民權,2024-10-11,9312
8089,康全電訊,20,12,8,華南永昌-民權,2024-10-11,9312
3303,岱稜,7,0,7,華南永昌-民權,2024-10-11,9312
3231,緯創,10,3,7,華南永昌-民權,2024-10-11,9312
2812,台中銀,7,1,6,華南永昌-民權,2024-10-11,9312
6246,臺龍,18,12,6,華南永昌-民權,2024-10-11,9312
5443,均豪,6,1,5,華南永昌-民權,2024-10-11,9312
00795B,中信美國公債20年,5,0,5,華南永昌-民權,2024-10-11,9312
1808,潤隆,5,0,5,華南永昌-民權,2024-10-11,9312
2439,美律,6,1,5,華南永昌-民權,2024-10-11,9312
00643,群益深証中小,5,0,5,華南永昌-民權,2024-10-11,9312
1473,台南,5,0,5,華南永昌-民權,2024-10-11,9312
2489,瑞軒,5,0,5,華南永昌-民權,2024-10-11,9312
4113,聯上,5,0,5,華南永昌-民權,2024-10-11,9312
4905,台聯電,5,0,5,華南永昌-民權,2024-10-11,9312
6770,力積電,5,0,5,華南永昌-民權,2024-10-11,9312
6834,天二科技,5,0,5,華南永昌-民權,2024-10-11,9312
8033,雷虎,6,1,5,華南永昌-民權,2024-10-11,9312
8111,立��,62,57,5,華南永昌-民權,2024-10-11,9312
911868,同方友友-DR,5,0,5,華南永昌-民權,2024-10-11,9312
00753L,中信中國50正2,4,0,4,華南永昌-民權,2024-10-11,9312
1533,車王電,4,0,4,華南永昌-民權,2024-10-11,9312
00937B,群益ESG投等債20,138,7,131,華南永昌-民權,2024-10-14,9312
6187,萬潤,52,2,50,華南永昌-民權,2024-10-14,9312
00887,永豐中國科技50大,43,0,43,華南永昌-民權,2024-10-14,9312
2883,凱基金,40,1,39,華南永昌-民權,2024-10-14,9312
6142,友勁,36,0,36,華南永昌-民權,2024-10-14,9312
1464,得力,30,0,30,華南永昌-民權,2024-10-14,9312
00940,元大台灣價值高息,30,2,28,華南永昌-民權,2024-10-14,9312
1410,南染,25,0,25,華南永昌-民權,2024-10-14,9312
5340,建榮,25,0,25,華南永昌-民權,2024-10-14,9312
2241,艾姆勒,22,0,22,華南永昌-民權,2024-10-14,9312
6133,金橋,21,0,21,華南永昌-民權,2024-10-14,9312
00633L,富邦上証正2,20,0,20,華南永昌-民權,2024-10-14,9312
3213,茂訊,20,0,20,華南永昌-民權,2024-10-14,9312
6156,松上,21,1,20,華南永昌-民權,2024-10-14,9312
6202,盛群,20,1,19,華南永昌-民權,2024-10-14,9312
3062,建漢,19,3,16,華南永昌-民權,2024-10-14,9312
00687B,國泰20年美債,15,0,15,華南永昌-民權,2024-10-14,9312
4977,眾達-KY,39,25,14,華南永昌-民權,2024-10-14,9312
00948B,中信優息投資級債,12,0,12,華南永昌-民權,2024-10-14,9312
2888A,新光金甲特,12,0,12,華南永昌-民權,2024-10-14,9312
0056,元大高股息,13,2,11,華南永昌-民權,2024-10-14,9312
00680L,元大美債20正2,10,0,10,華南永昌-民權,2024-10-14,9312
2312,金寶,11,1,10,華南永昌-民權,2024-10-14,9312
2618,長榮航,10,0,10,華南永昌-民權,2024-10-14,9312
3066,李洲,10,0,10,華南永昌-民權,2024-10-14,9312
3354,律勝,10,0,10,華南永昌-民權,2024-10-14,9312
6126,信音,10,0,10,華南永昌-民權,2024-10-14,9312
6706,惠特,10,0,10,華南永昌-民權,2024-10-14,9312
3013,晟銘電,16,7,9,華南永昌-民權,2024-10-14,9312
00637L,元大滬深300正2,15,6,9,華南永昌-民權,2024-10-14,9312
00929,復華台灣科技優息,14,5,9,華南永昌-民權,2024-10-14,9312
2887,台新金,12,4,8,華南永昌-民權,2024-10-14,9312
00905,FT臺灣Smart,8,0,8,華南永昌-民權,2024-10-14,9312
2615,萬海,9,2,7,華南永昌-民權,2024-10-14,9312
00877,復華中國5G,7,0,7,華南永昌-民權,2024-10-14,9312
2002,中鋼,6,0,6,華南永昌-民權,2024-10-14,9312
1316,上曜,6,0,6,華南永昌-民權,2024-10-14,9312
2467,志聖,9,3,6,華南永昌-民權,2024-10-14,9312
00922,國泰台灣領袖50,5,0,5,華南永昌-民權,2024-10-14,9312
00688L,國泰20年美債正2,5,0,5,華南永昌-民權,2024-10-14,9312
00740B,富邦全球投等債,5,0,5,華南永昌-民權,2024-10-14,9312
1525,江申,5,0,5,華南永昌-民權,2024-10-14,9312
2349,錸德,5,0,5,華南永昌-民權,2024-10-14,9312
2464,盟立,5,0,5,華南永昌-民權,2024-10-14,9312
2867,三商壽,5,0,5,華南永昌-民權,2024-10-14,9312
3019,亞光,15,10,5,華南永昌-民權,2024-10-14,9312
4113,聯上,5,0,5,華南永昌-民權,2024-10-14,9312
4510,高鋒,8,3,5,華南永昌-民權,2024-10-14,9312
4534,慶騰,5,0,5,華南永昌-民權,2024-10-14,9312
6790,永豐實,5,0,5,華南永昌-民權,2024-10-14,9312
2449,京元電子,115,17,98,華南永昌-民權,2024-10-15,9312
00687B,國泰20年美債,88,3,85,華南永昌-民權,2024-10-15,9312
00753L,中信中國50正2,65,0,65,華南永昌-民權,2024-10-15,9312
00919,群益台灣精選高息,54,1,53,華南永昌-民權,2024-10-15,9312
00933B,國泰10Y+金融債,52,3,49,華南永昌-民權,2024-10-15,9312
00679B,元大美債20年,78,30,48,華南永昌-民權,2024-10-15,9312
00918,大華優利高填息30,40,0,40,華南永昌-民權,2024-10-15,9312
2888,新光金,26,1,25,華南永昌-民權,2024-10-15,9312
1609,大亞,24,3,21,華南永昌-民權,2024-10-15,9312
3211,順達,21,0,21,華南永昌-民權,2024-10-15,9312
2363,矽統,39,19,20,華南永昌-民權,2024-10-15,9312
00951,台新日本半導體,20,0,20,華南永昌-民權,2024-10-15,9312
6125,廣運,23,4,19,華南永昌-民權,2024-10-15,9312
1711,永光,17,0,17,華南永昌-民權,2024-10-15,9312
4967,十銓,17,1,16,華南永昌-民權,2024-10-15,9312
00650L,復華香港正2,14,0,14,華南永昌-民權,2024-10-15,9312
8028,昇陽半導體,26,13,13,華南永昌-民權,2024-10-15,9312
2399,映泰,20,7,13,華南永昌-民權,2024-10-15,9312
00725B,國泰投資級公司債,16,4,12,華南永昌-民權,2024-10-15,9312
3581,博磊,12,0,12,華南永昌-民權,2024-10-15,9312
00637L,元大滬深300正2,11,0,11,華南永昌-民權,2024-10-15,9312
00857B,永豐20年美公債,10,0,10,華南永昌-民權,2024-10-15,9312
1410,南染,10,0,10,華南永昌-民權,2024-10-15,9312
6742,澤米,10,0,10,華南永昌-民權,2024-10-15,9312
1815,富喬,9,0,9,華南永昌-民權,2024-10-15,9312
2353,宏��,11,2,9,華南永昌-民權,2024-10-15,9312
2882,國泰金,9,0,9,華南永昌-民權,2024-10-15,9312
3652,精聯,9,0,9,華南永昌-民權,2024-10-15,9312
2887,台新金,10,1,9,華南永昌-民權,2024-10-15,9312
00891,中信關鍵半導體,10,2,8,華南永昌-民權,2024-10-15,9312
00937B,群益ESG投等債20,8,1,7,華南永昌-民權,2024-10-15,9312
3325,旭品,8,1,7,華南永昌-民權,2024-10-15,9312
2455,全新,8,2,6,華南永昌-民權,2024-10-15,9312
2601,益航,6,0,6,華南永昌-民權,2024-10-15,9312
3664,安瑞-KY,6,0,6,華南永昌-民權,2024-10-15,9312
8076,伍豐,6,0,6,華南永昌-民權,2024-10-15,9312
6187,萬潤,60,54,6,華南永昌-民權,2024-10-15,9312
00680L,元大美債20正2,5,0,5,華南永昌-民權,2024-10-15,9312
00633L,富邦上証正2,12,7,5,華南永昌-民權,2024-10-15,9312
3209,全科,5,0,5,華南永昌-民權,2024-10-15,9312
4563,百德,5,0,5,華南永昌-民權,2024-10-15,9312
6692,進能服,5,0,5,華南永昌-民權,2024-10-15,9312
6770,力積電,5,0,5,華南永昌-民權,2024-10-15,9312
3149,正達,38,33,5,華南永昌-民權,2024-10-15,9312
5347,世界,5,0,5,華南永昌-民權,2024-10-15,9312
006208,富邦台50,4,0,4,華南永昌-民權,2024-10-15,9312
2421,建準,5,1,4,華南永昌-民權,2024-10-15,9312
00922,國泰台灣領袖50,5,1,4,華南永昌-民權,2024-10-15,9312
1294,漢田生技,4,0,4,華南永昌-民權,2024-10-15,9312
2929,淘帝-KY,4,0,4,華南永昌-民權,2024-10-15,9312
00937B,群益ESG投等債20,102,1,101,華南永昌-民權,2024-10-16,9312
2344,華邦電,65,0,65,華南永昌-民權,2024-10-16,9312
2002,中鋼,64,0,64,華南永昌-民權,2024-10-16,9312
00887,永豐中國科技50大,53,0,53,華南永昌-民權,2024-10-16,9312
3706,神達,51,0,51,華南永昌-民權,2024-10-16,9312
00665L,富邦�琤肭磪囓�2,50,0,50,華南永昌-民權,2024-10-16,9312
00878,國泰永續高股息,38,2,36,華南永昌-民權,2024-10-16,9312
3213,茂訊,35,0,35,華南永昌-民權,2024-10-16,9312
2887,台新金,25,0,25,華南永昌-民權,2024-10-16,9312
1464,得力,30,7,23,華南永昌-民權,2024-10-16,9312
0056,元大高股息,24,1,23,華南永昌-民權,2024-10-16,9312
3715,定穎投控,23,4,19,華南永昌-民權,2024-10-16,9312
00922,國泰台灣領袖50,15,0,15,華南永昌-民權,2024-10-16,9312
1525,江申,15,0,15,華南永昌-民權,2024-10-16,9312
2888,新光金,15,0,15,華南永昌-民權,2024-10-16,9312
3031,佰鴻,15,0,15,華南永昌-民權,2024-10-16,9312
00687B,國泰20年美債,16,1,15,華南永昌-民權,2024-10-16,9312
00688L,國泰20年美債正2,12,0,12,華南永昌-民權,2024-10-16,9312
00912,中信臺灣智慧50,12,0,12,華南永昌-民權,2024-10-16,9312
1524,耿鼎,12,0,12,華南永昌-民權,2024-10-16,9312
2241,艾姆勒,11,0,11,華南永昌-民權,2024-10-16,9312
00918,大華優利高填息30,14,4,10,華南永昌-民權,2024-10-16,9312
00891,中信關鍵半導體,10,0,10,華南永昌-民權,2024-10-16,9312
00753L,中信中國50正2,17,7,10,華南永昌-民權,2024-10-16,9312
00943,兆豐電子高息等權,10,0,10,華南永昌-民權,2024-10-16,9312
2109,華豐,10,0,10,華南永昌-民權,2024-10-16,9312
2481,強茂,10,0,10,華南永昌-民權,2024-10-16,9312
3576,聯合再生,10,0,10,華南永昌-民權,2024-10-16,9312
6126,信音,10,0,10,華南永昌-民權,2024-10-16,9312
6220,岳豐,10,0,10,華南永昌-民權,2024-10-16,9312
6770,力積電,10,0,10,華南永昌-民權,2024-10-16,9312
1314,中石化,12,3,9,華南永昌-民權,2024-10-16,9312
00946,群益科技高息成長,8,0,8,華南永昌-民權,2024-10-16,9312
2615,萬海,8,0,8,華南永昌-民權,2024-10-16,9312
4979,華星光,8,0,8,華南永昌-民權,2024-10-16,9312
5871,中租-KY,8,0,8,華南永昌-民權,2024-10-16,9312
1773,勝一,7,0,7,華南永昌-民權,2024-10-16,9312
2867,三商壽,7,0,7,華南永昌-民權,2024-10-16,9312
6215,和椿,12,5,7,華南永昌-民權,2024-10-16,9312
8097,常珵,7,0,7,華南永昌-民權,2024-10-16,9312
1503,士電,6,0,6,華南永昌-民權,2024-10-16,9312
2890,永豐金,6,0,6,華南永昌-民權,2024-10-16,9312
00830,國泰費城半導體,6,1,5,華南永昌-民權,2024-10-16,9312
2542,興富發,5,0,5,華南永昌-民權,2024-10-16,9312
2929,淘帝-KY,5,0,5,華南永昌-民權,2024-10-16,9312
4113,聯上,5,0,5,華南永昌-民權,2024-10-16,9312
5014,建錩,10,5,5,華南永昌-民權,2024-10-16,9312
5328,華容,5,0,5,華南永昌-民權,2024-10-16,9312
6168,宏齊,6,1,5,華南永昌-民權,2024-10-16,9312
8163,達方,5,0,5,華南永昌-民權,2024-10-16,9312
6829,千附精密,71,0,71,華南永昌-民權,2024-10-17,9312
00887,永豐中國科技50大,67,2,65,華南永昌-民權,2024-10-17,9312
0056,元大高股息,42,1,41,華南永昌-民權,2024-10-17,9312
00753L,中信中國50正2,32,0,32,華南永昌-民權,2024-10-17,9312
1528,恩德,38,7,31,華南永昌-民權,2024-10-17,9312
8215,明基材,30,0,30,華南永昌-民權,2024-10-17,9312
3498,陽程,38,16,22,華南永昌-民權,2024-10-17,9312
1314,中石化,22,2,20,華南永昌-民權,2024-10-17,9312
00959B,大華投等美債15Y+,20,0,20,華南永昌-民權,2024-10-17,9312
00637L,元大滬深300正2,19,0,19,華南永昌-民權,2024-10-17,9312
2883,凱基金,25,7,18,華南永昌-民權,2024-10-17,9312
00922,國泰台灣領袖50,15,0,15,華南永昌-民權,2024-10-17,9312
8028,昇陽半導體,19,4,15,華南永昌-民權,2024-10-17,9312
2891,中信金,16,3,13,華南永昌-民權,2024-10-17,9312
2374,佳能,14,2,12,華南永昌-民權,2024-10-17,9312
6488,環球晶,11,0,11,華南永昌-民權,2024-10-17,9312
00891,中信關鍵半導體,10,0,10,華南永昌-民權,2024-10-17,9312
2431,聯昌,10,0,10,華南永昌-民權,2024-10-17,9312
2520,冠德,10,0,10,華南永昌-民權,2024-10-17,9312
2601,益航,10,0,10,華南永昌-民權,2024-10-17,9312
3213,茂訊,10,0,10,華南永昌-民權,2024-10-17,9312
3232,昱捷,10,0,10,華南永昌-民權,2024-10-17,9312
6517,保勝光學,10,0,10,華南永昌-民權,2024-10-17,9312
8050,廣積,10,0,10,華南永昌-民權,2024-10-17,9312
9945,潤泰新,10,0,10,華南永昌-民權,2024-10-17,9312
00730,富邦臺灣優質高息,9,0,9,華南永昌-民權,2024-10-17,9312
2543,皇昌,11,3,8,華南永昌-民權,2024-10-17,9312
2399,映泰,32,24,8,華南永昌-民權,2024-10-17,9312
2330,台積電,9,2,7,華南永昌-民權,2024-10-17,9312
2365,昆盈,13,6,7,華南永昌-民權,2024-10-17,9312
4927,泰鼎-KY,9,2,7,華南永昌-民權,2024-10-17,9312
4977,眾達-KY,9,2,7,華南永昌-民權,2024-10-17,9312
00725B,國泰投資級公司債,6,0,6,華南永昌-民權,2024-10-17,9312
2363,矽統,7,1,6,華南永昌-民權,2024-10-17,9312
2645,長榮航太,6,0,6,華南永昌-民權,2024-10-17,9312
6176,瑞儀,6,0,6,華南永昌-民權,2024-10-17,9312
8183,精星,6,0,6,華南永昌-民權,2024-10-17,9312
8240,華宏,6,0,6,華南永昌-民權,2024-10-17,9312
2845,遠東銀,5,0,5,華南永昌-民權,2024-10-17,9312
00662,富邦NASDAQ,5,0,5,華南永昌-民權,2024-10-17,9312
2426,鼎元,5,0,5,華南永昌-民權,2024-10-17,9312
3710,連展投控,5,0,5,華南永昌-民權,2024-10-17,9312
4905,台聯電,5,0,5,華南永昌-民權,2024-10-17,9312
6147,頎邦,5,0,5,華南永昌-民權,2024-10-17,9312
8069,元太,5,0,5,華南永昌-民權,2024-10-17,9312
8163,達方,5,0,5,華南永昌-民權,2024-10-17,9312
5452,佶優,13,9,4,華南永昌-民權,2024-10-17,9312
6241,易通展,4,0,4,華南永昌-民權,2024-10-17,9312
8374,羅昇,8,4,4,華南永昌-民權,2024-10-17,9312
2888B,新光金乙特,3,0,3,華南永昌-民權,2024-10-17,9312
2449,京元電子,370,11,359,華南永昌-民權,2024-10-18,9312
00937B,群益ESG投等債20,113,0,113,華南永昌-民權,2024-10-18,9312
00680L,元大美債20正2,98,0,98,華南永昌-民權,2024-10-18,9312
3652,精聯,60,0,60,華南永昌-民權,2024-10-18,9312
2101,南港,50,0,50,華南永昌-民權,2024-10-18,9312
2312,金寶,51,5,46,華南永昌-民權,2024-10-18,9312
00679B,元大美債20年,29,0,29,華南永昌-民權,2024-10-18,9312
00688L,國泰20年美債正2,27,0,27,華南永昌-民權,2024-10-18,9312
00919,群益台灣精選高息,28,2,26,華南永昌-民權,2024-10-18,9312
00905,FT臺灣Smart,29,6,23,華南永昌-民權,2024-10-18,9312
00946,群益科技高息成長,20,0,20,華南永昌-民權,2024-10-18,9312
1410,南染,20,0,20,華南永昌-民權,2024-10-18,9312
2303,聯電,25,8,17,華南永昌-民權,2024-10-18,9312
3213,茂訊,15,0,15,華南永昌-民權,2024-10-18,9312
00687B,國泰20年美債,14,0,14,華南永昌-民權,2024-10-18,9312
3380,明泰,15,1,14,華南永昌-民權,2024-10-18,9312
3673,TPK-KY,15,1,14,華南永昌-民權,2024-10-18,9312
6246,臺龍,14,0,14,華南永昌-民權,2024-10-18,9312
2888B,新光金乙特,11,0,11,華南永昌-民權,2024-10-18,9312
00887,永豐中國科技50大,41,30,11,華南永昌-民權,2024-10-18,9312
1609,大亞,11,0,11,華南永昌-民權,2024-10-18,9312
2402,毅嘉,28,17,11,華南永昌-民權,2024-10-18,9312
3162,精確,11,0,11,華南永昌-民權,2024-10-18,9312
3715,定穎投控,15,4,11,華南永昌-民權,2024-10-18,9312
8096,擎亞,11,0,11,華南永昌-民權,2024-10-18,9312
9938,百和,14,4,10,華南永昌-民權,2024-10-18,9312
5340,建榮,10,0,10,華南永昌-民權,2024-10-18,9312
6126,信音,10,0,10,華南永昌-民權,2024-10-18,9312
0056,元大高股息,34,25,9,華南永昌-民權,2024-10-18,9312
5347,世界,9,0,9,華南永昌-民權,2024-10-18,9312
2867,三商壽,26,17,9,華南永昌-民權,2024-10-18,9312
4905,台聯電,9,0,9,華南永昌-民權,2024-10-18,9312
6542,隆中,8,0,8,華南永昌-民權,2024-10-18,9312
006208,富邦台50,9,2,7,華南永昌-民權,2024-10-18,9312
3037,欣興,9,2,7,華南永昌-民權,2024-10-18,9312
3149,正達,8,1,7,華南永昌-民權,2024-10-18,9312
6546,正基,7,0,7,華南永昌-民權,2024-10-18,9312
8111,立��,9,2,7,華南永昌-民權,2024-10-18,9312
4979,華星光,7,0,7,華南永昌-民權,2024-10-18,9312
00933B,國泰10Y+金融債,6,0,6,華南永昌-民權,2024-10-18,9312
1528,恩德,10,4,6,華南永昌-民權,2024-10-18,9312
2615,萬海,14,8,6,華南永昌-民權,2024-10-18,9312
3374,精材,9,4,5,華南永昌-民權,2024-10-18,9312
00696B,富邦美債20年,5,0,5,華南永昌-民權,2024-10-18,9312
00795B,中信美國公債20年,5,0,5,華南永昌-民權,2024-10-18,9312
1471,首利,5,0,5,華南永昌-民權,2024-10-18,9312
1525,江申,5,0,5,華南永昌-民權,2024-10-18,9312
1905,華紙,5,0,5,華南永昌-民權,2024-10-18,9312
2527,宏璟,10,5,5,華南永昌-民權,2024-10-18,9312
3516,亞帝歐,5,0,5,華南永昌-民權,2024-10-18,9312
00937B,群益ESG投等債20,77,23,54,華南永昌-民權,2024-10-21,9312
00958B,永豐ESG銀行債15,53,0,53,華南永昌-民權,2024-10-21,9312
3652,精聯,50,0,50,華南永昌-民權,2024-10-21,9312
00905,FT臺灣Smart,42,9,33,華南永昌-民權,2024-10-21,9312
1101,台泥,20,0,20,華南永昌-民權,2024-10-21,9312
3581,博磊,20,0,20,華南永昌-民權,2024-10-21,9312
2332,友訊,21,6,15,華南永昌-民權,2024-10-21,9312
4909,新復興,35,20,15,華南永昌-民權,2024-10-21,9312
00878,國泰永續高股息,14,2,12,華南永昌-民權,2024-10-21,9312
00715L,期街口布蘭特正2,12,0,12,華南永昌-民權,2024-10-21,9312
4927,泰鼎-KY,14,3,11,華南永昌-民權,2024-10-21,9312
2409,友達,11,0,11,華南永昌-民權,2024-10-21,9312
6658,聯策,12,1,11,華南永昌-民權,2024-10-21,9312
00948B,中信優息投資級債,10,0,10,華南永昌-民權,2024-10-21,9312
2883,凱基金,10,0,10,華南永昌-民權,2024-10-21,9312
3289,宜特,10,0,10,華南永昌-民權,2024-10-21,9312
5392,能率,23,13,10,華南永昌-民權,2024-10-21,9312
00795B,中信美國公債20年,9,0,9,華南永昌-民權,2024-10-21,9312
00687B,國泰20年美債,8,0,8,華南永昌-民權,2024-10-21,9312
2867,三商壽,8,0,8,華南永昌-民權,2024-10-21,9312
0056,元大高股息,10,3,7,華南永昌-民權,2024-10-21,9312
2374,佳能,7,0,7,華南永昌-民權,2024-10-21,9312
00933B,國泰10Y+金融債,7,0,7,華南永昌-民權,2024-10-21,9312
00637L,元大滬深300正2,5,0,5,華南永昌-民權,2024-10-21,9312
00696B,富邦美債20年,5,0,5,華南永昌-民權,2024-10-21,9312
00753L,中信中國50正2,5,0,5,華南永昌-民權,2024-10-21,9312
2402,毅嘉,7,2,5,華南永昌-民權,2024-10-21,9312
2543,皇昌,17,12,5,華南永昌-民權,2024-10-21,9312
2601,益航,11,6,5,華南永昌-民權,2024-10-21,9312
3715,定穎投控,14,9,5,華南永昌-民權,2024-10-21,9312
6220,岳豐,5,0,5,華南永昌-民權,2024-10-21,9312
6770,力積電,6,1,5,華南永昌-民權,2024-10-21,9312
8097,常珵,5,0,5,華南永昌-民權,2024-10-21,9312
8111,立��,6,1,5,華南永昌-民權,2024-10-21,9312
2885,元大金,5,0,5,華南永昌-民權,2024-10-21,9312
00720B,元大投資級公司債,16,12,4,華南永昌-民權,2024-10-21,9312
6505,台塑化,4,0,4,華南永昌-民權,2024-10-21,9312
8089,康全電訊,10,6,4,華南永昌-民權,2024-10-21,9312
00679B,元大美債20年,9,6,3,華南永昌-民權,2024-10-21,9312
00725B,國泰投資級公司債,3,0,3,華南永昌-民權,2024-10-21,9312
00887,永豐中國科技50大,8,5,3,華南永昌-民權,2024-10-21,9312
00900,富邦特選高股息30,3,0,3,華南永昌-民權,2024-10-21,9312
1326,台化,3,0,3,華南永昌-民權,2024-10-21,9312
1742,台蠟,3,0,3,華南永昌-民權,2024-10-21,9312
2363,矽統,92,89,3,華南永昌-民權,2024-10-21,9312
2399,映泰,35,32,3,華南永昌-民權,2024-10-21,9312
2412,中華電,3,0,3,華南永昌-民權,2024-10-21,9312
3625,西勝,3,0,3,華南永昌-民權,2024-10-21,9312
4207,環泰,3,0,3,華南永昌-民權,2024-10-21,9312
6155,鈞寶,4,1,3,華南永昌-民權,2024-10-21,9312
00751B,元大AAA至A公司債,801,0,801,華南永昌-民權,2024-10-22,9312
2890,永豐金,300,0,300,華南永昌-民權,2024-10-22,9312
00937B,群益ESG投等債20,133,1,132,華南永昌-民權,2024-10-22,9312
00680L,元大美債20正2,130,0,130,華南永昌-民權,2024-10-22,9312
00919,群益台灣精選高息,104,0,104,華南永昌-民權,2024-10-22,9312
00918,大華優利高填息30,50,0,50,華南永昌-民權,2024-10-22,9312
2888,新光金,50,4,46,華南永昌-民權,2024-10-22,9312
2103,台橡,45,1,44,華南永昌-民權,2024-10-22,9312
5315,光聯,40,0,40,華南永昌-民權,2024-10-22,9312
1528,恩德,35,0,35,華南永昌-民權,2024-10-22,9312
4979,華星光,25,0,25,華南永昌-民權,2024-10-22,9312
00933B,國泰10Y+金融債,24,0,24,華南永昌-民權,2024-10-22,9312
1815,富喬,31,7,24,華南永昌-民權,2024-10-22,9312
00679B,元大美債20年,22,0,22,華南永昌-民權,2024-10-22,9312
2312,金寶,26,4,22,華南永昌-民權,2024-10-22,9312
2412,中華電,21,0,21,華南永昌-民權,2024-10-22,9312
00948B,中信優息投資級債,21,0,21,華南永昌-民權,2024-10-22,9312
3213,茂訊,20,0,20,華南永昌-民權,2024-10-22,9312
00795B,中信美國公債20年,17,0,17,華南永昌-民權,2024-10-22,9312
3066,李洲,15,2,13,華南永昌-民權,2024-10-22,9312
00958B,永豐ESG銀行債15,12,0,12,華南永昌-民權,2024-10-22,9312
5438,東友,12,0,12,華南永昌-民權,2024-10-22,9312
6207,雷科,13,1,12,華南永昌-民權,2024-10-22,9312
4927,泰鼎-KY,14,2,12,華南永昌-民權,2024-10-22,9312
00688L,國泰20年美債正2,10,0,10,華南永昌-民權,2024-10-22,9312
00951,台新日本半導體,10,0,10,華南永昌-民權,2024-10-22,9312
2332,友訊,10,0,10,華南永昌-民權,2024-10-22,9312
2367,燿華,10,0,10,華南永昌-民權,2024-10-22,9312
3581,博磊,21,11,10,華南永昌-民權,2024-10-22,9312
4576,大銀微系統,20,10,10,華南永昌-民權,2024-10-22,9312
4905,台聯電,10,0,10,華南永昌-民權,2024-10-22,9312
6126,信音,10,0,10,華南永昌-民權,2024-10-22,9312
6142,友勁,10,0,10,華南永昌-民權,2024-10-22,9312
3167,大量,9,0,9,華南永昌-民權,2024-10-22,9312
3290,東浦,15,6,9,華南永昌-民權,2024-10-22,9312
2330,台積電,11,3,8,華南永昌-民權,2024-10-22,9312
2344,華邦電,8,0,8,華南永昌-民權,2024-10-22,9312
2363,矽統,15,7,8,華南永昌-民權,2024-10-22,9312
0056,元大高股息,8,0,8,華南永昌-民權,2024-10-22,9312
00725B,國泰投資級公司債,44,37,7,華南永昌-民權,2024-10-22,9312
3437,榮創,7,0,7,華南永昌-民權,2024-10-22,9312
00878,國泰永續高股息,6,0,6,華南永昌-民權,2024-10-22,9312
00900,富邦特選高股息30,6,0,6,華南永昌-民權,2024-10-22,9312
2405,輔信,7,1,6,華南永昌-民權,2024-10-22,9312
2903,遠百,6,0,6,華南永昌-民權,2024-10-22,9312
6742,澤米,13,7,6,華南永昌-民權,2024-10-22,9312
2543,皇昌,6,1,5,華南永昌-民權,2024-10-22,9312
2388,威盛,7,2,5,華南永昌-民權,2024-10-22,9312
5347,世界,5,0,5,華南永昌-民權,2024-10-22,9312
00696B,富邦美債20年,5,0,5,華南永昌-民權,2024-10-22,9312
3037,欣興,248,7,241,華南永昌-民權,2024-10-23,9312
3652,精聯,90,0,90,華南永昌-民權,2024-10-23,9312
00637L,元大滬深300正2,93,10,83,華南永昌-民權,2024-10-23,9312
00937B,群益ESG投等債20,60,1,59,華南永昌-民權,2024-10-23,9312
00922,國泰台灣領袖50,55,0,55,華南永昌-民權,2024-10-23,9312
2449,京元電子,52,1,51,華南永昌-民權,2024-10-23,9312
3011,今皓,51,1,50,華南永昌-民權,2024-10-23,9312
00919,群益台灣精選高息,40,0,40,華南永昌-民權,2024-10-23,9312
3481,群創,64,24,40,華南永昌-民權,2024-10-23,9312
00878,國泰永續高股息,33,1,32,華南永昌-民權,2024-10-23,9312
00961,FT臺灣永續高息,32,0,32,華南永昌-民權,2024-10-23,9312
00929,復華台灣科技優息,32,0,32,華南永昌-民權,2024-10-23,9312
2303,聯電,24,0,24,華南永昌-民權,2024-10-23,9312
3149,正達,25,4,21,華南永昌-民權,2024-10-23,9312
00887,永豐中國科技50大,20,0,20,華南永昌-民權,2024-10-23,9312
2070,精湛,20,0,20,華南永昌-民權,2024-10-23,9312
3211,順達,20,0,20,華南永昌-民權,2024-10-23,9312
1109,信大,16,0,16,華南永昌-民權,2024-10-23,9312
8112,至上,15,0,15,華南永昌-民權,2024-10-23,9312
6116,彩晶,15,2,13,華南永昌-民權,2024-10-23,9312
00905,FT臺灣Smart,11,0,11,華南永昌-民權,2024-10-23,9312
00918,大華優利高填息30,10,0,10,華南永昌-民權,2024-10-23,9312
2034,允強,10,0,10,華南永昌-民權,2024-10-23,9312
2363,矽統,11,1,10,華南永昌-民權,2024-10-23,9312
4905,台聯電,10,0,10,華南永昌-民權,2024-10-23,9312
4306,炎洲,10,0,10,華南永昌-民權,2024-10-23,9312
2317,鴻海,15,6,9,華南永昌-民權,2024-10-23,9312
00933B,國泰10Y+金融債,8,0,8,華南永昌-民權,2024-10-23,9312
00927,群益半導體收益,7,0,7,華南永昌-民權,2024-10-23,9312
00915,凱基優選高股息30,7,0,7,華南永昌-民權,2024-10-23,9312
2408,南亞科,7,0,7,華南永昌-民權,2024-10-23,9312
4533,協易機,7,0,7,華南永昌-民權,2024-10-23,9312
4906,正文,10,3,7,華南永昌-民權,2024-10-23,9312
6906,現觀科,7,0,7,華南永昌-民權,2024-10-23,9312
1513,中興電,6,0,6,華南永昌-民權,2024-10-23,9312
5871,中租-KY,6,0,6,華南永昌-民權,2024-10-23,9312
2412,中華電,5,0,5,華南永昌-民權,2024-10-23,9312
00720B,元大投資級公司債,7,2,5,華南永昌-民權,2024-10-23,9312
00940,元大台灣價值高息,6,1,5,華南永昌-民權,2024-10-23,9312
1522,堤維西,5,0,5,華南永昌-民權,2024-10-23,9312
1582,信錦,7,2,5,華南永昌-民權,2024-10-23,9312
1905,華紙,5,0,5,華南永昌-民權,2024-10-23,9312
2338,光罩,5,0,5,華南永昌-民權,2024-10-23,9312
2356,英業達,6,1,5,華南永昌-民權,2024-10-23,9312
2618,長榮航,5,0,5,華南永昌-民權,2024-10-23,9312
3576,聯合再生,5,0,5,華南永昌-民權,2024-10-23,9312
6168,宏齊,5,0,5,華南永昌-民權,2024-10-23,9312
8163,達方,5,0,5,華南永昌-民權,2024-10-23,9312
2329,華泰,21,16,5,華南永昌-民權,2024-10-23,9312
2887,台新金,5,0,5,華南永昌-民權,2024-10-23,9312
3037,欣興,118,6,112,華南永昌-民權,2024-10-24,9312
00751B,元大AAA至A公司債,200,100,100,華南永昌-民權,2024-10-24,9312
2303,聯電,84,0,84,華南永昌-民權,2024-10-24,9312
00878,國泰永續高股息,68,2,66,華南永昌-民權,2024-10-24,9312
00918,大華優利高填息30,55,4,51,華南永昌-民權,2024-10-24,9312
2609,陽明,42,1,41,華南永昌-民權,2024-10-24,9312
2881,富邦金,35,0,35,華南永昌-民權,2024-10-24,9312
3481,群創,37,6,31,華南永昌-民權,2024-10-24,9312
00753L,中信中國50正2,30,0,30,華南永昌-民權,2024-10-24,9312
00961,FT臺灣永續高息,27,0,27,華南永昌-民權,2024-10-24,9312
2852,第一保,22,0,22,華南永昌-民權,2024-10-24,9312
3689,湧德,40,21,19,華南永昌-民權,2024-10-24,9312
0056,元大高股息,34,17,17,華南永昌-民權,2024-10-24,9312
2891,中信金,20,3,17,華南永昌-民權,2024-10-24,9312
00900,富邦特選高股息30,13,0,13,華南永昌-民權,2024-10-24,9312
00933B,國泰10Y+金融債,12,0,12,華南永昌-民權,2024-10-24,9312
2332,友訊,12,0,12,華南永昌-民權,2024-10-24,9312
3209,全科,16,5,11,華南永昌-民權,2024-10-24,9312
6609,瀧澤科,16,5,11,華南永昌-民權,2024-10-24,9312
00919,群益台灣精選高息,13,3,10,華南永昌-民權,2024-10-24,9312
00680L,元大美債20正2,10,0,10,華南永昌-民權,2024-10-24,9312
1815,富喬,18,8,10,華南永昌-民權,2024-10-24,9312
3518,柏騰,10,0,10,華南永昌-民權,2024-10-24,9312
4545,銘鈺,10,0,10,華南永昌-民權,2024-10-24,9312
00945B,凱基美國非投等債,9,0,9,華南永昌-民權,2024-10-24,9312
00679B,元大美債20年,9,0,9,華南永昌-民權,2024-10-24,9312
2402,毅嘉,14,5,9,華南永昌-民權,2024-10-24,9312
6147,頎邦,10,1,9,華南永昌-民權,2024-10-24,9312
9958,世紀鋼,9,1,8,華南永昌-民權,2024-10-24,9312
00927,群益半導體收益,8,0,8,華南永昌-民權,2024-10-24,9312
2489,瑞軒,8,0,8,華南永昌-民權,2024-10-24,9312
4123,晟德,11,3,8,華南永昌-民權,2024-10-24,9312
5315,光聯,10,2,8,華南永昌-民權,2024-10-24,9312
9945,潤泰新,9,1,8,華南永昌-民權,2024-10-24,9312
2374,佳能,9,2,7,華南永昌-民權,2024-10-24,9312
3081,聯亞,7,0,7,華南永昌-民權,2024-10-24,9312
4188,安克,7,0,7,華南永昌-民權,2024-10-24,9312
2888,新光金,7,1,6,華南永昌-民權,2024-10-24,9312
8096,擎亞,6,0,6,華南永昌-民權,2024-10-24,9312
1528,恩德,11,5,6,華南永昌-民權,2024-10-24,9312
1809,中釉,14,8,6,華南永昌-民權,2024-10-24,9312
2353,宏��,11,5,6,華南永昌-民權,2024-10-24,9312
6168,宏齊,7,1,6,華南永昌-民權,2024-10-24,9312
8374,羅昇,6,0,6,華南永昌-民權,2024-10-24,9312
2356,英業達,6,0,6,華南永昌-民權,2024-10-24,9312
2317,鴻海,16,10,6,華南永昌-民權,2024-10-24,9312
1524,耿鼎,5,0,5,華南永昌-民權,2024-10-24,9312
00665L,富邦�琤肭磪囓�2,5,0,5,華南永昌-民權,2024-10-24,9312
1109,信大,5,0,5,華南永昌-民權,2024-10-24,9312
2399,映泰,10,5,5,華南永昌-民權,2024-10-24,9312
2852,第一保,118,0,118,華南永昌-民權,2024-10-25,9312
00937B,群益ESG投等債20,106,2,104,華南永昌-民權,2024-10-25,9312
00932,兆豐永續高息等權,60,0,60,華南永昌-民權,2024-10-25,9312
2836,高雄銀,60,0,60,華南永昌-民權,2024-10-25,9312
00725B,國泰投資級公司債,52,2,50,華南永昌-民權,2024-10-25,9312
0056,元大高股息,45,0,45,華南永昌-民權,2024-10-25,9312
2891,中信金,44,0,44,華南永昌-民權,2024-10-25,9312
2646,星宇航空,80,43,37,華南永昌-民權,2024-10-25,9312
00687B,國泰20年美債,34,2,32,華南永昌-民權,2024-10-25,9312
2303,聯電,26,2,24,華南永昌-民權,2024-10-25,9312
2399,映泰,17,5,12,華南永昌-民權,2024-10-25,9312
2464,盟立,12,0,12,華南永昌-民權,2024-10-25,9312
6770,力積電,11,0,11,華南永昌-民權,2024-10-25,9312
00945B,凱基美國非投等債,10,0,10,華南永昌-民權,2024-10-25,9312
2409,友達,11,1,10,華南永昌-民權,2024-10-25,9312
2506,太設,10,0,10,華南永昌-民權,2024-10-25,9312
4123,晟德,25,15,10,華南永昌-民權,2024-10-25,9312
4739,康普,10,0,10,華南永昌-民權,2024-10-25,9312
4927,泰鼎-KY,22,12,10,華南永昌-民權,2024-10-25,9312
6269,台郡,10,0,10,華南永昌-民權,2024-10-25,9312
6405,悅城,10,0,10,華南永昌-民權,2024-10-25,9312
5438,東友,9,1,8,華南永昌-民權,2024-10-25,9312
2344,華邦電,7,0,7,華南永昌-民權,2024-10-25,9312
3029,零壹,11,4,7,華南永昌-民權,2024-10-25,9312
2884,玉山金,7,0,7,華南永昌-民權,2024-10-25,9312
00919,群益台灣精選高息,6,0,6,華南永昌-民權,2024-10-25,9312
2812,台中銀,6,0,6,華南永昌-民權,2024-10-25,9312
3356,奇偶,6,0,6,華南永昌-民權,2024-10-25,9312
2543,皇昌,8,2,6,華南永昌-民權,2024-10-25,9312
00885,富邦越南,5,0,5,華南永昌-民權,2024-10-25,9312
6546,正基,5,0,5,華南永昌-民權,2024-10-25,9312
3481,群創,7,2,5,華南永昌-民權,2024-10-25,9312
00953B,群益優選非投等債,5,0,5,華南永昌-民權,2024-10-25,9312
00960,野村全球航運龍頭,5,0,5,華南永昌-民權,2024-10-25,9312
3441,聯一光,5,0,5,華南永昌-民權,2024-10-25,9312
3652,精聯,5,0,5,華南永昌-民權,2024-10-25,9312
6788,華景電,5,0,5,華南永昌-民權,2024-10-25,9312
00959B,大華投等美債15Y+,4,0,4,華南永昌-民權,2024-10-25,9312
00948B,中信優息投資級債,5,1,4,華南永昌-民權,2024-10-25,9312
2408,南亞科,4,0,4,華南永昌-民權,2024-10-25,9312
2495,普安,19,15,4,華南永昌-民權,2024-10-25,9312
4576,大銀微系統,5,1,4,華南永昌-民權,2024-10-25,9312
6223,旺矽,5,1,4,華南永昌-民權,2024-10-25,9312
8404,百和興業-KY,6,2,4,華南永昌-民權,2024-10-25,9312
8437,大地-KY,21,17,4,華南永昌-民權,2024-10-25,9312
2330,台積電,4,1,3,華南永昌-民權,2024-10-25,9312
1721,三晃,3,0,3,華南永昌-民權,2024-10-25,9312
2890,永豐金,3,0,3,華南永昌-民權,2024-10-25,9312
3035,智原,3,0,3,華南永昌-民權,2024-10-25,9312
3049,精金,3,0,3,華南永昌-民權,2024-10-25,9312
2887,台新金,152,0,152,華南永昌-民權,2024-10-28,9312
2646,星宇航空,104,7,97,華南永昌-民權,2024-10-28,9312
3652,精聯,65,0,65,華南永昌-民權,2024-10-28,9312
00919,群益台灣精選高息,56,0,56,華南永昌-民權,2024-10-28,9312
00688L,國泰20年美債正2,31,0,31,華南永昌-民權,2024-10-28,9312
00878,國泰永續高股息,50,20,30,華南永昌-民權,2024-10-28,9312
2312,金寶,32,3,29,華南永昌-民權,2024-10-28,9312
1785,光洋科,31,4,27,華南永昌-民權,2024-10-28,9312
6770,力積電,25,3,22,華南永昌-民權,2024-10-28,9312
1721,三晃,21,0,21,華南永昌-民權,2024-10-28,9312
00932,兆豐永續高息等權,21,1,20,華南永昌-民權,2024-10-28,9312
6505,台塑化,20,1,19,華南永昌-民權,2024-10-28,9312
8437,大地-KY,24,5,19,華南永昌-民權,2024-10-28,9312
1533,車王電,19,1,18,華南永昌-民權,2024-10-28,9312
00952,凱基台灣AI50,15,0,15,華南永昌-民權,2024-10-28,9312
3049,精金,15,0,15,華南永昌-民權,2024-10-28,9312
2303,聯電,14,0,14,華南永昌-民權,2024-10-28,9312
2330,台積電,18,5,13,華南永昌-民權,2024-10-28,9312
8064,東捷,14,1,13,華南永昌-民權,2024-10-28,9312
2883,凱基金,12,0,12,華南永昌-民權,2024-10-28,9312
00937B,群益ESG投等債20,12,0,12,華南永昌-民權,2024-10-28,9312
00857B,永豐20年美公債,11,0,11,華南永昌-民權,2024-10-28,9312
2356,英業達,11,0,11,華南永昌-民權,2024-10-28,9312
4903,聯光通,11,0,11,華南永昌-民權,2024-10-28,9312
00675L,富邦臺灣加權正2,10,0,10,華南永昌-民權,2024-10-28,9312
2349,錸德,10,0,10,華南永昌-民權,2024-10-28,9312
3081,聯亞,10,0,10,華南永昌-民權,2024-10-28,9312
3167,大量,20,10,10,華南永昌-民權,2024-10-28,9312
3615,安可,10,0,10,華南永昌-民權,2024-10-28,9312
6579,研揚,10,0,10,華南永昌-民權,2024-10-28,9312
8404,百和興業-KY,12,3,9,華南永昌-民權,2024-10-28,9312
9958,世紀鋼,9,0,9,華南永昌-民權,2024-10-28,9312
00933B,國泰10Y+金融債,8,0,8,華南永昌-民權,2024-10-28,9312
6609,瀧澤科,9,1,8,華南永昌-民權,2024-10-28,9312
00680L,元大美債20正2,57,50,7,華南永昌-民權,2024-10-28,9312
1528,恩德,10,3,7,華南永昌-民權,2024-10-28,9312
2316,楠梓電,7,0,7,華南永昌-民權,2024-10-28,9312
00679B,元大美債20年,7,0,7,華南永昌-民權,2024-10-28,9312
00891,中信關鍵半導體,6,0,6,華南永昌-民權,2024-10-28,9312
00715L,期街口布蘭特正2,6,0,6,華南永昌-民權,2024-10-28,9312
2609,陽明,11,5,6,華南永昌-民權,2024-10-28,9312
5289,宜鼎,6,0,6,華南永昌-民權,2024-10-28,9312
8039,台虹,10,4,6,華南永昌-民權,2024-10-28,9312
3715,定穎投控,13,8,5,華南永昌-民權,2024-10-28,9312
00887,永豐中國科技50大,21,16,5,華南永昌-民權,2024-10-28,9312
00642U,期元大S＆P石油,5,0,5,華南永昌-民權,2024-10-28,9312
2885,元大金,6,1,5,華南永昌-民權,2024-10-28,9312
3518,柏騰,5,0,5,華南永昌-民權,2024-10-28,9312
3597,映興,5,0,5,華南永昌-民權,2024-10-28,9312
6147,頎邦,5,0,5,華南永昌-民權,2024-10-28,9312
00751B,元大AAA至A公司債,1700,0,1700,華南永昌-民權,2024-10-29,9312
2449,京元電子,400,100,300,華南永昌-民權,2024-10-29,9312
3037,欣興,104,2,102,華南永昌-民權,2024-10-29,9312
00919,群益台灣精選高息,100,1,99,華南永昌-民權,2024-10-29,9312
00929,復華台灣科技優息,79,20,59,華南永昌-民權,2024-10-29,9312
00878,國泰永續高股息,38,0,38,華南永昌-民權,2024-10-29,9312
2303,聯電,39,2,37,華南永昌-民權,2024-10-29,9312
8011,台通,32,0,32,華南永昌-民權,2024-10-29,9312
6142,友勁,30,0,30,華南永昌-民權,2024-10-29,9312
2883,凱基金,27,0,27,華南永昌-民權,2024-10-29,9312
00715L,期街口布蘭特正2,25,0,25,華南永昌-民權,2024-10-29,9312
00918,大華優利高填息30,30,5,25,華南永昌-民權,2024-10-29,9312
00713,元大台灣高息低波,22,0,22,華南永昌-民權,2024-10-29,9312
3481,群創,32,11,21,華南永昌-民權,2024-10-29,9312
4956,光鋐,21,0,21,華南永昌-民權,2024-10-29,9312
00632R,元大台灣50反1,20,0,20,華南永昌-民權,2024-10-29,9312
2610,華航,20,0,20,華南永昌-民權,2024-10-29,9312
3581,博磊,41,22,19,華南永昌-民權,2024-10-29,9312
5386,青雲,17,2,15,華南永昌-民權,2024-10-29,9312
00939,統一台灣高息動能,12,0,12,華南永昌-民權,2024-10-29,9312
2455,全新,13,1,12,華南永昌-民權,2024-10-29,9312
006208,富邦台50,11,0,11,華南永昌-民權,2024-10-29,9312
00930,永豐ESG低碳高息,11,0,11,華南永昌-民權,2024-10-29,9312
2489,瑞軒,10,0,10,華南永昌-民權,2024-10-29,9312
00943,兆豐電子高息等權,10,0,10,華南永昌-民權,2024-10-29,9312
2427,三商電,10,0,10,華南永昌-民權,2024-10-29,9312
3360,尚立,10,0,10,華南永昌-民權,2024-10-29,9312
8163,達方,10,0,10,華南永昌-民權,2024-10-29,9312
6152,百一,10,0,10,華南永昌-民權,2024-10-29,9312
00719B,元大美債1-3,9,0,9,華南永昌-民權,2024-10-29,9312
1533,車王電,8,0,8,華南永昌-民權,2024-10-29,9312
4927,泰鼎-KY,18,10,8,華南永昌-民權,2024-10-29,9312
6207,雷科,8,0,8,華南永昌-民權,2024-10-29,9312
8240,華宏,8,0,8,華南永昌-民權,2024-10-29,9312
3551,世禾,9,2,7,華南永昌-民權,2024-10-29,9312
00927,群益半導體收益,6,0,6,華南永昌-民權,2024-10-29,9312
00922,國泰台灣領袖50,6,0,6,華南永昌-民權,2024-10-29,9312
2351,順德,6,0,6,華南永昌-民權,2024-10-29,9312
3518,柏騰,6,0,6,華南永昌-民權,2024-10-29,9312
8374,羅昇,6,0,6,華南永昌-民權,2024-10-29,9312
2330,台積電,16,11,5,華南永昌-民權,2024-10-29,9312
00937B,群益ESG投等債20,5,0,5,華南永昌-民權,2024-10-29,9312
1104,環泥,5,0,5,華南永昌-民權,2024-10-29,9312
1449,佳和,13,8,5,華南永昌-民權,2024-10-29,9312
1522,堤維西,5,0,5,華南永昌-民權,2024-10-29,9312
2415,錩新,5,0,5,華南永昌-民權,2024-10-29,9312
2889,國票金,5,0,5,華南永昌-民權,2024-10-29,9312
4114,健喬,5,0,5,華南永昌-民權,2024-10-29,9312
6505,台塑化,5,0,5,華南永昌-民權,2024-10-29,9312
8064,東捷,5,0,5,華南永昌-民權,2024-10-29,9312
00882,中信中國高股息,301,0,301,華南永昌-民權,2024-10-30,9312
2449,京元電子,200,0,200,華南永昌-民權,2024-10-30,9312
00919,群益台灣精選高息,56,1,55,華南永昌-民權,2024-10-30,9312
3652,精聯,40,0,40,華南永昌-民權,2024-10-30,9312
3062,建漢,36,5,31,華南永昌-民權,2024-10-30,9312
00937B,群益ESG投等債20,31,0,31,華南永昌-民權,2024-10-30,9312
00878,國泰永續高股息,28,0,28,華南永昌-民權,2024-10-30,9312
6829,千附精密,25,0,25,華南永昌-民權,2024-10-30,9312
3715,定穎投控,17,0,17,華南永昌-民權,2024-10-30,9312
3481,群創,30,16,14,華南永昌-民權,2024-10-30,9312
1314,中石化,13,0,13,華南永昌-民權,2024-10-30,9312
1533,車王電,11,0,11,華南永昌-民權,2024-10-30,9312
2303,聯電,12,1,11,華南永昌-民權,2024-10-30,9312
2421,建準,11,1,10,華南永昌-民權,2024-10-30,9312
2489,瑞軒,10,0,10,華南永昌-民權,2024-10-30,9312
3167,大量,16,6,10,華南永昌-民權,2024-10-30,9312
00946,群益科技高息成長,9,0,9,華南永昌-民權,2024-10-30,9312
3689,湧德,11,2,9,華南永昌-民權,2024-10-30,9312
00947,台新臺灣IC設計,8,0,8,華南永昌-民權,2024-10-30,9312
00915,凱基優選高股息30,7,0,7,華南永昌-民權,2024-10-30,9312
1785,光洋科,10,3,7,華南永昌-民權,2024-10-30,9312
8044,網家,11,4,7,華南永昌-民權,2024-10-30,9312
2431,聯昌,6,0,6,華南永昌-民權,2024-10-30,9312
2890,永豐金,6,0,6,華南永昌-民權,2024-10-30,9312
00637L,元大滬深300正2,5,0,5,華南永昌-民權,2024-10-30,9312
2353,宏��,5,0,5,華南永昌-民權,2024-10-30,9312
2425,承啟,8,3,5,華南永昌-民權,2024-10-30,9312
4716,大立,10,5,5,華南永昌-民權,2024-10-30,9312
6133,金橋,6,1,5,華南永昌-民權,2024-10-30,9312
6147,頎邦,5,0,5,華南永昌-民權,2024-10-30,9312
6191,精成科,6,1,5,華南永昌-民權,2024-10-30,9312
1605,華新,4,0,4,華南永昌-民權,2024-10-30,9312
2883,凱基金,4,0,4,華南永昌-民權,2024-10-30,9312
3290,東浦,4,0,4,華南永昌-民權,2024-10-30,9312
5443,均豪,4,0,4,華南永昌-民權,2024-10-30,9312
6791,虎門科技,4,0,4,華南永昌-民權,2024-10-30,9312
2637,慧洋-KY,4,0,4,華南永昌-民權,2024-10-30,9312
00733,富邦臺灣中小,4,0,4,華南永昌-民權,2024-10-30,9312
2327,國巨,4,1,3,華南永昌-民權,2024-10-30,9312
00927,群益半導體收益,3,0,3,華南永昌-民權,2024-10-30,9312
00929,復華台灣科技優息,4,1,3,華南永昌-民權,2024-10-30,9312
00939,統一台灣高息動能,3,0,3,華南永昌-民權,2024-10-30,9312
00955,中信日本商社,3,0,3,華南永昌-民權,2024-10-30,9312
1229,聯華,3,0,3,華南永昌-民權,2024-10-30,9312
1449,佳和,3,0,3,華南永昌-民權,2024-10-30,9312
2356,英業達,4,1,3,華南永昌-民權,2024-10-30,9312
2365,昆盈,3,0,3,華南永昌-民權,2024-10-30,9312
2614,東森,3,0,3,華南永昌-民權,2024-10-30,9312
2845,遠東銀,3,0,3,華南永昌-民權,2024-10-30,9312
2884,玉山金,23,20,3,華南永昌-民權,2024-10-30,9312
2449,京元電子,503,1,502,華南永昌-民權,2024-11-01,9312
2880,華南金,102,0,102,華南永昌-民權,2024-11-01,9312
5222,全訊,50,0,50,華南永昌-民權,2024-11-01,9312
00919,群益台灣精選高息,42,1,41,華南永昌-民權,2024-11-01,9312
4927,泰鼎-KY,64,24,40,華南永昌-民權,2024-11-01,9312
00878,國泰永續高股息,37,0,37,華南永昌-民權,2024-11-01,9312
6177,達麗,26,0,26,華南永昌-民權,2024-11-01,9312
9945,潤泰新,25,0,25,華南永昌-民權,2024-11-01,9312
00929,復華台灣科技優息,24,1,23,華南永昌-民權,2024-11-01,9312
2303,聯電,36,14,22,華南永昌-民權,2024-11-01,9312
1104,環泥,20,0,20,華南永昌-民權,2024-11-01,9312
0056,元大高股息,32,13,19,華南永昌-民權,2024-11-01,9312
2382,廣達,22,4,18,華南永昌-民權,2024-11-01,9312
00918,大華優利高填息30,13,0,13,華南永昌-民權,2024-11-01,9312
2891,中信金,15,3,12,華南永昌-民權,2024-11-01,9312
4167,松瑞藥,12,0,12,華南永昌-民權,2024-11-01,9312
00946,群益科技高息成長,14,3,11,華南永昌-民權,2024-11-01,9312
00637L,元大滬深300正2,10,0,10,華南永昌-民權,2024-11-01,9312
2610,華航,10,0,10,華南永昌-民權,2024-11-01,9312
2337,旺宏,12,3,9,華南永昌-民權,2024-11-01,9312
2317,鴻海,14,5,9,華南永昌-民權,2024-11-01,9312
0050,元大台灣50,8,0,8,華南永昌-民權,2024-11-01,9312
2408,南亞科,9,1,8,華南永昌-民權,2024-11-01,9312
2509,全坤建,8,0,8,華南永昌-民權,2024-11-01,9312
00687B,國泰20年美債,13,5,8,華南永昌-民權,2024-11-01,9312
2884,玉山金,30,22,8,華南永昌-民權,2024-11-01,9312
1595,川寶,10,3,7,華南永昌-民權,2024-11-01,9312
2109,華豐,7,0,7,華南永昌-民權,2024-11-01,9312
5202,力新,8,1,7,華南永昌-民權,2024-11-01,9312
2887,台新金,7,1,6,華南永昌-民權,2024-11-01,9312
00713,元大台灣高息低波,7,1,6,華南永昌-民權,2024-11-01,9312
00937B,群益ESG投等債20,6,0,6,華南永昌-民權,2024-11-01,9312
2301,光寶科,6,0,6,華南永昌-民權,2024-11-01,9312
2353,宏��,6,0,6,華南永昌-民權,2024-11-01,9312
3066,李洲,6,0,6,華南永昌-民權,2024-11-01,9312
3663,鑫科,13,7,6,華南永昌-民權,2024-11-01,9312
00927,群益半導體收益,6,0,6,華南永昌-民權,2024-11-01,9312
2912,統一超,25,20,5,華南永昌-民權,2024-11-01,9312
00631L,元大台灣50正2,5,0,5,華南永昌-民權,2024-11-01,9312
3324,雙鴻,6,1,5,華南永昌-民權,2024-11-01,9312
3049,精金,5,0,5,華南永昌-民權,2024-11-01,9312
8069,元太,5,0,5,華南永昌-民權,2024-11-01,9312
00948B,中信優息投資級債,5,0,5,華南永昌-民權,2024-11-01,9312
00951,台新日本半導體,5,0,5,華南永昌-民權,2024-11-01,9312
1522,堤維西,5,0,5,華南永昌-民權,2024-11-01,9312
2405,輔信,5,0,5,華南永昌-民權,2024-11-01,9312
2460,建通,5,0,5,華南永昌-民權,2024-11-01,9312
2801,彰銀,5,0,5,華南永昌-民權,2024-11-01,9312
3518,柏騰,7,2,5,華南永昌-民權,2024-11-01,9312
5302,太欣,5,0,5,華南永昌-民權,2024-11-01,9312
2408,南亞科,80,9,71,華南永昌-民權,2024-11-04,9312
3037,欣興,54,3,51,華南永昌-民權,2024-11-04,9312
00932,兆豐永續高息等權,50,0,50,華南永昌-民權,2024-11-04,9312
00919,群益台灣精選高息,43,0,43,華南永昌-民權,2024-11-04,9312
2303,聯電,30,1,29,華南永昌-民權,2024-11-04,9312
3652,精聯,26,0,26,華南永昌-民權,2024-11-04,9312
2615,萬海,38,13,25,華南永昌-民權,2024-11-04,9312
2613,中櫃,26,2,24,華南永昌-民權,2024-11-04,9312
00946,群益科技高息成長,24,0,24,華南永昌-民權,2024-11-04,9312
2891,中信金,31,11,20,華南永昌-民權,2024-11-04,9312
2882,國泰金,20,2,18,華南永昌-民權,2024-11-04,9312
3167,大量,15,0,15,華南永昌-民權,2024-11-04,9312
6176,瑞儀,16,1,15,華南永昌-民權,2024-11-04,9312
4558,寶緯,14,0,14,華南永昌-民權,2024-11-04,9312
3062,建漢,19,5,14,華南永昌-民權,2024-11-04,9312
2409,友達,12,0,12,華南永昌-民權,2024-11-04,9312
3231,緯創,15,4,11,華南永昌-民權,2024-11-04,9312
00930,永豐ESG低碳高息,11,0,11,華南永昌-民權,2024-11-04,9312
2884,玉山金,10,0,10,華南永昌-民權,2024-11-04,9312
00912,中信臺灣智慧50,10,0,10,華南永昌-民權,2024-11-04,9312
2762,世界健身-KY,10,0,10,華南永昌-民權,2024-11-04,9312
00918,大華優利高填息30,10,0,10,華南永昌-民權,2024-11-04,9312
1410,南染,9,0,9,華南永昌-民權,2024-11-04,9312
1815,富喬,10,2,8,華南永昌-民權,2024-11-04,9312
00679B,元大美債20年,6,0,6,華南永昌-民權,2024-11-04,9312
8936,國統,6,0,6,華南永昌-民權,2024-11-04,9312
00751B,元大AAA至A公司債,8,2,6,華南永昌-民權,2024-11-04,9312
00795B,中信美國公債20年,6,0,6,華南永昌-民權,2024-11-04,9312
3605,宏致,10,4,6,華南永昌-民權,2024-11-04,9312
0056,元大高股息,6,0,6,華南永昌-民權,2024-11-04,9312
6187,萬潤,6,1,5,華南永昌-民權,2024-11-04,9312
2328,廣宇,48,43,5,華南永昌-民權,2024-11-04,9312
00687B,國泰20年美債,10,5,5,華南永昌-民權,2024-11-04,9312
5347,世界,5,0,5,華南永昌-民權,2024-11-04,9312
00943,兆豐電子高息等權,5,0,5,華南永昌-民權,2024-11-04,9312
1533,車王電,5,0,5,華南永昌-民權,2024-11-04,9312
2401,凌陽,5,0,5,華南永昌-民權,2024-11-04,9312
2881,富邦金,5,0,5,華南永昌-民權,2024-11-04,9312
3680,家登,5,0,5,華南永昌-民權,2024-11-04,9312
6152,百一,5,0,5,華南永昌-民權,2024-11-04,9312
00857B,永豐20年美公債,4,0,4,華南永昌-民權,2024-11-04,9312
00712,復華富時不動產,4,0,4,華南永昌-民權,2024-11-04,9312
3105,穩懋,4,0,4,華南永昌-民權,2024-11-04,9312
006208,富邦台50,3,0,3,華南永昌-民權,2024-11-04,9312
2353,宏��,3,0,3,華南永昌-民權,2024-11-04,9312
2413,環科,9,6,3,華南永昌-民權,2024-11-04,9312
4714,永捷,3,0,3,華南永昌-民權,2024-11-04,9312
4967,十銓,3,0,3,華南永昌-民權,2024-11-04,9312
6133,金橋,4,1,3,華南永昌-民權,2024-11-04,9312
6158,禾昌,3,0,3,華南永昌-民權,2024-11-04,9312
2317,鴻海,168,51,117,華南永昌-民權,2024-11-05,9312
2382,廣達,102,3,99,華南永昌-民權,2024-11-05,9312
00943,兆豐電子高息等權,65,0,65,華南永昌-民權,2024-11-05,9312
00725B,國泰投資級公司債,52,0,52,華南永昌-民權,2024-11-05,9312
00946,群益科技高息成長,31,0,31,華南永昌-民權,2024-11-05,9312
3062,建漢,23,0,23,華南永昌-民權,2024-11-05,9312
00940,元大台灣價值高息,22,1,21,華南永昌-民權,2024-11-05,9312
00688L,國泰20年美債正2,20,0,20,華南永昌-民權,2024-11-05,9312
1218,泰山,20,0,20,華南永昌-民權,2024-11-05,9312
8070,長華*,21,2,19,華南永昌-民權,2024-11-05,9312
2303,聯電,43,25,18,華南永昌-民權,2024-11-05,9312
00712,復華富時不動產,18,0,18,華南永昌-民權,2024-11-05,9312
00930,永豐ESG低碳高息,10,0,10,華南永昌-民權,2024-11-05,9312
00878,國泰永續高股息,10,0,10,華南永昌-民權,2024-11-05,9312
00673R,期元大S＆P原油反1,10,0,10,華南永昌-民權,2024-11-05,9312
2427,三商電,10,0,10,華南永昌-民權,2024-11-05,9312
00918,大華優利高填息30,9,0,9,華南永昌-民權,2024-11-05,9312
3490,單井,10,2,8,華南永昌-民權,2024-11-05,9312
00927,群益半導體收益,8,0,8,華南永昌-民權,2024-11-05,9312
3289,宜特,8,0,8,華南永昌-民權,2024-11-05,9312
5426,振發,10,3,7,華南永昌-民權,2024-11-05,9312
2882,國泰金,6,0,6,華南永昌-民權,2024-11-05,9312
00713,元大台灣高息低波,6,0,6,華南永昌-民權,2024-11-05,9312
2332,友訊,6,0,6,華南永昌-民權,2024-11-05,9312
2887,台新金,6,0,6,華南永昌-民權,2024-11-05,9312
8437,大地-KY,16,10,6,華南永昌-民權,2024-11-05,9312
5258,虹堡,6,0,6,華南永昌-民權,2024-11-05,9312
1528,恩德,8,3,5,華南永昌-民權,2024-11-05,9312
1524,耿鼎,5,0,5,華南永昌-民權,2024-11-05,9312
2405,輔信,6,1,5,華南永昌-民權,2024-11-05,9312
3419,譁裕,5,0,5,華南永昌-民權,2024-11-05,9312
4113,聯上,5,0,5,華南永昌-民權,2024-11-05,9312
8150,南茂,9,4,5,華南永昌-民權,2024-11-05,9312
3711,日月光投控,4,0,4,華南永昌-民權,2024-11-05,9312
00919,群益台灣精選高息,17,13,4,華南永昌-民權,2024-11-05,9312
6126,信音,6,2,4,華南永昌-民權,2024-11-05,9312
6405,悅城,40,36,4,華南永昌-民權,2024-11-05,9312
3324,雙鴻,4,1,3,華南永昌-民權,2024-11-05,9312
00950B,凱基A級公司債,4,1,3,華南永昌-民權,2024-11-05,9312
00905,FT臺灣Smart,3,0,3,華南永昌-民權,2024-11-05,9312
1436,華友聯,3,0,3,華南永昌-民權,2024-11-05,9312
1527,鑽全,3,0,3,華南永昌-民權,2024-11-05,9312
1595,川寶,3,0,3,華南永昌-民權,2024-11-05,9312
2328,廣宇,6,3,3,華南永昌-民權,2024-11-05,9312
2369,菱生,3,0,3,華南永昌-民權,2024-11-05,9312
2601,益航,5,2,3,華南永昌-民權,2024-11-05,9312
2605,新興,3,0,3,華南永昌-民權,2024-11-05,9312
3047,訊舟,5,2,3,華南永昌-民權,2024-11-05,9312
3714,富采,3,0,3,華南永昌-民權,2024-11-05,9312
4903,聯光通,12,9,3,華南永昌-民權,2024-11-05,9312
00940,元大台灣價值高息,500,58,442,華南永昌-民權,2024-11-06,9312
00687B,國泰20年美債,123,0,123,華南永昌-民權,2024-11-06,9312
00878,國泰永續高股息,94,0,94,華南永昌-民權,2024-11-06,9312
00680L,元大美債20正2,85,0,85,華南永昌-民權,2024-11-06,9312
1528,恩德,43,1,42,華南永昌-民權,2024-11-06,9312
00946,群益科技高息成長,50,15,35,華南永昌-民權,2024-11-06,9312
00887,永豐中國科技50大,32,0,32,華南永昌-民權,2024-11-06,9312
2610,華航,30,0,30,華南永昌-民權,2024-11-06,9312
00919,群益台灣精選高息,29,1,28,華南永昌-民權,2024-11-06,9312
00713,元大台灣高息低波,23,0,23,華南永昌-民權,2024-11-06,9312
00679B,元大美債20年,22,0,22,華南永昌-民權,2024-11-06,9312
00688L,國泰20年美債正2,19,0,19,華南永昌-民權,2024-11-06,9312
6126,信音,18,0,18,華南永昌-民權,2024-11-06,9312
00706L,期元大S＆P日圓正2,15,0,15,華南永昌-民權,2024-11-06,9312
3037,欣興,17,3,14,華南永昌-民權,2024-11-06,9312
2303,聯電,38,25,13,華南永昌-民權,2024-11-06,9312
6869,雲豹能源,15,2,13,華南永昌-民權,2024-11-06,9312
2399,映泰,15,3,12,華南永昌-民權,2024-11-06,9312
3450,聯鈞,29,17,12,華南永昌-民權,2024-11-06,9312
4561,健椿,13,2,11,華南永昌-民權,2024-11-06,9312
3652,精聯,10,0,10,華南永昌-民權,2024-11-06,9312
8163,達方,10,0,10,華南永昌-民權,2024-11-06,9312
2637,慧洋-KY,10,0,10,華南永昌-民權,2024-11-06,9312
00937B,群益ESG投等債20,20,11,9,華南永昌-民權,2024-11-06,9312
1449,佳和,14,5,9,華南永昌-民權,2024-11-06,9312
2431,聯昌,11,3,8,華南永昌-民權,2024-11-06,9312
4919,新唐,13,5,8,華南永昌-民權,2024-11-06,9312
6125,廣運,8,0,8,華南永昌-民權,2024-11-06,9312
6605,帝寶,8,0,8,華南永昌-民權,2024-11-06,9312
6770,力積電,10,2,8,華南永昌-民權,2024-11-06,9312
2613,中櫃,9,2,7,華南永昌-民權,2024-11-06,9312
5347,世界,8,1,7,華南永昌-民權,2024-11-06,9312
8039,台虹,10,3,7,華南永昌-民權,2024-11-06,9312
2367,燿華,6,0,6,華南永昌-民權,2024-11-06,9312
6191,精成科,6,0,6,華南永昌-民權,2024-11-06,9312
6505,台塑化,6,0,6,華南永昌-民權,2024-11-06,9312
6768,志強-KY,6,0,6,華南永昌-民權,2024-11-06,9312
9945,潤泰新,6,0,6,華南永昌-民權,2024-11-06,9312
3481,群創,6,0,6,華南永昌-民權,2024-11-06,9312
00935,野村臺灣新科技50,5,0,5,華南永昌-民權,2024-11-06,9312
2062,橋椿,10,5,5,華南永昌-民權,2024-11-06,9312
2353,宏��,16,11,5,華南永昌-民權,2024-11-06,9312
2762,世界健身-KY,5,0,5,華南永昌-民權,2024-11-06,9312
4927,泰鼎-KY,25,21,4,華南永昌-民權,2024-11-06,9312
2891,中信金,6,2,4,華南永昌-民權,2024-11-06,9312
1321,大洋,4,0,4,華南永昌-民權,2024-11-06,9312
2477,美隆電,4,0,4,華南永昌-民權,2024-11-06,9312
4763,材料-KY,4,0,4,華南永昌-民權,2024-11-06,9312
6116,彩晶,4,0,4,華南永昌-民權,2024-11-06,9312
6152,百一,4,0,4,華南永昌-民權,2024-11-06,9312
00680L,元大美債20正2,352,0,352,華南永昌-民權,2024-11-07,9312
2330,台積電,132,1,131,華南永昌-民權,2024-11-07,9312
00664R,國泰臺灣加權反1,100,0,100,華南永昌-民權,2024-11-07,9312
9924,福興,50,2,48,華南永昌-民權,2024-11-07,9312
2355,敬鵬,30,0,30,華南永昌-民權,2024-11-07,9312
2498,宏達電,25,0,25,華南永昌-民權,2024-11-07,9312
1536,和大,23,1,22,華南永昌-民權,2024-11-07,9312
6505,台塑化,20,1,19,華南永昌-民權,2024-11-07,9312
2356,英業達,29,11,18,華南永昌-民權,2024-11-07,9312
00688L,國泰20年美債正2,26,10,16,華南永昌-民權,2024-11-07,9312
3049,精金,15,0,15,華南永昌-民權,2024-11-07,9312
3615,安可,15,0,15,華南永昌-民權,2024-11-07,9312
2834,臺企銀,13,0,13,華南永昌-民權,2024-11-07,9312
1815,富喬,14,2,12,華南永昌-民權,2024-11-07,9312
2014,中鴻,14,2,12,華南永昌-民權,2024-11-07,9312
2027,大成鋼,12,1,11,華南永昌-民權,2024-11-07,9312
1410,南染,10,0,10,華南永昌-民權,2024-11-07,9312
1464,得力,11,1,10,華南永昌-民權,2024-11-07,9312
3441,聯一光,10,0,10,華南永昌-民權,2024-11-07,9312
4977,眾達-KY,11,1,10,華南永昌-民權,2024-11-07,9312
00637L,元大滬深300正2,18,9,9,華南永昌-民權,2024-11-07,9312
3357,臺慶科,9,0,9,華南永昌-民權,2024-11-07,9312
6288,聯嘉,9,2,7,華南永昌-民權,2024-11-07,9312
9958,世紀鋼,6,0,6,華南永昌-民權,2024-11-07,9312
00919,群益台灣精選高息,8,2,6,華南永昌-民權,2024-11-07,9312
00946,群益科技高息成長,16,10,6,華南永昌-民權,2024-11-07,9312
2603,長榮,5,0,5,華南永昌-民權,2024-11-07,9312
1528,恩德,5,0,5,華南永昌-民權,2024-11-07,9312
2062,橋椿,5,0,5,華南永昌-民權,2024-11-07,9312
2331,精英,5,0,5,華南永昌-民權,2024-11-07,9312
2882,國泰金,5,0,5,華南永昌-民權,2024-11-07,9312
3680,家登,5,0,5,華南永昌-民權,2024-11-07,9312
6177,達麗,6,1,5,華南永昌-民權,2024-11-07,9312
6873,泓德能源,5,1,4,華南永昌-民權,2024-11-07,9312
4991,環宇-KY,45,41,4,華南永昌-民權,2024-11-07,9312
1301,台塑,5,1,4,華南永昌-民權,2024-11-07,9312
00712,復華富時不動產,4,0,4,華南永昌-民權,2024-11-07,9312
00915,凱基優選高股息30,4,0,4,華南永昌-民權,2024-11-07,9312
00905,FT臺灣Smart,4,0,4,華南永昌-民權,2024-11-07,9312
2332,友訊,12,8,4,華南永昌-民權,2024-11-07,9312
3219,倚強科,4,0,4,華南永昌-民權,2024-11-07,9312
3231,緯創,15,11,4,華南永昌-民權,2024-11-07,9312
8033,雷虎,8,4,4,華南永昌-民權,2024-11-07,9312
8039,台虹,5,1,4,華南永昌-民權,2024-11-07,9312
8069,元太,4,0,4,華南永昌-民權,2024-11-07,9312
6442,光聖,3,0,3,華南永昌-民權,2024-11-07,9312
2351,順德,3,0,3,華南永昌-民權,2024-11-07,9312
2892,第一金,3,0,3,華南永昌-民權,2024-11-07,9312
3447,展達,3,0,3,華南永昌-民權,2024-11-07,9312
4109,加捷生醫,3,0,3,華南永昌-民權,2024-11-07,9312
3231,緯創,295,25,270,華南永昌-民權,2024-11-08,9312
2382,廣達,105,6,99,華南永昌-民權,2024-11-08,9312
2408,南亞科,72,0,72,華南永昌-民權,2024-11-08,9312
2356,英業達,71,27,44,華南永昌-民權,2024-11-08,9312
1528,恩德,41,1,40,華南永昌-民權,2024-11-08,9312
00943,兆豐電子高息等權,36,0,36,華南永昌-民權,2024-11-08,9312
6505,台塑化,34,2,32,華南永昌-民權,2024-11-08,9312
2353,宏��,26,0,26,華南永昌-民權,2024-11-08,9312
00937B,群益ESG投等債20,32,15,17,華南永昌-民權,2024-11-08,9312
0056,元大高股息,25,9,16,華南永昌-民權,2024-11-08,9312
3019,亞光,16,0,16,華南永昌-民權,2024-11-08,9312
1799,易威,25,10,15,華南永昌-民權,2024-11-08,9312
3062,建漢,29,15,14,華南永昌-民權,2024-11-08,9312
00878,國泰永續高股息,21,9,12,華南永昌-民權,2024-11-08,9312
00637L,元大滬深300正2,18,6,12,華南永昌-民權,2024-11-08,9312
3522,御嵿,12,0,12,華南永昌-民權,2024-11-08,9312
2014,中鴻,11,0,11,華南永昌-民權,2024-11-08,9312
3149,正達,42,31,11,華南永昌-民權,2024-11-08,9312
6116,彩晶,11,0,11,華南永昌-民權,2024-11-08,9312
2388,威盛,10,0,10,華南永昌-民權,2024-11-08,9312
00688L,國泰20年美債正2,10,0,10,華南永昌-民權,2024-11-08,9312
2419,仲琦,11,1,10,華南永昌-民權,2024-11-08,9312
3652,精聯,10,0,10,華南永昌-民權,2024-11-08,9312
6158,禾昌,10,0,10,華南永昌-民權,2024-11-08,9312
6164,華興,10,0,10,華南永昌-民權,2024-11-08,9312
6425,易發,21,11,10,華南永昌-民權,2024-11-08,9312
6835,圓裕,10,0,10,華南永昌-民權,2024-11-08,9312
2354,鴻準,30,20,10,華南永昌-民權,2024-11-08,9312
00919,群益台灣精選高息,20,10,10,華南永昌-民權,2024-11-08,9312
2031,新光鋼,7,0,7,華南永昌-民權,2024-11-08,9312
2489,瑞軒,13,6,7,華南永昌-民權,2024-11-08,9312
3374,精材,16,9,7,華南永昌-民權,2024-11-08,9312
9958,世紀鋼,7,1,6,華南永昌-民權,2024-11-08,9312
4904,遠傳,7,1,6,華南永昌-民權,2024-11-08,9312
1314,中石化,6,0,6,華南永昌-民權,2024-11-08,9312
1711,永光,6,0,6,華南永昌-民權,2024-11-08,9312
2481,強茂,6,0,6,華南永昌-民權,2024-11-08,9312
2542,興富發,8,2,6,華南永昌-民權,2024-11-08,9312
3441,聯一光,6,0,6,華南永昌-民權,2024-11-08,9312
2344,華邦電,7,1,6,華南永昌-民權,2024-11-08,9312
2027,大成鋼,5,0,5,華南永昌-民權,2024-11-08,9312
00951,台新日本半導體,5,0,5,華南永昌-民權,2024-11-08,9312
1471,首利,5,0,5,華南永昌-民權,2024-11-08,9312
1506,正道,5,0,5,華南永昌-民權,2024-11-08,9312
1717,長興,5,0,5,華南永昌-民權,2024-11-08,9312
2402,毅嘉,5,0,5,華南永昌-民權,2024-11-08,9312
2405,輔信,5,0,5,華南永昌-民權,2024-11-08,9312
3372,典範,5,0,5,華南永昌-民權,2024-11-08,9312
4772,台特化,5,0,5,華南永昌-民權,2024-11-08,9312
6120,達運,5,0,5,華南永昌-民權,2024-11-08,9312
3231,緯創,93,6,87,華南永昌-民權,2024-11-11,9312
3037,欣興,64,3,61,華南永昌-民權,2024-11-11,9312
00878,國泰永續高股息,44,0,44,華南永昌-民權,2024-11-11,9312
00688L,國泰20年美債正2,40,0,40,華南永昌-民權,2024-11-11,9312
2303,聯電,28,3,25,華南永昌-民權,2024-11-11,9312
1438,三地開發,25,0,25,華南永昌-民權,2024-11-11,9312
2609,陽明,34,11,23,華南永昌-民權,2024-11-11,9312
3552,同致,21,0,21,華南永昌-民權,2024-11-11,9312
5386,青雲,22,1,21,華南永昌-民權,2024-11-11,9312
2382,廣達,31,11,20,華南永昌-民權,2024-11-11,9312
3062,建漢,19,2,17,華南永昌-民權,2024-11-11,9312
6770,力積電,16,0,16,華南永昌-民權,2024-11-11,9312
00919,群益台灣精選高息,74,59,15,華南永昌-民權,2024-11-11,9312
6150,撼訊,15,0,15,華南永昌-民權,2024-11-11,9312
3715,定穎投控,23,9,14,華南永昌-民權,2024-11-11,9312
00946,群益科技高息成長,14,0,14,華南永昌-民權,2024-11-11,9312
2887,台新金,14,0,14,華南永昌-民權,2024-11-11,9312
8028,昇陽半導體,15,1,14,華南永昌-民權,2024-11-11,9312
3576,聯合再生,13,0,13,華南永昌-民權,2024-11-11,9312
00679B,元大美債20年,16,3,13,華南永昌-民權,2024-11-11,9312
00887,永豐中國科技50大,12,0,12,華南永昌-民權,2024-11-11,9312
2891,中信金,13,1,12,華南永昌-民權,2024-11-11,9312
00934,中信成長高股息,17,7,10,華南永昌-民權,2024-11-11,9312
1314,中石化,10,0,10,華南永昌-民權,2024-11-11,9312
2332,友訊,55,45,10,華南永昌-民權,2024-11-11,9312
3003,健和興,10,0,10,華南永昌-民權,2024-11-11,9312
4979,華星光,11,1,10,華南永昌-民權,2024-11-11,9312
6695,芯鼎,10,0,10,華南永昌-民權,2024-11-11,9312
2323,中環,10,0,10,華南永昌-民權,2024-11-11,9312
00937B,群益ESG投等債20,10,1,9,華南永昌-民權,2024-11-11,9312
2889,國票金,8,0,8,華南永昌-民權,2024-11-11,9312
5426,振發,10,2,8,華南永昌-民權,2024-11-11,9312
5483,中美晶,8,0,8,華南永昌-民權,2024-11-11,9312
6288,聯嘉,10,2,8,華南永昌-民權,2024-11-11,9312
00715L,期街口布蘭特正2,7,0,7,華南永昌-民權,2024-11-11,9312
2034,允強,7,0,7,華南永昌-民權,2024-11-11,9312
2883,凱基金,24,17,7,華南永昌-民權,2024-11-11,9312
3060,銘異,7,0,7,華南永昌-民權,2024-11-11,9312
3518,柏騰,7,0,7,華南永昌-民權,2024-11-11,9312
2392,正崴,14,7,7,華南永昌-民權,2024-11-11,9312
9941,裕融,6,0,6,華南永昌-民權,2024-11-11,9312
2646,星宇航空,7,1,6,華南永昌-民權,2024-11-11,9312
1799,易威,6,0,6,華南永昌-民權,2024-11-11,9312
3511,矽瑪,6,0,6,華南永昌-民權,2024-11-11,9312
4967,十銓,7,1,6,華南永昌-民權,2024-11-11,9312
00915,凱基優選高股息30,8,3,5,華南永昌-民權,2024-11-11,9312
00637L,元大滬深300正2,5,0,5,華南永昌-民權,2024-11-11,9312
1410,南染,5,0,5,華南永昌-民權,2024-11-11,9312
1513,中興電,6,1,5,華南永昌-民權,2024-11-11,9312
1718,中纖,5,0,5,華南永昌-民權,2024-11-11,9312
2367,燿華,133,0,133,華南永昌-民權,2024-11-12,9312
00878,國泰永續高股息,59,2,57,華南永昌-民權,2024-11-12,9312
0056,元大高股息,56,20,36,華南永昌-民權,2024-11-12,9312
00919,群益台灣精選高息,49,14,35,華南永昌-民權,2024-11-12,9312
00915,凱基優選高股息30,37,3,34,華南永昌-民權,2024-11-12,9312
2401,凌陽,31,0,31,華南永昌-民權,2024-11-12,9312
00961,FT臺灣永續高息,30,0,30,華南永昌-民權,2024-11-12,9312
1314,中石化,24,2,22,華南永昌-民權,2024-11-12,9312
00929,復華台灣科技優息,21,0,21,華南永昌-民權,2024-11-12,9312
2888,新光金,20,0,20,華南永昌-民權,2024-11-12,9312
1301,台塑,19,0,19,華南永昌-民權,2024-11-12,9312
2330,台積電,25,7,18,華南永昌-民權,2024-11-12,9312
2409,友達,21,3,18,華南永昌-民權,2024-11-12,9312
2542,興富發,17,0,17,華南永昌-民權,2024-11-12,9312
2353,宏��,15,0,15,華南永昌-民權,2024-11-12,9312
00918,大華優利高填息30,14,0,14,華南永昌-民權,2024-11-12,9312
5871,中租-KY,13,0,13,華南永昌-民權,2024-11-12,9312
2615,萬海,17,4,13,華南永昌-民權,2024-11-12,9312
2002,中鋼,13,0,13,華南永昌-民權,2024-11-12,9312
00943,兆豐電子高息等權,11,0,11,華南永昌-民權,2024-11-12,9312
4303,信立,16,5,11,華南永昌-民權,2024-11-12,9312
8404,百和興業-KY,11,0,11,華南永昌-民權,2024-11-12,9312
2356,英業達,20,10,10,華南永昌-民權,2024-11-12,9312
2845,遠東銀,10,0,10,華南永昌-民權,2024-11-12,9312
00753L,中信中國50正2,10,0,10,華南永昌-民權,2024-11-12,9312
2834,臺企銀,10,0,10,華南永昌-民權,2024-11-12,9312
3049,精金,10,0,10,華南永昌-民權,2024-11-12,9312
5398,慕康生醫,10,0,10,華南永昌-民權,2024-11-12,9312
6288,聯嘉,10,0,10,華南永昌-民權,2024-11-12,9312
00900,富邦特選高股息30,9,0,9,華南永昌-民權,2024-11-12,9312
00946,群益科技高息成長,11,2,9,華南永昌-民權,2024-11-12,9312
1727,中華化,9,0,9,華南永昌-民權,2024-11-12,9312
2882,國泰金,9,0,9,華南永昌-民權,2024-11-12,9312
5426,振發,10,1,9,華南永昌-民權,2024-11-12,9312
6695,芯鼎,13,4,9,華南永昌-民權,2024-11-12,9312
2328,廣宇,47,38,9,華南永昌-民權,2024-11-12,9312
00953B,群益優選非投等債,8,0,8,華南永昌-民權,2024-11-12,9312
1524,耿鼎,10,2,8,華南永昌-民權,2024-11-12,9312
3289,宜特,7,0,7,華南永昌-民權,2024-11-12,9312
3481,群創,8,1,7,華南永昌-民權,2024-11-12,9312
5014,建錩,7,0,7,華南永昌-民權,2024-11-12,9312
5386,青雲,7,0,7,華南永昌-民權,2024-11-12,9312
00687B,國泰20年美債,9,2,7,華南永昌-民權,2024-11-12,9312
006208,富邦台50,7,0,7,華南永昌-民權,2024-11-12,9312
2892,第一金,7,1,6,華南永昌-民權,2024-11-12,9312
00713,元大台灣高息低波,6,0,6,華南永昌-民權,2024-11-12,9312
2408,南亞科,9,3,6,華南永昌-民權,2024-11-12,9312
3163,波若威,6,0,6,華南永昌-民權,2024-11-12,9312
5340,建榮,6,0,6,華南永昌-民權,2024-11-12,9312
6770,力積電,6,0,6,華南永昌-民權,2024-11-12,9312
2801,彰銀,101,0,101,華南永昌-民權,2024-11-13,9312
00882,中信中國高股息,105,10,95,華南永昌-民權,2024-11-13,9312
00878,國泰永續高股息,64,10,54,華南永昌-民權,2024-11-13,9312
00919,群益台灣精選高息,48,6,42,華南永昌-民權,2024-11-13,9312
1785,光洋科,45,6,39,華南永昌-民權,2024-11-13,9312
2891,中信金,33,0,33,華南永昌-民權,2024-11-13,9312
6781,AES-KY,29,1,28,華南永昌-民權,2024-11-13,9312
00891,中信關鍵半導體,35,10,25,華南永昌-民權,2024-11-13,9312
1718,中纖,21,0,21,華南永昌-民權,2024-11-13,9312
2427,三商電,21,1,20,華南永昌-民權,2024-11-13,9312
2382,廣達,22,4,18,華南永昌-民權,2024-11-13,9312
2609,陽明,23,7,16,華南永昌-民權,2024-11-13,9312
00943,兆豐電子高息等權,16,0,16,華南永昌-民權,2024-11-13,9312
2883,凱基金,16,0,16,華南永昌-民權,2024-11-13,9312
3481,群創,18,2,16,華南永昌-民權,2024-11-13,9312
2834,臺企銀,14,0,14,華南永昌-民權,2024-11-13,9312
00946,群益科技高息成長,16,2,14,華南永昌-民權,2024-11-13,9312
1308,亞聚,14,0,14,華南永昌-民權,2024-11-13,9312
3312,弘憶股,13,0,13,華南永昌-民權,2024-11-13,9312
00950B,凱基A級公司債,15,2,13,華南永昌-民權,2024-11-13,9312
2312,金寶,18,6,12,華南永昌-民權,2024-11-13,9312
00687B,國泰20年美債,11,0,11,華南永昌-民權,2024-11-13,9312
0056,元大高股息,11,0,11,華南永昌-民權,2024-11-13,9312
2303,聯電,16,6,10,華南永昌-民權,2024-11-13,9312
00915,凱基優選高股息30,13,3,10,華南永昌-民權,2024-11-13,9312
00795B,中信美國公債20年,10,0,10,華南永昌-民權,2024-11-13,9312
00753L,中信中國50正2,10,0,10,華南永昌-民權,2024-11-13,9312
2109,華豐,10,0,10,華南永昌-民權,2024-11-13,9312
6283,淳安,11,1,10,華南永昌-民權,2024-11-13,9312
8411,福貞-KY,10,0,10,華南永昌-民權,2024-11-13,9312
2615,萬海,10,1,9,華南永昌-民權,2024-11-13,9312
8929,富堡,10,1,9,華南永昌-民權,2024-11-13,9312
00918,大華優利高填息30,8,0,8,華南永昌-民權,2024-11-13,9312
1773,勝一,8,0,8,華南永昌-民權,2024-11-13,9312
3031,佰鴻,8,0,8,華南永昌-民權,2024-11-13,9312
3162,精確,8,0,8,華南永昌-民權,2024-11-13,9312
1717,長興,7,0,7,華南永昌-民權,2024-11-13,9312
2316,楠梓電,13,6,7,華南永昌-民權,2024-11-13,9312
1809,中釉,9,2,7,華南永昌-民權,2024-11-13,9312
5309,系統電,9,2,7,華南永昌-民權,2024-11-13,9312
5386,青雲,17,10,7,華南永昌-民權,2024-11-13,9312
1301,台塑,7,0,7,華南永昌-民權,2024-11-13,9312
2317,鴻海,7,1,6,華南永昌-民權,2024-11-13,9312
3050,鈺德,6,0,6,華南永昌-民權,2024-11-13,9312
5014,建錩,6,0,6,華南永昌-民權,2024-11-13,9312
3583,辛耘,6,0,6,華南永昌-民權,2024-11-13,9312
2353,宏��,6,0,6,華南永昌-民權,2024-11-13,9312
2820,華票,5,0,5,華南永昌-民權,2024-11-13,9312
3356,奇偶,5,0,5,華南永昌-民權,2024-11-13,9312
1321,大洋,5,0,5,華南永昌-民權,2024-11-13,9312
00878,國泰永續高股息,154,0,154,華南永昌-民權,2024-11-14,9312
6116,彩晶,108,0,108,華南永昌-民權,2024-11-14,9312
2101,南港,100,0,100,華南永昌-民權,2024-11-14,9312
1609,大亞,90,0,90,華南永昌-民權,2024-11-14,9312
0056,元大高股息,58,0,58,華南永昌-民權,2024-11-14,9312
00680L,元大美債20正2,53,0,53,華南永昌-民權,2024-11-14,9312
00963,中信全球高股息,50,10,40,華南永昌-民權,2024-11-14,9312
00891,中信關鍵半導體,33,0,33,華南永昌-民權,2024-11-14,9312
2408,南亞科,38,11,27,華南永昌-民權,2024-11-14,9312
9904,寶成,25,0,25,華南永昌-民權,2024-11-14,9312
6790,永豐實,23,0,23,華南永昌-民權,2024-11-14,9312
00713,元大台灣高息低波,20,0,20,華南永昌-民權,2024-11-14,9312
2347,聯強,20,0,20,華南永昌-民權,2024-11-14,9312
00915,凱基優選高股息30,19,0,19,華南永昌-民權,2024-11-14,9312
2409,友達,18,0,18,華南永昌-民權,2024-11-14,9312
2303,聯電,23,6,17,華南永昌-民權,2024-11-14,9312
2891,中信金,15,0,15,華南永昌-民權,2024-11-14,9312
5202,力新,14,0,14,華南永昌-民權,2024-11-14,9312
00946,群益科技高息成長,13,0,13,華南永昌-民權,2024-11-14,9312
1449,佳和,13,0,13,華南永昌-民權,2024-11-14,9312
1524,耿鼎,13,0,13,華南永昌-民權,2024-11-14,9312
00905,FT臺灣Smart,14,2,12,華南永昌-民權,2024-11-14,9312
5426,振發,13,1,12,華南永昌-民權,2024-11-14,9312
00933B,國泰10Y+金融債,11,0,11,華南永昌-民權,2024-11-14,9312
1471,首利,10,0,10,華南永昌-民權,2024-11-14,9312
2516,新建,10,0,10,華南永昌-民權,2024-11-14,9312
2641,正德,10,0,10,華南永昌-民權,2024-11-14,9312
3066,李洲,10,0,10,華南永昌-民權,2024-11-14,9312
3167,大量,10,0,10,華南永昌-民權,2024-11-14,9312
3652,精聯,10,0,10,華南永昌-民權,2024-11-14,9312
3705,永信,10,0,10,華南永昌-民權,2024-11-14,9312
5608,四維航,10,0,10,華南永昌-民權,2024-11-14,9312
2316,楠梓電,9,0,9,華南永昌-民權,2024-11-14,9312
1326,台化,8,0,8,華南永昌-民權,2024-11-14,9312
6695,芯鼎,8,0,8,華南永昌-民權,2024-11-14,9312
1528,恩德,8,1,7,華南永昌-民權,2024-11-14,9312
2328,廣宇,12,5,7,華南永昌-民權,2024-11-14,9312
2349,錸德,10,3,7,華南永昌-民權,2024-11-14,9312
3481,群創,11,4,7,華南永昌-民權,2024-11-14,9312
2884,玉山金,9,2,7,華南永昌-民權,2024-11-14,9312
2834,臺企銀,6,0,6,華南永昌-民權,2024-11-14,9312
1533,車王電,6,0,6,華南永昌-民權,2024-11-14,9312
4167,松瑞藥,6,0,6,華南永昌-民權,2024-11-14,9312
1785,光洋科,10,5,5,華南永昌-民權,2024-11-14,9312
4938,和碩,5,0,5,華南永昌-民權,2024-11-14,9312
1301,台塑,5,0,5,華南永昌-民權,2024-11-14,9312
00932,兆豐永續高息等權,5,0,5,華南永昌-民權,2024-11-14,9312
00951,台新日本半導體,5,0,5,華南永昌-民權,2024-11-14,9312
1321,大洋,5,0,5,華南永昌-民權,2024-11-14,9312
1410,南染,5,0,5,華南永昌-民權,2024-11-14,9312
00878,國泰永續高股息,92,16,76,華南永昌-民權,2024-11-15,9312
00740B,富邦全球投等債,40,0,40,華南永昌-民權,2024-11-15,9312
4905,台聯電,25,0,25,華南永昌-民權,2024-11-15,9312
2887,台新金,24,3,21,華南永昌-民權,2024-11-15,9312
00933B,國泰10Y+金融債,21,0,21,華南永昌-民權,2024-11-15,9312
2498,宏達電,22,1,21,華南永昌-民權,2024-11-15,9312
00943,兆豐電子高息等權,20,0,20,華南永昌-民權,2024-11-15,9312
6190,萬泰科,20,0,20,華南永昌-民權,2024-11-15,9312
8249,菱光,105,85,20,華南永昌-民權,2024-11-15,9312
910861,神州-DR,20,0,20,華南永昌-民權,2024-11-15,9312
6213,聯茂,20,1,19,華南永昌-民權,2024-11-15,9312
0056,元大高股息,17,0,17,華南永昌-民權,2024-11-15,9312
6505,台塑化,16,1,15,華南永昌-民權,2024-11-15,9312
2891,中信金,15,0,15,華南永昌-民權,2024-11-15,9312
2330,台積電,13,0,13,華南永昌-民權,2024-11-15,9312
00932,兆豐永續高息等權,10,0,10,華南永昌-民權,2024-11-15,9312
00916,國泰全球品牌50,10,0,10,華南永昌-民權,2024-11-15,9312
1453,大將,10,0,10,華南永昌-民權,2024-11-15,9312
3042,晶技,10,0,10,華南永昌-民權,2024-11-15,9312
3518,柏騰,10,0,10,華南永昌-民權,2024-11-15,9312
2382,廣達,20,10,10,華南永昌-民權,2024-11-15,9312
2317,鴻海,11,2,9,華南永昌-民權,2024-11-15,9312
2109,華豐,9,1,8,華南永昌-民權,2024-11-15,9312
3706,神達,27,20,7,華南永昌-民權,2024-11-15,9312
00679B,元大美債20年,7,0,7,華南永昌-民權,2024-11-15,9312
3380,明泰,8,1,7,華南永昌-民權,2024-11-15,9312
3551,世禾,9,2,7,華南永昌-民權,2024-11-15,9312
3324,雙鴻,8,1,7,華南永昌-民權,2024-11-15,9312
3625,西勝,7,0,7,華南永昌-民權,2024-11-15,9312
00915,凱基優選高股息30,6,0,6,華南永昌-民權,2024-11-15,9312
1611,中電,6,0,6,華南永昌-民權,2024-11-15,9312
6223,旺矽,8,2,6,華南永昌-民權,2024-11-15,9312
2609,陽明,14,8,6,華南永昌-民權,2024-11-15,9312
1438,三地開發,5,0,5,華南永昌-民權,2024-11-15,9312
2337,旺宏,5,0,5,華南永昌-民權,2024-11-15,9312
3202,樺晟,5,0,5,華南永昌-民權,2024-11-15,9312
4904,遠傳,5,0,5,華南永昌-民權,2024-11-15,9312
4956,光鋐,7,2,5,華南永昌-民權,2024-11-15,9312
6283,淳安,5,0,5,華南永昌-民權,2024-11-15,9312
6443,元晶,5,0,5,華南永昌-民權,2024-11-15,9312
8437,大地-KY,8,3,5,華南永昌-民權,2024-11-15,9312
2324,仁寶,5,1,4,華南永昌-民權,2024-11-15,9312
00937B,群益ESG投等債20,4,0,4,華南永昌-民權,2024-11-15,9312
1616,億泰,4,0,4,華南永昌-民權,2024-11-15,9312
2489,瑞軒,7,3,4,華南永昌-民權,2024-11-15,9312
3149,正達,9,5,4,華南永昌-民權,2024-11-15,9312
4113,聯上,4,0,4,華南永昌-民權,2024-11-15,9312
6770,力積電,5,1,4,華南永昌-民權,2024-11-15,9312
8044,網家,4,0,4,華南永昌-民權,2024-11-15,9312
00731,復華富時高息低波,3,0,3,華南永昌-民權,2024-11-15,9312
1609,大亞,93,5,88,華南永昌-民權,2024-11-18,9312
00878,國泰永續高股息,94,20,74,華南永昌-民權,2024-11-18,9312
4905,台聯電,48,0,48,華南永昌-民權,2024-11-18,9312
5351,鈺創,40,0,40,華南永昌-民權,2024-11-18,9312
3652,精聯,36,4,32,華南永昌-民權,2024-11-18,9312
1210,大成,40,10,30,華南永昌-民權,2024-11-18,9312
2421,建準,25,1,24,華南永昌-民權,2024-11-18,9312
00725B,國泰投資級公司債,22,0,22,華南永昌-民權,2024-11-18,9312
00671R,富邦NASDAQ反1,20,0,20,華南永昌-民權,2024-11-18,9312
0056,元大高股息,18,0,18,華南永昌-民權,2024-11-18,9312
00930,永豐ESG低碳高息,20,3,17,華南永昌-民權,2024-11-18,9312
2353,宏��,26,10,16,華南永昌-民權,2024-11-18,9312
00919,群益台灣精選高息,22,6,16,華南永昌-民權,2024-11-18,9312
2646,星宇航空,15,0,15,華南永昌-民權,2024-11-18,9312
00943,兆豐電子高息等權,14,0,14,華南永昌-民權,2024-11-18,9312
00915,凱基優選高股息30,13,0,13,華南永昌-民權,2024-11-18,9312
5014,建錩,12,0,12,華南永昌-民權,2024-11-18,9312
1227,佳格,10,0,10,華南永昌-民權,2024-11-18,9312
2537,聯上發,11,1,10,華南永昌-民權,2024-11-18,9312
2734,易飛網,10,0,10,華南永昌-民權,2024-11-18,9312
3202,樺晟,10,0,10,華南永昌-民權,2024-11-18,9312
3455,由田,10,0,10,華南永昌-民權,2024-11-18,9312
6414,樺漢,10,0,10,華南永昌-民權,2024-11-18,9312
6456,GIS-KY,10,0,10,華南永昌-民權,2024-11-18,9312
2303,聯電,10,1,9,華南永昌-民權,2024-11-18,9312
2027,大成鋼,8,0,8,華南永昌-民權,2024-11-18,9312
2476,鉅祥,9,1,8,華南永昌-民權,2024-11-18,9312
3081,聯亞,8,0,8,華南永昌-民權,2024-11-18,9312
00713,元大台灣高息低波,8,0,8,華南永昌-民權,2024-11-18,9312
00929,復華台灣科技優息,42,35,7,華南永昌-民權,2024-11-18,9312
2208,台船,6,0,6,華南永昌-民權,2024-11-18,9312
2464,盟立,18,12,6,華南永昌-民權,2024-11-18,9312
2356,英業達,16,10,6,華南永昌-民權,2024-11-18,9312
00731,復華富時高息低波,5,0,5,華南永昌-民權,2024-11-18,9312
00887,永豐中國科技50大,8,3,5,華南永昌-民權,2024-11-18,9312
00885,富邦越南,5,0,5,華南永昌-民權,2024-11-18,9312
2109,華豐,10,5,5,華南永昌-民權,2024-11-18,9312
2481,強茂,5,0,5,華南永昌-民權,2024-11-18,9312
3006,晶豪科,5,0,5,華南永昌-民權,2024-11-18,9312
5426,振發,6,1,5,華南永昌-民權,2024-11-18,9312
6790,永豐實,5,0,5,華南永昌-民權,2024-11-18,9312
2867,三商壽,5,0,5,華南永昌-民權,2024-11-18,9312
2881,富邦金,4,0,4,華南永昌-民權,2024-11-18,9312
2371,大同,4,0,4,華南永昌-民權,2024-11-18,9312
00877,復華中國5G,4,0,4,華南永昌-民權,2024-11-18,9312
2014,中鴻,5,1,4,華南永昌-民權,2024-11-18,9312
2399,映泰,11,7,4,華南永昌-民權,2024-11-18,9312
2610,華航,4,0,4,華南永昌-民權,2024-11-18,9312
2615,萬海,6,2,4,華南永昌-民權,2024-11-18,9312
8028,昇陽半導體,4,0,4,華南永昌-民權,2024-11-18,9312
00877,復華中國5G,100,0,100,華南永昌-民權,2024-11-19,9312
2884,玉山金,45,3,42,華南永昌-民權,2024-11-19,9312
00937B,群益ESG投等債20,30,0,30,華南永昌-民權,2024-11-19,9312
00637L,元大滬深300正2,23,0,23,華南永昌-民權,2024-11-19,9312
2476,鉅祥,22,0,22,華南永昌-民權,2024-11-19,9312
2618,長榮航,25,5,20,華南永昌-民權,2024-11-19,9312
00725B,國泰投資級公司債,20,1,19,華南永昌-民權,2024-11-19,9312
1569,濱川,20,2,18,華南永昌-民權,2024-11-19,9312
2888,新光金,20,2,18,華南永昌-民權,2024-11-19,9312
8104,錸寶,19,1,18,華南永昌-民權,2024-11-19,9312
00878,國泰永續高股息,16,0,16,華南永昌-民權,2024-11-19,9312
2349,錸德,19,5,14,華南永昌-民權,2024-11-19,9312
2027,大成鋼,12,0,12,華南永昌-民權,2024-11-19,9312
2883B,凱基金乙特,12,0,12,華南永昌-民權,2024-11-19,9312
6213,聯茂,11,0,11,華南永昌-民權,2024-11-19,9312
2486,一詮,31,21,10,華南永昌-民權,2024-11-19,9312
0056,元大高股息,11,1,10,華南永昌-民權,2024-11-19,9312
3317,尼克森,10,0,10,華南永昌-民權,2024-11-19,9312
9945,潤泰新,10,0,10,華南永昌-民權,2024-11-19,9312
6805,富世達,8,0,8,華南永昌-民權,2024-11-19,9312
2241,艾姆勒,8,0,8,華南永昌-民權,2024-11-19,9312
4979,華星光,8,0,8,華南永昌-民權,2024-11-19,9312
6405,悅城,10,2,8,華南永昌-民權,2024-11-19,9312
00713,元大台灣高息低波,7,0,7,華南永昌-民權,2024-11-19,9312
2014,中鴻,7,0,7,華南永昌-民權,2024-11-19,9312
2409,友達,7,0,7,華南永昌-民權,2024-11-19,9312
3017,奇鋐,6,0,6,華南永昌-民權,2024-11-19,9312
00915,凱基優選高股息30,7,2,5,華南永昌-民權,2024-11-19,9312
1321,大洋,5,0,5,華南永昌-民權,2024-11-19,9312
00633L,富邦上証正2,5,0,5,華南永昌-民權,2024-11-19,9312
1618,合機,5,0,5,華南永昌-民權,2024-11-19,9312
2455,全新,5,0,5,華南永昌-民權,2024-11-19,9312
3086,華義,5,0,5,華南永昌-民權,2024-11-19,9312
5292,華懋,5,0,5,華南永昌-民權,2024-11-19,9312
2317,鴻海,7,3,4,華南永昌-民權,2024-11-19,9312
3481,群創,7,3,4,華南永昌-民權,2024-11-19,9312
3024,憶聲,4,0,4,華南永昌-民權,2024-11-19,9312
4927,泰鼎-KY,23,19,4,華南永昌-民權,2024-11-19,9312
6182,合晶,6,2,4,華南永昌-民權,2024-11-19,9312
2330,台積電,3,0,3,華南永昌-民權,2024-11-19,9312
00930,永豐ESG低碳高息,3,0,3,華南永昌-民權,2024-11-19,9312
2308,台達電,3,0,3,華南永昌-民權,2024-11-19,9312
2337,旺宏,3,0,3,華南永昌-民權,2024-11-19,9312
3535,晶彩科,3,0,3,華南永昌-民權,2024-11-19,9312
00929,復華台灣科技優息,17,15,2,華南永昌-民權,2024-11-19,9312
6763,綠界科技*,3,1,2,華南永昌-民權,2024-11-19,9312
3231,緯創,24,22,2,華南永昌-民權,2024-11-19,9312
00830,國泰費城半導體,2,0,2,華南永昌-民權,2024-11-19,9312
1301,台塑,3,1,2,華南永昌-民權,2024-11-19,9312
1734,杏輝,2,0,2,華南永昌-民權,2024-11-19,9312
2354,鴻準,84,19,65,華南永昌-民權,2024-11-20,9312
00664R,國泰臺灣加權反1,50,0,50,華南永昌-民權,2024-11-20,9312
6405,悅城,50,0,50,華南永昌-民權,2024-11-20,9312
2330,台積電,58,11,47,華南永昌-民權,2024-11-20,9312
2303,聯電,38,0,38,華南永昌-民權,2024-11-20,9312
00937B,群益ESG投等債20,30,1,29,華南永昌-民權,2024-11-20,9312
00930,永豐ESG低碳高息,25,0,25,華南永昌-民權,2024-11-20,9312
8039,台虹,25,3,22,華南永昌-民權,2024-11-20,9312
1210,大成,30,10,20,華南永昌-民權,2024-11-20,9312
2467,志聖,20,0,20,華南永昌-民權,2024-11-20,9312
00942B,台新美A公司債20+,22,2,20,華南永昌-民權,2024-11-20,9312
00725B,國泰投資級公司債,18,0,18,華南永昌-民權,2024-11-20,9312
3049,精金,20,3,17,華南永昌-民權,2024-11-20,9312
2603,長榮,26,12,14,華南永昌-民權,2024-11-20,9312
00927,群益半導體收益,14,0,14,華南永昌-民權,2024-11-20,9312
5014,建錩,13,0,13,華南永昌-民權,2024-11-20,9312
2392,正崴,11,1,10,華南永昌-民權,2024-11-20,9312
00959B,大華投等美債15Y+,10,0,10,華南永昌-民權,2024-11-20,9312
6235,華孚,10,0,10,華南永昌-民權,2024-11-20,9312
6443,元晶,10,0,10,華南永昌-民權,2024-11-20,9312
8261,富鼎,11,1,10,華南永昌-民權,2024-11-20,9312
2460,建通,11,2,9,華南永昌-民權,2024-11-20,9312
0056,元大高股息,8,0,8,華南永昌-民權,2024-11-20,9312
00929,復華台灣科技優息,23,15,8,華南永昌-民權,2024-11-20,9312
4113,聯上,10,2,8,華南永昌-民權,2024-11-20,9312
3021,鴻名,8,1,7,華南永昌-民權,2024-11-20,9312
3032,偉訓,50,43,7,華南永昌-民權,2024-11-20,9312
3290,東浦,7,0,7,華南永昌-民權,2024-11-20,9312
2317,鴻海,8,2,6,華南永昌-民權,2024-11-20,9312
006208,富邦台50,6,0,6,華南永昌-民權,2024-11-20,9312
2353,宏��,31,25,6,華南永昌-民權,2024-11-20,9312
00713,元大台灣高息低波,5,0,5,華南永昌-民權,2024-11-20,9312
00712,復華富時不動產,5,0,5,華南永昌-民權,2024-11-20,9312
1321,大洋,5,0,5,華南永昌-民權,2024-11-20,9312
2630,亞航,5,0,5,華南永昌-民權,2024-11-20,9312
3607,谷崧,5,0,5,華南永昌-民權,2024-11-20,9312
4714,永捷,5,0,5,華南永昌-民權,2024-11-20,9312
6488,環球晶,6,1,5,華南永昌-民權,2024-11-20,9312
2449,京元電子,8,4,4,華南永昌-民權,2024-11-20,9312
1449,佳和,4,0,4,華南永昌-民權,2024-11-20,9312
2027,大成鋼,4,0,4,華南永昌-民權,2024-11-20,9312
2337,旺宏,4,0,4,華南永昌-民權,2024-11-20,9312
2408,南亞科,4,0,4,華南永昌-民權,2024-11-20,9312
4109,加捷生醫,4,0,4,華南永昌-民權,2024-11-20,9312
6558,興能高,4,0,4,華南永昌-民權,2024-11-20,9312
9945,潤泰新,4,0,4,華南永昌-民權,2024-11-20,9312
3293,鈊象,3,0,3,華南永昌-民權,2024-11-20,9312
2356,英業達,19,16,3,華南永昌-民權,2024-11-20,9312
5871,中租-KY,3,0,3,華南永昌-民權,2024-11-20,9312
00895,富邦未來車,4,1,3,華南永昌-民權,2024-11-20,9312
00878,國泰永續高股息,47,1,46,華南永昌-民權,2024-11-21,9312
5386,青雲,42,1,41,華南永昌-民權,2024-11-21,9312
00932,兆豐永續高息等權,24,0,24,華南永昌-民權,2024-11-21,9312
2344,華邦電,23,2,21,華南永昌-民權,2024-11-21,9312
2109,華豐,17,0,17,華南永昌-民權,2024-11-21,9312
2330,台積電,17,1,16,華南永昌-民權,2024-11-21,9312
2353,宏��,19,4,15,華南永昌-民權,2024-11-21,9312
2356,英業達,34,20,14,華南永昌-民權,2024-11-21,9312
2317,鴻海,15,3,12,華南永昌-民權,2024-11-21,9312
1321,大洋,10,0,10,華南永昌-民權,2024-11-21,9312
2888,新光金,10,0,10,華南永昌-民權,2024-11-21,9312
2891,中信金,10,0,10,華南永昌-民權,2024-11-21,9312
3338,泰碩,10,0,10,華南永昌-民權,2024-11-21,9312
8421,旭源,10,0,10,華南永昌-民權,2024-11-21,9312
2303,聯電,11,3,8,華南永昌-民權,2024-11-21,9312
8104,錸寶,15,8,7,華南永昌-民權,2024-11-21,9312
8032,光菱,9,2,7,華南永昌-民權,2024-11-21,9312
4763,材料-KY,7,0,7,華南永昌-民權,2024-11-21,9312
3013,晟銘電,6,0,6,華南永昌-民權,2024-11-21,9312
2882,國泰金,6,0,6,華南永昌-民權,2024-11-21,9312
0050,元大台灣50,5,0,5,華南永昌-民權,2024-11-21,9312
1301,台塑,5,0,5,華南永昌-民權,2024-11-21,9312
1101,台泥,5,0,5,華南永昌-民權,2024-11-21,9312
2467,志聖,5,0,5,華南永昌-民權,2024-11-21,9312
2886,兆豐金,5,0,5,華南永昌-民權,2024-11-21,9312
3615,安可,5,0,5,華南永昌-民權,2024-11-21,9312
3711,日月光投控,5,0,5,華南永昌-民權,2024-11-21,9312
6790,永豐實,5,0,5,華南永昌-民權,2024-11-21,9312
8374,羅昇,5,0,5,華南永昌-民權,2024-11-21,9312
006208,富邦台50,5,0,5,華南永昌-民權,2024-11-21,9312
2204,中華,14,10,4,華南永昌-民權,2024-11-21,9312
4905,台聯電,4,0,4,華南永昌-民權,2024-11-21,9312
6282,康舒,11,7,4,華南永昌-民權,2024-11-21,9312
2349,錸德,14,10,4,華南永昌-民權,2024-11-21,9312
00919,群益台灣精選高息,4,1,3,華南永昌-民權,2024-11-21,9312
2618,長榮航,3,0,3,華南永昌-民權,2024-11-21,9312
0056,元大高股息,4,1,3,華南永昌-民權,2024-11-21,9312
1303,南亞,3,0,3,華南永昌-民權,2024-11-21,9312
2002,中鋼,3,0,3,華南永昌-民權,2024-11-21,9312
2413,環科,4,1,3,華南永昌-民權,2024-11-21,9312
3209,全科,3,0,3,華南永昌-民權,2024-11-21,9312
3447,展達,3,0,3,華南永昌-民權,2024-11-21,9312
3576,聯合再生,3,0,3,華南永昌-民權,2024-11-21,9312
4971,IET-KY,11,8,3,華南永昌-民權,2024-11-21,9312
2890,永豐金,3,0,3,華南永昌-民權,2024-11-21,9312
6770,力積電,2,0,2,華南永昌-民權,2024-11-21,9312
00679B,元大美債20年,2,0,2,華南永昌-民權,2024-11-21,9312
00895,富邦未來車,2,0,2,華南永昌-民權,2024-11-21,9312
00939,統一台灣高息動能,2,0,2,華南永昌-民權,2024-11-21,9312
00951,台新日本半導體,2,0,2,華南永昌-民權,2024-11-21,9312
00664R,國泰臺灣加權反1,100,0,100,華南永昌-民權,2024-11-22,9312
2356,英業達,113,24,89,華南永昌-民權,2024-11-22,9312
00637L,元大滬深300正2,64,12,52,華南永昌-民權,2024-11-22,9312
2867,三商壽,32,11,21,華南永昌-民權,2024-11-22,9312
8163,達方,48,30,18,華南永昌-民權,2024-11-22,9312
00878,國泰永續高股息,14,0,14,華南永昌-民權,2024-11-22,9312
9105,泰金寶-DR,109,95,14,華南永昌-民權,2024-11-22,9312
2349,錸德,13,0,13,華南永昌-民權,2024-11-22,9312
4956,光鋐,33,20,13,華南永昌-民權,2024-11-22,9312
00932,兆豐永續高息等權,11,0,11,華南永昌-民權,2024-11-22,9312
00959B,大華投等美債15Y+,10,0,10,華南永昌-民權,2024-11-22,9312
2332,友訊,10,0,10,華南永昌-民權,2024-11-22,9312
3625,西勝,9,0,9,華南永昌-民權,2024-11-22,9312
4927,泰鼎-KY,12,3,9,華南永昌-民權,2024-11-22,9312
6127,九豪,10,1,9,華南永昌-民權,2024-11-22,9312
2449,京元電子,15,6,9,華南永昌-民權,2024-11-22,9312
3323,加百裕,16,8,8,華南永昌-民權,2024-11-22,9312
3706,神達,60,54,6,華南永昌-民權,2024-11-22,9312
2399,映泰,6,0,6,華南永昌-民權,2024-11-22,9312
3552,同致,6,0,6,華南永昌-民權,2024-11-22,9312
5014,建錩,6,0,6,華南永昌-民權,2024-11-22,9312
2486,一詮,6,0,6,華南永昌-民權,2024-11-22,9312
2317,鴻海,8,2,6,華南永昌-民權,2024-11-22,9312
6176,瑞儀,5,0,5,華南永昌-民權,2024-11-22,9312
00943,兆豐電子高息等權,5,0,5,華南永昌-民權,2024-11-22,9312
1618,合機,5,0,5,華南永昌-民權,2024-11-22,9312
1717,長興,5,0,5,華南永昌-民權,2024-11-22,9312
1789,神隆,5,0,5,華南永昌-民權,2024-11-22,9312
2405,輔信,5,0,5,華南永昌-民權,2024-11-22,9312
3049,精金,5,0,5,華南永昌-民權,2024-11-22,9312
3419,譁裕,7,2,5,華南永昌-民權,2024-11-22,9312
5426,振發,8,3,5,華南永昌-民權,2024-11-22,9312
6139,亞翔,5,0,5,華南永昌-民權,2024-11-22,9312
6282,康舒,6,1,5,華南永昌-民權,2024-11-22,9312
8421,旭源,5,0,5,華南永昌-民權,2024-11-22,9312
912000,晨訊科-DR,5,0,5,華南永昌-民權,2024-11-22,9312
00915,凱基優選高股息30,4,0,4,華南永昌-民權,2024-11-22,9312
3501,維熹,4,0,4,華南永昌-民權,2024-11-22,9312
5876,上海商銀,4,0,4,華南永昌-民權,2024-11-22,9312
9941,裕融,4,0,4,華南永昌-民權,2024-11-22,9312
2609,陽明,25,21,4,華南永昌-民權,2024-11-22,9312
2615,萬海,6,3,3,華南永昌-民權,2024-11-22,9312
2303,聯電,4,1,3,華南永昌-民權,2024-11-22,9312
3665,貿聯-KY,4,1,3,華南永昌-民權,2024-11-22,9312
1536,和大,3,0,3,華南永昌-民權,2024-11-22,9312
1449,佳和,8,5,3,華南永昌-民權,2024-11-22,9312
2476,鉅祥,3,0,3,華南永昌-民權,2024-11-22,9312
2641,正德,3,0,3,華南永昌-民權,2024-11-22,9312
3211,順達,4,1,3,華南永昌-民權,2024-11-22,9312
3564,其陽,3,0,3,華南永昌-民權,2024-11-22,9312
00664R,國泰臺灣加權反1,549,50,499,華南永昌-民權,2024-11-25,9312
00877,復華中國5G,300,0,300,華南永昌-民權,2024-11-25,9312
5483,中美晶,205,10,195,華南永昌-民權,2024-11-25,9312
00919,群益台灣精選高息,124,0,124,華南永昌-民權,2024-11-25,9312
2324,仁寶,100,32,68,華南永昌-民權,2024-11-25,9312
6288,聯嘉,69,5,64,華南永昌-民權,2024-11-25,9312
9105,泰金寶-DR,71,9,62,華南永昌-民權,2024-11-25,9312
2330,台積電,115,80,35,華南永昌-民權,2024-11-25,9312
3625,西勝,29,0,29,華南永昌-民權,2024-11-25,9312
00708L,期元大S＆P黃金正2,25,0,25,華南永昌-民權,2024-11-25,9312
2603,長榮,40,19,21,華南永昌-民權,2024-11-25,9312
00930,永豐ESG低碳高息,21,0,21,華南永昌-民權,2024-11-25,9312
2618,長榮航,31,11,20,華南永昌-民權,2024-11-25,9312
3652,精聯,20,0,20,華南永昌-民權,2024-11-25,9312
6405,悅城,20,0,20,華南永昌-民權,2024-11-25,9312
5243,乙盛-KY,20,1,19,華南永昌-民權,2024-11-25,9312
1101,台泥,18,2,16,華南永昌-民權,2024-11-25,9312
4744,皇將,24,8,16,華南永昌-民權,2024-11-25,9312
1210,大成,15,0,15,華南永昌-民權,2024-11-25,9312
2429,銘旺科,15,0,15,華南永昌-民權,2024-11-25,9312
9904,寶成,20,6,14,華南永昌-民權,2024-11-25,9312
00637L,元大滬深300正2,23,10,13,華南永昌-民權,2024-11-25,9312
2520,冠德,12,0,12,華南永昌-民權,2024-11-25,9312
2367,燿華,10,0,10,華南永昌-民權,2024-11-25,9312
2332,友訊,20,10,10,華南永昌-民權,2024-11-25,9312
2903,遠百,11,1,10,華南永昌-民權,2024-11-25,9312
3346,麗清,10,0,10,華南永昌-民權,2024-11-25,9312
3607,谷崧,10,0,10,華南永昌-民權,2024-11-25,9312
5475,德宏,10,0,10,華南永昌-民權,2024-11-25,9312
6584,南俊國際,10,0,10,華南永昌-民權,2024-11-25,9312
2425,承啟,9,0,9,華南永昌-民權,2024-11-25,9312
00878,國泰永續高股息,7,0,7,華南永昌-民權,2024-11-25,9312
2344,華邦電,8,1,7,華南永昌-民權,2024-11-25,9312
00950B,凱基A級公司債,10,4,6,華南永昌-民權,2024-11-25,9312
2889,國票金,6,0,6,華南永昌-民權,2024-11-25,9312
3362,先進光,6,0,6,華南永昌-民權,2024-11-25,9312
8261,富鼎,12,6,6,華南永昌-民權,2024-11-25,9312
8942,森鉅,6,0,6,華南永昌-民權,2024-11-25,9312
2312,金寶,43,37,6,華南永昌-民權,2024-11-25,9312
3714,富采,5,0,5,華南永昌-民權,2024-11-25,9312
00955,中信日本商社,5,0,5,華南永昌-民權,2024-11-25,9312
00882,中信中國高股息,5,0,5,華南永昌-民權,2024-11-25,9312
1304,台聚,5,0,5,華南永昌-民權,2024-11-25,9312
1808,潤隆,5,0,5,華南永昌-民權,2024-11-25,9312
3027,盛達,5,0,5,華南永昌-民權,2024-11-25,9312
3032,偉訓,8,3,5,華南永昌-民權,2024-11-25,9312
4906,正文,5,0,5,華南永昌-民權,2024-11-25,9312
4987,科誠,5,0,5,華南永昌-民權,2024-11-25,9312
8421,旭源,5,0,5,華南永昌-民權,2024-11-25,9312
1303,南亞,6,2,4,華南永昌-民權,2024-11-25,9312
5483,中美晶,460,300,160,華南永昌-民權,2024-11-26,9312
2330,台積電,201,95,106,華南永昌-民權,2024-11-26,9312
00740B,富邦全球投等債,73,0,73,華南永昌-民權,2024-11-26,9312
2317,鴻海,24,1,23,華南永昌-民權,2024-11-26,9312
1815,富喬,32,13,19,華南永昌-民權,2024-11-26,9312
2419,仲琦,22,7,15,華南永昌-民權,2024-11-26,9312
6488,環球晶,15,1,14,華南永昌-民權,2024-11-26,9312
2392,正崴,32,19,13,華南永昌-民權,2024-11-26,9312
6152,百一,12,0,12,華南永昌-民權,2024-11-26,9312
2887,台新金,11,0,11,華南永昌-民權,2024-11-26,9312
6227,茂綸,11,0,11,華南永昌-民權,2024-11-26,9312
00878,國泰永續高股息,11,1,10,華南永昌-民權,2024-11-26,9312
2834,臺企銀,10,0,10,華南永昌-民權,2024-11-26,9312
2515,中工,10,0,10,華南永昌-民權,2024-11-26,9312
3652,精聯,10,0,10,華南永昌-民權,2024-11-26,9312
8163,達方,20,10,10,華南永昌-民權,2024-11-26,9312
6279,胡連,10,0,10,華南永昌-民權,2024-11-26,9312
1727,中華化,9,0,9,華南永昌-民權,2024-11-26,9312
2615,萬海,17,9,8,華南永昌-民權,2024-11-26,9312
2409,友達,8,0,8,華南永昌-民權,2024-11-26,9312
3231,緯創,18,10,8,華南永昌-民權,2024-11-26,9312
2204,中華,12,5,7,華南永昌-民權,2024-11-26,9312
00951,台新日本半導體,7,0,7,華南永昌-民權,2024-11-26,9312
1795,美時,8,1,7,華南永昌-民權,2024-11-26,9312
3625,西勝,18,11,7,華南永昌-民權,2024-11-26,9312
6806,森崴能源,8,1,7,華南永昌-民權,2024-11-26,9312
3576,聯合再生,7,0,7,華南永昌-民權,2024-11-26,9312
00715L,期街口布蘭特正2,6,0,6,華南永昌-民權,2024-11-26,9312
3363,上詮,12,6,6,華南永昌-民權,2024-11-26,9312
3706,神達,9,3,6,華南永昌-民權,2024-11-26,9312
1802,台玻,5,0,5,華南永昌-民權,2024-11-26,9312
3066,李洲,5,0,5,華南永昌-民權,2024-11-26,9312
3607,谷崧,5,0,5,華南永昌-民權,2024-11-26,9312
8437,大地-KY,5,0,5,華南永昌-民權,2024-11-26,9312
00929,復華台灣科技優息,6,2,4,華南永昌-民權,2024-11-26,9312
00919,群益台灣精選高息,7,3,4,華南永昌-民權,2024-11-26,9312
00915,凱基優選高股息30,4,0,4,華南永昌-民權,2024-11-26,9312
00955,中信日本商社,4,0,4,華南永昌-民權,2024-11-26,9312
2344,華邦電,9,5,4,華南永昌-民權,2024-11-26,9312
2374,佳能,4,0,4,華南永昌-民權,2024-11-26,9312
2543,皇昌,5,1,4,華南永昌-民權,2024-11-26,9312
5309,系統電,8,4,4,華南永昌-民權,2024-11-26,9312
9904,寶成,5,1,4,華南永昌-民權,2024-11-26,9312
1785,光洋科,3,0,3,華南永昌-民權,2024-11-26,9312
1524,耿鼎,4,1,3,華南永昌-民權,2024-11-26,9312
2408,南亞科,10,7,3,華南永昌-民權,2024-11-26,9312
2547,日勝生,4,1,3,華南永昌-民權,2024-11-26,9312
3665,貿聯-KY,3,0,3,華南永昌-民權,2024-11-26,9312
8234,新漢,3,0,3,華南永昌-民權,2024-11-26,9312
9934,成霖,3,0,3,華南永昌-民權,2024-11-26,9312
00918,大華優利高填息30,107,6,101,華南永昌-民權,2024-11-27,9312
1609,大亞,87,4,83,華南永昌-民權,2024-11-27,9312
00878,國泰永續高股息,76,2,74,華南永昌-民權,2024-11-27,9312
0056,元大高股息,74,0,74,華南永昌-民權,2024-11-27,9312
2887,台新金,66,30,36,華南永昌-民權,2024-11-27,9312
2303,聯電,38,10,28,華南永昌-民權,2024-11-27,9312
2317,鴻海,31,6,25,華南永昌-民權,2024-11-27,9312
1815,富喬,41,16,25,華南永昌-民權,2024-11-27,9312
00951,台新日本半導體,20,0,20,華南永昌-民權,2024-11-27,9312
2324,仁寶,20,0,20,華南永昌-民權,2024-11-27,9312
2353,宏��,20,0,20,華南永昌-民權,2024-11-27,9312
1536,和大,41,23,18,華南永昌-民權,2024-11-27,9312
2332,友訊,53,35,18,華南永昌-民權,2024-11-27,9312
2344,華邦電,21,4,17,華南永昌-民權,2024-11-27,9312
3231,緯創,28,12,16,華南永昌-民權,2024-11-27,9312
00929,復華台灣科技優息,27,11,16,華南永昌-民權,2024-11-27,9312
2355,敬鵬,15,0,15,華南永昌-民權,2024-11-27,9312
4905,台聯電,15,0,15,華南永昌-民權,2024-11-27,9312
5488,松普,15,0,15,華南永昌-民權,2024-11-27,9312
5531,鄉林,15,0,15,華南永昌-民權,2024-11-27,9312
3652,精聯,14,0,14,華南永昌-民權,2024-11-27,9312
3264,欣銓,11,0,11,華南永昌-民權,2024-11-27,9312
2002,中鋼,10,0,10,華南永昌-民權,2024-11-27,9312
3455,由田,10,0,10,華南永昌-民權,2024-11-27,9312
6279,胡連,10,0,10,華南永昌-民權,2024-11-27,9312
6290,良維,10,0,10,華南永昌-民權,2024-11-27,9312
2204,中華,11,2,9,華南永昌-民權,2024-11-27,9312
2367,燿華,10,1,9,華南永昌-民權,2024-11-27,9312
2426,鼎元,21,12,9,華南永昌-民權,2024-11-27,9312
4977,眾達-KY,8,0,8,華南永昌-民權,2024-11-27,9312
6505,台塑化,8,0,8,華南永昌-民權,2024-11-27,9312
2382,廣達,8,1,7,華南永昌-民權,2024-11-27,9312
00946,群益科技高息成長,7,0,7,華南永昌-民權,2024-11-27,9312
00887,永豐中國科技50大,7,0,7,華南永昌-民權,2024-11-27,9312
2408,南亞科,10,3,7,華南永昌-民權,2024-11-27,9312
4109,加捷生醫,7,0,7,華南永昌-民權,2024-11-27,9312
00922,國泰台灣領袖50,6,0,6,華南永昌-民權,2024-11-27,9312
1301,台塑,6,0,6,華南永昌-民權,2024-11-27,9312
2376,技嘉,7,1,6,華南永昌-民權,2024-11-27,9312
3019,亞光,7,1,6,華南永昌-民權,2024-11-27,9312
9105,泰金寶-DR,8,2,6,華南永昌-民權,2024-11-27,9312
2892,第一金,6,0,6,華南永昌-民權,2024-11-27,9312
4707,磐亞,6,0,6,華南永昌-民權,2024-11-27,9312
4526,東台,22,16,6,華南永昌-民權,2024-11-27,9312
1524,耿鼎,6,0,6,華南永昌-民權,2024-11-27,9312
00930,永豐ESG低碳高息,10,5,5,華南永昌-民權,2024-11-27,9312
00632R,元大台灣50反1,10,5,5,華南永昌-民權,2024-11-27,9312
1569,濱川,5,0,5,華南永昌-民權,2024-11-27,9312
2527,宏璟,5,0,5,華南永昌-民權,2024-11-27,9312
3049,精金,5,0,5,華南永昌-民權,2024-11-27,9312
2887,台新金,152,0,152,華南永昌-民權,2024-11-28,9312
2324,仁寶,165,55,110,華南永昌-民權,2024-11-28,9312
2367,燿華,63,0,63,華南永昌-民權,2024-11-28,9312
00940,元大台灣價值高息,61,0,61,華南永昌-民權,2024-11-28,9312
00878,國泰永續高股息,60,0,60,華南永昌-民權,2024-11-28,9312
2312,金寶,142,90,52,華南永昌-民權,2024-11-28,9312
2449,京元電子,50,0,50,華南永昌-民權,2024-11-28,9312
00919,群益台灣精選高息,63,23,40,華南永昌-民權,2024-11-28,9312
00953B,群益優選非投等債,38,0,38,華南永昌-民權,2024-11-28,9312
2354,鴻準,46,13,33,華南永昌-民權,2024-11-28,9312
00715L,期街口布蘭特正2,32,0,32,華南永昌-民權,2024-11-28,9312
1569,濱川,36,10,26,華南永昌-民權,2024-11-28,9312
2344,華邦電,24,2,22,華南永昌-民權,2024-11-28,9312
0056,元大高股息,22,0,22,華南永昌-民權,2024-11-28,9312
00915,凱基優選高股息30,18,0,18,華南永昌-民權,2024-11-28,9312
00946,群益科技高息成長,17,0,17,華南永昌-民權,2024-11-28,9312
2929,淘帝-KY,18,2,16,華南永昌-民權,2024-11-28,9312
8240,華宏,16,0,16,華南永昌-民權,2024-11-28,9312
2883B,凱基金乙特,15,0,15,華南永昌-民權,2024-11-28,9312
2419,仲琦,15,1,14,華南永昌-民權,2024-11-28,9312
1210,大成,12,0,12,華南永昌-民權,2024-11-28,9312
4510,高鋒,35,24,11,華南永昌-民權,2024-11-28,9312
9105,泰金寶-DR,35,24,11,華南永昌-民權,2024-11-28,9312
00882,中信中國高股息,10,0,10,華南永昌-民權,2024-11-28,9312
1314,中石化,10,0,10,華南永昌-民權,2024-11-28,9312
2353,宏��,10,0,10,華南永昌-民權,2024-11-28,9312
4906,正文,10,0,10,華南永昌-民權,2024-11-28,9312
1609,大亞,18,9,9,華南永昌-民權,2024-11-28,9312
2615,萬海,12,3,9,華南永昌-民權,2024-11-28,9312
2444,兆勁,9,0,9,華南永昌-民權,2024-11-28,9312
4760,勤凱,9,0,9,華南永昌-民權,2024-11-28,9312
4967,十銓,11,2,9,華南永昌-民權,2024-11-28,9312
3665,貿聯-KY,8,0,8,華南永昌-民權,2024-11-28,9312
00930,永豐ESG低碳高息,10,2,8,華南永昌-民權,2024-11-28,9312
1815,富喬,31,23,8,華南永昌-民權,2024-11-28,9312
2002,中鋼,9,2,7,華南永昌-民權,2024-11-28,9312
6288,聯嘉,33,26,7,華南永昌-民權,2024-11-28,9312
00713,元大台灣高息低波,6,0,6,華南永昌-民權,2024-11-28,9312
6163,華電網,6,0,6,華南永昌-民權,2024-11-28,9312
6488,環球晶,6,0,6,華南永昌-民權,2024-11-28,9312
2392,正崴,9,3,6,華南永昌-民權,2024-11-28,9312
3711,日月光投控,5,0,5,華南永昌-民權,2024-11-28,9312
00887,永豐中國科技50大,5,0,5,華南永昌-民權,2024-11-28,9312
1301,台塑,5,0,5,華南永昌-民權,2024-11-28,9312
1708,東鹼,6,1,5,華南永昌-民權,2024-11-28,9312
2409,友達,5,0,5,華南永昌-民權,2024-11-28,9312
6509,聚和,5,0,5,華南永昌-民權,2024-11-28,9312
8467,波力-KY,5,0,5,華南永昌-民權,2024-11-28,9312
4960,誠美材,4,0,4,華南永昌-民權,2024-11-28,9312
5309,系統電,80,76,4,華南永昌-民權,2024-11-28,9312
2618,長榮航,21,0,21,華南永昌-民權,2024-11-29,9312
2834,臺企銀,20,0,20,華南永昌-民權,2024-11-29,9312
3597,映興,16,0,16,華南永昌-民權,2024-11-29,9312
00929,復華台灣科技優息,15,0,15,華南永昌-民權,2024-11-29,9312
2344,華邦電,13,0,13,華南永昌-民權,2024-11-29,9312
2002,中鋼,12,1,11,華南永昌-民權,2024-11-29,9312
6505,台塑化,11,0,11,華南永昌-民權,2024-11-29,9312
00918,大華優利高填息30,11,0,11,華南永昌-民權,2024-11-29,9312
0056,元大高股息,11,0,11,華南永昌-民權,2024-11-29,9312
5871,中租-KY,11,1,10,華南永昌-民權,2024-11-29,9312
6142,友勁,10,0,10,華南永昌-民權,2024-11-29,9312
2330,台積電,9,0,9,華南永昌-民權,2024-11-29,9312
00675L,富邦臺灣加權正2,8,0,8,華南永昌-民權,2024-11-29,9312
00713,元大台灣高息低波,8,0,8,華南永昌-民權,2024-11-29,9312
1301,台塑,9,1,8,華南永昌-民權,2024-11-29,9312
00919,群益台灣精選高息,7,0,7,華南永昌-民權,2024-11-29,9312
00940,元大台灣價值高息,117,110,7,華南永昌-民權,2024-11-29,9312
2615,萬海,12,5,7,華南永昌-民權,2024-11-29,9312
2540,愛山林,7,0,7,華南永昌-民權,2024-11-29,9312
00878,國泰永續高股息,16,10,6,華南永昌-民權,2024-11-29,9312
6770,力積電,6,0,6,華南永昌-民權,2024-11-29,9312
00905,FT臺灣Smart,6,0,6,華南永昌-民權,2024-11-29,9312
00891,中信關鍵半導體,6,0,6,華南永昌-民權,2024-11-29,9312
4967,十銓,6,0,6,華南永昌-民權,2024-11-29,9312
2881,富邦金,6,0,6,華南永昌-民權,2024-11-29,9312
2317,鴻海,8,3,5,華南永昌-民權,2024-11-29,9312
2609,陽明,8,3,5,華南永昌-民權,2024-11-29,9312
1326,台化,5,0,5,華南永昌-民權,2024-11-29,9312
00881,國泰台灣5G+,5,0,5,華南永昌-民權,2024-11-29,9312
1449,佳和,5,0,5,華南永昌-民權,2024-11-29,9312
2405,輔信,5,0,5,華南永昌-民權,2024-11-29,9312
6191,精成科,5,0,5,華南永昌-民權,2024-11-29,9312
6509,聚和,5,0,5,華南永昌-民權,2024-11-29,9312
8163,達方,6,1,5,華南永昌-民權,2024-11-29,9312
9105,泰金寶-DR,11,6,5,華南永昌-民權,2024-11-29,9312
2303,聯電,6,2,4,華南永昌-民權,2024-11-29,9312
2408,南亞科,9,5,4,華南永昌-民權,2024-11-29,9312
3511,矽瑪,15,11,4,華南永昌-民權,2024-11-29,9312
3652,精聯,4,0,4,華南永昌-民權,2024-11-29,9312
2891,中信金,6,2,4,華南永昌-民權,2024-11-29,9312
00915,凱基優選高股息30,13,10,3,華南永昌-民權,2024-11-29,9312
00922,國泰台灣領袖50,3,0,3,華南永昌-民權,2024-11-29,9312
1210,大成,3,0,3,華南永昌-民權,2024-11-29,9312
00930,永豐ESG低碳高息,3,0,3,華南永昌-民權,2024-11-29,9312
2426,鼎元,5,2,3,華南永昌-民權,2024-11-29,9312
2442,新美齊,3,0,3,華南永昌-民權,2024-11-29,9312
4905,台聯電,3,0,3,華南永昌-民權,2024-11-29,9312
5880,合庫金,3,0,3,華南永昌-民權,2024-11-29,9312
8478,東哥遊艇,3,0,3,華南永昌-民權,2024-11-29,9312
2633,台灣高鐵,2,0,2,華南永昌-民權,2024-11-29,9312
00664R,國泰臺灣加權反1,50,0,50,華南永昌-民權,2024-12-02,9312
2305,全友,50,0,50,華南永昌-民權,2024-12-02,9312
00878,國泰永續高股息,53,11,42,華南永昌-民權,2024-12-02,9312
1609,大亞,42,0,42,華南永昌-民權,2024-12-02,9312
2884,玉山金,40,0,40,華南永昌-民權,2024-12-02,9312
1326,台化,30,0,30,華南永昌-民權,2024-12-02,9312
00961,FT臺灣永續高息,25,0,25,華南永昌-民權,2024-12-02,9312
00918,大華優利高填息30,35,10,25,華南永昌-民權,2024-12-02,9312
4729,熒茂,20,0,20,華南永昌-民權,2024-12-02,9312
6405,悅城,21,1,20,華南永昌-民權,2024-12-02,9312
3652,精聯,17,0,17,華南永昌-民權,2024-12-02,9312
00945B,凱基美國非投等債,20,4,16,華南永昌-民權,2024-12-02,9312
2354,鴻準,22,7,15,華南永昌-民權,2024-12-02,9312
2312,金寶,21,8,13,華南永昌-民權,2024-12-02,9312
00915,凱基優選高股息30,13,2,11,華南永昌-民權,2024-12-02,9312
0056,元大高股息,13,2,11,華南永昌-民權,2024-12-02,9312
2891,中信金,45,34,11,華南永昌-民權,2024-12-02,9312
4927,泰鼎-KY,25,15,10,華南永昌-民權,2024-12-02,9312
2399,映泰,10,0,10,華南永昌-民權,2024-12-02,9312
3264,欣銓,10,0,10,華南永昌-民權,2024-12-02,9312
3481,群創,10,0,10,華南永昌-民權,2024-12-02,9312
4909,新復興,11,1,10,華南永昌-民權,2024-12-02,9312
1605,華新,9,0,9,華南永昌-民權,2024-12-02,9312
1540,喬福,10,1,9,華南永昌-民權,2024-12-02,9312
3090,日電貿,10,1,9,華南永昌-民權,2024-12-02,9312
4123,晟德,11,3,8,華南永昌-民權,2024-12-02,9312
1536,和大,8,0,8,華南永昌-民權,2024-12-02,9312
6127,九豪,50,42,8,華南永昌-民權,2024-12-02,9312
2317,鴻海,10,3,7,華南永昌-民權,2024-12-02,9312
3003,健和興,7,0,7,華南永昌-民權,2024-12-02,9312
3025,星通,12,6,6,華南永昌-民權,2024-12-02,9312
3591,艾笛森,6,0,6,華南永昌-民權,2024-12-02,9312
5309,系統電,8,2,6,華南永昌-民權,2024-12-02,9312
00632R,元大台灣50反1,5,0,5,華南永昌-民權,2024-12-02,9312
1210,大成,5,0,5,華南永昌-民權,2024-12-02,9312
2349,錸德,5,0,5,華南永昌-民權,2024-12-02,9312
2351,順德,5,0,5,華南永昌-民權,2024-12-02,9312
4905,台聯電,5,0,5,華南永昌-民權,2024-12-02,9312
5864,致和證,8,3,5,華南永昌-民權,2024-12-02,9312
6288,聯嘉,9,4,5,華南永昌-民權,2024-12-02,9312
00891,中信關鍵半導體,5,0,5,華南永昌-民權,2024-12-02,9312
2382,廣達,5,0,5,華南永昌-民權,2024-12-02,9312
1314,中石化,4,0,4,華南永昌-民權,2024-12-02,9312
2002,中鋼,4,0,4,華南永昌-民權,2024-12-02,9312
2302,麗正,5,1,4,華南永昌-民權,2024-12-02,9312
2392,正崴,4,0,4,華南永昌-民權,2024-12-02,9312
2409,友達,5,1,4,華南永昌-民權,2024-12-02,9312
2929,淘帝-KY,6,2,4,華南永昌-民權,2024-12-02,9312
3037,欣興,4,0,4,華南永昌-民權,2024-12-02,9312
6257,矽格,4,0,4,華南永昌-民權,2024-12-02,9312
2881,富邦金,300,0,300,華南永昌-民權,2024-12-03,9312
00918,大華優利高填息30,209,0,209,華南永昌-民權,2024-12-03,9312
00919,群益台灣精選高息,48,10,38,華南永昌-民權,2024-12-03,9312
8171,天宇,31,1,30,華南永昌-民權,2024-12-03,9312
00878,國泰永續高股息,78,50,28,華南永昌-民權,2024-12-03,9312
00915,凱基優選高股息30,25,0,25,華南永昌-民權,2024-12-03,9312
6505,台塑化,25,1,24,華南永昌-民權,2024-12-03,9312
2887,台新金,20,0,20,華南永昌-民權,2024-12-03,9312
00945B,凱基美國非投等債,34,19,15,華南永昌-民權,2024-12-03,9312
2382,廣達,20,5,15,華南永昌-民權,2024-12-03,9312
2442,新美齊,12,0,12,華南永昌-民權,2024-12-03,9312
6127,九豪,14,2,12,華南永昌-民權,2024-12-03,9312
9938,百和,13,2,11,華南永昌-民權,2024-12-03,9312
00713,元大台灣高息低波,11,0,11,華南永昌-民權,2024-12-03,9312
8028,昇陽半導體,27,17,10,華南永昌-民權,2024-12-03,9312
2105,正新,10,0,10,華南永昌-民權,2024-12-03,9312
2637,慧洋-KY,10,0,10,華南永昌-民權,2024-12-03,9312
3062,建漢,12,2,10,華南永昌-民權,2024-12-03,9312
3591,艾笛森,10,0,10,華南永昌-民權,2024-12-03,9312
5244,弘凱,10,0,10,華南永昌-民權,2024-12-03,9312
00905,FT臺灣Smart,9,0,9,華南永昌-民權,2024-12-03,9312
2353,宏��,10,1,9,華南永昌-民權,2024-12-03,9312
3511,矽瑪,9,0,9,華南永昌-民權,2024-12-03,9312
8467,波力-KY,9,0,9,華南永昌-民權,2024-12-03,9312
4904,遠傳,8,0,8,華南永昌-民權,2024-12-03,9312
2312,金寶,12,6,6,華南永昌-民權,2024-12-03,9312
0056,元大高股息,6,0,6,華南永昌-民權,2024-12-03,9312
2488,漢平,6,0,6,華南永昌-民權,2024-12-03,9312
2547,日勝生,6,0,6,華南永昌-民權,2024-12-03,9312
2745,五福,6,0,6,華南永昌-民權,2024-12-03,9312
2812,台中銀,6,0,6,華南永昌-民權,2024-12-03,9312
3625,西勝,6,0,6,華南永昌-民權,2024-12-03,9312
00632R,元大台灣50反1,5,0,5,華南永昌-民權,2024-12-03,9312
1308,亞聚,5,0,5,華南永昌-民權,2024-12-03,9312
2354,鴻準,10,5,5,華南永昌-民權,2024-12-03,9312
2467,志聖,5,0,5,華南永昌-民權,2024-12-03,9312
4760,勤凱,5,0,5,華南永昌-民權,2024-12-03,9312
8279,生展,5,0,5,華南永昌-民權,2024-12-03,9312
2609,陽明,22,17,5,華南永昌-民權,2024-12-03,9312
3376,新日興,7,2,5,華南永昌-民權,2024-12-03,9312
5353,台林,6,1,5,華南永昌-民權,2024-12-03,9312
1504,東元,4,0,4,華南永昌-民權,2024-12-03,9312
4113,聯上,4,0,4,華南永昌-民權,2024-12-03,9312
4714,永捷,12,8,4,華南永昌-民權,2024-12-03,9312
8104,錸寶,4,0,4,華南永昌-民權,2024-12-03,9312
4968,立積,5,1,4,華南永昌-民權,2024-12-03,9312
2615,萬海,12,8,4,華南永昌-民權,2024-12-03,9312
6530,創威,6,3,3,華南永昌-民權,2024-12-03,9312
2014,中鴻,4,1,3,華南永昌-民權,2024-12-03,9312
2344,華邦電,3,0,3,華南永昌-民權,2024-12-03,9312
00664R,國泰臺灣加權反1,1048,0,1048,華南永昌-民權,2024-12-04,9312
2330,台積電,104,15,89,華南永昌-民權,2024-12-04,9312
00945B,凱基美國非投等債,67,7,60,華南永昌-民權,2024-12-04,9312
00687B,國泰20年美債,48,0,48,華南永昌-民權,2024-12-04,9312
2337,旺宏,52,5,47,華南永昌-民權,2024-12-04,9312
00919,群益台灣精選高息,49,3,46,華南永昌-民權,2024-12-04,9312
1528,恩德,43,0,43,華南永昌-民權,2024-12-04,9312
00676R,富邦臺灣加權反1,30,0,30,華南永昌-民權,2024-12-04,9312
00918,大華優利高填息30,22,0,22,華南永昌-民權,2024-12-04,9312
5244,弘凱,21,1,20,華南永昌-民權,2024-12-04,9312
3167,大量,35,16,19,華南永昌-民權,2024-12-04,9312
3540,曜越,18,0,18,華南永昌-民權,2024-12-04,9312
3323,加百裕,68,52,16,華南永昌-民權,2024-12-04,9312
0056,元大高股息,16,1,15,華南永昌-民權,2024-12-04,9312
00955,中信日本商社,15,0,15,華南永昌-民權,2024-12-04,9312
2492,華新科,16,1,15,華南永昌-民權,2024-12-04,9312
2303,聯電,24,10,14,華南永昌-民權,2024-12-04,9312
2405,輔信,10,0,10,華南永昌-民權,2024-12-04,9312
2646,星宇航空,10,0,10,華南永昌-民權,2024-12-04,9312
5309,系統電,28,18,10,華南永昌-民權,2024-12-04,9312
9938,百和,10,1,9,華南永昌-民權,2024-12-04,9312
3003,健和興,10,2,8,華南永昌-民權,2024-12-04,9312
9105,泰金寶-DR,9,1,8,華南永昌-民權,2024-12-04,9312
00713,元大台灣高息低波,7,0,7,華南永昌-民權,2024-12-04,9312
2344,華邦電,8,1,7,華南永昌-民權,2024-12-04,9312
2609,陽明,14,7,7,華南永昌-民權,2024-12-04,9312
2801,彰銀,7,0,7,華南永昌-民權,2024-12-04,9312
5315,光聯,7,0,7,華南永昌-民權,2024-12-04,9312
2891,中信金,6,0,6,華南永昌-民權,2024-12-04,9312
6530,創威,6,0,6,華南永昌-民權,2024-12-04,9312
1514,亞力,6,1,5,華南永昌-民權,2024-12-04,9312
3706,神達,33,28,5,華南永昌-民權,2024-12-04,9312
4541,晟田,5,0,5,華南永昌-民權,2024-12-04,9312
4760,勤凱,5,0,5,華南永昌-民權,2024-12-04,9312
2419,仲琦,7,3,4,華南永昌-民權,2024-12-04,9312
00953B,群益優選非投等債,4,0,4,華南永昌-民權,2024-12-04,9312
1101,台泥,5,1,4,華南永昌-民權,2024-12-04,9312
2408,南亞科,6,2,4,華南永昌-民權,2024-12-04,9312
4763,材料-KY,4,0,4,華南永昌-民權,2024-12-04,9312
8038,長園科,4,0,4,華南永昌-民權,2024-12-04,9312
3234,光環,4,0,4,華南永昌-民權,2024-12-04,9312
4968,立積,5,1,4,華南永昌-民權,2024-12-04,9312
00878,國泰永續高股息,4,1,3,華南永昌-民權,2024-12-04,9312
1614,三洋電,3,0,3,華南永昌-民權,2024-12-04,9312
2027,大成鋼,3,0,3,華南永昌-民權,2024-12-04,9312
2241,艾姆勒,3,0,3,華南永昌-民權,2024-12-04,9312
2349,錸德,4,1,3,華南永昌-民權,2024-12-04,9312
2444,兆勁,3,0,3,華南永昌-民權,2024-12-04,9312
2542,興富發,6,3,3,華南永昌-民權,2024-12-04,9312
2547,日勝生,3,0,3,華南永昌-民權,2024-12-04,9312
3231,緯創,406,6,400,華南永昌-民權,2024-12-05,9312
00918,大華優利高填息30,77,0,77,華南永昌-民權,2024-12-05,9312
00664R,國泰臺灣加權反1,100,50,50,華南永昌-民權,2024-12-05,9312
00753L,中信中國50正2,50,0,50,華南永昌-民權,2024-12-05,9312
1815,富喬,65,18,47,華南永昌-民權,2024-12-05,9312
00915,凱基優選高股息30,20,0,20,華南永昌-民權,2024-12-05,9312
2476,鉅祥,20,0,20,華南永昌-民權,2024-12-05,9312
9105,泰金寶-DR,23,3,20,華南永昌-民權,2024-12-05,9312
1528,恩德,17,0,17,華南永昌-民權,2024-12-05,9312
2375,凱美,16,2,14,華南永昌-民權,2024-12-05,9312
2615,萬海,14,1,13,華南永昌-民權,2024-12-05,9312
5328,華容,17,4,13,華南永昌-民權,2024-12-05,9312
00715L,期街口布蘭特正2,12,0,12,華南永昌-民權,2024-12-05,9312
3591,艾笛森,13,1,12,華南永昌-民權,2024-12-05,9312
3167,大量,17,6,11,華南永昌-民權,2024-12-05,9312
1609,大亞,10,0,10,華南永昌-民權,2024-12-05,9312
2302,麗正,10,0,10,華南永昌-民權,2024-12-05,9312
2399,映泰,12,2,10,華南永昌-民權,2024-12-05,9312
3234,光環,14,4,10,華南永昌-民權,2024-12-05,9312
6152,百一,10,0,10,華南永昌-民權,2024-12-05,9312
6164,華興,10,0,10,華南永昌-民權,2024-12-05,9312
8011,台通,10,0,10,華南永昌-民權,2024-12-05,9312
3712,永崴投控,30,21,9,華南永昌-民權,2024-12-05,9312
2409,友達,8,0,8,華南永昌-民權,2024-12-05,9312
6901,鑽石投資,14,6,8,華南永昌-民權,2024-12-05,9312
3481,群創,11,4,7,華南永昌-民權,2024-12-05,9312
2891,中信金,7,0,7,華南永昌-民權,2024-12-05,9312
2317,鴻海,11,4,7,華南永昌-民權,2024-12-05,9312
6274,台燿,8,1,7,華南永昌-民權,2024-12-05,9312
2002,中鋼,7,0,7,華南永昌-民權,2024-12-05,9312
8096,擎亞,9,2,7,華南永昌-民權,2024-12-05,9312
4303,信立,6,0,6,華南永昌-民權,2024-12-05,9312
6442,光聖,7,1,6,華南永昌-民權,2024-12-05,9312
2303,聯電,6,0,6,華南永昌-民權,2024-12-05,9312
4927,泰鼎-KY,13,8,5,華南永昌-民權,2024-12-05,9312
00885,富邦越南,9,4,5,華南永昌-民權,2024-12-05,9312
00955,中信日本商社,5,0,5,華南永昌-民權,2024-12-05,9312
1304,台聚,5,0,5,華南永昌-民權,2024-12-05,9312
1514,亞力,5,0,5,華南永昌-民權,2024-12-05,9312
2324,仁寶,10,5,5,華南永昌-民權,2024-12-05,9312
2368,金像電,5,0,5,華南永昌-民權,2024-12-05,9312
3217,優群,5,0,5,華南永昌-民權,2024-12-05,9312
3221,台嘉碩,5,0,5,華南永昌-民權,2024-12-05,9312
5386,青雲,6,1,5,華南永昌-民權,2024-12-05,9312
6763,綠界科技*,8,3,5,華南永昌-民權,2024-12-05,9312
6770,力積電,5,0,5,華南永昌-民權,2024-12-05,9312
6869,雲豹能源,5,0,5,華南永昌-民權,2024-12-05,9312
3211,順達,9,4,5,華南永昌-民權,2024-12-05,9312
3043,科風,4,0,4,華南永昌-民權,2024-12-05,9312
6558,興能高,10,6,4,華南永昌-民權,2024-12-05,9312
00919,群益台灣精選高息,84,1,83,華南永昌-民權,2024-12-06,9312
00918,大華優利高填息30,60,0,60,華南永昌-民權,2024-12-06,9312
3265,台星科,60,25,35,華南永昌-民權,2024-12-06,9312
2809,京城銀,20,0,20,華南永昌-民權,2024-12-06,9312
8054,安國,20,0,20,華南永昌-民權,2024-12-06,9312
3591,艾笛森,20,1,19,華南永昌-民權,2024-12-06,9312
3323,加百裕,21,3,18,華南永昌-民權,2024-12-06,9312
3706,神達,42,25,17,華南永昌-民權,2024-12-06,9312
00878,國泰永續高股息,16,2,14,華南永昌-民權,2024-12-06,9312
2337,旺宏,17,5,12,華南永昌-民權,2024-12-06,9312
00953B,群益優選非投等債,13,0,13,華南永昌-民權,2024-12-06,9312
00962,台新AI優息動能,12,0,12,華南永昌-民權,2024-12-06,9312
3380,明泰,13,1,12,華南永昌-民權,2024-12-06,9312
3597,映興,25,13,12,華南永昌-民權,2024-12-06,9312
00725B,國泰投資級公司債,10,0,10,華南永昌-民權,2024-12-06,9312
00720B,元大投資級公司債,10,0,10,華南永昌-民權,2024-12-06,9312
00719B,元大美債1-3,10,0,10,華南永昌-民權,2024-12-06,9312
3652,精聯,10,0,10,華南永昌-民權,2024-12-06,9312
6290,良維,10,0,10,華南永昌-民權,2024-12-06,9312
8011,台通,10,0,10,華南永昌-民權,2024-12-06,9312
8016,矽創,11,1,10,華南永昌-民權,2024-12-06,9312
9105,泰金寶-DR,10,0,10,華南永昌-民權,2024-12-06,9312
2382,廣達,10,1,9,華南永昌-民權,2024-12-06,9312
00915,凱基優選高股息30,7,0,7,華南永昌-民權,2024-12-06,9312
00909,國泰數位支付服務,10,3,7,華南永昌-民權,2024-12-06,9312
6901,鑽石投資,7,0,7,華南永昌-民權,2024-12-06,9312
1609,大亞,14,7,7,華南永昌-民權,2024-12-06,9312
4743,合一,12,6,6,華南永昌-民權,2024-12-06,9312
5328,華容,8,2,6,華南永昌-民權,2024-12-06,9312
2449,京元電子,11,5,6,華南永昌-民權,2024-12-06,9312
0056,元大高股息,6,0,6,華南永昌-民權,2024-12-06,9312
00922,國泰台灣領袖50,5,0,5,華南永昌-民權,2024-12-06,9312
4968,立積,5,0,5,華南永昌-民權,2024-12-06,9312
00676R,富邦臺灣加權反1,5,0,5,華南永昌-民權,2024-12-06,9312
2392,正崴,7,2,5,華南永昌-民權,2024-12-06,9312
2646,星宇航空,5,0,5,華南永昌-民權,2024-12-06,9312
3049,精金,5,0,5,華南永昌-民權,2024-12-06,9312
3581,博磊,5,0,5,華南永昌-民權,2024-12-06,9312
5315,光聯,5,0,5,華南永昌-民權,2024-12-06,9312
5508,永信建,5,0,5,華南永昌-民權,2024-12-06,9312
4919,新唐,8,3,5,華南永昌-民權,2024-12-06,9312
00830,國泰費城半導體,4,0,4,華南永昌-民權,2024-12-06,9312
00905,FT臺灣Smart,7,3,4,華南永昌-民權,2024-12-06,9312
1101,台泥,5,1,4,華南永昌-民權,2024-12-06,9312
2427,三商電,15,11,4,華南永昌-民權,2024-12-06,9312
5706,鳳凰,4,0,4,華南永昌-民權,2024-12-06,9312
8210,勤誠,5,1,4,華南永昌-民權,2024-12-06,9312
2330,台積電,4,0,4,華南永昌-民權,2024-12-06,9312
4905,台聯電,4,0,4,華南永昌-民權,2024-12-06,9312
5371,中光電,3,0,3,華南永昌-民權,2024-12-06,9312
00664R,國泰臺灣加權反1,589,0,589,華南永昌-民權,2024-12-09,9312
2330,台積電,102,1,101,華南永昌-民權,2024-12-09,9312
00740B,富邦全球投等債,70,0,70,華南永昌-民權,2024-12-09,9312
00918,大華優利高填息30,64,0,64,華南永昌-民權,2024-12-09,9312
1303,南亞,31,0,31,華南永昌-民權,2024-12-09,9312
1528,恩德,28,0,28,華南永昌-民權,2024-12-09,9312
2344,華邦電,22,0,22,華南永昌-民權,2024-12-09,9312
2801,彰銀,22,0,22,華南永昌-民權,2024-12-09,9312
8086,宏捷科,20,0,20,華南永昌-民權,2024-12-09,9312
5426,振發,18,0,18,華南永昌-民權,2024-12-09,9312
2615,萬海,42,24,18,華南永昌-民權,2024-12-09,9312
00687B,國泰20年美債,15,1,14,華南永昌-民權,2024-12-09,9312
00915,凱基優選高股息30,14,1,13,華南永昌-民權,2024-12-09,9312
8467,波力-KY,14,1,13,華南永昌-民權,2024-12-09,9312
2891,中信金,12,0,12,華南永昌-民權,2024-12-09,9312
1815,富喬,13,1,12,華南永昌-民權,2024-12-09,9312
6290,良維,12,0,12,華南永昌-民權,2024-12-09,9312
00919,群益台灣精選高息,24,13,11,華南永昌-民權,2024-12-09,9312
6152,百一,11,0,11,華南永昌-民權,2024-12-09,9312
00938,凱基優選30,10,0,10,華南永昌-民權,2024-12-09,9312
8076,伍豐,10,0,10,華南永昌-民權,2024-12-09,9312
2317,鴻海,16,6,10,華南永昌-民權,2024-12-09,9312
2637,慧洋-KY,9,0,9,華南永昌-民權,2024-12-09,9312
1314,中石化,9,0,9,華南永昌-民權,2024-12-09,9312
2328,廣宇,10,1,9,華南永昌-民權,2024-12-09,9312
6505,台塑化,9,0,9,華南永昌-民權,2024-12-09,9312
1514,亞力,8,0,8,華南永昌-民權,2024-12-09,9312
2408,南亞科,13,5,8,華南永昌-民權,2024-12-09,9312
3591,艾笛森,8,0,8,華南永昌-民權,2024-12-09,9312
00715L,期街口布蘭特正2,7,0,7,華南永昌-民權,2024-12-09,9312
1313,聯成,7,0,7,華南永昌-民權,2024-12-09,9312
2383,台光電,9,2,7,華南永昌-民權,2024-12-09,9312
5706,鳳凰,7,0,7,華南永昌-民權,2024-12-09,9312
6239,力成,7,0,7,華南永昌-民權,2024-12-09,9312
4968,立積,12,5,7,華南永昌-民權,2024-12-09,9312
2374,佳能,7,0,7,華南永昌-民權,2024-12-09,9312
6269,台郡,17,10,7,華南永昌-民權,2024-12-09,9312
2405,輔信,9,3,6,華南永昌-民權,2024-12-09,9312
3211,順達,10,4,6,華南永昌-民權,2024-12-09,9312
6901,鑽石投資,7,1,6,華南永昌-民權,2024-12-09,9312
3715,定穎投控,23,17,6,華南永昌-民權,2024-12-09,9312
2449,京元電子,5,0,5,華南永昌-民權,2024-12-09,9312
1609,大亞,9,4,5,華南永昌-民權,2024-12-09,9312
00962,台新AI優息動能,5,0,5,華南永昌-民權,2024-12-09,9312
1326,台化,6,1,5,華南永昌-民權,2024-12-09,9312
1471,首利,5,0,5,華南永昌-民權,2024-12-09,9312
2436,偉詮電,5,0,5,華南永昌-民權,2024-12-09,9312
2890,永豐金,5,0,5,華南永昌-民權,2024-12-09,9312
6288,聯嘉,6,1,5,華南永昌-民權,2024-12-09,9312
1785,光洋科,23,18,5,華南永昌-民權,2024-12-09,9312
00637L,元大滬深300正2,232,103,129,華南永昌-民權,2024-12-10,9312
00930,永豐ESG低碳高息,105,0,105,華南永昌-民權,2024-12-10,9312
00918,大華優利高填息30,45,5,40,華南永昌-民權,2024-12-10,9312
2610,華航,32,1,31,華南永昌-民權,2024-12-10,9312
00962,台新AI優息動能,30,0,30,華南永昌-民權,2024-12-10,9312
00945B,凱基美國非投等債,55,33,22,華南永昌-民權,2024-12-10,9312
00639,富邦深100,20,0,20,華南永昌-民權,2024-12-10,9312
1326,台化,20,0,20,華南永昌-民權,2024-12-10,9312
3481,群創,17,0,17,華南永昌-民權,2024-12-10,9312
6139,亞翔,15,0,15,華南永昌-民權,2024-12-10,9312
4905,台聯電,15,0,15,華南永昌-民權,2024-12-10,9312
3511,矽瑪,12,0,12,華南永昌-民權,2024-12-10,9312
1303,南亞,22,11,11,華南永昌-民權,2024-12-10,9312
6509,聚和,11,0,11,華南永昌-民權,2024-12-10,9312
9105,泰金寶-DR,11,0,11,華南永昌-民權,2024-12-10,9312
2354,鴻準,15,4,11,華南永昌-民權,2024-12-10,9312
2313,華通,16,6,10,華南永昌-民權,2024-12-10,9312
2884,玉山金,15,5,10,華南永昌-民權,2024-12-10,9312
1101,台泥,10,0,10,華南永昌-民權,2024-12-10,9312
1446,宏和,10,0,10,華南永昌-民權,2024-12-10,9312
1536,和大,10,0,10,華南永昌-民權,2024-12-10,9312
2353,宏��,12,2,10,華南永昌-民權,2024-12-10,9312
5519,隆大,10,0,10,華南永昌-民權,2024-12-10,9312
8064,東捷,10,0,10,華南永昌-民權,2024-12-10,9312
1718,中纖,9,0,9,華南永昌-民權,2024-12-10,9312
8054,安國,28,19,9,華南永昌-民權,2024-12-10,9312
3607,谷崧,8,0,8,華南永昌-民權,2024-12-10,9312
4566,時碩工業,8,0,8,華南永昌-民權,2024-12-10,9312
00953B,群益優選非投等債,7,0,7,華南永昌-民權,2024-12-10,9312
00687B,國泰20年美債,7,1,6,華南永昌-民權,2024-12-10,9312
2609,陽明,8,2,6,華南永昌-民權,2024-12-10,9312
2312,金寶,7,2,5,華南永昌-民權,2024-12-10,9312
1514,亞力,5,0,5,華南永昌-民權,2024-12-10,9312
1533,車王電,5,0,5,華南永昌-民權,2024-12-10,9312
2371,大同,5,0,5,華南永昌-民權,2024-12-10,9312
6834,天二科技,7,2,5,華南永昌-民權,2024-12-10,9312
6962,ITH-KY,5,0,5,華南永昌-民權,2024-12-10,9312
8069,元太,5,0,5,華南永昌-民權,2024-12-10,9312
00909,國泰數位支付服務,5,0,5,華南永昌-民權,2024-12-10,9312
2356,英業達,4,0,4,華南永昌-民權,2024-12-10,9312
6937,天虹,4,0,4,華南永昌-民權,2024-12-10,9312
1449,佳和,4,0,4,華南永昌-民權,2024-12-10,9312
2376,技嘉,4,0,4,華南永昌-民權,2024-12-10,9312
3015,全漢,4,0,4,華南永昌-民權,2024-12-10,9312
3078,僑威,6,2,4,華南永昌-民權,2024-12-10,9312
5309,系統電,5,1,4,華南永昌-民權,2024-12-10,9312
6558,興能高,4,0,4,華南永昌-民權,2024-12-10,9312
6790,永豐實,4,0,4,華南永昌-民權,2024-12-10,9312
6874,倍力,4,0,4,華南永昌-民權,2024-12-10,9312
4763,材料-KY,4,0,4,華南永昌-民權,2024-12-10,9312
2897,王道銀行,50,0,50,華南永昌-民權,2024-12-11,9312
00918,大華優利高填息30,56,8,48,華南永昌-民權,2024-12-11,9312
1303,南亞,28,0,28,華南永昌-民權,2024-12-11,9312
1712,興農,24,0,24,華南永昌-民權,2024-12-11,9312
6509,聚和,24,0,24,華南永昌-民權,2024-12-11,9312
00919,群益台灣精選高息,28,6,22,華南永昌-民權,2024-12-11,9312
3491,昇達科,20,0,20,華南永昌-民權,2024-12-11,9312
00922,國泰台灣領袖50,17,0,17,華南永昌-民權,2024-12-11,9312
4977,眾達-KY,25,9,16,華南永昌-民權,2024-12-11,9312
2317,鴻海,22,6,16,華南永昌-民權,2024-12-11,9312
0056,元大高股息,15,0,15,華南永昌-民權,2024-12-11,9312
00915,凱基優選高股息30,23,10,13,華南永昌-民權,2024-12-11,9312
2609,陽明,18,6,12,華南永昌-民權,2024-12-11,9312
1301,台塑,14,3,11,華南永昌-民權,2024-12-11,9312
2537,聯上發,11,0,11,華南永昌-民權,2024-12-11,9312
9921,巨大,11,0,11,華南永昌-民權,2024-12-11,9312
00713,元大台灣高息低波,10,0,10,華南永昌-民權,2024-12-11,9312
2834,臺企銀,10,0,10,華南永昌-民權,2024-12-11,9312
1210,大成,10,0,10,華南永昌-民權,2024-12-11,9312
1410,南染,10,0,10,華南永昌-民權,2024-12-11,9312
2633,台灣高鐵,10,0,10,華南永昌-民權,2024-12-11,9312
8011,台通,10,0,10,華南永昌-民權,2024-12-11,9312
8039,台虹,10,0,10,華南永昌-民權,2024-12-11,9312
8069,元太,10,0,10,華南永昌-民權,2024-12-11,9312
9919,康那香,10,0,10,華南永昌-民權,2024-12-11,9312
00878,國泰永續高股息,10,1,9,華南永昌-民權,2024-12-11,9312
1514,亞力,10,1,9,華南永昌-民權,2024-12-11,9312
3231,緯創,10,1,9,華南永昌-民權,2024-12-11,9312
9105,泰金寶-DR,11,2,9,華南永昌-民權,2024-12-11,9312
2382,廣達,8,0,8,華南永昌-民權,2024-12-11,9312
1449,佳和,8,0,8,華南永昌-民權,2024-12-11,9312
2610,華航,8,0,8,華南永昌-民權,2024-12-11,9312
3594,磐儀,7,0,7,華南永昌-民權,2024-12-11,9312
3652,精聯,7,0,7,華南永昌-民權,2024-12-11,9312
2312,金寶,7,1,6,華南永昌-民權,2024-12-11,9312
2495,普安,6,0,6,華南永昌-民權,2024-12-11,9312
5289,宜鼎,6,0,6,華南永昌-民權,2024-12-11,9312
6290,良維,6,0,6,華南永昌-民權,2024-12-11,9312
006208,富邦台50,5,0,5,華南永昌-民權,2024-12-11,9312
3481,群創,6,1,5,華南永昌-民權,2024-12-11,9312
2399,映泰,5,0,5,華南永昌-民權,2024-12-11,9312
00937B,群益ESG投等債20,5,0,5,華南永昌-民權,2024-12-11,9312
1533,車王電,5,0,5,華南永昌-民權,2024-12-11,9312
1618,合機,5,0,5,華南永昌-民權,2024-12-11,9312
2324,仁寶,11,6,5,華南永昌-民權,2024-12-11,9312
2634,漢翔,5,0,5,華南永昌-民權,2024-12-11,9312
3033,威健,4,0,4,華南永昌-民權,2024-12-11,9312
1314,中石化,4,0,4,華南永昌-民權,2024-12-11,9312
2102,泰豐,4,0,4,華南永昌-民權,2024-12-11,9312
3607,谷崧,4,0,4,華南永昌-民權,2024-12-11,9312
00664R,國泰臺灣加權反1,499,26,473,華南永昌-民權,2024-12-12,9312
1303,南亞,65,0,65,華南永昌-民權,2024-12-12,9312
00937B,群益ESG投等債20,133,89,44,華南永昌-民權,2024-12-12,9312
00915,凱基優選高股息30,41,0,41,華南永昌-民權,2024-12-12,9312
1326,台化,36,0,36,華南永昌-民權,2024-12-12,9312
00918,大華優利高填息30,27,0,27,華南永昌-民權,2024-12-12,9312
00933B,國泰10Y+金融債,21,0,21,華南永昌-民權,2024-12-12,9312
00687B,國泰20年美債,24,4,20,華南永昌-民權,2024-12-12,9312
3652,精聯,20,0,20,華南永昌-民權,2024-12-12,9312
2002,中鋼,17,0,17,華南永昌-民權,2024-12-12,9312
1815,富喬,20,5,15,華南永昌-民權,2024-12-12,9312
2547,日勝生,15,0,15,華南永昌-民權,2024-12-12,9312
2618,長榮航,15,1,14,華南永昌-民權,2024-12-12,9312
6505,台塑化,14,0,14,華南永昌-民權,2024-12-12,9312
2312,金寶,21,8,13,華南永昌-民權,2024-12-12,9312
1609,大亞,13,1,12,華南永昌-民權,2024-12-12,9312
2344,華邦電,12,0,12,華南永昌-民權,2024-12-12,9312
3013,晟銘電,16,4,12,華南永昌-民權,2024-12-12,9312
6558,興能高,13,1,12,華南永昌-民權,2024-12-12,9312
1301,台塑,10,0,10,華南永昌-民權,2024-12-12,9312
2349,錸德,10,0,10,華南永昌-民權,2024-12-12,9312
8054,安國,10,0,10,華南永昌-民權,2024-12-12,9312
1569,濱川,9,0,9,華南永昌-民權,2024-12-12,9312
2303,聯電,11,3,8,華南永昌-民權,2024-12-12,9312
3029,零壹,17,9,8,華南永昌-民權,2024-12-12,9312
2468,華經,8,0,8,華南永昌-民權,2024-12-12,9312
3481,群創,24,16,8,華南永昌-民權,2024-12-12,9312
5202,力新,10,2,8,華南永昌-民權,2024-12-12,9312
8110,華東,10,2,8,華南永昌-民權,2024-12-12,9312
2317,鴻海,10,2,8,華南永昌-民權,2024-12-12,9312
8039,台虹,7,0,7,華南永昌-民權,2024-12-12,9312
2324,仁寶,6,0,6,華南永昌-民權,2024-12-12,9312
2354,鴻準,9,3,6,華南永昌-民權,2024-12-12,9312
2540,愛山林,6,0,6,華南永昌-民權,2024-12-12,9312
4909,新復興,6,0,6,華南永昌-民權,2024-12-12,9312
00679B,元大美債20年,5,0,5,華南永昌-民權,2024-12-12,9312
1533,車王電,5,0,5,華南永昌-民權,2024-12-12,9312
1795,美時,5,0,5,華南永昌-民權,2024-12-12,9312
2314,台揚,5,0,5,華南永昌-民權,2024-12-12,9312
2453,凌群,5,0,5,華南永昌-民權,2024-12-12,9312
2488,漢平,5,0,5,華南永昌-民權,2024-12-12,9312
4919,新唐,5,0,5,華南永昌-民權,2024-12-12,9312
6167,久正,5,0,5,華南永昌-民權,2024-12-12,9312
6763,綠界科技*,6,1,5,華南永昌-民權,2024-12-12,9312
1785,光洋科,7,2,5,華南永昌-民權,2024-12-12,9312
2353,宏��,6,2,4,華南永昌-民權,2024-12-12,9312
1101,台泥,5,1,4,華南永昌-民權,2024-12-12,9312
2471,資通,14,10,4,華南永昌-民權,2024-12-12,9312
4566,時碩工業,7,3,4,華南永昌-民權,2024-12-12,9312
6937,天虹,4,0,4,華南永昌-民權,2024-12-12,9312
00751B,元大AAA至A公司債,250,50,200,華南永昌-民權,2024-12-13,9312
2324,仁寶,128,5,123,華南永昌-民權,2024-12-13,9312
2002,中鋼,61,0,61,華南永昌-民權,2024-12-13,9312
00915,凱基優選高股息30,43,0,43,華南永昌-民權,2024-12-13,9312
00937B,群益ESG投等債20,37,0,37,華南永昌-民權,2024-12-13,9312
1303,南亞,36,0,36,華南永昌-民權,2024-12-13,9312
2317,鴻海,39,6,33,華南永昌-民權,2024-12-13,9312
2887,台新金,31,0,31,華南永昌-民權,2024-12-13,9312
00918,大華優利高填息30,29,0,29,華南永昌-民權,2024-12-13,9312
3706,神達,30,5,25,華南永昌-民權,2024-12-13,9312
2891,中信金,29,4,25,華南永昌-民權,2024-12-13,9312
6509,聚和,21,0,21,華南永昌-民權,2024-12-13,9312
3652,精聯,20,0,20,華南永昌-民權,2024-12-13,9312
6116,彩晶,19,0,19,華南永昌-民權,2024-12-13,9312
1712,興農,16,0,16,華南永昌-民權,2024-12-13,9312
3013,晟銘電,15,0,15,華南永昌-民權,2024-12-13,9312
5483,中美晶,15,1,14,華南永昌-民權,2024-12-13,9312
00919,群益台灣精選高息,16,2,14,華南永昌-民權,2024-12-13,9312
2303,聯電,21,7,14,華南永昌-民權,2024-12-13,9312
00688L,國泰20年美債正2,13,0,13,華南永昌-民權,2024-12-13,9312
2408,南亞科,18,6,12,華南永昌-民權,2024-12-13,9312
3591,艾笛森,13,2,11,華南永昌-民權,2024-12-13,9312
00687B,國泰20年美債,13,2,11,華南永昌-民權,2024-12-13,9312
0056,元大高股息,22,11,11,華南永昌-民權,2024-12-13,9312
2102,泰豐,11,0,11,華南永昌-民權,2024-12-13,9312
2883,凱基金,10,0,10,華南永昌-民權,2024-12-13,9312
00850,元大臺灣ESG永續,10,0,10,華南永昌-民權,2024-12-13,9312
00719B,元大美債1-3,10,0,10,華南永昌-民權,2024-12-13,9312
2836,高雄銀,10,0,10,華南永昌-民權,2024-12-13,9312
2929,淘帝-KY,10,0,10,華南永昌-民權,2024-12-13,9312
8011,台通,10,0,10,華南永昌-民權,2024-12-13,9312
8039,台虹,15,5,10,華南永昌-民權,2024-12-13,9312
2609,陽明,17,7,10,華南永昌-民權,2024-12-13,9312
2382,廣達,11,2,9,華南永昌-民權,2024-12-13,9312
1815,富喬,9,1,8,華南永昌-民權,2024-12-13,9312
2371,大同,12,4,8,華南永昌-民權,2024-12-13,9312
2453,凌群,8,0,8,華南永昌-民權,2024-12-13,9312
6505,台塑化,8,1,7,華南永昌-民權,2024-12-13,9312
00900,富邦特選高股息30,7,0,7,華南永昌-民權,2024-12-13,9312
00932,兆豐永續高息等權,7,0,7,華南永昌-民權,2024-12-13,9312
2610,華航,8,1,7,華南永昌-民權,2024-12-13,9312
8404,百和興業-KY,7,0,7,華南永昌-民權,2024-12-13,9312
5871,中租-KY,8,1,7,華南永昌-民權,2024-12-13,9312
2354,鴻準,8,2,6,華南永昌-民權,2024-12-13,9312
00955,中信日本商社,6,0,6,華南永昌-民權,2024-12-13,9312
3049,精金,9,3,6,華南永昌-民權,2024-12-13,9312
3481,群創,6,0,6,華南永昌-民權,2024-12-13,9312
4979,華星光,11,5,6,華南永昌-民權,2024-12-13,9312
5289,宜鼎,6,0,6,華南永昌-民權,2024-12-13,9312
1301,台塑,5,0,5,華南永昌-民權,2024-12-13,9312
00687B,國泰20年美債,157,3,154,華南永昌-民權,2024-12-16,9312
2367,燿華,121,0,121,華南永昌-民權,2024-12-16,9312
2102,泰豐,100,10,90,華南永昌-民權,2024-12-16,9312
00945B,凱基美國非投等債,87,14,73,華南永昌-民權,2024-12-16,9312
00933B,國泰10Y+金融債,51,0,51,華南永昌-民權,2024-12-16,9312
2002,中鋼,48,3,45,華南永昌-民權,2024-12-16,9312
00918,大華優利高填息30,42,0,42,華南永昌-民權,2024-12-16,9312
00937B,群益ESG投等債20,37,0,37,華南永昌-民權,2024-12-16,9312
2382,廣達,36,3,33,華南永昌-民權,2024-12-16,9312
1326,台化,64,32,32,華南永昌-民權,2024-12-16,9312
0056,元大高股息,31,1,30,華南永昌-民權,2024-12-16,9312
00919,群益台灣精選高息,26,2,24,華南永昌-民權,2024-12-16,9312
2615,萬海,31,7,24,華南永昌-民權,2024-12-16,9312
00900,富邦特選高股息30,20,0,20,華南永昌-民權,2024-12-16,9312
00915,凱基優選高股息30,16,0,16,華南永昌-民權,2024-12-16,9312
2317,鴻海,20,5,15,華南永昌-民權,2024-12-16,9312
00887,永豐中國科技50大,13,0,13,華南永昌-民權,2024-12-16,9312
6509,聚和,16,4,12,華南永昌-民權,2024-12-16,9312
1569,濱川,12,1,11,華南永昌-民權,2024-12-16,9312
6142,友勁,10,0,10,華南永昌-民權,2024-12-16,9312
6829,千附精密,10,0,10,華南永昌-民權,2024-12-16,9312
8045,達運光電,10,0,10,華南永昌-民權,2024-12-16,9312
9105,泰金寶-DR,11,2,9,華南永昌-民權,2024-12-16,9312
2609,陽明,16,7,9,華南永昌-民權,2024-12-16,9312
4967,十銓,8,0,8,華南永昌-民權,2024-12-16,9312
6223,旺矽,9,1,8,華南永昌-民權,2024-12-16,9312
1785,光洋科,19,12,7,華南永昌-民權,2024-12-16,9312
2344,華邦電,7,0,7,華南永昌-民權,2024-12-16,9312
3019,亞光,25,18,7,華南永昌-民權,2024-12-16,9312
8358,金居,7,0,7,華南永昌-民權,2024-12-16,9312
6770,力積電,6,0,6,華南永昌-民權,2024-12-16,9312
2354,鴻準,8,2,6,華南永昌-民權,2024-12-16,9312
6695,芯鼎,10,4,6,華南永昌-民權,2024-12-16,9312
00878,國泰永續高股息,8,3,5,華南永昌-民權,2024-12-16,9312
6530,創威,5,0,5,華南永昌-民權,2024-12-16,9312
3450,聯鈞,17,12,5,華南永昌-民權,2024-12-16,9312
00712,復華富時不動產,5,0,5,華南永昌-民權,2024-12-16,9312
00688L,國泰20年美債正2,5,0,5,華南永昌-民權,2024-12-16,9312
2231,為升,5,0,5,華南永昌-民權,2024-12-16,9312
2476,鉅祥,5,0,5,華南永昌-民權,2024-12-16,9312
4739,康普,5,0,5,華南永昌-民權,2024-12-16,9312
5706,鳳凰,5,0,5,華南永昌-民權,2024-12-16,9312
6585,鼎基,5,0,5,華南永昌-民權,2024-12-16,9312
6937,天虹,5,0,5,華南永昌-民權,2024-12-16,9312
8182,加高,5,0,5,華南永昌-民權,2024-12-16,9312
3017,奇鋐,4,0,4,華南永昌-民權,2024-12-16,9312
1815,富喬,32,28,4,華南永昌-民權,2024-12-16,9312
2486,一詮,5,1,4,華南永昌-民權,2024-12-16,9312
3591,艾笛森,9,5,4,華南永昌-民權,2024-12-16,9312
3645,達邁,4,0,4,華南永昌-民權,2024-12-16,9312
00919,群益台灣精選高息,129,29,100,華南永昌-民權,2024-12-17,9312
00915,凱基優選高股息30,59,0,59,華南永昌-民權,2024-12-17,9312
2303,聯電,31,7,24,華南永昌-民權,2024-12-17,9312
2834,臺企銀,24,0,24,華南永昌-民權,2024-12-17,9312
2801,彰銀,24,2,22,華南永昌-民權,2024-12-17,9312
00753L,中信中國50正2,20,0,20,華南永昌-民權,2024-12-17,9312
1609,大亞,20,0,20,華南永昌-民權,2024-12-17,9312
2883,凱基金,17,0,17,華南永昌-民權,2024-12-17,9312
2317,鴻海,22,6,16,華南永昌-民權,2024-12-17,9312
00937B,群益ESG投等債20,15,0,15,華南永昌-民權,2024-12-17,9312
00713,元大台灣高息低波,13,0,13,華南永昌-民權,2024-12-17,9312
00687B,國泰20年美債,12,0,12,華南永昌-民權,2024-12-17,9312
00680L,元大美債20正2,12,0,12,華南永昌-民權,2024-12-17,9312
0056,元大高股息,11,0,11,華南永昌-民權,2024-12-17,9312
00933B,國泰10Y+金融債,11,0,11,華南永昌-民權,2024-12-17,9312
1101,台泥,11,0,11,華南永昌-民權,2024-12-17,9312
2637,慧洋-KY,11,0,11,華南永昌-民權,2024-12-17,9312
1303,南亞,10,0,10,華南永昌-民權,2024-12-17,9312
6509,聚和,9,0,9,華南永昌-民權,2024-12-17,9312
2886,兆豐金,8,0,8,華南永昌-民權,2024-12-17,9312
6133,金橋,8,0,8,華南永昌-民權,2024-12-17,9312
2002,中鋼,7,0,7,華南永昌-民權,2024-12-17,9312
1314,中石化,7,0,7,華南永昌-民權,2024-12-17,9312
00679B,元大美債20年,6,0,6,華南永昌-民權,2024-12-17,9312
00688L,國泰20年美債正2,6,0,6,華南永昌-民權,2024-12-17,9312
2324,仁寶,6,0,6,華南永昌-民權,2024-12-17,9312
2486,一詮,16,10,6,華南永昌-民權,2024-12-17,9312
2374,佳能,18,12,6,華南永昌-民權,2024-12-17,9312
00918,大華優利高填息30,15,10,5,華南永昌-民權,2024-12-17,9312
00929,復華台灣科技優息,6,1,5,華南永昌-民權,2024-12-17,9312
1301,台塑,7,2,5,華南永昌-民權,2024-12-17,9312
2301,光寶科,5,0,5,華南永昌-民權,2024-12-17,9312
3264,欣銓,6,1,5,華南永昌-民權,2024-12-17,9312
3380,明泰,6,1,5,華南永昌-民權,2024-12-17,9312
3615,安可,5,0,5,華南永昌-民權,2024-12-17,9312
4714,永捷,5,0,5,華南永昌-民權,2024-12-17,9312
6752,叡揚,5,0,5,華南永昌-民權,2024-12-17,9312
2449,京元電子,4,0,4,華南永昌-民權,2024-12-17,9312
6257,矽格,4,0,4,華南永昌-民權,2024-12-17,9312
1802,台玻,4,0,4,華南永昌-民權,2024-12-17,9312
2408,南亞科,43,39,4,華南永昌-民權,2024-12-17,9312
4739,康普,5,1,4,華南永昌-民權,2024-12-17,9312
8039,台虹,5,1,4,華南永昌-民權,2024-12-17,9312
00878,國泰永續高股息,3,0,3,華南永昌-民權,2024-12-17,9312
1216,統一,3,0,3,華南永昌-民權,2024-12-17,9312
5309,系統電,3,0,3,華南永昌-民權,2024-12-17,9312
2880,華南金,3,0,3,華南永昌-民權,2024-12-17,9312
2890,永豐金,3,0,3,華南永昌-民權,2024-12-17,9312
3029,零壹,42,39,3,華南永昌-民權,2024-12-17,9312
3481,群創,3,0,3,華南永昌-民權,2024-12-17,9312
6127,九豪,90,0,90,華南永昌-民權,2024-12-18,9312
00918,大華優利高填息30,49,0,49,華南永昌-民權,2024-12-18,9312
8039,台虹,48,0,48,華南永昌-民權,2024-12-18,9312
00959B,大華投等美債15Y+,40,0,40,華南永昌-民權,2024-12-18,9312
00953B,群益優選非投等債,26,0,26,華南永昌-民權,2024-12-18,9312
8054,安國,25,5,20,華南永昌-民權,2024-12-18,9312
9105,泰金寶-DR,22,2,20,華南永昌-民權,2024-12-18,9312
2610,華航,21,2,19,華南永昌-民權,2024-12-18,9312
6668,中揚光,19,0,19,華南永昌-民權,2024-12-18,9312
00915,凱基優選高股息30,13,0,13,華南永昌-民權,2024-12-18,9312
1303,南亞,13,0,13,華南永昌-民權,2024-12-18,9312
2886,兆豐金,13,0,13,華南永昌-民權,2024-12-18,9312
2303,聯電,49,38,11,華南永昌-民權,2024-12-18,9312
00680L,元大美債20正2,11,1,10,華南永昌-民權,2024-12-18,9312
3491,昇達科,10,0,10,華南永昌-民權,2024-12-18,9312
6509,聚和,10,0,10,華南永昌-民權,2024-12-18,9312
9931,欣高,10,0,10,華南永昌-民權,2024-12-18,9312
2637,慧洋-KY,9,0,9,華南永昌-民權,2024-12-18,9312
1410,南染,58,50,8,華南永昌-民權,2024-12-18,9312
3227,原相,8,0,8,華南永昌-民權,2024-12-18,9312
6104,創惟,12,4,8,華南永昌-民權,2024-12-18,9312
6706,惠特,10,2,8,華南永昌-民權,2024-12-18,9312
00933B,國泰10Y+金融債,7,0,7,華南永昌-民權,2024-12-18,9312
2354,鴻準,6,0,6,華南永昌-民權,2024-12-18,9312
8249,菱光,10,4,6,華南永昌-民權,2024-12-18,9312
00713,元大台灣高息低波,7,1,6,華南永昌-民權,2024-12-18,9312
3665,貿聯-KY,8,3,5,華南永昌-民權,2024-12-18,9312
3706,神達,28,23,5,華南永昌-民權,2024-12-18,9312
2349,錸德,5,0,5,華南永昌-民權,2024-12-18,9312
2417,圓剛,9,4,5,華南永昌-民權,2024-12-18,9312
2883,凱基金,5,0,5,華南永昌-民權,2024-12-18,9312
9928,中視,5,0,5,華南永昌-民權,2024-12-18,9312
2884,玉山金,5,1,4,華南永昌-民權,2024-12-18,9312
1795,美時,5,1,4,華南永昌-民權,2024-12-18,9312
2801,彰銀,4,0,4,華南永昌-民權,2024-12-18,9312
6770,力積電,5,1,4,華南永昌-民權,2024-12-18,9312
2382,廣達,5,1,4,華南永昌-民權,2024-12-18,9312
3211,順達,16,13,3,華南永昌-民權,2024-12-18,9312
1308,亞聚,3,0,3,華南永昌-民權,2024-12-18,9312
2392,正崴,5,2,3,華南永昌-民權,2024-12-18,9312
2426,鼎元,3,0,3,華南永昌-民權,2024-12-18,9312
2486,一詮,5,2,3,華南永昌-民權,2024-12-18,9312
2615,萬海,5,2,3,華南永昌-民權,2024-12-18,9312
3049,精金,3,0,3,華南永昌-民權,2024-12-18,9312
5871,中租-KY,4,1,3,華南永昌-民權,2024-12-18,9312
5880,合庫金,3,0,3,華南永昌-民權,2024-12-18,9312
3661,世芯-KY,6,3,3,華南永昌-民權,2024-12-18,9312
6962,ITH-KY,3,0,3,華南永昌-民權,2024-12-18,9312
5371,中光電,3,0,3,華南永昌-民權,2024-12-18,9312
2618,長榮航,17,14,3,華南永昌-民權,2024-12-18,9312
2801,彰銀,352,0,352,華南永昌-民權,2024-12-19,9312
2881,富邦金,102,0,102,華南永昌-民權,2024-12-19,9312
00679B,元大美債20年,63,0,63,華南永昌-民權,2024-12-19,9312
6127,九豪,55,0,55,華南永昌-民權,2024-12-19,9312
00918,大華優利高填息30,46,0,46,華南永昌-民權,2024-12-19,9312
00680L,元大美債20正2,40,0,40,華南永昌-民權,2024-12-19,9312
00937B,群益ESG投等債20,36,0,36,華南永昌-民權,2024-12-19,9312
2330,台積電,35,2,33,華南永昌-民權,2024-12-19,9312
2408,南亞科,106,73,33,華南永昌-民權,2024-12-19,9312
00915,凱基優選高股息30,32,0,32,華南永昌-民權,2024-12-19,9312
00878,國泰永續高股息,28,3,25,華南永昌-民權,2024-12-19,9312
2303,聯電,26,4,22,華南永昌-民權,2024-12-19,9312
2887,台新金,22,0,22,華南永昌-民權,2024-12-19,9312
2883,凱基金,21,0,21,華南永昌-民權,2024-12-19,9312
00753L,中信中國50正2,20,4,16,華南永昌-民權,2024-12-19,9312
00712,復華富時不動產,16,0,16,華南永昌-民權,2024-12-19,9312
00953B,群益優選非投等債,24,8,16,華南永昌-民權,2024-12-19,9312
2317,鴻海,17,1,16,華南永昌-民權,2024-12-19,9312
2382,廣達,15,3,12,華南永昌-民權,2024-12-19,9312
0056,元大高股息,11,0,11,華南永昌-民權,2024-12-19,9312
2836,高雄銀,11,0,11,華南永昌-民權,2024-12-19,9312
00900,富邦特選高股息30,10,0,10,華南永昌-民權,2024-12-19,9312
00970B,新光BBB投等債20,10,0,10,華南永昌-民權,2024-12-19,9312
1303,南亞,10,0,10,華南永昌-民權,2024-12-19,9312
2888,新光金,10,0,10,華南永昌-民權,2024-12-19,9312
2002,中鋼,10,0,10,華南永昌-民權,2024-12-19,9312
2880,華南金,9,0,9,華南永昌-民權,2024-12-19,9312
00922,國泰台灣領袖50,9,0,9,華南永昌-民權,2024-12-19,9312
2812,台中銀,17,8,9,華南永昌-民權,2024-12-19,9312
1722,台肥,9,0,9,華南永昌-民權,2024-12-19,9312
4113,聯上,9,0,9,華南永昌-民權,2024-12-19,9312
4931,新盛力,16,7,9,華南永昌-民權,2024-12-19,9312
6285,啟��,41,32,9,華南永昌-民權,2024-12-19,9312
1410,南染,68,60,8,華南永昌-民權,2024-12-19,9312
8021,尖點,8,0,8,華南永昌-民權,2024-12-19,9312
00713,元大台灣高息低波,7,0,7,華南永昌-民權,2024-12-19,9312
2834,臺企銀,7,0,7,華南永昌-民權,2024-12-19,9312
00751B,元大AAA至A公司債,10,3,7,華南永昌-民權,2024-12-19,9312
00687B,國泰20年美債,21,14,7,華南永昌-民權,2024-12-19,9312
1313,聯成,7,0,7,華南永昌-民權,2024-12-19,9312
2609,陽明,9,2,7,華南永昌-民權,2024-12-19,9312
3491,昇達科,6,0,6,華南永昌-民權,2024-12-19,9312
2845,遠東銀,6,1,5,華南永昌-民權,2024-12-19,9312
2884,玉山金,5,0,5,華南永昌-民權,2024-12-19,9312
2618,長榮航,8,3,5,華南永昌-民權,2024-12-19,9312
00909,國泰數位支付服務,5,0,5,華南永昌-民權,2024-12-19,9312
00933B,國泰10Y+金融債,5,0,5,華南永昌-民權,2024-12-19,9312
3704,合勤控,5,0,5,華南永昌-民權,2024-12-19,9312
5871,中租-KY,5,0,5,華南永昌-民權,2024-12-19,9312
6670,復盛應用,5,0,5,華南永昌-民權,2024-12-19,9312
