Ticker,Name,buy,sell,diff,Branch,Date,Branch_Code
00673R,期元大S＆P原油反1,268,0,268,富邦-宜蘭,2023-01-03,9686
3479,安勤,60,3,57,富邦-宜蘭,2023-01-03,9686
00632R,元大台灣50反1,39,0,39,富邦-宜蘭,2023-01-03,9686
00637L,元大滬深300正2,26,2,24,富邦-宜蘭,2023-01-03,9686
2317,鴻海,27,3,24,富邦-宜蘭,2023-01-03,9686
1605,華新,72,50,22,富邦-宜蘭,2023-01-03,9686
2609,陽明,38,18,20,富邦-宜蘭,2023-01-03,9686
0056,元大高股息,16,0,16,富邦-宜蘭,2023-01-03,9686
6443,元晶,16,1,15,富邦-宜蘭,2023-01-03,9686
4746,台耀,15,2,13,富邦-宜蘭,2023-01-03,9686
1524,耿鼎,14,2,12,富邦-宜蘭,2023-01-03,9686
00830,國泰費城半導體,11,0,11,富邦-宜蘭,2023-01-03,9686
2867,三商壽,13,2,11,富邦-宜蘭,2023-01-03,9686
4171,瑞基,14,3,11,富邦-宜蘭,2023-01-03,9686
2542,興富發,10,0,10,富邦-宜蘭,2023-01-03,9686
6153,嘉聯益,10,0,10,富邦-宜蘭,2023-01-03,9686
3494,誠研,10,0,10,富邦-宜蘭,2023-01-03,9686
6180,橘子,12,2,10,富邦-宜蘭,2023-01-03,9686
2331,精英,10,0,10,富邦-宜蘭,2023-01-03,9686
00669R,國泰美國道瓊反1,10,0,10,富邦-宜蘭,2023-01-03,9686
1701,中化,12,3,9,富邦-宜蘭,2023-01-03,9686
6589,台康生技,10,1,9,富邦-宜蘭,2023-01-03,9686
8033,雷虎,10,1,9,富邦-宜蘭,2023-01-03,9686
4121,優盛,9,0,9,富邦-宜蘭,2023-01-03,9686
3705,永信,10,1,9,富邦-宜蘭,2023-01-03,9686
2882,國泰金,11,2,9,富邦-宜蘭,2023-01-03,9686
00712,復華富時不動產,9,0,9,富邦-宜蘭,2023-01-03,9686
9103,美德醫療-DR,8,0,8,富邦-宜蘭,2023-01-03,9686
2883,凱基金,12,4,8,富邦-宜蘭,2023-01-03,9686
2603,長榮,29,22,7,富邦-宜蘭,2023-01-03,9686
00713,元大台灣高息低波,19,12,7,富邦-宜蘭,2023-01-03,9686
2444,兆勁,9,2,7,富邦-宜蘭,2023-01-03,9686
00665L,富邦�琤肭磪囓�2,7,0,7,富邦-宜蘭,2023-01-03,9686
1102,亞泥,7,0,7,富邦-宜蘭,2023-01-03,9686
2615,萬海,7,1,6,富邦-宜蘭,2023-01-03,9686
2612,中航,10,4,6,富邦-宜蘭,2023-01-03,9686
2379,瑞昱,6,1,5,富邦-宜蘭,2023-01-03,9686
1519,華城,8,3,5,富邦-宜蘭,2023-01-03,9686
2305,全友,5,0,5,富邦-宜蘭,2023-01-03,9686
1806,冠軍,5,0,5,富邦-宜蘭,2023-01-03,9686
1734,杏輝,7,2,5,富邦-宜蘭,2023-01-03,9686
1506,正道,5,0,5,富邦-宜蘭,2023-01-03,9686
1584,精剛,11,6,5,富邦-宜蘭,2023-01-03,9686
6125,廣運,5,0,5,富邦-宜蘭,2023-01-03,9686
1309,台達化,5,0,5,富邦-宜蘭,2023-01-03,9686
6118,建達,68,64,4,富邦-宜蘭,2023-01-03,9686
5009,榮剛,13,9,4,富邦-宜蘭,2023-01-03,9686
1718,中纖,5,1,4,富邦-宜蘭,2023-01-03,9686
2208,台船,5,1,4,富邦-宜蘭,2023-01-03,9686
1437,勤益控,4,0,4,富邦-宜蘭,2023-01-03,9686
00893,國泰智能電動車,55,0,55,富邦-宜蘭,2023-01-04,9686
00902,中信電池及儲能,41,0,41,富邦-宜蘭,2023-01-04,9686
2317,鴻海,39,3,36,富邦-宜蘭,2023-01-04,9686
2409,友達,53,26,27,富邦-宜蘭,2023-01-04,9686
4904,遠傳,20,0,20,富邦-宜蘭,2023-01-04,9686
3189,景碩,22,2,20,富邦-宜蘭,2023-01-04,9686
2027,大成鋼,18,0,18,富邦-宜蘭,2023-01-04,9686
2609,陽明,22,4,18,富邦-宜蘭,2023-01-04,9686
9955,佳龍,16,0,16,富邦-宜蘭,2023-01-04,9686
2618,長榮航,14,2,12,富邦-宜蘭,2023-01-04,9686
2465,麗臺,16,4,12,富邦-宜蘭,2023-01-04,9686
00830,國泰費城半導體,11,0,11,富邦-宜蘭,2023-01-04,9686
6443,元晶,16,5,11,富邦-宜蘭,2023-01-04,9686
4746,台耀,11,0,11,富邦-宜蘭,2023-01-04,9686
2030,彰源,10,0,10,富邦-宜蘭,2023-01-04,9686
6235,華孚,19,9,10,富邦-宜蘭,2023-01-04,9686
00706L,期元大S＆P日圓正2,10,0,10,富邦-宜蘭,2023-01-04,9686
1786,科妍,10,0,10,富邦-宜蘭,2023-01-04,9686
6598,ABC-KY,10,0,10,富邦-宜蘭,2023-01-04,9686
1316,上曜,10,1,9,富邦-宜蘭,2023-01-04,9686
0050,元大台灣50,9,0,9,富邦-宜蘭,2023-01-04,9686
3272,東碩,12,3,9,富邦-宜蘭,2023-01-04,9686
1444,力麗,14,5,9,富邦-宜蘭,2023-01-04,9686
1905,華紙,9,0,9,富邦-宜蘭,2023-01-04,9686
9919,康那香,9,0,9,富邦-宜蘭,2023-01-04,9686
2882,國泰金,12,4,8,富邦-宜蘭,2023-01-04,9686
8033,雷虎,13,5,8,富邦-宜蘭,2023-01-04,9686
1513,中興電,53,45,8,富邦-宜蘭,2023-01-04,9686
1605,華新,81,74,7,富邦-宜蘭,2023-01-04,9686
2637,慧洋-KY,8,1,7,富邦-宜蘭,2023-01-04,9686
2615,萬海,7,0,7,富邦-宜蘭,2023-01-04,9686
8046,南電,6,0,6,富邦-宜蘭,2023-01-04,9686
6141,柏承,6,0,6,富邦-宜蘭,2023-01-04,9686
3037,欣興,9,3,6,富邦-宜蘭,2023-01-04,9686
00669R,國泰美國道瓊反1,5,0,5,富邦-宜蘭,2023-01-04,9686
6456,GIS-KY,12,7,5,富邦-宜蘭,2023-01-04,9686
3520,華盈,5,0,5,富邦-宜蘭,2023-01-04,9686
4906,正文,6,1,5,富邦-宜蘭,2023-01-04,9686
6472,保瑞,4,0,4,富邦-宜蘭,2023-01-04,9686
3545,敦泰,5,1,4,富邦-宜蘭,2023-01-04,9686
4739,康普,4,0,4,富邦-宜蘭,2023-01-04,9686
1101,台泥,4,0,4,富邦-宜蘭,2023-01-04,9686
2014,中鴻,9,5,4,富邦-宜蘭,2023-01-04,9686
3711,日月光投控,4,0,4,富邦-宜蘭,2023-01-04,9686
1760,寶齡富錦,6,2,4,富邦-宜蘭,2023-01-04,9686
1524,耿鼎,4,0,4,富邦-宜蘭,2023-01-04,9686
00650L,復華香港正2,30,26,4,富邦-宜蘭,2023-01-04,9686
6279,胡連,4,0,4,富邦-宜蘭,2023-01-04,9686
3083,網龍,4,0,4,富邦-宜蘭,2023-01-04,9686
2603,長榮,29,26,3,富邦-宜蘭,2023-01-04,9686
6245,立端,90,0,90,富邦-宜蘭,2023-01-05,9686
00715L,期街口布蘭特正2,83,0,83,富邦-宜蘭,2023-01-05,9686
00706L,期元大S＆P日圓正2,78,0,78,富邦-宜蘭,2023-01-05,9686
4743,合一,74,2,72,富邦-宜蘭,2023-01-05,9686
4979,華星光,34,2,32,富邦-宜蘭,2023-01-05,9686
4157,太景*-KY,32,1,31,富邦-宜蘭,2023-01-05,9686
1529,樂事綠能,43,16,27,富邦-宜蘭,2023-01-05,9686
2317,鴻海,39,13,26,富邦-宜蘭,2023-01-05,9686
8358,金居,24,4,20,富邦-宜蘭,2023-01-05,9686
00674R,期元大S＆P黃金反1,20,0,20,富邦-宜蘭,2023-01-05,9686
5907,大洋-KY,24,4,20,富邦-宜蘭,2023-01-05,9686
2497,怡利電,16,1,15,富邦-宜蘭,2023-01-05,9686
00665L,富邦�琤肭磪囓�2,15,1,14,富邦-宜蘭,2023-01-05,9686
3037,欣興,19,6,13,富邦-宜蘭,2023-01-05,9686
6104,創惟,18,5,13,富邦-宜蘭,2023-01-05,9686
2610,華航,13,1,12,富邦-宜蘭,2023-01-05,9686
1513,中興電,18,6,12,富邦-宜蘭,2023-01-05,9686
1519,華城,17,6,11,富邦-宜蘭,2023-01-05,9686
2889,國票金,20,10,10,富邦-宜蘭,2023-01-05,9686
8044,網家,19,9,10,富邦-宜蘭,2023-01-05,9686
2903,遠百,10,0,10,富邦-宜蘭,2023-01-05,9686
1444,力麗,20,10,10,富邦-宜蘭,2023-01-05,9686
1605,華新,32,22,10,富邦-宜蘭,2023-01-05,9686
1560,中砂,11,1,10,富邦-宜蘭,2023-01-05,9686
3027,盛達,26,16,10,富邦-宜蘭,2023-01-05,9686
2609,陽明,27,18,9,富邦-宜蘭,2023-01-05,9686
0056,元大高股息,10,1,9,富邦-宜蘭,2023-01-05,9686
5009,榮剛,10,1,9,富邦-宜蘭,2023-01-05,9686
1736,喬山,11,2,9,富邦-宜蘭,2023-01-05,9686
8069,元太,15,7,8,富邦-宜蘭,2023-01-05,9686
3051,力特,8,0,8,富邦-宜蘭,2023-01-05,9686
3272,東碩,10,2,8,富邦-宜蘭,2023-01-05,9686
00770,國泰北美科技,8,0,8,富邦-宜蘭,2023-01-05,9686
1319,東陽,8,1,7,富邦-宜蘭,2023-01-05,9686
2419,仲琦,12,6,6,富邦-宜蘭,2023-01-05,9686
4162,智擎,6,0,6,富邦-宜蘭,2023-01-05,9686
1810,和成,5,0,5,富邦-宜蘭,2023-01-05,9686
2614,東森,35,30,5,富邦-宜蘭,2023-01-05,9686
2520,冠德,8,3,5,富邦-宜蘭,2023-01-05,9686
00902,中信電池及儲能,5,0,5,富邦-宜蘭,2023-01-05,9686
00632R,元大台灣50反1,12,7,5,富邦-宜蘭,2023-01-05,9686
2007,燁興,5,0,5,富邦-宜蘭,2023-01-05,9686
5245,智晶,5,0,5,富邦-宜蘭,2023-01-05,9686
8933,愛地雅,5,0,5,富邦-宜蘭,2023-01-05,9686
2022,聚亨,4,0,4,富邦-宜蘭,2023-01-05,9686
3704,合勤控,9,5,4,富邦-宜蘭,2023-01-05,9686
3149,正達,4,0,4,富邦-宜蘭,2023-01-05,9686
3712,永崴投控,4,0,4,富邦-宜蘭,2023-01-05,9686
1305,華夏,8,4,4,富邦-宜蘭,2023-01-05,9686
4746,台耀,5,1,4,富邦-宜蘭,2023-01-05,9686
00706L,期元大S＆P日圓正2,100,0,100,富邦-宜蘭,2023-01-06,9686
6116,彩晶,63,0,63,富邦-宜蘭,2023-01-06,9686
8121,越峰,60,0,60,富邦-宜蘭,2023-01-06,9686
6118,建達,60,17,43,富邦-宜蘭,2023-01-06,9686
00720B,元大投資級公司債,33,0,33,富邦-宜蘭,2023-01-06,9686
00881,國泰台灣5G+,31,2,29,富邦-宜蘭,2023-01-06,9686
00632R,元大台灣50反1,24,0,24,富邦-宜蘭,2023-01-06,9686
6215,和椿,24,1,23,富邦-宜蘭,2023-01-06,9686
00753L,中信中國50正2,20,0,20,富邦-宜蘭,2023-01-06,9686
2368,金像電,20,1,19,富邦-宜蘭,2023-01-06,9686
1701,中化,30,12,18,富邦-宜蘭,2023-01-06,9686
2363,矽統,15,0,15,富邦-宜蘭,2023-01-06,9686
2317,鴻海,18,5,13,富邦-宜蘭,2023-01-06,9686
8933,愛地雅,13,0,13,富邦-宜蘭,2023-01-06,9686
00671R,富邦NASDAQ反1,24,12,12,富邦-宜蘭,2023-01-06,9686
2610,華航,11,0,11,富邦-宜蘭,2023-01-06,9686
00916,國泰全球品牌50,11,1,10,富邦-宜蘭,2023-01-06,9686
2903,遠百,10,0,10,富邦-宜蘭,2023-01-06,9686
2915,潤泰全,10,0,10,富邦-宜蘭,2023-01-06,9686
6176,瑞儀,10,0,10,富邦-宜蘭,2023-01-06,9686
3576,聯合再生,10,0,10,富邦-宜蘭,2023-01-06,9686
2104,國際中橡,10,0,10,富邦-宜蘭,2023-01-06,9686
5009,榮剛,10,1,9,富邦-宜蘭,2023-01-06,9686
8271,宇瞻,10,1,9,富邦-宜蘭,2023-01-06,9686
3128,昇銳,12,3,9,富邦-宜蘭,2023-01-06,9686
1503,士電,11,3,8,富邦-宜蘭,2023-01-06,9686
1325,恆大,8,0,8,富邦-宜蘭,2023-01-06,9686
3705,永信,8,0,8,富邦-宜蘭,2023-01-06,9686
8049,晶采,16,8,8,富邦-宜蘭,2023-01-06,9686
3013,晟銘電,9,2,7,富邦-宜蘭,2023-01-06,9686
6531,愛普*,11,4,7,富邦-宜蘭,2023-01-06,9686
00670L,富邦NASDAQ正2,6,0,6,富邦-宜蘭,2023-01-06,9686
8044,網家,23,17,6,富邦-宜蘭,2023-01-06,9686
9941,裕融,6,0,6,富邦-宜蘭,2023-01-06,9686
4746,台耀,15,9,6,富邦-宜蘭,2023-01-06,9686
00641R,富邦日本反1,6,0,6,富邦-宜蘭,2023-01-06,9686
3714,富采,7,2,5,富邦-宜蘭,2023-01-06,9686
00665L,富邦�琤肭磪囓�2,10,5,5,富邦-宜蘭,2023-01-06,9686
6550,北極星藥業-KY,5,0,5,富邦-宜蘭,2023-01-06,9686
3706,神達,5,0,5,富邦-宜蘭,2023-01-06,9686
3693,營邦,5,0,5,富邦-宜蘭,2023-01-06,9686
6443,元晶,6,1,5,富邦-宜蘭,2023-01-06,9686
2614,東森,6,1,5,富邦-宜蘭,2023-01-06,9686
1605,華新,28,23,5,富邦-宜蘭,2023-01-06,9686
8222,寶一,5,0,5,富邦-宜蘭,2023-01-06,9686
1301,台塑,6,1,5,富邦-宜蘭,2023-01-06,9686
1514,亞力,5,0,5,富邦-宜蘭,2023-01-06,9686
00770,國泰北美科技,5,0,5,富邦-宜蘭,2023-01-06,9686
3083,網龍,4,0,4,富邦-宜蘭,2023-01-06,9686
8171,天宇,8,4,4,富邦-宜蘭,2023-01-06,9686
00632R,元大台灣50反1,150,25,125,富邦-宜蘭,2023-01-09,9686
1312,國喬,101,1,100,富邦-宜蘭,2023-01-09,9686
1304,台聚,100,2,98,富邦-宜蘭,2023-01-09,9686
00720B,元大投資級公司債,81,1,80,富邦-宜蘭,2023-01-09,9686
3231,緯創,102,30,72,富邦-宜蘭,2023-01-09,9686
1720,生達,75,4,71,富邦-宜蘭,2023-01-09,9686
2603,長榮,75,15,60,富邦-宜蘭,2023-01-09,9686
00885,富邦越南,37,0,37,富邦-宜蘭,2023-01-09,9686
6770,力積電,67,43,24,富邦-宜蘭,2023-01-09,9686
00664R,國泰臺灣加權反1,23,0,23,富邦-宜蘭,2023-01-09,9686
2104,國際中橡,22,0,22,富邦-宜蘭,2023-01-09,9686
1460,宏遠,20,0,20,富邦-宜蘭,2023-01-09,9686
6016,康和證,20,0,20,富邦-宜蘭,2023-01-09,9686
00674R,期元大S＆P黃金反1,20,0,20,富邦-宜蘭,2023-01-09,9686
3494,誠研,19,0,19,富邦-宜蘭,2023-01-09,9686
2609,陽明,26,8,18,富邦-宜蘭,2023-01-09,9686
2883,凱基金,22,7,15,富邦-宜蘭,2023-01-09,9686
2317,鴻海,20,6,14,富邦-宜蘭,2023-01-09,9686
5347,世界,23,9,14,富邦-宜蘭,2023-01-09,9686
1605,華新,38,25,13,富邦-宜蘭,2023-01-09,9686
5469,瀚宇博,12,0,12,富邦-宜蘭,2023-01-09,9686
2345,智邦,13,1,12,富邦-宜蘭,2023-01-09,9686
5227,立凱-KY,14,2,12,富邦-宜蘭,2023-01-09,9686
3141,晶宏,12,0,12,富邦-宜蘭,2023-01-09,9686
2328,廣宇,11,0,11,富邦-宜蘭,2023-01-09,9686
1701,中化,14,3,11,富邦-宜蘭,2023-01-09,9686
8450,霹靂,10,0,10,富邦-宜蘭,2023-01-09,9686
3498,陽程,10,0,10,富邦-宜蘭,2023-01-09,9686
3094,聯傑,10,0,10,富邦-宜蘭,2023-01-09,9686
00919,群益台灣精選高息,10,0,10,富邦-宜蘭,2023-01-09,9686
2520,冠德,10,0,10,富邦-宜蘭,2023-01-09,9686
6180,橘子,9,0,9,富邦-宜蘭,2023-01-09,9686
2401,凌陽,10,1,9,富邦-宜蘭,2023-01-09,9686
6531,愛普*,11,2,9,富邦-宜蘭,2023-01-09,9686
2481,強茂,11,3,8,富邦-宜蘭,2023-01-09,9686
4532,瑞智,8,0,8,富邦-宜蘭,2023-01-09,9686
8069,元太,12,4,8,富邦-宜蘭,2023-01-09,9686
8050,廣積,6,0,6,富邦-宜蘭,2023-01-09,9686
6223,旺矽,8,2,6,富邦-宜蘭,2023-01-09,9686
2890,永豐金,6,0,6,富邦-宜蘭,2023-01-09,9686
6509,聚和,8,2,6,富邦-宜蘭,2023-01-09,9686
6285,啟��,5,0,5,富邦-宜蘭,2023-01-09,9686
3708,上緯投控,5,0,5,富邦-宜蘭,2023-01-09,9686
1541,錩泰,5,0,5,富邦-宜蘭,2023-01-09,9686
6508,惠光,5,0,5,富邦-宜蘭,2023-01-09,9686
4123,晟德,5,0,5,富邦-宜蘭,2023-01-09,9686
2612,中航,6,1,5,富邦-宜蘭,2023-01-09,9686
2495,普安,5,0,5,富邦-宜蘭,2023-01-09,9686
2007,燁興,5,0,5,富邦-宜蘭,2023-01-09,9686
1325,恆大,5,0,5,富邦-宜蘭,2023-01-09,9686
2852,第一保,100,0,100,富邦-宜蘭,2023-01-10,9686
1444,力麗,89,9,80,富邦-宜蘭,2023-01-10,9686
1736,喬山,45,1,44,富邦-宜蘭,2023-01-10,9686
9940,信義,36,0,36,富邦-宜蘭,2023-01-10,9686
3576,聯合再生,26,0,26,富邦-宜蘭,2023-01-10,9686
6109,亞元,30,4,26,富邦-宜蘭,2023-01-10,9686
2104,國際中橡,24,0,24,富邦-宜蘭,2023-01-10,9686
1727,中華化,20,0,20,富邦-宜蘭,2023-01-10,9686
3444,利機,20,0,20,富邦-宜蘭,2023-01-10,9686
1514,亞力,19,0,19,富邦-宜蘭,2023-01-10,9686
2468,華經,20,1,19,富邦-宜蘭,2023-01-10,9686
00706L,期元大S＆P日圓正2,16,0,16,富邦-宜蘭,2023-01-10,9686
2363,矽統,22,6,16,富邦-宜蘭,2023-01-10,9686
2881,富邦金,16,2,14,富邦-宜蘭,2023-01-10,9686
1314,中石化,13,0,13,富邦-宜蘭,2023-01-10,9686
6223,旺矽,13,1,12,富邦-宜蘭,2023-01-10,9686
6461,益得,20,8,12,富邦-宜蘭,2023-01-10,9686
5608,四維航,12,0,12,富邦-宜蘭,2023-01-10,9686
2609,陽明,18,7,11,富邦-宜蘭,2023-01-10,9686
2444,兆勁,11,0,11,富邦-宜蘭,2023-01-10,9686
00773B,中信優先金融債,11,0,11,富邦-宜蘭,2023-01-10,9686
2374,佳能,10,0,10,富邦-宜蘭,2023-01-10,9686
5469,瀚宇博,10,0,10,富邦-宜蘭,2023-01-10,9686
2401,凌陽,10,0,10,富邦-宜蘭,2023-01-10,9686
6684,安格,10,0,10,富邦-宜蘭,2023-01-10,9686
00664R,國泰臺灣加權反1,10,0,10,富邦-宜蘭,2023-01-10,9686
6508,惠光,10,0,10,富邦-宜蘭,2023-01-10,9686
911868,同方友友-DR,10,0,10,富邦-宜蘭,2023-01-10,9686
2428,興勤,10,1,9,富邦-宜蘭,2023-01-10,9686
2413,環科,8,0,8,富邦-宜蘭,2023-01-10,9686
2929,淘帝-KY,8,0,8,富邦-宜蘭,2023-01-10,9686
4102,永日,11,3,8,富邦-宜蘭,2023-01-10,9686
1524,耿鼎,8,0,8,富邦-宜蘭,2023-01-10,9686
1319,東陽,9,1,8,富邦-宜蘭,2023-01-10,9686
3189,景碩,8,1,7,富邦-宜蘭,2023-01-10,9686
1720,生達,37,30,7,富邦-宜蘭,2023-01-10,9686
3128,昇銳,27,20,7,富邦-宜蘭,2023-01-10,9686
1708,東鹼,8,1,7,富邦-宜蘭,2023-01-10,9686
6274,台燿,9,3,6,富邦-宜蘭,2023-01-10,9686
0056,元大高股息,12,7,5,富邦-宜蘭,2023-01-10,9686
1609,大亞,6,1,5,富邦-宜蘭,2023-01-10,9686
1218,泰山,20,15,5,富邦-宜蘭,2023-01-10,9686
3083,網龍,5,0,5,富邦-宜蘭,2023-01-10,9686
1308,亞聚,5,0,5,富邦-宜蘭,2023-01-10,9686
6443,元晶,46,41,5,富邦-宜蘭,2023-01-10,9686
6261,久元,5,0,5,富邦-宜蘭,2023-01-10,9686
00650L,復華香港正2,15,10,5,富邦-宜蘭,2023-01-10,9686
6279,胡連,5,0,5,富邦-宜蘭,2023-01-10,9686
2884,玉山金,5,0,5,富邦-宜蘭,2023-01-10,9686
2014,中鴻,7,2,5,富邦-宜蘭,2023-01-10,9686
2897,王道銀行,351,0,351,富邦-宜蘭,2023-01-11,9686
2845,遠東銀,220,2,218,富邦-宜蘭,2023-01-11,9686
00673R,期元大S＆P原油反1,200,0,200,富邦-宜蘭,2023-01-11,9686
2610,華航,100,5,95,富邦-宜蘭,2023-01-11,9686
4979,華星光,66,22,44,富邦-宜蘭,2023-01-11,9686
6245,立端,40,0,40,富邦-宜蘭,2023-01-11,9686
6231,系微,40,0,40,富邦-宜蘭,2023-01-11,9686
8227,巨有科技,27,6,21,富邦-宜蘭,2023-01-11,9686
00674R,期元大S＆P黃金反1,20,0,20,富邦-宜蘭,2023-01-11,9686
2537,聯上發,20,0,20,富邦-宜蘭,2023-01-11,9686
00706L,期元大S＆P日圓正2,20,0,20,富邦-宜蘭,2023-01-11,9686
00679B,元大美債20年,16,0,16,富邦-宜蘭,2023-01-11,9686
3704,合勤控,17,1,16,富邦-宜蘭,2023-01-11,9686
6186,新潤,17,2,15,富邦-宜蘭,2023-01-11,9686
00632R,元大台灣50反1,16,2,14,富邦-宜蘭,2023-01-11,9686
9940,信義,14,0,14,富邦-宜蘭,2023-01-11,9686
6461,益得,20,6,14,富邦-宜蘭,2023-01-11,9686
1513,中興電,27,14,13,富邦-宜蘭,2023-01-11,9686
2317,鴻海,13,0,13,富邦-宜蘭,2023-01-11,9686
4130,健亞,12,0,12,富邦-宜蘭,2023-01-11,9686
2104,國際中橡,11,0,11,富邦-宜蘭,2023-01-11,9686
1529,樂事綠能,14,4,10,富邦-宜蘭,2023-01-11,9686
1795,美時,19,9,10,富邦-宜蘭,2023-01-11,9686
2302,麗正,10,0,10,富邦-宜蘭,2023-01-11,9686
2889,國票金,10,0,10,富邦-宜蘭,2023-01-11,9686
2543,皇昌,10,0,10,富邦-宜蘭,2023-01-11,9686
2313,華通,12,2,10,富邦-宜蘭,2023-01-11,9686
00919,群益台灣精選高息,10,2,8,富邦-宜蘭,2023-01-11,9686
2618,長榮航,29,21,8,富邦-宜蘭,2023-01-11,9686
3444,利機,7,0,7,富邦-宜蘭,2023-01-11,9686
3027,盛達,12,5,7,富邦-宜蘭,2023-01-11,9686
2882,國泰金,15,9,6,富邦-宜蘭,2023-01-11,9686
3479,安勤,6,0,6,富邦-宜蘭,2023-01-11,9686
4916,事欣科,11,5,6,富邦-宜蘭,2023-01-11,9686
2884,玉山金,7,1,6,富邦-宜蘭,2023-01-11,9686
3419,譁裕,8,2,6,富邦-宜蘭,2023-01-11,9686
4977,眾達-KY,6,0,6,富邦-宜蘭,2023-01-11,9686
6111,大宇資,7,2,5,富邦-宜蘭,2023-01-11,9686
2368,金像電,5,0,5,富邦-宜蘭,2023-01-11,9686
2028,威致,5,0,5,富邦-宜蘭,2023-01-11,9686
3587,閎康,6,1,5,富邦-宜蘭,2023-01-11,9686
4961,天鈺,8,3,5,富邦-宜蘭,2023-01-11,9686
4943,康控-KY,5,0,5,富邦-宜蘭,2023-01-11,9686
8215,明基材,5,0,5,富邦-宜蘭,2023-01-11,9686
6509,聚和,5,0,5,富邦-宜蘭,2023-01-11,9686
3287,廣寰科,5,0,5,富邦-宜蘭,2023-01-11,9686
1734,杏輝,5,0,5,富邦-宜蘭,2023-01-11,9686
5388,中磊,5,0,5,富邦-宜蘭,2023-01-11,9686
2465,麗臺,5,0,5,富邦-宜蘭,2023-01-11,9686
6216,居易,5,0,5,富邦-宜蘭,2023-01-11,9686
2897,王道銀行,253,8,245,富邦-宜蘭,2023-01-12,9686
00673R,期元大S＆P原油反1,225,0,225,富邦-宜蘭,2023-01-12,9686
6461,益得,40,0,40,富邦-宜蘭,2023-01-12,9686
00878,國泰永續高股息,34,1,33,富邦-宜蘭,2023-01-12,9686
2030,彰源,30,0,30,富邦-宜蘭,2023-01-12,9686
0056,元大高股息,32,5,27,富邦-宜蘭,2023-01-12,9686
2358,廷鑫,40,18,22,富邦-宜蘭,2023-01-12,9686
00665L,富邦�琤肭磪囓�2,20,0,20,富邦-宜蘭,2023-01-12,9686
2408,南亞科,20,0,20,富邦-宜蘭,2023-01-12,9686
00882,中信中國高股息,19,0,19,富邦-宜蘭,2023-01-12,9686
6118,建達,20,1,19,富邦-宜蘭,2023-01-12,9686
2883,凱基金,20,1,19,富邦-宜蘭,2023-01-12,9686
1701,中化,17,1,16,富邦-宜蘭,2023-01-12,9686
9940,信義,15,0,15,富邦-宜蘭,2023-01-12,9686
1605,華新,42,27,15,富邦-宜蘭,2023-01-12,9686
1218,泰山,15,2,13,富邦-宜蘭,2023-01-12,9686
2409,友達,24,11,13,富邦-宜蘭,2023-01-12,9686
6197,佳必琪,12,0,12,富邦-宜蘭,2023-01-12,9686
5258,虹堡,12,0,12,富邦-宜蘭,2023-01-12,9686
6245,立端,12,0,12,富邦-宜蘭,2023-01-12,9686
2401,凌陽,11,0,11,富邦-宜蘭,2023-01-12,9686
2603,長榮,13,2,11,富邦-宜蘭,2023-01-12,9686
00671R,富邦NASDAQ反1,10,0,10,富邦-宜蘭,2023-01-12,9686
2610,華航,61,51,10,富邦-宜蘭,2023-01-12,9686
2014,中鴻,17,7,10,富邦-宜蘭,2023-01-12,9686
2313,華通,10,0,10,富邦-宜蘭,2023-01-12,9686
5014,建錩,11,1,10,富邦-宜蘭,2023-01-12,9686
6598,ABC-KY,10,0,10,富邦-宜蘭,2023-01-12,9686
3016,嘉晶,10,0,10,富邦-宜蘭,2023-01-12,9686
1612,宏泰,11,1,10,富邦-宜蘭,2023-01-12,9686
2615,萬海,15,5,10,富邦-宜蘭,2023-01-12,9686
1455,集盛,10,0,10,富邦-宜蘭,2023-01-12,9686
1217,愛之味,10,0,10,富邦-宜蘭,2023-01-12,9686
2317,鴻海,10,0,10,富邦-宜蘭,2023-01-12,9686
2880,華南金,19,9,10,富邦-宜蘭,2023-01-12,9686
5321,美而快,15,6,9,富邦-宜蘭,2023-01-12,9686
6156,松上,9,0,9,富邦-宜蘭,2023-01-12,9686
6509,聚和,9,0,9,富邦-宜蘭,2023-01-12,9686
4167,松瑞藥,14,5,9,富邦-宜蘭,2023-01-12,9686
5880,合庫金,8,0,8,富邦-宜蘭,2023-01-12,9686
3287,廣寰科,8,0,8,富邦-宜蘭,2023-01-12,9686
2884,玉山金,8,0,8,富邦-宜蘭,2023-01-12,9686
2009,第一銅,13,5,8,富邦-宜蘭,2023-01-12,9686
00753L,中信中國50正2,12,5,7,富邦-宜蘭,2023-01-12,9686
6865,偉康科技,7,0,7,富邦-宜蘭,2023-01-12,9686
6176,瑞儀,7,0,7,富邦-宜蘭,2023-01-12,9686
2489,瑞軒,7,0,7,富邦-宜蘭,2023-01-12,9686
1718,中纖,10,3,7,富邦-宜蘭,2023-01-12,9686
8150,南茂,7,0,7,富邦-宜蘭,2023-01-12,9686
2891,中信金,9,2,7,富邦-宜蘭,2023-01-12,9686
00673R,期元大S＆P原油反1,131,0,131,富邦-宜蘭,2023-01-13,9686
3047,訊舟,50,0,50,富邦-宜蘭,2023-01-13,9686
00632R,元大台灣50反1,43,1,42,富邦-宜蘭,2023-01-13,9686
2358,廷鑫,30,7,23,富邦-宜蘭,2023-01-13,9686
1608,華榮,21,1,20,富邦-宜蘭,2023-01-13,9686
00674R,期元大S＆P黃金反1,20,0,20,富邦-宜蘭,2023-01-13,9686
3481,群創,21,2,19,富邦-宜蘭,2023-01-13,9686
2409,友達,17,1,16,富邦-宜蘭,2023-01-13,9686
9940,信義,15,0,15,富邦-宜蘭,2023-01-13,9686
00669R,國泰美國道瓊反1,13,0,13,富邦-宜蘭,2023-01-13,9686
3576,聯合再生,15,3,12,富邦-宜蘭,2023-01-13,9686
6182,合晶,13,2,11,富邦-宜蘭,2023-01-13,9686
1718,中纖,11,0,11,富邦-宜蘭,2023-01-13,9686
2388,威盛,11,0,11,富邦-宜蘭,2023-01-13,9686
5388,中磊,11,0,11,富邦-宜蘭,2023-01-13,9686
00664R,國泰臺灣加權反1,10,0,10,富邦-宜蘭,2023-01-13,9686
1701,中化,12,2,10,富邦-宜蘭,2023-01-13,9686
2401,凌陽,10,0,10,富邦-宜蘭,2023-01-13,9686
3236,千如,10,0,10,富邦-宜蘭,2023-01-13,9686
2609,陽明,11,2,9,富邦-宜蘭,2023-01-13,9686
6550,北極星藥業-KY,10,1,9,富邦-宜蘭,2023-01-13,9686
00882,中信中國高股息,9,0,9,富邦-宜蘭,2023-01-13,9686
2317,鴻海,10,1,9,富邦-宜蘭,2023-01-13,9686
6197,佳必琪,8,0,8,富邦-宜蘭,2023-01-13,9686
8050,廣積,7,0,7,富邦-宜蘭,2023-01-13,9686
2887,台新金,6,0,6,富邦-宜蘭,2023-01-13,9686
8215,明基材,6,0,6,富邦-宜蘭,2023-01-13,9686
3499,環天科,6,0,6,富邦-宜蘭,2023-01-13,9686
3105,穩懋,16,11,5,富邦-宜蘭,2023-01-13,9686
4167,松瑞藥,16,11,5,富邦-宜蘭,2023-01-13,9686
6770,力積電,12,7,5,富邦-宜蘭,2023-01-13,9686
4123,晟德,5,0,5,富邦-宜蘭,2023-01-13,9686
8081,致新,5,0,5,富邦-宜蘭,2023-01-13,9686
1449,佳和,4,0,4,富邦-宜蘭,2023-01-13,9686
3704,合勤控,7,3,4,富邦-宜蘭,2023-01-13,9686
8086,宏捷科,4,0,4,富邦-宜蘭,2023-01-13,9686
00902,中信電池及儲能,5,1,4,富邦-宜蘭,2023-01-13,9686
3265,台星科,4,0,4,富邦-宜蘭,2023-01-13,9686
1720,生達,4,0,4,富邦-宜蘭,2023-01-13,9686
2498,宏達電,11,7,4,富邦-宜蘭,2023-01-13,9686
2465,麗臺,14,10,4,富邦-宜蘭,2023-01-13,9686
00753L,中信中國50正2,9,5,4,富邦-宜蘭,2023-01-13,9686
9945,潤泰新,6,3,3,富邦-宜蘭,2023-01-13,9686
5263,智崴,5,2,3,富邦-宜蘭,2023-01-13,9686
4105,東洋,3,0,3,富邦-宜蘭,2023-01-13,9686
1314,中石化,3,0,3,富邦-宜蘭,2023-01-13,9686
2230,泰茂,9,6,3,富邦-宜蘭,2023-01-13,9686
2399,映泰,11,8,3,富邦-宜蘭,2023-01-13,9686
3479,安勤,3,0,3,富邦-宜蘭,2023-01-13,9686
4114,健喬,25,22,3,富邦-宜蘭,2023-01-13,9686
2313,華通,188,0,188,富邦-宜蘭,2023-01-16,9686
00673R,期元大S＆P原油反1,120,0,120,富邦-宜蘭,2023-01-16,9686
6770,力積電,63,12,51,富邦-宜蘭,2023-01-16,9686
1609,大亞,25,0,25,富邦-宜蘭,2023-01-16,9686
00632R,元大台灣50反1,32,11,21,富邦-宜蘭,2023-01-16,9686
2317,鴻海,19,2,17,富邦-宜蘭,2023-01-16,9686
00724B,群益投資級金融債,15,0,15,富邦-宜蘭,2023-01-16,9686
6118,建達,25,10,15,富邦-宜蘭,2023-01-16,9686
2603,長榮,15,2,13,富邦-宜蘭,2023-01-16,9686
2915,潤泰全,12,0,12,富邦-宜蘭,2023-01-16,9686
6443,元晶,13,2,11,富邦-宜蘭,2023-01-16,9686
00669R,國泰美國道瓊反1,11,0,11,富邦-宜蘭,2023-01-16,9686
3013,晟銘電,10,0,10,富邦-宜蘭,2023-01-16,9686
1708,東鹼,10,0,10,富邦-宜蘭,2023-01-16,9686
1522,堤維西,10,0,10,富邦-宜蘭,2023-01-16,9686
2363,矽統,10,1,9,富邦-宜蘭,2023-01-16,9686
8933,愛地雅,11,3,8,富邦-宜蘭,2023-01-16,9686
2009,第一銅,8,1,7,富邦-宜蘭,2023-01-16,9686
3207,耀勝,7,0,7,富邦-宜蘭,2023-01-16,9686
2609,陽明,25,18,7,富邦-宜蘭,2023-01-16,9686
2405,輔信,6,0,6,富邦-宜蘭,2023-01-16,9686
00687B,國泰20年美債,6,0,6,富邦-宜蘭,2023-01-16,9686
2867,三商壽,6,0,6,富邦-宜蘭,2023-01-16,9686
00679B,元大美債20年,5,0,5,富邦-宜蘭,2023-01-16,9686
2886,兆豐金,7,2,5,富邦-宜蘭,2023-01-16,9686
2441,超豐,5,0,5,富邦-宜蘭,2023-01-16,9686
00903,富邦元宇宙,5,0,5,富邦-宜蘭,2023-01-16,9686
2104,國際中橡,5,0,5,富邦-宜蘭,2023-01-16,9686
2606,裕民,5,0,5,富邦-宜蘭,2023-01-16,9686
9938,百和,5,1,4,富邦-宜蘭,2023-01-16,9686
6155,鈞寶,6,2,4,富邦-宜蘭,2023-01-16,9686
6192,巨路,4,0,4,富邦-宜蘭,2023-01-16,9686
3027,盛達,20,16,4,富邦-宜蘭,2023-01-16,9686
6472,保瑞,4,0,4,富邦-宜蘭,2023-01-16,9686
2889,國票金,5,1,4,富邦-宜蘭,2023-01-16,9686
6233,旺玖,3,0,3,富邦-宜蘭,2023-01-16,9686
5321,美而快,4,1,3,富邦-宜蘭,2023-01-16,9686
9962,有益,3,0,3,富邦-宜蘭,2023-01-16,9686
2014,中鴻,10,7,3,富邦-宜蘭,2023-01-16,9686
2905,三商,4,1,3,富邦-宜蘭,2023-01-16,9686
6141,柏承,3,0,3,富邦-宜蘭,2023-01-16,9686
8054,安國,3,0,3,富邦-宜蘭,2023-01-16,9686
8931,大汽電,3,0,3,富邦-宜蘭,2023-01-16,9686
1101,台泥,9,7,2,富邦-宜蘭,2023-01-16,9686
3380,明泰,2,0,2,富邦-宜蘭,2023-01-16,9686
2754,亞洲藏壽司,2,0,2,富邦-宜蘭,2023-01-16,9686
4979,華星光,7,5,2,富邦-宜蘭,2023-01-16,9686
00900,富邦特選高股息30,4,2,2,富邦-宜蘭,2023-01-16,9686
2368,金像電,3,1,2,富邦-宜蘭,2023-01-16,9686
2882,國泰金,5,3,2,富邦-宜蘭,2023-01-16,9686
2888,新光金,52,2,50,富邦-宜蘭,2023-01-17,9686
00632R,元大台灣50反1,57,15,42,富邦-宜蘭,2023-01-17,9686
00905,FT臺灣Smart,30,0,30,富邦-宜蘭,2023-01-17,9686
00706L,期元大S＆P日圓正2,21,0,21,富邦-宜蘭,2023-01-17,9686
1783,和康生,20,0,20,富邦-宜蘭,2023-01-17,9686
2610,華航,36,16,20,富邦-宜蘭,2023-01-17,9686
00885,富邦越南,20,0,20,富邦-宜蘭,2023-01-17,9686
2419,仲琦,20,0,20,富邦-宜蘭,2023-01-17,9686
00715L,期街口布蘭特正2,15,0,15,富邦-宜蘭,2023-01-17,9686
6770,力積電,30,17,13,富邦-宜蘭,2023-01-17,9686
1809,中釉,13,1,12,富邦-宜蘭,2023-01-17,9686
2614,東森,13,1,12,富邦-宜蘭,2023-01-17,9686
2317,鴻海,17,6,11,富邦-宜蘭,2023-01-17,9686
1101,台泥,14,4,10,富邦-宜蘭,2023-01-17,9686
2615,萬海,10,0,10,富邦-宜蘭,2023-01-17,9686
00650L,復華香港正2,10,0,10,富邦-宜蘭,2023-01-17,9686
1234,黑松,10,0,10,富邦-宜蘭,2023-01-17,9686
2010,春源,10,0,10,富邦-宜蘭,2023-01-17,9686
5243,乙盛-KY,10,0,10,富邦-宜蘭,2023-01-17,9686
00655L,國泰中國A50正2,10,0,10,富邦-宜蘭,2023-01-17,9686
6118,建達,10,0,10,富邦-宜蘭,2023-01-17,9686
1519,華城,12,2,10,富邦-宜蘭,2023-01-17,9686
4943,康控-KY,9,0,9,富邦-宜蘭,2023-01-17,9686
3481,群創,13,4,9,富邦-宜蘭,2023-01-17,9686
2468,華經,14,5,9,富邦-宜蘭,2023-01-17,9686
2618,長榮航,10,1,9,富邦-宜蘭,2023-01-17,9686
6550,北極星藥業-KY,10,1,9,富邦-宜蘭,2023-01-17,9686
8255,朋程,8,0,8,富邦-宜蘭,2023-01-17,9686
3704,合勤控,11,4,7,富邦-宜蘭,2023-01-17,9686
00679B,元大美債20年,6,0,6,富邦-宜蘭,2023-01-17,9686
8171,天宇,7,1,6,富邦-宜蘭,2023-01-17,9686
9955,佳龍,8,2,6,富邦-宜蘭,2023-01-17,9686
2313,華通,7,1,6,富邦-宜蘭,2023-01-17,9686
6443,元晶,15,9,6,富邦-宜蘭,2023-01-17,9686
4931,新盛力,6,0,6,富邦-宜蘭,2023-01-17,9686
2884,玉山金,15,10,5,富邦-宜蘭,2023-01-17,9686
00882,中信中國高股息,5,0,5,富邦-宜蘭,2023-01-17,9686
2867,三商壽,5,0,5,富邦-宜蘭,2023-01-17,9686
3686,達能,5,0,5,富邦-宜蘭,2023-01-17,9686
2537,聯上發,5,0,5,富邦-宜蘭,2023-01-17,9686
3710,連展投控,5,0,5,富邦-宜蘭,2023-01-17,9686
6104,創惟,5,0,5,富邦-宜蘭,2023-01-17,9686
2486,一詮,5,0,5,富邦-宜蘭,2023-01-17,9686
6276,安鈦克,5,0,5,富邦-宜蘭,2023-01-17,9686
1701,中化,5,0,5,富邦-宜蘭,2023-01-17,9686
00720B,元大投資級公司債,5,0,5,富邦-宜蘭,2023-01-17,9686
00671R,富邦NASDAQ反1,5,0,5,富邦-宜蘭,2023-01-17,9686
00902,中信電池及儲能,5,0,5,富邦-宜蘭,2023-01-17,9686
4162,智擎,6,1,5,富邦-宜蘭,2023-01-17,9686
4133,亞諾法,5,0,5,富邦-宜蘭,2023-01-17,9686
00632R,元大台灣50反1,269,1,268,富邦-宜蘭,2023-01-30,9686
3704,合勤控,82,2,80,富邦-宜蘭,2023-01-30,9686
2317,鴻海,78,3,75,富邦-宜蘭,2023-01-30,9686
00673R,期元大S＆P原油反1,70,0,70,富邦-宜蘭,2023-01-30,9686
00671R,富邦NASDAQ反1,60,0,60,富邦-宜蘭,2023-01-30,9686
1528,恩德,50,0,50,富邦-宜蘭,2023-01-30,9686
3481,群創,42,6,36,富邦-宜蘭,2023-01-30,9686
00706L,期元大S＆P日圓正2,30,0,30,富邦-宜蘭,2023-01-30,9686
2855,統一證,28,0,28,富邦-宜蘭,2023-01-30,9686
00674R,期元大S＆P黃金反1,20,0,20,富邦-宜蘭,2023-01-30,9686
00664R,國泰臺灣加權反1,20,0,20,富邦-宜蘭,2023-01-30,9686
2014,中鴻,34,16,18,富邦-宜蘭,2023-01-30,9686
2498,宏達電,19,5,14,富邦-宜蘭,2023-01-30,9686
2609,陽明,36,22,14,富邦-宜蘭,2023-01-30,9686
1514,亞力,16,3,13,富邦-宜蘭,2023-01-30,9686
2880,華南金,11,0,11,富邦-宜蘭,2023-01-30,9686
2358,廷鑫,12,1,11,富邦-宜蘭,2023-01-30,9686
2614,東森,10,0,10,富邦-宜蘭,2023-01-30,9686
3444,利機,10,0,10,富邦-宜蘭,2023-01-30,9686
2601,益航,10,0,10,富邦-宜蘭,2023-01-30,9686
2028,威致,11,2,9,富邦-宜蘭,2023-01-30,9686
2371,大同,10,1,9,富邦-宜蘭,2023-01-30,9686
5388,中磊,10,2,8,富邦-宜蘭,2023-01-30,9686
4162,智擎,23,15,8,富邦-宜蘭,2023-01-30,9686
4155,訊映,9,1,8,富邦-宜蘭,2023-01-30,9686
2603,長榮,8,1,7,富邦-宜蘭,2023-01-30,9686
8277,商丞,7,0,7,富邦-宜蘭,2023-01-30,9686
3231,緯創,20,13,7,富邦-宜蘭,2023-01-30,9686
6196,帆宣,7,0,7,富邦-宜蘭,2023-01-30,9686
3059,華晶科,12,5,7,富邦-宜蘭,2023-01-30,9686
2436,偉詮電,7,1,6,富邦-宜蘭,2023-01-30,9686
2308,台達電,6,0,6,富邦-宜蘭,2023-01-30,9686
2323,中環,8,2,6,富邦-宜蘭,2023-01-30,9686
2882,國泰金,20,15,5,富邦-宜蘭,2023-01-30,9686
3346,麗清,5,0,5,富邦-宜蘭,2023-01-30,9686
1711,永光,5,0,5,富邦-宜蘭,2023-01-30,9686
00753L,中信中國50正2,10,5,5,富邦-宜蘭,2023-01-30,9686
1802,台玻,5,0,5,富邦-宜蘭,2023-01-30,9686
1701,中化,5,0,5,富邦-宜蘭,2023-01-30,9686
9940,信義,5,0,5,富邦-宜蘭,2023-01-30,9686
1529,樂事綠能,6,1,5,富邦-宜蘭,2023-01-30,9686
3673,TPK-KY,6,1,5,富邦-宜蘭,2023-01-30,9686
2231,為升,5,0,5,富邦-宜蘭,2023-01-30,9686
2485,兆赫,5,0,5,富邦-宜蘭,2023-01-30,9686
2834,臺企銀,6,1,5,富邦-宜蘭,2023-01-30,9686
1584,精剛,5,0,5,富邦-宜蘭,2023-01-30,9686
8069,元太,11,7,4,富邦-宜蘭,2023-01-30,9686
1712,興農,4,0,4,富邦-宜蘭,2023-01-30,9686
2312,金寶,4,0,4,富邦-宜蘭,2023-01-30,9686
2897,王道銀行,4,0,4,富邦-宜蘭,2023-01-30,9686
00893,國泰智能電動車,208,2,206,富邦-宜蘭,2023-01-31,9686
3231,緯創,100,6,94,富邦-宜蘭,2023-01-31,9686
1409,新纖,40,0,40,富邦-宜蘭,2023-01-31,9686
2324,仁寶,34,0,34,富邦-宜蘭,2023-01-31,9686
6245,立端,41,9,32,富邦-宜蘭,2023-01-31,9686
3576,聯合再生,30,2,28,富邦-宜蘭,2023-01-31,9686
2892,第一金,27,0,27,富邦-宜蘭,2023-01-31,9686
1524,耿鼎,28,4,24,富邦-宜蘭,2023-01-31,9686
3624,光頡,33,11,22,富邦-宜蘭,2023-01-31,9686
6589,台康生技,27,6,21,富邦-宜蘭,2023-01-31,9686
00885,富邦越南,21,1,20,富邦-宜蘭,2023-01-31,9686
2485,兆赫,20,0,20,富邦-宜蘭,2023-01-31,9686
2408,南亞科,21,1,20,富邦-宜蘭,2023-01-31,9686
00706L,期元大S＆P日圓正2,20,0,20,富邦-宜蘭,2023-01-31,9686
8150,南茂,24,5,19,富邦-宜蘭,2023-01-31,9686
2601,益航,18,0,18,富邦-宜蘭,2023-01-31,9686
4979,華星光,77,59,18,富邦-宜蘭,2023-01-31,9686
2317,鴻海,22,6,16,富邦-宜蘭,2023-01-31,9686
1701,中化,15,0,15,富邦-宜蘭,2023-01-31,9686
2880,華南金,16,2,14,富邦-宜蘭,2023-01-31,9686
2457,飛宏,14,0,14,富邦-宜蘭,2023-01-31,9686
2049,上銀,13,0,13,富邦-宜蘭,2023-01-31,9686
5880,合庫金,14,1,13,富邦-宜蘭,2023-01-31,9686
2368,金像電,13,1,12,富邦-宜蘭,2023-01-31,9686
6235,華孚,18,7,11,富邦-宜蘭,2023-01-31,9686
6244,茂迪,11,0,11,富邦-宜蘭,2023-01-31,9686
5876,上海商銀,10,0,10,富邦-宜蘭,2023-01-31,9686
1305,華夏,10,0,10,富邦-宜蘭,2023-01-31,9686
1711,永光,10,0,10,富邦-宜蘭,2023-01-31,9686
5014,建錩,11,1,10,富邦-宜蘭,2023-01-31,9686
2464,盟立,10,0,10,富邦-宜蘭,2023-01-31,9686
3010,華立,10,0,10,富邦-宜蘭,2023-01-31,9686
3044,健鼎,10,0,10,富邦-宜蘭,2023-01-31,9686
1907,永豐餘,10,0,10,富邦-宜蘭,2023-01-31,9686
6116,彩晶,17,7,10,富邦-宜蘭,2023-01-31,9686
2412,中華電,9,0,9,富邦-宜蘭,2023-01-31,9686
2034,允強,10,1,9,富邦-宜蘭,2023-01-31,9686
2444,兆勁,14,5,9,富邦-宜蘭,2023-01-31,9686
00679B,元大美債20年,8,0,8,富邦-宜蘭,2023-01-31,9686
6167,久正,8,0,8,富邦-宜蘭,2023-01-31,9686
910861,神州-DR,8,0,8,富邦-宜蘭,2023-01-31,9686
2329,華泰,9,1,8,富邦-宜蘭,2023-01-31,9686
1783,和康生,7,0,7,富邦-宜蘭,2023-01-31,9686
00900,富邦特選高股息30,10,3,7,富邦-宜蘭,2023-01-31,9686
2302,麗正,7,0,7,富邦-宜蘭,2023-01-31,9686
6470,宇智,6,0,6,富邦-宜蘭,2023-01-31,9686
4915,致伸,7,1,6,富邦-宜蘭,2023-01-31,9686
2885,元大金,7,1,6,富邦-宜蘭,2023-01-31,9686
2890,永豐金,7,1,6,富邦-宜蘭,2023-01-31,9686
3189,景碩,7,2,5,富邦-宜蘭,2023-01-31,9686
3481,群創,55,3,52,富邦-宜蘭,2023-02-01,9686
2009,第一銅,46,16,30,富邦-宜蘭,2023-02-01,9686
00706L,期元大S＆P日圓正2,29,0,29,富邦-宜蘭,2023-02-01,9686
1701,中化,42,13,29,富邦-宜蘭,2023-02-01,9686
2312,金寶,30,4,26,富邦-宜蘭,2023-02-01,9686
2409,友達,22,0,22,富邦-宜蘭,2023-02-01,9686
4114,健喬,44,23,21,富邦-宜蘭,2023-02-01,9686
2537,聯上發,20,0,20,富邦-宜蘭,2023-02-01,9686
3576,聯合再生,21,1,20,富邦-宜蘭,2023-02-01,9686
1609,大亞,48,31,17,富邦-宜蘭,2023-02-01,9686
00632R,元大台灣50反1,19,3,16,富邦-宜蘭,2023-02-01,9686
2612,中航,14,0,14,富邦-宜蘭,2023-02-01,9686
1519,華城,17,4,13,富邦-宜蘭,2023-02-01,9686
1809,中釉,13,1,12,富邦-宜蘭,2023-02-01,9686
2014,中鴻,14,2,12,富邦-宜蘭,2023-02-01,9686
2031,新光鋼,11,0,11,富邦-宜蘭,2023-02-01,9686
4155,訊映,11,0,11,富邦-宜蘭,2023-02-01,9686
2634,漢翔,14,3,11,富邦-宜蘭,2023-02-01,9686
6494,九齊,11,0,11,富邦-宜蘭,2023-02-01,9686
2380,虹光,11,0,11,富邦-宜蘭,2023-02-01,9686
00905,FT臺灣Smart,13,2,11,富邦-宜蘭,2023-02-01,9686
1514,亞力,10,0,10,富邦-宜蘭,2023-02-01,9686
2038,海光,13,3,10,富邦-宜蘭,2023-02-01,9686
2908,特力,10,0,10,富邦-宜蘭,2023-02-01,9686
3092,鴻碩,10,0,10,富邦-宜蘭,2023-02-01,9686
00633L,富邦上証正2,10,0,10,富邦-宜蘭,2023-02-01,9686
6244,茂迪,13,3,10,富邦-宜蘭,2023-02-01,9686
6120,達運,10,0,10,富邦-宜蘭,2023-02-01,9686
3710,連展投控,10,0,10,富邦-宜蘭,2023-02-01,9686
1612,宏泰,11,1,10,富邦-宜蘭,2023-02-01,9686
00671R,富邦NASDAQ反1,10,0,10,富邦-宜蘭,2023-02-01,9686
8033,雷虎,11,1,10,富邦-宜蘭,2023-02-01,9686
3536,誠創,10,0,10,富邦-宜蘭,2023-02-01,9686
8043,蜜望實,10,0,10,富邦-宜蘭,2023-02-01,9686
1305,華夏,20,10,10,富邦-宜蘭,2023-02-01,9686
2317,鴻海,16,7,9,富邦-宜蘭,2023-02-01,9686
00715L,期街口布蘭特正2,9,0,9,富邦-宜蘭,2023-02-01,9686
3682,亞太電,9,0,9,富邦-宜蘭,2023-02-01,9686
1810,和成,10,2,8,富邦-宜蘭,2023-02-01,9686
1336,台翰,10,2,8,富邦-宜蘭,2023-02-01,9686
2415,錩新,8,0,8,富邦-宜蘭,2023-02-01,9686
9958,世紀鋼,20,12,8,富邦-宜蘭,2023-02-01,9686
2891,中信金,8,1,7,富邦-宜蘭,2023-02-01,9686
1529,樂事綠能,8,1,7,富邦-宜蘭,2023-02-01,9686
00753L,中信中國50正2,11,4,7,富邦-宜蘭,2023-02-01,9686
00878,國泰永續高股息,15,9,6,富邦-宜蘭,2023-02-01,9686
1595,川寶,6,0,6,富邦-宜蘭,2023-02-01,9686
2351,順德,24,18,6,富邦-宜蘭,2023-02-01,9686
3390,旭軟,6,0,6,富邦-宜蘭,2023-02-01,9686
2883,凱基金,7,1,6,富邦-宜蘭,2023-02-01,9686
00632R,元大台灣50反1,270,0,270,富邦-宜蘭,2023-02-02,9686
00878,國泰永續高股息,59,7,52,富邦-宜蘭,2023-02-02,9686
4114,健喬,75,29,46,富邦-宜蘭,2023-02-02,9686
2882,國泰金,38,4,34,富邦-宜蘭,2023-02-02,9686
1609,大亞,34,7,27,富邦-宜蘭,2023-02-02,9686
3059,華晶科,30,4,26,富邦-宜蘭,2023-02-02,9686
8105,凌巨,35,14,21,富邦-宜蘭,2023-02-02,9686
2891,中信金,20,0,20,富邦-宜蘭,2023-02-02,9686
3024,憶聲,20,0,20,富邦-宜蘭,2023-02-02,9686
00665L,富邦�琤肭磪囓�2,20,0,20,富邦-宜蘭,2023-02-02,9686
2201,裕隆,30,14,16,富邦-宜蘭,2023-02-02,9686
2607,榮運,15,0,15,富邦-宜蘭,2023-02-02,9686
3710,連展投控,15,0,15,富邦-宜蘭,2023-02-02,9686
00671R,富邦NASDAQ反1,15,0,15,富邦-宜蘭,2023-02-02,9686
2406,國碩,14,0,14,富邦-宜蘭,2023-02-02,9686
2880,華南金,18,5,13,富邦-宜蘭,2023-02-02,9686
00773B,中信優先金融債,12,0,12,富邦-宜蘭,2023-02-02,9686
4155,訊映,13,2,11,富邦-宜蘭,2023-02-02,9686
2402,毅嘉,11,0,11,富邦-宜蘭,2023-02-02,9686
4968,立積,14,3,11,富邦-宜蘭,2023-02-02,9686
2369,菱生,13,2,11,富邦-宜蘭,2023-02-02,9686
2618,長榮航,16,6,10,富邦-宜蘭,2023-02-02,9686
3217,優群,11,1,10,富邦-宜蘭,2023-02-02,9686
8215,明基材,15,5,10,富邦-宜蘭,2023-02-02,9686
2352,佳世達,10,0,10,富邦-宜蘭,2023-02-02,9686
1452,宏益,10,0,10,富邦-宜蘭,2023-02-02,9686
2038,海光,10,0,10,富邦-宜蘭,2023-02-02,9686
2884,玉山金,10,1,9,富邦-宜蘭,2023-02-02,9686
8033,雷虎,9,0,9,富邦-宜蘭,2023-02-02,9686
3019,亞光,11,2,9,富邦-宜蘭,2023-02-02,9686
2454,聯發科,9,1,8,富邦-宜蘭,2023-02-02,9686
2425,承啟,10,2,8,富邦-宜蘭,2023-02-02,9686
2887,台新金,11,3,8,富邦-宜蘭,2023-02-02,9686
6168,宏齊,8,0,8,富邦-宜蘭,2023-02-02,9686
2468,華經,18,11,7,富邦-宜蘭,2023-02-02,9686
8277,商丞,7,0,7,富邦-宜蘭,2023-02-02,9686
2317,鴻海,10,4,6,富邦-宜蘭,2023-02-02,9686
8070,長華*,6,0,6,富邦-宜蘭,2023-02-02,9686
2886,兆豐金,7,1,6,富邦-宜蘭,2023-02-02,9686
6180,橘子,9,3,6,富邦-宜蘭,2023-02-02,9686
2812,台中銀,7,1,6,富邦-宜蘭,2023-02-02,9686
8358,金居,7,1,6,富邦-宜蘭,2023-02-02,9686
2489,瑞軒,6,1,5,富邦-宜蘭,2023-02-02,9686
2542,興富發,5,0,5,富邦-宜蘭,2023-02-02,9686
3081,聯亞,8,3,5,富邦-宜蘭,2023-02-02,9686
00885,富邦越南,5,0,5,富邦-宜蘭,2023-02-02,9686
2399,映泰,5,0,5,富邦-宜蘭,2023-02-02,9686
3191,雲嘉南,5,0,5,富邦-宜蘭,2023-02-02,9686
2897,王道銀行,5,0,5,富邦-宜蘭,2023-02-02,9686
3706,神達,5,0,5,富邦-宜蘭,2023-02-02,9686
00650L,復華香港正2,90,0,90,富邦-宜蘭,2023-02-03,9686
00878,國泰永續高股息,65,2,63,富邦-宜蘭,2023-02-03,9686
00882,中信中國高股息,57,0,57,富邦-宜蘭,2023-02-03,9686
00877,復華中國5G,50,0,50,富邦-宜蘭,2023-02-03,9686
2603,長榮,62,12,50,富邦-宜蘭,2023-02-03,9686
1512,瑞利,47,0,47,富邦-宜蘭,2023-02-03,9686
00637L,元大滬深300正2,42,0,42,富邦-宜蘭,2023-02-03,9686
2882,國泰金,42,2,40,富邦-宜蘭,2023-02-03,9686
00715L,期街口布蘭特正2,34,0,34,富邦-宜蘭,2023-02-03,9686
2409,友達,31,0,31,富邦-宜蘭,2023-02-03,9686
5251,天鉞電,30,0,30,富邦-宜蘭,2023-02-03,9686
00671R,富邦NASDAQ反1,30,0,30,富邦-宜蘭,2023-02-03,9686
1906,寶隆,30,0,30,富邦-宜蘭,2023-02-03,9686
00903,富邦元宇宙,29,0,29,富邦-宜蘭,2023-02-03,9686
2891,中信金,28,0,28,富邦-宜蘭,2023-02-03,9686
3624,光頡,35,8,27,富邦-宜蘭,2023-02-03,9686
1303,南亞,27,0,27,富邦-宜蘭,2023-02-03,9686
4564,元翎,26,0,26,富邦-宜蘭,2023-02-03,9686
2612,中航,50,26,24,富邦-宜蘭,2023-02-03,9686
2358,廷鑫,26,2,24,富邦-宜蘭,2023-02-03,9686
6190,萬泰科,19,1,18,富邦-宜蘭,2023-02-03,9686
3481,群創,17,0,17,富邦-宜蘭,2023-02-03,9686
3219,倚強科,15,0,15,富邦-宜蘭,2023-02-03,9686
1101,台泥,14,0,14,富邦-宜蘭,2023-02-03,9686
2609,陽明,58,45,13,富邦-宜蘭,2023-02-03,9686
4979,華星光,19,6,13,富邦-宜蘭,2023-02-03,9686
2498,宏達電,60,48,12,富邦-宜蘭,2023-02-03,9686
2014,中鴻,17,5,12,富邦-宜蘭,2023-02-03,9686
2867,三商壽,12,0,12,富邦-宜蘭,2023-02-03,9686
1452,宏益,12,0,12,富邦-宜蘭,2023-02-03,9686
2364,倫飛,23,11,12,富邦-宜蘭,2023-02-03,9686
2542,興富發,11,0,11,富邦-宜蘭,2023-02-03,9686
1216,統一,11,0,11,富邦-宜蘭,2023-02-03,9686
1809,中釉,13,2,11,富邦-宜蘭,2023-02-03,9686
1752,南光,11,0,11,富邦-宜蘭,2023-02-03,9686
5425,台半,14,3,11,富邦-宜蘭,2023-02-03,9686
2363,矽統,10,0,10,富邦-宜蘭,2023-02-03,9686
1905,華紙,10,0,10,富邦-宜蘭,2023-02-03,9686
00679B,元大美債20年,12,2,10,富邦-宜蘭,2023-02-03,9686
6129,普誠,11,1,10,富邦-宜蘭,2023-02-03,9686
1701,中化,23,13,10,富邦-宜蘭,2023-02-03,9686
3499,環天科,10,0,10,富邦-宜蘭,2023-02-03,9686
00665L,富邦�琤肭磪囓�2,10,0,10,富邦-宜蘭,2023-02-03,9686
2601,益航,10,0,10,富邦-宜蘭,2023-02-03,9686
6177,達麗,10,0,10,富邦-宜蘭,2023-02-03,9686
6182,合晶,10,0,10,富邦-宜蘭,2023-02-03,9686
2892,第一金,10,0,10,富邦-宜蘭,2023-02-03,9686
3536,誠創,10,0,10,富邦-宜蘭,2023-02-03,9686
3710,連展投控,10,0,10,富邦-宜蘭,2023-02-03,9686
2838,聯邦銀,10,1,9,富邦-宜蘭,2023-02-03,9686
2888,新光金,106,3,103,富邦-宜蘭,2023-02-06,9686
2303,聯電,79,19,60,富邦-宜蘭,2023-02-06,9686
2609,陽明,72,13,59,富邦-宜蘭,2023-02-06,9686
5009,榮剛,61,6,55,富邦-宜蘭,2023-02-06,9686
2834,臺企銀,51,0,51,富邦-宜蘭,2023-02-06,9686
00878,國泰永續高股息,48,6,42,富邦-宜蘭,2023-02-06,9686
00706L,期元大S＆P日圓正2,39,0,39,富邦-宜蘭,2023-02-06,9686
1605,華新,52,15,37,富邦-宜蘭,2023-02-06,9686
6589,台康生技,36,1,35,富邦-宜蘭,2023-02-06,9686
6770,力積電,48,16,32,富邦-宜蘭,2023-02-06,9686
2354,鴻準,31,0,31,富邦-宜蘭,2023-02-06,9686
2317,鴻海,36,7,29,富邦-宜蘭,2023-02-06,9686
2882,國泰金,29,1,28,富邦-宜蘭,2023-02-06,9686
1524,耿鼎,36,11,25,富邦-宜蘭,2023-02-06,9686
0056,元大高股息,24,0,24,富邦-宜蘭,2023-02-06,9686
2603,長榮,23,1,22,富邦-宜蘭,2023-02-06,9686
9958,世紀鋼,23,3,20,富邦-宜蘭,2023-02-06,9686
2027,大成鋼,21,3,18,富邦-宜蘭,2023-02-06,9686
00715L,期街口布蘭特正2,17,0,17,富邦-宜蘭,2023-02-06,9686
00679B,元大美債20年,16,0,16,富邦-宜蘭,2023-02-06,9686
00900,富邦特選高股息30,16,0,16,富邦-宜蘭,2023-02-06,9686
00882,中信中國高股息,13,0,13,富邦-宜蘭,2023-02-06,9686
2816,旺旺保,13,0,13,富邦-宜蘭,2023-02-06,9686
00720B,元大投資級公司債,12,0,12,富邦-宜蘭,2023-02-06,9686
6550,北極星藥業-KY,17,5,12,富邦-宜蘭,2023-02-06,9686
00637L,元大滬深300正2,12,1,11,富邦-宜蘭,2023-02-06,9686
2408,南亞科,11,0,11,富邦-宜蘭,2023-02-06,9686
2634,漢翔,14,3,11,富邦-宜蘭,2023-02-06,9686
1609,大亞,12,2,10,富邦-宜蘭,2023-02-06,9686
1722,台肥,10,0,10,富邦-宜蘭,2023-02-06,9686
3664,安瑞-KY,10,0,10,富邦-宜蘭,2023-02-06,9686
2337,旺宏,11,1,10,富邦-宜蘭,2023-02-06,9686
9933,中鼎,10,0,10,富邦-宜蘭,2023-02-06,9686
6116,彩晶,10,0,10,富邦-宜蘭,2023-02-06,9686
2106,建大,10,0,10,富邦-宜蘭,2023-02-06,9686
2313,華通,10,0,10,富邦-宜蘭,2023-02-06,9686
00642U,期元大S＆P石油,10,0,10,富邦-宜蘭,2023-02-06,9686
3037,欣興,17,8,9,富邦-宜蘭,2023-02-06,9686
6182,合晶,10,1,9,富邦-宜蘭,2023-02-06,9686
2495,普安,9,0,9,富邦-宜蘭,2023-02-06,9686
2344,華邦電,22,14,8,富邦-宜蘭,2023-02-06,9686
2022,聚亨,8,0,8,富邦-宜蘭,2023-02-06,9686
2884,玉山金,9,1,8,富邦-宜蘭,2023-02-06,9686
0050,元大台灣50,7,0,7,富邦-宜蘭,2023-02-06,9686
3013,晟銘電,7,0,7,富邦-宜蘭,2023-02-06,9686
2618,長榮航,11,4,7,富邦-宜蘭,2023-02-06,9686
4906,正文,8,1,7,富邦-宜蘭,2023-02-06,9686
6118,建達,25,18,7,富邦-宜蘭,2023-02-06,9686
2436,偉詮電,8,1,7,富邦-宜蘭,2023-02-06,9686
8050,廣積,12,5,7,富邦-宜蘭,2023-02-06,9686
6116,彩晶,70,0,70,富邦-宜蘭,2023-02-07,9686
00715L,期街口布蘭特正2,43,0,43,富邦-宜蘭,2023-02-07,9686
2610,華航,73,37,36,富邦-宜蘭,2023-02-07,9686
2104,國際中橡,31,0,31,富邦-宜蘭,2023-02-07,9686
00878,國泰永續高股息,41,12,29,富邦-宜蘭,2023-02-07,9686
1752,南光,31,2,29,富邦-宜蘭,2023-02-07,9686
3037,欣興,28,1,27,富邦-宜蘭,2023-02-07,9686
2498,宏達電,76,52,24,富邦-宜蘭,2023-02-07,9686
1701,中化,23,1,22,富邦-宜蘭,2023-02-07,9686
4747,強生,43,22,21,富邦-宜蘭,2023-02-07,9686
2344,華邦電,23,2,21,富邦-宜蘭,2023-02-07,9686
3702,大聯大,20,0,20,富邦-宜蘭,2023-02-07,9686
2106,建大,20,0,20,富邦-宜蘭,2023-02-07,9686
2812,台中銀,20,0,20,富邦-宜蘭,2023-02-07,9686
1326,台化,20,0,20,富邦-宜蘭,2023-02-07,9686
5340,建榮,17,0,17,富邦-宜蘭,2023-02-07,9686
1717,長興,15,0,15,富邦-宜蘭,2023-02-07,9686
00706L,期元大S＆P日圓正2,15,0,15,富邦-宜蘭,2023-02-07,9686
3029,零壹,13,0,13,富邦-宜蘭,2023-02-07,9686
1605,華新,35,24,11,富邦-宜蘭,2023-02-07,9686
6770,力積電,12,1,11,富邦-宜蘭,2023-02-07,9686
00664R,國泰臺灣加權反1,11,0,11,富邦-宜蘭,2023-02-07,9686
00712,復華富時不動產,10,0,10,富邦-宜蘭,2023-02-07,9686
3236,千如,10,0,10,富邦-宜蘭,2023-02-07,9686
2342,茂矽,10,0,10,富邦-宜蘭,2023-02-07,9686
3322,建舜電,11,1,10,富邦-宜蘭,2023-02-07,9686
3664,安瑞-KY,10,0,10,富邦-宜蘭,2023-02-07,9686
2062,橋椿,10,0,10,富邦-宜蘭,2023-02-07,9686
8916,光隆,10,0,10,富邦-宜蘭,2023-02-07,9686
4155,訊映,10,0,10,富邦-宜蘭,2023-02-07,9686
2542,興富發,10,0,10,富邦-宜蘭,2023-02-07,9686
00671R,富邦NASDAQ反1,10,0,10,富邦-宜蘭,2023-02-07,9686
2027,大成鋼,10,0,10,富邦-宜蘭,2023-02-07,9686
2884,玉山金,10,0,10,富邦-宜蘭,2023-02-07,9686
1101,台泥,11,2,9,富邦-宜蘭,2023-02-07,9686
3704,合勤控,10,1,9,富邦-宜蘭,2023-02-07,9686
00713,元大台灣高息低波,9,0,9,富邦-宜蘭,2023-02-07,9686
6129,普誠,18,9,9,富邦-宜蘭,2023-02-07,9686
4726,永昕,36,27,9,富邦-宜蘭,2023-02-07,9686
2303,聯電,64,55,9,富邦-宜蘭,2023-02-07,9686
4102,永日,18,10,8,富邦-宜蘭,2023-02-07,9686
4746,台耀,14,6,8,富邦-宜蘭,2023-02-07,9686
5309,系統電,21,13,8,富邦-宜蘭,2023-02-07,9686
2603,長榮,9,2,7,富邦-宜蘭,2023-02-07,9686
2609,陽明,9,2,7,富邦-宜蘭,2023-02-07,9686
00637L,元大滬深300正2,7,0,7,富邦-宜蘭,2023-02-07,9686
4167,松瑞藥,12,5,7,富邦-宜蘭,2023-02-07,9686
2618,長榮航,8,1,7,富邦-宜蘭,2023-02-07,9686
6104,創惟,13,6,7,富邦-宜蘭,2023-02-07,9686
6282,康舒,22,15,7,富邦-宜蘭,2023-02-07,9686
00632R,元大台灣50反1,479,3,476,富邦-宜蘭,2023-02-08,9686
6142,友勁,81,1,80,富邦-宜蘭,2023-02-08,9686
5009,榮剛,61,0,61,富邦-宜蘭,2023-02-08,9686
00900,富邦特選高股息30,70,17,53,富邦-宜蘭,2023-02-08,9686
2834,臺企銀,50,0,50,富邦-宜蘭,2023-02-08,9686
2884,玉山金,46,6,40,富邦-宜蘭,2023-02-08,9686
00673R,期元大S＆P原油反1,30,0,30,富邦-宜蘭,2023-02-08,9686
2614,東森,28,1,27,富邦-宜蘭,2023-02-08,9686
2883,凱基金,26,0,26,富邦-宜蘭,2023-02-08,9686
3231,緯創,25,0,25,富邦-宜蘭,2023-02-08,9686
1326,台化,25,0,25,富邦-宜蘭,2023-02-08,9686
2104,國際中橡,26,2,24,富邦-宜蘭,2023-02-08,9686
1455,集盛,23,0,23,富邦-宜蘭,2023-02-08,9686
4979,華星光,37,16,21,富邦-宜蘭,2023-02-08,9686
2439,美律,20,0,20,富邦-宜蘭,2023-02-08,9686
1449,佳和,20,0,20,富邦-宜蘭,2023-02-08,9686
6282,康舒,21,4,17,富邦-宜蘭,2023-02-08,9686
4977,眾達-KY,17,0,17,富邦-宜蘭,2023-02-08,9686
2371,大同,16,0,16,富邦-宜蘭,2023-02-08,9686
2498,宏達電,45,30,15,富邦-宜蘭,2023-02-08,9686
1513,中興電,56,41,15,富邦-宜蘭,2023-02-08,9686
2610,華航,24,10,14,富邦-宜蘭,2023-02-08,9686
2358,廷鑫,25,11,14,富邦-宜蘭,2023-02-08,9686
4167,松瑞藥,24,11,13,富邦-宜蘭,2023-02-08,9686
1589,永冠-KY,13,0,13,富邦-宜蘭,2023-02-08,9686
3704,合勤控,17,4,13,富邦-宜蘭,2023-02-08,9686
2338,光罩,12,0,12,富邦-宜蘭,2023-02-08,9686
2364,倫飛,13,1,12,富邦-宜蘭,2023-02-08,9686
00679B,元大美債20年,11,0,11,富邦-宜蘭,2023-02-08,9686
1789,神隆,11,0,11,富邦-宜蘭,2023-02-08,9686
2425,承啟,19,8,11,富邦-宜蘭,2023-02-08,9686
00751B,元大AAA至A公司債,10,0,10,富邦-宜蘭,2023-02-08,9686
9919,康那香,10,0,10,富邦-宜蘭,2023-02-08,9686
00919,群益台灣精選高息,10,0,10,富邦-宜蘭,2023-02-08,9686
1514,亞力,10,0,10,富邦-宜蘭,2023-02-08,9686
1722,台肥,10,0,10,富邦-宜蘭,2023-02-08,9686
3594,磐儀,10,0,10,富邦-宜蘭,2023-02-08,9686
6589,台康生技,22,12,10,富邦-宜蘭,2023-02-08,9686
1305,華夏,10,1,9,富邦-宜蘭,2023-02-08,9686
2033,佳大,9,0,9,富邦-宜蘭,2023-02-08,9686
2002,中鋼,11,2,9,富邦-宜蘭,2023-02-08,9686
6217,中探針,9,1,8,富邦-宜蘭,2023-02-08,9686
3259,鑫創,8,0,8,富邦-宜蘭,2023-02-08,9686
8112,至上,10,2,8,富邦-宜蘭,2023-02-08,9686
2886,兆豐金,7,0,7,富邦-宜蘭,2023-02-08,9686
2349,錸德,7,0,7,富邦-宜蘭,2023-02-08,9686
8040,九暘,7,0,7,富邦-宜蘭,2023-02-08,9686
8277,商丞,6,0,6,富邦-宜蘭,2023-02-08,9686
4128,中天,18,12,6,富邦-宜蘭,2023-02-08,9686
00665L,富邦�琤肭磪囓�2,6,0,6,富邦-宜蘭,2023-02-08,9686
00673R,期元大S＆P原油反1,201,30,171,富邦-宜蘭,2023-02-09,9686
6770,力積電,124,3,121,富邦-宜蘭,2023-02-09,9686
1218,泰山,35,0,35,富邦-宜蘭,2023-02-09,9686
2344,華邦電,43,9,34,富邦-宜蘭,2023-02-09,9686
3481,群創,34,7,27,富邦-宜蘭,2023-02-09,9686
6282,康舒,76,53,23,富邦-宜蘭,2023-02-09,9686
1452,宏益,20,0,20,富邦-宜蘭,2023-02-09,9686
2393,億光,20,0,20,富邦-宜蘭,2023-02-09,9686
2305,全友,21,1,20,富邦-宜蘭,2023-02-09,9686
00751B,元大AAA至A公司債,20,0,20,富邦-宜蘭,2023-02-09,9686
2891,中信金,20,1,19,富邦-宜蘭,2023-02-09,9686
3552,同致,20,2,18,富邦-宜蘭,2023-02-09,9686
00720B,元大投資級公司債,17,0,17,富邦-宜蘭,2023-02-09,9686
2884,玉山金,17,0,17,富邦-宜蘭,2023-02-09,9686
00632R,元大台灣50反1,15,0,15,富邦-宜蘭,2023-02-09,9686
00878,國泰永續高股息,24,9,15,富邦-宜蘭,2023-02-09,9686
3624,光頡,22,8,14,富邦-宜蘭,2023-02-09,9686
6509,聚和,16,2,14,富邦-宜蘭,2023-02-09,9686
2614,東森,15,1,14,富邦-宜蘭,2023-02-09,9686
3027,盛達,13,0,13,富邦-宜蘭,2023-02-09,9686
2388,威盛,28,15,13,富邦-宜蘭,2023-02-09,9686
4720,德淵,13,0,13,富邦-宜蘭,2023-02-09,9686
5475,德宏,12,0,12,富邦-宜蘭,2023-02-09,9686
3357,臺慶科,12,0,12,富邦-宜蘭,2023-02-09,9686
1732,毛寶,15,3,12,富邦-宜蘭,2023-02-09,9686
6443,元晶,12,1,11,富邦-宜蘭,2023-02-09,9686
2408,南亞科,11,0,11,富邦-宜蘭,2023-02-09,9686
2607,榮運,13,2,11,富邦-宜蘭,2023-02-09,9686
2031,新光鋼,11,0,11,富邦-宜蘭,2023-02-09,9686
1409,新纖,10,0,10,富邦-宜蘭,2023-02-09,9686
4108,懷特,10,0,10,富邦-宜蘭,2023-02-09,9686
2104,國際中橡,10,0,10,富邦-宜蘭,2023-02-09,9686
2610,華航,65,55,10,富邦-宜蘭,2023-02-09,9686
2062,橋椿,10,0,10,富邦-宜蘭,2023-02-09,9686
3708,上緯投控,10,0,10,富邦-宜蘭,2023-02-09,9686
8933,愛地雅,10,0,10,富邦-宜蘭,2023-02-09,9686
3710,連展投控,29,20,9,富邦-宜蘭,2023-02-09,9686
8038,長園科,10,1,9,富邦-宜蘭,2023-02-09,9686
2498,宏達電,21,12,9,富邦-宜蘭,2023-02-09,9686
4533,協易機,9,0,9,富邦-宜蘭,2023-02-09,9686
0056,元大高股息,18,10,8,富邦-宜蘭,2023-02-09,9686
2369,菱生,8,0,8,富邦-宜蘭,2023-02-09,9686
00893,國泰智能電動車,11,3,8,富邦-宜蘭,2023-02-09,9686
6603,富強鑫,8,0,8,富邦-宜蘭,2023-02-09,9686
2303,聯電,12,5,7,富邦-宜蘭,2023-02-09,9686
1752,南光,25,18,7,富邦-宜蘭,2023-02-09,9686
2618,長榮航,10,3,7,富邦-宜蘭,2023-02-09,9686
2520,冠德,7,0,7,富邦-宜蘭,2023-02-09,9686
2453,凌群,7,0,7,富邦-宜蘭,2023-02-09,9686
910861,神州-DR,7,0,7,富邦-宜蘭,2023-02-09,9686
00676R,富邦臺灣加權反1,100,0,100,富邦-宜蘭,2023-02-10,9686
6116,彩晶,54,1,53,富邦-宜蘭,2023-02-10,9686
6770,力積電,50,10,40,富邦-宜蘭,2023-02-10,9686
00878,國泰永續高股息,56,18,38,富邦-宜蘭,2023-02-10,9686
3545,敦泰,40,4,36,富邦-宜蘭,2023-02-10,9686
1605,華新,64,36,28,富邦-宜蘭,2023-02-10,9686
2609,陽明,28,4,24,富邦-宜蘭,2023-02-10,9686
1815,富喬,23,0,23,富邦-宜蘭,2023-02-10,9686
3231,緯創,22,1,21,富邦-宜蘭,2023-02-10,9686
2498,宏達電,57,36,21,富邦-宜蘭,2023-02-10,9686
00712,復華富時不動產,26,5,21,富邦-宜蘭,2023-02-10,9686
2409,友達,22,1,21,富邦-宜蘭,2023-02-10,9686
3481,群創,22,2,20,富邦-宜蘭,2023-02-10,9686
3236,千如,20,0,20,富邦-宜蘭,2023-02-10,9686
1612,宏泰,20,0,20,富邦-宜蘭,2023-02-10,9686
6698,旭暉應材,20,0,20,富邦-宜蘭,2023-02-10,9686
3702,大聯大,20,0,20,富邦-宜蘭,2023-02-10,9686
2867,三商壽,19,0,19,富邦-宜蘭,2023-02-10,9686
1452,宏益,48,30,18,富邦-宜蘭,2023-02-10,9686
2634,漢翔,47,30,17,富邦-宜蘭,2023-02-10,9686
2413,環科,21,4,17,富邦-宜蘭,2023-02-10,9686
6245,立端,16,0,16,富邦-宜蘭,2023-02-10,9686
8933,愛地雅,17,1,16,富邦-宜蘭,2023-02-10,9686
2317,鴻海,21,6,15,富邦-宜蘭,2023-02-10,9686
00751B,元大AAA至A公司債,15,0,15,富邦-宜蘭,2023-02-10,9686
2883,凱基金,13,0,13,富邦-宜蘭,2023-02-10,9686
2313,華通,12,0,12,富邦-宜蘭,2023-02-10,9686
0056,元大高股息,16,5,11,富邦-宜蘭,2023-02-10,9686
2104,國際中橡,11,0,11,富邦-宜蘭,2023-02-10,9686
00773B,中信優先金融債,11,0,11,富邦-宜蘭,2023-02-10,9686
00673R,期元大S＆P原油反1,11,0,11,富邦-宜蘭,2023-02-10,9686
6443,元晶,15,4,11,富邦-宜蘭,2023-02-10,9686
2610,華航,14,4,10,富邦-宜蘭,2023-02-10,9686
1434,福懋,10,0,10,富邦-宜蘭,2023-02-10,9686
2371,大同,11,1,10,富邦-宜蘭,2023-02-10,9686
6248,沛波,10,0,10,富邦-宜蘭,2023-02-10,9686
2324,仁寶,12,2,10,富邦-宜蘭,2023-02-10,9686
3710,連展投控,16,6,10,富邦-宜蘭,2023-02-10,9686
1437,勤益控,12,2,10,富邦-宜蘭,2023-02-10,9686
2618,長榮航,12,3,9,富邦-宜蘭,2023-02-10,9686
3027,盛達,10,1,9,富邦-宜蘭,2023-02-10,9686
3624,光頡,26,17,9,富邦-宜蘭,2023-02-10,9686
1342,八貫,23,15,8,富邦-宜蘭,2023-02-10,9686
6104,創惟,17,9,8,富邦-宜蘭,2023-02-10,9686
00706L,期元大S＆P日圓正2,8,0,8,富邦-宜蘭,2023-02-10,9686
6689,伊雲谷,8,0,8,富邦-宜蘭,2023-02-10,9686
6282,康舒,16,9,7,富邦-宜蘭,2023-02-10,9686
1810,和成,20,13,7,富邦-宜蘭,2023-02-10,9686
00905,FT臺灣Smart,7,0,7,富邦-宜蘭,2023-02-10,9686
5347,世界,10,3,7,富邦-宜蘭,2023-02-10,9686
6282,康舒,111,0,111,富邦-宜蘭,2023-02-13,9686
3494,誠研,110,0,110,富邦-宜蘭,2023-02-13,9686
00878,國泰永續高股息,83,20,63,富邦-宜蘭,2023-02-13,9686
6770,力積電,63,0,63,富邦-宜蘭,2023-02-13,9686
1584,精剛,84,25,59,富邦-宜蘭,2023-02-13,9686
2409,友達,48,1,47,富邦-宜蘭,2023-02-13,9686
6116,彩晶,50,10,40,富邦-宜蘭,2023-02-13,9686
00673R,期元大S＆P原油反1,36,0,36,富邦-宜蘭,2023-02-13,9686
4747,強生,52,26,26,富邦-宜蘭,2023-02-13,9686
2609,陽明,36,16,20,富邦-宜蘭,2023-02-13,9686
2608,嘉里大榮,20,0,20,富邦-宜蘭,2023-02-13,9686
1447,力鵬,20,0,20,富邦-宜蘭,2023-02-13,9686
00679B,元大美債20年,19,0,19,富邦-宜蘭,2023-02-13,9686
2884,玉山金,23,4,19,富邦-宜蘭,2023-02-13,9686
2317,鴻海,20,2,18,富邦-宜蘭,2023-02-13,9686
00900,富邦特選高股息30,17,0,17,富邦-宜蘭,2023-02-13,9686
0056,元大高股息,29,12,17,富邦-宜蘭,2023-02-13,9686
3289,宜特,15,0,15,富邦-宜蘭,2023-02-13,9686
2303,聯電,19,4,15,富邦-宜蘭,2023-02-13,9686
3710,連展投控,17,2,15,富邦-宜蘭,2023-02-13,9686
3520,華盈,14,0,14,富邦-宜蘭,2023-02-13,9686
2457,飛宏,14,0,14,富邦-宜蘭,2023-02-13,9686
00706L,期元大S＆P日圓正2,14,0,14,富邦-宜蘭,2023-02-13,9686
1452,宏益,12,0,12,富邦-宜蘭,2023-02-13,9686
00712,復華富時不動產,12,0,12,富邦-宜蘭,2023-02-13,9686
1795,美時,34,23,11,富邦-宜蘭,2023-02-13,9686
2368,金像電,13,2,11,富邦-宜蘭,2023-02-13,9686
00885,富邦越南,11,0,11,富邦-宜蘭,2023-02-13,9686
1734,杏輝,11,0,11,富邦-宜蘭,2023-02-13,9686
6598,ABC-KY,10,0,10,富邦-宜蘭,2023-02-13,9686
2344,華邦電,10,0,10,富邦-宜蘭,2023-02-13,9686
2634,漢翔,13,3,10,富邦-宜蘭,2023-02-13,9686
1409,新纖,10,0,10,富邦-宜蘭,2023-02-13,9686
1735,日勝化,10,0,10,富邦-宜蘭,2023-02-13,9686
1701,中化,35,25,10,富邦-宜蘭,2023-02-13,9686
4102,永日,11,2,9,富邦-宜蘭,2023-02-13,9686
2618,長榮航,13,4,9,富邦-宜蘭,2023-02-13,9686
8227,巨有科技,8,0,8,富邦-宜蘭,2023-02-13,9686
1217,愛之味,16,8,8,富邦-宜蘭,2023-02-13,9686
2615,萬海,27,20,7,富邦-宜蘭,2023-02-13,9686
6806,森崴能源,18,11,7,富邦-宜蘭,2023-02-13,9686
1815,富喬,7,0,7,富邦-宜蘭,2023-02-13,9686
9945,潤泰新,11,4,7,富邦-宜蘭,2023-02-13,9686
00751B,元大AAA至A公司債,6,0,6,富邦-宜蘭,2023-02-13,9686
1512,瑞利,6,0,6,富邦-宜蘭,2023-02-13,9686
1504,東元,6,0,6,富邦-宜蘭,2023-02-13,9686
3189,景碩,7,1,6,富邦-宜蘭,2023-02-13,9686
00772B,中信高評級公司債,8,2,6,富邦-宜蘭,2023-02-13,9686
9928,中視,6,0,6,富邦-宜蘭,2023-02-13,9686
4968,立積,5,0,5,富邦-宜蘭,2023-02-13,9686
00632R,元大台灣50反1,230,0,230,富邦-宜蘭,2023-02-14,9686
00673R,期元大S＆P原油反1,110,35,75,富邦-宜蘭,2023-02-14,9686
00878,國泰永續高股息,86,18,68,富邦-宜蘭,2023-02-14,9686
6443,元晶,60,1,59,富邦-宜蘭,2023-02-14,9686
3481,群創,57,1,56,富邦-宜蘭,2023-02-14,9686
00885,富邦越南,50,0,50,富邦-宜蘭,2023-02-14,9686
2312,金寶,39,0,39,富邦-宜蘭,2023-02-14,9686
1701,中化,42,6,36,富邦-宜蘭,2023-02-14,9686
5512,力麒,30,0,30,富邦-宜蘭,2023-02-14,9686
5905,南仁湖,31,2,29,富邦-宜蘭,2023-02-14,9686
00900,富邦特選高股息30,30,5,25,富邦-宜蘭,2023-02-14,9686
00679B,元大美債20年,24,0,24,富邦-宜蘭,2023-02-14,9686
2610,華航,64,40,24,富邦-宜蘭,2023-02-14,9686
6142,友勁,21,0,21,富邦-宜蘭,2023-02-14,9686
4157,太景*-KY,20,0,20,富邦-宜蘭,2023-02-14,9686
6546,正基,20,0,20,富邦-宜蘭,2023-02-14,9686
3189,景碩,31,12,19,富邦-宜蘭,2023-02-14,9686
4960,誠美材,20,2,18,富邦-宜蘭,2023-02-14,9686
2104,國際中橡,14,0,14,富邦-宜蘭,2023-02-14,9686
6288,聯嘉,15,2,13,富邦-宜蘭,2023-02-14,9686
3044,健鼎,12,0,12,富邦-宜蘭,2023-02-14,9686
5203,訊連,13,2,11,富邦-宜蘭,2023-02-14,9686
3029,零壹,14,4,10,富邦-宜蘭,2023-02-14,9686
3664,安瑞-KY,10,0,10,富邦-宜蘭,2023-02-14,9686
00664R,國泰臺灣加權反1,10,0,10,富邦-宜蘭,2023-02-14,9686
1810,和成,10,0,10,富邦-宜蘭,2023-02-14,9686
2608,嘉里大榮,10,0,10,富邦-宜蘭,2023-02-14,9686
3010,華立,10,0,10,富邦-宜蘭,2023-02-14,9686
2382,廣達,10,0,10,富邦-宜蘭,2023-02-14,9686
3552,同致,11,1,10,富邦-宜蘭,2023-02-14,9686
3704,合勤控,9,0,9,富邦-宜蘭,2023-02-14,9686
6806,森崴能源,10,1,9,富邦-宜蘭,2023-02-14,9686
8215,明基材,9,0,9,富邦-宜蘭,2023-02-14,9686
3710,連展投控,10,1,9,富邦-宜蘭,2023-02-14,9686
2641,正德,10,1,9,富邦-宜蘭,2023-02-14,9686
4979,華星光,16,7,9,富邦-宜蘭,2023-02-14,9686
4755,三福化,10,1,9,富邦-宜蘭,2023-02-14,9686
4763,材料-KY,10,2,8,富邦-宜蘭,2023-02-14,9686
3042,晶技,8,0,8,富邦-宜蘭,2023-02-14,9686
5351,鈺創,8,0,8,富邦-宜蘭,2023-02-14,9686
2022,聚亨,8,0,8,富邦-宜蘭,2023-02-14,9686
1529,樂事綠能,8,0,8,富邦-宜蘭,2023-02-14,9686
2374,佳能,8,0,8,富邦-宜蘭,2023-02-14,9686
8222,寶一,39,31,8,富邦-宜蘭,2023-02-14,9686
8069,元太,16,8,8,富邦-宜蘭,2023-02-14,9686
4743,合一,8,1,7,富邦-宜蘭,2023-02-14,9686
2388,威盛,7,0,7,富邦-宜蘭,2023-02-14,9686
00909,國泰數位支付服務,7,0,7,富邦-宜蘭,2023-02-14,9686
1605,華新,39,32,7,富邦-宜蘭,2023-02-14,9686
2314,台揚,6,0,6,富邦-宜蘭,2023-02-14,9686
00885,富邦越南,80,0,80,富邦-宜蘭,2023-02-15,9686
1609,大亞,80,20,60,富邦-宜蘭,2023-02-15,9686
00664R,國泰臺灣加權反1,70,11,59,富邦-宜蘭,2023-02-15,9686
2610,華航,111,53,58,富邦-宜蘭,2023-02-15,9686
00893,國泰智能電動車,62,12,50,富邦-宜蘭,2023-02-15,9686
1718,中纖,46,0,46,富邦-宜蘭,2023-02-15,9686
00900,富邦特選高股息30,46,0,46,富邦-宜蘭,2023-02-15,9686
2027,大成鋼,42,0,42,富邦-宜蘭,2023-02-15,9686
2891,中信金,38,0,38,富邦-宜蘭,2023-02-15,9686
4739,康普,40,8,32,富邦-宜蘭,2023-02-15,9686
9105,泰金寶-DR,29,0,29,富邦-宜蘭,2023-02-15,9686
3576,聯合再生,30,3,27,富邦-宜蘭,2023-02-15,9686
1701,中化,29,6,23,富邦-宜蘭,2023-02-15,9686
3479,安勤,27,4,23,富邦-宜蘭,2023-02-15,9686
00679B,元大美債20年,21,0,21,富邦-宜蘭,2023-02-15,9686
5701,劍湖山,20,0,20,富邦-宜蘭,2023-02-15,9686
2206,三陽工業,39,22,17,富邦-宜蘭,2023-02-15,9686
2330,台積電,34,18,16,富邦-宜蘭,2023-02-15,9686
3540,曜越,21,6,15,富邦-宜蘭,2023-02-15,9686
2344,華邦電,18,3,15,富邦-宜蘭,2023-02-15,9686
1402,遠東新,15,0,15,富邦-宜蘭,2023-02-15,9686
4155,訊映,15,0,15,富邦-宜蘭,2023-02-15,9686
1815,富喬,15,0,15,富邦-宜蘭,2023-02-15,9686
3710,連展投控,14,0,14,富邦-宜蘭,2023-02-15,9686
1595,川寶,13,0,13,富邦-宜蘭,2023-02-15,9686
0056,元大高股息,13,0,13,富邦-宜蘭,2023-02-15,9686
00882,中信中國高股息,11,0,11,富邦-宜蘭,2023-02-15,9686
6104,創惟,12,1,11,富邦-宜蘭,2023-02-15,9686
8924,大田,11,0,11,富邦-宜蘭,2023-02-15,9686
0050,元大台灣50,13,2,11,富邦-宜蘭,2023-02-15,9686
00772B,中信高評級公司債,10,0,10,富邦-宜蘭,2023-02-15,9686
5011,久陽,10,0,10,富邦-宜蘭,2023-02-15,9686
1605,華新,35,25,10,富邦-宜蘭,2023-02-15,9686
1504,東元,10,0,10,富邦-宜蘭,2023-02-15,9686
3592,瑞鼎,10,0,10,富邦-宜蘭,2023-02-15,9686
00888,永豐台灣ESG,10,0,10,富邦-宜蘭,2023-02-15,9686
6217,中探針,9,0,9,富邦-宜蘭,2023-02-15,9686
1589,永冠-KY,9,0,9,富邦-宜蘭,2023-02-15,9686
6266,泰詠,11,3,8,富邦-宜蘭,2023-02-15,9686
2104,國際中橡,8,0,8,富邦-宜蘭,2023-02-15,9686
00891,中信關鍵半導體,8,0,8,富邦-宜蘭,2023-02-15,9686
1452,宏益,8,0,8,富邦-宜蘭,2023-02-15,9686
00896,中信綠能及電動車,7,0,7,富邦-宜蘭,2023-02-15,9686
2498,宏達電,51,44,7,富邦-宜蘭,2023-02-15,9686
4915,致伸,7,0,7,富邦-宜蘭,2023-02-15,9686
5905,南仁湖,7,0,7,富邦-宜蘭,2023-02-15,9686
3624,光頡,9,2,7,富邦-宜蘭,2023-02-15,9686
2388,威盛,7,0,7,富邦-宜蘭,2023-02-15,9686
3221,台嘉碩,9,2,7,富邦-宜蘭,2023-02-15,9686
00892,富邦台灣半導體,7,0,7,富邦-宜蘭,2023-02-15,9686
1513,中興電,207,4,203,富邦-宜蘭,2023-02-16,9686
1609,大亞,113,26,87,富邦-宜蘭,2023-02-16,9686
00632R,元大台灣50反1,71,0,71,富邦-宜蘭,2023-02-16,9686
00878,國泰永續高股息,88,22,66,富邦-宜蘭,2023-02-16,9686
8927,北基,50,0,50,富邦-宜蘭,2023-02-16,9686
00715L,期街口布蘭特正2,33,0,33,富邦-宜蘭,2023-02-16,9686
1101,台泥,31,0,31,富邦-宜蘭,2023-02-16,9686
3058,立德,30,0,30,富邦-宜蘭,2023-02-16,9686
00679B,元大美債20年,27,0,27,富邦-宜蘭,2023-02-16,9686
5880,合庫金,25,2,23,富邦-宜蘭,2023-02-16,9686
1503,士電,26,4,22,富邦-宜蘭,2023-02-16,9686
00664R,國泰臺灣加權反1,20,0,20,富邦-宜蘭,2023-02-16,9686
1727,中華化,20,0,20,富邦-宜蘭,2023-02-16,9686
3231,緯創,24,5,19,富邦-宜蘭,2023-02-16,9686
1524,耿鼎,20,2,18,富邦-宜蘭,2023-02-16,9686
3037,欣興,20,5,15,富邦-宜蘭,2023-02-16,9686
1701,中化,24,11,13,富邦-宜蘭,2023-02-16,9686
8093,保銳,13,0,13,富邦-宜蘭,2023-02-16,9686
3710,連展投控,18,6,12,富邦-宜蘭,2023-02-16,9686
2468,華經,19,8,11,富邦-宜蘭,2023-02-16,9686
6139,亞翔,10,0,10,富邦-宜蘭,2023-02-16,9686
3686,達能,10,0,10,富邦-宜蘭,2023-02-16,9686
6712,長聖,15,5,10,富邦-宜蘭,2023-02-16,9686
3536,誠創,10,0,10,富邦-宜蘭,2023-02-16,9686
4967,十銓,10,0,10,富邦-宜蘭,2023-02-16,9686
1447,力鵬,10,0,10,富邦-宜蘭,2023-02-16,9686
4979,華星光,19,9,10,富邦-宜蘭,2023-02-16,9686
6550,北極星藥業-KY,10,1,9,富邦-宜蘭,2023-02-16,9686
5706,鳳凰,18,9,9,富邦-宜蘭,2023-02-16,9686
1612,宏泰,9,0,9,富邦-宜蘭,2023-02-16,9686
9938,百和,9,0,9,富邦-宜蘭,2023-02-16,9686
3189,景碩,11,2,9,富邦-宜蘭,2023-02-16,9686
2471,資通,17,9,8,富邦-宜蘭,2023-02-16,9686
8940,新天地,8,0,8,富邦-宜蘭,2023-02-16,9686
3324,雙鴻,8,0,8,富邦-宜蘭,2023-02-16,9686
2406,國碩,8,0,8,富邦-宜蘭,2023-02-16,9686
2371,大同,10,2,8,富邦-宜蘭,2023-02-16,9686
1795,美時,15,7,8,富邦-宜蘭,2023-02-16,9686
2607,榮運,9,2,7,富邦-宜蘭,2023-02-16,9686
2465,麗臺,9,2,7,富邦-宜蘭,2023-02-16,9686
4739,康普,7,0,7,富邦-宜蘭,2023-02-16,9686
00680L,元大美債20正2,6,0,6,富邦-宜蘭,2023-02-16,9686
4915,致伸,7,1,6,富邦-宜蘭,2023-02-16,9686
6235,華孚,25,19,6,富邦-宜蘭,2023-02-16,9686
8040,九暘,7,1,6,富邦-宜蘭,2023-02-16,9686
00772B,中信高評級公司債,6,0,6,富邦-宜蘭,2023-02-16,9686
2457,飛宏,11,5,6,富邦-宜蘭,2023-02-16,9686
8171,天宇,9,3,6,富邦-宜蘭,2023-02-16,9686
2882,國泰金,6,0,6,富邦-宜蘭,2023-02-16,9686
2481,強茂,5,0,5,富邦-宜蘭,2023-02-16,9686
2610,華航,285,147,138,富邦-宜蘭,2023-02-17,9686
00877,復華中國5G,104,0,104,富邦-宜蘭,2023-02-17,9686
2634,漢翔,104,12,92,富邦-宜蘭,2023-02-17,9686
1796,金穎生技,90,0,90,富邦-宜蘭,2023-02-17,9686
6443,元晶,58,22,36,富邦-宜蘭,2023-02-17,9686
00637L,元大滬深300正2,37,1,36,富邦-宜蘭,2023-02-17,9686
00679B,元大美債20年,37,5,32,富邦-宜蘭,2023-02-17,9686
1314,中石化,30,2,28,富邦-宜蘭,2023-02-17,9686
2515,中工,26,0,26,富邦-宜蘭,2023-02-17,9686
00878,國泰永續高股息,58,33,25,富邦-宜蘭,2023-02-17,9686
3041,揚智,20,0,20,富邦-宜蘭,2023-02-17,9686
3013,晟銘電,22,2,20,富邦-宜蘭,2023-02-17,9686
1101,台泥,31,12,19,富邦-宜蘭,2023-02-17,9686
4979,華星光,37,18,19,富邦-宜蘭,2023-02-17,9686
2885,元大金,18,0,18,富邦-宜蘭,2023-02-17,9686
3260,威剛,18,0,18,富邦-宜蘭,2023-02-17,9686
2344,華邦電,19,1,18,富邦-宜蘭,2023-02-17,9686
3710,連展投控,16,0,16,富邦-宜蘭,2023-02-17,9686
2323,中環,15,0,15,富邦-宜蘭,2023-02-17,9686
8150,南茂,16,1,15,富邦-宜蘭,2023-02-17,9686
910861,神州-DR,14,0,14,富邦-宜蘭,2023-02-17,9686
3576,聯合再生,13,0,13,富邦-宜蘭,2023-02-17,9686
3209,全科,13,0,13,富邦-宜蘭,2023-02-17,9686
00670L,富邦NASDAQ正2,13,0,13,富邦-宜蘭,2023-02-17,9686
2330,台積電,16,4,12,富邦-宜蘭,2023-02-17,9686
1342,八貫,33,21,12,富邦-宜蘭,2023-02-17,9686
2368,金像電,17,6,11,富邦-宜蘭,2023-02-17,9686
2609,陽明,27,16,11,富邦-宜蘭,2023-02-17,9686
6122,擎邦,10,0,10,富邦-宜蘭,2023-02-17,9686
2892,第一金,10,0,10,富邦-宜蘭,2023-02-17,9686
00673R,期元大S＆P原油反1,10,0,10,富邦-宜蘭,2023-02-17,9686
00647L,元大S＆P500正2,10,0,10,富邦-宜蘭,2023-02-17,9686
2880,華南金,10,0,10,富邦-宜蘭,2023-02-17,9686
2324,仁寶,10,1,9,富邦-宜蘭,2023-02-17,9686
6509,聚和,9,0,9,富邦-宜蘭,2023-02-17,9686
2399,映泰,10,1,9,富邦-宜蘭,2023-02-17,9686
1529,樂事綠能,12,3,9,富邦-宜蘭,2023-02-17,9686
00773B,中信優先金融債,11,2,9,富邦-宜蘭,2023-02-17,9686
2317,鴻海,16,7,9,富邦-宜蘭,2023-02-17,9686
1402,遠東新,8,0,8,富邦-宜蘭,2023-02-17,9686
2201,裕隆,12,4,8,富邦-宜蘭,2023-02-17,9686
2376,技嘉,8,0,8,富邦-宜蘭,2023-02-17,9686
1701,中化,12,4,8,富邦-宜蘭,2023-02-17,9686
00680L,元大美債20正2,8,0,8,富邦-宜蘭,2023-02-17,9686
6104,創惟,30,22,8,富邦-宜蘭,2023-02-17,9686
1514,亞力,7,0,7,富邦-宜蘭,2023-02-17,9686
2618,長榮航,35,28,7,富邦-宜蘭,2023-02-17,9686
5425,台半,17,10,7,富邦-宜蘭,2023-02-17,9686
8227,巨有科技,9,3,6,富邦-宜蘭,2023-02-17,9686
00753L,中信中國50正2,6,0,6,富邦-宜蘭,2023-02-17,9686
2867,三商壽,400,0,400,富邦-宜蘭,2023-02-20,9686
2891,中信金,201,0,201,富邦-宜蘭,2023-02-20,9686
00893,國泰智能電動車,69,0,69,富邦-宜蘭,2023-02-20,9686
5512,力麒,73,12,61,富邦-宜蘭,2023-02-20,9686
2409,友達,100,47,53,富邦-宜蘭,2023-02-20,9686
6116,彩晶,51,15,36,富邦-宜蘭,2023-02-20,9686
2317,鴻海,39,4,35,富邦-宜蘭,2023-02-20,9686
4402,郡都開發,31,0,31,富邦-宜蘭,2023-02-20,9686
4128,中天,28,1,27,富邦-宜蘭,2023-02-20,9686
00665L,富邦�琤肭磪囓�2,24,0,24,富邦-宜蘭,2023-02-20,9686
1711,永光,22,0,22,富邦-宜蘭,2023-02-20,9686
4167,松瑞藥,21,0,21,富邦-宜蘭,2023-02-20,9686
2363,矽統,21,0,21,富邦-宜蘭,2023-02-20,9686
2603,長榮,21,2,19,富邦-宜蘭,2023-02-20,9686
5871,中租-KY,16,0,16,富邦-宜蘭,2023-02-20,9686
1708,東鹼,17,2,15,富邦-宜蘭,2023-02-20,9686
5905,南仁湖,15,1,14,富邦-宜蘭,2023-02-20,9686
3715,定穎投控,20,6,14,富邦-宜蘭,2023-02-20,9686
3710,連展投控,15,1,14,富邦-宜蘭,2023-02-20,9686
0056,元大高股息,13,0,13,富邦-宜蘭,2023-02-20,9686
4114,健喬,12,0,12,富邦-宜蘭,2023-02-20,9686
00882,中信中國高股息,11,0,11,富邦-宜蘭,2023-02-20,9686
4560,強信-KY,11,0,11,富邦-宜蘭,2023-02-20,9686
5701,劍湖山,11,0,11,富邦-宜蘭,2023-02-20,9686
3025,星通,15,5,10,富邦-宜蘭,2023-02-20,9686
6224,聚鼎,10,0,10,富邦-宜蘭,2023-02-20,9686
2324,仁寶,10,0,10,富邦-宜蘭,2023-02-20,9686
1796,金穎生技,10,0,10,富邦-宜蘭,2023-02-20,9686
2405,輔信,10,0,10,富邦-宜蘭,2023-02-20,9686
2331,精英,10,0,10,富邦-宜蘭,2023-02-20,9686
5475,德宏,10,0,10,富邦-宜蘭,2023-02-20,9686
2609,陽明,29,19,10,富邦-宜蘭,2023-02-20,9686
6770,力積電,14,4,10,富邦-宜蘭,2023-02-20,9686
00715L,期街口布蘭特正2,10,0,10,富邦-宜蘭,2023-02-20,9686
3005,神基,11,1,10,富邦-宜蘭,2023-02-20,9686
1227,佳格,10,0,10,富邦-宜蘭,2023-02-20,9686
5498,凱崴,10,0,10,富邦-宜蘭,2023-02-20,9686
1709,和益,10,1,9,富邦-宜蘭,2023-02-20,9686
2314,台揚,12,3,9,富邦-宜蘭,2023-02-20,9686
2328,廣宇,10,1,9,富邦-宜蘭,2023-02-20,9686
3037,欣興,10,1,9,富邦-宜蘭,2023-02-20,9686
00679B,元大美債20年,11,3,8,富邦-宜蘭,2023-02-20,9686
2471,資通,12,4,8,富邦-宜蘭,2023-02-20,9686
5706,鳳凰,10,2,8,富邦-宜蘭,2023-02-20,9686
8940,新天地,9,1,8,富邦-宜蘭,2023-02-20,9686
1605,華新,30,23,7,富邦-宜蘭,2023-02-20,9686
1503,士電,34,27,7,富邦-宜蘭,2023-02-20,9686
1513,中興電,8,2,6,富邦-宜蘭,2023-02-20,9686
6451,訊芯-KY,6,0,6,富邦-宜蘭,2023-02-20,9686
4207,環泰,6,0,6,富邦-宜蘭,2023-02-20,9686
2867,三商壽,224,0,224,富邦-宜蘭,2023-02-21,9686
1504,東元,115,0,115,富邦-宜蘭,2023-02-21,9686
2852,第一保,100,0,100,富邦-宜蘭,2023-02-21,9686
2884,玉山金,129,51,78,富邦-宜蘭,2023-02-21,9686
2618,長榮航,75,7,68,富邦-宜蘭,2023-02-21,9686
8033,雷虎,50,1,49,富邦-宜蘭,2023-02-21,9686
3041,揚智,45,0,45,富邦-宜蘭,2023-02-21,9686
0056,元大高股息,44,6,38,富邦-宜蘭,2023-02-21,9686
5512,力麒,27,2,25,富邦-宜蘭,2023-02-21,9686
1605,華新,32,8,24,富邦-宜蘭,2023-02-21,9686
1727,中華化,20,0,20,富邦-宜蘭,2023-02-21,9686
1815,富喬,20,0,20,富邦-宜蘭,2023-02-21,9686
00878,國泰永續高股息,22,4,18,富邦-宜蘭,2023-02-21,9686
2882,國泰金,18,1,17,富邦-宜蘭,2023-02-21,9686
3710,連展投控,17,1,16,富邦-宜蘭,2023-02-21,9686
2104,國際中橡,15,0,15,富邦-宜蘭,2023-02-21,9686
00664R,國泰臺灣加權反1,15,0,15,富邦-宜蘭,2023-02-21,9686
2886,兆豐金,15,0,15,富邦-宜蘭,2023-02-21,9686
00753L,中信中國50正2,25,10,15,富邦-宜蘭,2023-02-21,9686
5701,劍湖山,14,0,14,富邦-宜蘭,2023-02-21,9686
00888,永豐台灣ESG,14,0,14,富邦-宜蘭,2023-02-21,9686
1529,樂事綠能,14,0,14,富邦-宜蘭,2023-02-21,9686
8358,金居,16,2,14,富邦-宜蘭,2023-02-21,9686
2883,凱基金,14,0,14,富邦-宜蘭,2023-02-21,9686
2208,台船,35,22,13,富邦-宜蘭,2023-02-21,9686
2329,華泰,15,2,13,富邦-宜蘭,2023-02-21,9686
2014,中鴻,17,4,13,富邦-宜蘭,2023-02-21,9686
00665L,富邦�琤肭磪囓�2,13,0,13,富邦-宜蘭,2023-02-21,9686
1513,中興電,35,22,13,富邦-宜蘭,2023-02-21,9686
00892,富邦台灣半導體,12,2,10,富邦-宜蘭,2023-02-21,9686
3047,訊舟,10,0,10,富邦-宜蘭,2023-02-21,9686
6550,北極星藥業-KY,10,0,10,富邦-宜蘭,2023-02-21,9686
5531,鄉林,10,0,10,富邦-宜蘭,2023-02-21,9686
8112,至上,10,0,10,富邦-宜蘭,2023-02-21,9686
00679B,元大美債20年,10,0,10,富邦-宜蘭,2023-02-21,9686
2405,輔信,11,1,10,富邦-宜蘭,2023-02-21,9686
8421,旭源,10,0,10,富邦-宜蘭,2023-02-21,9686
2330,台積電,10,0,10,富邦-宜蘭,2023-02-21,9686
5258,虹堡,16,7,9,富邦-宜蘭,2023-02-21,9686
8426,紅木-KY,10,1,9,富邦-宜蘭,2023-02-21,9686
00751B,元大AAA至A公司債,9,0,9,富邦-宜蘭,2023-02-21,9686
8936,國統,11,2,9,富邦-宜蘭,2023-02-21,9686
00772B,中信高評級公司債,8,0,8,富邦-宜蘭,2023-02-21,9686
3078,僑威,10,3,7,富邦-宜蘭,2023-02-21,9686
2906,高林,7,0,7,富邦-宜蘭,2023-02-21,9686
1108,幸福,14,7,7,富邦-宜蘭,2023-02-21,9686
6118,建達,17,10,7,富邦-宜蘭,2023-02-21,9686
8086,宏捷科,7,0,7,富邦-宜蘭,2023-02-21,9686
2323,中環,6,0,6,富邦-宜蘭,2023-02-21,9686
3037,欣興,7,1,6,富邦-宜蘭,2023-02-21,9686
2303,聯電,116,30,86,富邦-宜蘭,2023-02-22,9686
00878,國泰永續高股息,96,30,66,富邦-宜蘭,2023-02-22,9686
5512,力麒,66,0,66,富邦-宜蘭,2023-02-22,9686
00893,國泰智能電動車,59,2,57,富邦-宜蘭,2023-02-22,9686
5210,寶碩,45,2,43,富邦-宜蘭,2023-02-22,9686
1815,富喬,41,0,41,富邦-宜蘭,2023-02-22,9686
9136,巨騰-DR,40,0,40,富邦-宜蘭,2023-02-22,9686
6245,立端,46,8,38,富邦-宜蘭,2023-02-22,9686
2884,玉山金,36,0,36,富邦-宜蘭,2023-02-22,9686
2888,新光金,31,0,31,富邦-宜蘭,2023-02-22,9686
3037,欣興,30,0,30,富邦-宜蘭,2023-02-22,9686
3715,定穎投控,30,0,30,富邦-宜蘭,2023-02-22,9686
3035,智原,31,3,28,富邦-宜蘭,2023-02-22,9686
0056,元大高股息,28,1,27,富邦-宜蘭,2023-02-22,9686
1605,華新,43,20,23,富邦-宜蘭,2023-02-22,9686
1584,精剛,36,14,22,富邦-宜蘭,2023-02-22,9686
2736,富野,23,3,20,富邦-宜蘭,2023-02-22,9686
2812,台中銀,20,0,20,富邦-宜蘭,2023-02-22,9686
2371,大同,20,0,20,富邦-宜蘭,2023-02-22,9686
2338,光罩,17,0,17,富邦-宜蘭,2023-02-22,9686
5258,虹堡,30,13,17,富邦-宜蘭,2023-02-22,9686
00900,富邦特選高股息30,16,0,16,富邦-宜蘭,2023-02-22,9686
2881,富邦金,23,8,15,富邦-宜蘭,2023-02-22,9686
00896,中信綠能及電動車,15,0,15,富邦-宜蘭,2023-02-22,9686
1513,中興電,17,3,14,富邦-宜蘭,2023-02-22,9686
00891,中信關鍵半導體,14,0,14,富邦-宜蘭,2023-02-22,9686
00679B,元大美債20年,13,0,13,富邦-宜蘭,2023-02-22,9686
1218,泰山,13,0,13,富邦-宜蘭,2023-02-22,9686
00680L,元大美債20正2,13,0,13,富邦-宜蘭,2023-02-22,9686
2330,台積電,12,0,12,富邦-宜蘭,2023-02-22,9686
6282,康舒,20,8,12,富邦-宜蘭,2023-02-22,9686
4164,承業醫,12,0,12,富邦-宜蘭,2023-02-22,9686
2208,台船,24,12,12,富邦-宜蘭,2023-02-22,9686
6589,台康生技,11,0,11,富邦-宜蘭,2023-02-22,9686
00712,復華富時不動產,11,0,11,富邦-宜蘭,2023-02-22,9686
5905,南仁湖,12,1,11,富邦-宜蘭,2023-02-22,9686
3019,亞光,11,0,11,富邦-宜蘭,2023-02-22,9686
2301,光寶科,12,1,11,富邦-宜蘭,2023-02-22,9686
6541,泰福-KY,11,0,11,富邦-宜蘭,2023-02-22,9686
1101,台泥,15,4,11,富邦-宜蘭,2023-02-22,9686
3494,誠研,10,0,10,富邦-宜蘭,2023-02-22,9686
00715L,期街口布蘭特正2,10,0,10,富邦-宜蘭,2023-02-22,9686
4979,華星光,12,2,10,富邦-宜蘭,2023-02-22,9686
5353,台林,10,0,10,富邦-宜蘭,2023-02-22,9686
1409,新纖,10,0,10,富邦-宜蘭,2023-02-22,9686
3062,建漢,10,0,10,富邦-宜蘭,2023-02-22,9686
00641R,富邦日本反1,10,0,10,富邦-宜蘭,2023-02-22,9686
3441,聯一光,10,0,10,富邦-宜蘭,2023-02-22,9686
00665L,富邦�琤肭磪囓�2,10,0,10,富邦-宜蘭,2023-02-22,9686
2608,嘉里大榮,10,0,10,富邦-宜蘭,2023-02-22,9686
00632R,元大台灣50反1,337,18,319,富邦-宜蘭,2023-02-23,9686
5210,寶碩,61,5,56,富邦-宜蘭,2023-02-23,9686
2867,三商壽,53,0,53,富邦-宜蘭,2023-02-23,9686
00712,復華富時不動產,42,0,42,富邦-宜蘭,2023-02-23,9686
2482,連宇,45,4,41,富邦-宜蘭,2023-02-23,9686
00642U,期元大S＆P石油,40,0,40,富邦-宜蘭,2023-02-23,9686
00715L,期街口布蘭特正2,39,0,39,富邦-宜蘭,2023-02-23,9686
2460,建通,35,0,35,富邦-宜蘭,2023-02-23,9686
1440,南紡,30,0,30,富邦-宜蘭,2023-02-23,9686
2610,華航,31,2,29,富邦-宜蘭,2023-02-23,9686
3094,聯傑,46,17,29,富邦-宜蘭,2023-02-23,9686
2748,雲品,37,9,28,富邦-宜蘭,2023-02-23,9686
2409,友達,27,1,26,富邦-宜蘭,2023-02-23,9686
2634,漢翔,41,16,25,富邦-宜蘭,2023-02-23,9686
3037,欣興,27,3,24,富邦-宜蘭,2023-02-23,9686
1452,宏益,23,0,23,富邦-宜蘭,2023-02-23,9686
2457,飛宏,23,2,21,富邦-宜蘭,2023-02-23,9686
2618,長榮航,29,8,21,富邦-宜蘭,2023-02-23,9686
00898,國泰基因免疫革命,20,0,20,富邦-宜蘭,2023-02-23,9686
6167,久正,20,0,20,富邦-宜蘭,2023-02-23,9686
5340,建榮,18,0,18,富邦-宜蘭,2023-02-23,9686
1108,幸福,35,17,18,富邦-宜蘭,2023-02-23,9686
00751B,元大AAA至A公司債,17,0,17,富邦-宜蘭,2023-02-23,9686
6589,台康生技,18,1,17,富邦-宜蘭,2023-02-23,9686
2605,新興,28,12,16,富邦-宜蘭,2023-02-23,9686
2886,兆豐金,17,1,16,富邦-宜蘭,2023-02-23,9686
3189,景碩,28,12,16,富邦-宜蘭,2023-02-23,9686
2344,華邦電,18,3,15,富邦-宜蘭,2023-02-23,9686
2104,國際中橡,15,0,15,富邦-宜蘭,2023-02-23,9686
00885,富邦越南,16,1,15,富邦-宜蘭,2023-02-23,9686
2436,偉詮電,14,0,14,富邦-宜蘭,2023-02-23,9686
3520,華盈,14,0,14,富邦-宜蘭,2023-02-23,9686
2736,富野,36,22,14,富邦-宜蘭,2023-02-23,9686
4207,環泰,13,0,13,富邦-宜蘭,2023-02-23,9686
2371,大同,12,0,12,富邦-宜蘭,2023-02-23,9686
8936,國統,15,3,12,富邦-宜蘭,2023-02-23,9686
2329,華泰,22,10,12,富邦-宜蘭,2023-02-23,9686
1560,中砂,11,0,11,富邦-宜蘭,2023-02-23,9686
4915,致伸,11,0,11,富邦-宜蘭,2023-02-23,9686
1103,嘉泥,11,0,11,富邦-宜蘭,2023-02-23,9686
1708,東鹼,17,6,11,富邦-宜蘭,2023-02-23,9686
6666,羅麗芬-KY,11,1,10,富邦-宜蘭,2023-02-23,9686
5498,凱崴,10,0,10,富邦-宜蘭,2023-02-23,9686
3380,明泰,10,0,10,富邦-宜蘭,2023-02-23,9686
8930,青鋼,11,1,10,富邦-宜蘭,2023-02-23,9686
4979,華星光,16,6,10,富邦-宜蘭,2023-02-23,9686
3390,旭軟,10,0,10,富邦-宜蘭,2023-02-23,9686
2535,達欣工,10,0,10,富邦-宜蘭,2023-02-23,9686
00881,國泰台灣5G+,10,0,10,富邦-宜蘭,2023-02-23,9686
2062,橋椿,10,0,10,富邦-宜蘭,2023-02-23,9686
2867,三商壽,200,5,195,富邦-宜蘭,2023-02-24,9686
2601,益航,187,20,167,富邦-宜蘭,2023-02-24,9686
00632R,元大台灣50反1,107,4,103,富邦-宜蘭,2023-02-24,9686
00878,國泰永續高股息,52,2,50,富邦-宜蘭,2023-02-24,9686
00637L,元大滬深300正2,49,0,49,富邦-宜蘭,2023-02-24,9686
00882,中信中國高股息,36,0,36,富邦-宜蘭,2023-02-24,9686
3481,群創,52,19,33,富邦-宜蘭,2023-02-24,9686
3058,立德,36,3,33,富邦-宜蘭,2023-02-24,9686
2030,彰源,32,0,32,富邦-宜蘭,2023-02-24,9686
2399,映泰,34,2,32,富邦-宜蘭,2023-02-24,9686
2104,國際中橡,30,0,30,富邦-宜蘭,2023-02-24,9686
2637,慧洋-KY,28,4,24,富邦-宜蘭,2023-02-24,9686
2618,長榮航,21,0,21,富邦-宜蘭,2023-02-24,9686
3701,大眾控,21,0,21,富邦-宜蘭,2023-02-24,9686
3536,誠創,20,0,20,富邦-宜蘭,2023-02-24,9686
2355,敬鵬,20,0,20,富邦-宜蘭,2023-02-24,9686
2886,兆豐金,19,0,19,富邦-宜蘭,2023-02-24,9686
2884,玉山金,19,1,18,富邦-宜蘭,2023-02-24,9686
00893,國泰智能電動車,18,0,18,富邦-宜蘭,2023-02-24,9686
1605,華新,39,21,18,富邦-宜蘭,2023-02-24,9686
4979,華星光,26,9,17,富邦-宜蘭,2023-02-24,9686
6541,泰福-KY,15,0,15,富邦-宜蘭,2023-02-24,9686
4164,承業醫,15,0,15,富邦-宜蘭,2023-02-24,9686
5009,榮剛,18,4,14,富邦-宜蘭,2023-02-24,9686
2498,宏達電,34,21,13,富邦-宜蘭,2023-02-24,9686
1503,士電,13,0,13,富邦-宜蘭,2023-02-24,9686
00772B,中信高評級公司債,12,0,12,富邦-宜蘭,2023-02-24,9686
4934,太極,12,0,12,富邦-宜蘭,2023-02-24,9686
4915,致伸,14,2,12,富邦-宜蘭,2023-02-24,9686
3224,三顧,12,0,12,富邦-宜蘭,2023-02-24,9686
00715L,期街口布蘭特正2,35,23,12,富邦-宜蘭,2023-02-24,9686
00753L,中信中國50正2,11,0,11,富邦-宜蘭,2023-02-24,9686
5351,鈺創,16,5,11,富邦-宜蘭,2023-02-24,9686
3037,欣興,32,21,11,富邦-宜蘭,2023-02-24,9686
2603,長榮,32,21,11,富邦-宜蘭,2023-02-24,9686
2504,國產,10,0,10,富邦-宜蘭,2023-02-24,9686
5701,劍湖山,10,0,10,富邦-宜蘭,2023-02-24,9686
1529,樂事綠能,12,2,10,富邦-宜蘭,2023-02-24,9686
00665L,富邦�琤肭磪囓�2,10,0,10,富邦-宜蘭,2023-02-24,9686
4128,中天,10,0,10,富邦-宜蘭,2023-02-24,9686
2329,華泰,11,1,10,富邦-宜蘭,2023-02-24,9686
3049,精金,10,0,10,富邦-宜蘭,2023-02-24,9686
2201,裕隆,21,12,9,富邦-宜蘭,2023-02-24,9686
8069,元太,18,9,9,富邦-宜蘭,2023-02-24,9686
8450,霹靂,9,0,9,富邦-宜蘭,2023-02-24,9686
4207,環泰,9,0,9,富邦-宜蘭,2023-02-24,9686
5905,南仁湖,10,1,9,富邦-宜蘭,2023-02-24,9686
2739,寒舍,9,0,9,富邦-宜蘭,2023-02-24,9686
6104,創惟,10,2,8,富邦-宜蘭,2023-02-24,9686
1452,宏益,13,5,8,富邦-宜蘭,2023-02-24,9686
1605,華新,100,22,78,富邦-宜蘭,2023-03-01,9686
1101,台泥,68,4,64,富邦-宜蘭,2023-03-01,9686
3481,群創,65,8,57,富邦-宜蘭,2023-03-01,9686
00878,國泰永續高股息,56,0,56,富邦-宜蘭,2023-03-01,9686
6770,力積電,58,13,45,富邦-宜蘭,2023-03-01,9686
5009,榮剛,50,8,42,富邦-宜蘭,2023-03-01,9686
2884,玉山金,44,8,36,富邦-宜蘭,2023-03-01,9686
6116,彩晶,35,0,35,富邦-宜蘭,2023-03-01,9686
3715,定穎投控,30,0,30,富邦-宜蘭,2023-03-01,9686
2014,中鴻,26,2,24,富邦-宜蘭,2023-03-01,9686
1219,福壽,23,1,22,富邦-宜蘭,2023-03-01,9686
2603,長榮,23,1,22,富邦-宜蘭,2023-03-01,9686
2408,南亞科,22,1,21,富邦-宜蘭,2023-03-01,9686
2344,華邦電,31,11,20,富邦-宜蘭,2023-03-01,9686
5701,劍湖山,20,1,19,富邦-宜蘭,2023-03-01,9686
2633,台灣高鐵,20,2,18,富邦-宜蘭,2023-03-01,9686
2618,長榮航,22,4,18,富邦-宜蘭,2023-03-01,9686
2460,建通,15,0,15,富邦-宜蘭,2023-03-01,9686
00773B,中信優先金融債,14,0,14,富邦-宜蘭,2023-03-01,9686
2313,華通,15,1,14,富邦-宜蘭,2023-03-01,9686
6689,伊雲谷,14,0,14,富邦-宜蘭,2023-03-01,9686
2002,中鋼,13,0,13,富邦-宜蘭,2023-03-01,9686
3520,華盈,14,1,13,富邦-宜蘭,2023-03-01,9686
2882,國泰金,13,0,13,富邦-宜蘭,2023-03-01,9686
2606,裕民,12,0,12,富邦-宜蘭,2023-03-01,9686
6180,橘子,18,6,12,富邦-宜蘭,2023-03-01,9686
1210,大成,16,5,11,富邦-宜蘭,2023-03-01,9686
4168,醣聯,11,0,11,富邦-宜蘭,2023-03-01,9686
2337,旺宏,12,1,11,富邦-宜蘭,2023-03-01,9686
5498,凱崴,11,0,11,富邦-宜蘭,2023-03-01,9686
00712,復華富時不動產,11,0,11,富邦-宜蘭,2023-03-01,9686
4114,健喬,16,5,11,富邦-宜蘭,2023-03-01,9686
2371,大同,11,0,11,富邦-宜蘭,2023-03-01,9686
3006,晶豪科,15,4,11,富邦-宜蘭,2023-03-01,9686
2641,正德,16,5,11,富邦-宜蘭,2023-03-01,9686
5880,合庫金,10,0,10,富邦-宜蘭,2023-03-01,9686
00772B,中信高評級公司債,10,0,10,富邦-宜蘭,2023-03-01,9686
00902,中信電池及儲能,20,10,10,富邦-宜蘭,2023-03-01,9686
3010,華立,10,0,10,富邦-宜蘭,2023-03-01,9686
9940,信義,10,0,10,富邦-宜蘭,2023-03-01,9686
3236,千如,10,0,10,富邦-宜蘭,2023-03-01,9686
2328,廣宇,10,0,10,富邦-宜蘭,2023-03-01,9686
4164,承業醫,12,2,10,富邦-宜蘭,2023-03-01,9686
6509,聚和,10,0,10,富邦-宜蘭,2023-03-01,9686
2492,華新科,10,0,10,富邦-宜蘭,2023-03-01,9686
2609,陽明,13,4,9,富邦-宜蘭,2023-03-01,9686
1108,幸福,10,1,9,富邦-宜蘭,2023-03-01,9686
6589,台康生技,10,1,9,富邦-宜蘭,2023-03-01,9686
2885,元大金,8,0,8,富邦-宜蘭,2023-03-01,9686
3576,聯合再生,13,5,8,富邦-宜蘭,2023-03-01,9686
00878,國泰永續高股息,272,28,244,富邦-宜蘭,2023-03-02,9686
2409,友達,111,4,107,富邦-宜蘭,2023-03-02,9686
00673R,期元大S＆P原油反1,100,0,100,富邦-宜蘭,2023-03-02,9686
1709,和益,100,0,100,富邦-宜蘭,2023-03-02,9686
00712,復華富時不動產,74,2,72,富邦-宜蘭,2023-03-02,9686
2027,大成鋼,60,0,60,富邦-宜蘭,2023-03-02,9686
1815,富喬,51,0,51,富邦-宜蘭,2023-03-02,9686
8938,明安,50,0,50,富邦-宜蘭,2023-03-02,9686
6142,友勁,50,2,48,富邦-宜蘭,2023-03-02,9686
3481,群創,23,2,21,富邦-宜蘭,2023-03-02,9686
2337,旺宏,21,0,21,富邦-宜蘭,2023-03-02,9686
1514,亞力,19,1,18,富邦-宜蘭,2023-03-02,9686
5512,力麒,38,21,17,富邦-宜蘭,2023-03-02,9686
00679B,元大美債20年,13,0,13,富邦-宜蘭,2023-03-02,9686
8936,國統,13,0,13,富邦-宜蘭,2023-03-02,9686
3059,華晶科,14,1,13,富邦-宜蘭,2023-03-02,9686
2605,新興,36,24,12,富邦-宜蘭,2023-03-02,9686
3430,奇鈦科,12,0,12,富邦-宜蘭,2023-03-02,9686
2450,神腦,12,0,12,富邦-宜蘭,2023-03-02,9686
4155,訊映,11,0,11,富邦-宜蘭,2023-03-02,9686
00891,中信關鍵半導體,11,0,11,富邦-宜蘭,2023-03-02,9686
1605,華新,67,57,10,富邦-宜蘭,2023-03-02,9686
2002,中鋼,14,4,10,富邦-宜蘭,2023-03-02,9686
2884,玉山金,13,3,10,富邦-宜蘭,2023-03-02,9686
3049,精金,10,0,10,富邦-宜蘭,2023-03-02,9686
1721,三晃,10,0,10,富邦-宜蘭,2023-03-02,9686
1711,永光,10,0,10,富邦-宜蘭,2023-03-02,9686
3666,光耀,10,0,10,富邦-宜蘭,2023-03-02,9686
3027,盛達,22,12,10,富邦-宜蘭,2023-03-02,9686
2486,一詮,10,0,10,富邦-宜蘭,2023-03-02,9686
1316,上曜,10,0,10,富邦-宜蘭,2023-03-02,9686
2601,益航,15,5,10,富邦-宜蘭,2023-03-02,9686
3715,定穎投控,10,0,10,富邦-宜蘭,2023-03-02,9686
2607,榮運,10,0,10,富邦-宜蘭,2023-03-02,9686
2413,環科,10,0,10,富邦-宜蘭,2023-03-02,9686
2380,虹光,9,0,9,富邦-宜蘭,2023-03-02,9686
2892,第一金,9,0,9,富邦-宜蘭,2023-03-02,9686
2887,台新金,10,2,8,富邦-宜蘭,2023-03-02,9686
8111,立��,8,0,8,富邦-宜蘭,2023-03-02,9686
2303,聯電,28,20,8,富邦-宜蘭,2023-03-02,9686
2611,志信,14,6,8,富邦-宜蘭,2023-03-02,9686
2482,連宇,8,0,8,富邦-宜蘭,2023-03-02,9686
2834,臺企銀,13,5,8,富邦-宜蘭,2023-03-02,9686
2882,國泰金,7,0,7,富邦-宜蘭,2023-03-02,9686
3290,東浦,7,0,7,富邦-宜蘭,2023-03-02,9686
3438,類比科,7,0,7,富邦-宜蘭,2023-03-02,9686
3043,科風,7,0,7,富邦-宜蘭,2023-03-02,9686
5258,虹堡,9,3,6,富邦-宜蘭,2023-03-02,9686
6288,聯嘉,10,4,6,富邦-宜蘭,2023-03-02,9686
00670L,富邦NASDAQ正2,6,0,6,富邦-宜蘭,2023-03-02,9686
00673R,期元大S＆P原油反1,225,0,225,富邦-宜蘭,2023-03-03,9686
00676R,富邦臺灣加權反1,100,0,100,富邦-宜蘭,2023-03-03,9686
2344,華邦電,147,91,56,富邦-宜蘭,2023-03-03,9686
1219,福壽,62,8,54,富邦-宜蘭,2023-03-03,9686
8924,大田,50,0,50,富邦-宜蘭,2023-03-03,9686
8383,千附,50,1,49,富邦-宜蘭,2023-03-03,9686
5907,大洋-KY,48,0,48,富邦-宜蘭,2023-03-03,9686
8213,志超,42,0,42,富邦-宜蘭,2023-03-03,9686
2607,榮運,37,2,35,富邦-宜蘭,2023-03-03,9686
1201,味全,32,1,31,富邦-宜蘭,2023-03-03,9686
1605,華新,48,19,29,富邦-宜蘭,2023-03-03,9686
00712,復華富時不動產,26,0,26,富邦-宜蘭,2023-03-03,9686
8033,雷虎,39,13,26,富邦-宜蘭,2023-03-03,9686
3380,明泰,23,0,23,富邦-宜蘭,2023-03-03,9686
2027,大成鋼,40,18,22,富邦-宜蘭,2023-03-03,9686
1528,恩德,41,20,21,富邦-宜蘭,2023-03-03,9686
3708,上緯投控,21,0,21,富邦-宜蘭,2023-03-03,9686
00773B,中信優先金融債,20,0,20,富邦-宜蘭,2023-03-03,9686
3028,增你強,20,0,20,富邦-宜蘭,2023-03-03,9686
8936,國統,19,1,18,富邦-宜蘭,2023-03-03,9686
2618,長榮航,18,2,16,富邦-宜蘭,2023-03-03,9686
4915,致伸,17,1,16,富邦-宜蘭,2023-03-03,9686
6120,達運,15,0,15,富邦-宜蘭,2023-03-03,9686
5009,榮剛,16,2,14,富邦-宜蘭,2023-03-03,9686
1708,東鹼,34,20,14,富邦-宜蘭,2023-03-03,9686
2886,兆豐金,14,0,14,富邦-宜蘭,2023-03-03,9686
00679B,元大美債20年,13,0,13,富邦-宜蘭,2023-03-03,9686
2641,正德,27,14,13,富邦-宜蘭,2023-03-03,9686
3013,晟銘電,15,2,13,富邦-宜蘭,2023-03-03,9686
6257,矽格,14,1,13,富邦-宜蘭,2023-03-03,9686
5512,力麒,16,3,13,富邦-宜蘭,2023-03-03,9686
2453,凌群,12,0,12,富邦-宜蘭,2023-03-03,9686
00632R,元大台灣50反1,12,0,12,富邦-宜蘭,2023-03-03,9686
3508,位速,11,0,11,富邦-宜蘭,2023-03-03,9686
2887,台新金,10,0,10,富邦-宜蘭,2023-03-03,9686
2883,凱基金,11,1,10,富邦-宜蘭,2023-03-03,9686
4111,濟生,10,0,10,富邦-宜蘭,2023-03-03,9686
3536,誠創,10,0,10,富邦-宜蘭,2023-03-03,9686
6188,廣明,11,2,9,富邦-宜蘭,2023-03-03,9686
2498,宏達電,24,16,8,富邦-宜蘭,2023-03-03,9686
5258,虹堡,19,11,8,富邦-宜蘭,2023-03-03,9686
1589,永冠-KY,8,0,8,富邦-宜蘭,2023-03-03,9686
6161,捷波,8,0,8,富邦-宜蘭,2023-03-03,9686
3207,耀勝,10,3,7,富邦-宜蘭,2023-03-03,9686
2230,泰茂,7,0,7,富邦-宜蘭,2023-03-03,9686
3290,東浦,7,0,7,富邦-宜蘭,2023-03-03,9686
6288,聯嘉,7,0,7,富邦-宜蘭,2023-03-03,9686
2506,太設,7,0,7,富邦-宜蘭,2023-03-03,9686
5880,合庫金,7,0,7,富邦-宜蘭,2023-03-03,9686
1514,亞力,27,21,6,富邦-宜蘭,2023-03-03,9686
00673R,期元大S＆P原油反1,487,0,487,富邦-宜蘭,2023-03-06,9686
1531,高林股,100,0,100,富邦-宜蘭,2023-03-06,9686
1517,利奇,83,1,82,富邦-宜蘭,2023-03-06,9686
2609,陽明,171,104,67,富邦-宜蘭,2023-03-06,9686
2618,長榮航,94,34,60,富邦-宜蘭,2023-03-06,9686
2884,玉山金,57,13,44,富邦-宜蘭,2023-03-06,9686
8383,千附,40,0,40,富邦-宜蘭,2023-03-06,9686
2374,佳能,40,1,39,富邦-宜蘭,2023-03-06,9686
6116,彩晶,54,15,39,富邦-宜蘭,2023-03-06,9686
2030,彰源,30,0,30,富邦-宜蘭,2023-03-06,9686
2614,東森,30,1,29,富邦-宜蘭,2023-03-06,9686
3028,增你強,27,0,27,富邦-宜蘭,2023-03-06,9686
00637L,元大滬深300正2,25,0,25,富邦-宜蘭,2023-03-06,9686
2344,華邦電,27,3,24,富邦-宜蘭,2023-03-06,9686
2891,中信金,21,0,21,富邦-宜蘭,2023-03-06,9686
3147,大綜,23,2,21,富邦-宜蘭,2023-03-06,9686
1210,大成,26,5,21,富邦-宜蘭,2023-03-06,9686
3163,波若威,21,1,20,富邦-宜蘭,2023-03-06,9686
6508,惠光,20,0,20,富邦-宜蘭,2023-03-06,9686
2897,王道銀行,20,0,20,富邦-宜蘭,2023-03-06,9686
3432,台端,21,2,19,富邦-宜蘭,2023-03-06,9686
8176,智捷,17,0,17,富邦-宜蘭,2023-03-06,9686
2886,兆豐金,17,0,17,富邦-宜蘭,2023-03-06,9686
2603,長榮,20,3,17,富邦-宜蘭,2023-03-06,9686
1452,宏益,22,6,16,富邦-宜蘭,2023-03-06,9686
1539,巨庭,17,1,16,富邦-宜蘭,2023-03-06,9686
1708,東鹼,55,40,15,富邦-宜蘭,2023-03-06,9686
4164,承業醫,15,0,15,富邦-宜蘭,2023-03-06,9686
2881,富邦金,20,5,15,富邦-宜蘭,2023-03-06,9686
2867,三商壽,14,0,14,富邦-宜蘭,2023-03-06,9686
3035,智原,14,2,12,富邦-宜蘭,2023-03-06,9686
1219,福壽,13,1,12,富邦-宜蘭,2023-03-06,9686
3706,神達,11,0,11,富邦-宜蘭,2023-03-06,9686
2506,太設,11,0,11,富邦-宜蘭,2023-03-06,9686
2605,新興,14,3,11,富邦-宜蘭,2023-03-06,9686
2104,國際中橡,10,0,10,富邦-宜蘭,2023-03-06,9686
1604,聲寶,10,0,10,富邦-宜蘭,2023-03-06,9686
3093,港建*,10,0,10,富邦-宜蘭,2023-03-06,9686
1103,嘉泥,10,0,10,富邦-宜蘭,2023-03-06,9686
5210,寶碩,11,1,10,富邦-宜蘭,2023-03-06,9686
2064,晉椿,10,0,10,富邦-宜蘭,2023-03-06,9686
2302,麗正,10,0,10,富邦-宜蘭,2023-03-06,9686
2607,榮運,10,0,10,富邦-宜蘭,2023-03-06,9686
00905,FT臺灣Smart,9,0,9,富邦-宜蘭,2023-03-06,9686
1109,信大,9,0,9,富邦-宜蘭,2023-03-06,9686
2329,華泰,11,2,9,富邦-宜蘭,2023-03-06,9686
2610,華航,10,1,9,富邦-宜蘭,2023-03-06,9686
6266,泰詠,10,1,9,富邦-宜蘭,2023-03-06,9686
3141,晶宏,10,1,9,富邦-宜蘭,2023-03-06,9686
3231,緯創,10,2,8,富邦-宜蘭,2023-03-06,9686
00673R,期元大S＆P原油反1,86,0,86,富邦-宜蘭,2023-03-07,9686
00712,復華富時不動產,58,0,58,富邦-宜蘭,2023-03-07,9686
1517,利奇,52,0,52,富邦-宜蘭,2023-03-07,9686
00877,復華中國5G,50,0,50,富邦-宜蘭,2023-03-07,9686
2883,凱基金,50,5,45,富邦-宜蘭,2023-03-07,9686
3432,台端,30,0,30,富邦-宜蘭,2023-03-07,9686
3481,群創,45,16,29,富邦-宜蘭,2023-03-07,9686
6282,康舒,139,113,26,富邦-宜蘭,2023-03-07,9686
2365,昆盈,20,0,20,富邦-宜蘭,2023-03-07,9686
6168,宏齊,19,0,19,富邦-宜蘭,2023-03-07,9686
1777,生泰,18,0,18,富邦-宜蘭,2023-03-07,9686
00772B,中信高評級公司債,17,0,17,富邦-宜蘭,2023-03-07,9686
00751B,元大AAA至A公司債,17,0,17,富邦-宜蘭,2023-03-07,9686
3552,同致,19,2,17,富邦-宜蘭,2023-03-07,9686
2481,強茂,26,9,17,富邦-宜蘭,2023-03-07,9686
2399,映泰,15,0,15,富邦-宜蘭,2023-03-07,9686
1524,耿鼎,23,8,15,富邦-宜蘭,2023-03-07,9686
2337,旺宏,16,1,15,富邦-宜蘭,2023-03-07,9686
1584,精剛,20,6,14,富邦-宜蘭,2023-03-07,9686
2471,資通,14,0,14,富邦-宜蘭,2023-03-07,9686
3093,港建*,15,1,14,富邦-宜蘭,2023-03-07,9686
4560,強信-KY,13,0,13,富邦-宜蘭,2023-03-07,9686
4931,新盛力,12,0,12,富邦-宜蘭,2023-03-07,9686
6125,廣運,12,0,12,富邦-宜蘭,2023-03-07,9686
4976,佳凌,14,3,11,富邦-宜蘭,2023-03-07,9686
2426,鼎元,10,0,10,富邦-宜蘭,2023-03-07,9686
2104,國際中橡,10,0,10,富邦-宜蘭,2023-03-07,9686
1712,興農,10,0,10,富邦-宜蘭,2023-03-07,9686
2441,超豐,10,0,10,富邦-宜蘭,2023-03-07,9686
8112,至上,13,3,10,富邦-宜蘭,2023-03-07,9686
2062,橋椿,10,0,10,富邦-宜蘭,2023-03-07,9686
2618,長榮航,10,0,10,富邦-宜蘭,2023-03-07,9686
910861,神州-DR,10,0,10,富邦-宜蘭,2023-03-07,9686
1734,杏輝,10,0,10,富邦-宜蘭,2023-03-07,9686
2409,友達,13,3,10,富邦-宜蘭,2023-03-07,9686
4114,健喬,10,1,9,富邦-宜蘭,2023-03-07,9686
2542,興富發,9,0,9,富邦-宜蘭,2023-03-07,9686
9940,信義,8,0,8,富邦-宜蘭,2023-03-07,9686
3027,盛達,16,8,8,富邦-宜蘭,2023-03-07,9686
2615,萬海,20,12,8,富邦-宜蘭,2023-03-07,9686
1810,和成,9,1,8,富邦-宜蘭,2023-03-07,9686
8050,廣積,10,2,8,富邦-宜蘭,2023-03-07,9686
1783,和康生,12,4,8,富邦-宜蘭,2023-03-07,9686
2801,彰銀,8,0,8,富邦-宜蘭,2023-03-07,9686
1701,中化,12,4,8,富邦-宜蘭,2023-03-07,9686
2891,中信金,10,3,7,富邦-宜蘭,2023-03-07,9686
00888,永豐台灣ESG,7,0,7,富邦-宜蘭,2023-03-07,9686
6288,聯嘉,8,1,7,富邦-宜蘭,2023-03-07,9686
2605,新興,7,0,7,富邦-宜蘭,2023-03-07,9686
00885,富邦越南,7,0,7,富邦-宜蘭,2023-03-07,9686
1701,中化,117,37,80,富邦-宜蘭,2023-03-08,9686
00877,復華中國5G,50,0,50,富邦-宜蘭,2023-03-08,9686
00751B,元大AAA至A公司債,42,0,42,富邦-宜蘭,2023-03-08,9686
3093,港建*,44,2,42,富邦-宜蘭,2023-03-08,9686
3011,今皓,35,0,35,富邦-宜蘭,2023-03-08,9686
2609,陽明,49,15,34,富邦-宜蘭,2023-03-08,9686
2337,旺宏,35,2,33,富邦-宜蘭,2023-03-08,9686
1504,東元,41,11,30,富邦-宜蘭,2023-03-08,9686
6589,台康生技,32,3,29,富邦-宜蘭,2023-03-08,9686
6142,友勁,30,1,29,富邦-宜蘭,2023-03-08,9686
00923,群益台ESG低碳50,25,0,25,富邦-宜蘭,2023-03-08,9686
00637L,元大滬深300正2,25,3,22,富邦-宜蘭,2023-03-08,9686
00878,國泰永續高股息,23,1,22,富邦-宜蘭,2023-03-08,9686
5864,致和證,20,0,20,富邦-宜蘭,2023-03-08,9686
1517,利奇,20,0,20,富邦-宜蘭,2023-03-08,9686
1438,三地開發,20,0,20,富邦-宜蘭,2023-03-08,9686
9933,中鼎,18,0,18,富邦-宜蘭,2023-03-08,9686
00773B,中信優先金融債,17,2,15,富邦-宜蘭,2023-03-08,9686
9946,三發地產,15,0,15,富邦-宜蘭,2023-03-08,9686
6806,森崴能源,16,1,15,富邦-宜蘭,2023-03-08,9686
3712,永崴投控,15,1,14,富邦-宜蘭,2023-03-08,9686
00882,中信中國高股息,14,0,14,富邦-宜蘭,2023-03-08,9686
4976,佳凌,22,9,13,富邦-宜蘭,2023-03-08,9686
6712,長聖,13,0,13,富邦-宜蘭,2023-03-08,9686
2409,友達,28,16,12,富邦-宜蘭,2023-03-08,9686
2329,華泰,22,10,12,富邦-宜蘭,2023-03-08,9686
00665L,富邦�琤肭磪囓�2,12,0,12,富邦-宜蘭,2023-03-08,9686
2371,大同,12,0,12,富邦-宜蘭,2023-03-08,9686
6257,矽格,15,3,12,富邦-宜蘭,2023-03-08,9686
6168,宏齊,11,0,11,富邦-宜蘭,2023-03-08,9686
00753L,中信中國50正2,11,0,11,富邦-宜蘭,2023-03-08,9686
5880,合庫金,11,0,11,富邦-宜蘭,2023-03-08,9686
2616,山隆,10,0,10,富邦-宜蘭,2023-03-08,9686
3013,晟銘電,15,5,10,富邦-宜蘭,2023-03-08,9686
3066,李洲,10,0,10,富邦-宜蘭,2023-03-08,9686
5468,凱鈺,10,0,10,富邦-宜蘭,2023-03-08,9686
2460,建通,10,0,10,富邦-宜蘭,2023-03-08,9686
1103,嘉泥,10,0,10,富邦-宜蘭,2023-03-08,9686
6140,訊達,10,0,10,富邦-宜蘭,2023-03-08,9686
4916,事欣科,10,0,10,富邦-宜蘭,2023-03-08,9686
2603,長榮,11,1,10,富邦-宜蘭,2023-03-08,9686
1101,台泥,10,1,9,富邦-宜蘭,2023-03-08,9686
2605,新興,16,7,9,富邦-宜蘭,2023-03-08,9686
3058,立德,9,0,9,富邦-宜蘭,2023-03-08,9686
2022,聚亨,9,0,9,富邦-宜蘭,2023-03-08,9686
3362,先進光,16,7,9,富邦-宜蘭,2023-03-08,9686
1220,台榮,10,1,9,富邦-宜蘭,2023-03-08,9686
1531,高林股,10,1,9,富邦-宜蘭,2023-03-08,9686
2887,台新金,10,1,9,富邦-宜蘭,2023-03-08,9686
3706,神達,10,1,9,富邦-宜蘭,2023-03-08,9686
3481,群創,351,88,263,富邦-宜蘭,2023-03-09,9686
1609,大亞,267,16,251,富邦-宜蘭,2023-03-09,9686
2409,友達,199,50,149,富邦-宜蘭,2023-03-09,9686
2884,玉山金,104,1,103,富邦-宜蘭,2023-03-09,9686
2890,永豐金,82,0,82,富邦-宜蘭,2023-03-09,9686
1101,台泥,76,10,66,富邦-宜蘭,2023-03-09,9686
2618,長榮航,69,11,58,富邦-宜蘭,2023-03-09,9686
00878,國泰永續高股息,57,2,55,富邦-宜蘭,2023-03-09,9686
4164,承業醫,51,3,48,富邦-宜蘭,2023-03-09,9686
2610,華航,96,52,44,富邦-宜蘭,2023-03-09,9686
6443,元晶,53,11,42,富邦-宜蘭,2023-03-09,9686
1517,利奇,41,0,41,富邦-宜蘭,2023-03-09,9686
6517,保勝光學,30,2,28,富邦-宜蘭,2023-03-09,9686
5347,世界,25,0,25,富邦-宜蘭,2023-03-09,9686
4114,健喬,25,2,23,富邦-宜蘭,2023-03-09,9686
5512,力麒,21,0,21,富邦-宜蘭,2023-03-09,9686
6770,力積電,65,44,21,富邦-宜蘭,2023-03-09,9686
3702,大聯大,21,0,21,富邦-宜蘭,2023-03-09,9686
2486,一詮,33,13,20,富邦-宜蘭,2023-03-09,9686
2880,華南金,20,0,20,富邦-宜蘭,2023-03-09,9686
3536,誠創,20,0,20,富邦-宜蘭,2023-03-09,9686
00751B,元大AAA至A公司債,19,0,19,富邦-宜蘭,2023-03-09,9686
00712,復華富時不動產,21,2,19,富邦-宜蘭,2023-03-09,9686
2359,所羅門,26,8,18,富邦-宜蘭,2023-03-09,9686
2457,飛宏,130,113,17,富邦-宜蘭,2023-03-09,9686
2852,第一保,16,0,16,富邦-宜蘭,2023-03-09,9686
3297,杭特,16,0,16,富邦-宜蘭,2023-03-09,9686
2537,聯上發,16,0,16,富邦-宜蘭,2023-03-09,9686
1303,南亞,16,0,16,富邦-宜蘭,2023-03-09,9686
2317,鴻海,15,0,15,富邦-宜蘭,2023-03-09,9686
00772B,中信高評級公司債,15,0,15,富邦-宜蘭,2023-03-09,9686
6129,普誠,31,17,14,富邦-宜蘭,2023-03-09,9686
3323,加百裕,14,0,14,富邦-宜蘭,2023-03-09,9686
2002,中鋼,13,0,13,富邦-宜蘭,2023-03-09,9686
3013,晟銘電,15,2,13,富邦-宜蘭,2023-03-09,9686
2630,亞航,13,0,13,富邦-宜蘭,2023-03-09,9686
3163,波若威,13,1,12,富邦-宜蘭,2023-03-09,9686
8222,寶一,52,40,12,富邦-宜蘭,2023-03-09,9686
2344,華邦電,45,33,12,富邦-宜蘭,2023-03-09,9686
3708,上緯投控,12,0,12,富邦-宜蘭,2023-03-09,9686
1514,亞力,13,1,12,富邦-宜蘭,2023-03-09,9686
00773B,中信優先金融債,12,0,12,富邦-宜蘭,2023-03-09,9686
3047,訊舟,21,10,11,富邦-宜蘭,2023-03-09,9686
6282,康舒,29,18,11,富邦-宜蘭,2023-03-09,9686
1522,堤維西,13,2,11,富邦-宜蘭,2023-03-09,9686
4716,大立,10,0,10,富邦-宜蘭,2023-03-09,9686
4974,亞泰,10,0,10,富邦-宜蘭,2023-03-09,9686
3188,鑫龍騰,10,0,10,富邦-宜蘭,2023-03-09,9686
2489,瑞軒,10,0,10,富邦-宜蘭,2023-03-09,9686
1905,華紙,10,0,10,富邦-宜蘭,2023-03-09,9686
6116,彩晶,143,1,142,富邦-宜蘭,2023-03-10,9686
2610,華航,191,51,140,富邦-宜蘭,2023-03-10,9686
2609,陽明,308,179,129,富邦-宜蘭,2023-03-10,9686
00878,國泰永續高股息,129,3,126,富邦-宜蘭,2023-03-10,9686
6274,台燿,112,31,81,富邦-宜蘭,2023-03-10,9686
1815,富喬,80,0,80,富邦-宜蘭,2023-03-10,9686
4743,合一,81,5,76,富邦-宜蘭,2023-03-10,9686
2618,長榮航,68,1,67,富邦-宜蘭,2023-03-10,9686
1517,利奇,65,0,65,富邦-宜蘭,2023-03-10,9686
2888,新光金,59,1,58,富邦-宜蘭,2023-03-10,9686
00713,元大台灣高息低波,58,8,50,富邦-宜蘭,2023-03-10,9686
1605,華新,51,10,41,富邦-宜蘭,2023-03-10,9686
2371,大同,40,0,40,富邦-宜蘭,2023-03-10,9686
2402,毅嘉,40,2,38,富邦-宜蘭,2023-03-10,9686
2641,正德,75,40,35,富邦-宜蘭,2023-03-10,9686
3593,力銘,35,0,35,富邦-宜蘭,2023-03-10,9686
2537,聯上發,35,0,35,富邦-宜蘭,2023-03-10,9686
00897,富邦基因免疫生技,32,0,32,富邦-宜蘭,2023-03-10,9686
9907,統一實,32,0,32,富邦-宜蘭,2023-03-10,9686
0056,元大高股息,47,17,30,富邦-宜蘭,2023-03-10,9686
2344,華邦電,62,33,29,富邦-宜蘭,2023-03-10,9686
00712,復華富時不動產,32,4,28,富邦-宜蘭,2023-03-10,9686
00715L,期街口布蘭特正2,28,0,28,富邦-宜蘭,2023-03-10,9686
2601,益航,29,1,28,富邦-宜蘭,2023-03-10,9686
1529,樂事綠能,28,1,27,富邦-宜蘭,2023-03-10,9686
8069,元太,36,9,27,富邦-宜蘭,2023-03-10,9686
3715,定穎投控,25,0,25,富邦-宜蘭,2023-03-10,9686
2881,富邦金,25,1,24,富邦-宜蘭,2023-03-10,9686
3209,全科,66,42,24,富邦-宜蘭,2023-03-10,9686
1519,華城,36,12,24,富邦-宜蘭,2023-03-10,9686
00882,中信中國高股息,23,0,23,富邦-宜蘭,2023-03-10,9686
1722,台肥,23,0,23,富邦-宜蘭,2023-03-10,9686
2002,中鋼,26,4,22,富邦-宜蘭,2023-03-10,9686
2891,中信金,23,1,22,富邦-宜蘭,2023-03-10,9686
2465,麗臺,22,1,21,富邦-宜蘭,2023-03-10,9686
2883,凱基金,26,6,20,富邦-宜蘭,2023-03-10,9686
2495,普安,20,0,20,富邦-宜蘭,2023-03-10,9686
6245,立端,20,0,20,富邦-宜蘭,2023-03-10,9686
6456,GIS-KY,20,0,20,富邦-宜蘭,2023-03-10,9686
1103,嘉泥,20,0,20,富邦-宜蘭,2023-03-10,9686
4967,十銓,20,0,20,富邦-宜蘭,2023-03-10,9686
4164,承業醫,22,4,18,富邦-宜蘭,2023-03-10,9686
2313,華通,28,10,18,富邦-宜蘭,2023-03-10,9686
1609,大亞,45,27,18,富邦-宜蘭,2023-03-10,9686
5907,大洋-KY,18,0,18,富邦-宜蘭,2023-03-10,9686
3011,今皓,18,1,17,富邦-宜蘭,2023-03-10,9686
4804,大略-KY,17,0,17,富邦-宜蘭,2023-03-10,9686
00701,國泰股利精選30,22,5,17,富邦-宜蘭,2023-03-10,9686
2885,元大金,16,0,16,富邦-宜蘭,2023-03-10,9686
4739,康普,16,0,16,富邦-宜蘭,2023-03-10,9686
00878,國泰永續高股息,122,14,108,富邦-宜蘭,2023-03-13,9686
6274,台燿,117,11,106,富邦-宜蘭,2023-03-13,9686
1708,東鹼,102,0,102,富邦-宜蘭,2023-03-13,9686
2852,第一保,100,3,97,富邦-宜蘭,2023-03-13,9686
2888,新光金,108,11,97,富邦-宜蘭,2023-03-13,9686
3209,全科,78,10,68,富邦-宜蘭,2023-03-13,9686
00715L,期街口布蘭特正2,60,0,60,富邦-宜蘭,2023-03-13,9686
1815,富喬,55,0,55,富邦-宜蘭,2023-03-13,9686
2883,凱基金,47,3,44,富邦-宜蘭,2023-03-13,9686
2610,華航,72,39,33,富邦-宜蘭,2023-03-13,9686
6770,力積電,74,41,33,富邦-宜蘭,2023-03-13,9686
00713,元大台灣高息低波,34,2,32,富邦-宜蘭,2023-03-13,9686
2886,兆豐金,31,0,31,富邦-宜蘭,2023-03-13,9686
1217,愛之味,30,2,28,富邦-宜蘭,2023-03-13,9686
00772B,中信高評級公司債,26,0,26,富邦-宜蘭,2023-03-13,9686
2884,玉山金,44,19,25,富邦-宜蘭,2023-03-13,9686
3011,今皓,22,0,22,富邦-宜蘭,2023-03-13,9686
9105,泰金寶-DR,20,0,20,富邦-宜蘭,2023-03-13,9686
1447,力鵬,20,0,20,富邦-宜蘭,2023-03-13,9686
2618,長榮航,21,3,18,富邦-宜蘭,2023-03-13,9686
2457,飛宏,49,32,17,富邦-宜蘭,2023-03-13,9686
00751B,元大AAA至A公司債,15,0,15,富邦-宜蘭,2023-03-13,9686
1434,福懋,17,2,15,富邦-宜蘭,2023-03-13,9686
4130,健亞,14,0,14,富邦-宜蘭,2023-03-13,9686
4979,華星光,21,7,14,富邦-宜蘭,2023-03-13,9686
2609,陽明,90,76,14,富邦-宜蘭,2023-03-13,9686
2634,漢翔,13,0,13,富邦-宜蘭,2023-03-13,9686
3093,港建*,18,5,13,富邦-宜蘭,2023-03-13,9686
3056,富華新,16,3,13,富邦-宜蘭,2023-03-13,9686
9933,中鼎,13,0,13,富邦-宜蘭,2023-03-13,9686
3027,盛達,12,0,12,富邦-宜蘭,2023-03-13,9686
2601,益航,17,5,12,富邦-宜蘭,2023-03-13,9686
3710,連展投控,11,0,11,富邦-宜蘭,2023-03-13,9686
2104,國際中橡,11,0,11,富邦-宜蘭,2023-03-13,9686
2355,敬鵬,11,0,11,富邦-宜蘭,2023-03-13,9686
1721,三晃,10,0,10,富邦-宜蘭,2023-03-13,9686
2312,金寶,10,0,10,富邦-宜蘭,2023-03-13,9686
1712,興農,10,0,10,富邦-宜蘭,2023-03-13,9686
00919,群益台灣精選高息,10,0,10,富邦-宜蘭,2023-03-13,9686
2324,仁寶,12,2,10,富邦-宜蘭,2023-03-13,9686
2425,承啟,10,0,10,富邦-宜蘭,2023-03-13,9686
911608,明輝-DR,10,0,10,富邦-宜蘭,2023-03-13,9686
3624,光頡,9,0,9,富邦-宜蘭,2023-03-13,9686
2867,三商壽,9,0,9,富邦-宜蘭,2023-03-13,9686
3128,昇銳,15,7,8,富邦-宜蘭,2023-03-13,9686
2537,聯上發,8,0,8,富邦-宜蘭,2023-03-13,9686
2014,中鴻,9,1,8,富邦-宜蘭,2023-03-13,9686
00632R,元大台灣50反1,11,3,8,富邦-宜蘭,2023-03-13,9686
2486,一詮,11,3,8,富邦-宜蘭,2023-03-13,9686
6122,擎邦,9,2,7,富邦-宜蘭,2023-03-13,9686
2888,新光金,228,2,226,富邦-宜蘭,2023-03-14,9686
00878,國泰永續高股息,184,10,174,富邦-宜蘭,2023-03-14,9686
00751B,元大AAA至A公司債,133,0,133,富邦-宜蘭,2023-03-14,9686
2610,華航,96,1,95,富邦-宜蘭,2023-03-14,9686
00902,中信電池及儲能,89,0,89,富邦-宜蘭,2023-03-14,9686
2618,長榮航,84,7,77,富邦-宜蘭,2023-03-14,9686
00882,中信中國高股息,57,0,57,富邦-宜蘭,2023-03-14,9686
00893,國泰智能電動車,54,0,54,富邦-宜蘭,2023-03-14,9686
1217,愛之味,42,0,42,富邦-宜蘭,2023-03-14,9686
00712,復華富時不動產,38,0,38,富邦-宜蘭,2023-03-14,9686
2615,萬海,50,14,36,富邦-宜蘭,2023-03-14,9686
3013,晟銘電,34,0,34,富邦-宜蘭,2023-03-14,9686
00669R,國泰美國道瓊反1,30,0,30,富邦-宜蘭,2023-03-14,9686
2883,凱基金,48,18,30,富邦-宜蘭,2023-03-14,9686
2303,聯電,45,17,28,富邦-宜蘭,2023-03-14,9686
6589,台康生技,31,7,24,富邦-宜蘭,2023-03-14,9686
2344,華邦電,24,1,23,富邦-宜蘭,2023-03-14,9686
2886,兆豐金,24,2,22,富邦-宜蘭,2023-03-14,9686
1605,華新,22,1,21,富邦-宜蘭,2023-03-14,9686
2812,台中銀,26,6,20,富邦-宜蘭,2023-03-14,9686
2409,友達,20,0,20,富邦-宜蘭,2023-03-14,9686
6282,康舒,25,5,20,富邦-宜蘭,2023-03-14,9686
1815,富喬,20,0,20,富邦-宜蘭,2023-03-14,9686
00664R,國泰臺灣加權反1,20,0,20,富邦-宜蘭,2023-03-14,9686
0056,元大高股息,21,2,19,富邦-宜蘭,2023-03-14,9686
2002,中鋼,22,4,18,富邦-宜蘭,2023-03-14,9686
00713,元大台灣高息低波,17,0,17,富邦-宜蘭,2023-03-14,9686
2891,中信金,18,1,17,富邦-宜蘭,2023-03-14,9686
00900,富邦特選高股息30,17,1,16,富邦-宜蘭,2023-03-14,9686
2881,富邦金,17,2,15,富邦-宜蘭,2023-03-14,9686
1229,聯華,15,0,15,富邦-宜蘭,2023-03-14,9686
2537,聯上發,15,0,15,富邦-宜蘭,2023-03-14,9686
5880,合庫金,16,1,15,富邦-宜蘭,2023-03-14,9686
2885,元大金,17,3,14,富邦-宜蘭,2023-03-14,9686
00892,富邦台灣半導體,14,0,14,富邦-宜蘭,2023-03-14,9686
6443,元晶,23,10,13,富邦-宜蘭,2023-03-14,9686
3058,立德,28,16,12,富邦-宜蘭,2023-03-14,9686
2892,第一金,12,0,12,富邦-宜蘭,2023-03-14,9686
00715L,期街口布蘭特正2,42,30,12,富邦-宜蘭,2023-03-14,9686
00665L,富邦�琤肭磪囓�2,13,1,12,富邦-宜蘭,2023-03-14,9686
8933,愛地雅,32,20,12,富邦-宜蘭,2023-03-14,9686
1434,福懋,12,0,12,富邦-宜蘭,2023-03-14,9686
3093,港建*,13,1,12,富邦-宜蘭,2023-03-14,9686
2408,南亞科,12,1,11,富邦-宜蘭,2023-03-14,9686
2849,安泰銀,10,0,10,富邦-宜蘭,2023-03-14,9686
6164,華興,10,0,10,富邦-宜蘭,2023-03-14,9686
3536,誠創,10,0,10,富邦-宜蘭,2023-03-14,9686
5607,遠雄港,10,0,10,富邦-宜蘭,2023-03-14,9686
00919,群益台灣精選高息,10,0,10,富邦-宜蘭,2023-03-14,9686
00642U,期元大S＆P石油,10,0,10,富邦-宜蘭,2023-03-14,9686
2313,華通,207,1,206,富邦-宜蘭,2023-03-15,9686
2603,長榮,137,36,101,富邦-宜蘭,2023-03-15,9686
2609,陽明,116,47,69,富邦-宜蘭,2023-03-15,9686
00715L,期街口布蘭特正2,63,3,60,富邦-宜蘭,2023-03-15,9686
2889,國票金,56,1,55,富邦-宜蘭,2023-03-15,9686
3209,全科,54,0,54,富邦-宜蘭,2023-03-15,9686
6275,元山,26,0,26,富邦-宜蘭,2023-03-15,9686
910861,神州-DR,25,0,25,富邦-宜蘭,2023-03-15,9686
5880,合庫金,24,0,24,富邦-宜蘭,2023-03-15,9686
3712,永崴投控,23,0,23,富邦-宜蘭,2023-03-15,9686
2506,太設,23,0,23,富邦-宜蘭,2023-03-15,9686
00773B,中信優先金融債,21,0,21,富邦-宜蘭,2023-03-15,9686
00878,國泰永續高股息,80,59,21,富邦-宜蘭,2023-03-15,9686
00712,復華富時不動產,40,20,20,富邦-宜蘭,2023-03-15,9686
2849,安泰銀,20,0,20,富邦-宜蘭,2023-03-15,9686
2371,大同,20,0,20,富邦-宜蘭,2023-03-15,9686
6288,聯嘉,22,3,19,富邦-宜蘭,2023-03-15,9686
2891,中信金,20,2,18,富邦-宜蘭,2023-03-15,9686
3011,今皓,18,0,18,富邦-宜蘭,2023-03-15,9686
2367,燿華,24,6,18,富邦-宜蘭,2023-03-15,9686
00900,富邦特選高股息30,20,2,18,富邦-宜蘭,2023-03-15,9686
00679B,元大美債20年,17,0,17,富邦-宜蘭,2023-03-15,9686
1504,東元,24,7,17,富邦-宜蘭,2023-03-15,9686
1452,宏益,37,20,17,富邦-宜蘭,2023-03-15,9686
00713,元大台灣高息低波,19,3,16,富邦-宜蘭,2023-03-15,9686
2897,王道銀行,16,0,16,富邦-宜蘭,2023-03-15,9686
2498,宏達電,33,18,15,富邦-宜蘭,2023-03-15,9686
4931,新盛力,15,0,15,富邦-宜蘭,2023-03-15,9686
3536,誠創,15,0,15,富邦-宜蘭,2023-03-15,9686
8404,百和興業-KY,15,0,15,富邦-宜蘭,2023-03-15,9686
00670L,富邦NASDAQ正2,14,0,14,富邦-宜蘭,2023-03-15,9686
2542,興富發,13,0,13,富邦-宜蘭,2023-03-15,9686
3481,群創,18,5,13,富邦-宜蘭,2023-03-15,9686
1316,上曜,14,1,13,富邦-宜蘭,2023-03-15,9686
2615,萬海,29,16,13,富邦-宜蘭,2023-03-15,9686
4130,健亞,12,0,12,富邦-宜蘭,2023-03-15,9686
2312,金寶,12,0,12,富邦-宜蘭,2023-03-15,9686
2388,威盛,22,10,12,富邦-宜蘭,2023-03-15,9686
9907,統一實,12,0,12,富邦-宜蘭,2023-03-15,9686
3515,華擎,11,0,11,富邦-宜蘭,2023-03-15,9686
6116,彩晶,13,2,11,富邦-宜蘭,2023-03-15,9686
00632R,元大台灣50反1,11,0,11,富邦-宜蘭,2023-03-15,9686
2888,新光金,13,2,11,富邦-宜蘭,2023-03-15,9686
1503,士電,13,2,11,富邦-宜蘭,2023-03-15,9686
9105,泰金寶-DR,10,0,10,富邦-宜蘭,2023-03-15,9686
3390,旭軟,11,1,10,富邦-宜蘭,2023-03-15,9686
2409,友達,14,4,10,富邦-宜蘭,2023-03-15,9686
2610,華航,122,112,10,富邦-宜蘭,2023-03-15,9686
8926,台汽電,11,1,10,富邦-宜蘭,2023-03-15,9686
2489,瑞軒,10,0,10,富邦-宜蘭,2023-03-15,9686
2883,凱基金,209,4,205,富邦-宜蘭,2023-03-16,9686
00878,國泰永續高股息,172,13,159,富邦-宜蘭,2023-03-16,9686
2834,臺企銀,150,25,125,富邦-宜蘭,2023-03-16,9686
2888,新光金,115,4,111,富邦-宜蘭,2023-03-16,9686
1815,富喬,70,0,70,富邦-宜蘭,2023-03-16,9686
3481,群創,84,29,55,富邦-宜蘭,2023-03-16,9686
6116,彩晶,76,22,54,富邦-宜蘭,2023-03-16,9686
2881,富邦金,53,3,50,富邦-宜蘭,2023-03-16,9686
2891,中信金,72,23,49,富邦-宜蘭,2023-03-16,9686
3576,聯合再生,44,1,43,富邦-宜蘭,2023-03-16,9686
2506,太設,41,0,41,富邦-宜蘭,2023-03-16,9686
2603,長榮,67,32,35,富邦-宜蘭,2023-03-16,9686
00712,復華富時不動產,32,0,32,富邦-宜蘭,2023-03-16,9686
2884,玉山金,32,1,31,富邦-宜蘭,2023-03-16,9686
8933,愛地雅,31,0,31,富邦-宜蘭,2023-03-16,9686
1101,台泥,33,3,30,富邦-宜蘭,2023-03-16,9686
00715L,期街口布蘭特正2,69,42,27,富邦-宜蘭,2023-03-16,9686
1701,中化,26,0,26,富邦-宜蘭,2023-03-16,9686
4128,中天,25,0,25,富邦-宜蘭,2023-03-16,9686
1452,宏益,28,5,23,富邦-宜蘭,2023-03-16,9686
3712,永崴投控,21,0,21,富邦-宜蘭,2023-03-16,9686
1217,愛之味,21,0,21,富邦-宜蘭,2023-03-16,9686
2886,兆豐金,22,1,21,富邦-宜蘭,2023-03-16,9686
2337,旺宏,21,1,20,富邦-宜蘭,2023-03-16,9686
3264,欣銓,23,3,20,富邦-宜蘭,2023-03-16,9686
00720B,元大投資級公司債,20,0,20,富邦-宜蘭,2023-03-16,9686
6203,海韻電,19,0,19,富邦-宜蘭,2023-03-16,9686
2371,大同,21,2,19,富邦-宜蘭,2023-03-16,9686
2929,淘帝-KY,20,2,18,富邦-宜蘭,2023-03-16,9686
6118,建達,18,0,18,富邦-宜蘭,2023-03-16,9686
9907,統一實,18,0,18,富邦-宜蘭,2023-03-16,9686
4743,合一,15,1,14,富邦-宜蘭,2023-03-16,9686
4916,事欣科,15,2,13,富邦-宜蘭,2023-03-16,9686
4909,新復興,13,0,13,富邦-宜蘭,2023-03-16,9686
2634,漢翔,15,2,13,富邦-宜蘭,2023-03-16,9686
2887,台新金,12,0,12,富邦-宜蘭,2023-03-16,9686
4168,醣聯,12,1,11,富邦-宜蘭,2023-03-16,9686
6244,茂迪,25,14,11,富邦-宜蘭,2023-03-16,9686
1326,台化,11,0,11,富邦-宜蘭,2023-03-16,9686
8936,國統,11,0,11,富邦-宜蘭,2023-03-16,9686
6581,鋼聯,11,0,11,富邦-宜蘭,2023-03-16,9686
2402,毅嘉,11,0,11,富邦-宜蘭,2023-03-16,9686
00902,中信電池及儲能,10,0,10,富邦-宜蘭,2023-03-16,9686
2890,永豐金,13,3,10,富邦-宜蘭,2023-03-16,9686
00882,中信中國高股息,10,0,10,富邦-宜蘭,2023-03-16,9686
00772B,中信高評級公司債,14,4,10,富邦-宜蘭,2023-03-16,9686
3058,立德,10,0,10,富邦-宜蘭,2023-03-16,9686
3552,同致,10,0,10,富邦-宜蘭,2023-03-16,9686
00642U,期元大S＆P石油,12,2,10,富邦-宜蘭,2023-03-16,9686
2314,台揚,10,0,10,富邦-宜蘭,2023-03-16,9686
00715L,期街口布蘭特正2,103,0,103,富邦-宜蘭,2023-03-17,9686
00878,國泰永續高股息,98,4,94,富邦-宜蘭,2023-03-17,9686
1720,生達,81,0,81,富邦-宜蘭,2023-03-17,9686
6118,建達,65,0,65,富邦-宜蘭,2023-03-17,9686
3010,華立,42,0,42,富邦-宜蘭,2023-03-17,9686
2880,華南金,33,1,32,富邦-宜蘭,2023-03-17,9686
9907,統一實,30,0,30,富邦-宜蘭,2023-03-17,9686
2812,台中銀,30,1,29,富邦-宜蘭,2023-03-17,9686
2303,聯電,70,41,29,富邦-宜蘭,2023-03-17,9686
00712,復華富時不動產,24,0,24,富邦-宜蘭,2023-03-17,9686
2399,映泰,25,1,24,富邦-宜蘭,2023-03-17,9686
1611,中電,24,1,23,富邦-宜蘭,2023-03-17,9686
00772B,中信高評級公司債,26,4,22,富邦-宜蘭,2023-03-17,9686
6282,康舒,26,4,22,富邦-宜蘭,2023-03-17,9686
2392,正崴,22,0,22,富邦-宜蘭,2023-03-17,9686
5483,中美晶,18,0,18,富邦-宜蘭,2023-03-17,9686
3576,聯合再生,28,10,18,富邦-宜蘭,2023-03-17,9686
2882,國泰金,19,2,17,富邦-宜蘭,2023-03-17,9686
2457,飛宏,88,72,16,富邦-宜蘭,2023-03-17,9686
911868,同方友友-DR,16,0,16,富邦-宜蘭,2023-03-17,9686
2603,長榮,17,1,16,富邦-宜蘭,2023-03-17,9686
2609,陽明,37,24,13,富邦-宜蘭,2023-03-17,9686
1802,台玻,13,0,13,富邦-宜蘭,2023-03-17,9686
5880,合庫金,12,0,12,富邦-宜蘭,2023-03-17,9686
2883,凱基金,19,7,12,富邦-宜蘭,2023-03-17,9686
4979,華星光,16,4,12,富邦-宜蘭,2023-03-17,9686
4164,承業醫,11,0,11,富邦-宜蘭,2023-03-17,9686
6116,彩晶,31,20,11,富邦-宜蘭,2023-03-17,9686
4938,和碩,11,1,10,富邦-宜蘭,2023-03-17,9686
1314,中石化,11,1,10,富邦-宜蘭,2023-03-17,9686
6248,沛波,10,0,10,富邦-宜蘭,2023-03-17,9686
00664R,國泰臺灣加權反1,10,0,10,富邦-宜蘭,2023-03-17,9686
1434,福懋,10,0,10,富邦-宜蘭,2023-03-17,9686
2636,台驊控股,10,0,10,富邦-宜蘭,2023-03-17,9686
2605,新興,12,2,10,富邦-宜蘭,2023-03-17,9686
5609,中菲行,11,1,10,富邦-宜蘭,2023-03-17,9686
3536,誠創,10,0,10,富邦-宜蘭,2023-03-17,9686
2426,鼎元,10,0,10,富邦-宜蘭,2023-03-17,9686
9914,美利達,10,0,10,富邦-宜蘭,2023-03-17,9686
4566,時碩工業,10,0,10,富邦-宜蘭,2023-03-17,9686
2881,富邦金,21,11,10,富邦-宜蘭,2023-03-17,9686
2486,一詮,9,0,9,富邦-宜蘭,2023-03-17,9686
00713,元大台灣高息低波,8,0,8,富邦-宜蘭,2023-03-17,9686
4513,福裕,8,0,8,富邦-宜蘭,2023-03-17,9686
5512,力麒,9,1,8,富邦-宜蘭,2023-03-17,9686
6180,橘子,10,3,7,富邦-宜蘭,2023-03-17,9686
3219,倚強科,7,0,7,富邦-宜蘭,2023-03-17,9686
6163,華電網,7,0,7,富邦-宜蘭,2023-03-17,9686
00902,中信電池及儲能,7,0,7,富邦-宜蘭,2023-03-17,9686
00679B,元大美債20年,11,5,6,富邦-宜蘭,2023-03-17,9686
00715L,期街口布蘭特正2,105,1,104,富邦-宜蘭,2023-03-20,9686
00878,國泰永續高股息,55,0,55,富邦-宜蘭,2023-03-20,9686
2834,臺企銀,49,3,46,富邦-宜蘭,2023-03-20,9686
5512,力麒,58,16,42,富邦-宜蘭,2023-03-20,9686
6116,彩晶,31,0,31,富邦-宜蘭,2023-03-20,9686
9945,潤泰新,35,5,30,富邦-宜蘭,2023-03-20,9686
911868,同方友友-DR,30,0,30,富邦-宜蘭,2023-03-20,9686
2884,玉山金,40,12,28,富邦-宜蘭,2023-03-20,9686
2888,新光金,37,12,25,富邦-宜蘭,2023-03-20,9686
2881,富邦金,34,10,24,富邦-宜蘭,2023-03-20,9686
1903,士紙,22,0,22,富邦-宜蘭,2023-03-20,9686
1718,中纖,20,1,19,富邦-宜蘭,2023-03-20,9686
1609,大亞,21,5,16,富邦-宜蘭,2023-03-20,9686
6770,力積電,19,4,15,富邦-宜蘭,2023-03-20,9686
00772B,中信高評級公司債,15,0,15,富邦-宜蘭,2023-03-20,9686
00637L,元大滬深300正2,14,0,14,富邦-宜蘭,2023-03-20,9686
4977,眾達-KY,14,0,14,富邦-宜蘭,2023-03-20,9686
3093,港建*,15,1,14,富邦-宜蘭,2023-03-20,9686
6753,龍德造船,18,4,14,富邦-宜蘭,2023-03-20,9686
00712,復華富時不動產,13,0,13,富邦-宜蘭,2023-03-20,9686
4560,強信-KY,13,0,13,富邦-宜蘭,2023-03-20,9686
4128,中天,12,0,12,富邦-宜蘭,2023-03-20,9686
2748,雲品,15,3,12,富邦-宜蘭,2023-03-20,9686
6219,富旺,12,0,12,富邦-宜蘭,2023-03-20,9686
2618,長榮航,18,7,11,富邦-宜蘭,2023-03-20,9686
8249,菱光,11,0,11,富邦-宜蘭,2023-03-20,9686
2891,中信金,16,6,10,富邦-宜蘭,2023-03-20,9686
1432,大魯閣,10,0,10,富邦-宜蘭,2023-03-20,9686
00751B,元大AAA至A公司債,10,0,10,富邦-宜蘭,2023-03-20,9686
4157,太景*-KY,10,0,10,富邦-宜蘭,2023-03-20,9686
00632R,元大台灣50反1,10,0,10,富邦-宜蘭,2023-03-20,9686
8234,新漢,10,0,10,富邦-宜蘭,2023-03-20,9686
6666,羅麗芬-KY,11,1,10,富邦-宜蘭,2023-03-20,9686
6443,元晶,36,27,9,富邦-宜蘭,2023-03-20,9686
6148,驊宏資,9,0,9,富邦-宜蘭,2023-03-20,9686
1504,東元,18,9,9,富邦-宜蘭,2023-03-20,9686
00753L,中信中國50正2,8,0,8,富邦-宜蘭,2023-03-20,9686
8926,台汽電,16,8,8,富邦-宜蘭,2023-03-20,9686
2603,長榮,12,4,8,富邦-宜蘭,2023-03-20,9686
6788,華景電,9,1,8,富邦-宜蘭,2023-03-20,9686
5608,四維航,8,0,8,富邦-宜蘭,2023-03-20,9686
2371,大同,8,0,8,富邦-宜蘭,2023-03-20,9686
3038,全台,8,0,8,富邦-宜蘭,2023-03-20,9686
00902,中信電池及儲能,8,0,8,富邦-宜蘭,2023-03-20,9686
1434,福懋,7,0,7,富邦-宜蘭,2023-03-20,9686
00720B,元大投資級公司債,7,0,7,富邦-宜蘭,2023-03-20,9686
2014,中鴻,8,1,7,富邦-宜蘭,2023-03-20,9686
4513,福裕,7,0,7,富邦-宜蘭,2023-03-20,9686
1513,中興電,36,29,7,富邦-宜蘭,2023-03-20,9686
2330,台積電,6,0,6,富邦-宜蘭,2023-03-20,9686
2883,凱基金,188,2,186,富邦-宜蘭,2023-03-21,9686
4906,正文,106,12,94,富邦-宜蘭,2023-03-21,9686
2610,華航,55,8,47,富邦-宜蘭,2023-03-21,9686
00878,國泰永續高股息,40,2,38,富邦-宜蘭,2023-03-21,9686
2888,新光金,37,1,36,富邦-宜蘭,2023-03-21,9686
2881,富邦金,29,0,29,富邦-宜蘭,2023-03-21,9686
00712,復華富時不動產,29,5,24,富邦-宜蘭,2023-03-21,9686
6203,海韻電,24,0,24,富邦-宜蘭,2023-03-21,9686
00885,富邦越南,24,2,22,富邦-宜蘭,2023-03-21,9686
5701,劍湖山,20,0,20,富邦-宜蘭,2023-03-21,9686
5907,大洋-KY,20,0,20,富邦-宜蘭,2023-03-21,9686
8131,福懋科,20,0,20,富邦-宜蘭,2023-03-21,9686
1517,利奇,20,1,19,富邦-宜蘭,2023-03-21,9686
1529,樂事綠能,24,6,18,富邦-宜蘭,2023-03-21,9686
2303,聯電,22,5,17,富邦-宜蘭,2023-03-21,9686
2609,陽明,22,7,15,富邦-宜蘭,2023-03-21,9686
00679B,元大美債20年,15,0,15,富邦-宜蘭,2023-03-21,9686
3624,光頡,17,2,15,富邦-宜蘭,2023-03-21,9686
4102,永日,15,0,15,富邦-宜蘭,2023-03-21,9686
00720B,元大投資級公司債,14,0,14,富邦-宜蘭,2023-03-21,9686
3189,景碩,18,4,14,富邦-宜蘭,2023-03-21,9686
1434,福懋,13,0,13,富邦-宜蘭,2023-03-21,9686
5880,合庫金,12,0,12,富邦-宜蘭,2023-03-21,9686
00715L,期街口布蘭特正2,13,1,12,富邦-宜蘭,2023-03-21,9686
2023,燁輝,13,1,12,富邦-宜蘭,2023-03-21,9686
1603,華電,21,9,12,富邦-宜蘭,2023-03-21,9686
8210,勤誠,11,0,11,富邦-宜蘭,2023-03-21,9686
1314,中石化,10,0,10,富邦-宜蘭,2023-03-21,9686
2382,廣達,10,0,10,富邦-宜蘭,2023-03-21,9686
3178,公準,10,0,10,富邦-宜蘭,2023-03-21,9686
8234,新漢,10,0,10,富邦-宜蘭,2023-03-21,9686
1471,首利,10,0,10,富邦-宜蘭,2023-03-21,9686
2329,華泰,10,0,10,富邦-宜蘭,2023-03-21,9686
2413,環科,12,2,10,富邦-宜蘭,2023-03-21,9686
1316,上曜,10,0,10,富邦-宜蘭,2023-03-21,9686
6243,迅杰,10,0,10,富邦-宜蘭,2023-03-21,9686
2406,國碩,26,17,9,富邦-宜蘭,2023-03-21,9686
1218,泰山,10,1,9,富邦-宜蘭,2023-03-21,9686
2884,玉山金,10,2,8,富邦-宜蘭,2023-03-21,9686
0056,元大高股息,12,4,8,富邦-宜蘭,2023-03-21,9686
2337,旺宏,8,0,8,富邦-宜蘭,2023-03-21,9686
6120,達運,10,2,8,富邦-宜蘭,2023-03-21,9686
00888,永豐台灣ESG,8,0,8,富邦-宜蘭,2023-03-21,9686
2834,臺企銀,8,1,7,富邦-宜蘭,2023-03-21,9686
3708,上緯投控,7,0,7,富邦-宜蘭,2023-03-21,9686
00632R,元大台灣50反1,32,25,7,富邦-宜蘭,2023-03-21,9686
5230,雷笛克光學,7,0,7,富邦-宜蘭,2023-03-21,9686
4934,太極,7,0,7,富邦-宜蘭,2023-03-21,9686
6231,系微,28,22,6,富邦-宜蘭,2023-03-21,9686
2634,漢翔,8,2,6,富邦-宜蘭,2023-03-21,9686
00632R,元大台灣50反1,913,10,903,富邦-宜蘭,2023-03-22,9686
3710,連展投控,72,3,69,富邦-宜蘭,2023-03-22,9686
2457,飛宏,86,40,46,富邦-宜蘭,2023-03-22,9686
00679B,元大美債20年,40,0,40,富邦-宜蘭,2023-03-22,9686
6153,嘉聯益,30,0,30,富邦-宜蘭,2023-03-22,9686
3025,星通,31,2,29,富邦-宜蘭,2023-03-22,9686
6203,海韻電,26,0,26,富邦-宜蘭,2023-03-22,9686
2371,大同,24,0,24,富邦-宜蘭,2023-03-22,9686
3715,定穎投控,25,2,23,富邦-宜蘭,2023-03-22,9686
1605,華新,34,12,22,富邦-宜蘭,2023-03-22,9686
3038,全台,27,7,20,富邦-宜蘭,2023-03-22,9686
3508,位速,20,0,20,富邦-宜蘭,2023-03-22,9686
2104,國際中橡,20,0,20,富邦-宜蘭,2023-03-22,9686
1102,亞泥,20,0,20,富邦-宜蘭,2023-03-22,9686
6163,華電網,20,0,20,富邦-宜蘭,2023-03-22,9686
1529,樂事綠能,28,9,19,富邦-宜蘭,2023-03-22,9686
6182,合晶,23,5,18,富邦-宜蘭,2023-03-22,9686
6770,力積電,20,2,18,富邦-宜蘭,2023-03-22,9686
8049,晶采,15,0,15,富邦-宜蘭,2023-03-22,9686
1711,永光,15,0,15,富邦-宜蘭,2023-03-22,9686
4804,大略-KY,14,0,14,富邦-宜蘭,2023-03-22,9686
9945,潤泰新,19,7,12,富邦-宜蘭,2023-03-22,9686
1810,和成,11,0,11,富邦-宜蘭,2023-03-22,9686
3552,同致,12,1,11,富邦-宜蘭,2023-03-22,9686
3062,建漢,10,0,10,富邦-宜蘭,2023-03-22,9686
3013,晟銘電,18,8,10,富邦-宜蘭,2023-03-22,9686
1218,泰山,10,0,10,富邦-宜蘭,2023-03-22,9686
3536,誠創,10,0,10,富邦-宜蘭,2023-03-22,9686
2618,長榮航,24,14,10,富邦-宜蘭,2023-03-22,9686
8927,北基,10,0,10,富邦-宜蘭,2023-03-22,9686
1712,興農,10,0,10,富邦-宜蘭,2023-03-22,9686
00903,富邦元宇宙,10,0,10,富邦-宜蘭,2023-03-22,9686
911868,同方友友-DR,10,0,10,富邦-宜蘭,2023-03-22,9686
3532,台勝科,11,1,10,富邦-宜蘭,2023-03-22,9686
2427,三商電,15,6,9,富邦-宜蘭,2023-03-22,9686
3533,嘉澤,10,1,9,富邦-宜蘭,2023-03-22,9686
00895,富邦未來車,10,2,8,富邦-宜蘭,2023-03-22,9686
4934,太極,8,0,8,富邦-宜蘭,2023-03-22,9686
6223,旺矽,29,21,8,富邦-宜蘭,2023-03-22,9686
00712,復華富時不動產,24,16,8,富邦-宜蘭,2023-03-22,9686
3027,盛達,11,3,8,富邦-宜蘭,2023-03-22,9686
00664R,國泰臺灣加權反1,8,0,8,富邦-宜蘭,2023-03-22,9686
2481,強茂,12,5,7,富邦-宜蘭,2023-03-22,9686
5258,虹堡,10,3,7,富邦-宜蘭,2023-03-22,9686
2498,宏達電,12,5,7,富邦-宜蘭,2023-03-22,9686
1219,福壽,7,0,7,富邦-宜蘭,2023-03-22,9686
00772B,中信高評級公司債,7,0,7,富邦-宜蘭,2023-03-22,9686
2820,華票,7,0,7,富邦-宜蘭,2023-03-22,9686
2038,海光,7,0,7,富邦-宜蘭,2023-03-22,9686
2482,連宇,18,11,7,富邦-宜蘭,2023-03-22,9686
2883,凱基金,188,1,187,富邦-宜蘭,2023-03-23,9686
2427,三商電,101,1,100,富邦-宜蘭,2023-03-23,9686
8234,新漢,52,1,51,富邦-宜蘭,2023-03-23,9686
4743,合一,44,6,38,富邦-宜蘭,2023-03-23,9686
3710,連展投控,47,12,35,富邦-宜蘭,2023-03-23,9686
3481,群創,58,24,34,富邦-宜蘭,2023-03-23,9686
5701,劍湖山,30,0,30,富邦-宜蘭,2023-03-23,9686
3294,英濟,30,0,30,富邦-宜蘭,2023-03-23,9686
2812,台中銀,26,0,26,富邦-宜蘭,2023-03-23,9686
2534,宏盛,23,0,23,富邦-宜蘭,2023-03-23,9686
00772B,中信高評級公司債,21,0,21,富邦-宜蘭,2023-03-23,9686
3536,誠創,20,0,20,富邦-宜蘭,2023-03-23,9686
1598,岱宇,20,0,20,富邦-宜蘭,2023-03-23,9686
00898,國泰基因免疫革命,20,0,20,富邦-宜蘭,2023-03-23,9686
6122,擎邦,35,16,19,富邦-宜蘭,2023-03-23,9686
2303,聯電,37,18,19,富邦-宜蘭,2023-03-23,9686
00679B,元大美債20年,18,1,17,富邦-宜蘭,2023-03-23,9686
3031,佰鴻,16,0,16,富邦-宜蘭,2023-03-23,9686
8105,凌巨,15,0,15,富邦-宜蘭,2023-03-23,9686
6235,華孚,21,6,15,富邦-宜蘭,2023-03-23,9686
6163,華電網,15,0,15,富邦-宜蘭,2023-03-23,9686
3071,協禧,15,0,15,富邦-宜蘭,2023-03-23,9686
6288,聯嘉,41,26,15,富邦-宜蘭,2023-03-23,9686
2609,陽明,40,25,15,富邦-宜蘭,2023-03-23,9686
6223,旺矽,29,15,14,富邦-宜蘭,2023-03-23,9686
1605,華新,20,6,14,富邦-宜蘭,2023-03-23,9686
00882,中信中國高股息,13,0,13,富邦-宜蘭,2023-03-23,9686
4164,承業醫,13,0,13,富邦-宜蘭,2023-03-23,9686
2328,廣宇,13,0,13,富邦-宜蘭,2023-03-23,9686
2606,裕民,17,5,12,富邦-宜蘭,2023-03-23,9686
2605,新興,13,2,11,富邦-宜蘭,2023-03-23,9686
6188,廣明,14,3,11,富邦-宜蘭,2023-03-23,9686
1524,耿鼎,19,8,11,富邦-宜蘭,2023-03-23,9686
8176,智捷,11,0,11,富邦-宜蘭,2023-03-23,9686
2312,金寶,10,0,10,富邦-宜蘭,2023-03-23,9686
4157,太景*-KY,12,2,10,富邦-宜蘭,2023-03-23,9686
3564,其陽,10,0,10,富邦-宜蘭,2023-03-23,9686
3363,上詮,12,2,10,富邦-宜蘭,2023-03-23,9686
1522,堤維西,11,1,10,富邦-宜蘭,2023-03-23,9686
2355,敬鵬,10,0,10,富邦-宜蘭,2023-03-23,9686
6874,倍力,10,0,10,富邦-宜蘭,2023-03-23,9686
5425,台半,14,4,10,富邦-宜蘭,2023-03-23,9686
3234,光環,9,0,9,富邦-宜蘭,2023-03-23,9686
5474,聰泰,9,0,9,富邦-宜蘭,2023-03-23,9686
1519,華城,9,0,9,富邦-宜蘭,2023-03-23,9686
00712,復華富時不動產,9,0,9,富邦-宜蘭,2023-03-23,9686
3027,盛達,8,0,8,富邦-宜蘭,2023-03-23,9686
3029,零壹,19,11,8,富邦-宜蘭,2023-03-23,9686
6509,聚和,8,0,8,富邦-宜蘭,2023-03-23,9686
1514,亞力,8,0,8,富邦-宜蘭,2023-03-23,9686
00632R,元大台灣50反1,182,40,142,富邦-宜蘭,2023-03-24,9686
1752,南光,50,0,50,富邦-宜蘭,2023-03-24,9686
00676R,富邦臺灣加權反1,50,0,50,富邦-宜蘭,2023-03-24,9686
2340,台亞,53,5,48,富邦-宜蘭,2023-03-24,9686
00679B,元大美債20年,47,0,47,富邦-宜蘭,2023-03-24,9686
3058,立德,32,0,32,富邦-宜蘭,2023-03-24,9686
3499,環天科,32,1,31,富邦-宜蘭,2023-03-24,9686
3033,威健,30,0,30,富邦-宜蘭,2023-03-24,9686
6192,巨路,30,0,30,富邦-宜蘭,2023-03-24,9686
2105,正新,30,5,25,富邦-宜蘭,2023-03-24,9686
2881,富邦金,27,3,24,富邦-宜蘭,2023-03-24,9686
6443,元晶,26,2,24,富邦-宜蘭,2023-03-24,9686
2812,台中銀,25,1,24,富邦-宜蘭,2023-03-24,9686
6116,彩晶,24,3,21,富邦-宜蘭,2023-03-24,9686
00882,中信中國高股息,20,0,20,富邦-宜蘭,2023-03-24,9686
8421,旭源,20,2,18,富邦-宜蘭,2023-03-24,9686
6274,台燿,18,0,18,富邦-宜蘭,2023-03-24,9686
2482,連宇,17,0,17,富邦-宜蘭,2023-03-24,9686
2478,大毅,17,0,17,富邦-宜蘭,2023-03-24,9686
6243,迅杰,27,10,17,富邦-宜蘭,2023-03-24,9686
2455,全新,17,1,16,富邦-宜蘭,2023-03-24,9686
00720B,元大投資級公司債,16,0,16,富邦-宜蘭,2023-03-24,9686
1815,富喬,15,0,15,富邦-宜蘭,2023-03-24,9686
2610,華航,15,0,15,富邦-宜蘭,2023-03-24,9686
2618,長榮航,15,1,14,富邦-宜蘭,2023-03-24,9686
2882,國泰金,14,0,14,富邦-宜蘭,2023-03-24,9686
9904,寶成,14,0,14,富邦-宜蘭,2023-03-24,9686
1326,台化,13,0,13,富邦-宜蘭,2023-03-24,9686
00712,復華富時不動產,12,0,12,富邦-宜蘭,2023-03-24,9686
2603,長榮,33,21,12,富邦-宜蘭,2023-03-24,9686
6284,佳邦,12,0,12,富邦-宜蘭,2023-03-24,9686
2371,大同,15,3,12,富邦-宜蘭,2023-03-24,9686
5009,榮剛,11,0,11,富邦-宜蘭,2023-03-24,9686
00892,富邦台灣半導體,11,0,11,富邦-宜蘭,2023-03-24,9686
3481,群創,20,9,11,富邦-宜蘭,2023-03-24,9686
1319,東陽,19,8,11,富邦-宜蘭,2023-03-24,9686
2884,玉山金,10,0,10,富邦-宜蘭,2023-03-24,9686
5225,東科-KY,10,0,10,富邦-宜蘭,2023-03-24,9686
3536,誠創,10,0,10,富邦-宜蘭,2023-03-24,9686
2302,麗正,12,2,10,富邦-宜蘭,2023-03-24,9686
2476,鉅祥,15,5,10,富邦-宜蘭,2023-03-24,9686
2889,國票金,18,8,10,富邦-宜蘭,2023-03-24,9686
2204,中華,9,0,9,富邦-宜蘭,2023-03-24,9686
8024,佑華,12,3,9,富邦-宜蘭,2023-03-24,9686
6606,建德工業,8,0,8,富邦-宜蘭,2023-03-24,9686
00674R,期元大S＆P黃金反1,8,0,8,富邦-宜蘭,2023-03-24,9686
6806,森崴能源,10,2,8,富邦-宜蘭,2023-03-24,9686
4934,太極,7,0,7,富邦-宜蘭,2023-03-24,9686
6188,廣明,12,5,7,富邦-宜蘭,2023-03-24,9686
6446,藥華藥,7,0,7,富邦-宜蘭,2023-03-24,9686
1605,華新,69,15,54,富邦-宜蘭,2023-03-27,9686
3050,鈺德,51,0,51,富邦-宜蘭,2023-03-27,9686
00877,復華中國5G,50,0,50,富邦-宜蘭,2023-03-27,9686
00922,國泰台灣領袖50,47,0,47,富邦-宜蘭,2023-03-27,9686
1504,東元,56,22,34,富邦-宜蘭,2023-03-27,9686
4157,太景*-KY,34,0,34,富邦-宜蘭,2023-03-27,9686
2014,中鴻,33,0,33,富邦-宜蘭,2023-03-27,9686
2890,永豐金,41,8,33,富邦-宜蘭,2023-03-27,9686
1316,上曜,32,0,32,富邦-宜蘭,2023-03-27,9686
00882,中信中國高股息,32,0,32,富邦-宜蘭,2023-03-27,9686
2889,國票金,41,10,31,富邦-宜蘭,2023-03-27,9686
2344,華邦電,32,10,22,富邦-宜蘭,2023-03-27,9686
6416,瑞祺電通,25,4,21,富邦-宜蘭,2023-03-27,9686
2206,三陽工業,39,19,20,富邦-宜蘭,2023-03-27,9686
2027,大成鋼,21,2,19,富邦-宜蘭,2023-03-27,9686
00637L,元大滬深300正2,17,0,17,富邦-宜蘭,2023-03-27,9686
3714,富采,33,17,16,富邦-宜蘭,2023-03-27,9686
3481,群創,29,13,16,富邦-宜蘭,2023-03-27,9686
00753L,中信中國50正2,20,6,14,富邦-宜蘭,2023-03-27,9686
3715,定穎投控,19,5,14,富邦-宜蘭,2023-03-27,9686
2002,中鋼,14,1,13,富邦-宜蘭,2023-03-27,9686
6288,聯嘉,51,39,12,富邦-宜蘭,2023-03-27,9686
00712,復華富時不動產,12,0,12,富邦-宜蘭,2023-03-27,9686
2402,毅嘉,17,5,12,富邦-宜蘭,2023-03-27,9686
6160,欣技,19,7,12,富邦-宜蘭,2023-03-27,9686
4903,聯光通,12,1,11,富邦-宜蘭,2023-03-27,9686
3056,富華新,11,0,11,富邦-宜蘭,2023-03-27,9686
5351,鈺創,13,2,11,富邦-宜蘭,2023-03-27,9686
4147,中裕,11,0,11,富邦-宜蘭,2023-03-27,9686
1612,宏泰,11,0,11,富邦-宜蘭,2023-03-27,9686
5340,建榮,10,0,10,富邦-宜蘭,2023-03-27,9686
2464,盟立,10,0,10,富邦-宜蘭,2023-03-27,9686
2317,鴻海,10,0,10,富邦-宜蘭,2023-03-27,9686
3051,力特,10,0,10,富邦-宜蘭,2023-03-27,9686
2891,中信金,11,1,10,富邦-宜蘭,2023-03-27,9686
1314,中石化,10,0,10,富邦-宜蘭,2023-03-27,9686
3013,晟銘電,10,0,10,富邦-宜蘭,2023-03-27,9686
8215,明基材,10,0,10,富邦-宜蘭,2023-03-27,9686
5880,合庫金,11,1,10,富邦-宜蘭,2023-03-27,9686
3372,典範,10,0,10,富邦-宜蘭,2023-03-27,9686
6113,亞矽,10,0,10,富邦-宜蘭,2023-03-27,9686
00892,富邦台灣半導體,11,1,10,富邦-宜蘭,2023-03-27,9686
1512,瑞利,10,0,10,富邦-宜蘭,2023-03-27,9686
2882,國泰金,11,2,9,富邦-宜蘭,2023-03-27,9686
1417,嘉裕,11,2,9,富邦-宜蘭,2023-03-27,9686
2323,中環,9,0,9,富邦-宜蘭,2023-03-27,9686
2486,一詮,10,1,9,富邦-宜蘭,2023-03-27,9686
3062,建漢,11,2,9,富邦-宜蘭,2023-03-27,9686
1524,耿鼎,8,0,8,富邦-宜蘭,2023-03-27,9686
2104,國際中橡,8,0,8,富邦-宜蘭,2023-03-27,9686
1722,台肥,209,4,205,富邦-宜蘭,2023-03-28,9686
2867,三商壽,100,0,100,富邦-宜蘭,2023-03-28,9686
6770,力積電,61,1,60,富邦-宜蘭,2023-03-28,9686
1709,和益,60,4,56,富邦-宜蘭,2023-03-28,9686
2603,長榮,74,30,44,富邦-宜蘭,2023-03-28,9686
00679B,元大美債20年,40,0,40,富邦-宜蘭,2023-03-28,9686
1708,東鹼,40,2,38,富邦-宜蘭,2023-03-28,9686
8403,盛弘,28,0,28,富邦-宜蘭,2023-03-28,9686
2105,正新,27,0,27,富邦-宜蘭,2023-03-28,9686
1605,華新,62,36,26,富邦-宜蘭,2023-03-28,9686
00882,中信中國高股息,25,0,25,富邦-宜蘭,2023-03-28,9686
3011,今皓,46,21,25,富邦-宜蘭,2023-03-28,9686
2303,聯電,45,22,23,富邦-宜蘭,2023-03-28,9686
2337,旺宏,22,0,22,富邦-宜蘭,2023-03-28,9686
00892,富邦台灣半導體,22,0,22,富邦-宜蘭,2023-03-28,9686
3047,訊舟,22,1,21,富邦-宜蘭,2023-03-28,9686
3010,華立,20,0,20,富邦-宜蘭,2023-03-28,9686
00712,復華富時不動產,17,0,17,富邦-宜蘭,2023-03-28,9686
3664,安瑞-KY,17,0,17,富邦-宜蘭,2023-03-28,9686
2890,永豐金,17,0,17,富邦-宜蘭,2023-03-28,9686
3037,欣興,30,13,17,富邦-宜蘭,2023-03-28,9686
3607,谷崧,16,0,16,富邦-宜蘭,2023-03-28,9686
2344,華邦電,24,8,16,富邦-宜蘭,2023-03-28,9686
4916,事欣科,15,0,15,富邦-宜蘭,2023-03-28,9686
2645,長榮航太,17,2,15,富邦-宜蘭,2023-03-28,9686
9907,統一實,15,0,15,富邦-宜蘭,2023-03-28,9686
2206,三陽工業,41,27,14,富邦-宜蘭,2023-03-28,9686
2498,宏達電,22,9,13,富邦-宜蘭,2023-03-28,9686
2884,玉山金,15,3,12,富邦-宜蘭,2023-03-28,9686
2399,映泰,17,5,12,富邦-宜蘭,2023-03-28,9686
00751B,元大AAA至A公司債,22,10,12,富邦-宜蘭,2023-03-28,9686
00772B,中信高評級公司債,11,0,11,富邦-宜蘭,2023-03-28,9686
6197,佳必琪,11,0,11,富邦-宜蘭,2023-03-28,9686
4974,亞泰,11,0,11,富邦-宜蘭,2023-03-28,9686
2537,聯上發,11,0,11,富邦-宜蘭,2023-03-28,9686
3217,優群,17,6,11,富邦-宜蘭,2023-03-28,9686
6118,建達,33,22,11,富邦-宜蘭,2023-03-28,9686
5309,系統電,11,0,11,富邦-宜蘭,2023-03-28,9686
3260,威剛,13,3,10,富邦-宜蘭,2023-03-28,9686
2609,陽明,20,10,10,富邦-宜蘭,2023-03-28,9686
3703,欣陸,10,0,10,富邦-宜蘭,2023-03-28,9686
3536,誠創,10,0,10,富邦-宜蘭,2023-03-28,9686
3031,佰鴻,11,1,10,富邦-宜蘭,2023-03-28,9686
2349,錸德,10,0,10,富邦-宜蘭,2023-03-28,9686
6243,迅杰,15,5,10,富邦-宜蘭,2023-03-28,9686
00680L,元大美債20正2,10,0,10,富邦-宜蘭,2023-03-28,9686
3005,神基,10,0,10,富邦-宜蘭,2023-03-28,9686
2607,榮運,10,0,10,富邦-宜蘭,2023-03-28,9686
1815,富喬,10,0,10,富邦-宜蘭,2023-03-28,9686
1612,宏泰,10,0,10,富邦-宜蘭,2023-03-28,9686
2852,第一保,100,0,100,富邦-宜蘭,2023-03-29,9686
2867,三商壽,110,19,91,富邦-宜蘭,2023-03-29,9686
1722,台肥,65,1,64,富邦-宜蘭,2023-03-29,9686
3479,安勤,42,1,41,富邦-宜蘭,2023-03-29,9686
2329,華泰,56,16,40,富邦-宜蘭,2023-03-29,9686
3010,華立,35,0,35,富邦-宜蘭,2023-03-29,9686
2342,茂矽,42,8,34,富邦-宜蘭,2023-03-29,9686
3664,安瑞-KY,33,0,33,富邦-宜蘭,2023-03-29,9686
9945,潤泰新,30,0,30,富邦-宜蘭,2023-03-29,9686
1708,東鹼,33,3,30,富邦-宜蘭,2023-03-29,9686
3432,台端,35,6,29,富邦-宜蘭,2023-03-29,9686
00772B,中信高評級公司債,25,0,25,富邦-宜蘭,2023-03-29,9686
00892,富邦台灣半導體,25,0,25,富邦-宜蘭,2023-03-29,9686
6168,宏齊,20,0,20,富邦-宜蘭,2023-03-29,9686
1612,宏泰,20,0,20,富邦-宜蘭,2023-03-29,9686
5340,建榮,19,0,19,富邦-宜蘭,2023-03-29,9686
2317,鴻海,28,10,18,富邦-宜蘭,2023-03-29,9686
2371,大同,20,3,17,富邦-宜蘭,2023-03-29,9686
2208,台船,17,0,17,富邦-宜蘭,2023-03-29,9686
00679B,元大美債20年,18,1,17,富邦-宜蘭,2023-03-29,9686
2609,陽明,23,7,16,富邦-宜蘭,2023-03-29,9686
00680L,元大美債20正2,16,0,16,富邦-宜蘭,2023-03-29,9686
1802,台玻,15,0,15,富邦-宜蘭,2023-03-29,9686
5258,虹堡,15,1,14,富邦-宜蘭,2023-03-29,9686
2303,聯電,59,46,13,富邦-宜蘭,2023-03-29,9686
2337,旺宏,13,0,13,富邦-宜蘭,2023-03-29,9686
5225,東科-KY,13,0,13,富邦-宜蘭,2023-03-29,9686
6416,瑞祺電通,12,0,12,富邦-宜蘭,2023-03-29,9686
1618,合機,18,7,11,富邦-宜蘭,2023-03-29,9686
6116,彩晶,31,20,11,富邦-宜蘭,2023-03-29,9686
00922,國泰台灣領袖50,11,1,10,富邦-宜蘭,2023-03-29,9686
4804,大略-KY,10,0,10,富邦-宜蘭,2023-03-29,9686
3441,聯一光,11,1,10,富邦-宜蘭,2023-03-29,9686
2010,春源,10,0,10,富邦-宜蘭,2023-03-29,9686
00903,富邦元宇宙,10,0,10,富邦-宜蘭,2023-03-29,9686
3710,連展投控,10,0,10,富邦-宜蘭,2023-03-29,9686
6531,愛普*,12,2,10,富邦-宜蘭,2023-03-29,9686
1609,大亞,35,25,10,富邦-宜蘭,2023-03-29,9686
3290,東浦,9,0,9,富邦-宜蘭,2023-03-29,9686
3217,優群,14,6,8,富邦-宜蘭,2023-03-29,9686
2399,映泰,10,2,8,富邦-宜蘭,2023-03-29,9686
3536,誠創,7,0,7,富邦-宜蘭,2023-03-29,9686
8171,天宇,7,0,7,富邦-宜蘭,2023-03-29,9686
2603,長榮,8,2,6,富邦-宜蘭,2023-03-29,9686
2027,大成鋼,6,0,6,富邦-宜蘭,2023-03-29,9686
8926,台汽電,6,0,6,富邦-宜蘭,2023-03-29,9686
3231,緯創,17,11,6,富邦-宜蘭,2023-03-29,9686
2492,華新科,5,0,5,富邦-宜蘭,2023-03-29,9686
3035,智原,12,7,5,富邦-宜蘭,2023-03-29,9686
00673R,期元大S＆P原油反1,5,0,5,富邦-宜蘭,2023-03-29,9686
2889,國票金,53,0,53,富邦-宜蘭,2023-03-30,9686
4804,大略-KY,52,0,52,富邦-宜蘭,2023-03-30,9686
6770,力積電,41,10,31,富邦-宜蘭,2023-03-30,9686
5701,劍湖山,30,0,30,富邦-宜蘭,2023-03-30,9686
2890,永豐金,29,0,29,富邦-宜蘭,2023-03-30,9686
2429,銘旺科,25,0,25,富邦-宜蘭,2023-03-30,9686
2331,精英,21,0,21,富邦-宜蘭,2023-03-30,9686
2610,華航,68,47,21,富邦-宜蘭,2023-03-30,9686
6167,久正,20,0,20,富邦-宜蘭,2023-03-30,9686
1722,台肥,20,0,20,富邦-宜蘭,2023-03-30,9686
5243,乙盛-KY,20,1,19,富邦-宜蘭,2023-03-30,9686
6443,元晶,20,1,19,富邦-宜蘭,2023-03-30,9686
2006,東和鋼鐵,15,1,14,富邦-宜蘭,2023-03-30,9686
1605,華新,67,53,14,富邦-宜蘭,2023-03-30,9686
2712,遠雄來,13,0,13,富邦-宜蘭,2023-03-30,9686
00679B,元大美債20年,13,0,13,富邦-宜蘭,2023-03-30,9686
1708,東鹼,12,0,12,富邦-宜蘭,2023-03-30,9686
2359,所羅門,26,14,12,富邦-宜蘭,2023-03-30,9686
3011,今皓,14,2,12,富邦-宜蘭,2023-03-30,9686
1218,泰山,10,0,10,富邦-宜蘭,2023-03-30,9686
5907,大洋-KY,10,0,10,富邦-宜蘭,2023-03-30,9686
6133,金橋,36,27,9,富邦-宜蘭,2023-03-30,9686
3312,弘憶股,8,0,8,富邦-宜蘭,2023-03-30,9686
2888,新光金,10,3,7,富邦-宜蘭,2023-03-30,9686
1504,東元,22,15,7,富邦-宜蘭,2023-03-30,9686
4746,台耀,7,0,7,富邦-宜蘭,2023-03-30,9686
00665L,富邦�琤肭磪囓�2,7,0,7,富邦-宜蘭,2023-03-30,9686
2881,富邦金,7,1,6,富邦-宜蘭,2023-03-30,9686
1609,大亞,10,4,6,富邦-宜蘭,2023-03-30,9686
2883,凱基金,6,0,6,富邦-宜蘭,2023-03-30,9686
5351,鈺創,7,1,6,富邦-宜蘭,2023-03-30,9686
6235,華孚,7,1,6,富邦-宜蘭,2023-03-30,9686
5521,工信,6,0,6,富邦-宜蘭,2023-03-30,9686
6134,萬旭,7,1,6,富邦-宜蘭,2023-03-30,9686
4908,前鼎,6,0,6,富邦-宜蘭,2023-03-30,9686
4977,眾達-KY,11,5,6,富邦-宜蘭,2023-03-30,9686
6147,頎邦,6,0,6,富邦-宜蘭,2023-03-30,9686
3189,景碩,8,2,6,富邦-宜蘭,2023-03-30,9686
5608,四維航,5,0,5,富邦-宜蘭,2023-03-30,9686
00882,中信中國高股息,5,0,5,富邦-宜蘭,2023-03-30,9686
8085,福華,5,0,5,富邦-宜蘭,2023-03-30,9686
8936,國統,5,0,5,富邦-宜蘭,2023-03-30,9686
1529,樂事綠能,9,4,5,富邦-宜蘭,2023-03-30,9686
2312,金寶,5,0,5,富邦-宜蘭,2023-03-30,9686
1304,台聚,5,0,5,富邦-宜蘭,2023-03-30,9686
6196,帆宣,5,0,5,富邦-宜蘭,2023-03-30,9686
1515,力山,5,0,5,富邦-宜蘭,2023-03-30,9686
3702,大聯大,5,0,5,富邦-宜蘭,2023-03-30,9686
2421,建準,12,7,5,富邦-宜蘭,2023-03-30,9686
3481,群創,5,0,5,富邦-宜蘭,2023-03-30,9686
00673R,期元大S＆P原油反1,305,0,305,富邦-宜蘭,2023-03-31,9686
00632R,元大台灣50反1,161,10,151,富邦-宜蘭,2023-03-31,9686
1304,台聚,50,0,50,富邦-宜蘭,2023-03-31,9686
2352,佳世達,50,3,47,富邦-宜蘭,2023-03-31,9686
8050,廣積,31,2,29,富邦-宜蘭,2023-03-31,9686
8436,大江,25,0,25,富邦-宜蘭,2023-03-31,9686
1789,神隆,22,0,22,富邦-宜蘭,2023-03-31,9686
00751B,元大AAA至A公司債,22,0,22,富邦-宜蘭,2023-03-31,9686
2615,萬海,23,1,22,富邦-宜蘭,2023-03-31,9686
3536,誠創,20,0,20,富邦-宜蘭,2023-03-31,9686
1612,宏泰,20,0,20,富邦-宜蘭,2023-03-31,9686
2426,鼎元,20,1,19,富邦-宜蘭,2023-03-31,9686
3056,富華新,17,2,15,富邦-宜蘭,2023-03-31,9686
2328,廣宇,15,1,14,富邦-宜蘭,2023-03-31,9686
2027,大成鋼,13,0,13,富邦-宜蘭,2023-03-31,9686
6770,力積電,42,29,13,富邦-宜蘭,2023-03-31,9686
1471,首利,11,0,11,富邦-宜蘭,2023-03-31,9686
2353,宏��,10,0,10,富邦-宜蘭,2023-03-31,9686
6285,啟��,15,5,10,富邦-宜蘭,2023-03-31,9686
1595,川寶,10,0,10,富邦-宜蘭,2023-03-31,9686
2634,漢翔,13,3,10,富邦-宜蘭,2023-03-31,9686
2429,銘旺科,10,0,10,富邦-宜蘭,2023-03-31,9686
5258,虹堡,11,1,10,富邦-宜蘭,2023-03-31,9686
6217,中探針,9,0,9,富邦-宜蘭,2023-03-31,9686
3224,三顧,10,1,9,富邦-宜蘭,2023-03-31,9686
3022,威強電,11,2,9,富邦-宜蘭,2023-03-31,9686
1605,華新,28,20,8,富邦-宜蘭,2023-03-31,9686
2342,茂矽,13,5,8,富邦-宜蘭,2023-03-31,9686
00679B,元大美債20年,8,0,8,富邦-宜蘭,2023-03-31,9686
2002,中鋼,8,1,7,富邦-宜蘭,2023-03-31,9686
1701,中化,9,2,7,富邦-宜蘭,2023-03-31,9686
8931,大汽電,9,2,7,富邦-宜蘭,2023-03-31,9686
2520,冠德,7,0,7,富邦-宜蘭,2023-03-31,9686
2302,麗正,8,1,7,富邦-宜蘭,2023-03-31,9686
2371,大同,7,0,7,富邦-宜蘭,2023-03-31,9686
1513,中興電,7,1,6,富邦-宜蘭,2023-03-31,9686
4130,健亞,6,0,6,富邦-宜蘭,2023-03-31,9686
6203,海韻電,7,1,6,富邦-宜蘭,2023-03-31,9686
1584,精剛,6,0,6,富邦-宜蘭,2023-03-31,9686
1569,濱川,5,0,5,富邦-宜蘭,2023-03-31,9686
8105,凌巨,5,0,5,富邦-宜蘭,2023-03-31,9686
3607,谷崧,5,0,5,富邦-宜蘭,2023-03-31,9686
2105,正新,6,1,5,富邦-宜蘭,2023-03-31,9686
4973,廣穎,5,0,5,富邦-宜蘭,2023-03-31,9686
2645,長榮航太,5,0,5,富邦-宜蘭,2023-03-31,9686
2881,富邦金,8,3,5,富邦-宜蘭,2023-03-31,9686
2889,國票金,12,7,5,富邦-宜蘭,2023-03-31,9686
3665,貿聯-KY,8,3,5,富邦-宜蘭,2023-03-31,9686
3037,欣興,7,3,4,富邦-宜蘭,2023-03-31,9686
3231,緯創,15,11,4,富邦-宜蘭,2023-03-31,9686
00673R,期元大S＆P原油反1,736,0,736,富邦-宜蘭,2023-04-06,9686
2344,華邦電,78,9,69,富邦-宜蘭,2023-04-06,9686
00893,國泰智能電動車,62,0,62,富邦-宜蘭,2023-04-06,9686
2834,臺企銀,56,2,54,富邦-宜蘭,2023-04-06,9686
2610,華航,40,0,40,富邦-宜蘭,2023-04-06,9686
2313,華通,34,0,34,富邦-宜蘭,2023-04-06,9686
3011,今皓,30,2,28,富邦-宜蘭,2023-04-06,9686
8069,元太,24,0,24,富邦-宜蘭,2023-04-06,9686
2484,希華,25,2,23,富邦-宜蘭,2023-04-06,9686
1708,東鹼,23,0,23,富邦-宜蘭,2023-04-06,9686
2891,中信金,22,0,22,富邦-宜蘭,2023-04-06,9686
8150,南茂,27,6,21,富邦-宜蘭,2023-04-06,9686
2609,陽明,27,7,20,富邦-宜蘭,2023-04-06,9686
00896,中信綠能及電動車,21,1,20,富邦-宜蘭,2023-04-06,9686
00882,中信中國高股息,19,0,19,富邦-宜蘭,2023-04-06,9686
2515,中工,19,0,19,富邦-宜蘭,2023-04-06,9686
3536,誠創,18,0,18,富邦-宜蘭,2023-04-06,9686
00712,復華富時不動產,16,0,16,富邦-宜蘭,2023-04-06,9686
2618,長榮航,18,3,15,富邦-宜蘭,2023-04-06,9686
9904,寶成,16,2,14,富邦-宜蘭,2023-04-06,9686
2603,長榮,31,17,14,富邦-宜蘭,2023-04-06,9686
6234,高僑,12,0,12,富邦-宜蘭,2023-04-06,9686
3430,奇鈦科,12,0,12,富邦-宜蘭,2023-04-06,9686
2027,大成鋼,11,1,10,富邦-宜蘭,2023-04-06,9686
4157,太景*-KY,10,0,10,富邦-宜蘭,2023-04-06,9686
00671R,富邦NASDAQ反1,10,0,10,富邦-宜蘭,2023-04-06,9686
3308,聯德,10,0,10,富邦-宜蘭,2023-04-06,9686
00665L,富邦�琤肭磪囓�2,10,0,10,富邦-宜蘭,2023-04-06,9686
00900,富邦特選高股息30,12,2,10,富邦-宜蘭,2023-04-06,9686
3664,安瑞-KY,10,0,10,富邦-宜蘭,2023-04-06,9686
8049,晶采,10,0,10,富邦-宜蘭,2023-04-06,9686
3520,華盈,10,0,10,富邦-宜蘭,2023-04-06,9686
4804,大略-KY,9,0,9,富邦-宜蘭,2023-04-06,9686
2211,長榮鋼,10,1,9,富邦-宜蘭,2023-04-06,9686
3202,樺晟,10,1,9,富邦-宜蘭,2023-04-06,9686
3078,僑威,9,0,9,富邦-宜蘭,2023-04-06,9686
6770,力積電,29,20,9,富邦-宜蘭,2023-04-06,9686
3037,欣興,10,1,9,富邦-宜蘭,2023-04-06,9686
3545,敦泰,11,3,8,富邦-宜蘭,2023-04-06,9686
1611,中電,8,0,8,富邦-宜蘭,2023-04-06,9686
2617,台航,8,0,8,富邦-宜蘭,2023-04-06,9686
5289,宜鼎,8,0,8,富邦-宜蘭,2023-04-06,9686
8033,雷虎,10,2,8,富邦-宜蘭,2023-04-06,9686
6163,華電網,20,12,8,富邦-宜蘭,2023-04-06,9686
2337,旺宏,8,0,8,富邦-宜蘭,2023-04-06,9686
2208,台船,31,24,7,富邦-宜蘭,2023-04-06,9686
3231,緯創,8,1,7,富邦-宜蘭,2023-04-06,9686
3149,正達,7,0,7,富邦-宜蘭,2023-04-06,9686
6182,合晶,8,1,7,富邦-宜蘭,2023-04-06,9686
6285,啟��,10,3,7,富邦-宜蘭,2023-04-06,9686
6770,力積電,65,2,63,富邦-宜蘭,2023-04-07,9686
1517,利奇,60,0,60,富邦-宜蘭,2023-04-07,9686
2618,長榮航,54,1,53,富邦-宜蘭,2023-04-07,9686
3149,正達,47,0,47,富邦-宜蘭,2023-04-07,9686
6126,信音,32,0,32,富邦-宜蘭,2023-04-07,9686
6152,百一,30,0,30,富邦-宜蘭,2023-04-07,9686
1313,聯成,30,0,30,富邦-宜蘭,2023-04-07,9686
2889,國票金,30,1,29,富邦-宜蘭,2023-04-07,9686
3664,安瑞-KY,28,0,28,富邦-宜蘭,2023-04-07,9686
3536,誠創,28,0,28,富邦-宜蘭,2023-04-07,9686
2891,中信金,30,5,25,富邦-宜蘭,2023-04-07,9686
1609,大亞,60,36,24,富邦-宜蘭,2023-04-07,9686
6244,茂迪,25,2,23,富邦-宜蘭,2023-04-07,9686
1504,東元,26,4,22,富邦-宜蘭,2023-04-07,9686
00673R,期元大S＆P原油反1,28,6,22,富邦-宜蘭,2023-04-07,9686
5469,瀚宇博,19,0,19,富邦-宜蘭,2023-04-07,9686
2534,宏盛,23,4,19,富邦-宜蘭,2023-04-07,9686
2303,聯電,19,0,19,富邦-宜蘭,2023-04-07,9686
00751B,元大AAA至A公司債,17,0,17,富邦-宜蘭,2023-04-07,9686
6470,宇智,18,1,17,富邦-宜蘭,2023-04-07,9686
4702,中美實,16,0,16,富邦-宜蘭,2023-04-07,9686
5225,東科-KY,16,0,16,富邦-宜蘭,2023-04-07,9686
00712,復華富時不動產,14,0,14,富邦-宜蘭,2023-04-07,9686
1701,中化,15,2,13,富邦-宜蘭,2023-04-07,9686
00922,國泰台灣領袖50,12,0,12,富邦-宜蘭,2023-04-07,9686
5258,虹堡,12,0,12,富邦-宜蘭,2023-04-07,9686
2421,建準,11,0,11,富邦-宜蘭,2023-04-07,9686
3027,盛達,10,0,10,富邦-宜蘭,2023-04-07,9686
1708,東鹼,10,0,10,富邦-宜蘭,2023-04-07,9686
3236,千如,10,0,10,富邦-宜蘭,2023-04-07,9686
5533,皇鼎,10,0,10,富邦-宜蘭,2023-04-07,9686
1471,首利,10,0,10,富邦-宜蘭,2023-04-07,9686
1815,富喬,10,0,10,富邦-宜蘭,2023-04-07,9686
1605,華新,15,5,10,富邦-宜蘭,2023-04-07,9686
1560,中砂,11,2,9,富邦-宜蘭,2023-04-07,9686
6807,峰源-KY,9,0,9,富邦-宜蘭,2023-04-07,9686
5222,全訊,11,2,9,富邦-宜蘭,2023-04-07,9686
00679B,元大美債20年,9,0,9,富邦-宜蘭,2023-04-07,9686
2723,美食-KY,8,0,8,富邦-宜蘭,2023-04-07,9686
6215,和椿,8,0,8,富邦-宜蘭,2023-04-07,9686
2852,第一保,8,0,8,富邦-宜蘭,2023-04-07,9686
6163,華電網,8,0,8,富邦-宜蘭,2023-04-07,9686
1524,耿鼎,11,3,8,富邦-宜蘭,2023-04-07,9686
6666,羅麗芬-KY,8,0,8,富邦-宜蘭,2023-04-07,9686
4566,時碩工業,8,0,8,富邦-宜蘭,2023-04-07,9686
00680L,元大美債20正2,16,8,8,富邦-宜蘭,2023-04-07,9686
2356,英業達,7,0,7,富邦-宜蘭,2023-04-07,9686
6235,華孚,11,4,7,富邦-宜蘭,2023-04-07,9686
6168,宏齊,7,0,7,富邦-宜蘭,2023-04-07,9686
2537,聯上發,7,0,7,富邦-宜蘭,2023-04-07,9686
6126,信音,170,0,170,富邦-宜蘭,2023-04-10,9686
6282,康舒,100,0,100,富邦-宜蘭,2023-04-10,9686
2349,錸德,100,7,93,富邦-宜蘭,2023-04-10,9686
2603,長榮,65,11,54,富邦-宜蘭,2023-04-10,9686
6770,力積電,47,0,47,富邦-宜蘭,2023-04-10,9686
00878,國泰永續高股息,62,18,44,富邦-宜蘭,2023-04-10,9686
2891,中信金,57,17,40,富邦-宜蘭,2023-04-10,9686
1101,台泥,36,2,34,富邦-宜蘭,2023-04-10,9686
00885,富邦越南,32,0,32,富邦-宜蘭,2023-04-10,9686
6288,聯嘉,58,26,32,富邦-宜蘭,2023-04-10,9686
00888,永豐台灣ESG,28,0,28,富邦-宜蘭,2023-04-10,9686
2547,日勝生,27,0,27,富邦-宜蘭,2023-04-10,9686
6163,華電網,31,5,26,富邦-宜蘭,2023-04-10,9686
00679B,元大美債20年,24,0,24,富邦-宜蘭,2023-04-10,9686
2324,仁寶,25,3,22,富邦-宜蘭,2023-04-10,9686
00751B,元大AAA至A公司債,20,0,20,富邦-宜蘭,2023-04-10,9686
4128,中天,20,0,20,富邦-宜蘭,2023-04-10,9686
8409,商之器,21,2,19,富邦-宜蘭,2023-04-10,9686
1519,華城,16,0,16,富邦-宜蘭,2023-04-10,9686
3447,展達,15,0,15,富邦-宜蘭,2023-04-10,9686
2867,三商壽,15,0,15,富邦-宜蘭,2023-04-10,9686
2344,華邦電,20,5,15,富邦-宜蘭,2023-04-10,9686
2890,永豐金,16,2,14,富邦-宜蘭,2023-04-10,9686
6197,佳必琪,15,1,14,富邦-宜蘭,2023-04-10,9686
00712,復華富時不動產,12,0,12,富邦-宜蘭,2023-04-10,9686
6807,峰源-KY,12,0,12,富邦-宜蘭,2023-04-10,9686
2634,漢翔,23,12,11,富邦-宜蘭,2023-04-10,9686
2637,慧洋-KY,11,0,11,富邦-宜蘭,2023-04-10,9686
1605,華新,11,0,11,富邦-宜蘭,2023-04-10,9686
3545,敦泰,15,5,10,富邦-宜蘭,2023-04-10,9686
4503,金雨,10,0,10,富邦-宜蘭,2023-04-10,9686
00664R,國泰臺灣加權反1,10,0,10,富邦-宜蘭,2023-04-10,9686
5488,松普,10,0,10,富邦-宜蘭,2023-04-10,9686
2302,麗正,11,1,10,富邦-宜蘭,2023-04-10,9686
5251,天鉞電,10,0,10,富邦-宜蘭,2023-04-10,9686
5531,鄉林,10,0,10,富邦-宜蘭,2023-04-10,9686
2489,瑞軒,10,1,9,富邦-宜蘭,2023-04-10,9686
1527,鑽全,9,0,9,富邦-宜蘭,2023-04-10,9686
4541,晟田,10,1,9,富邦-宜蘭,2023-04-10,9686
8421,旭源,9,0,9,富邦-宜蘭,2023-04-10,9686
00772B,中信高評級公司債,8,0,8,富邦-宜蘭,2023-04-10,9686
00795B,中信美國公債20年,8,0,8,富邦-宜蘭,2023-04-10,9686
2002,中鋼,8,0,8,富邦-宜蘭,2023-04-10,9686
3664,安瑞-KY,27,19,8,富邦-宜蘭,2023-04-10,9686
3715,定穎投控,10,2,8,富邦-宜蘭,2023-04-10,9686
2483,百容,8,0,8,富邦-宜蘭,2023-04-10,9686
4967,十銓,12,4,8,富邦-宜蘭,2023-04-10,9686
2484,希華,10,3,7,富邦-宜蘭,2023-04-10,9686
5315,光聯,7,0,7,富邦-宜蘭,2023-04-10,9686
3056,富華新,8,1,7,富邦-宜蘭,2023-04-10,9686
00673R,期元大S＆P原油反1,105,0,105,富邦-宜蘭,2023-04-11,9686
2204,中華,100,1,99,富邦-宜蘭,2023-04-11,9686
2867,三商壽,70,8,62,富邦-宜蘭,2023-04-11,9686
00751B,元大AAA至A公司債,60,0,60,富邦-宜蘭,2023-04-11,9686
1605,華新,61,1,60,富邦-宜蘭,2023-04-11,9686
2547,日勝生,40,1,39,富邦-宜蘭,2023-04-11,9686
00679B,元大美債20年,45,7,38,富邦-宜蘭,2023-04-11,9686
5531,鄉林,50,18,32,富邦-宜蘭,2023-04-11,9686
6245,立端,31,0,31,富邦-宜蘭,2023-04-11,9686
3432,台端,33,3,30,富邦-宜蘭,2023-04-11,9686
2457,飛宏,56,27,29,富邦-宜蘭,2023-04-11,9686
3664,安瑞-KY,27,0,27,富邦-宜蘭,2023-04-11,9686
2208,台船,26,2,24,富邦-宜蘭,2023-04-11,9686
00712,復華富時不動產,24,1,23,富邦-宜蘭,2023-04-11,9686
8110,華東,22,0,22,富邦-宜蘭,2023-04-11,9686
3430,奇鈦科,21,0,21,富邦-宜蘭,2023-04-11,9686
2303,聯電,45,25,20,富邦-宜蘭,2023-04-11,9686
5328,華容,20,1,19,富邦-宜蘭,2023-04-11,9686
2634,漢翔,47,30,17,富邦-宜蘭,2023-04-11,9686
1514,亞力,42,26,16,富邦-宜蘭,2023-04-11,9686
8234,新漢,17,1,16,富邦-宜蘭,2023-04-11,9686
2603,長榮,17,1,16,富邦-宜蘭,2023-04-11,9686
6160,欣技,19,4,15,富邦-宜蘭,2023-04-11,9686
8183,精星,13,2,11,富邦-宜蘭,2023-04-11,9686
6276,安鈦克,12,1,11,富邦-宜蘭,2023-04-11,9686
4968,立積,22,12,10,富邦-宜蘭,2023-04-11,9686
3027,盛達,10,0,10,富邦-宜蘭,2023-04-11,9686
5011,久陽,10,0,10,富邦-宜蘭,2023-04-11,9686
3287,廣寰科,10,0,10,富邦-宜蘭,2023-04-11,9686
6118,建達,10,0,10,富邦-宜蘭,2023-04-11,9686
3576,聯合再生,23,13,10,富邦-宜蘭,2023-04-11,9686
3354,律勝,10,0,10,富邦-宜蘭,2023-04-11,9686
3046,建��,13,4,9,富邦-宜蘭,2023-04-11,9686
2929,淘帝-KY,10,1,9,富邦-宜蘭,2023-04-11,9686
6733,博晟生醫,9,0,9,富邦-宜蘭,2023-04-11,9686
3706,神達,9,0,9,富邦-宜蘭,2023-04-11,9686
2031,新光鋼,8,0,8,富邦-宜蘭,2023-04-11,9686
6456,GIS-KY,8,0,8,富邦-宜蘭,2023-04-11,9686
2537,聯上發,8,0,8,富邦-宜蘭,2023-04-11,9686
2890,永豐金,8,0,8,富邦-宜蘭,2023-04-11,9686
2330,台積電,11,4,7,富邦-宜蘭,2023-04-11,9686
2450,神腦,7,0,7,富邦-宜蘭,2023-04-11,9686
3162,精確,7,0,7,富邦-宜蘭,2023-04-11,9686
4114,健喬,8,1,7,富邦-宜蘭,2023-04-11,9686
3673,TPK-KY,11,4,7,富邦-宜蘭,2023-04-11,9686
2317,鴻海,14,8,6,富邦-宜蘭,2023-04-11,9686
5225,東科-KY,6,0,6,富邦-宜蘭,2023-04-11,9686
2889,國票金,6,0,6,富邦-宜蘭,2023-04-11,9686
2548,華固,6,0,6,富邦-宜蘭,2023-04-11,9686
3037,欣興,8,2,6,富邦-宜蘭,2023-04-11,9686
4906,正文,100,0,100,富邦-宜蘭,2023-04-12,9686
00673R,期元大S＆P原油反1,101,10,91,富邦-宜蘭,2023-04-12,9686
2610,華航,125,45,80,富邦-宜蘭,2023-04-12,9686
2614,東森,55,1,54,富邦-宜蘭,2023-04-12,9686
2867,三商壽,50,0,50,富邦-宜蘭,2023-04-12,9686
3209,全科,30,0,30,富邦-宜蘭,2023-04-12,9686
1605,華新,80,51,29,富邦-宜蘭,2023-04-12,9686
00679B,元大美債20年,28,0,28,富邦-宜蘭,2023-04-12,9686
6116,彩晶,30,4,26,富邦-宜蘭,2023-04-12,9686
2328,廣宇,26,1,25,富邦-宜蘭,2023-04-12,9686
2317,鴻海,27,4,23,富邦-宜蘭,2023-04-12,9686
00751B,元大AAA至A公司債,22,0,22,富邦-宜蘭,2023-04-12,9686
4129,聯合,21,0,21,富邦-宜蘭,2023-04-12,9686
00878,國泰永續高股息,40,20,20,富邦-宜蘭,2023-04-12,9686
2465,麗臺,15,1,14,富邦-宜蘭,2023-04-12,9686
2206,三陽工業,73,60,13,富邦-宜蘭,2023-04-12,9686
2330,台積電,14,1,13,富邦-宜蘭,2023-04-12,9686
00795B,中信美國公債20年,12,0,12,富邦-宜蘭,2023-04-12,9686
6666,羅麗芬-KY,13,1,12,富邦-宜蘭,2023-04-12,9686
6234,高僑,12,0,12,富邦-宜蘭,2023-04-12,9686
2880,華南金,12,0,12,富邦-宜蘭,2023-04-12,9686
5011,久陽,11,0,11,富邦-宜蘭,2023-04-12,9686
3664,安瑞-KY,11,0,11,富邦-宜蘭,2023-04-12,9686
2324,仁寶,13,2,11,富邦-宜蘭,2023-04-12,9686
6217,中探針,11,0,11,富邦-宜蘭,2023-04-12,9686
1444,力麗,10,0,10,富邦-宜蘭,2023-04-12,9686
3030,德律,10,0,10,富邦-宜蘭,2023-04-12,9686
5533,皇鼎,10,0,10,富邦-宜蘭,2023-04-12,9686
3432,台端,11,1,10,富邦-宜蘭,2023-04-12,9686
6118,建達,10,0,10,富邦-宜蘭,2023-04-12,9686
3710,連展投控,10,0,10,富邦-宜蘭,2023-04-12,9686
00903,富邦元宇宙,10,0,10,富邦-宜蘭,2023-04-12,9686
4979,華星光,23,13,10,富邦-宜蘭,2023-04-12,9686
6609,瀧澤科,10,0,10,富邦-宜蘭,2023-04-12,9686
1201,味全,10,0,10,富邦-宜蘭,2023-04-12,9686
2929,淘帝-KY,10,0,10,富邦-宜蘭,2023-04-12,9686
3043,科風,10,0,10,富邦-宜蘭,2023-04-12,9686
8069,元太,9,0,9,富邦-宜蘭,2023-04-12,9686
4157,太景*-KY,9,0,9,富邦-宜蘭,2023-04-12,9686
2497,怡利電,10,1,9,富邦-宜蘭,2023-04-12,9686
4927,泰鼎-KY,9,0,9,富邦-宜蘭,2023-04-12,9686
2393,億光,8,0,8,富邦-宜蘭,2023-04-12,9686
3624,光頡,30,22,8,富邦-宜蘭,2023-04-12,9686
8028,昇陽半導體,8,0,8,富邦-宜蘭,2023-04-12,9686
2476,鉅祥,8,0,8,富邦-宜蘭,2023-04-12,9686
3715,定穎投控,7,0,7,富邦-宜蘭,2023-04-12,9686
4123,晟德,7,0,7,富邦-宜蘭,2023-04-12,9686
2484,希華,8,1,7,富邦-宜蘭,2023-04-12,9686
5328,華容,10,3,7,富邦-宜蘭,2023-04-12,9686
6477,安集,14,7,7,富邦-宜蘭,2023-04-12,9686
2515,中工,248,46,202,富邦-宜蘭,2023-04-13,9686
5475,德宏,63,1,62,富邦-宜蘭,2023-04-13,9686
00673R,期元大S＆P原油反1,59,0,59,富邦-宜蘭,2023-04-13,9686
6142,友勁,47,0,47,富邦-宜蘭,2023-04-13,9686
00878,國泰永續高股息,42,4,38,富邦-宜蘭,2023-04-13,9686
00888,永豐台灣ESG,31,0,31,富邦-宜蘭,2023-04-13,9686
00712,復華富時不動產,31,0,31,富邦-宜蘭,2023-04-13,9686
1504,東元,51,21,30,富邦-宜蘭,2023-04-13,9686
2883,凱基金,30,0,30,富邦-宜蘭,2023-04-13,9686
4541,晟田,52,23,29,富邦-宜蘭,2023-04-13,9686
00772B,中信高評級公司債,29,0,29,富邦-宜蘭,2023-04-13,9686
00679B,元大美債20年,27,0,27,富邦-宜蘭,2023-04-13,9686
6770,力積電,35,9,26,富邦-宜蘭,2023-04-13,9686
3380,明泰,25,1,24,富邦-宜蘭,2023-04-13,9686
3711,日月光投控,22,0,22,富邦-宜蘭,2023-04-13,9686
1609,大亞,51,29,22,富邦-宜蘭,2023-04-13,9686
8110,華東,21,2,19,富邦-宜蘭,2023-04-13,9686
00708L,期元大S＆P黃金正2,18,0,18,富邦-宜蘭,2023-04-13,9686
00893,國泰智能電動車,18,0,18,富邦-宜蘭,2023-04-13,9686
1314,中石化,22,5,17,富邦-宜蘭,2023-04-13,9686
1539,巨庭,17,0,17,富邦-宜蘭,2023-04-13,9686
2408,南亞科,17,0,17,富邦-宜蘭,2023-04-13,9686
3356,奇偶,17,0,17,富邦-宜蘭,2023-04-13,9686
2330,台積電,18,1,17,富邦-宜蘭,2023-04-13,9686
6244,茂迪,17,1,16,富邦-宜蘭,2023-04-13,9686
4960,誠美材,15,0,15,富邦-宜蘭,2023-04-13,9686
3481,群創,79,65,14,富邦-宜蘭,2023-04-13,9686
5009,榮剛,29,15,14,富邦-宜蘭,2023-04-13,9686
0056,元大高股息,17,4,13,富邦-宜蘭,2023-04-13,9686
00891,中信關鍵半導體,13,0,13,富邦-宜蘭,2023-04-13,9686
1529,樂事綠能,17,4,13,富邦-宜蘭,2023-04-13,9686
2867,三商壽,33,20,13,富邦-宜蘭,2023-04-13,9686
5351,鈺創,16,4,12,富邦-宜蘭,2023-04-13,9686
00795B,中信美國公債20年,12,0,12,富邦-宜蘭,2023-04-13,9686
2329,華泰,20,8,12,富邦-宜蘭,2023-04-13,9686
00892,富邦台灣半導體,12,0,12,富邦-宜蘭,2023-04-13,9686
6443,元晶,20,8,12,富邦-宜蘭,2023-04-13,9686
3162,精確,13,2,11,富邦-宜蘭,2023-04-13,9686
1102,亞泥,11,0,11,富邦-宜蘭,2023-04-13,9686
5309,系統電,14,3,11,富邦-宜蘭,2023-04-13,9686
3027,盛達,12,2,10,富邦-宜蘭,2023-04-13,9686
00751B,元大AAA至A公司債,10,0,10,富邦-宜蘭,2023-04-13,9686
5302,太欣,10,0,10,富邦-宜蘭,2023-04-13,9686
00680L,元大美債20正2,10,0,10,富邦-宜蘭,2023-04-13,9686
2313,華通,11,1,10,富邦-宜蘭,2023-04-13,9686
2457,飛宏,20,11,9,富邦-宜蘭,2023-04-13,9686
00725B,國泰投資級公司債,10,1,9,富邦-宜蘭,2023-04-13,9686
00922,國泰台灣領袖50,8,0,8,富邦-宜蘭,2023-04-13,9686
4164,承業醫,10,2,8,富邦-宜蘭,2023-04-13,9686
3041,揚智,8,0,8,富邦-宜蘭,2023-04-13,9686
00751B,元大AAA至A公司債,172,0,172,富邦-宜蘭,2023-04-14,9686
3049,精金,102,0,102,富邦-宜蘭,2023-04-14,9686
00632R,元大台灣50反1,85,0,85,富邦-宜蘭,2023-04-14,9686
3010,華立,70,0,70,富邦-宜蘭,2023-04-14,9686
2634,漢翔,127,61,66,富邦-宜蘭,2023-04-14,9686
00679B,元大美債20年,60,0,60,富邦-宜蘭,2023-04-14,9686
2208,台船,77,19,58,富邦-宜蘭,2023-04-14,9686
2630,亞航,53,3,50,富邦-宜蘭,2023-04-14,9686
2349,錸德,50,0,50,富邦-宜蘭,2023-04-14,9686
1529,樂事綠能,57,15,42,富邦-宜蘭,2023-04-14,9686
00673R,期元大S＆P原油反1,46,5,41,富邦-宜蘭,2023-04-14,9686
00878,國泰永續高股息,50,12,38,富邦-宜蘭,2023-04-14,9686
00772B,中信高評級公司債,36,0,36,富邦-宜蘭,2023-04-14,9686
00712,復華富時不動產,46,10,36,富邦-宜蘭,2023-04-14,9686
2444,兆勁,35,0,35,富邦-宜蘭,2023-04-14,9686
1584,精剛,81,48,33,富邦-宜蘭,2023-04-14,9686
6509,聚和,38,13,25,富邦-宜蘭,2023-04-14,9686
0056,元大高股息,26,1,25,富邦-宜蘭,2023-04-14,9686
4162,智擎,23,0,23,富邦-宜蘭,2023-04-14,9686
4541,晟田,30,9,21,富邦-宜蘭,2023-04-14,9686
5701,劍湖山,20,0,20,富邦-宜蘭,2023-04-14,9686
6770,力積電,23,3,20,富邦-宜蘭,2023-04-14,9686
6244,茂迪,21,1,20,富邦-宜蘭,2023-04-14,9686
8936,國統,22,3,19,富邦-宜蘭,2023-04-14,9686
1701,中化,18,0,18,富邦-宜蘭,2023-04-14,9686
2867,三商壽,22,5,17,富邦-宜蘭,2023-04-14,9686
2402,毅嘉,28,13,15,富邦-宜蘭,2023-04-14,9686
3576,聯合再生,26,11,15,富邦-宜蘭,2023-04-14,9686
5302,太欣,15,0,15,富邦-宜蘭,2023-04-14,9686
1504,東元,31,17,14,富邦-宜蘭,2023-04-14,9686
1712,興農,13,0,13,富邦-宜蘭,2023-04-14,9686
4916,事欣科,24,12,12,富邦-宜蘭,2023-04-14,9686
2323,中環,12,0,12,富邦-宜蘭,2023-04-14,9686
2023,燁輝,11,0,11,富邦-宜蘭,2023-04-14,9686
6266,泰詠,12,1,11,富邦-宜蘭,2023-04-14,9686
1608,華榮,11,0,11,富邦-宜蘭,2023-04-14,9686
6235,華孚,20,9,11,富邦-宜蘭,2023-04-14,9686
2331,精英,11,0,11,富邦-宜蘭,2023-04-14,9686
1513,中興電,16,5,11,富邦-宜蘭,2023-04-14,9686
2002,中鋼,10,0,10,富邦-宜蘭,2023-04-14,9686
6026,福邦證,11,1,10,富邦-宜蘭,2023-04-14,9686
6153,嘉聯益,10,0,10,富邦-宜蘭,2023-04-14,9686
1452,宏益,10,0,10,富邦-宜蘭,2023-04-14,9686
5225,東科-KY,10,0,10,富邦-宜蘭,2023-04-14,9686
5515,建國,10,0,10,富邦-宜蘭,2023-04-14,9686
2890,永豐金,10,0,10,富邦-宜蘭,2023-04-14,9686
1416,廣豐,10,0,10,富邦-宜蘭,2023-04-14,9686
8383,千附,11,1,10,富邦-宜蘭,2023-04-14,9686
00773B,中信優先金融債,10,0,10,富邦-宜蘭,2023-04-14,9686
4402,郡都開發,10,0,10,富邦-宜蘭,2023-04-14,9686
1609,大亞,119,7,112,富邦-宜蘭,2023-04-17,9686
00751B,元大AAA至A公司債,110,0,110,富邦-宜蘭,2023-04-17,9686
2601,益航,106,3,103,富邦-宜蘭,2023-04-17,9686
8121,越峰,60,7,53,富邦-宜蘭,2023-04-17,9686
00712,復華富時不動產,63,11,52,富邦-宜蘭,2023-04-17,9686
1312,國喬,50,0,50,富邦-宜蘭,2023-04-17,9686
2547,日勝生,50,0,50,富邦-宜蘭,2023-04-17,9686
00679B,元大美債20年,43,0,43,富邦-宜蘭,2023-04-17,9686
2329,華泰,64,31,33,富邦-宜蘭,2023-04-17,9686
2610,華航,44,13,31,富邦-宜蘭,2023-04-17,9686
00641R,富邦日本反1,30,0,30,富邦-宜蘭,2023-04-17,9686
2618,長榮航,30,1,29,富邦-宜蘭,2023-04-17,9686
2495,普安,30,1,29,富邦-宜蘭,2023-04-17,9686
2312,金寶,33,4,29,富邦-宜蘭,2023-04-17,9686
2014,中鴻,31,3,28,富邦-宜蘭,2023-04-17,9686
2883,凱基金,72,44,28,富邦-宜蘭,2023-04-17,9686
00680L,元大美債20正2,27,0,27,富邦-宜蘭,2023-04-17,9686
1444,力麗,32,5,27,富邦-宜蘭,2023-04-17,9686
2712,遠雄來,25,1,24,富邦-宜蘭,2023-04-17,9686
2206,三陽工業,31,8,23,富邦-宜蘭,2023-04-17,9686
8403,盛弘,23,0,23,富邦-宜蘭,2023-04-17,9686
4541,晟田,41,18,23,富邦-宜蘭,2023-04-17,9686
5344,立衛,20,0,20,富邦-宜蘭,2023-04-17,9686
6116,彩晶,20,0,20,富邦-宜蘭,2023-04-17,9686
1611,中電,19,0,19,富邦-宜蘭,2023-04-17,9686
3224,三顧,20,1,19,富邦-宜蘭,2023-04-17,9686
4909,新復興,18,0,18,富邦-宜蘭,2023-04-17,9686
3207,耀勝,21,3,18,富邦-宜蘭,2023-04-17,9686
2884,玉山金,31,13,18,富邦-宜蘭,2023-04-17,9686
00772B,中信高評級公司債,16,0,16,富邦-宜蘭,2023-04-17,9686
2002,中鋼,15,0,15,富邦-宜蘭,2023-04-17,9686
5907,大洋-KY,15,0,15,富邦-宜蘭,2023-04-17,9686
4934,太極,17,2,15,富邦-宜蘭,2023-04-17,9686
2615,萬海,17,2,15,富邦-宜蘭,2023-04-17,9686
3013,晟銘電,17,3,14,富邦-宜蘭,2023-04-17,9686
2324,仁寶,15,1,14,富邦-宜蘭,2023-04-17,9686
1905,華紙,15,1,14,富邦-宜蘭,2023-04-17,9686
6234,高僑,15,2,13,富邦-宜蘭,2023-04-17,9686
6235,華孚,27,15,12,富邦-宜蘭,2023-04-17,9686
2515,中工,13,1,12,富邦-宜蘭,2023-04-17,9686
3441,聯一光,12,0,12,富邦-宜蘭,2023-04-17,9686
1605,華新,39,28,11,富邦-宜蘭,2023-04-17,9686
00773B,中信優先金融債,11,0,11,富邦-宜蘭,2023-04-17,9686
2887,台新金,12,1,11,富邦-宜蘭,2023-04-17,9686
2371,大同,11,0,11,富邦-宜蘭,2023-04-17,9686
1718,中纖,11,0,11,富邦-宜蘭,2023-04-17,9686
2359,所羅門,20,10,10,富邦-宜蘭,2023-04-17,9686
8277,商丞,10,0,10,富邦-宜蘭,2023-04-17,9686
2478,大毅,10,0,10,富邦-宜蘭,2023-04-17,9686
3163,波若威,11,1,10,富邦-宜蘭,2023-04-17,9686
1444,力麗,187,36,151,富邦-宜蘭,2023-04-18,9686
00751B,元大AAA至A公司債,101,0,101,富邦-宜蘭,2023-04-18,9686
2603,長榮,75,18,57,富邦-宜蘭,2023-04-18,9686
8033,雷虎,85,32,53,富邦-宜蘭,2023-04-18,9686
3481,群創,56,13,43,富邦-宜蘭,2023-04-18,9686
2610,華航,36,0,36,富邦-宜蘭,2023-04-18,9686
00877,復華中國5G,50,15,35,富邦-宜蘭,2023-04-18,9686
2313,華通,36,2,34,富邦-宜蘭,2023-04-18,9686
00772B,中信高評級公司債,34,0,34,富邦-宜蘭,2023-04-18,9686
4541,晟田,48,15,33,富邦-宜蘭,2023-04-18,9686
3591,艾笛森,33,0,33,富邦-宜蘭,2023-04-18,9686
00712,復華富時不動產,32,0,32,富邦-宜蘭,2023-04-18,9686
2504,國產,33,1,32,富邦-宜蘭,2023-04-18,9686
1471,首利,31,0,31,富邦-宜蘭,2023-04-18,9686
6234,高僑,40,9,31,富邦-宜蘭,2023-04-18,9686
00679B,元大美債20年,27,0,27,富邦-宜蘭,2023-04-18,9686
2515,中工,33,7,26,富邦-宜蘭,2023-04-18,9686
3293,鈊象,24,0,24,富邦-宜蘭,2023-04-18,9686
2412,中華電,25,1,24,富邦-宜蘭,2023-04-18,9686
2537,聯上發,23,0,23,富邦-宜蘭,2023-04-18,9686
4961,天鈺,25,3,22,富邦-宜蘭,2023-04-18,9686
2618,長榮航,22,1,21,富邦-宜蘭,2023-04-18,9686
1609,大亞,35,14,21,富邦-宜蘭,2023-04-18,9686
8105,凌巨,26,5,21,富邦-宜蘭,2023-04-18,9686
00878,國泰永續高股息,39,19,20,富邦-宜蘭,2023-04-18,9686
1584,精剛,41,22,19,富邦-宜蘭,2023-04-18,9686
1605,華新,53,35,18,富邦-宜蘭,2023-04-18,9686
8038,長園科,19,1,18,富邦-宜蘭,2023-04-18,9686
1810,和成,24,6,18,富邦-宜蘭,2023-04-18,9686
3624,光頡,30,12,18,富邦-宜蘭,2023-04-18,9686
2338,光罩,18,0,18,富邦-宜蘭,2023-04-18,9686
2344,華邦電,21,4,17,富邦-宜蘭,2023-04-18,9686
3025,星通,18,1,17,富邦-宜蘭,2023-04-18,9686
6770,力積電,28,11,17,富邦-宜蘭,2023-04-18,9686
1809,中釉,18,2,16,富邦-宜蘭,2023-04-18,9686
5225,東科-KY,18,3,15,富邦-宜蘭,2023-04-18,9686
6126,信音,15,0,15,富邦-宜蘭,2023-04-18,9686
4934,太極,15,0,15,富邦-宜蘭,2023-04-18,9686
3037,欣興,15,0,15,富邦-宜蘭,2023-04-18,9686
2867,三商壽,16,2,14,富邦-宜蘭,2023-04-18,9686
3022,威強電,12,0,12,富邦-宜蘭,2023-04-18,9686
2457,飛宏,49,37,12,富邦-宜蘭,2023-04-18,9686
00795B,中信美國公債20年,12,0,12,富邦-宜蘭,2023-04-18,9686
8277,商丞,11,0,11,富邦-宜蘭,2023-04-18,9686
00720B,元大投資級公司債,11,0,11,富邦-宜蘭,2023-04-18,9686
6218,豪勉,21,10,11,富邦-宜蘭,2023-04-18,9686
2897,王道銀行,11,0,11,富邦-宜蘭,2023-04-18,9686
2208,台船,34,23,11,富邦-宜蘭,2023-04-18,9686
6477,安集,13,2,11,富邦-宜蘭,2023-04-18,9686
2363,矽統,11,0,11,富邦-宜蘭,2023-04-18,9686
6167,久正,48,0,48,富邦-宜蘭,2023-04-19,9686
2618,長榮航,47,2,45,富邦-宜蘭,2023-04-19,9686
2884,玉山金,33,2,31,富邦-宜蘭,2023-04-19,9686
1802,台玻,32,1,31,富邦-宜蘭,2023-04-19,9686
4510,高鋒,31,0,31,富邦-宜蘭,2023-04-19,9686
6770,力積電,38,8,30,富邦-宜蘭,2023-04-19,9686
1312,國喬,30,0,30,富邦-宜蘭,2023-04-19,9686
2363,矽統,30,0,30,富邦-宜蘭,2023-04-19,9686
3704,合勤控,39,10,29,富邦-宜蘭,2023-04-19,9686
3481,群創,112,83,29,富邦-宜蘭,2023-04-19,9686
2208,台船,36,10,26,富邦-宜蘭,2023-04-19,9686
3058,立德,29,4,25,富邦-宜蘭,2023-04-19,9686
6163,華電網,32,7,25,富邦-宜蘭,2023-04-19,9686
2206,三陽工業,31,7,24,富邦-宜蘭,2023-04-19,9686
6223,旺矽,22,0,22,富邦-宜蘭,2023-04-19,9686
5469,瀚宇博,22,0,22,富邦-宜蘭,2023-04-19,9686
00712,復華富時不動產,21,0,21,富邦-宜蘭,2023-04-19,9686
1725,元禎,20,0,20,富邦-宜蘭,2023-04-19,9686
2756,聯發國際,20,0,20,富邦-宜蘭,2023-04-19,9686
2356,英業達,36,16,20,富邦-宜蘭,2023-04-19,9686
2303,聯電,16,0,16,富邦-宜蘭,2023-04-19,9686
2457,飛宏,33,18,15,富邦-宜蘭,2023-04-19,9686
00888,永豐台灣ESG,16,1,15,富邦-宜蘭,2023-04-19,9686
2889,國票金,17,2,15,富邦-宜蘭,2023-04-19,9686
2329,華泰,15,0,15,富邦-宜蘭,2023-04-19,9686
00720B,元大投資級公司債,14,0,14,富邦-宜蘭,2023-04-19,9686
3037,欣興,16,3,13,富邦-宜蘭,2023-04-19,9686
00679B,元大美債20年,13,0,13,富邦-宜蘭,2023-04-19,9686
6168,宏齊,15,2,13,富邦-宜蘭,2023-04-19,9686
2027,大成鋼,13,0,13,富邦-宜蘭,2023-04-19,9686
6470,宇智,22,9,13,富邦-宜蘭,2023-04-19,9686
3673,TPK-KY,23,11,12,富邦-宜蘭,2023-04-19,9686
2409,友達,22,10,12,富邦-宜蘭,2023-04-19,9686
1721,三晃,12,0,12,富邦-宜蘭,2023-04-19,9686
0056,元大高股息,13,2,11,富邦-宜蘭,2023-04-19,9686
00687B,國泰20年美債,11,0,11,富邦-宜蘭,2023-04-19,9686
00772B,中信高評級公司債,11,0,11,富邦-宜蘭,2023-04-19,9686
2498,宏達電,13,2,11,富邦-宜蘭,2023-04-19,9686
8277,商丞,11,0,11,富邦-宜蘭,2023-04-19,9686
006208,富邦台50,11,0,11,富邦-宜蘭,2023-04-19,9686
2330,台積電,10,0,10,富邦-宜蘭,2023-04-19,9686
2358,廷鑫,10,0,10,富邦-宜蘭,2023-04-19,9686
3260,威剛,11,1,10,富邦-宜蘭,2023-04-19,9686
1416,廣豐,10,0,10,富邦-宜蘭,2023-04-19,9686
00680L,元大美債20正2,12,2,10,富邦-宜蘭,2023-04-19,9686
00895,富邦未來車,10,0,10,富邦-宜蘭,2023-04-19,9686
8086,宏捷科,10,0,10,富邦-宜蘭,2023-04-19,9686
00898,國泰基因免疫革命,10,0,10,富邦-宜蘭,2023-04-19,9686
2331,精英,10,0,10,富邦-宜蘭,2023-04-19,9686
5880,合庫金,10,0,10,富邦-宜蘭,2023-04-19,9686
1451,年興,100,0,100,富邦-宜蘭,2023-04-20,9686
00878,國泰永續高股息,96,0,96,富邦-宜蘭,2023-04-20,9686
00912,中信臺灣智慧50,66,0,66,富邦-宜蘭,2023-04-20,9686
2406,國碩,50,0,50,富邦-宜蘭,2023-04-20,9686
9907,統一實,50,0,50,富邦-宜蘭,2023-04-20,9686
3686,達能,37,0,37,富邦-宜蘭,2023-04-20,9686
2634,漢翔,67,34,33,富邦-宜蘭,2023-04-20,9686
2630,亞航,32,0,32,富邦-宜蘭,2023-04-20,9686
6477,安集,33,2,31,富邦-宜蘭,2023-04-20,9686
4934,太極,31,2,29,富邦-宜蘭,2023-04-20,9686
2476,鉅祥,27,1,26,富邦-宜蘭,2023-04-20,9686
1471,首利,26,1,25,富邦-宜蘭,2023-04-20,9686
6134,萬旭,27,3,24,富邦-宜蘭,2023-04-20,9686
6443,元晶,23,1,22,富邦-宜蘭,2023-04-20,9686
6244,茂迪,45,23,22,富邦-宜蘭,2023-04-20,9686
00687B,國泰20年美債,21,0,21,富邦-宜蘭,2023-04-20,9686
2324,仁寶,20,0,20,富邦-宜蘭,2023-04-20,9686
2392,正崴,20,0,20,富邦-宜蘭,2023-04-20,9686
1524,耿鼎,22,2,20,富邦-宜蘭,2023-04-20,9686
2344,華邦電,23,3,20,富邦-宜蘭,2023-04-20,9686
8033,雷虎,21,2,19,富邦-宜蘭,2023-04-20,9686
1815,富喬,20,1,19,富邦-宜蘭,2023-04-20,9686
00715L,期街口布蘭特正2,18,0,18,富邦-宜蘭,2023-04-20,9686
00713,元大台灣高息低波,17,0,17,富邦-宜蘭,2023-04-20,9686
00772B,中信高評級公司債,17,0,17,富邦-宜蘭,2023-04-20,9686
2495,普安,17,0,17,富邦-宜蘭,2023-04-20,9686
00888,永豐台灣ESG,15,0,15,富邦-宜蘭,2023-04-20,9686
2409,友達,14,0,14,富邦-宜蘭,2023-04-20,9686
1909,榮成,46,32,14,富邦-宜蘭,2023-04-20,9686
6284,佳邦,13,0,13,富邦-宜蘭,2023-04-20,9686
2884,玉山金,28,15,13,富邦-宜蘭,2023-04-20,9686
3580,友威科,12,0,12,富邦-宜蘭,2023-04-20,9686
3673,TPK-KY,13,1,12,富邦-宜蘭,2023-04-20,9686
6122,擎邦,14,2,12,富邦-宜蘭,2023-04-20,9686
1904,正隆,11,0,11,富邦-宜蘭,2023-04-20,9686
3041,揚智,10,0,10,富邦-宜蘭,2023-04-20,9686
2363,矽統,10,0,10,富邦-宜蘭,2023-04-20,9686
1802,台玻,10,0,10,富邦-宜蘭,2023-04-20,9686
2515,中工,10,0,10,富邦-宜蘭,2023-04-20,9686
3430,奇鈦科,10,0,10,富邦-宜蘭,2023-04-20,9686
6288,聯嘉,13,3,10,富邦-宜蘭,2023-04-20,9686
00720B,元大投資級公司債,10,0,10,富邦-宜蘭,2023-04-20,9686
6216,居易,10,0,10,富邦-宜蘭,2023-04-20,9686
3011,今皓,10,0,10,富邦-宜蘭,2023-04-20,9686
2066,世德,11,1,10,富邦-宜蘭,2023-04-20,9686
1907,永豐餘,11,2,9,富邦-宜蘭,2023-04-20,9686
3078,僑威,11,2,9,富邦-宜蘭,2023-04-20,9686
4977,眾達-KY,19,10,9,富邦-宜蘭,2023-04-20,9686
2356,英業達,13,4,9,富邦-宜蘭,2023-04-20,9686
2889,國票金,10,1,9,富邦-宜蘭,2023-04-20,9686
2610,華航,117,10,107,富邦-宜蘭,2023-04-21,9686
3047,訊舟,50,0,50,富邦-宜蘭,2023-04-21,9686
00877,復華中國5G,50,0,50,富邦-宜蘭,2023-04-21,9686
1611,中電,99,51,48,富邦-宜蘭,2023-04-21,9686
2913,農林,58,10,48,富邦-宜蘭,2023-04-21,9686
3481,群創,56,11,45,富邦-宜蘭,2023-04-21,9686
1815,富喬,50,10,40,富邦-宜蘭,2023-04-21,9686
1907,永豐餘,77,39,38,富邦-宜蘭,2023-04-21,9686
00772B,中信高評級公司債,32,0,32,富邦-宜蘭,2023-04-21,9686
00878,國泰永續高股息,32,1,31,富邦-宜蘭,2023-04-21,9686
1434,福懋,30,0,30,富邦-宜蘭,2023-04-21,9686
2609,陽明,32,4,28,富邦-宜蘭,2023-04-21,9686
2482,連宇,29,1,28,富邦-宜蘭,2023-04-21,9686
6163,華電網,35,7,28,富邦-宜蘭,2023-04-21,9686
6770,力積電,42,17,25,富邦-宜蘭,2023-04-21,9686
00715L,期街口布蘭特正2,22,0,22,富邦-宜蘭,2023-04-21,9686
00720B,元大投資級公司債,21,0,21,富邦-宜蘭,2023-04-21,9686
3490,單井,21,0,21,富邦-宜蘭,2023-04-21,9686
5302,太欣,20,0,20,富邦-宜蘭,2023-04-21,9686
4931,新盛力,23,4,19,富邦-宜蘭,2023-04-21,9686
2547,日勝生,19,0,19,富邦-宜蘭,2023-04-21,9686
6134,萬旭,18,0,18,富邦-宜蘭,2023-04-21,9686
1904,正隆,31,14,17,富邦-宜蘭,2023-04-21,9686
4168,醣聯,17,0,17,富邦-宜蘭,2023-04-21,9686
00893,國泰智能電動車,17,0,17,富邦-宜蘭,2023-04-21,9686
5880,合庫金,16,0,16,富邦-宜蘭,2023-04-21,9686
8210,勤誠,16,0,16,富邦-宜蘭,2023-04-21,9686
1909,榮成,19,3,16,富邦-宜蘭,2023-04-21,9686
3363,上詮,15,0,15,富邦-宜蘭,2023-04-21,9686
8404,百和興業-KY,15,0,15,富邦-宜蘭,2023-04-21,9686
4541,晟田,14,0,14,富邦-宜蘭,2023-04-21,9686
1409,新纖,14,0,14,富邦-宜蘭,2023-04-21,9686
5225,東科-KY,14,0,14,富邦-宜蘭,2023-04-21,9686
6753,龍德造船,16,3,13,富邦-宜蘭,2023-04-21,9686
4909,新復興,13,0,13,富邦-宜蘭,2023-04-21,9686
2317,鴻海,24,11,13,富邦-宜蘭,2023-04-21,9686
0056,元大高股息,14,2,12,富邦-宜蘭,2023-04-21,9686
00891,中信關鍵半導體,12,0,12,富邦-宜蘭,2023-04-21,9686
2399,映泰,12,0,12,富邦-宜蘭,2023-04-21,9686
2208,台船,19,7,12,富邦-宜蘭,2023-04-21,9686
5475,德宏,12,0,12,富邦-宜蘭,2023-04-21,9686
2495,普安,13,2,11,富邦-宜蘭,2023-04-21,9686
6182,合晶,13,2,11,富邦-宜蘭,2023-04-21,9686
3356,奇偶,11,0,11,富邦-宜蘭,2023-04-21,9686
6547,高端疫苗,12,1,11,富邦-宜蘭,2023-04-21,9686
2492,華新科,11,1,10,富邦-宜蘭,2023-04-21,9686
3430,奇鈦科,10,0,10,富邦-宜蘭,2023-04-21,9686
6216,居易,10,0,10,富邦-宜蘭,2023-04-21,9686
2356,英業達,11,1,10,富邦-宜蘭,2023-04-21,9686
4147,中裕,11,1,10,富邦-宜蘭,2023-04-21,9686
1101,台泥,544,33,511,富邦-宜蘭,2023-04-24,9686
0056,元大高股息,36,1,35,富邦-宜蘭,2023-04-24,9686
00720B,元大投資級公司債,34,0,34,富邦-宜蘭,2023-04-24,9686
5302,太欣,31,0,31,富邦-宜蘭,2023-04-24,9686
2515,中工,30,1,29,富邦-宜蘭,2023-04-24,9686
5475,德宏,30,2,28,富邦-宜蘭,2023-04-24,9686
8421,旭源,25,0,25,富邦-宜蘭,2023-04-24,9686
3005,神基,27,3,24,富邦-宜蘭,2023-04-24,9686
2027,大成鋼,23,0,23,富邦-宜蘭,2023-04-24,9686
8404,百和興業-KY,20,0,20,富邦-宜蘭,2023-04-24,9686
3189,景碩,21,1,20,富邦-宜蘭,2023-04-24,9686
00637L,元大滬深300正2,21,2,19,富邦-宜蘭,2023-04-24,9686
2913,農林,35,16,19,富邦-宜蘭,2023-04-24,9686
1905,華紙,33,15,18,富邦-宜蘭,2023-04-24,9686
4916,事欣科,18,0,18,富邦-宜蘭,2023-04-24,9686
00878,國泰永續高股息,26,9,17,富邦-宜蘭,2023-04-24,9686
8215,明基材,17,0,17,富邦-宜蘭,2023-04-24,9686
8403,盛弘,16,0,16,富邦-宜蘭,2023-04-24,9686
3058,立德,15,1,14,富邦-宜蘭,2023-04-24,9686
00753L,中信中國50正2,13,0,13,富邦-宜蘭,2023-04-24,9686
00712,復華富時不動產,13,0,13,富邦-宜蘭,2023-04-24,9686
2031,新光鋼,15,2,13,富邦-宜蘭,2023-04-24,9686
6770,力積電,16,3,13,富邦-宜蘭,2023-04-24,9686
1310,台苯,18,5,13,富邦-宜蘭,2023-04-24,9686
2603,長榮,12,0,12,富邦-宜蘭,2023-04-24,9686
6456,GIS-KY,12,0,12,富邦-宜蘭,2023-04-24,9686
00772B,中信高評級公司債,12,0,12,富邦-宜蘭,2023-04-24,9686
2344,華邦電,13,2,11,富邦-宜蘭,2023-04-24,9686
00679B,元大美債20年,11,1,10,富邦-宜蘭,2023-04-24,9686
2313,華通,12,2,10,富邦-宜蘭,2023-04-24,9686
6168,宏齊,10,0,10,富邦-宜蘭,2023-04-24,9686
6116,彩晶,10,0,10,富邦-宜蘭,2023-04-24,9686
00673R,期元大S＆P原油反1,10,0,10,富邦-宜蘭,2023-04-24,9686
1612,宏泰,10,0,10,富邦-宜蘭,2023-04-24,9686
2312,金寶,10,0,10,富邦-宜蘭,2023-04-24,9686
4960,誠美材,13,4,9,富邦-宜蘭,2023-04-24,9686
1907,永豐餘,47,38,9,富邦-宜蘭,2023-04-24,9686
4164,承業醫,10,1,9,富邦-宜蘭,2023-04-24,9686
00665L,富邦�琤肭磪囓�2,9,0,9,富邦-宜蘭,2023-04-24,9686
2634,漢翔,30,22,8,富邦-宜蘭,2023-04-24,9686
2371,大同,8,0,8,富邦-宜蘭,2023-04-24,9686
6182,合晶,8,0,8,富邦-宜蘭,2023-04-24,9686
1605,華新,10,3,7,富邦-宜蘭,2023-04-24,9686
3711,日月光投控,7,0,7,富邦-宜蘭,2023-04-24,9686
2317,鴻海,7,0,7,富邦-宜蘭,2023-04-24,9686
5258,虹堡,9,2,7,富邦-宜蘭,2023-04-24,9686
910861,神州-DR,7,0,7,富邦-宜蘭,2023-04-24,9686
00888,永豐台灣ESG,7,0,7,富邦-宜蘭,2023-04-24,9686
2002,中鋼,6,0,6,富邦-宜蘭,2023-04-24,9686
1471,首利,6,0,6,富邦-宜蘭,2023-04-24,9686
00878,國泰永續高股息,73,0,73,富邦-宜蘭,2023-04-25,9686
1310,台苯,75,10,65,富邦-宜蘭,2023-04-25,9686
3704,合勤控,78,19,59,富邦-宜蘭,2023-04-25,9686
00877,復華中國5G,50,0,50,富邦-宜蘭,2023-04-25,9686
00753L,中信中國50正2,37,0,37,富邦-宜蘭,2023-04-25,9686
00772B,中信高評級公司債,45,10,35,富邦-宜蘭,2023-04-25,9686
2913,農林,32,1,31,富邦-宜蘭,2023-04-25,9686
00671R,富邦NASDAQ反1,30,0,30,富邦-宜蘭,2023-04-25,9686
1444,力麗,40,10,30,富邦-宜蘭,2023-04-25,9686
00713,元大台灣高息低波,29,0,29,富邦-宜蘭,2023-04-25,9686
2614,東森,29,1,28,富邦-宜蘭,2023-04-25,9686
2337,旺宏,33,5,28,富邦-宜蘭,2023-04-25,9686
6118,建達,27,1,26,富邦-宜蘭,2023-04-25,9686
2423,固緯,26,0,26,富邦-宜蘭,2023-04-25,9686
2891,中信金,25,1,24,富邦-宜蘭,2023-04-25,9686
0056,元大高股息,30,7,23,富邦-宜蘭,2023-04-25,9686
00902,中信電池及儲能,23,0,23,富邦-宜蘭,2023-04-25,9686
1514,亞力,31,8,23,富邦-宜蘭,2023-04-25,9686
2401,凌陽,22,0,22,富邦-宜蘭,2023-04-25,9686
6216,居易,21,0,21,富邦-宜蘭,2023-04-25,9686
2002,中鋼,21,1,20,富邦-宜蘭,2023-04-25,9686
2406,國碩,30,10,20,富邦-宜蘭,2023-04-25,9686
00712,復華富時不動產,20,0,20,富邦-宜蘭,2023-04-25,9686
6126,信音,20,0,20,富邦-宜蘭,2023-04-25,9686
1101,台泥,29,10,19,富邦-宜蘭,2023-04-25,9686
4915,致伸,20,1,19,富邦-宜蘭,2023-04-25,9686
4979,華星光,21,4,17,富邦-宜蘭,2023-04-25,9686
1504,東元,21,4,17,富邦-宜蘭,2023-04-25,9686
1529,樂事綠能,17,1,16,富邦-宜蘭,2023-04-25,9686
6509,聚和,16,0,16,富邦-宜蘭,2023-04-25,9686
4128,中天,15,0,15,富邦-宜蘭,2023-04-25,9686
2393,億光,14,0,14,富邦-宜蘭,2023-04-25,9686
2344,華邦電,14,1,13,富邦-宜蘭,2023-04-25,9686
2883,凱基金,25,13,12,富邦-宜蘭,2023-04-25,9686
4960,誠美材,12,0,12,富邦-宜蘭,2023-04-25,9686
5302,太欣,12,0,12,富邦-宜蘭,2023-04-25,9686
2399,映泰,12,0,12,富邦-宜蘭,2023-04-25,9686
2537,聯上發,12,0,12,富邦-宜蘭,2023-04-25,9686
3005,神基,12,0,12,富邦-宜蘭,2023-04-25,9686
2027,大成鋼,11,0,11,富邦-宜蘭,2023-04-25,9686
4513,福裕,11,0,11,富邦-宜蘭,2023-04-25,9686
3499,環天科,12,1,11,富邦-宜蘭,2023-04-25,9686
2356,英業達,11,0,11,富邦-宜蘭,2023-04-25,9686
2338,光罩,11,0,11,富邦-宜蘭,2023-04-25,9686
1219,福壽,18,7,11,富邦-宜蘭,2023-04-25,9686
2317,鴻海,15,4,11,富邦-宜蘭,2023-04-25,9686
2330,台積電,18,7,11,富邦-宜蘭,2023-04-25,9686
2603,長榮,12,1,11,富邦-宜蘭,2023-04-25,9686
1605,華新,17,7,10,富邦-宜蘭,2023-04-25,9686
6285,啟��,10,0,10,富邦-宜蘭,2023-04-25,9686
1101,台泥,504,46,458,富邦-宜蘭,2023-04-26,9686
00877,復華中國5G,100,0,100,富邦-宜蘭,2023-04-26,9686
1310,台苯,91,9,82,富邦-宜蘭,2023-04-26,9686
6770,力積電,78,2,76,富邦-宜蘭,2023-04-26,9686
00893,國泰智能電動車,55,0,55,富邦-宜蘭,2023-04-26,9686
2610,華航,55,5,50,富邦-宜蘭,2023-04-26,9686
00751B,元大AAA至A公司債,32,3,29,富邦-宜蘭,2023-04-26,9686
00712,復華富時不動產,29,0,29,富邦-宜蘭,2023-04-26,9686
8222,寶一,29,1,28,富邦-宜蘭,2023-04-26,9686
1609,大亞,26,0,26,富邦-宜蘭,2023-04-26,9686
1907,永豐餘,23,4,19,富邦-宜蘭,2023-04-26,9686
1904,正隆,29,10,19,富邦-宜蘭,2023-04-26,9686
00878,國泰永續高股息,32,13,19,富邦-宜蘭,2023-04-26,9686
2303,聯電,29,13,16,富邦-宜蘭,2023-04-26,9686
2891,中信金,15,0,15,富邦-宜蘭,2023-04-26,9686
1711,永光,81,66,15,富邦-宜蘭,2023-04-26,9686
2481,強茂,15,0,15,富邦-宜蘭,2023-04-26,9686
00715L,期街口布蘭特正2,15,0,15,富邦-宜蘭,2023-04-26,9686
6443,元晶,16,1,15,富邦-宜蘭,2023-04-26,9686
00900,富邦特選高股息30,14,0,14,富邦-宜蘭,2023-04-26,9686
2066,世德,12,0,12,富邦-宜蘭,2023-04-26,9686
1503,士電,21,9,12,富邦-宜蘭,2023-04-26,9686
8426,紅木-KY,11,0,11,富邦-宜蘭,2023-04-26,9686
3624,光頡,12,1,11,富邦-宜蘭,2023-04-26,9686
2344,華邦電,14,3,11,富邦-宜蘭,2023-04-26,9686
2337,旺宏,13,3,10,富邦-宜蘭,2023-04-26,9686
6248,沛波,10,0,10,富邦-宜蘭,2023-04-26,9686
1444,力麗,10,0,10,富邦-宜蘭,2023-04-26,9686
2022,聚亨,14,4,10,富邦-宜蘭,2023-04-26,9686
1595,川寶,10,0,10,富邦-宜蘭,2023-04-26,9686
1710,東聯,20,10,10,富邦-宜蘭,2023-04-26,9686
00664R,國泰臺灣加權反1,10,0,10,富邦-宜蘭,2023-04-26,9686
8401,白紗科,10,0,10,富邦-宜蘭,2023-04-26,9686
2537,聯上發,10,0,10,富邦-宜蘭,2023-04-26,9686
1905,華紙,49,39,10,富邦-宜蘭,2023-04-26,9686
3035,智原,14,4,10,富邦-宜蘭,2023-04-26,9686
1519,華城,10,1,9,富邦-宜蘭,2023-04-26,9686
00888,永豐台灣ESG,8,0,8,富邦-宜蘭,2023-04-26,9686
4566,時碩工業,13,5,8,富邦-宜蘭,2023-04-26,9686
2603,長榮,9,2,7,富邦-宜蘭,2023-04-26,9686
2330,台積電,13,6,7,富邦-宜蘭,2023-04-26,9686
00637L,元大滬深300正2,10,3,7,富邦-宜蘭,2023-04-26,9686
2882,國泰金,8,1,7,富邦-宜蘭,2023-04-26,9686
2308,台達電,7,0,7,富邦-宜蘭,2023-04-26,9686
0050,元大台灣50,6,0,6,富邦-宜蘭,2023-04-26,9686
2002,中鋼,11,5,6,富邦-宜蘭,2023-04-26,9686
6285,啟��,7,1,6,富邦-宜蘭,2023-04-26,9686
2408,南亞科,6,0,6,富邦-宜蘭,2023-04-26,9686
6806,森崴能源,9,3,6,富邦-宜蘭,2023-04-26,9686
00922,國泰台灣領袖50,6,0,6,富邦-宜蘭,2023-04-26,9686
2206,三陽工業,95,1,94,富邦-宜蘭,2023-04-27,9686
00772B,中信高評級公司債,65,0,65,富邦-宜蘭,2023-04-27,9686
1101,台泥,82,19,63,富邦-宜蘭,2023-04-27,9686
1714,和桐,61,2,59,富邦-宜蘭,2023-04-27,9686
1710,東聯,64,15,49,富邦-宜蘭,2023-04-27,9686
8215,明基材,42,2,40,富邦-宜蘭,2023-04-27,9686
2476,鉅祥,40,0,40,富邦-宜蘭,2023-04-27,9686
2610,華航,38,7,31,富邦-宜蘭,2023-04-27,9686
00720B,元大投資級公司債,30,0,30,富邦-宜蘭,2023-04-27,9686
8011,台通,30,0,30,富邦-宜蘭,2023-04-27,9686
00712,復華富時不動產,26,0,26,富邦-宜蘭,2023-04-27,9686
00878,國泰永續高股息,24,1,23,富邦-宜蘭,2023-04-27,9686
00715L,期街口布蘭特正2,23,0,23,富邦-宜蘭,2023-04-27,9686
2504,國產,21,0,21,富邦-宜蘭,2023-04-27,9686
00679B,元大美債20年,21,1,20,富邦-宜蘭,2023-04-27,9686
4716,大立,20,0,20,富邦-宜蘭,2023-04-27,9686
6160,欣技,23,4,19,富邦-宜蘭,2023-04-27,9686
00891,中信關鍵半導體,18,2,16,富邦-宜蘭,2023-04-27,9686
2609,陽明,17,2,15,富邦-宜蘭,2023-04-27,9686
1709,和益,20,5,15,富邦-宜蘭,2023-04-27,9686
5009,榮剛,18,4,14,富邦-宜蘭,2023-04-27,9686
1108,幸福,14,0,14,富邦-宜蘭,2023-04-27,9686
1905,華紙,72,60,12,富邦-宜蘭,2023-04-27,9686
8069,元太,12,1,11,富邦-宜蘭,2023-04-27,9686
2882,國泰金,12,1,11,富邦-宜蘭,2023-04-27,9686
00687B,國泰20年美債,11,0,11,富邦-宜蘭,2023-04-27,9686
5302,太欣,11,0,11,富邦-宜蘭,2023-04-27,9686
00753L,中信中國50正2,13,2,11,富邦-宜蘭,2023-04-27,9686
6443,元晶,13,2,11,富邦-宜蘭,2023-04-27,9686
1612,宏泰,10,0,10,富邦-宜蘭,2023-04-27,9686
2352,佳世達,11,1,10,富邦-宜蘭,2023-04-27,9686
1536,和大,10,0,10,富邦-宜蘭,2023-04-27,9686
3232,昱捷,10,0,10,富邦-宜蘭,2023-04-27,9686
6712,長聖,10,0,10,富邦-宜蘭,2023-04-27,9686
2603,長榮,10,0,10,富邦-宜蘭,2023-04-27,9686
2002,中鋼,12,2,10,富邦-宜蘭,2023-04-27,9686
3037,欣興,12,3,9,富邦-宜蘭,2023-04-27,9686
2330,台積電,15,6,9,富邦-宜蘭,2023-04-27,9686
6182,合晶,8,1,7,富邦-宜蘭,2023-04-27,9686
3664,安瑞-KY,7,0,7,富邦-宜蘭,2023-04-27,9686
2066,世德,7,0,7,富邦-宜蘭,2023-04-27,9686
1464,得力,7,0,7,富邦-宜蘭,2023-04-27,9686
3520,華盈,7,0,7,富邦-宜蘭,2023-04-27,9686
00642U,期元大S＆P石油,7,0,7,富邦-宜蘭,2023-04-27,9686
1310,台苯,36,29,7,富邦-宜蘭,2023-04-27,9686
1711,永光,85,78,7,富邦-宜蘭,2023-04-27,9686
1522,堤維西,6,0,6,富邦-宜蘭,2023-04-27,9686
2881,富邦金,5,0,5,富邦-宜蘭,2023-04-27,9686
00795B,中信美國公債20年,5,0,5,富邦-宜蘭,2023-04-27,9686
2344,華邦電,7,2,5,富邦-宜蘭,2023-04-27,9686
2409,友達,319,0,319,富邦-宜蘭,2023-04-28,9686
2867,三商壽,201,5,196,富邦-宜蘭,2023-04-28,9686
3481,群創,189,25,164,富邦-宜蘭,2023-04-28,9686
1101,台泥,137,11,126,富邦-宜蘭,2023-04-28,9686
00632R,元大台灣50反1,60,10,50,富邦-宜蘭,2023-04-28,9686
00715L,期街口布蘭特正2,50,5,45,富邦-宜蘭,2023-04-28,9686
2530,華建,42,1,41,富邦-宜蘭,2023-04-28,9686
4157,太景*-KY,44,5,39,富邦-宜蘭,2023-04-28,9686
5251,天鉞電,40,1,39,富邦-宜蘭,2023-04-28,9686
2880,華南金,49,12,37,富邦-宜蘭,2023-04-28,9686
3025,星通,32,1,31,富邦-宜蘭,2023-04-28,9686
1776,展宇,30,0,30,富邦-宜蘭,2023-04-28,9686
2820,華票,29,0,29,富邦-宜蘭,2023-04-28,9686
00772B,中信高評級公司債,22,0,22,富邦-宜蘭,2023-04-28,9686
3024,憶聲,20,0,20,富邦-宜蘭,2023-04-28,9686
1611,中電,24,4,20,富邦-宜蘭,2023-04-28,9686
00878,國泰永續高股息,26,8,18,富邦-宜蘭,2023-04-28,9686
2609,陽明,21,3,18,富邦-宜蘭,2023-04-28,9686
2317,鴻海,22,5,17,富邦-宜蘭,2023-04-28,9686
1471,首利,21,5,16,富邦-宜蘭,2023-04-28,9686
5410,國眾,15,0,15,富邦-宜蘭,2023-04-28,9686
2337,旺宏,15,1,14,富邦-宜蘭,2023-04-28,9686
4961,天鈺,14,1,13,富邦-宜蘭,2023-04-28,9686
5302,太欣,12,0,12,富邦-宜蘭,2023-04-28,9686
6806,森崴能源,13,2,11,富邦-宜蘭,2023-04-28,9686
1777,生泰,11,0,11,富邦-宜蘭,2023-04-28,9686
6116,彩晶,11,0,11,富邦-宜蘭,2023-04-28,9686
2486,一詮,10,0,10,富邦-宜蘭,2023-04-28,9686
8011,台通,10,0,10,富邦-宜蘭,2023-04-28,9686
3545,敦泰,12,2,10,富邦-宜蘭,2023-04-28,9686
5011,久陽,10,0,10,富邦-宜蘭,2023-04-28,9686
00895,富邦未來車,10,0,10,富邦-宜蘭,2023-04-28,9686
2538,基泰,10,0,10,富邦-宜蘭,2023-04-28,9686
3711,日月光投控,9,0,9,富邦-宜蘭,2023-04-28,9686
1513,中興電,10,1,9,富邦-宜蘭,2023-04-28,9686
3673,TPK-KY,9,0,9,富邦-宜蘭,2023-04-28,9686
2611,志信,12,3,9,富邦-宜蘭,2023-04-28,9686
6126,信音,10,1,9,富邦-宜蘭,2023-04-28,9686
1504,東元,10,1,9,富邦-宜蘭,2023-04-28,9686
1524,耿鼎,10,2,8,富邦-宜蘭,2023-04-28,9686
3520,華盈,10,2,8,富邦-宜蘭,2023-04-28,9686
1529,樂事綠能,9,1,8,富邦-宜蘭,2023-04-28,9686
00679B,元大美債20年,7,0,7,富邦-宜蘭,2023-04-28,9686
2329,華泰,13,6,7,富邦-宜蘭,2023-04-28,9686
2462,良得電,7,0,7,富邦-宜蘭,2023-04-28,9686
1735,日勝化,10,3,7,富邦-宜蘭,2023-04-28,9686
1727,中華化,27,20,7,富邦-宜蘭,2023-04-28,9686
6282,康舒,17,10,7,富邦-宜蘭,2023-04-28,9686
2349,錸德,6,0,6,富邦-宜蘭,2023-04-28,9686
00892,富邦台灣半導體,6,0,6,富邦-宜蘭,2023-04-28,9686
2867,三商壽,300,1,299,富邦-宜蘭,2023-05-02,9686
1101,台泥,177,72,105,富邦-宜蘭,2023-05-02,9686
2353,宏��,101,0,101,富邦-宜蘭,2023-05-02,9686
2603,長榮,104,5,99,富邦-宜蘭,2023-05-02,9686
2610,華航,51,3,48,富邦-宜蘭,2023-05-02,9686
1905,華紙,90,51,39,富邦-宜蘭,2023-05-02,9686
2913,農林,41,6,35,富邦-宜蘭,2023-05-02,9686
3664,安瑞-KY,36,2,34,富邦-宜蘭,2023-05-02,9686
6116,彩晶,30,0,30,富邦-宜蘭,2023-05-02,9686
00772B,中信高評級公司債,31,2,29,富邦-宜蘭,2023-05-02,9686
2344,華邦電,33,6,27,富邦-宜蘭,2023-05-02,9686
2014,中鴻,26,0,26,富邦-宜蘭,2023-05-02,9686
2515,中工,25,0,25,富邦-宜蘭,2023-05-02,9686
00632R,元大台灣50反1,24,0,24,富邦-宜蘭,2023-05-02,9686
3205,佰研,25,5,20,富邦-宜蘭,2023-05-02,9686
910861,神州-DR,20,0,20,富邦-宜蘭,2023-05-02,9686
4121,優盛,22,3,19,富邦-宜蘭,2023-05-02,9686
2609,陽明,38,20,18,富邦-宜蘭,2023-05-02,9686
1904,正隆,20,2,18,富邦-宜蘭,2023-05-02,9686
2883,凱基金,18,1,17,富邦-宜蘭,2023-05-02,9686
5009,榮剛,18,2,16,富邦-宜蘭,2023-05-02,9686
8093,保銳,16,0,16,富邦-宜蘭,2023-05-02,9686
2402,毅嘉,16,1,15,富邦-宜蘭,2023-05-02,9686
6111,大宇資,16,1,15,富邦-宜蘭,2023-05-02,9686
00751B,元大AAA至A公司債,14,0,14,富邦-宜蘭,2023-05-02,9686
2641,正德,14,0,14,富邦-宜蘭,2023-05-02,9686
00680L,元大美債20正2,14,0,14,富邦-宜蘭,2023-05-02,9686
2409,友達,32,19,13,富邦-宜蘭,2023-05-02,9686
1802,台玻,12,0,12,富邦-宜蘭,2023-05-02,9686
6234,高僑,31,19,12,富邦-宜蘭,2023-05-02,9686
00679B,元大美債20年,11,0,11,富邦-宜蘭,2023-05-02,9686
2634,漢翔,22,11,11,富邦-宜蘭,2023-05-02,9686
1809,中釉,10,0,10,富邦-宜蘭,2023-05-02,9686
5302,太欣,10,0,10,富邦-宜蘭,2023-05-02,9686
3056,富華新,10,0,10,富邦-宜蘭,2023-05-02,9686
8938,明安,10,0,10,富邦-宜蘭,2023-05-02,9686
2903,遠百,10,0,10,富邦-宜蘭,2023-05-02,9686
6126,信音,10,0,10,富邦-宜蘭,2023-05-02,9686
6753,龍德造船,9,0,9,富邦-宜蘭,2023-05-02,9686
2352,佳世達,8,0,8,富邦-宜蘭,2023-05-02,9686
4130,健亞,9,1,8,富邦-宜蘭,2023-05-02,9686
3264,欣銓,8,0,8,富邦-宜蘭,2023-05-02,9686
2444,兆勁,28,20,8,富邦-宜蘭,2023-05-02,9686
00795B,中信美國公債20年,7,0,7,富邦-宜蘭,2023-05-02,9686
2002,中鋼,8,1,7,富邦-宜蘭,2023-05-02,9686
3515,華擎,7,0,7,富邦-宜蘭,2023-05-02,9686
00888,永豐台灣ESG,7,0,7,富邦-宜蘭,2023-05-02,9686
2489,瑞軒,7,0,7,富邦-宜蘭,2023-05-02,9686
2359,所羅門,7,0,7,富邦-宜蘭,2023-05-02,9686
2891,中信金,34,27,7,富邦-宜蘭,2023-05-02,9686
1101,台泥,215,1,214,富邦-宜蘭,2023-05-03,9686
00878,國泰永續高股息,201,6,195,富邦-宜蘭,2023-05-03,9686
00715L,期街口布蘭特正2,56,0,56,富邦-宜蘭,2023-05-03,9686
00712,復華富時不動產,52,0,52,富邦-宜蘭,2023-05-03,9686
5475,德宏,59,10,49,富邦-宜蘭,2023-05-03,9686
2417,圓剛,49,0,49,富邦-宜蘭,2023-05-03,9686
2603,長榮,65,22,43,富邦-宜蘭,2023-05-03,9686
3481,群創,31,0,31,富邦-宜蘭,2023-05-03,9686
1514,亞力,29,3,26,富邦-宜蘭,2023-05-03,9686
8028,昇陽半導體,25,0,25,富邦-宜蘭,2023-05-03,9686
2609,陽明,28,4,24,富邦-宜蘭,2023-05-03,9686
00753L,中信中國50正2,21,0,21,富邦-宜蘭,2023-05-03,9686
3419,譁裕,45,24,21,富邦-宜蘭,2023-05-03,9686
00642U,期元大S＆P石油,20,0,20,富邦-宜蘭,2023-05-03,9686
2801,彰銀,20,0,20,富邦-宜蘭,2023-05-03,9686
1721,三晃,20,0,20,富邦-宜蘭,2023-05-03,9686
1612,宏泰,20,0,20,富邦-宜蘭,2023-05-03,9686
00888,永豐台灣ESG,19,0,19,富邦-宜蘭,2023-05-03,9686
2615,萬海,18,0,18,富邦-宜蘭,2023-05-03,9686
3522,御嵿,17,0,17,富邦-宜蘭,2023-05-03,9686
6179,亞通,18,1,17,富邦-宜蘭,2023-05-03,9686
1709,和益,17,0,17,富邦-宜蘭,2023-05-03,9686
3006,晶豪科,25,11,14,富邦-宜蘭,2023-05-03,9686
3520,華盈,14,1,13,富邦-宜蘭,2023-05-03,9686
8222,寶一,67,54,13,富邦-宜蘭,2023-05-03,9686
00924,復華S＆P500成長,12,0,12,富邦-宜蘭,2023-05-03,9686
2002,中鋼,12,0,12,富邦-宜蘭,2023-05-03,9686
6697,東捷資訊,12,0,12,富邦-宜蘭,2023-05-03,9686
2399,映泰,12,0,12,富邦-宜蘭,2023-05-03,9686
2913,農林,33,21,12,富邦-宜蘭,2023-05-03,9686
2337,旺宏,11,0,11,富邦-宜蘭,2023-05-03,9686
2344,華邦電,11,0,11,富邦-宜蘭,2023-05-03,9686
8038,長園科,10,0,10,富邦-宜蘭,2023-05-03,9686
2356,英業達,10,0,10,富邦-宜蘭,2023-05-03,9686
2903,遠百,10,0,10,富邦-宜蘭,2023-05-03,9686
3441,聯一光,10,0,10,富邦-宜蘭,2023-05-03,9686
3264,欣銓,10,0,10,富邦-宜蘭,2023-05-03,9686
5410,國眾,10,0,10,富邦-宜蘭,2023-05-03,9686
00665L,富邦�琤肭磪囓�2,10,1,9,富邦-宜蘭,2023-05-03,9686
2353,宏��,10,1,9,富邦-宜蘭,2023-05-03,9686
8403,盛弘,10,2,8,富邦-宜蘭,2023-05-03,9686
4977,眾達-KY,8,0,8,富邦-宜蘭,2023-05-03,9686
2892,第一金,8,0,8,富邦-宜蘭,2023-05-03,9686
6806,森崴能源,8,0,8,富邦-宜蘭,2023-05-03,9686
6465,威潤,8,0,8,富邦-宜蘭,2023-05-03,9686
8383,千附,10,2,8,富邦-宜蘭,2023-05-03,9686
2231,為升,8,0,8,富邦-宜蘭,2023-05-03,9686
2867,三商壽,8,0,8,富邦-宜蘭,2023-05-03,9686
2014,中鴻,7,0,7,富邦-宜蘭,2023-05-03,9686
3056,富華新,7,0,7,富邦-宜蘭,2023-05-03,9686
2867,三商壽,108,0,108,富邦-宜蘭,2023-05-04,9686
00878,國泰永續高股息,111,7,104,富邦-宜蘭,2023-05-04,9686
00662,富邦NASDAQ,87,0,87,富邦-宜蘭,2023-05-04,9686
00715L,期街口布蘭特正2,79,0,79,富邦-宜蘭,2023-05-04,9686
00712,復華富時不動產,47,0,47,富邦-宜蘭,2023-05-04,9686
1101,台泥,61,15,46,富邦-宜蘭,2023-05-04,9686
1504,東元,45,7,38,富邦-宜蘭,2023-05-04,9686
1529,樂事綠能,49,16,33,富邦-宜蘭,2023-05-04,9686
5469,瀚宇博,28,3,25,富邦-宜蘭,2023-05-04,9686
00888,永豐台灣ESG,24,0,24,富邦-宜蘭,2023-05-04,9686
2208,台船,23,3,20,富邦-宜蘭,2023-05-04,9686
00642U,期元大S＆P石油,20,0,20,富邦-宜蘭,2023-05-04,9686
3673,TPK-KY,23,4,19,富邦-宜蘭,2023-05-04,9686
3202,樺晟,18,0,18,富邦-宜蘭,2023-05-04,9686
2890,永豐金,18,1,17,富邦-宜蘭,2023-05-04,9686
2489,瑞軒,26,9,17,富邦-宜蘭,2023-05-04,9686
2206,三陽工業,26,11,15,富邦-宜蘭,2023-05-04,9686
4541,晟田,26,12,14,富邦-宜蘭,2023-05-04,9686
1471,首利,13,0,13,富邦-宜蘭,2023-05-04,9686
4111,濟生,12,0,12,富邦-宜蘭,2023-05-04,9686
2002,中鋼,11,0,11,富邦-宜蘭,2023-05-04,9686
1709,和益,11,0,11,富邦-宜蘭,2023-05-04,9686
6116,彩晶,21,10,11,富邦-宜蘭,2023-05-04,9686
00892,富邦台灣半導體,11,0,11,富邦-宜蘭,2023-05-04,9686
3058,立德,19,9,10,富邦-宜蘭,2023-05-04,9686
2356,英業達,13,3,10,富邦-宜蘭,2023-05-04,9686
1522,堤維西,10,0,10,富邦-宜蘭,2023-05-04,9686
2359,所羅門,10,0,10,富邦-宜蘭,2023-05-04,9686
2425,承啟,10,0,10,富邦-宜蘭,2023-05-04,9686
2338,光罩,10,0,10,富邦-宜蘭,2023-05-04,9686
1560,中砂,10,0,10,富邦-宜蘭,2023-05-04,9686
2630,亞航,10,0,10,富邦-宜蘭,2023-05-04,9686
00877,復華中國5G,10,0,10,富邦-宜蘭,2023-05-04,9686
4566,時碩工業,12,2,10,富邦-宜蘭,2023-05-04,9686
6167,久正,12,2,10,富邦-宜蘭,2023-05-04,9686
8383,千附,10,0,10,富邦-宜蘭,2023-05-04,9686
3236,千如,9,0,9,富邦-宜蘭,2023-05-04,9686
3025,星通,10,1,9,富邦-宜蘭,2023-05-04,9686
3522,御嵿,9,0,9,富邦-宜蘭,2023-05-04,9686
2618,長榮航,8,0,8,富邦-宜蘭,2023-05-04,9686
2230,泰茂,8,0,8,富邦-宜蘭,2023-05-04,9686
2453,凌群,15,7,8,富邦-宜蘭,2023-05-04,9686
1708,東鹼,10,2,8,富邦-宜蘭,2023-05-04,9686
3356,奇偶,10,3,7,富邦-宜蘭,2023-05-04,9686
3038,全台,7,0,7,富邦-宜蘭,2023-05-04,9686
5258,虹堡,9,2,7,富邦-宜蘭,2023-05-04,9686
2537,聯上發,7,0,7,富邦-宜蘭,2023-05-04,9686
6548,長科*,11,4,7,富邦-宜蘭,2023-05-04,9686
1215,卜蜂,8,2,6,富邦-宜蘭,2023-05-04,9686
2538,基泰,6,0,6,富邦-宜蘭,2023-05-04,9686
00885,富邦越南,162,1,161,富邦-宜蘭,2023-05-05,9686
00715L,期街口布蘭特正2,90,5,85,富邦-宜蘭,2023-05-05,9686
4114,健喬,65,1,64,富邦-宜蘭,2023-05-05,9686
6241,易通展,59,0,59,富邦-宜蘭,2023-05-05,9686
00877,復華中國5G,55,0,55,富邦-宜蘭,2023-05-05,9686
3005,神基,51,6,45,富邦-宜蘭,2023-05-05,9686
00772B,中信高評級公司債,44,0,44,富邦-宜蘭,2023-05-05,9686
00712,復華富時不動產,31,0,31,富邦-宜蘭,2023-05-05,9686
00679B,元大美債20年,27,2,25,富邦-宜蘭,2023-05-05,9686
8215,明基材,33,8,25,富邦-宜蘭,2023-05-05,9686
3038,全台,23,0,23,富邦-宜蘭,2023-05-05,9686
3576,聯合再生,25,3,22,富邦-宜蘭,2023-05-05,9686
00878,國泰永續高股息,46,25,21,富邦-宜蘭,2023-05-05,9686
1609,大亞,58,38,20,富邦-宜蘭,2023-05-05,9686
2886,兆豐金,20,0,20,富邦-宜蘭,2023-05-05,9686
3265,台星科,17,1,16,富邦-宜蘭,2023-05-05,9686
6218,豪勉,16,0,16,富邦-宜蘭,2023-05-05,9686
00795B,中信美國公債20年,16,0,16,富邦-宜蘭,2023-05-05,9686
3060,銘異,15,0,15,富邦-宜蘭,2023-05-05,9686
6167,久正,16,1,15,富邦-宜蘭,2023-05-05,9686
1802,台玻,14,0,14,富邦-宜蘭,2023-05-05,9686
2352,佳世達,14,0,14,富邦-宜蘭,2023-05-05,9686
8390,金益鼎,16,2,14,富邦-宜蘭,2023-05-05,9686
2358,廷鑫,14,0,14,富邦-宜蘭,2023-05-05,9686
3058,立德,13,0,13,富邦-宜蘭,2023-05-05,9686
1504,東元,42,29,13,富邦-宜蘭,2023-05-05,9686
00751B,元大AAA至A公司債,11,0,11,富邦-宜蘭,2023-05-05,9686
2891,中信金,14,3,11,富邦-宜蘭,2023-05-05,9686
1905,華紙,62,51,11,富邦-宜蘭,2023-05-05,9686
6770,力積電,11,1,10,富邦-宜蘭,2023-05-05,9686
6191,精成科,13,3,10,富邦-宜蘭,2023-05-05,9686
2449,京元電子,10,0,10,富邦-宜蘭,2023-05-05,9686
00725B,國泰投資級公司債,10,0,10,富邦-宜蘭,2023-05-05,9686
6461,益得,10,0,10,富邦-宜蘭,2023-05-05,9686
6508,惠光,11,1,10,富邦-宜蘭,2023-05-05,9686
6244,茂迪,22,13,9,富邦-宜蘭,2023-05-05,9686
3664,安瑞-KY,10,1,9,富邦-宜蘭,2023-05-05,9686
3624,光頡,9,0,9,富邦-宜蘭,2023-05-05,9686
1618,合機,10,1,9,富邦-宜蘭,2023-05-05,9686
6163,華電網,9,0,9,富邦-宜蘭,2023-05-05,9686
2630,亞航,13,4,9,富邦-宜蘭,2023-05-05,9686
5465,富驊,13,4,9,富邦-宜蘭,2023-05-05,9686
2002,中鋼,8,0,8,富邦-宜蘭,2023-05-05,9686
1711,永光,9,1,8,富邦-宜蘭,2023-05-05,9686
00642U,期元大S＆P石油,8,0,8,富邦-宜蘭,2023-05-05,9686
3231,緯創,20,12,8,富邦-宜蘭,2023-05-05,9686
4744,皇將,8,1,7,富邦-宜蘭,2023-05-05,9686
4552,力達-KY,7,0,7,富邦-宜蘭,2023-05-05,9686
6456,GIS-KY,7,0,7,富邦-宜蘭,2023-05-05,9686
3029,零壹,15,8,7,富邦-宜蘭,2023-05-05,9686
00632R,元大台灣50反1,722,0,722,富邦-宜蘭,2023-05-08,9686
1605,華新,73,14,59,富邦-宜蘭,2023-05-08,9686
1434,福懋,47,0,47,富邦-宜蘭,2023-05-08,9686
9962,有益,36,0,36,富邦-宜蘭,2023-05-08,9686
00900,富邦特選高股息30,54,20,34,富邦-宜蘭,2023-05-08,9686
2630,亞航,33,2,31,富邦-宜蘭,2023-05-08,9686
2903,遠百,30,0,30,富邦-宜蘭,2023-05-08,9686
00641R,富邦日本反1,30,0,30,富邦-宜蘭,2023-05-08,9686
00878,國泰永續高股息,53,23,30,富邦-宜蘭,2023-05-08,9686
1708,東鹼,27,1,26,富邦-宜蘭,2023-05-08,9686
00720B,元大投資級公司債,25,0,25,富邦-宜蘭,2023-05-08,9686
2547,日勝生,22,0,22,富邦-宜蘭,2023-05-08,9686
3060,銘異,15,0,15,富邦-宜蘭,2023-05-08,9686
6443,元晶,16,2,14,富邦-宜蘭,2023-05-08,9686
2338,光罩,14,0,14,富邦-宜蘭,2023-05-08,9686
1218,泰山,23,10,13,富邦-宜蘭,2023-05-08,9686
00712,復華富時不動產,13,0,13,富邦-宜蘭,2023-05-08,9686
00679B,元大美債20年,11,0,11,富邦-宜蘭,2023-05-08,9686
5302,太欣,11,0,11,富邦-宜蘭,2023-05-08,9686
2915,潤泰全,11,0,11,富邦-宜蘭,2023-05-08,9686
6290,良維,10,0,10,富邦-宜蘭,2023-05-08,9686
6719,力智,12,2,10,富邦-宜蘭,2023-05-08,9686
5469,瀚宇博,15,5,10,富邦-宜蘭,2023-05-08,9686
2103,台橡,10,0,10,富邦-宜蘭,2023-05-08,9686
1711,永光,10,0,10,富邦-宜蘭,2023-05-08,9686
2614,東森,10,0,10,富邦-宜蘭,2023-05-08,9686
9945,潤泰新,10,0,10,富邦-宜蘭,2023-05-08,9686
9955,佳龍,10,1,9,富邦-宜蘭,2023-05-08,9686
3149,正達,9,0,9,富邦-宜蘭,2023-05-08,9686
9933,中鼎,9,0,9,富邦-宜蘭,2023-05-08,9686
2883,凱基金,66,58,8,富邦-宜蘭,2023-05-08,9686
6214,精誠,9,1,8,富邦-宜蘭,2023-05-08,9686
4114,健喬,9,1,8,富邦-宜蘭,2023-05-08,9686
6532,瑞耘,9,1,8,富邦-宜蘭,2023-05-08,9686
1104,環泥,10,3,7,富邦-宜蘭,2023-05-08,9686
3038,全台,14,7,7,富邦-宜蘭,2023-05-08,9686
1784,訊聯,11,5,6,富邦-宜蘭,2023-05-08,9686
4173,久裕,6,0,6,富邦-宜蘭,2023-05-08,9686
2834,臺企銀,6,0,6,富邦-宜蘭,2023-05-08,9686
2231,為升,6,0,6,富邦-宜蘭,2023-05-08,9686
00902,中信電池及儲能,5,0,5,富邦-宜蘭,2023-05-08,9686
2881,富邦金,7,2,5,富邦-宜蘭,2023-05-08,9686
2458,義隆,5,0,5,富邦-宜蘭,2023-05-08,9686
3545,敦泰,10,5,5,富邦-宜蘭,2023-05-08,9686
2468,華經,18,13,5,富邦-宜蘭,2023-05-08,9686
3704,合勤控,5,0,5,富邦-宜蘭,2023-05-08,9686
3032,偉訓,5,0,5,富邦-宜蘭,2023-05-08,9686
2897,王道銀行,5,0,5,富邦-宜蘭,2023-05-08,9686
2812,台中銀,5,0,5,富邦-宜蘭,2023-05-08,9686
2482,連宇,11,6,5,富邦-宜蘭,2023-05-08,9686
6282,康舒,104,5,99,富邦-宜蘭,2023-05-09,9686
2913,農林,70,12,58,富邦-宜蘭,2023-05-09,9686
6218,豪勉,43,0,43,富邦-宜蘭,2023-05-09,9686
1701,中化,39,0,39,富邦-宜蘭,2023-05-09,9686
2634,漢翔,55,19,36,富邦-宜蘭,2023-05-09,9686
00679B,元大美債20年,29,0,29,富邦-宜蘭,2023-05-09,9686
1504,東元,31,3,28,富邦-宜蘭,2023-05-09,9686
2609,陽明,34,7,27,富邦-宜蘭,2023-05-09,9686
1708,東鹼,28,1,27,富邦-宜蘭,2023-05-09,9686
1810,和成,26,1,25,富邦-宜蘭,2023-05-09,9686
1101,台泥,25,2,23,富邦-宜蘭,2023-05-09,9686
3712,永崴投控,21,1,20,富邦-宜蘭,2023-05-09,9686
1528,恩德,20,0,20,富邦-宜蘭,2023-05-09,9686
6443,元晶,48,30,18,富邦-宜蘭,2023-05-09,9686
3715,定穎投控,18,0,18,富邦-宜蘭,2023-05-09,9686
00720B,元大投資級公司債,18,1,17,富邦-宜蘭,2023-05-09,9686
1605,華新,22,5,17,富邦-宜蘭,2023-05-09,9686
00680L,元大美債20正2,15,0,15,富邦-宜蘭,2023-05-09,9686
00795B,中信美國公債20年,14,0,14,富邦-宜蘭,2023-05-09,9686
00632R,元大台灣50反1,14,0,14,富邦-宜蘭,2023-05-09,9686
5465,富驊,17,3,14,富邦-宜蘭,2023-05-09,9686
3025,星通,14,1,13,富邦-宜蘭,2023-05-09,9686
6770,力積電,15,2,13,富邦-宜蘭,2023-05-09,9686
00772B,中信高評級公司債,12,0,12,富邦-宜蘭,2023-05-09,9686
00712,復華富時不動產,14,2,12,富邦-宜蘭,2023-05-09,9686
6244,茂迪,22,11,11,富邦-宜蘭,2023-05-09,9686
1612,宏泰,12,1,11,富邦-宜蘭,2023-05-09,9686
9958,世紀鋼,11,0,11,富邦-宜蘭,2023-05-09,9686
3520,華盈,11,0,11,富邦-宜蘭,2023-05-09,9686
8383,千附,11,0,11,富邦-宜蘭,2023-05-09,9686
1513,中興電,22,11,11,富邦-宜蘭,2023-05-09,9686
00687B,國泰20年美債,10,0,10,富邦-宜蘭,2023-05-09,9686
3058,立德,10,0,10,富邦-宜蘭,2023-05-09,9686
2401,凌陽,10,0,10,富邦-宜蘭,2023-05-09,9686
2423,固緯,10,0,10,富邦-宜蘭,2023-05-09,9686
3202,樺晟,10,0,10,富邦-宜蘭,2023-05-09,9686
2547,日勝生,10,0,10,富邦-宜蘭,2023-05-09,9686
6163,華電網,11,1,10,富邦-宜蘭,2023-05-09,9686
2371,大同,10,0,10,富邦-宜蘭,2023-05-09,9686
4739,康普,10,0,10,富邦-宜蘭,2023-05-09,9686
1711,永光,10,0,10,富邦-宜蘭,2023-05-09,9686
2801,彰銀,10,0,10,富邦-宜蘭,2023-05-09,9686
2374,佳能,10,0,10,富邦-宜蘭,2023-05-09,9686
8215,明基材,13,4,9,富邦-宜蘭,2023-05-09,9686
3576,聯合再生,10,2,8,富邦-宜蘭,2023-05-09,9686
00751B,元大AAA至A公司債,8,0,8,富邦-宜蘭,2023-05-09,9686
6570,維田,8,1,7,富邦-宜蘭,2023-05-09,9686
00673R,期元大S＆P原油反1,7,0,7,富邦-宜蘭,2023-05-09,9686
5607,遠雄港,7,0,7,富邦-宜蘭,2023-05-09,9686
2408,南亞科,8,1,7,富邦-宜蘭,2023-05-09,9686
00878,國泰永續高股息,79,1,78,富邦-宜蘭,2023-05-10,9686
1722,台肥,47,0,47,富邦-宜蘭,2023-05-10,9686
1905,華紙,43,7,36,富邦-宜蘭,2023-05-10,9686
4173,久裕,32,0,32,富邦-宜蘭,2023-05-10,9686
1609,大亞,39,9,30,富邦-宜蘭,2023-05-10,9686
1337,再生-KY,30,0,30,富邦-宜蘭,2023-05-10,9686
1101,台泥,38,8,30,富邦-宜蘭,2023-05-10,9686
00679B,元大美債20年,32,7,25,富邦-宜蘭,2023-05-10,9686
00687B,國泰20年美債,24,0,24,富邦-宜蘭,2023-05-10,9686
6245,立端,25,2,23,富邦-宜蘭,2023-05-10,9686
2890,永豐金,22,0,22,富邦-宜蘭,2023-05-10,9686
5483,中美晶,20,0,20,富邦-宜蘭,2023-05-10,9686
00773B,中信優先金融債,20,0,20,富邦-宜蘭,2023-05-10,9686
2206,三陽工業,26,8,18,富邦-宜蘭,2023-05-10,9686
00720B,元大投資級公司債,16,0,16,富邦-宜蘭,2023-05-10,9686
3231,緯創,18,4,14,富邦-宜蘭,2023-05-10,9686
3013,晟銘電,19,6,13,富邦-宜蘭,2023-05-10,9686
2387,精元,20,7,13,富邦-宜蘭,2023-05-10,9686
2352,佳世達,14,1,13,富邦-宜蘭,2023-05-10,9686
6508,惠光,12,0,12,富邦-宜蘭,2023-05-10,9686
3058,立德,11,0,11,富邦-宜蘭,2023-05-10,9686
4979,華星光,16,5,11,富邦-宜蘭,2023-05-10,9686
00637L,元大滬深300正2,11,0,11,富邦-宜蘭,2023-05-10,9686
1310,台苯,11,0,11,富邦-宜蘭,2023-05-10,9686
00673R,期元大S＆P原油反1,10,0,10,富邦-宜蘭,2023-05-10,9686
2356,英業達,10,0,10,富邦-宜蘭,2023-05-10,9686
00665L,富邦�琤肭磪囓�2,10,0,10,富邦-宜蘭,2023-05-10,9686
1776,展宇,15,5,10,富邦-宜蘭,2023-05-10,9686
00753L,中信中國50正2,10,0,10,富邦-宜蘭,2023-05-10,9686
6235,華孚,11,2,9,富邦-宜蘭,2023-05-10,9686
00680L,元大美債20正2,9,0,9,富邦-宜蘭,2023-05-10,9686
00713,元大台灣高息低波,10,1,9,富邦-宜蘭,2023-05-10,9686
3708,上緯投控,8,0,8,富邦-宜蘭,2023-05-10,9686
2891,中信金,12,4,8,富邦-宜蘭,2023-05-10,9686
6026,福邦證,8,0,8,富邦-宜蘭,2023-05-10,9686
1519,華城,10,2,8,富邦-宜蘭,2023-05-10,9686
3576,聯合再生,7,0,7,富邦-宜蘭,2023-05-10,9686
2913,農林,9,2,7,富邦-宜蘭,2023-05-10,9686
3071,協禧,7,0,7,富邦-宜蘭,2023-05-10,9686
6173,信昌電,7,0,7,富邦-宜蘭,2023-05-10,9686
6125,廣運,7,0,7,富邦-宜蘭,2023-05-10,9686
5498,凱崴,7,0,7,富邦-宜蘭,2023-05-10,9686
6288,聯嘉,7,0,7,富邦-宜蘭,2023-05-10,9686
00712,復華富時不動產,6,0,6,富邦-宜蘭,2023-05-10,9686
1504,東元,6,0,6,富邦-宜蘭,2023-05-10,9686
00888,永豐台灣ESG,6,0,6,富邦-宜蘭,2023-05-10,9686
5607,遠雄港,6,0,6,富邦-宜蘭,2023-05-10,9686
9939,宏全,6,0,6,富邦-宜蘭,2023-05-10,9686
2634,漢翔,23,18,5,富邦-宜蘭,2023-05-10,9686
6168,宏齊,5,0,5,富邦-宜蘭,2023-05-10,9686
2610,華航,92,10,82,富邦-宜蘭,2023-05-11,9686
6282,康舒,58,6,52,富邦-宜蘭,2023-05-11,9686
3005,神基,48,3,45,富邦-宜蘭,2023-05-11,9686
00878,國泰永續高股息,48,7,41,富邦-宜蘭,2023-05-11,9686
2480,敦陽科,32,0,32,富邦-宜蘭,2023-05-11,9686
9105,泰金寶-DR,30,0,30,富邦-宜蘭,2023-05-11,9686
2801,彰銀,30,1,29,富邦-宜蘭,2023-05-11,9686
3013,晟銘電,33,5,28,富邦-宜蘭,2023-05-11,9686
1722,台肥,28,1,27,富邦-宜蘭,2023-05-11,9686
5880,合庫金,27,0,27,富邦-宜蘭,2023-05-11,9686
1905,華紙,36,10,26,富邦-宜蘭,2023-05-11,9686
1609,大亞,31,7,24,富邦-宜蘭,2023-05-11,9686
9958,世紀鋼,24,0,24,富邦-宜蘭,2023-05-11,9686
1708,東鹼,23,0,23,富邦-宜蘭,2023-05-11,9686
1584,精剛,33,10,23,富邦-宜蘭,2023-05-11,9686
2609,陽明,34,12,22,富邦-宜蘭,2023-05-11,9686
2405,輔信,23,1,22,富邦-宜蘭,2023-05-11,9686
3576,聯合再生,22,1,21,富邦-宜蘭,2023-05-11,9686
2890,永豐金,21,0,21,富邦-宜蘭,2023-05-11,9686
2344,華邦電,20,0,20,富邦-宜蘭,2023-05-11,9686
2618,長榮航,41,21,20,富邦-宜蘭,2023-05-11,9686
2409,友達,22,2,20,富邦-宜蘭,2023-05-11,9686
6167,久正,20,0,20,富邦-宜蘭,2023-05-11,9686
3202,樺晟,22,3,19,富邦-宜蘭,2023-05-11,9686
00900,富邦特選高股息30,18,1,17,富邦-宜蘭,2023-05-11,9686
4541,晟田,17,1,16,富邦-宜蘭,2023-05-11,9686
3038,全台,16,0,16,富邦-宜蘭,2023-05-11,9686
6285,啟��,48,34,14,富邦-宜蘭,2023-05-11,9686
3481,群創,17,3,14,富邦-宜蘭,2023-05-11,9686
8403,盛弘,14,0,14,富邦-宜蘭,2023-05-11,9686
1701,中化,12,0,12,富邦-宜蘭,2023-05-11,9686
3058,立德,13,2,11,富邦-宜蘭,2023-05-11,9686
6456,GIS-KY,11,0,11,富邦-宜蘭,2023-05-11,9686
1611,中電,10,0,10,富邦-宜蘭,2023-05-11,9686
3441,聯一光,10,0,10,富邦-宜蘭,2023-05-11,9686
4979,華星光,27,17,10,富邦-宜蘭,2023-05-11,9686
6173,信昌電,11,1,10,富邦-宜蘭,2023-05-11,9686
2889,國票金,11,1,10,富邦-宜蘭,2023-05-11,9686
1727,中華化,10,0,10,富邦-宜蘭,2023-05-11,9686
00687B,國泰20年美債,10,0,10,富邦-宜蘭,2023-05-11,9686
1762,中化生,13,3,10,富邦-宜蘭,2023-05-11,9686
00857B,永豐20年美公債,10,0,10,富邦-宜蘭,2023-05-11,9686
6508,惠光,10,0,10,富邦-宜蘭,2023-05-11,9686
6116,彩晶,30,20,10,富邦-宜蘭,2023-05-11,9686
2886,兆豐金,10,0,10,富邦-宜蘭,2023-05-11,9686
6698,旭暉應材,10,0,10,富邦-宜蘭,2023-05-11,9686
6109,亞元,9,0,9,富邦-宜蘭,2023-05-11,9686
2337,旺宏,10,1,9,富邦-宜蘭,2023-05-11,9686
4927,泰鼎-KY,9,0,9,富邦-宜蘭,2023-05-11,9686
2066,世德,12,3,9,富邦-宜蘭,2023-05-11,9686
00715L,期街口布蘭特正2,149,35,114,富邦-宜蘭,2023-05-12,9686
2888,新光金,105,0,105,富邦-宜蘭,2023-05-12,9686
2867,三商壽,100,1,99,富邦-宜蘭,2023-05-12,9686
2317,鴻海,81,3,78,富邦-宜蘭,2023-05-12,9686
2890,永豐金,46,2,44,富邦-宜蘭,2023-05-12,9686
4207,環泰,31,0,31,富邦-宜蘭,2023-05-12,9686
1701,中化,30,0,30,富邦-宜蘭,2023-05-12,9686
2610,華航,27,3,24,富邦-宜蘭,2023-05-12,9686
3481,群創,22,0,22,富邦-宜蘭,2023-05-12,9686
2880,華南金,22,0,22,富邦-宜蘭,2023-05-12,9686
4128,中天,22,0,22,富邦-宜蘭,2023-05-12,9686
2882,國泰金,21,0,21,富邦-宜蘭,2023-05-12,9686
6142,友勁,20,0,20,富邦-宜蘭,2023-05-12,9686
2066,世德,20,0,20,富邦-宜蘭,2023-05-12,9686
1810,和成,17,0,17,富邦-宜蘭,2023-05-12,9686
1101,台泥,24,8,16,富邦-宜蘭,2023-05-12,9686
2542,興富發,33,20,13,富邦-宜蘭,2023-05-12,9686
1722,台肥,13,0,13,富邦-宜蘭,2023-05-12,9686
1444,力麗,12,0,12,富邦-宜蘭,2023-05-12,9686
6244,茂迪,14,2,12,富邦-宜蘭,2023-05-12,9686
2630,亞航,15,4,11,富邦-宜蘭,2023-05-12,9686
3592,瑞鼎,11,0,11,富邦-宜蘭,2023-05-12,9686
2881,富邦金,11,0,11,富邦-宜蘭,2023-05-12,9686
00878,國泰永續高股息,32,21,11,富邦-宜蘭,2023-05-12,9686
6116,彩晶,10,0,10,富邦-宜蘭,2023-05-12,9686
1504,東元,13,3,10,富邦-宜蘭,2023-05-12,9686
6770,力積電,10,0,10,富邦-宜蘭,2023-05-12,9686
2331,精英,10,0,10,富邦-宜蘭,2023-05-12,9686
2387,精元,12,2,10,富邦-宜蘭,2023-05-12,9686
3322,建舜電,10,0,10,富邦-宜蘭,2023-05-12,9686
2023,燁輝,10,0,10,富邦-宜蘭,2023-05-12,9686
00753L,中信中國50正2,13,3,10,富邦-宜蘭,2023-05-12,9686
2891,中信金,11,1,10,富邦-宜蘭,2023-05-12,9686
1708,東鹼,10,1,9,富邦-宜蘭,2023-05-12,9686
00642U,期元大S＆P石油,9,0,9,富邦-宜蘭,2023-05-12,9686
4916,事欣科,13,4,9,富邦-宜蘭,2023-05-12,9686
00713,元大台灣高息低波,10,2,8,富邦-宜蘭,2023-05-12,9686
00712,復華富時不動產,8,0,8,富邦-宜蘭,2023-05-12,9686
5388,中磊,8,0,8,富邦-宜蘭,2023-05-12,9686
2482,連宇,9,1,8,富邦-宜蘭,2023-05-12,9686
4744,皇將,12,4,8,富邦-宜蘭,2023-05-12,9686
2421,建準,10,3,7,富邦-宜蘭,2023-05-12,9686
3324,雙鴻,7,1,6,富邦-宜蘭,2023-05-12,9686
6761,穩得,6,0,6,富邦-宜蘭,2023-05-12,9686
5531,鄉林,21,15,6,富邦-宜蘭,2023-05-12,9686
4168,醣聯,6,0,6,富邦-宜蘭,2023-05-12,9686
1312,國喬,6,0,6,富邦-宜蘭,2023-05-12,9686
6160,欣技,22,16,6,富邦-宜蘭,2023-05-12,9686
1608,華榮,14,8,6,富邦-宜蘭,2023-05-12,9686
1310,台苯,8,2,6,富邦-宜蘭,2023-05-12,9686
2303,聯電,91,11,80,富邦-宜蘭,2023-05-15,9686
8076,伍豐,83,7,76,富邦-宜蘭,2023-05-15,9686
6770,力積電,67,6,61,富邦-宜蘭,2023-05-15,9686
8049,晶采,54,0,54,富邦-宜蘭,2023-05-15,9686
00878,國泰永續高股息,71,19,52,富邦-宜蘭,2023-05-15,9686
3046,建��,55,9,46,富邦-宜蘭,2023-05-15,9686
00715L,期街口布蘭特正2,59,15,44,富邦-宜蘭,2023-05-15,9686
3231,緯創,32,4,28,富邦-宜蘭,2023-05-15,9686
3712,永崴投控,25,3,22,富邦-宜蘭,2023-05-15,9686
2886,兆豐金,20,0,20,富邦-宜蘭,2023-05-15,9686
3202,樺晟,36,17,19,富邦-宜蘭,2023-05-15,9686
1101,台泥,16,0,16,富邦-宜蘭,2023-05-15,9686
6185,幃翔,15,0,15,富邦-宜蘭,2023-05-15,9686
1722,台肥,14,0,14,富邦-宜蘭,2023-05-15,9686
8404,百和興業-KY,14,0,14,富邦-宜蘭,2023-05-15,9686
3038,全台,13,0,13,富邦-宜蘭,2023-05-15,9686
1609,大亞,20,7,13,富邦-宜蘭,2023-05-15,9686
1710,東聯,15,3,12,富邦-宜蘭,2023-05-15,9686
2457,飛宏,19,8,11,富邦-宜蘭,2023-05-15,9686
2617,台航,10,0,10,富邦-宜蘭,2023-05-15,9686
1536,和大,10,0,10,富邦-宜蘭,2023-05-15,9686
2897,王道銀行,10,0,10,富邦-宜蘭,2023-05-15,9686
00690,兆豐藍籌30,10,0,10,富邦-宜蘭,2023-05-15,9686
00753L,中信中國50正2,20,10,10,富邦-宜蘭,2023-05-15,9686
2027,大成鋼,8,0,8,富邦-宜蘭,2023-05-15,9686
6235,華孚,13,5,8,富邦-宜蘭,2023-05-15,9686
3481,群創,10,2,8,富邦-宜蘭,2023-05-15,9686
3704,合勤控,7,0,7,富邦-宜蘭,2023-05-15,9686
00687B,國泰20年美債,7,0,7,富邦-宜蘭,2023-05-15,9686
2382,廣達,7,0,7,富邦-宜蘭,2023-05-15,9686
6122,擎邦,17,10,7,富邦-宜蘭,2023-05-15,9686
1708,東鹼,7,0,7,富邦-宜蘭,2023-05-15,9686
3149,正達,6,0,6,富邦-宜蘭,2023-05-15,9686
1529,樂事綠能,9,3,6,富邦-宜蘭,2023-05-15,9686
4979,華星光,13,7,6,富邦-宜蘭,2023-05-15,9686
2820,華票,6,0,6,富邦-宜蘭,2023-05-15,9686
9928,中視,8,2,6,富邦-宜蘭,2023-05-15,9686
1514,亞力,6,0,6,富邦-宜蘭,2023-05-15,9686
1720,生達,6,0,6,富邦-宜蘭,2023-05-15,9686
00680L,元大美債20正2,6,0,6,富邦-宜蘭,2023-05-15,9686
00720B,元大投資級公司債,5,0,5,富邦-宜蘭,2023-05-15,9686
2453,凌群,5,0,5,富邦-宜蘭,2023-05-15,9686
2542,興富發,12,7,5,富邦-宜蘭,2023-05-15,9686
00712,復華富時不動產,5,0,5,富邦-宜蘭,2023-05-15,9686
2009,第一銅,5,0,5,富邦-宜蘭,2023-05-15,9686
5498,凱崴,5,0,5,富邦-宜蘭,2023-05-15,9686
3558,神準,6,1,5,富邦-宜蘭,2023-05-15,9686
6761,穩得,5,0,5,富邦-宜蘭,2023-05-15,9686
1312,國喬,5,0,5,富邦-宜蘭,2023-05-15,9686
3356,奇偶,5,0,5,富邦-宜蘭,2023-05-15,9686
1709,和益,115,0,115,富邦-宜蘭,2023-05-16,9686
2356,英業達,78,16,62,富邦-宜蘭,2023-05-16,9686
2409,友達,65,3,62,富邦-宜蘭,2023-05-16,9686
2323,中環,83,25,58,富邦-宜蘭,2023-05-16,9686
00772B,中信高評級公司債,56,0,56,富邦-宜蘭,2023-05-16,9686
00632R,元大台灣50反1,56,0,56,富邦-宜蘭,2023-05-16,9686
00679B,元大美債20年,39,4,35,富邦-宜蘭,2023-05-16,9686
1609,大亞,41,6,35,富邦-宜蘭,2023-05-16,9686
00687B,國泰20年美債,28,0,28,富邦-宜蘭,2023-05-16,9686
00773B,中信優先金融債,30,7,23,富邦-宜蘭,2023-05-16,9686
00795B,中信美國公債20年,20,0,20,富邦-宜蘭,2023-05-16,9686
2491,吉祥全,20,1,19,富邦-宜蘭,2023-05-16,9686
00751B,元大AAA至A公司債,17,0,17,富邦-宜蘭,2023-05-16,9686
6160,欣技,19,2,17,富邦-宜蘭,2023-05-16,9686
2371,大同,25,9,16,富邦-宜蘭,2023-05-16,9686
00720B,元大投資級公司債,14,0,14,富邦-宜蘭,2023-05-16,9686
4919,新唐,14,0,14,富邦-宜蘭,2023-05-16,9686
1504,東元,30,16,14,富邦-宜蘭,2023-05-16,9686
00680L,元大美債20正2,12,0,12,富邦-宜蘭,2023-05-16,9686
2603,長榮,11,0,11,富邦-宜蘭,2023-05-16,9686
2317,鴻海,11,0,11,富邦-宜蘭,2023-05-16,9686
2208,台船,12,2,10,富邦-宜蘭,2023-05-16,9686
3010,華立,10,0,10,富邦-宜蘭,2023-05-16,9686
3591,艾笛森,10,0,10,富邦-宜蘭,2023-05-16,9686
2929,淘帝-KY,10,0,10,富邦-宜蘭,2023-05-16,9686
00673R,期元大S＆P原油反1,10,0,10,富邦-宜蘭,2023-05-16,9686
4908,前鼎,10,0,10,富邦-宜蘭,2023-05-16,9686
1312,國喬,10,0,10,富邦-宜蘭,2023-05-16,9686
2206,三陽工業,11,1,10,富邦-宜蘭,2023-05-16,9686
2633,台灣高鐵,11,2,9,富邦-宜蘭,2023-05-16,9686
2736,富野,12,3,9,富邦-宜蘭,2023-05-16,9686
8426,紅木-KY,11,2,9,富邦-宜蘭,2023-05-16,9686
3231,緯創,15,8,7,富邦-宜蘭,2023-05-16,9686
3163,波若威,8,1,7,富邦-宜蘭,2023-05-16,9686
6741,91APP*-KY,8,1,7,富邦-宜蘭,2023-05-16,9686
6279,胡連,6,0,6,富邦-宜蘭,2023-05-16,9686
5321,美而快,7,1,6,富邦-宜蘭,2023-05-16,9686
1319,東陽,6,0,6,富邦-宜蘭,2023-05-16,9686
6547,高端疫苗,6,0,6,富邦-宜蘭,2023-05-16,9686
2548,華固,5,0,5,富邦-宜蘭,2023-05-16,9686
2745,五福,6,1,5,富邦-宜蘭,2023-05-16,9686
2313,華通,5,0,5,富邦-宜蘭,2023-05-16,9686
2312,金寶,5,0,5,富邦-宜蘭,2023-05-16,9686
3712,永崴投控,5,0,5,富邦-宜蘭,2023-05-16,9686
1444,力麗,5,0,5,富邦-宜蘭,2023-05-16,9686
6173,信昌電,5,0,5,富邦-宜蘭,2023-05-16,9686
6122,擎邦,16,11,5,富邦-宜蘭,2023-05-16,9686
3058,立德,5,0,5,富邦-宜蘭,2023-05-16,9686
6134,萬旭,5,0,5,富邦-宜蘭,2023-05-16,9686
2368,金像電,4,0,4,富邦-宜蘭,2023-05-16,9686
00632R,元大台灣50反1,1132,0,1132,富邦-宜蘭,2023-05-17,9686
6216,居易,100,0,100,富邦-宜蘭,2023-05-17,9686
00680L,元大美債20正2,57,0,57,富邦-宜蘭,2023-05-17,9686
4173,久裕,39,0,39,富邦-宜蘭,2023-05-17,9686
3202,樺晟,38,2,36,富邦-宜蘭,2023-05-17,9686
1337,再生-KY,32,2,30,富邦-宜蘭,2023-05-17,9686
1608,華榮,30,0,30,富邦-宜蘭,2023-05-17,9686
00795B,中信美國公債20年,26,0,26,富邦-宜蘭,2023-05-17,9686
3715,定穎投控,48,28,20,富邦-宜蘭,2023-05-17,9686
3058,立德,20,1,19,富邦-宜蘭,2023-05-17,9686
00679B,元大美債20年,18,1,17,富邦-宜蘭,2023-05-17,9686
00753L,中信中國50正2,18,2,16,富邦-宜蘭,2023-05-17,9686
1612,宏泰,24,8,16,富邦-宜蘭,2023-05-17,9686
3209,全科,12,0,12,富邦-宜蘭,2023-05-17,9686
6285,啟��,18,7,11,富邦-宜蘭,2023-05-17,9686
5302,太欣,11,0,11,富邦-宜蘭,2023-05-17,9686
3207,耀勝,32,21,11,富邦-宜蘭,2023-05-17,9686
2402,毅嘉,26,16,10,富邦-宜蘭,2023-05-17,9686
2495,普安,10,0,10,富邦-宜蘭,2023-05-17,9686
2491,吉祥全,15,5,10,富邦-宜蘭,2023-05-17,9686
1711,永光,10,0,10,富邦-宜蘭,2023-05-17,9686
2025,千興,10,0,10,富邦-宜蘭,2023-05-17,9686
7402,邑錡,18,8,10,富邦-宜蘭,2023-05-17,9686
00751B,元大AAA至A公司債,8,0,8,富邦-宜蘭,2023-05-17,9686
5225,東科-KY,8,0,8,富邦-宜蘭,2023-05-17,9686
1108,幸福,10,2,8,富邦-宜蘭,2023-05-17,9686
6770,力積電,11,3,8,富邦-宜蘭,2023-05-17,9686
1525,江申,7,0,7,富邦-宜蘭,2023-05-17,9686
2812,台中銀,7,0,7,富邦-宜蘭,2023-05-17,9686
6218,豪勉,14,7,7,富邦-宜蘭,2023-05-17,9686
00712,復華富時不動產,8,1,7,富邦-宜蘭,2023-05-17,9686
1504,東元,21,14,7,富邦-宜蘭,2023-05-17,9686
1101,台泥,6,0,6,富邦-宜蘭,2023-05-17,9686
5009,榮剛,8,2,6,富邦-宜蘭,2023-05-17,9686
1452,宏益,6,0,6,富邦-宜蘭,2023-05-17,9686
2368,金像電,10,4,6,富邦-宜蘭,2023-05-17,9686
00772B,中信高評級公司債,5,0,5,富邦-宜蘭,2023-05-17,9686
00715L,期街口布蘭特正2,5,0,5,富邦-宜蘭,2023-05-17,9686
910861,神州-DR,5,0,5,富邦-宜蘭,2023-05-17,9686
00664R,國泰臺灣加權反1,5,0,5,富邦-宜蘭,2023-05-17,9686
3265,台星科,5,0,5,富邦-宜蘭,2023-05-17,9686
1737,臺鹽,5,0,5,富邦-宜蘭,2023-05-17,9686
5347,世界,6,1,5,富邦-宜蘭,2023-05-17,9686
3059,華晶科,10,5,5,富邦-宜蘭,2023-05-17,9686
1809,中釉,5,0,5,富邦-宜蘭,2023-05-17,9686
2421,建準,10,5,5,富邦-宜蘭,2023-05-17,9686
2731,雄獅,5,0,5,富邦-宜蘭,2023-05-17,9686
1463,強盛新,5,0,5,富邦-宜蘭,2023-05-17,9686
3591,艾笛森,5,0,5,富邦-宜蘭,2023-05-17,9686
8033,雷虎,5,0,5,富邦-宜蘭,2023-05-17,9686
00632R,元大台灣50反1,511,0,511,富邦-宜蘭,2023-05-18,9686
2881,富邦金,119,52,67,富邦-宜蘭,2023-05-18,9686
2489,瑞軒,68,10,58,富邦-宜蘭,2023-05-18,9686
2897,王道銀行,50,0,50,富邦-宜蘭,2023-05-18,9686
00772B,中信高評級公司債,43,0,43,富邦-宜蘭,2023-05-18,9686
2303,聯電,53,18,35,富邦-宜蘭,2023-05-18,9686
3704,合勤控,48,14,34,富邦-宜蘭,2023-05-18,9686
00690,兆豐藍籌30,30,1,29,富邦-宜蘭,2023-05-18,9686
00751B,元大AAA至A公司債,22,0,22,富邦-宜蘭,2023-05-18,9686
2025,千興,22,0,22,富邦-宜蘭,2023-05-18,9686
00715L,期街口布蘭特正2,41,21,20,富邦-宜蘭,2023-05-18,9686
3043,科風,20,0,20,富邦-宜蘭,2023-05-18,9686
00687B,國泰20年美債,21,2,19,富邦-宜蘭,2023-05-18,9686
4168,醣聯,18,0,18,富邦-宜蘭,2023-05-18,9686
2491,吉祥全,20,6,14,富邦-宜蘭,2023-05-18,9686
2402,毅嘉,14,1,13,富邦-宜蘭,2023-05-18,9686
3022,威強電,16,3,13,富邦-宜蘭,2023-05-18,9686
2630,亞航,22,9,13,富邦-宜蘭,2023-05-18,9686
3202,樺晟,14,1,13,富邦-宜蘭,2023-05-18,9686
1101,台泥,19,7,12,富邦-宜蘭,2023-05-18,9686
3207,耀勝,19,7,12,富邦-宜蘭,2023-05-18,9686
5310,天剛,13,2,11,富邦-宜蘭,2023-05-18,9686
1514,亞力,41,30,11,富邦-宜蘭,2023-05-18,9686
6244,茂迪,23,12,11,富邦-宜蘭,2023-05-18,9686
2356,英業達,11,1,10,富邦-宜蘭,2023-05-18,9686
5876,上海商銀,10,0,10,富邦-宜蘭,2023-05-18,9686
5425,台半,11,1,10,富邦-宜蘭,2023-05-18,9686
00671R,富邦NASDAQ反1,10,0,10,富邦-宜蘭,2023-05-18,9686
1617,榮星,10,0,10,富邦-宜蘭,2023-05-18,9686
3591,艾笛森,20,10,10,富邦-宜蘭,2023-05-18,9686
8426,紅木-KY,12,2,10,富邦-宜蘭,2023-05-18,9686
2486,一詮,10,0,10,富邦-宜蘭,2023-05-18,9686
1721,三晃,10,0,10,富邦-宜蘭,2023-05-18,9686
8227,巨有科技,9,0,9,富邦-宜蘭,2023-05-18,9686
6584,南俊國際,10,1,9,富邦-宜蘭,2023-05-18,9686
1584,精剛,10,1,9,富邦-宜蘭,2023-05-18,9686
8076,伍豐,23,14,9,富邦-宜蘭,2023-05-18,9686
2929,淘帝-KY,8,0,8,富邦-宜蘭,2023-05-18,9686
5230,雷笛克光學,8,0,8,富邦-宜蘭,2023-05-18,9686
2736,富野,8,0,8,富邦-宜蘭,2023-05-18,9686
2615,萬海,7,0,7,富邦-宜蘭,2023-05-18,9686
2537,聯上發,7,0,7,富邦-宜蘭,2023-05-18,9686
6770,力積電,10,3,7,富邦-宜蘭,2023-05-18,9686
5531,鄉林,10,3,7,富邦-宜蘭,2023-05-18,9686
3006,晶豪科,19,12,7,富邦-宜蘭,2023-05-18,9686
00795B,中信美國公債20年,6,0,6,富邦-宜蘭,2023-05-18,9686
6188,廣明,6,0,6,富邦-宜蘭,2023-05-18,9686
6508,惠光,6,0,6,富邦-宜蘭,2023-05-18,9686
6550,北極星藥業-KY,6,0,6,富邦-宜蘭,2023-05-18,9686
1440,南紡,6,0,6,富邦-宜蘭,2023-05-18,9686
00690,兆豐藍籌30,439,2,437,富邦-宜蘭,2023-05-19,9686
00753L,中信中國50正2,47,0,47,富邦-宜蘭,2023-05-19,9686
3029,零壹,82,51,31,富邦-宜蘭,2023-05-19,9686
2453,凌群,31,1,30,富邦-宜蘭,2023-05-19,9686
8097,常珵,33,4,29,富邦-宜蘭,2023-05-19,9686
1776,展宇,28,0,28,富邦-宜蘭,2023-05-19,9686
00680L,元大美債20正2,28,0,28,富邦-宜蘭,2023-05-19,9686
9946,三發地產,25,0,25,富邦-宜蘭,2023-05-19,9686
1216,統一,25,0,25,富邦-宜蘭,2023-05-19,9686
5009,榮剛,33,8,25,富邦-宜蘭,2023-05-19,9686
00715L,期街口布蘭特正2,25,1,24,富邦-宜蘭,2023-05-19,9686
00665L,富邦�琤肭磪囓�2,22,0,22,富邦-宜蘭,2023-05-19,9686
00671R,富邦NASDAQ反1,20,0,20,富邦-宜蘭,2023-05-19,9686
1312,國喬,20,0,20,富邦-宜蘭,2023-05-19,9686
00637L,元大滬深300正2,22,4,18,富邦-宜蘭,2023-05-19,9686
3043,科風,20,2,18,富邦-宜蘭,2023-05-19,9686
00795B,中信美國公債20年,18,0,18,富邦-宜蘭,2023-05-19,9686
00687B,國泰20年美債,16,0,16,富邦-宜蘭,2023-05-19,9686
2025,千興,15,0,15,富邦-宜蘭,2023-05-19,9686
00772B,中信高評級公司債,14,0,14,富邦-宜蘭,2023-05-19,9686
2399,映泰,36,22,14,富邦-宜蘭,2023-05-19,9686
00679B,元大美債20年,25,12,13,富邦-宜蘭,2023-05-19,9686
2457,飛宏,17,5,12,富邦-宜蘭,2023-05-19,9686
6218,豪勉,14,2,12,富邦-宜蘭,2023-05-19,9686
2890,永豐金,13,1,12,富邦-宜蘭,2023-05-19,9686
4908,前鼎,12,0,12,富邦-宜蘭,2023-05-19,9686
1514,亞力,20,8,12,富邦-宜蘭,2023-05-19,9686
1519,華城,58,46,12,富邦-宜蘭,2023-05-19,9686
00712,復華富時不動產,11,0,11,富邦-宜蘭,2023-05-19,9686
1513,中興電,21,10,11,富邦-宜蘭,2023-05-19,9686
2402,毅嘉,22,11,11,富邦-宜蘭,2023-05-19,9686
8048,德勝,11,0,11,富邦-宜蘭,2023-05-19,9686
8069,元太,12,1,11,富邦-宜蘭,2023-05-19,9686
3712,永崴投控,10,0,10,富邦-宜蘭,2023-05-19,9686
6558,興能高,10,0,10,富邦-宜蘭,2023-05-19,9686
2401,凌陽,10,0,10,富邦-宜蘭,2023-05-19,9686
00720B,元大投資級公司債,9,0,9,富邦-宜蘭,2023-05-19,9686
3380,明泰,9,0,9,富邦-宜蘭,2023-05-19,9686
8403,盛弘,9,0,9,富邦-宜蘭,2023-05-19,9686
2537,聯上發,8,0,8,富邦-宜蘭,2023-05-19,9686
00853B,統一美債10年Aa-,8,0,8,富邦-宜蘭,2023-05-19,9686
6243,迅杰,8,0,8,富邦-宜蘭,2023-05-19,9686
00696B,富邦美債20年,8,0,8,富邦-宜蘭,2023-05-19,9686
6266,泰詠,10,2,8,富邦-宜蘭,2023-05-19,9686
2471,資通,11,4,7,富邦-宜蘭,2023-05-19,9686
6173,信昌電,8,1,7,富邦-宜蘭,2023-05-19,9686
2002,中鋼,7,0,7,富邦-宜蘭,2023-05-19,9686
3202,樺晟,8,2,6,富邦-宜蘭,2023-05-19,9686
3704,合勤控,8,2,6,富邦-宜蘭,2023-05-19,9686
8426,紅木-KY,20,14,6,富邦-宜蘭,2023-05-19,9686
2489,瑞軒,202,0,202,富邦-宜蘭,2023-05-22,9686
00885,富邦越南,124,2,122,富邦-宜蘭,2023-05-22,9686
2303,聯電,106,0,106,富邦-宜蘭,2023-05-22,9686
2890,永豐金,48,1,47,富邦-宜蘭,2023-05-22,9686
00679B,元大美債20年,40,6,34,富邦-宜蘭,2023-05-22,9686
00715L,期街口布蘭特正2,36,5,31,富邦-宜蘭,2023-05-22,9686
6233,旺玖,31,1,30,富邦-宜蘭,2023-05-22,9686
4157,太景*-KY,25,0,25,富邦-宜蘭,2023-05-22,9686
1595,川寶,26,1,25,富邦-宜蘭,2023-05-22,9686
00878,國泰永續高股息,39,16,23,富邦-宜蘭,2023-05-22,9686
2323,中環,52,30,22,富邦-宜蘭,2023-05-22,9686
2427,三商電,46,24,22,富邦-宜蘭,2023-05-22,9686
00773B,中信優先金融債,22,0,22,富邦-宜蘭,2023-05-22,9686
3037,欣興,26,4,22,富邦-宜蘭,2023-05-22,9686
4564,元翎,22,1,21,富邦-宜蘭,2023-05-22,9686
6235,華孚,26,5,21,富邦-宜蘭,2023-05-22,9686
6282,康舒,38,17,21,富邦-宜蘭,2023-05-22,9686
5425,台半,22,2,20,富邦-宜蘭,2023-05-22,9686
00720B,元大投資級公司債,22,2,20,富邦-宜蘭,2023-05-22,9686
8933,愛地雅,20,0,20,富邦-宜蘭,2023-05-22,9686
2025,千興,20,2,18,富邦-宜蘭,2023-05-22,9686
1711,永光,20,3,17,富邦-宜蘭,2023-05-22,9686
00687B,國泰20年美債,17,0,17,富邦-宜蘭,2023-05-22,9686
2368,金像電,62,46,16,富邦-宜蘭,2023-05-22,9686
5009,榮剛,15,2,13,富邦-宜蘭,2023-05-22,9686
2421,建準,20,8,12,富邦-宜蘭,2023-05-22,9686
2888,新光金,12,0,12,富邦-宜蘭,2023-05-22,9686
3058,立德,11,0,11,富邦-宜蘭,2023-05-22,9686
1312,國喬,10,0,10,富邦-宜蘭,2023-05-22,9686
3078,僑威,11,1,10,富邦-宜蘭,2023-05-22,9686
9105,泰金寶-DR,10,0,10,富邦-宜蘭,2023-05-22,9686
2615,萬海,10,0,10,富邦-宜蘭,2023-05-22,9686
5701,劍湖山,10,0,10,富邦-宜蘭,2023-05-22,9686
00751B,元大AAA至A公司債,10,0,10,富邦-宜蘭,2023-05-22,9686
1434,福懋,10,0,10,富邦-宜蘭,2023-05-22,9686
5243,乙盛-KY,24,15,9,富邦-宜蘭,2023-05-22,9686
6243,迅杰,17,8,9,富邦-宜蘭,2023-05-22,9686
00772B,中信高評級公司債,8,0,8,富邦-宜蘭,2023-05-22,9686
3022,威強電,9,1,8,富邦-宜蘭,2023-05-22,9686
00632R,元大台灣50反1,8,0,8,富邦-宜蘭,2023-05-22,9686
1504,東元,38,30,8,富邦-宜蘭,2023-05-22,9686
2442,新美齊,18,10,8,富邦-宜蘭,2023-05-22,9686
2881,富邦金,12,4,8,富邦-宜蘭,2023-05-22,9686
00888,永豐台灣ESG,8,1,7,富邦-宜蘭,2023-05-22,9686
6697,東捷資訊,7,0,7,富邦-宜蘭,2023-05-22,9686
00712,復華富時不動產,7,0,7,富邦-宜蘭,2023-05-22,9686
4173,久裕,8,1,7,富邦-宜蘭,2023-05-22,9686
6191,精成科,8,1,7,富邦-宜蘭,2023-05-22,9686
8059,凱碩,7,0,7,富邦-宜蘭,2023-05-22,9686
2371,大同,6,0,6,富邦-宜蘭,2023-05-22,9686
2897,王道銀行,380,0,380,富邦-宜蘭,2023-05-23,9686
00857B,永豐20年美公債,102,0,102,富邦-宜蘭,2023-05-23,9686
2371,大同,93,0,93,富邦-宜蘭,2023-05-23,9686
6216,居易,93,0,93,富邦-宜蘭,2023-05-23,9686
3664,安瑞-KY,83,0,83,富邦-宜蘭,2023-05-23,9686
00687B,國泰20年美債,77,0,77,富邦-宜蘭,2023-05-23,9686
2913,農林,59,5,54,富邦-宜蘭,2023-05-23,9686
8097,常珵,30,0,30,富邦-宜蘭,2023-05-23,9686
1711,永光,30,2,28,富邦-宜蘭,2023-05-23,9686
00673R,期元大S＆P原油反1,52,25,27,富邦-宜蘭,2023-05-23,9686
1513,中興電,31,6,25,富邦-宜蘭,2023-05-23,9686
8403,盛弘,25,1,24,富邦-宜蘭,2023-05-23,9686
1504,東元,47,25,22,富邦-宜蘭,2023-05-23,9686
5531,鄉林,32,10,22,富邦-宜蘭,2023-05-23,9686
1708,東鹼,21,0,21,富邦-宜蘭,2023-05-23,9686
5512,力麒,20,0,20,富邦-宜蘭,2023-05-23,9686
2425,承啟,18,0,18,富邦-宜蘭,2023-05-23,9686
2368,金像電,20,2,18,富邦-宜蘭,2023-05-23,9686
6535,順藥,18,1,17,富邦-宜蘭,2023-05-23,9686
00753L,中信中國50正2,17,0,17,富邦-宜蘭,2023-05-23,9686
3481,群創,18,1,17,富邦-宜蘭,2023-05-23,9686
2465,麗臺,18,1,17,富邦-宜蘭,2023-05-23,9686
3058,立德,17,1,16,富邦-宜蘭,2023-05-23,9686
1721,三晃,16,0,16,富邦-宜蘭,2023-05-23,9686
1810,和成,15,0,15,富邦-宜蘭,2023-05-23,9686
2705,六福,27,14,13,富邦-宜蘭,2023-05-23,9686
4909,新復興,16,3,13,富邦-宜蘭,2023-05-23,9686
3576,聯合再生,15,3,12,富邦-宜蘭,2023-05-23,9686
1584,精剛,15,3,12,富邦-宜蘭,2023-05-23,9686
1219,福壽,11,0,11,富邦-宜蘭,2023-05-23,9686
4919,新唐,11,0,11,富邦-宜蘭,2023-05-23,9686
00715L,期街口布蘭特正2,14,3,11,富邦-宜蘭,2023-05-23,9686
2731,雄獅,15,5,10,富邦-宜蘭,2023-05-23,9686
5351,鈺創,12,2,10,富邦-宜蘭,2023-05-23,9686
3552,同致,10,0,10,富邦-宜蘭,2023-05-23,9686
6118,建達,11,1,10,富邦-宜蘭,2023-05-23,9686
2421,建準,17,8,9,富邦-宜蘭,2023-05-23,9686
5388,中磊,10,1,9,富邦-宜蘭,2023-05-23,9686
6547,高端疫苗,10,1,9,富邦-宜蘭,2023-05-23,9686
2881,富邦金,12,4,8,富邦-宜蘭,2023-05-23,9686
6244,茂迪,8,0,8,富邦-宜蘭,2023-05-23,9686
5876,上海商銀,7,0,7,富邦-宜蘭,2023-05-23,9686
3202,樺晟,10,3,7,富邦-宜蘭,2023-05-23,9686
6799,來頡,8,1,7,富邦-宜蘭,2023-05-23,9686
00679B,元大美債20年,9,2,7,富邦-宜蘭,2023-05-23,9686
2201,裕隆,17,10,7,富邦-宜蘭,2023-05-23,9686
6443,元晶,7,0,7,富邦-宜蘭,2023-05-23,9686
00795B,中信美國公債20年,6,0,6,富邦-宜蘭,2023-05-23,9686
2603,長榮,6,0,6,富邦-宜蘭,2023-05-23,9686
1802,台玻,8,2,6,富邦-宜蘭,2023-05-23,9686
00885,富邦越南,107,0,107,富邦-宜蘭,2023-05-24,9686
00687B,國泰20年美債,62,0,62,富邦-宜蘭,2023-05-24,9686
00900,富邦特選高股息30,60,5,55,富邦-宜蘭,2023-05-24,9686
00679B,元大美債20年,58,3,55,富邦-宜蘭,2023-05-24,9686
6535,順藥,51,6,45,富邦-宜蘭,2023-05-24,9686
2305,全友,47,2,45,富邦-宜蘭,2023-05-24,9686
2399,映泰,67,29,38,富邦-宜蘭,2023-05-24,9686
2611,志信,35,0,35,富邦-宜蘭,2023-05-24,9686
1809,中釉,41,9,32,富邦-宜蘭,2023-05-24,9686
3060,銘異,30,0,30,富邦-宜蘭,2023-05-24,9686
1701,中化,30,0,30,富邦-宜蘭,2023-05-24,9686
00751B,元大AAA至A公司債,26,0,26,富邦-宜蘭,2023-05-24,9686
00637L,元大滬深300正2,26,2,24,富邦-宜蘭,2023-05-24,9686
1711,永光,30,7,23,富邦-宜蘭,2023-05-24,9686
5905,南仁湖,43,21,22,富邦-宜蘭,2023-05-24,9686
2371,大同,20,1,19,富邦-宜蘭,2023-05-24,9686
00882,中信中國高股息,19,0,19,富邦-宜蘭,2023-05-24,9686
00857B,永豐20年美公債,16,0,16,富邦-宜蘭,2023-05-24,9686
00665L,富邦�琤肭磪囓�2,15,0,15,富邦-宜蘭,2023-05-24,9686
00772B,中信高評級公司債,15,0,15,富邦-宜蘭,2023-05-24,9686
5009,榮剛,31,17,14,富邦-宜蘭,2023-05-24,9686
1519,華城,14,1,13,富邦-宜蘭,2023-05-24,9686
2409,友達,18,5,13,富邦-宜蘭,2023-05-24,9686
3664,安瑞-KY,13,0,13,富邦-宜蘭,2023-05-24,9686
2892,第一金,13,0,13,富邦-宜蘭,2023-05-24,9686
1785,光洋科,13,1,12,富邦-宜蘭,2023-05-24,9686
00720B,元大投資級公司債,12,0,12,富邦-宜蘭,2023-05-24,9686
00891,中信關鍵半導體,12,0,12,富邦-宜蘭,2023-05-24,9686
00680L,元大美債20正2,12,0,12,富邦-宜蘭,2023-05-24,9686
5512,力麒,15,4,11,富邦-宜蘭,2023-05-24,9686
2337,旺宏,10,0,10,富邦-宜蘭,2023-05-24,9686
4560,強信-KY,10,0,10,富邦-宜蘭,2023-05-24,9686
1802,台玻,10,0,10,富邦-宜蘭,2023-05-24,9686
2340,台亞,10,0,10,富邦-宜蘭,2023-05-24,9686
00664R,國泰臺灣加權反1,10,0,10,富邦-宜蘭,2023-05-24,9686
2066,世德,10,0,10,富邦-宜蘭,2023-05-24,9686
1218,泰山,10,0,10,富邦-宜蘭,2023-05-24,9686
00725B,國泰投資級公司債,9,0,9,富邦-宜蘭,2023-05-24,9686
4566,時碩工業,9,0,9,富邦-宜蘭,2023-05-24,9686
9958,世紀鋼,9,0,9,富邦-宜蘭,2023-05-24,9686
4971,IET-KY,8,0,8,富邦-宜蘭,2023-05-24,9686
1102,亞泥,8,0,8,富邦-宜蘭,2023-05-24,9686
1810,和成,8,0,8,富邦-宜蘭,2023-05-24,9686
2834,臺企銀,8,0,8,富邦-宜蘭,2023-05-24,9686
1101,台泥,7,0,7,富邦-宜蘭,2023-05-24,9686
6216,居易,7,0,7,富邦-宜蘭,2023-05-24,9686
3041,揚智,9,2,7,富邦-宜蘭,2023-05-24,9686
5321,美而快,9,3,6,富邦-宜蘭,2023-05-24,9686
2888,新光金,8,2,6,富邦-宜蘭,2023-05-24,9686
1504,東元,20,14,6,富邦-宜蘭,2023-05-24,9686
00753L,中信中國50正2,50,0,50,富邦-宜蘭,2023-05-25,9686
00637L,元大滬深300正2,46,4,42,富邦-宜蘭,2023-05-25,9686
00907,永豐優息存股,35,0,35,富邦-宜蘭,2023-05-25,9686
1608,華榮,37,4,33,富邦-宜蘭,2023-05-25,9686
2736,富野,46,13,33,富邦-宜蘭,2023-05-25,9686
6234,高僑,35,3,32,富邦-宜蘭,2023-05-25,9686
2367,燿華,31,0,31,富邦-宜蘭,2023-05-25,9686
2614,東森,27,0,27,富邦-宜蘭,2023-05-25,9686
00882,中信中國高股息,33,7,26,富邦-宜蘭,2023-05-25,9686
9946,三發地產,25,0,25,富邦-宜蘭,2023-05-25,9686
3013,晟銘電,31,7,24,富邦-宜蘭,2023-05-25,9686
2892,第一金,24,0,24,富邦-宜蘭,2023-05-25,9686
1504,東元,46,22,24,富邦-宜蘭,2023-05-25,9686
00632R,元大台灣50反1,35,12,23,富邦-宜蘭,2023-05-25,9686
2303,聯電,38,16,22,富邦-宜蘭,2023-05-25,9686
8097,常珵,22,0,22,富邦-宜蘭,2023-05-25,9686
8076,伍豐,21,0,21,富邦-宜蘭,2023-05-25,9686
2340,台亞,21,0,21,富邦-宜蘭,2023-05-25,9686
2881,富邦金,21,0,21,富邦-宜蘭,2023-05-25,9686
00673R,期元大S＆P原油反1,20,0,20,富邦-宜蘭,2023-05-25,9686
1310,台苯,22,5,17,富邦-宜蘭,2023-05-25,9686
00665L,富邦�琤肭磪囓�2,15,0,15,富邦-宜蘭,2023-05-25,9686
00687B,國泰20年美債,16,2,14,富邦-宜蘭,2023-05-25,9686
3481,群創,24,11,13,富邦-宜蘭,2023-05-25,9686
00680L,元大美債20正2,15,2,13,富邦-宜蘭,2023-05-25,9686
3419,譁裕,19,6,13,富邦-宜蘭,2023-05-25,9686
3058,立德,12,0,12,富邦-宜蘭,2023-05-25,9686
3265,台星科,12,0,12,富邦-宜蘭,2023-05-25,9686
2641,正德,12,0,12,富邦-宜蘭,2023-05-25,9686
2630,亞航,56,44,12,富邦-宜蘭,2023-05-25,9686
2705,六福,11,0,11,富邦-宜蘭,2023-05-25,9686
1460,宏遠,16,5,11,富邦-宜蘭,2023-05-25,9686
1312,國喬,11,0,11,富邦-宜蘭,2023-05-25,9686
2002,中鋼,11,0,11,富邦-宜蘭,2023-05-25,9686
3011,今皓,11,0,11,富邦-宜蘭,2023-05-25,9686
2882,國泰金,12,1,11,富邦-宜蘭,2023-05-25,9686
3029,零壹,12,2,10,富邦-宜蘭,2023-05-25,9686
1474,弘裕,10,0,10,富邦-宜蘭,2023-05-25,9686
2007,燁興,10,0,10,富邦-宜蘭,2023-05-25,9686
00898,國泰基因免疫革命,10,0,10,富邦-宜蘭,2023-05-25,9686
00902,中信電池及儲能,10,0,10,富邦-宜蘭,2023-05-25,9686
2801,彰銀,10,0,10,富邦-宜蘭,2023-05-25,9686
2349,錸德,10,0,10,富邦-宜蘭,2023-05-25,9686
8048,德勝,10,0,10,富邦-宜蘭,2023-05-25,9686
00712,復華富時不動產,9,0,9,富邦-宜蘭,2023-05-25,9686
2609,陽明,9,0,9,富邦-宜蘭,2023-05-25,9686
2603,長榮,10,1,9,富邦-宜蘭,2023-05-25,9686
3664,安瑞-KY,10,1,9,富邦-宜蘭,2023-05-25,9686
1605,華新,12,3,9,富邦-宜蘭,2023-05-25,9686
1452,宏益,25,16,9,富邦-宜蘭,2023-05-25,9686
00632R,元大台灣50反1,305,70,235,富邦-宜蘭,2023-05-26,9686
2323,中環,253,61,192,富邦-宜蘭,2023-05-26,9686
1314,中石化,101,1,100,富邦-宜蘭,2023-05-26,9686
00712,復華富時不動產,77,0,77,富邦-宜蘭,2023-05-26,9686
1905,華紙,52,1,51,富邦-宜蘭,2023-05-26,9686
00715L,期街口布蘭特正2,52,5,47,富邦-宜蘭,2023-05-26,9686
2634,漢翔,45,2,43,富邦-宜蘭,2023-05-26,9686
2736,富野,74,34,40,富邦-宜蘭,2023-05-26,9686
2382,廣達,42,14,28,富邦-宜蘭,2023-05-26,9686
3481,群創,43,15,28,富邦-宜蘭,2023-05-26,9686
1810,和成,23,0,23,富邦-宜蘭,2023-05-26,9686
2537,聯上發,22,0,22,富邦-宜蘭,2023-05-26,9686
2890,永豐金,21,0,21,富邦-宜蘭,2023-05-26,9686
8038,長園科,21,0,21,富邦-宜蘭,2023-05-26,9686
2491,吉祥全,20,0,20,富邦-宜蘭,2023-05-26,9686
6589,台康生技,20,0,20,富邦-宜蘭,2023-05-26,9686
2883,凱基金,22,3,19,富邦-宜蘭,2023-05-26,9686
1584,精剛,21,2,19,富邦-宜蘭,2023-05-26,9686
3324,雙鴻,26,7,19,富邦-宜蘭,2023-05-26,9686
6190,萬泰科,39,21,18,富邦-宜蘭,2023-05-26,9686
6508,惠光,18,0,18,富邦-宜蘭,2023-05-26,9686
6125,廣運,17,1,16,富邦-宜蘭,2023-05-26,9686
00751B,元大AAA至A公司債,15,0,15,富邦-宜蘭,2023-05-26,9686
5213,亞昕,15,0,15,富邦-宜蘭,2023-05-26,9686
1312,國喬,14,0,14,富邦-宜蘭,2023-05-26,9686
3231,緯創,81,68,13,富邦-宜蘭,2023-05-26,9686
2606,裕民,13,0,13,富邦-宜蘭,2023-05-26,9686
5410,國眾,13,0,13,富邦-宜蘭,2023-05-26,9686
2881,富邦金,22,10,12,富邦-宜蘭,2023-05-26,9686
5531,鄉林,12,0,12,富邦-宜蘭,2023-05-26,9686
6235,華孚,27,15,12,富邦-宜蘭,2023-05-26,9686
6770,力積電,15,3,12,富邦-宜蘭,2023-05-26,9686
00706L,期元大S＆P日圓正2,12,0,12,富邦-宜蘭,2023-05-26,9686
3058,立德,12,1,11,富邦-宜蘭,2023-05-26,9686
6217,中探針,17,6,11,富邦-宜蘭,2023-05-26,9686
2637,慧洋-KY,13,2,11,富邦-宜蘭,2023-05-26,9686
6689,伊雲谷,13,2,11,富邦-宜蘭,2023-05-26,9686
2367,燿華,10,0,10,富邦-宜蘭,2023-05-26,9686
2706,第一店,10,0,10,富邦-宜蘭,2023-05-26,9686
1434,福懋,10,0,10,富邦-宜蘭,2023-05-26,9686
2630,亞航,21,11,10,富邦-宜蘭,2023-05-26,9686
5701,劍湖山,10,0,10,富邦-宜蘭,2023-05-26,9686
2641,正德,10,0,10,富邦-宜蘭,2023-05-26,9686
00637L,元大滬深300正2,11,1,10,富邦-宜蘭,2023-05-26,9686
2453,凌群,18,8,10,富邦-宜蘭,2023-05-26,9686
1218,泰山,10,1,9,富邦-宜蘭,2023-05-26,9686
3013,晟銘電,9,0,9,富邦-宜蘭,2023-05-26,9686
2421,建準,46,37,9,富邦-宜蘭,2023-05-26,9686
2468,華經,12,3,9,富邦-宜蘭,2023-05-26,9686
2399,映泰,33,24,9,富邦-宜蘭,2023-05-26,9686
6441,廣錠,63,1,62,富邦-宜蘭,2023-05-29,9686
9955,佳龍,54,0,54,富邦-宜蘭,2023-05-29,9686
2736,富野,48,1,47,富邦-宜蘭,2023-05-29,9686
00665L,富邦�琤肭磪囓�2,45,0,45,富邦-宜蘭,2023-05-29,9686
0056,元大高股息,80,38,42,富邦-宜蘭,2023-05-29,9686
2547,日勝生,40,0,40,富邦-宜蘭,2023-05-29,9686
5483,中美晶,50,12,38,富邦-宜蘭,2023-05-29,9686
00637L,元大滬深300正2,48,10,38,富邦-宜蘭,2023-05-29,9686
3664,安瑞-KY,37,1,36,富邦-宜蘭,2023-05-29,9686
3045,台灣大,35,0,35,富邦-宜蘭,2023-05-29,9686
4906,正文,36,1,35,富邦-宜蘭,2023-05-29,9686
00679B,元大美債20年,38,4,34,富邦-宜蘭,2023-05-29,9686
6111,大宇資,34,2,32,富邦-宜蘭,2023-05-29,9686
00715L,期街口布蘭特正2,30,0,30,富邦-宜蘭,2023-05-29,9686
1460,宏遠,40,10,30,富邦-宜蘭,2023-05-29,9686
3231,緯創,173,147,26,富邦-宜蘭,2023-05-29,9686
3508,位速,25,2,23,富邦-宜蘭,2023-05-29,9686
3025,星通,104,83,21,富邦-宜蘭,2023-05-29,9686
00687B,國泰20年美債,21,0,21,富邦-宜蘭,2023-05-29,9686
1605,華新,25,4,21,富邦-宜蘭,2023-05-29,9686
3540,曜越,27,7,20,富邦-宜蘭,2023-05-29,9686
2537,聯上發,20,0,20,富邦-宜蘭,2023-05-29,9686
6695,芯鼎,18,0,18,富邦-宜蘭,2023-05-29,9686
00713,元大台灣高息低波,25,7,18,富邦-宜蘭,2023-05-29,9686
6116,彩晶,17,1,16,富邦-宜蘭,2023-05-29,9686
00673R,期元大S＆P原油反1,16,0,16,富邦-宜蘭,2023-05-29,9686
8085,福華,16,0,16,富邦-宜蘭,2023-05-29,9686
2027,大成鋼,16,0,16,富邦-宜蘭,2023-05-29,9686
6488,環球晶,19,3,16,富邦-宜蘭,2023-05-29,9686
2002,中鋼,16,0,16,富邦-宜蘭,2023-05-29,9686
00882,中信中國高股息,18,2,16,富邦-宜蘭,2023-05-29,9686
1101,台泥,21,6,15,富邦-宜蘭,2023-05-29,9686
6218,豪勉,22,7,15,富邦-宜蘭,2023-05-29,9686
2901,欣欣,14,0,14,富邦-宜蘭,2023-05-29,9686
00680L,元大美債20正2,14,0,14,富邦-宜蘭,2023-05-29,9686
2103,台橡,14,0,14,富邦-宜蘭,2023-05-29,9686
2887,台新金,13,0,13,富邦-宜蘭,2023-05-29,9686
2382,廣達,13,0,13,富邦-宜蘭,2023-05-29,9686
2705,六福,15,2,13,富邦-宜蘭,2023-05-29,9686
910861,神州-DR,13,0,13,富邦-宜蘭,2023-05-29,9686
00720B,元大投資級公司債,12,0,12,富邦-宜蘭,2023-05-29,9686
2723,美食-KY,12,0,12,富邦-宜蘭,2023-05-29,9686
6485,點序,12,1,11,富邦-宜蘭,2023-05-29,9686
2405,輔信,12,1,11,富邦-宜蘭,2023-05-29,9686
3576,聯合再生,11,1,10,富邦-宜蘭,2023-05-29,9686
02002L,兆豐富櫃200正二N,10,0,10,富邦-宜蘭,2023-05-29,9686
2385,群光,10,0,10,富邦-宜蘭,2023-05-29,9686
6589,台康生技,10,0,10,富邦-宜蘭,2023-05-29,9686
1452,宏益,10,0,10,富邦-宜蘭,2023-05-29,9686
1752,南光,10,0,10,富邦-宜蘭,2023-05-29,9686
00664R,國泰臺灣加權反1,343,0,343,富邦-宜蘭,2023-05-30,9686
2888,新光金,119,0,119,富邦-宜蘭,2023-05-30,9686
00720B,元大投資級公司債,116,0,116,富邦-宜蘭,2023-05-30,9686
2449,京元電子,101,12,89,富邦-宜蘭,2023-05-30,9686
1319,東陽,79,0,79,富邦-宜蘭,2023-05-30,9686
2356,英業達,122,44,78,富邦-宜蘭,2023-05-30,9686
3305,昇貿,70,10,60,富邦-宜蘭,2023-05-30,9686
8059,凱碩,58,2,56,富邦-宜蘭,2023-05-30,9686
00882,中信中國高股息,55,0,55,富邦-宜蘭,2023-05-30,9686
4979,華星光,105,54,51,富邦-宜蘭,2023-05-30,9686
3032,偉訓,61,11,50,富邦-宜蘭,2023-05-30,9686
2382,廣達,58,12,46,富邦-宜蘭,2023-05-30,9686
2618,長榮航,158,115,43,富邦-宜蘭,2023-05-30,9686
2515,中工,48,5,43,富邦-宜蘭,2023-05-30,9686
1709,和益,41,0,41,富邦-宜蘭,2023-05-30,9686
00637L,元大滬深300正2,62,22,40,富邦-宜蘭,2023-05-30,9686
0056,元大高股息,52,12,40,富邦-宜蘭,2023-05-30,9686
2206,三陽工業,45,8,37,富邦-宜蘭,2023-05-30,9686
2344,華邦電,43,7,36,富邦-宜蘭,2023-05-30,9686
00665L,富邦�琤肭磪囓�2,32,0,32,富邦-宜蘭,2023-05-30,9686
2486,一詮,35,3,32,富邦-宜蘭,2023-05-30,9686
2399,映泰,47,17,30,富邦-宜蘭,2023-05-30,9686
00725B,國泰投資級公司債,29,0,29,富邦-宜蘭,2023-05-30,9686
3231,緯創,86,57,29,富邦-宜蘭,2023-05-30,9686
4906,正文,40,12,28,富邦-宜蘭,2023-05-30,9686
4916,事欣科,28,0,28,富邦-宜蘭,2023-05-30,9686
2371,大同,184,156,28,富邦-宜蘭,2023-05-30,9686
1734,杏輝,28,1,27,富邦-宜蘭,2023-05-30,9686
2002,中鋼,43,17,26,富邦-宜蘭,2023-05-30,9686
9955,佳龍,26,0,26,富邦-宜蘭,2023-05-30,9686
1409,新纖,31,5,26,富邦-宜蘭,2023-05-30,9686
3078,僑威,42,17,25,富邦-宜蘭,2023-05-30,9686
1584,精剛,31,6,25,富邦-宜蘭,2023-05-30,9686
6770,力積電,31,7,24,富邦-宜蘭,2023-05-30,9686
1810,和成,34,10,24,富邦-宜蘭,2023-05-30,9686
00715L,期街口布蘭特正2,24,0,24,富邦-宜蘭,2023-05-30,9686
3706,神達,26,2,24,富邦-宜蘭,2023-05-30,9686
6120,達運,23,0,23,富邦-宜蘭,2023-05-30,9686
1752,南光,23,0,23,富邦-宜蘭,2023-05-30,9686
3029,零壹,21,0,21,富邦-宜蘭,2023-05-30,9686
6443,元晶,24,3,21,富邦-宜蘭,2023-05-30,9686
00706L,期元大S＆P日圓正2,20,0,20,富邦-宜蘭,2023-05-30,9686
6547,高端疫苗,20,0,20,富邦-宜蘭,2023-05-30,9686
1609,大亞,27,8,19,富邦-宜蘭,2023-05-30,9686
6508,惠光,18,0,18,富邦-宜蘭,2023-05-30,9686
6223,旺矽,23,5,18,富邦-宜蘭,2023-05-30,9686
00713,元大台灣高息低波,28,10,18,富邦-宜蘭,2023-05-30,9686
2615,萬海,19,1,18,富邦-宜蘭,2023-05-30,9686
2610,華航,151,133,18,富邦-宜蘭,2023-05-30,9686
2331,精英,26,9,17,富邦-宜蘭,2023-05-30,9686
2888,新光金,635,107,528,富邦-宜蘭,2023-05-31,9686
00637L,元大滬深300正2,152,0,152,富邦-宜蘭,2023-05-31,9686
00715L,期街口布蘭特正2,141,47,94,富邦-宜蘭,2023-05-31,9686
6216,居易,83,0,83,富邦-宜蘭,2023-05-31,9686
1101,台泥,86,4,82,富邦-宜蘭,2023-05-31,9686
2328,廣宇,103,24,79,富邦-宜蘭,2023-05-31,9686
3686,達能,72,0,72,富邦-宜蘭,2023-05-31,9686
00882,中信中國高股息,57,0,57,富邦-宜蘭,2023-05-31,9686
00725B,國泰投資級公司債,53,0,53,富邦-宜蘭,2023-05-31,9686
2706,第一店,52,1,51,富邦-宜蘭,2023-05-31,9686
00753L,中信中國50正2,45,0,45,富邦-宜蘭,2023-05-31,9686
2356,英業達,89,49,40,富邦-宜蘭,2023-05-31,9686
2884,玉山金,42,2,40,富邦-宜蘭,2023-05-31,9686
00878,國泰永續高股息,40,3,37,富邦-宜蘭,2023-05-31,9686
00688L,國泰20年美債正2,35,0,35,富邦-宜蘭,2023-05-31,9686
2388,威盛,72,39,33,富邦-宜蘭,2023-05-31,9686
6161,捷波,32,1,31,富邦-宜蘭,2023-05-31,9686
00642U,期元大S＆P石油,31,0,31,富邦-宜蘭,2023-05-31,9686
2317,鴻海,37,11,26,富邦-宜蘭,2023-05-31,9686
4157,太景*-KY,44,20,24,富邦-宜蘭,2023-05-31,9686
1752,南光,24,0,24,富邦-宜蘭,2023-05-31,9686
2455,全新,24,3,21,富邦-宜蘭,2023-05-31,9686
00671R,富邦NASDAQ反1,21,0,21,富邦-宜蘭,2023-05-31,9686
8155,博智,21,0,21,富邦-宜蘭,2023-05-31,9686
3260,威剛,65,46,19,富邦-宜蘭,2023-05-31,9686
6104,創惟,20,3,17,富邦-宜蘭,2023-05-31,9686
5324,士開,17,0,17,富邦-宜蘭,2023-05-31,9686
00687B,國泰20年美債,17,0,17,富邦-宜蘭,2023-05-31,9686
3380,明泰,19,3,16,富邦-宜蘭,2023-05-31,9686
6111,大宇資,15,0,15,富邦-宜蘭,2023-05-31,9686
910861,神州-DR,15,0,15,富邦-宜蘭,2023-05-31,9686
2329,華泰,17,2,15,富邦-宜蘭,2023-05-31,9686
2206,三陽工業,89,76,13,富邦-宜蘭,2023-05-31,9686
1336,台翰,13,0,13,富邦-宜蘭,2023-05-31,9686
3532,台勝科,13,0,13,富邦-宜蘭,2023-05-31,9686
0056,元大高股息,15,3,12,富邦-宜蘭,2023-05-31,9686
2344,華邦電,26,14,12,富邦-宜蘭,2023-05-31,9686
2421,建準,22,10,12,富邦-宜蘭,2023-05-31,9686
2103,台橡,12,0,12,富邦-宜蘭,2023-05-31,9686
6485,點序,18,6,12,富邦-宜蘭,2023-05-31,9686
3231,緯創,110,99,11,富邦-宜蘭,2023-05-31,9686
2887,台新金,12,1,11,富邦-宜蘭,2023-05-31,9686
3714,富采,12,1,11,富邦-宜蘭,2023-05-31,9686
1513,中興電,20,9,11,富邦-宜蘭,2023-05-31,9686
1326,台化,11,0,11,富邦-宜蘭,2023-05-31,9686
5512,力麒,24,13,11,富邦-宜蘭,2023-05-31,9686
2603,長榮,13,2,11,富邦-宜蘭,2023-05-31,9686
2609,陽明,13,3,10,富邦-宜蘭,2023-05-31,9686
6488,環球晶,11,1,10,富邦-宜蘭,2023-05-31,9686
3346,麗清,10,0,10,富邦-宜蘭,2023-05-31,9686
3312,弘憶股,231,10,221,富邦-宜蘭,2023-06-01,9686
2365,昆盈,109,0,109,富邦-宜蘭,2023-06-01,9686
2515,中工,151,51,100,富邦-宜蘭,2023-06-01,9686
00715L,期街口布蘭特正2,111,43,68,富邦-宜蘭,2023-06-01,9686
2701,萬企,64,1,63,富邦-宜蘭,2023-06-01,9686
00878,國泰永續高股息,67,7,60,富邦-宜蘭,2023-06-01,9686
2323,中環,100,56,44,富邦-宜蘭,2023-06-01,9686
2892,第一金,42,1,41,富邦-宜蘭,2023-06-01,9686
1609,大亞,40,2,38,富邦-宜蘭,2023-06-01,9686
4564,元翎,63,25,38,富邦-宜蘭,2023-06-01,9686
1907,永豐餘,41,5,36,富邦-宜蘭,2023-06-01,9686
1810,和成,38,3,35,富邦-宜蘭,2023-06-01,9686
1608,華榮,36,3,33,富邦-宜蘭,2023-06-01,9686
2031,新光鋼,32,0,32,富邦-宜蘭,2023-06-01,9686
3059,華晶科,42,10,32,富邦-宜蘭,2023-06-01,9686
1708,東鹼,30,0,30,富邦-宜蘭,2023-06-01,9686
2609,陽明,34,6,28,富邦-宜蘭,2023-06-01,9686
00882,中信中國高股息,27,0,27,富邦-宜蘭,2023-06-01,9686
2881,富邦金,26,1,25,富邦-宜蘭,2023-06-01,9686
2371,大同,53,29,24,富邦-宜蘭,2023-06-01,9686
2303,聯電,35,12,23,富邦-宜蘭,2023-06-01,9686
6441,廣錠,22,0,22,富邦-宜蘭,2023-06-01,9686
6288,聯嘉,21,0,21,富邦-宜蘭,2023-06-01,9686
3062,建漢,23,3,20,富邦-宜蘭,2023-06-01,9686
00650L,復華香港正2,20,0,20,富邦-宜蘭,2023-06-01,9686
2441,超豐,20,0,20,富邦-宜蘭,2023-06-01,9686
6216,居易,20,0,20,富邦-宜蘭,2023-06-01,9686
2332,友訊,32,12,20,富邦-宜蘭,2023-06-01,9686
00642U,期元大S＆P石油,19,0,19,富邦-宜蘭,2023-06-01,9686
00757,統一FANG+,20,1,19,富邦-宜蘭,2023-06-01,9686
4207,環泰,19,0,19,富邦-宜蘭,2023-06-01,9686
3260,威剛,25,6,19,富邦-宜蘭,2023-06-01,9686
2486,一詮,30,12,18,富邦-宜蘭,2023-06-01,9686
0056,元大高股息,30,13,17,富邦-宜蘭,2023-06-01,9686
6202,盛群,17,1,16,富邦-宜蘭,2023-06-01,9686
2882,國泰金,17,2,15,富邦-宜蘭,2023-06-01,9686
2606,裕民,16,1,15,富邦-宜蘭,2023-06-01,9686
2637,慧洋-KY,17,2,15,富邦-宜蘭,2023-06-01,9686
8940,新天地,14,0,14,富邦-宜蘭,2023-06-01,9686
6122,擎邦,48,34,14,富邦-宜蘭,2023-06-01,9686
2356,英業達,15,1,14,富邦-宜蘭,2023-06-01,9686
00725B,國泰投資級公司債,13,0,13,富邦-宜蘭,2023-06-01,9686
2331,精英,50,37,13,富邦-宜蘭,2023-06-01,9686
1904,正隆,42,30,12,富邦-宜蘭,2023-06-01,9686
1101,台泥,17,5,12,富邦-宜蘭,2023-06-01,9686
2504,國產,12,0,12,富邦-宜蘭,2023-06-01,9686
3038,全台,16,4,12,富邦-宜蘭,2023-06-01,9686
3374,精材,12,0,12,富邦-宜蘭,2023-06-01,9686
2630,亞航,56,44,12,富邦-宜蘭,2023-06-01,9686
1513,中興電,17,6,11,富邦-宜蘭,2023-06-01,9686
6188,廣明,231,34,197,富邦-宜蘭,2023-06-02,9686
00751B,元大AAA至A公司債,133,0,133,富邦-宜蘭,2023-06-02,9686
3231,緯創,274,162,112,富邦-宜蘭,2023-06-02,9686
2352,佳世達,106,7,99,富邦-宜蘭,2023-06-02,9686
2610,華航,240,162,78,富邦-宜蘭,2023-06-02,9686
3625,西勝,70,7,63,富邦-宜蘭,2023-06-02,9686
2701,萬企,91,36,55,富邦-宜蘭,2023-06-02,9686
6169,昱泉,50,0,50,富邦-宜蘭,2023-06-02,9686
2031,新光鋼,45,0,45,富邦-宜蘭,2023-06-02,9686
8049,晶采,42,0,42,富邦-宜蘭,2023-06-02,9686
00641R,富邦日本反1,40,0,40,富邦-宜蘭,2023-06-02,9686
3047,訊舟,48,10,38,富邦-宜蘭,2023-06-02,9686
1568,倉佑,40,3,37,富邦-宜蘭,2023-06-02,9686
8277,商丞,37,4,33,富邦-宜蘭,2023-06-02,9686
4413,飛寶企業,30,0,30,富邦-宜蘭,2023-06-02,9686
00679B,元大美債20年,33,4,29,富邦-宜蘭,2023-06-02,9686
00712,復華富時不動產,26,1,25,富邦-宜蘭,2023-06-02,9686
00919,群益台灣精選高息,25,0,25,富邦-宜蘭,2023-06-02,9686
00882,中信中國高股息,25,0,25,富邦-宜蘭,2023-06-02,9686
6546,正基,24,0,24,富邦-宜蘭,2023-06-02,9686
8404,百和興業-KY,21,0,21,富邦-宜蘭,2023-06-02,9686
00926,凱基全球菁英55,20,0,20,富邦-宜蘭,2023-06-02,9686
00671R,富邦NASDAQ反1,20,0,20,富邦-宜蘭,2023-06-02,9686
2901,欣欣,20,0,20,富邦-宜蘭,2023-06-02,9686
6441,廣錠,20,0,20,富邦-宜蘭,2023-06-02,9686
8048,德勝,21,2,19,富邦-宜蘭,2023-06-02,9686
2332,友訊,41,23,18,富邦-宜蘭,2023-06-02,9686
1904,正隆,30,13,17,富邦-宜蘭,2023-06-02,9686
9945,潤泰新,23,6,17,富邦-宜蘭,2023-06-02,9686
6568,宏觀,17,0,17,富邦-宜蘭,2023-06-02,9686
1503,士電,29,12,17,富邦-宜蘭,2023-06-02,9686
3346,麗清,17,1,16,富邦-宜蘭,2023-06-02,9686
2892,第一金,16,1,15,富邦-宜蘭,2023-06-02,9686
4564,元翎,24,9,15,富邦-宜蘭,2023-06-02,9686
2614,東森,18,3,15,富邦-宜蘭,2023-06-02,9686
6589,台康生技,15,0,15,富邦-宜蘭,2023-06-02,9686
00687B,國泰20年美債,14,0,14,富邦-宜蘭,2023-06-02,9686
5478,智冠,16,2,14,富邦-宜蘭,2023-06-02,9686
2331,精英,22,9,13,富邦-宜蘭,2023-06-02,9686
5009,榮剛,23,10,13,富邦-宜蘭,2023-06-02,9686
2211,長榮鋼,13,0,13,富邦-宜蘭,2023-06-02,9686
2471,資通,14,1,13,富邦-宜蘭,2023-06-02,9686
6161,捷波,13,1,12,富邦-宜蘭,2023-06-02,9686
1471,首利,12,0,12,富邦-宜蘭,2023-06-02,9686
2314,台揚,13,1,12,富邦-宜蘭,2023-06-02,9686
00713,元大台灣高息低波,24,12,12,富邦-宜蘭,2023-06-02,9686
2889,國票金,11,0,11,富邦-宜蘭,2023-06-02,9686
6517,保勝光學,12,1,11,富邦-宜蘭,2023-06-02,9686
3017,奇鋐,21,10,11,富邦-宜蘭,2023-06-02,9686
4953,緯軟,10,0,10,富邦-宜蘭,2023-06-02,9686
2888,新光金,558,114,444,富邦-宜蘭,2023-06-05,9686
00712,復華富時不動產,154,7,147,富邦-宜蘭,2023-06-05,9686
00673R,期元大S＆P原油反1,70,0,70,富邦-宜蘭,2023-06-05,9686
1314,中石化,72,3,69,富邦-宜蘭,2023-06-05,9686
9946,三發地產,62,0,62,富邦-宜蘭,2023-06-05,9686
1608,華榮,74,14,60,富邦-宜蘭,2023-06-05,9686
2610,華航,129,69,60,富邦-宜蘭,2023-06-05,9686
6016,康和證,76,17,59,富邦-宜蘭,2023-06-05,9686
6015,宏遠證,50,3,47,富邦-宜蘭,2023-06-05,9686
2618,長榮航,113,67,46,富邦-宜蘭,2023-06-05,9686
00882,中信中國高股息,45,0,45,富邦-宜蘭,2023-06-05,9686
1904,正隆,53,10,43,富邦-宜蘭,2023-06-05,9686
00687B,國泰20年美債,44,4,40,富邦-宜蘭,2023-06-05,9686
6441,廣錠,37,0,37,富邦-宜蘭,2023-06-05,9686
00679B,元大美債20年,40,3,37,富邦-宜蘭,2023-06-05,9686
5344,立衛,33,0,33,富邦-宜蘭,2023-06-05,9686
2399,映泰,49,16,33,富邦-宜蘭,2023-06-05,9686
2353,宏��,46,13,33,富邦-宜蘭,2023-06-05,9686
6282,康舒,95,63,32,富邦-宜蘭,2023-06-05,9686
6148,驊宏資,30,0,30,富邦-宜蘭,2023-06-05,9686
3049,精金,35,5,30,富邦-宜蘭,2023-06-05,9686
8109,博大,30,0,30,富邦-宜蘭,2023-06-05,9686
2337,旺宏,28,0,28,富邦-宜蘭,2023-06-05,9686
6214,精誠,40,13,27,富邦-宜蘭,2023-06-05,9686
5328,華容,31,4,27,富邦-宜蘭,2023-06-05,9686
6589,台康生技,26,0,26,富邦-宜蘭,2023-06-05,9686
1514,亞力,41,19,22,富邦-宜蘭,2023-06-05,9686
1795,美時,34,12,22,富邦-宜蘭,2023-06-05,9686
2371,大同,50,29,21,富邦-宜蘭,2023-06-05,9686
1471,首利,23,3,20,富邦-宜蘭,2023-06-05,9686
8054,安國,20,0,20,富邦-宜蘭,2023-06-05,9686
6229,研通,20,0,20,富邦-宜蘭,2023-06-05,9686
6189,豐藝,20,0,20,富邦-宜蘭,2023-06-05,9686
6270,倍微,20,0,20,富邦-宜蘭,2023-06-05,9686
2338,光罩,20,1,19,富邦-宜蘭,2023-06-05,9686
4157,太景*-KY,19,0,19,富邦-宜蘭,2023-06-05,9686
8404,百和興業-KY,24,5,19,富邦-宜蘭,2023-06-05,9686
6161,捷波,29,11,18,富邦-宜蘭,2023-06-05,9686
1515,力山,20,3,17,富邦-宜蘭,2023-06-05,9686
5511,德昌,20,4,16,富邦-宜蘭,2023-06-05,9686
2002,中鋼,25,9,16,富邦-宜蘭,2023-06-05,9686
3521,鴻翊,15,0,15,富邦-宜蘭,2023-06-05,9686
1905,華紙,54,39,15,富邦-宜蘭,2023-06-05,9686
3252,海灣,20,5,15,富邦-宜蘭,2023-06-05,9686
5016,松和,15,0,15,富邦-宜蘭,2023-06-05,9686
00720B,元大投資級公司債,14,0,14,富邦-宜蘭,2023-06-05,9686
2615,萬海,14,0,14,富邦-宜蘭,2023-06-05,9686
4979,華星光,37,23,14,富邦-宜蘭,2023-06-05,9686
3162,精確,15,1,14,富邦-宜蘭,2023-06-05,9686
1711,永光,44,30,14,富邦-宜蘭,2023-06-05,9686
6125,廣運,176,36,140,富邦-宜蘭,2023-06-06,9686
3706,神達,133,17,116,富邦-宜蘭,2023-06-06,9686
5512,力麒,100,0,100,富邦-宜蘭,2023-06-06,9686
1319,東陽,89,0,89,富邦-宜蘭,2023-06-06,9686
2701,萬企,104,30,74,富邦-宜蘭,2023-06-06,9686
1609,大亞,203,137,66,富邦-宜蘭,2023-06-06,9686
2399,映泰,79,20,59,富邦-宜蘭,2023-06-06,9686
1514,亞力,78,23,55,富邦-宜蘭,2023-06-06,9686
00927,群益半導體收益,51,0,51,富邦-宜蘭,2023-06-06,9686
6456,GIS-KY,49,0,49,富邦-宜蘭,2023-06-06,9686
2427,三商電,56,8,48,富邦-宜蘭,2023-06-06,9686
1907,永豐餘,74,27,47,富邦-宜蘭,2023-06-06,9686
00676R,富邦臺灣加權反1,47,0,47,富邦-宜蘭,2023-06-06,9686
2337,旺宏,50,3,47,富邦-宜蘭,2023-06-06,9686
1810,和成,47,1,46,富邦-宜蘭,2023-06-06,9686
6116,彩晶,49,5,44,富邦-宜蘭,2023-06-06,9686
2323,中環,123,79,44,富邦-宜蘭,2023-06-06,9686
5340,建榮,42,1,41,富邦-宜蘭,2023-06-06,9686
2332,友訊,43,3,40,富邦-宜蘭,2023-06-06,9686
2206,三陽工業,74,34,40,富邦-宜蘭,2023-06-06,9686
00919,群益台灣精選高息,37,1,36,富邦-宜蘭,2023-06-06,9686
3047,訊舟,37,3,34,富邦-宜蘭,2023-06-06,9686
2461,光群雷,42,9,33,富邦-宜蘭,2023-06-06,9686
00632R,元大台灣50反1,42,10,32,富邦-宜蘭,2023-06-06,9686
00713,元大台灣高息低波,31,0,31,富邦-宜蘭,2023-06-06,9686
00885,富邦越南,30,0,30,富邦-宜蘭,2023-06-06,9686
00751B,元大AAA至A公司債,30,0,30,富邦-宜蘭,2023-06-06,9686
4916,事欣科,30,1,29,富邦-宜蘭,2023-06-06,9686
1904,正隆,38,9,29,富邦-宜蘭,2023-06-06,9686
3025,星通,34,6,28,富邦-宜蘭,2023-06-06,9686
00757,統一FANG+,30,2,28,富邦-宜蘭,2023-06-06,9686
4931,新盛力,38,10,28,富邦-宜蘭,2023-06-06,9686
2402,毅嘉,90,65,25,富邦-宜蘭,2023-06-06,9686
00679B,元大美債20年,29,3,26,富邦-宜蘭,2023-06-06,9686
6441,廣錠,29,6,23,富邦-宜蘭,2023-06-06,9686
5483,中美晶,21,0,21,富邦-宜蘭,2023-06-06,9686
8097,常珵,21,0,21,富邦-宜蘭,2023-06-06,9686
00720B,元大投資級公司債,21,1,20,富邦-宜蘭,2023-06-06,9686
3682,亞太電,20,0,20,富邦-宜蘭,2023-06-06,9686
2634,漢翔,26,7,19,富邦-宜蘭,2023-06-06,9686
9945,潤泰新,21,4,17,富邦-宜蘭,2023-06-06,9686
4977,眾達-KY,16,0,16,富邦-宜蘭,2023-06-06,9686
2706,第一店,20,5,15,富邦-宜蘭,2023-06-06,9686
4906,正文,18,3,15,富邦-宜蘭,2023-06-06,9686
9944,新麗,15,0,15,富邦-宜蘭,2023-06-06,9686
6142,友勁,18,4,14,富邦-宜蘭,2023-06-06,9686
4915,致伸,13,0,13,富邦-宜蘭,2023-06-06,9686
5531,鄉林,15,2,13,富邦-宜蘭,2023-06-06,9686
8426,紅木-KY,16,3,13,富邦-宜蘭,2023-06-06,9686
8926,台汽電,12,0,12,富邦-宜蘭,2023-06-06,9686
6125,廣運,162,20,142,富邦-宜蘭,2023-06-07,9686
1806,冠軍,105,2,103,富邦-宜蘭,2023-06-07,9686
6441,廣錠,93,1,92,富邦-宜蘭,2023-06-07,9686
2362,藍天,55,1,54,富邦-宜蘭,2023-06-07,9686
6116,彩晶,60,16,44,富邦-宜蘭,2023-06-07,9686
2618,長榮航,69,31,38,富邦-宜蘭,2023-06-07,9686
9802,鈺齊-KY,38,1,37,富邦-宜蘭,2023-06-07,9686
3005,神基,44,7,37,富邦-宜蘭,2023-06-07,9686
3231,緯創,127,91,36,富邦-宜蘭,2023-06-07,9686
00673R,期元大S＆P原油反1,35,0,35,富邦-宜蘭,2023-06-07,9686
00679B,元大美債20年,34,1,33,富邦-宜蘭,2023-06-07,9686
00882,中信中國高股息,32,0,32,富邦-宜蘭,2023-06-07,9686
00751B,元大AAA至A公司債,32,0,32,富邦-宜蘭,2023-06-07,9686
6592,和潤企業,30,0,30,富邦-宜蘭,2023-06-07,9686
2489,瑞軒,49,20,29,富邦-宜蘭,2023-06-07,9686
5531,鄉林,41,14,27,富邦-宜蘭,2023-06-07,9686
3265,台星科,27,0,27,富邦-宜蘭,2023-06-07,9686
5009,榮剛,28,2,26,富邦-宜蘭,2023-06-07,9686
1514,亞力,43,17,26,富邦-宜蘭,2023-06-07,9686
5243,乙盛-KY,25,0,25,富邦-宜蘭,2023-06-07,9686
2109,華豐,25,0,25,富邦-宜蘭,2023-06-07,9686
00637L,元大滬深300正2,36,12,24,富邦-宜蘭,2023-06-07,9686
2504,國產,34,10,24,富邦-宜蘭,2023-06-07,9686
2409,友達,35,12,23,富邦-宜蘭,2023-06-07,9686
4916,事欣科,22,1,21,富邦-宜蘭,2023-06-07,9686
4915,致伸,21,0,21,富邦-宜蘭,2023-06-07,9686
5706,鳳凰,36,15,21,富邦-宜蘭,2023-06-07,9686
2882,國泰金,25,5,20,富邦-宜蘭,2023-06-07,9686
3043,科風,19,0,19,富邦-宜蘭,2023-06-07,9686
2906,高林,19,0,19,富邦-宜蘭,2023-06-07,9686
6205,詮欣,18,0,18,富邦-宜蘭,2023-06-07,9686
00927,群益半導體收益,18,0,18,富邦-宜蘭,2023-06-07,9686
3630,新鉅科,23,5,18,富邦-宜蘭,2023-06-07,9686
2881,富邦金,20,2,18,富邦-宜蘭,2023-06-07,9686
4123,晟德,26,8,18,富邦-宜蘭,2023-06-07,9686
2382,廣達,36,19,17,富邦-宜蘭,2023-06-07,9686
6243,迅杰,18,2,16,富邦-宜蘭,2023-06-07,9686
2515,中工,21,5,16,富邦-宜蘭,2023-06-07,9686
4977,眾達-KY,15,0,15,富邦-宜蘭,2023-06-07,9686
1444,力麗,20,5,15,富邦-宜蘭,2023-06-07,9686
6188,廣明,38,24,14,富邦-宜蘭,2023-06-07,9686
4968,立積,26,12,14,富邦-宜蘭,2023-06-07,9686
3293,鈊象,15,1,14,富邦-宜蘭,2023-06-07,9686
1605,華新,27,13,14,富邦-宜蘭,2023-06-07,9686
2206,三陽工業,70,57,13,富邦-宜蘭,2023-06-07,9686
3058,立德,16,3,13,富邦-宜蘭,2023-06-07,9686
1452,宏益,63,50,13,富邦-宜蘭,2023-06-07,9686
1104,環泥,13,0,13,富邦-宜蘭,2023-06-07,9686
2402,毅嘉,26,14,12,富邦-宜蘭,2023-06-07,9686
00720B,元大投資級公司債,13,1,12,富邦-宜蘭,2023-06-07,9686
00632R,元大台灣50反1,761,6,755,富邦-宜蘭,2023-06-08,9686
00919,群益台灣精選高息,718,1,717,富邦-宜蘭,2023-06-08,9686
1806,冠軍,190,4,186,富邦-宜蘭,2023-06-08,9686
2337,旺宏,84,0,84,富邦-宜蘭,2023-06-08,9686
1618,合機,84,10,74,富邦-宜蘭,2023-06-08,9686
5512,力麒,105,34,71,富邦-宜蘭,2023-06-08,9686
9944,新麗,81,10,71,富邦-宜蘭,2023-06-08,9686
6111,大宇資,72,2,70,富邦-宜蘭,2023-06-08,9686
1609,大亞,170,104,66,富邦-宜蘭,2023-06-08,9686
00795B,中信美國公債20年,66,0,66,富邦-宜蘭,2023-06-08,9686
1612,宏泰,86,23,63,富邦-宜蘭,2023-06-08,9686
00679B,元大美債20年,69,7,62,富邦-宜蘭,2023-06-08,9686
00878,國泰永續高股息,73,16,57,富邦-宜蘭,2023-06-08,9686
2344,華邦電,61,7,54,富邦-宜蘭,2023-06-08,9686
00713,元大台灣高息低波,53,2,51,富邦-宜蘭,2023-06-08,9686
3706,神達,52,2,50,富邦-宜蘭,2023-06-08,9686
00927,群益半導體收益,50,2,48,富邦-宜蘭,2023-06-08,9686
6005,群益證,53,8,45,富邦-宜蘭,2023-06-08,9686
2618,長榮航,99,57,42,富邦-宜蘭,2023-06-08,9686
6485,點序,41,0,41,富邦-宜蘭,2023-06-08,9686
00772B,中信高評級公司債,39,2,37,富邦-宜蘭,2023-06-08,9686
2881,富邦金,33,3,30,富邦-宜蘭,2023-06-08,9686
2897,王道銀行,30,0,30,富邦-宜蘭,2023-06-08,9686
00673R,期元大S＆P原油反1,28,0,28,富邦-宜蘭,2023-06-08,9686
4164,承業醫,28,1,27,富邦-宜蘭,2023-06-08,9686
1611,中電,31,5,26,富邦-宜蘭,2023-06-08,9686
1513,中興電,39,13,26,富邦-宜蘭,2023-06-08,9686
00712,復華富時不動產,30,5,25,富邦-宜蘭,2023-06-08,9686
1504,東元,38,13,25,富邦-宜蘭,2023-06-08,9686
2888,新光金,31,7,24,富邦-宜蘭,2023-06-08,9686
5905,南仁湖,41,19,22,富邦-宜蘭,2023-06-08,9686
3630,新鉅科,29,9,20,富邦-宜蘭,2023-06-08,9686
2208,台船,30,10,20,富邦-宜蘭,2023-06-08,9686
2705,六福,24,4,20,富邦-宜蘭,2023-06-08,9686
3037,欣興,62,43,19,富邦-宜蘭,2023-06-08,9686
3162,精確,21,3,18,富邦-宜蘭,2023-06-08,9686
00885,富邦越南,20,2,18,富邦-宜蘭,2023-06-08,9686
3011,今皓,20,2,18,富邦-宜蘭,2023-06-08,9686
1319,東陽,23,5,18,富邦-宜蘭,2023-06-08,9686
00687B,國泰20年美債,20,2,18,富邦-宜蘭,2023-06-08,9686
6568,宏觀,17,0,17,富邦-宜蘭,2023-06-08,9686
0056,元大高股息,21,4,17,富邦-宜蘭,2023-06-08,9686
2332,友訊,16,0,16,富邦-宜蘭,2023-06-08,9686
2408,南亞科,16,0,16,富邦-宜蘭,2023-06-08,9686
1524,耿鼎,35,19,16,富邦-宜蘭,2023-06-08,9686
2401,凌陽,27,12,15,富邦-宜蘭,2023-06-08,9686
2612,中航,20,5,15,富邦-宜蘭,2023-06-08,9686
1605,華新,51,37,14,富邦-宜蘭,2023-06-08,9686
3047,訊舟,14,0,14,富邦-宜蘭,2023-06-08,9686
2882,國泰金,15,2,13,富邦-宜蘭,2023-06-08,9686
6116,彩晶,207,1,206,富邦-宜蘭,2023-06-09,9686
2353,宏��,235,48,187,富邦-宜蘭,2023-06-09,9686
2031,新光鋼,78,0,78,富邦-宜蘭,2023-06-09,9686
2399,映泰,98,32,66,富邦-宜蘭,2023-06-09,9686
1709,和益,65,0,65,富邦-宜蘭,2023-06-09,9686
8034,榮群,60,0,60,富邦-宜蘭,2023-06-09,9686
00919,群益台灣精選高息,56,0,56,富邦-宜蘭,2023-06-09,9686
2705,六福,58,5,53,富邦-宜蘭,2023-06-09,9686
2365,昆盈,50,0,50,富邦-宜蘭,2023-06-09,9686
5009,榮剛,46,0,46,富邦-宜蘭,2023-06-09,9686
4105,東洋,43,0,43,富邦-宜蘭,2023-06-09,9686
2888,新光金,65,22,43,富邦-宜蘭,2023-06-09,9686
6179,亞通,45,10,35,富邦-宜蘭,2023-06-09,9686
00712,復華富時不動產,43,10,33,富邦-宜蘭,2023-06-09,9686
9919,康那香,35,2,33,富邦-宜蘭,2023-06-09,9686
1504,東元,48,15,33,富邦-宜蘭,2023-06-09,9686
3576,聯合再生,51,19,32,富邦-宜蘭,2023-06-09,9686
2436,偉詮電,32,2,30,富邦-宜蘭,2023-06-09,9686
2329,華泰,68,39,29,富邦-宜蘭,2023-06-09,9686
00679B,元大美債20年,27,0,27,富邦-宜蘭,2023-06-09,9686
2736,富野,31,4,27,富邦-宜蘭,2023-06-09,9686
2457,飛宏,42,15,27,富邦-宜蘭,2023-06-09,9686
1802,台玻,25,0,25,富邦-宜蘭,2023-06-09,9686
5475,德宏,29,4,25,富邦-宜蘭,2023-06-09,9686
2884,玉山金,25,1,24,富邦-宜蘭,2023-06-09,9686
4916,事欣科,38,15,23,富邦-宜蘭,2023-06-09,9686
5512,力麒,27,4,23,富邦-宜蘭,2023-06-09,9686
1612,宏泰,26,4,22,富邦-宜蘭,2023-06-09,9686
3046,建��,95,73,22,富邦-宜蘭,2023-06-09,9686
2352,佳世達,44,23,21,富邦-宜蘭,2023-06-09,9686
3207,耀勝,23,2,21,富邦-宜蘭,2023-06-09,9686
6266,泰詠,21,0,21,富邦-宜蘭,2023-06-09,9686
00713,元大台灣高息低波,22,1,21,富邦-宜蘭,2023-06-09,9686
1524,耿鼎,33,13,20,富邦-宜蘭,2023-06-09,9686
3432,台端,20,0,20,富邦-宜蘭,2023-06-09,9686
1605,華新,27,8,19,富邦-宜蘭,2023-06-09,9686
5701,劍湖山,18,0,18,富邦-宜蘭,2023-06-09,9686
2337,旺宏,20,2,18,富邦-宜蘭,2023-06-09,9686
2371,大同,22,5,17,富邦-宜蘭,2023-06-09,9686
6202,盛群,16,0,16,富邦-宜蘭,2023-06-09,9686
8488,吉源-KY,16,0,16,富邦-宜蘭,2023-06-09,9686
00900,富邦特選高股息30,41,25,16,富邦-宜蘭,2023-06-09,9686
2731,雄獅,30,15,15,富邦-宜蘭,2023-06-09,9686
8404,百和興業-KY,15,0,15,富邦-宜蘭,2023-06-09,9686
3715,定穎投控,27,13,14,富邦-宜蘭,2023-06-09,9686
1708,東鹼,16,3,13,富邦-宜蘭,2023-06-09,9686
5469,瀚宇博,22,9,13,富邦-宜蘭,2023-06-09,9686
7402,邑錡,15,2,13,富邦-宜蘭,2023-06-09,9686
1527,鑽全,12,0,12,富邦-宜蘭,2023-06-09,9686
3540,曜越,15,3,12,富邦-宜蘭,2023-06-09,9686
00632R,元大台灣50反1,616,24,592,富邦-宜蘭,2023-06-12,9686
00919,群益台灣精選高息,298,0,298,富邦-宜蘭,2023-06-12,9686
2323,中環,203,54,149,富邦-宜蘭,2023-06-12,9686
9944,新麗,119,1,118,富邦-宜蘭,2023-06-12,9686
0056,元大高股息,109,14,95,富邦-宜蘭,2023-06-12,9686
2618,長榮航,155,66,89,富邦-宜蘭,2023-06-12,9686
3231,緯創,161,74,87,富邦-宜蘭,2023-06-12,9686
00715L,期街口布蘭特正2,88,5,83,富邦-宜蘭,2023-06-12,9686
2356,英業達,71,8,63,富邦-宜蘭,2023-06-12,9686
2371,大同,82,28,54,富邦-宜蘭,2023-06-12,9686
00900,富邦特選高股息30,53,2,51,富邦-宜蘭,2023-06-12,9686
3630,新鉅科,46,0,46,富邦-宜蘭,2023-06-12,9686
3058,立德,45,2,43,富邦-宜蘭,2023-06-12,9686
2891,中信金,38,2,36,富邦-宜蘭,2023-06-12,9686
6148,驊宏資,38,2,36,富邦-宜蘭,2023-06-12,9686
00929,復華台灣科技優息,118,85,33,富邦-宜蘭,2023-06-12,9686
2705,六福,37,4,33,富邦-宜蘭,2023-06-12,9686
2887,台新金,34,2,32,富邦-宜蘭,2023-06-12,9686
3078,僑威,93,63,30,富邦-宜蘭,2023-06-12,9686
6142,友勁,42,17,25,富邦-宜蘭,2023-06-12,9686
3374,精材,38,13,25,富邦-宜蘭,2023-06-12,9686
6190,萬泰科,25,0,25,富邦-宜蘭,2023-06-12,9686
1589,永冠-KY,24,0,24,富邦-宜蘭,2023-06-12,9686
00878,國泰永續高股息,58,34,24,富邦-宜蘭,2023-06-12,9686
2312,金寶,35,12,23,富邦-宜蘭,2023-06-12,9686
3706,神達,30,7,23,富邦-宜蘭,2023-06-12,9686
00712,復華富時不動產,24,1,23,富邦-宜蘭,2023-06-12,9686
00713,元大台灣高息低波,25,3,22,富邦-宜蘭,2023-06-12,9686
2882,國泰金,32,10,22,富邦-宜蘭,2023-06-12,9686
8210,勤誠,22,0,22,富邦-宜蘭,2023-06-12,9686
2601,益航,22,0,22,富邦-宜蘭,2023-06-12,9686
1529,樂事綠能,64,43,21,富邦-宜蘭,2023-06-12,9686
4123,晟德,27,6,21,富邦-宜蘭,2023-06-12,9686
2328,廣宇,21,0,21,富邦-宜蘭,2023-06-12,9686
2630,亞航,35,15,20,富邦-宜蘭,2023-06-12,9686
2002,中鋼,20,0,20,富邦-宜蘭,2023-06-12,9686
8105,凌巨,20,0,20,富邦-宜蘭,2023-06-12,9686
2547,日勝生,20,0,20,富邦-宜蘭,2023-06-12,9686
2515,中工,21,2,19,富邦-宜蘭,2023-06-12,9686
00892,富邦台灣半導體,22,3,19,富邦-宜蘭,2023-06-12,9686
3207,耀勝,22,4,18,富邦-宜蘭,2023-06-12,9686
5009,榮剛,20,2,18,富邦-宜蘭,2023-06-12,9686
3029,零壹,20,2,18,富邦-宜蘭,2023-06-12,9686
6122,擎邦,24,7,17,富邦-宜蘭,2023-06-12,9686
2337,旺宏,19,3,16,富邦-宜蘭,2023-06-12,9686
1527,鑽全,15,0,15,富邦-宜蘭,2023-06-12,9686
3481,群創,56,41,15,富邦-宜蘭,2023-06-12,9686
2376,技嘉,50,36,14,富邦-宜蘭,2023-06-12,9686
3576,聯合再生,14,0,14,富邦-宜蘭,2023-06-12,9686
5475,德宏,14,0,14,富邦-宜蘭,2023-06-12,9686
00919,群益台灣精選高息,344,3,341,富邦-宜蘭,2023-06-13,9686
00715L,期街口布蘭特正2,273,30,243,富邦-宜蘭,2023-06-13,9686
00929,復華台灣科技優息,88,11,77,富邦-宜蘭,2023-06-13,9686
8155,博智,75,1,74,富邦-宜蘭,2023-06-13,9686
3045,台灣大,38,0,38,富邦-宜蘭,2023-06-13,9686
6179,亞通,41,3,38,富邦-宜蘭,2023-06-13,9686
2482,連宇,61,23,38,富邦-宜蘭,2023-06-13,9686
6142,友勁,42,5,37,富邦-宜蘭,2023-06-13,9686
6288,聯嘉,62,31,31,富邦-宜蘭,2023-06-13,9686
1742,台蠟,30,0,30,富邦-宜蘭,2023-06-13,9686
2801,彰銀,31,1,30,富邦-宜蘭,2023-06-13,9686
2614,東森,30,3,27,富邦-宜蘭,2023-06-13,9686
2324,仁寶,33,6,27,富邦-宜蘭,2023-06-13,9686
4979,華星光,69,43,26,富邦-宜蘭,2023-06-13,9686
1218,泰山,25,0,25,富邦-宜蘭,2023-06-13,9686
2305,全友,26,2,24,富邦-宜蘭,2023-06-13,9686
2323,中環,92,69,23,富邦-宜蘭,2023-06-13,9686
1806,冠軍,35,13,22,富邦-宜蘭,2023-06-13,9686
2206,三陽工業,112,90,22,富邦-宜蘭,2023-06-13,9686
6577,勁豐,20,0,20,富邦-宜蘭,2023-06-13,9686
00688L,國泰20年美債正2,20,0,20,富邦-宜蘭,2023-06-13,9686
2425,承啟,23,4,19,富邦-宜蘭,2023-06-13,9686
6111,大宇資,20,2,18,富邦-宜蘭,2023-06-13,9686
1101,台泥,17,0,17,富邦-宜蘭,2023-06-13,9686
2705,六福,20,3,17,富邦-宜蘭,2023-06-13,9686
4915,致伸,21,4,17,富邦-宜蘭,2023-06-13,9686
1522,堤維西,83,66,17,富邦-宜蘭,2023-06-13,9686
2913,農林,25,8,17,富邦-宜蘭,2023-06-13,9686
3711,日月光投控,22,5,17,富邦-宜蘭,2023-06-13,9686
2881,富邦金,27,11,16,富邦-宜蘭,2023-06-13,9686
9944,新麗,15,0,15,富邦-宜蘭,2023-06-13,9686
2027,大成鋼,22,7,15,富邦-宜蘭,2023-06-13,9686
4977,眾達-KY,17,3,14,富邦-宜蘭,2023-06-13,9686
00679B,元大美債20年,14,0,14,富邦-宜蘭,2023-06-13,9686
1326,台化,14,0,14,富邦-宜蘭,2023-06-13,9686
1104,環泥,25,11,14,富邦-宜蘭,2023-06-13,9686
5425,台半,22,8,14,富邦-宜蘭,2023-06-13,9686
2449,京元電子,45,31,14,富邦-宜蘭,2023-06-13,9686
2402,毅嘉,15,2,13,富邦-宜蘭,2023-06-13,9686
3163,波若威,14,1,13,富邦-宜蘭,2023-06-13,9686
8050,廣積,34,21,13,富邦-宜蘭,2023-06-13,9686
00680L,元大美債20正2,12,0,12,富邦-宜蘭,2023-06-13,9686
3105,穩懋,54,42,12,富邦-宜蘭,2023-06-13,9686
2340,台亞,12,0,12,富邦-宜蘭,2023-06-13,9686
2706,第一店,12,0,12,富邦-宜蘭,2023-06-13,9686
3032,偉訓,19,7,12,富邦-宜蘭,2023-06-13,9686
00687B,國泰20年美債,14,2,12,富邦-宜蘭,2023-06-13,9686
3017,奇鋐,21,10,11,富邦-宜蘭,2023-06-13,9686
5347,世界,11,0,11,富邦-宜蘭,2023-06-13,9686
00882,中信中國高股息,22,12,10,富邦-宜蘭,2023-06-13,9686
2897,王道銀行,1240,0,1240,富邦-宜蘭,2023-06-14,9686
00919,群益台灣精選高息,228,1,227,富邦-宜蘭,2023-06-14,9686
2882,國泰金,225,2,223,富邦-宜蘭,2023-06-14,9686
6282,康舒,107,8,99,富邦-宜蘭,2023-06-14,9686
2356,英業達,270,176,94,富邦-宜蘭,2023-06-14,9686
00712,復華富時不動產,94,8,86,富邦-宜蘭,2023-06-14,9686
4533,協易機,134,54,80,富邦-宜蘭,2023-06-14,9686
6125,廣運,84,6,78,富邦-宜蘭,2023-06-14,9686
2405,輔信,82,5,77,富邦-宜蘭,2023-06-14,9686
00895,富邦未來車,90,32,58,富邦-宜蘭,2023-06-14,9686
6111,大宇資,56,0,56,富邦-宜蘭,2023-06-14,9686
1314,中石化,56,1,55,富邦-宜蘭,2023-06-14,9686
2365,昆盈,50,0,50,富邦-宜蘭,2023-06-14,9686
6441,廣錠,43,1,42,富邦-宜蘭,2023-06-14,9686
6142,友勁,36,0,36,富邦-宜蘭,2023-06-14,9686
00772B,中信高評級公司債,35,0,35,富邦-宜蘭,2023-06-14,9686
6182,合晶,36,4,32,富邦-宜蘭,2023-06-14,9686
1568,倉佑,30,0,30,富邦-宜蘭,2023-06-14,9686
2705,六福,81,54,27,富邦-宜蘭,2023-06-14,9686
2354,鴻準,32,5,27,富邦-宜蘭,2023-06-14,9686
2884,玉山金,27,0,27,富邦-宜蘭,2023-06-14,9686
00929,復華台灣科技優息,28,4,24,富邦-宜蘭,2023-06-14,9686
1609,大亞,76,54,22,富邦-宜蘭,2023-06-14,9686
1522,堤維西,201,179,22,富邦-宜蘭,2023-06-14,9686
2353,宏��,22,2,20,富邦-宜蘭,2023-06-14,9686
3576,聯合再生,20,0,20,富邦-宜蘭,2023-06-14,9686
6577,勁豐,20,0,20,富邦-宜蘭,2023-06-14,9686
0056,元大高股息,43,23,20,富邦-宜蘭,2023-06-14,9686
2427,三商電,20,1,19,富邦-宜蘭,2023-06-14,9686
2480,敦陽科,27,8,19,富邦-宜蘭,2023-06-14,9686
2888,新光金,41,22,19,富邦-宜蘭,2023-06-14,9686
6171,大城地產,19,0,19,富邦-宜蘭,2023-06-14,9686
4541,晟田,17,0,17,富邦-宜蘭,2023-06-14,9686
3078,僑威,88,71,17,富邦-宜蘭,2023-06-14,9686
2376,技嘉,23,6,17,富邦-宜蘭,2023-06-14,9686
8426,紅木-KY,17,1,16,富邦-宜蘭,2023-06-14,9686
00655L,國泰中國A50正2,15,0,15,富邦-宜蘭,2023-06-14,9686
3665,貿聯-KY,16,1,15,富邦-宜蘭,2023-06-14,9686
2324,仁寶,14,0,14,富邦-宜蘭,2023-06-14,9686
1452,宏益,14,0,14,富邦-宜蘭,2023-06-14,9686
3022,威強電,26,12,14,富邦-宜蘭,2023-06-14,9686
4560,強信-KY,14,0,14,富邦-宜蘭,2023-06-14,9686
00679B,元大美債20年,14,0,14,富邦-宜蘭,2023-06-14,9686
00687B,國泰20年美債,13,0,13,富邦-宜蘭,2023-06-14,9686
3363,上詮,16,3,13,富邦-宜蘭,2023-06-14,9686
9946,三發地產,42,29,13,富邦-宜蘭,2023-06-14,9686
4915,致伸,14,2,12,富邦-宜蘭,2023-06-14,9686
8121,越峰,18,6,12,富邦-宜蘭,2023-06-14,9686
3033,威健,20,8,12,富邦-宜蘭,2023-06-14,9686
00753L,中信中國50正2,11,0,11,富邦-宜蘭,2023-06-14,9686
2897,王道銀行,735,0,735,富邦-宜蘭,2023-06-15,9686
3312,弘憶股,230,3,227,富邦-宜蘭,2023-06-15,9686
4747,強生,210,0,210,富邦-宜蘭,2023-06-15,9686
00919,群益台灣精選高息,212,4,208,富邦-宜蘭,2023-06-15,9686
2882,國泰金,106,3,103,富邦-宜蘭,2023-06-15,9686
2356,英業達,341,251,90,富邦-宜蘭,2023-06-15,9686
5324,士開,76,0,76,富邦-宜蘭,2023-06-15,9686
00632R,元大台灣50反1,56,0,56,富邦-宜蘭,2023-06-15,9686
3006,晶豪科,60,6,54,富邦-宜蘭,2023-06-15,9686
00712,復華富時不動產,60,10,50,富邦-宜蘭,2023-06-15,9686
1314,中石化,50,0,50,富邦-宜蘭,2023-06-15,9686
00664R,國泰臺灣加權反1,50,0,50,富邦-宜蘭,2023-06-15,9686
8201,無敵,49,1,48,富邦-宜蘭,2023-06-15,9686
1522,堤維西,60,14,46,富邦-宜蘭,2023-06-15,9686
1504,東元,77,35,42,富邦-宜蘭,2023-06-15,9686
2317,鴻海,42,5,37,富邦-宜蘭,2023-06-15,9686
6125,廣運,78,48,30,富邦-宜蘭,2023-06-15,9686
3055,蔚華科,52,22,30,富邦-宜蘭,2023-06-15,9686
2504,國產,30,0,30,富邦-宜蘭,2023-06-15,9686
2405,輔信,31,1,30,富邦-宜蘭,2023-06-15,9686
1611,中電,61,31,30,富邦-宜蘭,2023-06-15,9686
1513,中興電,42,13,29,富邦-宜蘭,2023-06-15,9686
5302,太欣,29,0,29,富邦-宜蘭,2023-06-15,9686
6133,金橋,29,0,29,富邦-宜蘭,2023-06-15,9686
1609,大亞,59,33,26,富邦-宜蘭,2023-06-15,9686
00679B,元大美債20年,26,0,26,富邦-宜蘭,2023-06-15,9686
6188,廣明,41,17,24,富邦-宜蘭,2023-06-15,9686
00720B,元大投資級公司債,22,0,22,富邦-宜蘭,2023-06-15,9686
6104,創惟,21,0,21,富邦-宜蘭,2023-06-15,9686
2365,昆盈,20,0,20,富邦-宜蘭,2023-06-15,9686
3685,元創精密,21,1,20,富邦-宜蘭,2023-06-15,9686
8933,愛地雅,20,0,20,富邦-宜蘭,2023-06-15,9686
3548,兆利,20,0,20,富邦-宜蘭,2023-06-15,9686
9945,潤泰新,19,1,18,富邦-宜蘭,2023-06-15,9686
5439,高技,19,1,18,富邦-宜蘭,2023-06-15,9686
2425,承啟,19,1,18,富邦-宜蘭,2023-06-15,9686
1529,樂事綠能,47,30,17,富邦-宜蘭,2023-06-15,9686
2489,瑞軒,31,14,17,富邦-宜蘭,2023-06-15,9686
1815,富喬,19,2,17,富邦-宜蘭,2023-06-15,9686
2426,鼎元,20,3,17,富邦-宜蘭,2023-06-15,9686
2603,長榮,24,7,17,富邦-宜蘭,2023-06-15,9686
2352,佳世達,27,11,16,富邦-宜蘭,2023-06-15,9686
4127,天良,16,0,16,富邦-宜蘭,2023-06-15,9686
1409,新纖,15,0,15,富邦-宜蘭,2023-06-15,9686
00902,中信電池及儲能,20,5,15,富邦-宜蘭,2023-06-15,9686
8033,雷虎,17,3,14,富邦-宜蘭,2023-06-15,9686
3264,欣銓,34,21,13,富邦-宜蘭,2023-06-15,9686
2204,中華,12,0,12,富邦-宜蘭,2023-06-15,9686
00878,國泰永續高股息,72,60,12,富邦-宜蘭,2023-06-15,9686
6127,九豪,13,1,12,富邦-宜蘭,2023-06-15,9686
0056,元大高股息,410,12,398,富邦-宜蘭,2023-06-16,9686
2371,大同,333,146,187,富邦-宜蘭,2023-06-16,9686
00637L,元大滬深300正2,203,23,180,富邦-宜蘭,2023-06-16,9686
4747,強生,162,1,161,富邦-宜蘭,2023-06-16,9686
2882,國泰金,86,0,86,富邦-宜蘭,2023-06-16,9686
6111,大宇資,86,0,86,富邦-宜蘭,2023-06-16,9686
1605,華新,190,106,84,富邦-宜蘭,2023-06-16,9686
2323,中環,95,14,81,富邦-宜蘭,2023-06-16,9686
2610,華航,504,425,79,富邦-宜蘭,2023-06-16,9686
2618,長榮航,167,91,76,富邦-宜蘭,2023-06-16,9686
2887,台新金,81,10,71,富邦-宜蘭,2023-06-16,9686
00725B,國泰投資級公司債,62,0,62,富邦-宜蘭,2023-06-16,9686
00673R,期元大S＆P原油反1,61,0,61,富邦-宜蘭,2023-06-16,9686
2359,所羅門,119,59,60,富邦-宜蘭,2023-06-16,9686
3709,鑫聯大投控,51,0,51,富邦-宜蘭,2023-06-16,9686
6877,鏵友益,46,1,45,富邦-宜蘭,2023-06-16,9686
1409,新纖,39,1,38,富邦-宜蘭,2023-06-16,9686
2449,京元電子,45,8,37,富邦-宜蘭,2023-06-16,9686
00885,富邦越南,34,2,32,富邦-宜蘭,2023-06-16,9686
00713,元大台灣高息低波,32,0,32,富邦-宜蘭,2023-06-16,9686
5439,高技,31,0,31,富邦-宜蘭,2023-06-16,9686
6441,廣錠,30,0,30,富邦-宜蘭,2023-06-16,9686
00712,復華富時不動產,61,31,30,富邦-宜蘭,2023-06-16,9686
2301,光寶科,35,6,29,富邦-宜蘭,2023-06-16,9686
4526,東台,39,12,27,富邦-宜蘭,2023-06-16,9686
9962,有益,25,0,25,富邦-宜蘭,2023-06-16,9686
6770,力積電,36,12,24,富邦-宜蘭,2023-06-16,9686
2883,凱基金,29,5,24,富邦-宜蘭,2023-06-16,9686
4915,致伸,24,0,24,富邦-宜蘭,2023-06-16,9686
3706,神達,113,90,23,富邦-宜蘭,2023-06-16,9686
6163,華電網,23,0,23,富邦-宜蘭,2023-06-16,9686
2834,臺企銀,23,1,22,富邦-宜蘭,2023-06-16,9686
3231,緯創,65,44,21,富邦-宜蘭,2023-06-16,9686
1309,台達化,20,0,20,富邦-宜蘭,2023-06-16,9686
6282,康舒,84,65,19,富邦-宜蘭,2023-06-16,9686
1101,台泥,108,89,19,富邦-宜蘭,2023-06-16,9686
1519,華城,51,33,18,富邦-宜蘭,2023-06-16,9686
3576,聯合再生,22,4,18,富邦-宜蘭,2023-06-16,9686
3027,盛達,28,10,18,富邦-宜蘭,2023-06-16,9686
2382,廣達,24,7,17,富邦-宜蘭,2023-06-16,9686
2388,威盛,72,56,16,富邦-宜蘭,2023-06-16,9686
2332,友訊,16,1,15,富邦-宜蘭,2023-06-16,9686
3058,立德,16,2,14,富邦-宜蘭,2023-06-16,9686
6532,瑞耘,15,1,14,富邦-宜蘭,2023-06-16,9686
5880,合庫金,14,0,14,富邦-宜蘭,2023-06-16,9686
2399,映泰,15,2,13,富邦-宜蘭,2023-06-16,9686
3178,公準,13,0,13,富邦-宜蘭,2023-06-16,9686
4533,協易機,44,31,13,富邦-宜蘭,2023-06-16,9686
9802,鈺齊-KY,12,0,12,富邦-宜蘭,2023-06-16,9686
3508,位速,12,0,12,富邦-宜蘭,2023-06-16,9686
2324,仁寶,200,14,186,富邦-宜蘭,2023-06-19,9686
3706,神達,142,7,135,富邦-宜蘭,2023-06-19,9686
5498,凱崴,120,1,119,富邦-宜蘭,2023-06-19,9686
00712,復華富時不動產,125,11,114,富邦-宜蘭,2023-06-19,9686
00673R,期元大S＆P原油反1,86,0,86,富邦-宜蘭,2023-06-19,9686
1605,華新,126,45,81,富邦-宜蘭,2023-06-19,9686
6116,彩晶,95,27,68,富邦-宜蘭,2023-06-19,9686
2356,英業達,168,102,66,富邦-宜蘭,2023-06-19,9686
2882,國泰金,71,6,65,富邦-宜蘭,2023-06-19,9686
5905,南仁湖,64,0,64,富邦-宜蘭,2023-06-19,9686
6770,力積電,62,3,59,富邦-宜蘭,2023-06-19,9686
00665L,富邦�琤肭磪囓�2,83,29,54,富邦-宜蘭,2023-06-19,9686
3058,立德,52,0,52,富邦-宜蘭,2023-06-19,9686
2883,凱基金,53,1,52,富邦-宜蘭,2023-06-19,9686
2618,長榮航,95,43,52,富邦-宜蘭,2023-06-19,9686
2344,華邦電,48,3,45,富邦-宜蘭,2023-06-19,9686
2610,華航,213,170,43,富邦-宜蘭,2023-06-19,9686
3664,安瑞-KY,44,3,41,富邦-宜蘭,2023-06-19,9686
2913,農林,43,3,40,富邦-宜蘭,2023-06-19,9686
2104,國際中橡,47,8,39,富邦-宜蘭,2023-06-19,9686
4960,誠美材,40,1,39,富邦-宜蘭,2023-06-19,9686
2371,大同,79,43,36,富邦-宜蘭,2023-06-19,9686
6120,達運,92,59,33,富邦-宜蘭,2023-06-19,9686
2609,陽明,40,8,32,富邦-宜蘭,2023-06-19,9686
2603,長榮,36,5,31,富邦-宜蘭,2023-06-19,9686
2328,廣宇,31,0,31,富邦-宜蘭,2023-06-19,9686
5009,榮剛,90,59,31,富邦-宜蘭,2023-06-19,9686
4538,大詠城,30,0,30,富邦-宜蘭,2023-06-19,9686
2406,國碩,31,3,28,富邦-宜蘭,2023-06-19,9686
3687,歐買尬,30,3,27,富邦-宜蘭,2023-06-19,9686
8155,博智,25,0,25,富邦-宜蘭,2023-06-19,9686
5703,亞都,24,0,24,富邦-宜蘭,2023-06-19,9686
2201,裕隆,24,2,22,富邦-宜蘭,2023-06-19,9686
4747,強生,23,1,22,富邦-宜蘭,2023-06-19,9686
2332,友訊,25,3,22,富邦-宜蘭,2023-06-19,9686
0056,元大高股息,22,1,21,富邦-宜蘭,2023-06-19,9686
2388,威盛,22,1,21,富邦-宜蘭,2023-06-19,9686
1455,集盛,20,0,20,富邦-宜蘭,2023-06-19,9686
6275,元山,21,1,20,富邦-宜蘭,2023-06-19,9686
8059,凱碩,20,0,20,富邦-宜蘭,2023-06-19,9686
2421,建準,28,9,19,富邦-宜蘭,2023-06-19,9686
4543,萬在,20,1,19,富邦-宜蘭,2023-06-19,9686
00919,群益台灣精選高息,28,10,18,富邦-宜蘭,2023-06-19,9686
00885,富邦越南,18,0,18,富邦-宜蘭,2023-06-19,9686
1727,中華化,20,4,16,富邦-宜蘭,2023-06-19,9686
2606,裕民,17,1,16,富邦-宜蘭,2023-06-19,9686
1513,中興電,102,87,15,富邦-宜蘭,2023-06-19,9686
3231,緯創,78,63,15,富邦-宜蘭,2023-06-19,9686
2481,強茂,15,0,15,富邦-宜蘭,2023-06-19,9686
2886,兆豐金,15,0,15,富邦-宜蘭,2023-06-19,9686
2897,王道銀行,351,0,351,富邦-宜蘭,2023-06-20,9686
8222,寶一,177,56,121,富邦-宜蘭,2023-06-20,9686
2701,萬企,109,1,108,富邦-宜蘭,2023-06-20,9686
3481,群創,131,29,102,富邦-宜蘭,2023-06-20,9686
8034,榮群,100,0,100,富邦-宜蘭,2023-06-20,9686
2427,三商電,103,10,93,富邦-宜蘭,2023-06-20,9686
00712,復華富時不動產,115,28,87,富邦-宜蘭,2023-06-20,9686
00751B,元大AAA至A公司債,78,0,78,富邦-宜蘭,2023-06-20,9686
2618,長榮航,125,49,76,富邦-宜蘭,2023-06-20,9686
4916,事欣科,76,11,65,富邦-宜蘭,2023-06-20,9686
1528,恩德,94,30,64,富邦-宜蘭,2023-06-20,9686
3706,神達,73,11,62,富邦-宜蘭,2023-06-20,9686
1103,嘉泥,114,52,62,富邦-宜蘭,2023-06-20,9686
2356,英業達,87,26,61,富邦-宜蘭,2023-06-20,9686
2867,三商壽,60,0,60,富邦-宜蘭,2023-06-20,9686
5512,力麒,71,12,59,富邦-宜蘭,2023-06-20,9686
3325,旭品,64,5,59,富邦-宜蘭,2023-06-20,9686
2023,燁輝,46,0,46,富邦-宜蘭,2023-06-20,9686
00632R,元大台灣50反1,50,12,38,富邦-宜蘭,2023-06-20,9686
6532,瑞耘,38,0,38,富邦-宜蘭,2023-06-20,9686
3231,緯創,87,50,37,富邦-宜蘭,2023-06-20,9686
00929,復華台灣科技優息,47,10,37,富邦-宜蘭,2023-06-20,9686
4747,強生,41,4,37,富邦-宜蘭,2023-06-20,9686
00665L,富邦�琤肭磪囓�2,55,20,35,富邦-宜蘭,2023-06-20,9686
5340,建榮,37,2,35,富邦-宜蘭,2023-06-20,9686
6485,點序,33,2,31,富邦-宜蘭,2023-06-20,9686
00885,富邦越南,30,1,29,富邦-宜蘭,2023-06-20,9686
5009,榮剛,28,1,27,富邦-宜蘭,2023-06-20,9686
2401,凌陽,36,10,26,富邦-宜蘭,2023-06-20,9686
00919,群益台灣精選高息,26,0,26,富邦-宜蘭,2023-06-20,9686
2454,聯發科,27,1,26,富邦-宜蘭,2023-06-20,9686
00673R,期元大S＆P原油反1,24,0,24,富邦-宜蘭,2023-06-20,9686
3236,千如,22,0,22,富邦-宜蘭,2023-06-20,9686
1540,喬福,20,0,20,富邦-宜蘭,2023-06-20,9686
6441,廣錠,20,1,19,富邦-宜蘭,2023-06-20,9686
1605,華新,68,49,19,富邦-宜蘭,2023-06-20,9686
3027,盛達,19,1,18,富邦-宜蘭,2023-06-20,9686
3264,欣銓,26,8,18,富邦-宜蘭,2023-06-20,9686
0056,元大高股息,33,16,17,富邦-宜蘭,2023-06-20,9686
2734,易飛網,18,2,16,富邦-宜蘭,2023-06-20,9686
4541,晟田,28,12,16,富邦-宜蘭,2023-06-20,9686
2382,廣達,20,5,15,富邦-宜蘭,2023-06-20,9686
6266,泰詠,13,0,13,富邦-宜蘭,2023-06-20,9686
2337,旺宏,13,0,13,富邦-宜蘭,2023-06-20,9686
6142,友勁,17,4,13,富邦-宜蘭,2023-06-20,9686
8403,盛弘,29,17,12,富邦-宜蘭,2023-06-20,9686
2481,強茂,11,0,11,富邦-宜蘭,2023-06-20,9686
8110,華東,11,0,11,富邦-宜蘭,2023-06-20,9686
2201,裕隆,23,13,10,富邦-宜蘭,2023-06-20,9686
2913,農林,10,0,10,富邦-宜蘭,2023-06-20,9686
5512,力麒,228,14,214,富邦-宜蘭,2023-06-21,9686
00665L,富邦�琤肭磪囓�2,162,0,162,富邦-宜蘭,2023-06-21,9686
0056,元大高股息,107,11,96,富邦-宜蘭,2023-06-21,9686
2609,陽明,98,6,92,富邦-宜蘭,2023-06-21,9686
1319,東陽,80,5,75,富邦-宜蘭,2023-06-21,9686
2427,三商電,111,39,72,富邦-宜蘭,2023-06-21,9686
2706,第一店,73,5,68,富邦-宜蘭,2023-06-21,9686
3682,亞太電,54,0,54,富邦-宜蘭,2023-06-21,9686
1708,東鹼,42,0,42,富邦-宜蘭,2023-06-21,9686
4127,天良,100,59,41,富邦-宜蘭,2023-06-21,9686
6120,達運,54,14,40,富邦-宜蘭,2023-06-21,9686
1446,宏和,40,0,40,富邦-宜蘭,2023-06-21,9686
3325,旭品,68,28,40,富邦-宜蘭,2023-06-21,9686
5464,霖宏,41,2,39,富邦-宜蘭,2023-06-21,9686
6441,廣錠,53,16,37,富邦-宜蘭,2023-06-21,9686
2634,漢翔,85,49,36,富邦-宜蘭,2023-06-21,9686
2702,華園,68,33,35,富邦-宜蘭,2023-06-21,9686
2705,六福,73,40,33,富邦-宜蘭,2023-06-21,9686
6589,台康生技,32,0,32,富邦-宜蘭,2023-06-21,9686
2317,鴻海,35,7,28,富邦-宜蘭,2023-06-21,9686
5425,台半,31,4,27,富邦-宜蘭,2023-06-21,9686
1810,和成,27,2,25,富邦-宜蘭,2023-06-21,9686
00712,復華富時不動產,33,9,24,富邦-宜蘭,2023-06-21,9686
6133,金橋,24,0,24,富邦-宜蘭,2023-06-21,9686
3027,盛達,77,54,23,富邦-宜蘭,2023-06-21,9686
2073,雄順,23,1,22,富邦-宜蘭,2023-06-21,9686
3013,晟銘電,80,58,22,富邦-宜蘭,2023-06-21,9686
2408,南亞科,22,0,22,富邦-宜蘭,2023-06-21,9686
2607,榮運,23,1,22,富邦-宜蘭,2023-06-21,9686
1504,東元,30,9,21,富邦-宜蘭,2023-06-21,9686
00924,復華S＆P500成長,20,0,20,富邦-宜蘭,2023-06-21,9686
6488,環球晶,18,0,18,富邦-宜蘭,2023-06-21,9686
2206,三陽工業,23,5,18,富邦-宜蘭,2023-06-21,9686
2337,旺宏,17,0,17,富邦-宜蘭,2023-06-21,9686
2889,國票金,27,10,17,富邦-宜蘭,2023-06-21,9686
3708,上緯投控,17,0,17,富邦-宜蘭,2023-06-21,9686
5465,富驊,23,6,17,富邦-宜蘭,2023-06-21,9686
8011,台通,17,0,17,富邦-宜蘭,2023-06-21,9686
00679B,元大美債20年,19,3,16,富邦-宜蘭,2023-06-21,9686
3693,營邦,49,33,16,富邦-宜蘭,2023-06-21,9686
2329,華泰,24,8,16,富邦-宜蘭,2023-06-21,9686
3611,鼎翰,15,0,15,富邦-宜蘭,2023-06-21,9686
2399,映泰,20,5,15,富邦-宜蘭,2023-06-21,9686
2312,金寶,24,11,13,富邦-宜蘭,2023-06-21,9686
2485,兆赫,17,4,13,富邦-宜蘭,2023-06-21,9686
2498,宏達電,18,5,13,富邦-宜蘭,2023-06-21,9686
6462,神盾,18,5,13,富邦-宜蘭,2023-06-21,9686
00673R,期元大S＆P原油反1,23,10,13,富邦-宜蘭,2023-06-21,9686
2017,官田鋼,13,0,13,富邦-宜蘭,2023-06-21,9686
1609,大亞,29,16,13,富邦-宜蘭,2023-06-21,9686
00637L,元大滬深300正2,115,8,107,富邦-宜蘭,2023-06-26,9686
00751B,元大AAA至A公司債,103,0,103,富邦-宜蘭,2023-06-26,9686
6770,力積電,107,12,95,富邦-宜蘭,2023-06-26,9686
1605,華新,106,12,94,富邦-宜蘭,2023-06-26,9686
00715L,期街口布蘭特正2,64,2,62,富邦-宜蘭,2023-06-26,9686
6282,康舒,68,7,61,富邦-宜蘭,2023-06-26,9686
00929,復華台灣科技優息,52,0,52,富邦-宜蘭,2023-06-26,9686
1337,再生-KY,51,0,51,富邦-宜蘭,2023-06-26,9686
2610,華航,111,61,50,富邦-宜蘭,2023-06-26,9686
3032,偉訓,49,2,47,富邦-宜蘭,2023-06-26,9686
2356,英業達,67,20,47,富邦-宜蘭,2023-06-26,9686
4564,元翎,53,7,46,富邦-宜蘭,2023-06-26,9686
00919,群益台灣精選高息,39,0,39,富邦-宜蘭,2023-06-26,9686
2409,友達,52,13,39,富邦-宜蘭,2023-06-26,9686
2340,台亞,64,31,33,富邦-宜蘭,2023-06-26,9686
2609,陽明,39,8,31,富邦-宜蘭,2023-06-26,9686
1219,福壽,30,0,30,富邦-宜蘭,2023-06-26,9686
1304,台聚,30,0,30,富邦-宜蘭,2023-06-26,9686
1528,恩德,92,62,30,富邦-宜蘭,2023-06-26,9686
3665,貿聯-KY,32,2,30,富邦-宜蘭,2023-06-26,9686
8155,博智,30,0,30,富邦-宜蘭,2023-06-26,9686
2890,永豐金,31,1,30,富邦-宜蘭,2023-06-26,9686
2349,錸德,30,1,29,富邦-宜蘭,2023-06-26,9686
2405,輔信,37,10,27,富邦-宜蘭,2023-06-26,9686
4916,事欣科,65,39,26,富邦-宜蘭,2023-06-26,9686
3038,全台,36,10,26,富邦-宜蘭,2023-06-26,9686
00893,國泰智能電動車,31,6,25,富邦-宜蘭,2023-06-26,9686
00679B,元大美債20年,29,5,24,富邦-宜蘭,2023-06-26,9686
6441,廣錠,29,5,24,富邦-宜蘭,2023-06-26,9686
3481,群創,100,79,21,富邦-宜蘭,2023-06-26,9686
5340,建榮,24,3,21,富邦-宜蘭,2023-06-26,9686
1319,東陽,23,2,21,富邦-宜蘭,2023-06-26,9686
2881,富邦金,20,0,20,富邦-宜蘭,2023-06-26,9686
3682,亞太電,20,0,20,富邦-宜蘭,2023-06-26,9686
3434,哲固,20,0,20,富邦-宜蘭,2023-06-26,9686
6163,華電網,20,0,20,富邦-宜蘭,2023-06-26,9686
00900,富邦特選高股息30,20,0,20,富邦-宜蘭,2023-06-26,9686
2354,鴻準,40,20,20,富邦-宜蘭,2023-06-26,9686
2705,六福,26,7,19,富邦-宜蘭,2023-06-26,9686
2867,三商壽,19,1,18,富邦-宜蘭,2023-06-26,9686
2883,凱基金,25,7,18,富邦-宜蘭,2023-06-26,9686
00902,中信電池及儲能,18,0,18,富邦-宜蘭,2023-06-26,9686
1227,佳格,20,2,18,富邦-宜蘭,2023-06-26,9686
1101,台泥,21,3,18,富邦-宜蘭,2023-06-26,9686
3252,海灣,18,1,17,富邦-宜蘭,2023-06-26,9686
6116,彩晶,26,9,17,富邦-宜蘭,2023-06-26,9686
00712,復華富時不動產,22,5,17,富邦-宜蘭,2023-06-26,9686
00878,國泰永續高股息,31,14,17,富邦-宜蘭,2023-06-26,9686
2352,佳世達,19,3,16,富邦-宜蘭,2023-06-26,9686
2489,瑞軒,17,1,16,富邦-宜蘭,2023-06-26,9686
2303,聯電,373,11,362,富邦-宜蘭,2023-06-27,9686
00929,復華台灣科技優息,164,3,161,富邦-宜蘭,2023-06-27,9686
0056,元大高股息,132,36,96,富邦-宜蘭,2023-06-27,9686
2610,華航,194,135,59,富邦-宜蘭,2023-06-27,9686
3078,僑威,69,10,59,富邦-宜蘭,2023-06-27,9686
3706,神達,65,8,57,富邦-宜蘭,2023-06-27,9686
1907,永豐餘,51,1,50,富邦-宜蘭,2023-06-27,9686
2867,三商壽,56,6,50,富邦-宜蘭,2023-06-27,9686
2427,三商電,122,73,49,富邦-宜蘭,2023-06-27,9686
2618,長榮航,126,84,42,富邦-宜蘭,2023-06-27,9686
2409,友達,41,1,40,富邦-宜蘭,2023-06-27,9686
1605,華新,57,19,38,富邦-宜蘭,2023-06-27,9686
1444,力麗,35,0,35,富邦-宜蘭,2023-06-27,9686
1301,台塑,31,0,31,富邦-宜蘭,2023-06-27,9686
1701,中化,32,1,31,富邦-宜蘭,2023-06-27,9686
6441,廣錠,31,0,31,富邦-宜蘭,2023-06-27,9686
3607,谷崧,30,0,30,富邦-宜蘭,2023-06-27,9686
3035,智原,33,4,29,富邦-宜蘭,2023-06-27,9686
00919,群益台灣精選高息,29,0,29,富邦-宜蘭,2023-06-27,9686
2323,中環,99,71,28,富邦-宜蘭,2023-06-27,9686
4566,時碩工業,27,0,27,富邦-宜蘭,2023-06-27,9686
3479,安勤,27,0,27,富邦-宜蘭,2023-06-27,9686
3202,樺晟,35,9,26,富邦-宜蘭,2023-06-27,9686
6188,廣明,30,5,25,富邦-宜蘭,2023-06-27,9686
6266,泰詠,24,0,24,富邦-宜蘭,2023-06-27,9686
6276,安鈦克,33,9,24,富邦-宜蘭,2023-06-27,9686
4111,濟生,23,0,23,富邦-宜蘭,2023-06-27,9686
3712,永崴投控,22,0,22,富邦-宜蘭,2023-06-27,9686
6788,華景電,22,0,22,富邦-宜蘭,2023-06-27,9686
6116,彩晶,50,28,22,富邦-宜蘭,2023-06-27,9686
1504,東元,29,8,21,富邦-宜蘭,2023-06-27,9686
1471,首利,36,15,21,富邦-宜蘭,2023-06-27,9686
00751B,元大AAA至A公司債,21,0,21,富邦-宜蘭,2023-06-27,9686
2891,中信金,24,3,21,富邦-宜蘭,2023-06-27,9686
8034,榮群,26,5,21,富邦-宜蘭,2023-06-27,9686
2913,農林,21,1,20,富邦-宜蘭,2023-06-27,9686
3260,威剛,27,7,20,富邦-宜蘭,2023-06-27,9686
00902,中信電池及儲能,20,0,20,富邦-宜蘭,2023-06-27,9686
2356,英業達,38,19,19,富邦-宜蘭,2023-06-27,9686
3252,海灣,34,15,19,富邦-宜蘭,2023-06-27,9686
2888,新光金,37,18,19,富邦-宜蘭,2023-06-27,9686
2401,凌陽,22,4,18,富邦-宜蘭,2023-06-27,9686
2362,藍天,20,2,18,富邦-宜蘭,2023-06-27,9686
1904,正隆,45,27,18,富邦-宜蘭,2023-06-27,9686
2302,麗正,20,2,18,富邦-宜蘭,2023-06-27,9686
2353,宏��,23,6,17,富邦-宜蘭,2023-06-27,9686
2748,雲品,25,8,17,富邦-宜蘭,2023-06-27,9686
2344,華邦電,50,33,17,富邦-宜蘭,2023-06-27,9686
3687,歐買尬,47,30,17,富邦-宜蘭,2023-06-27,9686
00740B,富邦全球投等債,16,0,16,富邦-宜蘭,2023-06-27,9686
2897,王道銀行,350,1,349,富邦-宜蘭,2023-06-28,9686
00715L,期街口布蘭特正2,161,1,160,富邦-宜蘭,2023-06-28,9686
1605,華新,144,27,117,富邦-宜蘭,2023-06-28,9686
6179,亞通,118,13,105,富邦-宜蘭,2023-06-28,9686
6163,華電網,55,0,55,富邦-宜蘭,2023-06-28,9686
2867,三商壽,50,0,50,富邦-宜蘭,2023-06-28,9686
2409,友達,58,8,50,富邦-宜蘭,2023-06-28,9686
2610,華航,105,61,44,富邦-宜蘭,2023-06-28,9686
3049,精金,46,2,44,富邦-宜蘭,2023-06-28,9686
3481,群創,69,29,40,富邦-宜蘭,2023-06-28,9686
2356,英業達,60,21,39,富邦-宜蘭,2023-06-28,9686
2609,陽明,44,6,38,富邦-宜蘭,2023-06-28,9686
6788,華景電,40,5,35,富邦-宜蘭,2023-06-28,9686
6276,安鈦克,40,6,34,富邦-宜蘭,2023-06-28,9686
2468,華經,33,0,33,富邦-宜蘭,2023-06-28,9686
2014,中鴻,33,1,32,富邦-宜蘭,2023-06-28,9686
3532,台勝科,28,0,28,富邦-宜蘭,2023-06-28,9686
00712,復華富時不動產,43,15,28,富邦-宜蘭,2023-06-28,9686
2630,亞航,30,5,25,富邦-宜蘭,2023-06-28,9686
3706,神達,34,9,25,富邦-宜蘭,2023-06-28,9686
3078,僑威,38,14,24,富邦-宜蘭,2023-06-28,9686
3011,今皓,27,6,21,富邦-宜蘭,2023-06-28,9686
2606,裕民,19,0,19,富邦-宜蘭,2023-06-28,9686
00919,群益台灣精選高息,21,3,18,富邦-宜蘭,2023-06-28,9686
8450,霹靂,33,15,18,富邦-宜蘭,2023-06-28,9686
3264,欣銓,42,24,18,富邦-宜蘭,2023-06-28,9686
2303,聯電,19,2,17,富邦-宜蘭,2023-06-28,9686
1471,首利,26,9,17,富邦-宜蘭,2023-06-28,9686
3576,聯合再生,24,7,17,富邦-宜蘭,2023-06-28,9686
6263,普萊德,16,0,16,富邦-宜蘭,2023-06-28,9686
4746,台耀,53,37,16,富邦-宜蘭,2023-06-28,9686
00900,富邦特選高股息30,22,7,15,富邦-宜蘭,2023-06-28,9686
2603,長榮,34,19,15,富邦-宜蘭,2023-06-28,9686
6116,彩晶,16,2,14,富邦-宜蘭,2023-06-28,9686
2736,富野,17,3,14,富邦-宜蘭,2023-06-28,9686
2913,農林,15,1,14,富邦-宜蘭,2023-06-28,9686
3037,欣興,34,20,14,富邦-宜蘭,2023-06-28,9686
6695,芯鼎,13,0,13,富邦-宜蘭,2023-06-28,9686
00665L,富邦�琤肭磪囓�2,25,12,13,富邦-宜蘭,2023-06-28,9686
2887,台新金,13,0,13,富邦-宜蘭,2023-06-28,9686
8086,宏捷科,14,2,12,富邦-宜蘭,2023-06-28,9686
8936,國統,12,1,11,富邦-宜蘭,2023-06-28,9686
00687B,國泰20年美債,12,1,11,富邦-宜蘭,2023-06-28,9686
910861,神州-DR,11,0,11,富邦-宜蘭,2023-06-28,9686
3189,景碩,15,4,11,富邦-宜蘭,2023-06-28,9686
4167,松瑞藥,12,1,11,富邦-宜蘭,2023-06-28,9686
3083,網龍,25,14,11,富邦-宜蘭,2023-06-28,9686
3033,威健,11,1,10,富邦-宜蘭,2023-06-28,9686
1609,大亞,17,7,10,富邦-宜蘭,2023-06-28,9686
8038,長園科,10,0,10,富邦-宜蘭,2023-06-28,9686
1605,華新,192,22,170,富邦-宜蘭,2023-06-29,9686
6770,力積電,102,4,98,富邦-宜蘭,2023-06-29,9686
2888,新光金,81,4,77,富邦-宜蘭,2023-06-29,9686
2303,聯電,80,5,75,富邦-宜蘭,2023-06-29,9686
2419,仲琦,137,84,53,富邦-宜蘭,2023-06-29,9686
4414,如興,52,0,52,富邦-宜蘭,2023-06-29,9686
6125,廣運,61,11,50,富邦-宜蘭,2023-06-29,9686
2610,華航,109,60,49,富邦-宜蘭,2023-06-29,9686
5222,全訊,41,0,41,富邦-宜蘭,2023-06-29,9686
8034,榮群,41,0,41,富邦-宜蘭,2023-06-29,9686
2340,台亞,36,2,34,富邦-宜蘭,2023-06-29,9686
2887,台新金,33,2,31,富邦-宜蘭,2023-06-29,9686
2885,元大金,30,0,30,富邦-宜蘭,2023-06-29,9686
5465,富驊,31,2,29,富邦-宜蘭,2023-06-29,9686
2409,友達,32,4,28,富邦-宜蘭,2023-06-29,9686
5608,四維航,28,0,28,富邦-宜蘭,2023-06-29,9686
2412,中華電,27,0,27,富邦-宜蘭,2023-06-29,9686
9105,泰金寶-DR,25,0,25,富邦-宜蘭,2023-06-29,9686
2317,鴻海,27,5,22,富邦-宜蘭,2023-06-29,9686
6217,中探針,23,2,21,富邦-宜蘭,2023-06-29,9686
6120,達運,21,1,20,富邦-宜蘭,2023-06-29,9686
3083,網龍,20,1,19,富邦-宜蘭,2023-06-29,9686
2323,中環,23,5,18,富邦-宜蘭,2023-06-29,9686
2014,中鴻,23,5,18,富邦-宜蘭,2023-06-29,9686
4157,太景*-KY,42,25,17,富邦-宜蘭,2023-06-29,9686
3481,群創,41,24,17,富邦-宜蘭,2023-06-29,9686
4155,訊映,17,1,16,富邦-宜蘭,2023-06-29,9686
2027,大成鋼,17,1,16,富邦-宜蘭,2023-06-29,9686
2618,長榮航,98,83,15,富邦-宜蘭,2023-06-29,9686
2353,宏��,16,1,15,富邦-宜蘭,2023-06-29,9686
3005,神基,16,1,15,富邦-宜蘭,2023-06-29,9686
2356,英業達,36,22,14,富邦-宜蘭,2023-06-29,9686
3027,盛達,17,4,13,富邦-宜蘭,2023-06-29,9686
00900,富邦特選高股息30,15,3,12,富邦-宜蘭,2023-06-29,9686
00712,復華富時不動產,15,3,12,富邦-宜蘭,2023-06-29,9686
7402,邑錡,20,8,12,富邦-宜蘭,2023-06-29,9686
6741,91APP*-KY,31,19,12,富邦-宜蘭,2023-06-29,9686
1909,榮成,12,0,12,富邦-宜蘭,2023-06-29,9686
2734,易飛網,18,6,12,富邦-宜蘭,2023-06-29,9686
00882,中信中國高股息,11,0,11,富邦-宜蘭,2023-06-29,9686
1905,華紙,41,30,11,富邦-宜蘭,2023-06-29,9686
2705,六福,13,2,11,富邦-宜蘭,2023-06-29,9686
1711,永光,11,0,11,富邦-宜蘭,2023-06-29,9686
3032,偉訓,27,17,10,富邦-宜蘭,2023-06-29,9686
3622,洋華,10,0,10,富邦-宜蘭,2023-06-29,9686
2702,華園,10,0,10,富邦-宜蘭,2023-06-29,9686
3041,揚智,10,0,10,富邦-宜蘭,2023-06-29,9686
6176,瑞儀,10,0,10,富邦-宜蘭,2023-06-29,9686
4915,致伸,22,12,10,富邦-宜蘭,2023-06-29,9686
3682,亞太電,10,0,10,富邦-宜蘭,2023-06-29,9686
2324,仁寶,112,0,112,富邦-宜蘭,2023-06-30,9686
8105,凌巨,106,1,105,富邦-宜蘭,2023-06-30,9686
1605,華新,153,71,82,富邦-宜蘭,2023-06-30,9686
2618,長榮航,173,95,78,富邦-宜蘭,2023-06-30,9686
2603,長榮,151,107,44,富邦-宜蘭,2023-06-30,9686
2462,良得電,44,0,44,富邦-宜蘭,2023-06-30,9686
2412,中華電,45,1,44,富邦-宜蘭,2023-06-30,9686
2883,凱基金,41,0,41,富邦-宜蘭,2023-06-30,9686
4543,萬在,42,3,39,富邦-宜蘭,2023-06-30,9686
9958,世紀鋼,48,12,36,富邦-宜蘭,2023-06-30,9686
3049,精金,38,3,35,富邦-宜蘭,2023-06-30,9686
00751B,元大AAA至A公司債,33,0,33,富邦-宜蘭,2023-06-30,9686
4121,優盛,38,7,31,富邦-宜蘭,2023-06-30,9686
6163,華電網,28,0,28,富邦-宜蘭,2023-06-30,9686
2344,華邦電,30,3,27,富邦-宜蘭,2023-06-30,9686
2353,宏��,26,0,26,富邦-宜蘭,2023-06-30,9686
3260,威剛,32,6,26,富邦-宜蘭,2023-06-30,9686
00673R,期元大S＆P原油反1,25,0,25,富邦-宜蘭,2023-06-30,9686
1720,生達,23,0,23,富邦-宜蘭,2023-06-30,9686
2206,三陽工業,34,13,21,富邦-宜蘭,2023-06-30,9686
00679B,元大美債20年,24,3,21,富邦-宜蘭,2023-06-30,9686
6188,廣明,34,13,21,富邦-宜蘭,2023-06-30,9686
2002,中鋼,20,0,20,富邦-宜蘭,2023-06-30,9686
2408,南亞科,21,1,20,富邦-宜蘭,2023-06-30,9686
2736,富野,26,6,20,富邦-宜蘭,2023-06-30,9686
00885,富邦越南,34,15,19,富邦-宜蘭,2023-06-30,9686
6441,廣錠,20,1,19,富邦-宜蘭,2023-06-30,9686
00878,國泰永續高股息,19,2,17,富邦-宜蘭,2023-06-30,9686
00720B,元大投資級公司債,16,0,16,富邦-宜蘭,2023-06-30,9686
00680L,元大美債20正2,15,0,15,富邦-宜蘭,2023-06-30,9686
2913,農林,16,2,14,富邦-宜蘭,2023-06-30,9686
3711,日月光投控,15,2,13,富邦-宜蘭,2023-06-30,9686
1513,中興電,29,16,13,富邦-宜蘭,2023-06-30,9686
4175,杏一,16,3,13,富邦-宜蘭,2023-06-30,9686
5608,四維航,15,2,13,富邦-宜蘭,2023-06-30,9686
1101,台泥,24,12,12,富邦-宜蘭,2023-06-30,9686
00687B,國泰20年美債,14,2,12,富邦-宜蘭,2023-06-30,9686
00929,復華台灣科技優息,13,1,12,富邦-宜蘭,2023-06-30,9686
1409,新纖,12,0,12,富邦-宜蘭,2023-06-30,9686
2025,千興,12,0,12,富邦-宜蘭,2023-06-30,9686
8034,榮群,13,2,11,富邦-宜蘭,2023-06-30,9686
3712,永崴投控,11,0,11,富邦-宜蘭,2023-06-30,9686
6732,昇佳電子,11,0,11,富邦-宜蘭,2023-06-30,9686
1301,台塑,11,0,11,富邦-宜蘭,2023-06-30,9686
1589,永冠-KY,11,0,11,富邦-宜蘭,2023-06-30,9686
2881,富邦金,10,0,10,富邦-宜蘭,2023-06-30,9686
6185,幃翔,17,7,10,富邦-宜蘭,2023-06-30,9686
6167,久正,10,0,10,富邦-宜蘭,2023-06-30,9686
3252,海灣,13,3,10,富邦-宜蘭,2023-06-30,9686
2883B,凱基金乙特,10,0,10,富邦-宜蘭,2023-06-30,9686
4532,瑞智,247,37,210,富邦-宜蘭,2023-07-03,9686
00673R,期元大S＆P原油反1,162,0,162,富邦-宜蘭,2023-07-03,9686
2419,仲琦,74,8,66,富邦-宜蘭,2023-07-03,9686
4533,協易機,63,0,63,富邦-宜蘭,2023-07-03,9686
6276,安鈦克,74,13,61,富邦-宜蘭,2023-07-03,9686
6125,廣運,64,11,53,富邦-宜蘭,2023-07-03,9686
3231,緯創,78,32,46,富邦-宜蘭,2023-07-03,9686
5512,力麒,42,1,41,富邦-宜蘭,2023-07-03,9686
00900,富邦特選高股息30,53,12,41,富邦-宜蘭,2023-07-03,9686
2206,三陽工業,56,15,41,富邦-宜蘭,2023-07-03,9686
5009,榮剛,43,5,38,富邦-宜蘭,2023-07-03,9686
2883,凱基金,41,4,37,富邦-宜蘭,2023-07-03,9686
00922,國泰台灣領袖50,41,4,37,富邦-宜蘭,2023-07-03,9686
6282,康舒,66,31,35,富邦-宜蘭,2023-07-03,9686
2615,萬海,54,19,35,富邦-宜蘭,2023-07-03,9686
1611,中電,44,12,32,富邦-宜蘭,2023-07-03,9686
5426,振發,33,3,30,富邦-宜蘭,2023-07-03,9686
4173,久裕,26,1,25,富邦-宜蘭,2023-07-03,9686
8404,百和興業-KY,25,0,25,富邦-宜蘭,2023-07-03,9686
3202,樺晟,23,0,23,富邦-宜蘭,2023-07-03,9686
3018,隆銘綠能,23,0,23,富邦-宜蘭,2023-07-03,9686
4155,訊映,27,4,23,富邦-宜蘭,2023-07-03,9686
6116,彩晶,60,39,21,富邦-宜蘭,2023-07-03,9686
00898,國泰基因免疫革命,20,0,20,富邦-宜蘭,2023-07-03,9686
6111,大宇資,27,7,20,富邦-宜蘭,2023-07-03,9686
5340,建榮,20,0,20,富邦-宜蘭,2023-07-03,9686
3622,洋華,20,0,20,富邦-宜蘭,2023-07-03,9686
5258,虹堡,30,11,19,富邦-宜蘭,2023-07-03,9686
6188,廣明,82,66,16,富邦-宜蘭,2023-07-03,9686
9945,潤泰新,16,0,16,富邦-宜蘭,2023-07-03,9686
2610,華航,48,32,16,富邦-宜蘭,2023-07-03,9686
3207,耀勝,19,3,16,富邦-宜蘭,2023-07-03,9686
3046,建��,17,1,16,富邦-宜蘭,2023-07-03,9686
1609,大亞,52,36,16,富邦-宜蘭,2023-07-03,9686
2412,中華電,16,1,15,富邦-宜蘭,2023-07-03,9686
2409,友達,13,0,13,富邦-宜蘭,2023-07-03,9686
8038,長園科,13,0,13,富邦-宜蘭,2023-07-03,9686
6122,擎邦,18,5,13,富邦-宜蘭,2023-07-03,9686
2603,長榮,59,47,12,富邦-宜蘭,2023-07-03,9686
2023,燁輝,12,0,12,富邦-宜蘭,2023-07-03,9686
5302,太欣,12,0,12,富邦-宜蘭,2023-07-03,9686
2428,興勤,12,0,12,富邦-宜蘭,2023-07-03,9686
3017,奇鋐,17,5,12,富邦-宜蘭,2023-07-03,9686
1608,華榮,12,0,12,富邦-宜蘭,2023-07-03,9686
4164,承業醫,11,0,11,富邦-宜蘭,2023-07-03,9686
6275,元山,12,1,11,富邦-宜蘭,2023-07-03,9686
2441,超豐,11,0,11,富邦-宜蘭,2023-07-03,9686
2408,南亞科,11,0,11,富邦-宜蘭,2023-07-03,9686
6217,中探針,17,6,11,富邦-宜蘭,2023-07-03,9686
6485,點序,12,1,11,富邦-宜蘭,2023-07-03,9686
2883,凱基金,320,1,319,富邦-宜蘭,2023-07-04,9686
2317,鴻海,240,9,231,富邦-宜蘭,2023-07-04,9686
00632R,元大台灣50反1,106,0,106,富邦-宜蘭,2023-07-04,9686
8105,凌巨,100,8,92,富邦-宜蘭,2023-07-04,9686
1710,東聯,63,0,63,富邦-宜蘭,2023-07-04,9686
2887,台新金,60,0,60,富邦-宜蘭,2023-07-04,9686
2603,長榮,130,73,57,富邦-宜蘭,2023-07-04,9686
3013,晟銘電,96,45,51,富邦-宜蘭,2023-07-04,9686
1605,華新,72,21,51,富邦-宜蘭,2023-07-04,9686
1467,南緯,50,0,50,富邦-宜蘭,2023-07-04,9686
3252,海灣,46,0,46,富邦-宜蘭,2023-07-04,9686
00713,元大台灣高息低波,47,1,46,富邦-宜蘭,2023-07-04,9686
3702,大聯大,43,0,43,富邦-宜蘭,2023-07-04,9686
00650L,復華香港正2,40,1,39,富邦-宜蘭,2023-07-04,9686
1301,台塑,38,1,37,富邦-宜蘭,2023-07-04,9686
2312,金寶,116,80,36,富邦-宜蘭,2023-07-04,9686
1101,台泥,36,2,34,富邦-宜蘭,2023-07-04,9686
2399,映泰,59,27,32,富邦-宜蘭,2023-07-04,9686
2618,長榮航,70,39,31,富邦-宜蘭,2023-07-04,9686
8403,盛弘,35,4,31,富邦-宜蘭,2023-07-04,9686
6125,廣運,47,16,31,富邦-宜蘭,2023-07-04,9686
5340,建榮,28,0,28,富邦-宜蘭,2023-07-04,9686
3049,精金,35,8,27,富邦-宜蘭,2023-07-04,9686
0056,元大高股息,79,54,25,富邦-宜蘭,2023-07-04,9686
1513,中興電,29,5,24,富邦-宜蘭,2023-07-04,9686
3362,先進光,25,1,24,富邦-宜蘭,2023-07-04,9686
2027,大成鋼,23,0,23,富邦-宜蘭,2023-07-04,9686
8033,雷虎,25,2,23,富邦-宜蘭,2023-07-04,9686
3090,日電貿,22,0,22,富邦-宜蘭,2023-07-04,9686
020038,元大ESG配息N,21,0,21,富邦-宜蘭,2023-07-04,9686
2609,陽明,146,126,20,富邦-宜蘭,2023-07-04,9686
2337,旺宏,20,0,20,富邦-宜蘭,2023-07-04,9686
00687B,國泰20年美債,20,0,20,富邦-宜蘭,2023-07-04,9686
3290,東浦,25,5,20,富邦-宜蘭,2023-07-04,9686
3024,憶聲,20,0,20,富邦-宜蘭,2023-07-04,9686
4157,太景*-KY,21,1,20,富邦-宜蘭,2023-07-04,9686
2888,新光金,30,10,20,富邦-宜蘭,2023-07-04,9686
8404,百和興業-KY,20,0,20,富邦-宜蘭,2023-07-04,9686
00692,富邦公司治理,22,2,20,富邦-宜蘭,2023-07-04,9686
2301,光寶科,65,46,19,富邦-宜蘭,2023-07-04,9686
3062,建漢,19,0,19,富邦-宜蘭,2023-07-04,9686
8183,精星,40,21,19,富邦-宜蘭,2023-07-04,9686
2344,華邦電,23,4,19,富邦-宜蘭,2023-07-04,9686
6263,普萊德,19,0,19,富邦-宜蘭,2023-07-04,9686
3025,星通,61,43,18,富邦-宜蘭,2023-07-04,9686
3217,優群,20,2,18,富邦-宜蘭,2023-07-04,9686
5464,霖宏,18,0,18,富邦-宜蘭,2023-07-04,9686
3704,合勤控,39,23,16,富邦-宜蘭,2023-07-04,9686
1795,美時,23,7,16,富邦-宜蘭,2023-07-04,9686
3380,明泰,19,3,16,富邦-宜蘭,2023-07-04,9686
00929,復華台灣科技優息,118,12,106,富邦-宜蘭,2023-07-05,9686
2356,英業達,210,122,88,富邦-宜蘭,2023-07-05,9686
3013,晟銘電,107,44,63,富邦-宜蘭,2023-07-05,9686
2457,飛宏,81,21,60,富邦-宜蘭,2023-07-05,9686
2317,鴻海,64,12,52,富邦-宜蘭,2023-07-05,9686
3231,緯創,86,43,43,富邦-宜蘭,2023-07-05,9686
2614,東森,54,13,41,富邦-宜蘭,2023-07-05,9686
6111,大宇資,62,23,39,富邦-宜蘭,2023-07-05,9686
00665L,富邦�琤肭磪囓�2,61,24,37,富邦-宜蘭,2023-07-05,9686
1609,大亞,138,102,36,富邦-宜蘭,2023-07-05,9686
00673R,期元大S＆P原油反1,35,0,35,富邦-宜蘭,2023-07-05,9686
2468,華經,33,1,32,富邦-宜蘭,2023-07-05,9686
4904,遠傳,31,0,31,富邦-宜蘭,2023-07-05,9686
2401,凌陽,31,0,31,富邦-宜蘭,2023-07-05,9686
2801,彰銀,29,0,29,富邦-宜蘭,2023-07-05,9686
1905,華紙,77,49,28,富邦-宜蘭,2023-07-05,9686
6578,達邦蛋白,28,0,28,富邦-宜蘭,2023-07-05,9686
3481,群創,29,2,27,富邦-宜蘭,2023-07-05,9686
1101,台泥,28,2,26,富邦-宜蘭,2023-07-05,9686
2329,華泰,81,56,25,富邦-宜蘭,2023-07-05,9686
2618,長榮航,245,220,25,富邦-宜蘭,2023-07-05,9686
1314,中石化,25,0,25,富邦-宜蘭,2023-07-05,9686
00679B,元大美債20年,23,0,23,富邦-宜蘭,2023-07-05,9686
2312,金寶,33,10,23,富邦-宜蘭,2023-07-05,9686
3583,辛耘,25,2,23,富邦-宜蘭,2023-07-05,9686
2014,中鴻,22,0,22,富邦-宜蘭,2023-07-05,9686
2369,菱生,32,10,22,富邦-宜蘭,2023-07-05,9686
2609,陽明,211,189,22,富邦-宜蘭,2023-07-05,9686
4960,誠美材,23,2,21,富邦-宜蘭,2023-07-05,9686
1471,首利,23,2,21,富邦-宜蘭,2023-07-05,9686
6244,茂迪,21,0,21,富邦-宜蘭,2023-07-05,9686
8109,博大,22,1,21,富邦-宜蘭,2023-07-05,9686
2103,台橡,21,0,21,富邦-宜蘭,2023-07-05,9686
5009,榮剛,36,16,20,富邦-宜蘭,2023-07-05,9686
6261,久元,20,0,20,富邦-宜蘭,2023-07-05,9686
2845,遠東銀,20,0,20,富邦-宜蘭,2023-07-05,9686
8050,廣積,34,15,19,富邦-宜蘭,2023-07-05,9686
2929,淘帝-KY,27,8,19,富邦-宜蘭,2023-07-05,9686
8222,寶一,18,0,18,富邦-宜蘭,2023-07-05,9686
1710,東聯,18,0,18,富邦-宜蘭,2023-07-05,9686
9919,康那香,54,37,17,富邦-宜蘭,2023-07-05,9686
3027,盛達,19,2,17,富邦-宜蘭,2023-07-05,9686
2883,凱基金,27,11,16,富邦-宜蘭,2023-07-05,9686
6168,宏齊,29,13,16,富邦-宜蘭,2023-07-05,9686
6605,帝寶,23,7,16,富邦-宜蘭,2023-07-05,9686
2405,輔信,17,1,16,富邦-宜蘭,2023-07-05,9686
8112,至上,19,3,16,富邦-宜蘭,2023-07-05,9686
4114,健喬,16,0,16,富邦-宜蘭,2023-07-05,9686
0056,元大高股息,43,27,16,富邦-宜蘭,2023-07-05,9686
3706,神達,133,117,16,富邦-宜蘭,2023-07-05,9686
2897,王道銀行,471,0,471,富邦-宜蘭,2023-07-06,9686
2801,彰銀,148,0,148,富邦-宜蘭,2023-07-06,9686
2317,鴻海,107,20,87,富邦-宜蘭,2023-07-06,9686
2419,仲琦,80,12,68,富邦-宜蘭,2023-07-06,9686
3013,晟銘電,112,45,67,富邦-宜蘭,2023-07-06,9686
2891,中信金,60,0,60,富邦-宜蘭,2023-07-06,9686
2888,新光金,54,0,54,富邦-宜蘭,2023-07-06,9686
2890,永豐金,53,0,53,富邦-宜蘭,2023-07-06,9686
5009,榮剛,65,12,53,富邦-宜蘭,2023-07-06,9686
8215,明基材,86,34,52,富邦-宜蘭,2023-07-06,9686
00673R,期元大S＆P原油反1,61,10,51,富邦-宜蘭,2023-07-06,9686
3260,威剛,49,1,48,富邦-宜蘭,2023-07-06,9686
1101,台泥,64,16,48,富邦-宜蘭,2023-07-06,9686
00878,國泰永續高股息,72,26,46,富邦-宜蘭,2023-07-06,9686
0056,元大高股息,74,29,45,富邦-宜蘭,2023-07-06,9686
00680L,元大美債20正2,44,0,44,富邦-宜蘭,2023-07-06,9686
8050,廣積,70,27,43,富邦-宜蘭,2023-07-06,9686
3037,欣興,48,5,43,富邦-宜蘭,2023-07-06,9686
2887,台新金,50,10,40,富邦-宜蘭,2023-07-06,9686
2356,英業達,90,52,38,富邦-宜蘭,2023-07-06,9686
2323,中環,110,73,37,富邦-宜蘭,2023-07-06,9686
2882,國泰金,36,0,36,富邦-宜蘭,2023-07-06,9686
6016,康和證,40,4,36,富邦-宜蘭,2023-07-06,9686
2474,可成,36,0,36,富邦-宜蘭,2023-07-06,9686
6169,昱泉,36,0,36,富邦-宜蘭,2023-07-06,9686
2382,廣達,98,63,35,富邦-宜蘭,2023-07-06,9686
4543,萬在,34,2,32,富邦-宜蘭,2023-07-06,9686
2634,漢翔,87,56,31,富邦-宜蘭,2023-07-06,9686
4532,瑞智,105,75,30,富邦-宜蘭,2023-07-06,9686
00751B,元大AAA至A公司債,30,0,30,富邦-宜蘭,2023-07-06,9686
2027,大成鋼,32,2,30,富邦-宜蘭,2023-07-06,9686
00720B,元大投資級公司債,29,0,29,富邦-宜蘭,2023-07-06,9686
1471,首利,70,42,28,富邦-宜蘭,2023-07-06,9686
3362,先進光,49,21,28,富邦-宜蘭,2023-07-06,9686
00882,中信中國高股息,40,12,28,富邦-宜蘭,2023-07-06,9686
6285,啟��,34,8,26,富邦-宜蘭,2023-07-06,9686
1609,大亞,57,32,25,富邦-宜蘭,2023-07-06,9686
2892,第一金,24,0,24,富邦-宜蘭,2023-07-06,9686
2002,中鋼,29,5,24,富邦-宜蘭,2023-07-06,9686
00665L,富邦�琤肭磪囓�2,31,7,24,富邦-宜蘭,2023-07-06,9686
5340,建榮,24,0,24,富邦-宜蘭,2023-07-06,9686
8477,創業家,24,0,24,富邦-宜蘭,2023-07-06,9686
2603,長榮,35,12,23,富邦-宜蘭,2023-07-06,9686
00885,富邦越南,24,2,22,富邦-宜蘭,2023-07-06,9686
2402,毅嘉,49,27,22,富邦-宜蘭,2023-07-06,9686
00753L,中信中國50正2,21,0,21,富邦-宜蘭,2023-07-06,9686
1584,精剛,21,0,21,富邦-宜蘭,2023-07-06,9686
2371,大同,38,17,21,富邦-宜蘭,2023-07-06,9686
1326,台化,20,0,20,富邦-宜蘭,2023-07-06,9686
6441,廣錠,21,1,20,富邦-宜蘭,2023-07-06,9686
2340,台亞,113,4,109,富邦-宜蘭,2023-07-07,9686
00929,復華台灣科技優息,115,18,97,富邦-宜蘭,2023-07-07,9686
6120,達運,85,0,85,富邦-宜蘭,2023-07-07,9686
6111,大宇資,91,13,78,富邦-宜蘭,2023-07-07,9686
2881,富邦金,78,3,75,富邦-宜蘭,2023-07-07,9686
3060,銘異,70,0,70,富邦-宜蘭,2023-07-07,9686
3481,群創,70,13,57,富邦-宜蘭,2023-07-07,9686
0056,元大高股息,71,15,56,富邦-宜蘭,2023-07-07,9686
4510,高鋒,74,23,51,富邦-宜蘭,2023-07-07,9686
2618,長榮航,127,77,50,富邦-宜蘭,2023-07-07,9686
2610,華航,60,13,47,富邦-宜蘭,2023-07-07,9686
3221,台嘉碩,46,0,46,富邦-宜蘭,2023-07-07,9686
2867,三商壽,42,0,42,富邦-宜蘭,2023-07-07,9686
00679B,元大美債20年,42,0,42,富邦-宜蘭,2023-07-07,9686
4532,瑞智,122,83,39,富邦-宜蘭,2023-07-07,9686
2409,友達,42,3,39,富邦-宜蘭,2023-07-07,9686
1710,東聯,36,1,35,富邦-宜蘭,2023-07-07,9686
1101,台泥,50,16,34,富邦-宜蘭,2023-07-07,9686
2380,虹光,36,2,34,富邦-宜蘭,2023-07-07,9686
6220,岳豐,34,0,34,富邦-宜蘭,2023-07-07,9686
2317,鴻海,38,5,33,富邦-宜蘭,2023-07-07,9686
6485,點序,33,1,32,富邦-宜蘭,2023-07-07,9686
8050,廣積,37,5,32,富邦-宜蘭,2023-07-07,9686
00720B,元大投資級公司債,31,0,31,富邦-宜蘭,2023-07-07,9686
6441,廣錠,32,2,30,富邦-宜蘭,2023-07-07,9686
3049,精金,30,0,30,富邦-宜蘭,2023-07-07,9686
2344,華邦電,33,4,29,富邦-宜蘭,2023-07-07,9686
4976,佳凌,28,0,28,富邦-宜蘭,2023-07-07,9686
2603,長榮,40,13,27,富邦-宜蘭,2023-07-07,9686
3260,威剛,34,7,27,富邦-宜蘭,2023-07-07,9686
00882,中信中國高股息,30,3,27,富邦-宜蘭,2023-07-07,9686
2402,毅嘉,26,1,25,富邦-宜蘭,2023-07-07,9686
2356,英業達,79,55,24,富邦-宜蘭,2023-07-07,9686
00665L,富邦�琤肭磪囓�2,44,20,24,富邦-宜蘭,2023-07-07,9686
00753L,中信中國50正2,31,8,23,富邦-宜蘭,2023-07-07,9686
2401,凌陽,25,2,23,富邦-宜蘭,2023-07-07,9686
2002,中鋼,23,0,23,富邦-宜蘭,2023-07-07,9686
2368,金像電,41,19,22,富邦-宜蘭,2023-07-07,9686
4114,健喬,22,0,22,富邦-宜蘭,2023-07-07,9686
2880,華南金,21,0,21,富邦-宜蘭,2023-07-07,9686
3535,晶彩科,21,0,21,富邦-宜蘭,2023-07-07,9686
2929,淘帝-KY,21,0,21,富邦-宜蘭,2023-07-07,9686
5457,宣德,21,0,21,富邦-宜蘭,2023-07-07,9686
1312,國喬,21,0,21,富邦-宜蘭,2023-07-07,9686
2460,建通,20,0,20,富邦-宜蘭,2023-07-07,9686
1605,華新,31,11,20,富邦-宜蘭,2023-07-07,9686
6117,迎廣,26,6,20,富邦-宜蘭,2023-07-07,9686
2845,遠東銀,20,0,20,富邦-宜蘭,2023-07-07,9686
3450,聯鈞,20,0,20,富邦-宜蘭,2023-07-07,9686
2883,凱基金,36,16,20,富邦-宜蘭,2023-07-07,9686
3481,群創,536,38,498,富邦-宜蘭,2023-07-10,9686
00673R,期元大S＆P原油反1,440,2,438,富邦-宜蘭,2023-07-10,9686
4707,磐亞,402,5,397,富邦-宜蘭,2023-07-10,9686
00664R,國泰臺灣加權反1,200,0,200,富邦-宜蘭,2023-07-10,9686
2883,凱基金,139,17,122,富邦-宜蘭,2023-07-10,9686
00676R,富邦臺灣加權反1,100,0,100,富邦-宜蘭,2023-07-10,9686
2609,陽明,103,42,61,富邦-宜蘭,2023-07-10,9686
1101,台泥,72,21,51,富邦-宜蘭,2023-07-10,9686
2365,昆盈,50,0,50,富邦-宜蘭,2023-07-10,9686
4510,高鋒,52,3,49,富邦-宜蘭,2023-07-10,9686
1471,首利,48,1,47,富邦-宜蘭,2023-07-10,9686
2356,英業達,113,69,44,富邦-宜蘭,2023-07-10,9686
2419,仲琦,55,11,44,富邦-宜蘭,2023-07-10,9686
00929,復華台灣科技優息,42,0,42,富邦-宜蘭,2023-07-10,9686
00882,中信中國高股息,41,0,41,富邦-宜蘭,2023-07-10,9686
2615,萬海,55,14,41,富邦-宜蘭,2023-07-10,9686
2618,長榮航,64,23,41,富邦-宜蘭,2023-07-10,9686
2801,彰銀,40,0,40,富邦-宜蘭,2023-07-10,9686
8093,保銳,38,0,38,富邦-宜蘭,2023-07-10,9686
3704,合勤控,35,3,32,富邦-宜蘭,2023-07-10,9686
6282,康舒,72,42,30,富邦-宜蘭,2023-07-10,9686
2344,華邦電,33,4,29,富邦-宜蘭,2023-07-10,9686
00927,群益半導體收益,29,0,29,富邦-宜蘭,2023-07-10,9686
2342,茂矽,31,2,29,富邦-宜蘭,2023-07-10,9686
6111,大宇資,38,9,29,富邦-宜蘭,2023-07-10,9686
00679B,元大美債20年,29,0,29,富邦-宜蘭,2023-07-10,9686
1504,東元,29,2,27,富邦-宜蘭,2023-07-10,9686
2603,長榮,36,10,26,富邦-宜蘭,2023-07-10,9686
2845,遠東銀,25,0,25,富邦-宜蘭,2023-07-10,9686
3025,星通,64,41,23,富邦-宜蘭,2023-07-10,9686
2633,台灣高鐵,22,0,22,富邦-宜蘭,2023-07-10,9686
8034,榮群,30,8,22,富邦-宜蘭,2023-07-10,9686
3707,漢磊,55,33,22,富邦-宜蘭,2023-07-10,9686
1337,再生-KY,22,1,21,富邦-宜蘭,2023-07-10,9686
2337,旺宏,21,1,20,富邦-宜蘭,2023-07-10,9686
3047,訊舟,25,5,20,富邦-宜蘭,2023-07-10,9686
2542,興富發,20,0,20,富邦-宜蘭,2023-07-10,9686
0056,元大高股息,29,10,19,富邦-宜蘭,2023-07-10,9686
3545,敦泰,19,0,19,富邦-宜蘭,2023-07-10,9686
2413,環科,19,1,18,富邦-宜蘭,2023-07-10,9686
2481,強茂,24,7,17,富邦-宜蘭,2023-07-10,9686
1217,愛之味,32,15,17,富邦-宜蘭,2023-07-10,9686
3324,雙鴻,18,2,16,富邦-宜蘭,2023-07-10,9686
5521,工信,16,1,15,富邦-宜蘭,2023-07-10,9686
3252,海灣,16,1,15,富邦-宜蘭,2023-07-10,9686
2317,鴻海,22,8,14,富邦-宜蘭,2023-07-10,9686
00722B,群益投資級電信債,14,0,14,富邦-宜蘭,2023-07-10,9686
6188,廣明,15,1,14,富邦-宜蘭,2023-07-10,9686
3114,好德,16,2,14,富邦-宜蘭,2023-07-10,9686
3346,麗清,24,10,14,富邦-宜蘭,2023-07-10,9686
00632R,元大台灣50反1,520,1,519,富邦-宜蘭,2023-07-11,9686
0056,元大高股息,154,48,106,富邦-宜蘭,2023-07-11,9686
2365,昆盈,90,0,90,富邦-宜蘭,2023-07-11,9686
1605,華新,91,9,82,富邦-宜蘭,2023-07-11,9686
6282,康舒,88,23,65,富邦-宜蘭,2023-07-11,9686
6142,友勁,66,5,61,富邦-宜蘭,2023-07-11,9686
1905,華紙,48,3,45,富邦-宜蘭,2023-07-11,9686
2609,陽明,66,23,43,富邦-宜蘭,2023-07-11,9686
2323,中環,95,55,40,富邦-宜蘭,2023-07-11,9686
00650L,復華香港正2,40,0,40,富邦-宜蘭,2023-07-11,9686
6203,海韻電,33,1,32,富邦-宜蘭,2023-07-11,9686
5457,宣德,31,1,30,富邦-宜蘭,2023-07-11,9686
2603,長榮,47,18,29,富邦-宜蘭,2023-07-11,9686
3078,僑威,36,7,29,富邦-宜蘭,2023-07-11,9686
3013,晟銘電,40,11,29,富邦-宜蘭,2023-07-11,9686
2303,聯電,35,8,27,富邦-宜蘭,2023-07-11,9686
00885,富邦越南,36,9,27,富邦-宜蘭,2023-07-11,9686
3576,聯合再生,36,9,27,富邦-宜蘭,2023-07-11,9686
5009,榮剛,26,0,26,富邦-宜蘭,2023-07-11,9686
00688L,國泰20年美債正2,25,0,25,富邦-宜蘭,2023-07-11,9686
3058,立德,24,0,24,富邦-宜蘭,2023-07-11,9686
00753L,中信中國50正2,49,25,24,富邦-宜蘭,2023-07-11,9686
1101,台泥,41,17,24,富邦-宜蘭,2023-07-11,9686
6016,康和證,25,2,23,富邦-宜蘭,2023-07-11,9686
2312,金寶,28,5,23,富邦-宜蘭,2023-07-11,9686
2457,飛宏,39,17,22,富邦-宜蘭,2023-07-11,9686
2482,連宇,33,12,21,富邦-宜蘭,2023-07-11,9686
5464,霖宏,21,0,21,富邦-宜蘭,2023-07-11,9686
2929,淘帝-KY,23,2,21,富邦-宜蘭,2023-07-11,9686
4934,太極,99,78,21,富邦-宜蘭,2023-07-11,9686
3532,台勝科,22,2,20,富邦-宜蘭,2023-07-11,9686
8071,能率網通,20,0,20,富邦-宜蘭,2023-07-11,9686
2413,環科,21,1,20,富邦-宜蘭,2023-07-11,9686
3052,夆典,25,5,20,富邦-宜蘭,2023-07-11,9686
6589,台康生技,19,0,19,富邦-宜蘭,2023-07-11,9686
3035,智原,70,52,18,富邦-宜蘭,2023-07-11,9686
00673R,期元大S＆P原油反1,16,0,16,富邦-宜蘭,2023-07-11,9686
1806,冠軍,34,18,16,富邦-宜蘭,2023-07-11,9686
4906,正文,15,0,15,富邦-宜蘭,2023-07-11,9686
6111,大宇資,33,18,15,富邦-宜蘭,2023-07-11,9686
4532,瑞智,37,22,15,富邦-宜蘭,2023-07-11,9686
3707,漢磊,59,45,14,富邦-宜蘭,2023-07-11,9686
3540,曜越,15,2,13,富邦-宜蘭,2023-07-11,9686
4526,東台,21,8,13,富邦-宜蘭,2023-07-11,9686
3363,上詮,20,7,13,富邦-宜蘭,2023-07-11,9686
6509,聚和,15,2,13,富邦-宜蘭,2023-07-11,9686
3032,偉訓,12,0,12,富邦-宜蘭,2023-07-11,9686
3324,雙鴻,16,4,12,富邦-宜蘭,2023-07-11,9686
3034,聯詠,13,1,12,富邦-宜蘭,2023-07-11,9686
2359,所羅門,12,1,11,富邦-宜蘭,2023-07-11,9686
00673R,期元大S＆P原油反1,623,5,618,富邦-宜蘭,2023-07-12,9686
6111,大宇資,113,1,112,富邦-宜蘭,2023-07-12,9686
2603,長榮,121,10,111,富邦-宜蘭,2023-07-12,9686
2365,昆盈,91,0,91,富邦-宜蘭,2023-07-12,9686
2425,承啟,77,1,76,富邦-宜蘭,2023-07-12,9686
4532,瑞智,116,60,56,富邦-宜蘭,2023-07-12,9686
2323,中環,60,6,54,富邦-宜蘭,2023-07-12,9686
5475,德宏,53,0,53,富邦-宜蘭,2023-07-12,9686
1417,嘉裕,50,0,50,富邦-宜蘭,2023-07-12,9686
1101,台泥,54,5,49,富邦-宜蘭,2023-07-12,9686
2481,強茂,174,129,45,富邦-宜蘭,2023-07-12,9686
3481,群創,47,9,38,富邦-宜蘭,2023-07-12,9686
1471,首利,42,5,37,富邦-宜蘭,2023-07-12,9686
4164,承業醫,39,2,37,富邦-宜蘭,2023-07-12,9686
6282,康舒,85,48,37,富邦-宜蘭,2023-07-12,9686
3231,緯創,63,30,33,富邦-宜蘭,2023-07-12,9686
2615,萬海,33,2,31,富邦-宜蘭,2023-07-12,9686
00885,富邦越南,31,0,31,富邦-宜蘭,2023-07-12,9686
2883,凱基金,37,6,31,富邦-宜蘭,2023-07-12,9686
2641,正德,31,0,31,富邦-宜蘭,2023-07-12,9686
2609,陽明,117,88,29,富邦-宜蘭,2023-07-12,9686
6116,彩晶,27,0,27,富邦-宜蘭,2023-07-12,9686
3189,景碩,45,18,27,富邦-宜蘭,2023-07-12,9686
2303,聯電,29,3,26,富邦-宜蘭,2023-07-12,9686
2489,瑞軒,27,1,26,富邦-宜蘭,2023-07-12,9686
00905,FT臺灣Smart,25,1,24,富邦-宜蘭,2023-07-12,9686
1905,華紙,23,0,23,富邦-宜蘭,2023-07-12,9686
2367,燿華,23,1,22,富邦-宜蘭,2023-07-12,9686
6215,和椿,21,0,21,富邦-宜蘭,2023-07-12,9686
4746,台耀,23,3,20,富邦-宜蘭,2023-07-12,9686
6441,廣錠,20,0,20,富邦-宜蘭,2023-07-12,9686
6142,友勁,21,1,20,富邦-宜蘭,2023-07-12,9686
1504,東元,22,3,19,富邦-宜蘭,2023-07-12,9686
6120,達運,57,38,19,富邦-宜蘭,2023-07-12,9686
8070,長華*,18,0,18,富邦-宜蘭,2023-07-12,9686
8404,百和興業-KY,18,0,18,富邦-宜蘭,2023-07-12,9686
5864,致和證,17,0,17,富邦-宜蘭,2023-07-12,9686
3252,海灣,17,0,17,富邦-宜蘭,2023-07-12,9686
2337,旺宏,17,0,17,富邦-宜蘭,2023-07-12,9686
3071,協禧,21,4,17,富邦-宜蘭,2023-07-12,9686
8403,盛弘,16,0,16,富邦-宜蘭,2023-07-12,9686
6223,旺矽,22,7,15,富邦-宜蘭,2023-07-12,9686
2701,萬企,15,0,15,富邦-宜蘭,2023-07-12,9686
9904,寶成,15,0,15,富邦-宜蘭,2023-07-12,9686
6770,力積電,26,12,14,富邦-宜蘭,2023-07-12,9686
2388,威盛,33,19,14,富邦-宜蘭,2023-07-12,9686
2356,英業達,225,211,14,富邦-宜蘭,2023-07-12,9686
6244,茂迪,13,0,13,富邦-宜蘭,2023-07-12,9686
5243,乙盛-KY,13,0,13,富邦-宜蘭,2023-07-12,9686
1560,中砂,14,1,13,富邦-宜蘭,2023-07-12,9686
00655L,國泰中國A50正2,152,6,146,富邦-宜蘭,2023-07-13,9686
2618,長榮航,158,45,113,富邦-宜蘭,2023-07-13,9686
2887,台新金,102,0,102,富邦-宜蘭,2023-07-13,9686
6216,居易,100,0,100,富邦-宜蘭,2023-07-13,9686
00632R,元大台灣50反1,187,90,97,富邦-宜蘭,2023-07-13,9686
2353,宏��,89,27,62,富邦-宜蘭,2023-07-13,9686
2340,台亞,70,8,62,富邦-宜蘭,2023-07-13,9686
6139,亞翔,79,18,61,富邦-宜蘭,2023-07-13,9686
1337,再生-KY,60,0,60,富邦-宜蘭,2023-07-13,9686
2369,菱生,56,0,56,富邦-宜蘭,2023-07-13,9686
2603,長榮,121,66,55,富邦-宜蘭,2023-07-13,9686
2312,金寶,80,26,54,富邦-宜蘭,2023-07-13,9686
6282,康舒,70,28,42,富邦-宜蘭,2023-07-13,9686
2520,冠德,45,5,40,富邦-宜蘭,2023-07-13,9686
1102,亞泥,37,0,37,富邦-宜蘭,2023-07-13,9686
6182,合晶,36,0,36,富邦-宜蘭,2023-07-13,9686
00673R,期元大S＆P原油反1,39,5,34,富邦-宜蘭,2023-07-13,9686
00665L,富邦�琤肭磪囓�2,56,26,30,富邦-宜蘭,2023-07-13,9686
2303,聯電,33,4,29,富邦-宜蘭,2023-07-13,9686
2883,凱基金,31,2,29,富邦-宜蘭,2023-07-13,9686
2614,東森,31,2,29,富邦-宜蘭,2023-07-13,9686
6118,建達,37,10,27,富邦-宜蘭,2023-07-13,9686
1907,永豐餘,26,0,26,富邦-宜蘭,2023-07-13,9686
4533,協易機,52,27,25,富邦-宜蘭,2023-07-13,9686
2495,普安,31,6,25,富邦-宜蘭,2023-07-13,9686
4105,東洋,25,0,25,富邦-宜蘭,2023-07-13,9686
4168,醣聯,24,0,24,富邦-宜蘭,2023-07-13,9686
2393,億光,27,3,24,富邦-宜蘭,2023-07-13,9686
5324,士開,20,0,20,富邦-宜蘭,2023-07-13,9686
2641,正德,21,1,20,富邦-宜蘭,2023-07-13,9686
3508,位速,20,0,20,富邦-宜蘭,2023-07-13,9686
2358,廷鑫,20,0,20,富邦-宜蘭,2023-07-13,9686
00930,永豐ESG低碳高息,20,0,20,富邦-宜蘭,2023-07-13,9686
2022,聚亨,20,1,19,富邦-宜蘭,2023-07-13,9686
2368,金像電,61,42,19,富邦-宜蘭,2023-07-13,9686
6129,普誠,20,3,17,富邦-宜蘭,2023-07-13,9686
1760,寶齡富錦,17,0,17,富邦-宜蘭,2023-07-13,9686
1303,南亞,20,3,17,富邦-宜蘭,2023-07-13,9686
00929,復華台灣科技優息,81,64,17,富邦-宜蘭,2023-07-13,9686
3236,千如,18,2,16,富邦-宜蘭,2023-07-13,9686
4931,新盛力,19,3,16,富邦-宜蘭,2023-07-13,9686
3217,優群,20,4,16,富邦-宜蘭,2023-07-13,9686
2405,輔信,15,0,15,富邦-宜蘭,2023-07-13,9686
6213,聯茂,17,2,15,富邦-宜蘭,2023-07-13,9686
5340,建榮,15,0,15,富邦-宜蘭,2023-07-13,9686
2409,友達,37,23,14,富邦-宜蘭,2023-07-13,9686
8404,百和興業-KY,14,0,14,富邦-宜蘭,2023-07-13,9686
2449,京元電子,114,100,14,富邦-宜蘭,2023-07-13,9686
6441,廣錠,15,1,14,富邦-宜蘭,2023-07-13,9686
5607,遠雄港,14,0,14,富邦-宜蘭,2023-07-13,9686
00632R,元大台灣50反1,569,60,509,富邦-宜蘭,2023-07-14,9686
8105,凌巨,170,4,166,富邦-宜蘭,2023-07-14,9686
2867,三商壽,108,6,102,富邦-宜蘭,2023-07-14,9686
2618,長榮航,265,201,64,富邦-宜蘭,2023-07-14,9686
00929,復華台灣科技優息,67,9,58,富邦-宜蘭,2023-07-14,9686
2610,華航,248,192,56,富邦-宜蘭,2023-07-14,9686
1802,台玻,57,3,54,富邦-宜蘭,2023-07-14,9686
1101,台泥,58,7,51,富邦-宜蘭,2023-07-14,9686
00673R,期元大S＆P原油反1,51,0,51,富邦-宜蘭,2023-07-14,9686
6190,萬泰科,57,10,47,富邦-宜蘭,2023-07-14,9686
2382,廣達,101,61,40,富邦-宜蘭,2023-07-14,9686
3607,谷崧,40,1,39,富邦-宜蘭,2023-07-14,9686
3711,日月光投控,46,9,37,富邦-宜蘭,2023-07-14,9686
2609,陽明,93,60,33,富邦-宜蘭,2023-07-14,9686
6282,康舒,42,9,33,富邦-宜蘭,2023-07-14,9686
5457,宣德,31,0,31,富邦-宜蘭,2023-07-14,9686
4127,天良,30,0,30,富邦-宜蘭,2023-07-14,9686
00713,元大台灣高息低波,34,5,29,富邦-宜蘭,2023-07-14,9686
6120,達運,35,9,26,富邦-宜蘭,2023-07-14,9686
2883B,凱基金乙特,25,0,25,富邦-宜蘭,2023-07-14,9686
6223,旺矽,46,23,23,富邦-宜蘭,2023-07-14,9686
2419,仲琦,54,31,23,富邦-宜蘭,2023-07-14,9686
2355,敬鵬,26,3,23,富邦-宜蘭,2023-07-14,9686
2344,華邦電,23,1,22,富邦-宜蘭,2023-07-14,9686
3380,明泰,36,14,22,富邦-宜蘭,2023-07-14,9686
2436,偉詮電,46,24,22,富邦-宜蘭,2023-07-14,9686
1618,合機,22,1,21,富邦-宜蘭,2023-07-14,9686
6285,啟��,26,6,20,富邦-宜蘭,2023-07-14,9686
00734B,台新JPM新興債,20,0,20,富邦-宜蘭,2023-07-14,9686
6185,幃翔,20,0,20,富邦-宜蘭,2023-07-14,9686
4960,誠美材,20,0,20,富邦-宜蘭,2023-07-14,9686
9105,泰金寶-DR,20,0,20,富邦-宜蘭,2023-07-14,9686
2324,仁寶,21,2,19,富邦-宜蘭,2023-07-14,9686
1227,佳格,19,0,19,富邦-宜蘭,2023-07-14,9686
1219,福壽,21,2,19,富邦-宜蘭,2023-07-14,9686
0056,元大高股息,91,73,18,富邦-宜蘭,2023-07-14,9686
00753L,中信中國50正2,25,7,18,富邦-宜蘭,2023-07-14,9686
3594,磐儀,18,0,18,富邦-宜蘭,2023-07-14,9686
00882,中信中國高股息,18,0,18,富邦-宜蘭,2023-07-14,9686
1605,華新,20,3,17,富邦-宜蘭,2023-07-14,9686
1217,愛之味,16,0,16,富邦-宜蘭,2023-07-14,9686
3481,群創,36,21,15,富邦-宜蘭,2023-07-14,9686
2486,一詮,18,3,15,富邦-宜蘭,2023-07-14,9686
1452,宏益,35,20,15,富邦-宜蘭,2023-07-14,9686
1722,台肥,25,10,15,富邦-宜蘭,2023-07-14,9686
3032,偉訓,22,9,13,富邦-宜蘭,2023-07-14,9686
6213,聯茂,16,3,13,富邦-宜蘭,2023-07-14,9686
5258,虹堡,29,17,12,富邦-宜蘭,2023-07-14,9686
6207,雷科,11,0,11,富邦-宜蘭,2023-07-14,9686
00722B,群益投資級電信債,11,0,11,富邦-宜蘭,2023-07-14,9686
00720B,元大投資級公司債,219,2,217,富邦-宜蘭,2023-07-17,9686
2312,金寶,162,59,103,富邦-宜蘭,2023-07-17,9686
2885,元大金,100,3,97,富邦-宜蘭,2023-07-17,9686
2883,凱基金,112,16,96,富邦-宜蘭,2023-07-17,9686
2618,長榮航,123,39,84,富邦-宜蘭,2023-07-17,9686
2356,英業達,99,36,63,富邦-宜蘭,2023-07-17,9686
00632R,元大台灣50反1,132,70,62,富邦-宜蘭,2023-07-17,9686
2329,華泰,97,41,56,富邦-宜蘭,2023-07-17,9686
00929,復華台灣科技優息,102,52,50,富邦-宜蘭,2023-07-17,9686
1337,再生-KY,42,0,42,富邦-宜蘭,2023-07-17,9686
00882,中信中國高股息,37,3,34,富邦-宜蘭,2023-07-17,9686
3607,谷崧,32,0,32,富邦-宜蘭,2023-07-17,9686
00925,新光標普電動車,29,0,29,富邦-宜蘭,2023-07-17,9686
4938,和碩,43,16,27,富邦-宜蘭,2023-07-17,9686
00679B,元大美債20年,23,0,23,富邦-宜蘭,2023-07-17,9686
2393,億光,22,0,22,富邦-宜蘭,2023-07-17,9686
2010,春源,22,0,22,富邦-宜蘭,2023-07-17,9686
3037,欣興,95,73,22,富邦-宜蘭,2023-07-17,9686
2371,大同,47,26,21,富邦-宜蘭,2023-07-17,9686
2382,廣達,68,47,21,富邦-宜蘭,2023-07-17,9686
6139,亞翔,21,1,20,富邦-宜蘭,2023-07-17,9686
1417,嘉裕,20,0,20,富邦-宜蘭,2023-07-17,9686
2388,威盛,48,29,19,富邦-宜蘭,2023-07-17,9686
3338,泰碩,31,12,19,富邦-宜蘭,2023-07-17,9686
4164,承業醫,18,0,18,富邦-宜蘭,2023-07-17,9686
3011,今皓,17,0,17,富邦-宜蘭,2023-07-17,9686
6191,精成科,17,2,15,富邦-宜蘭,2023-07-17,9686
1101,台泥,17,2,15,富邦-宜蘭,2023-07-17,9686
00655L,國泰中國A50正2,15,0,15,富邦-宜蘭,2023-07-17,9686
3704,合勤控,30,15,15,富邦-宜蘭,2023-07-17,9686
5512,力麒,15,0,15,富邦-宜蘭,2023-07-17,9686
006208,富邦台50,14,0,14,富邦-宜蘭,2023-07-17,9686
1504,東元,140,126,14,富邦-宜蘭,2023-07-17,9686
00637L,元大滬深300正2,24,10,14,富邦-宜蘭,2023-07-17,9686
2465,麗臺,15,1,14,富邦-宜蘭,2023-07-17,9686
2457,飛宏,38,25,13,富邦-宜蘭,2023-07-17,9686
2495,普安,15,2,13,富邦-宜蘭,2023-07-17,9686
00673R,期元大S＆P原油反1,18,5,13,富邦-宜蘭,2023-07-17,9686
6244,茂迪,15,2,13,富邦-宜蘭,2023-07-17,9686
3325,旭品,13,0,13,富邦-宜蘭,2023-07-17,9686
1402,遠東新,12,0,12,富邦-宜蘭,2023-07-17,9686
1560,中砂,43,31,12,富邦-宜蘭,2023-07-17,9686
2399,映泰,16,4,12,富邦-宜蘭,2023-07-17,9686
3447,展達,14,2,12,富邦-宜蘭,2023-07-17,9686
5465,富驊,15,3,12,富邦-宜蘭,2023-07-17,9686
2331,精英,29,17,12,富邦-宜蘭,2023-07-17,9686
3706,神達,22,11,11,富邦-宜蘭,2023-07-17,9686
00858,永豐美國500大,11,0,11,富邦-宜蘭,2023-07-17,9686
1815,富喬,12,1,11,富邦-宜蘭,2023-07-17,9686
00888,永豐台灣ESG,12,1,11,富邦-宜蘭,2023-07-17,9686
2324,仁寶,518,201,317,富邦-宜蘭,2023-07-18,9686
00929,復華台灣科技優息,230,5,225,富邦-宜蘭,2023-07-18,9686
5469,瀚宇博,180,11,169,富邦-宜蘭,2023-07-18,9686
6142,友勁,82,0,82,富邦-宜蘭,2023-07-18,9686
00882,中信中國高股息,84,6,78,富邦-宜蘭,2023-07-18,9686
00632R,元大台灣50反1,77,4,73,富邦-宜蘭,2023-07-18,9686
00930,永豐ESG低碳高息,72,1,71,富邦-宜蘭,2023-07-18,9686
2353,宏��,221,156,65,富邦-宜蘭,2023-07-18,9686
1337,再生-KY,70,7,63,富邦-宜蘭,2023-07-18,9686
1471,首利,67,6,61,富邦-宜蘭,2023-07-18,9686
6282,康舒,158,99,59,富邦-宜蘭,2023-07-18,9686
5512,力麒,55,0,55,富邦-宜蘭,2023-07-18,9686
00772B,中信高評級公司債,52,0,52,富邦-宜蘭,2023-07-18,9686
0056,元大高股息,137,88,49,富邦-宜蘭,2023-07-18,9686
2352,佳世達,123,77,46,富邦-宜蘭,2023-07-18,9686
5465,富驊,46,0,46,富邦-宜蘭,2023-07-18,9686
4533,協易機,61,18,43,富邦-宜蘭,2023-07-18,9686
1304,台聚,43,3,40,富邦-宜蘭,2023-07-18,9686
2337,旺宏,42,5,37,富邦-宜蘭,2023-07-18,9686
00679B,元大美債20年,37,1,36,富邦-宜蘭,2023-07-18,9686
2515,中工,36,0,36,富邦-宜蘭,2023-07-18,9686
2354,鴻準,72,40,32,富邦-宜蘭,2023-07-18,9686
8054,安國,30,0,30,富邦-宜蘭,2023-07-18,9686
00671R,富邦NASDAQ反1,30,0,30,富邦-宜蘭,2023-07-18,9686
8072,陞泰,31,1,30,富邦-宜蘭,2023-07-18,9686
2027,大成鋼,80,50,30,富邦-宜蘭,2023-07-18,9686
00885,富邦越南,35,5,30,富邦-宜蘭,2023-07-18,9686
3024,憶聲,31,1,30,富邦-宜蘭,2023-07-18,9686
1905,華紙,30,1,29,富邦-宜蘭,2023-07-18,9686
1609,大亞,67,38,29,富邦-宜蘭,2023-07-18,9686
2312,金寶,418,391,27,富邦-宜蘭,2023-07-18,9686
00687B,國泰20年美債,25,0,25,富邦-宜蘭,2023-07-18,9686
3049,精金,25,0,25,富邦-宜蘭,2023-07-18,9686
1513,中興電,55,31,24,富邦-宜蘭,2023-07-18,9686
3013,晟銘電,40,16,24,富邦-宜蘭,2023-07-18,9686
6285,啟��,43,19,24,富邦-宜蘭,2023-07-18,9686
4532,瑞智,38,14,24,富邦-宜蘭,2023-07-18,9686
00795B,中信美國公債20年,23,0,23,富邦-宜蘭,2023-07-18,9686
2323,中環,24,1,23,富邦-宜蘭,2023-07-18,9686
2393,億光,24,1,23,富邦-宜蘭,2023-07-18,9686
8011,台通,24,1,23,富邦-宜蘭,2023-07-18,9686
3078,僑威,67,45,22,富邦-宜蘭,2023-07-18,9686
1514,亞力,40,18,22,富邦-宜蘭,2023-07-18,9686
4168,醣聯,21,0,21,富邦-宜蘭,2023-07-18,9686
6120,達運,29,8,21,富邦-宜蘭,2023-07-18,9686
1605,華新,47,27,20,富邦-宜蘭,2023-07-18,9686
2413,環科,20,0,20,富邦-宜蘭,2023-07-18,9686
1809,中釉,20,0,20,富邦-宜蘭,2023-07-18,9686
3217,優群,22,2,20,富邦-宜蘭,2023-07-18,9686
5243,乙盛-KY,19,0,19,富邦-宜蘭,2023-07-18,9686
00680L,元大美債20正2,180,4,176,富邦-宜蘭,2023-07-19,9686
00929,復華台灣科技優息,168,0,168,富邦-宜蘭,2023-07-19,9686
2324,仁寶,293,139,154,富邦-宜蘭,2023-07-19,9686
2329,華泰,287,136,151,富邦-宜蘭,2023-07-19,9686
3481,群創,196,54,142,富邦-宜蘭,2023-07-19,9686
00701,國泰股利精選30,109,0,109,富邦-宜蘭,2023-07-19,9686
00679B,元大美債20年,116,23,93,富邦-宜蘭,2023-07-19,9686
2316,楠梓電,115,33,82,富邦-宜蘭,2023-07-19,9686
8054,安國,60,1,59,富邦-宜蘭,2023-07-19,9686
2461,光群雷,67,9,58,富邦-宜蘭,2023-07-19,9686
2881,富邦金,88,30,58,富邦-宜蘭,2023-07-19,9686
00895,富邦未來車,58,4,54,富邦-宜蘭,2023-07-19,9686
2027,大成鋼,53,1,52,富邦-宜蘭,2023-07-19,9686
2882,國泰金,58,10,48,富邦-宜蘭,2023-07-19,9686
6770,力積電,61,17,44,富邦-宜蘭,2023-07-19,9686
4938,和碩,58,14,44,富邦-宜蘭,2023-07-19,9686
3013,晟銘電,47,4,43,富邦-宜蘭,2023-07-19,9686
6111,大宇資,47,4,43,富邦-宜蘭,2023-07-19,9686
2014,中鴻,46,5,41,富邦-宜蘭,2023-07-19,9686
00882,中信中國高股息,50,10,40,富邦-宜蘭,2023-07-19,9686
2812,台中銀,37,0,37,富邦-宜蘭,2023-07-19,9686
2610,華航,42,6,36,富邦-宜蘭,2023-07-19,9686
1528,恩德,36,0,36,富邦-宜蘭,2023-07-19,9686
2603,長榮,50,15,35,富邦-宜蘭,2023-07-19,9686
6116,彩晶,43,10,33,富邦-宜蘭,2023-07-19,9686
6113,亞矽,30,0,30,富邦-宜蘭,2023-07-19,9686
2618,長榮航,154,125,29,富邦-宜蘭,2023-07-19,9686
2636,台驊控股,30,1,29,富邦-宜蘭,2023-07-19,9686
2317,鴻海,34,5,29,富邦-宜蘭,2023-07-19,9686
2801,彰銀,33,7,26,富邦-宜蘭,2023-07-19,9686
1102,亞泥,26,0,26,富邦-宜蘭,2023-07-19,9686
2887,台新金,32,8,24,富邦-宜蘭,2023-07-19,9686
6218,豪勉,43,19,24,富邦-宜蘭,2023-07-19,9686
00900,富邦特選高股息30,35,12,23,富邦-宜蘭,2023-07-19,9686
2542,興富發,25,2,23,富邦-宜蘭,2023-07-19,9686
1609,大亞,57,35,22,富邦-宜蘭,2023-07-19,9686
3712,永崴投控,21,0,21,富邦-宜蘭,2023-07-19,9686
2106,建大,21,1,20,富邦-宜蘭,2023-07-19,9686
2608,嘉里大榮,20,0,20,富邦-宜蘭,2023-07-19,9686
00665L,富邦�琤肭磪囓�2,209,190,19,富邦-宜蘭,2023-07-19,9686
6185,幃翔,19,0,19,富邦-宜蘭,2023-07-19,9686
2457,飛宏,23,5,18,富邦-宜蘭,2023-07-19,9686
00893,國泰智能電動車,40,24,16,富邦-宜蘭,2023-07-19,9686
6150,撼訊,21,5,16,富邦-宜蘭,2023-07-19,9686
8105,凌巨,27,11,16,富邦-宜蘭,2023-07-19,9686
00888,永豐台灣ESG,15,0,15,富邦-宜蘭,2023-07-19,9686
9105,泰金寶-DR,16,1,15,富邦-宜蘭,2023-07-19,9686
1722,台肥,16,1,15,富邦-宜蘭,2023-07-19,9686
00637L,元大滬深300正2,15,0,15,富邦-宜蘭,2023-07-19,9686
2303,聯電,27,13,14,富邦-宜蘭,2023-07-19,9686
00712,復華富時不動產,211,21,190,富邦-宜蘭,2023-07-20,9686
2630,亞航,142,7,135,富邦-宜蘭,2023-07-20,9686
00881,國泰台灣5G+,117,7,110,富邦-宜蘭,2023-07-20,9686
3481,群創,94,8,86,富邦-宜蘭,2023-07-20,9686
2515,中工,90,9,81,富邦-宜蘭,2023-07-20,9686
2303,聯電,75,10,65,富邦-宜蘭,2023-07-20,9686
2482,連宇,63,2,61,富邦-宜蘭,2023-07-20,9686
2610,華航,115,64,51,富邦-宜蘭,2023-07-20,9686
6150,撼訊,74,29,45,富邦-宜蘭,2023-07-20,9686
2324,仁寶,62,21,41,富邦-宜蘭,2023-07-20,9686
2634,漢翔,67,26,41,富邦-宜蘭,2023-07-20,9686
1102,亞泥,41,1,40,富邦-宜蘭,2023-07-20,9686
4162,智擎,40,0,40,富邦-宜蘭,2023-07-20,9686
4123,晟德,58,18,40,富邦-宜蘭,2023-07-20,9686
3037,欣興,62,25,37,富邦-宜蘭,2023-07-20,9686
4938,和碩,38,9,29,富邦-宜蘭,2023-07-20,9686
1529,樂事綠能,32,5,27,富邦-宜蘭,2023-07-20,9686
00888,永豐台灣ESG,26,0,26,富邦-宜蘭,2023-07-20,9686
2352,佳世達,71,47,24,富邦-宜蘭,2023-07-20,9686
1314,中石化,24,1,23,富邦-宜蘭,2023-07-20,9686
00929,復華台灣科技優息,43,20,23,富邦-宜蘭,2023-07-20,9686
00885,富邦越南,23,0,23,富邦-宜蘭,2023-07-20,9686
00665L,富邦�琤肭磪囓�2,27,5,22,富邦-宜蘭,2023-07-20,9686
00882,中信中國高股息,23,2,21,富邦-宜蘭,2023-07-20,9686
3217,優群,21,0,21,富邦-宜蘭,2023-07-20,9686
00679B,元大美債20年,22,1,21,富邦-宜蘭,2023-07-20,9686
6770,力積電,41,21,20,富邦-宜蘭,2023-07-20,9686
1736,喬山,22,2,20,富邦-宜蘭,2023-07-20,9686
2609,陽明,117,98,19,富邦-宜蘭,2023-07-20,9686
3289,宜特,24,5,19,富邦-宜蘭,2023-07-20,9686
3024,憶聲,40,21,19,富邦-宜蘭,2023-07-20,9686
00673R,期元大S＆P原油反1,30,11,19,富邦-宜蘭,2023-07-20,9686
2867,三商壽,21,3,18,富邦-宜蘭,2023-07-20,9686
2014,中鴻,22,5,17,富邦-宜蘭,2023-07-20,9686
2705,六福,21,4,17,富邦-宜蘭,2023-07-20,9686
2329,華泰,54,38,16,富邦-宜蘭,2023-07-20,9686
9105,泰金寶-DR,20,5,15,富邦-宜蘭,2023-07-20,9686
3706,神達,69,54,15,富邦-宜蘭,2023-07-20,9686
4977,眾達-KY,18,4,14,富邦-宜蘭,2023-07-20,9686
2337,旺宏,12,0,12,富邦-宜蘭,2023-07-20,9686
6235,華孚,28,16,12,富邦-宜蘭,2023-07-20,9686
4523,永彰,11,0,11,富邦-宜蘭,2023-07-20,9686
5607,遠雄港,21,10,11,富邦-宜蘭,2023-07-20,9686
2109,華豐,10,0,10,富邦-宜蘭,2023-07-20,9686
6605,帝寶,10,0,10,富邦-宜蘭,2023-07-20,9686
2020,美亞,10,0,10,富邦-宜蘭,2023-07-20,9686
2363,矽統,10,0,10,富邦-宜蘭,2023-07-20,9686
3032,偉訓,23,13,10,富邦-宜蘭,2023-07-20,9686
3013,晟銘電,33,23,10,富邦-宜蘭,2023-07-20,9686
1513,中興電,14,5,9,富邦-宜蘭,2023-07-20,9686
2344,華邦電,176,2,174,富邦-宜蘭,2023-07-21,9686
2610,華航,185,22,163,富邦-宜蘭,2023-07-21,9686
00878,國泰永續高股息,199,98,101,富邦-宜蘭,2023-07-21,9686
6282,康舒,114,25,89,富邦-宜蘭,2023-07-21,9686
2609,陽明,135,52,83,富邦-宜蘭,2023-07-21,9686
3706,神達,121,48,73,富邦-宜蘭,2023-07-21,9686
2323,中環,107,39,68,富邦-宜蘭,2023-07-21,9686
1513,中興電,115,57,58,富邦-宜蘭,2023-07-21,9686
2405,輔信,63,10,53,富邦-宜蘭,2023-07-21,9686
4414,如興,41,0,41,富邦-宜蘭,2023-07-21,9686
2303,聯電,53,17,36,富邦-宜蘭,2023-07-21,9686
3049,精金,35,0,35,富邦-宜蘭,2023-07-21,9686
2419,仲琦,63,28,35,富邦-宜蘭,2023-07-21,9686
1504,東元,79,44,35,富邦-宜蘭,2023-07-21,9686
1609,大亞,71,39,32,富邦-宜蘭,2023-07-21,9686
3013,晟銘電,121,89,32,富邦-宜蘭,2023-07-21,9686
6111,大宇資,36,6,30,富邦-宜蘭,2023-07-21,9686
2356,英業達,56,31,25,富邦-宜蘭,2023-07-21,9686
3024,憶聲,51,26,25,富邦-宜蘭,2023-07-21,9686
00888,永豐台灣ESG,25,0,25,富邦-宜蘭,2023-07-21,9686
6274,台燿,91,66,25,富邦-宜蘭,2023-07-21,9686
6505,台塑化,24,0,24,富邦-宜蘭,2023-07-21,9686
2801,彰銀,24,0,24,富邦-宜蘭,2023-07-21,9686
1605,華新,35,12,23,富邦-宜蘭,2023-07-21,9686
2330,台積電,29,6,23,富邦-宜蘭,2023-07-21,9686
5483,中美晶,23,1,22,富邦-宜蘭,2023-07-21,9686
4916,事欣科,41,19,22,富邦-宜蘭,2023-07-21,9686
3071,協禧,30,8,22,富邦-宜蘭,2023-07-21,9686
3338,泰碩,49,27,22,富邦-宜蘭,2023-07-21,9686
00687B,國泰20年美債,21,0,21,富邦-宜蘭,2023-07-21,9686
4906,正文,20,0,20,富邦-宜蘭,2023-07-21,9686
4164,承業醫,21,1,20,富邦-宜蘭,2023-07-21,9686
1102,亞泥,19,0,19,富邦-宜蘭,2023-07-21,9686
1584,精剛,19,1,18,富邦-宜蘭,2023-07-21,9686
2340,台亞,25,7,18,富邦-宜蘭,2023-07-21,9686
2337,旺宏,17,0,17,富邦-宜蘭,2023-07-21,9686
3703,欣陸,17,0,17,富邦-宜蘭,2023-07-21,9686
1101,台泥,24,7,17,富邦-宜蘭,2023-07-21,9686
1905,華紙,34,18,16,富邦-宜蘭,2023-07-21,9686
00720B,元大投資級公司債,16,0,16,富邦-宜蘭,2023-07-21,9686
2515,中工,22,7,15,富邦-宜蘭,2023-07-21,9686
3078,僑威,20,5,15,富邦-宜蘭,2023-07-21,9686
2106,建大,15,0,15,富邦-宜蘭,2023-07-21,9686
3583,辛耘,30,15,15,富邦-宜蘭,2023-07-21,9686
1762,中化生,18,4,14,富邦-宜蘭,2023-07-21,9686
00885,富邦越南,16,2,14,富邦-宜蘭,2023-07-21,9686
6118,建達,14,0,14,富邦-宜蘭,2023-07-21,9686
00665L,富邦�琤肭磪囓�2,34,20,14,富邦-宜蘭,2023-07-21,9686
5425,台半,19,5,14,富邦-宜蘭,2023-07-21,9686
8403,盛弘,15,1,14,富邦-宜蘭,2023-07-21,9686
1714,和桐,180,0,180,富邦-宜蘭,2023-07-24,9686
3481,群創,145,11,134,富邦-宜蘭,2023-07-24,9686
3013,晟銘電,256,143,113,富邦-宜蘭,2023-07-24,9686
2461,光群雷,89,6,83,富邦-宜蘭,2023-07-24,9686
00900,富邦特選高股息30,102,20,82,富邦-宜蘭,2023-07-24,9686
00929,復華台灣科技優息,91,14,77,富邦-宜蘭,2023-07-24,9686
00673R,期元大S＆P原油反1,61,0,61,富邦-宜蘭,2023-07-24,9686
2356,英業達,97,42,55,富邦-宜蘭,2023-07-24,9686
2603,長榮,51,2,49,富邦-宜蘭,2023-07-24,9686
2609,陽明,54,8,46,富邦-宜蘭,2023-07-24,9686
2884,玉山金,43,0,43,富邦-宜蘭,2023-07-24,9686
2801,彰銀,41,0,41,富邦-宜蘭,2023-07-24,9686
4714,永捷,42,3,39,富邦-宜蘭,2023-07-24,9686
6152,百一,33,0,33,富邦-宜蘭,2023-07-24,9686
6505,台塑化,30,0,30,富邦-宜蘭,2023-07-24,9686
4414,如興,30,0,30,富邦-宜蘭,2023-07-24,9686
2352,佳世達,104,75,29,富邦-宜蘭,2023-07-24,9686
8390,金益鼎,29,0,29,富邦-宜蘭,2023-07-24,9686
5425,台半,33,4,29,富邦-宜蘭,2023-07-24,9686
6142,友勁,35,8,27,富邦-宜蘭,2023-07-24,9686
1904,正隆,26,0,26,富邦-宜蘭,2023-07-24,9686
00679B,元大美債20年,25,0,25,富邦-宜蘭,2023-07-24,9686
1528,恩德,28,4,24,富邦-宜蘭,2023-07-24,9686
6190,萬泰科,24,1,23,富邦-宜蘭,2023-07-24,9686
2615,萬海,23,0,23,富邦-宜蘭,2023-07-24,9686
1102,亞泥,20,0,20,富邦-宜蘭,2023-07-24,9686
2421,建準,30,10,20,富邦-宜蘭,2023-07-24,9686
2889,國票金,20,0,20,富邦-宜蘭,2023-07-24,9686
2374,佳能,22,3,19,富邦-宜蘭,2023-07-24,9686
2330,台積電,25,6,19,富邦-宜蘭,2023-07-24,9686
2323,中環,25,7,18,富邦-宜蘭,2023-07-24,9686
2337,旺宏,17,1,16,富邦-宜蘭,2023-07-24,9686
1605,華新,34,19,15,富邦-宜蘭,2023-07-24,9686
00897,富邦基因免疫生技,16,1,15,富邦-宜蘭,2023-07-24,9686
2888,新光金,15,0,15,富邦-宜蘭,2023-07-24,9686
6191,精成科,14,0,14,富邦-宜蘭,2023-07-24,9686
6215,和椿,13,0,13,富邦-宜蘭,2023-07-24,9686
2449,京元電子,20,7,13,富邦-宜蘭,2023-07-24,9686
5340,建榮,20,7,13,富邦-宜蘭,2023-07-24,9686
5457,宣德,14,2,12,富邦-宜蘭,2023-07-24,9686
3037,欣興,31,19,12,富邦-宜蘭,2023-07-24,9686
6104,創惟,12,0,12,富邦-宜蘭,2023-07-24,9686
8409,商之器,13,1,12,富邦-宜蘭,2023-07-24,9686
2887,台新金,45,33,12,富邦-宜蘭,2023-07-24,9686
2881,富邦金,12,1,11,富邦-宜蘭,2023-07-24,9686
00930,永豐ESG低碳高息,11,0,11,富邦-宜蘭,2023-07-24,9686
3441,聯一光,14,3,11,富邦-宜蘭,2023-07-24,9686
4533,協易機,27,16,11,富邦-宜蘭,2023-07-24,9686
2401,凌陽,12,1,11,富邦-宜蘭,2023-07-24,9686
4904,遠傳,12,1,11,富邦-宜蘭,2023-07-24,9686
00673R,期元大S＆P原油反1,138,0,138,富邦-宜蘭,2023-07-25,9686
8105,凌巨,103,1,102,富邦-宜蘭,2023-07-25,9686
2886,兆豐金,102,2,100,富邦-宜蘭,2023-07-25,9686
2610,華航,95,22,73,富邦-宜蘭,2023-07-25,9686
00929,復華台灣科技優息,98,25,73,富邦-宜蘭,2023-07-25,9686
4414,如興,61,0,61,富邦-宜蘭,2023-07-25,9686
00930,永豐ESG低碳高息,54,0,54,富邦-宜蘭,2023-07-25,9686
6111,大宇資,43,1,42,富邦-宜蘭,2023-07-25,9686
2312,金寶,73,33,40,富邦-宜蘭,2023-07-25,9686
6188,廣明,47,10,37,富邦-宜蘭,2023-07-25,9686
2449,京元電子,35,1,34,富邦-宜蘭,2023-07-25,9686
00679B,元大美債20年,32,1,31,富邦-宜蘭,2023-07-25,9686
00688L,國泰20年美債正2,30,0,30,富邦-宜蘭,2023-07-25,9686
1618,合機,35,6,29,富邦-宜蘭,2023-07-25,9686
3227,原相,37,8,29,富邦-宜蘭,2023-07-25,9686
2603,長榮,41,13,28,富邦-宜蘭,2023-07-25,9686
3481,群創,42,16,26,富邦-宜蘭,2023-07-25,9686
3702,大聯大,26,1,25,富邦-宜蘭,2023-07-25,9686
6213,聯茂,27,2,25,富邦-宜蘭,2023-07-25,9686
3363,上詮,26,1,25,富邦-宜蘭,2023-07-25,9686
2382,廣達,121,98,23,富邦-宜蘭,2023-07-25,9686
2356,英業達,53,30,23,富邦-宜蘭,2023-07-25,9686
1905,華紙,45,23,22,富邦-宜蘭,2023-07-25,9686
2609,陽明,27,6,21,富邦-宜蘭,2023-07-25,9686
2303,聯電,23,2,21,富邦-宜蘭,2023-07-25,9686
3231,緯創,29,8,21,富邦-宜蘭,2023-07-25,9686
1314,中石化,21,1,20,富邦-宜蘭,2023-07-25,9686
5315,光聯,20,0,20,富邦-宜蘭,2023-07-25,9686
4726,永昕,24,6,18,富邦-宜蘭,2023-07-25,9686
6125,廣運,124,107,17,富邦-宜蘭,2023-07-25,9686
00897,富邦基因免疫生技,17,0,17,富邦-宜蘭,2023-07-25,9686
1815,富喬,17,0,17,富邦-宜蘭,2023-07-25,9686
4942,嘉彰,25,9,16,富邦-宜蘭,2023-07-25,9686
2002,中鋼,15,0,15,富邦-宜蘭,2023-07-25,9686
00712,復華富時不動產,15,0,15,富邦-宜蘭,2023-07-25,9686
2324,仁寶,52,37,15,富邦-宜蘭,2023-07-25,9686
8358,金居,56,42,14,富邦-宜蘭,2023-07-25,9686
1301,台塑,14,0,14,富邦-宜蘭,2023-07-25,9686
1402,遠東新,13,0,13,富邦-宜蘭,2023-07-25,9686
3025,星通,14,1,13,富邦-宜蘭,2023-07-25,9686
5469,瀚宇博,19,6,13,富邦-宜蘭,2023-07-25,9686
5465,富驊,17,4,13,富邦-宜蘭,2023-07-25,9686
3037,欣興,68,56,12,富邦-宜蘭,2023-07-25,9686
6182,合晶,12,0,12,富邦-宜蘭,2023-07-25,9686
2605,新興,12,0,12,富邦-宜蘭,2023-07-25,9686
2371,大同,13,1,12,富邦-宜蘭,2023-07-25,9686
4157,太景*-KY,12,0,12,富邦-宜蘭,2023-07-25,9686
1708,東鹼,12,0,12,富邦-宜蘭,2023-07-25,9686
4543,萬在,13,1,12,富邦-宜蘭,2023-07-25,9686
2542,興富發,11,0,11,富邦-宜蘭,2023-07-25,9686
6005,群益證,258,29,229,富邦-宜蘭,2023-07-26,9686
1618,合機,183,36,147,富邦-宜蘭,2023-07-26,9686
6125,廣運,157,30,127,富邦-宜蘭,2023-07-26,9686
1504,東元,208,84,124,富邦-宜蘭,2023-07-26,9686
2887,台新金,138,18,120,富邦-宜蘭,2023-07-26,9686
00929,復華台灣科技優息,107,3,104,富邦-宜蘭,2023-07-26,9686
9105,泰金寶-DR,100,0,100,富邦-宜蘭,2023-07-26,9686
6282,康舒,155,64,91,富邦-宜蘭,2023-07-26,9686
2399,映泰,80,0,80,富邦-宜蘭,2023-07-26,9686
2020,美亞,60,0,60,富邦-宜蘭,2023-07-26,9686
2312,金寶,57,1,56,富邦-宜蘭,2023-07-26,9686
6275,元山,86,32,54,富邦-宜蘭,2023-07-26,9686
2442,新美齊,50,0,50,富邦-宜蘭,2023-07-26,9686
3706,神達,67,21,46,富邦-宜蘭,2023-07-26,9686
3227,原相,49,8,41,富邦-宜蘭,2023-07-26,9686
2883,凱基金,58,18,40,富邦-宜蘭,2023-07-26,9686
6016,康和證,40,1,39,富邦-宜蘭,2023-07-26,9686
2344,華邦電,38,0,38,富邦-宜蘭,2023-07-26,9686
6188,廣明,56,21,35,富邦-宜蘭,2023-07-26,9686
2027,大成鋼,33,0,33,富邦-宜蘭,2023-07-26,9686
2457,飛宏,36,3,33,富邦-宜蘭,2023-07-26,9686
4746,台耀,36,5,31,富邦-宜蘭,2023-07-26,9686
5483,中美晶,38,8,30,富邦-宜蘭,2023-07-26,9686
8358,金居,168,138,30,富邦-宜蘭,2023-07-26,9686
1815,富喬,40,10,30,富邦-宜蘭,2023-07-26,9686
1609,大亞,41,13,28,富邦-宜蘭,2023-07-26,9686
6770,力積電,34,7,27,富邦-宜蘭,2023-07-26,9686
00687B,國泰20年美債,24,0,24,富邦-宜蘭,2023-07-26,9686
2340,台亞,52,30,22,富邦-宜蘭,2023-07-26,9686
1604,聲寶,22,0,22,富邦-宜蘭,2023-07-26,9686
00897,富邦基因免疫生技,21,0,21,富邦-宜蘭,2023-07-26,9686
4414,如興,21,0,21,富邦-宜蘭,2023-07-26,9686
2382,廣達,101,81,20,富邦-宜蘭,2023-07-26,9686
8109,博大,70,50,20,富邦-宜蘭,2023-07-26,9686
5703,亞都,20,0,20,富邦-宜蘭,2023-07-26,9686
1101,台泥,22,2,20,富邦-宜蘭,2023-07-26,9686
6235,華孚,46,27,19,富邦-宜蘭,2023-07-26,9686
8390,金益鼎,20,1,19,富邦-宜蘭,2023-07-26,9686
2371,大同,38,19,19,富邦-宜蘭,2023-07-26,9686
00930,永豐ESG低碳高息,17,0,17,富邦-宜蘭,2023-07-26,9686
5288,豐祥-KY,17,0,17,富邦-宜蘭,2023-07-26,9686
2482,連宇,16,0,16,富邦-宜蘭,2023-07-26,9686
3450,聯鈞,19,3,16,富邦-宜蘭,2023-07-26,9686
2301,光寶科,48,33,15,富邦-宜蘭,2023-07-26,9686
6215,和椿,14,0,14,富邦-宜蘭,2023-07-26,9686
00927,群益半導體收益,13,0,13,富邦-宜蘭,2023-07-26,9686
6517,保勝光學,13,0,13,富邦-宜蘭,2023-07-26,9686
2337,旺宏,15,3,12,富邦-宜蘭,2023-07-26,9686
8926,台汽電,13,1,12,富邦-宜蘭,2023-07-26,9686
2615,萬海,13,1,12,富邦-宜蘭,2023-07-26,9686
2883,凱基金,262,107,155,富邦-宜蘭,2023-07-27,9686
3049,精金,106,10,96,富邦-宜蘭,2023-07-27,9686
00902,中信電池及儲能,82,11,71,富邦-宜蘭,2023-07-27,9686
6015,宏遠證,95,29,66,富邦-宜蘭,2023-07-27,9686
2618,長榮航,87,27,60,富邦-宜蘭,2023-07-27,9686
3576,聯合再生,59,1,58,富邦-宜蘭,2023-07-27,9686
00929,復華台灣科技優息,46,10,36,富邦-宜蘭,2023-07-27,9686
6188,廣明,90,54,36,富邦-宜蘭,2023-07-27,9686
2316,楠梓電,37,2,35,富邦-宜蘭,2023-07-27,9686
2887,台新金,35,2,33,富邦-宜蘭,2023-07-27,9686
9939,宏全,31,0,31,富邦-宜蘭,2023-07-27,9686
8110,華東,30,0,30,富邦-宜蘭,2023-07-27,9686
5410,國眾,31,2,29,富邦-宜蘭,2023-07-27,9686
1313,聯成,28,0,28,富邦-宜蘭,2023-07-27,9686
2353,宏��,44,17,27,富邦-宜蘭,2023-07-27,9686
0056,元大高股息,67,40,27,富邦-宜蘭,2023-07-27,9686
6470,宇智,27,0,27,富邦-宜蘭,2023-07-27,9686
1217,愛之味,39,12,27,富邦-宜蘭,2023-07-27,9686
2610,華航,160,134,26,富邦-宜蘭,2023-07-27,9686
6485,點序,26,1,25,富邦-宜蘭,2023-07-27,9686
00679B,元大美債20年,22,0,22,富邦-宜蘭,2023-07-27,9686
2020,美亞,22,0,22,富邦-宜蘭,2023-07-27,9686
3189,景碩,22,0,22,富邦-宜蘭,2023-07-27,9686
00673R,期元大S＆P原油反1,21,0,21,富邦-宜蘭,2023-07-27,9686
00722B,群益投資級電信債,20,0,20,富邦-宜蘭,2023-07-27,9686
2352,佳世達,40,20,20,富邦-宜蘭,2023-07-27,9686
2002,中鋼,23,4,19,富邦-宜蘭,2023-07-27,9686
3380,明泰,20,1,19,富邦-宜蘭,2023-07-27,9686
8070,長華*,19,0,19,富邦-宜蘭,2023-07-27,9686
9105,泰金寶-DR,20,1,19,富邦-宜蘭,2023-07-27,9686
2399,映泰,21,2,19,富邦-宜蘭,2023-07-27,9686
2603,長榮,30,11,19,富邦-宜蘭,2023-07-27,9686
2340,台亞,81,64,17,富邦-宜蘭,2023-07-27,9686
2881,富邦金,27,10,17,富邦-宜蘭,2023-07-27,9686
3516,亞帝歐,17,0,17,富邦-宜蘭,2023-07-27,9686
1907,永豐餘,32,16,16,富邦-宜蘭,2023-07-27,9686
4533,協易機,79,63,16,富邦-宜蘭,2023-07-27,9686
2371,大同,35,19,16,富邦-宜蘭,2023-07-27,9686
1528,恩德,16,1,15,富邦-宜蘭,2023-07-27,9686
4973,廣穎,15,1,14,富邦-宜蘭,2023-07-27,9686
2453,凌群,20,7,13,富邦-宜蘭,2023-07-27,9686
2317,鴻海,18,5,13,富邦-宜蘭,2023-07-27,9686
6257,矽格,14,2,12,富邦-宜蘭,2023-07-27,9686
8234,新漢,17,5,12,富邦-宜蘭,2023-07-27,9686
2301,光寶科,30,18,12,富邦-宜蘭,2023-07-27,9686
2420,新巨,11,0,11,富邦-宜蘭,2023-07-27,9686
3346,麗清,14,3,11,富邦-宜蘭,2023-07-27,9686
2472,立隆電,13,3,10,富邦-宜蘭,2023-07-27,9686
1608,華榮,10,0,10,富邦-宜蘭,2023-07-27,9686
1540,喬福,10,0,10,富邦-宜蘭,2023-07-27,9686
00751B,元大AAA至A公司債,147,0,147,富邦-宜蘭,2023-07-28,9686
00680L,元大美債20正2,130,0,130,富邦-宜蘭,2023-07-28,9686
1612,宏泰,127,0,127,富邦-宜蘭,2023-07-28,9686
2892,第一金,107,9,98,富邦-宜蘭,2023-07-28,9686
2427,三商電,68,8,60,富邦-宜蘭,2023-07-28,9686
2515,中工,60,0,60,富邦-宜蘭,2023-07-28,9686
00679B,元大美債20年,59,1,58,富邦-宜蘭,2023-07-28,9686
2027,大成鋼,63,15,48,富邦-宜蘭,2023-07-28,9686
1802,台玻,59,19,40,富邦-宜蘭,2023-07-28,9686
1618,合機,42,5,37,富邦-宜蘭,2023-07-28,9686
2913,農林,328,293,35,富邦-宜蘭,2023-07-28,9686
3037,欣興,63,32,31,富邦-宜蘭,2023-07-28,9686
2399,映泰,66,35,31,富邦-宜蘭,2023-07-28,9686
8277,商丞,33,2,31,富邦-宜蘭,2023-07-28,9686
00725B,國泰投資級公司債,30,0,30,富邦-宜蘭,2023-07-28,9686
2316,楠梓電,41,12,29,富邦-宜蘭,2023-07-28,9686
2329,華泰,199,174,25,富邦-宜蘭,2023-07-28,9686
00632R,元大台灣50反1,45,20,25,富邦-宜蘭,2023-07-28,9686
00712,復華富時不動產,24,0,24,富邦-宜蘭,2023-07-28,9686
3231,緯創,115,91,24,富邦-宜蘭,2023-07-28,9686
2362,藍天,24,0,24,富邦-宜蘭,2023-07-28,9686
1609,大亞,38,17,21,富邦-宜蘭,2023-07-28,9686
2413,環科,21,0,21,富邦-宜蘭,2023-07-28,9686
00687B,國泰20年美債,21,0,21,富邦-宜蘭,2023-07-28,9686
2356,英業達,42,22,20,富邦-宜蘭,2023-07-28,9686
00673R,期元大S＆P原油反1,20,0,20,富邦-宜蘭,2023-07-28,9686
2442,新美齊,20,0,20,富邦-宜蘭,2023-07-28,9686
00688L,國泰20年美債正2,20,0,20,富邦-宜蘭,2023-07-28,9686
5315,光聯,20,0,20,富邦-宜蘭,2023-07-28,9686
5703,亞都,20,0,20,富邦-宜蘭,2023-07-28,9686
00720B,元大投資級公司債,19,0,19,富邦-宜蘭,2023-07-28,9686
2401,凌陽,25,7,18,富邦-宜蘭,2023-07-28,9686
5425,台半,19,1,18,富邦-宜蘭,2023-07-28,9686
00696B,富邦美債20年,15,0,15,富邦-宜蘭,2023-07-28,9686
4164,承業醫,15,0,15,富邦-宜蘭,2023-07-28,9686
1504,東元,31,16,15,富邦-宜蘭,2023-07-28,9686
2108,南帝,13,0,13,富邦-宜蘭,2023-07-28,9686
2369,菱生,27,14,13,富邦-宜蘭,2023-07-28,9686
4934,太極,16,3,13,富邦-宜蘭,2023-07-28,9686
3289,宜特,20,8,12,富邦-宜蘭,2023-07-28,9686
6719,力智,13,1,12,富邦-宜蘭,2023-07-28,9686
1313,聯成,12,0,12,富邦-宜蘭,2023-07-28,9686
8436,大江,14,2,12,富邦-宜蘭,2023-07-28,9686
2317,鴻海,12,1,11,富邦-宜蘭,2023-07-28,9686
2634,漢翔,11,0,11,富邦-宜蘭,2023-07-28,9686
2489,瑞軒,11,0,11,富邦-宜蘭,2023-07-28,9686
3207,耀勝,11,0,11,富邦-宜蘭,2023-07-28,9686
9945,潤泰新,11,0,11,富邦-宜蘭,2023-07-28,9686
3694,海華,21,10,11,富邦-宜蘭,2023-07-28,9686
00795B,中信美國公債20年,11,0,11,富邦-宜蘭,2023-07-28,9686
1504,東元,303,44,259,富邦-宜蘭,2023-07-31,9686
3231,緯創,274,95,179,富邦-宜蘭,2023-07-31,9686
2883,凱基金,131,13,118,富邦-宜蘭,2023-07-31,9686
2382,廣達,134,53,81,富邦-宜蘭,2023-07-31,9686
6116,彩晶,88,14,74,富邦-宜蘭,2023-07-31,9686
1618,合機,69,1,68,富邦-宜蘭,2023-07-31,9686
2329,華泰,150,82,68,富邦-宜蘭,2023-07-31,9686
2419,仲琦,71,4,67,富邦-宜蘭,2023-07-31,9686
4114,健喬,64,0,64,富邦-宜蘭,2023-07-31,9686
2027,大成鋼,59,0,59,富邦-宜蘭,2023-07-31,9686
00929,復華台灣科技優息,62,5,57,富邦-宜蘭,2023-07-31,9686
1612,宏泰,60,6,54,富邦-宜蘭,2023-07-31,9686
2880,華南金,52,0,52,富邦-宜蘭,2023-07-31,9686
00688L,國泰20年美債正2,51,0,51,富邦-宜蘭,2023-07-31,9686
2104,國際中橡,58,7,51,富邦-宜蘭,2023-07-31,9686
2609,陽明,56,8,48,富邦-宜蘭,2023-07-31,9686
5315,光聯,46,0,46,富邦-宜蘭,2023-07-31,9686
6118,建達,43,0,43,富邦-宜蘭,2023-07-31,9686
3706,神達,70,33,37,富邦-宜蘭,2023-07-31,9686
4532,瑞智,36,1,35,富邦-宜蘭,2023-07-31,9686
2324,仁寶,60,27,33,富邦-宜蘭,2023-07-31,9686
00679B,元大美債20年,31,0,31,富邦-宜蘭,2023-07-31,9686
911868,同方友友-DR,30,0,30,富邦-宜蘭,2023-07-31,9686
4569,六方科-KY,31,1,30,富邦-宜蘭,2023-07-31,9686
6188,廣明,50,20,30,富邦-宜蘭,2023-07-31,9686
00637L,元大滬深300正2,64,36,28,富邦-宜蘭,2023-07-31,9686
2537,聯上發,28,0,28,富邦-宜蘭,2023-07-31,9686
4979,華星光,53,26,27,富邦-宜蘭,2023-07-31,9686
3029,零壹,64,37,27,富邦-宜蘭,2023-07-31,9686
00753L,中信中國50正2,30,3,27,富邦-宜蘭,2023-07-31,9686
3051,力特,34,7,27,富邦-宜蘭,2023-07-31,9686
2885,元大金,31,4,27,富邦-宜蘭,2023-07-31,9686
2408,南亞科,30,4,26,富邦-宜蘭,2023-07-31,9686
00632R,元大台灣50反1,59,33,26,富邦-宜蘭,2023-07-31,9686
3272,東碩,28,2,26,富邦-宜蘭,2023-07-31,9686
4533,協易機,30,5,25,富邦-宜蘭,2023-07-31,9686
2317,鴻海,25,3,22,富邦-宜蘭,2023-07-31,9686
6642,富致,22,0,22,富邦-宜蘭,2023-07-31,9686
2356,英業達,65,44,21,富邦-宜蘭,2023-07-31,9686
00664R,國泰臺灣加權反1,21,0,21,富邦-宜蘭,2023-07-31,9686
2405,輔信,36,15,21,富邦-宜蘭,2023-07-31,9686
2409,友達,44,23,21,富邦-宜蘭,2023-07-31,9686
6190,萬泰科,23,3,20,富邦-宜蘭,2023-07-31,9686
1709,和益,20,0,20,富邦-宜蘭,2023-07-31,9686
9907,統一實,20,0,20,富邦-宜蘭,2023-07-31,9686
5457,宣德,25,5,20,富邦-宜蘭,2023-07-31,9686
2442,新美齊,20,0,20,富邦-宜蘭,2023-07-31,9686
2605,新興,20,0,20,富邦-宜蘭,2023-07-31,9686
3042,晶技,19,0,19,富邦-宜蘭,2023-07-31,9686
00751B,元大AAA至A公司債,19,0,19,富邦-宜蘭,2023-07-31,9686
00665L,富邦�琤肭磪囓�2,75,1,74,富邦-宜蘭,2023-08-01,9686
3029,零壹,69,15,54,富邦-宜蘭,2023-08-01,9686
1905,華紙,52,4,48,富邦-宜蘭,2023-08-01,9686
2363,矽統,103,56,47,富邦-宜蘭,2023-08-01,9686
2883,凱基金,53,8,45,富邦-宜蘭,2023-08-01,9686
2402,毅嘉,54,9,45,富邦-宜蘭,2023-08-01,9686
1504,東元,42,2,40,富邦-宜蘭,2023-08-01,9686
2401,凌陽,50,12,38,富邦-宜蘭,2023-08-01,9686
8358,金居,40,5,35,富邦-宜蘭,2023-08-01,9686
2312,金寶,66,32,34,富邦-宜蘭,2023-08-01,9686
00753L,中信中國50正2,33,0,33,富邦-宜蘭,2023-08-01,9686
00925,新光標普電動車,31,0,31,富邦-宜蘭,2023-08-01,9686
2329,華泰,48,21,27,富邦-宜蘭,2023-08-01,9686
00715L,期街口布蘭特正2,31,5,26,富邦-宜蘭,2023-08-01,9686
6218,豪勉,38,12,26,富邦-宜蘭,2023-08-01,9686
2603,長榮,29,4,25,富邦-宜蘭,2023-08-01,9686
2353,宏��,32,8,24,富邦-宜蘭,2023-08-01,9686
3062,建漢,27,4,23,富邦-宜蘭,2023-08-01,9686
00673R,期元大S＆P原油反1,25,3,22,富邦-宜蘭,2023-08-01,9686
00688L,國泰20年美債正2,21,0,21,富邦-宜蘭,2023-08-01,9686
5515,建國,20,0,20,富邦-宜蘭,2023-08-01,9686
5315,光聯,20,0,20,富邦-宜蘭,2023-08-01,9686
3051,力特,23,3,20,富邦-宜蘭,2023-08-01,9686
2906,高林,20,0,20,富邦-宜蘭,2023-08-01,9686
3264,欣銓,22,3,19,富邦-宜蘭,2023-08-01,9686
3706,神達,25,6,19,富邦-宜蘭,2023-08-01,9686
00893,國泰智能電動車,20,2,18,富邦-宜蘭,2023-08-01,9686
2634,漢翔,21,4,17,富邦-宜蘭,2023-08-01,9686
1618,合機,20,3,17,富邦-宜蘭,2023-08-01,9686
2890,永豐金,21,4,17,富邦-宜蘭,2023-08-01,9686
2344,華邦電,48,31,17,富邦-宜蘭,2023-08-01,9686
00930,永豐ESG低碳高息,18,2,16,富邦-宜蘭,2023-08-01,9686
6125,廣運,56,40,16,富邦-宜蘭,2023-08-01,9686
6282,康舒,65,50,15,富邦-宜蘭,2023-08-01,9686
2425,承啟,17,2,15,富邦-宜蘭,2023-08-01,9686
3033,威健,29,14,15,富邦-宜蘭,2023-08-01,9686
2449,京元電子,21,6,15,富邦-宜蘭,2023-08-01,9686
1210,大成,15,1,14,富邦-宜蘭,2023-08-01,9686
3583,辛耘,39,26,13,富邦-宜蘭,2023-08-01,9686
00929,復華台灣科技優息,72,59,13,富邦-宜蘭,2023-08-01,9686
2801,彰銀,13,0,13,富邦-宜蘭,2023-08-01,9686
3607,谷崧,13,0,13,富邦-宜蘭,2023-08-01,9686
2303,聯電,13,1,12,富邦-宜蘭,2023-08-01,9686
00924,復華S＆P500成長,12,0,12,富邦-宜蘭,2023-08-01,9686
4108,懷特,12,0,12,富邦-宜蘭,2023-08-01,9686
2454,聯發科,19,7,12,富邦-宜蘭,2023-08-01,9686
1471,首利,11,0,11,富邦-宜蘭,2023-08-01,9686
6231,系微,25,14,11,富邦-宜蘭,2023-08-01,9686
3682,亞太電,11,0,11,富邦-宜蘭,2023-08-01,9686
1584,精剛,11,0,11,富邦-宜蘭,2023-08-01,9686
4414,如興,247,0,247,富邦-宜蘭,2023-08-02,9686
3481,群創,255,19,236,富邦-宜蘭,2023-08-02,9686
2399,映泰,218,4,214,富邦-宜蘭,2023-08-02,9686
00929,復華台灣科技優息,214,24,190,富邦-宜蘭,2023-08-02,9686
00923,群益台ESG低碳50,194,14,180,富邦-宜蘭,2023-08-02,9686
6282,康舒,181,17,164,富邦-宜蘭,2023-08-02,9686
2409,友達,177,20,157,富邦-宜蘭,2023-08-02,9686
00900,富邦特選高股息30,166,26,140,富邦-宜蘭,2023-08-02,9686
1314,中石化,117,15,102,富邦-宜蘭,2023-08-02,9686
00680L,元大美債20正2,77,4,73,富邦-宜蘭,2023-08-02,9686
00751B,元大AAA至A公司債,78,5,73,富邦-宜蘭,2023-08-02,9686
2206,三陽工業,141,75,66,富邦-宜蘭,2023-08-02,9686
00679B,元大美債20年,73,7,66,富邦-宜蘭,2023-08-02,9686
2301,光寶科,87,22,65,富邦-宜蘭,2023-08-02,9686
2882,國泰金,63,5,58,富邦-宜蘭,2023-08-02,9686
8927,北基,50,0,50,富邦-宜蘭,2023-08-02,9686
4114,健喬,66,22,44,富邦-宜蘭,2023-08-02,9686
2888,新光金,116,76,40,富邦-宜蘭,2023-08-02,9686
00878,國泰永續高股息,359,321,38,富邦-宜蘭,2023-08-02,9686
2801,彰銀,36,0,36,富邦-宜蘭,2023-08-02,9686
6789,采鈺,36,0,36,富邦-宜蘭,2023-08-02,9686
00888,永豐台灣ESG,36,0,36,富邦-宜蘭,2023-08-02,9686
2890,永豐金,49,13,36,富邦-宜蘭,2023-08-02,9686
00673R,期元大S＆P原油反1,31,0,31,富邦-宜蘭,2023-08-02,9686
2886,兆豐金,34,4,30,富邦-宜蘭,2023-08-02,9686
00885,富邦越南,53,23,30,富邦-宜蘭,2023-08-02,9686
1605,華新,194,164,30,富邦-宜蘭,2023-08-02,9686
6125,廣運,67,38,29,富邦-宜蘭,2023-08-02,9686
00642U,期元大S＆P石油,30,1,29,富邦-宜蘭,2023-08-02,9686
2353,宏��,31,3,28,富邦-宜蘭,2023-08-02,9686
00881,國泰台灣5G+,32,5,27,富邦-宜蘭,2023-08-02,9686
2498,宏達電,52,25,27,富邦-宜蘭,2023-08-02,9686
00712,復華富時不動產,44,18,26,富邦-宜蘭,2023-08-02,9686
6116,彩晶,56,30,26,富邦-宜蘭,2023-08-02,9686
3037,欣興,42,17,25,富邦-宜蘭,2023-08-02,9686
2883,凱基金,37,12,25,富邦-宜蘭,2023-08-02,9686
1504,東元,105,80,25,富邦-宜蘭,2023-08-02,9686
2362,藍天,25,0,25,富邦-宜蘭,2023-08-02,9686
3711,日月光投控,25,1,24,富邦-宜蘭,2023-08-02,9686
2884,玉山金,27,4,23,富邦-宜蘭,2023-08-02,9686
5483,中美晶,27,5,22,富邦-宜蘭,2023-08-02,9686
00687B,國泰20年美債,21,0,21,富邦-宜蘭,2023-08-02,9686
00907,永豐優息存股,21,0,21,富邦-宜蘭,2023-08-02,9686
2885,元大金,24,4,20,富邦-宜蘭,2023-08-02,9686
8404,百和興業-KY,20,0,20,富邦-宜蘭,2023-08-02,9686
1709,和益,20,0,20,富邦-宜蘭,2023-08-02,9686
3272,東碩,21,1,20,富邦-宜蘭,2023-08-02,9686
00720B,元大投資級公司債,28,8,20,富邦-宜蘭,2023-08-02,9686
2881,富邦金,49,31,18,富邦-宜蘭,2023-08-02,9686
2618,長榮航,35,17,18,富邦-宜蘭,2023-08-02,9686
2344,華邦電,130,19,111,富邦-宜蘭,2023-08-04,9686
1504,東元,113,3,110,富邦-宜蘭,2023-08-04,9686
1608,華榮,99,13,86,富邦-宜蘭,2023-08-04,9686
2399,映泰,85,1,84,富邦-宜蘭,2023-08-04,9686
00680L,元大美債20正2,83,0,83,富邦-宜蘭,2023-08-04,9686
2609,陽明,98,21,77,富邦-宜蘭,2023-08-04,9686
00929,復華台灣科技優息,98,25,73,富邦-宜蘭,2023-08-04,9686
2014,中鴻,123,50,73,富邦-宜蘭,2023-08-04,9686
00679B,元大美債20年,74,7,67,富邦-宜蘭,2023-08-04,9686
1605,華新,119,53,66,富邦-宜蘭,2023-08-04,9686
1609,大亞,99,35,64,富邦-宜蘭,2023-08-04,9686
00720B,元大投資級公司債,62,0,62,富邦-宜蘭,2023-08-04,9686
2891,中信金,65,7,58,富邦-宜蘭,2023-08-04,9686
1905,華紙,79,21,58,富邦-宜蘭,2023-08-04,9686
00878,國泰永續高股息,127,69,58,富邦-宜蘭,2023-08-04,9686
3704,合勤控,59,2,57,富邦-宜蘭,2023-08-04,9686
00751B,元大AAA至A公司債,54,0,54,富邦-宜蘭,2023-08-04,9686
00900,富邦特選高股息30,53,1,52,富邦-宜蘭,2023-08-04,9686
00724B,群益投資級金融債,50,0,50,富邦-宜蘭,2023-08-04,9686
00923,群益台ESG低碳50,47,1,46,富邦-宜蘭,2023-08-04,9686
1434,福懋,50,5,45,富邦-宜蘭,2023-08-04,9686
00632R,元大台灣50反1,100,56,44,富邦-宜蘭,2023-08-04,9686
4746,台耀,51,8,43,富邦-宜蘭,2023-08-04,9686
00687B,國泰20年美債,42,1,41,富邦-宜蘭,2023-08-04,9686
8215,明基材,40,1,39,富邦-宜蘭,2023-08-04,9686
2356,英業達,127,89,38,富邦-宜蘭,2023-08-04,9686
00665L,富邦�琤肭磪囓�2,35,0,35,富邦-宜蘭,2023-08-04,9686
6609,瀧澤科,34,0,34,富邦-宜蘭,2023-08-04,9686
2809,京城銀,33,0,33,富邦-宜蘭,2023-08-04,9686
2630,亞航,34,4,30,富邦-宜蘭,2023-08-04,9686
00772B,中信高評級公司債,26,0,26,富邦-宜蘭,2023-08-04,9686
3163,波若威,52,26,26,富邦-宜蘭,2023-08-04,9686
1528,恩德,36,12,24,富邦-宜蘭,2023-08-04,9686
1210,大成,22,0,22,富邦-宜蘭,2023-08-04,9686
3581,博磊,35,14,21,富邦-宜蘭,2023-08-04,9686
4164,承業醫,24,3,21,富邦-宜蘭,2023-08-04,9686
00897,富邦基因免疫生技,20,0,20,富邦-宜蘭,2023-08-04,9686
2440,太空梭,23,3,20,富邦-宜蘭,2023-08-04,9686
8021,尖點,20,0,20,富邦-宜蘭,2023-08-04,9686
2009,第一銅,19,0,19,富邦-宜蘭,2023-08-04,9686
00673R,期元大S＆P原油反1,19,1,18,富邦-宜蘭,2023-08-04,9686
2002,中鋼,16,0,16,富邦-宜蘭,2023-08-04,9686
00922,國泰台灣領袖50,17,2,15,富邦-宜蘭,2023-08-04,9686
3305,昇貿,15,0,15,富邦-宜蘭,2023-08-04,9686
2881,富邦金,14,1,13,富邦-宜蘭,2023-08-04,9686
1810,和成,13,0,13,富邦-宜蘭,2023-08-04,9686
1612,宏泰,22,10,12,富邦-宜蘭,2023-08-04,9686
00891,中信關鍵半導體,12,0,12,富邦-宜蘭,2023-08-04,9686
9907,統一實,11,0,11,富邦-宜蘭,2023-08-04,9686
2329,華泰,50,39,11,富邦-宜蘭,2023-08-04,9686
00753L,中信中國50正2,115,0,115,富邦-宜蘭,2023-08-07,9686
00931B,統一美債20年,111,0,111,富邦-宜蘭,2023-08-07,9686
00929,復華台灣科技優息,127,28,99,富邦-宜蘭,2023-08-07,9686
00923,群益台ESG低碳50,75,2,73,富邦-宜蘭,2023-08-07,9686
3581,博磊,73,3,70,富邦-宜蘭,2023-08-07,9686
2409,友達,64,6,58,富邦-宜蘭,2023-08-07,9686
2402,毅嘉,57,3,54,富邦-宜蘭,2023-08-07,9686
2891,中信金,56,7,49,富邦-宜蘭,2023-08-07,9686
9927,泰銘,57,10,47,富邦-宜蘭,2023-08-07,9686
2610,華航,52,9,43,富邦-宜蘭,2023-08-07,9686
5009,榮剛,46,7,39,富邦-宜蘭,2023-08-07,9686
1727,中華化,38,0,38,富邦-宜蘭,2023-08-07,9686
2354,鴻準,39,1,38,富邦-宜蘭,2023-08-07,9686
2618,長榮航,43,10,33,富邦-宜蘭,2023-08-07,9686
00773B,中信優先金融債,33,0,33,富邦-宜蘭,2023-08-07,9686
8930,青鋼,40,9,31,富邦-宜蘭,2023-08-07,9686
2913,農林,39,8,31,富邦-宜蘭,2023-08-07,9686
00632R,元大台灣50反1,30,0,30,富邦-宜蘭,2023-08-07,9686
00673R,期元大S＆P原油反1,28,0,28,富邦-宜蘭,2023-08-07,9686
2464,盟立,40,13,27,富邦-宜蘭,2023-08-07,9686
2027,大成鋼,26,0,26,富邦-宜蘭,2023-08-07,9686
2489,瑞軒,27,2,25,富邦-宜蘭,2023-08-07,9686
2906,高林,24,0,24,富邦-宜蘭,2023-08-07,9686
9907,統一實,22,0,22,富邦-宜蘭,2023-08-07,9686
6753,龍德造船,21,0,21,富邦-宜蘭,2023-08-07,9686
00902,中信電池及儲能,22,1,21,富邦-宜蘭,2023-08-07,9686
2103,台橡,21,0,21,富邦-宜蘭,2023-08-07,9686
00795B,中信美國公債20年,21,0,21,富邦-宜蘭,2023-08-07,9686
2801,彰銀,30,10,20,富邦-宜蘭,2023-08-07,9686
2025,千興,20,0,20,富邦-宜蘭,2023-08-07,9686
4956,光鋐,20,0,20,富邦-宜蘭,2023-08-07,9686
2317,鴻海,38,19,19,富邦-宜蘭,2023-08-07,9686
1434,福懋,19,0,19,富邦-宜蘭,2023-08-07,9686
1529,樂事綠能,20,2,18,富邦-宜蘭,2023-08-07,9686
2312,金寶,18,1,17,富邦-宜蘭,2023-08-07,9686
1815,富喬,17,0,17,富邦-宜蘭,2023-08-07,9686
00720B,元大投資級公司債,17,0,17,富邦-宜蘭,2023-08-07,9686
3481,群創,34,17,17,富邦-宜蘭,2023-08-07,9686
3033,威健,17,1,16,富邦-宜蘭,2023-08-07,9686
3363,上詮,19,3,16,富邦-宜蘭,2023-08-07,9686
2009,第一銅,17,2,15,富邦-宜蘭,2023-08-07,9686
00930,永豐ESG低碳高息,13,0,13,富邦-宜蘭,2023-08-07,9686
2882,國泰金,20,7,13,富邦-宜蘭,2023-08-07,9686
6274,台燿,17,5,12,富邦-宜蘭,2023-08-07,9686
8150,南茂,15,3,12,富邦-宜蘭,2023-08-07,9686
6275,元山,16,4,12,富邦-宜蘭,2023-08-07,9686
00878,國泰永續高股息,57,46,11,富邦-宜蘭,2023-08-07,9686
3703,欣陸,11,0,11,富邦-宜蘭,2023-08-07,9686
2332,友訊,11,0,11,富邦-宜蘭,2023-08-07,9686
5452,佶優,30,19,11,富邦-宜蘭,2023-08-07,9686
2890,永豐金,175,4,171,富邦-宜蘭,2023-08-08,9686
00878,國泰永續高股息,190,20,170,富邦-宜蘭,2023-08-08,9686
00900,富邦特選高股息30,180,58,122,富邦-宜蘭,2023-08-08,9686
3231,緯創,304,188,116,富邦-宜蘭,2023-08-08,9686
00929,復華台灣科技優息,123,16,107,富邦-宜蘭,2023-08-08,9686
00665L,富邦�琤肭磪囓�2,73,0,73,富邦-宜蘭,2023-08-08,9686
1504,東元,76,16,60,富邦-宜蘭,2023-08-08,9686
8930,青鋼,69,10,59,富邦-宜蘭,2023-08-08,9686
2356,英業達,177,120,57,富邦-宜蘭,2023-08-08,9686
1608,華榮,61,10,51,富邦-宜蘭,2023-08-08,9686
00930,永豐ESG低碳高息,51,0,51,富邦-宜蘭,2023-08-08,9686
0056,元大高股息,81,33,48,富邦-宜蘭,2023-08-08,9686
00923,群益台ESG低碳50,50,2,48,富邦-宜蘭,2023-08-08,9686
6188,廣明,81,35,46,富邦-宜蘭,2023-08-08,9686
00931B,統一美債20年,41,0,41,富邦-宜蘭,2023-08-08,9686
00919,群益台灣精選高息,40,0,40,富邦-宜蘭,2023-08-08,9686
00772B,中信高評級公司債,40,1,39,富邦-宜蘭,2023-08-08,9686
5880,合庫金,39,1,38,富邦-宜蘭,2023-08-08,9686
2881,富邦金,42,5,37,富邦-宜蘭,2023-08-08,9686
2906,高林,36,0,36,富邦-宜蘭,2023-08-08,9686
2337,旺宏,35,0,35,富邦-宜蘭,2023-08-08,9686
00902,中信電池及儲能,34,0,34,富邦-宜蘭,2023-08-08,9686
2913,農林,54,21,33,富邦-宜蘭,2023-08-08,9686
4414,如興,31,0,31,富邦-宜蘭,2023-08-08,9686
1762,中化生,31,0,31,富邦-宜蘭,2023-08-08,9686
6271,同欣電,30,0,30,富邦-宜蘭,2023-08-08,9686
2891,中信金,30,2,28,富邦-宜蘭,2023-08-08,9686
1215,卜蜂,28,0,28,富邦-宜蘭,2023-08-08,9686
00888,永豐台灣ESG,38,10,28,富邦-宜蘭,2023-08-08,9686
3706,神達,47,20,27,富邦-宜蘭,2023-08-08,9686
4906,正文,27,1,26,富邦-宜蘭,2023-08-08,9686
2382,廣達,106,80,26,富邦-宜蘭,2023-08-08,9686
2303,聯電,52,27,25,富邦-宜蘭,2023-08-08,9686
00753L,中信中國50正2,24,1,23,富邦-宜蘭,2023-08-08,9686
00751B,元大AAA至A公司債,23,0,23,富邦-宜蘭,2023-08-08,9686
00680L,元大美債20正2,33,10,23,富邦-宜蘭,2023-08-08,9686
6116,彩晶,22,0,22,富邦-宜蘭,2023-08-08,9686
6139,亞翔,41,19,22,富邦-宜蘭,2023-08-08,9686
4938,和碩,30,8,22,富邦-宜蘭,2023-08-08,9686
2618,長榮航,44,23,21,富邦-宜蘭,2023-08-08,9686
6216,居易,20,0,20,富邦-宜蘭,2023-08-08,9686
3703,欣陸,20,0,20,富邦-宜蘭,2023-08-08,9686
1786,科妍,20,0,20,富邦-宜蘭,2023-08-08,9686
00720B,元大投資級公司債,18,0,18,富邦-宜蘭,2023-08-08,9686
00882,中信中國高股息,19,2,17,富邦-宜蘭,2023-08-08,9686
2388,威盛,24,7,17,富邦-宜蘭,2023-08-08,9686
2344,華邦電,19,2,17,富邦-宜蘭,2023-08-08,9686
3447,展達,16,0,16,富邦-宜蘭,2023-08-08,9686
3024,憶聲,16,0,16,富邦-宜蘭,2023-08-08,9686
5243,乙盛-KY,16,0,16,富邦-宜蘭,2023-08-08,9686
00929,復華台灣科技優息,78,5,73,富邦-宜蘭,2023-08-09,9686
00900,富邦特選高股息30,73,12,61,富邦-宜蘭,2023-08-09,9686
00680L,元大美債20正2,71,10,61,富邦-宜蘭,2023-08-09,9686
00931B,統一美債20年,54,1,53,富邦-宜蘭,2023-08-09,9686
1504,東元,56,3,53,富邦-宜蘭,2023-08-09,9686
00761B,國泰A級公司債,50,0,50,富邦-宜蘭,2023-08-09,9686
2344,華邦電,52,4,48,富邦-宜蘭,2023-08-09,9686
3231,緯創,297,250,47,富邦-宜蘭,2023-08-09,9686
00715L,期街口布蘭特正2,50,5,45,富邦-宜蘭,2023-08-09,9686
3062,建漢,39,0,39,富邦-宜蘭,2023-08-09,9686
2605,新興,35,0,35,富邦-宜蘭,2023-08-09,9686
2801,彰銀,52,20,32,富邦-宜蘭,2023-08-09,9686
00632R,元大台灣50反1,31,0,31,富邦-宜蘭,2023-08-09,9686
2002,中鋼,30,0,30,富邦-宜蘭,2023-08-09,9686
2606,裕民,30,0,30,富邦-宜蘭,2023-08-09,9686
6216,居易,30,0,30,富邦-宜蘭,2023-08-09,9686
1609,大亞,61,32,29,富邦-宜蘭,2023-08-09,9686
3051,力特,28,1,27,富邦-宜蘭,2023-08-09,9686
00878,國泰永續高股息,59,33,26,富邦-宜蘭,2023-08-09,9686
5880,合庫金,33,7,26,富邦-宜蘭,2023-08-09,9686
1514,亞力,25,1,24,富邦-宜蘭,2023-08-09,9686
6122,擎邦,25,3,22,富邦-宜蘭,2023-08-09,9686
00665L,富邦�琤肭磪囓�2,21,0,21,富邦-宜蘭,2023-08-09,9686
1711,永光,21,0,21,富邦-宜蘭,2023-08-09,9686
5425,台半,38,17,21,富邦-宜蘭,2023-08-09,9686
5864,致和證,20,0,20,富邦-宜蘭,2023-08-09,9686
9927,泰銘,21,2,19,富邦-宜蘭,2023-08-09,9686
2382,廣達,70,52,18,富邦-宜蘭,2023-08-09,9686
3706,神達,79,61,18,富邦-宜蘭,2023-08-09,9686
2882,國泰金,22,4,18,富邦-宜蘭,2023-08-09,9686
1722,台肥,18,0,18,富邦-宜蘭,2023-08-09,9686
00930,永豐ESG低碳高息,17,0,17,富邦-宜蘭,2023-08-09,9686
1708,東鹼,17,0,17,富邦-宜蘭,2023-08-09,9686
00885,富邦越南,22,5,17,富邦-宜蘭,2023-08-09,9686
6120,達運,18,1,17,富邦-宜蘭,2023-08-09,9686
5009,榮剛,17,0,17,富邦-宜蘭,2023-08-09,9686
2206,三陽工業,57,41,16,富邦-宜蘭,2023-08-09,9686
1727,中華化,16,0,16,富邦-宜蘭,2023-08-09,9686
2634,漢翔,31,15,16,富邦-宜蘭,2023-08-09,9686
2409,友達,22,7,15,富邦-宜蘭,2023-08-09,9686
00923,群益台ESG低碳50,15,0,15,富邦-宜蘭,2023-08-09,9686
4961,天鈺,15,0,15,富邦-宜蘭,2023-08-09,9686
2399,映泰,20,5,15,富邦-宜蘭,2023-08-09,9686
1802,台玻,19,4,15,富邦-宜蘭,2023-08-09,9686
6111,大宇資,15,0,15,富邦-宜蘭,2023-08-09,9686
6104,創惟,14,0,14,富邦-宜蘭,2023-08-09,9686
4744,皇將,14,0,14,富邦-宜蘭,2023-08-09,9686
6282,康舒,37,23,14,富邦-宜蘭,2023-08-09,9686
4127,天良,14,0,14,富邦-宜蘭,2023-08-09,9686
4976,佳凌,13,0,13,富邦-宜蘭,2023-08-09,9686
3481,群創,348,7,341,富邦-宜蘭,2023-08-10,9686
00878,國泰永續高股息,259,23,236,富邦-宜蘭,2023-08-10,9686
00929,復華台灣科技優息,146,28,118,富邦-宜蘭,2023-08-10,9686
1504,東元,109,0,109,富邦-宜蘭,2023-08-10,9686
00900,富邦特選高股息30,72,0,72,富邦-宜蘭,2023-08-10,9686
3706,神達,85,20,65,富邦-宜蘭,2023-08-10,9686
2886,兆豐金,59,1,58,富邦-宜蘭,2023-08-10,9686
2409,友達,64,8,56,富邦-宜蘭,2023-08-10,9686
2329,華泰,85,34,51,富邦-宜蘭,2023-08-10,9686
2382,廣達,84,40,44,富邦-宜蘭,2023-08-10,9686
2610,華航,77,33,44,富邦-宜蘭,2023-08-10,9686
2883,凱基金,58,15,43,富邦-宜蘭,2023-08-10,9686
6282,康舒,156,115,41,富邦-宜蘭,2023-08-10,9686
1720,生達,42,1,41,富邦-宜蘭,2023-08-10,9686
2323,中環,46,8,38,富邦-宜蘭,2023-08-10,9686
1605,華新,42,5,37,富邦-宜蘭,2023-08-10,9686
2606,裕民,37,1,36,富邦-宜蘭,2023-08-10,9686
2399,映泰,47,12,35,富邦-宜蘭,2023-08-10,9686
1609,大亞,53,19,34,富邦-宜蘭,2023-08-10,9686
00715L,期街口布蘭特正2,34,1,33,富邦-宜蘭,2023-08-10,9686
2356,英業達,79,48,31,富邦-宜蘭,2023-08-10,9686
2363,矽統,99,68,31,富邦-宜蘭,2023-08-10,9686
2376,技嘉,48,18,30,富邦-宜蘭,2023-08-10,9686
2609,陽明,35,7,28,富邦-宜蘭,2023-08-10,9686
3078,僑威,40,12,28,富邦-宜蘭,2023-08-10,9686
3715,定穎投控,27,0,27,富邦-宜蘭,2023-08-10,9686
00931B,統一美債20年,25,0,25,富邦-宜蘭,2023-08-10,9686
2402,毅嘉,49,24,25,富邦-宜蘭,2023-08-10,9686
00720B,元大投資級公司債,23,0,23,富邦-宜蘭,2023-08-10,9686
2891,中信金,29,7,22,富邦-宜蘭,2023-08-10,9686
6589,台康生技,22,1,21,富邦-宜蘭,2023-08-10,9686
00673R,期元大S＆P原油反1,21,0,21,富邦-宜蘭,2023-08-10,9686
00888,永豐台灣ESG,21,0,21,富邦-宜蘭,2023-08-10,9686
3710,連展投控,19,0,19,富邦-宜蘭,2023-08-10,9686
3032,偉訓,22,3,19,富邦-宜蘭,2023-08-10,9686
2002,中鋼,20,2,18,富邦-宜蘭,2023-08-10,9686
3017,奇鋐,30,12,18,富邦-宜蘭,2023-08-10,9686
2312,金寶,23,5,18,富邦-宜蘭,2023-08-10,9686
1513,中興電,34,16,18,富邦-宜蘭,2023-08-10,9686
00923,群益台ESG低碳50,17,0,17,富邦-宜蘭,2023-08-10,9686
2367,燿華,17,0,17,富邦-宜蘭,2023-08-10,9686
2892,第一金,28,11,17,富邦-宜蘭,2023-08-10,9686
00919,群益台灣精選高息,20,3,17,富邦-宜蘭,2023-08-10,9686
2353,宏��,17,1,16,富邦-宜蘭,2023-08-10,9686
00881,國泰台灣5G+,16,0,16,富邦-宜蘭,2023-08-10,9686
3163,波若威,59,43,16,富邦-宜蘭,2023-08-10,9686
2344,華邦電,16,0,16,富邦-宜蘭,2023-08-10,9686
6203,海韻電,18,2,16,富邦-宜蘭,2023-08-10,9686
00751B,元大AAA至A公司債,16,0,16,富邦-宜蘭,2023-08-10,9686
2303,聯電,17,2,15,富邦-宜蘭,2023-08-10,9686
00665L,富邦�琤肭磪囓�2,127,0,127,富邦-宜蘭,2023-08-11,9686
00929,復華台灣科技優息,151,40,111,富邦-宜蘭,2023-08-11,9686
3481,群創,119,25,94,富邦-宜蘭,2023-08-11,9686
2618,長榮航,95,42,53,富邦-宜蘭,2023-08-11,9686
00931B,統一美債20年,46,0,46,富邦-宜蘭,2023-08-11,9686
00900,富邦特選高股息30,45,1,44,富邦-宜蘭,2023-08-11,9686
1616,億泰,42,0,42,富邦-宜蘭,2023-08-11,9686
2355,敬鵬,52,16,36,富邦-宜蘭,2023-08-11,9686
00923,群益台ESG低碳50,35,0,35,富邦-宜蘭,2023-08-11,9686
9927,泰銘,34,0,34,富邦-宜蘭,2023-08-11,9686
2892,第一金,36,6,30,富邦-宜蘭,2023-08-11,9686
1609,大亞,37,8,29,富邦-宜蘭,2023-08-11,9686
2344,華邦電,29,5,24,富邦-宜蘭,2023-08-11,9686
00680L,元大美債20正2,24,0,24,富邦-宜蘭,2023-08-11,9686
00720B,元大投資級公司債,24,1,23,富邦-宜蘭,2023-08-11,9686
6508,惠光,22,0,22,富邦-宜蘭,2023-08-11,9686
1795,美時,27,6,21,富邦-宜蘭,2023-08-11,9686
00753L,中信中國50正2,21,0,21,富邦-宜蘭,2023-08-11,9686
8446,華研,22,1,21,富邦-宜蘭,2023-08-11,9686
2409,友達,42,22,20,富邦-宜蘭,2023-08-11,9686
00907,永豐優息存股,19,0,19,富邦-宜蘭,2023-08-11,9686
2027,大成鋼,19,0,19,富邦-宜蘭,2023-08-11,9686
3380,明泰,20,1,19,富邦-宜蘭,2023-08-11,9686
00637L,元大滬深300正2,28,10,18,富邦-宜蘭,2023-08-11,9686
2891,中信金,41,23,18,富邦-宜蘭,2023-08-11,9686
3706,神達,24,6,18,富邦-宜蘭,2023-08-11,9686
6129,普誠,17,0,17,富邦-宜蘭,2023-08-11,9686
5607,遠雄港,17,0,17,富邦-宜蘭,2023-08-11,9686
00655L,國泰中國A50正2,17,0,17,富邦-宜蘭,2023-08-11,9686
2609,陽明,22,5,17,富邦-宜蘭,2023-08-11,9686
2405,輔信,17,2,15,富邦-宜蘭,2023-08-11,9686
2855,統一證,15,0,15,富邦-宜蘭,2023-08-11,9686
2352,佳世達,41,26,15,富邦-宜蘭,2023-08-11,9686
2885,元大金,17,2,15,富邦-宜蘭,2023-08-11,9686
1722,台肥,14,0,14,富邦-宜蘭,2023-08-11,9686
1802,台玻,21,8,13,富邦-宜蘭,2023-08-11,9686
3591,艾笛森,17,5,12,富邦-宜蘭,2023-08-11,9686
2913,農林,13,1,12,富邦-宜蘭,2023-08-11,9686
6005,群益證,14,2,12,富邦-宜蘭,2023-08-11,9686
3535,晶彩科,12,0,12,富邦-宜蘭,2023-08-11,9686
00650L,復華香港正2,12,0,12,富邦-宜蘭,2023-08-11,9686
00722B,群益投資級電信債,12,0,12,富邦-宜蘭,2023-08-11,9686
2884,玉山金,13,2,11,富邦-宜蘭,2023-08-11,9686
00687B,國泰20年美債,11,0,11,富邦-宜蘭,2023-08-11,9686
5425,台半,13,2,11,富邦-宜蘭,2023-08-11,9686
2883,凱基金,16,5,11,富邦-宜蘭,2023-08-11,9686
5474,聰泰,11,0,11,富邦-宜蘭,2023-08-11,9686
2367,燿華,11,0,11,富邦-宜蘭,2023-08-11,9686
1608,華榮,11,0,11,富邦-宜蘭,2023-08-11,9686
8071,能率網通,11,0,11,富邦-宜蘭,2023-08-11,9686
00929,復華台灣科技優息,342,4,338,富邦-宜蘭,2023-08-14,9686
1616,億泰,200,0,200,富邦-宜蘭,2023-08-14,9686
00900,富邦特選高股息30,190,0,190,富邦-宜蘭,2023-08-14,9686
00878,國泰永續高股息,179,12,167,富邦-宜蘭,2023-08-14,9686
1504,東元,149,4,145,富邦-宜蘭,2023-08-14,9686
2881,富邦金,154,32,122,富邦-宜蘭,2023-08-14,9686
1216,統一,100,0,100,富邦-宜蘭,2023-08-14,9686
2344,華邦電,90,3,87,富邦-宜蘭,2023-08-14,9686
2610,華航,87,6,81,富邦-宜蘭,2023-08-14,9686
3479,安勤,61,1,60,富邦-宜蘭,2023-08-14,9686
4114,健喬,45,0,45,富邦-宜蘭,2023-08-14,9686
00673R,期元大S＆P原油反1,53,10,43,富邦-宜蘭,2023-08-14,9686
6282,康舒,49,8,41,富邦-宜蘭,2023-08-14,9686
2206,三陽工業,39,1,38,富邦-宜蘭,2023-08-14,9686
1513,中興電,36,1,35,富邦-宜蘭,2023-08-14,9686
00753L,中信中國50正2,40,5,35,富邦-宜蘭,2023-08-14,9686
2002,中鋼,36,3,33,富邦-宜蘭,2023-08-14,9686
2618,長榮航,41,11,30,富邦-宜蘭,2023-08-14,9686
00665L,富邦�琤肭磪囓�2,31,2,29,富邦-宜蘭,2023-08-14,9686
2401,凌陽,29,1,28,富邦-宜蘭,2023-08-14,9686
006208,富邦台50,26,1,25,富邦-宜蘭,2023-08-14,9686
00923,群益台ESG低碳50,23,0,23,富邦-宜蘭,2023-08-14,9686
2605,新興,23,0,23,富邦-宜蘭,2023-08-14,9686
2303,聯電,28,5,23,富邦-宜蘭,2023-08-14,9686
3231,緯創,96,73,23,富邦-宜蘭,2023-08-14,9686
3049,精金,22,0,22,富邦-宜蘭,2023-08-14,9686
2834,臺企銀,21,0,21,富邦-宜蘭,2023-08-14,9686
2301,光寶科,25,4,21,富邦-宜蘭,2023-08-14,9686
2014,中鴻,23,2,21,富邦-宜蘭,2023-08-14,9686
00888,永豐台灣ESG,20,0,20,富邦-宜蘭,2023-08-14,9686
2608,嘉里大榮,22,2,20,富邦-宜蘭,2023-08-14,9686
00722B,群益投資級電信債,20,0,20,富邦-宜蘭,2023-08-14,9686
3715,定穎投控,22,2,20,富邦-宜蘭,2023-08-14,9686
3581,博磊,22,3,19,富邦-宜蘭,2023-08-14,9686
2888,新光金,80,61,19,富邦-宜蘭,2023-08-14,9686
00907,永豐優息存股,19,0,19,富邦-宜蘭,2023-08-14,9686
4128,中天,19,2,17,富邦-宜蘭,2023-08-14,9686
1605,華新,57,41,16,富邦-宜蘭,2023-08-14,9686
3024,憶聲,16,0,16,富邦-宜蘭,2023-08-14,9686
6672,騰輝電子-KY,15,0,15,富邦-宜蘭,2023-08-14,9686
2106,建大,15,0,15,富邦-宜蘭,2023-08-14,9686
0056,元大高股息,26,11,15,富邦-宜蘭,2023-08-14,9686
0050,元大台灣50,16,1,15,富邦-宜蘭,2023-08-14,9686
00679B,元大美債20年,16,2,14,富邦-宜蘭,2023-08-14,9686
4933,友輝,15,1,14,富邦-宜蘭,2023-08-14,9686
2891,中信金,30,16,14,富邦-宜蘭,2023-08-14,9686
5258,虹堡,16,3,13,富邦-宜蘭,2023-08-14,9686
2882,國泰金,19,6,13,富邦-宜蘭,2023-08-14,9686
6508,惠光,13,0,13,富邦-宜蘭,2023-08-14,9686
2409,友達,26,14,12,富邦-宜蘭,2023-08-14,9686
00900,富邦特選高股息30,192,1,191,富邦-宜蘭,2023-08-15,9686
1616,億泰,191,2,189,富邦-宜蘭,2023-08-15,9686
00878,國泰永續高股息,188,30,158,富邦-宜蘭,2023-08-15,9686
00923,群益台ESG低碳50,134,0,134,富邦-宜蘭,2023-08-15,9686
2883,凱基金,120,7,113,富邦-宜蘭,2023-08-15,9686
2317,鴻海,114,6,108,富邦-宜蘭,2023-08-15,9686
00929,復華台灣科技優息,108,10,98,富邦-宜蘭,2023-08-15,9686
1504,東元,94,8,86,富邦-宜蘭,2023-08-15,9686
00632R,元大台灣50反1,90,15,75,富邦-宜蘭,2023-08-15,9686
00679B,元大美債20年,45,0,45,富邦-宜蘭,2023-08-15,9686
8109,博大,43,2,41,富邦-宜蘭,2023-08-15,9686
2887,台新金,40,0,40,富邦-宜蘭,2023-08-15,9686
6770,力積電,40,4,36,富邦-宜蘭,2023-08-15,9686
3581,博磊,31,1,30,富邦-宜蘭,2023-08-15,9686
00720B,元大投資級公司債,30,0,30,富邦-宜蘭,2023-08-15,9686
3567,逸昌,30,1,29,富邦-宜蘭,2023-08-15,9686
2886,兆豐金,27,1,26,富邦-宜蘭,2023-08-15,9686
2634,漢翔,29,3,26,富邦-宜蘭,2023-08-15,9686
00753L,中信中國50正2,31,6,25,富邦-宜蘭,2023-08-15,9686
2884,玉山金,25,0,25,富邦-宜蘭,2023-08-15,9686
1708,東鹼,24,0,24,富邦-宜蘭,2023-08-15,9686
5880,合庫金,26,2,24,富邦-宜蘭,2023-08-15,9686
2881,富邦金,43,21,22,富邦-宜蘭,2023-08-15,9686
1517,利奇,20,0,20,富邦-宜蘭,2023-08-15,9686
00907,永豐優息存股,25,5,20,富邦-宜蘭,2023-08-15,9686
2882,國泰金,17,0,17,富邦-宜蘭,2023-08-15,9686
2891,中信金,18,1,17,富邦-宜蘭,2023-08-15,9686
00931B,統一美債20年,17,2,15,富邦-宜蘭,2023-08-15,9686
2834,臺企銀,18,3,15,富邦-宜蘭,2023-08-15,9686
1802,台玻,19,4,15,富邦-宜蘭,2023-08-15,9686
2323,中環,24,9,15,富邦-宜蘭,2023-08-15,9686
6005,群益證,14,0,14,富邦-宜蘭,2023-08-15,9686
2609,陽明,20,6,14,富邦-宜蘭,2023-08-15,9686
2408,南亞科,13,0,13,富邦-宜蘭,2023-08-15,9686
4906,正文,15,2,13,富邦-宜蘭,2023-08-15,9686
6609,瀧澤科,12,0,12,富邦-宜蘭,2023-08-15,9686
1714,和桐,12,0,12,富邦-宜蘭,2023-08-15,9686
006208,富邦台50,11,0,11,富邦-宜蘭,2023-08-15,9686
4167,松瑞藥,11,0,11,富邦-宜蘭,2023-08-15,9686
00892,富邦台灣半導體,11,0,11,富邦-宜蘭,2023-08-15,9686
6579,研揚,15,4,11,富邦-宜蘭,2023-08-15,9686
1905,華紙,13,2,11,富邦-宜蘭,2023-08-15,9686
3710,連展投控,11,0,11,富邦-宜蘭,2023-08-15,9686
2206,三陽工業,16,5,11,富邦-宜蘭,2023-08-15,9686
2890,永豐金,11,0,11,富邦-宜蘭,2023-08-15,9686
2002,中鋼,15,5,10,富邦-宜蘭,2023-08-15,9686
6204,艾華,10,0,10,富邦-宜蘭,2023-08-15,9686
4127,天良,10,0,10,富邦-宜蘭,2023-08-15,9686
8034,榮群,10,0,10,富邦-宜蘭,2023-08-15,9686
00788B,元大10年IG電能債,10,0,10,富邦-宜蘭,2023-08-15,9686
1616,億泰,176,12,164,富邦-宜蘭,2023-08-16,9686
2883,凱基金,235,111,124,富邦-宜蘭,2023-08-16,9686
00900,富邦特選高股息30,120,1,119,富邦-宜蘭,2023-08-16,9686
00923,群益台ESG低碳50,97,1,96,富邦-宜蘭,2023-08-16,9686
1314,中石化,103,13,90,富邦-宜蘭,2023-08-16,9686
00929,復華台灣科技優息,125,39,86,富邦-宜蘭,2023-08-16,9686
2014,中鴻,69,0,69,富邦-宜蘭,2023-08-16,9686
2303,聯電,58,1,57,富邦-宜蘭,2023-08-16,9686
00878,國泰永續高股息,118,63,55,富邦-宜蘭,2023-08-16,9686
2884,玉山金,49,4,45,富邦-宜蘭,2023-08-16,9686
2324,仁寶,181,139,42,富邦-宜蘭,2023-08-16,9686
3706,神達,53,14,39,富邦-宜蘭,2023-08-16,9686
2887,台新金,38,4,34,富邦-宜蘭,2023-08-16,9686
6191,精成科,34,1,33,富邦-宜蘭,2023-08-16,9686
00680L,元大美債20正2,33,0,33,富邦-宜蘭,2023-08-16,9686
8930,青鋼,33,2,31,富邦-宜蘭,2023-08-16,9686
00897,富邦基因免疫生技,30,0,30,富邦-宜蘭,2023-08-16,9686
00688L,國泰20年美債正2,30,0,30,富邦-宜蘭,2023-08-16,9686
3567,逸昌,30,0,30,富邦-宜蘭,2023-08-16,9686
2880,華南金,33,6,27,富邦-宜蘭,2023-08-16,9686
2609,陽明,58,32,26,富邦-宜蘭,2023-08-16,9686
2363,矽統,58,32,26,富邦-宜蘭,2023-08-16,9686
6505,台塑化,24,0,24,富邦-宜蘭,2023-08-16,9686
2603,長榮,27,3,24,富邦-宜蘭,2023-08-16,9686
2301,光寶科,43,21,22,富邦-宜蘭,2023-08-16,9686
2409,友達,22,0,22,富邦-宜蘭,2023-08-16,9686
2892,第一金,22,2,20,富邦-宜蘭,2023-08-16,9686
2344,華邦電,24,4,20,富邦-宜蘭,2023-08-16,9686
00907,永豐優息存股,18,0,18,富邦-宜蘭,2023-08-16,9686
2332,友訊,55,37,18,富邦-宜蘭,2023-08-16,9686
00751B,元大AAA至A公司債,19,1,18,富邦-宜蘭,2023-08-16,9686
00888,永豐台灣ESG,17,0,17,富邦-宜蘭,2023-08-16,9686
2618,長榮航,39,23,16,富邦-宜蘭,2023-08-16,9686
9945,潤泰新,15,0,15,富邦-宜蘭,2023-08-16,9686
00753L,中信中國50正2,15,0,15,富邦-宜蘭,2023-08-16,9686
00632R,元大台灣50反1,20,5,15,富邦-宜蘭,2023-08-16,9686
1301,台塑,16,1,15,富邦-宜蘭,2023-08-16,9686
9925,新保,14,0,14,富邦-宜蘭,2023-08-16,9686
2002,中鋼,15,1,14,富邦-宜蘭,2023-08-16,9686
00679B,元大美債20年,23,10,13,富邦-宜蘭,2023-08-16,9686
00712,復華富時不動產,33,20,13,富邦-宜蘭,2023-08-16,9686
8210,勤誠,45,32,13,富邦-宜蘭,2023-08-16,9686
5469,瀚宇博,17,4,13,富邦-宜蘭,2023-08-16,9686
2317,鴻海,43,30,13,富邦-宜蘭,2023-08-16,9686
00772B,中信高評級公司債,12,0,12,富邦-宜蘭,2023-08-16,9686
1529,樂事綠能,20,8,12,富邦-宜蘭,2023-08-16,9686
8443,阿瘦,12,0,12,富邦-宜蘭,2023-08-16,9686
00902,中信電池及儲能,12,0,12,富邦-宜蘭,2023-08-16,9686
2027,大成鋼,11,0,11,富邦-宜蘭,2023-08-16,9686
00687B,國泰20年美債,11,0,11,富邦-宜蘭,2023-08-16,9686
00632R,元大台灣50反1,161,1,160,富邦-宜蘭,2023-08-17,9686
2883,凱基金,148,6,142,富邦-宜蘭,2023-08-17,9686
00772B,中信高評級公司債,139,0,139,富邦-宜蘭,2023-08-17,9686
2002,中鋼,85,3,82,富邦-宜蘭,2023-08-17,9686
3231,緯創,221,143,78,富邦-宜蘭,2023-08-17,9686
00753L,中信中國50正2,72,17,55,富邦-宜蘭,2023-08-17,9686
1314,中石化,52,0,52,富邦-宜蘭,2023-08-17,9686
00712,復華富時不動產,47,3,44,富邦-宜蘭,2023-08-17,9686
2324,仁寶,151,109,42,富邦-宜蘭,2023-08-17,9686
2884,玉山金,40,1,39,富邦-宜蘭,2023-08-17,9686
2409,友達,40,2,38,富邦-宜蘭,2023-08-17,9686
2303,聯電,51,16,35,富邦-宜蘭,2023-08-17,9686
2329,華泰,83,51,32,富邦-宜蘭,2023-08-17,9686
2356,英業達,80,49,31,富邦-宜蘭,2023-08-17,9686
1815,富喬,32,2,30,富邦-宜蘭,2023-08-17,9686
2891,中信金,37,8,29,富邦-宜蘭,2023-08-17,9686
1616,億泰,34,6,28,富邦-宜蘭,2023-08-17,9686
00878,國泰永續高股息,44,18,26,富邦-宜蘭,2023-08-17,9686
00882,中信中國高股息,28,2,26,富邦-宜蘭,2023-08-17,9686
00688L,國泰20年美債正2,31,5,26,富邦-宜蘭,2023-08-17,9686
2317,鴻海,32,7,25,富邦-宜蘭,2023-08-17,9686
2887,台新金,30,9,21,富邦-宜蘭,2023-08-17,9686
2906,高林,20,0,20,富邦-宜蘭,2023-08-17,9686
2014,中鴻,21,1,20,富邦-宜蘭,2023-08-17,9686
00929,復華台灣科技優息,41,22,19,富邦-宜蘭,2023-08-17,9686
6770,力積電,31,12,19,富邦-宜蘭,2023-08-17,9686
8390,金益鼎,20,1,19,富邦-宜蘭,2023-08-17,9686
00665L,富邦�琤肭磪囓�2,173,155,18,富邦-宜蘭,2023-08-17,9686
2867,三商壽,20,2,18,富邦-宜蘭,2023-08-17,9686
2301,光寶科,41,23,18,富邦-宜蘭,2023-08-17,9686
00679B,元大美債20年,23,6,17,富邦-宜蘭,2023-08-17,9686
00931B,統一美債20年,27,10,17,富邦-宜蘭,2023-08-17,9686
3338,泰碩,18,3,15,富邦-宜蘭,2023-08-17,9686
00795B,中信美國公債20年,14,0,14,富邦-宜蘭,2023-08-17,9686
1513,中興電,15,2,13,富邦-宜蘭,2023-08-17,9686
6664,群翊,15,3,12,富邦-宜蘭,2023-08-17,9686
2881,富邦金,16,5,11,富邦-宜蘭,2023-08-17,9686
2618,長榮航,37,26,11,富邦-宜蘭,2023-08-17,9686
3051,力特,46,35,11,富邦-宜蘭,2023-08-17,9686
2421,建準,40,29,11,富邦-宜蘭,2023-08-17,9686
1101,台泥,14,3,11,富邦-宜蘭,2023-08-17,9686
2892,第一金,21,10,11,富邦-宜蘭,2023-08-17,9686
1301,台塑,10,0,10,富邦-宜蘭,2023-08-17,9686
3711,日月光投控,11,1,10,富邦-宜蘭,2023-08-17,9686
1453,大將,10,0,10,富邦-宜蘭,2023-08-17,9686
2888,新光金,11,1,10,富邦-宜蘭,2023-08-17,9686
00720B,元大投資級公司債,13,3,10,富邦-宜蘭,2023-08-17,9686
5392,能率,10,0,10,富邦-宜蘭,2023-08-17,9686
6598,ABC-KY,10,0,10,富邦-宜蘭,2023-08-17,9686
6531,愛普*,29,19,10,富邦-宜蘭,2023-08-17,9686
00696B,富邦美債20年,100,0,100,富邦-宜蘭,2023-08-18,9686
3231,緯創,285,186,99,富邦-宜蘭,2023-08-18,9686
00929,復華台灣科技優息,186,90,96,富邦-宜蘭,2023-08-18,9686
00687B,國泰20年美債,101,5,96,富邦-宜蘭,2023-08-18,9686
2363,矽統,220,126,94,富邦-宜蘭,2023-08-18,9686
2605,新興,101,7,94,富邦-宜蘭,2023-08-18,9686
2324,仁寶,151,66,85,富邦-宜蘭,2023-08-18,9686
2641,正德,67,6,61,富邦-宜蘭,2023-08-18,9686
00923,群益台ESG低碳50,47,0,47,富邦-宜蘭,2023-08-18,9686
6442,光聖,45,2,43,富邦-宜蘭,2023-08-18,9686
2913,農林,58,18,40,富邦-宜蘭,2023-08-18,9686
1616,億泰,40,0,40,富邦-宜蘭,2023-08-18,9686
00900,富邦特選高股息30,37,0,37,富邦-宜蘭,2023-08-18,9686
2356,英業達,180,146,34,富邦-宜蘭,2023-08-18,9686
00878,國泰永續高股息,75,41,34,富邦-宜蘭,2023-08-18,9686
2401,凌陽,35,3,32,富邦-宜蘭,2023-08-18,9686
6282,康舒,60,31,29,富邦-宜蘭,2023-08-18,9686
2637,慧洋-KY,42,16,26,富邦-宜蘭,2023-08-18,9686
6188,廣明,51,25,26,富邦-宜蘭,2023-08-18,9686
2609,陽明,81,58,23,富邦-宜蘭,2023-08-18,9686
00712,復華富時不動產,58,35,23,富邦-宜蘭,2023-08-18,9686
8071,能率網通,23,0,23,富邦-宜蘭,2023-08-18,9686
2412,中華電,22,0,22,富邦-宜蘭,2023-08-18,9686
1905,華紙,22,1,21,富邦-宜蘭,2023-08-18,9686
00897,富邦基因免疫生技,30,10,20,富邦-宜蘭,2023-08-18,9686
2610,華航,39,20,19,富邦-宜蘭,2023-08-18,9686
1471,首利,27,9,18,富邦-宜蘭,2023-08-18,9686
1802,台玻,18,0,18,富邦-宜蘭,2023-08-18,9686
0056,元大高股息,25,8,17,富邦-宜蘭,2023-08-18,9686
4933,友輝,17,0,17,富邦-宜蘭,2023-08-18,9686
3701,大眾控,21,4,17,富邦-宜蘭,2023-08-18,9686
1101,台泥,17,0,17,富邦-宜蘭,2023-08-18,9686
4744,皇將,19,3,16,富邦-宜蘭,2023-08-18,9686
4747,強生,16,0,16,富邦-宜蘭,2023-08-18,9686
2382,廣達,71,55,16,富邦-宜蘭,2023-08-18,9686
3078,僑威,47,32,15,富邦-宜蘭,2023-08-18,9686
9925,新保,15,0,15,富邦-宜蘭,2023-08-18,9686
6125,廣運,63,49,14,富邦-宜蘭,2023-08-18,9686
2371,大同,32,18,14,富邦-宜蘭,2023-08-18,9686
1618,合機,15,1,14,富邦-宜蘭,2023-08-18,9686
5009,榮剛,14,0,14,富邦-宜蘭,2023-08-18,9686
2618,長榮航,29,16,13,富邦-宜蘭,2023-08-18,9686
6139,亞翔,29,16,13,富邦-宜蘭,2023-08-18,9686
2884,玉山金,14,2,12,富邦-宜蘭,2023-08-18,9686
2344,華邦電,19,7,12,富邦-宜蘭,2023-08-18,9686
6672,騰輝電子-KY,20,8,12,富邦-宜蘭,2023-08-18,9686
2376,技嘉,35,24,11,富邦-宜蘭,2023-08-18,9686
00753L,中信中國50正2,11,0,11,富邦-宜蘭,2023-08-18,9686
1268,漢來美食,11,0,11,富邦-宜蘭,2023-08-18,9686
5347,世界,11,0,11,富邦-宜蘭,2023-08-18,9686
5876,上海商銀,101,2,99,富邦-宜蘭,2023-08-21,9686
1504,東元,107,28,79,富邦-宜蘭,2023-08-21,9686
00637L,元大滬深300正2,79,10,69,富邦-宜蘭,2023-08-21,9686
00919,群益台灣精選高息,66,0,66,富邦-宜蘭,2023-08-21,9686
2605,新興,59,0,59,富邦-宜蘭,2023-08-21,9686
3706,神達,62,6,56,富邦-宜蘭,2023-08-21,9686
5608,四維航,60,5,55,富邦-宜蘭,2023-08-21,9686
00878,國泰永續高股息,48,3,45,富邦-宜蘭,2023-08-21,9686
00929,復華台灣科技優息,75,33,42,富邦-宜蘭,2023-08-21,9686
2892,第一金,41,0,41,富邦-宜蘭,2023-08-21,9686
4543,萬在,43,6,37,富邦-宜蘭,2023-08-21,9686
2618,長榮航,43,9,34,富邦-宜蘭,2023-08-21,9686
3051,力特,67,33,34,富邦-宜蘭,2023-08-21,9686
2606,裕民,57,28,29,富邦-宜蘭,2023-08-21,9686
00715L,期街口布蘭特正2,30,2,28,富邦-宜蘭,2023-08-21,9686
3206,志豐,27,0,27,富邦-宜蘭,2023-08-21,9686
2353,宏��,106,80,26,富邦-宜蘭,2023-08-21,9686
2344,華邦電,28,2,26,富邦-宜蘭,2023-08-21,9686
2303,聯電,26,0,26,富邦-宜蘭,2023-08-21,9686
00753L,中信中國50正2,25,0,25,富邦-宜蘭,2023-08-21,9686
2603,長榮,23,0,23,富邦-宜蘭,2023-08-21,9686
00679B,元大美債20年,23,0,23,富邦-宜蘭,2023-08-21,9686
3231,緯創,98,76,22,富邦-宜蘭,2023-08-21,9686
00680L,元大美債20正2,37,16,21,富邦-宜蘭,2023-08-21,9686
3308,聯德,38,17,21,富邦-宜蘭,2023-08-21,9686
2382,廣達,67,46,21,富邦-宜蘭,2023-08-21,9686
00712,復華富時不動產,20,0,20,富邦-宜蘭,2023-08-21,9686
00897,富邦基因免疫生技,20,0,20,富邦-宜蘭,2023-08-21,9686
1310,台苯,20,0,20,富邦-宜蘭,2023-08-21,9686
00696B,富邦美債20年,20,0,20,富邦-宜蘭,2023-08-21,9686
2609,陽明,24,4,20,富邦-宜蘭,2023-08-21,9686
1326,台化,20,1,19,富邦-宜蘭,2023-08-21,9686
6274,台燿,29,11,18,富邦-宜蘭,2023-08-21,9686
2881,富邦金,18,0,18,富邦-宜蘭,2023-08-21,9686
2888,新光金,17,0,17,富邦-宜蘭,2023-08-21,9686
3306,鼎天,66,50,16,富邦-宜蘭,2023-08-21,9686
3024,憶聲,16,0,16,富邦-宜蘭,2023-08-21,9686
1616,億泰,21,6,15,富邦-宜蘭,2023-08-21,9686
8443,阿瘦,15,0,15,富邦-宜蘭,2023-08-21,9686
6139,亞翔,44,29,15,富邦-宜蘭,2023-08-21,9686
2338,光罩,14,1,13,富邦-宜蘭,2023-08-21,9686
6470,宇智,19,6,13,富邦-宜蘭,2023-08-21,9686
6770,力積電,13,0,13,富邦-宜蘭,2023-08-21,9686
2610,華航,17,5,12,富邦-宜蘭,2023-08-21,9686
3264,欣銓,12,0,12,富邦-宜蘭,2023-08-21,9686
2313,華通,13,1,12,富邦-宜蘭,2023-08-21,9686
2886,兆豐金,13,1,12,富邦-宜蘭,2023-08-21,9686
0050,元大台灣50,11,0,11,富邦-宜蘭,2023-08-21,9686
00930,永豐ESG低碳高息,11,0,11,富邦-宜蘭,2023-08-21,9686
911868,同方友友-DR,11,0,11,富邦-宜蘭,2023-08-21,9686
2363,矽統,334,121,213,富邦-宜蘭,2023-08-22,9686
2883,凱基金,64,0,64,富邦-宜蘭,2023-08-22,9686
5876,上海商銀,60,0,60,富邦-宜蘭,2023-08-22,9686
2406,國碩,60,0,60,富邦-宜蘭,2023-08-22,9686
00929,復華台灣科技優息,73,25,48,富邦-宜蘭,2023-08-22,9686
2618,長榮航,85,40,45,富邦-宜蘭,2023-08-22,9686
00679B,元大美債20年,49,5,44,富邦-宜蘭,2023-08-22,9686
6108,競國,57,13,44,富邦-宜蘭,2023-08-22,9686
2332,友訊,64,24,40,富邦-宜蘭,2023-08-22,9686
3567,逸昌,38,0,38,富邦-宜蘭,2023-08-22,9686
2409,友達,53,17,36,富邦-宜蘭,2023-08-22,9686
3231,緯創,127,98,29,富邦-宜蘭,2023-08-22,9686
6125,廣運,57,30,27,富邦-宜蘭,2023-08-22,9686
2206,三陽工業,26,1,25,富邦-宜蘭,2023-08-22,9686
2027,大成鋼,24,0,24,富邦-宜蘭,2023-08-22,9686
2344,華邦電,33,10,23,富邦-宜蘭,2023-08-22,9686
00885,富邦越南,23,0,23,富邦-宜蘭,2023-08-22,9686
3163,波若威,48,25,23,富邦-宜蘭,2023-08-22,9686
4934,太極,28,6,22,富邦-宜蘭,2023-08-22,9686
1471,首利,75,53,22,富邦-宜蘭,2023-08-22,9686
3049,精金,30,10,20,富邦-宜蘭,2023-08-22,9686
5009,榮剛,20,0,20,富邦-宜蘭,2023-08-22,9686
1101,台泥,19,0,19,富邦-宜蘭,2023-08-22,9686
2615,萬海,17,0,17,富邦-宜蘭,2023-08-22,9686
2913,農林,17,0,17,富邦-宜蘭,2023-08-22,9686
3707,漢磊,17,1,16,富邦-宜蘭,2023-08-22,9686
6116,彩晶,29,13,16,富邦-宜蘭,2023-08-22,9686
6770,力積電,18,2,16,富邦-宜蘭,2023-08-22,9686
2641,正德,15,0,15,富邦-宜蘭,2023-08-22,9686
2891,中信金,28,13,15,富邦-宜蘭,2023-08-22,9686
00637L,元大滬深300正2,24,10,14,富邦-宜蘭,2023-08-22,9686
4979,華星光,27,13,14,富邦-宜蘭,2023-08-22,9686
2355,敬鵬,19,5,14,富邦-宜蘭,2023-08-22,9686
2352,佳世達,24,10,14,富邦-宜蘭,2023-08-22,9686
2002,中鋼,18,4,14,富邦-宜蘭,2023-08-22,9686
5452,佶優,20,7,13,富邦-宜蘭,2023-08-22,9686
8054,安國,13,0,13,富邦-宜蘭,2023-08-22,9686
1612,宏泰,12,0,12,富邦-宜蘭,2023-08-22,9686
9940,信義,12,0,12,富邦-宜蘭,2023-08-22,9686
2324,仁寶,85,74,11,富邦-宜蘭,2023-08-22,9686
00665L,富邦�琤肭磪囓�2,16,5,11,富邦-宜蘭,2023-08-22,9686
1708,東鹼,11,0,11,富邦-宜蘭,2023-08-22,9686
3596,智易,24,13,11,富邦-宜蘭,2023-08-22,9686
4933,友輝,11,0,11,富邦-宜蘭,2023-08-22,9686
2312,金寶,41,30,11,富邦-宜蘭,2023-08-22,9686
1444,力麗,11,0,11,富邦-宜蘭,2023-08-22,9686
3432,台端,11,0,11,富邦-宜蘭,2023-08-22,9686
3325,旭品,23,12,11,富邦-宜蘭,2023-08-22,9686
6217,中探針,11,0,11,富邦-宜蘭,2023-08-22,9686
6531,愛普*,18,7,11,富邦-宜蘭,2023-08-22,9686
3051,力特,70,10,60,富邦-宜蘭,2023-08-23,9686
6142,友勁,51,0,51,富邦-宜蘭,2023-08-23,9686
6282,康舒,79,29,50,富邦-宜蘭,2023-08-23,9686
2630,亞航,46,11,35,富邦-宜蘭,2023-08-23,9686
00751B,元大AAA至A公司債,30,0,30,富邦-宜蘭,2023-08-23,9686
1316,上曜,27,0,27,富邦-宜蘭,2023-08-23,9686
2634,漢翔,143,119,24,富邦-宜蘭,2023-08-23,9686
2353,宏��,24,0,24,富邦-宜蘭,2023-08-23,9686
6167,久正,28,6,22,富邦-宜蘭,2023-08-23,9686
3078,僑威,25,3,22,富邦-宜蘭,2023-08-23,9686
2610,華航,46,26,20,富邦-宜蘭,2023-08-23,9686
2906,高林,20,0,20,富邦-宜蘭,2023-08-23,9686
1722,台肥,21,2,19,富邦-宜蘭,2023-08-23,9686
2609,陽明,20,4,16,富邦-宜蘭,2023-08-23,9686
00679B,元大美債20年,18,2,16,富邦-宜蘭,2023-08-23,9686
2002,中鋼,17,2,15,富邦-宜蘭,2023-08-23,9686
3325,旭品,18,3,15,富邦-宜蘭,2023-08-23,9686
3483,力致,25,10,15,富邦-宜蘭,2023-08-23,9686
2882,國泰金,15,1,14,富邦-宜蘭,2023-08-23,9686
4979,華星光,33,19,14,富邦-宜蘭,2023-08-23,9686
2881,富邦金,15,1,14,富邦-宜蘭,2023-08-23,9686
6191,精成科,15,1,14,富邦-宜蘭,2023-08-23,9686
2303,聯電,15,2,13,富邦-宜蘭,2023-08-23,9686
4746,台耀,13,0,13,富邦-宜蘭,2023-08-23,9686
6116,彩晶,13,0,13,富邦-宜蘭,2023-08-23,9686
2382,廣達,51,39,12,富邦-宜蘭,2023-08-23,9686
2801,彰銀,12,0,12,富邦-宜蘭,2023-08-23,9686
00722B,群益投資級電信債,12,0,12,富邦-宜蘭,2023-08-23,9686
4906,正文,49,37,12,富邦-宜蘭,2023-08-23,9686
2408,南亞科,12,1,11,富邦-宜蘭,2023-08-23,9686
5474,聰泰,11,0,11,富邦-宜蘭,2023-08-23,9686
00632R,元大台灣50反1,11,0,11,富邦-宜蘭,2023-08-23,9686
9945,潤泰新,12,1,11,富邦-宜蘭,2023-08-23,9686
2883,凱基金,11,1,10,富邦-宜蘭,2023-08-23,9686
00706L,期元大S＆P日圓正2,10,0,10,富邦-宜蘭,2023-08-23,9686
2324,仁寶,45,35,10,富邦-宜蘭,2023-08-23,9686
2301,光寶科,24,14,10,富邦-宜蘭,2023-08-23,9686
1513,中興電,14,5,9,富邦-宜蘭,2023-08-23,9686
1101,台泥,9,0,9,富邦-宜蘭,2023-08-23,9686
3094,聯傑,14,5,9,富邦-宜蘭,2023-08-23,9686
3706,神達,14,5,9,富邦-宜蘭,2023-08-23,9686
1709,和益,8,0,8,富邦-宜蘭,2023-08-23,9686
2376,技嘉,20,12,8,富邦-宜蘭,2023-08-23,9686
2884,玉山金,10,2,8,富邦-宜蘭,2023-08-23,9686
3704,合勤控,8,0,8,富邦-宜蘭,2023-08-23,9686
3071,協禧,18,10,8,富邦-宜蘭,2023-08-23,9686
00902,中信電池及儲能,8,0,8,富邦-宜蘭,2023-08-23,9686
6185,幃翔,8,0,8,富邦-宜蘭,2023-08-23,9686
2332,友訊,52,44,8,富邦-宜蘭,2023-08-23,9686
00712,復華富時不動產,7,0,7,富邦-宜蘭,2023-08-23,9686
2363,矽統,704,233,471,富邦-宜蘭,2023-08-24,9686
00929,復華台灣科技優息,132,46,86,富邦-宜蘭,2023-08-24,9686
00919,群益台灣精選高息,105,52,53,富邦-宜蘭,2023-08-24,9686
00712,復華富時不動產,48,0,48,富邦-宜蘭,2023-08-24,9686
3013,晟銘電,102,62,40,富邦-宜蘭,2023-08-24,9686
1471,首利,53,14,39,富邦-宜蘭,2023-08-24,9686
2637,慧洋-KY,41,2,39,富邦-宜蘭,2023-08-24,9686
00679B,元大美債20年,36,0,36,富邦-宜蘭,2023-08-24,9686
2891,中信金,33,2,31,富邦-宜蘭,2023-08-24,9686
1434,福懋,30,0,30,富邦-宜蘭,2023-08-24,9686
2002,中鋼,26,0,26,富邦-宜蘭,2023-08-24,9686
3312,弘憶股,26,0,26,富邦-宜蘭,2023-08-24,9686
2641,正德,22,0,22,富邦-宜蘭,2023-08-24,9686
00632R,元大台灣50反1,31,10,21,富邦-宜蘭,2023-08-24,9686
4543,萬在,47,26,21,富邦-宜蘭,2023-08-24,9686
00753L,中信中國50正2,21,0,21,富邦-宜蘭,2023-08-24,9686
1806,冠軍,20,0,20,富邦-宜蘭,2023-08-24,9686
1303,南亞,20,0,20,富邦-宜蘭,2023-08-24,9686
3078,僑威,31,11,20,富邦-宜蘭,2023-08-24,9686
2887,台新金,22,2,20,富邦-宜蘭,2023-08-24,9686
2409,友達,24,5,19,富邦-宜蘭,2023-08-24,9686
2419,仲琦,29,10,19,富邦-宜蘭,2023-08-24,9686
2606,裕民,19,0,19,富邦-宜蘭,2023-08-24,9686
6770,力積電,24,6,18,富邦-宜蘭,2023-08-24,9686
6168,宏齊,19,1,18,富邦-宜蘭,2023-08-24,9686
00715L,期街口布蘭特正2,18,0,18,富邦-宜蘭,2023-08-24,9686
00650L,復華香港正2,18,0,18,富邦-宜蘭,2023-08-24,9686
2354,鴻準,30,12,18,富邦-宜蘭,2023-08-24,9686
3231,緯創,252,235,17,富邦-宜蘭,2023-08-24,9686
2324,仁寶,69,53,16,富邦-宜蘭,2023-08-24,9686
6531,愛普*,18,2,16,富邦-宜蘭,2023-08-24,9686
2449,京元電子,89,73,16,富邦-宜蘭,2023-08-24,9686
2884,玉山金,15,0,15,富邦-宜蘭,2023-08-24,9686
2211,長榮鋼,15,0,15,富邦-宜蘭,2023-08-24,9686
2486,一詮,17,2,15,富邦-宜蘭,2023-08-24,9686
5488,松普,15,0,15,富邦-宜蘭,2023-08-24,9686
6167,久正,16,2,14,富邦-宜蘭,2023-08-24,9686
3035,智原,33,19,14,富邦-宜蘭,2023-08-24,9686
3483,力致,31,18,13,富邦-宜蘭,2023-08-24,9686
6579,研揚,14,1,13,富邦-宜蘭,2023-08-24,9686
00907,永豐優息存股,13,0,13,富邦-宜蘭,2023-08-24,9686
3596,智易,17,4,13,富邦-宜蘭,2023-08-24,9686
4960,誠美材,29,16,13,富邦-宜蘭,2023-08-24,9686
1513,中興電,29,17,12,富邦-宜蘭,2023-08-24,9686
6116,彩晶,12,0,12,富邦-宜蘭,2023-08-24,9686
1709,和益,12,0,12,富邦-宜蘭,2023-08-24,9686
3499,環天科,12,0,12,富邦-宜蘭,2023-08-24,9686
4976,佳凌,12,0,12,富邦-宜蘭,2023-08-24,9686
1101,台泥,11,0,11,富邦-宜蘭,2023-08-24,9686
00900,富邦特選高股息30,20,9,11,富邦-宜蘭,2023-08-24,9686
3231,緯創,309,87,222,富邦-宜蘭,2023-08-25,9686
00878,國泰永續高股息,204,3,201,富邦-宜蘭,2023-08-25,9686
6282,康舒,139,3,136,富邦-宜蘭,2023-08-25,9686
2618,長榮航,89,11,78,富邦-宜蘭,2023-08-25,9686
2382,廣達,105,33,72,富邦-宜蘭,2023-08-25,9686
1434,福懋,70,0,70,富邦-宜蘭,2023-08-25,9686
2331,精英,100,47,53,富邦-宜蘭,2023-08-25,9686
00919,群益台灣精選高息,52,0,52,富邦-宜蘭,2023-08-25,9686
2883,凱基金,51,1,50,富邦-宜蘭,2023-08-25,9686
00930,永豐ESG低碳高息,50,0,50,富邦-宜蘭,2023-08-25,9686
2002,中鋼,46,3,43,富邦-宜蘭,2023-08-25,9686
00923,群益台ESG低碳50,40,0,40,富邦-宜蘭,2023-08-25,9686
2353,宏��,46,7,39,富邦-宜蘭,2023-08-25,9686
1303,南亞,37,0,37,富邦-宜蘭,2023-08-25,9686
3049,精金,37,0,37,富邦-宜蘭,2023-08-25,9686
2356,英業達,59,26,33,富邦-宜蘭,2023-08-25,9686
4532,瑞智,32,1,31,富邦-宜蘭,2023-08-25,9686
4944,兆遠,31,0,31,富邦-宜蘭,2023-08-25,9686
00665L,富邦�琤肭磪囓�2,30,0,30,富邦-宜蘭,2023-08-25,9686
00637L,元大滬深300正2,35,10,25,富邦-宜蘭,2023-08-25,9686
2330,台積電,25,1,24,富邦-宜蘭,2023-08-25,9686
2303,聯電,28,5,23,富邦-宜蘭,2023-08-25,9686
2332,友訊,84,61,23,富邦-宜蘭,2023-08-25,9686
3037,欣興,27,5,22,富邦-宜蘭,2023-08-25,9686
2027,大成鋼,22,0,22,富邦-宜蘭,2023-08-25,9686
2344,華邦電,25,4,21,富邦-宜蘭,2023-08-25,9686
2399,映泰,29,8,21,富邦-宜蘭,2023-08-25,9686
2736,富野,26,5,21,富邦-宜蘭,2023-08-25,9686
5348,正能量智能,21,0,21,富邦-宜蘭,2023-08-25,9686
2486,一詮,26,6,20,富邦-宜蘭,2023-08-25,9686
3576,聯合再生,30,12,18,富邦-宜蘭,2023-08-25,9686
0056,元大高股息,24,6,18,富邦-宜蘭,2023-08-25,9686
6274,台燿,17,2,15,富邦-宜蘭,2023-08-25,9686
1101,台泥,15,1,14,富邦-宜蘭,2023-08-25,9686
2705,六福,13,0,13,富邦-宜蘭,2023-08-25,9686
00929,復華台灣科技優息,56,44,12,富邦-宜蘭,2023-08-25,9686
00713,元大台灣高息低波,12,0,12,富邦-宜蘭,2023-08-25,9686
6517,保勝光學,14,2,12,富邦-宜蘭,2023-08-25,9686
6284,佳邦,16,5,11,富邦-宜蘭,2023-08-25,9686
2371,大同,12,1,11,富邦-宜蘭,2023-08-25,9686
00893,國泰智能電動車,14,4,10,富邦-宜蘭,2023-08-25,9686
1220,台榮,10,0,10,富邦-宜蘭,2023-08-25,9686
00897,富邦基因免疫生技,10,0,10,富邦-宜蘭,2023-08-25,9686
4207,環泰,14,4,10,富邦-宜蘭,2023-08-25,9686
2706,第一店,11,1,10,富邦-宜蘭,2023-08-25,9686
2430,燦坤,10,0,10,富邦-宜蘭,2023-08-25,9686
5521,工信,10,0,10,富邦-宜蘭,2023-08-25,9686
1471,首利,23,13,10,富邦-宜蘭,2023-08-25,9686
6188,廣明,19,9,10,富邦-宜蘭,2023-08-25,9686
3024,憶聲,10,0,10,富邦-宜蘭,2023-08-25,9686
00929,復華台灣科技優息,170,3,167,富邦-宜蘭,2023-08-28,9686
4906,正文,96,14,82,富邦-宜蘭,2023-08-28,9686
00878,國泰永續高股息,94,41,53,富邦-宜蘭,2023-08-28,9686
2882,國泰金,51,1,50,富邦-宜蘭,2023-08-28,9686
2705,六福,39,0,39,富邦-宜蘭,2023-08-28,9686
2363,矽統,101,62,39,富邦-宜蘭,2023-08-28,9686
2883,凱基金,40,2,38,富邦-宜蘭,2023-08-28,9686
6116,彩晶,36,2,34,富邦-宜蘭,2023-08-28,9686
00720B,元大投資級公司債,33,0,33,富邦-宜蘭,2023-08-28,9686
00919,群益台灣精選高息,31,0,31,富邦-宜蘭,2023-08-28,9686
2206,三陽工業,29,0,29,富邦-宜蘭,2023-08-28,9686
2355,敬鵬,29,0,29,富邦-宜蘭,2023-08-28,9686
6203,海韻電,31,3,28,富邦-宜蘭,2023-08-28,9686
3231,緯創,85,60,25,富邦-宜蘭,2023-08-28,9686
2002,中鋼,24,0,24,富邦-宜蘭,2023-08-28,9686
2332,友訊,86,64,22,富邦-宜蘭,2023-08-28,9686
1737,臺鹽,49,29,20,富邦-宜蘭,2023-08-28,9686
0056,元大高股息,21,1,20,富邦-宜蘭,2023-08-28,9686
2388,威盛,42,22,20,富邦-宜蘭,2023-08-28,9686
5348,正能量智能,20,0,20,富邦-宜蘭,2023-08-28,9686
2485,兆赫,43,24,19,富邦-宜蘭,2023-08-28,9686
6125,廣運,25,7,18,富邦-宜蘭,2023-08-28,9686
9934,成霖,18,0,18,富邦-宜蘭,2023-08-28,9686
2344,華邦電,23,5,18,富邦-宜蘭,2023-08-28,9686
6770,力積電,23,5,18,富邦-宜蘭,2023-08-28,9686
2409,友達,45,28,17,富邦-宜蘭,2023-08-28,9686
00650L,復華香港正2,31,14,17,富邦-宜蘭,2023-08-28,9686
00907,永豐優息存股,16,0,16,富邦-宜蘭,2023-08-28,9686
2614,東森,16,0,16,富邦-宜蘭,2023-08-28,9686
2408,南亞科,20,5,15,富邦-宜蘭,2023-08-28,9686
1303,南亞,14,0,14,富邦-宜蘭,2023-08-28,9686
3024,憶聲,14,0,14,富邦-宜蘭,2023-08-28,9686
2324,仁寶,21,8,13,富邦-宜蘭,2023-08-28,9686
9105,泰金寶-DR,13,0,13,富邦-宜蘭,2023-08-28,9686
2323,中環,14,2,12,富邦-宜蘭,2023-08-28,9686
6282,康舒,19,8,11,富邦-宜蘭,2023-08-28,9686
1229,聯華,11,0,11,富邦-宜蘭,2023-08-28,9686
3715,定穎投控,24,13,11,富邦-宜蘭,2023-08-28,9686
00900,富邦特選高股息30,12,1,11,富邦-宜蘭,2023-08-28,9686
3027,盛達,12,1,11,富邦-宜蘭,2023-08-28,9686
2353,宏��,16,5,11,富邦-宜蘭,2023-08-28,9686
9940,信義,16,5,11,富邦-宜蘭,2023-08-28,9686
2329,華泰,124,113,11,富邦-宜蘭,2023-08-28,9686
3037,欣興,16,6,10,富邦-宜蘭,2023-08-28,9686
00931B,統一美債20年,10,0,10,富邦-宜蘭,2023-08-28,9686
6026,福邦證,10,0,10,富邦-宜蘭,2023-08-28,9686
2405,輔信,10,0,10,富邦-宜蘭,2023-08-28,9686
2641,正德,10,0,10,富邦-宜蘭,2023-08-28,9686
2303,聯電,87,77,10,富邦-宜蘭,2023-08-28,9686
8926,台汽電,10,0,10,富邦-宜蘭,2023-08-28,9686
00919,群益台灣精選高息,155,0,155,富邦-宜蘭,2023-08-29,9686
3231,緯創,169,95,74,富邦-宜蘭,2023-08-29,9686
2002,中鋼,44,1,43,富邦-宜蘭,2023-08-29,9686
00722B,群益投資級電信債,43,0,43,富邦-宜蘭,2023-08-29,9686
2317,鴻海,62,19,43,富邦-宜蘭,2023-08-29,9686
1313,聯成,40,0,40,富邦-宜蘭,2023-08-29,9686
2363,矽統,318,284,34,富邦-宜蘭,2023-08-29,9686
00751B,元大AAA至A公司債,31,0,31,富邦-宜蘭,2023-08-29,9686
1810,和成,32,1,31,富邦-宜蘭,2023-08-29,9686
2618,長榮航,38,10,28,富邦-宜蘭,2023-08-29,9686
2886,兆豐金,25,0,25,富邦-宜蘭,2023-08-29,9686
00907,永豐優息存股,23,0,23,富邦-宜蘭,2023-08-29,9686
2883,凱基金,22,1,21,富邦-宜蘭,2023-08-29,9686
1737,臺鹽,31,10,21,富邦-宜蘭,2023-08-29,9686
3051,力特,53,33,20,富邦-宜蘭,2023-08-29,9686
2634,漢翔,38,19,19,富邦-宜蘭,2023-08-29,9686
6235,華孚,54,39,15,富邦-宜蘭,2023-08-29,9686
9940,信義,15,0,15,富邦-宜蘭,2023-08-29,9686
4541,晟田,13,0,13,富邦-宜蘭,2023-08-29,9686
1612,宏泰,14,1,13,富邦-宜蘭,2023-08-29,9686
3324,雙鴻,11,0,11,富邦-宜蘭,2023-08-29,9686
2892,第一金,10,0,10,富邦-宜蘭,2023-08-29,9686
00931B,統一美債20年,10,0,10,富邦-宜蘭,2023-08-29,9686
1584,精剛,10,1,9,富邦-宜蘭,2023-08-29,9686
00720B,元大投資級公司債,10,1,9,富邦-宜蘭,2023-08-29,9686
5457,宣德,11,2,9,富邦-宜蘭,2023-08-29,9686
3078,僑威,16,7,9,富邦-宜蘭,2023-08-29,9686
2356,英業達,9,1,8,富邦-宜蘭,2023-08-29,9686
00900,富邦特選高股息30,10,2,8,富邦-宜蘭,2023-08-29,9686
00922,國泰台灣領袖50,8,0,8,富邦-宜蘭,2023-08-29,9686
1338,廣華-KY,8,0,8,富邦-宜蘭,2023-08-29,9686
8086,宏捷科,8,1,7,富邦-宜蘭,2023-08-29,9686
3706,神達,15,8,7,富邦-宜蘭,2023-08-29,9686
6194,育富,7,0,7,富邦-宜蘭,2023-08-29,9686
2609,陽明,13,6,7,富邦-宜蘭,2023-08-29,9686
2913,農林,6,0,6,富邦-宜蘭,2023-08-29,9686
3013,晟銘電,16,10,6,富邦-宜蘭,2023-08-29,9686
4746,台耀,7,1,6,富邦-宜蘭,2023-08-29,9686
1452,宏益,6,0,6,富邦-宜蘭,2023-08-29,9686
6173,信昌電,9,3,6,富邦-宜蘭,2023-08-29,9686
4919,新唐,7,1,6,富邦-宜蘭,2023-08-29,9686
2323,中環,11,5,6,富邦-宜蘭,2023-08-29,9686
5880,合庫金,16,10,6,富邦-宜蘭,2023-08-29,9686
3058,立德,6,0,6,富邦-宜蘭,2023-08-29,9686
1905,華紙,9,3,6,富邦-宜蘭,2023-08-29,9686
2328,廣宇,5,0,5,富邦-宜蘭,2023-08-29,9686
9917,中保科,5,0,5,富邦-宜蘭,2023-08-29,9686
2462,良得電,5,0,5,富邦-宜蘭,2023-08-29,9686
2464,盟立,5,0,5,富邦-宜蘭,2023-08-29,9686
4147,中裕,5,0,5,富邦-宜蘭,2023-08-29,9686
2337,旺宏,196,115,81,富邦-宜蘭,2023-08-30,9686
5009,榮剛,56,2,54,富邦-宜蘭,2023-08-30,9686
3481,群創,56,2,54,富邦-宜蘭,2023-08-30,9686
2390,云辰,53,0,53,富邦-宜蘭,2023-08-30,9686
00643,群益深証中小,50,0,50,富邦-宜蘭,2023-08-30,9686
1612,宏泰,47,1,46,富邦-宜蘭,2023-08-30,9686
00636,國泰中國A50,30,0,30,富邦-宜蘭,2023-08-30,9686
006206,元大上證50,30,0,30,富邦-宜蘭,2023-08-30,9686
3011,今皓,29,0,29,富邦-宜蘭,2023-08-30,9686
00929,復華台灣科技優息,64,35,29,富邦-宜蘭,2023-08-30,9686
2206,三陽工業,35,9,26,富邦-宜蘭,2023-08-30,9686
2355,敬鵬,35,10,25,富邦-宜蘭,2023-08-30,9686
2464,盟立,24,0,24,富邦-宜蘭,2023-08-30,9686
2542,興富發,23,2,21,富邦-宜蘭,2023-08-30,9686
5258,虹堡,21,2,19,富邦-宜蘭,2023-08-30,9686
00637L,元大滬深300正2,22,3,19,富邦-宜蘭,2023-08-30,9686
2886,兆豐金,21,2,19,富邦-宜蘭,2023-08-30,9686
2301,光寶科,38,22,16,富邦-宜蘭,2023-08-30,9686
3078,僑威,20,4,16,富邦-宜蘭,2023-08-30,9686
5225,東科-KY,18,2,16,富邦-宜蘭,2023-08-30,9686
2891,中信金,15,0,15,富邦-宜蘭,2023-08-30,9686
1609,大亞,14,2,12,富邦-宜蘭,2023-08-30,9686
3305,昇貿,31,19,12,富邦-宜蘭,2023-08-30,9686
2449,京元電子,16,4,12,富邦-宜蘭,2023-08-30,9686
00664R,國泰臺灣加權反1,10,0,10,富邦-宜蘭,2023-08-30,9686
3189,景碩,10,0,10,富邦-宜蘭,2023-08-30,9686
2421,建準,18,8,10,富邦-宜蘭,2023-08-30,9686
3003,健和興,10,0,10,富邦-宜蘭,2023-08-30,9686
1210,大成,10,0,10,富邦-宜蘭,2023-08-30,9686
6218,豪勉,10,0,10,富邦-宜蘭,2023-08-30,9686
3703,欣陸,10,0,10,富邦-宜蘭,2023-08-30,9686
4142,國光生,13,3,10,富邦-宜蘭,2023-08-30,9686
3563,牧德,10,0,10,富邦-宜蘭,2023-08-30,9686
6126,信音,10,0,10,富邦-宜蘭,2023-08-30,9686
00931B,統一美債20年,10,0,10,富邦-宜蘭,2023-08-30,9686
2314,台揚,10,0,10,富邦-宜蘭,2023-08-30,9686
00633L,富邦上証正2,9,0,9,富邦-宜蘭,2023-08-30,9686
6194,育富,9,0,9,富邦-宜蘭,2023-08-30,9686
2382,廣達,55,46,9,富邦-宜蘭,2023-08-30,9686
3013,晟銘電,12,4,8,富邦-宜蘭,2023-08-30,9686
4543,萬在,11,3,8,富邦-宜蘭,2023-08-30,9686
3176,基亞,11,3,8,富邦-宜蘭,2023-08-30,9686
2537,聯上發,8,0,8,富邦-宜蘭,2023-08-30,9686
910861,神州-DR,8,0,8,富邦-宜蘭,2023-08-30,9686
6235,華孚,25,18,7,富邦-宜蘭,2023-08-30,9686
1101,台泥,10,3,7,富邦-宜蘭,2023-08-30,9686
2892,第一金,7,0,7,富邦-宜蘭,2023-08-30,9686
3715,定穎投控,80,74,6,富邦-宜蘭,2023-08-30,9686
00930,永豐ESG低碳高息,10,4,6,富邦-宜蘭,2023-08-30,9686
2352,佳世達,29,23,6,富邦-宜蘭,2023-08-30,9686
2882,國泰金,125,3,122,富邦-宜蘭,2023-08-31,9686
3481,群創,124,20,104,富邦-宜蘭,2023-08-31,9686
2881,富邦金,61,8,53,富邦-宜蘭,2023-08-31,9686
00878,國泰永續高股息,69,19,50,富邦-宜蘭,2023-08-31,9686
2485,兆赫,103,57,46,富邦-宜蘭,2023-08-31,9686
6282,康舒,52,7,45,富邦-宜蘭,2023-08-31,9686
2337,旺宏,66,23,43,富邦-宜蘭,2023-08-31,9686
1810,和成,41,0,41,富邦-宜蘭,2023-08-31,9686
2883,凱基金,41,0,41,富邦-宜蘭,2023-08-31,9686
2367,燿華,47,8,39,富邦-宜蘭,2023-08-31,9686
00929,復華台灣科技優息,59,24,35,富邦-宜蘭,2023-08-31,9686
2324,仁寶,42,7,35,富邦-宜蘭,2023-08-31,9686
2801,彰銀,36,2,34,富邦-宜蘭,2023-08-31,9686
6168,宏齊,54,21,33,富邦-宜蘭,2023-08-31,9686
3715,定穎投控,104,71,33,富邦-宜蘭,2023-08-31,9686
00900,富邦特選高股息30,37,5,32,富邦-宜蘭,2023-08-31,9686
6829,千附精密,36,6,30,富邦-宜蘭,2023-08-31,9686
1522,堤維西,33,4,29,富邦-宜蘭,2023-08-31,9686
2618,長榮航,30,3,27,富邦-宜蘭,2023-08-31,9686
00919,群益台灣精選高息,50,25,25,富邦-宜蘭,2023-08-31,9686
00885,富邦越南,31,7,24,富邦-宜蘭,2023-08-31,9686
6138,茂達,23,0,23,富邦-宜蘭,2023-08-31,9686
00713,元大台灣高息低波,22,0,22,富邦-宜蘭,2023-08-31,9686
1101,台泥,22,1,21,富邦-宜蘭,2023-08-31,9686
2034,允強,21,0,21,富邦-宜蘭,2023-08-31,9686
4564,元翎,20,1,19,富邦-宜蘭,2023-08-31,9686
2891,中信金,20,2,18,富邦-宜蘭,2023-08-31,9686
2303,聯電,47,30,17,富邦-宜蘭,2023-08-31,9686
2886,兆豐金,16,1,15,富邦-宜蘭,2023-08-31,9686
2317,鴻海,18,3,15,富邦-宜蘭,2023-08-31,9686
6770,力積電,26,12,14,富邦-宜蘭,2023-08-31,9686
00907,永豐優息存股,13,0,13,富邦-宜蘭,2023-08-31,9686
2880,華南金,12,1,11,富邦-宜蘭,2023-08-31,9686
2425,承啟,12,1,11,富邦-宜蘭,2023-08-31,9686
1904,正隆,11,0,11,富邦-宜蘭,2023-08-31,9686
1815,富喬,10,0,10,富邦-宜蘭,2023-08-31,9686
1471,首利,22,12,10,富邦-宜蘭,2023-08-31,9686
2885,元大金,11,1,10,富邦-宜蘭,2023-08-31,9686
4743,合一,10,0,10,富邦-宜蘭,2023-08-31,9686
00772B,中信高評級公司債,22,12,10,富邦-宜蘭,2023-08-31,9686
2356,英業達,24,15,9,富邦-宜蘭,2023-08-31,9686
5880,合庫金,9,0,9,富邦-宜蘭,2023-08-31,9686
6187,萬潤,10,1,9,富邦-宜蘭,2023-08-31,9686
2440,太空梭,9,0,9,富邦-宜蘭,2023-08-31,9686
1301,台塑,9,0,9,富邦-宜蘭,2023-08-31,9686
1737,臺鹽,10,1,9,富邦-宜蘭,2023-08-31,9686
2002,中鋼,10,2,8,富邦-宜蘭,2023-08-31,9686
6443,元晶,11,3,8,富邦-宜蘭,2023-08-31,9686
00931B,統一美債20年,9,1,8,富邦-宜蘭,2023-08-31,9686
6139,亞翔,10,2,8,富邦-宜蘭,2023-08-31,9686
00919,群益台灣精選高息,372,33,339,富邦-宜蘭,2023-09-01,9686
3231,緯創,156,54,102,富邦-宜蘭,2023-09-01,9686
1467,南緯,102,0,102,富邦-宜蘭,2023-09-01,9686
00929,復華台灣科技優息,111,22,89,富邦-宜蘭,2023-09-01,9686
2329,華泰,98,16,82,富邦-宜蘭,2023-09-01,9686
2206,三陽工業,102,27,75,富邦-宜蘭,2023-09-01,9686
3704,合勤控,66,0,66,富邦-宜蘭,2023-09-01,9686
00932,兆豐永續高息等權,123,60,63,富邦-宜蘭,2023-09-01,9686
2367,燿華,59,7,52,富邦-宜蘭,2023-09-01,9686
2356,英業達,63,20,43,富邦-宜蘭,2023-09-01,9686
9919,康那香,53,11,42,富邦-宜蘭,2023-09-01,9686
2002,中鋼,42,5,37,富邦-宜蘭,2023-09-01,9686
2369,菱生,51,14,37,富邦-宜蘭,2023-09-01,9686
6274,台燿,79,43,36,富邦-宜蘭,2023-09-01,9686
2376,技嘉,60,29,31,富邦-宜蘭,2023-09-01,9686
1810,和成,32,1,31,富邦-宜蘭,2023-09-01,9686
2399,映泰,65,37,28,富邦-宜蘭,2023-09-01,9686
2323,中環,22,0,22,富邦-宜蘭,2023-09-01,9686
2382,廣達,49,28,21,富邦-宜蘭,2023-09-01,9686
4188,安克,25,5,20,富邦-宜蘭,2023-09-01,9686
1815,富喬,22,2,20,富邦-宜蘭,2023-09-01,9686
1609,大亞,26,6,20,富邦-宜蘭,2023-09-01,9686
3078,僑威,29,10,19,富邦-宜蘭,2023-09-01,9686
2332,友訊,26,7,19,富邦-宜蘭,2023-09-01,9686
6547,高端疫苗,40,21,19,富邦-宜蘭,2023-09-01,9686
6235,華孚,41,23,18,富邦-宜蘭,2023-09-01,9686
1471,首利,21,3,18,富邦-宜蘭,2023-09-01,9686
3257,虹冠電,47,30,17,富邦-宜蘭,2023-09-01,9686
6207,雷科,17,0,17,富邦-宜蘭,2023-09-01,9686
2415,錩新,16,0,16,富邦-宜蘭,2023-09-01,9686
6213,聯茂,18,2,16,富邦-宜蘭,2023-09-01,9686
2405,輔信,15,0,15,富邦-宜蘭,2023-09-01,9686
6153,嘉聯益,15,0,15,富邦-宜蘭,2023-09-01,9686
2402,毅嘉,298,284,14,富邦-宜蘭,2023-09-01,9686
4906,正文,23,10,13,富邦-宜蘭,2023-09-01,9686
1514,亞力,25,12,13,富邦-宜蘭,2023-09-01,9686
00878,國泰永續高股息,24,12,12,富邦-宜蘭,2023-09-01,9686
2880,華南金,12,0,12,富邦-宜蘭,2023-09-01,9686
3228,金麗科,11,0,11,富邦-宜蘭,2023-09-01,9686
00673R,期元大S＆P原油反1,11,0,11,富邦-宜蘭,2023-09-01,9686
6175,立敦,12,2,10,富邦-宜蘭,2023-09-01,9686
2929,淘帝-KY,14,4,10,富邦-宜蘭,2023-09-01,9686
00922,國泰台灣領袖50,10,0,10,富邦-宜蘭,2023-09-01,9686
6139,亞翔,12,2,10,富邦-宜蘭,2023-09-01,9686
3033,威健,10,0,10,富邦-宜蘭,2023-09-01,9686
6462,神盾,10,0,10,富邦-宜蘭,2023-09-01,9686
5347,世界,10,0,10,富邦-宜蘭,2023-09-01,9686
3056,富華新,10,1,9,富邦-宜蘭,2023-09-01,9686
00665L,富邦�琤肭磪囓�2,9,0,9,富邦-宜蘭,2023-09-01,9686
2606,裕民,9,0,9,富邦-宜蘭,2023-09-01,9686
00919,群益台灣精選高息,359,9,350,富邦-宜蘭,2023-09-04,9686
00929,復華台灣科技優息,173,16,157,富邦-宜蘭,2023-09-04,9686
2323,中環,127,15,112,富邦-宜蘭,2023-09-04,9686
2897,王道銀行,100,0,100,富邦-宜蘭,2023-09-04,9686
2634,漢翔,94,16,78,富邦-宜蘭,2023-09-04,9686
2363,矽統,196,123,73,富邦-宜蘭,2023-09-04,9686
6125,廣運,61,3,58,富邦-宜蘭,2023-09-04,9686
2371,大同,80,23,57,富邦-宜蘭,2023-09-04,9686
2816,旺旺保,52,0,52,富邦-宜蘭,2023-09-04,9686
2409,友達,52,0,52,富邦-宜蘭,2023-09-04,9686
2329,華泰,62,16,46,富邦-宜蘭,2023-09-04,9686
1504,東元,65,20,45,富邦-宜蘭,2023-09-04,9686
3481,群創,46,8,38,富邦-宜蘭,2023-09-04,9686
6112,邁達特,36,1,35,富邦-宜蘭,2023-09-04,9686
2881,富邦金,28,0,28,富邦-宜蘭,2023-09-04,9686
2812,台中銀,27,1,26,富邦-宜蘭,2023-09-04,9686
2610,華航,24,2,22,富邦-宜蘭,2023-09-04,9686
3049,精金,20,0,20,富邦-宜蘭,2023-09-04,9686
1337,再生-KY,20,0,20,富邦-宜蘭,2023-09-04,9686
2888,新光金,30,11,19,富邦-宜蘭,2023-09-04,9686
00751B,元大AAA至A公司債,18,0,18,富邦-宜蘭,2023-09-04,9686
2462,良得電,20,2,18,富邦-宜蘭,2023-09-04,9686
2542,興富發,20,3,17,富邦-宜蘭,2023-09-04,9686
2324,仁寶,21,5,16,富邦-宜蘭,2023-09-04,9686
2355,敬鵬,19,3,16,富邦-宜蘭,2023-09-04,9686
00931B,統一美債20年,21,5,16,富邦-宜蘭,2023-09-04,9686
2206,三陽工業,22,6,16,富邦-宜蘭,2023-09-04,9686
8933,愛地雅,16,0,16,富邦-宜蘭,2023-09-04,9686
2374,佳能,26,11,15,富邦-宜蘭,2023-09-04,9686
4105,東洋,15,0,15,富邦-宜蘭,2023-09-04,9686
1802,台玻,40,26,14,富邦-宜蘭,2023-09-04,9686
2027,大成鋼,14,0,14,富邦-宜蘭,2023-09-04,9686
6547,高端疫苗,15,2,13,富邦-宜蘭,2023-09-04,9686
3290,東浦,13,0,13,富邦-宜蘭,2023-09-04,9686
2376,技嘉,30,18,12,富邦-宜蘭,2023-09-04,9686
00679B,元大美債20年,12,0,12,富邦-宜蘭,2023-09-04,9686
00720B,元大投資級公司債,12,0,12,富邦-宜蘭,2023-09-04,9686
4934,太極,12,0,12,富邦-宜蘭,2023-09-04,9686
6770,力積電,22,11,11,富邦-宜蘭,2023-09-04,9686
3325,旭品,11,1,10,富邦-宜蘭,2023-09-04,9686
1618,合機,11,1,10,富邦-宜蘭,2023-09-04,9686
6016,康和證,10,0,10,富邦-宜蘭,2023-09-04,9686
2929,淘帝-KY,10,0,10,富邦-宜蘭,2023-09-04,9686
6177,達麗,10,0,10,富邦-宜蘭,2023-09-04,9686
2615,萬海,11,1,10,富邦-宜蘭,2023-09-04,9686
1215,卜蜂,10,0,10,富邦-宜蘭,2023-09-04,9686
2892,第一金,12,2,10,富邦-宜蘭,2023-09-04,9686
5347,世界,10,1,9,富邦-宜蘭,2023-09-04,9686
1905,華紙,12,3,9,富邦-宜蘭,2023-09-04,9686
1471,首利,11,2,9,富邦-宜蘭,2023-09-04,9686
2610,華航,174,8,166,富邦-宜蘭,2023-09-05,9686
00929,復華台灣科技優息,225,114,111,富邦-宜蘭,2023-09-05,9686
2344,華邦電,141,40,101,富邦-宜蘭,2023-09-05,9686
00795B,中信美國公債20年,102,4,98,富邦-宜蘭,2023-09-05,9686
1471,首利,105,14,91,富邦-宜蘭,2023-09-05,9686
3058,立德,50,0,50,富邦-宜蘭,2023-09-05,9686
9103,美德醫療-DR,53,3,50,富邦-宜蘭,2023-09-05,9686
00696B,富邦美債20年,50,0,50,富邦-宜蘭,2023-09-05,9686
00687B,國泰20年美債,52,3,49,富邦-宜蘭,2023-09-05,9686
9919,康那香,44,0,44,富邦-宜蘭,2023-09-05,9686
2884,玉山金,43,0,43,富邦-宜蘭,2023-09-05,9686
00918,大華優利高填息30,42,0,42,富邦-宜蘭,2023-09-05,9686
00919,群益台灣精選高息,125,84,41,富邦-宜蘭,2023-09-05,9686
00907,永豐優息存股,38,0,38,富邦-宜蘭,2023-09-05,9686
5009,榮剛,39,1,38,富邦-宜蘭,2023-09-05,9686
6589,台康生技,52,17,35,富邦-宜蘭,2023-09-05,9686
1609,大亞,35,0,35,富邦-宜蘭,2023-09-05,9686
3481,群創,49,14,35,富邦-宜蘭,2023-09-05,9686
1616,億泰,140,108,32,富邦-宜蘭,2023-09-05,9686
2883B,凱基金乙特,32,0,32,富邦-宜蘭,2023-09-05,9686
3231,緯創,61,29,32,富邦-宜蘭,2023-09-05,9686
00753L,中信中國50正2,31,0,31,富邦-宜蘭,2023-09-05,9686
2436,偉詮電,57,27,30,富邦-宜蘭,2023-09-05,9686
2409,友達,39,12,27,富邦-宜蘭,2023-09-05,9686
00751B,元大AAA至A公司債,26,0,26,富邦-宜蘭,2023-09-05,9686
00932,兆豐永續高息等權,27,2,25,富邦-宜蘭,2023-09-05,9686
5381,合正,29,5,24,富邦-宜蘭,2023-09-05,9686
2376,技嘉,70,50,20,富邦-宜蘭,2023-09-05,9686
6271,同欣電,20,0,20,富邦-宜蘭,2023-09-05,9686
2025,千興,20,0,20,富邦-宜蘭,2023-09-05,9686
1101,台泥,20,1,19,富邦-宜蘭,2023-09-05,9686
5215,科嘉-KY,20,3,17,富邦-宜蘭,2023-09-05,9686
3051,力特,92,75,17,富邦-宜蘭,2023-09-05,9686
2881,富邦金,33,16,17,富邦-宜蘭,2023-09-05,9686
00896,中信綠能及電動車,16,0,16,富邦-宜蘭,2023-09-05,9686
2324,仁寶,28,13,15,富邦-宜蘭,2023-09-05,9686
00915,凱基優選高股息30,14,0,14,富邦-宜蘭,2023-09-05,9686
6197,佳必琪,14,0,14,富邦-宜蘭,2023-09-05,9686
6282,康舒,18,6,12,富邦-宜蘭,2023-09-05,9686
3645,達邁,14,2,12,富邦-宜蘭,2023-09-05,9686
4157,太景*-KY,13,1,12,富邦-宜蘭,2023-09-05,9686
3037,欣興,12,1,11,富邦-宜蘭,2023-09-05,9686
2634,漢翔,43,32,11,富邦-宜蘭,2023-09-05,9686
2317,鴻海,14,3,11,富邦-宜蘭,2023-09-05,9686
00931B,統一美債20年,10,0,10,富邦-宜蘭,2023-09-05,9686
6235,華孚,24,14,10,富邦-宜蘭,2023-09-05,9686
4714,永捷,10,0,10,富邦-宜蘭,2023-09-05,9686
2393,億光,10,0,10,富邦-宜蘭,2023-09-05,9686
8088,品安,10,0,10,富邦-宜蘭,2023-09-05,9686
4987,科誠,10,0,10,富邦-宜蘭,2023-09-05,9686
00929,復華台灣科技優息,353,89,264,富邦-宜蘭,2023-09-06,9686
2409,友達,141,0,141,富邦-宜蘭,2023-09-06,9686
2610,華航,111,13,98,富邦-宜蘭,2023-09-06,9686
00919,群益台灣精選高息,142,49,93,富邦-宜蘭,2023-09-06,9686
3481,群創,115,25,90,富邦-宜蘭,2023-09-06,9686
00932,兆豐永續高息等權,68,2,66,富邦-宜蘭,2023-09-06,9686
2401,凌陽,99,34,65,富邦-宜蘭,2023-09-06,9686
9919,康那香,67,3,64,富邦-宜蘭,2023-09-06,9686
00896,中信綠能及電動車,61,0,61,富邦-宜蘭,2023-09-06,9686
1101,台泥,70,9,61,富邦-宜蘭,2023-09-06,9686
00641R,富邦日本反1,55,0,55,富邦-宜蘭,2023-09-06,9686
00918,大華優利高填息30,54,0,54,富邦-宜蘭,2023-09-06,9686
2881,富邦金,55,2,53,富邦-宜蘭,2023-09-06,9686
8064,東捷,51,6,45,富邦-宜蘭,2023-09-06,9686
2363,矽統,166,122,44,富邦-宜蘭,2023-09-06,9686
1616,億泰,39,2,37,富邦-宜蘭,2023-09-06,9686
00915,凱基優選高股息30,36,0,36,富邦-宜蘭,2023-09-06,9686
1802,台玻,33,0,33,富邦-宜蘭,2023-09-06,9686
4977,眾達-KY,47,16,31,富邦-宜蘭,2023-09-06,9686
2915,潤泰全,31,0,31,富邦-宜蘭,2023-09-06,9686
00751B,元大AAA至A公司債,30,0,30,富邦-宜蘭,2023-09-06,9686
3625,西勝,42,13,29,富邦-宜蘭,2023-09-06,9686
8930,青鋼,25,0,25,富邦-宜蘭,2023-09-06,9686
4960,誠美材,25,0,25,富邦-宜蘭,2023-09-06,9686
00753L,中信中國50正2,23,0,23,富邦-宜蘭,2023-09-06,9686
2462,良得電,22,0,22,富邦-宜蘭,2023-09-06,9686
1268,漢來美食,20,0,20,富邦-宜蘭,2023-09-06,9686
8105,凌巨,20,0,20,富邦-宜蘭,2023-09-06,9686
00907,永豐優息存股,20,0,20,富邦-宜蘭,2023-09-06,9686
2609,陽明,20,1,19,富邦-宜蘭,2023-09-06,9686
1504,東元,20,1,19,富邦-宜蘭,2023-09-06,9686
6188,廣明,19,1,18,富邦-宜蘭,2023-09-06,9686
2388,威盛,23,5,18,富邦-宜蘭,2023-09-06,9686
00931B,統一美債20年,17,0,17,富邦-宜蘭,2023-09-06,9686
8358,金居,34,17,17,富邦-宜蘭,2023-09-06,9686
2002,中鋼,17,0,17,富邦-宜蘭,2023-09-06,9686
5468,凱鈺,15,0,15,富邦-宜蘭,2023-09-06,9686
3605,宏致,15,0,15,富邦-宜蘭,2023-09-06,9686
00897,富邦基因免疫生技,15,0,15,富邦-宜蘭,2023-09-06,9686
2393,億光,15,0,15,富邦-宜蘭,2023-09-06,9686
00642U,期元大S＆P石油,15,0,15,富邦-宜蘭,2023-09-06,9686
2027,大成鋼,14,0,14,富邦-宜蘭,2023-09-06,9686
2618,長榮航,26,12,14,富邦-宜蘭,2023-09-06,9686
00650L,復華香港正2,13,0,13,富邦-宜蘭,2023-09-06,9686
3308,聯德,19,6,13,富邦-宜蘭,2023-09-06,9686
2323,中環,13,0,13,富邦-宜蘭,2023-09-06,9686
2892,第一金,12,0,12,富邦-宜蘭,2023-09-06,9686
00680L,元大美債20正2,12,0,12,富邦-宜蘭,2023-09-06,9686
2457,飛宏,25,13,12,富邦-宜蘭,2023-09-06,9686
3567,逸昌,11,0,11,富邦-宜蘭,2023-09-06,9686
6116,彩晶,250,0,250,富邦-宜蘭,2023-09-07,9686
00929,復華台灣科技優息,337,123,214,富邦-宜蘭,2023-09-07,9686
2323,中環,124,8,116,富邦-宜蘭,2023-09-07,9686
00919,群益台灣精選高息,117,11,106,富邦-宜蘭,2023-09-07,9686
8112,至上,104,24,80,富邦-宜蘭,2023-09-07,9686
3481,群創,72,4,68,富邦-宜蘭,2023-09-07,9686
00673R,期元大S＆P原油反1,63,0,63,富邦-宜蘭,2023-09-07,9686
3231,緯創,71,15,56,富邦-宜蘭,2023-09-07,9686
2888,新光金,55,0,55,富邦-宜蘭,2023-09-07,9686
2358,廷鑫,79,30,49,富邦-宜蘭,2023-09-07,9686
2816,旺旺保,111,70,41,富邦-宜蘭,2023-09-07,9686
2614,東森,57,17,40,富邦-宜蘭,2023-09-07,9686
2303,聯電,41,2,39,富邦-宜蘭,2023-09-07,9686
2002,中鋼,30,0,30,富邦-宜蘭,2023-09-07,9686
8930,青鋼,35,5,30,富邦-宜蘭,2023-09-07,9686
2881,富邦金,81,52,29,富邦-宜蘭,2023-09-07,9686
4906,正文,29,1,28,富邦-宜蘭,2023-09-07,9686
00715L,期街口布蘭特正2,25,0,25,富邦-宜蘭,2023-09-07,9686
2356,英業達,28,4,24,富邦-宜蘭,2023-09-07,9686
2330,台積電,22,0,22,富邦-宜蘭,2023-09-07,9686
00932,兆豐永續高息等權,24,3,21,富邦-宜蘭,2023-09-07,9686
2615,萬海,20,0,20,富邦-宜蘭,2023-09-07,9686
2465,麗臺,20,0,20,富邦-宜蘭,2023-09-07,9686
0056,元大高股息,23,3,20,富邦-宜蘭,2023-09-07,9686
2409,友達,34,14,20,富邦-宜蘭,2023-09-07,9686
4933,友輝,20,1,19,富邦-宜蘭,2023-09-07,9686
3306,鼎天,24,5,19,富邦-宜蘭,2023-09-07,9686
2332,友訊,24,6,18,富邦-宜蘭,2023-09-07,9686
2313,華通,96,79,17,富邦-宜蘭,2023-09-07,9686
00900,富邦特選高股息30,18,1,17,富邦-宜蘭,2023-09-07,9686
3704,合勤控,38,22,16,富邦-宜蘭,2023-09-07,9686
2485,兆赫,86,70,16,富邦-宜蘭,2023-09-07,9686
5880,合庫金,16,0,16,富邦-宜蘭,2023-09-07,9686
00888,永豐台灣ESG,16,0,16,富邦-宜蘭,2023-09-07,9686
2382,廣達,52,36,16,富邦-宜蘭,2023-09-07,9686
00918,大華優利高填息30,19,4,15,富邦-宜蘭,2023-09-07,9686
3049,精金,15,0,15,富邦-宜蘭,2023-09-07,9686
911868,同方友友-DR,15,0,15,富邦-宜蘭,2023-09-07,9686
2634,漢翔,20,6,14,富邦-宜蘭,2023-09-07,9686
4147,中裕,21,7,14,富邦-宜蘭,2023-09-07,9686
2342,茂矽,15,1,14,富邦-宜蘭,2023-09-07,9686
00896,中信綠能及電動車,16,2,14,富邦-宜蘭,2023-09-07,9686
2308,台達電,16,2,14,富邦-宜蘭,2023-09-07,9686
1802,台玻,15,1,14,富邦-宜蘭,2023-09-07,9686
2884,玉山金,15,2,13,富邦-宜蘭,2023-09-07,9686
00907,永豐優息存股,13,0,13,富邦-宜蘭,2023-09-07,9686
2401,凌陽,47,34,13,富邦-宜蘭,2023-09-07,9686
5498,凱崴,14,1,13,富邦-宜蘭,2023-09-07,9686
4908,前鼎,23,11,12,富邦-宜蘭,2023-09-07,9686
5381,合正,19,8,11,富邦-宜蘭,2023-09-07,9686
00919,群益台灣精選高息,198,2,196,富邦-宜蘭,2023-09-08,9686
2323,中環,137,2,135,富邦-宜蘭,2023-09-08,9686
00929,復華台灣科技優息,161,45,116,富邦-宜蘭,2023-09-08,9686
2020,美亞,84,1,83,富邦-宜蘭,2023-09-08,9686
1616,億泰,72,21,51,富邦-宜蘭,2023-09-08,9686
2324,仁寶,53,8,45,富邦-宜蘭,2023-09-08,9686
2002,中鋼,43,0,43,富邦-宜蘭,2023-09-08,9686
00930,永豐ESG低碳高息,42,0,42,富邦-宜蘭,2023-09-08,9686
4933,友輝,40,0,40,富邦-宜蘭,2023-09-08,9686
2340,台亞,33,0,33,富邦-宜蘭,2023-09-08,9686
9105,泰金寶-DR,57,24,33,富邦-宜蘭,2023-09-08,9686
1337,再生-KY,30,0,30,富邦-宜蘭,2023-09-08,9686
00918,大華優利高填息30,32,2,30,富邦-宜蘭,2023-09-08,9686
2630,亞航,49,19,30,富邦-宜蘭,2023-09-08,9686
00637L,元大滬深300正2,25,0,25,富邦-宜蘭,2023-09-08,9686
00878,國泰永續高股息,34,9,25,富邦-宜蘭,2023-09-08,9686
2313,華通,38,15,23,富邦-宜蘭,2023-09-08,9686
2884,玉山金,23,1,22,富邦-宜蘭,2023-09-08,9686
1802,台玻,24,2,22,富邦-宜蘭,2023-09-08,9686
2486,一詮,40,18,22,富邦-宜蘭,2023-09-08,9686
2353,宏��,23,2,21,富邦-宜蘭,2023-09-08,9686
1101,台泥,20,0,20,富邦-宜蘭,2023-09-08,9686
2801,彰銀,20,0,20,富邦-宜蘭,2023-09-08,9686
4934,太極,43,23,20,富邦-宜蘭,2023-09-08,9686
2465,麗臺,20,0,20,富邦-宜蘭,2023-09-08,9686
8071,能率網通,20,0,20,富邦-宜蘭,2023-09-08,9686
2356,英業達,39,20,19,富邦-宜蘭,2023-09-08,9686
2382,廣達,45,27,18,富邦-宜蘭,2023-09-08,9686
3481,群創,24,6,18,富邦-宜蘭,2023-09-08,9686
6191,精成科,21,4,17,富邦-宜蘭,2023-09-08,9686
2344,華邦電,20,4,16,富邦-宜蘭,2023-09-08,9686
2888,新光金,20,4,16,富邦-宜蘭,2023-09-08,9686
3231,緯創,45,31,14,富邦-宜蘭,2023-09-08,9686
4533,協易機,26,12,14,富邦-宜蘭,2023-09-08,9686
2399,映泰,23,9,14,富邦-宜蘭,2023-09-08,9686
9907,統一實,13,0,13,富邦-宜蘭,2023-09-08,9686
5880,合庫金,13,1,12,富邦-宜蘭,2023-09-08,9686
8050,廣積,24,12,12,富邦-宜蘭,2023-09-08,9686
2201,裕隆,13,1,12,富邦-宜蘭,2023-09-08,9686
3308,聯德,14,2,12,富邦-宜蘭,2023-09-08,9686
3704,合勤控,22,10,12,富邦-宜蘭,2023-09-08,9686
3207,耀勝,16,4,12,富邦-宜蘭,2023-09-08,9686
5381,合正,22,10,12,富邦-宜蘭,2023-09-08,9686
2614,東森,19,8,11,富邦-宜蘭,2023-09-08,9686
2329,華泰,42,31,11,富邦-宜蘭,2023-09-08,9686
00902,中信電池及儲能,11,0,11,富邦-宜蘭,2023-09-08,9686
4931,新盛力,11,0,11,富邦-宜蘭,2023-09-08,9686
2405,輔信,18,7,11,富邦-宜蘭,2023-09-08,9686
1402,遠東新,10,0,10,富邦-宜蘭,2023-09-08,9686
2374,佳能,11,1,10,富邦-宜蘭,2023-09-08,9686
00919,群益台灣精選高息,296,0,296,富邦-宜蘭,2023-09-11,9686
2405,輔信,182,43,139,富邦-宜蘭,2023-09-11,9686
00878,國泰永續高股息,179,45,134,富邦-宜蘭,2023-09-11,9686
1616,億泰,109,5,104,富邦-宜蘭,2023-09-11,9686
00929,復華台灣科技優息,213,127,86,富邦-宜蘭,2023-09-11,9686
2020,美亞,75,0,75,富邦-宜蘭,2023-09-11,9686
2312,金寶,74,6,68,富邦-宜蘭,2023-09-11,9686
3576,聯合再生,50,0,50,富邦-宜蘭,2023-09-11,9686
00915,凱基優選高股息30,49,0,49,富邦-宜蘭,2023-09-11,9686
2363,矽統,118,71,47,富邦-宜蘭,2023-09-11,9686
00900,富邦特選高股息30,43,0,43,富邦-宜蘭,2023-09-11,9686
2313,華通,89,53,36,富邦-宜蘭,2023-09-11,9686
2376,技嘉,96,61,35,富邦-宜蘭,2023-09-11,9686
1504,東元,40,8,32,富邦-宜蘭,2023-09-11,9686
9919,康那香,30,0,30,富邦-宜蘭,2023-09-11,9686
1909,榮成,30,0,30,富邦-宜蘭,2023-09-11,9686
5348,正能量智能,27,0,27,富邦-宜蘭,2023-09-11,9686
00722B,群益投資級電信債,25,0,25,富邦-宜蘭,2023-09-11,9686
1506,正道,25,0,25,富邦-宜蘭,2023-09-11,9686
00918,大華優利高填息30,45,21,24,富邦-宜蘭,2023-09-11,9686
00712,復華富時不動產,24,0,24,富邦-宜蘭,2023-09-11,9686
1618,合機,27,4,23,富邦-宜蘭,2023-09-11,9686
0056,元大高股息,38,15,23,富邦-宜蘭,2023-09-11,9686
4934,太極,38,16,22,富邦-宜蘭,2023-09-11,9686
4543,萬在,23,2,21,富邦-宜蘭,2023-09-11,9686
3231,緯創,135,115,20,富邦-宜蘭,2023-09-11,9686
6190,萬泰科,20,0,20,富邦-宜蘭,2023-09-11,9686
00881,國泰台灣5G+,20,0,20,富邦-宜蘭,2023-09-11,9686
00642U,期元大S＆P石油,20,0,20,富邦-宜蘭,2023-09-11,9686
3202,樺晟,19,0,19,富邦-宜蘭,2023-09-11,9686
00931B,統一美債20年,18,0,18,富邦-宜蘭,2023-09-11,9686
6788,華景電,20,2,18,富邦-宜蘭,2023-09-11,9686
3029,零壹,20,2,18,富邦-宜蘭,2023-09-11,9686
00715L,期街口布蘭特正2,18,0,18,富邦-宜蘭,2023-09-11,9686
6139,亞翔,21,4,17,富邦-宜蘭,2023-09-11,9686
2881,富邦金,18,1,17,富邦-宜蘭,2023-09-11,9686
00932,兆豐永續高息等權,80,64,16,富邦-宜蘭,2023-09-11,9686
00751B,元大AAA至A公司債,15,0,15,富邦-宜蘭,2023-09-11,9686
6116,彩晶,25,10,15,富邦-宜蘭,2023-09-11,9686
6234,高僑,16,1,15,富邦-宜蘭,2023-09-11,9686
2440,太空梭,15,0,15,富邦-宜蘭,2023-09-11,9686
2388,威盛,15,0,15,富邦-宜蘭,2023-09-11,9686
3481,群創,40,26,14,富邦-宜蘭,2023-09-11,9686
5907,大洋-KY,14,0,14,富邦-宜蘭,2023-09-11,9686
6282,康舒,32,18,14,富邦-宜蘭,2023-09-11,9686
00679B,元大美債20年,14,0,14,富邦-宜蘭,2023-09-11,9686
2330,台積電,14,0,14,富邦-宜蘭,2023-09-11,9686
2002,中鋼,16,3,13,富邦-宜蘭,2023-09-11,9686
1101,台泥,13,0,13,富邦-宜蘭,2023-09-11,9686
8071,能率網通,13,0,13,富邦-宜蘭,2023-09-11,9686
2323,中環,206,3,203,富邦-宜蘭,2023-09-12,9686
00673R,期元大S＆P原油反1,157,10,147,富邦-宜蘭,2023-09-12,9686
1216,統一,100,0,100,富邦-宜蘭,2023-09-12,9686
00919,群益台灣精選高息,63,6,57,富邦-宜蘭,2023-09-12,9686
2363,矽統,112,59,53,富邦-宜蘭,2023-09-12,9686
00751B,元大AAA至A公司債,46,0,46,富邦-宜蘭,2023-09-12,9686
2618,長榮航,70,30,40,富邦-宜蘭,2023-09-12,9686
3380,明泰,39,0,39,富邦-宜蘭,2023-09-12,9686
00902,中信電池及儲能,35,0,35,富邦-宜蘭,2023-09-12,9686
6120,達運,66,33,33,富邦-宜蘭,2023-09-12,9686
2316,楠梓電,35,4,31,富邦-宜蘭,2023-09-12,9686
2010,春源,30,0,30,富邦-宜蘭,2023-09-12,9686
9103,美德醫療-DR,29,0,29,富邦-宜蘭,2023-09-12,9686
3049,精金,27,0,27,富邦-宜蘭,2023-09-12,9686
2457,飛宏,26,0,26,富邦-宜蘭,2023-09-12,9686
2883,凱基金,29,3,26,富邦-宜蘭,2023-09-12,9686
5210,寶碩,24,1,23,富邦-宜蘭,2023-09-12,9686
9105,泰金寶-DR,23,0,23,富邦-宜蘭,2023-09-12,9686
2002,中鋼,22,0,22,富邦-宜蘭,2023-09-12,9686
00915,凱基優選高股息30,21,0,21,富邦-宜蘭,2023-09-12,9686
2887,台新金,21,0,21,富邦-宜蘭,2023-09-12,9686
3163,波若威,45,25,20,富邦-宜蘭,2023-09-12,9686
2634,漢翔,34,15,19,富邦-宜蘭,2023-09-12,9686
2324,仁寶,22,4,18,富邦-宜蘭,2023-09-12,9686
2884,玉山金,30,12,18,富邦-宜蘭,2023-09-12,9686
2405,輔信,87,70,17,富邦-宜蘭,2023-09-12,9686
2025,千興,20,3,17,富邦-宜蘭,2023-09-12,9686
3078,僑威,72,55,17,富邦-宜蘭,2023-09-12,9686
2409,友達,31,15,16,富邦-宜蘭,2023-09-12,9686
2881,富邦金,23,7,16,富邦-宜蘭,2023-09-12,9686
00715L,期街口布蘭特正2,20,4,16,富邦-宜蘭,2023-09-12,9686
1515,力山,87,72,15,富邦-宜蘭,2023-09-12,9686
00932,兆豐永續高息等權,14,0,14,富邦-宜蘭,2023-09-12,9686
8069,元太,14,1,13,富邦-宜蘭,2023-09-12,9686
5215,科嘉-KY,19,7,12,富邦-宜蘭,2023-09-12,9686
3545,敦泰,18,7,11,富邦-宜蘭,2023-09-12,9686
4164,承業醫,11,0,11,富邦-宜蘭,2023-09-12,9686
5348,正能量智能,10,0,10,富邦-宜蘭,2023-09-12,9686
8071,能率網通,10,0,10,富邦-宜蘭,2023-09-12,9686
2211,長榮鋼,10,0,10,富邦-宜蘭,2023-09-12,9686
1618,合機,13,3,10,富邦-宜蘭,2023-09-12,9686
1815,富喬,11,1,10,富邦-宜蘭,2023-09-12,9686
8403,盛弘,10,0,10,富邦-宜蘭,2023-09-12,9686
00696B,富邦美債20年,10,0,10,富邦-宜蘭,2023-09-12,9686
6589,台康生技,10,0,10,富邦-宜蘭,2023-09-12,9686
4541,晟田,10,0,10,富邦-宜蘭,2023-09-12,9686
6274,台燿,13,3,10,富邦-宜蘭,2023-09-12,9686
4915,致伸,14,5,9,富邦-宜蘭,2023-09-12,9686
00929,復華台灣科技優息,73,64,9,富邦-宜蘭,2023-09-12,9686
5907,大洋-KY,9,0,9,富邦-宜蘭,2023-09-12,9686
00929,復華台灣科技優息,246,88,158,富邦-宜蘭,2023-09-13,9686
00919,群益台灣精選高息,92,0,92,富邦-宜蘭,2023-09-13,9686
2881,富邦金,90,12,78,富邦-宜蘭,2023-09-13,9686
00637L,元大滬深300正2,77,15,62,富邦-宜蘭,2023-09-13,9686
2025,千興,65,4,61,富邦-宜蘭,2023-09-13,9686
3231,緯創,67,18,49,富邦-宜蘭,2023-09-13,9686
1101,台泥,53,14,39,富邦-宜蘭,2023-09-13,9686
3029,零壹,34,1,33,富邦-宜蘭,2023-09-13,9686
00715L,期街口布蘭特正2,33,0,33,富邦-宜蘭,2023-09-13,9686
2915,潤泰全,31,0,31,富邦-宜蘭,2023-09-13,9686
1609,大亞,35,5,30,富邦-宜蘭,2023-09-13,9686
0056,元大高股息,30,2,28,富邦-宜蘭,2023-09-13,9686
1536,和大,36,8,28,富邦-宜蘭,2023-09-13,9686
2883,凱基金,34,6,28,富邦-宜蘭,2023-09-13,9686
1809,中釉,39,11,28,富邦-宜蘭,2023-09-13,9686
00931B,統一美債20年,21,0,21,富邦-宜蘭,2023-09-13,9686
5009,榮剛,25,4,21,富邦-宜蘭,2023-09-13,9686
2313,華通,51,30,21,富邦-宜蘭,2023-09-13,9686
8034,榮群,20,0,20,富邦-宜蘭,2023-09-13,9686
5227,立凱-KY,21,2,19,富邦-宜蘭,2023-09-13,9686
6282,康舒,24,7,17,富邦-宜蘭,2023-09-13,9686
2906,高林,17,0,17,富邦-宜蘭,2023-09-13,9686
2323,中環,21,4,17,富邦-宜蘭,2023-09-13,9686
6288,聯嘉,20,3,17,富邦-宜蘭,2023-09-13,9686
2482,連宇,16,0,16,富邦-宜蘭,2023-09-13,9686
3709,鑫聯大投控,15,1,14,富邦-宜蘭,2023-09-13,9686
2206,三陽工業,19,5,14,富邦-宜蘭,2023-09-13,9686
00878,國泰永續高股息,45,31,14,富邦-宜蘭,2023-09-13,9686
3711,日月光投控,13,0,13,富邦-宜蘭,2023-09-13,9686
2887,台新金,23,11,12,富邦-宜蘭,2023-09-13,9686
2610,華航,23,11,12,富邦-宜蘭,2023-09-13,9686
3481,群創,32,20,12,富邦-宜蘭,2023-09-13,9686
00670L,富邦NASDAQ正2,16,4,12,富邦-宜蘭,2023-09-13,9686
00902,中信電池及儲能,12,0,12,富邦-宜蘭,2023-09-13,9686
1524,耿鼎,64,54,10,富邦-宜蘭,2023-09-13,9686
2816,旺旺保,10,0,10,富邦-宜蘭,2023-09-13,9686
00633L,富邦上証正2,10,0,10,富邦-宜蘭,2023-09-13,9686
2903,遠百,10,0,10,富邦-宜蘭,2023-09-13,9686
00918,大華優利高填息30,12,2,10,富邦-宜蘭,2023-09-13,9686
2929,淘帝-KY,10,0,10,富邦-宜蘭,2023-09-13,9686
2537,聯上發,10,0,10,富邦-宜蘭,2023-09-13,9686
3122,笙泉,10,0,10,富邦-宜蘭,2023-09-13,9686
2211,長榮鋼,10,0,10,富邦-宜蘭,2023-09-13,9686
2465,麗臺,10,0,10,富邦-宜蘭,2023-09-13,9686
6235,華孚,17,7,10,富邦-宜蘭,2023-09-13,9686
8240,華宏,10,0,10,富邦-宜蘭,2023-09-13,9686
6125,廣運,18,9,9,富邦-宜蘭,2023-09-13,9686
1815,富喬,10,1,9,富邦-宜蘭,2023-09-13,9686
5474,聰泰,10,1,9,富邦-宜蘭,2023-09-13,9686
3346,麗清,29,20,9,富邦-宜蘭,2023-09-13,9686
2537,聯上發,235,0,235,富邦-宜蘭,2023-09-14,9686
00929,復華台灣科技優息,423,191,232,富邦-宜蘭,2023-09-14,9686
1314,中石化,168,17,151,富邦-宜蘭,2023-09-14,9686
00919,群益台灣精選高息,144,13,131,富邦-宜蘭,2023-09-14,9686
5498,凱崴,79,0,79,富邦-宜蘭,2023-09-14,9686
2371,大同,86,16,70,富邦-宜蘭,2023-09-14,9686
6120,達運,64,7,57,富邦-宜蘭,2023-09-14,9686
00764B,群益25年美債,40,0,40,富邦-宜蘭,2023-09-14,9686
00900,富邦特選高股息30,42,7,35,富邦-宜蘭,2023-09-14,9686
2641,正德,31,0,31,富邦-宜蘭,2023-09-14,9686
00679B,元大美債20年,30,0,30,富邦-宜蘭,2023-09-14,9686
3025,星通,45,17,28,富邦-宜蘭,2023-09-14,9686
3005,神基,23,0,23,富邦-宜蘭,2023-09-14,9686
4916,事欣科,30,8,22,富邦-宜蘭,2023-09-14,9686
2020,美亞,31,10,21,富邦-宜蘭,2023-09-14,9686
8088,品安,23,4,19,富邦-宜蘭,2023-09-14,9686
6585,鼎基,17,0,17,富邦-宜蘭,2023-09-14,9686
00664R,國泰臺灣加權反1,17,0,17,富邦-宜蘭,2023-09-14,9686
2610,華航,21,4,17,富邦-宜蘭,2023-09-14,9686
00720B,元大投資級公司債,16,0,16,富邦-宜蘭,2023-09-14,9686
2340,台亞,20,4,16,富邦-宜蘭,2023-09-14,9686
6188,廣明,21,5,16,富邦-宜蘭,2023-09-14,9686
6217,中探針,17,1,16,富邦-宜蘭,2023-09-14,9686
2405,輔信,22,6,16,富邦-宜蘭,2023-09-14,9686
00753L,中信中國50正2,13,0,13,富邦-宜蘭,2023-09-14,9686
1471,首利,13,0,13,富邦-宜蘭,2023-09-14,9686
2538,基泰,13,0,13,富邦-宜蘭,2023-09-14,9686
6271,同欣電,13,1,12,富邦-宜蘭,2023-09-14,9686
1616,億泰,13,2,11,富邦-宜蘭,2023-09-14,9686
00902,中信電池及儲能,11,0,11,富邦-宜蘭,2023-09-14,9686
2630,亞航,14,3,11,富邦-宜蘭,2023-09-14,9686
00885,富邦越南,11,1,10,富邦-宜蘭,2023-09-14,9686
2485,兆赫,24,14,10,富邦-宜蘭,2023-09-14,9686
6288,聯嘉,14,4,10,富邦-宜蘭,2023-09-14,9686
2867,三商壽,10,0,10,富邦-宜蘭,2023-09-14,9686
2645,長榮航太,10,0,10,富邦-宜蘭,2023-09-14,9686
2323,中環,30,20,10,富邦-宜蘭,2023-09-14,9686
1709,和益,10,0,10,富邦-宜蘭,2023-09-14,9686
1806,冠軍,10,0,10,富邦-宜蘭,2023-09-14,9686
3374,精材,10,0,10,富邦-宜蘭,2023-09-14,9686
3003,健和興,10,0,10,富邦-宜蘭,2023-09-14,9686
1409,新纖,10,0,10,富邦-宜蘭,2023-09-14,9686
00882,中信中國高股息,12,3,9,富邦-宜蘭,2023-09-14,9686
2618,長榮航,15,6,9,富邦-宜蘭,2023-09-14,9686
1522,堤維西,109,100,9,富邦-宜蘭,2023-09-14,9686
2025,千興,23,14,9,富邦-宜蘭,2023-09-14,9686
2332,友訊,9,0,9,富邦-宜蘭,2023-09-14,9686
3484,崧騰,9,0,9,富邦-宜蘭,2023-09-14,9686
1319,東陽,35,26,9,富邦-宜蘭,2023-09-14,9686
00931B,統一美債20年,8,0,8,富邦-宜蘭,2023-09-14,9686
00929,復華台灣科技優息,637,107,530,富邦-宜蘭,2023-09-15,9686
2891,中信金,238,1,237,富邦-宜蘭,2023-09-15,9686
00632R,元大台灣50反1,203,5,198,富邦-宜蘭,2023-09-15,9686
2618,長榮航,213,16,197,富邦-宜蘭,2023-09-15,9686
2601,益航,124,4,120,富邦-宜蘭,2023-09-15,9686
00751B,元大AAA至A公司債,71,0,71,富邦-宜蘭,2023-09-15,9686
00673R,期元大S＆P原油反1,66,0,66,富邦-宜蘭,2023-09-15,9686
1616,億泰,59,1,58,富邦-宜蘭,2023-09-15,9686
2486,一詮,130,76,54,富邦-宜蘭,2023-09-15,9686
00932,兆豐永續高息等權,54,0,54,富邦-宜蘭,2023-09-15,9686
00665L,富邦�琤肭磪囓�2,45,0,45,富邦-宜蘭,2023-09-15,9686
2641,正德,47,7,40,富邦-宜蘭,2023-09-15,9686
3481,群創,52,16,36,富邦-宜蘭,2023-09-15,9686
00896,中信綠能及電動車,46,10,36,富邦-宜蘭,2023-09-15,9686
00931B,統一美債20年,45,10,35,富邦-宜蘭,2023-09-15,9686
4908,前鼎,103,70,33,富邦-宜蘭,2023-09-15,9686
2329,華泰,39,8,31,富邦-宜蘭,2023-09-15,9686
2104,國際中橡,30,0,30,富邦-宜蘭,2023-09-15,9686
2867,三商壽,29,0,29,富邦-宜蘭,2023-09-15,9686
2611,志信,31,2,29,富邦-宜蘭,2023-09-15,9686
2610,華航,39,11,28,富邦-宜蘭,2023-09-15,9686
3322,建舜電,29,2,27,富邦-宜蘭,2023-09-15,9686
5608,四維航,43,16,27,富邦-宜蘭,2023-09-15,9686
1810,和成,27,0,27,富邦-宜蘭,2023-09-15,9686
2884,玉山金,33,7,26,富邦-宜蘭,2023-09-15,9686
2316,楠梓電,32,6,26,富邦-宜蘭,2023-09-15,9686
00722B,群益投資級電信債,25,0,25,富邦-宜蘭,2023-09-15,9686
8068,全達,27,2,25,富邦-宜蘭,2023-09-15,9686
00918,大華優利高填息30,27,2,25,富邦-宜蘭,2023-09-15,9686
2323,中環,30,6,24,富邦-宜蘭,2023-09-15,9686
00637L,元大滬深300正2,64,41,23,富邦-宜蘭,2023-09-15,9686
2425,承啟,31,11,20,富邦-宜蘭,2023-09-15,9686
3058,立德,23,3,20,富邦-宜蘭,2023-09-15,9686
2206,三陽工業,25,6,19,富邦-宜蘭,2023-09-15,9686
3209,全科,18,0,18,富邦-宜蘭,2023-09-15,9686
00720B,元大投資級公司債,18,0,18,富邦-宜蘭,2023-09-15,9686
2317,鴻海,18,1,17,富邦-宜蘭,2023-09-15,9686
3704,合勤控,66,49,17,富邦-宜蘭,2023-09-15,9686
2312,金寶,17,0,17,富邦-宜蘭,2023-09-15,9686
00679B,元大美債20年,17,0,17,富邦-宜蘭,2023-09-15,9686
2376,技嘉,36,20,16,富邦-宜蘭,2023-09-15,9686
00878,國泰永續高股息,24,8,16,富邦-宜蘭,2023-09-15,9686
00895,富邦未來車,18,2,16,富邦-宜蘭,2023-09-15,9686
3402,漢科,15,0,15,富邦-宜蘭,2023-09-15,9686
3029,零壹,15,0,15,富邦-宜蘭,2023-09-15,9686
00902,中信電池及儲能,15,0,15,富邦-宜蘭,2023-09-15,9686
2890,永豐金,16,1,15,富邦-宜蘭,2023-09-15,9686
8034,榮群,18,4,14,富邦-宜蘭,2023-09-15,9686
3715,定穎投控,121,108,13,富邦-宜蘭,2023-09-15,9686
2645,長榮航太,12,0,12,富邦-宜蘭,2023-09-15,9686
00929,復華台灣科技優息,441,31,410,富邦-宜蘭,2023-09-18,9686
2363,矽統,343,166,177,富邦-宜蘭,2023-09-18,9686
00751B,元大AAA至A公司債,71,0,71,富邦-宜蘭,2023-09-18,9686
00931B,統一美債20年,69,0,69,富邦-宜蘭,2023-09-18,9686
1616,億泰,63,0,63,富邦-宜蘭,2023-09-18,9686
00772B,中信高評級公司債,57,0,57,富邦-宜蘭,2023-09-18,9686
3231,緯創,81,29,52,富邦-宜蘭,2023-09-18,9686
2417,圓剛,86,36,50,富邦-宜蘭,2023-09-18,9686
5483,中美晶,57,8,49,富邦-宜蘭,2023-09-18,9686
1316,上曜,51,2,49,富邦-宜蘭,2023-09-18,9686
00915,凱基優選高股息30,48,0,48,富邦-宜蘭,2023-09-18,9686
00720B,元大投資級公司債,43,0,43,富邦-宜蘭,2023-09-18,9686
00878,國泰永續高股息,62,19,43,富邦-宜蘭,2023-09-18,9686
1504,東元,40,0,40,富邦-宜蘭,2023-09-18,9686
00916,國泰全球品牌50,38,0,38,富邦-宜蘭,2023-09-18,9686
6456,GIS-KY,36,2,34,富邦-宜蘭,2023-09-18,9686
00679B,元大美債20年,32,0,32,富邦-宜蘭,2023-09-18,9686
6418,詠昇,31,1,30,富邦-宜蘭,2023-09-18,9686
5227,立凱-KY,30,0,30,富邦-宜蘭,2023-09-18,9686
00753L,中信中國50正2,29,0,29,富邦-宜蘭,2023-09-18,9686
00885,富邦越南,28,0,28,富邦-宜蘭,2023-09-18,9686
1727,中華化,27,0,27,富邦-宜蘭,2023-09-18,9686
00918,大華優利高填息30,24,0,24,富邦-宜蘭,2023-09-18,9686
3450,聯鈞,32,9,23,富邦-宜蘭,2023-09-18,9686
2883B,凱基金乙特,22,0,22,富邦-宜蘭,2023-09-18,9686
1795,美時,21,0,21,富邦-宜蘭,2023-09-18,9686
00722B,群益投資級電信債,20,0,20,富邦-宜蘭,2023-09-18,9686
6153,嘉聯益,20,0,20,富邦-宜蘭,2023-09-18,9686
6116,彩晶,20,0,20,富邦-宜蘭,2023-09-18,9686
3363,上詮,32,12,20,富邦-宜蘭,2023-09-18,9686
00897,富邦基因免疫生技,20,0,20,富邦-宜蘭,2023-09-18,9686
2330,台積電,28,8,20,富邦-宜蘭,2023-09-18,9686
00896,中信綠能及電動車,18,0,18,富邦-宜蘭,2023-09-18,9686
4977,眾達-KY,61,43,18,富邦-宜蘭,2023-09-18,9686
2301,光寶科,26,8,18,富邦-宜蘭,2023-09-18,9686
1319,東陽,20,3,17,富邦-宜蘭,2023-09-18,9686
2605,新興,41,25,16,富邦-宜蘭,2023-09-18,9686
2025,千興,21,5,16,富邦-宜蘭,2023-09-18,9686
00900,富邦特選高股息30,23,7,16,富邦-宜蘭,2023-09-18,9686
00923,群益台ESG低碳50,15,0,15,富邦-宜蘭,2023-09-18,9686
1522,堤維西,32,17,15,富邦-宜蘭,2023-09-18,9686
2324,仁寶,15,0,15,富邦-宜蘭,2023-09-18,9686
8358,金居,18,3,15,富邦-宜蘭,2023-09-18,9686
2382,廣達,19,5,14,富邦-宜蘭,2023-09-18,9686
00893,國泰智能電動車,14,0,14,富邦-宜蘭,2023-09-18,9686
3260,威剛,17,3,14,富邦-宜蘭,2023-09-18,9686
00888,永豐台灣ESG,14,0,14,富邦-宜蘭,2023-09-18,9686
1471,首利,18,5,13,富邦-宜蘭,2023-09-18,9686
00687B,國泰20年美債,15,2,13,富邦-宜蘭,2023-09-18,9686
2353,宏��,12,0,12,富邦-宜蘭,2023-09-18,9686
00929,復華台灣科技優息,192,69,123,富邦-宜蘭,2023-09-19,9686
1504,東元,129,7,122,富邦-宜蘭,2023-09-19,9686
5475,德宏,70,0,70,富邦-宜蘭,2023-09-19,9686
2313,華通,281,223,58,富邦-宜蘭,2023-09-19,9686
2618,長榮航,57,4,53,富邦-宜蘭,2023-09-19,9686
00877,復華中國5G,50,0,50,富邦-宜蘭,2023-09-19,9686
5498,凱崴,50,4,46,富邦-宜蘭,2023-09-19,9686
3049,精金,45,0,45,富邦-宜蘭,2023-09-19,9686
2206,三陽工業,54,10,44,富邦-宜蘭,2023-09-19,9686
6901,鑽石投資,49,9,40,富邦-宜蘭,2023-09-19,9686
2498,宏達電,40,0,40,富邦-宜蘭,2023-09-19,9686
6789,采鈺,36,0,36,富邦-宜蘭,2023-09-19,9686
00919,群益台灣精選高息,90,55,35,富邦-宜蘭,2023-09-19,9686
2405,輔信,40,5,35,富邦-宜蘭,2023-09-19,9686
2617,台航,34,0,34,富邦-宜蘭,2023-09-19,9686
00665L,富邦�琤肭磪囓�2,33,0,33,富邦-宜蘭,2023-09-19,9686
2610,華航,44,12,32,富邦-宜蘭,2023-09-19,9686
00923,群益台ESG低碳50,32,0,32,富邦-宜蘭,2023-09-19,9686
00902,中信電池及儲能,32,0,32,富邦-宜蘭,2023-09-19,9686
3141,晶宏,32,0,32,富邦-宜蘭,2023-09-19,9686
4944,兆遠,31,0,31,富邦-宜蘭,2023-09-19,9686
2491,吉祥全,30,0,30,富邦-宜蘭,2023-09-19,9686
2332,友訊,28,1,27,富邦-宜蘭,2023-09-19,9686
00921,兆豐龍頭等權重,26,0,26,富邦-宜蘭,2023-09-19,9686
6282,康舒,28,2,26,富邦-宜蘭,2023-09-19,9686
5880,合庫金,25,0,25,富邦-宜蘭,2023-09-19,9686
00878,國泰永續高股息,40,17,23,富邦-宜蘭,2023-09-19,9686
2363,矽統,74,52,22,富邦-宜蘭,2023-09-19,9686
3704,合勤控,22,1,21,富邦-宜蘭,2023-09-19,9686
00772B,中信高評級公司債,26,5,21,富邦-宜蘭,2023-09-19,9686
4977,眾達-KY,22,1,21,富邦-宜蘭,2023-09-19,9686
8086,宏捷科,23,2,21,富邦-宜蘭,2023-09-19,9686
1324,地球,20,0,20,富邦-宜蘭,2023-09-19,9686
6788,華景電,20,0,20,富邦-宜蘭,2023-09-19,9686
2025,千興,20,1,19,富邦-宜蘭,2023-09-19,9686
2887,台新金,20,1,19,富邦-宜蘭,2023-09-19,9686
2330,台積電,19,0,19,富邦-宜蘭,2023-09-19,9686
2367,燿華,60,42,18,富邦-宜蘭,2023-09-19,9686
1609,大亞,19,1,18,富邦-宜蘭,2023-09-19,9686
1809,中釉,27,10,17,富邦-宜蘭,2023-09-19,9686
6274,台燿,56,40,16,富邦-宜蘭,2023-09-19,9686
00918,大華優利高填息30,25,10,15,富邦-宜蘭,2023-09-19,9686
3231,緯創,72,56,16,富邦-宜蘭,2023-09-19,9686
00715L,期街口布蘭特正2,15,0,15,富邦-宜蘭,2023-09-19,9686
2329,華泰,28,13,15,富邦-宜蘭,2023-09-19,9686
2376,技嘉,31,16,15,富邦-宜蘭,2023-09-19,9686
1101,台泥,16,1,15,富邦-宜蘭,2023-09-19,9686
00893,國泰智能電動車,15,0,15,富邦-宜蘭,2023-09-19,9686
4532,瑞智,14,0,14,富邦-宜蘭,2023-09-19,9686
1471,首利,13,0,13,富邦-宜蘭,2023-09-19,9686
00929,復華台灣科技優息,435,84,351,富邦-宜蘭,2023-09-20,9686
00919,群益台灣精選高息,222,92,130,富邦-宜蘭,2023-09-20,9686
5328,華容,101,1,100,富邦-宜蘭,2023-09-20,9686
00673R,期元大S＆P原油反1,75,0,75,富邦-宜蘭,2023-09-20,9686
2897,王道銀行,75,0,75,富邦-宜蘭,2023-09-20,9686
2881,富邦金,67,2,65,富邦-宜蘭,2023-09-20,9686
00923,群益台ESG低碳50,51,0,51,富邦-宜蘭,2023-09-20,9686
2367,燿華,152,101,51,富邦-宜蘭,2023-09-20,9686
2317,鴻海,50,0,50,富邦-宜蘭,2023-09-20,9686
1316,上曜,60,12,48,富邦-宜蘭,2023-09-20,9686
2401,凌陽,49,1,48,富邦-宜蘭,2023-09-20,9686
2882,國泰金,49,3,46,富邦-宜蘭,2023-09-20,9686
00897,富邦基因免疫生技,40,0,40,富邦-宜蘭,2023-09-20,9686
3276,宇環,52,14,38,富邦-宜蘭,2023-09-20,9686
1319,東陽,50,14,36,富邦-宜蘭,2023-09-20,9686
1504,東元,45,13,32,富邦-宜蘭,2023-09-20,9686
00795B,中信美國公債20年,32,0,32,富邦-宜蘭,2023-09-20,9686
3227,原相,31,0,31,富邦-宜蘭,2023-09-20,9686
6901,鑽石投資,55,25,30,富邦-宜蘭,2023-09-20,9686
2883,凱基金,28,0,28,富邦-宜蘭,2023-09-20,9686
3709,鑫聯大投控,29,2,27,富邦-宜蘭,2023-09-20,9686
2303,聯電,25,0,25,富邦-宜蘭,2023-09-20,9686
2324,仁寶,28,3,25,富邦-宜蘭,2023-09-20,9686
00922,國泰台灣領袖50,23,0,23,富邦-宜蘭,2023-09-20,9686
5348,正能量智能,22,0,22,富邦-宜蘭,2023-09-20,9686
00930,永豐ESG低碳高息,21,0,21,富邦-宜蘭,2023-09-20,9686
2610,華航,33,12,21,富邦-宜蘭,2023-09-20,9686
2809,京城銀,22,1,21,富邦-宜蘭,2023-09-20,9686
2330,台積電,21,1,20,富邦-宜蘭,2023-09-20,9686
00722B,群益投資級電信債,20,0,20,富邦-宜蘭,2023-09-20,9686
2618,長榮航,36,17,19,富邦-宜蘭,2023-09-20,9686
1101,台泥,19,0,19,富邦-宜蘭,2023-09-20,9686
2313,華通,108,89,19,富邦-宜蘭,2023-09-20,9686
1459,聯發,19,0,19,富邦-宜蘭,2023-09-20,9686
4979,華星光,36,17,19,富邦-宜蘭,2023-09-20,9686
2905,三商,20,2,18,富邦-宜蘭,2023-09-20,9686
3163,波若威,37,19,18,富邦-宜蘭,2023-09-20,9686
00687B,國泰20年美債,18,0,18,富邦-宜蘭,2023-09-20,9686
1605,華新,34,17,17,富邦-宜蘭,2023-09-20,9686
2409,友達,19,3,16,富邦-宜蘭,2023-09-20,9686
2337,旺宏,18,2,16,富邦-宜蘭,2023-09-20,9686
3706,神達,31,15,16,富邦-宜蘭,2023-09-20,9686
3265,台星科,79,64,15,富邦-宜蘭,2023-09-20,9686
00877,復華中國5G,15,0,15,富邦-宜蘭,2023-09-20,9686
2630,亞航,15,0,15,富邦-宜蘭,2023-09-20,9686
2354,鴻準,93,79,14,富邦-宜蘭,2023-09-20,9686
2606,裕民,32,18,14,富邦-宜蘭,2023-09-20,9686
3715,定穎投控,151,137,14,富邦-宜蘭,2023-09-20,9686
8064,東捷,21,8,13,富邦-宜蘭,2023-09-20,9686
00885,富邦越南,14,1,13,富邦-宜蘭,2023-09-20,9686
00929,復華台灣科技優息,365,95,270,富邦-宜蘭,2023-09-21,9686
1316,上曜,85,0,85,富邦-宜蘭,2023-09-21,9686
1616,億泰,77,0,77,富邦-宜蘭,2023-09-21,9686
1101,台泥,58,0,58,富邦-宜蘭,2023-09-21,9686
5880,合庫金,71,20,51,富邦-宜蘭,2023-09-21,9686
00637L,元大滬深300正2,50,0,50,富邦-宜蘭,2023-09-21,9686
00665L,富邦�琤肭磪囓�2,41,0,41,富邦-宜蘭,2023-09-21,9686
00888,永豐台灣ESG,40,0,40,富邦-宜蘭,2023-09-21,9686
3049,精金,40,1,39,富邦-宜蘭,2023-09-21,9686
00878,國泰永續高股息,63,25,38,富邦-宜蘭,2023-09-21,9686
5009,榮剛,37,0,37,富邦-宜蘭,2023-09-21,9686
0056,元大高股息,41,4,37,富邦-宜蘭,2023-09-21,9686
6169,昱泉,31,0,31,富邦-宜蘭,2023-09-21,9686
9103,美德醫療-DR,29,0,29,富邦-宜蘭,2023-09-21,9686
2887,台新金,30,2,28,富邦-宜蘭,2023-09-21,9686
2002,中鋼,27,0,27,富邦-宜蘭,2023-09-21,9686
2617,台航,27,0,27,富邦-宜蘭,2023-09-21,9686
1809,中釉,50,24,26,富邦-宜蘭,2023-09-21,9686
00932,兆豐永續高息等權,27,1,26,富邦-宜蘭,2023-09-21,9686
2881,富邦金,36,11,25,富邦-宜蘭,2023-09-21,9686
00679B,元大美債20年,30,5,25,富邦-宜蘭,2023-09-21,9686
4746,台耀,37,13,24,富邦-宜蘭,2023-09-21,9686
00753L,中信中國50正2,24,0,24,富邦-宜蘭,2023-09-21,9686
2330,台積電,27,4,23,富邦-宜蘭,2023-09-21,9686
00902,中信電池及儲能,22,0,22,富邦-宜蘭,2023-09-21,9686
2618,長榮航,24,3,21,富邦-宜蘭,2023-09-21,9686
2313,華通,95,75,20,富邦-宜蘭,2023-09-21,9686
6461,益得,20,0,20,富邦-宜蘭,2023-09-21,9686
3607,谷崧,20,0,20,富邦-宜蘭,2023-09-21,9686
00881,國泰台灣5G+,23,4,19,富邦-宜蘭,2023-09-21,9686
2104,國際中橡,20,1,19,富邦-宜蘭,2023-09-21,9686
6191,精成科,19,0,19,富邦-宜蘭,2023-09-21,9686
1609,大亞,18,0,18,富邦-宜蘭,2023-09-21,9686
1584,精剛,38,21,17,富邦-宜蘭,2023-09-21,9686
00680L,元大美債20正2,17,0,17,富邦-宜蘭,2023-09-21,9686
00921,兆豐龍頭等權重,16,0,16,富邦-宜蘭,2023-09-21,9686
2363,矽統,27,11,16,富邦-宜蘭,2023-09-21,9686
2883,凱基金,18,2,16,富邦-宜蘭,2023-09-21,9686
5243,乙盛-KY,16,0,16,富邦-宜蘭,2023-09-21,9686
6168,宏齊,16,0,16,富邦-宜蘭,2023-09-21,9686
00900,富邦特選高股息30,15,0,15,富邦-宜蘭,2023-09-21,9686
3715,定穎投控,89,74,15,富邦-宜蘭,2023-09-21,9686
2885,元大金,16,1,15,富邦-宜蘭,2023-09-21,9686
2892,第一金,15,0,15,富邦-宜蘭,2023-09-21,9686
1802,台玻,15,0,15,富邦-宜蘭,2023-09-21,9686
00751B,元大AAA至A公司債,14,0,14,富邦-宜蘭,2023-09-21,9686
00655L,國泰中國A50正2,14,0,14,富邦-宜蘭,2023-09-21,9686
6443,元晶,14,0,14,富邦-宜蘭,2023-09-21,9686
2409,友達,13,0,13,富邦-宜蘭,2023-09-21,9686
2353,宏��,15,2,13,富邦-宜蘭,2023-09-21,9686
5521,工信,205,5,200,富邦-宜蘭,2023-09-22,9686
00664R,國泰臺灣加權反1,192,0,192,富邦-宜蘭,2023-09-22,9686
00680L,元大美債20正2,129,0,129,富邦-宜蘭,2023-09-22,9686
3373,熱映,92,0,92,富邦-宜蘭,2023-09-22,9686
00679B,元大美債20年,72,1,71,富邦-宜蘭,2023-09-22,9686
2881,富邦金,63,0,63,富邦-宜蘭,2023-09-22,9686
00712,復華富時不動產,69,6,63,富邦-宜蘭,2023-09-22,9686
4906,正文,53,0,53,富邦-宜蘭,2023-09-22,9686
1101,台泥,44,0,44,富邦-宜蘭,2023-09-22,9686
00772B,中信高評級公司債,42,0,42,富邦-宜蘭,2023-09-22,9686
00751B,元大AAA至A公司債,40,0,40,富邦-宜蘭,2023-09-22,9686
2313,華通,61,25,36,富邦-宜蘭,2023-09-22,9686
00885,富邦越南,41,10,31,富邦-宜蘭,2023-09-22,9686
2748,雲品,30,0,30,富邦-宜蘭,2023-09-22,9686
3276,宇環,30,0,30,富邦-宜蘭,2023-09-22,9686
2344,華邦電,31,3,28,富邦-宜蘭,2023-09-22,9686
1504,東元,79,52,27,富邦-宜蘭,2023-09-22,9686
00878,國泰永續高股息,44,18,26,富邦-宜蘭,2023-09-22,9686
00687B,國泰20年美債,24,0,24,富邦-宜蘭,2023-09-22,9686
2905,三商,24,0,24,富邦-宜蘭,2023-09-22,9686
2618,長榮航,35,12,23,富邦-宜蘭,2023-09-22,9686
00902,中信電池及儲能,23,0,23,富邦-宜蘭,2023-09-22,9686
6901,鑽石投資,33,12,21,富邦-宜蘭,2023-09-22,9686
1217,愛之味,21,0,21,富邦-宜蘭,2023-09-22,9686
3481,群創,46,26,20,富邦-宜蘭,2023-09-22,9686
00720B,元大投資級公司債,20,0,20,富邦-宜蘭,2023-09-22,9686
5703,亞都,20,0,20,富邦-宜蘭,2023-09-22,9686
6282,康舒,20,0,20,富邦-宜蘭,2023-09-22,9686
2409,友達,31,12,19,富邦-宜蘭,2023-09-22,9686
00642U,期元大S＆P石油,18,0,18,富邦-宜蘭,2023-09-22,9686
2330,台積電,21,3,18,富邦-宜蘭,2023-09-22,9686
2312,金寶,17,0,17,富邦-宜蘭,2023-09-22,9686
2617,台航,16,0,16,富邦-宜蘭,2023-09-22,9686
1810,和成,15,0,15,富邦-宜蘭,2023-09-22,9686
2890,永豐金,15,1,14,富邦-宜蘭,2023-09-22,9686
00665L,富邦�琤肭磪囓�2,15,1,14,富邦-宜蘭,2023-09-22,9686
1444,力麗,25,12,13,富邦-宜蘭,2023-09-22,9686
6788,華景電,12,0,12,富邦-宜蘭,2023-09-22,9686
00907,永豐優息存股,12,0,12,富邦-宜蘭,2023-09-22,9686
2883,凱基金,16,4,12,富邦-宜蘭,2023-09-22,9686
9907,統一實,12,0,12,富邦-宜蘭,2023-09-22,9686
3037,欣興,14,3,11,富邦-宜蘭,2023-09-22,9686
2891,中信金,13,2,11,富邦-宜蘭,2023-09-22,9686
1324,地球,12,1,11,富邦-宜蘭,2023-09-22,9686
6285,啟��,17,6,11,富邦-宜蘭,2023-09-22,9686
2606,裕民,12,1,11,富邦-宜蘭,2023-09-22,9686
00919,群益台灣精選高息,49,39,10,富邦-宜蘭,2023-09-22,9686
1434,福懋,10,0,10,富邦-宜蘭,2023-09-22,9686
4916,事欣科,10,0,10,富邦-宜蘭,2023-09-22,9686
2702,華園,10,0,10,富邦-宜蘭,2023-09-22,9686
00632R,元大台灣50反1,155,0,155,富邦-宜蘭,2023-09-25,9686
00929,復華台灣科技優息,149,16,133,富邦-宜蘭,2023-09-25,9686
00664R,國泰臺灣加權反1,100,0,100,富邦-宜蘭,2023-09-25,9686
3615,安可,60,4,56,富邦-宜蘭,2023-09-25,9686
3715,定穎投控,130,94,36,富邦-宜蘭,2023-09-25,9686
00687B,國泰20年美債,35,0,35,富邦-宜蘭,2023-09-25,9686
8054,安國,36,1,35,富邦-宜蘭,2023-09-25,9686
00919,群益台灣精選高息,65,32,33,富邦-宜蘭,2023-09-25,9686
1101,台泥,29,1,28,富邦-宜蘭,2023-09-25,9686
3163,波若威,63,36,27,富邦-宜蘭,2023-09-25,9686
2313,華通,58,32,26,富邦-宜蘭,2023-09-25,9686
00712,復華富時不動產,25,1,24,富邦-宜蘭,2023-09-25,9686
0056,元大高股息,28,7,21,富邦-宜蘭,2023-09-25,9686
00764B,群益25年美債,20,0,20,富邦-宜蘭,2023-09-25,9686
3049,精金,20,0,20,富邦-宜蘭,2023-09-25,9686
3058,立德,22,2,20,富邦-宜蘭,2023-09-25,9686
00897,富邦基因免疫生技,20,0,20,富邦-宜蘭,2023-09-25,9686
00696B,富邦美債20年,20,0,20,富邦-宜蘭,2023-09-25,9686
3576,聯合再生,20,1,19,富邦-宜蘭,2023-09-25,9686
3043,科風,20,1,19,富邦-宜蘭,2023-09-25,9686
2206,三陽工業,35,17,18,富邦-宜蘭,2023-09-25,9686
2883,凱基金,18,0,18,富邦-宜蘭,2023-09-25,9686
3078,僑威,22,4,18,富邦-宜蘭,2023-09-25,9686
3450,聯鈞,34,17,17,富邦-宜蘭,2023-09-25,9686
2303,聯電,20,4,16,富邦-宜蘭,2023-09-25,9686
1434,福懋,15,0,15,富邦-宜蘭,2023-09-25,9686
1616,億泰,15,0,15,富邦-宜蘭,2023-09-25,9686
2543,皇昌,19,4,15,富邦-宜蘭,2023-09-25,9686
00679B,元大美債20年,14,0,14,富邦-宜蘭,2023-09-25,9686
4908,前鼎,15,3,12,富邦-宜蘭,2023-09-25,9686
2324,仁寶,16,4,12,富邦-宜蘭,2023-09-25,9686
00680L,元大美債20正2,12,0,12,富邦-宜蘭,2023-09-25,9686
00931B,統一美債20年,12,0,12,富邦-宜蘭,2023-09-25,9686
00655L,國泰中國A50正2,23,11,12,富邦-宜蘭,2023-09-25,9686
3013,晟銘電,16,4,12,富邦-宜蘭,2023-09-25,9686
4566,時碩工業,15,4,11,富邦-宜蘭,2023-09-25,9686
8064,東捷,10,0,10,富邦-宜蘭,2023-09-25,9686
00830,國泰費城半導體,10,0,10,富邦-宜蘭,2023-09-25,9686
1305,華夏,10,0,10,富邦-宜蘭,2023-09-25,9686
6190,萬泰科,10,0,10,富邦-宜蘭,2023-09-25,9686
3149,正達,10,0,10,富邦-宜蘭,2023-09-25,9686
4128,中天,10,0,10,富邦-宜蘭,2023-09-25,9686
4164,承業醫,10,0,10,富邦-宜蘭,2023-09-25,9686
3379,彬台,10,0,10,富邦-宜蘭,2023-09-25,9686
3024,憶聲,10,0,10,富邦-宜蘭,2023-09-25,9686
4933,友輝,10,0,10,富邦-宜蘭,2023-09-25,9686
1452,宏益,10,0,10,富邦-宜蘭,2023-09-25,9686
00900,富邦特選高股息30,20,11,9,富邦-宜蘭,2023-09-25,9686
2355,敬鵬,17,8,9,富邦-宜蘭,2023-09-25,9686
00902,中信電池及儲能,8,0,8,富邦-宜蘭,2023-09-25,9686
00664R,國泰臺灣加權反1,150,0,150,富邦-宜蘭,2023-09-26,9686
00929,復華台灣科技優息,133,31,102,富邦-宜蘭,2023-09-26,9686
00676R,富邦臺灣加權反1,150,50,100,富邦-宜蘭,2023-09-26,9686
00919,群益台灣精選高息,146,63,83,富邦-宜蘭,2023-09-26,9686
2399,映泰,70,2,68,富邦-宜蘭,2023-09-26,9686
00680L,元大美債20正2,73,9,64,富邦-宜蘭,2023-09-26,9686
4566,時碩工業,60,2,58,富邦-宜蘭,2023-09-26,9686
2543,皇昌,60,3,57,富邦-宜蘭,2023-09-26,9686
00923,群益台ESG低碳50,59,2,57,富邦-宜蘭,2023-09-26,9686
2344,華邦電,52,0,52,富邦-宜蘭,2023-09-26,9686
1522,堤維西,103,54,49,富邦-宜蘭,2023-09-26,9686
00637L,元大滬深300正2,50,6,44,富邦-宜蘭,2023-09-26,9686
00751B,元大AAA至A公司債,35,0,35,富邦-宜蘭,2023-09-26,9686
00897,富邦基因免疫生技,30,0,30,富邦-宜蘭,2023-09-26,9686
5009,榮剛,31,1,30,富邦-宜蘭,2023-09-26,9686
2317,鴻海,44,16,28,富邦-宜蘭,2023-09-26,9686
2881,富邦金,26,0,26,富邦-宜蘭,2023-09-26,9686
2303,聯電,27,1,26,富邦-宜蘭,2023-09-26,9686
2408,南亞科,26,1,25,富邦-宜蘭,2023-09-26,9686
3049,精金,25,0,25,富邦-宜蘭,2023-09-26,9686
2002,中鋼,26,2,24,富邦-宜蘭,2023-09-26,9686
5880,合庫金,23,1,22,富邦-宜蘭,2023-09-26,9686
00687B,國泰20年美債,21,0,21,富邦-宜蘭,2023-09-26,9686
00679B,元大美債20年,23,2,21,富邦-宜蘭,2023-09-26,9686
2890,永豐金,22,1,21,富邦-宜蘭,2023-09-26,9686
8054,安國,21,0,21,富邦-宜蘭,2023-09-26,9686
2201,裕隆,21,0,21,富邦-宜蘭,2023-09-26,9686
3481,群創,34,14,20,富邦-宜蘭,2023-09-26,9686
2402,毅嘉,21,2,19,富邦-宜蘭,2023-09-26,9686
00885,富邦越南,26,7,19,富邦-宜蘭,2023-09-26,9686
2337,旺宏,18,0,18,富邦-宜蘭,2023-09-26,9686
00878,國泰永續高股息,19,2,17,富邦-宜蘭,2023-09-26,9686
6901,鑽石投資,27,11,16,富邦-宜蘭,2023-09-26,9686
2231,為升,16,0,16,富邦-宜蘭,2023-09-26,9686
1101,台泥,15,0,15,富邦-宜蘭,2023-09-26,9686
00753L,中信中國50正2,15,0,15,富邦-宜蘭,2023-09-26,9686
3081,聯亞,17,2,15,富邦-宜蘭,2023-09-26,9686
2017,官田鋼,15,0,15,富邦-宜蘭,2023-09-26,9686
00907,永豐優息存股,15,0,15,富邦-宜蘭,2023-09-26,9686
00655L,國泰中國A50正2,17,2,15,富邦-宜蘭,2023-09-26,9686
1304,台聚,15,0,15,富邦-宜蘭,2023-09-26,9686
3231,緯創,27,12,15,富邦-宜蘭,2023-09-26,9686
8064,東捷,20,6,14,富邦-宜蘭,2023-09-26,9686
4102,永日,14,0,14,富邦-宜蘭,2023-09-26,9686
1301,台塑,13,0,13,富邦-宜蘭,2023-09-26,9686
00795B,中信美國公債20年,13,0,13,富邦-宜蘭,2023-09-26,9686
3078,僑威,15,2,13,富邦-宜蘭,2023-09-26,9686
0056,元大高股息,15,2,13,富邦-宜蘭,2023-09-26,9686
2330,台積電,18,6,12,富邦-宜蘭,2023-09-26,9686
1319,東陽,26,14,12,富邦-宜蘭,2023-09-26,9686
2883,凱基金,104,2,102,富邦-宜蘭,2023-09-27,9686
2002,中鋼,84,21,63,富邦-宜蘭,2023-09-27,9686
00720B,元大投資級公司債,52,0,52,富邦-宜蘭,2023-09-27,9686
1301,台塑,48,0,48,富邦-宜蘭,2023-09-27,9686
3715,定穎投控,161,113,48,富邦-宜蘭,2023-09-27,9686
00712,復華富時不動產,41,8,33,富邦-宜蘭,2023-09-27,9686
1802,台玻,31,0,31,富邦-宜蘭,2023-09-27,9686
6788,華景電,25,0,25,富邦-宜蘭,2023-09-27,9686
1434,福懋,24,0,24,富邦-宜蘭,2023-09-27,9686
00919,群益台灣精選高息,41,18,23,富邦-宜蘭,2023-09-27,9686
3037,欣興,27,4,23,富邦-宜蘭,2023-09-27,9686
3122,笙泉,36,14,22,富邦-宜蘭,2023-09-27,9686
2739,寒舍,22,0,22,富邦-宜蘭,2023-09-27,9686
2634,漢翔,22,0,22,富邦-宜蘭,2023-09-27,9686
2303,聯電,21,0,21,富邦-宜蘭,2023-09-27,9686
2337,旺宏,22,2,20,富邦-宜蘭,2023-09-27,9686
2614,東森,20,0,20,富邦-宜蘭,2023-09-27,9686
9945,潤泰新,22,2,20,富邦-宜蘭,2023-09-27,9686
6579,研揚,19,0,19,富邦-宜蘭,2023-09-27,9686
6188,廣明,16,0,16,富邦-宜蘭,2023-09-27,9686
3481,群創,17,3,14,富邦-宜蘭,2023-09-27,9686
4908,前鼎,19,5,14,富邦-宜蘭,2023-09-27,9686
3078,僑威,16,2,14,富邦-宜蘭,2023-09-27,9686
8420,明揚,31,17,14,富邦-宜蘭,2023-09-27,9686
00751B,元大AAA至A公司債,13,0,13,富邦-宜蘭,2023-09-27,9686
00907,永豐優息存股,13,0,13,富邦-宜蘭,2023-09-27,9686
00679B,元大美債20年,16,3,13,富邦-宜蘭,2023-09-27,9686
2317,鴻海,14,1,13,富邦-宜蘭,2023-09-27,9686
3709,鑫聯大投控,12,0,12,富邦-宜蘭,2023-09-27,9686
1101,台泥,12,1,11,富邦-宜蘭,2023-09-27,9686
2888,新光金,11,0,11,富邦-宜蘭,2023-09-27,9686
00655L,國泰中國A50正2,11,0,11,富邦-宜蘭,2023-09-27,9686
00902,中信電池及儲能,11,0,11,富邦-宜蘭,2023-09-27,9686
00900,富邦特選高股息30,18,7,11,富邦-宜蘭,2023-09-27,9686
2313,華通,35,25,10,富邦-宜蘭,2023-09-27,9686
2014,中鴻,10,0,10,富邦-宜蘭,2023-09-27,9686
00922,國泰台灣領袖50,10,0,10,富邦-宜蘭,2023-09-27,9686
1618,合機,14,4,10,富邦-宜蘭,2023-09-27,9686
2511,太子,10,0,10,富邦-宜蘭,2023-09-27,9686
3149,正達,10,0,10,富邦-宜蘭,2023-09-27,9686
2329,華泰,17,7,10,富邦-宜蘭,2023-09-27,9686
2891,中信金,9,0,9,富邦-宜蘭,2023-09-27,9686
6488,環球晶,10,1,9,富邦-宜蘭,2023-09-27,9686
1612,宏泰,12,3,9,富邦-宜蘭,2023-09-27,9686
8054,安國,12,3,9,富邦-宜蘭,2023-09-27,9686
1815,富喬,35,27,8,富邦-宜蘭,2023-09-27,9686
1326,台化,8,0,8,富邦-宜蘭,2023-09-27,9686
2615,萬海,9,1,8,富邦-宜蘭,2023-09-27,9686
2355,敬鵬,8,0,8,富邦-宜蘭,2023-09-27,9686
2906,高林,8,0,8,富邦-宜蘭,2023-09-27,9686
2888,新光金,125,10,115,富邦-宜蘭,2023-09-28,9686
2002,中鋼,119,34,85,富邦-宜蘭,2023-09-28,9686
00712,復華富時不動產,83,10,73,富邦-宜蘭,2023-09-28,9686
2634,漢翔,76,6,70,富邦-宜蘭,2023-09-28,9686
00679B,元大美債20年,64,2,62,富邦-宜蘭,2023-09-28,9686
00673R,期元大S＆P原油反1,60,0,60,富邦-宜蘭,2023-09-28,9686
00929,復華台灣科技優息,70,10,60,富邦-宜蘭,2023-09-28,9686
3231,緯創,103,50,53,富邦-宜蘭,2023-09-28,9686
3576,聯合再生,51,0,51,富邦-宜蘭,2023-09-28,9686
2408,南亞科,48,4,44,富邦-宜蘭,2023-09-28,9686
00772B,中信高評級公司債,40,0,40,富邦-宜蘭,2023-09-28,9686
3715,定穎投控,221,183,38,富邦-宜蘭,2023-09-28,9686
6125,廣運,62,27,35,富邦-宜蘭,2023-09-28,9686
2344,華邦電,35,1,34,富邦-宜蘭,2023-09-28,9686
00632R,元大台灣50反1,30,0,30,富邦-宜蘭,2023-09-28,9686
2313,華通,44,15,29,富邦-宜蘭,2023-09-28,9686
00919,群益台灣精選高息,52,24,28,富邦-宜蘭,2023-09-28,9686
5452,佶優,33,7,26,富邦-宜蘭,2023-09-28,9686
2208,台船,21,0,21,富邦-宜蘭,2023-09-28,9686
2201,裕隆,26,6,20,富邦-宜蘭,2023-09-28,9686
6461,益得,20,0,20,富邦-宜蘭,2023-09-28,9686
2609,陽明,22,3,19,富邦-宜蘭,2023-09-28,9686
2880,華南金,18,1,17,富邦-宜蘭,2023-09-28,9686
1584,精剛,62,45,17,富邦-宜蘭,2023-09-28,9686
00687B,國泰20年美債,16,0,16,富邦-宜蘭,2023-09-28,9686
00669R,國泰美國道瓊反1,20,5,15,富邦-宜蘭,2023-09-28,9686
3481,群創,33,18,15,富邦-宜蘭,2023-09-28,9686
2324,仁寶,17,3,14,富邦-宜蘭,2023-09-28,9686
00907,永豐優息存股,14,0,14,富邦-宜蘭,2023-09-28,9686
5347,世界,14,0,14,富邦-宜蘭,2023-09-28,9686
00680L,元大美債20正2,13,0,13,富邦-宜蘭,2023-09-28,9686
5457,宣德,20,7,13,富邦-宜蘭,2023-09-28,9686
1101,台泥,13,1,12,富邦-宜蘭,2023-09-28,9686
00882,中信中國高股息,12,0,12,富邦-宜蘭,2023-09-28,9686
2392,正崴,12,0,12,富邦-宜蘭,2023-09-28,9686
3706,神達,21,9,12,富邦-宜蘭,2023-09-28,9686
4908,前鼎,16,5,11,富邦-宜蘭,2023-09-28,9686
3260,威剛,14,4,10,富邦-宜蘭,2023-09-28,9686
2356,英業達,15,5,10,富邦-宜蘭,2023-09-28,9686
1102,亞泥,10,0,10,富邦-宜蘭,2023-09-28,9686
2630,亞航,10,0,10,富邦-宜蘭,2023-09-28,9686
2468,華經,26,16,10,富邦-宜蘭,2023-09-28,9686
2641,正德,10,0,10,富邦-宜蘭,2023-09-28,9686
1810,和成,10,0,10,富邦-宜蘭,2023-09-28,9686
8054,安國,10,0,10,富邦-宜蘭,2023-09-28,9686
00720B,元大投資級公司債,11,2,9,富邦-宜蘭,2023-09-28,9686
6770,力積電,9,0,9,富邦-宜蘭,2023-09-28,9686
6488,環球晶,9,0,9,富邦-宜蘭,2023-09-28,9686
2891,中信金,10,1,9,富邦-宜蘭,2023-09-28,9686
00637L,元大滬深300正2,25,16,9,富邦-宜蘭,2023-09-28,9686
00632R,元大台灣50反1,352,31,321,富邦-宜蘭,2023-10-02,9686
00664R,國泰臺灣加權反1,308,0,308,富邦-宜蘭,2023-10-02,9686
2888,新光金,104,2,102,富邦-宜蘭,2023-10-02,9686
00929,復華台灣科技優息,102,29,73,富邦-宜蘭,2023-10-02,9686
2363,矽統,98,32,66,富邦-宜蘭,2023-10-02,9686
6248,沛波,65,0,65,富邦-宜蘭,2023-10-02,9686
2002,中鋼,68,3,65,富邦-宜蘭,2023-10-02,9686
2324,仁寶,58,12,46,富邦-宜蘭,2023-10-02,9686
00893,國泰智能電動車,42,0,42,富邦-宜蘭,2023-10-02,9686
00897,富邦基因免疫生技,40,0,40,富邦-宜蘭,2023-10-02,9686
00679B,元大美債20年,36,1,35,富邦-宜蘭,2023-10-02,9686
2409,友達,35,1,34,富邦-宜蘭,2023-10-02,9686
00712,復華富時不動產,32,1,31,富邦-宜蘭,2023-10-02,9686
2025,千興,30,0,30,富邦-宜蘭,2023-10-02,9686
2480,敦陽科,29,0,29,富邦-宜蘭,2023-10-02,9686
3325,旭品,38,9,29,富邦-宜蘭,2023-10-02,9686
2617,台航,26,0,26,富邦-宜蘭,2023-10-02,9686
00665L,富邦�琤肭磪囓�2,29,4,25,富邦-宜蘭,2023-10-02,9686
8930,青鋼,25,0,25,富邦-宜蘭,2023-10-02,9686
1609,大亞,35,11,24,富邦-宜蘭,2023-10-02,9686
2402,毅嘉,46,23,23,富邦-宜蘭,2023-10-02,9686
2609,陽明,23,1,22,富邦-宜蘭,2023-10-02,9686
1517,利奇,25,5,20,富邦-宜蘭,2023-10-02,9686
2881,富邦金,18,0,18,富邦-宜蘭,2023-10-02,9686
00931B,統一美債20年,21,3,18,富邦-宜蘭,2023-10-02,9686
00722B,群益投資級電信債,15,0,15,富邦-宜蘭,2023-10-02,9686
2834,臺企銀,16,1,15,富邦-宜蘭,2023-10-02,9686
6285,啟��,19,4,15,富邦-宜蘭,2023-10-02,9686
00706L,期元大S＆P日圓正2,15,0,15,富邦-宜蘭,2023-10-02,9686
1905,華紙,15,0,15,富邦-宜蘭,2023-10-02,9686
2511,太子,15,0,15,富邦-宜蘭,2023-10-02,9686
2313,華通,38,23,15,富邦-宜蘭,2023-10-02,9686
2634,漢翔,14,0,14,富邦-宜蘭,2023-10-02,9686
00687B,國泰20年美債,14,0,14,富邦-宜蘭,2023-10-02,9686
3481,群創,25,12,13,富邦-宜蘭,2023-10-02,9686
2457,飛宏,19,6,13,富邦-宜蘭,2023-10-02,9686
00680L,元大美債20正2,13,0,13,富邦-宜蘭,2023-10-02,9686
3707,漢磊,13,0,13,富邦-宜蘭,2023-10-02,9686
2606,裕民,14,1,13,富邦-宜蘭,2023-10-02,9686
6605,帝寶,12,0,12,富邦-宜蘭,2023-10-02,9686
2367,燿華,39,28,11,富邦-宜蘭,2023-10-02,9686
2405,輔信,14,3,11,富邦-宜蘭,2023-10-02,9686
00907,永豐優息存股,12,1,11,富邦-宜蘭,2023-10-02,9686
3163,波若威,28,17,11,富邦-宜蘭,2023-10-02,9686
1519,華城,12,2,10,富邦-宜蘭,2023-10-02,9686
1305,華夏,10,0,10,富邦-宜蘭,2023-10-02,9686
4944,兆遠,12,2,10,富邦-宜蘭,2023-10-02,9686
00725B,國泰投資級公司債,10,0,10,富邦-宜蘭,2023-10-02,9686
5432,新門,12,2,10,富邦-宜蘭,2023-10-02,9686
1102,亞泥,10,0,10,富邦-宜蘭,2023-10-02,9686
00712,復華富時不動產,211,10,201,富邦-宜蘭,2023-10-03,9686
2002,中鋼,125,20,105,富邦-宜蘭,2023-10-03,9686
2409,友達,154,49,105,富邦-宜蘭,2023-10-03,9686
3481,群創,157,54,103,富邦-宜蘭,2023-10-03,9686
0056,元大高股息,102,3,99,富邦-宜蘭,2023-10-03,9686
3231,緯創,128,37,91,富邦-宜蘭,2023-10-03,9686
00929,復華台灣科技優息,175,87,88,富邦-宜蘭,2023-10-03,9686
2816,旺旺保,88,5,83,富邦-宜蘭,2023-10-03,9686
00922,國泰台灣領袖50,51,1,50,富邦-宜蘭,2023-10-03,9686
5426,振發,50,1,49,富邦-宜蘭,2023-10-03,9686
00665L,富邦�琤肭磪囓�2,45,0,45,富邦-宜蘭,2023-10-03,9686
00655L,國泰中國A50正2,47,2,45,富邦-宜蘭,2023-10-03,9686
3060,銘異,40,0,40,富邦-宜蘭,2023-10-03,9686
00764B,群益25年美債,40,0,40,富邦-宜蘭,2023-10-03,9686
1319,東陽,43,5,38,富邦-宜蘭,2023-10-03,9686
00753L,中信中國50正2,35,0,35,富邦-宜蘭,2023-10-03,9686
2324,仁寶,74,39,35,富邦-宜蘭,2023-10-03,9686
2104,國際中橡,35,0,35,富邦-宜蘭,2023-10-03,9686
2356,英業達,44,10,34,富邦-宜蘭,2023-10-03,9686
00882,中信中國高股息,29,0,29,富邦-宜蘭,2023-10-03,9686
00637L,元大滬深300正2,29,0,29,富邦-宜蘭,2023-10-03,9686
00650L,復華香港正2,26,0,26,富邦-宜蘭,2023-10-03,9686
00720B,元大投資級公司債,26,0,26,富邦-宜蘭,2023-10-03,9686
2399,映泰,25,0,25,富邦-宜蘭,2023-10-03,9686
2882,國泰金,27,4,23,富邦-宜蘭,2023-10-03,9686
2201,裕隆,23,1,22,富邦-宜蘭,2023-10-03,9686
3036,文曄,42,20,22,富邦-宜蘭,2023-10-03,9686
00773B,中信優先金融債,21,0,21,富邦-宜蘭,2023-10-03,9686
2891,中信金,21,0,21,富邦-宜蘭,2023-10-03,9686
00907,永豐優息存股,21,0,21,富邦-宜蘭,2023-10-03,9686
2618,長榮航,37,17,20,富邦-宜蘭,2023-10-03,9686
00772B,中信高評級公司債,20,0,20,富邦-宜蘭,2023-10-03,9686
2913,農林,21,1,20,富邦-宜蘭,2023-10-03,9686
2890,永豐金,19,0,19,富邦-宜蘭,2023-10-03,9686
3707,漢磊,23,4,19,富邦-宜蘭,2023-10-03,9686
2382,廣達,29,12,17,富邦-宜蘭,2023-10-03,9686
00885,富邦越南,18,1,17,富邦-宜蘭,2023-10-03,9686
3163,波若威,89,72,17,富邦-宜蘭,2023-10-03,9686
2014,中鴻,22,6,16,富邦-宜蘭,2023-10-03,9686
2615,萬海,15,0,15,富邦-宜蘭,2023-10-03,9686
1434,福懋,15,0,15,富邦-宜蘭,2023-10-03,9686
3715,定穎投控,112,97,15,富邦-宜蘭,2023-10-03,9686
3706,神達,56,41,15,富邦-宜蘭,2023-10-03,9686
2206,三陽工業,14,0,14,富邦-宜蘭,2023-10-03,9686
5425,台半,15,1,14,富邦-宜蘭,2023-10-03,9686
2603,長榮,18,4,14,富邦-宜蘭,2023-10-03,9686
8068,全達,13,0,13,富邦-宜蘭,2023-10-03,9686
1514,亞力,22,9,13,富邦-宜蘭,2023-10-03,9686
4102,永日,14,1,13,富邦-宜蘭,2023-10-03,9686
1471,首利,14,2,12,富邦-宜蘭,2023-10-03,9686
2834,臺企銀,230,0,230,富邦-宜蘭,2023-10-04,9686
6770,力積電,210,0,210,富邦-宜蘭,2023-10-04,9686
00632R,元大台灣50反1,215,10,205,富邦-宜蘭,2023-10-04,9686
00679B,元大美債20年,139,0,139,富邦-宜蘭,2023-10-04,9686
2883,凱基金,129,0,129,富邦-宜蘭,2023-10-04,9686
2002,中鋼,137,12,125,富邦-宜蘭,2023-10-04,9686
00712,復華富時不動產,105,0,105,富邦-宜蘭,2023-10-04,9686
00929,復華台灣科技優息,105,15,90,富邦-宜蘭,2023-10-04,9686
3481,群創,95,13,82,富邦-宜蘭,2023-10-04,9686
00680L,元大美債20正2,73,0,73,富邦-宜蘭,2023-10-04,9686
2303,聯電,69,0,69,富邦-宜蘭,2023-10-04,9686
00720B,元大投資級公司債,69,4,65,富邦-宜蘭,2023-10-04,9686
00637L,元大滬深300正2,57,0,57,富邦-宜蘭,2023-10-04,9686
00665L,富邦�琤肭磪囓�2,52,0,52,富邦-宜蘭,2023-10-04,9686
1714,和桐,50,0,50,富邦-宜蘭,2023-10-04,9686
1584,精剛,52,3,49,富邦-宜蘭,2023-10-04,9686
2014,中鴻,48,0,48,富邦-宜蘭,2023-10-04,9686
2887,台新金,43,0,43,富邦-宜蘭,2023-10-04,9686
2891,中信金,42,1,41,富邦-宜蘭,2023-10-04,9686
6112,邁達特,40,0,40,富邦-宜蘭,2023-10-04,9686
00772B,中信高評級公司債,39,0,39,富邦-宜蘭,2023-10-04,9686
00922,國泰台灣領袖50,37,0,37,富邦-宜蘭,2023-10-04,9686
1326,台化,35,0,35,富邦-宜蘭,2023-10-04,9686
3231,緯創,68,33,35,富邦-宜蘭,2023-10-04,9686
2882,國泰金,32,0,32,富邦-宜蘭,2023-10-04,9686
5272,笙科,31,0,31,富邦-宜蘭,2023-10-04,9686
3234,光環,47,16,31,富邦-宜蘭,2023-10-04,9686
5880,合庫金,31,0,31,富邦-宜蘭,2023-10-04,9686
1605,華新,40,10,30,富邦-宜蘭,2023-10-04,9686
00753L,中信中國50正2,34,4,30,富邦-宜蘭,2023-10-04,9686
2409,友達,37,7,30,富邦-宜蘭,2023-10-04,9686
2892,第一金,31,2,29,富邦-宜蘭,2023-10-04,9686
2618,長榮航,32,4,28,富邦-宜蘭,2023-10-04,9686
1434,福懋,28,0,28,富邦-宜蘭,2023-10-04,9686
00751B,元大AAA至A公司債,27,2,25,富邦-宜蘭,2023-10-04,9686
2884,玉山金,26,1,25,富邦-宜蘭,2023-10-04,9686
2104,國際中橡,25,0,25,富邦-宜蘭,2023-10-04,9686
6788,華景電,24,0,24,富邦-宜蘭,2023-10-04,9686
1603,華電,23,0,23,富邦-宜蘭,2023-10-04,9686
2317,鴻海,27,5,22,富邦-宜蘭,2023-10-04,9686
1301,台塑,22,0,22,富邦-宜蘭,2023-10-04,9686
2419,仲琦,21,0,21,富邦-宜蘭,2023-10-04,9686
6461,益得,20,0,20,富邦-宜蘭,2023-10-04,9686
1806,冠軍,20,0,20,富邦-宜蘭,2023-10-04,9686
2353,宏��,20,0,20,富邦-宜蘭,2023-10-04,9686
00850,元大臺灣ESG永續,20,0,20,富邦-宜蘭,2023-10-04,9686
3260,威剛,165,145,20,富邦-宜蘭,2023-10-04,9686
2337,旺宏,25,6,19,富邦-宜蘭,2023-10-04,9686
2388,威盛,52,33,19,富邦-宜蘭,2023-10-04,9686
6235,華孚,29,11,18,富邦-宜蘭,2023-10-04,9686
00676R,富邦臺灣加權反1,200,0,200,富邦-宜蘭,2023-10-05,9686
00712,復華富時不動產,128,1,127,富邦-宜蘭,2023-10-05,9686
3036,文曄,120,35,85,富邦-宜蘭,2023-10-05,9686
6770,力積電,66,10,56,富邦-宜蘭,2023-10-05,9686
2002,中鋼,58,4,54,富邦-宜蘭,2023-10-05,9686
00897,富邦基因免疫生技,40,0,40,富邦-宜蘭,2023-10-05,9686
3094,聯傑,40,0,40,富邦-宜蘭,2023-10-05,9686
3715,定穎投控,186,149,37,富邦-宜蘭,2023-10-05,9686
00751B,元大AAA至A公司債,33,0,33,富邦-宜蘭,2023-10-05,9686
2883,凱基金,32,2,30,富邦-宜蘭,2023-10-05,9686
2331,精英,30,0,30,富邦-宜蘭,2023-10-05,9686
2358,廷鑫,28,3,25,富邦-宜蘭,2023-10-05,9686
00842B,台新美元銀行債,23,0,23,富邦-宜蘭,2023-10-05,9686
00857B,永豐20年美公債,44,22,22,富邦-宜蘭,2023-10-05,9686
00715L,期街口布蘭特正2,28,7,21,富邦-宜蘭,2023-10-05,9686
2104,國際中橡,21,0,21,富邦-宜蘭,2023-10-05,9686
1313,聯成,20,0,20,富邦-宜蘭,2023-10-05,9686
00725B,國泰投資級公司債,20,0,20,富邦-宜蘭,2023-10-05,9686
1603,華電,42,24,18,富邦-宜蘭,2023-10-05,9686
2014,中鴻,18,0,18,富邦-宜蘭,2023-10-05,9686
00929,復華台灣科技優息,78,61,17,富邦-宜蘭,2023-10-05,9686
6274,台燿,52,36,16,富邦-宜蘭,2023-10-05,9686
3260,威剛,24,8,16,富邦-宜蘭,2023-10-05,9686
1524,耿鼎,17,1,16,富邦-宜蘭,2023-10-05,9686
3105,穩懋,15,0,15,富邦-宜蘭,2023-10-05,9686
3081,聯亞,17,2,15,富邦-宜蘭,2023-10-05,9686
1101,台泥,14,0,14,富邦-宜蘭,2023-10-05,9686
00679B,元大美債20年,14,0,14,富邦-宜蘭,2023-10-05,9686
6605,帝寶,14,0,14,富邦-宜蘭,2023-10-05,9686
1584,精剛,18,4,14,富邦-宜蘭,2023-10-05,9686
2417,圓剛,31,18,13,富邦-宜蘭,2023-10-05,9686
2618,長榮航,112,99,13,富邦-宜蘭,2023-10-05,9686
9946,三發地產,13,0,13,富邦-宜蘭,2023-10-05,9686
0056,元大高股息,19,6,13,富邦-宜蘭,2023-10-05,9686
00720B,元大投資級公司債,13,1,12,富邦-宜蘭,2023-10-05,9686
3013,晟銘電,28,17,11,富邦-宜蘭,2023-10-05,9686
2906,高林,11,0,11,富邦-宜蘭,2023-10-05,9686
6122,擎邦,19,8,11,富邦-宜蘭,2023-10-05,9686
2891,中信金,23,13,10,富邦-宜蘭,2023-10-05,9686
6451,訊芯-KY,42,32,10,富邦-宜蘭,2023-10-05,9686
3037,欣興,24,14,10,富邦-宜蘭,2023-10-05,9686
00931B,統一美債20年,10,0,10,富邦-宜蘭,2023-10-05,9686
6290,良維,11,1,10,富邦-宜蘭,2023-10-05,9686
910861,神州-DR,10,0,10,富邦-宜蘭,2023-10-05,9686
6405,悅城,10,0,10,富邦-宜蘭,2023-10-05,9686
3363,上詮,44,35,9,富邦-宜蘭,2023-10-05,9686
2392,正崴,9,0,9,富邦-宜蘭,2023-10-05,9686
8930,青鋼,13,4,9,富邦-宜蘭,2023-10-05,9686
2538,基泰,43,34,9,富邦-宜蘭,2023-10-05,9686
2801,彰銀,8,0,8,富邦-宜蘭,2023-10-05,9686
00929,復華台灣科技優息,160,28,132,富邦-宜蘭,2023-10-06,9686
00751B,元大AAA至A公司債,106,0,106,富邦-宜蘭,2023-10-06,9686
9105,泰金寶-DR,91,0,91,富邦-宜蘭,2023-10-06,9686
00676R,富邦臺灣加權反1,80,0,80,富邦-宜蘭,2023-10-06,9686
1324,地球,77,15,62,富邦-宜蘭,2023-10-06,9686
00919,群益台灣精選高息,59,0,59,富邦-宜蘭,2023-10-06,9686
0056,元大高股息,57,2,55,富邦-宜蘭,2023-10-06,9686
6148,驊宏資,41,0,41,富邦-宜蘭,2023-10-06,9686
00740B,富邦全球投等債,38,0,38,富邦-宜蘭,2023-10-06,9686
00862B,中信投資級公司債,38,0,38,富邦-宜蘭,2023-10-06,9686
3049,精金,32,0,32,富邦-宜蘭,2023-10-06,9686
3078,僑威,33,1,32,富邦-宜蘭,2023-10-06,9686
1319,東陽,53,26,27,富邦-宜蘭,2023-10-06,9686
2313,華通,27,2,25,富邦-宜蘭,2023-10-06,9686
6191,精成科,27,2,25,富邦-宜蘭,2023-10-06,9686
2486,一詮,32,8,24,富邦-宜蘭,2023-10-06,9686
3481,群創,33,9,24,富邦-宜蘭,2023-10-06,9686
00772B,中信高評級公司債,23,0,23,富邦-宜蘭,2023-10-06,9686
2442,新美齊,30,7,23,富邦-宜蘭,2023-10-06,9686
00679B,元大美債20年,23,0,23,富邦-宜蘭,2023-10-06,9686
5880,合庫金,21,0,21,富邦-宜蘭,2023-10-06,9686
3094,聯傑,20,0,20,富邦-宜蘭,2023-10-06,9686
3163,波若威,28,8,20,富邦-宜蘭,2023-10-06,9686
2358,廷鑫,18,1,17,富邦-宜蘭,2023-10-06,9686
00795B,中信美國公債20年,17,0,17,富邦-宜蘭,2023-10-06,9686
4714,永捷,18,2,16,富邦-宜蘭,2023-10-06,9686
8255,朋程,16,0,16,富邦-宜蘭,2023-10-06,9686
2816,旺旺保,24,8,16,富邦-宜蘭,2023-10-06,9686
00902,中信電池及儲能,15,0,15,富邦-宜蘭,2023-10-06,9686
00888,永豐台灣ESG,14,0,14,富邦-宜蘭,2023-10-06,9686
6111,大宇資,14,0,14,富邦-宜蘭,2023-10-06,9686
3037,欣興,35,22,13,富邦-宜蘭,2023-10-06,9686
4927,泰鼎-KY,14,1,13,富邦-宜蘭,2023-10-06,9686
00642U,期元大S＆P石油,12,0,12,富邦-宜蘭,2023-10-06,9686
2618,長榮航,18,6,12,富邦-宜蘭,2023-10-06,9686
5351,鈺創,18,6,12,富邦-宜蘭,2023-10-06,9686
3308,聯德,13,2,11,富邦-宜蘭,2023-10-06,9686
00730,富邦臺灣優質高息,11,0,11,富邦-宜蘭,2023-10-06,9686
00922,國泰台灣領袖50,11,0,11,富邦-宜蘭,2023-10-06,9686
2609,陽明,14,4,10,富邦-宜蘭,2023-10-06,9686
6589,台康生技,10,0,10,富邦-宜蘭,2023-10-06,9686
2332,友訊,10,0,10,富邦-宜蘭,2023-10-06,9686
6861,睿生光電,10,0,10,富邦-宜蘭,2023-10-06,9686
5014,建錩,10,0,10,富邦-宜蘭,2023-10-06,9686
8050,廣積,11,1,10,富邦-宜蘭,2023-10-06,9686
6125,廣運,12,2,10,富邦-宜蘭,2023-10-06,9686
00680L,元大美債20正2,10,0,10,富邦-宜蘭,2023-10-06,9686
2417,圓剛,15,5,10,富邦-宜蘭,2023-10-06,9686
3450,聯鈞,15,6,9,富邦-宜蘭,2023-10-06,9686
8093,保銳,8,0,8,富邦-宜蘭,2023-10-06,9686
00857B,永豐20年美公債,198,0,198,富邦-宜蘭,2023-10-11,9686
3231,緯創,189,27,162,富邦-宜蘭,2023-10-11,9686
1504,東元,157,1,156,富邦-宜蘭,2023-10-11,9686
2883,凱基金,154,17,137,富邦-宜蘭,2023-10-11,9686
00637L,元大滬深300正2,110,0,110,富邦-宜蘭,2023-10-11,9686
00850,元大臺灣ESG永續,79,0,79,富邦-宜蘭,2023-10-11,9686
2356,英業達,71,3,68,富邦-宜蘭,2023-10-11,9686
00712,復華富時不動產,67,9,58,富邦-宜蘭,2023-10-11,9686
8034,榮群,54,1,53,富邦-宜蘭,2023-10-11,9686
6788,華景電,51,1,50,富邦-宜蘭,2023-10-11,9686
8054,安國,45,0,45,富邦-宜蘭,2023-10-11,9686
6443,元晶,43,0,43,富邦-宜蘭,2023-10-11,9686
1605,華新,39,2,37,富邦-宜蘭,2023-10-11,9686
5347,世界,30,0,30,富邦-宜蘭,2023-10-11,9686
3049,精金,40,10,30,富邦-宜蘭,2023-10-11,9686
3706,神達,35,5,30,富邦-宜蘭,2023-10-11,9686
4953,緯軟,35,6,29,富邦-宜蘭,2023-10-11,9686
2812,台中銀,35,6,29,富邦-宜蘭,2023-10-11,9686
4164,承業醫,26,0,26,富邦-宜蘭,2023-10-11,9686
00929,復華台灣科技優息,48,22,26,富邦-宜蘭,2023-10-11,9686
8049,晶采,25,0,25,富邦-宜蘭,2023-10-11,9686
8033,雷虎,28,4,24,富邦-宜蘭,2023-10-11,9686
2002,中鋼,26,2,24,富邦-宜蘭,2023-10-11,9686
8358,金居,24,1,23,富邦-宜蘭,2023-10-11,9686
5243,乙盛-KY,23,0,23,富邦-宜蘭,2023-10-11,9686
3666,光耀,22,0,22,富邦-宜蘭,2023-10-11,9686
2014,中鴻,22,1,21,富邦-宜蘭,2023-10-11,9686
2405,輔信,23,2,21,富邦-宜蘭,2023-10-11,9686
4541,晟田,20,0,20,富邦-宜蘭,2023-10-11,9686
6282,康舒,20,0,20,富邦-宜蘭,2023-10-11,9686
6189,豐藝,23,4,19,富邦-宜蘭,2023-10-11,9686
1471,首利,22,4,18,富邦-宜蘭,2023-10-11,9686
4916,事欣科,20,2,18,富邦-宜蘭,2023-10-11,9686
1612,宏泰,18,0,18,富邦-宜蘭,2023-10-11,9686
2816,旺旺保,30,13,17,富邦-宜蘭,2023-10-11,9686
2399,映泰,30,14,16,富邦-宜蘭,2023-10-11,9686
2312,金寶,19,4,15,富邦-宜蘭,2023-10-11,9686
2206,三陽工業,15,0,15,富邦-宜蘭,2023-10-11,9686
2468,華經,22,7,15,富邦-宜蘭,2023-10-11,9686
8444,綠河-KY,15,0,15,富邦-宜蘭,2023-10-11,9686
2603,長榮,29,15,14,富邦-宜蘭,2023-10-11,9686
3013,晟銘電,37,25,12,富邦-宜蘭,2023-10-11,9686
00902,中信電池及儲能,12,0,12,富邦-宜蘭,2023-10-11,9686
6530,創威,19,7,12,富邦-宜蘭,2023-10-11,9686
2358,廷鑫,14,2,12,富邦-宜蘭,2023-10-11,9686
2412,中華電,12,0,12,富邦-宜蘭,2023-10-11,9686
8068,全達,12,1,11,富邦-宜蘭,2023-10-11,9686
3694,海華,14,3,11,富邦-宜蘭,2023-10-11,9686
2542,興富發,14,3,11,富邦-宜蘭,2023-10-11,9686
2634,漢翔,29,19,10,富邦-宜蘭,2023-10-11,9686
2888,新光金,251,10,241,富邦-宜蘭,2023-10-12,9686
00632R,元大台灣50反1,150,46,104,富邦-宜蘭,2023-10-12,9686
2618,長榮航,115,19,96,富邦-宜蘭,2023-10-12,9686
00919,群益台灣精選高息,142,63,79,富邦-宜蘭,2023-10-12,9686
0056,元大高股息,91,19,72,富邦-宜蘭,2023-10-12,9686
1101,台泥,78,11,67,富邦-宜蘭,2023-10-12,9686
3276,宇環,81,23,58,富邦-宜蘭,2023-10-12,9686
8176,智捷,35,2,33,富邦-宜蘭,2023-10-12,9686
2363,矽統,198,168,30,富邦-宜蘭,2023-10-12,9686
1402,遠東新,30,0,30,富邦-宜蘭,2023-10-12,9686
3313,斐成,30,0,30,富邦-宜蘭,2023-10-12,9686
1504,東元,31,4,27,富邦-宜蘭,2023-10-12,9686
5864,致和證,25,0,25,富邦-宜蘭,2023-10-12,9686
8049,晶采,25,0,25,富邦-宜蘭,2023-10-12,9686
5348,正能量智能,20,0,20,富邦-宜蘭,2023-10-12,9686
5469,瀚宇博,20,0,20,富邦-宜蘭,2023-10-12,9686
1584,精剛,19,0,19,富邦-宜蘭,2023-10-12,9686
6112,邁達特,23,5,18,富邦-宜蘭,2023-10-12,9686
4906,正文,17,1,16,富邦-宜蘭,2023-10-12,9686
00720B,元大投資級公司債,24,8,16,富邦-宜蘭,2023-10-12,9686
00730,富邦臺灣優質高息,16,0,16,富邦-宜蘭,2023-10-12,9686
00715L,期街口布蘭特正2,21,5,16,富邦-宜蘭,2023-10-12,9686
6605,帝寶,15,0,15,富邦-宜蘭,2023-10-12,9686
00692,富邦公司治理,16,1,15,富邦-宜蘭,2023-10-12,9686
2498,宏達電,17,3,14,富邦-宜蘭,2023-10-12,9686
3694,海華,18,5,13,富邦-宜蘭,2023-10-12,9686
3227,原相,12,0,12,富邦-宜蘭,2023-10-12,9686
2365,昆盈,12,0,12,富邦-宜蘭,2023-10-12,9686
2458,義隆,13,1,12,富邦-宜蘭,2023-10-12,9686
4102,永日,12,0,12,富邦-宜蘭,2023-10-12,9686
6129,普誠,15,3,12,富邦-宜蘭,2023-10-12,9686
1609,大亞,12,1,11,富邦-宜蘭,2023-10-12,9686
6188,廣明,11,1,10,富邦-宜蘭,2023-10-12,9686
8034,榮群,10,0,10,富邦-宜蘭,2023-10-12,9686
1721,三晃,10,0,10,富邦-宜蘭,2023-10-12,9686
3149,正達,10,0,10,富邦-宜蘭,2023-10-12,9686
1708,東鹼,10,0,10,富邦-宜蘭,2023-10-12,9686
6788,華景電,10,0,10,富邦-宜蘭,2023-10-12,9686
4157,太景*-KY,10,0,10,富邦-宜蘭,2023-10-12,9686
2390,云辰,9,0,9,富邦-宜蘭,2023-10-12,9686
00795B,中信美國公債20年,9,0,9,富邦-宜蘭,2023-10-12,9686
6231,系微,14,5,9,富邦-宜蘭,2023-10-12,9686
3706,神達,13,4,9,富邦-宜蘭,2023-10-12,9686
2634,漢翔,10,2,8,富邦-宜蘭,2023-10-12,9686
2382,廣達,30,22,8,富邦-宜蘭,2023-10-12,9686
6196,帆宣,8,0,8,富邦-宜蘭,2023-10-12,9686
5457,宣德,16,8,8,富邦-宜蘭,2023-10-12,9686
3308,聯德,15,7,8,富邦-宜蘭,2023-10-12,9686
2468,華經,11,3,8,富邦-宜蘭,2023-10-12,9686
2329,華泰,65,57,8,富邦-宜蘭,2023-10-12,9686
00857B,永豐20年美公債,223,0,223,富邦-宜蘭,2023-10-13,9686
00637L,元大滬深300正2,189,3,186,富邦-宜蘭,2023-10-13,9686
1319,東陽,178,35,143,富邦-宜蘭,2023-10-13,9686
2618,長榮航,150,7,143,富邦-宜蘭,2023-10-13,9686
0056,元大高股息,108,0,108,富邦-宜蘭,2023-10-13,9686
2317,鴻海,106,5,101,富邦-宜蘭,2023-10-13,9686
00712,復華富時不動產,82,0,82,富邦-宜蘭,2023-10-13,9686
2344,華邦電,89,7,82,富邦-宜蘭,2023-10-13,9686
00878,國泰永續高股息,86,6,80,富邦-宜蘭,2023-10-13,9686
00900,富邦特選高股息30,73,0,73,富邦-宜蘭,2023-10-13,9686
3231,緯創,108,35,73,富邦-宜蘭,2023-10-13,9686
00751B,元大AAA至A公司債,65,0,65,富邦-宜蘭,2023-10-13,9686
2883,凱基金,61,3,58,富邦-宜蘭,2023-10-13,9686
00888,永豐台灣ESG,50,0,50,富邦-宜蘭,2023-10-13,9686
2605,新興,54,7,47,富邦-宜蘭,2023-10-13,9686
3202,樺晟,68,24,44,富邦-宜蘭,2023-10-13,9686
00929,復華台灣科技優息,66,33,33,富邦-宜蘭,2023-10-13,9686
00687B,國泰20年美債,33,0,33,富邦-宜蘭,2023-10-13,9686
00720B,元大投資級公司債,34,3,31,富邦-宜蘭,2023-10-13,9686
2881,富邦金,34,3,31,富邦-宜蘭,2023-10-13,9686
3313,斐成,30,0,30,富邦-宜蘭,2023-10-13,9686
2353,宏��,31,3,28,富邦-宜蘭,2023-10-13,9686
2388,威盛,61,34,27,富邦-宜蘭,2023-10-13,9686
4105,東洋,30,6,24,富邦-宜蘭,2023-10-13,9686
1504,東元,24,1,23,富邦-宜蘭,2023-10-13,9686
1905,華紙,30,9,21,富邦-宜蘭,2023-10-13,9686
2610,華航,22,1,21,富邦-宜蘭,2023-10-13,9686
6901,鑽石投資,21,1,20,富邦-宜蘭,2023-10-13,9686
8176,智捷,20,0,20,富邦-宜蘭,2023-10-13,9686
00679B,元大美債20年,19,0,19,富邦-宜蘭,2023-10-13,9686
2382,廣達,35,16,19,富邦-宜蘭,2023-10-13,9686
00753L,中信中國50正2,28,10,18,富邦-宜蘭,2023-10-13,9686
9907,統一實,18,0,18,富邦-宜蘭,2023-10-13,9686
2332,友訊,18,0,18,富邦-宜蘭,2023-10-13,9686
2204,中華,21,4,17,富邦-宜蘭,2023-10-13,9686
6282,康舒,18,2,16,富邦-宜蘭,2023-10-13,9686
2352,佳世達,20,5,15,富邦-宜蘭,2023-10-13,9686
2399,映泰,46,31,15,富邦-宜蘭,2023-10-13,9686
1524,耿鼎,21,7,14,富邦-宜蘭,2023-10-13,9686
3481,群創,25,11,14,富邦-宜蘭,2023-10-13,9686
1584,精剛,30,17,13,富邦-宜蘭,2023-10-13,9686
2329,華泰,29,16,13,富邦-宜蘭,2023-10-13,9686
2609,陽明,15,2,13,富邦-宜蘭,2023-10-13,9686
00919,群益台灣精選高息,69,56,13,富邦-宜蘭,2023-10-13,9686
00680L,元大美債20正2,12,0,12,富邦-宜蘭,2023-10-13,9686
00922,國泰台灣領袖50,12,0,12,富邦-宜蘭,2023-10-13,9686
00655L,國泰中國A50正2,18,7,11,富邦-宜蘭,2023-10-13,9686
00650L,復華香港正2,11,0,11,富邦-宜蘭,2023-10-13,9686
6442,光聖,13,2,11,富邦-宜蘭,2023-10-13,9686
1810,和成,11,0,11,富邦-宜蘭,2023-10-13,9686
00929,復華台灣科技優息,151,3,148,富邦-宜蘭,2023-10-16,9686
2344,華邦電,146,14,132,富邦-宜蘭,2023-10-16,9686
2618,長榮航,98,10,88,富邦-宜蘭,2023-10-16,9686
0056,元大高股息,81,7,74,富邦-宜蘭,2023-10-16,9686
2610,華航,75,3,72,富邦-宜蘭,2023-10-16,9686
2515,中工,194,123,71,富邦-宜蘭,2023-10-16,9686
00637L,元大滬深300正2,82,17,65,富邦-宜蘭,2023-10-16,9686
2363,矽統,246,186,60,富邦-宜蘭,2023-10-16,9686
00673R,期元大S＆P原油反1,55,0,55,富邦-宜蘭,2023-10-16,9686
00720B,元大投資級公司債,54,1,53,富邦-宜蘭,2023-10-16,9686
2002,中鋼,49,0,49,富邦-宜蘭,2023-10-16,9686
2233,宇隆,42,0,42,富邦-宜蘭,2023-10-16,9686
3078,僑威,47,7,40,富邦-宜蘭,2023-10-16,9686
6770,力積電,83,44,39,富邦-宜蘭,2023-10-16,9686
2369,菱生,53,15,38,富邦-宜蘭,2023-10-16,9686
00919,群益台灣精選高息,43,7,36,富邦-宜蘭,2023-10-16,9686
00922,國泰台灣領袖50,33,0,33,富邦-宜蘭,2023-10-16,9686
2409,友達,28,0,28,富邦-宜蘭,2023-10-16,9686
3706,神達,30,2,28,富邦-宜蘭,2023-10-16,9686
00665L,富邦�琤肭磪囓�2,27,0,27,富邦-宜蘭,2023-10-16,9686
2106,建大,25,0,25,富邦-宜蘭,2023-10-16,9686
2201,裕隆,50,26,24,富邦-宜蘭,2023-10-16,9686
3062,建漢,25,1,24,富邦-宜蘭,2023-10-16,9686
00931B,統一美債20年,22,0,22,富邦-宜蘭,2023-10-16,9686
00900,富邦特選高股息30,22,1,21,富邦-宜蘭,2023-10-16,9686
5521,工信,21,0,21,富邦-宜蘭,2023-10-16,9686
9907,統一實,21,0,21,富邦-宜蘭,2023-10-16,9686
2061,風青,20,0,20,富邦-宜蘭,2023-10-16,9686
00712,復華富時不動產,22,2,20,富邦-宜蘭,2023-10-16,9686
3037,欣興,25,6,19,富邦-宜蘭,2023-10-16,9686
1605,華新,22,4,18,富邦-宜蘭,2023-10-16,9686
2399,映泰,19,2,17,富邦-宜蘭,2023-10-16,9686
2486,一詮,40,23,17,富邦-宜蘭,2023-10-16,9686
00715L,期街口布蘭特正2,37,21,16,富邦-宜蘭,2023-10-16,9686
00687B,國泰20年美債,105,90,15,富邦-宜蘭,2023-10-16,9686
2371,大同,15,0,15,富邦-宜蘭,2023-10-16,9686
00642U,期元大S＆P石油,14,0,14,富邦-宜蘭,2023-10-16,9686
6282,康舒,19,5,14,富邦-宜蘭,2023-10-16,9686
2337,旺宏,14,1,13,富邦-宜蘭,2023-10-16,9686
6684,安格,13,0,13,富邦-宜蘭,2023-10-16,9686
1611,中電,13,0,13,富邦-宜蘭,2023-10-16,9686
3025,星通,22,10,12,富邦-宜蘭,2023-10-16,9686
3202,樺晟,14,2,12,富邦-宜蘭,2023-10-16,9686
3376,新日興,31,19,12,富邦-宜蘭,2023-10-16,9686
4908,前鼎,125,113,12,富邦-宜蘭,2023-10-16,9686
1584,精剛,12,0,12,富邦-宜蘭,2023-10-16,9686
2412,中華電,12,0,12,富邦-宜蘭,2023-10-16,9686
3231,緯創,62,50,12,富邦-宜蘭,2023-10-16,9686
00753L,中信中國50正2,11,0,11,富邦-宜蘭,2023-10-16,9686
6570,維田,11,0,11,富邦-宜蘭,2023-10-16,9686
3231,緯創,198,56,142,富邦-宜蘭,2023-10-17,9686
2323,中環,88,1,87,富邦-宜蘭,2023-10-17,9686
0056,元大高股息,77,11,66,富邦-宜蘭,2023-10-17,9686
00929,復華台灣科技優息,72,9,63,富邦-宜蘭,2023-10-17,9686
00720B,元大投資級公司債,55,0,55,富邦-宜蘭,2023-10-17,9686
6770,力積電,82,34,48,富邦-宜蘭,2023-10-17,9686
2609,陽明,51,7,44,富邦-宜蘭,2023-10-17,9686
2363,矽統,294,252,42,富邦-宜蘭,2023-10-17,9686
5324,士開,40,0,40,富邦-宜蘭,2023-10-17,9686
6112,邁達特,36,0,36,富邦-宜蘭,2023-10-17,9686
1584,精剛,36,1,35,富邦-宜蘭,2023-10-17,9686
00632R,元大台灣50反1,34,0,34,富邦-宜蘭,2023-10-17,9686
3481,群創,46,13,33,富邦-宜蘭,2023-10-17,9686
1524,耿鼎,42,9,33,富邦-宜蘭,2023-10-17,9686
5009,榮剛,36,3,33,富邦-宜蘭,2023-10-17,9686
00751B,元大AAA至A公司債,32,0,32,富邦-宜蘭,2023-10-17,9686
2634,漢翔,32,2,30,富邦-宜蘭,2023-10-17,9686
00687B,國泰20年美債,24,0,24,富邦-宜蘭,2023-10-17,9686
6244,茂迪,23,0,23,富邦-宜蘭,2023-10-17,9686
1815,富喬,31,10,21,富邦-宜蘭,2023-10-17,9686
6114,久威,20,0,20,富邦-宜蘭,2023-10-17,9686
1527,鑽全,20,0,20,富邦-宜蘭,2023-10-17,9686
3122,笙泉,20,0,20,富邦-宜蘭,2023-10-17,9686
2812,台中銀,20,0,20,富邦-宜蘭,2023-10-17,9686
5310,天剛,20,0,20,富邦-宜蘭,2023-10-17,9686
00679B,元大美債20年,18,0,18,富邦-宜蘭,2023-10-17,9686
4746,台耀,18,0,18,富邦-宜蘭,2023-10-17,9686
00753L,中信中國50正2,17,0,17,富邦-宜蘭,2023-10-17,9686
3376,新日興,50,33,17,富邦-宜蘭,2023-10-17,9686
2104,國際中橡,17,0,17,富邦-宜蘭,2023-10-17,9686
00878,國泰永續高股息,28,11,17,富邦-宜蘭,2023-10-17,9686
2402,毅嘉,18,2,16,富邦-宜蘭,2023-10-17,9686
3227,原相,24,8,16,富邦-宜蘭,2023-10-17,9686
00730,富邦臺灣優質高息,16,0,16,富邦-宜蘭,2023-10-17,9686
5701,劍湖山,15,0,15,富邦-宜蘭,2023-10-17,9686
6589,台康生技,15,0,15,富邦-宜蘭,2023-10-17,9686
00932,兆豐永續高息等權,13,0,13,富邦-宜蘭,2023-10-17,9686
2014,中鴻,15,3,12,富邦-宜蘭,2023-10-17,9686
2317,鴻海,13,2,11,富邦-宜蘭,2023-10-17,9686
2376,技嘉,43,32,11,富邦-宜蘭,2023-10-17,9686
2498,宏達電,11,0,11,富邦-宜蘭,2023-10-17,9686
8033,雷虎,14,3,11,富邦-宜蘭,2023-10-17,9686
8183,精星,13,2,11,富邦-宜蘭,2023-10-17,9686
2425,承啟,18,7,11,富邦-宜蘭,2023-10-17,9686
3483,力致,23,13,10,富邦-宜蘭,2023-10-17,9686
00725B,國泰投資級公司債,10,0,10,富邦-宜蘭,2023-10-17,9686
4906,正文,11,1,10,富邦-宜蘭,2023-10-17,9686
6111,大宇資,10,0,10,富邦-宜蘭,2023-10-17,9686
4164,承業醫,10,0,10,富邦-宜蘭,2023-10-17,9686
2106,建大,10,0,10,富邦-宜蘭,2023-10-17,9686
00922,國泰台灣領袖50,170,2,168,富邦-宜蘭,2023-10-18,9686
0056,元大高股息,179,24,155,富邦-宜蘭,2023-10-18,9686
1101,台泥,113,3,110,富邦-宜蘭,2023-10-18,9686
1584,精剛,90,0,90,富邦-宜蘭,2023-10-18,9686
00878,國泰永續高股息,157,78,79,富邦-宜蘭,2023-10-18,9686
00929,復華台灣科技優息,113,35,78,富邦-宜蘭,2023-10-18,9686
1319,東陽,80,4,76,富邦-宜蘭,2023-10-18,9686
2002,中鋼,57,0,57,富邦-宜蘭,2023-10-18,9686
1471,首利,64,7,57,富邦-宜蘭,2023-10-18,9686
1314,中石化,63,8,55,富邦-宜蘭,2023-10-18,9686
2313,華通,59,14,45,富邦-宜蘭,2023-10-18,9686
3481,群創,54,10,44,富邦-宜蘭,2023-10-18,9686
2323,中環,51,9,42,富邦-宜蘭,2023-10-18,9686
1324,地球,44,4,40,富邦-宜蘭,2023-10-18,9686
00664R,國泰臺灣加權反1,35,0,35,富邦-宜蘭,2023-10-18,9686
00679B,元大美債20年,34,0,34,富邦-宜蘭,2023-10-18,9686
1815,富喬,93,62,31,富邦-宜蘭,2023-10-18,9686
2405,輔信,30,0,30,富邦-宜蘭,2023-10-18,9686
00932,兆豐永續高息等權,29,0,29,富邦-宜蘭,2023-10-18,9686
3706,神達,59,31,28,富邦-宜蘭,2023-10-18,9686
2353,宏��,26,1,25,富邦-宜蘭,2023-10-18,9686
00673R,期元大S＆P原油反1,25,0,25,富邦-宜蘭,2023-10-18,9686
2436,偉詮電,25,1,24,富邦-宜蘭,2023-10-18,9686
2382,廣達,44,21,23,富邦-宜蘭,2023-10-18,9686
4915,致伸,28,5,23,富邦-宜蘭,2023-10-18,9686
1102,亞泥,25,4,21,富邦-宜蘭,2023-10-18,9686
6191,精成科,21,0,21,富邦-宜蘭,2023-10-18,9686
4526,東台,21,0,21,富邦-宜蘭,2023-10-18,9686
00724B,群益投資級金融債,20,0,20,富邦-宜蘭,2023-10-18,9686
8024,佑華,20,0,20,富邦-宜蘭,2023-10-18,9686
5310,天剛,20,0,20,富邦-宜蘭,2023-10-18,9686
5348,正能量智能,20,0,20,富邦-宜蘭,2023-10-18,9686
00720B,元大投資級公司債,19,0,19,富邦-宜蘭,2023-10-18,9686
00687B,國泰20年美債,17,0,17,富邦-宜蘭,2023-10-18,9686
3041,揚智,21,4,17,富邦-宜蘭,2023-10-18,9686
6274,台燿,20,4,16,富邦-宜蘭,2023-10-18,9686
1303,南亞,17,0,17,富邦-宜蘭,2023-10-18,9686
2352,佳世達,25,9,16,富邦-宜蘭,2023-10-18,9686
00675L,富邦臺灣加權正2,15,0,15,富邦-宜蘭,2023-10-18,9686
2104,國際中橡,15,0,15,富邦-宜蘭,2023-10-18,9686
1316,上曜,16,1,15,富邦-宜蘭,2023-10-18,9686
6237,驊訊,28,13,15,富邦-宜蘭,2023-10-18,9686
3272,東碩,16,2,14,富邦-宜蘭,2023-10-18,9686
2369,菱生,40,26,14,富邦-宜蘭,2023-10-18,9686
2618,長榮航,26,13,13,富邦-宜蘭,2023-10-18,9686
2888,新光金,15,2,13,富邦-宜蘭,2023-10-18,9686
00730,富邦臺灣優質高息,13,0,13,富邦-宜蘭,2023-10-18,9686
3163,波若威,34,22,12,富邦-宜蘭,2023-10-18,9686
6788,華景電,12,0,12,富邦-宜蘭,2023-10-18,9686
3033,威健,11,0,11,富邦-宜蘭,2023-10-18,9686
00933B,國泰10Y+金融債,287,28,259,富邦-宜蘭,2023-10-19,9686
00885,富邦越南,230,0,230,富邦-宜蘭,2023-10-19,9686
3481,群創,196,31,165,富邦-宜蘭,2023-10-19,9686
00637L,元大滬深300正2,136,0,136,富邦-宜蘭,2023-10-19,9686
0056,元大高股息,137,19,118,富邦-宜蘭,2023-10-19,9686
2883,凱基金,108,2,106,富邦-宜蘭,2023-10-19,9686
1314,中石化,96,11,85,富邦-宜蘭,2023-10-19,9686
1101,台泥,109,26,83,富邦-宜蘭,2023-10-19,9686
2344,華邦電,69,6,63,富邦-宜蘭,2023-10-19,9686
00878,國泰永續高股息,62,3,59,富邦-宜蘭,2023-10-19,9686
00679B,元大美債20年,57,0,57,富邦-宜蘭,2023-10-19,9686
2352,佳世達,75,22,53,富邦-宜蘭,2023-10-19,9686
1455,集盛,50,0,50,富邦-宜蘭,2023-10-19,9686
00753L,中信中國50正2,48,0,48,富邦-宜蘭,2023-10-19,9686
1319,東陽,60,21,39,富邦-宜蘭,2023-10-19,9686
00715L,期街口布蘭特正2,38,0,38,富邦-宜蘭,2023-10-19,9686
00655L,國泰中國A50正2,41,5,36,富邦-宜蘭,2023-10-19,9686
6770,力積電,35,3,32,富邦-宜蘭,2023-10-19,9686
00751B,元大AAA至A公司債,32,0,32,富邦-宜蘭,2023-10-19,9686
6120,達運,31,0,31,富邦-宜蘭,2023-10-19,9686
1609,大亞,31,0,31,富邦-宜蘭,2023-10-19,9686
00633L,富邦上証正2,31,0,31,富邦-宜蘭,2023-10-19,9686
00929,復華台灣科技優息,49,21,28,富邦-宜蘭,2023-10-19,9686
3715,定穎投控,225,198,27,富邦-宜蘭,2023-10-19,9686
00687B,國泰20年美債,24,3,21,富邦-宜蘭,2023-10-19,9686
2412,中華電,21,0,21,富邦-宜蘭,2023-10-19,9686
2317,鴻海,21,1,20,富邦-宜蘭,2023-10-19,9686
00680L,元大美債20正2,20,0,20,富邦-宜蘭,2023-10-19,9686
2027,大成鋼,20,0,20,富邦-宜蘭,2023-10-19,9686
2104,國際中橡,20,0,20,富邦-宜蘭,2023-10-19,9686
2356,英業達,25,7,18,富邦-宜蘭,2023-10-19,9686
00650L,復華香港正2,18,0,18,富邦-宜蘭,2023-10-19,9686
00919,群益台灣精選高息,23,6,17,富邦-宜蘭,2023-10-19,9686
3231,緯創,130,114,16,富邦-宜蘭,2023-10-19,9686
6191,精成科,18,2,16,富邦-宜蘭,2023-10-19,9686
2816,旺旺保,30,15,15,富邦-宜蘭,2023-10-19,9686
2885,元大金,17,2,15,富邦-宜蘭,2023-10-19,9686
00720B,元大投資級公司債,15,0,15,富邦-宜蘭,2023-10-19,9686
2002,中鋼,15,0,15,富邦-宜蘭,2023-10-19,9686
3049,精金,14,0,14,富邦-宜蘭,2023-10-19,9686
1802,台玻,20,6,14,富邦-宜蘭,2023-10-19,9686
6530,創威,27,14,13,富邦-宜蘭,2023-10-19,9686
2388,威盛,80,67,13,富邦-宜蘭,2023-10-19,9686
1504,東元,13,1,12,富邦-宜蘭,2023-10-19,9686
2618,長榮航,13,1,12,富邦-宜蘭,2023-10-19,9686
2458,義隆,19,7,12,富邦-宜蘭,2023-10-19,9686
2353,宏��,14,2,12,富邦-宜蘭,2023-10-19,9686
1305,華夏,12,0,12,富邦-宜蘭,2023-10-19,9686
8261,富鼎,12,0,12,富邦-宜蘭,2023-10-19,9686
1434,福懋,12,0,12,富邦-宜蘭,2023-10-19,9686
00857B,永豐20年美公債,235,0,235,富邦-宜蘭,2023-10-20,9686
00712,復華富時不動產,168,1,167,富邦-宜蘭,2023-10-20,9686
6168,宏齊,120,12,108,富邦-宜蘭,2023-10-20,9686
0056,元大高股息,128,24,104,富邦-宜蘭,2023-10-20,9686
2369,菱生,92,17,75,富邦-宜蘭,2023-10-20,9686
1101,台泥,66,1,65,富邦-宜蘭,2023-10-20,9686
5880,合庫金,59,1,58,富邦-宜蘭,2023-10-20,9686
2610,華航,54,2,52,富邦-宜蘭,2023-10-20,9686
00877,復華中國5G,50,0,50,富邦-宜蘭,2023-10-20,9686
1314,中石化,47,0,47,富邦-宜蘭,2023-10-20,9686
00919,群益台灣精選高息,51,6,45,富邦-宜蘭,2023-10-20,9686
2515,中工,44,0,44,富邦-宜蘭,2023-10-20,9686
00878,國泰永續高股息,134,91,43,富邦-宜蘭,2023-10-20,9686
6237,驊訊,45,4,41,富邦-宜蘭,2023-10-20,9686
00929,復華台灣科技優息,64,24,40,富邦-宜蘭,2023-10-20,9686
9950,萬國通,45,7,38,富邦-宜蘭,2023-10-20,9686
2892,第一金,43,9,34,富邦-宜蘭,2023-10-20,9686
2888,新光金,34,1,33,富邦-宜蘭,2023-10-20,9686
00655L,國泰中國A50正2,36,4,32,富邦-宜蘭,2023-10-20,9686
4401,東隆興,31,0,31,富邦-宜蘭,2023-10-20,9686
3176,基亞,33,2,31,富邦-宜蘭,2023-10-20,9686
3287,廣寰科,32,2,30,富邦-宜蘭,2023-10-20,9686
00687B,國泰20年美債,26,3,23,富邦-宜蘭,2023-10-20,9686
00679B,元大美債20年,22,0,22,富邦-宜蘭,2023-10-20,9686
2882,國泰金,24,3,21,富邦-宜蘭,2023-10-20,9686
4532,瑞智,21,0,21,富邦-宜蘭,2023-10-20,9686
2324,仁寶,22,2,20,富邦-宜蘭,2023-10-20,9686
1781,合世,20,0,20,富邦-宜蘭,2023-10-20,9686
00722B,群益投資級電信債,20,0,20,富邦-宜蘭,2023-10-20,9686
6235,華孚,25,6,19,富邦-宜蘭,2023-10-20,9686
00751B,元大AAA至A公司債,18,0,18,富邦-宜蘭,2023-10-20,9686
2881,富邦金,61,43,18,富邦-宜蘭,2023-10-20,9686
2002,中鋼,17,0,17,富邦-宜蘭,2023-10-20,9686
2634,漢翔,19,3,16,富邦-宜蘭,2023-10-20,9686
2887,台新金,66,51,15,富邦-宜蘭,2023-10-20,9686
2606,裕民,38,23,15,富邦-宜蘭,2023-10-20,9686
2618,長榮航,21,6,15,富邦-宜蘭,2023-10-20,9686
2486,一詮,19,4,15,富邦-宜蘭,2023-10-20,9686
00720B,元大投資級公司債,14,0,14,富邦-宜蘭,2023-10-20,9686
2317,鴻海,16,2,14,富邦-宜蘭,2023-10-20,9686
00933B,國泰10Y+金融債,14,0,14,富邦-宜蘭,2023-10-20,9686
6104,創惟,18,4,14,富邦-宜蘭,2023-10-20,9686
6113,亞矽,18,4,14,富邦-宜蘭,2023-10-20,9686
00772B,中信高評級公司債,13,0,13,富邦-宜蘭,2023-10-20,9686
00637L,元大滬深300正2,13,0,13,富邦-宜蘭,2023-10-20,9686
00650L,復華香港正2,17,4,13,富邦-宜蘭,2023-10-20,9686
2886,兆豐金,15,2,13,富邦-宜蘭,2023-10-20,9686
6770,力積電,21,9,12,富邦-宜蘭,2023-10-20,9686
00907,永豐優息存股,12,0,12,富邦-宜蘭,2023-10-20,9686
1102,亞泥,11,0,11,富邦-宜蘭,2023-10-20,9686
00929,復華台灣科技優息,240,35,205,富邦-宜蘭,2023-10-23,9686
00712,復華富時不動產,135,0,135,富邦-宜蘭,2023-10-23,9686
00919,群益台灣精選高息,117,0,117,富邦-宜蘭,2023-10-23,9686
00878,國泰永續高股息,97,6,91,富邦-宜蘭,2023-10-23,9686
2317,鴻海,89,27,62,富邦-宜蘭,2023-10-23,9686
2834,臺企銀,55,0,55,富邦-宜蘭,2023-10-23,9686
5355,佳總,58,5,53,富邦-宜蘭,2023-10-23,9686
00933B,國泰10Y+金融債,66,21,45,富邦-宜蘭,2023-10-23,9686
00679B,元大美債20年,50,5,45,富邦-宜蘭,2023-10-23,9686
6770,力積電,45,2,43,富邦-宜蘭,2023-10-23,9686
00753L,中信中國50正2,43,0,43,富邦-宜蘭,2023-10-23,9686
1702,南僑,32,0,32,富邦-宜蘭,2023-10-23,9686
1303,南亞,33,1,32,富邦-宜蘭,2023-10-23,9686
2344,華邦電,33,2,31,富邦-宜蘭,2023-10-23,9686
0056,元大高股息,33,2,31,富邦-宜蘭,2023-10-23,9686
8155,博智,30,0,30,富邦-宜蘭,2023-10-23,9686
2881,富邦金,30,1,29,富邦-宜蘭,2023-10-23,9686
2409,友達,28,2,26,富邦-宜蘭,2023-10-23,9686
6547,高端疫苗,25,0,25,富邦-宜蘭,2023-10-23,9686
4747,強生,24,0,24,富邦-宜蘭,2023-10-23,9686
3163,波若威,27,4,23,富邦-宜蘭,2023-10-23,9686
2609,陽明,24,4,20,富邦-宜蘭,2023-10-23,9686
00715L,期街口布蘭特正2,21,1,20,富邦-宜蘭,2023-10-23,9686
1781,合世,20,0,20,富邦-宜蘭,2023-10-23,9686
1227,佳格,20,0,20,富邦-宜蘭,2023-10-23,9686
00655L,國泰中國A50正2,20,0,20,富邦-宜蘭,2023-10-23,9686
2312,金寶,20,1,19,富邦-宜蘭,2023-10-23,9686
2402,毅嘉,35,17,18,富邦-宜蘭,2023-10-23,9686
00687B,國泰20年美債,17,0,17,富邦-宜蘭,2023-10-23,9686
00751B,元大AAA至A公司債,16,0,16,富邦-宜蘭,2023-10-23,9686
2605,新興,17,1,16,富邦-宜蘭,2023-10-23,9686
1102,亞泥,16,0,16,富邦-宜蘭,2023-10-23,9686
6139,亞翔,21,6,15,富邦-宜蘭,2023-10-23,9686
2338,光罩,14,0,14,富邦-宜蘭,2023-10-23,9686
00650L,復華香港正2,14,0,14,富邦-宜蘭,2023-10-23,9686
00922,國泰台灣領袖50,14,0,14,富邦-宜蘭,2023-10-23,9686
5512,力麒,13,0,13,富邦-宜蘭,2023-10-23,9686
2883,凱基金,12,0,12,富邦-宜蘭,2023-10-23,9686
2637,慧洋-KY,12,0,12,富邦-宜蘭,2023-10-23,9686
2412,中華電,12,0,12,富邦-宜蘭,2023-10-23,9686
2882,國泰金,13,1,12,富邦-宜蘭,2023-10-23,9686
2363,矽統,31,20,11,富邦-宜蘭,2023-10-23,9686
2002,中鋼,15,4,11,富邦-宜蘭,2023-10-23,9686
3711,日月光投控,11,0,11,富邦-宜蘭,2023-10-23,9686
1402,遠東新,11,0,11,富邦-宜蘭,2023-10-23,9686
9938,百和,11,0,11,富邦-宜蘭,2023-10-23,9686
2330,台積電,12,1,11,富邦-宜蘭,2023-10-23,9686
3037,欣興,13,3,10,富邦-宜蘭,2023-10-23,9686
6153,嘉聯益,10,0,10,富邦-宜蘭,2023-10-23,9686
2438,翔耀,10,0,10,富邦-宜蘭,2023-10-23,9686
00929,復華台灣科技優息,97,3,94,富邦-宜蘭,2023-10-24,9686
2317,鴻海,123,31,92,富邦-宜蘭,2023-10-24,9686
00712,復華富時不動產,91,0,91,富邦-宜蘭,2023-10-24,9686
3715,定穎投控,169,106,63,富邦-宜蘭,2023-10-24,9686
8054,安國,69,7,62,富邦-宜蘭,2023-10-24,9686
2883,凱基金,59,0,59,富邦-宜蘭,2023-10-24,9686
00687B,國泰20年美債,58,0,58,富邦-宜蘭,2023-10-24,9686
1815,富喬,61,3,58,富邦-宜蘭,2023-10-24,9686
00680L,元大美債20正2,61,7,54,富邦-宜蘭,2023-10-24,9686
3363,上詮,105,52,53,富邦-宜蘭,2023-10-24,9686
00688L,國泰20年美債正2,50,6,44,富邦-宜蘭,2023-10-24,9686
2892,第一金,42,1,41,富邦-宜蘭,2023-10-24,9686
00637L,元大滬深300正2,42,6,36,富邦-宜蘭,2023-10-24,9686
3306,鼎天,37,8,29,富邦-宜蘭,2023-10-24,9686
00919,群益台灣精選高息,81,52,29,富邦-宜蘭,2023-10-24,9686
1319,東陽,29,1,28,富邦-宜蘭,2023-10-24,9686
4944,兆遠,26,0,26,富邦-宜蘭,2023-10-24,9686
8011,台通,25,0,25,富邦-宜蘭,2023-10-24,9686
00933B,國泰10Y+金融債,34,10,24,富邦-宜蘭,2023-10-24,9686
00897,富邦基因免疫生技,20,0,20,富邦-宜蘭,2023-10-24,9686
2002,中鋼,17,0,17,富邦-宜蘭,2023-10-24,9686
3014,聯陽,17,0,17,富邦-宜蘭,2023-10-24,9686
00633L,富邦上証正2,18,1,17,富邦-宜蘭,2023-10-24,9686
6197,佳必琪,43,26,17,富邦-宜蘭,2023-10-24,9686
00715L,期街口布蘭特正2,18,1,17,富邦-宜蘭,2023-10-24,9686
0056,元大高股息,44,28,16,富邦-宜蘭,2023-10-24,9686
1101,台泥,18,2,16,富邦-宜蘭,2023-10-24,9686
4979,華星光,91,76,15,富邦-宜蘭,2023-10-24,9686
2867,三商壽,15,0,15,富邦-宜蘭,2023-10-24,9686
00877,復華中國5G,15,0,15,富邦-宜蘭,2023-10-24,9686
9934,成霖,15,0,15,富邦-宜蘭,2023-10-24,9686
6257,矽格,24,9,15,富邦-宜蘭,2023-10-24,9686
6216,居易,13,0,13,富邦-宜蘭,2023-10-24,9686
3051,力特,33,21,12,富邦-宜蘭,2023-10-24,9686
2637,慧洋-KY,12,0,12,富邦-宜蘭,2023-10-24,9686
2208,台船,12,1,11,富邦-宜蘭,2023-10-24,9686
1315,達新,11,0,11,富邦-宜蘭,2023-10-24,9686
2881,富邦金,19,9,10,富邦-宜蘭,2023-10-24,9686
00650L,復華香港正2,13,3,10,富邦-宜蘭,2023-10-24,9686
2913,農林,10,0,10,富邦-宜蘭,2023-10-24,9686
4977,眾達-KY,11,1,10,富邦-宜蘭,2023-10-24,9686
5348,正能量智能,10,0,10,富邦-宜蘭,2023-10-24,9686
2606,裕民,15,5,10,富邦-宜蘭,2023-10-24,9686
3372,典範,10,0,10,富邦-宜蘭,2023-10-24,9686
3083,網龍,10,0,10,富邦-宜蘭,2023-10-24,9686
3294,英濟,12,2,10,富邦-宜蘭,2023-10-24,9686
2103,台橡,10,0,10,富邦-宜蘭,2023-10-24,9686
2820,華票,10,0,10,富邦-宜蘭,2023-10-24,9686
3339,泰谷,10,0,10,富邦-宜蘭,2023-10-24,9686
00923,群益台ESG低碳50,9,0,9,富邦-宜蘭,2023-10-24,9686
3481,群創,305,112,193,富邦-宜蘭,2023-10-25,9686
00929,復華台灣科技優息,119,21,98,富邦-宜蘭,2023-10-25,9686
6770,力積電,113,35,78,富邦-宜蘭,2023-10-25,9686
00878,國泰永續高股息,74,3,71,富邦-宜蘭,2023-10-25,9686
00919,群益台灣精選高息,66,0,66,富邦-宜蘭,2023-10-25,9686
00712,復華富時不動產,49,0,49,富邦-宜蘭,2023-10-25,9686
2337,旺宏,42,2,40,富邦-宜蘭,2023-10-25,9686
00933B,國泰10Y+金融債,36,0,36,富邦-宜蘭,2023-10-25,9686
2317,鴻海,47,12,35,富邦-宜蘭,2023-10-25,9686
1453,大將,30,0,30,富邦-宜蘭,2023-10-25,9686
00679B,元大美債20年,30,0,30,富邦-宜蘭,2023-10-25,9686
2206,三陽工業,30,1,29,富邦-宜蘭,2023-10-25,9686
6243,迅杰,39,14,25,富邦-宜蘭,2023-10-25,9686
8050,廣積,29,6,23,富邦-宜蘭,2023-10-25,9686
4908,前鼎,32,10,22,富邦-宜蘭,2023-10-25,9686
2405,輔信,24,4,20,富邦-宜蘭,2023-10-25,9686
6188,廣明,20,0,20,富邦-宜蘭,2023-10-25,9686
4977,眾達-KY,19,0,19,富邦-宜蘭,2023-10-25,9686
3176,基亞,23,4,19,富邦-宜蘭,2023-10-25,9686
2881,富邦金,19,0,19,富邦-宜蘭,2023-10-25,9686
2399,映泰,49,31,18,富邦-宜蘭,2023-10-25,9686
1101,台泥,17,0,17,富邦-宜蘭,2023-10-25,9686
2344,華邦電,18,1,17,富邦-宜蘭,2023-10-25,9686
5302,太欣,21,4,17,富邦-宜蘭,2023-10-25,9686
2002,中鋼,19,2,17,富邦-宜蘭,2023-10-25,9686
2329,華泰,26,9,17,富邦-宜蘭,2023-10-25,9686
6156,松上,16,0,16,富邦-宜蘭,2023-10-25,9686
1301,台塑,16,0,16,富邦-宜蘭,2023-10-25,9686
0056,元大高股息,24,8,16,富邦-宜蘭,2023-10-25,9686
2356,英業達,18,3,15,富邦-宜蘭,2023-10-25,9686
00673R,期元大S＆P原油反1,15,0,15,富邦-宜蘭,2023-10-25,9686
9934,成霖,15,0,15,富邦-宜蘭,2023-10-25,9686
1558,伸興,14,0,14,富邦-宜蘭,2023-10-25,9686
3202,樺晟,13,0,13,富邦-宜蘭,2023-10-25,9686
2867,三商壽,12,0,12,富邦-宜蘭,2023-10-25,9686
2816,旺旺保,13,1,12,富邦-宜蘭,2023-10-25,9686
3231,緯創,37,26,11,富邦-宜蘭,2023-10-25,9686
3037,欣興,17,6,11,富邦-宜蘭,2023-10-25,9686
00931B,統一美債20年,11,0,11,富邦-宜蘭,2023-10-25,9686
2014,中鴻,12,1,11,富邦-宜蘭,2023-10-25,9686
1785,光洋科,20,9,11,富邦-宜蘭,2023-10-25,9686
3363,上詮,22,12,10,富邦-宜蘭,2023-10-25,9686
2371,大同,12,2,10,富邦-宜蘭,2023-10-25,9686
3701,大眾控,21,11,10,富邦-宜蘭,2023-10-25,9686
2474,可成,10,0,10,富邦-宜蘭,2023-10-25,9686
6541,泰福-KY,10,0,10,富邦-宜蘭,2023-10-25,9686
2462,良得電,14,4,10,富邦-宜蘭,2023-10-25,9686
2883,凱基金,11,2,9,富邦-宜蘭,2023-10-25,9686
1618,合機,41,32,9,富邦-宜蘭,2023-10-25,9686
6753,龍德造船,9,0,9,富邦-宜蘭,2023-10-25,9686
00885,富邦越南,246,0,246,富邦-宜蘭,2023-10-26,9686
00929,復華台灣科技優息,209,24,185,富邦-宜蘭,2023-10-26,9686
2356,英業達,111,10,101,富邦-宜蘭,2023-10-26,9686
00712,復華富時不動產,98,2,96,富邦-宜蘭,2023-10-26,9686
2344,華邦電,90,1,89,富邦-宜蘭,2023-10-26,9686
00715L,期街口布蘭特正2,85,1,84,富邦-宜蘭,2023-10-26,9686
00753L,中信中國50正2,75,0,75,富邦-宜蘭,2023-10-26,9686
0056,元大高股息,73,0,73,富邦-宜蘭,2023-10-26,9686
6111,大宇資,70,0,70,富邦-宜蘭,2023-10-26,9686
2883,凱基金,53,0,53,富邦-宜蘭,2023-10-26,9686
2303,聯電,98,51,47,富邦-宜蘭,2023-10-26,9686
2618,長榮航,65,21,44,富邦-宜蘭,2023-10-26,9686
00919,群益台灣精選高息,95,52,43,富邦-宜蘭,2023-10-26,9686
2892,第一金,43,1,42,富邦-宜蘭,2023-10-26,9686
00878,國泰永續高股息,93,55,38,富邦-宜蘭,2023-10-26,9686
1227,佳格,36,0,36,富邦-宜蘭,2023-10-26,9686
00680L,元大美債20正2,35,0,35,富邦-宜蘭,2023-10-26,9686
9105,泰金寶-DR,44,10,34,富邦-宜蘭,2023-10-26,9686
4956,光鋐,31,0,31,富邦-宜蘭,2023-10-26,9686
2352,佳世達,43,12,31,富邦-宜蘭,2023-10-26,9686
1524,耿鼎,52,22,30,富邦-宜蘭,2023-10-26,9686
3058,立德,30,1,29,富邦-宜蘭,2023-10-26,9686
3706,神達,30,2,28,富邦-宜蘭,2023-10-26,9686
00922,國泰台灣領袖50,28,0,28,富邦-宜蘭,2023-10-26,9686
2337,旺宏,29,3,26,富邦-宜蘭,2023-10-26,9686
00687B,國泰20年美債,25,0,25,富邦-宜蘭,2023-10-26,9686
1301,台塑,26,2,24,富邦-宜蘭,2023-10-26,9686
2408,南亞科,25,1,24,富邦-宜蘭,2023-10-26,9686
2312,金寶,22,0,22,富邦-宜蘭,2023-10-26,9686
00850,元大臺灣ESG永續,22,0,22,富邦-宜蘭,2023-10-26,9686
1806,冠軍,20,0,20,富邦-宜蘭,2023-10-26,9686
3276,宇環,30,10,20,富邦-宜蘭,2023-10-26,9686
3057,喬鼎,20,0,20,富邦-宜蘭,2023-10-26,9686
4552,力達-KY,20,0,20,富邦-宜蘭,2023-10-26,9686
2485,兆赫,21,2,19,富邦-宜蘭,2023-10-26,9686
00650L,復華香港正2,20,1,19,富邦-宜蘭,2023-10-26,9686
1303,南亞,17,0,17,富邦-宜蘭,2023-10-26,9686
3704,合勤控,16,0,16,富邦-宜蘭,2023-10-26,9686
00665L,富邦�琤肭磪囓�2,26,10,16,富邦-宜蘭,2023-10-26,9686
2330,台積電,20,5,15,富邦-宜蘭,2023-10-26,9686
1722,台肥,15,0,15,富邦-宜蘭,2023-10-26,9686
1326,台化,15,0,15,富邦-宜蘭,2023-10-26,9686
2630,亞航,34,19,15,富邦-宜蘭,2023-10-26,9686
2317,鴻海,20,6,14,富邦-宜蘭,2023-10-26,9686
4105,東洋,32,18,14,富邦-宜蘭,2023-10-26,9686
6505,台塑化,13,0,13,富邦-宜蘭,2023-10-26,9686
1514,亞力,14,1,13,富邦-宜蘭,2023-10-26,9686
00888,永豐台灣ESG,12,0,12,富邦-宜蘭,2023-10-26,9686
6237,驊訊,37,25,12,富邦-宜蘭,2023-10-26,9686
3025,星通,20,8,12,富邦-宜蘭,2023-10-26,9686
2883,凱基金,227,10,217,富邦-宜蘭,2023-10-27,9686
6770,力積電,91,1,90,富邦-宜蘭,2023-10-27,9686
00929,復華台灣科技優息,132,45,87,富邦-宜蘭,2023-10-27,9686
3576,聯合再生,66,0,66,富邦-宜蘭,2023-10-27,9686
00919,群益台灣精選高息,57,0,57,富邦-宜蘭,2023-10-27,9686
4128,中天,55,1,54,富邦-宜蘭,2023-10-27,9686
2349,錸德,50,0,50,富邦-宜蘭,2023-10-27,9686
00712,復華富時不動產,47,0,47,富邦-宜蘭,2023-10-27,9686
00632R,元大台灣50反1,57,14,43,富邦-宜蘭,2023-10-27,9686
00900,富邦特選高股息30,41,0,41,富邦-宜蘭,2023-10-27,9686
2303,聯電,47,9,38,富邦-宜蘭,2023-10-27,9686
6111,大宇資,35,2,33,富邦-宜蘭,2023-10-27,9686
9105,泰金寶-DR,36,5,31,富邦-宜蘭,2023-10-27,9686
2363,矽統,43,15,28,富邦-宜蘭,2023-10-27,9686
6139,亞翔,34,7,27,富邦-宜蘭,2023-10-27,9686
1101,台泥,26,2,24,富邦-宜蘭,2023-10-27,9686
8034,榮群,21,0,21,富邦-宜蘭,2023-10-27,9686
3094,聯傑,51,31,20,富邦-宜蘭,2023-10-27,9686
2486,一詮,39,19,20,富邦-宜蘭,2023-10-27,9686
5426,振發,21,1,20,富邦-宜蘭,2023-10-27,9686
2382,廣達,24,5,19,富邦-宜蘭,2023-10-27,9686
2630,亞航,19,0,19,富邦-宜蘭,2023-10-27,9686
8044,網家,20,1,19,富邦-宜蘭,2023-10-27,9686
4123,晟德,23,5,18,富邦-宜蘭,2023-10-27,9686
1760,寶齡富錦,24,6,18,富邦-宜蘭,2023-10-27,9686
3287,廣寰科,19,2,17,富邦-宜蘭,2023-10-27,9686
3260,威剛,29,13,16,富邦-宜蘭,2023-10-27,9686
2337,旺宏,16,0,16,富邦-宜蘭,2023-10-27,9686
006208,富邦台50,16,1,15,富邦-宜蘭,2023-10-27,9686
00888,永豐台灣ESG,13,0,13,富邦-宜蘭,2023-10-27,9686
4977,眾達-KY,13,0,13,富邦-宜蘭,2023-10-27,9686
8358,金居,17,4,13,富邦-宜蘭,2023-10-27,9686
2329,華泰,25,13,12,富邦-宜蘭,2023-10-27,9686
6442,光聖,30,18,12,富邦-宜蘭,2023-10-27,9686
1471,首利,15,3,12,富邦-宜蘭,2023-10-27,9686
4908,前鼎,40,29,11,富邦-宜蘭,2023-10-27,9686
3284,太普高,11,0,11,富邦-宜蘭,2023-10-27,9686
5425,台半,11,1,10,富邦-宜蘭,2023-10-27,9686
2442,新美齊,10,0,10,富邦-宜蘭,2023-10-27,9686
2344,華邦電,15,5,10,富邦-宜蘭,2023-10-27,9686
00772B,中信高評級公司債,10,0,10,富邦-宜蘭,2023-10-27,9686
00878,國泰永續高股息,19,9,10,富邦-宜蘭,2023-10-27,9686
3163,波若威,31,21,10,富邦-宜蘭,2023-10-27,9686
2408,南亞科,10,2,8,富邦-宜蘭,2023-10-27,9686
2201,裕隆,9,2,7,富邦-宜蘭,2023-10-27,9686
2618,長榮航,23,16,7,富邦-宜蘭,2023-10-27,9686
2305,全友,12,5,7,富邦-宜蘭,2023-10-27,9686
3081,聯亞,7,0,7,富邦-宜蘭,2023-10-27,9686
2449,京元電子,10,3,7,富邦-宜蘭,2023-10-27,9686
2421,建準,7,0,7,富邦-宜蘭,2023-10-27,9686
6443,元晶,80,12,68,富邦-宜蘭,2023-10-30,9686
00712,復華富時不動產,66,0,66,富邦-宜蘭,2023-10-30,9686
3094,聯傑,75,16,59,富邦-宜蘭,2023-10-30,9686
5512,力麒,58,0,58,富邦-宜蘭,2023-10-30,9686
00751B,元大AAA至A公司債,46,0,46,富邦-宜蘭,2023-10-30,9686
4121,優盛,40,0,40,富邦-宜蘭,2023-10-30,9686
9105,泰金寶-DR,50,20,30,富邦-宜蘭,2023-10-30,9686
4960,誠美材,33,5,28,富邦-宜蘭,2023-10-30,9686
2356,英業達,32,4,28,富邦-宜蘭,2023-10-30,9686
6770,力積電,26,0,26,富邦-宜蘭,2023-10-30,9686
6492,生華科,32,7,25,富邦-宜蘭,2023-10-30,9686
2891,中信金,26,2,24,富邦-宜蘭,2023-10-30,9686
4128,中天,30,6,24,富邦-宜蘭,2023-10-30,9686
2618,長榮航,24,2,22,富邦-宜蘭,2023-10-30,9686
3709,鑫聯大投控,21,0,21,富邦-宜蘭,2023-10-30,9686
2609,陽明,26,6,20,富邦-宜蘭,2023-10-30,9686
5009,榮剛,20,1,19,富邦-宜蘭,2023-10-30,9686
2887,台新金,18,0,18,富邦-宜蘭,2023-10-30,9686
5880,合庫金,18,0,18,富邦-宜蘭,2023-10-30,9686
6168,宏齊,19,1,18,富邦-宜蘭,2023-10-30,9686
2301,光寶科,20,5,15,富邦-宜蘭,2023-10-30,9686
2881,富邦金,15,0,15,富邦-宜蘭,2023-10-30,9686
00933B,國泰10Y+金融債,15,0,15,富邦-宜蘭,2023-10-30,9686
00680L,元大美債20正2,15,0,15,富邦-宜蘭,2023-10-30,9686
2886,兆豐金,15,1,14,富邦-宜蘭,2023-10-30,9686
3041,揚智,14,0,14,富邦-宜蘭,2023-10-30,9686
00878,國泰永續高股息,25,12,13,富邦-宜蘭,2023-10-30,9686
1303,南亞,13,0,13,富邦-宜蘭,2023-10-30,9686
3325,旭品,19,7,12,富邦-宜蘭,2023-10-30,9686
3530,晶相光,16,5,11,富邦-宜蘭,2023-10-30,9686
3287,廣寰科,12,1,11,富邦-宜蘭,2023-10-30,9686
00931B,統一美債20年,10,0,10,富邦-宜蘭,2023-10-30,9686
8937,合騏,10,0,10,富邦-宜蘭,2023-10-30,9686
00696B,富邦美債20年,10,0,10,富邦-宜蘭,2023-10-30,9686
2885,元大金,10,1,9,富邦-宜蘭,2023-10-30,9686
2330,台積電,9,0,9,富邦-宜蘭,2023-10-30,9686
5347,世界,12,3,9,富邦-宜蘭,2023-10-30,9686
00679B,元大美債20年,8,0,8,富邦-宜蘭,2023-10-30,9686
8048,德勝,9,1,8,富邦-宜蘭,2023-10-30,9686
006208,富邦台50,7,0,7,富邦-宜蘭,2023-10-30,9686
2337,旺宏,11,4,7,富邦-宜蘭,2023-10-30,9686
1101,台泥,7,0,7,富邦-宜蘭,2023-10-30,9686
2453,凌群,8,1,7,富邦-宜蘭,2023-10-30,9686
6117,迎廣,26,19,7,富邦-宜蘭,2023-10-30,9686
2408,南亞科,8,1,7,富邦-宜蘭,2023-10-30,9686
4148,全宇生技-KY,7,0,7,富邦-宜蘭,2023-10-30,9686
6290,良維,7,0,7,富邦-宜蘭,2023-10-30,9686
5483,中美晶,7,0,7,富邦-宜蘭,2023-10-30,9686
8404,百和興業-KY,7,0,7,富邦-宜蘭,2023-10-30,9686
2402,毅嘉,7,0,7,富邦-宜蘭,2023-10-30,9686
00929,復華台灣科技優息,164,34,130,富邦-宜蘭,2023-10-31,9686
3322,建舜電,105,3,102,富邦-宜蘭,2023-10-31,9686
9919,康那香,100,4,96,富邦-宜蘭,2023-10-31,9686
3481,群創,107,35,72,富邦-宜蘭,2023-10-31,9686
2440,太空梭,70,0,70,富邦-宜蘭,2023-10-31,9686
0056,元大高股息,76,9,67,富邦-宜蘭,2023-10-31,9686
6443,元晶,72,17,55,富邦-宜蘭,2023-10-31,9686
2344,華邦電,61,10,51,富邦-宜蘭,2023-10-31,9686
00878,國泰永續高股息,55,4,51,富邦-宜蘭,2023-10-31,9686
2323,中環,50,0,50,富邦-宜蘭,2023-10-31,9686
6770,力積電,65,25,40,富邦-宜蘭,2023-10-31,9686
4108,懷特,42,2,40,富邦-宜蘭,2023-10-31,9686
3576,聯合再生,54,15,39,富邦-宜蘭,2023-10-31,9686
3094,聯傑,41,6,35,富邦-宜蘭,2023-10-31,9686
3265,台星科,32,0,32,富邦-宜蘭,2023-10-31,9686
3176,基亞,40,9,31,富邦-宜蘭,2023-10-31,9686
2314,台揚,31,0,31,富邦-宜蘭,2023-10-31,9686
6235,華孚,66,36,30,富邦-宜蘭,2023-10-31,9686
4154,樂威科-KY,30,0,30,富邦-宜蘭,2023-10-31,9686
4960,誠美材,40,11,29,富邦-宜蘭,2023-10-31,9686
2324,仁寶,29,0,29,富邦-宜蘭,2023-10-31,9686
00712,復華富時不動產,30,2,28,富邦-宜蘭,2023-10-31,9686
2356,英業達,32,6,26,富邦-宜蘭,2023-10-31,9686
2609,陽明,27,3,24,富邦-宜蘭,2023-10-31,9686
5425,台半,25,3,22,富邦-宜蘭,2023-10-31,9686
3231,緯創,68,47,21,富邦-宜蘭,2023-10-31,9686
6441,廣錠,21,1,20,富邦-宜蘭,2023-10-31,9686
9934,成霖,20,0,20,富邦-宜蘭,2023-10-31,9686
1536,和大,20,0,20,富邦-宜蘭,2023-10-31,9686
2329,華泰,34,15,19,富邦-宜蘭,2023-10-31,9686
6461,益得,21,2,19,富邦-宜蘭,2023-10-31,9686
2515,中工,23,4,19,富邦-宜蘭,2023-10-31,9686
00715L,期街口布蘭特正2,18,0,18,富邦-宜蘭,2023-10-31,9686
2303,聯電,17,0,17,富邦-宜蘭,2023-10-31,9686
2330,台積電,19,2,17,富邦-宜蘭,2023-10-31,9686
911868,同方友友-DR,16,0,16,富邦-宜蘭,2023-10-31,9686
3484,崧騰,16,0,16,富邦-宜蘭,2023-10-31,9686
1524,耿鼎,35,19,16,富邦-宜蘭,2023-10-31,9686
3686,達能,17,1,16,富邦-宜蘭,2023-10-31,9686
00692,富邦公司治理,15,0,15,富邦-宜蘭,2023-10-31,9686
2382,廣達,43,28,15,富邦-宜蘭,2023-10-31,9686
3078,僑威,16,3,13,富邦-宜蘭,2023-10-31,9686
5410,國眾,13,0,13,富邦-宜蘭,2023-10-31,9686
3715,定穎投控,173,161,12,富邦-宜蘭,2023-10-31,9686
3202,樺晟,12,0,12,富邦-宜蘭,2023-10-31,9686
6116,彩晶,12,0,12,富邦-宜蘭,2023-10-31,9686
4906,正文,12,0,12,富邦-宜蘭,2023-10-31,9686
1731,美吾華,12,0,12,富邦-宜蘭,2023-10-31,9686
2417,圓剛,15,3,12,富邦-宜蘭,2023-10-31,9686
4188,安克,15,3,12,富邦-宜蘭,2023-10-31,9686
00929,復華台灣科技優息,118,4,114,富邦-宜蘭,2023-11-01,9686
3094,聯傑,78,6,72,富邦-宜蘭,2023-11-01,9686
00712,復華富時不動產,76,4,72,富邦-宜蘭,2023-11-01,9686
2618,長榮航,177,107,70,富邦-宜蘭,2023-11-01,9686
1731,美吾華,70,2,68,富邦-宜蘭,2023-11-01,9686
00878,國泰永續高股息,55,2,53,富邦-宜蘭,2023-11-01,9686
00715L,期街口布蘭特正2,53,1,52,富邦-宜蘭,2023-11-01,9686
00893,國泰智能電動車,40,1,39,富邦-宜蘭,2023-11-01,9686
3041,揚智,37,2,35,富邦-宜蘭,2023-11-01,9686
4915,致伸,34,1,33,富邦-宜蘭,2023-11-01,9686
2313,華通,34,8,26,富邦-宜蘭,2023-11-01,9686
3016,嘉晶,24,1,23,富邦-宜蘭,2023-11-01,9686
5328,華容,22,0,22,富邦-宜蘭,2023-11-01,9686
3322,建舜電,33,12,21,富邦-宜蘭,2023-11-01,9686
3576,聯合再生,22,2,20,富邦-宜蘭,2023-11-01,9686
2610,華航,34,15,19,富邦-宜蘭,2023-11-01,9686
8255,朋程,18,0,18,富邦-宜蘭,2023-11-01,9686
2002,中鋼,17,0,17,富邦-宜蘭,2023-11-01,9686
00679B,元大美債20年,16,0,16,富邦-宜蘭,2023-11-01,9686
00931B,統一美債20年,16,0,16,富邦-宜蘭,2023-11-01,9686
2409,友達,15,0,15,富邦-宜蘭,2023-11-01,9686
3035,智原,75,60,15,富邦-宜蘭,2023-11-01,9686
2543,皇昌,51,37,14,富邦-宜蘭,2023-11-01,9686
4960,誠美材,15,2,13,富邦-宜蘭,2023-11-01,9686
00922,國泰台灣領袖50,14,2,12,富邦-宜蘭,2023-11-01,9686
8110,華東,14,2,12,富邦-宜蘭,2023-11-01,9686
2915,潤泰全,11,0,11,富邦-宜蘭,2023-11-01,9686
3122,笙泉,24,13,11,富邦-宜蘭,2023-11-01,9686
2104,國際中橡,17,6,11,富邦-宜蘭,2023-11-01,9686
00902,中信電池及儲能,10,0,10,富邦-宜蘭,2023-11-01,9686
1907,永豐餘,10,0,10,富邦-宜蘭,2023-11-01,9686
00923,群益台ESG低碳50,10,0,10,富邦-宜蘭,2023-11-01,9686
6285,啟��,10,1,9,富邦-宜蘭,2023-11-01,9686
00885,富邦越南,9,0,9,富邦-宜蘭,2023-11-01,9686
8044,網家,20,11,9,富邦-宜蘭,2023-11-01,9686
2406,國碩,13,4,9,富邦-宜蘭,2023-11-01,9686
1504,東元,11,2,9,富邦-宜蘭,2023-11-01,9686
3605,宏致,8,0,8,富邦-宜蘭,2023-11-01,9686
6117,迎廣,24,16,8,富邦-宜蘭,2023-11-01,9686
2317,鴻海,12,4,8,富邦-宜蘭,2023-11-01,9686
2609,陽明,13,6,7,富邦-宜蘭,2023-11-01,9686
2356,英業達,9,2,7,富邦-宜蘭,2023-11-01,9686
00753L,中信中國50正2,7,0,7,富邦-宜蘭,2023-11-01,9686
2388,威盛,20,13,7,富邦-宜蘭,2023-11-01,9686
00688L,國泰20年美債正2,7,0,7,富邦-宜蘭,2023-11-01,9686
8176,智捷,9,2,7,富邦-宜蘭,2023-11-01,9686
2358,廷鑫,10,3,7,富邦-宜蘭,2023-11-01,9686
2731,雄獅,11,5,6,富邦-宜蘭,2023-11-01,9686
3062,建漢,6,0,6,富邦-宜蘭,2023-11-01,9686
6579,研揚,6,0,6,富邦-宜蘭,2023-11-01,9686
2543,皇昌,129,30,99,富邦-宜蘭,2023-11-02,9686
2883,凱基金,104,6,98,富邦-宜蘭,2023-11-02,9686
3715,定穎投控,199,109,90,富邦-宜蘭,2023-11-02,9686
00751B,元大AAA至A公司債,71,1,70,富邦-宜蘭,2023-11-02,9686
2367,燿華,56,18,38,富邦-宜蘭,2023-11-02,9686
00878,國泰永續高股息,29,3,26,富邦-宜蘭,2023-11-02,9686
00934,中信成長高股息,25,0,25,富邦-宜蘭,2023-11-02,9686
3380,明泰,27,2,25,富邦-宜蘭,2023-11-02,9686
2376,技嘉,60,37,23,富邦-宜蘭,2023-11-02,9686
6492,生華科,20,0,20,富邦-宜蘭,2023-11-02,9686
00712,復華富時不動產,26,6,20,富邦-宜蘭,2023-11-02,9686
2301,光寶科,47,28,19,富邦-宜蘭,2023-11-02,9686
2356,英業達,28,9,19,富邦-宜蘭,2023-11-02,9686
8926,台汽電,19,0,19,富邦-宜蘭,2023-11-02,9686
00687B,國泰20年美債,31,13,18,富邦-宜蘭,2023-11-02,9686
2352,佳世達,44,26,18,富邦-宜蘭,2023-11-02,9686
3038,全台,17,0,17,富邦-宜蘭,2023-11-02,9686
2405,輔信,20,3,17,富邦-宜蘭,2023-11-02,9686
2324,仁寶,31,15,16,富邦-宜蘭,2023-11-02,9686
6282,康舒,13,0,13,富邦-宜蘭,2023-11-02,9686
4915,致伸,16,3,13,富邦-宜蘭,2023-11-02,9686
6168,宏齊,13,1,12,富邦-宜蘭,2023-11-02,9686
2888,新光金,12,0,12,富邦-宜蘭,2023-11-02,9686
1101,台泥,25,13,12,富邦-宜蘭,2023-11-02,9686
00753L,中信中國50正2,20,9,11,富邦-宜蘭,2023-11-02,9686
6190,萬泰科,11,0,11,富邦-宜蘭,2023-11-02,9686
6485,點序,22,12,10,富邦-宜蘭,2023-11-02,9686
9907,統一實,10,0,10,富邦-宜蘭,2023-11-02,9686
3576,聯合再生,10,0,10,富邦-宜蘭,2023-11-02,9686
4933,友輝,10,0,10,富邦-宜蘭,2023-11-02,9686
4128,中天,10,0,10,富邦-宜蘭,2023-11-02,9686
6116,彩晶,10,0,10,富邦-宜蘭,2023-11-02,9686
9934,成霖,10,0,10,富邦-宜蘭,2023-11-02,9686
6569,醫揚,10,1,9,富邦-宜蘭,2023-11-02,9686
3169,亞信,19,10,9,富邦-宜蘭,2023-11-02,9686
00642U,期元大S＆P石油,10,1,9,富邦-宜蘭,2023-11-02,9686
9105,泰金寶-DR,22,14,8,富邦-宜蘭,2023-11-02,9686
6541,泰福-KY,8,0,8,富邦-宜蘭,2023-11-02,9686
3004,豐達科,8,0,8,富邦-宜蘭,2023-11-02,9686
6451,訊芯-KY,17,9,8,富邦-宜蘭,2023-11-02,9686
1471,首利,7,0,7,富邦-宜蘭,2023-11-02,9686
3704,合勤控,17,10,7,富邦-宜蘭,2023-11-02,9686
3013,晟銘電,7,0,7,富邦-宜蘭,2023-11-02,9686
3122,笙泉,9,2,7,富邦-宜蘭,2023-11-02,9686
3094,聯傑,47,40,7,富邦-宜蘭,2023-11-02,9686
1524,耿鼎,19,13,6,富邦-宜蘭,2023-11-02,9686
2344,華邦電,14,8,6,富邦-宜蘭,2023-11-02,9686
8110,華東,8,2,6,富邦-宜蘭,2023-11-02,9686
00673R,期元大S＆P原油反1,40,34,6,富邦-宜蘭,2023-11-02,9686
4162,智擎,9,3,6,富邦-宜蘭,2023-11-02,9686
00934,中信成長高股息,165,1,164,富邦-宜蘭,2023-11-03,9686
2543,皇昌,161,0,161,富邦-宜蘭,2023-11-03,9686
00900,富邦特選高股息30,101,2,99,富邦-宜蘭,2023-11-03,9686
3373,熱映,91,1,90,富邦-宜蘭,2023-11-03,9686
00919,群益台灣精選高息,95,8,87,富邦-宜蘭,2023-11-03,9686
00712,復華富時不動產,105,37,68,富邦-宜蘭,2023-11-03,9686
6538,倉和,60,1,59,富邦-宜蘭,2023-11-03,9686
1815,富喬,65,28,37,富邦-宜蘭,2023-11-03,9686
2850,新產,36,0,36,富邦-宜蘭,2023-11-03,9686
2618,長榮航,94,61,33,富邦-宜蘭,2023-11-03,9686
0056,元大高股息,42,11,31,富邦-宜蘭,2023-11-03,9686
6161,捷波,30,0,30,富邦-宜蘭,2023-11-03,9686
6118,建達,39,9,30,富邦-宜蘭,2023-11-03,9686
2816,旺旺保,31,1,30,富邦-宜蘭,2023-11-03,9686
3038,全台,31,5,26,富邦-宜蘭,2023-11-03,9686
8150,南茂,24,2,22,富邦-宜蘭,2023-11-03,9686
3231,緯創,55,34,21,富邦-宜蘭,2023-11-03,9686
2458,義隆,26,5,21,富邦-宜蘭,2023-11-03,9686
3322,建舜電,22,2,20,富邦-宜蘭,2023-11-03,9686
2104,國際中橡,20,0,20,富邦-宜蘭,2023-11-03,9686
2317,鴻海,79,60,19,富邦-宜蘭,2023-11-03,9686
1558,伸興,16,0,16,富邦-宜蘭,2023-11-03,9686
6148,驊宏資,17,1,16,富邦-宜蘭,2023-11-03,9686
8176,智捷,15,0,15,富邦-宜蘭,2023-11-03,9686
4154,樂威科-KY,15,0,15,富邦-宜蘭,2023-11-03,9686
2485,兆赫,14,0,14,富邦-宜蘭,2023-11-03,9686
2354,鴻準,13,0,13,富邦-宜蘭,2023-11-03,9686
2417,圓剛,14,1,13,富邦-宜蘭,2023-11-03,9686
1312,國喬,13,0,13,富邦-宜蘭,2023-11-03,9686
00664R,國泰臺灣加權反1,12,0,12,富邦-宜蘭,2023-11-03,9686
6523,達爾膚,12,0,12,富邦-宜蘭,2023-11-03,9686
4746,台耀,12,0,12,富邦-宜蘭,2023-11-03,9686
6443,元晶,20,8,12,富邦-宜蘭,2023-11-03,9686
00687B,國泰20年美債,12,0,12,富邦-宜蘭,2023-11-03,9686
8046,南電,12,1,11,富邦-宜蘭,2023-11-03,9686
6237,驊訊,21,10,11,富邦-宜蘭,2023-11-03,9686
9958,世紀鋼,52,42,10,富邦-宜蘭,2023-11-03,9686
2867,三商壽,10,0,10,富邦-宜蘭,2023-11-03,9686
8111,立��,10,0,10,富邦-宜蘭,2023-11-03,9686
8404,百和興業-KY,10,0,10,富邦-宜蘭,2023-11-03,9686
5475,德宏,10,0,10,富邦-宜蘭,2023-11-03,9686
8163,達方,21,11,10,富邦-宜蘭,2023-11-03,9686
1303,南亞,10,0,10,富邦-宜蘭,2023-11-03,9686
1519,華城,24,14,10,富邦-宜蘭,2023-11-03,9686
5347,世界,9,0,9,富邦-宜蘭,2023-11-03,9686
3623,富晶通,12,3,9,富邦-宜蘭,2023-11-03,9686
6186,新潤,8,0,8,富邦-宜蘭,2023-11-03,9686
2630,亞航,12,4,8,富邦-宜蘭,2023-11-03,9686
2609,陽明,13,5,8,富邦-宜蘭,2023-11-03,9686
2382,廣達,13,6,7,富邦-宜蘭,2023-11-03,9686
2353,宏��,79,11,68,富邦-宜蘭,2023-11-06,9686
2486,一詮,81,21,60,富邦-宜蘭,2023-11-06,9686
4105,東洋,57,4,53,富邦-宜蘭,2023-11-06,9686
1471,首利,53,5,48,富邦-宜蘭,2023-11-06,9686
1721,三晃,40,8,32,富邦-宜蘭,2023-11-06,9686
3508,位速,32,2,30,富邦-宜蘭,2023-11-06,9686
2408,南亞科,30,1,29,富邦-宜蘭,2023-11-06,9686
6133,金橋,31,2,29,富邦-宜蘭,2023-11-06,9686
6418,詠昇,30,1,29,富邦-宜蘭,2023-11-06,9686
3163,波若威,28,2,26,富邦-宜蘭,2023-11-06,9686
2427,三商電,27,2,25,富邦-宜蘭,2023-11-06,9686
6112,邁達特,40,16,24,富邦-宜蘭,2023-11-06,9686
2002,中鋼,26,4,22,富邦-宜蘭,2023-11-06,9686
8088,品安,21,0,21,富邦-宜蘭,2023-11-06,9686
00632R,元大台灣50反1,26,5,21,富邦-宜蘭,2023-11-06,9686
00933B,國泰10Y+金融債,46,27,19,富邦-宜蘭,2023-11-06,9686
6139,亞翔,20,4,16,富邦-宜蘭,2023-11-06,9686
2390,云辰,23,7,16,富邦-宜蘭,2023-11-06,9686
00751B,元大AAA至A公司債,15,0,15,富邦-宜蘭,2023-11-06,9686
6263,普萊德,15,0,15,富邦-宜蘭,2023-11-06,9686
2743,山富,17,2,15,富邦-宜蘭,2023-11-06,9686
6274,台燿,16,2,14,富邦-宜蘭,2023-11-06,9686
00929,復華台灣科技優息,73,59,14,富邦-宜蘭,2023-11-06,9686
5880,合庫金,21,7,14,富邦-宜蘭,2023-11-06,9686
2388,威盛,181,168,13,富邦-宜蘭,2023-11-06,9686
00720B,元大投資級公司債,13,0,13,富邦-宜蘭,2023-11-06,9686
2369,菱生,13,0,13,富邦-宜蘭,2023-11-06,9686
00715L,期街口布蘭特正2,13,0,13,富邦-宜蘭,2023-11-06,9686
00679B,元大美債20年,32,20,12,富邦-宜蘭,2023-11-06,9686
6182,合晶,12,0,12,富邦-宜蘭,2023-11-06,9686
2417,圓剛,12,0,12,富邦-宜蘭,2023-11-06,9686
2329,華泰,54,42,12,富邦-宜蘭,2023-11-06,9686
2363,矽統,108,97,11,富邦-宜蘭,2023-11-06,9686
2867,三商壽,16,5,11,富邦-宜蘭,2023-11-06,9686
6016,康和證,10,0,10,富邦-宜蘭,2023-11-06,9686
1714,和桐,10,0,10,富邦-宜蘭,2023-11-06,9686
6585,鼎基,10,0,10,富邦-宜蘭,2023-11-06,9686
1905,華紙,10,0,10,富邦-宜蘭,2023-11-06,9686
00676R,富邦臺灣加權反1,10,0,10,富邦-宜蘭,2023-11-06,9686
2484,希華,10,0,10,富邦-宜蘭,2023-11-06,9686
4123,晟德,10,0,10,富邦-宜蘭,2023-11-06,9686
9934,成霖,10,0,10,富邦-宜蘭,2023-11-06,9686
3128,昇銳,10,0,10,富邦-宜蘭,2023-11-06,9686
9105,泰金寶-DR,10,0,10,富邦-宜蘭,2023-11-06,9686
1101,台泥,14,5,9,富邦-宜蘭,2023-11-06,9686
3006,晶豪科,10,1,9,富邦-宜蘭,2023-11-06,9686
3322,建舜電,10,1,9,富邦-宜蘭,2023-11-06,9686
8068,全達,18,9,9,富邦-宜蘭,2023-11-06,9686
5432,新門,8,0,8,富邦-宜蘭,2023-11-06,9686
1504,東元,8,0,8,富邦-宜蘭,2023-11-06,9686
2618,長榮航,202,12,190,富邦-宜蘭,2023-11-07,9686
1815,富喬,211,59,152,富邦-宜蘭,2023-11-07,9686
00929,復華台灣科技優息,107,49,58,富邦-宜蘭,2023-11-07,9686
2634,漢翔,59,1,58,富邦-宜蘭,2023-11-07,9686
00671R,富邦NASDAQ反1,52,0,52,富邦-宜蘭,2023-11-07,9686
8068,全達,46,0,46,富邦-宜蘭,2023-11-07,9686
2324,仁寶,37,3,34,富邦-宜蘭,2023-11-07,9686
1314,中石化,30,0,30,富邦-宜蘭,2023-11-07,9686
1721,三晃,39,10,29,富邦-宜蘭,2023-11-07,9686
6598,ABC-KY,30,1,29,富邦-宜蘭,2023-11-07,9686
2363,矽統,104,75,29,富邦-宜蘭,2023-11-07,9686
00665L,富邦�琤肭磪囓�2,27,0,27,富邦-宜蘭,2023-11-07,9686
2515,中工,36,10,26,富邦-宜蘭,2023-11-07,9686
3605,宏致,25,0,25,富邦-宜蘭,2023-11-07,9686
3570,大塚,25,0,25,富邦-宜蘭,2023-11-07,9686
3231,緯創,60,36,24,富邦-宜蘭,2023-11-07,9686
4167,松瑞藥,55,31,24,富邦-宜蘭,2023-11-07,9686
2486,一詮,74,52,22,富邦-宜蘭,2023-11-07,9686
2892,第一金,36,14,22,富邦-宜蘭,2023-11-07,9686
2401,凌陽,38,17,21,富邦-宜蘭,2023-11-07,9686
00935,野村臺灣新科技50,31,10,21,富邦-宜蘭,2023-11-07,9686
9945,潤泰新,21,0,21,富邦-宜蘭,2023-11-07,9686
2439,美律,23,6,17,富邦-宜蘭,2023-11-07,9686
8927,北基,16,0,16,富邦-宜蘭,2023-11-07,9686
1301,台塑,15,1,14,富邦-宜蘭,2023-11-07,9686
2356,英業達,24,10,14,富邦-宜蘭,2023-11-07,9686
2317,鴻海,22,9,13,富邦-宜蘭,2023-11-07,9686
2388,威盛,54,41,13,富邦-宜蘭,2023-11-07,9686
00679B,元大美債20年,16,3,13,富邦-宜蘭,2023-11-07,9686
1795,美時,28,16,12,富邦-宜蘭,2023-11-07,9686
1471,首利,16,4,12,富邦-宜蘭,2023-11-07,9686
2408,南亞科,14,2,12,富邦-宜蘭,2023-11-07,9686
2371,大同,11,0,11,富邦-宜蘭,2023-11-07,9686
1519,華城,14,3,11,富邦-宜蘭,2023-11-07,9686
2344,華邦電,13,2,11,富邦-宜蘭,2023-11-07,9686
6104,創惟,11,0,11,富邦-宜蘭,2023-11-07,9686
6494,九齊,11,0,11,富邦-宜蘭,2023-11-07,9686
2358,廷鑫,11,0,11,富邦-宜蘭,2023-11-07,9686
00642U,期元大S＆P石油,11,0,11,富邦-宜蘭,2023-11-07,9686
8044,網家,11,0,11,富邦-宜蘭,2023-11-07,9686
3017,奇鋐,14,3,11,富邦-宜蘭,2023-11-07,9686
6116,彩晶,10,0,10,富邦-宜蘭,2023-11-07,9686
6123,上奇,10,0,10,富邦-宜蘭,2023-11-07,9686
1103,嘉泥,10,0,10,富邦-宜蘭,2023-11-07,9686
2542,興富發,10,0,10,富邦-宜蘭,2023-11-07,9686
9907,統一實,10,0,10,富邦-宜蘭,2023-11-07,9686
6285,啟��,11,2,9,富邦-宜蘭,2023-11-07,9686
00715L,期街口布蘭特正2,9,0,9,富邦-宜蘭,2023-11-07,9686
6185,幃翔,11,2,9,富邦-宜蘭,2023-11-07,9686
8110,華東,9,0,9,富邦-宜蘭,2023-11-07,9686
00936,台新永續高息中小,306,1,305,富邦-宜蘭,2023-11-08,9686
00878,國泰永續高股息,226,30,196,富邦-宜蘭,2023-11-08,9686
2363,矽統,186,50,136,富邦-宜蘭,2023-11-08,9686
00712,復華富時不動產,110,1,109,富邦-宜蘭,2023-11-08,9686
00676R,富邦臺灣加權反1,55,0,55,富邦-宜蘭,2023-11-08,9686
00919,群益台灣精選高息,69,22,47,富邦-宜蘭,2023-11-08,9686
00900,富邦特選高股息30,42,5,37,富邦-宜蘭,2023-11-08,9686
2867,三商壽,25,0,25,富邦-宜蘭,2023-11-08,9686
8936,國統,25,1,24,富邦-宜蘭,2023-11-08,9686
3706,神達,24,0,24,富邦-宜蘭,2023-11-08,9686
4167,松瑞藥,27,5,22,富邦-宜蘭,2023-11-08,9686
2486,一詮,117,97,20,富邦-宜蘭,2023-11-08,9686
2614,東森,20,0,20,富邦-宜蘭,2023-11-08,9686
1781,合世,20,0,20,富邦-宜蘭,2023-11-08,9686
8088,品安,19,0,19,富邦-宜蘭,2023-11-08,9686
2303,聯電,23,5,18,富邦-宜蘭,2023-11-08,9686
3006,晶豪科,18,0,18,富邦-宜蘭,2023-11-08,9686
2515,中工,17,0,17,富邦-宜蘭,2023-11-08,9686
3545,敦泰,20,4,16,富邦-宜蘭,2023-11-08,9686
2002,中鋼,25,10,15,富邦-宜蘭,2023-11-08,9686
00632R,元大台灣50反1,15,0,15,富邦-宜蘭,2023-11-08,9686
5521,工信,15,0,15,富邦-宜蘭,2023-11-08,9686
2337,旺宏,14,0,14,富邦-宜蘭,2023-11-08,9686
2488,漢平,17,3,14,富邦-宜蘭,2023-11-08,9686
3481,群創,16,4,12,富邦-宜蘭,2023-11-08,9686
6933,AMAX-KY,14,2,12,富邦-宜蘭,2023-11-08,9686
2476,鉅祥,12,0,12,富邦-宜蘭,2023-11-08,9686
3094,聯傑,22,11,11,富邦-宜蘭,2023-11-08,9686
2353,宏��,12,1,11,富邦-宜蘭,2023-11-08,9686
1815,富喬,47,36,11,富邦-宜蘭,2023-11-08,9686
1609,大亞,14,3,11,富邦-宜蘭,2023-11-08,9686
6488,環球晶,10,0,10,富邦-宜蘭,2023-11-08,9686
00671R,富邦NASDAQ反1,10,0,10,富邦-宜蘭,2023-11-08,9686
4916,事欣科,10,0,10,富邦-宜蘭,2023-11-08,9686
2845,遠東銀,10,0,10,富邦-宜蘭,2023-11-08,9686
1806,冠軍,10,0,10,富邦-宜蘭,2023-11-08,9686
00935,野村臺灣新科技50,13,3,10,富邦-宜蘭,2023-11-08,9686
2104,國際中橡,10,0,10,富邦-宜蘭,2023-11-08,9686
6138,茂達,11,1,10,富邦-宜蘭,2023-11-08,9686
6523,達爾膚,10,1,9,富邦-宜蘭,2023-11-08,9686
1471,首利,10,1,9,富邦-宜蘭,2023-11-08,9686
1319,東陽,14,5,9,富邦-宜蘭,2023-11-08,9686
1789,神隆,9,0,9,富邦-宜蘭,2023-11-08,9686
6901,鑽石投資,13,5,8,富邦-宜蘭,2023-11-08,9686
1568,倉佑,9,1,8,富邦-宜蘭,2023-11-08,9686
6188,廣明,44,36,8,富邦-宜蘭,2023-11-08,9686
6531,愛普*,21,13,8,富邦-宜蘭,2023-11-08,9686
2388,威盛,27,20,7,富邦-宜蘭,2023-11-08,9686
2376,技嘉,84,77,7,富邦-宜蘭,2023-11-08,9686
5516,雙喜,7,0,7,富邦-宜蘭,2023-11-08,9686
00632R,元大台灣50反1,356,0,356,富邦-宜蘭,2023-11-09,9686
00664R,國泰臺灣加權反1,300,0,300,富邦-宜蘭,2023-11-09,9686
00936,台新永續高息中小,128,0,128,富邦-宜蘭,2023-11-09,9686
3049,精金,120,5,115,富邦-宜蘭,2023-11-09,9686
00929,復華台灣科技優息,145,47,98,富邦-宜蘭,2023-11-09,9686
2412,中華電,45,0,45,富邦-宜蘭,2023-11-09,9686
2329,華泰,138,95,43,富邦-宜蘭,2023-11-09,9686
2451,創見,65,22,43,富邦-宜蘭,2023-11-09,9686
00688L,國泰20年美債正2,50,14,36,富邦-宜蘭,2023-11-09,9686
2888,新光金,40,5,35,富邦-宜蘭,2023-11-09,9686
1802,台玻,30,0,30,富邦-宜蘭,2023-11-09,9686
6285,啟��,46,17,29,富邦-宜蘭,2023-11-09,9686
3013,晟銘電,32,4,28,富邦-宜蘭,2023-11-09,9686
2324,仁寶,27,2,25,富邦-宜蘭,2023-11-09,9686
5609,中菲行,24,0,24,富邦-宜蘭,2023-11-09,9686
00878,國泰永續高股息,29,7,22,富邦-宜蘭,2023-11-09,9686
6530,創威,25,3,22,富邦-宜蘭,2023-11-09,9686
00935,野村臺灣新科技50,23,1,22,富邦-宜蘭,2023-11-09,9686
3041,揚智,30,8,22,富邦-宜蘭,2023-11-09,9686
5347,世界,22,1,21,富邦-宜蘭,2023-11-09,9686
00751B,元大AAA至A公司債,21,0,21,富邦-宜蘭,2023-11-09,9686
1789,神隆,20,0,20,富邦-宜蘭,2023-11-09,9686
2405,輔信,20,0,20,富邦-宜蘭,2023-11-09,9686
8936,國統,31,11,20,富邦-宜蘭,2023-11-09,9686
00934,中信成長高股息,19,0,19,富邦-宜蘭,2023-11-09,9686
2850,新產,18,0,18,富邦-宜蘭,2023-11-09,9686
2515,中工,17,0,17,富邦-宜蘭,2023-11-09,9686
4533,協易機,37,21,16,富邦-宜蘭,2023-11-09,9686
2352,佳世達,30,14,16,富邦-宜蘭,2023-11-09,9686
00933B,國泰10Y+金融債,22,8,14,富邦-宜蘭,2023-11-09,9686
2634,漢翔,14,0,14,富邦-宜蘭,2023-11-09,9686
3122,笙泉,37,24,13,富邦-宜蘭,2023-11-09,9686
2427,三商電,19,6,13,富邦-宜蘭,2023-11-09,9686
2376,技嘉,41,29,12,富邦-宜蘭,2023-11-09,9686
8024,佑華,11,0,11,富邦-宜蘭,2023-11-09,9686
6684,安格,13,2,11,富邦-宜蘭,2023-11-09,9686
4974,亞泰,11,0,11,富邦-宜蘭,2023-11-09,9686
00680L,元大美債20正2,13,2,11,富邦-宜蘭,2023-11-09,9686
6284,佳邦,10,0,10,富邦-宜蘭,2023-11-09,9686
1809,中釉,10,0,10,富邦-宜蘭,2023-11-09,9686
2104,國際中橡,10,0,10,富邦-宜蘭,2023-11-09,9686
4906,正文,12,2,10,富邦-宜蘭,2023-11-09,9686
2542,興富發,10,0,10,富邦-宜蘭,2023-11-09,9686
4128,中天,19,9,10,富邦-宜蘭,2023-11-09,9686
3702,大聯大,12,2,10,富邦-宜蘭,2023-11-09,9686
3617,碩天,12,3,9,富邦-宜蘭,2023-11-09,9686
2867,三商壽,10,1,9,富邦-宜蘭,2023-11-09,9686
2486,一詮,61,52,9,富邦-宜蘭,2023-11-09,9686
1515,力山,9,1,8,富邦-宜蘭,2023-11-09,9686
3481,群創,19,11,8,富邦-宜蘭,2023-11-09,9686
2883,凱基金,502,8,494,富邦-宜蘭,2023-11-10,9686
00676R,富邦臺灣加權反1,300,0,300,富邦-宜蘭,2023-11-10,9686
2324,仁寶,229,2,227,富邦-宜蘭,2023-11-10,9686
3231,緯創,232,47,185,富邦-宜蘭,2023-11-10,9686
3049,精金,170,0,170,富邦-宜蘭,2023-11-10,9686
00936,台新永續高息中小,168,1,167,富邦-宜蘭,2023-11-10,9686
00671R,富邦NASDAQ反1,150,0,150,富邦-宜蘭,2023-11-10,9686
00929,復華台灣科技優息,151,33,118,富邦-宜蘭,2023-11-10,9686
6216,居易,131,14,117,富邦-宜蘭,2023-11-10,9686
1314,中石化,75,0,75,富邦-宜蘭,2023-11-10,9686
00878,國泰永續高股息,69,2,67,富邦-宜蘭,2023-11-10,9686
00720B,元大投資級公司債,59,2,57,富邦-宜蘭,2023-11-10,9686
1210,大成,58,1,57,富邦-宜蘭,2023-11-10,9686
00919,群益台灣精選高息,60,4,56,富邦-宜蘭,2023-11-10,9686
00679B,元大美債20年,53,0,53,富邦-宜蘭,2023-11-10,9686
00751B,元大AAA至A公司債,53,0,53,富邦-宜蘭,2023-11-10,9686
2543,皇昌,52,1,51,富邦-宜蘭,2023-11-10,9686
00712,復華富時不動產,46,2,44,富邦-宜蘭,2023-11-10,9686
00900,富邦特選高股息30,38,0,38,富邦-宜蘭,2023-11-10,9686
00772B,中信高評級公司債,31,0,31,富邦-宜蘭,2023-11-10,9686
2313,華通,147,116,31,富邦-宜蘭,2023-11-10,9686
00688L,國泰20年美債正2,30,0,30,富邦-宜蘭,2023-11-10,9686
2606,裕民,40,10,30,富邦-宜蘭,2023-11-10,9686
5381,合正,30,1,29,富邦-宜蘭,2023-11-10,9686
2344,華邦電,31,5,26,富邦-宜蘭,2023-11-10,9686
6770,力積電,25,0,25,富邦-宜蘭,2023-11-10,9686
4743,合一,48,23,25,富邦-宜蘭,2023-11-10,9686
2352,佳世達,24,0,24,富邦-宜蘭,2023-11-10,9686
4960,誠美材,24,2,22,富邦-宜蘭,2023-11-10,9686
00935,野村臺灣新科技50,21,0,21,富邦-宜蘭,2023-11-10,9686
2356,英業達,21,0,21,富邦-宜蘭,2023-11-10,9686
3041,揚智,32,11,21,富邦-宜蘭,2023-11-10,9686
00753L,中信中國50正2,20,0,20,富邦-宜蘭,2023-11-10,9686
00687B,國泰20年美債,20,1,19,富邦-宜蘭,2023-11-10,9686
6523,達爾膚,18,0,18,富邦-宜蘭,2023-11-10,9686
2399,映泰,20,2,18,富邦-宜蘭,2023-11-10,9686
2608,嘉里大榮,18,0,18,富邦-宜蘭,2023-11-10,9686
5009,榮剛,18,0,18,富邦-宜蘭,2023-11-10,9686
00715L,期街口布蘭特正2,23,5,18,富邦-宜蘭,2023-11-10,9686
2850,新產,18,0,18,富邦-宜蘭,2023-11-10,9686
3035,智原,59,42,17,富邦-宜蘭,2023-11-10,9686
00907,永豐優息存股,17,0,17,富邦-宜蘭,2023-11-10,9686
4916,事欣科,17,0,17,富邦-宜蘭,2023-11-10,9686
2369,菱生,31,14,17,富邦-宜蘭,2023-11-10,9686
6530,創威,18,2,16,富邦-宜蘭,2023-11-10,9686
00633L,富邦上証正2,16,0,16,富邦-宜蘭,2023-11-10,9686
4128,中天,72,57,15,富邦-宜蘭,2023-11-10,9686
3322,建舜電,14,0,14,富邦-宜蘭,2023-11-10,9686
2609,陽明,14,1,13,富邦-宜蘭,2023-11-10,9686
3011,今皓,13,0,13,富邦-宜蘭,2023-11-10,9686
5521,工信,137,0,137,富邦-宜蘭,2023-11-13,9686
2882,國泰金,141,5,136,富邦-宜蘭,2023-11-13,9686
2618,長榮航,121,16,105,富邦-宜蘭,2023-11-13,9686
00935,野村臺灣新科技50,103,0,103,富邦-宜蘭,2023-11-13,9686
00878,國泰永續高股息,109,16,93,富邦-宜蘭,2023-11-13,9686
6216,居易,135,60,75,富邦-宜蘭,2023-11-13,9686
2852,第一保,60,0,60,富邦-宜蘭,2023-11-13,9686
2888,新光金,54,1,53,富邦-宜蘭,2023-11-13,9686
8429,金麗-KY,50,0,50,富邦-宜蘭,2023-11-13,9686
6603,富強鑫,48,0,48,富邦-宜蘭,2023-11-13,9686
3049,精金,50,5,45,富邦-宜蘭,2023-11-13,9686
00900,富邦特選高股息30,40,0,40,富邦-宜蘭,2023-11-13,9686
2543,皇昌,82,44,38,富邦-宜蘭,2023-11-13,9686
6111,大宇資,30,1,29,富邦-宜蘭,2023-11-13,9686
00679B,元大美債20年,29,0,29,富邦-宜蘭,2023-11-13,9686
2609,陽明,27,1,26,富邦-宜蘭,2023-11-13,9686
3236,千如,25,0,25,富邦-宜蘭,2023-11-13,9686
00751B,元大AAA至A公司債,24,0,24,富邦-宜蘭,2023-11-13,9686
2382,廣達,33,10,23,富邦-宜蘭,2023-11-13,9686
00687B,國泰20年美債,22,0,22,富邦-宜蘭,2023-11-13,9686
2401,凌陽,22,1,21,富邦-宜蘭,2023-11-13,9686
1434,福懋,36,15,21,富邦-宜蘭,2023-11-13,9686
5483,中美晶,27,6,21,富邦-宜蘭,2023-11-13,9686
2542,興富發,20,0,20,富邦-宜蘭,2023-11-13,9686
6139,亞翔,27,8,19,富邦-宜蘭,2023-11-13,9686
2204,中華,21,3,18,富邦-宜蘭,2023-11-13,9686
1795,美時,17,1,16,富邦-宜蘭,2023-11-13,9686
4960,誠美材,16,1,15,富邦-宜蘭,2023-11-13,9686
9105,泰金寶-DR,15,0,15,富邦-宜蘭,2023-11-13,9686
4128,中天,19,5,14,富邦-宜蘭,2023-11-13,9686
3402,漢科,30,16,14,富邦-宜蘭,2023-11-13,9686
2605,新興,14,0,14,富邦-宜蘭,2023-11-13,9686
00664R,國泰臺灣加權反1,13,0,13,富邦-宜蘭,2023-11-13,9686
6441,廣錠,13,0,13,富邦-宜蘭,2023-11-13,9686
1313,聯成,14,2,12,富邦-宜蘭,2023-11-13,9686
2885,元大金,15,3,12,富邦-宜蘭,2023-11-13,9686
1101,台泥,16,5,11,富邦-宜蘭,2023-11-13,9686
6197,佳必琪,12,1,11,富邦-宜蘭,2023-11-13,9686
3055,蔚華科,11,0,11,富邦-宜蘭,2023-11-13,9686
6901,鑽石投資,18,7,11,富邦-宜蘭,2023-11-13,9686
2337,旺宏,10,0,10,富邦-宜蘭,2023-11-13,9686
3022,威強電,10,0,10,富邦-宜蘭,2023-11-13,9686
2450,神腦,10,0,10,富邦-宜蘭,2023-11-13,9686
6290,良維,12,2,10,富邦-宜蘭,2023-11-13,9686
1108,幸福,10,0,10,富邦-宜蘭,2023-11-13,9686
3710,連展投控,10,0,10,富邦-宜蘭,2023-11-13,9686
1402,遠東新,10,0,10,富邦-宜蘭,2023-11-13,9686
3380,明泰,10,0,10,富邦-宜蘭,2023-11-13,9686
1612,宏泰,10,0,10,富邦-宜蘭,2023-11-13,9686
8933,愛地雅,10,0,10,富邦-宜蘭,2023-11-13,9686
2852,第一保,140,0,140,富邦-宜蘭,2023-11-14,9686
6282,康舒,128,16,112,富邦-宜蘭,2023-11-14,9686
2801,彰銀,101,0,101,富邦-宜蘭,2023-11-14,9686
2883,凱基金,102,10,92,富邦-宜蘭,2023-11-14,9686
3231,緯創,87,22,65,富邦-宜蘭,2023-11-14,9686
00929,復華台灣科技優息,117,53,64,富邦-宜蘭,2023-11-14,9686
2882,國泰金,61,6,55,富邦-宜蘭,2023-11-14,9686
1709,和益,48,0,48,富邦-宜蘭,2023-11-14,9686
2317,鴻海,106,59,47,富邦-宜蘭,2023-11-14,9686
2608,嘉里大榮,42,0,42,富邦-宜蘭,2023-11-14,9686
2618,長榮航,90,51,39,富邦-宜蘭,2023-11-14,9686
1515,力山,61,28,33,富邦-宜蘭,2023-11-14,9686
2313,華通,58,26,32,富邦-宜蘭,2023-11-14,9686
2915,潤泰全,34,2,32,富邦-宜蘭,2023-11-14,9686
00878,國泰永續高股息,48,20,28,富邦-宜蘭,2023-11-14,9686
6593,台灣銘板,29,1,28,富邦-宜蘭,2023-11-14,9686
00751B,元大AAA至A公司債,27,0,27,富邦-宜蘭,2023-11-14,9686
1815,富喬,59,34,25,富邦-宜蘭,2023-11-14,9686
1504,東元,24,1,23,富邦-宜蘭,2023-11-14,9686
00632R,元大台灣50反1,23,0,23,富邦-宜蘭,2023-11-14,9686
2002,中鋼,23,1,22,富邦-宜蘭,2023-11-14,9686
2352,佳世達,24,2,22,富邦-宜蘭,2023-11-14,9686
3094,聯傑,37,15,22,富邦-宜蘭,2023-11-14,9686
1609,大亞,22,1,21,富邦-宜蘭,2023-11-14,9686
6203,海韻電,21,0,21,富邦-宜蘭,2023-11-14,9686
00692,富邦公司治理,26,5,21,富邦-宜蘭,2023-11-14,9686
6461,益得,20,0,20,富邦-宜蘭,2023-11-14,9686
00715L,期街口布蘭特正2,29,9,20,富邦-宜蘭,2023-11-14,9686
3548,兆利,32,14,18,富邦-宜蘭,2023-11-14,9686
00936,台新永續高息中小,49,32,17,富邦-宜蘭,2023-11-14,9686
2465,麗臺,14,0,14,富邦-宜蘭,2023-11-14,9686
2515,中工,14,0,14,富邦-宜蘭,2023-11-14,9686
9907,統一實,20,7,13,富邦-宜蘭,2023-11-14,9686
4915,致伸,14,1,13,富邦-宜蘭,2023-11-14,9686
6933,AMAX-KY,14,1,13,富邦-宜蘭,2023-11-14,9686
2486,一詮,29,17,12,富邦-宜蘭,2023-11-14,9686
00712,復華富時不動產,12,0,12,富邦-宜蘭,2023-11-14,9686
5381,合正,11,0,11,富邦-宜蘭,2023-11-14,9686
3362,先進光,12,1,11,富邦-宜蘭,2023-11-14,9686
6274,台燿,10,0,10,富邦-宜蘭,2023-11-14,9686
8403,盛弘,10,0,10,富邦-宜蘭,2023-11-14,9686
00637L,元大滬深300正2,10,0,10,富邦-宜蘭,2023-11-14,9686
3710,連展投控,10,0,10,富邦-宜蘭,2023-11-14,9686
1524,耿鼎,10,0,10,富邦-宜蘭,2023-11-14,9686
2481,強茂,10,0,10,富邦-宜蘭,2023-11-14,9686
4114,健喬,10,0,10,富邦-宜蘭,2023-11-14,9686
00690,兆豐藍籌30,10,0,10,富邦-宜蘭,2023-11-14,9686
5355,佳總,10,0,10,富邦-宜蘭,2023-11-14,9686
6235,華孚,26,16,10,富邦-宜蘭,2023-11-14,9686
6598,ABC-KY,10,0,10,富邦-宜蘭,2023-11-14,9686
8234,新漢,203,0,203,富邦-宜蘭,2023-11-15,9686
00878,國泰永續高股息,267,123,144,富邦-宜蘭,2023-11-15,9686
00632R,元大台灣50反1,118,0,118,富邦-宜蘭,2023-11-15,9686
2882,國泰金,114,10,104,富邦-宜蘭,2023-11-15,9686
00680L,元大美債20正2,97,0,97,富邦-宜蘭,2023-11-15,9686
00751B,元大AAA至A公司債,85,6,79,富邦-宜蘭,2023-11-15,9686
2609,陽明,57,3,54,富邦-宜蘭,2023-11-15,9686
00720B,元大投資級公司債,55,7,48,富邦-宜蘭,2023-11-15,9686
2355,敬鵬,44,0,44,富邦-宜蘭,2023-11-15,9686
3706,神達,43,0,43,富邦-宜蘭,2023-11-15,9686
6122,擎邦,69,37,32,富邦-宜蘭,2023-11-15,9686
1515,力山,99,69,30,富邦-宜蘭,2023-11-15,9686
6118,建達,30,0,30,富邦-宜蘭,2023-11-15,9686
2641,正德,29,0,29,富邦-宜蘭,2023-11-15,9686
3715,定穎投控,33,7,26,富邦-宜蘭,2023-11-15,9686
1815,富喬,84,59,25,富邦-宜蘭,2023-11-15,9686
3094,聯傑,32,8,24,富邦-宜蘭,2023-11-15,9686
3013,晟銘電,27,3,24,富邦-宜蘭,2023-11-15,9686
2451,創見,26,2,24,富邦-宜蘭,2023-11-15,9686
3260,威剛,49,26,23,富邦-宜蘭,2023-11-15,9686
9105,泰金寶-DR,22,0,22,富邦-宜蘭,2023-11-15,9686
2539,櫻花建,21,0,21,富邦-宜蘭,2023-11-15,9686
4533,協易機,22,1,21,富邦-宜蘭,2023-11-15,9686
3188,鑫龍騰,20,0,20,富邦-宜蘭,2023-11-15,9686
1568,倉佑,23,4,19,富邦-宜蘭,2023-11-15,9686
2369,菱生,38,19,19,富邦-宜蘭,2023-11-15,9686
2353,宏��,18,0,18,富邦-宜蘭,2023-11-15,9686
2449,京元電子,23,6,17,富邦-宜蘭,2023-11-15,9686
00850,元大臺灣ESG永續,17,0,17,富邦-宜蘭,2023-11-15,9686
6441,廣錠,17,0,17,富邦-宜蘭,2023-11-15,9686
6603,富強鑫,32,16,16,富邦-宜蘭,2023-11-15,9686
2323,中環,23,8,15,富邦-宜蘭,2023-11-15,9686
3033,威健,14,0,14,富邦-宜蘭,2023-11-15,9686
2402,毅嘉,15,2,13,富邦-宜蘭,2023-11-15,9686
3035,智原,40,28,12,富邦-宜蘭,2023-11-15,9686
6139,亞翔,13,1,12,富邦-宜蘭,2023-11-15,9686
2359,所羅門,12,0,12,富邦-宜蘭,2023-11-15,9686
4128,中天,13,1,12,富邦-宜蘭,2023-11-15,9686
3548,兆利,16,5,11,富邦-宜蘭,2023-11-15,9686
1806,冠軍,12,1,11,富邦-宜蘭,2023-11-15,9686
2354,鴻準,11,0,11,富邦-宜蘭,2023-11-15,9686
5347,世界,13,2,11,富邦-宜蘭,2023-11-15,9686
1471,首利,11,0,11,富邦-宜蘭,2023-11-15,9686
3044,健鼎,20,10,10,富邦-宜蘭,2023-11-15,9686
6026,福邦證,10,0,10,富邦-宜蘭,2023-11-15,9686
9934,成霖,10,0,10,富邦-宜蘭,2023-11-15,9686
1452,宏益,30,20,10,富邦-宜蘭,2023-11-15,9686
6223,旺矽,11,1,10,富邦-宜蘭,2023-11-15,9686
3545,敦泰,18,8,10,富邦-宜蘭,2023-11-15,9686
00687B,國泰20年美債,12,3,9,富邦-宜蘭,2023-11-15,9686
00632R,元大台灣50反1,301,0,301,富邦-宜蘭,2023-11-16,9686
2352,佳世達,196,11,185,富邦-宜蘭,2023-11-16,9686
00878,國泰永續高股息,160,7,153,富邦-宜蘭,2023-11-16,9686
00671R,富邦NASDAQ反1,200,100,100,富邦-宜蘭,2023-11-16,9686
2363,矽統,141,42,99,富邦-宜蘭,2023-11-16,9686
00931B,統一美債20年,91,1,90,富邦-宜蘭,2023-11-16,9686
2915,潤泰全,86,0,86,富邦-宜蘭,2023-11-16,9686
00679B,元大美債20年,68,0,68,富邦-宜蘭,2023-11-16,9686
3481,群創,75,17,58,富邦-宜蘭,2023-11-16,9686
00688L,國泰20年美債正2,56,0,56,富邦-宜蘭,2023-11-16,9686
00664R,國泰臺灣加權反1,55,0,55,富邦-宜蘭,2023-11-16,9686
5512,力麒,66,14,52,富邦-宜蘭,2023-11-16,9686
00929,復華台灣科技優息,70,21,49,富邦-宜蘭,2023-11-16,9686
00751B,元大AAA至A公司債,46,0,46,富邦-宜蘭,2023-11-16,9686
1101,台泥,45,1,44,富邦-宜蘭,2023-11-16,9686
00935,野村臺灣新科技50,41,0,41,富邦-宜蘭,2023-11-16,9686
6203,海韻電,40,0,40,富邦-宜蘭,2023-11-16,9686
8088,品安,43,4,39,富邦-宜蘭,2023-11-16,9686
2367,燿華,46,13,33,富邦-宜蘭,2023-11-16,9686
2451,創見,31,2,29,富邦-宜蘭,2023-11-16,9686
2885,元大金,30,2,28,富邦-宜蘭,2023-11-16,9686
8176,智捷,50,23,27,富邦-宜蘭,2023-11-16,9686
2344,華邦電,51,25,26,富邦-宜蘭,2023-11-16,9686
6603,富強鑫,31,6,25,富邦-宜蘭,2023-11-16,9686
5213,亞昕,25,0,25,富邦-宜蘭,2023-11-16,9686
00753L,中信中國50正2,36,14,22,富邦-宜蘭,2023-11-16,9686
00712,復華富時不動產,28,8,20,富邦-宜蘭,2023-11-16,9686
2337,旺宏,18,0,18,富邦-宜蘭,2023-11-16,9686
3141,晶宏,21,3,18,富邦-宜蘭,2023-11-16,9686
2905,三商,18,0,18,富邦-宜蘭,2023-11-16,9686
00933B,國泰10Y+金融債,17,0,17,富邦-宜蘭,2023-11-16,9686
1568,倉佑,17,0,17,富邦-宜蘭,2023-11-16,9686
3715,定穎投控,26,10,16,富邦-宜蘭,2023-11-16,9686
9105,泰金寶-DR,15,0,15,富邦-宜蘭,2023-11-16,9686
1524,耿鼎,33,19,14,富邦-宜蘭,2023-11-16,9686
2388,威盛,47,33,14,富邦-宜蘭,2023-11-16,9686
3257,虹冠電,15,2,13,富邦-宜蘭,2023-11-16,9686
00650L,復華香港正2,20,8,12,富邦-宜蘭,2023-11-16,9686
4967,十銓,36,24,12,富邦-宜蘭,2023-11-16,9686
2504,國產,12,0,12,富邦-宜蘭,2023-11-16,9686
00715L,期街口布蘭特正2,10,0,10,富邦-宜蘭,2023-11-16,9686
3149,正達,10,0,10,富邦-宜蘭,2023-11-16,9686
3188,鑫龍騰,10,0,10,富邦-宜蘭,2023-11-16,9686
6933,AMAX-KY,11,1,10,富邦-宜蘭,2023-11-16,9686
1447,力鵬,10,0,10,富邦-宜蘭,2023-11-16,9686
0056,元大高股息,21,11,10,富邦-宜蘭,2023-11-16,9686
3260,威剛,17,8,9,富邦-宜蘭,2023-11-16,9686
00922,國泰台灣領袖50,12,3,9,富邦-宜蘭,2023-11-16,9686
2816,旺旺保,9,0,9,富邦-宜蘭,2023-11-16,9686
3276,宇環,14,5,9,富邦-宜蘭,2023-11-16,9686
5512,力麒,132,2,130,富邦-宜蘭,2023-11-17,9686
00931B,統一美債20年,95,0,95,富邦-宜蘭,2023-11-17,9686
00715L,期街口布蘭特正2,74,10,64,富邦-宜蘭,2023-11-17,9686
2618,長榮航,90,29,61,富邦-宜蘭,2023-11-17,9686
2367,燿華,62,5,57,富邦-宜蘭,2023-11-17,9686
2882,國泰金,75,22,53,富邦-宜蘭,2023-11-17,9686
2009,第一銅,50,0,50,富邦-宜蘭,2023-11-17,9686
00676R,富邦臺灣加權反1,50,0,50,富邦-宜蘭,2023-11-17,9686
3715,定穎投控,56,19,37,富邦-宜蘭,2023-11-17,9686
2609,陽明,33,0,33,富邦-宜蘭,2023-11-17,9686
1515,力山,63,32,31,富邦-宜蘭,2023-11-17,9686
00751B,元大AAA至A公司債,26,0,26,富邦-宜蘭,2023-11-17,9686
00927,群益半導體收益,25,0,25,富邦-宜蘭,2023-11-17,9686
2356,英業達,25,1,24,富邦-宜蘭,2023-11-17,9686
2399,映泰,30,7,23,富邦-宜蘭,2023-11-17,9686
00753L,中信中國50正2,22,0,22,富邦-宜蘭,2023-11-17,9686
00919,群益台灣精選高息,38,16,22,富邦-宜蘭,2023-11-17,9686
3188,鑫龍騰,20,0,20,富邦-宜蘭,2023-11-17,9686
2380,虹光,20,0,20,富邦-宜蘭,2023-11-17,9686
2312,金寶,25,5,20,富邦-宜蘭,2023-11-17,9686
2542,興富發,20,0,20,富邦-宜蘭,2023-11-17,9686
2884,玉山金,25,5,20,富邦-宜蘭,2023-11-17,9686
6770,力積電,22,3,19,富邦-宜蘭,2023-11-17,9686
00637L,元大滬深300正2,18,0,18,富邦-宜蘭,2023-11-17,9686
3260,威剛,22,5,17,富邦-宜蘭,2023-11-17,9686
1452,宏益,71,54,17,富邦-宜蘭,2023-11-17,9686
00712,復華富時不動產,46,30,16,富邦-宜蘭,2023-11-17,9686
2607,榮運,16,1,15,富邦-宜蘭,2023-11-17,9686
9950,萬國通,20,5,15,富邦-宜蘭,2023-11-17,9686
2801,彰銀,14,0,14,富邦-宜蘭,2023-11-17,9686
2412,中華電,13,0,13,富邦-宜蘭,2023-11-17,9686
2354,鴻準,13,0,13,富邦-宜蘭,2023-11-17,9686
6285,啟��,13,0,13,富邦-宜蘭,2023-11-17,9686
3450,聯鈞,20,8,12,富邦-宜蘭,2023-11-17,9686
6108,競國,12,0,12,富邦-宜蘭,2023-11-17,9686
3041,揚智,61,50,11,富邦-宜蘭,2023-11-17,9686
6209,今國光,10,0,10,富邦-宜蘭,2023-11-17,9686
3257,虹冠電,10,0,10,富邦-宜蘭,2023-11-17,9686
9958,世紀鋼,14,4,10,富邦-宜蘭,2023-11-17,9686
6805,富世達,10,0,10,富邦-宜蘭,2023-11-17,9686
4188,安克,9,0,9,富邦-宜蘭,2023-11-17,9686
2353,宏��,10,1,9,富邦-宜蘭,2023-11-17,9686
2537,聯上發,9,0,9,富邦-宜蘭,2023-11-17,9686
3231,緯創,31,22,9,富邦-宜蘭,2023-11-17,9686
6282,康舒,10,2,8,富邦-宜蘭,2023-11-17,9686
6271,同欣電,23,15,8,富邦-宜蘭,2023-11-17,9686
00642U,期元大S＆P石油,9,1,8,富邦-宜蘭,2023-11-17,9686
00936,台新永續高息中小,11,3,8,富邦-宜蘭,2023-11-17,9686
2888,新光金,8,0,8,富邦-宜蘭,2023-11-17,9686
6231,系微,8,0,8,富邦-宜蘭,2023-11-17,9686
00632R,元大台灣50反1,600,52,548,富邦-宜蘭,2023-11-20,9686
00676R,富邦臺灣加權反1,500,0,500,富邦-宜蘭,2023-11-20,9686
00664R,國泰臺灣加權反1,450,0,450,富邦-宜蘭,2023-11-20,9686
6770,力積電,287,5,282,富邦-宜蘭,2023-11-20,9686
2401,凌陽,262,106,156,富邦-宜蘭,2023-11-20,9686
3059,華晶科,123,53,70,富邦-宜蘭,2023-11-20,9686
2337,旺宏,50,1,49,富邦-宜蘭,2023-11-20,9686
00919,群益台灣精選高息,63,17,46,富邦-宜蘭,2023-11-20,9686
2547,日勝生,50,5,45,富邦-宜蘭,2023-11-20,9686
8034,榮群,47,5,42,富邦-宜蘭,2023-11-20,9686
1319,東陽,44,2,42,富邦-宜蘭,2023-11-20,9686
2352,佳世達,43,1,42,富邦-宜蘭,2023-11-20,9686
00756B,群益投等新興公債,40,0,40,富邦-宜蘭,2023-11-20,9686
00751B,元大AAA至A公司債,43,5,38,富邦-宜蘭,2023-11-20,9686
3715,定穎投控,72,37,35,富邦-宜蘭,2023-11-20,9686
2468,華經,34,4,30,富邦-宜蘭,2023-11-20,9686
3049,精金,30,0,30,富邦-宜蘭,2023-11-20,9686
2515,中工,31,6,25,富邦-宜蘭,2023-11-20,9686
6235,華孚,31,6,25,富邦-宜蘭,2023-11-20,9686
6127,九豪,28,3,25,富邦-宜蘭,2023-11-20,9686
1303,南亞,24,0,24,富邦-宜蘭,2023-11-20,9686
2402,毅嘉,56,32,24,富邦-宜蘭,2023-11-20,9686
2451,創見,22,0,22,富邦-宜蘭,2023-11-20,9686
4919,新唐,24,2,22,富邦-宜蘭,2023-11-20,9686
3390,旭軟,22,1,21,富邦-宜蘭,2023-11-20,9686
2312,金寶,35,14,21,富邦-宜蘭,2023-11-20,9686
2356,英業達,21,1,20,富邦-宜蘭,2023-11-20,9686
6443,元晶,22,2,20,富邦-宜蘭,2023-11-20,9686
6139,亞翔,39,21,18,富邦-宜蘭,2023-11-20,9686
00915,凱基優選高股息30,18,0,18,富邦-宜蘭,2023-11-20,9686
2748,雲品,19,1,18,富邦-宜蘭,2023-11-20,9686
9105,泰金寶-DR,30,12,18,富邦-宜蘭,2023-11-20,9686
6243,迅杰,25,8,17,富邦-宜蘭,2023-11-20,9686
00885,富邦越南,19,2,17,富邦-宜蘭,2023-11-20,9686
8016,矽創,18,1,17,富邦-宜蘭,2023-11-20,9686
00679B,元大美債20年,16,0,16,富邦-宜蘭,2023-11-20,9686
6188,廣明,18,3,15,富邦-宜蘭,2023-11-20,9686
2314,台揚,15,0,15,富邦-宜蘭,2023-11-20,9686
3545,敦泰,23,10,13,富邦-宜蘭,2023-11-20,9686
2363,矽統,78,65,13,富邦-宜蘭,2023-11-20,9686
8215,明基材,13,0,13,富邦-宜蘭,2023-11-20,9686
00665L,富邦�琤肭磪囓�2,20,7,13,富邦-宜蘭,2023-11-20,9686
00922,國泰台灣領袖50,13,0,13,富邦-宜蘭,2023-11-20,9686
3380,明泰,13,0,13,富邦-宜蘭,2023-11-20,9686
2892,第一金,14,1,13,富邦-宜蘭,2023-11-20,9686
00688L,國泰20年美債正2,20,8,12,富邦-宜蘭,2023-11-20,9686
00935,野村臺灣新科技50,12,0,12,富邦-宜蘭,2023-11-20,9686
3060,銘異,12,0,12,富邦-宜蘭,2023-11-20,9686
8926,台汽電,12,0,12,富邦-宜蘭,2023-11-20,9686
1598,岱宇,16,5,11,富邦-宜蘭,2023-11-20,9686
00632R,元大台灣50反1,709,0,709,富邦-宜蘭,2023-11-21,9686
2883,凱基金,614,51,563,富邦-宜蘭,2023-11-21,9686
00690,兆豐藍籌30,137,0,137,富邦-宜蘭,2023-11-21,9686
00664R,國泰臺灣加權反1,122,0,122,富邦-宜蘭,2023-11-21,9686
3059,華晶科,118,15,103,富邦-宜蘭,2023-11-21,9686
2316,楠梓電,83,14,69,富邦-宜蘭,2023-11-21,9686
00715L,期街口布蘭特正2,68,0,68,富邦-宜蘭,2023-11-21,9686
00919,群益台灣精選高息,92,26,66,富邦-宜蘭,2023-11-21,9686
2363,矽統,119,53,66,富邦-宜蘭,2023-11-21,9686
3287,廣寰科,55,3,52,富邦-宜蘭,2023-11-21,9686
4543,萬在,100,53,47,富邦-宜蘭,2023-11-21,9686
6158,禾昌,42,3,39,富邦-宜蘭,2023-11-21,9686
2405,輔信,88,50,38,富邦-宜蘭,2023-11-21,9686
00751B,元大AAA至A公司債,35,2,33,富邦-宜蘭,2023-11-21,9686
3041,揚智,105,74,31,富邦-宜蘭,2023-11-21,9686
5292,華懋,30,0,30,富邦-宜蘭,2023-11-21,9686
2527,宏璟,30,0,30,富邦-宜蘭,2023-11-21,9686
2547,日勝生,30,0,30,富邦-宜蘭,2023-11-21,9686
6016,康和證,30,0,30,富邦-宜蘭,2023-11-21,9686
8436,大江,30,0,30,富邦-宜蘭,2023-11-21,9686
2849,安泰銀,25,0,25,富邦-宜蘭,2023-11-21,9686
2516,新建,24,2,22,富邦-宜蘭,2023-11-21,9686
8936,國統,26,5,21,富邦-宜蘭,2023-11-21,9686
8222,寶一,23,2,21,富邦-宜蘭,2023-11-21,9686
2344,華邦電,32,13,19,富邦-宜蘭,2023-11-21,9686
2308,台達電,20,2,18,富邦-宜蘭,2023-11-21,9686
3504,揚明光,20,3,17,富邦-宜蘭,2023-11-21,9686
00936,台新永續高息中小,18,2,16,富邦-宜蘭,2023-11-21,9686
1524,耿鼎,20,4,16,富邦-宜蘭,2023-11-21,9686
4952,凌通,19,3,16,富邦-宜蘭,2023-11-21,9686
6494,九齊,16,0,16,富邦-宜蘭,2023-11-21,9686
6579,研揚,23,8,15,富邦-宜蘭,2023-11-21,9686
1609,大亞,15,0,15,富邦-宜蘭,2023-11-21,9686
6282,康舒,22,9,13,富邦-宜蘭,2023-11-21,9686
6168,宏齊,25,13,12,富邦-宜蘭,2023-11-21,9686
3257,虹冠電,32,21,11,富邦-宜蘭,2023-11-21,9686
2428,興勤,11,0,11,富邦-宜蘭,2023-11-21,9686
3704,合勤控,13,2,11,富邦-宜蘭,2023-11-21,9686
2305,全友,11,0,11,富邦-宜蘭,2023-11-21,9686
6233,旺玖,37,26,11,富邦-宜蘭,2023-11-21,9686
3017,奇鋐,14,3,11,富邦-宜蘭,2023-11-21,9686
9945,潤泰新,10,0,10,富邦-宜蘭,2023-11-21,9686
3548,兆利,18,8,10,富邦-宜蘭,2023-11-21,9686
3046,建��,11,1,10,富邦-宜蘭,2023-11-21,9686
5471,松翰,10,0,10,富邦-宜蘭,2023-11-21,9686
2352,佳世達,10,0,10,富邦-宜蘭,2023-11-21,9686
2401,凌陽,21,11,10,富邦-宜蘭,2023-11-21,9686
5706,鳳凰,13,3,10,富邦-宜蘭,2023-11-21,9686
5531,鄉林,10,0,10,富邦-宜蘭,2023-11-21,9686
5351,鈺創,39,30,9,富邦-宜蘭,2023-11-21,9686
00671R,富邦NASDAQ反1,202,0,202,富邦-宜蘭,2023-11-22,9686
00664R,國泰臺灣加權反1,150,0,150,富邦-宜蘭,2023-11-22,9686
6770,力積電,123,3,120,富邦-宜蘭,2023-11-22,9686
2405,輔信,174,58,116,富邦-宜蘭,2023-11-22,9686
3231,緯創,143,37,106,富邦-宜蘭,2023-11-22,9686
2356,英業達,72,8,64,富邦-宜蘭,2023-11-22,9686
1319,東陽,64,2,62,富邦-宜蘭,2023-11-22,9686
00878,國泰永續高股息,71,21,50,富邦-宜蘭,2023-11-22,9686
2801,彰銀,42,0,42,富邦-宜蘭,2023-11-22,9686
2258,鴻華先進-創,41,0,41,富邦-宜蘭,2023-11-22,9686
00918,大華優利高填息30,40,0,40,富邦-宜蘭,2023-11-22,9686
00688L,國泰20年美債正2,39,0,39,富邦-宜蘭,2023-11-22,9686
2609,陽明,38,0,38,富邦-宜蘭,2023-11-22,9686
2892,第一金,43,6,37,富邦-宜蘭,2023-11-22,9686
2409,友達,34,0,34,富邦-宜蘭,2023-11-22,9686
0056,元大高股息,43,10,33,富邦-宜蘭,2023-11-22,9686
00936,台新永續高息中小,35,3,32,富邦-宜蘭,2023-11-22,9686
6125,廣運,43,16,27,富邦-宜蘭,2023-11-22,9686
2382,廣達,32,7,25,富邦-宜蘭,2023-11-22,9686
2515,中工,23,0,23,富邦-宜蘭,2023-11-22,9686
2516,新建,23,0,23,富邦-宜蘭,2023-11-22,9686
4542,科嶠,28,8,20,富邦-宜蘭,2023-11-22,9686
2399,映泰,20,0,20,富邦-宜蘭,2023-11-22,9686
8163,達方,23,4,19,富邦-宜蘭,2023-11-22,9686
00751B,元大AAA至A公司債,18,0,18,富邦-宜蘭,2023-11-22,9686
8011,台通,21,4,17,富邦-宜蘭,2023-11-22,9686
6494,九齊,28,11,17,富邦-宜蘭,2023-11-22,9686
3623,富晶通,51,35,16,富邦-宜蘭,2023-11-22,9686
00905,FT臺灣Smart,17,2,15,富邦-宜蘭,2023-11-22,9686
1338,廣華-KY,15,0,15,富邦-宜蘭,2023-11-22,9686
00679B,元大美債20年,16,1,15,富邦-宜蘭,2023-11-22,9686
00665L,富邦�琤肭磪囓�2,17,2,15,富邦-宜蘭,2023-11-22,9686
00934,中信成長高股息,14,0,14,富邦-宜蘭,2023-11-22,9686
3013,晟銘電,19,5,14,富邦-宜蘭,2023-11-22,9686
2301,光寶科,14,1,13,富邦-宜蘭,2023-11-22,9686
4952,凌通,13,0,13,富邦-宜蘭,2023-11-22,9686
6191,精成科,13,0,13,富邦-宜蘭,2023-11-22,9686
3234,光環,16,3,13,富邦-宜蘭,2023-11-22,9686
5533,皇鼎,21,8,13,富邦-宜蘭,2023-11-22,9686
00923,群益台ESG低碳50,13,0,13,富邦-宜蘭,2023-11-22,9686
3325,旭品,47,35,12,富邦-宜蘭,2023-11-22,9686
2610,華航,29,17,12,富邦-宜蘭,2023-11-22,9686
00669R,國泰美國道瓊反1,12,0,12,富邦-宜蘭,2023-11-22,9686
1449,佳和,17,5,12,富邦-宜蘭,2023-11-22,9686
2002,中鋼,14,3,11,富邦-宜蘭,2023-11-22,9686
5471,松翰,18,7,11,富邦-宜蘭,2023-11-22,9686
2468,華經,11,0,11,富邦-宜蘭,2023-11-22,9686
1464,得力,11,0,11,富邦-宜蘭,2023-11-22,9686
2453,凌群,13,2,11,富邦-宜蘭,2023-11-22,9686
2543,皇昌,11,0,11,富邦-宜蘭,2023-11-22,9686
5531,鄉林,220,10,210,富邦-宜蘭,2023-11-23,9686
2537,聯上發,140,15,125,富邦-宜蘭,2023-11-23,9686
2883,凱基金,125,3,122,富邦-宜蘭,2023-11-23,9686
00919,群益台灣精選高息,159,53,106,富邦-宜蘭,2023-11-23,9686
3231,緯創,123,22,101,富邦-宜蘭,2023-11-23,9686
6257,矽格,102,1,101,富邦-宜蘭,2023-11-23,9686
3041,揚智,95,24,71,富邦-宜蘭,2023-11-23,9686
6139,亞翔,67,11,56,富邦-宜蘭,2023-11-23,9686
2405,輔信,63,8,55,富邦-宜蘭,2023-11-23,9686
1471,首利,45,3,42,富邦-宜蘭,2023-11-23,9686
00637L,元大滬深300正2,41,0,41,富邦-宜蘭,2023-11-23,9686
2801,彰銀,41,1,40,富邦-宜蘭,2023-11-23,9686
3630,新鉅科,30,0,30,富邦-宜蘭,2023-11-23,9686
2468,華經,30,0,30,富邦-宜蘭,2023-11-23,9686
3059,華晶科,44,15,29,富邦-宜蘭,2023-11-23,9686
5521,工信,55,27,28,富邦-宜蘭,2023-11-23,9686
2915,潤泰全,25,0,25,富邦-宜蘭,2023-11-23,9686
2891,中信金,33,9,24,富邦-宜蘭,2023-11-23,9686
2399,映泰,24,0,24,富邦-宜蘭,2023-11-23,9686
3576,聯合再生,25,1,24,富邦-宜蘭,2023-11-23,9686
3078,僑威,69,46,23,富邦-宜蘭,2023-11-23,9686
3047,訊舟,29,6,23,富邦-宜蘭,2023-11-23,9686
2457,飛宏,94,73,21,富邦-宜蘭,2023-11-23,9686
2369,菱生,30,10,20,富邦-宜蘭,2023-11-23,9686
2401,凌陽,32,13,19,富邦-宜蘭,2023-11-23,9686
2409,友達,20,2,18,富邦-宜蘭,2023-11-23,9686
3715,定穎投控,65,47,18,富邦-宜蘭,2023-11-23,9686
6235,華孚,21,3,18,富邦-宜蘭,2023-11-23,9686
6284,佳邦,18,0,18,富邦-宜蘭,2023-11-23,9686
2313,華通,39,22,17,富邦-宜蘭,2023-11-23,9686
2388,威盛,50,35,15,富邦-宜蘭,2023-11-23,9686
3402,漢科,15,0,15,富邦-宜蘭,2023-11-23,9686
00633L,富邦上証正2,15,0,15,富邦-宜蘭,2023-11-23,9686
8040,九暘,28,13,15,富邦-宜蘭,2023-11-23,9686
8183,精星,35,20,15,富邦-宜蘭,2023-11-23,9686
2356,英業達,35,21,14,富邦-宜蘭,2023-11-23,9686
2344,華邦電,16,2,14,富邦-宜蘭,2023-11-23,9686
8358,金居,27,13,14,富邦-宜蘭,2023-11-23,9686
6456,GIS-KY,17,3,14,富邦-宜蘭,2023-11-23,9686
8450,霹靂,16,3,13,富邦-宜蘭,2023-11-23,9686
6113,亞矽,15,2,13,富邦-宜蘭,2023-11-23,9686
2603,長榮,13,0,13,富邦-宜蘭,2023-11-23,9686
00679B,元大美債20年,14,1,13,富邦-宜蘭,2023-11-23,9686
2368,金像電,13,0,13,富邦-宜蘭,2023-11-23,9686
4114,健喬,12,0,12,富邦-宜蘭,2023-11-23,9686
5471,松翰,14,2,12,富邦-宜蘭,2023-11-23,9686
8054,安國,47,35,12,富邦-宜蘭,2023-11-23,9686
8403,盛弘,16,4,12,富邦-宜蘭,2023-11-23,9686
8227,巨有科技,13,1,12,富邦-宜蘭,2023-11-23,9686
3014,聯陽,11,0,11,富邦-宜蘭,2023-11-23,9686
2888,新光金,246,51,195,富邦-宜蘭,2023-11-24,9686
2618,長榮航,169,0,169,富邦-宜蘭,2023-11-24,9686
2323,中環,107,2,105,富邦-宜蘭,2023-11-24,9686
5009,榮剛,66,2,64,富邦-宜蘭,2023-11-24,9686
1709,和益,42,0,42,富邦-宜蘭,2023-11-24,9686
2317,鴻海,36,1,35,富邦-宜蘭,2023-11-24,9686
3276,宇環,35,6,29,富邦-宜蘭,2023-11-24,9686
3231,緯創,52,24,28,富邦-宜蘭,2023-11-24,9686
1809,中釉,30,2,28,富邦-宜蘭,2023-11-24,9686
6120,達運,33,7,26,富邦-宜蘭,2023-11-24,9686
2630,亞航,38,12,26,富邦-宜蘭,2023-11-24,9686
00715L,期街口布蘭特正2,25,0,25,富邦-宜蘭,2023-11-24,9686
2399,映泰,25,0,25,富邦-宜蘭,2023-11-24,9686
00688L,國泰20年美債正2,24,0,24,富邦-宜蘭,2023-11-24,9686
2748,雲品,26,2,24,富邦-宜蘭,2023-11-24,9686
3701,大眾控,24,1,23,富邦-宜蘭,2023-11-24,9686
2401,凌陽,48,25,23,富邦-宜蘭,2023-11-24,9686
5351,鈺創,118,97,21,富邦-宜蘭,2023-11-24,9686
2515,中工,21,0,21,富邦-宜蘭,2023-11-24,9686
1316,上曜,20,0,20,富邦-宜蘭,2023-11-24,9686
2915,潤泰全,20,0,20,富邦-宜蘭,2023-11-24,9686
8089,康全電訊,20,0,20,富邦-宜蘭,2023-11-24,9686
2451,創見,19,0,19,富邦-宜蘭,2023-11-24,9686
6770,力積電,20,1,19,富邦-宜蘭,2023-11-24,9686
2883,凱基金,25,7,18,富邦-宜蘭,2023-11-24,9686
9105,泰金寶-DR,18,0,18,富邦-宜蘭,2023-11-24,9686
2736,富野,19,1,18,富邦-宜蘭,2023-11-24,9686
6494,九齊,19,1,18,富邦-宜蘭,2023-11-24,9686
3272,東碩,18,0,18,富邦-宜蘭,2023-11-24,9686
00655L,國泰中國A50正2,17,0,17,富邦-宜蘭,2023-11-24,9686
2486,一詮,52,35,17,富邦-宜蘭,2023-11-24,9686
2353,宏��,19,3,16,富邦-宜蘭,2023-11-24,9686
5706,鳳凰,16,0,16,富邦-宜蘭,2023-11-24,9686
2356,英業達,24,9,15,富邦-宜蘭,2023-11-24,9686
00751B,元大AAA至A公司債,15,0,15,富邦-宜蘭,2023-11-24,9686
6901,鑽石投資,21,6,15,富邦-宜蘭,2023-11-24,9686
6530,創威,18,3,15,富邦-宜蘭,2023-11-24,9686
1609,大亞,17,2,15,富邦-宜蘭,2023-11-24,9686
2428,興勤,14,0,14,富邦-宜蘭,2023-11-24,9686
2305,全友,13,0,13,富邦-宜蘭,2023-11-24,9686
00712,復華富時不動產,20,7,13,富邦-宜蘭,2023-11-24,9686
5284,jpp-KY,14,1,13,富邦-宜蘭,2023-11-24,9686
00885,富邦越南,12,0,12,富邦-宜蘭,2023-11-24,9686
5512,力麒,30,18,12,富邦-宜蘭,2023-11-24,9686
4714,永捷,12,0,12,富邦-宜蘭,2023-11-24,9686
3708,上緯投控,12,0,12,富邦-宜蘭,2023-11-24,9686
6235,華孚,49,38,11,富邦-宜蘭,2023-11-24,9686
2881,富邦金,31,20,11,富邦-宜蘭,2023-11-24,9686
2303,聯電,39,28,11,富邦-宜蘭,2023-11-24,9686
2417,圓剛,14,3,11,富邦-宜蘭,2023-11-24,9686
3049,精金,235,2,233,富邦-宜蘭,2023-11-27,9686
00919,群益台灣精選高息,211,3,208,富邦-宜蘭,2023-11-27,9686
2883,凱基金,262,111,151,富邦-宜蘭,2023-11-27,9686
6282,康舒,147,9,138,富邦-宜蘭,2023-11-27,9686
00905,FT臺灣Smart,112,0,112,富邦-宜蘭,2023-11-27,9686
00929,復華台灣科技優息,155,49,106,富邦-宜蘭,2023-11-27,9686
3231,緯創,121,27,94,富邦-宜蘭,2023-11-27,9686
9919,康那香,80,5,75,富邦-宜蘭,2023-11-27,9686
2816,旺旺保,78,12,66,富邦-宜蘭,2023-11-27,9686
00655L,國泰中國A50正2,58,0,58,富邦-宜蘭,2023-11-27,9686
1514,亞力,98,56,42,富邦-宜蘭,2023-11-27,9686
2355,敬鵬,50,11,39,富邦-宜蘭,2023-11-27,9686
00679B,元大美債20年,42,3,39,富邦-宜蘭,2023-11-27,9686
2630,亞航,45,10,35,富邦-宜蘭,2023-11-27,9686
2303,聯電,50,17,33,富邦-宜蘭,2023-11-27,9686
2356,英業達,36,4,32,富邦-宜蘭,2023-11-27,9686
00687B,國泰20年美債,32,0,32,富邦-宜蘭,2023-11-27,9686
2371,大同,32,2,30,富邦-宜蘭,2023-11-27,9686
2382,廣達,42,12,30,富邦-宜蘭,2023-11-27,9686
00686R,群益臺灣加權反1,30,0,30,富邦-宜蘭,2023-11-27,9686
1584,精剛,36,6,30,富邦-宜蘭,2023-11-27,9686
2344,華邦電,35,8,27,富邦-宜蘭,2023-11-27,9686
4188,安克,31,4,27,富邦-宜蘭,2023-11-27,9686
2610,華航,32,6,26,富邦-宜蘭,2023-11-27,9686
5292,華懋,24,1,23,富邦-宜蘭,2023-11-27,9686
5347,世界,50,30,20,富邦-宜蘭,2023-11-27,9686
2891,中信金,20,2,18,富邦-宜蘭,2023-11-27,9686
3490,單井,18,0,18,富邦-宜蘭,2023-11-27,9686
2399,映泰,18,1,17,富邦-宜蘭,2023-11-27,9686
4746,台耀,35,18,17,富邦-宜蘭,2023-11-27,9686
2634,漢翔,25,10,15,富邦-宜蘭,2023-11-27,9686
2305,全友,15,0,15,富邦-宜蘭,2023-11-27,9686
3058,立德,15,0,15,富邦-宜蘭,2023-11-27,9686
2605,新興,20,5,15,富邦-宜蘭,2023-11-27,9686
1612,宏泰,15,0,15,富邦-宜蘭,2023-11-27,9686
9944,新麗,15,0,15,富邦-宜蘭,2023-11-27,9686
6138,茂達,15,0,15,富邦-宜蘭,2023-11-27,9686
00878,國泰永續高股息,28,13,15,富邦-宜蘭,2023-11-27,9686
2618,長榮航,30,16,14,富邦-宜蘭,2023-11-27,9686
8086,宏捷科,26,12,14,富邦-宜蘭,2023-11-27,9686
2108,南帝,16,2,14,富邦-宜蘭,2023-11-27,9686
8936,國統,17,3,14,富邦-宜蘭,2023-11-27,9686
6127,九豪,26,13,13,富邦-宜蘭,2023-11-27,9686
2353,宏��,20,7,13,富邦-宜蘭,2023-11-27,9686
8033,雷虎,14,1,13,富邦-宜蘭,2023-11-27,9686
00665L,富邦�琤肭磪囓�2,12,0,12,富邦-宜蘭,2023-11-27,9686
2408,南亞科,12,0,12,富邦-宜蘭,2023-11-27,9686
1319,東陽,13,2,11,富邦-宜蘭,2023-11-27,9686
2330,台積電,14,3,11,富邦-宜蘭,2023-11-27,9686
3046,建��,11,0,11,富邦-宜蘭,2023-11-27,9686
00905,FT臺灣Smart,175,0,175,富邦-宜蘭,2023-11-28,9686
2323,中環,151,0,151,富邦-宜蘭,2023-11-28,9686
00637L,元大滬深300正2,100,1,99,富邦-宜蘭,2023-11-28,9686
5272,笙科,73,8,65,富邦-宜蘭,2023-11-28,9686
2382,廣達,78,21,57,富邦-宜蘭,2023-11-28,9686
2303,聯電,79,30,49,富邦-宜蘭,2023-11-28,9686
2355,敬鵬,53,12,41,富邦-宜蘭,2023-11-28,9686
3715,定穎投控,86,45,41,富邦-宜蘭,2023-11-28,9686
6282,康舒,43,3,40,富邦-宜蘭,2023-11-28,9686
3623,富晶通,31,0,31,富邦-宜蘭,2023-11-28,9686
2371,大同,51,22,29,富邦-宜蘭,2023-11-28,9686
5351,鈺創,74,47,27,富邦-宜蘭,2023-11-28,9686
6598,ABC-KY,25,0,25,富邦-宜蘭,2023-11-28,9686
00919,群益台灣精選高息,24,2,22,富邦-宜蘭,2023-11-28,9686
2316,楠梓電,20,0,20,富邦-宜蘭,2023-11-28,9686
2889,國票金,20,0,20,富邦-宜蘭,2023-11-28,9686
5347,世界,20,1,19,富邦-宜蘭,2023-11-28,9686
00712,復華富時不動產,17,0,17,富邦-宜蘭,2023-11-28,9686
8176,智捷,17,0,17,富邦-宜蘭,2023-11-28,9686
2383,台光電,61,45,16,富邦-宜蘭,2023-11-28,9686
2641,正德,42,26,16,富邦-宜蘭,2023-11-28,9686
5483,中美晶,33,17,16,富邦-宜蘭,2023-11-28,9686
8936,國統,21,5,16,富邦-宜蘭,2023-11-28,9686
00885,富邦越南,15,0,15,富邦-宜蘭,2023-11-28,9686
6243,迅杰,91,77,14,富邦-宜蘭,2023-11-28,9686
3041,揚智,17,3,14,富邦-宜蘭,2023-11-28,9686
1218,泰山,13,0,13,富邦-宜蘭,2023-11-28,9686
2834,臺企銀,14,1,13,富邦-宜蘭,2023-11-28,9686
00753L,中信中國50正2,16,4,12,富邦-宜蘭,2023-11-28,9686
2542,興富發,12,0,12,富邦-宜蘭,2023-11-28,9686
00706L,期元大S＆P日圓正2,12,0,12,富邦-宜蘭,2023-11-28,9686
2363,矽統,61,49,12,富邦-宜蘭,2023-11-28,9686
3481,群創,17,5,12,富邦-宜蘭,2023-11-28,9686
00757,統一FANG+,11,0,11,富邦-宜蘭,2023-11-28,9686
4128,中天,12,1,11,富邦-宜蘭,2023-11-28,9686
2465,麗臺,11,0,11,富邦-宜蘭,2023-11-28,9686
2327,國巨,16,6,10,富邦-宜蘭,2023-11-28,9686
8089,康全電訊,10,0,10,富邦-宜蘭,2023-11-28,9686
1760,寶齡富錦,16,6,10,富邦-宜蘭,2023-11-28,9686
3363,上詮,10,0,10,富邦-宜蘭,2023-11-28,9686
3056,富華新,10,0,10,富邦-宜蘭,2023-11-28,9686
00633L,富邦上証正2,10,0,10,富邦-宜蘭,2023-11-28,9686
00687B,國泰20年美債,10,0,10,富邦-宜蘭,2023-11-28,9686
2353,宏��,12,2,10,富邦-宜蘭,2023-11-28,9686
1701,中化,10,0,10,富邦-宜蘭,2023-11-28,9686
2867,三商壽,10,0,10,富邦-宜蘭,2023-11-28,9686
9103,美德醫療-DR,10,0,10,富邦-宜蘭,2023-11-28,9686
2023,燁輝,10,1,9,富邦-宜蘭,2023-11-28,9686
2630,亞航,12,3,9,富邦-宜蘭,2023-11-28,9686
8467,波力-KY,10,1,9,富邦-宜蘭,2023-11-28,9686
00637L,元大滬深300正2,173,0,173,富邦-宜蘭,2023-11-29,9686
00650L,復華香港正2,114,0,114,富邦-宜蘭,2023-11-29,9686
2353,宏��,82,3,79,富邦-宜蘭,2023-11-29,9686
00935,野村臺灣新科技50,67,0,67,富邦-宜蘭,2023-11-29,9686
1701,中化,61,0,61,富邦-宜蘭,2023-11-29,9686
2382,廣達,55,13,42,富邦-宜蘭,2023-11-29,9686
00753L,中信中國50正2,35,2,33,富邦-宜蘭,2023-11-29,9686
1101,台泥,51,18,33,富邦-宜蘭,2023-11-29,9686
00885,富邦越南,31,0,31,富邦-宜蘭,2023-11-29,9686
3481,群創,31,0,31,富邦-宜蘭,2023-11-29,9686
00712,復華富時不動產,31,0,31,富邦-宜蘭,2023-11-29,9686
00655L,國泰中國A50正2,30,0,30,富邦-宜蘭,2023-11-29,9686
3373,熱映,36,7,29,富邦-宜蘭,2023-11-29,9686
00882,中信中國高股息,29,0,29,富邦-宜蘭,2023-11-29,9686
2887,台新金,30,2,28,富邦-宜蘭,2023-11-29,9686
00665L,富邦�琤肭磪囓�2,27,0,27,富邦-宜蘭,2023-11-29,9686
6282,康舒,33,6,27,富邦-宜蘭,2023-11-29,9686
2401,凌陽,71,44,27,富邦-宜蘭,2023-11-29,9686
3257,虹冠電,25,0,25,富邦-宜蘭,2023-11-29,9686
8096,擎亞,25,0,25,富邦-宜蘭,2023-11-29,9686
3545,敦泰,39,15,24,富邦-宜蘭,2023-11-29,9686
2313,華通,106,82,24,富邦-宜蘭,2023-11-29,9686
6188,廣明,25,3,22,富邦-宜蘭,2023-11-29,9686
3231,緯創,75,53,22,富邦-宜蘭,2023-11-29,9686
3138,耀登,22,0,22,富邦-宜蘭,2023-11-29,9686
1732,毛寶,28,7,21,富邦-宜蘭,2023-11-29,9686
2332,友訊,20,0,20,富邦-宜蘭,2023-11-29,9686
00905,FT臺灣Smart,20,0,20,富邦-宜蘭,2023-11-29,9686
00679B,元大美債20年,22,2,20,富邦-宜蘭,2023-11-29,9686
2515,中工,20,0,20,富邦-宜蘭,2023-11-29,9686
6235,華孚,26,6,20,富邦-宜蘭,2023-11-29,9686
5521,工信,20,1,19,富邦-宜蘭,2023-11-29,9686
4121,優盛,21,2,19,富邦-宜蘭,2023-11-29,9686
6139,亞翔,26,8,18,富邦-宜蘭,2023-11-29,9686
3013,晟銘電,18,3,15,富邦-宜蘭,2023-11-29,9686
3217,優群,15,0,15,富邦-宜蘭,2023-11-29,9686
9103,美德醫療-DR,15,0,15,富邦-宜蘭,2023-11-29,9686
8467,波力-KY,16,1,15,富邦-宜蘭,2023-11-29,9686
2905,三商,15,0,15,富邦-宜蘭,2023-11-29,9686
00633L,富邦上証正2,15,0,15,富邦-宜蘭,2023-11-29,9686
3372,典範,15,0,15,富邦-宜蘭,2023-11-29,9686
2888,新光金,21,6,15,富邦-宜蘭,2023-11-29,9686
9945,潤泰新,14,0,14,富邦-宜蘭,2023-11-29,9686
6441,廣錠,15,1,14,富邦-宜蘭,2023-11-29,9686
4714,永捷,18,5,13,富邦-宜蘭,2023-11-29,9686
6133,金橋,13,0,13,富邦-宜蘭,2023-11-29,9686
4114,健喬,12,0,12,富邦-宜蘭,2023-11-29,9686
4533,協易機,12,0,12,富邦-宜蘭,2023-11-29,9686
2393,億光,12,0,12,富邦-宜蘭,2023-11-29,9686
2002,中鋼,17,5,12,富邦-宜蘭,2023-11-29,9686
00720B,元大投資級公司債,108,1,107,富邦-宜蘭,2023-11-30,9686
3437,榮創,102,0,102,富邦-宜蘭,2023-11-30,9686
1618,合機,70,1,69,富邦-宜蘭,2023-11-30,9686
00919,群益台灣精選高息,47,0,47,富邦-宜蘭,2023-11-30,9686
2880,華南金,43,1,42,富邦-宜蘭,2023-11-30,9686
00688L,國泰20年美債正2,40,1,39,富邦-宜蘭,2023-11-30,9686
3059,華晶科,35,0,35,富邦-宜蘭,2023-11-30,9686
1215,卜蜂,33,0,33,富邦-宜蘭,2023-11-30,9686
00905,FT臺灣Smart,34,2,32,富邦-宜蘭,2023-11-30,9686
00679B,元大美債20年,38,6,32,富邦-宜蘭,2023-11-30,9686
2329,華泰,194,165,29,富邦-宜蘭,2023-11-30,9686
00751B,元大AAA至A公司債,31,2,29,富邦-宜蘭,2023-11-30,9686
00882,中信中國高股息,33,5,28,富邦-宜蘭,2023-11-30,9686
6282,康舒,32,6,26,富邦-宜蘭,2023-11-30,9686
5347,世界,33,7,26,富邦-宜蘭,2023-11-30,9686
00650L,復華香港正2,24,0,24,富邦-宜蘭,2023-11-30,9686
5351,鈺創,63,39,24,富邦-宜蘭,2023-11-30,9686
2457,飛宏,25,2,23,富邦-宜蘭,2023-11-30,9686
8089,康全電訊,25,2,23,富邦-宜蘭,2023-11-30,9686
2369,菱生,25,3,22,富邦-宜蘭,2023-11-30,9686
00931B,統一美債20年,22,0,22,富邦-宜蘭,2023-11-30,9686
1513,中興電,27,7,20,富邦-宜蘭,2023-11-30,9686
3058,立德,20,0,20,富邦-宜蘭,2023-11-30,9686
2929,淘帝-KY,20,0,20,富邦-宜蘭,2023-11-30,9686
3481,群創,40,20,20,富邦-宜蘭,2023-11-30,9686
2332,友訊,20,1,19,富邦-宜蘭,2023-11-30,9686
1325,恆大,73,54,19,富邦-宜蘭,2023-11-30,9686
2327,國巨,20,1,19,富邦-宜蘭,2023-11-30,9686
3231,緯創,90,71,19,富邦-宜蘭,2023-11-30,9686
6284,佳邦,22,4,18,富邦-宜蘭,2023-11-30,9686
2892,第一金,17,0,17,富邦-宜蘭,2023-11-30,9686
2409,友達,32,15,17,富邦-宜蘭,2023-11-30,9686
2313,華通,35,19,16,富邦-宜蘭,2023-11-30,9686
3715,定穎投控,48,32,16,富邦-宜蘭,2023-11-30,9686
00933B,國泰10Y+金融債,16,0,16,富邦-宜蘭,2023-11-30,9686
2002,中鋼,22,7,15,富邦-宜蘭,2023-11-30,9686
8489,三貝德,15,0,15,富邦-宜蘭,2023-11-30,9686
8072,陞泰,15,0,15,富邦-宜蘭,2023-11-30,9686
6461,益得,14,0,14,富邦-宜蘭,2023-11-30,9686
00934,中信成長高股息,15,1,14,富邦-宜蘭,2023-11-30,9686
6125,廣運,21,7,14,富邦-宜蘭,2023-11-30,9686
2634,漢翔,16,2,14,富邦-宜蘭,2023-11-30,9686
2492,華新科,25,12,13,富邦-宜蘭,2023-11-30,9686
2317,鴻海,16,4,12,富邦-宜蘭,2023-11-30,9686
9942,茂順,12,0,12,富邦-宜蘭,2023-11-30,9686
6202,盛群,12,0,12,富邦-宜蘭,2023-11-30,9686
2303,聯電,11,0,11,富邦-宜蘭,2023-11-30,9686
00885,富邦越南,20,9,11,富邦-宜蘭,2023-11-30,9686
8261,富鼎,19,8,11,富邦-宜蘭,2023-11-30,9686
3265,台星科,35,24,11,富邦-宜蘭,2023-11-30,9686
3049,精金,238,0,238,富邦-宜蘭,2023-12-01,9686
2887,台新金,175,1,174,富邦-宜蘭,2023-12-01,9686
2883,凱基金,165,1,164,富邦-宜蘭,2023-12-01,9686
00929,復華台灣科技優息,125,15,110,富邦-宜蘭,2023-12-01,9686
1504,東元,102,0,102,富邦-宜蘭,2023-12-01,9686
6770,力積電,69,0,69,富邦-宜蘭,2023-12-01,9686
3231,緯創,105,51,54,富邦-宜蘭,2023-12-01,9686
2834,臺企銀,52,1,51,富邦-宜蘭,2023-12-01,9686
3094,聯傑,57,6,51,富邦-宜蘭,2023-12-01,9686
2867,三商壽,50,0,50,富邦-宜蘭,2023-12-01,9686
2889,國票金,50,0,50,富邦-宜蘭,2023-12-01,9686
2618,長榮航,53,5,48,富邦-宜蘭,2023-12-01,9686
00688L,國泰20年美債正2,42,0,42,富邦-宜蘭,2023-12-01,9686
1339,昭輝,41,2,39,富邦-宜蘭,2023-12-01,9686
5608,四維航,54,18,36,富邦-宜蘭,2023-12-01,9686
1101,台泥,36,2,34,富邦-宜蘭,2023-12-01,9686
2332,友訊,34,0,34,富邦-宜蘭,2023-12-01,9686
00885,富邦越南,33,0,33,富邦-宜蘭,2023-12-01,9686
2881,富邦金,32,0,32,富邦-宜蘭,2023-12-01,9686
00637L,元大滬深300正2,31,0,31,富邦-宜蘭,2023-12-01,9686
3481,群創,61,31,30,富邦-宜蘭,2023-12-01,9686
3450,聯鈞,44,14,30,富邦-宜蘭,2023-12-01,9686
2353,宏��,30,1,29,富邦-宜蘭,2023-12-01,9686
4154,樂威科-KY,31,2,29,富邦-宜蘭,2023-12-01,9686
00919,群益台灣精選高息,62,33,29,富邦-宜蘭,2023-12-01,9686
00679B,元大美債20年,28,0,28,富邦-宜蘭,2023-12-01,9686
2367,燿華,93,67,26,富邦-宜蘭,2023-12-01,9686
1701,中化,29,3,26,富邦-宜蘭,2023-12-01,9686
00900,富邦特選高股息30,25,0,25,富邦-宜蘭,2023-12-01,9686
4114,健喬,31,7,24,富邦-宜蘭,2023-12-01,9686
1720,生達,32,9,23,富邦-宜蘭,2023-12-01,9686
2601,益航,30,7,23,富邦-宜蘭,2023-12-01,9686
2615,萬海,30,7,23,富邦-宜蘭,2023-12-01,9686
5351,鈺創,53,31,22,富邦-宜蘭,2023-12-01,9686
2801,彰銀,20,0,20,富邦-宜蘭,2023-12-01,9686
00706L,期元大S＆P日圓正2,20,0,20,富邦-宜蘭,2023-12-01,9686
9919,康那香,61,42,19,富邦-宜蘭,2023-12-01,9686
8436,大江,37,18,19,富邦-宜蘭,2023-12-01,9686
6257,矽格,36,18,18,富邦-宜蘭,2023-12-01,9686
00933B,國泰10Y+金融債,18,0,18,富邦-宜蘭,2023-12-01,9686
2630,亞航,21,3,18,富邦-宜蘭,2023-12-01,9686
3363,上詮,24,6,18,富邦-宜蘭,2023-12-01,9686
3437,榮創,19,1,18,富邦-宜蘭,2023-12-01,9686
3704,合勤控,30,12,18,富邦-宜蘭,2023-12-01,9686
2605,新興,70,53,17,富邦-宜蘭,2023-12-01,9686
5347,世界,17,1,16,富邦-宜蘭,2023-12-01,9686
2915,潤泰全,16,0,16,富邦-宜蘭,2023-12-01,9686
00936,台新永續高息中小,16,0,16,富邦-宜蘭,2023-12-01,9686
2371,大同,16,0,16,富邦-宜蘭,2023-12-01,9686
2886,兆豐金,16,1,15,富邦-宜蘭,2023-12-01,9686
2883,凱基金,281,18,263,富邦-宜蘭,2023-12-04,9686
00676R,富邦臺灣加權反1,200,0,200,富邦-宜蘭,2023-12-04,9686
2601,益航,124,13,111,富邦-宜蘭,2023-12-04,9686
6216,居易,100,0,100,富邦-宜蘭,2023-12-04,9686
1605,華新,77,11,66,富邦-宜蘭,2023-12-04,9686
00918,大華優利高填息30,57,0,57,富邦-宜蘭,2023-12-04,9686
2543,皇昌,54,0,54,富邦-宜蘭,2023-12-04,9686
3715,定穎投控,84,32,52,富邦-宜蘭,2023-12-04,9686
1709,和益,50,0,50,富邦-宜蘭,2023-12-04,9686
2367,燿華,140,91,49,富邦-宜蘭,2023-12-04,9686
00931B,統一美債20年,48,0,48,富邦-宜蘭,2023-12-04,9686
00900,富邦特選高股息30,53,5,48,富邦-宜蘭,2023-12-04,9686
2352,佳世達,49,4,45,富邦-宜蘭,2023-12-04,9686
00929,復華台灣科技優息,89,47,42,富邦-宜蘭,2023-12-04,9686
2329,華泰,169,128,41,富邦-宜蘭,2023-12-04,9686
00650L,復華香港正2,40,0,40,富邦-宜蘭,2023-12-04,9686
1452,宏益,119,80,39,富邦-宜蘭,2023-12-04,9686
5202,力新,41,2,39,富邦-宜蘭,2023-12-04,9686
00882,中信中國高股息,38,0,38,富邦-宜蘭,2023-12-04,9686
6441,廣錠,37,1,36,富邦-宜蘭,2023-12-04,9686
3231,緯創,50,15,35,富邦-宜蘭,2023-12-04,9686
3710,連展投控,48,14,34,富邦-宜蘭,2023-12-04,9686
4533,協易機,101,67,34,富邦-宜蘭,2023-12-04,9686
00927,群益半導體收益,30,0,30,富邦-宜蘭,2023-12-04,9686
5351,鈺創,46,17,29,富邦-宜蘭,2023-12-04,9686
1453,大將,29,0,29,富邦-宜蘭,2023-12-04,9686
2611,志信,29,1,28,富邦-宜蘭,2023-12-04,9686
1504,東元,28,0,28,富邦-宜蘭,2023-12-04,9686
6829,千附精密,26,1,25,富邦-宜蘭,2023-12-04,9686
3706,神達,30,7,23,富邦-宜蘭,2023-12-04,9686
5439,高技,33,11,22,富邦-宜蘭,2023-12-04,9686
00712,復華富時不動產,46,24,22,富邦-宜蘭,2023-12-04,9686
8096,擎亞,25,3,22,富邦-宜蘭,2023-12-04,9686
2405,輔信,21,0,21,富邦-宜蘭,2023-12-04,9686
00688L,國泰20年美債正2,21,0,21,富邦-宜蘭,2023-12-04,9686
8927,北基,20,0,20,富邦-宜蘭,2023-12-04,9686
2399,映泰,45,25,20,富邦-宜蘭,2023-12-04,9686
6117,迎廣,37,18,19,富邦-宜蘭,2023-12-04,9686
1809,中釉,33,14,19,富邦-宜蘭,2023-12-04,9686
2316,楠梓電,42,23,19,富邦-宜蘭,2023-12-04,9686
6173,信昌電,22,3,19,富邦-宜蘭,2023-12-04,9686
6285,啟��,28,10,18,富邦-宜蘭,2023-12-04,9686
00919,群益台灣精選高息,73,56,17,富邦-宜蘭,2023-12-04,9686
00713,元大台灣高息低波,19,2,17,富邦-宜蘭,2023-12-04,9686
6122,擎邦,28,11,17,富邦-宜蘭,2023-12-04,9686
5464,霖宏,20,3,17,富邦-宜蘭,2023-12-04,9686
8033,雷虎,22,5,17,富邦-宜蘭,2023-12-04,9686
00722B,群益投資級電信債,17,0,17,富邦-宜蘭,2023-12-04,9686
2363,矽統,98,81,17,富邦-宜蘭,2023-12-04,9686
4543,萬在,54,37,17,富邦-宜蘭,2023-12-04,9686
00919,群益台灣精選高息,296,28,268,富邦-宜蘭,2023-12-05,9686
00937B,群益ESG投等債20,374,168,206,富邦-宜蘭,2023-12-05,9686
6916,華凌,123,0,123,富邦-宜蘭,2023-12-05,9686
3276,宇環,110,7,103,富邦-宜蘭,2023-12-05,9686
00665L,富邦�琤肭磪囓�2,101,0,101,富邦-宜蘭,2023-12-05,9686
3231,緯創,94,12,82,富邦-宜蘭,2023-12-05,9686
2613,中櫃,79,1,78,富邦-宜蘭,2023-12-05,9686
2617,台航,80,14,66,富邦-宜蘭,2023-12-05,9686
3710,連展投控,64,3,61,富邦-宜蘭,2023-12-05,9686
1466,聚隆,61,0,61,富邦-宜蘭,2023-12-05,9686
00650L,復華香港正2,60,0,60,富邦-宜蘭,2023-12-05,9686
1605,華新,62,9,53,富邦-宜蘭,2023-12-05,9686
00637L,元大滬深300正2,60,8,52,富邦-宜蘭,2023-12-05,9686
00688L,國泰20年美債正2,50,0,50,富邦-宜蘭,2023-12-05,9686
6556,勝品,50,0,50,富邦-宜蘭,2023-12-05,9686
00918,大華優利高填息30,62,12,50,富邦-宜蘭,2023-12-05,9686
6194,育富,78,33,45,富邦-宜蘭,2023-12-05,9686
00929,復華台灣科技優息,58,14,44,富邦-宜蘭,2023-12-05,9686
00687B,國泰20年美債,38,0,38,富邦-宜蘭,2023-12-05,9686
8926,台汽電,38,0,38,富邦-宜蘭,2023-12-05,9686
8436,大江,38,2,36,富邦-宜蘭,2023-12-05,9686
2607,榮運,38,3,35,富邦-宜蘭,2023-12-05,9686
8089,康全電訊,34,0,34,富邦-宜蘭,2023-12-05,9686
00722B,群益投資級電信債,33,0,33,富邦-宜蘭,2023-12-05,9686
5351,鈺創,41,9,32,富邦-宜蘭,2023-12-05,9686
1434,福懋,31,0,31,富邦-宜蘭,2023-12-05,9686
6241,易通展,30,0,30,富邦-宜蘭,2023-12-05,9686
2399,映泰,43,13,30,富邦-宜蘭,2023-12-05,9686
3050,鈺德,51,23,28,富邦-宜蘭,2023-12-05,9686
6101,寬魚國際,29,1,28,富邦-宜蘭,2023-12-05,9686
5464,霖宏,36,9,27,富邦-宜蘭,2023-12-05,9686
00751B,元大AAA至A公司債,28,1,27,富邦-宜蘭,2023-12-05,9686
5347,世界,29,4,25,富邦-宜蘭,2023-12-05,9686
00753L,中信中國50正2,37,12,25,富邦-宜蘭,2023-12-05,9686
6116,彩晶,26,1,25,富邦-宜蘭,2023-12-05,9686
1815,富喬,24,0,24,富邦-宜蘭,2023-12-05,9686
2891,中信金,24,0,24,富邦-宜蘭,2023-12-05,9686
6282,康舒,28,5,23,富邦-宜蘭,2023-12-05,9686
6742,澤米,23,0,23,富邦-宜蘭,2023-12-05,9686
2428,興勤,22,0,22,富邦-宜蘭,2023-12-05,9686
2303,聯電,21,0,21,富邦-宜蘭,2023-12-05,9686
2344,華邦電,24,4,20,富邦-宜蘭,2023-12-05,9686
3013,晟銘電,46,26,20,富邦-宜蘭,2023-12-05,9686
2881,富邦金,27,7,20,富邦-宜蘭,2023-12-05,9686
2618,長榮航,31,12,19,富邦-宜蘭,2023-12-05,9686
00878,國泰永續高股息,26,8,18,富邦-宜蘭,2023-12-05,9686
6143,振曜,30,12,18,富邦-宜蘭,2023-12-05,9686
3287,廣寰科,49,32,17,富邦-宜蘭,2023-12-05,9686
00669R,國泰美國道瓊反1,17,0,17,富邦-宜蘭,2023-12-05,9686
4167,松瑞藥,56,39,17,富邦-宜蘭,2023-12-05,9686
3481,群創,367,7,360,富邦-宜蘭,2023-12-06,9686
00905,FT臺灣Smart,273,0,273,富邦-宜蘭,2023-12-06,9686
00937B,群益ESG投等債20,304,34,270,富邦-宜蘭,2023-12-06,9686
00680L,元大美債20正2,227,30,197,富邦-宜蘭,2023-12-06,9686
00882,中信中國高股息,151,1,150,富邦-宜蘭,2023-12-06,9686
00637L,元大滬深300正2,145,10,135,富邦-宜蘭,2023-12-06,9686
2883,凱基金,98,0,98,富邦-宜蘭,2023-12-06,9686
00919,群益台灣精選高息,119,22,97,富邦-宜蘭,2023-12-06,9686
3265,台星科,105,11,94,富邦-宜蘭,2023-12-06,9686
1452,宏益,202,133,69,富邦-宜蘭,2023-12-06,9686
2419,仲琦,83,27,56,富邦-宜蘭,2023-12-06,9686
00931B,統一美債20年,50,1,49,富邦-宜蘭,2023-12-06,9686
5230,雷笛克光學,50,1,49,富邦-宜蘭,2023-12-06,9686
00679B,元大美債20年,53,7,46,富邦-宜蘭,2023-12-06,9686
00751B,元大AAA至A公司債,47,1,46,富邦-宜蘭,2023-12-06,9686
5464,霖宏,36,2,34,富邦-宜蘭,2023-12-06,9686
4164,承業醫,34,0,34,富邦-宜蘭,2023-12-06,9686
6257,矽格,35,2,33,富邦-宜蘭,2023-12-06,9686
00900,富邦特選高股息30,41,8,33,富邦-宜蘭,2023-12-06,9686
00632R,元大台灣50反1,32,0,32,富邦-宜蘭,2023-12-06,9686
1612,宏泰,35,3,32,富邦-宜蘭,2023-12-06,9686
8089,康全電訊,32,0,32,富邦-宜蘭,2023-12-06,9686
6111,大宇資,31,1,30,富邦-宜蘭,2023-12-06,9686
6125,廣運,41,12,29,富邦-宜蘭,2023-12-06,9686
2371,大同,40,11,29,富邦-宜蘭,2023-12-06,9686
2355,敬鵬,118,90,28,富邦-宜蘭,2023-12-06,9686
1605,華新,33,7,26,富邦-宜蘭,2023-12-06,9686
1513,中興電,44,18,26,富邦-宜蘭,2023-12-06,9686
6288,聯嘉,25,0,25,富邦-宜蘭,2023-12-06,9686
00687B,國泰20年美債,24,0,24,富邦-宜蘭,2023-12-06,9686
6122,擎邦,28,5,23,富邦-宜蘭,2023-12-06,9686
8034,榮群,25,3,22,富邦-宜蘭,2023-12-06,9686
2457,飛宏,21,1,20,富邦-宜蘭,2023-12-06,9686
6213,聯茂,20,0,20,富邦-宜蘭,2023-12-06,9686
00715L,期街口布蘭特正2,18,0,18,富邦-宜蘭,2023-12-06,9686
2393,億光,18,0,18,富邦-宜蘭,2023-12-06,9686
2344,華邦電,17,1,16,富邦-宜蘭,2023-12-06,9686
6904,伯鑫,18,2,16,富邦-宜蘭,2023-12-06,9686
1609,大亞,15,0,15,富邦-宜蘭,2023-12-06,9686
2363,矽統,20,5,15,富邦-宜蘭,2023-12-06,9686
5386,青雲,25,11,14,富邦-宜蘭,2023-12-06,9686
1529,樂事綠能,28,14,14,富邦-宜蘭,2023-12-06,9686
2444,兆勁,13,0,13,富邦-宜蘭,2023-12-06,9686
00712,復華富時不動產,13,0,13,富邦-宜蘭,2023-12-06,9686
00688L,國泰20年美債正2,13,0,13,富邦-宜蘭,2023-12-06,9686
4945,陞達科技,13,0,13,富邦-宜蘭,2023-12-06,9686
1101,台泥,16,3,13,富邦-宜蘭,2023-12-06,9686
2010,春源,12,0,12,富邦-宜蘭,2023-12-06,9686
6291,沛亨,12,0,12,富邦-宜蘭,2023-12-06,9686
4952,凌通,29,17,12,富邦-宜蘭,2023-12-06,9686
00664R,國泰臺灣加權反1,830,0,830,富邦-宜蘭,2023-12-07,9686
00632R,元大台灣50反1,600,0,600,富邦-宜蘭,2023-12-07,9686
00919,群益台灣精選高息,270,0,270,富邦-宜蘭,2023-12-07,9686
00679B,元大美債20年,240,52,188,富邦-宜蘭,2023-12-07,9686
3041,揚智,154,34,120,富邦-宜蘭,2023-12-07,9686
2399,映泰,191,73,118,富邦-宜蘭,2023-12-07,9686
2889,國票金,93,2,91,富邦-宜蘭,2023-12-07,9686
1522,堤維西,155,72,83,富邦-宜蘭,2023-12-07,9686
00931B,統一美債20年,116,34,82,富邦-宜蘭,2023-12-07,9686
1616,億泰,87,19,68,富邦-宜蘭,2023-12-07,9686
00918,大華優利高填息30,67,0,67,富邦-宜蘭,2023-12-07,9686
2344,華邦電,64,2,62,富邦-宜蘭,2023-12-07,9686
1611,中電,62,0,62,富邦-宜蘭,2023-12-07,9686
1466,聚隆,60,2,58,富邦-宜蘭,2023-12-07,9686
00665L,富邦�琤肭磪囓�2,53,0,53,富邦-宜蘭,2023-12-07,9686
2412,中華電,53,0,53,富邦-宜蘭,2023-12-07,9686
1609,大亞,203,152,51,富邦-宜蘭,2023-12-07,9686
9105,泰金寶-DR,66,15,51,富邦-宜蘭,2023-12-07,9686
00712,復華富時不動產,52,4,48,富邦-宜蘭,2023-12-07,9686
00715L,期街口布蘭特正2,48,0,48,富邦-宜蘭,2023-12-07,9686
2887,台新金,45,0,45,富邦-宜蘭,2023-12-07,9686
8936,國統,53,9,44,富邦-宜蘭,2023-12-07,9686
2417,圓剛,44,0,44,富邦-宜蘭,2023-12-07,9686
4561,健椿,60,17,43,富邦-宜蘭,2023-12-07,9686
4533,協易機,89,52,37,富邦-宜蘭,2023-12-07,9686
6153,嘉聯益,30,0,30,富邦-宜蘭,2023-12-07,9686
00753L,中信中國50正2,29,0,29,富邦-宜蘭,2023-12-07,9686
00933B,國泰10Y+金融債,24,0,24,富邦-宜蘭,2023-12-07,9686
3706,神達,45,21,24,富邦-宜蘭,2023-12-07,9686
2609,陽明,27,3,24,富邦-宜蘭,2023-12-07,9686
5351,鈺創,25,2,23,富邦-宜蘭,2023-12-07,9686
6125,廣運,26,4,22,富邦-宜蘭,2023-12-07,9686
00688L,國泰20年美債正2,22,0,22,富邦-宜蘭,2023-12-07,9686
5210,寶碩,21,0,21,富邦-宜蘭,2023-12-07,9686
1339,昭輝,30,9,21,富邦-宜蘭,2023-12-07,9686
5302,太欣,21,0,21,富邦-宜蘭,2023-12-07,9686
1434,福懋,20,0,20,富邦-宜蘭,2023-12-07,9686
2388,威盛,65,45,20,富邦-宜蘭,2023-12-07,9686
00687B,國泰20年美債,29,10,19,富邦-宜蘭,2023-12-07,9686
1618,合機,42,23,19,富邦-宜蘭,2023-12-07,9686
2355,敬鵬,121,103,18,富邦-宜蘭,2023-12-07,9686
2303,聯電,20,2,18,富邦-宜蘭,2023-12-07,9686
00882,中信中國高股息,19,2,17,富邦-宜蘭,2023-12-07,9686
2543,皇昌,17,0,17,富邦-宜蘭,2023-12-07,9686
1795,美時,17,0,17,富邦-宜蘭,2023-12-07,9686
00720B,元大投資級公司債,19,2,17,富邦-宜蘭,2023-12-07,9686
0056,元大高股息,34,17,17,富邦-宜蘭,2023-12-07,9686
2881,富邦金,46,30,16,富邦-宜蘭,2023-12-07,9686
5512,力麒,19,3,16,富邦-宜蘭,2023-12-07,9686
4967,十銓,29,13,16,富邦-宜蘭,2023-12-07,9686
00679B,元大美債20年,213,30,183,富邦-宜蘭,2023-12-08,9686
2605,新興,521,369,152,富邦-宜蘭,2023-12-08,9686
2611,志信,117,2,115,富邦-宜蘭,2023-12-08,9686
3231,緯創,169,64,105,富邦-宜蘭,2023-12-08,9686
5608,四維航,112,9,103,富邦-宜蘭,2023-12-08,9686
00905,FT臺灣Smart,100,1,99,富邦-宜蘭,2023-12-08,9686
9103,美德醫療-DR,90,0,90,富邦-宜蘭,2023-12-08,9686
00919,群益台灣精選高息,140,55,85,富邦-宜蘭,2023-12-08,9686
00937B,群益ESG投等債20,79,16,63,富邦-宜蘭,2023-12-08,9686
00929,復華台灣科技優息,75,14,61,富邦-宜蘭,2023-12-08,9686
00931B,統一美債20年,61,1,60,富邦-宜蘭,2023-12-08,9686
2359,所羅門,57,6,51,富邦-宜蘭,2023-12-08,9686
1514,亞力,118,73,45,富邦-宜蘭,2023-12-08,9686
2329,華泰,84,40,44,富邦-宜蘭,2023-12-08,9686
2342,茂矽,41,0,41,富邦-宜蘭,2023-12-08,9686
2867,三商壽,40,0,40,富邦-宜蘭,2023-12-08,9686
3481,群創,46,8,38,富邦-宜蘭,2023-12-08,9686
8354,冠好,31,1,30,富邦-宜蘭,2023-12-08,9686
1504,東元,29,2,27,富邦-宜蘭,2023-12-08,9686
00687B,國泰20年美債,32,6,26,富邦-宜蘭,2023-12-08,9686
2634,漢翔,28,2,26,富邦-宜蘭,2023-12-08,9686
1452,宏益,106,80,26,富邦-宜蘭,2023-12-08,9686
1522,堤維西,59,34,25,富邦-宜蘭,2023-12-08,9686
2376,技嘉,41,18,23,富邦-宜蘭,2023-12-08,9686
2314,台揚,28,5,23,富邦-宜蘭,2023-12-08,9686
2889,國票金,22,0,22,富邦-宜蘭,2023-12-08,9686
3078,僑威,92,71,21,富邦-宜蘭,2023-12-08,9686
1608,華榮,22,1,21,富邦-宜蘭,2023-12-08,9686
4906,正文,29,8,21,富邦-宜蘭,2023-12-08,9686
9934,成霖,20,0,20,富邦-宜蘭,2023-12-08,9686
2399,映泰,47,28,19,富邦-宜蘭,2023-12-08,9686
5302,太欣,18,0,18,富邦-宜蘭,2023-12-08,9686
6023,元大期,23,5,18,富邦-宜蘭,2023-12-08,9686
6274,台燿,27,9,18,富邦-宜蘭,2023-12-08,9686
6668,中揚光,18,0,18,富邦-宜蘭,2023-12-08,9686
5328,華容,20,3,17,富邦-宜蘭,2023-12-08,9686
2358,廷鑫,25,8,17,富邦-宜蘭,2023-12-08,9686
00882,中信中國高股息,16,0,16,富邦-宜蘭,2023-12-08,9686
6235,華孚,14,0,14,富邦-宜蘭,2023-12-08,9686
3576,聯合再生,14,0,14,富邦-宜蘭,2023-12-08,9686
6271,同欣電,19,5,14,富邦-宜蘭,2023-12-08,9686
3265,台星科,22,8,14,富邦-宜蘭,2023-12-08,9686
00918,大華優利高填息30,13,0,13,富邦-宜蘭,2023-12-08,9686
2363,矽統,19,6,13,富邦-宜蘭,2023-12-08,9686
1815,富喬,12,0,12,富邦-宜蘭,2023-12-08,9686
1536,和大,11,0,11,富邦-宜蘭,2023-12-08,9686
4114,健喬,14,3,11,富邦-宜蘭,2023-12-08,9686
3522,御嵿,11,0,11,富邦-宜蘭,2023-12-08,9686
3714,富采,11,0,11,富邦-宜蘭,2023-12-08,9686
2884,玉山金,12,1,11,富邦-宜蘭,2023-12-08,9686
00919,群益台灣精選高息,1676,32,1644,富邦-宜蘭,2023-12-11,9686
2883,凱基金,190,1,189,富邦-宜蘭,2023-12-11,9686
6265,方土昶,158,2,156,富邦-宜蘭,2023-12-11,9686
00679B,元大美債20年,147,0,147,富邦-宜蘭,2023-12-11,9686
2888,新光金,115,14,101,富邦-宜蘭,2023-12-11,9686
8050,廣積,100,0,100,富邦-宜蘭,2023-12-11,9686
3437,榮創,101,2,99,富邦-宜蘭,2023-12-11,9686
00795B,中信美國公債20年,96,0,96,富邦-宜蘭,2023-12-11,9686
00751B,元大AAA至A公司債,85,0,85,富邦-宜蘭,2023-12-11,9686
00929,復華台灣科技優息,77,12,65,富邦-宜蘭,2023-12-11,9686
2605,新興,109,51,58,富邦-宜蘭,2023-12-11,9686
00753L,中信中國50正2,52,0,52,富邦-宜蘭,2023-12-11,9686
00882,中信中國高股息,54,1,53,富邦-宜蘭,2023-12-11,9686
00688L,國泰20年美債正2,44,2,42,富邦-宜蘭,2023-12-11,9686
00637L,元大滬深300正2,38,0,38,富邦-宜蘭,2023-12-11,9686
00937B,群益ESG投等債20,185,152,33,富邦-宜蘭,2023-12-11,9686
1608,華榮,45,12,33,富邦-宜蘭,2023-12-11,9686
4933,友輝,33,0,33,富邦-宜蘭,2023-12-11,9686
2002,中鋼,38,6,32,富邦-宜蘭,2023-12-11,9686
2382,廣達,42,10,32,富邦-宜蘭,2023-12-11,9686
2882,國泰金,32,0,32,富邦-宜蘭,2023-12-11,9686
2543,皇昌,33,3,30,富邦-宜蘭,2023-12-11,9686
2618,長榮航,52,23,29,富邦-宜蘭,2023-12-11,9686
2615,萬海,27,0,27,富邦-宜蘭,2023-12-11,9686
2409,友達,26,0,26,富邦-宜蘭,2023-12-11,9686
2630,亞航,28,3,25,富邦-宜蘭,2023-12-11,9686
00650L,復華香港正2,25,0,25,富邦-宜蘭,2023-12-11,9686
2887,台新金,30,6,24,富邦-宜蘭,2023-12-11,9686
2417,圓剛,43,20,23,富邦-宜蘭,2023-12-11,9686
1524,耿鼎,141,119,22,富邦-宜蘭,2023-12-11,9686
00680L,元大美債20正2,35,13,22,富邦-宜蘭,2023-12-11,9686
00933B,國泰10Y+金融債,31,10,21,富邦-宜蘭,2023-12-11,9686
2491,吉祥全,20,0,20,富邦-宜蘭,2023-12-11,9686
00725B,國泰投資級公司債,20,0,20,富邦-宜蘭,2023-12-11,9686
00740B,富邦全球投等債,20,0,20,富邦-宜蘭,2023-12-11,9686
8034,榮群,22,2,20,富邦-宜蘭,2023-12-11,9686
1104,環泥,20,0,20,富邦-宜蘭,2023-12-11,9686
3607,谷崧,21,2,19,富邦-宜蘭,2023-12-11,9686
6284,佳邦,26,7,19,富邦-宜蘭,2023-12-11,9686
2303,聯電,22,4,18,富邦-宜蘭,2023-12-11,9686
00665L,富邦�琤肭磪囓�2,20,2,18,富邦-宜蘭,2023-12-11,9686
9940,信義,23,5,18,富邦-宜蘭,2023-12-11,9686
6457,紘康,20,2,18,富邦-宜蘭,2023-12-11,9686
1609,大亞,49,31,18,富邦-宜蘭,2023-12-11,9686
3078,僑威,23,6,17,富邦-宜蘭,2023-12-11,9686
6143,振曜,19,2,17,富邦-宜蘭,2023-12-11,9686
1815,富喬,32,15,17,富邦-宜蘭,2023-12-11,9686
6282,康舒,42,26,16,富邦-宜蘭,2023-12-11,9686
3013,晟銘電,35,19,16,富邦-宜蘭,2023-12-11,9686
1314,中石化,16,0,16,富邦-宜蘭,2023-12-11,9686
00919,群益台灣精選高息,348,51,297,富邦-宜蘭,2023-12-12,9686
00664R,國泰臺灣加權反1,260,0,260,富邦-宜蘭,2023-12-12,9686
00918,大華優利高填息30,179,40,139,富邦-宜蘭,2023-12-12,9686
1314,中石化,113,0,113,富邦-宜蘭,2023-12-12,9686
00929,復華台灣科技優息,152,46,106,富邦-宜蘭,2023-12-12,9686
2618,長榮航,131,27,104,富邦-宜蘭,2023-12-12,9686
00632R,元大台灣50反1,104,10,94,富邦-宜蘭,2023-12-12,9686
2609,陽明,133,39,94,富邦-宜蘭,2023-12-12,9686
9105,泰金寶-DR,104,33,71,富邦-宜蘭,2023-12-12,9686
2641,正德,79,11,68,富邦-宜蘭,2023-12-12,9686
5426,振發,84,24,60,富邦-宜蘭,2023-12-12,9686
2323,中環,57,0,57,富邦-宜蘭,2023-12-12,9686
1591,駿吉-KY,51,0,51,富邦-宜蘭,2023-12-12,9686
3287,廣寰科,79,32,47,富邦-宜蘭,2023-12-12,9686
2516,新建,45,8,37,富邦-宜蘭,2023-12-12,9686
2314,台揚,38,1,37,富邦-宜蘭,2023-12-12,9686
2313,華通,82,46,36,富邦-宜蘭,2023-12-12,9686
00937B,群益ESG投等債20,62,29,33,富邦-宜蘭,2023-12-12,9686
00688L,國泰20年美債正2,32,0,32,富邦-宜蘭,2023-12-12,9686
3266,昇陽,32,1,31,富邦-宜蘭,2023-12-12,9686
1536,和大,30,0,30,富邦-宜蘭,2023-12-12,9686
5351,鈺創,43,13,30,富邦-宜蘭,2023-12-12,9686
2020,美亞,30,0,30,富邦-宜蘭,2023-12-12,9686
6203,海韻電,30,0,30,富邦-宜蘭,2023-12-12,9686
4939,亞電,29,0,29,富邦-宜蘭,2023-12-12,9686
4167,松瑞藥,30,1,29,富邦-宜蘭,2023-12-12,9686
3058,立德,27,0,27,富邦-宜蘭,2023-12-12,9686
2883,凱基金,30,5,25,富邦-宜蘭,2023-12-12,9686
3325,旭品,26,2,24,富邦-宜蘭,2023-12-12,9686
2002,中鋼,51,28,23,富邦-宜蘭,2023-12-12,9686
2359,所羅門,25,2,23,富邦-宜蘭,2023-12-12,9686
2392,正崴,60,38,22,富邦-宜蘭,2023-12-12,9686
6143,振曜,22,1,21,富邦-宜蘭,2023-12-12,9686
00915,凱基優選高股息30,21,0,21,富邦-宜蘭,2023-12-12,9686
00679B,元大美債20年,22,1,21,富邦-宜蘭,2023-12-12,9686
3481,群創,111,91,20,富邦-宜蘭,2023-12-12,9686
00687B,國泰20年美債,20,0,20,富邦-宜蘭,2023-12-12,9686
4967,十銓,73,54,19,富邦-宜蘭,2023-12-12,9686
00751B,元大AAA至A公司債,19,0,19,富邦-宜蘭,2023-12-12,9686
2409,友達,33,16,17,富邦-宜蘭,2023-12-12,9686
00712,復華富時不動產,19,2,17,富邦-宜蘭,2023-12-12,9686
00931B,統一美債20年,23,6,17,富邦-宜蘭,2023-12-12,9686
3694,海華,27,10,17,富邦-宜蘭,2023-12-12,9686
2399,映泰,24,8,16,富邦-宜蘭,2023-12-12,9686
2439,美律,19,3,16,富邦-宜蘭,2023-12-12,9686
2636,台驊控股,16,1,15,富邦-宜蘭,2023-12-12,9686
4908,前鼎,31,17,14,富邦-宜蘭,2023-12-12,9686
2867,三商壽,15,1,14,富邦-宜蘭,2023-12-12,9686
6695,芯鼎,24,10,14,富邦-宜蘭,2023-12-12,9686
1608,華榮,22,8,14,富邦-宜蘭,2023-12-12,9686
00931B,統一美債20年,348,20,328,富邦-宜蘭,2023-12-13,9686
00919,群益台灣精選高息,339,45,294,富邦-宜蘭,2023-12-13,9686
2883,凱基金,222,0,222,富邦-宜蘭,2023-12-13,9686
00637L,元大滬深300正2,172,0,172,富邦-宜蘭,2023-12-13,9686
00664R,國泰臺灣加權反1,140,0,140,富邦-宜蘭,2023-12-13,9686
00632R,元大台灣50反1,112,0,112,富邦-宜蘭,2023-12-13,9686
00715L,期街口布蘭特正2,102,0,102,富邦-宜蘭,2023-12-13,9686
5426,振發,93,12,81,富邦-宜蘭,2023-12-13,9686
00918,大華優利高填息30,82,5,77,富邦-宜蘭,2023-12-13,9686
4939,亞電,113,40,73,富邦-宜蘭,2023-12-13,9686
00882,中信中國高股息,69,4,65,富邦-宜蘭,2023-12-13,9686
00905,FT臺灣Smart,60,0,60,富邦-宜蘭,2023-12-13,9686
2303,聯電,66,8,58,富邦-宜蘭,2023-12-13,9686
8089,康全電訊,57,1,56,富邦-宜蘭,2023-12-13,9686
3287,廣寰科,81,28,53,富邦-宜蘭,2023-12-13,9686
00753L,中信中國50正2,74,23,51,富邦-宜蘭,2023-12-13,9686
00907,永豐優息存股,48,0,48,富邦-宜蘭,2023-12-13,9686
6265,方土昶,49,2,47,富邦-宜蘭,2023-12-13,9686
00937B,群益ESG投等債20,45,1,44,富邦-宜蘭,2023-12-13,9686
6457,紘康,40,1,39,富邦-宜蘭,2023-12-13,9686
3706,神達,79,48,31,富邦-宜蘭,2023-12-13,9686
1452,宏益,100,70,30,富邦-宜蘭,2023-12-13,9686
2419,仲琦,109,81,28,富邦-宜蘭,2023-12-13,9686
2881,富邦金,26,0,26,富邦-宜蘭,2023-12-13,9686
2609,陽明,39,13,26,富邦-宜蘭,2023-12-13,9686
6139,亞翔,44,19,25,富邦-宜蘭,2023-12-13,9686
8034,榮群,27,5,22,富邦-宜蘭,2023-12-13,9686
2002,中鋼,23,2,21,富邦-宜蘭,2023-12-13,9686
00636,國泰中國A50,21,0,21,富邦-宜蘭,2023-12-13,9686
2006,東和鋼鐵,20,0,20,富邦-宜蘭,2023-12-13,9686
3622,洋華,57,37,20,富邦-宜蘭,2023-12-13,9686
1217,愛之味,20,0,20,富邦-宜蘭,2023-12-13,9686
2025,千興,20,0,20,富邦-宜蘭,2023-12-13,9686
1584,精剛,30,11,19,富邦-宜蘭,2023-12-13,9686
8011,台通,33,14,19,富邦-宜蘭,2023-12-13,9686
3035,智原,49,31,18,富邦-宜蘭,2023-12-13,9686
6206,飛捷,20,2,18,富邦-宜蘭,2023-12-13,9686
2501,國建,20,2,18,富邦-宜蘭,2023-12-13,9686
2610,華航,40,23,17,富邦-宜蘭,2023-12-13,9686
2543,皇昌,25,8,17,富邦-宜蘭,2023-12-13,9686
1434,福懋,16,0,16,富邦-宜蘭,2023-12-13,9686
6517,保勝光學,20,4,16,富邦-宜蘭,2023-12-13,9686
2634,漢翔,50,36,14,富邦-宜蘭,2023-12-13,9686
4915,致伸,18,4,14,富邦-宜蘭,2023-12-13,9686
3715,定穎投控,22,8,14,富邦-宜蘭,2023-12-13,9686
2027,大成鋼,14,1,13,富邦-宜蘭,2023-12-13,9686
5011,久陽,13,0,13,富邦-宜蘭,2023-12-13,9686
00642U,期元大S＆P石油,13,0,13,富邦-宜蘭,2023-12-13,9686
6282,康舒,21,9,12,富邦-宜蘭,2023-12-13,9686
6243,迅杰,13,1,12,富邦-宜蘭,2023-12-13,9686
00664R,國泰臺灣加權反1,704,0,704,富邦-宜蘭,2023-12-14,9686
00632R,元大台灣50反1,703,35,668,富邦-宜蘭,2023-12-14,9686
00919,群益台灣精選高息,448,91,357,富邦-宜蘭,2023-12-14,9686
5521,工信,293,80,213,富邦-宜蘭,2023-12-14,9686
00637L,元大滬深300正2,228,15,213,富邦-宜蘭,2023-12-14,9686
00937B,群益ESG投等債20,193,27,166,富邦-宜蘭,2023-12-14,9686
2515,中工,161,30,131,富邦-宜蘭,2023-12-14,9686
5426,振發,197,66,131,富邦-宜蘭,2023-12-14,9686
2365,昆盈,190,74,116,富邦-宜蘭,2023-12-14,9686
2885,元大金,126,13,113,富邦-宜蘭,2023-12-14,9686
8089,康全電訊,107,7,100,富邦-宜蘭,2023-12-14,9686
00676R,富邦臺灣加權反1,300,200,100,富邦-宜蘭,2023-12-14,9686
00905,FT臺灣Smart,100,0,100,富邦-宜蘭,2023-12-14,9686
6770,力積電,104,7,97,富邦-宜蘭,2023-12-14,9686
00687B,國泰20年美債,102,14,88,富邦-宜蘭,2023-12-14,9686
00679B,元大美債20年,72,10,62,富邦-宜蘭,2023-12-14,9686
2547,日勝生,60,0,60,富邦-宜蘭,2023-12-14,9686
2363,矽統,243,191,52,富邦-宜蘭,2023-12-14,9686
00933B,國泰10Y+金融債,57,10,47,富邦-宜蘭,2023-12-14,9686
1815,富喬,66,26,40,富邦-宜蘭,2023-12-14,9686
9940,信義,40,0,40,富邦-宜蘭,2023-12-14,9686
3645,達邁,41,2,39,富邦-宜蘭,2023-12-14,9686
00929,復華台灣科技優息,136,101,35,富邦-宜蘭,2023-12-14,9686
2401,凌陽,47,12,35,富邦-宜蘭,2023-12-14,9686
00934,中信成長高股息,35,0,35,富邦-宜蘭,2023-12-14,9686
2405,輔信,35,1,34,富邦-宜蘭,2023-12-14,9686
3704,合勤控,36,2,34,富邦-宜蘭,2023-12-14,9686
3481,群創,33,0,33,富邦-宜蘭,2023-12-14,9686
3508,位速,32,2,30,富邦-宜蘭,2023-12-14,9686
6118,建達,30,2,28,富邦-宜蘭,2023-12-14,9686
0056,元大高股息,48,21,27,富邦-宜蘭,2023-12-14,9686
6292,迅德,29,2,27,富邦-宜蘭,2023-12-14,9686
2353,宏��,34,7,27,富邦-宜蘭,2023-12-14,9686
3576,聯合再生,26,0,26,富邦-宜蘭,2023-12-14,9686
3163,波若威,32,7,25,富邦-宜蘭,2023-12-14,9686
8011,台通,30,6,24,富邦-宜蘭,2023-12-14,9686
2630,亞航,25,3,22,富邦-宜蘭,2023-12-14,9686
3694,海華,28,7,21,富邦-宜蘭,2023-12-14,9686
2498,宏達電,49,28,21,富邦-宜蘭,2023-12-14,9686
6206,飛捷,20,0,20,富邦-宜蘭,2023-12-14,9686
00932,兆豐永續高息等權,20,0,20,富邦-宜蘭,2023-12-14,9686
3322,建舜電,20,1,19,富邦-宜蘭,2023-12-14,9686
3380,明泰,19,0,19,富邦-宜蘭,2023-12-14,9686
2603,長榮,30,12,18,富邦-宜蘭,2023-12-14,9686
2313,華通,130,112,18,富邦-宜蘭,2023-12-14,9686
6257,矽格,38,21,17,富邦-宜蘭,2023-12-14,9686
00935,野村臺灣新科技50,17,1,16,富邦-宜蘭,2023-12-14,9686
3390,旭軟,51,35,16,富邦-宜蘭,2023-12-14,9686
3011,今皓,16,0,16,富邦-宜蘭,2023-12-14,9686
4915,致伸,16,0,16,富邦-宜蘭,2023-12-14,9686
00918,大華優利高填息30,192,32,160,富邦-宜蘭,2023-12-15,9686
00919,群益台灣精選高息,354,233,121,富邦-宜蘭,2023-12-15,9686
00929,復華台灣科技優息,169,89,80,富邦-宜蘭,2023-12-15,9686
2356,英業達,401,326,75,富邦-宜蘭,2023-12-15,9686
8011,台通,74,4,70,富邦-宜蘭,2023-12-15,9686
1618,合機,69,6,63,富邦-宜蘭,2023-12-15,9686
2382,廣達,55,4,51,富邦-宜蘭,2023-12-15,9686
6125,廣運,49,2,47,富邦-宜蘭,2023-12-15,9686
8034,榮群,44,1,43,富邦-宜蘭,2023-12-15,9686
2630,亞航,42,0,42,富邦-宜蘭,2023-12-15,9686
00687B,國泰20年美債,62,20,42,富邦-宜蘭,2023-12-15,9686
2637,慧洋-KY,43,2,41,富邦-宜蘭,2023-12-15,9686
00933B,國泰10Y+金融債,41,0,41,富邦-宜蘭,2023-12-15,9686
00679B,元大美債20年,46,7,39,富邦-宜蘭,2023-12-15,9686
00722B,群益投資級電信債,36,0,36,富邦-宜蘭,2023-12-15,9686
00930,永豐ESG低碳高息,37,1,36,富邦-宜蘭,2023-12-15,9686
00751B,元大AAA至A公司債,40,7,33,富邦-宜蘭,2023-12-15,9686
1514,亞力,43,11,32,富邦-宜蘭,2023-12-15,9686
6257,矽格,82,50,32,富邦-宜蘭,2023-12-15,9686
00680L,元大美債20正2,34,3,31,富邦-宜蘭,2023-12-15,9686
5469,瀚宇博,34,4,30,富邦-宜蘭,2023-12-15,9686
0056,元大高股息,47,19,28,富邦-宜蘭,2023-12-15,9686
4939,亞電,27,0,27,富邦-宜蘭,2023-12-15,9686
9105,泰金寶-DR,26,0,26,富邦-宜蘭,2023-12-15,9686
00715L,期街口布蘭特正2,33,7,26,富邦-宜蘭,2023-12-15,9686
4746,台耀,34,9,25,富邦-宜蘭,2023-12-15,9686
2401,凌陽,25,0,25,富邦-宜蘭,2023-12-15,9686
00637L,元大滬深300正2,25,1,24,富邦-宜蘭,2023-12-15,9686
6509,聚和,25,2,23,富邦-宜蘭,2023-12-15,9686
9958,世紀鋼,54,31,23,富邦-宜蘭,2023-12-15,9686
6192,巨路,22,0,22,富邦-宜蘭,2023-12-15,9686
2363,矽統,308,287,21,富邦-宜蘭,2023-12-15,9686
00931B,統一美債20年,30,10,20,富邦-宜蘭,2023-12-15,9686
2949,欣新網,20,0,20,富邦-宜蘭,2023-12-15,9686
020029,元大ESG高股息N,20,0,20,富邦-宜蘭,2023-12-15,9686
2484,希華,20,0,20,富邦-宜蘭,2023-12-15,9686
6173,信昌電,21,1,20,富邦-宜蘭,2023-12-15,9686
2883,凱基金,27,7,20,富邦-宜蘭,2023-12-15,9686
2211,長榮鋼,22,3,19,富邦-宜蘭,2023-12-15,9686
00935,野村臺灣新科技50,19,1,18,富邦-宜蘭,2023-12-15,9686
3623,富晶通,30,12,18,富邦-宜蘭,2023-12-15,9686
3122,笙泉,19,2,17,富邦-宜蘭,2023-12-15,9686
2405,輔信,17,0,17,富邦-宜蘭,2023-12-15,9686
2883B,凱基金乙特,17,0,17,富邦-宜蘭,2023-12-15,9686
2618,長榮航,18,2,16,富邦-宜蘭,2023-12-15,9686
00934,中信成長高股息,29,13,16,富邦-宜蘭,2023-12-15,9686
6548,長科*,16,0,16,富邦-宜蘭,2023-12-15,9686
6248,沛波,67,52,15,富邦-宜蘭,2023-12-15,9686
6275,元山,21,6,15,富邦-宜蘭,2023-12-15,9686
2388,威盛,64,49,15,富邦-宜蘭,2023-12-15,9686
00929,復華台灣科技優息,398,191,207,富邦-宜蘭,2023-12-18,9686
00637L,元大滬深300正2,215,39,176,富邦-宜蘭,2023-12-18,9686
00919,群益台灣精選高息,272,123,149,富邦-宜蘭,2023-12-18,9686
00936,台新永續高息中小,120,10,110,富邦-宜蘭,2023-12-18,9686
00712,復華富時不動產,123,19,104,富邦-宜蘭,2023-12-18,9686
3049,精金,100,0,100,富邦-宜蘭,2023-12-18,9686
00878,國泰永續高股息,94,11,83,富邦-宜蘭,2023-12-18,9686
2010,春源,82,2,80,富邦-宜蘭,2023-12-18,9686
1905,華紙,100,28,72,富邦-宜蘭,2023-12-18,9686
00650L,復華香港正2,71,0,71,富邦-宜蘭,2023-12-18,9686
00885,富邦越南,67,2,65,富邦-宜蘭,2023-12-18,9686
2505,國揚,60,0,60,富邦-宜蘭,2023-12-18,9686
2030,彰源,65,5,60,富邦-宜蘭,2023-12-18,9686
1701,中化,60,0,60,富邦-宜蘭,2023-12-18,9686
6206,飛捷,60,0,60,富邦-宜蘭,2023-12-18,9686
9962,有益,60,1,59,富邦-宜蘭,2023-12-18,9686
00937B,群益ESG投等債20,103,45,58,富邦-宜蘭,2023-12-18,9686
2618,長榮航,68,16,52,富邦-宜蘭,2023-12-18,9686
1721,三晃,50,1,49,富邦-宜蘭,2023-12-18,9686
00679B,元大美債20年,57,10,47,富邦-宜蘭,2023-12-18,9686
0056,元大高股息,61,15,46,富邦-宜蘭,2023-12-18,9686
2023,燁輝,99,54,45,富邦-宜蘭,2023-12-18,9686
2614,東森,43,0,43,富邦-宜蘭,2023-12-18,9686
2356,英業達,133,90,43,富邦-宜蘭,2023-12-18,9686
00687B,國泰20年美債,42,2,40,富邦-宜蘭,2023-12-18,9686
00931B,統一美債20年,44,5,39,富邦-宜蘭,2023-12-18,9686
00751B,元大AAA至A公司債,42,6,36,富邦-宜蘭,2023-12-18,9686
00933B,國泰10Y+金融債,34,0,34,富邦-宜蘭,2023-12-18,9686
1605,華新,132,101,31,富邦-宜蘭,2023-12-18,9686
2812,台中銀,31,0,31,富邦-宜蘭,2023-12-18,9686
2615,萬海,40,11,29,富邦-宜蘭,2023-12-18,9686
2328,廣宇,27,0,27,富邦-宜蘭,2023-12-18,9686
2543,皇昌,27,1,26,富邦-宜蘭,2023-12-18,9686
2449,京元電子,32,7,25,富邦-宜蘭,2023-12-18,9686
00753L,中信中國50正2,25,0,25,富邦-宜蘭,2023-12-18,9686
6770,力積電,56,31,25,富邦-宜蘭,2023-12-18,9686
6742,澤米,24,1,23,富邦-宜蘭,2023-12-18,9686
4167,松瑞藥,101,79,22,富邦-宜蘭,2023-12-18,9686
2211,長榮鋼,23,2,21,富邦-宜蘭,2023-12-18,9686
3014,聯陽,22,2,20,富邦-宜蘭,2023-12-18,9686
00720B,元大投資級公司債,23,3,20,富邦-宜蘭,2023-12-18,9686
2801,彰銀,20,0,20,富邦-宜蘭,2023-12-18,9686
9919,康那香,24,4,20,富邦-宜蘭,2023-12-18,9686
5210,寶碩,20,0,20,富邦-宜蘭,2023-12-18,9686
6168,宏齊,26,7,19,富邦-宜蘭,2023-12-18,9686
2008,高興昌,21,2,19,富邦-宜蘭,2023-12-18,9686
2890,永豐金,18,0,18,富邦-宜蘭,2023-12-18,9686
2417,圓剛,20,2,18,富邦-宜蘭,2023-12-18,9686
3481,群創,19,3,16,富邦-宜蘭,2023-12-18,9686
5425,台半,54,39,15,富邦-宜蘭,2023-12-18,9686
0056,元大高股息,962,1,961,富邦-宜蘭,2023-12-19,9686
00929,復華台灣科技優息,356,209,147,富邦-宜蘭,2023-12-19,9686
1815,富喬,78,1,77,富邦-宜蘭,2023-12-19,9686
2610,華航,78,10,68,富邦-宜蘭,2023-12-19,9686
00688L,國泰20年美債正2,68,0,68,富邦-宜蘭,2023-12-19,9686
2356,英業達,165,98,67,富邦-宜蘭,2023-12-19,9686
00679B,元大美債20年,91,25,66,富邦-宜蘭,2023-12-19,9686
2884,玉山金,65,10,55,富邦-宜蘭,2023-12-19,9686
2883,凱基金,59,5,54,富邦-宜蘭,2023-12-19,9686
2882,國泰金,40,0,40,富邦-宜蘭,2023-12-19,9686
5351,鈺創,51,12,39,富邦-宜蘭,2023-12-19,9686
3231,緯創,51,12,39,富邦-宜蘭,2023-12-19,9686
00918,大華優利高填息30,42,5,37,富邦-宜蘭,2023-12-19,9686
00885,富邦越南,41,5,36,富邦-宜蘭,2023-12-19,9686
8436,大江,36,0,36,富邦-宜蘭,2023-12-19,9686
2618,長榮航,81,47,34,富邦-宜蘭,2023-12-19,9686
00751B,元大AAA至A公司債,31,0,31,富邦-宜蘭,2023-12-19,9686
1536,和大,30,0,30,富邦-宜蘭,2023-12-19,9686
2344,華邦電,54,24,30,富邦-宜蘭,2023-12-19,9686
5210,寶碩,29,5,24,富邦-宜蘭,2023-12-19,9686
00680L,元大美債20正2,24,0,24,富邦-宜蘭,2023-12-19,9686
2014,中鴻,89,65,24,富邦-宜蘭,2023-12-19,9686
1452,宏益,82,60,22,富邦-宜蘭,2023-12-19,9686
00753L,中信中國50正2,25,3,22,富邦-宜蘭,2023-12-19,9686
00923,群益台ESG低碳50,22,1,21,富邦-宜蘭,2023-12-19,9686
1529,樂事綠能,20,0,20,富邦-宜蘭,2023-12-19,9686
4746,台耀,20,0,20,富邦-宜蘭,2023-12-19,9686
1524,耿鼎,29,10,19,富邦-宜蘭,2023-12-19,9686
2611,志信,18,0,18,富邦-宜蘭,2023-12-19,9686
00637L,元大滬深300正2,18,0,18,富邦-宜蘭,2023-12-19,9686
6143,振曜,18,0,18,富邦-宜蘭,2023-12-19,9686
4908,前鼎,25,7,18,富邦-宜蘭,2023-12-19,9686
00936,台新永續高息中小,30,12,18,富邦-宜蘭,2023-12-19,9686
2412,中華電,19,1,18,富邦-宜蘭,2023-12-19,9686
00878,國泰永續高股息,28,11,17,富邦-宜蘭,2023-12-19,9686
2115,六暉-KY,16,0,16,富邦-宜蘭,2023-12-19,9686
2027,大成鋼,19,3,16,富邦-宜蘭,2023-12-19,9686
6261,久元,16,0,16,富邦-宜蘭,2023-12-19,9686
00933B,國泰10Y+金融債,27,12,15,富邦-宜蘭,2023-12-19,9686
3390,旭軟,15,0,15,富邦-宜蘭,2023-12-19,9686
2324,仁寶,23,8,15,富邦-宜蘭,2023-12-19,9686
1584,精剛,23,9,14,富邦-宜蘭,2023-12-19,9686
6147,頎邦,14,0,14,富邦-宜蘭,2023-12-19,9686
6191,精成科,20,6,14,富邦-宜蘭,2023-12-19,9686
4114,健喬,14,1,13,富邦-宜蘭,2023-12-19,9686
2881,富邦金,16,3,13,富邦-宜蘭,2023-12-19,9686
00930,永豐ESG低碳高息,12,0,12,富邦-宜蘭,2023-12-19,9686
2543,皇昌,14,2,12,富邦-宜蘭,2023-12-19,9686
3033,威健,12,0,12,富邦-宜蘭,2023-12-19,9686
2313,華通,18,7,11,富邦-宜蘭,2023-12-19,9686
00680L,元大美債20正2,150,4,146,富邦-宜蘭,2023-12-20,9686
00937B,群益ESG投等債20,121,0,121,富邦-宜蘭,2023-12-20,9686
6207,雷科,78,0,78,富邦-宜蘭,2023-12-20,9686
6244,茂迪,75,2,73,富邦-宜蘭,2023-12-20,9686
2355,敬鵬,71,4,67,富邦-宜蘭,2023-12-20,9686
2406,國碩,72,10,62,富邦-宜蘭,2023-12-20,9686
2641,正德,68,12,56,富邦-宜蘭,2023-12-20,9686
6248,沛波,66,11,55,富邦-宜蘭,2023-12-20,9686
8201,無敵,60,5,55,富邦-宜蘭,2023-12-20,9686
2892,第一金,53,0,53,富邦-宜蘭,2023-12-20,9686
2882,國泰金,51,0,51,富邦-宜蘭,2023-12-20,9686
8089,康全電訊,60,11,49,富邦-宜蘭,2023-12-20,9686
00929,復華台灣科技優息,59,11,48,富邦-宜蘭,2023-12-20,9686
00637L,元大滬深300正2,60,15,45,富邦-宜蘭,2023-12-20,9686
4934,太極,32,1,31,富邦-宜蘭,2023-12-20,9686
2881,富邦金,31,0,31,富邦-宜蘭,2023-12-20,9686
6116,彩晶,40,10,30,富邦-宜蘭,2023-12-20,9686
00919,群益台灣精選高息,182,155,27,富邦-宜蘭,2023-12-20,9686
00885,富邦越南,29,4,25,富邦-宜蘭,2023-12-20,9686
2949,欣新網,24,0,24,富邦-宜蘭,2023-12-20,9686
2405,輔信,23,0,23,富邦-宜蘭,2023-12-20,9686
2009,第一銅,41,19,22,富邦-宜蘭,2023-12-20,9686
5410,國眾,22,0,22,富邦-宜蘭,2023-12-20,9686
00933B,國泰10Y+金融債,22,0,22,富邦-宜蘭,2023-12-20,9686
6139,亞翔,26,4,22,富邦-宜蘭,2023-12-20,9686
6156,松上,23,1,22,富邦-宜蘭,2023-12-20,9686
2891,中信金,35,15,20,富邦-宜蘭,2023-12-20,9686
3128,昇銳,20,0,20,富邦-宜蘭,2023-12-20,9686
6263,普萊德,21,1,20,富邦-宜蘭,2023-12-20,9686
2387,精元,25,7,18,富邦-宜蘭,2023-12-20,9686
00934,中信成長高股息,17,0,17,富邦-宜蘭,2023-12-20,9686
00918,大華優利高填息30,16,0,16,富邦-宜蘭,2023-12-20,9686
00720B,元大投資級公司債,16,0,16,富邦-宜蘭,2023-12-20,9686
1324,地球,15,0,15,富邦-宜蘭,2023-12-20,9686
2610,華航,19,5,14,富邦-宜蘭,2023-12-20,9686
2314,台揚,16,2,14,富邦-宜蘭,2023-12-20,9686
2007,燁興,17,3,14,富邦-宜蘭,2023-12-20,9686
1815,富喬,20,6,14,富邦-宜蘭,2023-12-20,9686
3715,定穎投控,34,21,13,富邦-宜蘭,2023-12-20,9686
8011,台通,23,10,13,富邦-宜蘭,2023-12-20,9686
2313,華通,56,43,13,富邦-宜蘭,2023-12-20,9686
1609,大亞,12,0,12,富邦-宜蘭,2023-12-20,9686
5403,中菲,12,0,12,富邦-宜蘭,2023-12-20,9686
00679B,元大美債20年,13,1,12,富邦-宜蘭,2023-12-20,9686
2886,兆豐金,13,2,11,富邦-宜蘭,2023-12-20,9686
3178,公準,12,1,11,富邦-宜蘭,2023-12-20,9686
00646,元大S＆P500,11,0,11,富邦-宜蘭,2023-12-20,9686
1522,堤維西,14,3,11,富邦-宜蘭,2023-12-20,9686
3211,順達,11,0,11,富邦-宜蘭,2023-12-20,9686
00757,統一FANG+,11,0,11,富邦-宜蘭,2023-12-20,9686
9105,泰金寶-DR,235,85,150,富邦-宜蘭,2023-12-21,9686
2506,太設,147,0,147,富邦-宜蘭,2023-12-21,9686
00929,復華台灣科技優息,120,27,93,富邦-宜蘭,2023-12-21,9686
00937B,群益ESG投等債20,88,11,77,富邦-宜蘭,2023-12-21,9686
00919,群益台灣精選高息,148,81,67,富邦-宜蘭,2023-12-21,9686
2353,宏��,104,38,66,富邦-宜蘭,2023-12-21,9686
00877,復華中國5G,50,0,50,富邦-宜蘭,2023-12-21,9686
2601,益航,45,6,39,富邦-宜蘭,2023-12-21,9686
1504,東元,38,1,37,富邦-宜蘭,2023-12-21,9686
2344,華邦電,48,11,37,富邦-宜蘭,2023-12-21,9686
1732,毛寶,91,56,35,富邦-宜蘭,2023-12-21,9686
2014,中鴻,45,10,35,富邦-宜蘭,2023-12-21,9686
00933B,國泰10Y+金融債,34,0,34,富邦-宜蘭,2023-12-21,9686
1452,宏益,134,100,34,富邦-宜蘭,2023-12-21,9686
00687B,國泰20年美債,48,15,33,富邦-宜蘭,2023-12-21,9686
2303,聯電,33,3,30,富邦-宜蘭,2023-12-21,9686
6233,旺玖,37,10,27,富邦-宜蘭,2023-12-21,9686
2881,富邦金,27,2,25,富邦-宜蘭,2023-12-21,9686
2363,矽統,25,2,23,富邦-宜蘭,2023-12-21,9686
3047,訊舟,23,1,22,富邦-宜蘭,2023-12-21,9686
6657,華安,21,0,21,富邦-宜蘭,2023-12-21,9686
1536,和大,21,0,21,富邦-宜蘭,2023-12-21,9686
1466,聚隆,20,0,20,富邦-宜蘭,2023-12-21,9686
2002,中鋼,24,5,19,富邦-宜蘭,2023-12-21,9686
2033,佳大,17,0,17,富邦-宜蘭,2023-12-21,9686
9919,康那香,94,78,16,富邦-宜蘭,2023-12-21,9686
6116,彩晶,16,0,16,富邦-宜蘭,2023-12-21,9686
2634,漢翔,19,4,15,富邦-宜蘭,2023-12-21,9686
2330,台積電,16,1,15,富邦-宜蘭,2023-12-21,9686
2331,精英,17,3,14,富邦-宜蘭,2023-12-21,9686
4142,國光生,14,0,14,富邦-宜蘭,2023-12-21,9686
2882,國泰金,13,0,13,富邦-宜蘭,2023-12-21,9686
1102,亞泥,13,0,13,富邦-宜蘭,2023-12-21,9686
8110,華東,15,2,13,富邦-宜蘭,2023-12-21,9686
2612,中航,13,0,13,富邦-宜蘭,2023-12-21,9686
00679B,元大美債20年,29,17,12,富邦-宜蘭,2023-12-21,9686
4915,致伸,12,0,12,富邦-宜蘭,2023-12-21,9686
3035,智原,56,44,12,富邦-宜蘭,2023-12-21,9686
2412,中華電,11,0,11,富邦-宜蘭,2023-12-21,9686
3128,昇銳,11,0,11,富邦-宜蘭,2023-12-21,9686
4114,健喬,12,1,11,富邦-宜蘭,2023-12-21,9686
3005,神基,13,2,11,富邦-宜蘭,2023-12-21,9686
00900,富邦特選高股息30,11,0,11,富邦-宜蘭,2023-12-21,9686
3357,臺慶科,11,0,11,富邦-宜蘭,2023-12-21,9686
1104,環泥,10,0,10,富邦-宜蘭,2023-12-21,9686
1731,美吾華,10,0,10,富邦-宜蘭,2023-12-21,9686
3010,華立,10,0,10,富邦-宜蘭,2023-12-21,9686
6122,擎邦,15,5,10,富邦-宜蘭,2023-12-21,9686
6113,亞矽,10,0,10,富邦-宜蘭,2023-12-21,9686
00637L,元大滬深300正2,20,10,10,富邦-宜蘭,2023-12-21,9686
020038,元大ESG配息N,1796,0,1796,富邦-宜蘭,2023-12-22,9686
00937B,群益ESG投等債20,285,3,282,富邦-宜蘭,2023-12-22,9686
2105,正新,185,0,185,富邦-宜蘭,2023-12-22,9686
2543,皇昌,108,0,108,富邦-宜蘭,2023-12-22,9686
2344,華邦電,193,102,91,富邦-宜蘭,2023-12-22,9686
2324,仁寶,136,50,86,富邦-宜蘭,2023-12-22,9686
2609,陽明,617,539,78,富邦-宜蘭,2023-12-22,9686
2641,正德,63,7,56,富邦-宜蘭,2023-12-22,9686
2515,中工,58,5,53,富邦-宜蘭,2023-12-22,9686
00687B,國泰20年美債,53,1,52,富邦-宜蘭,2023-12-22,9686
2356,英業達,155,103,52,富邦-宜蘭,2023-12-22,9686
00688L,國泰20年美債正2,46,0,46,富邦-宜蘭,2023-12-22,9686
00680L,元大美債20正2,45,0,45,富邦-宜蘭,2023-12-22,9686
2332,友訊,40,0,40,富邦-宜蘭,2023-12-22,9686
00650L,復華香港正2,60,20,40,富邦-宜蘭,2023-12-22,9686
5521,工信,80,41,39,富邦-宜蘭,2023-12-22,9686
00753L,中信中國50正2,38,0,38,富邦-宜蘭,2023-12-22,9686
5009,榮剛,38,3,35,富邦-宜蘭,2023-12-22,9686
1314,中石化,35,0,35,富邦-宜蘭,2023-12-22,9686
00679B,元大美債20年,53,18,35,富邦-宜蘭,2023-12-22,9686
00720B,元大投資級公司債,38,5,33,富邦-宜蘭,2023-12-22,9686
00919,群益台灣精選高息,41,9,32,富邦-宜蘭,2023-12-22,9686
6153,嘉聯益,30,0,30,富邦-宜蘭,2023-12-22,9686
1452,宏益,100,71,29,富邦-宜蘭,2023-12-22,9686
00929,復華台灣科技優息,34,9,25,富邦-宜蘭,2023-12-22,9686
00673R,期元大S＆P原油反1,25,0,25,富邦-宜蘭,2023-12-22,9686
4157,太景*-KY,25,0,25,富邦-宜蘭,2023-12-22,9686
1303,南亞,24,0,24,富邦-宜蘭,2023-12-22,9686
2506,太設,100,77,23,富邦-宜蘭,2023-12-22,9686
2363,矽統,43,21,22,富邦-宜蘭,2023-12-22,9686
6461,益得,34,13,21,富邦-宜蘭,2023-12-22,9686
6026,福邦證,20,0,20,富邦-宜蘭,2023-12-22,9686
5701,劍湖山,20,0,20,富邦-宜蘭,2023-12-22,9686
3086,華義,26,6,20,富邦-宜蘭,2023-12-22,9686
2014,中鴻,30,12,18,富邦-宜蘭,2023-12-22,9686
3362,先進光,18,2,16,富邦-宜蘭,2023-12-22,9686
2601,益航,22,6,16,富邦-宜蘭,2023-12-22,9686
3051,力特,20,4,16,富邦-宜蘭,2023-12-22,9686
2637,慧洋-KY,23,7,16,富邦-宜蘭,2023-12-22,9686
2636,台驊控股,16,1,15,富邦-宜蘭,2023-12-22,9686
00918,大華優利高填息30,16,2,14,富邦-宜蘭,2023-12-22,9686
2486,一詮,13,0,13,富邦-宜蘭,2023-12-22,9686
2891,中信金,14,1,13,富邦-宜蘭,2023-12-22,9686
2359,所羅門,12,0,12,富邦-宜蘭,2023-12-22,9686
4168,醣聯,13,1,12,富邦-宜蘭,2023-12-22,9686
2388,威盛,27,16,11,富邦-宜蘭,2023-12-22,9686
00632R,元大台灣50反1,11,0,11,富邦-宜蘭,2023-12-22,9686
3014,聯陽,11,0,11,富邦-宜蘭,2023-12-22,9686
2812,台中銀,11,0,11,富邦-宜蘭,2023-12-22,9686
6937,天虹,10,0,10,富邦-宜蘭,2023-12-22,9686
00937B,群益ESG投等債20,149,3,146,富邦-宜蘭,2023-12-25,9686
00919,群益台灣精選高息,143,8,135,富邦-宜蘭,2023-12-25,9686
2609,陽明,478,360,118,富邦-宜蘭,2023-12-25,9686
2362,藍天,113,3,110,富邦-宜蘭,2023-12-25,9686
2506,太設,80,0,80,富邦-宜蘭,2023-12-25,9686
2641,正德,87,9,78,富邦-宜蘭,2023-12-25,9686
2606,裕民,68,7,61,富邦-宜蘭,2023-12-25,9686
2014,中鴻,108,56,52,富邦-宜蘭,2023-12-25,9686
2323,中環,54,4,50,富邦-宜蘭,2023-12-25,9686
1733,五鼎,67,18,49,富邦-宜蘭,2023-12-25,9686
1514,亞力,47,4,43,富邦-宜蘭,2023-12-25,9686
8477,創業家,40,0,40,富邦-宜蘭,2023-12-25,9686
2543,皇昌,41,1,40,富邦-宜蘭,2023-12-25,9686
8034,榮群,41,7,34,富邦-宜蘭,2023-12-25,9686
4109,加捷生醫,30,0,30,富邦-宜蘭,2023-12-25,9686
1618,合機,27,2,25,富邦-宜蘭,2023-12-25,9686
2605,新興,30,7,23,富邦-宜蘭,2023-12-25,9686
2610,華航,116,94,22,富邦-宜蘭,2023-12-25,9686
6139,亞翔,56,35,21,富邦-宜蘭,2023-12-25,9686
3558,神準,18,0,18,富邦-宜蘭,2023-12-25,9686
3051,力特,18,1,17,富邦-宜蘭,2023-12-25,9686
2882,國泰金,18,2,16,富邦-宜蘭,2023-12-25,9686
6231,系微,20,4,16,富邦-宜蘭,2023-12-25,9686
3363,上詮,16,0,16,富邦-宜蘭,2023-12-25,9686
8068,全達,16,0,16,富邦-宜蘭,2023-12-25,9686
00929,復華台灣科技優息,32,18,14,富邦-宜蘭,2023-12-25,9686
00900,富邦特選高股息30,17,3,14,富邦-宜蘭,2023-12-25,9686
00909,國泰數位支付服務,14,0,14,富邦-宜蘭,2023-12-25,9686
2601,益航,13,0,13,富邦-宜蘭,2023-12-25,9686
1815,富喬,13,0,13,富邦-宜蘭,2023-12-25,9686
2421,建準,113,101,12,富邦-宜蘭,2023-12-25,9686
3264,欣銓,17,5,12,富邦-宜蘭,2023-12-25,9686
3532,台勝科,14,2,12,富邦-宜蘭,2023-12-25,9686
3374,精材,12,0,12,富邦-宜蘭,2023-12-25,9686
00712,復華富時不動產,11,0,11,富邦-宜蘭,2023-12-25,9686
6770,力積電,11,0,11,富邦-宜蘭,2023-12-25,9686
2023,燁輝,13,2,11,富邦-宜蘭,2023-12-25,9686
1906,寶隆,10,0,10,富邦-宜蘭,2023-12-25,9686
1319,東陽,10,0,10,富邦-宜蘭,2023-12-25,9686
3715,定穎投控,18,8,10,富邦-宜蘭,2023-12-25,9686
3706,神達,12,2,10,富邦-宜蘭,2023-12-25,9686
4931,新盛力,10,0,10,富邦-宜蘭,2023-12-25,9686
00680L,元大美債20正2,10,0,10,富邦-宜蘭,2023-12-25,9686
2031,新光鋼,28,18,10,富邦-宜蘭,2023-12-25,9686
00752,中信中國50,10,0,10,富邦-宜蘭,2023-12-25,9686
4402,郡都開發,10,0,10,富邦-宜蘭,2023-12-25,9686
6488,環球晶,11,2,9,富邦-宜蘭,2023-12-25,9686
00918,大華優利高填息30,9,0,9,富邦-宜蘭,2023-12-25,9686
6443,元晶,9,0,9,富邦-宜蘭,2023-12-25,9686
00907,永豐優息存股,9,0,9,富邦-宜蘭,2023-12-25,9686
00632R,元大台灣50反1,310,0,310,富邦-宜蘭,2023-12-26,9686
00680L,元大美債20正2,240,27,213,富邦-宜蘭,2023-12-26,9686
00637L,元大滬深300正2,137,0,137,富邦-宜蘭,2023-12-26,9686
00720B,元大投資級公司債,107,0,107,富邦-宜蘭,2023-12-26,9686
00937B,群益ESG投等債20,100,9,91,富邦-宜蘭,2023-12-26,9686
2615,萬海,93,27,66,富邦-宜蘭,2023-12-26,9686
00919,群益台灣精選高息,83,24,59,富邦-宜蘭,2023-12-26,9686
00931B,統一美債20年,58,2,56,富邦-宜蘭,2023-12-26,9686
1312,國喬,52,1,51,富邦-宜蘭,2023-12-26,9686
1304,台聚,50,0,50,富邦-宜蘭,2023-12-26,9686
00676R,富邦臺灣加權反1,50,0,50,富邦-宜蘭,2023-12-26,9686
1733,五鼎,51,4,47,富邦-宜蘭,2023-12-26,9686
2885,元大金,60,16,44,富邦-宜蘭,2023-12-26,9686
1504,東元,51,12,39,富邦-宜蘭,2023-12-26,9686
00936,台新永續高息中小,36,0,36,富邦-宜蘭,2023-12-26,9686
1452,宏益,124,89,35,富邦-宜蘭,2023-12-26,9686
00753L,中信中國50正2,40,5,35,富邦-宜蘭,2023-12-26,9686
5426,振發,32,0,32,富邦-宜蘭,2023-12-26,9686
6233,旺玖,36,5,31,富邦-宜蘭,2023-12-26,9686
2208,台船,30,0,30,富邦-宜蘭,2023-12-26,9686
8066,來思達,30,0,30,富邦-宜蘭,2023-12-26,9686
2369,菱生,30,0,30,富邦-宜蘭,2023-12-26,9686
00712,復華富時不動產,40,16,24,富邦-宜蘭,2023-12-26,9686
2610,華航,40,16,24,富邦-宜蘭,2023-12-26,9686
5009,榮剛,24,2,22,富邦-宜蘭,2023-12-26,9686
2543,皇昌,20,0,20,富邦-宜蘭,2023-12-26,9686
3322,建舜電,20,0,20,富邦-宜蘭,2023-12-26,9686
8930,青鋼,20,0,20,富邦-宜蘭,2023-12-26,9686
1584,精剛,22,4,18,富邦-宜蘭,2023-12-26,9686
2618,長榮航,34,16,18,富邦-宜蘭,2023-12-26,9686
1409,新纖,17,0,17,富邦-宜蘭,2023-12-26,9686
3122,笙泉,28,11,17,富邦-宜蘭,2023-12-26,9686
6120,達運,20,4,16,富邦-宜蘭,2023-12-26,9686
2331,精英,23,7,16,富邦-宜蘭,2023-12-26,9686
8215,明基材,15,0,15,富邦-宜蘭,2023-12-26,9686
5608,四維航,15,0,15,富邦-宜蘭,2023-12-26,9686
2603,長榮,29,14,15,富邦-宜蘭,2023-12-26,9686
1806,冠軍,36,22,14,富邦-宜蘭,2023-12-26,9686
1536,和大,14,0,14,富邦-宜蘭,2023-12-26,9686
1314,中石化,21,7,14,富邦-宜蘭,2023-12-26,9686
3545,敦泰,14,1,13,富邦-宜蘭,2023-12-26,9686
00888,永豐台灣ESG,13,0,13,富邦-宜蘭,2023-12-26,9686
2357,華碩,13,0,13,富邦-宜蘭,2023-12-26,9686
2303,聯電,60,48,12,富邦-宜蘭,2023-12-26,9686
3094,聯傑,21,9,12,富邦-宜蘭,2023-12-26,9686
00633L,富邦上証正2,12,0,12,富邦-宜蘭,2023-12-26,9686
6231,系微,22,10,12,富邦-宜蘭,2023-12-26,9686
8088,品安,15,4,11,富邦-宜蘭,2023-12-26,9686
3086,華義,12,1,11,富邦-宜蘭,2023-12-26,9686
6488,環球晶,10,0,10,富邦-宜蘭,2023-12-26,9686
00937B,群益ESG投等債20,287,10,277,富邦-宜蘭,2023-12-27,9686
00632R,元大台灣50反1,212,6,206,富邦-宜蘭,2023-12-27,9686
6770,力積電,98,17,81,富邦-宜蘭,2023-12-27,9686
1316,上曜,76,0,76,富邦-宜蘭,2023-12-27,9686
2618,長榮航,83,18,65,富邦-宜蘭,2023-12-27,9686
4933,友輝,62,0,62,富邦-宜蘭,2023-12-27,9686
2353,宏��,102,56,46,富邦-宜蘭,2023-12-27,9686
2337,旺宏,86,43,43,富邦-宜蘭,2023-12-27,9686
2637,慧洋-KY,50,7,43,富邦-宜蘭,2023-12-27,9686
1452,宏益,135,95,40,富邦-宜蘭,2023-12-27,9686
8155,博智,40,0,40,富邦-宜蘭,2023-12-27,9686
2892,第一金,39,0,39,富邦-宜蘭,2023-12-27,9686
3380,明泰,39,4,35,富邦-宜蘭,2023-12-27,9686
1815,富喬,32,0,32,富邦-宜蘭,2023-12-27,9686
6668,中揚光,32,0,32,富邦-宜蘭,2023-12-27,9686
2515,中工,34,3,31,富邦-宜蘭,2023-12-27,9686
3545,敦泰,34,3,31,富邦-宜蘭,2023-12-27,9686
8059,凱碩,44,13,31,富邦-宜蘭,2023-12-27,9686
00900,富邦特選高股息30,40,10,30,富邦-宜蘭,2023-12-27,9686
6129,普誠,41,16,25,富邦-宜蘭,2023-12-27,9686
3047,訊舟,26,2,24,富邦-宜蘭,2023-12-27,9686
1733,五鼎,95,73,22,富邦-宜蘭,2023-12-27,9686
00676R,富邦臺灣加權反1,20,0,20,富邦-宜蘭,2023-12-27,9686
00935,野村臺灣新科技50,20,1,19,富邦-宜蘭,2023-12-27,9686
00931B,統一美債20年,22,4,18,富邦-宜蘭,2023-12-27,9686
1434,福懋,17,0,17,富邦-宜蘭,2023-12-27,9686
8936,國統,28,11,17,富邦-宜蘭,2023-12-27,9686
3481,群創,73,56,17,富邦-宜蘭,2023-12-27,9686
00929,復華台灣科技優息,35,21,14,富邦-宜蘭,2023-12-27,9686
3576,聯合再生,20,7,13,富邦-宜蘭,2023-12-27,9686
00933B,國泰10Y+金融債,15,3,12,富邦-宜蘭,2023-12-27,9686
5521,工信,15,4,11,富邦-宜蘭,2023-12-27,9686
8477,創業家,12,1,11,富邦-宜蘭,2023-12-27,9686
00907,永豐優息存股,12,1,11,富邦-宜蘭,2023-12-27,9686
8105,凌巨,13,2,11,富邦-宜蘭,2023-12-27,9686
2329,華泰,14,3,11,富邦-宜蘭,2023-12-27,9686
1584,精剛,19,8,11,富邦-宜蘭,2023-12-27,9686
6805,富世達,11,0,11,富邦-宜蘭,2023-12-27,9686
5213,亞昕,10,0,10,富邦-宜蘭,2023-12-27,9686
2867,三商壽,10,0,10,富邦-宜蘭,2023-12-27,9686
1536,和大,10,0,10,富邦-宜蘭,2023-12-27,9686
2614,東森,14,4,10,富邦-宜蘭,2023-12-27,9686
3042,晶技,10,0,10,富邦-宜蘭,2023-12-27,9686
00664R,國泰臺灣加權反1,10,0,10,富邦-宜蘭,2023-12-27,9686
2324,仁寶,144,134,10,富邦-宜蘭,2023-12-27,9686
1609,大亞,13,3,10,富邦-宜蘭,2023-12-27,9686
1522,堤維西,9,0,9,富邦-宜蘭,2023-12-27,9686
8112,至上,12,3,9,富邦-宜蘭,2023-12-27,9686
00673R,期元大S＆P原油反1,9,0,9,富邦-宜蘭,2023-12-27,9686
5425,台半,15,6,9,富邦-宜蘭,2023-12-27,9686
00919,群益台灣精選高息,249,12,237,富邦-宜蘭,2023-12-28,9686
00933B,國泰10Y+金融債,211,20,191,富邦-宜蘭,2023-12-28,9686
00888,永豐台灣ESG,155,0,155,富邦-宜蘭,2023-12-28,9686
00937B,群益ESG投等債20,151,11,140,富邦-宜蘭,2023-12-28,9686
00878,國泰永續高股息,108,18,90,富邦-宜蘭,2023-12-28,9686
8096,擎亞,235,147,88,富邦-宜蘭,2023-12-28,9686
6166,凌華,74,2,72,富邦-宜蘭,2023-12-28,9686
3706,神達,195,134,61,富邦-宜蘭,2023-12-28,9686
2609,陽明,85,31,54,富邦-宜蘭,2023-12-28,9686
00712,復華富時不動產,45,0,45,富邦-宜蘭,2023-12-28,9686
2382,廣達,62,18,44,富邦-宜蘭,2023-12-28,9686
00929,復華台灣科技優息,60,18,42,富邦-宜蘭,2023-12-28,9686
00751B,元大AAA至A公司債,42,0,42,富邦-宜蘭,2023-12-28,9686
8034,榮群,41,0,41,富邦-宜蘭,2023-12-28,9686
00632R,元大台灣50反1,50,10,40,富邦-宜蘭,2023-12-28,9686
2353,宏��,455,419,36,富邦-宜蘭,2023-12-28,9686
9105,泰金寶-DR,35,0,35,富邦-宜蘭,2023-12-28,9686
3380,明泰,34,0,34,富邦-宜蘭,2023-12-28,9686
0056,元大高股息,68,35,33,富邦-宜蘭,2023-12-28,9686
1618,合機,75,43,32,富邦-宜蘭,2023-12-28,9686
2436,偉詮電,56,25,31,富邦-宜蘭,2023-12-28,9686
3622,洋華,30,0,30,富邦-宜蘭,2023-12-28,9686
2615,萬海,36,7,29,富邦-宜蘭,2023-12-28,9686
1524,耿鼎,32,3,29,富邦-宜蘭,2023-12-28,9686
2356,英業達,143,114,29,富邦-宜蘭,2023-12-28,9686
2603,長榮,36,9,27,富邦-宜蘭,2023-12-28,9686
2365,昆盈,64,37,27,富邦-宜蘭,2023-12-28,9686
2618,長榮航,27,1,26,富邦-宜蘭,2023-12-28,9686
2313,華通,31,6,25,富邦-宜蘭,2023-12-28,9686
8277,商丞,25,1,24,富邦-宜蘭,2023-12-28,9686
1514,亞力,92,68,24,富邦-宜蘭,2023-12-28,9686
6179,亞通,105,86,19,富邦-宜蘭,2023-12-28,9686
2610,華航,28,10,18,富邦-宜蘭,2023-12-28,9686
2405,輔信,43,25,18,富邦-宜蘭,2023-12-28,9686
2607,榮運,17,0,17,富邦-宜蘭,2023-12-28,9686
3231,緯創,122,106,16,富邦-宜蘭,2023-12-28,9686
5426,振發,16,0,16,富邦-宜蘭,2023-12-28,9686
00900,富邦特選高股息30,15,0,15,富邦-宜蘭,2023-12-28,9686
1434,福懋,15,0,15,富邦-宜蘭,2023-12-28,9686
1504,東元,29,14,15,富邦-宜蘭,2023-12-28,9686
910861,神州-DR,15,0,15,富邦-宜蘭,2023-12-28,9686
1513,中興電,28,13,15,富邦-宜蘭,2023-12-28,9686
2889,國票金,15,0,15,富邦-宜蘭,2023-12-28,9686
3694,海華,19,5,14,富邦-宜蘭,2023-12-28,9686
3006,晶豪科,88,75,13,富邦-宜蘭,2023-12-28,9686
00918,大華優利高填息30,17,4,13,富邦-宜蘭,2023-12-28,9686
6188,廣明,53,40,13,富邦-宜蘭,2023-12-28,9686
2357,華碩,13,1,12,富邦-宜蘭,2023-12-28,9686
1452,宏益,116,104,12,富邦-宜蘭,2023-12-28,9686
1527,鑽全,12,0,12,富邦-宜蘭,2023-12-28,9686
00937B,群益ESG投等債20,222,24,198,富邦-宜蘭,2023-12-29,9686
2312,金寶,201,5,196,富邦-宜蘭,2023-12-29,9686
00919,群益台灣精選高息,138,67,71,富邦-宜蘭,2023-12-29,9686
2702,華園,66,0,66,富邦-宜蘭,2023-12-29,9686
2609,陽明,140,81,59,富邦-宜蘭,2023-12-29,9686
5701,劍湖山,54,2,52,富邦-宜蘭,2023-12-29,9686
1514,亞力,58,17,41,富邦-宜蘭,2023-12-29,9686
2892,第一金,40,0,40,富邦-宜蘭,2023-12-29,9686
2722,夏都,80,41,39,富邦-宜蘭,2023-12-29,9686
00931B,統一美債20年,54,16,38,富邦-宜蘭,2023-12-29,9686
00715L,期街口布蘭特正2,35,0,35,富邦-宜蘭,2023-12-29,9686
2515,中工,36,3,33,富邦-宜蘭,2023-12-29,9686
2393,億光,39,7,32,富邦-宜蘭,2023-12-29,9686
00688L,國泰20年美債正2,32,0,32,富邦-宜蘭,2023-12-29,9686
00632R,元大台灣50反1,30,0,30,富邦-宜蘭,2023-12-29,9686
1101,台泥,35,5,30,富邦-宜蘭,2023-12-29,9686
2355,敬鵬,32,2,30,富邦-宜蘭,2023-12-29,9686
00935,野村臺灣新科技50,25,0,25,富邦-宜蘭,2023-12-29,9686
8927,北基,25,0,25,富邦-宜蘭,2023-12-29,9686
6166,凌華,27,3,24,富邦-宜蘭,2023-12-29,9686
8096,擎亞,106,82,24,富邦-宜蘭,2023-12-29,9686
00751B,元大AAA至A公司債,31,8,23,富邦-宜蘭,2023-12-29,9686
00929,復華台灣科技優息,38,17,21,富邦-宜蘭,2023-12-29,9686
2485,兆赫,20,0,20,富邦-宜蘭,2023-12-29,9686
6129,普誠,23,5,18,富邦-宜蘭,2023-12-29,9686
2352,佳世達,122,104,18,富邦-宜蘭,2023-12-29,9686
2421,建準,31,14,17,富邦-宜蘭,2023-12-29,9686
6187,萬潤,18,1,17,富邦-宜蘭,2023-12-29,9686
5469,瀚宇博,18,2,16,富邦-宜蘭,2023-12-29,9686
2324,仁寶,59,43,16,富邦-宜蘭,2023-12-29,9686
1519,華城,40,25,15,富邦-宜蘭,2023-12-29,9686
1503,士電,21,6,15,富邦-宜蘭,2023-12-29,9686
2344,華邦電,52,37,15,富邦-宜蘭,2023-12-29,9686
3376,新日興,17,4,13,富邦-宜蘭,2023-12-29,9686
2889,國票金,14,1,13,富邦-宜蘭,2023-12-29,9686
2641,正德,12,0,12,富邦-宜蘭,2023-12-29,9686
6223,旺矽,12,0,12,富邦-宜蘭,2023-12-29,9686
1609,大亞,13,1,12,富邦-宜蘭,2023-12-29,9686
8936,國統,14,2,12,富邦-宜蘭,2023-12-29,9686
2208,台船,12,1,11,富邦-宜蘭,2023-12-29,9686
2405,輔信,12,1,11,富邦-宜蘭,2023-12-29,9686
00882,中信中國高股息,14,3,11,富邦-宜蘭,2023-12-29,9686
6116,彩晶,12,1,11,富邦-宜蘭,2023-12-29,9686
3260,威剛,30,20,10,富邦-宜蘭,2023-12-29,9686
1336,台翰,10,0,10,富邦-宜蘭,2023-12-29,9686
3042,晶技,10,0,10,富邦-宜蘭,2023-12-29,9686
00902,中信電池及儲能,10,0,10,富邦-宜蘭,2023-12-29,9686
8068,全達,10,0,10,富邦-宜蘭,2023-12-29,9686
8088,品安,11,1,10,富邦-宜蘭,2023-12-29,9686
1584,精剛,11,1,10,富邦-宜蘭,2023-12-29,9686
00937B,群益ESG投等債20,435,40,395,富邦-宜蘭,2024-01-02,9686
00688L,國泰20年美債正2,156,0,156,富邦-宜蘭,2024-01-02,9686
00637L,元大滬深300正2,145,0,145,富邦-宜蘭,2024-01-02,9686
3231,緯創,149,26,123,富邦-宜蘭,2024-01-02,9686
00680L,元大美債20正2,109,0,109,富邦-宜蘭,2024-01-02,9686
2323,中環,105,10,95,富邦-宜蘭,2024-01-02,9686
00919,群益台灣精選高息,130,61,69,富邦-宜蘭,2024-01-02,9686
00715L,期街口布蘭特正2,68,2,66,富邦-宜蘭,2024-01-02,9686
00929,復華台灣科技優息,96,35,61,富邦-宜蘭,2024-01-02,9686
00934,中信成長高股息,54,2,52,富邦-宜蘭,2024-01-02,9686
2618,長榮航,346,295,51,富邦-宜蘭,2024-01-02,9686
2890,永豐金,51,0,51,富邦-宜蘭,2024-01-02,9686
2543,皇昌,52,5,47,富邦-宜蘭,2024-01-02,9686
0056,元大高股息,60,13,47,富邦-宜蘭,2024-01-02,9686
00650L,復華香港正2,47,3,44,富邦-宜蘭,2024-01-02,9686
5515,建國,43,1,42,富邦-宜蘭,2024-01-02,9686
00679B,元大美債20年,36,1,35,富邦-宜蘭,2024-01-02,9686
2887,台新金,55,20,35,富邦-宜蘭,2024-01-02,9686
00878,國泰永續高股息,36,1,35,富邦-宜蘭,2024-01-02,9686
2324,仁寶,47,15,32,富邦-宜蘭,2024-01-02,9686
6139,亞翔,38,13,25,富邦-宜蘭,2024-01-02,9686
3041,揚智,25,0,25,富邦-宜蘭,2024-01-02,9686
1702,南僑,24,0,24,富邦-宜蘭,2024-01-02,9686
2362,藍天,47,23,24,富邦-宜蘭,2024-01-02,9686
00923,群益台ESG低碳50,22,0,22,富邦-宜蘭,2024-01-02,9686
5425,台半,25,3,22,富邦-宜蘭,2024-01-02,9686
2421,建準,26,4,22,富邦-宜蘭,2024-01-02,9686
2352,佳世達,62,41,21,富邦-宜蘭,2024-01-02,9686
2376,技嘉,31,10,21,富邦-宜蘭,2024-01-02,9686
3706,神達,22,1,21,富邦-宜蘭,2024-01-02,9686
2363,矽統,22,1,21,富邦-宜蘭,2024-01-02,9686
00687B,國泰20年美債,21,0,21,富邦-宜蘭,2024-01-02,9686
1455,集盛,20,0,20,富邦-宜蘭,2024-01-02,9686
2356,英業達,275,255,20,富邦-宜蘭,2024-01-02,9686
2382,廣達,34,16,18,富邦-宜蘭,2024-01-02,9686
6770,力積電,19,1,18,富邦-宜蘭,2024-01-02,9686
2399,映泰,18,0,18,富邦-宜蘭,2024-01-02,9686
00930,永豐ESG低碳高息,20,3,17,富邦-宜蘭,2024-01-02,9686
2615,萬海,33,17,16,富邦-宜蘭,2024-01-02,9686
00720B,元大投資級公司債,16,0,16,富邦-宜蘭,2024-01-02,9686
3264,欣銓,17,1,16,富邦-宜蘭,2024-01-02,9686
2636,台驊控股,48,32,16,富邦-宜蘭,2024-01-02,9686
1707,葡萄王,16,0,16,富邦-宜蘭,2024-01-02,9686
6776,展�眥篕�,15,0,15,富邦-宜蘭,2024-01-02,9686
9945,潤泰新,17,2,15,富邦-宜蘭,2024-01-02,9686
2409,友達,21,6,15,富邦-宜蘭,2024-01-02,9686
00885,富邦越南,15,1,14,富邦-宜蘭,2024-01-02,9686
3047,訊舟,14,1,13,富邦-宜蘭,2024-01-02,9686
2038,海光,14,1,13,富邦-宜蘭,2024-01-02,9686
2344,華邦電,24,12,12,富邦-宜蘭,2024-01-02,9686
00937B,群益ESG投等債20,237,8,229,富邦-宜蘭,2024-01-03,9686
00929,復華台灣科技優息,221,15,206,富邦-宜蘭,2024-01-03,9686
3481,群創,122,20,102,富邦-宜蘭,2024-01-03,9686
2605,新興,120,19,101,富邦-宜蘭,2024-01-03,9686
6140,訊達,145,46,99,富邦-宜蘭,2024-01-03,9686
00919,群益台灣精選高息,68,8,60,富邦-宜蘭,2024-01-03,9686
0056,元大高股息,76,22,54,富邦-宜蘭,2024-01-03,9686
5223,安力-KY,60,9,51,富邦-宜蘭,2024-01-03,9686
2356,英業達,97,48,49,富邦-宜蘭,2024-01-03,9686
3390,旭軟,186,140,46,富邦-宜蘭,2024-01-03,9686
2303,聯電,65,19,46,富邦-宜蘭,2024-01-03,9686
6770,力積電,52,8,44,富邦-宜蘭,2024-01-03,9686
2399,映泰,48,5,43,富邦-宜蘭,2024-01-03,9686
2618,長榮航,75,33,42,富邦-宜蘭,2024-01-03,9686
2362,藍天,118,81,37,富邦-宜蘭,2024-01-03,9686
1101,台泥,30,0,30,富邦-宜蘭,2024-01-03,9686
2206,三陽工業,52,22,30,富邦-宜蘭,2024-01-03,9686
9934,成霖,35,6,29,富邦-宜蘭,2024-01-03,9686
5608,四維航,33,4,29,富邦-宜蘭,2024-01-03,9686
00934,中信成長高股息,35,7,28,富邦-宜蘭,2024-01-03,9686
2881,富邦金,29,2,27,富邦-宜蘭,2024-01-03,9686
2885,元大金,30,3,27,富邦-宜蘭,2024-01-03,9686
2611,志信,30,3,27,富邦-宜蘭,2024-01-03,9686
3051,力特,27,1,26,富邦-宜蘭,2024-01-03,9686
3260,威剛,30,6,24,富邦-宜蘭,2024-01-03,9686
6625,必應,31,7,24,富邦-宜蘭,2024-01-03,9686
6113,亞矽,33,9,24,富邦-宜蘭,2024-01-03,9686
6282,康舒,23,0,23,富邦-宜蘭,2024-01-03,9686
2610,華航,39,16,23,富邦-宜蘭,2024-01-03,9686
00650L,復華香港正2,22,0,22,富邦-宜蘭,2024-01-03,9686
00715L,期街口布蘭特正2,21,0,21,富邦-宜蘭,2024-01-03,9686
1303,南亞,21,0,21,富邦-宜蘭,2024-01-03,9686
2637,慧洋-KY,22,2,20,富邦-宜蘭,2024-01-03,9686
2330,台積電,24,4,20,富邦-宜蘭,2024-01-03,9686
2883,凱基金,31,12,19,富邦-宜蘭,2024-01-03,9686
2331,精英,43,25,18,富邦-宜蘭,2024-01-03,9686
5425,台半,19,1,18,富邦-宜蘭,2024-01-03,9686
2409,友達,44,26,18,富邦-宜蘭,2024-01-03,9686
2352,佳世達,37,20,17,富邦-宜蘭,2024-01-03,9686
2324,仁寶,38,21,17,富邦-宜蘭,2024-01-03,9686
00922,國泰台灣領袖50,17,0,17,富邦-宜蘭,2024-01-03,9686
6275,元山,18,1,17,富邦-宜蘭,2024-01-03,9686
2027,大成鋼,20,4,16,富邦-宜蘭,2024-01-03,9686
3711,日月光投控,17,1,16,富邦-宜蘭,2024-01-03,9686
3041,揚智,16,0,16,富邦-宜蘭,2024-01-03,9686
00888,永豐台灣ESG,15,0,15,富邦-宜蘭,2024-01-03,9686
2417,圓剛,15,0,15,富邦-宜蘭,2024-01-03,9686
3045,台灣大,15,0,15,富邦-宜蘭,2024-01-03,9686
2405,輔信,24,9,15,富邦-宜蘭,2024-01-03,9686
00918,大華優利高填息30,16,2,14,富邦-宜蘭,2024-01-03,9686
00937B,群益ESG投等債20,430,1,429,富邦-宜蘭,2024-01-04,9686
00929,復華台灣科技優息,164,22,142,富邦-宜蘭,2024-01-04,9686
00888,永豐台灣ESG,118,0,118,富邦-宜蘭,2024-01-04,9686
00881,國泰台灣5G+,62,1,61,富邦-宜蘭,2024-01-04,9686
6113,亞矽,67,10,57,富邦-宜蘭,2024-01-04,9686
6125,廣運,60,9,51,富邦-宜蘭,2024-01-04,9686
3231,緯創,87,38,49,富邦-宜蘭,2024-01-04,9686
5521,工信,89,41,48,富邦-宜蘭,2024-01-04,9686
00927,群益半導體收益,54,10,44,富邦-宜蘭,2024-01-04,9686
00650L,復華香港正2,41,0,41,富邦-宜蘭,2024-01-04,9686
00665L,富邦�琤肭磪囓�2,40,0,40,富邦-宜蘭,2024-01-04,9686
5608,四維航,41,5,36,富邦-宜蘭,2024-01-04,9686
5450,南良,35,0,35,富邦-宜蘭,2024-01-04,9686
00712,復華富時不動產,55,20,35,富邦-宜蘭,2024-01-04,9686
4167,松瑞藥,31,0,31,富邦-宜蘭,2024-01-04,9686
2486,一詮,99,69,30,富邦-宜蘭,2024-01-04,9686
3052,夆典,30,0,30,富邦-宜蘭,2024-01-04,9686
00637L,元大滬深300正2,28,0,28,富邦-宜蘭,2024-01-04,9686
2887,台新金,25,2,23,富邦-宜蘭,2024-01-04,9686
8046,南電,25,2,23,富邦-宜蘭,2024-01-04,9686
2605,新興,56,34,22,富邦-宜蘭,2024-01-04,9686
2357,華碩,20,0,20,富邦-宜蘭,2024-01-04,9686
2363,矽統,30,10,20,富邦-宜蘭,2024-01-04,9686
5469,瀚宇博,20,0,20,富邦-宜蘭,2024-01-04,9686
2331,精英,38,19,19,富邦-宜蘭,2024-01-04,9686
2344,華邦電,31,12,19,富邦-宜蘭,2024-01-04,9686
00720B,元大投資級公司債,20,2,18,富邦-宜蘭,2024-01-04,9686
2353,宏��,105,88,17,富邦-宜蘭,2024-01-04,9686
2337,旺宏,18,1,17,富邦-宜蘭,2024-01-04,9686
6770,力積電,21,4,17,富邦-宜蘭,2024-01-04,9686
2208,台船,16,0,16,富邦-宜蘭,2024-01-04,9686
2009,第一銅,43,28,15,富邦-宜蘭,2024-01-04,9686
2027,大成鋼,16,1,15,富邦-宜蘭,2024-01-04,9686
1815,富喬,16,1,15,富邦-宜蘭,2024-01-04,9686
6782,視陽,15,0,15,富邦-宜蘭,2024-01-04,9686
00932,兆豐永續高息等權,15,0,15,富邦-宜蘭,2024-01-04,9686
2324,仁寶,48,34,14,富邦-宜蘭,2024-01-04,9686
3354,律勝,16,2,14,富邦-宜蘭,2024-01-04,9686
3051,力特,15,1,14,富邦-宜蘭,2024-01-04,9686
1806,冠軍,14,0,14,富邦-宜蘭,2024-01-04,9686
00687B,國泰20年美債,13,0,13,富邦-宜蘭,2024-01-04,9686
2419,仲琦,15,2,13,富邦-宜蘭,2024-01-04,9686
1584,精剛,13,0,13,富邦-宜蘭,2024-01-04,9686
1609,大亞,17,4,13,富邦-宜蘭,2024-01-04,9686
2308,台達電,12,0,12,富邦-宜蘭,2024-01-04,9686
1326,台化,12,0,12,富邦-宜蘭,2024-01-04,9686
00673R,期元大S＆P原油反1,12,0,12,富邦-宜蘭,2024-01-04,9686
2362,藍天,21,9,12,富邦-宜蘭,2024-01-04,9686
6550,北極星藥業-KY,12,0,12,富邦-宜蘭,2024-01-04,9686
1503,士電,15,4,11,富邦-宜蘭,2024-01-04,9686
00918,大華優利高填息30,460,2,458,富邦-宜蘭,2024-01-05,9686
00937B,群益ESG投等債20,292,23,269,富邦-宜蘭,2024-01-05,9686
6120,達運,116,5,111,富邦-宜蘭,2024-01-05,9686
2312,金寶,100,2,98,富邦-宜蘭,2024-01-05,9686
00919,群益台灣精選高息,101,5,96,富邦-宜蘭,2024-01-05,9686
00933B,國泰10Y+金融債,79,16,63,富邦-宜蘭,2024-01-05,9686
2353,宏��,90,37,53,富邦-宜蘭,2024-01-05,9686
2606,裕民,64,20,44,富邦-宜蘭,2024-01-05,9686
2543,皇昌,47,8,39,富邦-宜蘭,2024-01-05,9686
00687B,國泰20年美債,33,0,33,富邦-宜蘭,2024-01-05,9686
1452,宏益,103,72,31,富邦-宜蘭,2024-01-05,9686
3188,鑫龍騰,30,0,30,富邦-宜蘭,2024-01-05,9686
00934,中信成長高股息,30,0,30,富邦-宜蘭,2024-01-05,9686
00679B,元大美債20年,31,3,28,富邦-宜蘭,2024-01-05,9686
2393,億光,27,0,27,富邦-宜蘭,2024-01-05,9686
6140,訊達,32,5,27,富邦-宜蘭,2024-01-05,9686
5425,台半,28,2,26,富邦-宜蘭,2024-01-05,9686
00720B,元大投資級公司債,47,22,25,富邦-宜蘭,2024-01-05,9686
00772B,中信高評級公司債,24,0,24,富邦-宜蘭,2024-01-05,9686
2356,英業達,92,68,24,富邦-宜蘭,2024-01-05,9686
00929,復華台灣科技優息,72,48,24,富邦-宜蘭,2024-01-05,9686
5426,振發,38,15,23,富邦-宜蘭,2024-01-05,9686
3086,華義,31,11,20,富邦-宜蘭,2024-01-05,9686
00715L,期街口布蘭特正2,18,0,18,富邦-宜蘭,2024-01-05,9686
8096,擎亞,24,7,17,富邦-宜蘭,2024-01-05,9686
00753L,中信中國50正2,21,5,16,富邦-宜蘭,2024-01-05,9686
9912,偉聯,16,0,16,富邦-宜蘭,2024-01-05,9686
2486,一詮,56,41,15,富邦-宜蘭,2024-01-05,9686
00923,群益台ESG低碳50,14,0,14,富邦-宜蘭,2024-01-05,9686
2331,精英,17,3,14,富邦-宜蘭,2024-01-05,9686
00680L,元大美債20正2,13,0,13,富邦-宜蘭,2024-01-05,9686
6782,視陽,15,2,13,富邦-宜蘭,2024-01-05,9686
1536,和大,12,0,12,富邦-宜蘭,2024-01-05,9686
3228,金麗科,12,0,12,富邦-宜蘭,2024-01-05,9686
8086,宏捷科,13,1,12,富邦-宜蘭,2024-01-05,9686
3390,旭軟,15,3,12,富邦-宜蘭,2024-01-05,9686
8112,至上,14,2,12,富邦-宜蘭,2024-01-05,9686
2324,仁寶,30,18,12,富邦-宜蘭,2024-01-05,9686
2882,國泰金,12,1,11,富邦-宜蘭,2024-01-05,9686
2408,南亞科,11,0,11,富邦-宜蘭,2024-01-05,9686
2323,中環,11,0,11,富邦-宜蘭,2024-01-05,9686
2344,華邦電,18,7,11,富邦-宜蘭,2024-01-05,9686
2368,金像電,12,2,10,富邦-宜蘭,2024-01-05,9686
1708,東鹼,10,0,10,富邦-宜蘭,2024-01-05,9686
3252,海灣,10,0,10,富邦-宜蘭,2024-01-05,9686
1569,濱川,12,2,10,富邦-宜蘭,2024-01-05,9686
2903,遠百,10,0,10,富邦-宜蘭,2024-01-05,9686
2484,希華,10,0,10,富邦-宜蘭,2024-01-05,9686
3715,定穎投控,26,16,10,富邦-宜蘭,2024-01-05,9686
8110,華東,9,0,9,富邦-宜蘭,2024-01-05,9686
00929,復華台灣科技優息,205,18,187,富邦-宜蘭,2024-01-08,9686
00637L,元大滬深300正2,179,21,158,富邦-宜蘭,2024-01-08,9686
2353,宏��,417,272,145,富邦-宜蘭,2024-01-08,9686
2365,昆盈,101,0,101,富邦-宜蘭,2024-01-08,9686
00877,復華中國5G,105,7,98,富邦-宜蘭,2024-01-08,9686
00919,群益台灣精選高息,155,77,78,富邦-宜蘭,2024-01-08,9686
00665L,富邦�琤肭磪囓�2,72,1,71,富邦-宜蘭,2024-01-08,9686
00937B,群益ESG投等債20,74,20,54,富邦-宜蘭,2024-01-08,9686
00650L,復華香港正2,47,0,47,富邦-宜蘭,2024-01-08,9686
00904,新光臺灣半導體30,50,5,45,富邦-宜蘭,2024-01-08,9686
00934,中信成長高股息,42,0,42,富邦-宜蘭,2024-01-08,9686
00632R,元大台灣50反1,136,100,36,富邦-宜蘭,2024-01-08,9686
8068,全達,35,0,35,富邦-宜蘭,2024-01-08,9686
00753L,中信中國50正2,42,10,32,富邦-宜蘭,2024-01-08,9686
00720B,元大投資級公司債,43,12,31,富邦-宜蘭,2024-01-08,9686
4167,松瑞藥,30,0,30,富邦-宜蘭,2024-01-08,9686
6418,詠昇,30,0,30,富邦-宜蘭,2024-01-08,9686
00927,群益半導體收益,28,3,25,富邦-宜蘭,2024-01-08,9686
6139,亞翔,30,5,25,富邦-宜蘭,2024-01-08,9686
8096,擎亞,41,16,25,富邦-宜蘭,2024-01-08,9686
2387,精元,28,4,24,富邦-宜蘭,2024-01-08,9686
2317,鴻海,28,8,20,富邦-宜蘭,2024-01-08,9686
3033,威健,20,0,20,富邦-宜蘭,2024-01-08,9686
5490,同亨,20,1,19,富邦-宜蘭,2024-01-08,9686
00772B,中信高評級公司債,20,1,19,富邦-宜蘭,2024-01-08,9686
6243,迅杰,27,8,19,富邦-宜蘭,2024-01-08,9686
2615,萬海,21,3,18,富邦-宜蘭,2024-01-08,9686
00882,中信中國高股息,18,0,18,富邦-宜蘭,2024-01-08,9686
2344,華邦電,21,4,17,富邦-宜蘭,2024-01-08,9686
2543,皇昌,30,13,17,富邦-宜蘭,2024-01-08,9686
910861,神州-DR,17,0,17,富邦-宜蘭,2024-01-08,9686
2630,亞航,32,15,17,富邦-宜蘭,2024-01-08,9686
6695,芯鼎,38,22,16,富邦-宜蘭,2024-01-08,9686
1603,華電,16,0,16,富邦-宜蘭,2024-01-08,9686
2363,矽統,18,2,16,富邦-宜蘭,2024-01-08,9686
2607,榮運,17,1,16,富邦-宜蘭,2024-01-08,9686
2611,志信,15,0,15,富邦-宜蘭,2024-01-08,9686
2393,億光,15,0,15,富邦-宜蘭,2024-01-08,9686
4746,台耀,24,10,14,富邦-宜蘭,2024-01-08,9686
1905,華紙,14,0,14,富邦-宜蘭,2024-01-08,9686
2736,富野,17,3,14,富邦-宜蘭,2024-01-08,9686
2313,華通,23,10,13,富邦-宜蘭,2024-01-08,9686
6416,瑞祺電通,13,0,13,富邦-宜蘭,2024-01-08,9686
2352,佳世達,35,22,13,富邦-宜蘭,2024-01-08,9686
8046,南電,18,6,12,富邦-宜蘭,2024-01-08,9686
2610,華航,12,1,11,富邦-宜蘭,2024-01-08,9686
6182,合晶,15,4,11,富邦-宜蘭,2024-01-08,9686
2337,旺宏,20,10,10,富邦-宜蘭,2024-01-08,9686
00680L,元大美債20正2,10,0,10,富邦-宜蘭,2024-01-08,9686
4114,健喬,10,0,10,富邦-宜蘭,2024-01-08,9686
2312,金寶,210,0,210,富邦-宜蘭,2024-01-09,9686
00919,群益台灣精選高息,176,3,173,富邦-宜蘭,2024-01-09,9686
00725B,國泰投資級公司債,122,5,117,富邦-宜蘭,2024-01-09,9686
4552,力達-KY,105,0,105,富邦-宜蘭,2024-01-09,9686
2609,陽明,263,162,101,富邦-宜蘭,2024-01-09,9686
6770,力積電,94,4,90,富邦-宜蘭,2024-01-09,9686
00929,復華台灣科技優息,70,5,65,富邦-宜蘭,2024-01-09,9686
2888,新光金,83,21,62,富邦-宜蘭,2024-01-09,9686
1618,合機,63,1,62,富邦-宜蘭,2024-01-09,9686
00632R,元大台灣50反1,70,10,60,富邦-宜蘭,2024-01-09,9686
00937B,群益ESG投等債20,80,26,54,富邦-宜蘭,2024-01-09,9686
6122,擎邦,58,7,51,富邦-宜蘭,2024-01-09,9686
2887,台新金,50,0,50,富邦-宜蘭,2024-01-09,9686
1762,中化生,51,3,48,富邦-宜蘭,2024-01-09,9686
00687B,國泰20年美債,43,0,43,富邦-宜蘭,2024-01-09,9686
00715L,期街口布蘭特正2,41,0,41,富邦-宜蘭,2024-01-09,9686
2324,仁寶,110,75,35,富邦-宜蘭,2024-01-09,9686
4956,光鋐,114,83,31,富邦-宜蘭,2024-01-09,9686
2356,英業達,76,46,30,富邦-宜蘭,2024-01-09,9686
2615,萬海,43,14,29,富邦-宜蘭,2024-01-09,9686
6120,達運,143,115,28,富邦-宜蘭,2024-01-09,9686
2317,鴻海,29,2,27,富邦-宜蘭,2024-01-09,9686
2337,旺宏,26,0,26,富邦-宜蘭,2024-01-09,9686
3576,聯合再生,36,10,26,富邦-宜蘭,2024-01-09,9686
8071,能率網通,26,0,26,富邦-宜蘭,2024-01-09,9686
1727,中華化,25,0,25,富邦-宜蘭,2024-01-09,9686
00927,群益半導體收益,24,1,23,富邦-宜蘭,2024-01-09,9686
00933B,國泰10Y+金融債,22,0,22,富邦-宜蘭,2024-01-09,9686
5426,振發,24,2,22,富邦-宜蘭,2024-01-09,9686
2601,益航,23,2,21,富邦-宜蘭,2024-01-09,9686
1584,精剛,21,0,21,富邦-宜蘭,2024-01-09,9686
3260,威剛,22,1,21,富邦-宜蘭,2024-01-09,9686
3481,群創,44,24,20,富邦-宜蘭,2024-01-09,9686
4167,松瑞藥,21,1,20,富邦-宜蘭,2024-01-09,9686
00887,永豐中國科技50大,20,0,20,富邦-宜蘭,2024-01-09,9686
2603,長榮,86,66,20,富邦-宜蘭,2024-01-09,9686
2498,宏達電,91,72,19,富邦-宜蘭,2024-01-09,9686
2610,華航,20,1,19,富邦-宜蘭,2024-01-09,9686
2352,佳世達,27,9,18,富邦-宜蘭,2024-01-09,9686
3231,緯創,76,59,17,富邦-宜蘭,2024-01-09,9686
2409,友達,29,13,16,富邦-宜蘭,2024-01-09,9686
2426,鼎元,16,0,16,富邦-宜蘭,2024-01-09,9686
2634,漢翔,33,17,16,富邦-宜蘭,2024-01-09,9686
2206,三陽工業,15,0,15,富邦-宜蘭,2024-01-09,9686
00918,大華優利高填息30,14,0,14,富邦-宜蘭,2024-01-09,9686
3078,僑威,15,1,14,富邦-宜蘭,2024-01-09,9686
1605,華新,48,34,14,富邦-宜蘭,2024-01-09,9686
2491,吉祥全,13,0,13,富邦-宜蘭,2024-01-09,9686
00888,永豐台灣ESG,13,0,13,富邦-宜蘭,2024-01-09,9686
2881,富邦金,13,0,13,富邦-宜蘭,2024-01-09,9686
2890,永豐金,210,0,210,富邦-宜蘭,2024-01-10,9686
2323,中環,130,0,130,富邦-宜蘭,2024-01-10,9686
4552,力達-KY,101,1,100,富邦-宜蘭,2024-01-10,9686
6140,訊達,152,73,79,富邦-宜蘭,2024-01-10,9686
2630,亞航,100,30,70,富邦-宜蘭,2024-01-10,9686
2618,長榮航,80,18,62,富邦-宜蘭,2024-01-10,9686
2610,華航,58,2,56,富邦-宜蘭,2024-01-10,9686
2637,慧洋-KY,58,3,55,富邦-宜蘭,2024-01-10,9686
9940,信義,72,18,54,富邦-宜蘭,2024-01-10,9686
1584,精剛,48,0,48,富邦-宜蘭,2024-01-10,9686
2352,佳世達,46,2,44,富邦-宜蘭,2024-01-10,9686
00927,群益半導體收益,43,0,43,富邦-宜蘭,2024-01-10,9686
2362,藍天,48,7,41,富邦-宜蘭,2024-01-10,9686
00933B,國泰10Y+金融債,40,0,40,富邦-宜蘭,2024-01-10,9686
6139,亞翔,46,6,40,富邦-宜蘭,2024-01-10,9686
1605,華新,41,5,36,富邦-宜蘭,2024-01-10,9686
8096,擎亞,61,25,36,富邦-宜蘭,2024-01-10,9686
2634,漢翔,35,0,35,富邦-宜蘭,2024-01-10,9686
00665L,富邦�琤肭磪囓�2,67,33,34,富邦-宜蘭,2024-01-10,9686
2884,玉山金,34,0,34,富邦-宜蘭,2024-01-10,9686
2301,光寶科,36,3,33,富邦-宜蘭,2024-01-10,9686
0056,元大高股息,40,7,33,富邦-宜蘭,2024-01-10,9686
2324,仁寶,39,9,30,富邦-宜蘭,2024-01-10,9686
1452,宏益,100,70,30,富邦-宜蘭,2024-01-10,9686
6113,亞矽,32,3,29,富邦-宜蘭,2024-01-10,9686
8155,博智,35,6,29,富邦-宜蘭,2024-01-10,9686
00919,群益台灣精選高息,128,102,26,富邦-宜蘭,2024-01-10,9686
1802,台玻,25,0,25,富邦-宜蘭,2024-01-10,9686
2371,大同,42,17,25,富邦-宜蘭,2024-01-10,9686
6243,迅杰,44,21,23,富邦-宜蘭,2024-01-10,9686
00929,復華台灣科技優息,54,31,23,富邦-宜蘭,2024-01-10,9686
00937B,群益ESG投等債20,26,5,21,富邦-宜蘭,2024-01-10,9686
2888,新光金,21,0,21,富邦-宜蘭,2024-01-10,9686
2382,廣達,29,8,21,富邦-宜蘭,2024-01-10,9686
4916,事欣科,20,0,20,富邦-宜蘭,2024-01-10,9686
2801,彰銀,20,0,20,富邦-宜蘭,2024-01-10,9686
2317,鴻海,21,3,18,富邦-宜蘭,2024-01-10,9686
2356,英業達,44,26,18,富邦-宜蘭,2024-01-10,9686
2603,長榮,46,28,18,富邦-宜蘭,2024-01-10,9686
6120,達運,85,68,17,富邦-宜蘭,2024-01-10,9686
6274,台燿,16,0,16,富邦-宜蘭,2024-01-10,9686
2481,強茂,16,0,16,富邦-宜蘭,2024-01-10,9686
2329,華泰,68,53,15,富邦-宜蘭,2024-01-10,9686
1707,葡萄王,15,0,15,富邦-宜蘭,2024-01-10,9686
6122,擎邦,29,14,15,富邦-宜蘭,2024-01-10,9686
2031,新光鋼,15,0,15,富邦-宜蘭,2024-01-10,9686
2748,雲品,16,1,15,富邦-宜蘭,2024-01-10,9686
00878,國泰永續高股息,19,6,13,富邦-宜蘭,2024-01-10,9686
2027,大成鋼,14,1,13,富邦-宜蘭,2024-01-10,9686
00904,新光臺灣半導體30,12,0,12,富邦-宜蘭,2024-01-10,9686
3481,群創,304,138,166,富邦-宜蘭,2024-01-11,9686
00929,復華台灣科技優息,134,17,117,富邦-宜蘭,2024-01-11,9686
00919,群益台灣精選高息,99,11,88,富邦-宜蘭,2024-01-11,9686
4956,光鋐,310,237,73,富邦-宜蘭,2024-01-11,9686
2610,華航,97,45,52,富邦-宜蘭,2024-01-11,9686
6140,訊達,55,3,52,富邦-宜蘭,2024-01-11,9686
6219,富旺,50,1,49,富邦-宜蘭,2024-01-11,9686
2365,昆盈,58,13,45,富邦-宜蘭,2024-01-11,9686
2353,宏��,86,56,30,富邦-宜蘭,2024-01-11,9686
2211,長榮鋼,30,0,30,富邦-宜蘭,2024-01-11,9686
4909,新復興,53,23,30,富邦-宜蘭,2024-01-11,9686
3050,鈺德,30,2,28,富邦-宜蘭,2024-01-11,9686
2409,友達,46,18,28,富邦-宜蘭,2024-01-11,9686
6139,亞翔,37,11,26,富邦-宜蘭,2024-01-11,9686
6770,力積電,27,5,22,富邦-宜蘭,2024-01-11,9686
2344,華邦電,28,7,21,富邦-宜蘭,2024-01-11,9686
5348,正能量智能,20,0,20,富邦-宜蘭,2024-01-11,9686
6116,彩晶,25,7,18,富邦-宜蘭,2024-01-11,9686
2301,光寶科,19,2,17,富邦-宜蘭,2024-01-11,9686
2606,裕民,18,1,17,富邦-宜蘭,2024-01-11,9686
3437,榮創,29,12,17,富邦-宜蘭,2024-01-11,9686
2303,聯電,17,0,17,富邦-宜蘭,2024-01-11,9686
00927,群益半導體收益,16,0,16,富邦-宜蘭,2024-01-11,9686
1452,宏益,76,60,16,富邦-宜蘭,2024-01-11,9686
2387,精元,16,0,16,富邦-宜蘭,2024-01-11,9686
1504,東元,15,0,15,富邦-宜蘭,2024-01-11,9686
00903,富邦元宇宙,15,0,15,富邦-宜蘭,2024-01-11,9686
6695,芯鼎,142,127,15,富邦-宜蘭,2024-01-11,9686
2031,新光鋼,15,0,15,富邦-宜蘭,2024-01-11,9686
00892,富邦台灣半導體,15,0,15,富邦-宜蘭,2024-01-11,9686
2317,鴻海,29,14,15,富邦-宜蘭,2024-01-11,9686
4960,誠美材,20,6,14,富邦-宜蘭,2024-01-11,9686
2615,萬海,26,12,14,富邦-宜蘭,2024-01-11,9686
2449,京元電子,21,8,13,富邦-宜蘭,2024-01-11,9686
1303,南亞,12,0,12,富邦-宜蘭,2024-01-11,9686
1519,華城,36,24,12,富邦-宜蘭,2024-01-11,9686
6237,驊訊,12,0,12,富邦-宜蘭,2024-01-11,9686
2421,建準,14,3,11,富邦-宜蘭,2024-01-11,9686
1471,首利,11,0,11,富邦-宜蘭,2024-01-11,9686
6120,達運,101,90,11,富邦-宜蘭,2024-01-11,9686
0050,元大台灣50,11,1,10,富邦-宜蘭,2024-01-11,9686
1301,台塑,10,0,10,富邦-宜蘭,2024-01-11,9686
00933B,國泰10Y+金融債,10,0,10,富邦-宜蘭,2024-01-11,9686
6285,啟��,10,0,10,富邦-宜蘭,2024-01-11,9686
6509,聚和,10,0,10,富邦-宜蘭,2024-01-11,9686
2884,玉山金,12,2,10,富邦-宜蘭,2024-01-11,9686
00882,中信中國高股息,16,6,10,富邦-宜蘭,2024-01-11,9686
2408,南亞科,14,5,9,富邦-宜蘭,2024-01-11,9686
6223,旺矽,10,1,9,富邦-宜蘭,2024-01-11,9686
3712,永崴投控,9,0,9,富邦-宜蘭,2024-01-11,9686
00929,復華台灣科技優息,300,8,292,富邦-宜蘭,2024-01-12,9686
2834,臺企銀,200,0,200,富邦-宜蘭,2024-01-12,9686
00927,群益半導體收益,134,5,129,富邦-宜蘭,2024-01-12,9686
2890,永豐金,116,0,116,富邦-宜蘭,2024-01-12,9686
2641,正德,87,6,81,富邦-宜蘭,2024-01-12,9686
6120,達運,105,30,75,富邦-宜蘭,2024-01-12,9686
2801,彰銀,66,0,66,富邦-宜蘭,2024-01-12,9686
2606,裕民,52,1,51,富邦-宜蘭,2024-01-12,9686
2353,宏��,88,46,42,富邦-宜蘭,2024-01-12,9686
2399,映泰,36,0,36,富邦-宜蘭,2024-01-12,9686
2610,華航,39,3,36,富邦-宜蘭,2024-01-12,9686
00937B,群益ESG投等債20,31,2,29,富邦-宜蘭,2024-01-12,9686
2317,鴻海,30,2,28,富邦-宜蘭,2024-01-12,9686
0056,元大高股息,25,5,20,富邦-宜蘭,2024-01-12,9686
2449,京元電子,26,7,19,富邦-宜蘭,2024-01-12,9686
3706,神達,29,10,19,富邦-宜蘭,2024-01-12,9686
1452,宏益,80,61,19,富邦-宜蘭,2024-01-12,9686
00919,群益台灣精選高息,44,25,19,富邦-宜蘭,2024-01-12,9686
1815,富喬,17,0,17,富邦-宜蘭,2024-01-12,9686
6122,擎邦,22,5,17,富邦-宜蘭,2024-01-12,9686
1301,台塑,17,0,17,富邦-宜蘭,2024-01-12,9686
1314,中石化,26,10,16,富邦-宜蘭,2024-01-12,9686
8096,擎亞,76,61,15,富邦-宜蘭,2024-01-12,9686
5425,台半,16,1,15,富邦-宜蘭,2024-01-12,9686
2883,凱基金,15,0,15,富邦-宜蘭,2024-01-12,9686
1325,恆大,34,19,15,富邦-宜蘭,2024-01-12,9686
1595,川寶,16,1,15,富邦-宜蘭,2024-01-12,9686
2329,華泰,54,40,14,富邦-宜蘭,2024-01-12,9686
3227,原相,14,0,14,富邦-宜蘭,2024-01-12,9686
6770,力積電,16,2,14,富邦-宜蘭,2024-01-12,9686
2408,南亞科,17,3,14,富邦-宜蘭,2024-01-12,9686
00673R,期元大S＆P原油反1,12,0,12,富邦-宜蘭,2024-01-12,9686
3066,李洲,16,4,12,富邦-宜蘭,2024-01-12,9686
00753L,中信中國50正2,12,0,12,富邦-宜蘭,2024-01-12,9686
8176,智捷,11,0,11,富邦-宜蘭,2024-01-12,9686
4909,新復興,59,48,11,富邦-宜蘭,2024-01-12,9686
2424,隴華,11,0,11,富邦-宜蘭,2024-01-12,9686
5009,榮剛,11,0,11,富邦-宜蘭,2024-01-12,9686
1707,葡萄王,11,0,11,富邦-宜蘭,2024-01-12,9686
00881,國泰台灣5G+,20,10,10,富邦-宜蘭,2024-01-12,9686
2374,佳能,10,0,10,富邦-宜蘭,2024-01-12,9686
00669R,國泰美國道瓊反1,10,0,10,富邦-宜蘭,2024-01-12,9686
3122,笙泉,10,0,10,富邦-宜蘭,2024-01-12,9686
2607,榮運,15,5,10,富邦-宜蘭,2024-01-12,9686
2406,國碩,10,0,10,富邦-宜蘭,2024-01-12,9686
2548,華固,10,0,10,富邦-宜蘭,2024-01-12,9686
1324,地球,10,0,10,富邦-宜蘭,2024-01-12,9686
6698,旭暉應材,10,0,10,富邦-宜蘭,2024-01-12,9686
4714,永捷,10,0,10,富邦-宜蘭,2024-01-12,9686
2436,偉詮電,12,2,10,富邦-宜蘭,2024-01-12,9686
8096,擎亞,124,13,111,富邦-宜蘭,2024-01-15,9686
2515,中工,115,8,107,富邦-宜蘭,2024-01-15,9686
6219,富旺,135,35,100,富邦-宜蘭,2024-01-15,9686
00933B,國泰10Y+金融債,82,5,77,富邦-宜蘭,2024-01-15,9686
00929,復華台灣科技優息,253,181,72,富邦-宜蘭,2024-01-15,9686
2618,長榮航,71,0,71,富邦-宜蘭,2024-01-15,9686
00877,復華中國5G,55,0,55,富邦-宜蘭,2024-01-15,9686
6207,雷科,65,13,52,富邦-宜蘭,2024-01-15,9686
5426,振發,104,53,51,富邦-宜蘭,2024-01-15,9686
2498,宏達電,55,5,50,富邦-宜蘭,2024-01-15,9686
1452,宏益,123,79,44,富邦-宜蘭,2024-01-15,9686
2888,新光金,49,5,44,富邦-宜蘭,2024-01-15,9686
0056,元大高股息,36,1,35,富邦-宜蘭,2024-01-15,9686
2356,英業達,63,29,34,富邦-宜蘭,2024-01-15,9686
6140,訊達,68,36,32,富邦-宜蘭,2024-01-15,9686
6244,茂迪,33,2,31,富邦-宜蘭,2024-01-15,9686
00665L,富邦�琤肭磪囓�2,30,0,30,富邦-宜蘭,2024-01-15,9686
2609,陽明,198,169,29,富邦-宜蘭,2024-01-15,9686
00720B,元大投資級公司債,33,5,28,富邦-宜蘭,2024-01-15,9686
2406,國碩,64,37,27,富邦-宜蘭,2024-01-15,9686
00725B,國泰投資級公司債,26,0,26,富邦-宜蘭,2024-01-15,9686
2329,華泰,60,34,26,富邦-宜蘭,2024-01-15,9686
00650L,復華香港正2,23,2,21,富邦-宜蘭,2024-01-15,9686
00931B,統一美債20年,22,1,21,富邦-宜蘭,2024-01-15,9686
3576,聯合再生,21,0,21,富邦-宜蘭,2024-01-15,9686
00921,兆豐龍頭等權重,20,0,20,富邦-宜蘭,2024-01-15,9686
2208,台船,27,8,19,富邦-宜蘭,2024-01-15,9686
2409,友達,34,16,18,富邦-宜蘭,2024-01-15,9686
00878,國泰永續高股息,20,2,18,富邦-宜蘭,2024-01-15,9686
1101,台泥,17,0,17,富邦-宜蘭,2024-01-15,9686
3231,緯創,100,83,17,富邦-宜蘭,2024-01-15,9686
00927,群益半導體收益,16,0,16,富邦-宜蘭,2024-01-15,9686
910861,神州-DR,16,0,16,富邦-宜蘭,2024-01-15,9686
020038,元大ESG配息N,15,0,15,富邦-宜蘭,2024-01-15,9686
2610,華航,22,7,15,富邦-宜蘭,2024-01-15,9686
3035,智原,32,19,13,富邦-宜蘭,2024-01-15,9686
6233,旺玖,15,2,13,富邦-宜蘭,2024-01-15,9686
2630,亞航,16,3,13,富邦-宜蘭,2024-01-15,9686
00904,新光臺灣半導體30,12,0,12,富邦-宜蘭,2024-01-15,9686
2883,凱基金,15,3,12,富邦-宜蘭,2024-01-15,9686
2801,彰銀,12,0,12,富邦-宜蘭,2024-01-15,9686
2362,藍天,13,1,12,富邦-宜蘭,2024-01-15,9686
5706,鳳凰,12,1,11,富邦-宜蘭,2024-01-15,9686
00900,富邦特選高股息30,13,2,11,富邦-宜蘭,2024-01-15,9686
2748,雲品,13,2,11,富邦-宜蘭,2024-01-15,9686
6116,彩晶,22,11,11,富邦-宜蘭,2024-01-15,9686
2353,宏��,52,42,10,富邦-宜蘭,2024-01-15,9686
1326,台化,11,1,10,富邦-宜蘭,2024-01-15,9686
00679B,元大美債20年,13,3,10,富邦-宜蘭,2024-01-15,9686
3044,健鼎,11,1,10,富邦-宜蘭,2024-01-15,9686
00676R,富邦臺灣加權反1,376,100,276,富邦-宜蘭,2024-01-16,9686
00664R,國泰臺灣加權反1,250,0,250,富邦-宜蘭,2024-01-16,9686
00929,復華台灣科技優息,240,5,235,富邦-宜蘭,2024-01-16,9686
0056,元大高股息,175,19,156,富邦-宜蘭,2024-01-16,9686
2887,台新金,141,0,141,富邦-宜蘭,2024-01-16,9686
00882,中信中國高股息,137,0,137,富邦-宜蘭,2024-01-16,9686
8034,榮群,135,23,112,富邦-宜蘭,2024-01-16,9686
00919,群益台灣精選高息,111,6,105,富邦-宜蘭,2024-01-16,9686
2401,凌陽,101,9,92,富邦-宜蘭,2024-01-16,9686
2486,一詮,121,38,83,富邦-宜蘭,2024-01-16,9686
2344,華邦電,75,1,74,富邦-宜蘭,2024-01-16,9686
2801,彰銀,68,0,68,富邦-宜蘭,2024-01-16,9686
00927,群益半導體收益,63,0,63,富邦-宜蘭,2024-01-16,9686
2883,凱基金,63,5,58,富邦-宜蘭,2024-01-16,9686
1528,恩德,103,47,56,富邦-宜蘭,2024-01-16,9686
4931,新盛力,57,1,56,富邦-宜蘭,2024-01-16,9686
2603,長榮,84,31,53,富邦-宜蘭,2024-01-16,9686
6695,芯鼎,190,137,53,富邦-宜蘭,2024-01-16,9686
5351,鈺創,119,68,51,富邦-宜蘭,2024-01-16,9686
2892,第一金,51,1,50,富邦-宜蘭,2024-01-16,9686
2324,仁寶,53,6,47,富邦-宜蘭,2024-01-16,9686
1434,福懋,38,0,38,富邦-宜蘭,2024-01-16,9686
8096,擎亞,130,93,37,富邦-宜蘭,2024-01-16,9686
00680L,元大美債20正2,37,0,37,富邦-宜蘭,2024-01-16,9686
2312,金寶,45,8,37,富邦-宜蘭,2024-01-16,9686
2618,長榮航,68,32,36,富邦-宜蘭,2024-01-16,9686
5488,松普,35,2,33,富邦-宜蘭,2024-01-16,9686
2885,元大金,33,0,33,富邦-宜蘭,2024-01-16,9686
00881,國泰台灣5G+,33,0,33,富邦-宜蘭,2024-01-16,9686
00650L,復華香港正2,53,21,32,富邦-宜蘭,2024-01-16,9686
2002,中鋼,36,5,31,富邦-宜蘭,2024-01-16,9686
2352,佳世達,31,0,31,富邦-宜蘭,2024-01-16,9686
6139,亞翔,52,23,29,富邦-宜蘭,2024-01-16,9686
2337,旺宏,28,0,28,富邦-宜蘭,2024-01-16,9686
2610,華航,50,23,27,富邦-宜蘭,2024-01-16,9686
00770,國泰北美科技,35,8,27,富邦-宜蘭,2024-01-16,9686
1301,台塑,36,10,26,富邦-宜蘭,2024-01-16,9686
6770,力積電,35,10,25,富邦-宜蘭,2024-01-16,9686
6698,旭暉應材,38,15,23,富邦-宜蘭,2024-01-16,9686
4157,太景*-KY,23,0,23,富邦-宜蘭,2024-01-16,9686
2609,陽明,72,49,23,富邦-宜蘭,2024-01-16,9686
1605,華新,32,10,22,富邦-宜蘭,2024-01-16,9686
2317,鴻海,24,2,22,富邦-宜蘭,2024-01-16,9686
6461,益得,20,0,20,富邦-宜蘭,2024-01-16,9686
2882,國泰金,20,1,19,富邦-宜蘭,2024-01-16,9686
2889,國票金,18,0,18,富邦-宜蘭,2024-01-16,9686
2408,南亞科,18,0,18,富邦-宜蘭,2024-01-16,9686
00923,群益台ESG低碳50,17,0,17,富邦-宜蘭,2024-01-16,9686
6684,安格,42,26,16,富邦-宜蘭,2024-01-16,9686
6282,康舒,15,0,15,富邦-宜蘭,2024-01-16,9686
00919,群益台灣精選高息,307,62,245,富邦-宜蘭,2024-01-17,9686
0056,元大高股息,247,18,229,富邦-宜蘭,2024-01-17,9686
00929,復華台灣科技優息,408,201,207,富邦-宜蘭,2024-01-17,9686
1312,國喬,205,0,205,富邦-宜蘭,2024-01-17,9686
2303,聯電,125,15,110,富邦-宜蘭,2024-01-17,9686
00679B,元大美債20年,108,7,101,富邦-宜蘭,2024-01-17,9686
6770,力積電,100,2,98,富邦-宜蘭,2024-01-17,9686
00882,中信中國高股息,89,5,84,富邦-宜蘭,2024-01-17,9686
2886,兆豐金,79,3,76,富邦-宜蘭,2024-01-17,9686
2352,佳世達,81,9,72,富邦-宜蘭,2024-01-17,9686
00937B,群益ESG投等債20,80,14,66,富邦-宜蘭,2024-01-17,9686
4956,光鋐,95,30,65,富邦-宜蘭,2024-01-17,9686
00650L,復華香港正2,86,22,64,富邦-宜蘭,2024-01-17,9686
2888,新光金,84,23,61,富邦-宜蘭,2024-01-17,9686
2344,華邦電,69,10,59,富邦-宜蘭,2024-01-17,9686
00878,國泰永續高股息,90,34,56,富邦-宜蘭,2024-01-17,9686
00772B,中信高評級公司債,53,3,50,富邦-宜蘭,2024-01-17,9686
3349,寶德,45,0,45,富邦-宜蘭,2024-01-17,9686
2323,中環,43,1,42,富邦-宜蘭,2024-01-17,9686
3025,星通,66,25,41,富邦-宜蘭,2024-01-17,9686
6116,彩晶,53,13,40,富邦-宜蘭,2024-01-17,9686
2457,飛宏,39,0,39,富邦-宜蘭,2024-01-17,9686
2634,漢翔,40,1,39,富邦-宜蘭,2024-01-17,9686
00637L,元大滬深300正2,93,54,39,富邦-宜蘭,2024-01-17,9686
6122,擎邦,45,8,37,富邦-宜蘭,2024-01-17,9686
2880,華南金,37,1,36,富邦-宜蘭,2024-01-17,9686
1104,環泥,35,0,35,富邦-宜蘭,2024-01-17,9686
00753L,中信中國50正2,109,76,33,富邦-宜蘭,2024-01-17,9686
5425,台半,40,8,32,富邦-宜蘭,2024-01-17,9686
5488,松普,65,33,32,富邦-宜蘭,2024-01-17,9686
6698,旭暉應材,33,1,32,富邦-宜蘭,2024-01-17,9686
2408,南亞科,33,3,30,富邦-宜蘭,2024-01-17,9686
2317,鴻海,33,3,30,富邦-宜蘭,2024-01-17,9686
2618,長榮航,30,1,29,富邦-宜蘭,2024-01-17,9686
1452,宏益,106,77,29,富邦-宜蘭,2024-01-17,9686
00918,大華優利高填息30,37,9,28,富邦-宜蘭,2024-01-17,9686
2377,微星,28,0,28,富邦-宜蘭,2024-01-17,9686
8096,擎亞,100,73,27,富邦-宜蘭,2024-01-17,9686
2883,凱基金,35,11,24,富邦-宜蘭,2024-01-17,9686
2356,英業達,68,44,24,富邦-宜蘭,2024-01-17,9686
1314,中石化,28,5,23,富邦-宜蘭,2024-01-17,9686
2337,旺宏,22,0,22,富邦-宜蘭,2024-01-17,9686
3149,正達,22,0,22,富邦-宜蘭,2024-01-17,9686
1101,台泥,24,3,21,富邦-宜蘭,2024-01-17,9686
5009,榮剛,21,0,21,富邦-宜蘭,2024-01-17,9686
00904,新光臺灣半導體30,34,13,21,富邦-宜蘭,2024-01-17,9686
2353,宏��,34,13,21,富邦-宜蘭,2024-01-17,9686
3266,昇陽,20,0,20,富邦-宜蘭,2024-01-17,9686
00712,復華富時不動產,21,1,20,富邦-宜蘭,2024-01-17,9686
5351,鈺創,37,17,20,富邦-宜蘭,2024-01-17,9686
4552,力達-KY,100,0,100,富邦-宜蘭,2024-01-18,9686
00929,復華台灣科技優息,116,26,90,富邦-宜蘭,2024-01-18,9686
00637L,元大滬深300正2,154,68,86,富邦-宜蘭,2024-01-18,9686
6120,達運,127,47,80,富邦-宜蘭,2024-01-18,9686
00882,中信中國高股息,77,0,77,富邦-宜蘭,2024-01-18,9686
6770,力積電,76,9,67,富邦-宜蘭,2024-01-18,9686
0056,元大高股息,54,1,53,富邦-宜蘭,2024-01-18,9686
00878,國泰永續高股息,62,23,39,富邦-宜蘭,2024-01-18,9686
2317,鴻海,34,1,33,富邦-宜蘭,2024-01-18,9686
2867,三商壽,32,0,32,富邦-宜蘭,2024-01-18,9686
2353,宏��,90,59,31,富邦-宜蘭,2024-01-18,9686
3321,同泰,31,2,29,富邦-宜蘭,2024-01-18,9686
00919,群益台灣精選高息,62,34,28,富邦-宜蘭,2024-01-18,9686
2302,麗正,32,4,28,富邦-宜蘭,2024-01-18,9686
2002,中鋼,27,1,26,富邦-宜蘭,2024-01-18,9686
4960,誠美材,39,14,25,富邦-宜蘭,2024-01-18,9686
1301,台塑,26,2,24,富邦-宜蘭,2024-01-18,9686
2409,友達,80,56,24,富邦-宜蘭,2024-01-18,9686
00933B,國泰10Y+金融債,24,0,24,富邦-宜蘭,2024-01-18,9686
3481,群創,355,333,22,富邦-宜蘭,2024-01-18,9686
6122,擎邦,28,6,22,富邦-宜蘭,2024-01-18,9686
00753L,中信中國50正2,63,42,21,富邦-宜蘭,2024-01-18,9686
5425,台半,21,1,20,富邦-宜蘭,2024-01-18,9686
3607,谷崧,21,1,20,富邦-宜蘭,2024-01-18,9686
6243,迅杰,51,32,19,富邦-宜蘭,2024-01-18,9686
00720B,元大投資級公司債,25,6,19,富邦-宜蘭,2024-01-18,9686
2515,中工,20,2,18,富邦-宜蘭,2024-01-18,9686
00712,復華富時不動產,18,0,18,富邦-宜蘭,2024-01-18,9686
3712,永崴投控,21,3,18,富邦-宜蘭,2024-01-18,9686
2881,富邦金,22,5,17,富邦-宜蘭,2024-01-18,9686
00687B,國泰20年美債,17,0,17,富邦-宜蘭,2024-01-18,9686
1612,宏泰,15,0,15,富邦-宜蘭,2024-01-18,9686
00936,台新永續高息中小,17,2,15,富邦-宜蘭,2024-01-18,9686
3622,洋華,76,61,15,富邦-宜蘭,2024-01-18,9686
2485,兆赫,35,21,14,富邦-宜蘭,2024-01-18,9686
6148,驊宏資,14,1,13,富邦-宜蘭,2024-01-18,9686
2365,昆盈,14,1,13,富邦-宜蘭,2024-01-18,9686
2801,彰銀,13,0,13,富邦-宜蘭,2024-01-18,9686
6667,信紘科,29,16,13,富邦-宜蘭,2024-01-18,9686
00881,國泰台灣5G+,13,1,12,富邦-宜蘭,2024-01-18,9686
6235,華孚,13,1,12,富邦-宜蘭,2024-01-18,9686
2323,中環,13,1,12,富邦-宜蘭,2024-01-18,9686
2884,玉山金,12,0,12,富邦-宜蘭,2024-01-18,9686
8222,寶一,12,1,11,富邦-宜蘭,2024-01-18,9686
8936,國統,13,2,11,富邦-宜蘭,2024-01-18,9686
00893,國泰智能電動車,11,0,11,富邦-宜蘭,2024-01-18,9686
2892,第一金,21,10,11,富邦-宜蘭,2024-01-18,9686
2303,聯電,18,7,11,富邦-宜蘭,2024-01-18,9686
2436,偉詮電,11,1,10,富邦-宜蘭,2024-01-18,9686
4303,信立,10,0,10,富邦-宜蘭,2024-01-18,9686
00673R,期元大S＆P原油反1,220,0,220,富邦-宜蘭,2024-01-19,9686
00904,新光臺灣半導體30,131,0,131,富邦-宜蘭,2024-01-19,9686
00878,國泰永續高股息,139,21,118,富邦-宜蘭,2024-01-19,9686
5880,合庫金,117,0,117,富邦-宜蘭,2024-01-19,9686
00929,復華台灣科技優息,155,64,91,富邦-宜蘭,2024-01-19,9686
00679B,元大美債20年,74,2,72,富邦-宜蘭,2024-01-19,9686
00919,群益台灣精選高息,62,1,61,富邦-宜蘭,2024-01-19,9686
00931B,統一美債20年,59,1,58,富邦-宜蘭,2024-01-19,9686
9945,潤泰新,47,0,47,富邦-宜蘭,2024-01-19,9686
2610,華航,49,4,45,富邦-宜蘭,2024-01-19,9686
00882,中信中國高股息,42,0,42,富邦-宜蘭,2024-01-19,9686
8436,大江,43,1,42,富邦-宜蘭,2024-01-19,9686
2603,長榮,56,14,42,富邦-宜蘭,2024-01-19,9686
2609,陽明,60,19,41,富邦-宜蘭,2024-01-19,9686
2888,新光金,43,2,41,富邦-宜蘭,2024-01-19,9686
2344,華邦電,42,5,37,富邦-宜蘭,2024-01-19,9686
2316,楠梓電,41,4,37,富邦-宜蘭,2024-01-19,9686
1452,宏益,110,73,37,富邦-宜蘭,2024-01-19,9686
00720B,元大投資級公司債,46,11,35,富邦-宜蘭,2024-01-19,9686
6207,雷科,34,2,32,富邦-宜蘭,2024-01-19,9686
00905,FT臺灣Smart,49,17,32,富邦-宜蘭,2024-01-19,9686
5443,均豪,45,14,31,富邦-宜蘭,2024-01-19,9686
00753L,中信中國50正2,58,28,30,富邦-宜蘭,2024-01-19,9686
2486,一詮,57,28,29,富邦-宜蘭,2024-01-19,9686
1102,亞泥,27,0,27,富邦-宜蘭,2024-01-19,9686
4960,誠美材,30,5,25,富邦-宜蘭,2024-01-19,9686
00680L,元大美債20正2,45,20,25,富邦-宜蘭,2024-01-19,9686
00751B,元大AAA至A公司債,24,0,24,富邦-宜蘭,2024-01-19,9686
6668,中揚光,38,15,23,富邦-宜蘭,2024-01-19,9686
5272,笙科,23,0,23,富邦-宜蘭,2024-01-19,9686
2884,玉山金,22,0,22,富邦-宜蘭,2024-01-19,9686
00687B,國泰20年美債,36,14,22,富邦-宜蘭,2024-01-19,9686
3624,光頡,20,0,20,富邦-宜蘭,2024-01-19,9686
9904,寶成,20,0,20,富邦-宜蘭,2024-01-19,9686
2409,友達,48,29,19,富邦-宜蘭,2024-01-19,9686
6120,達運,65,46,19,富邦-宜蘭,2024-01-19,9686
00712,復華富時不動產,18,0,18,富邦-宜蘭,2024-01-19,9686
2881,富邦金,30,14,16,富邦-宜蘭,2024-01-19,9686
3050,鈺德,16,0,16,富邦-宜蘭,2024-01-19,9686
2317,鴻海,16,1,15,富邦-宜蘭,2024-01-19,9686
6789,采鈺,18,4,14,富邦-宜蘭,2024-01-19,9686
1319,東陽,13,0,13,富邦-宜蘭,2024-01-19,9686
6116,彩晶,23,10,13,富邦-宜蘭,2024-01-19,9686
6223,旺矽,17,4,13,富邦-宜蘭,2024-01-19,9686
0056,元大高股息,21,8,13,富邦-宜蘭,2024-01-19,9686
2634,漢翔,14,2,12,富邦-宜蘭,2024-01-19,9686
00713,元大台灣高息低波,11,0,11,富邦-宜蘭,2024-01-19,9686
8096,擎亞,43,32,11,富邦-宜蘭,2024-01-19,9686
6185,幃翔,11,0,11,富邦-宜蘭,2024-01-19,9686
4729,熒茂,11,0,11,富邦-宜蘭,2024-01-19,9686
00632R,元大台灣50反1,978,0,978,富邦-宜蘭,2024-01-22,9686
2365,昆盈,100,22,78,富邦-宜蘭,2024-01-22,9686
00882,中信中國高股息,75,0,75,富邦-宜蘭,2024-01-22,9686
8489,三貝德,71,0,71,富邦-宜蘭,2024-01-22,9686
2618,長榮航,88,17,71,富邦-宜蘭,2024-01-22,9686
00753L,中信中國50正2,91,23,68,富邦-宜蘭,2024-01-22,9686
2453,凌群,62,4,58,富邦-宜蘭,2024-01-22,9686
2353,宏��,126,74,52,富邦-宜蘭,2024-01-22,9686
2363,矽統,99,47,52,富邦-宜蘭,2024-01-22,9686
4188,安克,46,3,43,富邦-宜蘭,2024-01-22,9686
2543,皇昌,40,0,40,富邦-宜蘭,2024-01-22,9686
2610,華航,54,14,40,富邦-宜蘭,2024-01-22,9686
00929,復華台灣科技優息,69,31,38,富邦-宜蘭,2024-01-22,9686
00902,中信電池及儲能,36,0,36,富邦-宜蘭,2024-01-22,9686
00933B,國泰10Y+金融債,35,0,35,富邦-宜蘭,2024-01-22,9686
2316,楠梓電,33,0,33,富邦-宜蘭,2024-01-22,9686
2609,陽明,94,63,31,富邦-宜蘭,2024-01-22,9686
00905,FT臺灣Smart,30,0,30,富邦-宜蘭,2024-01-22,9686
1101,台泥,30,2,28,富邦-宜蘭,2024-01-22,9686
8028,昇陽半導體,26,0,26,富邦-宜蘭,2024-01-22,9686
3623,富晶通,46,20,26,富邦-宜蘭,2024-01-22,9686
2369,菱生,27,2,25,富邦-宜蘭,2024-01-22,9686
9934,成霖,24,0,24,富邦-宜蘭,2024-01-22,9686
2329,華泰,352,329,23,富邦-宜蘭,2024-01-22,9686
3339,泰谷,49,26,23,富邦-宜蘭,2024-01-22,9686
2002,中鋼,26,3,23,富邦-宜蘭,2024-01-22,9686
2317,鴻海,21,0,21,富邦-宜蘭,2024-01-22,9686
3055,蔚華科,21,1,20,富邦-宜蘭,2024-01-22,9686
3490,單井,21,1,20,富邦-宜蘭,2024-01-22,9686
00679B,元大美債20年,25,5,20,富邦-宜蘭,2024-01-22,9686
3033,威健,20,1,19,富邦-宜蘭,2024-01-22,9686
2606,裕民,21,2,19,富邦-宜蘭,2024-01-22,9686
6155,鈞寶,20,1,19,富邦-宜蘭,2024-01-22,9686
3380,明泰,30,12,18,富邦-宜蘭,2024-01-22,9686
2344,華邦電,19,2,17,富邦-宜蘭,2024-01-22,9686
3057,喬鼎,19,2,17,富邦-宜蘭,2024-01-22,9686
2454,聯發科,19,2,17,富邦-宜蘭,2024-01-22,9686
1584,精剛,16,0,16,富邦-宜蘭,2024-01-22,9686
4906,正文,21,5,16,富邦-宜蘭,2024-01-22,9686
6188,廣明,16,1,15,富邦-宜蘭,2024-01-22,9686
00935,野村臺灣新科技50,21,6,15,富邦-宜蘭,2024-01-22,9686
5202,力新,16,1,15,富邦-宜蘭,2024-01-22,9686
00936,台新永續高息中小,15,2,13,富邦-宜蘭,2024-01-22,9686
2615,萬海,20,8,12,富邦-宜蘭,2024-01-22,9686
2511,太子,12,0,12,富邦-宜蘭,2024-01-22,9686
6531,愛普*,19,7,12,富邦-宜蘭,2024-01-22,9686
2360,致茂,11,0,11,富邦-宜蘭,2024-01-22,9686
6198,瑞築,11,0,11,富邦-宜蘭,2024-01-22,9686
9941,裕融,10,0,10,富邦-宜蘭,2024-01-22,9686
2867,三商壽,10,0,10,富邦-宜蘭,2024-01-22,9686
00919,群益台灣精選高息,376,1,375,富邦-宜蘭,2024-01-23,9686
6140,訊達,184,36,148,富邦-宜蘭,2024-01-23,9686
2312,金寶,111,2,109,富邦-宜蘭,2024-01-23,9686
8105,凌巨,130,23,107,富邦-宜蘭,2024-01-23,9686
6245,立端,101,1,100,富邦-宜蘭,2024-01-23,9686
5426,振發,140,51,89,富邦-宜蘭,2024-01-23,9686
8155,博智,74,4,70,富邦-宜蘭,2024-01-23,9686
2609,陽明,90,32,58,富邦-宜蘭,2024-01-23,9686
00937B,群益ESG投等債20,53,0,53,富邦-宜蘭,2024-01-23,9686
5244,弘凱,40,0,40,富邦-宜蘭,2024-01-23,9686
2324,仁寶,90,52,38,富邦-宜蘭,2024-01-23,9686
3059,華晶科,68,33,35,富邦-宜蘭,2024-01-23,9686
3380,明泰,34,1,33,富邦-宜蘭,2024-01-23,9686
2610,華航,38,7,31,富邦-宜蘭,2024-01-23,9686
6147,頎邦,30,1,29,富邦-宜蘭,2024-01-23,9686
2353,宏��,65,39,26,富邦-宜蘭,2024-01-23,9686
00929,復華台灣科技優息,43,17,26,富邦-宜蘭,2024-01-23,9686
00650L,復華香港正2,54,30,24,富邦-宜蘭,2024-01-23,9686
2363,矽統,27,3,24,富邦-宜蘭,2024-01-23,9686
8034,榮群,22,0,22,富邦-宜蘭,2024-01-23,9686
00931B,統一美債20年,21,0,21,富邦-宜蘭,2024-01-23,9686
00637L,元大滬深300正2,41,20,21,富邦-宜蘭,2024-01-23,9686
00676R,富邦臺灣加權反1,20,0,20,富邦-宜蘭,2024-01-23,9686
6257,矽格,23,3,20,富邦-宜蘭,2024-01-23,9686
3707,漢磊,20,0,20,富邦-宜蘭,2024-01-23,9686
5202,力新,21,1,20,富邦-宜蘭,2024-01-23,9686
6698,旭暉應材,21,2,19,富邦-宜蘭,2024-01-23,9686
00712,復華富時不動產,19,0,19,富邦-宜蘭,2024-01-23,9686
3607,谷崧,18,0,18,富邦-宜蘭,2024-01-23,9686
2382,廣達,31,14,17,富邦-宜蘭,2024-01-23,9686
00679B,元大美債20年,17,0,17,富邦-宜蘭,2024-01-23,9686
1101,台泥,18,1,17,富邦-宜蘭,2024-01-23,9686
6160,欣技,16,0,16,富邦-宜蘭,2024-01-23,9686
00751B,元大AAA至A公司債,15,0,15,富邦-宜蘭,2024-01-23,9686
5211,蒙恬,19,4,15,富邦-宜蘭,2024-01-23,9686
6155,鈞寶,14,0,14,富邦-宜蘭,2024-01-23,9686
6120,達運,50,36,14,富邦-宜蘭,2024-01-23,9686
8201,無敵,14,0,14,富邦-宜蘭,2024-01-23,9686
00882,中信中國高股息,14,1,13,富邦-宜蘭,2024-01-23,9686
4956,光鋐,24,11,13,富邦-宜蘭,2024-01-23,9686
1312,國喬,22,9,13,富邦-宜蘭,2024-01-23,9686
2615,萬海,24,12,12,富邦-宜蘭,2024-01-23,9686
1471,首利,13,1,12,富邦-宜蘭,2024-01-23,9686
1220,台榮,12,0,12,富邦-宜蘭,2024-01-23,9686
3545,敦泰,14,2,12,富邦-宜蘭,2024-01-23,9686
1301,台塑,13,2,11,富邦-宜蘭,2024-01-23,9686
6505,台塑化,11,0,11,富邦-宜蘭,2024-01-23,9686
1326,台化,11,0,11,富邦-宜蘭,2024-01-23,9686
2022,聚亨,11,0,11,富邦-宜蘭,2024-01-23,9686
5351,鈺創,25,14,11,富邦-宜蘭,2024-01-23,9686
8105,凌巨,154,4,150,富邦-宜蘭,2024-01-24,9686
00937B,群益ESG投等債20,118,20,98,富邦-宜蘭,2024-01-24,9686
2887,台新金,100,2,98,富邦-宜蘭,2024-01-24,9686
3535,晶彩科,104,7,97,富邦-宜蘭,2024-01-24,9686
3047,訊舟,130,58,72,富邦-宜蘭,2024-01-24,9686
5244,弘凱,69,0,69,富邦-宜蘭,2024-01-24,9686
00929,復華台灣科技優息,71,5,66,富邦-宜蘭,2024-01-24,9686
00637L,元大滬深300正2,170,105,65,富邦-宜蘭,2024-01-24,9686
00882,中信中國高股息,64,0,64,富邦-宜蘭,2024-01-24,9686
3276,宇環,53,0,53,富邦-宜蘭,2024-01-24,9686
00877,復華中國5G,50,0,50,富邦-宜蘭,2024-01-24,9686
6116,彩晶,131,82,49,富邦-宜蘭,2024-01-24,9686
00679B,元大美債20年,42,0,42,富邦-宜蘭,2024-01-24,9686
00636,國泰中國A50,41,0,41,富邦-宜蘭,2024-01-24,9686
00934,中信成長高股息,50,12,38,富邦-宜蘭,2024-01-24,9686
00687B,國泰20年美債,35,0,35,富邦-宜蘭,2024-01-24,9686
8088,品安,34,2,32,富邦-宜蘭,2024-01-24,9686
2362,藍天,31,0,31,富邦-宜蘭,2024-01-24,9686
1453,大將,30,0,30,富邦-宜蘭,2024-01-24,9686
2618,長榮航,36,6,30,富邦-宜蘭,2024-01-24,9686
3059,華晶科,36,9,27,富邦-宜蘭,2024-01-24,9686
1517,利奇,25,0,25,富邦-宜蘭,2024-01-24,9686
2630,亞航,24,0,24,富邦-宜蘭,2024-01-24,9686
2002,中鋼,22,0,22,富邦-宜蘭,2024-01-24,9686
00753L,中信中國50正2,82,62,20,富邦-宜蘭,2024-01-24,9686
4934,太極,20,0,20,富邦-宜蘭,2024-01-24,9686
00720B,元大投資級公司債,21,2,19,富邦-宜蘭,2024-01-24,9686
00680L,元大美債20正2,19,0,19,富邦-宜蘭,2024-01-24,9686
00933B,國泰10Y+金融債,25,7,18,富邦-宜蘭,2024-01-24,9686
00725B,國泰投資級公司債,20,2,18,富邦-宜蘭,2024-01-24,9686
5521,工信,16,0,16,富邦-宜蘭,2024-01-24,9686
2484,希華,16,0,16,富邦-宜蘭,2024-01-24,9686
5351,鈺創,18,2,16,富邦-宜蘭,2024-01-24,9686
3149,正達,15,0,15,富邦-宜蘭,2024-01-24,9686
2610,華航,16,1,15,富邦-宜蘭,2024-01-24,9686
3490,單井,41,26,15,富邦-宜蘭,2024-01-24,9686
00902,中信電池及儲能,14,0,14,富邦-宜蘭,2024-01-24,9686
2329,華泰,34,20,14,富邦-宜蘭,2024-01-24,9686
2363,矽統,17,4,13,富邦-宜蘭,2024-01-24,9686
3025,星通,28,15,13,富邦-宜蘭,2024-01-24,9686
8027,鈦昇,25,12,13,富邦-宜蘭,2024-01-24,9686
6243,迅杰,19,6,13,富邦-宜蘭,2024-01-24,9686
2353,宏��,97,84,13,富邦-宜蘭,2024-01-24,9686
2382,廣達,16,4,12,富邦-宜蘭,2024-01-24,9686
00650L,復華香港正2,22,10,12,富邦-宜蘭,2024-01-24,9686
2515,中工,12,0,12,富邦-宜蘭,2024-01-24,9686
8096,擎亞,66,55,11,富邦-宜蘭,2024-01-24,9686
3037,欣興,11,0,11,富邦-宜蘭,2024-01-24,9686
1301,台塑,12,1,11,富邦-宜蘭,2024-01-24,9686
6152,百一,11,0,11,富邦-宜蘭,2024-01-24,9686
8105,凌巨,252,5,247,富邦-宜蘭,2024-01-25,9686
00937B,群益ESG投等債20,188,27,161,富邦-宜蘭,2024-01-25,9686
00673R,期元大S＆P原油反1,106,0,106,富邦-宜蘭,2024-01-25,9686
6667,信紘科,80,3,77,富邦-宜蘭,2024-01-25,9686
8096,擎亞,183,121,62,富邦-宜蘭,2024-01-25,9686
5426,振發,291,233,58,富邦-宜蘭,2024-01-25,9686
1452,宏益,133,83,50,富邦-宜蘭,2024-01-25,9686
3520,華盈,62,12,50,富邦-宜蘭,2024-01-25,9686
00687B,國泰20年美債,50,3,47,富邦-宜蘭,2024-01-25,9686
00919,群益台灣精選高息,98,54,44,富邦-宜蘭,2024-01-25,9686
2356,英業達,94,51,43,富邦-宜蘭,2024-01-25,9686
2618,長榮航,47,5,42,富邦-宜蘭,2024-01-25,9686
2323,中環,42,0,42,富邦-宜蘭,2024-01-25,9686
2312,金寶,50,10,40,富邦-宜蘭,2024-01-25,9686
00679B,元大美債20年,47,11,36,富邦-宜蘭,2024-01-25,9686
6167,久正,35,0,35,富邦-宜蘭,2024-01-25,9686
2609,陽明,46,13,33,富邦-宜蘭,2024-01-25,9686
4729,熒茂,55,26,29,富邦-宜蘭,2024-01-25,9686
00680L,元大美債20正2,28,0,28,富邦-宜蘭,2024-01-25,9686
2610,華航,26,0,26,富邦-宜蘭,2024-01-25,9686
3025,星通,37,11,26,富邦-宜蘭,2024-01-25,9686
8155,博智,31,6,25,富邦-宜蘭,2024-01-25,9686
6120,達運,26,1,25,富邦-宜蘭,2024-01-25,9686
3002,歐格,21,0,21,富邦-宜蘭,2024-01-25,9686
00905,FT臺灣Smart,27,6,21,富邦-宜蘭,2024-01-25,9686
2603,長榮,23,3,20,富邦-宜蘭,2024-01-25,9686
020029,元大ESG高股息N,20,0,20,富邦-宜蘭,2024-01-25,9686
3707,漢磊,20,0,20,富邦-宜蘭,2024-01-25,9686
00712,復華富時不動產,19,0,19,富邦-宜蘭,2024-01-25,9686
3231,緯創,95,77,18,富邦-宜蘭,2024-01-25,9686
6113,亞矽,71,53,18,富邦-宜蘭,2024-01-25,9686
1584,精剛,17,0,17,富邦-宜蘭,2024-01-25,9686
2007,燁興,17,0,17,富邦-宜蘭,2024-01-25,9686
00720B,元大投資級公司債,16,0,16,富邦-宜蘭,2024-01-25,9686
5478,智冠,28,12,16,富邦-宜蘭,2024-01-25,9686
2353,宏��,52,37,15,富邦-宜蘭,2024-01-25,9686
2486,一詮,34,20,14,富邦-宜蘭,2024-01-25,9686
6235,華孚,13,1,12,富邦-宜蘭,2024-01-25,9686
00933B,國泰10Y+金融債,12,0,12,富邦-宜蘭,2024-01-25,9686
2308,台達電,13,2,11,富邦-宜蘭,2024-01-25,9686
8034,榮群,29,18,11,富邦-宜蘭,2024-01-25,9686
5521,工信,17,6,11,富邦-宜蘭,2024-01-25,9686
6799,來頡,14,3,11,富邦-宜蘭,2024-01-25,9686
1612,宏泰,11,0,11,富邦-宜蘭,2024-01-25,9686
6916,華凌,11,0,11,富邦-宜蘭,2024-01-25,9686
00722B,群益投資級電信債,10,0,10,富邦-宜蘭,2024-01-25,9686
2615,萬海,11,1,10,富邦-宜蘭,2024-01-25,9686
2104,國際中橡,10,0,10,富邦-宜蘭,2024-01-25,9686
1528,恩德,13,3,10,富邦-宜蘭,2024-01-25,9686
2449,京元電子,12,2,10,富邦-宜蘭,2024-01-25,9686
00757,統一FANG+,319,8,311,富邦-宜蘭,2024-01-26,9686
2365,昆盈,273,69,204,富邦-宜蘭,2024-01-26,9686
00753L,中信中國50正2,235,42,193,富邦-宜蘭,2024-01-26,9686
2312,金寶,152,0,152,富邦-宜蘭,2024-01-26,9686
00919,群益台灣精選高息,154,51,103,富邦-宜蘭,2024-01-26,9686
6143,振曜,100,3,97,富邦-宜蘭,2024-01-26,9686
00933B,國泰10Y+金融債,108,20,88,富邦-宜蘭,2024-01-26,9686
2303,聯電,150,70,80,富邦-宜蘭,2024-01-26,9686
3490,單井,65,0,65,富邦-宜蘭,2024-01-26,9686
2359,所羅門,60,0,60,富邦-宜蘭,2024-01-26,9686
00902,中信電池及儲能,59,0,59,富邦-宜蘭,2024-01-26,9686
00673R,期元大S＆P原油反1,57,0,57,富邦-宜蘭,2024-01-26,9686
3535,晶彩科,82,25,57,富邦-宜蘭,2024-01-26,9686
8105,凌巨,90,33,57,富邦-宜蘭,2024-01-26,9686
00929,復華台灣科技優息,54,0,54,富邦-宜蘭,2024-01-26,9686
2353,宏��,85,39,46,富邦-宜蘭,2024-01-26,9686
2736,富野,44,0,44,富邦-宜蘭,2024-01-26,9686
3066,李洲,68,25,43,富邦-宜蘭,2024-01-26,9686
2344,華邦電,55,14,41,富邦-宜蘭,2024-01-26,9686
2892,第一金,39,1,38,富邦-宜蘭,2024-01-26,9686
6270,倍微,82,48,34,富邦-宜蘭,2024-01-26,9686
00937B,群益ESG投等債20,33,0,33,富邦-宜蘭,2024-01-26,9686
00676R,富邦臺灣加權反1,30,0,30,富邦-宜蘭,2024-01-26,9686
6165,浪凡,30,0,30,富邦-宜蘭,2024-01-26,9686
6229,研通,32,3,29,富邦-宜蘭,2024-01-26,9686
2324,仁寶,62,35,27,富邦-宜蘭,2024-01-26,9686
6167,久正,25,0,25,富邦-宜蘭,2024-01-26,9686
2417,圓剛,35,10,25,富邦-宜蘭,2024-01-26,9686
4167,松瑞藥,24,1,23,富邦-宜蘭,2024-01-26,9686
00927,群益半導體收益,22,0,22,富邦-宜蘭,2024-01-26,9686
1584,精剛,22,0,22,富邦-宜蘭,2024-01-26,9686
00918,大華優利高填息30,22,0,22,富邦-宜蘭,2024-01-26,9686
5328,華容,20,0,20,富邦-宜蘭,2024-01-26,9686
2453,凌群,20,0,20,富邦-宜蘭,2024-01-26,9686
3712,永崴投控,21,1,20,富邦-宜蘭,2024-01-26,9686
6785,昱展新藥,19,0,19,富邦-宜蘭,2024-01-26,9686
5469,瀚宇博,28,10,18,富邦-宜蘭,2024-01-26,9686
1432,大魯閣,20,2,18,富邦-宜蘭,2024-01-26,9686
6116,彩晶,46,28,18,富邦-宜蘭,2024-01-26,9686
8111,立��,21,3,18,富邦-宜蘭,2024-01-26,9686
6237,驊訊,19,2,17,富邦-宜蘭,2024-01-26,9686
8027,鈦昇,31,16,15,富邦-宜蘭,2024-01-26,9686
3607,谷崧,15,0,15,富邦-宜蘭,2024-01-26,9686
3360,尚立,94,79,15,富邦-宜蘭,2024-01-26,9686
2356,英業達,80,65,15,富邦-宜蘭,2024-01-26,9686
1514,亞力,25,11,14,富邦-宜蘭,2024-01-26,9686
9904,寶成,15,1,14,富邦-宜蘭,2024-01-26,9686
3037,欣興,16,2,14,富邦-宜蘭,2024-01-26,9686
6698,旭暉應材,18,5,13,富邦-宜蘭,2024-01-26,9686
00893,國泰智能電動車,13,0,13,富邦-宜蘭,2024-01-26,9686
00877,復華中國5G,155,0,155,富邦-宜蘭,2024-01-29,9686
5426,振發,144,30,114,富邦-宜蘭,2024-01-29,9686
2611,志信,100,0,100,富邦-宜蘭,2024-01-29,9686
2303,聯電,94,5,89,富邦-宜蘭,2024-01-29,9686
00937B,群益ESG投等債20,61,3,58,富邦-宜蘭,2024-01-29,9686
3128,昇銳,68,17,51,富邦-宜蘭,2024-01-29,9686
2337,旺宏,46,0,46,富邦-宜蘭,2024-01-29,9686
9904,寶成,46,1,45,富邦-宜蘭,2024-01-29,9686
00687B,國泰20年美債,45,1,44,富邦-宜蘭,2024-01-29,9686
4532,瑞智,38,0,38,富邦-宜蘭,2024-01-29,9686
2402,毅嘉,39,1,38,富邦-宜蘭,2024-01-29,9686
3360,尚立,118,80,38,富邦-宜蘭,2024-01-29,9686
2356,英業達,49,16,33,富邦-宜蘭,2024-01-29,9686
6405,悅城,32,0,32,富邦-宜蘭,2024-01-29,9686
1101,台泥,31,0,31,富邦-宜蘭,2024-01-29,9686
1452,宏益,89,60,29,富邦-宜蘭,2024-01-29,9686
6116,彩晶,29,0,29,富邦-宜蘭,2024-01-29,9686
00679B,元大美債20年,28,0,28,富邦-宜蘭,2024-01-29,9686
3066,李洲,39,12,27,富邦-宜蘭,2024-01-29,9686
00673R,期元大S＆P原油反1,33,6,27,富邦-宜蘭,2024-01-29,9686
3434,哲固,30,3,27,富邦-宜蘭,2024-01-29,9686
00751B,元大AAA至A公司債,25,0,25,富邦-宜蘭,2024-01-29,9686
8096,擎亞,56,31,25,富邦-宜蘭,2024-01-29,9686
00632R,元大台灣50反1,45,20,25,富邦-宜蘭,2024-01-29,9686
2359,所羅門,24,0,24,富邦-宜蘭,2024-01-29,9686
2324,仁寶,56,32,24,富邦-宜蘭,2024-01-29,9686
00931B,統一美債20年,22,0,22,富邦-宜蘭,2024-01-29,9686
4588,玖鼎電力,21,1,20,富邦-宜蘭,2024-01-29,9686
4414,如興,20,0,20,富邦-宜蘭,2024-01-29,9686
6113,亞矽,38,19,19,富邦-宜蘭,2024-01-29,9686
3622,洋華,27,8,19,富邦-宜蘭,2024-01-29,9686
00933B,國泰10Y+金融債,19,0,19,富邦-宜蘭,2024-01-29,9686
3605,宏致,49,31,18,富邦-宜蘭,2024-01-29,9686
00665L,富邦�琤肭磪囓�2,69,51,18,富邦-宜蘭,2024-01-29,9686
2355,敬鵬,18,0,18,富邦-宜蘭,2024-01-29,9686
1582,信錦,18,2,16,富邦-宜蘭,2024-01-29,9686
2610,華航,22,6,16,富邦-宜蘭,2024-01-29,9686
8034,榮群,14,0,14,富邦-宜蘭,2024-01-29,9686
1301,台塑,21,7,14,富邦-宜蘭,2024-01-29,9686
00753L,中信中國50正2,27,14,13,富邦-宜蘭,2024-01-29,9686
2603,長榮,13,0,13,富邦-宜蘭,2024-01-29,9686
1584,精剛,13,0,13,富邦-宜蘭,2024-01-29,9686
3047,訊舟,14,1,13,富邦-宜蘭,2024-01-29,9686
2867,三商壽,13,0,13,富邦-宜蘭,2024-01-29,9686
2409,友達,12,0,12,富邦-宜蘭,2024-01-29,9686
4906,正文,12,0,12,富邦-宜蘭,2024-01-29,9686
3231,緯創,68,55,13,富邦-宜蘭,2024-01-29,9686
6223,旺矽,12,0,12,富邦-宜蘭,2024-01-29,9686
2634,漢翔,21,9,12,富邦-宜蘭,2024-01-29,9686
4979,華星光,13,2,11,富邦-宜蘭,2024-01-29,9686
1312,國喬,200,0,200,富邦-宜蘭,2024-01-30,9686
00753L,中信中國50正2,216,20,196,富邦-宜蘭,2024-01-30,9686
2312,金寶,150,2,148,富邦-宜蘭,2024-01-30,9686
00637L,元大滬深300正2,128,5,123,富邦-宜蘭,2024-01-30,9686
00687B,國泰20年美債,109,10,99,富邦-宜蘭,2024-01-30,9686
3360,尚立,243,144,99,富邦-宜蘭,2024-01-30,9686
00650L,復華香港正2,93,0,93,富邦-宜蘭,2024-01-30,9686
3051,力特,61,1,60,富邦-宜蘭,2024-01-30,9686
00632R,元大台灣50反1,60,0,60,富邦-宜蘭,2024-01-30,9686
00882,中信中國高股息,60,0,60,富邦-宜蘭,2024-01-30,9686
2610,華航,56,0,56,富邦-宜蘭,2024-01-30,9686
8155,博智,55,0,55,富邦-宜蘭,2024-01-30,9686
00937B,群益ESG投等債20,56,2,54,富邦-宜蘭,2024-01-30,9686
5251,天鉞電,60,7,53,富邦-宜蘭,2024-01-30,9686
8064,東捷,46,1,45,富邦-宜蘭,2024-01-30,9686
6120,達運,54,12,42,富邦-宜蘭,2024-01-30,9686
2356,英業達,81,39,42,富邦-宜蘭,2024-01-30,9686
2337,旺宏,58,25,33,富邦-宜蘭,2024-01-30,9686
2233,宇隆,36,5,31,富邦-宜蘭,2024-01-30,9686
1711,永光,30,0,30,富邦-宜蘭,2024-01-30,9686
8059,凱碩,31,2,29,富邦-宜蘭,2024-01-30,9686
2609,陽明,33,11,22,富邦-宜蘭,2024-01-30,9686
1536,和大,21,0,21,富邦-宜蘭,2024-01-30,9686
5347,世界,21,0,21,富邦-宜蘭,2024-01-30,9686
00933B,國泰10Y+金融債,21,0,21,富邦-宜蘭,2024-01-30,9686
3715,定穎投控,74,54,20,富邦-宜蘭,2024-01-30,9686
3481,群創,75,56,19,富邦-宜蘭,2024-01-30,9686
2867,三商壽,24,5,19,富邦-宜蘭,2024-01-30,9686
3005,神基,19,1,18,富邦-宜蘭,2024-01-30,9686
2606,裕民,20,2,18,富邦-宜蘭,2024-01-30,9686
4167,松瑞藥,18,0,18,富邦-宜蘭,2024-01-30,9686
8210,勤誠,21,4,17,富邦-宜蘭,2024-01-30,9686
2409,友達,32,16,16,富邦-宜蘭,2024-01-30,9686
5880,合庫金,15,0,15,富邦-宜蘭,2024-01-30,9686
3211,順達,15,0,15,富邦-宜蘭,2024-01-30,9686
2241,艾姆勒,16,1,15,富邦-宜蘭,2024-01-30,9686
3321,同泰,14,0,14,富邦-宜蘭,2024-01-30,9686
2344,華邦電,15,1,14,富邦-宜蘭,2024-01-30,9686
00929,復華台灣科技優息,15,2,13,富邦-宜蘭,2024-01-30,9686
6243,迅杰,30,17,13,富邦-宜蘭,2024-01-30,9686
8444,綠河-KY,13,0,13,富邦-宜蘭,2024-01-30,9686
8085,福華,13,0,13,富邦-宜蘭,2024-01-30,9686
2363,矽統,12,0,12,富邦-宜蘭,2024-01-30,9686
2421,建準,38,26,12,富邦-宜蘭,2024-01-30,9686
3376,新日興,16,4,12,富邦-宜蘭,2024-01-30,9686
2103,台橡,12,0,12,富邦-宜蘭,2024-01-30,9686
00885,富邦越南,12,0,12,富邦-宜蘭,2024-01-30,9686
6111,大宇資,12,0,12,富邦-宜蘭,2024-01-30,9686
1101,台泥,11,0,11,富邦-宜蘭,2024-01-30,9686
6235,華孚,11,0,11,富邦-宜蘭,2024-01-30,9686
3360,尚立,151,35,116,富邦-宜蘭,2024-01-31,9686
8155,博智,83,0,83,富邦-宜蘭,2024-01-31,9686
00650L,復華香港正2,77,0,77,富邦-宜蘭,2024-01-31,9686
3231,緯創,78,2,76,富邦-宜蘭,2024-01-31,9686
00673R,期元大S＆P原油反1,75,0,75,富邦-宜蘭,2024-01-31,9686
1529,樂事綠能,65,3,62,富邦-宜蘭,2024-01-31,9686
00753L,中信中國50正2,76,23,53,富邦-宜蘭,2024-01-31,9686
2002,中鋼,54,1,53,富邦-宜蘭,2024-01-31,9686
00882,中信中國高股息,50,0,50,富邦-宜蘭,2024-01-31,9686
1418,東華,51,1,50,富邦-宜蘭,2024-01-31,9686
2312,金寶,50,0,50,富邦-宜蘭,2024-01-31,9686
6134,萬旭,50,0,50,富邦-宜蘭,2024-01-31,9686
8473,山林水,41,0,41,富邦-宜蘭,2024-01-31,9686
6770,力積電,50,10,40,富邦-宜蘭,2024-01-31,9686
8080,印鉐,40,0,40,富邦-宜蘭,2024-01-31,9686
2330,台積電,44,9,35,富邦-宜蘭,2024-01-31,9686
6140,訊達,40,6,34,富邦-宜蘭,2024-01-31,9686
00665L,富邦�琤肭磪囓�2,32,0,32,富邦-宜蘭,2024-01-31,9686
00933B,國泰10Y+金融債,35,5,30,富邦-宜蘭,2024-01-31,9686
3055,蔚華科,34,6,28,富邦-宜蘭,2024-01-31,9686
6120,達運,43,17,26,富邦-宜蘭,2024-01-31,9686
2340,台亞,22,0,22,富邦-宜蘭,2024-01-31,9686
6206,飛捷,22,0,22,富邦-宜蘭,2024-01-31,9686
2515,中工,21,0,21,富邦-宜蘭,2024-01-31,9686
1514,亞力,25,5,20,富邦-宜蘭,2024-01-31,9686
1752,南光,20,0,20,富邦-宜蘭,2024-01-31,9686
00752,中信中國50,20,0,20,富邦-宜蘭,2024-01-31,9686
2606,裕民,20,1,19,富邦-宜蘭,2024-01-31,9686
2609,陽明,66,47,19,富邦-宜蘭,2024-01-31,9686
2882,國泰金,20,2,18,富邦-宜蘭,2024-01-31,9686
2356,英業達,62,44,18,富邦-宜蘭,2024-01-31,9686
00751B,元大AAA至A公司債,17,0,17,富邦-宜蘭,2024-01-31,9686
2884,玉山金,19,2,17,富邦-宜蘭,2024-01-31,9686
2303,聯電,29,13,16,富邦-宜蘭,2024-01-31,9686
2301,光寶科,17,2,15,富邦-宜蘭,2024-01-31,9686
2399,映泰,15,0,15,富邦-宜蘭,2024-01-31,9686
00687B,國泰20年美債,24,9,15,富邦-宜蘭,2024-01-31,9686
2412,中華電,14,0,14,富邦-宜蘭,2024-01-31,9686
00680L,元大美債20正2,16,2,14,富邦-宜蘭,2024-01-31,9686
2344,華邦電,13,0,13,富邦-宜蘭,2024-01-31,9686
2883,凱基金,14,1,13,富邦-宜蘭,2024-01-31,9686
2363,矽統,13,1,12,富邦-宜蘭,2024-01-31,9686
2308,台達電,12,0,12,富邦-宜蘭,2024-01-31,9686
1326,台化,12,1,11,富邦-宜蘭,2024-01-31,9686
2323,中環,11,0,11,富邦-宜蘭,2024-01-31,9686
4912,聯德控股-KY,10,0,10,富邦-宜蘭,2024-01-31,9686
3038,全台,10,0,10,富邦-宜蘭,2024-01-31,9686
4440,宜新實業,10,0,10,富邦-宜蘭,2024-01-31,9686
4588,玖鼎電力,11,1,10,富邦-宜蘭,2024-01-31,9686
9940,信義,10,0,10,富邦-宜蘭,2024-01-31,9686
5512,力麒,140,15,125,富邦-宜蘭,2024-02-01,9686
00929,復華台灣科技優息,120,2,118,富邦-宜蘭,2024-02-01,9686
00878,國泰永續高股息,130,19,111,富邦-宜蘭,2024-02-01,9686
3704,合勤控,61,1,60,富邦-宜蘭,2024-02-01,9686
1418,東華,60,10,50,富邦-宜蘭,2024-02-01,9686
2409,友達,55,8,47,富邦-宜蘭,2024-02-01,9686
00712,復華富時不動產,47,0,47,富邦-宜蘭,2024-02-01,9686
4933,友輝,36,0,36,富邦-宜蘭,2024-02-01,9686
8155,博智,34,0,34,富邦-宜蘭,2024-02-01,9686
3313,斐成,30,0,30,富邦-宜蘭,2024-02-01,9686
8011,台通,39,10,29,富邦-宜蘭,2024-02-01,9686
00927,群益半導體收益,27,0,27,富邦-宜蘭,2024-02-01,9686
3041,揚智,38,11,27,富邦-宜蘭,2024-02-01,9686
3308,聯德,26,1,25,富邦-宜蘭,2024-02-01,9686
8936,國統,40,16,24,富邦-宜蘭,2024-02-01,9686
3543,州巧,24,1,23,富邦-宜蘭,2024-02-01,9686
2356,英業達,40,17,23,富邦-宜蘭,2024-02-01,9686
2812,台中銀,73,51,22,富邦-宜蘭,2024-02-01,9686
3297,杭特,26,4,22,富邦-宜蘭,2024-02-01,9686
8080,印鉐,21,0,21,富邦-宜蘭,2024-02-01,9686
00887,永豐中國科技50大,20,0,20,富邦-宜蘭,2024-02-01,9686
6122,擎邦,26,6,20,富邦-宜蘭,2024-02-01,9686
2443,昶虹,20,0,20,富邦-宜蘭,2024-02-01,9686
00673R,期元大S＆P原油反1,20,0,20,富邦-宜蘭,2024-02-01,9686
3548,兆利,24,5,19,富邦-宜蘭,2024-02-01,9686
2618,長榮航,52,34,18,富邦-宜蘭,2024-02-01,9686
2329,華泰,70,53,17,富邦-宜蘭,2024-02-01,9686
3481,群創,31,15,16,富邦-宜蘭,2024-02-01,9686
00687B,國泰20年美債,47,31,16,富邦-宜蘭,2024-02-01,9686
2881,富邦金,16,1,15,富邦-宜蘭,2024-02-01,9686
2211,長榮鋼,15,0,15,富邦-宜蘭,2024-02-01,9686
3576,聯合再生,15,0,15,富邦-宜蘭,2024-02-01,9686
3033,威健,29,14,15,富邦-宜蘭,2024-02-01,9686
1444,力麗,13,0,13,富邦-宜蘭,2024-02-01,9686
00882,中信中國高股息,13,0,13,富邦-宜蘭,2024-02-01,9686
6116,彩晶,14,1,13,富邦-宜蘭,2024-02-01,9686
1504,東元,16,4,12,富邦-宜蘭,2024-02-01,9686
00904,新光臺灣半導體30,12,0,12,富邦-宜蘭,2024-02-01,9686
2382,廣達,17,6,11,富邦-宜蘭,2024-02-01,9686
6240,松崗,11,0,11,富邦-宜蘭,2024-02-01,9686
2486,一詮,76,66,10,富邦-宜蘭,2024-02-01,9686
2405,輔信,10,0,10,富邦-宜蘭,2024-02-01,9686
3434,哲固,11,1,10,富邦-宜蘭,2024-02-01,9686
00922,國泰台灣領袖50,10,0,10,富邦-宜蘭,2024-02-01,9686
00664R,國泰臺灣加權反1,10,0,10,富邦-宜蘭,2024-02-01,9686
4513,福裕,10,0,10,富邦-宜蘭,2024-02-01,9686
1514,亞力,21,11,10,富邦-宜蘭,2024-02-01,9686
2330,台積電,15,6,9,富邦-宜蘭,2024-02-01,9686
2337,旺宏,11,2,9,富邦-宜蘭,2024-02-01,9686
6271,同欣電,10,1,9,富邦-宜蘭,2024-02-01,9686
00757,統一FANG+,179,0,179,富邦-宜蘭,2024-02-02,9686
2303,聯電,158,10,148,富邦-宜蘭,2024-02-02,9686
00919,群益台灣精選高息,143,17,126,富邦-宜蘭,2024-02-02,9686
2609,陽明,102,31,71,富邦-宜蘭,2024-02-02,9686
9904,寶成,64,0,64,富邦-宜蘭,2024-02-02,9686
8034,榮群,70,11,59,富邦-宜蘭,2024-02-02,9686
3535,晶彩科,66,12,54,富邦-宜蘭,2024-02-02,9686
00933B,國泰10Y+金融債,52,0,52,富邦-宜蘭,2024-02-02,9686
3230,錦明,50,0,50,富邦-宜蘭,2024-02-02,9686
2324,仁寶,74,25,49,富邦-宜蘭,2024-02-02,9686
6425,易發,53,5,48,富邦-宜蘭,2024-02-02,9686
00637L,元大滬深300正2,54,8,46,富邦-宜蘭,2024-02-02,9686
00929,復華台灣科技優息,53,8,45,富邦-宜蘭,2024-02-02,9686
00937B,群益ESG投等債20,80,36,44,富邦-宜蘭,2024-02-02,9686
2606,裕民,42,2,40,富邦-宜蘭,2024-02-02,9686
6806,森崴能源,39,1,38,富邦-宜蘭,2024-02-02,9686
00712,復華富時不動產,85,50,35,富邦-宜蘭,2024-02-02,9686
4906,正文,33,0,33,富邦-宜蘭,2024-02-02,9686
1528,恩德,39,6,33,富邦-宜蘭,2024-02-02,9686
00900,富邦特選高股息30,36,4,32,富邦-宜蘭,2024-02-02,9686
3313,斐成,30,0,30,富邦-宜蘭,2024-02-02,9686
3321,同泰,29,0,29,富邦-宜蘭,2024-02-02,9686
3294,英濟,31,3,28,富邦-宜蘭,2024-02-02,9686
2603,長榮,38,11,27,富邦-宜蘭,2024-02-02,9686
1536,和大,26,0,26,富邦-宜蘭,2024-02-02,9686
3481,群創,28,2,26,富邦-宜蘭,2024-02-02,9686
6785,昱展新藥,21,0,21,富邦-宜蘭,2024-02-02,9686
2313,華通,34,13,21,富邦-宜蘭,2024-02-02,9686
5272,笙科,41,20,21,富邦-宜蘭,2024-02-02,9686
2423,固緯,21,0,21,富邦-宜蘭,2024-02-02,9686
2408,南亞科,20,0,20,富邦-宜蘭,2024-02-02,9686
00857B,永豐20年美公債,20,0,20,富邦-宜蘭,2024-02-02,9686
8067,志旭,20,0,20,富邦-宜蘭,2024-02-02,9686
1514,亞力,29,11,18,富邦-宜蘭,2024-02-02,9686
2390,云辰,89,71,18,富邦-宜蘭,2024-02-02,9686
00882,中信中國高股息,16,0,16,富邦-宜蘭,2024-02-02,9686
6770,力積電,28,13,15,富邦-宜蘭,2024-02-02,9686
00676R,富邦臺灣加權反1,15,0,15,富邦-宜蘭,2024-02-02,9686
2250,IKKA-KY,15,0,15,富邦-宜蘭,2024-02-02,9686
2344,華邦電,28,13,15,富邦-宜蘭,2024-02-02,9686
00753L,中信中國50正2,345,331,14,富邦-宜蘭,2024-02-02,9686
3712,永崴投控,20,6,14,富邦-宜蘭,2024-02-02,9686
2317,鴻海,21,7,14,富邦-宜蘭,2024-02-02,9686
00688L,國泰20年美債正2,15,2,13,富邦-宜蘭,2024-02-02,9686
5439,高技,14,1,13,富邦-宜蘭,2024-02-02,9686
2329,華泰,69,56,13,富邦-宜蘭,2024-02-02,9686
3694,海華,23,10,13,富邦-宜蘭,2024-02-02,9686
1560,中砂,14,2,12,富邦-宜蘭,2024-02-02,9686
3268,海德威,12,0,12,富邦-宜蘭,2024-02-02,9686
5314,世紀,13,1,12,富邦-宜蘭,2024-02-02,9686
00937B,群益ESG投等債20,239,71,168,富邦-宜蘭,2024-02-05,9686
2312,金寶,110,1,109,富邦-宜蘭,2024-02-05,9686
00688L,國泰20年美債正2,106,0,106,富邦-宜蘭,2024-02-05,9686
00877,復華中國5G,101,0,101,富邦-宜蘭,2024-02-05,9686
2025,千興,95,18,77,富邦-宜蘭,2024-02-05,9686
2324,仁寶,78,2,76,富邦-宜蘭,2024-02-05,9686
00919,群益台灣精選高息,78,3,75,富邦-宜蘭,2024-02-05,9686
00679B,元大美債20年,70,8,62,富邦-宜蘭,2024-02-05,9686
2915,潤泰全,61,0,61,富邦-宜蘭,2024-02-05,9686
00712,復華富時不動產,54,0,54,富邦-宜蘭,2024-02-05,9686
2303,聯電,72,24,48,富邦-宜蘭,2024-02-05,9686
4306,炎洲,46,0,46,富邦-宜蘭,2024-02-05,9686
00687B,國泰20年美債,49,5,44,富邦-宜蘭,2024-02-05,9686
6770,力積電,43,0,43,富邦-宜蘭,2024-02-05,9686
6695,芯鼎,59,16,43,富邦-宜蘭,2024-02-05,9686
00891,中信關鍵半導體,41,1,40,富邦-宜蘭,2024-02-05,9686
6584,南俊國際,41,1,40,富邦-宜蘭,2024-02-05,9686
1720,生達,38,0,38,富邦-宜蘭,2024-02-05,9686
6265,方土昶,44,6,38,富邦-宜蘭,2024-02-05,9686
00931B,統一美債20年,36,0,36,富邦-宜蘭,2024-02-05,9686
00929,復華台灣科技優息,52,19,33,富邦-宜蘭,2024-02-05,9686
6425,易發,50,17,33,富邦-宜蘭,2024-02-05,9686
2363,矽統,34,2,32,富邦-宜蘭,2024-02-05,9686
3607,谷崧,55,24,31,富邦-宜蘭,2024-02-05,9686
00632R,元大台灣50反1,50,20,30,富邦-宜蘭,2024-02-05,9686
3576,聯合再生,30,1,29,富邦-宜蘭,2024-02-05,9686
00882,中信中國高股息,38,10,28,富邦-宜蘭,2024-02-05,9686
00900,富邦特選高股息30,34,6,28,富邦-宜蘭,2024-02-05,9686
5351,鈺創,42,15,27,富邦-宜蘭,2024-02-05,9686
00715L,期街口布蘭特正2,31,4,27,富邦-宜蘭,2024-02-05,9686
3055,蔚華科,26,0,26,富邦-宜蘭,2024-02-05,9686
00680L,元大美債20正2,25,0,25,富邦-宜蘭,2024-02-05,9686
00878,國泰永續高股息,46,21,25,富邦-宜蘭,2024-02-05,9686
3481,群創,172,148,24,富邦-宜蘭,2024-02-05,9686
2002,中鋼,22,0,22,富邦-宜蘭,2024-02-05,9686
1528,恩德,98,76,22,富邦-宜蘭,2024-02-05,9686
1609,大亞,26,5,21,富邦-宜蘭,2024-02-05,9686
6116,彩晶,22,1,21,富邦-宜蘭,2024-02-05,9686
00690,兆豐藍籌30,20,0,20,富邦-宜蘭,2024-02-05,9686
00665L,富邦�琤肭磪囓�2,20,0,20,富邦-宜蘭,2024-02-05,9686
3376,新日興,117,97,20,富邦-宜蘭,2024-02-05,9686
00933B,國泰10Y+金融債,23,4,19,富邦-宜蘭,2024-02-05,9686
3675,德微,28,9,19,富邦-宜蘭,2024-02-05,9686
2884,玉山金,30,11,19,富邦-宜蘭,2024-02-05,9686
2421,建準,76,57,19,富邦-宜蘭,2024-02-05,9686
6270,倍微,20,2,18,富邦-宜蘭,2024-02-05,9686
1319,東陽,19,1,18,富邦-宜蘭,2024-02-05,9686
6667,信紘科,17,0,17,富邦-宜蘭,2024-02-05,9686
6122,擎邦,17,0,17,富邦-宜蘭,2024-02-05,9686
3380,明泰,25,10,15,富邦-宜蘭,2024-02-05,9686
00937B,群益ESG投等債20,749,165,584,富邦-宜蘭,2024-02-15,9686
5457,宣德,251,0,251,富邦-宜蘭,2024-02-15,9686
00673R,期元大S＆P原油反1,242,0,242,富邦-宜蘭,2024-02-15,9686
00680L,元大美債20正2,156,3,153,富邦-宜蘭,2024-02-15,9686
00632R,元大台灣50反1,298,163,135,富邦-宜蘭,2024-02-15,9686
00688L,國泰20年美債正2,116,5,111,富邦-宜蘭,2024-02-15,9686
00712,復華富時不動產,107,0,107,富邦-宜蘭,2024-02-15,9686
00679B,元大美債20年,88,5,83,富邦-宜蘭,2024-02-15,9686
00751B,元大AAA至A公司債,81,5,76,富邦-宜蘭,2024-02-15,9686
2312,金寶,70,0,70,富邦-宜蘭,2024-02-15,9686
00720B,元大投資級公司債,77,8,69,富邦-宜蘭,2024-02-15,9686
4127,天良,53,0,53,富邦-宜蘭,2024-02-15,9686
00931B,統一美債20年,50,0,50,富邦-宜蘭,2024-02-15,9686
1504,東元,61,15,46,富邦-宜蘭,2024-02-15,9686
2408,南亞科,44,0,44,富邦-宜蘭,2024-02-15,9686
00929,復華台灣科技優息,53,13,40,富邦-宜蘭,2024-02-15,9686
5521,工信,39,0,39,富邦-宜蘭,2024-02-15,9686
00687B,國泰20年美債,61,23,38,富邦-宜蘭,2024-02-15,9686
8240,華宏,38,3,35,富邦-宜蘭,2024-02-15,9686
2344,華邦電,47,13,34,富邦-宜蘭,2024-02-15,9686
6245,立端,34,1,33,富邦-宜蘭,2024-02-15,9686
00907,永豐優息存股,30,0,30,富邦-宜蘭,2024-02-15,9686
8096,擎亞,32,2,30,富邦-宜蘭,2024-02-15,9686
1514,亞力,60,32,28,富邦-宜蘭,2024-02-15,9686
2353,宏��,38,11,27,富邦-宜蘭,2024-02-15,9686
3535,晶彩科,30,4,26,富邦-宜蘭,2024-02-15,9686
2618,長榮航,49,25,24,富邦-宜蘭,2024-02-15,9686
5452,佶優,24,0,24,富邦-宜蘭,2024-02-15,9686
4714,永捷,55,31,24,富邦-宜蘭,2024-02-15,9686
2313,華通,29,5,24,富邦-宜蘭,2024-02-15,9686
2356,英業達,148,125,23,富邦-宜蘭,2024-02-15,9686
00664R,國泰臺灣加權反1,22,0,22,富邦-宜蘭,2024-02-15,9686
6176,瑞儀,21,0,21,富邦-宜蘭,2024-02-15,9686
2834,臺企銀,21,0,21,富邦-宜蘭,2024-02-15,9686
3234,光環,21,0,21,富邦-宜蘭,2024-02-15,9686
2610,華航,32,12,20,富邦-宜蘭,2024-02-15,9686
00795B,中信美國公債20年,20,0,20,富邦-宜蘭,2024-02-15,9686
9904,寶成,20,0,20,富邦-宜蘭,2024-02-15,9686
1402,遠東新,20,0,20,富邦-宜蘭,2024-02-15,9686
6180,橘子,21,1,20,富邦-宜蘭,2024-02-15,9686
3532,台勝科,19,0,19,富邦-宜蘭,2024-02-15,9686
1536,和大,20,1,19,富邦-宜蘭,2024-02-15,9686
00690,兆豐藍籌30,19,1,18,富邦-宜蘭,2024-02-15,9686
6716,應廣,18,0,18,富邦-宜蘭,2024-02-15,9686
2405,輔信,50,32,18,富邦-宜蘭,2024-02-15,9686
9945,潤泰新,16,0,16,富邦-宜蘭,2024-02-15,9686
3712,永崴投控,18,2,16,富邦-宜蘭,2024-02-15,9686
1319,東陽,29,13,16,富邦-宜蘭,2024-02-15,9686
2603,長榮,41,26,15,富邦-宜蘭,2024-02-15,9686
2464,盟立,15,0,15,富邦-宜蘭,2024-02-15,9686
5457,宣德,255,0,255,富邦-宜蘭,2024-02-16,9686
00680L,元大美債20正2,90,0,90,富邦-宜蘭,2024-02-16,9686
00933B,國泰10Y+金融債,80,0,80,富邦-宜蘭,2024-02-16,9686
8089,康全電訊,69,10,59,富邦-宜蘭,2024-02-16,9686
00751B,元大AAA至A公司債,61,3,58,富邦-宜蘭,2024-02-16,9686
2618,長榮航,101,43,58,富邦-宜蘭,2024-02-16,9686
00632R,元大台灣50反1,55,1,54,富邦-宜蘭,2024-02-16,9686
3231,緯創,97,48,49,富邦-宜蘭,2024-02-16,9686
00679B,元大美債20年,50,3,47,富邦-宜蘭,2024-02-16,9686
1806,冠軍,50,6,44,富邦-宜蘭,2024-02-16,9686
4956,光鋐,45,1,44,富邦-宜蘭,2024-02-16,9686
3481,群創,131,88,43,富邦-宜蘭,2024-02-16,9686
5521,工信,52,12,40,富邦-宜蘭,2024-02-16,9686
00772B,中信高評級公司債,50,11,39,富邦-宜蘭,2024-02-16,9686
2355,敬鵬,48,10,38,富邦-宜蘭,2024-02-16,9686
00882,中信中國高股息,47,10,37,富邦-宜蘭,2024-02-16,9686
3380,明泰,35,0,35,富邦-宜蘭,2024-02-16,9686
00687B,國泰20年美債,35,0,35,富邦-宜蘭,2024-02-16,9686
2303,聯電,36,2,34,富邦-宜蘭,2024-02-16,9686
3047,訊舟,43,9,34,富邦-宜蘭,2024-02-16,9686
00905,FT臺灣Smart,32,0,32,富邦-宜蘭,2024-02-16,9686
3516,亞帝歐,30,0,30,富邦-宜蘭,2024-02-16,9686
4543,萬在,33,3,30,富邦-宜蘭,2024-02-16,9686
1101,台泥,31,2,29,富邦-宜蘭,2024-02-16,9686
2206,三陽工業,40,13,27,富邦-宜蘭,2024-02-16,9686
1339,昭輝,26,0,26,富邦-宜蘭,2024-02-16,9686
00673R,期元大S＆P原油反1,32,7,25,富邦-宜蘭,2024-02-16,9686
2408,南亞科,25,1,24,富邦-宜蘭,2024-02-16,9686
2888,新光金,26,2,24,富邦-宜蘭,2024-02-16,9686
2382,廣達,74,51,23,富邦-宜蘭,2024-02-16,9686
6139,亞翔,23,1,22,富邦-宜蘭,2024-02-16,9686
3715,定穎投控,22,2,20,富邦-宜蘭,2024-02-16,9686
3522,御嵿,20,0,20,富邦-宜蘭,2024-02-16,9686
9940,信義,20,0,20,富邦-宜蘭,2024-02-16,9686
00931B,統一美債20年,27,9,18,富邦-宜蘭,2024-02-16,9686
00720B,元大投資級公司債,19,1,18,富邦-宜蘭,2024-02-16,9686
2884,玉山金,20,2,18,富邦-宜蘭,2024-02-16,9686
2330,台積電,23,6,17,富邦-宜蘭,2024-02-16,9686
00937B,群益ESG投等債20,110,93,17,富邦-宜蘭,2024-02-16,9686
00795B,中信美國公債20年,16,0,16,富邦-宜蘭,2024-02-16,9686
3576,聯合再生,16,0,16,富邦-宜蘭,2024-02-16,9686
3535,晶彩科,16,0,16,富邦-宜蘭,2024-02-16,9686
4916,事欣科,20,4,16,富邦-宜蘭,2024-02-16,9686
6605,帝寶,18,2,16,富邦-宜蘭,2024-02-16,9686
2409,友達,17,2,15,富邦-宜蘭,2024-02-16,9686
2887,台新金,17,2,15,富邦-宜蘭,2024-02-16,9686
8050,廣積,14,0,14,富邦-宜蘭,2024-02-16,9686
2367,燿華,37,23,14,富邦-宜蘭,2024-02-16,9686
3372,典範,15,1,14,富邦-宜蘭,2024-02-16,9686
00878,國泰永續高股息,61,47,14,富邦-宜蘭,2024-02-16,9686
2867,三商壽,260,4,256,富邦-宜蘭,2024-02-19,9686
2888,新光金,254,40,214,富邦-宜蘭,2024-02-19,9686
2489,瑞軒,183,14,169,富邦-宜蘭,2024-02-19,9686
00937B,群益ESG投等債20,166,3,163,富邦-宜蘭,2024-02-19,9686
00673R,期元大S＆P原油反1,112,0,112,富邦-宜蘭,2024-02-19,9686
00637L,元大滬深300正2,115,14,101,富邦-宜蘭,2024-02-19,9686
2611,志信,97,3,94,富邦-宜蘭,2024-02-19,9686
1409,新纖,78,0,78,富邦-宜蘭,2024-02-19,9686
00679B,元大美債20年,76,0,76,富邦-宜蘭,2024-02-19,9686
2356,英業達,99,27,72,富邦-宜蘭,2024-02-19,9686
00919,群益台灣精選高息,91,26,65,富邦-宜蘭,2024-02-19,9686
00933B,國泰10Y+金融債,63,2,61,富邦-宜蘭,2024-02-19,9686
1513,中興電,79,26,53,富邦-宜蘭,2024-02-19,9686
2312,金寶,52,4,48,富邦-宜蘭,2024-02-19,9686
3231,緯創,79,35,44,富邦-宜蘭,2024-02-19,9686
6288,聯嘉,47,5,42,富邦-宜蘭,2024-02-19,9686
1314,中石化,41,0,41,富邦-宜蘭,2024-02-19,9686
00878,國泰永續高股息,59,21,38,富邦-宜蘭,2024-02-19,9686
00665L,富邦�琤肭磪囓�2,37,1,36,富邦-宜蘭,2024-02-19,9686
1806,冠軍,49,14,35,富邦-宜蘭,2024-02-19,9686
3313,斐成,33,0,33,富邦-宜蘭,2024-02-19,9686
8089,康全電訊,35,2,33,富邦-宜蘭,2024-02-19,9686
2369,菱生,116,84,32,富邦-宜蘭,2024-02-19,9686
2402,毅嘉,32,0,32,富邦-宜蘭,2024-02-19,9686
00720B,元大投資級公司債,44,12,32,富邦-宜蘭,2024-02-19,9686
3516,亞帝歐,30,1,29,富邦-宜蘭,2024-02-19,9686
1319,東陽,31,3,28,富邦-宜蘭,2024-02-19,9686
6274,台燿,46,20,26,富邦-宜蘭,2024-02-19,9686
3437,榮創,73,50,23,富邦-宜蘭,2024-02-19,9686
2002,中鋼,24,1,23,富邦-宜蘭,2024-02-19,9686
2355,敬鵬,36,14,22,富邦-宜蘭,2024-02-19,9686
2382,廣達,29,7,22,富邦-宜蘭,2024-02-19,9686
2353,宏��,88,67,21,富邦-宜蘭,2024-02-19,9686
3047,訊舟,44,24,20,富邦-宜蘭,2024-02-19,9686
2014,中鴻,19,0,19,富邦-宜蘭,2024-02-19,9686
00751B,元大AAA至A公司債,19,0,19,富邦-宜蘭,2024-02-19,9686
5426,振發,46,28,18,富邦-宜蘭,2024-02-19,9686
3715,定穎投控,18,2,16,富邦-宜蘭,2024-02-19,9686
3227,原相,28,12,16,富邦-宜蘭,2024-02-19,9686
6668,中揚光,22,6,16,富邦-宜蘭,2024-02-19,9686
6282,康舒,34,18,16,富邦-宜蘭,2024-02-19,9686
3035,智原,34,19,15,富邦-宜蘭,2024-02-19,9686
6126,信音,21,6,15,富邦-宜蘭,2024-02-19,9686
6789,采鈺,19,5,14,富邦-宜蘭,2024-02-19,9686
5443,均豪,39,25,14,富邦-宜蘭,2024-02-19,9686
00891,中信關鍵半導體,19,5,14,富邦-宜蘭,2024-02-19,9686
2362,藍天,15,1,14,富邦-宜蘭,2024-02-19,9686
00753L,中信中國50正2,15,1,14,富邦-宜蘭,2024-02-19,9686
2409,友達,29,15,14,富邦-宜蘭,2024-02-19,9686
1589,永冠-KY,13,0,13,富邦-宜蘭,2024-02-19,9686
2312,金寶,300,7,293,富邦-宜蘭,2024-02-20,9686
4714,永捷,273,88,185,富邦-宜蘭,2024-02-20,9686
2405,輔信,253,70,183,富邦-宜蘭,2024-02-20,9686
00937B,群益ESG投等債20,187,28,159,富邦-宜蘭,2024-02-20,9686
3607,谷崧,113,13,100,富邦-宜蘭,2024-02-20,9686
3231,緯創,119,33,86,富邦-宜蘭,2024-02-20,9686
3481,群創,253,182,71,富邦-宜蘭,2024-02-20,9686
2399,映泰,75,9,66,富邦-宜蘭,2024-02-20,9686
2882,國泰金,63,1,62,富邦-宜蘭,2024-02-20,9686
00720B,元大投資級公司債,59,0,59,富邦-宜蘭,2024-02-20,9686
1316,上曜,60,7,53,富邦-宜蘭,2024-02-20,9686
2402,毅嘉,53,2,51,富邦-宜蘭,2024-02-20,9686
00632R,元大台灣50反1,51,0,51,富邦-宜蘭,2024-02-20,9686
00676R,富邦臺灣加權反1,50,0,50,富邦-宜蘭,2024-02-20,9686
3041,揚智,164,118,46,富邦-宜蘭,2024-02-20,9686
00933B,國泰10Y+金融債,52,10,42,富邦-宜蘭,2024-02-20,9686
2365,昆盈,70,31,39,富邦-宜蘭,2024-02-20,9686
00665L,富邦�琤肭磪囓�2,40,1,39,富邦-宜蘭,2024-02-20,9686
8110,華東,75,37,38,富邦-宜蘭,2024-02-20,9686
00882,中信中國高股息,37,0,37,富邦-宜蘭,2024-02-20,9686
2355,敬鵬,51,17,34,富邦-宜蘭,2024-02-20,9686
00673R,期元大S＆P原油反1,34,0,34,富邦-宜蘭,2024-02-20,9686
1414,東和,33,1,32,富邦-宜蘭,2024-02-20,9686
2605,新興,51,20,31,富邦-宜蘭,2024-02-20,9686
00679B,元大美債20年,34,3,31,富邦-宜蘭,2024-02-20,9686
2610,華航,35,5,30,富邦-宜蘭,2024-02-20,9686
3313,斐成,30,0,30,富邦-宜蘭,2024-02-20,9686
2329,華泰,134,104,30,富邦-宜蘭,2024-02-20,9686
5009,榮剛,25,0,25,富邦-宜蘭,2024-02-20,9686
00877,復華中國5G,27,3,24,富邦-宜蘭,2024-02-20,9686
6126,信音,26,3,23,富邦-宜蘭,2024-02-20,9686
5403,中菲,22,0,22,富邦-宜蘭,2024-02-20,9686
8064,東捷,54,32,22,富邦-宜蘭,2024-02-20,9686
9103,美德醫療-DR,22,0,22,富邦-宜蘭,2024-02-20,9686
00929,復華台灣科技優息,83,61,22,富邦-宜蘭,2024-02-20,9686
3002,歐格,22,1,21,富邦-宜蘭,2024-02-20,9686
2801,彰銀,20,0,20,富邦-宜蘭,2024-02-20,9686
9907,統一實,20,0,20,富邦-宜蘭,2024-02-20,9686
4960,誠美材,27,8,19,富邦-宜蘭,2024-02-20,9686
00878,國泰永續高股息,51,32,19,富邦-宜蘭,2024-02-20,9686
2367,燿華,44,26,18,富邦-宜蘭,2024-02-20,9686
2344,華邦電,21,3,18,富邦-宜蘭,2024-02-20,9686
1528,恩德,18,1,17,富邦-宜蘭,2024-02-20,9686
6139,亞翔,18,2,16,富邦-宜蘭,2024-02-20,9686
00857B,永豐20年美公債,15,0,15,富邦-宜蘭,2024-02-20,9686
2618,長榮航,15,1,14,富邦-宜蘭,2024-02-20,9686
2537,聯上發,14,0,14,富邦-宜蘭,2024-02-20,9686
8011,台通,16,2,14,富邦-宜蘭,2024-02-20,9686
1319,東陽,28,15,13,富邦-宜蘭,2024-02-20,9686
3047,訊舟,28,15,13,富邦-宜蘭,2024-02-20,9686
00878,國泰永續高股息,272,38,234,富邦-宜蘭,2024-02-21,9686
3047,訊舟,327,112,215,富邦-宜蘭,2024-02-21,9686
1528,恩德,221,7,214,富邦-宜蘭,2024-02-21,9686
2312,金寶,211,18,193,富邦-宜蘭,2024-02-21,9686
2303,聯電,143,5,138,富邦-宜蘭,2024-02-21,9686
2609,陽明,164,31,133,富邦-宜蘭,2024-02-21,9686
3041,揚智,139,24,115,富邦-宜蘭,2024-02-21,9686
6770,力積電,117,4,113,富邦-宜蘭,2024-02-21,9686
00637L,元大滬深300正2,329,232,97,富邦-宜蘭,2024-02-21,9686
6282,康舒,100,4,96,富邦-宜蘭,2024-02-21,9686
4729,熒茂,73,10,63,富邦-宜蘭,2024-02-21,9686
5443,均豪,95,33,62,富邦-宜蘭,2024-02-21,9686
00673R,期元大S＆P原油反1,60,0,60,富邦-宜蘭,2024-02-21,9686
00937B,群益ESG投等債20,78,23,55,富邦-宜蘭,2024-02-21,9686
3481,群創,157,107,50,富邦-宜蘭,2024-02-21,9686
1609,大亞,50,5,45,富邦-宜蘭,2024-02-21,9686
6265,方土昶,41,1,40,富邦-宜蘭,2024-02-21,9686
00712,復華富時不動產,40,1,39,富邦-宜蘭,2024-02-21,9686
6206,飛捷,36,0,36,富邦-宜蘭,2024-02-21,9686
3593,力銘,35,0,35,富邦-宜蘭,2024-02-21,9686
00933B,國泰10Y+金融債,34,0,34,富邦-宜蘭,2024-02-21,9686
3066,李洲,33,0,33,富邦-宜蘭,2024-02-21,9686
1314,中石化,31,0,31,富邦-宜蘭,2024-02-21,9686
6288,聯嘉,31,0,31,富邦-宜蘭,2024-02-21,9686
3581,博磊,24,0,24,富邦-宜蘭,2024-02-21,9686
3265,台星科,26,2,24,富邦-宜蘭,2024-02-21,9686
2834,臺企銀,23,0,23,富邦-宜蘭,2024-02-21,9686
910861,神州-DR,23,0,23,富邦-宜蘭,2024-02-21,9686
1702,南僑,41,18,23,富邦-宜蘭,2024-02-21,9686
00919,群益台灣精選高息,195,174,21,富邦-宜蘭,2024-02-21,9686
3715,定穎投控,34,13,21,富邦-宜蘭,2024-02-21,9686
3035,智原,27,6,21,富邦-宜蘭,2024-02-21,9686
8936,國統,95,75,20,富邦-宜蘭,2024-02-21,9686
2890,永豐金,20,0,20,富邦-宜蘭,2024-02-21,9686
5381,合正,58,39,19,富邦-宜蘭,2024-02-21,9686
3055,蔚華科,143,125,18,富邦-宜蘭,2024-02-21,9686
8039,台虹,18,0,18,富邦-宜蘭,2024-02-21,9686
6189,豐藝,20,2,18,富邦-宜蘭,2024-02-21,9686
8110,華東,33,15,18,富邦-宜蘭,2024-02-21,9686
00666R,富邦�琤肭磪齯�1,17,0,17,富邦-宜蘭,2024-02-21,9686
6112,邁達特,16,0,16,富邦-宜蘭,2024-02-21,9686
1815,富喬,41,25,16,富邦-宜蘭,2024-02-21,9686
00891,中信關鍵半導體,16,0,16,富邦-宜蘭,2024-02-21,9686
2547,日勝生,53,38,15,富邦-宜蘭,2024-02-21,9686
0056,元大高股息,35,21,14,富邦-宜蘭,2024-02-21,9686
3321,同泰,24,10,14,富邦-宜蘭,2024-02-21,9686
1731,美吾華,14,0,14,富邦-宜蘭,2024-02-21,9686
3339,泰谷,25,11,14,富邦-宜蘭,2024-02-21,9686
3051,力特,15,1,14,富邦-宜蘭,2024-02-21,9686
3231,緯創,64,50,14,富邦-宜蘭,2024-02-21,9686
5512,力麒,251,1,250,富邦-宜蘭,2024-02-22,9686
00937B,群益ESG投等債20,259,51,208,富邦-宜蘭,2024-02-22,9686
00933B,國泰10Y+金融債,116,1,115,富邦-宜蘭,2024-02-22,9686
2801,彰銀,100,0,100,富邦-宜蘭,2024-02-22,9686
2543,皇昌,104,13,91,富邦-宜蘭,2024-02-22,9686
9105,泰金寶-DR,84,7,77,富邦-宜蘭,2024-02-22,9686
2303,聯電,72,0,72,富邦-宜蘭,2024-02-22,9686
3706,神達,81,18,63,富邦-宜蘭,2024-02-22,9686
3607,谷崧,77,14,63,富邦-宜蘭,2024-02-22,9686
00878,國泰永續高股息,69,12,57,富邦-宜蘭,2024-02-22,9686
2884,玉山金,52,0,52,富邦-宜蘭,2024-02-22,9686
2369,菱生,138,87,51,富邦-宜蘭,2024-02-22,9686
3481,群創,103,61,42,富邦-宜蘭,2024-02-22,9686
4534,慶騰,50,8,42,富邦-宜蘭,2024-02-22,9686
2371,大同,55,14,41,富邦-宜蘭,2024-02-22,9686
2356,英業達,73,32,41,富邦-宜蘭,2024-02-22,9686
2484,希華,51,10,41,富邦-宜蘭,2024-02-22,9686
6451,訊芯-KY,73,39,34,富邦-宜蘭,2024-02-22,9686
4960,誠美材,33,0,33,富邦-宜蘭,2024-02-22,9686
6425,易發,72,40,32,富邦-宜蘭,2024-02-22,9686
2365,昆盈,37,6,31,富邦-宜蘭,2024-02-22,9686
1319,東陽,35,5,30,富邦-宜蘭,2024-02-22,9686
3402,漢科,35,5,30,富邦-宜蘭,2024-02-22,9686
1339,昭輝,30,0,30,富邦-宜蘭,2024-02-22,9686
00712,復華富時不動產,30,0,30,富邦-宜蘭,2024-02-22,9686
3231,緯創,90,61,29,富邦-宜蘭,2024-02-22,9686
6116,彩晶,28,0,28,富邦-宜蘭,2024-02-22,9686
8936,國統,56,30,26,富邦-宜蘭,2024-02-22,9686
8011,台通,32,6,26,富邦-宜蘭,2024-02-22,9686
6139,亞翔,28,2,26,富邦-宜蘭,2024-02-22,9686
6269,台郡,25,0,25,富邦-宜蘭,2024-02-22,9686
3293,鈊象,22,0,22,富邦-宜蘭,2024-02-22,9686
2453,凌群,20,0,20,富邦-宜蘭,2024-02-22,9686
2641,正德,20,0,20,富邦-宜蘭,2024-02-22,9686
3230,錦明,20,0,20,富邦-宜蘭,2024-02-22,9686
00679B,元大美債20年,21,1,20,富邦-宜蘭,2024-02-22,9686
5351,鈺創,22,3,19,富邦-宜蘭,2024-02-22,9686
6799,來頡,22,3,19,富邦-宜蘭,2024-02-22,9686
3221,台嘉碩,23,6,17,富邦-宜蘭,2024-02-22,9686
1316,上曜,26,9,17,富邦-宜蘭,2024-02-22,9686
1809,中釉,52,35,17,富邦-宜蘭,2024-02-22,9686
4563,百德,17,0,17,富邦-宜蘭,2024-02-22,9686
5531,鄉林,17,0,17,富邦-宜蘭,2024-02-22,9686
4909,新復興,32,15,17,富邦-宜蘭,2024-02-22,9686
9802,鈺齊-KY,21,5,16,富邦-宜蘭,2024-02-22,9686
8064,東捷,67,51,16,富邦-宜蘭,2024-02-22,9686
2610,華航,16,1,15,富邦-宜蘭,2024-02-22,9686
00857B,永豐20年美公債,15,0,15,富邦-宜蘭,2024-02-22,9686
8054,安國,16,1,15,富邦-宜蘭,2024-02-22,9686
00687B,國泰20年美債,14,0,14,富邦-宜蘭,2024-02-22,9686
3481,群創,373,165,208,富邦-宜蘭,2024-02-23,9686
4707,磐亞,200,0,200,富邦-宜蘭,2024-02-23,9686
00937B,群益ESG投等債20,164,0,164,富邦-宜蘭,2024-02-23,9686
5457,宣德,150,1,149,富邦-宜蘭,2024-02-23,9686
1316,上曜,182,37,145,富邦-宜蘭,2024-02-23,9686
00919,群益台灣精選高息,234,119,115,富邦-宜蘭,2024-02-23,9686
3712,永崴投控,109,33,76,富邦-宜蘭,2024-02-23,9686
00680L,元大美債20正2,70,0,70,富邦-宜蘭,2024-02-23,9686
5315,光聯,65,0,65,富邦-宜蘭,2024-02-23,9686
1522,堤維西,67,4,63,富邦-宜蘭,2024-02-23,9686
3231,緯創,94,32,62,富邦-宜蘭,2024-02-23,9686
2303,聯電,61,1,60,富邦-宜蘭,2024-02-23,9686
2369,菱生,75,16,59,富邦-宜蘭,2024-02-23,9686
5452,佶優,60,1,59,富邦-宜蘭,2024-02-23,9686
00753L,中信中國50正2,51,0,51,富邦-宜蘭,2024-02-23,9686
2356,英業達,100,52,48,富邦-宜蘭,2024-02-23,9686
2353,宏��,62,19,43,富邦-宜蘭,2024-02-23,9686
00900,富邦特選高股息30,49,5,44,富邦-宜蘭,2024-02-23,9686
2609,陽明,139,97,42,富邦-宜蘭,2024-02-23,9686
2324,仁寶,52,11,41,富邦-宜蘭,2024-02-23,9686
00712,復華富時不動產,52,12,40,富邦-宜蘭,2024-02-23,9686
5009,榮剛,37,0,37,富邦-宜蘭,2024-02-23,9686
00905,FT臺灣Smart,36,0,36,富邦-宜蘭,2024-02-23,9686
2313,華通,294,259,35,富邦-宜蘭,2024-02-23,9686
8047,星雲,34,0,34,富邦-宜蘭,2024-02-23,9686
2630,亞航,33,3,30,富邦-宜蘭,2024-02-23,9686
8240,華宏,30,0,30,富邦-宜蘭,2024-02-23,9686
00878,國泰永續高股息,71,43,28,富邦-宜蘭,2024-02-23,9686
3535,晶彩科,41,17,24,富邦-宜蘭,2024-02-23,9686
2801,彰銀,26,3,23,富邦-宜蘭,2024-02-23,9686
1603,華電,25,2,23,富邦-宜蘭,2024-02-23,9686
3479,安勤,32,10,22,富邦-宜蘭,2024-02-23,9686
00720B,元大投資級公司債,22,0,22,富邦-宜蘭,2024-02-23,9686
6443,元晶,22,1,21,富邦-宜蘭,2024-02-23,9686
2486,一詮,30,9,21,富邦-宜蘭,2024-02-23,9686
6165,浪凡,24,3,21,富邦-宜蘭,2024-02-23,9686
5880,合庫金,21,1,20,富邦-宜蘭,2024-02-23,9686
2498,宏達電,21,1,20,富邦-宜蘭,2024-02-23,9686
3715,定穎投控,43,24,19,富邦-宜蘭,2024-02-23,9686
4534,慶騰,20,2,18,富邦-宜蘭,2024-02-23,9686
2208,台船,20,3,17,富邦-宜蘭,2024-02-23,9686
00795B,中信美國公債20年,17,0,17,富邦-宜蘭,2024-02-23,9686
2887,台新金,17,0,17,富邦-宜蘭,2024-02-23,9686
1717,長興,32,15,17,富邦-宜蘭,2024-02-23,9686
2542,興富發,16,0,16,富邦-宜蘭,2024-02-23,9686
6141,柏承,21,5,16,富邦-宜蘭,2024-02-23,9686
2449,京元電子,36,21,15,富邦-宜蘭,2024-02-23,9686
2603,長榮,22,7,15,富邦-宜蘭,2024-02-23,9686
6189,豐藝,25,10,15,富邦-宜蘭,2024-02-23,9686
00687B,國泰20年美債,15,0,15,富邦-宜蘭,2024-02-23,9686
00933B,國泰10Y+金融債,248,14,234,富邦-宜蘭,2024-02-26,9686
00665L,富邦�琤肭磪囓�2,224,0,224,富邦-宜蘭,2024-02-26,9686
00878,國泰永續高股息,202,22,180,富邦-宜蘭,2024-02-26,9686
1609,大亞,143,11,132,富邦-宜蘭,2024-02-26,9686
3481,群創,181,77,104,富邦-宜蘭,2024-02-26,9686
5457,宣德,100,0,100,富邦-宜蘭,2024-02-26,9686
2349,錸德,100,3,97,富邦-宜蘭,2024-02-26,9686
00929,復華台灣科技優息,162,76,86,富邦-宜蘭,2024-02-26,9686
2495,普安,65,4,61,富邦-宜蘭,2024-02-26,9686
00679B,元大美債20年,64,5,59,富邦-宜蘭,2024-02-26,9686
00687B,國泰20年美債,70,11,59,富邦-宜蘭,2024-02-26,9686
00937B,群益ESG投等債20,115,61,54,富邦-宜蘭,2024-02-26,9686
1718,中纖,50,0,50,富邦-宜蘭,2024-02-26,9686
2610,華航,51,1,50,富邦-宜蘭,2024-02-26,9686
6141,柏承,56,6,50,富邦-宜蘭,2024-02-26,9686
2609,陽明,63,24,39,富邦-宜蘭,2024-02-26,9686
2405,輔信,120,84,36,富邦-宜蘭,2024-02-26,9686
3313,斐成,32,0,32,富邦-宜蘭,2024-02-26,9686
00905,FT臺灣Smart,32,0,32,富邦-宜蘭,2024-02-26,9686
3025,星通,49,17,32,富邦-宜蘭,2024-02-26,9686
3706,神達,35,5,30,富邦-宜蘭,2024-02-26,9686
4127,天良,30,0,30,富邦-宜蘭,2024-02-26,9686
6265,方土昶,33,3,30,富邦-宜蘭,2024-02-26,9686
00919,群益台灣精選高息,143,113,30,富邦-宜蘭,2024-02-26,9686
5009,榮剛,30,2,28,富邦-宜蘭,2024-02-26,9686
00891,中信關鍵半導體,27,2,25,富邦-宜蘭,2024-02-26,9686
2371,大同,63,38,25,富邦-宜蘭,2024-02-26,9686
2369,菱生,70,45,25,富邦-宜蘭,2024-02-26,9686
8064,東捷,32,7,25,富邦-宜蘭,2024-02-26,9686
1710,東聯,23,0,23,富邦-宜蘭,2024-02-26,9686
2440,太空梭,24,2,22,富邦-宜蘭,2024-02-26,9686
2211,長榮鋼,21,0,21,富邦-宜蘭,2024-02-26,9686
8011,台通,27,6,21,富邦-宜蘭,2024-02-26,9686
00795B,中信美國公債20年,21,0,21,富邦-宜蘭,2024-02-26,9686
2329,華泰,52,32,20,富邦-宜蘭,2024-02-26,9686
1504,東元,26,6,20,富邦-宜蘭,2024-02-26,9686
2014,中鴻,19,0,19,富邦-宜蘭,2024-02-26,9686
3325,旭品,16,0,16,富邦-宜蘭,2024-02-26,9686
00751B,元大AAA至A公司債,20,4,16,富邦-宜蘭,2024-02-26,9686
4102,永日,15,0,15,富邦-宜蘭,2024-02-26,9686
6168,宏齊,18,4,14,富邦-宜蘭,2024-02-26,9686
2489,瑞軒,19,5,14,富邦-宜蘭,2024-02-26,9686
2206,三陽工業,17,3,14,富邦-宜蘭,2024-02-26,9686
00696B,富邦美債20年,14,0,14,富邦-宜蘭,2024-02-26,9686
4588,玖鼎電力,22,8,14,富邦-宜蘭,2024-02-26,9686
1513,中興電,64,51,13,富邦-宜蘭,2024-02-26,9686
2352,佳世達,15,2,13,富邦-宜蘭,2024-02-26,9686
2303,聯電,23,10,13,富邦-宜蘭,2024-02-26,9686
2617,台航,13,1,12,富邦-宜蘭,2024-02-26,9686
3702,大聯大,12,0,12,富邦-宜蘭,2024-02-26,9686
2888,新光金,287,1,286,富邦-宜蘭,2024-02-27,9686
00878,國泰永續高股息,277,20,257,富邦-宜蘭,2024-02-27,9686
2867,三商壽,205,0,205,富邦-宜蘭,2024-02-27,9686
1314,中石化,155,0,155,富邦-宜蘭,2024-02-27,9686
00937B,群益ESG投等債20,226,87,139,富邦-宜蘭,2024-02-27,9686
00632R,元大台灣50反1,77,0,77,富邦-宜蘭,2024-02-27,9686
3037,欣興,81,10,71,富邦-宜蘭,2024-02-27,9686
00679B,元大美債20年,73,4,69,富邦-宜蘭,2024-02-27,9686
5315,光聯,68,0,68,富邦-宜蘭,2024-02-27,9686
6667,信紘科,66,2,64,富邦-宜蘭,2024-02-27,9686
00919,群益台灣精選高息,188,125,63,富邦-宜蘭,2024-02-27,9686
2484,希華,65,6,59,富邦-宜蘭,2024-02-27,9686
3231,緯創,95,38,57,富邦-宜蘭,2024-02-27,9686
3704,合勤控,62,6,56,富邦-宜蘭,2024-02-27,9686
5457,宣德,54,0,54,富邦-宜蘭,2024-02-27,9686
00933B,國泰10Y+金融債,53,0,53,富邦-宜蘭,2024-02-27,9686
6167,久正,57,5,52,富邦-宜蘭,2024-02-27,9686
00905,FT臺灣Smart,51,0,51,富邦-宜蘭,2024-02-27,9686
3211,順達,50,0,50,富邦-宜蘭,2024-02-27,9686
2408,南亞科,46,3,43,富邦-宜蘭,2024-02-27,9686
6120,達運,43,0,43,富邦-宜蘭,2024-02-27,9686
3450,聯鈞,64,23,41,富邦-宜蘭,2024-02-27,9686
00897,富邦基因免疫生技,40,2,38,富邦-宜蘭,2024-02-27,9686
8024,佑華,40,4,36,富邦-宜蘭,2024-02-27,9686
2301,光寶科,51,15,36,富邦-宜蘭,2024-02-27,9686
00795B,中信美國公債20年,35,0,35,富邦-宜蘭,2024-02-27,9686
2371,大同,36,3,33,富邦-宜蘭,2024-02-27,9686
6233,旺玖,88,55,33,富邦-宜蘭,2024-02-27,9686
1776,展宇,30,0,30,富邦-宜蘭,2024-02-27,9686
3516,亞帝歐,30,0,30,富邦-宜蘭,2024-02-27,9686
4157,太景*-KY,29,0,29,富邦-宜蘭,2024-02-27,9686
3041,揚智,32,4,28,富邦-宜蘭,2024-02-27,9686
1514,亞力,73,45,28,富邦-宜蘭,2024-02-27,9686
4513,福裕,27,0,27,富邦-宜蘭,2024-02-27,9686
3360,尚立,29,2,27,富邦-宜蘭,2024-02-27,9686
1301,台塑,26,0,26,富邦-宜蘭,2024-02-27,9686
8105,凌巨,36,10,26,富邦-宜蘭,2024-02-27,9686
2359,所羅門,30,4,26,富邦-宜蘭,2024-02-27,9686
1101,台泥,26,0,26,富邦-宜蘭,2024-02-27,9686
00927,群益半導體收益,25,0,25,富邦-宜蘭,2024-02-27,9686
2362,藍天,26,1,25,富邦-宜蘭,2024-02-27,9686
8088,品安,27,2,25,富邦-宜蘭,2024-02-27,9686
00751B,元大AAA至A公司債,28,4,24,富邦-宜蘭,2024-02-27,9686
8096,擎亞,33,9,24,富邦-宜蘭,2024-02-27,9686
2002,中鋼,35,11,24,富邦-宜蘭,2024-02-27,9686
00687B,國泰20年美債,25,1,24,富邦-宜蘭,2024-02-27,9686
00712,復華富時不動產,32,9,23,富邦-宜蘭,2024-02-27,9686
3481,群創,251,229,22,富邦-宜蘭,2024-02-27,9686
5425,台半,26,5,21,富邦-宜蘭,2024-02-27,9686
6770,力積電,29,8,21,富邦-宜蘭,2024-02-27,9686
00772B,中信高評級公司債,200,0,200,富邦-宜蘭,2024-02-29,9686
00937B,群益ESG投等債20,201,6,195,富邦-宜蘭,2024-02-29,9686
1460,宏遠,126,0,126,富邦-宜蘭,2024-02-29,9686
5457,宣德,107,0,107,富邦-宜蘭,2024-02-29,9686
1455,集盛,100,0,100,富邦-宜蘭,2024-02-29,9686
2834,臺企銀,100,12,88,富邦-宜蘭,2024-02-29,9686
1314,中石化,87,1,86,富邦-宜蘭,2024-02-29,9686
2641,正德,103,17,86,富邦-宜蘭,2024-02-29,9686
2889,國票金,64,6,58,富邦-宜蘭,2024-02-29,9686
4960,誠美材,58,1,57,富邦-宜蘭,2024-02-29,9686
5452,佶優,126,72,54,富邦-宜蘭,2024-02-29,9686
00676R,富邦臺灣加權反1,50,0,50,富邦-宜蘭,2024-02-29,9686
3712,永崴投控,56,8,48,富邦-宜蘭,2024-02-29,9686
2329,華泰,116,68,48,富邦-宜蘭,2024-02-29,9686
6141,柏承,50,6,44,富邦-宜蘭,2024-02-29,9686
3576,聯合再生,42,1,41,富邦-宜蘭,2024-02-29,9686
00673R,期元大S＆P原油反1,41,0,41,富邦-宜蘭,2024-02-29,9686
8047,星雲,46,5,41,富邦-宜蘭,2024-02-29,9686
3312,弘憶股,40,1,39,富邦-宜蘭,2024-02-29,9686
00929,復華台灣科技優息,58,22,36,富邦-宜蘭,2024-02-29,9686
4303,信立,33,3,30,富邦-宜蘭,2024-02-29,9686
1524,耿鼎,107,78,29,富邦-宜蘭,2024-02-29,9686
00878,國泰永續高股息,54,26,28,富邦-宜蘭,2024-02-29,9686
4543,萬在,32,3,29,富邦-宜蘭,2024-02-29,9686
3265,台星科,26,0,26,富邦-宜蘭,2024-02-29,9686
5529,鉅陞,26,0,26,富邦-宜蘭,2024-02-29,9686
00665L,富邦�琤肭磪囓�2,26,0,26,富邦-宜蘭,2024-02-29,9686
2362,藍天,24,0,24,富邦-宜蘭,2024-02-29,9686
3481,群創,122,99,23,富邦-宜蘭,2024-02-29,9686
2313,華通,34,11,23,富邦-宜蘭,2024-02-29,9686
6116,彩晶,23,0,23,富邦-宜蘭,2024-02-29,9686
3360,尚立,26,3,23,富邦-宜蘭,2024-02-29,9686
8473,山林水,23,1,22,富邦-宜蘭,2024-02-29,9686
3058,立德,42,20,22,富邦-宜蘭,2024-02-29,9686
2820,華票,21,0,21,富邦-宜蘭,2024-02-29,9686
5383,金利,20,0,20,富邦-宜蘭,2024-02-29,9686
6120,達運,20,0,20,富邦-宜蘭,2024-02-29,9686
2104,國際中橡,20,0,20,富邦-宜蘭,2024-02-29,9686
5202,力新,19,0,19,富邦-宜蘭,2024-02-29,9686
00679B,元大美債20年,19,0,19,富邦-宜蘭,2024-02-29,9686
1727,中華化,59,41,18,富邦-宜蘭,2024-02-29,9686
00632R,元大台灣50反1,58,40,18,富邦-宜蘭,2024-02-29,9686
00934,中信成長高股息,20,2,18,富邦-宜蘭,2024-02-29,9686
2331,精英,21,3,18,富邦-宜蘭,2024-02-29,9686
1101,台泥,24,6,18,富邦-宜蘭,2024-02-29,9686
2605,新興,22,5,17,富邦-宜蘭,2024-02-29,9686
6233,旺玖,41,24,17,富邦-宜蘭,2024-02-29,9686
2405,輔信,26,9,17,富邦-宜蘭,2024-02-29,9686
3055,蔚華科,24,7,17,富邦-宜蘭,2024-02-29,9686
1303,南亞,17,0,17,富邦-宜蘭,2024-02-29,9686
00919,群益台灣精選高息,426,74,352,富邦-宜蘭,2024-03-01,9686
2367,燿華,225,37,188,富邦-宜蘭,2024-03-01,9686
00937B,群益ESG投等債20,211,52,159,富邦-宜蘭,2024-03-01,9686
3372,典範,155,62,93,富邦-宜蘭,2024-03-01,9686
00772B,中信高評級公司債,120,30,90,富邦-宜蘭,2024-03-01,9686
2399,映泰,133,65,68,富邦-宜蘭,2024-03-01,9686
3312,弘憶股,54,3,51,富邦-宜蘭,2024-03-01,9686
8033,雷虎,50,0,50,富邦-宜蘭,2024-03-01,9686
8080,印鉐,50,0,50,富邦-宜蘭,2024-03-01,9686
5315,光聯,60,10,50,富邦-宜蘭,2024-03-01,9686
1711,永光,50,1,49,富邦-宜蘭,2024-03-01,9686
1513,中興電,84,36,48,富邦-宜蘭,2024-03-01,9686
4303,信立,47,7,40,富邦-宜蘭,2024-03-01,9686
2882,國泰金,47,10,37,富邦-宜蘭,2024-03-01,9686
2601,益航,35,0,35,富邦-宜蘭,2024-03-01,9686
3322,建舜電,34,1,33,富邦-宜蘭,2024-03-01,9686
8110,華東,32,0,32,富邦-宜蘭,2024-03-01,9686
2609,陽明,62,36,26,富邦-宜蘭,2024-03-01,9686
2409,友達,27,1,26,富邦-宜蘭,2024-03-01,9686
2883,凱基金,35,9,26,富邦-宜蘭,2024-03-01,9686
1618,合機,71,47,24,富邦-宜蘭,2024-03-01,9686
6168,宏齊,25,2,23,富邦-宜蘭,2024-03-01,9686
00885,富邦越南,23,1,22,富邦-宜蘭,2024-03-01,9686
1308,亞聚,21,0,21,富邦-宜蘭,2024-03-01,9686
00673R,期元大S＆P原油反1,20,0,20,富邦-宜蘭,2024-03-01,9686
006205,富邦上証,20,0,20,富邦-宜蘭,2024-03-01,9686
00918,大華優利高填息30,63,43,20,富邦-宜蘭,2024-03-01,9686
4939,亞電,20,0,20,富邦-宜蘭,2024-03-01,9686
4414,如興,20,0,20,富邦-宜蘭,2024-03-01,9686
2303,聯電,30,10,20,富邦-宜蘭,2024-03-01,9686
00687B,國泰20年美債,20,1,19,富邦-宜蘭,2024-03-01,9686
6770,力積電,26,7,19,富邦-宜蘭,2024-03-01,9686
5529,鉅陞,18,0,18,富邦-宜蘭,2024-03-01,9686
00922,國泰台灣領袖50,18,0,18,富邦-宜蘭,2024-03-01,9686
6233,旺玖,20,2,18,富邦-宜蘭,2024-03-01,9686
2451,創見,22,5,17,富邦-宜蘭,2024-03-01,9686
2323,中環,20,3,17,富邦-宜蘭,2024-03-01,9686
2356,英業達,74,58,16,富邦-宜蘭,2024-03-01,9686
3706,神達,20,4,16,富邦-宜蘭,2024-03-01,9686
2206,三陽工業,78,62,16,富邦-宜蘭,2024-03-01,9686
4906,正文,16,0,16,富邦-宜蘭,2024-03-01,9686
3588,通嘉,29,14,15,富邦-宜蘭,2024-03-01,9686
6176,瑞儀,21,6,15,富邦-宜蘭,2024-03-01,9686
1524,耿鼎,16,1,15,富邦-宜蘭,2024-03-01,9686
6244,茂迪,18,3,15,富邦-宜蘭,2024-03-01,9686
6257,矽格,15,0,15,富邦-宜蘭,2024-03-01,9686
2431,聯昌,15,0,15,富邦-宜蘭,2024-03-01,9686
2329,華泰,56,41,15,富邦-宜蘭,2024-03-01,9686
2355,敬鵬,15,1,14,富邦-宜蘭,2024-03-01,9686
5452,佶優,29,15,14,富邦-宜蘭,2024-03-01,9686
2489,瑞軒,291,0,291,富邦-宜蘭,2024-03-04,9686
00937B,群益ESG投等債20,167,22,145,富邦-宜蘭,2024-03-04,9686
2332,友訊,109,11,98,富邦-宜蘭,2024-03-04,9686
2887,台新金,105,20,85,富邦-宜蘭,2024-03-04,9686
6127,九豪,85,0,85,富邦-宜蘭,2024-03-04,9686
2002,中鋼,71,1,70,富邦-宜蘭,2024-03-04,9686
00918,大華優利高填息30,97,27,70,富邦-宜蘭,2024-03-04,9686
2883,凱基金,82,18,64,富邦-宜蘭,2024-03-04,9686
6218,豪勉,65,2,63,富邦-宜蘭,2024-03-04,9686
1909,榮成,56,0,56,富邦-宜蘭,2024-03-04,9686
2312,金寶,57,1,56,富邦-宜蘭,2024-03-04,9686
1609,大亞,57,1,56,富邦-宜蘭,2024-03-04,9686
00632R,元大台灣50反1,86,31,55,富邦-宜蘭,2024-03-04,9686
2485,兆赫,56,2,54,富邦-宜蘭,2024-03-04,9686
3059,華晶科,52,0,52,富邦-宜蘭,2024-03-04,9686
1101,台泥,59,11,48,富邦-宜蘭,2024-03-04,9686
00919,群益台灣精選高息,246,201,45,富邦-宜蘭,2024-03-04,9686
00933B,國泰10Y+金融債,48,6,42,富邦-宜蘭,2024-03-04,9686
00673R,期元大S＆P原油反1,42,0,42,富邦-宜蘭,2024-03-04,9686
2888,新光金,82,41,41,富邦-宜蘭,2024-03-04,9686
1514,亞力,178,138,40,富邦-宜蘭,2024-03-04,9686
2305,全友,94,55,39,富邦-宜蘭,2024-03-04,9686
6282,康舒,45,7,38,富邦-宜蘭,2024-03-04,9686
2610,華航,40,3,37,富邦-宜蘭,2024-03-04,9686
5340,建榮,35,0,35,富邦-宜蘭,2024-03-04,9686
1513,中興電,62,27,35,富邦-宜蘭,2024-03-04,9686
00712,復華富時不動產,76,41,35,富邦-宜蘭,2024-03-04,9686
2543,皇昌,44,11,33,富邦-宜蘭,2024-03-04,9686
6770,力積電,49,17,32,富邦-宜蘭,2024-03-04,9686
6139,亞翔,57,26,31,富邦-宜蘭,2024-03-04,9686
2365,昆盈,46,15,31,富邦-宜蘭,2024-03-04,9686
3645,達邁,36,5,31,富邦-宜蘭,2024-03-04,9686
1308,亞聚,30,0,30,富邦-宜蘭,2024-03-04,9686
8105,凌巨,40,13,27,富邦-宜蘭,2024-03-04,9686
1301,台塑,27,0,27,富邦-宜蘭,2024-03-04,9686
2421,建準,29,3,26,富邦-宜蘭,2024-03-04,9686
00915,凱基優選高股息30,26,0,26,富邦-宜蘭,2024-03-04,9686
2464,盟立,27,1,26,富邦-宜蘭,2024-03-04,9686
2609,陽明,81,55,26,富邦-宜蘭,2024-03-04,9686
4543,萬在,55,30,25,富邦-宜蘭,2024-03-04,9686
5009,榮剛,25,0,25,富邦-宜蘭,2024-03-04,9686
8383,千附,33,10,23,富邦-宜蘭,2024-03-04,9686
3005,神基,50,27,23,富邦-宜蘭,2024-03-04,9686
6806,森崴能源,33,12,21,富邦-宜蘭,2024-03-04,9686
6901,鑽石投資,21,0,21,富邦-宜蘭,2024-03-04,9686
6125,廣運,36,15,21,富邦-宜蘭,2024-03-04,9686
2354,鴻準,24,3,21,富邦-宜蘭,2024-03-04,9686
2104,國際中橡,21,0,21,富邦-宜蘭,2024-03-04,9686
1217,愛之味,20,0,20,富邦-宜蘭,2024-03-04,9686
8024,佑華,21,1,20,富邦-宜蘭,2024-03-04,9686
00632R,元大台灣50反1,266,7,259,富邦-宜蘭,2024-03-05,9686
00937B,群益ESG投等債20,168,2,166,富邦-宜蘭,2024-03-05,9686
2324,仁寶,158,14,144,富邦-宜蘭,2024-03-05,9686
00712,復華富時不動產,142,2,140,富邦-宜蘭,2024-03-05,9686
3312,弘憶股,112,7,105,富邦-宜蘭,2024-03-05,9686
00915,凱基優選高股息30,100,0,100,富邦-宜蘭,2024-03-05,9686
2888,新光金,144,50,94,富邦-宜蘭,2024-03-05,9686
00919,群益台灣精選高息,208,118,90,富邦-宜蘭,2024-03-05,9686
3481,群創,316,228,88,富邦-宜蘭,2024-03-05,9686
2409,友達,113,33,80,富邦-宜蘭,2024-03-05,9686
6109,亞元,51,0,51,富邦-宜蘭,2024-03-05,9686
1316,上曜,90,42,48,富邦-宜蘭,2024-03-05,9686
6770,力積電,55,8,47,富邦-宜蘭,2024-03-05,9686
4747,強生,45,0,45,富邦-宜蘭,2024-03-05,9686
00753L,中信中國50正2,59,20,39,富邦-宜蘭,2024-03-05,9686
1503,士電,62,24,38,富邦-宜蘭,2024-03-05,9686
2344,華邦電,46,12,34,富邦-宜蘭,2024-03-05,9686
5347,世界,32,0,32,富邦-宜蘭,2024-03-05,9686
00918,大華優利高填息30,32,0,32,富邦-宜蘭,2024-03-05,9686
1409,新纖,59,27,32,富邦-宜蘭,2024-03-05,9686
8105,凌巨,31,0,31,富邦-宜蘭,2024-03-05,9686
2340,台亞,33,2,31,富邦-宜蘭,2024-03-05,9686
1721,三晃,31,1,30,富邦-宜蘭,2024-03-05,9686
2328,廣宇,30,0,30,富邦-宜蘭,2024-03-05,9686
2025,千興,30,1,29,富邦-宜蘭,2024-03-05,9686
4533,協易機,28,2,26,富邦-宜蘭,2024-03-05,9686
5498,凱崴,35,10,25,富邦-宜蘭,2024-03-05,9686
00665L,富邦�琤肭磪囓�2,36,12,24,富邦-宜蘭,2024-03-05,9686
3062,建漢,26,2,24,富邦-宜蘭,2024-03-05,9686
2610,華航,25,1,24,富邦-宜蘭,2024-03-05,9686
3088,艾訊,29,7,22,富邦-宜蘭,2024-03-05,9686
1101,台泥,22,1,21,富邦-宜蘭,2024-03-05,9686
2605,新興,24,3,21,富邦-宜蘭,2024-03-05,9686
6275,元山,30,9,21,富邦-宜蘭,2024-03-05,9686
2408,南亞科,25,5,20,富邦-宜蘭,2024-03-05,9686
5340,建榮,20,0,20,富邦-宜蘭,2024-03-05,9686
4513,福裕,20,0,20,富邦-宜蘭,2024-03-05,9686
1312,國喬,20,0,20,富邦-宜蘭,2024-03-05,9686
2547,日勝生,20,0,20,富邦-宜蘭,2024-03-05,9686
3032,偉訓,23,3,20,富邦-宜蘭,2024-03-05,9686
5251,天鉞電,20,1,19,富邦-宜蘭,2024-03-05,9686
3163,波若威,29,10,19,富邦-宜蘭,2024-03-05,9686
8383,千附,20,1,19,富邦-宜蘭,2024-03-05,9686
3260,威剛,19,1,18,富邦-宜蘭,2024-03-05,9686
1210,大成,19,1,18,富邦-宜蘭,2024-03-05,9686
3055,蔚華科,23,6,17,富邦-宜蘭,2024-03-05,9686
5488,松普,33,16,17,富邦-宜蘭,2024-03-05,9686
2889,國票金,17,0,17,富邦-宜蘭,2024-03-05,9686
00929,復華台灣科技優息,94,77,17,富邦-宜蘭,2024-03-05,9686
1584,精剛,16,0,16,富邦-宜蘭,2024-03-05,9686
2845,遠東銀,326,7,319,富邦-宜蘭,2024-03-06,9686
00637L,元大滬深300正2,310,9,301,富邦-宜蘭,2024-03-06,9686
00919,群益台灣精選高息,271,95,176,富邦-宜蘭,2024-03-06,9686
2882,國泰金,234,101,133,富邦-宜蘭,2024-03-06,9686
00918,大華優利高填息30,120,9,111,富邦-宜蘭,2024-03-06,9686
1709,和益,100,0,100,富邦-宜蘭,2024-03-06,9686
8105,凌巨,100,2,98,富邦-宜蘭,2024-03-06,9686
3481,群創,160,67,93,富邦-宜蘭,2024-03-06,9686
1451,年興,77,0,77,富邦-宜蘭,2024-03-06,9686
00915,凱基優選高股息30,75,5,70,富邦-宜蘭,2024-03-06,9686
00687B,國泰20年美債,56,2,54,富邦-宜蘭,2024-03-06,9686
2324,仁寶,61,10,51,富邦-宜蘭,2024-03-06,9686
2543,皇昌,51,0,51,富邦-宜蘭,2024-03-06,9686
2352,佳世達,58,8,50,富邦-宜蘭,2024-03-06,9686
2609,陽明,59,11,48,富邦-宜蘭,2024-03-06,9686
2884,玉山金,48,3,45,富邦-宜蘭,2024-03-06,9686
2356,英業達,50,10,40,富邦-宜蘭,2024-03-06,9686
3325,旭品,163,129,34,富邦-宜蘭,2024-03-06,9686
6282,康舒,45,12,33,富邦-宜蘭,2024-03-06,9686
6770,力積電,55,24,31,富邦-宜蘭,2024-03-06,9686
3078,僑威,37,6,31,富邦-宜蘭,2024-03-06,9686
00885,富邦越南,52,21,31,富邦-宜蘭,2024-03-06,9686
4933,友輝,30,0,30,富邦-宜蘭,2024-03-06,9686
2409,友達,37,8,29,富邦-宜蘭,2024-03-06,9686
3013,晟銘電,108,80,28,富邦-宜蘭,2024-03-06,9686
2610,華航,39,11,28,富邦-宜蘭,2024-03-06,9686
00927,群益半導體收益,28,4,24,富邦-宜蘭,2024-03-06,9686
3712,永崴投控,26,2,24,富邦-宜蘭,2024-03-06,9686
1471,首利,31,8,23,富邦-宜蘭,2024-03-06,9686
1589,永冠-KY,38,15,23,富邦-宜蘭,2024-03-06,9686
3231,緯創,38,17,21,富邦-宜蘭,2024-03-06,9686
6591,動力-KY,33,13,20,富邦-宜蘭,2024-03-06,9686
3516,亞帝歐,23,3,20,富邦-宜蘭,2024-03-06,9686
3049,精金,20,0,20,富邦-宜蘭,2024-03-06,9686
6531,愛普*,21,2,19,富邦-宜蘭,2024-03-06,9686
6163,華電網,67,48,19,富邦-宜蘭,2024-03-06,9686
8011,台通,55,36,19,富邦-宜蘭,2024-03-06,9686
2014,中鴻,22,5,17,富邦-宜蘭,2024-03-06,9686
2444,兆勁,17,0,17,富邦-宜蘭,2024-03-06,9686
2365,昆盈,23,6,17,富邦-宜蘭,2024-03-06,9686
6120,達運,18,3,15,富邦-宜蘭,2024-03-06,9686
1301,台塑,15,0,15,富邦-宜蘭,2024-03-06,9686
1434,福懋,15,0,15,富邦-宜蘭,2024-03-06,9686
4747,強生,15,0,15,富邦-宜蘭,2024-03-06,9686
3540,曜越,24,9,15,富邦-宜蘭,2024-03-06,9686
1514,亞力,55,41,14,富邦-宜蘭,2024-03-06,9686
2303,聯電,30,17,13,富邦-宜蘭,2024-03-06,9686
4162,智擎,13,0,13,富邦-宜蘭,2024-03-06,9686
00929,復華台灣科技優息,112,99,13,富邦-宜蘭,2024-03-06,9686
2013,中鋼構,15,2,13,富邦-宜蘭,2024-03-06,9686
00632R,元大台灣50反1,295,0,295,富邦-宜蘭,2024-03-07,9686
00919,群益台灣精選高息,403,180,223,富邦-宜蘭,2024-03-07,9686
2882,國泰金,212,7,205,富邦-宜蘭,2024-03-07,9686
3481,群創,244,49,195,富邦-宜蘭,2024-03-07,9686
5512,力麒,147,0,147,富邦-宜蘭,2024-03-07,9686
6125,廣運,156,26,130,富邦-宜蘭,2024-03-07,9686
2312,金寶,92,3,89,富邦-宜蘭,2024-03-07,9686
5521,工信,122,47,75,富邦-宜蘭,2024-03-07,9686
8034,榮群,69,3,66,富邦-宜蘭,2024-03-07,9686
2486,一詮,95,32,63,富邦-宜蘭,2024-03-07,9686
1815,富喬,157,101,56,富邦-宜蘭,2024-03-07,9686
2352,佳世達,51,0,51,富邦-宜蘭,2024-03-07,9686
6770,力積電,65,20,45,富邦-宜蘭,2024-03-07,9686
6120,達運,44,0,44,富邦-宜蘭,2024-03-07,9686
2417,圓剛,74,36,38,富邦-宜蘭,2024-03-07,9686
6591,動力-KY,50,13,37,富邦-宜蘭,2024-03-07,9686
8105,凌巨,40,3,37,富邦-宜蘭,2024-03-07,9686
6176,瑞儀,34,0,34,富邦-宜蘭,2024-03-07,9686
6290,良維,37,4,33,富邦-宜蘭,2024-03-07,9686
00712,復華富時不動產,43,11,32,富邦-宜蘭,2024-03-07,9686
1312,國喬,30,0,30,富邦-宜蘭,2024-03-07,9686
3312,弘憶股,31,2,29,富邦-宜蘭,2024-03-07,9686
1434,福懋,27,0,27,富邦-宜蘭,2024-03-07,9686
1582,信錦,29,2,27,富邦-宜蘭,2024-03-07,9686
2420,新巨,25,0,25,富邦-宜蘭,2024-03-07,9686
8930,青鋼,24,0,24,富邦-宜蘭,2024-03-07,9686
2329,華泰,81,58,23,富邦-宜蘭,2024-03-07,9686
00857B,永豐20年美公債,23,0,23,富邦-宜蘭,2024-03-07,9686
1451,年興,23,0,23,富邦-宜蘭,2024-03-07,9686
2883,凱基金,101,78,23,富邦-宜蘭,2024-03-07,9686
5425,台半,26,5,21,富邦-宜蘭,2024-03-07,9686
6735,美達科技,22,1,21,富邦-宜蘭,2024-03-07,9686
8011,台通,30,9,21,富邦-宜蘭,2024-03-07,9686
6235,華孚,23,2,21,富邦-宜蘭,2024-03-07,9686
2002,中鋼,35,15,20,富邦-宜蘭,2024-03-07,9686
8072,陞泰,19,0,19,富邦-宜蘭,2024-03-07,9686
4543,萬在,24,5,19,富邦-宜蘭,2024-03-07,9686
2481,強茂,25,6,19,富邦-宜蘭,2024-03-07,9686
2369,菱生,65,47,18,富邦-宜蘭,2024-03-07,9686
00933B,國泰10Y+金融債,62,44,18,富邦-宜蘭,2024-03-07,9686
4534,慶騰,17,0,17,富邦-宜蘭,2024-03-07,9686
2495,普安,17,0,17,富邦-宜蘭,2024-03-07,9686
2504,國產,20,3,17,富邦-宜蘭,2024-03-07,9686
2887,台新金,19,2,17,富邦-宜蘭,2024-03-07,9686
5434,崇越,17,0,17,富邦-宜蘭,2024-03-07,9686
3689,湧德,31,15,16,富邦-宜蘭,2024-03-07,9686
3712,永崴投控,24,8,16,富邦-宜蘭,2024-03-07,9686
6116,彩晶,26,10,16,富邦-宜蘭,2024-03-07,9686
8112,至上,26,11,15,富邦-宜蘭,2024-03-07,9686
3694,海華,15,0,15,富邦-宜蘭,2024-03-07,9686
2883,凱基金,214,7,207,富邦-宜蘭,2024-03-08,9686
00919,群益台灣精選高息,511,338,173,富邦-宜蘭,2024-03-08,9686
2882,國泰金,171,4,167,富邦-宜蘭,2024-03-08,9686
9902,台火,167,5,162,富邦-宜蘭,2024-03-08,9686
00937B,群益ESG投等債20,181,28,153,富邦-宜蘭,2024-03-08,9686
1531,高林股,80,0,80,富邦-宜蘭,2024-03-08,9686
00927,群益半導體收益,66,5,61,富邦-宜蘭,2024-03-08,9686
2104,國際中橡,55,2,53,富邦-宜蘭,2024-03-08,9686
1312,國喬,52,0,52,富邦-宜蘭,2024-03-08,9686
00892,富邦台灣半導體,52,6,46,富邦-宜蘭,2024-03-08,9686
8049,晶采,41,0,41,富邦-宜蘭,2024-03-08,9686
1316,上曜,59,19,40,富邦-宜蘭,2024-03-08,9686
3481,群創,71,32,39,富邦-宜蘭,2024-03-08,9686
3138,耀登,40,1,39,富邦-宜蘭,2024-03-08,9686
6770,力積電,46,10,36,富邦-宜蘭,2024-03-08,9686
2317,鴻海,86,52,34,富邦-宜蘭,2024-03-08,9686
2353,宏��,56,23,33,富邦-宜蘭,2024-03-08,9686
4714,永捷,32,0,32,富邦-宜蘭,2024-03-08,9686
6125,廣運,75,43,32,富邦-宜蘭,2024-03-08,9686
2449,京元電子,69,37,32,富邦-宜蘭,2024-03-08,9686
5340,建榮,34,5,29,富邦-宜蘭,2024-03-08,9686
6667,信紘科,59,32,27,富邦-宜蘭,2024-03-08,9686
6190,萬泰科,28,3,25,富邦-宜蘭,2024-03-08,9686
2211,長榮鋼,26,2,24,富邦-宜蘭,2024-03-08,9686
6274,台燿,79,55,24,富邦-宜蘭,2024-03-08,9686
5488,松普,39,17,22,富邦-宜蘭,2024-03-08,9686
2405,輔信,29,8,21,富邦-宜蘭,2024-03-08,9686
8080,印鉐,21,0,21,富邦-宜蘭,2024-03-08,9686
3338,泰碩,28,8,20,富邦-宜蘭,2024-03-08,9686
00929,復華台灣科技優息,220,200,20,富邦-宜蘭,2024-03-08,9686
8927,北基,21,1,20,富邦-宜蘭,2024-03-08,9686
2601,益航,20,0,20,富邦-宜蘭,2024-03-08,9686
3171,炎洲流通,32,12,20,富邦-宜蘭,2024-03-08,9686
8930,青鋼,20,0,20,富邦-宜蘭,2024-03-08,9686
2890,永豐金,25,6,19,富邦-宜蘭,2024-03-08,9686
9105,泰金寶-DR,20,1,19,富邦-宜蘭,2024-03-08,9686
2634,漢翔,23,4,19,富邦-宜蘭,2024-03-08,9686
00725B,國泰投資級公司債,21,3,18,富邦-宜蘭,2024-03-08,9686
6233,旺玖,19,1,18,富邦-宜蘭,2024-03-08,9686
6176,瑞儀,25,7,18,富邦-宜蘭,2024-03-08,9686
3005,神基,24,6,18,富邦-宜蘭,2024-03-08,9686
2609,陽明,82,64,18,富邦-宜蘭,2024-03-08,9686
6120,達運,17,0,17,富邦-宜蘭,2024-03-08,9686
3325,旭品,18,1,17,富邦-宜蘭,2024-03-08,9686
00687B,國泰20年美債,24,7,17,富邦-宜蘭,2024-03-08,9686
6266,泰詠,16,0,16,富邦-宜蘭,2024-03-08,9686
6290,良維,20,4,16,富邦-宜蘭,2024-03-08,9686
2641,正德,26,10,16,富邦-宜蘭,2024-03-08,9686
2328,廣宇,17,1,16,富邦-宜蘭,2024-03-08,9686
5009,榮剛,19,3,16,富邦-宜蘭,2024-03-08,9686
00931B,統一美債20年,205,0,205,富邦-宜蘭,2024-03-11,9686
00937B,群益ESG投等債20,214,18,196,富邦-宜蘭,2024-03-11,9686
00919,群益台灣精選高息,319,206,113,富邦-宜蘭,2024-03-11,9686
2344,華邦電,71,1,70,富邦-宜蘭,2024-03-11,9686
1535,中宇,65,0,65,富邦-宜蘭,2024-03-11,9686
2882,國泰金,123,68,55,富邦-宜蘭,2024-03-11,9686
6116,彩晶,66,14,52,富邦-宜蘭,2024-03-11,9686
00929,復華台灣科技優息,112,60,52,富邦-宜蘭,2024-03-11,9686
2365,昆盈,71,20,51,富邦-宜蘭,2024-03-11,9686
6425,易發,55,5,50,富邦-宜蘭,2024-03-11,9686
9105,泰金寶-DR,50,1,49,富邦-宜蘭,2024-03-11,9686
00933B,國泰10Y+金融債,57,9,48,富邦-宜蘭,2024-03-11,9686
1304,台聚,40,0,40,富邦-宜蘭,2024-03-11,9686
00687B,國泰20年美債,38,0,38,富邦-宜蘭,2024-03-11,9686
2610,華航,40,2,38,富邦-宜蘭,2024-03-11,9686
00918,大華優利高填息30,36,0,36,富邦-宜蘭,2024-03-11,9686
6125,廣運,33,3,30,富邦-宜蘭,2024-03-11,9686
00679B,元大美債20年,51,23,28,富邦-宜蘭,2024-03-11,9686
3293,鈊象,29,2,27,富邦-宜蘭,2024-03-11,9686
4953,緯軟,27,0,27,富邦-宜蘭,2024-03-11,9686
2002,中鋼,30,3,27,富邦-宜蘭,2024-03-11,9686
2329,華泰,72,48,24,富邦-宜蘭,2024-03-11,9686
2303,聯電,75,52,23,富邦-宜蘭,2024-03-11,9686
8926,台汽電,27,4,23,富邦-宜蘭,2024-03-11,9686
00751B,元大AAA至A公司債,22,0,22,富邦-宜蘭,2024-03-11,9686
6278,台表科,27,5,22,富邦-宜蘭,2024-03-11,9686
2645,長榮航太,21,0,21,富邦-宜蘭,2024-03-11,9686
5403,中菲,21,0,21,富邦-宜蘭,2024-03-11,9686
00650L,復華香港正2,20,0,20,富邦-宜蘭,2024-03-11,9686
2461,光群雷,20,0,20,富邦-宜蘭,2024-03-11,9686
00915,凱基優選高股息30,20,0,20,富邦-宜蘭,2024-03-11,9686
5519,隆大,23,4,19,富邦-宜蘭,2024-03-11,9686
5225,東科-KY,20,1,19,富邦-宜蘭,2024-03-11,9686
3607,谷崧,19,0,19,富邦-宜蘭,2024-03-11,9686
2425,承啟,19,2,17,富邦-宜蘭,2024-03-11,9686
5498,凱崴,32,15,17,富邦-宜蘭,2024-03-11,9686
2603,長榮,24,7,17,富邦-宜蘭,2024-03-11,9686
2880,華南金,22,5,17,富邦-宜蘭,2024-03-11,9686
1101,台泥,17,1,16,富邦-宜蘭,2024-03-11,9686
1316,上曜,38,22,16,富邦-宜蘭,2024-03-11,9686
1570,力肯,18,2,16,富邦-宜蘭,2024-03-11,9686
00923,群益台ESG低碳50,18,3,15,富邦-宜蘭,2024-03-11,9686
2618,長榮航,20,5,15,富邦-宜蘭,2024-03-11,9686
5907,大洋-KY,16,1,15,富邦-宜蘭,2024-03-11,9686
3062,建漢,19,4,15,富邦-宜蘭,2024-03-11,9686
8401,白紗科,15,0,15,富邦-宜蘭,2024-03-11,9686
00891,中信關鍵半導體,14,0,14,富邦-宜蘭,2024-03-11,9686
3360,尚立,14,0,14,富邦-宜蘭,2024-03-11,9686
6190,萬泰科,17,3,14,富邦-宜蘭,2024-03-11,9686
6182,合晶,16,2,14,富邦-宜蘭,2024-03-11,9686
2883,凱基金,230,35,195,富邦-宜蘭,2024-03-12,9686
6120,達運,241,79,162,富邦-宜蘭,2024-03-12,9686
2607,榮運,100,1,99,富邦-宜蘭,2024-03-12,9686
1101,台泥,103,5,98,富邦-宜蘭,2024-03-12,9686
00905,FT臺灣Smart,100,2,98,富邦-宜蘭,2024-03-12,9686
00679B,元大美債20年,97,6,91,富邦-宜蘭,2024-03-12,9686
2344,華邦電,93,3,90,富邦-宜蘭,2024-03-12,9686
00937B,群益ESG投等債20,92,28,64,富邦-宜蘭,2024-03-12,9686
1618,合機,55,4,51,富邦-宜蘭,2024-03-12,9686
3709,鑫聯大投控,48,0,48,富邦-宜蘭,2024-03-12,9686
00933B,國泰10Y+金融債,72,28,44,富邦-宜蘭,2024-03-12,9686
2371,大同,43,6,37,富邦-宜蘭,2024-03-12,9686
00712,復華富時不動產,38,3,35,富邦-宜蘭,2024-03-12,9686
8059,凱碩,61,31,30,富邦-宜蘭,2024-03-12,9686
1514,亞力,68,38,30,富邦-宜蘭,2024-03-12,9686
00918,大華優利高填息30,61,32,29,富邦-宜蘭,2024-03-12,9686
3163,波若威,38,11,27,富邦-宜蘭,2024-03-12,9686
2002,中鋼,37,12,25,富邦-宜蘭,2024-03-12,9686
00687B,國泰20年美債,27,3,24,富邦-宜蘭,2024-03-12,9686
00706L,期元大S＆P日圓正2,23,0,23,富邦-宜蘭,2024-03-12,9686
2025,千興,23,1,22,富邦-宜蘭,2024-03-12,9686
00857B,永豐20年美公債,20,0,20,富邦-宜蘭,2024-03-12,9686
3257,虹冠電,20,0,20,富邦-宜蘭,2024-03-12,9686
1467,南緯,20,0,20,富邦-宜蘭,2024-03-12,9686
1440,南紡,20,0,20,富邦-宜蘭,2024-03-12,9686
2031,新光鋼,19,0,19,富邦-宜蘭,2024-03-12,9686
8064,東捷,25,6,19,富邦-宜蘭,2024-03-12,9686
1215,卜蜂,18,1,17,富邦-宜蘭,2024-03-12,9686
8048,德勝,17,0,17,富邦-宜蘭,2024-03-12,9686
8930,青鋼,16,0,16,富邦-宜蘭,2024-03-12,9686
4933,友輝,16,0,16,富邦-宜蘭,2024-03-12,9686
9950,萬國通,16,0,16,富邦-宜蘭,2024-03-12,9686
2211,長榮鋼,16,1,15,富邦-宜蘭,2024-03-12,9686
6177,達麗,14,0,14,富邦-宜蘭,2024-03-12,9686
2401,凌陽,16,2,14,富邦-宜蘭,2024-03-12,9686
2313,華通,119,105,14,富邦-宜蘭,2024-03-12,9686
2383,台光電,15,2,13,富邦-宜蘭,2024-03-12,9686
2408,南亞科,14,1,13,富邦-宜蘭,2024-03-12,9686
5483,中美晶,15,3,12,富邦-宜蘭,2024-03-12,9686
2905,三商,12,0,12,富邦-宜蘭,2024-03-12,9686
1570,力肯,12,0,12,富邦-宜蘭,2024-03-12,9686
2641,正德,12,0,12,富邦-宜蘭,2024-03-12,9686
3266,昇陽,12,1,11,富邦-宜蘭,2024-03-12,9686
2636,台驊控股,11,0,11,富邦-宜蘭,2024-03-12,9686
00893,國泰智能電動車,12,1,11,富邦-宜蘭,2024-03-12,9686
2421,建準,16,5,11,富邦-宜蘭,2024-03-12,9686
00915,凱基優選高股息30,14,3,11,富邦-宜蘭,2024-03-12,9686
3231,緯創,28,17,11,富邦-宜蘭,2024-03-12,9686
00935,野村臺灣新科技50,10,0,10,富邦-宜蘭,2024-03-12,9686
3372,典範,10,0,10,富邦-宜蘭,2024-03-12,9686
1314,中石化,254,1,253,富邦-宜蘭,2024-03-13,9686
2885,元大金,163,19,144,富邦-宜蘭,2024-03-13,9686
3231,緯創,156,39,117,富邦-宜蘭,2024-03-13,9686
6770,力積電,118,4,114,富邦-宜蘭,2024-03-13,9686
00918,大華優利高填息30,124,13,111,富邦-宜蘭,2024-03-13,9686
2887,台新金,106,0,106,富邦-宜蘭,2024-03-13,9686
00937B,群益ESG投等債20,100,16,84,富邦-宜蘭,2024-03-13,9686
2852,第一保,102,22,80,富邦-宜蘭,2024-03-13,9686
00637L,元大滬深300正2,56,0,56,富邦-宜蘭,2024-03-13,9686
2352,佳世達,51,0,51,富邦-宜蘭,2024-03-13,9686
3543,州巧,50,0,50,富邦-宜蘭,2024-03-13,9686
2609,陽明,83,34,49,富邦-宜蘭,2024-03-13,9686
2408,南亞科,48,2,46,富邦-宜蘭,2024-03-13,9686
2328,廣宇,46,2,44,富邦-宜蘭,2024-03-13,9686
00857B,永豐20年美公債,42,0,42,富邦-宜蘭,2024-03-13,9686
5009,榮剛,62,20,42,富邦-宜蘭,2024-03-13,9686
3481,群創,239,204,35,富邦-宜蘭,2024-03-13,9686
3050,鈺德,51,16,35,富邦-宜蘭,2024-03-13,9686
2376,技嘉,56,21,35,富邦-宜蘭,2024-03-13,9686
1609,大亞,52,19,33,富邦-宜蘭,2024-03-13,9686
8933,愛地雅,31,0,31,富邦-宜蘭,2024-03-13,9686
2344,華邦電,38,7,31,富邦-宜蘭,2024-03-13,9686
6274,台燿,36,6,30,富邦-宜蘭,2024-03-13,9686
8064,東捷,32,2,30,富邦-宜蘭,2024-03-13,9686
4534,慶騰,30,0,30,富邦-宜蘭,2024-03-13,9686
3715,定穎投控,32,3,29,富邦-宜蘭,2024-03-13,9686
00929,復華台灣科技優息,131,105,26,富邦-宜蘭,2024-03-13,9686
6667,信紘科,36,10,26,富邦-宜蘭,2024-03-13,9686
1616,億泰,36,10,26,富邦-宜蘭,2024-03-13,9686
1513,中興電,106,82,24,富邦-宜蘭,2024-03-13,9686
3163,波若威,77,53,24,富邦-宜蘭,2024-03-13,9686
6278,台表科,29,5,24,富邦-宜蘭,2024-03-13,9686
9907,統一實,23,0,23,富邦-宜蘭,2024-03-13,9686
6120,達運,30,7,23,富邦-宜蘭,2024-03-13,9686
6233,旺玖,27,4,23,富邦-宜蘭,2024-03-13,9686
00720B,元大投資級公司債,24,1,23,富邦-宜蘭,2024-03-13,9686
2383,台光電,25,3,22,富邦-宜蘭,2024-03-13,9686
6282,康舒,20,0,20,富邦-宜蘭,2024-03-13,9686
4167,松瑞藥,20,0,20,富邦-宜蘭,2024-03-13,9686
1531,高林股,20,0,20,富邦-宜蘭,2024-03-13,9686
3234,光環,26,6,20,富邦-宜蘭,2024-03-13,9686
1618,合機,23,4,19,富邦-宜蘭,2024-03-13,9686
3709,鑫聯大投控,19,0,19,富邦-宜蘭,2024-03-13,9686
6125,廣運,33,14,19,富邦-宜蘭,2024-03-13,9686
00712,復華富時不動產,29,10,19,富邦-宜蘭,2024-03-13,9686
0056,元大高股息,25,6,19,富邦-宜蘭,2024-03-13,9686
8040,九暘,48,30,18,富邦-宜蘭,2024-03-13,9686
2371,大同,31,13,18,富邦-宜蘭,2024-03-13,9686
6224,聚鼎,18,1,17,富邦-宜蘭,2024-03-13,9686
8034,榮群,32,15,17,富邦-宜蘭,2024-03-13,9686
2883,凱基金,725,213,512,富邦-宜蘭,2024-03-14,9686
1314,中石化,223,1,222,富邦-宜蘭,2024-03-14,9686
00637L,元大滬深300正2,202,3,199,富邦-宜蘭,2024-03-14,9686
00919,群益台灣精選高息,651,474,177,富邦-宜蘭,2024-03-14,9686
00687B,國泰20年美債,177,5,172,富邦-宜蘭,2024-03-14,9686
1447,力鵬,150,0,150,富邦-宜蘭,2024-03-14,9686
1304,台聚,100,0,100,富邦-宜蘭,2024-03-14,9686
2609,陽明,97,18,79,富邦-宜蘭,2024-03-14,9686
00665L,富邦�琤肭磪囓�2,59,0,59,富邦-宜蘭,2024-03-14,9686
00933B,國泰10Y+金融債,94,39,55,富邦-宜蘭,2024-03-14,9686
2889,國票金,73,20,53,富邦-宜蘭,2024-03-14,9686
2880,華南金,70,19,51,富邦-宜蘭,2024-03-14,9686
2618,長榮航,111,61,50,富邦-宜蘭,2024-03-14,9686
00673R,期元大S＆P原油反1,45,0,45,富邦-宜蘭,2024-03-14,9686
3702,大聯大,41,0,41,富邦-宜蘭,2024-03-14,9686
00915,凱基優選高股息30,70,29,41,富邦-宜蘭,2024-03-14,9686
2915,潤泰全,51,12,39,富邦-宜蘭,2024-03-14,9686
2354,鴻準,44,13,31,富邦-宜蘭,2024-03-14,9686
1615,大山,30,0,30,富邦-宜蘭,2024-03-14,9686
1503,士電,96,68,28,富邦-宜蘭,2024-03-14,9686
2603,長榮,59,32,27,富邦-宜蘭,2024-03-14,9686
3628,盈正,26,0,26,富邦-宜蘭,2024-03-14,9686
6120,達運,26,1,25,富邦-宜蘭,2024-03-14,9686
2363,矽統,25,1,24,富邦-宜蘭,2024-03-14,9686
6217,中探針,26,2,24,富邦-宜蘭,2024-03-14,9686
5225,東科-KY,22,1,21,富邦-宜蘭,2024-03-14,9686
4306,炎洲,21,0,21,富邦-宜蘭,2024-03-14,9686
1609,大亞,75,54,21,富邦-宜蘭,2024-03-14,9686
2002,中鋼,24,4,20,富邦-宜蘭,2024-03-14,9686
00918,大華優利高填息30,100,80,20,富邦-宜蘭,2024-03-14,9686
9940,信義,20,0,20,富邦-宜蘭,2024-03-14,9686
1714,和桐,20,0,20,富邦-宜蘭,2024-03-14,9686
2892,第一金,30,10,20,富邦-宜蘭,2024-03-14,9686
1316,上曜,54,35,19,富邦-宜蘭,2024-03-14,9686
6189,豐藝,22,3,19,富邦-宜蘭,2024-03-14,9686
2109,華豐,21,2,19,富邦-宜蘭,2024-03-14,9686
6125,廣運,37,18,19,富邦-宜蘭,2024-03-14,9686
2801,彰銀,18,0,18,富邦-宜蘭,2024-03-14,9686
3013,晟銘電,19,1,18,富邦-宜蘭,2024-03-14,9686
3481,群創,22,4,18,富邦-宜蘭,2024-03-14,9686
00857B,永豐20年美公債,17,0,17,富邦-宜蘭,2024-03-14,9686
1452,宏益,76,59,17,富邦-宜蘭,2024-03-14,9686
3231,緯創,43,26,17,富邦-宜蘭,2024-03-14,9686
6176,瑞儀,44,27,17,富邦-宜蘭,2024-03-14,9686
1513,中興電,74,57,17,富邦-宜蘭,2024-03-14,9686
4714,永捷,30,14,16,富邦-宜蘭,2024-03-14,9686
2816,旺旺保,17,1,16,富邦-宜蘭,2024-03-14,9686
8089,康全電訊,17,3,14,富邦-宜蘭,2024-03-14,9686
2009,第一銅,55,41,14,富邦-宜蘭,2024-03-14,9686
2537,聯上發,14,0,14,富邦-宜蘭,2024-03-14,9686
00679B,元大美債20年,1504,5,1499,富邦-宜蘭,2024-03-15,9686
00919,群益台灣精選高息,523,141,382,富邦-宜蘭,2024-03-15,9686
00941,中信上游半導體,350,144,206,富邦-宜蘭,2024-03-15,9686
6770,力積電,140,27,113,富邦-宜蘭,2024-03-15,9686
2618,長榮航,87,0,87,富邦-宜蘭,2024-03-15,9686
00882,中信中國高股息,78,2,76,富邦-宜蘭,2024-03-15,9686
6190,萬泰科,83,13,70,富邦-宜蘭,2024-03-15,9686
00673R,期元大S＆P原油反1,71,3,68,富邦-宜蘭,2024-03-15,9686
4714,永捷,109,44,65,富邦-宜蘭,2024-03-15,9686
2356,英業達,71,9,62,富邦-宜蘭,2024-03-15,9686
00687B,國泰20年美債,61,0,61,富邦-宜蘭,2024-03-15,9686
2312,金寶,60,1,59,富邦-宜蘭,2024-03-15,9686
00937B,群益ESG投等債20,89,31,58,富邦-宜蘭,2024-03-15,9686
00637L,元大滬深300正2,150,100,50,富邦-宜蘭,2024-03-15,9686
9945,潤泰新,49,0,49,富邦-宜蘭,2024-03-15,9686
1815,富喬,45,1,44,富邦-宜蘭,2024-03-15,9686
2915,潤泰全,44,4,40,富邦-宜蘭,2024-03-15,9686
2330,台積電,46,10,36,富邦-宜蘭,2024-03-15,9686
2486,一詮,48,12,36,富邦-宜蘭,2024-03-15,9686
00751B,元大AAA至A公司債,36,1,35,富邦-宜蘭,2024-03-15,9686
1616,億泰,36,3,33,富邦-宜蘭,2024-03-15,9686
00665L,富邦�琤肭磪囓�2,31,0,31,富邦-宜蘭,2024-03-15,9686
00915,凱基優選高股息30,32,1,31,富邦-宜蘭,2024-03-15,9686
2880,華南金,78,47,31,富邦-宜蘭,2024-03-15,9686
3289,宜特,32,2,30,富邦-宜蘭,2024-03-15,9686
00918,大華優利高填息30,65,36,29,富邦-宜蘭,2024-03-15,9686
2371,大同,30,1,29,富邦-宜蘭,2024-03-15,9686
00933B,國泰10Y+金融債,28,0,28,富邦-宜蘭,2024-03-15,9686
6116,彩晶,28,1,27,富邦-宜蘭,2024-03-15,9686
9950,萬國通,27,3,24,富邦-宜蘭,2024-03-15,9686
3715,定穎投控,27,3,24,富邦-宜蘭,2024-03-15,9686
2889,國票金,37,14,23,富邦-宜蘭,2024-03-15,9686
5009,榮剛,22,0,22,富邦-宜蘭,2024-03-15,9686
6667,信紘科,23,1,22,富邦-宜蘭,2024-03-15,9686
2609,陽明,158,137,21,富邦-宜蘭,2024-03-15,9686
1471,首利,23,2,21,富邦-宜蘭,2024-03-15,9686
00712,復華富時不動產,21,0,21,富邦-宜蘭,2024-03-15,9686
2888,新光金,21,1,20,富邦-宜蘭,2024-03-15,9686
00633L,富邦上証正2,20,0,20,富邦-宜蘭,2024-03-15,9686
006205,富邦上証,20,0,20,富邦-宜蘭,2024-03-15,9686
4938,和碩,20,0,20,富邦-宜蘭,2024-03-15,9686
2002,中鋼,19,0,19,富邦-宜蘭,2024-03-15,9686
2610,華航,20,2,18,富邦-宜蘭,2024-03-15,9686
6668,中揚光,18,0,18,富邦-宜蘭,2024-03-15,9686
3013,晟銘電,20,2,18,富邦-宜蘭,2024-03-15,9686
3041,揚智,18,0,18,富邦-宜蘭,2024-03-15,9686
1445,大宇,18,0,18,富邦-宜蘭,2024-03-15,9686
2603,長榮,105,88,17,富邦-宜蘭,2024-03-15,9686
6120,達運,20,3,17,富邦-宜蘭,2024-03-15,9686
2340,台亞,17,0,17,富邦-宜蘭,2024-03-15,9686
00919,群益台灣精選高息,455,15,440,富邦-宜蘭,2024-03-18,9686
00941,中信上游半導體,205,20,185,富邦-宜蘭,2024-03-18,9686
2834,臺企銀,159,2,157,富邦-宜蘭,2024-03-18,9686
4714,永捷,154,15,139,富邦-宜蘭,2024-03-18,9686
8011,台通,108,19,89,富邦-宜蘭,2024-03-18,9686
00679B,元大美債20年,76,0,76,富邦-宜蘭,2024-03-18,9686
2641,正德,69,0,69,富邦-宜蘭,2024-03-18,9686
00918,大華優利高填息30,79,16,63,富邦-宜蘭,2024-03-18,9686
00687B,國泰20年美債,60,1,59,富邦-宜蘭,2024-03-18,9686
00900,富邦特選高股息30,67,13,54,富邦-宜蘭,2024-03-18,9686
2010,春源,50,0,50,富邦-宜蘭,2024-03-18,9686
2889,國票金,56,7,49,富邦-宜蘭,2024-03-18,9686
2323,中環,84,36,48,富邦-宜蘭,2024-03-18,9686
2609,陽明,73,28,45,富邦-宜蘭,2024-03-18,9686
2505,國揚,40,0,40,富邦-宜蘭,2024-03-18,9686
00751B,元大AAA至A公司債,39,0,39,富邦-宜蘭,2024-03-18,9686
3709,鑫聯大投控,39,0,39,富邦-宜蘭,2024-03-18,9686
2504,國產,38,0,38,富邦-宜蘭,2024-03-18,9686
2408,南亞科,36,0,36,富邦-宜蘭,2024-03-18,9686
00904,新光臺灣半導體30,35,1,34,富邦-宜蘭,2024-03-18,9686
9902,台火,38,7,31,富邦-宜蘭,2024-03-18,9686
1319,東陽,42,11,31,富邦-宜蘭,2024-03-18,9686
3032,偉訓,31,1,30,富邦-宜蘭,2024-03-18,9686
2328,廣宇,31,3,28,富邦-宜蘭,2024-03-18,9686
00915,凱基優選高股息30,29,1,28,富邦-宜蘭,2024-03-18,9686
2303,聯電,48,21,27,富邦-宜蘭,2024-03-18,9686
00878,國泰永續高股息,40,13,27,富邦-宜蘭,2024-03-18,9686
00696B,富邦美債20年,25,0,25,富邦-宜蘭,2024-03-18,9686
00673R,期元大S＆P原油反1,24,0,24,富邦-宜蘭,2024-03-18,9686
2618,長榮航,29,6,23,富邦-宜蘭,2024-03-18,9686
6128,上福,24,1,23,富邦-宜蘭,2024-03-18,9686
2382,廣達,70,49,21,富邦-宜蘭,2024-03-18,9686
2880,華南金,27,7,20,富邦-宜蘭,2024-03-18,9686
1101,台泥,23,3,20,富邦-宜蘭,2024-03-18,9686
00680L,元大美債20正2,20,0,20,富邦-宜蘭,2024-03-18,9686
9907,統一實,20,0,20,富邦-宜蘭,2024-03-18,9686
4953,緯軟,20,3,17,富邦-宜蘭,2024-03-18,9686
4420,光明,17,1,16,富邦-宜蘭,2024-03-18,9686
3622,洋華,30,14,16,富邦-宜蘭,2024-03-18,9686
6125,廣運,20,4,16,富邦-宜蘭,2024-03-18,9686
1452,宏益,62,47,15,富邦-宜蘭,2024-03-18,9686
2371,大同,19,5,14,富邦-宜蘭,2024-03-18,9686
2801,彰銀,14,0,14,富邦-宜蘭,2024-03-18,9686
3207,耀勝,15,1,14,富邦-宜蘭,2024-03-18,9686
5201,凱衛,13,0,13,富邦-宜蘭,2024-03-18,9686
2362,藍天,15,2,13,富邦-宜蘭,2024-03-18,9686
2344,華邦電,15,3,12,富邦-宜蘭,2024-03-18,9686
3450,聯鈞,15,3,12,富邦-宜蘭,2024-03-18,9686
00753L,中信中國50正2,13,1,12,富邦-宜蘭,2024-03-18,9686
1582,信錦,20,8,12,富邦-宜蘭,2024-03-18,9686
4714,永捷,232,56,176,富邦-宜蘭,2024-03-19,9686
2888,新光金,105,0,105,富邦-宜蘭,2024-03-19,9686
00919,群益台灣精選高息,335,231,104,富邦-宜蘭,2024-03-19,9686
2834,臺企銀,136,53,83,富邦-宜蘭,2024-03-19,9686
00680L,元大美債20正2,55,0,55,富邦-宜蘭,2024-03-19,9686
00679B,元大美債20年,54,10,44,富邦-宜蘭,2024-03-19,9686
2353,宏��,46,6,40,富邦-宜蘭,2024-03-19,9686
00915,凱基優選高股息30,49,16,33,富邦-宜蘭,2024-03-19,9686
2006,東和鋼鐵,32,0,32,富邦-宜蘭,2024-03-19,9686
3045,台灣大,31,0,31,富邦-宜蘭,2024-03-19,9686
6265,方土昶,31,0,31,富邦-宜蘭,2024-03-19,9686
00706L,期元大S＆P日圓正2,29,0,29,富邦-宜蘭,2024-03-19,9686
8011,台通,65,39,26,富邦-宜蘭,2024-03-19,9686
6505,台塑化,26,0,26,富邦-宜蘭,2024-03-19,9686
00905,FT臺灣Smart,30,4,26,富邦-宜蘭,2024-03-19,9686
00696B,富邦美債20年,26,0,26,富邦-宜蘭,2024-03-19,9686
6770,力積電,25,0,25,富邦-宜蘭,2024-03-19,9686
00857B,永豐20年美公債,25,0,25,富邦-宜蘭,2024-03-19,9686
2515,中工,35,10,25,富邦-宜蘭,2024-03-19,9686
2002,中鋼,31,6,25,富邦-宜蘭,2024-03-19,9686
1101,台泥,27,3,24,富邦-宜蘭,2024-03-19,9686
3207,耀勝,28,5,23,富邦-宜蘭,2024-03-19,9686
9902,台火,24,1,23,富邦-宜蘭,2024-03-19,9686
00918,大華優利高填息30,60,37,23,富邦-宜蘭,2024-03-19,9686
2887,台新金,31,9,22,富邦-宜蘭,2024-03-19,9686
2355,敬鵬,24,2,22,富邦-宜蘭,2024-03-19,9686
6125,廣運,32,10,22,富邦-宜蘭,2024-03-19,9686
2486,一詮,105,84,21,富邦-宜蘭,2024-03-19,9686
2618,長榮航,41,20,21,富邦-宜蘭,2024-03-19,9686
2020,美亞,21,0,21,富邦-宜蘭,2024-03-19,9686
2610,華航,31,10,21,富邦-宜蘭,2024-03-19,9686
2405,輔信,21,1,20,富邦-宜蘭,2024-03-19,9686
3709,鑫聯大投控,20,0,20,富邦-宜蘭,2024-03-19,9686
2885,元大金,22,3,19,富邦-宜蘭,2024-03-19,9686
4938,和碩,52,33,19,富邦-宜蘭,2024-03-19,9686
3715,定穎投控,21,2,19,富邦-宜蘭,2024-03-19,9686
8936,國統,53,34,19,富邦-宜蘭,2024-03-19,9686
1452,宏益,73,54,19,富邦-宜蘭,2024-03-19,9686
00720B,元大投資級公司債,18,0,18,富邦-宜蘭,2024-03-19,9686
3512,皇龍,18,0,18,富邦-宜蘭,2024-03-19,9686
6275,元山,22,4,18,富邦-宜蘭,2024-03-19,9686
2464,盟立,45,28,17,富邦-宜蘭,2024-03-19,9686
6233,旺玖,18,1,17,富邦-宜蘭,2024-03-19,9686
1326,台化,17,1,16,富邦-宜蘭,2024-03-19,9686
1316,上曜,24,8,16,富邦-宜蘭,2024-03-19,9686
1815,富喬,16,0,16,富邦-宜蘭,2024-03-19,9686
9958,世紀鋼,24,8,16,富邦-宜蘭,2024-03-19,9686
00712,復華富時不動產,17,2,15,富邦-宜蘭,2024-03-19,9686
4503,金雨,25,10,15,富邦-宜蘭,2024-03-19,9686
3372,典範,14,0,14,富邦-宜蘭,2024-03-19,9686
00939,統一台灣高息動能,1165,385,780,富邦-宜蘭,2024-03-20,9686
1319,東陽,221,5,216,富邦-宜蘭,2024-03-20,9686
3709,鑫聯大投控,100,0,100,富邦-宜蘭,2024-03-20,9686
1101,台泥,118,22,96,富邦-宜蘭,2024-03-20,9686
5512,力麒,92,0,92,富邦-宜蘭,2024-03-20,9686
00937B,群益ESG投等債20,111,29,82,富邦-宜蘭,2024-03-20,9686
00893,國泰智能電動車,80,4,76,富邦-宜蘭,2024-03-20,9686
00919,群益台灣精選高息,450,378,72,富邦-宜蘭,2024-03-20,9686
8050,廣積,55,5,50,富邦-宜蘭,2024-03-20,9686
4526,東台,52,2,50,富邦-宜蘭,2024-03-20,9686
4938,和碩,107,59,48,富邦-宜蘭,2024-03-20,9686
3231,緯創,92,43,49,富邦-宜蘭,2024-03-20,9686
4533,協易機,55,10,45,富邦-宜蘭,2024-03-20,9686
2888,新光金,46,4,42,富邦-宜蘭,2024-03-20,9686
3041,揚智,65,26,39,富邦-宜蘭,2024-03-20,9686
6120,達運,38,0,38,富邦-宜蘭,2024-03-20,9686
2354,鴻準,113,78,35,富邦-宜蘭,2024-03-20,9686
8926,台汽電,41,6,35,富邦-宜蘭,2024-03-20,9686
00941,中信上游半導體,36,2,34,富邦-宜蘭,2024-03-20,9686
6160,欣技,33,0,33,富邦-宜蘭,2024-03-20,9686
3508,位速,34,1,33,富邦-宜蘭,2024-03-20,9686
2356,英業達,50,19,31,富邦-宜蘭,2024-03-20,9686
8155,博智,30,0,30,富邦-宜蘭,2024-03-20,9686
00877,復華中國5G,30,1,29,富邦-宜蘭,2024-03-20,9686
2887,台新金,27,1,26,富邦-宜蘭,2024-03-20,9686
00673R,期元大S＆P原油反1,25,0,25,富邦-宜蘭,2024-03-20,9686
5488,松普,25,1,24,富邦-宜蘭,2024-03-20,9686
2323,中環,28,5,23,富邦-宜蘭,2024-03-20,9686
4933,友輝,22,0,22,富邦-宜蘭,2024-03-20,9686
1326,台化,22,0,22,富邦-宜蘭,2024-03-20,9686
2317,鴻海,86,65,21,富邦-宜蘭,2024-03-20,9686
2376,技嘉,30,9,21,富邦-宜蘭,2024-03-20,9686
2211,長榮鋼,20,0,20,富邦-宜蘭,2024-03-20,9686
2313,華通,43,24,19,富邦-宜蘭,2024-03-20,9686
2329,華泰,50,31,19,富邦-宜蘭,2024-03-20,9686
3576,聯合再生,18,0,18,富邦-宜蘭,2024-03-20,9686
5251,天鉞電,18,0,18,富邦-宜蘭,2024-03-20,9686
2618,長榮航,56,38,18,富邦-宜蘭,2024-03-20,9686
8086,宏捷科,18,1,17,富邦-宜蘭,2024-03-20,9686
8064,東捷,20,3,17,富邦-宜蘭,2024-03-20,9686
5521,工信,16,0,16,富邦-宜蘭,2024-03-20,9686
2374,佳能,44,28,16,富邦-宜蘭,2024-03-20,9686
6788,華景電,16,0,16,富邦-宜蘭,2024-03-20,9686
4127,天良,66,50,16,富邦-宜蘭,2024-03-20,9686
2543,皇昌,20,4,16,富邦-宜蘭,2024-03-20,9686
2353,宏��,36,20,16,富邦-宜蘭,2024-03-20,9686
2371,大同,19,4,15,富邦-宜蘭,2024-03-20,9686
2421,建準,16,1,15,富邦-宜蘭,2024-03-20,9686
00679B,元大美債20年,15,0,15,富邦-宜蘭,2024-03-20,9686
2834,臺企銀,20,6,14,富邦-宜蘭,2024-03-20,9686
00679B,元大美債20年,268,5,263,富邦-宜蘭,2024-03-21,9686
00939,統一台灣高息動能,509,262,247,富邦-宜蘭,2024-03-21,9686
00632R,元大台灣50反1,232,46,186,富邦-宜蘭,2024-03-21,9686
00905,FT臺灣Smart,150,5,145,富邦-宜蘭,2024-03-21,9686
2883,凱基金,180,42,138,富邦-宜蘭,2024-03-21,9686
00937B,群益ESG投等債20,88,13,75,富邦-宜蘭,2024-03-21,9686
6160,欣技,73,3,70,富邦-宜蘭,2024-03-21,9686
1319,東陽,77,8,69,富邦-宜蘭,2024-03-21,9686
2816,旺旺保,60,0,60,富邦-宜蘭,2024-03-21,9686
6207,雷科,61,2,59,富邦-宜蘭,2024-03-21,9686
2405,輔信,80,23,57,富邦-宜蘭,2024-03-21,9686
2369,菱生,52,9,43,富邦-宜蘭,2024-03-21,9686
1789,神隆,42,0,42,富邦-宜蘭,2024-03-21,9686
1539,巨庭,40,0,40,富邦-宜蘭,2024-03-21,9686
3706,神達,173,136,37,富邦-宜蘭,2024-03-21,9686
1609,大亞,50,13,37,富邦-宜蘭,2024-03-21,9686
6770,力積電,56,20,36,富邦-宜蘭,2024-03-21,9686
00931B,統一美債20年,34,0,34,富邦-宜蘭,2024-03-21,9686
00687B,國泰20年美債,32,0,32,富邦-宜蘭,2024-03-21,9686
2353,宏��,53,21,32,富邦-宜蘭,2024-03-21,9686
2328,廣宇,31,0,31,富邦-宜蘭,2024-03-21,9686
1513,中興電,82,51,31,富邦-宜蘭,2024-03-21,9686
9934,成霖,30,0,30,富邦-宜蘭,2024-03-21,9686
5701,劍湖山,30,0,30,富邦-宜蘭,2024-03-21,9686
2834,臺企銀,46,16,30,富邦-宜蘭,2024-03-21,9686
3043,科風,30,2,28,富邦-宜蘭,2024-03-21,9686
6425,易發,27,2,25,富邦-宜蘭,2024-03-21,9686
2603,長榮,31,10,21,富邦-宜蘭,2024-03-21,9686
1101,台泥,20,0,20,富邦-宜蘭,2024-03-21,9686
3498,陽程,27,7,20,富邦-宜蘭,2024-03-21,9686
2618,長榮航,56,36,20,富邦-宜蘭,2024-03-21,9686
2406,國碩,28,9,19,富邦-宜蘭,2024-03-21,9686
1905,華紙,20,1,19,富邦-宜蘭,2024-03-21,9686
6176,瑞儀,60,43,17,富邦-宜蘭,2024-03-21,9686
3005,神基,51,34,17,富邦-宜蘭,2024-03-21,9686
2597,潤弘,18,2,16,富邦-宜蘭,2024-03-21,9686
3714,富采,16,0,16,富邦-宜蘭,2024-03-21,9686
00929,復華台灣科技優息,106,91,15,富邦-宜蘭,2024-03-21,9686
00751B,元大AAA至A公司債,14,0,14,富邦-宜蘭,2024-03-21,9686
9902,台火,15,1,14,富邦-宜蘭,2024-03-21,9686
4105,東洋,13,0,13,富邦-宜蘭,2024-03-21,9686
3594,磐儀,14,1,13,富邦-宜蘭,2024-03-21,9686
4714,永捷,24,11,13,富邦-宜蘭,2024-03-21,9686
8059,凱碩,13,0,13,富邦-宜蘭,2024-03-21,9686
2609,陽明,59,46,13,富邦-宜蘭,2024-03-21,9686
2002,中鋼,14,1,13,富邦-宜蘭,2024-03-21,9686
00706L,期元大S＆P日圓正2,12,0,12,富邦-宜蘭,2024-03-21,9686
00930,永豐ESG低碳高息,12,0,12,富邦-宜蘭,2024-03-21,9686
1301,台塑,15,3,12,富邦-宜蘭,2024-03-21,9686
6244,茂迪,15,4,11,富邦-宜蘭,2024-03-21,9686
00679B,元大美債20年,369,8,361,富邦-宜蘭,2024-03-22,9686
00919,群益台灣精選高息,351,166,185,富邦-宜蘭,2024-03-22,9686
00939,統一台灣高息動能,279,120,159,富邦-宜蘭,2024-03-22,9686
00687B,國泰20年美債,160,5,155,富邦-宜蘭,2024-03-22,9686
3709,鑫聯大投控,186,35,151,富邦-宜蘭,2024-03-22,9686
2303,聯電,116,19,97,富邦-宜蘭,2024-03-22,9686
00720B,元大投資級公司債,101,7,94,富邦-宜蘭,2024-03-22,9686
00937B,群益ESG投等債20,164,85,79,富邦-宜蘭,2024-03-22,9686
5009,榮剛,59,1,58,富邦-宜蘭,2024-03-22,9686
1314,中石化,52,1,51,富邦-宜蘭,2024-03-22,9686
6160,欣技,51,0,51,富邦-宜蘭,2024-03-22,9686
2543,皇昌,50,0,50,富邦-宜蘭,2024-03-22,9686
00664R,國泰臺灣加權反1,50,0,50,富邦-宜蘭,2024-03-22,9686
1101,台泥,50,0,50,富邦-宜蘭,2024-03-22,9686
2611,志信,69,20,49,富邦-宜蘭,2024-03-22,9686
2888,新光金,47,0,47,富邦-宜蘭,2024-03-22,9686
8936,國統,119,72,47,富邦-宜蘭,2024-03-22,9686
1608,華榮,48,5,43,富邦-宜蘭,2024-03-22,9686
2353,宏��,118,76,42,富邦-宜蘭,2024-03-22,9686
1789,神隆,41,0,41,富邦-宜蘭,2024-03-22,9686
3622,洋華,41,4,37,富邦-宜蘭,2024-03-22,9686
6443,元晶,121,84,37,富邦-宜蘭,2024-03-22,9686
00665L,富邦�琤肭磪囓�2,39,3,36,富邦-宜蘭,2024-03-22,9686
2371,大同,55,21,34,富邦-宜蘭,2024-03-22,9686
2834,臺企銀,35,2,33,富邦-宜蘭,2024-03-22,9686
2406,國碩,70,39,31,富邦-宜蘭,2024-03-22,9686
1597,直得,32,2,30,富邦-宜蘭,2024-03-22,9686
2376,技嘉,113,83,30,富邦-宜蘭,2024-03-22,9686
5469,瀚宇博,40,11,29,富邦-宜蘭,2024-03-22,9686
2603,長榮,38,10,28,富邦-宜蘭,2024-03-22,9686
00888,永豐台灣ESG,28,0,28,富邦-宜蘭,2024-03-22,9686
3706,神達,195,167,28,富邦-宜蘭,2024-03-22,9686
2328,廣宇,37,10,27,富邦-宜蘭,2024-03-22,9686
00882,中信中國高股息,33,7,26,富邦-宜蘭,2024-03-22,9686
6147,頎邦,26,0,26,富邦-宜蘭,2024-03-22,9686
6176,瑞儀,56,30,26,富邦-宜蘭,2024-03-22,9686
3498,陽程,27,1,26,富邦-宜蘭,2024-03-22,9686
3005,神基,32,8,24,富邦-宜蘭,2024-03-22,9686
8155,博智,23,0,23,富邦-宜蘭,2024-03-22,9686
2609,陽明,26,3,23,富邦-宜蘭,2024-03-22,9686
2449,京元電子,50,27,23,富邦-宜蘭,2024-03-22,9686
6197,佳必琪,21,0,21,富邦-宜蘭,2024-03-22,9686
6244,茂迪,28,7,21,富邦-宜蘭,2024-03-22,9686
00706L,期元大S＆P日圓正2,20,0,20,富邦-宜蘭,2024-03-22,9686
2344,華邦電,35,15,20,富邦-宜蘭,2024-03-22,9686
1467,南緯,20,0,20,富邦-宜蘭,2024-03-22,9686
3083,網龍,51,31,20,富邦-宜蘭,2024-03-22,9686
00927,群益半導體收益,18,0,18,富邦-宜蘭,2024-03-22,9686
5871,中租-KY,17,0,17,富邦-宜蘭,2024-03-22,9686
3058,立德,22,5,17,富邦-宜蘭,2024-03-22,9686
2323,中環,140,22,118,富邦-宜蘭,2024-03-25,9686
00931B,統一美債20年,103,0,103,富邦-宜蘭,2024-03-25,9686
00939,統一台灣高息動能,207,106,101,富邦-宜蘭,2024-03-25,9686
2356,英業達,153,60,93,富邦-宜蘭,2024-03-25,9686
00929,復華台灣科技優息,158,72,86,富邦-宜蘭,2024-03-25,9686
2352,佳世達,91,6,85,富邦-宜蘭,2024-03-25,9686
1609,大亞,154,69,85,富邦-宜蘭,2024-03-25,9686
1905,華紙,83,4,79,富邦-宜蘭,2024-03-25,9686
2367,燿華,140,68,72,富邦-宜蘭,2024-03-25,9686
3062,建漢,102,33,69,富邦-宜蘭,2024-03-25,9686
2359,所羅門,71,3,68,富邦-宜蘭,2024-03-25,9686
2888,新光金,73,11,62,富邦-宜蘭,2024-03-25,9686
1305,華夏,57,0,57,富邦-宜蘭,2024-03-25,9686
00919,群益台灣精選高息,131,79,52,富邦-宜蘭,2024-03-25,9686
00937B,群益ESG投等債20,58,7,51,富邦-宜蘭,2024-03-25,9686
2303,聯電,55,10,45,富邦-宜蘭,2024-03-25,9686
6188,廣明,57,15,42,富邦-宜蘭,2024-03-25,9686
1504,東元,45,6,39,富邦-宜蘭,2024-03-25,9686
1789,神隆,40,3,37,富邦-宜蘭,2024-03-25,9686
1734,杏輝,30,2,28,富邦-宜蘭,2024-03-25,9686
2317,鴻海,76,51,25,富邦-宜蘭,2024-03-25,9686
6282,康舒,25,0,25,富邦-宜蘭,2024-03-25,9686
6215,和椿,24,0,24,富邦-宜蘭,2024-03-25,9686
2464,盟立,88,67,21,富邦-宜蘭,2024-03-25,9686
00857B,永豐20年美公債,25,4,21,富邦-宜蘭,2024-03-25,9686
3024,憶聲,21,0,21,富邦-宜蘭,2024-03-25,9686
3673,TPK-KY,23,3,20,富邦-宜蘭,2024-03-25,9686
6606,建德工業,20,0,20,富邦-宜蘭,2024-03-25,9686
00933B,國泰10Y+金融債,29,10,19,富邦-宜蘭,2024-03-25,9686
1529,樂事綠能,50,32,18,富邦-宜蘭,2024-03-25,9686
2363,矽統,20,2,18,富邦-宜蘭,2024-03-25,9686
8112,至上,24,6,18,富邦-宜蘭,2024-03-25,9686
9945,潤泰新,19,2,17,富邦-宜蘭,2024-03-25,9686
6425,易發,17,0,17,富邦-宜蘭,2024-03-25,9686
3322,建舜電,17,0,17,富邦-宜蘭,2024-03-25,9686
5347,世界,20,3,17,富邦-宜蘭,2024-03-25,9686
2884,玉山金,24,7,17,富邦-宜蘭,2024-03-25,9686
2402,毅嘉,18,2,16,富邦-宜蘭,2024-03-25,9686
6113,亞矽,16,0,16,富邦-宜蘭,2024-03-25,9686
6235,華孚,19,3,16,富邦-宜蘭,2024-03-25,9686
2449,京元電子,17,2,15,富邦-宜蘭,2024-03-25,9686
4526,東台,29,14,15,富邦-宜蘭,2024-03-25,9686
1217,愛之味,15,0,15,富邦-宜蘭,2024-03-25,9686
00753L,中信中國50正2,20,5,15,富邦-宜蘭,2024-03-25,9686
3379,彬台,15,0,15,富邦-宜蘭,2024-03-25,9686
00878,國泰永續高股息,36,22,14,富邦-宜蘭,2024-03-25,9686
4420,光明,16,2,14,富邦-宜蘭,2024-03-25,9686
1303,南亞,14,0,14,富邦-宜蘭,2024-03-25,9686
2382,廣達,21,8,13,富邦-宜蘭,2024-03-25,9686
00885,富邦越南,14,1,13,富邦-宜蘭,2024-03-25,9686
020038,元大ESG配息N,1254,0,1254,富邦-宜蘭,2024-03-26,9686
00757,統一FANG+,507,0,507,富邦-宜蘭,2024-03-26,9686
00919,群益台灣精選高息,493,95,398,富邦-宜蘭,2024-03-26,9686
00929,復華台灣科技優息,233,54,179,富邦-宜蘭,2024-03-26,9686
00939,統一台灣高息動能,275,122,153,富邦-宜蘭,2024-03-26,9686
00905,FT臺灣Smart,116,0,116,富邦-宜蘭,2024-03-26,9686
2611,志信,79,0,79,富邦-宜蘭,2024-03-26,9686
8936,國統,218,152,66,富邦-宜蘭,2024-03-26,9686
1616,億泰,80,21,59,富邦-宜蘭,2024-03-26,9686
5880,合庫金,59,0,59,富邦-宜蘭,2024-03-26,9686
2618,長榮航,65,7,58,富邦-宜蘭,2024-03-26,9686
2328,廣宇,53,0,53,富邦-宜蘭,2024-03-26,9686
1587,吉茂,52,0,52,富邦-宜蘭,2024-03-26,9686
00934,中信成長高股息,52,0,52,富邦-宜蘭,2024-03-26,9686
3059,華晶科,51,0,51,富邦-宜蘭,2024-03-26,9686
1514,亞力,75,27,48,富邦-宜蘭,2024-03-26,9686
2885,元大金,100,52,48,富邦-宜蘭,2024-03-26,9686
1109,信大,46,0,46,富邦-宜蘭,2024-03-26,9686
3231,緯創,113,67,46,富邦-宜蘭,2024-03-26,9686
2356,英業達,80,37,43,富邦-宜蘭,2024-03-26,9686
2609,陽明,52,9,43,富邦-宜蘭,2024-03-26,9686
00937B,群益ESG投等債20,80,38,42,富邦-宜蘭,2024-03-26,9686
2392,正崴,40,0,40,富邦-宜蘭,2024-03-26,9686
6216,居易,40,0,40,富邦-宜蘭,2024-03-26,9686
5531,鄉林,38,0,38,富邦-宜蘭,2024-03-26,9686
2834,臺企銀,36,0,36,富邦-宜蘭,2024-03-26,9686
00931B,統一美債20年,40,5,35,富邦-宜蘭,2024-03-26,9686
5521,工信,35,0,35,富邦-宜蘭,2024-03-26,9686
1611,中電,35,3,32,富邦-宜蘭,2024-03-26,9686
3481,群創,99,68,31,富邦-宜蘭,2024-03-26,9686
00673R,期元大S＆P原油反1,30,0,30,富邦-宜蘭,2024-03-26,9686
2543,皇昌,30,0,30,富邦-宜蘭,2024-03-26,9686
3163,波若威,42,13,29,富邦-宜蘭,2024-03-26,9686
2417,圓剛,34,6,28,富邦-宜蘭,2024-03-26,9686
2367,燿華,60,32,28,富邦-宜蘭,2024-03-26,9686
2409,友達,31,4,27,富邦-宜蘭,2024-03-26,9686
6188,廣明,37,10,27,富邦-宜蘭,2024-03-26,9686
00671R,富邦NASDAQ反1,25,0,25,富邦-宜蘭,2024-03-26,9686
6770,力積電,43,18,25,富邦-宜蘭,2024-03-26,9686
00918,大華優利高填息30,27,3,24,富邦-宜蘭,2024-03-26,9686
2332,友訊,24,0,24,富邦-宜蘭,2024-03-26,9686
2603,長榮,27,4,23,富邦-宜蘭,2024-03-26,9686
6023,元大期,22,0,22,富邦-宜蘭,2024-03-26,9686
6789,采鈺,24,3,21,富邦-宜蘭,2024-03-26,9686
4979,華星光,21,0,21,富邦-宜蘭,2024-03-26,9686
2313,華通,22,1,21,富邦-宜蘭,2024-03-26,9686
6163,華電網,28,7,21,富邦-宜蘭,2024-03-26,9686
1504,東元,79,58,21,富邦-宜蘭,2024-03-26,9686
00878,國泰永續高股息,33,12,21,富邦-宜蘭,2024-03-26,9686
6290,良維,35,16,19,富邦-宜蘭,2024-03-26,9686
00939,統一台灣高息動能,319,144,175,富邦-宜蘭,2024-03-27,9686
00905,FT臺灣Smart,145,1,144,富邦-宜蘭,2024-03-27,9686
1504,東元,107,10,97,富邦-宜蘭,2024-03-27,9686
3372,典範,97,1,96,富邦-宜蘭,2024-03-27,9686
1316,上曜,114,42,72,富邦-宜蘭,2024-03-27,9686
5880,合庫金,58,0,58,富邦-宜蘭,2024-03-27,9686
2365,昆盈,52,1,51,富邦-宜蘭,2024-03-27,9686
2303,聯電,58,20,38,富邦-宜蘭,2024-03-27,9686
2409,友達,38,1,37,富邦-宜蘭,2024-03-27,9686
2501,國建,30,0,30,富邦-宜蘭,2024-03-27,9686
00885,富邦越南,33,3,30,富邦-宜蘭,2024-03-27,9686
2301,光寶科,34,5,29,富邦-宜蘭,2024-03-27,9686
2356,英業達,56,30,26,富邦-宜蘭,2024-03-27,9686
00941,中信上游半導體,30,4,26,富邦-宜蘭,2024-03-27,9686
2211,長榮鋼,34,8,26,富邦-宜蘭,2024-03-27,9686
1529,樂事綠能,69,43,26,富邦-宜蘭,2024-03-27,9686
2464,盟立,68,44,24,富邦-宜蘭,2024-03-27,9686
2302,麗正,22,0,22,富邦-宜蘭,2024-03-27,9686
2417,圓剛,24,3,21,富邦-宜蘭,2024-03-27,9686
1587,吉茂,20,0,20,富邦-宜蘭,2024-03-27,9686
00725B,國泰投資級公司債,20,0,20,富邦-宜蘭,2024-03-27,9686
3672,康聯訊,26,6,20,富邦-宜蘭,2024-03-27,9686
4933,友輝,20,0,20,富邦-宜蘭,2024-03-27,9686
3231,緯創,51,32,19,富邦-宜蘭,2024-03-27,9686
2609,陽明,19,1,18,富邦-宜蘭,2024-03-27,9686
1611,中電,19,1,18,富邦-宜蘭,2024-03-27,9686
1101,台泥,19,1,18,富邦-宜蘭,2024-03-27,9686
1513,中興電,92,74,18,富邦-宜蘭,2024-03-27,9686
1608,華榮,133,116,17,富邦-宜蘭,2024-03-27,9686
2371,大同,81,64,17,富邦-宜蘭,2024-03-27,9686
6274,台燿,106,89,17,富邦-宜蘭,2024-03-27,9686
6139,亞翔,30,14,16,富邦-宜蘭,2024-03-27,9686
9958,世紀鋼,47,31,16,富邦-宜蘭,2024-03-27,9686
1215,卜蜂,16,0,16,富邦-宜蘭,2024-03-27,9686
1808,潤隆,27,12,15,富邦-宜蘭,2024-03-27,9686
4105,東洋,15,0,15,富邦-宜蘭,2024-03-27,9686
00650L,復華香港正2,15,0,15,富邦-宜蘭,2024-03-27,9686
3013,晟銘電,49,35,14,富邦-宜蘭,2024-03-27,9686
4714,永捷,28,14,14,富邦-宜蘭,2024-03-27,9686
1319,東陽,22,9,13,富邦-宜蘭,2024-03-27,9686
2392,正崴,36,24,12,富邦-宜蘭,2024-03-27,9686
2312,金寶,12,0,12,富邦-宜蘭,2024-03-27,9686
00857B,永豐20年美公債,12,0,12,富邦-宜蘭,2024-03-27,9686
00665L,富邦�琤肭磪囓�2,12,0,12,富邦-宜蘭,2024-03-27,9686
2359,所羅門,17,5,12,富邦-宜蘭,2024-03-27,9686
6188,廣明,17,5,12,富邦-宜蘭,2024-03-27,9686
00922,國泰台灣領袖50,12,1,11,富邦-宜蘭,2024-03-27,9686
2885,元大金,21,10,11,富邦-宜蘭,2024-03-27,9686
3607,谷崧,10,0,10,富邦-宜蘭,2024-03-27,9686
6026,福邦證,10,0,10,富邦-宜蘭,2024-03-27,9686
1608,華榮,341,16,325,富邦-宜蘭,2024-03-28,9686
00939,統一台灣高息動能,175,14,161,富邦-宜蘭,2024-03-28,9686
2883,凱基金,207,68,139,富邦-宜蘭,2024-03-28,9686
2630,亞航,123,5,118,富邦-宜蘭,2024-03-28,9686
2816,旺旺保,80,0,80,富邦-宜蘭,2024-03-28,9686
2014,中鴻,85,6,79,富邦-宜蘭,2024-03-28,9686
00919,群益台灣精選高息,144,80,64,富邦-宜蘭,2024-03-28,9686
3673,TPK-KY,57,4,53,富邦-宜蘭,2024-03-28,9686
00632R,元大台灣50反1,50,0,50,富邦-宜蘭,2024-03-28,9686
8092,建暐,50,1,49,富邦-宜蘭,2024-03-28,9686
00937B,群益ESG投等債20,71,23,48,富邦-宜蘭,2024-03-28,9686
6126,信音,47,0,47,富邦-宜蘭,2024-03-28,9686
1101,台泥,54,10,44,富邦-宜蘭,2024-03-28,9686
5324,士開,40,0,40,富邦-宜蘭,2024-03-28,9686
5309,系統電,70,31,39,富邦-宜蘭,2024-03-28,9686
00882,中信中國高股息,40,1,39,富邦-宜蘭,2024-03-28,9686
6244,茂迪,55,16,39,富邦-宜蘭,2024-03-28,9686
4105,東洋,38,0,38,富邦-宜蘭,2024-03-28,9686
3706,神達,57,23,34,富邦-宜蘭,2024-03-28,9686
2301,光寶科,52,21,31,富邦-宜蘭,2024-03-28,9686
5243,乙盛-KY,46,16,30,富邦-宜蘭,2024-03-28,9686
6265,方土昶,30,0,30,富邦-宜蘭,2024-03-28,9686
6206,飛捷,30,0,30,富邦-宜蘭,2024-03-28,9686
00679B,元大美債20年,27,0,27,富邦-宜蘭,2024-03-28,9686
2867,三商壽,28,1,27,富邦-宜蘭,2024-03-28,9686
3163,波若威,38,16,22,富邦-宜蘭,2024-03-28,9686
3055,蔚華科,22,0,22,富邦-宜蘭,2024-03-28,9686
6278,台表科,22,0,22,富邦-宜蘭,2024-03-28,9686
3437,榮創,30,9,21,富邦-宜蘭,2024-03-28,9686
00673R,期元大S＆P原油反1,20,0,20,富邦-宜蘭,2024-03-28,9686
6216,居易,20,0,20,富邦-宜蘭,2024-03-28,9686
2367,燿華,52,32,20,富邦-宜蘭,2024-03-28,9686
1720,生達,20,0,20,富邦-宜蘭,2024-03-28,9686
4906,正文,20,1,19,富邦-宜蘭,2024-03-28,9686
4306,炎洲,20,2,18,富邦-宜蘭,2024-03-28,9686
3005,神基,32,15,17,富邦-宜蘭,2024-03-28,9686
1514,亞力,21,5,16,富邦-宜蘭,2024-03-28,9686
00666R,富邦�琤肭磪齯�1,15,0,15,富邦-宜蘭,2024-03-28,9686
1609,大亞,24,10,14,富邦-宜蘭,2024-03-28,9686
1342,八貫,20,6,14,富邦-宜蘭,2024-03-28,9686
2417,圓剛,17,3,14,富邦-宜蘭,2024-03-28,9686
3707,漢磊,15,2,13,富邦-宜蘭,2024-03-28,9686
6929,佑全,12,0,12,富邦-宜蘭,2024-03-28,9686
6179,亞通,24,12,12,富邦-宜蘭,2024-03-28,9686
6282,康舒,20,8,12,富邦-宜蘭,2024-03-28,9686
2369,菱生,12,0,12,富邦-宜蘭,2024-03-28,9686
1229,聯華,12,0,12,富邦-宜蘭,2024-03-28,9686
2704,國賓,12,0,12,富邦-宜蘭,2024-03-28,9686
3581,博磊,12,0,12,富邦-宜蘭,2024-03-28,9686
5371,中光電,18,6,12,富邦-宜蘭,2024-03-28,9686
2882,國泰金,530,16,514,富邦-宜蘭,2024-03-29,9686
00937B,群益ESG投等債20,209,52,157,富邦-宜蘭,2024-03-29,9686
00929,復華台灣科技優息,128,18,110,富邦-宜蘭,2024-03-29,9686
00919,群益台灣精選高息,140,32,108,富邦-宜蘭,2024-03-29,9686
4562,穎漢,96,10,86,富邦-宜蘭,2024-03-29,9686
2324,仁寶,81,6,75,富邦-宜蘭,2024-03-29,9686
6753,龍德造船,72,4,68,富邦-宜蘭,2024-03-29,9686
2352,佳世達,59,8,51,富邦-宜蘭,2024-03-29,9686
5225,東科-KY,42,3,39,富邦-宜蘭,2024-03-29,9686
00885,富邦越南,37,0,37,富邦-宜蘭,2024-03-29,9686
00939,統一台灣高息動能,44,8,36,富邦-宜蘭,2024-03-29,9686
2504,國產,36,0,36,富邦-宜蘭,2024-03-29,9686
00720B,元大投資級公司債,40,4,36,富邦-宜蘭,2024-03-29,9686
6126,信音,41,6,35,富邦-宜蘭,2024-03-29,9686
2354,鴻準,82,49,33,富邦-宜蘭,2024-03-29,9686
4714,永捷,35,3,32,富邦-宜蘭,2024-03-29,9686
00632R,元大台灣50反1,31,0,31,富邦-宜蘭,2024-03-29,9686
4105,東洋,30,0,30,富邦-宜蘭,2024-03-29,9686
1608,華榮,45,15,30,富邦-宜蘭,2024-03-29,9686
2301,光寶科,48,19,29,富邦-宜蘭,2024-03-29,9686
3313,斐成,29,0,29,富邦-宜蘭,2024-03-29,9686
2317,鴻海,108,80,28,富邦-宜蘭,2024-03-29,9686
3706,神達,54,27,27,富邦-宜蘭,2024-03-29,9686
00650L,復華香港正2,26,0,26,富邦-宜蘭,2024-03-29,9686
2633,台灣高鐵,25,0,25,富邦-宜蘭,2024-03-29,9686
6116,彩晶,33,10,23,富邦-宜蘭,2024-03-29,9686
2303,聯電,55,33,22,富邦-宜蘭,2024-03-29,9686
2609,陽明,23,2,21,富邦-宜蘭,2024-03-29,9686
3712,永崴投控,21,0,21,富邦-宜蘭,2024-03-29,9686
2406,國碩,26,5,21,富邦-宜蘭,2024-03-29,9686
5515,建國,35,14,21,富邦-宜蘭,2024-03-29,9686
3380,明泰,20,0,20,富邦-宜蘭,2024-03-29,9686
2515,中工,30,11,19,富邦-宜蘭,2024-03-29,9686
5386,青雲,19,1,18,富邦-宜蘭,2024-03-29,9686
1815,富喬,38,21,17,富邦-宜蘭,2024-03-29,9686
2417,圓剛,27,10,17,富邦-宜蘭,2024-03-29,9686
1525,江申,17,0,17,富邦-宜蘭,2024-03-29,9686
1796,金穎生技,17,0,17,富邦-宜蘭,2024-03-29,9686
00753L,中信中國50正2,26,10,16,富邦-宜蘭,2024-03-29,9686
5009,榮剛,16,0,16,富邦-宜蘭,2024-03-29,9686
1504,東元,30,14,16,富邦-宜蘭,2024-03-29,9686
2409,友達,19,4,15,富邦-宜蘭,2024-03-29,9686
2543,皇昌,16,2,14,富邦-宜蘭,2024-03-29,9686
3481,群創,17,3,14,富邦-宜蘭,2024-03-29,9686
3450,聯鈞,13,0,13,富邦-宜蘭,2024-03-29,9686
2328,廣宇,15,3,12,富邦-宜蘭,2024-03-29,9686
5425,台半,14,2,12,富邦-宜蘭,2024-03-29,9686
3013,晟銘電,110,98,12,富邦-宜蘭,2024-03-29,9686
1806,冠軍,11,0,11,富邦-宜蘭,2024-03-29,9686
6179,亞通,11,0,11,富邦-宜蘭,2024-03-29,9686
00940,元大台灣價值高息,2205,307,1898,富邦-宜蘭,2024-04-01,9686
2344,華邦電,339,20,319,富邦-宜蘭,2024-04-01,9686
2349,錸德,313,0,313,富邦-宜蘭,2024-04-01,9686
00632R,元大台灣50反1,200,1,199,富邦-宜蘭,2024-04-01,9686
00939,統一台灣高息動能,157,5,152,富邦-宜蘭,2024-04-01,9686
5531,鄉林,119,0,119,富邦-宜蘭,2024-04-01,9686
00937B,群益ESG投等債20,121,18,103,富邦-宜蘭,2024-04-01,9686
3231,緯創,98,28,70,富邦-宜蘭,2024-04-01,9686
2352,佳世達,64,4,60,富邦-宜蘭,2024-04-01,9686
2547,日勝生,58,0,58,富邦-宜蘭,2024-04-01,9686
00751B,元大AAA至A公司債,59,5,54,富邦-宜蘭,2024-04-01,9686
4938,和碩,45,2,43,富邦-宜蘭,2024-04-01,9686
2317,鴻海,114,72,42,富邦-宜蘭,2024-04-01,9686
00941,中信上游半導體,63,22,41,富邦-宜蘭,2024-04-01,9686
2520,冠德,40,1,39,富邦-宜蘭,2024-04-01,9686
4188,安克,35,0,35,富邦-宜蘭,2024-04-01,9686
3313,斐成,31,0,31,富邦-宜蘭,2024-04-01,9686
2356,英業達,64,36,28,富邦-宜蘭,2024-04-01,9686
2882,國泰金,62,34,28,富邦-宜蘭,2024-04-01,9686
3706,神達,61,36,25,富邦-宜蘭,2024-04-01,9686
5225,東科-KY,45,20,25,富邦-宜蘭,2024-04-01,9686
2303,聯電,26,2,24,富邦-宜蘭,2024-04-01,9686
00885,富邦越南,33,11,22,富邦-宜蘭,2024-04-01,9686
3711,日月光投控,22,0,22,富邦-宜蘭,2024-04-01,9686
2382,廣達,62,41,21,富邦-宜蘭,2024-04-01,9686
1109,信大,20,0,20,富邦-宜蘭,2024-04-01,9686
8215,明基材,21,1,20,富邦-宜蘭,2024-04-01,9686
2597,潤弘,20,0,20,富邦-宜蘭,2024-04-01,9686
2834,臺企銀,26,6,20,富邦-宜蘭,2024-04-01,9686
2845,遠東銀,20,0,20,富邦-宜蘭,2024-04-01,9686
3481,群創,22,2,20,富邦-宜蘭,2024-04-01,9686
6139,亞翔,30,10,20,富邦-宜蘭,2024-04-01,9686
3516,亞帝歐,20,1,19,富邦-宜蘭,2024-04-01,9686
2301,光寶科,20,1,19,富邦-宜蘭,2024-04-01,9686
3059,華晶科,28,12,16,富邦-宜蘭,2024-04-01,9686
2603,長榮,26,10,16,富邦-宜蘭,2024-04-01,9686
8222,寶一,27,12,15,富邦-宜蘭,2024-04-01,9686
6274,台燿,42,28,14,富邦-宜蘭,2024-04-01,9686
00720B,元大投資級公司債,14,1,13,富邦-宜蘭,2024-04-01,9686
6284,佳邦,15,2,13,富邦-宜蘭,2024-04-01,9686
5434,崇越,12,0,12,富邦-宜蘭,2024-04-01,9686
2891,中信金,39,27,12,富邦-宜蘭,2024-04-01,9686
2354,鴻準,32,21,11,富邦-宜蘭,2024-04-01,9686
00637L,元大滬深300正2,137,126,11,富邦-宜蘭,2024-04-01,9686
5483,中美晶,16,5,11,富邦-宜蘭,2024-04-01,9686
6026,福邦證,11,0,11,富邦-宜蘭,2024-04-01,9686
6271,同欣電,17,6,11,富邦-宜蘭,2024-04-01,9686
00878,國泰永續高股息,40,29,11,富邦-宜蘭,2024-04-01,9686
5009,榮剛,11,0,11,富邦-宜蘭,2024-04-01,9686
1618,合機,11,0,11,富邦-宜蘭,2024-04-01,9686
00940,元大台灣價值高息,1227,514,713,富邦-宜蘭,2024-04-02,9686
00632R,元大台灣50反1,415,0,415,富邦-宜蘭,2024-04-02,9686
00929,復華台灣科技優息,320,83,237,富邦-宜蘭,2024-04-02,9686
00719B,元大美債1-3,150,0,150,富邦-宜蘭,2024-04-02,9686
5512,力麒,126,0,126,富邦-宜蘭,2024-04-02,9686
2834,臺企銀,125,3,122,富邦-宜蘭,2024-04-02,9686
00937B,群益ESG投等債20,169,62,107,富邦-宜蘭,2024-04-02,9686
00933B,國泰10Y+金融債,108,2,106,富邦-宜蘭,2024-04-02,9686
2312,金寶,88,0,88,富邦-宜蘭,2024-04-02,9686
1717,長興,76,10,66,富邦-宜蘭,2024-04-02,9686
2883,凱基金,67,1,66,富邦-宜蘭,2024-04-02,9686
00882,中信中國高股息,65,0,65,富邦-宜蘭,2024-04-02,9686
2371,大同,93,37,56,富邦-宜蘭,2024-04-02,9686
00931B,統一美債20年,54,0,54,富邦-宜蘭,2024-04-02,9686
2009,第一銅,76,23,53,富邦-宜蘭,2024-04-02,9686
00720B,元大投資級公司債,48,0,48,富邦-宜蘭,2024-04-02,9686
00941,中信上游半導體,58,10,48,富邦-宜蘭,2024-04-02,9686
00751B,元大AAA至A公司債,66,26,40,富邦-宜蘭,2024-04-02,9686
00712,復華富時不動產,39,0,39,富邦-宜蘭,2024-04-02,9686
00679B,元大美債20年,53,15,38,富邦-宜蘭,2024-04-02,9686
00877,復華中國5G,30,0,30,富邦-宜蘭,2024-04-02,9686
00687B,國泰20年美債,29,0,29,富邦-宜蘭,2024-04-02,9686
00688L,國泰20年美債正2,28,0,28,富邦-宜蘭,2024-04-02,9686
5426,振發,28,0,28,富邦-宜蘭,2024-04-02,9686
00857B,永豐20年美公債,26,0,26,富邦-宜蘭,2024-04-02,9686
6234,高僑,37,11,26,富邦-宜蘭,2024-04-02,9686
00764B,群益25年美債,25,0,25,富邦-宜蘭,2024-04-02,9686
1529,樂事綠能,23,0,23,富邦-宜蘭,2024-04-02,9686
2014,中鴻,22,0,22,富邦-宜蘭,2024-04-02,9686
00664R,國泰臺灣加權反1,20,0,20,富邦-宜蘭,2024-04-02,9686
2208,台船,21,1,20,富邦-宜蘭,2024-04-02,9686
8933,愛地雅,20,0,20,富邦-宜蘭,2024-04-02,9686
6213,聯茂,38,19,19,富邦-宜蘭,2024-04-02,9686
1301,台塑,17,0,17,富邦-宜蘭,2024-04-02,9686
3289,宜特,17,0,17,富邦-宜蘭,2024-04-02,9686
4714,永捷,20,4,16,富邦-宜蘭,2024-04-02,9686
3059,華晶科,25,9,16,富邦-宜蘭,2024-04-02,9686
2301,光寶科,34,18,16,富邦-宜蘭,2024-04-02,9686
8033,雷虎,25,10,15,富邦-宜蘭,2024-04-02,9686
6265,方土昶,15,0,15,富邦-宜蘭,2024-04-02,9686
00706L,期元大S＆P日圓正2,15,0,15,富邦-宜蘭,2024-04-02,9686
6191,精成科,17,2,15,富邦-宜蘭,2024-04-02,9686
5351,鈺創,19,4,15,富邦-宜蘭,2024-04-02,9686
2634,漢翔,22,7,15,富邦-宜蘭,2024-04-02,9686
3622,洋華,43,29,14,富邦-宜蘭,2024-04-02,9686
0056,元大高股息,15,2,13,富邦-宜蘭,2024-04-02,9686
2609,陽明,15,2,13,富邦-宜蘭,2024-04-02,9686
1504,東元,22,9,13,富邦-宜蘭,2024-04-02,9686
2450,神腦,13,0,13,富邦-宜蘭,2024-04-02,9686
1452,宏益,61,48,13,富邦-宜蘭,2024-04-02,9686
00929,復華台灣科技優息,478,13,465,富邦-宜蘭,2024-04-03,9686
00940,元大台灣價值高息,492,126,366,富邦-宜蘭,2024-04-03,9686
00941,中信上游半導體,234,12,222,富邦-宜蘭,2024-04-03,9686
00937B,群益ESG投等債20,112,2,110,富邦-宜蘭,2024-04-03,9686
2515,中工,138,66,72,富邦-宜蘭,2024-04-03,9686
00679B,元大美債20年,68,0,68,富邦-宜蘭,2024-04-03,9686
00687B,國泰20年美債,76,14,62,富邦-宜蘭,2024-04-03,9686
3481,群創,62,1,61,富邦-宜蘭,2024-04-03,9686
2409,友達,61,2,59,富邦-宜蘭,2024-04-03,9686
2641,正德,55,0,55,富邦-宜蘭,2024-04-03,9686
2317,鴻海,89,34,55,富邦-宜蘭,2024-04-03,9686
00692,富邦公司治理,54,0,54,富邦-宜蘭,2024-04-03,9686
2303,聯電,53,0,53,富邦-宜蘭,2024-04-03,9686
00934,中信成長高股息,51,1,50,富邦-宜蘭,2024-04-03,9686
2887,台新金,47,0,47,富邦-宜蘭,2024-04-03,9686
5443,均豪,103,59,44,富邦-宜蘭,2024-04-03,9686
00933B,國泰10Y+金融債,46,2,44,富邦-宜蘭,2024-04-03,9686
2618,長榮航,42,6,36,富邦-宜蘭,2024-04-03,9686
2610,華航,34,0,34,富邦-宜蘭,2024-04-03,9686
2359,所羅門,44,10,34,富邦-宜蘭,2024-04-03,9686
6265,方土昶,33,0,33,富邦-宜蘭,2024-04-03,9686
00751B,元大AAA至A公司債,35,3,32,富邦-宜蘭,2024-04-03,9686
00864B,中信美國公債0-1,31,0,31,富邦-宜蘭,2024-04-03,9686
00665L,富邦�琤肭磪囓�2,31,0,31,富邦-宜蘭,2024-04-03,9686
1316,上曜,35,4,31,富邦-宜蘭,2024-04-03,9686
00706L,期元大S＆P日圓正2,30,0,30,富邦-宜蘭,2024-04-03,9686
00897,富邦基因免疫生技,30,0,30,富邦-宜蘭,2024-04-03,9686
00931B,統一美債20年,30,0,30,富邦-宜蘭,2024-04-03,9686
2883,凱基金,36,6,30,富邦-宜蘭,2024-04-03,9686
2486,一詮,113,85,28,富邦-宜蘭,2024-04-03,9686
00633L,富邦上証正2,27,0,27,富邦-宜蘭,2024-04-03,9686
2504,國產,59,32,27,富邦-宜蘭,2024-04-03,9686
00688L,國泰20年美債正2,25,0,25,富邦-宜蘭,2024-04-03,9686
3673,TPK-KY,43,18,25,富邦-宜蘭,2024-04-03,9686
6213,聯茂,65,40,25,富邦-宜蘭,2024-04-03,9686
00680L,元大美債20正2,24,0,24,富邦-宜蘭,2024-04-03,9686
2332,友訊,24,0,24,富邦-宜蘭,2024-04-03,9686
00673R,期元大S＆P原油反1,29,6,23,富邦-宜蘭,2024-04-03,9686
0056,元大高股息,25,2,23,富邦-宜蘭,2024-04-03,9686
00733,富邦臺灣中小,22,1,21,富邦-宜蘭,2024-04-03,9686
2884,玉山金,21,0,21,富邦-宜蘭,2024-04-03,9686
5488,松普,21,0,21,富邦-宜蘭,2024-04-03,9686
2002,中鋼,28,8,20,富邦-宜蘭,2024-04-03,9686
1733,五鼎,20,0,20,富邦-宜蘭,2024-04-03,9686
00878,國泰永續高股息,19,0,19,富邦-宜蘭,2024-04-03,9686
2880,華南金,19,0,19,富邦-宜蘭,2024-04-03,9686
2301,光寶科,26,9,17,富邦-宜蘭,2024-04-03,9686
2537,聯上發,17,0,17,富邦-宜蘭,2024-04-03,9686
00720B,元大投資級公司債,17,0,17,富邦-宜蘭,2024-04-03,9686
2634,漢翔,20,3,17,富邦-宜蘭,2024-04-03,9686
00940,元大台灣價值高息,385,47,338,富邦-宜蘭,2024-04-08,9686
00929,復華台灣科技優息,277,15,262,富邦-宜蘭,2024-04-08,9686
00937B,群益ESG投等債20,178,21,157,富邦-宜蘭,2024-04-08,9686
00679B,元大美債20年,129,9,120,富邦-宜蘭,2024-04-08,9686
00941,中信上游半導體,125,10,115,富邦-宜蘭,2024-04-08,9686
00919,群益台灣精選高息,90,5,85,富邦-宜蘭,2024-04-08,9686
00751B,元大AAA至A公司債,73,3,70,富邦-宜蘭,2024-04-08,9686
2504,國產,126,63,63,富邦-宜蘭,2024-04-08,9686
6216,居易,54,0,54,富邦-宜蘭,2024-04-08,9686
00664R,國泰臺灣加權反1,50,0,50,富邦-宜蘭,2024-04-08,9686
6770,力積電,62,12,50,富邦-宜蘭,2024-04-08,9686
00933B,國泰10Y+金融債,48,2,46,富邦-宜蘭,2024-04-08,9686
5443,均豪,59,19,40,富邦-宜蘭,2024-04-08,9686
1609,大亞,55,18,37,富邦-宜蘭,2024-04-08,9686
4968,立積,36,2,34,富邦-宜蘭,2024-04-08,9686
00935,野村臺灣新科技50,31,0,31,富邦-宜蘭,2024-04-08,9686
00795B,中信美國公債20年,29,0,29,富邦-宜蘭,2024-04-08,9686
2618,長榮航,28,0,28,富邦-宜蘭,2024-04-08,9686
00637L,元大滬深300正2,28,0,28,富邦-宜蘭,2024-04-08,9686
1301,台塑,27,0,27,富邦-宜蘭,2024-04-08,9686
3027,盛達,29,2,27,富邦-宜蘭,2024-04-08,9686
4746,台耀,40,14,26,富邦-宜蘭,2024-04-08,9686
00939,統一台灣高息動能,39,13,26,富邦-宜蘭,2024-04-08,9686
2405,輔信,28,3,25,富邦-宜蘭,2024-04-08,9686
6125,廣運,35,10,25,富邦-宜蘭,2024-04-08,9686
00688L,國泰20年美債正2,24,0,24,富邦-宜蘭,2024-04-08,9686
2356,英業達,33,11,22,富邦-宜蘭,2024-04-08,9686
3055,蔚華科,21,0,21,富邦-宜蘭,2024-04-08,9686
3450,聯鈞,23,3,20,富邦-宜蘭,2024-04-08,9686
3481,群創,48,28,20,富邦-宜蘭,2024-04-08,9686
2375,凱美,20,0,20,富邦-宜蘭,2024-04-08,9686
3059,華晶科,36,17,19,富邦-宜蘭,2024-04-08,9686
1809,中釉,20,1,19,富邦-宜蘭,2024-04-08,9686
8155,博智,20,1,19,富邦-宜蘭,2024-04-08,9686
3231,緯創,52,33,19,富邦-宜蘭,2024-04-08,9686
2617,台航,18,0,18,富邦-宜蘭,2024-04-08,9686
2258,鴻華先進-創,16,0,16,富邦-宜蘭,2024-04-08,9686
5530,龍巖,16,0,16,富邦-宜蘭,2024-04-08,9686
2801,彰銀,16,0,16,富邦-宜蘭,2024-04-08,9686
1513,中興電,27,12,15,富邦-宜蘭,2024-04-08,9686
6548,長科*,18,2,16,富邦-宜蘭,2024-04-08,9686
3036,文曄,18,3,15,富邦-宜蘭,2024-04-08,9686
2359,所羅門,20,5,15,富邦-宜蘭,2024-04-08,9686
1785,光洋科,16,1,15,富邦-宜蘭,2024-04-08,9686
4157,太景*-KY,15,0,15,富邦-宜蘭,2024-04-08,9686
2501,國建,23,8,15,富邦-宜蘭,2024-04-08,9686
00687B,國泰20年美債,42,28,14,富邦-宜蘭,2024-04-08,9686
00720B,元大投資級公司債,17,3,14,富邦-宜蘭,2024-04-08,9686
4533,協易機,27,13,14,富邦-宜蘭,2024-04-08,9686
6190,萬泰科,14,0,14,富邦-宜蘭,2024-04-08,9686
3231,緯創,358,76,282,富邦-宜蘭,2024-04-09,9686
00940,元大台灣價值高息,201,79,122,富邦-宜蘭,2024-04-09,9686
00632R,元大台灣50反1,103,0,103,富邦-宜蘭,2024-04-09,9686
1701,中化,88,1,87,富邦-宜蘭,2024-04-09,9686
6188,廣明,86,16,70,富邦-宜蘭,2024-04-09,9686
00929,復華台灣科技優息,82,19,63,富邦-宜蘭,2024-04-09,9686
1587,吉茂,59,7,52,富邦-宜蘭,2024-04-09,9686
6113,亞矽,52,3,49,富邦-宜蘭,2024-04-09,9686
2025,千興,55,6,49,富邦-宜蘭,2024-04-09,9686
3360,尚立,50,3,47,富邦-宜蘭,2024-04-09,9686
2023,燁輝,61,15,46,富邦-宜蘭,2024-04-09,9686
2609,陽明,74,29,45,富邦-宜蘭,2024-04-09,9686
8088,品安,46,4,42,富邦-宜蘭,2024-04-09,9686
8155,博智,42,0,42,富邦-宜蘭,2024-04-09,9686
00919,群益台灣精選高息,97,55,42,富邦-宜蘭,2024-04-09,9686
6120,達運,43,2,41,富邦-宜蘭,2024-04-09,9686
6207,雷科,52,12,40,富邦-宜蘭,2024-04-09,9686
3289,宜特,36,0,36,富邦-宜蘭,2024-04-09,9686
00885,富邦越南,36,0,36,富邦-宜蘭,2024-04-09,9686
2371,大同,63,28,35,富邦-宜蘭,2024-04-09,9686
1618,合機,63,30,33,富邦-宜蘭,2024-04-09,9686
6015,宏遠證,42,10,32,富邦-宜蘭,2024-04-09,9686
8213,志超,31,0,31,富邦-宜蘭,2024-04-09,9686
6603,富強鑫,30,0,30,富邦-宜蘭,2024-04-09,9686
2453,凌群,36,7,29,富邦-宜蘭,2024-04-09,9686
6206,飛捷,28,0,28,富邦-宜蘭,2024-04-09,9686
2885,元大金,89,61,28,富邦-宜蘭,2024-04-09,9686
5388,中磊,26,0,26,富邦-宜蘭,2024-04-09,9686
912000,晨訊科-DR,27,1,26,富邦-宜蘭,2024-04-09,9686
2028,威致,27,1,26,富邦-宜蘭,2024-04-09,9686
910861,神州-DR,23,0,23,富邦-宜蘭,2024-04-09,9686
6163,華電網,25,2,23,富邦-宜蘭,2024-04-09,9686
3029,零壹,43,20,23,富邦-宜蘭,2024-04-09,9686
6282,康舒,23,1,22,富邦-宜蘭,2024-04-09,9686
3555,博士旺,21,0,21,富邦-宜蘭,2024-04-09,9686
3042,晶技,21,1,20,富邦-宜蘭,2024-04-09,9686
5533,皇鼎,20,0,20,富邦-宜蘭,2024-04-09,9686
9955,佳龍,51,31,20,富邦-宜蘭,2024-04-09,9686
00673R,期元大S＆P原油反1,20,0,20,富邦-宜蘭,2024-04-09,9686
5324,士開,21,1,20,富邦-宜蘭,2024-04-09,9686
5701,劍湖山,20,0,20,富邦-宜蘭,2024-04-09,9686
2486,一詮,69,50,19,富邦-宜蘭,2024-04-09,9686
5211,蒙恬,19,0,19,富邦-宜蘭,2024-04-09,9686
4105,東洋,18,0,18,富邦-宜蘭,2024-04-09,9686
2354,鴻準,30,12,18,富邦-宜蘭,2024-04-09,9686
00941,中信上游半導體,20,3,17,富邦-宜蘭,2024-04-09,9686
00927,群益半導體收益,17,0,17,富邦-宜蘭,2024-04-09,9686
2611,志信,17,0,17,富邦-宜蘭,2024-04-09,9686
00637L,元大滬深300正2,17,0,17,富邦-宜蘭,2024-04-09,9686
2509,全坤建,17,0,17,富邦-宜蘭,2024-04-09,9686
00632R,元大台灣50反1,131,0,131,富邦-宜蘭,2024-04-10,9686
00937B,群益ESG投等債20,127,0,127,富邦-宜蘭,2024-04-10,9686
1608,華榮,243,139,104,富邦-宜蘭,2024-04-10,9686
2007,燁興,89,1,88,富邦-宜蘭,2024-04-10,9686
6770,力積電,89,13,76,富邦-宜蘭,2024-04-10,9686
2547,日勝生,75,0,75,富邦-宜蘭,2024-04-10,9686
2023,燁輝,79,5,74,富邦-宜蘭,2024-04-10,9686
2427,三商電,75,5,70,富邦-宜蘭,2024-04-10,9686
2025,千興,74,5,69,富邦-宜蘭,2024-04-10,9686
1789,神隆,67,2,65,富邦-宜蘭,2024-04-10,9686
3312,弘憶股,83,32,51,富邦-宜蘭,2024-04-10,9686
2634,漢翔,85,35,50,富邦-宜蘭,2024-04-10,9686
1815,富喬,53,3,50,富邦-宜蘭,2024-04-10,9686
3673,TPK-KY,50,1,49,富邦-宜蘭,2024-04-10,9686
9933,中鼎,50,2,48,富邦-宜蘭,2024-04-10,9686
1453,大將,50,2,48,富邦-宜蘭,2024-04-10,9686
2883,凱基金,50,4,46,富邦-宜蘭,2024-04-10,9686
00877,復華中國5G,50,5,45,富邦-宜蘭,2024-04-10,9686
2374,佳能,48,6,42,富邦-宜蘭,2024-04-10,9686
2317,鴻海,67,26,41,富邦-宜蘭,2024-04-10,9686
00933B,國泰10Y+金融債,44,6,38,富邦-宜蘭,2024-04-10,9686
8411,福貞-KY,35,0,35,富邦-宜蘭,2024-04-10,9686
5009,榮剛,110,77,33,富邦-宜蘭,2024-04-10,9686
2515,中工,78,46,32,富邦-宜蘭,2024-04-10,9686
2514,龍邦,36,5,31,富邦-宜蘭,2024-04-10,9686
8121,越峰,30,2,28,富邦-宜蘭,2024-04-10,9686
3576,聯合再生,48,20,28,富邦-宜蘭,2024-04-10,9686
2882,國泰金,27,0,27,富邦-宜蘭,2024-04-10,9686
00909,國泰數位支付服務,25,0,25,富邦-宜蘭,2024-04-10,9686
2376,技嘉,45,21,24,富邦-宜蘭,2024-04-10,9686
6215,和椿,40,17,23,富邦-宜蘭,2024-04-10,9686
3481,群創,55,33,22,富邦-宜蘭,2024-04-10,9686
1734,杏輝,21,0,21,富邦-宜蘭,2024-04-10,9686
3499,環天科,23,2,21,富邦-宜蘭,2024-04-10,9686
2883B,凱基金乙特,21,0,21,富邦-宜蘭,2024-04-10,9686
2382,廣達,31,10,21,富邦-宜蘭,2024-04-10,9686
2332,友訊,22,2,20,富邦-宜蘭,2024-04-10,9686
5864,致和證,20,0,20,富邦-宜蘭,2024-04-10,9686
6264,富裔,20,0,20,富邦-宜蘭,2024-04-10,9686
3055,蔚華科,21,1,20,富邦-宜蘭,2024-04-10,9686
00673R,期元大S＆P原油反1,20,0,20,富邦-宜蘭,2024-04-10,9686
8213,志超,20,0,20,富邦-宜蘭,2024-04-10,9686
00893,國泰智能電動車,20,1,19,富邦-宜蘭,2024-04-10,9686
00905,FT臺灣Smart,19,0,19,富邦-宜蘭,2024-04-10,9686
6213,聯茂,42,24,18,富邦-宜蘭,2024-04-10,9686
00885,富邦越南,22,4,18,富邦-宜蘭,2024-04-10,9686
6207,雷科,27,10,17,富邦-宜蘭,2024-04-10,9686
2609,陽明,30,13,17,富邦-宜蘭,2024-04-10,9686
1597,直得,17,0,17,富邦-宜蘭,2024-04-10,9686
5531,鄉林,17,0,17,富邦-宜蘭,2024-04-10,9686
1789,神隆,295,1,294,富邦-宜蘭,2024-04-11,9686
3481,群創,212,9,203,富邦-宜蘭,2024-04-11,9686
1314,中石化,154,0,154,富邦-宜蘭,2024-04-11,9686
2506,太設,128,14,114,富邦-宜蘭,2024-04-11,9686
00712,復華富時不動產,111,0,111,富邦-宜蘭,2024-04-11,9686
4155,訊映,110,0,110,富邦-宜蘭,2024-04-11,9686
8213,志超,110,0,110,富邦-宜蘭,2024-04-11,9686
00937B,群益ESG投等債20,110,1,109,富邦-宜蘭,2024-04-11,9686
00671R,富邦NASDAQ反1,90,0,90,富邦-宜蘭,2024-04-11,9686
2303,聯電,85,7,78,富邦-宜蘭,2024-04-11,9686
5324,士開,76,0,76,富邦-宜蘭,2024-04-11,9686
2884,玉山金,80,4,76,富邦-宜蘭,2024-04-11,9686
2329,華泰,114,45,69,富邦-宜蘭,2024-04-11,9686
4164,承業醫,67,1,66,富邦-宜蘭,2024-04-11,9686
00751B,元大AAA至A公司債,72,7,65,富邦-宜蘭,2024-04-11,9686
00929,復華台灣科技優息,97,33,64,富邦-宜蘭,2024-04-11,9686
2816,旺旺保,60,0,60,富邦-宜蘭,2024-04-11,9686
00664R,國泰臺灣加權反1,60,0,60,富邦-宜蘭,2024-04-11,9686
00679B,元大美債20年,73,13,60,富邦-宜蘭,2024-04-11,9686
0056,元大高股息,63,4,59,富邦-宜蘭,2024-04-11,9686
00933B,國泰10Y+金融債,78,22,56,富邦-宜蘭,2024-04-11,9686
2882,國泰金,80,25,55,富邦-宜蘭,2024-04-11,9686
3576,聯合再生,54,2,52,富邦-宜蘭,2024-04-11,9686
8092,建暐,50,0,50,富邦-宜蘭,2024-04-11,9686
2889,國票金,50,0,50,富邦-宜蘭,2024-04-11,9686
4113,聯上,50,0,50,富邦-宜蘭,2024-04-11,9686
4513,福裕,51,2,49,富邦-宜蘭,2024-04-11,9686
2409,友達,45,2,43,富邦-宜蘭,2024-04-11,9686
6215,和椿,48,14,34,富邦-宜蘭,2024-04-11,9686
00941,中信上游半導體,35,1,34,富邦-宜蘭,2024-04-11,9686
00939,統一台灣高息動能,33,0,33,富邦-宜蘭,2024-04-11,9686
3450,聯鈞,33,0,33,富邦-宜蘭,2024-04-11,9686
2731,雄獅,36,4,32,富邦-宜蘭,2024-04-11,9686
9958,世紀鋼,46,15,31,富邦-宜蘭,2024-04-11,9686
2618,長榮航,218,188,30,富邦-宜蘭,2024-04-11,9686
00687B,國泰20年美債,30,0,30,富邦-宜蘭,2024-04-11,9686
00857B,永豐20年美公債,40,12,28,富邦-宜蘭,2024-04-11,9686
9945,潤泰新,27,0,27,富邦-宜蘭,2024-04-11,9686
2834,臺企銀,33,6,27,富邦-宜蘭,2024-04-11,9686
6233,旺玖,25,0,25,富邦-宜蘭,2024-04-11,9686
3231,緯創,49,26,23,富邦-宜蘭,2024-04-11,9686
8096,擎亞,54,31,23,富邦-宜蘭,2024-04-11,9686
1618,合機,23,1,22,富邦-宜蘭,2024-04-11,9686
1326,台化,22,0,22,富邦-宜蘭,2024-04-11,9686
2371,大同,50,28,22,富邦-宜蘭,2024-04-11,9686
3260,威剛,30,9,21,富邦-宜蘭,2024-04-11,9686
912000,晨訊科-DR,30,9,21,富邦-宜蘭,2024-04-11,9686
3714,富采,21,0,21,富邦-宜蘭,2024-04-11,9686
00688L,國泰20年美債正2,32,12,20,富邦-宜蘭,2024-04-11,9686
2355,敬鵬,20,0,20,富邦-宜蘭,2024-04-11,9686
2352,佳世達,225,2,223,富邦-宜蘭,2024-04-12,9686
00929,復華台灣科技優息,185,2,183,富邦-宜蘭,2024-04-12,9686
6216,居易,170,0,170,富邦-宜蘭,2024-04-12,9686
00937B,群益ESG投等債20,157,6,151,富邦-宜蘭,2024-04-12,9686
6125,廣運,180,41,139,富邦-宜蘭,2024-04-12,9686
00940,元大台灣價值高息,261,136,125,富邦-宜蘭,2024-04-12,9686
3481,群創,122,17,105,富邦-宜蘭,2024-04-12,9686
2402,毅嘉,103,0,103,富邦-宜蘭,2024-04-12,9686
2618,長榮航,78,5,73,富邦-宜蘭,2024-04-12,9686
2504,國產,66,2,64,富邦-宜蘭,2024-04-12,9686
8096,擎亞,158,94,64,富邦-宜蘭,2024-04-12,9686
3231,緯創,84,25,59,富邦-宜蘭,2024-04-12,9686
2883,凱基金,59,2,57,富邦-宜蘭,2024-04-12,9686
2834,臺企銀,55,0,55,富邦-宜蘭,2024-04-12,9686
2610,華航,74,20,54,富邦-宜蘭,2024-04-12,9686
00679B,元大美債20年,55,2,53,富邦-宜蘭,2024-04-12,9686
00927,群益半導體收益,50,0,50,富邦-宜蘭,2024-04-12,9686
2353,宏��,228,178,50,富邦-宜蘭,2024-04-12,9686
2363,矽統,319,270,49,富邦-宜蘭,2024-04-12,9686
1453,大將,57,9,48,富邦-宜蘭,2024-04-12,9686
2888,新光金,47,0,47,富邦-宜蘭,2024-04-12,9686
00671R,富邦NASDAQ反1,45,0,45,富邦-宜蘭,2024-04-12,9686
3354,律勝,52,12,40,富邦-宜蘭,2024-04-12,9686
00751B,元大AAA至A公司債,39,0,39,富邦-宜蘭,2024-04-12,9686
4513,福裕,51,12,39,富邦-宜蘭,2024-04-12,9686
00687B,國泰20年美債,58,21,37,富邦-宜蘭,2024-04-12,9686
00680L,元大美債20正2,37,0,37,富邦-宜蘭,2024-04-12,9686
3615,安可,118,83,35,富邦-宜蘭,2024-04-12,9686
00665L,富邦�琤肭磪囓�2,45,10,35,富邦-宜蘭,2024-04-12,9686
2464,盟立,48,13,35,富邦-宜蘭,2024-04-12,9686
2611,志信,31,0,31,富邦-宜蘭,2024-04-12,9686
3402,漢科,31,2,29,富邦-宜蘭,2024-04-12,9686
1733,五鼎,30,3,27,富邦-宜蘭,2024-04-12,9686
2382,廣達,33,7,26,富邦-宜蘭,2024-04-12,9686
2344,華邦電,39,13,26,富邦-宜蘭,2024-04-12,9686
1442,名軒,26,0,26,富邦-宜蘭,2024-04-12,9686
00753L,中信中國50正2,26,0,26,富邦-宜蘭,2024-04-12,9686
8358,金居,26,0,26,富邦-宜蘭,2024-04-12,9686
3059,華晶科,46,24,22,富邦-宜蘭,2024-04-12,9686
8936,國統,32,11,21,富邦-宜蘭,2024-04-12,9686
2427,三商電,60,40,20,富邦-宜蘭,2024-04-12,9686
1301,台塑,19,0,19,富邦-宜蘭,2024-04-12,9686
4105,東洋,19,0,19,富邦-宜蘭,2024-04-12,9686
3714,富采,19,0,19,富邦-宜蘭,2024-04-12,9686
2101,南港,22,3,19,富邦-宜蘭,2024-04-12,9686
2409,友達,21,2,19,富邦-宜蘭,2024-04-12,9686
2634,漢翔,29,11,18,富邦-宜蘭,2024-04-12,9686
2457,飛宏,18,0,18,富邦-宜蘭,2024-04-12,9686
00764B,群益25年美債,17,0,17,富邦-宜蘭,2024-04-12,9686
2449,京元電子,29,12,17,富邦-宜蘭,2024-04-12,9686
00692,富邦公司治理,360,0,360,富邦-宜蘭,2024-04-15,9686
00929,復華台灣科技優息,352,42,310,富邦-宜蘭,2024-04-15,9686
2543,皇昌,195,23,172,富邦-宜蘭,2024-04-15,9686
2367,燿華,158,33,125,富邦-宜蘭,2024-04-15,9686
1609,大亞,207,82,125,富邦-宜蘭,2024-04-15,9686
2402,毅嘉,110,1,109,富邦-宜蘭,2024-04-15,9686
4155,訊映,105,0,105,富邦-宜蘭,2024-04-15,9686
1605,華新,139,71,68,富邦-宜蘭,2024-04-15,9686
3294,英濟,71,5,66,富邦-宜蘭,2024-04-15,9686
2618,長榮航,65,0,65,富邦-宜蘭,2024-04-15,9686
2303,聯電,72,14,58,富邦-宜蘭,2024-04-15,9686
1304,台聚,95,38,57,富邦-宜蘭,2024-04-15,9686
00919,群益台灣精選高息,86,30,56,富邦-宜蘭,2024-04-15,9686
2371,大同,243,189,54,富邦-宜蘭,2024-04-15,9686
00939,統一台灣高息動能,65,13,52,富邦-宜蘭,2024-04-15,9686
1504,東元,119,68,51,富邦-宜蘭,2024-04-15,9686
00933B,國泰10Y+金融債,64,13,51,富邦-宜蘭,2024-04-15,9686
2538,基泰,50,0,50,富邦-宜蘭,2024-04-15,9686
1513,中興電,120,72,48,富邦-宜蘭,2024-04-15,9686
3059,華晶科,52,6,46,富邦-宜蘭,2024-04-15,9686
2374,佳能,98,54,44,富邦-宜蘭,2024-04-15,9686
00665L,富邦�琤肭磪囓�2,44,0,44,富邦-宜蘭,2024-04-15,9686
4919,新唐,40,1,39,富邦-宜蘭,2024-04-15,9686
2883,凱基金,66,28,38,富邦-宜蘭,2024-04-15,9686
2344,華邦電,35,1,34,富邦-宜蘭,2024-04-15,9686
6188,廣明,35,1,34,富邦-宜蘭,2024-04-15,9686
3481,群創,82,50,32,富邦-宜蘭,2024-04-15,9686
0056,元大高股息,55,24,31,富邦-宜蘭,2024-04-15,9686
2356,英業達,43,12,31,富邦-宜蘭,2024-04-15,9686
00650L,復華香港正2,30,0,30,富邦-宜蘭,2024-04-15,9686
3622,洋華,42,14,28,富邦-宜蘭,2024-04-15,9686
1514,亞力,197,170,27,富邦-宜蘭,2024-04-15,9686
00715L,期街口布蘭特正2,27,3,24,富邦-宜蘭,2024-04-15,9686
5009,榮剛,38,15,23,富邦-宜蘭,2024-04-15,9686
2365,昆盈,24,1,23,富邦-宜蘭,2024-04-15,9686
2605,新興,25,2,23,富邦-宜蘭,2024-04-15,9686
2317,鴻海,47,25,22,富邦-宜蘭,2024-04-15,9686
2610,華航,25,3,22,富邦-宜蘭,2024-04-15,9686
00927,群益半導體收益,22,0,22,富邦-宜蘭,2024-04-15,9686
4164,承業醫,22,0,22,富邦-宜蘭,2024-04-15,9686
2408,南亞科,32,11,21,富邦-宜蘭,2024-04-15,9686
2208,台船,23,2,21,富邦-宜蘭,2024-04-15,9686
3712,永崴投控,34,13,21,富邦-宜蘭,2024-04-15,9686
2025,千興,24,3,21,富邦-宜蘭,2024-04-15,9686
00753L,中信中國50正2,28,8,20,富邦-宜蘭,2024-04-15,9686
2836,高雄銀,20,0,20,富邦-宜蘭,2024-04-15,9686
910861,神州-DR,20,0,20,富邦-宜蘭,2024-04-15,9686
00712,復華富時不動產,20,0,20,富邦-宜蘭,2024-04-15,9686
00733,富邦臺灣中小,20,0,20,富邦-宜蘭,2024-04-15,9686
2630,亞航,63,44,19,富邦-宜蘭,2024-04-15,9686
00940,元大台灣價值高息,995,130,865,富邦-宜蘭,2024-04-16,9686
00929,復華台灣科技優息,419,32,387,富邦-宜蘭,2024-04-16,9686
00937B,群益ESG投等債20,543,200,343,富邦-宜蘭,2024-04-16,9686
2867,三商壽,339,83,256,富邦-宜蘭,2024-04-16,9686
00933B,國泰10Y+金融債,258,21,237,富邦-宜蘭,2024-04-16,9686
00919,群益台灣精選高息,315,86,229,富邦-宜蘭,2024-04-16,9686
2834,臺企銀,204,19,185,富邦-宜蘭,2024-04-16,9686
00939,統一台灣高息動能,146,0,146,富邦-宜蘭,2024-04-16,9686
0056,元大高股息,146,13,133,富邦-宜蘭,2024-04-16,9686
00878,國泰永續高股息,173,47,126,富邦-宜蘭,2024-04-16,9686
2303,聯電,136,20,116,富邦-宜蘭,2024-04-16,9686
2610,華航,121,12,109,富邦-宜蘭,2024-04-16,9686
00719B,元大美債1-3,100,0,100,富邦-宜蘭,2024-04-16,9686
3231,緯創,125,25,100,富邦-宜蘭,2024-04-16,9686
4155,訊映,99,0,99,富邦-宜蘭,2024-04-16,9686
00918,大華優利高填息30,90,5,85,富邦-宜蘭,2024-04-16,9686
2887,台新金,88,6,82,富邦-宜蘭,2024-04-16,9686
2618,長榮航,120,39,81,富邦-宜蘭,2024-04-16,9686
2344,華邦電,88,14,74,富邦-宜蘭,2024-04-16,9686
2014,中鴻,72,1,71,富邦-宜蘭,2024-04-16,9686
2399,映泰,57,0,57,富邦-宜蘭,2024-04-16,9686
00679B,元大美債20年,54,0,54,富邦-宜蘭,2024-04-16,9686
2634,漢翔,65,12,53,富邦-宜蘭,2024-04-16,9686
2892,第一金,61,7,54,富邦-宜蘭,2024-04-16,9686
2880,華南金,57,5,52,富邦-宜蘭,2024-04-16,9686
3059,華晶科,111,60,51,富邦-宜蘭,2024-04-16,9686
6026,福邦證,51,0,51,富邦-宜蘭,2024-04-16,9686
1609,大亞,187,137,50,富邦-宜蘭,2024-04-16,9686
5880,合庫金,55,6,49,富邦-宜蘭,2024-04-16,9686
3481,群創,64,16,48,富邦-宜蘭,2024-04-16,9686
6111,大宇資,40,0,40,富邦-宜蘭,2024-04-16,9686
5521,工信,41,2,39,富邦-宜蘭,2024-04-16,9686
1603,華電,41,3,38,富邦-宜蘭,2024-04-16,9686
6125,廣運,42,4,38,富邦-宜蘭,2024-04-16,9686
2317,鴻海,92,56,36,富邦-宜蘭,2024-04-16,9686
00706L,期元大S＆P日圓正2,35,0,35,富邦-宜蘭,2024-04-16,9686
1301,台塑,33,1,32,富邦-宜蘭,2024-04-16,9686
2812,台中銀,31,0,31,富邦-宜蘭,2024-04-16,9686
00897,富邦基因免疫生技,30,0,30,富邦-宜蘭,2024-04-16,9686
8936,國統,33,4,29,富邦-宜蘭,2024-04-16,9686
5434,崇越,44,16,28,富邦-宜蘭,2024-04-16,9686
2330,台積電,34,7,27,富邦-宜蘭,2024-04-16,9686
2884,玉山金,30,4,26,富邦-宜蘭,2024-04-16,9686
6206,飛捷,25,0,25,富邦-宜蘭,2024-04-16,9686
1618,合機,133,109,24,富邦-宜蘭,2024-04-16,9686
5425,台半,24,0,24,富邦-宜蘭,2024-04-16,9686
6605,帝寶,25,1,24,富邦-宜蘭,2024-04-16,9686
3260,威剛,31,7,24,富邦-宜蘭,2024-04-16,9686
1617,榮星,27,4,23,富邦-宜蘭,2024-04-16,9686
2537,聯上發,24,2,22,富邦-宜蘭,2024-04-16,9686
00632R,元大台灣50反1,521,4,517,富邦-宜蘭,2024-04-17,9686
00937B,群益ESG投等債20,412,25,387,富邦-宜蘭,2024-04-17,9686
00929,復華台灣科技優息,181,17,164,富邦-宜蘭,2024-04-17,9686
2885,元大金,154,0,154,富邦-宜蘭,2024-04-17,9686
00712,復華富時不動產,161,11,150,富邦-宜蘭,2024-04-17,9686
00905,FT臺灣Smart,129,0,129,富邦-宜蘭,2024-04-17,9686
1815,富喬,125,11,114,富邦-宜蘭,2024-04-17,9686
1618,合機,119,12,107,富邦-宜蘭,2024-04-17,9686
00665L,富邦�琤肭磪囓�2,105,0,105,富邦-宜蘭,2024-04-17,9686
00878,國泰永續高股息,117,14,103,富邦-宜蘭,2024-04-17,9686
0056,元大高股息,97,3,94,富邦-宜蘭,2024-04-17,9686
3490,單井,110,26,84,富邦-宜蘭,2024-04-17,9686
1605,華新,291,217,74,富邦-宜蘭,2024-04-17,9686
2892,第一金,51,5,46,富邦-宜蘭,2024-04-17,9686
2352,佳世達,53,10,43,富邦-宜蘭,2024-04-17,9686
5512,力麒,55,12,43,富邦-宜蘭,2024-04-17,9686
00933B,國泰10Y+金融債,51,10,41,富邦-宜蘭,2024-04-17,9686
6770,力積電,47,7,40,富邦-宜蘭,2024-04-17,9686
00720B,元大投資級公司債,40,0,40,富邦-宜蘭,2024-04-17,9686
2537,聯上發,41,3,38,富邦-宜蘭,2024-04-17,9686
9934,成霖,36,0,36,富邦-宜蘭,2024-04-17,9686
3027,盛達,56,21,35,富邦-宜蘭,2024-04-17,9686
3059,華晶科,51,17,34,富邦-宜蘭,2024-04-17,9686
00753L,中信中國50正2,33,0,33,富邦-宜蘭,2024-04-17,9686
00940,元大台灣價值高息,130,98,32,富邦-宜蘭,2024-04-17,9686
3231,緯創,67,36,31,富邦-宜蘭,2024-04-17,9686
1612,宏泰,48,18,30,富邦-宜蘭,2024-04-17,9686
3219,倚強科,31,3,28,富邦-宜蘭,2024-04-17,9686
6120,達運,25,0,25,富邦-宜蘭,2024-04-17,9686
2002,中鋼,28,5,23,富邦-宜蘭,2024-04-17,9686
5880,合庫金,23,0,23,富邦-宜蘭,2024-04-17,9686
1504,東元,73,51,22,富邦-宜蘭,2024-04-17,9686
00751B,元大AAA至A公司債,27,5,22,富邦-宜蘭,2024-04-17,9686
2101,南港,31,9,22,富邦-宜蘭,2024-04-17,9686
00650L,復華香港正2,27,5,22,富邦-宜蘭,2024-04-17,9686
5534,長虹,30,8,22,富邦-宜蘭,2024-04-17,9686
2382,廣達,36,15,21,富邦-宜蘭,2024-04-17,9686
00885,富邦越南,20,0,20,富邦-宜蘭,2024-04-17,9686
2408,南亞科,22,2,20,富邦-宜蘭,2024-04-17,9686
6244,茂迪,20,0,20,富邦-宜蘭,2024-04-17,9686
3062,建漢,20,0,20,富邦-宜蘭,2024-04-17,9686
6605,帝寶,20,0,20,富邦-宜蘭,2024-04-17,9686
00679B,元大美債20年,32,14,18,富邦-宜蘭,2024-04-17,9686
8033,雷虎,20,2,18,富邦-宜蘭,2024-04-17,9686
00772B,中信高評級公司債,18,0,18,富邦-宜蘭,2024-04-17,9686
8440,綠電,35,17,18,富邦-宜蘭,2024-04-17,9686
3555,博士旺,18,0,18,富邦-宜蘭,2024-04-17,9686
00706L,期元大S＆P日圓正2,18,0,18,富邦-宜蘭,2024-04-17,9686
1326,台化,17,0,17,富邦-宜蘭,2024-04-17,9686
00939,統一台灣高息動能,27,10,17,富邦-宜蘭,2024-04-17,9686
00632R,元大台灣50反1,908,0,908,富邦-宜蘭,2024-04-18,9686
00664R,國泰臺灣加權反1,800,0,800,富邦-宜蘭,2024-04-18,9686
00676R,富邦臺灣加權反1,300,0,300,富邦-宜蘭,2024-04-18,9686
1605,華新,377,234,143,富邦-宜蘭,2024-04-18,9686
2891,中信金,93,5,88,富邦-宜蘭,2024-04-18,9686
00937B,群益ESG投等債20,141,64,77,富邦-宜蘭,2024-04-18,9686
00942B,台新美A公司債20+,68,0,68,富邦-宜蘭,2024-04-18,9686
5230,雷笛克光學,84,21,63,富邦-宜蘭,2024-04-18,9686
4167,松瑞藥,59,0,59,富邦-宜蘭,2024-04-18,9686
2007,燁興,62,4,58,富邦-宜蘭,2024-04-18,9686
00712,復華富時不動產,74,18,56,富邦-宜蘭,2024-04-18,9686
00902,中信電池及儲能,54,0,54,富邦-宜蘭,2024-04-18,9686
9940,信義,50,0,50,富邦-宜蘭,2024-04-18,9686
2457,飛宏,53,4,49,富邦-宜蘭,2024-04-18,9686
4556,旭然,40,0,40,富邦-宜蘭,2024-04-18,9686
00941,中信上游半導體,52,13,39,富邦-宜蘭,2024-04-18,9686
4919,新唐,43,5,38,富邦-宜蘭,2024-04-18,9686
8926,台汽電,52,15,37,富邦-宜蘭,2024-04-18,9686
5009,榮剛,40,3,37,富邦-宜蘭,2024-04-18,9686
2610,華航,53,16,37,富邦-宜蘭,2024-04-18,9686
5534,長虹,47,12,35,富邦-宜蘭,2024-04-18,9686
8155,博智,35,0,35,富邦-宜蘭,2024-04-18,9686
0056,元大高股息,59,25,34,富邦-宜蘭,2024-04-18,9686
6023,元大期,34,0,34,富邦-宜蘭,2024-04-18,9686
1504,東元,71,39,32,富邦-宜蘭,2024-04-18,9686
8064,東捷,35,4,31,富邦-宜蘭,2024-04-18,9686
6288,聯嘉,30,0,30,富邦-宜蘭,2024-04-18,9686
2367,燿華,77,48,29,富邦-宜蘭,2024-04-18,9686
2303,聯電,40,13,27,富邦-宜蘭,2024-04-18,9686
3707,漢磊,61,34,27,富邦-宜蘭,2024-04-18,9686
2408,南亞科,28,2,26,富邦-宜蘭,2024-04-18,9686
2504,國產,73,47,26,富邦-宜蘭,2024-04-18,9686
4142,國光生,26,2,24,富邦-宜蘭,2024-04-18,9686
3481,群創,38,15,23,富邦-宜蘭,2024-04-18,9686
1312,國喬,20,0,20,富邦-宜蘭,2024-04-18,9686
2348,海悅,20,0,20,富邦-宜蘭,2024-04-18,9686
6770,力積電,31,12,19,富邦-宜蘭,2024-04-18,9686
2061,風青,21,2,19,富邦-宜蘭,2024-04-18,9686
2353,宏��,24,5,19,富邦-宜蘭,2024-04-18,9686
2809,京城銀,19,0,19,富邦-宜蘭,2024-04-18,9686
6282,康舒,52,33,19,富邦-宜蘭,2024-04-18,9686
00666R,富邦�琤肭磪齯�1,18,0,18,富邦-宜蘭,2024-04-18,9686
2511,太子,18,0,18,富邦-宜蘭,2024-04-18,9686
2520,冠德,25,7,18,富邦-宜蘭,2024-04-18,9686
2887,台新金,17,0,17,富邦-宜蘭,2024-04-18,9686
6125,廣運,29,12,17,富邦-宜蘭,2024-04-18,9686
2344,華邦電,18,1,17,富邦-宜蘭,2024-04-18,9686
00720B,元大投資級公司債,18,2,16,富邦-宜蘭,2024-04-18,9686
3027,盛達,23,7,16,富邦-宜蘭,2024-04-18,9686
2547,日勝生,50,34,16,富邦-宜蘭,2024-04-18,9686
00929,復華台灣科技優息,594,34,560,富邦-宜蘭,2024-04-19,9686
0056,元大高股息,169,21,148,富邦-宜蘭,2024-04-19,9686
1609,大亞,355,210,145,富邦-宜蘭,2024-04-19,9686
2520,冠德,215,81,134,富邦-宜蘭,2024-04-19,9686
2515,中工,176,61,115,富邦-宜蘭,2024-04-19,9686
3481,群創,121,12,109,富邦-宜蘭,2024-04-19,9686
1618,合機,232,128,104,富邦-宜蘭,2024-04-19,9686
2506,太設,105,1,104,富邦-宜蘭,2024-04-19,9686
1709,和益,100,1,99,富邦-宜蘭,2024-04-19,9686
2303,聯電,118,26,92,富邦-宜蘭,2024-04-19,9686
2330,台積電,111,21,90,富邦-宜蘭,2024-04-19,9686
00941,中信上游半導體,127,40,87,富邦-宜蘭,2024-04-19,9686
00919,群益台灣精選高息,191,109,82,富邦-宜蘭,2024-04-19,9686
00878,國泰永續高股息,163,84,79,富邦-宜蘭,2024-04-19,9686
3231,緯創,109,32,77,富邦-宜蘭,2024-04-19,9686
5512,力麒,348,272,76,富邦-宜蘭,2024-04-19,9686
2547,日勝生,73,0,73,富邦-宜蘭,2024-04-19,9686
4167,松瑞藥,61,0,61,富邦-宜蘭,2024-04-19,9686
4157,太景*-KY,75,15,60,富邦-宜蘭,2024-04-19,9686
3703,欣陸,72,14,58,富邦-宜蘭,2024-04-19,9686
8463,潤泰材,60,3,57,富邦-宜蘭,2024-04-19,9686
2801,彰銀,55,0,55,富邦-宜蘭,2024-04-19,9686
2317,鴻海,108,59,49,富邦-宜蘭,2024-04-19,9686
8086,宏捷科,52,5,47,富邦-宜蘭,2024-04-19,9686
3576,聯合再生,74,27,47,富邦-宜蘭,2024-04-19,9686
2356,英業達,59,19,40,富邦-宜蘭,2024-04-19,9686
8926,台汽電,41,2,39,富邦-宜蘭,2024-04-19,9686
2101,南港,57,19,38,富邦-宜蘭,2024-04-19,9686
1612,宏泰,60,23,37,富邦-宜蘭,2024-04-19,9686
00939,統一台灣高息動能,94,58,36,富邦-宜蘭,2024-04-19,9686
2880,華南金,36,1,35,富邦-宜蘭,2024-04-19,9686
2312,金寶,37,2,35,富邦-宜蘭,2024-04-19,9686
2014,中鴻,39,4,35,富邦-宜蘭,2024-04-19,9686
2605,新興,68,33,35,富邦-宜蘭,2024-04-19,9686
8155,博智,30,0,30,富邦-宜蘭,2024-04-19,9686
2542,興富發,30,0,30,富邦-宜蘭,2024-04-19,9686
1789,神隆,29,0,29,富邦-宜蘭,2024-04-19,9686
2371,大同,363,335,28,富邦-宜蘭,2024-04-19,9686
2634,漢翔,82,55,27,富邦-宜蘭,2024-04-19,9686
2610,華航,69,42,27,富邦-宜蘭,2024-04-19,9686
3450,聯鈞,26,0,26,富邦-宜蘭,2024-04-19,9686
1529,樂事綠能,30,5,25,富邦-宜蘭,2024-04-19,9686
3013,晟銘電,60,36,24,富邦-宜蘭,2024-04-19,9686
2409,友達,31,7,24,富邦-宜蘭,2024-04-19,9686
00692,富邦公司治理,24,1,23,富邦-宜蘭,2024-04-19,9686
8011,台通,25,4,21,富邦-宜蘭,2024-04-19,9686
00650L,復華香港正2,40,20,20,富邦-宜蘭,2024-04-19,9686
3055,蔚華科,20,0,20,富邦-宜蘭,2024-04-19,9686
5514,三豐,20,0,20,富邦-宜蘭,2024-04-19,9686
6443,元晶,44,24,20,富邦-宜蘭,2024-04-19,9686
2897,王道銀行,750,0,750,富邦-宜蘭,2024-04-22,9686
00937B,群益ESG投等債20,425,3,422,富邦-宜蘭,2024-04-22,9686
00929,復華台灣科技優息,465,82,383,富邦-宜蘭,2024-04-22,9686
2534,宏盛,200,0,200,富邦-宜蘭,2024-04-22,9686
5521,工信,212,35,177,富邦-宜蘭,2024-04-22,9686
00939,統一台灣高息動能,144,26,118,富邦-宜蘭,2024-04-22,9686
2883,凱基金,101,12,89,富邦-宜蘭,2024-04-22,9686
2371,大同,202,115,87,富邦-宜蘭,2024-04-22,9686
3576,聯合再生,109,27,82,富邦-宜蘭,2024-04-22,9686
4303,信立,81,1,80,富邦-宜蘭,2024-04-22,9686
1439,雋揚,80,0,80,富邦-宜蘭,2024-04-22,9686
3703,欣陸,146,74,72,富邦-宜蘭,2024-04-22,9686
2303,聯電,71,5,66,富邦-宜蘭,2024-04-22,9686
6188,廣明,63,1,62,富邦-宜蘭,2024-04-22,9686
2374,佳能,68,7,61,富邦-宜蘭,2024-04-22,9686
9940,信義,66,5,61,富邦-宜蘭,2024-04-22,9686
00878,國泰永續高股息,100,40,60,富邦-宜蘭,2024-04-22,9686
3312,弘憶股,55,1,54,富邦-宜蘭,2024-04-22,9686
2515,中工,167,113,54,富邦-宜蘭,2024-04-22,9686
6753,龍德造船,57,5,52,富邦-宜蘭,2024-04-22,9686
3623,富晶通,55,3,52,富邦-宜蘭,2024-04-22,9686
8121,越峰,52,0,52,富邦-宜蘭,2024-04-22,9686
1608,華榮,102,54,48,富邦-宜蘭,2024-04-22,9686
5864,致和證,49,1,48,富邦-宜蘭,2024-04-22,9686
2547,日勝生,91,46,45,富邦-宜蘭,2024-04-22,9686
2542,興富發,61,18,43,富邦-宜蘭,2024-04-22,9686
2363,矽統,59,16,43,富邦-宜蘭,2024-04-22,9686
0056,元大高股息,50,9,41,富邦-宜蘭,2024-04-22,9686
5251,天鉞電,39,1,38,富邦-宜蘭,2024-04-22,9686
00679B,元大美債20年,35,0,35,富邦-宜蘭,2024-04-22,9686
6505,台塑化,36,3,33,富邦-宜蘭,2024-04-22,9686
6233,旺玖,32,0,32,富邦-宜蘭,2024-04-22,9686
2356,英業達,46,16,30,富邦-宜蘭,2024-04-22,9686
00733,富邦臺灣中小,30,0,30,富邦-宜蘭,2024-04-22,9686
2344,華邦電,31,1,30,富邦-宜蘭,2024-04-22,9686
1308,亞聚,38,8,30,富邦-宜蘭,2024-04-22,9686
00688L,國泰20年美債正2,30,0,30,富邦-宜蘭,2024-04-22,9686
1108,幸福,30,0,30,富邦-宜蘭,2024-04-22,9686
2867,三商壽,73,45,28,富邦-宜蘭,2024-04-22,9686
2034,允強,26,0,26,富邦-宜蘭,2024-04-22,9686
3019,亞光,25,0,25,富邦-宜蘭,2024-04-22,9686
4164,承業醫,34,9,25,富邦-宜蘭,2024-04-22,9686
5533,皇鼎,27,2,25,富邦-宜蘭,2024-04-22,9686
00919,群益台灣精選高息,145,121,24,富邦-宜蘭,2024-04-22,9686
9933,中鼎,25,1,24,富邦-宜蘭,2024-04-22,9686
2367,燿華,28,4,24,富邦-宜蘭,2024-04-22,9686
2329,華泰,42,18,24,富邦-宜蘭,2024-04-22,9686
00941,中信上游半導體,28,5,23,富邦-宜蘭,2024-04-22,9686
5534,長虹,83,60,23,富邦-宜蘭,2024-04-22,9686
1504,東元,43,21,22,富邦-宜蘭,2024-04-22,9686
00940,元大台灣價值高息,247,49,198,富邦-宜蘭,2024-04-23,9686
1608,華榮,159,17,142,富邦-宜蘭,2024-04-23,9686
00929,復華台灣科技優息,178,41,137,富邦-宜蘭,2024-04-23,9686
5864,致和證,97,0,97,富邦-宜蘭,2024-04-23,9686
00891,中信關鍵半導體,82,0,82,富邦-宜蘭,2024-04-23,9686
3686,達能,72,4,68,富邦-宜蘭,2024-04-23,9686
1702,南僑,72,9,63,富邦-宜蘭,2024-04-23,9686
3715,定穎投控,56,5,51,富邦-宜蘭,2024-04-23,9686
00919,群益台灣精選高息,62,11,51,富邦-宜蘭,2024-04-23,9686
2897,王道銀行,50,0,50,富邦-宜蘭,2024-04-23,9686
3576,聯合再生,51,2,49,富邦-宜蘭,2024-04-23,9686
4402,郡都開發,45,10,35,富邦-宜蘭,2024-04-23,9686
2367,燿華,42,9,33,富邦-宜蘭,2024-04-23,9686
3312,弘憶股,35,3,32,富邦-宜蘭,2024-04-23,9686
0056,元大高股息,34,4,30,富邦-宜蘭,2024-04-23,9686
2543,皇昌,36,6,30,富邦-宜蘭,2024-04-23,9686
2374,佳能,44,17,27,富邦-宜蘭,2024-04-23,9686
2371,大同,134,108,26,富邦-宜蘭,2024-04-23,9686
2317,鴻海,56,32,24,富邦-宜蘭,2024-04-23,9686
6120,達運,38,14,24,富邦-宜蘭,2024-04-23,9686
2630,亞航,42,18,24,富邦-宜蘭,2024-04-23,9686
9902,台火,26,4,22,富邦-宜蘭,2024-04-23,9686
2449,京元電子,42,21,21,富邦-宜蘭,2024-04-23,9686
8092,建暐,22,1,21,富邦-宜蘭,2024-04-23,9686
910861,神州-DR,20,0,20,富邦-宜蘭,2024-04-23,9686
5508,永信建,20,0,20,富邦-宜蘭,2024-04-23,9686
5534,長虹,25,5,20,富邦-宜蘭,2024-04-23,9686
6109,亞元,19,0,19,富邦-宜蘭,2024-04-23,9686
00673R,期元大S＆P原油反1,18,0,18,富邦-宜蘭,2024-04-23,9686
6170,統振,18,0,18,富邦-宜蘭,2024-04-23,9686
1316,上曜,98,80,18,富邦-宜蘭,2024-04-23,9686
3666,光耀,17,0,17,富邦-宜蘭,2024-04-23,9686
6425,易發,27,10,17,富邦-宜蘭,2024-04-23,9686
1504,東元,29,12,17,富邦-宜蘭,2024-04-23,9686
2464,盟立,19,3,16,富邦-宜蘭,2024-04-23,9686
4726,永昕,46,30,16,富邦-宜蘭,2024-04-23,9686
9933,中鼎,16,0,16,富邦-宜蘭,2024-04-23,9686
00878,國泰永續高股息,38,22,16,富邦-宜蘭,2024-04-23,9686
5230,雷笛克光學,15,0,15,富邦-宜蘭,2024-04-23,9686
2506,太設,16,2,14,富邦-宜蘭,2024-04-23,9686
00941,中信上游半導體,15,1,14,富邦-宜蘭,2024-04-23,9686
3583,辛耘,13,1,12,富邦-宜蘭,2024-04-23,9686
00939,統一台灣高息動能,25,14,11,富邦-宜蘭,2024-04-23,9686
3027,盛達,19,8,11,富邦-宜蘭,2024-04-23,9686
3535,晶彩科,17,6,11,富邦-宜蘭,2024-04-23,9686
2731,雄獅,38,27,11,富邦-宜蘭,2024-04-23,9686
2329,華泰,14,3,11,富邦-宜蘭,2024-04-23,9686
6143,振曜,10,0,10,富邦-宜蘭,2024-04-23,9686
2867,三商壽,10,0,10,富邦-宜蘭,2024-04-23,9686
1325,恆大,10,0,10,富邦-宜蘭,2024-04-23,9686
00632R,元大台灣50反1,2033,4,2029,富邦-宜蘭,2024-04-24,9686
00905,FT臺灣Smart,285,1,284,富邦-宜蘭,2024-04-24,9686
2897,王道銀行,118,0,118,富邦-宜蘭,2024-04-24,9686
3481,群創,121,13,108,富邦-宜蘭,2024-04-24,9686
3576,聯合再生,91,0,91,富邦-宜蘭,2024-04-24,9686
00900,富邦特選高股息30,100,10,90,富邦-宜蘭,2024-04-24,9686
00937B,群益ESG投等債20,71,0,71,富邦-宜蘭,2024-04-24,9686
2886,兆豐金,62,0,62,富邦-宜蘭,2024-04-24,9686
2206,三陽工業,117,61,56,富邦-宜蘭,2024-04-24,9686
00929,復華台灣科技優息,117,63,54,富邦-宜蘭,2024-04-24,9686
1605,華新,125,74,51,富邦-宜蘭,2024-04-24,9686
3294,英濟,52,3,49,富邦-宜蘭,2024-04-24,9686
5508,永信建,41,0,41,富邦-宜蘭,2024-04-24,9686
5230,雷笛克光學,63,24,39,富邦-宜蘭,2024-04-24,9686
2504,國產,40,7,33,富邦-宜蘭,2024-04-24,9686
5864,致和證,32,0,32,富邦-宜蘭,2024-04-24,9686
2409,友達,31,0,31,富邦-宜蘭,2024-04-24,9686
4402,郡都開發,45,14,31,富邦-宜蘭,2024-04-24,9686
00679B,元大美債20年,30,0,30,富邦-宜蘭,2024-04-24,9686
1603,華電,47,17,30,富邦-宜蘭,2024-04-24,9686
8011,台通,62,32,30,富邦-宜蘭,2024-04-24,9686
3535,晶彩科,31,2,29,富邦-宜蘭,2024-04-24,9686
6547,高端疫苗,33,5,28,富邦-宜蘭,2024-04-24,9686
5371,中光電,30,3,27,富邦-宜蘭,2024-04-24,9686
00671R,富邦NASDAQ反1,26,0,26,富邦-宜蘭,2024-04-24,9686
910861,神州-DR,25,0,25,富邦-宜蘭,2024-04-24,9686
00940,元大台灣價值高息,97,73,24,富邦-宜蘭,2024-04-24,9686
00665L,富邦�琤肭磪囓�2,45,22,23,富邦-宜蘭,2024-04-24,9686
00687B,國泰20年美債,23,0,23,富邦-宜蘭,2024-04-24,9686
6120,達運,24,2,22,富邦-宜蘭,2024-04-24,9686
1781,合世,21,0,21,富邦-宜蘭,2024-04-24,9686
4916,事欣科,21,1,20,富邦-宜蘭,2024-04-24,9686
00680L,元大美債20正2,20,0,20,富邦-宜蘭,2024-04-24,9686
6026,福邦證,20,0,20,富邦-宜蘭,2024-04-24,9686
2515,中工,62,42,20,富邦-宜蘭,2024-04-24,9686
00915,凱基優選高股息30,20,1,19,富邦-宜蘭,2024-04-24,9686
4716,大立,19,0,19,富邦-宜蘭,2024-04-24,9686
6125,廣運,77,58,19,富邦-宜蘭,2024-04-24,9686
00922,國泰台灣領袖50,17,0,17,富邦-宜蘭,2024-04-24,9686
2354,鴻準,35,18,17,富邦-宜蘭,2024-04-24,9686
2406,國碩,31,14,17,富邦-宜蘭,2024-04-24,9686
3706,神達,35,20,15,富邦-宜蘭,2024-04-24,9686
2101,南港,19,4,15,富邦-宜蘭,2024-04-24,9686
1789,神隆,15,0,15,富邦-宜蘭,2024-04-24,9686
6215,和椿,90,76,14,富邦-宜蘭,2024-04-24,9686
1618,合機,52,38,14,富邦-宜蘭,2024-04-24,9686
6117,迎廣,28,15,13,富邦-宜蘭,2024-04-24,9686
6668,中揚光,18,5,13,富邦-宜蘭,2024-04-24,9686
2449,京元電子,13,1,12,富邦-宜蘭,2024-04-24,9686
6182,合晶,13,1,12,富邦-宜蘭,2024-04-24,9686
00676R,富邦臺灣加權反1,2000,0,2000,富邦-宜蘭,2024-04-25,9686
00664R,國泰臺灣加權反1,400,0,400,富邦-宜蘭,2024-04-25,9686
1608,華榮,207,9,198,富邦-宜蘭,2024-04-25,9686
2888,新光金,113,20,93,富邦-宜蘭,2024-04-25,9686
00937B,群益ESG投等債20,99,10,89,富邦-宜蘭,2024-04-25,9686
4716,大立,101,25,76,富邦-宜蘭,2024-04-25,9686
8463,潤泰材,65,1,64,富邦-宜蘭,2024-04-25,9686
00929,復華台灣科技優息,67,6,61,富邦-宜蘭,2024-04-25,9686
2317,鴻海,69,9,60,富邦-宜蘭,2024-04-25,9686
00878,國泰永續高股息,59,4,55,富邦-宜蘭,2024-04-25,9686
00934,中信成長高股息,50,0,50,富邦-宜蘭,2024-04-25,9686
2897,王道銀行,50,0,50,富邦-宜蘭,2024-04-25,9686
2534,宏盛,51,3,48,富邦-宜蘭,2024-04-25,9686
1609,大亞,118,72,46,富邦-宜蘭,2024-04-25,9686
00940,元大台灣價值高息,47,1,46,富邦-宜蘭,2024-04-25,9686
3703,欣陸,136,93,43,富邦-宜蘭,2024-04-25,9686
2101,南港,71,29,42,富邦-宜蘭,2024-04-25,9686
2371,大同,98,56,42,富邦-宜蘭,2024-04-25,9686
1440,南紡,59,20,39,富邦-宜蘭,2024-04-25,9686
2731,雄獅,74,38,36,富邦-宜蘭,2024-04-25,9686
2641,正德,32,1,31,富邦-宜蘭,2024-04-25,9686
5251,天鉞電,32,3,29,富邦-宜蘭,2024-04-25,9686
2423,固緯,36,7,29,富邦-宜蘭,2024-04-25,9686
2206,三陽工業,46,19,27,富邦-宜蘭,2024-04-25,9686
3231,緯創,41,14,27,富邦-宜蘭,2024-04-25,9686
00720B,元大投資級公司債,30,5,25,富邦-宜蘭,2024-04-25,9686
00919,群益台灣精選高息,40,15,25,富邦-宜蘭,2024-04-25,9686
1815,富喬,24,0,24,富邦-宜蘭,2024-04-25,9686
6117,迎廣,25,2,23,富邦-宜蘭,2024-04-25,9686
2009,第一銅,26,3,23,富邦-宜蘭,2024-04-25,9686
2630,亞航,33,11,22,富邦-宜蘭,2024-04-25,9686
2412,中華電,21,0,21,富邦-宜蘭,2024-04-25,9686
3024,憶聲,20,0,20,富邦-宜蘭,2024-04-25,9686
2610,華航,48,28,20,富邦-宜蘭,2024-04-25,9686
4155,訊映,20,0,20,富邦-宜蘭,2024-04-25,9686
1301,台塑,17,0,17,富邦-宜蘭,2024-04-25,9686
2344,華邦電,21,4,17,富邦-宜蘭,2024-04-25,9686
1802,台玻,20,3,17,富邦-宜蘭,2024-04-25,9686
5531,鄉林,17,0,17,富邦-宜蘭,2024-04-25,9686
00939,統一台灣高息動能,16,0,16,富邦-宜蘭,2024-04-25,9686
6806,森崴能源,17,1,16,富邦-宜蘭,2024-04-25,9686
8070,長華*,16,0,16,富邦-宜蘭,2024-04-25,9686
5521,工信,27,12,15,富邦-宜蘭,2024-04-25,9686
00688L,國泰20年美債正2,14,0,14,富邦-宜蘭,2024-04-25,9686
00687B,國泰20年美債,13,0,13,富邦-宜蘭,2024-04-25,9686
2211,長榮鋼,14,1,13,富邦-宜蘭,2024-04-25,9686
2506,太設,13,0,13,富邦-宜蘭,2024-04-25,9686
8011,台通,16,4,12,富邦-宜蘭,2024-04-25,9686
2330,台積電,15,3,12,富邦-宜蘭,2024-04-25,9686
2884,玉山金,13,1,12,富邦-宜蘭,2024-04-25,9686
2881,富邦金,203,9,194,富邦-宜蘭,2024-04-26,9686
00937B,群益ESG投等債20,194,15,179,富邦-宜蘭,2024-04-26,9686
1459,聯發,101,3,98,富邦-宜蘭,2024-04-26,9686
00929,復華台灣科技優息,127,34,93,富邦-宜蘭,2024-04-26,9686
1413,宏洲,86,0,86,富邦-宜蘭,2024-04-26,9686
00671R,富邦NASDAQ反1,77,0,77,富邦-宜蘭,2024-04-26,9686
6443,元晶,73,1,72,富邦-宜蘭,2024-04-26,9686
9902,台火,71,0,71,富邦-宜蘭,2024-04-26,9686
910861,神州-DR,71,0,71,富邦-宜蘭,2024-04-26,9686
6552,易華電,72,3,69,富邦-宜蘭,2024-04-26,9686
1709,和益,67,0,67,富邦-宜蘭,2024-04-26,9686
00687B,國泰20年美債,64,2,62,富邦-宜蘭,2024-04-26,9686
2534,宏盛,60,0,60,富邦-宜蘭,2024-04-26,9686
3576,聯合再生,63,4,59,富邦-宜蘭,2024-04-26,9686
8234,新漢,60,1,59,富邦-宜蘭,2024-04-26,9686
2371,大同,86,34,52,富邦-宜蘭,2024-04-26,9686
1446,宏和,50,0,50,富邦-宜蘭,2024-04-26,9686
2543,皇昌,50,5,45,富邦-宜蘭,2024-04-26,9686
2206,三陽工業,56,14,42,富邦-宜蘭,2024-04-26,9686
00919,群益台灣精選高息,48,7,41,富邦-宜蘭,2024-04-26,9686
00720B,元大投資級公司債,41,0,41,富邦-宜蘭,2024-04-26,9686
00905,FT臺灣Smart,60,21,39,富邦-宜蘭,2024-04-26,9686
6217,中探針,46,8,38,富邦-宜蘭,2024-04-26,9686
00679B,元大美債20年,38,0,38,富邦-宜蘭,2024-04-26,9686
2324,仁寶,37,1,36,富邦-宜蘭,2024-04-26,9686
00934,中信成長高股息,34,0,34,富邦-宜蘭,2024-04-26,9686
4426,利勤,30,0,30,富邦-宜蘭,2024-04-26,9686
2359,所羅門,137,109,28,富邦-宜蘭,2024-04-26,9686
4303,信立,59,33,26,富邦-宜蘭,2024-04-26,9686
1442,名軒,27,1,26,富邦-宜蘭,2024-04-26,9686
8936,國統,45,19,26,富邦-宜蘭,2024-04-26,9686
2464,盟立,44,19,25,富邦-宜蘭,2024-04-26,9686
00882,中信中國高股息,30,5,25,富邦-宜蘭,2024-04-26,9686
5508,永信建,24,0,24,富邦-宜蘭,2024-04-26,9686
3481,群創,110,87,23,富邦-宜蘭,2024-04-26,9686
1504,東元,31,9,22,富邦-宜蘭,2024-04-26,9686
2542,興富發,21,0,21,富邦-宜蘭,2024-04-26,9686
2637,慧洋-KY,25,4,21,富邦-宜蘭,2024-04-26,9686
5426,振發,20,0,20,富邦-宜蘭,2024-04-26,9686
3013,晟銘電,34,14,20,富邦-宜蘭,2024-04-26,9686
5706,鳳凰,24,5,19,富邦-宜蘭,2024-04-26,9686
2867,三商壽,19,0,19,富邦-宜蘭,2024-04-26,9686
4747,強生,19,0,19,富邦-宜蘭,2024-04-26,9686
6116,彩晶,31,12,19,富邦-宜蘭,2024-04-26,9686
6125,廣運,39,21,18,富邦-宜蘭,2024-04-26,9686
00897,富邦基因免疫生技,20,2,18,富邦-宜蘭,2024-04-26,9686
2634,漢翔,54,37,17,富邦-宜蘭,2024-04-26,9686
9940,信義,17,0,17,富邦-宜蘭,2024-04-26,9686
3715,定穎投控,33,17,16,富邦-宜蘭,2024-04-26,9686
2379,瑞昱,15,0,15,富邦-宜蘭,2024-04-26,9686
00632R,元大台灣50反1,3071,0,3071,富邦-宜蘭,2024-04-29,9686
00664R,國泰臺灣加權反1,1505,0,1505,富邦-宜蘭,2024-04-29,9686
00937B,群益ESG投等債20,276,16,260,富邦-宜蘭,2024-04-29,9686
1314,中石化,395,174,221,富邦-宜蘭,2024-04-29,9686
2010,春源,187,0,187,富邦-宜蘭,2024-04-29,9686
2363,矽統,270,117,153,富邦-宜蘭,2024-04-29,9686
4127,天良,115,11,104,富邦-宜蘭,2024-04-29,9686
6216,居易,100,0,100,富邦-宜蘭,2024-04-29,9686
2349,錸德,100,1,99,富邦-宜蘭,2024-04-29,9686
2107,厚生,100,10,90,富邦-宜蘭,2024-04-29,9686
2615,萬海,132,50,82,富邦-宜蘭,2024-04-29,9686
6552,易華電,101,20,81,富邦-宜蘭,2024-04-29,9686
2801,彰銀,60,0,60,富邦-宜蘭,2024-04-29,9686
2885,元大金,69,9,60,富邦-宜蘭,2024-04-29,9686
1440,南紡,71,16,55,富邦-宜蘭,2024-04-29,9686
2374,佳能,56,5,51,富邦-宜蘭,2024-04-29,9686
8234,新漢,55,7,48,富邦-宜蘭,2024-04-29,9686
2515,中工,114,66,48,富邦-宜蘭,2024-04-29,9686
2323,中環,102,55,47,富邦-宜蘭,2024-04-29,9686
00933B,國泰10Y+金融債,49,2,47,富邦-宜蘭,2024-04-29,9686
2359,所羅門,83,37,46,富邦-宜蘭,2024-04-29,9686
1817,凱撒衛,45,2,43,富邦-宜蘭,2024-04-29,9686
6177,達麗,53,10,43,富邦-宜蘭,2024-04-29,9686
910861,神州-DR,41,0,41,富邦-宜蘭,2024-04-29,9686
1532,勤美,72,33,39,富邦-宜蘭,2024-04-29,9686
1709,和益,33,0,33,富邦-宜蘭,2024-04-29,9686
6206,飛捷,33,0,33,富邦-宜蘭,2024-04-29,9686
2449,京元電子,58,26,32,富邦-宜蘭,2024-04-29,9686
00882,中信中國高股息,53,21,32,富邦-宜蘭,2024-04-29,9686
6207,雷科,32,2,30,富邦-宜蘭,2024-04-29,9686
5529,鉅陞,32,2,30,富邦-宜蘭,2024-04-29,9686
6016,康和證,30,0,30,富邦-宜蘭,2024-04-29,9686
1413,宏洲,27,0,27,富邦-宜蘭,2024-04-29,9686
2101,南港,51,27,24,富邦-宜蘭,2024-04-29,9686
4402,郡都開發,24,0,24,富邦-宜蘭,2024-04-29,9686
6215,和椿,54,30,24,富邦-宜蘭,2024-04-29,9686
2303,聯電,29,6,23,富邦-宜蘭,2024-04-29,9686
1609,大亞,45,23,22,富邦-宜蘭,2024-04-29,9686
00929,復華台灣科技優息,51,29,22,富邦-宜蘭,2024-04-29,9686
5701,劍湖山,20,0,20,富邦-宜蘭,2024-04-29,9686
6026,福邦證,20,0,20,富邦-宜蘭,2024-04-29,9686
2527,宏璟,22,2,20,富邦-宜蘭,2024-04-29,9686
5706,鳳凰,22,3,19,富邦-宜蘭,2024-04-29,9686
1312,國喬,20,1,19,富邦-宜蘭,2024-04-29,9686
1722,台肥,19,1,18,富邦-宜蘭,2024-04-29,9686
1612,宏泰,20,3,17,富邦-宜蘭,2024-04-29,9686
3047,訊舟,17,1,16,富邦-宜蘭,2024-04-29,9686
9934,成霖,15,0,15,富邦-宜蘭,2024-04-29,9686
6525,捷敏-KY,15,0,15,富邦-宜蘭,2024-04-29,9686
00941,中信上游半導體,21,6,15,富邦-宜蘭,2024-04-29,9686
2867,三商壽,292,0,292,富邦-宜蘭,2024-04-30,9686
2611,志信,138,10,128,富邦-宜蘭,2024-04-30,9686
00940,元大台灣價值高息,128,5,123,富邦-宜蘭,2024-04-30,9686
6177,達麗,149,34,115,富邦-宜蘭,2024-04-30,9686
1314,中石化,151,40,111,富邦-宜蘭,2024-04-30,9686
00929,復華台灣科技優息,127,25,102,富邦-宜蘭,2024-04-30,9686
00934,中信成長高股息,100,0,100,富邦-宜蘭,2024-04-30,9686
00664R,國泰臺灣加權反1,98,0,98,富邦-宜蘭,2024-04-30,9686
00937B,群益ESG投等債20,181,91,90,富邦-宜蘭,2024-04-30,9686
2515,中工,80,9,71,富邦-宜蘭,2024-04-30,9686
1584,精剛,65,1,64,富邦-宜蘭,2024-04-30,9686
2427,三商電,77,14,63,富邦-宜蘭,2024-04-30,9686
3041,揚智,63,1,62,富邦-宜蘭,2024-04-30,9686
1413,宏洲,48,0,48,富邦-宜蘭,2024-04-30,9686
3481,群創,81,39,42,富邦-宜蘭,2024-04-30,9686
4127,天良,94,53,41,富邦-宜蘭,2024-04-30,9686
2401,凌陽,65,26,39,富邦-宜蘭,2024-04-30,9686
00882,中信中國高股息,36,0,36,富邦-宜蘭,2024-04-30,9686
5230,雷笛克光學,33,1,32,富邦-宜蘭,2024-04-30,9686
2537,聯上發,40,9,31,富邦-宜蘭,2024-04-30,9686
00878,國泰永續高股息,37,7,30,富邦-宜蘭,2024-04-30,9686
5512,力麒,36,6,30,富邦-宜蘭,2024-04-30,9686
6235,華孚,59,35,24,富邦-宜蘭,2024-04-30,9686
00919,群益台灣精選高息,26,3,23,富邦-宜蘭,2024-04-30,9686
5340,建榮,23,0,23,富邦-宜蘭,2024-04-30,9686
1434,福懋,25,3,22,富邦-宜蘭,2024-04-30,9686
3030,德律,24,2,22,富邦-宜蘭,2024-04-30,9686
1605,華新,54,32,22,富邦-宜蘭,2024-04-30,9686
4526,東台,37,15,22,富邦-宜蘭,2024-04-30,9686
2312,金寶,21,0,21,富邦-宜蘭,2024-04-30,9686
2449,京元電子,20,0,20,富邦-宜蘭,2024-04-30,9686
3055,蔚華科,20,0,20,富邦-宜蘭,2024-04-30,9686
00632R,元大台灣50反1,25,5,20,富邦-宜蘭,2024-04-30,9686
2511,太子,21,2,19,富邦-宜蘭,2024-04-30,9686
8121,越峰,19,0,19,富邦-宜蘭,2024-04-30,9686
5531,鄉林,52,33,19,富邦-宜蘭,2024-04-30,9686
2206,三陽工業,31,13,18,富邦-宜蘭,2024-04-30,9686
912000,晨訊科-DR,18,0,18,富邦-宜蘭,2024-04-30,9686
2363,矽統,107,90,17,富邦-宜蘭,2024-04-30,9686
2353,宏��,18,2,16,富邦-宜蘭,2024-04-30,9686
2618,長榮航,75,60,15,富邦-宜蘭,2024-04-30,9686
3356,奇偶,15,0,15,富邦-宜蘭,2024-04-30,9686
6538,倉和,16,1,15,富邦-宜蘭,2024-04-30,9686
00706L,期元大S＆P日圓正2,20,6,14,富邦-宜蘭,2024-04-30,9686
8150,南茂,14,0,14,富邦-宜蘭,2024-04-30,9686
6190,萬泰科,23,9,14,富邦-宜蘭,2024-04-30,9686
2402,毅嘉,20,6,14,富邦-宜蘭,2024-04-30,9686
5426,振發,13,0,13,富邦-宜蘭,2024-04-30,9686
2630,亞航,15,3,12,富邦-宜蘭,2024-04-30,9686
2913,農林,22,10,12,富邦-宜蘭,2024-04-30,9686
00632R,元大台灣50反1,687,0,687,富邦-宜蘭,2024-05-02,9686
1314,中石化,300,33,267,富邦-宜蘭,2024-05-02,9686
00676R,富邦臺灣加權反1,200,0,200,富邦-宜蘭,2024-05-02,9686
2913,農林,195,24,171,富邦-宜蘭,2024-05-02,9686
00878,國泰永續高股息,170,1,169,富邦-宜蘭,2024-05-02,9686
2609,陽明,150,40,110,富邦-宜蘭,2024-05-02,9686
00940,元大台灣價值高息,97,10,87,富邦-宜蘭,2024-05-02,9686
6177,達麗,92,24,68,富邦-宜蘭,2024-05-02,9686
6113,亞矽,80,14,66,富邦-宜蘭,2024-05-02,9686
00665L,富邦�琤肭磪囓�2,76,12,64,富邦-宜蘭,2024-05-02,9686
2102,泰豐,111,50,61,富邦-宜蘭,2024-05-02,9686
3481,群創,67,10,57,富邦-宜蘭,2024-05-02,9686
1584,精剛,61,6,55,富邦-宜蘭,2024-05-02,9686
00937B,群益ESG投等債20,76,23,53,富邦-宜蘭,2024-05-02,9686
1815,富喬,53,1,52,富邦-宜蘭,2024-05-02,9686
00923,群益台ESG低碳50,52,1,51,富邦-宜蘭,2024-05-02,9686
2363,矽統,120,71,49,富邦-宜蘭,2024-05-02,9686
3715,定穎投控,102,53,49,富邦-宜蘭,2024-05-02,9686
2367,燿華,70,23,47,富邦-宜蘭,2024-05-02,9686
2501,國建,97,51,46,富邦-宜蘭,2024-05-02,9686
00929,復華台灣科技優息,90,47,43,富邦-宜蘭,2024-05-02,9686
2371,大同,95,57,38,富邦-宜蘭,2024-05-02,9686
2497,怡利電,41,4,37,富邦-宜蘭,2024-05-02,9686
6770,力積電,86,51,35,富邦-宜蘭,2024-05-02,9686
00919,群益台灣精選高息,35,3,32,富邦-宜蘭,2024-05-02,9686
2515,中工,71,41,30,富邦-宜蘭,2024-05-02,9686
2603,長榮,45,17,28,富邦-宜蘭,2024-05-02,9686
2312,金寶,29,1,28,富邦-宜蘭,2024-05-02,9686
00715L,期街口布蘭特正2,36,10,26,富邦-宜蘭,2024-05-02,9686
6023,元大期,24,0,24,富邦-宜蘭,2024-05-02,9686
8064,東捷,25,1,24,富邦-宜蘭,2024-05-02,9686
2520,冠德,33,9,24,富邦-宜蘭,2024-05-02,9686
6188,廣明,30,6,24,富邦-宜蘭,2024-05-02,9686
2401,凌陽,26,3,23,富邦-宜蘭,2024-05-02,9686
00664R,國泰臺灣加權反1,28,5,23,富邦-宜蘭,2024-05-02,9686
2402,毅嘉,23,0,23,富邦-宜蘭,2024-05-02,9686
9933,中鼎,22,0,22,富邦-宜蘭,2024-05-02,9686
2324,仁寶,23,2,21,富邦-宜蘭,2024-05-02,9686
2303,聯電,24,4,20,富邦-宜蘭,2024-05-02,9686
6552,易華電,21,1,20,富邦-宜蘭,2024-05-02,9686
4747,強生,20,0,20,富邦-宜蘭,2024-05-02,9686
1532,勤美,28,8,20,富邦-宜蘭,2024-05-02,9686
5907,大洋-KY,20,0,20,富邦-宜蘭,2024-05-02,9686
2506,太設,19,0,19,富邦-宜蘭,2024-05-02,9686
2330,台積電,21,3,18,富邦-宜蘭,2024-05-02,9686
6230,尼得科超眾,23,6,17,富邦-宜蘭,2024-05-02,9686
5371,中光電,21,4,17,富邦-宜蘭,2024-05-02,9686
2211,長榮鋼,22,6,16,富邦-宜蘭,2024-05-02,9686
1319,東陽,22,7,15,富邦-宜蘭,2024-05-02,9686
2009,第一銅,27,13,14,富邦-宜蘭,2024-05-02,9686
00940,元大台灣價值高息,190,0,190,富邦-宜蘭,2024-05-03,9686
00937B,群益ESG投等債20,138,0,138,富邦-宜蘭,2024-05-03,9686
00905,FT臺灣Smart,129,0,129,富邦-宜蘭,2024-05-03,9686
6120,達運,130,1,129,富邦-宜蘭,2024-05-03,9686
00929,復華台灣科技優息,122,30,92,富邦-宜蘭,2024-05-03,9686
5328,華容,85,10,75,富邦-宜蘭,2024-05-03,9686
5512,力麒,113,45,68,富邦-宜蘭,2024-05-03,9686
6770,力積電,123,61,62,富邦-宜蘭,2024-05-03,9686
6175,立敦,57,3,54,富邦-宜蘭,2024-05-03,9686
1584,精剛,52,0,52,富邦-宜蘭,2024-05-03,9686
00878,國泰永續高股息,52,0,52,富邦-宜蘭,2024-05-03,9686
2538,基泰,50,0,50,富邦-宜蘭,2024-05-03,9686
6188,廣明,50,1,49,富邦-宜蘭,2024-05-03,9686
00934,中信成長高股息,50,4,46,富邦-宜蘭,2024-05-03,9686
2888,新光金,64,21,43,富邦-宜蘭,2024-05-03,9686
1514,亞力,47,7,40,富邦-宜蘭,2024-05-03,9686
00665L,富邦�琤肭磪囓�2,42,3,39,富邦-宜蘭,2024-05-03,9686
2607,榮運,41,2,39,富邦-宜蘭,2024-05-03,9686
00891,中信關鍵半導體,40,2,38,富邦-宜蘭,2024-05-03,9686
8096,擎亞,150,112,38,富邦-宜蘭,2024-05-03,9686
6667,信紘科,42,7,35,富邦-宜蘭,2024-05-03,9686
2634,漢翔,35,1,34,富邦-宜蘭,2024-05-03,9686
3231,緯創,38,6,32,富邦-宜蘭,2024-05-03,9686
00688L,國泰20年美債正2,41,10,31,富邦-宜蘭,2024-05-03,9686
4164,承業醫,29,0,29,富邦-宜蘭,2024-05-03,9686
2515,中工,65,37,28,富邦-宜蘭,2024-05-03,9686
5009,榮剛,34,6,28,富邦-宜蘭,2024-05-03,9686
5522,遠雄,48,21,27,富邦-宜蘭,2024-05-03,9686
00679B,元大美債20年,27,0,27,富邦-宜蘭,2024-05-03,9686
2603,長榮,36,10,26,富邦-宜蘭,2024-05-03,9686
00945B,凱基美國非投等債,26,0,26,富邦-宜蘭,2024-05-03,9686
9911,櫻花,32,6,26,富邦-宜蘭,2024-05-03,9686
2609,陽明,45,20,25,富邦-宜蘭,2024-05-03,9686
2201,裕隆,39,15,24,富邦-宜蘭,2024-05-03,9686
8936,國統,56,34,22,富邦-宜蘭,2024-05-03,9686
8926,台汽電,22,1,21,富邦-宜蘭,2024-05-03,9686
1314,中石化,64,43,21,富邦-宜蘭,2024-05-03,9686
2025,千興,20,0,20,富邦-宜蘭,2024-05-03,9686
5519,隆大,70,50,20,富邦-宜蘭,2024-05-03,9686
2534,宏盛,20,1,19,富邦-宜蘭,2024-05-03,9686
2537,聯上發,40,23,17,富邦-宜蘭,2024-05-03,9686
6125,廣運,24,7,17,富邦-宜蘭,2024-05-03,9686
8069,元太,20,3,17,富邦-宜蘭,2024-05-03,9686
1217,愛之味,17,0,17,富邦-宜蘭,2024-05-03,9686
3707,漢磊,16,0,16,富邦-宜蘭,2024-05-03,9686
2497,怡利電,20,4,16,富邦-宜蘭,2024-05-03,9686
5907,大洋-KY,16,0,16,富邦-宜蘭,2024-05-03,9686
2359,所羅門,42,26,16,富邦-宜蘭,2024-05-03,9686
00939,統一台灣高息動能,15,0,15,富邦-宜蘭,2024-05-03,9686
1605,華新,64,49,15,富邦-宜蘭,2024-05-03,9686
00632R,元大台灣50反1,471,20,451,富邦-宜蘭,2024-05-06,9686
2506,太設,343,22,321,富邦-宜蘭,2024-05-06,9686
00664R,國泰臺灣加權反1,205,0,205,富邦-宜蘭,2024-05-06,9686
4707,磐亞,200,4,196,富邦-宜蘭,2024-05-06,9686
00937B,群益ESG投等債20,161,1,160,富邦-宜蘭,2024-05-06,9686
00929,復華台灣科技優息,202,43,159,富邦-宜蘭,2024-05-06,9686
2867,三商壽,150,3,147,富邦-宜蘭,2024-05-06,9686
2885,元大金,154,9,145,富邦-宜蘭,2024-05-06,9686
2913,農林,106,1,105,富邦-宜蘭,2024-05-06,9686
00905,FT臺灣Smart,100,0,100,富邦-宜蘭,2024-05-06,9686
00637L,元大滬深300正2,100,0,100,富邦-宜蘭,2024-05-06,9686
2889,國票金,111,13,98,富邦-宜蘭,2024-05-06,9686
5522,遠雄,74,3,71,富邦-宜蘭,2024-05-06,9686
9933,中鼎,63,1,62,富邦-宜蘭,2024-05-06,9686
00751B,元大AAA至A公司債,59,0,59,富邦-宜蘭,2024-05-06,9686
2312,金寶,57,0,57,富邦-宜蘭,2024-05-06,9686
4155,訊映,49,0,49,富邦-宜蘭,2024-05-06,9686
2014,中鴻,47,2,45,富邦-宜蘭,2024-05-06,9686
00891,中信關鍵半導體,45,0,45,富邦-宜蘭,2024-05-06,9686
6206,飛捷,67,31,36,富邦-宜蘭,2024-05-06,9686
2354,鴻準,50,14,36,富邦-宜蘭,2024-05-06,9686
1584,精剛,37,2,35,富邦-宜蘭,2024-05-06,9686
5512,力麒,43,10,33,富邦-宜蘭,2024-05-06,9686
8069,元太,34,2,32,富邦-宜蘭,2024-05-06,9686
00688L,國泰20年美債正2,32,0,32,富邦-宜蘭,2024-05-06,9686
3287,廣寰科,41,9,32,富邦-宜蘭,2024-05-06,9686
1413,宏洲,31,0,31,富邦-宜蘭,2024-05-06,9686
00942B,台新美A公司債20+,32,2,30,富邦-宜蘭,2024-05-06,9686
2355,敬鵬,30,0,30,富邦-宜蘭,2024-05-06,9686
3312,弘憶股,142,112,30,富邦-宜蘭,2024-05-06,9686
6757,台灣虎航,30,1,29,富邦-宜蘭,2024-05-06,9686
00650L,復華香港正2,27,0,27,富邦-宜蘭,2024-05-06,9686
1314,中石化,69,42,27,富邦-宜蘭,2024-05-06,9686
2449,京元電子,47,21,26,富邦-宜蘭,2024-05-06,9686
1605,華新,48,23,25,富邦-宜蘭,2024-05-06,9686
1734,杏輝,25,0,25,富邦-宜蘭,2024-05-06,9686
00919,群益台灣精選高息,46,22,24,富邦-宜蘭,2024-05-06,9686
3706,神達,33,11,22,富邦-宜蘭,2024-05-06,9686
00896,中信綠能及電動車,28,6,22,富邦-宜蘭,2024-05-06,9686
2313,華通,25,3,22,富邦-宜蘭,2024-05-06,9686
00939,統一台灣高息動能,24,2,22,富邦-宜蘭,2024-05-06,9686
2636,台驊控股,21,0,21,富邦-宜蘭,2024-05-06,9686
4933,友輝,21,0,21,富邦-宜蘭,2024-05-06,9686
6257,矽格,23,2,21,富邦-宜蘭,2024-05-06,9686
2887,台新金,21,0,21,富邦-宜蘭,2024-05-06,9686
00679B,元大美債20年,20,0,20,富邦-宜蘭,2024-05-06,9686
6173,信昌電,21,1,20,富邦-宜蘭,2024-05-06,9686
4714,永捷,25,5,20,富邦-宜蘭,2024-05-06,9686
3555,博士旺,20,0,20,富邦-宜蘭,2024-05-06,9686
6278,台表科,19,1,18,富邦-宜蘭,2024-05-06,9686
00632R,元大台灣50反1,160,5,155,富邦-宜蘭,2024-05-07,9686
00664R,國泰臺灣加權反1,150,0,150,富邦-宜蘭,2024-05-07,9686
2356,英業達,106,10,96,富邦-宜蘭,2024-05-07,9686
2834,臺企銀,66,1,65,富邦-宜蘭,2024-05-07,9686
2374,佳能,96,33,63,富邦-宜蘭,2024-05-07,9686
00937B,群益ESG投等債20,68,7,61,富邦-宜蘭,2024-05-07,9686
1453,大將,133,80,53,富邦-宜蘭,2024-05-07,9686
6834,天二科技,53,0,53,富邦-宜蘭,2024-05-07,9686
1612,宏泰,130,78,52,富邦-宜蘭,2024-05-07,9686
2506,太設,60,17,43,富邦-宜蘭,2024-05-07,9686
6477,安集,40,0,40,富邦-宜蘭,2024-05-07,9686
6016,康和證,40,0,40,富邦-宜蘭,2024-05-07,9686
1609,大亞,48,8,40,富邦-宜蘭,2024-05-07,9686
2101,南港,58,19,39,富邦-宜蘭,2024-05-07,9686
2367,燿華,64,26,38,富邦-宜蘭,2024-05-07,9686
5608,四維航,37,3,34,富邦-宜蘭,2024-05-07,9686
1434,福懋,40,10,30,富邦-宜蘭,2024-05-07,9686
1734,杏輝,31,1,30,富邦-宜蘭,2024-05-07,9686
5512,力麒,37,8,29,富邦-宜蘭,2024-05-07,9686
00891,中信關鍵半導體,32,4,28,富邦-宜蘭,2024-05-07,9686
3481,群創,41,14,27,富邦-宜蘭,2024-05-07,9686
1101,台泥,27,0,27,富邦-宜蘭,2024-05-07,9686
00939,統一台灣高息動能,27,0,27,富邦-宜蘭,2024-05-07,9686
00919,群益台灣精選高息,26,1,25,富邦-宜蘭,2024-05-07,9686
2540,愛山林,50,25,25,富邦-宜蘭,2024-05-07,9686
6005,群益證,29,4,25,富邦-宜蘭,2024-05-07,9686
00940,元大台灣價值高息,48,23,25,富邦-宜蘭,2024-05-07,9686
2615,萬海,36,13,23,富邦-宜蘭,2024-05-07,9686
00680L,元大美債20正2,22,0,22,富邦-宜蘭,2024-05-07,9686
1584,精剛,23,1,22,富邦-宜蘭,2024-05-07,9686
0056,元大高股息,26,5,21,富邦-宜蘭,2024-05-07,9686
00882,中信中國高股息,22,1,21,富邦-宜蘭,2024-05-07,9686
5348,正能量智能,20,0,20,富邦-宜蘭,2024-05-07,9686
4155,訊映,20,0,20,富邦-宜蘭,2024-05-07,9686
2406,國碩,21,1,20,富邦-宜蘭,2024-05-07,9686
6550,北極星藥業-KY,21,2,19,富邦-宜蘭,2024-05-07,9686
3466,德晉,25,6,19,富邦-宜蘭,2024-05-07,9686
9958,世紀鋼,29,11,18,富邦-宜蘭,2024-05-07,9686
6120,達運,25,8,17,富邦-宜蘭,2024-05-07,9686
2520,冠德,20,4,16,富邦-宜蘭,2024-05-07,9686
5871,中租-KY,16,0,16,富邦-宜蘭,2024-05-07,9686
6263,普萊德,16,0,16,富邦-宜蘭,2024-05-07,9686
2486,一詮,87,72,15,富邦-宜蘭,2024-05-07,9686
3450,聯鈞,15,0,15,富邦-宜蘭,2024-05-07,9686
1215,卜蜂,15,0,15,富邦-宜蘭,2024-05-07,9686
2324,仁寶,15,0,15,富邦-宜蘭,2024-05-07,9686
1527,鑽全,15,0,15,富邦-宜蘭,2024-05-07,9686
00931B,統一美債20年,16,1,15,富邦-宜蘭,2024-05-07,9686
2354,鴻準,55,40,15,富邦-宜蘭,2024-05-07,9686
2344,華邦電,17,2,15,富邦-宜蘭,2024-05-07,9686
00632R,元大台灣50反1,115,10,105,富邦-宜蘭,2024-05-08,9686
00713,元大台灣高息低波,60,0,60,富邦-宜蘭,2024-05-08,9686
6016,康和證,60,0,60,富邦-宜蘭,2024-05-08,9686
2887,台新金,60,1,59,富邦-宜蘭,2024-05-08,9686
8277,商丞,58,1,57,富邦-宜蘭,2024-05-08,9686
2603,長榮,61,5,56,富邦-宜蘭,2024-05-08,9686
5871,中租-KY,55,3,52,富邦-宜蘭,2024-05-08,9686
00664R,國泰臺灣加權反1,50,0,50,富邦-宜蘭,2024-05-08,9686
1721,三晃,61,12,49,富邦-宜蘭,2024-05-08,9686
3338,泰碩,42,1,41,富邦-宜蘭,2024-05-08,9686
2634,漢翔,44,4,40,富邦-宜蘭,2024-05-08,9686
00929,復華台灣科技優息,70,32,38,富邦-宜蘭,2024-05-08,9686
2504,國產,36,0,36,富邦-宜蘭,2024-05-08,9686
3481,群創,38,2,36,富邦-宜蘭,2024-05-08,9686
2606,裕民,87,54,33,富邦-宜蘭,2024-05-08,9686
00919,群益台灣精選高息,35,2,33,富邦-宜蘭,2024-05-08,9686
2002,中鋼,38,8,30,富邦-宜蘭,2024-05-08,9686
1434,福懋,30,0,30,富邦-宜蘭,2024-05-08,9686
2365,昆盈,63,33,30,富邦-宜蘭,2024-05-08,9686
5230,雷笛克光學,35,6,29,富邦-宜蘭,2024-05-08,9686
1608,華榮,107,80,27,富邦-宜蘭,2024-05-08,9686
2344,華邦電,27,0,27,富邦-宜蘭,2024-05-08,9686
2031,新光鋼,29,3,26,富邦-宜蘭,2024-05-08,9686
2101,南港,49,24,25,富邦-宜蘭,2024-05-08,9686
1810,和成,23,0,23,富邦-宜蘭,2024-05-08,9686
6215,和椿,56,34,22,富邦-宜蘭,2024-05-08,9686
2915,潤泰全,22,0,22,富邦-宜蘭,2024-05-08,9686
4967,十銓,50,29,21,富邦-宜蘭,2024-05-08,9686
2338,光罩,53,32,21,富邦-宜蘭,2024-05-08,9686
00937B,群益ESG投等債20,25,4,21,富邦-宜蘭,2024-05-08,9686
1517,利奇,20,0,20,富邦-宜蘭,2024-05-08,9686
2464,盟立,24,4,20,富邦-宜蘭,2024-05-08,9686
2540,愛山林,22,3,19,富邦-宜蘭,2024-05-08,9686
3287,廣寰科,24,5,19,富邦-宜蘭,2024-05-08,9686
1618,合機,80,62,18,富邦-宜蘭,2024-05-08,9686
1582,信錦,29,12,17,富邦-宜蘭,2024-05-08,9686
1702,南僑,20,3,17,富邦-宜蘭,2024-05-08,9686
00712,復華富時不動產,21,5,16,富邦-宜蘭,2024-05-08,9686
6122,擎邦,20,4,16,富邦-宜蘭,2024-05-08,9686
1452,宏益,48,33,15,富邦-宜蘭,2024-05-08,9686
5864,致和證,15,0,15,富邦-宜蘭,2024-05-08,9686
00650L,復華香港正2,35,20,15,富邦-宜蘭,2024-05-08,9686
5392,能率,14,0,14,富邦-宜蘭,2024-05-08,9686
3036,文曄,14,0,14,富邦-宜蘭,2024-05-08,9686
00939,統一台灣高息動能,21,8,13,富邦-宜蘭,2024-05-08,9686
00751B,元大AAA至A公司債,13,0,13,富邦-宜蘭,2024-05-08,9686
8112,至上,23,10,13,富邦-宜蘭,2024-05-08,9686
00687B,國泰20年美債,15,2,13,富邦-宜蘭,2024-05-08,9686
2423,固緯,12,0,12,富邦-宜蘭,2024-05-08,9686
910861,神州-DR,12,0,12,富邦-宜蘭,2024-05-08,9686
2834,臺企銀,135,1,134,富邦-宜蘭,2024-05-09,9686
00929,復華台灣科技優息,155,21,134,富邦-宜蘭,2024-05-09,9686
00632R,元大台灣50反1,102,0,102,富邦-宜蘭,2024-05-09,9686
2601,益航,101,0,101,富邦-宜蘭,2024-05-09,9686
6016,康和證,80,0,80,富邦-宜蘭,2024-05-09,9686
2618,長榮航,105,28,77,富邦-宜蘭,2024-05-09,9686
4949,有成精密,74,0,74,富邦-宜蘭,2024-05-09,9686
1714,和桐,73,7,66,富邦-宜蘭,2024-05-09,9686
1313,聯成,62,0,62,富邦-宜蘭,2024-05-09,9686
8438,昶昕,56,1,55,富邦-宜蘭,2024-05-09,9686
9103,美德醫療-DR,51,0,51,富邦-宜蘭,2024-05-09,9686
8121,越峰,53,4,49,富邦-宜蘭,2024-05-09,9686
2371,大同,185,136,49,富邦-宜蘭,2024-05-09,9686
2889,國票金,98,50,48,富邦-宜蘭,2024-05-09,9686
00937B,群益ESG投等債20,45,0,45,富邦-宜蘭,2024-05-09,9686
00878,國泰永續高股息,67,22,45,富邦-宜蘭,2024-05-09,9686
3030,德律,59,17,42,富邦-宜蘭,2024-05-09,9686
5014,建錩,40,0,40,富邦-宜蘭,2024-05-09,9686
2883,凱基金,45,6,39,富邦-宜蘭,2024-05-09,9686
2515,中工,56,18,38,富邦-宜蘭,2024-05-09,9686
00946,群益科技高息成長,210,173,37,富邦-宜蘭,2024-05-09,9686
1524,耿鼎,36,0,36,富邦-宜蘭,2024-05-09,9686
2363,矽統,164,129,35,富邦-宜蘭,2024-05-09,9686
8463,潤泰材,51,16,35,富邦-宜蘭,2024-05-09,9686
00940,元大台灣價值高息,60,28,32,富邦-宜蘭,2024-05-09,9686
5871,中租-KY,33,1,32,富邦-宜蘭,2024-05-09,9686
00919,群益台灣精選高息,42,11,31,富邦-宜蘭,2024-05-09,9686
1609,大亞,49,19,30,富邦-宜蘭,2024-05-09,9686
3231,緯創,35,6,29,富邦-宜蘭,2024-05-09,9686
4967,十銓,47,20,27,富邦-宜蘭,2024-05-09,9686
2820,華票,27,0,27,富邦-宜蘭,2024-05-09,9686
3060,銘異,34,8,26,富邦-宜蘭,2024-05-09,9686
3313,斐成,25,0,25,富邦-宜蘭,2024-05-09,9686
2543,皇昌,28,3,25,富邦-宜蘭,2024-05-09,9686
2609,陽明,235,210,25,富邦-宜蘭,2024-05-09,9686
2449,京元電子,28,4,24,富邦-宜蘭,2024-05-09,9686
3338,泰碩,27,3,24,富邦-宜蘭,2024-05-09,9686
4562,穎漢,24,3,21,富邦-宜蘭,2024-05-09,9686
1457,宜進,21,0,21,富邦-宜蘭,2024-05-09,9686
2367,燿華,104,84,20,富邦-宜蘭,2024-05-09,9686
00664R,國泰臺灣加權反1,20,0,20,富邦-宜蘭,2024-05-09,9686
1309,台達化,20,0,20,富邦-宜蘭,2024-05-09,9686
3481,群創,23,3,20,富邦-宜蘭,2024-05-09,9686
3712,永崴投控,21,1,20,富邦-宜蘭,2024-05-09,9686
2317,鴻海,49,29,20,富邦-宜蘭,2024-05-09,9686
2886,兆豐金,19,0,19,富邦-宜蘭,2024-05-09,9686
6727,亞泰金屬,18,0,18,富邦-宜蘭,2024-05-09,9686
9958,世紀鋼,37,20,17,富邦-宜蘭,2024-05-09,9686
2313,華通,32,15,17,富邦-宜蘭,2024-05-09,9686
3036,文曄,21,5,16,富邦-宜蘭,2024-05-09,9686
00680L,元大美債20正2,239,0,239,富邦-宜蘭,2024-05-10,9686
00929,復華台灣科技優息,281,120,161,富邦-宜蘭,2024-05-10,9686
00940,元大台灣價值高息,156,15,141,富邦-宜蘭,2024-05-10,9686
2601,益航,108,3,105,富邦-宜蘭,2024-05-10,9686
6026,福邦證,115,10,105,富邦-宜蘭,2024-05-10,9686
2855,統一證,100,0,100,富邦-宜蘭,2024-05-10,9686
6203,海韻電,102,2,100,富邦-宜蘭,2024-05-10,9686
00665L,富邦�琤肭磪囓�2,118,22,96,富邦-宜蘭,2024-05-10,9686
2313,華通,88,22,66,富邦-宜蘭,2024-05-10,9686
1702,南僑,60,1,59,富邦-宜蘭,2024-05-10,9686
00937B,群益ESG投等債20,57,5,52,富邦-宜蘭,2024-05-10,9686
6005,群益證,50,5,45,富邦-宜蘭,2024-05-10,9686
00946,群益科技高息成長,53,16,37,富邦-宜蘭,2024-05-10,9686
3030,德律,58,26,32,富邦-宜蘭,2024-05-10,9686
8936,國統,42,11,31,富邦-宜蘭,2024-05-10,9686
2537,聯上發,32,1,31,富邦-宜蘭,2024-05-10,9686
2888,新光金,372,341,31,富邦-宜蘭,2024-05-10,9686
2890,永豐金,33,2,31,富邦-宜蘭,2024-05-10,9686
2405,輔信,30,0,30,富邦-宜蘭,2024-05-10,9686
00944,野村趨勢動能高息,27,1,26,富邦-宜蘭,2024-05-10,9686
6770,力積電,82,57,25,富邦-宜蘭,2024-05-10,9686
00905,FT臺灣Smart,22,0,22,富邦-宜蘭,2024-05-10,9686
2883,凱基金,342,320,22,富邦-宜蘭,2024-05-10,9686
00632R,元大台灣50反1,43,22,21,富邦-宜蘭,2024-05-10,9686
3712,永崴投控,20,0,20,富邦-宜蘭,2024-05-10,9686
3056,富華新,20,1,19,富邦-宜蘭,2024-05-10,9686
00752,中信中國50,19,0,19,富邦-宜蘭,2024-05-10,9686
1815,富喬,25,7,18,富邦-宜蘭,2024-05-10,9686
5864,致和證,21,4,17,富邦-宜蘭,2024-05-10,9686
3013,晟銘電,41,24,17,富邦-宜蘭,2024-05-10,9686
1473,台南,45,28,17,富邦-宜蘭,2024-05-10,9686
6244,茂迪,18,1,17,富邦-宜蘭,2024-05-10,9686
8121,越峰,48,31,17,富邦-宜蘭,2024-05-10,9686
2409,友達,18,2,16,富邦-宜蘭,2024-05-10,9686
2897,王道銀行,16,0,16,富邦-宜蘭,2024-05-10,9686
4958,臻鼎-KY,17,1,16,富邦-宜蘭,2024-05-10,9686
8112,至上,43,27,16,富邦-宜蘭,2024-05-10,9686
3710,連展投控,15,0,15,富邦-宜蘭,2024-05-10,9686
4157,太景*-KY,15,0,15,富邦-宜蘭,2024-05-10,9686
2605,新興,44,29,15,富邦-宜蘭,2024-05-10,9686
4562,穎漢,162,147,15,富邦-宜蘭,2024-05-10,9686
3576,聯合再生,16,2,14,富邦-宜蘭,2024-05-10,9686
4127,天良,14,0,14,富邦-宜蘭,2024-05-10,9686
1532,勤美,34,20,14,富邦-宜蘭,2024-05-10,9686
00945B,凱基美國非投等債,14,0,14,富邦-宜蘭,2024-05-10,9686
3036,文曄,16,3,13,富邦-宜蘭,2024-05-10,9686
2352,佳世達,20,7,13,富邦-宜蘭,2024-05-10,9686
1308,亞聚,13,0,13,富邦-宜蘭,2024-05-10,9686
00885,富邦越南,22,9,13,富邦-宜蘭,2024-05-10,9686
6214,精誠,14,1,13,富邦-宜蘭,2024-05-10,9686
00929,復華台灣科技優息,420,35,385,富邦-宜蘭,2024-05-13,9686
00632R,元大台灣50反1,371,0,371,富邦-宜蘭,2024-05-13,9686
5475,德宏,212,2,210,富邦-宜蘭,2024-05-13,9686
00665L,富邦�琤肭磪囓�2,203,4,199,富邦-宜蘭,2024-05-13,9686
2618,長榮航,154,60,94,富邦-宜蘭,2024-05-13,9686
2367,燿華,184,100,84,富邦-宜蘭,2024-05-13,9686
1434,福懋,80,10,70,富邦-宜蘭,2024-05-13,9686
5521,工信,66,1,65,富邦-宜蘭,2024-05-13,9686
2882,國泰金,70,5,65,富邦-宜蘭,2024-05-13,9686
00882,中信中國高股息,69,9,60,富邦-宜蘭,2024-05-13,9686
2883,凱基金,60,2,58,富邦-宜蘭,2024-05-13,9686
2497,怡利電,52,1,51,富邦-宜蘭,2024-05-13,9686
2610,華航,228,177,51,富邦-宜蘭,2024-05-13,9686
2617,台航,56,7,49,富邦-宜蘭,2024-05-13,9686
2501,國建,48,5,43,富邦-宜蘭,2024-05-13,9686
00934,中信成長高股息,41,0,41,富邦-宜蘭,2024-05-13,9686
00878,國泰永續高股息,59,19,40,富邦-宜蘭,2024-05-13,9686
1452,宏益,101,63,38,富邦-宜蘭,2024-05-13,9686
00935,野村臺灣新科技50,45,11,34,富邦-宜蘭,2024-05-13,9686
00720B,元大投資級公司債,33,0,33,富邦-宜蘭,2024-05-13,9686
6770,力積電,47,14,33,富邦-宜蘭,2024-05-13,9686
2363,矽統,84,53,31,富邦-宜蘭,2024-05-13,9686
4967,十銓,35,4,31,富邦-宜蘭,2024-05-13,9686
3284,太普高,30,0,30,富邦-宜蘭,2024-05-13,9686
00664R,國泰臺灣加權反1,30,0,30,富邦-宜蘭,2024-05-13,9686
2634,漢翔,39,12,27,富邦-宜蘭,2024-05-13,9686
6148,驊宏資,30,4,26,富邦-宜蘭,2024-05-13,9686
2104,國際中橡,25,0,25,富邦-宜蘭,2024-05-13,9686
2615,萬海,131,106,25,富邦-宜蘭,2024-05-13,9686
2486,一詮,36,12,24,富邦-宜蘭,2024-05-13,9686
4903,聯光通,24,0,24,富邦-宜蘭,2024-05-13,9686
00857B,永豐20年美公債,24,0,24,富邦-宜蘭,2024-05-13,9686
2312,金寶,25,2,23,富邦-宜蘭,2024-05-13,9686
3030,德律,56,34,22,富邦-宜蘭,2024-05-13,9686
00936,台新永續高息中小,24,3,21,富邦-宜蘭,2024-05-13,9686
3516,亞帝歐,25,4,21,富邦-宜蘭,2024-05-13,9686
5469,瀚宇博,22,1,21,富邦-宜蘭,2024-05-13,9686
1513,中興電,52,32,20,富邦-宜蘭,2024-05-13,9686
3231,緯創,21,1,20,富邦-宜蘭,2024-05-13,9686
3356,奇偶,21,1,20,富邦-宜蘭,2024-05-13,9686
00715L,期街口布蘭特正2,20,0,20,富邦-宜蘭,2024-05-13,9686
2701,萬企,20,0,20,富邦-宜蘭,2024-05-13,9686
4746,台耀,20,0,20,富邦-宜蘭,2024-05-13,9686
3628,盈正,20,0,20,富邦-宜蘭,2024-05-13,9686
6122,擎邦,20,0,20,富邦-宜蘭,2024-05-13,9686
4960,誠美材,22,2,20,富邦-宜蘭,2024-05-13,9686
1201,味全,20,1,19,富邦-宜蘭,2024-05-13,9686
6863,永道-KY,20,1,19,富邦-宜蘭,2024-05-13,9686
6667,信紘科,27,8,19,富邦-宜蘭,2024-05-13,9686
2537,聯上發,19,0,19,富邦-宜蘭,2024-05-13,9686
2547,日勝生,205,2,203,富邦-宜蘭,2024-05-14,9686
00632R,元大台灣50反1,195,3,192,富邦-宜蘭,2024-05-14,9686
00937B,群益ESG投等債20,144,3,141,富邦-宜蘭,2024-05-14,9686
00929,復華台灣科技優息,146,55,91,富邦-宜蘭,2024-05-14,9686
3047,訊舟,85,16,69,富邦-宜蘭,2024-05-14,9686
2497,怡利電,68,0,68,富邦-宜蘭,2024-05-14,9686
2543,皇昌,61,0,61,富邦-宜蘭,2024-05-14,9686
2482,連宇,71,20,51,富邦-宜蘭,2024-05-14,9686
00676R,富邦臺灣加權反1,50,0,50,富邦-宜蘭,2024-05-14,9686
00664R,國泰臺灣加權反1,50,0,50,富邦-宜蘭,2024-05-14,9686
2889,國票金,45,1,44,富邦-宜蘭,2024-05-14,9686
2606,裕民,61,20,41,富邦-宜蘭,2024-05-14,9686
2615,萬海,230,192,38,富邦-宜蘭,2024-05-14,9686
1101,台泥,37,1,36,富邦-宜蘭,2024-05-14,9686
4303,信立,36,1,35,富邦-宜蘭,2024-05-14,9686
2618,長榮航,59,27,32,富邦-宜蘭,2024-05-14,9686
2636,台驊控股,31,2,29,富邦-宜蘭,2024-05-14,9686
00795B,中信美國公債20年,28,0,28,富邦-宜蘭,2024-05-14,9686
1452,宏益,61,35,26,富邦-宜蘭,2024-05-14,9686
1815,富喬,28,3,25,富邦-宜蘭,2024-05-14,9686
00878,國泰永續高股息,54,30,24,富邦-宜蘭,2024-05-14,9686
2427,三商電,24,1,23,富邦-宜蘭,2024-05-14,9686
3005,神基,39,18,21,富邦-宜蘭,2024-05-14,9686
00679B,元大美債20年,21,0,21,富邦-宜蘭,2024-05-14,9686
6863,永道-KY,24,4,20,富邦-宜蘭,2024-05-14,9686
2801,彰銀,20,0,20,富邦-宜蘭,2024-05-14,9686
2101,南港,24,4,20,富邦-宜蘭,2024-05-14,9686
2845,遠東銀,30,10,20,富邦-宜蘭,2024-05-14,9686
2323,中環,22,2,20,富邦-宜蘭,2024-05-14,9686
00673R,期元大S＆P原油反1,20,0,20,富邦-宜蘭,2024-05-14,9686
3231,緯創,35,15,20,富邦-宜蘭,2024-05-14,9686
2374,佳能,97,78,19,富邦-宜蘭,2024-05-14,9686
2537,聯上發,22,4,18,富邦-宜蘭,2024-05-14,9686
1525,江申,18,0,18,富邦-宜蘭,2024-05-14,9686
2317,鴻海,60,43,17,富邦-宜蘭,2024-05-14,9686
2353,宏��,81,64,17,富邦-宜蘭,2024-05-14,9686
1608,華榮,26,9,17,富邦-宜蘭,2024-05-14,9686
4716,大立,21,4,17,富邦-宜蘭,2024-05-14,9686
00933B,國泰10Y+金融債,18,1,17,富邦-宜蘭,2024-05-14,9686
3706,神達,63,47,16,富邦-宜蘭,2024-05-14,9686
8069,元太,16,0,16,富邦-宜蘭,2024-05-14,9686
2890,永豐金,15,0,15,富邦-宜蘭,2024-05-14,9686
2312,金寶,20,5,15,富邦-宜蘭,2024-05-14,9686
3694,海華,15,0,15,富邦-宜蘭,2024-05-14,9686
1440,南紡,16,1,15,富邦-宜蘭,2024-05-14,9686
00719B,元大美債1-3,15,0,15,富邦-宜蘭,2024-05-14,9686
6207,雷科,24,10,14,富邦-宜蘭,2024-05-14,9686
8033,雷虎,18,5,13,富邦-宜蘭,2024-05-14,9686
5222,全訊,13,0,13,富邦-宜蘭,2024-05-14,9686
4562,穎漢,13,1,12,富邦-宜蘭,2024-05-14,9686
00676R,富邦臺灣加權反1,260,0,260,富邦-宜蘭,2024-05-15,9686
00937B,群益ESG投等債20,173,0,173,富邦-宜蘭,2024-05-15,9686
2405,輔信,164,12,152,富邦-宜蘭,2024-05-15,9686
00905,FT臺灣Smart,98,4,94,富邦-宜蘭,2024-05-15,9686
2374,佳能,150,84,66,富邦-宜蘭,2024-05-15,9686
1312,國喬,75,10,65,富邦-宜蘭,2024-05-15,9686
00919,群益台灣精選高息,74,14,60,富邦-宜蘭,2024-05-15,9686
3047,訊舟,100,43,57,富邦-宜蘭,2024-05-15,9686
2514,龍邦,59,4,55,富邦-宜蘭,2024-05-15,9686
2609,陽明,342,289,53,富邦-宜蘭,2024-05-15,9686
2486,一詮,52,4,48,富邦-宜蘭,2024-05-15,9686
00940,元大台灣價值高息,90,43,47,富邦-宜蘭,2024-05-15,9686
2352,佳世達,40,0,40,富邦-宜蘭,2024-05-15,9686
2867,三商壽,40,1,39,富邦-宜蘭,2024-05-15,9686
1532,勤美,41,3,38,富邦-宜蘭,2024-05-15,9686
00929,復華台灣科技優息,167,134,33,富邦-宜蘭,2024-05-15,9686
9958,世紀鋼,93,61,32,富邦-宜蘭,2024-05-15,9686
2614,東森,30,0,30,富邦-宜蘭,2024-05-15,9686
2329,華泰,30,1,29,富邦-宜蘭,2024-05-15,9686
2362,藍天,36,8,28,富邦-宜蘭,2024-05-15,9686
6727,亞泰金屬,27,1,26,富邦-宜蘭,2024-05-15,9686
8070,長華*,29,5,24,富邦-宜蘭,2024-05-15,9686
1702,南僑,25,2,23,富邦-宜蘭,2024-05-15,9686
2897,王道銀行,22,0,22,富邦-宜蘭,2024-05-15,9686
1540,喬福,22,0,22,富邦-宜蘭,2024-05-15,9686
1563,巧新,26,5,21,富邦-宜蘭,2024-05-15,9686
00946,群益科技高息成長,27,6,21,富邦-宜蘭,2024-05-15,9686
2464,盟立,51,30,21,富邦-宜蘭,2024-05-15,9686
2208,台船,25,5,20,富邦-宜蘭,2024-05-15,9686
1617,榮星,20,1,19,富邦-宜蘭,2024-05-15,9686
2317,鴻海,89,71,18,富邦-宜蘭,2024-05-15,9686
2603,長榮,62,44,18,富邦-宜蘭,2024-05-15,9686
6716,應廣,18,0,18,富邦-宜蘭,2024-05-15,9686
2406,國碩,50,33,17,富邦-宜蘭,2024-05-15,9686
2610,華航,40,23,17,富邦-宜蘭,2024-05-15,9686
3706,神達,54,38,16,富邦-宜蘭,2024-05-15,9686
5410,國眾,16,0,16,富邦-宜蘭,2024-05-15,9686
00933B,國泰10Y+金融債,16,0,16,富邦-宜蘭,2024-05-15,9686
9802,鈺齊-KY,16,0,16,富邦-宜蘭,2024-05-15,9686
2704,國賓,16,0,16,富邦-宜蘭,2024-05-15,9686
2634,漢翔,50,34,16,富邦-宜蘭,2024-05-15,9686
2323,中環,18,2,16,富邦-宜蘭,2024-05-15,9686
00932,兆豐永續高息等權,15,0,15,富邦-宜蘭,2024-05-15,9686
6863,永道-KY,32,17,15,富邦-宜蘭,2024-05-15,9686
00725B,國泰投資級公司債,15,0,15,富邦-宜蘭,2024-05-15,9686
00878,國泰永續高股息,50,36,14,富邦-宜蘭,2024-05-15,9686
6753,龍德造船,21,8,13,富邦-宜蘭,2024-05-15,9686
2515,中工,15,2,13,富邦-宜蘭,2024-05-15,9686
2506,太設,13,0,13,富邦-宜蘭,2024-05-15,9686
3576,聯合再生,13,0,13,富邦-宜蘭,2024-05-15,9686
00680L,元大美債20正2,305,7,298,富邦-宜蘭,2024-05-16,9686
00944,野村趨勢動能高息,244,0,244,富邦-宜蘭,2024-05-16,9686
2489,瑞軒,211,39,172,富邦-宜蘭,2024-05-16,9686
2641,正德,107,0,107,富邦-宜蘭,2024-05-16,9686
3047,訊舟,158,55,103,富邦-宜蘭,2024-05-16,9686
3694,海華,86,8,78,富邦-宜蘭,2024-05-16,9686
3231,緯創,83,10,73,富邦-宜蘭,2024-05-16,9686
2374,佳能,90,20,70,富邦-宜蘭,2024-05-16,9686
2382,廣達,113,44,69,富邦-宜蘭,2024-05-16,9686
1453,大將,73,4,69,富邦-宜蘭,2024-05-16,9686
2356,英業達,94,38,56,富邦-宜蘭,2024-05-16,9686
5302,太欣,50,0,50,富邦-宜蘭,2024-05-16,9686
2885,元大金,56,9,47,富邦-宜蘭,2024-05-16,9686
4934,太極,45,0,45,富邦-宜蘭,2024-05-16,9686
2897,王道銀行,57,12,45,富邦-宜蘭,2024-05-16,9686
00878,國泰永續高股息,85,42,43,富邦-宜蘭,2024-05-16,9686
2609,陽明,352,310,42,富邦-宜蘭,2024-05-16,9686
3356,奇偶,41,0,41,富邦-宜蘭,2024-05-16,9686
00940,元大台灣價值高息,95,57,38,富邦-宜蘭,2024-05-16,9686
5392,能率,81,43,38,富邦-宜蘭,2024-05-16,9686
2611,志信,36,0,36,富邦-宜蘭,2024-05-16,9686
2882,國泰金,43,9,34,富邦-宜蘭,2024-05-16,9686
1608,華榮,65,31,34,富邦-宜蘭,2024-05-16,9686
3030,德律,41,8,33,富邦-宜蘭,2024-05-16,9686
6207,雷科,33,2,31,富邦-宜蘭,2024-05-16,9686
2025,千興,30,0,30,富邦-宜蘭,2024-05-16,9686
2495,普安,31,3,28,富邦-宜蘭,2024-05-16,9686
2501,國建,29,4,25,富邦-宜蘭,2024-05-16,9686
00720B,元大投資級公司債,26,1,25,富邦-宜蘭,2024-05-16,9686
6233,旺玖,25,2,23,富邦-宜蘭,2024-05-16,9686
2211,長榮鋼,23,0,23,富邦-宜蘭,2024-05-16,9686
6928,攸泰科技,23,1,22,富邦-宜蘭,2024-05-16,9686
00724B,群益投資級金融債,20,0,20,富邦-宜蘭,2024-05-16,9686
00932,兆豐永續高息等權,20,0,20,富邦-宜蘭,2024-05-16,9686
1457,宜進,19,0,19,富邦-宜蘭,2024-05-16,9686
6215,和椿,49,30,19,富邦-宜蘭,2024-05-16,9686
1326,台化,19,0,19,富邦-宜蘭,2024-05-16,9686
0056,元大高股息,43,24,19,富邦-宜蘭,2024-05-16,9686
1474,弘裕,18,0,18,富邦-宜蘭,2024-05-16,9686
00712,復華富時不動產,23,5,18,富邦-宜蘭,2024-05-16,9686
2338,光罩,17,0,17,富邦-宜蘭,2024-05-16,9686
00795B,中信美國公債20年,20,3,17,富邦-宜蘭,2024-05-16,9686
1444,力麗,25,10,15,富邦-宜蘭,2024-05-16,9686
1540,喬福,15,0,15,富邦-宜蘭,2024-05-16,9686
1456,怡華,15,0,15,富邦-宜蘭,2024-05-16,9686
1717,長興,15,0,15,富邦-宜蘭,2024-05-16,9686
2104,國際中橡,14,0,14,富邦-宜蘭,2024-05-16,9686
3011,今皓,13,0,13,富邦-宜蘭,2024-05-16,9686
00942B,台新美A公司債20+,13,0,13,富邦-宜蘭,2024-05-16,9686
2504,國產,71,59,12,富邦-宜蘭,2024-05-16,9686
00929,復華台灣科技優息,353,5,348,富邦-宜蘭,2024-05-17,9686
2867,三商壽,564,346,218,富邦-宜蘭,2024-05-17,9686
2489,瑞軒,274,89,185,富邦-宜蘭,2024-05-17,9686
2883,凱基金,165,9,156,富邦-宜蘭,2024-05-17,9686
2349,錸德,141,0,141,富邦-宜蘭,2024-05-17,9686
5392,能率,164,49,115,富邦-宜蘭,2024-05-17,9686
00937B,群益ESG投等債20,121,9,112,富邦-宜蘭,2024-05-17,9686
2897,王道銀行,110,0,110,富邦-宜蘭,2024-05-17,9686
5498,凱崴,110,2,108,富邦-宜蘭,2024-05-17,9686
2605,新興,102,18,84,富邦-宜蘭,2024-05-17,9686
8071,能率網通,75,0,75,富邦-宜蘭,2024-05-17,9686
00946,群益科技高息成長,73,0,73,富邦-宜蘭,2024-05-17,9686
1413,宏洲,69,0,69,富邦-宜蘭,2024-05-17,9686
2367,燿華,271,205,66,富邦-宜蘭,2024-05-17,9686
5608,四維航,61,2,59,富邦-宜蘭,2024-05-17,9686
1440,南紡,50,0,50,富邦-宜蘭,2024-05-17,9686
00878,國泰永續高股息,100,51,49,富邦-宜蘭,2024-05-17,9686
6215,和椿,53,6,47,富邦-宜蘭,2024-05-17,9686
1452,宏益,90,47,43,富邦-宜蘭,2024-05-17,9686
2882,國泰金,65,23,42,富邦-宜蘭,2024-05-17,9686
2312,金寶,79,43,36,富邦-宜蘭,2024-05-17,9686
5469,瀚宇博,35,3,32,富邦-宜蘭,2024-05-17,9686
5230,雷笛克光學,34,2,32,富邦-宜蘭,2024-05-17,9686
2352,佳世達,32,1,31,富邦-宜蘭,2024-05-17,9686
00795B,中信美國公債20年,30,0,30,富邦-宜蘭,2024-05-17,9686
1434,福懋,40,10,30,富邦-宜蘭,2024-05-17,9686
00919,群益台灣精選高息,57,27,30,富邦-宜蘭,2024-05-17,9686
2609,陽明,83,58,25,富邦-宜蘭,2024-05-17,9686
2323,中環,37,12,25,富邦-宜蘭,2024-05-17,9686
1587,吉茂,46,22,24,富邦-宜蘭,2024-05-17,9686
2444,兆勁,23,0,23,富邦-宜蘭,2024-05-17,9686
4549,桓達,30,7,23,富邦-宜蘭,2024-05-17,9686
6257,矽格,56,33,23,富邦-宜蘭,2024-05-17,9686
2408,南亞科,27,5,22,富邦-宜蘭,2024-05-17,9686
00915,凱基優選高股息30,25,3,22,富邦-宜蘭,2024-05-17,9686
1720,生達,61,39,22,富邦-宜蘭,2024-05-17,9686
2317,鴻海,43,21,22,富邦-宜蘭,2024-05-17,9686
3707,漢磊,21,0,21,富邦-宜蘭,2024-05-17,9686
00720B,元大投資級公司債,21,0,21,富邦-宜蘭,2024-05-17,9686
2371,大同,27,7,20,富邦-宜蘭,2024-05-17,9686
2617,台航,20,0,20,富邦-宜蘭,2024-05-17,9686
2537,聯上發,35,15,20,富邦-宜蘭,2024-05-17,9686
1460,宏遠,20,0,20,富邦-宜蘭,2024-05-17,9686
1312,國喬,30,10,20,富邦-宜蘭,2024-05-17,9686
00724B,群益投資級金融債,20,0,20,富邦-宜蘭,2024-05-17,9686
2641,正德,34,14,20,富邦-宜蘭,2024-05-17,9686
00853B,統一美債10年Aa-,20,0,20,富邦-宜蘭,2024-05-17,9686
00740B,富邦全球投等債,20,0,20,富邦-宜蘭,2024-05-17,9686
6235,華孚,20,0,20,富邦-宜蘭,2024-05-17,9686
6753,龍德造船,20,2,18,富邦-宜蘭,2024-05-17,9686
00937B,群益ESG投等債20,130,6,124,富邦-宜蘭,2024-05-20,9686
2514,龍邦,150,54,96,富邦-宜蘭,2024-05-20,9686
6770,力積電,120,24,96,富邦-宜蘭,2024-05-20,9686
2618,長榮航,136,58,78,富邦-宜蘭,2024-05-20,9686
3024,憶聲,60,1,59,富邦-宜蘭,2024-05-20,9686
00929,復華台灣科技優息,141,86,55,富邦-宜蘭,2024-05-20,9686
00637L,元大滬深300正2,76,23,53,富邦-宜蘭,2024-05-20,9686
00946,群益科技高息成長,52,0,52,富邦-宜蘭,2024-05-20,9686
2061,風青,51,0,51,富邦-宜蘭,2024-05-20,9686
00632R,元大台灣50反1,60,10,50,富邦-宜蘭,2024-05-20,9686
3276,宇環,50,0,50,富邦-宜蘭,2024-05-20,9686
00753L,中信中國50正2,58,8,50,富邦-宜蘭,2024-05-20,9686
2312,金寶,100,56,44,富邦-宜蘭,2024-05-20,9686
2610,華航,358,314,44,富邦-宜蘭,2024-05-20,9686
912000,晨訊科-DR,49,6,43,富邦-宜蘭,2024-05-20,9686
3033,威健,57,16,41,富邦-宜蘭,2024-05-20,9686
1817,凱撒衛,38,0,38,富邦-宜蘭,2024-05-20,9686
00676R,富邦臺灣加權反1,30,0,30,富邦-宜蘭,2024-05-20,9686
4933,友輝,30,0,30,富邦-宜蘭,2024-05-20,9686
1210,大成,130,100,30,富邦-宜蘭,2024-05-20,9686
2367,燿華,134,105,29,富邦-宜蘭,2024-05-20,9686
8438,昶昕,30,2,28,富邦-宜蘭,2024-05-20,9686
1326,台化,35,10,25,富邦-宜蘭,2024-05-20,9686
2816,旺旺保,25,0,25,富邦-宜蘭,2024-05-20,9686
3231,緯創,28,4,24,富邦-宜蘭,2024-05-20,9686
2745,五福,23,1,22,富邦-宜蘭,2024-05-20,9686
00688L,國泰20年美債正2,21,0,21,富邦-宜蘭,2024-05-20,9686
4976,佳凌,36,15,21,富邦-宜蘭,2024-05-20,9686
2636,台驊控股,20,0,20,富邦-宜蘭,2024-05-20,9686
1809,中釉,20,0,20,富邦-宜蘭,2024-05-20,9686
2302,麗正,20,0,20,富邦-宜蘭,2024-05-20,9686
1537,廣隆,20,0,20,富邦-宜蘭,2024-05-20,9686
8092,建暐,20,0,20,富邦-宜蘭,2024-05-20,9686
2497,怡利電,20,0,20,富邦-宜蘭,2024-05-20,9686
5703,亞都,20,0,20,富邦-宜蘭,2024-05-20,9686
1618,合機,29,9,20,富邦-宜蘭,2024-05-20,9686
2102,泰豐,20,0,20,富邦-宜蘭,2024-05-20,9686
00650L,復華香港正2,28,8,20,富邦-宜蘭,2024-05-20,9686
00680L,元大美債20正2,19,0,19,富邦-宜蘭,2024-05-20,9686
8071,能率網通,52,33,19,富邦-宜蘭,2024-05-20,9686
3363,上詮,19,1,18,富邦-宜蘭,2024-05-20,9686
1452,宏益,88,70,18,富邦-宜蘭,2024-05-20,9686
2025,千興,20,2,18,富邦-宜蘭,2024-05-20,9686
3005,神基,20,2,18,富邦-宜蘭,2024-05-20,9686
2401,凌陽,22,4,18,富邦-宜蘭,2024-05-20,9686
2204,中華,21,4,17,富邦-宜蘭,2024-05-20,9686
5871,中租-KY,18,1,17,富邦-宜蘭,2024-05-20,9686
2906,高林,17,0,17,富邦-宜蘭,2024-05-20,9686
2359,所羅門,114,97,17,富邦-宜蘭,2024-05-20,9686
00679B,元大美債20年,16,0,16,富邦-宜蘭,2024-05-20,9686
2880,華南金,162,1,161,富邦-宜蘭,2024-05-21,9686
2834,臺企銀,128,1,127,富邦-宜蘭,2024-05-21,9686
00929,復華台灣科技優息,263,163,100,富邦-宜蘭,2024-05-21,9686
00753L,中信中國50正2,97,6,91,富邦-宜蘭,2024-05-21,9686
2374,佳能,140,60,80,富邦-宜蘭,2024-05-21,9686
00937B,群益ESG投等債20,81,5,76,富邦-宜蘭,2024-05-21,9686
2618,長榮航,75,8,67,富邦-宜蘭,2024-05-21,9686
00940,元大台灣價值高息,132,66,66,富邦-宜蘭,2024-05-21,9686
2514,龍邦,67,3,64,富邦-宜蘭,2024-05-21,9686
2312,金寶,86,32,54,富邦-宜蘭,2024-05-21,9686
00878,國泰永續高股息,73,24,49,富邦-宜蘭,2024-05-21,9686
6425,易發,49,2,47,富邦-宜蘭,2024-05-21,9686
3033,威健,60,14,46,富邦-宜蘭,2024-05-21,9686
912000,晨訊科-DR,49,3,46,富邦-宜蘭,2024-05-21,9686
3060,銘異,50,5,45,富邦-宜蘭,2024-05-21,9686
2365,昆盈,124,79,45,富邦-宜蘭,2024-05-21,9686
3356,奇偶,40,0,40,富邦-宜蘭,2024-05-21,9686
3481,群創,56,16,40,富邦-宜蘭,2024-05-21,9686
1460,宏遠,36,0,36,富邦-宜蘭,2024-05-21,9686
1326,台化,34,0,34,富邦-宜蘭,2024-05-21,9686
2371,大同,47,16,31,富邦-宜蘭,2024-05-21,9686
6581,鋼聯,30,0,30,富邦-宜蘭,2024-05-21,9686
1310,台苯,30,0,30,富邦-宜蘭,2024-05-21,9686
4549,桓達,50,20,30,富邦-宜蘭,2024-05-21,9686
2634,漢翔,27,0,27,富邦-宜蘭,2024-05-21,9686
3321,同泰,30,3,27,富邦-宜蘭,2024-05-21,9686
2363,矽統,70,44,26,富邦-宜蘭,2024-05-21,9686
6257,矽格,28,2,26,富邦-宜蘭,2024-05-21,9686
1605,華新,192,167,25,富邦-宜蘭,2024-05-21,9686
1303,南亞,25,1,24,富邦-宜蘭,2024-05-21,9686
9962,有益,22,0,22,富邦-宜蘭,2024-05-21,9686
1101,台泥,22,0,22,富邦-宜蘭,2024-05-21,9686
2615,萬海,22,1,21,富邦-宜蘭,2024-05-21,9686
1434,福懋,21,0,21,富邦-宜蘭,2024-05-21,9686
2605,新興,34,13,21,富邦-宜蘭,2024-05-21,9686
1301,台塑,24,3,21,富邦-宜蘭,2024-05-21,9686
00688L,國泰20年美債正2,20,0,20,富邦-宜蘭,2024-05-21,9686
3702,大聯大,19,0,19,富邦-宜蘭,2024-05-21,9686
2317,鴻海,38,19,19,富邦-宜蘭,2024-05-21,9686
2515,中工,27,8,19,富邦-宜蘭,2024-05-21,9686
6605,帝寶,20,2,18,富邦-宜蘭,2024-05-21,9686
2609,陽明,34,17,17,富邦-宜蘭,2024-05-21,9686
2409,友達,17,0,17,富邦-宜蘭,2024-05-21,9686
2027,大成鋼,39,23,16,富邦-宜蘭,2024-05-21,9686
1714,和桐,15,0,15,富邦-宜蘭,2024-05-21,9686
3010,華立,15,0,15,富邦-宜蘭,2024-05-21,9686
1722,台肥,15,0,15,富邦-宜蘭,2024-05-21,9686
8150,南茂,16,1,15,富邦-宜蘭,2024-05-21,9686
3030,德律,47,32,15,富邦-宜蘭,2024-05-21,9686
1708,東鹼,15,0,15,富邦-宜蘭,2024-05-21,9686
00632R,元大台灣50反1,671,65,606,富邦-宜蘭,2024-05-22,9686
00664R,國泰臺灣加權反1,200,0,200,富邦-宜蘭,2024-05-22,9686
00937B,群益ESG投等債20,139,30,109,富邦-宜蘭,2024-05-22,9686
00905,FT臺灣Smart,106,2,104,富邦-宜蘭,2024-05-22,9686
00772B,中信高評級公司債,100,0,100,富邦-宜蘭,2024-05-22,9686
6216,居易,100,1,99,富邦-宜蘭,2024-05-22,9686
2613,中櫃,111,12,99,富邦-宜蘭,2024-05-22,9686
2601,益航,100,2,98,富邦-宜蘭,2024-05-22,9686
5608,四維航,105,10,95,富邦-宜蘭,2024-05-22,9686
00687B,國泰20年美債,106,20,86,富邦-宜蘭,2024-05-22,9686
2641,正德,80,10,70,富邦-宜蘭,2024-05-22,9686
4533,協易機,100,34,66,富邦-宜蘭,2024-05-22,9686
2884,玉山金,65,0,65,富邦-宜蘭,2024-05-22,9686
3030,德律,83,20,63,富邦-宜蘭,2024-05-22,9686
8071,能率網通,90,32,58,富邦-宜蘭,2024-05-22,9686
2027,大成鋼,56,2,54,富邦-宜蘭,2024-05-22,9686
2611,志信,54,2,52,富邦-宜蘭,2024-05-22,9686
00665L,富邦�琤肭磪囓�2,55,5,50,富邦-宜蘭,2024-05-22,9686
2888,新光金,40,0,40,富邦-宜蘭,2024-05-22,9686
4111,濟生,79,39,40,富邦-宜蘭,2024-05-22,9686
2634,漢翔,47,13,34,富邦-宜蘭,2024-05-22,9686
8121,越峰,32,0,32,富邦-宜蘭,2024-05-22,9686
1326,台化,36,5,31,富邦-宜蘭,2024-05-22,9686
2867,三商壽,66,37,29,富邦-宜蘭,2024-05-22,9686
6207,雷科,49,20,29,富邦-宜蘭,2024-05-22,9686
1217,愛之味,30,1,29,富邦-宜蘭,2024-05-22,9686
2369,菱生,31,3,28,富邦-宜蘭,2024-05-22,9686
3491,昇達科,31,4,27,富邦-宜蘭,2024-05-22,9686
6116,彩晶,75,48,27,富邦-宜蘭,2024-05-22,9686
3013,晟銘電,57,33,24,富邦-宜蘭,2024-05-22,9686
2504,國產,25,2,23,富邦-宜蘭,2024-05-22,9686
00676R,富邦臺灣加權反1,20,0,20,富邦-宜蘭,2024-05-22,9686
2241,艾姆勒,21,2,19,富邦-宜蘭,2024-05-22,9686
2495,普安,21,2,19,富邦-宜蘭,2024-05-22,9686
6753,龍德造船,18,0,18,富邦-宜蘭,2024-05-22,9686
4571,鈞興-KY,18,0,18,富邦-宜蘭,2024-05-22,9686
2515,中工,21,3,18,富邦-宜蘭,2024-05-22,9686
2354,鴻準,38,20,18,富邦-宜蘭,2024-05-22,9686
1516,川飛,17,0,17,富邦-宜蘭,2024-05-22,9686
00753L,中信中國50正2,30,14,16,富邦-宜蘭,2024-05-22,9686
5432,新門,24,8,16,富邦-宜蘭,2024-05-22,9686
6125,廣運,69,54,15,富邦-宜蘭,2024-05-22,9686
2913,農林,15,0,15,富邦-宜蘭,2024-05-22,9686
5531,鄉林,15,0,15,富邦-宜蘭,2024-05-22,9686
8070,長華*,22,8,14,富邦-宜蘭,2024-05-22,9686
8064,東捷,45,31,14,富邦-宜蘭,2024-05-22,9686
8110,華東,32,18,14,富邦-宜蘭,2024-05-22,9686
6257,矽格,30,17,13,富邦-宜蘭,2024-05-22,9686
3264,欣銓,16,3,13,富邦-宜蘭,2024-05-22,9686
4543,萬在,18,5,13,富邦-宜蘭,2024-05-22,9686
00946,群益科技高息成長,312,1,311,富邦-宜蘭,2024-05-23,9686
00632R,元大台灣50反1,391,104,287,富邦-宜蘭,2024-05-23,9686
2312,金寶,124,3,121,富邦-宜蘭,2024-05-23,9686
00905,FT臺灣Smart,114,3,111,富邦-宜蘭,2024-05-23,9686
6216,居易,107,0,107,富邦-宜蘭,2024-05-23,9686
00637L,元大滬深300正2,109,5,104,富邦-宜蘭,2024-05-23,9686
2464,盟立,330,235,95,富邦-宜蘭,2024-05-23,9686
00937B,群益ESG投等債20,101,10,91,富邦-宜蘭,2024-05-23,9686
4714,永捷,84,1,83,富邦-宜蘭,2024-05-23,9686
3481,群創,136,66,70,富邦-宜蘭,2024-05-23,9686
6120,達運,68,0,68,富邦-宜蘭,2024-05-23,9686
2392,正崴,120,61,59,富邦-宜蘭,2024-05-23,9686
2880,華南金,54,3,51,富邦-宜蘭,2024-05-23,9686
1434,福懋,50,0,50,富邦-宜蘭,2024-05-23,9686
2002,中鋼,53,7,46,富邦-宜蘭,2024-05-23,9686
3231,緯創,56,12,44,富邦-宜蘭,2024-05-23,9686
6209,今國光,63,20,43,富邦-宜蘭,2024-05-23,9686
4127,天良,101,59,42,富邦-宜蘭,2024-05-23,9686
2324,仁寶,69,27,42,富邦-宜蘭,2024-05-23,9686
2359,所羅門,125,86,39,富邦-宜蘭,2024-05-23,9686
6207,雷科,40,3,37,富邦-宜蘭,2024-05-23,9686
3284,太普高,37,0,37,富邦-宜蘭,2024-05-23,9686
00936,台新永續高息中小,34,0,34,富邦-宜蘭,2024-05-23,9686
6190,萬泰科,34,2,32,富邦-宜蘭,2024-05-23,9686
1802,台玻,30,0,30,富邦-宜蘭,2024-05-23,9686
2884,玉山金,35,6,29,富邦-宜蘭,2024-05-23,9686
2101,南港,43,15,28,富邦-宜蘭,2024-05-23,9686
2497,怡利電,25,0,25,富邦-宜蘭,2024-05-23,9686
2409,友達,35,11,24,富邦-宜蘭,2024-05-23,9686
4967,十銓,29,5,24,富邦-宜蘭,2024-05-23,9686
8011,台通,25,1,24,富邦-宜蘭,2024-05-23,9686
1326,台化,23,0,23,富邦-宜蘭,2024-05-23,9686
9945,潤泰新,26,3,23,富邦-宜蘭,2024-05-23,9686
2915,潤泰全,23,0,23,富邦-宜蘭,2024-05-23,9686
00882,中信中國高股息,25,4,21,富邦-宜蘭,2024-05-23,9686
8064,東捷,35,14,21,富邦-宜蘭,2024-05-23,9686
8121,越峰,36,15,21,富邦-宜蘭,2024-05-23,9686
8936,國統,38,18,20,富邦-宜蘭,2024-05-23,9686
2913,農林,20,0,20,富邦-宜蘭,2024-05-23,9686
2701,萬企,20,0,20,富邦-宜蘭,2024-05-23,9686
4207,環泰,20,0,20,富邦-宜蘭,2024-05-23,9686
6147,頎邦,20,0,20,富邦-宜蘭,2024-05-23,9686
5515,建國,20,1,19,富邦-宜蘭,2024-05-23,9686
3607,谷崧,20,1,19,富邦-宜蘭,2024-05-23,9686
8039,台虹,18,0,18,富邦-宜蘭,2024-05-23,9686
2501,國建,21,3,18,富邦-宜蘭,2024-05-23,9686
1301,台塑,18,2,16,富邦-宜蘭,2024-05-23,9686
00665L,富邦�琤肭磪囓�2,29,13,16,富邦-宜蘭,2024-05-23,9686
3652,精聯,16,0,16,富邦-宜蘭,2024-05-23,9686
1608,華榮,33,17,16,富邦-宜蘭,2024-05-23,9686
00937B,群益ESG投等債20,167,15,152,富邦-宜蘭,2024-05-24,9686
1608,華榮,99,3,96,富邦-宜蘭,2024-05-24,9686
3060,銘異,110,25,85,富邦-宜蘭,2024-05-24,9686
00712,復華富時不動產,70,0,70,富邦-宜蘭,2024-05-24,9686
00929,復華台灣科技優息,115,50,65,富邦-宜蘭,2024-05-24,9686
3062,建漢,62,1,61,富邦-宜蘭,2024-05-24,9686
6770,力積電,110,56,54,富邦-宜蘭,2024-05-24,9686
2303,聯電,80,27,53,富邦-宜蘭,2024-05-24,9686
00650L,復華香港正2,72,20,52,富邦-宜蘭,2024-05-24,9686
3466,德晉,50,3,47,富邦-宜蘭,2024-05-24,9686
2867,三商壽,55,9,46,富邦-宜蘭,2024-05-24,9686
2392,正崴,84,40,44,富邦-宜蘭,2024-05-24,9686
2634,漢翔,49,7,42,富邦-宜蘭,2024-05-24,9686
1707,葡萄王,41,0,41,富邦-宜蘭,2024-05-24,9686
2371,大同,67,32,35,富邦-宜蘭,2024-05-24,9686
4908,前鼎,41,6,35,富邦-宜蘭,2024-05-24,9686
3041,揚智,30,0,30,富邦-宜蘭,2024-05-24,9686
2002,中鋼,26,0,26,富邦-宜蘭,2024-05-24,9686
3234,光環,35,9,26,富邦-宜蘭,2024-05-24,9686
00688L,國泰20年美債正2,25,0,25,富邦-宜蘭,2024-05-24,9686
4566,時碩工業,25,0,25,富邦-宜蘭,2024-05-24,9686
00633L,富邦上証正2,25,0,25,富邦-宜蘭,2024-05-24,9686
2027,大成鋼,38,13,25,富邦-宜蘭,2024-05-24,9686
2324,仁寶,34,10,24,富邦-宜蘭,2024-05-24,9686
2884,玉山金,29,5,24,富邦-宜蘭,2024-05-24,9686
00946,群益科技高息成長,29,5,24,富邦-宜蘭,2024-05-24,9686
6244,茂迪,24,0,24,富邦-宜蘭,2024-05-24,9686
2618,長榮航,42,18,24,富邦-宜蘭,2024-05-24,9686
3030,德律,23,0,23,富邦-宜蘭,2024-05-24,9686
2359,所羅門,114,92,22,富邦-宜蘭,2024-05-24,9686
2486,一詮,63,41,22,富邦-宜蘭,2024-05-24,9686
2534,宏盛,21,0,21,富邦-宜蘭,2024-05-24,9686
00772B,中信高評級公司債,22,1,21,富邦-宜蘭,2024-05-24,9686
4543,萬在,41,20,21,富邦-宜蘭,2024-05-24,9686
2891,中信金,28,8,20,富邦-宜蘭,2024-05-24,9686
8033,雷虎,18,0,18,富邦-宜蘭,2024-05-24,9686
2886,兆豐金,20,2,18,富邦-宜蘭,2024-05-24,9686
3163,波若威,50,32,18,富邦-宜蘭,2024-05-24,9686
6147,頎邦,18,0,18,富邦-宜蘭,2024-05-24,9686
2464,盟立,39,22,17,富邦-宜蘭,2024-05-24,9686
6190,萬泰科,28,12,16,富邦-宜蘭,2024-05-24,9686
1301,台塑,14,0,14,富邦-宜蘭,2024-05-24,9686
2743,山富,18,4,14,富邦-宜蘭,2024-05-24,9686
5498,凱崴,33,19,14,富邦-宜蘭,2024-05-24,9686
1303,南亞,16,2,14,富邦-宜蘭,2024-05-24,9686
2458,義隆,14,0,14,富邦-宜蘭,2024-05-24,9686
4714,永捷,14,0,14,富邦-宜蘭,2024-05-24,9686
3491,昇達科,16,2,14,富邦-宜蘭,2024-05-24,9686
3706,神達,33,20,13,富邦-宜蘭,2024-05-24,9686
5426,振發,14,1,13,富邦-宜蘭,2024-05-24,9686
00905,FT臺灣Smart,366,5,361,富邦-宜蘭,2024-05-27,9686
2489,瑞軒,331,115,216,富邦-宜蘭,2024-05-27,9686
00937B,群益ESG投等債20,272,71,201,富邦-宜蘭,2024-05-27,9686
1312,國喬,150,6,144,富邦-宜蘭,2024-05-27,9686
00946,群益科技高息成長,152,10,142,富邦-宜蘭,2024-05-27,9686
2363,矽統,370,243,127,富邦-宜蘭,2024-05-27,9686
8358,金居,105,5,100,富邦-宜蘭,2024-05-27,9686
00929,復華台灣科技優息,279,181,98,富邦-宜蘭,2024-05-27,9686
00665L,富邦�琤肭磪囓�2,94,0,94,富邦-宜蘭,2024-05-27,9686
2002,中鋼,116,23,93,富邦-宜蘭,2024-05-27,9686
2353,宏��,237,156,81,富邦-宜蘭,2024-05-27,9686
5498,凱崴,114,34,80,富邦-宜蘭,2024-05-27,9686
2611,志信,80,4,76,富邦-宜蘭,2024-05-27,9686
3481,群創,115,50,65,富邦-宜蘭,2024-05-27,9686
6834,天二科技,65,0,65,富邦-宜蘭,2024-05-27,9686
3047,訊舟,114,50,64,富邦-宜蘭,2024-05-27,9686
9105,泰金寶-DR,86,22,64,富邦-宜蘭,2024-05-27,9686
912000,晨訊科-DR,54,0,54,富邦-宜蘭,2024-05-27,9686
5452,佶優,54,1,53,富邦-宜蘭,2024-05-27,9686
3466,德晉,63,13,50,富邦-宜蘭,2024-05-27,9686
00753L,中信中國50正2,44,10,34,富邦-宜蘭,2024-05-27,9686
6227,茂綸,35,2,33,富邦-宜蘭,2024-05-27,9686
3284,太普高,30,0,30,富邦-宜蘭,2024-05-27,9686
4577,達航科技,30,0,30,富邦-宜蘭,2024-05-27,9686
1453,大將,34,4,30,富邦-宜蘭,2024-05-27,9686
2025,千興,27,0,27,富邦-宜蘭,2024-05-27,9686
1618,合機,37,10,27,富邦-宜蘭,2024-05-27,9686
1815,富喬,68,44,24,富邦-宜蘭,2024-05-27,9686
4545,銘鈺,26,2,24,富邦-宜蘭,2024-05-27,9686
2609,陽明,63,41,22,富邦-宜蘭,2024-05-27,9686
2603,長榮,117,95,22,富邦-宜蘭,2024-05-27,9686
2204,中華,22,1,21,富邦-宜蘭,2024-05-27,9686
2472,立隆電,30,10,20,富邦-宜蘭,2024-05-27,9686
1452,宏益,82,62,20,富邦-宜蘭,2024-05-27,9686
4157,太景*-KY,20,0,20,富邦-宜蘭,2024-05-27,9686
00679B,元大美債20年,19,1,18,富邦-宜蘭,2024-05-27,9686
3703,欣陸,18,0,18,富邦-宜蘭,2024-05-27,9686
00764B,群益25年美債,18,0,18,富邦-宜蘭,2024-05-27,9686
00712,復華富時不動產,18,0,18,富邦-宜蘭,2024-05-27,9686
4127,天良,21,3,18,富邦-宜蘭,2024-05-27,9686
6191,精成科,18,0,18,富邦-宜蘭,2024-05-27,9686
1720,生達,17,0,17,富邦-宜蘭,2024-05-27,9686
6125,廣運,48,31,17,富邦-宜蘭,2024-05-27,9686
6257,矽格,17,1,16,富邦-宜蘭,2024-05-27,9686
2618,長榮航,46,30,16,富邦-宜蘭,2024-05-27,9686
2369,菱生,23,8,15,富邦-宜蘭,2024-05-27,9686
00795B,中信美國公債20年,15,0,15,富邦-宜蘭,2024-05-27,9686
2467,志聖,17,3,14,富邦-宜蘭,2024-05-27,9686
1707,葡萄王,14,0,14,富邦-宜蘭,2024-05-27,9686
9958,世紀鋼,32,19,13,富邦-宜蘭,2024-05-27,9686
00946,群益科技高息成長,427,22,405,富邦-宜蘭,2024-05-28,9686
2601,益航,156,14,142,富邦-宜蘭,2024-05-28,9686
2349,錸德,130,10,120,富邦-宜蘭,2024-05-28,9686
2354,鴻準,233,137,96,富邦-宜蘭,2024-05-28,9686
2312,金寶,93,0,93,富邦-宜蘭,2024-05-28,9686
00937B,群益ESG投等債20,171,81,90,富邦-宜蘭,2024-05-28,9686
2514,龍邦,82,2,80,富邦-宜蘭,2024-05-28,9686
00919,群益台灣精選高息,82,4,78,富邦-宜蘭,2024-05-28,9686
2495,普安,92,16,76,富邦-宜蘭,2024-05-28,9686
2353,宏��,156,84,72,富邦-宜蘭,2024-05-28,9686
2609,陽明,123,53,70,富邦-宜蘭,2024-05-28,9686
2401,凌陽,154,85,69,富邦-宜蘭,2024-05-28,9686
3041,揚智,71,6,65,富邦-宜蘭,2024-05-28,9686
00929,復華台灣科技優息,106,42,64,富邦-宜蘭,2024-05-28,9686
00632R,元大台灣50反1,59,0,59,富邦-宜蘭,2024-05-28,9686
1516,川飛,51,1,50,富邦-宜蘭,2024-05-28,9686
00679B,元大美債20年,52,3,49,富邦-宜蘭,2024-05-28,9686
6023,元大期,46,0,46,富邦-宜蘭,2024-05-28,9686
1312,國喬,50,5,45,富邦-宜蘭,2024-05-28,9686
2027,大成鋼,44,0,44,富邦-宜蘭,2024-05-28,9686
3047,訊舟,93,52,41,富邦-宜蘭,2024-05-28,9686
2301,光寶科,46,5,41,富邦-宜蘭,2024-05-28,9686
2882,國泰金,80,40,40,富邦-宜蘭,2024-05-28,9686
00712,復華富時不動產,45,7,38,富邦-宜蘭,2024-05-28,9686
6188,廣明,78,41,37,富邦-宜蘭,2024-05-28,9686
00687B,國泰20年美債,42,6,36,富邦-宜蘭,2024-05-28,9686
2393,億光,36,0,36,富邦-宜蘭,2024-05-28,9686
8064,東捷,82,51,31,富邦-宜蘭,2024-05-28,9686
2891,中信金,35,5,30,富邦-宜蘭,2024-05-28,9686
4576,大銀微系統,30,1,29,富邦-宜蘭,2024-05-28,9686
3450,聯鈞,71,44,27,富邦-宜蘭,2024-05-28,9686
1514,亞力,29,4,25,富邦-宜蘭,2024-05-28,9686
2886,兆豐金,24,0,24,富邦-宜蘭,2024-05-28,9686
2002,中鋼,47,23,24,富邦-宜蘭,2024-05-28,9686
2883,凱基金,59,36,23,富邦-宜蘭,2024-05-28,9686
9105,泰金寶-DR,22,0,22,富邦-宜蘭,2024-05-28,9686
2867,三商壽,41,19,22,富邦-宜蘭,2024-05-28,9686
2615,萬海,45,24,21,富邦-宜蘭,2024-05-28,9686
2305,全友,21,0,21,富邦-宜蘭,2024-05-28,9686
00795B,中信美國公債20年,21,0,21,富邦-宜蘭,2024-05-28,9686
00680L,元大美債20正2,20,0,20,富邦-宜蘭,2024-05-28,9686
2636,台驊控股,32,12,20,富邦-宜蘭,2024-05-28,9686
2363,矽統,65,45,20,富邦-宜蘭,2024-05-28,9686
2324,仁寶,24,5,19,富邦-宜蘭,2024-05-28,9686
3594,磐儀,40,21,19,富邦-宜蘭,2024-05-28,9686
8176,智捷,19,0,19,富邦-宜蘭,2024-05-28,9686
4533,協易機,19,1,18,富邦-宜蘭,2024-05-28,9686
2634,漢翔,22,4,18,富邦-宜蘭,2024-05-28,9686
6509,聚和,18,0,18,富邦-宜蘭,2024-05-28,9686
3169,亞信,18,2,16,富邦-宜蘭,2024-05-28,9686
020038,元大ESG配息N,6013,0,6013,富邦-宜蘭,2024-05-29,9686
2867,三商壽,374,46,328,富邦-宜蘭,2024-05-29,9686
00937B,群益ESG投等債20,346,62,284,富邦-宜蘭,2024-05-29,9686
2312,金寶,149,6,143,富邦-宜蘭,2024-05-29,9686
1471,首利,150,9,141,富邦-宜蘭,2024-05-29,9686
2605,新興,214,88,126,富邦-宜蘭,2024-05-29,9686
00940,元大台灣價值高息,176,52,124,富邦-宜蘭,2024-05-29,9686
2601,益航,101,3,98,富邦-宜蘭,2024-05-29,9686
6166,凌華,109,15,94,富邦-宜蘭,2024-05-29,9686
2610,華航,171,83,88,富邦-宜蘭,2024-05-29,9686
2303,聯電,102,23,79,富邦-宜蘭,2024-05-29,9686
2886,兆豐金,69,0,69,富邦-宜蘭,2024-05-29,9686
2352,佳世達,75,8,67,富邦-宜蘭,2024-05-29,9686
2328,廣宇,181,115,66,富邦-宜蘭,2024-05-29,9686
3313,斐成,65,3,62,富邦-宜蘭,2024-05-29,9686
00687B,國泰20年美債,53,0,53,富邦-宜蘭,2024-05-29,9686
00688L,國泰20年美債正2,53,0,53,富邦-宜蘭,2024-05-29,9686
2705,六福,52,0,52,富邦-宜蘭,2024-05-29,9686
6148,驊宏資,52,0,52,富邦-宜蘭,2024-05-29,9686
2367,燿華,56,4,52,富邦-宜蘭,2024-05-29,9686
1312,國喬,52,0,52,富邦-宜蘭,2024-05-29,9686
2883,凱基金,56,8,48,富邦-宜蘭,2024-05-29,9686
3594,磐儀,58,11,47,富邦-宜蘭,2024-05-29,9686
2014,中鴻,42,3,39,富邦-宜蘭,2024-05-29,9686
3564,其陽,48,9,39,富邦-宜蘭,2024-05-29,9686
00679B,元大美債20年,84,47,37,富邦-宜蘭,2024-05-29,9686
00753L,中信中國50正2,36,0,36,富邦-宜蘭,2024-05-29,9686
2880,華南金,36,0,36,富邦-宜蘭,2024-05-29,9686
1434,福懋,35,0,35,富邦-宜蘭,2024-05-29,9686
00772B,中信高評級公司債,34,0,34,富邦-宜蘭,2024-05-29,9686
8105,凌巨,55,21,34,富邦-宜蘭,2024-05-29,9686
2002,中鋼,30,0,30,富邦-宜蘭,2024-05-29,9686
00673R,期元大S＆P原油反1,30,0,30,富邦-宜蘭,2024-05-29,9686
00929,復華台灣科技優息,125,96,29,富邦-宜蘭,2024-05-29,9686
1217,愛之味,28,0,28,富邦-宜蘭,2024-05-29,9686
00650L,復華香港正2,27,0,27,富邦-宜蘭,2024-05-29,9686
2444,兆勁,27,0,27,富邦-宜蘭,2024-05-29,9686
2538,基泰,27,0,27,富邦-宜蘭,2024-05-29,9686
2882,國泰金,29,3,26,富邦-宜蘭,2024-05-29,9686
2486,一詮,32,6,26,富邦-宜蘭,2024-05-29,9686
00712,復華富時不動產,28,2,26,富邦-宜蘭,2024-05-29,9686
8438,昶昕,26,1,25,富邦-宜蘭,2024-05-29,9686
2891,中信金,27,4,23,富邦-宜蘭,2024-05-29,9686
2464,盟立,31,8,23,富邦-宜蘭,2024-05-29,9686
3652,精聯,24,1,23,富邦-宜蘭,2024-05-29,9686
3380,明泰,29,6,23,富邦-宜蘭,2024-05-29,9686
2915,潤泰全,23,0,23,富邦-宜蘭,2024-05-29,9686
4306,炎洲,24,2,22,富邦-宜蘭,2024-05-29,9686
2618,長榮航,86,65,21,富邦-宜蘭,2024-05-29,9686
6207,雷科,38,17,21,富邦-宜蘭,2024-05-29,9686
00679B,元大美債20年,368,1,367,富邦-宜蘭,2024-05-30,9686
00665L,富邦�琤肭磪囓�2,208,13,195,富邦-宜蘭,2024-05-30,9686
00937B,群益ESG投等債20,168,5,163,富邦-宜蘭,2024-05-30,9686
2489,瑞軒,170,40,130,富邦-宜蘭,2024-05-30,9686
1314,中石化,148,28,120,富邦-宜蘭,2024-05-30,9686
2892,第一金,110,0,110,富邦-宜蘭,2024-05-30,9686
5880,合庫金,114,8,106,富邦-宜蘭,2024-05-30,9686
2440,太空梭,105,0,105,富邦-宜蘭,2024-05-30,9686
8105,凌巨,271,169,102,富邦-宜蘭,2024-05-30,9686
1218,泰山,103,3,100,富邦-宜蘭,2024-05-30,9686
00929,復華台灣科技優息,159,62,97,富邦-宜蘭,2024-05-30,9686
2891,中信金,75,10,65,富邦-宜蘭,2024-05-30,9686
2405,輔信,92,30,62,富邦-宜蘭,2024-05-30,9686
00940,元大台灣價值高息,66,8,58,富邦-宜蘭,2024-05-30,9686
00637L,元大滬深300正2,61,4,57,富邦-宜蘭,2024-05-30,9686
00878,國泰永續高股息,82,25,57,富邦-宜蘭,2024-05-30,9686
2514,龍邦,72,22,50,富邦-宜蘭,2024-05-30,9686
00676R,富邦臺灣加權反1,50,0,50,富邦-宜蘭,2024-05-30,9686
2504,國產,47,0,47,富邦-宜蘭,2024-05-30,9686
3231,緯創,52,9,43,富邦-宜蘭,2024-05-30,9686
5706,鳳凰,37,0,37,富邦-宜蘭,2024-05-30,9686
00915,凱基優選高股息30,37,0,37,富邦-宜蘭,2024-05-30,9686
4967,十銓,51,14,37,富邦-宜蘭,2024-05-30,9686
2002,中鋼,36,0,36,富邦-宜蘭,2024-05-30,9686
3312,弘憶股,81,45,36,富邦-宜蘭,2024-05-30,9686
00712,復華富時不動產,36,0,36,富邦-宜蘭,2024-05-30,9686
3051,力特,36,2,34,富邦-宜蘭,2024-05-30,9686
8358,金居,32,0,32,富邦-宜蘭,2024-05-30,9686
2349,錸德,37,5,32,富邦-宜蘭,2024-05-30,9686
00688L,國泰20年美債正2,41,10,31,富邦-宜蘭,2024-05-30,9686
1444,力麗,31,0,31,富邦-宜蘭,2024-05-30,9686
1303,南亞,30,0,30,富邦-宜蘭,2024-05-30,9686
6425,易發,35,5,30,富邦-宜蘭,2024-05-30,9686
5469,瀚宇博,32,2,30,富邦-宜蘭,2024-05-30,9686
2886,兆豐金,29,0,29,富邦-宜蘭,2024-05-30,9686
2317,鴻海,51,22,29,富邦-宜蘭,2024-05-30,9686
00946,群益科技高息成長,28,0,28,富邦-宜蘭,2024-05-30,9686
4303,信立,34,6,28,富邦-宜蘭,2024-05-30,9686
1815,富喬,174,147,27,富邦-宜蘭,2024-05-30,9686
00650L,復華香港正2,46,19,27,富邦-宜蘭,2024-05-30,9686
6505,台塑化,27,0,27,富邦-宜蘭,2024-05-30,9686
3059,華晶科,26,0,26,富邦-宜蘭,2024-05-30,9686
6792,詠業,26,0,26,富邦-宜蘭,2024-05-30,9686
6209,今國光,53,27,26,富邦-宜蘭,2024-05-30,9686
8155,博智,27,1,26,富邦-宜蘭,2024-05-30,9686
2371,大同,31,6,25,富邦-宜蘭,2024-05-30,9686
00795B,中信美國公債20年,25,0,25,富邦-宜蘭,2024-05-30,9686
3712,永崴投控,29,4,25,富邦-宜蘭,2024-05-30,9686
8054,安國,41,16,25,富邦-宜蘭,2024-05-30,9686
3706,神達,28,4,24,富邦-宜蘭,2024-05-30,9686
2867,三商壽,370,27,343,富邦-宜蘭,2024-05-31,9686
00929,復華台灣科技優息,305,8,297,富邦-宜蘭,2024-05-31,9686
00946,群益科技高息成長,241,0,241,富邦-宜蘭,2024-05-31,9686
2489,瑞軒,226,23,203,富邦-宜蘭,2024-05-31,9686
00940,元大台灣價值高息,200,12,188,富邦-宜蘭,2024-05-31,9686
2609,陽明,452,300,152,富邦-宜蘭,2024-05-31,9686
00919,群益台灣精選高息,156,20,136,富邦-宜蘭,2024-05-31,9686
00878,國泰永續高股息,128,15,113,富邦-宜蘭,2024-05-31,9686
2888,新光金,388,282,106,富邦-宜蘭,2024-05-31,9686
00942B,台新美A公司債20+,100,0,100,富邦-宜蘭,2024-05-31,9686
2317,鴻海,104,17,87,富邦-宜蘭,2024-05-31,9686
00665L,富邦�琤肭磪囓�2,65,0,65,富邦-宜蘭,2024-05-31,9686
00939,統一台灣高息動能,60,4,56,富邦-宜蘭,2024-05-31,9686
2303,聯電,73,22,51,富邦-宜蘭,2024-05-31,9686
6770,力積電,85,38,47,富邦-宜蘭,2024-05-31,9686
3312,弘憶股,145,101,44,富邦-宜蘭,2024-05-31,9686
1532,勤美,50,10,40,富邦-宜蘭,2024-05-31,9686
2344,華邦電,39,1,38,富邦-宜蘭,2024-05-31,9686
8463,潤泰材,50,15,35,富邦-宜蘭,2024-05-31,9686
5880,合庫金,31,0,31,富邦-宜蘭,2024-05-31,9686
00918,大華優利高填息30,29,0,29,富邦-宜蘭,2024-05-31,9686
2367,燿華,103,75,28,富邦-宜蘭,2024-05-31,9686
2002,中鋼,28,2,26,富邦-宜蘭,2024-05-31,9686
2618,長榮航,73,47,26,富邦-宜蘭,2024-05-31,9686
2313,華通,29,4,25,富邦-宜蘭,2024-05-31,9686
2615,萬海,25,1,24,富邦-宜蘭,2024-05-31,9686
4906,正文,36,15,21,富邦-宜蘭,2024-05-31,9686
2108,南帝,20,0,20,富邦-宜蘭,2024-05-31,9686
3058,立德,20,0,20,富邦-宜蘭,2024-05-31,9686
1528,恩德,20,0,20,富邦-宜蘭,2024-05-31,9686
4545,銘鈺,22,2,20,富邦-宜蘭,2024-05-31,9686
5230,雷笛克光學,24,5,19,富邦-宜蘭,2024-05-31,9686
3231,緯創,38,19,19,富邦-宜蘭,2024-05-31,9686
2449,京元電子,18,0,18,富邦-宜蘭,2024-05-31,9686
00891,中信關鍵半導體,18,0,18,富邦-宜蘭,2024-05-31,9686
00905,FT臺灣Smart,23,5,18,富邦-宜蘭,2024-05-31,9686
2889,國票金,21,3,18,富邦-宜蘭,2024-05-31,9686
3450,聯鈞,21,3,18,富邦-宜蘭,2024-05-31,9686
8070,長華*,23,5,18,富邦-宜蘭,2024-05-31,9686
2330,台積電,20,2,18,富邦-宜蘭,2024-05-31,9686
3564,其陽,20,2,18,富邦-宜蘭,2024-05-31,9686
2324,仁寶,20,3,17,富邦-宜蘭,2024-05-31,9686
8071,能率網通,16,0,16,富邦-宜蘭,2024-05-31,9686
1442,名軒,18,2,16,富邦-宜蘭,2024-05-31,9686
00715L,期街口布蘭特正2,18,2,16,富邦-宜蘭,2024-05-31,9686
2356,英業達,16,1,15,富邦-宜蘭,2024-05-31,9686
00935,野村臺灣新科技50,15,0,15,富邦-宜蘭,2024-05-31,9686
00852L,國泰美國道瓊正2,15,0,15,富邦-宜蘭,2024-05-31,9686
4903,聯光通,18,3,15,富邦-宜蘭,2024-05-31,9686
4513,福裕,20,5,15,富邦-宜蘭,2024-05-31,9686
00905,FT臺灣Smart,255,0,255,富邦-宜蘭,2024-06-03,9686
1314,中石化,240,33,207,富邦-宜蘭,2024-06-03,9686
2867,三商壽,186,12,174,富邦-宜蘭,2024-06-03,9686
2891,中信金,181,27,154,富邦-宜蘭,2024-06-03,9686
00919,群益台灣精選高息,130,1,129,富邦-宜蘭,2024-06-03,9686
2613,中櫃,115,4,111,富邦-宜蘭,2024-06-03,9686
3047,訊舟,111,6,105,富邦-宜蘭,2024-06-03,9686
00944,野村趨勢動能高息,99,0,99,富邦-宜蘭,2024-06-03,9686
2618,長榮航,112,36,76,富邦-宜蘭,2024-06-03,9686
00929,復華台灣科技優息,116,44,72,富邦-宜蘭,2024-06-03,9686
00937B,群益ESG投等債20,78,7,71,富邦-宜蘭,2024-06-03,9686
2317,鴻海,88,20,68,富邦-宜蘭,2024-06-03,9686
3564,其陽,61,3,58,富邦-宜蘭,2024-06-03,9686
00665L,富邦�琤肭磪囓�2,52,0,52,富邦-宜蘭,2024-06-03,9686
00946,群益科技高息成長,49,0,49,富邦-宜蘭,2024-06-03,9686
1312,國喬,50,5,45,富邦-宜蘭,2024-06-03,9686
00918,大華優利高填息30,46,1,45,富邦-宜蘭,2024-06-03,9686
1815,富喬,81,38,43,富邦-宜蘭,2024-06-03,9686
2354,鴻準,93,51,42,富邦-宜蘭,2024-06-03,9686
1301,台塑,39,0,39,富邦-宜蘭,2024-06-03,9686
2882,國泰金,39,1,38,富邦-宜蘭,2024-06-03,9686
6770,力積電,96,61,35,富邦-宜蘭,2024-06-03,9686
4561,健椿,36,1,35,富邦-宜蘭,2024-06-03,9686
2312,金寶,56,26,30,富邦-宜蘭,2024-06-03,9686
00715L,期街口布蘭特正2,33,3,30,富邦-宜蘭,2024-06-03,9686
2464,盟立,95,65,30,富邦-宜蘭,2024-06-03,9686
2889,國票金,30,0,30,富邦-宜蘭,2024-06-03,9686
2610,華航,31,2,29,富邦-宜蘭,2024-06-03,9686
5880,合庫金,28,0,28,富邦-宜蘭,2024-06-03,9686
2615,萬海,75,47,28,富邦-宜蘭,2024-06-03,9686
2340,台亞,25,0,25,富邦-宜蘭,2024-06-03,9686
2353,宏��,57,33,24,富邦-宜蘭,2024-06-03,9686
3570,大塚,22,0,22,富邦-宜蘭,2024-06-03,9686
2324,仁寶,32,11,21,富邦-宜蘭,2024-06-03,9686
1303,南亞,23,2,21,富邦-宜蘭,2024-06-03,9686
1101,台泥,20,0,20,富邦-宜蘭,2024-06-03,9686
4571,鈞興-KY,20,0,20,富邦-宜蘭,2024-06-03,9686
3287,廣寰科,24,4,20,富邦-宜蘭,2024-06-03,9686
4533,協易機,52,33,19,富邦-宜蘭,2024-06-03,9686
1452,宏益,70,52,18,富邦-宜蘭,2024-06-03,9686
6143,振曜,18,0,18,富邦-宜蘭,2024-06-03,9686
2204,中華,19,2,17,富邦-宜蘭,2024-06-03,9686
00922,國泰台灣領袖50,18,1,17,富邦-宜蘭,2024-06-03,9686
5469,瀚宇博,18,1,17,富邦-宜蘭,2024-06-03,9686
00637L,元大滬深300正2,34,17,17,富邦-宜蘭,2024-06-03,9686
2538,基泰,21,5,16,富邦-宜蘭,2024-06-03,9686
3059,華晶科,63,47,16,富邦-宜蘭,2024-06-03,9686
2352,佳世達,22,7,15,富邦-宜蘭,2024-06-03,9686
6163,華電網,24,9,15,富邦-宜蘭,2024-06-03,9686
6026,福邦證,15,0,15,富邦-宜蘭,2024-06-03,9686
2867,三商壽,511,5,506,富邦-宜蘭,2024-06-04,9686
2888,新光金,447,46,401,富邦-宜蘭,2024-06-04,9686
2312,金寶,318,59,259,富邦-宜蘭,2024-06-04,9686
00881,國泰台灣5G+,117,0,117,富邦-宜蘭,2024-06-04,9686
00878,國泰永續高股息,117,2,115,富邦-宜蘭,2024-06-04,9686
00929,復華台灣科技優息,129,32,97,富邦-宜蘭,2024-06-04,9686
00918,大華優利高填息30,85,0,85,富邦-宜蘭,2024-06-04,9686
3380,明泰,80,0,80,富邦-宜蘭,2024-06-04,9686
00919,群益台灣精選高息,144,72,72,富邦-宜蘭,2024-06-04,9686
00665L,富邦�琤肭磪囓�2,84,14,70,富邦-宜蘭,2024-06-04,9686
2344,華邦電,75,11,64,富邦-宜蘭,2024-06-04,9686
00934,中信成長高股息,163,100,63,富邦-宜蘭,2024-06-04,9686
2317,鴻海,69,11,58,富邦-宜蘭,2024-06-04,9686
2353,宏��,65,12,53,富邦-宜蘭,2024-06-04,9686
2409,友達,58,7,51,富邦-宜蘭,2024-06-04,9686
6125,廣運,101,53,48,富邦-宜蘭,2024-06-04,9686
2506,太設,50,2,48,富邦-宜蘭,2024-06-04,9686
8047,星雲,50,2,48,富邦-宜蘭,2024-06-04,9686
0056,元大高股息,46,2,44,富邦-宜蘭,2024-06-04,9686
2402,毅嘉,43,0,43,富邦-宜蘭,2024-06-04,9686
4571,鈞興-KY,42,0,42,富邦-宜蘭,2024-06-04,9686
3481,群創,42,4,38,富邦-宜蘭,2024-06-04,9686
00715L,期街口布蘭特正2,56,18,38,富邦-宜蘭,2024-06-04,9686
2367,燿華,84,48,36,富邦-宜蘭,2024-06-04,9686
2324,仁寶,62,28,34,富邦-宜蘭,2024-06-04,9686
2618,長榮航,73,40,33,富邦-宜蘭,2024-06-04,9686
1326,台化,37,4,33,富邦-宜蘭,2024-06-04,9686
6215,和椿,38,6,32,富邦-宜蘭,2024-06-04,9686
2495,普安,51,19,32,富邦-宜蘭,2024-06-04,9686
8121,越峰,51,20,31,富邦-宜蘭,2024-06-04,9686
2356,英業達,37,10,27,富邦-宜蘭,2024-06-04,9686
1101,台泥,22,0,22,富邦-宜蘭,2024-06-04,9686
00713,元大台灣高息低波,22,0,22,富邦-宜蘭,2024-06-04,9686
2882,國泰金,22,0,22,富邦-宜蘭,2024-06-04,9686
6770,力積電,28,7,21,富邦-宜蘭,2024-06-04,9686
6120,達運,22,1,21,富邦-宜蘭,2024-06-04,9686
00927,群益半導體收益,21,0,21,富邦-宜蘭,2024-06-04,9686
2002,中鋼,27,7,20,富邦-宜蘭,2024-06-04,9686
4533,協易機,59,39,20,富邦-宜蘭,2024-06-04,9686
6270,倍微,26,6,20,富邦-宜蘭,2024-06-04,9686
8155,博智,20,0,20,富邦-宜蘭,2024-06-04,9686
6486,互動,20,0,20,富邦-宜蘭,2024-06-04,9686
6206,飛捷,20,0,20,富邦-宜蘭,2024-06-04,9686
00900,富邦特選高股息30,20,0,20,富邦-宜蘭,2024-06-04,9686
1301,台塑,21,1,20,富邦-宜蘭,2024-06-04,9686
3260,威剛,20,0,20,富邦-宜蘭,2024-06-04,9686
2301,光寶科,24,5,19,富邦-宜蘭,2024-06-04,9686
2834,臺企銀,19,0,19,富邦-宜蘭,2024-06-04,9686
2331,精英,154,135,19,富邦-宜蘭,2024-06-04,9686
2465,麗臺,40,21,19,富邦-宜蘭,2024-06-04,9686
2888,新光金,321,39,282,富邦-宜蘭,2024-06-05,9686
2506,太設,151,2,149,富邦-宜蘭,2024-06-05,9686
00936,台新永續高息中小,150,6,144,富邦-宜蘭,2024-06-05,9686
00878,國泰永續高股息,129,2,127,富邦-宜蘭,2024-06-05,9686
2002,中鋼,123,3,120,富邦-宜蘭,2024-06-05,9686
00929,復華台灣科技優息,225,137,88,富邦-宜蘭,2024-06-05,9686
2344,華邦電,80,0,80,富邦-宜蘭,2024-06-05,9686
00881,國泰台灣5G+,61,0,61,富邦-宜蘭,2024-06-05,9686
2417,圓剛,67,17,50,富邦-宜蘭,2024-06-05,9686
2331,精英,72,26,46,富邦-宜蘭,2024-06-05,9686
2303,聯電,61,15,46,富邦-宜蘭,2024-06-05,9686
6270,倍微,60,16,44,富邦-宜蘭,2024-06-05,9686
1303,南亞,51,10,41,富邦-宜蘭,2024-06-05,9686
00632R,元大台灣50反1,40,0,40,富邦-宜蘭,2024-06-05,9686
2323,中環,135,96,39,富邦-宜蘭,2024-06-05,9686
1718,中纖,39,0,39,富邦-宜蘭,2024-06-05,9686
2353,宏��,47,9,38,富邦-宜蘭,2024-06-05,9686
00946,群益科技高息成長,38,0,38,富邦-宜蘭,2024-06-05,9686
5302,太欣,52,16,36,富邦-宜蘭,2024-06-05,9686
00918,大華優利高填息30,40,6,34,富邦-宜蘭,2024-06-05,9686
6216,居易,59,25,34,富邦-宜蘭,2024-06-05,9686
2393,億光,32,2,30,富邦-宜蘭,2024-06-05,9686
2609,陽明,221,192,29,富邦-宜蘭,2024-06-05,9686
2105,正新,28,0,28,富邦-宜蘭,2024-06-05,9686
00715L,期街口布蘭特正2,28,0,28,富邦-宜蘭,2024-06-05,9686
6770,力積電,50,22,28,富邦-宜蘭,2024-06-05,9686
6161,捷波,37,10,27,富邦-宜蘭,2024-06-05,9686
2258,鴻華先進-創,25,0,25,富邦-宜蘭,2024-06-05,9686
4303,信立,26,1,25,富邦-宜蘭,2024-06-05,9686
3062,建漢,32,7,25,富邦-宜蘭,2024-06-05,9686
00937B,群益ESG投等債20,52,28,24,富邦-宜蘭,2024-06-05,9686
1605,華新,25,1,24,富邦-宜蘭,2024-06-05,9686
9924,福興,23,0,23,富邦-宜蘭,2024-06-05,9686
1313,聯成,23,0,23,富邦-宜蘭,2024-06-05,9686
6234,高僑,23,0,23,富邦-宜蘭,2024-06-05,9686
1815,富喬,124,101,23,富邦-宜蘭,2024-06-05,9686
6245,立端,22,0,22,富邦-宜蘭,2024-06-05,9686
6188,廣明,37,16,21,富邦-宜蘭,2024-06-05,9686
5880,合庫金,21,0,21,富邦-宜蘭,2024-06-05,9686
4545,銘鈺,21,0,21,富邦-宜蘭,2024-06-05,9686
6176,瑞儀,23,2,21,富邦-宜蘭,2024-06-05,9686
2356,英業達,24,4,20,富邦-宜蘭,2024-06-05,9686
1301,台塑,20,0,20,富邦-宜蘭,2024-06-05,9686
1453,大將,22,2,20,富邦-宜蘭,2024-06-05,9686
2352,佳世達,19,0,19,富邦-宜蘭,2024-06-05,9686
3372,典範,33,14,19,富邦-宜蘭,2024-06-05,9686
2495,普安,25,6,19,富邦-宜蘭,2024-06-05,9686
2524,京城,21,3,18,富邦-宜蘭,2024-06-05,9686
3202,樺晟,21,3,18,富邦-宜蘭,2024-06-05,9686
4967,十銓,26,8,18,富邦-宜蘭,2024-06-05,9686
00632R,元大台灣50反1,447,10,437,富邦-宜蘭,2024-06-06,9686
2867,三商壽,345,3,342,富邦-宜蘭,2024-06-06,9686
2888,新光金,300,28,272,富邦-宜蘭,2024-06-06,9686
1314,中石化,218,1,217,富邦-宜蘭,2024-06-06,9686
00929,復華台灣科技優息,148,30,118,富邦-宜蘭,2024-06-06,9686
3373,熱映,120,4,116,富邦-宜蘭,2024-06-06,9686
5302,太欣,130,33,97,富邦-宜蘭,2024-06-06,9686
00936,台新永續高息中小,83,0,83,富邦-宜蘭,2024-06-06,9686
2915,潤泰全,100,27,73,富邦-宜蘭,2024-06-06,9686
8906,花王,71,11,60,富邦-宜蘭,2024-06-06,9686
1718,中纖,57,0,57,富邦-宜蘭,2024-06-06,9686
00680L,元大美債20正2,46,1,45,富邦-宜蘭,2024-06-06,9686
2409,友達,43,4,39,富邦-宜蘭,2024-06-06,9686
2312,金寶,322,285,37,富邦-宜蘭,2024-06-06,9686
00753L,中信中國50正2,44,9,35,富邦-宜蘭,2024-06-06,9686
6215,和椿,37,2,35,富邦-宜蘭,2024-06-06,9686
8121,越峰,34,0,34,富邦-宜蘭,2024-06-06,9686
3356,奇偶,50,18,32,富邦-宜蘭,2024-06-06,9686
2489,瑞軒,52,22,30,富邦-宜蘭,2024-06-06,9686
00673R,期元大S＆P原油反1,30,0,30,富邦-宜蘭,2024-06-06,9686
5880,合庫金,30,0,30,富邦-宜蘭,2024-06-06,9686
6226,光鼎,29,0,29,富邦-宜蘭,2024-06-06,9686
2313,華通,29,0,29,富邦-宜蘭,2024-06-06,9686
6546,正基,55,27,28,富邦-宜蘭,2024-06-06,9686
1815,富喬,49,21,28,富邦-宜蘭,2024-06-06,9686
00892,富邦台灣半導體,30,2,28,富邦-宜蘭,2024-06-06,9686
5009,榮剛,31,4,27,富邦-宜蘭,2024-06-06,9686
2353,宏��,38,11,27,富邦-宜蘭,2024-06-06,9686
00933B,國泰10Y+金融債,30,4,26,富邦-宜蘭,2024-06-06,9686
2303,聯電,50,25,25,富邦-宜蘭,2024-06-06,9686
00665L,富邦�琤肭磪囓�2,85,60,25,富邦-宜蘭,2024-06-06,9686
5426,振發,27,2,25,富邦-宜蘭,2024-06-06,9686
910861,神州-DR,24,0,24,富邦-宜蘭,2024-06-06,9686
00688L,國泰20年美債正2,24,0,24,富邦-宜蘭,2024-06-06,9686
00687B,國泰20年美債,29,7,22,富邦-宜蘭,2024-06-06,9686
3481,群創,32,11,21,富邦-宜蘭,2024-06-06,9686
1101,台泥,29,9,20,富邦-宜蘭,2024-06-06,9686
2104,國際中橡,20,0,20,富邦-宜蘭,2024-06-06,9686
00895,富邦未來車,21,1,20,富邦-宜蘭,2024-06-06,9686
2801,彰銀,21,2,19,富邦-宜蘭,2024-06-06,9686
8089,康全電訊,27,8,19,富邦-宜蘭,2024-06-06,9686
5434,崇越,18,0,18,富邦-宜蘭,2024-06-06,9686
2367,燿華,137,119,18,富邦-宜蘭,2024-06-06,9686
8438,昶昕,17,0,17,富邦-宜蘭,2024-06-06,9686
4934,太極,16,0,16,富邦-宜蘭,2024-06-06,9686
4545,銘鈺,15,0,15,富邦-宜蘭,2024-06-06,9686
1905,華紙,15,0,15,富邦-宜蘭,2024-06-06,9686
2006,東和鋼鐵,15,0,15,富邦-宜蘭,2024-06-06,9686
2352,佳世達,15,0,15,富邦-宜蘭,2024-06-06,9686
00878,國泰永續高股息,23,8,15,富邦-宜蘭,2024-06-06,9686
2888,新光金,625,88,537,富邦-宜蘭,2024-06-07,9686
6215,和椿,282,7,275,富邦-宜蘭,2024-06-07,9686
2867,三商壽,238,44,194,富邦-宜蘭,2024-06-07,9686
00929,復華台灣科技優息,137,4,133,富邦-宜蘭,2024-06-07,9686
00878,國泰永續高股息,108,4,104,富邦-宜蘭,2024-06-07,9686
00936,台新永續高息中小,105,5,100,富邦-宜蘭,2024-06-07,9686
00637L,元大滬深300正2,91,10,81,富邦-宜蘭,2024-06-07,9686
00918,大華優利高填息30,80,0,80,富邦-宜蘭,2024-06-07,9686
2885,元大金,67,0,67,富邦-宜蘭,2024-06-07,9686
2312,金寶,150,84,66,富邦-宜蘭,2024-06-07,9686
1108,幸福,64,0,64,富邦-宜蘭,2024-06-07,9686
1609,大亞,95,34,61,富邦-宜蘭,2024-06-07,9686
1453,大將,60,8,52,富邦-宜蘭,2024-06-07,9686
2371,大同,72,21,51,富邦-宜蘭,2024-06-07,9686
3231,緯創,58,12,46,富邦-宜蘭,2024-06-07,9686
2641,正德,101,56,45,富邦-宜蘭,2024-06-07,9686
4571,鈞興-KY,140,95,45,富邦-宜蘭,2024-06-07,9686
8089,康全電訊,40,2,38,富邦-宜蘭,2024-06-07,9686
4956,光鋐,63,29,34,富邦-宜蘭,2024-06-07,9686
8076,伍豐,35,1,34,富邦-宜蘭,2024-06-07,9686
0056,元大高股息,35,1,34,富邦-宜蘭,2024-06-07,9686
3622,洋華,32,1,31,富邦-宜蘭,2024-06-07,9686
00764B,群益25年美債,30,0,30,富邦-宜蘭,2024-06-07,9686
2331,精英,30,2,28,富邦-宜蘭,2024-06-07,9686
4160,訊聯基因,26,1,25,富邦-宜蘭,2024-06-07,9686
910861,神州-DR,25,0,25,富邦-宜蘭,2024-06-07,9686
1532,勤美,40,16,24,富邦-宜蘭,2024-06-07,9686
4113,聯上,43,21,22,富邦-宜蘭,2024-06-07,9686
2344,華邦電,27,5,22,富邦-宜蘭,2024-06-07,9686
6206,飛捷,22,0,22,富邦-宜蘭,2024-06-07,9686
9105,泰金寶-DR,44,22,22,富邦-宜蘭,2024-06-07,9686
1528,恩德,21,0,21,富邦-宜蘭,2024-06-07,9686
00712,復華富時不動產,32,11,21,富邦-宜蘭,2024-06-07,9686
2609,陽明,197,177,20,富邦-宜蘭,2024-06-07,9686
2330,台積電,26,5,21,富邦-宜蘭,2024-06-07,9686
1447,力鵬,21,1,20,富邦-宜蘭,2024-06-07,9686
2836,高雄銀,30,10,20,富邦-宜蘭,2024-06-07,9686
2317,鴻海,49,30,19,富邦-宜蘭,2024-06-07,9686
6257,矽格,21,3,18,富邦-宜蘭,2024-06-07,9686
00942B,台新美A公司債20+,25,7,18,富邦-宜蘭,2024-06-07,9686
2497,怡利電,19,1,18,富邦-宜蘭,2024-06-07,9686
3029,零壹,84,66,18,富邦-宜蘭,2024-06-07,9686
2382,廣達,17,0,17,富邦-宜蘭,2024-06-07,9686
6155,鈞寶,21,4,17,富邦-宜蘭,2024-06-07,9686
2356,英業達,24,7,17,富邦-宜蘭,2024-06-07,9686
3047,訊舟,55,38,17,富邦-宜蘭,2024-06-07,9686
1796,金穎生技,16,0,16,富邦-宜蘭,2024-06-07,9686
3338,泰碩,16,0,16,富邦-宜蘭,2024-06-07,9686
1464,得力,15,0,15,富邦-宜蘭,2024-06-07,9686
8033,雷虎,17,2,15,富邦-宜蘭,2024-06-07,9686
2888,新光金,1039,342,697,富邦-宜蘭,2024-06-11,9686
00919,群益台灣精選高息,269,32,237,富邦-宜蘭,2024-06-11,9686
00942B,台新美A公司債20+,234,18,216,富邦-宜蘭,2024-06-11,9686
2609,陽明,431,227,204,富邦-宜蘭,2024-06-11,9686
1325,恆大,180,27,153,富邦-宜蘭,2024-06-11,9686
00937B,群益ESG投等債20,189,45,144,富邦-宜蘭,2024-06-11,9686
6215,和椿,146,2,144,富邦-宜蘭,2024-06-11,9686
00680L,元大美債20正2,116,0,116,富邦-宜蘭,2024-06-11,9686
00936,台新永續高息中小,126,14,112,富邦-宜蘭,2024-06-11,9686
00929,復華台灣科技優息,171,60,111,富邦-宜蘭,2024-06-11,9686
00918,大華優利高填息30,98,2,96,富邦-宜蘭,2024-06-11,9686
1815,富喬,104,8,96,富邦-宜蘭,2024-06-11,9686
6206,飛捷,102,20,82,富邦-宜蘭,2024-06-11,9686
2603,長榮,124,42,82,富邦-宜蘭,2024-06-11,9686
00665L,富邦�琤肭磪囓�2,158,80,78,富邦-宜蘭,2024-06-11,9686
00687B,國泰20年美債,82,11,71,富邦-宜蘭,2024-06-11,9686
2537,聯上發,124,54,70,富邦-宜蘭,2024-06-11,9686
2867,三商壽,509,441,68,富邦-宜蘭,2024-06-11,9686
2515,中工,65,1,64,富邦-宜蘭,2024-06-11,9686
00679B,元大美債20年,111,50,61,富邦-宜蘭,2024-06-11,9686
1316,上曜,65,8,57,富邦-宜蘭,2024-06-11,9686
9919,康那香,72,16,56,富邦-宜蘭,2024-06-11,9686
2328,廣宇,58,8,50,富邦-宜蘭,2024-06-11,9686
00933B,國泰10Y+金融債,49,2,47,富邦-宜蘭,2024-06-11,9686
4714,永捷,46,2,44,富邦-宜蘭,2024-06-11,9686
9938,百和,43,0,43,富邦-宜蘭,2024-06-11,9686
1108,幸福,41,2,39,富邦-宜蘭,2024-06-11,9686
4967,十銓,45,8,37,富邦-宜蘭,2024-06-11,9686
5608,四維航,46,10,36,富邦-宜蘭,2024-06-11,9686
00878,國泰永續高股息,39,4,35,富邦-宜蘭,2024-06-11,9686
00939,統一台灣高息動能,39,4,35,富邦-宜蘭,2024-06-11,9686
3481,群創,39,5,34,富邦-宜蘭,2024-06-11,9686
9105,泰金寶-DR,45,12,33,富邦-宜蘭,2024-06-11,9686
8926,台汽電,33,1,32,富邦-宜蘭,2024-06-11,9686
6770,力積電,85,53,32,富邦-宜蘭,2024-06-11,9686
2374,佳能,32,1,31,富邦-宜蘭,2024-06-11,9686
2356,英業達,32,2,30,富邦-宜蘭,2024-06-11,9686
2002,中鋼,38,8,30,富邦-宜蘭,2024-06-11,9686
5426,振發,31,1,30,富邦-宜蘭,2024-06-11,9686
2889,國票金,32,2,30,富邦-宜蘭,2024-06-11,9686
00795B,中信美國公債20年,29,0,29,富邦-宜蘭,2024-06-11,9686
3229,晟鈦,30,1,29,富邦-宜蘭,2024-06-11,9686
2353,宏��,50,23,27,富邦-宜蘭,2024-06-11,9686
00915,凱基優選高股息30,28,0,28,富邦-宜蘭,2024-06-11,9686
1618,合機,39,14,25,富邦-宜蘭,2024-06-11,9686
2801,彰銀,25,0,25,富邦-宜蘭,2024-06-11,9686
2615,萬海,101,76,25,富邦-宜蘭,2024-06-11,9686
6257,矽格,25,0,25,富邦-宜蘭,2024-06-11,9686
00688L,國泰20年美債正2,24,0,24,富邦-宜蘭,2024-06-11,9686
00751B,元大AAA至A公司債,24,1,23,富邦-宜蘭,2024-06-11,9686
2888,新光金,688,72,616,富邦-宜蘭,2024-06-12,9686
00937B,群益ESG投等債20,275,29,246,富邦-宜蘭,2024-06-12,9686
00948B,中信優息投資級債,191,0,191,富邦-宜蘭,2024-06-12,9686
00665L,富邦�琤肭磪囓�2,100,0,100,富邦-宜蘭,2024-06-12,9686
00687B,國泰20年美債,115,22,93,富邦-宜蘭,2024-06-12,9686
3231,緯創,103,10,93,富邦-宜蘭,2024-06-12,9686
4545,銘鈺,114,22,92,富邦-宜蘭,2024-06-12,9686
00679B,元大美債20年,74,0,74,富邦-宜蘭,2024-06-12,9686
6216,居易,113,43,70,富邦-宜蘭,2024-06-12,9686
00934,中信成長高股息,69,0,69,富邦-宜蘭,2024-06-12,9686
2353,宏��,63,2,61,富邦-宜蘭,2024-06-12,9686
2609,陽明,244,188,56,富邦-宜蘭,2024-06-12,9686
00676R,富邦臺灣加權反1,50,0,50,富邦-宜蘭,2024-06-12,9686
00712,復華富時不動產,48,0,48,富邦-宜蘭,2024-06-12,9686
00936,台新永續高息中小,45,2,43,富邦-宜蘭,2024-06-12,9686
6257,矽格,41,1,40,富邦-宜蘭,2024-06-12,9686
6509,聚和,40,0,40,富邦-宜蘭,2024-06-12,9686
00918,大華優利高填息30,42,2,40,富邦-宜蘭,2024-06-12,9686
2337,旺宏,38,2,36,富邦-宜蘭,2024-06-12,9686
00947,台新臺灣IC設計,51,15,36,富邦-宜蘭,2024-06-12,9686
2354,鴻準,42,7,35,富邦-宜蘭,2024-06-12,9686
8033,雷虎,41,9,32,富邦-宜蘭,2024-06-12,9686
3481,群創,33,1,32,富邦-宜蘭,2024-06-12,9686
1514,亞力,57,26,31,富邦-宜蘭,2024-06-12,9686
2101,南港,34,4,30,富邦-宜蘭,2024-06-12,9686
2486,一詮,41,11,30,富邦-宜蘭,2024-06-12,9686
4543,萬在,32,4,28,富邦-宜蘭,2024-06-12,9686
00753L,中信中國50正2,41,14,27,富邦-宜蘭,2024-06-12,9686
6834,天二科技,27,1,26,富邦-宜蘭,2024-06-12,9686
4207,環泰,25,0,25,富邦-宜蘭,2024-06-12,9686
4562,穎漢,52,27,25,富邦-宜蘭,2024-06-12,9686
2515,中工,27,3,24,富邦-宜蘭,2024-06-12,9686
2610,華航,24,1,23,富邦-宜蘭,2024-06-12,9686
2362,藍天,21,0,21,富邦-宜蘭,2024-06-12,9686
2882,國泰金,21,1,20,富邦-宜蘭,2024-06-12,9686
00935,野村臺灣新科技50,20,0,20,富邦-宜蘭,2024-06-12,9686
8429,金麗-KY,20,0,20,富邦-宜蘭,2024-06-12,9686
4432,銘旺實,20,0,20,富邦-宜蘭,2024-06-12,9686
3652,精聯,20,0,20,富邦-宜蘭,2024-06-12,9686
1312,國喬,20,0,20,富邦-宜蘭,2024-06-12,9686
6706,惠特,34,14,20,富邦-宜蘭,2024-06-12,9686
2890,永豐金,19,0,19,富邦-宜蘭,2024-06-12,9686
5608,四維航,21,2,19,富邦-宜蘭,2024-06-12,9686
2344,華邦電,18,0,18,富邦-宜蘭,2024-06-12,9686
1452,宏益,82,64,18,富邦-宜蘭,2024-06-12,9686
6743,安普新,17,0,17,富邦-宜蘭,2024-06-12,9686
1301,台塑,17,0,17,富邦-宜蘭,2024-06-12,9686
2371,大同,22,6,16,富邦-宜蘭,2024-06-12,9686
6770,力積電,29,13,16,富邦-宜蘭,2024-06-12,9686
2634,漢翔,15,0,15,富邦-宜蘭,2024-06-12,9686
1447,力鵬,205,1,204,富邦-宜蘭,2024-06-13,9686
6216,居易,211,26,185,富邦-宜蘭,2024-06-13,9686
3060,銘異,120,0,120,富邦-宜蘭,2024-06-13,9686
00948B,中信優息投資級債,110,0,110,富邦-宜蘭,2024-06-13,9686
2402,毅嘉,108,0,108,富邦-宜蘭,2024-06-13,9686
1815,富喬,107,17,90,富邦-宜蘭,2024-06-13,9686
2888,新光金,167,78,89,富邦-宜蘭,2024-06-13,9686
2359,所羅門,150,88,62,富邦-宜蘭,2024-06-13,9686
00946,群益科技高息成長,59,1,58,富邦-宜蘭,2024-06-13,9686
2903,遠百,62,5,57,富邦-宜蘭,2024-06-13,9686
2464,盟立,79,24,55,富邦-宜蘭,2024-06-13,9686
8929,富堡,54,0,54,富邦-宜蘭,2024-06-13,9686
1616,億泰,51,1,50,富邦-宜蘭,2024-06-13,9686
5392,能率,52,3,49,富邦-宜蘭,2024-06-13,9686
00936,台新永續高息中小,41,0,41,富邦-宜蘭,2024-06-13,9686
6257,矽格,41,4,37,富邦-宜蘭,2024-06-13,9686
2365,昆盈,52,15,37,富邦-宜蘭,2024-06-13,9686
2618,長榮航,43,9,34,富邦-宜蘭,2024-06-13,9686
9105,泰金寶-DR,44,11,33,富邦-宜蘭,2024-06-13,9686
2002,中鋼,40,11,29,富邦-宜蘭,2024-06-13,9686
1314,中石化,28,0,28,富邦-宜蘭,2024-06-13,9686
8906,花王,26,0,26,富邦-宜蘭,2024-06-13,9686
3516,亞帝歐,25,0,25,富邦-宜蘭,2024-06-13,9686
6125,廣運,29,6,23,富邦-宜蘭,2024-06-13,9686
4545,銘鈺,25,2,23,富邦-宜蘭,2024-06-13,9686
2367,燿華,34,11,23,富邦-宜蘭,2024-06-13,9686
8064,東捷,33,10,23,富邦-宜蘭,2024-06-13,9686
1707,葡萄王,25,2,23,富邦-宜蘭,2024-06-13,9686
00753L,中信中國50正2,37,14,23,富邦-宜蘭,2024-06-13,9686
2539,櫻花建,22,0,22,富邦-宜蘭,2024-06-13,9686
6834,天二科技,22,1,21,富邦-宜蘭,2024-06-13,9686
2514,龍邦,20,0,20,富邦-宜蘭,2024-06-13,9686
1452,宏益,75,55,20,富邦-宜蘭,2024-06-13,9686
4588,玖鼎電力,20,0,20,富邦-宜蘭,2024-06-13,9686
4167,松瑞藥,29,9,20,富邦-宜蘭,2024-06-13,9686
1303,南亞,19,0,19,富邦-宜蘭,2024-06-13,9686
4960,誠美材,20,1,19,富邦-宜蘭,2024-06-13,9686
00934,中信成長高股息,19,0,19,富邦-宜蘭,2024-06-13,9686
00673R,期元大S＆P原油反1,22,4,18,富邦-宜蘭,2024-06-13,9686
3048,益登,93,75,18,富邦-宜蘭,2024-06-13,9686
00830,國泰費城半導體,18,0,18,富邦-宜蘭,2024-06-13,9686
2883,凱基金,25,7,18,富邦-宜蘭,2024-06-13,9686
3481,群創,28,11,17,富邦-宜蘭,2024-06-13,9686
4967,十銓,45,28,17,富邦-宜蘭,2024-06-13,9686
6706,惠特,21,5,16,富邦-宜蘭,2024-06-13,9686
2609,陽明,177,161,16,富邦-宜蘭,2024-06-13,9686
2812,台中銀,15,0,15,富邦-宜蘭,2024-06-13,9686
8121,越峰,20,5,15,富邦-宜蘭,2024-06-13,9686
2104,國際中橡,15,0,15,富邦-宜蘭,2024-06-13,9686
00942B,台新美A公司債20+,16,1,15,富邦-宜蘭,2024-06-13,9686
2886,兆豐金,171,0,171,富邦-宜蘭,2024-06-14,9686
2371,大同,217,84,133,富邦-宜蘭,2024-06-14,9686
2883,凱基金,131,10,121,富邦-宜蘭,2024-06-14,9686
00919,群益台灣精選高息,162,50,112,富邦-宜蘭,2024-06-14,9686
2801,彰銀,112,0,112,富邦-宜蘭,2024-06-14,9686
1325,恆大,92,2,90,富邦-宜蘭,2024-06-14,9686
2025,千興,87,13,74,富邦-宜蘭,2024-06-14,9686
00937B,群益ESG投等債20,79,16,63,富邦-宜蘭,2024-06-14,9686
3231,緯創,65,14,51,富邦-宜蘭,2024-06-14,9686
2002,中鋼,57,6,51,富邦-宜蘭,2024-06-14,9686
1504,東元,62,24,38,富邦-宜蘭,2024-06-14,9686
5230,雷笛克光學,36,0,36,富邦-宜蘭,2024-06-14,9686
1301,台塑,35,0,35,富邦-宜蘭,2024-06-14,9686
3029,零壹,38,6,32,富邦-宜蘭,2024-06-14,9686
1815,富喬,37,6,31,富邦-宜蘭,2024-06-14,9686
3576,聯合再生,33,2,31,富邦-宜蘭,2024-06-14,9686
3219,倚強科,30,0,30,富邦-宜蘭,2024-06-14,9686
9946,三發地產,29,0,29,富邦-宜蘭,2024-06-14,9686
2537,聯上發,27,0,27,富邦-宜蘭,2024-06-14,9686
2363,矽統,30,4,26,富邦-宜蘭,2024-06-14,9686
8906,花王,42,18,24,富邦-宜蘭,2024-06-14,9686
910861,神州-DR,23,0,23,富邦-宜蘭,2024-06-14,9686
5469,瀚宇博,23,0,23,富邦-宜蘭,2024-06-14,9686
00905,FT臺灣Smart,23,1,22,富邦-宜蘭,2024-06-14,9686
00918,大華優利高填息30,27,6,21,富邦-宜蘭,2024-06-14,9686
4960,誠美材,30,10,20,富邦-宜蘭,2024-06-14,9686
3372,典範,32,12,20,富邦-宜蘭,2024-06-14,9686
3518,柏騰,20,0,20,富邦-宜蘭,2024-06-14,9686
6005,群益證,20,1,19,富邦-宜蘭,2024-06-14,9686
00881,國泰台灣5G+,40,21,19,富邦-宜蘭,2024-06-14,9686
5347,世界,29,11,18,富邦-宜蘭,2024-06-14,9686
2367,燿華,27,9,18,富邦-宜蘭,2024-06-14,9686
2022,聚亨,20,2,18,富邦-宜蘭,2024-06-14,9686
00947,台新臺灣IC設計,20,2,18,富邦-宜蘭,2024-06-14,9686
3105,穩懋,20,2,18,富邦-宜蘭,2024-06-14,9686
3548,兆利,18,1,17,富邦-宜蘭,2024-06-14,9686
2484,希華,17,0,17,富邦-宜蘭,2024-06-14,9686
4533,協易機,24,7,17,富邦-宜蘭,2024-06-14,9686
00637L,元大滬深300正2,23,6,17,富邦-宜蘭,2024-06-14,9686
00680L,元大美債20正2,24,8,16,富邦-宜蘭,2024-06-14,9686
5608,四維航,18,2,16,富邦-宜蘭,2024-06-14,9686
3437,榮創,15,0,15,富邦-宜蘭,2024-06-14,9686
1802,台玻,15,0,15,富邦-宜蘭,2024-06-14,9686
3555,博士旺,15,0,15,富邦-宜蘭,2024-06-14,9686
2365,昆盈,41,27,14,富邦-宜蘭,2024-06-14,9686
2330,台積電,17,3,14,富邦-宜蘭,2024-06-14,9686
1587,吉茂,21,8,13,富邦-宜蘭,2024-06-14,9686
8277,商丞,15,2,13,富邦-宜蘭,2024-06-14,9686
8028,昇陽半導體,24,11,13,富邦-宜蘭,2024-06-14,9686
2601,益航,12,0,12,富邦-宜蘭,2024-06-14,9686
2867,三商壽,1009,0,1009,富邦-宜蘭,2024-06-17,9686
00929,復華台灣科技優息,203,39,164,富邦-宜蘭,2024-06-17,9686
00918,大華優利高填息30,168,22,146,富邦-宜蘭,2024-06-17,9686
2888,新光金,165,24,141,富邦-宜蘭,2024-06-17,9686
1802,台玻,173,40,133,富邦-宜蘭,2024-06-17,9686
00936,台新永續高息中小,180,75,105,富邦-宜蘭,2024-06-17,9686
00881,國泰台灣5G+,116,17,99,富邦-宜蘭,2024-06-17,9686
2489,瑞軒,102,15,87,富邦-宜蘭,2024-06-17,9686
00937B,群益ESG投等債20,126,44,82,富邦-宜蘭,2024-06-17,9686
3373,熱映,81,20,61,富邦-宜蘭,2024-06-17,9686
4133,亞諾法,60,0,60,富邦-宜蘭,2024-06-17,9686
9103,美德醫療-DR,62,4,58,富邦-宜蘭,2024-06-17,9686
00915,凱基優選高股息30,63,5,58,富邦-宜蘭,2024-06-17,9686
2515,中工,56,1,55,富邦-宜蘭,2024-06-17,9686
6257,矽格,49,0,49,富邦-宜蘭,2024-06-17,9686
1618,合機,93,44,49,富邦-宜蘭,2024-06-17,9686
00948B,中信優息投資級債,48,0,48,富邦-宜蘭,2024-06-17,9686
6005,群益證,46,0,46,富邦-宜蘭,2024-06-17,9686
4142,國光生,50,7,43,富邦-宜蘭,2024-06-17,9686
00933B,國泰10Y+金融債,42,0,42,富邦-宜蘭,2024-06-17,9686
6116,彩晶,41,1,40,富邦-宜蘭,2024-06-17,9686
4106,雃博,41,1,40,富邦-宜蘭,2024-06-17,9686
00713,元大台灣高息低波,38,0,38,富邦-宜蘭,2024-06-17,9686
2609,陽明,75,44,31,富邦-宜蘭,2024-06-17,9686
4154,樂威科-KY,30,0,30,富邦-宜蘭,2024-06-17,9686
4188,安克,30,0,30,富邦-宜蘭,2024-06-17,9686
00946,群益科技高息成長,27,0,27,富邦-宜蘭,2024-06-17,9686
00712,復華富時不動產,29,3,26,富邦-宜蘭,2024-06-17,9686
6197,佳必琪,77,53,24,富邦-宜蘭,2024-06-17,9686
5871,中租-KY,28,4,24,富邦-宜蘭,2024-06-17,9686
3466,德晉,23,0,23,富邦-宜蘭,2024-06-17,9686
1524,耿鼎,23,1,22,富邦-宜蘭,2024-06-17,9686
3205,佰研,20,0,20,富邦-宜蘭,2024-06-17,9686
2915,潤泰全,21,1,20,富邦-宜蘭,2024-06-17,9686
8429,金麗-KY,20,0,20,富邦-宜蘭,2024-06-17,9686
2514,龍邦,20,0,20,富邦-宜蘭,2024-06-17,9686
1612,宏泰,19,0,19,富邦-宜蘭,2024-06-17,9686
1616,億泰,21,2,19,富邦-宜蘭,2024-06-17,9686
1503,士電,38,19,19,富邦-宜蘭,2024-06-17,9686
00687B,國泰20年美債,77,59,18,富邦-宜蘭,2024-06-17,9686
00942B,台新美A公司債20+,27,10,17,富邦-宜蘭,2024-06-17,9686
2314,台揚,24,7,17,富邦-宜蘭,2024-06-17,9686
5347,世界,24,7,17,富邦-宜蘭,2024-06-17,9686
2615,萬海,32,16,16,富邦-宜蘭,2024-06-17,9686
4903,聯光通,18,2,16,富邦-宜蘭,2024-06-17,9686
910861,神州-DR,15,0,15,富邦-宜蘭,2024-06-17,9686
5533,皇鼎,15,0,15,富邦-宜蘭,2024-06-17,9686
4128,中天,15,0,15,富邦-宜蘭,2024-06-17,9686
3188,鑫龍騰,15,0,15,富邦-宜蘭,2024-06-17,9686
5434,崇越,15,1,14,富邦-宜蘭,2024-06-17,9686
00664R,國泰臺灣加權反1,300,0,300,富邦-宜蘭,2024-06-18,9686
00936,台新永續高息中小,203,3,200,富邦-宜蘭,2024-06-18,9686
5392,能率,154,7,147,富邦-宜蘭,2024-06-18,9686
00929,復華台灣科技優息,131,26,105,富邦-宜蘭,2024-06-18,9686
1504,東元,83,0,83,富邦-宜蘭,2024-06-18,9686
912000,晨訊科-DR,71,4,67,富邦-宜蘭,2024-06-18,9686
00946,群益科技高息成長,65,1,64,富邦-宜蘭,2024-06-18,9686
00712,復華富時不動產,70,9,61,富邦-宜蘭,2024-06-18,9686
3060,銘異,61,0,61,富邦-宜蘭,2024-06-18,9686
6257,矽格,60,1,59,富邦-宜蘭,2024-06-18,9686
00937B,群益ESG投等債20,160,102,58,富邦-宜蘭,2024-06-18,9686
8277,商丞,59,3,56,富邦-宜蘭,2024-06-18,9686
00673R,期元大S＆P原油反1,54,0,54,富邦-宜蘭,2024-06-18,9686
3466,德晉,56,3,53,富邦-宜蘭,2024-06-18,9686
3047,訊舟,56,4,52,富邦-宜蘭,2024-06-18,9686
00665L,富邦�琤肭磪囓�2,50,0,50,富邦-宜蘭,2024-06-18,9686
5880,合庫金,53,4,49,富邦-宜蘭,2024-06-18,9686
2317,鴻海,51,10,41,富邦-宜蘭,2024-06-18,9686
9103,美德醫療-DR,59,18,41,富邦-宜蘭,2024-06-18,9686
00918,大華優利高填息30,56,16,40,富邦-宜蘭,2024-06-18,9686
2025,千興,48,8,40,富邦-宜蘭,2024-06-18,9686
4956,光鋐,45,7,38,富邦-宜蘭,2024-06-18,9686
2486,一詮,79,41,38,富邦-宜蘭,2024-06-18,9686
2353,宏��,44,8,36,富邦-宜蘭,2024-06-18,9686
3481,群創,66,30,36,富邦-宜蘭,2024-06-18,9686
6637,醫影,33,0,33,富邦-宜蘭,2024-06-18,9686
2885,元大金,38,5,33,富邦-宜蘭,2024-06-18,9686
5371,中光電,32,2,30,富邦-宜蘭,2024-06-18,9686
00919,群益台灣精選高息,174,146,28,富邦-宜蘭,2024-06-18,9686
2208,台船,27,0,27,富邦-宜蘭,2024-06-18,9686
2312,金寶,98,72,26,富邦-宜蘭,2024-06-18,9686
4967,十銓,46,21,25,富邦-宜蘭,2024-06-18,9686
1301,台塑,25,1,24,富邦-宜蘭,2024-06-18,9686
2515,中工,23,0,23,富邦-宜蘭,2024-06-18,9686
2206,三陽工業,30,7,23,富邦-宜蘭,2024-06-18,9686
6856,鑫傳,22,0,22,富邦-宜蘭,2024-06-18,9686
8071,能率網通,22,0,22,富邦-宜蘭,2024-06-18,9686
5426,振發,22,1,21,富邦-宜蘭,2024-06-18,9686
6770,力積電,35,14,21,富邦-宜蘭,2024-06-18,9686
6130,上亞科技,20,0,20,富邦-宜蘭,2024-06-18,9686
00680L,元大美債20正2,30,11,19,富邦-宜蘭,2024-06-18,9686
00915,凱基優選高股息30,24,6,18,富邦-宜蘭,2024-06-18,9686
3376,新日興,26,8,18,富邦-宜蘭,2024-06-18,9686
2313,華通,26,10,16,富邦-宜蘭,2024-06-18,9686
3029,零壹,32,16,16,富邦-宜蘭,2024-06-18,9686
1760,寶齡富錦,15,0,15,富邦-宜蘭,2024-06-18,9686
1452,宏益,77,62,15,富邦-宜蘭,2024-06-18,9686
00882,中信中國高股息,15,0,15,富邦-宜蘭,2024-06-18,9686
2355,敬鵬,24,9,15,富邦-宜蘭,2024-06-18,9686
2882,國泰金,31,16,15,富邦-宜蘭,2024-06-18,9686
00664R,國泰臺灣加權反1,910,30,880,富邦-宜蘭,2024-06-19,9686
2867,三商壽,866,1,865,富邦-宜蘭,2024-06-19,9686
00632R,元大台灣50反1,249,83,166,富邦-宜蘭,2024-06-19,9686
00918,大華優利高填息30,170,31,139,富邦-宜蘭,2024-06-19,9686
00673R,期元大S＆P原油反1,103,0,103,富邦-宜蘭,2024-06-19,9686
2337,旺宏,83,9,74,富邦-宜蘭,2024-06-19,9686
2371,大同,108,38,70,富邦-宜蘭,2024-06-19,9686
6257,矽格,71,4,67,富邦-宜蘭,2024-06-19,9686
00946,群益科技高息成長,100,39,61,富邦-宜蘭,2024-06-19,9686
00944,野村趨勢動能高息,57,1,56,富邦-宜蘭,2024-06-19,9686
8277,商丞,53,7,46,富邦-宜蘭,2024-06-19,9686
1522,堤維西,77,31,46,富邦-宜蘭,2024-06-19,9686
3537,堡達,45,0,45,富邦-宜蘭,2024-06-19,9686
4545,銘鈺,75,31,44,富邦-宜蘭,2024-06-19,9686
00937B,群益ESG投等債20,48,6,42,富邦-宜蘭,2024-06-19,9686
00915,凱基優選高股息30,43,2,41,富邦-宜蘭,2024-06-19,9686
4533,協易機,51,13,38,富邦-宜蘭,2024-06-19,9686
1301,台塑,37,0,37,富邦-宜蘭,2024-06-19,9686
8926,台汽電,35,0,35,富邦-宜蘭,2024-06-19,9686
8096,擎亞,74,39,35,富邦-宜蘭,2024-06-19,9686
2883,凱基金,61,30,31,富邦-宜蘭,2024-06-19,9686
2506,太設,30,0,30,富邦-宜蘭,2024-06-19,9686
4153,鈺緯,30,0,30,富邦-宜蘭,2024-06-19,9686
2888,新光金,75,45,30,富邦-宜蘭,2024-06-19,9686
00712,復華富時不動產,41,13,28,富邦-宜蘭,2024-06-19,9686
8011,台通,33,6,27,富邦-宜蘭,2024-06-19,9686
2353,宏��,36,9,27,富邦-宜蘭,2024-06-19,9686
2885,元大金,41,15,26,富邦-宜蘭,2024-06-19,9686
1809,中釉,27,1,26,富邦-宜蘭,2024-06-19,9686
6233,旺玖,25,0,25,富邦-宜蘭,2024-06-19,9686
2515,中工,31,6,25,富邦-宜蘭,2024-06-19,9686
6190,萬泰科,39,15,24,富邦-宜蘭,2024-06-19,9686
2323,中環,25,1,24,富邦-宜蘭,2024-06-19,9686
5457,宣德,23,0,23,富邦-宜蘭,2024-06-19,9686
5443,均豪,51,28,23,富邦-宜蘭,2024-06-19,9686
3036,文曄,24,2,22,富邦-宜蘭,2024-06-19,9686
6716,應廣,22,0,22,富邦-宜蘭,2024-06-19,9686
2611,志信,22,1,21,富邦-宜蘭,2024-06-19,9686
3490,單井,21,0,21,富邦-宜蘭,2024-06-19,9686
00687B,國泰20年美債,31,10,21,富邦-宜蘭,2024-06-19,9686
2101,南港,21,0,21,富邦-宜蘭,2024-06-19,9686
2409,友達,24,3,21,富邦-宜蘭,2024-06-19,9686
4956,光鋐,114,94,20,富邦-宜蘭,2024-06-19,9686
00948B,中信優息投資級債,20,0,20,富邦-宜蘭,2024-06-19,9686
4303,信立,20,0,20,富邦-宜蘭,2024-06-19,9686
00665L,富邦�琤肭磪囓�2,35,15,20,富邦-宜蘭,2024-06-19,9686
3308,聯德,21,1,20,富邦-宜蘭,2024-06-19,9686
00713,元大台灣高息低波,20,0,20,富邦-宜蘭,2024-06-19,9686
3372,典範,34,15,19,富邦-宜蘭,2024-06-19,9686
6770,力積電,64,46,18,富邦-宜蘭,2024-06-19,9686
00664R,國泰臺灣加權反1,355,0,355,富邦-宜蘭,2024-06-20,9686
8105,凌巨,221,33,188,富邦-宜蘭,2024-06-20,9686
00919,群益台灣精選高息,220,33,187,富邦-宜蘭,2024-06-20,9686
2801,彰銀,129,2,127,富邦-宜蘭,2024-06-20,9686
00948B,中信優息投資級債,108,0,108,富邦-宜蘭,2024-06-20,9686
6206,飛捷,100,0,100,富邦-宜蘭,2024-06-20,9686
2885,元大金,100,14,86,富邦-宜蘭,2024-06-20,9686
2344,華邦電,116,36,80,富邦-宜蘭,2024-06-20,9686
00936,台新永續高息中小,67,0,67,富邦-宜蘭,2024-06-20,9686
4133,亞諾法,60,0,60,富邦-宜蘭,2024-06-20,9686
1605,華新,53,0,53,富邦-宜蘭,2024-06-20,9686
4168,醣聯,50,0,50,富邦-宜蘭,2024-06-20,9686
4111,濟生,50,0,50,富邦-宜蘭,2024-06-20,9686
6257,矽格,44,1,43,富邦-宜蘭,2024-06-20,9686
2353,宏��,93,51,42,富邦-宜蘭,2024-06-20,9686
4153,鈺緯,50,11,39,富邦-宜蘭,2024-06-20,9686
00946,群益科技高息成長,53,15,38,富邦-宜蘭,2024-06-20,9686
2324,仁寶,38,1,37,富邦-宜蘭,2024-06-20,9686
00680L,元大美債20正2,36,0,36,富邦-宜蘭,2024-06-20,9686
1618,合機,51,16,35,富邦-宜蘭,2024-06-20,9686
00947,台新臺灣IC設計,36,2,34,富邦-宜蘭,2024-06-20,9686
6477,安集,32,0,32,富邦-宜蘭,2024-06-20,9686
00673R,期元大S＆P原油反1,32,0,32,富邦-宜蘭,2024-06-20,9686
00915,凱基優選高股息30,33,1,32,富邦-宜蘭,2024-06-20,9686
4155,訊映,30,0,30,富邦-宜蘭,2024-06-20,9686
4109,加捷生醫,30,0,30,富邦-宜蘭,2024-06-20,9686
00937B,群益ESG投等債20,29,0,29,富邦-宜蘭,2024-06-20,9686
3537,堡達,37,10,27,富邦-宜蘭,2024-06-20,9686
00753L,中信中國50正2,37,12,25,富邦-宜蘭,2024-06-20,9686
910861,神州-DR,23,0,23,富邦-宜蘭,2024-06-20,9686
1326,台化,21,0,21,富邦-宜蘭,2024-06-20,9686
2534,宏盛,20,0,20,富邦-宜蘭,2024-06-20,9686
8933,愛地雅,20,0,20,富邦-宜蘭,2024-06-20,9686
6023,元大期,19,0,19,富邦-宜蘭,2024-06-20,9686
2630,亞航,20,1,19,富邦-宜蘭,2024-06-20,9686
00687B,國泰20年美債,53,35,18,富邦-宜蘭,2024-06-20,9686
00696B,富邦美債20年,22,4,18,富邦-宜蘭,2024-06-20,9686
2888,新光金,76,58,18,富邦-宜蘭,2024-06-20,9686
4952,凌通,18,0,18,富邦-宜蘭,2024-06-20,9686
3033,威健,16,0,16,富邦-宜蘭,2024-06-20,9686
4164,承業醫,16,0,16,富邦-宜蘭,2024-06-20,9686
8039,台虹,16,0,16,富邦-宜蘭,2024-06-20,9686
2330,台積電,19,3,16,富邦-宜蘭,2024-06-20,9686
00772B,中信高評級公司債,15,0,15,富邦-宜蘭,2024-06-20,9686
00935,野村臺灣新科技50,15,0,15,富邦-宜蘭,2024-06-20,9686
1303,南亞,15,0,15,富邦-宜蘭,2024-06-20,9686
6215,和椿,30,15,15,富邦-宜蘭,2024-06-20,9686
1608,華榮,23,9,14,富邦-宜蘭,2024-06-20,9686
6111,大宇資,14,1,13,富邦-宜蘭,2024-06-20,9686
2615,萬海,46,33,13,富邦-宜蘭,2024-06-20,9686
00933B,國泰10Y+金融債,425,3,422,富邦-宜蘭,2024-06-21,9686
00937B,群益ESG投等債20,162,1,161,富邦-宜蘭,2024-06-21,9686
1611,中電,183,25,158,富邦-宜蘭,2024-06-21,9686
2312,金寶,196,75,121,富邦-宜蘭,2024-06-21,9686
1301,台塑,89,0,89,富邦-宜蘭,2024-06-21,9686
2317,鴻海,105,28,77,富邦-宜蘭,2024-06-21,9686
8105,凌巨,118,42,76,富邦-宜蘭,2024-06-21,9686
00637L,元大滬深300正2,63,1,62,富邦-宜蘭,2024-06-21,9686
00712,復華富時不動產,61,11,50,富邦-宜蘭,2024-06-21,9686
6196,帆宣,50,1,49,富邦-宜蘭,2024-06-21,9686
2412,中華電,47,1,46,富邦-宜蘭,2024-06-21,9686
6239,力成,46,0,46,富邦-宜蘭,2024-06-21,9686
00878,國泰永續高股息,56,10,46,富邦-宜蘭,2024-06-21,9686
00936,台新永續高息中小,46,0,46,富邦-宜蘭,2024-06-21,9686
00946,群益科技高息成長,45,0,45,富邦-宜蘭,2024-06-21,9686
3714,富采,45,0,45,富邦-宜蘭,2024-06-21,9686
00919,群益台灣精選高息,318,274,44,富邦-宜蘭,2024-06-21,9686
2609,陽明,183,140,43,富邦-宜蘭,2024-06-21,9686
4167,松瑞藥,41,0,41,富邦-宜蘭,2024-06-21,9686
00665L,富邦�琤肭磪囓�2,40,0,40,富邦-宜蘭,2024-06-21,9686
00948B,中信優息投資級債,42,5,37,富邦-宜蘭,2024-06-21,9686
3029,零壹,37,1,36,富邦-宜蘭,2024-06-21,9686
00830,國泰費城半導體,35,0,35,富邦-宜蘭,2024-06-21,9686
2438,翔耀,35,0,35,富邦-宜蘭,2024-06-21,9686
912000,晨訊科-DR,30,0,30,富邦-宜蘭,2024-06-21,9686
6176,瑞儀,48,20,28,富邦-宜蘭,2024-06-21,9686
8076,伍豐,33,5,28,富邦-宜蘭,2024-06-21,9686
6753,龍德造船,27,0,27,富邦-宜蘭,2024-06-21,9686
4933,友輝,25,0,25,富邦-宜蘭,2024-06-21,9686
2369,菱生,24,1,23,富邦-宜蘭,2024-06-21,9686
2330,台積電,25,4,21,富邦-宜蘭,2024-06-21,9686
9955,佳龍,25,5,20,富邦-宜蘭,2024-06-21,9686
5434,崇越,20,0,20,富邦-宜蘭,2024-06-21,9686
5469,瀚宇博,19,0,19,富邦-宜蘭,2024-06-21,9686
1809,中釉,20,1,19,富邦-宜蘭,2024-06-21,9686
1612,宏泰,19,0,19,富邦-宜蘭,2024-06-21,9686
6890,來億-KY,19,1,18,富邦-宜蘭,2024-06-21,9686
2836,高雄銀,18,0,18,富邦-宜蘭,2024-06-21,9686
00882,中信中國高股息,19,1,18,富邦-宜蘭,2024-06-21,9686
00940,元大台灣價值高息,66,48,18,富邦-宜蘭,2024-06-21,9686
2353,宏��,42,25,17,富邦-宜蘭,2024-06-21,9686
2498,宏達電,45,28,17,富邦-宜蘭,2024-06-21,9686
2537,聯上發,17,0,17,富邦-宜蘭,2024-06-21,9686
3047,訊舟,75,58,17,富邦-宜蘭,2024-06-21,9686
6116,彩晶,28,12,16,富邦-宜蘭,2024-06-21,9686
2382,廣達,45,29,16,富邦-宜蘭,2024-06-21,9686
8033,雷虎,17,2,15,富邦-宜蘭,2024-06-21,9686
2371,大同,49,34,15,富邦-宜蘭,2024-06-21,9686
6856,鑫傳,15,0,15,富邦-宜蘭,2024-06-21,9686
6173,信昌電,21,6,15,富邦-宜蘭,2024-06-21,9686
3481,群創,827,436,391,富邦-宜蘭,2024-06-24,9686
1310,台苯,319,0,319,富邦-宜蘭,2024-06-24,9686
00664R,國泰臺灣加權反1,280,11,269,富邦-宜蘭,2024-06-24,9686
00632R,元大台灣50反1,381,179,202,富邦-宜蘭,2024-06-24,9686
00940,元大台灣價值高息,224,33,191,富邦-宜蘭,2024-06-24,9686
00937B,群益ESG投等債20,109,8,101,富邦-宜蘭,2024-06-24,9686
1101,台泥,107,11,96,富邦-宜蘭,2024-06-24,9686
2883,凱基金,104,10,94,富邦-宜蘭,2024-06-24,9686
00946,群益科技高息成長,100,7,93,富邦-宜蘭,2024-06-24,9686
00936,台新永續高息中小,101,9,92,富邦-宜蘭,2024-06-24,9686
00919,群益台灣精選高息,271,182,89,富邦-宜蘭,2024-06-24,9686
6770,力積電,90,4,86,富邦-宜蘭,2024-06-24,9686
00948B,中信優息投資級債,83,0,83,富邦-宜蘭,2024-06-24,9686
00922,國泰台灣領袖50,77,0,77,富邦-宜蘭,2024-06-24,9686
8277,商丞,60,2,58,富邦-宜蘭,2024-06-24,9686
2615,萬海,80,24,56,富邦-宜蘭,2024-06-24,9686
6496,科懋,40,0,40,富邦-宜蘭,2024-06-24,9686
1815,富喬,49,12,37,富邦-宜蘭,2024-06-24,9686
5531,鄉林,35,0,35,富邦-宜蘭,2024-06-24,9686
3580,友威科,54,20,34,富邦-宜蘭,2024-06-24,9686
00753L,中信中國50正2,33,0,33,富邦-宜蘭,2024-06-24,9686
4971,IET-KY,33,2,31,富邦-宜蘭,2024-06-24,9686
2409,友達,53,22,31,富邦-宜蘭,2024-06-24,9686
2472,立隆電,30,1,29,富邦-宜蘭,2024-06-24,9686
00688L,國泰20年美債正2,29,0,29,富邦-宜蘭,2024-06-24,9686
1785,光洋科,91,64,27,富邦-宜蘭,2024-06-24,9686
2353,宏��,43,16,27,富邦-宜蘭,2024-06-24,9686
2609,陽明,65,39,26,富邦-宜蘭,2024-06-24,9686
4153,鈺緯,48,22,26,富邦-宜蘭,2024-06-24,9686
3062,建漢,131,106,25,富邦-宜蘭,2024-06-24,9686
00939,統一台灣高息動能,25,1,24,富邦-宜蘭,2024-06-24,9686
00918,大華優利高填息30,43,19,24,富邦-宜蘭,2024-06-24,9686
3712,永崴投控,25,1,24,富邦-宜蘭,2024-06-24,9686
2369,菱生,65,41,24,富邦-宜蘭,2024-06-24,9686
1809,中釉,23,0,23,富邦-宜蘭,2024-06-24,9686
2303,聯電,40,17,23,富邦-宜蘭,2024-06-24,9686
5328,華容,33,11,22,富邦-宜蘭,2024-06-24,9686
5608,四維航,22,0,22,富邦-宜蘭,2024-06-24,9686
5340,建榮,24,2,22,富邦-宜蘭,2024-06-24,9686
4979,華星光,22,1,21,富邦-宜蘭,2024-06-24,9686
8121,越峰,20,0,20,富邦-宜蘭,2024-06-24,9686
1313,聯成,20,0,20,富邦-宜蘭,2024-06-24,9686
4526,東台,55,35,20,富邦-宜蘭,2024-06-24,9686
00944,野村趨勢動能高息,20,0,20,富邦-宜蘭,2024-06-24,9686
006208,富邦台50,21,1,20,富邦-宜蘭,2024-06-24,9686
1409,新纖,33,14,19,富邦-宜蘭,2024-06-24,9686
6509,聚和,20,1,19,富邦-宜蘭,2024-06-24,9686
6111,大宇資,30,11,19,富邦-宜蘭,2024-06-24,9686
2330,台積電,46,28,18,富邦-宜蘭,2024-06-24,9686
2338,光罩,25,7,18,富邦-宜蘭,2024-06-24,9686
3481,群創,410,45,365,富邦-宜蘭,2024-06-25,9686
00929,復華台灣科技優息,243,30,213,富邦-宜蘭,2024-06-25,9686
00919,群益台灣精選高息,176,59,117,富邦-宜蘭,2024-06-25,9686
00664R,國泰臺灣加權反1,120,8,112,富邦-宜蘭,2024-06-25,9686
00936,台新永續高息中小,75,0,75,富邦-宜蘭,2024-06-25,9686
2344,華邦電,77,2,75,富邦-宜蘭,2024-06-25,9686
1309,台達化,74,2,72,富邦-宜蘭,2024-06-25,9686
6698,旭暉應材,93,32,61,富邦-宜蘭,2024-06-25,9686
00918,大華優利高填息30,71,13,58,富邦-宜蘭,2024-06-25,9686
2409,友達,59,3,56,富邦-宜蘭,2024-06-25,9686
1815,富喬,94,39,55,富邦-宜蘭,2024-06-25,9686
00946,群益科技高息成長,53,1,52,富邦-宜蘭,2024-06-25,9686
6431,光麗-KY,50,2,48,富邦-宜蘭,2024-06-25,9686
00712,復華富時不動產,49,8,41,富邦-宜蘭,2024-06-25,9686
8110,華東,111,70,41,富邦-宜蘭,2024-06-25,9686
1303,南亞,39,0,39,富邦-宜蘭,2024-06-25,9686
00940,元大台灣價值高息,150,112,38,富邦-宜蘭,2024-06-25,9686
00881,國泰台灣5G+,41,5,36,富邦-宜蘭,2024-06-25,9686
2406,國碩,89,56,33,富邦-宜蘭,2024-06-25,9686
00937B,群益ESG投等債20,50,18,32,富邦-宜蘭,2024-06-25,9686
6147,頎邦,31,0,31,富邦-宜蘭,2024-06-25,9686
4562,穎漢,35,7,28,富邦-宜蘭,2024-06-25,9686
2610,華航,33,5,28,富邦-宜蘭,2024-06-25,9686
3576,聯合再生,27,0,27,富邦-宜蘭,2024-06-25,9686
2317,鴻海,85,61,24,富邦-宜蘭,2024-06-25,9686
2031,新光鋼,25,1,24,富邦-宜蘭,2024-06-25,9686
8105,凌巨,26,2,24,富邦-宜蘭,2024-06-25,9686
5351,鈺創,23,0,23,富邦-宜蘭,2024-06-25,9686
00927,群益半導體收益,26,3,23,富邦-宜蘭,2024-06-25,9686
6957,裕慶-KY,25,3,22,富邦-宜蘭,2024-06-25,9686
4571,鈞興-KY,22,0,22,富邦-宜蘭,2024-06-25,9686
6603,富強鑫,23,2,21,富邦-宜蘭,2024-06-25,9686
3285,微端,34,13,21,富邦-宜蘭,2024-06-25,9686
8096,擎亞,29,9,20,富邦-宜蘭,2024-06-25,9686
6282,康舒,25,5,20,富邦-宜蘭,2024-06-25,9686
1452,宏益,148,129,19,富邦-宜蘭,2024-06-25,9686
00944,野村趨勢動能高息,69,50,19,富邦-宜蘭,2024-06-25,9686
6116,彩晶,16,0,16,富邦-宜蘭,2024-06-25,9686
5230,雷笛克光學,15,0,15,富邦-宜蘭,2024-06-25,9686
6153,嘉聯益,15,0,15,富邦-宜蘭,2024-06-25,9686
5340,建榮,16,1,15,富邦-宜蘭,2024-06-25,9686
2515,中工,18,3,15,富邦-宜蘭,2024-06-25,9686
00687B,國泰20年美債,16,2,14,富邦-宜蘭,2024-06-25,9686
5302,太欣,15,1,14,富邦-宜蘭,2024-06-25,9686
3030,德律,15,2,13,富邦-宜蘭,2024-06-25,9686
2882,國泰金,13,0,13,富邦-宜蘭,2024-06-25,9686
5425,台半,13,0,13,富邦-宜蘭,2024-06-25,9686
9907,統一實,13,0,13,富邦-宜蘭,2024-06-25,9686
00947,台新臺灣IC設計,13,0,13,富邦-宜蘭,2024-06-25,9686
1711,永光,13,0,13,富邦-宜蘭,2024-06-25,9686
00632R,元大台灣50反1,670,13,657,富邦-宜蘭,2024-06-26,9686
00948B,中信優息投資級債,402,0,402,富邦-宜蘭,2024-06-26,9686
2002,中鋼,132,4,128,富邦-宜蘭,2024-06-26,9686
2409,友達,128,1,127,富邦-宜蘭,2024-06-26,9686
2312,金寶,153,35,118,富邦-宜蘭,2024-06-26,9686
00937B,群益ESG投等債20,108,4,104,富邦-宜蘭,2024-06-26,9686
00664R,國泰臺灣加權反1,100,0,100,富邦-宜蘭,2024-06-26,9686
00919,群益台灣精選高息,117,24,93,富邦-宜蘭,2024-06-26,9686
2344,華邦電,96,4,92,富邦-宜蘭,2024-06-26,9686
2317,鴻海,133,56,77,富邦-宜蘭,2024-06-26,9686
00936,台新永續高息中小,66,1,65,富邦-宜蘭,2024-06-26,9686
6578,達邦蛋白,50,0,50,富邦-宜蘭,2024-06-26,9686
2371,大同,56,8,48,富邦-宜蘭,2024-06-26,9686
1303,南亞,48,3,45,富邦-宜蘭,2024-06-26,9686
6233,旺玖,46,1,45,富邦-宜蘭,2024-06-26,9686
2884,玉山金,40,0,40,富邦-宜蘭,2024-06-26,9686
910861,神州-DR,44,8,36,富邦-宜蘭,2024-06-26,9686
1101,台泥,35,0,35,富邦-宜蘭,2024-06-26,9686
6505,台塑化,35,0,35,富邦-宜蘭,2024-06-26,9686
2352,佳世達,39,5,34,富邦-宜蘭,2024-06-26,9686
00929,復華台灣科技優息,65,34,31,富邦-宜蘭,2024-06-26,9686
00830,國泰費城半導體,29,2,27,富邦-宜蘭,2024-06-26,9686
1609,大亞,37,12,25,富邦-宜蘭,2024-06-26,9686
006208,富邦台50,25,0,25,富邦-宜蘭,2024-06-26,9686
1102,亞泥,24,0,24,富邦-宜蘭,2024-06-26,9686
2609,陽明,48,24,24,富邦-宜蘭,2024-06-26,9686
2883,凱基金,38,14,24,富邦-宜蘭,2024-06-26,9686
00878,國泰永續高股息,32,9,23,富邦-宜蘭,2024-06-26,9686
00940,元大台灣價值高息,76,53,23,富邦-宜蘭,2024-06-26,9686
00751B,元大AAA至A公司債,52,30,22,富邦-宜蘭,2024-06-26,9686
2515,中工,22,0,22,富邦-宜蘭,2024-06-26,9686
2331,精英,25,5,20,富邦-宜蘭,2024-06-26,9686
1711,永光,20,0,20,富邦-宜蘭,2024-06-26,9686
2338,光罩,20,0,20,富邦-宜蘭,2024-06-26,9686
00939,統一台灣高息動能,32,13,19,富邦-宜蘭,2024-06-26,9686
00946,群益科技高息成長,31,13,18,富邦-宜蘭,2024-06-26,9686
2388,威盛,20,2,18,富邦-宜蘭,2024-06-26,9686
2885,元大金,19,1,18,富邦-宜蘭,2024-06-26,9686
6869,雲豹能源,24,7,17,富邦-宜蘭,2024-06-26,9686
00688L,國泰20年美債正2,17,0,17,富邦-宜蘭,2024-06-26,9686
8110,華東,134,117,17,富邦-宜蘭,2024-06-26,9686
1301,台塑,31,14,17,富邦-宜蘭,2024-06-26,9686
2636,台驊控股,16,0,16,富邦-宜蘭,2024-06-26,9686
8024,佑華,16,0,16,富邦-宜蘭,2024-06-26,9686
2374,佳能,21,5,16,富邦-宜蘭,2024-06-26,9686
00933B,國泰10Y+金融債,15,0,15,富邦-宜蘭,2024-06-26,9686
00713,元大台灣高息低波,15,0,15,富邦-宜蘭,2024-06-26,9686
2890,永豐金,14,0,14,富邦-宜蘭,2024-06-26,9686
6216,居易,18,4,14,富邦-宜蘭,2024-06-26,9686
5388,中磊,13,0,13,富邦-宜蘭,2024-06-26,9686
00632R,元大台灣50反1,300,20,280,富邦-宜蘭,2024-06-27,9686
2897,王道銀行,232,0,232,富邦-宜蘭,2024-06-27,9686
3481,群創,214,26,188,富邦-宜蘭,2024-06-27,9686
00937B,群益ESG投等債20,184,16,168,富邦-宜蘭,2024-06-27,9686
00882,中信中國高股息,149,0,149,富邦-宜蘭,2024-06-27,9686
00679B,元大美債20年,157,29,128,富邦-宜蘭,2024-06-27,9686
2312,金寶,107,9,98,富邦-宜蘭,2024-06-27,9686
00946,群益科技高息成長,104,7,97,富邦-宜蘭,2024-06-27,9686
6405,悅城,91,0,91,富邦-宜蘭,2024-06-27,9686
00878,國泰永續高股息,90,9,81,富邦-宜蘭,2024-06-27,9686
3712,永崴投控,86,27,59,富邦-宜蘭,2024-06-27,9686
00936,台新永續高息中小,58,0,58,富邦-宜蘭,2024-06-27,9686
3083,網龍,61,9,52,富邦-宜蘭,2024-06-27,9686
00919,群益台灣精選高息,77,28,49,富邦-宜蘭,2024-06-27,9686
2885,元大金,47,2,45,富邦-宜蘭,2024-06-27,9686
3047,訊舟,82,37,45,富邦-宜蘭,2024-06-27,9686
00687B,國泰20年美債,51,7,44,富邦-宜蘭,2024-06-27,9686
2884,玉山金,44,0,44,富邦-宜蘭,2024-06-27,9686
6443,元晶,127,83,44,富邦-宜蘭,2024-06-27,9686
00948B,中信優息投資級債,48,5,43,富邦-宜蘭,2024-06-27,9686
1535,中宇,41,0,41,富邦-宜蘭,2024-06-27,9686
3652,精聯,45,5,40,富邦-宜蘭,2024-06-27,9686
8076,伍豐,99,59,40,富邦-宜蘭,2024-06-27,9686
00680L,元大美債20正2,40,1,39,富邦-宜蘭,2024-06-27,9686
00929,復華台灣科技優息,67,30,37,富邦-宜蘭,2024-06-27,9686
00753L,中信中國50正2,49,12,37,富邦-宜蘭,2024-06-27,9686
4938,和碩,37,2,35,富邦-宜蘭,2024-06-27,9686
6505,台塑化,34,2,32,富邦-宜蘭,2024-06-27,9686
9945,潤泰新,38,7,31,富邦-宜蘭,2024-06-27,9686
912000,晨訊科-DR,63,33,30,富邦-宜蘭,2024-06-27,9686
4729,熒茂,30,0,30,富邦-宜蘭,2024-06-27,9686
2867,三商壽,33,4,29,富邦-宜蘭,2024-06-27,9686
6509,聚和,38,10,28,富邦-宜蘭,2024-06-27,9686
8064,東捷,70,43,27,富邦-宜蘭,2024-06-27,9686
4167,松瑞藥,43,17,26,富邦-宜蘭,2024-06-27,9686
1611,中電,41,17,24,富邦-宜蘭,2024-06-27,9686
3673,TPK-KY,23,0,23,富邦-宜蘭,2024-06-27,9686
2002,中鋼,34,11,23,富邦-宜蘭,2024-06-27,9686
6901,鑽石投資,22,0,22,富邦-宜蘭,2024-06-27,9686
5443,均豪,37,16,21,富邦-宜蘭,2024-06-27,9686
2367,燿華,34,13,21,富邦-宜蘭,2024-06-27,9686
8440,綠電,22,1,21,富邦-宜蘭,2024-06-27,9686
6692,進能服,21,0,21,富邦-宜蘭,2024-06-27,9686
6869,雲豹能源,41,20,21,富邦-宜蘭,2024-06-27,9686
910861,神州-DR,20,0,20,富邦-宜蘭,2024-06-27,9686
2506,太設,20,0,20,富邦-宜蘭,2024-06-27,9686
1709,和益,39,19,20,富邦-宜蘭,2024-06-27,9686
00933B,國泰10Y+金融債,30,10,20,富邦-宜蘭,2024-06-27,9686
00944,野村趨勢動能高息,19,0,19,富邦-宜蘭,2024-06-27,9686
6202,盛群,19,0,19,富邦-宜蘭,2024-06-27,9686
2834,臺企銀,400,12,388,富邦-宜蘭,2024-06-28,9686
00948B,中信優息投資級債,255,0,255,富邦-宜蘭,2024-06-28,9686
3481,群創,253,32,221,富邦-宜蘭,2024-06-28,9686
2406,國碩,259,94,165,富邦-宜蘭,2024-06-28,9686
00919,群益台灣精選高息,197,49,148,富邦-宜蘭,2024-06-28,9686
00936,台新永續高息中小,144,0,144,富邦-宜蘭,2024-06-28,9686
2337,旺宏,133,3,130,富邦-宜蘭,2024-06-28,9686
2547,日勝生,117,0,117,富邦-宜蘭,2024-06-28,9686
911868,同方友友-DR,109,3,106,富邦-宜蘭,2024-06-28,9686
8440,綠電,89,9,80,富邦-宜蘭,2024-06-28,9686
8105,凌巨,114,37,77,富邦-宜蘭,2024-06-28,9686
00673R,期元大S＆P原油反1,74,0,74,富邦-宜蘭,2024-06-28,9686
00946,群益科技高息成長,71,0,71,富邦-宜蘭,2024-06-28,9686
00712,復華富時不動產,71,1,70,富邦-宜蘭,2024-06-28,9686
00679B,元大美債20年,69,2,67,富邦-宜蘭,2024-06-28,9686
2618,長榮航,71,6,65,富邦-宜蘭,2024-06-28,9686
3043,科風,77,15,62,富邦-宜蘭,2024-06-28,9686
2417,圓剛,92,30,62,富邦-宜蘭,2024-06-28,9686
9136,巨騰-DR,50,0,50,富邦-宜蘭,2024-06-28,9686
1326,台化,50,0,50,富邦-宜蘭,2024-06-28,9686
00881,國泰台灣5G+,61,11,50,富邦-宜蘭,2024-06-28,9686
2208,台船,53,4,49,富邦-宜蘭,2024-06-28,9686
2349,錸德,62,14,48,富邦-宜蘭,2024-06-28,9686
912000,晨訊科-DR,50,10,40,富邦-宜蘭,2024-06-28,9686
6244,茂迪,115,75,40,富邦-宜蘭,2024-06-28,9686
00687B,國泰20年美債,82,45,37,富邦-宜蘭,2024-06-28,9686
00937B,群益ESG投等債20,48,11,37,富邦-宜蘭,2024-06-28,9686
8421,旭源,33,0,33,富邦-宜蘭,2024-06-28,9686
00885,富邦越南,32,0,32,富邦-宜蘭,2024-06-28,9686
2061,風青,30,0,30,富邦-宜蘭,2024-06-28,9686
4919,新唐,28,1,27,富邦-宜蘭,2024-06-28,9686
3029,零壹,27,0,27,富邦-宜蘭,2024-06-28,9686
00918,大華優利高填息30,42,17,25,富邦-宜蘭,2024-06-28,9686
6582,申豐,25,0,25,富邦-宜蘭,2024-06-28,9686
2429,銘旺科,25,1,24,富邦-宜蘭,2024-06-28,9686
2363,矽統,22,0,22,富邦-宜蘭,2024-06-28,9686
3615,安可,37,17,20,富邦-宜蘭,2024-06-28,9686
6442,光聖,22,2,20,富邦-宜蘭,2024-06-28,9686
2354,鴻準,24,4,20,富邦-宜蘭,2024-06-28,9686
2542,興富發,19,0,19,富邦-宜蘭,2024-06-28,9686
4934,太極,21,2,19,富邦-宜蘭,2024-06-28,9686
3581,博磊,55,36,19,富邦-宜蘭,2024-06-28,9686
2324,仁寶,21,2,19,富邦-宜蘭,2024-06-28,9686
4909,新復興,32,13,19,富邦-宜蘭,2024-06-28,9686
9958,世紀鋼,74,56,18,富邦-宜蘭,2024-06-28,9686
00795B,中信美國公債20年,20,2,18,富邦-宜蘭,2024-06-28,9686
3264,欣銓,17,0,17,富邦-宜蘭,2024-06-28,9686
2374,佳能,43,26,17,富邦-宜蘭,2024-06-28,9686
6895,宏碩系統,20,3,17,富邦-宜蘭,2024-06-28,9686
2633,台灣高鐵,20,3,17,富邦-宜蘭,2024-06-28,9686
00687B,國泰20年美債,299,1,298,富邦-宜蘭,2024-07-01,9686
00948B,中信優息投資級債,239,2,237,富邦-宜蘭,2024-07-01,9686
8105,凌巨,203,4,199,富邦-宜蘭,2024-07-01,9686
00946,群益科技高息成長,178,9,169,富邦-宜蘭,2024-07-01,9686
00931B,統一美債20年,125,0,125,富邦-宜蘭,2024-07-01,9686
4919,新唐,124,8,116,富邦-宜蘭,2024-07-01,9686
6203,海韻電,107,0,107,富邦-宜蘭,2024-07-01,9686
2409,友達,106,1,105,富邦-宜蘭,2024-07-01,9686
3545,敦泰,100,0,100,富邦-宜蘭,2024-07-01,9686
00679B,元大美債20年,100,1,99,富邦-宜蘭,2024-07-01,9686
00929,復華台灣科技優息,159,62,97,富邦-宜蘭,2024-07-01,9686
2883,凱基金,95,5,90,富邦-宜蘭,2024-07-01,9686
2514,龍邦,90,2,88,富邦-宜蘭,2024-07-01,9686
2406,國碩,137,61,76,富邦-宜蘭,2024-07-01,9686
00937B,群益ESG投等債20,84,23,61,富邦-宜蘭,2024-07-01,9686
6753,龍德造船,75,15,60,富邦-宜蘭,2024-07-01,9686
2609,陽明,83,28,55,富邦-宜蘭,2024-07-01,9686
00936,台新永續高息中小,55,0,55,富邦-宜蘭,2024-07-01,9686
2892,第一金,51,0,51,富邦-宜蘭,2024-07-01,9686
9136,巨騰-DR,50,0,50,富邦-宜蘭,2024-07-01,9686
2816,旺旺保,50,0,50,富邦-宜蘭,2024-07-01,9686
3481,群創,84,43,41,富邦-宜蘭,2024-07-01,9686
2103,台橡,41,0,41,富邦-宜蘭,2024-07-01,9686
3576,聯合再生,60,20,40,富邦-宜蘭,2024-07-01,9686
2867,三商壽,40,0,40,富邦-宜蘭,2024-07-01,9686
2367,燿華,45,6,39,富邦-宜蘭,2024-07-01,9686
00757,統一FANG+,37,0,37,富邦-宜蘭,2024-07-01,9686
2355,敬鵬,34,1,33,富邦-宜蘭,2024-07-01,9686
00857B,永豐20年美公債,32,0,32,富邦-宜蘭,2024-07-01,9686
2025,千興,32,0,32,富邦-宜蘭,2024-07-01,9686
1446,宏和,30,0,30,富邦-宜蘭,2024-07-01,9686
6598,ABC-KY,30,0,30,富邦-宜蘭,2024-07-01,9686
5468,凱鈺,30,0,30,富邦-宜蘭,2024-07-01,9686
2913,農林,30,0,30,富邦-宜蘭,2024-07-01,9686
00933B,國泰10Y+金融債,30,0,30,富邦-宜蘭,2024-07-01,9686
00688L,國泰20年美債正2,39,11,28,富邦-宜蘭,2024-07-01,9686
00942B,台新美A公司債20+,30,2,28,富邦-宜蘭,2024-07-01,9686
3048,益登,53,26,27,富邦-宜蘭,2024-07-01,9686
2031,新光鋼,31,5,26,富邦-宜蘭,2024-07-01,9686
6582,申豐,25,0,25,富邦-宜蘭,2024-07-01,9686
2429,銘旺科,25,0,25,富邦-宜蘭,2024-07-01,9686
2313,華通,42,18,24,富邦-宜蘭,2024-07-01,9686
00905,FT臺灣Smart,24,0,24,富邦-宜蘭,2024-07-01,9686
1522,堤維西,31,7,24,富邦-宜蘭,2024-07-01,9686
5443,均豪,30,6,24,富邦-宜蘭,2024-07-01,9686
00720B,元大投資級公司債,23,0,23,富邦-宜蘭,2024-07-01,9686
00795B,中信美國公債20年,23,1,22,富邦-宜蘭,2024-07-01,9686
1611,中電,24,3,21,富邦-宜蘭,2024-07-01,9686
8033,雷虎,22,1,21,富邦-宜蘭,2024-07-01,9686
5880,合庫金,21,0,21,富邦-宜蘭,2024-07-01,9686
00934,中信成長高股息,566,48,518,富邦-宜蘭,2024-07-02,9686
2303,聯電,254,31,223,富邦-宜蘭,2024-07-02,9686
00687B,國泰20年美債,178,14,164,富邦-宜蘭,2024-07-02,9686
00946,群益科技高息成長,155,5,150,富邦-宜蘭,2024-07-02,9686
2349,錸德,261,120,141,富邦-宜蘭,2024-07-02,9686
00929,復華台灣科技優息,336,195,141,富邦-宜蘭,2024-07-02,9686
00919,群益台灣精選高息,195,62,133,富邦-宜蘭,2024-07-02,9686
2915,潤泰全,133,3,130,富邦-宜蘭,2024-07-02,9686
1785,光洋科,125,11,114,富邦-宜蘭,2024-07-02,9686
1304,台聚,120,7,113,富邦-宜蘭,2024-07-02,9686
3481,群創,109,10,99,富邦-宜蘭,2024-07-02,9686
9105,泰金寶-DR,121,31,90,富邦-宜蘭,2024-07-02,9686
00679B,元大美債20年,89,1,88,富邦-宜蘭,2024-07-02,9686
6505,台塑化,84,0,84,富邦-宜蘭,2024-07-02,9686
00665L,富邦�琤肭磪囓�2,79,0,79,富邦-宜蘭,2024-07-02,9686
6834,天二科技,75,9,66,富邦-宜蘭,2024-07-02,9686
00936,台新永續高息中小,65,2,63,富邦-宜蘭,2024-07-02,9686
2317,鴻海,121,63,58,富邦-宜蘭,2024-07-02,9686
5276,達輝-KY,50,0,50,富邦-宜蘭,2024-07-02,9686
00949,復華日本龍頭,80,31,49,富邦-宜蘭,2024-07-02,9686
2208,台船,50,1,49,富邦-宜蘭,2024-07-02,9686
8076,伍豐,66,17,49,富邦-宜蘭,2024-07-02,9686
4919,新唐,45,1,44,富邦-宜蘭,2024-07-02,9686
00712,復華富時不動產,51,10,41,富邦-宜蘭,2024-07-02,9686
2025,千興,40,0,40,富邦-宜蘭,2024-07-02,9686
2406,國碩,307,269,38,富邦-宜蘭,2024-07-02,9686
00857B,永豐20年美公債,35,0,35,富邦-宜蘭,2024-07-02,9686
2402,毅嘉,58,25,33,富邦-宜蘭,2024-07-02,9686
4188,安克,31,0,31,富邦-宜蘭,2024-07-02,9686
5230,雷笛克光學,31,2,29,富邦-宜蘭,2024-07-02,9686
00918,大華優利高填息30,44,15,29,富邦-宜蘭,2024-07-02,9686
3702,大聯大,28,1,27,富邦-宜蘭,2024-07-02,9686
6139,亞翔,40,13,27,富邦-宜蘭,2024-07-02,9686
8054,安國,25,3,22,富邦-宜蘭,2024-07-02,9686
8089,康全電訊,27,6,21,富邦-宜蘭,2024-07-02,9686
00927,群益半導體收益,23,2,21,富邦-宜蘭,2024-07-02,9686
3033,威健,21,1,20,富邦-宜蘭,2024-07-02,9686
6130,上亞科技,21,1,20,富邦-宜蘭,2024-07-02,9686
2438,翔耀,20,0,20,富邦-宜蘭,2024-07-02,9686
6661,威健生技,20,0,20,富邦-宜蘭,2024-07-02,9686
4976,佳凌,20,0,20,富邦-宜蘭,2024-07-02,9686
2002,中鋼,28,8,20,富邦-宜蘭,2024-07-02,9686
2417,圓剛,30,11,19,富邦-宜蘭,2024-07-02,9686
3062,建漢,42,23,19,富邦-宜蘭,2024-07-02,9686
2449,京元電子,25,6,19,富邦-宜蘭,2024-07-02,9686
2609,陽明,49,30,19,富邦-宜蘭,2024-07-02,9686
2515,中工,21,2,19,富邦-宜蘭,2024-07-02,9686
00942B,台新美A公司債20+,20,2,18,富邦-宜蘭,2024-07-02,9686
3622,洋華,59,42,17,富邦-宜蘭,2024-07-02,9686
6116,彩晶,21,4,17,富邦-宜蘭,2024-07-02,9686
4906,正文,286,27,259,富邦-宜蘭,2024-07-03,9686
00757,統一FANG+,224,0,224,富邦-宜蘭,2024-07-03,9686
00934,中信成長高股息,242,19,223,富邦-宜蘭,2024-07-03,9686
2867,三商壽,294,90,204,富邦-宜蘭,2024-07-03,9686
3576,聯合再生,264,118,146,富邦-宜蘭,2024-07-03,9686
2027,大成鋼,100,1,99,富邦-宜蘭,2024-07-03,9686
00905,FT臺灣Smart,93,0,93,富邦-宜蘭,2024-07-03,9686
00687B,國泰20年美債,104,17,87,富邦-宜蘭,2024-07-03,9686
00946,群益科技高息成長,64,0,64,富邦-宜蘭,2024-07-03,9686
2613,中櫃,60,0,60,富邦-宜蘭,2024-07-03,9686
2405,輔信,78,20,58,富邦-宜蘭,2024-07-03,9686
2323,中環,169,114,55,富邦-宜蘭,2024-07-03,9686
2883,凱基金,229,176,53,富邦-宜蘭,2024-07-03,9686
00940,元大台灣價值高息,69,19,50,富邦-宜蘭,2024-07-03,9686
2002,中鋼,47,3,44,富邦-宜蘭,2024-07-03,9686
2885,元大金,40,0,40,富邦-宜蘭,2024-07-03,9686
6658,聯策,39,0,39,富邦-宜蘭,2024-07-03,9686
00679B,元大美債20年,40,1,39,富邦-宜蘭,2024-07-03,9686
00712,復華富時不動產,34,0,34,富邦-宜蘭,2024-07-03,9686
2332,友訊,37,3,34,富邦-宜蘭,2024-07-03,9686
2367,燿華,125,91,34,富邦-宜蘭,2024-07-03,9686
2317,鴻海,91,59,32,富邦-宜蘭,2024-07-03,9686
00929,復華台灣科技優息,91,60,31,富邦-宜蘭,2024-07-03,9686
5347,世界,33,3,30,富邦-宜蘭,2024-07-03,9686
00937B,群益ESG投等債20,34,5,29,富邦-宜蘭,2024-07-03,9686
2489,瑞軒,33,5,28,富邦-宜蘭,2024-07-03,9686
5276,達輝-KY,27,0,27,富邦-宜蘭,2024-07-03,9686
2641,正德,45,18,27,富邦-宜蘭,2024-07-03,9686
2610,華航,32,7,25,富邦-宜蘭,2024-07-03,9686
4968,立積,26,1,25,富邦-宜蘭,2024-07-03,9686
3356,奇偶,24,0,24,富邦-宜蘭,2024-07-03,9686
4303,信立,25,1,24,富邦-宜蘭,2024-07-03,9686
6443,元晶,136,113,23,富邦-宜蘭,2024-07-03,9686
006207,復華滬深,22,0,22,富邦-宜蘭,2024-07-03,9686
3005,神基,25,3,22,富邦-宜蘭,2024-07-03,9686
00919,群益台灣精選高息,62,42,20,富邦-宜蘭,2024-07-03,9686
3202,樺晟,20,0,20,富邦-宜蘭,2024-07-03,9686
6244,茂迪,138,118,20,富邦-宜蘭,2024-07-03,9686
6558,興能高,20,0,20,富邦-宜蘭,2024-07-03,9686
2349,錸德,53,33,20,富邦-宜蘭,2024-07-03,9686
6215,和椿,19,0,19,富邦-宜蘭,2024-07-03,9686
5202,力新,20,1,19,富邦-宜蘭,2024-07-03,9686
4915,致伸,18,0,18,富邦-宜蘭,2024-07-03,9686
1708,東鹼,28,10,18,富邦-宜蘭,2024-07-03,9686
3047,訊舟,114,97,17,富邦-宜蘭,2024-07-03,9686
6843,進典,17,0,17,富邦-宜蘭,2024-07-03,9686
3686,達能,18,2,16,富邦-宜蘭,2024-07-03,9686
6477,安集,20,4,16,富邦-宜蘭,2024-07-03,9686
6235,華孚,18,2,16,富邦-宜蘭,2024-07-03,9686
6278,台表科,22,6,16,富邦-宜蘭,2024-07-03,9686
2889,國票金,508,1,507,富邦-宜蘭,2024-07-04,9686
00929,復華台灣科技優息,274,105,169,富邦-宜蘭,2024-07-04,9686
00687B,國泰20年美債,131,11,120,富邦-宜蘭,2024-07-04,9686
00934,中信成長高股息,178,66,112,富邦-宜蘭,2024-07-04,9686
1409,新纖,104,30,74,富邦-宜蘭,2024-07-04,9686
4540,全球傳動,69,1,68,富邦-宜蘭,2024-07-04,9686
3060,銘異,61,1,60,富邦-宜蘭,2024-07-04,9686
1815,富喬,63,8,55,富邦-宜蘭,2024-07-04,9686
1217,愛之味,55,0,55,富邦-宜蘭,2024-07-04,9686
4109,加捷生醫,71,18,53,富邦-宜蘭,2024-07-04,9686
2412,中華電,47,0,47,富邦-宜蘭,2024-07-04,9686
3346,麗清,50,4,46,富邦-宜蘭,2024-07-04,9686
00918,大華優利高填息30,69,26,43,富邦-宜蘭,2024-07-04,9686
8104,錸寶,43,3,40,富邦-宜蘭,2024-07-04,9686
00946,群益科技高息成長,78,40,38,富邦-宜蘭,2024-07-04,9686
6698,旭暉應材,61,24,37,富邦-宜蘭,2024-07-04,9686
3259,鑫創,37,1,36,富邦-宜蘭,2024-07-04,9686
00949,復華日本龍頭,74,38,36,富邦-宜蘭,2024-07-04,9686
2609,陽明,72,37,35,富邦-宜蘭,2024-07-04,9686
2374,佳能,46,11,35,富邦-宜蘭,2024-07-04,9686
3323,加百裕,66,32,34,富邦-宜蘭,2024-07-04,9686
6142,友勁,32,1,31,富邦-宜蘭,2024-07-04,9686
00948B,中信優息投資級債,33,2,31,富邦-宜蘭,2024-07-04,9686
3041,揚智,30,0,30,富邦-宜蘭,2024-07-04,9686
00944,野村趨勢動能高息,30,2,28,富邦-宜蘭,2024-07-04,9686
2323,中環,63,37,26,富邦-宜蘭,2024-07-04,9686
2349,錸德,28,2,26,富邦-宜蘭,2024-07-04,9686
4721,美琪瑪,26,1,25,富邦-宜蘭,2024-07-04,9686
1301,台塑,30,6,24,富邦-宜蘭,2024-07-04,9686
4571,鈞興-KY,24,0,24,富邦-宜蘭,2024-07-04,9686
8064,東捷,57,34,23,富邦-宜蘭,2024-07-04,9686
2353,宏��,34,11,23,富邦-宜蘭,2024-07-04,9686
2417,圓剛,53,30,23,富邦-宜蘭,2024-07-04,9686
2025,千興,23,0,23,富邦-宜蘭,2024-07-04,9686
2618,長榮航,70,47,23,富邦-宜蘭,2024-07-04,9686
5347,世界,28,6,22,富邦-宜蘭,2024-07-04,9686
4995,晶達,20,0,20,富邦-宜蘭,2024-07-04,9686
1452,宏益,80,60,20,富邦-宜蘭,2024-07-04,9686
1595,川寶,26,6,20,富邦-宜蘭,2024-07-04,9686
4130,健亞,20,0,20,富邦-宜蘭,2024-07-04,9686
00947,台新臺灣IC設計,20,1,19,富邦-宜蘭,2024-07-04,9686
3312,弘憶股,63,45,18,富邦-宜蘭,2024-07-04,9686
00675L,富邦臺灣加權正2,18,0,18,富邦-宜蘭,2024-07-04,9686
3231,緯創,23,5,18,富邦-宜蘭,2024-07-04,9686
2409,友達,23,6,17,富邦-宜蘭,2024-07-04,9686
2230,泰茂,17,0,17,富邦-宜蘭,2024-07-04,9686
2855,統一證,16,0,16,富邦-宜蘭,2024-07-04,9686
2605,新興,17,1,16,富邦-宜蘭,2024-07-04,9686
1447,力鵬,16,0,16,富邦-宜蘭,2024-07-04,9686
6217,中探針,16,1,15,富邦-宜蘭,2024-07-04,9686
2888,新光金,327,22,305,富邦-宜蘭,2024-07-05,9686
00948B,中信優息投資級債,207,0,207,富邦-宜蘭,2024-07-05,9686
2618,長榮航,190,30,160,富邦-宜蘭,2024-07-05,9686
2312,金寶,195,49,146,富邦-宜蘭,2024-07-05,9686
00934,中信成長高股息,126,10,116,富邦-宜蘭,2024-07-05,9686
5328,華容,113,12,101,富邦-宜蘭,2024-07-05,9686
00687B,國泰20年美債,99,0,99,富邦-宜蘭,2024-07-05,9686
8105,凌巨,96,1,95,富邦-宜蘭,2024-07-05,9686
2457,飛宏,79,0,79,富邦-宜蘭,2024-07-05,9686
00885,富邦越南,57,3,54,富邦-宜蘭,2024-07-05,9686
00944,野村趨勢動能高息,52,2,50,富邦-宜蘭,2024-07-05,9686
2892,第一金,52,2,50,富邦-宜蘭,2024-07-05,9686
1325,恆大,50,0,50,富邦-宜蘭,2024-07-05,9686
0056,元大高股息,53,6,47,富邦-宜蘭,2024-07-05,9686
6153,嘉聯益,66,21,45,富邦-宜蘭,2024-07-05,9686
4540,全球傳動,62,18,44,富邦-宜蘭,2024-07-05,9686
1597,直得,56,12,44,富邦-宜蘭,2024-07-05,9686
00637L,元大滬深300正2,43,0,43,富邦-宜蘭,2024-07-05,9686
1303,南亞,43,0,43,富邦-宜蘭,2024-07-05,9686
8104,錸寶,62,24,38,富邦-宜蘭,2024-07-05,9686
4142,國光生,40,2,38,富邦-宜蘭,2024-07-05,9686
4543,萬在,41,4,37,富邦-宜蘭,2024-07-05,9686
2367,燿華,139,104,35,富邦-宜蘭,2024-07-05,9686
00937B,群益ESG投等債20,72,39,33,富邦-宜蘭,2024-07-05,9686
2324,仁寶,41,9,32,富邦-宜蘭,2024-07-05,9686
2347,聯強,31,0,31,富邦-宜蘭,2024-07-05,9686
8096,擎亞,41,13,28,富邦-宜蘭,2024-07-05,9686
5347,世界,35,8,27,富邦-宜蘭,2024-07-05,9686
4952,凌通,37,10,27,富邦-宜蘭,2024-07-05,9686
6753,龍德造船,32,5,27,富邦-宜蘭,2024-07-05,9686
3048,益登,97,71,26,富邦-宜蘭,2024-07-05,9686
3265,台星科,26,0,26,富邦-宜蘭,2024-07-05,9686
6005,群益證,26,1,25,富邦-宜蘭,2024-07-05,9686
00929,復華台灣科技優息,105,81,24,富邦-宜蘭,2024-07-05,9686
5243,乙盛-KY,24,1,23,富邦-宜蘭,2024-07-05,9686
1609,大亞,75,53,22,富邦-宜蘭,2024-07-05,9686
6477,安集,40,19,21,富邦-宜蘭,2024-07-05,9686
6405,悅城,23,2,21,富邦-宜蘭,2024-07-05,9686
1714,和桐,20,0,20,富邦-宜蘭,2024-07-05,9686
2486,一詮,40,20,20,富邦-宜蘭,2024-07-05,9686
4127,天良,30,10,20,富邦-宜蘭,2024-07-05,9686
1201,味全,20,0,20,富邦-宜蘭,2024-07-05,9686
4160,訊聯基因,20,0,20,富邦-宜蘭,2024-07-05,9686
00887,永豐中國科技50大,20,0,20,富邦-宜蘭,2024-07-05,9686
6218,豪勉,20,0,20,富邦-宜蘭,2024-07-05,9686
1402,遠東新,20,1,19,富邦-宜蘭,2024-07-05,9686
3673,TPK-KY,28,9,19,富邦-宜蘭,2024-07-05,9686
00753L,中信中國50正2,19,0,19,富邦-宜蘭,2024-07-05,9686
1514,亞力,35,17,18,富邦-宜蘭,2024-07-05,9686
2399,映泰,20,2,18,富邦-宜蘭,2024-07-05,9686
0056,元大高股息,509,45,464,富邦-宜蘭,2024-07-08,9686
3276,宇環,150,0,150,富邦-宜蘭,2024-07-08,9686
00687B,國泰20年美債,132,14,118,富邦-宜蘭,2024-07-08,9686
00934,中信成長高股息,118,5,113,富邦-宜蘭,2024-07-08,9686
5328,華容,146,33,113,富邦-宜蘭,2024-07-08,9686
1309,台達化,106,0,106,富邦-宜蘭,2024-07-08,9686
00929,復華台灣科技優息,142,55,87,富邦-宜蘭,2024-07-08,9686
00720B,元大投資級公司債,101,22,79,富邦-宜蘭,2024-07-08,9686
6160,欣技,83,4,79,富邦-宜蘭,2024-07-08,9686
2317,鴻海,162,85,77,富邦-宜蘭,2024-07-08,9686
2489,瑞軒,68,1,67,富邦-宜蘭,2024-07-08,9686
2365,昆盈,138,80,58,富邦-宜蘭,2024-07-08,9686
00944,野村趨勢動能高息,59,1,58,富邦-宜蘭,2024-07-08,9686
00927,群益半導體收益,105,50,55,富邦-宜蘭,2024-07-08,9686
2108,南帝,79,24,55,富邦-宜蘭,2024-07-08,9686
3576,聯合再生,68,15,53,富邦-宜蘭,2024-07-08,9686
2618,長榮航,85,37,48,富邦-宜蘭,2024-07-08,9686
1597,直得,50,3,47,富邦-宜蘭,2024-07-08,9686
1785,光洋科,175,131,44,富邦-宜蘭,2024-07-08,9686
00882,中信中國高股息,44,0,44,富邦-宜蘭,2024-07-08,9686
2836,高雄銀,41,1,40,富邦-宜蘭,2024-07-08,9686
2401,凌陽,50,10,40,富邦-宜蘭,2024-07-08,9686
6770,力積電,41,8,33,富邦-宜蘭,2024-07-08,9686
2514,龍邦,33,0,33,富邦-宜蘭,2024-07-08,9686
00936,台新永續高息中小,45,13,32,富邦-宜蘭,2024-07-08,9686
00933B,國泰10Y+金融債,32,1,31,富邦-宜蘭,2024-07-08,9686
3005,神基,31,1,30,富邦-宜蘭,2024-07-08,9686
6582,申豐,30,0,30,富邦-宜蘭,2024-07-08,9686
1454,台富,30,0,30,富邦-宜蘭,2024-07-08,9686
1815,富喬,41,12,29,富邦-宜蘭,2024-07-08,9686
6189,豐藝,39,10,29,富邦-宜蘭,2024-07-08,9686
00937B,群益ESG投等債20,43,16,27,富邦-宜蘭,2024-07-08,9686
3094,聯傑,61,34,27,富邦-宜蘭,2024-07-08,9686
6120,達運,31,4,27,富邦-宜蘭,2024-07-08,9686
6661,威健生技,27,0,27,富邦-宜蘭,2024-07-08,9686
6477,安集,47,20,27,富邦-宜蘭,2024-07-08,9686
2374,佳能,108,82,26,富邦-宜蘭,2024-07-08,9686
00905,FT臺灣Smart,28,2,26,富邦-宜蘭,2024-07-08,9686
1409,新纖,50,24,26,富邦-宜蘭,2024-07-08,9686
00712,復華富時不動產,27,2,25,富邦-宜蘭,2024-07-08,9686
3663,鑫科,26,1,25,富邦-宜蘭,2024-07-08,9686
3346,麗清,25,2,23,富邦-宜蘭,2024-07-08,9686
2354,鴻準,51,29,22,富邦-宜蘭,2024-07-08,9686
6534,正瀚-創,34,13,21,富邦-宜蘭,2024-07-08,9686
1340,勝悅-KY,21,0,21,富邦-宜蘭,2024-07-08,9686
912000,晨訊科-DR,23,2,21,富邦-宜蘭,2024-07-08,9686
5272,笙科,24,3,21,富邦-宜蘭,2024-07-08,9686
4562,穎漢,45,25,20,富邦-宜蘭,2024-07-08,9686
1452,宏益,20,0,20,富邦-宜蘭,2024-07-08,9686
00673R,期元大S＆P原油反1,20,0,20,富邦-宜蘭,2024-07-08,9686
2834,臺企銀,274,30,244,富邦-宜蘭,2024-07-09,9686
2888,新光金,517,276,241,富邦-宜蘭,2024-07-09,9686
9105,泰金寶-DR,275,68,207,富邦-宜蘭,2024-07-09,9686
2312,金寶,322,170,152,富邦-宜蘭,2024-07-09,9686
00934,中信成長高股息,121,8,113,富邦-宜蘭,2024-07-09,9686
00881,國泰台灣5G+,127,17,110,富邦-宜蘭,2024-07-09,9686
3481,群創,183,81,102,富邦-宜蘭,2024-07-09,9686
5475,德宏,98,4,94,富邦-宜蘭,2024-07-09,9686
6218,豪勉,136,48,88,富邦-宜蘭,2024-07-09,9686
3050,鈺德,130,50,80,富邦-宜蘭,2024-07-09,9686
2317,鴻海,157,83,74,富邦-宜蘭,2024-07-09,9686
2883,凱基金,103,33,70,富邦-宜蘭,2024-07-09,9686
1528,恩德,68,0,68,富邦-宜蘭,2024-07-09,9686
00929,復華台灣科技優息,113,58,55,富邦-宜蘭,2024-07-09,9686
6126,信音,78,24,54,富邦-宜蘭,2024-07-09,9686
2618,長榮航,56,11,45,富邦-宜蘭,2024-07-09,9686
00688L,國泰20年美債正2,53,10,43,富邦-宜蘭,2024-07-09,9686
8105,凌巨,114,72,42,富邦-宜蘭,2024-07-09,9686
5328,華容,124,85,39,富邦-宜蘭,2024-07-09,9686
00632R,元大台灣50反1,69,30,39,富邦-宜蘭,2024-07-09,9686
4933,友輝,38,0,38,富邦-宜蘭,2024-07-09,9686
0056,元大高股息,42,5,37,富邦-宜蘭,2024-07-09,9686
3498,陽程,38,1,37,富邦-宜蘭,2024-07-09,9686
6282,康舒,39,3,36,富邦-宜蘭,2024-07-09,9686
2801,彰銀,36,0,36,富邦-宜蘭,2024-07-09,9686
6209,今國光,46,10,36,富邦-宜蘭,2024-07-09,9686
4510,高鋒,61,27,34,富邦-宜蘭,2024-07-09,9686
4906,正文,60,27,33,富邦-宜蘭,2024-07-09,9686
8028,昇陽半導體,82,49,33,富邦-宜蘭,2024-07-09,9686
2002,中鋼,34,2,32,富邦-宜蘭,2024-07-09,9686
2417,圓剛,43,12,31,富邦-宜蘭,2024-07-09,9686
00936,台新永續高息中小,46,15,31,富邦-宜蘭,2024-07-09,9686
2344,華邦電,39,14,25,富邦-宜蘭,2024-07-09,9686
2349,錸德,122,100,22,富邦-宜蘭,2024-07-09,9686
9906,欣巴巴,22,0,22,富邦-宜蘭,2024-07-09,9686
6834,天二科技,28,6,22,富邦-宜蘭,2024-07-09,9686
8071,能率網通,28,7,21,富邦-宜蘭,2024-07-09,9686
2405,輔信,100,80,20,富邦-宜蘭,2024-07-09,9686
3710,連展投控,29,9,20,富邦-宜蘭,2024-07-09,9686
3663,鑫科,21,1,20,富邦-宜蘭,2024-07-09,9686
00950B,凱基A級公司債,20,0,20,富邦-宜蘭,2024-07-09,9686
2354,鴻準,51,31,20,富邦-宜蘭,2024-07-09,9686
2609,陽明,91,71,20,富邦-宜蘭,2024-07-09,9686
8085,福華,20,1,19,富邦-宜蘭,2024-07-09,9686
3047,訊舟,237,218,19,富邦-宜蘭,2024-07-09,9686
2884,玉山金,28,10,18,富邦-宜蘭,2024-07-09,9686
9934,成霖,18,0,18,富邦-宜蘭,2024-07-09,9686
912000,晨訊科-DR,18,0,18,富邦-宜蘭,2024-07-09,9686
2337,旺宏,32,14,18,富邦-宜蘭,2024-07-09,9686
00905,FT臺灣Smart,23,6,17,富邦-宜蘭,2024-07-09,9686
2312,金寶,285,140,145,富邦-宜蘭,2024-07-10,9686
00881,國泰台灣5G+,145,8,137,富邦-宜蘭,2024-07-10,9686
1616,億泰,174,47,127,富邦-宜蘭,2024-07-10,9686
2367,燿華,163,49,114,富邦-宜蘭,2024-07-10,9686
3047,訊舟,118,38,80,富邦-宜蘭,2024-07-10,9686
2002,中鋼,66,1,65,富邦-宜蘭,2024-07-10,9686
00679B,元大美債20年,61,2,59,富邦-宜蘭,2024-07-10,9686
2883,凱基金,266,207,59,富邦-宜蘭,2024-07-10,9686
3481,群創,248,191,57,富邦-宜蘭,2024-07-10,9686
00934,中信成長高股息,54,0,54,富邦-宜蘭,2024-07-10,9686
00937B,群益ESG投等債20,78,27,51,富邦-宜蘭,2024-07-10,9686
6770,力積電,51,0,51,富邦-宜蘭,2024-07-10,9686
2405,輔信,68,18,50,富邦-宜蘭,2024-07-10,9686
00929,復華台灣科技優息,67,20,47,富邦-宜蘭,2024-07-10,9686
2392,正崴,103,57,46,富邦-宜蘭,2024-07-10,9686
3272,東碩,50,4,46,富邦-宜蘭,2024-07-10,9686
2406,國碩,83,38,45,富邦-宜蘭,2024-07-10,9686
00665L,富邦�琤肭磪囓�2,169,125,44,富邦-宜蘭,2024-07-10,9686
3576,聯合再生,51,9,42,富邦-宜蘭,2024-07-10,9686
9906,欣巴巴,40,0,40,富邦-宜蘭,2024-07-10,9686
1102,亞泥,40,0,40,富邦-宜蘭,2024-07-10,9686
6443,元晶,71,31,40,富邦-宜蘭,2024-07-10,9686
3264,欣銓,38,0,38,富邦-宜蘭,2024-07-10,9686
8105,凌巨,57,20,37,富邦-宜蘭,2024-07-10,9686
1536,和大,93,57,36,富邦-宜蘭,2024-07-10,9686
9105,泰金寶-DR,47,13,34,富邦-宜蘭,2024-07-10,9686
4566,時碩工業,32,1,31,富邦-宜蘭,2024-07-10,9686
1605,華新,33,2,31,富邦-宜蘭,2024-07-10,9686
4735,豪展,35,7,28,富邦-宜蘭,2024-07-10,9686
00720B,元大投資級公司債,27,0,27,富邦-宜蘭,2024-07-10,9686
8383,千附,27,1,26,富邦-宜蘭,2024-07-10,9686
1475,業旺,25,0,25,富邦-宜蘭,2024-07-10,9686
1452,宏益,96,72,24,富邦-宜蘭,2024-07-10,9686
6005,群益證,24,0,24,富邦-宜蘭,2024-07-10,9686
00885,富邦越南,25,1,24,富邦-宜蘭,2024-07-10,9686
2305,全友,34,11,23,富邦-宜蘭,2024-07-10,9686
2606,裕民,25,3,22,富邦-宜蘭,2024-07-10,9686
00945B,凱基美國非投等債,21,0,21,富邦-宜蘭,2024-07-10,9686
6442,光聖,22,1,21,富邦-宜蘭,2024-07-10,9686
4726,永昕,25,4,21,富邦-宜蘭,2024-07-10,9686
2344,華邦電,25,4,21,富邦-宜蘭,2024-07-10,9686
6937,天虹,23,3,20,富邦-宜蘭,2024-07-10,9686
3380,明泰,20,0,20,富邦-宜蘭,2024-07-10,9686
4419,皇家美食,20,0,20,富邦-宜蘭,2024-07-10,9686
6213,聯茂,20,0,20,富邦-宜蘭,2024-07-10,9686
2634,漢翔,20,0,20,富邦-宜蘭,2024-07-10,9686
1618,合機,46,28,18,富邦-宜蘭,2024-07-10,9686
2603,長榮,22,5,17,富邦-宜蘭,2024-07-10,9686
00936,台新永續高息中小,18,1,17,富邦-宜蘭,2024-07-10,9686
3019,亞光,19,3,16,富邦-宜蘭,2024-07-10,9686
00673R,期元大S＆P原油反1,330,20,310,富邦-宜蘭,2024-07-11,9686
6216,居易,230,10,220,富邦-宜蘭,2024-07-11,9686
5880,合庫金,136,5,131,富邦-宜蘭,2024-07-11,9686
2883,凱基金,200,85,115,富邦-宜蘭,2024-07-11,9686
1447,力鵬,115,0,115,富邦-宜蘭,2024-07-11,9686
4927,泰鼎-KY,100,0,100,富邦-宜蘭,2024-07-11,9686
00632R,元大台灣50反1,89,10,79,富邦-宜蘭,2024-07-11,9686
00948B,中信優息投資級債,171,103,68,富邦-宜蘭,2024-07-11,9686
00936,台新永續高息中小,67,5,62,富邦-宜蘭,2024-07-11,9686
6570,維田,96,34,62,富邦-宜蘭,2024-07-11,9686
2477,美隆電,50,0,50,富邦-宜蘭,2024-07-11,9686
00725B,國泰投資級公司債,42,0,42,富邦-宜蘭,2024-07-11,9686
2618,長榮航,43,5,38,富邦-宜蘭,2024-07-11,9686
8112,至上,40,5,35,富邦-宜蘭,2024-07-11,9686
2891,中信金,43,8,35,富邦-宜蘭,2024-07-11,9686
0056,元大高股息,44,11,33,富邦-宜蘭,2024-07-11,9686
2464,盟立,91,59,32,富邦-宜蘭,2024-07-11,9686
00919,群益台灣精選高息,52,21,31,富邦-宜蘭,2024-07-11,9686
1101,台泥,36,6,30,富邦-宜蘭,2024-07-11,9686
2362,藍天,37,9,28,富邦-宜蘭,2024-07-11,9686
00940,元大台灣價值高息,85,57,28,富邦-宜蘭,2024-07-11,9686
6530,創威,45,18,27,富邦-宜蘭,2024-07-11,9686
6116,彩晶,30,3,27,富邦-宜蘭,2024-07-11,9686
2417,圓剛,27,1,26,富邦-宜蘭,2024-07-11,9686
6173,信昌電,30,4,26,富邦-宜蘭,2024-07-11,9686
2489,瑞軒,93,68,25,富邦-宜蘭,2024-07-11,9686
6689,伊雲谷,28,4,24,富邦-宜蘭,2024-07-11,9686
2303,聯電,29,6,23,富邦-宜蘭,2024-07-11,9686
5871,中租-KY,25,3,22,富邦-宜蘭,2024-07-11,9686
1513,中興電,108,86,22,富邦-宜蘭,2024-07-11,9686
00881,國泰台灣5G+,33,11,22,富邦-宜蘭,2024-07-11,9686
6133,金橋,28,6,22,富邦-宜蘭,2024-07-11,9686
00950B,凱基A級公司債,22,0,22,富邦-宜蘭,2024-07-11,9686
00933B,國泰10Y+金融債,30,8,22,富邦-宜蘭,2024-07-11,9686
2438,翔耀,22,0,22,富邦-宜蘭,2024-07-11,9686
1314,中石化,26,5,21,富邦-宜蘭,2024-07-11,9686
6271,同欣電,25,4,21,富邦-宜蘭,2024-07-11,9686
3576,聯合再生,34,13,21,富邦-宜蘭,2024-07-11,9686
2834,臺企銀,21,0,21,富邦-宜蘭,2024-07-11,9686
6951,青新-創,20,0,20,富邦-宜蘭,2024-07-11,9686
00945B,凱基美國非投等債,20,0,20,富邦-宜蘭,2024-07-11,9686
6282,康舒,37,17,20,富邦-宜蘭,2024-07-11,9686
2354,鴻準,39,19,20,富邦-宜蘭,2024-07-11,9686
6546,正基,28,9,19,富邦-宜蘭,2024-07-11,9686
2412,中華電,20,1,19,富邦-宜蘭,2024-07-11,9686
1504,東元,30,12,18,富邦-宜蘭,2024-07-11,9686
1725,元禎,18,0,18,富邦-宜蘭,2024-07-11,9686
3062,建漢,37,19,18,富邦-宜蘭,2024-07-11,9686
1514,亞力,61,44,17,富邦-宜蘭,2024-07-11,9686
2609,陽明,35,19,16,富邦-宜蘭,2024-07-11,9686
00934,中信成長高股息,391,12,379,富邦-宜蘭,2024-07-12,9686
00937B,群益ESG投等債20,434,63,371,富邦-宜蘭,2024-07-12,9686
00680L,元大美債20正2,322,0,322,富邦-宜蘭,2024-07-12,9686
00919,群益台灣精選高息,269,21,248,富邦-宜蘭,2024-07-12,9686
00632R,元大台灣50反1,347,198,149,富邦-宜蘭,2024-07-12,9686
00929,復華台灣科技優息,387,244,143,富邦-宜蘭,2024-07-12,9686
00679B,元大美債20年,152,12,140,富邦-宜蘭,2024-07-12,9686
00927,群益半導體收益,124,2,122,富邦-宜蘭,2024-07-12,9686
2477,美隆電,123,18,105,富邦-宜蘭,2024-07-12,9686
2303,聯電,99,16,83,富邦-宜蘭,2024-07-12,9686
6151,晉倫,100,20,80,富邦-宜蘭,2024-07-12,9686
3706,神達,76,7,69,富邦-宜蘭,2024-07-12,9686
2317,鴻海,143,80,63,富邦-宜蘭,2024-07-12,9686
1452,宏益,108,45,63,富邦-宜蘭,2024-07-12,9686
00878,國泰永續高股息,60,4,56,富邦-宜蘭,2024-07-12,9686
1301,台塑,55,0,55,富邦-宜蘭,2024-07-12,9686
0056,元大高股息,44,0,44,富邦-宜蘭,2024-07-12,9686
00687B,國泰20年美債,93,50,43,富邦-宜蘭,2024-07-12,9686
9955,佳龍,45,4,41,富邦-宜蘭,2024-07-12,9686
6570,維田,47,8,39,富邦-宜蘭,2024-07-12,9686
2888,新光金,149,111,38,富邦-宜蘭,2024-07-12,9686
2885,元大金,37,1,36,富邦-宜蘭,2024-07-12,9686
1316,上曜,46,10,36,富邦-宜蘭,2024-07-12,9686
2371,大同,55,20,35,富邦-宜蘭,2024-07-12,9686
00935,野村臺灣新科技50,47,13,34,富邦-宜蘭,2024-07-12,9686
1446,宏和,35,1,34,富邦-宜蘭,2024-07-12,9686
1447,力鵬,35,5,30,富邦-宜蘭,2024-07-12,9686
6005,群益證,30,0,30,富邦-宜蘭,2024-07-12,9686
2313,華通,37,8,29,富邦-宜蘭,2024-07-12,9686
2538,基泰,27,0,27,富邦-宜蘭,2024-07-12,9686
3711,日月光投控,28,1,27,富邦-宜蘭,2024-07-12,9686
3047,訊舟,40,14,26,富邦-宜蘭,2024-07-12,9686
4157,太景*-KY,25,0,25,富邦-宜蘭,2024-07-12,9686
2891,中信金,41,16,25,富邦-宜蘭,2024-07-12,9686
1569,濱川,34,10,24,富邦-宜蘭,2024-07-12,9686
2330,台積電,43,20,23,富邦-宜蘭,2024-07-12,9686
3712,永崴投控,47,24,23,富邦-宜蘭,2024-07-12,9686
6834,天二科技,24,1,23,富邦-宜蘭,2024-07-12,9686
3663,鑫科,26,3,23,富邦-宜蘭,2024-07-12,9686
6182,合晶,22,0,22,富邦-宜蘭,2024-07-12,9686
3050,鈺德,52,30,22,富邦-宜蘭,2024-07-12,9686
8112,至上,24,2,22,富邦-宜蘭,2024-07-12,9686
4576,大銀微系統,23,1,22,富邦-宜蘭,2024-07-12,9686
2609,陽明,47,25,22,富邦-宜蘭,2024-07-12,9686
1785,光洋科,31,10,21,富邦-宜蘭,2024-07-12,9686
00923,群益台ESG低碳50,24,3,21,富邦-宜蘭,2024-07-12,9686
1314,中石化,21,0,21,富邦-宜蘭,2024-07-12,9686
6026,福邦證,21,0,21,富邦-宜蘭,2024-07-12,9686
00725B,國泰投資級公司債,20,0,20,富邦-宜蘭,2024-07-12,9686
4513,福裕,20,0,20,富邦-宜蘭,2024-07-12,9686
1447,力鵬,200,1,199,富邦-宜蘭,2024-07-15,9686
2312,金寶,278,121,157,富邦-宜蘭,2024-07-15,9686
00934,中信成長高股息,157,2,155,富邦-宜蘭,2024-07-15,9686
00937B,群益ESG投等債20,140,29,111,富邦-宜蘭,2024-07-15,9686
00680L,元大美債20正2,117,10,107,富邦-宜蘭,2024-07-15,9686
00929,復華台灣科技優息,108,3,105,富邦-宜蘭,2024-07-15,9686
6188,廣明,99,3,96,富邦-宜蘭,2024-07-15,9686
2891,中信金,90,4,86,富邦-宜蘭,2024-07-15,9686
2356,英業達,169,95,74,富邦-宜蘭,2024-07-15,9686
0056,元大高股息,69,1,68,富邦-宜蘭,2024-07-15,9686
8437,大地-KY,94,30,64,富邦-宜蘭,2024-07-15,9686
00948B,中信優息投資級債,52,0,52,富邦-宜蘭,2024-07-15,9686
4513,福裕,52,0,52,富邦-宜蘭,2024-07-15,9686
1102,亞泥,51,0,51,富邦-宜蘭,2024-07-15,9686
8463,潤泰材,50,0,50,富邦-宜蘭,2024-07-15,9686
6026,福邦證,50,0,50,富邦-宜蘭,2024-07-15,9686
8070,長華*,46,0,46,富邦-宜蘭,2024-07-15,9686
3706,神達,46,0,46,富邦-宜蘭,2024-07-15,9686
1536,和大,75,32,43,富邦-宜蘭,2024-07-15,9686
6005,群益證,42,0,42,富邦-宜蘭,2024-07-15,9686
00878,國泰永續高股息,48,7,41,富邦-宜蘭,2024-07-15,9686
2538,基泰,40,2,38,富邦-宜蘭,2024-07-15,9686
2029,盛餘,36,1,35,富邦-宜蘭,2024-07-15,9686
8105,凌巨,39,4,35,富邦-宜蘭,2024-07-15,9686
2481,強茂,43,10,33,富邦-宜蘭,2024-07-15,9686
6290,良維,36,4,32,富邦-宜蘭,2024-07-15,9686
6603,富強鑫,39,8,31,富邦-宜蘭,2024-07-15,9686
00945B,凱基美國非投等債,30,0,30,富邦-宜蘭,2024-07-15,9686
3567,逸昌,29,0,29,富邦-宜蘭,2024-07-15,9686
3022,威強電,36,7,29,富邦-宜蘭,2024-07-15,9686
2618,長榮航,44,16,28,富邦-宜蘭,2024-07-15,9686
2887,台新金,30,2,28,富邦-宜蘭,2024-07-15,9686
5328,華容,45,18,27,富邦-宜蘭,2024-07-15,9686
2399,映泰,32,8,24,富邦-宜蘭,2024-07-15,9686
6151,晉倫,22,0,22,富邦-宜蘭,2024-07-15,9686
4960,誠美材,26,4,22,富邦-宜蘭,2024-07-15,9686
2401,凌陽,30,8,22,富邦-宜蘭,2024-07-15,9686
2208,台船,21,0,21,富邦-宜蘭,2024-07-15,9686
2324,仁寶,21,0,21,富邦-宜蘭,2024-07-15,9686
5381,合正,30,10,20,富邦-宜蘭,2024-07-15,9686
1708,東鹼,20,0,20,富邦-宜蘭,2024-07-15,9686
1513,中興電,62,42,20,富邦-宜蘭,2024-07-15,9686
2409,友達,22,3,19,富邦-宜蘭,2024-07-15,9686
2025,千興,20,1,19,富邦-宜蘭,2024-07-15,9686
9955,佳龍,19,1,18,富邦-宜蘭,2024-07-15,9686
8358,金居,19,1,18,富邦-宜蘭,2024-07-15,9686
2363,矽統,24,7,17,富邦-宜蘭,2024-07-15,9686
2344,華邦電,21,4,17,富邦-宜蘭,2024-07-15,9686
00905,FT臺灣Smart,19,3,16,富邦-宜蘭,2024-07-15,9686
2884,玉山金,21,5,16,富邦-宜蘭,2024-07-15,9686
2312,金寶,398,129,269,富邦-宜蘭,2024-07-16,9686
00942B,台新美A公司債20+,190,2,188,富邦-宜蘭,2024-07-16,9686
2356,英業達,183,23,160,富邦-宜蘭,2024-07-16,9686
00905,FT臺灣Smart,143,0,143,富邦-宜蘭,2024-07-16,9686
00934,中信成長高股息,131,4,127,富邦-宜蘭,2024-07-16,9686
6148,驊宏資,123,0,123,富邦-宜蘭,2024-07-16,9686
00919,群益台灣精選高息,107,0,107,富邦-宜蘭,2024-07-16,9686
1304,台聚,100,0,100,富邦-宜蘭,2024-07-16,9686
2618,長榮航,102,5,97,富邦-宜蘭,2024-07-16,9686
1447,力鵬,100,15,85,富邦-宜蘭,2024-07-16,9686
2317,鴻海,94,12,82,富邦-宜蘭,2024-07-16,9686
3048,益登,83,9,74,富邦-宜蘭,2024-07-16,9686
6151,晉倫,53,1,52,富邦-宜蘭,2024-07-16,9686
0056,元大高股息,53,4,49,富邦-宜蘭,2024-07-16,9686
1409,新纖,65,20,45,富邦-宜蘭,2024-07-16,9686
3324,雙鴻,44,2,42,富邦-宜蘭,2024-07-16,9686
5328,華容,50,9,41,富邦-宜蘭,2024-07-16,9686
8390,金益鼎,39,0,39,富邦-宜蘭,2024-07-16,9686
00665L,富邦�琤肭磪囓�2,35,0,35,富邦-宜蘭,2024-07-16,9686
2891,中信金,49,14,35,富邦-宜蘭,2024-07-16,9686
4956,光鋐,76,42,34,富邦-宜蘭,2024-07-16,9686
1532,勤美,31,0,31,富邦-宜蘭,2024-07-16,9686
5392,能率,28,0,28,富邦-宜蘭,2024-07-16,9686
2834,臺企銀,26,0,26,富邦-宜蘭,2024-07-16,9686
5426,振發,39,14,25,富邦-宜蘭,2024-07-16,9686
4114,健喬,26,1,25,富邦-宜蘭,2024-07-16,9686
00927,群益半導體收益,23,0,23,富邦-宜蘭,2024-07-16,9686
1101,台泥,22,0,22,富邦-宜蘭,2024-07-16,9686
1722,台肥,26,5,21,富邦-宜蘭,2024-07-16,9686
6492,生華科,35,14,21,富邦-宜蘭,2024-07-16,9686
8933,愛地雅,21,0,21,富邦-宜蘭,2024-07-16,9686
00937B,群益ESG投等債20,58,37,21,富邦-宜蘭,2024-07-16,9686
8358,金居,24,3,21,富邦-宜蘭,2024-07-16,9686
6219,富旺,20,0,20,富邦-宜蘭,2024-07-16,9686
8043,蜜望實,19,0,19,富邦-宜蘭,2024-07-16,9686
00949,復華日本龍頭,24,5,19,富邦-宜蘭,2024-07-16,9686
00878,國泰永續高股息,21,2,19,富邦-宜蘭,2024-07-16,9686
2883,凱基金,22,4,18,富邦-宜蘭,2024-07-16,9686
6425,易發,16,0,16,富邦-宜蘭,2024-07-16,9686
2867,三商壽,46,30,16,富邦-宜蘭,2024-07-16,9686
00948B,中信優息投資級債,15,0,15,富邦-宜蘭,2024-07-16,9686
3041,揚智,15,0,15,富邦-宜蘭,2024-07-16,9686
00950B,凱基A級公司債,15,0,15,富邦-宜蘭,2024-07-16,9686
4960,誠美材,18,3,15,富邦-宜蘭,2024-07-16,9686
3537,堡達,15,0,15,富邦-宜蘭,2024-07-16,9686
00720B,元大投資級公司債,15,0,15,富邦-宜蘭,2024-07-16,9686
6695,芯鼎,37,22,15,富邦-宜蘭,2024-07-16,9686
5381,合正,15,0,15,富邦-宜蘭,2024-07-16,9686
00946,群益科技高息成長,15,1,14,富邦-宜蘭,2024-07-16,9686
8473,山林水,26,12,14,富邦-宜蘭,2024-07-16,9686
00882,中信中國高股息,423,10,413,富邦-宜蘭,2024-07-17,9686
00712,復華富時不動產,395,48,347,富邦-宜蘭,2024-07-17,9686
00937B,群益ESG投等債20,183,11,172,富邦-宜蘭,2024-07-17,9686
00929,復華台灣科技優息,176,20,156,富邦-宜蘭,2024-07-17,9686
1721,三晃,187,44,143,富邦-宜蘭,2024-07-17,9686
2506,太設,150,9,141,富邦-宜蘭,2024-07-17,9686
00885,富邦越南,234,120,114,富邦-宜蘭,2024-07-17,9686
5876,上海商銀,113,0,113,富邦-宜蘭,2024-07-17,9686
2537,聯上發,105,41,64,富邦-宜蘭,2024-07-17,9686
6163,華電網,92,36,56,富邦-宜蘭,2024-07-17,9686
00933B,國泰10Y+金融債,56,1,55,富邦-宜蘭,2024-07-17,9686
2349,錸德,53,1,52,富邦-宜蘭,2024-07-17,9686
4513,福裕,51,1,50,富邦-宜蘭,2024-07-17,9686
2312,金寶,166,116,50,富邦-宜蘭,2024-07-17,9686
00934,中信成長高股息,69,20,49,富邦-宜蘭,2024-07-17,9686
2353,宏��,54,6,48,富邦-宜蘭,2024-07-17,9686
00878,國泰永續高股息,46,0,46,富邦-宜蘭,2024-07-17,9686
00687B,國泰20年美債,46,0,46,富邦-宜蘭,2024-07-17,9686
2408,南亞科,42,0,42,富邦-宜蘭,2024-07-17,9686
9906,欣巴巴,41,1,40,富邦-宜蘭,2024-07-17,9686
6126,信音,50,11,39,富邦-宜蘭,2024-07-17,9686
2515,中工,37,1,36,富邦-宜蘭,2024-07-17,9686
00948B,中信優息投資級債,37,1,36,富邦-宜蘭,2024-07-17,9686
2834,臺企銀,35,0,35,富邦-宜蘭,2024-07-17,9686
3379,彬台,80,48,32,富邦-宜蘭,2024-07-17,9686
5880,合庫金,32,1,31,富邦-宜蘭,2024-07-17,9686
5426,振發,35,5,30,富邦-宜蘭,2024-07-17,9686
2030,彰源,30,0,30,富邦-宜蘭,2024-07-17,9686
3673,TPK-KY,37,7,30,富邦-宜蘭,2024-07-17,9686
3231,緯創,55,25,30,富邦-宜蘭,2024-07-17,9686
3706,神達,32,3,29,富邦-宜蘭,2024-07-17,9686
2344,華邦電,28,0,28,富邦-宜蘭,2024-07-17,9686
6492,生華科,31,3,28,富邦-宜蘭,2024-07-17,9686
00665L,富邦�琤肭磪囓�2,78,50,28,富邦-宜蘭,2024-07-17,9686
6443,元晶,35,7,28,富邦-宜蘭,2024-07-17,9686
2317,鴻海,34,6,28,富邦-宜蘭,2024-07-17,9686
8089,康全電訊,28,1,27,富邦-宜蘭,2024-07-17,9686
00927,群益半導體收益,26,0,26,富邦-宜蘭,2024-07-17,9686
2489,瑞軒,88,62,26,富邦-宜蘭,2024-07-17,9686
3050,鈺德,33,8,25,富邦-宜蘭,2024-07-17,9686
0056,元大高股息,26,2,24,富邦-宜蘭,2024-07-17,9686
00936,台新永續高息中小,50,26,24,富邦-宜蘭,2024-07-17,9686
3567,逸昌,24,0,24,富邦-宜蘭,2024-07-17,9686
1536,和大,35,11,24,富邦-宜蘭,2024-07-17,9686
2888,新光金,42,20,22,富邦-宜蘭,2024-07-17,9686
6770,力積電,47,25,22,富邦-宜蘭,2024-07-17,9686
00881,國泰台灣5G+,70,48,22,富邦-宜蘭,2024-07-17,9686
00946,群益科技高息成長,25,4,21,富邦-宜蘭,2024-07-17,9686
3346,麗清,21,0,21,富邦-宜蘭,2024-07-17,9686
5309,系統電,20,0,20,富邦-宜蘭,2024-07-17,9686
00929,復華台灣科技優息,279,106,173,富邦-宜蘭,2024-07-18,9686
00687B,國泰20年美債,161,1,160,富邦-宜蘭,2024-07-18,9686
6770,力積電,170,21,149,富邦-宜蘭,2024-07-18,9686
00919,群益台灣精選高息,164,68,96,富邦-宜蘭,2024-07-18,9686
00878,國泰永續高股息,114,20,94,富邦-宜蘭,2024-07-18,9686
00927,群益半導體收益,90,0,90,富邦-宜蘭,2024-07-18,9686
2356,英業達,95,18,77,富邦-宜蘭,2024-07-18,9686
00934,中信成長高股息,77,2,75,富邦-宜蘭,2024-07-18,9686
1709,和益,100,26,74,富邦-宜蘭,2024-07-18,9686
1301,台塑,103,43,60,富邦-宜蘭,2024-07-18,9686
4729,熒茂,60,0,60,富邦-宜蘭,2024-07-18,9686
00948B,中信優息投資級債,62,5,57,富邦-宜蘭,2024-07-18,9686
5871,中租-KY,60,3,57,富邦-宜蘭,2024-07-18,9686
1402,遠東新,56,0,56,富邦-宜蘭,2024-07-18,9686
6492,生華科,71,19,52,富邦-宜蘭,2024-07-18,9686
2641,正德,52,1,51,富邦-宜蘭,2024-07-18,9686
3013,晟銘電,74,23,51,富邦-宜蘭,2024-07-18,9686
0056,元大高股息,63,16,47,富邦-宜蘭,2024-07-18,9686
00937B,群益ESG投等債20,189,143,46,富邦-宜蘭,2024-07-18,9686
00881,國泰台灣5G+,46,1,45,富邦-宜蘭,2024-07-18,9686
8121,越峰,41,1,40,富邦-宜蘭,2024-07-18,9686
6240,松崗,40,0,40,富邦-宜蘭,2024-07-18,9686
2419,仲琦,55,16,39,富邦-宜蘭,2024-07-18,9686
8105,凌巨,122,85,37,富邦-宜蘭,2024-07-18,9686
00936,台新永續高息中小,44,8,36,富邦-宜蘭,2024-07-18,9686
3706,神達,40,4,36,富邦-宜蘭,2024-07-18,9686
00946,群益科技高息成長,90,55,35,富邦-宜蘭,2024-07-18,9686
5607,遠雄港,35,1,34,富邦-宜蘭,2024-07-18,9686
3346,麗清,33,0,33,富邦-宜蘭,2024-07-18,9686
2382,廣達,34,1,33,富邦-宜蘭,2024-07-18,9686
3703,欣陸,36,5,31,富邦-宜蘭,2024-07-18,9686
6196,帆宣,32,1,31,富邦-宜蘭,2024-07-18,9686
4933,友輝,30,0,30,富邦-宜蘭,2024-07-18,9686
2330,台積電,60,31,29,富邦-宜蘭,2024-07-18,9686
00893,國泰智能電動車,30,1,29,富邦-宜蘭,2024-07-18,9686
2449,京元電子,36,8,28,富邦-宜蘭,2024-07-18,9686
00905,FT臺灣Smart,27,0,27,富邦-宜蘭,2024-07-18,9686
1316,上曜,60,35,25,富邦-宜蘭,2024-07-18,9686
00918,大華優利高填息30,39,14,25,富邦-宜蘭,2024-07-18,9686
1536,和大,38,14,24,富邦-宜蘭,2024-07-18,9686
5426,振發,24,0,24,富邦-宜蘭,2024-07-18,9686
00930,永豐ESG低碳高息,24,0,24,富邦-宜蘭,2024-07-18,9686
3312,弘憶股,24,2,22,富邦-宜蘭,2024-07-18,9686
1102,亞泥,21,0,21,富邦-宜蘭,2024-07-18,9686
9955,佳龍,45,24,21,富邦-宜蘭,2024-07-18,9686
5469,瀚宇博,21,0,21,富邦-宜蘭,2024-07-18,9686
2317,鴻海,116,95,21,富邦-宜蘭,2024-07-18,9686
00904,新光臺灣半導體30,20,0,20,富邦-宜蘭,2024-07-18,9686
1815,富喬,29,9,20,富邦-宜蘭,2024-07-18,9686
6834,天二科技,21,1,20,富邦-宜蘭,2024-07-18,9686
00680L,元大美債20正2,410,40,370,富邦-宜蘭,2024-07-19,9686
2888,新光金,278,20,258,富邦-宜蘭,2024-07-19,9686
00929,復華台灣科技優息,309,76,233,富邦-宜蘭,2024-07-19,9686
00885,富邦越南,236,14,222,富邦-宜蘭,2024-07-19,9686
00753L,中信中國50正2,200,0,200,富邦-宜蘭,2024-07-19,9686
00937B,群益ESG投等債20,198,24,174,富邦-宜蘭,2024-07-19,9686
00665L,富邦�琤肭磪囓�2,101,3,98,富邦-宜蘭,2024-07-19,9686
2330,台積電,102,12,90,富邦-宜蘭,2024-07-19,9686
6598,ABC-KY,86,2,84,富邦-宜蘭,2024-07-19,9686
3481,群創,555,473,82,富邦-宜蘭,2024-07-19,9686
00936,台新永續高息中小,79,0,79,富邦-宜蘭,2024-07-19,9686
0056,元大高股息,82,6,76,富邦-宜蘭,2024-07-19,9686
6206,飛捷,76,0,76,富邦-宜蘭,2024-07-19,9686
5876,上海商銀,68,0,68,富邦-宜蘭,2024-07-19,9686
1540,喬福,90,26,64,富邦-宜蘭,2024-07-19,9686
5871,中租-KY,62,3,59,富邦-宜蘭,2024-07-19,9686
6120,達運,59,0,59,富邦-宜蘭,2024-07-19,9686
00632R,元大台灣50反1,113,55,58,富邦-宜蘭,2024-07-19,9686
00878,國泰永續高股息,95,40,55,富邦-宜蘭,2024-07-19,9686
00673R,期元大S＆P原油反1,55,0,55,富邦-宜蘭,2024-07-19,9686
00934,中信成長高股息,57,3,54,富邦-宜蘭,2024-07-19,9686
3419,譁裕,54,1,53,富邦-宜蘭,2024-07-19,9686
6126,信音,55,3,52,富邦-宜蘭,2024-07-19,9686
00946,群益科技高息成長,54,3,51,富邦-宜蘭,2024-07-19,9686
2356,英業達,58,9,49,富邦-宜蘭,2024-07-19,9686
2014,中鴻,49,0,49,富邦-宜蘭,2024-07-19,9686
2881,富邦金,56,9,47,富邦-宜蘭,2024-07-19,9686
2337,旺宏,68,21,47,富邦-宜蘭,2024-07-19,9686
2641,正德,52,5,47,富邦-宜蘭,2024-07-19,9686
2845,遠東銀,45,0,45,富邦-宜蘭,2024-07-19,9686
6257,矽格,125,80,45,富邦-宜蘭,2024-07-19,9686
4960,誠美材,52,11,41,富邦-宜蘭,2024-07-19,9686
4188,安克,40,0,40,富邦-宜蘭,2024-07-19,9686
2618,長榮航,43,5,38,富邦-宜蘭,2024-07-19,9686
2344,華邦電,39,1,38,富邦-宜蘭,2024-07-19,9686
6116,彩晶,37,0,37,富邦-宜蘭,2024-07-19,9686
1597,直得,50,14,36,富邦-宜蘭,2024-07-19,9686
1709,和益,150,115,35,富邦-宜蘭,2024-07-19,9686
00918,大華優利高填息30,50,15,35,富邦-宜蘭,2024-07-19,9686
6156,松上,34,0,34,富邦-宜蘭,2024-07-19,9686
6770,力積電,40,8,32,富邦-宜蘭,2024-07-19,9686
2031,新光鋼,32,0,32,富邦-宜蘭,2024-07-19,9686
00939,統一台灣高息動能,49,18,31,富邦-宜蘭,2024-07-19,9686
1612,宏泰,30,0,30,富邦-宜蘭,2024-07-19,9686
5607,遠雄港,29,0,29,富邦-宜蘭,2024-07-19,9686
2834,臺企銀,43,15,28,富邦-宜蘭,2024-07-19,9686
00687B,國泰20年美債,44,16,28,富邦-宜蘭,2024-07-19,9686
2331,精英,28,0,28,富邦-宜蘭,2024-07-19,9686
2891,中信金,52,24,28,富邦-宜蘭,2024-07-19,9686
8011,台通,29,2,27,富邦-宜蘭,2024-07-19,9686
00676R,富邦臺灣加權反1,378,5,373,富邦-宜蘭,2024-07-22,9686
2888,新光金,394,99,295,富邦-宜蘭,2024-07-22,9686
5512,力麒,494,206,288,富邦-宜蘭,2024-07-22,9686
00929,復華台灣科技優息,368,97,271,富邦-宜蘭,2024-07-22,9686
00942B,台新美A公司債20+,180,8,172,富邦-宜蘭,2024-07-22,9686
00919,群益台灣精選高息,228,86,142,富邦-宜蘭,2024-07-22,9686
00878,國泰永續高股息,159,63,96,富邦-宜蘭,2024-07-22,9686
3481,群創,118,36,82,富邦-宜蘭,2024-07-22,9686
00665L,富邦�琤肭磪囓�2,81,2,79,富邦-宜蘭,2024-07-22,9686
00940,元大台灣價值高息,131,52,79,富邦-宜蘭,2024-07-22,9686
00937B,群益ESG投等債20,96,31,65,富邦-宜蘭,2024-07-22,9686
2409,友達,68,7,61,富邦-宜蘭,2024-07-22,9686
2303,聯電,82,29,53,富邦-宜蘭,2024-07-22,9686
6120,達運,52,0,52,富邦-宜蘭,2024-07-22,9686
1540,喬福,63,15,48,富邦-宜蘭,2024-07-22,9686
5880,合庫金,43,2,41,富邦-宜蘭,2024-07-22,9686
0056,元大高股息,53,14,39,富邦-宜蘭,2024-07-22,9686
2349,錸德,37,0,37,富邦-宜蘭,2024-07-22,9686
2317,鴻海,152,118,34,富邦-宜蘭,2024-07-22,9686
4916,事欣科,93,60,33,富邦-宜蘭,2024-07-22,9686
8473,山林水,110,78,32,富邦-宜蘭,2024-07-22,9686
2344,華邦電,51,20,31,富邦-宜蘭,2024-07-22,9686
1609,大亞,75,44,31,富邦-宜蘭,2024-07-22,9686
00687B,國泰20年美債,34,4,30,富邦-宜蘭,2024-07-22,9686
00680L,元大美債20正2,30,1,29,富邦-宜蘭,2024-07-22,9686
3128,昇銳,28,0,28,富邦-宜蘭,2024-07-22,9686
6443,元晶,28,1,27,富邦-宜蘭,2024-07-22,9686
2834,臺企銀,34,7,27,富邦-宜蘭,2024-07-22,9686
00936,台新永續高息中小,29,3,26,富邦-宜蘭,2024-07-22,9686
5531,鄉林,26,1,25,富邦-宜蘭,2024-07-22,9686
00934,中信成長高股息,130,105,25,富邦-宜蘭,2024-07-22,9686
3680,家登,25,1,24,富邦-宜蘭,2024-07-22,9686
5876,上海商銀,24,0,24,富邦-宜蘭,2024-07-22,9686
6257,矽格,30,6,24,富邦-宜蘭,2024-07-22,9686
2365,昆盈,83,60,23,富邦-宜蘭,2024-07-22,9686
2476,鉅祥,26,3,23,富邦-宜蘭,2024-07-22,9686
2002,中鋼,24,1,23,富邦-宜蘭,2024-07-22,9686
1316,上曜,22,0,22,富邦-宜蘭,2024-07-22,9686
006208,富邦台50,28,6,22,富邦-宜蘭,2024-07-22,9686
2884,玉山金,56,34,22,富邦-宜蘭,2024-07-22,9686
2356,英業達,58,37,21,富邦-宜蘭,2024-07-22,9686
6206,飛捷,21,0,21,富邦-宜蘭,2024-07-22,9686
00637L,元大滬深300正2,33,12,21,富邦-宜蘭,2024-07-22,9686
2031,新光鋼,21,0,21,富邦-宜蘭,2024-07-22,9686
4743,合一,38,17,21,富邦-宜蘭,2024-07-22,9686
2913,農林,20,0,20,富邦-宜蘭,2024-07-22,9686
00945B,凱基美國非投等債,21,1,20,富邦-宜蘭,2024-07-22,9686
2539,櫻花建,20,0,20,富邦-宜蘭,2024-07-22,9686
8936,國統,22,2,20,富邦-宜蘭,2024-07-22,9686
00946,群益科技高息成長,85,65,20,富邦-宜蘭,2024-07-22,9686
00632R,元大台灣50反1,1217,162,1055,富邦-宜蘭,2024-07-23,9686
00680L,元大美債20正2,325,9,316,富邦-宜蘭,2024-07-23,9686
2867,三商壽,304,2,302,富邦-宜蘭,2024-07-23,9686
00919,群益台灣精選高息,296,48,248,富邦-宜蘭,2024-07-23,9686
2897,王道銀行,201,0,201,富邦-宜蘭,2024-07-23,9686
2883,凱基金,202,10,192,富邦-宜蘭,2024-07-23,9686
00679B,元大美債20年,207,25,182,富邦-宜蘭,2024-07-23,9686
5512,力麒,195,18,177,富邦-宜蘭,2024-07-23,9686
5276,達輝-KY,170,0,170,富邦-宜蘭,2024-07-23,9686
00929,復華台灣科技優息,224,62,162,富邦-宜蘭,2024-07-23,9686
2208,台船,142,0,142,富邦-宜蘭,2024-07-23,9686
3481,群創,187,46,141,富邦-宜蘭,2024-07-23,9686
00881,國泰台灣5G+,116,0,116,富邦-宜蘭,2024-07-23,9686
00878,國泰永續高股息,131,27,104,富邦-宜蘭,2024-07-23,9686
00946,群益科技高息成長,85,4,81,富邦-宜蘭,2024-07-23,9686
00937B,群益ESG投等債20,80,0,80,富邦-宜蘭,2024-07-23,9686
00948B,中信優息投資級債,67,0,67,富邦-宜蘭,2024-07-23,9686
1702,南僑,60,0,60,富邦-宜蘭,2024-07-23,9686
00712,復華富時不動產,53,0,53,富邦-宜蘭,2024-07-23,9686
6661,威健生技,53,1,52,富邦-宜蘭,2024-07-23,9686
2323,中環,47,1,46,富邦-宜蘭,2024-07-23,9686
2489,瑞軒,52,8,44,富邦-宜蘭,2024-07-23,9686
6239,力成,41,0,41,富邦-宜蘭,2024-07-23,9686
2834,臺企銀,51,14,37,富邦-宜蘭,2024-07-23,9686
2359,所羅門,118,82,36,富邦-宜蘭,2024-07-23,9686
2408,南亞科,48,13,35,富邦-宜蘭,2024-07-23,9686
0056,元大高股息,74,40,34,富邦-宜蘭,2024-07-23,9686
8085,福華,56,22,34,富邦-宜蘭,2024-07-23,9686
6834,天二科技,34,0,34,富邦-宜蘭,2024-07-23,9686
00940,元大台灣價值高息,75,42,33,富邦-宜蘭,2024-07-23,9686
2888,新光金,49,18,31,富邦-宜蘭,2024-07-23,9686
1727,中華化,30,0,30,富邦-宜蘭,2024-07-23,9686
3050,鈺德,35,6,29,富邦-宜蘭,2024-07-23,9686
3706,神達,33,5,28,富邦-宜蘭,2024-07-23,9686
1452,宏益,83,55,28,富邦-宜蘭,2024-07-23,9686
2301,光寶科,28,1,27,富邦-宜蘭,2024-07-23,9686
1217,愛之味,34,9,25,富邦-宜蘭,2024-07-23,9686
2537,聯上發,36,13,23,富邦-宜蘭,2024-07-23,9686
2820,華票,22,0,22,富邦-宜蘭,2024-07-23,9686
00637L,元大滬深300正2,23,2,21,富邦-宜蘭,2024-07-23,9686
4960,誠美材,21,0,21,富邦-宜蘭,2024-07-23,9686
00918,大華優利高填息30,20,0,20,富邦-宜蘭,2024-07-23,9686
2002,中鋼,20,0,20,富邦-宜蘭,2024-07-23,9686
5309,系統電,24,5,19,富邦-宜蘭,2024-07-23,9686
3073,天方能源,18,0,18,富邦-宜蘭,2024-07-23,9686
2601,益航,20,2,18,富邦-宜蘭,2024-07-23,9686
6257,矽格,22,4,18,富邦-宜蘭,2024-07-23,9686
6182,合晶,19,1,18,富邦-宜蘭,2024-07-23,9686
4967,十銓,19,2,17,富邦-宜蘭,2024-07-23,9686
00913,兆豐台灣晶圓製造,16,0,16,富邦-宜蘭,2024-07-23,9686
00929,復華台灣科技優息,274,2,272,富邦-宜蘭,2024-07-26,9686
2888,新光金,209,52,157,富邦-宜蘭,2024-07-26,9686
00937B,群益ESG投等債20,154,12,142,富邦-宜蘭,2024-07-26,9686
00919,群益台灣精選高息,125,18,107,富邦-宜蘭,2024-07-26,9686
00878,國泰永續高股息,81,0,81,富邦-宜蘭,2024-07-26,9686
5880,合庫金,85,6,79,富邦-宜蘭,2024-07-26,9686
2317,鴻海,97,25,72,富邦-宜蘭,2024-07-26,9686
0056,元大高股息,77,8,69,富邦-宜蘭,2024-07-26,9686
00712,復華富時不動產,86,18,68,富邦-宜蘭,2024-07-26,9686
2303,聯電,87,22,65,富邦-宜蘭,2024-07-26,9686
2820,華票,55,0,55,富邦-宜蘭,2024-07-26,9686
6770,力積電,78,23,55,富邦-宜蘭,2024-07-26,9686
4105,東洋,52,0,52,富邦-宜蘭,2024-07-26,9686
6830,汎銓,50,0,50,富邦-宜蘭,2024-07-26,9686
00933B,國泰10Y+金融債,63,17,46,富邦-宜蘭,2024-07-26,9686
2881,富邦金,46,2,44,富邦-宜蘭,2024-07-26,9686
2330,台積電,57,14,43,富邦-宜蘭,2024-07-26,9686
2356,英業達,59,17,42,富邦-宜蘭,2024-07-26,9686
2884,玉山金,41,0,41,富邦-宜蘭,2024-07-26,9686
2344,華邦電,41,2,39,富邦-宜蘭,2024-07-26,9686
00934,中信成長高股息,39,1,38,富邦-宜蘭,2024-07-26,9686
2801,彰銀,42,10,32,富邦-宜蘭,2024-07-26,9686
00720B,元大投資級公司債,34,2,32,富邦-宜蘭,2024-07-26,9686
8085,福華,52,21,31,富邦-宜蘭,2024-07-26,9686
8390,金益鼎,30,0,30,富邦-宜蘭,2024-07-26,9686
1608,華榮,44,14,30,富邦-宜蘭,2024-07-26,9686
2348,海悅,34,4,30,富邦-宜蘭,2024-07-26,9686
6425,易發,30,0,30,富邦-宜蘭,2024-07-26,9686
3711,日月光投控,29,0,29,富邦-宜蘭,2024-07-26,9686
2349,錸德,31,3,28,富邦-宜蘭,2024-07-26,9686
3231,緯創,41,13,28,富邦-宜蘭,2024-07-26,9686
2885,元大金,28,1,27,富邦-宜蘭,2024-07-26,9686
4933,友輝,30,3,27,富邦-宜蘭,2024-07-26,9686
00936,台新永續高息中小,32,6,26,富邦-宜蘭,2024-07-26,9686
2408,南亞科,26,0,26,富邦-宜蘭,2024-07-26,9686
2382,廣達,29,3,26,富邦-宜蘭,2024-07-26,9686
8028,昇陽半導體,85,63,22,富邦-宜蘭,2024-07-26,9686
00940,元大台灣價值高息,144,122,22,富邦-宜蘭,2024-07-26,9686
2409,友達,28,7,21,富邦-宜蘭,2024-07-26,9686
2323,中環,20,0,20,富邦-宜蘭,2024-07-26,9686
00948B,中信優息投資級債,20,0,20,富邦-宜蘭,2024-07-26,9686
4188,安克,20,0,20,富邦-宜蘭,2024-07-26,9686
1301,台塑,19,0,19,富邦-宜蘭,2024-07-26,9686
3013,晟銘電,55,36,19,富邦-宜蘭,2024-07-26,9686
3260,威剛,20,1,19,富邦-宜蘭,2024-07-26,9686
00927,群益半導體收益,18,0,18,富邦-宜蘭,2024-07-26,9686
00946,群益科技高息成長,78,60,18,富邦-宜蘭,2024-07-26,9686
4967,十銓,22,4,18,富邦-宜蘭,2024-07-26,9686
5512,力麒,43,26,17,富邦-宜蘭,2024-07-26,9686
2610,華航,25,8,17,富邦-宜蘭,2024-07-26,9686
00929,復華台灣科技優息,196,54,142,富邦-宜蘭,2024-07-29,9686
00740B,富邦全球投等債,120,0,120,富邦-宜蘭,2024-07-29,9686
00919,群益台灣精選高息,152,36,116,富邦-宜蘭,2024-07-29,9686
00878,國泰永續高股息,113,7,106,富邦-宜蘭,2024-07-29,9686
3481,群創,179,75,104,富邦-宜蘭,2024-07-29,9686
00933B,國泰10Y+金融債,110,7,103,富邦-宜蘭,2024-07-29,9686
6188,廣明,102,2,100,富邦-宜蘭,2024-07-29,9686
00680L,元大美債20正2,100,3,97,富邦-宜蘭,2024-07-29,9686
2883,凱基金,101,4,97,富邦-宜蘭,2024-07-29,9686
2349,錸德,106,17,89,富邦-宜蘭,2024-07-29,9686
2884,玉山金,86,1,85,富邦-宜蘭,2024-07-29,9686
2888,新光金,64,5,59,富邦-宜蘭,2024-07-29,9686
00633L,富邦上証正2,56,0,56,富邦-宜蘭,2024-07-29,9686
00679B,元大美債20年,82,27,55,富邦-宜蘭,2024-07-29,9686
6206,飛捷,53,3,50,富邦-宜蘭,2024-07-29,9686
00937B,群益ESG投等債20,55,5,50,富邦-宜蘭,2024-07-29,9686
2356,英業達,70,21,49,富邦-宜蘭,2024-07-29,9686
2303,聯電,48,1,47,富邦-宜蘭,2024-07-29,9686
2515,中工,68,21,47,富邦-宜蘭,2024-07-29,9686
0056,元大高股息,47,6,41,富邦-宜蘭,2024-07-29,9686
00934,中信成長高股息,43,3,40,富邦-宜蘭,2024-07-29,9686
8215,明基材,40,0,40,富邦-宜蘭,2024-07-29,9686
00687B,國泰20年美債,51,14,37,富邦-宜蘭,2024-07-29,9686
2353,宏��,34,2,32,富邦-宜蘭,2024-07-29,9686
1727,中華化,32,0,32,富邦-宜蘭,2024-07-29,9686
00946,群益科技高息成長,28,0,28,富邦-宜蘭,2024-07-29,9686
2867,三商壽,28,1,27,富邦-宜蘭,2024-07-29,9686
1319,東陽,24,0,24,富邦-宜蘭,2024-07-29,9686
5530,龍巖,24,0,24,富邦-宜蘭,2024-07-29,9686
6257,矽格,24,0,24,富邦-宜蘭,2024-07-29,9686
3188,鑫龍騰,42,19,23,富邦-宜蘭,2024-07-29,9686
1609,大亞,38,15,23,富邦-宜蘭,2024-07-29,9686
2406,國碩,21,0,21,富邦-宜蘭,2024-07-29,9686
2324,仁寶,22,2,20,富邦-宜蘭,2024-07-29,9686
9911,櫻花,22,2,20,富邦-宜蘭,2024-07-29,9686
6770,力積電,20,1,19,富邦-宜蘭,2024-07-29,9686
2886,兆豐金,21,4,17,富邦-宜蘭,2024-07-29,9686
8105,凌巨,36,19,17,富邦-宜蘭,2024-07-29,9686
2070,精湛,50,33,17,富邦-宜蘭,2024-07-29,9686
3062,建漢,17,1,16,富邦-宜蘭,2024-07-29,9686
00942B,台新美A公司債20+,16,0,16,富邦-宜蘭,2024-07-29,9686
6120,達運,16,0,16,富邦-宜蘭,2024-07-29,9686
1815,富喬,19,4,15,富邦-宜蘭,2024-07-29,9686
5340,建榮,15,0,15,富邦-宜蘭,2024-07-29,9686
3024,憶聲,25,10,15,富邦-宜蘭,2024-07-29,9686
2367,燿華,27,13,14,富邦-宜蘭,2024-07-29,9686
2408,南亞科,15,1,14,富邦-宜蘭,2024-07-29,9686
3663,鑫科,36,23,13,富邦-宜蘭,2024-07-29,9686
8096,擎亞,16,4,12,富邦-宜蘭,2024-07-29,9686
3006,晶豪科,12,0,12,富邦-宜蘭,2024-07-29,9686
00929,復華台灣科技優息,337,66,271,富邦-宜蘭,2024-07-30,9686
00940,元大台灣價值高息,294,50,244,富邦-宜蘭,2024-07-30,9686
00919,群益台灣精選高息,176,56,120,富邦-宜蘭,2024-07-30,9686
00878,國泰永續高股息,138,29,109,富邦-宜蘭,2024-07-30,9686
00946,群益科技高息成長,95,4,91,富邦-宜蘭,2024-07-30,9686
1303,南亞,76,1,75,富邦-宜蘭,2024-07-30,9686
00637L,元大滬深300正2,65,0,65,富邦-宜蘭,2024-07-30,9686
2409,友達,54,0,54,富邦-宜蘭,2024-07-30,9686
0056,元大高股息,54,0,54,富邦-宜蘭,2024-07-30,9686
00753L,中信中國50正2,48,0,48,富邦-宜蘭,2024-07-30,9686
2303,聯電,67,23,44,富邦-宜蘭,2024-07-30,9686
2356,英業達,43,0,43,富邦-宜蘭,2024-07-30,9686
3019,亞光,53,10,43,富邦-宜蘭,2024-07-30,9686
00665L,富邦�琤肭磪囓�2,42,0,42,富邦-宜蘭,2024-07-30,9686
1815,富喬,50,13,37,富邦-宜蘭,2024-07-30,9686
1101,台泥,46,10,36,富邦-宜蘭,2024-07-30,9686
00934,中信成長高股息,36,0,36,富邦-宜蘭,2024-07-30,9686
2337,旺宏,60,25,35,富邦-宜蘭,2024-07-30,9686
4160,訊聯基因,35,1,34,富邦-宜蘭,2024-07-30,9686
00936,台新永續高息中小,34,0,34,富邦-宜蘭,2024-07-30,9686
2313,華通,35,2,33,富邦-宜蘭,2024-07-30,9686
6196,帆宣,33,0,33,富邦-宜蘭,2024-07-30,9686
00633L,富邦上証正2,32,0,32,富邦-宜蘭,2024-07-30,9686
00687B,國泰20年美債,52,21,31,富邦-宜蘭,2024-07-30,9686
2344,華邦電,33,2,31,富邦-宜蘭,2024-07-30,9686
3188,鑫龍騰,47,16,31,富邦-宜蘭,2024-07-30,9686
5512,力麒,35,9,26,富邦-宜蘭,2024-07-30,9686
00951,台新日本半導體,21,0,21,富邦-宜蘭,2024-07-30,9686
6228,全譜,25,5,20,富邦-宜蘭,2024-07-30,9686
6282,康舒,22,3,19,富邦-宜蘭,2024-07-30,9686
00939,統一台灣高息動能,18,0,18,富邦-宜蘭,2024-07-30,9686
5515,建國,19,1,18,富邦-宜蘭,2024-07-30,9686
2867,三商壽,18,0,18,富邦-宜蘭,2024-07-30,9686
1609,大亞,21,4,17,富邦-宜蘭,2024-07-30,9686
00715L,期街口布蘭特正2,17,0,17,富邦-宜蘭,2024-07-30,9686
2891,中信金,17,1,16,富邦-宜蘭,2024-07-30,9686
00909,國泰數位支付服務,15,0,15,富邦-宜蘭,2024-07-30,9686
5309,系統電,16,1,15,富邦-宜蘭,2024-07-30,9686
00652,富邦印度,15,0,15,富邦-宜蘭,2024-07-30,9686
6505,台塑化,15,0,15,富邦-宜蘭,2024-07-30,9686
2442,新美齊,16,2,14,富邦-宜蘭,2024-07-30,9686
2062,橋椿,15,1,14,富邦-宜蘭,2024-07-30,9686
4526,東台,16,3,13,富邦-宜蘭,2024-07-30,9686
2367,燿華,16,3,13,富邦-宜蘭,2024-07-30,9686
00650L,復華香港正2,13,0,13,富邦-宜蘭,2024-07-30,9686
00927,群益半導體收益,12,0,12,富邦-宜蘭,2024-07-30,9686
6239,力成,13,1,12,富邦-宜蘭,2024-07-30,9686
3030,德律,13,1,12,富邦-宜蘭,2024-07-30,9686
00937B,群益ESG投等債20,29,18,11,富邦-宜蘭,2024-07-30,9686
2201,裕隆,11,0,11,富邦-宜蘭,2024-07-30,9686
00929,復華台灣科技優息,130,13,117,富邦-宜蘭,2024-07-31,9686
6770,力積電,106,4,102,富邦-宜蘭,2024-07-31,9686
2515,中工,100,3,97,富邦-宜蘭,2024-07-31,9686
3481,群創,182,107,75,富邦-宜蘭,2024-07-31,9686
2062,橋椿,78,9,69,富邦-宜蘭,2024-07-31,9686
3047,訊舟,192,126,66,富邦-宜蘭,2024-07-31,9686
00919,群益台灣精選高息,98,52,46,富邦-宜蘭,2024-07-31,9686
3024,憶聲,69,25,44,富邦-宜蘭,2024-07-31,9686
00940,元大台灣價值高息,57,14,43,富邦-宜蘭,2024-07-31,9686
1540,喬福,46,3,43,富邦-宜蘭,2024-07-31,9686
2349,錸德,171,129,42,富邦-宜蘭,2024-07-31,9686
2374,佳能,42,2,40,富邦-宜蘭,2024-07-31,9686
2489,瑞軒,59,20,39,富邦-宜蘭,2024-07-31,9686
00918,大華優利高填息30,31,0,31,富邦-宜蘭,2024-07-31,9686
00882,中信中國高股息,30,0,30,富邦-宜蘭,2024-07-31,9686
8463,潤泰材,36,8,28,富邦-宜蘭,2024-07-31,9686
4526,東台,41,13,28,富邦-宜蘭,2024-07-31,9686
6239,力成,28,1,27,富邦-宜蘭,2024-07-31,9686
2405,輔信,36,12,24,富邦-宜蘭,2024-07-31,9686
6834,天二科技,22,1,21,富邦-宜蘭,2024-07-31,9686
6768,志強-KY,20,0,20,富邦-宜蘭,2024-07-31,9686
00650L,復華香港正2,20,0,20,富邦-宜蘭,2024-07-31,9686
2344,華邦電,29,10,19,富邦-宜蘭,2024-07-31,9686
00688L,國泰20年美債正2,20,1,19,富邦-宜蘭,2024-07-31,9686
3188,鑫龍騰,25,6,19,富邦-宜蘭,2024-07-31,9686
2889,國票金,20,2,18,富邦-宜蘭,2024-07-31,9686
2409,友達,36,18,18,富邦-宜蘭,2024-07-31,9686
00942B,台新美A公司債20+,18,0,18,富邦-宜蘭,2024-07-31,9686
1316,上曜,29,11,18,富邦-宜蘭,2024-07-31,9686
4967,十銓,25,8,17,富邦-宜蘭,2024-07-31,9686
2888,新光金,35,19,16,富邦-宜蘭,2024-07-31,9686
00720B,元大投資級公司債,16,0,16,富邦-宜蘭,2024-07-31,9686
00946,群益科技高息成長,24,8,16,富邦-宜蘭,2024-07-31,9686
2504,國產,16,2,14,富邦-宜蘭,2024-07-31,9686
00715L,期街口布蘭特正2,14,0,14,富邦-宜蘭,2024-07-31,9686
00687B,國泰20年美債,52,38,14,富邦-宜蘭,2024-07-31,9686
9933,中鼎,16,2,14,富邦-宜蘭,2024-07-31,9686
00949,復華日本龍頭,15,1,14,富邦-宜蘭,2024-07-31,9686
1815,富喬,48,35,13,富邦-宜蘭,2024-07-31,9686
2867,三商壽,13,0,13,富邦-宜蘭,2024-07-31,9686
2486,一詮,22,9,13,富邦-宜蘭,2024-07-31,9686
2882,國泰金,16,4,12,富邦-宜蘭,2024-07-31,9686
00937B,群益ESG投等債20,31,20,11,富邦-宜蘭,2024-07-31,9686
00885,富邦越南,15,4,11,富邦-宜蘭,2024-07-31,9686
2362,藍天,22,11,11,富邦-宜蘭,2024-07-31,9686
910861,神州-DR,11,0,11,富邦-宜蘭,2024-07-31,9686
6219,富旺,11,0,11,富邦-宜蘭,2024-07-31,9686
3673,TPK-KY,13,2,11,富邦-宜蘭,2024-07-31,9686
3376,新日興,20,9,11,富邦-宜蘭,2024-07-31,9686
2359,所羅門,20,10,10,富邦-宜蘭,2024-07-31,9686
00671R,富邦NASDAQ反1,136,0,136,富邦-宜蘭,2024-08-01,9686
2515,中工,210,93,117,富邦-宜蘭,2024-08-01,9686
2883,凱基金,120,18,102,富邦-宜蘭,2024-08-01,9686
00905,FT臺灣Smart,102,3,99,富邦-宜蘭,2024-08-01,9686
00881,國泰台灣5G+,92,0,92,富邦-宜蘭,2024-08-01,9686
2062,橋椿,112,23,89,富邦-宜蘭,2024-08-01,9686
0056,元大高股息,91,12,79,富邦-宜蘭,2024-08-01,9686
00929,復華台灣科技優息,103,26,77,富邦-宜蘭,2024-08-01,9686
00679B,元大美債20年,282,207,75,富邦-宜蘭,2024-08-01,9686
00878,國泰永續高股息,120,52,68,富邦-宜蘭,2024-08-01,9686
9904,寶成,65,4,61,富邦-宜蘭,2024-08-01,9686
00932,兆豐永續高息等權,55,0,55,富邦-宜蘭,2024-08-01,9686
1313,聯成,53,0,53,富邦-宜蘭,2024-08-01,9686
00937B,群益ESG投等債20,67,15,52,富邦-宜蘭,2024-08-01,9686
3522,御嵿,45,2,43,富邦-宜蘭,2024-08-01,9686
00712,復華富時不動產,49,9,40,富邦-宜蘭,2024-08-01,9686
6425,易發,41,1,40,富邦-宜蘭,2024-08-01,9686
6199,天品,40,0,40,富邦-宜蘭,2024-08-01,9686
3663,鑫科,105,74,31,富邦-宜蘭,2024-08-01,9686
8463,潤泰材,29,1,28,富邦-宜蘭,2024-08-01,9686
6603,富強鑫,33,6,27,富邦-宜蘭,2024-08-01,9686
2405,輔信,34,8,26,富邦-宜蘭,2024-08-01,9686
6257,矽格,42,17,25,富邦-宜蘭,2024-08-01,9686
2383,台光電,35,11,24,富邦-宜蘭,2024-08-01,9686
00640L,富邦日本正2,23,0,23,富邦-宜蘭,2024-08-01,9686
8096,擎亞,28,6,22,富邦-宜蘭,2024-08-01,9686
2409,友達,21,0,21,富邦-宜蘭,2024-08-01,9686
6275,元山,21,0,21,富邦-宜蘭,2024-08-01,9686
00915,凱基優選高股息30,21,0,21,富邦-宜蘭,2024-08-01,9686
2915,潤泰全,21,0,21,富邦-宜蘭,2024-08-01,9686
2882,國泰金,20,0,20,富邦-宜蘭,2024-08-01,9686
2887,台新金,20,1,19,富邦-宜蘭,2024-08-01,9686
4571,鈞興-KY,20,1,19,富邦-宜蘭,2024-08-01,9686
8936,國統,39,21,18,富邦-宜蘭,2024-08-01,9686
6125,廣運,39,21,18,富邦-宜蘭,2024-08-01,9686
2501,國建,45,28,17,富邦-宜蘭,2024-08-01,9686
8105,凌巨,22,5,17,富邦-宜蘭,2024-08-01,9686
6239,力成,17,0,17,富邦-宜蘭,2024-08-01,9686
3535,晶彩科,29,13,16,富邦-宜蘭,2024-08-01,9686
00795B,中信美國公債20年,22,6,16,富邦-宜蘭,2024-08-01,9686
4967,十銓,17,1,16,富邦-宜蘭,2024-08-01,9686
9105,泰金寶-DR,25,9,16,富邦-宜蘭,2024-08-01,9686
00664R,國泰臺灣加權反1,16,0,16,富邦-宜蘭,2024-08-01,9686
2884,玉山金,18,2,16,富邦-宜蘭,2024-08-01,9686
00951,台新日本半導體,19,3,16,富邦-宜蘭,2024-08-01,9686
1452,宏益,64,49,15,富邦-宜蘭,2024-08-01,9686
00948B,中信優息投資級債,25,10,15,富邦-宜蘭,2024-08-01,9686
2406,國碩,16,1,15,富邦-宜蘭,2024-08-01,9686
1402,遠東新,12,0,12,富邦-宜蘭,2024-08-01,9686
3024,憶聲,12,0,12,富邦-宜蘭,2024-08-01,9686
00679B,元大美債20年,468,16,452,富邦-宜蘭,2024-08-02,9686
2317,鴻海,346,32,314,富邦-宜蘭,2024-08-02,9686
00937B,群益ESG投等債20,316,20,296,富邦-宜蘭,2024-08-02,9686
00919,群益台灣精選高息,360,78,282,富邦-宜蘭,2024-08-02,9686
00929,復華台灣科技優息,277,16,261,富邦-宜蘭,2024-08-02,9686
00878,國泰永續高股息,261,6,255,富邦-宜蘭,2024-08-02,9686
00680L,元大美債20正2,229,7,222,富邦-宜蘭,2024-08-02,9686
2337,旺宏,167,15,152,富邦-宜蘭,2024-08-02,9686
6188,廣明,102,2,100,富邦-宜蘭,2024-08-02,9686
1303,南亞,103,3,100,富邦-宜蘭,2024-08-02,9686
6770,力積電,103,5,98,富邦-宜蘭,2024-08-02,9686
5512,力麒,138,52,86,富邦-宜蘭,2024-08-02,9686
2330,台積電,100,15,85,富邦-宜蘭,2024-08-02,9686
2543,皇昌,78,1,77,富邦-宜蘭,2024-08-02,9686
0056,元大高股息,78,2,76,富邦-宜蘭,2024-08-02,9686
00940,元大台灣價值高息,168,92,76,富邦-宜蘭,2024-08-02,9686
00900,富邦特選高股息30,74,0,74,富邦-宜蘭,2024-08-02,9686
00687B,國泰20年美債,100,31,69,富邦-宜蘭,2024-08-02,9686
00688L,國泰20年美債正2,63,5,58,富邦-宜蘭,2024-08-02,9686
00923,群益台ESG低碳50,55,0,55,富邦-宜蘭,2024-08-02,9686
4714,永捷,54,0,54,富邦-宜蘭,2024-08-02,9686
1440,南紡,57,5,52,富邦-宜蘭,2024-08-02,9686
00881,國泰台灣5G+,51,6,45,富邦-宜蘭,2024-08-02,9686
00951,台新日本半導體,44,0,44,富邦-宜蘭,2024-08-02,9686
00891,中信關鍵半導體,49,7,42,富邦-宜蘭,2024-08-02,9686
2408,南亞科,43,2,41,富邦-宜蘭,2024-08-02,9686
6199,天品,38,0,38,富邦-宜蘭,2024-08-02,9686
2014,中鴻,42,6,36,富邦-宜蘭,2024-08-02,9686
2301,光寶科,62,26,36,富邦-宜蘭,2024-08-02,9686
00885,富邦越南,40,5,35,富邦-宜蘭,2024-08-02,9686
00948B,中信優息投資級債,50,15,35,富邦-宜蘭,2024-08-02,9686
4545,銘鈺,34,0,34,富邦-宜蘭,2024-08-02,9686
1316,上曜,48,14,34,富邦-宜蘭,2024-08-02,9686
00753L,中信中國50正2,34,0,34,富邦-宜蘭,2024-08-02,9686
00712,復華富時不動產,39,7,32,富邦-宜蘭,2024-08-02,9686
00637L,元大滬深300正2,40,10,30,富邦-宜蘭,2024-08-02,9686
2888,新光金,75,45,30,富邦-宜蘭,2024-08-02,9686
2537,聯上發,33,4,29,富邦-宜蘭,2024-08-02,9686
2356,英業達,41,13,28,富邦-宜蘭,2024-08-02,9686
6196,帆宣,27,0,27,富邦-宜蘭,2024-08-02,9686
6546,正基,38,11,27,富邦-宜蘭,2024-08-02,9686
2027,大成鋼,27,1,26,富邦-宜蘭,2024-08-02,9686
00715L,期街口布蘭特正2,30,4,26,富邦-宜蘭,2024-08-02,9686
00934,中信成長高股息,64,38,26,富邦-宜蘭,2024-08-02,9686
2344,華邦電,59,33,26,富邦-宜蘭,2024-08-02,9686
2449,京元電子,30,4,26,富邦-宜蘭,2024-08-02,9686
3037,欣興,29,3,26,富邦-宜蘭,2024-08-02,9686
00936,台新永續高息中小,25,0,25,富邦-宜蘭,2024-08-02,9686
2884,玉山金,25,0,25,富邦-宜蘭,2024-08-02,9686
5876,上海商銀,24,0,24,富邦-宜蘭,2024-08-02,9686
00671R,富邦NASDAQ反1,988,1,987,富邦-宜蘭,2024-08-05,9686
00929,復華台灣科技優息,870,119,751,富邦-宜蘭,2024-08-05,9686
00688L,國泰20年美債正2,290,48,242,富邦-宜蘭,2024-08-05,9686
1314,中石化,255,27,228,富邦-宜蘭,2024-08-05,9686
1312,國喬,203,1,202,富邦-宜蘭,2024-08-05,9686
5880,合庫金,163,9,154,富邦-宜蘭,2024-08-05,9686
00878,國泰永續高股息,323,182,141,富邦-宜蘭,2024-08-05,9686
2409,友達,186,46,140,富邦-宜蘭,2024-08-05,9686
6877,鏵友益,196,77,119,富邦-宜蘭,2024-08-05,9686
2317,鴻海,191,74,117,富邦-宜蘭,2024-08-05,9686
00679B,元大美債20年,440,332,108,富邦-宜蘭,2024-08-05,9686
3481,群創,218,113,105,富邦-宜蘭,2024-08-05,9686
1304,台聚,118,16,102,富邦-宜蘭,2024-08-05,9686
1451,年興,100,0,100,富邦-宜蘭,2024-08-05,9686
2834,臺企銀,107,12,95,富邦-宜蘭,2024-08-05,9686
00715L,期街口布蘭特正2,98,3,95,富邦-宜蘭,2024-08-05,9686
1540,喬福,429,336,93,富邦-宜蘭,2024-08-05,9686
2324,仁寶,97,17,80,富邦-宜蘭,2024-08-05,9686
0050,元大台灣50,83,6,77,富邦-宜蘭,2024-08-05,9686
00712,復華富時不動產,77,7,70,富邦-宜蘭,2024-08-05,9686
00900,富邦特選高股息30,82,16,66,富邦-宜蘭,2024-08-05,9686
00919,群益台灣精選高息,305,242,63,富邦-宜蘭,2024-08-05,9686
00706L,期元大S＆P日圓正2,65,2,63,富邦-宜蘭,2024-08-05,9686
2337,旺宏,129,67,62,富邦-宜蘭,2024-08-05,9686
00885,富邦越南,125,64,61,富邦-宜蘭,2024-08-05,9686
2330,台積電,116,56,60,富邦-宜蘭,2024-08-05,9686
00931B,統一美債20年,79,22,57,富邦-宜蘭,2024-08-05,9686
00936,台新永續高息中小,60,5,55,富邦-宜蘭,2024-08-05,9686
00650L,復華香港正2,55,0,55,富邦-宜蘭,2024-08-05,9686
2887,台新金,61,7,54,富邦-宜蘭,2024-08-05,9686
3663,鑫科,69,17,52,富邦-宜蘭,2024-08-05,9686
00753L,中信中國50正2,58,13,45,富邦-宜蘭,2024-08-05,9686
6443,元晶,40,0,40,富邦-宜蘭,2024-08-05,9686
2344,華邦電,55,16,39,富邦-宜蘭,2024-08-05,9686
4933,友輝,37,0,37,富邦-宜蘭,2024-08-05,9686
1440,南紡,60,24,36,富邦-宜蘭,2024-08-05,9686
912000,晨訊科-DR,37,1,36,富邦-宜蘭,2024-08-05,9686
2031,新光鋼,34,0,34,富邦-宜蘭,2024-08-05,9686
2884,玉山金,39,8,31,富邦-宜蘭,2024-08-05,9686
3050,鈺德,32,1,31,富邦-宜蘭,2024-08-05,9686
5009,榮剛,30,0,30,富邦-宜蘭,2024-08-05,9686
2886,兆豐金,50,20,30,富邦-宜蘭,2024-08-05,9686
6901,鑽石投資,28,0,28,富邦-宜蘭,2024-08-05,9686
2070,精湛,39,12,27,富邦-宜蘭,2024-08-05,9686
2382,廣達,41,14,27,富邦-宜蘭,2024-08-05,9686
00713,元大台灣高息低波,28,1,27,富邦-宜蘭,2024-08-05,9686
8103,瀚荃,25,1,24,富邦-宜蘭,2024-08-05,9686
00631L,元大台灣50正2,42,19,23,富邦-宜蘭,2024-08-05,9686
00944,野村趨勢動能高息,23,0,23,富邦-宜蘭,2024-08-05,9686
4545,銘鈺,23,0,23,富邦-宜蘭,2024-08-05,9686
2888,新光金,880,34,846,富邦-宜蘭,2024-08-06,9686
00929,復華台灣科技優息,371,175,196,富邦-宜蘭,2024-08-06,9686
00679B,元大美債20年,244,61,183,富邦-宜蘭,2024-08-06,9686
0056,元大高股息,175,7,168,富邦-宜蘭,2024-08-06,9686
00942B,台新美A公司債20+,130,5,125,富邦-宜蘭,2024-08-06,9686
00940,元大台灣價值高息,204,82,122,富邦-宜蘭,2024-08-06,9686
2317,鴻海,256,140,116,富邦-宜蘭,2024-08-06,9686
00632R,元大台灣50反1,178,65,113,富邦-宜蘭,2024-08-06,9686
1304,台聚,105,2,103,富邦-宜蘭,2024-08-06,9686
6215,和椿,103,3,100,富邦-宜蘭,2024-08-06,9686
00885,富邦越南,96,2,94,富邦-宜蘭,2024-08-06,9686
00878,國泰永續高股息,127,37,90,富邦-宜蘭,2024-08-06,9686
00919,群益台灣精選高息,108,28,80,富邦-宜蘭,2024-08-06,9686
00937B,群益ESG投等債20,154,76,78,富邦-宜蘭,2024-08-06,9686
2409,友達,75,8,67,富邦-宜蘭,2024-08-06,9686
00946,群益科技高息成長,63,1,62,富邦-宜蘭,2024-08-06,9686
2615,萬海,74,22,52,富邦-宜蘭,2024-08-06,9686
2313,華通,58,7,51,富邦-宜蘭,2024-08-06,9686
3481,群創,157,109,48,富邦-宜蘭,2024-08-06,9686
00900,富邦特選高股息30,59,12,47,富邦-宜蘭,2024-08-06,9686
6239,力成,87,41,46,富邦-宜蘭,2024-08-06,9686
00665L,富邦�琤肭磪囓�2,40,0,40,富邦-宜蘭,2024-08-06,9686
2539,櫻花建,40,0,40,富邦-宜蘭,2024-08-06,9686
00637L,元大滬深300正2,51,12,39,富邦-宜蘭,2024-08-06,9686
2337,旺宏,134,96,38,富邦-宜蘭,2024-08-06,9686
00706L,期元大S＆P日圓正2,37,1,36,富邦-宜蘭,2024-08-06,9686
9105,泰金寶-DR,117,85,32,富邦-宜蘭,2024-08-06,9686
3050,鈺德,40,9,31,富邦-宜蘭,2024-08-06,9686
2913,農林,30,0,30,富邦-宜蘭,2024-08-06,9686
4174,浩鼎,34,4,30,富邦-宜蘭,2024-08-06,9686
2489,瑞軒,54,29,25,富邦-宜蘭,2024-08-06,9686
3714,富采,25,0,25,富邦-宜蘭,2024-08-06,9686
2062,橋椿,32,7,25,富邦-宜蘭,2024-08-06,9686
2887,台新金,31,8,23,富邦-宜蘭,2024-08-06,9686
00932,兆豐永續高息等權,22,0,22,富邦-宜蘭,2024-08-06,9686
3605,宏致,21,0,21,富邦-宜蘭,2024-08-06,9686
3037,欣興,43,23,20,富邦-宜蘭,2024-08-06,9686
3189,景碩,38,18,20,富邦-宜蘭,2024-08-06,9686
6180,橘子,20,0,20,富邦-宜蘭,2024-08-06,9686
1451,年興,20,0,20,富邦-宜蘭,2024-08-06,9686
2520,冠德,22,3,19,富邦-宜蘭,2024-08-06,9686
6753,龍德造船,29,10,19,富邦-宜蘭,2024-08-06,9686
00715L,期街口布蘭特正2,24,6,18,富邦-宜蘭,2024-08-06,9686
8071,能率網通,22,4,18,富邦-宜蘭,2024-08-06,9686
6770,力積電,42,24,18,富邦-宜蘭,2024-08-06,9686
6169,昱泉,18,0,18,富邦-宜蘭,2024-08-06,9686
6698,旭暉應材,20,2,18,富邦-宜蘭,2024-08-06,9686
5880,合庫金,19,2,17,富邦-宜蘭,2024-08-06,9686
2485,兆赫,17,0,17,富邦-宜蘭,2024-08-06,9686
4513,福裕,33,16,17,富邦-宜蘭,2024-08-06,9686
00680L,元大美債20正2,339,55,284,富邦-宜蘭,2024-08-07,9686
2883,凱基金,203,14,189,富邦-宜蘭,2024-08-07,9686
2888,新光金,164,9,155,富邦-宜蘭,2024-08-07,9686
2892,第一金,128,1,127,富邦-宜蘭,2024-08-07,9686
00929,復華台灣科技優息,200,98,102,富邦-宜蘭,2024-08-07,9686
00679B,元大美債20年,147,46,101,富邦-宜蘭,2024-08-07,9686
00885,富邦越南,101,6,95,富邦-宜蘭,2024-08-07,9686
2317,鴻海,145,50,95,富邦-宜蘭,2024-08-07,9686
00942B,台新美A公司債20+,90,0,90,富邦-宜蘭,2024-08-07,9686
1540,喬福,147,67,80,富邦-宜蘭,2024-08-07,9686
6877,鏵友益,183,109,74,富邦-宜蘭,2024-08-07,9686
2834,臺企銀,99,43,56,富邦-宜蘭,2024-08-07,9686
00878,國泰永續高股息,81,25,56,富邦-宜蘭,2024-08-07,9686
00900,富邦特選高股息30,86,35,51,富邦-宜蘭,2024-08-07,9686
6122,擎邦,68,18,50,富邦-宜蘭,2024-08-07,9686
3711,日月光投控,54,5,49,富邦-宜蘭,2024-08-07,9686
00946,群益科技高息成長,53,4,49,富邦-宜蘭,2024-08-07,9686
3481,群創,69,21,48,富邦-宜蘭,2024-08-07,9686
00715L,期街口布蘭特正2,50,3,47,富邦-宜蘭,2024-08-07,9686
2349,錸德,53,10,43,富邦-宜蘭,2024-08-07,9686
6133,金橋,42,0,42,富邦-宜蘭,2024-08-07,9686
1312,國喬,40,0,40,富邦-宜蘭,2024-08-07,9686
00753L,中信中國50正2,50,12,38,富邦-宜蘭,2024-08-07,9686
00795B,中信美國公債20年,32,0,32,富邦-宜蘭,2024-08-07,9686
00931B,統一美債20年,41,10,31,富邦-宜蘭,2024-08-07,9686
00650L,復華香港正2,30,0,30,富邦-宜蘭,2024-08-07,9686
2382,廣達,52,24,28,富邦-宜蘭,2024-08-07,9686
5880,合庫金,28,0,28,富邦-宜蘭,2024-08-07,9686
00637L,元大滬深300正2,28,0,28,富邦-宜蘭,2024-08-07,9686
00632R,元大台灣50反1,102,75,27,富邦-宜蘭,2024-08-07,9686
00706L,期元大S＆P日圓正2,40,13,27,富邦-宜蘭,2024-08-07,9686
00936,台新永續高息中小,27,0,27,富邦-宜蘭,2024-08-07,9686
2376,技嘉,44,18,26,富邦-宜蘭,2024-08-07,9686
00688L,國泰20年美債正2,73,47,26,富邦-宜蘭,2024-08-07,9686
2408,南亞科,40,15,25,富邦-宜蘭,2024-08-07,9686
00932,兆豐永續高息等權,27,2,25,富邦-宜蘭,2024-08-07,9686
910861,神州-DR,24,0,24,富邦-宜蘭,2024-08-07,9686
2312,金寶,45,23,22,富邦-宜蘭,2024-08-07,9686
00850,元大臺灣ESG永續,21,0,21,富邦-宜蘭,2024-08-07,9686
1785,光洋科,32,12,20,富邦-宜蘭,2024-08-07,9686
2845,遠東銀,20,0,20,富邦-宜蘭,2024-08-07,9686
2305,全友,20,0,20,富邦-宜蘭,2024-08-07,9686
2867,三商壽,22,2,20,富邦-宜蘭,2024-08-07,9686
2409,友達,20,0,20,富邦-宜蘭,2024-08-07,9686
3037,欣興,36,17,19,富邦-宜蘭,2024-08-07,9686
8076,伍豐,19,0,19,富邦-宜蘭,2024-08-07,9686
0056,元大高股息,40,23,17,富邦-宜蘭,2024-08-07,9686
3030,德律,19,2,17,富邦-宜蘭,2024-08-07,9686
2367,燿華,31,14,17,富邦-宜蘭,2024-08-07,9686
1314,中石化,20,3,17,富邦-宜蘭,2024-08-07,9686
00680L,元大美債20正2,160,14,146,富邦-宜蘭,2024-08-08,9686
00919,群益台灣精選高息,164,27,137,富邦-宜蘭,2024-08-08,9686
00937B,群益ESG投等債20,138,2,136,富邦-宜蘭,2024-08-08,9686
00671R,富邦NASDAQ反1,120,0,120,富邦-宜蘭,2024-08-08,9686
00878,國泰永續高股息,130,25,105,富邦-宜蘭,2024-08-08,9686
1714,和桐,105,0,105,富邦-宜蘭,2024-08-08,9686
00923,群益台ESG低碳50,105,5,100,富邦-宜蘭,2024-08-08,9686
00679B,元大美債20年,92,19,73,富邦-宜蘭,2024-08-08,9686
2356,英業達,70,5,65,富邦-宜蘭,2024-08-08,9686
6239,力成,67,4,63,富邦-宜蘭,2024-08-08,9686
2834,臺企銀,91,29,62,富邦-宜蘭,2024-08-08,9686
2317,鴻海,102,45,57,富邦-宜蘭,2024-08-08,9686
00929,復華台灣科技優息,188,132,56,富邦-宜蘭,2024-08-08,9686
00795B,中信美國公債20年,52,0,52,富邦-宜蘭,2024-08-08,9686
00933B,國泰10Y+金融債,51,0,51,富邦-宜蘭,2024-08-08,9686
00940,元大台灣價值高息,73,22,51,富邦-宜蘭,2024-08-08,9686
2886,兆豐金,67,24,43,富邦-宜蘭,2024-08-08,9686
2609,陽明,56,14,42,富邦-宜蘭,2024-08-08,9686
6206,飛捷,41,2,39,富邦-宜蘭,2024-08-08,9686
2014,中鴻,39,0,39,富邦-宜蘭,2024-08-08,9686
3047,訊舟,55,19,36,富邦-宜蘭,2024-08-08,9686
00642U,期元大S＆P石油,35,1,34,富邦-宜蘭,2024-08-08,9686
3481,群創,52,19,33,富邦-宜蘭,2024-08-08,9686
00881,國泰台灣5G+,35,2,33,富邦-宜蘭,2024-08-08,9686
6727,亞泰金屬,32,0,32,富邦-宜蘭,2024-08-08,9686
00712,復華富時不動產,32,0,32,富邦-宜蘭,2024-08-08,9686
2354,鴻準,32,3,29,富邦-宜蘭,2024-08-08,9686
6603,富強鑫,35,6,29,富邦-宜蘭,2024-08-08,9686
6282,康舒,30,2,28,富邦-宜蘭,2024-08-08,9686
00885,富邦越南,34,7,27,富邦-宜蘭,2024-08-08,9686
4510,高鋒,155,130,25,富邦-宜蘭,2024-08-08,9686
00632R,元大台灣50反1,57,32,25,富邦-宜蘭,2024-08-08,9686
2888,新光金,29,5,24,富邦-宜蘭,2024-08-08,9686
5880,合庫金,22,0,22,富邦-宜蘭,2024-08-08,9686
00931B,統一美債20年,22,0,22,富邦-宜蘭,2024-08-08,9686
2880,華南金,32,10,22,富邦-宜蘭,2024-08-08,9686
5531,鄉林,24,2,22,富邦-宜蘭,2024-08-08,9686
6505,台塑化,21,0,21,富邦-宜蘭,2024-08-08,9686
2344,華邦電,32,14,18,富邦-宜蘭,2024-08-08,9686
0056,元大高股息,24,6,18,富邦-宜蘭,2024-08-08,9686
910861,神州-DR,17,0,17,富邦-宜蘭,2024-08-08,9686
2382,廣達,22,5,17,富邦-宜蘭,2024-08-08,9686
4533,協易機,46,30,16,富邦-宜蘭,2024-08-08,9686
1326,台化,15,0,15,富邦-宜蘭,2024-08-08,9686
2405,輔信,40,25,15,富邦-宜蘭,2024-08-08,9686
2337,旺宏,57,43,14,富邦-宜蘭,2024-08-08,9686
1514,亞力,17,3,14,富邦-宜蘭,2024-08-08,9686
3024,憶聲,12,0,12,富邦-宜蘭,2024-08-08,9686
2329,華泰,12,0,12,富邦-宜蘭,2024-08-08,9686
6177,達麗,12,0,12,富邦-宜蘭,2024-08-08,9686
00937B,群益ESG投等債20,646,24,622,富邦-宜蘭,2024-08-09,9686
00688L,國泰20年美債正2,370,45,325,富邦-宜蘭,2024-08-09,9686
00905,FT臺灣Smart,299,0,299,富邦-宜蘭,2024-08-09,9686
00878,國泰永續高股息,224,19,205,富邦-宜蘭,2024-08-09,9686
2906,高林,200,0,200,富邦-宜蘭,2024-08-09,9686
2888,新光金,356,168,188,富邦-宜蘭,2024-08-09,9686
2337,旺宏,162,57,105,富邦-宜蘭,2024-08-09,9686
1531,高林股,100,0,100,富邦-宜蘭,2024-08-09,9686
00893,國泰智能電動車,91,0,91,富邦-宜蘭,2024-08-09,9686
00795B,中信美國公債20年,92,8,84,富邦-宜蘭,2024-08-09,9686
4934,太極,76,0,76,富邦-宜蘭,2024-08-09,9686
00929,復華台灣科技優息,137,73,64,富邦-宜蘭,2024-08-09,9686
00687B,國泰20年美債,97,36,61,富邦-宜蘭,2024-08-09,9686
2353,宏��,69,12,57,富邦-宜蘭,2024-08-09,9686
2834,臺企銀,102,50,52,富邦-宜蘭,2024-08-09,9686
00931B,統一美債20年,51,0,51,富邦-宜蘭,2024-08-09,9686
00680L,元大美債20正2,58,10,48,富邦-宜蘭,2024-08-09,9686
6770,力積電,55,10,45,富邦-宜蘭,2024-08-09,9686
2882,國泰金,94,51,43,富邦-宜蘭,2024-08-09,9686
00933B,國泰10Y+金融債,53,11,42,富邦-宜蘭,2024-08-09,9686
6152,百一,40,0,40,富邦-宜蘭,2024-08-09,9686
00948B,中信優息投資級債,36,1,35,富邦-宜蘭,2024-08-09,9686
00944,野村趨勢動能高息,33,3,30,富邦-宜蘭,2024-08-09,9686
6505,台塑化,30,0,30,富邦-宜蘭,2024-08-09,9686
2356,英業達,56,27,29,富邦-宜蘭,2024-08-09,9686
910861,神州-DR,29,0,29,富邦-宜蘭,2024-08-09,9686
00679B,元大美債20年,42,15,27,富邦-宜蘭,2024-08-09,9686
00900,富邦特選高股息30,33,6,27,富邦-宜蘭,2024-08-09,9686
4306,炎洲,26,1,25,富邦-宜蘭,2024-08-09,9686
00936,台新永續高息中小,28,3,25,富邦-宜蘭,2024-08-09,9686
00946,群益科技高息成長,31,8,23,富邦-宜蘭,2024-08-09,9686
2892,第一金,24,2,22,富邦-宜蘭,2024-08-09,9686
1711,永光,22,0,22,富邦-宜蘭,2024-08-09,9686
00676R,富邦臺灣加權反1,22,1,21,富邦-宜蘭,2024-08-09,9686
00942B,台新美A公司債20+,21,0,21,富邦-宜蘭,2024-08-09,9686
1312,國喬,22,1,21,富邦-宜蘭,2024-08-09,9686
1536,和大,25,5,20,富邦-宜蘭,2024-08-09,9686
00715L,期街口布蘭特正2,32,12,20,富邦-宜蘭,2024-08-09,9686
3163,波若威,31,11,20,富邦-宜蘭,2024-08-09,9686
00664R,國泰臺灣加權反1,20,0,20,富邦-宜蘭,2024-08-09,9686
00632R,元大台灣50反1,54,36,18,富邦-宜蘭,2024-08-09,9686
4534,慶騰,21,3,18,富邦-宜蘭,2024-08-09,9686
5347,世界,21,3,18,富邦-宜蘭,2024-08-09,9686
4510,高鋒,21,4,17,富邦-宜蘭,2024-08-09,9686
00751B,元大AAA至A公司債,18,1,17,富邦-宜蘭,2024-08-09,9686
6546,正基,33,17,16,富邦-宜蘭,2024-08-09,9686
2891,中信金,87,72,15,富邦-宜蘭,2024-08-09,9686
4532,瑞智,16,1,15,富邦-宜蘭,2024-08-09,9686
6432,今展科,14,0,14,富邦-宜蘭,2024-08-09,9686
8071,能率網通,30,16,14,富邦-宜蘭,2024-08-09,9686
00679B,元大美債20年,305,48,257,富邦-宜蘭,2024-08-12,9686
00878,國泰永續高股息,268,21,247,富邦-宜蘭,2024-08-12,9686
2888,新光金,257,109,148,富邦-宜蘭,2024-08-12,9686
6216,居易,101,1,100,富邦-宜蘭,2024-08-12,9686
00632R,元大台灣50反1,111,30,81,富邦-宜蘭,2024-08-12,9686
2312,金寶,113,36,77,富邦-宜蘭,2024-08-12,9686
00664R,國泰臺灣加權反1,63,0,63,富邦-宜蘭,2024-08-12,9686
00929,復華台灣科技優息,173,126,47,富邦-宜蘭,2024-08-12,9686
00687B,國泰20年美債,50,9,41,富邦-宜蘭,2024-08-12,9686
00933B,國泰10Y+金融債,40,0,40,富邦-宜蘭,2024-08-12,9686
00688L,國泰20年美債正2,46,11,35,富邦-宜蘭,2024-08-12,9686
3593,力銘,31,0,31,富邦-宜蘭,2024-08-12,9686
2543,皇昌,33,4,29,富邦-宜蘭,2024-08-12,9686
2356,英業達,61,35,26,富邦-宜蘭,2024-08-12,9686
2429,銘旺科,40,14,26,富邦-宜蘭,2024-08-12,9686
2374,佳能,34,8,26,富邦-宜蘭,2024-08-12,9686
1597,直得,50,24,26,富邦-宜蘭,2024-08-12,9686
4714,永捷,30,5,25,富邦-宜蘭,2024-08-12,9686
910861,神州-DR,25,0,25,富邦-宜蘭,2024-08-12,9686
00712,復華富時不動產,33,9,24,富邦-宜蘭,2024-08-12,9686
8358,金居,23,0,23,富邦-宜蘭,2024-08-12,9686
6613,朋億*,23,0,23,富邦-宜蘭,2024-08-12,9686
6609,瀧澤科,31,9,22,富邦-宜蘭,2024-08-12,9686
1608,華榮,25,4,21,富邦-宜蘭,2024-08-12,9686
00715L,期街口布蘭特正2,24,4,20,富邦-宜蘭,2024-08-12,9686
4513,福裕,25,5,20,富邦-宜蘭,2024-08-12,9686
3230,錦明,19,0,19,富邦-宜蘭,2024-08-12,9686
2891,中信金,19,1,18,富邦-宜蘭,2024-08-12,9686
2362,藍天,18,1,17,富邦-宜蘭,2024-08-12,9686
6754,匯僑設計,16,0,16,富邦-宜蘭,2024-08-12,9686
00650L,復華香港正2,15,0,15,富邦-宜蘭,2024-08-12,9686
2610,華航,22,7,15,富邦-宜蘭,2024-08-12,9686
2317,鴻海,91,77,14,富邦-宜蘭,2024-08-12,9686
00725B,國泰投資級公司債,13,0,13,富邦-宜蘭,2024-08-12,9686
6122,擎邦,18,5,13,富邦-宜蘭,2024-08-12,9686
2906,高林,12,0,12,富邦-宜蘭,2024-08-12,9686
2359,所羅門,93,81,12,富邦-宜蘭,2024-08-12,9686
4977,眾達-KY,11,0,11,富邦-宜蘭,2024-08-12,9686
1618,合機,23,12,11,富邦-宜蘭,2024-08-12,9686
00948B,中信優息投資級債,21,10,11,富邦-宜蘭,2024-08-12,9686
1532,勤美,11,0,11,富邦-宜蘭,2024-08-12,9686
4562,穎漢,75,65,10,富邦-宜蘭,2024-08-12,9686
2376,技嘉,18,8,10,富邦-宜蘭,2024-08-12,9686
00947,台新臺灣IC設計,10,0,10,富邦-宜蘭,2024-08-12,9686
3022,威強電,12,2,10,富邦-宜蘭,2024-08-12,9686
1611,中電,10,0,10,富邦-宜蘭,2024-08-12,9686
00934,中信成長高股息,10,0,10,富邦-宜蘭,2024-08-12,9686
6727,亞泰金屬,10,0,10,富邦-宜蘭,2024-08-12,9686
8011,台通,11,2,9,富邦-宜蘭,2024-08-12,9686
00936,台新永續高息中小,14,5,9,富邦-宜蘭,2024-08-12,9686
00688L,國泰20年美債正2,180,2,178,富邦-宜蘭,2024-08-13,9686
2883,凱基金,173,7,166,富邦-宜蘭,2024-08-13,9686
00937B,群益ESG投等債20,163,0,163,富邦-宜蘭,2024-08-13,9686
2880,華南金,205,48,157,富邦-宜蘭,2024-08-13,9686
2834,臺企銀,93,1,92,富邦-宜蘭,2024-08-13,9686
2609,陽明,193,120,73,富邦-宜蘭,2024-08-13,9686
00878,國泰永續高股息,83,12,71,富邦-宜蘭,2024-08-13,9686
6505,台塑化,56,0,56,富邦-宜蘭,2024-08-13,9686
1101,台泥,56,1,55,富邦-宜蘭,2024-08-13,9686
00632R,元大台灣50反1,40,0,40,富邦-宜蘭,2024-08-13,9686
00679B,元大美債20年,60,24,36,富邦-宜蘭,2024-08-13,9686
00680L,元大美債20正2,34,0,34,富邦-宜蘭,2024-08-13,9686
00642U,期元大S＆P石油,33,0,33,富邦-宜蘭,2024-08-13,9686
6838,台新藥,34,1,33,富邦-宜蘭,2024-08-13,9686
2312,金寶,35,2,33,富邦-宜蘭,2024-08-13,9686
6239,力成,30,1,29,富邦-宜蘭,2024-08-13,9686
2356,英業達,47,18,29,富邦-宜蘭,2024-08-13,9686
2208,台船,40,13,27,富邦-宜蘭,2024-08-13,9686
00929,復華台灣科技優息,70,45,25,富邦-宜蘭,2024-08-13,9686
1513,中興電,54,30,24,富邦-宜蘭,2024-08-13,9686
00907,永豐優息存股,23,0,23,富邦-宜蘭,2024-08-13,9686
8085,福華,23,1,22,富邦-宜蘭,2024-08-13,9686
2409,友達,22,0,22,富邦-宜蘭,2024-08-13,9686
3663,鑫科,61,41,20,富邦-宜蘭,2024-08-13,9686
6598,ABC-KY,20,0,20,富邦-宜蘭,2024-08-13,9686
6928,攸泰科技,20,0,20,富邦-宜蘭,2024-08-13,9686
2491,吉祥全,20,0,20,富邦-宜蘭,2024-08-13,9686
00687B,國泰20年美債,25,5,20,富邦-宜蘭,2024-08-13,9686
6265,方土昶,21,2,19,富邦-宜蘭,2024-08-13,9686
2615,萬海,62,44,18,富邦-宜蘭,2024-08-13,9686
00900,富邦特選高股息30,18,0,18,富邦-宜蘭,2024-08-13,9686
00881,國泰台灣5G+,31,14,17,富邦-宜蘭,2024-08-13,9686
1307,三芳,16,0,16,富邦-宜蘭,2024-08-13,9686
3013,晟銘電,54,40,14,富邦-宜蘭,2024-08-13,9686
3231,緯創,36,22,14,富邦-宜蘭,2024-08-13,9686
1301,台塑,18,4,14,富邦-宜蘭,2024-08-13,9686
3324,雙鴻,30,18,12,富邦-宜蘭,2024-08-13,9686
00637L,元大滬深300正2,32,20,12,富邦-宜蘭,2024-08-13,9686
6290,良維,12,0,12,富邦-宜蘭,2024-08-13,9686
00635U,期元大S＆P黃金,12,0,12,富邦-宜蘭,2024-08-13,9686
4540,全球傳動,48,36,12,富邦-宜蘭,2024-08-13,9686
00936,台新永續高息中小,12,0,12,富邦-宜蘭,2024-08-13,9686
6269,台郡,12,0,12,富邦-宜蘭,2024-08-13,9686
00712,復華富時不動產,11,0,11,富邦-宜蘭,2024-08-13,9686
2317,鴻海,71,60,11,富邦-宜蘭,2024-08-13,9686
00931B,統一美債20年,11,0,11,富邦-宜蘭,2024-08-13,9686
2399,映泰,11,0,11,富邦-宜蘭,2024-08-13,9686
2365,昆盈,53,42,11,富邦-宜蘭,2024-08-13,9686
2886,兆豐金,11,1,10,富邦-宜蘭,2024-08-13,9686
2313,華通,17,7,10,富邦-宜蘭,2024-08-13,9686
00664R,國泰臺灣加權反1,504,0,504,富邦-宜蘭,2024-08-14,9686
00632R,元大台灣50反1,204,0,204,富邦-宜蘭,2024-08-14,9686
2888,新光金,227,38,189,富邦-宜蘭,2024-08-14,9686
2801,彰銀,105,0,105,富邦-宜蘭,2024-08-14,9686
2393,億光,101,0,101,富邦-宜蘭,2024-08-14,9686
00900,富邦特選高股息30,124,24,100,富邦-宜蘭,2024-08-14,9686
00687B,國泰20年美債,100,0,100,富邦-宜蘭,2024-08-14,9686
00929,復華台灣科技優息,100,27,73,富邦-宜蘭,2024-08-14,9686
8043,蜜望實,92,30,62,富邦-宜蘭,2024-08-14,9686
00940,元大台灣價值高息,67,17,50,富邦-宜蘭,2024-08-14,9686
00937B,群益ESG投等債20,89,40,49,富邦-宜蘭,2024-08-14,9686
00878,國泰永續高股息,62,14,48,富邦-宜蘭,2024-08-14,9686
2504,國產,50,2,48,富邦-宜蘭,2024-08-14,9686
2489,瑞軒,51,16,35,富邦-宜蘭,2024-08-14,9686
00680L,元大美債20正2,49,14,35,富邦-宜蘭,2024-08-14,9686
00679B,元大美債20年,45,12,33,富邦-宜蘭,2024-08-14,9686
00665L,富邦�琤肭磪囓�2,28,2,26,富邦-宜蘭,2024-08-14,9686
2405,輔信,35,10,25,富邦-宜蘭,2024-08-14,9686
910861,神州-DR,25,0,25,富邦-宜蘭,2024-08-14,9686
4958,臻鼎-KY,29,5,24,富邦-宜蘭,2024-08-14,9686
9105,泰金寶-DR,23,0,23,富邦-宜蘭,2024-08-14,9686
2002,中鋼,33,11,22,富邦-宜蘭,2024-08-14,9686
00948B,中信優息投資級債,22,0,22,富邦-宜蘭,2024-08-14,9686
8071,能率網通,103,81,22,富邦-宜蘭,2024-08-14,9686
00933B,國泰10Y+金融債,23,2,21,富邦-宜蘭,2024-08-14,9686
6754,匯僑設計,21,0,21,富邦-宜蘭,2024-08-14,9686
00696B,富邦美債20年,19,0,19,富邦-宜蘭,2024-08-14,9686
1452,宏益,80,61,19,富邦-宜蘭,2024-08-14,9686
2880,華南金,21,2,19,富邦-宜蘭,2024-08-14,9686
00881,國泰台灣5G+,24,6,18,富邦-宜蘭,2024-08-14,9686
5443,均豪,40,22,18,富邦-宜蘭,2024-08-14,9686
9958,世紀鋼,24,7,17,富邦-宜蘭,2024-08-14,9686
8089,康全電訊,16,0,16,富邦-宜蘭,2024-08-14,9686
00753L,中信中國50正2,16,0,16,富邦-宜蘭,2024-08-14,9686
2464,盟立,20,4,16,富邦-宜蘭,2024-08-14,9686
1101,台泥,23,8,15,富邦-宜蘭,2024-08-14,9686
00725B,國泰投資級公司債,15,0,15,富邦-宜蘭,2024-08-14,9686
4533,協易機,22,8,14,富邦-宜蘭,2024-08-14,9686
4513,福裕,35,22,13,富邦-宜蘭,2024-08-14,9686
3202,樺晟,13,0,13,富邦-宜蘭,2024-08-14,9686
8076,伍豐,19,6,13,富邦-宜蘭,2024-08-14,9686
00751B,元大AAA至A公司債,13,0,13,富邦-宜蘭,2024-08-14,9686
2014,中鴻,104,92,12,富邦-宜蘭,2024-08-14,9686
2356,英業達,115,103,12,富邦-宜蘭,2024-08-14,9686
2367,燿華,22,10,12,富邦-宜蘭,2024-08-14,9686
6122,擎邦,11,0,11,富邦-宜蘭,2024-08-14,9686
1471,首利,13,2,11,富邦-宜蘭,2024-08-14,9686
6603,富強鑫,14,3,11,富邦-宜蘭,2024-08-14,9686
2834,臺企銀,17,7,10,富邦-宜蘭,2024-08-14,9686
00931B,統一美債20年,20,10,10,富邦-宜蘭,2024-08-14,9686
00878,國泰永續高股息,180,10,170,富邦-宜蘭,2024-08-15,9686
00900,富邦特選高股息30,203,34,169,富邦-宜蘭,2024-08-15,9686
00679B,元大美債20年,150,14,136,富邦-宜蘭,2024-08-15,9686
00688L,國泰20年美債正2,123,3,120,富邦-宜蘭,2024-08-15,9686
00687B,國泰20年美債,160,56,104,富邦-宜蘭,2024-08-15,9686
00937B,群益ESG投等債20,79,23,56,富邦-宜蘭,2024-08-15,9686
00881,國泰台灣5G+,48,4,44,富邦-宜蘭,2024-08-15,9686
2883,凱基金,40,1,39,富邦-宜蘭,2024-08-15,9686
00795B,中信美國公債20年,37,0,37,富邦-宜蘭,2024-08-15,9686
2002,中鋼,36,3,33,富邦-宜蘭,2024-08-15,9686
1101,台泥,33,2,31,富邦-宜蘭,2024-08-15,9686
00946,群益科技高息成長,30,1,29,富邦-宜蘭,2024-08-15,9686
6505,台塑化,26,0,26,富邦-宜蘭,2024-08-15,9686
2891,中信金,28,3,25,富邦-宜蘭,2024-08-15,9686
5364,力麗店,31,7,24,富邦-宜蘭,2024-08-15,9686
00680L,元大美債20正2,27,3,24,富邦-宜蘭,2024-08-15,9686
00725B,國泰投資級公司債,22,0,22,富邦-宜蘭,2024-08-15,9686
910861,神州-DR,19,0,19,富邦-宜蘭,2024-08-15,9686
2610,華航,21,3,18,富邦-宜蘭,2024-08-15,9686
8121,越峰,20,2,18,富邦-宜蘭,2024-08-15,9686
3703,欣陸,17,0,17,富邦-宜蘭,2024-08-15,9686
5014,建錩,20,3,17,富邦-宜蘭,2024-08-15,9686
00931B,統一美債20年,16,0,16,富邦-宜蘭,2024-08-15,9686
3230,錦明,25,9,16,富邦-宜蘭,2024-08-15,9686
1217,愛之味,16,0,16,富邦-宜蘭,2024-08-15,9686
00715L,期街口布蘭特正2,18,2,16,富邦-宜蘭,2024-08-15,9686
2317,鴻海,55,39,16,富邦-宜蘭,2024-08-15,9686
1301,台塑,16,0,16,富邦-宜蘭,2024-08-15,9686
00632R,元大台灣50反1,26,11,15,富邦-宜蘭,2024-08-15,9686
6532,瑞耘,16,1,15,富邦-宜蘭,2024-08-15,9686
8064,東捷,30,16,14,富邦-宜蘭,2024-08-15,9686
8076,伍豐,14,0,14,富邦-宜蘭,2024-08-15,9686
6546,正基,43,29,14,富邦-宜蘭,2024-08-15,9686
1536,和大,17,3,14,富邦-宜蘭,2024-08-15,9686
00939,統一台灣高息動能,13,0,13,富邦-宜蘭,2024-08-15,9686
6152,百一,13,0,13,富邦-宜蘭,2024-08-15,9686
2312,金寶,29,16,13,富邦-宜蘭,2024-08-15,9686
00918,大華優利高填息30,13,0,13,富邦-宜蘭,2024-08-15,9686
6877,鏵友益,14,1,13,富邦-宜蘭,2024-08-15,9686
2834,臺企銀,16,3,13,富邦-宜蘭,2024-08-15,9686
4540,全球傳動,65,53,12,富邦-宜蘭,2024-08-15,9686
3535,晶彩科,16,4,12,富邦-宜蘭,2024-08-15,9686
00642U,期元大S＆P石油,12,0,12,富邦-宜蘭,2024-08-15,9686
3062,建漢,25,13,12,富邦-宜蘭,2024-08-15,9686
2882,國泰金,12,1,11,富邦-宜蘭,2024-08-15,9686
2376,技嘉,23,12,11,富邦-宜蘭,2024-08-15,9686
2892,第一金,11,0,11,富邦-宜蘭,2024-08-15,9686
8011,台通,13,2,11,富邦-宜蘭,2024-08-15,9686
2371,大同,11,0,11,富邦-宜蘭,2024-08-15,9686
1319,東陽,12,1,11,富邦-宜蘭,2024-08-15,9686
00687B,國泰20年美債,321,12,309,富邦-宜蘭,2024-08-16,9686
1314,中石化,268,0,268,富邦-宜蘭,2024-08-16,9686
2062,橋椿,242,80,162,富邦-宜蘭,2024-08-16,9686
00878,國泰永續高股息,153,7,146,富邦-宜蘭,2024-08-16,9686
00632R,元大台灣50反1,102,0,102,富邦-宜蘭,2024-08-16,9686
6877,鏵友益,90,15,75,富邦-宜蘭,2024-08-16,9686
6505,台塑化,74,0,74,富邦-宜蘭,2024-08-16,9686
00688L,國泰20年美債正2,75,15,60,富邦-宜蘭,2024-08-16,9686
00795B,中信美國公債20年,56,0,56,富邦-宜蘭,2024-08-16,9686
00932,兆豐永續高息等權,53,0,53,富邦-宜蘭,2024-08-16,9686
00907,永豐優息存股,50,0,50,富邦-宜蘭,2024-08-16,9686
6133,金橋,49,1,48,富邦-宜蘭,2024-08-16,9686
00929,復華台灣科技優息,125,78,47,富邦-宜蘭,2024-08-16,9686
2002,中鋼,146,100,46,富邦-宜蘭,2024-08-16,9686
00933B,國泰10Y+金融債,44,2,42,富邦-宜蘭,2024-08-16,9686
2323,中環,84,43,41,富邦-宜蘭,2024-08-16,9686
00931B,統一美債20年,34,0,34,富邦-宜蘭,2024-08-16,9686
00881,國泰台灣5G+,38,5,33,富邦-宜蘭,2024-08-16,9686
2489,瑞軒,115,83,32,富邦-宜蘭,2024-08-16,9686
1303,南亞,60,31,29,富邦-宜蘭,2024-08-16,9686
00857B,永豐20年美公債,26,0,26,富邦-宜蘭,2024-08-16,9686
1101,台泥,23,0,23,富邦-宜蘭,2024-08-16,9686
00945B,凱基美國非投等債,23,0,23,富邦-宜蘭,2024-08-16,9686
00919,群益台灣精選高息,39,16,23,富邦-宜蘭,2024-08-16,9686
00951,台新日本半導體,25,3,22,富邦-宜蘭,2024-08-16,9686
2897,王道銀行,22,0,22,富邦-宜蘭,2024-08-16,9686
3231,緯創,28,6,22,富邦-宜蘭,2024-08-16,9686
00671R,富邦NASDAQ反1,21,0,21,富邦-宜蘭,2024-08-16,9686
6206,飛捷,20,0,20,富邦-宜蘭,2024-08-16,9686
00673R,期元大S＆P原油反1,20,0,20,富邦-宜蘭,2024-08-16,9686
4533,協易機,43,23,20,富邦-宜蘭,2024-08-16,9686
4562,穎漢,60,41,19,富邦-宜蘭,2024-08-16,9686
4561,健椿,24,6,18,富邦-宜蘭,2024-08-16,9686
2850,新產,20,2,18,富邦-宜蘭,2024-08-16,9686
8076,伍豐,18,0,18,富邦-宜蘭,2024-08-16,9686
6443,元晶,21,3,18,富邦-宜蘭,2024-08-16,9686
2353,宏��,24,7,17,富邦-宜蘭,2024-08-16,9686
910861,神州-DR,17,0,17,富邦-宜蘭,2024-08-16,9686
4934,太極,30,13,17,富邦-宜蘭,2024-08-16,9686
4540,全球傳動,22,5,17,富邦-宜蘭,2024-08-16,9686
2365,昆盈,40,24,16,富邦-宜蘭,2024-08-16,9686
8071,能率網通,32,16,16,富邦-宜蘭,2024-08-16,9686
6613,朋億*,16,0,16,富邦-宜蘭,2024-08-16,9686
1513,中興電,36,21,15,富邦-宜蘭,2024-08-16,9686
4956,光鋐,18,4,14,富邦-宜蘭,2024-08-16,9686
1321,大洋,14,0,14,富邦-宜蘭,2024-08-16,9686
5324,士開,13,0,13,富邦-宜蘭,2024-08-16,9686
8096,擎亞,56,44,12,富邦-宜蘭,2024-08-16,9686
9105,泰金寶-DR,12,0,12,富邦-宜蘭,2024-08-16,9686
3167,大量,14,2,12,富邦-宜蘭,2024-08-16,9686
00687B,國泰20年美債,565,8,557,富邦-宜蘭,2024-08-19,9686
2888,新光金,376,60,316,富邦-宜蘭,2024-08-19,9686
2062,橋椿,326,59,267,富邦-宜蘭,2024-08-19,9686
00929,復華台灣科技優息,105,6,99,富邦-宜蘭,2024-08-19,9686
00885,富邦越南,102,4,98,富邦-宜蘭,2024-08-19,9686
00688L,國泰20年美債正2,92,5,87,富邦-宜蘭,2024-08-19,9686
3047,訊舟,187,123,64,富邦-宜蘭,2024-08-19,9686
00713,元大台灣高息低波,56,0,56,富邦-宜蘭,2024-08-19,9686
00795B,中信美國公債20年,56,0,56,富邦-宜蘭,2024-08-19,9686
2317,鴻海,79,29,50,富邦-宜蘭,2024-08-19,9686
00931B,統一美債20年,59,10,49,富邦-宜蘭,2024-08-19,9686
2617,台航,40,0,40,富邦-宜蘭,2024-08-19,9686
00940,元大台灣價值高息,68,31,37,富邦-宜蘭,2024-08-19,9686
00919,群益台灣精選高息,58,22,36,富邦-宜蘭,2024-08-19,9686
2354,鴻準,39,7,32,富邦-宜蘭,2024-08-19,9686
8021,尖點,31,2,29,富邦-宜蘭,2024-08-19,9686
2359,所羅門,102,74,28,富邦-宜蘭,2024-08-19,9686
9904,寶成,28,0,28,富邦-宜蘭,2024-08-19,9686
2506,太設,30,3,27,富邦-宜蘭,2024-08-19,9686
1316,上曜,34,7,27,富邦-宜蘭,2024-08-19,9686
6546,正基,27,1,26,富邦-宜蘭,2024-08-19,9686
00857B,永豐20年美公債,26,0,26,富邦-宜蘭,2024-08-19,9686
8043,蜜望實,36,10,26,富邦-宜蘭,2024-08-19,9686
6789,采鈺,26,0,26,富邦-宜蘭,2024-08-19,9686
2362,藍天,31,7,24,富邦-宜蘭,2024-08-19,9686
00680L,元大美債20正2,23,0,23,富邦-宜蘭,2024-08-19,9686
5371,中光電,32,9,23,富邦-宜蘭,2024-08-19,9686
00715L,期街口布蘭特正2,24,2,22,富邦-宜蘭,2024-08-19,9686
3231,緯創,25,3,22,富邦-宜蘭,2024-08-19,9686
2002,中鋼,32,11,21,富邦-宜蘭,2024-08-19,9686
6505,台塑化,22,1,21,富邦-宜蘭,2024-08-19,9686
6116,彩晶,20,0,20,富邦-宜蘭,2024-08-19,9686
00933B,國泰10Y+金融債,34,15,19,富邦-宜蘭,2024-08-19,9686
4513,福裕,21,2,19,富邦-宜蘭,2024-08-19,9686
9933,中鼎,19,1,18,富邦-宜蘭,2024-08-19,9686
3518,柏騰,100,82,18,富邦-宜蘭,2024-08-19,9686
8028,昇陽半導體,102,85,17,富邦-宜蘭,2024-08-19,9686
00712,復華富時不動產,16,0,16,富邦-宜蘭,2024-08-19,9686
3374,精材,40,26,14,富邦-宜蘭,2024-08-19,9686
2609,陽明,24,10,14,富邦-宜蘭,2024-08-19,9686
3703,欣陸,20,6,14,富邦-宜蘭,2024-08-19,9686
8096,擎亞,39,25,14,富邦-宜蘭,2024-08-19,9686
2313,華通,15,1,14,富邦-宜蘭,2024-08-19,9686
3013,晟銘電,78,64,14,富邦-宜蘭,2024-08-19,9686
00696B,富邦美債20年,13,0,13,富邦-宜蘭,2024-08-19,9686
6213,聯茂,23,10,13,富邦-宜蘭,2024-08-19,9686
5450,南良,13,0,13,富邦-宜蘭,2024-08-19,9686
4906,正文,18,6,12,富邦-宜蘭,2024-08-19,9686
4956,光鋐,16,4,12,富邦-宜蘭,2024-08-19,9686
1785,光洋科,19,7,12,富邦-宜蘭,2024-08-19,9686
00687B,國泰20年美債,123,11,112,富邦-宜蘭,2024-08-20,9686
2834,臺企銀,111,0,111,富邦-宜蘭,2024-08-20,9686
00929,復華台灣科技優息,114,30,84,富邦-宜蘭,2024-08-20,9686
00679B,元大美債20年,86,3,83,富邦-宜蘭,2024-08-20,9686
00715L,期街口布蘭特正2,74,0,74,富邦-宜蘭,2024-08-20,9686
2323,中環,56,15,41,富邦-宜蘭,2024-08-20,9686
2867,三商壽,46,5,41,富邦-宜蘭,2024-08-20,9686
00795B,中信美國公債20年,41,0,41,富邦-宜蘭,2024-08-20,9686
00878,國泰永續高股息,46,10,36,富邦-宜蘭,2024-08-20,9686
00937B,群益ESG投等債20,34,1,33,富邦-宜蘭,2024-08-20,9686
1326,台化,36,4,32,富邦-宜蘭,2024-08-20,9686
3518,柏騰,32,3,29,富邦-宜蘭,2024-08-20,9686
6958,日盛台駿,30,2,28,富邦-宜蘭,2024-08-20,9686
00931B,統一美債20年,28,0,28,富邦-宜蘭,2024-08-20,9686
00751B,元大AAA至A公司債,30,2,28,富邦-宜蘭,2024-08-20,9686
6122,擎邦,26,0,26,富邦-宜蘭,2024-08-20,9686
6667,信紘科,28,3,25,富邦-宜蘭,2024-08-20,9686
5443,均豪,98,74,24,富邦-宜蘭,2024-08-20,9686
6757,台灣虎航,24,0,24,富邦-宜蘭,2024-08-20,9686
2356,英業達,69,45,24,富邦-宜蘭,2024-08-20,9686
00919,群益台灣精選高息,28,5,23,富邦-宜蘭,2024-08-20,9686
6505,台塑化,23,0,23,富邦-宜蘭,2024-08-20,9686
00857B,永豐20年美公債,25,2,23,富邦-宜蘭,2024-08-20,9686
2542,興富發,32,10,22,富邦-宜蘭,2024-08-20,9686
2002,中鋼,26,4,22,富邦-宜蘭,2024-08-20,9686
1101,台泥,22,0,22,富邦-宜蘭,2024-08-20,9686
00632R,元大台灣50反1,22,0,22,富邦-宜蘭,2024-08-20,9686
3712,永崴投控,32,10,22,富邦-宜蘭,2024-08-20,9686
2537,聯上發,23,1,22,富邦-宜蘭,2024-08-20,9686
00936,台新永續高息中小,21,0,21,富邦-宜蘭,2024-08-20,9686
1217,愛之味,21,0,21,富邦-宜蘭,2024-08-20,9686
2882,國泰金,36,16,20,富邦-宜蘭,2024-08-20,9686
00671R,富邦NASDAQ反1,20,1,19,富邦-宜蘭,2024-08-20,9686
2374,佳能,56,39,17,富邦-宜蘭,2024-08-20,9686
5519,隆大,16,0,16,富邦-宜蘭,2024-08-20,9686
4513,福裕,16,0,16,富邦-宜蘭,2024-08-20,9686
2401,凌陽,30,15,15,富邦-宜蘭,2024-08-20,9686
8440,綠電,25,10,15,富邦-宜蘭,2024-08-20,9686
00923,群益台ESG低碳50,14,0,14,富邦-宜蘭,2024-08-20,9686
8059,凱碩,14,0,14,富邦-宜蘭,2024-08-20,9686
2881,富邦金,37,24,13,富邦-宜蘭,2024-08-20,9686
00933B,國泰10Y+金融債,13,0,13,富邦-宜蘭,2024-08-20,9686
5484,慧友,15,3,12,富邦-宜蘭,2024-08-20,9686
3056,富華新,12,0,12,富邦-宜蘭,2024-08-20,9686
3580,友威科,49,37,12,富邦-宜蘭,2024-08-20,9686
2520,冠德,11,0,11,富邦-宜蘭,2024-08-20,9686
2405,輔信,16,5,11,富邦-宜蘭,2024-08-20,9686
2367,燿華,12,1,11,富邦-宜蘭,2024-08-20,9686
9904,寶成,11,0,11,富邦-宜蘭,2024-08-20,9686
5371,中光電,13,2,11,富邦-宜蘭,2024-08-20,9686
2888,新光金,719,389,330,富邦-宜蘭,2024-08-21,9686
2891,中信金,251,9,242,富邦-宜蘭,2024-08-21,9686
2349,錸德,229,65,164,富邦-宜蘭,2024-08-21,9686
00687B,國泰20年美債,149,7,142,富邦-宜蘭,2024-08-21,9686
2356,英業達,148,48,100,富邦-宜蘭,2024-08-21,9686
00919,群益台灣精選高息,96,18,78,富邦-宜蘭,2024-08-21,9686
00937B,群益ESG投等債20,85,17,68,富邦-宜蘭,2024-08-21,9686
2883,凱基金,72,4,68,富邦-宜蘭,2024-08-21,9686
8440,綠電,52,4,48,富邦-宜蘭,2024-08-21,9686
00940,元大台灣價值高息,53,12,41,富邦-宜蘭,2024-08-21,9686
5905,南仁湖,146,107,39,富邦-宜蘭,2024-08-21,9686
2834,臺企銀,92,54,38,富邦-宜蘭,2024-08-21,9686
8121,越峰,35,0,35,富邦-宜蘭,2024-08-21,9686
3580,友威科,91,56,35,富邦-宜蘭,2024-08-21,9686
00665L,富邦�琤肭磪囓�2,35,0,35,富邦-宜蘭,2024-08-21,9686
00929,復華台灣科技優息,107,75,32,富邦-宜蘭,2024-08-21,9686
8043,蜜望實,101,70,31,富邦-宜蘭,2024-08-21,9686
1540,喬福,31,1,30,富邦-宜蘭,2024-08-21,9686
2233,宇隆,30,1,29,富邦-宜蘭,2024-08-21,9686
2845,遠東銀,28,0,28,富邦-宜蘭,2024-08-21,9686
00688L,國泰20年美債正2,60,35,25,富邦-宜蘭,2024-08-21,9686
3645,達邁,41,18,23,富邦-宜蘭,2024-08-21,9686
1536,和大,25,3,22,富邦-宜蘭,2024-08-21,9686
2905,三商,22,0,22,富邦-宜蘭,2024-08-21,9686
1455,集盛,20,0,20,富邦-宜蘭,2024-08-21,9686
2516,新建,20,0,20,富邦-宜蘭,2024-08-21,9686
2610,華航,60,40,20,富邦-宜蘭,2024-08-21,9686
00946,群益科技高息成長,20,0,20,富邦-宜蘭,2024-08-21,9686
00907,永豐優息存股,19,0,19,富邦-宜蘭,2024-08-21,9686
3019,亞光,51,32,19,富邦-宜蘭,2024-08-21,9686
2537,聯上發,19,1,18,富邦-宜蘭,2024-08-21,9686
6213,聯茂,19,1,18,富邦-宜蘭,2024-08-21,9686
1326,台化,22,5,17,富邦-宜蘭,2024-08-21,9686
00918,大華優利高填息30,19,2,17,富邦-宜蘭,2024-08-21,9686
9945,潤泰新,22,7,15,富邦-宜蘭,2024-08-21,9686
2025,千興,16,1,15,富邦-宜蘭,2024-08-21,9686
1737,臺鹽,15,0,15,富邦-宜蘭,2024-08-21,9686
6120,達運,15,0,15,富邦-宜蘭,2024-08-21,9686
2371,大同,21,7,14,富邦-宜蘭,2024-08-21,9686
2323,中環,29,15,14,富邦-宜蘭,2024-08-21,9686
5347,世界,13,0,13,富邦-宜蘭,2024-08-21,9686
00881,國泰台灣5G+,13,0,13,富邦-宜蘭,2024-08-21,9686
00945B,凱基美國非投等債,13,0,13,富邦-宜蘭,2024-08-21,9686
00715L,期街口布蘭特正2,13,0,13,富邦-宜蘭,2024-08-21,9686
8054,安國,22,9,13,富邦-宜蘭,2024-08-21,9686
1319,東陽,13,0,13,富邦-宜蘭,2024-08-21,9686
6207,雷科,19,7,12,富邦-宜蘭,2024-08-21,9686
8421,旭源,19,7,12,富邦-宜蘭,2024-08-21,9686
6869,雲豹能源,28,16,12,富邦-宜蘭,2024-08-21,9686
00923,群益台ESG低碳50,11,0,11,富邦-宜蘭,2024-08-21,9686
2891,中信金,138,9,129,富邦-宜蘭,2024-08-22,9686
00715L,期街口布蘭特正2,102,0,102,富邦-宜蘭,2024-08-22,9686
00929,復華台灣科技優息,88,40,48,富邦-宜蘭,2024-08-22,9686
2349,錸德,498,457,41,富邦-宜蘭,2024-08-22,9686
00878,國泰永續高股息,53,12,41,富邦-宜蘭,2024-08-22,9686
2913,農林,40,0,40,富邦-宜蘭,2024-08-22,9686
2002,中鋼,40,3,37,富邦-宜蘭,2024-08-22,9686
6257,矽格,38,1,37,富邦-宜蘭,2024-08-22,9686
2867,三商壽,36,0,36,富邦-宜蘭,2024-08-22,9686
3518,柏騰,69,33,36,富邦-宜蘭,2024-08-22,9686
2890,永豐金,37,2,35,富邦-宜蘭,2024-08-22,9686
00907,永豐優息存股,37,10,27,富邦-宜蘭,2024-08-22,9686
8409,商之器,22,1,21,富邦-宜蘭,2024-08-22,9686
9955,佳龍,21,1,20,富邦-宜蘭,2024-08-22,9686
6443,元晶,19,0,19,富邦-宜蘭,2024-08-22,9686
1446,宏和,18,0,18,富邦-宜蘭,2024-08-22,9686
2885,元大金,20,2,18,富邦-宜蘭,2024-08-22,9686
8096,擎亞,89,72,17,富邦-宜蘭,2024-08-22,9686
6733,博晟生醫,17,0,17,富邦-宜蘭,2024-08-22,9686
3047,訊舟,142,125,17,富邦-宜蘭,2024-08-22,9686
00882,中信中國高股息,16,0,16,富邦-宜蘭,2024-08-22,9686
3062,建漢,22,7,15,富邦-宜蘭,2024-08-22,9686
3202,樺晟,14,0,14,富邦-宜蘭,2024-08-22,9686
2834,臺企銀,14,0,14,富邦-宜蘭,2024-08-22,9686
5443,均豪,56,43,13,富邦-宜蘭,2024-08-22,9686
8033,雷虎,13,1,12,富邦-宜蘭,2024-08-22,9686
5905,南仁湖,43,31,12,富邦-宜蘭,2024-08-22,9686
2392,正崴,14,2,12,富邦-宜蘭,2024-08-22,9686
00919,群益台灣精選高息,19,7,12,富邦-宜蘭,2024-08-22,9686
2881,富邦金,20,9,11,富邦-宜蘭,2024-08-22,9686
00937B,群益ESG投等債20,19,8,11,富邦-宜蘭,2024-08-22,9686
1809,中釉,11,0,11,富邦-宜蘭,2024-08-22,9686
9934,成霖,11,0,11,富邦-宜蘭,2024-08-22,9686
2062,橋椿,62,51,11,富邦-宜蘭,2024-08-22,9686
00918,大華優利高填息30,10,0,10,富邦-宜蘭,2024-08-22,9686
910861,神州-DR,10,0,10,富邦-宜蘭,2024-08-22,9686
8011,台通,11,1,10,富邦-宜蘭,2024-08-22,9686
4545,銘鈺,10,0,10,富邦-宜蘭,2024-08-22,9686
3715,定穎投控,44,34,10,富邦-宜蘭,2024-08-22,9686
2417,圓剛,25,15,10,富邦-宜蘭,2024-08-22,9686
3535,晶彩科,21,11,10,富邦-宜蘭,2024-08-22,9686
2022,聚亨,10,0,10,富邦-宜蘭,2024-08-22,9686
2609,陽明,12,3,9,富邦-宜蘭,2024-08-22,9686
3059,華晶科,10,1,9,富邦-宜蘭,2024-08-22,9686
8927,北基,10,1,9,富邦-宜蘭,2024-08-22,9686
4909,新復興,12,3,9,富邦-宜蘭,2024-08-22,9686
2353,宏��,14,6,8,富邦-宜蘭,2024-08-22,9686
5534,長虹,8,0,8,富邦-宜蘭,2024-08-22,9686
1785,光洋科,17,10,7,富邦-宜蘭,2024-08-22,9686
1519,華城,67,60,7,富邦-宜蘭,2024-08-22,9686
00937B,群益ESG投等債20,102,5,97,富邦-宜蘭,2024-08-23,9686
2543,皇昌,75,0,75,富邦-宜蘭,2024-08-23,9686
00919,群益台灣精選高息,68,7,61,富邦-宜蘭,2024-08-23,9686
2867,三商壽,61,0,61,富邦-宜蘭,2024-08-23,9686
1314,中石化,162,103,59,富邦-宜蘭,2024-08-23,9686
00632R,元大台灣50反1,170,113,57,富邦-宜蘭,2024-08-23,9686
00940,元大台灣價值高息,68,21,47,富邦-宜蘭,2024-08-23,9686
5009,榮剛,45,0,45,富邦-宜蘭,2024-08-23,9686
3522,御嵿,39,2,37,富邦-宜蘭,2024-08-23,9686
2891,中信金,50,13,37,富邦-宜蘭,2024-08-23,9686
2429,銘旺科,33,0,33,富邦-宜蘭,2024-08-23,9686
00948B,中信優息投資級債,33,0,33,富邦-宜蘭,2024-08-23,9686
2317,鴻海,60,29,31,富邦-宜蘭,2024-08-23,9686
4906,正文,31,5,26,富邦-宜蘭,2024-08-23,9686
3047,訊舟,60,35,25,富邦-宜蘭,2024-08-23,9686
00642U,期元大S＆P石油,25,0,25,富邦-宜蘭,2024-08-23,9686
2887,台新金,30,7,23,富邦-宜蘭,2024-08-23,9686
00650L,復華香港正2,22,0,22,富邦-宜蘭,2024-08-23,9686
3019,亞光,83,61,22,富邦-宜蘭,2024-08-23,9686
2885,元大金,22,1,21,富邦-宜蘭,2024-08-23,9686
1708,東鹼,32,11,21,富邦-宜蘭,2024-08-23,9686
6505,台塑化,21,0,21,富邦-宜蘭,2024-08-23,9686
5364,力麗店,20,1,19,富邦-宜蘭,2024-08-23,9686
00918,大華優利高填息30,19,0,19,富邦-宜蘭,2024-08-23,9686
5905,南仁湖,36,17,19,富邦-宜蘭,2024-08-23,9686
3518,柏騰,23,4,19,富邦-宜蘭,2024-08-23,9686
3231,緯創,21,5,16,富邦-宜蘭,2024-08-23,9686
2337,旺宏,17,1,16,富邦-宜蘭,2024-08-23,9686
0056,元大高股息,20,5,15,富邦-宜蘭,2024-08-23,9686
2303,聯電,22,8,14,富邦-宜蘭,2024-08-23,9686
2312,金寶,22,9,13,富邦-宜蘭,2024-08-23,9686
6218,豪勉,14,1,13,富邦-宜蘭,2024-08-23,9686
4960,誠美材,12,0,12,富邦-宜蘭,2024-08-23,9686
6133,金橋,93,82,11,富邦-宜蘭,2024-08-23,9686
00712,復華富時不動產,11,0,11,富邦-宜蘭,2024-08-23,9686
1316,上曜,11,0,11,富邦-宜蘭,2024-08-23,9686
00953B,群益優選非投等債,11,0,11,富邦-宜蘭,2024-08-23,9686
00882,中信中國高股息,10,0,10,富邦-宜蘭,2024-08-23,9686
1307,三芳,10,0,10,富邦-宜蘭,2024-08-23,9686
2405,輔信,14,4,10,富邦-宜蘭,2024-08-23,9686
2330,台積電,11,1,10,富邦-宜蘭,2024-08-23,9686
2376,技嘉,10,1,9,富邦-宜蘭,2024-08-23,9686
6215,和椿,29,20,9,富邦-宜蘭,2024-08-23,9686
00680L,元大美債20正2,14,5,9,富邦-宜蘭,2024-08-23,9686
2606,裕民,10,1,9,富邦-宜蘭,2024-08-23,9686
8354,冠好,9,0,9,富邦-宜蘭,2024-08-23,9686
2363,矽統,12,3,9,富邦-宜蘭,2024-08-23,9686
5425,台半,9,1,8,富邦-宜蘭,2024-08-23,9686
3189,景碩,29,22,7,富邦-宜蘭,2024-08-23,9686
2442,新美齊,7,0,7,富邦-宜蘭,2024-08-23,9686
00948B,中信優息投資級債,354,5,349,富邦-宜蘭,2024-08-26,9686
00878,國泰永續高股息,355,42,313,富邦-宜蘭,2024-08-26,9686
00687B,國泰20年美債,213,1,212,富邦-宜蘭,2024-08-26,9686
2601,益航,209,1,208,富邦-宜蘭,2024-08-26,9686
00937B,群益ESG投等債20,85,5,80,富邦-宜蘭,2024-08-26,9686
00919,群益台灣精選高息,88,16,72,富邦-宜蘭,2024-08-26,9686
2399,映泰,73,15,58,富邦-宜蘭,2024-08-26,9686
3049,精金,62,11,51,富邦-宜蘭,2024-08-26,9686
00929,復華台灣科技優息,90,41,49,富邦-宜蘭,2024-08-26,9686
5905,南仁湖,40,3,37,富邦-宜蘭,2024-08-26,9686
3518,柏騰,35,1,34,富邦-宜蘭,2024-08-26,9686
2867,三商壽,82,49,33,富邦-宜蘭,2024-08-26,9686
2429,銘旺科,33,4,29,富邦-宜蘭,2024-08-26,9686
1540,喬福,30,3,27,富邦-宜蘭,2024-08-26,9686
5011,久陽,30,3,27,富邦-宜蘭,2024-08-26,9686
5481,新華,26,1,25,富邦-宜蘭,2024-08-26,9686
6834,天二科技,24,0,24,富邦-宜蘭,2024-08-26,9686
00934,中信成長高股息,24,0,24,富邦-宜蘭,2024-08-26,9686
00946,群益科技高息成長,31,8,23,富邦-宜蘭,2024-08-26,9686
4967,十銓,35,12,23,富邦-宜蘭,2024-08-26,9686
5364,力麗店,33,10,23,富邦-宜蘭,2024-08-26,9686
00680L,元大美債20正2,22,0,22,富邦-宜蘭,2024-08-26,9686
1615,大山,22,0,22,富邦-宜蘭,2024-08-26,9686
8121,越峰,44,22,22,富邦-宜蘭,2024-08-26,9686
2331,精英,34,12,22,富邦-宜蘭,2024-08-26,9686
8390,金益鼎,26,6,20,富邦-宜蘭,2024-08-26,9686
4127,天良,20,0,20,富邦-宜蘭,2024-08-26,9686
4741,泓瀚,20,0,20,富邦-宜蘭,2024-08-26,9686
6443,元晶,29,9,20,富邦-宜蘭,2024-08-26,9686
00679B,元大美債20年,20,0,20,富邦-宜蘭,2024-08-26,9686
2489,瑞軒,33,14,19,富邦-宜蘭,2024-08-26,9686
3450,聯鈞,23,5,18,富邦-宜蘭,2024-08-26,9686
6133,金橋,28,10,18,富邦-宜蘭,2024-08-26,9686
2330,台積電,21,3,18,富邦-宜蘭,2024-08-26,9686
2887,台新金,41,23,18,富邦-宜蘭,2024-08-26,9686
00918,大華優利高填息30,17,0,17,富邦-宜蘭,2024-08-26,9686
2615,萬海,48,31,17,富邦-宜蘭,2024-08-26,9686
2359,所羅門,26,10,16,富邦-宜蘭,2024-08-26,9686
1722,台肥,16,0,16,富邦-宜蘭,2024-08-26,9686
2891,中信金,42,27,15,富邦-宜蘭,2024-08-26,9686
8011,台通,15,0,15,富邦-宜蘭,2024-08-26,9686
1316,上曜,15,0,15,富邦-宜蘭,2024-08-26,9686
3673,TPK-KY,20,5,15,富邦-宜蘭,2024-08-26,9686
00885,富邦越南,15,1,14,富邦-宜蘭,2024-08-26,9686
2365,昆盈,20,6,14,富邦-宜蘭,2024-08-26,9686
3312,弘憶股,18,4,14,富邦-宜蘭,2024-08-26,9686
4949,有成精密,14,0,14,富邦-宜蘭,2024-08-26,9686
5243,乙盛-KY,15,1,14,富邦-宜蘭,2024-08-26,9686
5452,佶優,17,4,13,富邦-宜蘭,2024-08-26,9686
2204,中華,13,0,13,富邦-宜蘭,2024-08-26,9686
3481,群創,451,90,361,富邦-宜蘭,2024-08-27,9686
2891,中信金,150,3,147,富邦-宜蘭,2024-08-27,9686
00687B,國泰20年美債,121,3,118,富邦-宜蘭,2024-08-27,9686
2062,橋椿,162,58,104,富邦-宜蘭,2024-08-27,9686
00919,群益台灣精選高息,76,0,76,富邦-宜蘭,2024-08-27,9686
2303,聯電,72,1,71,富邦-宜蘭,2024-08-27,9686
2610,華航,56,0,56,富邦-宜蘭,2024-08-27,9686
1722,台肥,54,0,54,富邦-宜蘭,2024-08-27,9686
1776,展宇,50,1,49,富邦-宜蘭,2024-08-27,9686
2609,陽明,56,8,48,富邦-宜蘭,2024-08-27,9686
2834,臺企銀,51,5,46,富邦-宜蘭,2024-08-27,9686
2867,三商壽,41,4,37,富邦-宜蘭,2024-08-27,9686
5701,劍湖山,36,0,36,富邦-宜蘭,2024-08-27,9686
00706L,期元大S＆P日圓正2,36,1,35,富邦-宜蘭,2024-08-27,9686
00918,大華優利高填息30,33,0,33,富邦-宜蘭,2024-08-27,9686
2883,凱基金,34,6,28,富邦-宜蘭,2024-08-27,9686
3149,正達,49,22,27,富邦-宜蘭,2024-08-27,9686
00878,國泰永續高股息,27,0,27,富邦-宜蘭,2024-08-27,9686
00937B,群益ESG投等債20,26,0,26,富邦-宜蘭,2024-08-27,9686
00933B,國泰10Y+金融債,26,0,26,富邦-宜蘭,2024-08-27,9686
5398,慕康生醫,25,0,25,富邦-宜蘭,2024-08-27,9686
00715L,期街口布蘭特正2,53,31,22,富邦-宜蘭,2024-08-27,9686
00680L,元大美債20正2,24,3,21,富邦-宜蘭,2024-08-27,9686
3673,TPK-KY,26,5,21,富邦-宜蘭,2024-08-27,9686
2354,鴻準,43,22,21,富邦-宜蘭,2024-08-27,9686
00730,富邦臺灣優質高息,20,0,20,富邦-宜蘭,2024-08-27,9686
5538,東明-KY,34,14,20,富邦-宜蘭,2024-08-27,9686
2887,台新金,23,4,19,富邦-宜蘭,2024-08-27,9686
2409,友達,30,11,19,富邦-宜蘭,2024-08-27,9686
8374,羅昇,32,13,19,富邦-宜蘭,2024-08-27,9686
2002,中鋼,42,24,18,富邦-宜蘭,2024-08-27,9686
6133,金橋,25,7,18,富邦-宜蘭,2024-08-27,9686
3033,威健,40,24,16,富邦-宜蘭,2024-08-27,9686
2880,華南金,21,5,16,富邦-宜蘭,2024-08-27,9686
6789,采鈺,16,1,15,富邦-宜蘭,2024-08-27,9686
2845,遠東銀,16,1,15,富邦-宜蘭,2024-08-27,9686
2537,聯上發,14,0,14,富邦-宜蘭,2024-08-27,9686
00753L,中信中國50正2,14,0,14,富邦-宜蘭,2024-08-27,9686
2882,國泰金,14,0,14,富邦-宜蘭,2024-08-27,9686
0056,元大高股息,14,1,13,富邦-宜蘭,2024-08-27,9686
4958,臻鼎-KY,16,3,13,富邦-宜蘭,2024-08-27,9686
2330,台積電,14,1,13,富邦-宜蘭,2024-08-27,9686
2402,毅嘉,65,52,13,富邦-宜蘭,2024-08-27,9686
3260,威剛,16,3,13,富邦-宜蘭,2024-08-27,9686
4967,十銓,26,14,12,富邦-宜蘭,2024-08-27,9686
3078,僑威,11,0,11,富邦-宜蘭,2024-08-27,9686
6126,信音,11,0,11,富邦-宜蘭,2024-08-27,9686
1708,東鹼,12,1,11,富邦-宜蘭,2024-08-27,9686
2363,矽統,15,4,11,富邦-宜蘭,2024-08-27,9686
2888,新光金,129,119,10,富邦-宜蘭,2024-08-27,9686
2409,友達,165,7,158,富邦-宜蘭,2024-08-28,9686
6282,康舒,61,0,61,富邦-宜蘭,2024-08-28,9686
00959B,大華投等美債15Y+,61,0,61,富邦-宜蘭,2024-08-28,9686
00715L,期街口布蘭特正2,54,5,49,富邦-宜蘭,2024-08-28,9686
2891,中信金,52,6,46,富邦-宜蘭,2024-08-28,9686
00753L,中信中國50正2,43,0,43,富邦-宜蘭,2024-08-28,9686
6216,居易,43,0,43,富邦-宜蘭,2024-08-28,9686
00687B,國泰20年美債,40,0,40,富邦-宜蘭,2024-08-28,9686
00937B,群益ESG投等債20,38,7,31,富邦-宜蘭,2024-08-28,9686
6505,台塑化,30,0,30,富邦-宜蘭,2024-08-28,9686
1314,中石化,51,21,30,富邦-宜蘭,2024-08-28,9686
00950B,凱基A級公司債,27,0,27,富邦-宜蘭,2024-08-28,9686
6177,達麗,36,9,27,富邦-宜蘭,2024-08-28,9686
2356,英業達,29,4,25,富邦-宜蘭,2024-08-28,9686
00650L,復華香港正2,23,0,23,富邦-宜蘭,2024-08-28,9686
2344,華邦電,21,1,20,富邦-宜蘭,2024-08-28,9686
00673R,期元大S＆P原油反1,20,0,20,富邦-宜蘭,2024-08-28,9686
0056,元大高股息,19,1,18,富邦-宜蘭,2024-08-28,9686
2365,昆盈,25,8,17,富邦-宜蘭,2024-08-28,9686
4906,正文,24,7,17,富邦-宜蘭,2024-08-28,9686
3049,精金,17,0,17,富邦-宜蘭,2024-08-28,9686
2402,毅嘉,32,16,16,富邦-宜蘭,2024-08-28,9686
4908,前鼎,21,5,16,富邦-宜蘭,2024-08-28,9686
5701,劍湖山,16,0,16,富邦-宜蘭,2024-08-28,9686
8039,台虹,52,36,16,富邦-宜蘭,2024-08-28,9686
2392,正崴,30,15,15,富邦-宜蘭,2024-08-28,9686
2008,高興昌,15,0,15,富邦-宜蘭,2024-08-28,9686
1449,佳和,15,0,15,富邦-宜蘭,2024-08-28,9686
2020,美亞,15,0,15,富邦-宜蘭,2024-08-28,9686
3078,僑威,14,0,14,富邦-宜蘭,2024-08-28,9686
3057,喬鼎,14,0,14,富邦-宜蘭,2024-08-28,9686
8064,東捷,20,6,14,富邦-宜蘭,2024-08-28,9686
2845,遠東銀,13,0,13,富邦-宜蘭,2024-08-28,9686
2324,仁寶,15,2,13,富邦-宜蘭,2024-08-28,9686
2425,承啟,15,2,13,富邦-宜蘭,2024-08-28,9686
2399,映泰,50,37,13,富邦-宜蘭,2024-08-28,9686
6126,信音,13,0,13,富邦-宜蘭,2024-08-28,9686
2906,高林,13,0,13,富邦-宜蘭,2024-08-28,9686
2317,鴻海,29,17,12,富邦-宜蘭,2024-08-28,9686
3062,建漢,30,18,12,富邦-宜蘭,2024-08-28,9686
3047,訊舟,16,4,12,富邦-宜蘭,2024-08-28,9686
3260,威剛,12,1,11,富邦-宜蘭,2024-08-28,9686
00637L,元大滬深300正2,14,3,11,富邦-宜蘭,2024-08-28,9686
6443,元晶,13,2,11,富邦-宜蘭,2024-08-28,9686
4960,誠美材,11,0,11,富邦-宜蘭,2024-08-28,9686
2208,台船,11,0,11,富邦-宜蘭,2024-08-28,9686
5443,均豪,120,109,11,富邦-宜蘭,2024-08-28,9686
2353,宏��,11,0,11,富邦-宜蘭,2024-08-28,9686
3037,欣興,10,0,10,富邦-宜蘭,2024-08-28,9686
6175,立敦,11,1,10,富邦-宜蘭,2024-08-28,9686
00933B,國泰10Y+金融債,93,0,93,富邦-宜蘭,2024-08-29,9686
00688L,國泰20年美債正2,87,1,86,富邦-宜蘭,2024-08-29,9686
2314,台揚,74,5,69,富邦-宜蘭,2024-08-29,9686
2392,正崴,71,4,67,富邦-宜蘭,2024-08-29,9686
00853B,統一美債10年Aa-,65,0,65,富邦-宜蘭,2024-08-29,9686
2425,承啟,85,24,61,富邦-宜蘭,2024-08-29,9686
2891,中信金,68,8,60,富邦-宜蘭,2024-08-29,9686
3234,光環,57,2,55,富邦-宜蘭,2024-08-29,9686
4526,東台,134,81,53,富邦-宜蘭,2024-08-29,9686
00687B,國泰20年美債,59,11,48,富邦-宜蘭,2024-08-29,9686
00937B,群益ESG投等債20,53,6,47,富邦-宜蘭,2024-08-29,9686
3481,群創,49,3,46,富邦-宜蘭,2024-08-29,9686
3437,榮創,46,1,45,富邦-宜蘭,2024-08-29,9686
2409,友達,47,3,44,富邦-宜蘭,2024-08-29,9686
00959B,大華投等美債15Y+,44,0,44,富邦-宜蘭,2024-08-29,9686
4127,天良,35,0,35,富邦-宜蘭,2024-08-29,9686
8111,立��,38,5,33,富邦-宜蘭,2024-08-29,9686
1722,台肥,31,0,31,富邦-宜蘭,2024-08-29,9686
00753L,中信中國50正2,29,0,29,富邦-宜蘭,2024-08-29,9686
1721,三晃,93,64,29,富邦-宜蘭,2024-08-29,9686
00679B,元大美債20年,35,6,29,富邦-宜蘭,2024-08-29,9686
6282,康舒,28,0,28,富邦-宜蘭,2024-08-29,9686
00665L,富邦�琤肭磪囓�2,25,0,25,富邦-宜蘭,2024-08-29,9686
2610,華航,25,0,25,富邦-宜蘭,2024-08-29,9686
3550,聯穎,41,17,24,富邦-宜蘭,2024-08-29,9686
3615,安可,23,0,23,富邦-宜蘭,2024-08-29,9686
00650L,復華香港正2,23,2,21,富邦-宜蘭,2024-08-29,9686
8150,南茂,21,0,21,富邦-宜蘭,2024-08-29,9686
6698,旭暉應材,28,8,20,富邦-宜蘭,2024-08-29,9686
6120,達運,20,0,20,富邦-宜蘭,2024-08-29,9686
5443,均豪,75,56,19,富邦-宜蘭,2024-08-29,9686
6431,光麗-KY,20,1,19,富邦-宜蘭,2024-08-29,9686
00929,復華台灣科技優息,32,13,19,富邦-宜蘭,2024-08-29,9686
2330,台積電,19,1,18,富邦-宜蘭,2024-08-29,9686
2353,宏��,21,4,17,富邦-宜蘭,2024-08-29,9686
1314,中石化,33,16,17,富邦-宜蘭,2024-08-29,9686
8096,擎亞,23,7,16,富邦-宜蘭,2024-08-29,9686
00715L,期街口布蘭特正2,20,4,16,富邦-宜蘭,2024-08-29,9686
2312,金寶,25,10,15,富邦-宜蘭,2024-08-29,9686
6175,立敦,14,0,14,富邦-宜蘭,2024-08-29,9686
4510,高鋒,91,77,14,富邦-宜蘭,2024-08-29,9686
00881,國泰台灣5G+,24,11,13,富邦-宜蘭,2024-08-29,9686
3047,訊舟,29,16,13,富邦-宜蘭,2024-08-29,9686
00696B,富邦美債20年,13,0,13,富邦-宜蘭,2024-08-29,9686
6196,帆宣,15,2,13,富邦-宜蘭,2024-08-29,9686
3518,柏騰,20,7,13,富邦-宜蘭,2024-08-29,9686
2464,盟立,28,16,12,富邦-宜蘭,2024-08-29,9686
6505,台塑化,12,0,12,富邦-宜蘭,2024-08-29,9686
4167,松瑞藥,14,2,12,富邦-宜蘭,2024-08-29,9686
1303,南亞,13,1,12,富邦-宜蘭,2024-08-29,9686
2062,橋椿,275,16,259,富邦-宜蘭,2024-08-30,9686
3481,群創,191,24,167,富邦-宜蘭,2024-08-30,9686
2537,聯上發,153,21,132,富邦-宜蘭,2024-08-30,9686
00937B,群益ESG投等債20,115,7,108,富邦-宜蘭,2024-08-30,9686
00688L,國泰20年美債正2,68,0,68,富邦-宜蘭,2024-08-30,9686
4526,東台,154,94,60,富邦-宜蘭,2024-08-30,9686
6290,良維,61,4,57,富邦-宜蘭,2024-08-30,9686
6143,振曜,70,15,55,富邦-宜蘭,2024-08-30,9686
6698,旭暉應材,135,90,45,富邦-宜蘭,2024-08-30,9686
2891,中信金,39,1,38,富邦-宜蘭,2024-08-30,9686
6770,力積電,34,0,34,富邦-宜蘭,2024-08-30,9686
2367,燿華,122,88,34,富邦-宜蘭,2024-08-30,9686
2618,長榮航,48,16,32,富邦-宜蘭,2024-08-30,9686
3313,斐成,32,0,32,富邦-宜蘭,2024-08-30,9686
1303,南亞,32,0,32,富邦-宜蘭,2024-08-30,9686
1471,首利,31,0,31,富邦-宜蘭,2024-08-30,9686
2008,高興昌,30,0,30,富邦-宜蘭,2024-08-30,9686
4721,美琪瑪,29,0,29,富邦-宜蘭,2024-08-30,9686
1785,光洋科,85,57,28,富邦-宜蘭,2024-08-30,9686
5452,佶優,32,6,26,富邦-宜蘭,2024-08-30,9686
2520,冠德,31,7,24,富邦-宜蘭,2024-08-30,9686
2313,華通,106,84,22,富邦-宜蘭,2024-08-30,9686
00687B,國泰20年美債,23,1,22,富邦-宜蘭,2024-08-30,9686
3580,友威科,25,4,21,富邦-宜蘭,2024-08-30,9686
2515,中工,22,2,20,富邦-宜蘭,2024-08-30,9686
1711,永光,113,93,20,富邦-宜蘭,2024-08-30,9686
4402,郡都開發,20,0,20,富邦-宜蘭,2024-08-30,9686
00931B,統一美債20年,20,0,20,富邦-宜蘭,2024-08-30,9686
2409,友達,31,12,19,富邦-宜蘭,2024-08-30,9686
3062,建漢,36,17,19,富邦-宜蘭,2024-08-30,9686
2312,金寶,46,27,19,富邦-宜蘭,2024-08-30,9686
4729,熒茂,19,1,18,富邦-宜蘭,2024-08-30,9686
00680L,元大美債20正2,17,0,17,富邦-宜蘭,2024-08-30,9686
4534,慶騰,16,0,16,富邦-宜蘭,2024-08-30,9686
2504,國產,16,0,16,富邦-宜蘭,2024-08-30,9686
3015,全漢,23,7,16,富邦-宜蘭,2024-08-30,9686
2340,台亞,21,6,15,富邦-宜蘭,2024-08-30,9686
2426,鼎元,28,14,14,富邦-宜蘭,2024-08-30,9686
2027,大成鋼,17,3,14,富邦-宜蘭,2024-08-30,9686
4561,健椿,37,23,14,富邦-宜蘭,2024-08-30,9686
6869,雲豹能源,15,2,13,富邦-宜蘭,2024-08-30,9686
2489,瑞軒,14,2,12,富邦-宜蘭,2024-08-30,9686
3594,磐儀,17,5,12,富邦-宜蘭,2024-08-30,9686
3294,英濟,17,5,12,富邦-宜蘭,2024-08-30,9686
6175,立敦,12,0,12,富邦-宜蘭,2024-08-30,9686
00951,台新日本半導體,13,1,12,富邦-宜蘭,2024-08-30,9686
1301,台塑,11,0,11,富邦-宜蘭,2024-08-30,9686
00959B,大華投等美債15Y+,11,0,11,富邦-宜蘭,2024-08-30,9686
8046,南電,13,2,11,富邦-宜蘭,2024-08-30,9686
00878,國泰永續高股息,22,12,10,富邦-宜蘭,2024-08-30,9686
00679B,元大美債20年,427,29,398,富邦-宜蘭,2024-09-02,9686
00715L,期街口布蘭特正2,95,5,90,富邦-宜蘭,2024-09-02,9686
3481,群創,89,3,86,富邦-宜蘭,2024-09-02,9686
00795B,中信美國公債20年,69,0,69,富邦-宜蘭,2024-09-02,9686
00919,群益台灣精選高息,67,1,66,富邦-宜蘭,2024-09-02,9686
3066,李洲,67,6,61,富邦-宜蘭,2024-09-02,9686
2409,友達,58,0,58,富邦-宜蘭,2024-09-02,9686
6188,廣明,55,0,55,富邦-宜蘭,2024-09-02,9686
1722,台肥,52,0,52,富邦-宜蘭,2024-09-02,9686
00929,復華台灣科技優息,79,31,48,富邦-宜蘭,2024-09-02,9686
00937B,群益ESG投等債20,68,21,47,富邦-宜蘭,2024-09-02,9686
3043,科風,52,10,42,富邦-宜蘭,2024-09-02,9686
00948B,中信優息投資級債,51,10,41,富邦-宜蘭,2024-09-02,9686
5876,上海商銀,40,0,40,富邦-宜蘭,2024-09-02,9686
6290,良維,34,2,32,富邦-宜蘭,2024-09-02,9686
3189,景碩,46,15,31,富邦-宜蘭,2024-09-02,9686
00945B,凱基美國非投等債,31,0,31,富邦-宜蘭,2024-09-02,9686
1301,台塑,28,1,27,富邦-宜蘭,2024-09-02,9686
2603,長榮,28,3,25,富邦-宜蘭,2024-09-02,9686
00637L,元大滬深300正2,24,0,24,富邦-宜蘭,2024-09-02,9686
8105,凌巨,92,69,23,富邦-宜蘭,2024-09-02,9686
2352,佳世達,44,21,23,富邦-宜蘭,2024-09-02,9686
3163,波若威,31,8,23,富邦-宜蘭,2024-09-02,9686
3264,欣銓,22,0,22,富邦-宜蘭,2024-09-02,9686
3518,柏騰,22,1,21,富邦-宜蘭,2024-09-02,9686
8155,博智,20,0,20,富邦-宜蘭,2024-09-02,9686
1815,富喬,23,3,20,富邦-宜蘭,2024-09-02,9686
1434,福懋,20,0,20,富邦-宜蘭,2024-09-02,9686
1708,東鹼,19,0,19,富邦-宜蘭,2024-09-02,9686
00753L,中信中國50正2,24,5,19,富邦-宜蘭,2024-09-02,9686
00918,大華優利高填息30,22,4,18,富邦-宜蘭,2024-09-02,9686
2891,中信金,50,32,18,富邦-宜蘭,2024-09-02,9686
2609,陽明,24,6,18,富邦-宜蘭,2024-09-02,9686
2317,鴻海,33,15,18,富邦-宜蘭,2024-09-02,9686
6282,康舒,17,0,17,富邦-宜蘭,2024-09-02,9686
2515,中工,26,9,17,富邦-宜蘭,2024-09-02,9686
6770,力積電,17,0,17,富邦-宜蘭,2024-09-02,9686
00944,野村趨勢動能高息,16,0,16,富邦-宜蘭,2024-09-02,9686
4306,炎洲,28,12,16,富邦-宜蘭,2024-09-02,9686
3162,精確,16,0,16,富邦-宜蘭,2024-09-02,9686
6505,台塑化,16,0,16,富邦-宜蘭,2024-09-02,9686
2008,高興昌,15,0,15,富邦-宜蘭,2024-09-02,9686
1314,中石化,24,10,14,富邦-宜蘭,2024-09-02,9686
00959B,大華投等美債15Y+,17,3,14,富邦-宜蘭,2024-09-02,9686
2495,普安,22,9,13,富邦-宜蘭,2024-09-02,9686
3207,耀勝,13,0,13,富邦-宜蘭,2024-09-02,9686
2545,皇翔,16,3,13,富邦-宜蘭,2024-09-02,9686
2258,鴻華先進-創,13,0,13,富邦-宜蘭,2024-09-02,9686
2615,萬海,51,38,13,富邦-宜蘭,2024-09-02,9686
4714,永捷,13,1,12,富邦-宜蘭,2024-09-02,9686
00919,群益台灣精選高息,541,44,497,富邦-宜蘭,2024-09-03,9686
1314,中石化,229,5,224,富邦-宜蘭,2024-09-03,9686
00753L,中信中國50正2,102,15,87,富邦-宜蘭,2024-09-03,9686
00918,大華優利高填息30,75,0,75,富邦-宜蘭,2024-09-03,9686
1722,台肥,68,0,68,富邦-宜蘭,2024-09-03,9686
9945,潤泰新,60,5,55,富邦-宜蘭,2024-09-03,9686
2313,華通,88,34,54,富邦-宜蘭,2024-09-03,9686
00688L,國泰20年美債正2,51,0,51,富邦-宜蘭,2024-09-03,9686
00943,兆豐電子高息等權,50,0,50,富邦-宜蘭,2024-09-03,9686
2409,友達,50,5,45,富邦-宜蘭,2024-09-03,9686
00921,兆豐龍頭等權重,44,0,44,富邦-宜蘭,2024-09-03,9686
3481,群創,63,22,41,富邦-宜蘭,2024-09-03,9686
3050,鈺德,40,0,40,富邦-宜蘭,2024-09-03,9686
4127,天良,39,0,39,富邦-宜蘭,2024-09-03,9686
6757,台灣虎航,35,0,35,富邦-宜蘭,2024-09-03,9686
1815,富喬,55,22,33,富邦-宜蘭,2024-09-03,9686
4303,信立,32,2,30,富邦-宜蘭,2024-09-03,9686
2515,中工,32,2,30,富邦-宜蘭,2024-09-03,9686
00878,國泰永續高股息,39,10,29,富邦-宜蘭,2024-09-03,9686
00931B,統一美債20年,30,2,28,富邦-宜蘭,2024-09-03,9686
2323,中環,31,5,26,富邦-宜蘭,2024-09-03,9686
00915,凱基優選高股息30,27,1,26,富邦-宜蘭,2024-09-03,9686
00940,元大台灣價值高息,57,32,25,富邦-宜蘭,2024-09-03,9686
00679B,元大美債20年,25,0,25,富邦-宜蘭,2024-09-03,9686
00907,永豐優息存股,24,0,24,富邦-宜蘭,2024-09-03,9686
3149,正達,32,9,23,富邦-宜蘭,2024-09-03,9686
6213,聯茂,42,20,22,富邦-宜蘭,2024-09-03,9686
2356,英業達,21,0,21,富邦-宜蘭,2024-09-03,9686
2609,陽明,25,5,20,富邦-宜蘭,2024-09-03,9686
2913,農林,20,0,20,富邦-宜蘭,2024-09-03,9686
3716,中化控股,20,0,20,富邦-宜蘭,2024-09-03,9686
1612,宏泰,60,40,20,富邦-宜蘭,2024-09-03,9686
1440,南紡,20,0,20,富邦-宜蘭,2024-09-03,9686
00632R,元大台灣50反1,20,0,20,富邦-宜蘭,2024-09-03,9686
1434,福懋,19,0,19,富邦-宜蘭,2024-09-03,9686
2486,一詮,20,3,17,富邦-宜蘭,2024-09-03,9686
2891,中信金,29,13,16,富邦-宜蘭,2024-09-03,9686
3037,欣興,17,1,16,富邦-宜蘭,2024-09-03,9686
2408,南亞科,18,3,15,富邦-宜蘭,2024-09-03,9686
00680L,元大美債20正2,15,0,15,富邦-宜蘭,2024-09-03,9686
6290,良維,19,5,14,富邦-宜蘭,2024-09-03,9686
1101,台泥,17,3,14,富邦-宜蘭,2024-09-03,9686
1326,台化,13,0,13,富邦-宜蘭,2024-09-03,9686
00687B,國泰20年美債,85,72,13,富邦-宜蘭,2024-09-03,9686
3162,精確,13,0,13,富邦-宜蘭,2024-09-03,9686
5880,合庫金,13,0,13,富邦-宜蘭,2024-09-03,9686
4714,永捷,25,13,12,富邦-宜蘭,2024-09-03,9686
5425,台半,12,0,12,富邦-宜蘭,2024-09-03,9686
1301,台塑,17,5,12,富邦-宜蘭,2024-09-03,9686
4155,訊映,11,0,11,富邦-宜蘭,2024-09-03,9686
00919,群益台灣精選高息,447,56,391,富邦-宜蘭,2024-09-04,9686
00878,國泰永續高股息,244,27,217,富邦-宜蘭,2024-09-04,9686
00687B,國泰20年美債,342,135,207,富邦-宜蘭,2024-09-04,9686
0056,元大高股息,201,11,190,富邦-宜蘭,2024-09-04,9686
00715L,期街口布蘭特正2,160,0,160,富邦-宜蘭,2024-09-04,9686
00929,復華台灣科技優息,337,206,131,富邦-宜蘭,2024-09-04,9686
2887,台新金,107,0,107,富邦-宜蘭,2024-09-04,9686
2834,臺企銀,118,15,103,富邦-宜蘭,2024-09-04,9686
2891,中信金,108,7,101,富邦-宜蘭,2024-09-04,9686
5880,合庫金,106,10,96,富邦-宜蘭,2024-09-04,9686
00940,元大台灣價值高息,142,50,92,富邦-宜蘭,2024-09-04,9686
00918,大華優利高填息30,112,31,81,富邦-宜蘭,2024-09-04,9686
00753L,中信中國50正2,90,10,80,富邦-宜蘭,2024-09-04,9686
2888,新光金,109,35,74,富邦-宜蘭,2024-09-04,9686
2409,友達,92,29,63,富邦-宜蘭,2024-09-04,9686
2344,華邦電,64,2,62,富邦-宜蘭,2024-09-04,9686
1303,南亞,73,13,60,富邦-宜蘭,2024-09-04,9686
00915,凱基優選高股息30,57,0,57,富邦-宜蘭,2024-09-04,9686
6189,豐藝,57,0,57,富邦-宜蘭,2024-09-04,9686
1722,台肥,60,5,55,富邦-宜蘭,2024-09-04,9686
2330,台積電,61,7,54,富邦-宜蘭,2024-09-04,9686
6290,良維,54,1,53,富邦-宜蘭,2024-09-04,9686
3346,麗清,47,0,47,富邦-宜蘭,2024-09-04,9686
2634,漢翔,45,1,44,富邦-宜蘭,2024-09-04,9686
2543,皇昌,45,1,44,富邦-宜蘭,2024-09-04,9686
2883,凱基金,47,4,43,富邦-宜蘭,2024-09-04,9686
2547,日勝生,40,0,40,富邦-宜蘭,2024-09-04,9686
3037,欣興,42,3,39,富邦-宜蘭,2024-09-04,9686
2317,鴻海,73,35,38,富邦-宜蘭,2024-09-04,9686
2356,英業達,40,2,38,富邦-宜蘭,2024-09-04,9686
00946,群益科技高息成長,35,0,35,富邦-宜蘭,2024-09-04,9686
00905,FT臺灣Smart,35,0,35,富邦-宜蘭,2024-09-04,9686
00951,台新日本半導體,34,0,34,富邦-宜蘭,2024-09-04,9686
2303,聯電,54,20,34,富邦-宜蘭,2024-09-04,9686
00900,富邦特選高股息30,36,3,33,富邦-宜蘭,2024-09-04,9686
00881,國泰台灣5G+,42,9,33,富邦-宜蘭,2024-09-04,9686
2002,中鋼,32,0,32,富邦-宜蘭,2024-09-04,9686
6188,廣明,32,1,31,富邦-宜蘭,2024-09-04,9686
00713,元大台灣高息低波,40,9,31,富邦-宜蘭,2024-09-04,9686
00665L,富邦�琤肭磪囓�2,30,0,30,富邦-宜蘭,2024-09-04,9686
1301,台塑,32,4,28,富邦-宜蘭,2024-09-04,9686
00923,群益台ESG低碳50,28,1,27,富邦-宜蘭,2024-09-04,9686
5531,鄉林,27,0,27,富邦-宜蘭,2024-09-04,9686
00650L,復華香港正2,26,0,26,富邦-宜蘭,2024-09-04,9686
6770,力積電,30,5,25,富邦-宜蘭,2024-09-04,9686
5876,上海商銀,25,0,25,富邦-宜蘭,2024-09-04,9686
2313,華通,38,14,24,富邦-宜蘭,2024-09-04,9686
2882,國泰金,30,7,23,富邦-宜蘭,2024-09-04,9686
00943,兆豐電子高息等權,23,0,23,富邦-宜蘭,2024-09-04,9686
4510,高鋒,139,116,23,富邦-宜蘭,2024-09-04,9686
00919,群益台灣精選高息,238,3,235,富邦-宜蘭,2024-09-05,9686
1722,台肥,170,0,170,富邦-宜蘭,2024-09-05,9686
00715L,期街口布蘭特正2,128,0,128,富邦-宜蘭,2024-09-05,9686
2891,中信金,124,2,122,富邦-宜蘭,2024-09-05,9686
2344,華邦電,116,1,115,富邦-宜蘭,2024-09-05,9686
2408,南亞科,117,8,109,富邦-宜蘭,2024-09-05,9686
00929,復華台灣科技優息,152,46,106,富邦-宜蘭,2024-09-05,9686
2543,皇昌,109,4,105,富邦-宜蘭,2024-09-05,9686
5880,合庫金,102,2,100,富邦-宜蘭,2024-09-05,9686
00720B,元大投資級公司債,100,0,100,富邦-宜蘭,2024-09-05,9686
00687B,國泰20年美債,122,23,99,富邦-宜蘭,2024-09-05,9686
00878,國泰永續高股息,81,14,67,富邦-宜蘭,2024-09-05,9686
2317,鴻海,86,21,65,富邦-宜蘭,2024-09-05,9686
2362,藍天,65,0,65,富邦-宜蘭,2024-09-05,9686
4971,IET-KY,57,1,56,富邦-宜蘭,2024-09-05,9686
6257,矽格,56,0,56,富邦-宜蘭,2024-09-05,9686
00951,台新日本半導體,50,2,48,富邦-宜蘭,2024-09-05,9686
00688L,國泰20年美債正2,47,10,37,富邦-宜蘭,2024-09-05,9686
00952,凱基台灣AI50,116,79,37,富邦-宜蘭,2024-09-05,9686
3481,群創,51,15,36,富邦-宜蘭,2024-09-05,9686
1527,鑽全,36,0,36,富邦-宜蘭,2024-09-05,9686
6606,建德工業,57,21,36,富邦-宜蘭,2024-09-05,9686
6727,亞泰金屬,32,0,32,富邦-宜蘭,2024-09-05,9686
00706L,期元大S＆P日圓正2,30,1,29,富邦-宜蘭,2024-09-05,9686
1539,巨庭,136,108,28,富邦-宜蘭,2024-09-05,9686
1314,中石化,27,0,27,富邦-宜蘭,2024-09-05,9686
2367,燿華,33,6,27,富邦-宜蘭,2024-09-05,9686
00915,凱基優選高股息30,29,2,27,富邦-宜蘭,2024-09-05,9686
2312,金寶,27,0,27,富邦-宜蘭,2024-09-05,9686
3050,鈺德,24,0,24,富邦-宜蘭,2024-09-05,9686
2402,毅嘉,28,5,23,富邦-宜蘭,2024-09-05,9686
00948B,中信優息投資級債,23,0,23,富邦-宜蘭,2024-09-05,9686
00940,元大台灣價值高息,43,21,22,富邦-宜蘭,2024-09-05,9686
2002,中鋼,32,10,22,富邦-宜蘭,2024-09-05,9686
3062,建漢,27,5,22,富邦-宜蘭,2024-09-05,9686
0056,元大高股息,23,3,20,富邦-宜蘭,2024-09-05,9686
1310,台苯,20,0,20,富邦-宜蘭,2024-09-05,9686
9907,統一實,20,0,20,富邦-宜蘭,2024-09-05,9686
6505,台塑化,19,0,19,富邦-宜蘭,2024-09-05,9686
2405,輔信,20,1,19,富邦-宜蘭,2024-09-05,9686
00713,元大台灣高息低波,22,4,18,富邦-宜蘭,2024-09-05,9686
6191,精成科,18,0,18,富邦-宜蘭,2024-09-05,9686
2354,鴻準,24,6,18,富邦-宜蘭,2024-09-05,9686
6143,振曜,31,13,18,富邦-宜蘭,2024-09-05,9686
6739,竹陞科技,27,10,17,富邦-宜蘭,2024-09-05,9686
6570,維田,17,1,16,富邦-宜蘭,2024-09-05,9686
1540,喬福,107,92,15,富邦-宜蘭,2024-09-05,9686
2337,旺宏,24,9,15,富邦-宜蘭,2024-09-05,9686
1101,台泥,15,0,15,富邦-宜蘭,2024-09-05,9686
2359,所羅門,66,52,14,富邦-宜蘭,2024-09-05,9686
2888,新光金,507,11,496,富邦-宜蘭,2024-09-06,9686
00919,群益台灣精選高息,178,23,155,富邦-宜蘭,2024-09-06,9686
2409,友達,182,60,122,富邦-宜蘭,2024-09-06,9686
00929,復華台灣科技優息,90,19,71,富邦-宜蘭,2024-09-06,9686
00715L,期街口布蘭特正2,52,0,52,富邦-宜蘭,2024-09-06,9686
00915,凱基優選高股息30,43,1,42,富邦-宜蘭,2024-09-06,9686
8929,富堡,42,0,42,富邦-宜蘭,2024-09-06,9686
1815,富喬,50,9,41,富邦-宜蘭,2024-09-06,9686
00688L,國泰20年美債正2,40,1,39,富邦-宜蘭,2024-09-06,9686
6405,悅城,141,107,34,富邦-宜蘭,2024-09-06,9686
00679B,元大美債20年,45,11,34,富邦-宜蘭,2024-09-06,9686
00878,國泰永續高股息,36,5,31,富邦-宜蘭,2024-09-06,9686
00937B,群益ESG投等債20,28,4,24,富邦-宜蘭,2024-09-06,9686
5701,劍湖山,22,0,22,富邦-宜蘭,2024-09-06,9686
2002,中鋼,22,1,21,富邦-宜蘭,2024-09-06,9686
2489,瑞軒,36,16,20,富邦-宜蘭,2024-09-06,9686
4971,IET-KY,20,0,20,富邦-宜蘭,2024-09-06,9686
6770,力積電,22,2,20,富邦-宜蘭,2024-09-06,9686
00918,大華優利高填息30,35,16,19,富邦-宜蘭,2024-09-06,9686
2881,富邦金,25,7,18,富邦-宜蘭,2024-09-06,9686
00959B,大華投等美債15Y+,17,0,17,富邦-宜蘭,2024-09-06,9686
3481,群創,28,11,17,富邦-宜蘭,2024-09-06,9686
00945B,凱基美國非投等債,16,0,16,富邦-宜蘭,2024-09-06,9686
00940,元大台灣價值高息,28,13,15,富邦-宜蘭,2024-09-06,9686
00951,台新日本半導體,15,0,15,富邦-宜蘭,2024-09-06,9686
00664R,國泰臺灣加權反1,15,0,15,富邦-宜蘭,2024-09-06,9686
2349,錸德,18,3,15,富邦-宜蘭,2024-09-06,9686
1721,三晃,15,0,15,富邦-宜蘭,2024-09-06,9686
910861,神州-DR,15,0,15,富邦-宜蘭,2024-09-06,9686
00753L,中信中國50正2,15,0,15,富邦-宜蘭,2024-09-06,9686
2426,鼎元,18,5,13,富邦-宜蘭,2024-09-06,9686
00650L,復華香港正2,15,2,13,富邦-宜蘭,2024-09-06,9686
1314,中石化,13,0,13,富邦-宜蘭,2024-09-06,9686
2464,盟立,25,13,12,富邦-宜蘭,2024-09-06,9686
6213,聯茂,17,5,12,富邦-宜蘭,2024-09-06,9686
1905,華紙,12,0,12,富邦-宜蘭,2024-09-06,9686
6290,良維,12,0,12,富邦-宜蘭,2024-09-06,9686
2337,旺宏,29,18,11,富邦-宜蘭,2024-09-06,9686
9946,三發地產,11,0,11,富邦-宜蘭,2024-09-06,9686
5009,榮剛,13,2,11,富邦-宜蘭,2024-09-06,9686
2313,華通,56,46,10,富邦-宜蘭,2024-09-06,9686
5443,均豪,46,36,10,富邦-宜蘭,2024-09-06,9686
3380,明泰,10,0,10,富邦-宜蘭,2024-09-06,9686
4538,大詠城,10,0,10,富邦-宜蘭,2024-09-06,9686
3437,榮創,19,9,10,富邦-宜蘭,2024-09-06,9686
3054,立萬利,10,0,10,富邦-宜蘭,2024-09-06,9686
9907,統一實,10,0,10,富邦-宜蘭,2024-09-06,9686
2486,一詮,13,4,9,富邦-宜蘭,2024-09-06,9686
3607,谷崧,11,2,9,富邦-宜蘭,2024-09-06,9686
1785,光洋科,10,1,9,富邦-宜蘭,2024-09-06,9686
00948B,中信優息投資級債,295,32,263,富邦-宜蘭,2024-09-09,9686
00919,群益台灣精選高息,233,18,215,富邦-宜蘭,2024-09-09,9686
00929,復華台灣科技優息,209,6,203,富邦-宜蘭,2024-09-09,9686
00878,國泰永續高股息,196,4,192,富邦-宜蘭,2024-09-09,9686
2409,友達,140,6,134,富邦-宜蘭,2024-09-09,9686
1316,上曜,132,1,131,富邦-宜蘭,2024-09-09,9686
2317,鴻海,116,22,94,富邦-宜蘭,2024-09-09,9686
00940,元大台灣價值高息,92,17,75,富邦-宜蘭,2024-09-09,9686
3511,矽瑪,117,45,72,富邦-宜蘭,2024-09-09,9686
5475,德宏,63,1,62,富邦-宜蘭,2024-09-09,9686
0056,元大高股息,57,0,57,富邦-宜蘭,2024-09-09,9686
2891,中信金,60,6,54,富邦-宜蘭,2024-09-09,9686
6505,台塑化,54,0,54,富邦-宜蘭,2024-09-09,9686
00687B,國泰20年美債,75,23,52,富邦-宜蘭,2024-09-09,9686
3664,安瑞-KY,51,0,51,富邦-宜蘭,2024-09-09,9686
2881,富邦金,64,14,50,富邦-宜蘭,2024-09-09,9686
00637L,元大滬深300正2,51,10,41,富邦-宜蘭,2024-09-09,9686
2539,櫻花建,40,0,40,富邦-宜蘭,2024-09-09,9686
4303,信立,40,0,40,富邦-宜蘭,2024-09-09,9686
8249,菱光,68,28,40,富邦-宜蘭,2024-09-09,9686
00751B,元大AAA至A公司債,44,5,39,富邦-宜蘭,2024-09-09,9686
3303,岱稜,37,0,37,富邦-宜蘭,2024-09-09,9686
00915,凱基優選高股息30,35,2,33,富邦-宜蘭,2024-09-09,9686
2344,華邦電,37,5,32,富邦-宜蘭,2024-09-09,9686
2609,陽明,33,5,28,富邦-宜蘭,2024-09-09,9686
00918,大華優利高填息30,38,10,28,富邦-宜蘭,2024-09-09,9686
00680L,元大美債20正2,77,51,26,富邦-宜蘭,2024-09-09,9686
2543,皇昌,27,1,26,富邦-宜蘭,2024-09-09,9686
2497,怡利電,118,93,25,富邦-宜蘭,2024-09-09,9686
2618,長榮航,33,9,24,富邦-宜蘭,2024-09-09,9686
5460,同協,23,1,22,富邦-宜蘭,2024-09-09,9686
2885,元大金,22,1,21,富邦-宜蘭,2024-09-09,9686
006208,富邦台50,21,0,21,富邦-宜蘭,2024-09-09,9686
6770,力積電,22,1,21,富邦-宜蘭,2024-09-09,9686
3518,柏騰,25,5,20,富邦-宜蘭,2024-09-09,9686
00881,國泰台灣5G+,20,2,18,富邦-宜蘭,2024-09-09,9686
00923,群益台ESG低碳50,17,0,17,富邦-宜蘭,2024-09-09,9686
1314,中石化,80,63,17,富邦-宜蘭,2024-09-09,9686
1711,永光,36,19,17,富邦-宜蘭,2024-09-09,9686
00934,中信成長高股息,22,5,17,富邦-宜蘭,2024-09-09,9686
00665L,富邦�琤肭磪囓�2,71,55,16,富邦-宜蘭,2024-09-09,9686
2330,台積電,21,5,16,富邦-宜蘭,2024-09-09,9686
1326,台化,15,0,15,富邦-宜蘭,2024-09-09,9686
1109,信大,15,0,15,富邦-宜蘭,2024-09-09,9686
00715L,期街口布蘭特正2,24,9,15,富邦-宜蘭,2024-09-09,9686
6739,竹陞科技,22,7,15,富邦-宜蘭,2024-09-09,9686
4720,德淵,15,0,15,富邦-宜蘭,2024-09-09,9686
2303,聯電,28,13,15,富邦-宜蘭,2024-09-09,9686
3673,TPK-KY,17,3,14,富邦-宜蘭,2024-09-09,9686
4571,鈞興-KY,23,9,14,富邦-宜蘭,2024-09-09,9686
00929,復華台灣科技優息,286,20,266,富邦-宜蘭,2024-09-10,9686
00751B,元大AAA至A公司債,105,0,105,富邦-宜蘭,2024-09-10,9686
9945,潤泰新,102,0,102,富邦-宜蘭,2024-09-10,9686
00919,群益台灣精選高息,144,49,95,富邦-宜蘭,2024-09-10,9686
6246,臺龍,71,1,70,富邦-宜蘭,2024-09-10,9686
00878,國泰永續高股息,71,6,65,富邦-宜蘭,2024-09-10,9686
2344,華邦電,67,4,63,富邦-宜蘭,2024-09-10,9686
2539,櫻花建,50,0,50,富邦-宜蘭,2024-09-10,9686
1301,台塑,55,5,50,富邦-宜蘭,2024-09-10,9686
3715,定穎投控,102,57,45,富邦-宜蘭,2024-09-10,9686
00931B,統一美債20年,61,17,44,富邦-宜蘭,2024-09-10,9686
2337,旺宏,48,4,44,富邦-宜蘭,2024-09-10,9686
0056,元大高股息,45,8,37,富邦-宜蘭,2024-09-10,9686
00940,元大台灣價值高息,37,0,37,富邦-宜蘭,2024-09-10,9686
00715L,期街口布蘭特正2,37,2,35,富邦-宜蘭,2024-09-10,9686
00665L,富邦�琤肭磪囓�2,50,16,34,富邦-宜蘭,2024-09-10,9686
00679B,元大美債20年,45,18,27,富邦-宜蘭,2024-09-10,9686
3481,群創,60,35,25,富邦-宜蘭,2024-09-10,9686
00687B,國泰20年美債,33,10,23,富邦-宜蘭,2024-09-10,9686
2382,廣達,34,11,23,富邦-宜蘭,2024-09-10,9686
00948B,中信優息投資級債,52,30,22,富邦-宜蘭,2024-09-10,9686
4303,信立,20,0,20,富邦-宜蘭,2024-09-10,9686
4432,銘旺實,20,0,20,富邦-宜蘭,2024-09-10,9686
00952,凱基台灣AI50,20,0,20,富邦-宜蘭,2024-09-10,9686
6770,力積電,19,1,18,富邦-宜蘭,2024-09-10,9686
3663,鑫科,31,14,17,富邦-宜蘭,2024-09-10,9686
6739,竹陞科技,24,7,17,富邦-宜蘭,2024-09-10,9686
2890,永豐金,16,0,16,富邦-宜蘭,2024-09-10,9686
8150,南茂,16,0,16,富邦-宜蘭,2024-09-10,9686
00692,富邦公司治理,16,1,15,富邦-宜蘭,2024-09-10,9686
3645,達邁,14,0,14,富邦-宜蘭,2024-09-10,9686
00945B,凱基美國非投等債,25,11,14,富邦-宜蘭,2024-09-10,9686
00713,元大台灣高息低波,13,0,13,富邦-宜蘭,2024-09-10,9686
2408,南亞科,14,1,13,富邦-宜蘭,2024-09-10,9686
2317,鴻海,45,32,13,富邦-宜蘭,2024-09-10,9686
00688L,國泰20年美債正2,17,5,12,富邦-宜蘭,2024-09-10,9686
2751,王座,12,0,12,富邦-宜蘭,2024-09-10,9686
2537,聯上發,15,3,12,富邦-宜蘭,2024-09-10,9686
3548,兆利,28,16,12,富邦-宜蘭,2024-09-10,9686
6443,元晶,12,1,11,富邦-宜蘭,2024-09-10,9686
00882,中信中國高股息,11,0,11,富邦-宜蘭,2024-09-10,9686
4510,高鋒,30,19,11,富邦-宜蘭,2024-09-10,9686
1540,喬福,26,15,11,富邦-宜蘭,2024-09-10,9686
2301,光寶科,12,2,10,富邦-宜蘭,2024-09-10,9686
6143,振曜,21,11,10,富邦-宜蘭,2024-09-10,9686
3011,今皓,10,0,10,富邦-宜蘭,2024-09-10,9686
2505,國揚,10,0,10,富邦-宜蘭,2024-09-10,9686
2402,毅嘉,20,10,10,富邦-宜蘭,2024-09-10,9686
1453,大將,12,2,10,富邦-宜蘭,2024-09-10,9686
00902,中信電池及儲能,10,0,10,富邦-宜蘭,2024-09-10,9686
1447,力鵬,105,0,105,富邦-宜蘭,2024-09-11,9686
00650L,復華香港正2,105,0,105,富邦-宜蘭,2024-09-11,9686
00919,群益台灣精選高息,98,11,87,富邦-宜蘭,2024-09-11,9686
00929,復華台灣科技優息,117,44,73,富邦-宜蘭,2024-09-11,9686
00688L,國泰20年美債正2,73,9,64,富邦-宜蘭,2024-09-11,9686
00706L,期元大S＆P日圓正2,65,2,63,富邦-宜蘭,2024-09-11,9686
00959B,大華投等美債15Y+,60,0,60,富邦-宜蘭,2024-09-11,9686
00937B,群益ESG投等債20,106,48,58,富邦-宜蘭,2024-09-11,9686
3715,定穎投控,64,14,50,富邦-宜蘭,2024-09-11,9686
5460,同協,41,1,40,富邦-宜蘭,2024-09-11,9686
2891,中信金,38,2,36,富邦-宜蘭,2024-09-11,9686
1522,堤維西,48,12,36,富邦-宜蘭,2024-09-11,9686
8249,菱光,42,7,35,富邦-宜蘭,2024-09-11,9686
00878,國泰永續高股息,52,17,35,富邦-宜蘭,2024-09-11,9686
00940,元大台灣價值高息,34,0,34,富邦-宜蘭,2024-09-11,9686
3047,訊舟,42,11,31,富邦-宜蘭,2024-09-11,9686
2409,友達,34,7,27,富邦-宜蘭,2024-09-11,9686
00915,凱基優選高股息30,23,0,23,富邦-宜蘭,2024-09-11,9686
5880,合庫金,23,0,23,富邦-宜蘭,2024-09-11,9686
6257,矽格,23,0,23,富邦-宜蘭,2024-09-11,9686
1536,和大,25,3,22,富邦-宜蘭,2024-09-11,9686
3481,群創,52,31,21,富邦-宜蘭,2024-09-11,9686
00687B,國泰20年美債,41,20,21,富邦-宜蘭,2024-09-11,9686
4956,光鋐,25,4,21,富邦-宜蘭,2024-09-11,9686
00713,元大台灣高息低波,21,0,21,富邦-宜蘭,2024-09-11,9686
5481,新華,20,0,20,富邦-宜蘭,2024-09-11,9686
3050,鈺德,20,0,20,富邦-宜蘭,2024-09-11,9686
6727,亞泰金屬,20,0,20,富邦-宜蘭,2024-09-11,9686
00936,台新永續高息中小,20,0,20,富邦-宜蘭,2024-09-11,9686
6216,居易,38,19,19,富邦-宜蘭,2024-09-11,9686
2362,藍天,19,0,19,富邦-宜蘭,2024-09-11,9686
6282,康舒,20,1,19,富邦-宜蘭,2024-09-11,9686
2497,怡利電,124,106,18,富邦-宜蘭,2024-09-11,9686
2399,映泰,113,95,18,富邦-宜蘭,2024-09-11,9686
00918,大華優利高填息30,16,0,16,富邦-宜蘭,2024-09-11,9686
00900,富邦特選高股息30,17,1,16,富邦-宜蘭,2024-09-11,9686
1452,宏益,73,57,16,富邦-宜蘭,2024-09-11,9686
00679B,元大美債20年,33,17,16,富邦-宜蘭,2024-09-11,9686
2520,冠德,16,0,16,富邦-宜蘭,2024-09-11,9686
2002,中鋼,18,3,15,富邦-宜蘭,2024-09-11,9686
2353,宏��,14,0,14,富邦-宜蘭,2024-09-11,9686
2887,台新金,14,0,14,富邦-宜蘭,2024-09-11,9686
2539,櫻花建,13,0,13,富邦-宜蘭,2024-09-11,9686
9945,潤泰新,13,0,13,富邦-宜蘭,2024-09-11,9686
5483,中美晶,13,1,12,富邦-宜蘭,2024-09-11,9686
4903,聯光通,18,6,12,富邦-宜蘭,2024-09-11,9686
3707,漢磊,17,5,12,富邦-宜蘭,2024-09-11,9686
910861,神州-DR,12,0,12,富邦-宜蘭,2024-09-11,9686
00753L,中信中國50正2,15,4,11,富邦-宜蘭,2024-09-11,9686
2408,南亞科,12,2,10,富邦-宜蘭,2024-09-11,9686
00665L,富邦�琤肭磪囓�2,111,7,104,富邦-宜蘭,2024-09-12,9686
00878,國泰永續高股息,107,7,100,富邦-宜蘭,2024-09-12,9686
00918,大華優利高填息30,100,8,92,富邦-宜蘭,2024-09-12,9686
00751B,元大AAA至A公司債,75,0,75,富邦-宜蘭,2024-09-12,9686
2891,中信金,65,1,64,富邦-宜蘭,2024-09-12,9686
8032,光菱,53,3,50,富邦-宜蘭,2024-09-12,9686
00676R,富邦臺灣加權反1,50,0,50,富邦-宜蘭,2024-09-12,9686
00919,群益台灣精選高息,94,45,49,富邦-宜蘭,2024-09-12,9686
3049,精金,47,0,47,富邦-宜蘭,2024-09-12,9686
00632R,元大台灣50反1,43,0,43,富邦-宜蘭,2024-09-12,9686
2313,華通,68,29,39,富邦-宜蘭,2024-09-12,9686
00688L,國泰20年美債正2,43,6,37,富邦-宜蘭,2024-09-12,9686
5438,東友,66,31,35,富邦-宜蘭,2024-09-12,9686
2539,櫻花建,30,0,30,富邦-宜蘭,2024-09-12,9686
00664R,國泰臺灣加權反1,25,0,25,富邦-宜蘭,2024-09-12,9686
3481,群創,30,6,24,富邦-宜蘭,2024-09-12,9686
2344,華邦電,24,1,23,富邦-宜蘭,2024-09-12,9686
4563,百德,27,7,20,富邦-宜蘭,2024-09-12,9686
2405,輔信,30,10,20,富邦-宜蘭,2024-09-12,9686
2406,國碩,20,0,20,富邦-宜蘭,2024-09-12,9686
6770,力積電,17,0,17,富邦-宜蘭,2024-09-12,9686
2367,燿華,18,3,15,富邦-宜蘭,2024-09-12,9686
3229,晟鈦,14,0,14,富邦-宜蘭,2024-09-12,9686
00679B,元大美債20年,44,32,12,富邦-宜蘭,2024-09-12,9686
5475,德宏,12,0,12,富邦-宜蘭,2024-09-12,9686
2637,慧洋-KY,12,0,12,富邦-宜蘭,2024-09-12,9686
1303,南亞,12,1,11,富邦-宜蘭,2024-09-12,9686
6134,萬旭,63,52,11,富邦-宜蘭,2024-09-12,9686
3437,榮創,11,0,11,富邦-宜蘭,2024-09-12,9686
2887,台新金,18,8,10,富邦-宜蘭,2024-09-12,9686
00680L,元大美債20正2,27,16,11,富邦-宜蘭,2024-09-12,9686
00637L,元大滬深300正2,20,10,10,富邦-宜蘭,2024-09-12,9686
2498,宏達電,10,0,10,富邦-宜蘭,2024-09-12,9686
3673,TPK-KY,15,5,10,富邦-宜蘭,2024-09-12,9686
3379,彬台,10,1,9,富邦-宜蘭,2024-09-12,9686
00881,國泰台灣5G+,15,6,9,富邦-宜蘭,2024-09-12,9686
3567,逸昌,9,0,9,富邦-宜蘭,2024-09-12,9686
6257,矽格,9,0,9,富邦-宜蘭,2024-09-12,9686
6194,育富,15,7,8,富邦-宜蘭,2024-09-12,9686
3715,定穎投控,13,5,8,富邦-宜蘭,2024-09-12,9686
3303,岱稜,77,70,7,富邦-宜蘭,2024-09-12,9686
2540,愛山林,11,4,7,富邦-宜蘭,2024-09-12,9686
00915,凱基優選高股息30,28,21,7,富邦-宜蘭,2024-09-12,9686
5905,南仁湖,98,91,7,富邦-宜蘭,2024-09-12,9686
6120,達運,10,3,7,富邦-宜蘭,2024-09-12,9686
8028,昇陽半導體,11,4,7,富邦-宜蘭,2024-09-12,9686
3580,友威科,9,2,7,富邦-宜蘭,2024-09-12,9686
5443,均豪,98,91,7,富邦-宜蘭,2024-09-12,9686
2312,金寶,7,0,7,富邦-宜蘭,2024-09-12,9686
2884,玉山金,8,1,7,富邦-宜蘭,2024-09-12,9686
2883,凱基金,802,8,794,富邦-宜蘭,2024-09-13,9686
00937B,群益ESG投等債20,165,70,95,富邦-宜蘭,2024-09-13,9686
00919,群益台灣精選高息,114,27,87,富邦-宜蘭,2024-09-13,9686
00948B,中信優息投資級債,63,2,61,富邦-宜蘭,2024-09-13,9686
5905,南仁湖,117,57,60,富邦-宜蘭,2024-09-13,9686
00905,FT臺灣Smart,58,1,57,富邦-宜蘭,2024-09-13,9686
00929,復華台灣科技優息,66,11,55,富邦-宜蘭,2024-09-13,9686
00712,復華富時不動產,54,1,53,富邦-宜蘭,2024-09-13,9686
00959B,大華投等美債15Y+,46,0,46,富邦-宜蘭,2024-09-13,9686
5438,東友,45,0,45,富邦-宜蘭,2024-09-13,9686
00632R,元大台灣50反1,35,0,35,富邦-宜蘭,2024-09-13,9686
00933B,國泰10Y+金融債,33,0,33,富邦-宜蘭,2024-09-13,9686
2303,聯電,31,0,31,富邦-宜蘭,2024-09-13,9686
4933,友輝,34,3,31,富邦-宜蘭,2024-09-13,9686
00665L,富邦�琤肭磪囓�2,32,3,29,富邦-宜蘭,2024-09-13,9686
1540,喬福,58,31,27,富邦-宜蘭,2024-09-13,9686
6116,彩晶,28,1,27,富邦-宜蘭,2024-09-13,9686
6257,矽格,31,4,27,富邦-宜蘭,2024-09-13,9686
00946,群益科技高息成長,24,0,24,富邦-宜蘭,2024-09-13,9686
2891,中信金,28,4,24,富邦-宜蘭,2024-09-13,9686
4562,穎漢,25,2,23,富邦-宜蘭,2024-09-13,9686
8032,光菱,23,0,23,富邦-宜蘭,2024-09-13,9686
1711,永光,40,19,21,富邦-宜蘭,2024-09-13,9686
1734,杏輝,20,0,20,富邦-宜蘭,2024-09-13,9686
2897,王道銀行,20,0,20,富邦-宜蘭,2024-09-13,9686
6239,力成,20,0,20,富邦-宜蘭,2024-09-13,9686
3535,晶彩科,23,4,19,富邦-宜蘭,2024-09-13,9686
2520,冠德,19,0,19,富邦-宜蘭,2024-09-13,9686
6216,居易,20,2,18,富邦-宜蘭,2024-09-13,9686
8011,台通,16,0,16,富邦-宜蘭,2024-09-13,9686
00642U,期元大S＆P石油,15,0,15,富邦-宜蘭,2024-09-13,9686
3518,柏騰,13,0,13,富邦-宜蘭,2024-09-13,9686
00674R,期元大S＆P黃金反1,12,0,12,富邦-宜蘭,2024-09-13,9686
00930,永豐ESG低碳高息,11,0,11,富邦-宜蘭,2024-09-13,9686
6405,悅城,13,2,11,富邦-宜蘭,2024-09-13,9686
00692,富邦公司治理,11,0,11,富邦-宜蘭,2024-09-13,9686
0056,元大高股息,14,4,10,富邦-宜蘭,2024-09-13,9686
00713,元大台灣高息低波,10,0,10,富邦-宜蘭,2024-09-13,9686
8390,金益鼎,55,45,10,富邦-宜蘭,2024-09-13,9686
1710,東聯,10,0,10,富邦-宜蘭,2024-09-13,9686
5283,禾聯碩,10,0,10,富邦-宜蘭,2024-09-13,9686
2204,中華,10,0,10,富邦-宜蘭,2024-09-13,9686
00751B,元大AAA至A公司債,11,1,10,富邦-宜蘭,2024-09-13,9686
6290,良維,12,2,10,富邦-宜蘭,2024-09-13,9686
910861,神州-DR,10,0,10,富邦-宜蘭,2024-09-13,9686
3149,正達,33,23,10,富邦-宜蘭,2024-09-13,9686
3019,亞光,33,24,9,富邦-宜蘭,2024-09-13,9686
1309,台達化,9,0,9,富邦-宜蘭,2024-09-13,9686
1452,宏益,90,81,9,富邦-宜蘭,2024-09-13,9686
00918,大華優利高填息30,8,0,8,富邦-宜蘭,2024-09-13,9686
00713,元大台灣高息低波,342,1,341,富邦-宜蘭,2024-09-16,9686
00687B,國泰20年美債,325,8,317,富邦-宜蘭,2024-09-16,9686
00948B,中信優息投資級債,222,0,222,富邦-宜蘭,2024-09-16,9686
1217,愛之味,162,0,162,富邦-宜蘭,2024-09-16,9686
00919,群益台灣精選高息,122,2,120,富邦-宜蘭,2024-09-16,9686
00753L,中信中國50正2,120,0,120,富邦-宜蘭,2024-09-16,9686
3047,訊舟,65,5,60,富邦-宜蘭,2024-09-16,9686
00751B,元大AAA至A公司債,58,0,58,富邦-宜蘭,2024-09-16,9686
2349,錸德,116,60,56,富邦-宜蘭,2024-09-16,9686
00706L,期元大S＆P日圓正2,50,0,50,富邦-宜蘭,2024-09-16,9686
00929,復華台灣科技優息,55,9,46,富邦-宜蘭,2024-09-16,9686
1711,永光,78,35,43,富邦-宜蘭,2024-09-16,9686
2891,中信金,40,1,39,富邦-宜蘭,2024-09-16,9686
2344,華邦電,41,2,39,富邦-宜蘭,2024-09-16,9686
00945B,凱基美國非投等債,36,0,36,富邦-宜蘭,2024-09-16,9686
5460,同協,39,5,34,富邦-宜蘭,2024-09-16,9686
00688L,國泰20年美債正2,34,0,34,富邦-宜蘭,2024-09-16,9686
8039,台虹,48,15,33,富邦-宜蘭,2024-09-16,9686
2303,聯電,53,21,32,富邦-宜蘭,2024-09-16,9686
00665L,富邦�琤肭磪囓�2,62,31,31,富邦-宜蘭,2024-09-16,9686
6134,萬旭,34,3,31,富邦-宜蘭,2024-09-16,9686
8071,能率網通,31,0,31,富邦-宜蘭,2024-09-16,9686
3354,律勝,36,6,30,富邦-宜蘭,2024-09-16,9686
00680L,元大美債20正2,36,8,28,富邦-宜蘭,2024-09-16,9686
5230,雷笛克光學,60,33,27,富邦-宜蘭,2024-09-16,9686
00918,大華優利高填息30,25,0,25,富邦-宜蘭,2024-09-16,9686
6443,元晶,24,3,21,富邦-宜蘭,2024-09-16,9686
00943,兆豐電子高息等權,31,11,20,富邦-宜蘭,2024-09-16,9686
00650L,復華香港正2,20,0,20,富邦-宜蘭,2024-09-16,9686
2033,佳大,20,1,19,富邦-宜蘭,2024-09-16,9686
00937B,群益ESG投等債20,17,0,17,富邦-宜蘭,2024-09-16,9686
00712,復華富時不動產,22,5,17,富邦-宜蘭,2024-09-16,9686
1537,廣隆,16,0,16,富邦-宜蘭,2024-09-16,9686
4510,高鋒,26,11,15,富邦-宜蘭,2024-09-16,9686
910861,神州-DR,15,0,15,富邦-宜蘭,2024-09-16,9686
3050,鈺德,14,0,14,富邦-宜蘭,2024-09-16,9686
8374,羅昇,21,8,13,富邦-宜蘭,2024-09-16,9686
2340,台亞,19,6,13,富邦-宜蘭,2024-09-16,9686
1710,東聯,12,0,12,富邦-宜蘭,2024-09-16,9686
3607,谷崧,13,1,12,富邦-宜蘭,2024-09-16,9686
3147,大綜,13,1,12,富邦-宜蘭,2024-09-16,9686
4534,慶騰,12,0,12,富邦-宜蘭,2024-09-16,9686
3048,益登,12,1,11,富邦-宜蘭,2024-09-16,9686
2609,陽明,12,1,11,富邦-宜蘭,2024-09-16,9686
9955,佳龍,11,0,11,富邦-宜蘭,2024-09-16,9686
6290,良維,13,2,11,富邦-宜蘭,2024-09-16,9686
2233,宇隆,11,1,10,富邦-宜蘭,2024-09-16,9686
8086,宏捷科,10,0,10,富邦-宜蘭,2024-09-16,9686
3360,尚立,17,7,10,富邦-宜蘭,2024-09-16,9686
3303,岱稜,13,3,10,富邦-宜蘭,2024-09-16,9686
00696B,富邦美債20年,501,17,484,富邦-宜蘭,2024-09-18,9686
00929,復華台灣科技優息,456,34,422,富邦-宜蘭,2024-09-18,9686
00679B,元大美債20年,308,16,292,富邦-宜蘭,2024-09-18,9686
00915,凱基優選高股息30,167,1,166,富邦-宜蘭,2024-09-18,9686
2344,華邦電,163,1,162,富邦-宜蘭,2024-09-18,9686
00919,群益台灣精選高息,183,31,152,富邦-宜蘭,2024-09-18,9686
2845,遠東銀,140,0,140,富邦-宜蘭,2024-09-18,9686
3049,精金,111,7,104,富邦-宜蘭,2024-09-18,9686
00665L,富邦�琤肭磪囓�2,120,19,101,富邦-宜蘭,2024-09-18,9686
00918,大華優利高填息30,98,6,92,富邦-宜蘭,2024-09-18,9686
1314,中石化,89,6,83,富邦-宜蘭,2024-09-18,9686
00720B,元大投資級公司債,100,40,60,富邦-宜蘭,2024-09-18,9686
2033,佳大,62,5,57,富邦-宜蘭,2024-09-18,9686
00937B,群益ESG投等債20,137,83,54,富邦-宜蘭,2024-09-18,9686
00878,國泰永續高股息,59,7,52,富邦-宜蘭,2024-09-18,9686
3550,聯穎,65,15,50,富邦-宜蘭,2024-09-18,9686
8074,鉅橡,48,2,46,富邦-宜蘭,2024-09-18,9686
3455,由田,45,0,45,富邦-宜蘭,2024-09-18,9686
2317,鴻海,58,13,45,富邦-宜蘭,2024-09-18,9686
2313,華通,41,5,36,富邦-宜蘭,2024-09-18,9686
00945B,凱基美國非投等債,32,0,32,富邦-宜蘭,2024-09-18,9686
0056,元大高股息,32,1,31,富邦-宜蘭,2024-09-18,9686
00857B,永豐20年美公債,30,1,29,富邦-宜蘭,2024-09-18,9686
00933B,國泰10Y+金融債,32,5,27,富邦-宜蘭,2024-09-18,9686
00713,元大台灣高息低波,27,1,26,富邦-宜蘭,2024-09-18,9686
00712,復華富時不動產,27,3,24,富邦-宜蘭,2024-09-18,9686
1710,東聯,22,0,22,富邦-宜蘭,2024-09-18,9686
4933,友輝,29,7,22,富邦-宜蘭,2024-09-18,9686
00927,群益半導體收益,71,50,21,富邦-宜蘭,2024-09-18,9686
3481,群創,70,49,21,富邦-宜蘭,2024-09-18,9686
00676R,富邦臺灣加權反1,20,0,20,富邦-宜蘭,2024-09-18,9686
00637L,元大滬深300正2,20,0,20,富邦-宜蘭,2024-09-18,9686
8011,台通,23,3,20,富邦-宜蘭,2024-09-18,9686
2449,京元電子,20,1,19,富邦-宜蘭,2024-09-18,9686
2324,仁寶,20,2,18,富邦-宜蘭,2024-09-18,9686
2062,橋椿,20,2,18,富邦-宜蘭,2024-09-18,9686
00930,永豐ESG低碳高息,17,0,17,富邦-宜蘭,2024-09-18,9686
00943,兆豐電子高息等權,16,0,16,富邦-宜蘭,2024-09-18,9686
00688L,國泰20年美債正2,40,25,15,富邦-宜蘭,2024-09-18,9686
6216,居易,17,2,15,富邦-宜蘭,2024-09-18,9686
00934,中信成長高股息,19,5,14,富邦-宜蘭,2024-09-18,9686
1307,三芳,14,0,14,富邦-宜蘭,2024-09-18,9686
2393,億光,14,0,14,富邦-宜蘭,2024-09-18,9686
00633L,富邦上証正2,14,0,14,富邦-宜蘭,2024-09-18,9686
00946,群益科技高息成長,14,0,14,富邦-宜蘭,2024-09-18,9686
00881,國泰台灣5G+,13,0,13,富邦-宜蘭,2024-09-18,9686
6609,瀧澤科,58,45,13,富邦-宜蘭,2024-09-18,9686
2889,國票金,13,0,13,富邦-宜蘭,2024-09-18,9686
2477,美隆電,32,20,12,富邦-宜蘭,2024-09-18,9686
2634,漢翔,14,2,12,富邦-宜蘭,2024-09-18,9686
2891,中信金,309,23,286,富邦-宜蘭,2024-09-19,9686
00919,群益台灣精選高息,193,3,190,富邦-宜蘭,2024-09-19,9686
00929,復華台灣科技優息,117,9,108,富邦-宜蘭,2024-09-19,9686
9105,泰金寶-DR,108,1,107,富邦-宜蘭,2024-09-19,9686
00712,復華富時不動產,100,6,94,富邦-宜蘭,2024-09-19,9686
00937B,群益ESG投等債20,91,10,81,富邦-宜蘭,2024-09-19,9686
00706L,期元大S＆P日圓正2,61,0,61,富邦-宜蘭,2024-09-19,9686
6288,聯嘉,87,44,43,富邦-宜蘭,2024-09-19,9686
00958B,永豐ESG銀行債15,43,0,43,富邦-宜蘭,2024-09-19,9686
8071,能率網通,41,0,41,富邦-宜蘭,2024-09-19,9686
3481,群創,66,29,37,富邦-宜蘭,2024-09-19,9686
00878,國泰永續高股息,55,20,35,富邦-宜蘭,2024-09-19,9686
2303,聯電,33,2,31,富邦-宜蘭,2024-09-19,9686
00915,凱基優選高股息30,39,10,29,富邦-宜蘭,2024-09-19,9686
00680L,元大美債20正2,35,6,29,富邦-宜蘭,2024-09-19,9686
00740B,富邦全球投等債,39,10,29,富邦-宜蘭,2024-09-19,9686
4510,高鋒,43,14,29,富邦-宜蘭,2024-09-19,9686
00918,大華優利高填息30,31,4,27,富邦-宜蘭,2024-09-19,9686
3049,精金,223,200,23,富邦-宜蘭,2024-09-19,9686
5701,劍湖山,22,0,22,富邦-宜蘭,2024-09-19,9686
1540,喬福,63,42,21,富邦-宜蘭,2024-09-19,9686
00952,凱基台灣AI50,20,0,20,富邦-宜蘭,2024-09-19,9686
3003,健和興,21,1,20,富邦-宜蘭,2024-09-19,9686
2349,錸德,95,77,18,富邦-宜蘭,2024-09-19,9686
3031,佰鴻,17,0,17,富邦-宜蘭,2024-09-19,9686
00923,群益台ESG低碳50,17,1,16,富邦-宜蘭,2024-09-19,9686
8421,旭源,21,5,16,富邦-宜蘭,2024-09-19,9686
3596,智易,15,0,15,富邦-宜蘭,2024-09-19,9686
00724B,群益投資級金融債,15,0,15,富邦-宜蘭,2024-09-19,9686
00713,元大台灣高息低波,17,3,14,富邦-宜蘭,2024-09-19,9686
00885,富邦越南,15,1,14,富邦-宜蘭,2024-09-19,9686
3303,岱稜,15,1,14,富邦-宜蘭,2024-09-19,9686
2022,聚亨,15,2,13,富邦-宜蘭,2024-09-19,9686
3217,優群,12,0,12,富邦-宜蘭,2024-09-19,9686
2344,華邦電,16,5,11,富邦-宜蘭,2024-09-19,9686
00933B,國泰10Y+金融債,21,10,11,富邦-宜蘭,2024-09-19,9686
2337,旺宏,12,1,11,富邦-宜蘭,2024-09-19,9686
2449,京元電子,13,2,11,富邦-宜蘭,2024-09-19,9686
3230,錦明,41,30,11,富邦-宜蘭,2024-09-19,9686
4526,東台,30,19,11,富邦-宜蘭,2024-09-19,9686
4939,亞電,11,0,11,富邦-宜蘭,2024-09-19,9686
2243,宏旭-KY,34,23,11,富邦-宜蘭,2024-09-19,9686
2312,金寶,12,1,11,富邦-宜蘭,2024-09-19,9686
910861,神州-DR,11,0,11,富邦-宜蘭,2024-09-19,9686
3011,今皓,10,0,10,富邦-宜蘭,2024-09-19,9686
2106,建大,10,0,10,富邦-宜蘭,2024-09-19,9686
5460,同協,12,2,10,富邦-宜蘭,2024-09-19,9686
3033,威健,11,1,10,富邦-宜蘭,2024-09-19,9686
2429,銘旺科,9,0,9,富邦-宜蘭,2024-09-19,9686
6405,悅城,11,2,9,富邦-宜蘭,2024-09-19,9686
00919,群益台灣精選高息,551,82,469,富邦-宜蘭,2024-09-20,9686
1785,光洋科,179,65,114,富邦-宜蘭,2024-09-20,9686
00905,FT臺灣Smart,101,0,101,富邦-宜蘭,2024-09-20,9686
2888,新光金,168,74,94,富邦-宜蘭,2024-09-20,9686
00878,國泰永續高股息,103,34,69,富邦-宜蘭,2024-09-20,9686
2520,冠德,60,1,59,富邦-宜蘭,2024-09-20,9686
1709,和益,64,5,59,富邦-宜蘭,2024-09-20,9686
8074,鉅橡,84,25,59,富邦-宜蘭,2024-09-20,9686
00676R,富邦臺灣加權反1,56,0,56,富邦-宜蘭,2024-09-20,9686
1446,宏和,49,0,49,富邦-宜蘭,2024-09-20,9686
3060,銘異,50,2,48,富邦-宜蘭,2024-09-20,9686
3062,建漢,98,57,41,富邦-宜蘭,2024-09-20,9686
4714,永捷,51,12,39,富邦-宜蘭,2024-09-20,9686
2867,三商壽,39,0,39,富邦-宜蘭,2024-09-20,9686
00637L,元大滬深300正2,47,10,37,富邦-宜蘭,2024-09-20,9686
1721,三晃,54,18,36,富邦-宜蘭,2024-09-20,9686
00958B,永豐ESG銀行債15,39,3,36,富邦-宜蘭,2024-09-20,9686
4729,熒茂,61,25,36,富邦-宜蘭,2024-09-20,9686
00632R,元大台灣50反1,32,0,32,富邦-宜蘭,2024-09-20,9686
00795B,中信美國公債20年,32,0,32,富邦-宜蘭,2024-09-20,9686
6288,聯嘉,44,13,31,富邦-宜蘭,2024-09-20,9686
00671R,富邦NASDAQ反1,30,0,30,富邦-宜蘭,2024-09-20,9686
00764B,群益25年美債,30,0,30,富邦-宜蘭,2024-09-20,9686
2038,海光,30,1,29,富邦-宜蘭,2024-09-20,9686
2885,元大金,29,0,29,富邦-宜蘭,2024-09-20,9686
2543,皇昌,30,2,28,富邦-宜蘭,2024-09-20,9686
2101,南港,32,5,27,富邦-宜蘭,2024-09-20,9686
00915,凱基優選高股息30,27,2,25,富邦-宜蘭,2024-09-20,9686
3266,昇陽,25,0,25,富邦-宜蘭,2024-09-20,9686
3567,逸昌,24,0,24,富邦-宜蘭,2024-09-20,9686
2889,國票金,23,0,23,富邦-宜蘭,2024-09-20,9686
00680L,元大美債20正2,37,14,23,富邦-宜蘭,2024-09-20,9686
1316,上曜,27,5,22,富邦-宜蘭,2024-09-20,9686
4561,健椿,28,7,21,富邦-宜蘭,2024-09-20,9686
6276,安鈦克,20,0,20,富邦-宜蘭,2024-09-20,9686
2002,中鋼,20,1,19,富邦-宜蘭,2024-09-20,9686
2545,皇翔,22,3,19,富邦-宜蘭,2024-09-20,9686
4956,光鋐,29,10,19,富邦-宜蘭,2024-09-20,9686
3390,旭軟,19,1,18,富邦-宜蘭,2024-09-20,9686
2204,中華,16,0,16,富邦-宜蘭,2024-09-20,9686
2542,興富發,39,23,16,富邦-宜蘭,2024-09-20,9686
6148,驊宏資,17,2,15,富邦-宜蘭,2024-09-20,9686
3360,尚立,15,0,15,富邦-宜蘭,2024-09-20,9686
5202,力新,15,1,14,富邦-宜蘭,2024-09-20,9686
4707,磐亞,14,0,14,富邦-宜蘭,2024-09-20,9686
2388,威盛,29,16,13,富邦-宜蘭,2024-09-20,9686
8011,台通,17,4,13,富邦-宜蘭,2024-09-20,9686
3550,聯穎,15,2,13,富邦-宜蘭,2024-09-20,9686
4306,炎洲,14,1,13,富邦-宜蘭,2024-09-20,9686
2349,錸德,22,10,12,富邦-宜蘭,2024-09-20,9686
2891,中信金,376,235,141,富邦-宜蘭,2024-09-23,9686
1711,永光,188,53,135,富邦-宜蘭,2024-09-23,9686
00632R,元大台灣50反1,99,0,99,富邦-宜蘭,2024-09-23,9686
00919,群益台灣精選高息,136,45,91,富邦-宜蘭,2024-09-23,9686
1314,中石化,101,16,85,富邦-宜蘭,2024-09-23,9686
00929,復華台灣科技優息,86,10,76,富邦-宜蘭,2024-09-23,9686
2888,新光金,144,84,60,富邦-宜蘭,2024-09-23,9686
6506,雙邦,51,0,51,富邦-宜蘭,2024-09-23,9686
8926,台汽電,50,0,50,富邦-宜蘭,2024-09-23,9686
00878,國泰永續高股息,60,13,47,富邦-宜蘭,2024-09-23,9686
00687B,國泰20年美債,69,29,40,富邦-宜蘭,2024-09-23,9686
00945B,凱基美國非投等債,35,0,35,富邦-宜蘭,2024-09-23,9686
2495,普安,37,2,35,富邦-宜蘭,2024-09-23,9686
2515,中工,38,3,35,富邦-宜蘭,2024-09-23,9686
3234,光環,32,1,31,富邦-宜蘭,2024-09-23,9686
3550,聯穎,32,2,30,富邦-宜蘭,2024-09-23,9686
2464,盟立,35,6,29,富邦-宜蘭,2024-09-23,9686
2426,鼎元,30,1,29,富邦-宜蘭,2024-09-23,9686
3049,精金,115,86,29,富邦-宜蘭,2024-09-23,9686
2520,冠德,33,5,28,富邦-宜蘭,2024-09-23,9686
1536,和大,57,32,25,富邦-宜蘭,2024-09-23,9686
0056,元大高股息,26,1,25,富邦-宜蘭,2024-09-23,9686
00931B,統一美債20年,25,0,25,富邦-宜蘭,2024-09-23,9686
00958B,永豐ESG銀行債15,22,0,22,富邦-宜蘭,2024-09-23,9686
2409,友達,23,2,21,富邦-宜蘭,2024-09-23,9686
00937B,群益ESG投等債20,36,15,21,富邦-宜蘭,2024-09-23,9686
1734,杏輝,21,0,21,富邦-宜蘭,2024-09-23,9686
3062,建漢,29,8,21,富邦-宜蘭,2024-09-23,9686
6177,達麗,22,2,20,富邦-宜蘭,2024-09-23,9686
2915,潤泰全,20,0,20,富邦-宜蘭,2024-09-23,9686
3257,虹冠電,20,0,20,富邦-宜蘭,2024-09-23,9686
6770,力積電,20,0,20,富邦-宜蘭,2024-09-23,9686
00795B,中信美國公債20年,19,0,19,富邦-宜蘭,2024-09-23,9686
8011,台通,18,0,18,富邦-宜蘭,2024-09-23,9686
4711,永純,24,6,18,富邦-宜蘭,2024-09-23,9686
00688L,國泰20年美債正2,17,0,17,富邦-宜蘭,2024-09-23,9686
6288,聯嘉,25,10,15,富邦-宜蘭,2024-09-23,9686
3149,正達,32,18,14,富邦-宜蘭,2024-09-23,9686
3048,益登,23,11,12,富邦-宜蘭,2024-09-23,9686
3581,博磊,27,15,12,富邦-宜蘭,2024-09-23,9686
2371,大同,12,0,12,富邦-宜蘭,2024-09-23,9686
2367,燿華,12,0,12,富邦-宜蘭,2024-09-23,9686
6727,亞泰金屬,12,0,12,富邦-宜蘭,2024-09-23,9686
3481,群創,100,89,11,富邦-宜蘭,2024-09-23,9686
2449,京元電子,17,6,11,富邦-宜蘭,2024-09-23,9686
5230,雷笛克光學,31,20,11,富邦-宜蘭,2024-09-23,9686
00885,富邦越南,11,0,11,富邦-宜蘭,2024-09-23,9686
00900,富邦特選高股息30,10,0,10,富邦-宜蘭,2024-09-23,9686
2374,佳能,10,0,10,富邦-宜蘭,2024-09-23,9686
4934,太極,10,0,10,富邦-宜蘭,2024-09-23,9686
00882,中信中國高股息,167,23,144,富邦-宜蘭,2024-09-24,9686
6506,雙邦,130,1,129,富邦-宜蘭,2024-09-24,9686
00632R,元大台灣50反1,112,0,112,富邦-宜蘭,2024-09-24,9686
2601,益航,104,1,103,富邦-宜蘭,2024-09-24,9686
00960,野村全球航運龍頭,111,18,93,富邦-宜蘭,2024-09-24,9686
2891,中信金,123,36,87,富邦-宜蘭,2024-09-24,9686
00687B,國泰20年美債,85,4,81,富邦-宜蘭,2024-09-24,9686
00929,復華台灣科技優息,83,3,80,富邦-宜蘭,2024-09-24,9686
5905,南仁湖,87,7,80,富邦-宜蘭,2024-09-24,9686
6109,亞元,85,5,80,富邦-宜蘭,2024-09-24,9686
00712,復華富時不動產,77,7,70,富邦-宜蘭,2024-09-24,9686
2888,新光金,51,10,41,富邦-宜蘭,2024-09-24,9686
5608,四維航,51,11,40,富邦-宜蘭,2024-09-24,9686
3049,精金,81,45,36,富邦-宜蘭,2024-09-24,9686
8926,台汽電,35,0,35,富邦-宜蘭,2024-09-24,9686
2344,華邦電,37,3,34,富邦-宜蘭,2024-09-24,9686
2062,橋椿,36,2,34,富邦-宜蘭,2024-09-24,9686
3066,李洲,91,57,34,富邦-宜蘭,2024-09-24,9686
3605,宏致,39,6,33,富邦-宜蘭,2024-09-24,9686
2349,錸德,100,68,32,富邦-宜蘭,2024-09-24,9686
2611,志信,31,0,31,富邦-宜蘭,2024-09-24,9686
00664R,國泰臺灣加權反1,30,0,30,富邦-宜蘭,2024-09-24,9686
1776,展宇,31,1,30,富邦-宜蘭,2024-09-24,9686
0056,元大高股息,29,0,29,富邦-宜蘭,2024-09-24,9686
5460,同協,32,5,27,富邦-宜蘭,2024-09-24,9686
8255,朋程,26,0,26,富邦-宜蘭,2024-09-24,9686
3715,定穎投控,137,112,25,富邦-宜蘭,2024-09-24,9686
8240,華宏,36,12,24,富邦-宜蘭,2024-09-24,9686
1524,耿鼎,26,3,23,富邦-宜蘭,2024-09-24,9686
1522,堤維西,24,2,22,富邦-宜蘭,2024-09-24,9686
00878,國泰永續高股息,25,5,20,富邦-宜蘭,2024-09-24,9686
2605,新興,25,5,20,富邦-宜蘭,2024-09-24,9686
2612,中航,20,0,20,富邦-宜蘭,2024-09-24,9686
00671R,富邦NASDAQ反1,20,0,20,富邦-宜蘭,2024-09-24,9686
5398,慕康生醫,25,5,20,富邦-宜蘭,2024-09-24,9686
8096,擎亞,19,0,19,富邦-宜蘭,2024-09-24,9686
2515,中工,20,1,19,富邦-宜蘭,2024-09-24,9686
00650L,復華香港正2,74,56,18,富邦-宜蘭,2024-09-24,9686
00937B,群益ESG投等債20,21,4,17,富邦-宜蘭,2024-09-24,9686
5425,台半,19,3,16,富邦-宜蘭,2024-09-24,9686
6770,力積電,17,1,16,富邦-宜蘭,2024-09-24,9686
3481,群創,32,16,16,富邦-宜蘭,2024-09-24,9686
00751B,元大AAA至A公司債,16,1,15,富邦-宜蘭,2024-09-24,9686
8473,山林水,15,0,15,富邦-宜蘭,2024-09-24,9686
00680L,元大美債20正2,35,20,15,富邦-宜蘭,2024-09-24,9686
6196,帆宣,15,0,15,富邦-宜蘭,2024-09-24,9686
2606,裕民,15,0,15,富邦-宜蘭,2024-09-24,9686
00946,群益科技高息成長,14,0,14,富邦-宜蘭,2024-09-24,9686
4916,事欣科,14,0,14,富邦-宜蘭,2024-09-24,9686
4711,永純,14,0,14,富邦-宜蘭,2024-09-24,9686
4934,太極,84,0,84,富邦-宜蘭,2024-09-25,9686
00753L,中信中國50正2,101,28,73,富邦-宜蘭,2024-09-25,9686
4530,宏易,70,0,70,富邦-宜蘭,2024-09-25,9686
4903,聯光通,84,22,62,富邦-宜蘭,2024-09-25,9686
1584,精剛,63,4,59,富邦-宜蘭,2024-09-25,9686
3481,群創,92,33,59,富邦-宜蘭,2024-09-25,9686
00795B,中信美國公債20年,60,2,58,富邦-宜蘭,2024-09-25,9686
3062,建漢,84,30,54,富邦-宜蘭,2024-09-25,9686
2613,中櫃,57,5,52,富邦-宜蘭,2024-09-25,9686
00948B,中信優息投資級債,50,0,50,富邦-宜蘭,2024-09-25,9686
00679B,元大美債20年,64,18,46,富邦-宜蘭,2024-09-25,9686
00688L,國泰20年美債正2,42,0,42,富邦-宜蘭,2024-09-25,9686
2344,華邦電,92,52,40,富邦-宜蘭,2024-09-25,9686
006205,富邦上証,41,2,39,富邦-宜蘭,2024-09-25,9686
4977,眾達-KY,39,4,35,富邦-宜蘭,2024-09-25,9686
00915,凱基優選高股息30,34,1,33,富邦-宜蘭,2024-09-25,9686
00712,復華富時不動產,31,0,31,富邦-宜蘭,2024-09-25,9686
1326,台化,35,6,29,富邦-宜蘭,2024-09-25,9686
6288,聯嘉,31,3,28,富邦-宜蘭,2024-09-25,9686
2888,新光金,29,2,27,富邦-宜蘭,2024-09-25,9686
00687B,國泰20年美債,43,16,27,富邦-宜蘭,2024-09-25,9686
1711,永光,34,11,23,富邦-宜蘭,2024-09-25,9686
4420,光明,23,0,23,富邦-宜蘭,2024-09-25,9686
00945B,凱基美國非投等債,21,0,21,富邦-宜蘭,2024-09-25,9686
00636,國泰中國A50,20,0,20,富邦-宜蘭,2024-09-25,9686
2365,昆盈,49,30,19,富邦-宜蘭,2024-09-25,9686
2258,鴻華先進-創,18,0,18,富邦-宜蘭,2024-09-25,9686
6967,汎瑋材料,17,0,17,富邦-宜蘭,2024-09-25,9686
2399,映泰,33,16,17,富邦-宜蘭,2024-09-25,9686
8070,長華*,31,15,16,富邦-宜蘭,2024-09-25,9686
1303,南亞,16,1,15,富邦-宜蘭,2024-09-25,9686
5425,台半,38,23,15,富邦-宜蘭,2024-09-25,9686
2316,楠梓電,15,1,14,富邦-宜蘭,2024-09-25,9686
00933B,國泰10Y+金融債,15,1,14,富邦-宜蘭,2024-09-25,9686
3550,聯穎,54,40,14,富邦-宜蘭,2024-09-25,9686
1539,巨庭,27,14,13,富邦-宜蘭,2024-09-25,9686
3594,磐儀,13,0,13,富邦-宜蘭,2024-09-25,9686
2349,錸德,31,19,12,富邦-宜蘭,2024-09-25,9686
3518,柏騰,12,0,12,富邦-宜蘭,2024-09-25,9686
6792,詠業,12,0,12,富邦-宜蘭,2024-09-25,9686
4939,亞電,18,7,11,富邦-宜蘭,2024-09-25,9686
4563,百德,16,5,11,富邦-宜蘭,2024-09-25,9686
2313,華通,18,7,11,富邦-宜蘭,2024-09-25,9686
2890,永豐金,11,1,10,富邦-宜蘭,2024-09-25,9686
5488,松普,26,16,10,富邦-宜蘭,2024-09-25,9686
1795,美時,10,0,10,富邦-宜蘭,2024-09-25,9686
1722,台肥,10,0,10,富邦-宜蘭,2024-09-25,9686
2425,承啟,25,15,10,富邦-宜蘭,2024-09-25,9686
2505,國揚,10,0,10,富邦-宜蘭,2024-09-25,9686
1312,國喬,10,0,10,富邦-宜蘭,2024-09-25,9686
00632R,元大台灣50反1,288,26,262,富邦-宜蘭,2024-09-26,9686
00948B,中信優息投資級債,90,0,90,富邦-宜蘭,2024-09-26,9686
00942B,台新美A公司債20+,68,0,68,富邦-宜蘭,2024-09-26,9686
00715L,期街口布蘭特正2,66,5,61,富邦-宜蘭,2024-09-26,9686
3062,建漢,66,10,56,富邦-宜蘭,2024-09-26,9686
00960,野村全球航運龍頭,75,25,50,富邦-宜蘭,2024-09-26,9686
2376,技嘉,50,1,49,富邦-宜蘭,2024-09-26,9686
00878,國泰永續高股息,77,30,47,富邦-宜蘭,2024-09-26,9686
6257,矽格,68,23,45,富邦-宜蘭,2024-09-26,9686
00637L,元大滬深300正2,314,273,41,富邦-宜蘭,2024-09-26,9686
00687B,國泰20年美債,91,51,40,富邦-宜蘭,2024-09-26,9686
2399,映泰,41,5,36,富邦-宜蘭,2024-09-26,9686
2801,彰銀,35,0,35,富邦-宜蘭,2024-09-26,9686
2349,錸德,70,35,35,富邦-宜蘭,2024-09-26,9686
3094,聯傑,50,15,35,富邦-宜蘭,2024-09-26,9686
4114,健喬,30,0,30,富邦-宜蘭,2024-09-26,9686
2613,中櫃,67,40,27,富邦-宜蘭,2024-09-26,9686
1808,潤隆,34,8,26,富邦-宜蘭,2024-09-26,9686
2915,潤泰全,27,1,26,富邦-宜蘭,2024-09-26,9686
4714,永捷,25,0,25,富邦-宜蘭,2024-09-26,9686
3673,TPK-KY,30,8,22,富邦-宜蘭,2024-09-26,9686
2344,華邦電,82,60,22,富邦-宜蘭,2024-09-26,9686
1101,台泥,22,1,21,富邦-宜蘭,2024-09-26,9686
2201,裕隆,22,1,21,富邦-宜蘭,2024-09-26,9686
2421,建準,21,0,21,富邦-宜蘭,2024-09-26,9686
3715,定穎投控,66,47,19,富邦-宜蘭,2024-09-26,9686
3605,宏致,84,65,19,富邦-宜蘭,2024-09-26,9686
2897,王道銀行,18,0,18,富邦-宜蘭,2024-09-26,9686
00712,復華富時不動產,18,0,18,富邦-宜蘭,2024-09-26,9686
1305,華夏,17,0,17,富邦-宜蘭,2024-09-26,9686
5907,大洋-KY,35,18,17,富邦-宜蘭,2024-09-26,9686
6104,創惟,26,10,16,富邦-宜蘭,2024-09-26,9686
4974,亞泰,16,0,16,富邦-宜蘭,2024-09-26,9686
6237,驊訊,16,0,16,富邦-宜蘭,2024-09-26,9686
2520,冠德,15,0,15,富邦-宜蘭,2024-09-26,9686
1449,佳和,15,0,15,富邦-宜蘭,2024-09-26,9686
2408,南亞科,19,4,15,富邦-宜蘭,2024-09-26,9686
2545,皇翔,14,0,14,富邦-宜蘭,2024-09-26,9686
2359,所羅門,26,12,14,富邦-宜蘭,2024-09-26,9686
4903,聯光通,19,5,14,富邦-宜蘭,2024-09-26,9686
8096,擎亞,36,22,14,富邦-宜蘭,2024-09-26,9686
1301,台塑,14,0,14,富邦-宜蘭,2024-09-26,9686
3019,亞光,61,47,14,富邦-宜蘭,2024-09-26,9686
2929,淘帝-KY,12,0,12,富邦-宜蘭,2024-09-26,9686
8011,台通,12,0,12,富邦-宜蘭,2024-09-26,9686
2426,鼎元,12,0,12,富邦-宜蘭,2024-09-26,9686
8076,伍豐,16,4,12,富邦-宜蘭,2024-09-26,9686
3607,谷崧,11,0,11,富邦-宜蘭,2024-09-26,9686
6526,達發,14,3,11,富邦-宜蘭,2024-09-26,9686
2354,鴻準,17,7,10,富邦-宜蘭,2024-09-26,9686
00632R,元大台灣50反1,604,33,571,富邦-宜蘭,2024-09-27,9686
00937B,群益ESG投等債20,169,22,147,富邦-宜蘭,2024-09-27,9686
00687B,國泰20年美債,212,67,145,富邦-宜蘭,2024-09-27,9686
2601,益航,141,1,140,富邦-宜蘭,2024-09-27,9686
00948B,中信優息投資級債,137,4,133,富邦-宜蘭,2024-09-27,9686
2356,英業達,110,10,100,富邦-宜蘭,2024-09-27,9686
00715L,期街口布蘭特正2,140,42,98,富邦-宜蘭,2024-09-27,9686
00960,野村全球航運龍頭,158,71,87,富邦-宜蘭,2024-09-27,9686
1905,華紙,82,3,79,富邦-宜蘭,2024-09-27,9686
00953B,群益優選非投等債,65,0,65,富邦-宜蘭,2024-09-27,9686
00688L,國泰20年美債正2,64,2,62,富邦-宜蘭,2024-09-27,9686
00795B,中信美國公債20年,56,0,56,富邦-宜蘭,2024-09-27,9686
2883,凱基金,57,1,56,富邦-宜蘭,2024-09-27,9686
00945B,凱基美國非投等債,54,0,54,富邦-宜蘭,2024-09-27,9686
2611,志信,53,1,52,富邦-宜蘭,2024-09-27,9686
00931B,統一美債20年,73,25,48,富邦-宜蘭,2024-09-27,9686
910861,神州-DR,48,0,48,富邦-宜蘭,2024-09-27,9686
3041,揚智,52,5,47,富邦-宜蘭,2024-09-27,9686
5608,四維航,52,8,44,富邦-宜蘭,2024-09-27,9686
2399,映泰,103,65,38,富邦-宜蘭,2024-09-27,9686
00878,國泰永續高股息,43,6,37,富邦-宜蘭,2024-09-27,9686
6118,建達,37,0,37,富邦-宜蘭,2024-09-27,9686
0056,元大高股息,55,21,34,富邦-宜蘭,2024-09-27,9686
00664R,國泰臺灣加權反1,30,0,30,富邦-宜蘭,2024-09-27,9686
2913,農林,66,38,28,富邦-宜蘭,2024-09-27,9686
6116,彩晶,60,34,26,富邦-宜蘭,2024-09-27,9686
4554,橙的,25,0,25,富邦-宜蘭,2024-09-27,9686
2313,華通,27,2,25,富邦-宜蘭,2024-09-27,9686
3715,定穎投控,56,34,22,富邦-宜蘭,2024-09-27,9686
00650L,復華香港正2,53,31,22,富邦-宜蘭,2024-09-27,9686
00958B,永豐ESG銀行債15,22,0,22,富邦-宜蘭,2024-09-27,9686
5701,劍湖山,20,0,20,富邦-宜蘭,2024-09-27,9686
9934,成霖,20,0,20,富邦-宜蘭,2024-09-27,9686
1304,台聚,30,10,20,富邦-宜蘭,2024-09-27,9686
2486,一詮,27,8,19,富邦-宜蘭,2024-09-27,9686
3163,波若威,47,29,18,富邦-宜蘭,2024-09-27,9686
3147,大綜,19,1,18,富邦-宜蘭,2024-09-27,9686
2606,裕民,23,6,17,富邦-宜蘭,2024-09-27,9686
2023,燁輝,52,35,17,富邦-宜蘭,2024-09-27,9686
2388,威盛,28,12,16,富邦-宜蘭,2024-09-27,9686
4729,熒茂,20,5,15,富邦-宜蘭,2024-09-27,9686
6270,倍微,15,0,15,富邦-宜蘭,2024-09-27,9686
2801,彰銀,25,10,15,富邦-宜蘭,2024-09-27,9686
2891,中信金,18,3,15,富邦-宜蘭,2024-09-27,9686
00696B,富邦美債20年,15,1,14,富邦-宜蘭,2024-09-27,9686
1313,聯成,34,20,14,富邦-宜蘭,2024-09-27,9686
3605,宏致,41,30,11,富邦-宜蘭,2024-09-27,9686
1734,杏輝,11,0,11,富邦-宜蘭,2024-09-27,9686
5315,光聯,11,0,11,富邦-宜蘭,2024-09-27,9686
3149,正達,74,63,11,富邦-宜蘭,2024-09-27,9686
00696B,富邦美債20年,685,0,685,富邦-宜蘭,2024-09-30,9686
00679B,元大美債20年,269,5,264,富邦-宜蘭,2024-09-30,9686
00929,復華台灣科技優息,198,24,174,富邦-宜蘭,2024-09-30,9686
2605,新興,132,44,88,富邦-宜蘭,2024-09-30,9686
00919,群益台灣精選高息,201,113,88,富邦-宜蘭,2024-09-30,9686
00937B,群益ESG投等債20,108,21,87,富邦-宜蘭,2024-09-30,9686
1316,上曜,63,0,63,富邦-宜蘭,2024-09-30,9686
2014,中鴻,157,96,61,富邦-宜蘭,2024-09-30,9686
0056,元大高股息,96,35,61,富邦-宜蘭,2024-09-30,9686
2402,毅嘉,61,1,60,富邦-宜蘭,2024-09-30,9686
00687B,國泰20年美債,63,5,58,富邦-宜蘭,2024-09-30,9686
1608,華榮,51,0,51,富邦-宜蘭,2024-09-30,9686
6509,聚和,50,0,50,富邦-宜蘭,2024-09-30,9686
00945B,凱基美國非投等債,49,0,49,富邦-宜蘭,2024-09-30,9686
2303,聯電,60,13,47,富邦-宜蘭,2024-09-30,9686
00715L,期街口布蘭特正2,59,20,39,富邦-宜蘭,2024-09-30,9686
3622,洋華,38,0,38,富邦-宜蘭,2024-09-30,9686
1702,南僑,36,0,36,富邦-宜蘭,2024-09-30,9686
00891,中信關鍵半導體,37,2,35,富邦-宜蘭,2024-09-30,9686
00960,野村全球航運龍頭,37,3,34,富邦-宜蘭,2024-09-30,9686
00940,元大台灣價值高息,40,10,30,富邦-宜蘭,2024-09-30,9686
1806,冠軍,31,1,30,富邦-宜蘭,2024-09-30,9686
2349,錸德,33,3,30,富邦-宜蘭,2024-09-30,9686
3499,環天科,30,1,29,富邦-宜蘭,2024-09-30,9686
5014,建錩,31,3,28,富邦-宜蘭,2024-09-30,9686
2601,益航,35,7,28,富邦-宜蘭,2024-09-30,9686
1309,台達化,42,16,26,富邦-宜蘭,2024-09-30,9686
2313,華通,38,13,25,富邦-宜蘭,2024-09-30,9686
00948B,中信優息投資級債,24,0,24,富邦-宜蘭,2024-09-30,9686
6257,矽格,23,0,23,富邦-宜蘭,2024-09-30,9686
2330,台積電,28,5,23,富邦-宜蘭,2024-09-30,9686
9958,世紀鋼,32,10,22,富邦-宜蘭,2024-09-30,9686
2609,陽明,93,71,22,富邦-宜蘭,2024-09-30,9686
00927,群益半導體收益,22,0,22,富邦-宜蘭,2024-09-30,9686
2030,彰源,29,8,21,富邦-宜蘭,2024-09-30,9686
1449,佳和,21,0,21,富邦-宜蘭,2024-09-30,9686
1313,聯成,20,0,20,富邦-宜蘭,2024-09-30,9686
00643,群益深証中小,20,0,20,富邦-宜蘭,2024-09-30,9686
1802,台玻,60,42,18,富邦-宜蘭,2024-09-30,9686
1532,勤美,18,0,18,富邦-宜蘭,2024-09-30,9686
00923,群益台ESG低碳50,17,0,17,富邦-宜蘭,2024-09-30,9686
00915,凱基優選高股息30,17,0,17,富邦-宜蘭,2024-09-30,9686
2317,鴻海,93,77,16,富邦-宜蘭,2024-09-30,9686
2897B,王道銀乙特,15,0,15,富邦-宜蘭,2024-09-30,9686
6237,驊訊,15,0,15,富邦-宜蘭,2024-09-30,9686
2363,矽統,51,36,15,富邦-宜蘭,2024-09-30,9686
2892,第一金,14,1,13,富邦-宜蘭,2024-09-30,9686
00953B,群益優選非投等債,12,0,12,富邦-宜蘭,2024-09-30,9686
2515,中工,12,0,12,富邦-宜蘭,2024-09-30,9686
2929,淘帝-KY,12,0,12,富邦-宜蘭,2024-09-30,9686
00696B,富邦美債20年,215,0,215,富邦-宜蘭,2024-10-01,9686
00632R,元大台灣50反1,211,5,206,富邦-宜蘭,2024-10-01,9686
00929,復華台灣科技優息,133,1,132,富邦-宜蘭,2024-10-01,9686
6118,建達,102,4,98,富邦-宜蘭,2024-10-01,9686
00919,群益台灣精選高息,115,18,97,富邦-宜蘭,2024-10-01,9686
0056,元大高股息,86,0,86,富邦-宜蘭,2024-10-01,9686
00720B,元大投資級公司債,80,0,80,富邦-宜蘭,2024-10-01,9686
00751B,元大AAA至A公司債,67,0,67,富邦-宜蘭,2024-10-01,9686
00753L,中信中國50正2,587,533,54,富邦-宜蘭,2024-10-01,9686
2834,臺企銀,54,2,52,富邦-宜蘭,2024-10-01,9686
00922,國泰台灣領袖50,50,0,50,富邦-宜蘭,2024-10-01,9686
3062,建漢,55,7,48,富邦-宜蘭,2024-10-01,9686
2356,英業達,52,6,46,富邦-宜蘭,2024-10-01,9686
00687B,國泰20年美債,56,12,44,富邦-宜蘭,2024-10-01,9686
00679B,元大美債20年,40,0,40,富邦-宜蘭,2024-10-01,9686
8429,金麗-KY,46,7,39,富邦-宜蘭,2024-10-01,9686
00878,國泰永續高股息,46,8,38,富邦-宜蘭,2024-10-01,9686
00665L,富邦�琤肭磪囓�2,34,0,34,富邦-宜蘭,2024-10-01,9686
00688L,國泰20年美債正2,33,0,33,富邦-宜蘭,2024-10-01,9686
2515,中工,30,0,30,富邦-宜蘭,2024-10-01,9686
5344,立衛,30,0,30,富邦-宜蘭,2024-10-01,9686
3339,泰谷,30,0,30,富邦-宜蘭,2024-10-01,9686
3354,律勝,29,0,29,富邦-宜蘭,2024-10-01,9686
1722,台肥,28,0,28,富邦-宜蘭,2024-10-01,9686
4909,新復興,93,68,25,富邦-宜蘭,2024-10-01,9686
00948B,中信優息投資級債,28,4,24,富邦-宜蘭,2024-10-01,9686
00915,凱基優選高股息30,24,1,23,富邦-宜蘭,2024-10-01,9686
2367,燿華,26,3,23,富邦-宜蘭,2024-10-01,9686
00757,統一FANG+,23,0,23,富邦-宜蘭,2024-10-01,9686
3508,位速,21,0,21,富邦-宜蘭,2024-10-01,9686
8011,台通,20,0,20,富邦-宜蘭,2024-10-01,9686
6163,華電網,20,0,20,富邦-宜蘭,2024-10-01,9686
6246,臺龍,24,4,20,富邦-宜蘭,2024-10-01,9686
8039,台虹,20,0,20,富邦-宜蘭,2024-10-01,9686
4526,東台,21,1,20,富邦-宜蘭,2024-10-01,9686
2801,彰銀,20,0,20,富邦-宜蘭,2024-10-01,9686
2374,佳能,23,4,19,富邦-宜蘭,2024-10-01,9686
2317,鴻海,29,11,18,富邦-宜蘭,2024-10-01,9686
6913,鴻呈,19,1,18,富邦-宜蘭,2024-10-01,9686
9945,潤泰新,20,2,18,富邦-宜蘭,2024-10-01,9686
00715L,期街口布蘭特正2,20,3,17,富邦-宜蘭,2024-10-01,9686
9940,信義,20,3,17,富邦-宜蘭,2024-10-01,9686
00952,凱基台灣AI50,16,0,16,富邦-宜蘭,2024-10-01,9686
3715,定穎投控,129,114,15,富邦-宜蘭,2024-10-01,9686
2929,淘帝-KY,22,7,15,富邦-宜蘭,2024-10-01,9686
2897B,王道銀乙特,15,0,15,富邦-宜蘭,2024-10-01,9686
1711,永光,85,71,14,富邦-宜蘭,2024-10-01,9686
2426,鼎元,15,1,14,富邦-宜蘭,2024-10-01,9686
2258,鴻華先進-創,13,0,13,富邦-宜蘭,2024-10-01,9686
2303,聯電,15,2,13,富邦-宜蘭,2024-10-01,9686
00673R,期元大S＆P原油反1,603,0,603,富邦-宜蘭,2024-10-04,9686
00919,群益台灣精選高息,325,43,282,富邦-宜蘭,2024-10-04,9686
00688L,國泰20年美債正2,257,0,257,富邦-宜蘭,2024-10-04,9686
2618,長榮航,191,7,184,富邦-宜蘭,2024-10-04,9686
3049,精金,200,55,145,富邦-宜蘭,2024-10-04,9686
00632R,元大台灣50反1,147,5,142,富邦-宜蘭,2024-10-04,9686
2603,長榮,122,7,115,富邦-宜蘭,2024-10-04,9686
2609,陽明,170,61,109,富邦-宜蘭,2024-10-04,9686
00948B,中信優息投資級債,95,0,95,富邦-宜蘭,2024-10-04,9686
2891,中信金,93,3,90,富邦-宜蘭,2024-10-04,9686
0056,元大高股息,123,37,86,富邦-宜蘭,2024-10-04,9686
1595,川寶,75,3,72,富邦-宜蘭,2024-10-04,9686
00680L,元大美債20正2,59,0,59,富邦-宜蘭,2024-10-04,9686
2029,盛餘,58,0,58,富邦-宜蘭,2024-10-04,9686
8429,金麗-KY,77,19,58,富邦-宜蘭,2024-10-04,9686
5907,大洋-KY,60,5,55,富邦-宜蘭,2024-10-04,9686
00940,元大台灣價值高息,60,11,49,富邦-宜蘭,2024-10-04,9686
00752,中信中國50,82,36,46,富邦-宜蘭,2024-10-04,9686
2834,臺企銀,50,5,45,富邦-宜蘭,2024-10-04,9686
00679B,元大美債20年,69,24,45,富邦-宜蘭,2024-10-04,9686
2303,聯電,51,6,45,富邦-宜蘭,2024-10-04,9686
4303,信立,47,3,44,富邦-宜蘭,2024-10-04,9686
2886,兆豐金,44,1,43,富邦-宜蘭,2024-10-04,9686
00878,國泰永續高股息,42,4,38,富邦-宜蘭,2024-10-04,9686
00696B,富邦美債20年,37,0,37,富邦-宜蘭,2024-10-04,9686
00918,大華優利高填息30,34,1,33,富邦-宜蘭,2024-10-04,9686
8070,長華*,40,8,32,富邦-宜蘭,2024-10-04,9686
2419,仲琦,35,3,32,富邦-宜蘭,2024-10-04,9686
6257,矽格,32,0,32,富邦-宜蘭,2024-10-04,9686
2610,華航,32,2,30,富邦-宜蘭,2024-10-04,9686
3354,律勝,29,0,29,富邦-宜蘭,2024-10-04,9686
6246,臺龍,32,3,29,富邦-宜蘭,2024-10-04,9686
00952,凱基台灣AI50,28,0,28,富邦-宜蘭,2024-10-04,9686
2515,中工,33,5,28,富邦-宜蘭,2024-10-04,9686
2498,宏達電,118,90,28,富邦-宜蘭,2024-10-04,9686
00725B,國泰投資級公司債,28,0,28,富邦-宜蘭,2024-10-04,9686
2399,映泰,196,168,28,富邦-宜蘭,2024-10-04,9686
2605,新興,33,6,27,富邦-宜蘭,2024-10-04,9686
2615,萬海,33,6,27,富邦-宜蘭,2024-10-04,9686
2439,美律,28,1,27,富邦-宜蘭,2024-10-04,9686
2344,華邦電,25,0,25,富邦-宜蘭,2024-10-04,9686
00937B,群益ESG投等債20,26,2,24,富邦-宜蘭,2024-10-04,9686
2365,昆盈,28,5,23,富邦-宜蘭,2024-10-04,9686
00687B,國泰20年美債,41,18,23,富邦-宜蘭,2024-10-04,9686
00915,凱基優選高股息30,22,0,22,富邦-宜蘭,2024-10-04,9686
8450,霹靂,26,4,22,富邦-宜蘭,2024-10-04,9686
6163,華電網,21,0,21,富邦-宜蘭,2024-10-04,9686
6919,康霈*,24,4,20,富邦-宜蘭,2024-10-04,9686
6188,廣明,24,5,19,富邦-宜蘭,2024-10-04,9686
1301,台塑,31,12,19,富邦-宜蘭,2024-10-04,9686
00673R,期元大S＆P原油反1,220,0,220,富邦-宜蘭,2024-10-07,9686
00905,FT臺灣Smart,107,2,105,富邦-宜蘭,2024-10-07,9686
00696B,富邦美債20年,82,0,82,富邦-宜蘭,2024-10-07,9686
00665L,富邦�琤肭磪囓�2,91,14,77,富邦-宜蘭,2024-10-07,9686
1540,喬福,78,3,75,富邦-宜蘭,2024-10-07,9686
0056,元大高股息,75,1,74,富邦-宜蘭,2024-10-07,9686
8039,台虹,69,3,66,富邦-宜蘭,2024-10-07,9686
00919,群益台灣精選高息,116,57,59,富邦-宜蘭,2024-10-07,9686
3591,艾笛森,62,9,53,富邦-宜蘭,2024-10-07,9686
5907,大洋-KY,54,4,50,富邦-宜蘭,2024-10-07,9686
1569,濱川,52,4,48,富邦-宜蘭,2024-10-07,9686
00650L,復華香港正2,50,6,44,富邦-宜蘭,2024-10-07,9686
2601,益航,57,13,44,富邦-宜蘭,2024-10-07,9686
6118,建達,65,22,43,富邦-宜蘭,2024-10-07,9686
00639,富邦深100,61,19,42,富邦-宜蘭,2024-10-07,9686
2344,華邦電,39,1,38,富邦-宜蘭,2024-10-07,9686
3622,洋華,38,2,36,富邦-宜蘭,2024-10-07,9686
00752,中信中國50,39,4,35,富邦-宜蘭,2024-10-07,9686
1721,三晃,38,5,33,富邦-宜蘭,2024-10-07,9686
4510,高鋒,35,2,33,富邦-宜蘭,2024-10-07,9686
00753L,中信中國50正2,248,216,32,富邦-宜蘭,2024-10-07,9686
2303,聯電,32,2,30,富邦-宜蘭,2024-10-07,9686
00878,國泰永續高股息,47,20,27,富邦-宜蘭,2024-10-07,9686
2609,陽明,37,10,27,富邦-宜蘭,2024-10-07,9686
00725B,國泰投資級公司債,27,0,27,富邦-宜蘭,2024-10-07,9686
00688L,國泰20年美債正2,71,45,26,富邦-宜蘭,2024-10-07,9686
2337,旺宏,24,0,24,富邦-宜蘭,2024-10-07,9686
00960,野村全球航運龍頭,24,1,23,富邦-宜蘭,2024-10-07,9686
8111,立��,133,110,23,富邦-宜蘭,2024-10-07,9686
00680L,元大美債20正2,31,9,22,富邦-宜蘭,2024-10-07,9686
1532,勤美,22,0,22,富邦-宜蘭,2024-10-07,9686
6509,聚和,20,0,20,富邦-宜蘭,2024-10-07,9686
6163,華電網,20,0,20,富邦-宜蘭,2024-10-07,9686
00636,國泰中國A50,25,6,19,富邦-宜蘭,2024-10-07,9686
2497,怡利電,27,9,18,富邦-宜蘭,2024-10-07,9686
1309,台達化,17,0,17,富邦-宜蘭,2024-10-07,9686
3025,星通,54,37,17,富邦-宜蘭,2024-10-07,9686
3260,威剛,16,0,16,富邦-宜蘭,2024-10-07,9686
00922,國泰台灣領袖50,16,0,16,富邦-宜蘭,2024-10-07,9686
00687B,國泰20年美債,38,23,15,富邦-宜蘭,2024-10-07,9686
00931B,統一美債20年,21,6,15,富邦-宜蘭,2024-10-07,9686
00643,群益深証中小,25,10,15,富邦-宜蘭,2024-10-07,9686
2495,普安,15,0,15,富邦-宜蘭,2024-10-07,9686
0061,元大寶滬深,21,6,15,富邦-宜蘭,2024-10-07,9686
2436,偉詮電,18,3,15,富邦-宜蘭,2024-10-07,9686
006208,富邦台50,17,2,15,富邦-宜蘭,2024-10-07,9686
00933B,國泰10Y+金融債,14,0,14,富邦-宜蘭,2024-10-07,9686
2449,京元電子,17,4,13,富邦-宜蘭,2024-10-07,9686
2359,所羅門,18,5,13,富邦-宜蘭,2024-10-07,9686
5880,合庫金,12,0,12,富邦-宜蘭,2024-10-07,9686
2883,凱基金,652,0,652,富邦-宜蘭,2024-10-08,9686
2601,益航,720,74,646,富邦-宜蘭,2024-10-08,9686
00673R,期元大S＆P原油反1,432,0,432,富邦-宜蘭,2024-10-08,9686
2887,台新金,406,0,406,富邦-宜蘭,2024-10-08,9686
00665L,富邦�琤肭磪囓�2,297,80,217,富邦-宜蘭,2024-10-08,9686
00637L,元大滬深300正2,713,513,200,富邦-宜蘭,2024-10-08,9686
0056,元大高股息,190,1,189,富邦-宜蘭,2024-10-08,9686
00958B,永豐ESG銀行債15,141,0,141,富邦-宜蘭,2024-10-08,9686
00931B,統一美債20年,144,4,140,富邦-宜蘭,2024-10-08,9686
5512,力麒,130,0,130,富邦-宜蘭,2024-10-08,9686
0061,元大寶滬深,130,8,122,富邦-宜蘭,2024-10-08,9686
00905,FT臺灣Smart,107,0,107,富邦-宜蘭,2024-10-08,9686
2929,淘帝-KY,98,10,88,富邦-宜蘭,2024-10-08,9686
1314,中石化,83,0,83,富邦-宜蘭,2024-10-08,9686
2891,中信金,103,20,83,富邦-宜蘭,2024-10-08,9686
00919,群益台灣精選高息,87,17,70,富邦-宜蘭,2024-10-08,9686
1815,富喬,74,8,66,富邦-宜蘭,2024-10-08,9686
2344,華邦電,97,38,59,富邦-宜蘭,2024-10-08,9686
8429,金麗-KY,63,4,59,富邦-宜蘭,2024-10-08,9686
1434,福懋,56,0,56,富邦-宜蘭,2024-10-08,9686
00882,中信中國高股息,160,105,55,富邦-宜蘭,2024-10-08,9686
00878,國泰永續高股息,51,0,51,富邦-宜蘭,2024-10-08,9686
00651R,復華香港反1,60,10,50,富邦-宜蘭,2024-10-08,9686
00679B,元大美債20年,90,44,46,富邦-宜蘭,2024-10-08,9686
2317,鴻海,57,16,41,富邦-宜蘭,2024-10-08,9686
2515,中工,40,1,39,富邦-宜蘭,2024-10-08,9686
2845,遠東銀,35,0,35,富邦-宜蘭,2024-10-08,9686
3303,岱稜,36,2,34,富邦-宜蘭,2024-10-08,9686
2101,南港,32,2,30,富邦-宜蘭,2024-10-08,9686
2882,國泰金,34,5,29,富邦-宜蘭,2024-10-08,9686
00696B,富邦美債20年,60,31,29,富邦-宜蘭,2024-10-08,9686
6405,悅城,32,3,29,富邦-宜蘭,2024-10-08,9686
4402,郡都開發,29,0,29,富邦-宜蘭,2024-10-08,9686
2356,英業達,32,4,28,富邦-宜蘭,2024-10-08,9686
8176,智捷,25,0,25,富邦-宜蘭,2024-10-08,9686
3481,群創,25,1,24,富邦-宜蘭,2024-10-08,9686
6438,迅得,35,13,22,富邦-宜蘭,2024-10-08,9686
2405,輔信,22,1,21,富邦-宜蘭,2024-10-08,9686
6196,帆宣,25,5,20,富邦-宜蘭,2024-10-08,9686
2801,彰銀,20,0,20,富邦-宜蘭,2024-10-08,9686
00887,永豐中國科技50大,52,32,20,富邦-宜蘭,2024-10-08,9686
00922,國泰台灣領袖50,20,1,19,富邦-宜蘭,2024-10-08,9686
2834,臺企銀,23,4,19,富邦-宜蘭,2024-10-08,9686
1727,中華化,19,0,19,富邦-宜蘭,2024-10-08,9686
8111,立��,30,12,18,富邦-宜蘭,2024-10-08,9686
2486,一詮,33,15,18,富邦-宜蘭,2024-10-08,9686
2426,鼎元,20,2,18,富邦-宜蘭,2024-10-08,9686
3037,欣興,15,0,15,富邦-宜蘭,2024-10-08,9686
00918,大華優利高填息30,16,1,15,富邦-宜蘭,2024-10-08,9686
4906,正文,20,5,15,富邦-宜蘭,2024-10-08,9686
2883,凱基金,548,1,547,富邦-宜蘭,2024-10-09,9686
2312,金寶,363,12,351,富邦-宜蘭,2024-10-09,9686
00665L,富邦�琤肭磪囓�2,443,121,322,富邦-宜蘭,2024-10-09,9686
00637L,元大滬深300正2,548,238,310,富邦-宜蘭,2024-10-09,9686
00882,中信中國高股息,376,84,292,富邦-宜蘭,2024-10-09,9686
2601,益航,224,5,219,富邦-宜蘭,2024-10-09,9686
00753L,中信中國50正2,357,160,197,富邦-宜蘭,2024-10-09,9686
00937B,群益ESG投等債20,104,5,99,富邦-宜蘭,2024-10-09,9686
2891,中信金,101,2,99,富邦-宜蘭,2024-10-09,9686
00639,富邦深100,129,37,92,富邦-宜蘭,2024-10-09,9686
00905,FT臺灣Smart,100,13,87,富邦-宜蘭,2024-10-09,9686
1314,中石化,86,13,73,富邦-宜蘭,2024-10-09,9686
00696B,富邦美債20年,79,10,69,富邦-宜蘭,2024-10-09,9686
00650L,復華香港正2,132,65,67,富邦-宜蘭,2024-10-09,9686
5014,建錩,70,4,66,富邦-宜蘭,2024-10-09,9686
2408,南亞科,63,4,59,富邦-宜蘭,2024-10-09,9686
00948B,中信優息投資級債,49,0,49,富邦-宜蘭,2024-10-09,9686
00679B,元大美債20年,49,1,48,富邦-宜蘭,2024-10-09,9686
6152,百一,47,0,47,富邦-宜蘭,2024-10-09,9686
00931B,統一美債20年,50,4,46,富邦-宜蘭,2024-10-09,9686
1101,台泥,44,2,42,富邦-宜蘭,2024-10-09,9686
00958B,永豐ESG銀行債15,40,0,40,富邦-宜蘭,2024-10-09,9686
2344,華邦電,40,1,39,富邦-宜蘭,2024-10-09,9686
2303,聯電,37,0,37,富邦-宜蘭,2024-10-09,9686
00933B,國泰10Y+金融債,37,0,37,富邦-宜蘭,2024-10-09,9686
2892,第一金,35,0,35,富邦-宜蘭,2024-10-09,9686
1434,福懋,35,0,35,富邦-宜蘭,2024-10-09,9686
8240,華宏,32,0,32,富邦-宜蘭,2024-10-09,9686
00680L,元大美債20正2,32,0,32,富邦-宜蘭,2024-10-09,9686
2353,宏��,32,1,31,富邦-宜蘭,2024-10-09,9686
2014,中鴻,31,0,31,富邦-宜蘭,2024-10-09,9686
2603,長榮,32,2,30,富邦-宜蘭,2024-10-09,9686
00919,群益台灣精選高息,39,8,31,富邦-宜蘭,2024-10-09,9686
00633L,富邦上証正2,170,140,30,富邦-宜蘭,2024-10-09,9686
00673R,期元大S＆P原油反1,30,0,30,富邦-宜蘭,2024-10-09,9686
00687B,國泰20年美債,43,15,28,富邦-宜蘭,2024-10-09,9686
2439,美律,31,3,28,富邦-宜蘭,2024-10-09,9686
1452,宏益,72,44,28,富邦-宜蘭,2024-10-09,9686
6486,互動,28,0,28,富邦-宜蘭,2024-10-09,9686
2313,華通,40,13,27,富邦-宜蘭,2024-10-09,9686
3550,聯穎,81,55,26,富邦-宜蘭,2024-10-09,9686
5443,均豪,45,20,25,富邦-宜蘭,2024-10-09,9686
2609,陽明,37,13,24,富邦-宜蘭,2024-10-09,9686
2002,中鋼,29,5,24,富邦-宜蘭,2024-10-09,9686
2363,矽統,116,92,24,富邦-宜蘭,2024-10-09,9686
5905,南仁湖,24,2,22,富邦-宜蘭,2024-10-09,9686
1532,勤美,22,0,22,富邦-宜蘭,2024-10-09,9686
2453,凌群,21,0,21,富邦-宜蘭,2024-10-09,9686
3591,艾笛森,74,53,21,富邦-宜蘭,2024-10-09,9686
3481,群創,22,2,20,富邦-宜蘭,2024-10-09,9686
2867,三商壽,270,6,264,富邦-宜蘭,2024-10-11,9686
2888,新光金,198,22,176,富邦-宜蘭,2024-10-11,9686
1721,三晃,154,7,147,富邦-宜蘭,2024-10-11,9686
00673R,期元大S＆P原油反1,125,0,125,富邦-宜蘭,2024-10-11,9686
00937B,群益ESG投等債20,125,3,122,富邦-宜蘭,2024-10-11,9686
2303,聯電,103,2,101,富邦-宜蘭,2024-10-11,9686
5014,建錩,73,1,72,富邦-宜蘭,2024-10-11,9686
2515,中工,70,2,68,富邦-宜蘭,2024-10-11,9686
2449,京元電子,101,34,67,富邦-宜蘭,2024-10-11,9686
00687B,國泰20年美債,100,41,59,富邦-宜蘭,2024-10-11,9686
2344,華邦電,57,1,56,富邦-宜蘭,2024-10-11,9686
00637L,元大滬深300正2,451,400,51,富邦-宜蘭,2024-10-11,9686
00753L,中信中國50正2,75,31,44,富邦-宜蘭,2024-10-11,9686
2543,皇昌,52,9,43,富邦-宜蘭,2024-10-11,9686
2409,友達,51,8,43,富邦-宜蘭,2024-10-11,9686
3049,精金,125,88,37,富邦-宜蘭,2024-10-11,9686
1605,華新,32,0,32,富邦-宜蘭,2024-10-11,9686
00650L,復華香港正2,30,0,30,富邦-宜蘭,2024-10-11,9686
3591,艾笛森,100,70,30,富邦-宜蘭,2024-10-11,9686
1527,鑽全,29,0,29,富邦-宜蘭,2024-10-11,9686
2887,台新金,30,1,29,富邦-宜蘭,2024-10-11,9686
00680L,元大美債20正2,28,0,28,富邦-宜蘭,2024-10-11,9686
2388,威盛,111,84,27,富邦-宜蘭,2024-10-11,9686
00919,群益台灣精選高息,58,31,27,富邦-宜蘭,2024-10-11,9686
00688L,國泰20年美債正2,26,0,26,富邦-宜蘭,2024-10-11,9686
4736,泰博,25,0,25,富邦-宜蘭,2024-10-11,9686
2615,萬海,24,4,20,富邦-宜蘭,2024-10-11,9686
2495,普安,22,2,20,富邦-宜蘭,2024-10-11,9686
00877,復華中國5G,25,5,20,富邦-宜蘭,2024-10-11,9686
00955,中信日本商社,20,0,20,富邦-宜蘭,2024-10-11,9686
4956,光鋐,67,47,20,富邦-宜蘭,2024-10-11,9686
00772B,中信高評級公司債,20,0,20,富邦-宜蘭,2024-10-11,9686
00636,國泰中國A50,22,2,20,富邦-宜蘭,2024-10-11,9686
00708L,期元大S＆P黃金正2,20,0,20,富邦-宜蘭,2024-10-11,9686
2399,映泰,56,37,19,富邦-宜蘭,2024-10-11,9686
3066,李洲,19,0,19,富邦-宜蘭,2024-10-11,9686
3450,聯鈞,44,26,18,富邦-宜蘭,2024-10-11,9686
4927,泰鼎-KY,30,12,18,富邦-宜蘭,2024-10-11,9686
4909,新復興,27,10,17,富邦-宜蘭,2024-10-11,9686
2363,矽統,98,81,17,富邦-宜蘭,2024-10-11,9686
2324,仁寶,23,6,17,富邦-宜蘭,2024-10-11,9686
1815,富喬,16,0,16,富邦-宜蘭,2024-10-11,9686
4967,十銓,17,1,16,富邦-宜蘭,2024-10-11,9686
4958,臻鼎-KY,15,0,15,富邦-宜蘭,2024-10-11,9686
2464,盟立,17,2,15,富邦-宜蘭,2024-10-11,9686
00915,凱基優選高股息30,16,1,15,富邦-宜蘭,2024-10-11,9686
3149,正達,78,63,15,富邦-宜蘭,2024-10-11,9686
8111,立��,88,75,13,富邦-宜蘭,2024-10-11,9686
00931B,統一美債20年,12,0,12,富邦-宜蘭,2024-10-11,9686
2367,燿華,21,9,12,富邦-宜蘭,2024-10-11,9686
2888,新光金,956,10,946,富邦-宜蘭,2024-10-14,9686
2312,金寶,342,132,210,富邦-宜蘭,2024-10-14,9686
00882,中信中國高股息,225,45,180,富邦-宜蘭,2024-10-14,9686
00887,永豐中國科技50大,130,7,123,富邦-宜蘭,2024-10-14,9686
0056,元大高股息,127,41,86,富邦-宜蘭,2024-10-14,9686
00877,復華中國5G,85,2,83,富邦-宜蘭,2024-10-14,9686
00907,永豐優息存股,72,0,72,富邦-宜蘭,2024-10-14,9686
00632R,元大台灣50反1,71,0,71,富邦-宜蘭,2024-10-14,9686
00687B,國泰20年美債,70,5,65,富邦-宜蘭,2024-10-14,9686
00679B,元大美債20年,153,93,60,富邦-宜蘭,2024-10-14,9686
2883,凱基金,60,12,48,富邦-宜蘭,2024-10-14,9686
00878,國泰永續高股息,76,31,45,富邦-宜蘭,2024-10-14,9686
00933B,國泰10Y+金融債,46,2,44,富邦-宜蘭,2024-10-14,9686
2344,華邦電,42,1,41,富邦-宜蘭,2024-10-14,9686
00680L,元大美債20正2,38,1,37,富邦-宜蘭,2024-10-14,9686
2543,皇昌,51,21,30,富邦-宜蘭,2024-10-14,9686
2392,正崴,27,0,27,富邦-宜蘭,2024-10-14,9686
00885,富邦越南,27,1,26,富邦-宜蘭,2024-10-14,9686
00637L,元大滬深300正2,208,182,26,富邦-宜蘭,2024-10-14,9686
1326,台化,28,6,22,富邦-宜蘭,2024-10-14,9686
1595,川寶,45,24,21,富邦-宜蘭,2024-10-14,9686
6425,易發,31,12,19,富邦-宜蘭,2024-10-14,9686
00688L,國泰20年美債正2,37,18,19,富邦-宜蘭,2024-10-14,9686
2365,昆盈,27,9,18,富邦-宜蘭,2024-10-14,9686
00937B,群益ESG投等債20,71,54,17,富邦-宜蘭,2024-10-14,9686
3030,德律,16,0,16,富邦-宜蘭,2024-10-14,9686
3576,聯合再生,17,1,16,富邦-宜蘭,2024-10-14,9686
8240,華宏,20,5,15,富邦-宜蘭,2024-10-14,9686
1540,喬福,19,4,15,富邦-宜蘭,2024-10-14,9686
00931B,統一美債20年,15,0,15,富邦-宜蘭,2024-10-14,9686
3047,訊舟,17,3,14,富邦-宜蘭,2024-10-14,9686
4303,信立,30,16,14,富邦-宜蘭,2024-10-14,9686
3380,明泰,15,1,14,富邦-宜蘭,2024-10-14,9686
8039,台虹,13,0,13,富邦-宜蘭,2024-10-14,9686
6517,保勝光學,13,0,13,富邦-宜蘭,2024-10-14,9686
6405,悅城,15,2,13,富邦-宜蘭,2024-10-14,9686
6182,合晶,13,0,13,富邦-宜蘭,2024-10-14,9686
5880,合庫金,12,0,12,富邦-宜蘭,2024-10-14,9686
2426,鼎元,43,31,12,富邦-宜蘭,2024-10-14,9686
9945,潤泰新,15,4,11,富邦-宜蘭,2024-10-14,9686
8105,凌巨,12,1,11,富邦-宜蘭,2024-10-14,9686
2498,宏達電,21,11,10,富邦-宜蘭,2024-10-14,9686
2002,中鋼,11,1,10,富邦-宜蘭,2024-10-14,9686
00696B,富邦美債20年,10,0,10,富邦-宜蘭,2024-10-14,9686
4510,高鋒,22,12,10,富邦-宜蘭,2024-10-14,9686
00905,FT臺灣Smart,10,0,10,富邦-宜蘭,2024-10-14,9686
2601,益航,10,0,10,富邦-宜蘭,2024-10-14,9686
00740B,富邦全球投等債,10,0,10,富邦-宜蘭,2024-10-14,9686
8096,擎亞,12,2,10,富邦-宜蘭,2024-10-14,9686
2641,正德,10,0,10,富邦-宜蘭,2024-10-14,9686
2888,新光金,1357,53,1304,富邦-宜蘭,2024-10-15,9686
00948B,中信優息投資級債,112,0,112,富邦-宜蘭,2024-10-15,9686
00632R,元大台灣50反1,130,26,104,富邦-宜蘭,2024-10-15,9686
2399,映泰,174,77,97,富邦-宜蘭,2024-10-15,9686
00687B,國泰20年美債,102,19,83,富邦-宜蘭,2024-10-15,9686
00753L,中信中國50正2,84,10,74,富邦-宜蘭,2024-10-15,9686
00637L,元大滬深300正2,265,205,60,富邦-宜蘭,2024-10-15,9686
1314,中石化,77,21,56,富邦-宜蘭,2024-10-15,9686
2376,技嘉,47,1,46,富邦-宜蘭,2024-10-15,9686
00680L,元大美債20正2,48,4,44,富邦-宜蘭,2024-10-15,9686
00937B,群益ESG投等債20,61,18,43,富邦-宜蘭,2024-10-15,9686
2426,鼎元,53,13,40,富邦-宜蘭,2024-10-15,9686
00877,復華中國5G,32,0,32,富邦-宜蘭,2024-10-15,9686
00665L,富邦�琤肭磪囓�2,106,75,31,富邦-宜蘭,2024-10-15,9686
00887,永豐中國科技50大,61,31,30,富邦-宜蘭,2024-10-15,9686
00688L,國泰20年美債正2,29,0,29,富邦-宜蘭,2024-10-15,9686
00752,中信中國50,30,1,29,富邦-宜蘭,2024-10-15,9686
5014,建錩,34,8,26,富邦-宜蘭,2024-10-15,9686
00650L,復華香港正2,38,15,23,富邦-宜蘭,2024-10-15,9686
4927,泰鼎-KY,23,0,23,富邦-宜蘭,2024-10-15,9686
6156,松上,75,52,23,富邦-宜蘭,2024-10-15,9686
00922,國泰台灣領袖50,25,4,21,富邦-宜蘭,2024-10-15,9686
4991,環宇-KY,34,13,21,富邦-宜蘭,2024-10-15,9686
3219,倚強科,21,0,21,富邦-宜蘭,2024-10-15,9686
4934,太極,20,0,20,富邦-宜蘭,2024-10-15,9686
00933B,國泰10Y+金融債,20,0,20,富邦-宜蘭,2024-10-15,9686
8088,品安,20,0,20,富邦-宜蘭,2024-10-15,9686
00679B,元大美債20年,72,52,20,富邦-宜蘭,2024-10-15,9686
2417,圓剛,20,1,19,富邦-宜蘭,2024-10-15,9686
3576,聯合再生,22,4,18,富邦-宜蘭,2024-10-15,9686
2241,艾姆勒,25,7,18,富邦-宜蘭,2024-10-15,9686
6116,彩晶,20,3,17,富邦-宜蘭,2024-10-15,9686
1785,光洋科,19,2,17,富邦-宜蘭,2024-10-15,9686
3149,正達,147,130,17,富邦-宜蘭,2024-10-15,9686
8103,瀚荃,15,0,15,富邦-宜蘭,2024-10-15,9686
8099,大世科,16,1,15,富邦-宜蘭,2024-10-15,9686
00664R,國泰臺灣加權反1,15,0,15,富邦-宜蘭,2024-10-15,9686
3036,文曄,17,2,15,富邦-宜蘭,2024-10-15,9686
2405,輔信,15,1,14,富邦-宜蘭,2024-10-15,9686
6438,迅得,22,8,14,富邦-宜蘭,2024-10-15,9686
3049,精金,37,25,12,富邦-宜蘭,2024-10-15,9686
3591,艾笛森,30,18,12,富邦-宜蘭,2024-10-15,9686
8429,金麗-KY,16,5,11,富邦-宜蘭,2024-10-15,9686
1815,富喬,13,2,11,富邦-宜蘭,2024-10-15,9686
9907,統一實,11,0,11,富邦-宜蘭,2024-10-15,9686
6274,台燿,14,3,11,富邦-宜蘭,2024-10-15,9686
1434,福懋,10,0,10,富邦-宜蘭,2024-10-15,9686
2537,聯上發,10,0,10,富邦-宜蘭,2024-10-15,9686
00656R,國泰中國A50反1,10,0,10,富邦-宜蘭,2024-10-15,9686
2514,龍邦,10,0,10,富邦-宜蘭,2024-10-15,9686
2888,新光金,891,4,887,富邦-宜蘭,2024-10-16,9686
00680L,元大美債20正2,457,0,457,富邦-宜蘭,2024-10-16,9686
00679B,元大美債20年,130,0,130,富邦-宜蘭,2024-10-16,9686
00887,永豐中國科技50大,143,17,126,富邦-宜蘭,2024-10-16,9686
00688L,國泰20年美債正2,101,0,101,富邦-宜蘭,2024-10-16,9686
2317,鴻海,128,28,100,富邦-宜蘭,2024-10-16,9686
0056,元大高股息,131,32,99,富邦-宜蘭,2024-10-16,9686
00922,國泰台灣領袖50,86,6,80,富邦-宜蘭,2024-10-16,9686
2344,華邦電,78,4,74,富邦-宜蘭,2024-10-16,9686
2601,益航,72,1,71,富邦-宜蘭,2024-10-16,9686
6118,建達,71,1,70,富邦-宜蘭,2024-10-16,9686
6505,台塑化,52,0,52,富邦-宜蘭,2024-10-16,9686
00958B,永豐ESG銀行債15,45,0,45,富邦-宜蘭,2024-10-16,9686
8097,常珵,45,5,40,富邦-宜蘭,2024-10-16,9686
00878,國泰永續高股息,43,4,39,富邦-宜蘭,2024-10-16,9686
1326,台化,40,3,37,富邦-宜蘭,2024-10-16,9686
2880,華南金,38,1,37,富邦-宜蘭,2024-10-16,9686
00751B,元大AAA至A公司債,39,5,34,富邦-宜蘭,2024-10-16,9686
2314,台揚,30,2,28,富邦-宜蘭,2024-10-16,9686
4142,國光生,28,0,28,富邦-宜蘭,2024-10-16,9686
2881,富邦金,28,2,26,富邦-宜蘭,2024-10-16,9686
00941,中信上游半導體,26,0,26,富邦-宜蘭,2024-10-16,9686
2313,華通,28,3,25,富邦-宜蘭,2024-10-16,9686
6257,矽格,25,1,24,富邦-宜蘭,2024-10-16,9686
1605,華新,23,0,23,富邦-宜蘭,2024-10-16,9686
00738U,期元大道瓊白銀,20,0,20,富邦-宜蘭,2024-10-16,9686
1409,新纖,20,0,20,富邦-宜蘭,2024-10-16,9686
3550,聯穎,20,0,20,富邦-宜蘭,2024-10-16,9686
1434,福懋,20,0,20,富邦-宜蘭,2024-10-16,9686
2241,艾姆勒,53,34,19,富邦-宜蘭,2024-10-16,9686
2062,橋椿,21,2,19,富邦-宜蘭,2024-10-16,9686
00753L,中信中國50正2,126,107,19,富邦-宜蘭,2024-10-16,9686
3149,正達,106,87,19,富邦-宜蘭,2024-10-16,9686
00877,復華中國5G,18,0,18,富邦-宜蘭,2024-10-16,9686
2330,台積電,22,5,17,富邦-宜蘭,2024-10-16,9686
6530,創威,43,26,17,富邦-宜蘭,2024-10-16,9686
6274,台燿,17,0,17,富邦-宜蘭,2024-10-16,9686
4958,臻鼎-KY,16,0,16,富邦-宜蘭,2024-10-16,9686
6239,力成,16,0,16,富邦-宜蘭,2024-10-16,9686
2349,錸德,31,15,16,富邦-宜蘭,2024-10-16,9686
2382,廣達,27,11,16,富邦-宜蘭,2024-10-16,9686
00894,中信小資高價30,15,0,15,富邦-宜蘭,2024-10-16,9686
6241,易通展,15,0,15,富邦-宜蘭,2024-10-16,9686
1314,中石化,19,5,14,富邦-宜蘭,2024-10-16,9686
2258,鴻華先進-創,14,0,14,富邦-宜蘭,2024-10-16,9686
3162,精確,16,2,14,富邦-宜蘭,2024-10-16,9686
2377,微星,14,0,14,富邦-宜蘭,2024-10-16,9686
2426,鼎元,26,12,14,富邦-宜蘭,2024-10-16,9686
1301,台塑,14,0,14,富邦-宜蘭,2024-10-16,9686
00915,凱基優選高股息30,13,0,13,富邦-宜蘭,2024-10-16,9686
2888,新光金,723,1,722,富邦-宜蘭,2024-10-17,9686
00887,永豐中國科技50大,116,9,107,富邦-宜蘭,2024-10-17,9686
00922,國泰台灣領袖50,112,25,87,富邦-宜蘭,2024-10-17,9686
00687B,國泰20年美債,85,4,81,富邦-宜蘭,2024-10-17,9686
3231,緯創,106,32,74,富邦-宜蘭,2024-10-17,9686
3550,聯穎,70,0,70,富邦-宜蘭,2024-10-17,9686
00912,中信臺灣智慧50,65,0,65,富邦-宜蘭,2024-10-17,9686
0056,元大高股息,65,1,64,富邦-宜蘭,2024-10-17,9686
2305,全友,50,0,50,富邦-宜蘭,2024-10-17,9686
00945B,凱基美國非投等債,47,0,47,富邦-宜蘭,2024-10-17,9686
1528,恩德,105,60,45,富邦-宜蘭,2024-10-17,9686
00665L,富邦�琤肭磪囓�2,42,2,40,富邦-宜蘭,2024-10-17,9686
6237,驊訊,36,0,36,富邦-宜蘭,2024-10-17,9686
4956,光鋐,33,0,33,富邦-宜蘭,2024-10-17,9686
6727,亞泰金屬,33,0,33,富邦-宜蘭,2024-10-17,9686
6763,綠界科技*,41,9,32,富邦-宜蘭,2024-10-17,9686
2420,新巨,25,1,24,富邦-宜蘭,2024-10-17,9686
00882,中信中國高股息,50,27,23,富邦-宜蘭,2024-10-17,9686
4903,聯光通,50,27,23,富邦-宜蘭,2024-10-17,9686
4533,協易機,60,38,22,富邦-宜蘭,2024-10-17,9686
2399,映泰,166,144,22,富邦-宜蘭,2024-10-17,9686
2344,華邦電,24,2,22,富邦-宜蘭,2024-10-17,9686
8176,智捷,20,0,20,富邦-宜蘭,2024-10-17,9686
3236,千如,20,0,20,富邦-宜蘭,2024-10-17,9686
1714,和桐,20,0,20,富邦-宜蘭,2024-10-17,9686
6244,茂迪,20,1,19,富邦-宜蘭,2024-10-17,9686
3447,展達,19,0,19,富邦-宜蘭,2024-10-17,9686
3062,建漢,81,62,19,富邦-宜蘭,2024-10-17,9686
2330,台積電,21,2,19,富邦-宜蘭,2024-10-17,9686
2388,威盛,23,4,19,富邦-宜蘭,2024-10-17,9686
00919,群益台灣精選高息,25,7,18,富邦-宜蘭,2024-10-17,9686
1711,永光,23,5,18,富邦-宜蘭,2024-10-17,9686
6274,台燿,18,0,18,富邦-宜蘭,2024-10-17,9686
9105,泰金寶-DR,85,68,17,富邦-宜蘭,2024-10-17,9686
00905,FT臺灣Smart,17,0,17,富邦-宜蘭,2024-10-17,9686
1721,三晃,21,5,16,富邦-宜蘭,2024-10-17,9686
00632R,元大台灣50反1,15,0,15,富邦-宜蘭,2024-10-17,9686
2365,昆盈,23,8,15,富邦-宜蘭,2024-10-17,9686
1314,中石化,17,2,15,富邦-宜蘭,2024-10-17,9686
00927,群益半導體收益,15,0,15,富邦-宜蘭,2024-10-17,9686
6658,聯策,22,8,14,富邦-宜蘭,2024-10-17,9686
4977,眾達-KY,15,1,14,富邦-宜蘭,2024-10-17,9686
3209,全科,39,25,14,富邦-宜蘭,2024-10-17,9686
3450,聯鈞,77,65,12,富邦-宜蘭,2024-10-17,9686
8064,東捷,19,7,12,富邦-宜蘭,2024-10-17,9686
6241,易通展,12,0,12,富邦-宜蘭,2024-10-17,9686
00954,中信日本半導體,12,0,12,富邦-宜蘭,2024-10-17,9686
1582,信錦,11,0,11,富邦-宜蘭,2024-10-17,9686
6177,達麗,32,21,11,富邦-宜蘭,2024-10-17,9686
2303,聯電,10,0,10,富邦-宜蘭,2024-10-17,9686
00931B,統一美債20年,184,0,184,富邦-宜蘭,2024-10-18,9686
3011,今皓,154,9,145,富邦-宜蘭,2024-10-18,9686
00942B,台新美A公司債20+,134,0,134,富邦-宜蘭,2024-10-18,9686
3047,訊舟,96,14,82,富邦-宜蘭,2024-10-18,9686
6234,高僑,97,15,82,富邦-宜蘭,2024-10-18,9686
2303,聯電,71,0,71,富邦-宜蘭,2024-10-18,9686
00632R,元大台灣50反1,124,53,71,富邦-宜蘭,2024-10-18,9686
2402,毅嘉,67,7,60,富邦-宜蘭,2024-10-18,9686
4736,泰博,60,0,60,富邦-宜蘭,2024-10-18,9686
2883,凱基金,86,27,59,富邦-宜蘭,2024-10-18,9686
1301,台塑,53,3,50,富邦-宜蘭,2024-10-18,9686
2449,京元電子,63,13,50,富邦-宜蘭,2024-10-18,9686
1536,和大,57,10,47,富邦-宜蘭,2024-10-18,9686
6257,矽格,41,1,40,富邦-宜蘭,2024-10-18,9686
00945B,凱基美國非投等債,33,0,33,富邦-宜蘭,2024-10-18,9686
2867,三商壽,36,3,33,富邦-宜蘭,2024-10-18,9686
2906,高林,33,0,33,富邦-宜蘭,2024-10-18,9686
00948B,中信優息投資級債,31,0,31,富邦-宜蘭,2024-10-18,9686
1447,力鵬,30,0,30,富邦-宜蘭,2024-10-18,9686
00676R,富邦臺灣加權反1,30,0,30,富邦-宜蘭,2024-10-18,9686
2349,錸德,34,4,30,富邦-宜蘭,2024-10-18,9686
00795B,中信美國公債20年,28,0,28,富邦-宜蘭,2024-10-18,9686
00941,中信上游半導體,27,0,27,富邦-宜蘭,2024-10-18,9686
2887,台新金,33,8,25,富邦-宜蘭,2024-10-18,9686
00927,群益半導體收益,25,0,25,富邦-宜蘭,2024-10-18,9686
2497,怡利電,28,3,25,富邦-宜蘭,2024-10-18,9686
00933B,國泰10Y+金融債,27,2,25,富邦-宜蘭,2024-10-18,9686
2367,燿華,24,2,22,富邦-宜蘭,2024-10-18,9686
3710,連展投控,22,0,22,富邦-宜蘭,2024-10-18,9686
5347,世界,21,0,21,富邦-宜蘭,2024-10-18,9686
8070,長華*,21,1,20,富邦-宜蘭,2024-10-18,9686
00673R,期元大S＆P原油反1,20,0,20,富邦-宜蘭,2024-10-18,9686
00664R,國泰臺灣加權反1,20,0,20,富邦-宜蘭,2024-10-18,9686
00937B,群益ESG投等債20,22,3,19,富邦-宜蘭,2024-10-18,9686
3312,弘憶股,25,6,19,富邦-宜蘭,2024-10-18,9686
2031,新光鋼,20,1,19,富邦-宜蘭,2024-10-18,9686
5014,建錩,22,4,18,富邦-宜蘭,2024-10-18,9686
1595,川寶,20,2,18,富邦-宜蘭,2024-10-18,9686
00751B,元大AAA至A公司債,17,0,17,富邦-宜蘭,2024-10-18,9686
00715L,期街口布蘭特正2,17,0,17,富邦-宜蘭,2024-10-18,9686
2374,佳能,24,7,17,富邦-宜蘭,2024-10-18,9686
6770,力積電,18,2,16,富邦-宜蘭,2024-10-18,9686
6274,台燿,17,2,15,富邦-宜蘭,2024-10-18,9686
8111,立��,18,3,15,富邦-宜蘭,2024-10-18,9686
4562,穎漢,57,43,14,富邦-宜蘭,2024-10-18,9686
4526,東台,16,2,14,富邦-宜蘭,2024-10-18,9686
3231,緯創,28,15,13,富邦-宜蘭,2024-10-18,9686
2486,一詮,15,3,12,富邦-宜蘭,2024-10-18,9686
3374,精材,27,15,12,富邦-宜蘭,2024-10-18,9686
3450,聯鈞,39,27,12,富邦-宜蘭,2024-10-18,9686
00937B,群益ESG投等債20,235,50,185,富邦-宜蘭,2024-10-21,9686
00882,中信中國高股息,194,10,184,富邦-宜蘭,2024-10-21,9686
00905,FT臺灣Smart,169,3,166,富邦-宜蘭,2024-10-21,9686
00637L,元大滬深300正2,243,167,76,富邦-宜蘭,2024-10-21,9686
2882,國泰金,72,0,72,富邦-宜蘭,2024-10-21,9686
2312,金寶,71,1,70,富邦-宜蘭,2024-10-21,9686
1326,台化,67,1,66,富邦-宜蘭,2024-10-21,9686
00687B,國泰20年美債,87,23,64,富邦-宜蘭,2024-10-21,9686
00738U,期元大道瓊白銀,58,0,58,富邦-宜蘭,2024-10-21,9686
2891,中信金,54,1,53,富邦-宜蘭,2024-10-21,9686
2881,富邦金,51,2,49,富邦-宜蘭,2024-10-21,9686
2303,聯電,59,14,45,富邦-宜蘭,2024-10-21,9686
00715L,期街口布蘭特正2,40,0,40,富邦-宜蘭,2024-10-21,9686
2883,凱基金,48,11,37,富邦-宜蘭,2024-10-21,9686
4736,泰博,36,0,36,富邦-宜蘭,2024-10-21,9686
00912,中信臺灣智慧50,34,0,34,富邦-宜蘭,2024-10-21,9686
00907,永豐優息存股,32,0,32,富邦-宜蘭,2024-10-21,9686
2412,中華電,31,0,31,富邦-宜蘭,2024-10-21,9686
3576,聯合再生,31,1,30,富邦-宜蘭,2024-10-21,9686
2601,益航,30,0,30,富邦-宜蘭,2024-10-21,9686
00679B,元大美債20年,31,1,30,富邦-宜蘭,2024-10-21,9686
3011,今皓,95,66,29,富邦-宜蘭,2024-10-21,9686
1532,勤美,31,3,28,富邦-宜蘭,2024-10-21,9686
00958B,永豐ESG銀行債15,28,0,28,富邦-宜蘭,2024-10-21,9686
2884,玉山金,28,1,27,富邦-宜蘭,2024-10-21,9686
1595,川寶,49,22,27,富邦-宜蘭,2024-10-21,9686
6763,綠界科技*,33,6,27,富邦-宜蘭,2024-10-21,9686
00950B,凱基A級公司債,22,0,22,富邦-宜蘭,2024-10-21,9686
00650L,復華香港正2,40,18,22,富邦-宜蘭,2024-10-21,9686
00751B,元大AAA至A公司債,21,0,21,富邦-宜蘭,2024-10-21,9686
5425,台半,26,5,21,富邦-宜蘭,2024-10-21,9686
4114,健喬,20,0,20,富邦-宜蘭,2024-10-21,9686
8240,華宏,20,0,20,富邦-宜蘭,2024-10-21,9686
6165,浪凡,20,0,20,富邦-宜蘭,2024-10-21,9686
00680L,元大美債20正2,20,0,20,富邦-宜蘭,2024-10-21,9686
6274,台燿,20,0,20,富邦-宜蘭,2024-10-21,9686
3481,群創,36,16,20,富邦-宜蘭,2024-10-21,9686
00951,台新日本半導體,20,1,19,富邦-宜蘭,2024-10-21,9686
6645,金萬林-創,19,0,19,富邦-宜蘭,2024-10-21,9686
00632R,元大台灣50反1,26,7,19,富邦-宜蘭,2024-10-21,9686
00753L,中信中國50正2,42,23,19,富邦-宜蘭,2024-10-21,9686
00688L,國泰20年美債正2,17,0,17,富邦-宜蘭,2024-10-21,9686
2359,所羅門,29,13,16,富邦-宜蘭,2024-10-21,9686
1434,福懋,18,2,16,富邦-宜蘭,2024-10-21,9686
1721,三晃,24,8,16,富邦-宜蘭,2024-10-21,9686
2317,鴻海,50,34,16,富邦-宜蘭,2024-10-21,9686
6425,易發,24,9,15,富邦-宜蘭,2024-10-21,9686
6239,力成,15,0,15,富邦-宜蘭,2024-10-21,9686
1605,華新,15,0,15,富邦-宜蘭,2024-10-21,9686
00692,富邦公司治理,15,0,15,富邦-宜蘭,2024-10-21,9686
00687B,國泰20年美債,371,71,300,富邦-宜蘭,2024-10-22,9686
00937B,群益ESG投等債20,319,142,177,富邦-宜蘭,2024-10-22,9686
2543,皇昌,173,1,172,富邦-宜蘭,2024-10-22,9686
00948B,中信優息投資級債,106,0,106,富邦-宜蘭,2024-10-22,9686
6168,宏齊,105,7,98,富邦-宜蘭,2024-10-22,9686
6763,綠界科技*,107,18,89,富邦-宜蘭,2024-10-22,9686
6127,九豪,92,6,86,富邦-宜蘭,2024-10-22,9686
00679B,元大美債20年,127,55,72,富邦-宜蘭,2024-10-22,9686
00931B,統一美債20年,68,0,68,富邦-宜蘭,2024-10-22,9686
00680L,元大美債20正2,71,3,68,富邦-宜蘭,2024-10-22,9686
00905,FT臺灣Smart,67,0,67,富邦-宜蘭,2024-10-22,9686
5315,光聯,59,3,56,富邦-宜蘭,2024-10-22,9686
2889,國票金,55,0,55,富邦-宜蘭,2024-10-22,9686
3550,聯穎,58,5,53,富邦-宜蘭,2024-10-22,9686
00688L,國泰20年美債正2,68,15,53,富邦-宜蘭,2024-10-22,9686
2630,亞航,50,0,50,富邦-宜蘭,2024-10-22,9686
5481,新華,51,2,49,富邦-宜蘭,2024-10-22,9686
2312,金寶,52,5,47,富邦-宜蘭,2024-10-22,9686
00751B,元大AAA至A公司債,46,0,46,富邦-宜蘭,2024-10-22,9686
00887,永豐中國科技50大,43,0,43,富邦-宜蘭,2024-10-22,9686
00637L,元大滬深300正2,65,24,41,富邦-宜蘭,2024-10-22,9686
00632R,元大台灣50反1,45,4,41,富邦-宜蘭,2024-10-22,9686
2884,玉山金,42,5,37,富邦-宜蘭,2024-10-22,9686
4903,聯光通,35,2,33,富邦-宜蘭,2024-10-22,9686
00753L,中信中國50正2,43,10,33,富邦-宜蘭,2024-10-22,9686
00795B,中信美國公債20年,33,0,33,富邦-宜蘭,2024-10-22,9686
2208,台船,25,0,25,富邦-宜蘭,2024-10-22,9686
2888,新光金,31,6,25,富邦-宜蘭,2024-10-22,9686
2855,統一證,23,0,23,富邦-宜蘭,2024-10-22,9686
1301,台塑,25,2,23,富邦-宜蘭,2024-10-22,9686
6005,群益證,23,1,22,富邦-宜蘭,2024-10-22,9686
4541,晟田,23,1,22,富邦-宜蘭,2024-10-22,9686
00650L,復華香港正2,26,5,21,富邦-宜蘭,2024-10-22,9686
00927,群益半導體收益,21,0,21,富邦-宜蘭,2024-10-22,9686
2330,台積電,24,4,20,富邦-宜蘭,2024-10-22,9686
3576,聯合再生,21,1,20,富邦-宜蘭,2024-10-22,9686
1409,新纖,20,0,20,富邦-宜蘭,2024-10-22,9686
3189,景碩,46,26,20,富邦-宜蘭,2024-10-22,9686
2464,盟立,26,7,19,富邦-宜蘭,2024-10-22,9686
00673R,期元大S＆P原油反1,19,0,19,富邦-宜蘭,2024-10-22,9686
00892,富邦台灣半導體,21,2,19,富邦-宜蘭,2024-10-22,9686
00950B,凱基A級公司債,19,0,19,富邦-宜蘭,2024-10-22,9686
1314,中石化,28,10,18,富邦-宜蘭,2024-10-22,9686
2363,矽統,39,21,18,富邦-宜蘭,2024-10-22,9686
1434,福懋,17,0,17,富邦-宜蘭,2024-10-22,9686
00882,中信中國高股息,17,0,17,富邦-宜蘭,2024-10-22,9686
1711,永光,39,23,16,富邦-宜蘭,2024-10-22,9686
8039,台虹,20,4,16,富邦-宜蘭,2024-10-22,9686
3354,律勝,19,4,15,富邦-宜蘭,2024-10-22,9686
2303,聯電,15,0,15,富邦-宜蘭,2024-10-22,9686
00937B,群益ESG投等債20,268,31,237,富邦-宜蘭,2024-10-23,9686
00687B,國泰20年美債,178,10,168,富邦-宜蘭,2024-10-23,9686
5907,大洋-KY,103,1,102,富邦-宜蘭,2024-10-23,9686
8111,立��,112,39,73,富邦-宜蘭,2024-10-23,9686
1528,恩德,119,58,61,富邦-宜蘭,2024-10-23,9686
1434,福懋,57,0,57,富邦-宜蘭,2024-10-23,9686
00688L,國泰20年美債正2,54,0,54,富邦-宜蘭,2024-10-23,9686
2834,臺企銀,53,1,52,富邦-宜蘭,2024-10-23,9686
1314,中石化,57,6,51,富邦-宜蘭,2024-10-23,9686
1725,元禎,50,0,50,富邦-宜蘭,2024-10-23,9686
00929,復華台灣科技優息,68,22,46,富邦-宜蘭,2024-10-23,9686
00907,永豐優息存股,44,0,44,富邦-宜蘭,2024-10-23,9686
8240,華宏,40,0,40,富邦-宜蘭,2024-10-23,9686
00680L,元大美債20正2,38,0,38,富邦-宜蘭,2024-10-23,9686
00905,FT臺灣Smart,41,5,36,富邦-宜蘭,2024-10-23,9686
2886,兆豐金,36,2,34,富邦-宜蘭,2024-10-23,9686
6405,悅城,104,71,33,富邦-宜蘭,2024-10-23,9686
2906,高林,30,0,30,富邦-宜蘭,2024-10-23,9686
2929,淘帝-KY,30,0,30,富邦-宜蘭,2024-10-23,9686
00712,復華富時不動產,29,0,29,富邦-宜蘭,2024-10-23,9686
00887,永豐中國科技50大,47,18,29,富邦-宜蘭,2024-10-23,9686
3264,欣銓,26,1,25,富邦-宜蘭,2024-10-23,9686
00673R,期元大S＆P原油反1,25,0,25,富邦-宜蘭,2024-10-23,9686
00679B,元大美債20年,27,2,25,富邦-宜蘭,2024-10-23,9686
0056,元大高股息,28,6,22,富邦-宜蘭,2024-10-23,9686
2887,台新金,24,2,22,富邦-宜蘭,2024-10-23,9686
3576,聯合再生,21,0,21,富邦-宜蘭,2024-10-23,9686
00878,國泰永續高股息,23,3,20,富邦-宜蘭,2024-10-23,9686
1813,寶利徠,20,0,20,富邦-宜蘭,2024-10-23,9686
5484,慧友,20,0,20,富邦-宜蘭,2024-10-23,9686
2329,華泰,78,59,19,富邦-宜蘭,2024-10-23,9686
6156,松上,21,2,19,富邦-宜蘭,2024-10-23,9686
00882,中信中國高股息,32,13,19,富邦-宜蘭,2024-10-23,9686
3019,亞光,18,0,18,富邦-宜蘭,2024-10-23,9686
1584,精剛,19,1,18,富邦-宜蘭,2024-10-23,9686
3710,連展投控,17,0,17,富邦-宜蘭,2024-10-23,9686
2880,華南金,16,0,16,富邦-宜蘭,2024-10-23,9686
4956,光鋐,23,7,16,富邦-宜蘭,2024-10-23,9686
2618,長榮航,41,26,15,富邦-宜蘭,2024-10-23,9686
3049,精金,66,51,15,富邦-宜蘭,2024-10-23,9686
8272,全景軟體,20,5,15,富邦-宜蘭,2024-10-23,9686
6116,彩晶,15,0,15,富邦-宜蘭,2024-10-23,9686
2543,皇昌,17,2,15,富邦-宜蘭,2024-10-23,9686
00900,富邦特選高股息30,14,0,14,富邦-宜蘭,2024-10-23,9686
9945,潤泰新,18,4,14,富邦-宜蘭,2024-10-23,9686
2392,正崴,14,0,14,富邦-宜蘭,2024-10-23,9686
1605,華新,14,0,14,富邦-宜蘭,2024-10-23,9686
2889,國票金,15,1,14,富邦-宜蘭,2024-10-23,9686
2489,瑞軒,53,40,13,富邦-宜蘭,2024-10-23,9686
3715,定穎投控,34,21,13,富邦-宜蘭,2024-10-23,9686
2906,高林,154,0,154,富邦-宜蘭,2024-10-24,9686
00637L,元大滬深300正2,416,269,147,富邦-宜蘭,2024-10-24,9686
00937B,群益ESG投等債20,140,5,135,富邦-宜蘭,2024-10-24,9686
3033,威健,123,8,115,富邦-宜蘭,2024-10-24,9686
00878,國泰永續高股息,119,5,114,富邦-宜蘭,2024-10-24,9686
0056,元大高股息,107,5,102,富邦-宜蘭,2024-10-24,9686
00673R,期元大S＆P原油反1,100,0,100,富邦-宜蘭,2024-10-24,9686
1528,恩德,152,64,88,富邦-宜蘭,2024-10-24,9686
2431,聯昌,107,19,88,富邦-宜蘭,2024-10-24,9686
00688L,國泰20年美債正2,88,3,85,富邦-宜蘭,2024-10-24,9686
2543,皇昌,73,3,70,富邦-宜蘭,2024-10-24,9686
00887,永豐中國科技50大,66,10,56,富邦-宜蘭,2024-10-24,9686
00959B,大華投等美債15Y+,50,0,50,富邦-宜蘭,2024-10-24,9686
00938,凱基優選30,48,0,48,富邦-宜蘭,2024-10-24,9686
2344,華邦電,45,1,44,富邦-宜蘭,2024-10-24,9686
00929,復華台灣科技優息,71,28,43,富邦-宜蘭,2024-10-24,9686
2303,聯電,48,7,41,富邦-宜蘭,2024-10-24,9686
2464,盟立,42,5,37,富邦-宜蘭,2024-10-24,9686
3264,欣銓,37,0,37,富邦-宜蘭,2024-10-24,9686
5907,大洋-KY,35,0,35,富邦-宜蘭,2024-10-24,9686
00687B,國泰20年美債,41,7,34,富邦-宜蘭,2024-10-24,9686
2388,威盛,53,19,34,富邦-宜蘭,2024-10-24,9686
3450,聯鈞,67,34,33,富邦-宜蘭,2024-10-24,9686
3715,定穎投控,76,43,33,富邦-宜蘭,2024-10-24,9686
1301,台塑,30,0,30,富邦-宜蘭,2024-10-24,9686
2489,瑞軒,49,19,30,富邦-宜蘭,2024-10-24,9686
2449,京元電子,39,10,29,富邦-宜蘭,2024-10-24,9686
2486,一詮,54,25,29,富邦-宜蘭,2024-10-24,9686
8429,金麗-KY,28,1,27,富邦-宜蘭,2024-10-24,9686
2317,鴻海,54,27,27,富邦-宜蘭,2024-10-24,9686
2365,昆盈,37,12,25,富邦-宜蘭,2024-10-24,9686
00665L,富邦�琤肭磪囓�2,25,0,25,富邦-宜蘭,2024-10-24,9686
2891,中信金,47,23,24,富邦-宜蘭,2024-10-24,9686
00933B,國泰10Y+金融債,25,1,24,富邦-宜蘭,2024-10-24,9686
5392,能率,45,22,23,富邦-宜蘭,2024-10-24,9686
00753L,中信中國50正2,172,149,23,富邦-宜蘭,2024-10-24,9686
00680L,元大美債20正2,27,4,23,富邦-宜蘭,2024-10-24,9686
00919,群益台灣精選高息,34,13,21,富邦-宜蘭,2024-10-24,9686
2349,錸德,24,3,21,富邦-宜蘭,2024-10-24,9686
1101,台泥,26,5,21,富邦-宜蘭,2024-10-24,9686
3167,大量,28,7,21,富邦-宜蘭,2024-10-24,9686
00706L,期元大S＆P日圓正2,20,0,20,富邦-宜蘭,2024-10-24,9686
00752,中信中國50,21,2,19,富邦-宜蘭,2024-10-24,9686
00960,野村全球航運龍頭,18,1,17,富邦-宜蘭,2024-10-24,9686
4979,華星光,19,3,16,富邦-宜蘭,2024-10-24,9686
5512,力麒,20,4,16,富邦-宜蘭,2024-10-24,9686
00922,國泰台灣領袖50,16,0,16,富邦-宜蘭,2024-10-24,9686
6763,綠界科技*,22,7,15,富邦-宜蘭,2024-10-24,9686
6104,創惟,16,2,14,富邦-宜蘭,2024-10-24,9686
00950B,凱基A級公司債,14,0,14,富邦-宜蘭,2024-10-24,9686
2646,星宇航空,613,149,464,富邦-宜蘭,2024-10-25,9686
00753L,中信中國50正2,183,34,149,富邦-宜蘭,2024-10-25,9686
1815,富喬,104,8,96,富邦-宜蘭,2024-10-25,9686
00650L,復華香港正2,111,16,95,富邦-宜蘭,2024-10-25,9686
2302,麗正,70,4,66,富邦-宜蘭,2024-10-25,9686
00937B,群益ESG投等債20,61,9,52,富邦-宜蘭,2024-10-25,9686
6405,悅城,56,7,49,富邦-宜蘭,2024-10-25,9686
00887,永豐中國科技50大,48,12,36,富邦-宜蘭,2024-10-25,9686
8070,長華*,35,1,34,富邦-宜蘭,2024-10-25,9686
2303,聯電,55,22,33,富邦-宜蘭,2024-10-25,9686
2431,聯昌,49,16,33,富邦-宜蘭,2024-10-25,9686
6235,華孚,39,7,32,富邦-宜蘭,2024-10-25,9686
2495,普安,121,90,31,富邦-宜蘭,2024-10-25,9686
3447,展達,35,5,30,富邦-宜蘭,2024-10-25,9686
00959B,大華投等美債15Y+,29,0,29,富邦-宜蘭,2024-10-25,9686
00632R,元大台灣50反1,32,4,28,富邦-宜蘭,2024-10-25,9686
6283,淳安,27,0,27,富邦-宜蘭,2024-10-25,9686
6770,力積電,38,13,25,富邦-宜蘭,2024-10-25,9686
6505,台塑化,23,0,23,富邦-宜蘭,2024-10-25,9686
00751B,元大AAA至A公司債,26,3,23,富邦-宜蘭,2024-10-25,9686
4919,新唐,61,39,22,富邦-宜蘭,2024-10-25,9686
5907,大洋-KY,21,0,21,富邦-宜蘭,2024-10-25,9686
00922,國泰台灣領袖50,23,2,21,富邦-宜蘭,2024-10-25,9686
1101,台泥,20,0,20,富邦-宜蘭,2024-10-25,9686
2845,遠東銀,20,0,20,富邦-宜蘭,2024-10-25,9686
8121,越峰,21,1,20,富邦-宜蘭,2024-10-25,9686
2891,中信金,21,4,17,富邦-宜蘭,2024-10-25,9686
00878,國泰永續高股息,20,3,17,富邦-宜蘭,2024-10-25,9686
3652,精聯,19,3,16,富邦-宜蘭,2024-10-25,9686
3264,欣銓,17,1,16,富邦-宜蘭,2024-10-25,9686
6257,矽格,20,5,15,富邦-宜蘭,2024-10-25,9686
6425,易發,14,0,14,富邦-宜蘭,2024-10-25,9686
2905,三商,14,0,14,富邦-宜蘭,2024-10-25,9686
5202,力新,40,26,14,富邦-宜蘭,2024-10-25,9686
2313,華通,17,3,14,富邦-宜蘭,2024-10-25,9686
2489,瑞軒,14,0,14,富邦-宜蘭,2024-10-25,9686
00715L,期街口布蘭特正2,14,0,14,富邦-宜蘭,2024-10-25,9686
2062,橋椿,14,0,14,富邦-宜蘭,2024-10-25,9686
3455,由田,16,2,14,富邦-宜蘭,2024-10-25,9686
5522,遠雄,13,0,13,富邦-宜蘭,2024-10-25,9686
00687B,國泰20年美債,38,25,13,富邦-宜蘭,2024-10-25,9686
00960,野村全球航運龍頭,12,0,12,富邦-宜蘭,2024-10-25,9686
4743,合一,13,1,12,富邦-宜蘭,2024-10-25,9686
3663,鑫科,25,13,12,富邦-宜蘭,2024-10-25,9686
6207,雷科,13,1,12,富邦-宜蘭,2024-10-25,9686
3149,正達,18,6,12,富邦-宜蘭,2024-10-25,9686
2515,中工,21,9,12,富邦-宜蘭,2024-10-25,9686
3049,精金,13,2,11,富邦-宜蘭,2024-10-25,9686
1584,精剛,11,0,11,富邦-宜蘭,2024-10-25,9686
2413,環科,11,0,11,富邦-宜蘭,2024-10-25,9686
2845,遠東銀,230,0,230,富邦-宜蘭,2024-10-28,9686
00715L,期街口布蘭特正2,211,0,211,富邦-宜蘭,2024-10-28,9686
2365,昆盈,117,11,106,富邦-宜蘭,2024-10-28,9686
2399,映泰,95,25,70,富邦-宜蘭,2024-10-28,9686
00959B,大華投等美債15Y+,75,8,67,富邦-宜蘭,2024-10-28,9686
00931B,統一美債20年,64,3,61,富邦-宜蘭,2024-10-28,9686
2891,中信金,63,3,60,富邦-宜蘭,2024-10-28,9686
00751B,元大AAA至A公司債,55,0,55,富邦-宜蘭,2024-10-28,9686
00905,FT臺灣Smart,55,3,52,富邦-宜蘭,2024-10-28,9686
6165,浪凡,50,1,49,富邦-宜蘭,2024-10-28,9686
3049,精金,51,3,48,富邦-宜蘭,2024-10-28,9686
00937B,群益ESG投等債20,166,123,43,富邦-宜蘭,2024-10-28,9686
2543,皇昌,48,5,43,富邦-宜蘭,2024-10-28,9686
00680L,元大美債20正2,64,22,42,富邦-宜蘭,2024-10-28,9686
2615,萬海,52,12,40,富邦-宜蘭,2024-10-28,9686
3094,聯傑,40,0,40,富邦-宜蘭,2024-10-28,9686
2330,台積電,41,2,39,富邦-宜蘭,2024-10-28,9686
00688L,國泰20年美債正2,48,9,39,富邦-宜蘭,2024-10-28,9686
00946,群益科技高息成長,32,0,32,富邦-宜蘭,2024-10-28,9686
2303,聯電,31,0,31,富邦-宜蘭,2024-10-28,9686
4142,國光生,30,0,30,富邦-宜蘭,2024-10-28,9686
6283,淳安,54,26,28,富邦-宜蘭,2024-10-28,9686
00919,群益台灣精選高息,34,7,27,富邦-宜蘭,2024-10-28,9686
3231,緯創,38,12,26,富邦-宜蘭,2024-10-28,9686
6288,聯嘉,61,38,23,富邦-宜蘭,2024-10-28,9686
3062,建漢,26,4,22,富邦-宜蘭,2024-10-28,9686
2356,英業達,23,1,22,富邦-宜蘭,2024-10-28,9686
2302,麗正,43,22,21,富邦-宜蘭,2024-10-28,9686
2609,陽明,77,57,20,富邦-宜蘭,2024-10-28,9686
3289,宜特,21,1,20,富邦-宜蘭,2024-10-28,9686
6133,金橋,23,4,19,富邦-宜蘭,2024-10-28,9686
1301,台塑,23,4,19,富邦-宜蘭,2024-10-28,9686
2392,正崴,20,2,18,富邦-宜蘭,2024-10-28,9686
00918,大華優利高填息30,18,0,18,富邦-宜蘭,2024-10-28,9686
2477,美隆電,67,49,18,富邦-宜蘭,2024-10-28,9686
2376,技嘉,24,6,18,富邦-宜蘭,2024-10-28,9686
00687B,國泰20年美債,46,28,18,富邦-宜蘭,2024-10-28,9686
00933B,國泰10Y+金融債,17,0,17,富邦-宜蘭,2024-10-28,9686
3675,德微,17,0,17,富邦-宜蘭,2024-10-28,9686
2611,志信,17,0,17,富邦-宜蘭,2024-10-28,9686
6142,友勁,28,11,17,富邦-宜蘭,2024-10-28,9686
2367,燿華,17,1,16,富邦-宜蘭,2024-10-28,9686
3264,欣銓,16,0,16,富邦-宜蘭,2024-10-28,9686
8021,尖點,23,9,14,富邦-宜蘭,2024-10-28,9686
6239,力成,13,0,13,富邦-宜蘭,2024-10-28,9686
2634,漢翔,13,0,13,富邦-宜蘭,2024-10-28,9686
1514,亞力,14,2,12,富邦-宜蘭,2024-10-28,9686
6114,久威,12,0,12,富邦-宜蘭,2024-10-28,9686
5309,系統電,13,1,12,富邦-宜蘭,2024-10-28,9686
1452,宏益,72,60,12,富邦-宜蘭,2024-10-28,9686
2883,凱基金,253,12,241,富邦-宜蘭,2024-10-29,9686
3481,群創,241,38,203,富邦-宜蘭,2024-10-29,9686
2888,新光金,202,2,200,富邦-宜蘭,2024-10-29,9686
00929,復華台灣科技優息,254,54,200,富邦-宜蘭,2024-10-29,9686
00946,群益科技高息成長,166,0,166,富邦-宜蘭,2024-10-29,9686
00878,國泰永續高股息,164,8,156,富邦-宜蘭,2024-10-29,9686
2646,星宇航空,184,76,108,富邦-宜蘭,2024-10-29,9686
00918,大華優利高填息30,113,6,107,富邦-宜蘭,2024-10-29,9686
2303,聯電,102,0,102,富邦-宜蘭,2024-10-29,9686
00902,中信電池及儲能,100,0,100,富邦-宜蘭,2024-10-29,9686
00919,群益台灣精選高息,121,22,99,富邦-宜蘭,2024-10-29,9686
2365,昆盈,98,15,83,富邦-宜蘭,2024-10-29,9686
0056,元大高股息,75,0,75,富邦-宜蘭,2024-10-29,9686
00940,元大台灣價值高息,73,11,62,富邦-宜蘭,2024-10-29,9686
00715L,期街口布蘭特正2,58,0,58,富邦-宜蘭,2024-10-29,9686
2317,鴻海,86,34,52,富邦-宜蘭,2024-10-29,9686
2515,中工,57,10,47,富邦-宜蘭,2024-10-29,9686
1528,恩德,62,16,46,富邦-宜蘭,2024-10-29,9686
1449,佳和,64,21,43,富邦-宜蘭,2024-10-29,9686
6770,力積電,42,2,40,富邦-宜蘭,2024-10-29,9686
2344,華邦電,38,1,37,富邦-宜蘭,2024-10-29,9686
00687B,國泰20年美債,40,5,35,富邦-宜蘭,2024-10-29,9686
00665L,富邦�琤肭磪囓�2,37,5,32,富邦-宜蘭,2024-10-29,9686
5880,合庫金,30,0,30,富邦-宜蘭,2024-10-29,9686
2409,友達,28,0,28,富邦-宜蘭,2024-10-29,9686
6505,台塑化,27,0,27,富邦-宜蘭,2024-10-29,9686
2882,國泰金,25,0,25,富邦-宜蘭,2024-10-29,9686
00881,國泰台灣5G+,25,0,25,富邦-宜蘭,2024-10-29,9686
00712,復華富時不動產,28,5,23,富邦-宜蘭,2024-10-29,9686
00922,國泰台灣領袖50,23,1,22,富邦-宜蘭,2024-10-29,9686
6156,松上,23,1,22,富邦-宜蘭,2024-10-29,9686
3552,同致,29,8,21,富邦-宜蘭,2024-10-29,9686
1540,喬福,28,7,21,富邦-宜蘭,2024-10-29,9686
1905,華紙,21,0,21,富邦-宜蘭,2024-10-29,9686
3005,神基,20,0,20,富邦-宜蘭,2024-10-29,9686
1455,集盛,20,0,20,富邦-宜蘭,2024-10-29,9686
4960,誠美材,20,0,20,富邦-宜蘭,2024-10-29,9686
2349,錸德,18,0,18,富邦-宜蘭,2024-10-29,9686
00738U,期元大道瓊白銀,17,0,17,富邦-宜蘭,2024-10-29,9686
2543,皇昌,17,0,17,富邦-宜蘭,2024-10-29,9686
8107,大億金茂,42,25,17,富邦-宜蘭,2024-10-29,9686
2453,凌群,16,0,16,富邦-宜蘭,2024-10-29,9686
6191,精成科,16,0,16,富邦-宜蘭,2024-10-29,9686
00905,FT臺灣Smart,16,0,16,富邦-宜蘭,2024-10-29,9686
6274,台燿,17,2,15,富邦-宜蘭,2024-10-29,9686
5398,慕康生醫,15,0,15,富邦-宜蘭,2024-10-29,9686
00633L,富邦上証正2,15,0,15,富邦-宜蘭,2024-10-29,9686
3062,建漢,28,14,14,富邦-宜蘭,2024-10-29,9686
6239,力成,13,0,13,富邦-宜蘭,2024-10-29,9686
00953B,群益優選非投等債,13,0,13,富邦-宜蘭,2024-10-29,9686
2888,新光金,200,0,200,富邦-宜蘭,2024-10-30,9686
8070,長華*,136,0,136,富邦-宜蘭,2024-10-30,9686
3481,群創,116,36,80,富邦-宜蘭,2024-10-30,9686
00712,復華富時不動產,77,2,75,富邦-宜蘭,2024-10-30,9686
2337,旺宏,74,1,73,富邦-宜蘭,2024-10-30,9686
00753L,中信中國50正2,86,20,66,富邦-宜蘭,2024-10-30,9686
2303,聯電,71,20,51,富邦-宜蘭,2024-10-30,9686
00918,大華優利高填息30,51,0,51,富邦-宜蘭,2024-10-30,9686
00757,統一FANG+,50,0,50,富邦-宜蘭,2024-10-30,9686
9945,潤泰新,50,0,50,富邦-宜蘭,2024-10-30,9686
00929,復華台灣科技優息,77,27,50,富邦-宜蘭,2024-10-30,9686
2834,臺企銀,50,2,48,富邦-宜蘭,2024-10-30,9686
00637L,元大滬深300正2,65,19,46,富邦-宜蘭,2024-10-30,9686
2543,皇昌,67,23,44,富邦-宜蘭,2024-10-30,9686
00953B,群益優選非投等債,40,0,40,富邦-宜蘭,2024-10-30,9686
00919,群益台灣精選高息,55,19,36,富邦-宜蘭,2024-10-30,9686
4919,新唐,52,20,32,富邦-宜蘭,2024-10-30,9686
5014,建錩,32,0,32,富邦-宜蘭,2024-10-30,9686
4532,瑞智,31,0,31,富邦-宜蘭,2024-10-30,9686
2409,友達,31,0,31,富邦-宜蘭,2024-10-30,9686
6257,矽格,32,2,30,富邦-宜蘭,2024-10-30,9686
2328,廣宇,50,22,28,富邦-宜蘭,2024-10-30,9686
2618,長榮航,30,3,27,富邦-宜蘭,2024-10-30,9686
2449,京元電子,28,3,25,富邦-宜蘭,2024-10-30,9686
8021,尖點,25,0,25,富邦-宜蘭,2024-10-30,9686
2344,華邦電,25,0,25,富邦-宜蘭,2024-10-30,9686
3047,訊舟,37,13,24,富邦-宜蘭,2024-10-30,9686
00715L,期街口布蘭特正2,26,3,23,富邦-宜蘭,2024-10-30,9686
00940,元大台灣價值高息,22,0,22,富邦-宜蘭,2024-10-30,9686
00882,中信中國高股息,21,0,21,富邦-宜蘭,2024-10-30,9686
3264,欣銓,21,0,21,富邦-宜蘭,2024-10-30,9686
2885,元大金,20,0,20,富邦-宜蘭,2024-10-30,9686
2426,鼎元,20,0,20,富邦-宜蘭,2024-10-30,9686
00887,永豐中國科技50大,25,6,19,富邦-宜蘭,2024-10-30,9686
00633L,富邦上証正2,19,0,19,富邦-宜蘭,2024-10-30,9686
00650L,復華香港正2,34,15,19,富邦-宜蘭,2024-10-30,9686
6770,力積電,35,17,18,富邦-宜蘭,2024-10-30,9686
1605,華新,17,1,16,富邦-宜蘭,2024-10-30,9686
2477,美隆電,38,22,16,富邦-宜蘭,2024-10-30,9686
2515,中工,18,2,16,富邦-宜蘭,2024-10-30,9686
00932,兆豐永續高息等權,15,0,15,富邦-宜蘭,2024-10-30,9686
3567,逸昌,15,0,15,富邦-宜蘭,2024-10-30,9686
6156,松上,15,0,15,富邦-宜蘭,2024-10-30,9686
3325,旭品,22,7,15,富邦-宜蘭,2024-10-30,9686
1568,倉佑,19,4,15,富邦-宜蘭,2024-10-30,9686
3715,定穎投控,17,2,15,富邦-宜蘭,2024-10-30,9686
3709,鑫聯大投控,16,2,14,富邦-宜蘭,2024-10-30,9686
00958B,永豐ESG銀行債15,14,0,14,富邦-宜蘭,2024-10-30,9686
8011,台通,16,3,13,富邦-宜蘭,2024-10-30,9686
4945,陞達科技,13,0,13,富邦-宜蘭,2024-10-30,9686
2888,新光金,606,5,601,富邦-宜蘭,2024-11-01,9686
2303,聯電,157,16,141,富邦-宜蘭,2024-11-01,9686
00882,中信中國高股息,142,10,132,富邦-宜蘭,2024-11-01,9686
00878,國泰永續高股息,135,12,123,富邦-宜蘭,2024-11-01,9686
2884,玉山金,115,3,112,富邦-宜蘭,2024-11-01,9686
00929,復華台灣科技優息,124,23,101,富邦-宜蘭,2024-11-01,9686
00919,群益台灣精選高息,117,21,96,富邦-宜蘭,2024-11-01,9686
3481,群創,111,15,96,富邦-宜蘭,2024-11-01,9686
6257,矽格,72,2,70,富邦-宜蘭,2024-11-01,9686
0056,元大高股息,62,0,62,富邦-宜蘭,2024-11-01,9686
00673R,期元大S＆P原油反1,88,30,58,富邦-宜蘭,2024-11-01,9686
2405,輔信,55,1,54,富邦-宜蘭,2024-11-01,9686
00706L,期元大S＆P日圓正2,50,0,50,富邦-宜蘭,2024-11-01,9686
2399,映泰,72,24,48,富邦-宜蘭,2024-11-01,9686
2618,長榮航,50,6,44,富邦-宜蘭,2024-11-01,9686
2887,台新金,35,0,35,富邦-宜蘭,2024-11-01,9686
2881,富邦金,56,22,34,富邦-宜蘭,2024-11-01,9686
2409,友達,38,5,33,富邦-宜蘭,2024-11-01,9686
00915,凱基優選高股息30,34,2,32,富邦-宜蘭,2024-11-01,9686
2317,鴻海,77,49,28,富邦-宜蘭,2024-11-01,9686
00712,復華富時不動產,27,0,27,富邦-宜蘭,2024-11-01,9686
00713,元大台灣高息低波,27,0,27,富邦-宜蘭,2024-11-01,9686
00887,永豐中國科技50大,37,10,27,富邦-宜蘭,2024-11-01,9686
2337,旺宏,29,3,26,富邦-宜蘭,2024-11-01,9686
2382,廣達,29,5,24,富邦-宜蘭,2024-11-01,9686
2891,中信金,29,5,24,富邦-宜蘭,2024-11-01,9686
2330,台積電,35,11,24,富邦-宜蘭,2024-11-01,9686
2882,國泰金,25,3,22,富邦-宜蘭,2024-11-01,9686
6606,建德工業,25,5,20,富邦-宜蘭,2024-11-01,9686
5471,松翰,25,5,20,富邦-宜蘭,2024-11-01,9686
2301,光寶科,20,1,19,富邦-宜蘭,2024-11-01,9686
3062,建漢,51,32,19,富邦-宜蘭,2024-11-01,9686
00900,富邦特選高股息30,18,0,18,富邦-宜蘭,2024-11-01,9686
1449,佳和,29,11,18,富邦-宜蘭,2024-11-01,9686
006208,富邦台50,18,0,18,富邦-宜蘭,2024-11-01,9686
2543,皇昌,23,7,16,富邦-宜蘭,2024-11-01,9686
4162,智擎,24,8,16,富邦-宜蘭,2024-11-01,9686
00885,富邦越南,16,0,16,富邦-宜蘭,2024-11-01,9686
6727,亞泰金屬,15,0,15,富邦-宜蘭,2024-11-01,9686
00945B,凱基美國非投等債,18,3,15,富邦-宜蘭,2024-11-01,9686
2354,鴻準,430,415,15,富邦-宜蘭,2024-11-01,9686
2353,宏��,17,3,14,富邦-宜蘭,2024-11-01,9686
6216,居易,84,70,14,富邦-宜蘭,2024-11-01,9686
6768,志強-KY,17,3,14,富邦-宜蘭,2024-11-01,9686
1301,台塑,20,7,13,富邦-宜蘭,2024-11-01,9686
2465,麗臺,12,0,12,富邦-宜蘭,2024-11-01,9686
00923,群益台ESG低碳50,12,0,12,富邦-宜蘭,2024-11-01,9686
6168,宏齊,12,0,12,富邦-宜蘭,2024-11-01,9686
2349,錸德,16,5,11,富邦-宜蘭,2024-11-01,9686
4956,光鋐,13,2,11,富邦-宜蘭,2024-11-01,9686
00932,兆豐永續高息等權,248,0,248,富邦-宜蘭,2024-11-04,9686
2834,臺企銀,220,11,209,富邦-宜蘭,2024-11-04,9686
00878,國泰永續高股息,143,1,142,富邦-宜蘭,2024-11-04,9686
00937B,群益ESG投等債20,133,0,133,富邦-宜蘭,2024-11-04,9686
00712,復華富時不動產,126,0,126,富邦-宜蘭,2024-11-04,9686
2609,陽明,270,148,122,富邦-宜蘭,2024-11-04,9686
00943,兆豐電子高息等權,85,0,85,富邦-宜蘭,2024-11-04,9686
00929,復華台灣科技優息,383,304,79,富邦-宜蘭,2024-11-04,9686
1815,富喬,80,4,76,富邦-宜蘭,2024-11-04,9686
2888,新光金,94,20,74,富邦-宜蘭,2024-11-04,9686
00919,群益台灣精選高息,154,88,66,富邦-宜蘭,2024-11-04,9686
2405,輔信,67,2,65,富邦-宜蘭,2024-11-04,9686
00953B,群益優選非投等債,63,0,63,富邦-宜蘭,2024-11-04,9686
2409,友達,61,0,61,富邦-宜蘭,2024-11-04,9686
1326,台化,60,1,59,富邦-宜蘭,2024-11-04,9686
00637L,元大滬深300正2,59,3,56,富邦-宜蘭,2024-11-04,9686
9945,潤泰新,51,0,51,富邦-宜蘭,2024-11-04,9686
00680L,元大美債20正2,47,2,45,富邦-宜蘭,2024-11-04,9686
2303,聯電,58,14,44,富邦-宜蘭,2024-11-04,9686
00959B,大華投等美債15Y+,41,0,41,富邦-宜蘭,2024-11-04,9686
00900,富邦特選高股息30,34,0,34,富邦-宜蘭,2024-11-04,9686
00907,永豐優息存股,31,0,31,富邦-宜蘭,2024-11-04,9686
4991,環宇-KY,43,13,30,富邦-宜蘭,2024-11-04,9686
4934,太極,30,0,30,富邦-宜蘭,2024-11-04,9686
00933B,國泰10Y+金融債,29,0,29,富邦-宜蘭,2024-11-04,9686
2646,星宇航空,38,11,27,富邦-宜蘭,2024-11-04,9686
00945B,凱基美國非投等債,26,0,26,富邦-宜蘭,2024-11-04,9686
2431,聯昌,61,36,25,富邦-宜蘭,2024-11-04,9686
00673R,期元大S＆P原油反1,22,0,22,富邦-宜蘭,2024-11-04,9686
00679B,元大美債20年,43,21,22,富邦-宜蘭,2024-11-04,9686
00688L,國泰20年美債正2,21,0,21,富邦-宜蘭,2024-11-04,9686
2355,敬鵬,21,0,21,富邦-宜蘭,2024-11-04,9686
4927,泰鼎-KY,21,0,21,富邦-宜蘭,2024-11-04,9686
4207,環泰,18,0,18,富邦-宜蘭,2024-11-04,9686
00650L,復華香港正2,30,12,18,富邦-宜蘭,2024-11-04,9686
2208,台船,20,2,18,富邦-宜蘭,2024-11-04,9686
2615,萬海,117,100,17,富邦-宜蘭,2024-11-04,9686
00751B,元大AAA至A公司債,16,0,16,富邦-宜蘭,2024-11-04,9686
6425,易發,19,3,16,富邦-宜蘭,2024-11-04,9686
00633L,富邦上証正2,16,0,16,富邦-宜蘭,2024-11-04,9686
2489,瑞軒,18,2,16,富邦-宜蘭,2024-11-04,9686
6768,志強-KY,20,5,15,富邦-宜蘭,2024-11-04,9686
2329,華泰,20,5,15,富邦-宜蘭,2024-11-04,9686
1434,福懋,15,0,15,富邦-宜蘭,2024-11-04,9686
1449,佳和,16,2,14,富邦-宜蘭,2024-11-04,9686
1603,華電,14,0,14,富邦-宜蘭,2024-11-04,9686
00753L,中信中國50正2,36,22,14,富邦-宜蘭,2024-11-04,9686
5014,建錩,14,0,14,富邦-宜蘭,2024-11-04,9686
00687B,國泰20年美債,15,2,13,富邦-宜蘭,2024-11-04,9686
2425,承啟,14,1,13,富邦-宜蘭,2024-11-04,9686
8429,金麗-KY,152,2,150,富邦-宜蘭,2024-11-05,9686
2303,聯電,189,43,146,富邦-宜蘭,2024-11-05,9686
5907,大洋-KY,100,5,95,富邦-宜蘭,2024-11-05,9686
00919,群益台灣精選高息,112,42,70,富邦-宜蘭,2024-11-05,9686
2354,鴻準,229,164,65,富邦-宜蘭,2024-11-05,9686
00929,復華台灣科技優息,94,36,58,富邦-宜蘭,2024-11-05,9686
00650L,復華香港正2,98,44,54,富邦-宜蘭,2024-11-05,9686
8070,長華*,53,2,51,富邦-宜蘭,2024-11-05,9686
4430,耀億,50,2,48,富邦-宜蘭,2024-11-05,9686
6152,百一,40,0,40,富邦-宜蘭,2024-11-05,9686
3303,岱稜,42,5,37,富邦-宜蘭,2024-11-05,9686
6176,瑞儀,32,0,32,富邦-宜蘭,2024-11-05,9686
2834,臺企銀,31,0,31,富邦-宜蘭,2024-11-05,9686
1528,恩德,44,16,28,富邦-宜蘭,2024-11-05,9686
2906,高林,26,0,26,富邦-宜蘭,2024-11-05,9686
4956,光鋐,43,18,25,富邦-宜蘭,2024-11-05,9686
6134,萬旭,28,4,24,富邦-宜蘭,2024-11-05,9686
6288,聯嘉,22,0,22,富邦-宜蘭,2024-11-05,9686
1708,東鹼,21,1,20,富邦-宜蘭,2024-11-05,9686
1409,新纖,20,0,20,富邦-宜蘭,2024-11-05,9686
00952,凱基台灣AI50,20,0,20,富邦-宜蘭,2024-11-05,9686
00673R,期元大S＆P原油反1,18,0,18,富邦-宜蘭,2024-11-05,9686
3711,日月光投控,16,0,16,富邦-宜蘭,2024-11-05,9686
2351,順德,15,0,15,富邦-宜蘭,2024-11-05,9686
3049,精金,126,111,15,富邦-宜蘭,2024-11-05,9686
6739,竹陞科技,25,10,15,富邦-宜蘭,2024-11-05,9686
00675L,富邦臺灣加權正2,15,0,15,富邦-宜蘭,2024-11-05,9686
4545,銘鈺,17,3,14,富邦-宜蘭,2024-11-05,9686
3490,單井,24,10,14,富邦-宜蘭,2024-11-05,9686
9105,泰金寶-DR,16,3,13,富邦-宜蘭,2024-11-05,9686
00931B,統一美債20年,13,0,13,富邦-宜蘭,2024-11-05,9686
1326,台化,14,1,13,富邦-宜蘭,2024-11-05,9686
00878,國泰永續高股息,37,25,12,富邦-宜蘭,2024-11-05,9686
00844B,新光15年IG金融債,12,0,12,富邦-宜蘭,2024-11-05,9686
3083,網龍,12,0,12,富邦-宜蘭,2024-11-05,9686
2486,一詮,16,4,12,富邦-宜蘭,2024-11-05,9686
00905,FT臺灣Smart,11,0,11,富邦-宜蘭,2024-11-05,9686
4991,環宇-KY,59,48,11,富邦-宜蘭,2024-11-05,9686
2543,皇昌,17,6,11,富邦-宜蘭,2024-11-05,9686
5315,光聯,14,3,11,富邦-宜蘭,2024-11-05,9686
2337,旺宏,10,0,10,富邦-宜蘭,2024-11-05,9686
6177,達麗,10,0,10,富邦-宜蘭,2024-11-05,9686
6708,天擎,10,0,10,富邦-宜蘭,2024-11-05,9686
2070,精湛,19,9,10,富邦-宜蘭,2024-11-05,9686
4538,大詠城,10,0,10,富邦-宜蘭,2024-11-05,9686
00730,富邦臺灣優質高息,10,0,10,富邦-宜蘭,2024-11-05,9686
2328,廣宇,16,6,10,富邦-宜蘭,2024-11-05,9686
00943,兆豐電子高息等權,9,0,9,富邦-宜蘭,2024-11-05,9686
00937B,群益ESG投等債20,15,6,9,富邦-宜蘭,2024-11-05,9686
3163,波若威,10,1,9,富邦-宜蘭,2024-11-05,9686
00650L,復華香港正2,234,2,232,富邦-宜蘭,2024-11-06,9686
2613,中櫃,192,36,156,富邦-宜蘭,2024-11-06,9686
00687B,國泰20年美債,147,7,140,富邦-宜蘭,2024-11-06,9686
1449,佳和,122,28,94,富邦-宜蘭,2024-11-06,9686
00753L,中信中國50正2,93,2,91,富邦-宜蘭,2024-11-06,9686
00905,FT臺灣Smart,78,5,73,富邦-宜蘭,2024-11-06,9686
00680L,元大美債20正2,120,48,72,富邦-宜蘭,2024-11-06,9686
00918,大華優利高填息30,70,5,65,富邦-宜蘭,2024-11-06,9686
00907,永豐優息存股,59,0,59,富邦-宜蘭,2024-11-06,9686
00937B,群益ESG投等債20,82,24,58,富邦-宜蘭,2024-11-06,9686
00679B,元大美債20年,81,28,53,富邦-宜蘭,2024-11-06,9686
2834,臺企銀,50,0,50,富邦-宜蘭,2024-11-06,9686
3011,今皓,50,3,47,富邦-宜蘭,2024-11-06,9686
6156,松上,45,0,45,富邦-宜蘭,2024-11-06,9686
00632R,元大台灣50反1,192,155,37,富邦-宜蘭,2024-11-06,9686
2609,陽明,138,105,33,富邦-宜蘭,2024-11-06,9686
6153,嘉聯益,31,1,30,富邦-宜蘭,2024-11-06,9686
00688L,國泰20年美債正2,122,93,29,富邦-宜蘭,2024-11-06,9686
1434,福懋,25,0,25,富邦-宜蘭,2024-11-06,9686
8249,菱光,72,48,24,富邦-宜蘭,2024-11-06,9686
00931B,統一美債20年,37,14,23,富邦-宜蘭,2024-11-06,9686
2431,聯昌,90,67,23,富邦-宜蘭,2024-11-06,9686
2615,萬海,123,100,23,富邦-宜蘭,2024-11-06,9686
2031,新光鋼,22,0,22,富邦-宜蘭,2024-11-06,9686
00665L,富邦�琤肭磪囓�2,125,103,22,富邦-宜蘭,2024-11-06,9686
2515,中工,30,8,22,富邦-宜蘭,2024-11-06,9686
00933B,國泰10Y+金融債,21,0,21,富邦-宜蘭,2024-11-06,9686
2409,友達,22,1,21,富邦-宜蘭,2024-11-06,9686
00712,復華富時不動產,22,5,17,富邦-宜蘭,2024-11-06,9686
2634,漢翔,21,4,17,富邦-宜蘭,2024-11-06,9686
2399,映泰,70,54,16,富邦-宜蘭,2024-11-06,9686
00948B,中信優息投資級債,16,0,16,富邦-宜蘭,2024-11-06,9686
2419,仲琦,23,7,16,富邦-宜蘭,2024-11-06,9686
8011,台通,16,0,16,富邦-宜蘭,2024-11-06,9686
2646,星宇航空,27,12,15,富邦-宜蘭,2024-11-06,9686
2062,橋椿,15,0,15,富邦-宜蘭,2024-11-06,9686
00960,野村全球航運龍頭,15,0,15,富邦-宜蘭,2024-11-06,9686
4726,永昕,15,0,15,富邦-宜蘭,2024-11-06,9686
6768,志強-KY,17,2,15,富邦-宜蘭,2024-11-06,9686
2906,高林,14,0,14,富邦-宜蘭,2024-11-06,9686
2929,淘帝-KY,15,2,13,富邦-宜蘭,2024-11-06,9686
4919,新唐,18,5,13,富邦-宜蘭,2024-11-06,9686
2892,第一金,19,7,12,富邦-宜蘭,2024-11-06,9686
8429,金麗-KY,12,0,12,富邦-宜蘭,2024-11-06,9686
8150,南茂,13,1,12,富邦-宜蘭,2024-11-06,9686
3710,連展投控,12,0,12,富邦-宜蘭,2024-11-06,9686
5907,大洋-KY,17,5,12,富邦-宜蘭,2024-11-06,9686
4510,高鋒,19,8,11,富邦-宜蘭,2024-11-06,9686
00637L,元大滬深300正2,74,63,11,富邦-宜蘭,2024-11-06,9686
6120,達運,11,0,11,富邦-宜蘭,2024-11-06,9686
2344,華邦電,169,10,159,富邦-宜蘭,2024-11-07,9686
9105,泰金寶-DR,153,28,125,富邦-宜蘭,2024-11-07,9686
00895,富邦未來車,124,3,121,富邦-宜蘭,2024-11-07,9686
3550,聯穎,81,0,81,富邦-宜蘭,2024-11-07,9686
1451,年興,82,2,80,富邦-宜蘭,2024-11-07,9686
6288,聯嘉,103,32,71,富邦-宜蘭,2024-11-07,9686
8070,長華*,68,2,66,富邦-宜蘭,2024-11-07,9686
6176,瑞儀,62,0,62,富邦-宜蘭,2024-11-07,9686
00632R,元大台灣50反1,68,8,60,富邦-宜蘭,2024-11-07,9686
2314,台揚,56,9,47,富邦-宜蘭,2024-11-07,9686
00887,永豐中國科技50大,62,20,42,富邦-宜蘭,2024-11-07,9686
00673R,期元大S＆P原油反1,41,0,41,富邦-宜蘭,2024-11-07,9686
1540,喬福,41,4,37,富邦-宜蘭,2024-11-07,9686
00680L,元大美債20正2,46,9,37,富邦-宜蘭,2024-11-07,9686
3303,岱稜,37,3,34,富邦-宜蘭,2024-11-07,9686
2399,映泰,46,16,30,富邦-宜蘭,2024-11-07,9686
00688L,國泰20年美債正2,28,0,28,富邦-宜蘭,2024-11-07,9686
3019,亞光,29,4,25,富邦-宜蘭,2024-11-07,9686
006208,富邦台50,27,5,22,富邦-宜蘭,2024-11-07,9686
00878,國泰永續高股息,63,41,22,富邦-宜蘭,2024-11-07,9686
6116,彩晶,22,1,21,富邦-宜蘭,2024-11-07,9686
8155,博智,20,0,20,富邦-宜蘭,2024-11-07,9686
4956,光鋐,23,3,20,富邦-宜蘭,2024-11-07,9686
6274,台燿,21,2,19,富邦-宜蘭,2024-11-07,9686
2646,星宇航空,20,1,19,富邦-宜蘭,2024-11-07,9686
2014,中鴻,63,46,17,富邦-宜蘭,2024-11-07,9686
2489,瑞軒,22,6,16,富邦-宜蘭,2024-11-07,9686
00675L,富邦臺灣加權正2,19,3,16,富邦-宜蘭,2024-11-07,9686
1452,宏益,55,40,15,富邦-宜蘭,2024-11-07,9686
3033,威健,16,1,15,富邦-宜蘭,2024-11-07,9686
2313,華通,37,22,15,富邦-宜蘭,2024-11-07,9686
00665L,富邦�琤肭磪囓�2,32,18,14,富邦-宜蘭,2024-11-07,9686
2615,萬海,33,20,13,富邦-宜蘭,2024-11-07,9686
8044,網家,19,7,12,富邦-宜蘭,2024-11-07,9686
2062,橋椿,12,0,12,富邦-宜蘭,2024-11-07,9686
1809,中釉,12,0,12,富邦-宜蘭,2024-11-07,9686
2425,承啟,18,6,12,富邦-宜蘭,2024-11-07,9686
4927,泰鼎-KY,12,0,12,富邦-宜蘭,2024-11-07,9686
3006,晶豪科,12,0,12,富邦-宜蘭,2024-11-07,9686
2889,國票金,12,0,12,富邦-宜蘭,2024-11-07,9686
2351,順德,18,7,11,富邦-宜蘭,2024-11-07,9686
00918,大華優利高填息30,11,0,11,富邦-宜蘭,2024-11-07,9686
3552,同致,13,2,11,富邦-宜蘭,2024-11-07,9686
2906,高林,11,0,11,富邦-宜蘭,2024-11-07,9686
2603,長榮,35,24,11,富邦-宜蘭,2024-11-07,9686
8112,至上,13,3,10,富邦-宜蘭,2024-11-07,9686
6112,邁達特,10,0,10,富邦-宜蘭,2024-11-07,9686
1312,國喬,10,0,10,富邦-宜蘭,2024-11-07,9686
6109,亞元,10,0,10,富邦-宜蘭,2024-11-07,9686
6026,福邦證,10,0,10,富邦-宜蘭,2024-11-07,9686
00632R,元大台灣50反1,273,0,273,富邦-宜蘭,2024-11-08,9686
1531,高林股,234,31,203,富邦-宜蘭,2024-11-08,9686
00637L,元大滬深300正2,153,27,126,富邦-宜蘭,2024-11-08,9686
2409,友達,101,1,100,富邦-宜蘭,2024-11-08,9686
6505,台塑化,100,0,100,富邦-宜蘭,2024-11-08,9686
00878,國泰永續高股息,101,25,76,富邦-宜蘭,2024-11-08,9686
00943,兆豐電子高息等權,71,0,71,富邦-宜蘭,2024-11-08,9686
3062,建漢,111,43,68,富邦-宜蘭,2024-11-08,9686
00932,兆豐永續高息等權,68,0,68,富邦-宜蘭,2024-11-08,9686
2613,中櫃,129,62,67,富邦-宜蘭,2024-11-08,9686
00882,中信中國高股息,152,87,65,富邦-宜蘭,2024-11-08,9686
00934,中信成長高股息,71,8,63,富邦-宜蘭,2024-11-08,9686
6216,居易,73,10,63,富邦-宜蘭,2024-11-08,9686
6153,嘉聯益,61,0,61,富邦-宜蘭,2024-11-08,9686
00945B,凱基美國非投等債,60,0,60,富邦-宜蘭,2024-11-08,9686
9105,泰金寶-DR,82,28,54,富邦-宜蘭,2024-11-08,9686
2303,聯電,61,9,52,富邦-宜蘭,2024-11-08,9686
2027,大成鋼,54,3,51,富邦-宜蘭,2024-11-08,9686
2388,威盛,53,7,46,富邦-宜蘭,2024-11-08,9686
3056,富華新,46,1,45,富邦-宜蘭,2024-11-08,9686
5907,大洋-KY,42,4,38,富邦-宜蘭,2024-11-08,9686
2646,星宇航空,55,18,37,富邦-宜蘭,2024-11-08,9686
00712,復華富時不動產,37,1,36,富邦-宜蘭,2024-11-08,9686
2406,國碩,30,0,30,富邦-宜蘭,2024-11-08,9686
4960,誠美材,30,0,30,富邦-宜蘭,2024-11-08,9686
2344,華邦電,41,11,30,富邦-宜蘭,2024-11-08,9686
2313,華通,40,11,29,富邦-宜蘭,2024-11-08,9686
3149,正達,36,7,29,富邦-宜蘭,2024-11-08,9686
00918,大華優利高填息30,43,16,27,富邦-宜蘭,2024-11-08,9686
2405,輔信,28,4,24,富邦-宜蘭,2024-11-08,9686
2368,金像電,28,5,23,富邦-宜蘭,2024-11-08,9686
4533,協易機,24,1,23,富邦-宜蘭,2024-11-08,9686
2392,正崴,97,75,22,富邦-宜蘭,2024-11-08,9686
5452,佶優,21,0,21,富邦-宜蘭,2024-11-08,9686
3498,陽程,23,2,21,富邦-宜蘭,2024-11-08,9686
2408,南亞科,23,2,21,富邦-宜蘭,2024-11-08,9686
00665L,富邦�琤肭磪囓�2,144,123,21,富邦-宜蘭,2024-11-08,9686
6196,帆宣,20,1,19,富邦-宜蘭,2024-11-08,9686
2543,皇昌,46,28,18,富邦-宜蘭,2024-11-08,9686
2353,宏��,33,15,18,富邦-宜蘭,2024-11-08,9686
2515,中工,18,0,18,富邦-宜蘭,2024-11-08,9686
9958,世紀鋼,78,61,17,富邦-宜蘭,2024-11-08,9686
3037,欣興,29,11,18,富邦-宜蘭,2024-11-08,9686
2731,雄獅,19,2,17,富邦-宜蘭,2024-11-08,9686
8043,蜜望實,17,0,17,富邦-宜蘭,2024-11-08,9686
8096,擎亞,21,6,15,富邦-宜蘭,2024-11-08,9686
2385,群光,15,0,15,富邦-宜蘭,2024-11-08,9686
00639,富邦深100,15,0,15,富邦-宜蘭,2024-11-08,9686
3715,定穎投控,20,5,15,富邦-宜蘭,2024-11-08,9686
6530,創威,20,6,14,富邦-宜蘭,2024-11-08,9686
00650L,復華香港正2,154,0,154,富邦-宜蘭,2024-11-11,9686
2303,聯電,162,14,148,富邦-宜蘭,2024-11-11,9686
2506,太設,141,0,141,富邦-宜蘭,2024-11-11,9686
2609,陽明,198,76,122,富邦-宜蘭,2024-11-11,9686
00937B,群益ESG投等債20,205,84,121,富邦-宜蘭,2024-11-11,9686
00878,國泰永續高股息,115,17,98,富邦-宜蘭,2024-11-11,9686
1326,台化,94,5,89,富邦-宜蘭,2024-11-11,9686
00665L,富邦�琤肭磪囓�2,133,66,67,富邦-宜蘭,2024-11-11,9686
3062,建漢,87,20,67,富邦-宜蘭,2024-11-11,9686
00715L,期街口布蘭特正2,65,0,65,富邦-宜蘭,2024-11-11,9686
2495,普安,58,3,55,富邦-宜蘭,2024-11-11,9686
2441,超豐,54,0,54,富邦-宜蘭,2024-11-11,9686
3260,威剛,50,1,49,富邦-宜蘭,2024-11-11,9686
2354,鴻準,275,230,45,富邦-宜蘭,2024-11-11,9686
00753L,中信中國50正2,72,28,44,富邦-宜蘭,2024-11-11,9686
00943,兆豐電子高息等權,41,0,41,富邦-宜蘭,2024-11-11,9686
00945B,凱基美國非投等債,40,0,40,富邦-宜蘭,2024-11-11,9686
1449,佳和,72,33,39,富邦-宜蘭,2024-11-11,9686
5490,同亨,39,1,38,富邦-宜蘭,2024-11-11,9686
0056,元大高股息,36,0,36,富邦-宜蘭,2024-11-11,9686
2641,正德,35,0,35,富邦-宜蘭,2024-11-11,9686
00919,群益台灣精選高息,47,13,34,富邦-宜蘭,2024-11-11,9686
4933,友輝,33,1,32,富邦-宜蘭,2024-11-11,9686
2388,威盛,39,8,31,富邦-宜蘭,2024-11-11,9686
00724B,群益投資級金融債,31,0,31,富邦-宜蘭,2024-11-11,9686
3622,洋華,34,4,30,富邦-宜蘭,2024-11-11,9686
00740B,富邦全球投等債,30,0,30,富邦-宜蘭,2024-11-11,9686
00915,凱基優選高股息30,30,1,29,富邦-宜蘭,2024-11-11,9686
3673,TPK-KY,29,0,29,富邦-宜蘭,2024-11-11,9686
00932,兆豐永續高息等權,25,0,25,富邦-宜蘭,2024-11-11,9686
8155,博智,25,0,25,富邦-宜蘭,2024-11-11,9686
1605,華新,24,0,24,富邦-宜蘭,2024-11-11,9686
5014,建錩,23,0,23,富邦-宜蘭,2024-11-11,9686
2646,星宇航空,28,6,22,富邦-宜蘭,2024-11-11,9686
3481,群創,22,0,22,富邦-宜蘭,2024-11-11,9686
2610,華航,30,9,21,富邦-宜蘭,2024-11-11,9686
6789,采鈺,20,0,20,富邦-宜蘭,2024-11-11,9686
5907,大洋-KY,20,0,20,富邦-宜蘭,2024-11-11,9686
00953B,群益優選非投等債,20,0,20,富邦-宜蘭,2024-11-11,9686
5457,宣德,25,5,20,富邦-宜蘭,2024-11-11,9686
8096,擎亞,26,6,20,富邦-宜蘭,2024-11-11,9686
3037,欣興,21,2,19,富邦-宜蘭,2024-11-11,9686
00637L,元大滬深300正2,33,14,19,富邦-宜蘭,2024-11-11,9686
6770,力積電,19,0,19,富邦-宜蘭,2024-11-11,9686
8240,華宏,36,17,19,富邦-宜蘭,2024-11-11,9686
2409,友達,28,10,18,富邦-宜蘭,2024-11-11,9686
1301,台塑,23,4,19,富邦-宜蘭,2024-11-11,9686
6269,台郡,18,0,18,富邦-宜蘭,2024-11-11,9686
3312,弘憶股,26,9,17,富邦-宜蘭,2024-11-11,9686
2615,萬海,24,8,16,富邦-宜蘭,2024-11-11,9686
00632R,元大台灣50反1,365,94,271,富邦-宜蘭,2024-11-12,9686
00878,國泰永續高股息,381,112,269,富邦-宜蘭,2024-11-12,9686
2882,國泰金,154,1,153,富邦-宜蘭,2024-11-12,9686
2356,英業達,137,37,100,富邦-宜蘭,2024-11-12,9686
2609,陽明,142,43,99,富邦-宜蘭,2024-11-12,9686
00687B,國泰20年美債,110,21,89,富邦-宜蘭,2024-11-12,9686
2641,正德,105,24,81,富邦-宜蘭,2024-11-12,9686
2354,鴻準,251,172,79,富邦-宜蘭,2024-11-12,9686
00753L,中信中國50正2,99,22,77,富邦-宜蘭,2024-11-12,9686
3481,群創,160,91,69,富邦-宜蘭,2024-11-12,9686
00715L,期街口布蘭特正2,64,0,64,富邦-宜蘭,2024-11-12,9686
4931,新盛力,92,32,60,富邦-宜蘭,2024-11-12,9686
2323,中環,54,0,54,富邦-宜蘭,2024-11-12,9686
0056,元大高股息,102,50,52,富邦-宜蘭,2024-11-12,9686
00932,兆豐永續高息等權,48,0,48,富邦-宜蘭,2024-11-12,9686
00918,大華優利高填息30,46,1,45,富邦-宜蘭,2024-11-12,9686
00946,群益科技高息成長,44,0,44,富邦-宜蘭,2024-11-12,9686
2328,廣宇,56,14,42,富邦-宜蘭,2024-11-12,9686
2884,玉山金,43,2,41,富邦-宜蘭,2024-11-12,9686
5871,中租-KY,39,0,39,富邦-宜蘭,2024-11-12,9686
2312,金寶,42,4,38,富邦-宜蘭,2024-11-12,9686
1711,永光,38,1,37,富邦-宜蘭,2024-11-12,9686
1712,興農,35,0,35,富邦-宜蘭,2024-11-12,9686
00943,兆豐電子高息等權,35,0,35,富邦-宜蘭,2024-11-12,9686
00929,復華台灣科技優息,119,87,32,富邦-宜蘭,2024-11-12,9686
1524,耿鼎,83,51,32,富邦-宜蘭,2024-11-12,9686
2515,中工,31,0,31,富邦-宜蘭,2024-11-12,9686
9105,泰金寶-DR,41,10,31,富邦-宜蘭,2024-11-12,9686
1326,台化,32,2,30,富邦-宜蘭,2024-11-12,9686
00650L,復華香港正2,32,2,30,富邦-宜蘭,2024-11-12,9686
00915,凱基優選高股息30,27,0,27,富邦-宜蘭,2024-11-12,9686
2615,萬海,56,31,25,富邦-宜蘭,2024-11-12,9686
00922,國泰台灣領袖50,25,0,25,富邦-宜蘭,2024-11-12,9686
2353,宏��,44,19,25,富邦-宜蘭,2024-11-12,9686
3149,正達,25,2,23,富邦-宜蘭,2024-11-12,9686
6257,矽格,23,0,23,富邦-宜蘭,2024-11-12,9686
2330,台積電,27,5,22,富邦-宜蘭,2024-11-12,9686
3036,文曄,26,4,22,富邦-宜蘭,2024-11-12,9686
2409,友達,27,6,21,富邦-宜蘭,2024-11-12,9686
3673,TPK-KY,21,0,21,富邦-宜蘭,2024-11-12,9686
6763,綠界科技*,25,5,20,富邦-宜蘭,2024-11-12,9686
2367,燿華,20,0,20,富邦-宜蘭,2024-11-12,9686
1451,年興,20,0,20,富邦-宜蘭,2024-11-12,9686
00665L,富邦�琤肭磪囓�2,29,10,19,富邦-宜蘭,2024-11-12,9686
5243,乙盛-KY,39,20,19,富邦-宜蘭,2024-11-12,9686
6505,台塑化,18,0,18,富邦-宜蘭,2024-11-12,9686
2892,第一金,29,11,18,富邦-宜蘭,2024-11-12,9686
00905,FT臺灣Smart,18,0,18,富邦-宜蘭,2024-11-12,9686
006208,富邦台50,22,6,16,富邦-宜蘭,2024-11-12,9686
2344,華邦電,26,10,16,富邦-宜蘭,2024-11-12,9686
00650L,復華香港正2,134,2,132,富邦-宜蘭,2024-11-13,9686
00878,國泰永續高股息,193,76,117,富邦-宜蘭,2024-11-13,9686
00932,兆豐永續高息等權,116,0,116,富邦-宜蘭,2024-11-13,9686
2641,正德,124,11,113,富邦-宜蘭,2024-11-13,9686
9105,泰金寶-DR,124,37,87,富邦-宜蘭,2024-11-13,9686
2834,臺企銀,57,3,54,富邦-宜蘭,2024-11-13,9686
3481,群創,72,20,52,富邦-宜蘭,2024-11-13,9686
00753L,中信中國50正2,62,11,51,富邦-宜蘭,2024-11-13,9686
2882,國泰金,53,12,41,富邦-宜蘭,2024-11-13,9686
0056,元大高股息,39,6,33,富邦-宜蘭,2024-11-13,9686
00937B,群益ESG投等債20,45,13,32,富邦-宜蘭,2024-11-13,9686
00688L,國泰20年美債正2,33,2,31,富邦-宜蘭,2024-11-13,9686
8155,博智,30,0,30,富邦-宜蘭,2024-11-13,9686
00895,富邦未來車,30,1,29,富邦-宜蘭,2024-11-13,9686
2356,英業達,94,65,29,富邦-宜蘭,2024-11-13,9686
8070,長華*,28,1,27,富邦-宜蘭,2024-11-13,9686
2330,台積電,30,4,26,富邦-宜蘭,2024-11-13,9686
2881,富邦金,26,1,25,富邦-宜蘭,2024-11-13,9686
2609,陽明,39,15,24,富邦-宜蘭,2024-11-13,9686
2409,友達,24,0,24,富邦-宜蘭,2024-11-13,9686
00679B,元大美債20年,28,4,24,富邦-宜蘭,2024-11-13,9686
4931,新盛力,81,58,23,富邦-宜蘭,2024-11-13,9686
6163,華電網,34,11,23,富邦-宜蘭,2024-11-13,9686
00713,元大台灣高息低波,22,0,22,富邦-宜蘭,2024-11-13,9686
1301,台塑,20,0,20,富邦-宜蘭,2024-11-13,9686
5426,振發,31,11,20,富邦-宜蘭,2024-11-13,9686
00706L,期元大S＆P日圓正2,23,3,20,富邦-宜蘭,2024-11-13,9686
2027,大成鋼,21,1,20,富邦-宜蘭,2024-11-13,9686
3694,海華,20,2,18,富邦-宜蘭,2024-11-13,9686
3607,谷崧,18,0,18,富邦-宜蘭,2024-11-13,9686
3050,鈺德,18,0,18,富邦-宜蘭,2024-11-13,9686
00712,復華富時不動產,43,25,18,富邦-宜蘭,2024-11-13,9686
2317,鴻海,27,9,18,富邦-宜蘭,2024-11-13,9686
2883,凱基金,17,0,17,富邦-宜蘭,2024-11-13,9686
2449,京元電子,23,6,17,富邦-宜蘭,2024-11-13,9686
00725B,國泰投資級公司債,16,0,16,富邦-宜蘭,2024-11-13,9686
2892,第一金,16,0,16,富邦-宜蘭,2024-11-13,9686
2634,漢翔,16,0,16,富邦-宜蘭,2024-11-13,9686
00665L,富邦�琤肭磪囓�2,30,14,16,富邦-宜蘭,2024-11-13,9686
00795B,中信美國公債20年,20,5,15,富邦-宜蘭,2024-11-13,9686
2615,萬海,20,5,15,富邦-宜蘭,2024-11-13,9686
7703,銳澤,15,0,15,富邦-宜蘭,2024-11-13,9686
6147,頎邦,15,0,15,富邦-宜蘭,2024-11-13,9686
3037,欣興,32,17,15,富邦-宜蘭,2024-11-13,9686
00915,凱基優選高股息30,14,0,14,富邦-宜蘭,2024-11-13,9686
2408,南亞科,19,5,14,富邦-宜蘭,2024-11-13,9686
4906,正文,14,0,14,富邦-宜蘭,2024-11-13,9686
1308,亞聚,14,0,14,富邦-宜蘭,2024-11-13,9686
00905,FT臺灣Smart,14,0,14,富邦-宜蘭,2024-11-13,9686
6605,帝寶,14,0,14,富邦-宜蘭,2024-11-13,9686
00878,國泰永續高股息,460,10,450,富邦-宜蘭,2024-11-14,9686
00688L,國泰20年美債正2,139,0,139,富邦-宜蘭,2024-11-14,9686
00909,國泰數位支付服務,127,0,127,富邦-宜蘭,2024-11-14,9686
00932,兆豐永續高息等權,127,0,127,富邦-宜蘭,2024-11-14,9686
00650L,復華香港正2,126,9,117,富邦-宜蘭,2024-11-14,9686
00929,復華台灣科技優息,125,29,96,富邦-宜蘭,2024-11-14,9686
3481,群創,88,0,88,富邦-宜蘭,2024-11-14,9686
2641,正德,94,9,85,富邦-宜蘭,2024-11-14,9686
4306,炎洲,80,0,80,富邦-宜蘭,2024-11-14,9686
00937B,群益ESG投等債20,86,11,75,富邦-宜蘭,2024-11-14,9686
00918,大華優利高填息30,75,1,74,富邦-宜蘭,2024-11-14,9686
2888,新光金,83,16,67,富邦-宜蘭,2024-11-14,9686
1531,高林股,60,0,60,富邦-宜蘭,2024-11-14,9686
00946,群益科技高息成長,56,0,56,富邦-宜蘭,2024-11-14,9686
1611,中電,54,1,53,富邦-宜蘭,2024-11-14,9686
2312,金寶,62,10,52,富邦-宜蘭,2024-11-14,9686
3024,憶聲,53,2,51,富邦-宜蘭,2024-11-14,9686
00919,群益台灣精選高息,90,40,50,富邦-宜蘭,2024-11-14,9686
0056,元大高股息,49,3,46,富邦-宜蘭,2024-11-14,9686
1301,台塑,45,0,45,富邦-宜蘭,2024-11-14,9686
2303,聯電,58,13,45,富邦-宜蘭,2024-11-14,9686
2344,華邦電,47,3,44,富邦-宜蘭,2024-11-14,9686
2887,台新金,40,0,40,富邦-宜蘭,2024-11-14,9686
00915,凱基優選高股息30,39,0,39,富邦-宜蘭,2024-11-14,9686
4931,新盛力,143,111,32,富邦-宜蘭,2024-11-14,9686
2017,官田鋼,31,0,31,富邦-宜蘭,2024-11-14,9686
2392,正崴,54,24,30,富邦-宜蘭,2024-11-14,9686
5871,中租-KY,34,4,30,富邦-宜蘭,2024-11-14,9686
4414,如興,30,0,30,富邦-宜蘭,2024-11-14,9686
2897,王道銀行,29,0,29,富邦-宜蘭,2024-11-14,9686
00943,兆豐電子高息等權,28,0,28,富邦-宜蘭,2024-11-14,9686
2409,友達,37,11,26,富邦-宜蘭,2024-11-14,9686
1711,永光,36,11,25,富邦-宜蘭,2024-11-14,9686
8011,台通,29,5,24,富邦-宜蘭,2024-11-14,9686
8261,富鼎,29,6,23,富邦-宜蘭,2024-11-14,9686
1605,華新,22,0,22,富邦-宜蘭,2024-11-14,9686
3048,益登,22,1,21,富邦-宜蘭,2024-11-14,9686
6156,松上,25,4,21,富邦-宜蘭,2024-11-14,9686
00905,FT臺灣Smart,21,0,21,富邦-宜蘭,2024-11-14,9686
2337,旺宏,21,1,20,富邦-宜蘭,2024-11-14,9686
6176,瑞儀,20,0,20,富邦-宜蘭,2024-11-14,9686
6196,帆宣,20,0,20,富邦-宜蘭,2024-11-14,9686
5880,合庫金,19,0,19,富邦-宜蘭,2024-11-14,9686
2101,南港,24,5,19,富邦-宜蘭,2024-11-14,9686
2609,陽明,35,16,19,富邦-宜蘭,2024-11-14,9686
00927,群益半導體收益,28,10,18,富邦-宜蘭,2024-11-14,9686
00850,元大臺灣ESG永續,18,0,18,富邦-宜蘭,2024-11-14,9686
2330,台積電,24,7,17,富邦-宜蘭,2024-11-14,9686
2027,大成鋼,17,0,17,富邦-宜蘭,2024-11-14,9686
2449,京元電子,22,6,16,富邦-宜蘭,2024-11-14,9686
00878,國泰永續高股息,466,28,438,富邦-宜蘭,2024-11-15,9686
2888,新光金,90,4,86,富邦-宜蘭,2024-11-15,9686
2382,廣達,62,6,56,富邦-宜蘭,2024-11-15,9686
00637L,元大滬深300正2,48,0,48,富邦-宜蘭,2024-11-15,9686
00887,永豐中國科技50大,46,1,45,富邦-宜蘭,2024-11-15,9686
2641,正德,80,35,45,富邦-宜蘭,2024-11-15,9686
00937B,群益ESG投等債20,40,0,40,富邦-宜蘭,2024-11-15,9686
1522,堤維西,35,4,31,富邦-宜蘭,2024-11-15,9686
6151,晉倫,31,4,27,富邦-宜蘭,2024-11-15,9686
3450,聯鈞,76,51,25,富邦-宜蘭,2024-11-15,9686
00918,大華優利高填息30,24,0,24,富邦-宜蘭,2024-11-15,9686
2356,英業達,24,0,24,富邦-宜蘭,2024-11-15,9686
0056,元大高股息,24,0,24,富邦-宜蘭,2024-11-15,9686
3013,晟銘電,92,69,23,富邦-宜蘭,2024-11-15,9686
00905,FT臺灣Smart,20,0,20,富邦-宜蘭,2024-11-15,9686
2002,中鋼,20,0,20,富邦-宜蘭,2024-11-15,9686
1301,台塑,25,6,19,富邦-宜蘭,2024-11-15,9686
6505,台塑化,30,12,18,富邦-宜蘭,2024-11-15,9686
00715L,期街口布蘭特正2,30,12,18,富邦-宜蘭,2024-11-15,9686
2324,仁寶,32,14,18,富邦-宜蘭,2024-11-15,9686
00915,凱基優選高股息30,16,0,16,富邦-宜蘭,2024-11-15,9686
2495,普安,24,8,16,富邦-宜蘭,2024-11-15,9686
2365,昆盈,16,0,16,富邦-宜蘭,2024-11-15,9686
6405,悅城,16,0,16,富邦-宜蘭,2024-11-15,9686
00932,兆豐永續高息等權,15,0,15,富邦-宜蘭,2024-11-15,9686
2344,華邦電,15,0,15,富邦-宜蘭,2024-11-15,9686
00922,國泰台灣領袖50,14,0,14,富邦-宜蘭,2024-11-15,9686
3706,神達,240,226,14,富邦-宜蘭,2024-11-15,9686
2399,映泰,17,4,13,富邦-宜蘭,2024-11-15,9686
4414,如興,13,0,13,富邦-宜蘭,2024-11-15,9686
1605,華新,14,2,12,富邦-宜蘭,2024-11-15,9686
1815,富喬,14,2,12,富邦-宜蘭,2024-11-15,9686
8064,東捷,14,2,12,富邦-宜蘭,2024-11-15,9686
2467,志聖,15,3,12,富邦-宜蘭,2024-11-15,9686
00900,富邦特選高股息30,12,0,12,富邦-宜蘭,2024-11-15,9686
00919,群益台灣精選高息,30,18,12,富邦-宜蘭,2024-11-15,9686
1307,三芳,13,2,11,富邦-宜蘭,2024-11-15,9686
1449,佳和,12,1,11,富邦-宜蘭,2024-11-15,9686
4933,友輝,10,0,10,富邦-宜蘭,2024-11-15,9686
6109,亞元,10,0,10,富邦-宜蘭,2024-11-15,9686
2605,新興,16,6,10,富邦-宜蘭,2024-11-15,9686
00898,國泰基因免疫革命,10,0,10,富邦-宜蘭,2024-11-15,9686
2543,皇昌,10,1,9,富邦-宜蘭,2024-11-15,9686
2352,佳世達,9,0,9,富邦-宜蘭,2024-11-15,9686
2308,台達電,9,0,9,富邦-宜蘭,2024-11-15,9686
00713,元大台灣高息低波,8,0,8,富邦-宜蘭,2024-11-15,9686
6605,帝寶,8,0,8,富邦-宜蘭,2024-11-15,9686
8043,蜜望實,8,0,8,富邦-宜蘭,2024-11-15,9686
1314,中石化,8,0,8,富邦-宜蘭,2024-11-15,9686
2897,王道銀行,8,0,8,富邦-宜蘭,2024-11-15,9686
00632R,元大台灣50反1,503,202,301,富邦-宜蘭,2024-11-18,9686
00878,國泰永續高股息,307,28,279,富邦-宜蘭,2024-11-18,9686
00937B,群益ESG投等債20,222,19,203,富邦-宜蘭,2024-11-18,9686
00929,復華台灣科技優息,207,65,142,富邦-宜蘭,2024-11-18,9686
2312,金寶,234,109,125,富邦-宜蘭,2024-11-18,9686
2354,鴻準,212,101,111,富邦-宜蘭,2024-11-18,9686
00943,兆豐電子高息等權,97,1,96,富邦-宜蘭,2024-11-18,9686
00933B,國泰10Y+金融債,106,10,96,富邦-宜蘭,2024-11-18,9686
00909,國泰數位支付服務,94,0,94,富邦-宜蘭,2024-11-18,9686
2317,鴻海,92,18,74,富邦-宜蘭,2024-11-18,9686
0056,元大高股息,63,0,63,富邦-宜蘭,2024-11-18,9686
00676R,富邦臺灣加權反1,100,50,50,富邦-宜蘭,2024-11-18,9686
00919,群益台灣精選高息,67,18,49,富邦-宜蘭,2024-11-18,9686
1785,光洋科,43,3,40,富邦-宜蘭,2024-11-18,9686
2881,富邦金,43,3,40,富邦-宜蘭,2024-11-18,9686
3231,緯創,44,5,39,富邦-宜蘭,2024-11-18,9686
3005,神基,36,0,36,富邦-宜蘭,2024-11-18,9686
2603,長榮,40,8,32,富邦-宜蘭,2024-11-18,9686
2883,凱基金,34,3,31,富邦-宜蘭,2024-11-18,9686
1314,中石化,31,0,31,富邦-宜蘭,2024-11-18,9686
2027,大成鋼,37,7,30,富邦-宜蘭,2024-11-18,9686
8070,長華*,26,0,26,富邦-宜蘭,2024-11-18,9686
00918,大華優利高填息30,28,2,26,富邦-宜蘭,2024-11-18,9686
2495,普安,29,4,25,富邦-宜蘭,2024-11-18,9686
6753,龍德造船,27,3,24,富邦-宜蘭,2024-11-18,9686
00892,富邦台灣半導體,22,0,22,富邦-宜蘭,2024-11-18,9686
4736,泰博,22,0,22,富邦-宜蘭,2024-11-18,9686
2882,國泰金,23,1,22,富邦-宜蘭,2024-11-18,9686
00687B,國泰20年美債,21,0,21,富邦-宜蘭,2024-11-18,9686
006208,富邦台50,21,2,19,富邦-宜蘭,2024-11-18,9686
00715L,期街口布蘭特正2,18,0,18,富邦-宜蘭,2024-11-18,9686
2344,華邦電,25,7,18,富邦-宜蘭,2024-11-18,9686
2330,台積電,19,3,16,富邦-宜蘭,2024-11-18,9686
2609,陽明,48,33,15,富邦-宜蘭,2024-11-18,9686
4306,炎洲,15,0,15,富邦-宜蘭,2024-11-18,9686
00905,FT臺灣Smart,15,0,15,富邦-宜蘭,2024-11-18,9686
3450,聯鈞,24,10,14,富邦-宜蘭,2024-11-18,9686
2646,星宇航空,16,2,14,富邦-宜蘭,2024-11-18,9686
912000,晨訊科-DR,14,0,14,富邦-宜蘭,2024-11-18,9686
2515,中工,15,1,14,富邦-宜蘭,2024-11-18,9686
2880,華南金,15,1,14,富邦-宜蘭,2024-11-18,9686
00885,富邦越南,13,0,13,富邦-宜蘭,2024-11-18,9686
2356,英業達,37,24,13,富邦-宜蘭,2024-11-18,9686
00932,兆豐永續高息等權,13,0,13,富邦-宜蘭,2024-11-18,9686
1471,首利,15,2,13,富邦-宜蘭,2024-11-18,9686
5321,美而快,13,0,13,富邦-宜蘭,2024-11-18,9686
00795B,中信美國公債20年,12,0,12,富邦-宜蘭,2024-11-18,9686
2371,大同,12,0,12,富邦-宜蘭,2024-11-18,9686
2891,中信金,13,1,12,富邦-宜蘭,2024-11-18,9686
6196,帆宣,11,0,11,富邦-宜蘭,2024-11-18,9686
00637L,元大滬深300正2,137,0,137,富邦-宜蘭,2024-11-19,9686
2888,新光金,122,1,121,富邦-宜蘭,2024-11-19,9686
00937B,群益ESG投等債20,87,0,87,富邦-宜蘭,2024-11-19,9686
00878,國泰永續高股息,103,37,66,富邦-宜蘭,2024-11-19,9686
3481,群創,68,14,54,富邦-宜蘭,2024-11-19,9686
9105,泰金寶-DR,192,143,49,富邦-宜蘭,2024-11-19,9686
2317,鴻海,55,11,44,富邦-宜蘭,2024-11-19,9686
1711,永光,38,1,37,富邦-宜蘭,2024-11-19,9686
2605,新興,36,3,33,富邦-宜蘭,2024-11-19,9686
2543,皇昌,37,4,33,富邦-宜蘭,2024-11-19,9686
2349,錸德,64,34,30,富邦-宜蘭,2024-11-19,9686
1471,首利,31,3,28,富邦-宜蘭,2024-11-19,9686
00946,群益科技高息成長,31,4,27,富邦-宜蘭,2024-11-19,9686
00930,永豐ESG低碳高息,27,0,27,富邦-宜蘭,2024-11-19,9686
2020,美亞,26,0,26,富邦-宜蘭,2024-11-19,9686
00919,群益台灣精選高息,27,1,26,富邦-宜蘭,2024-11-19,9686
2409,友達,25,1,24,富邦-宜蘭,2024-11-19,9686
3711,日月光投控,25,3,22,富邦-宜蘭,2024-11-19,9686
00713,元大台灣高息低波,22,0,22,富邦-宜蘭,2024-11-19,9686
00887,永豐中國科技50大,30,10,20,富邦-宜蘭,2024-11-19,9686
2399,映泰,68,48,20,富邦-宜蘭,2024-11-19,9686
2542,興富發,27,8,19,富邦-宜蘭,2024-11-19,9686
2382,廣達,21,4,17,富邦-宜蘭,2024-11-19,9686
1452,宏益,48,32,16,富邦-宜蘭,2024-11-19,9686
1537,廣隆,16,0,16,富邦-宜蘭,2024-11-19,9686
2887,台新金,22,7,15,富邦-宜蘭,2024-11-19,9686
2344,華邦電,17,3,14,富邦-宜蘭,2024-11-19,9686
2347,聯強,21,7,14,富邦-宜蘭,2024-11-19,9686
2329,華泰,26,12,14,富邦-宜蘭,2024-11-19,9686
8089,康全電訊,14,0,14,富邦-宜蘭,2024-11-19,9686
8104,錸寶,26,14,12,富邦-宜蘭,2024-11-19,9686
1815,富喬,16,4,12,富邦-宜蘭,2024-11-19,9686
8249,菱光,13,1,12,富邦-宜蘭,2024-11-19,9686
5309,系統電,42,30,12,富邦-宜蘭,2024-11-19,9686
00665L,富邦�琤肭磪囓�2,19,7,12,富邦-宜蘭,2024-11-19,9686
6271,同欣電,12,0,12,富邦-宜蘭,2024-11-19,9686
1449,佳和,17,6,11,富邦-宜蘭,2024-11-19,9686
2634,漢翔,15,4,11,富邦-宜蘭,2024-11-19,9686
2406,國碩,10,0,10,富邦-宜蘭,2024-11-19,9686
4916,事欣科,11,1,10,富邦-宜蘭,2024-11-19,9686
3689,湧德,11,1,10,富邦-宜蘭,2024-11-19,9686
00896,中信綠能及電動車,10,0,10,富邦-宜蘭,2024-11-19,9686
2355,敬鵬,10,0,10,富邦-宜蘭,2024-11-19,9686
1568,倉佑,10,0,10,富邦-宜蘭,2024-11-19,9686
6244,茂迪,10,0,10,富邦-宜蘭,2024-11-19,9686
00877,復華中國5G,10,0,10,富邦-宜蘭,2024-11-19,9686
1611,中電,10,0,10,富邦-宜蘭,2024-11-19,9686
4906,正文,10,0,10,富邦-宜蘭,2024-11-19,9686
3049,精金,10,1,9,富邦-宜蘭,2024-11-19,9686
2883,凱基金,9,0,9,富邦-宜蘭,2024-11-19,9686
2354,鴻準,274,71,203,富邦-宜蘭,2024-11-20,9686
2431,聯昌,201,30,171,富邦-宜蘭,2024-11-20,9686
00937B,群益ESG投等債20,172,7,165,富邦-宜蘭,2024-11-20,9686
00929,復華台灣科技優息,88,19,69,富邦-宜蘭,2024-11-20,9686
00930,永豐ESG低碳高息,68,0,68,富邦-宜蘭,2024-11-20,9686
2303,聯電,62,5,57,富邦-宜蘭,2024-11-20,9686
00946,群益科技高息成長,62,7,55,富邦-宜蘭,2024-11-20,9686
00753L,中信中國50正2,70,18,52,富邦-宜蘭,2024-11-20,9686
2906,高林,45,0,45,富邦-宜蘭,2024-11-20,9686
3706,神達,247,203,44,富邦-宜蘭,2024-11-20,9686
2834,臺企銀,41,0,41,富邦-宜蘭,2024-11-20,9686
1711,永光,40,1,39,富邦-宜蘭,2024-11-20,9686
2881,富邦金,43,5,38,富邦-宜蘭,2024-11-20,9686
00952,凱基台灣AI50,36,0,36,富邦-宜蘭,2024-11-20,9686
3481,群創,54,23,31,富邦-宜蘭,2024-11-20,9686
00948B,中信優息投資級債,30,0,30,富邦-宜蘭,2024-11-20,9686
9105,泰金寶-DR,98,69,29,富邦-宜蘭,2024-11-20,9686
5864,致和證,25,0,25,富邦-宜蘭,2024-11-20,9686
00919,群益台灣精選高息,26,1,25,富邦-宜蘭,2024-11-20,9686
3447,展達,31,7,24,富邦-宜蘭,2024-11-20,9686
3455,由田,24,0,24,富邦-宜蘭,2024-11-20,9686
1326,台化,23,0,23,富邦-宜蘭,2024-11-20,9686
2328,廣宇,34,11,23,富邦-宜蘭,2024-11-20,9686
6257,矽格,22,0,22,富邦-宜蘭,2024-11-20,9686
2618,長榮航,49,27,22,富邦-宜蘭,2024-11-20,9686
3167,大量,48,27,21,富邦-宜蘭,2024-11-20,9686
2603,長榮,119,98,21,富邦-宜蘭,2024-11-20,9686
2330,台積電,25,4,21,富邦-宜蘭,2024-11-20,9686
00936,台新永續高息中小,20,0,20,富邦-宜蘭,2024-11-20,9686
9907,統一實,20,0,20,富邦-宜蘭,2024-11-20,9686
6283,淳安,20,0,20,富邦-宜蘭,2024-11-20,9686
2449,京元電子,19,3,16,富邦-宜蘭,2024-11-20,9686
3628,盈正,16,0,16,富邦-宜蘭,2024-11-20,9686
2409,友達,15,0,15,富邦-宜蘭,2024-11-20,9686
2356,英業達,45,30,15,富邦-宜蘭,2024-11-20,9686
3050,鈺德,28,13,15,富邦-宜蘭,2024-11-20,9686
8011,台通,15,0,15,富邦-宜蘭,2024-11-20,9686
3450,聯鈞,40,26,14,富邦-宜蘭,2024-11-20,9686
2301,光寶科,15,1,14,富邦-宜蘭,2024-11-20,9686
3209,全科,16,2,14,富邦-宜蘭,2024-11-20,9686
3323,加百裕,26,12,14,富邦-宜蘭,2024-11-20,9686
9945,潤泰新,24,11,13,富邦-宜蘭,2024-11-20,9686
2754,亞洲藏壽司,13,0,13,富邦-宜蘭,2024-11-20,9686
3511,矽瑪,62,49,13,富邦-宜蘭,2024-11-20,9686
6416,瑞祺電通,13,0,13,富邦-宜蘭,2024-11-20,9686
0056,元大高股息,19,6,13,富邦-宜蘭,2024-11-20,9686
2353,宏��,14,1,13,富邦-宜蘭,2024-11-20,9686
6770,力積電,18,6,12,富邦-宜蘭,2024-11-20,9686
6182,合晶,14,2,12,富邦-宜蘭,2024-11-20,9686
3231,緯創,19,7,12,富邦-宜蘭,2024-11-20,9686
9945,潤泰新,172,5,167,富邦-宜蘭,2024-11-21,9686
00878,國泰永續高股息,127,40,87,富邦-宜蘭,2024-11-21,9686
6674,鋐寶科技,62,0,62,富邦-宜蘭,2024-11-21,9686
00909,國泰數位支付服務,52,3,49,富邦-宜蘭,2024-11-21,9686
0056,元大高股息,48,2,46,富邦-宜蘭,2024-11-21,9686
9105,泰金寶-DR,167,125,42,富邦-宜蘭,2024-11-21,9686
2349,錸德,113,73,40,富邦-宜蘭,2024-11-21,9686
3625,西勝,42,6,36,富邦-宜蘭,2024-11-21,9686
8038,長園科,34,0,34,富邦-宜蘭,2024-11-21,9686
00679B,元大美債20年,37,4,33,富邦-宜蘭,2024-11-21,9686
2303,聯電,44,13,31,富邦-宜蘭,2024-11-21,9686
2204,中華,50,19,31,富邦-宜蘭,2024-11-21,9686
00637L,元大滬深300正2,30,0,30,富邦-宜蘭,2024-11-21,9686
2344,華邦電,29,1,28,富邦-宜蘭,2024-11-21,9686
8088,品安,26,0,26,富邦-宜蘭,2024-11-21,9686
2317,鴻海,34,9,25,富邦-宜蘭,2024-11-21,9686
006208,富邦台50,25,0,25,富邦-宜蘭,2024-11-21,9686
2883,凱基金,25,0,25,富邦-宜蘭,2024-11-21,9686
2354,鴻準,116,92,24,富邦-宜蘭,2024-11-21,9686
2891,中信金,27,4,23,富邦-宜蘭,2024-11-21,9686
2027,大成鋼,22,0,22,富邦-宜蘭,2024-11-21,9686
1449,佳和,38,17,21,富邦-宜蘭,2024-11-21,9686
2882,國泰金,20,0,20,富邦-宜蘭,2024-11-21,9686
9907,統一實,20,0,20,富邦-宜蘭,2024-11-21,9686
00715L,期街口布蘭特正2,22,2,20,富邦-宜蘭,2024-11-21,9686
1720,生達,19,0,19,富邦-宜蘭,2024-11-21,9686
2353,宏��,20,1,19,富邦-宜蘭,2024-11-21,9686
00922,國泰台灣領袖50,18,0,18,富邦-宜蘭,2024-11-21,9686
2330,台積電,24,7,17,富邦-宜蘭,2024-11-21,9686
2881,富邦金,27,12,15,富邦-宜蘭,2024-11-21,9686
3264,欣銓,15,0,15,富邦-宜蘭,2024-11-21,9686
1301,台塑,14,0,14,富邦-宜蘭,2024-11-21,9686
2543,皇昌,15,1,14,富邦-宜蘭,2024-11-21,9686
2062,橋椿,19,5,14,富邦-宜蘭,2024-11-21,9686
00937B,群益ESG投等債20,13,0,13,富邦-宜蘭,2024-11-21,9686
2371,大同,23,11,12,富邦-宜蘭,2024-11-21,9686
00919,群益台灣精選高息,18,6,12,富邦-宜蘭,2024-11-21,9686
00915,凱基優選高股息30,12,0,12,富邦-宜蘭,2024-11-21,9686
8011,台通,12,0,12,富邦-宜蘭,2024-11-21,9686
9940,信義,12,0,12,富邦-宜蘭,2024-11-21,9686
0050,元大台灣50,19,8,11,富邦-宜蘭,2024-11-21,9686
2409,友達,11,0,11,富邦-宜蘭,2024-11-21,9686
1597,直得,13,2,11,富邦-宜蘭,2024-11-21,9686
2615,萬海,35,25,10,富邦-宜蘭,2024-11-21,9686
2884,玉山金,13,3,10,富邦-宜蘭,2024-11-21,9686
3059,華晶科,10,0,10,富邦-宜蘭,2024-11-21,9686
00665L,富邦�琤肭磪囓�2,10,0,10,富邦-宜蘭,2024-11-21,9686
2491,吉祥全,10,0,10,富邦-宜蘭,2024-11-21,9686
00751B,元大AAA至A公司債,10,1,9,富邦-宜蘭,2024-11-21,9686
3518,柏騰,8,0,8,富邦-宜蘭,2024-11-21,9686
00950B,凱基A級公司債,136,0,136,富邦-宜蘭,2024-11-22,9686
00665L,富邦�琤肭磪囓�2,216,100,116,富邦-宜蘭,2024-11-22,9686
9105,泰金寶-DR,305,237,68,富邦-宜蘭,2024-11-22,9686
00878,國泰永續高股息,62,5,57,富邦-宜蘭,2024-11-22,9686
00923,群益台ESG低碳50,55,0,55,富邦-宜蘭,2024-11-22,9686
00632R,元大台灣50反1,50,0,50,富邦-宜蘭,2024-11-22,9686
00958B,永豐ESG銀行債15,50,0,50,富邦-宜蘭,2024-11-22,9686
00753L,中信中國50正2,59,10,49,富邦-宜蘭,2024-11-22,9686
00830,國泰費城半導體,38,0,38,富邦-宜蘭,2024-11-22,9686
2609,陽明,137,100,37,富邦-宜蘭,2024-11-22,9686
6134,萬旭,31,2,29,富邦-宜蘭,2024-11-22,9686
6151,晉倫,33,4,29,富邦-宜蘭,2024-11-22,9686
00673R,期元大S＆P原油反1,26,0,26,富邦-宜蘭,2024-11-22,9686
00637L,元大滬深300正2,60,36,24,富邦-宜蘭,2024-11-22,9686
9945,潤泰新,45,21,24,富邦-宜蘭,2024-11-22,9686
4532,瑞智,21,0,21,富邦-宜蘭,2024-11-22,9686
00680L,元大美債20正2,20,0,20,富邦-宜蘭,2024-11-22,9686
3049,精金,51,32,19,富邦-宜蘭,2024-11-22,9686
2543,皇昌,18,1,17,富邦-宜蘭,2024-11-22,9686
6271,同欣電,17,0,17,富邦-宜蘭,2024-11-22,9686
1802,台玻,43,26,17,富邦-宜蘭,2024-11-22,9686
8358,金居,21,4,17,富邦-宜蘭,2024-11-22,9686
2867,三商壽,24,7,17,富邦-宜蘭,2024-11-22,9686
1537,廣隆,16,0,16,富邦-宜蘭,2024-11-22,9686
4956,光鋐,24,8,16,富邦-宜蘭,2024-11-22,9686
2317,鴻海,19,4,15,富邦-宜蘭,2024-11-22,9686
2641,正德,14,0,14,富邦-宜蘭,2024-11-22,9686
00919,群益台灣精選高息,30,16,14,富邦-宜蘭,2024-11-22,9686
3290,東浦,14,0,14,富邦-宜蘭,2024-11-22,9686
1452,宏益,73,60,13,富邦-宜蘭,2024-11-22,9686
2881,富邦金,19,7,12,富邦-宜蘭,2024-11-22,9686
8104,錸寶,18,6,12,富邦-宜蘭,2024-11-22,9686
00959B,大華投等美債15Y+,12,0,12,富邦-宜蘭,2024-11-22,9686
2204,中華,15,3,12,富邦-宜蘭,2024-11-22,9686
2349,錸德,20,8,12,富邦-宜蘭,2024-11-22,9686
2615,萬海,27,16,11,富邦-宜蘭,2024-11-22,9686
2027,大成鋼,21,10,11,富邦-宜蘭,2024-11-22,9686
1568,倉佑,10,0,10,富邦-宜蘭,2024-11-22,9686
00943,兆豐電子高息等權,10,0,10,富邦-宜蘭,2024-11-22,9686
2365,昆盈,25,15,10,富邦-宜蘭,2024-11-22,9686
2497,怡利電,10,0,10,富邦-宜蘭,2024-11-22,9686
2353,宏��,11,1,10,富邦-宜蘭,2024-11-22,9686
5880,合庫金,10,0,10,富邦-宜蘭,2024-11-22,9686
8163,達方,19,9,10,富邦-宜蘭,2024-11-22,9686
00960,野村全球航運龍頭,9,0,9,富邦-宜蘭,2024-11-22,9686
3036,文曄,10,1,9,富邦-宜蘭,2024-11-22,9686
2363,矽統,9,0,9,富邦-宜蘭,2024-11-22,9686
2356,英業達,27,18,9,富邦-宜蘭,2024-11-22,9686
2539,櫻花建,19,10,9,富邦-宜蘭,2024-11-22,9686
1101,台泥,11,2,9,富邦-宜蘭,2024-11-22,9686
2888,新光金,155,18,137,富邦-宜蘭,2024-11-25,9686
9105,泰金寶-DR,264,128,136,富邦-宜蘭,2024-11-25,9686
2618,長榮航,131,9,122,富邦-宜蘭,2024-11-25,9686
00953B,群益優選非投等債,111,8,103,富邦-宜蘭,2024-11-25,9686
00830,國泰費城半導體,75,0,75,富邦-宜蘭,2024-11-25,9686
00919,群益台灣精選高息,101,34,67,富邦-宜蘭,2024-11-25,9686
00687B,國泰20年美債,86,20,66,富邦-宜蘭,2024-11-25,9686
2883,凱基金,63,8,55,富邦-宜蘭,2024-11-25,9686
2371,大同,58,12,46,富邦-宜蘭,2024-11-25,9686
1101,台泥,80,34,46,富邦-宜蘭,2024-11-25,9686
2449,京元電子,39,3,36,富邦-宜蘭,2024-11-25,9686
00887,永豐中國科技50大,40,11,29,富邦-宜蘭,2024-11-25,9686
00753L,中信中國50正2,29,0,29,富邦-宜蘭,2024-11-25,9686
00633L,富邦上証正2,25,0,25,富邦-宜蘭,2024-11-25,9686
4931,新盛力,25,3,22,富邦-宜蘭,2024-11-25,9686
2027,大成鋼,28,7,21,富邦-宜蘭,2024-11-25,9686
2867,三商壽,27,7,20,富邦-宜蘭,2024-11-25,9686
2641,正德,25,6,19,富邦-宜蘭,2024-11-25,9686
00637L,元大滬深300正2,128,110,18,富邦-宜蘭,2024-11-25,9686
5465,富驊,25,7,18,富邦-宜蘭,2024-11-25,9686
2258,鴻華先進-創,16,0,16,富邦-宜蘭,2024-11-25,9686
3004,豐達科,16,0,16,富邦-宜蘭,2024-11-25,9686
2609,陽明,46,30,16,富邦-宜蘭,2024-11-25,9686
2399,映泰,34,19,15,富邦-宜蘭,2024-11-25,9686
00934,中信成長高股息,15,1,14,富邦-宜蘭,2024-11-25,9686
1611,中電,15,1,14,富邦-宜蘭,2024-11-25,9686
2409,友達,15,1,14,富邦-宜蘭,2024-11-25,9686
2834,臺企銀,14,1,13,富邦-宜蘭,2024-11-25,9686
2887,台新金,13,0,13,富邦-宜蘭,2024-11-25,9686
3152,璟德,12,0,12,富邦-宜蘭,2024-11-25,9686
2331,精英,12,0,12,富邦-宜蘭,2024-11-25,9686
6284,佳邦,12,0,12,富邦-宜蘭,2024-11-25,9686
1301,台塑,11,0,11,富邦-宜蘭,2024-11-25,9686
2634,漢翔,13,2,11,富邦-宜蘭,2024-11-25,9686
3290,東浦,10,0,10,富邦-宜蘭,2024-11-25,9686
911868,同方友友-DR,10,0,10,富邦-宜蘭,2024-11-25,9686
1466,聚隆,10,0,10,富邦-宜蘭,2024-11-25,9686
6546,正基,17,8,9,富邦-宜蘭,2024-11-25,9686
2431,聯昌,21,12,9,富邦-宜蘭,2024-11-25,9686
3149,正達,16,7,9,富邦-宜蘭,2024-11-25,9686
3354,律勝,9,0,9,富邦-宜蘭,2024-11-25,9686
3047,訊舟,8,0,8,富邦-宜蘭,2024-11-25,9686
6697,東捷資訊,8,0,8,富邦-宜蘭,2024-11-25,9686
4526,東台,10,2,8,富邦-宜蘭,2024-11-25,9686
4956,光鋐,34,26,8,富邦-宜蘭,2024-11-25,9686
2349,錸德,27,20,7,富邦-宜蘭,2024-11-25,9686
912000,晨訊科-DR,7,0,7,富邦-宜蘭,2024-11-25,9686
8043,蜜望實,7,0,7,富邦-宜蘭,2024-11-25,9686
00927,群益半導體收益,8,1,7,富邦-宜蘭,2024-11-25,9686
6706,惠特,7,0,7,富邦-宜蘭,2024-11-25,9686
00632R,元大台灣50反1,1239,1,1238,富邦-宜蘭,2024-11-26,9686
2349,錸德,157,31,126,富邦-宜蘭,2024-11-26,9686
2317,鴻海,128,7,121,富邦-宜蘭,2024-11-26,9686
00687B,國泰20年美債,100,18,82,富邦-宜蘭,2024-11-26,9686
1540,喬福,89,14,75,富邦-宜蘭,2024-11-26,9686
00878,國泰永續高股息,136,63,73,富邦-宜蘭,2024-11-26,9686
3419,譁裕,71,5,66,富邦-宜蘭,2024-11-26,9686
00918,大華優利高填息30,59,2,57,富邦-宜蘭,2024-11-26,9686
6962,ITH-KY,56,5,51,富邦-宜蘭,2024-11-26,9686
2630,亞航,50,1,49,富邦-宜蘭,2024-11-26,9686
0056,元大高股息,44,2,42,富邦-宜蘭,2024-11-26,9686
2834,臺企銀,40,0,40,富邦-宜蘭,2024-11-26,9686
2344,華邦電,37,0,37,富邦-宜蘭,2024-11-26,9686
2426,鼎元,51,16,35,富邦-宜蘭,2024-11-26,9686
2887,台新金,44,11,33,富邦-宜蘭,2024-11-26,9686
2610,華航,31,2,29,富邦-宜蘭,2024-11-26,9686
00943,兆豐電子高息等權,29,0,29,富邦-宜蘭,2024-11-26,9686
00715L,期街口布蘭特正2,48,21,27,富邦-宜蘭,2024-11-26,9686
2615,萬海,46,19,27,富邦-宜蘭,2024-11-26,9686
2371,大同,31,5,26,富邦-宜蘭,2024-11-26,9686
00951,台新日本半導體,23,0,23,富邦-宜蘭,2024-11-26,9686
4931,新盛力,30,7,23,富邦-宜蘭,2024-11-26,9686
3231,緯創,39,17,22,富邦-宜蘭,2024-11-26,9686
9105,泰金寶-DR,74,52,22,富邦-宜蘭,2024-11-26,9686
5876,上海商銀,23,1,22,富邦-宜蘭,2024-11-26,9686
1432,大魯閣,21,0,21,富邦-宜蘭,2024-11-26,9686
3622,洋華,23,2,21,富邦-宜蘭,2024-11-26,9686
00960,野村全球航運龍頭,20,0,20,富邦-宜蘭,2024-11-26,9686
3060,銘異,20,0,20,富邦-宜蘭,2024-11-26,9686
2501,國建,20,0,20,富邦-宜蘭,2024-11-26,9686
4109,加捷生醫,19,0,19,富邦-宜蘭,2024-11-26,9686
00965,元大航太防衛科技,57,40,17,富邦-宜蘭,2024-11-26,9686
00922,國泰台灣領袖50,17,0,17,富邦-宜蘭,2024-11-26,9686
1402,遠東新,16,0,16,富邦-宜蘭,2024-11-26,9686
2330,台積電,18,2,16,富邦-宜蘭,2024-11-26,9686
3363,上詮,47,32,15,富邦-宜蘭,2024-11-26,9686
6443,元晶,14,0,14,富邦-宜蘭,2024-11-26,9686
4960,誠美材,17,3,14,富邦-宜蘭,2024-11-26,9686
2495,普安,19,5,14,富邦-宜蘭,2024-11-26,9686
00891,中信關鍵半導體,14,0,14,富邦-宜蘭,2024-11-26,9686
006208,富邦台50,13,0,13,富邦-宜蘭,2024-11-26,9686
00713,元大台灣高息低波,12,0,12,富邦-宜蘭,2024-11-26,9686
00910,第一金太空衛星,12,0,12,富邦-宜蘭,2024-11-26,9686
2367,燿華,13,1,12,富邦-宜蘭,2024-11-26,9686
2603,長榮,76,65,11,富邦-宜蘭,2024-11-26,9686
00881,國泰台灣5G+,11,0,11,富邦-宜蘭,2024-11-26,9686
2354,鴻準,37,26,11,富邦-宜蘭,2024-11-26,9686
2449,京元電子,16,5,11,富邦-宜蘭,2024-11-26,9686
3580,友威科,12,1,11,富邦-宜蘭,2024-11-26,9686
00954,中信日本半導體,11,0,11,富邦-宜蘭,2024-11-26,9686
00664R,國泰臺灣加權反1,541,0,541,富邦-宜蘭,2024-11-27,9686
00878,國泰永續高股息,256,21,235,富邦-宜蘭,2024-11-27,9686
2303,聯電,165,15,150,富邦-宜蘭,2024-11-27,9686
0056,元大高股息,150,6,144,富邦-宜蘭,2024-11-27,9686
911868,同方友友-DR,100,0,100,富邦-宜蘭,2024-11-27,9686
1432,大魯閣,104,10,94,富邦-宜蘭,2024-11-27,9686
2603,長榮,82,6,76,富邦-宜蘭,2024-11-27,9686
00687B,國泰20年美債,103,32,71,富邦-宜蘭,2024-11-27,9686
2883,凱基金,67,1,66,富邦-宜蘭,2024-11-27,9686
2317,鴻海,75,11,64,富邦-宜蘭,2024-11-27,9686
00950B,凱基A級公司債,60,0,60,富邦-宜蘭,2024-11-27,9686
00715L,期街口布蘭特正2,60,0,60,富邦-宜蘭,2024-11-27,9686
00940,元大台灣價值高息,66,6,60,富邦-宜蘭,2024-11-27,9686
5371,中光電,62,8,54,富邦-宜蘭,2024-11-27,9686
8163,達方,60,10,50,富邦-宜蘭,2024-11-27,9686
9945,潤泰新,51,1,50,富邦-宜蘭,2024-11-27,9686
00900,富邦特選高股息30,50,1,49,富邦-宜蘭,2024-11-27,9686
2426,鼎元,61,13,48,富邦-宜蘭,2024-11-27,9686
3043,科風,51,3,48,富邦-宜蘭,2024-11-27,9686
3231,緯創,77,30,47,富邦-宜蘭,2024-11-27,9686
2609,陽明,97,55,42,富邦-宜蘭,2024-11-27,9686
00919,群益台灣精選高息,155,113,42,富邦-宜蘭,2024-11-27,9686
5880,合庫金,50,9,41,富邦-宜蘭,2024-11-27,9686
00915,凱基優選高股息30,37,0,37,富邦-宜蘭,2024-11-27,9686
4510,高鋒,67,31,36,富邦-宜蘭,2024-11-27,9686
1449,佳和,40,5,35,富邦-宜蘭,2024-11-27,9686
2330,台積電,32,0,32,富邦-宜蘭,2024-11-27,9686
1711,永光,31,0,31,富邦-宜蘭,2024-11-27,9686
2615,萬海,52,23,29,富邦-宜蘭,2024-11-27,9686
00922,國泰台灣領袖50,27,0,27,富邦-宜蘭,2024-11-27,9686
00918,大華優利高填息30,42,15,27,富邦-宜蘭,2024-11-27,9686
3481,群創,29,2,27,富邦-宜蘭,2024-11-27,9686
3049,精金,25,0,25,富邦-宜蘭,2024-11-27,9686
00929,復華台灣科技優息,118,94,24,富邦-宜蘭,2024-11-27,9686
6257,矽格,24,0,24,富邦-宜蘭,2024-11-27,9686
5243,乙盛-KY,23,0,23,富邦-宜蘭,2024-11-27,9686
4562,穎漢,60,37,23,富邦-宜蘭,2024-11-27,9686
00930,永豐ESG低碳高息,22,1,21,富邦-宜蘭,2024-11-27,9686
2881,富邦金,24,3,21,富邦-宜蘭,2024-11-27,9686
3013,晟銘電,22,2,20,富邦-宜蘭,2024-11-27,9686
00895,富邦未來車,20,0,20,富邦-宜蘭,2024-11-27,9686
2515,中工,20,0,20,富邦-宜蘭,2024-11-27,9686
6603,富強鑫,21,1,20,富邦-宜蘭,2024-11-27,9686
1815,富喬,41,21,20,富邦-宜蘭,2024-11-27,9686
00927,群益半導體收益,17,0,17,富邦-宜蘭,2024-11-27,9686
0050,元大台灣50,17,0,17,富邦-宜蘭,2024-11-27,9686
5398,慕康生醫,17,0,17,富邦-宜蘭,2024-11-27,9686
2344,華邦電,25,8,17,富邦-宜蘭,2024-11-27,9686
00881,國泰台灣5G+,15,0,15,富邦-宜蘭,2024-11-27,9686
4931,新盛力,18,3,15,富邦-宜蘭,2024-11-27,9686
00878,國泰永續高股息,173,26,147,富邦-宜蘭,2024-11-28,9686
00919,群益台灣精選高息,122,23,99,富邦-宜蘭,2024-11-28,9686
2317,鴻海,110,28,82,富邦-宜蘭,2024-11-28,9686
4510,高鋒,138,58,80,富邦-宜蘭,2024-11-28,9686
00929,復華台灣科技優息,97,19,78,富邦-宜蘭,2024-11-28,9686
2312,金寶,124,62,62,富邦-宜蘭,2024-11-28,9686
3043,科風,56,1,55,富邦-宜蘭,2024-11-28,9686
2303,聯電,82,30,52,富邦-宜蘭,2024-11-28,9686
0056,元大高股息,73,21,52,富邦-宜蘭,2024-11-28,9686
2332,友訊,71,23,48,富邦-宜蘭,2024-11-28,9686
2344,華邦電,48,2,46,富邦-宜蘭,2024-11-28,9686
1815,富喬,140,95,45,富邦-宜蘭,2024-11-28,9686
2603,長榮,52,10,42,富邦-宜蘭,2024-11-28,9686
00946,群益科技高息成長,42,4,38,富邦-宜蘭,2024-11-28,9686
2405,輔信,40,3,37,富邦-宜蘭,2024-11-28,9686
2888,新光金,36,0,36,富邦-宜蘭,2024-11-28,9686
2883,凱基金,47,13,34,富邦-宜蘭,2024-11-28,9686
1711,永光,30,0,30,富邦-宜蘭,2024-11-28,9686
2349,錸德,46,17,29,富邦-宜蘭,2024-11-28,9686
1301,台塑,33,5,28,富邦-宜蘭,2024-11-28,9686
00909,國泰數位支付服務,33,7,26,富邦-宜蘭,2024-11-28,9686
2834,臺企銀,25,0,25,富邦-宜蘭,2024-11-28,9686
00918,大華優利高填息30,24,0,24,富邦-宜蘭,2024-11-28,9686
3450,聯鈞,70,47,23,富邦-宜蘭,2024-11-28,9686
00715L,期街口布蘭特正2,22,0,22,富邦-宜蘭,2024-11-28,9686
4105,東洋,27,7,20,富邦-宜蘭,2024-11-28,9686
5603,陸海,20,0,20,富邦-宜蘭,2024-11-28,9686
5426,振發,23,4,19,富邦-宜蘭,2024-11-28,9686
00940,元大台灣價值高息,42,24,18,富邦-宜蘭,2024-11-28,9686
00631L,元大台灣50正2,20,3,17,富邦-宜蘭,2024-11-28,9686
2605,新興,17,0,17,富邦-宜蘭,2024-11-28,9686
2855,統一證,15,0,15,富邦-宜蘭,2024-11-28,9686
6116,彩晶,15,0,15,富邦-宜蘭,2024-11-28,9686
006208,富邦台50,15,0,15,富邦-宜蘭,2024-11-28,9686
2371,大同,14,0,14,富邦-宜蘭,2024-11-28,9686
00891,中信關鍵半導體,13,0,13,富邦-宜蘭,2024-11-28,9686
8171,天宇,17,4,13,富邦-宜蘭,2024-11-28,9686
9958,世紀鋼,14,1,13,富邦-宜蘭,2024-11-28,9686
3706,神達,351,339,12,富邦-宜蘭,2024-11-28,9686
2449,京元電子,21,9,12,富邦-宜蘭,2024-11-28,9686
6133,金橋,12,0,12,富邦-宜蘭,2024-11-28,9686
2330,台積電,15,3,12,富邦-宜蘭,2024-11-28,9686
3363,上詮,17,5,12,富邦-宜蘭,2024-11-28,9686
6202,盛群,11,0,11,富邦-宜蘭,2024-11-28,9686
6196,帆宣,11,0,11,富邦-宜蘭,2024-11-28,9686
3037,欣興,13,2,11,富邦-宜蘭,2024-11-28,9686
2610,華航,19,8,11,富邦-宜蘭,2024-11-28,9686
6706,惠特,12,1,11,富邦-宜蘭,2024-11-28,9686
2547,日勝生,11,1,10,富邦-宜蘭,2024-11-28,9686
8473,山林水,10,0,10,富邦-宜蘭,2024-11-28,9686
2431,聯昌,210,12,198,富邦-宜蘭,2024-11-29,9686
2317,鴻海,221,32,189,富邦-宜蘭,2024-11-29,9686
00878,國泰永續高股息,120,2,118,富邦-宜蘭,2024-11-29,9686
1301,台塑,74,0,74,富邦-宜蘭,2024-11-29,9686
2444,兆勁,62,6,56,富邦-宜蘭,2024-11-29,9686
2641,正德,54,3,51,富邦-宜蘭,2024-11-29,9686
2312,金寶,101,53,48,富邦-宜蘭,2024-11-29,9686
5353,台林,110,62,48,富邦-宜蘭,2024-11-29,9686
3024,憶聲,50,4,46,富邦-宜蘭,2024-11-29,9686
8042,金山電,56,10,46,富邦-宜蘭,2024-11-29,9686
3019,亞光,43,3,40,富邦-宜蘭,2024-11-29,9686
00929,復華台灣科技優息,60,20,40,富邦-宜蘭,2024-11-29,9686
2618,長榮航,47,8,39,富邦-宜蘭,2024-11-29,9686
2344,華邦電,54,16,38,富邦-宜蘭,2024-11-29,9686
2887,台新金,38,2,36,富邦-宜蘭,2024-11-29,9686
0056,元大高股息,50,17,33,富邦-宜蘭,2024-11-29,9686
3706,神達,500,468,32,富邦-宜蘭,2024-11-29,9686
2834,臺企銀,26,1,25,富邦-宜蘭,2024-11-29,9686
00919,群益台灣精選高息,31,6,25,富邦-宜蘭,2024-11-29,9686
3090,日電貿,42,18,24,富邦-宜蘭,2024-11-29,9686
3032,偉訓,27,3,24,富邦-宜蘭,2024-11-29,9686
5481,新華,23,0,23,富邦-宜蘭,2024-11-29,9686
3628,盈正,23,0,23,富邦-宜蘭,2024-11-29,9686
2313,華通,28,5,23,富邦-宜蘭,2024-11-29,9686
1402,遠東新,20,0,20,富邦-宜蘭,2024-11-29,9686
00953B,群益優選非投等債,20,0,20,富邦-宜蘭,2024-11-29,9686
00915,凱基優選高股息30,20,1,19,富邦-宜蘭,2024-11-29,9686
3231,緯創,23,5,18,富邦-宜蘭,2024-11-29,9686
1802,台玻,32,14,18,富邦-宜蘭,2024-11-29,9686
2303,聯電,36,18,18,富邦-宜蘭,2024-11-29,9686
00918,大華優利高填息30,19,2,17,富邦-宜蘭,2024-11-29,9686
1452,宏益,72,55,17,富邦-宜蘭,2024-11-29,9686
5244,弘凱,73,56,17,富邦-宜蘭,2024-11-29,9686
2609,陽明,35,18,17,富邦-宜蘭,2024-11-29,9686
5309,系統電,79,63,16,富邦-宜蘭,2024-11-29,9686
1326,台化,23,8,15,富邦-宜蘭,2024-11-29,9686
3419,譁裕,21,6,15,富邦-宜蘭,2024-11-29,9686
00938,凱基優選30,15,0,15,富邦-宜蘭,2024-11-29,9686
2881,富邦金,25,10,15,富邦-宜蘭,2024-11-29,9686
2543,皇昌,18,4,14,富邦-宜蘭,2024-11-29,9686
00940,元大台灣價值高息,14,0,14,富邦-宜蘭,2024-11-29,9686
00922,國泰台灣領袖50,16,2,14,富邦-宜蘭,2024-11-29,9686
00924,復華S＆P500成長,12,0,12,富邦-宜蘭,2024-11-29,9686
6175,立敦,17,5,12,富邦-宜蘭,2024-11-29,9686
6757,台灣虎航,18,6,12,富邦-宜蘭,2024-11-29,9686
2615,萬海,32,20,12,富邦-宜蘭,2024-11-29,9686
1303,南亞,11,0,11,富邦-宜蘭,2024-11-29,9686
6443,元晶,16,5,11,富邦-宜蘭,2024-11-29,9686
2911,麗嬰房,10,0,10,富邦-宜蘭,2024-11-29,9686
00950B,凱基A級公司債,10,0,10,富邦-宜蘭,2024-11-29,9686
00632R,元大台灣50反1,1240,8,1232,富邦-宜蘭,2024-12-02,9686
00918,大華優利高填息30,372,3,369,富邦-宜蘭,2024-12-02,9686
2495,普安,84,1,83,富邦-宜蘭,2024-12-02,9686
2312,金寶,116,50,66,富邦-宜蘭,2024-12-02,9686
6558,興能高,171,105,66,富邦-宜蘭,2024-12-02,9686
2317,鴻海,79,18,61,富邦-宜蘭,2024-12-02,9686
00679B,元大美債20年,72,12,60,富邦-宜蘭,2024-12-02,9686
2834,臺企銀,61,3,58,富邦-宜蘭,2024-12-02,9686
00950B,凱基A級公司債,50,0,50,富邦-宜蘭,2024-12-02,9686
00878,國泰永續高股息,60,10,50,富邦-宜蘭,2024-12-02,9686
00919,群益台灣精選高息,52,6,46,富邦-宜蘭,2024-12-02,9686
2313,華通,34,0,34,富邦-宜蘭,2024-12-02,9686
00753L,中信中國50正2,33,2,31,富邦-宜蘭,2024-12-02,9686
00688L,國泰20年美債正2,30,0,30,富邦-宜蘭,2024-12-02,9686
1721,三晃,30,3,27,富邦-宜蘭,2024-12-02,9686
6962,ITH-KY,25,0,25,富邦-宜蘭,2024-12-02,9686
00650L,復華香港正2,26,4,22,富邦-宜蘭,2024-12-02,9686
00959B,大華投等美債15Y+,20,0,20,富邦-宜蘭,2024-12-02,9686
2515,中工,20,0,20,富邦-宜蘭,2024-12-02,9686
2646,星宇航空,22,2,20,富邦-宜蘭,2024-12-02,9686
00715L,期街口布蘭特正2,23,4,19,富邦-宜蘭,2024-12-02,9686
00830,國泰費城半導體,23,5,18,富邦-宜蘭,2024-12-02,9686
4123,晟德,18,0,18,富邦-宜蘭,2024-12-02,9686
00664R,國泰臺灣加權反1,17,0,17,富邦-宜蘭,2024-12-02,9686
2392,正崴,29,12,17,富邦-宜蘭,2024-12-02,9686
2337,旺宏,20,4,16,富邦-宜蘭,2024-12-02,9686
00953B,群益優選非投等債,15,0,15,富邦-宜蘭,2024-12-02,9686
2408,南亞科,18,3,15,富邦-宜蘭,2024-12-02,9686
1528,恩德,20,6,14,富邦-宜蘭,2024-12-02,9686
3211,順達,94,81,13,富邦-宜蘭,2024-12-02,9686
2426,鼎元,16,4,12,富邦-宜蘭,2024-12-02,9686
2886,兆豐金,12,1,11,富邦-宜蘭,2024-12-02,9686
6127,九豪,11,0,11,富邦-宜蘭,2024-12-02,9686
2354,鴻準,55,44,11,富邦-宜蘭,2024-12-02,9686
2444,兆勁,10,0,10,富邦-宜蘭,2024-12-02,9686
2344,華邦電,15,5,10,富邦-宜蘭,2024-12-02,9686
2419,仲琦,22,12,10,富邦-宜蘭,2024-12-02,9686
00930,永豐ESG低碳高息,10,0,10,富邦-宜蘭,2024-12-02,9686
2601,益航,10,0,10,富邦-宜蘭,2024-12-02,9686
2855,統一證,10,0,10,富邦-宜蘭,2024-12-02,9686
6770,力積電,20,12,8,富邦-宜蘭,2024-12-02,9686
6505,台塑化,12,4,8,富邦-宜蘭,2024-12-02,9686
1605,華新,10,2,8,富邦-宜蘭,2024-12-02,9686
00637L,元大滬深300正2,75,67,8,富邦-宜蘭,2024-12-02,9686
6016,康和證,8,0,8,富邦-宜蘭,2024-12-02,9686
3481,群創,36,28,8,富邦-宜蘭,2024-12-02,9686
3231,緯創,35,27,8,富邦-宜蘭,2024-12-02,9686
5371,中光電,32,24,8,富邦-宜蘭,2024-12-02,9686
3162,精確,9,2,7,富邦-宜蘭,2024-12-02,9686
4571,鈞興-KY,7,0,7,富邦-宜蘭,2024-12-02,9686
00919,群益台灣精選高息,341,53,288,富邦-宜蘭,2024-12-03,9686
00951,台新日本半導體,270,7,263,富邦-宜蘭,2024-12-03,9686
9907,統一實,150,0,150,富邦-宜蘭,2024-12-03,9686
00918,大華優利高填息30,108,0,108,富邦-宜蘭,2024-12-03,9686
2317,鴻海,121,13,108,富邦-宜蘭,2024-12-03,9686
8440,綠電,75,0,75,富邦-宜蘭,2024-12-03,9686
1451,年興,70,0,70,富邦-宜蘭,2024-12-03,9686
00713,元大台灣高息低波,45,0,45,富邦-宜蘭,2024-12-03,9686
6834,天二科技,45,0,45,富邦-宜蘭,2024-12-03,9686
2312,金寶,96,60,36,富邦-宜蘭,2024-12-03,9686
00937B,群益ESG投等債20,67,35,32,富邦-宜蘭,2024-12-03,9686
8438,昶昕,32,0,32,富邦-宜蘭,2024-12-03,9686
3211,順達,78,48,30,富邦-宜蘭,2024-12-03,9686
00959B,大華投等美債15Y+,29,0,29,富邦-宜蘭,2024-12-03,9686
00930,永豐ESG低碳高息,25,0,25,富邦-宜蘭,2024-12-03,9686
00715L,期街口布蘭特正2,25,0,25,富邦-宜蘭,2024-12-03,9686
00953B,群益優選非投等債,25,0,25,富邦-宜蘭,2024-12-03,9686
8111,立��,21,1,20,富邦-宜蘭,2024-12-03,9686
9928,中視,20,0,20,富邦-宜蘭,2024-12-03,9686
00878,國泰永續高股息,68,49,19,富邦-宜蘭,2024-12-03,9686
3712,永崴投控,20,1,19,富邦-宜蘭,2024-12-03,9686
00712,復華富時不動產,21,2,19,富邦-宜蘭,2024-12-03,9686
5011,久陽,18,0,18,富邦-宜蘭,2024-12-03,9686
1618,合機,17,1,16,富邦-宜蘭,2024-12-03,9686
9904,寶成,15,0,15,富邦-宜蘭,2024-12-03,9686
2303,聯電,52,39,13,富邦-宜蘭,2024-12-03,9686
1537,廣隆,13,0,13,富邦-宜蘭,2024-12-03,9686
4977,眾達-KY,44,31,13,富邦-宜蘭,2024-12-03,9686
2385,群光,14,2,12,富邦-宜蘭,2024-12-03,9686
4303,信立,28,16,12,富邦-宜蘭,2024-12-03,9686
3380,明泰,12,0,12,富邦-宜蘭,2024-12-03,9686
0056,元大高股息,18,7,11,富邦-宜蘭,2024-12-03,9686
6173,信昌電,26,15,11,富邦-宜蘭,2024-12-03,9686
6862,三集瑞-KY,13,2,11,富邦-宜蘭,2024-12-03,9686
2498,宏達電,11,0,11,富邦-宜蘭,2024-12-03,9686
00887,永豐中國科技50大,11,0,11,富邦-宜蘭,2024-12-03,9686
2062,橋椿,17,6,11,富邦-宜蘭,2024-12-03,9686
3231,緯創,28,18,10,富邦-宜蘭,2024-12-03,9686
2344,華邦電,10,0,10,富邦-宜蘭,2024-12-03,9686
3152,璟德,10,0,10,富邦-宜蘭,2024-12-03,9686
912000,晨訊科-DR,10,0,10,富邦-宜蘭,2024-12-03,9686
5244,弘凱,15,5,10,富邦-宜蘭,2024-12-03,9686
1528,恩德,11,1,10,富邦-宜蘭,2024-12-03,9686
00664R,國泰臺灣加權反1,10,0,10,富邦-宜蘭,2024-12-03,9686
2426,鼎元,18,8,10,富邦-宜蘭,2024-12-03,9686
2302,麗正,17,7,10,富邦-宜蘭,2024-12-03,9686
6558,興能高,27,18,9,富邦-宜蘭,2024-12-03,9686
4906,正文,15,7,8,富邦-宜蘭,2024-12-03,9686
4904,遠傳,8,0,8,富邦-宜蘭,2024-12-03,9686
5488,松普,8,0,8,富邦-宜蘭,2024-12-03,9686
00919,群益台灣精選高息,157,25,132,富邦-宜蘭,2024-12-04,9686
00673R,期元大S＆P原油反1,122,0,122,富邦-宜蘭,2024-12-04,9686
00931B,統一美債20年,130,15,115,富邦-宜蘭,2024-12-04,9686
3645,達邁,115,0,115,富邦-宜蘭,2024-12-04,9686
00946,群益科技高息成長,70,0,70,富邦-宜蘭,2024-12-04,9686
00706L,期元大S＆P日圓正2,70,0,70,富邦-宜蘭,2024-12-04,9686
6153,嘉聯益,63,0,63,富邦-宜蘭,2024-12-04,9686
2884,玉山金,53,1,52,富邦-宜蘭,2024-12-04,9686
2317,鴻海,63,15,48,富邦-宜蘭,2024-12-04,9686
00679B,元大美債20年,43,3,40,富邦-宜蘭,2024-12-04,9686
4974,亞泰,36,0,36,富邦-宜蘭,2024-12-04,9686
00918,大華優利高填息30,37,2,35,富邦-宜蘭,2024-12-04,9686
5244,弘凱,50,15,35,富邦-宜蘭,2024-12-04,9686
2881,富邦金,35,1,34,富邦-宜蘭,2024-12-04,9686
00671R,富邦NASDAQ反1,30,0,30,富邦-宜蘭,2024-12-04,9686
2887,台新金,40,10,30,富邦-宜蘭,2024-12-04,9686
2891,中信金,24,4,20,富邦-宜蘭,2024-12-04,9686
00887,永豐中國科技50大,20,0,20,富邦-宜蘭,2024-12-04,9686
1301,台塑,21,1,20,富邦-宜蘭,2024-12-04,9686
5452,佶優,19,0,19,富邦-宜蘭,2024-12-04,9686
2929,淘帝-KY,22,5,17,富邦-宜蘭,2024-12-04,9686
6962,ITH-KY,18,1,17,富邦-宜蘭,2024-12-04,9686
00933B,國泰10Y+金融債,16,0,16,富邦-宜蘭,2024-12-04,9686
2409,友達,15,0,15,富邦-宜蘭,2024-12-04,9686
8021,尖點,15,0,15,富邦-宜蘭,2024-12-04,9686
6284,佳邦,15,0,15,富邦-宜蘭,2024-12-04,9686
8155,博智,15,0,15,富邦-宜蘭,2024-12-04,9686
00948B,中信優息投資級債,30,16,14,富邦-宜蘭,2024-12-04,9686
2062,橋椿,26,12,14,富邦-宜蘭,2024-12-04,9686
6133,金橋,17,3,14,富邦-宜蘭,2024-12-04,9686
1314,中石化,13,0,13,富邦-宜蘭,2024-12-04,9686
4541,晟田,12,0,12,富邦-宜蘭,2024-12-04,9686
2349,錸德,52,41,11,富邦-宜蘭,2024-12-04,9686
1802,台玻,18,7,11,富邦-宜蘭,2024-12-04,9686
3706,神達,293,282,11,富邦-宜蘭,2024-12-04,9686
3037,欣興,14,3,11,富邦-宜蘭,2024-12-04,9686
6257,矽格,11,0,11,富邦-宜蘭,2024-12-04,9686
00947,台新臺灣IC設計,10,0,10,富邦-宜蘭,2024-12-04,9686
2516,新建,10,0,10,富邦-宜蘭,2024-12-04,9686
8105,凌巨,10,0,10,富邦-宜蘭,2024-12-04,9686
00664R,國泰臺灣加權反1,10,0,10,富邦-宜蘭,2024-12-04,9686
2888,新光金,11,1,10,富邦-宜蘭,2024-12-04,9686
2486,一詮,24,14,10,富邦-宜蘭,2024-12-04,9686
3628,盈正,19,10,9,富邦-宜蘭,2024-12-04,9686
6207,雷科,11,2,9,富邦-宜蘭,2024-12-04,9686
8043,蜜望實,13,4,9,富邦-宜蘭,2024-12-04,9686
3338,泰碩,13,5,8,富邦-宜蘭,2024-12-04,9686
6763,綠界科技*,8,0,8,富邦-宜蘭,2024-12-04,9686
3591,艾笛森,8,0,8,富邦-宜蘭,2024-12-04,9686
8112,至上,8,1,7,富邦-宜蘭,2024-12-04,9686
1721,三晃,103,1,102,富邦-宜蘭,2024-12-05,9686
2317,鴻海,88,4,84,富邦-宜蘭,2024-12-05,9686
00715L,期街口布蘭特正2,70,0,70,富邦-宜蘭,2024-12-05,9686
6127,九豪,81,21,60,富邦-宜蘭,2024-12-05,9686
1735,日勝化,48,0,48,富邦-宜蘭,2024-12-05,9686
2303,聯電,51,5,46,富邦-宜蘭,2024-12-05,9686
00887,永豐中國科技50大,45,2,43,富邦-宜蘭,2024-12-05,9686
2399,映泰,45,3,42,富邦-宜蘭,2024-12-05,9686
912000,晨訊科-DR,41,0,41,富邦-宜蘭,2024-12-05,9686
4716,大立,40,0,40,富邦-宜蘭,2024-12-05,9686
2392,正崴,81,43,38,富邦-宜蘭,2024-12-05,9686
00918,大華優利高填息30,62,25,37,富邦-宜蘭,2024-12-05,9686
8440,綠電,35,1,34,富邦-宜蘭,2024-12-05,9686
1815,富喬,162,129,33,富邦-宜蘭,2024-12-05,9686
00941,中信上游半導體,33,1,32,富邦-宜蘭,2024-12-05,9686
00909,國泰數位支付服務,38,8,30,富邦-宜蘭,2024-12-05,9686
6770,力積電,27,0,27,富邦-宜蘭,2024-12-05,9686
3043,科風,31,4,27,富邦-宜蘭,2024-12-05,9686
9904,寶成,27,0,27,富邦-宜蘭,2024-12-05,9686
2371,大同,30,4,26,富邦-宜蘭,2024-12-05,9686
3211,順達,129,103,26,富邦-宜蘭,2024-12-05,9686
2834,臺企銀,25,0,25,富邦-宜蘭,2024-12-05,9686
1303,南亞,26,2,24,富邦-宜蘭,2024-12-05,9686
2344,華邦電,24,1,23,富邦-宜蘭,2024-12-05,9686
3234,光環,25,2,23,富邦-宜蘭,2024-12-05,9686
2356,英業達,24,1,23,富邦-宜蘭,2024-12-05,9686
1536,和大,21,0,21,富邦-宜蘭,2024-12-05,9686
3236,千如,20,0,20,富邦-宜蘭,2024-12-05,9686
00948B,中信優息投資級債,20,0,20,富邦-宜蘭,2024-12-05,9686
5328,華容,45,25,20,富邦-宜蘭,2024-12-05,9686
2027,大成鋼,21,2,19,富邦-宜蘭,2024-12-05,9686
1537,廣隆,18,0,18,富邦-宜蘭,2024-12-05,9686
4953,緯軟,19,1,18,富邦-宜蘭,2024-12-05,9686
00753L,中信中國50正2,17,0,17,富邦-宜蘭,2024-12-05,9686
3041,揚智,26,10,16,富邦-宜蘭,2024-12-05,9686
00665L,富邦�琤肭磪囓�2,16,0,16,富邦-宜蘭,2024-12-05,9686
2382,廣達,21,6,15,富邦-宜蘭,2024-12-05,9686
5907,大洋-KY,15,0,15,富邦-宜蘭,2024-12-05,9686
2883,凱基金,32,17,15,富邦-宜蘭,2024-12-05,9686
00900,富邦特選高股息30,14,0,14,富邦-宜蘭,2024-12-05,9686
2425,承啟,14,0,14,富邦-宜蘭,2024-12-05,9686
00637L,元大滬深300正2,28,15,13,富邦-宜蘭,2024-12-05,9686
6134,萬旭,13,0,13,富邦-宜蘭,2024-12-05,9686
6806,森崴能源,16,3,13,富邦-宜蘭,2024-12-05,9686
2002,中鋼,13,1,12,富邦-宜蘭,2024-12-05,9686
8171,天宇,12,0,12,富邦-宜蘭,2024-12-05,9686
2495,普安,12,0,12,富邦-宜蘭,2024-12-05,9686
2609,陽明,24,12,12,富邦-宜蘭,2024-12-05,9686
1452,宏益,45,34,11,富邦-宜蘭,2024-12-05,9686
00907,永豐優息存股,11,0,11,富邦-宜蘭,2024-12-05,9686
8038,長園科,150,0,150,富邦-宜蘭,2024-12-06,9686
00680L,元大美債20正2,113,0,113,富邦-宜蘭,2024-12-06,9686
00919,群益台灣精選高息,92,13,79,富邦-宜蘭,2024-12-06,9686
1301,台塑,69,7,62,富邦-宜蘭,2024-12-06,9686
1605,華新,134,72,62,富邦-宜蘭,2024-12-06,9686
2312,金寶,86,32,54,富邦-宜蘭,2024-12-06,9686
8070,長華*,52,1,51,富邦-宜蘭,2024-12-06,9686
2317,鴻海,51,5,46,富邦-宜蘭,2024-12-06,9686
3706,神達,299,254,45,富邦-宜蘭,2024-12-06,9686
6153,嘉聯益,35,0,35,富邦-宜蘭,2024-12-06,9686
9927,泰銘,35,0,35,富邦-宜蘭,2024-12-06,9686
00882,中信中國高股息,50,16,34,富邦-宜蘭,2024-12-06,9686
1815,富喬,55,22,33,富邦-宜蘭,2024-12-06,9686
1307,三芳,32,0,32,富邦-宜蘭,2024-12-06,9686
3229,晟鈦,31,0,31,富邦-宜蘭,2024-12-06,9686
00918,大華優利高填息30,44,14,30,富邦-宜蘭,2024-12-06,9686
2889,國票金,30,0,30,富邦-宜蘭,2024-12-06,9686
00897,富邦基因免疫生技,30,0,30,富邦-宜蘭,2024-12-06,9686
00941,中信上游半導體,30,1,29,富邦-宜蘭,2024-12-06,9686
2354,鴻準,133,106,27,富邦-宜蘭,2024-12-06,9686
00715L,期街口布蘭特正2,26,0,26,富邦-宜蘭,2024-12-06,9686
2303,聯電,37,12,25,富邦-宜蘭,2024-12-06,9686
3024,憶聲,32,9,23,富邦-宜蘭,2024-12-06,9686
6425,易發,22,0,22,富邦-宜蘭,2024-12-06,9686
6257,矽格,23,1,22,富邦-宜蘭,2024-12-06,9686
2543,皇昌,22,2,20,富邦-宜蘭,2024-12-06,9686
9105,泰金寶-DR,20,1,19,富邦-宜蘭,2024-12-06,9686
8111,立��,32,14,18,富邦-宜蘭,2024-12-06,9686
00940,元大台灣價值高息,18,1,17,富邦-宜蘭,2024-12-06,9686
2426,鼎元,23,7,16,富邦-宜蘭,2024-12-06,9686
3625,西勝,17,1,16,富邦-宜蘭,2024-12-06,9686
6789,采鈺,15,0,15,富邦-宜蘭,2024-12-06,9686
1595,川寶,45,31,14,富邦-宜蘭,2024-12-06,9686
3591,艾笛森,16,2,14,富邦-宜蘭,2024-12-06,9686
5488,松普,14,0,14,富邦-宜蘭,2024-12-06,9686
6558,興能高,92,78,14,富邦-宜蘭,2024-12-06,9686
4931,新盛力,187,174,13,富邦-宜蘭,2024-12-06,9686
3680,家登,14,1,13,富邦-宜蘭,2024-12-06,9686
8069,元太,12,0,12,富邦-宜蘭,2024-12-06,9686
2408,南亞科,13,1,12,富邦-宜蘭,2024-12-06,9686
2380,虹光,12,0,12,富邦-宜蘭,2024-12-06,9686
3162,精確,12,0,12,富邦-宜蘭,2024-12-06,9686
00933B,國泰10Y+金融債,12,0,12,富邦-宜蘭,2024-12-06,9686
6218,豪勉,12,0,12,富邦-宜蘭,2024-12-06,9686
6720,久昌,12,0,12,富邦-宜蘭,2024-12-06,9686
00713,元大台灣高息低波,12,0,12,富邦-宜蘭,2024-12-06,9686
3032,偉訓,18,7,11,富邦-宜蘭,2024-12-06,9686
6187,萬潤,20,9,11,富邦-宜蘭,2024-12-06,9686
6667,信紘科,15,4,11,富邦-宜蘭,2024-12-06,9686
3567,逸昌,11,0,11,富邦-宜蘭,2024-12-06,9686
00712,復華富時不動產,446,27,419,富邦-宜蘭,2024-12-09,9686
2324,仁寶,138,41,97,富邦-宜蘭,2024-12-09,9686
00715L,期街口布蘭特正2,79,0,79,富邦-宜蘭,2024-12-09,9686
00918,大華優利高填息30,74,8,66,富邦-宜蘭,2024-12-09,9686
3211,順達,64,12,52,富邦-宜蘭,2024-12-09,9686
00909,國泰數位支付服務,55,3,52,富邦-宜蘭,2024-12-09,9686
2603,長榮,55,9,46,富邦-宜蘭,2024-12-09,9686
1711,永光,38,0,38,富邦-宜蘭,2024-12-09,9686
2405,輔信,41,3,38,富邦-宜蘭,2024-12-09,9686
5907,大洋-KY,36,0,36,富邦-宜蘭,2024-12-09,9686
1303,南亞,39,4,35,富邦-宜蘭,2024-12-09,9686
1101,台泥,35,2,33,富邦-宜蘭,2024-12-09,9686
00900,富邦特選高股息30,33,0,33,富邦-宜蘭,2024-12-09,9686
00938,凱基優選30,32,0,32,富邦-宜蘭,2024-12-09,9686
00637L,元大滬深300正2,45,15,30,富邦-宜蘭,2024-12-09,9686
00959B,大華投等美債15Y+,90,60,30,富邦-宜蘭,2024-12-09,9686
00878,國泰永續高股息,39,10,29,富邦-宜蘭,2024-12-09,9686
9904,寶成,33,5,28,富邦-宜蘭,2024-12-09,9686
0056,元大高股息,31,5,26,富邦-宜蘭,2024-12-09,9686
2886,兆豐金,25,0,25,富邦-宜蘭,2024-12-09,9686
00960,野村全球航運龍頭,26,1,25,富邦-宜蘭,2024-12-09,9686
00932,兆豐永續高息等權,25,0,25,富邦-宜蘭,2024-12-09,9686
2392,正崴,43,19,24,富邦-宜蘭,2024-12-09,9686
2409,友達,26,3,23,富邦-宜蘭,2024-12-09,9686
6443,元晶,24,1,23,富邦-宜蘭,2024-12-09,9686
00937B,群益ESG投等債20,50,28,22,富邦-宜蘭,2024-12-09,9686
2002,中鋼,22,0,22,富邦-宜蘭,2024-12-09,9686
8261,富鼎,26,4,22,富邦-宜蘭,2024-12-09,9686
8111,立��,22,1,21,富邦-宜蘭,2024-12-09,9686
00662,富邦NASDAQ,21,0,21,富邦-宜蘭,2024-12-09,9686
2605,新興,21,0,21,富邦-宜蘭,2024-12-09,9686
00926,凱基全球菁英55,21,0,21,富邦-宜蘭,2024-12-09,9686
9927,泰銘,21,0,21,富邦-宜蘭,2024-12-09,9686
4971,IET-KY,21,0,21,富邦-宜蘭,2024-12-09,9686
9105,泰金寶-DR,23,3,20,富邦-宜蘭,2024-12-09,9686
1307,三芳,20,0,20,富邦-宜蘭,2024-12-09,9686
3025,星通,25,5,20,富邦-宜蘭,2024-12-09,9686
00664R,國泰臺灣加權反1,20,0,20,富邦-宜蘭,2024-12-09,9686
00921,兆豐龍頭等權重,20,0,20,富邦-宜蘭,2024-12-09,9686
2436,偉詮電,27,7,20,富邦-宜蘭,2024-12-09,9686
00915,凱基優選高股息30,19,0,19,富邦-宜蘭,2024-12-09,9686
2449,京元電子,20,2,18,富邦-宜蘭,2024-12-09,9686
2408,南亞科,27,9,18,富邦-宜蘭,2024-12-09,9686
1815,富喬,45,27,18,富邦-宜蘭,2024-12-09,9686
2337,旺宏,47,30,17,富邦-宜蘭,2024-12-09,9686
8103,瀚荃,17,0,17,富邦-宜蘭,2024-12-09,9686
2317,鴻海,23,7,16,富邦-宜蘭,2024-12-09,9686
2375,凱美,18,3,15,富邦-宜蘭,2024-12-09,9686
8070,長華*,15,0,15,富邦-宜蘭,2024-12-09,9686
00751B,元大AAA至A公司債,15,1,14,富邦-宜蘭,2024-12-09,9686
00712,復華富時不動產,458,13,445,富邦-宜蘭,2024-12-10,9686
00918,大華優利高填息30,301,5,296,富邦-宜蘭,2024-12-10,9686
00680L,元大美債20正2,250,0,250,富邦-宜蘭,2024-12-10,9686
00937B,群益ESG投等債20,233,131,102,富邦-宜蘭,2024-12-10,9686
3706,神達,353,275,78,富邦-宜蘭,2024-12-10,9686
2618,長榮航,74,6,68,富邦-宜蘭,2024-12-10,9686
2399,映泰,67,1,66,富邦-宜蘭,2024-12-10,9686
2609,陽明,259,197,62,富邦-宜蘭,2024-12-10,9686
00919,群益台灣精選高息,96,37,59,富邦-宜蘭,2024-12-10,9686
00715L,期街口布蘭特正2,58,14,44,富邦-宜蘭,2024-12-10,9686
2317,鴻海,53,10,43,富邦-宜蘭,2024-12-10,9686
00909,國泰數位支付服務,40,1,39,富邦-宜蘭,2024-12-10,9686
1815,富喬,91,52,39,富邦-宜蘭,2024-12-10,9686
1449,佳和,42,6,36,富邦-宜蘭,2024-12-10,9686
0056,元大高股息,42,10,32,富邦-宜蘭,2024-12-10,9686
8121,越峰,31,1,30,富邦-宜蘭,2024-12-10,9686
3231,緯創,36,7,29,富邦-宜蘭,2024-12-10,9686
2845,遠東銀,30,1,29,富邦-宜蘭,2024-12-10,9686
5403,中菲,34,5,29,富邦-宜蘭,2024-12-10,9686
4807,日成-KY,28,2,26,富邦-宜蘭,2024-12-10,9686
1605,華新,67,42,25,富邦-宜蘭,2024-12-10,9686
5328,華容,30,5,25,富邦-宜蘭,2024-12-10,9686
5880,合庫金,24,0,24,富邦-宜蘭,2024-12-10,9686
2354,鴻準,93,70,23,富邦-宜蘭,2024-12-10,9686
1802,台玻,34,12,22,富邦-宜蘭,2024-12-10,9686
2887,台新金,25,3,22,富邦-宜蘭,2024-12-10,9686
00959B,大華投等美債15Y+,21,0,21,富邦-宜蘭,2024-12-10,9686
00878,國泰永續高股息,40,19,21,富邦-宜蘭,2024-12-10,9686
6517,保勝光學,20,0,20,富邦-宜蘭,2024-12-10,9686
2547,日勝生,20,0,20,富邦-宜蘭,2024-12-10,9686
00915,凱基優選高股息30,20,0,20,富邦-宜蘭,2024-12-10,9686
2405,輔信,25,6,19,富邦-宜蘭,2024-12-10,9686
2812,台中銀,30,11,19,富邦-宜蘭,2024-12-10,9686
6589,台康生技,18,0,18,富邦-宜蘭,2024-12-10,9686
2376,技嘉,19,3,16,富邦-宜蘭,2024-12-10,9686
8011,台通,31,15,16,富邦-宜蘭,2024-12-10,9686
3712,永崴投控,16,0,16,富邦-宜蘭,2024-12-10,9686
2002,中鋼,15,1,14,富邦-宜蘭,2024-12-10,9686
2603,長榮,48,34,14,富邦-宜蘭,2024-12-10,9686
2301,光寶科,15,1,14,富邦-宜蘭,2024-12-10,9686
6139,亞翔,13,0,13,富邦-宜蘭,2024-12-10,9686
00688L,國泰20年美債正2,13,0,13,富邦-宜蘭,2024-12-10,9686
3591,艾笛森,13,0,13,富邦-宜蘭,2024-12-10,9686
2312,金寶,49,37,12,富邦-宜蘭,2024-12-10,9686
2495,普安,12,0,12,富邦-宜蘭,2024-12-10,9686
5309,系統電,20,8,12,富邦-宜蘭,2024-12-10,9686
3715,定穎投控,15,4,11,富邦-宜蘭,2024-12-10,9686
00960,野村全球航運龍頭,11,0,11,富邦-宜蘭,2024-12-10,9686
8096,擎亞,13,2,11,富邦-宜蘭,2024-12-10,9686
4906,正文,11,0,11,富邦-宜蘭,2024-12-10,9686
00712,復華富時不動產,297,1,296,富邦-宜蘭,2024-12-11,9686
00680L,元大美債20正2,204,10,194,富邦-宜蘭,2024-12-11,9686
00919,群益台灣精選高息,106,7,99,富邦-宜蘭,2024-12-11,9686
00918,大華優利高填息30,97,1,96,富邦-宜蘭,2024-12-11,9686
2317,鴻海,111,15,96,富邦-宜蘭,2024-12-11,9686
00878,國泰永續高股息,62,13,49,富邦-宜蘭,2024-12-11,9686
00915,凱基優選高股息30,46,1,45,富邦-宜蘭,2024-12-11,9686
00637L,元大滬深300正2,87,42,45,富邦-宜蘭,2024-12-11,9686
2618,長榮航,63,21,42,富邦-宜蘭,2024-12-11,9686
00753L,中信中國50正2,50,8,42,富邦-宜蘭,2024-12-11,9686
00909,國泰數位支付服務,40,1,39,富邦-宜蘭,2024-12-11,9686
0056,元大高股息,40,3,37,富邦-宜蘭,2024-12-11,9686
1711,永光,35,0,35,富邦-宜蘭,2024-12-11,9686
6596,寬宏藝術,33,0,33,富邦-宜蘭,2024-12-11,9686
1301,台塑,34,3,31,富邦-宜蘭,2024-12-11,9686
00900,富邦特選高股息30,31,0,31,富邦-宜蘭,2024-12-11,9686
00953B,群益優選非投等債,30,0,30,富邦-宜蘭,2024-12-11,9686
00713,元大台灣高息低波,29,1,28,富邦-宜蘭,2024-12-11,9686
00941,中信上游半導體,28,0,28,富邦-宜蘭,2024-12-11,9686
00795B,中信美國公債20年,27,0,27,富邦-宜蘭,2024-12-11,9686
5907,大洋-KY,28,2,26,富邦-宜蘭,2024-12-11,9686
2834,臺企銀,31,7,24,富邦-宜蘭,2024-12-11,9686
00631L,元大台灣50正2,28,4,24,富邦-宜蘭,2024-12-11,9686
2609,陽明,42,19,23,富邦-宜蘭,2024-12-11,9686
2349,錸德,22,0,22,富邦-宜蘭,2024-12-11,9686
2881,富邦金,22,1,21,富邦-宜蘭,2024-12-11,9686
2344,華邦電,22,1,21,富邦-宜蘭,2024-12-11,9686
2014,中鴻,20,0,20,富邦-宜蘭,2024-12-11,9686
00664R,國泰臺灣加權反1,20,0,20,富邦-宜蘭,2024-12-11,9686
9904,寶成,21,1,20,富邦-宜蘭,2024-12-11,9686
2498,宏達電,20,1,19,富邦-宜蘭,2024-12-11,9686
2401,凌陽,19,0,19,富邦-宜蘭,2024-12-11,9686
00931B,統一美債20年,18,0,18,富邦-宜蘭,2024-12-11,9686
1434,福懋,18,0,18,富邦-宜蘭,2024-12-11,9686
3024,憶聲,21,4,17,富邦-宜蘭,2024-12-11,9686
00940,元大台灣價值高息,19,2,17,富邦-宜蘭,2024-12-11,9686
1340,勝悅-KY,15,0,15,富邦-宜蘭,2024-12-11,9686
00688L,國泰20年美債正2,14,0,14,富邦-宜蘭,2024-12-11,9686
00922,國泰台灣領袖50,14,1,13,富邦-宜蘭,2024-12-11,9686
2301,光寶科,15,2,13,富邦-宜蘭,2024-12-11,9686
6589,台康生技,16,3,13,富邦-宜蘭,2024-12-11,9686
5488,松普,13,0,13,富邦-宜蘭,2024-12-11,9686
3607,谷崧,14,2,12,富邦-宜蘭,2024-12-11,9686
3455,由田,12,0,12,富邦-宜蘭,2024-12-11,9686
8089,康全電訊,15,3,12,富邦-宜蘭,2024-12-11,9686
2892,第一金,15,3,12,富邦-宜蘭,2024-12-11,9686
4931,新盛力,20,9,11,富邦-宜蘭,2024-12-11,9686
2408,南亞科,11,0,11,富邦-宜蘭,2024-12-11,9686
6116,彩晶,11,0,11,富邦-宜蘭,2024-12-11,9686
1326,台化,14,3,11,富邦-宜蘭,2024-12-11,9686
2332,友訊,138,20,118,富邦-宜蘭,2024-12-12,9686
00687B,國泰20年美債,122,6,116,富邦-宜蘭,2024-12-12,9686
00918,大華優利高填息30,116,1,115,富邦-宜蘭,2024-12-12,9686
00953B,群益優選非投等債,112,0,112,富邦-宜蘭,2024-12-12,9686
8070,長華*,85,1,84,富邦-宜蘭,2024-12-12,9686
2344,華邦電,63,7,56,富邦-宜蘭,2024-12-12,9686
1301,台塑,61,7,54,富邦-宜蘭,2024-12-12,9686
00764B,群益25年美債,50,0,50,富邦-宜蘭,2024-12-12,9686
2312,金寶,54,5,49,富邦-宜蘭,2024-12-12,9686
8039,台虹,48,0,48,富邦-宜蘭,2024-12-12,9686
3029,零壹,170,123,47,富邦-宜蘭,2024-12-12,9686
2317,鴻海,46,3,43,富邦-宜蘭,2024-12-12,9686
2609,陽明,54,19,35,富邦-宜蘭,2024-12-12,9686
6127,九豪,42,9,33,富邦-宜蘭,2024-12-12,9686
2354,鴻準,45,12,33,富邦-宜蘭,2024-12-12,9686
00679B,元大美債20年,37,4,33,富邦-宜蘭,2024-12-12,9686
2002,中鋼,35,3,32,富邦-宜蘭,2024-12-12,9686
00680L,元大美債20正2,32,1,31,富邦-宜蘭,2024-12-12,9686
00671R,富邦NASDAQ反1,30,0,30,富邦-宜蘭,2024-12-12,9686
2801,彰銀,27,0,27,富邦-宜蘭,2024-12-12,9686
00915,凱基優選高股息30,25,0,25,富邦-宜蘭,2024-12-12,9686
00673R,期元大S＆P原油反1,25,0,25,富邦-宜蘭,2024-12-12,9686
6962,ITH-KY,25,0,25,富邦-宜蘭,2024-12-12,9686
2618,長榮航,31,6,25,富邦-宜蘭,2024-12-12,9686
1434,福懋,22,0,22,富邦-宜蘭,2024-12-12,9686
1303,南亞,28,7,21,富邦-宜蘭,2024-12-12,9686
3709,鑫聯大投控,20,0,20,富邦-宜蘭,2024-12-12,9686
4510,高鋒,27,7,20,富邦-宜蘭,2024-12-12,9686
4971,IET-KY,20,0,20,富邦-宜蘭,2024-12-12,9686
00919,群益台灣精選高息,45,27,18,富邦-宜蘭,2024-12-12,9686
00878,國泰永續高股息,58,41,17,富邦-宜蘭,2024-12-12,9686
9927,泰銘,16,0,16,富邦-宜蘭,2024-12-12,9686
8929,富堡,15,0,15,富邦-宜蘭,2024-12-12,9686
6163,華電網,15,0,15,富邦-宜蘭,2024-12-12,9686
6443,元晶,17,2,15,富邦-宜蘭,2024-12-12,9686
6274,台燿,29,15,14,富邦-宜蘭,2024-12-12,9686
00751B,元大AAA至A公司債,15,1,14,富邦-宜蘭,2024-12-12,9686
00688L,國泰20年美債正2,14,0,14,富邦-宜蘭,2024-12-12,9686
2615,萬海,20,7,13,富邦-宜蘭,2024-12-12,9686
1815,富喬,41,28,13,富邦-宜蘭,2024-12-12,9686
2641,正德,13,1,12,富邦-宜蘭,2024-12-12,9686
2388,威盛,14,3,11,富邦-宜蘭,2024-12-12,9686
3217,優群,15,4,11,富邦-宜蘭,2024-12-12,9686
9941,裕融,11,0,11,富邦-宜蘭,2024-12-12,9686
1517,利奇,11,0,11,富邦-宜蘭,2024-12-12,9686
00937B,群益ESG投等債20,11,0,11,富邦-宜蘭,2024-12-12,9686
5328,華容,19,9,10,富邦-宜蘭,2024-12-12,9686
2385,群光,10,0,10,富邦-宜蘭,2024-12-12,9686
2323,中環,10,0,10,富邦-宜蘭,2024-12-12,9686
00772B,中信高評級公司債,10,0,10,富邦-宜蘭,2024-12-12,9686
00680L,元大美債20正2,312,2,310,富邦-宜蘭,2024-12-13,9686
00919,群益台灣精選高息,168,8,160,富邦-宜蘭,2024-12-13,9686
00665L,富邦�琤肭磪囓�2,159,21,138,富邦-宜蘭,2024-12-13,9686
00918,大華優利高填息30,132,10,122,富邦-宜蘭,2024-12-13,9686
2883,凱基金,109,11,98,富邦-宜蘭,2024-12-13,9686
3706,神達,218,130,88,富邦-宜蘭,2024-12-13,9686
00637L,元大滬深300正2,89,2,87,富邦-宜蘭,2024-12-13,9686
2834,臺企銀,82,0,82,富邦-宜蘭,2024-12-13,9686
0056,元大高股息,76,0,76,富邦-宜蘭,2024-12-13,9686
3323,加百裕,118,50,68,富邦-宜蘭,2024-12-13,9686
00915,凱基優選高股息30,67,4,63,富邦-宜蘭,2024-12-13,9686
00878,國泰永續高股息,57,2,55,富邦-宜蘭,2024-12-13,9686
2317,鴻海,57,11,46,富邦-宜蘭,2024-12-13,9686
1303,南亞,44,0,44,富邦-宜蘭,2024-12-13,9686
2303,聯電,78,34,44,富邦-宜蘭,2024-12-13,9686
3231,緯創,52,10,42,富邦-宜蘭,2024-12-13,9686
00950B,凱基A級公司債,40,0,40,富邦-宜蘭,2024-12-13,9686
1301,台塑,48,8,40,富邦-宜蘭,2024-12-13,9686
3037,欣興,57,21,36,富邦-宜蘭,2024-12-13,9686
6558,興能高,92,59,33,富邦-宜蘭,2024-12-13,9686
1314,中石化,32,1,31,富邦-宜蘭,2024-12-13,9686
1434,福懋,30,0,30,富邦-宜蘭,2024-12-13,9686
00953B,群益優選非投等債,30,0,30,富邦-宜蘭,2024-12-13,9686
00679B,元大美債20年,30,2,28,富邦-宜蘭,2024-12-13,9686
00795B,中信美國公債20年,26,0,26,富邦-宜蘭,2024-12-13,9686
6288,聯嘉,25,0,25,富邦-宜蘭,2024-12-13,9686
00753L,中信中國50正2,58,33,25,富邦-宜蘭,2024-12-13,9686
00751B,元大AAA至A公司債,24,0,24,富邦-宜蘭,2024-12-13,9686
8042,金山電,31,7,24,富邦-宜蘭,2024-12-13,9686
00887,永豐中國科技50大,23,0,23,富邦-宜蘭,2024-12-13,9686
2356,英業達,28,6,22,富邦-宜蘭,2024-12-13,9686
3481,群創,26,4,22,富邦-宜蘭,2024-12-13,9686
6505,台塑化,25,3,22,富邦-宜蘭,2024-12-13,9686
00688L,國泰20年美債正2,21,0,21,富邦-宜蘭,2024-12-13,9686
00882,中信中國高股息,24,3,21,富邦-宜蘭,2024-12-13,9686
6120,達運,21,0,21,富邦-宜蘭,2024-12-13,9686
5701,劍湖山,20,0,20,富邦-宜蘭,2024-12-13,9686
3715,定穎投控,22,2,20,富邦-宜蘭,2024-12-13,9686
00940,元大台灣價值高息,60,41,19,富邦-宜蘭,2024-12-13,9686
00650L,復華香港正2,20,1,19,富邦-宜蘭,2024-12-13,9686
2002,中鋼,25,6,19,富邦-宜蘭,2024-12-13,9686
2353,宏��,25,8,17,富邦-宜蘭,2024-12-13,9686
00946,群益科技高息成長,17,0,17,富邦-宜蘭,2024-12-13,9686
00713,元大台灣高息低波,17,0,17,富邦-宜蘭,2024-12-13,9686
2634,漢翔,18,2,16,富邦-宜蘭,2024-12-13,9686
2890,永豐金,16,0,16,富邦-宜蘭,2024-12-13,9686
00933B,國泰10Y+金融債,16,0,16,富邦-宜蘭,2024-12-13,9686
9945,潤泰新,15,0,15,富邦-宜蘭,2024-12-13,9686
2867,三商壽,15,0,15,富邦-宜蘭,2024-12-13,9686
5871,中租-KY,15,0,15,富邦-宜蘭,2024-12-13,9686
00918,大華優利高填息30,226,1,225,富邦-宜蘭,2024-12-16,9686
00919,群益台灣精選高息,221,9,212,富邦-宜蘭,2024-12-16,9686
00940,元大台灣價值高息,138,9,129,富邦-宜蘭,2024-12-16,9686
00937B,群益ESG投等債20,88,6,82,富邦-宜蘭,2024-12-16,9686
0056,元大高股息,79,8,71,富邦-宜蘭,2024-12-16,9686
2609,陽明,118,51,67,富邦-宜蘭,2024-12-16,9686
00687B,國泰20年美債,59,2,57,富邦-宜蘭,2024-12-16,9686
00680L,元大美債20正2,66,17,49,富邦-宜蘭,2024-12-16,9686
00878,國泰永續高股息,54,12,42,富邦-宜蘭,2024-12-16,9686
1220,台榮,41,1,40,富邦-宜蘭,2024-12-16,9686
00671R,富邦NASDAQ反1,40,0,40,富邦-宜蘭,2024-12-16,9686
6885,全福生技,38,0,38,富邦-宜蘭,2024-12-16,9686
00688L,國泰20年美債正2,37,0,37,富邦-宜蘭,2024-12-16,9686
00900,富邦特選高股息30,36,0,36,富邦-宜蘭,2024-12-16,9686
00945B,凱基美國非投等債,36,0,36,富邦-宜蘭,2024-12-16,9686
00915,凱基優選高股息30,36,1,35,富邦-宜蘭,2024-12-16,9686
00887,永豐中國科技50大,35,1,34,富邦-宜蘭,2024-12-16,9686
3712,永崴投控,31,1,30,富邦-宜蘭,2024-12-16,9686
1815,富喬,57,28,29,富邦-宜蘭,2024-12-16,9686
2486,一詮,30,2,28,富邦-宜蘭,2024-12-16,9686
00953B,群益優選非投等債,25,0,25,富邦-宜蘭,2024-12-16,9686
6425,易發,26,1,25,富邦-宜蘭,2024-12-16,9686
9105,泰金寶-DR,34,11,23,富邦-宜蘭,2024-12-16,9686
3450,聯鈞,87,66,21,富邦-宜蘭,2024-12-16,9686
00665L,富邦�琤肭磪囓�2,121,100,21,富邦-宜蘭,2024-12-16,9686
8411,福貞-KY,21,0,21,富邦-宜蘭,2024-12-16,9686
00713,元大台灣高息低波,22,1,21,富邦-宜蘭,2024-12-16,9686
2601,益航,20,0,20,富邦-宜蘭,2024-12-16,9686
3323,加百裕,44,25,19,富邦-宜蘭,2024-12-16,9686
00753L,中信中國50正2,19,0,19,富邦-宜蘭,2024-12-16,9686
6596,寬宏藝術,19,0,19,富邦-宜蘭,2024-12-16,9686
1513,中興電,20,2,18,富邦-宜蘭,2024-12-16,9686
2354,鴻準,35,17,18,富邦-宜蘭,2024-12-16,9686
00795B,中信美國公債20年,18,0,18,富邦-宜蘭,2024-12-16,9686
2405,輔信,23,5,18,富邦-宜蘭,2024-12-16,9686
2867,三商壽,18,0,18,富邦-宜蘭,2024-12-16,9686
3013,晟銘電,23,5,18,富邦-宜蘭,2024-12-16,9686
00960,野村全球航運龍頭,20,3,17,富邦-宜蘭,2024-12-16,9686
6558,興能高,44,27,17,富邦-宜蘭,2024-12-16,9686
2368,金像電,44,28,16,富邦-宜蘭,2024-12-16,9686
00864B,中信美國公債0-1,16,0,16,富邦-宜蘭,2024-12-16,9686
6187,萬潤,18,3,15,富邦-宜蘭,2024-12-16,9686
6770,力積電,15,0,15,富邦-宜蘭,2024-12-16,9686
5009,榮剛,16,1,15,富邦-宜蘭,2024-12-16,9686
00946,群益科技高息成長,14,0,14,富邦-宜蘭,2024-12-16,9686
3037,欣興,24,11,13,富邦-宜蘭,2024-12-16,9686
9928,中視,13,0,13,富邦-宜蘭,2024-12-16,9686
00948B,中信優息投資級債,23,10,13,富邦-宜蘭,2024-12-16,9686
00712,復華富時不動產,12,0,12,富邦-宜蘭,2024-12-16,9686
00637L,元大滬深300正2,15,3,12,富邦-宜蘭,2024-12-16,9686
2897,王道銀行,220,0,220,富邦-宜蘭,2024-12-17,9686
0056,元大高股息,141,7,134,富邦-宜蘭,2024-12-17,9686
00918,大華優利高填息30,130,1,129,富邦-宜蘭,2024-12-17,9686
1718,中纖,120,0,120,富邦-宜蘭,2024-12-17,9686
1714,和桐,100,0,100,富邦-宜蘭,2024-12-17,9686
00959B,大華投等美債15Y+,100,0,100,富邦-宜蘭,2024-12-17,9686
2882,國泰金,100,0,100,富邦-宜蘭,2024-12-17,9686
2344,華邦電,97,6,91,富邦-宜蘭,2024-12-17,9686
00937B,群益ESG投等債20,78,6,72,富邦-宜蘭,2024-12-17,9686
2317,鴻海,81,17,64,富邦-宜蘭,2024-12-17,9686
00915,凱基優選高股息30,63,7,56,富邦-宜蘭,2024-12-17,9686
3481,群創,63,10,53,富邦-宜蘭,2024-12-17,9686
2883,凱基金,46,0,46,富邦-宜蘭,2024-12-17,9686
2515,中工,45,0,45,富邦-宜蘭,2024-12-17,9686
2399,映泰,40,1,39,富邦-宜蘭,2024-12-17,9686
00687B,國泰20年美債,38,0,38,富邦-宜蘭,2024-12-17,9686
2303,聯電,134,98,36,富邦-宜蘭,2024-12-17,9686
00713,元大台灣高息低波,44,8,36,富邦-宜蘭,2024-12-17,9686
8111,立��,43,10,33,富邦-宜蘭,2024-12-17,9686
1301,台塑,38,6,32,富邦-宜蘭,2024-12-17,9686
00673R,期元大S＆P原油反1,30,0,30,富邦-宜蘭,2024-12-17,9686
00671R,富邦NASDAQ反1,30,0,30,富邦-宜蘭,2024-12-17,9686
5907,大洋-KY,30,0,30,富邦-宜蘭,2024-12-17,9686
2449,京元電子,29,3,26,富邦-宜蘭,2024-12-17,9686
2002,中鋼,45,19,26,富邦-宜蘭,2024-12-17,9686
1314,中石化,26,0,26,富邦-宜蘭,2024-12-17,9686
2405,輔信,30,4,26,富邦-宜蘭,2024-12-17,9686
3013,晟銘電,80,55,25,富邦-宜蘭,2024-12-17,9686
2834,臺企銀,25,1,24,富邦-宜蘭,2024-12-17,9686
6885,全福生技,19,0,19,富邦-宜蘭,2024-12-17,9686
8249,菱光,92,73,19,富邦-宜蘭,2024-12-17,9686
2301,光寶科,19,2,17,富邦-宜蘭,2024-12-17,9686
2353,宏��,18,1,17,富邦-宜蘭,2024-12-17,9686
2607,榮運,19,2,17,富邦-宜蘭,2024-12-17,9686
2610,華航,33,17,16,富邦-宜蘭,2024-12-17,9686
5425,台半,16,0,16,富邦-宜蘭,2024-12-17,9686
2906,高林,16,0,16,富邦-宜蘭,2024-12-17,9686
6438,迅得,15,0,15,富邦-宜蘭,2024-12-17,9686
3447,展達,18,3,15,富邦-宜蘭,2024-12-17,9686
00909,國泰數位支付服務,31,16,15,富邦-宜蘭,2024-12-17,9686
6785,昱展新藥,15,0,15,富邦-宜蘭,2024-12-17,9686
4919,新唐,15,0,15,富邦-宜蘭,2024-12-17,9686
00947,台新臺灣IC設計,15,0,15,富邦-宜蘭,2024-12-17,9686
9904,寶成,15,1,14,富邦-宜蘭,2024-12-17,9686
2929,淘帝-KY,15,1,14,富邦-宜蘭,2024-12-17,9686
00924,復華S＆P500成長,14,0,14,富邦-宜蘭,2024-12-17,9686
00753L,中信中國50正2,14,0,14,富邦-宜蘭,2024-12-17,9686
6215,和椿,35,21,14,富邦-宜蘭,2024-12-17,9686
2409,友達,13,0,13,富邦-宜蘭,2024-12-17,9686
1722,台肥,13,0,13,富邦-宜蘭,2024-12-17,9686
2303,聯電,304,68,236,富邦-宜蘭,2024-12-18,9686
00918,大華優利高填息30,106,2,104,富邦-宜蘭,2024-12-18,9686
1447,力鵬,80,0,80,富邦-宜蘭,2024-12-18,9686
9105,泰金寶-DR,80,21,59,富邦-宜蘭,2024-12-18,9686
1314,中石化,52,0,52,富邦-宜蘭,2024-12-18,9686
8929,富堡,50,0,50,富邦-宜蘭,2024-12-18,9686
00712,復華富時不動產,36,0,36,富邦-宜蘭,2024-12-18,9686
5371,中光電,41,7,34,富邦-宜蘭,2024-12-18,9686
1316,上曜,31,0,31,富邦-宜蘭,2024-12-18,9686
00919,群益台灣精選高息,81,50,31,富邦-宜蘭,2024-12-18,9686
6271,同欣電,29,0,29,富邦-宜蘭,2024-12-18,9686
1451,年興,28,0,28,富邦-宜蘭,2024-12-18,9686
00850,元大臺灣ESG永續,26,0,26,富邦-宜蘭,2024-12-18,9686
5309,系統電,30,5,25,富邦-宜蘭,2024-12-18,9686
2344,華邦電,36,11,25,富邦-宜蘭,2024-12-18,9686
00937B,群益ESG投等債20,26,2,24,富邦-宜蘭,2024-12-18,9686
3231,緯創,25,2,23,富邦-宜蘭,2024-12-18,9686
3481,群創,32,10,22,富邦-宜蘭,2024-12-18,9686
1326,台化,33,11,22,富邦-宜蘭,2024-12-18,9686
6763,綠界科技*,23,1,22,富邦-宜蘭,2024-12-18,9686
3062,建漢,22,1,21,富邦-宜蘭,2024-12-18,9686
3709,鑫聯大投控,20,0,20,富邦-宜蘭,2024-12-18,9686
1305,華夏,21,2,19,富邦-宜蘭,2024-12-18,9686
2337,旺宏,20,1,19,富邦-宜蘭,2024-12-18,9686
2609,陽明,41,22,19,富邦-宜蘭,2024-12-18,9686
2408,南亞科,226,208,18,富邦-宜蘭,2024-12-18,9686
00687B,國泰20年美債,17,0,17,富邦-宜蘭,2024-12-18,9686
4979,華星光,27,10,17,富邦-宜蘭,2024-12-18,9686
2543,皇昌,18,1,17,富邦-宜蘭,2024-12-18,9686
3041,揚智,57,40,17,富邦-宜蘭,2024-12-18,9686
5328,華容,33,16,17,富邦-宜蘭,2024-12-18,9686
5392,能率,19,2,17,富邦-宜蘭,2024-12-18,9686
2615,萬海,22,6,16,富邦-宜蘭,2024-12-18,9686
1717,長興,16,0,16,富邦-宜蘭,2024-12-18,9686
00673R,期元大S＆P原油反1,15,0,15,富邦-宜蘭,2024-12-18,9686
2886,兆豐金,14,0,14,富邦-宜蘭,2024-12-18,9686
6214,精誠,14,0,14,富邦-宜蘭,2024-12-18,9686
6596,寬宏藝術,14,0,14,富邦-宜蘭,2024-12-18,9686
00960,野村全球航運龍頭,13,0,13,富邦-宜蘭,2024-12-18,9686
00631L,元大台灣50正2,13,0,13,富邦-宜蘭,2024-12-18,9686
2409,友達,12,0,12,富邦-宜蘭,2024-12-18,9686
6962,ITH-KY,21,9,12,富邦-宜蘭,2024-12-18,9686
3706,神達,152,141,11,富邦-宜蘭,2024-12-18,9686
00713,元大台灣高息低波,12,0,12,富邦-宜蘭,2024-12-18,9686
2607,榮運,12,1,11,富邦-宜蘭,2024-12-18,9686
00900,富邦特選高股息30,12,1,11,富邦-宜蘭,2024-12-18,9686
00679B,元大美債20年,11,0,11,富邦-宜蘭,2024-12-18,9686
6257,矽格,13,3,10,富邦-宜蘭,2024-12-18,9686
00922,國泰台灣領袖50,11,1,10,富邦-宜蘭,2024-12-18,9686
00959B,大華投等美債15Y+,10,0,10,富邦-宜蘭,2024-12-18,9686
3481,群創,327,7,320,富邦-宜蘭,2024-12-19,9686
00953B,群益優選非投等債,281,1,280,富邦-宜蘭,2024-12-19,9686
2303,聯電,183,24,159,富邦-宜蘭,2024-12-19,9686
00712,復華富時不動產,127,0,127,富邦-宜蘭,2024-12-19,9686
00918,大華優利高填息30,111,0,111,富邦-宜蘭,2024-12-19,9686
00919,群益台灣精選高息,121,27,94,富邦-宜蘭,2024-12-19,9686
2317,鴻海,81,5,76,富邦-宜蘭,2024-12-19,9686
00878,國泰永續高股息,70,1,69,富邦-宜蘭,2024-12-19,9686
3591,艾笛森,65,1,64,富邦-宜蘭,2024-12-19,9686
00687B,國泰20年美債,77,25,52,富邦-宜蘭,2024-12-19,9686
8070,長華*,51,0,51,富邦-宜蘭,2024-12-19,9686
3019,亞光,227,188,39,富邦-宜蘭,2024-12-19,9686
00688L,國泰20年美債正2,47,8,39,富邦-宜蘭,2024-12-19,9686
1314,中石化,38,1,37,富邦-宜蘭,2024-12-19,9686
00680L,元大美債20正2,34,0,34,富邦-宜蘭,2024-12-19,9686
4167,松瑞藥,31,0,31,富邦-宜蘭,2024-12-19,9686
00965,元大航太防衛科技,30,0,30,富邦-宜蘭,2024-12-19,9686
00753L,中信中國50正2,29,0,29,富邦-宜蘭,2024-12-19,9686
2882,國泰金,26,0,26,富邦-宜蘭,2024-12-19,9686
2887,台新金,26,0,26,富邦-宜蘭,2024-12-19,9686
2409,友達,25,0,25,富邦-宜蘭,2024-12-19,9686
2062,橋椿,26,3,23,富邦-宜蘭,2024-12-19,9686
00922,國泰台灣領袖50,24,1,23,富邦-宜蘭,2024-12-19,9686
1319,東陽,24,2,22,富邦-宜蘭,2024-12-19,9686
00900,富邦特選高股息30,21,0,21,富邦-宜蘭,2024-12-19,9686
3037,欣興,23,2,21,富邦-宜蘭,2024-12-19,9686
2609,陽明,43,23,20,富邦-宜蘭,2024-12-19,9686
3715,定穎投控,20,0,20,富邦-宜蘭,2024-12-19,9686
5871,中租-KY,21,1,20,富邦-宜蘭,2024-12-19,9686
8929,富堡,20,0,20,富邦-宜蘭,2024-12-19,9686
3706,神達,93,73,20,富邦-宜蘭,2024-12-19,9686
2441,超豐,20,0,20,富邦-宜蘭,2024-12-19,9686
2539,櫻花建,20,0,20,富邦-宜蘭,2024-12-19,9686
2344,華邦電,28,8,20,富邦-宜蘭,2024-12-19,9686
2881,富邦金,36,16,20,富邦-宜蘭,2024-12-19,9686
0056,元大高股息,20,1,19,富邦-宜蘭,2024-12-19,9686
6282,康舒,20,1,19,富邦-宜蘭,2024-12-19,9686
6215,和椿,35,17,18,富邦-宜蘭,2024-12-19,9686
1303,南亞,19,1,18,富邦-宜蘭,2024-12-19,9686
00960,野村全球航運龍頭,21,3,18,富邦-宜蘭,2024-12-19,9686
6116,彩晶,18,0,18,富邦-宜蘭,2024-12-19,9686
6770,力積電,32,15,17,富邦-宜蘭,2024-12-19,9686
5328,華容,27,10,17,富邦-宜蘭,2024-12-19,9686
4931,新盛力,187,170,17,富邦-宜蘭,2024-12-19,9686
2354,鴻準,22,5,17,富邦-宜蘭,2024-12-19,9686
2356,英業達,27,11,16,富邦-宜蘭,2024-12-19,9686
2101,南港,16,0,16,富邦-宜蘭,2024-12-19,9686
00915,凱基優選高股息30,16,0,16,富邦-宜蘭,2024-12-19,9686
2615,萬海,17,2,15,富邦-宜蘭,2024-12-19,9686
4563,百德,46,31,15,富邦-宜蘭,2024-12-19,9686
