Ticker,Name,buy,sell,diff,Branch,Date,Branch_Code
00632R,元大台灣50反1,543,43,500,富邦-嘉義,2023-01-03,9692
1513,中興電,837,727,110,富邦-嘉義,2023-01-03,9692
00679B,元大美債20年,105,0,105,富邦-嘉義,2023-01-03,9692
2399,映泰,283,207,76,富邦-嘉義,2023-01-03,9692
00878,國泰永續高股息,75,15,60,富邦-嘉義,2023-01-03,9692
2243,宏旭-KY,54,2,52,富邦-嘉義,2023-01-03,9692
6541,泰福-KY,50,0,50,富邦-嘉義,2023-01-03,9692
6806,森崴能源,204,162,42,富邦-嘉義,2023-01-03,9692
1605,華新,93,52,41,富邦-嘉義,2023-01-03,9692
6111,大宇資,67,27,40,富邦-嘉義,2023-01-03,9692
2380,虹光,35,0,35,富邦-嘉義,2023-01-03,9692
00773B,中信優先金融債,34,0,34,富邦-嘉義,2023-01-03,9692
8436,大江,50,20,30,富邦-嘉義,2023-01-03,9692
8996,高力,187,159,28,富邦-嘉義,2023-01-03,9692
2618,長榮航,82,55,27,富邦-嘉義,2023-01-03,9692
00733,富邦臺灣中小,24,0,24,富邦-嘉義,2023-01-03,9692
3162,精確,62,38,24,富邦-嘉義,2023-01-03,9692
00882,中信中國高股息,31,8,23,富邦-嘉義,2023-01-03,9692
1217,愛之味,20,0,20,富邦-嘉義,2023-01-03,9692
1795,美時,55,36,19,富邦-嘉義,2023-01-03,9692
3703,欣陸,17,0,17,富邦-嘉義,2023-01-03,9692
2498,宏達電,148,133,15,富邦-嘉義,2023-01-03,9692
4746,台耀,52,37,15,富邦-嘉義,2023-01-03,9692
2312,金寶,15,0,15,富邦-嘉義,2023-01-03,9692
00720B,元大投資級公司債,15,0,15,富邦-嘉義,2023-01-03,9692
1609,大亞,80,65,15,富邦-嘉義,2023-01-03,9692
1528,恩德,15,0,15,富邦-嘉義,2023-01-03,9692
3479,安勤,143,129,14,富邦-嘉義,2023-01-03,9692
2317,鴻海,1042,1029,13,富邦-嘉義,2023-01-03,9692
1529,樂事綠能,129,117,12,富邦-嘉義,2023-01-03,9692
2546,根基,12,0,12,富邦-嘉義,2023-01-03,9692
00662,富邦NASDAQ,19,7,12,富邦-嘉義,2023-01-03,9692
2515,中工,11,0,11,富邦-嘉義,2023-01-03,9692
3708,上緯投控,18,7,11,富邦-嘉義,2023-01-03,9692
00637L,元大滬深300正2,18,7,11,富邦-嘉義,2023-01-03,9692
2884,玉山金,11,0,11,富邦-嘉義,2023-01-03,9692
00713,元大台灣高息低波,10,0,10,富邦-嘉義,2023-01-03,9692
1752,南光,62,52,10,富邦-嘉義,2023-01-03,9692
2208,台船,10,0,10,富邦-嘉義,2023-01-03,9692
5009,榮剛,21,11,10,富邦-嘉義,2023-01-03,9692
1615,大山,10,0,10,富邦-嘉義,2023-01-03,9692
00725B,國泰投資級公司債,10,0,10,富邦-嘉義,2023-01-03,9692
1444,力麗,10,0,10,富邦-嘉義,2023-01-03,9692
6150,撼訊,182,172,10,富邦-嘉義,2023-01-03,9692
00888,永豐台灣ESG,10,0,10,富邦-嘉義,2023-01-03,9692
00772B,中信高評級公司債,10,0,10,富邦-嘉義,2023-01-03,9692
1540,喬福,10,0,10,富邦-嘉義,2023-01-03,9692
3454,晶睿,323,313,10,富邦-嘉義,2023-01-03,9692
6708,天擎,11,2,9,富邦-嘉義,2023-01-03,9692
2023,燁輝,70,61,9,富邦-嘉義,2023-01-03,9692
3704,合勤控,470,88,382,富邦-嘉義,2023-01-04,9692
1519,華城,1062,829,233,富邦-嘉義,2023-01-04,9692
00641R,富邦日本反1,199,0,199,富邦-嘉義,2023-01-04,9692
2419,仲琦,222,92,130,富邦-嘉義,2023-01-04,9692
8104,錸寶,133,23,110,富邦-嘉義,2023-01-04,9692
2344,華邦電,104,0,104,富邦-嘉義,2023-01-04,9692
1605,華新,538,454,84,富邦-嘉義,2023-01-04,9692
2610,華航,63,1,62,富邦-嘉義,2023-01-04,9692
00878,國泰永續高股息,46,0,46,富邦-嘉義,2023-01-04,9692
4961,天鈺,45,3,42,富邦-嘉義,2023-01-04,9692
1783,和康生,41,0,41,富邦-嘉義,2023-01-04,9692
1529,樂事綠能,744,704,40,富邦-嘉義,2023-01-04,9692
00902,中信電池及儲能,54,20,34,富邦-嘉義,2023-01-04,9692
6547,高端疫苗,32,1,31,富邦-嘉義,2023-01-04,9692
5425,台半,32,4,28,富邦-嘉義,2023-01-04,9692
3432,台端,25,0,25,富邦-嘉義,2023-01-04,9692
3705,永信,24,0,24,富邦-嘉義,2023-01-04,9692
3587,閎康,23,1,22,富邦-嘉義,2023-01-04,9692
8171,天宇,161,140,21,富邦-嘉義,2023-01-04,9692
6118,建達,322,301,21,富邦-嘉義,2023-01-04,9692
6180,橘子,23,2,21,富邦-嘉義,2023-01-04,9692
0056,元大高股息,20,0,20,富邦-嘉義,2023-01-04,9692
2392,正崴,20,0,20,富邦-嘉義,2023-01-04,9692
00701,國泰股利精選30,20,0,20,富邦-嘉義,2023-01-04,9692
9802,鈺齊-KY,23,3,20,富邦-嘉義,2023-01-04,9692
6533,晶心科,22,3,19,富邦-嘉義,2023-01-04,9692
5340,建榮,20,1,19,富邦-嘉義,2023-01-04,9692
2305,全友,18,0,18,富邦-嘉義,2023-01-04,9692
2884,玉山金,22,4,18,富邦-嘉義,2023-01-04,9692
1609,大亞,280,263,17,富邦-嘉義,2023-01-04,9692
4979,華星光,22,6,16,富邦-嘉義,2023-01-04,9692
6104,創惟,21,6,15,富邦-嘉義,2023-01-04,9692
2313,華通,17,3,14,富邦-嘉義,2023-01-04,9692
6274,台燿,28,14,14,富邦-嘉義,2023-01-04,9692
4171,瑞基,23,10,13,富邦-嘉義,2023-01-04,9692
8033,雷虎,42,30,12,富邦-嘉義,2023-01-04,9692
2603,長榮,627,615,12,富邦-嘉義,2023-01-04,9692
6209,今國光,15,3,12,富邦-嘉義,2023-01-04,9692
3231,緯創,11,0,11,富邦-嘉義,2023-01-04,9692
2023,燁輝,41,30,11,富邦-嘉義,2023-01-04,9692
00679B,元大美債20年,11,0,11,富邦-嘉義,2023-01-04,9692
2851,中再保,13,2,11,富邦-嘉義,2023-01-04,9692
6143,振曜,17,6,11,富邦-嘉義,2023-01-04,9692
2615,萬海,286,275,11,富邦-嘉義,2023-01-04,9692
0050,元大台灣50,11,0,11,富邦-嘉義,2023-01-04,9692
8046,南電,14,4,10,富邦-嘉義,2023-01-04,9692
3189,景碩,18,8,10,富邦-嘉義,2023-01-04,9692
2002,中鋼,21,11,10,富邦-嘉義,2023-01-04,9692
00725B,國泰投資級公司債,10,0,10,富邦-嘉義,2023-01-04,9692
6541,泰福-KY,10,0,10,富邦-嘉義,2023-01-04,9692
00715L,期街口布蘭特正2,116,2,114,富邦-嘉義,2023-01-05,9692
8033,雷虎,109,30,79,富邦-嘉義,2023-01-05,9692
3594,磐儀,70,0,70,富邦-嘉義,2023-01-05,9692
3272,東碩,111,52,59,富邦-嘉義,2023-01-05,9692
3162,精確,112,59,53,富邦-嘉義,2023-01-05,9692
00679B,元大美債20年,56,4,52,富邦-嘉義,2023-01-05,9692
9802,鈺齊-KY,51,0,51,富邦-嘉義,2023-01-05,9692
4763,材料-KY,60,15,45,富邦-嘉義,2023-01-05,9692
5905,南仁湖,66,22,44,富邦-嘉義,2023-01-05,9692
2608,嘉里大榮,83,53,30,富邦-嘉義,2023-01-05,9692
2609,陽明,47,18,29,富邦-嘉義,2023-01-05,9692
3481,群創,50,22,28,富邦-嘉義,2023-01-05,9692
00888,永豐台灣ESG,27,0,27,富邦-嘉義,2023-01-05,9692
6548,長科*,25,0,25,富邦-嘉義,2023-01-05,9692
6015,宏遠證,24,0,24,富邦-嘉義,2023-01-05,9692
3059,華晶科,24,0,24,富邦-嘉義,2023-01-05,9692
2344,華邦電,139,117,22,富邦-嘉義,2023-01-05,9692
2317,鴻海,39,17,22,富邦-嘉義,2023-01-05,9692
2313,華通,30,10,20,富邦-嘉義,2023-01-05,9692
9955,佳龍,21,1,20,富邦-嘉義,2023-01-05,9692
5469,瀚宇博,20,0,20,富邦-嘉義,2023-01-05,9692
6443,元晶,40,20,20,富邦-嘉義,2023-01-05,9692
2472,立隆電,19,0,19,富邦-嘉義,2023-01-05,9692
4171,瑞基,38,20,18,富邦-嘉義,2023-01-05,9692
00713,元大台灣高息低波,17,0,17,富邦-嘉義,2023-01-05,9692
2338,光罩,22,5,17,富邦-嘉義,2023-01-05,9692
00642U,期元大S＆P石油,16,0,16,富邦-嘉義,2023-01-05,9692
8069,元太,40,25,15,富邦-嘉義,2023-01-05,9692
4747,強生,25,10,15,富邦-嘉義,2023-01-05,9692
00650L,復華香港正2,15,0,15,富邦-嘉義,2023-01-05,9692
2929,淘帝-KY,14,0,14,富邦-嘉義,2023-01-05,9692
2546,根基,13,0,13,富邦-嘉義,2023-01-05,9692
1101,台泥,29,16,13,富邦-嘉義,2023-01-05,9692
1905,華紙,12,0,12,富邦-嘉義,2023-01-05,9692
2603,長榮,31,20,11,富邦-嘉義,2023-01-05,9692
00725B,國泰投資級公司債,11,0,11,富邦-嘉義,2023-01-05,9692
2444,兆勁,11,0,11,富邦-嘉義,2023-01-05,9692
2014,中鴻,17,6,11,富邦-嘉義,2023-01-05,9692
2101,南港,11,0,11,富邦-嘉義,2023-01-05,9692
5309,系統電,12,1,11,富邦-嘉義,2023-01-05,9692
00878,國泰永續高股息,31,20,11,富邦-嘉義,2023-01-05,9692
2851,中再保,12,2,10,富邦-嘉義,2023-01-05,9692
2615,萬海,15,5,10,富邦-嘉義,2023-01-05,9692
2363,矽統,11,1,10,富邦-嘉義,2023-01-05,9692
1447,力鵬,10,0,10,富邦-嘉義,2023-01-05,9692
1504,東元,16,6,10,富邦-嘉義,2023-01-05,9692
2457,飛宏,11,1,10,富邦-嘉義,2023-01-05,9692
00881,國泰台灣5G+,9,0,9,富邦-嘉義,2023-01-05,9692
3530,晶相光,10,1,9,富邦-嘉義,2023-01-05,9692
2440,太空梭,9,0,9,富邦-嘉義,2023-01-05,9692
2014,中鴻,512,4,508,富邦-嘉義,2023-01-06,9692
1605,華新,344,85,259,富邦-嘉義,2023-01-06,9692
00753L,中信中國50正2,250,3,247,富邦-嘉義,2023-01-06,9692
00632R,元大台灣50反1,280,165,115,富邦-嘉義,2023-01-06,9692
00720B,元大投資級公司債,74,0,74,富邦-嘉義,2023-01-06,9692
6196,帆宣,74,1,73,富邦-嘉義,2023-01-06,9692
1783,和康生,82,17,65,富邦-嘉義,2023-01-06,9692
5475,德宏,73,14,59,富邦-嘉義,2023-01-06,9692
3705,永信,32,0,32,富邦-嘉義,2023-01-06,9692
2308,台達電,34,3,31,富邦-嘉義,2023-01-06,9692
00900,富邦特選高股息30,32,1,31,富邦-嘉義,2023-01-06,9692
8044,網家,43,14,29,富邦-嘉義,2023-01-06,9692
4114,健喬,145,120,25,富邦-嘉義,2023-01-06,9692
00715L,期街口布蘭特正2,31,6,25,富邦-嘉義,2023-01-06,9692
4162,智擎,25,1,24,富邦-嘉義,2023-01-06,9692
1701,中化,67,43,24,富邦-嘉義,2023-01-06,9692
4763,材料-KY,38,16,22,富邦-嘉義,2023-01-06,9692
00637L,元大滬深300正2,201,180,21,富邦-嘉義,2023-01-06,9692
3479,安勤,29,8,21,富邦-嘉義,2023-01-06,9692
2892,第一金,22,2,20,富邦-嘉義,2023-01-06,9692
2201,裕隆,102,83,19,富邦-嘉義,2023-01-06,9692
00902,中信電池及儲能,20,2,18,富邦-嘉義,2023-01-06,9692
00679B,元大美債20年,17,0,17,富邦-嘉義,2023-01-06,9692
2027,大成鋼,15,0,15,富邦-嘉義,2023-01-06,9692
3027,盛達,15,2,13,富邦-嘉義,2023-01-06,9692
6118,建達,16,4,12,富邦-嘉義,2023-01-06,9692
1529,樂事綠能,56,44,12,富邦-嘉義,2023-01-06,9692
2444,兆勁,12,1,11,富邦-嘉義,2023-01-06,9692
2501,國建,11,0,11,富邦-嘉義,2023-01-06,9692
8358,金居,35,24,11,富邦-嘉義,2023-01-06,9692
1785,光洋科,11,1,10,富邦-嘉義,2023-01-06,9692
3162,精確,11,1,10,富邦-嘉義,2023-01-06,9692
00891,中信關鍵半導體,10,0,10,富邦-嘉義,2023-01-06,9692
2405,輔信,10,0,10,富邦-嘉義,2023-01-06,9692
3049,精金,10,0,10,富邦-嘉義,2023-01-06,9692
5608,四維航,10,0,10,富邦-嘉義,2023-01-06,9692
2884,玉山金,12,3,9,富邦-嘉義,2023-01-06,9692
2317,鴻海,13,4,9,富邦-嘉義,2023-01-06,9692
2354,鴻準,20,11,9,富邦-嘉義,2023-01-06,9692
8171,天宇,113,105,8,富邦-嘉義,2023-01-06,9692
4167,松瑞藥,191,183,8,富邦-嘉義,2023-01-06,9692
2495,普安,8,0,8,富邦-嘉義,2023-01-06,9692
1810,和成,8,0,8,富邦-嘉義,2023-01-06,9692
3141,晶宏,125,118,7,富邦-嘉義,2023-01-06,9692
3714,富采,7,0,7,富邦-嘉義,2023-01-06,9692
3686,達能,7,0,7,富邦-嘉義,2023-01-06,9692
8081,致新,7,0,7,富邦-嘉義,2023-01-06,9692
1611,中電,10,4,6,富邦-嘉義,2023-01-06,9692
1815,富喬,6,0,6,富邦-嘉義,2023-01-06,9692
1453,大將,6,0,6,富邦-嘉義,2023-01-06,9692
2883,凱基金,391,4,387,富邦-嘉義,2023-01-09,9692
00632R,元大台灣50反1,239,110,129,富邦-嘉義,2023-01-09,9692
6180,橘子,84,5,79,富邦-嘉義,2023-01-09,9692
2009,第一銅,125,50,75,富邦-嘉義,2023-01-09,9692
3479,安勤,92,20,72,富邦-嘉義,2023-01-09,9692
00902,中信電池及儲能,63,1,62,富邦-嘉義,2023-01-09,9692
3027,盛達,91,32,59,富邦-嘉義,2023-01-09,9692
2338,光罩,124,65,59,富邦-嘉義,2023-01-09,9692
2612,中航,51,0,51,富邦-嘉義,2023-01-09,9692
00679B,元大美債20年,45,1,44,富邦-嘉義,2023-01-09,9692
8171,天宇,51,10,41,富邦-嘉義,2023-01-09,9692
00715L,期街口布蘭特正2,41,0,41,富邦-嘉義,2023-01-09,9692
00637L,元大滬深300正2,235,203,32,富邦-嘉義,2023-01-09,9692
2328,廣宇,41,9,32,富邦-嘉義,2023-01-09,9692
3006,晶豪科,67,35,32,富邦-嘉義,2023-01-09,9692
2812,台中銀,32,2,30,富邦-嘉義,2023-01-09,9692
1101,台泥,41,13,28,富邦-嘉義,2023-01-09,9692
2313,華通,36,8,28,富邦-嘉義,2023-01-09,9692
1795,美時,154,127,27,富邦-嘉義,2023-01-09,9692
5258,虹堡,30,4,26,富邦-嘉義,2023-01-09,9692
8069,元太,274,250,24,富邦-嘉義,2023-01-09,9692
1708,東鹼,22,0,22,富邦-嘉義,2023-01-09,9692
2367,燿華,25,3,22,富邦-嘉義,2023-01-09,9692
00753L,中信中國50正2,21,0,21,富邦-嘉義,2023-01-09,9692
3380,明泰,21,0,21,富邦-嘉義,2023-01-09,9692
2457,飛宏,20,0,20,富邦-嘉義,2023-01-09,9692
00665L,富邦�琤肭磪囓�2,22,2,20,富邦-嘉義,2023-01-09,9692
00680L,元大美債20正2,20,0,20,富邦-嘉義,2023-01-09,9692
5388,中磊,21,2,19,富邦-嘉義,2023-01-09,9692
00892,富邦台灣半導體,21,5,16,富邦-嘉義,2023-01-09,9692
1417,嘉裕,15,0,15,富邦-嘉義,2023-01-09,9692
2539,櫻花建,15,0,15,富邦-嘉義,2023-01-09,9692
6770,力積電,298,286,12,富邦-嘉義,2023-01-09,9692
2451,創見,12,0,12,富邦-嘉義,2023-01-09,9692
1529,樂事綠能,13,1,12,富邦-嘉義,2023-01-09,9692
00720B,元大投資級公司債,12,0,12,富邦-嘉義,2023-01-09,9692
8044,網家,44,32,12,富邦-嘉義,2023-01-09,9692
0050,元大台灣50,18,7,11,富邦-嘉義,2023-01-09,9692
2886,兆豐金,17,5,12,富邦-嘉義,2023-01-09,9692
3531,先益,11,0,11,富邦-嘉義,2023-01-09,9692
3162,精確,21,10,11,富邦-嘉義,2023-01-09,9692
00885,富邦越南,20,9,11,富邦-嘉義,2023-01-09,9692
2390,云辰,10,0,10,富邦-嘉義,2023-01-09,9692
1783,和康生,21,11,10,富邦-嘉義,2023-01-09,9692
2392,正崴,10,0,10,富邦-嘉義,2023-01-09,9692
3466,德晉,10,0,10,富邦-嘉義,2023-01-09,9692
3501,維熹,10,0,10,富邦-嘉義,2023-01-09,9692
6533,晶心科,180,170,10,富邦-嘉義,2023-01-09,9692
3105,穩懋,197,187,10,富邦-嘉義,2023-01-09,9692
5905,南仁湖,9,0,9,富邦-嘉義,2023-01-09,9692
4979,華星光,234,83,151,富邦-嘉義,2023-01-10,9692
3704,合勤控,357,220,137,富邦-嘉義,2023-01-10,9692
00753L,中信中國50正2,151,20,131,富邦-嘉義,2023-01-10,9692
1701,中化,138,28,110,富邦-嘉義,2023-01-10,9692
2748,雲品,110,0,110,富邦-嘉義,2023-01-10,9692
00679B,元大美債20年,103,1,102,富邦-嘉義,2023-01-10,9692
1513,中興電,234,150,84,富邦-嘉義,2023-01-10,9692
00632R,元大台灣50反1,155,71,84,富邦-嘉義,2023-01-10,9692
4961,天鈺,115,51,64,富邦-嘉義,2023-01-10,9692
8171,天宇,103,40,63,富邦-嘉義,2023-01-10,9692
1519,華城,71,20,51,富邦-嘉義,2023-01-10,9692
2812,台中銀,51,5,46,富邦-嘉義,2023-01-10,9692
2618,長榮航,50,4,46,富邦-嘉義,2023-01-10,9692
00715L,期街口布蘭特正2,40,0,40,富邦-嘉義,2023-01-10,9692
6148,驊宏資,40,0,40,富邦-嘉義,2023-01-10,9692
4989,榮科,54,20,34,富邦-嘉義,2023-01-10,9692
2610,華航,50,21,29,富邦-嘉義,2023-01-10,9692
00902,中信電池及儲能,28,2,26,富邦-嘉義,2023-01-10,9692
3031,佰鴻,25,0,25,富邦-嘉義,2023-01-10,9692
6215,和椿,28,5,23,富邦-嘉義,2023-01-10,9692
00637L,元大滬深300正2,32,10,22,富邦-嘉義,2023-01-10,9692
00643,群益深証中小,20,0,20,富邦-嘉義,2023-01-10,9692
2313,華通,22,3,19,富邦-嘉義,2023-01-10,9692
00720B,元大投資級公司債,19,0,19,富邦-嘉義,2023-01-10,9692
1736,喬山,17,0,17,富邦-嘉義,2023-01-10,9692
2351,順德,17,1,16,富邦-嘉義,2023-01-10,9692
6505,台塑化,20,4,16,富邦-嘉義,2023-01-10,9692
4114,健喬,31,16,15,富邦-嘉義,2023-01-10,9692
00772B,中信高評級公司債,15,0,15,富邦-嘉義,2023-01-10,9692
2889,國票金,17,2,15,富邦-嘉義,2023-01-10,9692
00830,國泰費城半導體,20,6,14,富邦-嘉義,2023-01-10,9692
6133,金橋,13,0,13,富邦-嘉義,2023-01-10,9692
2615,萬海,16,3,13,富邦-嘉義,2023-01-10,9692
2393,億光,13,0,13,富邦-嘉義,2023-01-10,9692
3083,網龍,12,0,12,富邦-嘉義,2023-01-10,9692
5905,南仁湖,84,72,12,富邦-嘉義,2023-01-10,9692
3715,定穎投控,12,1,11,富邦-嘉義,2023-01-10,9692
3006,晶豪科,64,53,11,富邦-嘉義,2023-01-10,9692
1530,亞崴,10,0,10,富邦-嘉義,2023-01-10,9692
3669,圓展,10,0,10,富邦-嘉義,2023-01-10,9692
00911,兆豐洲際半導體,10,0,10,富邦-嘉義,2023-01-10,9692
6166,凌華,10,0,10,富邦-嘉義,2023-01-10,9692
6176,瑞儀,10,0,10,富邦-嘉義,2023-01-10,9692
6111,大宇資,10,0,10,富邦-嘉義,2023-01-10,9692
2472,立隆電,10,0,10,富邦-嘉義,2023-01-10,9692
8105,凌巨,15,6,9,富邦-嘉義,2023-01-10,9692
1326,台化,9,0,9,富邦-嘉義,2023-01-10,9692
2609,陽明,43,35,8,富邦-嘉義,2023-01-10,9692
006208,富邦台50,10,2,8,富邦-嘉義,2023-01-10,9692
2201,裕隆,87,79,8,富邦-嘉義,2023-01-10,9692
2014,中鴻,333,64,269,富邦-嘉義,2023-01-11,9692
00632R,元大台灣50反1,103,1,102,富邦-嘉義,2023-01-11,9692
5347,世界,84,9,75,富邦-嘉義,2023-01-11,9692
1529,樂事綠能,445,389,56,富邦-嘉義,2023-01-11,9692
9939,宏全,50,0,50,富邦-嘉義,2023-01-11,9692
2358,廷鑫,112,68,44,富邦-嘉義,2023-01-11,9692
2892,第一金,44,1,43,富邦-嘉義,2023-01-11,9692
6741,91APP*-KY,72,31,41,富邦-嘉義,2023-01-11,9692
4402,郡都開發,40,1,39,富邦-嘉義,2023-01-11,9692
2886,兆豐金,34,0,34,富邦-嘉義,2023-01-11,9692
1809,中釉,45,13,32,富邦-嘉義,2023-01-11,9692
4747,強生,45,14,31,富邦-嘉義,2023-01-11,9692
8358,金居,68,38,30,富邦-嘉義,2023-01-11,9692
00878,國泰永續高股息,33,6,27,富邦-嘉義,2023-01-11,9692
5905,南仁湖,22,0,22,富邦-嘉義,2023-01-11,9692
2313,華通,21,0,21,富邦-嘉義,2023-01-11,9692
1536,和大,20,0,20,富邦-嘉義,2023-01-11,9692
00852L,國泰美國道瓊正2,20,0,20,富邦-嘉義,2023-01-11,9692
2888,新光金,21,1,20,富邦-嘉義,2023-01-11,9692
1783,和康生,21,2,19,富邦-嘉義,2023-01-11,9692
6443,元晶,39,20,19,富邦-嘉義,2023-01-11,9692
00720B,元大投資級公司債,18,0,18,富邦-嘉義,2023-01-11,9692
2884,玉山金,17,0,17,富邦-嘉義,2023-01-11,9692
1560,中砂,20,3,17,富邦-嘉義,2023-01-11,9692
2915,潤泰全,16,0,16,富邦-嘉義,2023-01-11,9692
1701,中化,26,10,16,富邦-嘉義,2023-01-11,9692
00772B,中信高評級公司債,16,0,16,富邦-嘉義,2023-01-11,9692
3128,昇銳,16,0,16,富邦-嘉義,2023-01-11,9692
3027,盛達,32,16,16,富邦-嘉義,2023-01-11,9692
006208,富邦台50,15,1,14,富邦-嘉義,2023-01-11,9692
2457,飛宏,17,3,14,富邦-嘉義,2023-01-11,9692
00830,國泰費城半導體,30,16,14,富邦-嘉義,2023-01-11,9692
3322,建舜電,13,0,13,富邦-嘉義,2023-01-11,9692
3037,欣興,25,12,13,富邦-嘉義,2023-01-11,9692
1515,力山,12,0,12,富邦-嘉義,2023-01-11,9692
3162,精確,44,32,12,富邦-嘉義,2023-01-11,9692
5608,四維航,13,1,12,富邦-嘉義,2023-01-11,9692
8044,網家,244,233,11,富邦-嘉義,2023-01-11,9692
00679B,元大美債20年,11,0,11,富邦-嘉義,2023-01-11,9692
2302,麗正,11,0,11,富邦-嘉義,2023-01-11,9692
2377,微星,10,0,10,富邦-嘉義,2023-01-11,9692
1609,大亞,13,3,10,富邦-嘉義,2023-01-11,9692
2356,英業達,11,1,10,富邦-嘉義,2023-01-11,9692
00911,兆豐洲際半導體,10,0,10,富邦-嘉義,2023-01-11,9692
3207,耀勝,10,0,10,富邦-嘉義,2023-01-11,9692
5263,智崴,21,11,10,富邦-嘉義,2023-01-11,9692
00715L,期街口布蘭特正2,11,1,10,富邦-嘉義,2023-01-11,9692
2612,中航,10,0,10,富邦-嘉義,2023-01-11,9692
3419,譁裕,10,0,10,富邦-嘉義,2023-01-11,9692
6415,矽力*-KY,23,13,10,富邦-嘉義,2023-01-11,9692
2201,裕隆,164,6,158,富邦-嘉義,2023-01-12,9692
2023,燁輝,94,2,92,富邦-嘉義,2023-01-12,9692
00882,中信中國高股息,75,5,70,富邦-嘉義,2023-01-12,9692
00673R,期元大S＆P原油反1,69,0,69,富邦-嘉義,2023-01-12,9692
1312,國喬,65,1,64,富邦-嘉義,2023-01-12,9692
2845,遠東銀,60,5,55,富邦-嘉義,2023-01-12,9692
00680L,元大美債20正2,52,0,52,富邦-嘉義,2023-01-12,9692
1313,聯成,51,2,49,富邦-嘉義,2023-01-12,9692
2498,宏達電,128,87,41,富邦-嘉義,2023-01-12,9692
00770,國泰北美科技,39,0,39,富邦-嘉義,2023-01-12,9692
2610,華航,41,10,31,富邦-嘉義,2023-01-12,9692
9928,中視,31,0,31,富邦-嘉義,2023-01-12,9692
00878,國泰永續高股息,50,21,29,富邦-嘉義,2023-01-12,9692
6153,嘉聯益,33,4,29,富邦-嘉義,2023-01-12,9692
3037,欣興,32,8,24,富邦-嘉義,2023-01-12,9692
00896,中信綠能及電動車,22,0,22,富邦-嘉義,2023-01-12,9692
2609,陽明,45,25,20,富邦-嘉義,2023-01-12,9692
00901,永豐智能車供應鏈,20,0,20,富邦-嘉義,2023-01-12,9692
2317,鴻海,22,3,19,富邦-嘉義,2023-01-12,9692
4155,訊映,20,1,19,富邦-嘉義,2023-01-12,9692
4968,立積,25,6,19,富邦-嘉義,2023-01-12,9692
4128,中天,24,5,19,富邦-嘉義,2023-01-12,9692
2834,臺企銀,22,5,17,富邦-嘉義,2023-01-12,9692
8033,雷虎,16,0,16,富邦-嘉義,2023-01-12,9692
1718,中纖,15,0,15,富邦-嘉義,2023-01-12,9692
1519,華城,17,4,13,富邦-嘉義,2023-01-12,9692
1308,亞聚,16,3,13,富邦-嘉義,2023-01-12,9692
1304,台聚,19,6,13,富邦-嘉義,2023-01-12,9692
00713,元大台灣高息低波,13,0,13,富邦-嘉義,2023-01-12,9692
2440,太空梭,13,0,13,富邦-嘉義,2023-01-12,9692
1539,巨庭,12,0,12,富邦-嘉義,2023-01-12,9692
2816,旺旺保,12,0,12,富邦-嘉義,2023-01-12,9692
00895,富邦未來車,12,0,12,富邦-嘉義,2023-01-12,9692
4743,合一,22,11,11,富邦-嘉義,2023-01-12,9692
2637,慧洋-KY,11,0,11,富邦-嘉義,2023-01-12,9692
1513,中興電,26,15,11,富邦-嘉義,2023-01-12,9692
00905,FT臺灣Smart,11,0,11,富邦-嘉義,2023-01-12,9692
2614,東森,11,0,11,富邦-嘉義,2023-01-12,9692
6589,台康生技,12,1,11,富邦-嘉義,2023-01-12,9692
0056,元大高股息,12,1,11,富邦-嘉義,2023-01-12,9692
2612,中航,10,0,10,富邦-嘉義,2023-01-12,9692
4924,欣厚-KY,10,0,10,富邦-嘉義,2023-01-12,9692
2929,淘帝-KY,10,0,10,富邦-嘉義,2023-01-12,9692
2331,精英,10,0,10,富邦-嘉義,2023-01-12,9692
1702,南僑,10,0,10,富邦-嘉義,2023-01-12,9692
2618,長榮航,16,7,9,富邦-嘉義,2023-01-12,9692
2615,萬海,216,207,9,富邦-嘉義,2023-01-12,9692
00642U,期元大S＆P石油,13,4,9,富邦-嘉義,2023-01-12,9692
2820,華票,8,0,8,富邦-嘉義,2023-01-12,9692
2009,第一銅,555,547,8,富邦-嘉義,2023-01-12,9692
00679B,元大美債20年,175,0,175,富邦-嘉義,2023-01-13,9692
00676R,富邦臺灣加權反1,150,0,150,富邦-嘉義,2023-01-13,9692
1810,和成,101,0,101,富邦-嘉義,2023-01-13,9692
00632R,元大台灣50反1,199,104,95,富邦-嘉義,2023-01-13,9692
6770,力積電,79,8,71,富邦-嘉義,2023-01-13,9692
2618,長榮航,81,35,46,富邦-嘉義,2023-01-13,9692
4743,合一,67,25,42,富邦-嘉義,2023-01-13,9692
00893,國泰智能電動車,36,3,33,富邦-嘉義,2023-01-13,9692
2885,元大金,30,0,30,富邦-嘉義,2023-01-13,9692
2812,台中銀,26,0,26,富邦-嘉義,2023-01-13,9692
1752,南光,66,41,25,富邦-嘉義,2023-01-13,9692
6689,伊雲谷,27,2,25,富邦-嘉義,2023-01-13,9692
00895,富邦未來車,23,0,23,富邦-嘉義,2023-01-13,9692
2641,正德,29,7,22,富邦-嘉義,2023-01-13,9692
5469,瀚宇博,20,0,20,富邦-嘉義,2023-01-13,9692
2929,淘帝-KY,20,0,20,富邦-嘉義,2023-01-13,9692
4968,立積,16,0,16,富邦-嘉義,2023-01-13,9692
2327,國巨,15,0,15,富邦-嘉義,2023-01-13,9692
3189,景碩,19,5,14,富邦-嘉義,2023-01-13,9692
8050,廣積,17,3,14,富邦-嘉義,2023-01-13,9692
00673R,期元大S＆P原油反1,13,0,13,富邦-嘉義,2023-01-13,9692
2359,所羅門,15,2,13,富邦-嘉義,2023-01-13,9692
5321,美而快,31,19,12,富邦-嘉義,2023-01-13,9692
3550,聯穎,12,0,12,富邦-嘉義,2023-01-13,9692
2609,陽明,19,7,12,富邦-嘉義,2023-01-13,9692
2312,金寶,12,0,12,富邦-嘉義,2023-01-13,9692
2889,國票金,26,14,12,富邦-嘉義,2023-01-13,9692
4114,健喬,32,21,11,富邦-嘉義,2023-01-13,9692
4128,中天,12,1,11,富邦-嘉義,2023-01-13,9692
8105,凌巨,10,0,10,富邦-嘉義,2023-01-13,9692
1310,台苯,10,0,10,富邦-嘉義,2023-01-13,9692
1711,永光,10,0,10,富邦-嘉義,2023-01-13,9692
6245,立端,13,4,9,富邦-嘉義,2023-01-13,9692
8110,華東,10,1,9,富邦-嘉義,2023-01-13,9692
2468,華經,47,39,8,富邦-嘉義,2023-01-13,9692
8086,宏捷科,10,3,7,富邦-嘉義,2023-01-13,9692
3443,創意,7,0,7,富邦-嘉義,2023-01-13,9692
2328,廣宇,11,4,7,富邦-嘉義,2023-01-13,9692
8996,高力,8,1,7,富邦-嘉義,2023-01-13,9692
6122,擎邦,8,1,7,富邦-嘉義,2023-01-13,9692
00770,國泰北美科技,7,0,7,富邦-嘉義,2023-01-13,9692
6182,合晶,10,3,7,富邦-嘉義,2023-01-13,9692
1795,美時,10,4,6,富邦-嘉義,2023-01-13,9692
2484,希華,6,0,6,富邦-嘉義,2023-01-13,9692
00752,中信中國50,6,0,6,富邦-嘉義,2023-01-13,9692
3162,精確,24,18,6,富邦-嘉義,2023-01-13,9692
4974,亞泰,6,0,6,富邦-嘉義,2023-01-13,9692
00664R,國泰臺灣加權反1,6,0,6,富邦-嘉義,2023-01-13,9692
00643,群益深証中小,6,0,6,富邦-嘉義,2023-01-13,9692
6788,華景電,8,2,6,富邦-嘉義,2023-01-13,9692
00673R,期元大S＆P原油反1,436,0,436,富邦-嘉義,2023-01-16,9692
2201,裕隆,524,300,224,富邦-嘉義,2023-01-16,9692
00650L,復華香港正2,105,2,103,富邦-嘉義,2023-01-16,9692
00676R,富邦臺灣加權反1,100,0,100,富邦-嘉義,2023-01-16,9692
00632R,元大台灣50反1,102,26,76,富邦-嘉義,2023-01-16,9692
00679B,元大美債20年,161,100,61,富邦-嘉義,2023-01-16,9692
00893,國泰智能電動車,52,9,43,富邦-嘉義,2023-01-16,9692
2867,三商壽,42,0,42,富邦-嘉義,2023-01-16,9692
2358,廷鑫,32,3,29,富邦-嘉義,2023-01-16,9692
6547,高端疫苗,30,2,28,富邦-嘉義,2023-01-16,9692
1308,亞聚,26,0,26,富邦-嘉義,2023-01-16,9692
2812,台中銀,26,1,25,富邦-嘉義,2023-01-16,9692
2465,麗臺,80,55,25,富邦-嘉義,2023-01-16,9692
00878,國泰永續高股息,86,61,25,富邦-嘉義,2023-01-16,9692
5263,智崴,32,8,24,富邦-嘉義,2023-01-16,9692
00885,富邦越南,23,0,23,富邦-嘉義,2023-01-16,9692
6015,宏遠證,23,1,22,富邦-嘉義,2023-01-16,9692
2317,鴻海,22,2,20,富邦-嘉義,2023-01-16,9692
1795,美時,99,81,18,富邦-嘉義,2023-01-16,9692
00900,富邦特選高股息30,25,7,18,富邦-嘉義,2023-01-16,9692
2610,華航,23,6,17,富邦-嘉義,2023-01-16,9692
00772B,中信高評級公司債,12,0,12,富邦-嘉義,2023-01-16,9692
8933,愛地雅,15,3,12,富邦-嘉義,2023-01-16,9692
6150,撼訊,33,22,11,富邦-嘉義,2023-01-16,9692
8070,長華*,11,0,11,富邦-嘉義,2023-01-16,9692
2889,國票金,11,0,11,富邦-嘉義,2023-01-16,9692
00715L,期街口布蘭特正2,23,12,11,富邦-嘉義,2023-01-16,9692
1409,新纖,11,0,11,富邦-嘉義,2023-01-16,9692
4102,永日,10,0,10,富邦-嘉義,2023-01-16,9692
2351,順德,10,0,10,富邦-嘉義,2023-01-16,9692
3693,營邦,104,94,10,富邦-嘉義,2023-01-16,9692
6163,華電網,10,0,10,富邦-嘉義,2023-01-16,9692
3441,聯一光,11,1,10,富邦-嘉義,2023-01-16,9692
3675,德微,11,2,9,富邦-嘉義,2023-01-16,9692
6770,力積電,33,24,9,富邦-嘉義,2023-01-16,9692
1475,業旺,8,0,8,富邦-嘉義,2023-01-16,9692
3454,晶睿,22,14,8,富邦-嘉義,2023-01-16,9692
2359,所羅門,10,3,7,富邦-嘉義,2023-01-16,9692
1783,和康生,11,4,7,富邦-嘉義,2023-01-16,9692
2883,凱基金,9,2,7,富邦-嘉義,2023-01-16,9692
2338,光罩,65,58,7,富邦-嘉義,2023-01-16,9692
6443,元晶,16,9,7,富邦-嘉義,2023-01-16,9692
3715,定穎投控,7,1,6,富邦-嘉義,2023-01-16,9692
6285,啟��,8,2,6,富邦-嘉義,2023-01-16,9692
3550,聯穎,6,0,6,富邦-嘉義,2023-01-16,9692
1560,中砂,8,2,6,富邦-嘉義,2023-01-16,9692
00712,復華富時不動產,6,0,6,富邦-嘉義,2023-01-16,9692
3680,家登,8,2,6,富邦-嘉義,2023-01-16,9692
2444,兆勁,7,1,6,富邦-嘉義,2023-01-16,9692
2603,長榮,114,108,6,富邦-嘉義,2023-01-16,9692
00679B,元大美債20年,252,0,252,富邦-嘉義,2023-01-17,9692
2014,中鴻,229,22,207,富邦-嘉義,2023-01-17,9692
00680L,元大美債20正2,202,0,202,富邦-嘉義,2023-01-17,9692
00753L,中信中國50正2,154,0,154,富邦-嘉義,2023-01-17,9692
2367,燿華,103,3,100,富邦-嘉義,2023-01-17,9692
2303,聯電,214,119,95,富邦-嘉義,2023-01-17,9692
6612,奈米醫材,120,27,93,富邦-嘉義,2023-01-17,9692
00673R,期元大S＆P原油反1,82,0,82,富邦-嘉義,2023-01-17,9692
1101,台泥,88,8,80,富邦-嘉義,2023-01-17,9692
2201,裕隆,466,388,78,富邦-嘉義,2023-01-17,9692
1605,華新,104,41,63,富邦-嘉義,2023-01-17,9692
00676R,富邦臺灣加權反1,57,0,57,富邦-嘉義,2023-01-17,9692
5009,榮剛,50,1,49,富邦-嘉義,2023-01-17,9692
2884,玉山金,41,0,41,富邦-嘉義,2023-01-17,9692
1529,樂事綠能,138,108,30,富邦-嘉義,2023-01-17,9692
00885,富邦越南,28,0,28,富邦-嘉義,2023-01-17,9692
8033,雷虎,27,0,27,富邦-嘉義,2023-01-17,9692
8996,高力,258,232,26,富邦-嘉義,2023-01-17,9692
4747,強生,21,0,21,富邦-嘉義,2023-01-17,9692
2332,友訊,20,0,20,富邦-嘉義,2023-01-17,9692
00891,中信關鍵半導體,20,0,20,富邦-嘉義,2023-01-17,9692
2028,威致,27,9,18,富邦-嘉義,2023-01-17,9692
00772B,中信高評級公司債,17,0,17,富邦-嘉義,2023-01-17,9692
6609,瀧澤科,25,8,17,富邦-嘉義,2023-01-17,9692
1809,中釉,28,11,17,富邦-嘉義,2023-01-17,9692
1584,精剛,17,0,17,富邦-嘉義,2023-01-17,9692
3481,群創,20,4,16,富邦-嘉義,2023-01-17,9692
2913,農林,15,0,15,富邦-嘉義,2023-01-17,9692
00665L,富邦�琤肭磪囓�2,15,1,14,富邦-嘉義,2023-01-17,9692
1305,華夏,20,6,14,富邦-嘉義,2023-01-17,9692
1219,福壽,89,76,13,富邦-嘉義,2023-01-17,9692
2484,希華,12,0,12,富邦-嘉義,2023-01-17,9692
2608,嘉里大榮,13,2,11,富邦-嘉義,2023-01-17,9692
4746,台耀,30,19,11,富邦-嘉義,2023-01-17,9692
3576,聯合再生,20,10,10,富邦-嘉義,2023-01-17,9692
4171,瑞基,12,2,10,富邦-嘉義,2023-01-17,9692
8255,朋程,11,1,10,富邦-嘉義,2023-01-17,9692
00893,國泰智能電動車,10,0,10,富邦-嘉義,2023-01-17,9692
2351,順德,10,0,10,富邦-嘉義,2023-01-17,9692
6274,台燿,10,0,10,富邦-嘉義,2023-01-17,9692
00719B,元大美債1-3,10,0,10,富邦-嘉義,2023-01-17,9692
2371,大同,10,0,10,富邦-嘉義,2023-01-17,9692
8478,東哥遊艇,84,74,10,富邦-嘉義,2023-01-17,9692
0056,元大高股息,18,9,9,富邦-嘉義,2023-01-17,9692
2603,長榮,18,9,9,富邦-嘉義,2023-01-17,9692
4770,上品,12,3,9,富邦-嘉義,2023-01-17,9692
2637,慧洋-KY,10,1,9,富邦-嘉義,2023-01-17,9692
4968,立積,10,1,9,富邦-嘉義,2023-01-17,9692
00650L,復華香港正2,8,0,8,富邦-嘉義,2023-01-17,9692
00752,中信中國50,8,0,8,富邦-嘉義,2023-01-17,9692
00680L,元大美債20正2,703,0,703,富邦-嘉義,2023-01-30,9692
2201,裕隆,1378,872,506,富邦-嘉義,2023-01-30,9692
00632R,元大台灣50反1,476,0,476,富邦-嘉義,2023-01-30,9692
00753L,中信中國50正2,419,0,419,富邦-嘉義,2023-01-30,9692
2317,鴻海,117,3,114,富邦-嘉義,2023-01-30,9692
00676R,富邦臺灣加權反1,103,0,103,富邦-嘉義,2023-01-30,9692
3682,亞太電,100,30,70,富邦-嘉義,2023-01-30,9692
3675,德微,160,93,67,富邦-嘉義,2023-01-30,9692
1612,宏泰,119,58,61,富邦-嘉義,2023-01-30,9692
00878,國泰永續高股息,132,79,53,富邦-嘉義,2023-01-30,9692
2027,大成鋼,55,3,52,富邦-嘉義,2023-01-30,9692
4958,臻鼎-KY,50,1,49,富邦-嘉義,2023-01-30,9692
1513,中興電,122,74,48,富邦-嘉義,2023-01-30,9692
00673R,期元大S＆P原油反1,38,0,38,富邦-嘉義,2023-01-30,9692
2867,三商壽,36,0,36,富邦-嘉義,2023-01-30,9692
6443,元晶,60,29,31,富邦-嘉義,2023-01-30,9692
1809,中釉,34,4,30,富邦-嘉義,2023-01-30,9692
2324,仁寶,30,0,30,富邦-嘉義,2023-01-30,9692
6505,台塑化,30,1,29,富邦-嘉義,2023-01-30,9692
2338,光罩,90,65,25,富邦-嘉義,2023-01-30,9692
2023,燁輝,34,9,25,富邦-嘉義,2023-01-30,9692
6205,詮欣,25,1,24,富邦-嘉義,2023-01-30,9692
4961,天鈺,42,19,23,富邦-嘉義,2023-01-30,9692
00894,中信小資高價30,20,0,20,富邦-嘉義,2023-01-30,9692
2230,泰茂,52,32,20,富邦-嘉義,2023-01-30,9692
00633L,富邦上証正2,20,1,19,富邦-嘉義,2023-01-30,9692
1752,南光,18,1,17,富邦-嘉義,2023-01-30,9692
1528,恩德,17,0,17,富邦-嘉義,2023-01-30,9692
2367,燿華,20,3,17,富邦-嘉義,2023-01-30,9692
00637L,元大滬深300正2,55,40,15,富邦-嘉義,2023-01-30,9692
5340,建榮,15,1,14,富邦-嘉義,2023-01-30,9692
5258,虹堡,30,16,14,富邦-嘉義,2023-01-30,9692
2732,六角,14,0,14,富邦-嘉義,2023-01-30,9692
6150,撼訊,81,68,13,富邦-嘉義,2023-01-30,9692
2313,華通,57,44,13,富邦-嘉義,2023-01-30,9692
1312,國喬,20,8,12,富邦-嘉義,2023-01-30,9692
6245,立端,12,1,11,富邦-嘉義,2023-01-30,9692
00696B,富邦美債20年,11,0,11,富邦-嘉義,2023-01-30,9692
2482,連宇,266,256,10,富邦-嘉義,2023-01-30,9692
2912,統一超,10,0,10,富邦-嘉義,2023-01-30,9692
2457,飛宏,11,1,10,富邦-嘉義,2023-01-30,9692
1342,八貫,10,0,10,富邦-嘉義,2023-01-30,9692
00674R,期元大S＆P黃金反1,10,0,10,富邦-嘉義,2023-01-30,9692
2365,昆盈,10,0,10,富邦-嘉義,2023-01-30,9692
1714,和桐,10,0,10,富邦-嘉義,2023-01-30,9692
00858,永豐美國500大,10,0,10,富邦-嘉義,2023-01-30,9692
6541,泰福-KY,10,0,10,富邦-嘉義,2023-01-30,9692
1560,中砂,11,2,9,富邦-嘉義,2023-01-30,9692
00720B,元大投資級公司債,10,1,9,富邦-嘉義,2023-01-30,9692
2449,京元電子,16,7,9,富邦-嘉義,2023-01-30,9692
1605,華新,4567,1203,3364,富邦-嘉義,2023-01-31,9692
2009,第一銅,829,521,308,富邦-嘉義,2023-01-31,9692
2929,淘帝-KY,627,386,241,富邦-嘉義,2023-01-31,9692
00905,FT臺灣Smart,222,0,222,富邦-嘉義,2023-01-31,9692
6116,彩晶,210,70,140,富邦-嘉義,2023-01-31,9692
1443,立益物流,136,0,136,富邦-嘉義,2023-01-31,9692
8038,長園科,131,9,122,富邦-嘉義,2023-01-31,9692
8121,越峰,121,4,117,富邦-嘉義,2023-01-31,9692
00753L,中信中國50正2,110,0,110,富邦-嘉義,2023-01-31,9692
00665L,富邦�琤肭磪囓�2,104,0,104,富邦-嘉義,2023-01-31,9692
2444,兆勁,109,12,97,富邦-嘉義,2023-01-31,9692
3682,亞太電,85,0,85,富邦-嘉義,2023-01-31,9692
00680L,元大美債20正2,70,0,70,富邦-嘉義,2023-01-31,9692
00878,國泰永續高股息,103,34,69,富邦-嘉義,2023-01-31,9692
5258,虹堡,383,316,67,富邦-嘉義,2023-01-31,9692
3057,喬鼎,47,0,47,富邦-嘉義,2023-01-31,9692
2885,元大金,44,1,43,富邦-嘉義,2023-01-31,9692
00830,國泰費城半導體,40,0,40,富邦-嘉義,2023-01-31,9692
2892,第一金,59,20,39,富邦-嘉義,2023-01-31,9692
00885,富邦越南,38,0,38,富邦-嘉義,2023-01-31,9692
1101,台泥,38,1,37,富邦-嘉義,2023-01-31,9692
3454,晶睿,38,1,37,富邦-嘉義,2023-01-31,9692
4128,中天,283,246,37,富邦-嘉義,2023-01-31,9692
2023,燁輝,41,6,35,富邦-嘉義,2023-01-31,9692
4743,合一,149,114,35,富邦-嘉義,2023-01-31,9692
2317,鴻海,365,332,33,富邦-嘉義,2023-01-31,9692
8171,天宇,148,115,33,富邦-嘉義,2023-01-31,9692
2465,麗臺,52,23,29,富邦-嘉義,2023-01-31,9692
2834,臺企銀,34,6,28,富邦-嘉義,2023-01-31,9692
8044,網家,28,2,26,富邦-嘉義,2023-01-31,9692
4915,致伸,30,4,26,富邦-嘉義,2023-01-31,9692
2634,漢翔,25,0,25,富邦-嘉義,2023-01-31,9692
8996,高力,434,409,25,富邦-嘉義,2023-01-31,9692
2884,玉山金,25,2,23,富邦-嘉義,2023-01-31,9692
9907,統一實,21,1,20,富邦-嘉義,2023-01-31,9692
6541,泰福-KY,21,1,20,富邦-嘉義,2023-01-31,9692
3711,日月光投控,22,2,20,富邦-嘉義,2023-01-31,9692
2330,台積電,326,310,16,富邦-嘉義,2023-01-31,9692
1524,耿鼎,17,1,16,富邦-嘉義,2023-01-31,9692
2497,怡利電,16,0,16,富邦-嘉義,2023-01-31,9692
00633L,富邦上証正2,15,0,15,富邦-嘉義,2023-01-31,9692
5880,合庫金,15,1,14,富邦-嘉義,2023-01-31,9692
2324,仁寶,14,0,14,富邦-嘉義,2023-01-31,9692
00882,中信中國高股息,15,1,14,富邦-嘉義,2023-01-31,9692
00752,中信中國50,14,0,14,富邦-嘉義,2023-01-31,9692
2880,華南金,16,2,14,富邦-嘉義,2023-01-31,9692
00712,復華富時不動產,14,1,13,富邦-嘉義,2023-01-31,9692
1444,力麗,13,0,13,富邦-嘉義,2023-01-31,9692
00679B,元大美債20年,12,0,12,富邦-嘉義,2023-01-31,9692
6118,建達,45,33,12,富邦-嘉義,2023-01-31,9692
00753L,中信中國50正2,147,0,147,富邦-嘉義,2023-02-01,9692
00637L,元大滬深300正2,133,4,129,富邦-嘉義,2023-02-01,9692
2867,三商壽,90,0,90,富邦-嘉義,2023-02-01,9692
3481,群創,101,16,85,富邦-嘉義,2023-02-01,9692
8069,元太,91,27,64,富邦-嘉義,2023-02-01,9692
00633L,富邦上証正2,57,0,57,富邦-嘉義,2023-02-01,9692
6282,康舒,207,150,57,富邦-嘉義,2023-02-01,9692
1701,中化,61,9,52,富邦-嘉義,2023-02-01,9692
2027,大成鋼,57,10,47,富邦-嘉義,2023-02-01,9692
1584,精剛,346,302,44,富邦-嘉義,2023-02-01,9692
4968,立積,46,3,43,富邦-嘉義,2023-02-01,9692
2492,華新科,124,82,42,富邦-嘉義,2023-02-01,9692
1342,八貫,88,51,37,富邦-嘉義,2023-02-01,9692
2413,環科,35,1,34,富邦-嘉義,2023-02-01,9692
2634,漢翔,33,0,33,富邦-嘉義,2023-02-01,9692
2023,燁輝,34,3,31,富邦-嘉義,2023-02-01,9692
8150,南茂,30,3,27,富邦-嘉義,2023-02-01,9692
2305,全友,26,0,26,富邦-嘉義,2023-02-01,9692
6443,元晶,91,65,26,富邦-嘉義,2023-02-01,9692
5351,鈺創,44,20,24,富邦-嘉義,2023-02-01,9692
5299,杰力,21,0,21,富邦-嘉義,2023-02-01,9692
6115,鎰勝,21,0,21,富邦-嘉義,2023-02-01,9692
00905,FT臺灣Smart,20,0,20,富邦-嘉義,2023-02-01,9692
00673R,期元大S＆P原油反1,20,0,20,富邦-嘉義,2023-02-01,9692
6197,佳必琪,20,0,20,富邦-嘉義,2023-02-01,9692
2890,永豐金,19,1,18,富邦-嘉義,2023-02-01,9692
6788,華景電,42,24,18,富邦-嘉義,2023-02-01,9692
4977,眾達-KY,19,2,17,富邦-嘉義,2023-02-01,9692
00892,富邦台灣半導體,18,1,17,富邦-嘉義,2023-02-01,9692
1514,亞力,18,1,17,富邦-嘉義,2023-02-01,9692
2468,華經,175,159,16,富邦-嘉義,2023-02-01,9692
4123,晟德,16,0,16,富邦-嘉義,2023-02-01,9692
2883,凱基金,17,2,15,富邦-嘉義,2023-02-01,9692
2603,長榮,16,1,15,富邦-嘉義,2023-02-01,9692
00679B,元大美債20年,15,0,15,富邦-嘉義,2023-02-01,9692
1519,華城,29,15,14,富邦-嘉義,2023-02-01,9692
8091,翔名,16,2,14,富邦-嘉義,2023-02-01,9692
2834,臺企銀,15,2,13,富邦-嘉義,2023-02-01,9692
2889,國票金,13,0,13,富邦-嘉義,2023-02-01,9692
2364,倫飛,16,3,13,富邦-嘉義,2023-02-01,9692
2482,連宇,166,153,13,富邦-嘉義,2023-02-01,9692
9802,鈺齊-KY,12,0,12,富邦-嘉義,2023-02-01,9692
8033,雷虎,79,67,12,富邦-嘉義,2023-02-01,9692
2340,台亞,13,1,12,富邦-嘉義,2023-02-01,9692
8086,宏捷科,14,3,11,富邦-嘉義,2023-02-01,9692
00665L,富邦�琤肭磪囓�2,21,10,11,富邦-嘉義,2023-02-01,9692
3027,盛達,22,11,11,富邦-嘉義,2023-02-01,9692
3088,艾訊,11,0,11,富邦-嘉義,2023-02-01,9692
1529,樂事綠能,13,2,11,富邦-嘉義,2023-02-01,9692
3189,景碩,15,4,11,富邦-嘉義,2023-02-01,9692
2609,陽明,1506,515,991,富邦-嘉義,2023-02-02,9692
6418,詠昇,609,0,609,富邦-嘉義,2023-02-02,9692
2498,宏達電,869,564,305,富邦-嘉義,2023-02-02,9692
2482,連宇,557,254,303,富邦-嘉義,2023-02-02,9692
00632R,元大台灣50反1,238,22,216,富邦-嘉義,2023-02-02,9692
00885,富邦越南,155,2,153,富邦-嘉義,2023-02-02,9692
3454,晶睿,168,18,150,富邦-嘉義,2023-02-02,9692
2388,威盛,687,571,116,富邦-嘉義,2023-02-02,9692
6116,彩晶,105,3,102,富邦-嘉義,2023-02-02,9692
1313,聯成,101,0,101,富邦-嘉義,2023-02-02,9692
1522,堤維西,85,0,85,富邦-嘉義,2023-02-02,9692
3710,連展投控,70,2,68,富邦-嘉義,2023-02-02,9692
00878,國泰永續高股息,144,78,66,富邦-嘉義,2023-02-02,9692
3704,合勤控,93,29,64,富邦-嘉義,2023-02-02,9692
2230,泰茂,106,48,58,富邦-嘉義,2023-02-02,9692
6118,建達,77,19,58,富邦-嘉義,2023-02-02,9692
6411,晶焱,154,100,54,富邦-嘉義,2023-02-02,9692
00633L,富邦上証正2,47,0,47,富邦-嘉義,2023-02-02,9692
2618,長榮航,53,7,46,富邦-嘉義,2023-02-02,9692
3057,喬鼎,84,40,44,富邦-嘉義,2023-02-02,9692
00715L,期街口布蘭特正2,52,12,40,富邦-嘉義,2023-02-02,9692
00676R,富邦臺灣加權反1,39,0,39,富邦-嘉義,2023-02-02,9692
8038,長園科,40,3,37,富邦-嘉義,2023-02-02,9692
1810,和成,107,71,36,富邦-嘉義,2023-02-02,9692
00753L,中信中國50正2,33,0,33,富邦-嘉義,2023-02-02,9692
3508,位速,33,0,33,富邦-嘉義,2023-02-02,9692
4743,合一,33,4,29,富邦-嘉義,2023-02-02,9692
2406,國碩,30,1,29,富邦-嘉義,2023-02-02,9692
1528,恩德,28,0,28,富邦-嘉義,2023-02-02,9692
2610,華航,46,19,27,富邦-嘉義,2023-02-02,9692
4961,天鈺,48,21,27,富邦-嘉義,2023-02-02,9692
00882,中信中國高股息,27,1,26,富邦-嘉義,2023-02-02,9692
00706L,期元大S＆P日圓正2,50,25,25,富邦-嘉義,2023-02-02,9692
2328,廣宇,30,5,25,富邦-嘉義,2023-02-02,9692
2891,中信金,25,0,25,富邦-嘉義,2023-02-02,9692
2317,鴻海,51,28,23,富邦-嘉義,2023-02-02,9692
2369,菱生,45,22,23,富邦-嘉義,2023-02-02,9692
2399,映泰,24,4,20,富邦-嘉義,2023-02-02,9692
1513,中興電,244,224,20,富邦-嘉義,2023-02-02,9692
1101,台泥,25,5,20,富邦-嘉義,2023-02-02,9692
3693,營邦,23,4,19,富邦-嘉義,2023-02-02,9692
00679B,元大美債20年,19,0,19,富邦-嘉義,2023-02-02,9692
2867,三商壽,20,2,18,富邦-嘉義,2023-02-02,9692
2481,強茂,30,12,18,富邦-嘉義,2023-02-02,9692
2614,東森,17,0,17,富邦-嘉義,2023-02-02,9692
6129,普誠,37,20,17,富邦-嘉義,2023-02-02,9692
2888,新光金,19,2,17,富邦-嘉義,2023-02-02,9692
2455,全新,16,0,16,富邦-嘉義,2023-02-02,9692
00903,富邦元宇宙,18,2,16,富邦-嘉義,2023-02-02,9692
4744,皇將,16,0,16,富邦-嘉義,2023-02-02,9692
00680L,元大美債20正2,370,0,370,富邦-嘉義,2023-02-03,9692
00753L,中信中國50正2,336,20,316,富邦-嘉義,2023-02-03,9692
1584,精剛,557,385,172,富邦-嘉義,2023-02-03,9692
00878,國泰永續高股息,178,25,153,富邦-嘉義,2023-02-03,9692
00715L,期街口布蘭特正2,105,0,105,富邦-嘉義,2023-02-03,9692
3588,通嘉,86,17,69,富邦-嘉義,2023-02-03,9692
2489,瑞軒,67,0,67,富邦-嘉義,2023-02-03,9692
3704,合勤控,64,3,61,富邦-嘉義,2023-02-03,9692
00665L,富邦�琤肭磪囓�2,51,0,51,富邦-嘉義,2023-02-03,9692
2891,中信金,46,0,46,富邦-嘉義,2023-02-03,9692
8358,金居,48,12,36,富邦-嘉義,2023-02-03,9692
2834,臺企銀,37,4,33,富邦-嘉義,2023-02-03,9692
3189,景碩,36,4,32,富邦-嘉義,2023-02-03,9692
00882,中信中國高股息,31,0,31,富邦-嘉義,2023-02-03,9692
2317,鴻海,36,6,30,富邦-嘉義,2023-02-03,9692
2330,台積電,152,124,28,富邦-嘉義,2023-02-03,9692
3591,艾笛森,31,6,25,富邦-嘉義,2023-02-03,9692
2610,華航,25,3,22,富邦-嘉義,2023-02-03,9692
6188,廣明,20,0,20,富邦-嘉義,2023-02-03,9692
2801,彰銀,18,0,18,富邦-嘉義,2023-02-03,9692
00772B,中信高評級公司債,18,0,18,富邦-嘉義,2023-02-03,9692
6282,康舒,75,57,18,富邦-嘉義,2023-02-03,9692
4747,強生,42,25,17,富邦-嘉義,2023-02-03,9692
6770,力積電,23,6,17,富邦-嘉義,2023-02-03,9692
2002,中鋼,35,19,16,富邦-嘉義,2023-02-03,9692
2419,仲琦,16,0,16,富邦-嘉義,2023-02-03,9692
00632R,元大台灣50反1,37,21,16,富邦-嘉義,2023-02-03,9692
4743,合一,16,1,15,富邦-嘉義,2023-02-03,9692
2883,凱基金,19,4,15,富邦-嘉義,2023-02-03,9692
00902,中信電池及儲能,35,21,14,富邦-嘉義,2023-02-03,9692
2412,中華電,15,1,14,富邦-嘉義,2023-02-03,9692
2431,聯昌,14,0,14,富邦-嘉義,2023-02-03,9692
3162,精確,22,10,12,富邦-嘉義,2023-02-03,9692
2305,全友,12,0,12,富邦-嘉義,2023-02-03,9692
3236,千如,12,0,12,富邦-嘉義,2023-02-03,9692
2614,東森,22,11,11,富邦-嘉義,2023-02-03,9692
2014,中鴻,34,23,11,富邦-嘉義,2023-02-03,9692
2637,慧洋-KY,17,6,11,富邦-嘉義,2023-02-03,9692
2929,淘帝-KY,61,50,11,富邦-嘉義,2023-02-03,9692
00900,富邦特選高股息30,23,12,11,富邦-嘉義,2023-02-03,9692
5009,榮剛,11,1,10,富邦-嘉義,2023-02-03,9692
8046,南電,13,3,10,富邦-嘉義,2023-02-03,9692
00637L,元大滬深300正2,18,8,10,富邦-嘉義,2023-02-03,9692
9927,泰銘,10,0,10,富邦-嘉義,2023-02-03,9692
1528,恩德,10,0,10,富邦-嘉義,2023-02-03,9692
4207,環泰,10,0,10,富邦-嘉義,2023-02-03,9692
1310,台苯,10,0,10,富邦-嘉義,2023-02-03,9692
00640L,富邦日本正2,10,0,10,富邦-嘉義,2023-02-03,9692
8234,新漢,10,0,10,富邦-嘉義,2023-02-03,9692
1308,亞聚,11,1,10,富邦-嘉義,2023-02-03,9692
00632R,元大台灣50反1,346,4,342,富邦-嘉義,2023-02-06,9692
1524,耿鼎,322,33,289,富邦-嘉義,2023-02-06,9692
00878,國泰永續高股息,306,33,273,富邦-嘉義,2023-02-06,9692
00753L,中信中國50正2,191,0,191,富邦-嘉義,2023-02-06,9692
00715L,期街口布蘭特正2,141,0,141,富邦-嘉義,2023-02-06,9692
6282,康舒,412,276,136,富邦-嘉義,2023-02-06,9692
6443,元晶,185,61,124,富邦-嘉義,2023-02-06,9692
2201,裕隆,155,58,97,富邦-嘉義,2023-02-06,9692
00665L,富邦�琤肭磪囓�2,113,20,93,富邦-嘉義,2023-02-06,9692
00882,中信中國高股息,84,0,84,富邦-嘉義,2023-02-06,9692
00637L,元大滬深300正2,81,3,78,富邦-嘉義,2023-02-06,9692
00681R,元大美債20反1,50,0,50,富邦-嘉義,2023-02-06,9692
2328,廣宇,205,156,49,富邦-嘉義,2023-02-06,9692
0056,元大高股息,55,14,41,富邦-嘉義,2023-02-06,9692
2388,威盛,59,21,38,富邦-嘉義,2023-02-06,9692
3322,建舜電,41,4,37,富邦-嘉義,2023-02-06,9692
3189,景碩,45,10,35,富邦-嘉義,2023-02-06,9692
00662,富邦NASDAQ,35,2,33,富邦-嘉義,2023-02-06,9692
1809,中釉,34,1,33,富邦-嘉義,2023-02-06,9692
00885,富邦越南,32,0,32,富邦-嘉義,2023-02-06,9692
2412,中華電,32,0,32,富邦-嘉義,2023-02-06,9692
2892,第一金,31,0,31,富邦-嘉義,2023-02-06,9692
8996,高力,141,110,31,富邦-嘉義,2023-02-06,9692
5351,鈺創,39,8,31,富邦-嘉義,2023-02-06,9692
2603,長榮,200,172,28,富邦-嘉義,2023-02-06,9692
2441,超豐,28,0,28,富邦-嘉義,2023-02-06,9692
00720B,元大投資級公司債,27,0,27,富邦-嘉義,2023-02-06,9692
00642U,期元大S＆P石油,26,0,26,富邦-嘉義,2023-02-06,9692
1605,華新,189,163,26,富邦-嘉義,2023-02-06,9692
1795,美時,337,312,25,富邦-嘉義,2023-02-06,9692
2498,宏達電,851,827,24,富邦-嘉義,2023-02-06,9692
3693,營邦,32,11,21,富邦-嘉義,2023-02-06,9692
2002,中鋼,35,15,20,富邦-嘉義,2023-02-06,9692
2426,鼎元,20,0,20,富邦-嘉義,2023-02-06,9692
6441,廣錠,70,51,19,富邦-嘉義,2023-02-06,9692
2027,大成鋼,21,2,19,富邦-嘉義,2023-02-06,9692
2884,玉山金,25,8,17,富邦-嘉義,2023-02-06,9692
00706L,期元大S＆P日圓正2,17,0,17,富邦-嘉義,2023-02-06,9692
3037,欣興,40,24,16,富邦-嘉義,2023-02-06,9692
3454,晶睿,181,165,16,富邦-嘉義,2023-02-06,9692
2929,淘帝-KY,16,0,16,富邦-嘉義,2023-02-06,9692
00679B,元大美債20年,15,0,15,富邦-嘉義,2023-02-06,9692
6245,立端,15,0,15,富邦-嘉義,2023-02-06,9692
1513,中興電,25,10,15,富邦-嘉義,2023-02-06,9692
9802,鈺齊-KY,15,0,15,富邦-嘉義,2023-02-06,9692
4979,華星光,21,7,14,富邦-嘉義,2023-02-06,9692
00752,中信中國50,14,0,14,富邦-嘉義,2023-02-06,9692
4904,遠傳,16,2,14,富邦-嘉義,2023-02-06,9692
1432,大魯閣,20,6,14,富邦-嘉義,2023-02-06,9692
3027,盛達,13,0,13,富邦-嘉義,2023-02-06,9692
8069,元太,316,7,309,富邦-嘉義,2023-02-07,9692
2419,仲琦,314,37,277,富邦-嘉義,2023-02-07,9692
00715L,期街口布蘭特正2,225,6,219,富邦-嘉義,2023-02-07,9692
6116,彩晶,304,180,124,富邦-嘉義,2023-02-07,9692
3454,晶睿,234,116,118,富邦-嘉義,2023-02-07,9692
00878,國泰永續高股息,145,55,90,富邦-嘉義,2023-02-07,9692
6205,詮欣,83,0,83,富邦-嘉義,2023-02-07,9692
2364,倫飛,157,84,73,富邦-嘉義,2023-02-07,9692
2891,中信金,62,0,62,富邦-嘉義,2023-02-07,9692
2201,裕隆,174,114,60,富邦-嘉義,2023-02-07,9692
1313,聯成,53,0,53,富邦-嘉義,2023-02-07,9692
5258,虹堡,66,18,48,富邦-嘉義,2023-02-07,9692
6472,保瑞,172,132,40,富邦-嘉義,2023-02-07,9692
00680L,元大美債20正2,35,0,35,富邦-嘉義,2023-02-07,9692
2812,台中銀,35,0,35,富邦-嘉義,2023-02-07,9692
6788,華景電,35,1,34,富邦-嘉義,2023-02-07,9692
4743,合一,110,77,33,富邦-嘉義,2023-02-07,9692
2618,長榮航,38,6,32,富邦-嘉義,2023-02-07,9692
00637L,元大滬深300正2,102,70,32,富邦-嘉義,2023-02-07,9692
2412,中華電,31,0,31,富邦-嘉義,2023-02-07,9692
2867,三商壽,32,1,31,富邦-嘉義,2023-02-07,9692
8033,雷虎,40,10,30,富邦-嘉義,2023-02-07,9692
2884,玉山金,29,0,29,富邦-嘉義,2023-02-07,9692
00900,富邦特選高股息30,25,1,24,富邦-嘉義,2023-02-07,9692
00679B,元大美債20年,23,0,23,富邦-嘉義,2023-02-07,9692
4114,健喬,95,72,23,富邦-嘉義,2023-02-07,9692
3059,華晶科,24,2,22,富邦-嘉義,2023-02-07,9692
2892,第一金,20,0,20,富邦-嘉義,2023-02-07,9692
00902,中信電池及儲能,20,0,20,富邦-嘉義,2023-02-07,9692
2358,廷鑫,21,2,19,富邦-嘉義,2023-02-07,9692
3162,精確,57,38,19,富邦-嘉義,2023-02-07,9692
2324,仁寶,20,2,18,富邦-嘉義,2023-02-07,9692
2344,華邦電,24,6,18,富邦-嘉義,2023-02-07,9692
2852,第一保,22,5,17,富邦-嘉義,2023-02-07,9692
4128,中天,27,10,17,富邦-嘉義,2023-02-07,9692
3576,聯合再生,15,0,15,富邦-嘉義,2023-02-07,9692
8255,朋程,15,0,15,富邦-嘉義,2023-02-07,9692
00720B,元大投資級公司債,14,0,14,富邦-嘉義,2023-02-07,9692
00712,復華富時不動產,17,4,13,富邦-嘉義,2023-02-07,9692
2880,華南金,13,0,13,富邦-嘉義,2023-02-07,9692
2887,台新金,14,2,12,富邦-嘉義,2023-02-07,9692
2408,南亞科,12,0,12,富邦-嘉義,2023-02-07,9692
2889,國票金,12,0,12,富邦-嘉義,2023-02-07,9692
3006,晶豪科,21,10,11,富邦-嘉義,2023-02-07,9692
2402,毅嘉,11,0,11,富邦-嘉義,2023-02-07,9692
2382,廣達,13,2,11,富邦-嘉義,2023-02-07,9692
3362,先進光,78,67,11,富邦-嘉義,2023-02-07,9692
00692,富邦公司治理,11,1,10,富邦-嘉義,2023-02-07,9692
3221,台嘉碩,10,0,10,富邦-嘉義,2023-02-07,9692
2365,昆盈,10,0,10,富邦-嘉義,2023-02-07,9692
2883,凱基金,235,0,235,富邦-嘉義,2023-02-08,9692
2610,華航,218,10,208,富邦-嘉義,2023-02-08,9692
6552,易華電,196,1,195,富邦-嘉義,2023-02-08,9692
6215,和椿,186,10,176,富邦-嘉義,2023-02-08,9692
00878,國泰永續高股息,161,17,144,富邦-嘉義,2023-02-08,9692
00632R,元大台灣50反1,132,0,132,富邦-嘉義,2023-02-08,9692
00676R,富邦臺灣加權反1,108,0,108,富邦-嘉義,2023-02-08,9692
1795,美時,161,56,105,富邦-嘉義,2023-02-08,9692
00671R,富邦NASDAQ反1,80,0,80,富邦-嘉義,2023-02-08,9692
4743,合一,176,106,70,富邦-嘉義,2023-02-08,9692
2834,臺企銀,70,2,68,富邦-嘉義,2023-02-08,9692
5475,德宏,57,2,55,富邦-嘉義,2023-02-08,9692
00753L,中信中國50正2,54,0,54,富邦-嘉義,2023-02-08,9692
2498,宏達電,148,94,54,富邦-嘉義,2023-02-08,9692
00680L,元大美債20正2,51,0,51,富邦-嘉義,2023-02-08,9692
3027,盛達,55,11,44,富邦-嘉義,2023-02-08,9692
1529,樂事綠能,46,4,42,富邦-嘉義,2023-02-08,9692
00885,富邦越南,41,0,41,富邦-嘉義,2023-02-08,9692
2453,凌群,39,0,39,富邦-嘉義,2023-02-08,9692
00679B,元大美債20年,37,0,37,富邦-嘉義,2023-02-08,9692
6118,建達,61,28,33,富邦-嘉義,2023-02-08,9692
3710,連展投控,32,2,30,富邦-嘉義,2023-02-08,9692
6282,康舒,39,11,28,富邦-嘉義,2023-02-08,9692
2884,玉山金,27,2,25,富邦-嘉義,2023-02-08,9692
00772B,中信高評級公司債,25,1,24,富邦-嘉義,2023-02-08,9692
5465,富驊,24,0,24,富邦-嘉義,2023-02-08,9692
2542,興富發,25,1,24,富邦-嘉義,2023-02-08,9692
00665L,富邦�琤肭磪囓�2,23,0,23,富邦-嘉義,2023-02-08,9692
2888,新光金,23,0,23,富邦-嘉義,2023-02-08,9692
6719,力智,23,3,20,富邦-嘉義,2023-02-08,9692
4938,和碩,20,0,20,富邦-嘉義,2023-02-08,9692
1605,華新,36,17,19,富邦-嘉義,2023-02-08,9692
4128,中天,177,160,17,富邦-嘉義,2023-02-08,9692
1434,福懋,25,8,17,富邦-嘉義,2023-02-08,9692
2014,中鴻,41,24,17,富邦-嘉義,2023-02-08,9692
1720,生達,20,3,17,富邦-嘉義,2023-02-08,9692
8916,光隆,18,1,17,富邦-嘉義,2023-02-08,9692
2474,可成,22,6,16,富邦-嘉義,2023-02-08,9692
6548,長科*,16,0,16,富邦-嘉義,2023-02-08,9692
6547,高端疫苗,28,12,16,富邦-嘉義,2023-02-08,9692
5014,建錩,16,0,16,富邦-嘉義,2023-02-08,9692
6443,元晶,24,9,15,富邦-嘉義,2023-02-08,9692
2618,長榮航,36,21,15,富邦-嘉義,2023-02-08,9692
4114,健喬,155,140,15,富邦-嘉義,2023-02-08,9692
6153,嘉聯益,15,0,15,富邦-嘉義,2023-02-08,9692
3443,創意,79,64,15,富邦-嘉義,2023-02-08,9692
4721,美琪瑪,15,1,14,富邦-嘉義,2023-02-08,9692
8076,伍豐,14,0,14,富邦-嘉義,2023-02-08,9692
2892,第一金,14,0,14,富邦-嘉義,2023-02-08,9692
2886,兆豐金,14,0,14,富邦-嘉義,2023-02-08,9692
00878,國泰永續高股息,220,3,217,富邦-嘉義,2023-02-09,9692
2888,新光金,158,2,156,富邦-嘉義,2023-02-09,9692
4743,合一,146,21,125,富邦-嘉義,2023-02-09,9692
2371,大同,100,4,96,富邦-嘉義,2023-02-09,9692
8227,巨有科技,212,120,92,富邦-嘉義,2023-02-09,9692
00673R,期元大S＆P原油反1,82,0,82,富邦-嘉義,2023-02-09,9692
1810,和成,203,125,78,富邦-嘉義,2023-02-09,9692
3710,連展投控,86,23,63,富邦-嘉義,2023-02-09,9692
1519,華城,101,41,60,富邦-嘉義,2023-02-09,9692
1342,八貫,500,440,60,富邦-嘉義,2023-02-09,9692
2634,漢翔,117,61,56,富邦-嘉義,2023-02-09,9692
2883,凱基金,55,0,55,富邦-嘉義,2023-02-09,9692
00753L,中信中國50正2,55,0,55,富邦-嘉義,2023-02-09,9692
8436,大江,44,0,44,富邦-嘉義,2023-02-09,9692
00903,富邦元宇宙,42,0,42,富邦-嘉義,2023-02-09,9692
2468,華經,44,2,42,富邦-嘉義,2023-02-09,9692
2867,三商壽,140,100,40,富邦-嘉義,2023-02-09,9692
00671R,富邦NASDAQ反1,40,0,40,富邦-嘉義,2023-02-09,9692
00632R,元大台灣50反1,40,0,40,富邦-嘉義,2023-02-09,9692
8033,雷虎,87,47,40,富邦-嘉義,2023-02-09,9692
2498,宏達電,204,167,37,富邦-嘉義,2023-02-09,9692
2369,菱生,41,10,31,富邦-嘉義,2023-02-09,9692
00892,富邦台灣半導體,38,10,28,富邦-嘉義,2023-02-09,9692
3189,景碩,33,5,28,富邦-嘉義,2023-02-09,9692
4979,華星光,64,37,27,富邦-嘉義,2023-02-09,9692
6643,M31,81,54,27,富邦-嘉義,2023-02-09,9692
6541,泰福-KY,28,2,26,富邦-嘉義,2023-02-09,9692
5533,皇鼎,26,0,26,富邦-嘉義,2023-02-09,9692
3520,華盈,28,3,25,富邦-嘉義,2023-02-09,9692
5258,虹堡,99,74,25,富邦-嘉義,2023-02-09,9692
5465,富驊,24,0,24,富邦-嘉義,2023-02-09,9692
6689,伊雲谷,22,0,22,富邦-嘉義,2023-02-09,9692
3558,神準,33,11,22,富邦-嘉義,2023-02-09,9692
1101,台泥,34,12,22,富邦-嘉義,2023-02-09,9692
2330,台積電,129,108,21,富邦-嘉義,2023-02-09,9692
6111,大宇資,21,0,21,富邦-嘉義,2023-02-09,9692
1409,新纖,22,1,21,富邦-嘉義,2023-02-09,9692
3059,華晶科,23,2,21,富邦-嘉義,2023-02-09,9692
2425,承啟,28,10,18,富邦-嘉義,2023-02-09,9692
3128,昇銳,179,162,17,富邦-嘉義,2023-02-09,9692
6443,元晶,24,7,17,富邦-嘉義,2023-02-09,9692
2313,華通,21,5,16,富邦-嘉義,2023-02-09,9692
2236,百達-KY,48,32,16,富邦-嘉義,2023-02-09,9692
6770,力積電,36,20,16,富邦-嘉義,2023-02-09,9692
4130,健亞,266,250,16,富邦-嘉義,2023-02-09,9692
6235,華孚,304,288,16,富邦-嘉義,2023-02-09,9692
1609,大亞,40,25,15,富邦-嘉義,2023-02-09,9692
2027,大成鋼,14,0,14,富邦-嘉義,2023-02-09,9692
2359,所羅門,23,9,14,富邦-嘉義,2023-02-09,9692
8028,昇陽半導體,14,0,14,富邦-嘉義,2023-02-09,9692
00673R,期元大S＆P原油反1,320,5,315,富邦-嘉義,2023-02-10,9692
8033,雷虎,361,75,286,富邦-嘉義,2023-02-10,9692
00632R,元大台灣50反1,476,200,276,富邦-嘉義,2023-02-10,9692
3494,誠研,127,2,125,富邦-嘉義,2023-02-10,9692
00878,國泰永續高股息,133,11,122,富邦-嘉義,2023-02-10,9692
2201,裕隆,235,122,113,富邦-嘉義,2023-02-10,9692
0056,元大高股息,96,2,94,富邦-嘉義,2023-02-10,9692
6443,元晶,87,29,58,富邦-嘉義,2023-02-10,9692
2409,友達,62,7,55,富邦-嘉義,2023-02-10,9692
00753L,中信中國50正2,53,0,53,富邦-嘉義,2023-02-10,9692
5009,榮剛,61,8,53,富邦-嘉義,2023-02-10,9692
2101,南港,52,7,45,富邦-嘉義,2023-02-10,9692
2468,華經,286,243,43,富邦-嘉義,2023-02-10,9692
1101,台泥,48,6,42,富邦-嘉義,2023-02-10,9692
2883,凱基金,44,3,41,富邦-嘉義,2023-02-10,9692
8222,寶一,1175,1135,40,富邦-嘉義,2023-02-10,9692
3481,群創,76,39,37,富邦-嘉義,2023-02-10,9692
00893,國泰智能電動車,37,0,37,富邦-嘉義,2023-02-10,9692
00637L,元大滬深300正2,36,0,36,富邦-嘉義,2023-02-10,9692
2344,華邦電,34,0,34,富邦-嘉義,2023-02-10,9692
4744,皇將,36,2,34,富邦-嘉義,2023-02-10,9692
2867,三商壽,32,0,32,富邦-嘉義,2023-02-10,9692
1605,華新,47,16,31,富邦-嘉義,2023-02-10,9692
00892,富邦台灣半導體,30,0,30,富邦-嘉義,2023-02-10,9692
1312,國喬,30,0,30,富邦-嘉義,2023-02-10,9692
3710,連展投控,32,3,29,富邦-嘉義,2023-02-10,9692
6782,視陽,28,0,28,富邦-嘉義,2023-02-10,9692
3178,公準,28,0,28,富邦-嘉義,2023-02-10,9692
6266,泰詠,219,192,27,富邦-嘉義,2023-02-10,9692
3501,維熹,26,0,26,富邦-嘉義,2023-02-10,9692
3162,精確,54,29,25,富邦-嘉義,2023-02-10,9692
6770,力積電,27,2,25,富邦-嘉義,2023-02-10,9692
5309,系統電,25,1,24,富邦-嘉義,2023-02-10,9692
00712,復華富時不動產,26,2,24,富邦-嘉義,2023-02-10,9692
00772B,中信高評級公司債,23,0,23,富邦-嘉義,2023-02-10,9692
2609,陽明,32,9,23,富邦-嘉義,2023-02-10,9692
3037,欣興,34,12,22,富邦-嘉義,2023-02-10,9692
8072,陞泰,29,7,22,富邦-嘉義,2023-02-10,9692
00720B,元大投資級公司債,22,0,22,富邦-嘉義,2023-02-10,9692
2618,長榮航,22,3,19,富邦-嘉義,2023-02-10,9692
6245,立端,21,2,19,富邦-嘉義,2023-02-10,9692
00903,富邦元宇宙,18,0,18,富邦-嘉義,2023-02-10,9692
3090,日電貿,18,0,18,富邦-嘉義,2023-02-10,9692
6703,軒郁,17,0,17,富邦-嘉義,2023-02-10,9692
2312,金寶,17,0,17,富邦-嘉義,2023-02-10,9692
2368,金像電,17,1,16,富邦-嘉義,2023-02-10,9692
4977,眾達-KY,70,54,16,富邦-嘉義,2023-02-10,9692
2427,三商電,16,0,16,富邦-嘉義,2023-02-10,9692
2845,遠東銀,16,0,16,富邦-嘉義,2023-02-10,9692
2890,永豐金,17,1,16,富邦-嘉義,2023-02-10,9692
00878,國泰永續高股息,284,15,269,富邦-嘉義,2023-02-13,9692
8996,高力,684,488,196,富邦-嘉義,2023-02-13,9692
2889,國票金,161,14,147,富邦-嘉義,2023-02-13,9692
00673R,期元大S＆P原油反1,115,0,115,富邦-嘉義,2023-02-13,9692
00680L,元大美債20正2,105,0,105,富邦-嘉義,2023-02-13,9692
6235,華孚,107,25,82,富邦-嘉義,2023-02-13,9692
2634,漢翔,112,32,80,富邦-嘉義,2023-02-13,9692
3029,零壹,106,56,50,富邦-嘉義,2023-02-13,9692
6770,力積電,52,4,48,富邦-嘉義,2023-02-13,9692
2453,凌群,599,551,48,富邦-嘉義,2023-02-13,9692
2409,友達,50,3,47,富邦-嘉義,2023-02-13,9692
2489,瑞軒,44,1,43,富邦-嘉義,2023-02-13,9692
1568,倉佑,41,0,41,富邦-嘉義,2023-02-13,9692
2388,威盛,54,14,40,富邦-嘉義,2023-02-13,9692
00679B,元大美債20年,39,0,39,富邦-嘉義,2023-02-13,9692
3037,欣興,41,2,39,富邦-嘉義,2023-02-13,9692
5309,系統電,39,0,39,富邦-嘉義,2023-02-13,9692
6282,康舒,63,24,39,富邦-嘉義,2023-02-13,9692
3710,連展投控,35,0,35,富邦-嘉義,2023-02-13,9692
5533,皇鼎,35,0,35,富邦-嘉義,2023-02-13,9692
1701,中化,374,339,35,富邦-嘉義,2023-02-13,9692
1102,亞泥,37,3,34,富邦-嘉義,2023-02-13,9692
00893,國泰智能電動車,47,15,32,富邦-嘉義,2023-02-13,9692
2314,台揚,36,4,32,富邦-嘉義,2023-02-13,9692
4744,皇將,33,3,30,富邦-嘉義,2023-02-13,9692
1591,駿吉-KY,28,0,28,富邦-嘉義,2023-02-13,9692
1342,八貫,64,37,27,富邦-嘉義,2023-02-13,9692
00900,富邦特選高股息30,27,1,26,富邦-嘉義,2023-02-13,9692
2102,泰豐,26,0,26,富邦-嘉義,2023-02-13,9692
4114,健喬,153,127,26,富邦-嘉義,2023-02-13,9692
2303,聯電,54,30,24,富邦-嘉義,2023-02-13,9692
6796,晉弘,24,1,23,富邦-嘉義,2023-02-13,9692
8222,寶一,396,374,22,富邦-嘉義,2023-02-13,9692
00720B,元大投資級公司債,26,5,21,富邦-嘉義,2023-02-13,9692
2884,玉山金,28,8,20,富邦-嘉義,2023-02-13,9692
3624,光頡,28,8,20,富邦-嘉義,2023-02-13,9692
2332,友訊,37,17,20,富邦-嘉義,2023-02-13,9692
1417,嘉裕,20,0,20,富邦-嘉義,2023-02-13,9692
3189,景碩,23,3,20,富邦-嘉義,2023-02-13,9692
00892,富邦台灣半導體,24,5,19,富邦-嘉義,2023-02-13,9692
2495,普安,24,5,19,富邦-嘉義,2023-02-13,9692
3501,維熹,19,0,19,富邦-嘉義,2023-02-13,9692
3027,盛達,19,0,19,富邦-嘉義,2023-02-13,9692
4503,金雨,67,48,19,富邦-嘉義,2023-02-13,9692
2002,中鋼,31,13,18,富邦-嘉義,2023-02-13,9692
0056,元大高股息,26,9,17,富邦-嘉義,2023-02-13,9692
6741,91APP*-KY,16,0,16,富邦-嘉義,2023-02-13,9692
00921,兆豐龍頭等權重,15,0,15,富邦-嘉義,2023-02-13,9692
1506,正道,15,0,15,富邦-嘉義,2023-02-13,9692
2344,華邦電,22,7,15,富邦-嘉義,2023-02-13,9692
00673R,期元大S＆P原油反1,227,0,227,富邦-嘉義,2023-02-14,9692
00878,國泰永續高股息,174,30,144,富邦-嘉義,2023-02-14,9692
00671R,富邦NASDAQ反1,106,0,106,富邦-嘉義,2023-02-14,9692
6603,富強鑫,84,3,81,富邦-嘉義,2023-02-14,9692
1701,中化,103,23,80,富邦-嘉義,2023-02-14,9692
2884,玉山金,69,4,65,富邦-嘉義,2023-02-14,9692
3540,曜越,50,0,50,富邦-嘉義,2023-02-14,9692
2834,臺企銀,70,23,47,富邦-嘉義,2023-02-14,9692
1101,台泥,67,30,37,富邦-嘉義,2023-02-14,9692
3207,耀勝,33,0,33,富邦-嘉義,2023-02-14,9692
2009,第一銅,125,93,32,富邦-嘉義,2023-02-14,9692
2317,鴻海,41,9,32,富邦-嘉義,2023-02-14,9692
3481,群創,53,24,29,富邦-嘉義,2023-02-14,9692
3438,類比科,32,3,29,富邦-嘉義,2023-02-14,9692
2609,陽明,29,3,26,富邦-嘉義,2023-02-14,9692
2482,連宇,134,109,25,富邦-嘉義,2023-02-14,9692
2885,元大金,29,6,23,富邦-嘉義,2023-02-14,9692
2754,亞洲藏壽司,64,42,22,富邦-嘉義,2023-02-14,9692
2208,台船,21,0,21,富邦-嘉義,2023-02-14,9692
8940,新天地,21,0,21,富邦-嘉義,2023-02-14,9692
5706,鳳凰,61,42,19,富邦-嘉義,2023-02-14,9692
1514,亞力,18,0,18,富邦-嘉義,2023-02-14,9692
4979,華星光,193,175,18,富邦-嘉義,2023-02-14,9692
6290,良維,90,72,18,富邦-嘉義,2023-02-14,9692
00637L,元大滬深300正2,18,1,17,富邦-嘉義,2023-02-14,9692
2330,台積電,428,412,16,富邦-嘉義,2023-02-14,9692
2634,漢翔,18,2,16,富邦-嘉義,2023-02-14,9692
5315,光聯,15,0,15,富邦-嘉義,2023-02-14,9692
9904,寶成,18,4,14,富邦-嘉義,2023-02-14,9692
1432,大魯閣,24,10,14,富邦-嘉義,2023-02-14,9692
2484,希華,13,1,12,富邦-嘉義,2023-02-14,9692
3189,景碩,16,5,11,富邦-嘉義,2023-02-14,9692
8429,金麗-KY,11,0,11,富邦-嘉義,2023-02-14,9692
4133,亞諾法,12,1,11,富邦-嘉義,2023-02-14,9692
2027,大成鋼,12,2,10,富邦-嘉義,2023-02-14,9692
5258,虹堡,12,2,10,富邦-嘉義,2023-02-14,9692
6441,廣錠,10,0,10,富邦-嘉義,2023-02-14,9692
00773B,中信優先金融債,10,0,10,富邦-嘉義,2023-02-14,9692
2495,普安,10,0,10,富邦-嘉義,2023-02-14,9692
4102,永日,10,1,9,富邦-嘉義,2023-02-14,9692
2748,雲品,40,31,9,富邦-嘉義,2023-02-14,9692
3162,精確,24,15,9,富邦-嘉義,2023-02-14,9692
00676R,富邦臺灣加權反1,21,12,9,富邦-嘉義,2023-02-14,9692
8436,大江,10,1,9,富邦-嘉義,2023-02-14,9692
1605,華新,1067,1058,9,富邦-嘉義,2023-02-14,9692
6112,邁達特,75,66,9,富邦-嘉義,2023-02-14,9692
1513,中興電,28,20,8,富邦-嘉義,2023-02-14,9692
3675,德微,26,18,8,富邦-嘉義,2023-02-14,9692
00665L,富邦�琤肭磪囓�2,8,0,8,富邦-嘉義,2023-02-14,9692
00720B,元大投資級公司債,8,0,8,富邦-嘉義,2023-02-14,9692
00878,國泰永續高股息,459,32,427,富邦-嘉義,2023-02-15,9692
4804,大略-KY,306,0,306,富邦-嘉義,2023-02-15,9692
2327,國巨,262,51,211,富邦-嘉義,2023-02-15,9692
00673R,期元大S＆P原油反1,206,20,186,富邦-嘉義,2023-02-15,9692
3406,玉晶光,184,39,145,富邦-嘉義,2023-02-15,9692
00753L,中信中國50正2,131,0,131,富邦-嘉義,2023-02-15,9692
2312,金寶,100,0,100,富邦-嘉義,2023-02-15,9692
3564,其陽,72,0,72,富邦-嘉義,2023-02-15,9692
1701,中化,54,2,52,富邦-嘉義,2023-02-15,9692
00892,富邦台灣半導體,48,3,45,富邦-嘉義,2023-02-15,9692
6266,泰詠,51,11,40,富邦-嘉義,2023-02-15,9692
00900,富邦特選高股息30,35,0,35,富邦-嘉義,2023-02-15,9692
2851,中再保,37,2,35,富邦-嘉義,2023-02-15,9692
2618,長榮航,33,3,30,富邦-嘉義,2023-02-15,9692
1101,台泥,35,5,30,富邦-嘉義,2023-02-15,9692
1795,美時,38,9,29,富邦-嘉義,2023-02-15,9692
2425,承啟,31,3,28,富邦-嘉義,2023-02-15,9692
4155,訊映,28,2,26,富邦-嘉義,2023-02-15,9692
3675,德微,200,175,25,富邦-嘉義,2023-02-15,9692
8234,新漢,33,8,25,富邦-嘉義,2023-02-15,9692
2731,雄獅,239,214,25,富邦-嘉義,2023-02-15,9692
00905,FT臺灣Smart,24,0,24,富邦-嘉義,2023-02-15,9692
8183,精星,43,19,24,富邦-嘉義,2023-02-15,9692
2883,凱基金,39,17,22,富邦-嘉義,2023-02-15,9692
8033,雷虎,45,23,22,富邦-嘉義,2023-02-15,9692
2498,宏達電,56,35,21,富邦-嘉義,2023-02-15,9692
2032,新鋼,21,0,21,富邦-嘉義,2023-02-15,9692
2884,玉山金,27,7,20,富邦-嘉義,2023-02-15,9692
6443,元晶,25,5,20,富邦-嘉義,2023-02-15,9692
00692,富邦公司治理,22,3,19,富邦-嘉義,2023-02-15,9692
6541,泰福-KY,18,0,18,富邦-嘉義,2023-02-15,9692
2834,臺企銀,41,24,17,富邦-嘉義,2023-02-15,9692
6874,倍力,17,0,17,富邦-嘉義,2023-02-15,9692
2102,泰豐,16,0,16,富邦-嘉義,2023-02-15,9692
00713,元大台灣高息低波,15,0,15,富邦-嘉義,2023-02-15,9692
0056,元大高股息,23,8,15,富邦-嘉義,2023-02-15,9692
6138,茂達,15,0,15,富邦-嘉義,2023-02-15,9692
6191,精成科,16,1,15,富邦-嘉義,2023-02-15,9692
00882,中信中國高股息,15,0,15,富邦-嘉義,2023-02-15,9692
6703,軒郁,15,0,15,富邦-嘉義,2023-02-15,9692
00715L,期街口布蘭特正2,20,5,15,富邦-嘉義,2023-02-15,9692
00665L,富邦�琤肭磪囓�2,14,0,14,富邦-嘉義,2023-02-15,9692
8996,高力,27,13,14,富邦-嘉義,2023-02-15,9692
6509,聚和,23,9,14,富邦-嘉義,2023-02-15,9692
1503,士電,106,92,14,富邦-嘉義,2023-02-15,9692
3576,聯合再生,14,0,14,富邦-嘉義,2023-02-15,9692
2337,旺宏,18,6,12,富邦-嘉義,2023-02-15,9692
6770,力積電,12,0,12,富邦-嘉義,2023-02-15,9692
2882,國泰金,15,3,12,富邦-嘉義,2023-02-15,9692
2034,允強,12,0,12,富邦-嘉義,2023-02-15,9692
1605,華新,1383,419,964,富邦-嘉義,2023-02-16,9692
6116,彩晶,305,125,180,富邦-嘉義,2023-02-16,9692
2201,裕隆,475,369,106,富邦-嘉義,2023-02-16,9692
3049,精金,100,0,100,富邦-嘉義,2023-02-16,9692
6282,康舒,180,90,90,富邦-嘉義,2023-02-16,9692
1216,統一,90,0,90,富邦-嘉義,2023-02-16,9692
00673R,期元大S＆P原油反1,83,0,83,富邦-嘉義,2023-02-16,9692
3027,盛達,107,27,80,富邦-嘉義,2023-02-16,9692
1609,大亞,85,15,70,富邦-嘉義,2023-02-16,9692
1417,嘉裕,62,0,62,富邦-嘉義,2023-02-16,9692
2884,玉山金,52,3,49,富邦-嘉義,2023-02-16,9692
2453,凌群,75,28,47,富邦-嘉義,2023-02-16,9692
00679B,元大美債20年,47,0,47,富邦-嘉義,2023-02-16,9692
4961,天鈺,643,597,46,富邦-嘉義,2023-02-16,9692
2327,國巨,182,139,43,富邦-嘉義,2023-02-16,9692
00878,國泰永續高股息,177,134,43,富邦-嘉義,2023-02-16,9692
2481,強茂,48,7,41,富邦-嘉義,2023-02-16,9692
2812,台中銀,38,0,38,富邦-嘉義,2023-02-16,9692
2236,百達-KY,43,5,38,富邦-嘉義,2023-02-16,9692
2329,華泰,50,14,36,富邦-嘉義,2023-02-16,9692
3207,耀勝,33,0,33,富邦-嘉義,2023-02-16,9692
2471,資通,106,74,32,富邦-嘉義,2023-02-16,9692
6235,華孚,49,18,31,富邦-嘉義,2023-02-16,9692
4979,華星光,98,67,31,富邦-嘉義,2023-02-16,9692
2364,倫飛,32,3,29,富邦-嘉義,2023-02-16,9692
2354,鴻準,30,1,29,富邦-嘉義,2023-02-16,9692
00885,富邦越南,34,5,29,富邦-嘉義,2023-02-16,9692
3189,景碩,28,4,24,富邦-嘉義,2023-02-16,9692
2375,凱美,80,56,24,富邦-嘉義,2023-02-16,9692
3693,營邦,29,6,23,富邦-嘉義,2023-02-16,9692
1218,泰山,21,0,21,富邦-嘉義,2023-02-16,9692
00902,中信電池及儲能,21,0,21,富邦-嘉義,2023-02-16,9692
6770,力積電,25,4,21,富邦-嘉義,2023-02-16,9692
3321,同泰,20,0,20,富邦-嘉義,2023-02-16,9692
1528,恩德,20,0,20,富邦-嘉義,2023-02-16,9692
00882,中信中國高股息,22,2,20,富邦-嘉義,2023-02-16,9692
4919,新唐,24,4,20,富邦-嘉義,2023-02-16,9692
2308,台達電,21,1,20,富邦-嘉義,2023-02-16,9692
1432,大魯閣,20,1,19,富邦-嘉義,2023-02-16,9692
1513,中興電,111,93,18,富邦-嘉義,2023-02-16,9692
6266,泰詠,183,165,18,富邦-嘉義,2023-02-16,9692
3576,聯合再生,23,5,18,富邦-嘉義,2023-02-16,9692
00753L,中信中國50正2,21,4,17,富邦-嘉義,2023-02-16,9692
5701,劍湖山,24,7,17,富邦-嘉義,2023-02-16,9692
8234,新漢,55,39,16,富邦-嘉義,2023-02-16,9692
2023,燁輝,15,0,15,富邦-嘉義,2023-02-16,9692
8076,伍豐,15,0,15,富邦-嘉義,2023-02-16,9692
3710,連展投控,17,3,14,富邦-嘉義,2023-02-16,9692
5475,德宏,14,0,14,富邦-嘉義,2023-02-16,9692
6556,勝品,16,2,14,富邦-嘉義,2023-02-16,9692
00878,國泰永續高股息,217,22,195,富邦-嘉義,2023-02-17,9692
00680L,元大美債20正2,126,0,126,富邦-嘉義,2023-02-17,9692
2618,長榮航,161,52,109,富邦-嘉義,2023-02-17,9692
1218,泰山,110,5,105,富邦-嘉義,2023-02-17,9692
1795,美時,1007,903,104,富邦-嘉義,2023-02-17,9692
00679B,元大美債20年,98,1,97,富邦-嘉義,2023-02-17,9692
1503,士電,349,272,77,富邦-嘉義,2023-02-17,9692
5465,富驊,69,2,67,富邦-嘉義,2023-02-17,9692
2201,裕隆,76,21,55,富邦-嘉義,2023-02-17,9692
5704,老爺知,66,12,54,富邦-嘉義,2023-02-17,9692
00893,國泰智能電動車,54,0,54,富邦-嘉義,2023-02-17,9692
00632R,元大台灣50反1,50,2,48,富邦-嘉義,2023-02-17,9692
2028,威致,41,0,41,富邦-嘉義,2023-02-17,9692
6770,力積電,49,12,37,富邦-嘉義,2023-02-17,9692
1513,中興電,148,115,33,富邦-嘉義,2023-02-17,9692
00637L,元大滬深300正2,78,45,33,富邦-嘉義,2023-02-17,9692
00772B,中信高評級公司債,33,0,33,富邦-嘉義,2023-02-17,9692
2230,泰茂,48,17,31,富邦-嘉義,2023-02-17,9692
8436,大江,70,42,28,富邦-嘉義,2023-02-17,9692
6741,91APP*-KY,145,118,27,富邦-嘉義,2023-02-17,9692
2867,三商壽,25,0,25,富邦-嘉義,2023-02-17,9692
4744,皇將,50,25,25,富邦-嘉義,2023-02-17,9692
00882,中信中國高股息,25,2,23,富邦-嘉義,2023-02-17,9692
00895,富邦未來車,22,0,22,富邦-嘉義,2023-02-17,9692
2719,燦星旅,22,0,22,富邦-嘉義,2023-02-17,9692
3540,曜越,30,9,21,富邦-嘉義,2023-02-17,9692
2014,中鴻,34,13,21,富邦-嘉義,2023-02-17,9692
5258,虹堡,23,4,19,富邦-嘉義,2023-02-17,9692
6603,富強鑫,21,2,19,富邦-嘉義,2023-02-17,9692
2330,台積電,26,9,17,富邦-嘉義,2023-02-17,9692
6205,詮欣,17,0,17,富邦-嘉義,2023-02-17,9692
8358,金居,167,151,16,富邦-嘉義,2023-02-17,9692
2705,六福,126,110,16,富邦-嘉義,2023-02-17,9692
00683L,期元大美元指正2,16,1,15,富邦-嘉義,2023-02-17,9692
2344,華邦電,38,24,14,富邦-嘉義,2023-02-17,9692
00902,中信電池及儲能,14,0,14,富邦-嘉義,2023-02-17,9692
2812,台中銀,13,0,13,富邦-嘉義,2023-02-17,9692
3013,晟銘電,13,0,13,富邦-嘉義,2023-02-17,9692
4173,久裕,13,0,13,富邦-嘉義,2023-02-17,9692
3322,建舜電,13,0,13,富邦-嘉義,2023-02-17,9692
4763,材料-KY,17,4,13,富邦-嘉義,2023-02-17,9692
4566,時碩工業,18,5,13,富邦-嘉義,2023-02-17,9692
006208,富邦台50,13,1,12,富邦-嘉義,2023-02-17,9692
9910,豐泰,12,0,12,富邦-嘉義,2023-02-17,9692
6180,橘子,14,2,12,富邦-嘉義,2023-02-17,9692
2610,華航,306,294,12,富邦-嘉義,2023-02-17,9692
00877,復華中國5G,12,0,12,富邦-嘉義,2023-02-17,9692
3576,聯合再生,22,10,12,富邦-嘉義,2023-02-17,9692
0056,元大高股息,20,9,11,富邦-嘉義,2023-02-17,9692
2887,台新金,12,1,11,富邦-嘉義,2023-02-17,9692
2610,華航,688,173,515,富邦-嘉義,2023-02-20,9692
3276,宇環,271,0,271,富邦-嘉義,2023-02-20,9692
6266,泰詠,384,117,267,富邦-嘉義,2023-02-20,9692
1519,華城,312,114,198,富邦-嘉義,2023-02-20,9692
8473,山林水,199,17,182,富邦-嘉義,2023-02-20,9692
2344,華邦電,205,27,178,富邦-嘉義,2023-02-20,9692
2201,裕隆,184,17,167,富邦-嘉義,2023-02-20,9692
2883,凱基金,209,47,162,富邦-嘉義,2023-02-20,9692
1609,大亞,182,26,156,富邦-嘉義,2023-02-20,9692
4968,立積,190,82,108,富邦-嘉義,2023-02-20,9692
2812,台中銀,112,9,103,富邦-嘉義,2023-02-20,9692
3624,光頡,105,4,101,富邦-嘉義,2023-02-20,9692
4979,華星光,441,347,94,富邦-嘉義,2023-02-20,9692
1218,泰山,75,1,74,富邦-嘉義,2023-02-20,9692
2230,泰茂,186,114,72,富邦-嘉義,2023-02-20,9692
2618,長榮航,154,83,71,富邦-嘉義,2023-02-20,9692
2634,漢翔,96,31,65,富邦-嘉義,2023-02-20,9692
6118,建達,101,38,63,富邦-嘉義,2023-02-20,9692
5258,虹堡,317,257,60,富邦-嘉義,2023-02-20,9692
3594,磐儀,188,129,59,富邦-嘉義,2023-02-20,9692
6541,泰福-KY,54,2,52,富邦-嘉義,2023-02-20,9692
1611,中電,55,5,50,富邦-嘉義,2023-02-20,9692
1108,幸福,74,25,49,富邦-嘉義,2023-02-20,9692
4142,國光生,51,2,49,富邦-嘉義,2023-02-20,9692
6104,創惟,150,104,46,富邦-嘉義,2023-02-20,9692
6782,視陽,44,0,44,富邦-嘉義,2023-02-20,9692
00902,中信電池及儲能,42,0,42,富邦-嘉義,2023-02-20,9692
2364,倫飛,42,0,42,富邦-嘉義,2023-02-20,9692
3128,昇銳,40,4,36,富邦-嘉義,2023-02-20,9692
3207,耀勝,46,13,33,富邦-嘉義,2023-02-20,9692
00673R,期元大S＆P原油反1,80,48,32,富邦-嘉義,2023-02-20,9692
2867,三商壽,32,0,32,富邦-嘉義,2023-02-20,9692
3693,營邦,41,10,31,富邦-嘉義,2023-02-20,9692
8936,國統,175,148,27,富邦-嘉義,2023-02-20,9692
3062,建漢,33,6,27,富邦-嘉義,2023-02-20,9692
4572,駐龍,26,0,26,富邦-嘉義,2023-02-20,9692
4526,東台,290,264,26,富邦-嘉義,2023-02-20,9692
8383,千附,335,311,24,富邦-嘉義,2023-02-20,9692
4747,強生,29,5,24,富邦-嘉義,2023-02-20,9692
1560,中砂,21,0,21,富邦-嘉義,2023-02-20,9692
2367,燿華,29,9,20,富邦-嘉義,2023-02-20,9692
00919,群益台灣精選高息,20,0,20,富邦-嘉義,2023-02-20,9692
6115,鎰勝,20,0,20,富邦-嘉義,2023-02-20,9692
2515,中工,20,0,20,富邦-嘉義,2023-02-20,9692
00903,富邦元宇宙,20,2,18,富邦-嘉義,2023-02-20,9692
3704,合勤控,18,3,15,富邦-嘉義,2023-02-20,9692
020034,元大IC設計N,15,0,15,富邦-嘉義,2023-02-20,9692
6245,立端,88,73,15,富邦-嘉義,2023-02-20,9692
6180,橘子,23,8,15,富邦-嘉義,2023-02-20,9692
8215,明基材,22,8,14,富邦-嘉義,2023-02-20,9692
3481,群創,544,46,498,富邦-嘉義,2023-02-21,9692
2884,玉山金,382,56,326,富邦-嘉義,2023-02-21,9692
6282,康舒,1840,1575,265,富邦-嘉義,2023-02-21,9692
00753L,中信中國50正2,221,0,221,富邦-嘉義,2023-02-21,9692
1524,耿鼎,212,41,171,富邦-嘉義,2023-02-21,9692
8033,雷虎,179,17,162,富邦-嘉義,2023-02-21,9692
1519,華城,1009,912,97,富邦-嘉義,2023-02-21,9692
3207,耀勝,149,66,83,富邦-嘉義,2023-02-21,9692
2610,華航,109,39,70,富邦-嘉義,2023-02-21,9692
4909,新復興,66,0,66,富邦-嘉義,2023-02-21,9692
2618,長榮航,68,6,62,富邦-嘉義,2023-02-21,9692
2388,威盛,257,198,59,富邦-嘉義,2023-02-21,9692
2482,連宇,60,1,59,富邦-嘉義,2023-02-21,9692
00885,富邦越南,62,11,51,富邦-嘉義,2023-02-21,9692
2201,裕隆,206,157,49,富邦-嘉義,2023-02-21,9692
2049,上銀,163,116,47,富邦-嘉義,2023-02-21,9692
4916,事欣科,40,0,40,富邦-嘉義,2023-02-21,9692
2230,泰茂,163,125,38,富邦-嘉義,2023-02-21,9692
8222,寶一,337,299,38,富邦-嘉義,2023-02-21,9692
00720B,元大投資級公司債,37,0,37,富邦-嘉義,2023-02-21,9692
6104,創惟,42,6,36,富邦-嘉義,2023-02-21,9692
6570,維田,35,0,35,富邦-嘉義,2023-02-21,9692
00713,元大台灣高息低波,35,1,34,富邦-嘉義,2023-02-21,9692
2834,臺企銀,40,9,31,富邦-嘉義,2023-02-21,9692
00903,富邦元宇宙,30,0,30,富邦-嘉義,2023-02-21,9692
3441,聯一光,82,52,30,富邦-嘉義,2023-02-21,9692
1342,八貫,390,361,29,富邦-嘉義,2023-02-21,9692
1584,精剛,280,252,28,富邦-嘉義,2023-02-21,9692
6153,嘉聯益,28,0,28,富邦-嘉義,2023-02-21,9692
2313,華通,40,13,27,富邦-嘉義,2023-02-21,9692
1605,華新,67,44,23,富邦-嘉義,2023-02-21,9692
8121,越峰,37,14,23,富邦-嘉義,2023-02-21,9692
5344,立衛,25,3,22,富邦-嘉義,2023-02-21,9692
3029,零壹,22,0,22,富邦-嘉義,2023-02-21,9692
00679B,元大美債20年,22,1,21,富邦-嘉義,2023-02-21,9692
1522,堤維西,33,12,21,富邦-嘉義,2023-02-21,9692
6290,良維,22,2,20,富邦-嘉義,2023-02-21,9692
2236,百達-KY,22,3,19,富邦-嘉義,2023-02-21,9692
3454,晶睿,458,440,18,富邦-嘉義,2023-02-21,9692
6205,詮欣,173,155,18,富邦-嘉義,2023-02-21,9692
8076,伍豐,19,2,17,富邦-嘉義,2023-02-21,9692
3321,同泰,16,0,16,富邦-嘉義,2023-02-21,9692
2611,志信,15,0,15,富邦-嘉義,2023-02-21,9692
6715,嘉基,26,11,15,富邦-嘉義,2023-02-21,9692
4934,太極,15,0,15,富邦-嘉義,2023-02-21,9692
2312,金寶,17,2,15,富邦-嘉義,2023-02-21,9692
6116,彩晶,29,15,14,富邦-嘉義,2023-02-21,9692
00752,中信中國50,14,0,14,富邦-嘉義,2023-02-21,9692
5309,系統電,32,18,14,富邦-嘉義,2023-02-21,9692
3508,位速,14,0,14,富邦-嘉義,2023-02-21,9692
00632R,元大台灣50反1,270,11,259,富邦-嘉義,2023-02-22,9692
00878,國泰永續高股息,250,29,221,富邦-嘉義,2023-02-22,9692
00753L,中信中國50正2,126,0,126,富邦-嘉義,2023-02-22,9692
6116,彩晶,129,18,111,富邦-嘉義,2023-02-22,9692
2867,三商壽,107,0,107,富邦-嘉義,2023-02-22,9692
1314,中石化,101,3,98,富邦-嘉義,2023-02-22,9692
2634,漢翔,86,13,73,富邦-嘉義,2023-02-22,9692
2453,凌群,111,40,71,富邦-嘉義,2023-02-22,9692
2471,資通,152,88,64,富邦-嘉義,2023-02-22,9692
2457,飛宏,86,23,63,富邦-嘉義,2023-02-22,9692
3094,聯傑,126,70,56,富邦-嘉義,2023-02-22,9692
6148,驊宏資,174,120,54,富邦-嘉義,2023-02-22,9692
00902,中信電池及儲能,50,0,50,富邦-嘉義,2023-02-22,9692
2845,遠東銀,50,0,50,富邦-嘉義,2023-02-22,9692
00641R,富邦日本反1,50,0,50,富邦-嘉義,2023-02-22,9692
6443,元晶,77,28,49,富邦-嘉義,2023-02-22,9692
2727,王品,116,67,49,富邦-嘉義,2023-02-22,9692
3252,海灣,56,9,47,富邦-嘉義,2023-02-22,9692
1514,亞力,854,808,46,富邦-嘉義,2023-02-22,9692
2303,聯電,59,15,44,富邦-嘉義,2023-02-22,9692
8936,國統,544,501,43,富邦-嘉義,2023-02-22,9692
4114,健喬,76,35,41,富邦-嘉義,2023-02-22,9692
2388,威盛,56,16,40,富邦-嘉義,2023-02-22,9692
5475,德宏,49,10,39,富邦-嘉義,2023-02-22,9692
2618,長榮航,43,6,37,富邦-嘉義,2023-02-22,9692
0056,元大高股息,39,6,33,富邦-嘉義,2023-02-22,9692
4564,元翎,33,0,33,富邦-嘉義,2023-02-22,9692
2023,燁輝,99,69,30,富邦-嘉義,2023-02-22,9692
6612,奈米醫材,52,22,30,富邦-嘉義,2023-02-22,9692
00671R,富邦NASDAQ反1,30,0,30,富邦-嘉義,2023-02-22,9692
4977,眾達-KY,45,16,29,富邦-嘉義,2023-02-22,9692
5512,力麒,210,181,29,富邦-嘉義,2023-02-22,9692
6770,力積電,32,4,28,富邦-嘉義,2023-02-22,9692
3037,欣興,35,8,27,富邦-嘉義,2023-02-22,9692
00882,中信中國高股息,30,4,26,富邦-嘉義,2023-02-22,9692
2038,海光,25,0,25,富邦-嘉義,2023-02-22,9692
6666,羅麗芬-KY,34,9,25,富邦-嘉義,2023-02-22,9692
6266,泰詠,51,28,23,富邦-嘉義,2023-02-22,9692
2610,華航,58,35,23,富邦-嘉義,2023-02-22,9692
3035,智原,49,26,23,富邦-嘉義,2023-02-22,9692
00720B,元大投資級公司債,23,0,23,富邦-嘉義,2023-02-22,9692
1506,正道,29,6,23,富邦-嘉義,2023-02-22,9692
2337,旺宏,23,0,23,富邦-嘉義,2023-02-22,9692
2748,雲品,212,190,22,富邦-嘉義,2023-02-22,9692
2883,凱基金,38,16,22,富邦-嘉義,2023-02-22,9692
2633,台灣高鐵,21,0,21,富邦-嘉義,2023-02-22,9692
00897,富邦基因免疫生技,21,0,21,富邦-嘉義,2023-02-22,9692
00665L,富邦�琤肭磪囓�2,20,0,20,富邦-嘉義,2023-02-22,9692
2812,台中銀,20,0,20,富邦-嘉義,2023-02-22,9692
3016,嘉晶,20,0,20,富邦-嘉義,2023-02-22,9692
2603,長榮,1733,439,1294,富邦-嘉義,2023-02-23,9692
5512,力麒,1860,1311,549,富邦-嘉義,2023-02-23,9692
00632R,元大台灣50反1,375,0,375,富邦-嘉義,2023-02-23,9692
00715L,期街口布蘭特正2,184,1,183,富邦-嘉義,2023-02-23,9692
00753L,中信中國50正2,165,0,165,富邦-嘉義,2023-02-23,9692
2888,新光金,122,11,111,富邦-嘉義,2023-02-23,9692
2722,夏都,110,8,102,富邦-嘉義,2023-02-23,9692
2605,新興,329,229,100,富邦-嘉義,2023-02-23,9692
00900,富邦特選高股息30,107,16,91,富邦-嘉義,2023-02-23,9692
2201,裕隆,97,16,81,富邦-嘉義,2023-02-23,9692
2748,雲品,354,274,80,富邦-嘉義,2023-02-23,9692
6104,創惟,145,77,68,富邦-嘉義,2023-02-23,9692
9955,佳龍,68,0,68,富邦-嘉義,2023-02-23,9692
2303,聯電,104,41,63,富邦-嘉義,2023-02-23,9692
4147,中裕,100,42,58,富邦-嘉義,2023-02-23,9692
5009,榮剛,62,7,55,富邦-嘉義,2023-02-23,9692
5236,凌陽創新,103,51,52,富邦-嘉義,2023-02-23,9692
2409,友達,65,16,49,富邦-嘉義,2023-02-23,9692
6129,普誠,64,19,45,富邦-嘉義,2023-02-23,9692
1519,華城,102,63,39,富邦-嘉義,2023-02-23,9692
2230,泰茂,137,98,39,富邦-嘉義,2023-02-23,9692
2457,飛宏,116,78,38,富邦-嘉義,2023-02-23,9692
3515,華擎,134,99,35,富邦-嘉義,2023-02-23,9692
6205,詮欣,58,23,35,富邦-嘉義,2023-02-23,9692
4961,天鈺,231,198,33,富邦-嘉義,2023-02-23,9692
2344,華邦電,58,29,29,富邦-嘉義,2023-02-23,9692
2482,連宇,364,335,29,富邦-嘉義,2023-02-23,9692
2736,富野,242,213,29,富邦-嘉義,2023-02-23,9692
2023,燁輝,70,41,29,富邦-嘉義,2023-02-23,9692
00720B,元大投資級公司債,27,0,27,富邦-嘉義,2023-02-23,9692
00637L,元大滬深300正2,277,252,25,富邦-嘉義,2023-02-23,9692
1584,精剛,63,39,24,富邦-嘉義,2023-02-23,9692
4977,眾達-KY,41,17,24,富邦-嘉義,2023-02-23,9692
00665L,富邦�琤肭磪囓�2,26,3,23,富邦-嘉義,2023-02-23,9692
00725B,國泰投資級公司債,23,0,23,富邦-嘉義,2023-02-23,9692
2369,菱生,106,84,22,富邦-嘉義,2023-02-23,9692
6570,維田,28,7,21,富邦-嘉義,2023-02-23,9692
020034,元大IC設計N,20,0,20,富邦-嘉義,2023-02-23,9692
00706L,期元大S＆P日圓正2,20,0,20,富邦-嘉義,2023-02-23,9692
6101,寬魚國際,21,1,20,富邦-嘉義,2023-02-23,9692
5269,祥碩,77,57,20,富邦-嘉義,2023-02-23,9692
2809,京城銀,19,0,19,富邦-嘉義,2023-02-23,9692
00893,國泰智能電動車,27,8,19,富邦-嘉義,2023-02-23,9692
3710,連展投控,20,1,19,富邦-嘉義,2023-02-23,9692
00642U,期元大S＆P石油,17,0,17,富邦-嘉義,2023-02-23,9692
00679B,元大美債20年,22,6,16,富邦-嘉義,2023-02-23,9692
2883,凱基金,24,7,17,富邦-嘉義,2023-02-23,9692
1460,宏遠,16,0,16,富邦-嘉義,2023-02-23,9692
8049,晶采,43,27,16,富邦-嘉義,2023-02-23,9692
2208,台船,17,1,16,富邦-嘉義,2023-02-23,9692
2201,裕隆,522,26,496,富邦-嘉義,2023-02-24,9692
00637L,元大滬深300正2,171,1,170,富邦-嘉義,2023-02-24,9692
00753L,中信中國50正2,152,30,122,富邦-嘉義,2023-02-24,9692
3037,欣興,119,22,97,富邦-嘉義,2023-02-24,9692
00878,國泰永續高股息,84,16,68,富邦-嘉義,2023-02-24,9692
2014,中鴻,64,2,62,富邦-嘉義,2023-02-24,9692
5309,系統電,56,3,53,富邦-嘉義,2023-02-24,9692
1313,聯成,52,0,52,富邦-嘉義,2023-02-24,9692
6180,橘子,51,0,51,富邦-嘉義,2023-02-24,9692
2886,兆豐金,51,0,51,富邦-嘉義,2023-02-24,9692
3006,晶豪科,51,3,48,富邦-嘉義,2023-02-24,9692
1219,福壽,36,0,36,富邦-嘉義,2023-02-24,9692
2399,映泰,39,4,35,富邦-嘉義,2023-02-24,9692
1514,亞力,39,7,32,富邦-嘉義,2023-02-24,9692
2867,三商壽,31,0,31,富邦-嘉義,2023-02-24,9692
2890,永豐金,34,5,29,富邦-嘉義,2023-02-24,9692
2834,臺企銀,42,14,28,富邦-嘉義,2023-02-24,9692
5388,中磊,32,4,28,富邦-嘉義,2023-02-24,9692
2892,第一金,27,1,26,富邦-嘉義,2023-02-24,9692
2457,飛宏,65,39,26,富邦-嘉義,2023-02-24,9692
8074,鉅橡,25,0,25,富邦-嘉義,2023-02-24,9692
4763,材料-KY,51,27,24,富邦-嘉義,2023-02-24,9692
2913,農林,23,0,23,富邦-嘉義,2023-02-24,9692
4931,新盛力,22,0,22,富邦-嘉義,2023-02-24,9692
1605,華新,56,34,22,富邦-嘉義,2023-02-24,9692
4923,力士,21,0,21,富邦-嘉義,2023-02-24,9692
8358,金居,24,3,21,富邦-嘉義,2023-02-24,9692
1513,中興電,36,15,21,富邦-嘉義,2023-02-24,9692
4934,太極,20,0,20,富邦-嘉義,2023-02-24,9692
00673R,期元大S＆P原油反1,20,0,20,富邦-嘉義,2023-02-24,9692
2705,六福,23,3,20,富邦-嘉義,2023-02-24,9692
2701,萬企,18,0,18,富邦-嘉義,2023-02-24,9692
2453,凌群,48,30,18,富邦-嘉義,2023-02-24,9692
2465,麗臺,20,4,16,富邦-嘉義,2023-02-24,9692
3594,磐儀,25,9,16,富邦-嘉義,2023-02-24,9692
1506,正道,26,11,15,富邦-嘉義,2023-02-24,9692
4536,拓凱,15,0,15,富邦-嘉義,2023-02-24,9692
2369,菱生,38,24,14,富邦-嘉義,2023-02-24,9692
1432,大魯閣,14,0,14,富邦-嘉義,2023-02-24,9692
2420,新巨,14,0,14,富邦-嘉義,2023-02-24,9692
5009,榮剛,16,2,14,富邦-嘉義,2023-02-24,9692
1708,東鹼,14,1,13,富邦-嘉義,2023-02-24,9692
1584,精剛,20,7,13,富邦-嘉義,2023-02-24,9692
6603,富強鑫,15,2,13,富邦-嘉義,2023-02-24,9692
8210,勤誠,13,0,13,富邦-嘉義,2023-02-24,9692
8076,伍豐,13,0,13,富邦-嘉義,2023-02-24,9692
00882,中信中國高股息,62,50,12,富邦-嘉義,2023-02-24,9692
6214,精誠,12,0,12,富邦-嘉義,2023-02-24,9692
3535,晶彩科,53,41,12,富邦-嘉義,2023-02-24,9692
2613,中櫃,12,0,12,富邦-嘉義,2023-02-24,9692
2605,新興,449,184,265,富邦-嘉義,2023-03-01,9692
1220,台榮,626,384,242,富邦-嘉義,2023-03-01,9692
5258,虹堡,303,87,216,富邦-嘉義,2023-03-01,9692
00878,國泰永續高股息,215,16,199,富邦-嘉義,2023-03-01,9692
8996,高力,294,98,196,富邦-嘉義,2023-03-01,9692
3661,世芯-KY,144,15,129,富邦-嘉義,2023-03-01,9692
1605,華新,238,112,126,富邦-嘉義,2023-03-01,9692
2812,台中銀,122,0,122,富邦-嘉義,2023-03-01,9692
6266,泰詠,238,132,106,富邦-嘉義,2023-03-01,9692
6578,達邦蛋白,133,30,103,富邦-嘉義,2023-03-01,9692
2371,大同,100,0,100,富邦-嘉義,2023-03-01,9692
2845,遠東銀,100,0,100,富邦-嘉義,2023-03-01,9692
8936,國統,105,10,95,富邦-嘉義,2023-03-01,9692
5452,佶優,102,8,94,富邦-嘉義,2023-03-01,9692
1513,中興電,114,21,93,富邦-嘉義,2023-03-01,9692
2882,國泰金,80,2,78,富邦-嘉義,2023-03-01,9692
2641,正德,219,148,71,富邦-嘉義,2023-03-01,9692
2606,裕民,150,90,60,富邦-嘉義,2023-03-01,9692
1101,台泥,84,25,59,富邦-嘉義,2023-03-01,9692
2883,凱基金,84,25,59,富邦-嘉義,2023-03-01,9692
3443,創意,228,170,58,富邦-嘉義,2023-03-01,9692
1313,聯成,56,0,56,富邦-嘉義,2023-03-01,9692
2637,慧洋-KY,112,61,51,富邦-嘉義,2023-03-01,9692
2014,中鴻,62,20,42,富邦-嘉義,2023-03-01,9692
1336,台翰,41,0,41,富邦-嘉義,2023-03-01,9692
3362,先進光,108,68,40,富邦-嘉義,2023-03-01,9692
2601,益航,488,449,39,富邦-嘉義,2023-03-01,9692
3207,耀勝,186,148,38,富邦-嘉義,2023-03-01,9692
00882,中信中國高股息,39,3,36,富邦-嘉義,2023-03-01,9692
4961,天鈺,242,209,33,富邦-嘉義,2023-03-01,9692
2002,中鋼,67,35,32,富邦-嘉義,2023-03-01,9692
5009,榮剛,34,4,30,富邦-嘉義,2023-03-01,9692
3006,晶豪科,31,1,30,富邦-嘉義,2023-03-01,9692
2201,裕隆,484,454,30,富邦-嘉義,2023-03-01,9692
00712,復華富時不動產,28,0,28,富邦-嘉義,2023-03-01,9692
2617,台航,39,12,27,富邦-嘉義,2023-03-01,9692
2504,國產,27,0,27,富邦-嘉義,2023-03-01,9692
2885,元大金,39,14,25,富邦-嘉義,2023-03-01,9692
00900,富邦特選高股息30,38,14,24,富邦-嘉義,2023-03-01,9692
2236,百達-KY,24,0,24,富邦-嘉義,2023-03-01,9692
2023,燁輝,24,2,22,富邦-嘉義,2023-03-01,9692
5608,四維航,149,128,21,富邦-嘉義,2023-03-01,9692
2705,六福,21,0,21,富邦-嘉義,2023-03-01,9692
2888,新光金,24,3,21,富邦-嘉義,2023-03-01,9692
2610,華航,90,69,21,富邦-嘉義,2023-03-01,9692
4111,濟生,20,0,20,富邦-嘉義,2023-03-01,9692
3231,緯創,26,6,20,富邦-嘉義,2023-03-01,9692
2852,第一保,20,0,20,富邦-嘉義,2023-03-01,9692
6215,和椿,20,1,19,富邦-嘉義,2023-03-01,9692
6282,康舒,49,30,19,富邦-嘉義,2023-03-01,9692
2603,長榮,1003,619,384,富邦-嘉義,2023-03-02,9692
6170,統振,611,249,362,富邦-嘉義,2023-03-02,9692
6235,華孚,424,232,192,富邦-嘉義,2023-03-02,9692
00632R,元大台灣50反1,311,123,188,富邦-嘉義,2023-03-02,9692
00878,國泰永續高股息,175,9,166,富邦-嘉義,2023-03-02,9692
2457,飛宏,171,21,150,富邦-嘉義,2023-03-02,9692
8033,雷虎,120,14,106,富邦-嘉義,2023-03-02,9692
2834,臺企銀,89,3,86,富邦-嘉義,2023-03-02,9692
2328,廣宇,76,1,75,富邦-嘉義,2023-03-02,9692
8227,巨有科技,103,29,74,富邦-嘉義,2023-03-02,9692
6799,來頡,235,165,70,富邦-嘉義,2023-03-02,9692
00725B,國泰投資級公司債,65,0,65,富邦-嘉義,2023-03-02,9692
2722,夏都,134,74,60,富邦-嘉義,2023-03-02,9692
6670,復盛應用,60,1,59,富邦-嘉義,2023-03-02,9692
00713,元大台灣高息低波,62,10,52,富邦-嘉義,2023-03-02,9692
3454,晶睿,356,304,52,富邦-嘉義,2023-03-02,9692
2312,金寶,60,10,50,富邦-嘉義,2023-03-02,9692
6282,康舒,56,11,45,富邦-嘉義,2023-03-02,9692
2501,國建,44,0,44,富邦-嘉義,2023-03-02,9692
3362,先進光,217,175,42,富邦-嘉義,2023-03-02,9692
4147,中裕,42,2,40,富邦-嘉義,2023-03-02,9692
1762,中化生,74,36,38,富邦-嘉義,2023-03-02,9692
3058,立德,32,0,32,富邦-嘉義,2023-03-02,9692
00897,富邦基因免疫生技,36,5,31,富邦-嘉義,2023-03-02,9692
2303,聯電,65,35,30,富邦-嘉義,2023-03-02,9692
4915,致伸,33,5,28,富邦-嘉義,2023-03-02,9692
00712,復華富時不動產,28,0,28,富邦-嘉義,2023-03-02,9692
6531,愛普*,58,32,26,富邦-嘉義,2023-03-02,9692
1795,美時,28,5,23,富邦-嘉義,2023-03-02,9692
2236,百達-KY,60,37,23,富邦-嘉義,2023-03-02,9692
8478,東哥遊艇,36,13,23,富邦-嘉義,2023-03-02,9692
4747,強生,91,69,22,富邦-嘉義,2023-03-02,9692
00773B,中信優先金融債,22,0,22,富邦-嘉義,2023-03-02,9692
2890,永豐金,20,0,20,富邦-嘉義,2023-03-02,9692
2317,鴻海,27,8,19,富邦-嘉義,2023-03-02,9692
2610,華航,26,7,19,富邦-嘉義,2023-03-02,9692
00679B,元大美債20年,20,3,17,富邦-嘉義,2023-03-02,9692
1701,中化,26,9,17,富邦-嘉義,2023-03-02,9692
3624,光頡,16,0,16,富邦-嘉義,2023-03-02,9692
00900,富邦特選高股息30,32,16,16,富邦-嘉義,2023-03-02,9692
00664R,國泰臺灣加權反1,15,0,15,富邦-嘉義,2023-03-02,9692
4155,訊映,31,17,14,富邦-嘉義,2023-03-02,9692
00772B,中信高評級公司債,14,0,14,富邦-嘉義,2023-03-02,9692
2371,大同,16,2,14,富邦-嘉義,2023-03-02,9692
3346,麗清,27,13,14,富邦-嘉義,2023-03-02,9692
6603,富強鑫,14,0,14,富邦-嘉義,2023-03-02,9692
2105,正新,14,0,14,富邦-嘉義,2023-03-02,9692
2498,宏達電,53,40,13,富邦-嘉義,2023-03-02,9692
5880,合庫金,18,5,13,富邦-嘉義,2023-03-02,9692
4128,中天,19,6,13,富邦-嘉義,2023-03-02,9692
5211,蒙恬,520,1,519,富邦-嘉義,2023-03-03,9692
00673R,期元大S＆P原油反1,420,0,420,富邦-嘉義,2023-03-03,9692
3147,大綜,416,117,299,富邦-嘉義,2023-03-03,9692
2605,新興,380,138,242,富邦-嘉義,2023-03-03,9692
1605,華新,189,42,147,富邦-嘉義,2023-03-03,9692
1539,巨庭,295,168,127,富邦-嘉義,2023-03-03,9692
5512,力麒,104,0,104,富邦-嘉義,2023-03-03,9692
5464,霖宏,118,24,94,富邦-嘉義,2023-03-03,9692
2606,裕民,186,97,89,富邦-嘉義,2023-03-03,9692
2328,廣宇,86,0,86,富邦-嘉義,2023-03-03,9692
2845,遠東銀,96,11,85,富邦-嘉義,2023-03-03,9692
6245,立端,191,107,84,富邦-嘉義,2023-03-03,9692
00712,復華富時不動產,66,0,66,富邦-嘉義,2023-03-03,9692
2834,臺企銀,90,24,66,富邦-嘉義,2023-03-03,9692
2607,榮運,106,43,63,富邦-嘉義,2023-03-03,9692
6570,維田,67,7,60,富邦-嘉義,2023-03-03,9692
3689,湧德,52,1,51,富邦-嘉義,2023-03-03,9692
2317,鴻海,62,12,50,富邦-嘉義,2023-03-03,9692
3664,安瑞-KY,50,0,50,富邦-嘉義,2023-03-03,9692
3432,台端,80,31,49,富邦-嘉義,2023-03-03,9692
1760,寶齡富錦,53,9,44,富邦-嘉義,2023-03-03,9692
2312,金寶,54,10,44,富邦-嘉義,2023-03-03,9692
5425,台半,67,23,44,富邦-嘉義,2023-03-03,9692
4747,強生,138,98,40,富邦-嘉義,2023-03-03,9692
4953,緯軟,41,3,38,富邦-嘉義,2023-03-03,9692
2388,威盛,47,10,37,富邦-嘉義,2023-03-03,9692
8046,南電,55,19,36,富邦-嘉義,2023-03-03,9692
2884,玉山金,47,12,35,富邦-嘉義,2023-03-03,9692
00772B,中信高評級公司債,31,0,31,富邦-嘉義,2023-03-03,9692
2498,宏達電,46,15,31,富邦-嘉義,2023-03-03,9692
3693,營邦,43,16,27,富邦-嘉義,2023-03-03,9692
3356,奇偶,373,346,27,富邦-嘉義,2023-03-03,9692
1101,台泥,38,11,27,富邦-嘉義,2023-03-03,9692
00900,富邦特選高股息30,46,19,27,富邦-嘉義,2023-03-03,9692
00773B,中信優先金融債,31,7,24,富邦-嘉義,2023-03-03,9692
8049,晶采,27,5,22,富邦-嘉義,2023-03-03,9692
6556,勝品,55,33,22,富邦-嘉義,2023-03-03,9692
00679B,元大美債20年,20,0,20,富邦-嘉義,2023-03-03,9692
00885,富邦越南,20,0,20,富邦-嘉義,2023-03-03,9692
6282,康舒,40,20,20,富邦-嘉義,2023-03-03,9692
3324,雙鴻,20,0,20,富邦-嘉義,2023-03-03,9692
6180,橘子,21,1,20,富邦-嘉義,2023-03-03,9692
5251,天鉞電,54,34,20,富邦-嘉義,2023-03-03,9692
1709,和益,21,1,20,富邦-嘉義,2023-03-03,9692
8040,九暘,20,0,20,富邦-嘉義,2023-03-03,9692
2890,永豐金,25,5,20,富邦-嘉義,2023-03-03,9692
2601,益航,24,5,19,富邦-嘉義,2023-03-03,9692
8033,雷虎,85,66,19,富邦-嘉義,2023-03-03,9692
6811,宏�硌穈T,32,13,19,富邦-嘉義,2023-03-03,9692
8289,泰藝,46,27,19,富邦-嘉義,2023-03-03,9692
2601,益航,607,4,603,富邦-嘉義,2023-03-06,9692
00673R,期元大S＆P原油反1,511,3,508,富邦-嘉義,2023-03-06,9692
2457,飛宏,306,95,211,富邦-嘉義,2023-03-06,9692
00713,元大台灣高息低波,208,2,206,富邦-嘉義,2023-03-06,9692
8033,雷虎,293,89,204,富邦-嘉義,2023-03-06,9692
6235,華孚,468,267,201,富邦-嘉義,2023-03-06,9692
3362,先進光,470,302,168,富邦-嘉義,2023-03-06,9692
3297,杭特,136,2,134,富邦-嘉義,2023-03-06,9692
2486,一詮,702,594,108,富邦-嘉義,2023-03-06,9692
3454,晶睿,181,75,106,富邦-嘉義,2023-03-06,9692
6113,亞矽,176,90,86,富邦-嘉義,2023-03-06,9692
2482,連宇,307,241,66,富邦-嘉義,2023-03-06,9692
4919,新唐,488,427,61,富邦-嘉義,2023-03-06,9692
2641,正德,62,7,55,富邦-嘉義,2023-03-06,9692
00637L,元大滬深300正2,103,50,53,富邦-嘉義,2023-03-06,9692
6266,泰詠,52,0,52,富邦-嘉義,2023-03-06,9692
4961,天鈺,59,8,51,富邦-嘉義,2023-03-06,9692
2481,強茂,225,179,46,富邦-嘉義,2023-03-06,9692
6438,迅得,40,0,40,富邦-嘉義,2023-03-06,9692
2375,凱美,180,142,38,富邦-嘉義,2023-03-06,9692
2634,漢翔,36,1,35,富邦-嘉義,2023-03-06,9692
5425,台半,55,21,34,富邦-嘉義,2023-03-06,9692
6517,保勝光學,32,0,32,富邦-嘉義,2023-03-06,9692
2637,慧洋-KY,34,2,32,富邦-嘉義,2023-03-06,9692
3231,緯創,42,13,29,富邦-嘉義,2023-03-06,9692
2330,台積電,133,104,29,富邦-嘉義,2023-03-06,9692
00885,富邦越南,28,0,28,富邦-嘉義,2023-03-06,9692
00712,復華富時不動產,26,0,26,富邦-嘉義,2023-03-06,9692
6443,元晶,62,37,25,富邦-嘉義,2023-03-06,9692
3035,智原,24,0,24,富邦-嘉義,2023-03-06,9692
2453,凌群,145,121,24,富邦-嘉義,2023-03-06,9692
6799,來頡,25,1,24,富邦-嘉義,2023-03-06,9692
8070,長華*,48,25,23,富邦-嘉義,2023-03-06,9692
2328,廣宇,25,3,22,富邦-嘉義,2023-03-06,9692
3701,大眾控,39,17,22,富邦-嘉義,2023-03-06,9692
00919,群益台灣精選高息,20,0,20,富邦-嘉義,2023-03-06,9692
00706L,期元大S＆P日圓正2,20,0,20,富邦-嘉義,2023-03-06,9692
8927,北基,20,0,20,富邦-嘉義,2023-03-06,9692
6175,立敦,30,10,20,富邦-嘉義,2023-03-06,9692
1449,佳和,20,0,20,富邦-嘉義,2023-03-06,9692
2371,大同,22,4,18,富邦-嘉義,2023-03-06,9692
2609,陽明,127,110,17,富邦-嘉義,2023-03-06,9692
3008,大立光,27,11,16,富邦-嘉義,2023-03-06,9692
3236,千如,24,9,15,富邦-嘉義,2023-03-06,9692
2337,旺宏,21,6,15,富邦-嘉義,2023-03-06,9692
2327,國巨,16,1,15,富邦-嘉義,2023-03-06,9692
2867,三商壽,14,0,14,富邦-嘉義,2023-03-06,9692
2313,華通,18,4,14,富邦-嘉義,2023-03-06,9692
1326,台化,20,7,13,富邦-嘉義,2023-03-06,9692
6643,M31,14,1,13,富邦-嘉義,2023-03-06,9692
00673R,期元大S＆P原油反1,379,0,379,富邦-嘉義,2023-03-07,9692
3046,建��,255,3,252,富邦-嘉義,2023-03-07,9692
6282,康舒,327,128,199,富邦-嘉義,2023-03-07,9692
2453,凌群,239,85,154,富邦-嘉義,2023-03-07,9692
2610,華航,154,4,150,富邦-嘉義,2023-03-07,9692
2618,長榮航,151,3,148,富邦-嘉義,2023-03-07,9692
2201,裕隆,130,18,112,富邦-嘉義,2023-03-07,9692
6558,興能高,175,73,102,富邦-嘉義,2023-03-07,9692
1504,東元,126,27,99,富邦-嘉義,2023-03-07,9692
3479,安勤,207,109,98,富邦-嘉義,2023-03-07,9692
8111,立��,224,127,97,富邦-嘉義,2023-03-07,9692
2606,裕民,107,18,89,富邦-嘉義,2023-03-07,9692
4967,十銓,89,4,85,富邦-嘉義,2023-03-07,9692
2634,漢翔,74,11,63,富邦-嘉義,2023-03-07,9692
4976,佳凌,162,100,62,富邦-嘉義,2023-03-07,9692
8227,巨有科技,85,33,52,富邦-嘉義,2023-03-07,9692
3454,晶睿,721,678,43,富邦-嘉義,2023-03-07,9692
00632R,元大台灣50反1,57,21,36,富邦-嘉義,2023-03-07,9692
3272,東碩,35,3,32,富邦-嘉義,2023-03-07,9692
1710,東聯,236,205,31,富邦-嘉義,2023-03-07,9692
00897,富邦基因免疫生技,30,0,30,富邦-嘉義,2023-03-07,9692
2892,第一金,33,4,29,富邦-嘉義,2023-03-07,9692
3058,立德,34,6,28,富邦-嘉義,2023-03-07,9692
3162,精確,38,11,27,富邦-嘉義,2023-03-07,9692
4108,懷特,26,0,26,富邦-嘉義,2023-03-07,9692
3037,欣興,44,19,25,富邦-嘉義,2023-03-07,9692
00642U,期元大S＆P石油,32,8,24,富邦-嘉義,2023-03-07,9692
2328,廣宇,34,10,24,富邦-嘉義,2023-03-07,9692
1815,富喬,25,1,24,富邦-嘉義,2023-03-07,9692
2236,百達-KY,23,1,22,富邦-嘉義,2023-03-07,9692
2308,台達電,29,7,22,富邦-嘉義,2023-03-07,9692
1701,中化,27,6,21,富邦-嘉義,2023-03-07,9692
2344,華邦電,35,14,21,富邦-嘉義,2023-03-07,9692
2323,中環,30,10,20,富邦-嘉義,2023-03-07,9692
00753L,中信中國50正2,20,0,20,富邦-嘉義,2023-03-07,9692
2356,英業達,20,0,20,富邦-嘉義,2023-03-07,9692
1471,首利,26,6,20,富邦-嘉義,2023-03-07,9692
3047,訊舟,22,2,20,富邦-嘉義,2023-03-07,9692
3114,好德,20,0,20,富邦-嘉義,2023-03-07,9692
3149,正達,21,1,20,富邦-嘉義,2023-03-07,9692
1513,中興電,803,784,19,富邦-嘉義,2023-03-07,9692
00900,富邦特選高股息30,43,24,19,富邦-嘉義,2023-03-07,9692
2889,國票金,25,7,18,富邦-嘉義,2023-03-07,9692
6799,來頡,46,28,18,富邦-嘉義,2023-03-07,9692
3059,華晶科,19,1,18,富邦-嘉義,2023-03-07,9692
3552,同致,582,564,18,富邦-嘉義,2023-03-07,9692
1101,台泥,19,3,16,富邦-嘉義,2023-03-07,9692
6706,惠特,28,13,15,富邦-嘉義,2023-03-07,9692
1714,和桐,17,2,15,富邦-嘉義,2023-03-07,9692
2504,國產,75,61,14,富邦-嘉義,2023-03-07,9692
2243,宏旭-KY,1210,4,1206,富邦-嘉義,2023-03-08,9692
5425,台半,1555,506,1049,富邦-嘉義,2023-03-08,9692
2471,資通,1355,903,452,富邦-嘉義,2023-03-08,9692
4155,訊映,361,17,344,富邦-嘉義,2023-03-08,9692
4977,眾達-KY,301,101,200,富邦-嘉義,2023-03-08,9692
3481,群創,199,33,166,富邦-嘉義,2023-03-08,9692
00753L,中信中國50正2,174,30,144,富邦-嘉義,2023-03-08,9692
2482,連宇,197,65,132,富邦-嘉義,2023-03-08,9692
8033,雷虎,157,40,117,富邦-嘉義,2023-03-08,9692
5340,建榮,125,10,115,富邦-嘉義,2023-03-08,9692
00637L,元大滬深300正2,359,253,106,富邦-嘉義,2023-03-08,9692
5211,蒙恬,101,2,99,富邦-嘉義,2023-03-08,9692
8222,寶一,680,590,90,富邦-嘉義,2023-03-08,9692
2344,華邦電,246,157,89,富邦-嘉義,2023-03-08,9692
5309,系統電,69,2,67,富邦-嘉義,2023-03-08,9692
6443,元晶,107,42,65,富邦-嘉義,2023-03-08,9692
00665L,富邦�琤肭磪囓�2,64,0,64,富邦-嘉義,2023-03-08,9692
6841,長佳智能,56,1,55,富邦-嘉義,2023-03-08,9692
8131,福懋科,55,0,55,富邦-嘉義,2023-03-08,9692
3712,永崴投控,72,18,54,富邦-嘉義,2023-03-08,9692
2880,華南金,51,0,51,富邦-嘉義,2023-03-08,9692
8046,南電,55,4,51,富邦-嘉義,2023-03-08,9692
3441,聯一光,71,21,50,富邦-嘉義,2023-03-08,9692
6266,泰詠,172,123,49,富邦-嘉義,2023-03-08,9692
2883,凱基金,55,7,48,富邦-嘉義,2023-03-08,9692
00725B,國泰投資級公司債,50,3,47,富邦-嘉義,2023-03-08,9692
1513,中興電,437,390,47,富邦-嘉義,2023-03-08,9692
00878,國泰永續高股息,60,17,43,富邦-嘉義,2023-03-08,9692
8936,國統,72,34,38,富邦-嘉義,2023-03-08,9692
4147,中裕,37,0,37,富邦-嘉義,2023-03-08,9692
2609,陽明,47,11,36,富邦-嘉義,2023-03-08,9692
6129,普誠,293,257,36,富邦-嘉義,2023-03-08,9692
6643,M31,66,30,36,富邦-嘉義,2023-03-08,9692
6547,高端疫苗,35,0,35,富邦-嘉義,2023-03-08,9692
8383,千附,74,39,35,富邦-嘉義,2023-03-08,9692
1605,華新,59,24,35,富邦-嘉義,2023-03-08,9692
1708,東鹼,34,1,33,富邦-嘉義,2023-03-08,9692
6770,力積電,39,7,32,富邦-嘉義,2023-03-08,9692
3594,磐儀,32,2,30,富邦-嘉義,2023-03-08,9692
0056,元大高股息,34,5,29,富邦-嘉義,2023-03-08,9692
5284,jpp-KY,39,14,25,富邦-嘉義,2023-03-08,9692
5452,佶優,25,0,25,富邦-嘉義,2023-03-08,9692
2882,國泰金,24,0,24,富邦-嘉義,2023-03-08,9692
3491,昇達科,35,11,24,富邦-嘉義,2023-03-08,9692
00713,元大台灣高息低波,54,31,23,富邦-嘉義,2023-03-08,9692
1762,中化生,23,0,23,富邦-嘉義,2023-03-08,9692
2812,台中銀,23,0,23,富邦-嘉義,2023-03-08,9692
00712,復華富時不動產,23,0,23,富邦-嘉義,2023-03-08,9692
1514,亞力,295,273,22,富邦-嘉義,2023-03-08,9692
4533,協易機,21,0,21,富邦-嘉義,2023-03-08,9692
3624,光頡,456,197,259,富邦-嘉義,2023-03-09,9692
4155,訊映,249,4,245,富邦-嘉義,2023-03-09,9692
2388,威盛,628,443,185,富邦-嘉義,2023-03-09,9692
00878,國泰永續高股息,182,0,182,富邦-嘉義,2023-03-09,9692
6235,華孚,190,32,158,富邦-嘉義,2023-03-09,9692
2413,環科,1610,1493,117,富邦-嘉義,2023-03-09,9692
2486,一詮,114,13,101,富邦-嘉義,2023-03-09,9692
3712,永崴投控,379,286,93,富邦-嘉義,2023-03-09,9692
2331,精英,92,1,91,富邦-嘉義,2023-03-09,9692
3481,群創,104,29,75,富邦-嘉義,2023-03-09,9692
2367,燿華,80,10,70,富邦-嘉義,2023-03-09,9692
00680L,元大美債20正2,70,0,70,富邦-嘉義,2023-03-09,9692
1503,士電,99,34,65,富邦-嘉義,2023-03-09,9692
2504,國產,63,0,63,富邦-嘉義,2023-03-09,9692
2888,新光金,71,10,61,富邦-嘉義,2023-03-09,9692
2409,友達,62,3,59,富邦-嘉義,2023-03-09,9692
5321,美而快,162,103,59,富邦-嘉義,2023-03-09,9692
3661,世芯-KY,280,221,59,富邦-嘉義,2023-03-09,9692
1101,台泥,52,9,43,富邦-嘉義,2023-03-09,9692
8155,博智,50,8,42,富邦-嘉義,2023-03-09,9692
2891,中信金,43,1,42,富邦-嘉義,2023-03-09,9692
2722,夏都,39,2,37,富邦-嘉義,2023-03-09,9692
5340,建榮,62,25,37,富邦-嘉義,2023-03-09,9692
6603,富強鑫,36,0,36,富邦-嘉義,2023-03-09,9692
2618,長榮航,273,237,36,富邦-嘉義,2023-03-09,9692
5425,台半,97,62,35,富邦-嘉義,2023-03-09,9692
2368,金像電,58,25,33,富邦-嘉義,2023-03-09,9692
2883,凱基金,39,6,33,富邦-嘉義,2023-03-09,9692
6643,M31,180,148,32,富邦-嘉義,2023-03-09,9692
6112,邁達特,59,27,32,富邦-嘉義,2023-03-09,9692
1709,和益,38,6,32,富邦-嘉義,2023-03-09,9692
6550,北極星藥業-KY,37,5,32,富邦-嘉義,2023-03-09,9692
00637L,元大滬深300正2,31,0,31,富邦-嘉義,2023-03-09,9692
3594,磐儀,72,41,31,富邦-嘉義,2023-03-09,9692
2498,宏達電,551,521,30,富邦-嘉義,2023-03-09,9692
3419,譁裕,30,0,30,富邦-嘉義,2023-03-09,9692
2312,金寶,27,0,27,富邦-嘉義,2023-03-09,9692
6129,普誠,107,80,27,富邦-嘉義,2023-03-09,9692
2890,永豐金,26,0,26,富邦-嘉義,2023-03-09,9692
00753L,中信中國50正2,26,0,26,富邦-嘉義,2023-03-09,9692
2347,聯強,28,2,26,富邦-嘉義,2023-03-09,9692
6556,勝品,33,8,25,富邦-嘉義,2023-03-09,9692
00633L,富邦上証正2,106,81,25,富邦-嘉義,2023-03-09,9692
2495,普安,28,4,24,富邦-嘉義,2023-03-09,9692
00632R,元大台灣50反1,24,0,24,富邦-嘉義,2023-03-09,9692
00773B,中信優先金融債,22,0,22,富邦-嘉義,2023-03-09,9692
2884,玉山金,33,11,22,富邦-嘉義,2023-03-09,9692
00655L,國泰中國A50正2,22,0,22,富邦-嘉義,2023-03-09,9692
1504,東元,527,505,22,富邦-嘉義,2023-03-09,9692
00885,富邦越南,25,4,21,富邦-嘉義,2023-03-09,9692
1504,東元,753,19,734,富邦-嘉義,2023-03-10,9692
2201,裕隆,561,351,210,富邦-嘉義,2023-03-10,9692
00715L,期街口布蘭特正2,250,50,200,富邦-嘉義,2023-03-10,9692
00878,國泰永續高股息,210,16,194,富邦-嘉義,2023-03-10,9692
2457,飛宏,1187,1039,148,富邦-嘉義,2023-03-10,9692
1605,華新,152,49,103,富邦-嘉義,2023-03-10,9692
00923,群益台ESG低碳50,96,0,96,富邦-嘉義,2023-03-10,9692
6443,元晶,110,20,90,富邦-嘉義,2023-03-10,9692
0056,元大高股息,169,95,74,富邦-嘉義,2023-03-10,9692
2888,新光金,97,26,71,富邦-嘉義,2023-03-10,9692
2634,漢翔,86,19,67,富邦-嘉義,2023-03-10,9692
00882,中信中國高股息,73,6,67,富邦-嘉義,2023-03-10,9692
2618,長榮航,76,14,62,富邦-嘉義,2023-03-10,9692
2328,廣宇,72,11,61,富邦-嘉義,2023-03-10,9692
2882,國泰金,63,4,59,富邦-嘉義,2023-03-10,9692
8105,凌巨,62,6,56,富邦-嘉義,2023-03-10,9692
4543,萬在,60,6,54,富邦-嘉義,2023-03-10,9692
6129,普誠,60,6,54,富邦-嘉義,2023-03-10,9692
4510,高鋒,50,0,50,富邦-嘉義,2023-03-10,9692
00713,元大台灣高息低波,57,11,46,富邦-嘉義,2023-03-10,9692
00665L,富邦�琤肭磪囓�2,45,0,45,富邦-嘉義,2023-03-10,9692
5512,力麒,43,0,43,富邦-嘉義,2023-03-10,9692
2929,淘帝-KY,56,14,42,富邦-嘉義,2023-03-10,9692
2880,華南金,112,73,39,富邦-嘉義,2023-03-10,9692
3058,立德,60,26,34,富邦-嘉義,2023-03-10,9692
2609,陽明,5116,5082,34,富邦-嘉義,2023-03-10,9692
2344,華邦電,37,4,33,富邦-嘉義,2023-03-10,9692
2881,富邦金,35,2,33,富邦-嘉義,2023-03-10,9692
4934,太極,32,0,32,富邦-嘉義,2023-03-10,9692
2891,中信金,32,0,32,富邦-嘉義,2023-03-10,9692
2633,台灣高鐵,31,0,31,富邦-嘉義,2023-03-10,9692
2365,昆盈,30,0,30,富邦-嘉義,2023-03-10,9692
00664R,國泰臺灣加權反1,30,0,30,富邦-嘉義,2023-03-10,9692
3093,港建*,51,22,29,富邦-嘉義,2023-03-10,9692
2359,所羅門,224,195,29,富邦-嘉義,2023-03-10,9692
2801,彰銀,29,0,29,富邦-嘉義,2023-03-10,9692
1712,興農,28,0,28,富邦-嘉義,2023-03-10,9692
1609,大亞,41,13,28,富邦-嘉義,2023-03-10,9692
3162,精確,45,17,28,富邦-嘉義,2023-03-10,9692
6806,森崴能源,27,0,27,富邦-嘉義,2023-03-10,9692
3710,連展投控,26,0,26,富邦-嘉義,2023-03-10,9692
1810,和成,29,5,24,富邦-嘉義,2023-03-10,9692
2313,華通,24,0,24,富邦-嘉義,2023-03-10,9692
6282,康舒,47,23,24,富邦-嘉義,2023-03-10,9692
3046,建��,463,439,24,富邦-嘉義,2023-03-10,9692
00885,富邦越南,29,5,24,富邦-嘉義,2023-03-10,9692
3501,維熹,25,2,23,富邦-嘉義,2023-03-10,9692
00655L,國泰中國A50正2,23,2,21,富邦-嘉義,2023-03-10,9692
8255,朋程,21,0,21,富邦-嘉義,2023-03-10,9692
00671R,富邦NASDAQ反1,20,0,20,富邦-嘉義,2023-03-10,9692
00632R,元大台灣50反1,961,166,795,富邦-嘉義,2023-03-13,9692
1504,東元,345,11,334,富邦-嘉義,2023-03-13,9692
1605,華新,321,67,254,富邦-嘉義,2023-03-13,9692
2201,裕隆,386,132,254,富邦-嘉義,2023-03-13,9692
2606,裕民,204,0,204,富邦-嘉義,2023-03-13,9692
00878,國泰永續高股息,308,108,200,富邦-嘉義,2023-03-13,9692
1316,上曜,280,130,150,富邦-嘉義,2023-03-13,9692
00715L,期街口布蘭特正2,175,43,132,富邦-嘉義,2023-03-13,9692
3481,群創,140,31,109,富邦-嘉義,2023-03-13,9692
00712,復華富時不動產,88,0,88,富邦-嘉義,2023-03-13,9692
2888,新光金,96,8,88,富邦-嘉義,2023-03-13,9692
00753L,中信中國50正2,86,2,84,富邦-嘉義,2023-03-13,9692
3046,建��,653,569,84,富邦-嘉義,2023-03-13,9692
2230,泰茂,75,2,73,富邦-嘉義,2023-03-13,9692
2812,台中銀,72,7,65,富邦-嘉義,2023-03-13,9692
00713,元大台灣高息低波,66,2,64,富邦-嘉義,2023-03-13,9692
1229,聯華,58,2,56,富邦-嘉義,2023-03-13,9692
9955,佳龍,115,63,52,富邦-嘉義,2023-03-13,9692
8069,元太,346,296,50,富邦-嘉義,2023-03-13,9692
2413,環科,450,401,49,富邦-嘉義,2023-03-13,9692
6191,精成科,46,3,43,富邦-嘉義,2023-03-13,9692
6180,橘子,51,10,41,富邦-嘉義,2023-03-13,9692
2884,玉山金,48,11,37,富邦-嘉義,2023-03-13,9692
6235,華孚,581,545,36,富邦-嘉義,2023-03-13,9692
2633,台灣高鐵,30,1,29,富邦-嘉義,2023-03-13,9692
00679B,元大美債20年,33,4,29,富邦-嘉義,2023-03-13,9692
3441,聯一光,60,32,28,富邦-嘉義,2023-03-13,9692
00773B,中信優先金融債,28,0,28,富邦-嘉義,2023-03-13,9692
2801,彰銀,27,0,27,富邦-嘉義,2023-03-13,9692
2636,台驊控股,656,629,27,富邦-嘉義,2023-03-13,9692
2881,富邦金,40,13,27,富邦-嘉義,2023-03-13,9692
2328,廣宇,26,1,25,富邦-嘉義,2023-03-13,9692
00676R,富邦臺灣加權反1,124,100,24,富邦-嘉義,2023-03-13,9692
6139,亞翔,26,3,23,富邦-嘉義,2023-03-13,9692
5009,榮剛,136,114,22,富邦-嘉義,2023-03-13,9692
2882,國泰金,24,3,21,富邦-嘉義,2023-03-13,9692
00892,富邦台灣半導體,21,0,21,富邦-嘉義,2023-03-13,9692
2457,飛宏,467,446,21,富邦-嘉義,2023-03-13,9692
2453,凌群,423,402,21,富邦-嘉義,2023-03-13,9692
2890,永豐金,32,11,21,富邦-嘉義,2023-03-13,9692
00640L,富邦日本正2,20,0,20,富邦-嘉義,2023-03-13,9692
00664R,國泰臺灣加權反1,20,0,20,富邦-嘉義,2023-03-13,9692
6443,元晶,38,21,17,富邦-嘉義,2023-03-13,9692
2610,華航,27,10,17,富邦-嘉義,2023-03-13,9692
3162,精確,123,106,17,富邦-嘉義,2023-03-13,9692
3093,港建*,58,42,16,富邦-嘉義,2023-03-13,9692
00642U,期元大S＆P石油,17,1,16,富邦-嘉義,2023-03-13,9692
9802,鈺齊-KY,17,1,16,富邦-嘉義,2023-03-13,9692
4903,聯光通,16,1,15,富邦-嘉義,2023-03-13,9692
3128,昇銳,15,1,14,富邦-嘉義,2023-03-13,9692
2603,長榮,5231,4538,693,富邦-嘉義,2023-03-14,9692
00878,國泰永續高股息,302,36,266,富邦-嘉義,2023-03-14,9692
00882,中信中國高股息,233,0,233,富邦-嘉義,2023-03-14,9692
8222,寶一,200,34,166,富邦-嘉義,2023-03-14,9692
00632R,元大台灣50反1,142,36,106,富邦-嘉義,2023-03-14,9692
2618,長榮航,124,23,101,富邦-嘉義,2023-03-14,9692
1701,中化,101,1,100,富邦-嘉義,2023-03-14,9692
2880,華南金,98,20,78,富邦-嘉義,2023-03-14,9692
2892,第一金,74,2,72,富邦-嘉義,2023-03-14,9692
2888,新光金,80,10,70,富邦-嘉義,2023-03-14,9692
2883,凱基金,113,47,66,富邦-嘉義,2023-03-14,9692
2834,臺企銀,97,35,62,富邦-嘉義,2023-03-14,9692
00642U,期元大S＆P石油,61,0,61,富邦-嘉義,2023-03-14,9692
0056,元大高股息,68,7,61,富邦-嘉義,2023-03-14,9692
3652,精聯,60,0,60,富邦-嘉義,2023-03-14,9692
2610,華航,83,24,59,富邦-嘉義,2023-03-14,9692
2303,聯電,71,13,58,富邦-嘉義,2023-03-14,9692
9955,佳龍,109,52,57,富邦-嘉義,2023-03-14,9692
00751B,元大AAA至A公司債,49,0,49,富邦-嘉義,2023-03-14,9692
2891,中信金,43,0,43,富邦-嘉義,2023-03-14,9692
2027,大成鋼,437,398,39,富邦-嘉義,2023-03-14,9692
2890,永豐金,39,1,38,富邦-嘉義,2023-03-14,9692
4915,致伸,43,5,38,富邦-嘉義,2023-03-14,9692
00713,元大台灣高息低波,49,12,37,富邦-嘉義,2023-03-14,9692
6770,力積電,40,3,37,富邦-嘉義,2023-03-14,9692
2884,玉山金,36,0,36,富邦-嘉義,2023-03-14,9692
2615,萬海,294,260,34,富邦-嘉義,2023-03-14,9692
2201,裕隆,75,42,33,富邦-嘉義,2023-03-14,9692
00637L,元大滬深300正2,33,0,33,富邦-嘉義,2023-03-14,9692
00664R,國泰臺灣加權反1,30,0,30,富邦-嘉義,2023-03-14,9692
1712,興農,30,0,30,富邦-嘉義,2023-03-14,9692
2801,彰銀,29,0,29,富邦-嘉義,2023-03-14,9692
8390,金益鼎,153,125,28,富邦-嘉義,2023-03-14,9692
2881,富邦金,28,3,25,富邦-嘉義,2023-03-14,9692
2328,廣宇,25,1,24,富邦-嘉義,2023-03-14,9692
00892,富邦台灣半導體,23,0,23,富邦-嘉義,2023-03-14,9692
2344,華邦電,26,3,23,富邦-嘉義,2023-03-14,9692
00712,復華富時不動產,67,45,22,富邦-嘉義,2023-03-14,9692
5880,合庫金,23,1,22,富邦-嘉義,2023-03-14,9692
2812,台中銀,21,0,21,富邦-嘉義,2023-03-14,9692
00651R,復華香港反1,20,0,20,富邦-嘉義,2023-03-14,9692
2409,友達,25,6,19,富邦-嘉義,2023-03-14,9692
2885,元大金,21,3,18,富邦-嘉義,2023-03-14,9692
4916,事欣科,18,0,18,富邦-嘉義,2023-03-14,9692
9945,潤泰新,18,1,17,富邦-嘉義,2023-03-14,9692
2609,陽明,1514,1497,17,富邦-嘉義,2023-03-14,9692
5009,榮剛,112,96,16,富邦-嘉義,2023-03-14,9692
8033,雷虎,23,8,15,富邦-嘉義,2023-03-14,9692
2354,鴻準,15,0,15,富邦-嘉義,2023-03-14,9692
2495,普安,34,20,14,富邦-嘉義,2023-03-14,9692
00715L,期街口布蘭特正2,305,30,275,富邦-嘉義,2023-03-15,9692
00632R,元大台灣50反1,202,30,172,富邦-嘉義,2023-03-15,9692
2371,大同,152,0,152,富邦-嘉義,2023-03-15,9692
2880,華南金,192,42,150,富邦-嘉義,2023-03-15,9692
00878,國泰永續高股息,144,6,138,富邦-嘉義,2023-03-15,9692
2312,金寶,107,2,105,富邦-嘉義,2023-03-15,9692
00679B,元大美債20年,105,2,103,富邦-嘉義,2023-03-15,9692
00706L,期元大S＆P日圓正2,99,0,99,富邦-嘉義,2023-03-15,9692
6243,迅杰,113,29,84,富邦-嘉義,2023-03-15,9692
2891,中信金,88,6,82,富邦-嘉義,2023-03-15,9692
3630,新鉅科,74,0,74,富邦-嘉義,2023-03-15,9692
2313,華通,72,0,72,富邦-嘉義,2023-03-15,9692
2243,宏旭-KY,192,138,54,富邦-嘉義,2023-03-15,9692
1312,國喬,51,1,50,富邦-嘉義,2023-03-15,9692
3056,富華新,50,0,50,富邦-嘉義,2023-03-15,9692
1712,興農,51,3,48,富邦-嘉義,2023-03-15,9692
2607,榮運,127,83,44,富邦-嘉義,2023-03-15,9692
00713,元大台灣高息低波,48,5,43,富邦-嘉義,2023-03-15,9692
2855,統一證,42,0,42,富邦-嘉義,2023-03-15,9692
2609,陽明,504,464,40,富邦-嘉義,2023-03-15,9692
3481,群創,40,1,39,富邦-嘉義,2023-03-15,9692
2614,東森,38,0,38,富邦-嘉義,2023-03-15,9692
00642U,期元大S＆P石油,39,1,38,富邦-嘉義,2023-03-15,9692
6470,宇智,37,1,36,富邦-嘉義,2023-03-15,9692
1762,中化生,40,5,35,富邦-嘉義,2023-03-15,9692
6799,來頡,273,238,35,富邦-嘉義,2023-03-15,9692
5880,合庫金,35,0,35,富邦-嘉義,2023-03-15,9692
2881,富邦金,45,10,35,富邦-嘉義,2023-03-15,9692
2834,臺企銀,47,17,30,富邦-嘉義,2023-03-15,9692
6770,力積電,32,4,28,富邦-嘉義,2023-03-15,9692
2888,新光金,34,7,27,富邦-嘉義,2023-03-15,9692
00892,富邦台灣半導體,40,14,26,富邦-嘉義,2023-03-15,9692
00671R,富邦NASDAQ反1,44,20,24,富邦-嘉義,2023-03-15,9692
00773B,中信優先金融債,27,4,23,富邦-嘉義,2023-03-15,9692
9907,統一實,22,0,22,富邦-嘉義,2023-03-15,9692
5608,四維航,28,6,22,富邦-嘉義,2023-03-15,9692
2890,永豐金,21,0,21,富邦-嘉義,2023-03-15,9692
3006,晶豪科,22,1,21,富邦-嘉義,2023-03-15,9692
1444,力麗,20,0,20,富邦-嘉義,2023-03-15,9692
3576,聯合再生,32,13,19,富邦-嘉義,2023-03-15,9692
8936,國統,21,2,19,富邦-嘉義,2023-03-15,9692
6472,保瑞,30,11,19,富邦-嘉義,2023-03-15,9692
4157,太景*-KY,18,0,18,富邦-嘉義,2023-03-15,9692
4960,誠美材,18,0,18,富邦-嘉義,2023-03-15,9692
00676R,富邦臺灣加權反1,18,1,17,富邦-嘉義,2023-03-15,9692
1229,聯華,19,2,17,富邦-嘉義,2023-03-15,9692
8171,天宇,18,1,17,富邦-嘉義,2023-03-15,9692
2027,大成鋼,33,16,17,富邦-嘉義,2023-03-15,9692
1720,生達,22,6,16,富邦-嘉義,2023-03-15,9692
5425,台半,205,189,16,富邦-嘉義,2023-03-15,9692
00715L,期街口布蘭特正2,518,20,498,富邦-嘉義,2023-03-16,9692
2457,飛宏,530,231,299,富邦-嘉義,2023-03-16,9692
2834,臺企銀,1715,1529,186,富邦-嘉義,2023-03-16,9692
8069,元太,287,131,156,富邦-嘉義,2023-03-16,9692
00878,國泰永續高股息,199,43,156,富邦-嘉義,2023-03-16,9692
00632R,元大台灣50反1,149,28,121,富邦-嘉義,2023-03-16,9692
2438,翔耀,106,1,105,富邦-嘉義,2023-03-16,9692
00706L,期元大S＆P日圓正2,97,0,97,富邦-嘉義,2023-03-16,9692
2867,三商壽,131,37,94,富邦-嘉義,2023-03-16,9692
6235,華孚,157,64,93,富邦-嘉義,2023-03-16,9692
2884,玉山金,98,20,78,富邦-嘉義,2023-03-16,9692
2313,華通,91,15,76,富邦-嘉義,2023-03-16,9692
2891,中信金,97,23,74,富邦-嘉義,2023-03-16,9692
5880,合庫金,65,4,61,富邦-嘉義,2023-03-16,9692
6244,茂迪,80,21,59,富邦-嘉義,2023-03-16,9692
2883,凱基金,87,29,58,富邦-嘉義,2023-03-16,9692
2880,華南金,56,4,52,富邦-嘉義,2023-03-16,9692
2380,虹光,50,0,50,富邦-嘉義,2023-03-16,9692
00713,元大台灣高息低波,47,3,44,富邦-嘉義,2023-03-16,9692
9955,佳龍,132,92,40,富邦-嘉義,2023-03-16,9692
2603,長榮,717,678,39,富邦-嘉義,2023-03-16,9692
1720,生達,47,9,38,富邦-嘉義,2023-03-16,9692
6182,合晶,60,24,36,富邦-嘉義,2023-03-16,9692
1101,台泥,37,5,32,富邦-嘉義,2023-03-16,9692
2317,鴻海,33,1,32,富邦-嘉義,2023-03-16,9692
2887,台新金,32,2,30,富邦-嘉義,2023-03-16,9692
00634R,富邦上証反1,30,0,30,富邦-嘉義,2023-03-16,9692
6550,北極星藥業-KY,33,3,30,富邦-嘉義,2023-03-16,9692
2812,台中銀,64,34,30,富邦-嘉義,2023-03-16,9692
5603,陸海,38,10,28,富邦-嘉義,2023-03-16,9692
2027,大成鋼,41,13,28,富邦-嘉義,2023-03-16,9692
2609,陽明,55,27,28,富邦-嘉義,2023-03-16,9692
2332,友訊,29,2,27,富邦-嘉義,2023-03-16,9692
3481,群創,60,34,26,富邦-嘉義,2023-03-16,9692
2882,國泰金,31,4,27,富邦-嘉義,2023-03-16,9692
00712,復華富時不動產,27,1,26,富邦-嘉義,2023-03-16,9692
2881,富邦金,27,2,25,富邦-嘉義,2023-03-16,9692
2331,精英,25,1,24,富邦-嘉義,2023-03-16,9692
3006,晶豪科,25,1,24,富邦-嘉義,2023-03-16,9692
6449,鈺邦,24,0,24,富邦-嘉義,2023-03-16,9692
9945,潤泰新,75,53,22,富邦-嘉義,2023-03-16,9692
1605,華新,37,15,22,富邦-嘉義,2023-03-16,9692
1711,永光,21,0,21,富邦-嘉義,2023-03-16,9692
1514,亞力,24,3,21,富邦-嘉義,2023-03-16,9692
2890,永豐金,26,6,20,富邦-嘉義,2023-03-16,9692
2855,統一證,20,0,20,富邦-嘉義,2023-03-16,9692
2014,中鴻,29,10,19,富邦-嘉義,2023-03-16,9692
3162,精確,23,5,18,富邦-嘉義,2023-03-16,9692
3652,精聯,21,3,18,富邦-嘉義,2023-03-16,9692
2618,長榮航,42,25,17,富邦-嘉義,2023-03-16,9692
2888,新光金,226,4,222,富邦-嘉義,2023-03-17,9692
3037,欣興,202,12,190,富邦-嘉義,2023-03-17,9692
1605,華新,225,67,158,富邦-嘉義,2023-03-17,9692
00885,富邦越南,137,0,137,富邦-嘉義,2023-03-17,9692
2364,倫飛,125,1,124,富邦-嘉義,2023-03-17,9692
00715L,期街口布蘭特正2,116,5,111,富邦-嘉義,2023-03-17,9692
00878,國泰永續高股息,162,76,86,富邦-嘉義,2023-03-17,9692
2891,中信金,93,8,85,富邦-嘉義,2023-03-17,9692
00706L,期元大S＆P日圓正2,84,0,84,富邦-嘉義,2023-03-17,9692
2201,裕隆,272,193,79,富邦-嘉義,2023-03-17,9692
00712,復華富時不動產,78,0,78,富邦-嘉義,2023-03-17,9692
2453,凌群,404,330,74,富邦-嘉義,2023-03-17,9692
6163,華電網,227,160,67,富邦-嘉義,2023-03-17,9692
00713,元大台灣高息低波,61,0,61,富邦-嘉義,2023-03-17,9692
00679B,元大美債20年,57,0,57,富邦-嘉義,2023-03-17,9692
00681R,元大美債20反1,50,0,50,富邦-嘉義,2023-03-17,9692
5340,建榮,50,1,49,富邦-嘉義,2023-03-17,9692
00902,中信電池及儲能,43,0,43,富邦-嘉義,2023-03-17,9692
6753,龍德造船,41,1,40,富邦-嘉義,2023-03-17,9692
8033,雷虎,42,3,39,富邦-嘉義,2023-03-17,9692
2880,華南金,41,4,37,富邦-嘉義,2023-03-17,9692
8936,國統,34,4,30,富邦-嘉義,2023-03-17,9692
2609,陽明,35,8,27,富邦-嘉義,2023-03-17,9692
4111,濟生,25,0,25,富邦-嘉義,2023-03-17,9692
2438,翔耀,25,1,24,富邦-嘉義,2023-03-17,9692
3652,精聯,23,0,23,富邦-嘉義,2023-03-17,9692
9103,美德醫療-DR,23,0,23,富邦-嘉義,2023-03-17,9692
1326,台化,23,1,22,富邦-嘉義,2023-03-17,9692
2023,燁輝,24,2,22,富邦-嘉義,2023-03-17,9692
2230,泰茂,27,5,22,富邦-嘉義,2023-03-17,9692
3479,安勤,32,10,22,富邦-嘉義,2023-03-17,9692
00725B,國泰投資級公司債,22,0,22,富邦-嘉義,2023-03-17,9692
9904,寶成,21,0,21,富邦-嘉義,2023-03-17,9692
2618,長榮航,34,13,21,富邦-嘉義,2023-03-17,9692
2313,華通,22,1,21,富邦-嘉義,2023-03-17,9692
3056,富華新,27,6,21,富邦-嘉義,2023-03-17,9692
3217,優群,309,288,21,富邦-嘉義,2023-03-17,9692
2885,元大金,20,0,20,富邦-嘉義,2023-03-17,9692
020034,元大IC設計N,20,0,20,富邦-嘉義,2023-03-17,9692
2883,凱基金,28,9,19,富邦-嘉義,2023-03-17,9692
2014,中鴻,34,15,19,富邦-嘉義,2023-03-17,9692
2890,永豐金,18,0,18,富邦-嘉義,2023-03-17,9692
8176,智捷,20,2,18,富邦-嘉義,2023-03-17,9692
5425,台半,45,27,18,富邦-嘉義,2023-03-17,9692
2834,臺企銀,105,88,17,富邦-嘉義,2023-03-17,9692
1101,台泥,18,2,16,富邦-嘉義,2023-03-17,9692
3686,達能,16,0,16,富邦-嘉義,2023-03-17,9692
1319,東陽,15,1,14,富邦-嘉義,2023-03-17,9692
1513,中興電,40,26,14,富邦-嘉義,2023-03-17,9692
3362,先進光,19,6,13,富邦-嘉義,2023-03-17,9692
2453,凌群,716,306,410,富邦-嘉義,2023-03-20,9692
6233,旺玖,126,12,114,富邦-嘉義,2023-03-20,9692
00878,國泰永續高股息,106,6,100,富邦-嘉義,2023-03-20,9692
00706L,期元大S＆P日圓正2,99,0,99,富邦-嘉義,2023-03-20,9692
2471,資通,413,322,91,富邦-嘉義,2023-03-20,9692
2303,聯電,122,31,91,富邦-嘉義,2023-03-20,9692
3046,建��,836,752,84,富邦-嘉義,2023-03-20,9692
00632R,元大台灣50反1,73,2,71,富邦-嘉義,2023-03-20,9692
6235,華孚,102,31,71,富邦-嘉義,2023-03-20,9692
3231,緯創,72,18,54,富邦-嘉義,2023-03-20,9692
5211,蒙恬,57,5,52,富邦-嘉義,2023-03-20,9692
2880,華南金,52,2,50,富邦-嘉義,2023-03-20,9692
2890,永豐金,72,25,47,富邦-嘉義,2023-03-20,9692
8222,寶一,125,79,46,富邦-嘉義,2023-03-20,9692
2313,華通,57,12,45,富邦-嘉義,2023-03-20,9692
9955,佳龍,49,6,43,富邦-嘉義,2023-03-20,9692
00902,中信電池及儲能,38,0,38,富邦-嘉義,2023-03-20,9692
00712,復華富時不動產,41,6,35,富邦-嘉義,2023-03-20,9692
4716,大立,35,0,35,富邦-嘉義,2023-03-20,9692
2342,茂矽,81,47,34,富邦-嘉義,2023-03-20,9692
2636,台驊控股,35,1,34,富邦-嘉義,2023-03-20,9692
8033,雷虎,113,80,33,富邦-嘉義,2023-03-20,9692
6163,華電網,40,7,33,富邦-嘉義,2023-03-20,9692
2634,漢翔,53,21,32,富邦-嘉義,2023-03-20,9692
00664R,國泰臺灣加權反1,31,0,31,富邦-嘉義,2023-03-20,9692
2882,國泰金,33,4,29,富邦-嘉義,2023-03-20,9692
5512,力麒,45,20,25,富邦-嘉義,2023-03-20,9692
2867,三商壽,24,0,24,富邦-嘉義,2023-03-20,9692
6148,驊宏資,76,52,24,富邦-嘉義,2023-03-20,9692
2881,富邦金,35,11,24,富邦-嘉義,2023-03-20,9692
8996,高力,22,1,21,富邦-嘉義,2023-03-20,9692
00651R,復華香港反1,20,0,20,富邦-嘉義,2023-03-20,9692
3162,精確,53,33,20,富邦-嘉義,2023-03-20,9692
00671R,富邦NASDAQ反1,20,0,20,富邦-嘉義,2023-03-20,9692
00634R,富邦上証反1,20,0,20,富邦-嘉義,2023-03-20,9692
6026,福邦證,20,0,20,富邦-嘉義,2023-03-20,9692
6443,元晶,288,268,20,富邦-嘉義,2023-03-20,9692
1603,華電,25,6,19,富邦-嘉義,2023-03-20,9692
4977,眾達-KY,33,14,19,富邦-嘉義,2023-03-20,9692
4967,十銓,246,229,17,富邦-嘉義,2023-03-20,9692
2014,中鴻,27,11,16,富邦-嘉義,2023-03-20,9692
00715L,期街口布蘭特正2,115,100,15,富邦-嘉義,2023-03-20,9692
8440,綠電,16,1,15,富邦-嘉義,2023-03-20,9692
1712,興農,23,8,15,富邦-嘉義,2023-03-20,9692
00753L,中信中國50正2,14,0,14,富邦-嘉義,2023-03-20,9692
1442,名軒,14,0,14,富邦-嘉義,2023-03-20,9692
2603,長榮,580,567,13,富邦-嘉義,2023-03-20,9692
2915,潤泰全,21,8,13,富邦-嘉義,2023-03-20,9692
9907,統一實,14,1,13,富邦-嘉義,2023-03-20,9692
2455,全新,20,8,12,富邦-嘉義,2023-03-20,9692
6140,訊達,509,126,383,富邦-嘉義,2023-03-21,9692
3013,晟銘電,523,170,353,富邦-嘉義,2023-03-21,9692
6109,亞元,350,0,350,富邦-嘉義,2023-03-21,9692
1524,耿鼎,312,33,279,富邦-嘉義,2023-03-21,9692
2201,裕隆,593,356,237,富邦-嘉義,2023-03-21,9692
1529,樂事綠能,305,154,151,富邦-嘉義,2023-03-21,9692
2427,三商電,160,60,100,富邦-嘉義,2023-03-21,9692
6288,聯嘉,106,7,99,富邦-嘉義,2023-03-21,9692
3432,台端,267,172,95,富邦-嘉義,2023-03-21,9692
2890,永豐金,105,14,91,富邦-嘉義,2023-03-21,9692
2303,聯電,122,36,86,富邦-嘉義,2023-03-21,9692
6223,旺矽,73,4,69,富邦-嘉義,2023-03-21,9692
2482,連宇,310,246,64,富邦-嘉義,2023-03-21,9692
2438,翔耀,55,0,55,富邦-嘉義,2023-03-21,9692
00706L,期元大S＆P日圓正2,51,0,51,富邦-嘉義,2023-03-21,9692
5469,瀚宇博,50,1,49,富邦-嘉義,2023-03-21,9692
2888,新光金,123,75,48,富邦-嘉義,2023-03-21,9692
5258,虹堡,65,20,45,富邦-嘉義,2023-03-21,9692
00878,國泰永續高股息,44,4,40,富邦-嘉義,2023-03-21,9692
2618,長榮航,39,0,39,富邦-嘉義,2023-03-21,9692
3661,世芯-KY,357,320,37,富邦-嘉義,2023-03-21,9692
6531,愛普*,172,139,33,富邦-嘉義,2023-03-21,9692
00715L,期街口布蘭特正2,52,19,33,富邦-嘉義,2023-03-21,9692
00679B,元大美債20年,34,1,33,富邦-嘉義,2023-03-21,9692
3712,永崴投控,32,1,31,富邦-嘉義,2023-03-21,9692
2610,華航,35,5,30,富邦-嘉義,2023-03-21,9692
00902,中信電池及儲能,29,0,29,富邦-嘉義,2023-03-21,9692
2881,富邦金,29,1,28,富邦-嘉義,2023-03-21,9692
6443,元晶,73,46,27,富邦-嘉義,2023-03-21,9692
00885,富邦越南,24,0,24,富邦-嘉義,2023-03-21,9692
2328,廣宇,28,5,23,富邦-嘉義,2023-03-21,9692
2388,威盛,101,79,22,富邦-嘉義,2023-03-21,9692
00892,富邦台灣半導體,22,0,22,富邦-嘉義,2023-03-21,9692
5009,榮剛,352,330,22,富邦-嘉義,2023-03-21,9692
5403,中菲,21,0,21,富邦-嘉義,2023-03-21,9692
1605,華新,51,30,21,富邦-嘉義,2023-03-21,9692
6276,安鈦克,20,0,20,富邦-嘉義,2023-03-21,9692
00904,新光臺灣半導體30,20,0,20,富邦-嘉義,2023-03-21,9692
2609,陽明,20,2,18,富邦-嘉義,2023-03-21,9692
5353,台林,154,136,18,富邦-嘉義,2023-03-21,9692
1611,中電,25,8,17,富邦-嘉義,2023-03-21,9692
6770,力積電,35,18,17,富邦-嘉義,2023-03-21,9692
3346,麗清,18,1,17,富邦-嘉義,2023-03-21,9692
3029,零壹,149,132,17,富邦-嘉義,2023-03-21,9692
1560,中砂,17,1,16,富邦-嘉義,2023-03-21,9692
2033,佳大,15,0,15,富邦-嘉義,2023-03-21,9692
6112,邁達特,18,3,15,富邦-嘉義,2023-03-21,9692
00680L,元大美債20正2,14,0,14,富邦-嘉義,2023-03-21,9692
2342,茂矽,17,3,14,富邦-嘉義,2023-03-21,9692
2882,國泰金,17,3,14,富邦-嘉義,2023-03-21,9692
5425,台半,1491,437,1054,富邦-嘉義,2023-03-22,9692
6223,旺矽,1353,527,826,富邦-嘉義,2023-03-22,9692
3017,奇鋐,1946,1319,627,富邦-嘉義,2023-03-22,9692
2303,聯電,506,35,471,富邦-嘉義,2023-03-22,9692
8069,元太,411,10,401,富邦-嘉義,2023-03-22,9692
2402,毅嘉,504,200,304,富邦-嘉義,2023-03-22,9692
3628,盈正,310,10,300,富邦-嘉義,2023-03-22,9692
00679B,元大美債20年,202,0,202,富邦-嘉義,2023-03-22,9692
1453,大將,173,6,167,富邦-嘉義,2023-03-22,9692
00753L,中信中國50正2,160,7,153,富邦-嘉義,2023-03-22,9692
3443,創意,106,6,100,富邦-嘉義,2023-03-22,9692
1504,東元,1019,956,63,富邦-嘉義,2023-03-22,9692
2409,友達,64,5,59,富邦-嘉義,2023-03-22,9692
3483,力致,85,29,56,富邦-嘉義,2023-03-22,9692
2438,翔耀,51,0,51,富邦-嘉義,2023-03-22,9692
3027,盛達,164,113,51,富邦-嘉義,2023-03-22,9692
00902,中信電池及儲能,50,0,50,富邦-嘉義,2023-03-22,9692
4123,晟德,50,0,50,富邦-嘉義,2023-03-22,9692
00715L,期街口布蘭特正2,56,10,46,富邦-嘉義,2023-03-22,9692
00878,國泰永續高股息,53,9,44,富邦-嘉義,2023-03-22,9692
00712,復華富時不動產,41,0,41,富邦-嘉義,2023-03-22,9692
6715,嘉基,74,33,41,富邦-嘉義,2023-03-22,9692
3217,優群,79,42,37,富邦-嘉義,2023-03-22,9692
2388,威盛,43,9,34,富邦-嘉義,2023-03-22,9692
2495,普安,32,1,31,富邦-嘉義,2023-03-22,9692
6163,華電網,36,6,30,富邦-嘉義,2023-03-22,9692
5353,台林,131,106,25,富邦-嘉義,2023-03-22,9692
6190,萬泰科,25,0,25,富邦-嘉義,2023-03-22,9692
6443,元晶,35,11,24,富邦-嘉義,2023-03-22,9692
2359,所羅門,27,3,24,富邦-嘉義,2023-03-22,9692
3499,環天科,24,1,23,富邦-嘉義,2023-03-22,9692
2886,兆豐金,26,3,23,富邦-嘉義,2023-03-22,9692
1304,台聚,22,0,22,富邦-嘉義,2023-03-22,9692
3038,全台,82,60,22,富邦-嘉義,2023-03-22,9692
2453,凌群,253,232,21,富邦-嘉義,2023-03-22,9692
00904,新光臺灣半導體30,40,20,20,富邦-嘉義,2023-03-22,9692
2419,仲琦,20,0,20,富邦-嘉義,2023-03-22,9692
3056,富華新,25,6,19,富邦-嘉義,2023-03-22,9692
3652,精聯,51,32,19,富邦-嘉義,2023-03-22,9692
2344,華邦電,34,16,18,富邦-嘉義,2023-03-22,9692
00680L,元大美債20正2,18,0,18,富邦-嘉義,2023-03-22,9692
2915,潤泰全,17,0,17,富邦-嘉義,2023-03-22,9692
00669R,國泰美國道瓊反1,19,3,16,富邦-嘉義,2023-03-22,9692
2399,映泰,18,2,16,富邦-嘉義,2023-03-22,9692
3029,零壹,24,8,16,富邦-嘉義,2023-03-22,9692
8478,東哥遊艇,163,147,16,富邦-嘉義,2023-03-22,9692
2618,長榮航,20,4,16,富邦-嘉義,2023-03-22,9692
6231,系微,82,67,15,富邦-嘉義,2023-03-22,9692
2421,建準,23,8,15,富邦-嘉義,2023-03-22,9692
6874,倍力,15,0,15,富邦-嘉義,2023-03-22,9692
00632R,元大台灣50反1,1166,351,815,富邦-嘉義,2023-03-23,9692
4702,中美實,499,0,499,富邦-嘉義,2023-03-23,9692
2201,裕隆,178,13,165,富邦-嘉義,2023-03-23,9692
6122,擎邦,262,100,162,富邦-嘉義,2023-03-23,9692
4743,合一,161,6,155,富邦-嘉義,2023-03-23,9692
2486,一詮,148,13,135,富邦-嘉義,2023-03-23,9692
6116,彩晶,121,1,120,富邦-嘉義,2023-03-23,9692
1101,台泥,119,2,117,富邦-嘉義,2023-03-23,9692
2454,聯發科,100,1,99,富邦-嘉義,2023-03-23,9692
6109,亞元,105,12,93,富邦-嘉義,2023-03-23,9692
8401,白紗科,62,0,62,富邦-嘉義,2023-03-23,9692
1529,樂事綠能,178,117,61,富邦-嘉義,2023-03-23,9692
6863,永道-KY,57,0,57,富邦-嘉義,2023-03-23,9692
00878,國泰永續高股息,128,78,50,富邦-嘉義,2023-03-23,9692
2482,連宇,50,1,49,富邦-嘉義,2023-03-23,9692
2027,大成鋼,52,3,49,富邦-嘉義,2023-03-23,9692
8046,南電,51,6,45,富邦-嘉義,2023-03-23,9692
5475,德宏,57,13,44,富邦-嘉義,2023-03-23,9692
3162,精確,115,72,43,富邦-嘉義,2023-03-23,9692
00637L,元大滬深300正2,91,51,40,富邦-嘉義,2023-03-23,9692
2453,凌群,103,65,38,富邦-嘉義,2023-03-23,9692
00882,中信中國高股息,36,0,36,富邦-嘉義,2023-03-23,9692
1314,中石化,36,0,36,富邦-嘉義,2023-03-23,9692
3693,營邦,39,3,36,富邦-嘉義,2023-03-23,9692
3481,群創,217,183,34,富邦-嘉義,2023-03-23,9692
2105,正新,35,2,33,富邦-嘉義,2023-03-23,9692
3675,德微,28,1,27,富邦-嘉義,2023-03-23,9692
4155,訊映,36,9,27,富邦-嘉義,2023-03-23,9692
3362,先進光,94,67,27,富邦-嘉義,2023-03-23,9692
00712,復華富時不動產,41,15,26,富邦-嘉義,2023-03-23,9692
8069,元太,25,0,25,富邦-嘉義,2023-03-23,9692
00897,富邦基因免疫生技,24,0,24,富邦-嘉義,2023-03-23,9692
2614,東森,24,0,24,富邦-嘉義,2023-03-23,9692
5284,jpp-KY,93,71,22,富邦-嘉義,2023-03-23,9692
2303,聯電,26,5,21,富邦-嘉義,2023-03-23,9692
2204,中華,27,6,21,富邦-嘉義,2023-03-23,9692
6576,逸達,21,0,21,富邦-嘉義,2023-03-23,9692
00671R,富邦NASDAQ反1,20,0,20,富邦-嘉義,2023-03-23,9692
2641,正德,22,2,20,富邦-嘉義,2023-03-23,9692
5222,全訊,160,140,20,富邦-嘉義,2023-03-23,9692
00679B,元大美債20年,19,0,19,富邦-嘉義,2023-03-23,9692
1584,精剛,23,4,19,富邦-嘉義,2023-03-23,9692
2603,長榮,21,3,18,富邦-嘉義,2023-03-23,9692
1609,大亞,17,0,17,富邦-嘉義,2023-03-23,9692
6134,萬旭,37,20,17,富邦-嘉義,2023-03-23,9692
3499,環天科,72,55,17,富邦-嘉義,2023-03-23,9692
3441,聯一光,48,31,17,富邦-嘉義,2023-03-23,9692
8478,東哥遊艇,138,121,17,富邦-嘉義,2023-03-23,9692
2617,台航,16,0,16,富邦-嘉義,2023-03-23,9692
3715,定穎投控,16,0,16,富邦-嘉義,2023-03-23,9692
8222,寶一,400,84,316,富邦-嘉義,2023-03-24,9692
2201,裕隆,386,144,242,富邦-嘉義,2023-03-24,9692
6288,聯嘉,592,372,220,富邦-嘉義,2023-03-24,9692
4162,智擎,154,10,144,富邦-嘉義,2023-03-24,9692
2204,中華,135,5,130,富邦-嘉義,2023-03-24,9692
8069,元太,367,242,125,富邦-嘉義,2023-03-24,9692
00665L,富邦�琤肭磪囓�2,108,2,106,富邦-嘉義,2023-03-24,9692
2329,華泰,100,0,100,富邦-嘉義,2023-03-24,9692
1519,華城,100,8,92,富邦-嘉義,2023-03-24,9692
5425,台半,85,14,71,富邦-嘉義,2023-03-24,9692
3029,零壹,59,5,54,富邦-嘉義,2023-03-24,9692
2883,凱基金,81,28,53,富邦-嘉義,2023-03-24,9692
2371,大同,53,2,51,富邦-嘉義,2023-03-24,9692
00706L,期元大S＆P日圓正2,50,0,50,富邦-嘉義,2023-03-24,9692
3664,安瑞-KY,50,3,47,富邦-嘉義,2023-03-24,9692
1503,士電,47,0,47,富邦-嘉義,2023-03-24,9692
3037,欣興,121,76,45,富邦-嘉義,2023-03-24,9692
3594,磐儀,47,3,44,富邦-嘉義,2023-03-24,9692
00893,國泰智能電動車,51,16,35,富邦-嘉義,2023-03-24,9692
3035,智原,855,821,34,富邦-嘉義,2023-03-24,9692
3017,奇鋐,142,109,33,富邦-嘉義,2023-03-24,9692
2891,中信金,36,4,32,富邦-嘉義,2023-03-24,9692
6443,元晶,35,3,32,富邦-嘉義,2023-03-24,9692
3501,維熹,34,4,30,富邦-嘉義,2023-03-24,9692
3441,聯一光,57,29,28,富邦-嘉義,2023-03-24,9692
1314,中石化,26,0,26,富邦-嘉義,2023-03-24,9692
2457,飛宏,31,7,24,富邦-嘉義,2023-03-24,9692
2034,允強,22,0,22,富邦-嘉義,2023-03-24,9692
4562,穎漢,21,0,21,富邦-嘉義,2023-03-24,9692
2634,漢翔,36,16,20,富邦-嘉義,2023-03-24,9692
8401,白紗科,20,0,20,富邦-嘉義,2023-03-24,9692
2618,長榮航,23,4,19,富邦-嘉義,2023-03-24,9692
3624,光頡,19,0,19,富邦-嘉義,2023-03-24,9692
2340,台亞,23,5,18,富邦-嘉義,2023-03-24,9692
6733,博晟生醫,29,11,18,富邦-嘉義,2023-03-24,9692
4995,晶達,22,6,16,富邦-嘉義,2023-03-24,9692
4979,華星光,22,6,16,富邦-嘉義,2023-03-24,9692
2342,茂矽,23,7,16,富邦-嘉義,2023-03-24,9692
6161,捷波,16,0,16,富邦-嘉義,2023-03-24,9692
8936,國統,22,6,16,富邦-嘉義,2023-03-24,9692
00882,中信中國高股息,16,1,15,富邦-嘉義,2023-03-24,9692
6168,宏齊,33,18,15,富邦-嘉義,2023-03-24,9692
2002,中鋼,15,0,15,富邦-嘉義,2023-03-24,9692
3306,鼎天,16,2,14,富邦-嘉義,2023-03-24,9692
6664,群翊,15,1,14,富邦-嘉義,2023-03-24,9692
00676R,富邦臺灣加權反1,14,0,14,富邦-嘉義,2023-03-24,9692
1504,東元,1041,1028,13,富邦-嘉義,2023-03-24,9692
3046,建��,38,25,13,富邦-嘉義,2023-03-24,9692
6840,東研信超,14,1,13,富邦-嘉義,2023-03-24,9692
1308,亞聚,13,0,13,富邦-嘉義,2023-03-24,9692
1584,精剛,615,266,349,富邦-嘉義,2023-03-27,9692
00753L,中信中國50正2,162,14,148,富邦-嘉義,2023-03-27,9692
2438,翔耀,146,3,143,富邦-嘉義,2023-03-27,9692
6152,百一,125,21,104,富邦-嘉義,2023-03-27,9692
8033,雷虎,122,25,97,富邦-嘉義,2023-03-27,9692
5211,蒙恬,194,101,93,富邦-嘉義,2023-03-27,9692
6443,元晶,121,30,91,富邦-嘉義,2023-03-27,9692
4971,IET-KY,89,1,88,富邦-嘉義,2023-03-27,9692
1605,華新,214,129,85,富邦-嘉義,2023-03-27,9692
3025,星通,100,18,82,富邦-嘉義,2023-03-27,9692
3338,泰碩,89,16,73,富邦-嘉義,2023-03-27,9692
2371,大同,68,0,68,富邦-嘉義,2023-03-27,9692
4960,誠美材,64,0,64,富邦-嘉義,2023-03-27,9692
00900,富邦特選高股息30,81,18,63,富邦-嘉義,2023-03-27,9692
2204,中華,63,0,63,富邦-嘉義,2023-03-27,9692
6753,龍德造船,58,0,58,富邦-嘉義,2023-03-27,9692
1504,東元,216,158,58,富邦-嘉義,2023-03-27,9692
6122,擎邦,150,94,56,富邦-嘉義,2023-03-27,9692
00882,中信中國高股息,54,0,54,富邦-嘉義,2023-03-27,9692
2890,永豐金,100,47,53,富邦-嘉義,2023-03-27,9692
1760,寶齡富錦,66,13,53,富邦-嘉義,2023-03-27,9692
4162,智擎,51,0,51,富邦-嘉義,2023-03-27,9692
00638R,元大滬深300反1,50,0,50,富邦-嘉義,2023-03-27,9692
2634,漢翔,144,95,49,富邦-嘉義,2023-03-27,9692
5222,全訊,113,66,47,富邦-嘉義,2023-03-27,9692
3402,漢科,47,0,47,富邦-嘉義,2023-03-27,9692
00665L,富邦�琤肭磪囓�2,129,84,45,富邦-嘉義,2023-03-27,9692
4916,事欣科,219,177,42,富邦-嘉義,2023-03-27,9692
2641,正德,56,15,41,富邦-嘉義,2023-03-27,9692
1609,大亞,143,102,41,富邦-嘉義,2023-03-27,9692
1314,中石化,37,0,37,富邦-嘉義,2023-03-27,9692
2645,長榮航太,35,1,34,富邦-嘉義,2023-03-27,9692
4541,晟田,155,124,31,富邦-嘉義,2023-03-27,9692
3712,永崴投控,30,1,29,富邦-嘉義,2023-03-27,9692
2392,正崴,31,3,28,富邦-嘉義,2023-03-27,9692
1101,台泥,33,6,27,富邦-嘉義,2023-03-27,9692
2014,中鴻,28,2,26,富邦-嘉義,2023-03-27,9692
2867,三商壽,26,4,22,富邦-嘉義,2023-03-27,9692
1701,中化,22,1,21,富邦-嘉義,2023-03-27,9692
3056,富華新,23,3,20,富邦-嘉義,2023-03-27,9692
5608,四維航,20,0,20,富邦-嘉義,2023-03-27,9692
4930,燦星網,19,0,19,富邦-嘉義,2023-03-27,9692
1795,美時,41,22,19,富邦-嘉義,2023-03-27,9692
2327,國巨,19,0,19,富邦-嘉義,2023-03-27,9692
2618,長榮航,20,1,19,富邦-嘉義,2023-03-27,9692
6698,旭暉應材,20,1,19,富邦-嘉義,2023-03-27,9692
6160,欣技,44,25,19,富邦-嘉義,2023-03-27,9692
3715,定穎投控,337,319,18,富邦-嘉義,2023-03-27,9692
6606,建德工業,21,4,17,富邦-嘉義,2023-03-27,9692
00650L,復華香港正2,16,0,16,富邦-嘉義,2023-03-27,9692
00882,中信中國高股息,111,0,111,富邦-嘉義,2023-03-28,9692
00679B,元大美債20年,107,4,103,富邦-嘉義,2023-03-28,9692
1605,華新,286,218,68,富邦-嘉義,2023-03-28,9692
00665L,富邦�琤肭磪囓�2,142,83,59,富邦-嘉義,2023-03-28,9692
2504,國產,52,0,52,富邦-嘉義,2023-03-28,9692
00673R,期元大S＆P原油反1,51,0,51,富邦-嘉義,2023-03-28,9692
6235,華孚,59,10,49,富邦-嘉義,2023-03-28,9692
3011,今皓,49,5,44,富邦-嘉義,2023-03-28,9692
2317,鴻海,51,11,40,富邦-嘉義,2023-03-28,9692
2412,中華電,40,0,40,富邦-嘉義,2023-03-28,9692
2303,聯電,42,7,35,富邦-嘉義,2023-03-28,9692
4919,新唐,34,1,33,富邦-嘉義,2023-03-28,9692
2438,翔耀,33,1,32,富邦-嘉義,2023-03-28,9692
3362,先進光,31,2,29,富邦-嘉義,2023-03-28,9692
3272,東碩,48,21,27,富邦-嘉義,2023-03-28,9692
0056,元大高股息,27,0,27,富邦-嘉義,2023-03-28,9692
00751B,元大AAA至A公司債,26,0,26,富邦-嘉義,2023-03-28,9692
3706,神達,25,0,25,富邦-嘉義,2023-03-28,9692
1444,力麗,24,0,24,富邦-嘉義,2023-03-28,9692
4979,華星光,280,260,20,富邦-嘉義,2023-03-28,9692
6770,力積電,26,6,20,富邦-嘉義,2023-03-28,9692
9945,潤泰新,20,0,20,富邦-嘉義,2023-03-28,9692
00892,富邦台灣半導體,20,0,20,富邦-嘉義,2023-03-28,9692
3652,精聯,240,220,20,富邦-嘉義,2023-03-28,9692
3035,智原,346,327,19,富邦-嘉義,2023-03-28,9692
3710,連展投控,19,0,19,富邦-嘉義,2023-03-28,9692
3447,展達,20,2,18,富邦-嘉義,2023-03-28,9692
3162,精確,53,36,17,富邦-嘉義,2023-03-28,9692
2641,正德,22,5,17,富邦-嘉義,2023-03-28,9692
3019,亞光,20,4,16,富邦-嘉義,2023-03-28,9692
6441,廣錠,16,0,16,富邦-嘉義,2023-03-28,9692
006208,富邦台50,17,2,15,富邦-嘉義,2023-03-28,9692
1708,東鹼,18,3,15,富邦-嘉義,2023-03-28,9692
2388,威盛,47,32,15,富邦-嘉義,2023-03-28,9692
00664R,國泰臺灣加權反1,15,0,15,富邦-嘉義,2023-03-28,9692
3006,晶豪科,19,5,14,富邦-嘉義,2023-03-28,9692
6197,佳必琪,13,0,13,富邦-嘉義,2023-03-28,9692
1609,大亞,20,7,13,富邦-嘉義,2023-03-28,9692
5512,力麒,13,0,13,富邦-嘉義,2023-03-28,9692
00680L,元大美債20正2,13,0,13,富邦-嘉義,2023-03-28,9692
2409,友達,13,1,12,富邦-嘉義,2023-03-28,9692
6111,大宇資,12,0,12,富邦-嘉義,2023-03-28,9692
3178,公準,12,0,12,富邦-嘉義,2023-03-28,9692
2106,建大,16,4,12,富邦-嘉義,2023-03-28,9692
5351,鈺創,20,8,12,富邦-嘉義,2023-03-28,9692
00772B,中信高評級公司債,12,1,11,富邦-嘉義,2023-03-28,9692
2618,長榮航,17,6,11,富邦-嘉義,2023-03-28,9692
4564,元翎,11,0,11,富邦-嘉義,2023-03-28,9692
6015,宏遠證,11,0,11,富邦-嘉義,2023-03-28,9692
6233,旺玖,11,0,11,富邦-嘉義,2023-03-28,9692
3312,弘憶股,366,35,331,富邦-嘉義,2023-03-29,9692
6116,彩晶,140,0,140,富邦-嘉義,2023-03-29,9692
00632R,元大台灣50反1,100,0,100,富邦-嘉義,2023-03-29,9692
2392,正崴,95,0,95,富邦-嘉義,2023-03-29,9692
00673R,期元大S＆P原油反1,65,2,63,富邦-嘉義,2023-03-29,9692
8931,大汽電,50,0,50,富邦-嘉義,2023-03-29,9692
00892,富邦台灣半導體,41,0,41,富邦-嘉義,2023-03-29,9692
2438,翔耀,72,31,41,富邦-嘉義,2023-03-29,9692
2371,大同,289,253,36,富邦-嘉義,2023-03-29,9692
2303,聯電,49,15,34,富邦-嘉義,2023-03-29,9692
2329,華泰,208,175,33,富邦-嘉義,2023-03-29,9692
3162,精確,50,18,32,富邦-嘉義,2023-03-29,9692
00902,中信電池及儲能,31,0,31,富邦-嘉義,2023-03-29,9692
2603,長榮,30,0,30,富邦-嘉義,2023-03-29,9692
2884,玉山金,33,4,29,富邦-嘉義,2023-03-29,9692
2412,中華電,27,1,26,富邦-嘉義,2023-03-29,9692
2453,凌群,41,16,25,富邦-嘉義,2023-03-29,9692
00664R,國泰臺灣加權反1,25,0,25,富邦-嘉義,2023-03-29,9692
6770,力積電,25,1,24,富邦-嘉義,2023-03-29,9692
1101,台泥,25,3,22,富邦-嘉義,2023-03-29,9692
3081,聯亞,22,0,22,富邦-嘉義,2023-03-29,9692
2867,三商壽,27,5,22,富邦-嘉義,2023-03-29,9692
3715,定穎投控,869,848,21,富邦-嘉義,2023-03-29,9692
5425,台半,23,2,21,富邦-嘉義,2023-03-29,9692
2641,正德,33,13,20,富邦-嘉義,2023-03-29,9692
2331,精英,49,29,20,富邦-嘉義,2023-03-29,9692
1568,倉佑,20,0,20,富邦-嘉義,2023-03-29,9692
2449,京元電子,21,1,20,富邦-嘉義,2023-03-29,9692
4919,新唐,26,9,17,富邦-嘉義,2023-03-29,9692
2408,南亞科,19,3,16,富邦-嘉義,2023-03-29,9692
4960,誠美材,21,5,16,富邦-嘉義,2023-03-29,9692
2409,友達,20,4,16,富邦-嘉義,2023-03-29,9692
00900,富邦特選高股息30,15,0,15,富邦-嘉義,2023-03-29,9692
3576,聯合再生,16,1,15,富邦-嘉義,2023-03-29,9692
5475,德宏,24,9,15,富邦-嘉義,2023-03-29,9692
3682,亞太電,20,5,15,富邦-嘉義,2023-03-29,9692
2609,陽明,24,9,15,富邦-嘉義,2023-03-29,9692
00882,中信中國高股息,14,0,14,富邦-嘉義,2023-03-29,9692
3017,奇鋐,44,31,13,富邦-嘉義,2023-03-29,9692
3037,欣興,31,18,13,富邦-嘉義,2023-03-29,9692
6485,點序,28,15,13,富邦-嘉義,2023-03-29,9692
2208,台船,24,11,13,富邦-嘉義,2023-03-29,9692
1760,寶齡富錦,55,42,13,富邦-嘉義,2023-03-29,9692
3714,富采,19,6,13,富邦-嘉義,2023-03-29,9692
2912,統一超,13,1,12,富邦-嘉義,2023-03-29,9692
2834,臺企銀,26,14,12,富邦-嘉義,2023-03-29,9692
5211,蒙恬,58,46,12,富邦-嘉義,2023-03-29,9692
4763,材料-KY,12,0,12,富邦-嘉義,2023-03-29,9692
00679B,元大美債20年,21,9,12,富邦-嘉義,2023-03-29,9692
00772B,中信高評級公司債,11,0,11,富邦-嘉義,2023-03-29,9692
6285,啟��,931,452,479,富邦-嘉義,2023-03-30,9692
00665L,富邦�琤肭磪囓�2,211,0,211,富邦-嘉義,2023-03-30,9692
3715,定穎投控,129,4,125,富邦-嘉義,2023-03-30,9692
3025,星通,75,0,75,富邦-嘉義,2023-03-30,9692
5309,系統電,116,43,73,富邦-嘉義,2023-03-30,9692
6669,緯穎,204,135,69,富邦-嘉義,2023-03-30,9692
8255,朋程,62,10,52,富邦-嘉義,2023-03-30,9692
6160,欣技,56,9,47,富邦-嘉義,2023-03-30,9692
1539,巨庭,47,1,46,富邦-嘉義,2023-03-30,9692
2883,凱基金,40,1,39,富邦-嘉義,2023-03-30,9692
6770,力積電,39,4,35,富邦-嘉義,2023-03-30,9692
2889,國票金,33,1,32,富邦-嘉義,2023-03-30,9692
00882,中信中國高股息,30,0,30,富邦-嘉義,2023-03-30,9692
3081,聯亞,32,2,30,富邦-嘉義,2023-03-30,9692
6223,旺矽,31,1,30,富邦-嘉義,2023-03-30,9692
1310,台苯,30,0,30,富邦-嘉義,2023-03-30,9692
00679B,元大美債20年,29,1,28,富邦-嘉義,2023-03-30,9692
3324,雙鴻,33,6,27,富邦-嘉義,2023-03-30,9692
8277,商丞,45,19,26,富邦-嘉義,2023-03-30,9692
8227,巨有科技,22,0,22,富邦-嘉義,2023-03-30,9692
2323,中環,20,0,20,富邦-嘉義,2023-03-30,9692
8926,台汽電,19,0,19,富邦-嘉義,2023-03-30,9692
00715L,期街口布蘭特正2,33,16,17,富邦-嘉義,2023-03-30,9692
5880,合庫金,15,0,15,富邦-嘉義,2023-03-30,9692
2342,茂矽,23,8,15,富邦-嘉義,2023-03-30,9692
2633,台灣高鐵,20,5,15,富邦-嘉義,2023-03-30,9692
00902,中信電池及儲能,20,5,15,富邦-嘉義,2023-03-30,9692
2610,華航,15,0,15,富邦-嘉義,2023-03-30,9692
3714,富采,21,6,15,富邦-嘉義,2023-03-30,9692
00676R,富邦臺灣加權反1,14,0,14,富邦-嘉義,2023-03-30,9692
6138,茂達,37,23,14,富邦-嘉義,2023-03-30,9692
1533,車王電,13,0,13,富邦-嘉義,2023-03-30,9692
2392,正崴,14,1,13,富邦-嘉義,2023-03-30,9692
6116,彩晶,12,0,12,富邦-嘉義,2023-03-30,9692
8033,雷虎,16,4,12,富邦-嘉義,2023-03-30,9692
2006,東和鋼鐵,12,1,11,富邦-嘉義,2023-03-30,9692
2881,富邦金,11,0,11,富邦-嘉義,2023-03-30,9692
3447,展達,36,25,11,富邦-嘉義,2023-03-30,9692
2618,長榮航,16,5,11,富邦-嘉義,2023-03-30,9692
6140,訊達,12,1,11,富邦-嘉義,2023-03-30,9692
5289,宜鼎,94,83,11,富邦-嘉義,2023-03-30,9692
1603,華電,10,0,10,富邦-嘉義,2023-03-30,9692
4906,正文,11,1,10,富邦-嘉義,2023-03-30,9692
1451,年興,10,0,10,富邦-嘉義,2023-03-30,9692
3033,威健,10,0,10,富邦-嘉義,2023-03-30,9692
6122,擎邦,11,1,10,富邦-嘉義,2023-03-30,9692
2897A,王道銀甲特,10,0,10,富邦-嘉義,2023-03-30,9692
02001L,富邦蘋果正二N,10,0,10,富邦-嘉義,2023-03-30,9692
5457,宣德,10,0,10,富邦-嘉義,2023-03-30,9692
00673R,期元大S＆P原油反1,10,0,10,富邦-嘉義,2023-03-30,9692
00632R,元大台灣50反1,249,100,149,富邦-嘉義,2023-03-31,9692
5353,台林,155,8,147,富邦-嘉義,2023-03-31,9692
3715,定穎投控,271,144,127,富邦-嘉義,2023-03-31,9692
6235,華孚,424,305,119,富邦-嘉義,2023-03-31,9692
3338,泰碩,100,3,97,富邦-嘉義,2023-03-31,9692
00673R,期元大S＆P原油反1,91,0,91,富邦-嘉義,2023-03-31,9692
3661,世芯-KY,91,1,90,富邦-嘉義,2023-03-31,9692
00892,富邦台灣半導體,66,1,65,富邦-嘉義,2023-03-31,9692
2204,中華,56,1,55,富邦-嘉義,2023-03-31,9692
6244,茂迪,65,10,55,富邦-嘉義,2023-03-31,9692
6753,龍德造船,60,7,53,富邦-嘉義,2023-03-31,9692
2889,國票金,53,0,53,富邦-嘉義,2023-03-31,9692
2453,凌群,167,115,52,富邦-嘉義,2023-03-31,9692
3675,德微,67,17,50,富邦-嘉義,2023-03-31,9692
00633L,富邦上証正2,53,8,45,富邦-嘉義,2023-03-31,9692
3231,緯創,73,29,44,富邦-嘉義,2023-03-31,9692
8255,朋程,73,29,44,富邦-嘉義,2023-03-31,9692
1605,華新,86,44,42,富邦-嘉義,2023-03-31,9692
3272,東碩,47,6,41,富邦-嘉義,2023-03-31,9692
4147,中裕,41,3,38,富邦-嘉義,2023-03-31,9692
4111,濟生,32,0,32,富邦-嘉義,2023-03-31,9692
6643,M31,52,22,30,富邦-嘉義,2023-03-31,9692
2645,長榮航太,33,4,29,富邦-嘉義,2023-03-31,9692
3711,日月光投控,28,0,28,富邦-嘉義,2023-03-31,9692
2748,雲品,30,2,28,富邦-嘉義,2023-03-31,9692
4746,台耀,33,5,28,富邦-嘉義,2023-03-31,9692
2633,台灣高鐵,30,2,28,富邦-嘉義,2023-03-31,9692
3703,欣陸,26,0,26,富邦-嘉義,2023-03-31,9692
00655L,國泰中國A50正2,34,8,26,富邦-嘉義,2023-03-31,9692
6443,元晶,53,28,25,富邦-嘉義,2023-03-31,9692
1314,中石化,22,1,21,富邦-嘉義,2023-03-31,9692
1336,台翰,21,0,21,富邦-嘉義,2023-03-31,9692
00772B,中信高評級公司債,41,20,21,富邦-嘉義,2023-03-31,9692
1752,南光,20,0,20,富邦-嘉義,2023-03-31,9692
2323,中環,20,0,20,富邦-嘉義,2023-03-31,9692
1609,大亞,20,0,20,富邦-嘉義,2023-03-31,9692
2340,台亞,20,1,19,富邦-嘉義,2023-03-31,9692
9907,統一實,20,1,19,富邦-嘉義,2023-03-31,9692
8222,寶一,24,6,18,富邦-嘉義,2023-03-31,9692
3032,偉訓,32,14,18,富邦-嘉義,2023-03-31,9692
4763,材料-KY,21,3,18,富邦-嘉義,2023-03-31,9692
2329,華泰,18,0,18,富邦-嘉義,2023-03-31,9692
8996,高力,27,9,18,富邦-嘉義,2023-03-31,9692
7402,邑錡,17,1,16,富邦-嘉義,2023-03-31,9692
2302,麗正,24,8,16,富邦-嘉義,2023-03-31,9692
2388,威盛,25,10,15,富邦-嘉義,2023-03-31,9692
2392,正崴,16,1,15,富邦-嘉義,2023-03-31,9692
8028,昇陽半導體,82,67,15,富邦-嘉義,2023-03-31,9692
6531,愛普*,21,7,14,富邦-嘉義,2023-03-31,9692
2105,正新,26,12,14,富邦-嘉義,2023-03-31,9692
00673R,期元大S＆P原油反1,258,20,238,富邦-嘉義,2023-04-06,9692
6244,茂迪,203,5,198,富邦-嘉義,2023-04-06,9692
4716,大立,172,0,172,富邦-嘉義,2023-04-06,9692
2886,兆豐金,102,7,95,富邦-嘉義,2023-04-06,9692
1795,美時,236,158,78,富邦-嘉義,2023-04-06,9692
2344,華邦電,102,25,77,富邦-嘉義,2023-04-06,9692
6142,友勁,82,8,74,富邦-嘉義,2023-04-06,9692
00753L,中信中國50正2,72,0,72,富邦-嘉義,2023-04-06,9692
3046,建��,75,4,71,富邦-嘉義,2023-04-06,9692
1519,華城,232,163,69,富邦-嘉義,2023-04-06,9692
2438,翔耀,61,0,61,富邦-嘉義,2023-04-06,9692
5284,jpp-KY,60,0,60,富邦-嘉義,2023-04-06,9692
2317,鴻海,62,4,58,富邦-嘉義,2023-04-06,9692
6160,欣技,57,2,55,富邦-嘉義,2023-04-06,9692
6276,安鈦克,51,0,51,富邦-嘉義,2023-04-06,9692
00632R,元大台灣50反1,56,5,51,富邦-嘉義,2023-04-06,9692
02001R,富邦蘋果反一N,50,0,50,富邦-嘉義,2023-04-06,9692
6431,光麗-KY,50,0,50,富邦-嘉義,2023-04-06,9692
00665L,富邦�琤肭磪囓�2,94,45,49,富邦-嘉義,2023-04-06,9692
2645,長榮航太,77,30,47,富邦-嘉義,2023-04-06,9692
4111,濟生,49,4,45,富邦-嘉義,2023-04-06,9692
4743,合一,77,33,44,富邦-嘉義,2023-04-06,9692
3025,星通,756,712,44,富邦-嘉義,2023-04-06,9692
3004,豐達科,143,108,35,富邦-嘉義,2023-04-06,9692
8289,泰藝,31,1,30,富邦-嘉義,2023-04-06,9692
2618,長榮航,38,10,28,富邦-嘉義,2023-04-06,9692
2101,南港,30,2,28,富邦-嘉義,2023-04-06,9692
5351,鈺創,29,2,27,富邦-嘉義,2023-04-06,9692
3006,晶豪科,27,1,26,富邦-嘉義,2023-04-06,9692
1220,台榮,328,302,26,富邦-嘉義,2023-04-06,9692
2331,精英,41,15,26,富邦-嘉義,2023-04-06,9692
2495,普安,36,10,26,富邦-嘉義,2023-04-06,9692
2201,裕隆,30,4,26,富邦-嘉義,2023-04-06,9692
6548,長科*,58,33,25,富邦-嘉義,2023-04-06,9692
1809,中釉,25,0,25,富邦-嘉義,2023-04-06,9692
2481,強茂,25,1,24,富邦-嘉義,2023-04-06,9692
3703,欣陸,23,0,23,富邦-嘉義,2023-04-06,9692
2609,陽明,23,1,22,富邦-嘉義,2023-04-06,9692
1336,台翰,21,0,21,富邦-嘉義,2023-04-06,9692
9802,鈺齊-KY,20,0,20,富邦-嘉義,2023-04-06,9692
00651R,復華香港反1,20,0,20,富邦-嘉義,2023-04-06,9692
2601,益航,20,0,20,富邦-嘉義,2023-04-06,9692
4763,材料-KY,36,18,18,富邦-嘉義,2023-04-06,9692
6861,睿生光電,18,0,18,富邦-嘉義,2023-04-06,9692
1101,台泥,24,6,18,富邦-嘉義,2023-04-06,9692
00882,中信中國高股息,17,0,17,富邦-嘉義,2023-04-06,9692
2332,友訊,17,1,16,富邦-嘉義,2023-04-06,9692
2367,燿華,20,4,16,富邦-嘉義,2023-04-06,9692
3576,聯合再生,16,0,16,富邦-嘉義,2023-04-06,9692
2002,中鋼,15,0,15,富邦-嘉義,2023-04-06,9692
2427,三商電,260,6,254,富邦-嘉義,2023-04-07,9692
2606,裕民,247,3,244,富邦-嘉義,2023-04-07,9692
3447,展達,192,9,183,富邦-嘉義,2023-04-07,9692
2867,三商壽,159,0,159,富邦-嘉義,2023-04-07,9692
1519,華城,1176,1063,113,富邦-嘉義,2023-04-07,9692
6578,達邦蛋白,90,5,85,富邦-嘉義,2023-04-07,9692
4967,十銓,270,192,78,富邦-嘉義,2023-04-07,9692
2208,台船,82,23,59,富邦-嘉義,2023-04-07,9692
00633L,富邦上証正2,50,1,49,富邦-嘉義,2023-04-07,9692
2482,連宇,88,41,47,富邦-嘉義,2023-04-07,9692
6861,睿生光電,61,19,42,富邦-嘉義,2023-04-07,9692
3712,永崴投控,41,1,40,富邦-嘉義,2023-04-07,9692
6417,韋僑,72,33,39,富邦-嘉義,2023-04-07,9692
6431,光麗-KY,40,1,39,富邦-嘉義,2023-04-07,9692
00902,中信電池及儲能,36,0,36,富邦-嘉義,2023-04-07,9692
1809,中釉,35,0,35,富邦-嘉義,2023-04-07,9692
2834,臺企銀,39,4,35,富邦-嘉義,2023-04-07,9692
00673R,期元大S＆P原油反1,35,0,35,富邦-嘉義,2023-04-07,9692
1609,大亞,94,61,33,富邦-嘉義,2023-04-07,9692
4716,大立,32,0,32,富邦-嘉義,2023-04-07,9692
3162,精確,73,43,30,富邦-嘉義,2023-04-07,9692
3501,維熹,44,15,29,富邦-嘉義,2023-04-07,9692
6197,佳必琪,74,46,28,富邦-嘉義,2023-04-07,9692
2605,新興,45,18,27,富邦-嘉義,2023-04-07,9692
8936,國統,29,6,23,富邦-嘉義,2023-04-07,9692
3056,富華新,27,5,22,富邦-嘉義,2023-04-07,9692
4130,健亞,23,1,22,富邦-嘉義,2023-04-07,9692
6156,松上,32,10,22,富邦-嘉義,2023-04-07,9692
2618,長榮航,25,4,21,富邦-嘉義,2023-04-07,9692
6220,岳豐,21,0,21,富邦-嘉義,2023-04-07,9692
4763,材料-KY,42,21,21,富邦-嘉義,2023-04-07,9692
3324,雙鴻,47,27,20,富邦-嘉義,2023-04-07,9692
00753L,中信中國50正2,20,0,20,富邦-嘉義,2023-04-07,9692
1584,精剛,26,6,20,富邦-嘉義,2023-04-07,9692
3479,安勤,40,22,18,富邦-嘉義,2023-04-07,9692
2436,偉詮電,20,3,17,富邦-嘉義,2023-04-07,9692
3661,世芯-KY,164,147,17,富邦-嘉義,2023-04-07,9692
5309,系統電,30,14,16,富邦-嘉義,2023-04-07,9692
6829,千附精密,33,17,16,富邦-嘉義,2023-04-07,9692
00830,國泰費城半導體,15,0,15,富邦-嘉義,2023-04-07,9692
3680,家登,16,1,15,富邦-嘉義,2023-04-07,9692
3312,弘憶股,14,0,14,富邦-嘉義,2023-04-07,9692
1314,中石化,14,0,14,富邦-嘉義,2023-04-07,9692
2356,英業達,32,19,13,富邦-嘉義,2023-04-07,9692
9942,茂順,70,57,13,富邦-嘉義,2023-04-07,9692
2472,立隆電,12,0,12,富邦-嘉義,2023-04-07,9692
3701,大眾控,12,0,12,富邦-嘉義,2023-04-07,9692
3481,群創,35,23,12,富邦-嘉義,2023-04-07,9692
1504,東元,147,135,12,富邦-嘉義,2023-04-07,9692
2485,兆赫,23,12,11,富邦-嘉義,2023-04-07,9692
6148,驊宏資,454,117,337,富邦-嘉義,2023-04-10,9692
6266,泰詠,305,27,278,富邦-嘉義,2023-04-10,9692
1513,中興電,334,62,272,富邦-嘉義,2023-04-10,9692
6235,華孚,169,11,158,富邦-嘉義,2023-04-10,9692
6829,千附精密,291,148,143,富邦-嘉義,2023-04-10,9692
6116,彩晶,127,1,126,富邦-嘉義,2023-04-10,9692
6733,博晟生醫,125,2,123,富邦-嘉義,2023-04-10,9692
2402,毅嘉,212,110,102,富邦-嘉義,2023-04-10,9692
6209,今國光,116,16,100,富邦-嘉義,2023-04-10,9692
3046,建��,237,139,98,富邦-嘉義,2023-04-10,9692
00679B,元大美債20年,96,7,89,富邦-嘉義,2023-04-10,9692
2634,漢翔,117,32,85,富邦-嘉義,2023-04-10,9692
4967,十銓,129,49,80,富邦-嘉義,2023-04-10,9692
2457,飛宏,994,916,78,富邦-嘉義,2023-04-10,9692
3006,晶豪科,89,14,75,富邦-嘉義,2023-04-10,9692
5009,榮剛,82,11,71,富邦-嘉義,2023-04-10,9692
2438,翔耀,69,0,69,富邦-嘉義,2023-04-10,9692
6152,百一,61,5,56,富邦-嘉義,2023-04-10,9692
5209,新鼎,51,0,51,富邦-嘉義,2023-04-10,9692
4503,金雨,165,115,50,富邦-嘉義,2023-04-10,9692
02001L,富邦蘋果正二N,50,0,50,富邦-嘉義,2023-04-10,9692
2208,台船,193,144,49,富邦-嘉義,2023-04-10,9692
8383,千附,68,22,46,富邦-嘉義,2023-04-10,9692
2034,允強,40,0,40,富邦-嘉義,2023-04-10,9692
00673R,期元大S＆P原油反1,42,4,38,富邦-嘉義,2023-04-10,9692
6578,達邦蛋白,71,35,36,富邦-嘉義,2023-04-10,9692
2206,三陽工業,83,47,36,富邦-嘉義,2023-04-10,9692
2610,華航,39,6,33,富邦-嘉義,2023-04-10,9692
5328,華容,42,10,32,富邦-嘉義,2023-04-10,9692
8222,寶一,123,92,31,富邦-嘉義,2023-04-10,9692
8277,商丞,32,1,31,富邦-嘉義,2023-04-10,9692
2812,台中銀,32,3,29,富邦-嘉義,2023-04-10,9692
2855,統一證,28,0,28,富邦-嘉義,2023-04-10,9692
6168,宏齊,28,0,28,富邦-嘉義,2023-04-10,9692
1605,華新,41,15,26,富邦-嘉義,2023-04-10,9692
3714,富采,25,1,24,富邦-嘉義,2023-04-10,9692
4111,濟生,23,0,23,富邦-嘉義,2023-04-10,9692
2891,中信金,25,2,23,富邦-嘉義,2023-04-10,9692
2618,長榮航,25,3,22,富邦-嘉義,2023-04-10,9692
5351,鈺創,24,2,22,富邦-嘉義,2023-04-10,9692
3682,亞太電,21,0,21,富邦-嘉義,2023-04-10,9692
2603,長榮,34,14,20,富邦-嘉義,2023-04-10,9692
020034,元大IC設計N,20,0,20,富邦-嘉義,2023-04-10,9692
00687B,國泰20年美債,20,0,20,富邦-嘉義,2023-04-10,9692
2409,友達,35,16,19,富邦-嘉義,2023-04-10,9692
4977,眾達-KY,43,24,19,富邦-嘉義,2023-04-10,9692
1504,東元,99,80,19,富邦-嘉義,2023-04-10,9692
3078,僑威,105,87,18,富邦-嘉義,2023-04-10,9692
2450,神腦,17,0,17,富邦-嘉義,2023-04-10,9692
3162,精確,105,89,16,富邦-嘉義,2023-04-10,9692
2368,金像電,1011,26,985,富邦-嘉義,2023-04-11,9692
00885,富邦越南,151,2,149,富邦-嘉義,2023-04-11,9692
1519,華城,1112,985,127,富邦-嘉義,2023-04-11,9692
3661,世芯-KY,285,178,107,富邦-嘉義,2023-04-11,9692
3325,旭品,120,20,100,富邦-嘉義,2023-04-11,9692
3715,定穎投控,90,2,88,富邦-嘉義,2023-04-11,9692
6485,點序,199,113,86,富邦-嘉義,2023-04-11,9692
4968,立積,476,390,86,富邦-嘉義,2023-04-11,9692
6770,力積電,402,320,82,富邦-嘉義,2023-04-11,9692
1584,精剛,102,22,80,富邦-嘉義,2023-04-11,9692
2634,漢翔,101,27,74,富邦-嘉義,2023-04-11,9692
00673R,期元大S＆P原油反1,72,0,72,富邦-嘉義,2023-04-11,9692
00679B,元大美債20年,56,0,56,富邦-嘉義,2023-04-11,9692
2201,裕隆,55,2,53,富邦-嘉義,2023-04-11,9692
2547,日勝生,50,0,50,富邦-嘉義,2023-04-11,9692
00683L,期元大美元指正2,50,0,50,富邦-嘉義,2023-04-11,9692
6142,友勁,51,5,46,富邦-嘉義,2023-04-11,9692
2365,昆盈,40,0,40,富邦-嘉義,2023-04-11,9692
2492,華新科,48,9,39,富邦-嘉義,2023-04-11,9692
8255,朋程,40,2,38,富邦-嘉義,2023-04-11,9692
3011,今皓,37,2,35,富邦-嘉義,2023-04-11,9692
2834,臺企銀,61,26,35,富邦-嘉義,2023-04-11,9692
5284,jpp-KY,32,0,32,富邦-嘉義,2023-04-11,9692
6160,欣技,57,25,32,富邦-嘉義,2023-04-11,9692
4953,緯軟,31,0,31,富邦-嘉義,2023-04-11,9692
2109,華豐,30,0,30,富邦-嘉義,2023-04-11,9692
1529,樂事綠能,50,23,27,富邦-嘉義,2023-04-11,9692
2303,聯電,34,8,26,富邦-嘉義,2023-04-11,9692
6223,旺矽,41,16,25,富邦-嘉義,2023-04-11,9692
3706,神達,29,6,23,富邦-嘉義,2023-04-11,9692
2888,新光金,23,2,21,富邦-嘉義,2023-04-11,9692
6532,瑞耘,21,0,21,富邦-嘉義,2023-04-11,9692
5269,祥碩,33,12,21,富邦-嘉義,2023-04-11,9692
1101,台泥,69,48,21,富邦-嘉義,2023-04-11,9692
00888,永豐台灣ESG,20,0,20,富邦-嘉義,2023-04-11,9692
2486,一詮,20,0,20,富邦-嘉義,2023-04-11,9692
1336,台翰,20,0,20,富邦-嘉義,2023-04-11,9692
00753L,中信中國50正2,180,160,20,富邦-嘉義,2023-04-11,9692
6861,睿生光電,20,0,20,富邦-嘉義,2023-04-11,9692
020034,元大IC設計N,20,0,20,富邦-嘉義,2023-04-11,9692
2482,連宇,87,68,19,富邦-嘉義,2023-04-11,9692
1308,亞聚,21,2,19,富邦-嘉義,2023-04-11,9692
2413,環科,32,13,19,富邦-嘉義,2023-04-11,9692
3289,宜特,18,0,18,富邦-嘉義,2023-04-11,9692
6122,擎邦,40,22,18,富邦-嘉義,2023-04-11,9692
1722,台肥,20,2,18,富邦-嘉義,2023-04-11,9692
3714,富采,25,7,18,富邦-嘉義,2023-04-11,9692
6874,倍力,18,1,17,富邦-嘉義,2023-04-11,9692
6241,易通展,17,0,17,富邦-嘉義,2023-04-11,9692
8076,伍豐,19,2,17,富邦-嘉義,2023-04-11,9692
2603,長榮,1001,18,983,富邦-嘉義,2023-04-12,9692
8034,榮群,501,0,501,富邦-嘉義,2023-04-12,9692
6163,華電網,373,109,264,富邦-嘉義,2023-04-12,9692
2834,臺企銀,265,38,227,富邦-嘉義,2023-04-12,9692
2206,三陽工業,432,209,223,富邦-嘉義,2023-04-12,9692
3715,定穎投控,218,3,215,富邦-嘉義,2023-04-12,9692
1503,士電,481,271,210,富邦-嘉義,2023-04-12,9692
6122,擎邦,482,286,196,富邦-嘉義,2023-04-12,9692
1529,樂事綠能,215,37,178,富邦-嘉義,2023-04-12,9692
1514,亞力,636,482,154,富邦-嘉義,2023-04-12,9692
6148,驊宏資,180,51,129,富邦-嘉義,2023-04-12,9692
1519,華城,257,134,123,富邦-嘉義,2023-04-12,9692
00632R,元大台灣50反1,118,0,118,富邦-嘉義,2023-04-12,9692
2845,遠東銀,100,0,100,富邦-嘉義,2023-04-12,9692
3025,星通,98,1,97,富邦-嘉義,2023-04-12,9692
00673R,期元大S＆P原油反1,69,0,69,富邦-嘉義,2023-04-12,9692
4155,訊映,77,12,65,富邦-嘉義,2023-04-12,9692
2634,漢翔,1565,1502,63,富邦-嘉義,2023-04-12,9692
00753L,中信中國50正2,61,0,61,富邦-嘉義,2023-04-12,9692
1504,東元,497,439,58,富邦-嘉義,2023-04-12,9692
00772B,中信高評級公司債,57,0,57,富邦-嘉義,2023-04-12,9692
1609,大亞,169,114,55,富邦-嘉義,2023-04-12,9692
2371,大同,57,3,54,富邦-嘉義,2023-04-12,9692
6443,元晶,121,68,53,富邦-嘉義,2023-04-12,9692
00679B,元大美債20年,54,2,52,富邦-嘉義,2023-04-12,9692
1611,中電,67,16,51,富邦-嘉義,2023-04-12,9692
2534,宏盛,51,0,51,富邦-嘉義,2023-04-12,9692
4916,事欣科,88,37,51,富邦-嘉義,2023-04-12,9692
00712,復華富時不動產,51,2,49,富邦-嘉義,2023-04-12,9692
6538,倉和,96,49,47,富邦-嘉義,2023-04-12,9692
8222,寶一,730,685,45,富邦-嘉義,2023-04-12,9692
2482,連宇,67,27,40,富邦-嘉義,2023-04-12,9692
4147,中裕,160,122,38,富邦-嘉義,2023-04-12,9692
1783,和康生,35,0,35,富邦-嘉義,2023-04-12,9692
00902,中信電池及儲能,33,0,33,富邦-嘉義,2023-04-12,9692
3693,營邦,141,108,33,富邦-嘉義,2023-04-12,9692
2208,台船,133,101,32,富邦-嘉義,2023-04-12,9692
3058,立德,33,2,31,富邦-嘉義,2023-04-12,9692
1722,台肥,30,0,30,富邦-嘉義,2023-04-12,9692
6235,華孚,142,112,30,富邦-嘉義,2023-04-12,9692
1605,華新,95,69,26,富邦-嘉義,2023-04-12,9692
2645,長榮航太,26,1,25,富邦-嘉義,2023-04-12,9692
1810,和成,25,0,25,富邦-嘉義,2023-04-12,9692
2027,大成鋼,26,1,25,富邦-嘉義,2023-04-12,9692
6266,泰詠,463,438,25,富邦-嘉義,2023-04-12,9692
6217,中探針,25,1,24,富邦-嘉義,2023-04-12,9692
1101,台泥,35,11,24,富邦-嘉義,2023-04-12,9692
4977,眾達-KY,25,3,22,富邦-嘉義,2023-04-12,9692
2609,陽明,78,56,22,富邦-嘉義,2023-04-12,9692
2328,廣宇,21,0,21,富邦-嘉義,2023-04-12,9692
2645,長榮航太,353,30,323,富邦-嘉義,2023-04-13,9692
2834,臺企銀,230,27,203,富邦-嘉義,2023-04-13,9692
4128,中天,180,21,159,富邦-嘉義,2023-04-13,9692
1584,精剛,448,317,131,富邦-嘉義,2023-04-13,9692
2201,裕隆,126,26,100,富邦-嘉義,2023-04-13,9692
00878,國泰永續高股息,123,27,96,富邦-嘉義,2023-04-13,9692
8222,寶一,981,893,88,富邦-嘉義,2023-04-13,9692
2208,台船,1171,1083,88,富邦-嘉義,2023-04-13,9692
5009,榮剛,266,179,87,富邦-嘉義,2023-04-13,9692
6612,奈米醫材,116,46,70,富邦-嘉義,2023-04-13,9692
00673R,期元大S＆P原油反1,70,0,70,富邦-嘉義,2023-04-13,9692
6578,達邦蛋白,71,1,70,富邦-嘉義,2023-04-13,9692
00902,中信電池及儲能,70,1,69,富邦-嘉義,2023-04-13,9692
2867,三商壽,253,187,66,富邦-嘉義,2023-04-13,9692
2890,永豐金,62,9,53,富邦-嘉義,2023-04-13,9692
9962,有益,108,57,51,富邦-嘉義,2023-04-13,9692
2317,鴻海,50,4,46,富邦-嘉義,2023-04-13,9692
6829,千附精密,118,74,44,富邦-嘉義,2023-04-13,9692
00888,永豐台灣ESG,44,3,41,富邦-嘉義,2023-04-13,9692
00772B,中信高評級公司債,46,6,40,富邦-嘉義,2023-04-13,9692
1752,南光,69,30,39,富邦-嘉義,2023-04-13,9692
2610,華航,59,21,38,富邦-嘉義,2023-04-13,9692
6547,高端疫苗,32,1,31,富邦-嘉義,2023-04-13,9692
7402,邑錡,130,101,29,富邦-嘉義,2023-04-13,9692
1336,台翰,27,0,27,富邦-嘉義,2023-04-13,9692
3711,日月光投控,27,2,25,富邦-嘉義,2023-04-13,9692
00671R,富邦NASDAQ反1,25,0,25,富邦-嘉義,2023-04-13,9692
2369,菱生,27,3,24,富邦-嘉義,2023-04-13,9692
6168,宏齊,24,0,24,富邦-嘉義,2023-04-13,9692
00713,元大台灣高息低波,27,3,24,富邦-嘉義,2023-04-13,9692
8033,雷虎,52,28,24,富邦-嘉義,2023-04-13,9692
8088,品安,23,0,23,富邦-嘉義,2023-04-13,9692
006208,富邦台50,23,1,22,富邦-嘉義,2023-04-13,9692
5457,宣德,25,4,21,富邦-嘉義,2023-04-13,9692
8076,伍豐,25,5,20,富邦-嘉義,2023-04-13,9692
00687B,國泰20年美債,20,0,20,富邦-嘉義,2023-04-13,9692
2534,宏盛,20,0,20,富邦-嘉義,2023-04-13,9692
02001R,富邦蘋果反一N,20,0,20,富邦-嘉義,2023-04-13,9692
00651R,復華香港反1,20,0,20,富邦-嘉義,2023-04-13,9692
1605,華新,193,173,20,富邦-嘉義,2023-04-13,9692
3006,晶豪科,48,29,19,富邦-嘉義,2023-04-13,9692
2390,云辰,80,61,19,富邦-嘉義,2023-04-13,9692
2382,廣達,20,2,18,富邦-嘉義,2023-04-13,9692
3499,環天科,79,61,18,富邦-嘉義,2023-04-13,9692
6541,泰福-KY,18,0,18,富邦-嘉義,2023-04-13,9692
6753,龍德造船,25,8,17,富邦-嘉義,2023-04-13,9692
2359,所羅門,51,34,17,富邦-嘉義,2023-04-13,9692
00680L,元大美債20正2,17,0,17,富邦-嘉義,2023-04-13,9692
2329,華泰,20,3,17,富邦-嘉義,2023-04-13,9692
6182,合晶,19,2,17,富邦-嘉義,2023-04-13,9692
6235,華孚,1280,746,534,富邦-嘉義,2023-04-14,9692
6140,訊達,547,188,359,富邦-嘉義,2023-04-14,9692
2603,長榮,372,69,303,富邦-嘉義,2023-04-14,9692
5211,蒙恬,254,44,210,富邦-嘉義,2023-04-14,9692
5328,華容,204,13,191,富邦-嘉義,2023-04-14,9692
00673R,期元大S＆P原油反1,155,0,155,富邦-嘉義,2023-04-14,9692
8033,雷虎,254,106,148,富邦-嘉義,2023-04-14,9692
5209,新鼎,132,11,121,富邦-嘉義,2023-04-14,9692
2471,資通,404,285,119,富邦-嘉義,2023-04-14,9692
2748,雲品,168,66,102,富邦-嘉義,2023-04-14,9692
1504,東元,217,138,79,富邦-嘉義,2023-04-14,9692
8105,凌巨,80,1,79,富邦-嘉義,2023-04-14,9692
1810,和成,220,144,76,富邦-嘉義,2023-04-14,9692
00632R,元大台灣50反1,72,1,71,富邦-嘉義,2023-04-14,9692
2453,凌群,237,170,67,富邦-嘉義,2023-04-14,9692
00712,復華富時不動產,60,0,60,富邦-嘉義,2023-04-14,9692
8996,高力,63,7,56,富邦-嘉義,2023-04-14,9692
1444,力麗,55,3,52,富邦-嘉義,2023-04-14,9692
3025,星通,55,6,49,富邦-嘉義,2023-04-14,9692
2482,連宇,70,22,48,富邦-嘉義,2023-04-14,9692
6753,龍德造船,46,0,46,富邦-嘉義,2023-04-14,9692
2739,寒舍,45,0,45,富邦-嘉義,2023-04-14,9692
00878,國泰永續高股息,51,6,45,富邦-嘉義,2023-04-14,9692
1336,台翰,43,0,43,富邦-嘉義,2023-04-14,9692
2382,廣達,44,3,41,富邦-嘉義,2023-04-14,9692
9939,宏全,40,0,40,富邦-嘉義,2023-04-14,9692
4804,大略-KY,40,0,40,富邦-嘉義,2023-04-14,9692
4967,十銓,160,120,40,富邦-嘉義,2023-04-14,9692
6160,欣技,71,32,39,富邦-嘉義,2023-04-14,9692
00772B,中信高評級公司債,38,0,38,富邦-嘉義,2023-04-14,9692
00679B,元大美債20年,52,15,37,富邦-嘉義,2023-04-14,9692
4961,天鈺,69,34,35,富邦-嘉義,2023-04-14,9692
3624,光頡,50,15,35,富邦-嘉義,2023-04-14,9692
2066,世德,37,6,31,富邦-嘉義,2023-04-14,9692
3481,群創,56,25,31,富邦-嘉義,2023-04-14,9692
2609,陽明,57,26,31,富邦-嘉義,2023-04-14,9692
6461,益得,40,10,30,富邦-嘉義,2023-04-14,9692
2303,聯電,30,3,27,富邦-嘉義,2023-04-14,9692
2342,茂矽,60,34,26,富邦-嘉義,2023-04-14,9692
5371,中光電,42,19,23,富邦-嘉義,2023-04-14,9692
8936,國統,26,4,22,富邦-嘉義,2023-04-14,9692
3325,旭品,22,1,21,富邦-嘉義,2023-04-14,9692
020034,元大IC設計N,20,0,20,富邦-嘉義,2023-04-14,9692
6222,上揚,20,0,20,富邦-嘉義,2023-04-14,9692
2812,台中銀,20,1,19,富邦-嘉義,2023-04-14,9692
2731,雄獅,125,106,19,富邦-嘉義,2023-04-14,9692
1609,大亞,94,76,18,富邦-嘉義,2023-04-14,9692
8478,東哥遊艇,19,1,18,富邦-嘉義,2023-04-14,9692
0056,元大高股息,25,7,18,富邦-嘉義,2023-04-14,9692
3062,建漢,20,2,18,富邦-嘉義,2023-04-14,9692
6148,驊宏資,571,86,485,富邦-嘉義,2023-04-17,9692
5211,蒙恬,598,133,465,富邦-嘉義,2023-04-17,9692
2634,漢翔,3926,3597,329,富邦-嘉義,2023-04-17,9692
1584,精剛,377,147,230,富邦-嘉義,2023-04-17,9692
2883B,凱基金乙特,200,0,200,富邦-嘉義,2023-04-17,9692
2201,裕隆,222,40,182,富邦-嘉義,2023-04-17,9692
00632R,元大台灣50反1,172,1,171,富邦-嘉義,2023-04-17,9692
2365,昆盈,166,2,164,富邦-嘉義,2023-04-17,9692
6829,千附精密,169,34,135,富邦-嘉義,2023-04-17,9692
1529,樂事綠能,364,231,133,富邦-嘉義,2023-04-17,9692
1810,和成,246,119,127,富邦-嘉義,2023-04-17,9692
2471,資通,299,177,122,富邦-嘉義,2023-04-17,9692
3013,晟銘電,134,18,116,富邦-嘉義,2023-04-17,9692
2630,亞航,437,343,94,富邦-嘉義,2023-04-17,9692
6142,友勁,106,13,93,富邦-嘉義,2023-04-17,9692
00679B,元大美債20年,91,0,91,富邦-嘉義,2023-04-17,9692
6223,旺矽,100,11,89,富邦-嘉義,2023-04-17,9692
2206,三陽工業,307,244,63,富邦-嘉義,2023-04-17,9692
2645,長榮航太,74,12,62,富邦-嘉義,2023-04-17,9692
2453,凌群,150,90,60,富邦-嘉義,2023-04-17,9692
00683L,期元大美元指正2,55,0,55,富邦-嘉義,2023-04-17,9692
6547,高端疫苗,66,14,52,富邦-嘉義,2023-04-17,9692
6590,普鴻,50,0,50,富邦-嘉義,2023-04-17,9692
8383,千附,52,3,49,富邦-嘉義,2023-04-17,9692
2610,華航,57,8,49,富邦-嘉義,2023-04-17,9692
2342,茂矽,51,3,48,富邦-嘉義,2023-04-17,9692
00687B,國泰20年美債,44,0,44,富邦-嘉義,2023-04-17,9692
5488,松普,49,6,43,富邦-嘉義,2023-04-17,9692
3046,建��,197,155,42,富邦-嘉義,2023-04-17,9692
3211,順達,41,0,41,富邦-嘉義,2023-04-17,9692
1503,士電,262,223,39,富邦-嘉義,2023-04-17,9692
6282,康舒,107,68,39,富邦-嘉義,2023-04-17,9692
5009,榮剛,75,37,38,富邦-嘉義,2023-04-17,9692
3062,建漢,42,5,37,富邦-嘉義,2023-04-17,9692
2002,中鋼,44,8,36,富邦-嘉義,2023-04-17,9692
2457,飛宏,1330,1296,34,富邦-嘉義,2023-04-17,9692
8033,雷虎,639,606,33,富邦-嘉義,2023-04-17,9692
00888,永豐台灣ESG,33,0,33,富邦-嘉義,2023-04-17,9692
1809,中釉,234,201,33,富邦-嘉義,2023-04-17,9692
2885,元大金,35,3,32,富邦-嘉義,2023-04-17,9692
2211,長榮鋼,32,1,31,富邦-嘉義,2023-04-17,9692
1783,和康生,30,1,29,富邦-嘉義,2023-04-17,9692
9939,宏全,30,1,29,富邦-嘉義,2023-04-17,9692
8409,商之器,33,4,29,富邦-嘉義,2023-04-17,9692
2204,中華,30,3,27,富邦-嘉義,2023-04-17,9692
6167,久正,27,1,26,富邦-嘉義,2023-04-17,9692
4966,譜瑞-KY,58,32,26,富邦-嘉義,2023-04-17,9692
1618,合機,28,3,25,富邦-嘉義,2023-04-17,9692
3664,安瑞-KY,25,0,25,富邦-嘉義,2023-04-17,9692
2364,倫飛,24,1,23,富邦-嘉義,2023-04-17,9692
2201,裕隆,2301,892,1409,富邦-嘉義,2023-04-18,9692
3673,TPK-KY,149,3,146,富邦-嘉義,2023-04-18,9692
2365,昆盈,142,0,142,富邦-嘉義,2023-04-18,9692
00753L,中信中國50正2,100,0,100,富邦-嘉義,2023-04-18,9692
6806,森崴能源,279,180,99,富邦-嘉義,2023-04-18,9692
2645,長榮航太,157,62,95,富邦-嘉義,2023-04-18,9692
00632R,元大台灣50反1,122,30,92,富邦-嘉義,2023-04-18,9692
00679B,元大美債20年,76,11,65,富邦-嘉義,2023-04-18,9692
3686,達能,61,1,60,富邦-嘉義,2023-04-18,9692
1314,中石化,65,7,58,富邦-嘉義,2023-04-18,9692
00720B,元大投資級公司債,60,2,58,富邦-嘉義,2023-04-18,9692
6863,永道-KY,51,0,51,富邦-嘉義,2023-04-18,9692
1905,華紙,50,0,50,富邦-嘉義,2023-04-18,9692
4934,太極,53,3,50,富邦-嘉義,2023-04-18,9692
6465,威潤,46,1,45,富邦-嘉義,2023-04-18,9692
4979,華星光,317,274,43,富邦-嘉義,2023-04-18,9692
00878,國泰永續高股息,50,8,42,富邦-嘉義,2023-04-18,9692
00680L,元大美債20正2,41,0,41,富邦-嘉義,2023-04-18,9692
5009,榮剛,51,11,40,富邦-嘉義,2023-04-18,9692
1444,力麗,99,59,40,富邦-嘉義,2023-04-18,9692
4971,IET-KY,40,2,38,富邦-嘉義,2023-04-18,9692
2401,凌陽,63,30,33,富邦-嘉義,2023-04-18,9692
2867,三商壽,64,31,33,富邦-嘉義,2023-04-18,9692
4951,精拓科,33,0,33,富邦-嘉義,2023-04-18,9692
3715,定穎投控,49,16,33,富邦-嘉義,2023-04-18,9692
00772B,中信高評級公司債,30,0,30,富邦-嘉義,2023-04-18,9692
3058,立德,35,5,30,富邦-嘉義,2023-04-18,9692
00673R,期元大S＆P原油反1,31,1,30,富邦-嘉義,2023-04-18,9692
3221,台嘉碩,39,10,29,富邦-嘉義,2023-04-18,9692
1609,大亞,42,14,28,富邦-嘉義,2023-04-18,9692
2634,漢翔,1689,1662,27,富邦-嘉義,2023-04-18,9692
3232,昱捷,27,0,27,富邦-嘉義,2023-04-18,9692
3481,群創,41,15,26,富邦-嘉義,2023-04-18,9692
1605,華新,73,47,26,富邦-嘉義,2023-04-18,9692
1722,台肥,26,0,26,富邦-嘉義,2023-04-18,9692
3149,正達,25,0,25,富邦-嘉義,2023-04-18,9692
6612,奈米醫材,28,4,24,富邦-嘉義,2023-04-18,9692
2208,台船,343,320,23,富邦-嘉義,2023-04-18,9692
3078,僑威,38,15,23,富邦-嘉義,2023-04-18,9692
1733,五鼎,22,0,22,富邦-嘉義,2023-04-18,9692
3038,全台,23,2,21,富邦-嘉義,2023-04-18,9692
1313,聯成,21,1,20,富邦-嘉義,2023-04-18,9692
6222,上揚,20,0,20,富邦-嘉義,2023-04-18,9692
9945,潤泰新,20,1,19,富邦-嘉義,2023-04-18,9692
00895,富邦未來車,20,1,19,富邦-嘉義,2023-04-18,9692
3013,晟銘電,244,226,18,富邦-嘉義,2023-04-18,9692
2313,華通,20,3,17,富邦-嘉義,2023-04-18,9692
4114,健喬,38,21,17,富邦-嘉義,2023-04-18,9692
8076,伍豐,20,3,17,富邦-嘉義,2023-04-18,9692
2340,台亞,16,0,16,富邦-嘉義,2023-04-18,9692
3652,精聯,1041,283,758,富邦-嘉義,2023-04-19,9692
1760,寶齡富錦,729,158,571,富邦-嘉義,2023-04-19,9692
2634,漢翔,660,312,348,富邦-嘉義,2023-04-19,9692
3058,立德,237,22,215,富邦-嘉義,2023-04-19,9692
6443,元晶,529,353,176,富邦-嘉義,2023-04-19,9692
4147,中裕,345,185,160,富邦-嘉義,2023-04-19,9692
6235,華孚,190,60,130,富邦-嘉義,2023-04-19,9692
00753L,中信中國50正2,101,0,101,富邦-嘉義,2023-04-19,9692
1447,力鵬,88,0,88,富邦-嘉義,2023-04-19,9692
2495,普安,108,25,83,富邦-嘉義,2023-04-19,9692
6282,康舒,400,325,75,富邦-嘉義,2023-04-19,9692
1722,台肥,82,8,74,富邦-嘉義,2023-04-19,9692
5465,富驊,80,9,71,富邦-嘉義,2023-04-19,9692
2317,鴻海,69,3,66,富邦-嘉義,2023-04-19,9692
2754,亞洲藏壽司,120,57,63,富邦-嘉義,2023-04-19,9692
6461,益得,63,0,63,富邦-嘉義,2023-04-19,9692
6285,啟��,62,4,58,富邦-嘉義,2023-04-19,9692
2739,寒舍,64,6,58,富邦-嘉義,2023-04-19,9692
3078,僑威,340,288,52,富邦-嘉義,2023-04-19,9692
2356,英業達,58,7,51,富邦-嘉義,2023-04-19,9692
6811,宏�硌穈T,52,2,50,富邦-嘉義,2023-04-19,9692
4966,譜瑞-KY,51,3,48,富邦-嘉義,2023-04-19,9692
6791,虎門科技,50,2,48,富邦-嘉義,2023-04-19,9692
6167,久正,445,398,47,富邦-嘉義,2023-04-19,9692
00772B,中信高評級公司債,42,0,42,富邦-嘉義,2023-04-19,9692
6244,茂迪,354,313,41,富邦-嘉義,2023-04-19,9692
1802,台玻,53,13,40,富邦-嘉義,2023-04-19,9692
1336,台翰,36,0,36,富邦-嘉義,2023-04-19,9692
1783,和康生,49,16,33,富邦-嘉義,2023-04-19,9692
00712,復華富時不動產,34,2,32,富邦-嘉義,2023-04-19,9692
6829,千附精密,67,37,30,富邦-嘉義,2023-04-19,9692
00902,中信電池及儲能,27,0,27,富邦-嘉義,2023-04-19,9692
00680L,元大美債20正2,25,0,25,富邦-嘉義,2023-04-19,9692
1219,福壽,25,0,25,富邦-嘉義,2023-04-19,9692
00720B,元大投資級公司債,24,0,24,富邦-嘉義,2023-04-19,9692
5488,松普,23,0,23,富邦-嘉義,2023-04-19,9692
6477,安集,331,309,22,富邦-嘉義,2023-04-19,9692
3466,德晉,25,3,22,富邦-嘉義,2023-04-19,9692
4102,永日,21,0,21,富邦-嘉義,2023-04-19,9692
6841,長佳智能,37,16,21,富邦-嘉義,2023-04-19,9692
3004,豐達科,112,92,20,富邦-嘉義,2023-04-19,9692
00888,永豐台灣ESG,19,0,19,富邦-嘉義,2023-04-19,9692
2388,威盛,22,3,19,富邦-嘉義,2023-04-19,9692
00922,國泰台灣領袖50,19,0,19,富邦-嘉義,2023-04-19,9692
2855,統一證,18,0,18,富邦-嘉義,2023-04-19,9692
6240,松崗,18,0,18,富邦-嘉義,2023-04-19,9692
00751B,元大AAA至A公司債,16,0,16,富邦-嘉義,2023-04-19,9692
2630,亞航,22,6,16,富邦-嘉義,2023-04-19,9692
2449,京元電子,19,4,15,富邦-嘉義,2023-04-19,9692
6122,擎邦,24,9,15,富邦-嘉義,2023-04-19,9692
6163,華電網,337,118,219,富邦-嘉義,2023-04-20,9692
1905,華紙,1258,1102,156,富邦-嘉義,2023-04-20,9692
8222,寶一,202,73,129,富邦-嘉義,2023-04-20,9692
2495,普安,112,1,111,富邦-嘉義,2023-04-20,9692
2913,農林,284,175,109,富邦-嘉義,2023-04-20,9692
1611,中電,134,29,105,富邦-嘉義,2023-04-20,9692
1909,榮成,433,333,100,富邦-嘉義,2023-04-20,9692
3443,創意,106,6,100,富邦-嘉義,2023-04-20,9692
3661,世芯-KY,101,25,76,富邦-嘉義,2023-04-20,9692
00878,國泰永續高股息,125,65,60,富邦-嘉義,2023-04-20,9692
2312,金寶,55,0,55,富邦-嘉義,2023-04-20,9692
3006,晶豪科,56,2,54,富邦-嘉義,2023-04-20,9692
2885,元大金,53,0,53,富邦-嘉義,2023-04-20,9692
6134,萬旭,110,59,51,富邦-嘉義,2023-04-20,9692
3576,聯合再生,210,159,51,富邦-嘉義,2023-04-20,9692
00772B,中信高評級公司債,46,0,46,富邦-嘉義,2023-04-20,9692
6806,森崴能源,57,16,41,富邦-嘉義,2023-04-20,9692
4503,金雨,40,0,40,富邦-嘉義,2023-04-20,9692
4979,華星光,70,32,38,富邦-嘉義,2023-04-20,9692
1539,巨庭,38,0,38,富邦-嘉義,2023-04-20,9692
3704,合勤控,62,24,38,富邦-嘉義,2023-04-20,9692
2409,友達,37,1,36,富邦-嘉義,2023-04-20,9692
1609,大亞,50,15,35,富邦-嘉義,2023-04-20,9692
2402,毅嘉,48,16,32,富邦-嘉義,2023-04-20,9692
2618,長榮航,34,5,29,富邦-嘉義,2023-04-20,9692
1712,興農,34,5,29,富邦-嘉義,2023-04-20,9692
5302,太欣,30,1,29,富邦-嘉義,2023-04-20,9692
2324,仁寶,29,0,29,富邦-嘉義,2023-04-20,9692
2609,陽明,48,20,28,富邦-嘉義,2023-04-20,9692
0056,元大高股息,30,3,27,富邦-嘉義,2023-04-20,9692
6148,驊宏資,77,51,26,富邦-嘉義,2023-04-20,9692
3441,聯一光,28,2,26,富邦-嘉義,2023-04-20,9692
2498,宏達電,30,5,25,富邦-嘉義,2023-04-20,9692
6288,聯嘉,31,7,24,富邦-嘉義,2023-04-20,9692
8111,立��,46,22,24,富邦-嘉義,2023-04-20,9692
2105,正新,22,0,22,富邦-嘉義,2023-04-20,9692
3029,零壹,24,2,22,富邦-嘉義,2023-04-20,9692
5227,立凱-KY,36,14,22,富邦-嘉義,2023-04-20,9692
00893,國泰智能電動車,26,5,21,富邦-嘉義,2023-04-20,9692
00651R,復華香港反1,20,0,20,富邦-嘉義,2023-04-20,9692
1529,樂事綠能,55,35,20,富邦-嘉義,2023-04-20,9692
6182,合晶,20,0,20,富邦-嘉義,2023-04-20,9692
1722,台肥,20,0,20,富邦-嘉義,2023-04-20,9692
4532,瑞智,20,0,20,富邦-嘉義,2023-04-20,9692
8033,雷虎,133,114,19,富邦-嘉義,2023-04-20,9692
3033,威健,20,1,19,富邦-嘉義,2023-04-20,9692
1336,台翰,19,0,19,富邦-嘉義,2023-04-20,9692
1605,華新,27,9,18,富邦-嘉義,2023-04-20,9692
2356,英業達,20,2,18,富邦-嘉義,2023-04-20,9692
1907,永豐餘,69,51,18,富邦-嘉義,2023-04-20,9692
3324,雙鴻,278,32,246,富邦-嘉義,2023-04-21,9692
2634,漢翔,654,529,125,富邦-嘉義,2023-04-21,9692
2312,金寶,130,10,120,富邦-嘉義,2023-04-21,9692
6829,千附精密,205,102,103,富邦-嘉義,2023-04-21,9692
1810,和成,273,170,103,富邦-嘉義,2023-04-21,9692
3481,群創,108,22,86,富邦-嘉義,2023-04-21,9692
2867,三商壽,72,0,72,富邦-嘉義,2023-04-21,9692
6733,博晟生醫,69,1,68,富邦-嘉義,2023-04-21,9692
00715L,期街口布蘭特正2,61,6,55,富邦-嘉義,2023-04-21,9692
1608,華榮,51,1,50,富邦-嘉義,2023-04-21,9692
2031,新光鋼,297,249,48,富邦-嘉義,2023-04-21,9692
3652,精聯,46,0,46,富邦-嘉義,2023-04-21,9692
1722,台肥,44,2,42,富邦-嘉義,2023-04-21,9692
1409,新纖,141,100,41,富邦-嘉義,2023-04-21,9692
6160,欣技,42,1,41,富邦-嘉義,2023-04-21,9692
2515,中工,82,41,41,富邦-嘉義,2023-04-21,9692
6416,瑞祺電通,36,0,36,富邦-嘉義,2023-04-21,9692
2356,英業達,36,4,32,富邦-嘉義,2023-04-21,9692
1522,堤維西,34,3,31,富邦-嘉義,2023-04-21,9692
0056,元大高股息,39,9,30,富邦-嘉義,2023-04-21,9692
00651R,復華香港反1,30,0,30,富邦-嘉義,2023-04-21,9692
2365,昆盈,40,10,30,富邦-嘉義,2023-04-21,9692
00679B,元大美債20年,32,2,30,富邦-嘉義,2023-04-21,9692
2495,普安,31,2,29,富邦-嘉義,2023-04-21,9692
1714,和桐,29,0,29,富邦-嘉義,2023-04-21,9692
1907,永豐餘,1274,1246,28,富邦-嘉義,2023-04-21,9692
6271,同欣電,28,0,28,富邦-嘉義,2023-04-21,9692
3006,晶豪科,30,2,28,富邦-嘉義,2023-04-21,9692
3576,聯合再生,29,1,28,富邦-嘉義,2023-04-21,9692
3162,精確,41,17,24,富邦-嘉義,2023-04-21,9692
2739,寒舍,24,0,24,富邦-嘉義,2023-04-21,9692
00720B,元大投資級公司債,24,0,24,富邦-嘉義,2023-04-21,9692
00900,富邦特選高股息30,23,0,23,富邦-嘉義,2023-04-21,9692
00686R,群益臺灣加權反1,23,0,23,富邦-嘉義,2023-04-21,9692
3501,維熹,33,11,22,富邦-嘉義,2023-04-21,9692
8076,伍豐,25,3,22,富邦-嘉義,2023-04-21,9692
1783,和康生,31,10,21,富邦-嘉義,2023-04-21,9692
2340,台亞,21,0,21,富邦-嘉義,2023-04-21,9692
4532,瑞智,21,0,21,富邦-嘉義,2023-04-21,9692
7402,邑錡,23,2,21,富邦-嘉義,2023-04-21,9692
8093,保銳,20,0,20,富邦-嘉義,2023-04-21,9692
00671R,富邦NASDAQ反1,20,0,20,富邦-嘉義,2023-04-21,9692
00638R,元大滬深300反1,20,0,20,富邦-嘉義,2023-04-21,9692
00919,群益台灣精選高息,20,2,18,富邦-嘉義,2023-04-21,9692
2328,廣宇,24,6,18,富邦-嘉義,2023-04-21,9692
1310,台苯,27,10,17,富邦-嘉義,2023-04-21,9692
2645,長榮航太,21,5,16,富邦-嘉義,2023-04-21,9692
2888,新光金,17,1,16,富邦-嘉義,2023-04-21,9692
1308,亞聚,16,0,16,富邦-嘉義,2023-04-21,9692
00712,復華富時不動產,20,4,16,富邦-嘉義,2023-04-21,9692
1721,三晃,484,75,409,富邦-嘉義,2023-04-24,9692
2634,漢翔,2495,2289,206,富邦-嘉義,2023-04-24,9692
6218,豪勉,178,3,175,富邦-嘉義,2023-04-24,9692
6282,康舒,301,129,172,富邦-嘉義,2023-04-24,9692
3324,雙鴻,151,4,147,富邦-嘉義,2023-04-24,9692
6234,高僑,426,280,146,富邦-嘉義,2023-04-24,9692
1310,台苯,288,152,136,富邦-嘉義,2023-04-24,9692
1101,台泥,334,248,86,富邦-嘉義,2023-04-24,9692
00902,中信電池及儲能,87,5,82,富邦-嘉義,2023-04-24,9692
6625,必應,251,182,69,富邦-嘉義,2023-04-24,9692
2328,廣宇,67,0,67,富邦-嘉義,2023-04-24,9692
6266,泰詠,60,0,60,富邦-嘉義,2023-04-24,9692
4121,優盛,59,0,59,富邦-嘉義,2023-04-24,9692
00900,富邦特選高股息30,68,11,57,富邦-嘉義,2023-04-24,9692
2312,金寶,56,0,56,富邦-嘉義,2023-04-24,9692
00878,國泰永續高股息,86,32,54,富邦-嘉義,2023-04-24,9692
6752,叡揚,91,40,51,富邦-嘉義,2023-04-24,9692
00772B,中信高評級公司債,49,0,49,富邦-嘉義,2023-04-24,9692
00679B,元大美債20年,50,3,47,富邦-嘉義,2023-04-24,9692
1503,士電,308,261,47,富邦-嘉義,2023-04-24,9692
2471,資通,85,42,43,富邦-嘉義,2023-04-24,9692
2801,彰銀,40,0,40,富邦-嘉義,2023-04-24,9692
9907,統一實,38,1,37,富邦-嘉義,2023-04-24,9692
1711,永光,385,350,35,富邦-嘉義,2023-04-24,9692
1905,華紙,1474,1440,34,富邦-嘉義,2023-04-24,9692
6547,高端疫苗,122,91,31,富邦-嘉義,2023-04-24,9692
00720B,元大投資級公司債,31,0,31,富邦-嘉義,2023-04-24,9692
2913,農林,159,129,30,富邦-嘉義,2023-04-24,9692
1720,生達,30,2,28,富邦-嘉義,2023-04-24,9692
2610,華航,41,16,25,富邦-嘉義,2023-04-24,9692
6244,茂迪,84,59,25,富邦-嘉義,2023-04-24,9692
3308,聯德,25,0,25,富邦-嘉義,2023-04-24,9692
00712,復華富時不動產,24,0,24,富邦-嘉義,2023-04-24,9692
3712,永崴投控,25,1,24,富邦-嘉義,2023-04-24,9692
00713,元大台灣高息低波,23,0,23,富邦-嘉義,2023-04-24,9692
2206,三陽工業,33,10,23,富邦-嘉義,2023-04-24,9692
5009,榮剛,27,4,23,富邦-嘉義,2023-04-24,9692
2344,華邦電,28,7,21,富邦-嘉義,2023-04-24,9692
2329,華泰,20,0,20,富邦-嘉義,2023-04-24,9692
6156,松上,20,0,20,富邦-嘉義,2023-04-24,9692
00638R,元大滬深300反1,20,0,20,富邦-嘉義,2023-04-24,9692
1519,華城,202,183,19,富邦-嘉義,2023-04-24,9692
1533,車王電,17,0,17,富邦-嘉義,2023-04-24,9692
1584,精剛,44,28,16,富邦-嘉義,2023-04-24,9692
00637L,元大滬深300正2,16,0,16,富邦-嘉義,2023-04-24,9692
2313,華通,19,4,15,富邦-嘉義,2023-04-24,9692
1722,台肥,15,0,15,富邦-嘉義,2023-04-24,9692
1712,興農,16,1,15,富邦-嘉義,2023-04-24,9692
2486,一詮,20,5,15,富邦-嘉義,2023-04-24,9692
1909,榮成,19,4,15,富邦-嘉義,2023-04-24,9692
00878,國泰永續高股息,233,61,172,富邦-嘉義,2023-04-25,9692
00665L,富邦�琤肭磪囓�2,211,70,141,富邦-嘉義,2023-04-25,9692
6116,彩晶,121,5,116,富邦-嘉義,2023-04-25,9692
00676R,富邦臺灣加權反1,92,0,92,富邦-嘉義,2023-04-25,9692
00753L,中信中國50正2,90,0,90,富邦-嘉義,2023-04-25,9692
0056,元大高股息,89,8,81,富邦-嘉義,2023-04-25,9692
00902,中信電池及儲能,72,1,71,富邦-嘉義,2023-04-25,9692
1101,台泥,106,36,70,富邦-嘉義,2023-04-25,9692
2208,台船,78,13,65,富邦-嘉義,2023-04-25,9692
00673R,期元大S＆P原油反1,72,11,61,富邦-嘉義,2023-04-25,9692
00892,富邦台灣半導體,58,0,58,富邦-嘉義,2023-04-25,9692
8222,寶一,393,340,53,富邦-嘉義,2023-04-25,9692
1313,聯成,50,0,50,富邦-嘉義,2023-04-25,9692
2618,長榮航,60,12,48,富邦-嘉義,2023-04-25,9692
2515,中工,66,22,44,富邦-嘉義,2023-04-25,9692
6244,茂迪,83,39,44,富邦-嘉義,2023-04-25,9692
1904,正隆,60,17,43,富邦-嘉義,2023-04-25,9692
5009,榮剛,59,17,42,富邦-嘉義,2023-04-25,9692
2371,大同,38,2,36,富邦-嘉義,2023-04-25,9692
8121,越峰,57,22,35,富邦-嘉義,2023-04-25,9692
2313,華通,37,3,34,富邦-嘉義,2023-04-25,9692
2614,東森,32,0,32,富邦-嘉義,2023-04-25,9692
4147,中裕,49,20,29,富邦-嘉義,2023-04-25,9692
4916,事欣科,30,2,28,富邦-嘉義,2023-04-25,9692
4306,炎洲,33,5,28,富邦-嘉義,2023-04-25,9692
3058,立德,29,1,28,富邦-嘉義,2023-04-25,9692
1722,台肥,27,2,25,富邦-嘉義,2023-04-25,9692
00680L,元大美債20正2,43,20,23,富邦-嘉義,2023-04-25,9692
2342,茂矽,26,3,23,富邦-嘉義,2023-04-25,9692
2905,三商,24,1,23,富邦-嘉義,2023-04-25,9692
2002,中鋼,22,0,22,富邦-嘉義,2023-04-25,9692
1720,生達,35,13,22,富邦-嘉義,2023-04-25,9692
3189,景碩,22,1,21,富邦-嘉義,2023-04-25,9692
6160,欣技,27,7,20,富邦-嘉義,2023-04-25,9692
3004,豐達科,21,1,20,富邦-嘉義,2023-04-25,9692
8105,凌巨,20,1,19,富邦-嘉義,2023-04-25,9692
2368,金像電,19,1,18,富邦-嘉義,2023-04-25,9692
006208,富邦台50,18,0,18,富邦-嘉義,2023-04-25,9692
1605,華新,44,26,18,富邦-嘉義,2023-04-25,9692
6470,宇智,21,3,18,富邦-嘉義,2023-04-25,9692
0050,元大台灣50,19,1,18,富邦-嘉義,2023-04-25,9692
00919,群益台灣精選高息,20,3,17,富邦-嘉義,2023-04-25,9692
6461,益得,44,27,17,富邦-嘉義,2023-04-25,9692
4566,時碩工業,177,160,17,富邦-嘉義,2023-04-25,9692
2457,飛宏,82,66,16,富邦-嘉義,2023-04-25,9692
2330,台積電,21,5,16,富邦-嘉義,2023-04-25,9692
2913,農林,65,49,16,富邦-嘉義,2023-04-25,9692
4960,誠美材,15,0,15,富邦-嘉義,2023-04-25,9692
2607,榮運,16,1,15,富邦-嘉義,2023-04-25,9692
1220,台榮,15,0,15,富邦-嘉義,2023-04-25,9692
1721,三晃,2064,1164,900,富邦-嘉義,2023-04-26,9692
1810,和成,234,68,166,富邦-嘉義,2023-04-26,9692
2313,華通,124,3,121,富邦-嘉義,2023-04-26,9692
00878,國泰永續高股息,135,35,100,富邦-嘉義,2023-04-26,9692
3189,景碩,100,2,98,富邦-嘉義,2023-04-26,9692
1905,華紙,2092,2016,76,富邦-嘉義,2023-04-26,9692
2634,漢翔,975,903,72,富邦-嘉義,2023-04-26,9692
3294,英濟,76,6,70,富邦-嘉義,2023-04-26,9692
1310,台苯,315,248,67,富邦-嘉義,2023-04-26,9692
1710,東聯,91,28,63,富邦-嘉義,2023-04-26,9692
6733,博晟生醫,62,1,61,富邦-嘉義,2023-04-26,9692
2601,益航,51,0,51,富邦-嘉義,2023-04-26,9692
2441,超豐,50,0,50,富邦-嘉義,2023-04-26,9692
00680L,元大美債20正2,51,6,45,富邦-嘉義,2023-04-26,9692
3046,建��,51,7,44,富邦-嘉義,2023-04-26,9692
2312,金寶,41,0,41,富邦-嘉義,2023-04-26,9692
2610,華航,52,14,38,富邦-嘉義,2023-04-26,9692
00712,復華富時不動產,52,15,37,富邦-嘉義,2023-04-26,9692
00713,元大台灣高息低波,37,0,37,富邦-嘉義,2023-04-26,9692
2547,日勝生,37,0,37,富邦-嘉義,2023-04-26,9692
2206,三陽工業,113,77,36,富邦-嘉義,2023-04-26,9692
2204,中華,60,26,34,富邦-嘉義,2023-04-26,9692
00671R,富邦NASDAQ反1,30,0,30,富邦-嘉義,2023-04-26,9692
3035,智原,40,13,27,富邦-嘉義,2023-04-26,9692
2208,台船,30,4,26,富邦-嘉義,2023-04-26,9692
2002,中鋼,27,2,25,富邦-嘉義,2023-04-26,9692
6770,力積電,24,0,24,富邦-嘉義,2023-04-26,9692
2645,長榮航太,26,2,24,富邦-嘉義,2023-04-26,9692
4979,華星光,47,23,24,富邦-嘉義,2023-04-26,9692
00753L,中信中國50正2,23,0,23,富邦-嘉義,2023-04-26,9692
1460,宏遠,22,0,22,富邦-嘉義,2023-04-26,9692
00885,富邦越南,23,2,21,富邦-嘉義,2023-04-26,9692
00715L,期街口布蘭特正2,21,0,21,富邦-嘉義,2023-04-26,9692
2609,陽明,42,22,20,富邦-嘉義,2023-04-26,9692
00692,富邦公司治理,21,0,21,富邦-嘉義,2023-04-26,9692
6234,高僑,31,11,20,富邦-嘉義,2023-04-26,9692
2328,廣宇,21,1,20,富邦-嘉義,2023-04-26,9692
00638R,元大滬深300反1,20,0,20,富邦-嘉義,2023-04-26,9692
00648R,元大S＆P500反1,20,0,20,富邦-嘉義,2023-04-26,9692
3029,零壹,19,0,19,富邦-嘉義,2023-04-26,9692
00676R,富邦臺灣加權反1,18,0,18,富邦-嘉義,2023-04-26,9692
00853B,統一美債10年Aa-,18,0,18,富邦-嘉義,2023-04-26,9692
1609,大亞,26,8,18,富邦-嘉義,2023-04-26,9692
8403,盛弘,16,0,16,富邦-嘉義,2023-04-26,9692
2603,長榮,16,1,15,富邦-嘉義,2023-04-26,9692
1618,合機,14,0,14,富邦-嘉義,2023-04-26,9692
8227,巨有科技,84,70,14,富邦-嘉義,2023-04-26,9692
2337,旺宏,90,77,13,富邦-嘉義,2023-04-26,9692
1605,華新,24,11,13,富邦-嘉義,2023-04-26,9692
00720B,元大投資級公司債,13,0,13,富邦-嘉義,2023-04-26,9692
00715L,期街口布蘭特正2,264,0,264,富邦-嘉義,2023-04-27,9692
1711,永光,1524,1291,233,富邦-嘉義,2023-04-27,9692
3324,雙鴻,271,45,226,富邦-嘉義,2023-04-27,9692
2471,資通,350,138,212,富邦-嘉義,2023-04-27,9692
4572,駐龍,278,141,137,富邦-嘉義,2023-04-27,9692
4541,晟田,261,138,123,富邦-嘉義,2023-04-27,9692
2303,聯電,134,15,119,富邦-嘉義,2023-04-27,9692
2801,彰銀,121,4,117,富邦-嘉義,2023-04-27,9692
2845,遠東銀,104,0,104,富邦-嘉義,2023-04-27,9692
4916,事欣科,160,69,91,富邦-嘉義,2023-04-27,9692
3363,上詮,128,38,90,富邦-嘉義,2023-04-27,9692
6288,聯嘉,200,112,88,富邦-嘉義,2023-04-27,9692
1101,台泥,88,4,84,富邦-嘉義,2023-04-27,9692
6179,亞通,72,1,71,富邦-嘉義,2023-04-27,9692
1529,樂事綠能,94,28,66,富邦-嘉義,2023-04-27,9692
00679B,元大美債20年,68,5,63,富邦-嘉義,2023-04-27,9692
6148,驊宏資,219,158,61,富邦-嘉義,2023-04-27,9692
6234,高僑,255,200,55,富邦-嘉義,2023-04-27,9692
00712,復華富時不動產,51,0,51,富邦-嘉義,2023-04-27,9692
1710,東聯,253,202,51,富邦-嘉義,2023-04-27,9692
8222,寶一,745,696,49,富邦-嘉義,2023-04-27,9692
00772B,中信高評級公司債,50,2,48,富邦-嘉義,2023-04-27,9692
4121,優盛,68,23,45,富邦-嘉義,2023-04-27,9692
6741,91APP*-KY,212,167,45,富邦-嘉義,2023-04-27,9692
2002,中鋼,50,5,45,富邦-嘉義,2023-04-27,9692
2495,普安,48,5,43,富邦-嘉義,2023-04-27,9692
00877,復華中國5G,38,0,38,富邦-嘉義,2023-04-27,9692
2897,王道銀行,35,0,35,富邦-嘉義,2023-04-27,9692
3071,協禧,43,11,32,富邦-嘉義,2023-04-27,9692
00753L,中信中國50正2,31,0,31,富邦-嘉義,2023-04-27,9692
4581,光隆精密-KY,55,25,30,富邦-嘉義,2023-04-27,9692
00706L,期元大S＆P日圓正2,30,0,30,富邦-嘉義,2023-04-27,9692
00751B,元大AAA至A公司債,30,0,30,富邦-嘉義,2023-04-27,9692
5483,中美晶,33,3,30,富邦-嘉義,2023-04-27,9692
6829,千附精密,271,243,28,富邦-嘉義,2023-04-27,9692
2609,陽明,34,6,28,富邦-嘉義,2023-04-27,9692
2312,金寶,36,10,26,富邦-嘉義,2023-04-27,9692
2884,玉山金,28,5,23,富邦-嘉義,2023-04-27,9692
00720B,元大投資級公司債,25,2,23,富邦-嘉義,2023-04-27,9692
2352,佳世達,24,2,22,富邦-嘉義,2023-04-27,9692
1336,台翰,22,0,22,富邦-嘉義,2023-04-27,9692
2913,農林,34,12,22,富邦-嘉義,2023-04-27,9692
2388,威盛,26,5,21,富邦-嘉義,2023-04-27,9692
8033,雷虎,41,20,21,富邦-嘉義,2023-04-27,9692
6244,茂迪,45,24,21,富邦-嘉義,2023-04-27,9692
3624,光頡,32,11,21,富邦-嘉義,2023-04-27,9692
1717,長興,118,97,21,富邦-嘉義,2023-04-27,9692
00648R,元大S＆P500反1,20,0,20,富邦-嘉義,2023-04-27,9692
8150,南茂,20,0,20,富邦-嘉義,2023-04-27,9692
6282,康舒,160,141,19,富邦-嘉義,2023-04-27,9692
8069,元太,867,24,843,富邦-嘉義,2023-04-28,9692
6148,驊宏資,551,4,547,富邦-嘉義,2023-04-28,9692
2880,華南金,273,14,259,富邦-嘉義,2023-04-28,9692
2471,資通,1589,1360,229,富邦-嘉義,2023-04-28,9692
8093,保銳,206,11,195,富邦-嘉義,2023-04-28,9692
3481,群創,260,110,150,富邦-嘉義,2023-04-28,9692
2482,連宇,468,334,134,富邦-嘉義,2023-04-28,9692
1727,中華化,317,216,101,富邦-嘉義,2023-04-28,9692
2409,友達,102,10,92,富邦-嘉義,2023-04-28,9692
5222,全訊,124,33,91,富邦-嘉義,2023-04-28,9692
2867,三商壽,100,10,90,富邦-嘉義,2023-04-28,9692
6443,元晶,85,1,84,富邦-嘉義,2023-04-28,9692
1503,士電,82,4,78,富邦-嘉義,2023-04-28,9692
4121,優盛,113,43,70,富邦-嘉義,2023-04-28,9692
3479,安勤,148,85,63,富邦-嘉義,2023-04-28,9692
2453,凌群,904,842,62,富邦-嘉義,2023-04-28,9692
00882,中信中國高股息,50,0,50,富邦-嘉義,2023-04-28,9692
1460,宏遠,50,0,50,富邦-嘉義,2023-04-28,9692
3419,譁裕,60,13,47,富邦-嘉義,2023-04-28,9692
8403,盛弘,369,324,45,富邦-嘉義,2023-04-28,9692
3058,立德,50,6,44,富邦-嘉義,2023-04-28,9692
2352,佳世達,48,7,41,富邦-嘉義,2023-04-28,9692
00665L,富邦�琤肭磪囓�2,42,4,38,富邦-嘉義,2023-04-28,9692
1101,台泥,45,9,36,富邦-嘉義,2023-04-28,9692
1905,華紙,241,210,31,富邦-嘉義,2023-04-28,9692
4763,材料-KY,71,41,30,富邦-嘉義,2023-04-28,9692
00683L,期元大美元指正2,30,0,30,富邦-嘉義,2023-04-28,9692
6235,華孚,40,11,29,富邦-嘉義,2023-04-28,9692
6026,福邦證,30,5,25,富邦-嘉義,2023-04-28,9692
00676R,富邦臺灣加權反1,25,1,24,富邦-嘉義,2023-04-28,9692
3046,建��,56,32,24,富邦-嘉義,2023-04-28,9692
4961,天鈺,59,35,24,富邦-嘉義,2023-04-28,9692
2344,華邦電,274,250,24,富邦-嘉義,2023-04-28,9692
00878,國泰永續高股息,38,15,23,富邦-嘉義,2023-04-28,9692
6625,必應,22,0,22,富邦-嘉義,2023-04-28,9692
00720B,元大投資級公司債,23,1,22,富邦-嘉義,2023-04-28,9692
00772B,中信高評級公司債,21,0,21,富邦-嘉義,2023-04-28,9692
1907,永豐餘,27,6,21,富邦-嘉義,2023-04-28,9692
2883,凱基金,23,2,21,富邦-嘉義,2023-04-28,9692
3178,公準,20,0,20,富邦-嘉義,2023-04-28,9692
2358,廷鑫,20,0,20,富邦-嘉義,2023-04-28,9692
00651R,復華香港反1,20,0,20,富邦-嘉義,2023-04-28,9692
1314,中石化,20,1,19,富邦-嘉義,2023-04-28,9692
6185,幃翔,28,10,18,富邦-嘉義,2023-04-28,9692
00916,國泰全球品牌50,20,2,18,富邦-嘉義,2023-04-28,9692
1718,中纖,25,7,18,富邦-嘉義,2023-04-28,9692
2342,茂矽,19,1,18,富邦-嘉義,2023-04-28,9692
2303,聯電,32,15,17,富邦-嘉義,2023-04-28,9692
6282,康舒,136,119,17,富邦-嘉義,2023-04-28,9692
8926,台汽電,20,3,17,富邦-嘉義,2023-04-28,9692
1519,華城,849,518,331,富邦-嘉義,2023-05-02,9692
1503,士電,653,351,302,富邦-嘉義,2023-05-02,9692
5465,富驊,452,299,153,富邦-嘉義,2023-05-02,9692
00665L,富邦�琤肭磪囓�2,236,83,153,富邦-嘉義,2023-05-02,9692
1529,樂事綠能,537,393,144,富邦-嘉義,2023-05-02,9692
2409,友達,112,1,111,富邦-嘉義,2023-05-02,9692
00900,富邦特選高股息30,107,1,106,富邦-嘉義,2023-05-02,9692
2206,三陽工業,373,267,106,富邦-嘉義,2023-05-02,9692
1909,榮成,92,0,92,富邦-嘉義,2023-05-02,9692
1905,華紙,1834,1746,88,富邦-嘉義,2023-05-02,9692
1514,亞力,828,749,79,富邦-嘉義,2023-05-02,9692
2002,中鋼,77,1,76,富邦-嘉義,2023-05-02,9692
8105,凌巨,67,11,56,富邦-嘉義,2023-05-02,9692
6589,台康生技,64,14,50,富邦-嘉義,2023-05-02,9692
1314,中石化,52,2,50,富邦-嘉義,2023-05-02,9692
00679B,元大美債20年,49,1,48,富邦-嘉義,2023-05-02,9692
4968,立積,313,266,47,富邦-嘉義,2023-05-02,9692
1513,中興電,311,264,47,富邦-嘉義,2023-05-02,9692
2603,長榮,519,475,44,富邦-嘉義,2023-05-02,9692
2884,玉山金,48,10,38,富邦-嘉義,2023-05-02,9692
2880,華南金,39,2,37,富邦-嘉義,2023-05-02,9692
2312,金寶,50,13,37,富邦-嘉義,2023-05-02,9692
1721,三晃,106,70,36,富邦-嘉義,2023-05-02,9692
1727,中華化,70,37,33,富邦-嘉義,2023-05-02,9692
2457,飛宏,52,21,31,富邦-嘉義,2023-05-02,9692
4746,台耀,62,32,30,富邦-嘉義,2023-05-02,9692
00772B,中信高評級公司債,27,0,27,富邦-嘉義,2023-05-02,9692
00725B,國泰投資級公司債,27,0,27,富邦-嘉義,2023-05-02,9692
2609,陽明,42,16,26,富邦-嘉義,2023-05-02,9692
2887,台新金,25,2,23,富邦-嘉義,2023-05-02,9692
00680L,元大美債20正2,22,0,22,富邦-嘉義,2023-05-02,9692
6160,欣技,22,0,22,富邦-嘉義,2023-05-02,9692
4967,十銓,37,16,21,富邦-嘉義,2023-05-02,9692
6235,華孚,21,0,21,富邦-嘉義,2023-05-02,9692
1734,杏輝,20,0,20,富邦-嘉義,2023-05-02,9692
4161,聿新科,20,0,20,富邦-嘉義,2023-05-02,9692
00638R,元大滬深300反1,20,0,20,富邦-嘉義,2023-05-02,9692
1783,和康生,20,0,20,富邦-嘉義,2023-05-02,9692
3661,世芯-KY,286,266,20,富邦-嘉義,2023-05-02,9692
00773B,中信優先金融債,19,0,19,富邦-嘉義,2023-05-02,9692
00916,國泰全球品牌50,20,1,19,富邦-嘉義,2023-05-02,9692
8046,南電,34,15,19,富邦-嘉義,2023-05-02,9692
00751B,元大AAA至A公司債,19,0,19,富邦-嘉義,2023-05-02,9692
00712,復華富時不動產,18,0,18,富邦-嘉義,2023-05-02,9692
3363,上詮,65,47,18,富邦-嘉義,2023-05-02,9692
3481,群創,27,9,18,富邦-嘉義,2023-05-02,9692
3058,立德,60,43,17,富邦-嘉義,2023-05-02,9692
2344,華邦電,204,188,16,富邦-嘉義,2023-05-02,9692
5531,鄉林,16,0,16,富邦-嘉義,2023-05-02,9692
4763,材料-KY,140,124,16,富邦-嘉義,2023-05-02,9692
00715L,期街口布蘭特正2,451,0,451,富邦-嘉義,2023-05-03,9692
2883B,凱基金乙特,105,0,105,富邦-嘉義,2023-05-03,9692
00665L,富邦�琤肭磪囓�2,106,2,104,富邦-嘉義,2023-05-03,9692
3664,安瑞-KY,101,0,101,富邦-嘉義,2023-05-03,9692
00878,國泰永續高股息,115,16,99,富邦-嘉義,2023-05-03,9692
2634,漢翔,813,718,95,富邦-嘉義,2023-05-03,9692
1310,台苯,146,60,86,富邦-嘉義,2023-05-03,9692
00712,復華富時不動產,77,0,77,富邦-嘉義,2023-05-03,9692
6167,久正,90,14,76,富邦-嘉義,2023-05-03,9692
3443,創意,84,12,72,富邦-嘉義,2023-05-03,9692
3481,群創,122,56,66,富邦-嘉義,2023-05-03,9692
4121,優盛,120,56,64,富邦-嘉義,2023-05-03,9692
3231,緯創,82,27,55,富邦-嘉義,2023-05-03,9692
2409,友達,66,11,55,富邦-嘉義,2023-05-03,9692
1727,中華化,97,42,55,富邦-嘉義,2023-05-03,9692
2302,麗正,53,0,53,富邦-嘉義,2023-05-03,9692
2890,永豐金,56,3,53,富邦-嘉義,2023-05-03,9692
6770,力積電,82,33,49,富邦-嘉義,2023-05-03,9692
1710,東聯,56,11,45,富邦-嘉義,2023-05-03,9692
2609,陽明,67,24,43,富邦-嘉義,2023-05-03,9692
8093,保銳,46,5,41,富邦-嘉義,2023-05-03,9692
8033,雷虎,39,0,39,富邦-嘉義,2023-05-03,9692
6168,宏齊,40,1,39,富邦-嘉義,2023-05-03,9692
1101,台泥,70,31,39,富邦-嘉義,2023-05-03,9692
1810,和成,53,16,37,富邦-嘉義,2023-05-03,9692
2603,長榮,959,922,37,富邦-嘉義,2023-05-03,9692
9907,統一實,33,0,33,富邦-嘉義,2023-05-03,9692
2002,中鋼,35,3,32,富邦-嘉義,2023-05-03,9692
5222,全訊,534,502,32,富邦-嘉義,2023-05-03,9692
00725B,國泰投資級公司債,27,0,27,富邦-嘉義,2023-05-03,9692
6112,邁達特,60,34,26,富邦-嘉義,2023-05-03,9692
00632R,元大台灣50反1,26,0,26,富邦-嘉義,2023-05-03,9692
2801,彰銀,25,0,25,富邦-嘉義,2023-05-03,9692
5351,鈺創,24,0,24,富邦-嘉義,2023-05-03,9692
1314,中石化,24,1,23,富邦-嘉義,2023-05-03,9692
6806,森崴能源,76,53,23,富邦-嘉義,2023-05-03,9692
2230,泰茂,25,2,23,富邦-嘉義,2023-05-03,9692
3078,僑威,25,4,21,富邦-嘉義,2023-05-03,9692
1609,大亞,110,89,21,富邦-嘉義,2023-05-03,9692
2615,萬海,22,2,20,富邦-嘉義,2023-05-03,9692
00690,兆豐藍籌30,20,0,20,富邦-嘉義,2023-05-03,9692
00638R,元大滬深300反1,20,0,20,富邦-嘉義,2023-05-03,9692
00651R,復華香港反1,20,0,20,富邦-嘉義,2023-05-03,9692
3494,誠研,20,0,20,富邦-嘉義,2023-05-03,9692
5321,美而快,37,17,20,富邦-嘉義,2023-05-03,9692
00676R,富邦臺灣加權反1,20,0,20,富邦-嘉義,2023-05-03,9692
3015,全漢,19,0,19,富邦-嘉義,2023-05-03,9692
00882,中信中國高股息,20,1,19,富邦-嘉義,2023-05-03,9692
6234,高僑,733,714,19,富邦-嘉義,2023-05-03,9692
3029,零壹,17,1,16,富邦-嘉義,2023-05-03,9692
4147,中裕,730,83,647,富邦-嘉義,2023-05-04,9692
4161,聿新科,511,0,511,富邦-嘉義,2023-05-04,9692
00715L,期街口布蘭特正2,502,2,500,富邦-嘉義,2023-05-04,9692
1503,士電,182,20,162,富邦-嘉義,2023-05-04,9692
1529,樂事綠能,377,222,155,富邦-嘉義,2023-05-04,9692
4173,久裕,305,156,149,富邦-嘉義,2023-05-04,9692
6191,精成科,114,9,105,富邦-嘉義,2023-05-04,9692
2883B,凱基金乙特,101,0,101,富邦-嘉義,2023-05-04,9692
00706L,期元大S＆P日圓正2,100,0,100,富邦-嘉義,2023-05-04,9692
3356,奇偶,190,90,100,富邦-嘉義,2023-05-04,9692
6806,森崴能源,125,26,99,富邦-嘉義,2023-05-04,9692
6218,豪勉,324,234,90,富邦-嘉義,2023-05-04,9692
00878,國泰永續高股息,89,18,71,富邦-嘉義,2023-05-04,9692
4108,懷特,82,12,70,富邦-嘉義,2023-05-04,9692
00712,復華富時不動產,69,0,69,富邦-嘉義,2023-05-04,9692
3058,立德,72,3,69,富邦-嘉義,2023-05-04,9692
5465,富驊,67,2,65,富邦-嘉義,2023-05-04,9692
2897,王道銀行,63,0,63,富邦-嘉義,2023-05-04,9692
1783,和康生,82,23,59,富邦-嘉義,2023-05-04,9692
1722,台肥,50,0,50,富邦-嘉義,2023-05-04,9692
1310,台苯,45,4,41,富邦-嘉義,2023-05-04,9692
2855,統一證,40,0,40,富邦-嘉義,2023-05-04,9692
1219,福壽,40,0,40,富邦-嘉義,2023-05-04,9692
2609,陽明,51,11,40,富邦-嘉義,2023-05-04,9692
2471,資通,203,170,33,富邦-嘉義,2023-05-04,9692
6234,高僑,227,196,31,富邦-嘉義,2023-05-04,9692
2486,一詮,31,0,31,富邦-嘉義,2023-05-04,9692
6548,長科*,27,0,27,富邦-嘉義,2023-05-04,9692
3006,晶豪科,28,3,25,富邦-嘉義,2023-05-04,9692
00632R,元大台灣50反1,46,21,25,富邦-嘉義,2023-05-04,9692
00679B,元大美債20年,31,7,24,富邦-嘉義,2023-05-04,9692
00725B,國泰投資級公司債,23,0,23,富邦-嘉義,2023-05-04,9692
00891,中信關鍵半導體,23,0,23,富邦-嘉義,2023-05-04,9692
2832,台產,22,0,22,富邦-嘉義,2023-05-04,9692
8926,台汽電,26,4,22,富邦-嘉義,2023-05-04,9692
8403,盛弘,50,29,21,富邦-嘉義,2023-05-04,9692
1608,華榮,117,96,21,富邦-嘉義,2023-05-04,9692
1616,億泰,21,0,21,富邦-嘉義,2023-05-04,9692
2867,三商壽,20,0,20,富邦-嘉義,2023-05-04,9692
2495,普安,23,3,20,富邦-嘉義,2023-05-04,9692
5009,榮剛,71,51,20,富邦-嘉義,2023-05-04,9692
6266,泰詠,36,16,20,富邦-嘉義,2023-05-04,9692
3494,誠研,26,7,19,富邦-嘉義,2023-05-04,9692
6517,保勝光學,50,31,19,富邦-嘉義,2023-05-04,9692
3071,協禧,18,0,18,富邦-嘉義,2023-05-04,9692
6244,茂迪,33,15,18,富邦-嘉義,2023-05-04,9692
00642U,期元大S＆P石油,40,22,18,富邦-嘉義,2023-05-04,9692
1305,華夏,16,0,16,富邦-嘉義,2023-05-04,9692
6148,驊宏資,272,256,16,富邦-嘉義,2023-05-04,9692
2630,亞航,70,54,16,富邦-嘉義,2023-05-04,9692
00715L,期街口布蘭特正2,195,0,195,富邦-嘉義,2023-05-05,9692
3715,定穎投控,152,0,152,富邦-嘉義,2023-05-05,9692
00878,國泰永續高股息,135,5,130,富邦-嘉義,2023-05-05,9692
00706L,期元大S＆P日圓正2,100,0,100,富邦-嘉義,2023-05-05,9692
8085,福華,102,5,97,富邦-嘉義,2023-05-05,9692
9955,佳龍,208,116,92,富邦-嘉義,2023-05-05,9692
1609,大亞,324,242,82,富邦-嘉義,2023-05-05,9692
2421,建準,138,62,76,富邦-嘉義,2023-05-05,9692
8222,寶一,281,210,71,富邦-嘉義,2023-05-05,9692
00712,復華富時不動產,65,0,65,富邦-嘉義,2023-05-05,9692
1314,中石化,55,2,53,富邦-嘉義,2023-05-05,9692
1734,杏輝,111,62,49,富邦-嘉義,2023-05-05,9692
6244,茂迪,96,51,45,富邦-嘉義,2023-05-05,9692
2352,佳世達,44,1,43,富邦-嘉義,2023-05-05,9692
2609,陽明,42,6,36,富邦-嘉義,2023-05-05,9692
00679B,元大美債20年,53,20,33,富邦-嘉義,2023-05-05,9692
1219,福壽,34,2,32,富邦-嘉義,2023-05-05,9692
00642U,期元大S＆P石油,29,0,29,富邦-嘉義,2023-05-05,9692
3207,耀勝,28,0,28,富邦-嘉義,2023-05-05,9692
2388,威盛,30,2,28,富邦-嘉義,2023-05-05,9692
2897,王道銀行,26,0,26,富邦-嘉義,2023-05-05,9692
2501,國建,26,0,26,富邦-嘉義,2023-05-05,9692
2353,宏��,140,115,25,富邦-嘉義,2023-05-05,9692
1905,華紙,47,22,25,富邦-嘉義,2023-05-05,9692
2634,漢翔,187,165,22,富邦-嘉義,2023-05-05,9692
00772B,中信高評級公司債,23,1,22,富邦-嘉義,2023-05-05,9692
6806,森崴能源,27,5,22,富邦-嘉義,2023-05-05,9692
00720B,元大投資級公司債,22,0,22,富邦-嘉義,2023-05-05,9692
00924,復華S＆P500成長,20,0,20,富邦-嘉義,2023-05-05,9692
020020,元大台股領航N,20,0,20,富邦-嘉義,2023-05-05,9692
00725B,國泰投資級公司債,20,0,20,富邦-嘉義,2023-05-05,9692
3038,全台,21,2,19,富邦-嘉義,2023-05-05,9692
1722,台肥,20,1,19,富邦-嘉義,2023-05-05,9692
00830,國泰費城半導體,17,0,17,富邦-嘉義,2023-05-05,9692
5309,系統電,19,2,17,富邦-嘉義,2023-05-05,9692
6592,和潤企業,17,0,17,富邦-嘉義,2023-05-05,9692
2489,瑞軒,21,5,16,富邦-嘉義,2023-05-05,9692
8936,國統,29,13,16,富邦-嘉義,2023-05-05,9692
4763,材料-KY,59,43,16,富邦-嘉義,2023-05-05,9692
3338,泰碩,350,335,15,富邦-嘉義,2023-05-05,9692
6112,邁達特,351,336,15,富邦-嘉義,2023-05-05,9692
3252,海灣,15,0,15,富邦-嘉義,2023-05-05,9692
2014,中鴻,16,1,15,富邦-嘉義,2023-05-05,9692
2344,華邦電,18,4,14,富邦-嘉義,2023-05-05,9692
00632R,元大台灣50反1,17,3,14,富邦-嘉義,2023-05-05,9692
2002,中鋼,14,0,14,富邦-嘉義,2023-05-05,9692
8155,博智,21,8,13,富邦-嘉義,2023-05-05,9692
3035,智原,14,1,13,富邦-嘉義,2023-05-05,9692
8249,菱光,13,0,13,富邦-嘉義,2023-05-05,9692
1711,永光,25,12,13,富邦-嘉義,2023-05-05,9692
1795,美時,355,33,322,富邦-嘉義,2023-05-08,9692
2883,凱基金,261,88,173,富邦-嘉義,2023-05-08,9692
1519,華城,260,99,161,富邦-嘉義,2023-05-08,9692
1605,華新,229,90,139,富邦-嘉義,2023-05-08,9692
6235,華孚,128,26,102,富邦-嘉義,2023-05-08,9692
6112,邁達特,454,352,102,富邦-嘉義,2023-05-08,9692
5864,致和證,100,0,100,富邦-嘉義,2023-05-08,9692
2471,資通,183,99,84,富邦-嘉義,2023-05-08,9692
00669R,國泰美國道瓊反1,80,0,80,富邦-嘉義,2023-05-08,9692
2365,昆盈,75,0,75,富邦-嘉義,2023-05-08,9692
3029,零壹,294,220,74,富邦-嘉義,2023-05-08,9692
6741,91APP*-KY,107,37,70,富邦-嘉義,2023-05-08,9692
00680L,元大美債20正2,65,0,65,富邦-嘉義,2023-05-08,9692
3483,力致,102,39,63,富邦-嘉義,2023-05-08,9692
3058,立德,55,2,53,富邦-嘉義,2023-05-08,9692
00632R,元大台灣50反1,53,1,52,富邦-嘉義,2023-05-08,9692
00671R,富邦NASDAQ反1,50,0,50,富邦-嘉義,2023-05-08,9692
4121,優盛,80,31,49,富邦-嘉義,2023-05-08,9692
2867,三商壽,50,2,48,富邦-嘉義,2023-05-08,9692
3703,欣陸,48,0,48,富邦-嘉義,2023-05-08,9692
2206,三陽工業,82,35,47,富邦-嘉義,2023-05-08,9692
2402,毅嘉,57,10,47,富邦-嘉義,2023-05-08,9692
1514,亞力,129,82,47,富邦-嘉義,2023-05-08,9692
4967,十銓,58,12,46,富邦-嘉義,2023-05-08,9692
00715L,期街口布蘭特正2,120,74,46,富邦-嘉義,2023-05-08,9692
3443,創意,117,75,42,富邦-嘉義,2023-05-08,9692
5315,光聯,37,0,37,富邦-嘉義,2023-05-08,9692
2888,新光金,37,3,34,富邦-嘉義,2023-05-08,9692
3481,群創,32,0,32,富邦-嘉義,2023-05-08,9692
2515,中工,36,4,32,富邦-嘉義,2023-05-08,9692
6179,亞通,69,37,32,富邦-嘉義,2023-05-08,9692
6443,元晶,44,13,31,富邦-嘉義,2023-05-08,9692
4173,久裕,89,58,31,富邦-嘉義,2023-05-08,9692
3693,營邦,92,62,30,富邦-嘉義,2023-05-08,9692
00679B,元大美債20年,34,6,28,富邦-嘉義,2023-05-08,9692
2845,遠東銀,35,11,24,富邦-嘉義,2023-05-08,9692
2371,大同,35,12,23,富邦-嘉義,2023-05-08,9692
00720B,元大投資級公司債,23,0,23,富邦-嘉義,2023-05-08,9692
1218,泰山,62,40,22,富邦-嘉義,2023-05-08,9692
5483,中美晶,28,6,22,富邦-嘉義,2023-05-08,9692
2897,王道銀行,21,0,21,富邦-嘉義,2023-05-08,9692
5465,富驊,23,2,21,富邦-嘉義,2023-05-08,9692
8358,金居,21,0,21,富邦-嘉義,2023-05-08,9692
1210,大成,31,10,21,富邦-嘉義,2023-05-08,9692
00882,中信中國高股息,51,31,20,富邦-嘉義,2023-05-08,9692
020020,元大台股領航N,20,0,20,富邦-嘉義,2023-05-08,9692
4541,晟田,407,388,19,富邦-嘉義,2023-05-08,9692
2406,國碩,20,1,19,富邦-嘉義,2023-05-08,9692
8016,矽創,18,0,18,富邦-嘉義,2023-05-08,9692
6125,廣運,27,10,17,富邦-嘉義,2023-05-08,9692
2421,建準,1395,137,1258,富邦-嘉義,2023-05-09,9692
00665L,富邦�琤肭磪囓�2,170,2,168,富邦-嘉義,2023-05-09,9692
00632R,元大台灣50反1,125,0,125,富邦-嘉義,2023-05-09,9692
00680L,元大美債20正2,77,0,77,富邦-嘉義,2023-05-09,9692
00673R,期元大S＆P原油反1,65,0,65,富邦-嘉義,2023-05-09,9692
2022,聚亨,60,10,50,富邦-嘉義,2023-05-09,9692
00720B,元大投資級公司債,40,0,40,富邦-嘉義,2023-05-09,9692
00878,國泰永續高股息,61,22,39,富邦-嘉義,2023-05-09,9692
1605,華新,193,158,35,富邦-嘉義,2023-05-09,9692
00772B,中信高評級公司債,37,2,35,富邦-嘉義,2023-05-09,9692
3324,雙鴻,303,269,34,富邦-嘉義,2023-05-09,9692
3017,奇鋐,44,12,32,富邦-嘉義,2023-05-09,9692
6275,元山,39,8,31,富邦-嘉義,2023-05-09,9692
6244,茂迪,49,20,29,富邦-嘉義,2023-05-09,9692
00725B,國泰投資級公司債,29,0,29,富邦-嘉義,2023-05-09,9692
00712,復華富時不動產,26,0,26,富邦-嘉義,2023-05-09,9692
2401,凌陽,24,0,24,富邦-嘉義,2023-05-09,9692
5475,德宏,24,0,24,富邦-嘉義,2023-05-09,9692
1513,中興電,686,662,24,富邦-嘉義,2023-05-09,9692
1101,台泥,39,18,21,富邦-嘉義,2023-05-09,9692
2641,正德,21,0,21,富邦-嘉義,2023-05-09,9692
5465,富驊,28,7,21,富邦-嘉義,2023-05-09,9692
00696B,富邦美債20年,20,0,20,富邦-嘉義,2023-05-09,9692
8093,保銳,22,2,20,富邦-嘉義,2023-05-09,9692
2911,麗嬰房,20,0,20,富邦-嘉義,2023-05-09,9692
2913,農林,86,66,20,富邦-嘉義,2023-05-09,9692
4919,新唐,22,3,19,富邦-嘉義,2023-05-09,9692
2444,兆勁,19,0,19,富邦-嘉義,2023-05-09,9692
4967,十銓,59,40,19,富邦-嘉義,2023-05-09,9692
2888,新光金,48,29,19,富邦-嘉義,2023-05-09,9692
3715,定穎投控,92,74,18,富邦-嘉義,2023-05-09,9692
6142,友勁,18,0,18,富邦-嘉義,2023-05-09,9692
00687B,國泰20年美債,17,0,17,富邦-嘉義,2023-05-09,9692
6477,安集,25,9,16,富邦-嘉義,2023-05-09,9692
3576,聯合再生,30,14,16,富邦-嘉義,2023-05-09,9692
4744,皇將,44,29,15,富邦-嘉義,2023-05-09,9692
2312,金寶,15,0,15,富邦-嘉義,2023-05-09,9692
00751B,元大AAA至A公司債,15,0,15,富邦-嘉義,2023-05-09,9692
1708,東鹼,21,7,14,富邦-嘉義,2023-05-09,9692
3481,群創,47,34,13,富邦-嘉義,2023-05-09,9692
2002,中鋼,14,1,13,富邦-嘉義,2023-05-09,9692
3034,聯詠,13,0,13,富邦-嘉義,2023-05-09,9692
2851,中再保,13,0,13,富邦-嘉義,2023-05-09,9692
2484,希華,14,2,12,富邦-嘉義,2023-05-09,9692
3149,正達,15,3,12,富邦-嘉義,2023-05-09,9692
1722,台肥,14,2,12,富邦-嘉義,2023-05-09,9692
6443,元晶,135,124,11,富邦-嘉義,2023-05-09,9692
2406,國碩,12,1,11,富邦-嘉義,2023-05-09,9692
5483,中美晶,11,0,11,富邦-嘉義,2023-05-09,9692
8033,雷虎,37,26,11,富邦-嘉義,2023-05-09,9692
6443,元晶,227,37,190,富邦-嘉義,2023-05-10,9692
6116,彩晶,126,0,126,富邦-嘉義,2023-05-10,9692
5498,凱崴,103,3,100,富邦-嘉義,2023-05-10,9692
3596,智易,100,1,99,富邦-嘉義,2023-05-10,9692
00878,國泰永續高股息,99,5,94,富邦-嘉義,2023-05-10,9692
6122,擎邦,102,24,78,富邦-嘉義,2023-05-10,9692
3661,世芯-KY,190,113,77,富邦-嘉義,2023-05-10,9692
00882,中信中國高股息,65,0,65,富邦-嘉義,2023-05-10,9692
00687B,國泰20年美債,59,0,59,富邦-嘉義,2023-05-10,9692
2883,凱基金,67,11,56,富邦-嘉義,2023-05-10,9692
00673R,期元大S＆P原油反1,55,0,55,富邦-嘉義,2023-05-10,9692
00902,中信電池及儲能,52,3,49,富邦-嘉義,2023-05-10,9692
5452,佶優,52,6,46,富邦-嘉義,2023-05-10,9692
3231,緯創,349,308,41,富邦-嘉義,2023-05-10,9692
2402,毅嘉,42,4,38,富邦-嘉義,2023-05-10,9692
6185,幃翔,61,25,36,富邦-嘉義,2023-05-10,9692
1609,大亞,125,92,33,富邦-嘉義,2023-05-10,9692
00712,復華富時不動產,33,0,33,富邦-嘉義,2023-05-10,9692
3013,晟銘電,89,59,30,富邦-嘉義,2023-05-10,9692
1444,力麗,30,0,30,富邦-嘉義,2023-05-10,9692
6218,豪勉,42,14,28,富邦-嘉義,2023-05-10,9692
00713,元大台灣高息低波,27,0,27,富邦-嘉義,2023-05-10,9692
00725B,國泰投資級公司債,26,0,26,富邦-嘉義,2023-05-10,9692
00680L,元大美債20正2,25,0,25,富邦-嘉義,2023-05-10,9692
00877,復華中國5G,24,0,24,富邦-嘉義,2023-05-10,9692
1529,樂事綠能,37,14,23,富邦-嘉義,2023-05-10,9692
4503,金雨,42,20,22,富邦-嘉義,2023-05-10,9692
4960,誠美材,21,0,21,富邦-嘉義,2023-05-10,9692
6538,倉和,21,0,21,富邦-嘉義,2023-05-10,9692
2312,金寶,20,0,20,富邦-嘉義,2023-05-10,9692
3209,全科,21,1,20,富邦-嘉義,2023-05-10,9692
3027,盛達,20,0,20,富邦-嘉義,2023-05-10,9692
2358,廷鑫,20,0,20,富邦-嘉義,2023-05-10,9692
6148,驊宏資,50,30,20,富邦-嘉義,2023-05-10,9692
00669R,國泰美國道瓊反1,20,0,20,富邦-嘉義,2023-05-10,9692
2385,群光,21,2,19,富邦-嘉義,2023-05-10,9692
00665L,富邦�琤肭磪囓�2,19,0,19,富邦-嘉義,2023-05-10,9692
2603,長榮,35,16,19,富邦-嘉義,2023-05-10,9692
00683L,期元大美元指正2,20,2,18,富邦-嘉義,2023-05-10,9692
00637L,元大滬深300正2,19,1,18,富邦-嘉義,2023-05-10,9692
2515,中工,20,2,18,富邦-嘉義,2023-05-10,9692
00664R,國泰臺灣加權反1,17,0,17,富邦-嘉義,2023-05-10,9692
1905,華紙,34,17,17,富邦-嘉義,2023-05-10,9692
3481,群創,19,3,16,富邦-嘉義,2023-05-10,9692
6625,必應,22,6,16,富邦-嘉義,2023-05-10,9692
2330,台積電,16,0,16,富邦-嘉義,2023-05-10,9692
2504,國產,15,0,15,富邦-嘉義,2023-05-10,9692
6290,良維,15,0,15,富邦-嘉義,2023-05-10,9692
1809,中釉,45,30,15,富邦-嘉義,2023-05-10,9692
2406,國碩,18,4,14,富邦-嘉義,2023-05-10,9692
1609,大亞,211,72,139,富邦-嘉義,2023-05-11,9692
2421,建準,170,67,103,富邦-嘉義,2023-05-11,9692
2312,金寶,95,0,95,富邦-嘉義,2023-05-11,9692
00673R,期元大S＆P原油反1,80,0,80,富邦-嘉義,2023-05-11,9692
00671R,富邦NASDAQ反1,100,20,80,富邦-嘉義,2023-05-11,9692
5864,致和證,70,0,70,富邦-嘉義,2023-05-11,9692
00665L,富邦�琤肭磪囓�2,110,44,66,富邦-嘉義,2023-05-11,9692
1314,中石化,61,0,61,富邦-嘉義,2023-05-11,9692
5452,佶優,56,1,55,富邦-嘉義,2023-05-11,9692
6285,啟��,49,1,48,富邦-嘉義,2023-05-11,9692
1447,力鵬,61,15,46,富邦-嘉義,2023-05-11,9692
00900,富邦特選高股息30,51,5,46,富邦-嘉義,2023-05-11,9692
2609,陽明,46,1,45,富邦-嘉義,2023-05-11,9692
9907,統一實,46,1,45,富邦-嘉義,2023-05-11,9692
1720,生達,41,4,37,富邦-嘉義,2023-05-11,9692
2371,大同,54,17,37,富邦-嘉義,2023-05-11,9692
1605,華新,42,8,34,富邦-嘉義,2023-05-11,9692
1524,耿鼎,37,4,33,富邦-嘉義,2023-05-11,9692
2890,永豐金,33,0,33,富邦-嘉義,2023-05-11,9692
00713,元大台灣高息低波,33,1,32,富邦-嘉義,2023-05-11,9692
8940,新天地,43,15,28,富邦-嘉義,2023-05-11,9692
1905,華紙,148,120,28,富邦-嘉義,2023-05-11,9692
00720B,元大投資級公司債,32,5,27,富邦-嘉義,2023-05-11,9692
6160,欣技,30,3,27,富邦-嘉義,2023-05-11,9692
00888,永豐台灣ESG,26,0,26,富邦-嘉義,2023-05-11,9692
3596,智易,27,1,26,富邦-嘉義,2023-05-11,9692
0056,元大高股息,34,8,26,富邦-嘉義,2023-05-11,9692
1409,新纖,25,0,25,富邦-嘉義,2023-05-11,9692
6219,富旺,25,0,25,富邦-嘉義,2023-05-11,9692
1776,展宇,24,0,24,富邦-嘉義,2023-05-11,9692
3202,樺晟,83,60,23,富邦-嘉義,2023-05-11,9692
1712,興農,29,6,23,富邦-嘉義,2023-05-11,9692
2106,建大,22,0,22,富邦-嘉義,2023-05-11,9692
3230,錦明,22,0,22,富邦-嘉義,2023-05-11,9692
3520,華盈,22,0,22,富邦-嘉義,2023-05-11,9692
3704,合勤控,24,2,22,富邦-嘉義,2023-05-11,9692
2603,長榮,22,0,22,富邦-嘉義,2023-05-11,9692
2399,映泰,20,0,20,富邦-嘉義,2023-05-11,9692
4173,久裕,20,0,20,富邦-嘉義,2023-05-11,9692
1777,生泰,20,1,19,富邦-嘉義,2023-05-11,9692
00772B,中信高評級公司債,20,1,19,富邦-嘉義,2023-05-11,9692
5009,榮剛,23,5,18,富邦-嘉義,2023-05-11,9692
00905,FT臺灣Smart,17,0,17,富邦-嘉義,2023-05-11,9692
3363,上詮,19,3,16,富邦-嘉義,2023-05-11,9692
3058,立德,21,5,16,富邦-嘉義,2023-05-11,9692
4121,優盛,19,4,15,富邦-嘉義,2023-05-11,9692
6163,華電網,17,3,14,富邦-嘉義,2023-05-11,9692
2515,中工,14,0,14,富邦-嘉義,2023-05-11,9692
3046,建��,27,13,14,富邦-嘉義,2023-05-11,9692
2887,台新金,19,5,14,富邦-嘉義,2023-05-11,9692
2371,大同,523,146,377,富邦-嘉義,2023-05-12,9692
00715L,期街口布蘭特正2,362,28,334,富邦-嘉義,2023-05-12,9692
2888,新光金,155,4,151,富邦-嘉義,2023-05-12,9692
2883,凱基金,129,11,118,富邦-嘉義,2023-05-12,9692
6122,擎邦,189,90,99,富邦-嘉義,2023-05-12,9692
00712,復華富時不動產,91,3,88,富邦-嘉義,2023-05-12,9692
00882,中信中國高股息,73,0,73,富邦-嘉義,2023-05-12,9692
2317,鴻海,71,6,65,富邦-嘉義,2023-05-12,9692
2409,友達,57,3,54,富邦-嘉義,2023-05-12,9692
3481,群創,48,6,42,富邦-嘉義,2023-05-12,9692
1101,台泥,44,4,40,富邦-嘉義,2023-05-12,9692
2890,永豐金,39,0,39,富邦-嘉義,2023-05-12,9692
2402,毅嘉,41,6,35,富邦-嘉義,2023-05-12,9692
2736,富野,92,62,30,富邦-嘉義,2023-05-12,9692
00671R,富邦NASDAQ反1,30,0,30,富邦-嘉義,2023-05-12,9692
3576,聯合再生,29,0,29,富邦-嘉義,2023-05-12,9692
2881,富邦金,31,2,29,富邦-嘉義,2023-05-12,9692
6016,康和證,25,0,25,富邦-嘉義,2023-05-12,9692
2884,玉山金,47,23,24,富邦-嘉義,2023-05-12,9692
1605,華新,35,12,23,富邦-嘉義,2023-05-12,9692
1609,大亞,173,151,22,富邦-嘉義,2023-05-12,9692
5284,jpp-KY,68,46,22,富邦-嘉義,2023-05-12,9692
1460,宏遠,20,0,20,富邦-嘉義,2023-05-12,9692
2745,五福,22,2,20,富邦-嘉義,2023-05-12,9692
1727,中華化,23,3,20,富邦-嘉義,2023-05-12,9692
6160,欣技,53,33,20,富邦-嘉義,2023-05-12,9692
1513,中興電,95,76,19,富邦-嘉義,2023-05-12,9692
1905,華紙,49,31,18,富邦-嘉義,2023-05-12,9692
00655L,國泰中國A50正2,15,0,15,富邦-嘉義,2023-05-12,9692
1519,華城,139,125,14,富邦-嘉義,2023-05-12,9692
1524,耿鼎,14,0,14,富邦-嘉義,2023-05-12,9692
6167,久正,16,2,14,富邦-嘉義,2023-05-12,9692
2630,亞航,45,31,14,富邦-嘉義,2023-05-12,9692
2882,國泰金,19,5,14,富邦-嘉義,2023-05-12,9692
6005,群益證,13,0,13,富邦-嘉義,2023-05-12,9692
2312,金寶,22,9,13,富邦-嘉義,2023-05-12,9692
8121,越峰,15,2,13,富邦-嘉義,2023-05-12,9692
00900,富邦特選高股息30,13,0,13,富邦-嘉義,2023-05-12,9692
6285,啟��,29,17,12,富邦-嘉義,2023-05-12,9692
3617,碩天,13,1,12,富邦-嘉義,2023-05-12,9692
0056,元大高股息,20,8,12,富邦-嘉義,2023-05-12,9692
1795,美時,22,11,11,富邦-嘉義,2023-05-12,9692
3006,晶豪科,11,0,11,富邦-嘉義,2023-05-12,9692
2801,彰銀,11,0,11,富邦-嘉義,2023-05-12,9692
8299,群聯,12,1,11,富邦-嘉義,2023-05-12,9692
1336,台翰,11,0,11,富邦-嘉義,2023-05-12,9692
2885,元大金,15,4,11,富邦-嘉義,2023-05-12,9692
8222,寶一,14,3,11,富邦-嘉義,2023-05-12,9692
3092,鴻碩,11,0,11,富邦-嘉義,2023-05-12,9692
1712,興農,12,2,10,富邦-嘉義,2023-05-12,9692
00632R,元大台灣50反1,221,0,221,富邦-嘉義,2023-05-15,9692
00878,國泰永續高股息,218,61,157,富邦-嘉義,2023-05-15,9692
8011,台通,178,26,152,富邦-嘉義,2023-05-15,9692
00882,中信中國高股息,112,0,112,富邦-嘉義,2023-05-15,9692
8076,伍豐,169,68,101,富邦-嘉義,2023-05-15,9692
00671R,富邦NASDAQ反1,100,0,100,富邦-嘉義,2023-05-15,9692
00715L,期街口布蘭特正2,110,11,99,富邦-嘉義,2023-05-15,9692
3058,立德,44,1,43,富邦-嘉義,2023-05-15,9692
2208,台船,43,0,43,富邦-嘉義,2023-05-15,9692
2734,易飛網,41,0,41,富邦-嘉義,2023-05-15,9692
1727,中華化,61,20,41,富邦-嘉義,2023-05-15,9692
00712,復華富時不動產,35,0,35,富邦-嘉義,2023-05-15,9692
6753,龍德造船,35,1,34,富邦-嘉義,2023-05-15,9692
3202,樺晟,157,124,33,富邦-嘉義,2023-05-15,9692
1101,台泥,33,1,32,富邦-嘉義,2023-05-15,9692
6139,亞翔,38,8,30,富邦-嘉義,2023-05-15,9692
4533,協易機,37,8,29,富邦-嘉義,2023-05-15,9692
00751B,元大AAA至A公司債,25,0,25,富邦-嘉義,2023-05-15,9692
3078,僑威,41,16,25,富邦-嘉義,2023-05-15,9692
00679B,元大美債20年,25,0,25,富邦-嘉義,2023-05-15,9692
2303,聯電,25,2,23,富邦-嘉義,2023-05-15,9692
1784,訊聯,31,8,23,富邦-嘉義,2023-05-15,9692
3046,建��,137,114,23,富邦-嘉義,2023-05-15,9692
5498,凱崴,23,0,23,富邦-嘉義,2023-05-15,9692
00877,復華中國5G,22,0,22,富邦-嘉義,2023-05-15,9692
2317,鴻海,29,7,22,富邦-嘉義,2023-05-15,9692
4111,濟生,21,0,21,富邦-嘉義,2023-05-15,9692
2603,長榮,25,5,20,富邦-嘉義,2023-05-15,9692
2886,兆豐金,24,4,20,富邦-嘉義,2023-05-15,9692
00640L,富邦日本正2,20,0,20,富邦-嘉義,2023-05-15,9692
00638R,元大滬深300反1,20,0,20,富邦-嘉義,2023-05-15,9692
00651R,復華香港反1,20,0,20,富邦-嘉義,2023-05-15,9692
4906,正文,19,0,19,富邦-嘉義,2023-05-15,9692
2515,中工,20,1,19,富邦-嘉義,2023-05-15,9692
3617,碩天,21,2,19,富邦-嘉義,2023-05-15,9692
1605,華新,30,12,18,富邦-嘉義,2023-05-15,9692
3035,智原,19,1,18,富邦-嘉義,2023-05-15,9692
00885,富邦越南,35,17,18,富邦-嘉義,2023-05-15,9692
2834,臺企銀,20,4,16,富邦-嘉義,2023-05-15,9692
2312,金寶,15,0,15,富邦-嘉義,2023-05-15,9692
00664R,國泰臺灣加權反1,15,0,15,富邦-嘉義,2023-05-15,9692
3481,群創,17,2,15,富邦-嘉義,2023-05-15,9692
00687B,國泰20年美債,14,0,14,富邦-嘉義,2023-05-15,9692
00900,富邦特選高股息30,14,0,14,富邦-嘉義,2023-05-15,9692
2731,雄獅,63,50,13,富邦-嘉義,2023-05-15,9692
2888,新光金,12,0,12,富邦-嘉義,2023-05-15,9692
6244,茂迪,16,4,12,富邦-嘉義,2023-05-15,9692
9907,統一實,13,1,12,富邦-嘉義,2023-05-15,9692
4163,鐿鈦,12,0,12,富邦-嘉義,2023-05-15,9692
1722,台肥,17,5,12,富邦-嘉義,2023-05-15,9692
2427,三商電,481,104,377,富邦-嘉義,2023-05-16,9692
8069,元太,376,168,208,富邦-嘉義,2023-05-16,9692
1519,華城,251,131,120,富邦-嘉義,2023-05-16,9692
5225,東科-KY,124,7,117,富邦-嘉義,2023-05-16,9692
00679B,元大美債20年,103,0,103,富邦-嘉義,2023-05-16,9692
2634,漢翔,117,26,91,富邦-嘉義,2023-05-16,9692
6625,必應,78,2,76,富邦-嘉義,2023-05-16,9692
00772B,中信高評級公司債,75,0,75,富邦-嘉義,2023-05-16,9692
00680L,元大美債20正2,68,0,68,富邦-嘉義,2023-05-16,9692
6139,亞翔,231,164,67,富邦-嘉義,2023-05-16,9692
6112,邁達特,98,35,63,富邦-嘉義,2023-05-16,9692
00632R,元大台灣50反1,63,0,63,富邦-嘉義,2023-05-16,9692
2365,昆盈,57,0,57,富邦-嘉義,2023-05-16,9692
3207,耀勝,127,74,53,富邦-嘉義,2023-05-16,9692
00725B,國泰投資級公司債,49,0,49,富邦-嘉義,2023-05-16,9692
1503,士電,87,41,46,富邦-嘉義,2023-05-16,9692
2331,精英,45,1,44,富邦-嘉義,2023-05-16,9692
3058,立德,46,4,42,富邦-嘉義,2023-05-16,9692
2489,瑞軒,39,0,39,富邦-嘉義,2023-05-16,9692
3661,世芯-KY,117,79,38,富邦-嘉義,2023-05-16,9692
3675,德微,50,15,35,富邦-嘉義,2023-05-16,9692
00671R,富邦NASDAQ反1,30,0,30,富邦-嘉義,2023-05-16,9692
3481,群創,35,5,30,富邦-嘉義,2023-05-16,9692
2323,中環,167,137,30,富邦-嘉義,2023-05-16,9692
00687B,國泰20年美債,29,0,29,富邦-嘉義,2023-05-16,9692
2313,華通,28,1,27,富邦-嘉義,2023-05-16,9692
1101,台泥,34,7,27,富邦-嘉義,2023-05-16,9692
00720B,元大投資級公司債,26,0,26,富邦-嘉義,2023-05-16,9692
6874,倍力,34,12,22,富邦-嘉義,2023-05-16,9692
00751B,元大AAA至A公司債,21,0,21,富邦-嘉義,2023-05-16,9692
4960,誠美材,21,0,21,富邦-嘉義,2023-05-16,9692
2633,台灣高鐵,128,109,19,富邦-嘉義,2023-05-16,9692
3406,玉晶光,54,35,19,富邦-嘉義,2023-05-16,9692
3617,碩天,206,188,18,富邦-嘉義,2023-05-16,9692
00715L,期街口布蘭特正2,29,12,17,富邦-嘉義,2023-05-16,9692
1709,和益,15,0,15,富邦-嘉義,2023-05-16,9692
2630,亞航,165,150,15,富邦-嘉義,2023-05-16,9692
5371,中光電,15,0,15,富邦-嘉義,2023-05-16,9692
3363,上詮,561,546,15,富邦-嘉義,2023-05-16,9692
1514,亞力,15,1,14,富邦-嘉義,2023-05-16,9692
00696B,富邦美債20年,14,0,14,富邦-嘉義,2023-05-16,9692
2409,友達,15,2,13,富邦-嘉義,2023-05-16,9692
3011,今皓,13,0,13,富邦-嘉義,2023-05-16,9692
6234,高僑,12,0,12,富邦-嘉義,2023-05-16,9692
00902,中信電池及儲能,17,5,12,富邦-嘉義,2023-05-16,9692
2897,王道銀行,16,4,12,富邦-嘉義,2023-05-16,9692
2105,正新,20,8,12,富邦-嘉義,2023-05-16,9692
1905,華紙,61,50,11,富邦-嘉義,2023-05-16,9692
3052,夆典,16,5,11,富邦-嘉義,2023-05-16,9692
3059,華晶科,10,0,10,富邦-嘉義,2023-05-16,9692
00632R,元大台灣50反1,581,99,482,富邦-嘉義,2023-05-17,9692
2630,亞航,557,356,201,富邦-嘉義,2023-05-17,9692
1795,美時,445,277,168,富邦-嘉義,2023-05-17,9692
00878,國泰永續高股息,177,36,141,富邦-嘉義,2023-05-17,9692
8426,紅木-KY,296,156,140,富邦-嘉義,2023-05-17,9692
6235,華孚,118,6,112,富邦-嘉義,2023-05-17,9692
1612,宏泰,119,10,109,富邦-嘉義,2023-05-17,9692
2610,華航,112,5,107,富邦-嘉義,2023-05-17,9692
6112,邁達特,824,718,106,富邦-嘉義,2023-05-17,9692
00671R,富邦NASDAQ反1,100,0,100,富邦-嘉義,2023-05-17,9692
2634,漢翔,512,417,95,富邦-嘉義,2023-05-17,9692
00715L,期街口布蘭特正2,89,0,89,富邦-嘉義,2023-05-17,9692
1314,中石化,79,4,75,富邦-嘉義,2023-05-17,9692
8222,寶一,183,110,73,富邦-嘉義,2023-05-17,9692
3362,先進光,112,52,60,富邦-嘉義,2023-05-17,9692
00712,復華富時不動產,48,0,48,富邦-嘉義,2023-05-17,9692
2206,三陽工業,111,65,46,富邦-嘉義,2023-05-17,9692
6148,驊宏資,103,60,43,富邦-嘉義,2023-05-17,9692
1722,台肥,40,0,40,富邦-嘉義,2023-05-17,9692
00720B,元大投資級公司債,33,0,33,富邦-嘉義,2023-05-17,9692
2402,毅嘉,175,142,33,富邦-嘉義,2023-05-17,9692
00679B,元大美債20年,32,0,32,富邦-嘉義,2023-05-17,9692
5515,建國,31,0,31,富邦-嘉義,2023-05-17,9692
00680L,元大美債20正2,30,0,30,富邦-嘉義,2023-05-17,9692
4533,協易機,33,3,30,富邦-嘉義,2023-05-17,9692
2392,正崴,30,0,30,富邦-嘉義,2023-05-17,9692
3046,建��,347,318,29,富邦-嘉義,2023-05-17,9692
1514,亞力,30,1,29,富邦-嘉義,2023-05-17,9692
5328,華容,29,2,27,富邦-嘉義,2023-05-17,9692
6517,保勝光學,122,97,25,富邦-嘉義,2023-05-17,9692
5706,鳳凰,36,13,23,富邦-嘉義,2023-05-17,9692
6625,必應,379,356,23,富邦-嘉義,2023-05-17,9692
2367,燿華,22,0,22,富邦-嘉義,2023-05-17,9692
00772B,中信高評級公司債,21,0,21,富邦-嘉義,2023-05-17,9692
5284,jpp-KY,39,19,20,富邦-嘉義,2023-05-17,9692
2377,微星,63,44,19,富邦-嘉義,2023-05-17,9692
2388,威盛,23,6,17,富邦-嘉義,2023-05-17,9692
8076,伍豐,27,10,17,富邦-嘉義,2023-05-17,9692
00751B,元大AAA至A公司債,16,0,16,富邦-嘉義,2023-05-17,9692
3324,雙鴻,533,517,16,富邦-嘉義,2023-05-17,9692
2023,燁輝,16,0,16,富邦-嘉義,2023-05-17,9692
2618,長榮航,120,105,15,富邦-嘉義,2023-05-17,9692
5425,台半,15,0,15,富邦-嘉義,2023-05-17,9692
4960,誠美材,15,0,15,富邦-嘉義,2023-05-17,9692
8936,國統,15,1,14,富邦-嘉義,2023-05-17,9692
1727,中華化,17,3,14,富邦-嘉義,2023-05-17,9692
6405,悅城,13,0,13,富邦-嘉義,2023-05-17,9692
6589,台康生技,59,46,13,富邦-嘉義,2023-05-17,9692
1504,東元,18,6,12,富邦-嘉義,2023-05-17,9692
00713,元大台灣高息低波,19,7,12,富邦-嘉義,2023-05-17,9692
2888,新光金,454,16,438,富邦-嘉義,2023-05-18,9692
2471,資通,356,41,315,富邦-嘉義,2023-05-18,9692
2453,凌群,386,155,231,富邦-嘉義,2023-05-18,9692
2371,大同,1578,1368,210,富邦-嘉義,2023-05-18,9692
3324,雙鴻,219,35,184,富邦-嘉義,2023-05-18,9692
1503,士電,1002,889,113,富邦-嘉義,2023-05-18,9692
2427,三商電,268,156,112,富邦-嘉義,2023-05-18,9692
5324,士開,104,6,98,富邦-嘉義,2023-05-18,9692
2421,建準,235,156,79,富邦-嘉義,2023-05-18,9692
1519,華城,1385,1312,73,富邦-嘉義,2023-05-18,9692
6203,海韻電,61,1,60,富邦-嘉義,2023-05-18,9692
6517,保勝光學,139,83,56,富邦-嘉義,2023-05-18,9692
3029,零壹,92,39,53,富邦-嘉義,2023-05-18,9692
3443,創意,182,131,51,富邦-嘉義,2023-05-18,9692
1513,中興電,705,661,44,富邦-嘉義,2023-05-18,9692
3693,營邦,55,11,44,富邦-嘉義,2023-05-18,9692
4746,台耀,56,13,43,富邦-嘉義,2023-05-18,9692
8076,伍豐,223,183,40,富邦-嘉義,2023-05-18,9692
1219,福壽,30,0,30,富邦-嘉義,2023-05-18,9692
1101,台泥,28,0,28,富邦-嘉義,2023-05-18,9692
6185,幃翔,29,1,28,富邦-嘉義,2023-05-18,9692
2201,裕隆,45,19,26,富邦-嘉義,2023-05-18,9692
6276,安鈦克,25,1,24,富邦-嘉義,2023-05-18,9692
1609,大亞,71,47,24,富邦-嘉義,2023-05-18,9692
6122,擎邦,109,88,21,富邦-嘉義,2023-05-18,9692
2457,飛宏,178,157,21,富邦-嘉義,2023-05-18,9692
4763,材料-KY,51,31,20,富邦-嘉義,2023-05-18,9692
00673R,期元大S＆P原油反1,20,0,20,富邦-嘉義,2023-05-18,9692
1722,台肥,20,0,20,富邦-嘉義,2023-05-18,9692
3252,海灣,20,0,20,富邦-嘉義,2023-05-18,9692
00733,富邦臺灣中小,25,6,19,富邦-嘉義,2023-05-18,9692
4979,華星光,21,2,19,富邦-嘉義,2023-05-18,9692
00632R,元大台灣50反1,425,406,19,富邦-嘉義,2023-05-18,9692
2106,建大,20,1,19,富邦-嘉義,2023-05-18,9692
2882,國泰金,41,22,19,富邦-嘉義,2023-05-18,9692
00680L,元大美債20正2,18,0,18,富邦-嘉義,2023-05-18,9692
3702,大聯大,18,1,17,富邦-嘉義,2023-05-18,9692
6443,元晶,50,35,15,富邦-嘉義,2023-05-18,9692
2369,菱生,25,10,15,富邦-嘉義,2023-05-18,9692
1504,東元,465,451,14,富邦-嘉義,2023-05-18,9692
2633,台灣高鐵,16,2,14,富邦-嘉義,2023-05-18,9692
3576,聯合再生,17,4,13,富邦-嘉義,2023-05-18,9692
2206,三陽工業,151,138,13,富邦-嘉義,2023-05-18,9692
00882,中信中國高股息,13,0,13,富邦-嘉義,2023-05-18,9692
2330,台積電,60,48,12,富邦-嘉義,2023-05-18,9692
2812,台中銀,14,2,12,富邦-嘉義,2023-05-18,9692
5475,德宏,12,0,12,富邦-嘉義,2023-05-18,9692
00885,富邦越南,12,0,12,富邦-嘉義,2023-05-18,9692
2610,華航,130,118,12,富邦-嘉義,2023-05-18,9692
6005,群益證,15,4,11,富邦-嘉義,2023-05-18,9692
00632R,元大台灣50反1,197,20,177,富邦-嘉義,2023-05-19,9692
2888,新光金,200,34,166,富邦-嘉義,2023-05-19,9692
00665L,富邦�琤肭磪囓�2,209,50,159,富邦-嘉義,2023-05-19,9692
2427,三商電,103,2,101,富邦-嘉義,2023-05-19,9692
8076,伍豐,96,16,80,富邦-嘉義,2023-05-19,9692
5864,致和證,60,0,60,富邦-嘉義,2023-05-19,9692
2349,錸德,60,5,55,富邦-嘉義,2023-05-19,9692
2330,台積電,107,58,49,富邦-嘉義,2023-05-19,9692
2377,微星,51,6,45,富邦-嘉義,2023-05-19,9692
1514,亞力,81,39,42,富邦-嘉義,2023-05-19,9692
00687B,國泰20年美債,40,0,40,富邦-嘉義,2023-05-19,9692
4763,材料-KY,123,83,40,富邦-嘉義,2023-05-19,9692
2630,亞航,172,134,38,富邦-嘉義,2023-05-19,9692
5009,榮剛,231,193,38,富邦-嘉義,2023-05-19,9692
2889,國票金,35,0,35,富邦-嘉義,2023-05-19,9692
2023,燁輝,30,0,30,富邦-嘉義,2023-05-19,9692
00882,中信中國高股息,28,0,28,富邦-嘉義,2023-05-19,9692
4804,大略-KY,26,0,26,富邦-嘉義,2023-05-19,9692
3664,安瑞-KY,26,0,26,富邦-嘉義,2023-05-19,9692
2534,宏盛,25,0,25,富邦-嘉義,2023-05-19,9692
2401,凌陽,25,0,25,富邦-嘉義,2023-05-19,9692
8940,新天地,30,5,25,富邦-嘉義,2023-05-19,9692
1108,幸福,24,0,24,富邦-嘉義,2023-05-19,9692
2801,彰銀,23,1,22,富邦-嘉義,2023-05-19,9692
2358,廷鑫,21,0,21,富邦-嘉義,2023-05-19,9692
6112,邁達特,71,50,21,富邦-嘉義,2023-05-19,9692
2331,精英,23,3,20,富邦-嘉義,2023-05-19,9692
2538,基泰,20,0,20,富邦-嘉義,2023-05-19,9692
5230,雷笛克光學,20,0,20,富邦-嘉義,2023-05-19,9692
1504,東元,116,96,20,富邦-嘉義,2023-05-19,9692
1618,合機,26,10,16,富邦-嘉義,2023-05-19,9692
2332,友訊,44,28,16,富邦-嘉義,2023-05-19,9692
00680L,元大美債20正2,15,0,15,富邦-嘉義,2023-05-19,9692
4953,緯軟,15,0,15,富邦-嘉義,2023-05-19,9692
00773B,中信優先金融債,15,1,14,富邦-嘉義,2023-05-19,9692
2442,新美齊,20,6,14,富邦-嘉義,2023-05-19,9692
00696B,富邦美債20年,14,0,14,富邦-嘉義,2023-05-19,9692
2105,正新,21,8,13,富邦-嘉義,2023-05-19,9692
2302,麗正,18,5,13,富邦-嘉義,2023-05-19,9692
4163,鐿鈦,30,17,13,富邦-嘉義,2023-05-19,9692
3594,磐儀,16,3,13,富邦-嘉義,2023-05-19,9692
2367,燿華,15,3,12,富邦-嘉義,2023-05-19,9692
1314,中石化,11,0,11,富邦-嘉義,2023-05-19,9692
5515,建國,11,0,11,富邦-嘉義,2023-05-19,9692
4137,麗豐-KY,11,0,11,富邦-嘉義,2023-05-19,9692
2834,臺企銀,17,6,11,富邦-嘉義,2023-05-19,9692
00637L,元大滬深300正2,11,1,10,富邦-嘉義,2023-05-19,9692
1471,首利,11,1,10,富邦-嘉義,2023-05-19,9692
2537,聯上發,10,0,10,富邦-嘉義,2023-05-19,9692
6125,廣運,11,1,10,富邦-嘉義,2023-05-19,9692
2618,長榮航,3669,144,3525,富邦-嘉義,2023-05-22,9692
6233,旺玖,621,109,512,富邦-嘉義,2023-05-22,9692
2634,漢翔,534,82,452,富邦-嘉義,2023-05-22,9692
4541,晟田,233,20,213,富邦-嘉義,2023-05-22,9692
3715,定穎投控,201,2,199,富邦-嘉義,2023-05-22,9692
6122,擎邦,150,2,148,富邦-嘉義,2023-05-22,9692
2442,新美齊,207,62,145,富邦-嘉義,2023-05-22,9692
2421,建準,183,58,125,富邦-嘉義,2023-05-22,9692
00715L,期街口布蘭特正2,89,1,88,富邦-嘉義,2023-05-22,9692
2734,易飛網,85,0,85,富邦-嘉義,2023-05-22,9692
2409,友達,121,37,84,富邦-嘉義,2023-05-22,9692
3363,上詮,245,163,82,富邦-嘉義,2023-05-22,9692
2303,聯電,100,22,78,富邦-嘉義,2023-05-22,9692
6160,欣技,63,11,52,富邦-嘉義,2023-05-22,9692
2365,昆盈,51,0,51,富邦-嘉義,2023-05-22,9692
5706,鳳凰,115,68,47,富邦-嘉義,2023-05-22,9692
5328,華容,65,19,46,富邦-嘉義,2023-05-22,9692
1809,中釉,72,26,46,富邦-嘉義,2023-05-22,9692
5324,士開,69,23,46,富邦-嘉義,2023-05-22,9692
1101,台泥,48,9,39,富邦-嘉義,2023-05-22,9692
1795,美時,62,24,38,富邦-嘉義,2023-05-22,9692
00687B,國泰20年美債,36,0,36,富邦-嘉義,2023-05-22,9692
4960,誠美材,36,0,36,富邦-嘉義,2023-05-22,9692
2845,遠東銀,32,1,31,富邦-嘉義,2023-05-22,9692
2739,寒舍,40,10,30,富邦-嘉義,2023-05-22,9692
6754,匯僑設計,30,0,30,富邦-嘉義,2023-05-22,9692
5864,致和證,30,0,30,富邦-嘉義,2023-05-22,9692
8222,寶一,97,69,28,富邦-嘉義,2023-05-22,9692
3664,安瑞-KY,37,11,26,富邦-嘉義,2023-05-22,9692
2353,宏��,29,4,25,富邦-嘉義,2023-05-22,9692
2356,英業達,25,1,24,富邦-嘉義,2023-05-22,9692
8478,東哥遊艇,30,7,23,富邦-嘉義,2023-05-22,9692
1504,東元,96,74,22,富邦-嘉義,2023-05-22,9692
3617,碩天,32,11,21,富邦-嘉義,2023-05-22,9692
3088,艾訊,21,0,21,富邦-嘉義,2023-05-22,9692
2323,中環,37,16,21,富邦-嘉義,2023-05-22,9692
8076,伍豐,39,19,20,富邦-嘉義,2023-05-22,9692
00642U,期元大S＆P石油,20,0,20,富邦-嘉義,2023-05-22,9692
8426,紅木-KY,20,0,20,富邦-嘉義,2023-05-22,9692
6276,安鈦克,20,0,20,富邦-嘉義,2023-05-22,9692
6111,大宇資,26,6,20,富邦-嘉義,2023-05-22,9692
1810,和成,21,1,20,富邦-嘉義,2023-05-22,9692
1605,華新,31,11,20,富邦-嘉義,2023-05-22,9692
2731,雄獅,20,2,18,富邦-嘉義,2023-05-22,9692
1806,冠軍,18,0,18,富邦-嘉義,2023-05-22,9692
9939,宏全,20,2,18,富邦-嘉義,2023-05-22,9692
2313,華通,21,4,17,富邦-嘉義,2023-05-22,9692
2719,燦星旅,16,0,16,富邦-嘉義,2023-05-22,9692
2610,華航,114,99,15,富邦-嘉義,2023-05-22,9692
1314,中石化,26,11,15,富邦-嘉義,2023-05-22,9692
2399,映泰,566,138,428,富邦-嘉義,2023-05-23,9692
6235,華孚,337,60,277,富邦-嘉義,2023-05-23,9692
8222,寶一,339,97,242,富邦-嘉義,2023-05-23,9692
2736,富野,228,27,201,富邦-嘉義,2023-05-23,9692
6288,聯嘉,207,20,187,富邦-嘉義,2023-05-23,9692
8059,凱碩,169,11,158,富邦-嘉義,2023-05-23,9692
6122,擎邦,320,166,154,富邦-嘉義,2023-05-23,9692
2457,飛宏,132,16,116,富邦-嘉義,2023-05-23,9692
2888,新光金,111,3,108,富邦-嘉義,2023-05-23,9692
1314,中石化,100,0,100,富邦-嘉義,2023-05-23,9692
2722,夏都,514,417,97,富邦-嘉義,2023-05-23,9692
00632R,元大台灣50反1,128,35,93,富邦-嘉義,2023-05-23,9692
6245,立端,323,230,93,富邦-嘉義,2023-05-23,9692
2719,燦星旅,100,16,84,富邦-嘉義,2023-05-23,9692
2365,昆盈,72,0,72,富邦-嘉義,2023-05-23,9692
2812,台中銀,55,0,55,富邦-嘉義,2023-05-23,9692
00712,復華富時不動產,101,54,47,富邦-嘉義,2023-05-23,9692
00687B,國泰20年美債,44,0,44,富邦-嘉義,2023-05-23,9692
3325,旭品,172,129,43,富邦-嘉義,2023-05-23,9692
00882,中信中國高股息,42,0,42,富邦-嘉義,2023-05-23,9692
6111,大宇資,42,0,42,富邦-嘉義,2023-05-23,9692
00673R,期元大S＆P原油反1,41,0,41,富邦-嘉義,2023-05-23,9692
5284,jpp-KY,252,216,36,富邦-嘉義,2023-05-23,9692
2409,友達,40,5,35,富邦-嘉義,2023-05-23,9692
00795B,中信美國公債20年,34,0,34,富邦-嘉義,2023-05-23,9692
5388,中磊,33,0,33,富邦-嘉義,2023-05-23,9692
3122,笙泉,32,0,32,富邦-嘉義,2023-05-23,9692
2739,寒舍,51,21,30,富邦-嘉義,2023-05-23,9692
3617,碩天,29,1,28,富邦-嘉義,2023-05-23,9692
1605,華新,32,4,28,富邦-嘉義,2023-05-23,9692
1795,美時,61,33,28,富邦-嘉義,2023-05-23,9692
8121,越峰,30,3,27,富邦-嘉義,2023-05-23,9692
1513,中興電,65,40,25,富邦-嘉義,2023-05-23,9692
8097,常珵,24,0,24,富邦-嘉義,2023-05-23,9692
6198,瑞築,20,0,20,富邦-嘉義,2023-05-23,9692
5864,致和證,20,0,20,富邦-嘉義,2023-05-23,9692
2337,旺宏,22,2,20,富邦-嘉義,2023-05-23,9692
3015,全漢,20,0,20,富邦-嘉義,2023-05-23,9692
3049,精金,19,0,19,富邦-嘉義,2023-05-23,9692
6753,龍德造船,19,1,18,富邦-嘉義,2023-05-23,9692
00696B,富邦美債20年,18,0,18,富邦-嘉義,2023-05-23,9692
3041,揚智,20,2,18,富邦-嘉義,2023-05-23,9692
2442,新美齊,80,63,17,富邦-嘉義,2023-05-23,9692
6112,邁達特,421,404,17,富邦-嘉義,2023-05-23,9692
2313,華通,16,0,16,富邦-嘉義,2023-05-23,9692
2208,台船,65,50,15,富邦-嘉義,2023-05-23,9692
5225,東科-KY,16,1,15,富邦-嘉義,2023-05-23,9692
2371,大同,27,12,15,富邦-嘉義,2023-05-23,9692
1201,味全,14,0,14,富邦-嘉義,2023-05-23,9692
00725B,國泰投資級公司債,13,0,13,富邦-嘉義,2023-05-23,9692
2402,毅嘉,268,3,265,富邦-嘉義,2023-05-24,9692
5706,鳳凰,646,381,265,富邦-嘉義,2023-05-24,9692
00632R,元大台灣50反1,251,6,245,富邦-嘉義,2023-05-24,9692
1905,華紙,427,188,239,富邦-嘉義,2023-05-24,9692
00878,國泰永續高股息,242,16,226,富邦-嘉義,2023-05-24,9692
00665L,富邦�琤肭磪囓�2,218,0,218,富邦-嘉義,2023-05-24,9692
5512,力麒,524,324,200,富邦-嘉義,2023-05-24,9692
00687B,國泰20年美債,164,0,164,富邦-嘉義,2023-05-24,9692
00882,中信中國高股息,175,22,153,富邦-嘉義,2023-05-24,9692
5243,乙盛-KY,191,39,152,富邦-嘉義,2023-05-24,9692
2421,建準,172,42,130,富邦-嘉義,2023-05-24,9692
00674R,期元大S＆P黃金反1,100,0,100,富邦-嘉義,2023-05-24,9692
2611,志信,272,173,99,富邦-嘉義,2023-05-24,9692
00673R,期元大S＆P原油反1,91,0,91,富邦-嘉義,2023-05-24,9692
1727,中華化,116,28,88,富邦-嘉義,2023-05-24,9692
6753,龍德造船,70,1,69,富邦-嘉義,2023-05-24,9692
3032,偉訓,60,0,60,富邦-嘉義,2023-05-24,9692
2748,雲品,256,198,58,富邦-嘉義,2023-05-24,9692
3231,緯創,121,73,48,富邦-嘉義,2023-05-24,9692
1809,中釉,481,436,45,富邦-嘉義,2023-05-24,9692
2427,三商電,84,42,42,富邦-嘉義,2023-05-24,9692
2409,友達,31,1,30,富邦-嘉義,2023-05-24,9692
2342,茂矽,30,0,30,富邦-嘉義,2023-05-24,9692
1810,和成,53,24,29,富邦-嘉義,2023-05-24,9692
5009,榮剛,67,40,27,富邦-嘉義,2023-05-24,9692
2706,第一店,50,23,27,富邦-嘉義,2023-05-24,9692
00680L,元大美債20正2,26,1,25,富邦-嘉義,2023-05-24,9692
6185,幃翔,25,2,23,富邦-嘉義,2023-05-24,9692
1721,三晃,35,15,20,富邦-嘉義,2023-05-24,9692
5324,士開,21,1,20,富邦-嘉義,2023-05-24,9692
1616,億泰,20,0,20,富邦-嘉義,2023-05-24,9692
2834,臺企銀,22,2,20,富邦-嘉義,2023-05-24,9692
00637L,元大滬深300正2,25,6,19,富邦-嘉義,2023-05-24,9692
6026,福邦證,21,3,18,富邦-嘉義,2023-05-24,9692
6416,瑞祺電通,18,0,18,富邦-嘉義,2023-05-24,9692
2201,裕隆,29,12,17,富邦-嘉義,2023-05-24,9692
5880,合庫金,20,3,17,富邦-嘉義,2023-05-24,9692
3363,上詮,26,10,16,富邦-嘉義,2023-05-24,9692
6509,聚和,19,3,16,富邦-嘉義,2023-05-24,9692
6535,順藥,29,13,16,富邦-嘉義,2023-05-24,9692
8097,常珵,18,2,16,富邦-嘉義,2023-05-24,9692
1513,中興電,32,17,15,富邦-嘉義,2023-05-24,9692
3078,僑威,51,36,15,富邦-嘉義,2023-05-24,9692
00655L,國泰中國A50正2,15,0,15,富邦-嘉義,2023-05-24,9692
2023,燁輝,15,0,15,富邦-嘉義,2023-05-24,9692
2314,台揚,28,14,14,富邦-嘉義,2023-05-24,9692
3705,永信,16,2,14,富邦-嘉義,2023-05-24,9692
1514,亞力,20,6,14,富邦-嘉義,2023-05-24,9692
5704,老爺知,179,166,13,富邦-嘉義,2023-05-24,9692
00713,元大台灣高息低波,18,6,12,富邦-嘉義,2023-05-24,9692
2323,中環,1715,201,1514,富邦-嘉義,2023-05-25,9692
1608,華榮,1118,598,520,富邦-嘉義,2023-05-25,9692
2736,富野,1264,916,348,富邦-嘉義,2023-05-25,9692
00882,中信中國高股息,198,17,181,富邦-嘉義,2023-05-25,9692
00632R,元大台灣50反1,119,0,119,富邦-嘉義,2023-05-25,9692
2427,三商電,243,134,109,富邦-嘉義,2023-05-25,9692
6160,欣技,90,1,89,富邦-嘉義,2023-05-25,9692
00637L,元大滬深300正2,78,1,77,富邦-嘉義,2023-05-25,9692
2409,友達,64,1,63,富邦-嘉義,2023-05-25,9692
2371,大同,112,52,60,富邦-嘉義,2023-05-25,9692
3693,營邦,83,31,52,富邦-嘉義,2023-05-25,9692
6164,華興,50,0,50,富邦-嘉義,2023-05-25,9692
2704,國賓,46,1,45,富邦-嘉義,2023-05-25,9692
2867,三商壽,50,10,40,富邦-嘉義,2023-05-25,9692
2023,燁輝,40,0,40,富邦-嘉義,2023-05-25,9692
6689,伊雲谷,40,0,40,富邦-嘉義,2023-05-25,9692
2349,錸德,60,22,38,富邦-嘉義,2023-05-25,9692
2887,台新金,39,2,37,富邦-嘉義,2023-05-25,9692
2317,鴻海,36,0,36,富邦-嘉義,2023-05-25,9692
2630,亞航,376,345,31,富邦-嘉義,2023-05-25,9692
00753L,中信中國50正2,31,0,31,富邦-嘉義,2023-05-25,9692
6547,高端疫苗,34,3,31,富邦-嘉義,2023-05-25,9692
2884,玉山金,40,10,30,富邦-嘉義,2023-05-25,9692
00706L,期元大S＆P日圓正2,100,70,30,富邦-嘉義,2023-05-25,9692
5425,台半,34,4,30,富邦-嘉義,2023-05-25,9692
2888,新光金,30,1,29,富邦-嘉義,2023-05-25,9692
00687B,國泰20年美債,28,0,28,富邦-嘉義,2023-05-25,9692
2883,凱基金,31,4,27,富邦-嘉義,2023-05-25,9692
4564,元翎,74,47,27,富邦-嘉義,2023-05-25,9692
5531,鄉林,34,8,26,富邦-嘉義,2023-05-25,9692
2890,永豐金,24,0,24,富邦-嘉義,2023-05-25,9692
2356,英業達,1322,1298,24,富邦-嘉義,2023-05-25,9692
2913,農林,23,0,23,富邦-嘉義,2023-05-25,9692
3025,星通,27,4,23,富邦-嘉義,2023-05-25,9692
00712,復華富時不動產,29,6,23,富邦-嘉義,2023-05-25,9692
00655L,國泰中國A50正2,21,0,21,富邦-嘉義,2023-05-25,9692
3048,益登,26,5,21,富邦-嘉義,2023-05-25,9692
3680,家登,24,3,21,富邦-嘉義,2023-05-25,9692
3481,群創,23,2,21,富邦-嘉義,2023-05-25,9692
00751B,元大AAA至A公司債,20,0,20,富邦-嘉義,2023-05-25,9692
5315,光聯,20,0,20,富邦-嘉義,2023-05-25,9692
00651R,復華香港反1,20,0,20,富邦-嘉義,2023-05-25,9692
2891,中信金,20,1,19,富邦-嘉義,2023-05-25,9692
6185,幃翔,19,0,19,富邦-嘉義,2023-05-25,9692
8076,伍豐,33,14,19,富邦-嘉義,2023-05-25,9692
5324,士開,18,0,18,富邦-嘉義,2023-05-25,9692
8222,寶一,19,1,18,富邦-嘉義,2023-05-25,9692
2103,台橡,17,0,17,富邦-嘉義,2023-05-25,9692
4746,台耀,21,4,17,富邦-嘉義,2023-05-25,9692
2885,元大金,18,1,17,富邦-嘉義,2023-05-25,9692
2371,大同,467,49,418,富邦-嘉義,2023-05-26,9692
2601,益航,208,0,208,富邦-嘉義,2023-05-26,9692
00795B,中信美國公債20年,205,0,205,富邦-嘉義,2023-05-26,9692
1609,大亞,194,50,144,富邦-嘉義,2023-05-26,9692
3265,台星科,346,215,131,富邦-嘉義,2023-05-26,9692
00632R,元大台灣50反1,186,69,117,富邦-嘉義,2023-05-26,9692
3025,星通,721,634,87,富邦-嘉義,2023-05-26,9692
2883,凱基金,91,12,79,富邦-嘉義,2023-05-26,9692
8996,高力,176,99,77,富邦-嘉義,2023-05-26,9692
00882,中信中國高股息,76,4,72,富邦-嘉義,2023-05-26,9692
2454,聯發科,167,99,68,富邦-嘉義,2023-05-26,9692
3231,緯創,1366,1313,53,富邦-嘉義,2023-05-26,9692
2409,友達,53,9,44,富邦-嘉義,2023-05-26,9692
6643,M31,122,79,43,富邦-嘉義,2023-05-26,9692
3058,立德,44,2,42,富邦-嘉義,2023-05-26,9692
00712,復華富時不動產,81,40,41,富邦-嘉義,2023-05-26,9692
2352,佳世達,52,12,40,富邦-嘉義,2023-05-26,9692
00715L,期街口布蘭特正2,51,11,40,富邦-嘉義,2023-05-26,9692
6443,元晶,50,10,40,富邦-嘉義,2023-05-26,9692
3252,海灣,42,2,40,富邦-嘉義,2023-05-26,9692
4746,台耀,35,2,33,富邦-嘉義,2023-05-26,9692
2913,農林,30,0,30,富邦-嘉義,2023-05-26,9692
5289,宜鼎,128,98,30,富邦-嘉義,2023-05-26,9692
1722,台肥,24,0,24,富邦-嘉義,2023-05-26,9692
6770,力積電,24,1,23,富邦-嘉義,2023-05-26,9692
2444,兆勁,23,0,23,富邦-嘉義,2023-05-26,9692
00878,國泰永續高股息,57,35,22,富邦-嘉義,2023-05-26,9692
5243,乙盛-KY,48,26,22,富邦-嘉義,2023-05-26,9692
6282,康舒,26,5,21,富邦-嘉義,2023-05-26,9692
00655L,國泰中國A50正2,21,0,21,富邦-嘉義,2023-05-26,9692
6535,順藥,30,10,20,富邦-嘉義,2023-05-26,9692
6005,群益證,20,0,20,富邦-嘉義,2023-05-26,9692
2537,聯上發,20,0,20,富邦-嘉義,2023-05-26,9692
8426,紅木-KY,30,10,20,富邦-嘉義,2023-05-26,9692
00706L,期元大S＆P日圓正2,20,0,20,富邦-嘉義,2023-05-26,9692
3131,弘塑,39,19,20,富邦-嘉義,2023-05-26,9692
2471,資通,44,25,19,富邦-嘉義,2023-05-26,9692
3325,旭品,21,2,19,富邦-嘉義,2023-05-26,9692
2489,瑞軒,20,1,19,富邦-嘉義,2023-05-26,9692
2606,裕民,20,2,18,富邦-嘉義,2023-05-26,9692
2208,台船,17,0,17,富邦-嘉義,2023-05-26,9692
1591,駿吉-KY,17,0,17,富邦-嘉義,2023-05-26,9692
1783,和康生,17,0,17,富邦-嘉義,2023-05-26,9692
8033,雷虎,16,0,16,富邦-嘉義,2023-05-26,9692
5324,士開,16,0,16,富邦-嘉義,2023-05-26,9692
6570,維田,16,0,16,富邦-嘉義,2023-05-26,9692
3032,偉訓,20,5,15,富邦-嘉義,2023-05-26,9692
2855,統一證,15,0,15,富邦-嘉義,2023-05-26,9692
3540,曜越,327,313,14,富邦-嘉義,2023-05-26,9692
4915,致伸,15,1,14,富邦-嘉義,2023-05-26,9692
3013,晟銘電,944,431,513,富邦-嘉義,2023-05-29,9692
2421,建準,1018,526,492,富邦-嘉義,2023-05-29,9692
1519,華城,1154,756,398,富邦-嘉義,2023-05-29,9692
3025,星通,751,359,392,富邦-嘉義,2023-05-29,9692
00882,中信中國高股息,142,0,142,富邦-嘉義,2023-05-29,9692
5328,華容,145,12,133,富邦-嘉義,2023-05-29,9692
0056,元大高股息,188,77,111,富邦-嘉義,2023-05-29,9692
3306,鼎天,108,1,107,富邦-嘉義,2023-05-29,9692
4979,華星光,485,385,100,富邦-嘉義,2023-05-29,9692
6235,華孚,1530,1432,98,富邦-嘉義,2023-05-29,9692
2376,技嘉,625,530,95,富邦-嘉義,2023-05-29,9692
4543,萬在,290,197,93,富邦-嘉義,2023-05-29,9692
3363,上詮,140,60,80,富邦-嘉義,2023-05-29,9692
00902,中信電池及儲能,68,0,68,富邦-嘉義,2023-05-29,9692
00885,富邦越南,60,0,60,富邦-嘉義,2023-05-29,9692
3711,日月光投控,59,0,59,富邦-嘉義,2023-05-29,9692
2345,智邦,93,39,54,富邦-嘉義,2023-05-29,9692
3232,昱捷,53,0,53,富邦-嘉義,2023-05-29,9692
00673R,期元大S＆P原油反1,50,0,50,富邦-嘉義,2023-05-29,9692
6125,廣運,163,113,50,富邦-嘉義,2023-05-29,9692
6005,群益證,50,0,50,富邦-嘉義,2023-05-29,9692
2388,威盛,206,162,44,富邦-嘉義,2023-05-29,9692
2427,三商電,110,70,40,富邦-嘉義,2023-05-29,9692
2317,鴻海,86,48,38,富邦-嘉義,2023-05-29,9692
2349,錸德,52,14,38,富邦-嘉義,2023-05-29,9692
3325,旭品,58,20,38,富邦-嘉義,2023-05-29,9692
00772B,中信高評級公司債,30,0,30,富邦-嘉義,2023-05-29,9692
2867,三商壽,30,0,30,富邦-嘉義,2023-05-29,9692
2002,中鋼,33,4,29,富邦-嘉義,2023-05-29,9692
00712,復華富時不動產,33,5,28,富邦-嘉義,2023-05-29,9692
00753L,中信中國50正2,28,0,28,富邦-嘉義,2023-05-29,9692
5439,高技,70,43,27,富邦-嘉義,2023-05-29,9692
2630,亞航,103,77,26,富邦-嘉義,2023-05-29,9692
2337,旺宏,27,1,26,富邦-嘉義,2023-05-29,9692
3661,世芯-KY,228,202,26,富邦-嘉義,2023-05-29,9692
2208,台船,26,1,25,富邦-嘉義,2023-05-29,9692
1591,駿吉-KY,25,0,25,富邦-嘉義,2023-05-29,9692
2881,富邦金,30,6,24,富邦-嘉義,2023-05-29,9692
2880,華南金,24,0,24,富邦-嘉義,2023-05-29,9692
6276,安鈦克,25,1,24,富邦-嘉義,2023-05-29,9692
2431,聯昌,51,27,24,富邦-嘉義,2023-05-29,9692
3032,偉訓,451,428,23,富邦-嘉義,2023-05-29,9692
2425,承啟,151,129,22,富邦-嘉義,2023-05-29,9692
1568,倉佑,31,10,21,富邦-嘉義,2023-05-29,9692
4977,眾達-KY,47,26,21,富邦-嘉義,2023-05-29,9692
2491,吉祥全,20,0,20,富邦-嘉義,2023-05-29,9692
6213,聯茂,20,0,20,富邦-嘉義,2023-05-29,9692
1474,弘裕,20,0,20,富邦-嘉義,2023-05-29,9692
00891,中信關鍵半導體,20,1,19,富邦-嘉義,2023-05-29,9692
2801,彰銀,17,0,17,富邦-嘉義,2023-05-29,9692
00882,中信中國高股息,202,0,202,富邦-嘉義,2023-05-30,9692
2421,建準,222,36,186,富邦-嘉義,2023-05-30,9692
3202,樺晟,100,1,99,富邦-嘉義,2023-05-30,9692
1503,士電,124,26,98,富邦-嘉義,2023-05-30,9692
3686,達能,100,4,96,富邦-嘉義,2023-05-30,9692
2883,凱基金,98,2,96,富邦-嘉義,2023-05-30,9692
3704,合勤控,188,109,79,富邦-嘉義,2023-05-30,9692
2368,金像電,133,55,78,富邦-嘉義,2023-05-30,9692
6243,迅杰,71,0,71,富邦-嘉義,2023-05-30,9692
2427,三商電,98,31,67,富邦-嘉義,2023-05-30,9692
6166,凌華,122,57,65,富邦-嘉義,2023-05-30,9692
2323,中環,59,5,54,富邦-嘉義,2023-05-30,9692
2349,錸德,60,7,53,富邦-嘉義,2023-05-30,9692
6443,元晶,77,27,50,富邦-嘉義,2023-05-30,9692
3231,緯創,1660,1614,46,富邦-嘉義,2023-05-30,9692
2104,國際中橡,46,0,46,富邦-嘉義,2023-05-30,9692
0056,元大高股息,98,53,45,富邦-嘉義,2023-05-30,9692
00638R,元大滬深300反1,50,7,43,富邦-嘉義,2023-05-30,9692
2465,麗臺,49,7,42,富邦-嘉義,2023-05-30,9692
3711,日月光投控,46,10,36,富邦-嘉義,2023-05-30,9692
00665L,富邦�琤肭磪囓�2,34,0,34,富邦-嘉義,2023-05-30,9692
2002,中鋼,37,6,31,富邦-嘉義,2023-05-30,9692
2356,英業達,219,188,31,富邦-嘉義,2023-05-30,9692
00687B,國泰20年美債,32,3,29,富邦-嘉義,2023-05-30,9692
2201,裕隆,784,758,26,富邦-嘉義,2023-05-30,9692
5876,上海商銀,25,0,25,富邦-嘉義,2023-05-30,9692
2331,精英,107,83,24,富邦-嘉義,2023-05-30,9692
6218,豪勉,28,5,23,富邦-嘉義,2023-05-30,9692
1609,大亞,58,36,22,富邦-嘉義,2023-05-30,9692
9907,統一實,22,0,22,富邦-嘉義,2023-05-30,9692
00706L,期元大S＆P日圓正2,22,0,22,富邦-嘉義,2023-05-30,9692
8210,勤誠,439,417,22,富邦-嘉義,2023-05-30,9692
1101,台泥,22,1,21,富邦-嘉義,2023-05-30,9692
2801,彰銀,22,3,19,富邦-嘉義,2023-05-30,9692
3078,僑威,28,9,19,富邦-嘉義,2023-05-30,9692
5386,青雲,20,1,19,富邦-嘉義,2023-05-30,9692
2634,漢翔,31,12,19,富邦-嘉義,2023-05-30,9692
3037,欣興,27,9,18,富邦-嘉義,2023-05-30,9692
3705,永信,18,0,18,富邦-嘉義,2023-05-30,9692
00632R,元大台灣50反1,50,32,18,富邦-嘉義,2023-05-30,9692
3029,零壹,53,37,16,富邦-嘉義,2023-05-30,9692
2603,長榮,20,4,16,富邦-嘉義,2023-05-30,9692
3706,神達,221,205,16,富邦-嘉義,2023-05-30,9692
5498,凱崴,151,135,16,富邦-嘉義,2023-05-30,9692
2736,富野,40,24,16,富邦-嘉義,2023-05-30,9692
2615,萬海,16,1,15,富邦-嘉義,2023-05-30,9692
2548,華固,14,0,14,富邦-嘉義,2023-05-30,9692
1907,永豐餘,15,1,14,富邦-嘉義,2023-05-30,9692
8076,伍豐,27,13,14,富邦-嘉義,2023-05-30,9692
6202,盛群,13,0,13,富邦-嘉義,2023-05-30,9692
2323,中環,1230,251,979,富邦-嘉義,2023-05-31,9692
3013,晟銘電,968,453,515,富邦-嘉義,2023-05-31,9692
8277,商丞,514,0,514,富邦-嘉義,2023-05-31,9692
00715L,期街口布蘭特正2,406,0,406,富邦-嘉義,2023-05-31,9692
2421,建準,324,20,304,富邦-嘉義,2023-05-31,9692
3306,鼎天,187,0,187,富邦-嘉義,2023-05-31,9692
1905,華紙,211,36,175,富邦-嘉義,2023-05-31,9692
5706,鳳凰,332,161,171,富邦-嘉義,2023-05-31,9692
4523,永彰,142,0,142,富邦-嘉義,2023-05-31,9692
6235,華孚,329,203,126,富邦-嘉義,2023-05-31,9692
8271,宇瞻,120,7,113,富邦-嘉義,2023-05-31,9692
2722,夏都,272,162,110,富邦-嘉義,2023-05-31,9692
1525,江申,147,38,109,富邦-嘉義,2023-05-31,9692
00753L,中信中國50正2,102,0,102,富邦-嘉義,2023-05-31,9692
4564,元翎,151,61,90,富邦-嘉義,2023-05-31,9692
4129,聯合,96,12,84,富邦-嘉義,2023-05-31,9692
2376,技嘉,241,157,84,富邦-嘉義,2023-05-31,9692
3252,海灣,103,31,72,富邦-嘉義,2023-05-31,9692
6282,康舒,117,56,61,富邦-嘉義,2023-05-31,9692
00665L,富邦�琤肭磪囓�2,60,0,60,富邦-嘉義,2023-05-31,9692
00882,中信中國高股息,58,0,58,富邦-嘉義,2023-05-31,9692
5301,寶得利,58,0,58,富邦-嘉義,2023-05-31,9692
3025,星通,105,49,56,富邦-嘉義,2023-05-31,9692
00642U,期元大S＆P石油,57,1,56,富邦-嘉義,2023-05-31,9692
2331,精英,54,1,53,富邦-嘉義,2023-05-31,9692
1513,中興電,69,16,53,富邦-嘉義,2023-05-31,9692
3706,神達,214,162,52,富邦-嘉義,2023-05-31,9692
4747,強生,146,97,49,富邦-嘉義,2023-05-31,9692
1608,華榮,56,12,44,富邦-嘉義,2023-05-31,9692
00651R,復華香港反1,40,0,40,富邦-嘉義,2023-05-31,9692
00656R,國泰中國A50反1,40,0,40,富邦-嘉義,2023-05-31,9692
2312,金寶,39,0,39,富邦-嘉義,2023-05-31,9692
6266,泰詠,34,0,34,富邦-嘉義,2023-05-31,9692
3071,協禧,33,3,30,富邦-嘉義,2023-05-31,9692
2208,台船,26,0,26,富邦-嘉義,2023-05-31,9692
2457,飛宏,152,126,26,富邦-嘉義,2023-05-31,9692
00712,復華富時不動產,31,6,25,富邦-嘉義,2023-05-31,9692
2419,仲琦,26,1,25,富邦-嘉義,2023-05-31,9692
00632R,元大台灣50反1,33,10,23,富邦-嘉義,2023-05-31,9692
3703,欣陸,23,0,23,富邦-嘉義,2023-05-31,9692
4147,中裕,35,12,23,富邦-嘉義,2023-05-31,9692
2371,大同,244,222,22,富邦-嘉義,2023-05-31,9692
5328,華容,26,4,22,富邦-嘉義,2023-05-31,9692
3594,磐儀,38,16,22,富邦-嘉義,2023-05-31,9692
6122,擎邦,22,0,22,富邦-嘉義,2023-05-31,9692
006208,富邦台50,21,0,21,富邦-嘉義,2023-05-31,9692
2365,昆盈,20,0,20,富邦-嘉義,2023-05-31,9692
2889,國票金,30,10,20,富邦-嘉義,2023-05-31,9692
00795B,中信美國公債20年,20,0,20,富邦-嘉義,2023-05-31,9692
3058,立德,23,4,19,富邦-嘉義,2023-05-31,9692
2618,長榮航,4025,2055,1970,富邦-嘉義,2023-06-01,9692
3231,緯創,1779,872,907,富邦-嘉義,2023-06-01,9692
8277,商丞,1126,541,585,富邦-嘉義,2023-06-01,9692
00715L,期街口布蘭特正2,292,22,270,富邦-嘉義,2023-06-01,9692
4979,華星光,799,562,237,富邦-嘉義,2023-06-01,9692
6215,和椿,289,53,236,富邦-嘉義,2023-06-01,9692
6282,康舒,524,341,183,富邦-嘉義,2023-06-01,9692
2328,廣宇,346,174,172,富邦-嘉義,2023-06-01,9692
8905,裕國,187,19,168,富邦-嘉義,2023-06-01,9692
2402,毅嘉,152,4,148,富邦-嘉義,2023-06-01,9692
3305,昇貿,199,65,134,富邦-嘉義,2023-06-01,9692
2376,技嘉,730,604,126,富邦-嘉義,2023-06-01,9692
6116,彩晶,122,2,120,富邦-嘉義,2023-06-01,9692
4523,永彰,116,1,115,富邦-嘉義,2023-06-01,9692
1727,中華化,314,219,95,富邦-嘉義,2023-06-01,9692
2706,第一店,428,341,87,富邦-嘉義,2023-06-01,9692
1514,亞力,79,8,71,富邦-嘉義,2023-06-01,9692
8374,羅昇,70,0,70,富邦-嘉義,2023-06-01,9692
2208,台船,75,7,68,富邦-嘉義,2023-06-01,9692
8478,東哥遊艇,121,58,63,富邦-嘉義,2023-06-01,9692
1907,永豐餘,157,98,59,富邦-嘉義,2023-06-01,9692
2356,英業達,118,61,57,富邦-嘉義,2023-06-01,9692
8088,品安,92,37,55,富邦-嘉義,2023-06-01,9692
3594,磐儀,53,1,52,富邦-嘉義,2023-06-01,9692
2634,漢翔,69,17,52,富邦-嘉義,2023-06-01,9692
00638R,元大滬深300反1,50,0,50,富邦-嘉義,2023-06-01,9692
2913,農林,187,140,47,富邦-嘉義,2023-06-01,9692
8210,勤誠,46,3,43,富邦-嘉義,2023-06-01,9692
3363,上詮,679,636,43,富邦-嘉義,2023-06-01,9692
6770,力積電,47,7,40,富邦-嘉義,2023-06-01,9692
4543,萬在,80,41,39,富邦-嘉義,2023-06-01,9692
8059,凱碩,60,21,39,富邦-嘉義,2023-06-01,9692
2349,錸德,101,67,34,富邦-嘉義,2023-06-01,9692
4968,立積,49,20,29,富邦-嘉義,2023-06-01,9692
1101,台泥,37,8,29,富邦-嘉義,2023-06-01,9692
6643,M31,28,0,28,富邦-嘉義,2023-06-01,9692
00632R,元大台灣50反1,28,0,28,富邦-嘉義,2023-06-01,9692
2834,臺企銀,28,1,27,富邦-嘉義,2023-06-01,9692
2331,精英,55,28,27,富邦-嘉義,2023-06-01,9692
5315,光聯,26,0,26,富邦-嘉義,2023-06-01,9692
00642U,期元大S＆P石油,23,0,23,富邦-嘉義,2023-06-01,9692
1605,華新,33,11,22,富邦-嘉義,2023-06-01,9692
00919,群益台灣精選高息,20,0,20,富邦-嘉義,2023-06-01,9692
1337,再生-KY,20,0,20,富邦-嘉義,2023-06-01,9692
00712,復華富時不動產,20,0,20,富邦-嘉義,2023-06-01,9692
4533,協易機,54,36,18,富邦-嘉義,2023-06-01,9692
6697,東捷資訊,18,0,18,富邦-嘉義,2023-06-01,9692
1609,大亞,60,42,18,富邦-嘉義,2023-06-01,9692
00882,中信中國高股息,17,0,17,富邦-嘉義,2023-06-01,9692
6244,茂迪,41,24,17,富邦-嘉義,2023-06-01,9692
2353,宏��,3211,2721,490,富邦-嘉義,2023-06-02,9692
6125,廣運,959,494,465,富邦-嘉義,2023-06-02,9692
6282,康舒,1360,1110,250,富邦-嘉義,2023-06-02,9692
6185,幃翔,317,82,235,富邦-嘉義,2023-06-02,9692
1519,華城,573,344,229,富邦-嘉義,2023-06-02,9692
2610,華航,271,88,183,富邦-嘉義,2023-06-02,9692
1514,亞力,331,149,182,富邦-嘉義,2023-06-02,9692
3715,定穎投控,150,0,150,富邦-嘉義,2023-06-02,9692
1529,樂事綠能,323,209,114,富邦-嘉義,2023-06-02,9692
8046,南電,117,14,103,富邦-嘉義,2023-06-02,9692
1513,中興電,1189,1100,89,富邦-嘉義,2023-06-02,9692
00919,群益台灣精選高息,88,3,85,富邦-嘉義,2023-06-02,9692
00632R,元大台灣50反1,172,91,81,富邦-嘉義,2023-06-02,9692
3540,曜越,77,1,76,富邦-嘉義,2023-06-02,9692
8011,台通,70,0,70,富邦-嘉義,2023-06-02,9692
00637L,元大滬深300正2,70,0,70,富邦-嘉義,2023-06-02,9692
1608,華榮,226,157,69,富邦-嘉義,2023-06-02,9692
6535,順藥,51,0,51,富邦-嘉義,2023-06-02,9692
5301,寶得利,50,0,50,富邦-嘉義,2023-06-02,9692
2399,映泰,208,159,49,富邦-嘉義,2023-06-02,9692
1471,首利,60,12,48,富邦-嘉義,2023-06-02,9692
2486,一詮,76,30,46,富邦-嘉義,2023-06-02,9692
3711,日月光投控,102,59,43,富邦-嘉義,2023-06-02,9692
2883,凱基金,56,15,41,富邦-嘉義,2023-06-02,9692
1506,正道,41,0,41,富邦-嘉義,2023-06-02,9692
2706,第一店,45,9,36,富邦-嘉義,2023-06-02,9692
3324,雙鴻,427,392,35,富邦-嘉義,2023-06-02,9692
00679B,元大美債20年,38,7,31,富邦-嘉義,2023-06-02,9692
2208,台船,35,4,31,富邦-嘉義,2023-06-02,9692
2515,中工,49,22,27,富邦-嘉義,2023-06-02,9692
1504,東元,291,265,26,富邦-嘉義,2023-06-02,9692
00772B,中信高評級公司債,25,0,25,富邦-嘉義,2023-06-02,9692
2331,精英,182,157,25,富邦-嘉義,2023-06-02,9692
6111,大宇資,31,9,22,富邦-嘉義,2023-06-02,9692
2727,王品,41,20,21,富邦-嘉義,2023-06-02,9692
2371,大同,216,196,20,富邦-嘉義,2023-06-02,9692
8059,凱碩,21,1,20,富邦-嘉義,2023-06-02,9692
5512,力麒,20,0,20,富邦-嘉義,2023-06-02,9692
2889,國票金,20,0,20,富邦-嘉義,2023-06-02,9692
3046,建��,36,16,20,富邦-嘉義,2023-06-02,9692
5315,光聯,20,0,20,富邦-嘉義,2023-06-02,9692
6770,力積電,20,2,18,富邦-嘉義,2023-06-02,9692
2913,農林,52,35,17,富邦-嘉義,2023-06-02,9692
2801,彰銀,16,0,16,富邦-嘉義,2023-06-02,9692
2603,長榮,17,1,16,富邦-嘉義,2023-06-02,9692
3481,群創,26,11,15,富邦-嘉義,2023-06-02,9692
6190,萬泰科,29,14,15,富邦-嘉義,2023-06-02,9692
6275,元山,18,3,15,富邦-嘉義,2023-06-02,9692
8426,紅木-KY,15,0,15,富邦-嘉義,2023-06-02,9692
6274,台燿,14,0,14,富邦-嘉義,2023-06-02,9692
2399,映泰,1649,452,1197,富邦-嘉義,2023-06-05,9692
2402,毅嘉,850,233,617,富邦-嘉義,2023-06-05,9692
6243,迅杰,405,1,404,富邦-嘉義,2023-06-05,9692
6625,必應,499,155,344,富邦-嘉義,2023-06-05,9692
2888,新光金,1871,1549,322,富邦-嘉義,2023-06-05,9692
00665L,富邦�琤肭磪囓�2,308,2,306,富邦-嘉義,2023-06-05,9692
2368,金像電,418,120,298,富邦-嘉義,2023-06-05,9692
2376,技嘉,383,151,232,富邦-嘉義,2023-06-05,9692
2634,漢翔,494,281,213,富邦-嘉義,2023-06-05,9692
1905,華紙,769,569,200,富邦-嘉義,2023-06-05,9692
00679B,元大美債20年,299,105,194,富邦-嘉義,2023-06-05,9692
2482,連宇,177,26,151,富邦-嘉義,2023-06-05,9692
3013,晟銘電,149,37,112,富邦-嘉義,2023-06-05,9692
00830,國泰費城半導體,101,3,98,富邦-嘉義,2023-06-05,9692
3046,建��,250,161,89,富邦-嘉義,2023-06-05,9692
00673R,期元大S＆P原油反1,87,0,87,富邦-嘉義,2023-06-05,9692
2427,三商電,86,1,85,富邦-嘉義,2023-06-05,9692
8033,雷虎,77,6,71,富邦-嘉義,2023-06-05,9692
2498,宏達電,275,205,70,富邦-嘉義,2023-06-05,9692
1314,中石化,84,17,67,富邦-嘉義,2023-06-05,9692
6005,群益證,65,1,64,富邦-嘉義,2023-06-05,9692
00687B,國泰20年美債,54,0,54,富邦-嘉義,2023-06-05,9692
2344,華邦電,164,111,53,富邦-嘉義,2023-06-05,9692
3540,曜越,54,2,52,富邦-嘉義,2023-06-05,9692
6214,精誠,52,7,45,富邦-嘉義,2023-06-05,9692
00919,群益台灣精選高息,46,1,45,富邦-嘉義,2023-06-05,9692
6770,力積電,48,5,43,富邦-嘉義,2023-06-05,9692
5475,德宏,42,0,42,富邦-嘉義,2023-06-05,9692
6235,華孚,1835,1793,42,富邦-嘉義,2023-06-05,9692
3521,鴻翊,41,0,41,富邦-嘉義,2023-06-05,9692
6015,宏遠證,40,2,38,富邦-嘉義,2023-06-05,9692
2891,中信金,40,3,37,富邦-嘉義,2023-06-05,9692
00878,國泰永續高股息,59,24,35,富邦-嘉義,2023-06-05,9692
3705,永信,35,0,35,富邦-嘉義,2023-06-05,9692
5328,華容,52,18,34,富邦-嘉義,2023-06-05,9692
3231,緯創,282,250,32,富邦-嘉義,2023-06-05,9692
9939,宏全,32,2,30,富邦-嘉義,2023-06-05,9692
2609,陽明,37,8,29,富邦-嘉義,2023-06-05,9692
2317,鴻海,35,6,29,富邦-嘉義,2023-06-05,9692
4916,事欣科,454,428,26,富邦-嘉義,2023-06-05,9692
3406,玉晶光,50,24,26,富邦-嘉義,2023-06-05,9692
3058,立德,34,11,23,富邦-嘉義,2023-06-05,9692
2887,台新金,26,4,22,富邦-嘉義,2023-06-05,9692
2889,國票金,23,1,22,富邦-嘉義,2023-06-05,9692
3706,神達,29,7,22,富邦-嘉義,2023-06-05,9692
8905,裕國,21,0,21,富邦-嘉義,2023-06-05,9692
2401,凌陽,24,3,21,富邦-嘉義,2023-06-05,9692
2801,彰銀,20,0,20,富邦-嘉義,2023-06-05,9692
8088,品安,20,2,18,富邦-嘉義,2023-06-05,9692
00720B,元大投資級公司債,17,0,17,富邦-嘉義,2023-06-05,9692
2618,長榮航,3487,1591,1896,富邦-嘉義,2023-06-06,9692
3231,緯創,1262,176,1086,富邦-嘉義,2023-06-06,9692
2706,第一店,2666,2349,317,富邦-嘉義,2023-06-06,9692
3058,立德,326,22,304,富邦-嘉義,2023-06-06,9692
3324,雙鴻,297,63,234,富邦-嘉義,2023-06-06,9692
2486,一詮,213,26,187,富邦-嘉義,2023-06-06,9692
2610,華航,222,45,177,富邦-嘉義,2023-06-06,9692
2722,夏都,679,557,122,富邦-嘉義,2023-06-06,9692
5706,鳳凰,427,326,101,富邦-嘉義,2023-06-06,9692
2701,萬企,334,245,89,富邦-嘉義,2023-06-06,9692
2421,建準,945,861,84,富邦-嘉義,2023-06-06,9692
2731,雄獅,1215,1145,70,富邦-嘉義,2023-06-06,9692
2206,三陽工業,322,258,64,富邦-嘉義,2023-06-06,9692
00679B,元大美債20年,62,0,62,富邦-嘉義,2023-06-06,9692
4543,萬在,110,50,60,富邦-嘉義,2023-06-06,9692
1529,樂事綠能,56,2,54,富邦-嘉義,2023-06-06,9692
4763,材料-KY,55,6,49,富邦-嘉義,2023-06-06,9692
6535,順藥,49,0,49,富邦-嘉義,2023-06-06,9692
4906,正文,56,8,48,富邦-嘉義,2023-06-06,9692
3707,漢磊,50,3,47,富邦-嘉義,2023-06-06,9692
6185,幃翔,45,0,45,富邦-嘉義,2023-06-06,9692
8222,寶一,55,13,42,富邦-嘉義,2023-06-06,9692
1608,華榮,265,227,38,富邦-嘉義,2023-06-06,9692
3540,曜越,41,4,37,富邦-嘉義,2023-06-06,9692
2630,亞航,50,14,36,富邦-嘉義,2023-06-06,9692
00712,復華富時不動產,34,0,34,富邦-嘉義,2023-06-06,9692
00632R,元大台灣50反1,41,8,33,富邦-嘉義,2023-06-06,9692
2882,國泰金,31,1,30,富邦-嘉義,2023-06-06,9692
00633L,富邦上証正2,30,0,30,富邦-嘉義,2023-06-06,9692
6118,建達,30,0,30,富邦-嘉義,2023-06-06,9692
1444,力麗,56,27,29,富邦-嘉義,2023-06-06,9692
1584,精剛,30,2,28,富邦-嘉義,2023-06-06,9692
1528,恩德,31,4,27,富邦-嘉義,2023-06-06,9692
3594,磐儀,31,4,27,富邦-嘉義,2023-06-06,9692
9939,宏全,25,0,25,富邦-嘉義,2023-06-06,9692
00720B,元大投資級公司債,23,0,23,富邦-嘉義,2023-06-06,9692
4931,新盛力,28,5,23,富邦-嘉義,2023-06-06,9692
8478,東哥遊艇,25,2,23,富邦-嘉義,2023-06-06,9692
1101,台泥,26,3,23,富邦-嘉義,2023-06-06,9692
00715L,期街口布蘭特正2,50,28,22,富邦-嘉義,2023-06-06,9692
4804,大略-KY,20,0,20,富邦-嘉義,2023-06-06,9692
1447,力鵬,20,0,20,富邦-嘉義,2023-06-06,9692
1714,和桐,20,0,20,富邦-嘉義,2023-06-06,9692
6160,欣技,30,10,20,富邦-嘉義,2023-06-06,9692
00919,群益台灣精選高息,19,0,19,富邦-嘉義,2023-06-06,9692
2303,聯電,24,5,19,富邦-嘉義,2023-06-06,9692
6234,高僑,20,1,19,富邦-嘉義,2023-06-06,9692
6116,彩晶,264,245,19,富邦-嘉義,2023-06-06,9692
3006,晶豪科,20,2,18,富邦-嘉義,2023-06-06,9692
5222,全訊,22,4,18,富邦-嘉義,2023-06-06,9692
1609,大亞,2322,1915,407,富邦-嘉義,2023-06-07,9692
1608,華榮,1077,684,393,富邦-嘉義,2023-06-07,9692
2421,建準,585,201,384,富邦-嘉義,2023-06-07,9692
2630,亞航,285,110,175,富邦-嘉義,2023-06-07,9692
3046,建��,181,20,161,富邦-嘉義,2023-06-07,9692
2376,技嘉,510,366,144,富邦-嘉義,2023-06-07,9692
6733,博晟生醫,105,1,104,富邦-嘉義,2023-06-07,9692
00919,群益台灣精選高息,81,0,81,富邦-嘉義,2023-06-07,9692
1529,樂事綠能,94,18,76,富邦-嘉義,2023-06-07,9692
2736,富野,280,207,73,富邦-嘉義,2023-06-07,9692
3583,辛耘,164,100,64,富邦-嘉義,2023-06-07,9692
2323,中環,449,389,60,富邦-嘉義,2023-06-07,9692
6829,千附精密,351,298,53,富邦-嘉義,2023-06-07,9692
3325,旭品,86,37,49,富邦-嘉義,2023-06-07,9692
2206,三陽工業,373,325,48,富邦-嘉義,2023-06-07,9692
2851,中再保,50,7,43,富邦-嘉義,2023-06-07,9692
3105,穩懋,649,607,42,富邦-嘉義,2023-06-07,9692
00878,國泰永續高股息,92,51,41,富邦-嘉義,2023-06-07,9692
020020,元大台股領航N,40,0,40,富邦-嘉義,2023-06-07,9692
020034,元大IC設計N,40,0,40,富邦-嘉義,2023-06-07,9692
2371,大同,42,4,38,富邦-嘉義,2023-06-07,9692
6187,萬潤,239,204,35,富邦-嘉義,2023-06-07,9692
00885,富邦越南,70,37,33,富邦-嘉義,2023-06-07,9692
2743,山富,34,4,30,富邦-嘉義,2023-06-07,9692
2610,華航,43,14,29,富邦-嘉義,2023-06-07,9692
2883B,凱基金乙特,30,1,29,富邦-嘉義,2023-06-07,9692
3306,鼎天,45,17,28,富邦-嘉義,2023-06-07,9692
4543,萬在,228,200,28,富邦-嘉義,2023-06-07,9692
6125,廣運,572,545,27,富邦-嘉義,2023-06-07,9692
2748,雲品,123,96,27,富邦-嘉義,2023-06-07,9692
00712,復華富時不動產,28,2,26,富邦-嘉義,2023-06-07,9692
00924,復華S＆P500成長,26,0,26,富邦-嘉義,2023-06-07,9692
6153,嘉聯益,25,0,25,富邦-嘉義,2023-06-07,9692
3037,欣興,35,12,23,富邦-嘉義,2023-06-07,9692
00637L,元大滬深300正2,23,0,23,富邦-嘉義,2023-06-07,9692
3494,誠研,23,0,23,富邦-嘉義,2023-06-07,9692
2634,漢翔,235,212,23,富邦-嘉義,2023-06-07,9692
6188,廣明,65,42,23,富邦-嘉義,2023-06-07,9692
4123,晟德,55,33,22,富邦-嘉義,2023-06-07,9692
8033,雷虎,32,10,22,富邦-嘉義,2023-06-07,9692
1514,亞力,45,23,22,富邦-嘉義,2023-06-07,9692
6112,邁達特,36,15,21,富邦-嘉義,2023-06-07,9692
2313,華通,23,2,21,富邦-嘉義,2023-06-07,9692
00902,中信電池及儲能,22,1,21,富邦-嘉義,2023-06-07,9692
1504,東元,252,231,21,富邦-嘉義,2023-06-07,9692
6183,關貿,20,0,20,富邦-嘉義,2023-06-07,9692
1471,首利,20,0,20,富邦-嘉義,2023-06-07,9692
3661,世芯-KY,20,0,20,富邦-嘉義,2023-06-07,9692
8940,新天地,31,11,20,富邦-嘉義,2023-06-07,9692
2402,毅嘉,51,33,18,富邦-嘉義,2023-06-07,9692
2482,連宇,637,266,371,富邦-嘉義,2023-06-08,9692
2731,雄獅,525,277,248,富邦-嘉義,2023-06-08,9692
00679B,元大美債20年,151,3,148,富邦-嘉義,2023-06-08,9692
2801,彰銀,104,0,104,富邦-嘉義,2023-06-08,9692
6625,必應,537,433,104,富邦-嘉義,2023-06-08,9692
00673R,期元大S＆P原油反1,102,1,101,富邦-嘉義,2023-06-08,9692
6443,元晶,92,0,92,富邦-嘉義,2023-06-08,9692
1432,大魯閣,103,13,90,富邦-嘉義,2023-06-08,9692
00878,國泰永續高股息,102,13,89,富邦-嘉義,2023-06-08,9692
2888,新光金,95,7,88,富邦-嘉義,2023-06-08,9692
00919,群益台灣精選高息,72,0,72,富邦-嘉義,2023-06-08,9692
2706,第一店,207,140,67,富邦-嘉義,2023-06-08,9692
00712,復華富時不動產,73,6,67,富邦-嘉義,2023-06-08,9692
6125,廣運,73,12,61,富邦-嘉義,2023-06-08,9692
1533,車王電,101,42,59,富邦-嘉義,2023-06-08,9692
2504,國產,64,10,54,富邦-嘉義,2023-06-08,9692
1605,華新,111,58,53,富邦-嘉義,2023-06-08,9692
2851,中再保,51,6,45,富邦-嘉義,2023-06-08,9692
8940,新天地,76,32,44,富邦-嘉義,2023-06-08,9692
6139,亞翔,47,5,42,富邦-嘉義,2023-06-08,9692
6005,群益證,45,7,38,富邦-嘉義,2023-06-08,9692
00720B,元大投資級公司債,30,0,30,富邦-嘉義,2023-06-08,9692
3006,晶豪科,35,5,30,富邦-嘉義,2023-06-08,9692
2641,正德,31,1,30,富邦-嘉義,2023-06-08,9692
8033,雷虎,42,13,29,富邦-嘉義,2023-06-08,9692
6753,龍德造船,30,2,28,富邦-嘉義,2023-06-08,9692
2383,台光電,36,11,25,富邦-嘉義,2023-06-08,9692
2618,長榮航,689,665,24,富邦-嘉義,2023-06-08,9692
00927,群益半導體收益,23,0,23,富邦-嘉義,2023-06-08,9692
1504,東元,29,6,23,富邦-嘉義,2023-06-08,9692
0056,元大高股息,40,17,23,富邦-嘉義,2023-06-08,9692
1720,生達,26,3,23,富邦-嘉義,2023-06-08,9692
3038,全台,25,3,22,富邦-嘉義,2023-06-08,9692
1513,中興電,56,35,21,富邦-嘉義,2023-06-08,9692
3217,優群,28,7,21,富邦-嘉義,2023-06-08,9692
8016,矽創,22,1,21,富邦-嘉義,2023-06-08,9692
3037,欣興,46,25,21,富邦-嘉義,2023-06-08,9692
00751B,元大AAA至A公司債,20,0,20,富邦-嘉義,2023-06-08,9692
3221,台嘉碩,20,1,19,富邦-嘉義,2023-06-08,9692
6596,寬宏藝術,46,27,19,富邦-嘉義,2023-06-08,9692
6509,聚和,19,0,19,富邦-嘉義,2023-06-08,9692
8277,商丞,19,0,19,富邦-嘉義,2023-06-08,9692
00687B,國泰20年美債,19,0,19,富邦-嘉義,2023-06-08,9692
8222,寶一,109,91,18,富邦-嘉義,2023-06-08,9692
2344,華邦電,38,20,18,富邦-嘉義,2023-06-08,9692
6491,晶碩,17,0,17,富邦-嘉義,2023-06-08,9692
2882,國泰金,18,2,16,富邦-嘉義,2023-06-08,9692
4906,正文,22,6,16,富邦-嘉義,2023-06-08,9692
5328,華容,17,1,16,富邦-嘉義,2023-06-08,9692
3029,零壹,22,7,15,富邦-嘉義,2023-06-08,9692
3231,緯創,4194,2845,1349,富邦-嘉義,2023-06-09,9692
2618,長榮航,1338,30,1308,富邦-嘉義,2023-06-09,9692
5465,富驊,1319,674,645,富邦-嘉義,2023-06-09,9692
3515,華擎,334,132,202,富邦-嘉義,2023-06-09,9692
6122,擎邦,782,583,199,富邦-嘉義,2023-06-09,9692
2421,建準,576,397,179,富邦-嘉義,2023-06-09,9692
2888,新光金,311,145,166,富邦-嘉義,2023-06-09,9692
3037,欣興,130,17,113,富邦-嘉義,2023-06-09,9692
1605,華新,123,29,94,富邦-嘉義,2023-06-09,9692
6101,寬魚國際,75,1,74,富邦-嘉義,2023-06-09,9692
2425,承啟,331,257,74,富邦-嘉義,2023-06-09,9692
6125,廣運,407,335,72,富邦-嘉義,2023-06-09,9692
2609,陽明,80,18,62,富邦-嘉義,2023-06-09,9692
3374,精材,232,172,60,富邦-嘉義,2023-06-09,9692
5340,建榮,68,9,59,富邦-嘉義,2023-06-09,9692
00715L,期街口布蘭特正2,61,3,58,富邦-嘉義,2023-06-09,9692
3013,晟銘電,136,85,51,富邦-嘉義,2023-06-09,9692
2356,英業達,139,96,43,富邦-嘉義,2023-06-09,9692
3706,神達,43,8,35,富邦-嘉義,2023-06-09,9692
00919,群益台灣精選高息,38,4,34,富邦-嘉義,2023-06-09,9692
1524,耿鼎,41,10,31,富邦-嘉義,2023-06-09,9692
00632R,元大台灣50反1,36,5,31,富邦-嘉義,2023-06-09,9692
6205,詮欣,44,14,30,富邦-嘉義,2023-06-09,9692
2382,廣達,333,304,29,富邦-嘉義,2023-06-09,9692
6266,泰詠,46,18,28,富邦-嘉義,2023-06-09,9692
4157,太景*-KY,29,2,27,富邦-嘉義,2023-06-09,9692
8996,高力,34,7,27,富邦-嘉義,2023-06-09,9692
2436,偉詮電,89,62,27,富邦-嘉義,2023-06-09,9692
4123,晟德,35,8,27,富邦-嘉義,2023-06-09,9692
6196,帆宣,32,6,26,富邦-嘉義,2023-06-09,9692
2402,毅嘉,38,14,24,富邦-嘉義,2023-06-09,9692
00712,復華富時不動產,28,5,23,富邦-嘉義,2023-06-09,9692
2851,中再保,23,0,23,富邦-嘉義,2023-06-09,9692
00637L,元大滬深300正2,22,0,22,富邦-嘉義,2023-06-09,9692
2328,廣宇,55,33,22,富邦-嘉義,2023-06-09,9692
6576,逸達,21,0,21,富邦-嘉義,2023-06-09,9692
2705,六福,200,179,21,富邦-嘉義,2023-06-09,9692
4306,炎洲,21,0,21,富邦-嘉義,2023-06-09,9692
6441,廣錠,29,8,21,富邦-嘉義,2023-06-09,9692
00642U,期元大S＆P石油,23,3,20,富邦-嘉義,2023-06-09,9692
3707,漢磊,22,2,20,富邦-嘉義,2023-06-09,9692
2883B,凱基金乙特,20,0,20,富邦-嘉義,2023-06-09,9692
3169,亞信,20,0,20,富邦-嘉義,2023-06-09,9692
2358,廷鑫,20,0,20,富邦-嘉義,2023-06-09,9692
5498,凱崴,20,0,20,富邦-嘉義,2023-06-09,9692
1504,東元,50,31,19,富邦-嘉義,2023-06-09,9692
2734,易飛網,21,2,19,富邦-嘉義,2023-06-09,9692
1314,中石化,23,4,19,富邦-嘉義,2023-06-09,9692
00725B,國泰投資級公司債,19,1,18,富邦-嘉義,2023-06-09,9692
6188,廣明,75,57,18,富邦-嘉義,2023-06-09,9692
00715L,期街口布蘭特正2,414,20,394,富邦-嘉義,2023-06-12,9692
6288,聯嘉,757,554,203,富邦-嘉義,2023-06-12,9692
00929,復華台灣科技優息,212,15,197,富邦-嘉義,2023-06-12,9692
00712,復華富時不動產,208,30,178,富邦-嘉義,2023-06-12,9692
6605,帝寶,168,4,164,富邦-嘉義,2023-06-12,9692
2888,新光金,698,537,161,富邦-嘉義,2023-06-12,9692
3178,公準,428,280,148,富邦-嘉義,2023-06-12,9692
2427,三商電,87,2,85,富邦-嘉義,2023-06-12,9692
00919,群益台灣精選高息,81,0,81,富邦-嘉義,2023-06-12,9692
6116,彩晶,81,0,81,富邦-嘉義,2023-06-12,9692
2495,普安,104,30,74,富邦-嘉義,2023-06-12,9692
6196,帆宣,122,59,63,富邦-嘉義,2023-06-12,9692
1314,中石化,62,1,61,富邦-嘉義,2023-06-12,9692
00888,永豐台灣ESG,53,2,51,富邦-嘉義,2023-06-12,9692
1101,台泥,47,3,44,富邦-嘉義,2023-06-12,9692
3308,聯德,74,32,42,富邦-嘉義,2023-06-12,9692
020020,元大台股領航N,40,0,40,富邦-嘉義,2023-06-12,9692
1815,富喬,138,101,37,富邦-嘉義,2023-06-12,9692
00632R,元大台灣50反1,55,20,35,富邦-嘉義,2023-06-12,9692
1809,中釉,35,0,35,富邦-嘉義,2023-06-12,9692
00642U,期元大S＆P石油,33,0,33,富邦-嘉義,2023-06-12,9692
5905,南仁湖,37,4,33,富邦-嘉義,2023-06-12,9692
2371,大同,36,4,32,富邦-嘉義,2023-06-12,9692
3481,群創,61,29,32,富邦-嘉義,2023-06-12,9692
2486,一詮,134,103,31,富邦-嘉義,2023-06-12,9692
6153,嘉聯益,31,0,31,富邦-嘉義,2023-06-12,9692
5324,士開,34,3,31,富邦-嘉義,2023-06-12,9692
2330,台積電,54,23,31,富邦-嘉義,2023-06-12,9692
00772B,中信高評級公司債,37,8,29,富邦-嘉義,2023-06-12,9692
2356,英業達,124,97,27,富邦-嘉義,2023-06-12,9692
3594,磐儀,30,5,25,富邦-嘉義,2023-06-12,9692
1524,耿鼎,24,0,24,富邦-嘉義,2023-06-12,9692
2444,兆勁,25,1,24,富邦-嘉義,2023-06-12,9692
2332,友訊,27,4,23,富邦-嘉義,2023-06-12,9692
6187,萬潤,24,2,22,富邦-嘉義,2023-06-12,9692
00679B,元大美債20年,21,0,21,富邦-嘉義,2023-06-12,9692
2457,飛宏,63,42,21,富邦-嘉義,2023-06-12,9692
2312,金寶,434,413,21,富邦-嘉義,2023-06-12,9692
2736,富野,125,105,20,富邦-嘉義,2023-06-12,9692
3661,世芯-KY,35,15,20,富邦-嘉義,2023-06-12,9692
1504,東元,44,24,20,富邦-嘉義,2023-06-12,9692
3078,僑威,96,77,19,富邦-嘉義,2023-06-12,9692
4123,晟德,21,2,19,富邦-嘉義,2023-06-12,9692
2882,國泰金,18,0,18,富邦-嘉義,2023-06-12,9692
7402,邑錡,19,1,18,富邦-嘉義,2023-06-12,9692
00894,中信小資高價30,20,3,17,富邦-嘉義,2023-06-12,9692
00902,中信電池及儲能,16,0,16,富邦-嘉義,2023-06-12,9692
2388,威盛,26,10,16,富邦-嘉義,2023-06-12,9692
6148,驊宏資,25,10,15,富邦-嘉義,2023-06-12,9692
3483,力致,17,2,15,富邦-嘉義,2023-06-12,9692
2618,長榮航,4659,1667,2992,富邦-嘉義,2023-06-13,9692
00715L,期街口布蘭特正2,654,0,654,富邦-嘉義,2023-06-13,9692
2356,英業達,1740,1113,627,富邦-嘉義,2023-06-13,9692
1742,台蠟,309,0,309,富邦-嘉義,2023-06-13,9692
2324,仁寶,283,6,277,富邦-嘉義,2023-06-13,9692
4533,協易機,737,568,169,富邦-嘉義,2023-06-13,9692
2888,新光金,385,237,148,富邦-嘉義,2023-06-13,9692
00632R,元大台灣50反1,225,80,145,富邦-嘉義,2023-06-13,9692
6235,華孚,646,508,138,富邦-嘉義,2023-06-13,9692
6532,瑞耘,285,159,126,富邦-嘉義,2023-06-13,9692
3481,群創,149,29,120,富邦-嘉義,2023-06-13,9692
3583,辛耘,239,132,107,富邦-嘉義,2023-06-13,9692
2323,中環,251,147,104,富邦-嘉義,2023-06-13,9692
00919,群益台灣精選高息,109,7,102,富邦-嘉義,2023-06-13,9692
5864,致和證,102,0,102,富邦-嘉義,2023-06-13,9692
00885,富邦越南,87,12,75,富邦-嘉義,2023-06-13,9692
3515,華擎,110,40,70,富邦-嘉義,2023-06-13,9692
2376,技嘉,149,80,69,富邦-嘉義,2023-06-13,9692
2312,金寶,76,11,65,富邦-嘉義,2023-06-13,9692
1471,首利,65,1,64,富邦-嘉義,2023-06-13,9692
2399,映泰,143,80,63,富邦-嘉義,2023-06-13,9692
2705,六福,190,133,57,富邦-嘉義,2023-06-13,9692
2489,瑞軒,58,2,56,富邦-嘉義,2023-06-13,9692
00924,復華S＆P500成長,45,0,45,富邦-嘉義,2023-06-13,9692
3715,定穎投控,51,7,44,富邦-嘉義,2023-06-13,9692
6148,驊宏資,64,21,43,富邦-嘉義,2023-06-13,9692
3014,聯陽,48,7,41,富邦-嘉義,2023-06-13,9692
020034,元大IC設計N,40,0,40,富邦-嘉義,2023-06-13,9692
3617,碩天,59,20,39,富邦-嘉義,2023-06-13,9692
1513,中興電,65,26,39,富邦-嘉義,2023-06-13,9692
00929,復華台灣科技優息,51,13,38,富邦-嘉義,2023-06-13,9692
2630,亞航,92,56,36,富邦-嘉義,2023-06-13,9692
5258,虹堡,184,148,36,富邦-嘉義,2023-06-13,9692
2409,友達,60,25,35,富邦-嘉義,2023-06-13,9692
00642U,期元大S＆P石油,32,0,32,富邦-嘉義,2023-06-13,9692
6122,擎邦,49,18,31,富邦-嘉義,2023-06-13,9692
3363,上詮,33,3,30,富邦-嘉義,2023-06-13,9692
2425,承啟,32,2,30,富邦-嘉義,2023-06-13,9692
00882,中信中國高股息,29,0,29,富邦-嘉義,2023-06-13,9692
2515,中工,55,27,28,富邦-嘉義,2023-06-13,9692
8034,榮群,41,13,28,富邦-嘉義,2023-06-13,9692
00712,復華富時不動產,45,18,27,富邦-嘉義,2023-06-13,9692
5871,中租-KY,28,1,27,富邦-嘉義,2023-06-13,9692
6282,康舒,39,14,25,富邦-嘉義,2023-06-13,9692
2382,廣達,704,680,24,富邦-嘉義,2023-06-13,9692
3078,僑威,228,205,23,富邦-嘉義,2023-06-13,9692
2610,華航,42,21,21,富邦-嘉義,2023-06-13,9692
3374,精材,63,43,20,富邦-嘉義,2023-06-13,9692
00772B,中信高評級公司債,20,0,20,富邦-嘉義,2023-06-13,9692
2736,富野,59,39,20,富邦-嘉義,2023-06-13,9692
2618,長榮航,7967,6096,1871,富邦-嘉義,2023-06-14,9692
2482,連宇,615,334,281,富邦-嘉義,2023-06-14,9692
8210,勤誠,264,5,259,富邦-嘉義,2023-06-14,9692
2382,廣達,405,163,242,富邦-嘉義,2023-06-14,9692
00665L,富邦�琤肭磪囓�2,200,2,198,富邦-嘉義,2023-06-14,9692
2401,凌陽,140,23,117,富邦-嘉義,2023-06-14,9692
1609,大亞,183,68,115,富邦-嘉義,2023-06-14,9692
6770,力積電,135,27,108,富邦-嘉義,2023-06-14,9692
00919,群益台灣精選高息,117,11,106,富邦-嘉義,2023-06-14,9692
6005,群益證,89,0,89,富邦-嘉義,2023-06-14,9692
4533,協易機,979,904,75,富邦-嘉義,2023-06-14,9692
4543,萬在,71,0,71,富邦-嘉義,2023-06-14,9692
1611,中電,1113,1044,69,富邦-嘉義,2023-06-14,9692
2453,凌群,122,54,68,富邦-嘉義,2023-06-14,9692
2888,新光金,96,32,64,富邦-嘉義,2023-06-14,9692
2399,映泰,361,301,60,富邦-嘉義,2023-06-14,9692
3078,僑威,75,15,60,富邦-嘉義,2023-06-14,9692
00902,中信電池及儲能,56,2,54,富邦-嘉義,2023-06-14,9692
00712,復華富時不動產,53,2,51,富邦-嘉義,2023-06-14,9692
00673R,期元大S＆P原油反1,50,0,50,富邦-嘉義,2023-06-14,9692
2409,友達,100,55,45,富邦-嘉義,2023-06-14,9692
2845,遠東銀,52,8,44,富邦-嘉義,2023-06-14,9692
00688L,國泰20年美債正2,41,0,41,富邦-嘉義,2023-06-14,9692
2324,仁寶,41,8,33,富邦-嘉義,2023-06-14,9692
4916,事欣科,34,2,32,富邦-嘉義,2023-06-14,9692
2388,威盛,32,1,31,富邦-嘉義,2023-06-14,9692
3443,創意,51,20,31,富邦-嘉義,2023-06-14,9692
5222,全訊,30,0,30,富邦-嘉義,2023-06-14,9692
00632R,元大台灣50反1,30,0,30,富邦-嘉義,2023-06-14,9692
2367,燿華,30,0,30,富邦-嘉義,2023-06-14,9692
3022,威強電,179,152,27,富邦-嘉義,2023-06-14,9692
3058,立德,117,90,27,富邦-嘉義,2023-06-14,9692
00679B,元大美債20年,27,1,26,富邦-嘉義,2023-06-14,9692
2228,劍麟,40,17,23,富邦-嘉義,2023-06-14,9692
6182,合晶,40,18,22,富邦-嘉義,2023-06-14,9692
1795,美時,47,25,22,富邦-嘉義,2023-06-14,9692
6669,緯穎,20,0,20,富邦-嘉義,2023-06-14,9692
6195,詩肯,20,0,20,富邦-嘉義,2023-06-14,9692
3169,亞信,20,0,20,富邦-嘉義,2023-06-14,9692
00751B,元大AAA至A公司債,19,0,19,富邦-嘉義,2023-06-14,9692
8916,光隆,20,1,19,富邦-嘉義,2023-06-14,9692
00929,復華台灣科技優息,20,3,17,富邦-嘉義,2023-06-14,9692
3356,奇偶,179,162,17,富邦-嘉義,2023-06-14,9692
8227,巨有科技,21,5,16,富邦-嘉義,2023-06-14,9692
8088,品安,30,14,16,富邦-嘉義,2023-06-14,9692
1513,中興電,37,22,15,富邦-嘉義,2023-06-14,9692
2331,精英,14,0,14,富邦-嘉義,2023-06-14,9692
2536,宏普,14,0,14,富邦-嘉義,2023-06-14,9692
3317,尼克森,22,8,14,富邦-嘉義,2023-06-14,9692
8086,宏捷科,15,2,13,富邦-嘉義,2023-06-14,9692
2610,華航,13142,12330,812,富邦-嘉義,2023-06-15,9692
3706,神達,1502,862,640,富邦-嘉義,2023-06-15,9692
00632R,元大台灣50反1,486,6,480,富邦-嘉義,2023-06-15,9692
1528,恩德,467,70,397,富邦-嘉義,2023-06-15,9692
5201,凱衛,332,2,330,富邦-嘉義,2023-06-15,9692
2888,新光金,290,31,259,富邦-嘉義,2023-06-15,9692
3231,緯創,3257,3018,239,富邦-嘉義,2023-06-15,9692
2618,長榮航,5461,5270,191,富邦-嘉義,2023-06-15,9692
00919,群益台灣精選高息,162,14,148,富邦-嘉義,2023-06-15,9692
5258,虹堡,623,484,139,富邦-嘉義,2023-06-15,9692
3078,僑威,306,171,135,富邦-嘉義,2023-06-15,9692
4572,駐龍,138,23,115,富邦-嘉義,2023-06-15,9692
6116,彩晶,113,0,113,富邦-嘉義,2023-06-15,9692
1815,富喬,576,468,108,富邦-嘉義,2023-06-15,9692
00706L,期元大S＆P日圓正2,102,0,102,富邦-嘉義,2023-06-15,9692
2356,英業達,1464,1384,80,富邦-嘉義,2023-06-15,9692
8076,伍豐,227,158,69,富邦-嘉義,2023-06-15,9692
3652,精聯,73,5,68,富邦-嘉義,2023-06-15,9692
4763,材料-KY,61,1,60,富邦-嘉義,2023-06-15,9692
2453,凌群,1363,1307,56,富邦-嘉義,2023-06-15,9692
6235,華孚,162,110,52,富邦-嘉義,2023-06-15,9692
1522,堤維西,190,143,47,富邦-嘉義,2023-06-15,9692
8034,榮群,50,6,44,富邦-嘉義,2023-06-15,9692
00712,復華富時不動產,75,33,42,富邦-嘉義,2023-06-15,9692
5465,富驊,61,23,38,富邦-嘉義,2023-06-15,9692
2371,大同,377,342,35,富邦-嘉義,2023-06-15,9692
3346,麗清,47,13,34,富邦-嘉義,2023-06-15,9692
2736,富野,43,10,33,富邦-嘉義,2023-06-15,9692
2812,台中銀,31,0,31,富邦-嘉義,2023-06-15,9692
5905,南仁湖,32,4,28,富邦-嘉義,2023-06-15,9692
2359,所羅門,142,114,28,富邦-嘉義,2023-06-15,9692
5864,致和證,27,0,27,富邦-嘉義,2023-06-15,9692
8147,正淩,26,1,25,富邦-嘉義,2023-06-15,9692
3325,旭品,154,131,23,富邦-嘉義,2023-06-15,9692
6577,勁豐,22,0,22,富邦-嘉義,2023-06-15,9692
5871,中租-KY,22,1,21,富邦-嘉義,2023-06-15,9692
1314,中石化,21,0,21,富邦-嘉義,2023-06-15,9692
3481,群創,53,32,21,富邦-嘉義,2023-06-15,9692
00642U,期元大S＆P石油,21,0,21,富邦-嘉義,2023-06-15,9692
2376,技嘉,196,176,20,富邦-嘉義,2023-06-15,9692
5508,永信建,20,0,20,富邦-嘉義,2023-06-15,9692
2884,玉山金,35,15,20,富邦-嘉義,2023-06-15,9692
00882,中信中國高股息,19,0,19,富邦-嘉義,2023-06-15,9692
2344,華邦電,37,18,19,富邦-嘉義,2023-06-15,9692
1714,和桐,18,0,18,富邦-嘉義,2023-06-15,9692
0056,元大高股息,53,36,17,富邦-嘉義,2023-06-15,9692
2609,陽明,23,7,16,富邦-嘉義,2023-06-15,9692
00715L,期街口布蘭特正2,122,106,16,富邦-嘉義,2023-06-15,9692
1605,華新,29,13,16,富邦-嘉義,2023-06-15,9692
6441,廣錠,16,1,15,富邦-嘉義,2023-06-15,9692
2634,漢翔,1001,226,775,富邦-嘉義,2023-06-16,9692
2312,金寶,2052,1651,401,富邦-嘉義,2023-06-16,9692
1513,中興電,684,336,348,富邦-嘉義,2023-06-16,9692
1525,江申,252,3,249,富邦-嘉義,2023-06-16,9692
4526,東台,271,138,133,富邦-嘉義,2023-06-16,9692
1605,華新,492,384,108,富邦-嘉義,2023-06-16,9692
3049,精金,106,0,106,富邦-嘉義,2023-06-16,9692
00673R,期元大S＆P原油反1,90,0,90,富邦-嘉義,2023-06-16,9692
00919,群益台灣精選高息,123,38,85,富邦-嘉義,2023-06-16,9692
1471,首利,92,12,80,富邦-嘉義,2023-06-16,9692
3498,陽程,70,1,69,富邦-嘉義,2023-06-16,9692
2356,英業達,247,180,67,富邦-嘉義,2023-06-16,9692
1609,大亞,293,228,65,富邦-嘉義,2023-06-16,9692
4138,曜亞,109,44,65,富邦-嘉義,2023-06-16,9692
4543,萬在,106,44,62,富邦-嘉義,2023-06-16,9692
1519,華城,843,788,55,富邦-嘉義,2023-06-16,9692
2014,中鴻,59,8,51,富邦-嘉義,2023-06-16,9692
4207,環泰,49,0,49,富邦-嘉義,2023-06-16,9692
00688L,國泰20年美債正2,45,0,45,富邦-嘉義,2023-06-16,9692
1514,亞力,153,110,43,富邦-嘉義,2023-06-16,9692
00713,元大台灣高息低波,40,6,34,富邦-嘉義,2023-06-16,9692
2504,國產,35,1,34,富邦-嘉義,2023-06-16,9692
2371,大同,869,836,33,富邦-嘉義,2023-06-16,9692
2834,臺企銀,38,5,33,富邦-嘉義,2023-06-16,9692
3013,晟銘電,101,69,32,富邦-嘉義,2023-06-16,9692
3583,辛耘,44,12,32,富邦-嘉義,2023-06-16,9692
3022,威強電,30,3,27,富邦-嘉義,2023-06-16,9692
8034,榮群,28,1,27,富邦-嘉義,2023-06-16,9692
6282,康舒,106,81,25,富邦-嘉義,2023-06-16,9692
2332,友訊,38,15,23,富邦-嘉義,2023-06-16,9692
2206,三陽工業,38,16,22,富邦-嘉義,2023-06-16,9692
2801,彰銀,25,3,22,富邦-嘉義,2023-06-16,9692
2706,第一店,21,0,21,富邦-嘉義,2023-06-16,9692
1709,和益,21,0,21,富邦-嘉義,2023-06-16,9692
3005,神基,21,0,21,富邦-嘉義,2023-06-16,9692
2359,所羅門,109,89,20,富邦-嘉義,2023-06-16,9692
3050,鈺德,20,0,20,富邦-嘉義,2023-06-16,9692
2401,凌陽,74,54,20,富邦-嘉義,2023-06-16,9692
5381,合正,28,10,18,富邦-嘉義,2023-06-16,9692
1802,台玻,145,127,18,富邦-嘉義,2023-06-16,9692
6214,精誠,91,73,18,富邦-嘉義,2023-06-16,9692
6770,力積電,21,4,17,富邦-嘉義,2023-06-16,9692
3346,麗清,18,1,17,富邦-嘉義,2023-06-16,9692
3443,創意,20,3,17,富邦-嘉義,2023-06-16,9692
2883,凱基金,30,14,16,富邦-嘉義,2023-06-16,9692
1301,台塑,18,2,16,富邦-嘉義,2023-06-16,9692
1907,永豐餘,20,4,16,富邦-嘉義,2023-06-16,9692
2886,兆豐金,18,3,15,富邦-嘉義,2023-06-16,9692
0056,元大高股息,28,12,16,富邦-嘉義,2023-06-16,9692
2601,益航,15,0,15,富邦-嘉義,2023-06-16,9692
1528,恩德,1113,664,449,富邦-嘉義,2023-06-19,9692
2610,華航,715,347,368,富邦-嘉義,2023-06-19,9692
2382,廣達,360,31,329,富邦-嘉義,2023-06-19,9692
2634,漢翔,2647,2337,310,富邦-嘉義,2023-06-19,9692
2356,英業達,345,159,186,富邦-嘉義,2023-06-19,9692
3481,群創,11939,11770,169,富邦-嘉義,2023-06-19,9692
2104,國際中橡,170,22,148,富邦-嘉義,2023-06-19,9692
2427,三商電,886,749,137,富邦-嘉義,2023-06-19,9692
8222,寶一,330,201,129,富邦-嘉義,2023-06-19,9692
3363,上詮,93,1,92,富邦-嘉義,2023-06-19,9692
2736,富野,418,327,91,富邦-嘉義,2023-06-19,9692
6116,彩晶,805,727,78,富邦-嘉義,2023-06-19,9692
8110,華東,73,0,73,富邦-嘉義,2023-06-19,9692
00712,復華富時不動產,80,10,70,富邦-嘉義,2023-06-19,9692
2609,陽明,78,8,70,富邦-嘉義,2023-06-19,9692
6462,神盾,140,76,64,富邦-嘉義,2023-06-19,9692
8210,勤誠,163,99,64,富邦-嘉義,2023-06-19,9692
2324,仁寶,67,3,64,富邦-嘉義,2023-06-19,9692
5704,老爺知,121,64,57,富邦-嘉義,2023-06-19,9692
7402,邑錡,158,102,56,富邦-嘉義,2023-06-19,9692
6148,驊宏資,179,129,50,富邦-嘉義,2023-06-19,9692
2482,連宇,56,8,48,富邦-嘉義,2023-06-19,9692
8034,榮群,50,6,44,富邦-嘉義,2023-06-19,9692
2504,國產,44,1,43,富邦-嘉義,2023-06-19,9692
5474,聰泰,45,3,42,富邦-嘉義,2023-06-19,9692
3664,安瑞-KY,40,0,40,富邦-嘉義,2023-06-19,9692
2303,聯電,41,3,38,富邦-嘉義,2023-06-19,9692
8033,雷虎,43,6,37,富邦-嘉義,2023-06-19,9692
4916,事欣科,652,615,37,富邦-嘉義,2023-06-19,9692
2603,長榮,66,31,35,富邦-嘉義,2023-06-19,9692
00673R,期元大S＆P原油反1,34,0,34,富邦-嘉義,2023-06-19,9692
2486,一詮,36,2,34,富邦-嘉義,2023-06-19,9692
3443,創意,57,24,33,富邦-嘉義,2023-06-19,9692
3515,華擎,42,10,32,富邦-嘉義,2023-06-19,9692
5009,榮剛,88,56,32,富邦-嘉義,2023-06-19,9692
2313,華通,35,4,31,富邦-嘉義,2023-06-19,9692
6126,信音,29,0,29,富邦-嘉義,2023-06-19,9692
2353,宏��,36,7,29,富邦-嘉義,2023-06-19,9692
3071,協禧,48,20,28,富邦-嘉義,2023-06-19,9692
6290,良維,32,5,27,富邦-嘉義,2023-06-19,9692
2883,凱基金,205,179,26,富邦-嘉義,2023-06-19,9692
2344,華邦電,26,1,25,富邦-嘉義,2023-06-19,9692
2323,中環,194,169,25,富邦-嘉義,2023-06-19,9692
00665L,富邦�琤肭磪囓�2,72,49,23,富邦-嘉義,2023-06-19,9692
2402,毅嘉,37,15,22,富邦-嘉義,2023-06-19,9692
2014,中鴻,70,49,21,富邦-嘉義,2023-06-19,9692
2421,建準,204,183,21,富邦-嘉義,2023-06-19,9692
1815,富喬,21,0,21,富邦-嘉義,2023-06-19,9692
9939,宏全,20,0,20,富邦-嘉義,2023-06-19,9692
5386,青雲,19,0,19,富邦-嘉義,2023-06-19,9692
1609,大亞,393,71,322,富邦-嘉義,2023-06-20,9692
2376,技嘉,428,149,279,富邦-嘉義,2023-06-20,9692
2845,遠東銀,141,1,140,富邦-嘉義,2023-06-20,9692
1514,亞力,213,105,108,富邦-嘉義,2023-06-20,9692
2630,亞航,125,25,100,富邦-嘉義,2023-06-20,9692
2722,夏都,208,115,93,富邦-嘉義,2023-06-20,9692
5258,虹堡,100,13,87,富邦-嘉義,2023-06-20,9692
2736,富野,247,181,66,富邦-嘉義,2023-06-20,9692
00922,國泰台灣領袖50,55,2,53,富邦-嘉義,2023-06-20,9692
8085,福華,52,2,50,富邦-嘉義,2023-06-20,9692
3006,晶豪科,53,7,46,富邦-嘉義,2023-06-20,9692
2405,輔信,101,57,44,富邦-嘉義,2023-06-20,9692
3287,廣寰科,45,4,41,富邦-嘉義,2023-06-20,9692
1529,樂事綠能,97,59,38,富邦-嘉義,2023-06-20,9692
5905,南仁湖,358,321,37,富邦-嘉義,2023-06-20,9692
00895,富邦未來車,40,4,36,富邦-嘉義,2023-06-20,9692
2337,旺宏,37,2,35,富邦-嘉義,2023-06-20,9692
1714,和桐,35,0,35,富邦-嘉義,2023-06-20,9692
4916,事欣科,241,207,34,富邦-嘉義,2023-06-20,9692
1905,華紙,1039,1006,33,富邦-嘉義,2023-06-20,9692
2017,官田鋼,51,19,32,富邦-嘉義,2023-06-20,9692
1471,首利,39,7,32,富邦-嘉義,2023-06-20,9692
00679B,元大美債20年,36,5,31,富邦-嘉義,2023-06-20,9692
3687,歐買尬,35,6,29,富邦-嘉義,2023-06-20,9692
2748,雲品,364,336,28,富邦-嘉義,2023-06-20,9692
00919,群益台灣精選高息,29,1,28,富邦-嘉義,2023-06-20,9692
2419,仲琦,27,0,27,富邦-嘉義,2023-06-20,9692
6244,茂迪,59,33,26,富邦-嘉義,2023-06-20,9692
00929,復華台灣科技優息,25,0,25,富邦-嘉義,2023-06-20,9692
3025,星通,157,132,25,富邦-嘉義,2023-06-20,9692
6125,廣運,32,10,22,富邦-嘉義,2023-06-20,9692
2701,萬企,24,3,21,富邦-嘉義,2023-06-20,9692
2030,彰源,21,0,21,富邦-嘉義,2023-06-20,9692
00673R,期元大S＆P原油反1,21,0,21,富邦-嘉義,2023-06-20,9692
3260,威剛,22,1,21,富邦-嘉義,2023-06-20,9692
2888,新光金,33,13,20,富邦-嘉義,2023-06-20,9692
1460,宏遠,20,0,20,富邦-嘉義,2023-06-20,9692
2409,友達,39,19,20,富邦-嘉義,2023-06-20,9692
4533,協易機,90,71,19,富邦-嘉義,2023-06-20,9692
1584,精剛,26,7,19,富邦-嘉義,2023-06-20,9692
2104,國際中橡,30,11,19,富邦-嘉義,2023-06-20,9692
6806,森崴能源,20,1,19,富邦-嘉義,2023-06-20,9692
2401,凌陽,29,10,19,富邦-嘉義,2023-06-20,9692
6282,康舒,22,4,18,富邦-嘉義,2023-06-20,9692
8121,越峰,18,0,18,富邦-嘉義,2023-06-20,9692
00923,群益台ESG低碳50,18,0,18,富邦-嘉義,2023-06-20,9692
4906,正文,19,1,18,富邦-嘉義,2023-06-20,9692
6443,元晶,93,76,17,富邦-嘉義,2023-06-20,9692
4934,太極,19,3,16,富邦-嘉義,2023-06-20,9692
2515,中工,16,0,16,富邦-嘉義,2023-06-20,9692
2610,華航,1537,507,1030,富邦-嘉義,2023-06-21,9692
1905,華紙,749,219,530,富邦-嘉義,2023-06-21,9692
6125,廣運,734,223,511,富邦-嘉義,2023-06-21,9692
2382,廣達,602,181,421,富邦-嘉義,2023-06-21,9692
2340,台亞,454,103,351,富邦-嘉義,2023-06-21,9692
2618,長榮航,678,351,327,富邦-嘉義,2023-06-21,9692
5465,富驊,538,325,213,富邦-嘉義,2023-06-21,9692
00665L,富邦�琤肭磪囓�2,227,45,182,富邦-嘉義,2023-06-21,9692
00753L,中信中國50正2,122,1,121,富邦-嘉義,2023-06-21,9692
0056,元大高股息,155,36,119,富邦-嘉義,2023-06-21,9692
1513,中興電,220,109,111,富邦-嘉義,2023-06-21,9692
00673R,期元大S＆P原油反1,108,0,108,富邦-嘉義,2023-06-21,9692
1907,永豐餘,198,92,106,富邦-嘉義,2023-06-21,9692
1533,車王電,375,273,102,富邦-嘉義,2023-06-21,9692
5512,力麒,122,36,86,富邦-嘉義,2023-06-21,9692
2705,六福,509,424,85,富邦-嘉義,2023-06-21,9692
6148,驊宏資,94,20,74,富邦-嘉義,2023-06-21,9692
1909,榮成,71,0,71,富邦-嘉義,2023-06-21,9692
00632R,元大台灣50反1,75,13,62,富邦-嘉義,2023-06-21,9692
4543,萬在,322,262,60,富邦-嘉義,2023-06-21,9692
6443,元晶,57,7,50,富邦-嘉義,2023-06-21,9692
5302,太欣,50,2,48,富邦-嘉義,2023-06-21,9692
00892,富邦台灣半導體,45,0,45,富邦-嘉義,2023-06-21,9692
2453,凌群,52,9,43,富邦-嘉義,2023-06-21,9692
2609,陽明,103,60,43,富邦-嘉義,2023-06-21,9692
2301,光寶科,44,3,41,富邦-嘉義,2023-06-21,9692
00919,群益台灣精選高息,45,4,41,富邦-嘉義,2023-06-21,9692
7402,邑錡,141,101,40,富邦-嘉義,2023-06-21,9692
6276,安鈦克,41,3,38,富邦-嘉義,2023-06-21,9692
1727,中華化,68,31,37,富邦-嘉義,2023-06-21,9692
5351,鈺創,35,3,32,富邦-嘉義,2023-06-21,9692
4563,百德,30,0,30,富邦-嘉義,2023-06-21,9692
1815,富喬,31,1,30,富邦-嘉義,2023-06-21,9692
8096,擎亞,30,0,30,富邦-嘉義,2023-06-21,9692
3481,群創,230,201,29,富邦-嘉義,2023-06-21,9692
5703,亞都,43,14,29,富邦-嘉義,2023-06-21,9692
1605,華新,43,15,28,富邦-嘉義,2023-06-21,9692
2409,友達,57,28,29,富邦-嘉義,2023-06-21,9692
2603,長榮,49,22,27,富邦-嘉義,2023-06-21,9692
2337,旺宏,27,0,27,富邦-嘉義,2023-06-21,9692
2457,飛宏,35,10,25,富邦-嘉義,2023-06-21,9692
5439,高技,25,0,25,富邦-嘉義,2023-06-21,9692
8034,榮群,25,0,25,富邦-嘉義,2023-06-21,9692
6122,擎邦,30,6,24,富邦-嘉義,2023-06-21,9692
2913,農林,47,24,23,富邦-嘉義,2023-06-21,9692
2323,中環,49,26,23,富邦-嘉義,2023-06-21,9692
6124,業強,22,0,22,富邦-嘉義,2023-06-21,9692
2331,精英,36,14,22,富邦-嘉義,2023-06-21,9692
2801,彰銀,21,0,21,富邦-嘉義,2023-06-21,9692
8210,勤誠,104,84,20,富邦-嘉義,2023-06-21,9692
2618,長榮航,2181,417,1764,富邦-嘉義,2023-06-26,9692
1802,台玻,759,44,715,富邦-嘉義,2023-06-26,9692
2634,漢翔,538,30,508,富邦-嘉義,2023-06-26,9692
3356,奇偶,378,87,291,富邦-嘉義,2023-06-26,9692
00919,群益台灣精選高息,286,17,269,富邦-嘉義,2023-06-26,9692
4510,高鋒,427,172,255,富邦-嘉義,2023-06-26,9692
6124,業強,315,101,214,富邦-嘉義,2023-06-26,9692
00715L,期街口布蘭特正2,201,0,201,富邦-嘉義,2023-06-26,9692
6188,廣明,523,331,192,富邦-嘉義,2023-06-26,9692
4106,雃博,200,14,186,富邦-嘉義,2023-06-26,9692
2427,三商電,535,355,180,富邦-嘉義,2023-06-26,9692
3306,鼎天,555,378,177,富邦-嘉義,2023-06-26,9692
2312,金寶,163,4,159,富邦-嘉義,2023-06-26,9692
2845,遠東銀,151,0,151,富邦-嘉義,2023-06-26,9692
3481,群創,210,61,149,富邦-嘉義,2023-06-26,9692
3038,全台,966,825,141,富邦-嘉義,2023-06-26,9692
3706,神達,359,234,125,富邦-嘉義,2023-06-26,9692
00637L,元大滬深300正2,125,3,122,富邦-嘉義,2023-06-26,9692
1101,台泥,122,10,112,富邦-嘉義,2023-06-26,9692
2731,雄獅,102,0,102,富邦-嘉義,2023-06-26,9692
1326,台化,100,0,100,富邦-嘉義,2023-06-26,9692
2303,聯電,124,27,97,富邦-嘉義,2023-06-26,9692
2344,華邦電,78,7,71,富邦-嘉義,2023-06-26,9692
1528,恩德,75,6,69,富邦-嘉義,2023-06-26,9692
2329,華泰,70,5,65,富邦-嘉義,2023-06-26,9692
4564,元翎,74,9,65,富邦-嘉義,2023-06-26,9692
4747,強生,90,30,60,富邦-嘉義,2023-06-26,9692
1605,華新,85,28,57,富邦-嘉義,2023-06-26,9692
00712,復華富時不動產,75,19,56,富邦-嘉義,2023-06-26,9692
5302,太欣,49,0,49,富邦-嘉義,2023-06-26,9692
1904,正隆,597,549,48,富邦-嘉義,2023-06-26,9692
2354,鴻準,72,25,47,富邦-嘉義,2023-06-26,9692
2888,新光金,568,521,47,富邦-嘉義,2023-06-26,9692
2371,大同,179,137,42,富邦-嘉義,2023-06-26,9692
6120,達運,136,99,37,富邦-嘉義,2023-06-26,9692
4915,致伸,37,2,35,富邦-嘉義,2023-06-26,9692
2405,輔信,32,1,31,富邦-嘉義,2023-06-26,9692
2867,三商壽,67,41,26,富邦-嘉義,2023-06-26,9692
2409,友達,32,6,26,富邦-嘉義,2023-06-26,9692
2515,中工,31,6,25,富邦-嘉義,2023-06-26,9692
2883,凱基金,32,8,24,富邦-嘉義,2023-06-26,9692
2412,中華電,23,0,23,富邦-嘉義,2023-06-26,9692
3260,威剛,24,1,23,富邦-嘉義,2023-06-26,9692
00633L,富邦上証正2,23,0,23,富邦-嘉義,2023-06-26,9692
3003,健和興,23,0,23,富邦-嘉義,2023-06-26,9692
00929,復華台灣科技優息,33,11,22,富邦-嘉義,2023-06-26,9692
5512,力麒,40,18,22,富邦-嘉義,2023-06-26,9692
1314,中石化,22,0,22,富邦-嘉義,2023-06-26,9692
6169,昱泉,24,3,21,富邦-嘉義,2023-06-26,9692
3049,精金,121,100,21,富邦-嘉義,2023-06-26,9692
1802,台玻,351,43,308,富邦-嘉義,2023-06-27,9692
4746,台耀,370,185,185,富邦-嘉義,2023-06-27,9692
6111,大宇資,516,354,162,富邦-嘉義,2023-06-27,9692
4994,傳奇,131,4,127,富邦-嘉義,2023-06-27,9692
8069,元太,194,74,120,富邦-嘉義,2023-06-27,9692
1609,大亞,170,55,115,富邦-嘉義,2023-06-27,9692
3231,緯創,196,102,94,富邦-嘉義,2023-06-27,9692
00715L,期街口布蘭特正2,108,16,92,富邦-嘉義,2023-06-27,9692
3687,歐買尬,459,380,79,富邦-嘉義,2023-06-27,9692
2323,中環,396,331,65,富邦-嘉義,2023-06-27,9692
3205,佰研,127,62,65,富邦-嘉義,2023-06-27,9692
2303,聯電,73,8,65,富邦-嘉義,2023-06-27,9692
1471,首利,68,4,64,富邦-嘉義,2023-06-27,9692
2312,金寶,67,8,59,富邦-嘉義,2023-06-27,9692
2344,華邦電,56,4,52,富邦-嘉義,2023-06-27,9692
1605,華新,70,21,49,富邦-嘉義,2023-06-27,9692
2486,一詮,47,0,47,富邦-嘉義,2023-06-27,9692
4564,元翎,45,0,45,富邦-嘉義,2023-06-27,9692
2409,友達,52,8,44,富邦-嘉義,2023-06-27,9692
00712,復華富時不動產,47,4,43,富邦-嘉義,2023-06-27,9692
3363,上詮,42,0,42,富邦-嘉義,2023-06-27,9692
8110,華東,38,0,38,富邦-嘉義,2023-06-27,9692
6116,彩晶,52,15,37,富邦-嘉義,2023-06-27,9692
1301,台塑,37,1,36,富邦-嘉義,2023-06-27,9692
1513,中興電,711,679,32,富邦-嘉義,2023-06-27,9692
6625,必應,30,0,30,富邦-嘉義,2023-06-27,9692
00885,富邦越南,35,6,29,富邦-嘉義,2023-06-27,9692
3374,精材,30,2,28,富邦-嘉義,2023-06-27,9692
2515,中工,26,0,26,富邦-嘉義,2023-06-27,9692
3673,TPK-KY,26,2,24,富邦-嘉義,2023-06-27,9692
2883,凱基金,24,1,23,富邦-嘉義,2023-06-27,9692
4167,松瑞藥,23,0,23,富邦-嘉義,2023-06-27,9692
1718,中纖,23,0,23,富邦-嘉義,2023-06-27,9692
2888,新光金,225,204,21,富邦-嘉義,2023-06-27,9692
2489,瑞軒,21,0,21,富邦-嘉義,2023-06-27,9692
3016,嘉晶,21,0,21,富邦-嘉義,2023-06-27,9692
2027,大成鋼,20,0,20,富邦-嘉義,2023-06-27,9692
8038,長園科,20,1,19,富邦-嘉義,2023-06-27,9692
6770,力積電,24,6,18,富邦-嘉義,2023-06-27,9692
2436,偉詮電,23,6,17,富邦-嘉義,2023-06-27,9692
5302,太欣,17,0,17,富邦-嘉義,2023-06-27,9692
2371,大同,75,58,17,富邦-嘉義,2023-06-27,9692
3049,精金,21,5,16,富邦-嘉義,2023-06-27,9692
1710,東聯,16,0,16,富邦-嘉義,2023-06-27,9692
4111,濟生,49,33,16,富邦-嘉義,2023-06-27,9692
3715,定穎投控,19,3,16,富邦-嘉義,2023-06-27,9692
8215,明基材,20,4,16,富邦-嘉義,2023-06-27,9692
00655L,國泰中國A50正2,15,0,15,富邦-嘉義,2023-06-27,9692
4108,懷特,15,0,15,富邦-嘉義,2023-06-27,9692
3031,佰鴻,15,1,14,富邦-嘉義,2023-06-27,9692
8277,商丞,1004,24,980,富邦-嘉義,2023-06-28,9692
2618,長榮航,1063,280,783,富邦-嘉義,2023-06-28,9692
00715L,期街口布蘭特正2,452,30,422,富邦-嘉義,2023-06-28,9692
4526,東台,300,5,295,富邦-嘉義,2023-06-28,9692
6470,宇智,346,135,211,富邦-嘉義,2023-06-28,9692
00632R,元大台灣50反1,200,0,200,富邦-嘉義,2023-06-28,9692
1522,堤維西,179,36,143,富邦-嘉義,2023-06-28,9692
0056,元大高股息,174,31,143,富邦-嘉義,2023-06-28,9692
1605,華新,262,158,104,富邦-嘉義,2023-06-28,9692
4157,太景*-KY,109,6,103,富邦-嘉義,2023-06-28,9692
6243,迅杰,100,0,100,富邦-嘉義,2023-06-28,9692
5706,鳳凰,166,99,67,富邦-嘉義,2023-06-28,9692
2609,陽明,88,24,64,富邦-嘉義,2023-06-28,9692
3025,星通,79,24,55,富邦-嘉義,2023-06-28,9692
8072,陞泰,57,2,55,富邦-嘉義,2023-06-28,9692
2731,雄獅,50,1,49,富邦-嘉義,2023-06-28,9692
2204,中華,51,4,47,富邦-嘉義,2023-06-28,9692
2880,華南金,44,0,44,富邦-嘉義,2023-06-28,9692
2323,中環,97,53,44,富邦-嘉義,2023-06-28,9692
8011,台通,40,0,40,富邦-嘉義,2023-06-28,9692
8076,伍豐,57,18,39,富邦-嘉義,2023-06-28,9692
2303,聯電,41,2,39,富邦-嘉義,2023-06-28,9692
2495,普安,47,10,37,富邦-嘉義,2023-06-28,9692
2743,山富,35,0,35,富邦-嘉義,2023-06-28,9692
6443,元晶,51,16,35,富邦-嘉義,2023-06-28,9692
3715,定穎投控,33,0,33,富邦-嘉義,2023-06-28,9692
2382,廣達,435,403,32,富邦-嘉義,2023-06-28,9692
2890,永豐金,32,0,32,富邦-嘉義,2023-06-28,9692
00642U,期元大S＆P石油,32,1,31,富邦-嘉義,2023-06-28,9692
00893,國泰智能電動車,51,20,31,富邦-嘉義,2023-06-28,9692
6125,廣運,112,82,30,富邦-嘉義,2023-06-28,9692
4763,材料-KY,172,142,30,富邦-嘉義,2023-06-28,9692
2230,泰茂,33,4,29,富邦-嘉義,2023-06-28,9692
3596,智易,64,36,28,富邦-嘉義,2023-06-28,9692
2030,彰源,27,0,27,富邦-嘉義,2023-06-28,9692
1301,台塑,28,1,27,富邦-嘉義,2023-06-28,9692
00895,富邦未來車,30,4,26,富邦-嘉義,2023-06-28,9692
6285,啟��,54,29,25,富邦-嘉義,2023-06-28,9692
1783,和康生,26,1,25,富邦-嘉義,2023-06-28,9692
4979,華星光,161,136,25,富邦-嘉義,2023-06-28,9692
1609,大亞,50,26,24,富邦-嘉義,2023-06-28,9692
2888,新光金,39,15,24,富邦-嘉義,2023-06-28,9692
2884,玉山金,39,15,24,富邦-嘉義,2023-06-28,9692
3019,亞光,22,0,22,富邦-嘉義,2023-06-28,9692
6188,廣明,41,19,22,富邦-嘉義,2023-06-28,9692
2468,華經,21,0,21,富邦-嘉義,2023-06-28,9692
2402,毅嘉,23,2,21,富邦-嘉義,2023-06-28,9692
2882,國泰金,20,1,19,富邦-嘉義,2023-06-28,9692
2014,中鴻,23,4,19,富邦-嘉義,2023-06-28,9692
2103,台橡,20,1,19,富邦-嘉義,2023-06-28,9692
2888,新光金,181,3,178,富邦-嘉義,2023-06-29,9692
3049,精金,100,0,100,富邦-嘉義,2023-06-29,9692
00632R,元大台灣50反1,358,295,63,富邦-嘉義,2023-06-29,9692
1605,華新,69,6,63,富邦-嘉義,2023-06-29,9692
6153,嘉聯益,273,211,62,富邦-嘉義,2023-06-29,9692
00929,復華台灣科技優息,56,1,55,富邦-嘉義,2023-06-29,9692
3027,盛達,66,14,52,富邦-嘉義,2023-06-29,9692
2230,泰茂,259,211,48,富邦-嘉義,2023-06-29,9692
3057,喬鼎,48,0,48,富邦-嘉義,2023-06-29,9692
00664R,國泰臺灣加權反1,46,0,46,富邦-嘉義,2023-06-29,9692
5864,致和證,50,5,45,富邦-嘉義,2023-06-29,9692
3356,奇偶,257,213,44,富邦-嘉義,2023-06-29,9692
6276,安鈦克,82,39,43,富邦-嘉義,2023-06-29,9692
3481,群創,60,18,42,富邦-嘉義,2023-06-29,9692
2406,國碩,40,0,40,富邦-嘉義,2023-06-29,9692
1904,正隆,45,5,40,富邦-嘉義,2023-06-29,9692
4161,聿新科,54,16,38,富邦-嘉義,2023-06-29,9692
4147,中裕,37,1,36,富邦-嘉義,2023-06-29,9692
2609,陽明,57,22,35,富邦-嘉義,2023-06-29,9692
00919,群益台灣精選高息,41,6,35,富邦-嘉義,2023-06-29,9692
3591,艾笛森,39,6,33,富邦-嘉義,2023-06-29,9692
4543,萬在,56,25,31,富邦-嘉義,2023-06-29,9692
6753,龍德造船,30,0,30,富邦-嘉義,2023-06-29,9692
3363,上詮,37,7,30,富邦-嘉義,2023-06-29,9692
2303,聯電,30,2,28,富邦-嘉義,2023-06-29,9692
4763,材料-KY,115,88,27,富邦-嘉義,2023-06-29,9692
5465,富驊,64,38,26,富邦-嘉義,2023-06-29,9692
2323,中環,48,22,26,富邦-嘉義,2023-06-29,9692
3005,神基,70,46,24,富邦-嘉義,2023-06-29,9692
2312,金寶,37,13,24,富邦-嘉義,2023-06-29,9692
1802,台玻,28,4,24,富邦-嘉義,2023-06-29,9692
2610,華航,88,65,23,富邦-嘉義,2023-06-29,9692
3665,貿聯-KY,24,3,21,富邦-嘉義,2023-06-29,9692
2399,映泰,26,5,21,富邦-嘉義,2023-06-29,9692
1609,大亞,35,14,21,富邦-嘉義,2023-06-29,9692
6285,啟��,40,20,20,富邦-嘉義,2023-06-29,9692
00720B,元大投資級公司債,20,0,20,富邦-嘉義,2023-06-29,9692
00673R,期元大S＆P原油反1,20,0,20,富邦-嘉義,2023-06-29,9692
1533,車王電,26,6,20,富邦-嘉義,2023-06-29,9692
2349,錸德,20,0,20,富邦-嘉義,2023-06-29,9692
9911,櫻花,20,0,20,富邦-嘉義,2023-06-29,9692
6446,藥華藥,20,0,20,富邦-嘉義,2023-06-29,9692
3231,緯創,1826,1807,19,富邦-嘉義,2023-06-29,9692
2428,興勤,20,1,19,富邦-嘉義,2023-06-29,9692
1234,黑松,19,0,19,富邦-嘉義,2023-06-29,9692
4967,十銓,42,23,19,富邦-嘉義,2023-06-29,9692
00692,富邦公司治理,20,1,19,富邦-嘉義,2023-06-29,9692
2883,凱基金,23,5,18,富邦-嘉義,2023-06-29,9692
8222,寶一,49,31,18,富邦-嘉義,2023-06-29,9692
2412,中華電,17,0,17,富邦-嘉義,2023-06-29,9692
2603,長榮,2000,928,1072,富邦-嘉義,2023-06-30,9692
3356,奇偶,653,337,316,富邦-嘉義,2023-06-30,9692
1514,亞力,426,135,291,富邦-嘉義,2023-06-30,9692
3013,晟銘電,464,177,287,富邦-嘉義,2023-06-30,9692
1528,恩德,693,479,214,富邦-嘉義,2023-06-30,9692
2382,廣達,2261,2070,191,富邦-嘉義,2023-06-30,9692
2344,華邦電,149,3,146,富邦-嘉義,2023-06-30,9692
1513,中興電,225,124,101,富邦-嘉義,2023-06-30,9692
6126,信音,101,1,100,富邦-嘉義,2023-06-30,9692
2609,陽明,901,804,97,富邦-嘉義,2023-06-30,9692
6122,擎邦,116,25,91,富邦-嘉義,2023-06-30,9692
00673R,期元大S＆P原油反1,84,0,84,富邦-嘉義,2023-06-30,9692
2323,中環,134,52,82,富邦-嘉義,2023-06-30,9692
6125,廣運,110,32,78,富邦-嘉義,2023-06-30,9692
2230,泰茂,389,322,67,富邦-嘉義,2023-06-30,9692
2880,華南金,62,1,61,富邦-嘉義,2023-06-30,9692
2883,凱基金,58,5,53,富邦-嘉義,2023-06-30,9692
2845,遠東銀,51,1,50,富邦-嘉義,2023-06-30,9692
4564,元翎,67,21,46,富邦-嘉義,2023-06-30,9692
00688L,國泰20年美債正2,45,0,45,富邦-嘉義,2023-06-30,9692
1605,華新,79,37,42,富邦-嘉義,2023-06-30,9692
6120,達運,84,43,41,富邦-嘉義,2023-06-30,9692
5302,太欣,48,8,40,富邦-嘉義,2023-06-30,9692
6576,逸達,39,0,39,富邦-嘉義,2023-06-30,9692
2328,廣宇,40,1,39,富邦-嘉義,2023-06-30,9692
6276,安鈦克,159,120,39,富邦-嘉義,2023-06-30,9692
2610,華航,97,59,38,富邦-嘉義,2023-06-30,9692
1301,台塑,32,0,32,富邦-嘉義,2023-06-30,9692
2023,燁輝,30,0,30,富邦-嘉義,2023-06-30,9692
2412,中華電,28,0,28,富邦-嘉義,2023-06-30,9692
00679B,元大美債20年,25,0,25,富邦-嘉義,2023-06-30,9692
2892,第一金,25,0,25,富邦-嘉義,2023-06-30,9692
1904,正隆,35,11,24,富邦-嘉義,2023-06-30,9692
6625,必應,34,10,24,富邦-嘉義,2023-06-30,9692
2881,富邦金,24,1,23,富邦-嘉義,2023-06-30,9692
00919,群益台灣精選高息,34,12,22,富邦-嘉義,2023-06-30,9692
2736,富野,24,2,22,富邦-嘉義,2023-06-30,9692
5905,南仁湖,22,1,21,富邦-嘉義,2023-06-30,9692
3006,晶豪科,21,0,21,富邦-嘉義,2023-06-30,9692
3583,辛耘,22,2,20,富邦-嘉義,2023-06-30,9692
3011,今皓,23,3,20,富邦-嘉義,2023-06-30,9692
2489,瑞軒,36,16,20,富邦-嘉義,2023-06-30,9692
5230,雷笛克光學,20,0,20,富邦-嘉義,2023-06-30,9692
2303,聯電,20,1,19,富邦-嘉義,2023-06-30,9692
2352,佳世達,22,3,19,富邦-嘉義,2023-06-30,9692
2368,金像電,84,65,19,富邦-嘉義,2023-06-30,9692
8048,德勝,62,43,19,富邦-嘉義,2023-06-30,9692
6285,啟��,26,7,19,富邦-嘉義,2023-06-30,9692
2317,鴻海,32,13,19,富邦-嘉義,2023-06-30,9692
4121,優盛,55,37,18,富邦-嘉義,2023-06-30,9692
3025,星通,723,260,463,富邦-嘉義,2023-07-03,9692
3013,晟銘電,732,313,419,富邦-嘉義,2023-07-03,9692
2421,建準,682,370,312,富邦-嘉義,2023-07-03,9692
2883,凱基金,325,45,280,富邦-嘉義,2023-07-03,9692
1603,華電,455,216,239,富邦-嘉義,2023-07-03,9692
2382,廣達,4946,4738,208,富邦-嘉義,2023-07-03,9692
2888,新光金,212,36,176,富邦-嘉義,2023-07-03,9692
6122,擎邦,286,134,152,富邦-嘉義,2023-07-03,9692
2468,華經,130,6,124,富邦-嘉義,2023-07-03,9692
6470,宇智,405,309,96,富邦-嘉義,2023-07-03,9692
4979,華星光,256,167,89,富邦-嘉義,2023-07-03,9692
3715,定穎投控,85,0,85,富邦-嘉義,2023-07-03,9692
1905,華紙,1329,1249,80,富邦-嘉義,2023-07-03,9692
8210,勤誠,234,159,75,富邦-嘉義,2023-07-03,9692
3324,雙鴻,80,5,75,富邦-嘉義,2023-07-03,9692
8222,寶一,92,22,70,富邦-嘉義,2023-07-03,9692
3046,建��,87,23,64,富邦-嘉義,2023-07-03,9692
8996,高力,356,293,63,富邦-嘉義,2023-07-03,9692
2356,英業達,219,156,63,富邦-嘉義,2023-07-03,9692
3661,世芯-KY,122,60,62,富邦-嘉義,2023-07-03,9692
2002,中鋼,76,14,62,富邦-嘉義,2023-07-03,9692
2880,華南金,60,0,60,富邦-嘉義,2023-07-03,9692
5608,四維航,57,2,55,富邦-嘉義,2023-07-03,9692
00929,復華台灣科技優息,53,2,51,富邦-嘉義,2023-07-03,9692
1503,士電,53,2,51,富邦-嘉義,2023-07-03,9692
3466,德晉,50,0,50,富邦-嘉義,2023-07-03,9692
2897,王道銀行,50,0,50,富邦-嘉義,2023-07-03,9692
3419,譁裕,50,0,50,富邦-嘉義,2023-07-03,9692
6451,訊芯-KY,157,107,50,富邦-嘉義,2023-07-03,9692
6806,森崴能源,50,6,44,富邦-嘉義,2023-07-03,9692
1471,首利,56,13,43,富邦-嘉義,2023-07-03,9692
7402,邑錡,43,2,41,富邦-嘉義,2023-07-03,9692
9907,統一實,42,1,41,富邦-嘉義,2023-07-03,9692
3231,緯創,881,840,41,富邦-嘉義,2023-07-03,9692
2406,國碩,40,2,38,富邦-嘉義,2023-07-03,9692
3308,聯德,44,6,38,富邦-嘉義,2023-07-03,9692
3027,盛達,41,3,38,富邦-嘉義,2023-07-03,9692
1522,堤維西,40,5,35,富邦-嘉義,2023-07-03,9692
2303,聯電,40,5,35,富邦-嘉義,2023-07-03,9692
00665L,富邦�琤肭磪囓�2,31,0,31,富邦-嘉義,2023-07-03,9692
3045,台灣大,30,0,30,富邦-嘉義,2023-07-03,9692
2023,燁輝,30,0,30,富邦-嘉義,2023-07-03,9692
00673R,期元大S＆P原油反1,30,0,30,富邦-嘉義,2023-07-03,9692
00712,復華富時不動產,81,52,29,富邦-嘉義,2023-07-03,9692
2427,三商電,223,194,29,富邦-嘉義,2023-07-03,9692
2736,富野,36,7,29,富邦-嘉義,2023-07-03,9692
6153,嘉聯益,80,53,27,富邦-嘉義,2023-07-03,9692
00892,富邦台灣半導體,40,16,24,富邦-嘉義,2023-07-03,9692
2352,佳世達,31,8,23,富邦-嘉義,2023-07-03,9692
2801,彰銀,40,17,23,富邦-嘉義,2023-07-03,9692
3231,緯創,1277,774,503,富邦-嘉義,2023-07-04,9692
2419,仲琦,1758,1258,500,富邦-嘉義,2023-07-04,9692
3374,精材,846,639,207,富邦-嘉義,2023-07-04,9692
2356,英業達,2466,2272,194,富邦-嘉義,2023-07-04,9692
0056,元大高股息,163,10,153,富邦-嘉義,2023-07-04,9692
3583,辛耘,426,285,141,富邦-嘉義,2023-07-04,9692
2880,華南金,129,0,129,富邦-嘉義,2023-07-04,9692
1608,華榮,127,0,127,富邦-嘉義,2023-07-04,9692
2402,毅嘉,778,658,120,富邦-嘉義,2023-07-04,9692
3163,波若威,170,63,107,富邦-嘉義,2023-07-04,9692
8110,華東,109,3,106,富邦-嘉義,2023-07-04,9692
00673R,期元大S＆P原油反1,100,0,100,富邦-嘉義,2023-07-04,9692
00688L,國泰20年美債正2,90,0,90,富邦-嘉義,2023-07-04,9692
2427,三商電,305,224,81,富邦-嘉義,2023-07-04,9692
00919,群益台灣精選高息,113,35,78,富邦-嘉義,2023-07-04,9692
2317,鴻海,117,52,65,富邦-嘉義,2023-07-04,9692
2376,技嘉,663,600,63,富邦-嘉義,2023-07-04,9692
2609,陽明,386,326,60,富邦-嘉義,2023-07-04,9692
1815,富喬,58,0,58,富邦-嘉義,2023-07-04,9692
4763,材料-KY,110,56,54,富邦-嘉義,2023-07-04,9692
2610,華航,85,34,51,富邦-嘉義,2023-07-04,9692
3356,奇偶,52,4,48,富邦-嘉義,2023-07-04,9692
5302,太欣,44,0,44,富邦-嘉義,2023-07-04,9692
00929,復華台灣科技優息,45,2,43,富邦-嘉義,2023-07-04,9692
00712,復華富時不動產,40,1,39,富邦-嘉義,2023-07-04,9692
2449,京元電子,52,14,38,富邦-嘉義,2023-07-04,9692
6770,力積電,40,3,37,富邦-嘉義,2023-07-04,9692
8088,品安,38,2,36,富邦-嘉義,2023-07-04,9692
3706,神達,1180,1145,35,富邦-嘉義,2023-07-04,9692
2615,萬海,324,291,33,富邦-嘉義,2023-07-04,9692
4526,東台,33,1,32,富邦-嘉義,2023-07-04,9692
6117,迎廣,51,21,30,富邦-嘉義,2023-07-04,9692
2331,精英,42,12,30,富邦-嘉義,2023-07-04,9692
1301,台塑,28,0,28,富邦-嘉義,2023-07-04,9692
3057,喬鼎,26,0,26,富邦-嘉義,2023-07-04,9692
2603,長榮,4571,4547,24,富邦-嘉義,2023-07-04,9692
6112,邁達特,125,101,24,富邦-嘉義,2023-07-04,9692
8050,廣積,43,19,24,富邦-嘉義,2023-07-04,9692
3443,創意,85,62,23,富邦-嘉義,2023-07-04,9692
5426,振發,86,64,22,富邦-嘉義,2023-07-04,9692
1605,華新,43,21,22,富邦-嘉義,2023-07-04,9692
2607,榮運,22,1,21,富邦-嘉義,2023-07-04,9692
2444,兆勁,25,4,21,富邦-嘉義,2023-07-04,9692
3035,智原,88,67,21,富邦-嘉義,2023-07-04,9692
2368,金像電,257,237,20,富邦-嘉義,2023-07-04,9692
4915,致伸,20,0,20,富邦-嘉義,2023-07-04,9692
5347,世界,21,1,20,富邦-嘉義,2023-07-04,9692
2442,新美齊,20,0,20,富邦-嘉義,2023-07-04,9692
3515,華擎,171,152,19,富邦-嘉義,2023-07-04,9692
3390,旭軟,19,0,19,富邦-嘉義,2023-07-04,9692
6117,迎廣,1251,30,1221,富邦-嘉義,2023-07-05,9692
3231,緯創,4509,3944,565,富邦-嘉義,2023-07-05,9692
6122,擎邦,256,6,250,富邦-嘉義,2023-07-05,9692
6111,大宇資,297,90,207,富邦-嘉義,2023-07-05,9692
4566,時碩工業,488,305,183,富邦-嘉義,2023-07-05,9692
3362,先進光,290,161,129,富邦-嘉義,2023-07-05,9692
5706,鳳凰,113,5,108,富邦-嘉義,2023-07-05,9692
00929,復華台灣科技優息,101,0,101,富邦-嘉義,2023-07-05,9692
2609,陽明,511,436,75,富邦-嘉義,2023-07-05,9692
6538,倉和,389,316,73,富邦-嘉義,2023-07-05,9692
6138,茂達,77,6,71,富邦-嘉義,2023-07-05,9692
0056,元大高股息,112,42,70,富邦-嘉義,2023-07-05,9692
2382,廣達,873,803,70,富邦-嘉義,2023-07-05,9692
2515,中工,74,5,69,富邦-嘉義,2023-07-05,9692
1611,中電,157,93,64,富邦-嘉義,2023-07-05,9692
00673R,期元大S＆P原油反1,55,0,55,富邦-嘉義,2023-07-05,9692
2883,凱基金,76,22,54,富邦-嘉義,2023-07-05,9692
2409,友達,49,0,49,富邦-嘉義,2023-07-05,9692
00632R,元大台灣50反1,53,9,44,富邦-嘉義,2023-07-05,9692
2812,台中銀,44,2,42,富邦-嘉義,2023-07-05,9692
2845,遠東銀,40,0,40,富邦-嘉義,2023-07-05,9692
1471,首利,51,12,39,富邦-嘉義,2023-07-05,9692
2486,一詮,55,16,39,富邦-嘉義,2023-07-05,9692
3466,德晉,38,0,38,富邦-嘉義,2023-07-05,9692
1522,堤維西,39,2,37,富邦-嘉義,2023-07-05,9692
2303,聯電,30,0,30,富邦-嘉義,2023-07-05,9692
2028,威致,30,0,30,富邦-嘉義,2023-07-05,9692
00683L,期元大美元指正2,30,0,30,富邦-嘉義,2023-07-05,9692
2880,華南金,30,1,29,富邦-嘉義,2023-07-05,9692
3013,晟銘電,319,292,27,富邦-嘉義,2023-07-05,9692
4919,新唐,49,22,27,富邦-嘉義,2023-07-05,9692
3447,展達,42,18,24,富邦-嘉義,2023-07-05,9692
8227,巨有科技,37,14,23,富邦-嘉義,2023-07-05,9692
1326,台化,26,3,23,富邦-嘉義,2023-07-05,9692
3687,歐買尬,269,246,23,富邦-嘉義,2023-07-05,9692
6446,藥華藥,26,3,23,富邦-嘉義,2023-07-05,9692
4207,環泰,23,1,22,富邦-嘉義,2023-07-05,9692
4934,太極,584,563,21,富邦-嘉義,2023-07-05,9692
2344,華邦電,30,9,21,富邦-嘉義,2023-07-05,9692
6472,保瑞,44,24,20,富邦-嘉義,2023-07-05,9692
8936,國統,28,8,20,富邦-嘉義,2023-07-05,9692
2888,新光金,62,43,19,富邦-嘉義,2023-07-05,9692
4960,誠美材,20,1,19,富邦-嘉義,2023-07-05,9692
4414,如興,41,22,19,富邦-嘉義,2023-07-05,9692
2368,金像電,47,28,19,富邦-嘉義,2023-07-05,9692
6120,達運,71,53,18,富邦-嘉義,2023-07-05,9692
3363,上詮,132,114,18,富邦-嘉義,2023-07-05,9692
2645,長榮航太,22,4,18,富邦-嘉義,2023-07-05,9692
5243,乙盛-KY,18,0,18,富邦-嘉義,2023-07-05,9692
1229,聯華,20,3,17,富邦-嘉義,2023-07-05,9692
3715,定穎投控,419,28,391,富邦-嘉義,2023-07-06,9692
00878,國泰永續高股息,307,42,265,富邦-嘉義,2023-07-06,9692
00665L,富邦�琤肭磪囓�2,217,2,215,富邦-嘉義,2023-07-06,9692
3231,緯創,5880,5690,190,富邦-嘉義,2023-07-06,9692
3701,大眾控,350,178,172,富邦-嘉義,2023-07-06,9692
0056,元大高股息,170,25,145,富邦-嘉義,2023-07-06,9692
00673R,期元大S＆P原油反1,125,0,125,富邦-嘉義,2023-07-06,9692
6546,正基,100,2,98,富邦-嘉義,2023-07-06,9692
2883,凱基金,154,57,97,富邦-嘉義,2023-07-06,9692
4510,高鋒,152,56,96,富邦-嘉義,2023-07-06,9692
2340,台亞,891,802,89,富邦-嘉義,2023-07-06,9692
2402,毅嘉,161,74,87,富邦-嘉義,2023-07-06,9692
2317,鴻海,95,12,83,富邦-嘉義,2023-07-06,9692
2634,漢翔,87,11,76,富邦-嘉義,2023-07-06,9692
2892,第一金,69,1,68,富邦-嘉義,2023-07-06,9692
2889,國票金,65,0,65,富邦-嘉義,2023-07-06,9692
2419,仲琦,254,190,64,富邦-嘉義,2023-07-06,9692
2002,中鋼,76,16,60,富邦-嘉義,2023-07-06,9692
6125,廣運,97,37,60,富邦-嘉義,2023-07-06,9692
4543,萬在,100,46,54,富邦-嘉義,2023-07-06,9692
2468,華經,60,7,53,富邦-嘉義,2023-07-06,9692
2880,華南金,52,0,52,富邦-嘉義,2023-07-06,9692
5439,高技,50,0,50,富邦-嘉義,2023-07-06,9692
6425,易發,50,0,50,富邦-嘉義,2023-07-06,9692
2489,瑞軒,59,11,48,富邦-嘉義,2023-07-06,9692
4533,協易機,72,26,46,富邦-嘉義,2023-07-06,9692
3661,世芯-KY,53,11,42,富邦-嘉義,2023-07-06,9692
00929,復華台灣科技優息,43,2,41,富邦-嘉義,2023-07-06,9692
3037,欣興,52,12,40,富邦-嘉義,2023-07-06,9692
1326,台化,38,4,34,富邦-嘉義,2023-07-06,9692
2449,京元電子,36,2,34,富邦-嘉義,2023-07-06,9692
8215,明基材,73,40,33,富邦-嘉義,2023-07-06,9692
2884,玉山金,47,14,33,富邦-嘉義,2023-07-06,9692
00637L,元大滬深300正2,35,2,33,富邦-嘉義,2023-07-06,9692
6770,力積電,34,3,31,富邦-嘉義,2023-07-06,9692
1301,台塑,31,0,31,富邦-嘉義,2023-07-06,9692
2887,台新金,50,20,30,富邦-嘉義,2023-07-06,9692
6126,信音,45,15,30,富邦-嘉義,2023-07-06,9692
2409,友達,1369,1342,27,富邦-嘉義,2023-07-06,9692
2354,鴻準,27,0,27,富邦-嘉義,2023-07-06,9692
1101,台泥,35,9,26,富邦-嘉義,2023-07-06,9692
2891,中信金,32,6,26,富邦-嘉義,2023-07-06,9692
1904,正隆,31,5,26,富邦-嘉義,2023-07-06,9692
6282,康舒,131,106,25,富邦-嘉義,2023-07-06,9692
2881,富邦金,29,4,25,富邦-嘉義,2023-07-06,9692
00712,復華富時不動產,38,13,25,富邦-嘉義,2023-07-06,9692
2303,聯電,28,3,25,富邦-嘉義,2023-07-06,9692
5009,榮剛,60,35,25,富邦-嘉義,2023-07-06,9692
8110,華東,25,1,24,富邦-嘉義,2023-07-06,9692
2834,臺企銀,24,0,24,富邦-嘉義,2023-07-06,9692
00673R,期元大S＆P原油反1,461,0,461,富邦-嘉義,2023-07-07,9692
4155,訊映,355,1,354,富邦-嘉義,2023-07-07,9692
2801,彰銀,145,0,145,富邦-嘉義,2023-07-07,9692
6122,擎邦,130,18,112,富邦-嘉義,2023-07-07,9692
00632R,元大台灣50反1,146,35,111,富邦-嘉義,2023-07-07,9692
2897,王道銀行,100,0,100,富邦-嘉義,2023-07-07,9692
00878,國泰永續高股息,119,23,96,富邦-嘉義,2023-07-07,9692
2323,中環,93,2,91,富邦-嘉義,2023-07-07,9692
6120,達運,249,166,83,富邦-嘉義,2023-07-07,9692
4979,華星光,387,320,67,富邦-嘉義,2023-07-07,9692
00679B,元大美債20年,65,2,63,富邦-嘉義,2023-07-07,9692
6470,宇智,93,33,60,富邦-嘉義,2023-07-07,9692
00929,復華台灣科技優息,66,6,60,富邦-嘉義,2023-07-07,9692
3481,群創,74,15,59,富邦-嘉義,2023-07-07,9692
6282,康舒,297,241,56,富邦-嘉義,2023-07-07,9692
2887,台新金,51,1,50,富邦-嘉義,2023-07-07,9692
6425,易發,46,0,46,富邦-嘉義,2023-07-07,9692
2845,遠東銀,45,2,43,富邦-嘉義,2023-07-07,9692
2892,第一金,44,2,42,富邦-嘉義,2023-07-07,9692
2609,陽明,69,27,42,富邦-嘉義,2023-07-07,9692
2603,長榮,59,17,42,富邦-嘉義,2023-07-07,9692
2881,富邦金,42,1,41,富邦-嘉義,2023-07-07,9692
2405,輔信,38,0,38,富邦-嘉義,2023-07-07,9692
2382,廣達,180,143,37,富邦-嘉義,2023-07-07,9692
2356,英業達,137,101,36,富邦-嘉義,2023-07-07,9692
2880,華南金,34,0,34,富邦-嘉義,2023-07-07,9692
1301,台塑,29,0,29,富邦-嘉義,2023-07-07,9692
00772B,中信高評級公司債,28,2,26,富邦-嘉義,2023-07-07,9692
8358,金居,28,3,25,富邦-嘉義,2023-07-07,9692
2886,兆豐金,28,4,24,富邦-嘉義,2023-07-07,9692
3071,協禧,61,38,23,富邦-嘉義,2023-07-07,9692
3062,建漢,23,0,23,富邦-嘉義,2023-07-07,9692
4763,材料-KY,24,1,23,富邦-嘉義,2023-07-07,9692
2449,京元電子,43,21,22,富邦-嘉義,2023-07-07,9692
2002,中鋼,22,0,22,富邦-嘉義,2023-07-07,9692
6443,元晶,25,3,22,富邦-嘉義,2023-07-07,9692
00897,富邦基因免疫生技,21,0,21,富邦-嘉義,2023-07-07,9692
2888,新光金,22,2,20,富邦-嘉義,2023-07-07,9692
1810,和成,20,0,20,富邦-嘉義,2023-07-07,9692
1503,士電,21,1,20,富邦-嘉義,2023-07-07,9692
5512,力麒,20,0,20,富邦-嘉義,2023-07-07,9692
3441,聯一光,20,0,20,富邦-嘉義,2023-07-07,9692
4162,智擎,21,1,20,富邦-嘉義,2023-07-07,9692
8933,愛地雅,20,0,20,富邦-嘉義,2023-07-07,9692
2344,華邦電,44,25,19,富邦-嘉義,2023-07-07,9692
8076,伍豐,24,5,19,富邦-嘉義,2023-07-07,9692
1467,南緯,19,0,19,富邦-嘉義,2023-07-07,9692
1514,亞力,25,6,19,富邦-嘉義,2023-07-07,9692
4532,瑞智,329,310,19,富邦-嘉義,2023-07-07,9692
1326,台化,21,3,18,富邦-嘉義,2023-07-07,9692
3231,緯創,2191,1801,390,富邦-嘉義,2023-07-10,9692
4533,協易機,482,177,305,富邦-嘉義,2023-07-10,9692
00673R,期元大S＆P原油反1,271,0,271,富邦-嘉義,2023-07-10,9692
2376,技嘉,800,551,249,富邦-嘉義,2023-07-10,9692
4526,東台,275,62,213,富邦-嘉義,2023-07-10,9692
1519,華城,231,24,207,富邦-嘉義,2023-07-10,9692
3035,智原,223,31,192,富邦-嘉義,2023-07-10,9692
00902,中信電池及儲能,200,12,188,富邦-嘉義,2023-07-10,9692
2883,凱基金,193,30,163,富邦-嘉義,2023-07-10,9692
1604,聲寶,340,218,122,富邦-嘉義,2023-07-10,9692
1618,合機,159,42,117,富邦-嘉義,2023-07-10,9692
4510,高鋒,221,108,113,富邦-嘉義,2023-07-10,9692
00885,富邦越南,107,3,104,富邦-嘉義,2023-07-10,9692
6120,達運,282,182,100,富邦-嘉義,2023-07-10,9692
00679B,元大美債20年,87,0,87,富邦-嘉義,2023-07-10,9692
2884,玉山金,71,1,70,富邦-嘉義,2023-07-10,9692
1785,光洋科,87,19,68,富邦-嘉義,2023-07-10,9692
3014,聯陽,70,3,67,富邦-嘉義,2023-07-10,9692
2618,長榮航,70,8,62,富邦-嘉義,2023-07-10,9692
2609,陽明,139,78,61,富邦-嘉義,2023-07-10,9692
2382,廣達,459,398,61,富邦-嘉義,2023-07-10,9692
4532,瑞智,153,92,61,富邦-嘉義,2023-07-10,9692
2356,英業達,80,23,57,富邦-嘉義,2023-07-10,9692
4934,太極,219,166,53,富邦-嘉義,2023-07-10,9692
2913,農林,56,3,53,富邦-嘉義,2023-07-10,9692
2419,仲琦,158,110,48,富邦-嘉義,2023-07-10,9692
2634,漢翔,60,14,46,富邦-嘉義,2023-07-10,9692
6770,力積電,42,2,40,富邦-嘉義,2023-07-10,9692
2887,台新金,42,3,39,富邦-嘉義,2023-07-10,9692
5258,虹堡,50,14,36,富邦-嘉義,2023-07-10,9692
6111,大宇資,41,8,33,富邦-嘉義,2023-07-10,9692
3576,聯合再生,32,0,32,富邦-嘉義,2023-07-10,9692
3234,光環,34,3,31,富邦-嘉義,2023-07-10,9692
2489,瑞軒,31,0,31,富邦-嘉義,2023-07-10,9692
00882,中信中國高股息,32,2,30,富邦-嘉義,2023-07-10,9692
3346,麗清,47,17,30,富邦-嘉義,2023-07-10,9692
2371,大同,62,33,29,富邦-嘉義,2023-07-10,9692
6425,易發,28,0,28,富邦-嘉義,2023-07-10,9692
00687B,國泰20年美債,26,0,26,富邦-嘉義,2023-07-10,9692
3025,星通,191,166,25,富邦-嘉義,2023-07-10,9692
1101,台泥,25,0,25,富邦-嘉義,2023-07-10,9692
00929,復華台灣科技優息,31,7,24,富邦-嘉義,2023-07-10,9692
2886,兆豐金,25,1,24,富邦-嘉義,2023-07-10,9692
2633,台灣高鐵,29,5,24,富邦-嘉義,2023-07-10,9692
3019,亞光,24,1,23,富邦-嘉義,2023-07-10,9692
2880,華南金,25,2,23,富邦-嘉義,2023-07-10,9692
3022,威強電,23,1,22,富邦-嘉義,2023-07-10,9692
2834,臺企銀,31,9,22,富邦-嘉義,2023-07-10,9692
00919,群益台灣精選高息,33,12,21,富邦-嘉義,2023-07-10,9692
1802,台玻,24,3,21,富邦-嘉義,2023-07-10,9692
3231,緯創,4554,3503,1051,富邦-嘉義,2023-07-11,9692
2382,廣達,3911,3471,440,富邦-嘉義,2023-07-11,9692
1618,合機,575,303,272,富邦-嘉義,2023-07-11,9692
2356,英業達,849,695,154,富邦-嘉義,2023-07-11,9692
2301,光寶科,508,399,109,富邦-嘉義,2023-07-11,9692
2481,強茂,211,113,98,富邦-嘉義,2023-07-11,9692
5258,虹堡,155,58,97,富邦-嘉義,2023-07-11,9692
3515,華擎,170,81,89,富邦-嘉義,2023-07-11,9692
1314,中石化,87,3,84,富邦-嘉義,2023-07-11,9692
3362,先進光,109,29,80,富邦-嘉義,2023-07-11,9692
00673R,期元大S＆P原油反1,78,0,78,富邦-嘉義,2023-07-11,9692
2388,威盛,1140,1067,73,富邦-嘉義,2023-07-11,9692
6669,緯穎,119,50,69,富邦-嘉義,2023-07-11,9692
4967,十銓,75,12,63,富邦-嘉義,2023-07-11,9692
8092,建暐,63,2,61,富邦-嘉義,2023-07-11,9692
5864,致和證,51,0,51,富邦-嘉義,2023-07-11,9692
5465,富驊,49,1,48,富邦-嘉義,2023-07-11,9692
3057,喬鼎,47,0,47,富邦-嘉義,2023-07-11,9692
2486,一詮,468,422,46,富邦-嘉義,2023-07-11,9692
2867,三商壽,54,10,44,富邦-嘉義,2023-07-11,9692
6282,康舒,72,28,44,富邦-嘉義,2023-07-11,9692
00679B,元大美債20年,44,1,43,富邦-嘉義,2023-07-11,9692
3706,神達,206,164,42,富邦-嘉義,2023-07-11,9692
1734,杏輝,42,1,41,富邦-嘉義,2023-07-11,9692
2365,昆盈,91,53,38,富邦-嘉義,2023-07-11,9692
1905,華紙,55,21,34,富邦-嘉義,2023-07-11,9692
2609,陽明,57,24,33,富邦-嘉義,2023-07-11,9692
5234,達興材料,51,20,31,富邦-嘉義,2023-07-11,9692
3501,維熹,30,0,30,富邦-嘉義,2023-07-11,9692
2399,映泰,100,70,30,富邦-嘉義,2023-07-11,9692
1101,台泥,34,4,30,富邦-嘉義,2023-07-11,9692
3313,斐成,30,1,29,富邦-嘉義,2023-07-11,9692
6117,迎廣,30,1,29,富邦-嘉義,2023-07-11,9692
1301,台塑,26,0,26,富邦-嘉義,2023-07-11,9692
2812,台中銀,32,7,25,富邦-嘉義,2023-07-11,9692
2312,金寶,252,228,24,富邦-嘉義,2023-07-11,9692
3707,漢磊,51,29,22,富邦-嘉義,2023-07-11,9692
3289,宜特,48,26,22,富邦-嘉義,2023-07-11,9692
2371,大同,80,59,21,富邦-嘉義,2023-07-11,9692
2363,矽統,21,0,21,富邦-嘉義,2023-07-11,9692
1720,生達,21,0,21,富邦-嘉義,2023-07-11,9692
6152,百一,20,0,20,富邦-嘉義,2023-07-11,9692
2606,裕民,20,0,20,富邦-嘉義,2023-07-11,9692
020020,元大台股領航N,20,0,20,富邦-嘉義,2023-07-11,9692
9945,潤泰新,20,1,19,富邦-嘉義,2023-07-11,9692
3265,台星科,23,4,19,富邦-嘉義,2023-07-11,9692
6147,頎邦,20,1,19,富邦-嘉義,2023-07-11,9692
00720B,元大投資級公司債,18,0,18,富邦-嘉義,2023-07-11,9692
8096,擎亞,20,2,18,富邦-嘉義,2023-07-11,9692
4164,承業醫,22,5,17,富邦-嘉義,2023-07-11,9692
2388,威盛,2238,1093,1145,富邦-嘉義,2023-07-12,9692
3706,神達,3020,2335,685,富邦-嘉義,2023-07-12,9692
3231,緯創,7164,6546,618,富邦-嘉義,2023-07-12,9692
00632R,元大台灣50反1,262,25,237,富邦-嘉義,2023-07-12,9692
2618,長榮航,354,126,228,富邦-嘉義,2023-07-12,9692
1609,大亞,341,152,189,富邦-嘉義,2023-07-12,9692
2883,凱基金,202,28,174,富邦-嘉義,2023-07-12,9692
2323,中環,333,201,132,富邦-嘉義,2023-07-12,9692
00679B,元大美債20年,123,0,123,富邦-嘉義,2023-07-12,9692
2376,技嘉,835,730,105,富邦-嘉義,2023-07-12,9692
3049,精金,100,1,99,富邦-嘉義,2023-07-12,9692
8210,勤誠,223,137,86,富邦-嘉義,2023-07-12,9692
2371,大同,90,12,78,富邦-嘉義,2023-07-12,9692
1108,幸福,63,0,63,富邦-嘉義,2023-07-12,9692
3363,上詮,155,94,61,富邦-嘉義,2023-07-12,9692
6120,達運,222,166,56,富邦-嘉義,2023-07-12,9692
00905,FT臺灣Smart,55,0,55,富邦-嘉義,2023-07-12,9692
6274,台燿,87,32,55,富邦-嘉義,2023-07-12,9692
4934,太極,72,19,53,富邦-嘉義,2023-07-12,9692
1101,台泥,51,6,45,富邦-嘉義,2023-07-12,9692
1513,中興電,192,148,44,富邦-嘉義,2023-07-12,9692
5864,致和證,50,7,43,富邦-嘉義,2023-07-12,9692
2303,聯電,60,17,43,富邦-嘉義,2023-07-12,9692
2486,一詮,91,49,42,富邦-嘉義,2023-07-12,9692
00715L,期街口布蘭特正2,53,12,41,富邦-嘉義,2023-07-12,9692
2634,漢翔,41,2,39,富邦-嘉義,2023-07-12,9692
6829,千附精密,38,1,37,富邦-嘉義,2023-07-12,9692
00882,中信中國高股息,36,0,36,富邦-嘉義,2023-07-12,9692
2610,華航,197,162,35,富邦-嘉義,2023-07-12,9692
1734,杏輝,32,0,32,富邦-嘉義,2023-07-12,9692
00772B,中信高評級公司債,31,0,31,富邦-嘉義,2023-07-12,9692
00687B,國泰20年美債,31,0,31,富邦-嘉義,2023-07-12,9692
2887,台新金,30,0,30,富邦-嘉義,2023-07-12,9692
2834,臺企銀,49,20,29,富邦-嘉義,2023-07-12,9692
6285,啟��,43,14,29,富邦-嘉義,2023-07-12,9692
8155,博智,48,21,27,富邦-嘉義,2023-07-12,9692
2882,國泰金,42,15,27,富邦-嘉義,2023-07-12,9692
1503,士電,418,392,26,富邦-嘉義,2023-07-12,9692
2609,陽明,100,75,25,富邦-嘉義,2023-07-12,9692
3322,建舜電,27,2,25,富邦-嘉義,2023-07-12,9692
2515,中工,30,5,25,富邦-嘉義,2023-07-12,9692
4564,元翎,49,25,24,富邦-嘉義,2023-07-12,9692
3205,佰研,24,1,23,富邦-嘉義,2023-07-12,9692
2419,仲琦,54,33,21,富邦-嘉義,2023-07-12,9692
3234,光環,36,15,21,富邦-嘉義,2023-07-12,9692
2851,中再保,20,0,20,富邦-嘉義,2023-07-12,9692
00712,復華富時不動產,30,11,19,富邦-嘉義,2023-07-12,9692
3024,憶聲,20,1,19,富邦-嘉義,2023-07-12,9692
2913,農林,20,1,19,富邦-嘉義,2023-07-12,9692
00919,群益台灣精選高息,22,3,19,富邦-嘉義,2023-07-12,9692
2201,裕隆,315,15,300,富邦-嘉義,2023-07-13,9692
2356,英業達,3023,2729,294,富邦-嘉義,2023-07-13,9692
00882,中信中國高股息,170,4,166,富邦-嘉義,2023-07-13,9692
00673R,期元大S＆P原油反1,121,0,121,富邦-嘉義,2023-07-13,9692
2027,大成鋼,108,11,97,富邦-嘉義,2023-07-13,9692
2515,中工,130,42,88,富邦-嘉義,2023-07-13,9692
3483,力致,100,13,87,富邦-嘉義,2023-07-13,9692
2610,華航,281,201,80,富邦-嘉義,2023-07-13,9692
8028,昇陽半導體,211,144,67,富邦-嘉義,2023-07-13,9692
00929,復華台灣科技優息,91,26,65,富邦-嘉義,2023-07-13,9692
3013,晟銘電,503,440,63,富邦-嘉義,2023-07-13,9692
5457,宣德,79,23,56,富邦-嘉義,2023-07-13,9692
1101,台泥,62,6,56,富邦-嘉義,2023-07-13,9692
5388,中磊,90,40,50,富邦-嘉義,2023-07-13,9692
2913,農林,50,1,49,富邦-嘉義,2023-07-13,9692
2371,大同,119,74,45,富邦-嘉義,2023-07-13,9692
4533,協易機,74,30,44,富邦-嘉義,2023-07-13,9692
00857B,永豐20年美公債,41,0,41,富邦-嘉義,2023-07-13,9692
020020,元大台股領航N,40,0,40,富邦-嘉義,2023-07-13,9692
8131,福懋科,40,0,40,富邦-嘉義,2023-07-13,9692
6538,倉和,45,5,40,富邦-嘉義,2023-07-13,9692
2609,陽明,135,97,38,富邦-嘉義,2023-07-13,9692
3515,華擎,123,87,36,富邦-嘉義,2023-07-13,9692
00715L,期街口布蘭特正2,81,48,33,富邦-嘉義,2023-07-13,9692
3617,碩天,49,16,33,富邦-嘉義,2023-07-13,9692
9958,世紀鋼,52,20,32,富邦-嘉義,2023-07-13,9692
6188,廣明,787,755,32,富邦-嘉義,2023-07-13,9692
3234,光環,41,14,27,富邦-嘉義,2023-07-13,9692
1905,華紙,31,4,27,富邦-嘉義,2023-07-13,9692
1519,華城,76,50,26,富邦-嘉義,2023-07-13,9692
2601,益航,27,2,25,富邦-嘉義,2023-07-13,9692
1514,亞力,26,1,25,富邦-嘉義,2023-07-13,9692
4934,太極,104,81,23,富邦-嘉義,2023-07-13,9692
3019,亞光,27,4,23,富邦-嘉義,2023-07-13,9692
00687B,國泰20年美債,22,0,22,富邦-嘉義,2023-07-13,9692
1301,台塑,26,5,21,富邦-嘉義,2023-07-13,9692
8050,廣積,52,31,21,富邦-嘉義,2023-07-13,9692
4743,合一,79,59,20,富邦-嘉義,2023-07-13,9692
8070,長華*,21,1,20,富邦-嘉義,2023-07-13,9692
2495,普安,20,0,20,富邦-嘉義,2023-07-13,9692
00733,富邦臺灣中小,20,1,19,富邦-嘉義,2023-07-13,9692
1618,合機,22,3,19,富邦-嘉義,2023-07-13,9692
5905,南仁湖,19,0,19,富邦-嘉義,2023-07-13,9692
2402,毅嘉,24,6,18,富邦-嘉義,2023-07-13,9692
1460,宏遠,18,0,18,富邦-嘉義,2023-07-13,9692
2362,藍天,18,0,18,富邦-嘉義,2023-07-13,9692
2455,全新,19,1,18,富邦-嘉義,2023-07-13,9692
6111,大宇資,65,48,17,富邦-嘉義,2023-07-13,9692
3363,上詮,547,531,16,富邦-嘉義,2023-07-13,9692
2421,建準,50,34,16,富邦-嘉義,2023-07-13,9692
2388,威盛,1949,1039,910,富邦-嘉義,2023-07-14,9692
2356,英業達,4201,3705,496,富邦-嘉義,2023-07-14,9692
2419,仲琦,975,632,343,富邦-嘉義,2023-07-14,9692
00706L,期元大S＆P日圓正2,284,0,284,富邦-嘉義,2023-07-14,9692
3715,定穎投控,429,219,210,富邦-嘉義,2023-07-14,9692
1503,士電,446,291,155,富邦-嘉義,2023-07-14,9692
8050,廣積,501,355,146,富邦-嘉義,2023-07-14,9692
00712,復華富時不動產,145,7,138,富邦-嘉義,2023-07-14,9692
1519,華城,371,245,126,富邦-嘉義,2023-07-14,9692
2618,長榮航,469,345,124,富邦-嘉義,2023-07-14,9692
3583,辛耘,198,84,114,富邦-嘉義,2023-07-14,9692
00929,復華台灣科技優息,140,28,112,富邦-嘉義,2023-07-14,9692
3013,晟銘電,308,204,104,富邦-嘉義,2023-07-14,9692
2329,華泰,375,274,101,富邦-嘉義,2023-07-14,9692
1513,中興電,417,317,100,富邦-嘉義,2023-07-14,9692
6016,康和證,120,20,100,富邦-嘉義,2023-07-14,9692
2610,華航,260,163,97,富邦-嘉義,2023-07-14,9692
3035,智原,340,256,84,富邦-嘉義,2023-07-14,9692
3305,昇貿,122,45,77,富邦-嘉義,2023-07-14,9692
5258,虹堡,345,276,69,富邦-嘉義,2023-07-14,9692
2204,中華,58,1,57,富邦-嘉義,2023-07-14,9692
00673R,期元大S＆P原油反1,258,204,54,富邦-嘉義,2023-07-14,9692
6669,緯穎,222,171,51,富邦-嘉義,2023-07-14,9692
6841,長佳智能,55,4,51,富邦-嘉義,2023-07-14,9692
3379,彬台,51,0,51,富邦-嘉義,2023-07-14,9692
3443,創意,197,148,49,富邦-嘉義,2023-07-14,9692
1560,中砂,65,17,48,富邦-嘉義,2023-07-14,9692
6187,萬潤,97,49,48,富邦-嘉義,2023-07-14,9692
3338,泰碩,184,138,46,富邦-嘉義,2023-07-14,9692
00888,永豐台灣ESG,38,0,38,富邦-嘉義,2023-07-14,9692
3704,合勤控,517,482,35,富邦-嘉義,2023-07-14,9692
3032,偉訓,52,17,35,富邦-嘉義,2023-07-14,9692
8131,福懋科,35,1,34,富邦-嘉義,2023-07-14,9692
2359,所羅門,427,397,30,富邦-嘉義,2023-07-14,9692
00637L,元大滬深300正2,34,4,30,富邦-嘉義,2023-07-14,9692
6150,撼訊,43,14,29,富邦-嘉義,2023-07-14,9692
1313,聯成,29,0,29,富邦-嘉義,2023-07-14,9692
2324,仁寶,101,74,27,富邦-嘉義,2023-07-14,9692
00753L,中信中國50正2,91,65,26,富邦-嘉義,2023-07-14,9692
2027,大成鋼,26,0,26,富邦-嘉義,2023-07-14,9692
3285,微端,25,0,25,富邦-嘉義,2023-07-14,9692
00919,群益台灣精選高息,50,25,25,富邦-嘉義,2023-07-14,9692
2352,佳世達,246,222,24,富邦-嘉義,2023-07-14,9692
4414,如興,22,0,22,富邦-嘉義,2023-07-14,9692
6127,九豪,22,0,22,富邦-嘉義,2023-07-14,9692
2367,燿華,21,0,21,富邦-嘉義,2023-07-14,9692
2515,中工,32,12,20,富邦-嘉義,2023-07-14,9692
2537,聯上發,20,0,20,富邦-嘉義,2023-07-14,9692
4564,元翎,22,2,20,富邦-嘉義,2023-07-14,9692
6120,達運,48,28,20,富邦-嘉義,2023-07-14,9692
2356,英業達,1885,1218,667,富邦-嘉義,2023-07-17,9692
2353,宏��,1227,759,468,富邦-嘉義,2023-07-17,9692
3071,協禧,407,11,396,富邦-嘉義,2023-07-17,9692
6188,廣明,450,68,382,富邦-嘉義,2023-07-17,9692
3363,上詮,405,83,322,富邦-嘉義,2023-07-17,9692
4908,前鼎,312,7,305,富邦-嘉義,2023-07-17,9692
4938,和碩,607,394,213,富邦-嘉義,2023-07-17,9692
2312,金寶,1195,993,202,富邦-嘉義,2023-07-17,9692
4743,合一,189,8,181,富邦-嘉義,2023-07-17,9692
6414,樺漢,202,43,159,富邦-嘉義,2023-07-17,9692
2352,佳世達,653,496,157,富邦-嘉義,2023-07-17,9692
00673R,期元大S＆P原油反1,251,94,157,富邦-嘉義,2023-07-17,9692
00929,復華台灣科技優息,156,5,151,富邦-嘉義,2023-07-17,9692
6274,台燿,187,61,126,富邦-嘉義,2023-07-17,9692
00712,復華富時不動產,112,0,112,富邦-嘉義,2023-07-17,9692
2344,華邦電,143,31,112,富邦-嘉義,2023-07-17,9692
1314,中石化,108,1,107,富邦-嘉義,2023-07-17,9692
2421,建準,159,58,101,富邦-嘉義,2023-07-17,9692
6016,康和證,100,0,100,富邦-嘉義,2023-07-17,9692
6470,宇智,449,349,100,富邦-嘉義,2023-07-17,9692
2883,凱基金,149,51,98,富邦-嘉義,2023-07-17,9692
2328,廣宇,115,24,91,富邦-嘉義,2023-07-17,9692
0056,元大高股息,208,118,90,富邦-嘉義,2023-07-17,9692
2388,威盛,441,354,87,富邦-嘉義,2023-07-17,9692
4746,台耀,109,25,84,富邦-嘉義,2023-07-17,9692
6282,康舒,1079,996,83,富邦-嘉義,2023-07-17,9692
3362,先進光,319,240,79,富邦-嘉義,2023-07-17,9692
1789,神隆,202,124,78,富邦-嘉義,2023-07-17,9692
00633L,富邦上証正2,64,5,59,富邦-嘉義,2023-07-17,9692
3078,僑威,203,147,56,富邦-嘉義,2023-07-17,9692
00885,富邦越南,57,4,53,富邦-嘉義,2023-07-17,9692
1529,樂事綠能,185,132,53,富邦-嘉義,2023-07-17,9692
5328,華容,76,23,53,富邦-嘉義,2023-07-17,9692
2371,大同,1036,983,53,富邦-嘉義,2023-07-17,9692
2340,台亞,220,169,51,富邦-嘉義,2023-07-17,9692
2482,連宇,50,2,48,富邦-嘉義,2023-07-17,9692
6290,良維,127,79,48,富邦-嘉義,2023-07-17,9692
4123,晟德,273,226,47,富邦-嘉義,2023-07-17,9692
6276,安鈦克,54,15,39,富邦-嘉義,2023-07-17,9692
5302,太欣,35,0,35,富邦-嘉義,2023-07-17,9692
00919,群益台灣精選高息,45,11,34,富邦-嘉義,2023-07-17,9692
1402,遠東新,32,0,32,富邦-嘉義,2023-07-17,9692
6446,藥華藥,37,5,32,富邦-嘉義,2023-07-17,9692
3163,波若威,728,697,31,富邦-嘉義,2023-07-17,9692
4414,如興,30,0,30,富邦-嘉義,2023-07-17,9692
8933,愛地雅,35,5,30,富邦-嘉義,2023-07-17,9692
00891,中信關鍵半導體,33,4,29,富邦-嘉義,2023-07-17,9692
6235,華孚,32,3,29,富邦-嘉義,2023-07-17,9692
1219,福壽,28,0,28,富邦-嘉義,2023-07-17,9692
3711,日月光投控,28,0,28,富邦-嘉義,2023-07-17,9692
3231,緯創,1153,251,902,富邦-嘉義,2023-07-18,9692
2421,建準,1731,1359,372,富邦-嘉義,2023-07-18,9692
2312,金寶,6988,6641,347,富邦-嘉義,2023-07-18,9692
2329,華泰,1937,1671,266,富邦-嘉義,2023-07-18,9692
2324,仁寶,1529,1281,248,富邦-嘉義,2023-07-18,9692
2515,中工,275,28,247,富邦-嘉義,2023-07-18,9692
3037,欣興,1211,1014,197,富邦-嘉義,2023-07-18,9692
2399,映泰,564,374,190,富邦-嘉義,2023-07-18,9692
00632R,元大台灣50反1,214,26,188,富邦-嘉義,2023-07-18,9692
1584,精剛,200,14,186,富邦-嘉義,2023-07-18,9692
00712,復華富時不動產,186,5,181,富邦-嘉義,2023-07-18,9692
5469,瀚宇博,185,11,174,富邦-嘉義,2023-07-18,9692
00882,中信中國高股息,143,0,143,富邦-嘉義,2023-07-18,9692
2382,廣達,2777,2644,133,富邦-嘉義,2023-07-18,9692
6124,業強,126,14,112,富邦-嘉義,2023-07-18,9692
6470,宇智,152,47,105,富邦-嘉義,2023-07-18,9692
00929,復華台灣科技優息,144,45,99,富邦-嘉義,2023-07-18,9692
6126,信音,96,2,94,富邦-嘉義,2023-07-18,9692
9105,泰金寶-DR,201,113,88,富邦-嘉義,2023-07-18,9692
3052,夆典,80,0,80,富邦-嘉義,2023-07-18,9692
1609,大亞,116,51,65,富邦-嘉義,2023-07-18,9692
3005,神基,74,11,63,富邦-嘉義,2023-07-18,9692
1591,駿吉-KY,134,78,56,富邦-嘉義,2023-07-18,9692
2388,威盛,103,47,56,富邦-嘉義,2023-07-18,9692
2481,強茂,115,64,51,富邦-嘉義,2023-07-18,9692
2812,台中銀,70,25,45,富邦-嘉義,2023-07-18,9692
00715L,期街口布蘭特正2,55,10,45,富邦-嘉義,2023-07-18,9692
3494,誠研,49,6,43,富邦-嘉義,2023-07-18,9692
8176,智捷,47,4,43,富邦-嘉義,2023-07-18,9692
00900,富邦特選高股息30,50,9,41,富邦-嘉義,2023-07-18,9692
2359,所羅門,42,5,37,富邦-嘉義,2023-07-18,9692
1560,中砂,49,13,36,富邦-嘉義,2023-07-18,9692
8076,伍豐,43,11,32,富邦-嘉義,2023-07-18,9692
6150,撼訊,54,23,31,富邦-嘉義,2023-07-18,9692
1513,中興電,94,63,31,富邦-嘉義,2023-07-18,9692
3379,彬台,30,0,30,富邦-嘉義,2023-07-18,9692
6546,正基,34,4,30,富邦-嘉義,2023-07-18,9692
1514,亞力,47,19,28,富邦-嘉義,2023-07-18,9692
6197,佳必琪,32,4,28,富邦-嘉義,2023-07-18,9692
4768,晶呈科技,56,30,26,富邦-嘉義,2023-07-18,9692
2059,川湖,43,17,26,富邦-嘉義,2023-07-18,9692
2027,大成鋼,36,11,25,富邦-嘉義,2023-07-18,9692
8155,博智,79,55,24,富邦-嘉義,2023-07-18,9692
3540,曜越,33,9,24,富邦-嘉義,2023-07-18,9692
3057,喬鼎,31,8,23,富邦-嘉義,2023-07-18,9692
8996,高力,30,8,22,富邦-嘉義,2023-07-18,9692
8028,昇陽半導體,27,5,22,富邦-嘉義,2023-07-18,9692
9907,統一實,20,0,20,富邦-嘉義,2023-07-18,9692
5302,太欣,20,0,20,富邦-嘉義,2023-07-18,9692
2332,友訊,20,2,18,富邦-嘉義,2023-07-18,9692
4123,晟德,741,422,319,富邦-嘉義,2023-07-19,9692
4908,前鼎,303,30,273,富邦-嘉義,2023-07-19,9692
2352,佳世達,259,82,177,富邦-嘉義,2023-07-19,9692
2353,宏��,302,203,99,富邦-嘉義,2023-07-19,9692
1591,駿吉-KY,94,0,94,富邦-嘉義,2023-07-19,9692
4743,合一,102,10,92,富邦-嘉義,2023-07-19,9692
6282,康舒,166,86,80,富邦-嘉義,2023-07-19,9692
3703,欣陸,78,5,73,富邦-嘉義,2023-07-19,9692
6150,撼訊,76,3,73,富邦-嘉義,2023-07-19,9692
00919,群益台灣精選高息,94,23,71,富邦-嘉義,2023-07-19,9692
2618,長榮航,95,27,68,富邦-嘉義,2023-07-19,9692
6125,廣運,132,67,65,富邦-嘉義,2023-07-19,9692
3264,欣銓,87,22,65,富邦-嘉義,2023-07-19,9692
2801,彰銀,62,0,62,富邦-嘉義,2023-07-19,9692
8050,廣積,81,20,61,富邦-嘉義,2023-07-19,9692
2303,聯電,67,7,60,富邦-嘉義,2023-07-19,9692
6451,訊芯-KY,62,3,59,富邦-嘉義,2023-07-19,9692
00900,富邦特選高股息30,75,16,59,富邦-嘉義,2023-07-19,9692
3661,世芯-KY,155,104,51,富邦-嘉義,2023-07-19,9692
00712,復華富時不動產,53,4,49,富邦-嘉義,2023-07-19,9692
2324,仁寶,302,256,46,富邦-嘉義,2023-07-19,9692
6116,彩晶,49,5,44,富邦-嘉義,2023-07-19,9692
6472,保瑞,159,116,43,富邦-嘉義,2023-07-19,9692
2897,王道銀行,41,0,41,富邦-嘉義,2023-07-19,9692
2206,三陽工業,43,2,41,富邦-嘉義,2023-07-19,9692
00929,復華台灣科技優息,66,26,40,富邦-嘉義,2023-07-19,9692
1103,嘉泥,36,0,36,富邦-嘉義,2023-07-19,9692
2388,威盛,144,108,36,富邦-嘉義,2023-07-19,9692
1514,亞力,45,12,33,富邦-嘉義,2023-07-19,9692
3047,訊舟,34,1,33,富邦-嘉義,2023-07-19,9692
6446,藥華藥,81,50,31,富邦-嘉義,2023-07-19,9692
2059,川湖,78,48,30,富邦-嘉義,2023-07-19,9692
2867,三商壽,31,2,29,富邦-嘉義,2023-07-19,9692
1219,福壽,30,1,29,富邦-嘉義,2023-07-19,9692
8996,高力,320,291,29,富邦-嘉義,2023-07-19,9692
6470,宇智,79,51,28,富邦-嘉義,2023-07-19,9692
00632R,元大台灣50反1,106,78,28,富邦-嘉義,2023-07-19,9692
2834,臺企銀,33,6,27,富邦-嘉義,2023-07-19,9692
3013,晟銘電,261,234,27,富邦-嘉義,2023-07-19,9692
2401,凌陽,29,5,24,富邦-嘉義,2023-07-19,9692
2606,裕民,23,0,23,富邦-嘉義,2023-07-19,9692
3071,協禧,36,13,23,富邦-嘉義,2023-07-19,9692
6182,合晶,27,4,23,富邦-嘉義,2023-07-19,9692
2312,金寶,717,695,22,富邦-嘉義,2023-07-19,9692
1471,首利,25,4,21,富邦-嘉義,2023-07-19,9692
8234,新漢,20,0,20,富邦-嘉義,2023-07-19,9692
6016,康和證,20,0,20,富邦-嘉義,2023-07-19,9692
3002,歐格,20,0,20,富邦-嘉義,2023-07-19,9692
1609,大亞,42,22,20,富邦-嘉義,2023-07-19,9692
6811,宏�硌穈T,23,4,19,富邦-嘉義,2023-07-19,9692
2382,廣達,2348,1512,836,富邦-嘉義,2023-07-20,9692
2421,建準,553,121,432,富邦-嘉義,2023-07-20,9692
3013,晟銘電,467,133,334,富邦-嘉義,2023-07-20,9692
00632R,元大台灣50反1,353,100,253,富邦-嘉義,2023-07-20,9692
3231,緯創,498,323,175,富邦-嘉義,2023-07-20,9692
2388,威盛,354,204,150,富邦-嘉義,2023-07-20,9692
2409,友達,123,6,117,富邦-嘉義,2023-07-20,9692
2356,英業達,374,261,113,富邦-嘉義,2023-07-20,9692
2303,聯電,114,13,101,富邦-嘉義,2023-07-20,9692
6139,亞翔,102,1,101,富邦-嘉義,2023-07-20,9692
6274,台燿,458,365,93,富邦-嘉義,2023-07-20,9692
3049,精金,127,50,77,富邦-嘉義,2023-07-20,9692
6158,禾昌,60,1,59,富邦-嘉義,2023-07-20,9692
00900,富邦特選高股息30,68,10,58,富邦-嘉義,2023-07-20,9692
2405,輔信,274,217,57,富邦-嘉義,2023-07-20,9692
5439,高技,52,4,48,富邦-嘉義,2023-07-20,9692
6438,迅得,46,0,46,富邦-嘉義,2023-07-20,9692
2301,光寶科,184,139,45,富邦-嘉義,2023-07-20,9692
3035,智原,107,64,43,富邦-嘉義,2023-07-20,9692
00929,復華台灣科技優息,60,21,39,富邦-嘉義,2023-07-20,9692
6125,廣運,71,32,39,富邦-嘉義,2023-07-20,9692
2634,漢翔,67,29,38,富邦-嘉義,2023-07-20,9692
1219,福壽,35,0,35,富邦-嘉義,2023-07-20,9692
3481,群創,78,45,33,富邦-嘉義,2023-07-20,9692
3583,辛耘,156,124,32,富邦-嘉義,2023-07-20,9692
5864,致和證,30,0,30,富邦-嘉義,2023-07-20,9692
4953,緯軟,418,388,30,富邦-嘉義,2023-07-20,9692
4906,正文,50,21,29,富邦-嘉義,2023-07-20,9692
00712,復華富時不動產,39,10,29,富邦-嘉義,2023-07-20,9692
2206,三陽工業,75,47,28,富邦-嘉義,2023-07-20,9692
1444,力麗,28,1,27,富邦-嘉義,2023-07-20,9692
3704,合勤控,29,3,26,富邦-嘉義,2023-07-20,9692
3205,佰研,28,3,25,富邦-嘉義,2023-07-20,9692
6874,倍力,25,0,25,富邦-嘉義,2023-07-20,9692
1529,樂事綠能,111,87,24,富邦-嘉義,2023-07-20,9692
6235,華孚,27,5,22,富邦-嘉義,2023-07-20,9692
2609,陽明,75,53,22,富邦-嘉義,2023-07-20,9692
6669,緯穎,77,55,22,富邦-嘉義,2023-07-20,9692
1102,亞泥,22,0,22,富邦-嘉義,2023-07-20,9692
8210,勤誠,121,100,21,富邦-嘉義,2023-07-20,9692
2329,華泰,86,65,21,富邦-嘉義,2023-07-20,9692
2485,兆赫,20,0,20,富邦-嘉義,2023-07-20,9692
00633L,富邦上証正2,20,0,20,富邦-嘉義,2023-07-20,9692
6753,龍德造船,21,2,19,富邦-嘉義,2023-07-20,9692
1522,堤維西,19,0,19,富邦-嘉義,2023-07-20,9692
1519,華城,18,0,18,富邦-嘉義,2023-07-20,9692
2436,偉詮電,219,201,18,富邦-嘉義,2023-07-20,9692
1789,神隆,50,33,17,富邦-嘉義,2023-07-20,9692
2630,亞航,89,73,16,富邦-嘉義,2023-07-20,9692
5706,鳳凰,18,2,16,富邦-嘉義,2023-07-20,9692
3338,泰碩,1137,668,469,富邦-嘉義,2023-07-21,9692
3483,力致,280,6,274,富邦-嘉義,2023-07-21,9692
2316,楠梓電,582,390,192,富邦-嘉義,2023-07-21,9692
2357,華碩,332,176,156,富邦-嘉義,2023-07-21,9692
2405,輔信,135,3,132,富邦-嘉義,2023-07-21,9692
2388,威盛,366,237,129,富邦-嘉義,2023-07-21,9692
00715L,期街口布蘭特正2,121,11,110,富邦-嘉義,2023-07-21,9692
3035,智原,997,889,108,富邦-嘉義,2023-07-21,9692
00712,復華富時不動產,116,10,106,富邦-嘉義,2023-07-21,9692
3017,奇鋐,569,464,105,富邦-嘉義,2023-07-21,9692
00664R,國泰臺灣加權反1,100,0,100,富邦-嘉義,2023-07-21,9692
1101,台泥,88,3,85,富邦-嘉義,2023-07-21,9692
2027,大成鋼,82,5,77,富邦-嘉義,2023-07-21,9692
1513,中興電,1023,951,72,富邦-嘉義,2023-07-21,9692
1903,士紙,112,40,72,富邦-嘉義,2023-07-21,9692
6125,廣運,176,105,71,富邦-嘉義,2023-07-21,9692
2344,華邦電,86,19,67,富邦-嘉義,2023-07-21,9692
00929,復華台灣科技優息,75,12,63,富邦-嘉義,2023-07-21,9692
2206,三陽工業,62,6,56,富邦-嘉義,2023-07-21,9692
2801,彰銀,53,1,52,富邦-嘉義,2023-07-21,9692
1102,亞泥,51,1,50,富邦-嘉義,2023-07-21,9692
3444,利機,44,1,43,富邦-嘉義,2023-07-21,9692
2303,聯電,57,16,41,富邦-嘉義,2023-07-21,9692
6016,康和證,40,2,38,富邦-嘉義,2023-07-21,9692
2353,宏��,66,30,36,富邦-嘉義,2023-07-21,9692
2002,中鋼,33,0,33,富邦-嘉義,2023-07-21,9692
5880,合庫金,33,3,30,富邦-嘉義,2023-07-21,9692
3231,緯創,360,330,30,富邦-嘉義,2023-07-21,9692
1504,東元,98,69,29,富邦-嘉義,2023-07-21,9692
6120,達運,35,6,29,富邦-嘉義,2023-07-21,9692
2634,漢翔,32,4,28,富邦-嘉義,2023-07-21,9692
8996,高力,147,119,28,富邦-嘉義,2023-07-21,9692
2603,長榮,38,11,27,富邦-嘉義,2023-07-21,9692
8033,雷虎,50,24,26,富邦-嘉義,2023-07-21,9692
00919,群益台灣精選高息,45,19,26,富邦-嘉義,2023-07-21,9692
6188,廣明,235,209,26,富邦-嘉義,2023-07-21,9692
2330,台積電,32,7,25,富邦-嘉義,2023-07-21,9692
4979,華星光,38,13,25,富邦-嘉義,2023-07-21,9692
1605,華新,27,2,25,富邦-嘉義,2023-07-21,9692
2734,易飛網,25,1,24,富邦-嘉義,2023-07-21,9692
3049,精金,23,0,23,富邦-嘉義,2023-07-21,9692
1313,聯成,24,2,22,富邦-嘉義,2023-07-21,9692
2609,陽明,57,35,22,富邦-嘉義,2023-07-21,9692
6530,創威,55,33,22,富邦-嘉義,2023-07-21,9692
2352,佳世達,41,21,20,富邦-嘉義,2023-07-21,9692
1905,華紙,281,261,20,富邦-嘉義,2023-07-21,9692
4160,訊聯基因,19,0,19,富邦-嘉義,2023-07-21,9692
5864,致和證,24,5,19,富邦-嘉義,2023-07-21,9692
6116,彩晶,46,28,18,富邦-嘉義,2023-07-21,9692
6282,康舒,58,40,18,富邦-嘉義,2023-07-21,9692
2376,技嘉,1148,545,603,富邦-嘉義,2023-07-24,9692
2356,英業達,1226,688,538,富邦-嘉義,2023-07-24,9692
2382,廣達,3546,3224,322,富邦-嘉義,2023-07-24,9692
2888,新光金,214,13,201,富邦-嘉義,2023-07-24,9692
2312,金寶,216,50,166,富邦-嘉義,2023-07-24,9692
2329,華泰,1039,876,163,富邦-嘉義,2023-07-24,9692
4953,緯軟,262,121,141,富邦-嘉義,2023-07-24,9692
2301,光寶科,498,365,133,富邦-嘉義,2023-07-24,9692
3706,神達,435,327,108,富邦-嘉義,2023-07-24,9692
2461,光群雷,127,22,105,富邦-嘉義,2023-07-24,9692
5474,聰泰,103,7,96,富邦-嘉義,2023-07-24,9692
00720B,元大投資級公司債,92,5,87,富邦-嘉義,2023-07-24,9692
6188,廣明,1194,1109,85,富邦-嘉義,2023-07-24,9692
3071,協禧,1793,1709,84,富邦-嘉義,2023-07-24,9692
1903,士紙,288,210,78,富邦-嘉義,2023-07-24,9692
2887,台新金,77,2,75,富邦-嘉義,2023-07-24,9692
1609,大亞,157,91,66,富邦-嘉義,2023-07-24,9692
1591,駿吉-KY,60,2,58,富邦-嘉義,2023-07-24,9692
2352,佳世達,60,3,57,富邦-嘉義,2023-07-24,9692
00712,復華富時不動產,58,3,55,富邦-嘉義,2023-07-24,9692
3051,力特,54,1,53,富邦-嘉義,2023-07-24,9692
2609,陽明,57,11,46,富邦-嘉義,2023-07-24,9692
2801,彰銀,46,0,46,富邦-嘉義,2023-07-24,9692
3481,群創,53,9,44,富邦-嘉義,2023-07-24,9692
2880,華南金,43,0,43,富邦-嘉義,2023-07-24,9692
2425,承啟,262,224,38,富邦-嘉義,2023-07-24,9692
1504,東元,101,64,37,富邦-嘉義,2023-07-24,9692
5864,致和證,37,3,34,富邦-嘉義,2023-07-24,9692
3324,雙鴻,133,99,34,富邦-嘉義,2023-07-24,9692
2890,永豐金,41,8,33,富邦-嘉義,2023-07-24,9692
6016,康和證,32,0,32,富邦-嘉義,2023-07-24,9692
00679B,元大美債20年,33,1,32,富邦-嘉義,2023-07-24,9692
6274,台燿,232,201,31,富邦-嘉義,2023-07-24,9692
6123,上奇,31,0,31,富邦-嘉義,2023-07-24,9692
5386,青雲,31,0,31,富邦-嘉義,2023-07-24,9692
2444,兆勁,31,1,30,富邦-嘉義,2023-07-24,9692
2349,錸德,30,0,30,富邦-嘉義,2023-07-24,9692
00882,中信中國高股息,34,5,29,富邦-嘉義,2023-07-24,9692
00687B,國泰20年美債,32,3,29,富邦-嘉義,2023-07-24,9692
3047,訊舟,28,0,28,富邦-嘉義,2023-07-24,9692
2449,京元電子,138,111,27,富邦-嘉義,2023-07-24,9692
00919,群益台灣精選高息,36,9,27,富邦-嘉義,2023-07-24,9692
00885,富邦越南,47,20,27,富邦-嘉義,2023-07-24,9692
6275,元山,31,5,26,富邦-嘉義,2023-07-24,9692
00664R,國泰臺灣加權反1,26,0,26,富邦-嘉義,2023-07-24,9692
6282,康舒,78,53,25,富邦-嘉義,2023-07-24,9692
5392,能率,25,0,25,富邦-嘉義,2023-07-24,9692
3564,其陽,26,2,24,富邦-嘉義,2023-07-24,9692
2328,廣宇,26,2,24,富邦-嘉義,2023-07-24,9692
1584,精剛,45,21,24,富邦-嘉義,2023-07-24,9692
2329,華泰,959,120,839,富邦-嘉義,2023-07-25,9692
1504,東元,1059,568,491,富邦-嘉義,2023-07-25,9692
1618,合機,642,350,292,富邦-嘉義,2023-07-25,9692
4533,協易機,209,11,198,富邦-嘉義,2023-07-25,9692
6188,廣明,1105,912,193,富邦-嘉義,2023-07-25,9692
00673R,期元大S＆P原油反1,179,0,179,富邦-嘉義,2023-07-25,9692
3583,辛耘,565,398,167,富邦-嘉義,2023-07-25,9692
3450,聯鈞,176,35,141,富邦-嘉義,2023-07-25,9692
2359,所羅門,183,49,134,富邦-嘉義,2023-07-25,9692
1905,華紙,263,133,130,富邦-嘉義,2023-07-25,9692
6841,長佳智能,262,135,127,富邦-嘉義,2023-07-25,9692
6112,邁達特,179,59,120,富邦-嘉義,2023-07-25,9692
2354,鴻準,726,609,117,富邦-嘉義,2023-07-25,9692
2377,微星,103,9,94,富邦-嘉義,2023-07-25,9692
00885,富邦越南,93,5,88,富邦-嘉義,2023-07-25,9692
5386,青雲,235,168,67,富邦-嘉義,2023-07-25,9692
00929,復華台灣科技優息,72,6,66,富邦-嘉義,2023-07-25,9692
4763,材料-KY,58,0,58,富邦-嘉義,2023-07-25,9692
3363,上詮,116,63,53,富邦-嘉義,2023-07-25,9692
2425,承啟,149,98,51,富邦-嘉義,2023-07-25,9692
00878,國泰永續高股息,263,212,51,富邦-嘉義,2023-07-25,9692
2014,中鴻,49,1,48,富邦-嘉義,2023-07-25,9692
4510,高鋒,46,0,46,富邦-嘉義,2023-07-25,9692
8234,新漢,173,127,46,富邦-嘉義,2023-07-25,9692
1314,中石化,43,0,43,富邦-嘉義,2023-07-25,9692
0056,元大高股息,69,28,41,富邦-嘉義,2023-07-25,9692
5443,均豪,113,73,40,富邦-嘉義,2023-07-25,9692
6446,藥華藥,100,62,38,富邦-嘉義,2023-07-25,9692
3037,欣興,944,907,37,富邦-嘉義,2023-07-25,9692
2409,友達,50,15,35,富邦-嘉義,2023-07-25,9692
3306,鼎天,318,283,35,富邦-嘉義,2023-07-25,9692
3501,維熹,35,0,35,富邦-嘉義,2023-07-25,9692
00679B,元大美債20年,46,11,35,富邦-嘉義,2023-07-25,9692
3564,其陽,34,1,33,富邦-嘉義,2023-07-25,9692
2888,新光金,40,8,32,富邦-嘉義,2023-07-25,9692
00900,富邦特選高股息30,37,6,31,富邦-嘉義,2023-07-25,9692
3703,欣陸,30,0,30,富邦-嘉義,2023-07-25,9692
3287,廣寰科,30,1,29,富邦-嘉義,2023-07-25,9692
3227,原相,70,43,27,富邦-嘉義,2023-07-25,9692
3013,晟銘電,111,85,26,富邦-嘉義,2023-07-25,9692
8358,金居,1079,1054,25,富邦-嘉義,2023-07-25,9692
5258,虹堡,417,393,24,富邦-嘉義,2023-07-25,9692
3163,波若威,26,2,24,富邦-嘉義,2023-07-25,9692
6235,華孚,134,111,23,富邦-嘉義,2023-07-25,9692
2618,長榮航,39,17,22,富邦-嘉義,2023-07-25,9692
00795B,中信美國公債20年,21,0,21,富邦-嘉義,2023-07-25,9692
2887,台新金,52,32,20,富邦-嘉義,2023-07-25,9692
020038,元大ESG配息N,20,0,20,富邦-嘉義,2023-07-25,9692
2002,中鋼,52,33,19,富邦-嘉義,2023-07-25,9692
1229,聯華,19,0,19,富邦-嘉義,2023-07-25,9692
2382,廣達,2454,1536,918,富邦-嘉義,2023-07-26,9692
00632R,元大台灣50反1,303,0,303,富邦-嘉義,2023-07-26,9692
2312,金寶,157,8,149,富邦-嘉義,2023-07-26,9692
2340,台亞,259,134,125,富邦-嘉義,2023-07-26,9692
2485,兆赫,115,0,115,富邦-嘉義,2023-07-26,9692
8201,無敵,103,9,94,富邦-嘉義,2023-07-26,9692
1609,大亞,112,21,91,富邦-嘉義,2023-07-26,9692
00673R,期元大S＆P原油反1,79,0,79,富邦-嘉義,2023-07-26,9692
8478,東哥遊艇,73,8,65,富邦-嘉義,2023-07-26,9692
2888,新光金,170,109,61,富邦-嘉義,2023-07-26,9692
2421,建準,553,495,58,富邦-嘉義,2023-07-26,9692
00929,復華台灣科技優息,55,2,53,富邦-嘉義,2023-07-26,9692
4979,華星光,140,91,49,富邦-嘉義,2023-07-26,9692
2301,光寶科,1346,1297,49,富邦-嘉義,2023-07-26,9692
3105,穩懋,58,11,47,富邦-嘉義,2023-07-26,9692
1522,堤維西,48,9,39,富邦-嘉義,2023-07-26,9692
2313,華通,37,0,37,富邦-嘉義,2023-07-26,9692
5488,松普,33,0,33,富邦-嘉義,2023-07-26,9692
8086,宏捷科,33,1,32,富邦-嘉義,2023-07-26,9692
00679B,元大美債20年,32,1,31,富邦-嘉義,2023-07-26,9692
3163,波若威,320,289,31,富邦-嘉義,2023-07-26,9692
6770,力積電,46,16,30,富邦-嘉義,2023-07-26,9692
6213,聯茂,64,35,29,富邦-嘉義,2023-07-26,9692
2316,楠梓電,62,34,28,富邦-嘉義,2023-07-26,9692
1314,中石化,30,2,28,富邦-嘉義,2023-07-26,9692
3501,維熹,27,1,26,富邦-嘉義,2023-07-26,9692
5864,致和證,25,0,25,富邦-嘉義,2023-07-26,9692
6015,宏遠證,93,70,23,富邦-嘉義,2023-07-26,9692
2303,聯電,23,2,21,富邦-嘉義,2023-07-26,9692
3564,其陽,22,1,21,富邦-嘉義,2023-07-26,9692
6124,業強,22,1,21,富邦-嘉義,2023-07-26,9692
6874,倍力,24,3,21,富邦-嘉義,2023-07-26,9692
2889,國票金,20,0,20,富邦-嘉義,2023-07-26,9692
00922,國泰台灣領袖50,24,4,20,富邦-嘉義,2023-07-26,9692
1210,大成,23,4,19,富邦-嘉義,2023-07-26,9692
6811,宏�硌穈T,18,0,18,富邦-嘉義,2023-07-26,9692
1326,台化,23,5,18,富邦-嘉義,2023-07-26,9692
4960,誠美材,20,2,18,富邦-嘉義,2023-07-26,9692
3231,緯創,366,349,17,富邦-嘉義,2023-07-26,9692
4510,高鋒,67,50,17,富邦-嘉義,2023-07-26,9692
5483,中美晶,26,10,16,富邦-嘉義,2023-07-26,9692
2337,旺宏,18,2,16,富邦-嘉義,2023-07-26,9692
3227,原相,16,1,15,富邦-嘉義,2023-07-26,9692
2027,大成鋼,22,8,14,富邦-嘉義,2023-07-26,9692
00720B,元大投資級公司債,14,0,14,富邦-嘉義,2023-07-26,9692
3047,訊舟,15,1,14,富邦-嘉義,2023-07-26,9692
8403,盛弘,14,0,14,富邦-嘉義,2023-07-26,9692
6191,精成科,17,4,13,富邦-嘉義,2023-07-26,9692
6182,合晶,17,4,13,富邦-嘉義,2023-07-26,9692
00713,元大台灣高息低波,12,0,12,富邦-嘉義,2023-07-26,9692
6117,迎廣,743,51,692,富邦-嘉義,2023-07-27,9692
00673R,期元大S＆P原油反1,493,0,493,富邦-嘉義,2023-07-27,9692
2329,華泰,1755,1469,286,富邦-嘉義,2023-07-27,9692
6538,倉和,202,1,201,富邦-嘉義,2023-07-27,9692
1903,士紙,590,427,163,富邦-嘉義,2023-07-27,9692
00679B,元大美債20年,139,0,139,富邦-嘉義,2023-07-27,9692
00665L,富邦�琤肭磪囓�2,121,6,115,富邦-嘉義,2023-07-27,9692
2427,三商電,137,30,107,富邦-嘉義,2023-07-27,9692
2027,大成鋼,124,18,106,富邦-嘉義,2023-07-27,9692
3014,聯陽,108,9,99,富邦-嘉義,2023-07-27,9692
1618,合機,112,18,94,富邦-嘉義,2023-07-27,9692
2301,光寶科,362,279,83,富邦-嘉義,2023-07-27,9692
2316,楠梓電,100,32,68,富邦-嘉義,2023-07-27,9692
3231,緯創,279,214,65,富邦-嘉義,2023-07-27,9692
1904,正隆,369,304,65,富邦-嘉義,2023-07-27,9692
2883,凱基金,107,43,64,富邦-嘉義,2023-07-27,9692
00885,富邦越南,76,13,63,富邦-嘉義,2023-07-27,9692
3583,辛耘,240,178,62,富邦-嘉義,2023-07-27,9692
2383,台光電,58,1,57,富邦-嘉義,2023-07-27,9692
6531,愛普*,254,199,55,富邦-嘉義,2023-07-27,9692
5258,虹堡,70,15,55,富邦-嘉義,2023-07-27,9692
3693,營邦,59,8,51,富邦-嘉義,2023-07-27,9692
3558,神準,51,3,48,富邦-嘉義,2023-07-27,9692
00632R,元大台灣50反1,48,1,47,富邦-嘉義,2023-07-27,9692
2884,玉山金,52,8,44,富邦-嘉義,2023-07-27,9692
00712,復華富時不動產,51,8,43,富邦-嘉義,2023-07-27,9692
3205,佰研,43,2,41,富邦-嘉義,2023-07-27,9692
8086,宏捷科,41,0,41,富邦-嘉義,2023-07-27,9692
1591,駿吉-KY,40,0,40,富邦-嘉義,2023-07-27,9692
020020,元大台股領航N,40,0,40,富邦-嘉義,2023-07-27,9692
5475,德宏,42,2,40,富邦-嘉義,2023-07-27,9692
6257,矽格,40,1,39,富邦-嘉義,2023-07-27,9692
6125,廣運,153,116,37,富邦-嘉義,2023-07-27,9692
6116,彩晶,628,592,36,富邦-嘉義,2023-07-27,9692
3035,智原,42,6,36,富邦-嘉義,2023-07-27,9692
6443,元晶,56,20,36,富邦-嘉義,2023-07-27,9692
00929,復華台灣科技優息,33,1,32,富邦-嘉義,2023-07-27,9692
6282,康舒,106,75,31,富邦-嘉義,2023-07-27,9692
2356,英業達,320,289,31,富邦-嘉義,2023-07-27,9692
6274,台燿,233,204,29,富邦-嘉義,2023-07-27,9692
3049,精金,31,2,29,富邦-嘉義,2023-07-27,9692
1519,華城,54,25,29,富邦-嘉義,2023-07-27,9692
8234,新漢,124,95,29,富邦-嘉義,2023-07-27,9692
4572,駐龍,31,3,28,富邦-嘉義,2023-07-27,9692
2002,中鋼,30,3,27,富邦-嘉義,2023-07-27,9692
5864,致和證,27,0,27,富邦-嘉義,2023-07-27,9692
1783,和康生,27,1,26,富邦-嘉義,2023-07-27,9692
1907,永豐餘,616,591,25,富邦-嘉義,2023-07-27,9692
3037,欣興,53,28,25,富邦-嘉義,2023-07-27,9692
00857B,永豐20年美公債,25,0,25,富邦-嘉義,2023-07-27,9692
3231,緯創,3998,2721,1277,富邦-嘉義,2023-07-28,9692
2301,光寶科,715,226,489,富邦-嘉義,2023-07-28,9692
5340,建榮,348,37,311,富邦-嘉義,2023-07-28,9692
00712,復華富時不動產,203,11,192,富邦-嘉義,2023-07-28,9692
00679B,元大美債20年,171,0,171,富邦-嘉義,2023-07-28,9692
2888,新光金,173,12,161,富邦-嘉義,2023-07-28,9692
2356,英業達,240,123,117,富邦-嘉義,2023-07-28,9692
2913,農林,192,89,103,富邦-嘉義,2023-07-28,9692
8926,台汽電,101,2,99,富邦-嘉義,2023-07-28,9692
1905,華紙,11708,11612,96,富邦-嘉義,2023-07-28,9692
00919,群益台灣精選高息,107,14,93,富邦-嘉義,2023-07-28,9692
3044,健鼎,162,73,89,富邦-嘉義,2023-07-28,9692
6231,系微,89,3,86,富邦-嘉義,2023-07-28,9692
1591,駿吉-KY,90,5,85,富邦-嘉義,2023-07-28,9692
1612,宏泰,82,0,82,富邦-嘉義,2023-07-28,9692
00882,中信中國高股息,86,13,73,富邦-嘉義,2023-07-28,9692
8358,金居,305,234,71,富邦-嘉義,2023-07-28,9692
3707,漢磊,71,0,71,富邦-嘉義,2023-07-28,9692
3706,神達,173,107,66,富邦-嘉義,2023-07-28,9692
4979,華星光,406,343,63,富邦-嘉義,2023-07-28,9692
1609,大亞,77,16,61,富邦-嘉義,2023-07-28,9692
5515,建國,55,0,55,富邦-嘉義,2023-07-28,9692
2455,全新,51,3,48,富邦-嘉義,2023-07-28,9692
8215,明基材,48,1,47,富邦-嘉義,2023-07-28,9692
4953,緯軟,53,8,45,富邦-嘉義,2023-07-28,9692
6116,彩晶,65,20,45,富邦-嘉義,2023-07-28,9692
4908,前鼎,58,17,41,富邦-嘉義,2023-07-28,9692
3587,閎康,54,14,40,富邦-嘉義,2023-07-28,9692
2002,中鋼,46,7,39,富邦-嘉義,2023-07-28,9692
1718,中纖,36,0,36,富邦-嘉義,2023-07-28,9692
00720B,元大投資級公司債,44,12,32,富邦-嘉義,2023-07-28,9692
3715,定穎投控,33,1,32,富邦-嘉義,2023-07-28,9692
2352,佳世達,42,11,31,富邦-嘉義,2023-07-28,9692
1219,福壽,31,0,31,富邦-嘉義,2023-07-28,9692
4973,廣穎,50,21,29,富邦-嘉義,2023-07-28,9692
8234,新漢,62,33,29,富邦-嘉義,2023-07-28,9692
3703,欣陸,30,3,27,富邦-嘉義,2023-07-28,9692
2610,華航,35,8,27,富邦-嘉義,2023-07-28,9692
6188,廣明,54,28,26,富邦-嘉義,2023-07-28,9692
00680L,元大美債20正2,26,0,26,富邦-嘉義,2023-07-28,9692
3663,鑫科,82,56,26,富邦-嘉義,2023-07-28,9692
00687B,國泰20年美債,29,5,24,富邦-嘉義,2023-07-28,9692
6191,精成科,25,1,24,富邦-嘉義,2023-07-28,9692
4414,如興,24,0,24,富邦-嘉義,2023-07-28,9692
2316,楠梓電,74,50,24,富邦-嘉義,2023-07-28,9692
4915,致伸,151,128,23,富邦-嘉義,2023-07-28,9692
2357,華碩,91,68,23,富邦-嘉義,2023-07-28,9692
4526,東台,22,0,22,富邦-嘉義,2023-07-28,9692
6180,橘子,25,4,21,富邦-嘉義,2023-07-28,9692
6187,萬潤,442,421,21,富邦-嘉義,2023-07-28,9692
2363,矽統,1259,112,1147,富邦-嘉義,2023-07-31,9692
2913,農林,1354,633,721,富邦-嘉義,2023-07-31,9692
2301,光寶科,4658,4338,320,富邦-嘉義,2023-07-31,9692
1905,華紙,862,599,263,富邦-嘉義,2023-07-31,9692
2888,新光金,290,133,157,富邦-嘉義,2023-07-31,9692
5388,中磊,389,255,134,富邦-嘉義,2023-07-31,9692
2401,凌陽,184,56,128,富邦-嘉義,2023-07-31,9692
2382,廣達,3649,3527,122,富邦-嘉義,2023-07-31,9692
00632R,元大台灣50反1,139,22,117,富邦-嘉義,2023-07-31,9692
1314,中石化,151,36,115,富邦-嘉義,2023-07-31,9692
00706L,期元大S＆P日圓正2,111,0,111,富邦-嘉義,2023-07-31,9692
1815,富喬,285,185,100,富邦-嘉義,2023-07-31,9692
00712,復華富時不動產,108,14,94,富邦-嘉義,2023-07-31,9692
3596,智易,333,243,90,富邦-嘉義,2023-07-31,9692
00929,復華台灣科技優息,143,54,89,富邦-嘉義,2023-07-31,9692
3088,艾訊,90,3,87,富邦-嘉義,2023-07-31,9692
6753,龍德造船,86,2,84,富邦-嘉義,2023-07-31,9692
8069,元太,86,6,80,富邦-嘉義,2023-07-31,9692
2427,三商電,71,6,65,富邦-嘉義,2023-07-31,9692
1519,華城,70,16,54,富邦-嘉義,2023-07-31,9692
00679B,元大美債20年,54,0,54,富邦-嘉義,2023-07-31,9692
1591,駿吉-KY,51,0,51,富邦-嘉義,2023-07-31,9692
00631L,元大台灣50正2,50,0,50,富邦-嘉義,2023-07-31,9692
6160,欣技,50,0,50,富邦-嘉義,2023-07-31,9692
4746,台耀,52,3,49,富邦-嘉義,2023-07-31,9692
2883,凱基金,80,32,48,富邦-嘉義,2023-07-31,9692
5222,全訊,50,3,47,富邦-嘉義,2023-07-31,9692
6161,捷波,51,4,47,富邦-嘉義,2023-07-31,9692
6116,彩晶,134,88,46,富邦-嘉義,2023-07-31,9692
3044,健鼎,271,225,46,富邦-嘉義,2023-07-31,9692
6153,嘉聯益,41,0,41,富邦-嘉義,2023-07-31,9692
1316,上曜,36,1,35,富邦-嘉義,2023-07-31,9692
2851,中再保,35,1,34,富邦-嘉義,2023-07-31,9692
3047,訊舟,62,31,31,富邦-嘉義,2023-07-31,9692
00878,國泰永續高股息,221,191,30,富邦-嘉義,2023-07-31,9692
8358,金居,109,79,30,富邦-嘉義,2023-07-31,9692
1326,台化,30,3,27,富邦-嘉義,2023-07-31,9692
6538,倉和,90,63,27,富邦-嘉義,2023-07-31,9692
020027,元大上櫃ESG成長N,25,0,25,富邦-嘉義,2023-07-31,9692
3014,聯陽,34,9,25,富邦-嘉義,2023-07-31,9692
4960,誠美材,42,18,24,富邦-嘉義,2023-07-31,9692
3617,碩天,24,0,24,富邦-嘉義,2023-07-31,9692
2337,旺宏,33,10,23,富邦-嘉義,2023-07-31,9692
1903,士紙,24,1,23,富邦-嘉義,2023-07-31,9692
2891,中信金,36,13,23,富邦-嘉義,2023-07-31,9692
3005,神基,26,4,22,富邦-嘉義,2023-07-31,9692
2610,華航,49,27,22,富邦-嘉義,2023-07-31,9692
00720B,元大投資級公司債,24,3,21,富邦-嘉義,2023-07-31,9692
00930,永豐ESG低碳高息,23,2,21,富邦-嘉義,2023-07-31,9692
6535,順藥,21,0,21,富邦-嘉義,2023-07-31,9692
3325,旭品,606,274,332,富邦-嘉義,2023-08-01,9692
2009,第一銅,563,276,287,富邦-嘉義,2023-08-01,9692
00673R,期元大S＆P原油反1,262,0,262,富邦-嘉義,2023-08-01,9692
1605,華新,245,16,229,富邦-嘉義,2023-08-01,9692
2301,光寶科,1315,1109,206,富邦-嘉義,2023-08-01,9692
1608,華榮,201,0,201,富邦-嘉義,2023-08-01,9692
2402,毅嘉,205,46,159,富邦-嘉義,2023-08-01,9692
6285,啟��,419,264,155,富邦-嘉義,2023-08-01,9692
1802,台玻,229,81,148,富邦-嘉義,2023-08-01,9692
3163,波若威,644,537,107,富邦-嘉義,2023-08-01,9692
00929,復華台灣科技優息,116,10,106,富邦-嘉義,2023-08-01,9692
4979,華星光,531,454,77,富邦-嘉義,2023-08-01,9692
2312,金寶,432,357,75,富邦-嘉義,2023-08-01,9692
3706,神達,593,525,68,富邦-嘉義,2023-08-01,9692
9927,泰銘,96,37,59,富邦-嘉義,2023-08-01,9692
6841,長佳智能,219,163,56,富邦-嘉義,2023-08-01,9692
2388,威盛,760,704,56,富邦-嘉義,2023-08-01,9692
00753L,中信中國50正2,51,1,50,富邦-嘉義,2023-08-01,9692
1314,中石化,52,3,49,富邦-嘉義,2023-08-01,9692
3014,聯陽,105,62,43,富邦-嘉義,2023-08-01,9692
5328,華容,66,28,38,富邦-嘉義,2023-08-01,9692
2801,彰銀,35,0,35,富邦-嘉義,2023-08-01,9692
6188,廣明,67,33,34,富邦-嘉義,2023-08-01,9692
3587,閎康,91,58,33,富邦-嘉義,2023-08-01,9692
8096,擎亞,33,0,33,富邦-嘉義,2023-08-01,9692
3105,穩懋,33,1,32,富邦-嘉義,2023-08-01,9692
00923,群益台ESG低碳50,40,10,30,富邦-嘉義,2023-08-01,9692
3501,維熹,30,0,30,富邦-嘉義,2023-08-01,9692
2485,兆赫,31,2,29,富邦-嘉義,2023-08-01,9692
2323,中環,32,4,28,富邦-嘉義,2023-08-01,9692
020027,元大上櫃ESG成長N,25,0,25,富邦-嘉義,2023-08-01,9692
6531,愛普*,36,11,25,富邦-嘉義,2023-08-01,9692
6282,康舒,98,74,24,富邦-嘉義,2023-08-01,9692
6005,群益證,30,6,24,富邦-嘉義,2023-08-01,9692
3217,優群,28,5,23,富邦-嘉義,2023-08-01,9692
3029,零壹,26,3,23,富邦-嘉義,2023-08-01,9692
6669,緯穎,28,7,21,富邦-嘉義,2023-08-01,9692
1907,永豐餘,29,9,20,富邦-嘉義,2023-08-01,9692
3363,上詮,57,37,20,富邦-嘉義,2023-08-01,9692
2851,中再保,20,0,20,富邦-嘉義,2023-08-01,9692
1609,大亞,31,11,20,富邦-嘉義,2023-08-01,9692
6016,康和證,21,1,20,富邦-嘉義,2023-08-01,9692
00655L,國泰中國A50正2,32,13,19,富邦-嘉義,2023-08-01,9692
4746,台耀,751,732,19,富邦-嘉義,2023-08-01,9692
1217,愛之味,34,15,19,富邦-嘉義,2023-08-01,9692
8105,凌巨,18,0,18,富邦-嘉義,2023-08-01,9692
6235,華孚,40,23,17,富邦-嘉義,2023-08-01,9692
00679B,元大美債20年,16,0,16,富邦-嘉義,2023-08-01,9692
3056,富華新,18,2,16,富邦-嘉義,2023-08-01,9692
3037,欣興,24,9,15,富邦-嘉義,2023-08-01,9692
00878,國泰永續高股息,382,66,316,富邦-嘉義,2023-08-02,9692
00673R,期元大S＆P原油反1,198,0,198,富邦-嘉義,2023-08-02,9692
00900,富邦特選高股息30,220,34,186,富邦-嘉義,2023-08-02,9692
0056,元大高股息,199,53,146,富邦-嘉義,2023-08-02,9692
1905,華紙,1178,1047,131,富邦-嘉義,2023-08-02,9692
2892,第一金,112,12,100,富邦-嘉義,2023-08-02,9692
2618,長榮航,100,6,94,富邦-嘉義,2023-08-02,9692
6538,倉和,107,15,92,富邦-嘉義,2023-08-02,9692
00923,群益台ESG低碳50,110,21,89,富邦-嘉義,2023-08-02,9692
00712,復華富時不動產,101,19,82,富邦-嘉義,2023-08-02,9692
3481,群創,132,53,79,富邦-嘉義,2023-08-02,9692
9955,佳龍,311,238,73,富邦-嘉義,2023-08-02,9692
1402,遠東新,72,0,72,富邦-嘉義,2023-08-02,9692
2801,彰銀,62,0,62,富邦-嘉義,2023-08-02,9692
00929,復華台灣科技優息,159,104,55,富邦-嘉義,2023-08-02,9692
2883,凱基金,52,2,50,富邦-嘉義,2023-08-02,9692
00679B,元大美債20年,61,12,49,富邦-嘉義,2023-08-02,9692
2014,中鴻,91,43,48,富邦-嘉義,2023-08-02,9692
6231,系微,83,35,48,富邦-嘉義,2023-08-02,9692
1815,富喬,51,6,45,富邦-嘉義,2023-08-02,9692
1608,華榮,732,690,42,富邦-嘉義,2023-08-02,9692
2851,中再保,41,0,41,富邦-嘉義,2023-08-02,9692
2312,金寶,172,132,40,富邦-嘉義,2023-08-02,9692
00687B,國泰20年美債,39,0,39,富邦-嘉義,2023-08-02,9692
00680L,元大美債20正2,42,5,37,富邦-嘉義,2023-08-02,9692
6282,康舒,122,85,37,富邦-嘉義,2023-08-02,9692
1785,光洋科,879,847,32,富邦-嘉義,2023-08-02,9692
2317,鴻海,36,7,29,富邦-嘉義,2023-08-02,9692
6005,群益證,26,0,26,富邦-嘉義,2023-08-02,9692
2002,中鋼,30,5,25,富邦-嘉義,2023-08-02,9692
1616,億泰,43,18,25,富邦-嘉義,2023-08-02,9692
2204,中華,26,2,24,富邦-嘉義,2023-08-02,9692
2886,兆豐金,25,1,24,富邦-嘉義,2023-08-02,9692
1712,興農,22,0,22,富邦-嘉義,2023-08-02,9692
3037,欣興,58,36,22,富邦-嘉義,2023-08-02,9692
00857B,永豐20年美公債,23,1,22,富邦-嘉義,2023-08-02,9692
3362,先進光,23,2,21,富邦-嘉義,2023-08-02,9692
3711,日月光投控,22,1,21,富邦-嘉義,2023-08-02,9692
4977,眾達-KY,30,9,21,富邦-嘉義,2023-08-02,9692
1314,中石化,791,770,21,富邦-嘉義,2023-08-02,9692
6156,松上,21,0,21,富邦-嘉義,2023-08-02,9692
6190,萬泰科,22,1,21,富邦-嘉義,2023-08-02,9692
00720B,元大投資級公司債,25,5,20,富邦-嘉義,2023-08-02,9692
00930,永豐ESG低碳高息,20,0,20,富邦-嘉義,2023-08-02,9692
3284,太普高,20,0,20,富邦-嘉義,2023-08-02,9692
2845,遠東銀,20,0,20,富邦-嘉義,2023-08-02,9692
2498,宏達電,24,5,19,富邦-嘉義,2023-08-02,9692
6505,台塑化,18,0,18,富邦-嘉義,2023-08-02,9692
5483,中美晶,21,3,18,富邦-嘉義,2023-08-02,9692
2609,陽明,19,2,17,富邦-嘉義,2023-08-02,9692
2382,廣達,1911,1149,762,富邦-嘉義,2023-08-04,9692
2409,友達,605,6,599,富邦-嘉義,2023-08-04,9692
00680L,元大美債20正2,329,0,329,富邦-嘉義,2023-08-04,9692
2913,農林,687,375,312,富邦-嘉義,2023-08-04,9692
00929,復華台灣科技優息,291,10,281,富邦-嘉義,2023-08-04,9692
3693,營邦,320,62,258,富邦-嘉義,2023-08-04,9692
3231,緯創,4656,4434,222,富邦-嘉義,2023-08-04,9692
2344,華邦電,181,12,169,富邦-嘉義,2023-08-04,9692
8086,宏捷科,449,305,144,富邦-嘉義,2023-08-04,9692
3583,辛耘,181,41,140,富邦-嘉義,2023-08-04,9692
3689,湧德,139,7,132,富邦-嘉義,2023-08-04,9692
3004,豐達科,228,99,129,富邦-嘉義,2023-08-04,9692
00878,國泰永續高股息,240,111,129,富邦-嘉義,2023-08-04,9692
1314,中石化,130,12,118,富邦-嘉義,2023-08-04,9692
1609,大亞,156,41,115,富邦-嘉義,2023-08-04,9692
1605,華新,139,31,108,富邦-嘉義,2023-08-04,9692
2014,中鴻,131,23,108,富邦-嘉義,2023-08-04,9692
2888,新光金,228,135,93,富邦-嘉義,2023-08-04,9692
2352,佳世達,103,11,92,富邦-嘉義,2023-08-04,9692
6125,廣運,271,179,92,富邦-嘉義,2023-08-04,9692
00687B,國泰20年美債,94,7,87,富邦-嘉義,2023-08-04,9692
2634,漢翔,90,8,82,富邦-嘉義,2023-08-04,9692
2891,中信金,81,2,79,富邦-嘉義,2023-08-04,9692
2329,華泰,330,258,72,富邦-嘉義,2023-08-04,9692
1905,華紙,264,203,61,富邦-嘉義,2023-08-04,9692
00720B,元大投資級公司債,62,1,61,富邦-嘉義,2023-08-04,9692
1591,駿吉-KY,55,5,50,富邦-嘉義,2023-08-04,9692
00753L,中信中國50正2,70,20,50,富邦-嘉義,2023-08-04,9692
3481,群創,75,26,49,富邦-嘉義,2023-08-04,9692
2353,宏��,78,29,49,富邦-嘉義,2023-08-04,9692
2301,光寶科,1555,1507,48,富邦-嘉義,2023-08-04,9692
3362,先進光,50,7,43,富邦-嘉義,2023-08-04,9692
2316,楠梓電,50,7,43,富邦-嘉義,2023-08-04,9692
4572,駐龍,43,0,43,富邦-嘉義,2023-08-04,9692
2458,義隆,64,22,42,富邦-嘉義,2023-08-04,9692
00679B,元大美債20年,156,114,42,富邦-嘉義,2023-08-04,9692
4747,強生,40,1,39,富邦-嘉義,2023-08-04,9692
1904,正隆,45,8,37,富邦-嘉義,2023-08-04,9692
00772B,中信高評級公司債,36,0,36,富邦-嘉義,2023-08-04,9692
00900,富邦特選高股息30,50,15,35,富邦-嘉義,2023-08-04,9692
0056,元大高股息,102,68,34,富邦-嘉義,2023-08-04,9692
3338,泰碩,47,13,34,富邦-嘉義,2023-08-04,9692
6443,元晶,34,1,33,富邦-嘉義,2023-08-04,9692
8210,勤誠,101,70,31,富邦-嘉義,2023-08-04,9692
1722,台肥,30,0,30,富邦-嘉義,2023-08-04,9692
6753,龍德造船,32,2,30,富邦-嘉義,2023-08-04,9692
6114,久威,48,19,29,富邦-嘉義,2023-08-04,9692
2890,永豐金,28,0,28,富邦-嘉義,2023-08-04,9692
8215,明基材,28,1,27,富邦-嘉義,2023-08-04,9692
6217,中探針,27,0,27,富邦-嘉義,2023-08-04,9692
2356,英業達,2665,1400,1265,富邦-嘉義,2023-08-07,9692
2382,廣達,2231,1631,600,富邦-嘉義,2023-08-07,9692
3231,緯創,2336,1752,584,富邦-嘉義,2023-08-07,9692
2329,華泰,631,441,190,富邦-嘉義,2023-08-07,9692
2383,台光電,422,237,185,富邦-嘉義,2023-08-07,9692
2316,楠梓電,302,118,184,富邦-嘉義,2023-08-07,9692
6188,廣明,895,720,175,富邦-嘉義,2023-08-07,9692
00929,復華台灣科技優息,194,24,170,富邦-嘉義,2023-08-07,9692
00772B,中信高評級公司債,145,0,145,富邦-嘉義,2023-08-07,9692
3163,波若威,229,86,143,富邦-嘉義,2023-08-07,9692
2883,凱基金,138,5,133,富邦-嘉義,2023-08-07,9692
00720B,元大投資級公司債,125,0,125,富邦-嘉義,2023-08-07,9692
00900,富邦特選高股息30,164,39,125,富邦-嘉義,2023-08-07,9692
2376,技嘉,321,208,113,富邦-嘉義,2023-08-07,9692
3049,精金,100,0,100,富邦-嘉義,2023-08-07,9692
6116,彩晶,117,18,99,富邦-嘉義,2023-08-07,9692
2317,鴻海,120,22,98,富邦-嘉義,2023-08-07,9692
6285,啟��,119,38,81,富邦-嘉義,2023-08-07,9692
2618,長榮航,114,34,80,富邦-嘉義,2023-08-07,9692
3362,先進光,79,12,67,富邦-嘉義,2023-08-07,9692
00680L,元大美債20正2,75,10,65,富邦-嘉義,2023-08-07,9692
00795B,中信美國公債20年,62,0,62,富邦-嘉義,2023-08-07,9692
6222,上揚,61,0,61,富邦-嘉義,2023-08-07,9692
1217,愛之味,61,2,59,富邦-嘉義,2023-08-07,9692
1609,大亞,68,15,53,富邦-嘉義,2023-08-07,9692
00673R,期元大S＆P原油反1,49,0,49,富邦-嘉義,2023-08-07,9692
4979,華星光,57,10,47,富邦-嘉義,2023-08-07,9692
00931B,統一美債20年,45,0,45,富邦-嘉義,2023-08-07,9692
2323,中環,55,12,43,富邦-嘉義,2023-08-07,9692
3324,雙鴻,55,12,43,富邦-嘉義,2023-08-07,9692
00712,復華富時不動產,41,0,41,富邦-嘉義,2023-08-07,9692
6274,台燿,106,74,32,富邦-嘉義,2023-08-07,9692
8201,無敵,46,14,32,富邦-嘉義,2023-08-07,9692
3044,健鼎,35,6,29,富邦-嘉義,2023-08-07,9692
2890,永豐金,34,6,28,富邦-嘉義,2023-08-07,9692
00632R,元大台灣50反1,68,40,28,富邦-嘉義,2023-08-07,9692
2609,陽明,42,14,28,富邦-嘉義,2023-08-07,9692
1714,和桐,27,0,27,富邦-嘉義,2023-08-07,9692
1504,東元,61,35,26,富邦-嘉義,2023-08-07,9692
2352,佳世達,37,12,25,富邦-嘉義,2023-08-07,9692
4747,強生,25,0,25,富邦-嘉義,2023-08-07,9692
3363,上詮,67,46,21,富邦-嘉義,2023-08-07,9692
2014,中鴻,56,35,21,富邦-嘉義,2023-08-07,9692
2515,中工,20,0,20,富邦-嘉義,2023-08-07,9692
6126,信音,20,0,20,富邦-嘉義,2023-08-07,9692
3078,僑威,32,12,20,富邦-嘉義,2023-08-07,9692
3481,群創,56,39,17,富邦-嘉義,2023-08-07,9692
00687B,國泰20年美債,18,1,17,富邦-嘉義,2023-08-07,9692
00637L,元大滬深300正2,17,0,17,富邦-嘉義,2023-08-07,9692
3013,晟銘電,30,13,17,富邦-嘉義,2023-08-07,9692
2801,彰銀,542,0,542,富邦-嘉義,2023-08-08,9692
3325,旭品,446,95,351,富邦-嘉義,2023-08-08,9692
00929,復華台灣科技優息,240,2,238,富邦-嘉義,2023-08-08,9692
2376,技嘉,1222,1016,206,富邦-嘉義,2023-08-08,9692
6470,宇智,201,11,190,富邦-嘉義,2023-08-08,9692
3017,奇鋐,188,52,136,富邦-嘉義,2023-08-08,9692
00931B,統一美債20年,144,21,123,富邦-嘉義,2023-08-08,9692
3661,世芯-KY,153,32,121,富邦-嘉義,2023-08-08,9692
2892,第一金,108,0,108,富邦-嘉義,2023-08-08,9692
8930,青鋼,120,31,89,富邦-嘉義,2023-08-08,9692
00900,富邦特選高股息30,97,12,85,富邦-嘉義,2023-08-08,9692
3583,辛耘,168,107,61,富邦-嘉義,2023-08-08,9692
3078,僑威,106,49,57,富邦-嘉義,2023-08-08,9692
2867,三商壽,55,0,55,富邦-嘉義,2023-08-08,9692
4747,強生,67,12,55,富邦-嘉義,2023-08-08,9692
1522,堤維西,51,0,51,富邦-嘉義,2023-08-08,9692
00850,元大臺灣ESG永續,45,0,45,富邦-嘉義,2023-08-08,9692
3689,湧德,50,9,41,富邦-嘉義,2023-08-08,9692
00720B,元大投資級公司債,43,2,41,富邦-嘉義,2023-08-08,9692
1313,聯成,40,6,34,富邦-嘉義,2023-08-08,9692
1605,華新,49,16,33,富邦-嘉義,2023-08-08,9692
6222,上揚,33,1,32,富邦-嘉義,2023-08-08,9692
00688L,國泰20年美債正2,30,0,30,富邦-嘉義,2023-08-08,9692
3056,富華新,30,2,28,富邦-嘉義,2023-08-08,9692
3715,定穎投控,32,4,28,富邦-嘉義,2023-08-08,9692
3576,聯合再生,27,1,26,富邦-嘉義,2023-08-08,9692
1905,華紙,86,60,26,富邦-嘉義,2023-08-08,9692
2891,中信金,26,0,26,富邦-嘉義,2023-08-08,9692
00715L,期街口布蘭特正2,26,0,26,富邦-嘉義,2023-08-08,9692
2890,永豐金,26,2,24,富邦-嘉義,2023-08-08,9692
00878,國泰永續高股息,61,38,23,富邦-嘉義,2023-08-08,9692
8050,廣積,27,4,23,富邦-嘉義,2023-08-08,9692
5880,合庫金,26,3,23,富邦-嘉義,2023-08-08,9692
2002,中鋼,27,5,22,富邦-嘉義,2023-08-08,9692
1609,大亞,44,23,21,富邦-嘉義,2023-08-08,9692
2303,聯電,34,13,21,富邦-嘉義,2023-08-08,9692
6412,群電,32,11,21,富邦-嘉義,2023-08-08,9692
3526,凡甲,59,38,21,富邦-嘉義,2023-08-08,9692
2883,凱基金,30,10,20,富邦-嘉義,2023-08-08,9692
1314,中石化,22,2,20,富邦-嘉義,2023-08-08,9692
8027,鈦昇,27,7,20,富邦-嘉義,2023-08-08,9692
1591,駿吉-KY,60,41,19,富邦-嘉義,2023-08-08,9692
2834,臺企銀,19,0,19,富邦-嘉義,2023-08-08,9692
0056,元大高股息,37,18,19,富邦-嘉義,2023-08-08,9692
00892,富邦台灣半導體,17,0,17,富邦-嘉義,2023-08-08,9692
00882,中信中國高股息,17,0,17,富邦-嘉義,2023-08-08,9692
6005,群益證,20,3,17,富邦-嘉義,2023-08-08,9692
00696B,富邦美債20年,16,0,16,富邦-嘉義,2023-08-08,9692
4533,協易機,17,1,16,富邦-嘉義,2023-08-08,9692
2880,華南金,16,0,16,富邦-嘉義,2023-08-08,9692
00929,復華台灣科技優息,303,62,241,富邦-嘉義,2023-08-09,9692
00706L,期元大S＆P日圓正2,100,0,100,富邦-嘉義,2023-08-09,9692
3693,營邦,165,67,98,富邦-嘉義,2023-08-09,9692
00900,富邦特選高股息30,102,13,89,富邦-嘉義,2023-08-09,9692
2376,技嘉,386,313,73,富邦-嘉義,2023-08-09,9692
3363,上詮,68,1,67,富邦-嘉義,2023-08-09,9692
1519,華城,240,185,55,富邦-嘉義,2023-08-09,9692
00931B,統一美債20年,55,0,55,富邦-嘉義,2023-08-09,9692
1591,駿吉-KY,66,15,51,富邦-嘉義,2023-08-09,9692
5439,高技,51,1,50,富邦-嘉義,2023-08-09,9692
2603,長榮,52,2,50,富邦-嘉義,2023-08-09,9692
2834,臺企銀,48,4,44,富邦-嘉義,2023-08-09,9692
6605,帝寶,61,17,44,富邦-嘉義,2023-08-09,9692
2002,中鋼,42,0,42,富邦-嘉義,2023-08-09,9692
1609,大亞,61,20,41,富邦-嘉義,2023-08-09,9692
2455,全新,41,1,40,富邦-嘉義,2023-08-09,9692
00665L,富邦�琤肭磪囓�2,41,3,38,富邦-嘉義,2023-08-09,9692
00923,群益台ESG低碳50,41,4,37,富邦-嘉義,2023-08-09,9692
1785,光洋科,39,2,37,富邦-嘉義,2023-08-09,9692
8210,勤誠,362,326,36,富邦-嘉義,2023-08-09,9692
5469,瀚宇博,128,92,36,富邦-嘉義,2023-08-09,9692
2890,永豐金,47,16,31,富邦-嘉義,2023-08-09,9692
3284,太普高,30,0,30,富邦-嘉義,2023-08-09,9692
2388,威盛,109,80,29,富邦-嘉義,2023-08-09,9692
2801,彰銀,27,1,26,富邦-嘉義,2023-08-09,9692
5425,台半,29,4,25,富邦-嘉義,2023-08-09,9692
2421,建準,41,16,25,富邦-嘉義,2023-08-09,9692
3047,訊舟,24,0,24,富邦-嘉義,2023-08-09,9692
6282,康舒,47,24,23,富邦-嘉義,2023-08-09,9692
2399,映泰,26,3,23,富邦-嘉義,2023-08-09,9692
2301,光寶科,325,302,23,富邦-嘉義,2023-08-09,9692
2891,中信金,22,0,22,富邦-嘉義,2023-08-09,9692
2883,凱基金,23,2,21,富邦-嘉義,2023-08-09,9692
2515,中工,21,0,21,富邦-嘉義,2023-08-09,9692
3038,全台,21,0,21,富邦-嘉義,2023-08-09,9692
2645,長榮航太,32,12,20,富邦-嘉義,2023-08-09,9692
00664R,國泰臺灣加權反1,20,0,20,富邦-嘉義,2023-08-09,9692
6216,居易,21,1,20,富邦-嘉義,2023-08-09,9692
00773B,中信優先金融債,20,0,20,富邦-嘉義,2023-08-09,9692
3706,神達,40,21,19,富邦-嘉義,2023-08-09,9692
2344,華邦電,45,26,19,富邦-嘉義,2023-08-09,9692
2438,翔耀,19,0,19,富邦-嘉義,2023-08-09,9692
00679B,元大美債20年,48,30,18,富邦-嘉義,2023-08-09,9692
5880,合庫金,38,20,18,富邦-嘉義,2023-08-09,9692
00878,國泰永續高股息,60,43,17,富邦-嘉義,2023-08-09,9692
3324,雙鴻,22,5,17,富邦-嘉義,2023-08-09,9692
6111,大宇資,17,0,17,富邦-嘉義,2023-08-09,9692
1305,華夏,19,2,17,富邦-嘉義,2023-08-09,9692
3483,力致,122,106,16,富邦-嘉義,2023-08-09,9692
8109,博大,16,0,16,富邦-嘉義,2023-08-09,9692
3231,緯創,3698,2706,992,富邦-嘉義,2023-08-10,9692
2618,長榮航,628,104,524,富邦-嘉義,2023-08-10,9692
00929,復華台灣科技優息,237,0,237,富邦-嘉義,2023-08-10,9692
00900,富邦特選高股息30,169,3,166,富邦-嘉義,2023-08-10,9692
2883,凱基金,124,16,108,富邦-嘉義,2023-08-10,9692
0056,元大高股息,131,25,106,富邦-嘉義,2023-08-10,9692
00706L,期元大S＆P日圓正2,103,0,103,富邦-嘉義,2023-08-10,9692
3481,群創,191,113,78,富邦-嘉義,2023-08-10,9692
2610,華航,105,31,74,富邦-嘉義,2023-08-10,9692
1513,中興電,85,14,71,富邦-嘉義,2023-08-10,9692
6122,擎邦,75,8,67,富邦-嘉義,2023-08-10,9692
00919,群益台灣精選高息,79,15,64,富邦-嘉義,2023-08-10,9692
2303,聯電,61,1,60,富邦-嘉義,2023-08-10,9692
2405,輔信,61,3,58,富邦-嘉義,2023-08-10,9692
6282,康舒,123,69,54,富邦-嘉義,2023-08-10,9692
2409,友達,74,21,53,富邦-嘉義,2023-08-10,9692
8930,青鋼,62,11,51,富邦-嘉義,2023-08-10,9692
6176,瑞儀,51,0,51,富邦-嘉義,2023-08-10,9692
3596,智易,50,1,49,富邦-嘉義,2023-08-10,9692
00637L,元大滬深300正2,51,3,48,富邦-嘉義,2023-08-10,9692
3163,波若威,271,223,48,富邦-嘉義,2023-08-10,9692
5512,力麒,43,0,43,富邦-嘉義,2023-08-10,9692
1605,華新,119,78,41,富邦-嘉義,2023-08-10,9692
2607,榮運,40,0,40,富邦-嘉義,2023-08-10,9692
2324,仁寶,44,4,40,富邦-嘉義,2023-08-10,9692
4747,強生,38,0,38,富邦-嘉義,2023-08-10,9692
3483,力致,394,357,37,富邦-嘉義,2023-08-10,9692
1802,台玻,44,11,33,富邦-嘉義,2023-08-10,9692
1609,大亞,41,8,33,富邦-嘉義,2023-08-10,9692
00665L,富邦�琤肭磪囓�2,32,0,32,富邦-嘉義,2023-08-10,9692
00882,中信中國高股息,29,0,29,富邦-嘉義,2023-08-10,9692
8046,南電,28,0,28,富邦-嘉義,2023-08-10,9692
8936,國統,28,0,28,富邦-嘉義,2023-08-10,9692
2402,毅嘉,137,110,27,富邦-嘉義,2023-08-10,9692
3044,健鼎,60,33,27,富邦-嘉義,2023-08-10,9692
6153,嘉聯益,24,0,24,富邦-嘉義,2023-08-10,9692
6160,欣技,23,0,23,富邦-嘉義,2023-08-10,9692
00720B,元大投資級公司債,23,2,21,富邦-嘉義,2023-08-10,9692
2516,新建,21,0,21,富邦-嘉義,2023-08-10,9692
2457,飛宏,22,1,21,富邦-嘉義,2023-08-10,9692
1722,台肥,20,0,20,富邦-嘉義,2023-08-10,9692
00671R,富邦NASDAQ反1,20,0,20,富邦-嘉義,2023-08-10,9692
3714,富采,20,0,20,富邦-嘉義,2023-08-10,9692
1101,台泥,26,7,19,富邦-嘉義,2023-08-10,9692
1568,倉佑,25,6,19,富邦-嘉義,2023-08-10,9692
2323,中環,29,10,19,富邦-嘉義,2023-08-10,9692
1103,嘉泥,19,0,19,富邦-嘉義,2023-08-10,9692
8112,至上,34,15,19,富邦-嘉義,2023-08-10,9692
3356,奇偶,22,4,18,富邦-嘉義,2023-08-10,9692
2419,仲琦,19,1,18,富邦-嘉義,2023-08-10,9692
2610,華航,852,181,671,富邦-嘉義,2023-08-11,9692
00929,復華台灣科技優息,639,8,631,富邦-嘉義,2023-08-11,9692
2892,第一金,309,15,294,富邦-嘉義,2023-08-11,9692
00900,富邦特選高股息30,152,0,152,富邦-嘉義,2023-08-11,9692
00706L,期元大S＆P日圓正2,116,0,116,富邦-嘉義,2023-08-11,9692
00772B,中信高評級公司債,121,9,112,富邦-嘉義,2023-08-11,9692
1314,中石化,180,116,64,富邦-嘉義,2023-08-11,9692
6116,彩晶,63,3,60,富邦-嘉義,2023-08-11,9692
00687B,國泰20年美債,56,0,56,富邦-嘉義,2023-08-11,9692
6120,達運,57,6,51,富邦-嘉義,2023-08-11,9692
00715L,期街口布蘭特正2,50,1,49,富邦-嘉義,2023-08-11,9692
1722,台肥,45,0,45,富邦-嘉義,2023-08-11,9692
2014,中鴻,49,5,44,富邦-嘉義,2023-08-11,9692
2317,鴻海,44,2,42,富邦-嘉義,2023-08-11,9692
3032,偉訓,46,5,41,富邦-嘉義,2023-08-11,9692
3078,僑威,74,35,39,富邦-嘉義,2023-08-11,9692
2888,新光金,367,333,34,富邦-嘉義,2023-08-11,9692
2109,華豐,33,0,33,富邦-嘉義,2023-08-11,9692
00923,群益台ESG低碳50,32,0,32,富邦-嘉義,2023-08-11,9692
2801,彰銀,30,0,30,富邦-嘉義,2023-08-11,9692
00931B,統一美債20年,31,3,28,富邦-嘉義,2023-08-11,9692
3682,亞太電,28,0,28,富邦-嘉義,2023-08-11,9692
2002,中鋼,26,1,25,富邦-嘉義,2023-08-11,9692
2886,兆豐金,28,3,25,富邦-嘉義,2023-08-11,9692
00632R,元大台灣50反1,30,7,23,富邦-嘉義,2023-08-11,9692
2516,新建,23,0,23,富邦-嘉義,2023-08-11,9692
8112,至上,32,10,22,富邦-嘉義,2023-08-11,9692
5512,力麒,22,0,22,富邦-嘉義,2023-08-11,9692
2440,太空梭,27,5,22,富邦-嘉義,2023-08-11,9692
00795B,中信美國公債20年,21,0,21,富邦-嘉義,2023-08-11,9692
6005,群益證,21,0,21,富邦-嘉義,2023-08-11,9692
00882,中信中國高股息,21,0,21,富邦-嘉義,2023-08-11,9692
3019,亞光,20,0,20,富邦-嘉義,2023-08-11,9692
1591,駿吉-KY,20,0,20,富邦-嘉義,2023-08-11,9692
2357,華碩,28,8,20,富邦-嘉義,2023-08-11,9692
6625,必應,20,0,20,富邦-嘉義,2023-08-11,9692
1310,台苯,20,1,19,富邦-嘉義,2023-08-11,9692
2881,富邦金,24,6,18,富邦-嘉義,2023-08-11,9692
8210,勤誠,130,113,17,富邦-嘉義,2023-08-11,9692
1815,富喬,26,9,17,富邦-嘉義,2023-08-11,9692
2883,凱基金,28,12,16,富邦-嘉義,2023-08-11,9692
2022,聚亨,16,0,16,富邦-嘉義,2023-08-11,9692
2027,大成鋼,17,2,15,富邦-嘉義,2023-08-11,9692
5353,台林,15,0,15,富邦-嘉義,2023-08-11,9692
2606,裕民,22,7,15,富邦-嘉義,2023-08-11,9692
00857B,永豐20年美公債,15,0,15,富邦-嘉義,2023-08-11,9692
4763,材料-KY,18,3,15,富邦-嘉義,2023-08-11,9692
00885,富邦越南,34,19,15,富邦-嘉義,2023-08-11,9692
00751B,元大AAA至A公司債,19,5,14,富邦-嘉義,2023-08-11,9692
2412,中華電,15,1,14,富邦-嘉義,2023-08-11,9692
00929,復華台灣科技優息,1062,146,916,富邦-嘉義,2023-08-14,9692
2363,矽統,2834,2096,738,富邦-嘉義,2023-08-14,9692
00632R,元大台灣50反1,817,229,588,富邦-嘉義,2023-08-14,9692
00900,富邦特選高股息30,393,2,391,富邦-嘉義,2023-08-14,9692
00878,國泰永續高股息,331,93,238,富邦-嘉義,2023-08-14,9692
3035,智原,327,136,191,富邦-嘉義,2023-08-14,9692
2892,第一金,185,2,183,富邦-嘉義,2023-08-14,9692
00923,群益台ESG低碳50,143,6,137,富邦-嘉義,2023-08-14,9692
3682,亞太電,105,0,105,富邦-嘉義,2023-08-14,9692
2344,華邦電,108,4,104,富邦-嘉義,2023-08-14,9692
6005,群益證,99,0,99,富邦-嘉義,2023-08-14,9692
00634R,富邦上証反1,90,0,90,富邦-嘉義,2023-08-14,9692
00669R,國泰美國道瓊反1,88,0,88,富邦-嘉義,2023-08-14,9692
1101,台泥,82,6,76,富邦-嘉義,2023-08-14,9692
1319,東陽,88,13,75,富邦-嘉義,2023-08-14,9692
3481,群創,111,37,74,富邦-嘉義,2023-08-14,9692
2002,中鋼,75,1,74,富邦-嘉義,2023-08-14,9692
2888,新光金,111,40,71,富邦-嘉義,2023-08-14,9692
00882,中信中國高股息,89,22,67,富邦-嘉義,2023-08-14,9692
2881,富邦金,69,5,64,富邦-嘉義,2023-08-14,9692
00713,元大台灣高息低波,61,1,60,富邦-嘉義,2023-08-14,9692
2601,益航,60,0,60,富邦-嘉義,2023-08-14,9692
2303,聯電,67,11,56,富邦-嘉義,2023-08-14,9692
2867,三商壽,55,0,55,富邦-嘉義,2023-08-14,9692
8050,廣積,120,68,52,富邦-嘉義,2023-08-14,9692
3715,定穎投控,86,34,52,富邦-嘉義,2023-08-14,9692
2880,華南金,60,8,52,富邦-嘉義,2023-08-14,9692
3703,欣陸,51,0,51,富邦-嘉義,2023-08-14,9692
9105,泰金寶-DR,50,0,50,富邦-嘉義,2023-08-14,9692
3231,緯創,2580,2533,47,富邦-嘉義,2023-08-14,9692
2603,長榮,66,19,47,富邦-嘉義,2023-08-14,9692
1513,中興電,70,24,46,富邦-嘉義,2023-08-14,9692
00679B,元大美債20年,50,9,41,富邦-嘉義,2023-08-14,9692
00931B,統一美債20年,45,5,40,富邦-嘉義,2023-08-14,9692
0050,元大台灣50,40,0,40,富邦-嘉義,2023-08-14,9692
00907,永豐優息存股,34,0,34,富邦-嘉義,2023-08-14,9692
1605,華新,71,38,33,富邦-嘉義,2023-08-14,9692
2409,友達,54,21,33,富邦-嘉義,2023-08-14,9692
2402,毅嘉,38,6,32,富邦-嘉義,2023-08-14,9692
2356,英業達,287,255,32,富邦-嘉義,2023-08-14,9692
1313,聯成,52,20,32,富邦-嘉義,2023-08-14,9692
6274,台燿,90,59,31,富邦-嘉義,2023-08-14,9692
6770,力積電,36,6,30,富邦-嘉義,2023-08-14,9692
2606,裕民,29,0,29,富邦-嘉義,2023-08-14,9692
00902,中信電池及儲能,31,2,29,富邦-嘉義,2023-08-14,9692
1103,嘉泥,29,0,29,富邦-嘉義,2023-08-14,9692
2883,凱基金,59,31,28,富邦-嘉義,2023-08-14,9692
2633,台灣高鐵,26,0,26,富邦-嘉義,2023-08-14,9692
2316,楠梓電,52,27,25,富邦-嘉義,2023-08-14,9692
2329,華泰,185,160,25,富邦-嘉義,2023-08-14,9692
2324,仁寶,4877,4342,535,富邦-嘉義,2023-08-15,9692
00929,復華台灣科技優息,599,155,444,富邦-嘉義,2023-08-15,9692
00923,群益台ESG低碳50,344,3,341,富邦-嘉義,2023-08-15,9692
2332,友訊,921,723,198,富邦-嘉義,2023-08-15,9692
3035,智原,291,100,191,富邦-嘉義,2023-08-15,9692
00900,富邦特選高股息30,235,61,174,富邦-嘉義,2023-08-15,9692
2883,凱基金,156,5,151,富邦-嘉義,2023-08-15,9692
00772B,中信高評級公司債,151,10,141,富邦-嘉義,2023-08-15,9692
2329,華泰,412,276,136,富邦-嘉義,2023-08-15,9692
00931B,統一美債20年,133,0,133,富邦-嘉義,2023-08-15,9692
2317,鴻海,136,24,112,富邦-嘉義,2023-08-15,9692
00878,國泰永續高股息,150,52,98,富邦-嘉義,2023-08-15,9692
00679B,元大美債20年,106,8,98,富邦-嘉義,2023-08-15,9692
00632R,元大台灣50反1,150,53,97,富邦-嘉義,2023-08-15,9692
2357,華碩,210,117,93,富邦-嘉義,2023-08-15,9692
00892,富邦台灣半導體,91,0,91,富邦-嘉義,2023-08-15,9692
3481,群創,114,34,80,富邦-嘉義,2023-08-15,9692
4123,晟德,79,5,74,富邦-嘉義,2023-08-15,9692
6016,康和證,72,1,71,富邦-嘉義,2023-08-15,9692
3231,緯創,2203,2133,70,富邦-嘉義,2023-08-15,9692
2892,第一金,65,0,65,富邦-嘉義,2023-08-15,9692
2002,中鋼,64,0,64,富邦-嘉義,2023-08-15,9692
6176,瑞儀,60,0,60,富邦-嘉義,2023-08-15,9692
3362,先進光,85,29,56,富邦-嘉義,2023-08-15,9692
1314,中石化,81,28,53,富邦-嘉義,2023-08-15,9692
6120,達運,59,7,52,富邦-嘉義,2023-08-15,9692
2409,友達,61,10,51,富邦-嘉義,2023-08-15,9692
6285,啟��,70,22,48,富邦-嘉義,2023-08-15,9692
6418,詠昇,83,41,42,富邦-嘉義,2023-08-15,9692
2474,可成,40,0,40,富邦-嘉義,2023-08-15,9692
2881,富邦金,39,4,35,富邦-嘉義,2023-08-15,9692
00907,永豐優息存股,35,0,35,富邦-嘉義,2023-08-15,9692
6664,群翊,37,2,35,富邦-嘉義,2023-08-15,9692
00687B,國泰20年美債,32,0,32,富邦-嘉義,2023-08-15,9692
00680L,元大美債20正2,30,0,30,富邦-嘉義,2023-08-15,9692
8210,勤誠,117,87,30,富邦-嘉義,2023-08-15,9692
2462,良得電,28,0,28,富邦-嘉義,2023-08-15,9692
6770,力積電,33,5,28,富邦-嘉義,2023-08-15,9692
00850,元大臺灣ESG永續,28,1,27,富邦-嘉義,2023-08-15,9692
3501,維熹,25,0,25,富邦-嘉義,2023-08-15,9692
2301,光寶科,192,168,24,富邦-嘉義,2023-08-15,9692
00715L,期街口布蘭特正2,24,0,24,富邦-嘉義,2023-08-15,9692
2603,長榮,30,6,24,富邦-嘉義,2023-08-15,9692
1326,台化,31,9,22,富邦-嘉義,2023-08-15,9692
3105,穩懋,27,6,21,富邦-嘉義,2023-08-15,9692
2634,漢翔,32,11,21,富邦-嘉義,2023-08-15,9692
2328,廣宇,21,0,21,富邦-嘉義,2023-08-15,9692
3017,奇鋐,32,12,20,富邦-嘉義,2023-08-15,9692
4532,瑞智,21,1,20,富邦-嘉義,2023-08-15,9692
1313,聯成,20,0,20,富邦-嘉義,2023-08-15,9692
3231,緯創,4078,2881,1197,富邦-嘉義,2023-08-16,9692
2382,廣達,1608,1178,430,富邦-嘉義,2023-08-16,9692
3306,鼎天,608,180,428,富邦-嘉義,2023-08-16,9692
2421,建準,1232,829,403,富邦-嘉義,2023-08-16,9692
3051,力特,423,36,387,富邦-嘉義,2023-08-16,9692
3049,精金,527,153,374,富邦-嘉義,2023-08-16,9692
2883,凱基金,211,51,160,富邦-嘉義,2023-08-16,9692
3693,營邦,438,286,152,富邦-嘉義,2023-08-16,9692
6116,彩晶,137,3,134,富邦-嘉義,2023-08-16,9692
3682,亞太電,129,1,128,富邦-嘉義,2023-08-16,9692
2376,技嘉,276,160,116,富邦-嘉義,2023-08-16,9692
00929,復華台灣科技優息,215,105,110,富邦-嘉義,2023-08-16,9692
00795B,中信美國公債20年,103,0,103,富邦-嘉義,2023-08-16,9692
2603,長榮,101,1,100,富邦-嘉義,2023-08-16,9692
2323,中環,102,3,99,富邦-嘉義,2023-08-16,9692
1314,中石化,90,0,90,富邦-嘉義,2023-08-16,9692
2002,中鋼,95,10,85,富邦-嘉義,2023-08-16,9692
00923,群益台ESG低碳50,78,0,78,富邦-嘉義,2023-08-16,9692
2618,長榮航,81,5,76,富邦-嘉義,2023-08-16,9692
2460,建通,81,7,74,富邦-嘉義,2023-08-16,9692
2880,華南金,71,4,67,富邦-嘉義,2023-08-16,9692
6139,亞翔,175,110,65,富邦-嘉義,2023-08-16,9692
2892,第一金,68,6,62,富邦-嘉義,2023-08-16,9692
00882,中信中國高股息,61,1,60,富邦-嘉義,2023-08-16,9692
3078,僑威,107,52,55,富邦-嘉義,2023-08-16,9692
00632R,元大台灣50反1,100,45,55,富邦-嘉義,2023-08-16,9692
2363,矽統,273,219,54,富邦-嘉義,2023-08-16,9692
2891,中信金,60,7,53,富邦-嘉義,2023-08-16,9692
2888,新光金,64,12,52,富邦-嘉義,2023-08-16,9692
00931B,統一美債20年,41,0,41,富邦-嘉義,2023-08-16,9692
4743,合一,153,112,41,富邦-嘉義,2023-08-16,9692
2368,金像電,258,218,40,富邦-嘉義,2023-08-16,9692
1802,台玻,51,11,40,富邦-嘉義,2023-08-16,9692
2317,鴻海,53,13,40,富邦-嘉義,2023-08-16,9692
00900,富邦特選高股息30,60,21,39,富邦-嘉義,2023-08-16,9692
1301,台塑,38,2,36,富邦-嘉義,2023-08-16,9692
2884,玉山金,60,27,33,富邦-嘉義,2023-08-16,9692
2356,英業達,181,148,33,富邦-嘉義,2023-08-16,9692
8050,廣積,981,949,32,富邦-嘉義,2023-08-16,9692
2834,臺企銀,45,13,32,富邦-嘉義,2023-08-16,9692
3706,神達,116,85,31,富邦-嘉義,2023-08-16,9692
2882,國泰金,33,2,31,富邦-嘉義,2023-08-16,9692
3483,力致,268,237,31,富邦-嘉義,2023-08-16,9692
3689,湧德,260,230,30,富邦-嘉義,2023-08-16,9692
00893,國泰智能電動車,31,2,29,富邦-嘉義,2023-08-16,9692
3481,群創,80,51,29,富邦-嘉義,2023-08-16,9692
3043,科風,84,55,29,富邦-嘉義,2023-08-16,9692
1529,樂事綠能,31,2,29,富邦-嘉義,2023-08-16,9692
2886,兆豐金,31,3,28,富邦-嘉義,2023-08-16,9692
2610,華航,53,26,27,富邦-嘉義,2023-08-16,9692
2368,金像電,2054,1758,296,富邦-嘉義,2023-08-17,9692
3163,波若威,741,446,295,富邦-嘉義,2023-08-17,9692
2363,矽統,1476,1270,206,富邦-嘉義,2023-08-17,9692
00929,復華台灣科技優息,219,63,156,富邦-嘉義,2023-08-17,9692
2888,新光金,166,13,153,富邦-嘉義,2023-08-17,9692
1802,台玻,146,31,115,富邦-嘉義,2023-08-17,9692
00665L,富邦�琤肭磪囓�2,112,2,110,富邦-嘉義,2023-08-17,9692
2356,英業達,463,360,103,富邦-嘉義,2023-08-17,9692
6418,詠昇,102,2,100,富邦-嘉義,2023-08-17,9692
2880,華南金,100,0,100,富邦-嘉義,2023-08-17,9692
2324,仁寶,923,829,94,富邦-嘉義,2023-08-17,9692
2886,兆豐金,86,3,83,富邦-嘉義,2023-08-17,9692
00712,復華富時不動產,86,5,81,富邦-嘉義,2023-08-17,9692
2301,光寶科,212,133,79,富邦-嘉義,2023-08-17,9692
2883,凱基金,96,18,78,富邦-嘉義,2023-08-17,9692
3362,先進光,161,86,75,富邦-嘉義,2023-08-17,9692
2618,長榮航,98,26,72,富邦-嘉義,2023-08-17,9692
00753L,中信中國50正2,69,0,69,富邦-嘉義,2023-08-17,9692
2892,第一金,76,8,68,富邦-嘉義,2023-08-17,9692
2002,中鋼,80,12,68,富邦-嘉義,2023-08-17,9692
2401,凌陽,174,108,66,富邦-嘉義,2023-08-17,9692
8112,至上,72,6,66,富邦-嘉義,2023-08-17,9692
00931B,統一美債20年,76,10,66,富邦-嘉義,2023-08-17,9692
1303,南亞,65,2,63,富邦-嘉義,2023-08-17,9692
00715L,期街口布蘭特正2,70,11,59,富邦-嘉義,2023-08-17,9692
2312,金寶,181,125,56,富邦-嘉義,2023-08-17,9692
00893,國泰智能電動車,77,22,55,富邦-嘉義,2023-08-17,9692
1101,台泥,75,22,53,富邦-嘉義,2023-08-17,9692
00687B,國泰20年美債,52,0,52,富邦-嘉義,2023-08-17,9692
2014,中鴻,50,2,48,富邦-嘉義,2023-08-17,9692
00679B,元大美債20年,51,6,45,富邦-嘉義,2023-08-17,9692
2801,彰銀,47,2,45,富邦-嘉義,2023-08-17,9692
2399,映泰,138,95,43,富邦-嘉義,2023-08-17,9692
00720B,元大投資級公司債,55,13,42,富邦-嘉義,2023-08-17,9692
1319,東陽,49,9,40,富邦-嘉義,2023-08-17,9692
00923,群益台ESG低碳50,44,5,39,富邦-嘉義,2023-08-17,9692
00900,富邦特選高股息30,59,20,39,富邦-嘉義,2023-08-17,9692
2211,長榮鋼,40,2,38,富邦-嘉義,2023-08-17,9692
2303,聯電,56,19,37,富邦-嘉義,2023-08-17,9692
6005,群益證,35,0,35,富邦-嘉義,2023-08-17,9692
2367,燿華,38,5,33,富邦-嘉義,2023-08-17,9692
00713,元大台灣高息低波,41,9,32,富邦-嘉義,2023-08-17,9692
6275,元山,34,3,31,富邦-嘉義,2023-08-17,9692
6770,力積電,36,7,29,富邦-嘉義,2023-08-17,9692
00751B,元大AAA至A公司債,35,6,29,富邦-嘉義,2023-08-17,9692
2357,華碩,41,15,26,富邦-嘉義,2023-08-17,9692
1905,華紙,27,1,26,富邦-嘉義,2023-08-17,9692
4944,兆遠,26,0,26,富邦-嘉義,2023-08-17,9692
1326,台化,38,12,26,富邦-嘉義,2023-08-17,9692
6505,台塑化,25,0,25,富邦-嘉義,2023-08-17,9692
00929,復華台灣科技優息,367,43,324,富邦-嘉義,2023-08-18,9692
00632R,元大台灣50反1,459,254,205,富邦-嘉義,2023-08-18,9692
2641,正德,187,71,116,富邦-嘉義,2023-08-18,9692
3231,緯創,6424,6313,111,富邦-嘉義,2023-08-18,9692
00878,國泰永續高股息,136,29,107,富邦-嘉義,2023-08-18,9692
2324,仁寶,251,145,106,富邦-嘉義,2023-08-18,9692
00673R,期元大S＆P原油反1,110,5,105,富邦-嘉義,2023-08-18,9692
4906,正文,161,83,78,富邦-嘉義,2023-08-18,9692
1504,東元,176,111,65,富邦-嘉義,2023-08-18,9692
2355,敬鵬,67,8,59,富邦-嘉義,2023-08-18,9692
1442,名軒,52,0,52,富邦-嘉義,2023-08-18,9692
1402,遠東新,50,0,50,富邦-嘉義,2023-08-18,9692
4533,協易機,48,2,46,富邦-嘉義,2023-08-18,9692
1471,首利,58,12,46,富邦-嘉義,2023-08-18,9692
2317,鴻海,51,5,46,富邦-嘉義,2023-08-18,9692
3056,富華新,56,14,42,富邦-嘉義,2023-08-18,9692
2009,第一銅,40,0,40,富邦-嘉義,2023-08-18,9692
0056,元大高股息,49,9,40,富邦-嘉義,2023-08-18,9692
00772B,中信高評級公司債,40,2,38,富邦-嘉義,2023-08-18,9692
2332,友訊,903,866,37,富邦-嘉義,2023-08-18,9692
2383,台光電,175,139,36,富邦-嘉義,2023-08-18,9692
00924,復華S＆P500成長,36,0,36,富邦-嘉義,2023-08-18,9692
2408,南亞科,36,2,34,富邦-嘉義,2023-08-18,9692
2329,華泰,1523,1491,32,富邦-嘉義,2023-08-18,9692
2606,裕民,410,378,32,富邦-嘉義,2023-08-18,9692
1589,永冠-KY,30,0,30,富邦-嘉義,2023-08-18,9692
3051,力特,38,10,28,富邦-嘉義,2023-08-18,9692
2610,華航,56,29,27,富邦-嘉義,2023-08-18,9692
00665L,富邦�琤肭磪囓�2,66,40,26,富邦-嘉義,2023-08-18,9692
2886,兆豐金,28,3,25,富邦-嘉義,2023-08-18,9692
1905,華紙,37,12,25,富邦-嘉義,2023-08-18,9692
2609,陽明,107,82,25,富邦-嘉義,2023-08-18,9692
2634,漢翔,34,9,25,富邦-嘉義,2023-08-18,9692
2409,友達,31,6,25,富邦-嘉義,2023-08-18,9692
00923,群益台ESG低碳50,27,4,23,富邦-嘉義,2023-08-18,9692
2316,楠梓電,23,0,23,富邦-嘉義,2023-08-18,9692
3035,智原,153,130,23,富邦-嘉義,2023-08-18,9692
2618,長榮航,67,44,23,富邦-嘉義,2023-08-18,9692
00931B,統一美債20年,23,0,23,富邦-嘉義,2023-08-18,9692
00753L,中信中國50正2,22,0,22,富邦-嘉義,2023-08-18,9692
1319,東陽,88,66,22,富邦-嘉義,2023-08-18,9692
3014,聯陽,23,1,22,富邦-嘉義,2023-08-18,9692
2419,仲琦,30,9,21,富邦-嘉義,2023-08-18,9692
5340,建榮,32,11,21,富邦-嘉義,2023-08-18,9692
6477,安集,21,0,21,富邦-嘉義,2023-08-18,9692
9904,寶成,20,0,20,富邦-嘉義,2023-08-18,9692
6285,啟��,30,11,19,富邦-嘉義,2023-08-18,9692
4550,長佳,19,0,19,富邦-嘉義,2023-08-18,9692
00687B,國泰20年美債,20,2,18,富邦-嘉義,2023-08-18,9692
00680L,元大美債20正2,18,0,18,富邦-嘉義,2023-08-18,9692
2421,建準,712,280,432,富邦-嘉義,2023-08-21,9692
00929,復華台灣科技優息,362,41,321,富邦-嘉義,2023-08-21,9692
3483,力致,570,293,277,富邦-嘉義,2023-08-21,9692
3163,波若威,696,455,241,富邦-嘉義,2023-08-21,9692
2888,新光金,208,6,202,富邦-嘉義,2023-08-21,9692
00885,富邦越南,269,102,167,富邦-嘉義,2023-08-21,9692
00632R,元大台灣50反1,225,118,107,富邦-嘉義,2023-08-21,9692
00720B,元大投資級公司債,107,16,91,富邦-嘉義,2023-08-21,9692
2645,長榮航太,103,20,83,富邦-嘉義,2023-08-21,9692
00919,群益台灣精選高息,71,4,67,富邦-嘉義,2023-08-21,9692
00772B,中信高評級公司債,69,2,67,富邦-嘉義,2023-08-21,9692
3501,維熹,68,1,67,富邦-嘉義,2023-08-21,9692
2601,益航,100,34,66,富邦-嘉義,2023-08-21,9692
2834,臺企銀,81,16,65,富邦-嘉義,2023-08-21,9692
2368,金像電,175,113,62,富邦-嘉義,2023-08-21,9692
8050,廣積,71,11,60,富邦-嘉義,2023-08-21,9692
3044,健鼎,64,4,60,富邦-嘉義,2023-08-21,9692
6770,力積電,60,1,59,富邦-嘉義,2023-08-21,9692
2892,第一金,58,1,57,富邦-嘉義,2023-08-21,9692
00882,中信中國高股息,65,9,56,富邦-嘉義,2023-08-21,9692
3583,辛耘,74,23,51,富邦-嘉義,2023-08-21,9692
3231,緯創,489,440,49,富邦-嘉義,2023-08-21,9692
4743,合一,48,0,48,富邦-嘉義,2023-08-21,9692
2313,華通,47,0,47,富邦-嘉義,2023-08-21,9692
4979,華星光,55,8,47,富邦-嘉義,2023-08-21,9692
3715,定穎投控,146,100,46,富邦-嘉義,2023-08-21,9692
2344,華邦電,53,8,45,富邦-嘉義,2023-08-21,9692
2324,仁寶,109,69,40,富邦-嘉義,2023-08-21,9692
4147,中裕,154,115,39,富邦-嘉義,2023-08-21,9692
2408,南亞科,38,0,38,富邦-嘉義,2023-08-21,9692
2303,聯電,40,2,38,富邦-嘉義,2023-08-21,9692
8210,勤誠,68,31,37,富邦-嘉義,2023-08-21,9692
2301,光寶科,278,242,36,富邦-嘉義,2023-08-21,9692
2603,長榮,36,0,36,富邦-嘉義,2023-08-21,9692
2516,新建,38,3,35,富邦-嘉義,2023-08-21,9692
2637,慧洋-KY,37,4,33,富邦-嘉義,2023-08-21,9692
00665L,富邦�琤肭磪囓�2,32,0,32,富邦-嘉義,2023-08-21,9692
2402,毅嘉,40,10,30,富邦-嘉義,2023-08-21,9692
00687B,國泰20年美債,49,22,27,富邦-嘉義,2023-08-21,9692
00753L,中信中國50正2,25,0,25,富邦-嘉義,2023-08-21,9692
2332,友訊,780,755,25,富邦-嘉義,2023-08-21,9692
0056,元大高股息,38,14,24,富邦-嘉義,2023-08-21,9692
2880,華南金,27,2,25,富邦-嘉義,2023-08-21,9692
00923,群益台ESG低碳50,26,2,24,富邦-嘉義,2023-08-21,9692
2801,彰銀,32,9,23,富邦-嘉義,2023-08-21,9692
00931B,統一美債20年,23,0,23,富邦-嘉義,2023-08-21,9692
2913,農林,23,1,22,富邦-嘉義,2023-08-21,9692
3042,晶技,25,3,22,富邦-嘉義,2023-08-21,9692
2401,凌陽,33,11,22,富邦-嘉義,2023-08-21,9692
3693,營邦,64,44,20,富邦-嘉義,2023-08-21,9692
2618,長榮航,590,82,508,富邦-嘉義,2023-08-22,9692
3013,晟銘電,662,500,162,富邦-嘉義,2023-08-22,9692
1314,中石化,152,0,152,富邦-嘉義,2023-08-22,9692
00929,復華台灣科技優息,150,32,118,富邦-嘉義,2023-08-22,9692
6117,迎廣,110,5,105,富邦-嘉義,2023-08-22,9692
00706L,期元大S＆P日圓正2,101,0,101,富邦-嘉義,2023-08-22,9692
2402,毅嘉,109,12,97,富邦-嘉義,2023-08-22,9692
1513,中興電,82,14,68,富邦-嘉義,2023-08-22,9692
2401,凌陽,110,47,63,富邦-嘉義,2023-08-22,9692
2002,中鋼,66,4,62,富邦-嘉義,2023-08-22,9692
2888,新光金,63,2,61,富邦-嘉義,2023-08-22,9692
2449,京元電子,659,604,55,富邦-嘉義,2023-08-22,9692
1519,華城,324,273,51,富邦-嘉義,2023-08-22,9692
00925,新光標普電動車,50,0,50,富邦-嘉義,2023-08-22,9692
00772B,中信高評級公司債,49,1,48,富邦-嘉義,2023-08-22,9692
4157,太景*-KY,45,0,45,富邦-嘉義,2023-08-22,9692
1471,首利,118,73,45,富邦-嘉義,2023-08-22,9692
2645,長榮航太,50,7,43,富邦-嘉義,2023-08-22,9692
2705,六福,42,0,42,富邦-嘉義,2023-08-22,9692
3714,富采,41,0,41,富邦-嘉義,2023-08-22,9692
2883,凱基金,44,4,40,富邦-嘉義,2023-08-22,9692
2886,兆豐金,36,2,34,富邦-嘉義,2023-08-22,9692
3567,逸昌,46,13,33,富邦-嘉義,2023-08-22,9692
3576,聯合再生,36,5,31,富邦-嘉義,2023-08-22,9692
1609,大亞,35,5,30,富邦-嘉義,2023-08-22,9692
00673R,期元大S＆P原油反1,60,30,30,富邦-嘉義,2023-08-22,9692
00665L,富邦�琤肭磪囓�2,33,3,30,富邦-嘉義,2023-08-22,9692
6235,華孚,55,25,30,富邦-嘉義,2023-08-22,9692
00923,群益台ESG低碳50,29,0,29,富邦-嘉義,2023-08-22,9692
3501,維熹,26,0,26,富邦-嘉義,2023-08-22,9692
4916,事欣科,25,0,25,富邦-嘉義,2023-08-22,9692
5469,瀚宇博,28,3,25,富邦-嘉義,2023-08-22,9692
2323,中環,30,5,25,富邦-嘉義,2023-08-22,9692
1529,樂事綠能,24,0,24,富邦-嘉義,2023-08-22,9692
2884,玉山金,27,4,23,富邦-嘉義,2023-08-22,9692
6122,擎邦,23,2,21,富邦-嘉義,2023-08-22,9692
00655L,國泰中國A50正2,20,0,20,富邦-嘉義,2023-08-22,9692
1591,駿吉-KY,20,0,20,富邦-嘉義,2023-08-22,9692
00679B,元大美債20年,25,5,20,富邦-嘉義,2023-08-22,9692
00751B,元大AAA至A公司債,19,0,19,富邦-嘉義,2023-08-22,9692
6285,啟��,36,17,19,富邦-嘉義,2023-08-22,9692
2880,華南金,19,0,19,富邦-嘉義,2023-08-22,9692
00715L,期街口布蘭特正2,18,0,18,富邦-嘉義,2023-08-22,9692
3312,弘憶股,16,0,16,富邦-嘉義,2023-08-22,9692
2329,華泰,325,309,16,富邦-嘉義,2023-08-22,9692
00900,富邦特選高股息30,19,3,16,富邦-嘉義,2023-08-22,9692
4934,太極,17,2,15,富邦-嘉義,2023-08-22,9692
2363,矽統,557,542,15,富邦-嘉義,2023-08-22,9692
2359,所羅門,21,7,14,富邦-嘉義,2023-08-22,9692
1605,華新,16,2,14,富邦-嘉義,2023-08-22,9692
2363,矽統,3727,2599,1128,富邦-嘉義,2023-08-23,9692
00664R,國泰臺灣加權反1,342,0,342,富邦-嘉義,2023-08-23,9692
2357,華碩,287,53,234,富邦-嘉義,2023-08-23,9692
00632R,元大台灣50反1,708,484,224,富邦-嘉義,2023-08-23,9692
2376,技嘉,241,55,186,富邦-嘉義,2023-08-23,9692
3231,緯創,4163,4016,147,富邦-嘉義,2023-08-23,9692
2419,仲琦,951,808,143,富邦-嘉義,2023-08-23,9692
6125,廣運,214,100,114,富邦-嘉義,2023-08-23,9692
00919,群益台灣精選高息,122,10,112,富邦-嘉義,2023-08-23,9692
2002,中鋼,110,3,107,富邦-嘉義,2023-08-23,9692
00753L,中信中國50正2,111,5,106,富邦-嘉義,2023-08-23,9692
3501,維熹,109,4,105,富邦-嘉義,2023-08-23,9692
6170,統振,371,273,98,富邦-嘉義,2023-08-23,9692
5371,中光電,178,81,97,富邦-嘉義,2023-08-23,9692
2382,廣達,282,197,85,富邦-嘉義,2023-08-23,9692
6285,啟��,140,57,83,富邦-嘉義,2023-08-23,9692
3380,明泰,91,25,66,富邦-嘉義,2023-08-23,9692
2516,新建,65,7,58,富邦-嘉義,2023-08-23,9692
2618,長榮航,186,129,57,富邦-嘉義,2023-08-23,9692
2880,華南金,56,0,56,富邦-嘉義,2023-08-23,9692
9904,寶成,54,0,54,富邦-嘉義,2023-08-23,9692
1316,上曜,51,0,51,富邦-嘉義,2023-08-23,9692
2345,智邦,53,2,51,富邦-嘉義,2023-08-23,9692
3596,智易,50,1,49,富邦-嘉義,2023-08-23,9692
6443,元晶,56,9,47,富邦-嘉義,2023-08-23,9692
2883,凱基金,42,0,42,富邦-嘉義,2023-08-23,9692
4979,華星光,342,308,34,富邦-嘉義,2023-08-23,9692
2303,聯電,47,17,30,富邦-嘉義,2023-08-23,9692
3008,大立光,29,0,29,富邦-嘉義,2023-08-23,9692
3362,先進光,29,0,29,富邦-嘉義,2023-08-23,9692
00712,復華富時不動產,38,10,28,富邦-嘉義,2023-08-23,9692
2603,長榮,30,3,27,富邦-嘉義,2023-08-23,9692
00929,復華台灣科技優息,170,143,27,富邦-嘉義,2023-08-23,9692
2605,新興,38,12,26,富邦-嘉義,2023-08-23,9692
6282,康舒,80,56,24,富邦-嘉義,2023-08-23,9692
2329,華泰,198,174,24,富邦-嘉義,2023-08-23,9692
5521,工信,30,7,23,富邦-嘉義,2023-08-23,9692
2886,兆豐金,26,3,23,富邦-嘉義,2023-08-23,9692
1326,台化,23,1,22,富邦-嘉義,2023-08-23,9692
00772B,中信高評級公司債,22,0,22,富邦-嘉義,2023-08-23,9692
2884,玉山金,23,2,21,富邦-嘉義,2023-08-23,9692
2882,國泰金,20,1,19,富邦-嘉義,2023-08-23,9692
1503,士電,19,0,19,富邦-嘉義,2023-08-23,9692
6222,上揚,20,1,19,富邦-嘉義,2023-08-23,9692
8222,寶一,45,26,19,富邦-嘉義,2023-08-23,9692
8215,明基材,18,1,17,富邦-嘉義,2023-08-23,9692
00679B,元大美債20年,16,0,16,富邦-嘉義,2023-08-23,9692
5608,四維航,21,5,16,富邦-嘉義,2023-08-23,9692
3689,湧德,107,91,16,富邦-嘉義,2023-08-23,9692
2601,益航,39,23,16,富邦-嘉義,2023-08-23,9692
2331,精英,831,114,717,富邦-嘉義,2023-08-24,9692
2332,友訊,860,528,332,富邦-嘉義,2023-08-24,9692
00929,復華台灣科技優息,181,19,162,富邦-嘉義,2023-08-24,9692
2485,兆赫,266,129,137,富邦-嘉義,2023-08-24,9692
2376,技嘉,1135,1014,121,富邦-嘉義,2023-08-24,9692
00882,中信中國高股息,113,1,112,富邦-嘉義,2023-08-24,9692
4543,萬在,215,105,110,富邦-嘉義,2023-08-24,9692
00919,群益台灣精選高息,114,5,109,富邦-嘉義,2023-08-24,9692
3013,晟銘電,196,88,108,富邦-嘉義,2023-08-24,9692
00673R,期元大S＆P原油反1,100,10,90,富邦-嘉義,2023-08-24,9692
2618,長榮航,105,19,86,富邦-嘉義,2023-08-24,9692
5388,中磊,95,9,86,富邦-嘉義,2023-08-24,9692
2601,益航,84,0,84,富邦-嘉義,2023-08-24,9692
00632R,元大台灣50反1,130,55,75,富邦-嘉義,2023-08-24,9692
3707,漢磊,73,4,69,富邦-嘉義,2023-08-24,9692
2349,錸德,70,2,68,富邦-嘉義,2023-08-24,9692
2356,英業達,170,106,64,富邦-嘉義,2023-08-24,9692
2884,玉山金,63,2,61,富邦-嘉義,2023-08-24,9692
2516,新建,68,9,59,富邦-嘉義,2023-08-24,9692
2399,映泰,323,264,59,富邦-嘉義,2023-08-24,9692
2324,仁寶,175,117,58,富邦-嘉義,2023-08-24,9692
2538,基泰,65,10,55,富邦-嘉義,2023-08-24,9692
2880,華南金,58,3,55,富邦-嘉義,2023-08-24,9692
2383,台光電,71,19,52,富邦-嘉義,2023-08-24,9692
3501,維熹,49,0,49,富邦-嘉義,2023-08-24,9692
4207,環泰,52,6,46,富邦-嘉義,2023-08-24,9692
4960,誠美材,43,0,43,富邦-嘉義,2023-08-24,9692
3483,力致,67,29,38,富邦-嘉義,2023-08-24,9692
2609,陽明,67,31,36,富邦-嘉義,2023-08-24,9692
2230,泰茂,37,2,35,富邦-嘉義,2023-08-24,9692
2882,國泰金,35,1,34,富邦-嘉義,2023-08-24,9692
3071,協禧,39,6,33,富邦-嘉義,2023-08-24,9692
1471,首利,73,40,33,富邦-嘉義,2023-08-24,9692
3044,健鼎,61,29,32,富邦-嘉義,2023-08-24,9692
00712,復華富時不動產,30,0,30,富邦-嘉義,2023-08-24,9692
1319,東陽,33,6,27,富邦-嘉義,2023-08-24,9692
2002,中鋼,35,9,26,富邦-嘉義,2023-08-24,9692
6282,康舒,57,32,25,富邦-嘉義,2023-08-24,9692
2702,華園,24,0,24,富邦-嘉義,2023-08-24,9692
3703,欣陸,30,6,24,富邦-嘉義,2023-08-24,9692
6216,居易,27,6,21,富邦-嘉義,2023-08-24,9692
5465,富驊,22,1,21,富邦-嘉義,2023-08-24,9692
3576,聯合再生,19,0,19,富邦-嘉義,2023-08-24,9692
6116,彩晶,20,1,19,富邦-嘉義,2023-08-24,9692
3035,智原,335,316,19,富邦-嘉義,2023-08-24,9692
8996,高力,26,8,18,富邦-嘉義,2023-08-24,9692
2641,正德,18,0,18,富邦-嘉義,2023-08-24,9692
4541,晟田,68,51,17,富邦-嘉義,2023-08-24,9692
00679B,元大美債20年,39,23,16,富邦-嘉義,2023-08-24,9692
3264,欣銓,41,25,16,富邦-嘉義,2023-08-24,9692
00919,群益台灣精選高息,402,0,402,富邦-嘉義,2023-08-25,9692
00878,國泰永續高股息,394,25,369,富邦-嘉義,2023-08-25,9692
3231,緯創,3811,3468,343,富邦-嘉義,2023-08-25,9692
00683L,期元大美元指正2,145,0,145,富邦-嘉義,2023-08-25,9692
00632R,元大台灣50反1,161,17,144,富邦-嘉義,2023-08-25,9692
2382,廣達,3412,3291,121,富邦-嘉義,2023-08-25,9692
2402,毅嘉,134,22,112,富邦-嘉義,2023-08-25,9692
3163,波若威,214,115,99,富邦-嘉義,2023-08-25,9692
00929,復華台灣科技優息,138,44,94,富邦-嘉義,2023-08-25,9692
2449,京元電子,624,534,90,富邦-嘉義,2023-08-25,9692
2883,凱基金,138,50,88,富邦-嘉義,2023-08-25,9692
2892,第一金,85,1,84,富邦-嘉義,2023-08-25,9692
3035,智原,104,35,69,富邦-嘉義,2023-08-25,9692
00900,富邦特選高股息30,65,1,64,富邦-嘉義,2023-08-25,9692
2634,漢翔,127,64,63,富邦-嘉義,2023-08-25,9692
1722,台肥,60,0,60,富邦-嘉義,2023-08-25,9692
3037,欣興,91,31,60,富邦-嘉義,2023-08-25,9692
2630,亞航,135,76,59,富邦-嘉義,2023-08-25,9692
2419,仲琦,185,127,58,富邦-嘉義,2023-08-25,9692
2618,長榮航,86,29,57,富邦-嘉義,2023-08-25,9692
2913,農林,56,0,56,富邦-嘉義,2023-08-25,9692
2834,臺企銀,57,2,55,富邦-嘉義,2023-08-25,9692
6245,立端,63,10,53,富邦-嘉義,2023-08-25,9692
1905,華紙,52,2,50,富邦-嘉義,2023-08-25,9692
2409,友達,63,14,49,富邦-嘉義,2023-08-25,9692
3715,定穎投控,60,13,47,富邦-嘉義,2023-08-25,9692
00882,中信中國高股息,52,5,47,富邦-嘉義,2023-08-25,9692
2421,建準,136,89,47,富邦-嘉義,2023-08-25,9692
2303,聯電,49,3,46,富邦-嘉義,2023-08-25,9692
00665L,富邦�琤肭磪囓�2,44,0,44,富邦-嘉義,2023-08-25,9692
6168,宏齊,152,108,44,富邦-嘉義,2023-08-25,9692
2301,光寶科,508,466,42,富邦-嘉義,2023-08-25,9692
2002,中鋼,49,8,41,富邦-嘉義,2023-08-25,9692
2392,正崴,47,7,40,富邦-嘉義,2023-08-25,9692
0056,元大高股息,92,56,36,富邦-嘉義,2023-08-25,9692
2330,台積電,43,8,35,富邦-嘉義,2023-08-25,9692
2890,永豐金,33,0,33,富邦-嘉義,2023-08-25,9692
2349,錸德,30,0,30,富邦-嘉義,2023-08-25,9692
4960,誠美材,42,14,28,富邦-嘉義,2023-08-25,9692
3707,漢磊,30,2,28,富邦-嘉義,2023-08-25,9692
2324,仁寶,79,53,26,富邦-嘉義,2023-08-25,9692
4944,兆遠,30,3,27,富邦-嘉義,2023-08-25,9692
1301,台塑,27,2,25,富邦-嘉義,2023-08-25,9692
3706,神達,48,23,25,富邦-嘉義,2023-08-25,9692
00773B,中信優先金融債,25,0,25,富邦-嘉義,2023-08-25,9692
2538,基泰,25,0,25,富邦-嘉義,2023-08-25,9692
00922,國泰台灣領袖50,25,0,25,富邦-嘉義,2023-08-25,9692
3308,聯德,234,209,25,富邦-嘉義,2023-08-25,9692
6282,康舒,48,25,23,富邦-嘉義,2023-08-25,9692
4916,事欣科,28,5,23,富邦-嘉義,2023-08-25,9692
2888,新光金,405,30,375,富邦-嘉義,2023-08-28,9692
8222,寶一,667,376,291,富邦-嘉義,2023-08-28,9692
2363,矽統,522,248,274,富邦-嘉義,2023-08-28,9692
00919,群益台灣精選高息,219,1,218,富邦-嘉義,2023-08-28,9692
00929,復華台灣科技優息,310,136,174,富邦-嘉義,2023-08-28,9692
00632R,元大台灣50反1,158,0,158,富邦-嘉義,2023-08-28,9692
4906,正文,347,193,154,富邦-嘉義,2023-08-28,9692
00753L,中信中國50正2,150,9,141,富邦-嘉義,2023-08-28,9692
00878,國泰永續高股息,157,24,133,富邦-嘉義,2023-08-28,9692
2323,中環,116,5,111,富邦-嘉義,2023-08-28,9692
2603,長榮,113,3,110,富邦-嘉義,2023-08-28,9692
2376,技嘉,150,50,100,富邦-嘉義,2023-08-28,9692
2331,精英,233,137,96,富邦-嘉義,2023-08-28,9692
3481,群創,113,29,84,富邦-嘉義,2023-08-28,9692
3011,今皓,84,2,82,富邦-嘉義,2023-08-28,9692
2601,益航,77,2,75,富邦-嘉義,2023-08-28,9692
6245,立端,74,0,74,富邦-嘉義,2023-08-28,9692
2485,兆赫,238,178,60,富邦-嘉義,2023-08-28,9692
1217,愛之味,65,6,59,富邦-嘉義,2023-08-28,9692
2618,長榮航,118,60,58,富邦-嘉義,2023-08-28,9692
3308,聯德,161,103,58,富邦-嘉義,2023-08-28,9692
8054,安國,50,0,50,富邦-嘉義,2023-08-28,9692
2332,友訊,97,50,47,富邦-嘉義,2023-08-28,9692
2355,敬鵬,77,37,40,富邦-嘉義,2023-08-28,9692
2388,威盛,74,37,37,富邦-嘉義,2023-08-28,9692
6111,大宇資,33,1,32,富邦-嘉義,2023-08-28,9692
4533,協易機,34,2,32,富邦-嘉義,2023-08-28,9692
4960,誠美材,32,1,31,富邦-嘉義,2023-08-28,9692
6188,廣明,40,11,29,富邦-嘉義,2023-08-28,9692
2537,聯上發,40,11,29,富邦-嘉義,2023-08-28,9692
6829,千附精密,175,146,29,富邦-嘉義,2023-08-28,9692
2884,玉山金,59,32,27,富邦-嘉義,2023-08-28,9692
6191,精成科,37,11,26,富邦-嘉義,2023-08-28,9692
4977,眾達-KY,30,4,26,富邦-嘉義,2023-08-28,9692
2344,華邦電,26,2,24,富邦-嘉義,2023-08-28,9692
1101,台泥,25,2,23,富邦-嘉義,2023-08-28,9692
2634,漢翔,529,506,23,富邦-嘉義,2023-08-28,9692
8016,矽創,23,1,22,富邦-嘉義,2023-08-28,9692
4510,高鋒,22,0,22,富邦-嘉義,2023-08-28,9692
3051,力特,130,109,21,富邦-嘉義,2023-08-28,9692
2419,仲琦,28,7,21,富邦-嘉義,2023-08-28,9692
2369,菱生,96,75,21,富邦-嘉義,2023-08-28,9692
4543,萬在,24,3,21,富邦-嘉義,2023-08-28,9692
6170,統振,22,2,20,富邦-嘉義,2023-08-28,9692
6285,啟��,38,19,19,富邦-嘉義,2023-08-28,9692
4743,合一,20,1,19,富邦-嘉義,2023-08-28,9692
6222,上揚,19,0,19,富邦-嘉義,2023-08-28,9692
4207,環泰,20,1,19,富邦-嘉義,2023-08-28,9692
2405,輔信,19,0,19,富邦-嘉義,2023-08-28,9692
3032,偉訓,19,1,18,富邦-嘉義,2023-08-28,9692
2331,精英,261,59,202,富邦-嘉義,2023-08-29,9692
00919,群益台灣精選高息,164,2,162,富邦-嘉義,2023-08-29,9692
00753L,中信中國50正2,103,0,103,富邦-嘉義,2023-08-29,9692
2208,台船,100,0,100,富邦-嘉義,2023-08-29,9692
00929,復華台灣科技優息,94,1,93,富邦-嘉義,2023-08-29,9692
2634,漢翔,149,62,87,富邦-嘉義,2023-08-29,9692
6245,立端,59,1,58,富邦-嘉義,2023-08-29,9692
00885,富邦越南,65,10,55,富邦-嘉義,2023-08-29,9692
2002,中鋼,54,0,54,富邦-嘉義,2023-08-29,9692
2317,鴻海,93,40,53,富邦-嘉義,2023-08-29,9692
2392,正崴,47,1,46,富邦-嘉義,2023-08-29,9692
2303,聯電,75,30,45,富邦-嘉義,2023-08-29,9692
3481,群創,57,14,43,富邦-嘉義,2023-08-29,9692
2352,佳世達,46,5,41,富邦-嘉義,2023-08-29,9692
2884,玉山金,38,7,31,富邦-嘉義,2023-08-29,9692
2329,華泰,94,63,31,富邦-嘉義,2023-08-29,9692
2349,錸德,30,0,30,富邦-嘉義,2023-08-29,9692
3231,緯創,267,241,26,富邦-嘉義,2023-08-29,9692
00900,富邦特選高股息30,28,4,24,富邦-嘉義,2023-08-29,9692
6222,上揚,23,0,23,富邦-嘉義,2023-08-29,9692
4944,兆遠,21,0,21,富邦-嘉義,2023-08-29,9692
2340,台亞,36,15,21,富邦-嘉義,2023-08-29,9692
1409,新纖,21,1,20,富邦-嘉義,2023-08-29,9692
3325,旭品,20,2,18,富邦-嘉義,2023-08-29,9692
1514,亞力,20,3,17,富邦-嘉義,2023-08-29,9692
6167,久正,72,55,17,富邦-嘉義,2023-08-29,9692
2382,廣達,74,58,16,富邦-嘉義,2023-08-29,9692
1802,台玻,15,0,15,富邦-嘉義,2023-08-29,9692
3706,神達,19,4,15,富邦-嘉義,2023-08-29,9692
8033,雷虎,25,11,14,富邦-嘉義,2023-08-29,9692
2356,英業達,36,23,13,富邦-嘉義,2023-08-29,9692
2312,金寶,15,2,13,富邦-嘉義,2023-08-29,9692
2485,兆赫,97,84,13,富邦-嘉義,2023-08-29,9692
2355,敬鵬,20,7,13,富邦-嘉義,2023-08-29,9692
2436,偉詮電,76,63,13,富邦-嘉義,2023-08-29,9692
00878,國泰永續高股息,43,30,13,富邦-嘉義,2023-08-29,9692
1737,臺鹽,13,1,12,富邦-嘉義,2023-08-29,9692
6216,居易,12,0,12,富邦-嘉義,2023-08-29,9692
3163,波若威,13,1,12,富邦-嘉義,2023-08-29,9692
3062,建漢,28,16,12,富邦-嘉義,2023-08-29,9692
00772B,中信高評級公司債,12,0,12,富邦-嘉義,2023-08-29,9692
2376,技嘉,59,48,11,富邦-嘉義,2023-08-29,9692
2377,微星,13,2,11,富邦-嘉義,2023-08-29,9692
2630,亞航,237,227,10,富邦-嘉義,2023-08-29,9692
4934,太極,10,0,10,富邦-嘉義,2023-08-29,9692
1217,愛之味,12,2,10,富邦-嘉義,2023-08-29,9692
5880,合庫金,10,0,10,富邦-嘉義,2023-08-29,9692
4908,前鼎,11,1,10,富邦-嘉義,2023-08-29,9692
1304,台聚,10,0,10,富邦-嘉義,2023-08-29,9692
5864,致和證,10,0,10,富邦-嘉義,2023-08-29,9692
3715,定穎投控,805,221,584,富邦-嘉義,2023-08-30,9692
2436,偉詮電,494,268,226,富邦-嘉義,2023-08-30,9692
00673R,期元大S＆P原油反1,212,0,212,富邦-嘉義,2023-08-30,9692
2390,云辰,188,75,113,富邦-嘉義,2023-08-30,9692
00637L,元大滬深300正2,109,0,109,富邦-嘉義,2023-08-30,9692
00919,群益台灣精選高息,99,2,97,富邦-嘉義,2023-08-30,9692
2618,長榮航,158,64,94,富邦-嘉義,2023-08-30,9692
3481,群創,115,27,88,富邦-嘉義,2023-08-30,9692
2329,華泰,130,53,77,富邦-嘉義,2023-08-30,9692
2610,華航,64,12,52,富邦-嘉義,2023-08-30,9692
3661,世芯-KY,74,25,49,富邦-嘉義,2023-08-30,9692
3035,智原,431,387,44,富邦-嘉義,2023-08-30,9692
6547,高端疫苗,51,9,42,富邦-嘉義,2023-08-30,9692
00665L,富邦�琤肭磪囓�2,57,15,42,富邦-嘉義,2023-08-30,9692
00929,復華台灣科技優息,52,15,37,富邦-嘉義,2023-08-30,9692
00753L,中信中國50正2,50,15,35,富邦-嘉義,2023-08-30,9692
3714,富采,36,1,35,富邦-嘉義,2023-08-30,9692
5009,榮剛,57,25,32,富邦-嘉義,2023-08-30,9692
2449,京元電子,75,43,32,富邦-嘉義,2023-08-30,9692
2630,亞航,101,70,31,富邦-嘉義,2023-08-30,9692
6446,藥華藥,31,2,29,富邦-嘉義,2023-08-30,9692
6188,廣明,35,7,28,富邦-嘉義,2023-08-30,9692
1519,華城,134,106,28,富邦-嘉義,2023-08-30,9692
6282,康舒,36,9,27,富邦-嘉義,2023-08-30,9692
2888,新光金,366,339,27,富邦-嘉義,2023-08-30,9692
3058,立德,26,0,26,富邦-嘉義,2023-08-30,9692
2301,光寶科,75,49,26,富邦-嘉義,2023-08-30,9692
5210,寶碩,25,0,25,富邦-嘉義,2023-08-30,9692
1417,嘉裕,25,0,25,富邦-嘉義,2023-08-30,9692
2409,友達,38,17,21,富邦-嘉義,2023-08-30,9692
3707,漢磊,30,9,21,富邦-嘉義,2023-08-30,9692
00632R,元大台灣50反1,23,2,21,富邦-嘉義,2023-08-30,9692
5289,宜鼎,20,0,20,富邦-嘉義,2023-08-30,9692
3094,聯傑,25,5,20,富邦-嘉義,2023-08-30,9692
2645,長榮航太,26,6,20,富邦-嘉義,2023-08-30,9692
2208,台船,36,17,19,富邦-嘉義,2023-08-30,9692
00773B,中信優先金融債,18,1,17,富邦-嘉義,2023-08-30,9692
1305,華夏,17,0,17,富邦-嘉義,2023-08-30,9692
2540,愛山林,19,2,17,富邦-嘉義,2023-08-30,9692
4148,全宇生技-KY,17,1,16,富邦-嘉義,2023-08-30,9692
3176,基亞,17,1,16,富邦-嘉義,2023-08-30,9692
2834,臺企銀,19,4,15,富邦-嘉義,2023-08-30,9692
00676R,富邦臺灣加權反1,25,10,15,富邦-嘉義,2023-08-30,9692
2897,王道銀行,15,0,15,富邦-嘉義,2023-08-30,9692
2892,第一金,16,2,14,富邦-嘉義,2023-08-30,9692
2356,英業達,46,32,14,富邦-嘉義,2023-08-30,9692
2324,仁寶,30,17,13,富邦-嘉義,2023-08-30,9692
2317,鴻海,49,35,14,富邦-嘉義,2023-08-30,9692
0056,元大高股息,22,9,13,富邦-嘉義,2023-08-30,9692
4960,誠美材,13,0,13,富邦-嘉義,2023-08-30,9692
3231,緯創,6068,5433,635,富邦-嘉義,2023-08-31,9692
2402,毅嘉,865,270,595,富邦-嘉義,2023-08-31,9692
2363,矽統,1192,704,488,富邦-嘉義,2023-08-31,9692
2883,凱基金,384,49,335,富邦-嘉義,2023-08-31,9692
00919,群益台灣精選高息,222,2,220,富邦-嘉義,2023-08-31,9692
2331,精英,294,84,210,富邦-嘉義,2023-08-31,9692
2630,亞航,125,5,120,富邦-嘉義,2023-08-31,9692
2313,華通,107,15,92,富邦-嘉義,2023-08-31,9692
6213,聯茂,141,52,89,富邦-嘉義,2023-08-31,9692
2329,華泰,892,804,88,富邦-嘉義,2023-08-31,9692
3481,群創,92,6,86,富邦-嘉義,2023-08-31,9692
3308,聯德,83,0,83,富邦-嘉義,2023-08-31,9692
6122,擎邦,142,67,75,富邦-嘉義,2023-08-31,9692
00929,復華台灣科技優息,70,11,59,富邦-嘉義,2023-08-31,9692
2105,正新,53,4,49,富邦-嘉義,2023-08-31,9692
2610,華航,69,22,47,富邦-嘉義,2023-08-31,9692
1326,台化,51,5,46,富邦-嘉義,2023-08-31,9692
6139,亞翔,65,20,45,富邦-嘉義,2023-08-31,9692
2834,臺企銀,46,2,44,富邦-嘉義,2023-08-31,9692
4909,新復興,55,11,44,富邦-嘉義,2023-08-31,9692
00882,中信中國高股息,42,0,42,富邦-嘉義,2023-08-31,9692
2887,台新金,42,2,40,富邦-嘉義,2023-08-31,9692
6125,廣運,127,88,39,富邦-嘉義,2023-08-31,9692
2382,廣達,400,361,39,富邦-嘉義,2023-08-31,9692
2323,中環,38,0,38,富邦-嘉義,2023-08-31,9692
4414,如興,47,10,37,富邦-嘉義,2023-08-31,9692
2455,全新,46,11,35,富邦-嘉義,2023-08-31,9692
2801,彰銀,34,0,34,富邦-嘉義,2023-08-31,9692
8927,北基,38,4,34,富邦-嘉義,2023-08-31,9692
2376,技嘉,280,246,34,富邦-嘉義,2023-08-31,9692
2884,玉山金,32,1,31,富邦-嘉義,2023-08-31,9692
00671R,富邦NASDAQ反1,30,0,30,富邦-嘉義,2023-08-31,9692
2371,大同,31,2,29,富邦-嘉義,2023-08-31,9692
2324,仁寶,35,7,28,富邦-嘉義,2023-08-31,9692
2880,華南金,28,0,28,富邦-嘉義,2023-08-31,9692
2002,中鋼,25,0,25,富邦-嘉義,2023-08-31,9692
2383,台光電,83,58,25,富邦-嘉義,2023-08-31,9692
8358,金居,74,49,25,富邦-嘉義,2023-08-31,9692
2603,長榮,30,6,24,富邦-嘉義,2023-08-31,9692
2892,第一金,28,5,23,富邦-嘉義,2023-08-31,9692
00878,國泰永續高股息,29,6,23,富邦-嘉義,2023-08-31,9692
8936,國統,21,0,21,富邦-嘉義,2023-08-31,9692
4979,華星光,39,18,21,富邦-嘉義,2023-08-31,9692
1802,台玻,64,45,19,富邦-嘉義,2023-08-31,9692
6216,居易,20,1,19,富邦-嘉義,2023-08-31,9692
8050,廣積,42,24,18,富邦-嘉義,2023-08-31,9692
3362,先進光,40,22,18,富邦-嘉義,2023-08-31,9692
2890,永豐金,18,1,17,富邦-嘉義,2023-08-31,9692
8271,宇瞻,18,1,17,富邦-嘉義,2023-08-31,9692
4916,事欣科,23,6,17,富邦-嘉義,2023-08-31,9692
00919,群益台灣精選高息,706,9,697,富邦-嘉義,2023-09-01,9692
00673R,期元大S＆P原油反1,374,20,354,富邦-嘉義,2023-09-01,9692
2634,漢翔,326,181,145,富邦-嘉義,2023-09-01,9692
2603,長榮,104,21,83,富邦-嘉義,2023-09-01,9692
2356,英業達,124,42,82,富邦-嘉義,2023-09-01,9692
6547,高端疫苗,118,43,75,富邦-嘉義,2023-09-01,9692
00932,兆豐永續高息等權,74,0,74,富邦-嘉義,2023-09-01,9692
2887,台新金,70,5,65,富邦-嘉義,2023-09-01,9692
3715,定穎投控,149,86,63,富邦-嘉義,2023-09-01,9692
2886,兆豐金,51,0,51,富邦-嘉義,2023-09-01,9692
3588,通嘉,80,29,51,富邦-嘉義,2023-09-01,9692
2313,華通,65,16,49,富邦-嘉義,2023-09-01,9692
2355,敬鵬,101,54,47,富邦-嘉義,2023-09-01,9692
3432,台端,50,6,44,富邦-嘉義,2023-09-01,9692
2516,新建,52,9,43,富邦-嘉義,2023-09-01,9692
3231,緯創,3030,2998,32,富邦-嘉義,2023-09-01,9692
2436,偉詮電,34,2,32,富邦-嘉義,2023-09-01,9692
6192,巨路,30,0,30,富邦-嘉義,2023-09-01,9692
3673,TPK-KY,30,0,30,富邦-嘉義,2023-09-01,9692
1718,中纖,28,0,28,富邦-嘉義,2023-09-01,9692
00900,富邦特選高股息30,29,2,27,富邦-嘉義,2023-09-01,9692
6282,康舒,36,11,25,富邦-嘉義,2023-09-01,9692
6216,居易,25,0,25,富邦-嘉義,2023-09-01,9692
4414,如興,25,0,25,富邦-嘉義,2023-09-01,9692
3714,富采,35,10,25,富邦-嘉義,2023-09-01,9692
1101,台泥,26,2,24,富邦-嘉義,2023-09-01,9692
00929,復華台灣科技優息,147,123,24,富邦-嘉義,2023-09-01,9692
6213,聯茂,117,95,22,富邦-嘉義,2023-09-01,9692
1514,亞力,34,12,22,富邦-嘉義,2023-09-01,9692
1795,美時,39,18,21,富邦-嘉義,2023-09-01,9692
00882,中信中國高股息,21,0,21,富邦-嘉義,2023-09-01,9692
1319,東陽,34,13,21,富邦-嘉義,2023-09-01,9692
3094,聯傑,28,7,21,富邦-嘉義,2023-09-01,9692
6152,百一,20,0,20,富邦-嘉義,2023-09-01,9692
6248,沛波,20,0,20,富邦-嘉義,2023-09-01,9692
2601,益航,20,0,20,富邦-嘉義,2023-09-01,9692
1301,台塑,19,0,19,富邦-嘉義,2023-09-01,9692
2618,長榮航,54,35,19,富邦-嘉義,2023-09-01,9692
5452,佶優,20,2,18,富邦-嘉義,2023-09-01,9692
1727,中華化,22,4,18,富邦-嘉義,2023-09-01,9692
3689,湧德,19,1,18,富邦-嘉義,2023-09-01,9692
2301,光寶科,130,113,17,富邦-嘉義,2023-09-01,9692
2303,聯電,31,14,17,富邦-嘉義,2023-09-01,9692
1605,華新,32,16,16,富邦-嘉義,2023-09-01,9692
2368,金像電,127,111,16,富邦-嘉義,2023-09-01,9692
3059,華晶科,97,81,16,富邦-嘉義,2023-09-01,9692
8421,旭源,16,0,16,富邦-嘉義,2023-09-01,9692
4944,兆遠,46,30,16,富邦-嘉義,2023-09-01,9692
2458,義隆,18,3,15,富邦-嘉義,2023-09-01,9692
1815,富喬,17,2,15,富邦-嘉義,2023-09-01,9692
3014,聯陽,561,83,478,富邦-嘉義,2023-09-04,9692
00915,凱基優選高股息30,294,0,294,富邦-嘉義,2023-09-04,9692
00673R,期元大S＆P原油反1,365,90,275,富邦-嘉義,2023-09-04,9692
6122,擎邦,529,297,232,富邦-嘉義,2023-09-04,9692
3715,定穎投控,449,257,192,富邦-嘉義,2023-09-04,9692
5488,松普,132,7,125,富邦-嘉義,2023-09-04,9692
00929,復華台灣科技優息,250,136,114,富邦-嘉義,2023-09-04,9692
00753L,中信中國50正2,106,1,105,富邦-嘉義,2023-09-04,9692
6213,聯茂,466,375,91,富邦-嘉義,2023-09-04,9692
3711,日月光投控,88,5,83,富邦-嘉義,2023-09-04,9692
2409,友達,84,9,75,富邦-嘉義,2023-09-04,9692
00922,國泰台灣領袖50,70,5,65,富邦-嘉義,2023-09-04,9692
00919,群益台灣精選高息,96,32,64,富邦-嘉義,2023-09-04,9692
1802,台玻,460,400,60,富邦-嘉義,2023-09-04,9692
3163,波若威,72,19,53,富邦-嘉義,2023-09-04,9692
2206,三陽工業,62,10,52,富邦-嘉義,2023-09-04,9692
2358,廷鑫,54,7,47,富邦-嘉義,2023-09-04,9692
00751B,元大AAA至A公司債,40,0,40,富邦-嘉義,2023-09-04,9692
2323,中環,77,37,40,富邦-嘉義,2023-09-04,9692
1104,環泥,40,0,40,富邦-嘉義,2023-09-04,9692
2355,敬鵬,50,11,39,富邦-嘉義,2023-09-04,9692
2204,中華,933,894,39,富邦-嘉義,2023-09-04,9692
00932,兆豐永續高息等權,37,1,36,富邦-嘉義,2023-09-04,9692
2371,大同,404,369,35,富邦-嘉義,2023-09-04,9692
4906,正文,104,71,33,富邦-嘉義,2023-09-04,9692
2405,輔信,34,3,31,富邦-嘉義,2023-09-04,9692
3622,洋華,41,11,30,富邦-嘉義,2023-09-04,9692
00687B,國泰20年美債,30,0,30,富邦-嘉義,2023-09-04,9692
2449,京元電子,40,13,27,富邦-嘉義,2023-09-04,9692
00931B,統一美債20年,27,0,27,富邦-嘉義,2023-09-04,9692
1101,台泥,28,1,27,富邦-嘉義,2023-09-04,9692
6175,立敦,26,0,26,富邦-嘉義,2023-09-04,9692
00878,國泰永續高股息,61,36,25,富邦-嘉義,2023-09-04,9692
3362,先進光,36,11,25,富邦-嘉義,2023-09-04,9692
2436,偉詮電,742,717,25,富邦-嘉義,2023-09-04,9692
2601,益航,24,2,22,富邦-嘉義,2023-09-04,9692
1608,華榮,24,2,22,富邦-嘉義,2023-09-04,9692
2488,漢平,22,0,22,富邦-嘉義,2023-09-04,9692
5381,合正,62,41,21,富邦-嘉義,2023-09-04,9692
1609,大亞,23,3,20,富邦-嘉義,2023-09-04,9692
1616,億泰,27,7,20,富邦-嘉義,2023-09-04,9692
2881,富邦金,28,8,20,富邦-嘉義,2023-09-04,9692
00655L,國泰中國A50正2,25,6,19,富邦-嘉義,2023-09-04,9692
1533,車王電,25,6,19,富邦-嘉義,2023-09-04,9692
6531,愛普*,27,8,19,富邦-嘉義,2023-09-04,9692
2337,旺宏,26,7,19,富邦-嘉義,2023-09-04,9692
2344,華邦電,32,13,19,富邦-嘉義,2023-09-04,9692
00679B,元大美債20年,20,2,18,富邦-嘉義,2023-09-04,9692
2472,立隆電,21,3,18,富邦-嘉義,2023-09-04,9692
2331,精英,164,147,17,富邦-嘉義,2023-09-04,9692
2485,兆赫,963,40,923,富邦-嘉義,2023-09-05,9692
5381,合正,875,429,446,富邦-嘉義,2023-09-05,9692
00915,凱基優選高股息30,367,0,367,富邦-嘉義,2023-09-05,9692
5432,新門,295,3,292,富邦-嘉義,2023-09-05,9692
6274,台燿,1550,1270,280,富邦-嘉義,2023-09-05,9692
2401,凌陽,554,309,245,富邦-嘉義,2023-09-05,9692
2363,矽統,382,171,211,富邦-嘉義,2023-09-05,9692
5469,瀚宇博,215,50,165,富邦-嘉義,2023-09-05,9692
2382,廣達,140,21,119,富邦-嘉義,2023-09-05,9692
00753L,中信中國50正2,102,0,102,富邦-嘉義,2023-09-05,9692
00929,復華台灣科技優息,358,270,88,富邦-嘉義,2023-09-05,9692
3035,智原,318,231,87,富邦-嘉義,2023-09-05,9692
1101,台泥,87,1,86,富邦-嘉義,2023-09-05,9692
2634,漢翔,103,18,85,富邦-嘉義,2023-09-05,9692
00919,群益台灣精選高息,97,13,84,富邦-嘉義,2023-09-05,9692
3231,緯創,220,140,80,富邦-嘉義,2023-09-05,9692
2534,宏盛,60,0,60,富邦-嘉義,2023-09-05,9692
3481,群創,51,11,40,富邦-嘉義,2023-09-05,9692
2881,富邦金,42,1,41,富邦-嘉義,2023-09-05,9692
00931B,統一美債20年,34,0,34,富邦-嘉義,2023-09-05,9692
8110,華東,86,52,34,富邦-嘉義,2023-09-05,9692
1409,新纖,32,0,32,富邦-嘉義,2023-09-05,9692
8436,大江,44,13,31,富邦-嘉義,2023-09-05,9692
00932,兆豐永續高息等權,30,0,30,富邦-嘉義,2023-09-05,9692
2601,益航,29,0,29,富邦-嘉義,2023-09-05,9692
6625,必應,30,1,29,富邦-嘉義,2023-09-05,9692
00712,復華富時不動產,32,3,29,富邦-嘉義,2023-09-05,9692
8255,朋程,30,2,28,富邦-嘉義,2023-09-05,9692
6770,力積電,57,29,28,富邦-嘉義,2023-09-05,9692
5371,中光電,32,4,28,富邦-嘉義,2023-09-05,9692
3324,雙鴻,73,45,28,富邦-嘉義,2023-09-05,9692
8222,寶一,33,6,27,富邦-嘉義,2023-09-05,9692
2356,英業達,69,42,27,富邦-嘉義,2023-09-05,9692
2610,華航,64,38,26,富邦-嘉義,2023-09-05,9692
2324,仁寶,42,17,25,富邦-嘉義,2023-09-05,9692
00679B,元大美債20年,26,1,25,富邦-嘉義,2023-09-05,9692
2633,台灣高鐵,24,0,24,富邦-嘉義,2023-09-05,9692
8358,金居,496,472,24,富邦-嘉義,2023-09-05,9692
3617,碩天,35,13,22,富邦-嘉義,2023-09-05,9692
6158,禾昌,22,0,22,富邦-嘉義,2023-09-05,9692
00930,永豐ESG低碳高息,25,4,21,富邦-嘉義,2023-09-05,9692
00637L,元大滬深300正2,53,32,21,富邦-嘉義,2023-09-05,9692
00907,永豐優息存股,21,0,21,富邦-嘉義,2023-09-05,9692
6235,華孚,44,24,20,富邦-嘉義,2023-09-05,9692
00857B,永豐20年美公債,20,0,20,富邦-嘉義,2023-09-05,9692
1905,華紙,20,0,20,富邦-嘉義,2023-09-05,9692
00676R,富邦臺灣加權反1,20,0,20,富邦-嘉義,2023-09-05,9692
2301,光寶科,39,19,20,富邦-嘉義,2023-09-05,9692
00717,富邦美國特別股,21,2,19,富邦-嘉義,2023-09-05,9692
00900,富邦特選高股息30,38,19,19,富邦-嘉義,2023-09-05,9692
2367,燿華,580,6,574,富邦-嘉義,2023-09-06,9692
6285,啟��,825,338,487,富邦-嘉義,2023-09-06,9692
00929,復華台灣科技優息,715,322,393,富邦-嘉義,2023-09-06,9692
3481,群創,467,134,333,富邦-嘉義,2023-09-06,9692
00915,凱基優選高股息30,253,1,252,富邦-嘉義,2023-09-06,9692
2356,英業達,939,723,216,富邦-嘉義,2023-09-06,9692
2492,華新科,238,41,197,富邦-嘉義,2023-09-06,9692
6114,久威,190,0,190,富邦-嘉義,2023-09-06,9692
00673R,期元大S＆P原油反1,170,0,170,富邦-嘉義,2023-09-06,9692
2409,友達,150,34,116,富邦-嘉義,2023-09-06,9692
00919,群益台灣精選高息,192,83,109,富邦-嘉義,2023-09-06,9692
6122,擎邦,108,15,93,富邦-嘉義,2023-09-06,9692
3704,合勤控,106,15,91,富邦-嘉義,2023-09-06,9692
1101,台泥,91,5,86,富邦-嘉義,2023-09-06,9692
4908,前鼎,200,116,84,富邦-嘉義,2023-09-06,9692
8086,宏捷科,188,126,62,富邦-嘉義,2023-09-06,9692
00931B,統一美債20年,57,0,57,富邦-嘉義,2023-09-06,9692
2382,廣達,294,243,51,富邦-嘉義,2023-09-06,9692
6117,迎廣,81,30,51,富邦-嘉義,2023-09-06,9692
2601,益航,50,1,49,富邦-嘉義,2023-09-06,9692
2385,群光,50,1,49,富邦-嘉義,2023-09-06,9692
1905,華紙,46,0,46,富邦-嘉義,2023-09-06,9692
00679B,元大美債20年,45,0,45,富邦-嘉義,2023-09-06,9692
2634,漢翔,50,7,43,富邦-嘉義,2023-09-06,9692
2402,毅嘉,165,122,43,富邦-嘉義,2023-09-06,9692
6176,瑞儀,49,8,41,富邦-嘉義,2023-09-06,9692
2891,中信金,41,1,40,富邦-嘉義,2023-09-06,9692
5880,合庫金,39,0,39,富邦-嘉義,2023-09-06,9692
00713,元大台灣高息低波,40,1,39,富邦-嘉義,2023-09-06,9692
5469,瀚宇博,68,29,39,富邦-嘉義,2023-09-06,9692
2603,長榮,40,2,38,富邦-嘉義,2023-09-06,9692
6016,康和證,37,0,37,富邦-嘉義,2023-09-06,9692
2881,富邦金,39,4,35,富邦-嘉義,2023-09-06,9692
2884,玉山金,40,5,35,富邦-嘉義,2023-09-06,9692
2421,建準,44,10,34,富邦-嘉義,2023-09-06,9692
00720B,元大投資級公司債,33,0,33,富邦-嘉義,2023-09-06,9692
6531,愛普*,41,12,29,富邦-嘉義,2023-09-06,9692
00902,中信電池及儲能,27,0,27,富邦-嘉義,2023-09-06,9692
2316,楠梓電,83,56,27,富邦-嘉義,2023-09-06,9692
2344,華邦電,31,5,26,富邦-嘉義,2023-09-06,9692
00772B,中信高評級公司債,27,1,26,富邦-嘉義,2023-09-06,9692
8054,安國,25,0,25,富邦-嘉義,2023-09-06,9692
1409,新纖,25,0,25,富邦-嘉義,2023-09-06,9692
6541,泰福-KY,24,0,24,富邦-嘉義,2023-09-06,9692
00932,兆豐永續高息等權,24,0,24,富邦-嘉義,2023-09-06,9692
00930,永豐ESG低碳高息,23,0,23,富邦-嘉義,2023-09-06,9692
4148,全宇生技-KY,32,9,23,富邦-嘉義,2023-09-06,9692
2369,菱生,92,71,21,富邦-嘉義,2023-09-06,9692
3311,閎暉,24,3,21,富邦-嘉義,2023-09-06,9692
3032,偉訓,31,10,21,富邦-嘉義,2023-09-06,9692
3231,緯創,3031,1832,1199,富邦-嘉義,2023-09-07,9692
00929,復華台灣科技優息,466,130,336,富邦-嘉義,2023-09-07,9692
00919,群益台灣精選高息,272,2,270,富邦-嘉義,2023-09-07,9692
00915,凱基優選高股息30,201,0,201,富邦-嘉義,2023-09-07,9692
2367,燿華,166,10,156,富邦-嘉義,2023-09-07,9692
2329,華泰,147,9,138,富邦-嘉義,2023-09-07,9692
4906,正文,169,36,133,富邦-嘉義,2023-09-07,9692
2601,益航,120,0,120,富邦-嘉義,2023-09-07,9692
00632R,元大台灣50反1,123,9,114,富邦-嘉義,2023-09-07,9692
00932,兆豐永續高息等權,119,20,99,富邦-嘉義,2023-09-07,9692
3481,群創,109,13,96,富邦-嘉義,2023-09-07,9692
2358,廷鑫,402,306,96,富邦-嘉義,2023-09-07,9692
2313,華通,153,57,96,富邦-嘉義,2023-09-07,9692
00902,中信電池及儲能,91,0,91,富邦-嘉義,2023-09-07,9692
2409,友達,139,59,80,富邦-嘉義,2023-09-07,9692
2332,友訊,80,2,78,富邦-嘉義,2023-09-07,9692
9928,中視,75,2,73,富邦-嘉義,2023-09-07,9692
2884,玉山金,71,0,71,富邦-嘉義,2023-09-07,9692
6125,廣運,78,10,68,富邦-嘉義,2023-09-07,9692
6672,騰輝電子-KY,63,5,58,富邦-嘉義,2023-09-07,9692
3548,兆利,135,78,57,富邦-嘉義,2023-09-07,9692
4915,致伸,55,4,51,富邦-嘉義,2023-09-07,9692
2486,一詮,238,187,51,富邦-嘉義,2023-09-07,9692
5452,佶優,52,1,51,富邦-嘉義,2023-09-07,9692
5344,立衛,50,0,50,富邦-嘉義,2023-09-07,9692
2002,中鋼,59,12,47,富邦-嘉義,2023-09-07,9692
8277,商丞,47,0,47,富邦-嘉義,2023-09-07,9692
2455,全新,109,66,43,富邦-嘉義,2023-09-07,9692
2383,台光電,42,0,42,富邦-嘉義,2023-09-07,9692
2705,六福,42,0,42,富邦-嘉義,2023-09-07,9692
3213,茂訊,46,5,41,富邦-嘉義,2023-09-07,9692
00878,國泰永續高股息,66,25,41,富邦-嘉義,2023-09-07,9692
8112,至上,102,62,40,富邦-嘉義,2023-09-07,9692
00892,富邦台灣半導體,37,0,37,富邦-嘉義,2023-09-07,9692
2330,台積電,36,0,36,富邦-嘉義,2023-09-07,9692
6016,康和證,38,3,35,富邦-嘉義,2023-09-07,9692
2303,聯電,35,0,35,富邦-嘉義,2023-09-07,9692
5381,合正,129,95,34,富邦-嘉義,2023-09-07,9692
3044,健鼎,40,7,33,富邦-嘉義,2023-09-07,9692
1802,台玻,41,10,31,富邦-嘉義,2023-09-07,9692
6150,撼訊,32,2,30,富邦-嘉義,2023-09-07,9692
1568,倉佑,45,18,27,富邦-嘉義,2023-09-07,9692
4977,眾達-KY,51,25,26,富邦-嘉義,2023-09-07,9692
6274,台燿,34,8,26,富邦-嘉義,2023-09-07,9692
2401,凌陽,42,17,25,富邦-嘉義,2023-09-07,9692
2356,英業達,80,56,24,富邦-嘉義,2023-09-07,9692
3346,麗清,32,9,23,富邦-嘉義,2023-09-07,9692
2605,新興,24,1,23,富邦-嘉義,2023-09-07,9692
2881,富邦金,23,1,22,富邦-嘉義,2023-09-07,9692
9105,泰金寶-DR,20,0,20,富邦-嘉義,2023-09-07,9692
00919,群益台灣精選高息,327,14,313,富邦-嘉義,2023-09-08,9692
6285,啟��,311,25,286,富邦-嘉義,2023-09-08,9692
3715,定穎投控,467,263,204,富邦-嘉義,2023-09-08,9692
2367,燿華,154,5,149,富邦-嘉義,2023-09-08,9692
00929,復華台灣科技優息,308,197,111,富邦-嘉義,2023-09-08,9692
00915,凱基優選高股息30,106,0,106,富邦-嘉義,2023-09-08,9692
8222,寶一,212,110,102,富邦-嘉義,2023-09-08,9692
4561,健椿,101,1,100,富邦-嘉義,2023-09-08,9692
2485,兆赫,153,54,99,富邦-嘉義,2023-09-08,9692
3049,精金,95,0,95,富邦-嘉義,2023-09-08,9692
6770,力積電,91,0,91,富邦-嘉義,2023-09-08,9692
3481,群創,175,97,78,富邦-嘉義,2023-09-08,9692
4944,兆遠,107,30,77,富邦-嘉義,2023-09-08,9692
1471,首利,126,64,62,富邦-嘉義,2023-09-08,9692
2634,漢翔,106,55,51,富邦-嘉義,2023-09-08,9692
2880,華南金,51,0,51,富邦-嘉義,2023-09-08,9692
00632R,元大台灣50反1,66,18,48,富邦-嘉義,2023-09-08,9692
2436,偉詮電,69,23,46,富邦-嘉義,2023-09-08,9692
00676R,富邦臺灣加權反1,45,0,45,富邦-嘉義,2023-09-08,9692
3714,富采,41,0,41,富邦-嘉義,2023-09-08,9692
00878,國泰永續高股息,50,13,37,富邦-嘉義,2023-09-08,9692
00918,大華優利高填息30,36,0,36,富邦-嘉義,2023-09-08,9692
2409,友達,57,24,33,富邦-嘉義,2023-09-08,9692
00713,元大台灣高息低波,35,2,33,富邦-嘉義,2023-09-08,9692
00932,兆豐永續高息等權,80,50,30,富邦-嘉義,2023-09-08,9692
2618,長榮航,64,35,29,富邦-嘉義,2023-09-08,9692
2482,連宇,32,3,29,富邦-嘉義,2023-09-08,9692
6170,統振,32,4,28,富邦-嘉義,2023-09-08,9692
2313,華通,49,22,27,富邦-嘉義,2023-09-08,9692
8088,品安,42,15,27,富邦-嘉義,2023-09-08,9692
2356,英業達,52,25,27,富邦-嘉義,2023-09-08,9692
00751B,元大AAA至A公司債,27,2,25,富邦-嘉義,2023-09-08,9692
2308,台達電,26,2,24,富邦-嘉義,2023-09-08,9692
00902,中信電池及儲能,26,2,24,富邦-嘉義,2023-09-08,9692
2332,友訊,25,2,23,富邦-嘉義,2023-09-08,9692
4934,太極,28,6,22,富邦-嘉義,2023-09-08,9692
3338,泰碩,31,9,22,富邦-嘉義,2023-09-08,9692
1568,倉佑,45,23,22,富邦-嘉義,2023-09-08,9692
1802,台玻,37,16,21,富邦-嘉義,2023-09-08,9692
8358,金居,29,8,21,富邦-嘉義,2023-09-08,9692
1101,台泥,22,2,20,富邦-嘉義,2023-09-08,9692
6148,驊宏資,42,22,20,富邦-嘉義,2023-09-08,9692
2491,吉祥全,20,0,20,富邦-嘉義,2023-09-08,9692
6603,富強鑫,21,1,20,富邦-嘉義,2023-09-08,9692
4945,陞達科技,20,0,20,富邦-嘉義,2023-09-08,9692
1217,愛之味,22,4,18,富邦-嘉義,2023-09-08,9692
2376,技嘉,52,33,19,富邦-嘉義,2023-09-08,9692
1451,年興,18,0,18,富邦-嘉義,2023-09-08,9692
2883,凱基金,20,2,18,富邦-嘉義,2023-09-08,9692
1303,南亞,17,0,17,富邦-嘉義,2023-09-08,9692
3231,緯創,7087,5669,1418,富邦-嘉義,2023-09-11,9692
00919,群益台灣精選高息,345,38,307,富邦-嘉義,2023-09-11,9692
00878,國泰永續高股息,251,33,218,富邦-嘉義,2023-09-11,9692
2603,長榮,214,33,181,富邦-嘉義,2023-09-11,9692
00929,復華台灣科技優息,270,122,148,富邦-嘉義,2023-09-11,9692
00932,兆豐永續高息等權,131,5,126,富邦-嘉義,2023-09-11,9692
00673R,期元大S＆P原油反1,129,5,124,富邦-嘉義,2023-09-11,9692
00751B,元大AAA至A公司債,118,2,116,富邦-嘉義,2023-09-11,9692
2323,中環,95,0,95,富邦-嘉義,2023-09-11,9692
2485,兆赫,159,73,86,富邦-嘉義,2023-09-11,9692
4564,元翎,108,23,85,富邦-嘉義,2023-09-11,9692
0056,元大高股息,109,30,79,富邦-嘉義,2023-09-11,9692
00915,凱基優選高股息30,74,0,74,富邦-嘉義,2023-09-11,9692
6191,精成科,91,18,73,富邦-嘉義,2023-09-11,9692
2601,益航,69,0,69,富邦-嘉義,2023-09-11,9692
6719,力智,63,0,63,富邦-嘉義,2023-09-11,9692
3715,定穎投控,148,86,62,富邦-嘉義,2023-09-11,9692
2634,漢翔,119,58,61,富邦-嘉義,2023-09-11,9692
1108,幸福,58,0,58,富邦-嘉義,2023-09-11,9692
2312,金寶,67,14,53,富邦-嘉義,2023-09-11,9692
3234,光環,50,0,50,富邦-嘉義,2023-09-11,9692
00885,富邦越南,53,4,49,富邦-嘉義,2023-09-11,9692
3078,僑威,58,13,45,富邦-嘉義,2023-09-11,9692
6125,廣運,109,73,36,富邦-嘉義,2023-09-11,9692
2618,長榮航,79,46,33,富邦-嘉義,2023-09-11,9692
2002,中鋼,40,7,33,富邦-嘉義,2023-09-11,9692
00900,富邦特選高股息30,36,4,32,富邦-嘉義,2023-09-11,9692
6274,台燿,55,23,32,富邦-嘉義,2023-09-11,9692
1605,華新,36,5,31,富邦-嘉義,2023-09-11,9692
3213,茂訊,60,29,31,富邦-嘉義,2023-09-11,9692
2457,飛宏,64,33,31,富邦-嘉義,2023-09-11,9692
9105,泰金寶-DR,30,0,30,富邦-嘉義,2023-09-11,9692
1618,合機,53,24,29,富邦-嘉義,2023-09-11,9692
2880,華南金,28,1,27,富邦-嘉義,2023-09-11,9692
2356,英業達,117,91,26,富邦-嘉義,2023-09-11,9692
00931B,統一美債20年,31,5,26,富邦-嘉義,2023-09-11,9692
2369,菱生,56,30,26,富邦-嘉義,2023-09-11,9692
1101,台泥,27,2,25,富邦-嘉義,2023-09-11,9692
3548,兆利,47,26,21,富邦-嘉義,2023-09-11,9692
2020,美亞,21,0,21,富邦-嘉義,2023-09-11,9692
2313,華通,76,55,21,富邦-嘉義,2023-09-11,9692
3481,群創,131,110,21,富邦-嘉義,2023-09-11,9692
3206,志豐,20,0,20,富邦-嘉義,2023-09-11,9692
00918,大華優利高填息30,20,0,20,富邦-嘉義,2023-09-11,9692
00753L,中信中國50正2,20,0,20,富邦-嘉義,2023-09-11,9692
00895,富邦未來車,20,0,20,富邦-嘉義,2023-09-11,9692
00713,元大台灣高息低波,20,0,20,富邦-嘉義,2023-09-11,9692
00679B,元大美債20年,20,0,20,富邦-嘉義,2023-09-11,9692
3483,力致,30,11,19,富邦-嘉義,2023-09-11,9692
4916,事欣科,41,22,19,富邦-嘉義,2023-09-11,9692
00929,復華台灣科技優息,395,133,262,富邦-嘉義,2023-09-12,9692
00919,群益台灣精選高息,150,15,135,富邦-嘉義,2023-09-12,9692
00878,國泰永續高股息,182,48,134,富邦-嘉義,2023-09-12,9692
4561,健椿,126,7,119,富邦-嘉義,2023-09-12,9692
1471,首利,124,9,115,富邦-嘉義,2023-09-12,9692
5381,合正,195,100,95,富邦-嘉義,2023-09-12,9692
2367,燿華,142,50,92,富邦-嘉義,2023-09-12,9692
3481,群創,82,8,74,富邦-嘉義,2023-09-12,9692
3049,精金,69,0,69,富邦-嘉義,2023-09-12,9692
1515,力山,164,96,68,富邦-嘉義,2023-09-12,9692
6282,康舒,163,100,63,富邦-嘉義,2023-09-12,9692
9945,潤泰新,58,3,55,富邦-嘉義,2023-09-12,9692
2358,廷鑫,57,5,52,富邦-嘉義,2023-09-12,9692
00915,凱基優選高股息30,50,0,50,富邦-嘉義,2023-09-12,9692
3035,智原,84,36,48,富邦-嘉義,2023-09-12,9692
2323,中環,47,0,47,富邦-嘉義,2023-09-12,9692
00673R,期元大S＆P原油反1,56,13,43,富邦-嘉義,2023-09-12,9692
6125,廣運,66,24,42,富邦-嘉義,2023-09-12,9692
1522,堤維西,198,165,33,富邦-嘉義,2023-09-12,9692
2915,潤泰全,31,0,31,富邦-嘉義,2023-09-12,9692
1314,中石化,164,134,30,富邦-嘉義,2023-09-12,9692
2630,亞航,132,104,28,富邦-嘉義,2023-09-12,9692
4953,緯軟,31,4,27,富邦-嘉義,2023-09-12,9692
00902,中信電池及儲能,27,0,27,富邦-嘉義,2023-09-12,9692
3227,原相,48,22,26,富邦-嘉義,2023-09-12,9692
2816,旺旺保,40,15,25,富邦-嘉義,2023-09-12,9692
8222,寶一,59,35,24,富邦-嘉義,2023-09-12,9692
3380,明泰,76,53,23,富邦-嘉義,2023-09-12,9692
3276,宇環,25,3,22,富邦-嘉義,2023-09-12,9692
00679B,元大美債20年,21,0,21,富邦-嘉義,2023-09-12,9692
2201,裕隆,27,6,21,富邦-嘉義,2023-09-12,9692
5009,榮剛,27,6,21,富邦-嘉義,2023-09-12,9692
2601,益航,20,0,20,富邦-嘉義,2023-09-12,9692
2634,漢翔,36,16,20,富邦-嘉義,2023-09-12,9692
4564,元翎,20,0,20,富邦-嘉義,2023-09-12,9692
4714,永捷,20,0,20,富邦-嘉義,2023-09-12,9692
2645,長榮航太,47,27,20,富邦-嘉義,2023-09-12,9692
2618,長榮航,54,35,19,富邦-嘉義,2023-09-12,9692
00924,復華S＆P500成長,20,2,18,富邦-嘉義,2023-09-12,9692
6235,華孚,26,9,17,富邦-嘉義,2023-09-12,9692
2880,華南金,17,0,17,富邦-嘉義,2023-09-12,9692
2002,中鋼,18,2,16,富邦-嘉義,2023-09-12,9692
2105,正新,21,5,16,富邦-嘉義,2023-09-12,9692
5508,永信建,16,0,16,富邦-嘉義,2023-09-12,9692
8033,雷虎,33,18,15,富邦-嘉義,2023-09-12,9692
5880,合庫金,15,1,14,富邦-嘉義,2023-09-12,9692
2382,廣達,79,65,14,富邦-嘉義,2023-09-12,9692
6120,達運,362,348,14,富邦-嘉義,2023-09-12,9692
0056,元大高股息,19,6,13,富邦-嘉義,2023-09-12,9692
00882,中信中國高股息,13,0,13,富邦-嘉義,2023-09-12,9692
00919,群益台灣精選高息,768,101,667,富邦-嘉義,2023-09-13,9692
1524,耿鼎,887,649,238,富邦-嘉義,2023-09-13,9692
00929,復華台灣科技優息,345,141,204,富邦-嘉義,2023-09-13,9692
1319,東陽,455,318,137,富邦-嘉義,2023-09-13,9692
00673R,期元大S＆P原油反1,131,0,131,富邦-嘉義,2023-09-13,9692
2002,中鋼,129,4,125,富邦-嘉義,2023-09-13,9692
2486,一詮,466,356,110,富邦-嘉義,2023-09-13,9692
2417,圓剛,112,2,110,富邦-嘉義,2023-09-13,9692
5469,瀚宇博,84,1,83,富邦-嘉義,2023-09-13,9692
6451,訊芯-KY,101,21,80,富邦-嘉義,2023-09-13,9692
3363,上詮,135,58,77,富邦-嘉義,2023-09-13,9692
8068,全達,80,17,63,富邦-嘉義,2023-09-13,9692
2363,矽統,147,87,60,富邦-嘉義,2023-09-13,9692
2201,裕隆,66,6,60,富邦-嘉義,2023-09-13,9692
00902,中信電池及儲能,56,2,54,富邦-嘉義,2023-09-13,9692
1905,華紙,53,1,52,富邦-嘉義,2023-09-13,9692
00915,凱基優選高股息30,52,1,51,富邦-嘉義,2023-09-13,9692
2204,中華,52,7,45,富邦-嘉義,2023-09-13,9692
2634,漢翔,63,19,44,富邦-嘉義,2023-09-13,9692
2883,凱基金,50,8,42,富邦-嘉義,2023-09-13,9692
3596,智易,42,1,41,富邦-嘉義,2023-09-13,9692
6419,京晨科,40,0,40,富邦-嘉義,2023-09-13,9692
2618,長榮航,49,11,38,富邦-嘉義,2023-09-13,9692
3661,世芯-KY,82,46,36,富邦-嘉義,2023-09-13,9692
00655L,國泰中國A50正2,35,0,35,富邦-嘉義,2023-09-13,9692
3481,群創,59,25,34,富邦-嘉義,2023-09-13,9692
2344,華邦電,47,13,34,富邦-嘉義,2023-09-13,9692
2405,輔信,45,12,33,富邦-嘉義,2023-09-13,9692
2374,佳能,177,144,33,富邦-嘉義,2023-09-13,9692
3322,建舜電,47,15,32,富邦-嘉義,2023-09-13,9692
1616,億泰,30,0,30,富邦-嘉義,2023-09-13,9692
3443,創意,65,36,29,富邦-嘉義,2023-09-13,9692
00893,國泰智能電動車,32,4,28,富邦-嘉義,2023-09-13,9692
1722,台肥,26,0,26,富邦-嘉義,2023-09-13,9692
6446,藥華藥,30,4,26,富邦-嘉義,2023-09-13,9692
2385,群光,32,8,24,富邦-嘉義,2023-09-13,9692
1471,首利,35,11,24,富邦-嘉義,2023-09-13,9692
2884,玉山金,31,8,23,富邦-嘉義,2023-09-13,9692
8222,寶一,29,7,22,富邦-嘉義,2023-09-13,9692
00918,大華優利高填息30,27,6,21,富邦-嘉義,2023-09-13,9692
6288,聯嘉,242,221,21,富邦-嘉義,2023-09-13,9692
00715L,期街口布蘭特正2,21,0,21,富邦-嘉義,2023-09-13,9692
3257,虹冠電,22,1,21,富邦-嘉義,2023-09-13,9692
00637L,元大滬深300正2,27,6,21,富邦-嘉義,2023-09-13,9692
4958,臻鼎-KY,20,0,20,富邦-嘉義,2023-09-13,9692
4564,元翎,20,0,20,富邦-嘉義,2023-09-13,9692
00894,中信小資高價30,20,0,20,富邦-嘉義,2023-09-13,9692
2206,三陽工業,20,0,20,富邦-嘉義,2023-09-13,9692
3264,欣銓,30,10,20,富邦-嘉義,2023-09-13,9692
8033,雷虎,22,2,20,富邦-嘉義,2023-09-13,9692
6285,啟��,746,211,535,富邦-嘉義,2023-09-14,9692
00929,復華台灣科技優息,550,41,509,富邦-嘉義,2023-09-14,9692
00919,群益台灣精選高息,559,62,497,富邦-嘉義,2023-09-14,9692
4908,前鼎,714,315,399,富邦-嘉義,2023-09-14,9692
3014,聯陽,525,230,295,富邦-嘉義,2023-09-14,9692
3163,波若威,987,761,226,富邦-嘉義,2023-09-14,9692
6426,統新,531,325,206,富邦-嘉義,2023-09-14,9692
2313,華通,228,75,153,富邦-嘉義,2023-09-14,9692
00632R,元大台灣50反1,177,50,127,富邦-嘉義,2023-09-14,9692
4906,正文,138,22,116,富邦-嘉義,2023-09-14,9692
3260,威剛,125,19,106,富邦-嘉義,2023-09-14,9692
3363,上詮,570,466,104,富邦-嘉義,2023-09-14,9692
2371,大同,115,24,91,富邦-嘉義,2023-09-14,9692
3380,明泰,186,97,89,富邦-嘉義,2023-09-14,9692
00673R,期元大S＆P原油反1,91,10,81,富邦-嘉義,2023-09-14,9692
2630,亞航,87,16,71,富邦-嘉義,2023-09-14,9692
3694,海華,76,5,71,富邦-嘉義,2023-09-14,9692
2486,一詮,2116,2046,70,富邦-嘉義,2023-09-14,9692
6176,瑞儀,62,1,61,富邦-嘉義,2023-09-14,9692
2358,廷鑫,85,30,55,富邦-嘉義,2023-09-14,9692
00722B,群益投資級電信債,54,0,54,富邦-嘉義,2023-09-14,9692
3013,晟銘電,399,345,54,富邦-嘉義,2023-09-14,9692
3362,先進光,171,124,47,富邦-嘉義,2023-09-14,9692
6188,廣明,49,4,45,富邦-嘉義,2023-09-14,9692
8210,勤誠,150,108,42,富邦-嘉義,2023-09-14,9692
1314,中石化,72,31,41,富邦-嘉義,2023-09-14,9692
6715,嘉基,66,28,38,富邦-嘉義,2023-09-14,9692
00679B,元大美債20年,37,1,36,富邦-嘉義,2023-09-14,9692
8227,巨有科技,84,51,33,富邦-嘉義,2023-09-14,9692
4953,緯軟,36,3,33,富邦-嘉義,2023-09-14,9692
2634,漢翔,53,21,32,富邦-嘉義,2023-09-14,9692
3217,優群,32,4,28,富邦-嘉義,2023-09-14,9692
00676R,富邦臺灣加權反1,47,20,27,富邦-嘉義,2023-09-14,9692
5328,華容,27,2,25,富邦-嘉義,2023-09-14,9692
2402,毅嘉,62,37,25,富邦-嘉義,2023-09-14,9692
5474,聰泰,40,16,24,富邦-嘉義,2023-09-14,9692
2812,台中銀,34,10,24,富邦-嘉義,2023-09-14,9692
4942,嘉彰,23,0,23,富邦-嘉義,2023-09-14,9692
00882,中信中國高股息,23,0,23,富邦-嘉義,2023-09-14,9692
5864,致和證,30,7,23,富邦-嘉義,2023-09-14,9692
1905,華紙,27,5,22,富邦-嘉義,2023-09-14,9692
00773B,中信優先金融債,21,0,21,富邦-嘉義,2023-09-14,9692
3005,神基,33,13,20,富邦-嘉義,2023-09-14,9692
1515,力山,32,12,20,富邦-嘉義,2023-09-14,9692
4414,如興,20,0,20,富邦-嘉義,2023-09-14,9692
2368,金像電,20,0,20,富邦-嘉義,2023-09-14,9692
2485,兆赫,44,24,20,富邦-嘉義,2023-09-14,9692
00885,富邦越南,27,7,20,富邦-嘉義,2023-09-14,9692
3264,欣銓,29,10,19,富邦-嘉義,2023-09-14,9692
00664R,國泰臺灣加權反1,20,1,19,富邦-嘉義,2023-09-14,9692
00919,群益台灣精選高息,588,86,502,富邦-嘉義,2023-09-15,9692
00929,復華台灣科技優息,572,84,488,富邦-嘉義,2023-09-15,9692
2363,矽統,988,545,443,富邦-嘉義,2023-09-15,9692
2605,新興,1330,961,369,富邦-嘉義,2023-09-15,9692
2838,聯邦銀,260,0,260,富邦-嘉義,2023-09-15,9692
1522,堤維西,365,125,240,富邦-嘉義,2023-09-15,9692
3276,宇環,1060,908,152,富邦-嘉義,2023-09-15,9692
2542,興富發,117,0,117,富邦-嘉義,2023-09-15,9692
3062,建漢,117,12,105,富邦-嘉義,2023-09-15,9692
8112,至上,110,7,103,富邦-嘉義,2023-09-15,9692
6585,鼎基,110,8,102,富邦-嘉義,2023-09-15,9692
3049,精金,95,1,94,富邦-嘉義,2023-09-15,9692
2449,京元電子,1364,1292,72,富邦-嘉義,2023-09-15,9692
00857B,永豐20年美公債,67,0,67,富邦-嘉義,2023-09-15,9692
2618,長榮航,84,19,65,富邦-嘉義,2023-09-15,9692
8110,華東,71,10,61,富邦-嘉義,2023-09-15,9692
4743,合一,61,4,57,富邦-嘉義,2023-09-15,9692
2002,中鋼,73,18,55,富邦-嘉義,2023-09-15,9692
2356,英業達,154,100,54,富邦-嘉義,2023-09-15,9692
00885,富邦越南,59,5,54,富邦-嘉義,2023-09-15,9692
2610,華航,58,6,52,富邦-嘉義,2023-09-15,9692
3260,威剛,103,56,47,富邦-嘉義,2023-09-15,9692
00931B,統一美債20年,49,4,45,富邦-嘉義,2023-09-15,9692
00751B,元大AAA至A公司債,44,0,44,富邦-嘉義,2023-09-15,9692
8222,寶一,69,25,44,富邦-嘉義,2023-09-15,9692
5864,致和證,48,5,43,富邦-嘉義,2023-09-15,9692
1314,中石化,57,14,43,富邦-嘉義,2023-09-15,9692
00930,永豐ESG低碳高息,42,1,41,富邦-嘉義,2023-09-15,9692
00918,大華優利高填息30,67,26,41,富邦-嘉義,2023-09-15,9692
2884,玉山金,43,2,41,富邦-嘉義,2023-09-15,9692
6605,帝寶,42,2,40,富邦-嘉義,2023-09-15,9692
4953,緯軟,41,2,39,富邦-嘉義,2023-09-15,9692
3094,聯傑,53,18,35,富邦-嘉義,2023-09-15,9692
8086,宏捷科,42,8,34,富邦-嘉義,2023-09-15,9692
3617,碩天,47,13,34,富邦-嘉義,2023-09-15,9692
1802,台玻,36,4,32,富邦-嘉義,2023-09-15,9692
3714,富采,31,0,31,富邦-嘉義,2023-09-15,9692
00679B,元大美債20年,31,0,31,富邦-嘉義,2023-09-15,9692
1319,東陽,73,43,30,富邦-嘉義,2023-09-15,9692
6125,廣運,49,19,30,富邦-嘉義,2023-09-15,9692
2352,佳世達,33,3,30,富邦-嘉義,2023-09-15,9692
2337,旺宏,145,116,29,富邦-嘉義,2023-09-15,9692
2406,國碩,31,2,29,富邦-嘉義,2023-09-15,9692
3209,全科,30,1,29,富邦-嘉義,2023-09-15,9692
1718,中纖,27,0,27,富邦-嘉義,2023-09-15,9692
2025,千興,29,2,27,富邦-嘉義,2023-09-15,9692
00637L,元大滬深300正2,168,142,26,富邦-嘉義,2023-09-15,9692
3078,僑威,26,1,25,富邦-嘉義,2023-09-15,9692
1568,倉佑,55,30,25,富邦-嘉義,2023-09-15,9692
2332,友訊,30,6,24,富邦-嘉義,2023-09-15,9692
3231,緯創,8175,6875,1300,富邦-嘉義,2023-09-18,9692
00929,復華台灣科技優息,653,122,531,富邦-嘉義,2023-09-18,9692
00919,群益台灣精選高息,456,13,443,富邦-嘉義,2023-09-18,9692
2316,楠梓電,214,20,194,富邦-嘉義,2023-09-18,9692
00751B,元大AAA至A公司債,83,0,83,富邦-嘉義,2023-09-18,9692
2382,廣達,1901,1821,80,富邦-嘉義,2023-09-18,9692
00772B,中信高評級公司債,75,0,75,富邦-嘉義,2023-09-18,9692
00878,國泰永續高股息,99,26,73,富邦-嘉義,2023-09-18,9692
2323,中環,69,4,65,富邦-嘉義,2023-09-18,9692
3264,欣銓,66,4,62,富邦-嘉義,2023-09-18,9692
2317,鴻海,63,1,62,富邦-嘉義,2023-09-18,9692
3706,神達,58,3,55,富邦-嘉義,2023-09-18,9692
2301,光寶科,78,24,54,富邦-嘉義,2023-09-18,9692
3005,神基,75,24,51,富邦-嘉義,2023-09-18,9692
2603,長榮,89,41,48,富邦-嘉義,2023-09-18,9692
00921,兆豐龍頭等權重,50,2,48,富邦-嘉義,2023-09-18,9692
00931B,統一美債20年,46,0,46,富邦-嘉義,2023-09-18,9692
6125,廣運,62,18,44,富邦-嘉義,2023-09-18,9692
00918,大華優利高填息30,41,0,41,富邦-嘉義,2023-09-18,9692
6282,康舒,45,4,41,富邦-嘉義,2023-09-18,9692
00893,國泰智能電動車,41,0,41,富邦-嘉義,2023-09-18,9692
3081,聯亞,37,0,37,富邦-嘉義,2023-09-18,9692
2330,台積電,36,0,36,富邦-嘉義,2023-09-18,9692
00896,中信綠能及電動車,36,0,36,富邦-嘉義,2023-09-18,9692
2303,聯電,56,21,35,富邦-嘉義,2023-09-18,9692
00673R,期元大S＆P原油反1,39,6,33,富邦-嘉義,2023-09-18,9692
2485,兆赫,47,15,32,富邦-嘉義,2023-09-18,9692
2344,華邦電,37,5,32,富邦-嘉義,2023-09-18,9692
2204,中華,34,3,31,富邦-嘉義,2023-09-18,9692
3481,群創,87,56,31,富邦-嘉義,2023-09-18,9692
3260,威剛,50,20,30,富邦-嘉義,2023-09-18,9692
00713,元大台灣高息低波,26,0,26,富邦-嘉義,2023-09-18,9692
00895,富邦未來車,25,0,25,富邦-嘉義,2023-09-18,9692
00679B,元大美債20年,43,20,23,富邦-嘉義,2023-09-18,9692
00753L,中信中國50正2,27,4,23,富邦-嘉義,2023-09-18,9692
8358,金居,24,1,23,富邦-嘉義,2023-09-18,9692
00932,兆豐永續高息等權,38,15,23,富邦-嘉義,2023-09-18,9692
00720B,元大投資級公司債,22,0,22,富邦-嘉義,2023-09-18,9692
4953,緯軟,23,1,22,富邦-嘉義,2023-09-18,9692
2634,漢翔,31,11,20,富邦-嘉義,2023-09-18,9692
3323,加百裕,20,0,20,富邦-嘉義,2023-09-18,9692
3167,大量,20,0,20,富邦-嘉義,2023-09-18,9692
00928,中信上櫃ESG30,20,0,20,富邦-嘉義,2023-09-18,9692
2630,亞航,34,14,20,富邦-嘉義,2023-09-18,9692
3622,洋華,22,2,20,富邦-嘉義,2023-09-18,9692
1301,台塑,20,0,20,富邦-嘉義,2023-09-18,9692
00882,中信中國高股息,19,0,19,富邦-嘉義,2023-09-18,9692
6274,台燿,44,25,19,富邦-嘉義,2023-09-18,9692
00665L,富邦�琤肭磪囓�2,18,0,18,富邦-嘉義,2023-09-18,9692
2462,良得電,280,262,18,富邦-嘉義,2023-09-18,9692
2376,技嘉,719,162,557,富邦-嘉義,2023-09-19,9692
2344,華邦電,471,52,419,富邦-嘉義,2023-09-19,9692
00929,復華台灣科技優息,450,99,351,富邦-嘉義,2023-09-19,9692
3049,精金,297,150,147,富邦-嘉義,2023-09-19,9692
2913,農林,111,0,111,富邦-嘉義,2023-09-19,9692
5381,合正,453,350,103,富邦-嘉義,2023-09-19,9692
00753L,中信中國50正2,100,0,100,富邦-嘉義,2023-09-19,9692
3122,笙泉,239,141,98,富邦-嘉義,2023-09-19,9692
2363,矽統,215,120,95,富邦-嘉義,2023-09-19,9692
3037,欣興,108,22,86,富邦-嘉義,2023-09-19,9692
6257,矽格,144,59,85,富邦-嘉義,2023-09-19,9692
00878,國泰永續高股息,96,15,81,富邦-嘉義,2023-09-19,9692
1609,大亞,79,4,75,富邦-嘉義,2023-09-19,9692
2329,華泰,91,20,71,富邦-嘉義,2023-09-19,9692
4906,正文,111,41,70,富邦-嘉義,2023-09-19,9692
2313,華通,691,622,69,富邦-嘉義,2023-09-19,9692
00885,富邦越南,59,3,56,富邦-嘉義,2023-09-19,9692
4960,誠美材,57,4,53,富邦-嘉義,2023-09-19,9692
2382,廣達,154,103,51,富邦-嘉義,2023-09-19,9692
00919,群益台灣精選高息,104,56,48,富邦-嘉義,2023-09-19,9692
3265,台星科,211,166,45,富邦-嘉義,2023-09-19,9692
3081,聯亞,42,0,42,富邦-嘉義,2023-09-19,9692
00892,富邦台灣半導體,40,2,38,富邦-嘉義,2023-09-19,9692
1591,駿吉-KY,42,5,37,富邦-嘉義,2023-09-19,9692
2330,台積電,37,1,36,富邦-嘉義,2023-09-19,9692
00893,國泰智能電動車,33,0,33,富邦-嘉義,2023-09-19,9692
00673R,期元大S＆P原油反1,33,0,33,富邦-嘉義,2023-09-19,9692
8046,南電,38,5,33,富邦-嘉義,2023-09-19,9692
2542,興富發,41,9,32,富邦-嘉義,2023-09-19,9692
6112,邁達特,30,0,30,富邦-嘉義,2023-09-19,9692
2883,凱基金,34,5,29,富邦-嘉義,2023-09-19,9692
2630,亞航,51,22,29,富邦-嘉義,2023-09-19,9692
2409,友達,31,2,29,富邦-嘉義,2023-09-19,9692
6274,台燿,65,37,28,富邦-嘉義,2023-09-19,9692
5880,合庫金,29,2,27,富邦-嘉義,2023-09-19,9692
1568,倉佑,34,7,27,富邦-嘉義,2023-09-19,9692
4979,華星光,163,138,25,富邦-嘉義,2023-09-19,9692
00895,富邦未來車,27,3,24,富邦-嘉義,2023-09-19,9692
2014,中鴻,26,2,24,富邦-嘉義,2023-09-19,9692
2455,全新,25,1,24,富邦-嘉義,2023-09-19,9692
2340,台亞,24,2,22,富邦-嘉義,2023-09-19,9692
4533,協易機,22,0,22,富邦-嘉義,2023-09-19,9692
6282,康舒,60,38,22,富邦-嘉義,2023-09-19,9692
2301,光寶科,25,3,22,富邦-嘉義,2023-09-19,9692
2401,凌陽,25,4,21,富邦-嘉義,2023-09-19,9692
6451,訊芯-KY,43,22,21,富邦-嘉義,2023-09-19,9692
1101,台泥,21,1,20,富邦-嘉義,2023-09-19,9692
5289,宜鼎,20,0,20,富邦-嘉義,2023-09-19,9692
2610,華航,32,12,20,富邦-嘉義,2023-09-19,9692
4958,臻鼎-KY,20,0,20,富邦-嘉義,2023-09-19,9692
3231,緯創,4593,3865,728,富邦-嘉義,2023-09-20,9692
6274,台燿,142,27,115,富邦-嘉義,2023-09-20,9692
00921,兆豐龍頭等權重,105,0,105,富邦-嘉義,2023-09-20,9692
2618,長榮航,112,34,78,富邦-嘉義,2023-09-20,9692
2383,台光電,50,1,49,富邦-嘉義,2023-09-20,9692
1605,華新,148,100,48,富邦-嘉義,2023-09-20,9692
2401,凌陽,51,5,46,富邦-嘉義,2023-09-20,9692
2392,正崴,45,0,45,富邦-嘉義,2023-09-20,9692
1609,大亞,61,18,43,富邦-嘉義,2023-09-20,9692
3711,日月光投控,38,1,37,富邦-嘉義,2023-09-20,9692
2405,輔信,90,53,37,富邦-嘉義,2023-09-20,9692
3036,文曄,234,198,36,富邦-嘉義,2023-09-20,9692
3481,群創,83,48,35,富邦-嘉義,2023-09-20,9692
00932,兆豐永續高息等權,34,0,34,富邦-嘉義,2023-09-20,9692
1316,上曜,38,4,34,富邦-嘉義,2023-09-20,9692
2330,台積電,34,0,34,富邦-嘉義,2023-09-20,9692
00893,國泰智能電動車,32,0,32,富邦-嘉義,2023-09-20,9692
00922,國泰台灣領袖50,31,0,31,富邦-嘉義,2023-09-20,9692
3663,鑫科,33,2,31,富邦-嘉義,2023-09-20,9692
1101,台泥,31,0,31,富邦-嘉義,2023-09-20,9692
8068,全達,46,16,30,富邦-嘉義,2023-09-20,9692
00885,富邦越南,36,8,28,富邦-嘉義,2023-09-20,9692
3037,欣興,45,20,25,富邦-嘉義,2023-09-20,9692
5488,松普,23,0,23,富邦-嘉義,2023-09-20,9692
2888,新光金,41,20,21,富邦-嘉義,2023-09-20,9692
1722,台肥,21,0,21,富邦-嘉義,2023-09-20,9692
2610,華航,23,3,20,富邦-嘉義,2023-09-20,9692
2211,長榮鋼,21,1,20,富邦-嘉義,2023-09-20,9692
2801,彰銀,20,0,20,富邦-嘉義,2023-09-20,9692
5210,寶碩,20,0,20,富邦-嘉義,2023-09-20,9692
00676R,富邦臺灣加權反1,20,0,20,富邦-嘉義,2023-09-20,9692
3163,波若威,30,12,18,富邦-嘉義,2023-09-20,9692
2323,中環,23,5,18,富邦-嘉義,2023-09-20,9692
2887,台新金,25,7,18,富邦-嘉義,2023-09-20,9692
4979,華星光,90,72,18,富邦-嘉義,2023-09-20,9692
1314,中石化,24,6,18,富邦-嘉義,2023-09-20,9692
4942,嘉彰,18,0,18,富邦-嘉義,2023-09-20,9692
6770,力積電,17,0,17,富邦-嘉義,2023-09-20,9692
1712,興農,18,1,17,富邦-嘉義,2023-09-20,9692
8222,寶一,47,30,17,富邦-嘉義,2023-09-20,9692
5880,合庫金,17,0,17,富邦-嘉義,2023-09-20,9692
2892,第一金,16,0,16,富邦-嘉義,2023-09-20,9692
2486,一詮,25,9,16,富邦-嘉義,2023-09-20,9692
3706,神達,126,110,16,富邦-嘉義,2023-09-20,9692
00772B,中信高評級公司債,20,4,16,富邦-嘉義,2023-09-20,9692
00637L,元大滬深300正2,21,5,16,富邦-嘉義,2023-09-20,9692
00902,中信電池及儲能,16,0,16,富邦-嘉義,2023-09-20,9692
2609,陽明,45,29,16,富邦-嘉義,2023-09-20,9692
2354,鴻準,35,19,16,富邦-嘉義,2023-09-20,9692
2324,仁寶,15,0,15,富邦-嘉義,2023-09-20,9692
00673R,期元大S＆P原油反1,527,6,521,富邦-嘉義,2023-09-21,9692
00929,復華台灣科技優息,436,195,241,富邦-嘉義,2023-09-21,9692
3049,精金,192,1,191,富邦-嘉義,2023-09-21,9692
00919,群益台灣精選高息,197,33,164,富邦-嘉義,2023-09-21,9692
00720B,元大投資級公司債,162,6,156,富邦-嘉義,2023-09-21,9692
2201,裕隆,120,12,108,富邦-嘉義,2023-09-21,9692
2605,新興,127,21,106,富邦-嘉義,2023-09-21,9692
5880,合庫金,118,12,106,富邦-嘉義,2023-09-21,9692
2884,玉山金,102,0,102,富邦-嘉義,2023-09-21,9692
0056,元大高股息,126,27,99,富邦-嘉義,2023-09-21,9692
2002,中鋼,97,2,95,富邦-嘉義,2023-09-21,9692
00683L,期元大美元指正2,91,0,91,富邦-嘉義,2023-09-21,9692
2880,華南金,84,0,84,富邦-嘉義,2023-09-21,9692
00932,兆豐永續高息等權,76,1,75,富邦-嘉義,2023-09-21,9692
2891,中信金,69,0,69,富邦-嘉義,2023-09-21,9692
2344,華邦電,71,7,64,富邦-嘉義,2023-09-21,9692
1101,台泥,63,4,59,富邦-嘉義,2023-09-21,9692
3481,群創,81,24,57,富邦-嘉義,2023-09-21,9692
00878,國泰永續高股息,131,76,55,富邦-嘉義,2023-09-21,9692
2330,台積電,50,1,49,富邦-嘉義,2023-09-21,9692
00632R,元大台灣50反1,369,321,48,富邦-嘉義,2023-09-21,9692
1316,上曜,45,0,45,富邦-嘉義,2023-09-21,9692
2610,華航,52,9,43,富邦-嘉義,2023-09-21,9692
2352,佳世達,42,0,42,富邦-嘉義,2023-09-21,9692
00637L,元大滬深300正2,42,0,42,富邦-嘉義,2023-09-21,9692
2883,凱基金,51,9,42,富邦-嘉義,2023-09-21,9692
2887,台新金,44,3,41,富邦-嘉義,2023-09-21,9692
2601,益航,40,0,40,富邦-嘉義,2023-09-21,9692
4960,誠美材,38,0,38,富邦-嘉義,2023-09-21,9692
2313,華通,115,78,37,富邦-嘉義,2023-09-21,9692
1722,台肥,37,4,33,富邦-嘉義,2023-09-21,9692
0050,元大台灣50,33,0,33,富邦-嘉義,2023-09-21,9692
2303,聯電,41,9,32,富邦-嘉義,2023-09-21,9692
2409,友達,45,13,32,富邦-嘉義,2023-09-21,9692
2323,中環,31,0,31,富邦-嘉義,2023-09-21,9692
2367,燿華,100,70,30,富邦-嘉義,2023-09-21,9692
3576,聯合再生,29,0,29,富邦-嘉義,2023-09-21,9692
3450,聯鈞,263,234,29,富邦-嘉義,2023-09-21,9692
2329,華泰,51,22,29,富邦-嘉義,2023-09-21,9692
3037,欣興,29,2,27,富邦-嘉義,2023-09-21,9692
2316,楠梓電,28,1,27,富邦-嘉義,2023-09-21,9692
1718,中纖,26,0,26,富邦-嘉義,2023-09-21,9692
00922,國泰台灣領袖50,37,12,25,富邦-嘉義,2023-09-21,9692
3501,維熹,25,0,25,富邦-嘉義,2023-09-21,9692
6443,元晶,28,3,25,富邦-嘉義,2023-09-21,9692
00900,富邦特選高股息30,47,23,24,富邦-嘉義,2023-09-21,9692
2890,永豐金,24,2,22,富邦-嘉義,2023-09-21,9692
2332,友訊,23,1,22,富邦-嘉義,2023-09-21,9692
6005,群益證,22,0,22,富邦-嘉義,2023-09-21,9692
2312,金寶,21,0,21,富邦-嘉義,2023-09-21,9692
2313,華通,507,105,402,富邦-嘉義,2023-09-22,9692
00679B,元大美債20年,231,1,230,富邦-嘉義,2023-09-22,9692
3231,緯創,1807,1601,206,富邦-嘉義,2023-09-22,9692
00673R,期元大S＆P原油反1,211,81,130,富邦-嘉義,2023-09-22,9692
00712,復華富時不動產,125,1,124,富邦-嘉義,2023-09-22,9692
00931B,統一美債20年,113,0,113,富邦-嘉義,2023-09-22,9692
6530,創威,101,6,95,富邦-嘉義,2023-09-22,9692
3481,群創,96,2,94,富邦-嘉義,2023-09-22,9692
00772B,中信高評級公司債,94,5,89,富邦-嘉義,2023-09-22,9692
2888,新光金,87,2,85,富邦-嘉義,2023-09-22,9692
00919,群益台灣精選高息,108,30,78,富邦-嘉義,2023-09-22,9692
1101,台泥,80,15,65,富邦-嘉義,2023-09-22,9692
1810,和成,50,0,50,富邦-嘉義,2023-09-22,9692
00676R,富邦臺灣加權反1,50,0,50,富邦-嘉義,2023-09-22,9692
2883,凱基金,50,1,49,富邦-嘉義,2023-09-22,9692
00687B,國泰20年美債,77,28,49,富邦-嘉義,2023-09-22,9692
2426,鼎元,59,14,45,富邦-嘉義,2023-09-22,9692
00900,富邦特選高股息30,48,6,42,富邦-嘉義,2023-09-22,9692
1313,聯成,40,0,40,富邦-嘉義,2023-09-22,9692
2344,華邦電,40,1,39,富邦-嘉義,2023-09-22,9692
2330,台積電,35,0,35,富邦-嘉義,2023-09-22,9692
2303,聯電,53,21,32,富邦-嘉義,2023-09-22,9692
6901,鑽石投資,36,5,31,富邦-嘉義,2023-09-22,9692
5880,合庫金,29,0,29,富邦-嘉義,2023-09-22,9692
2891,中信金,27,0,27,富邦-嘉義,2023-09-22,9692
2603,長榮,93,68,25,富邦-嘉義,2023-09-22,9692
5210,寶碩,26,1,25,富邦-嘉義,2023-09-22,9692
2618,長榮航,61,37,24,富邦-嘉義,2023-09-22,9692
1584,精剛,46,22,24,富邦-嘉義,2023-09-22,9692
2630,亞航,61,38,23,富邦-嘉義,2023-09-22,9692
00680L,元大美債20正2,41,18,23,富邦-嘉義,2023-09-22,9692
00773B,中信優先金融債,21,0,21,富邦-嘉義,2023-09-22,9692
00715L,期街口布蘭特正2,23,2,21,富邦-嘉義,2023-09-22,9692
2881,富邦金,31,10,21,富邦-嘉義,2023-09-22,9692
2369,菱生,20,0,20,富邦-嘉義,2023-09-22,9692
2002,中鋼,21,1,20,富邦-嘉義,2023-09-22,9692
00795B,中信美國公債20年,18,0,18,富邦-嘉義,2023-09-22,9692
6451,訊芯-KY,38,20,18,富邦-嘉義,2023-09-22,9692
00888,永豐台灣ESG,17,0,17,富邦-嘉義,2023-09-22,9692
3163,波若威,42,25,17,富邦-嘉義,2023-09-22,9692
4903,聯光通,17,0,17,富邦-嘉義,2023-09-22,9692
2617,台航,17,1,16,富邦-嘉義,2023-09-22,9692
3715,定穎投控,102,86,16,富邦-嘉義,2023-09-22,9692
9103,美德醫療-DR,16,0,16,富邦-嘉義,2023-09-22,9692
2363,矽統,685,669,16,富邦-嘉義,2023-09-22,9692
00688L,國泰20年美債正2,17,2,15,富邦-嘉義,2023-09-22,9692
2312,金寶,15,0,15,富邦-嘉義,2023-09-22,9692
1722,台肥,15,0,15,富邦-嘉義,2023-09-22,9692
00932,兆豐永續高息等權,15,0,15,富邦-嘉義,2023-09-22,9692
00918,大華優利高填息30,15,0,15,富邦-嘉義,2023-09-22,9692
00929,復華台灣科技優息,505,52,453,富邦-嘉義,2023-09-25,9692
00919,群益台灣精選高息,402,10,392,富邦-嘉義,2023-09-25,9692
2367,燿華,361,71,290,富邦-嘉義,2023-09-25,9692
1522,堤維西,304,61,243,富邦-嘉義,2023-09-25,9692
3715,定穎投控,1243,1026,217,富邦-嘉義,2023-09-25,9692
2363,矽統,648,449,199,富邦-嘉義,2023-09-25,9692
1524,耿鼎,126,1,125,富邦-嘉義,2023-09-25,9692
00753L,中信中國50正2,100,0,100,富邦-嘉義,2023-09-25,9692
1101,台泥,96,2,94,富邦-嘉義,2023-09-25,9692
5465,富驊,94,6,88,富邦-嘉義,2023-09-25,9692
2368,金像電,468,420,48,富邦-嘉義,2023-09-25,9692
00679B,元大美債20年,41,1,40,富邦-嘉義,2023-09-25,9692
00712,復華富時不動產,40,0,40,富邦-嘉義,2023-09-25,9692
4906,正文,63,23,40,富邦-嘉義,2023-09-25,9692
00900,富邦特選高股息30,86,49,37,富邦-嘉義,2023-09-25,9692
00921,兆豐龍頭等權重,37,0,37,富邦-嘉義,2023-09-25,9692
3363,上詮,513,478,35,富邦-嘉義,2023-09-25,9692
00893,國泰智能電動車,33,0,33,富邦-嘉義,2023-09-25,9692
00892,富邦台灣半導體,33,0,33,富邦-嘉義,2023-09-25,9692
5529,鉅陞,32,0,32,富邦-嘉義,2023-09-25,9692
2204,中華,33,2,31,富邦-嘉義,2023-09-25,9692
3081,聯亞,32,2,30,富邦-嘉義,2023-09-25,9692
2303,聯電,41,12,29,富邦-嘉義,2023-09-25,9692
1504,東元,39,10,29,富邦-嘉義,2023-09-25,9692
4979,華星光,509,482,27,富邦-嘉義,2023-09-25,9692
4960,誠美材,25,0,25,富邦-嘉義,2023-09-25,9692
2891,中信金,25,0,25,富邦-嘉義,2023-09-25,9692
00665L,富邦�琤肭磪囓�2,45,21,24,富邦-嘉義,2023-09-25,9692
2317,鴻海,24,0,24,富邦-嘉義,2023-09-25,9692
2376,技嘉,147,124,23,富邦-嘉義,2023-09-25,9692
3276,宇環,22,0,22,富邦-嘉義,2023-09-25,9692
3706,神達,38,17,21,富邦-嘉義,2023-09-25,9692
2401,凌陽,24,4,20,富邦-嘉義,2023-09-25,9692
2206,三陽工業,39,20,19,富邦-嘉義,2023-09-25,9692
3501,維熹,20,1,19,富邦-嘉義,2023-09-25,9692
8210,勤誠,24,6,18,富邦-嘉義,2023-09-25,9692
2354,鴻準,18,0,18,富邦-嘉義,2023-09-25,9692
1471,首利,18,1,17,富邦-嘉義,2023-09-25,9692
2025,千興,20,3,17,富邦-嘉義,2023-09-25,9692
00902,中信電池及儲能,17,0,17,富邦-嘉義,2023-09-25,9692
00930,永豐ESG低碳高息,16,0,16,富邦-嘉義,2023-09-25,9692
2485,兆赫,54,38,16,富邦-嘉義,2023-09-25,9692
00642U,期元大S＆P石油,19,3,16,富邦-嘉義,2023-09-25,9692
2201,裕隆,27,11,16,富邦-嘉義,2023-09-25,9692
9105,泰金寶-DR,22,6,16,富邦-嘉義,2023-09-25,9692
2883,凱基金,21,6,15,富邦-嘉義,2023-09-25,9692
2002,中鋼,15,0,15,富邦-嘉義,2023-09-25,9692
2324,仁寶,16,1,15,富邦-嘉義,2023-09-25,9692
1584,精剛,245,231,14,富邦-嘉義,2023-09-25,9692
2399,映泰,21,7,14,富邦-嘉義,2023-09-25,9692
2367,燿華,635,6,629,富邦-嘉義,2023-09-26,9692
2313,華通,737,153,584,富邦-嘉義,2023-09-26,9692
3049,精金,245,0,245,富邦-嘉義,2023-09-26,9692
00679B,元大美債20年,204,36,168,富邦-嘉義,2023-09-26,9692
3481,群創,191,32,159,富邦-嘉義,2023-09-26,9692
00919,群益台灣精選高息,172,22,150,富邦-嘉義,2023-09-26,9692
00795B,中信美國公債20年,135,0,135,富邦-嘉義,2023-09-26,9692
2881,富邦金,87,2,85,富邦-嘉義,2023-09-26,9692
2303,聯電,73,11,62,富邦-嘉義,2023-09-26,9692
4942,嘉彰,61,0,61,富邦-嘉義,2023-09-26,9692
00892,富邦台灣半導體,60,0,60,富邦-嘉義,2023-09-26,9692
2353,宏��,59,0,59,富邦-嘉義,2023-09-26,9692
00687B,國泰20年美債,55,1,54,富邦-嘉義,2023-09-26,9692
1584,精剛,96,44,52,富邦-嘉義,2023-09-26,9692
00931B,統一美債20年,55,3,52,富邦-嘉義,2023-09-26,9692
5880,合庫金,56,5,51,富邦-嘉義,2023-09-26,9692
00922,國泰台灣領袖50,49,0,49,富邦-嘉義,2023-09-26,9692
00772B,中信高評級公司債,49,0,49,富邦-嘉義,2023-09-26,9692
1815,富喬,1014,965,49,富邦-嘉義,2023-09-26,9692
2401,凌陽,56,8,48,富邦-嘉義,2023-09-26,9692
00905,FT臺灣Smart,47,0,47,富邦-嘉義,2023-09-26,9692
2515,中工,52,6,46,富邦-嘉義,2023-09-26,9692
00929,復華台灣科技優息,288,243,45,富邦-嘉義,2023-09-26,9692
2486,一詮,70,26,44,富邦-嘉義,2023-09-26,9692
00712,復華富時不動產,47,3,44,富邦-嘉義,2023-09-26,9692
2344,華邦電,52,11,41,富邦-嘉義,2023-09-26,9692
1802,台玻,43,2,41,富邦-嘉義,2023-09-26,9692
2317,鴻海,53,14,39,富邦-嘉義,2023-09-26,9692
00885,富邦越南,57,19,38,富邦-嘉義,2023-09-26,9692
6806,森崴能源,53,16,37,富邦-嘉義,2023-09-26,9692
1471,首利,87,51,36,富邦-嘉義,2023-09-26,9692
1314,中石化,34,0,34,富邦-嘉義,2023-09-26,9692
0056,元大高股息,72,39,33,富邦-嘉義,2023-09-26,9692
2880,華南金,30,0,30,富邦-嘉義,2023-09-26,9692
3006,晶豪科,35,5,30,富邦-嘉義,2023-09-26,9692
1313,聯成,30,0,30,富邦-嘉義,2023-09-26,9692
2330,台積電,30,4,26,富邦-嘉義,2023-09-26,9692
1718,中纖,26,0,26,富邦-嘉義,2023-09-26,9692
1504,東元,37,12,25,富邦-嘉義,2023-09-26,9692
2388,威盛,88,63,25,富邦-嘉義,2023-09-26,9692
3323,加百裕,25,0,25,富邦-嘉義,2023-09-26,9692
00857B,永豐20年美公債,24,0,24,富邦-嘉義,2023-09-26,9692
2892,第一金,29,6,23,富邦-嘉義,2023-09-26,9692
00720B,元大投資級公司債,23,0,23,富邦-嘉義,2023-09-26,9692
1101,台泥,25,3,22,富邦-嘉義,2023-09-26,9692
2387,精元,22,0,22,富邦-嘉義,2023-09-26,9692
00893,國泰智能電動車,31,10,21,富邦-嘉義,2023-09-26,9692
1722,台肥,21,0,21,富邦-嘉義,2023-09-26,9692
6274,台燿,94,74,20,富邦-嘉義,2023-09-26,9692
5432,新門,22,2,20,富邦-嘉義,2023-09-26,9692
6418,詠昇,154,5,149,富邦-嘉義,2023-09-27,9692
6117,迎廣,130,9,121,富邦-嘉義,2023-09-27,9692
1314,中石化,120,0,120,富邦-嘉義,2023-09-27,9692
2002,中鋼,144,31,113,富邦-嘉義,2023-09-27,9692
00720B,元大投資級公司債,102,0,102,富邦-嘉義,2023-09-27,9692
2313,華通,169,73,96,富邦-嘉義,2023-09-27,9692
00919,群益台灣精選高息,153,59,94,富邦-嘉義,2023-09-27,9692
2382,廣達,118,27,91,富邦-嘉義,2023-09-27,9692
2603,長榮,104,21,83,富邦-嘉義,2023-09-27,9692
00712,復華富時不動產,68,1,67,富邦-嘉義,2023-09-27,9692
3036,文曄,367,304,63,富邦-嘉義,2023-09-27,9692
3715,定穎投控,1280,1239,41,富邦-嘉義,2023-09-27,9692
3231,緯創,2618,2577,41,富邦-嘉義,2023-09-27,9692
00900,富邦特選高股息30,38,2,36,富邦-嘉義,2023-09-27,9692
2881,富邦金,39,4,35,富邦-嘉義,2023-09-27,9692
2888,新光金,34,0,34,富邦-嘉義,2023-09-27,9692
00885,富邦越南,38,4,34,富邦-嘉義,2023-09-27,9692
00892,富邦台灣半導體,34,0,34,富邦-嘉義,2023-09-27,9692
00893,國泰智能電動車,33,0,33,富邦-嘉義,2023-09-27,9692
00888,永豐台灣ESG,33,0,33,富邦-嘉義,2023-09-27,9692
2201,裕隆,50,18,32,富邦-嘉義,2023-09-27,9692
00713,元大台灣高息低波,31,0,31,富邦-嘉義,2023-09-27,9692
1603,華電,94,65,29,富邦-嘉義,2023-09-27,9692
2102,泰豐,27,0,27,富邦-嘉義,2023-09-27,9692
6901,鑽石投資,30,3,27,富邦-嘉義,2023-09-27,9692
2367,燿華,80,53,27,富邦-嘉義,2023-09-27,9692
00795B,中信美國公債20年,25,0,25,富邦-嘉義,2023-09-27,9692
2855,統一證,25,0,25,富邦-嘉義,2023-09-27,9692
6197,佳必琪,26,1,25,富邦-嘉義,2023-09-27,9692
3265,台星科,24,0,24,富邦-嘉義,2023-09-27,9692
00637L,元大滬深300正2,23,0,23,富邦-嘉義,2023-09-27,9692
2014,中鴻,23,0,23,富邦-嘉義,2023-09-27,9692
2641,正德,35,14,21,富邦-嘉義,2023-09-27,9692
2605,新興,180,159,21,富邦-嘉義,2023-09-27,9692
6222,上揚,20,0,20,富邦-嘉義,2023-09-27,9692
4533,協易機,20,0,20,富邦-嘉義,2023-09-27,9692
6405,悅城,33,13,20,富邦-嘉義,2023-09-27,9692
6477,安集,20,0,20,富邦-嘉義,2023-09-27,9692
3122,笙泉,73,54,19,富邦-嘉義,2023-09-27,9692
3037,欣興,28,9,19,富邦-嘉義,2023-09-27,9692
2376,技嘉,52,34,18,富邦-嘉義,2023-09-27,9692
1618,合機,112,94,18,富邦-嘉義,2023-09-27,9692
2492,華新科,20,2,18,富邦-嘉義,2023-09-27,9692
4979,華星光,322,304,18,富邦-嘉義,2023-09-27,9692
2834,臺企銀,18,1,17,富邦-嘉義,2023-09-27,9692
00679B,元大美債20年,19,3,16,富邦-嘉義,2023-09-27,9692
00932,兆豐永續高息等權,21,5,16,富邦-嘉義,2023-09-27,9692
1605,華新,19,3,16,富邦-嘉義,2023-09-27,9692
2303,聯電,35,20,15,富邦-嘉義,2023-09-27,9692
0050,元大台灣50,16,0,16,富邦-嘉義,2023-09-27,9692
00665L,富邦�琤肭磪囓�2,523,0,523,富邦-嘉義,2023-09-28,9692
2323,中環,230,20,210,富邦-嘉義,2023-09-28,9692
00673R,期元大S＆P原油反1,323,165,158,富邦-嘉義,2023-09-28,9692
1806,冠軍,157,2,155,富邦-嘉義,2023-09-28,9692
6274,台燿,195,70,125,富邦-嘉義,2023-09-28,9692
3481,群創,224,102,122,富邦-嘉義,2023-09-28,9692
4542,科嶠,255,135,120,富邦-嘉義,2023-09-28,9692
3363,上詮,133,14,119,富邦-嘉義,2023-09-28,9692
00929,復華台灣科技優息,141,29,112,富邦-嘉義,2023-09-28,9692
3231,緯創,7187,7076,111,富邦-嘉義,2023-09-28,9692
00679B,元大美債20年,137,30,107,富邦-嘉義,2023-09-28,9692
2313,華通,132,39,93,富邦-嘉義,2023-09-28,9692
1504,東元,104,12,92,富邦-嘉義,2023-09-28,9692
8088,品安,95,3,92,富邦-嘉義,2023-09-28,9692
2329,華泰,121,31,90,富邦-嘉義,2023-09-28,9692
00664R,國泰臺灣加權反1,88,0,88,富邦-嘉義,2023-09-28,9692
2344,華邦電,81,11,70,富邦-嘉義,2023-09-28,9692
3325,旭品,396,334,62,富邦-嘉義,2023-09-28,9692
3596,智易,59,2,57,富邦-嘉義,2023-09-28,9692
00712,復華富時不動產,53,2,51,富邦-嘉義,2023-09-28,9692
00772B,中信高評級公司債,49,0,49,富邦-嘉義,2023-09-28,9692
6187,萬潤,55,10,45,富邦-嘉義,2023-09-28,9692
3714,富采,40,0,40,富邦-嘉義,2023-09-28,9692
1529,樂事綠能,55,15,40,富邦-嘉義,2023-09-28,9692
1513,中興電,56,17,39,富邦-嘉義,2023-09-28,9692
2408,南亞科,38,0,38,富邦-嘉義,2023-09-28,9692
00687B,國泰20年美債,36,0,36,富邦-嘉義,2023-09-28,9692
2337,旺宏,51,15,36,富邦-嘉義,2023-09-28,9692
9904,寶成,34,0,34,富邦-嘉義,2023-09-28,9692
2206,三陽工業,37,12,25,富邦-嘉義,2023-09-28,9692
2892,第一金,24,0,24,富邦-嘉義,2023-09-28,9692
00931B,統一美債20年,23,0,23,富邦-嘉義,2023-09-28,9692
4906,正文,23,1,22,富邦-嘉義,2023-09-28,9692
1722,台肥,31,9,22,富邦-嘉義,2023-09-28,9692
00892,富邦台灣半導體,21,0,21,富邦-嘉義,2023-09-28,9692
00753L,中信中國50正2,20,0,20,富邦-嘉義,2023-09-28,9692
3564,其陽,22,2,20,富邦-嘉義,2023-09-28,9692
00757,統一FANG+,19,0,19,富邦-嘉義,2023-09-28,9692
2102,泰豐,19,0,19,富邦-嘉義,2023-09-28,9692
2401,凌陽,23,5,18,富邦-嘉義,2023-09-28,9692
1710,東聯,18,0,18,富邦-嘉義,2023-09-28,9692
00637L,元大滬深300正2,17,0,17,富邦-嘉義,2023-09-28,9692
2317,鴻海,21,5,16,富邦-嘉義,2023-09-28,9692
00923,群益台ESG低碳50,16,0,16,富邦-嘉義,2023-09-28,9692
2208,台船,16,1,15,富邦-嘉義,2023-09-28,9692
2201,裕隆,29,14,15,富邦-嘉義,2023-09-28,9692
00922,國泰台灣領袖50,15,0,15,富邦-嘉義,2023-09-28,9692
00680L,元大美債20正2,33,18,15,富邦-嘉義,2023-09-28,9692
3501,維熹,15,0,15,富邦-嘉義,2023-09-28,9692
1324,地球,15,0,15,富邦-嘉義,2023-09-28,9692
6117,迎廣,500,95,405,富邦-嘉義,2023-10-02,9692
00676R,富邦臺灣加權反1,264,0,264,富邦-嘉義,2023-10-02,9692
3036,文曄,310,57,253,富邦-嘉義,2023-10-02,9692
3325,旭品,382,131,251,富邦-嘉義,2023-10-02,9692
2603,長榮,269,25,244,富邦-嘉義,2023-10-02,9692
3078,僑威,206,2,204,富邦-嘉義,2023-10-02,9692
3715,定穎投控,506,345,161,富邦-嘉義,2023-10-02,9692
2891,中信金,166,8,158,富邦-嘉義,2023-10-02,9692
2002,中鋼,166,10,156,富邦-嘉義,2023-10-02,9692
8088,品安,148,17,131,富邦-嘉義,2023-10-02,9692
3013,晟銘電,242,123,119,富邦-嘉義,2023-10-02,9692
1815,富喬,337,226,111,富邦-嘉義,2023-10-02,9692
2102,泰豐,100,0,100,富邦-嘉義,2023-10-02,9692
3032,偉訓,169,76,93,富邦-嘉義,2023-10-02,9692
2409,友達,111,18,93,富邦-嘉義,2023-10-02,9692
00720B,元大投資級公司債,84,0,84,富邦-嘉義,2023-10-02,9692
2449,京元電子,91,9,82,富邦-嘉義,2023-10-02,9692
6191,精成科,117,50,67,富邦-嘉義,2023-10-02,9692
3044,健鼎,347,281,66,富邦-嘉義,2023-10-02,9692
2890,永豐金,64,0,64,富邦-嘉義,2023-10-02,9692
3231,緯創,5060,5000,60,富邦-嘉義,2023-10-02,9692
2610,華航,142,84,58,富邦-嘉義,2023-10-02,9692
2486,一詮,138,85,53,富邦-嘉義,2023-10-02,9692
1217,愛之味,51,0,51,富邦-嘉義,2023-10-02,9692
00712,復華富時不動產,46,0,46,富邦-嘉義,2023-10-02,9692
00679B,元大美債20年,45,3,42,富邦-嘉義,2023-10-02,9692
2615,萬海,43,2,41,富邦-嘉義,2023-10-02,9692
3617,碩天,43,4,39,富邦-嘉義,2023-10-02,9692
5324,士開,41,3,38,富邦-嘉義,2023-10-02,9692
6125,廣運,54,16,38,富邦-嘉義,2023-10-02,9692
3501,維熹,35,0,35,富邦-嘉義,2023-10-02,9692
6505,台塑化,36,1,35,富邦-嘉義,2023-10-02,9692
00929,復華台灣科技優息,132,98,34,富邦-嘉義,2023-10-02,9692
00878,國泰永續高股息,87,54,33,富邦-嘉義,2023-10-02,9692
3017,奇鋐,39,8,31,富邦-嘉義,2023-10-02,9692
5475,德宏,30,0,30,富邦-嘉義,2023-10-02,9692
2457,飛宏,33,3,30,富邦-嘉義,2023-10-02,9692
00772B,中信高評級公司債,30,1,29,富邦-嘉義,2023-10-02,9692
1905,華紙,27,0,27,富邦-嘉義,2023-10-02,9692
6669,緯穎,34,7,27,富邦-嘉義,2023-10-02,9692
2892,第一金,25,0,25,富邦-嘉義,2023-10-02,9692
2201,裕隆,37,14,23,富邦-嘉義,2023-10-02,9692
00919,群益台灣精選高息,75,52,23,富邦-嘉義,2023-10-02,9692
4961,天鈺,26,6,20,富邦-嘉義,2023-10-02,9692
2314,台揚,20,0,20,富邦-嘉義,2023-10-02,9692
1314,中石化,36,16,20,富邦-嘉義,2023-10-02,9692
1584,精剛,27,7,20,富邦-嘉義,2023-10-02,9692
2337,旺宏,21,2,19,富邦-嘉義,2023-10-02,9692
6213,聯茂,37,19,18,富邦-嘉義,2023-10-02,9692
2377,微星,18,0,18,富邦-嘉義,2023-10-02,9692
00929,復華台灣科技優息,312,29,283,富邦-嘉義,2023-10-03,9692
00922,國泰台灣領袖50,207,1,206,富邦-嘉義,2023-10-03,9692
2356,英業達,237,40,197,富邦-嘉義,2023-10-03,9692
00665L,富邦�琤肭磪囓�2,157,0,157,富邦-嘉義,2023-10-03,9692
2618,長榮航,180,29,151,富邦-嘉義,2023-10-03,9692
00919,群益台灣精選高息,150,23,127,富邦-嘉義,2023-10-03,9692
00637L,元大滬深300正2,96,0,96,富邦-嘉義,2023-10-03,9692
3481,群創,215,122,93,富邦-嘉義,2023-10-03,9692
2883,凱基金,91,0,91,富邦-嘉義,2023-10-03,9692
0056,元大高股息,116,32,84,富邦-嘉義,2023-10-03,9692
00882,中信中國高股息,77,0,77,富邦-嘉義,2023-10-03,9692
00679B,元大美債20年,86,10,76,富邦-嘉義,2023-10-03,9692
3231,緯創,2220,2146,74,富邦-嘉義,2023-10-03,9692
3036,文曄,330,263,67,富邦-嘉義,2023-10-03,9692
00720B,元大投資級公司債,59,2,57,富邦-嘉義,2023-10-03,9692
2313,華通,113,57,56,富邦-嘉義,2023-10-03,9692
2882,國泰金,64,11,53,富邦-嘉義,2023-10-03,9692
2603,長榮,62,10,52,富邦-嘉義,2023-10-03,9692
1316,上曜,48,1,47,富邦-嘉義,2023-10-03,9692
6451,訊芯-KY,53,6,47,富邦-嘉義,2023-10-03,9692
2002,中鋼,52,7,45,富邦-嘉義,2023-10-03,9692
2888,新光金,46,1,45,富邦-嘉義,2023-10-03,9692
6231,系微,42,1,41,富邦-嘉義,2023-10-03,9692
2601,益航,41,0,41,富邦-嘉義,2023-10-03,9692
2303,聯電,45,5,40,富邦-嘉義,2023-10-03,9692
1605,華新,49,10,39,富邦-嘉義,2023-10-03,9692
2409,友達,397,358,39,富邦-嘉義,2023-10-03,9692
2880,華南金,52,14,38,富邦-嘉義,2023-10-03,9692
00885,富邦越南,37,0,37,富邦-嘉義,2023-10-03,9692
00655L,國泰中國A50正2,37,0,37,富邦-嘉義,2023-10-03,9692
00772B,中信高評級公司債,41,5,36,富邦-嘉義,2023-10-03,9692
5225,東科-KY,38,3,35,富邦-嘉義,2023-10-03,9692
00878,國泰永續高股息,43,11,32,富邦-嘉義,2023-10-03,9692
3701,大眾控,53,21,32,富邦-嘉義,2023-10-03,9692
1324,地球,46,15,31,富邦-嘉義,2023-10-03,9692
00712,復華富時不動產,71,40,31,富邦-嘉義,2023-10-03,9692
1313,聯成,30,0,30,富邦-嘉義,2023-10-03,9692
3217,優群,30,1,29,富邦-嘉義,2023-10-03,9692
2884,玉山金,31,4,27,富邦-嘉義,2023-10-03,9692
5439,高技,36,9,27,富邦-嘉義,2023-10-03,9692
2382,廣達,263,236,27,富邦-嘉義,2023-10-03,9692
1722,台肥,31,5,26,富邦-嘉義,2023-10-03,9692
2402,毅嘉,37,12,25,富邦-嘉義,2023-10-03,9692
00931B,統一美債20年,26,1,25,富邦-嘉義,2023-10-03,9692
2388,威盛,82,58,24,富邦-嘉義,2023-10-03,9692
00905,FT臺灣Smart,24,0,24,富邦-嘉義,2023-10-03,9692
2615,萬海,24,0,24,富邦-嘉義,2023-10-03,9692
00715L,期街口布蘭特正2,24,2,22,富邦-嘉義,2023-10-03,9692
6170,統振,30,8,22,富邦-嘉義,2023-10-03,9692
6120,達運,26,4,22,富邦-嘉義,2023-10-03,9692
00632R,元大台灣50反1,335,130,205,富邦-嘉義,2023-10-04,9692
00922,國泰台灣領袖50,198,37,161,富邦-嘉義,2023-10-04,9692
00679B,元大美債20年,138,23,115,富邦-嘉義,2023-10-04,9692
3576,聯合再生,114,0,114,富邦-嘉義,2023-10-04,9692
00929,復華台灣科技優息,195,90,105,富邦-嘉義,2023-10-04,9692
2884,玉山金,113,14,99,富邦-嘉義,2023-10-04,9692
2405,輔信,100,2,98,富邦-嘉義,2023-10-04,9692
1314,中石化,94,0,94,富邦-嘉義,2023-10-04,9692
3481,群創,117,25,92,富邦-嘉義,2023-10-04,9692
3231,緯創,862,773,89,富邦-嘉義,2023-10-04,9692
00878,國泰永續高股息,106,20,86,富邦-嘉義,2023-10-04,9692
2409,友達,115,39,76,富邦-嘉義,2023-10-04,9692
0056,元大高股息,96,23,73,富邦-嘉義,2023-10-04,9692
2891,中信金,81,9,72,富邦-嘉義,2023-10-04,9692
3032,偉訓,80,10,70,富邦-嘉義,2023-10-04,9692
6274,台燿,157,87,70,富邦-嘉義,2023-10-04,9692
2303,聯電,70,1,69,富邦-嘉義,2023-10-04,9692
2618,長榮航,72,7,65,富邦-嘉義,2023-10-04,9692
00919,群益台灣精選高息,83,24,59,富邦-嘉義,2023-10-04,9692
1217,愛之味,56,0,56,富邦-嘉義,2023-10-04,9692
00931B,統一美債20年,56,0,56,富邦-嘉義,2023-10-04,9692
00687B,國泰20年美債,54,0,54,富邦-嘉義,2023-10-04,9692
1605,華新,57,5,52,富邦-嘉義,2023-10-04,9692
6285,啟��,63,11,52,富邦-嘉義,2023-10-04,9692
3715,定穎投控,300,249,51,富邦-嘉義,2023-10-04,9692
2801,彰銀,50,0,50,富邦-嘉義,2023-10-04,9692
2201,裕隆,58,10,48,富邦-嘉義,2023-10-04,9692
3049,精金,49,1,48,富邦-嘉義,2023-10-04,9692
2607,榮運,50,5,45,富邦-嘉義,2023-10-04,9692
2888,新光金,66,21,45,富邦-嘉義,2023-10-04,9692
2382,廣達,108,65,43,富邦-嘉義,2023-10-04,9692
00720B,元大投資級公司債,73,30,43,富邦-嘉義,2023-10-04,9692
00923,群益台ESG低碳50,41,0,41,富邦-嘉義,2023-10-04,9692
2455,全新,84,44,40,富邦-嘉義,2023-10-04,9692
1104,環泥,40,0,40,富邦-嘉義,2023-10-04,9692
3501,維熹,40,0,40,富邦-嘉義,2023-10-04,9692
00795B,中信美國公債20年,37,0,37,富邦-嘉義,2023-10-04,9692
3036,文曄,546,509,37,富邦-嘉義,2023-10-04,9692
1313,聯成,40,4,36,富邦-嘉義,2023-10-04,9692
00712,復華富時不動產,108,72,36,富邦-嘉義,2023-10-04,9692
2881,富邦金,46,12,34,富邦-嘉義,2023-10-04,9692
5880,合庫金,48,15,33,富邦-嘉義,2023-10-04,9692
2601,益航,33,0,33,富邦-嘉義,2023-10-04,9692
1101,台泥,35,3,32,富邦-嘉義,2023-10-04,9692
2417,圓剛,381,350,31,富邦-嘉義,2023-10-04,9692
2383,台光電,50,20,30,富邦-嘉義,2023-10-04,9692
00751B,元大AAA至A公司債,28,0,28,富邦-嘉義,2023-10-04,9692
3322,建舜電,37,9,28,富邦-嘉義,2023-10-04,9692
1301,台塑,28,0,28,富邦-嘉義,2023-10-04,9692
1718,中纖,27,0,27,富邦-嘉義,2023-10-04,9692
00712,復華富時不動產,317,6,311,富邦-嘉義,2023-10-05,9692
00673R,期元大S＆P原油反1,310,57,253,富邦-嘉義,2023-10-05,9692
9950,萬國通,180,1,179,富邦-嘉義,2023-10-05,9692
3325,旭品,343,204,139,富邦-嘉義,2023-10-05,9692
5225,東科-KY,117,5,112,富邦-嘉義,2023-10-05,9692
3481,群創,123,16,107,富邦-嘉義,2023-10-05,9692
2468,華經,115,24,91,富邦-嘉義,2023-10-05,9692
3276,宇環,398,314,84,富邦-嘉義,2023-10-05,9692
2382,廣達,113,34,79,富邦-嘉義,2023-10-05,9692
5272,笙科,133,58,75,富邦-嘉義,2023-10-05,9692
2002,中鋼,81,9,72,富邦-嘉義,2023-10-05,9692
00720B,元大投資級公司債,65,1,64,富邦-嘉義,2023-10-05,9692
00715L,期街口布蘭特正2,57,2,55,富邦-嘉義,2023-10-05,9692
00929,復華台灣科技優息,88,37,51,富邦-嘉義,2023-10-05,9692
2618,長榮航,125,75,50,富邦-嘉義,2023-10-05,9692
2405,輔信,52,6,46,富邦-嘉義,2023-10-05,9692
6282,康舒,51,8,43,富邦-嘉義,2023-10-05,9692
2449,京元電子,62,22,40,富邦-嘉義,2023-10-05,9692
3501,維熹,40,0,40,富邦-嘉義,2023-10-05,9692
6122,擎邦,55,20,35,富邦-嘉義,2023-10-05,9692
2409,友達,47,14,33,富邦-嘉義,2023-10-05,9692
6585,鼎基,45,13,32,富邦-嘉義,2023-10-05,9692
6684,安格,32,4,28,富邦-嘉義,2023-10-05,9692
00922,國泰台灣領袖50,33,7,26,富邦-嘉義,2023-10-05,9692
6139,亞翔,26,1,25,富邦-嘉義,2023-10-05,9692
2890,永豐金,26,2,24,富邦-嘉義,2023-10-05,9692
00671R,富邦NASDAQ反1,24,0,24,富邦-嘉義,2023-10-05,9692
00719B,元大美債1-3,23,0,23,富邦-嘉義,2023-10-05,9692
2883,凱基金,28,5,23,富邦-嘉義,2023-10-05,9692
8112,至上,29,7,22,富邦-嘉義,2023-10-05,9692
00885,富邦越南,26,5,21,富邦-嘉義,2023-10-05,9692
00882,中信中國高股息,20,0,20,富邦-嘉義,2023-10-05,9692
4503,金雨,20,0,20,富邦-嘉義,2023-10-05,9692
6112,邁達特,37,19,18,富邦-嘉義,2023-10-05,9692
1104,環泥,18,0,18,富邦-嘉義,2023-10-05,9692
2332,友訊,22,5,17,富邦-嘉義,2023-10-05,9692
00679B,元大美債20年,28,11,17,富邦-嘉義,2023-10-05,9692
00687B,國泰20年美債,19,3,16,富邦-嘉義,2023-10-05,9692
2538,基泰,72,56,16,富邦-嘉義,2023-10-05,9692
2630,亞航,18,2,16,富邦-嘉義,2023-10-05,9692
8420,明揚,15,0,15,富邦-嘉義,2023-10-05,9692
3081,聯亞,22,7,15,富邦-嘉義,2023-10-05,9692
4979,華星光,121,107,14,富邦-嘉義,2023-10-05,9692
1342,八貫,16,2,14,富邦-嘉義,2023-10-05,9692
3669,圓展,22,8,14,富邦-嘉義,2023-10-05,9692
1101,台泥,17,3,14,富邦-嘉義,2023-10-05,9692
6288,聯嘉,30,17,13,富邦-嘉義,2023-10-05,9692
2634,漢翔,16,3,13,富邦-嘉義,2023-10-05,9692
3122,笙泉,405,393,12,富邦-嘉義,2023-10-05,9692
2897,王道銀行,12,0,12,富邦-嘉義,2023-10-05,9692
3234,光環,454,12,442,富邦-嘉義,2023-10-06,9692
00929,復華台灣科技優息,275,37,238,富邦-嘉義,2023-10-06,9692
00632R,元大台灣50反1,235,70,165,富邦-嘉義,2023-10-06,9692
3051,力特,242,91,151,富邦-嘉義,2023-10-06,9692
1568,倉佑,97,0,97,富邦-嘉義,2023-10-06,9692
3260,威剛,197,105,92,富邦-嘉義,2023-10-06,9692
2405,輔信,99,17,82,富邦-嘉義,2023-10-06,9692
2409,友達,83,6,77,富邦-嘉義,2023-10-06,9692
00680L,元大美債20正2,70,4,66,富邦-嘉義,2023-10-06,9692
2637,慧洋-KY,72,11,61,富邦-嘉義,2023-10-06,9692
3306,鼎天,57,0,57,富邦-嘉義,2023-10-06,9692
4906,正文,54,6,48,富邦-嘉義,2023-10-06,9692
6530,創威,60,14,46,富邦-嘉義,2023-10-06,9692
6168,宏齊,41,0,41,富邦-嘉義,2023-10-06,9692
2883,凱基金,40,0,40,富邦-嘉義,2023-10-06,9692
6274,台燿,77,38,39,富邦-嘉義,2023-10-06,9692
00712,復華富時不動產,41,3,38,富邦-嘉義,2023-10-06,9692
00679B,元大美債20年,53,15,38,富邦-嘉義,2023-10-06,9692
00720B,元大投資級公司債,38,0,38,富邦-嘉義,2023-10-06,9692
3689,湧德,35,0,35,富邦-嘉義,2023-10-06,9692
5521,工信,35,0,35,富邦-嘉義,2023-10-06,9692
3049,精金,39,6,33,富邦-嘉義,2023-10-06,9692
2603,長榮,55,22,33,富邦-嘉義,2023-10-06,9692
00715L,期街口布蘭特正2,32,0,32,富邦-嘉義,2023-10-06,9692
1316,上曜,31,1,30,富邦-嘉義,2023-10-06,9692
2618,長榮航,49,23,26,富邦-嘉義,2023-10-06,9692
3443,創意,55,29,26,富邦-嘉義,2023-10-06,9692
9105,泰金寶-DR,33,7,26,富邦-嘉義,2023-10-06,9692
4503,金雨,126,101,25,富邦-嘉義,2023-10-06,9692
3231,緯創,925,901,24,富邦-嘉義,2023-10-06,9692
2453,凌群,46,24,22,富邦-嘉義,2023-10-06,9692
5258,虹堡,28,6,22,富邦-嘉義,2023-10-06,9692
6231,系微,22,1,21,富邦-嘉義,2023-10-06,9692
2329,華泰,59,38,21,富邦-嘉義,2023-10-06,9692
2312,金寶,20,0,20,富邦-嘉義,2023-10-06,9692
1609,大亞,61,41,20,富邦-嘉義,2023-10-06,9692
2324,仁寶,20,0,20,富邦-嘉義,2023-10-06,9692
3022,威強電,20,0,20,富邦-嘉義,2023-10-06,9692
00717,富邦美國特別股,20,0,20,富邦-嘉義,2023-10-06,9692
8155,博智,18,0,18,富邦-嘉義,2023-10-06,9692
00757,統一FANG+,17,0,17,富邦-嘉義,2023-10-06,9692
1101,台泥,18,2,16,富邦-嘉義,2023-10-06,9692
5426,振發,17,2,15,富邦-嘉義,2023-10-06,9692
1616,億泰,15,1,14,富邦-嘉義,2023-10-06,9692
4128,中天,14,0,14,富邦-嘉義,2023-10-06,9692
00687B,國泰20年美債,14,0,14,富邦-嘉義,2023-10-06,9692
00897,富邦基因免疫生技,15,2,13,富邦-嘉義,2023-10-06,9692
8271,宇瞻,14,1,13,富邦-嘉義,2023-10-06,9692
6901,鑽石投資,18,6,12,富邦-嘉義,2023-10-06,9692
2371,大同,12,0,12,富邦-嘉義,2023-10-06,9692
2363,矽統,2772,1872,900,富邦-嘉義,2023-10-11,9692
00632R,元大台灣50反1,168,38,130,富邦-嘉義,2023-10-11,9692
00720B,元大投資級公司債,128,0,128,富邦-嘉義,2023-10-11,9692
2641,正德,102,2,100,富邦-嘉義,2023-10-11,9692
3325,旭品,226,136,90,富邦-嘉義,2023-10-11,9692
00919,群益台灣精選高息,118,31,87,富邦-嘉義,2023-10-11,9692
2618,長榮航,126,43,83,富邦-嘉義,2023-10-11,9692
00918,大華優利高填息30,70,0,70,富邦-嘉義,2023-10-11,9692
6216,居易,72,4,68,富邦-嘉義,2023-10-11,9692
00679B,元大美債20年,72,5,67,富邦-嘉義,2023-10-11,9692
6158,禾昌,181,122,59,富邦-嘉義,2023-10-11,9692
2358,廷鑫,52,2,50,富邦-嘉義,2023-10-11,9692
3231,緯創,4661,4613,48,富邦-嘉義,2023-10-11,9692
00931B,統一美債20年,41,2,39,富邦-嘉義,2023-10-11,9692
2367,燿華,37,0,37,富邦-嘉義,2023-10-11,9692
6197,佳必琪,41,5,36,富邦-嘉義,2023-10-11,9692
00929,復華台灣科技優息,100,67,33,富邦-嘉義,2023-10-11,9692
3483,力致,44,12,32,富邦-嘉義,2023-10-11,9692
3276,宇環,312,282,30,富邦-嘉義,2023-10-11,9692
2601,益航,31,1,30,富邦-嘉義,2023-10-11,9692
2340,台亞,49,19,30,富邦-嘉義,2023-10-11,9692
2002,中鋼,26,2,24,富邦-嘉義,2023-10-11,9692
3481,群創,24,2,22,富邦-嘉義,2023-10-11,9692
1312,國喬,22,0,22,富邦-嘉義,2023-10-11,9692
2365,昆盈,25,3,22,富邦-嘉義,2023-10-11,9692
00676R,富邦臺灣加權反1,22,0,22,富邦-嘉義,2023-10-11,9692
3706,神達,41,20,21,富邦-嘉義,2023-10-11,9692
2316,楠梓電,24,3,21,富邦-嘉義,2023-10-11,9692
3576,聯合再生,21,0,21,富邦-嘉義,2023-10-11,9692
8927,北基,20,0,20,富邦-嘉義,2023-10-11,9692
00922,國泰台灣領袖50,47,27,20,富邦-嘉義,2023-10-11,9692
2332,友訊,109,90,19,富邦-嘉義,2023-10-11,9692
3027,盛達,20,1,19,富邦-嘉義,2023-10-11,9692
8390,金益鼎,43,24,19,富邦-嘉義,2023-10-11,9692
2443,昶虹,19,0,19,富邦-嘉義,2023-10-11,9692
1609,大亞,24,5,19,富邦-嘉義,2023-10-11,9692
2204,中華,35,17,18,富邦-嘉義,2023-10-11,9692
4510,高鋒,16,0,16,富邦-嘉義,2023-10-11,9692
1104,環泥,15,0,15,富邦-嘉義,2023-10-11,9692
2337,旺宏,19,4,15,富邦-嘉義,2023-10-11,9692
3689,湧德,15,0,15,富邦-嘉義,2023-10-11,9692
2102,泰豐,15,0,15,富邦-嘉義,2023-10-11,9692
2515,中工,24,9,15,富邦-嘉義,2023-10-11,9692
00687B,國泰20年美債,27,12,15,富邦-嘉義,2023-10-11,9692
2329,華泰,34,20,14,富邦-嘉義,2023-10-11,9692
6122,擎邦,14,1,13,富邦-嘉義,2023-10-11,9692
2353,宏��,22,9,13,富邦-嘉義,2023-10-11,9692
4543,萬在,15,2,13,富邦-嘉義,2023-10-11,9692
4944,兆遠,14,1,13,富邦-嘉義,2023-10-11,9692
2615,萬海,14,1,13,富邦-嘉義,2023-10-11,9692
3231,緯創,4139,3116,1023,富邦-嘉義,2023-10-12,9692
00642U,期元大S＆P石油,612,5,607,富邦-嘉義,2023-10-12,9692
2382,廣達,1215,683,532,富邦-嘉義,2023-10-12,9692
2363,矽統,5239,4779,460,富邦-嘉義,2023-10-12,9692
00632R,元大台灣50反1,326,0,326,富邦-嘉義,2023-10-12,9692
4908,前鼎,340,53,287,富邦-嘉義,2023-10-12,9692
6276,安鈦克,269,4,265,富邦-嘉義,2023-10-12,9692
1603,華電,318,64,254,富邦-嘉義,2023-10-12,9692
3715,定穎投控,1496,1340,156,富邦-嘉義,2023-10-12,9692
2364,倫飛,117,22,95,富邦-嘉義,2023-10-12,9692
9928,中視,102,7,95,富邦-嘉義,2023-10-12,9692
2417,圓剛,117,36,81,富邦-嘉義,2023-10-12,9692
4763,材料-KY,81,8,73,富邦-嘉義,2023-10-12,9692
2883,凱基金,111,51,60,富邦-嘉義,2023-10-12,9692
8176,智捷,61,1,60,富邦-嘉義,2023-10-12,9692
6116,彩晶,61,2,59,富邦-嘉義,2023-10-12,9692
3013,晟銘電,185,130,55,富邦-嘉義,2023-10-12,9692
5521,工信,60,5,55,富邦-嘉義,2023-10-12,9692
2204,中華,73,19,54,富邦-嘉義,2023-10-12,9692
3035,智原,72,20,52,富邦-嘉義,2023-10-12,9692
5371,中光電,52,0,52,富邦-嘉義,2023-10-12,9692
6684,安格,64,13,51,富邦-嘉義,2023-10-12,9692
4967,十銓,56,7,49,富邦-嘉義,2023-10-12,9692
3443,創意,241,192,49,富邦-嘉義,2023-10-12,9692
4414,如興,52,7,45,富邦-嘉義,2023-10-12,9692
3234,光環,63,20,43,富邦-嘉義,2023-10-12,9692
1609,大亞,52,10,42,富邦-嘉義,2023-10-12,9692
2891,中信金,85,43,42,富邦-嘉義,2023-10-12,9692
2388,威盛,130,91,39,富邦-嘉義,2023-10-12,9692
00891,中信關鍵半導體,50,11,39,富邦-嘉義,2023-10-12,9692
00929,復華台灣科技優息,116,77,39,富邦-嘉義,2023-10-12,9692
3260,威剛,45,10,35,富邦-嘉義,2023-10-12,9692
6188,廣明,42,8,34,富邦-嘉義,2023-10-12,9692
2377,微星,32,0,32,富邦-嘉義,2023-10-12,9692
2368,金像電,73,44,29,富邦-嘉義,2023-10-12,9692
2855,統一證,25,0,25,富邦-嘉義,2023-10-12,9692
00679B,元大美債20年,26,5,21,富邦-嘉義,2023-10-12,9692
8048,德勝,22,1,21,富邦-嘉義,2023-10-12,9692
8033,雷虎,28,7,21,富邦-嘉義,2023-10-12,9692
5603,陸海,22,2,20,富邦-嘉義,2023-10-12,9692
2233,宇隆,25,6,19,富邦-嘉義,2023-10-12,9692
3006,晶豪科,74,56,18,富邦-嘉義,2023-10-12,9692
2609,陽明,22,4,18,富邦-嘉義,2023-10-12,9692
6213,聯茂,23,5,18,富邦-嘉義,2023-10-12,9692
2442,新美齊,17,0,17,富邦-嘉義,2023-10-12,9692
3363,上詮,83,66,17,富邦-嘉義,2023-10-12,9692
6197,佳必琪,22,6,16,富邦-嘉義,2023-10-12,9692
1440,南紡,16,0,16,富邦-嘉義,2023-10-12,9692
2374,佳能,16,0,16,富邦-嘉義,2023-10-12,9692
2349,錸德,16,0,16,富邦-嘉義,2023-10-12,9692
2485,兆赫,232,14,218,富邦-嘉義,2023-10-13,9692
00919,群益台灣精選高息,165,15,150,富邦-嘉義,2023-10-13,9692
2313,華通,126,10,116,富邦-嘉義,2023-10-13,9692
5706,鳳凰,105,5,100,富邦-嘉義,2023-10-13,9692
2449,京元電子,139,43,96,富邦-嘉義,2023-10-13,9692
3325,旭品,134,43,91,富邦-嘉義,2023-10-13,9692
0056,元大高股息,107,17,90,富邦-嘉義,2023-10-13,9692
4414,如興,90,0,90,富邦-嘉義,2023-10-13,9692
00922,國泰台灣領袖50,86,0,86,富邦-嘉義,2023-10-13,9692
8076,伍豐,95,19,76,富邦-嘉義,2023-10-13,9692
00931B,統一美債20年,69,0,69,富邦-嘉義,2023-10-13,9692
00655L,國泰中國A50正2,70,2,68,富邦-嘉義,2023-10-13,9692
00720B,元大投資級公司債,141,74,67,富邦-嘉義,2023-10-13,9692
3450,聯鈞,99,32,67,富邦-嘉義,2023-10-13,9692
2204,中華,69,7,62,富邦-嘉義,2023-10-13,9692
00632R,元大台灣50反1,62,3,59,富邦-嘉義,2023-10-13,9692
2516,新建,62,4,58,富邦-嘉義,2023-10-13,9692
2743,山富,70,12,58,富邦-嘉義,2023-10-13,9692
00878,國泰永續高股息,65,7,58,富邦-嘉義,2023-10-13,9692
2301,光寶科,77,20,57,富邦-嘉義,2023-10-13,9692
6187,萬潤,55,1,54,富邦-嘉義,2023-10-13,9692
00637L,元大滬深300正2,55,2,53,富邦-嘉義,2023-10-13,9692
6442,光聖,223,173,50,富邦-嘉義,2023-10-13,9692
8176,智捷,50,0,50,富邦-嘉義,2023-10-13,9692
00688L,國泰20年美債正2,45,0,45,富邦-嘉義,2023-10-13,9692
5215,科嘉-KY,60,15,45,富邦-嘉義,2023-10-13,9692
5258,虹堡,46,2,44,富邦-嘉義,2023-10-13,9692
2355,敬鵬,64,26,38,富邦-嘉義,2023-10-13,9692
2344,華邦電,57,19,38,富邦-嘉義,2023-10-13,9692
4906,正文,155,117,38,富邦-嘉義,2023-10-13,9692
6605,帝寶,63,28,35,富邦-嘉義,2023-10-13,9692
00679B,元大美債20年,82,47,35,富邦-嘉義,2023-10-13,9692
2376,技嘉,336,303,33,富邦-嘉義,2023-10-13,9692
00715L,期街口布蘭特正2,40,8,32,富邦-嘉義,2023-10-13,9692
2881,富邦金,34,3,31,富邦-嘉義,2023-10-13,9692
3338,泰碩,31,0,31,富邦-嘉義,2023-10-13,9692
3234,光環,35,4,31,富邦-嘉義,2023-10-13,9692
00751B,元大AAA至A公司債,30,0,30,富邦-嘉義,2023-10-13,9692
1609,大亞,35,5,30,富邦-嘉義,2023-10-13,9692
2851,中再保,28,0,28,富邦-嘉義,2023-10-13,9692
1524,耿鼎,173,146,27,富邦-嘉義,2023-10-13,9692
3078,僑威,71,45,26,富邦-嘉義,2023-10-13,9692
6284,佳邦,58,32,26,富邦-嘉義,2023-10-13,9692
3481,群創,48,22,26,富邦-嘉義,2023-10-13,9692
1810,和成,25,1,24,富邦-嘉義,2023-10-13,9692
6158,禾昌,30,6,24,富邦-嘉義,2023-10-13,9692
6530,創威,35,11,24,富邦-嘉義,2023-10-13,9692
2892,第一金,24,1,23,富邦-嘉義,2023-10-13,9692
2002,中鋼,20,0,20,富邦-嘉義,2023-10-13,9692
6191,精成科,24,6,18,富邦-嘉義,2023-10-13,9692
2344,華邦電,434,84,350,富邦-嘉義,2023-10-16,9692
00922,國泰台灣領袖50,265,0,265,富邦-嘉義,2023-10-16,9692
2888,新光金,229,7,222,富邦-嘉義,2023-10-16,9692
00929,復華台灣科技優息,231,13,218,富邦-嘉義,2023-10-16,9692
00715L,期街口布蘭特正2,152,7,145,富邦-嘉義,2023-10-16,9692
0056,元大高股息,153,10,143,富邦-嘉義,2023-10-16,9692
2363,矽統,3340,3199,141,富邦-嘉義,2023-10-16,9692
2618,長榮航,193,79,114,富邦-嘉義,2023-10-16,9692
5521,工信,90,5,85,富邦-嘉義,2023-10-16,9692
00673R,期元大S＆P原油反1,86,7,79,富邦-嘉義,2023-10-16,9692
4906,正文,120,46,74,富邦-嘉義,2023-10-16,9692
2409,友達,77,12,65,富邦-嘉義,2023-10-16,9692
4979,華星光,171,113,58,富邦-嘉義,2023-10-16,9692
3706,神達,73,16,57,富邦-嘉義,2023-10-16,9692
3276,宇環,74,17,57,富邦-嘉義,2023-10-16,9692
2610,華航,94,38,56,富邦-嘉義,2023-10-16,9692
1605,華新,57,3,54,富邦-嘉義,2023-10-16,9692
3481,群創,93,40,53,富邦-嘉義,2023-10-16,9692
00927,群益半導體收益,50,0,50,富邦-嘉義,2023-10-16,9692
2323,中環,52,4,48,富邦-嘉義,2023-10-16,9692
4743,合一,53,6,47,富邦-嘉義,2023-10-16,9692
00878,國泰永續高股息,48,1,47,富邦-嘉義,2023-10-16,9692
6530,創威,170,126,44,富邦-嘉義,2023-10-16,9692
00679B,元大美債20年,43,0,43,富邦-嘉義,2023-10-16,9692
2313,華通,63,20,43,富邦-嘉義,2023-10-16,9692
6139,亞翔,51,13,38,富邦-嘉義,2023-10-16,9692
00720B,元大投資級公司債,136,100,36,富邦-嘉義,2023-10-16,9692
1447,力鵬,35,1,34,富邦-嘉義,2023-10-16,9692
2201,裕隆,70,38,32,富邦-嘉義,2023-10-16,9692
2601,益航,32,0,32,富邦-嘉義,2023-10-16,9692
3036,文曄,42,10,32,富邦-嘉義,2023-10-16,9692
6770,力積電,46,15,31,富邦-嘉義,2023-10-16,9692
00712,復華富時不動產,32,2,30,富邦-嘉義,2023-10-16,9692
2367,燿華,30,0,30,富邦-嘉義,2023-10-16,9692
2376,技嘉,193,164,29,富邦-嘉義,2023-10-16,9692
3231,緯創,728,699,29,富邦-嘉義,2023-10-16,9692
2206,三陽工業,35,9,26,富邦-嘉義,2023-10-16,9692
1409,新纖,30,5,25,富邦-嘉義,2023-10-16,9692
5452,佶優,20,0,20,富邦-嘉義,2023-10-16,9692
2390,云辰,63,43,20,富邦-嘉義,2023-10-16,9692
3025,星通,71,52,19,富邦-嘉義,2023-10-16,9692
1714,和桐,38,20,18,富邦-嘉義,2023-10-16,9692
6274,台燿,26,9,17,富邦-嘉義,2023-10-16,9692
6170,統振,22,5,17,富邦-嘉義,2023-10-16,9692
3049,精金,17,0,17,富邦-嘉義,2023-10-16,9692
3037,欣興,31,15,16,富邦-嘉義,2023-10-16,9692
2312,金寶,21,5,16,富邦-嘉義,2023-10-16,9692
2233,宇隆,39,23,16,富邦-嘉義,2023-10-16,9692
8996,高力,39,24,15,富邦-嘉義,2023-10-16,9692
00687B,國泰20年美債,27,13,14,富邦-嘉義,2023-10-16,9692
0056,元大高股息,272,16,256,富邦-嘉義,2023-10-17,9692
00922,國泰台灣領袖50,182,0,182,富邦-嘉義,2023-10-17,9692
2388,威盛,303,144,159,富邦-嘉義,2023-10-17,9692
2601,益航,148,1,147,富邦-嘉義,2023-10-17,9692
3481,群創,170,23,147,富邦-嘉義,2023-10-17,9692
2887,台新金,127,3,124,富邦-嘉義,2023-10-17,9692
3576,聯合再生,124,2,122,富邦-嘉義,2023-10-17,9692
00929,復華台灣科技優息,126,10,116,富邦-嘉義,2023-10-17,9692
00720B,元大投資級公司債,111,2,109,富邦-嘉義,2023-10-17,9692
3548,兆利,258,154,104,富邦-嘉義,2023-10-17,9692
4906,正文,126,31,95,富邦-嘉義,2023-10-17,9692
3049,精金,82,0,82,富邦-嘉義,2023-10-17,9692
00927,群益半導體收益,80,0,80,富邦-嘉義,2023-10-17,9692
2891,中信金,66,3,63,富邦-嘉義,2023-10-17,9692
2618,長榮航,80,20,60,富邦-嘉義,2023-10-17,9692
6114,久威,170,117,53,富邦-嘉義,2023-10-17,9692
00902,中信電池及儲能,51,0,51,富邦-嘉義,2023-10-17,9692
9939,宏全,50,0,50,富邦-嘉義,2023-10-17,9692
2323,中環,49,0,49,富邦-嘉義,2023-10-17,9692
8176,智捷,102,54,48,富邦-嘉義,2023-10-17,9692
2371,大同,48,3,45,富邦-嘉義,2023-10-17,9692
00680L,元大美債20正2,47,3,44,富邦-嘉義,2023-10-17,9692
2317,鴻海,44,1,43,富邦-嘉義,2023-10-17,9692
3483,力致,81,40,41,富邦-嘉義,2023-10-17,9692
2401,凌陽,67,26,41,富邦-嘉義,2023-10-17,9692
00751B,元大AAA至A公司債,40,0,40,富邦-嘉義,2023-10-17,9692
00679B,元大美債20年,39,0,39,富邦-嘉義,2023-10-17,9692
2201,裕隆,61,22,39,富邦-嘉義,2023-10-17,9692
2888,新光金,38,0,38,富邦-嘉義,2023-10-17,9692
2610,華航,53,16,37,富邦-嘉義,2023-10-17,9692
2364,倫飛,45,8,37,富邦-嘉義,2023-10-17,9692
2637,慧洋-KY,41,4,37,富邦-嘉義,2023-10-17,9692
00687B,國泰20年美債,48,12,36,富邦-嘉義,2023-10-17,9692
3491,昇達科,49,18,31,富邦-嘉義,2023-10-17,9692
2352,佳世達,33,3,30,富邦-嘉義,2023-10-17,9692
2634,漢翔,36,7,29,富邦-嘉義,2023-10-17,9692
3078,僑威,130,101,29,富邦-嘉義,2023-10-17,9692
2516,新建,31,3,28,富邦-嘉義,2023-10-17,9692
00931B,統一美債20年,28,0,28,富邦-嘉義,2023-10-17,9692
6005,群益證,26,0,26,富邦-嘉義,2023-10-17,9692
00722B,群益投資級電信債,25,0,25,富邦-嘉義,2023-10-17,9692
9955,佳龍,92,67,25,富邦-嘉義,2023-10-17,9692
3094,聯傑,125,102,23,富邦-嘉義,2023-10-17,9692
2368,金像電,29,7,22,富邦-嘉義,2023-10-17,9692
1815,富喬,30,8,22,富邦-嘉義,2023-10-17,9692
00878,國泰永續高股息,72,51,21,富邦-嘉義,2023-10-17,9692
00900,富邦特選高股息30,25,5,20,富邦-嘉義,2023-10-17,9692
1447,力鵬,20,0,20,富邦-嘉義,2023-10-17,9692
00662,富邦NASDAQ,19,0,19,富邦-嘉義,2023-10-17,9692
2206,三陽工業,18,0,18,富邦-嘉義,2023-10-17,9692
00929,復華台灣科技優息,503,76,427,富邦-嘉義,2023-10-18,9692
0056,元大高股息,405,67,338,富邦-嘉義,2023-10-18,9692
00922,國泰台灣領袖50,237,1,236,富邦-嘉義,2023-10-18,9692
00878,國泰永續高股息,260,48,212,富邦-嘉義,2023-10-18,9692
2382,廣達,784,588,196,富邦-嘉義,2023-10-18,9692
00919,群益台灣精選高息,185,28,157,富邦-嘉義,2023-10-18,9692
00715L,期街口布蘭特正2,122,17,105,富邦-嘉義,2023-10-18,9692
1324,地球,278,183,95,富邦-嘉義,2023-10-18,9692
3481,群創,101,21,80,富邦-嘉義,2023-10-18,9692
2344,華邦電,70,3,67,富邦-嘉義,2023-10-18,9692
2618,長榮航,126,61,65,富邦-嘉義,2023-10-18,9692
1815,富喬,93,29,64,富邦-嘉義,2023-10-18,9692
2634,漢翔,78,16,62,富邦-嘉義,2023-10-18,9692
6530,創威,214,153,61,富邦-嘉義,2023-10-18,9692
1101,台泥,79,20,59,富邦-嘉義,2023-10-18,9692
6026,福邦證,57,0,57,富邦-嘉義,2023-10-18,9692
3715,定穎投控,410,356,54,富邦-嘉義,2023-10-18,9692
2002,中鋼,60,6,54,富邦-嘉義,2023-10-18,9692
3044,健鼎,51,1,50,富邦-嘉義,2023-10-18,9692
2486,一詮,62,14,48,富邦-嘉義,2023-10-18,9692
4906,正文,77,30,47,富邦-嘉義,2023-10-18,9692
1609,大亞,46,0,46,富邦-嘉義,2023-10-18,9692
00720B,元大投資級公司債,45,0,45,富邦-嘉義,2023-10-18,9692
3049,精金,45,1,44,富邦-嘉義,2023-10-18,9692
00687B,國泰20年美債,41,0,41,富邦-嘉義,2023-10-18,9692
2323,中環,44,3,41,富邦-嘉義,2023-10-18,9692
2352,佳世達,53,14,39,富邦-嘉義,2023-10-18,9692
6276,安鈦克,34,2,32,富邦-嘉義,2023-10-18,9692
3122,笙泉,35,5,30,富邦-嘉義,2023-10-18,9692
2376,技嘉,593,565,28,富邦-嘉義,2023-10-18,9692
00893,國泰智能電動車,29,1,28,富邦-嘉義,2023-10-18,9692
2888,新光金,37,10,27,富邦-嘉義,2023-10-18,9692
2324,仁寶,29,3,26,富邦-嘉義,2023-10-18,9692
3037,欣興,33,8,25,富邦-嘉義,2023-10-18,9692
2201,裕隆,33,9,24,富邦-嘉義,2023-10-18,9692
2748,雲品,24,0,24,富邦-嘉義,2023-10-18,9692
4960,誠美材,82,58,24,富邦-嘉義,2023-10-18,9692
2383,台光電,39,16,23,富邦-嘉義,2023-10-18,9692
2204,中華,23,1,22,富邦-嘉義,2023-10-18,9692
2354,鴻準,23,1,22,富邦-嘉義,2023-10-18,9692
00892,富邦台灣半導體,38,16,22,富邦-嘉義,2023-10-18,9692
00730,富邦臺灣優質高息,21,0,21,富邦-嘉義,2023-10-18,9692
00900,富邦特選高股息30,23,2,21,富邦-嘉義,2023-10-18,9692
00751B,元大AAA至A公司債,20,0,20,富邦-嘉義,2023-10-18,9692
00772B,中信高評級公司債,20,0,20,富邦-嘉義,2023-10-18,9692
5465,富驊,20,0,20,富邦-嘉義,2023-10-18,9692
2369,菱生,47,27,20,富邦-嘉義,2023-10-18,9692
9958,世紀鋼,23,3,20,富邦-嘉義,2023-10-18,9692
2516,新建,20,0,20,富邦-嘉義,2023-10-18,9692
3227,原相,24,4,20,富邦-嘉義,2023-10-18,9692
3231,緯創,1784,467,1317,富邦-嘉義,2023-10-19,9692
2382,廣達,1458,1103,355,富邦-嘉義,2023-10-19,9692
2515,中工,311,19,292,富邦-嘉義,2023-10-19,9692
0056,元大高股息,249,25,224,富邦-嘉義,2023-10-19,9692
5521,工信,212,14,198,富邦-嘉義,2023-10-19,9692
00720B,元大投資級公司債,154,1,153,富邦-嘉義,2023-10-19,9692
00687B,國泰20年美債,153,1,152,富邦-嘉義,2023-10-19,9692
00922,國泰台灣領袖50,157,6,151,富邦-嘉義,2023-10-19,9692
1101,台泥,172,30,142,富邦-嘉義,2023-10-19,9692
00878,國泰永續高股息,165,34,131,富邦-嘉義,2023-10-19,9692
4401,東隆興,123,0,123,富邦-嘉義,2023-10-19,9692
00933B,國泰10Y+金融債,198,96,102,富邦-嘉義,2023-10-19,9692
2363,矽統,537,456,81,富邦-嘉義,2023-10-19,9692
00885,富邦越南,86,6,80,富邦-嘉義,2023-10-19,9692
1324,地球,220,144,76,富邦-嘉義,2023-10-19,9692
00751B,元大AAA至A公司債,75,1,74,富邦-嘉義,2023-10-19,9692
4743,合一,82,11,71,富邦-嘉義,2023-10-19,9692
6237,驊訊,101,34,67,富邦-嘉義,2023-10-19,9692
00712,復華富時不動產,66,3,63,富邦-嘉義,2023-10-19,9692
2449,京元電子,108,48,60,富邦-嘉義,2023-10-19,9692
3122,笙泉,78,18,60,富邦-嘉義,2023-10-19,9692
00679B,元大美債20年,63,4,59,富邦-嘉義,2023-10-19,9692
2369,菱生,68,9,59,富邦-嘉義,2023-10-19,9692
1568,倉佑,171,113,58,富邦-嘉義,2023-10-19,9692
00893,國泰智能電動車,54,0,54,富邦-嘉義,2023-10-19,9692
3041,揚智,197,144,53,富邦-嘉義,2023-10-19,9692
2409,友達,58,6,52,富邦-嘉義,2023-10-19,9692
2323,中環,43,0,43,富邦-嘉義,2023-10-19,9692
2465,麗臺,48,7,41,富邦-嘉義,2023-10-19,9692
2888,新光金,60,22,38,富邦-嘉義,2023-10-19,9692
2317,鴻海,50,12,38,富邦-嘉義,2023-10-19,9692
2607,榮運,37,0,37,富邦-嘉義,2023-10-19,9692
00931B,統一美債20年,38,2,36,富邦-嘉義,2023-10-19,9692
2356,英業達,69,34,35,富邦-嘉義,2023-10-19,9692
00715L,期街口布蘭特正2,34,0,34,富邦-嘉義,2023-10-19,9692
00882,中信中國高股息,30,0,30,富邦-嘉義,2023-10-19,9692
2538,基泰,30,0,30,富邦-嘉義,2023-10-19,9692
4763,材料-KY,98,69,29,富邦-嘉義,2023-10-19,9692
9955,佳龍,159,131,28,富邦-嘉義,2023-10-19,9692
00655L,國泰中國A50正2,27,0,27,富邦-嘉義,2023-10-19,9692
1524,耿鼎,96,70,26,富邦-嘉義,2023-10-19,9692
6901,鑽石投資,31,8,23,富邦-嘉義,2023-10-19,9692
2344,華邦電,41,19,22,富邦-嘉義,2023-10-19,9692
2353,宏��,25,3,22,富邦-嘉義,2023-10-19,9692
4908,前鼎,441,419,22,富邦-嘉義,2023-10-19,9692
2884,玉山金,31,10,21,富邦-嘉義,2023-10-19,9692
00918,大華優利高填息30,21,0,21,富邦-嘉義,2023-10-19,9692
00772B,中信高評級公司債,20,0,20,富邦-嘉義,2023-10-19,9692
6243,迅杰,20,0,20,富邦-嘉義,2023-10-19,9692
1313,聯成,20,0,20,富邦-嘉義,2023-10-19,9692
2382,廣達,2236,1845,391,富邦-嘉義,2023-10-20,9692
2376,技嘉,690,390,300,富邦-嘉義,2023-10-20,9692
2369,菱生,388,162,226,富邦-嘉義,2023-10-20,9692
00720B,元大投資級公司債,219,20,199,富邦-嘉義,2023-10-20,9692
00712,復華富時不動產,216,50,166,富邦-嘉義,2023-10-20,9692
2305,全友,206,55,151,富邦-嘉義,2023-10-20,9692
2363,矽統,532,383,149,富邦-嘉義,2023-10-20,9692
00929,復華台灣科技優息,176,39,137,富邦-嘉義,2023-10-20,9692
00878,國泰永續高股息,176,54,122,富邦-嘉義,2023-10-20,9692
1721,三晃,129,7,122,富邦-嘉義,2023-10-20,9692
6770,力積電,134,17,117,富邦-嘉義,2023-10-20,9692
00751B,元大AAA至A公司債,118,1,117,富邦-嘉義,2023-10-20,9692
0056,元大高股息,129,22,107,富邦-嘉義,2023-10-20,9692
6442,光聖,96,1,95,富邦-嘉義,2023-10-20,9692
2883,凱基金,90,1,89,富邦-嘉義,2023-10-20,9692
6113,亞矽,100,15,85,富邦-嘉義,2023-10-20,9692
1101,台泥,87,5,82,富邦-嘉義,2023-10-20,9692
2601,益航,80,0,80,富邦-嘉義,2023-10-20,9692
2002,中鋼,79,3,76,富邦-嘉義,2023-10-20,9692
00933B,國泰10Y+金融債,63,1,62,富邦-嘉義,2023-10-20,9692
6026,福邦證,61,0,61,富邦-嘉義,2023-10-20,9692
00919,群益台灣精選高息,68,8,60,富邦-嘉義,2023-10-20,9692
00680L,元大美債20正2,75,16,59,富邦-嘉義,2023-10-20,9692
2888,新光金,98,40,58,富邦-嘉義,2023-10-20,9692
4906,正文,100,43,57,富邦-嘉義,2023-10-20,9692
2409,友達,63,11,52,富邦-嘉義,2023-10-20,9692
2834,臺企銀,59,9,50,富邦-嘉義,2023-10-20,9692
2880,華南金,50,1,49,富邦-嘉義,2023-10-20,9692
00642U,期元大S＆P石油,52,5,47,富邦-嘉義,2023-10-20,9692
00673R,期元大S＆P原油反1,48,4,44,富邦-嘉義,2023-10-20,9692
5880,合庫金,43,0,43,富邦-嘉義,2023-10-20,9692
3325,旭品,44,3,41,富邦-嘉義,2023-10-20,9692
2913,農林,40,0,40,富邦-嘉義,2023-10-20,9692
3049,精金,40,0,40,富邦-嘉義,2023-10-20,9692
2881,富邦金,43,5,38,富邦-嘉義,2023-10-20,9692
1524,耿鼎,92,57,35,富邦-嘉義,2023-10-20,9692
2102,泰豐,35,0,35,富邦-嘉義,2023-10-20,9692
2892,第一金,35,1,34,富邦-嘉義,2023-10-20,9692
6114,久威,53,20,33,富邦-嘉義,2023-10-20,9692
6443,元晶,38,6,32,富邦-嘉義,2023-10-20,9692
00687B,國泰20年美債,32,2,30,富邦-嘉義,2023-10-20,9692
1718,中纖,31,1,30,富邦-嘉義,2023-10-20,9692
00892,富邦台灣半導體,40,11,29,富邦-嘉義,2023-10-20,9692
2885,元大金,32,3,29,富邦-嘉義,2023-10-20,9692
6235,華孚,107,81,26,富邦-嘉義,2023-10-20,9692
2884,玉山金,42,16,26,富邦-嘉義,2023-10-20,9692
3044,健鼎,27,1,26,富邦-嘉義,2023-10-20,9692
1785,光洋科,39,14,25,富邦-嘉義,2023-10-20,9692
00893,國泰智能電動車,38,13,25,富邦-嘉義,2023-10-20,9692
2516,新建,26,4,22,富邦-嘉義,2023-10-20,9692
6168,宏齊,576,231,345,富邦-嘉義,2023-10-23,9692
00929,復華台灣科技優息,359,20,339,富邦-嘉義,2023-10-23,9692
00712,復華富時不動產,258,0,258,富邦-嘉義,2023-10-23,9692
3715,定穎投控,688,497,191,富邦-嘉義,2023-10-23,9692
00878,國泰永續高股息,171,27,144,富邦-嘉義,2023-10-23,9692
00751B,元大AAA至A公司債,140,1,139,富邦-嘉義,2023-10-23,9692
00708L,期元大S＆P黃金正2,132,0,132,富邦-嘉義,2023-10-23,9692
3025,星通,120,15,105,富邦-嘉義,2023-10-23,9692
2376,技嘉,282,184,98,富邦-嘉義,2023-10-23,9692
1324,地球,272,181,91,富邦-嘉義,2023-10-23,9692
4743,合一,105,18,87,富邦-嘉義,2023-10-23,9692
6113,亞矽,191,110,81,富邦-嘉義,2023-10-23,9692
6695,芯鼎,80,3,77,富邦-嘉義,2023-10-23,9692
00919,群益台灣精選高息,92,16,76,富邦-嘉義,2023-10-23,9692
3122,笙泉,337,271,66,富邦-嘉義,2023-10-23,9692
0056,元大高股息,95,34,61,富邦-嘉義,2023-10-23,9692
4401,東隆興,57,3,54,富邦-嘉義,2023-10-23,9692
00923,群益台ESG低碳50,51,0,51,富邦-嘉義,2023-10-23,9692
2409,友達,70,22,48,富邦-嘉義,2023-10-23,9692
3701,大眾控,64,19,45,富邦-嘉義,2023-10-23,9692
2317,鴻海,122,79,43,富邦-嘉義,2023-10-23,9692
6733,博晟生醫,40,0,40,富邦-嘉義,2023-10-23,9692
5272,笙科,260,221,39,富邦-嘉義,2023-10-23,9692
2002,中鋼,39,0,39,富邦-嘉義,2023-10-23,9692
00720B,元大投資級公司債,44,6,38,富邦-嘉義,2023-10-23,9692
00932,兆豐永續高息等權,29,0,29,富邦-嘉義,2023-10-23,9692
4162,智擎,51,22,29,富邦-嘉義,2023-10-23,9692
00679B,元大美債20年,54,27,27,富邦-嘉義,2023-10-23,9692
2201,裕隆,27,1,26,富邦-嘉義,2023-10-23,9692
1605,華新,26,0,26,富邦-嘉義,2023-10-23,9692
1101,台泥,29,4,25,富邦-嘉義,2023-10-23,9692
2880,華南金,27,2,25,富邦-嘉義,2023-10-23,9692
00688L,國泰20年美債正2,85,60,25,富邦-嘉義,2023-10-23,9692
4714,永捷,92,67,25,富邦-嘉義,2023-10-23,9692
00893,國泰智能電動車,41,17,24,富邦-嘉義,2023-10-23,9692
4908,前鼎,100,77,23,富邦-嘉義,2023-10-23,9692
3704,合勤控,48,25,23,富邦-嘉義,2023-10-23,9692
1301,台塑,23,0,23,富邦-嘉義,2023-10-23,9692
2891,中信金,32,9,23,富邦-嘉義,2023-10-23,9692
2330,台積電,24,2,22,富邦-嘉義,2023-10-23,9692
1609,大亞,35,13,22,富邦-嘉義,2023-10-23,9692
00900,富邦特選高股息30,23,2,21,富邦-嘉義,2023-10-23,9692
1815,富喬,24,3,21,富邦-嘉義,2023-10-23,9692
2367,燿華,21,1,20,富邦-嘉義,2023-10-23,9692
5608,四維航,22,2,20,富邦-嘉義,2023-10-23,9692
2105,正新,21,1,20,富邦-嘉義,2023-10-23,9692
2543,皇昌,20,0,20,富邦-嘉義,2023-10-23,9692
00924,復華S＆P500成長,20,0,20,富邦-嘉義,2023-10-23,9692
00664R,國泰臺灣加權反1,20,0,20,富邦-嘉義,2023-10-23,9692
3481,群創,32,12,20,富邦-嘉義,2023-10-23,9692
4979,華星光,961,667,294,富邦-嘉義,2023-10-24,9692
2405,輔信,530,256,274,富邦-嘉義,2023-10-24,9692
3535,晶彩科,262,0,262,富邦-嘉義,2023-10-24,9692
1524,耿鼎,343,141,202,富邦-嘉義,2023-10-24,9692
4908,前鼎,1378,1186,192,富邦-嘉義,2023-10-24,9692
2329,華泰,180,24,156,富邦-嘉義,2023-10-24,9692
2305,全友,311,156,155,富邦-嘉義,2023-10-24,9692
00712,復華富時不動產,210,58,152,富邦-嘉義,2023-10-24,9692
6139,亞翔,744,600,144,富邦-嘉義,2023-10-24,9692
2834,臺企銀,121,7,114,富邦-嘉義,2023-10-24,9692
4162,智擎,312,200,112,富邦-嘉義,2023-10-24,9692
3025,星通,627,518,109,富邦-嘉義,2023-10-24,9692
2317,鴻海,203,102,101,富邦-嘉義,2023-10-24,9692
2838,聯邦銀,100,0,100,富邦-嘉義,2023-10-24,9692
3693,營邦,105,6,99,富邦-嘉義,2023-10-24,9692
6114,久威,283,184,99,富邦-嘉義,2023-10-24,9692
1618,合機,105,7,98,富邦-嘉義,2023-10-24,9692
00929,復華台灣科技優息,117,26,91,富邦-嘉義,2023-10-24,9692
2816,旺旺保,71,3,68,富邦-嘉義,2023-10-24,9692
2340,台亞,82,16,66,富邦-嘉義,2023-10-24,9692
6216,居易,73,12,61,富邦-嘉義,2023-10-24,9692
00919,群益台灣精選高息,53,0,53,富邦-嘉義,2023-10-24,9692
00715L,期街口布蘭特正2,56,3,53,富邦-嘉義,2023-10-24,9692
00753L,中信中國50正2,52,0,52,富邦-嘉義,2023-10-24,9692
3231,緯創,493,441,52,富邦-嘉義,2023-10-24,9692
00680L,元大美債20正2,50,0,50,富邦-嘉義,2023-10-24,9692
2301,光寶科,54,6,48,富邦-嘉義,2023-10-24,9692
00687B,國泰20年美債,48,0,48,富邦-嘉義,2023-10-24,9692
2468,華經,67,19,48,富邦-嘉義,2023-10-24,9692
2882,國泰金,48,0,48,富邦-嘉義,2023-10-24,9692
00679B,元大美債20年,57,13,44,富邦-嘉義,2023-10-24,9692
6530,創威,167,125,42,富邦-嘉義,2023-10-24,9692
2388,威盛,170,129,41,富邦-嘉義,2023-10-24,9692
00900,富邦特選高股息30,51,12,39,富邦-嘉義,2023-10-24,9692
2002,中鋼,39,3,36,富邦-嘉義,2023-10-24,9692
2880,華南金,36,0,36,富邦-嘉義,2023-10-24,9692
2634,漢翔,39,4,35,富邦-嘉義,2023-10-24,9692
00637L,元大滬深300正2,34,0,34,富邦-嘉義,2023-10-24,9692
4944,兆遠,36,3,33,富邦-嘉義,2023-10-24,9692
2233,宇隆,103,72,31,富邦-嘉義,2023-10-24,9692
1301,台塑,30,0,30,富邦-嘉義,2023-10-24,9692
4763,材料-KY,34,4,30,富邦-嘉義,2023-10-24,9692
5258,虹堡,36,6,30,富邦-嘉義,2023-10-24,9692
6026,福邦證,29,0,29,富邦-嘉義,2023-10-24,9692
2883,凱基金,37,10,27,富邦-嘉義,2023-10-24,9692
1721,三晃,822,795,27,富邦-嘉義,2023-10-24,9692
5880,合庫金,27,0,27,富邦-嘉義,2023-10-24,9692
3041,揚智,271,245,26,富邦-嘉義,2023-10-24,9692
00655L,國泰中國A50正2,26,0,26,富邦-嘉義,2023-10-24,9692
2887,台新金,37,11,26,富邦-嘉義,2023-10-24,9692
00642U,期元大S＆P石油,600,2,598,富邦-嘉義,2023-10-25,9692
3041,揚智,1567,1145,422,富邦-嘉義,2023-10-25,9692
2313,華通,209,23,186,富邦-嘉義,2023-10-25,9692
6237,驊訊,267,100,167,富邦-嘉義,2023-10-25,9692
1721,三晃,338,182,156,富邦-嘉義,2023-10-25,9692
1785,光洋科,149,22,127,富邦-嘉義,2023-10-25,9692
00712,復華富時不動產,121,0,121,富邦-嘉義,2023-10-25,9692
6117,迎廣,509,397,112,富邦-嘉義,2023-10-25,9692
5439,高技,135,30,105,富邦-嘉義,2023-10-25,9692
00687B,國泰20年美債,92,0,92,富邦-嘉義,2023-10-25,9692
8110,華東,224,154,70,富邦-嘉義,2023-10-25,9692
1324,地球,260,199,61,富邦-嘉義,2023-10-25,9692
2317,鴻海,78,28,50,富邦-嘉義,2023-10-25,9692
2233,宇隆,83,37,46,富邦-嘉義,2023-10-25,9692
00878,國泰永續高股息,70,26,44,富邦-嘉義,2023-10-25,9692
2834,臺企銀,56,15,41,富邦-嘉義,2023-10-25,9692
1471,首利,58,19,39,富邦-嘉義,2023-10-25,9692
00933B,國泰10Y+金融債,71,33,38,富邦-嘉義,2023-10-25,9692
00715L,期街口布蘭特正2,32,0,32,富邦-嘉義,2023-10-25,9692
2371,大同,32,0,32,富邦-嘉義,2023-10-25,9692
4960,誠美材,54,23,31,富邦-嘉義,2023-10-25,9692
00665L,富邦�琤肭磪囓�2,29,0,29,富邦-嘉義,2023-10-25,9692
2369,菱生,234,205,29,富邦-嘉義,2023-10-25,9692
00929,復華台灣科技優息,106,77,29,富邦-嘉義,2023-10-25,9692
4944,兆遠,36,8,28,富邦-嘉義,2023-10-25,9692
00679B,元大美債20年,29,1,28,富邦-嘉義,2023-10-25,9692
2913,農林,31,4,27,富邦-嘉義,2023-10-25,9692
2618,長榮航,50,24,26,富邦-嘉義,2023-10-25,9692
6593,台灣銘板,36,10,26,富邦-嘉義,2023-10-25,9692
2402,毅嘉,32,8,24,富邦-嘉義,2023-10-25,9692
3481,群創,136,114,22,富邦-嘉義,2023-10-25,9692
6695,芯鼎,35,13,22,富邦-嘉義,2023-10-25,9692
6443,元晶,24,2,22,富邦-嘉義,2023-10-25,9692
2464,盟立,22,2,20,富邦-嘉義,2023-10-25,9692
6026,福邦證,20,0,20,富邦-嘉義,2023-10-25,9692
5289,宜鼎,21,1,20,富邦-嘉義,2023-10-25,9692
8069,元太,21,2,19,富邦-嘉義,2023-10-25,9692
2462,良得電,21,5,16,富邦-嘉義,2023-10-25,9692
1514,亞力,20,4,16,富邦-嘉義,2023-10-25,9692
2337,旺宏,40,25,15,富邦-嘉義,2023-10-25,9692
1781,合世,15,0,15,富邦-嘉義,2023-10-25,9692
2324,仁寶,21,6,15,富邦-嘉義,2023-10-25,9692
00902,中信電池及儲能,15,0,15,富邦-嘉義,2023-10-25,9692
6284,佳邦,18,5,13,富邦-嘉義,2023-10-25,9692
2886,兆豐金,13,1,12,富邦-嘉義,2023-10-25,9692
1795,美時,19,7,12,富邦-嘉義,2023-10-25,9692
00905,FT臺灣Smart,12,0,12,富邦-嘉義,2023-10-25,9692
3276,宇環,14,2,12,富邦-嘉義,2023-10-25,9692
2543,皇昌,32,21,11,富邦-嘉義,2023-10-25,9692
00931B,統一美債20年,11,0,11,富邦-嘉義,2023-10-25,9692
00929,復華台灣科技優息,396,48,348,富邦-嘉義,2023-10-26,9692
2485,兆赫,297,34,263,富邦-嘉義,2023-10-26,9692
4906,正文,172,5,167,富邦-嘉義,2023-10-26,9692
2883,凱基金,134,12,122,富邦-嘉義,2023-10-26,9692
00712,復華富時不動產,159,45,114,富邦-嘉義,2023-10-26,9692
0056,元大高股息,114,6,108,富邦-嘉義,2023-10-26,9692
2303,聯電,317,210,107,富邦-嘉義,2023-10-26,9692
00919,群益台灣精選高息,135,32,103,富邦-嘉義,2023-10-26,9692
00878,國泰永續高股息,116,22,94,富邦-嘉義,2023-10-26,9692
2344,華邦電,123,38,85,富邦-嘉義,2023-10-26,9692
3049,精金,110,29,81,富邦-嘉義,2023-10-26,9692
00632R,元大台灣50反1,245,167,78,富邦-嘉義,2023-10-26,9692
00885,富邦越南,80,9,71,富邦-嘉義,2023-10-26,9692
00720B,元大投資級公司債,64,0,64,富邦-嘉義,2023-10-26,9692
2838,聯邦銀,60,0,60,富邦-嘉義,2023-10-26,9692
2601,益航,60,0,60,富邦-嘉義,2023-10-26,9692
2743,山富,60,4,56,富邦-嘉義,2023-10-26,9692
2888,新光金,55,0,55,富邦-嘉義,2023-10-26,9692
3276,宇環,76,23,53,富邦-嘉義,2023-10-26,9692
8176,智捷,58,5,53,富邦-嘉義,2023-10-26,9692
1326,台化,44,0,44,富邦-嘉義,2023-10-26,9692
00922,國泰台灣領袖50,47,6,41,富邦-嘉義,2023-10-26,9692
2352,佳世達,41,1,40,富邦-嘉義,2023-10-26,9692
2002,中鋼,48,10,38,富邦-嘉義,2023-10-26,9692
2330,台積電,45,7,38,富邦-嘉義,2023-10-26,9692
1301,台塑,39,2,37,富邦-嘉義,2023-10-26,9692
8358,金居,41,5,36,富邦-嘉義,2023-10-26,9692
6442,光聖,425,389,36,富邦-嘉義,2023-10-26,9692
2337,旺宏,45,9,36,富邦-嘉義,2023-10-26,9692
2892,第一金,35,0,35,富邦-嘉義,2023-10-26,9692
2618,長榮航,42,10,32,富邦-嘉義,2023-10-26,9692
2884,玉山金,54,22,32,富邦-嘉義,2023-10-26,9692
8054,安國,135,104,31,富邦-嘉義,2023-10-26,9692
2409,友達,48,17,31,富邦-嘉義,2023-10-26,9692
2887,台新金,30,1,29,富邦-嘉義,2023-10-26,9692
1303,南亞,29,0,29,富邦-嘉義,2023-10-26,9692
00900,富邦特選高股息30,29,1,28,富邦-嘉義,2023-10-26,9692
00687B,國泰20年美債,48,20,28,富邦-嘉義,2023-10-26,9692
00893,國泰智能電動車,28,1,27,富邦-嘉義,2023-10-26,9692
0050,元大台灣50,31,5,26,富邦-嘉義,2023-10-26,9692
2880,華南金,25,0,25,富邦-嘉義,2023-10-26,9692
00902,中信電池及儲能,25,0,25,富邦-嘉義,2023-10-26,9692
2390,云辰,25,0,25,富邦-嘉義,2023-10-26,9692
00679B,元大美債20年,34,10,24,富邦-嘉義,2023-10-26,9692
2515,中工,29,5,24,富邦-嘉義,2023-10-26,9692
2520,冠德,23,0,23,富邦-嘉義,2023-10-26,9692
2913,農林,21,0,21,富邦-嘉義,2023-10-26,9692
4977,眾達-KY,22,1,21,富邦-嘉義,2023-10-26,9692
3450,聯鈞,22,3,19,富邦-嘉義,2023-10-26,9692
2486,一詮,23,4,19,富邦-嘉義,2023-10-26,9692
00642U,期元大S＆P石油,660,1,659,富邦-嘉義,2023-10-27,9692
2382,廣達,1027,369,658,富邦-嘉義,2023-10-27,9692
2376,技嘉,325,27,298,富邦-嘉義,2023-10-27,9692
1524,耿鼎,455,224,231,富邦-嘉義,2023-10-27,9692
00929,復華台灣科技優息,215,29,186,富邦-嘉義,2023-10-27,9692
00632R,元大台灣50反1,144,13,131,富邦-嘉義,2023-10-27,9692
00933B,國泰10Y+金融債,108,5,103,富邦-嘉義,2023-10-27,9692
3035,智原,110,9,101,富邦-嘉義,2023-10-27,9692
6139,亞翔,200,100,100,富邦-嘉義,2023-10-27,9692
00712,復華富時不動產,101,1,100,富邦-嘉義,2023-10-27,9692
1721,三晃,180,95,85,富邦-嘉義,2023-10-27,9692
2233,宇隆,176,96,80,富邦-嘉義,2023-10-27,9692
2390,云辰,367,287,80,富邦-嘉義,2023-10-27,9692
4162,智擎,110,35,75,富邦-嘉義,2023-10-27,9692
2427,三商電,76,3,73,富邦-嘉義,2023-10-27,9692
3715,定穎投控,210,137,73,富邦-嘉義,2023-10-27,9692
2301,光寶科,103,42,61,富邦-嘉義,2023-10-27,9692
2409,友達,66,11,55,富邦-嘉義,2023-10-27,9692
2317,鴻海,60,5,55,富邦-嘉義,2023-10-27,9692
8054,安國,193,139,54,富邦-嘉義,2023-10-27,9692
6443,元晶,89,38,51,富邦-嘉義,2023-10-27,9692
6150,撼訊,53,3,50,富邦-嘉義,2023-10-27,9692
1303,南亞,44,0,44,富邦-嘉義,2023-10-27,9692
2303,聯電,51,9,42,富邦-嘉義,2023-10-27,9692
4142,國光生,44,2,42,富邦-嘉義,2023-10-27,9692
00885,富邦越南,40,0,40,富邦-嘉義,2023-10-27,9692
2344,華邦電,46,13,33,富邦-嘉義,2023-10-27,9692
3530,晶相光,47,16,31,富邦-嘉義,2023-10-27,9692
8358,金居,29,0,29,富邦-嘉義,2023-10-27,9692
2337,旺宏,46,17,29,富邦-嘉義,2023-10-27,9692
1815,富喬,38,10,28,富邦-嘉義,2023-10-27,9692
00720B,元大投資級公司債,78,50,28,富邦-嘉義,2023-10-27,9692
6170,統振,26,0,26,富邦-嘉義,2023-10-27,9692
00662,富邦NASDAQ,24,0,24,富邦-嘉義,2023-10-27,9692
00665L,富邦�琤肭磪囓�2,42,20,22,富邦-嘉義,2023-10-27,9692
2323,中環,22,0,22,富邦-嘉義,2023-10-27,9692
00878,國泰永續高股息,33,11,22,富邦-嘉義,2023-10-27,9692
6168,宏齊,23,2,21,富邦-嘉義,2023-10-27,9692
2888,新光金,20,0,20,富邦-嘉義,2023-10-27,9692
00932,兆豐永續高息等權,20,0,20,富邦-嘉義,2023-10-27,9692
6108,競國,20,0,20,富邦-嘉義,2023-10-27,9692
00715L,期街口布蘭特正2,35,16,19,富邦-嘉義,2023-10-27,9692
3078,僑威,33,14,19,富邦-嘉義,2023-10-27,9692
2883,凱基金,31,12,19,富邦-嘉義,2023-10-27,9692
3049,精金,34,17,17,富邦-嘉義,2023-10-27,9692
4933,友輝,17,1,16,富邦-嘉義,2023-10-27,9692
6446,藥華藥,80,64,16,富邦-嘉義,2023-10-27,9692
6752,叡揚,82,67,15,富邦-嘉義,2023-10-27,9692
3264,欣銓,26,12,14,富邦-嘉義,2023-10-27,9692
3051,力特,52,38,14,富邦-嘉義,2023-10-27,9692
2417,圓剛,697,254,443,富邦-嘉義,2023-10-30,9692
00712,復華富時不動產,318,23,295,富邦-嘉義,2023-10-30,9692
2317,鴻海,713,579,134,富邦-嘉義,2023-10-30,9692
3372,典範,346,213,133,富邦-嘉義,2023-10-30,9692
6189,豐藝,101,1,100,富邦-嘉義,2023-10-30,9692
3325,旭品,101,6,95,富邦-嘉義,2023-10-30,9692
2025,千興,89,1,88,富邦-嘉義,2023-10-30,9692
00878,國泰永續高股息,87,1,86,富邦-嘉義,2023-10-30,9692
2485,兆赫,257,175,82,富邦-嘉義,2023-10-30,9692
2891,中信金,82,2,80,富邦-嘉義,2023-10-30,9692
8040,九暘,473,393,80,富邦-嘉義,2023-10-30,9692
3049,精金,67,0,67,富邦-嘉義,2023-10-30,9692
4960,誠美材,96,32,64,富邦-嘉義,2023-10-30,9692
00751B,元大AAA至A公司債,54,0,54,富邦-嘉義,2023-10-30,9692
6443,元晶,538,485,53,富邦-嘉義,2023-10-30,9692
2888,新光金,66,13,53,富邦-嘉義,2023-10-30,9692
3669,圓展,58,6,52,富邦-嘉義,2023-10-30,9692
1785,光洋科,61,13,48,富邦-嘉義,2023-10-30,9692
3715,定穎投控,324,278,46,富邦-嘉義,2023-10-30,9692
3094,聯傑,403,358,45,富邦-嘉義,2023-10-30,9692
2486,一詮,40,1,39,富邦-嘉義,2023-10-30,9692
00720B,元大投資級公司債,39,0,39,富邦-嘉義,2023-10-30,9692
00679B,元大美債20年,37,0,37,富邦-嘉義,2023-10-30,9692
1101,台泥,37,2,35,富邦-嘉義,2023-10-30,9692
5880,合庫金,35,0,35,富邦-嘉義,2023-10-30,9692
2812,台中銀,33,0,33,富邦-嘉義,2023-10-30,9692
2406,國碩,76,44,32,富邦-嘉義,2023-10-30,9692
2736,富野,30,0,30,富邦-嘉義,2023-10-30,9692
2303,聯電,41,12,29,富邦-嘉義,2023-10-30,9692
9955,佳龍,45,16,29,富邦-嘉義,2023-10-30,9692
6243,迅杰,33,6,27,富邦-嘉義,2023-10-30,9692
3438,類比科,65,39,26,富邦-嘉義,2023-10-30,9692
2883,凱基金,40,16,24,富邦-嘉義,2023-10-30,9692
2887,台新金,29,4,25,富邦-嘉義,2023-10-30,9692
4128,中天,23,0,23,富邦-嘉義,2023-10-30,9692
2023,燁輝,20,0,20,富邦-嘉義,2023-10-30,9692
9907,統一實,20,0,20,富邦-嘉義,2023-10-30,9692
00687B,國泰20年美債,19,0,19,富邦-嘉義,2023-10-30,9692
6197,佳必琪,23,4,19,富邦-嘉義,2023-10-30,9692
3037,欣興,20,2,18,富邦-嘉義,2023-10-30,9692
1303,南亞,17,0,17,富邦-嘉義,2023-10-30,9692
00931B,統一美債20年,17,0,17,富邦-嘉義,2023-10-30,9692
2884,玉山金,32,15,17,富邦-嘉義,2023-10-30,9692
2610,華航,19,2,17,富邦-嘉義,2023-10-30,9692
3339,泰谷,20,3,17,富邦-嘉義,2023-10-30,9692
5876,上海商銀,18,1,17,富邦-嘉義,2023-10-30,9692
3231,緯創,65,48,17,富邦-嘉義,2023-10-30,9692
4743,合一,25,9,16,富邦-嘉義,2023-10-30,9692
00933B,國泰10Y+金融債,16,0,16,富邦-嘉義,2023-10-30,9692
2344,華邦電,58,42,16,富邦-嘉義,2023-10-30,9692
2515,中工,259,19,240,富邦-嘉義,2023-10-31,9692
2485,兆赫,342,116,226,富邦-嘉義,2023-10-31,9692
00878,國泰永續高股息,180,61,119,富邦-嘉義,2023-10-31,9692
3338,泰碩,330,217,113,富邦-嘉義,2023-10-31,9692
00929,復華台灣科技優息,249,145,104,富邦-嘉義,2023-10-31,9692
2913,農林,103,2,101,富邦-嘉義,2023-10-31,9692
2801,彰銀,100,5,95,富邦-嘉義,2023-10-31,9692
4906,正文,129,40,89,富邦-嘉義,2023-10-31,9692
0056,元大高股息,110,21,89,富邦-嘉義,2023-10-31,9692
3623,富晶通,148,63,85,富邦-嘉義,2023-10-31,9692
2323,中環,73,2,71,富邦-嘉義,2023-10-31,9692
2601,益航,70,2,68,富邦-嘉義,2023-10-31,9692
2812,台中銀,63,0,63,富邦-嘉義,2023-10-31,9692
00751B,元大AAA至A公司債,61,0,61,富邦-嘉義,2023-10-31,9692
00919,群益台灣精選高息,70,17,53,富邦-嘉義,2023-10-31,9692
00676R,富邦臺灣加權反1,53,0,53,富邦-嘉義,2023-10-31,9692
2465,麗臺,54,5,49,富邦-嘉義,2023-10-31,9692
2313,華通,118,71,47,富邦-嘉義,2023-10-31,9692
2356,英業達,83,38,45,富邦-嘉義,2023-10-31,9692
00715L,期街口布蘭特正2,54,12,42,富邦-嘉義,2023-10-31,9692
3231,緯創,745,708,37,富邦-嘉義,2023-10-31,9692
00712,復華富時不動產,35,1,34,富邦-嘉義,2023-10-31,9692
3702,大聯大,43,9,34,富邦-嘉義,2023-10-31,9692
4960,誠美材,64,31,33,富邦-嘉義,2023-10-31,9692
2344,華邦電,78,45,33,富邦-嘉義,2023-10-31,9692
6117,迎廣,64,31,33,富邦-嘉義,2023-10-31,9692
00922,國泰台灣領袖50,29,1,28,富邦-嘉義,2023-10-31,9692
2880,華南金,29,1,28,富邦-嘉義,2023-10-31,9692
6443,元晶,230,203,27,富邦-嘉義,2023-10-31,9692
2891,中信金,30,4,26,富邦-嘉義,2023-10-31,9692
3176,基亞,59,35,24,富邦-嘉義,2023-10-31,9692
5880,合庫金,29,6,23,富邦-嘉義,2023-10-31,9692
2317,鴻海,79,56,23,富邦-嘉義,2023-10-31,9692
1519,華城,30,8,22,富邦-嘉義,2023-10-31,9692
6111,大宇資,28,6,22,富邦-嘉義,2023-10-31,9692
1605,華新,21,1,20,富邦-嘉義,2023-10-31,9692
00686R,群益臺灣加權反1,20,0,20,富邦-嘉義,2023-10-31,9692
2603,長榮,61,41,20,富邦-嘉義,2023-10-31,9692
4108,懷特,41,21,20,富邦-嘉義,2023-10-31,9692
6235,華孚,33,14,19,富邦-嘉義,2023-10-31,9692
6168,宏齊,26,7,19,富邦-嘉義,2023-10-31,9692
2401,凌陽,54,35,19,富邦-嘉義,2023-10-31,9692
2201,裕隆,18,1,17,富邦-嘉義,2023-10-31,9692
1609,大亞,20,3,17,富邦-嘉義,2023-10-31,9692
2442,新美齊,16,0,16,富邦-嘉義,2023-10-31,9692
2303,聯電,32,16,16,富邦-嘉義,2023-10-31,9692
0050,元大台灣50,16,0,16,富邦-嘉義,2023-10-31,9692
2449,京元電子,17,2,15,富邦-嘉義,2023-10-31,9692
1618,合機,17,2,15,富邦-嘉義,2023-10-31,9692
1591,駿吉-KY,20,5,15,富邦-嘉義,2023-10-31,9692
2409,友達,315,77,238,富邦-嘉義,2023-11-01,9692
00934,中信成長高股息,168,15,153,富邦-嘉義,2023-11-01,9692
00878,國泰永續高股息,165,39,126,富邦-嘉義,2023-11-01,9692
00929,復華台灣科技優息,126,17,109,富邦-嘉義,2023-11-01,9692
2801,彰銀,100,1,99,富邦-嘉義,2023-11-01,9692
6116,彩晶,100,1,99,富邦-嘉義,2023-11-01,9692
00885,富邦越南,89,0,89,富邦-嘉義,2023-11-01,9692
00679B,元大美債20年,59,0,59,富邦-嘉義,2023-11-01,9692
1815,富喬,83,32,51,富邦-嘉義,2023-11-01,9692
1313,聯成,50,0,50,富邦-嘉義,2023-11-01,9692
00632R,元大台灣50反1,60,13,47,富邦-嘉義,2023-11-01,9692
6168,宏齊,46,0,46,富邦-嘉義,2023-11-01,9692
2413,環科,45,0,45,富邦-嘉義,2023-11-01,9692
00720B,元大投資級公司債,45,0,45,富邦-嘉義,2023-11-01,9692
3481,群創,53,9,44,富邦-嘉義,2023-11-01,9692
00715L,期街口布蘭特正2,63,20,43,富邦-嘉義,2023-11-01,9692
2363,矽統,175,132,43,富邦-嘉義,2023-11-01,9692
2601,益航,40,0,40,富邦-嘉義,2023-11-01,9692
5347,世界,40,1,39,富邦-嘉義,2023-11-01,9692
2317,鴻海,69,32,37,富邦-嘉義,2023-11-01,9692
1609,大亞,40,4,36,富邦-嘉義,2023-11-01,9692
2485,兆赫,82,47,35,富邦-嘉義,2023-11-01,9692
1513,中興電,42,9,33,富邦-嘉義,2023-11-01,9692
00712,復華富時不動產,54,22,32,富邦-嘉義,2023-11-01,9692
6197,佳必琪,32,1,31,富邦-嘉義,2023-11-01,9692
4960,誠美材,30,0,30,富邦-嘉義,2023-11-01,9692
4532,瑞智,30,0,30,富邦-嘉義,2023-11-01,9692
1721,三晃,51,21,30,富邦-嘉義,2023-11-01,9692
4967,十銓,36,8,28,富邦-嘉義,2023-11-01,9692
1101,台泥,29,3,26,富邦-嘉義,2023-11-01,9692
2364,倫飛,32,7,25,富邦-嘉義,2023-11-01,9692
2332,友訊,25,0,25,富邦-嘉義,2023-11-01,9692
6461,益得,22,0,22,富邦-嘉義,2023-11-01,9692
2542,興富發,21,0,21,富邦-嘉義,2023-11-01,9692
2408,南亞科,21,0,21,富邦-嘉義,2023-11-01,9692
2401,凌陽,25,4,21,富邦-嘉義,2023-11-01,9692
6219,富旺,20,0,20,富邦-嘉義,2023-11-01,9692
2353,宏��,19,2,17,富邦-嘉義,2023-11-01,9692
4908,前鼎,113,96,17,富邦-嘉義,2023-11-01,9692
2886,兆豐金,19,2,17,富邦-嘉義,2023-11-01,9692
6282,康舒,16,0,16,富邦-嘉義,2023-11-01,9692
4915,致伸,23,7,16,富邦-嘉義,2023-11-01,9692
2344,華邦電,20,4,16,富邦-嘉義,2023-11-01,9692
3325,旭品,33,17,16,富邦-嘉義,2023-11-01,9692
00687B,國泰20年美債,15,0,15,富邦-嘉義,2023-11-01,9692
6593,台灣銘板,15,0,15,富邦-嘉義,2023-11-01,9692
2356,英業達,14,0,14,富邦-嘉義,2023-11-01,9692
00919,群益台灣精選高息,16,2,14,富邦-嘉義,2023-11-01,9692
3576,聯合再生,14,0,14,富邦-嘉義,2023-11-01,9692
2887,台新金,14,0,14,富邦-嘉義,2023-11-01,9692
2382,廣達,2006,1023,983,富邦-嘉義,2023-11-02,9692
2883,凱基金,414,3,411,富邦-嘉義,2023-11-02,9692
1815,富喬,1470,1200,270,富邦-嘉義,2023-11-02,9692
3122,笙泉,233,14,219,富邦-嘉義,2023-11-02,9692
2417,圓剛,214,60,154,富邦-嘉義,2023-11-02,9692
3322,建舜電,138,2,136,富邦-嘉義,2023-11-02,9692
2363,矽統,648,541,107,富邦-嘉義,2023-11-02,9692
2376,技嘉,350,242,108,富邦-嘉義,2023-11-02,9692
5215,科嘉-KY,107,1,106,富邦-嘉義,2023-11-02,9692
1314,中石化,119,20,99,富邦-嘉義,2023-11-02,9692
2313,華通,158,62,96,富邦-嘉義,2023-11-02,9692
2317,鴻海,102,26,76,富邦-嘉義,2023-11-02,9692
00637L,元大滬深300正2,90,20,70,富邦-嘉義,2023-11-02,9692
6191,精成科,154,86,68,富邦-嘉義,2023-11-02,9692
3036,文曄,91,26,65,富邦-嘉義,2023-11-02,9692
00934,中信成長高股息,66,10,56,富邦-嘉義,2023-11-02,9692
00878,國泰永續高股息,78,22,56,富邦-嘉義,2023-11-02,9692
2485,兆赫,58,9,49,富邦-嘉義,2023-11-02,9692
2454,聯發科,82,34,48,富邦-嘉義,2023-11-02,9692
2371,大同,53,6,47,富邦-嘉義,2023-11-02,9692
6139,亞翔,76,29,47,富邦-嘉義,2023-11-02,9692
6531,愛普*,175,128,47,富邦-嘉義,2023-11-02,9692
00680L,元大美債20正2,33,0,33,富邦-嘉義,2023-11-02,9692
00885,富邦越南,64,31,33,富邦-嘉義,2023-11-02,9692
00719B,元大美債1-3,27,0,27,富邦-嘉義,2023-11-02,9692
1524,耿鼎,82,55,27,富邦-嘉義,2023-11-02,9692
2388,威盛,318,294,24,富邦-嘉義,2023-11-02,9692
1449,佳和,24,0,24,富邦-嘉義,2023-11-02,9692
3548,兆利,565,542,23,富邦-嘉義,2023-11-02,9692
6285,啟��,126,104,22,富邦-嘉義,2023-11-02,9692
5258,虹堡,127,106,21,富邦-嘉義,2023-11-02,9692
6188,廣明,21,0,21,富邦-嘉義,2023-11-02,9692
8227,巨有科技,53,32,21,富邦-嘉義,2023-11-02,9692
2230,泰茂,26,6,20,富邦-嘉義,2023-11-02,9692
3105,穩懋,38,18,20,富邦-嘉義,2023-11-02,9692
3682,亞太電,19,0,19,富邦-嘉義,2023-11-02,9692
6274,台燿,184,166,18,富邦-嘉義,2023-11-02,9692
00712,復華富時不動產,38,22,16,富邦-嘉義,2023-11-02,9692
4908,前鼎,111,95,16,富邦-嘉義,2023-11-02,9692
4108,懷特,15,0,15,富邦-嘉義,2023-11-02,9692
00696B,富邦美債20年,14,0,14,富邦-嘉義,2023-11-02,9692
2399,映泰,50,36,14,富邦-嘉義,2023-11-02,9692
2206,三陽工業,17,3,14,富邦-嘉義,2023-11-02,9692
2516,新建,15,2,13,富邦-嘉義,2023-11-02,9692
2450,神腦,13,0,13,富邦-嘉義,2023-11-02,9692
1522,堤維西,16,3,13,富邦-嘉義,2023-11-02,9692
8054,安國,598,585,13,富邦-嘉義,2023-11-02,9692
1319,東陽,17,5,12,富邦-嘉義,2023-11-02,9692
8068,全達,24,13,11,富邦-嘉義,2023-11-02,9692
6117,迎廣,55,44,11,富邦-嘉義,2023-11-02,9692
6118,建達,261,30,231,富邦-嘉義,2023-11-03,9692
2388,威盛,709,589,120,富邦-嘉義,2023-11-03,9692
8936,國統,175,69,106,富邦-嘉義,2023-11-03,9692
2492,華新科,119,28,91,富邦-嘉義,2023-11-03,9692
6197,佳必琪,160,77,83,富邦-嘉義,2023-11-03,9692
00632R,元大台灣50反1,94,31,63,富邦-嘉義,2023-11-03,9692
00934,中信成長高股息,90,30,60,富邦-嘉義,2023-11-03,9692
00935,野村臺灣新科技50,55,7,48,富邦-嘉義,2023-11-03,9692
2486,一詮,98,51,47,富邦-嘉義,2023-11-03,9692
3481,群創,65,20,45,富邦-嘉義,2023-11-03,9692
3231,緯創,110,65,45,富邦-嘉義,2023-11-03,9692
2610,華航,176,141,35,富邦-嘉義,2023-11-03,9692
4960,誠美材,34,0,34,富邦-嘉義,2023-11-03,9692
2317,鴻海,49,15,34,富邦-嘉義,2023-11-03,9692
2409,友達,75,41,34,富邦-嘉義,2023-11-03,9692
2344,華邦電,71,38,33,富邦-嘉義,2023-11-03,9692
6139,亞翔,105,73,32,富邦-嘉義,2023-11-03,9692
00680L,元大美債20正2,36,5,31,富邦-嘉義,2023-11-03,9692
6531,愛普*,120,90,30,富邦-嘉義,2023-11-03,9692
4743,合一,28,2,26,富邦-嘉義,2023-11-03,9692
2390,云辰,141,115,26,富邦-嘉義,2023-11-03,9692
6443,元晶,41,16,25,富邦-嘉義,2023-11-03,9692
5521,工信,34,9,25,富邦-嘉義,2023-11-03,9692
2323,中環,36,13,23,富邦-嘉義,2023-11-03,9692
3260,威剛,36,14,22,富邦-嘉義,2023-11-03,9692
6168,宏齊,23,1,22,富邦-嘉義,2023-11-03,9692
00675L,富邦臺灣加權正2,21,0,21,富邦-嘉義,2023-11-03,9692
3312,弘憶股,23,2,21,富邦-嘉義,2023-11-03,9692
5465,富驊,20,0,20,富邦-嘉義,2023-11-03,9692
1522,堤維西,27,7,20,富邦-嘉義,2023-11-03,9692
6282,康舒,25,5,20,富邦-嘉義,2023-11-03,9692
3303,岱稜,20,0,20,富邦-嘉義,2023-11-03,9692
00795B,中信美國公債20年,21,1,20,富邦-嘉義,2023-11-03,9692
6669,緯穎,73,54,19,富邦-嘉義,2023-11-03,9692
8046,南電,21,2,19,富邦-嘉義,2023-11-03,9692
6274,台燿,39,22,17,富邦-嘉義,2023-11-03,9692
6235,華孚,65,49,16,富邦-嘉義,2023-11-03,9692
00878,國泰永續高股息,25,9,16,富邦-嘉義,2023-11-03,9692
4128,中天,15,0,15,富邦-嘉義,2023-11-03,9692
2353,宏��,16,1,15,富邦-嘉義,2023-11-03,9692
3704,合勤控,26,11,15,富邦-嘉義,2023-11-03,9692
4542,科嶠,67,52,15,富邦-嘉義,2023-11-03,9692
2387,精元,19,4,15,富邦-嘉義,2023-11-03,9692
3356,奇偶,15,0,15,富邦-嘉義,2023-11-03,9692
6491,晶碩,15,0,15,富邦-嘉義,2023-11-03,9692
00753L,中信中國50正2,16,2,14,富邦-嘉義,2023-11-03,9692
1524,耿鼎,168,154,14,富邦-嘉義,2023-11-03,9692
3094,聯傑,21,7,14,富邦-嘉義,2023-11-03,9692
3041,揚智,17,4,13,富邦-嘉義,2023-11-03,9692
1449,佳和,17,4,13,富邦-嘉義,2023-11-03,9692
1815,富喬,1627,990,637,富邦-嘉義,2023-11-06,9692
00632R,元大台灣50反1,240,48,192,富邦-嘉義,2023-11-06,9692
3231,緯創,170,39,131,富邦-嘉義,2023-11-06,9692
2313,華通,138,24,114,富邦-嘉義,2023-11-06,9692
2421,建準,242,150,92,富邦-嘉義,2023-11-06,9692
9950,萬國通,92,0,92,富邦-嘉義,2023-11-06,9692
2453,凌群,246,170,76,富邦-嘉義,2023-11-06,9692
2603,長榮,82,7,75,富邦-嘉義,2023-11-06,9692
00715L,期街口布蘭特正2,79,6,73,富邦-嘉義,2023-11-06,9692
2363,矽統,401,344,57,富邦-嘉義,2023-11-06,9692
2369,菱生,56,4,52,富邦-嘉義,2023-11-06,9692
2816,旺旺保,61,11,50,富邦-嘉義,2023-11-06,9692
2812,台中銀,50,1,49,富邦-嘉義,2023-11-06,9692
00878,國泰永續高股息,58,11,47,富邦-嘉義,2023-11-06,9692
6625,必應,50,5,45,富邦-嘉義,2023-11-06,9692
1314,中石化,45,0,45,富邦-嘉義,2023-11-06,9692
4167,松瑞藥,48,6,42,富邦-嘉義,2023-11-06,9692
1721,三晃,110,69,41,富邦-嘉義,2023-11-06,9692
020039,元大加權N,40,0,40,富邦-嘉義,2023-11-06,9692
3443,創意,130,90,40,富邦-嘉義,2023-11-06,9692
00687B,國泰20年美債,40,1,39,富邦-嘉義,2023-11-06,9692
6117,迎廣,209,171,38,富邦-嘉義,2023-11-06,9692
4967,十銓,126,89,37,富邦-嘉義,2023-11-06,9692
3041,揚智,51,15,36,富邦-嘉義,2023-11-06,9692
00676R,富邦臺灣加權反1,34,0,34,富邦-嘉義,2023-11-06,9692
1524,耿鼎,87,54,33,富邦-嘉義,2023-11-06,9692
6669,緯穎,63,33,30,富邦-嘉義,2023-11-06,9692
6223,旺矽,32,5,27,富邦-嘉義,2023-11-06,9692
3260,威剛,42,16,26,富邦-嘉義,2023-11-06,9692
00935,野村臺灣新科技50,25,1,24,富邦-嘉義,2023-11-06,9692
2486,一詮,63,40,23,富邦-嘉義,2023-11-06,9692
4162,智擎,28,5,23,富邦-嘉義,2023-11-06,9692
6168,宏齊,24,1,23,富邦-嘉義,2023-11-06,9692
8110,華東,36,13,23,富邦-嘉義,2023-11-06,9692
00719B,元大美債1-3,24,2,22,富邦-嘉義,2023-11-06,9692
2353,宏��,22,1,21,富邦-嘉義,2023-11-06,9692
1217,愛之味,39,19,20,富邦-嘉義,2023-11-06,9692
2641,正德,21,2,19,富邦-嘉義,2023-11-06,9692
2515,中工,16,0,16,富邦-嘉義,2023-11-06,9692
1504,東元,16,0,16,富邦-嘉義,2023-11-06,9692
2736,富野,24,9,15,富邦-嘉義,2023-11-06,9692
2385,群光,103,88,15,富邦-嘉義,2023-11-06,9692
2329,華泰,54,39,15,富邦-嘉義,2023-11-06,9692
2465,麗臺,17,2,15,富邦-嘉義,2023-11-06,9692
4979,華星光,34,19,15,富邦-嘉義,2023-11-06,9692
00679B,元大美債20年,24,10,14,富邦-嘉義,2023-11-06,9692
00931B,統一美債20年,14,0,14,富邦-嘉義,2023-11-06,9692
1319,東陽,26,13,13,富邦-嘉義,2023-11-06,9692
3036A,文曄甲特,13,0,13,富邦-嘉義,2023-11-06,9692
2892,第一金,48,35,13,富邦-嘉義,2023-11-06,9692
4967,十銓,620,240,380,富邦-嘉義,2023-11-07,9692
2409,友達,281,29,252,富邦-嘉義,2023-11-07,9692
3036,文曄,483,305,178,富邦-嘉義,2023-11-07,9692
2618,長榮航,208,34,174,富邦-嘉義,2023-11-07,9692
3041,揚智,438,299,139,富邦-嘉義,2023-11-07,9692
4906,正文,141,3,138,富邦-嘉義,2023-11-07,9692
4743,合一,183,63,120,富邦-嘉義,2023-11-07,9692
6531,愛普*,161,55,106,富邦-嘉義,2023-11-07,9692
00933B,國泰10Y+金融債,96,17,79,富邦-嘉義,2023-11-07,9692
2317,鴻海,96,18,78,富邦-嘉義,2023-11-07,9692
5439,高技,75,1,74,富邦-嘉義,2023-11-07,9692
4108,懷特,89,19,70,富邦-嘉義,2023-11-07,9692
6117,迎廣,317,255,62,富邦-嘉義,2023-11-07,9692
00927,群益半導體收益,62,0,62,富邦-嘉義,2023-11-07,9692
1324,地球,62,0,62,富邦-嘉義,2023-11-07,9692
2488,漢平,114,56,58,富邦-嘉義,2023-11-07,9692
3234,光環,51,0,51,富邦-嘉義,2023-11-07,9692
00632R,元大台灣50反1,62,12,50,富邦-嘉義,2023-11-07,9692
3078,僑威,58,9,49,富邦-嘉義,2023-11-07,9692
2634,漢翔,54,5,49,富邦-嘉義,2023-11-07,9692
00878,國泰永續高股息,47,5,42,富邦-嘉義,2023-11-07,9692
2722,夏都,42,0,42,富邦-嘉義,2023-11-07,9692
3481,群創,47,6,41,富邦-嘉義,2023-11-07,9692
00935,野村臺灣新科技50,43,3,40,富邦-嘉義,2023-11-07,9692
3013,晟銘電,169,130,39,富邦-嘉義,2023-11-07,9692
00934,中信成長高股息,39,0,39,富邦-嘉義,2023-11-07,9692
3176,基亞,71,34,37,富邦-嘉義,2023-11-07,9692
1314,中石化,49,12,37,富邦-嘉義,2023-11-07,9692
9934,成霖,33,0,33,富邦-嘉義,2023-11-07,9692
00637L,元大滬深300正2,31,0,31,富邦-嘉義,2023-11-07,9692
2355,敬鵬,34,3,31,富邦-嘉義,2023-11-07,9692
8054,安國,47,17,30,富邦-嘉義,2023-11-07,9692
2369,菱生,33,4,29,富邦-嘉義,2023-11-07,9692
2329,華泰,44,15,29,富邦-嘉義,2023-11-07,9692
2365,昆盈,33,5,28,富邦-嘉義,2023-11-07,9692
1313,聯成,26,0,26,富邦-嘉義,2023-11-07,9692
00680L,元大美債20正2,23,0,23,富邦-嘉義,2023-11-07,9692
3576,聯合再生,23,0,23,富邦-嘉義,2023-11-07,9692
6530,創威,68,46,22,富邦-嘉義,2023-11-07,9692
1789,神隆,44,22,22,富邦-嘉義,2023-11-07,9692
3704,合勤控,23,2,21,富邦-嘉義,2023-11-07,9692
1217,愛之味,21,0,21,富邦-嘉義,2023-11-07,9692
2534,宏盛,21,0,21,富邦-嘉義,2023-11-07,9692
00712,復華富時不動產,28,7,21,富邦-嘉義,2023-11-07,9692
1802,台玻,20,0,20,富邦-嘉義,2023-11-07,9692
3715,定穎投控,93,73,20,富邦-嘉義,2023-11-07,9692
8222,寶一,18,0,18,富邦-嘉義,2023-11-07,9692
3673,TPK-KY,20,3,17,富邦-嘉義,2023-11-07,9692
1504,東元,23,6,17,富邦-嘉義,2023-11-07,9692
00751B,元大AAA至A公司債,17,1,16,富邦-嘉義,2023-11-07,9692
3049,精金,1091,0,1091,富邦-嘉義,2023-11-08,9692
00936,台新永續高息中小,270,0,270,富邦-嘉義,2023-11-08,9692
3122,笙泉,1007,798,209,富邦-嘉義,2023-11-08,9692
2367,燿華,201,3,198,富邦-嘉義,2023-11-08,9692
2421,建準,189,24,165,富邦-嘉義,2023-11-08,9692
00915,凱基優選高股息30,161,3,158,富邦-嘉義,2023-11-08,9692
8936,國統,151,10,141,富邦-嘉義,2023-11-08,9692
1314,中石化,128,5,123,富邦-嘉義,2023-11-08,9692
1815,富喬,121,31,90,富邦-嘉義,2023-11-08,9692
00929,復華台灣科技優息,151,62,89,富邦-嘉義,2023-11-08,9692
2618,長榮航,102,16,86,富邦-嘉義,2023-11-08,9692
3308,聯德,72,0,72,富邦-嘉義,2023-11-08,9692
1524,耿鼎,140,70,70,富邦-嘉義,2023-11-08,9692
6770,力積電,72,2,70,富邦-嘉義,2023-11-08,9692
2363,矽統,502,438,64,富邦-嘉義,2023-11-08,9692
00715L,期街口布蘭特正2,63,9,54,富邦-嘉義,2023-11-08,9692
2515,中工,66,12,54,富邦-嘉義,2023-11-08,9692
2313,華通,144,94,50,富邦-嘉義,2023-11-08,9692
00676R,富邦臺灣加權反1,45,0,45,富邦-嘉義,2023-11-08,9692
2303,聯電,53,12,41,富邦-嘉義,2023-11-08,9692
8086,宏捷科,84,47,37,富邦-嘉義,2023-11-08,9692
9934,成霖,35,0,35,富邦-嘉義,2023-11-08,9692
4906,正文,51,16,35,富邦-嘉義,2023-11-08,9692
00919,群益台灣精選高息,70,36,34,富邦-嘉義,2023-11-08,9692
5347,世界,31,2,29,富邦-嘉義,2023-11-08,9692
2601,益航,30,1,29,富邦-嘉義,2023-11-08,9692
00680L,元大美債20正2,31,4,27,富邦-嘉義,2023-11-08,9692
1605,華新,27,1,26,富邦-嘉義,2023-11-08,9692
2485,兆赫,27,2,25,富邦-嘉義,2023-11-08,9692
2014,中鴻,27,2,25,富邦-嘉義,2023-11-08,9692
2059,川湖,34,9,25,富邦-嘉義,2023-11-08,9692
6530,創威,51,28,23,富邦-嘉義,2023-11-08,9692
2543,皇昌,22,0,22,富邦-嘉義,2023-11-08,9692
2812,台中銀,21,0,21,富邦-嘉義,2023-11-08,9692
2369,菱生,86,65,21,富邦-嘉義,2023-11-08,9692
2390,云辰,22,1,21,富邦-嘉義,2023-11-08,9692
3483,力致,71,50,21,富邦-嘉義,2023-11-08,9692
2609,陽明,36,16,20,富邦-嘉義,2023-11-08,9692
4167,松瑞藥,33,13,20,富邦-嘉義,2023-11-08,9692
6605,帝寶,20,1,19,富邦-嘉義,2023-11-08,9692
6290,良維,35,16,19,富邦-嘉義,2023-11-08,9692
6125,廣運,24,5,19,富邦-嘉義,2023-11-08,9692
5258,虹堡,126,109,17,富邦-嘉義,2023-11-08,9692
00934,中信成長高股息,31,14,17,富邦-嘉義,2023-11-08,9692
6122,擎邦,41,24,17,富邦-嘉義,2023-11-08,9692
6603,富強鑫,26,9,17,富邦-嘉義,2023-11-08,9692
2436,偉詮電,16,0,16,富邦-嘉義,2023-11-08,9692
5210,寶碩,20,4,16,富邦-嘉義,2023-11-08,9692
2455,全新,66,51,15,富邦-嘉義,2023-11-08,9692
3712,永崴投控,15,0,15,富邦-嘉義,2023-11-08,9692
2382,廣達,543,44,499,富邦-嘉義,2023-11-09,9692
3049,精金,441,134,307,富邦-嘉義,2023-11-09,9692
4906,正文,281,3,278,富邦-嘉義,2023-11-09,9692
4533,協易機,334,104,230,富邦-嘉義,2023-11-09,9692
6805,富世達,229,3,226,富邦-嘉義,2023-11-09,9692
00936,台新永續高息中小,116,0,116,富邦-嘉義,2023-11-09,9692
1217,愛之味,103,0,103,富邦-嘉義,2023-11-09,9692
00931B,統一美債20年,115,12,103,富邦-嘉義,2023-11-09,9692
1314,中石化,139,37,102,富邦-嘉義,2023-11-09,9692
00715L,期街口布蘭特正2,166,65,101,富邦-嘉義,2023-11-09,9692
5386,青雲,303,203,100,富邦-嘉義,2023-11-09,9692
00680L,元大美債20正2,84,0,84,富邦-嘉義,2023-11-09,9692
2367,燿華,75,1,74,富邦-嘉義,2023-11-09,9692
3231,緯創,588,520,68,富邦-嘉義,2023-11-09,9692
00915,凱基優選高股息30,61,5,56,富邦-嘉義,2023-11-09,9692
00878,國泰永續高股息,72,21,51,富邦-嘉義,2023-11-09,9692
2516,新建,50,0,50,富邦-嘉義,2023-11-09,9692
1522,堤維西,129,83,46,富邦-嘉義,2023-11-09,9692
5347,世界,46,0,46,富邦-嘉義,2023-11-09,9692
4743,合一,184,144,40,富邦-嘉義,2023-11-09,9692
00934,中信成長高股息,40,2,38,富邦-嘉義,2023-11-09,9692
4129,聯合,48,12,36,富邦-嘉義,2023-11-09,9692
2883,凱基金,36,1,35,富邦-嘉義,2023-11-09,9692
6191,精成科,46,12,34,富邦-嘉義,2023-11-09,9692
3228,金麗科,31,1,30,富邦-嘉義,2023-11-09,9692
1324,地球,45,16,29,富邦-嘉義,2023-11-09,9692
2002,中鋼,34,5,29,富邦-嘉義,2023-11-09,9692
4960,誠美材,27,1,26,富邦-嘉義,2023-11-09,9692
2462,良得電,30,5,25,富邦-嘉義,2023-11-09,9692
6244,茂迪,25,0,25,富邦-嘉義,2023-11-09,9692
2303,聯電,29,5,24,富邦-嘉義,2023-11-09,9692
6593,台灣銘板,27,3,24,富邦-嘉義,2023-11-09,9692
6176,瑞儀,23,1,22,富邦-嘉義,2023-11-09,9692
4128,中天,46,24,22,富邦-嘉義,2023-11-09,9692
00933B,國泰10Y+金融債,45,24,21,富邦-嘉義,2023-11-09,9692
00637L,元大滬深300正2,51,30,21,富邦-嘉義,2023-11-09,9692
00882,中信中國高股息,21,0,21,富邦-嘉義,2023-11-09,9692
2405,輔信,20,0,20,富邦-嘉義,2023-11-09,9692
2834,臺企銀,26,6,20,富邦-嘉義,2023-11-09,9692
3704,合勤控,33,14,19,富邦-嘉義,2023-11-09,9692
5521,工信,20,1,19,富邦-嘉義,2023-11-09,9692
00929,復華台灣科技優息,147,128,19,富邦-嘉義,2023-11-09,9692
2323,中環,18,0,18,富邦-嘉義,2023-11-09,9692
6104,創惟,18,0,18,富邦-嘉義,2023-11-09,9692
00687B,國泰20年美債,31,14,17,富邦-嘉義,2023-11-09,9692
3217,優群,40,23,17,富邦-嘉義,2023-11-09,9692
6625,必應,18,2,16,富邦-嘉義,2023-11-09,9692
3693,營邦,23,7,16,富邦-嘉義,2023-11-09,9692
00919,群益台灣精選高息,39,24,15,富邦-嘉義,2023-11-09,9692
8112,至上,15,0,15,富邦-嘉義,2023-11-09,9692
2367,燿華,546,17,529,富邦-嘉義,2023-11-10,9692
00632R,元大台灣50反1,538,90,448,富邦-嘉義,2023-11-10,9692
00720B,元大投資級公司債,204,0,204,富邦-嘉義,2023-11-10,9692
6901,鑽石投資,204,69,135,富邦-嘉義,2023-11-10,9692
00929,復華台灣科技優息,132,13,119,富邦-嘉義,2023-11-10,9692
1524,耿鼎,118,11,107,富邦-嘉義,2023-11-10,9692
4128,中天,662,559,103,富邦-嘉義,2023-11-10,9692
1515,力山,224,130,94,富邦-嘉義,2023-11-10,9692
00936,台新永續高息中小,78,2,76,富邦-嘉義,2023-11-10,9692
6805,富世達,102,34,68,富邦-嘉義,2023-11-10,9692
8034,榮群,180,112,68,富邦-嘉義,2023-11-10,9692
00679B,元大美債20年,70,3,67,富邦-嘉義,2023-11-10,9692
00878,國泰永續高股息,82,16,66,富邦-嘉義,2023-11-10,9692
1217,愛之味,61,1,60,富邦-嘉義,2023-11-10,9692
1808,潤隆,61,1,60,富邦-嘉義,2023-11-10,9692
00931B,統一美債20年,60,4,56,富邦-嘉義,2023-11-10,9692
2838,聯邦銀,55,0,55,富邦-嘉義,2023-11-10,9692
8054,安國,167,115,52,富邦-嘉義,2023-11-10,9692
2382,廣達,70,18,52,富邦-嘉義,2023-11-10,9692
6133,金橋,56,5,51,富邦-嘉義,2023-11-10,9692
1760,寶齡富錦,62,11,51,富邦-嘉義,2023-11-10,9692
1319,東陽,55,6,49,富邦-嘉義,2023-11-10,9692
00919,群益台灣精選高息,50,1,49,富邦-嘉義,2023-11-10,9692
00751B,元大AAA至A公司債,47,0,47,富邦-嘉義,2023-11-10,9692
2601,益航,43,0,43,富邦-嘉義,2023-11-10,9692
2409,友達,45,3,42,富邦-嘉義,2023-11-10,9692
2323,中環,42,0,42,富邦-嘉義,2023-11-10,9692
2743,山富,86,44,42,富邦-嘉義,2023-11-10,9692
6016,康和證,49,10,39,富邦-嘉義,2023-11-10,9692
2618,長榮航,157,119,38,富邦-嘉義,2023-11-10,9692
3312,弘憶股,39,2,37,富邦-嘉義,2023-11-10,9692
2002,中鋼,49,13,36,富邦-嘉義,2023-11-10,9692
2486,一詮,38,2,36,富邦-嘉義,2023-11-10,9692
2408,南亞科,35,0,35,富邦-嘉義,2023-11-10,9692
3176,基亞,34,0,34,富邦-嘉義,2023-11-10,9692
2353,宏��,33,0,33,富邦-嘉義,2023-11-10,9692
3576,聯合再生,40,10,30,富邦-嘉義,2023-11-10,9692
8210,勤誠,31,1,30,富邦-嘉義,2023-11-10,9692
00934,中信成長高股息,35,6,29,富邦-嘉義,2023-11-10,9692
2388,威盛,42,14,28,富邦-嘉義,2023-11-10,9692
00712,復華富時不動產,27,0,27,富邦-嘉義,2023-11-10,9692
2344,華邦電,29,3,26,富邦-嘉義,2023-11-10,9692
6117,迎廣,364,339,25,富邦-嘉義,2023-11-10,9692
3673,TPK-KY,25,0,25,富邦-嘉義,2023-11-10,9692
2317,鴻海,31,7,24,富邦-嘉義,2023-11-10,9692
6605,帝寶,25,1,24,富邦-嘉義,2023-11-10,9692
2615,萬海,24,1,23,富邦-嘉義,2023-11-10,9692
00680L,元大美債20正2,25,2,23,富邦-嘉義,2023-11-10,9692
5388,中磊,30,7,23,富邦-嘉義,2023-11-10,9692
9945,潤泰新,21,0,21,富邦-嘉義,2023-11-10,9692
3231,緯創,1106,199,907,富邦-嘉義,2023-11-13,9692
6122,擎邦,469,84,385,富邦-嘉義,2023-11-13,9692
3049,精金,238,3,235,富邦-嘉義,2023-11-13,9692
00720B,元大投資級公司債,205,2,203,富邦-嘉義,2023-11-13,9692
2367,燿華,203,2,201,富邦-嘉義,2023-11-13,9692
1515,力山,633,474,159,富邦-嘉義,2023-11-13,9692
2313,華通,1285,1141,144,富邦-嘉義,2023-11-13,9692
3306,鼎天,214,84,130,富邦-嘉義,2023-11-13,9692
8034,榮群,114,4,110,富邦-嘉義,2023-11-13,9692
2388,威盛,123,19,104,富邦-嘉義,2023-11-13,9692
2486,一詮,74,2,72,富邦-嘉義,2023-11-13,9692
2888,新光金,86,17,69,富邦-嘉義,2023-11-13,9692
1449,佳和,61,0,61,富邦-嘉義,2023-11-13,9692
00878,國泰永續高股息,81,29,52,富邦-嘉義,2023-11-13,9692
5880,合庫金,51,0,51,富邦-嘉義,2023-11-13,9692
00681R,元大美債20反1,50,0,50,富邦-嘉義,2023-11-13,9692
2204,中華,53,6,47,富邦-嘉義,2023-11-13,9692
6669,緯穎,88,43,45,富邦-嘉義,2023-11-13,9692
00882,中信中國高股息,43,0,43,富邦-嘉義,2023-11-13,9692
1314,中石化,44,2,42,富邦-嘉義,2023-11-13,9692
00680L,元大美債20正2,73,35,38,富邦-嘉義,2023-11-13,9692
5381,合正,60,22,38,富邦-嘉義,2023-11-13,9692
00679B,元大美債20年,39,2,37,富邦-嘉義,2023-11-13,9692
2618,長榮航,48,12,36,富邦-嘉義,2023-11-13,9692
2323,中環,57,22,35,富邦-嘉義,2023-11-13,9692
4123,晟德,40,5,35,富邦-嘉義,2023-11-13,9692
2851,中再保,34,0,34,富邦-嘉義,2023-11-13,9692
2449,京元電子,90,56,34,富邦-嘉義,2023-11-13,9692
2409,友達,37,4,33,富邦-嘉義,2023-11-13,9692
2417,圓剛,32,2,30,富邦-嘉義,2023-11-13,9692
2332,友訊,30,0,30,富邦-嘉義,2023-11-13,9692
6593,台灣銘板,99,70,29,富邦-嘉義,2023-11-13,9692
1718,中纖,28,0,28,富邦-嘉義,2023-11-13,9692
2534,宏盛,32,4,28,富邦-嘉義,2023-11-13,9692
2363,矽統,132,106,26,富邦-嘉義,2023-11-13,9692
4746,台耀,26,1,25,富邦-嘉義,2023-11-13,9692
5328,華容,23,0,23,富邦-嘉義,2023-11-13,9692
2303,聯電,48,25,23,富邦-嘉義,2023-11-13,9692
00687B,國泰20年美債,22,0,22,富邦-嘉義,2023-11-13,9692
2501,國建,42,20,22,富邦-嘉義,2023-11-13,9692
6016,康和證,22,0,22,富邦-嘉義,2023-11-13,9692
8176,智捷,26,5,21,富邦-嘉義,2023-11-13,9692
1795,美時,26,5,21,富邦-嘉義,2023-11-13,9692
00688L,國泰20年美債正2,21,1,20,富邦-嘉義,2023-11-13,9692
3022,威強電,21,1,20,富邦-嘉義,2023-11-13,9692
2438,翔耀,20,0,20,富邦-嘉義,2023-11-13,9692
6026,福邦證,20,0,20,富邦-嘉義,2023-11-13,9692
00934,中信成長高股息,19,0,19,富邦-嘉義,2023-11-13,9692
6770,力積電,21,3,18,富邦-嘉義,2023-11-13,9692
00900,富邦特選高股息30,17,0,17,富邦-嘉義,2023-11-13,9692
2313,華通,317,68,249,富邦-嘉義,2023-11-14,9692
6531,愛普*,222,21,201,富邦-嘉義,2023-11-14,9692
6117,迎廣,246,47,199,富邦-嘉義,2023-11-14,9692
3049,精金,188,0,188,富邦-嘉義,2023-11-14,9692
2368,金像電,470,286,184,富邦-嘉義,2023-11-14,9692
00892,富邦台灣半導體,111,2,109,富邦-嘉義,2023-11-14,9692
8088,品安,122,43,79,富邦-嘉義,2023-11-14,9692
2883,凱基金,61,1,60,富邦-嘉義,2023-11-14,9692
1721,三晃,73,17,56,富邦-嘉義,2023-11-14,9692
2323,中環,53,0,53,富邦-嘉義,2023-11-14,9692
2367,燿華,53,3,50,富邦-嘉義,2023-11-14,9692
8112,至上,52,3,49,富邦-嘉義,2023-11-14,9692
6285,啟��,53,6,47,富邦-嘉義,2023-11-14,9692
6116,彩晶,48,2,46,富邦-嘉義,2023-11-14,9692
2516,新建,44,0,44,富邦-嘉義,2023-11-14,9692
3036,文曄,154,111,43,富邦-嘉義,2023-11-14,9692
2352,佳世達,44,2,42,富邦-嘉義,2023-11-14,9692
2002,中鋼,47,5,42,富邦-嘉義,2023-11-14,9692
2884,玉山金,45,3,42,富邦-嘉義,2023-11-14,9692
2455,全新,40,0,40,富邦-嘉義,2023-11-14,9692
4979,華星光,41,3,38,富邦-嘉義,2023-11-14,9692
00900,富邦特選高股息30,50,15,35,富邦-嘉義,2023-11-14,9692
6282,康舒,43,8,35,富邦-嘉義,2023-11-14,9692
2610,華航,35,4,31,富邦-嘉義,2023-11-14,9692
3443,創意,33,3,30,富邦-嘉義,2023-11-14,9692
2329,華泰,261,232,29,富邦-嘉義,2023-11-14,9692
9927,泰銘,35,9,26,富邦-嘉義,2023-11-14,9692
6578,達邦蛋白,34,8,26,富邦-嘉義,2023-11-14,9692
2303,聯電,77,51,26,富邦-嘉義,2023-11-14,9692
00715L,期街口布蘭特正2,36,12,24,富邦-嘉義,2023-11-14,9692
5009,榮剛,126,102,24,富邦-嘉義,2023-11-14,9692
2705,六福,22,0,22,富邦-嘉義,2023-11-14,9692
00673R,期元大S＆P原油反1,24,2,22,富邦-嘉義,2023-11-14,9692
00665L,富邦�琤肭磪囓�2,22,0,22,富邦-嘉義,2023-11-14,9692
3715,定穎投控,313,291,22,富邦-嘉義,2023-11-14,9692
00935,野村臺灣新科技50,21,0,21,富邦-嘉義,2023-11-14,9692
2601,益航,21,0,21,富邦-嘉義,2023-11-14,9692
2851,中再保,20,0,20,富邦-嘉義,2023-11-14,9692
2867,三商壽,20,0,20,富邦-嘉義,2023-11-14,9692
3147,大綜,39,19,20,富邦-嘉義,2023-11-14,9692
4128,中天,24,4,20,富邦-嘉義,2023-11-14,9692
2356,英業達,23,3,20,富邦-嘉義,2023-11-14,9692
4401,東隆興,30,11,19,富邦-嘉義,2023-11-14,9692
9928,中視,19,0,19,富邦-嘉義,2023-11-14,9692
1504,東元,62,45,17,富邦-嘉義,2023-11-14,9692
1217,愛之味,18,1,17,富邦-嘉義,2023-11-14,9692
3346,麗清,17,0,17,富邦-嘉義,2023-11-14,9692
9945,潤泰新,19,3,16,富邦-嘉義,2023-11-14,9692
2359,所羅門,17,1,16,富邦-嘉義,2023-11-14,9692
3276,宇環,329,313,16,富邦-嘉義,2023-11-14,9692
00720B,元大投資級公司債,445,5,440,富邦-嘉義,2023-11-15,9692
2417,圓剛,922,503,419,富邦-嘉義,2023-11-15,9692
2368,金像電,291,11,280,富邦-嘉義,2023-11-15,9692
2323,中環,249,23,226,富邦-嘉義,2023-11-15,9692
2313,華通,218,46,172,富邦-嘉義,2023-11-15,9692
1515,力山,317,202,115,富邦-嘉義,2023-11-15,9692
00706L,期元大S＆P日圓正2,115,5,110,富邦-嘉義,2023-11-15,9692
2618,長榮航,116,24,92,富邦-嘉義,2023-11-15,9692
00632R,元大台灣50反1,125,35,90,富邦-嘉義,2023-11-15,9692
2363,矽統,612,525,87,富邦-嘉義,2023-11-15,9692
2610,華航,108,21,87,富邦-嘉義,2023-11-15,9692
2405,輔信,70,1,69,富邦-嘉義,2023-11-15,9692
6243,迅杰,83,15,68,富邦-嘉義,2023-11-15,9692
00679B,元大美債20年,68,10,58,富邦-嘉義,2023-11-15,9692
4401,東隆興,65,21,44,富邦-嘉義,2023-11-15,9692
3450,聯鈞,39,4,35,富邦-嘉義,2023-11-15,9692
3276,宇環,193,160,33,富邦-嘉義,2023-11-15,9692
9945,潤泰新,83,51,32,富邦-嘉義,2023-11-15,9692
00719B,元大美債1-3,30,0,30,富邦-嘉義,2023-11-15,9692
3031,佰鴻,28,0,28,富邦-嘉義,2023-11-15,9692
2364,倫飛,84,57,27,富邦-嘉義,2023-11-15,9692
00715L,期街口布蘭特正2,29,5,24,富邦-嘉義,2023-11-15,9692
6150,撼訊,29,5,24,富邦-嘉義,2023-11-15,9692
00687B,國泰20年美債,26,3,23,富邦-嘉義,2023-11-15,9692
8996,高力,72,52,20,富邦-嘉義,2023-11-15,9692
00680L,元大美債20正2,29,10,19,富邦-嘉義,2023-11-15,9692
1815,富喬,33,15,18,富邦-嘉義,2023-11-15,9692
6667,信紘科,168,150,18,富邦-嘉義,2023-11-15,9692
0051,元大中型100,17,0,17,富邦-嘉義,2023-11-15,9692
00935,野村臺灣新科技50,19,2,17,富邦-嘉義,2023-11-15,9692
2324,仁寶,24,7,17,富邦-嘉義,2023-11-15,9692
00878,國泰永續高股息,293,276,17,富邦-嘉義,2023-11-15,9692
3324,雙鴻,20,4,16,富邦-嘉義,2023-11-15,9692
00637L,元大滬深300正2,66,50,16,富邦-嘉義,2023-11-15,9692
3706,神達,36,20,16,富邦-嘉義,2023-11-15,9692
00772B,中信高評級公司債,18,2,16,富邦-嘉義,2023-11-15,9692
00795B,中信美國公債20年,17,2,15,富邦-嘉義,2023-11-15,9692
6156,松上,15,0,15,富邦-嘉義,2023-11-15,9692
00934,中信成長高股息,22,7,15,富邦-嘉義,2023-11-15,9692
3260,威剛,32,18,14,富邦-嘉義,2023-11-15,9692
6282,康舒,32,18,14,富邦-嘉義,2023-11-15,9692
2356,英業達,21,8,13,富邦-嘉義,2023-11-15,9692
6651,全宇昕,15,2,13,富邦-嘉義,2023-11-15,9692
6026,福邦證,22,9,13,富邦-嘉義,2023-11-15,9692
00665L,富邦�琤肭磪囓�2,14,2,12,富邦-嘉義,2023-11-15,9692
2401,凌陽,126,115,11,富邦-嘉義,2023-11-15,9692
6290,良維,22,11,11,富邦-嘉義,2023-11-15,9692
4564,元翎,11,0,11,富邦-嘉義,2023-11-15,9692
8112,至上,12,1,11,富邦-嘉義,2023-11-15,9692
9958,世紀鋼,61,50,11,富邦-嘉義,2023-11-15,9692
00878,國泰永續高股息,813,59,754,富邦-嘉義,2023-11-16,9692
2382,廣達,538,26,512,富邦-嘉義,2023-11-16,9692
3041,揚智,647,145,502,富邦-嘉義,2023-11-16,9692
00632R,元大台灣50反1,405,45,360,富邦-嘉義,2023-11-16,9692
2313,華通,334,66,268,富邦-嘉義,2023-11-16,9692
2344,華邦電,312,83,229,富邦-嘉義,2023-11-16,9692
3623,富晶通,233,23,210,富邦-嘉義,2023-11-16,9692
2618,長榮航,1488,1320,168,富邦-嘉義,2023-11-16,9692
00720B,元大投資級公司債,140,0,140,富邦-嘉義,2023-11-16,9692
6243,迅杰,497,390,107,富邦-嘉義,2023-11-16,9692
9950,萬國通,356,261,95,富邦-嘉義,2023-11-16,9692
3545,敦泰,167,83,84,富邦-嘉義,2023-11-16,9692
3715,定穎投控,228,150,78,富邦-嘉義,2023-11-16,9692
00687B,國泰20年美債,66,0,66,富邦-嘉義,2023-11-16,9692
00885,富邦越南,67,2,65,富邦-嘉義,2023-11-16,9692
00679B,元大美債20年,56,0,56,富邦-嘉義,2023-11-16,9692
8176,智捷,57,2,55,富邦-嘉義,2023-11-16,9692
1314,中石化,56,4,52,富邦-嘉義,2023-11-16,9692
2029,盛餘,50,0,50,富邦-嘉義,2023-11-16,9692
2329,華泰,757,709,48,富邦-嘉義,2023-11-16,9692
4401,東隆興,47,1,46,富邦-嘉義,2023-11-16,9692
0056,元大高股息,65,20,45,富邦-嘉義,2023-11-16,9692
3306,鼎天,56,11,45,富邦-嘉義,2023-11-16,9692
2402,毅嘉,59,20,39,富邦-嘉義,2023-11-16,9692
8034,榮群,105,66,39,富邦-嘉義,2023-11-16,9692
6127,九豪,38,0,38,富邦-嘉義,2023-11-16,9692
2369,菱生,94,56,38,富邦-嘉義,2023-11-16,9692
2543,皇昌,135,100,35,富邦-嘉義,2023-11-16,9692
3324,雙鴻,70,37,33,富邦-嘉義,2023-11-16,9692
6584,南俊國際,30,0,30,富邦-嘉義,2023-11-16,9692
3042,晶技,30,0,30,富邦-嘉義,2023-11-16,9692
00683L,期元大美元指正2,30,0,30,富邦-嘉義,2023-11-16,9692
6223,旺矽,41,13,28,富邦-嘉義,2023-11-16,9692
2010,春源,27,0,27,富邦-嘉義,2023-11-16,9692
2615,萬海,30,4,26,富邦-嘉義,2023-11-16,9692
00935,野村臺灣新科技50,25,0,25,富邦-嘉義,2023-11-16,9692
2388,威盛,304,280,24,富邦-嘉義,2023-11-16,9692
00934,中信成長高股息,31,7,24,富邦-嘉義,2023-11-16,9692
0051,元大中型100,24,0,24,富邦-嘉義,2023-11-16,9692
2465,麗臺,28,7,21,富邦-嘉義,2023-11-16,9692
00719B,元大美債1-3,21,1,20,富邦-嘉義,2023-11-16,9692
2352,佳世達,21,1,20,富邦-嘉義,2023-11-16,9692
1714,和桐,36,17,19,富邦-嘉義,2023-11-16,9692
5512,力麒,191,173,18,富邦-嘉義,2023-11-16,9692
6805,富世達,35,17,18,富邦-嘉義,2023-11-16,9692
00751B,元大AAA至A公司債,18,0,18,富邦-嘉義,2023-11-16,9692
6274,台燿,29,12,17,富邦-嘉義,2023-11-16,9692
3122,笙泉,44,27,17,富邦-嘉義,2023-11-16,9692
1301,台塑,20,4,16,富邦-嘉義,2023-11-16,9692
4927,泰鼎-KY,15,0,15,富邦-嘉義,2023-11-16,9692
3231,緯創,2551,2066,485,富邦-嘉義,2023-11-17,9692
2367,燿華,385,33,352,富邦-嘉義,2023-11-17,9692
4979,華星光,312,6,306,富邦-嘉義,2023-11-17,9692
00715L,期街口布蘭特正2,198,0,198,富邦-嘉義,2023-11-17,9692
6191,精成科,156,5,151,富邦-嘉義,2023-11-17,9692
5469,瀚宇博,104,1,103,富邦-嘉義,2023-11-17,9692
00919,群益台灣精選高息,125,23,102,富邦-嘉義,2023-11-17,9692
3715,定穎投控,331,235,96,富邦-嘉義,2023-11-17,9692
6237,驊訊,172,79,93,富邦-嘉義,2023-11-17,9692
3545,敦泰,191,104,87,富邦-嘉義,2023-11-17,9692
2618,長榮航,176,91,85,富邦-嘉義,2023-11-17,9692
6695,芯鼎,93,10,83,富邦-嘉義,2023-11-17,9692
2363,矽統,227,164,63,富邦-嘉義,2023-11-17,9692
3252,海灣,73,25,48,富邦-嘉義,2023-11-17,9692
2344,華邦電,48,3,45,富邦-嘉義,2023-11-17,9692
00676R,富邦臺灣加權反1,45,1,44,富邦-嘉義,2023-11-17,9692
5531,鄉林,94,51,43,富邦-嘉義,2023-11-17,9692
3035,智原,480,440,40,富邦-嘉義,2023-11-17,9692
6282,康舒,46,6,40,富邦-嘉義,2023-11-17,9692
00931B,統一美債20年,40,0,40,富邦-嘉義,2023-11-17,9692
1815,富喬,55,15,40,富邦-嘉義,2023-11-17,9692
2610,華航,75,38,37,富邦-嘉義,2023-11-17,9692
2332,友訊,38,2,36,富邦-嘉義,2023-11-17,9692
2405,輔信,188,152,36,富邦-嘉義,2023-11-17,9692
1313,聯成,40,6,34,富邦-嘉義,2023-11-17,9692
6667,信紘科,49,17,32,富邦-嘉義,2023-11-17,9692
6138,茂達,42,11,31,富邦-嘉義,2023-11-17,9692
5864,致和證,30,0,30,富邦-嘉義,2023-11-17,9692
8467,波力-KY,31,1,30,富邦-嘉義,2023-11-17,9692
9928,中視,29,0,29,富邦-嘉義,2023-11-17,9692
2312,金寶,49,20,29,富邦-嘉義,2023-11-17,9692
2354,鴻準,28,1,27,富邦-嘉義,2023-11-17,9692
2705,六福,54,28,26,富邦-嘉義,2023-11-17,9692
00679B,元大美債20年,26,1,25,富邦-嘉義,2023-11-17,9692
2498,宏達電,29,4,25,富邦-嘉義,2023-11-17,9692
3324,雙鴻,50,25,25,富邦-嘉義,2023-11-17,9692
5258,虹堡,37,14,23,富邦-嘉義,2023-11-17,9692
2609,陽明,26,3,23,富邦-嘉義,2023-11-17,9692
6584,南俊國際,34,11,23,富邦-嘉義,2023-11-17,9692
3260,威剛,24,2,22,富邦-嘉義,2023-11-17,9692
2731,雄獅,119,98,21,富邦-嘉義,2023-11-17,9692
2002,中鋼,32,11,21,富邦-嘉義,2023-11-17,9692
3147,大綜,22,2,20,富邦-嘉義,2023-11-17,9692
2020,美亞,20,0,20,富邦-嘉義,2023-11-17,9692
6585,鼎基,20,0,20,富邦-嘉義,2023-11-17,9692
2883,凱基金,40,21,19,富邦-嘉義,2023-11-17,9692
00665L,富邦�琤肭磪囓�2,60,41,19,富邦-嘉義,2023-11-17,9692
3363,上詮,32,13,19,富邦-嘉義,2023-11-17,9692
2371,大同,21,2,19,富邦-嘉義,2023-11-17,9692
1432,大魯閣,23,5,18,富邦-嘉義,2023-11-17,9692
3231,緯創,1091,285,806,富邦-嘉義,2023-11-20,9692
2388,威盛,1206,792,414,富邦-嘉義,2023-11-20,9692
3715,定穎投控,2267,1882,385,富邦-嘉義,2023-11-20,9692
3041,揚智,628,294,334,富邦-嘉義,2023-11-20,9692
2355,敬鵬,1008,676,332,富邦-嘉義,2023-11-20,9692
3059,華晶科,412,161,251,富邦-嘉義,2023-11-20,9692
6117,迎廣,390,172,218,富邦-嘉義,2023-11-20,9692
00929,復華台灣科技優息,232,65,167,富邦-嘉義,2023-11-20,9692
3623,富晶通,146,0,146,富邦-嘉義,2023-11-20,9692
5351,鈺創,759,617,142,富邦-嘉義,2023-11-20,9692
3548,兆利,211,108,103,富邦-嘉義,2023-11-20,9692
2329,華泰,148,49,99,富邦-嘉義,2023-11-20,9692
3005,神基,186,120,66,富邦-嘉義,2023-11-20,9692
2610,華航,145,82,63,富邦-嘉義,2023-11-20,9692
1524,耿鼎,96,35,61,富邦-嘉義,2023-11-20,9692
2832,台產,60,0,60,富邦-嘉義,2023-11-20,9692
8054,安國,177,118,59,富邦-嘉義,2023-11-20,9692
00673R,期元大S＆P原油反1,55,0,55,富邦-嘉義,2023-11-20,9692
00885,富邦越南,57,5,52,富邦-嘉義,2023-11-20,9692
2409,友達,78,29,49,富邦-嘉義,2023-11-20,9692
2486,一詮,51,3,48,富邦-嘉義,2023-11-20,9692
00687B,國泰20年美債,45,0,45,富邦-嘉義,2023-11-20,9692
00679B,元大美債20年,47,3,44,富邦-嘉義,2023-11-20,9692
00878,國泰永續高股息,63,22,41,富邦-嘉義,2023-11-20,9692
2915,潤泰全,39,1,38,富邦-嘉義,2023-11-20,9692
6125,廣運,240,204,36,富邦-嘉義,2023-11-20,9692
2618,長榮航,61,26,35,富邦-嘉義,2023-11-20,9692
2356,英業達,56,21,35,富邦-嘉義,2023-11-20,9692
2883,凱基金,40,8,32,富邦-嘉義,2023-11-20,9692
8111,立��,32,0,32,富邦-嘉義,2023-11-20,9692
00720B,元大投資級公司債,33,2,31,富邦-嘉義,2023-11-20,9692
3701,大眾控,33,2,31,富邦-嘉義,2023-11-20,9692
3376,新日興,59,29,30,富邦-嘉義,2023-11-20,9692
2382,廣達,60,30,30,富邦-嘉義,2023-11-20,9692
8040,九暘,31,3,28,富邦-嘉義,2023-11-20,9692
2516,新建,52,25,27,富邦-嘉義,2023-11-20,9692
2462,良得電,89,62,27,富邦-嘉義,2023-11-20,9692
1312,國喬,30,3,27,富邦-嘉義,2023-11-20,9692
00719B,元大美債1-3,30,5,25,富邦-嘉義,2023-11-20,9692
5880,合庫金,23,0,23,富邦-嘉義,2023-11-20,9692
00896,中信綠能及電動車,22,0,22,富邦-嘉義,2023-11-20,9692
6120,達運,24,2,22,富邦-嘉義,2023-11-20,9692
1522,堤維西,43,21,22,富邦-嘉義,2023-11-20,9692
00931B,統一美債20年,21,0,21,富邦-嘉義,2023-11-20,9692
4107,邦特,20,0,20,富邦-嘉義,2023-11-20,9692
2443,昶虹,20,0,20,富邦-嘉義,2023-11-20,9692
2454,聯發科,21,2,19,富邦-嘉義,2023-11-20,9692
00712,復華富時不動產,19,0,19,富邦-嘉義,2023-11-20,9692
1471,首利,22,3,19,富邦-嘉義,2023-11-20,9692
1515,力山,64,45,19,富邦-嘉義,2023-11-20,9692
2367,燿華,2718,1551,1167,富邦-嘉義,2023-11-21,9692
3049,精金,517,5,512,富邦-嘉義,2023-11-21,9692
4908,前鼎,782,433,349,富邦-嘉義,2023-11-21,9692
6530,創威,356,54,302,富邦-嘉義,2023-11-21,9692
00720B,元大投資級公司債,250,1,249,富邦-嘉義,2023-11-21,9692
3147,大綜,310,142,168,富邦-嘉義,2023-11-21,9692
2382,廣達,981,856,125,富邦-嘉義,2023-11-21,9692
6451,訊芯-KY,293,193,100,富邦-嘉義,2023-11-21,9692
2313,華通,763,666,97,富邦-嘉義,2023-11-21,9692
6168,宏齊,97,6,91,富邦-嘉義,2023-11-21,9692
2618,長榮航,110,22,88,富邦-嘉義,2023-11-21,9692
2888,新光金,112,26,86,富邦-嘉義,2023-11-21,9692
2465,麗臺,88,3,85,富邦-嘉義,2023-11-21,9692
2380,虹光,56,0,56,富邦-嘉義,2023-11-21,9692
3062,建漢,81,27,54,富邦-嘉義,2023-11-21,9692
00712,復華富時不動產,50,0,50,富邦-嘉義,2023-11-21,9692
6233,旺玖,59,9,50,富邦-嘉義,2023-11-21,9692
1432,大魯閣,40,0,40,富邦-嘉義,2023-11-21,9692
4927,泰鼎-KY,39,0,39,富邦-嘉義,2023-11-21,9692
9950,萬國通,89,52,37,富邦-嘉義,2023-11-21,9692
3545,敦泰,64,27,37,富邦-嘉義,2023-11-21,9692
00710B,復華彭博非投等債,34,0,34,富邦-嘉義,2023-11-21,9692
00679B,元大美債20年,34,2,32,富邦-嘉義,2023-11-21,9692
2363,矽統,122,93,29,富邦-嘉義,2023-11-21,9692
6533,晶心科,38,9,29,富邦-嘉義,2023-11-21,9692
4979,華星光,605,580,25,富邦-嘉義,2023-11-21,9692
2615,萬海,25,1,24,富邦-嘉義,2023-11-21,9692
00936,台新永續高息中小,43,19,24,富邦-嘉義,2023-11-21,9692
6412,群電,23,0,23,富邦-嘉義,2023-11-21,9692
6285,啟��,38,16,22,富邦-嘉義,2023-11-21,9692
2258,鴻華先進-創,21,0,21,富邦-嘉義,2023-11-21,9692
3230,錦明,20,0,20,富邦-嘉義,2023-11-21,9692
3036A,文曄甲特,20,0,20,富邦-嘉義,2023-11-21,9692
5864,致和證,20,0,20,富邦-嘉義,2023-11-21,9692
2390,云辰,36,17,19,富邦-嘉義,2023-11-21,9692
2748,雲品,22,4,18,富邦-嘉義,2023-11-21,9692
3483,力致,212,194,18,富邦-嘉義,2023-11-21,9692
3290,東浦,17,0,17,富邦-嘉義,2023-11-21,9692
00892,富邦台灣半導體,20,3,17,富邦-嘉義,2023-11-21,9692
2059,川湖,18,2,16,富邦-嘉義,2023-11-21,9692
2401,凌陽,44,29,15,富邦-嘉義,2023-11-21,9692
00919,群益台灣精選高息,35,20,15,富邦-嘉義,2023-11-21,9692
1447,力鵬,15,0,15,富邦-嘉義,2023-11-21,9692
00719B,元大美債1-3,20,5,15,富邦-嘉義,2023-11-21,9692
2534,宏盛,27,12,15,富邦-嘉義,2023-11-21,9692
2303,聯電,115,101,14,富邦-嘉義,2023-11-21,9692
6415,矽力*-KY,25,11,14,富邦-嘉義,2023-11-21,9692
6274,台燿,35,22,13,富邦-嘉義,2023-11-21,9692
8050,廣積,13,0,13,富邦-嘉義,2023-11-21,9692
00673R,期元大S＆P原油反1,30,17,13,富邦-嘉義,2023-11-21,9692
00632R,元大台灣50反1,744,85,659,富邦-嘉義,2023-11-22,9692
6139,亞翔,675,164,511,富邦-嘉義,2023-11-22,9692
3362,先進光,467,195,272,富邦-嘉義,2023-11-22,9692
6237,驊訊,357,111,246,富邦-嘉義,2023-11-22,9692
5351,鈺創,304,164,140,富邦-嘉義,2023-11-22,9692
2543,皇昌,193,83,110,富邦-嘉義,2023-11-22,9692
5521,工信,715,606,109,富邦-嘉義,2023-11-22,9692
2367,燿華,337,241,96,富邦-嘉義,2023-11-22,9692
6243,迅杰,271,179,92,富邦-嘉義,2023-11-22,9692
2313,華通,189,97,92,富邦-嘉義,2023-11-22,9692
2355,敬鵬,175,84,91,富邦-嘉義,2023-11-22,9692
3715,定穎投控,163,79,84,富邦-嘉義,2023-11-22,9692
2356,英業達,143,63,80,富邦-嘉義,2023-11-22,9692
3443,創意,104,25,79,富邦-嘉義,2023-11-22,9692
2888,新光金,70,2,68,富邦-嘉義,2023-11-22,9692
00637L,元大滬深300正2,61,0,61,富邦-嘉義,2023-11-22,9692
8054,安國,325,265,60,富邦-嘉義,2023-11-22,9692
00919,群益台灣精選高息,72,15,57,富邦-嘉義,2023-11-22,9692
5236,凌陽創新,61,5,56,富邦-嘉義,2023-11-22,9692
2801,彰銀,64,11,53,富邦-嘉義,2023-11-22,9692
2615,萬海,52,0,52,富邦-嘉義,2023-11-22,9692
2537,聯上發,50,0,50,富邦-嘉義,2023-11-22,9692
4931,新盛力,50,0,50,富邦-嘉義,2023-11-22,9692
3483,力致,71,21,50,富邦-嘉義,2023-11-22,9692
3228,金麗科,54,4,50,富邦-嘉義,2023-11-22,9692
2534,宏盛,50,4,46,富邦-嘉義,2023-11-22,9692
2618,長榮航,169,124,45,富邦-嘉義,2023-11-22,9692
6533,晶心科,70,26,44,富邦-嘉義,2023-11-22,9692
8227,巨有科技,104,61,43,富邦-嘉義,2023-11-22,9692
2377,微星,44,3,41,富邦-嘉義,2023-11-22,9692
00915,凱基優選高股息30,40,0,40,富邦-嘉義,2023-11-22,9692
2353,宏��,37,1,36,富邦-嘉義,2023-11-22,9692
00935,野村臺灣新科技50,37,2,35,富邦-嘉義,2023-11-22,9692
2376,技嘉,42,10,32,富邦-嘉義,2023-11-22,9692
3706,神達,58,26,32,富邦-嘉義,2023-11-22,9692
1785,光洋科,36,5,31,富邦-嘉義,2023-11-22,9692
00773B,中信優先金融債,30,0,30,富邦-嘉義,2023-11-22,9692
6112,邁達特,35,6,29,富邦-嘉義,2023-11-22,9692
2002,中鋼,65,37,28,富邦-嘉義,2023-11-22,9692
00720B,元大投資級公司債,27,0,27,富邦-嘉義,2023-11-22,9692
6585,鼎基,72,45,27,富邦-嘉義,2023-11-22,9692
2915,潤泰全,26,1,25,富邦-嘉義,2023-11-22,9692
00679B,元大美債20年,25,0,25,富邦-嘉義,2023-11-22,9692
3596,智易,24,0,24,富邦-嘉義,2023-11-22,9692
3122,笙泉,125,101,24,富邦-嘉義,2023-11-22,9692
00665L,富邦�琤肭磪囓�2,24,0,24,富邦-嘉義,2023-11-22,9692
5258,虹堡,81,58,23,富邦-嘉義,2023-11-22,9692
2402,毅嘉,28,6,22,富邦-嘉義,2023-11-22,9692
2409,友達,61,39,22,富邦-嘉義,2023-11-22,9692
00676R,富邦臺灣加權反1,22,0,22,富邦-嘉義,2023-11-22,9692
2455,全新,1125,425,700,富邦-嘉義,2023-11-23,9692
3122,笙泉,862,604,258,富邦-嘉義,2023-11-23,9692
2515,中工,240,12,228,富邦-嘉義,2023-11-23,9692
00929,復華台灣科技優息,230,31,199,富邦-嘉義,2023-11-23,9692
3406,玉晶光,201,2,199,富邦-嘉義,2023-11-23,9692
2367,燿華,238,51,187,富邦-嘉義,2023-11-23,9692
2501,國建,130,0,130,富邦-嘉義,2023-11-23,9692
00919,群益台灣精選高息,156,32,124,富邦-嘉義,2023-11-23,9692
2313,華通,184,63,121,富邦-嘉義,2023-11-23,9692
2888,新光金,110,10,100,富邦-嘉義,2023-11-23,9692
2516,新建,112,16,96,富邦-嘉義,2023-11-23,9692
6485,點序,109,17,92,富邦-嘉義,2023-11-23,9692
6282,康舒,200,112,88,富邦-嘉義,2023-11-23,9692
00715L,期街口布蘭特正2,87,1,86,富邦-嘉義,2023-11-23,9692
3437,榮創,319,254,65,富邦-嘉義,2023-11-23,9692
6719,力智,81,17,64,富邦-嘉義,2023-11-23,9692
00632R,元大台灣50反1,254,190,64,富邦-嘉義,2023-11-23,9692
5521,工信,395,334,61,富邦-嘉義,2023-11-23,9692
3060,銘異,57,0,57,富邦-嘉義,2023-11-23,9692
2002,中鋼,65,10,55,富邦-嘉義,2023-11-23,9692
1504,東元,59,8,51,富邦-嘉義,2023-11-23,9692
3623,富晶通,78,28,50,富邦-嘉義,2023-11-23,9692
3530,晶相光,86,39,47,富邦-嘉義,2023-11-23,9692
2801,彰銀,47,1,46,富邦-嘉義,2023-11-23,9692
3041,揚智,93,49,44,富邦-嘉義,2023-11-23,9692
1471,首利,59,17,42,富邦-嘉義,2023-11-23,9692
9945,潤泰新,41,0,41,富邦-嘉義,2023-11-23,9692
1524,耿鼎,44,3,41,富邦-嘉義,2023-11-23,9692
00637L,元大滬深300正2,42,2,40,富邦-嘉義,2023-11-23,9692
4960,誠美材,41,3,38,富邦-嘉義,2023-11-23,9692
00936,台新永續高息中小,38,0,38,富邦-嘉義,2023-11-23,9692
2457,飛宏,97,61,36,富邦-嘉義,2023-11-23,9692
00934,中信成長高股息,36,0,36,富邦-嘉義,2023-11-23,9692
3231,緯創,85,49,36,富邦-嘉義,2023-11-23,9692
6443,元晶,36,1,35,富邦-嘉義,2023-11-23,9692
2486,一詮,35,4,31,富邦-嘉義,2023-11-23,9692
00676R,富邦臺灣加權反1,30,0,30,富邦-嘉義,2023-11-23,9692
2382,廣達,1044,1015,29,富邦-嘉義,2023-11-23,9692
2371,大同,30,2,28,富邦-嘉義,2023-11-23,9692
2402,毅嘉,28,1,27,富邦-嘉義,2023-11-23,9692
2308,台達電,31,4,27,富邦-嘉義,2023-11-23,9692
1440,南紡,25,0,25,富邦-嘉義,2023-11-23,9692
2338,光罩,33,8,25,富邦-嘉義,2023-11-23,9692
3325,旭品,97,73,24,富邦-嘉義,2023-11-23,9692
5347,世界,170,146,24,富邦-嘉義,2023-11-23,9692
5009,榮剛,34,10,24,富邦-嘉義,2023-11-23,9692
2344,華邦電,29,6,23,富邦-嘉義,2023-11-23,9692
3035,智原,36,13,23,富邦-嘉義,2023-11-23,9692
3545,敦泰,41,18,23,富邦-嘉義,2023-11-23,9692
2884,玉山金,35,13,22,富邦-嘉義,2023-11-23,9692
00720B,元大投資級公司債,510,0,510,富邦-嘉義,2023-11-24,9692
4979,華星光,585,85,500,富邦-嘉義,2023-11-24,9692
2501,國建,281,1,280,富邦-嘉義,2023-11-24,9692
3437,榮創,562,299,263,富邦-嘉義,2023-11-24,9692
2367,燿華,255,5,250,富邦-嘉義,2023-11-24,9692
3548,兆利,440,228,212,富邦-嘉義,2023-11-24,9692
3362,先進光,490,283,207,富邦-嘉義,2023-11-24,9692
2618,長榮航,231,73,158,富邦-嘉義,2023-11-24,9692
00919,群益台灣精選高息,118,3,115,富邦-嘉義,2023-11-24,9692
2516,新建,229,120,109,富邦-嘉義,2023-11-24,9692
00929,復華台灣科技優息,195,95,100,富邦-嘉義,2023-11-24,9692
6284,佳邦,112,18,94,富邦-嘉義,2023-11-24,9692
2610,華航,101,10,91,富邦-嘉義,2023-11-24,9692
3545,敦泰,111,56,55,富邦-嘉義,2023-11-24,9692
2888,新光金,355,303,52,富邦-嘉義,2023-11-24,9692
6127,九豪,58,6,52,富邦-嘉義,2023-11-24,9692
6231,系微,50,0,50,富邦-嘉義,2023-11-24,9692
00772B,中信高評級公司債,43,0,43,富邦-嘉義,2023-11-24,9692
3035,智原,62,19,43,富邦-嘉義,2023-11-24,9692
3701,大眾控,94,52,42,富邦-嘉義,2023-11-24,9692
00885,富邦越南,52,10,42,富邦-嘉義,2023-11-24,9692
00687B,國泰20年美債,41,0,41,富邦-嘉義,2023-11-24,9692
1515,力山,116,81,35,富邦-嘉義,2023-11-24,9692
6202,盛群,35,0,35,富邦-嘉義,2023-11-24,9692
3694,海華,84,49,35,富邦-嘉義,2023-11-24,9692
6451,訊芯-KY,58,25,33,富邦-嘉義,2023-11-24,9692
3059,華晶科,38,5,33,富邦-嘉義,2023-11-24,9692
2344,華邦電,40,7,33,富邦-嘉義,2023-11-24,9692
2492,華新科,157,125,32,富邦-嘉義,2023-11-24,9692
3704,合勤控,60,30,30,富邦-嘉義,2023-11-24,9692
2002,中鋼,81,53,28,富邦-嘉義,2023-11-24,9692
2382,廣達,41,15,26,富邦-嘉義,2023-11-24,9692
6494,九齊,25,0,25,富邦-嘉義,2023-11-24,9692
6233,旺玖,25,0,25,富邦-嘉義,2023-11-24,9692
3041,揚智,88,63,25,富邦-嘉義,2023-11-24,9692
6805,富世達,35,11,24,富邦-嘉義,2023-11-24,9692
1815,富喬,34,10,24,富邦-嘉義,2023-11-24,9692
3122,笙泉,60,37,23,富邦-嘉義,2023-11-24,9692
3706,神達,25,2,23,富邦-嘉義,2023-11-24,9692
00712,復華富時不動產,23,2,21,富邦-嘉義,2023-11-24,9692
4977,眾達-KY,21,0,21,富邦-嘉義,2023-11-24,9692
6170,統振,22,1,21,富邦-嘉義,2023-11-24,9692
2485,兆赫,20,0,20,富邦-嘉義,2023-11-24,9692
3623,富晶通,70,51,19,富邦-嘉義,2023-11-24,9692
2206,三陽工業,19,1,18,富邦-嘉義,2023-11-24,9692
1605,華新,35,18,17,富邦-嘉義,2023-11-24,9692
6485,點序,20,3,17,富邦-嘉義,2023-11-24,9692
1809,中釉,17,0,17,富邦-嘉義,2023-11-24,9692
00933B,國泰10Y+金融債,16,1,15,富邦-嘉義,2023-11-24,9692
00935,野村臺灣新科技50,21,6,15,富邦-嘉義,2023-11-24,9692
00688L,國泰20年美債正2,300,0,300,富邦-嘉義,2023-11-27,9692
2367,燿華,217,7,210,富邦-嘉義,2023-11-27,9692
00715L,期街口布蘭特正2,160,0,160,富邦-嘉義,2023-11-27,9692
2501,國建,156,0,156,富邦-嘉義,2023-11-27,9692
4956,光鋐,350,208,142,富邦-嘉義,2023-11-27,9692
2915,潤泰全,132,1,131,富邦-嘉義,2023-11-27,9692
4979,華星光,262,148,114,富邦-嘉義,2023-11-27,9692
1444,力麗,100,0,100,富邦-嘉義,2023-11-27,9692
00679B,元大美債20年,85,7,78,富邦-嘉義,2023-11-27,9692
2323,中環,80,5,75,富邦-嘉義,2023-11-27,9692
2516,新建,69,0,69,富邦-嘉義,2023-11-27,9692
1514,亞力,159,94,65,富邦-嘉義,2023-11-27,9692
00891,中信關鍵半導體,59,1,58,富邦-嘉義,2023-11-27,9692
4906,正文,87,30,57,富邦-嘉義,2023-11-27,9692
00929,復華台灣科技優息,153,99,54,富邦-嘉義,2023-11-27,9692
1752,南光,81,28,53,富邦-嘉義,2023-11-27,9692
3406,玉晶光,104,51,53,富邦-嘉義,2023-11-27,9692
2382,廣達,907,855,52,富邦-嘉義,2023-11-27,9692
9105,泰金寶-DR,50,0,50,富邦-嘉義,2023-11-27,9692
5432,新門,70,20,50,富邦-嘉義,2023-11-27,9692
4188,安克,58,8,50,富邦-嘉義,2023-11-27,9692
3231,緯創,128,80,48,富邦-嘉義,2023-11-27,9692
00637L,元大滬深300正2,46,3,43,富邦-嘉義,2023-11-27,9692
2457,飛宏,62,19,43,富邦-嘉義,2023-11-27,9692
00878,國泰永續高股息,47,5,42,富邦-嘉義,2023-11-27,9692
4133,亞諾法,55,14,41,富邦-嘉義,2023-11-27,9692
00687B,國泰20年美債,44,4,40,富邦-嘉義,2023-11-27,9692
00915,凱基優選高股息30,38,0,38,富邦-嘉義,2023-11-27,9692
00720B,元大投資級公司債,39,2,37,富邦-嘉義,2023-11-27,9692
2630,亞航,69,32,37,富邦-嘉義,2023-11-27,9692
5347,世界,58,24,34,富邦-嘉義,2023-11-27,9692
6547,高端疫苗,36,2,34,富邦-嘉義,2023-11-27,9692
6461,益得,39,5,34,富邦-嘉義,2023-11-27,9692
3706,神達,37,4,33,富邦-嘉義,2023-11-27,9692
2303,聯電,50,18,32,富邦-嘉義,2023-11-27,9692
00885,富邦越南,40,8,32,富邦-嘉義,2023-11-27,9692
2352,佳世達,49,18,31,富邦-嘉義,2023-11-27,9692
00905,FT臺灣Smart,31,0,31,富邦-嘉義,2023-11-27,9692
5009,榮剛,35,4,31,富邦-嘉義,2023-11-27,9692
3481,群創,35,5,30,富邦-嘉義,2023-11-27,9692
6667,信紘科,33,3,30,富邦-嘉義,2023-11-27,9692
2356,英業達,47,18,29,富邦-嘉義,2023-11-27,9692
00712,復華富時不動產,53,24,29,富邦-嘉義,2023-11-27,9692
3013,晟銘電,33,4,29,富邦-嘉義,2023-11-27,9692
00919,群益台灣精選高息,122,93,29,富邦-嘉義,2023-11-27,9692
2888,新光金,36,8,28,富邦-嘉義,2023-11-27,9692
00772B,中信高評級公司債,37,10,27,富邦-嘉義,2023-11-27,9692
2515,中工,26,1,25,富邦-嘉義,2023-11-27,9692
3689,湧德,30,5,25,富邦-嘉義,2023-11-27,9692
2605,新興,220,195,25,富邦-嘉義,2023-11-27,9692
2329,華泰,1014,282,732,富邦-嘉義,2023-11-28,9692
00632R,元大台灣50反1,636,20,616,富邦-嘉義,2023-11-28,9692
00688L,國泰20年美債正2,500,0,500,富邦-嘉義,2023-11-28,9692
2388,威盛,918,524,394,富邦-嘉義,2023-11-28,9692
3545,敦泰,938,561,377,富邦-嘉義,2023-11-28,9692
2516,新建,217,20,197,富邦-嘉義,2023-11-28,9692
6276,安鈦克,218,75,143,富邦-嘉義,2023-11-28,9692
6122,擎邦,103,0,103,富邦-嘉義,2023-11-28,9692
2405,輔信,178,81,97,富邦-嘉義,2023-11-28,9692
4114,健喬,130,52,78,富邦-嘉義,2023-11-28,9692
1514,亞力,116,39,77,富邦-嘉義,2023-11-28,9692
5236,凌陽創新,109,33,76,富邦-嘉義,2023-11-28,9692
2543,皇昌,68,0,68,富邦-嘉義,2023-11-28,9692
3122,笙泉,548,481,67,富邦-嘉義,2023-11-28,9692
00720B,元大投資級公司債,273,206,67,富邦-嘉義,2023-11-28,9692
6695,芯鼎,81,15,66,富邦-嘉義,2023-11-28,9692
2355,敬鵬,66,18,48,富邦-嘉義,2023-11-28,9692
2816,旺旺保,51,5,46,富邦-嘉義,2023-11-28,9692
8054,安國,199,155,44,富邦-嘉義,2023-11-28,9692
3217,優群,190,147,43,富邦-嘉義,2023-11-28,9692
00885,富邦越南,43,0,43,富邦-嘉義,2023-11-28,9692
6191,精成科,35,3,32,富邦-嘉義,2023-11-28,9692
00905,FT臺灣Smart,30,0,30,富邦-嘉義,2023-11-28,9692
3231,緯創,460,431,29,富邦-嘉義,2023-11-28,9692
3031,佰鴻,29,0,29,富邦-嘉義,2023-11-28,9692
2641,正德,475,446,29,富邦-嘉義,2023-11-28,9692
3704,合勤控,33,5,28,富邦-嘉義,2023-11-28,9692
6533,晶心科,30,2,28,富邦-嘉義,2023-11-28,9692
2353,宏��,31,4,27,富邦-嘉義,2023-11-28,9692
2883,凱基金,270,244,26,富邦-嘉義,2023-11-28,9692
3715,定穎投控,161,136,25,富邦-嘉義,2023-11-28,9692
2382,廣達,438,413,25,富邦-嘉義,2023-11-28,9692
6120,達運,23,0,23,富邦-嘉義,2023-11-28,9692
1101,台泥,426,405,21,富邦-嘉義,2023-11-28,9692
8109,博大,21,0,21,富邦-嘉義,2023-11-28,9692
00712,復華富時不動產,46,25,21,富邦-嘉義,2023-11-28,9692
2443,昶虹,20,0,20,富邦-嘉義,2023-11-28,9692
9919,康那香,98,78,20,富邦-嘉義,2023-11-28,9692
00893,國泰智能電動車,20,0,20,富邦-嘉義,2023-11-28,9692
6605,帝寶,20,1,19,富邦-嘉義,2023-11-28,9692
6243,迅杰,286,267,19,富邦-嘉義,2023-11-28,9692
6245,立端,25,7,18,富邦-嘉義,2023-11-28,9692
2303,聯電,26,9,17,富邦-嘉義,2023-11-28,9692
6116,彩晶,20,3,17,富邦-嘉義,2023-11-28,9692
6643,M31,19,3,16,富邦-嘉義,2023-11-28,9692
1314,中石化,28,12,16,富邦-嘉義,2023-11-28,9692
2882,國泰金,18,2,16,富邦-嘉義,2023-11-28,9692
3189,景碩,16,0,16,富邦-嘉義,2023-11-28,9692
3437,榮創,131,116,15,富邦-嘉義,2023-11-28,9692
00915,凱基優選高股息30,14,0,14,富邦-嘉義,2023-11-28,9692
3049,精金,1696,196,1500,富邦-嘉義,2023-11-29,9692
2367,燿華,715,263,452,富邦-嘉義,2023-11-29,9692
5328,華容,512,255,257,富邦-嘉義,2023-11-29,9692
3715,定穎投控,272,58,214,富邦-嘉義,2023-11-29,9692
1616,億泰,215,6,209,富邦-嘉義,2023-11-29,9692
6117,迎廣,476,297,179,富邦-嘉義,2023-11-29,9692
2603,長榮,154,7,147,富邦-嘉義,2023-11-29,9692
00665L,富邦�琤肭磪囓�2,146,0,146,富邦-嘉義,2023-11-29,9692
3437,榮創,370,230,140,富邦-嘉義,2023-11-29,9692
3035,智原,579,465,114,富邦-嘉義,2023-11-29,9692
00882,中信中國高股息,106,0,106,富邦-嘉義,2023-11-29,9692
00706L,期元大S＆P日圓正2,104,0,104,富邦-嘉義,2023-11-29,9692
2501,國建,93,0,93,富邦-嘉義,2023-11-29,9692
2618,長榮航,104,15,89,富邦-嘉義,2023-11-29,9692
3694,海華,111,28,83,富邦-嘉義,2023-11-29,9692
4979,華星光,322,239,83,富邦-嘉義,2023-11-29,9692
00934,中信成長高股息,79,8,71,富邦-嘉義,2023-11-29,9692
6435,大中,73,3,70,富邦-嘉義,2023-11-29,9692
2888,新光金,81,13,68,富邦-嘉義,2023-11-29,9692
3693,營邦,165,102,63,富邦-嘉義,2023-11-29,9692
2382,廣達,694,631,63,富邦-嘉義,2023-11-29,9692
2641,正德,69,8,61,富邦-嘉義,2023-11-29,9692
6191,精成科,72,11,61,富邦-嘉義,2023-11-29,9692
4503,金雨,58,0,58,富邦-嘉義,2023-11-29,9692
5608,四維航,63,11,52,富邦-嘉義,2023-11-29,9692
2543,皇昌,90,45,45,富邦-嘉義,2023-11-29,9692
00687B,國泰20年美債,49,5,44,富邦-嘉義,2023-11-29,9692
8210,勤誠,184,140,44,富邦-嘉義,2023-11-29,9692
6282,康舒,47,5,42,富邦-嘉義,2023-11-29,9692
4306,炎洲,40,0,40,富邦-嘉義,2023-11-29,9692
6243,迅杰,110,70,40,富邦-嘉義,2023-11-29,9692
3231,緯創,105,66,39,富邦-嘉義,2023-11-29,9692
00905,FT臺灣Smart,40,2,38,富邦-嘉義,2023-11-29,9692
2401,凌陽,187,150,37,富邦-嘉義,2023-11-29,9692
2436,偉詮電,100,63,37,富邦-嘉義,2023-11-29,9692
2369,菱生,1096,1059,37,富邦-嘉義,2023-11-29,9692
3051,力特,48,13,35,富邦-嘉義,2023-11-29,9692
00712,復華富時不動產,40,7,33,富邦-嘉義,2023-11-29,9692
8936,國統,40,8,32,富邦-嘉義,2023-11-29,9692
2323,中環,30,0,30,富邦-嘉義,2023-11-29,9692
2352,佳世達,31,2,29,富邦-嘉義,2023-11-29,9692
3147,大綜,66,37,29,富邦-嘉義,2023-11-29,9692
00673R,期元大S＆P原油反1,28,0,28,富邦-嘉義,2023-11-29,9692
5439,高技,30,3,27,富邦-嘉義,2023-11-29,9692
1325,恆大,61,35,26,富邦-嘉義,2023-11-29,9692
3094,聯傑,62,36,26,富邦-嘉義,2023-11-29,9692
6494,九齊,45,19,26,富邦-嘉義,2023-11-29,9692
00878,國泰永續高股息,42,19,23,富邦-嘉義,2023-11-29,9692
6593,台灣銘板,53,30,23,富邦-嘉義,2023-11-29,9692
00924,復華S＆P500成長,23,0,23,富邦-嘉義,2023-11-29,9692
2382,廣達,567,129,438,富邦-嘉義,2023-11-30,9692
2359,所羅門,631,267,364,富邦-嘉義,2023-11-30,9692
00665L,富邦�琤肭磪囓�2,490,153,337,富邦-嘉義,2023-11-30,9692
00673R,期元大S＆P原油反1,274,0,274,富邦-嘉義,2023-11-30,9692
6117,迎廣,446,250,196,富邦-嘉義,2023-11-30,9692
00753L,中信中國50正2,170,0,170,富邦-嘉義,2023-11-30,9692
3715,定穎投控,975,814,161,富邦-嘉義,2023-11-30,9692
3049,精金,151,0,151,富邦-嘉義,2023-11-30,9692
8096,擎亞,609,459,150,富邦-嘉義,2023-11-30,9692
00933B,國泰10Y+金融債,145,2,143,富邦-嘉義,2023-11-30,9692
00919,群益台灣精選高息,131,12,119,富邦-嘉義,2023-11-30,9692
1514,亞力,1032,917,115,富邦-嘉義,2023-11-30,9692
3363,上詮,128,29,99,富邦-嘉義,2023-11-30,9692
2367,燿華,162,64,98,富邦-嘉義,2023-11-30,9692
3545,敦泰,114,18,96,富邦-嘉義,2023-11-30,9692
3564,其陽,88,7,81,富邦-嘉義,2023-11-30,9692
3479,安勤,75,1,74,富邦-嘉義,2023-11-30,9692
1519,華城,114,43,71,富邦-嘉義,2023-11-30,9692
3217,優群,85,15,70,富邦-嘉義,2023-11-30,9692
00882,中信中國高股息,70,1,69,富邦-嘉義,2023-11-30,9692
1582,信錦,219,151,68,富邦-嘉義,2023-11-30,9692
00929,復華台灣科技優息,182,124,58,富邦-嘉義,2023-11-30,9692
1616,億泰,76,21,55,富邦-嘉義,2023-11-30,9692
00934,中信成長高股息,51,0,51,富邦-嘉義,2023-11-30,9692
3231,緯創,381,334,47,富邦-嘉義,2023-11-30,9692
2409,友達,92,46,46,富邦-嘉義,2023-11-30,9692
6276,安鈦克,208,163,45,富邦-嘉義,2023-11-30,9692
00680L,元大美債20正2,42,0,42,富邦-嘉義,2023-11-30,9692
3044,健鼎,42,3,39,富邦-嘉義,2023-11-30,9692
3481,群創,44,5,39,富邦-嘉義,2023-11-30,9692
2368,金像電,36,4,32,富邦-嘉義,2023-11-30,9692
2313,華通,133,101,32,富邦-嘉義,2023-11-30,9692
00927,群益半導體收益,31,0,31,富邦-嘉義,2023-11-30,9692
1524,耿鼎,40,9,31,富邦-嘉義,2023-11-30,9692
3213,茂訊,47,17,30,富邦-嘉義,2023-11-30,9692
3094,聯傑,34,4,30,富邦-嘉義,2023-11-30,9692
8261,富鼎,31,4,27,富邦-嘉義,2023-11-30,9692
2002,中鋼,95,69,26,富邦-嘉義,2023-11-30,9692
5371,中光電,25,0,25,富邦-嘉義,2023-11-30,9692
00679B,元大美債20年,32,7,25,富邦-嘉義,2023-11-30,9692
3623,富晶通,40,16,24,富邦-嘉義,2023-11-30,9692
1440,南紡,25,1,24,富邦-嘉義,2023-11-30,9692
5347,世界,35,12,23,富邦-嘉義,2023-11-30,9692
2618,長榮航,59,37,22,富邦-嘉義,2023-11-30,9692
3687,歐買尬,23,2,21,富邦-嘉義,2023-11-30,9692
2516,新建,75,54,21,富邦-嘉義,2023-11-30,9692
5381,合正,38,17,21,富邦-嘉義,2023-11-30,9692
2431,聯昌,20,0,20,富邦-嘉義,2023-11-30,9692
2611,志信,20,0,20,富邦-嘉義,2023-11-30,9692
2609,陽明,24,5,19,富邦-嘉義,2023-11-30,9692
2329,華泰,5782,3929,1853,富邦-嘉義,2023-12-01,9692
2883,凱基金,785,418,367,富邦-嘉義,2023-12-01,9692
3049,精金,177,4,173,富邦-嘉義,2023-12-01,9692
00720B,元大投資級公司債,379,208,171,富邦-嘉義,2023-12-01,9692
00915,凱基優選高股息30,156,0,156,富邦-嘉義,2023-12-01,9692
00919,群益台灣精選高息,271,131,140,富邦-嘉義,2023-12-01,9692
4533,協易機,213,86,127,富邦-嘉義,2023-12-01,9692
5439,高技,366,247,119,富邦-嘉義,2023-12-01,9692
2355,敬鵬,261,146,115,富邦-嘉義,2023-12-01,9692
6789,采鈺,108,7,101,富邦-嘉義,2023-12-01,9692
00688L,國泰20年美債正2,101,0,101,富邦-嘉義,2023-12-01,9692
00715L,期街口布蘭特正2,95,1,94,富邦-嘉義,2023-12-01,9692
00933B,國泰10Y+金融債,120,31,89,富邦-嘉義,2023-12-01,9692
8210,勤誠,144,60,84,富邦-嘉義,2023-12-01,9692
2888,新光金,88,9,79,富邦-嘉義,2023-12-01,9692
6194,育富,95,28,67,富邦-嘉義,2023-12-01,9692
4909,新復興,77,12,65,富邦-嘉義,2023-12-01,9692
2014,中鴻,62,0,62,富邦-嘉義,2023-12-01,9692
6233,旺玖,1099,1046,53,富邦-嘉義,2023-12-01,9692
4968,立積,58,6,52,富邦-嘉義,2023-12-01,9692
6282,康舒,68,19,49,富邦-嘉義,2023-12-01,9692
00687B,國泰20年美債,50,2,48,富邦-嘉義,2023-12-01,9692
3325,旭品,57,10,47,富邦-嘉義,2023-12-01,9692
6733,博晟生醫,55,9,46,富邦-嘉義,2023-12-01,9692
2618,長榮航,58,13,45,富邦-嘉義,2023-12-01,9692
4414,如興,41,0,41,富邦-嘉義,2023-12-01,9692
2002,中鋼,58,18,40,富邦-嘉義,2023-12-01,9692
2892,第一金,41,1,40,富邦-嘉義,2023-12-01,9692
2388,威盛,238,199,39,富邦-嘉義,2023-12-01,9692
2516,新建,73,36,37,富邦-嘉義,2023-12-01,9692
3450,聯鈞,73,37,36,富邦-嘉義,2023-12-01,9692
1101,台泥,57,21,36,富邦-嘉義,2023-12-01,9692
00679B,元大美債20年,48,12,36,富邦-嘉義,2023-12-01,9692
3231,緯創,609,573,36,富邦-嘉義,2023-12-01,9692
2880,華南金,36,1,35,富邦-嘉義,2023-12-01,9692
4919,新唐,37,3,34,富邦-嘉義,2023-12-01,9692
5347,世界,35,4,31,富邦-嘉義,2023-12-01,9692
2867,三商壽,30,0,30,富邦-嘉義,2023-12-01,9692
3479,安勤,31,2,29,富邦-嘉義,2023-12-01,9692
2612,中航,606,577,29,富邦-嘉義,2023-12-01,9692
5258,虹堡,46,17,29,富邦-嘉義,2023-12-01,9692
00882,中信中國高股息,29,1,28,富邦-嘉義,2023-12-01,9692
4420,光明,28,0,28,富邦-嘉義,2023-12-01,9692
2884,玉山金,29,2,27,富邦-嘉義,2023-12-01,9692
2365,昆盈,27,0,27,富邦-嘉義,2023-12-01,9692
4116,明基醫,27,0,27,富邦-嘉義,2023-12-01,9692
4167,松瑞藥,1097,1071,26,富邦-嘉義,2023-12-01,9692
5469,瀚宇博,54,28,26,富邦-嘉義,2023-12-01,9692
6125,廣運,49,23,26,富邦-嘉義,2023-12-01,9692
00893,國泰智能電動車,25,0,25,富邦-嘉義,2023-12-01,9692
00715L,期街口布蘭特正2,457,1,456,富邦-嘉義,2023-12-04,9692
4167,松瑞藥,588,150,438,富邦-嘉義,2023-12-04,9692
00919,群益台灣精選高息,496,87,409,富邦-嘉義,2023-12-04,9692
00918,大華優利高填息30,243,0,243,富邦-嘉義,2023-12-04,9692
00665L,富邦�琤肭磪囓�2,220,0,220,富邦-嘉義,2023-12-04,9692
2641,正德,1358,1145,213,富邦-嘉義,2023-12-04,9692
00720B,元大投資級公司債,604,437,167,富邦-嘉義,2023-12-04,9692
2516,新建,193,29,164,富邦-嘉義,2023-12-04,9692
00933B,國泰10Y+金融債,133,7,126,富邦-嘉義,2023-12-04,9692
00687B,國泰20年美債,108,6,102,富邦-嘉義,2023-12-04,9692
3105,穩懋,118,20,98,富邦-嘉義,2023-12-04,9692
2542,興富發,93,0,93,富邦-嘉義,2023-12-04,9692
2329,華泰,1056,976,80,富邦-嘉義,2023-12-04,9692
2605,新興,1230,1153,77,富邦-嘉義,2023-12-04,9692
1591,駿吉-KY,311,238,73,富邦-嘉義,2023-12-04,9692
2617,台航,159,91,68,富邦-嘉義,2023-12-04,9692
4162,智擎,53,0,53,富邦-嘉義,2023-12-04,9692
2515,中工,45,0,45,富邦-嘉義,2023-12-04,9692
2017,官田鋼,55,11,44,富邦-嘉義,2023-12-04,9692
1515,力山,62,20,42,富邦-嘉義,2023-12-04,9692
5512,力麒,41,0,41,富邦-嘉義,2023-12-04,9692
2611,志信,1040,1002,38,富邦-嘉義,2023-12-04,9692
2883,凱基金,122,85,37,富邦-嘉義,2023-12-04,9692
6143,振曜,44,7,37,富邦-嘉義,2023-12-04,9692
2108,南帝,41,4,37,富邦-嘉義,2023-12-04,9692
2031,新光鋼,41,7,34,富邦-嘉義,2023-12-04,9692
6282,康舒,69,37,32,富邦-嘉義,2023-12-04,9692
1727,中華化,183,152,31,富邦-嘉義,2023-12-04,9692
6593,台灣銘板,31,1,30,富邦-嘉義,2023-12-04,9692
6148,驊宏資,36,7,29,富邦-嘉義,2023-12-04,9692
2455,全新,33,5,28,富邦-嘉義,2023-12-04,9692
2417,圓剛,41,14,27,富邦-嘉義,2023-12-04,9692
3276,宇環,28,1,27,富邦-嘉義,2023-12-04,9692
6026,福邦證,28,1,27,富邦-嘉義,2023-12-04,9692
9919,康那香,861,835,26,富邦-嘉義,2023-12-04,9692
1605,華新,82,56,26,富邦-嘉義,2023-12-04,9692
2421,建準,24,0,24,富邦-嘉義,2023-12-04,9692
00751B,元大AAA至A公司債,22,0,22,富邦-嘉義,2023-12-04,9692
3706,神達,65,43,22,富邦-嘉義,2023-12-04,9692
3264,欣銓,221,199,22,富邦-嘉義,2023-12-04,9692
2812,台中銀,22,0,22,富邦-嘉義,2023-12-04,9692
1785,光洋科,34,12,22,富邦-嘉義,2023-12-04,9692
4121,優盛,23,2,21,富邦-嘉義,2023-12-04,9692
2838,聯邦銀,29,8,21,富邦-嘉義,2023-12-04,9692
00882,中信中國高股息,44,24,20,富邦-嘉義,2023-12-04,9692
2376,技嘉,225,205,20,富邦-嘉義,2023-12-04,9692
00712,復華富時不動產,38,18,20,富邦-嘉義,2023-12-04,9692
2905,三商,21,1,20,富邦-嘉義,2023-12-04,9692
6120,達運,20,0,20,富邦-嘉義,2023-12-04,9692
2313,華通,318,299,19,富邦-嘉義,2023-12-04,9692
1514,亞力,1890,1298,592,富邦-嘉義,2023-12-05,9692
2313,華通,546,40,506,富邦-嘉義,2023-12-05,9692
00919,群益台灣精選高息,517,31,486,富邦-嘉義,2023-12-05,9692
2367,燿華,404,39,365,富邦-嘉義,2023-12-05,9692
00688L,國泰20年美債正2,300,0,300,富邦-嘉義,2023-12-05,9692
00929,復華台灣科技優息,299,27,272,富邦-嘉義,2023-12-05,9692
3049,精金,193,4,189,富邦-嘉義,2023-12-05,9692
00937B,群益ESG投等債20,625,437,188,富邦-嘉義,2023-12-05,9692
00715L,期街口布蘭特正2,184,0,184,富邦-嘉義,2023-12-05,9692
2516,新建,162,0,162,富邦-嘉義,2023-12-05,9692
00918,大華優利高填息30,148,0,148,富邦-嘉義,2023-12-05,9692
4533,協易機,267,120,147,富邦-嘉義,2023-12-05,9692
2605,新興,2370,2224,146,富邦-嘉義,2023-12-05,9692
00632R,元大台灣50反1,160,50,110,富邦-嘉義,2023-12-05,9692
00665L,富邦�琤肭磪囓�2,125,20,105,富邦-嘉義,2023-12-05,9692
2355,敬鵬,128,28,100,富邦-嘉義,2023-12-05,9692
2601,益航,467,373,94,富邦-嘉義,2023-12-05,9692
4979,華星光,119,28,91,富邦-嘉義,2023-12-05,9692
00687B,國泰20年美債,92,2,90,富邦-嘉義,2023-12-05,9692
2501,國建,89,2,87,富邦-嘉義,2023-12-05,9692
00882,中信中國高股息,87,0,87,富邦-嘉義,2023-12-05,9692
2618,長榮航,90,14,76,富邦-嘉義,2023-12-05,9692
6148,驊宏資,160,84,76,富邦-嘉義,2023-12-05,9692
00878,國泰永續高股息,79,5,74,富邦-嘉義,2023-12-05,9692
2888,新光金,74,5,69,富邦-嘉義,2023-12-05,9692
6191,精成科,90,22,68,富邦-嘉義,2023-12-05,9692
1529,樂事綠能,125,59,66,富邦-嘉義,2023-12-05,9692
1605,華新,102,39,63,富邦-嘉義,2023-12-05,9692
2204,中華,65,2,63,富邦-嘉義,2023-12-05,9692
2405,輔信,80,19,61,富邦-嘉義,2023-12-05,9692
3013,晟銘電,334,275,59,富邦-嘉義,2023-12-05,9692
2009,第一銅,58,0,58,富邦-嘉義,2023-12-05,9692
00679B,元大美債20年,62,5,57,富邦-嘉義,2023-12-05,9692
00885,富邦越南,57,1,56,富邦-嘉義,2023-12-05,9692
00680L,元大美債20正2,57,2,55,富邦-嘉義,2023-12-05,9692
1519,華城,392,338,54,富邦-嘉義,2023-12-05,9692
00681R,元大美債20反1,50,0,50,富邦-嘉義,2023-12-05,9692
5469,瀚宇博,57,8,49,富邦-嘉義,2023-12-05,9692
1503,士電,158,110,48,富邦-嘉義,2023-12-05,9692
4116,明基醫,46,0,46,富邦-嘉義,2023-12-05,9692
3481,群創,385,339,46,富邦-嘉義,2023-12-05,9692
3044,健鼎,52,9,43,富邦-嘉義,2023-12-05,9692
2880,華南金,52,10,42,富邦-嘉義,2023-12-05,9692
2801,彰銀,41,0,41,富邦-嘉義,2023-12-05,9692
3231,緯創,77,38,39,富邦-嘉義,2023-12-05,9692
00933B,國泰10Y+金融債,49,11,38,富邦-嘉義,2023-12-05,9692
4909,新復興,72,36,36,富邦-嘉義,2023-12-05,9692
5381,合正,78,44,34,富邦-嘉義,2023-12-05,9692
2344,華邦電,54,20,34,富邦-嘉義,2023-12-05,9692
0056,元大高股息,42,8,34,富邦-嘉義,2023-12-05,9692
2367,燿華,1181,199,982,富邦-嘉義,2023-12-06,9692
00919,群益台灣精選高息,417,25,392,富邦-嘉義,2023-12-06,9692
00937B,群益ESG投等債20,549,168,381,富邦-嘉義,2023-12-06,9692
1618,合機,570,205,365,富邦-嘉義,2023-12-06,9692
2417,圓剛,236,25,211,富邦-嘉義,2023-12-06,9692
00688L,國泰20年美債正2,220,20,200,富邦-嘉義,2023-12-06,9692
00933B,國泰10Y+金融債,188,11,177,富邦-嘉義,2023-12-06,9692
6243,迅杰,370,219,151,富邦-嘉義,2023-12-06,9692
3041,揚智,1049,915,134,富邦-嘉義,2023-12-06,9692
2017,官田鋼,135,2,133,富邦-嘉義,2023-12-06,9692
6237,驊訊,329,212,117,富邦-嘉義,2023-12-06,9692
2323,中環,110,1,109,富邦-嘉義,2023-12-06,9692
2388,威盛,210,106,104,富邦-嘉義,2023-12-06,9692
00680L,元大美債20正2,116,14,102,富邦-嘉義,2023-12-06,9692
00715L,期街口布蘭特正2,101,5,96,富邦-嘉義,2023-12-06,9692
2542,興富發,101,7,94,富邦-嘉義,2023-12-06,9692
2516,新建,85,1,84,富邦-嘉義,2023-12-06,9692
6233,旺玖,233,159,74,富邦-嘉義,2023-12-06,9692
3481,群創,132,63,69,富邦-嘉義,2023-12-06,9692
6684,安格,149,80,69,富邦-嘉義,2023-12-06,9692
00665L,富邦�琤肭磪囓�2,88,20,68,富邦-嘉義,2023-12-06,9692
00712,復華富時不動產,79,15,64,富邦-嘉義,2023-12-06,9692
00687B,國泰20年美債,68,5,63,富邦-嘉義,2023-12-06,9692
2303,聯電,68,7,61,富邦-嘉義,2023-12-06,9692
00751B,元大AAA至A公司債,58,0,58,富邦-嘉義,2023-12-06,9692
2409,友達,76,19,57,富邦-嘉義,2023-12-06,9692
2313,華通,354,298,56,富邦-嘉義,2023-12-06,9692
2485,兆赫,57,4,53,富邦-嘉義,2023-12-06,9692
4561,健椿,63,10,53,富邦-嘉義,2023-12-06,9692
4909,新復興,61,12,49,富邦-嘉義,2023-12-06,9692
2883,凱基金,50,3,47,富邦-嘉義,2023-12-06,9692
1319,東陽,110,66,44,富邦-嘉義,2023-12-06,9692
00918,大華優利高填息30,43,0,43,富邦-嘉義,2023-12-06,9692
00929,復華台灣科技優息,82,44,38,富邦-嘉義,2023-12-06,9692
2867,三商壽,40,2,38,富邦-嘉義,2023-12-06,9692
00753L,中信中國50正2,38,0,38,富邦-嘉義,2023-12-06,9692
00637L,元大滬深300正2,91,55,36,富邦-嘉義,2023-12-06,9692
6125,廣運,49,14,35,富邦-嘉義,2023-12-06,9692
2489,瑞軒,35,1,34,富邦-嘉義,2023-12-06,9692
6806,森崴能源,46,13,33,富邦-嘉義,2023-12-06,9692
2851,中再保,33,0,33,富邦-嘉義,2023-12-06,9692
2355,敬鵬,1195,1162,33,富邦-嘉義,2023-12-06,9692
00772B,中信高評級公司債,37,5,32,富邦-嘉義,2023-12-06,9692
1312,國喬,31,0,31,富邦-嘉義,2023-12-06,9692
3437,榮創,32,1,31,富邦-嘉義,2023-12-06,9692
3217,優群,32,1,31,富邦-嘉義,2023-12-06,9692
3443,創意,84,53,31,富邦-嘉義,2023-12-06,9692
3715,定穎投控,336,306,30,富邦-嘉義,2023-12-06,9692
8054,安國,255,225,30,富邦-嘉義,2023-12-06,9692
2888,新光金,27,0,27,富邦-嘉義,2023-12-06,9692
3231,緯創,1073,408,665,富邦-嘉義,2023-12-07,9692
00937B,群益ESG投等債20,726,225,501,富邦-嘉義,2023-12-07,9692
00715L,期街口布蘭特正2,396,0,396,富邦-嘉義,2023-12-07,9692
00919,群益台灣精選高息,379,6,373,富邦-嘉義,2023-12-07,9692
2313,華通,434,135,299,富邦-嘉義,2023-12-07,9692
1524,耿鼎,427,222,205,富邦-嘉義,2023-12-07,9692
00882,中信中國高股息,161,2,159,富邦-嘉義,2023-12-07,9692
00933B,國泰10Y+金融債,246,88,158,富邦-嘉義,2023-12-07,9692
8034,榮群,547,393,154,富邦-嘉義,2023-12-07,9692
2314,台揚,170,38,132,富邦-嘉義,2023-12-07,9692
00929,復華台灣科技優息,175,50,125,富邦-嘉義,2023-12-07,9692
00680L,元大美債20正2,129,7,122,富邦-嘉義,2023-12-07,9692
00918,大華優利高填息30,121,0,121,富邦-嘉義,2023-12-07,9692
3035,智原,116,12,104,富邦-嘉義,2023-12-07,9692
00687B,國泰20年美債,127,24,103,富邦-嘉義,2023-12-07,9692
00679B,元大美債20年,156,54,102,富邦-嘉義,2023-12-07,9692
3715,定穎投控,288,224,64,富邦-嘉義,2023-12-07,9692
6126,信音,65,2,63,富邦-嘉義,2023-12-07,9692
2537,聯上發,63,0,63,富邦-嘉義,2023-12-07,9692
00931B,統一美債20年,80,22,58,富邦-嘉義,2023-12-07,9692
2801,彰銀,52,0,52,富邦-嘉義,2023-12-07,9692
00935,野村臺灣新科技50,47,0,47,富邦-嘉義,2023-12-07,9692
1616,億泰,75,29,46,富邦-嘉義,2023-12-07,9692
2637,慧洋-KY,50,5,45,富邦-嘉義,2023-12-07,9692
2501,國建,44,0,44,富邦-嘉義,2023-12-07,9692
6274,台燿,59,17,42,富邦-嘉義,2023-12-07,9692
2399,映泰,80,38,42,富邦-嘉義,2023-12-07,9692
2883,凱基金,64,24,40,富邦-嘉義,2023-12-07,9692
1612,宏泰,42,3,39,富邦-嘉義,2023-12-07,9692
2605,新興,150,111,39,富邦-嘉義,2023-12-07,9692
1605,華新,68,30,38,富邦-嘉義,2023-12-07,9692
2881,富邦金,40,2,38,富邦-嘉義,2023-12-07,9692
2516,新建,50,12,38,富邦-嘉義,2023-12-07,9692
4967,十銓,51,13,38,富邦-嘉義,2023-12-07,9692
2344,華邦電,42,5,37,富邦-嘉義,2023-12-07,9692
00632R,元大台灣50反1,43,6,37,富邦-嘉義,2023-12-07,9692
00753L,中信中國50正2,32,0,32,富邦-嘉義,2023-12-07,9692
6547,高端疫苗,47,15,32,富邦-嘉義,2023-12-07,9692
1319,東陽,110,78,32,富邦-嘉義,2023-12-07,9692
3390,旭軟,189,158,31,富邦-嘉義,2023-12-07,9692
2486,一詮,31,1,30,富邦-嘉義,2023-12-07,9692
2515,中工,31,1,30,富邦-嘉義,2023-12-07,9692
2359,所羅門,38,8,30,富邦-嘉義,2023-12-07,9692
2705,六福,30,0,30,富邦-嘉義,2023-12-07,9692
00795B,中信美國公債20年,31,1,30,富邦-嘉義,2023-12-07,9692
4744,皇將,121,91,30,富邦-嘉義,2023-12-07,9692
00728,第一金工業30,50,21,29,富邦-嘉義,2023-12-07,9692
3481,群創,68,40,28,富邦-嘉義,2023-12-07,9692
2882,國泰金,26,0,26,富邦-嘉義,2023-12-07,9692
5608,四維航,49,23,26,富邦-嘉義,2023-12-07,9692
00642U,期元大S＆P石油,602,0,602,富邦-嘉義,2023-12-08,9692
00632R,元大台灣50反1,541,0,541,富邦-嘉義,2023-12-08,9692
00720B,元大投資級公司債,315,3,312,富邦-嘉義,2023-12-08,9692
00919,群益台灣精選高息,325,20,305,富邦-嘉義,2023-12-08,9692
00712,復華富時不動產,260,13,247,富邦-嘉義,2023-12-08,9692
8096,擎亞,866,627,239,富邦-嘉義,2023-12-08,9692
3049,精金,180,0,180,富邦-嘉義,2023-12-08,9692
2367,燿華,184,22,162,富邦-嘉義,2023-12-08,9692
00687B,國泰20年美債,160,2,158,富邦-嘉義,2023-12-08,9692
2852,第一保,141,0,141,富邦-嘉義,2023-12-08,9692
00706L,期元大S＆P日圓正2,124,1,123,富邦-嘉義,2023-12-08,9692
1524,耿鼎,1158,1036,122,富邦-嘉義,2023-12-08,9692
1609,大亞,140,23,117,富邦-嘉義,2023-12-08,9692
00715L,期街口布蘭特正2,141,28,113,富邦-嘉義,2023-12-08,9692
5351,鈺創,592,492,100,富邦-嘉義,2023-12-08,9692
6462,神盾,409,312,97,富邦-嘉義,2023-12-08,9692
00882,中信中國高股息,95,1,94,富邦-嘉義,2023-12-08,9692
2603,長榮,102,20,82,富邦-嘉義,2023-12-08,9692
00931B,統一美債20年,86,5,81,富邦-嘉義,2023-12-08,9692
00679B,元大美債20年,95,16,79,富邦-嘉義,2023-12-08,9692
00680L,元大美債20正2,71,0,71,富邦-嘉義,2023-12-08,9692
6684,安格,237,168,69,富邦-嘉義,2023-12-08,9692
3078,僑威,241,178,63,富邦-嘉義,2023-12-08,9692
4979,華星光,562,505,57,富邦-嘉義,2023-12-08,9692
2375,凱美,62,6,56,富邦-嘉義,2023-12-08,9692
3443,創意,72,18,54,富邦-嘉義,2023-12-08,9692
00637L,元大滬深300正2,51,0,51,富邦-嘉義,2023-12-08,9692
3268,海德威,102,51,51,富邦-嘉義,2023-12-08,9692
1217,愛之味,50,0,50,富邦-嘉義,2023-12-08,9692
4148,全宇生技-KY,59,10,49,富邦-嘉義,2023-12-08,9692
00937B,群益ESG投等債20,204,156,48,富邦-嘉義,2023-12-08,9692
2313,華通,246,199,47,富邦-嘉義,2023-12-08,9692
4806,桂田文創,45,0,45,富邦-嘉義,2023-12-08,9692
6139,亞翔,65,21,44,富邦-嘉義,2023-12-08,9692
2605,新興,277,236,41,富邦-嘉義,2023-12-08,9692
6799,來頡,42,1,41,富邦-嘉義,2023-12-08,9692
00918,大華優利高填息30,39,0,39,富邦-嘉義,2023-12-08,9692
3234,光環,74,36,38,富邦-嘉義,2023-12-08,9692
5381,合正,45,9,36,富邦-嘉義,2023-12-08,9692
2501,國建,35,0,35,富邦-嘉義,2023-12-08,9692
4908,前鼎,59,25,34,富邦-嘉義,2023-12-08,9692
1514,亞力,1179,1146,33,富邦-嘉義,2023-12-08,9692
1313,聯成,31,0,31,富邦-嘉義,2023-12-08,9692
2538,基泰,30,0,30,富邦-嘉義,2023-12-08,9692
1440,南紡,30,0,30,富邦-嘉義,2023-12-08,9692
5432,新門,30,1,29,富邦-嘉義,2023-12-08,9692
3501,維熹,31,2,29,富邦-嘉義,2023-12-08,9692
2867,三商壽,46,20,26,富邦-嘉義,2023-12-08,9692
3607,谷崧,26,0,26,富邦-嘉義,2023-12-08,9692
6719,力智,30,4,26,富邦-嘉義,2023-12-08,9692
3049,精金,684,1,683,富邦-嘉義,2023-12-11,9692
4908,前鼎,2186,1608,578,富邦-嘉義,2023-12-11,9692
00919,群益台灣精選高息,510,71,439,富邦-嘉義,2023-12-11,9692
8112,至上,1386,998,388,富邦-嘉義,2023-12-11,9692
4967,十銓,218,27,191,富邦-嘉義,2023-12-11,9692
00918,大華優利高填息30,176,0,176,富邦-嘉義,2023-12-11,9692
2888,新光金,191,16,175,富邦-嘉義,2023-12-11,9692
8936,國統,171,7,164,富邦-嘉義,2023-12-11,9692
00929,復華台灣科技優息,221,63,158,富邦-嘉義,2023-12-11,9692
00882,中信中國高股息,156,0,156,富邦-嘉義,2023-12-11,9692
3051,力特,147,10,137,富邦-嘉義,2023-12-11,9692
2516,新建,177,47,130,富邦-嘉義,2023-12-11,9692
00687B,國泰20年美債,156,35,121,富邦-嘉義,2023-12-11,9692
2409,友達,127,10,117,富邦-嘉義,2023-12-11,9692
3078,僑威,196,82,114,富邦-嘉義,2023-12-11,9692
3694,海華,120,10,110,富邦-嘉義,2023-12-11,9692
3287,廣寰科,108,5,103,富邦-嘉義,2023-12-11,9692
3499,環天科,109,6,103,富邦-嘉義,2023-12-11,9692
3266,昇陽,112,10,102,富邦-嘉義,2023-12-11,9692
8096,擎亞,953,854,99,富邦-嘉義,2023-12-11,9692
8034,榮群,105,13,92,富邦-嘉義,2023-12-11,9692
2367,燿華,94,13,81,富邦-嘉義,2023-12-11,9692
00715L,期街口布蘭特正2,150,70,80,富邦-嘉義,2023-12-11,9692
2618,長榮航,168,96,72,富邦-嘉義,2023-12-11,9692
2504,國產,70,0,70,富邦-嘉義,2023-12-11,9692
00878,國泰永續高股息,85,19,66,富邦-嘉義,2023-12-11,9692
2605,新興,123,63,60,富邦-嘉義,2023-12-11,9692
5523,豐謙,49,0,49,富邦-嘉義,2023-12-11,9692
1616,億泰,50,3,47,富邦-嘉義,2023-12-11,9692
4142,國光生,46,0,46,富邦-嘉義,2023-12-11,9692
3607,谷崧,55,11,44,富邦-嘉義,2023-12-11,9692
2002,中鋼,60,17,43,富邦-嘉義,2023-12-11,9692
6530,創威,329,286,43,富邦-嘉義,2023-12-11,9692
2501,國建,42,0,42,富邦-嘉義,2023-12-11,9692
2388,威盛,1254,1214,40,富邦-嘉義,2023-12-11,9692
00671R,富邦NASDAQ反1,43,4,39,富邦-嘉義,2023-12-11,9692
00937B,群益ESG投等債20,207,170,37,富邦-嘉義,2023-12-11,9692
3260,威剛,55,18,37,富邦-嘉義,2023-12-11,9692
3346,麗清,37,1,36,富邦-嘉義,2023-12-11,9692
1314,中石化,38,4,34,富邦-嘉義,2023-12-11,9692
1504,東元,33,0,33,富邦-嘉義,2023-12-11,9692
5515,建國,32,0,32,富邦-嘉義,2023-12-11,9692
00637L,元大滬深300正2,43,12,31,富邦-嘉義,2023-12-11,9692
4806,桂田文創,30,0,30,富邦-嘉義,2023-12-11,9692
3041,揚智,52,23,29,富邦-嘉義,2023-12-11,9692
1515,力山,144,116,28,富邦-嘉義,2023-12-11,9692
1513,中興電,41,14,27,富邦-嘉義,2023-12-11,9692
00934,中信成長高股息,26,1,25,富邦-嘉義,2023-12-11,9692
2376,技嘉,46,22,24,富邦-嘉義,2023-12-11,9692
2356,英業達,65,43,22,富邦-嘉義,2023-12-11,9692
2367,燿華,439,29,410,富邦-嘉義,2023-12-12,9692
2392,正崴,600,260,340,富邦-嘉義,2023-12-12,9692
3035,智原,388,87,301,富邦-嘉義,2023-12-12,9692
5521,工信,919,649,270,富邦-嘉義,2023-12-12,9692
00673R,期元大S＆P原油反1,230,0,230,富邦-嘉義,2023-12-12,9692
00919,群益台灣精選高息,257,50,207,富邦-嘉義,2023-12-12,9692
4933,友輝,274,75,199,富邦-嘉義,2023-12-12,9692
2516,新建,205,7,198,富邦-嘉義,2023-12-12,9692
9105,泰金寶-DR,175,0,175,富邦-嘉義,2023-12-12,9692
2419,仲琦,252,79,173,富邦-嘉義,2023-12-12,9692
00712,復華富時不動產,120,4,116,富邦-嘉義,2023-12-12,9692
3545,敦泰,103,0,103,富邦-嘉義,2023-12-12,9692
2323,中環,99,1,98,富邦-嘉義,2023-12-12,9692
3266,昇陽,100,3,97,富邦-嘉義,2023-12-12,9692
00937B,群益ESG投等債20,123,26,97,富邦-嘉義,2023-12-12,9692
3380,明泰,169,73,96,富邦-嘉義,2023-12-12,9692
00687B,國泰20年美債,89,1,88,富邦-嘉義,2023-12-12,9692
5426,振發,130,42,88,富邦-嘉義,2023-12-12,9692
00934,中信成長高股息,78,0,78,富邦-嘉義,2023-12-12,9692
2409,友達,152,79,73,富邦-嘉義,2023-12-12,9692
6517,保勝光學,83,14,69,富邦-嘉義,2023-12-12,9692
00918,大華優利高填息30,67,0,67,富邦-嘉義,2023-12-12,9692
4976,佳凌,322,256,66,富邦-嘉義,2023-12-12,9692
2618,長榮航,101,37,64,富邦-嘉義,2023-12-12,9692
5523,豐謙,60,2,58,富邦-嘉義,2023-12-12,9692
3715,定穎投控,216,159,57,富邦-嘉義,2023-12-12,9692
3086,華義,56,0,56,富邦-嘉義,2023-12-12,9692
3362,先進光,84,28,56,富邦-嘉義,2023-12-12,9692
2376,技嘉,76,22,54,富邦-嘉義,2023-12-12,9692
00679B,元大美債20年,73,21,52,富邦-嘉義,2023-12-12,9692
00900,富邦特選高股息30,66,14,52,富邦-嘉義,2023-12-12,9692
8034,榮群,78,28,50,富邦-嘉義,2023-12-12,9692
3622,洋華,341,293,48,富邦-嘉義,2023-12-12,9692
2913,農林,47,0,47,富邦-嘉義,2023-12-12,9692
4148,全宇生技-KY,51,6,45,富邦-嘉義,2023-12-12,9692
2363,矽統,137,94,43,富邦-嘉義,2023-12-12,9692
3694,海華,51,10,41,富邦-嘉義,2023-12-12,9692
00720B,元大投資級公司債,41,6,35,富邦-嘉義,2023-12-12,9692
2705,六福,34,0,34,富邦-嘉義,2023-12-12,9692
4915,致伸,34,0,34,富邦-嘉義,2023-12-12,9692
00715L,期街口布蘭特正2,41,10,31,富邦-嘉義,2023-12-12,9692
2355,敬鵬,76,45,31,富邦-嘉義,2023-12-12,9692
6187,萬潤,33,2,31,富邦-嘉義,2023-12-12,9692
2353,宏��,65,34,31,富邦-嘉義,2023-12-12,9692
2344,華邦電,42,13,29,富邦-嘉義,2023-12-12,9692
3576,聯合再生,29,0,29,富邦-嘉義,2023-12-12,9692
2002,中鋼,64,37,27,富邦-嘉義,2023-12-12,9692
3033,威健,31,4,27,富邦-嘉義,2023-12-12,9692
4961,天鈺,25,0,25,富邦-嘉義,2023-12-12,9692
2023,燁輝,25,0,25,富邦-嘉義,2023-12-12,9692
2363,矽統,2123,89,2034,富邦-嘉義,2023-12-13,9692
2367,燿華,730,10,720,富邦-嘉義,2023-12-13,9692
2356,英業達,752,106,646,富邦-嘉義,2023-12-13,9692
2515,中工,1927,1420,507,富邦-嘉義,2023-12-13,9692
1524,耿鼎,465,105,360,富邦-嘉義,2023-12-13,9692
00715L,期街口布蘭特正2,385,87,298,富邦-嘉義,2023-12-13,9692
00919,群益台灣精選高息,441,146,295,富邦-嘉義,2023-12-13,9692
2329,華泰,255,23,232,富邦-嘉義,2023-12-13,9692
6292,迅德,233,24,209,富邦-嘉義,2023-12-13,9692
00720B,元大投資級公司債,311,104,207,富邦-嘉義,2023-12-13,9692
2365,昆盈,526,320,206,富邦-嘉義,2023-12-13,9692
3390,旭軟,323,150,173,富邦-嘉義,2023-12-13,9692
5521,工信,1498,1330,168,富邦-嘉義,2023-12-13,9692
00637L,元大滬深300正2,167,0,167,富邦-嘉義,2023-12-13,9692
3712,永崴投控,143,6,137,富邦-嘉義,2023-12-13,9692
2465,麗臺,151,15,136,富邦-嘉義,2023-12-13,9692
2002,中鋼,165,35,130,富邦-嘉義,2023-12-13,9692
00679B,元大美債20年,101,1,100,富邦-嘉義,2023-12-13,9692
00665L,富邦�琤肭磪囓�2,142,50,92,富邦-嘉義,2023-12-13,9692
2634,漢翔,96,6,90,富邦-嘉義,2023-12-13,9692
2516,新建,112,23,89,富邦-嘉義,2023-12-13,9692
3437,榮創,116,34,82,富邦-嘉義,2023-12-13,9692
2601,益航,81,5,76,富邦-嘉義,2023-12-13,9692
3706,神達,807,738,69,富邦-嘉義,2023-12-13,9692
8034,榮群,80,16,64,富邦-嘉義,2023-12-13,9692
3380,明泰,131,70,61,富邦-嘉義,2023-12-13,9692
1521,大億,129,69,60,富邦-嘉義,2023-12-13,9692
2882,國泰金,54,0,54,富邦-嘉義,2023-12-13,9692
8150,南茂,57,5,52,富邦-嘉義,2023-12-13,9692
2605,新興,69,18,51,富邦-嘉義,2023-12-13,9692
3443,創意,53,2,51,富邦-嘉義,2023-12-13,9692
2618,長榮航,66,16,50,富邦-嘉義,2023-12-13,9692
8054,安國,100,52,48,富邦-嘉義,2023-12-13,9692
00937B,群益ESG投等債20,73,26,47,富邦-嘉義,2023-12-13,9692
2610,華航,82,35,47,富邦-嘉義,2023-12-13,9692
00680L,元大美債20正2,58,13,45,富邦-嘉義,2023-12-13,9692
00929,復華台灣科技優息,171,128,43,富邦-嘉義,2023-12-13,9692
00642U,期元大S＆P石油,42,0,42,富邦-嘉義,2023-12-13,9692
5432,新門,42,1,41,富邦-嘉義,2023-12-13,9692
2890,永豐金,45,6,39,富邦-嘉義,2023-12-13,9692
1514,亞力,161,122,39,富邦-嘉義,2023-12-13,9692
6282,康舒,70,31,39,富邦-嘉義,2023-12-13,9692
2641,正德,135,98,37,富邦-嘉義,2023-12-13,9692
5324,士開,41,4,37,富邦-嘉義,2023-12-13,9692
5523,豐謙,39,6,33,富邦-嘉義,2023-12-13,9692
00882,中信中國高股息,67,34,33,富邦-嘉義,2023-12-13,9692
00934,中信成長高股息,32,0,32,富邦-嘉義,2023-12-13,9692
8299,群聯,31,0,31,富邦-嘉義,2023-12-13,9692
2897,王道銀行,31,0,31,富邦-嘉義,2023-12-13,9692
2615,萬海,38,7,31,富邦-嘉義,2023-12-13,9692
2883,凱基金,376,71,305,富邦-嘉義,2023-12-14,9692
8096,擎亞,264,56,208,富邦-嘉義,2023-12-14,9692
2356,英業達,315,137,178,富邦-嘉義,2023-12-14,9692
00919,群益台灣精選高息,420,265,155,富邦-嘉義,2023-12-14,9692
00687B,國泰20年美債,141,8,133,富邦-嘉義,2023-12-14,9692
6127,九豪,338,214,124,富邦-嘉義,2023-12-14,9692
00688L,國泰20年美債正2,131,10,121,富邦-嘉義,2023-12-14,9692
2367,燿華,827,714,113,富邦-嘉義,2023-12-14,9692
2516,新建,128,15,113,富邦-嘉義,2023-12-14,9692
3481,群創,124,13,111,富邦-嘉義,2023-12-14,9692
00934,中信成長高股息,138,28,110,富邦-嘉義,2023-12-14,9692
2408,南亞科,181,79,102,富邦-嘉義,2023-12-14,9692
6239,力成,250,151,99,富邦-嘉義,2023-12-14,9692
8112,至上,112,19,93,富邦-嘉義,2023-12-14,9692
6233,旺玖,117,25,92,富邦-嘉義,2023-12-14,9692
00679B,元大美債20年,140,52,88,富邦-嘉義,2023-12-14,9692
00751B,元大AAA至A公司債,105,17,88,富邦-嘉義,2023-12-14,9692
3287,廣寰科,164,83,81,富邦-嘉義,2023-12-14,9692
00933B,國泰10Y+金融債,106,31,75,富邦-嘉義,2023-12-14,9692
3005,神基,373,303,70,富邦-嘉義,2023-12-14,9692
00680L,元大美債20正2,114,47,67,富邦-嘉義,2023-12-14,9692
2601,益航,62,1,61,富邦-嘉義,2023-12-14,9692
00637L,元大滬深300正2,60,0,60,富邦-嘉義,2023-12-14,9692
6204,艾華,197,142,55,富邦-嘉義,2023-12-14,9692
2387,精元,83,33,50,富邦-嘉義,2023-12-14,9692
00885,富邦越南,62,12,50,富邦-嘉義,2023-12-14,9692
3049,精金,51,1,50,富邦-嘉義,2023-12-14,9692
3265,台星科,267,217,50,富邦-嘉義,2023-12-14,9692
8034,榮群,105,57,48,富邦-嘉義,2023-12-14,9692
5523,豐謙,46,1,45,富邦-嘉義,2023-12-14,9692
2405,輔信,125,81,44,富邦-嘉義,2023-12-14,9692
6117,迎廣,56,14,42,富邦-嘉義,2023-12-14,9692
2449,京元電子,567,525,42,富邦-嘉義,2023-12-14,9692
00905,FT臺灣Smart,40,1,39,富邦-嘉義,2023-12-14,9692
2376,技嘉,426,388,38,富邦-嘉義,2023-12-14,9692
3078,僑威,38,3,35,富邦-嘉義,2023-12-14,9692
1101,台泥,55,23,32,富邦-嘉義,2023-12-14,9692
00918,大華優利高填息30,54,22,32,富邦-嘉義,2023-12-14,9692
3706,神達,215,184,31,富邦-嘉義,2023-12-14,9692
2836,高雄銀,31,0,31,富邦-嘉義,2023-12-14,9692
3437,榮創,172,141,31,富邦-嘉義,2023-12-14,9692
00772B,中信高評級公司債,27,0,27,富邦-嘉義,2023-12-14,9692
4148,全宇生技-KY,26,0,26,富邦-嘉義,2023-12-14,9692
2606,裕民,26,1,25,富邦-嘉義,2023-12-14,9692
1513,中興電,43,18,25,富邦-嘉義,2023-12-14,9692
6182,合晶,27,2,25,富邦-嘉義,2023-12-14,9692
6147,頎邦,60,35,25,富邦-嘉義,2023-12-14,9692
2419,仲琦,65,41,24,富邦-嘉義,2023-12-14,9692
5314,世紀,28,4,24,富邦-嘉義,2023-12-14,9692
1609,大亞,25,2,23,富邦-嘉義,2023-12-14,9692
2367,燿華,910,14,896,富邦-嘉義,2023-12-15,9692
00687B,國泰20年美債,323,10,313,富邦-嘉義,2023-12-15,9692
00688L,國泰20年美債正2,176,0,176,富邦-嘉義,2023-12-15,9692
00679B,元大美債20年,172,9,163,富邦-嘉義,2023-12-15,9692
00919,群益台灣精選高息,534,394,140,富邦-嘉義,2023-12-15,9692
00937B,群益ESG投等債20,187,69,118,富邦-嘉義,2023-12-15,9692
6168,宏齊,186,74,112,富邦-嘉義,2023-12-15,9692
00706L,期元大S＆P日圓正2,106,2,104,富邦-嘉義,2023-12-15,9692
2344,華邦電,544,446,98,富邦-嘉義,2023-12-15,9692
00720B,元大投資級公司債,310,229,81,富邦-嘉義,2023-12-15,9692
2022,聚亨,110,30,80,富邦-嘉義,2023-12-15,9692
00905,FT臺灣Smart,80,0,80,富邦-嘉義,2023-12-15,9692
2363,矽統,4800,4722,78,富邦-嘉義,2023-12-15,9692
2634,漢翔,91,14,77,富邦-嘉義,2023-12-15,9692
00712,復華富時不動產,129,55,74,富邦-嘉義,2023-12-15,9692
2028,威致,73,2,71,富邦-嘉義,2023-12-15,9692
4973,廣穎,61,5,56,富邦-嘉義,2023-12-15,9692
2881,富邦金,92,38,54,富邦-嘉義,2023-12-15,9692
3260,威剛,74,22,52,富邦-嘉義,2023-12-15,9692
2516,新建,64,13,51,富邦-嘉義,2023-12-15,9692
2064,晉椿,50,0,50,富邦-嘉義,2023-12-15,9692
3380,明泰,50,0,50,富邦-嘉義,2023-12-15,9692
00933B,國泰10Y+金融債,47,1,46,富邦-嘉義,2023-12-15,9692
00934,中信成長高股息,47,2,45,富邦-嘉義,2023-12-15,9692
3078,僑威,48,3,45,富邦-嘉義,2023-12-15,9692
00918,大華優利高填息30,89,46,43,富邦-嘉義,2023-12-15,9692
2313,華通,85,43,42,富邦-嘉義,2023-12-15,9692
5515,建國,56,16,40,富邦-嘉義,2023-12-15,9692
00931B,統一美債20年,39,0,39,富邦-嘉義,2023-12-15,9692
2368,金像電,48,10,38,富邦-嘉義,2023-12-15,9692
5521,工信,71,33,38,富邦-嘉義,2023-12-15,9692
2481,強茂,161,124,37,富邦-嘉義,2023-12-15,9692
6136,富爾特,37,1,36,富邦-嘉義,2023-12-15,9692
3231,緯創,54,19,35,富邦-嘉義,2023-12-15,9692
00673R,期元大S＆P原油反1,35,0,35,富邦-嘉義,2023-12-15,9692
00915,凱基優選高股息30,35,0,35,富邦-嘉義,2023-12-15,9692
2425,承啟,66,32,34,富邦-嘉義,2023-12-15,9692
1519,華城,292,259,33,富邦-嘉義,2023-12-15,9692
8201,無敵,39,10,29,富邦-嘉義,2023-12-15,9692
00773B,中信優先金融債,28,0,28,富邦-嘉義,2023-12-15,9692
00891,中信關鍵半導體,40,13,27,富邦-嘉義,2023-12-15,9692
5302,太欣,27,0,27,富邦-嘉義,2023-12-15,9692
2801,彰銀,26,0,26,富邦-嘉義,2023-12-15,9692
2009,第一銅,194,168,26,富邦-嘉義,2023-12-15,9692
2025,千興,25,0,25,富邦-嘉義,2023-12-15,9692
8050,廣積,26,1,25,富邦-嘉義,2023-12-15,9692
00885,富邦越南,27,3,24,富邦-嘉義,2023-12-15,9692
2387,精元,37,13,24,富邦-嘉義,2023-12-15,9692
2402,毅嘉,49,25,24,富邦-嘉義,2023-12-15,9692
3086,華義,41,18,23,富邦-嘉義,2023-12-15,9692
2609,陽明,6707,4736,1971,富邦-嘉義,2023-12-18,9692
3231,緯創,1050,41,1009,富邦-嘉義,2023-12-18,9692
2382,廣達,711,129,582,富邦-嘉義,2023-12-18,9692
2038,海光,578,137,441,富邦-嘉義,2023-12-18,9692
2367,燿華,374,19,355,富邦-嘉義,2023-12-18,9692
00919,群益台灣精選高息,409,108,301,富邦-嘉義,2023-12-18,9692
2801,彰銀,274,0,274,富邦-嘉義,2023-12-18,9692
00673R,期元大S＆P原油反1,250,0,250,富邦-嘉義,2023-12-18,9692
1325,恆大,245,67,178,富邦-嘉義,2023-12-18,9692
1519,華城,158,7,151,富邦-嘉義,2023-12-18,9692
00665L,富邦�琤肭磪囓�2,150,0,150,富邦-嘉義,2023-12-18,9692
2014,中鴻,760,630,130,富邦-嘉義,2023-12-18,9692
2007,燁興,106,4,102,富邦-嘉義,2023-12-18,9692
00931B,統一美債20年,102,3,99,富邦-嘉義,2023-12-18,9692
5521,工信,300,203,97,富邦-嘉義,2023-12-18,9692
00688L,國泰20年美債正2,99,9,90,富邦-嘉義,2023-12-18,9692
2606,裕民,122,33,89,富邦-嘉義,2023-12-18,9692
00687B,國泰20年美債,92,5,87,富邦-嘉義,2023-12-18,9692
00679B,元大美債20年,94,8,86,富邦-嘉義,2023-12-18,9692
2032,新鋼,248,164,84,富邦-嘉義,2023-12-18,9692
00933B,國泰10Y+金融債,99,17,82,富邦-嘉義,2023-12-18,9692
00937B,群益ESG投等債20,265,184,81,富邦-嘉義,2023-12-18,9692
2618,長榮航,156,83,73,富邦-嘉義,2023-12-18,9692
9919,康那香,119,47,72,富邦-嘉義,2023-12-18,9692
9950,萬國通,74,4,70,富邦-嘉義,2023-12-18,9692
2027,大成鋼,110,52,58,富邦-嘉義,2023-12-18,9692
2409,友達,61,4,57,富邦-嘉義,2023-12-18,9692
2376,技嘉,65,10,55,富邦-嘉義,2023-12-18,9692
6874,倍力,51,0,51,富邦-嘉義,2023-12-18,9692
2615,萬海,1020,970,50,富邦-嘉義,2023-12-18,9692
00772B,中信高評級公司債,51,2,49,富邦-嘉義,2023-12-18,9692
3078,僑威,47,0,47,富邦-嘉義,2023-12-18,9692
5388,中磊,50,4,46,富邦-嘉義,2023-12-18,9692
2002,中鋼,613,570,43,富邦-嘉義,2023-12-18,9692
00918,大華優利高填息30,50,8,42,富邦-嘉義,2023-12-18,9692
6120,達運,42,0,42,富邦-嘉義,2023-12-18,9692
8085,福華,213,171,42,富邦-嘉義,2023-12-18,9692
6140,訊達,61,20,41,富邦-嘉義,2023-12-18,9692
2883,凱基金,46,5,41,富邦-嘉義,2023-12-18,9692
8112,至上,50,10,40,富邦-嘉義,2023-12-18,9692
5469,瀚宇博,44,5,39,富邦-嘉義,2023-12-18,9692
00929,復華台灣科技優息,263,224,39,富邦-嘉義,2023-12-18,9692
2357,華碩,84,46,38,富邦-嘉義,2023-12-18,9692
6191,精成科,43,5,38,富邦-嘉義,2023-12-18,9692
3481,群創,46,12,34,富邦-嘉義,2023-12-18,9692
2023,燁輝,252,219,33,富邦-嘉義,2023-12-18,9692
00712,復華富時不動產,43,12,31,富邦-嘉義,2023-12-18,9692
2809,京城銀,30,0,30,富邦-嘉義,2023-12-18,9692
2610,華航,42,13,29,富邦-嘉義,2023-12-18,9692
2486,一詮,33,4,29,富邦-嘉義,2023-12-18,9692
2376,技嘉,612,215,397,富邦-嘉義,2023-12-19,9692
00929,復華台灣科技優息,471,116,355,富邦-嘉義,2023-12-19,9692
3035,智原,367,63,304,富邦-嘉義,2023-12-19,9692
00720B,元大投資級公司債,304,8,296,富邦-嘉義,2023-12-19,9692
2367,燿華,223,10,213,富邦-嘉義,2023-12-19,9692
2883,凱基金,176,0,176,富邦-嘉義,2023-12-19,9692
2801,彰銀,140,0,140,富邦-嘉義,2023-12-19,9692
4167,松瑞藥,591,464,127,富邦-嘉義,2023-12-19,9692
00937B,群益ESG投等債20,215,109,106,富邦-嘉義,2023-12-19,9692
2409,友達,107,11,96,富邦-嘉義,2023-12-19,9692
3373,熱映,96,0,96,富邦-嘉義,2023-12-19,9692
2329,華泰,106,11,95,富邦-嘉義,2023-12-19,9692
2515,中工,236,146,90,富邦-嘉義,2023-12-19,9692
2316,楠梓電,84,0,84,富邦-嘉義,2023-12-19,9692
1616,億泰,84,3,81,富邦-嘉義,2023-12-19,9692
5521,工信,361,286,75,富邦-嘉義,2023-12-19,9692
2610,華航,78,5,73,富邦-嘉義,2023-12-19,9692
00708L,期元大S＆P黃金正2,73,0,73,富邦-嘉義,2023-12-19,9692
6191,精成科,69,0,69,富邦-嘉義,2023-12-19,9692
2888,新光金,106,38,68,富邦-嘉義,2023-12-19,9692
2324,仁寶,96,35,61,富邦-嘉義,2023-12-19,9692
2356,英業達,110,53,57,富邦-嘉義,2023-12-19,9692
00688L,國泰20年美債正2,181,124,57,富邦-嘉義,2023-12-19,9692
00933B,國泰10Y+金融債,63,10,53,富邦-嘉義,2023-12-19,9692
8112,至上,65,17,48,富邦-嘉義,2023-12-19,9692
6147,頎邦,47,2,45,富邦-嘉義,2023-12-19,9692
1815,富喬,50,6,44,富邦-嘉義,2023-12-19,9692
00687B,國泰20年美債,44,2,42,富邦-嘉義,2023-12-19,9692
2605,新興,50,8,42,富邦-嘉義,2023-12-19,9692
2352,佳世達,44,3,41,富邦-嘉義,2023-12-19,9692
3532,台勝科,44,4,40,富邦-嘉義,2023-12-19,9692
2486,一詮,39,0,39,富邦-嘉義,2023-12-19,9692
2641,正德,40,2,38,富邦-嘉義,2023-12-19,9692
2344,華邦電,71,33,38,富邦-嘉義,2023-12-19,9692
5347,世界,39,1,38,富邦-嘉義,2023-12-19,9692
00665L,富邦�琤肭磪囓�2,36,0,36,富邦-嘉義,2023-12-19,9692
2618,長榮航,162,127,35,富邦-嘉義,2023-12-19,9692
2630,亞航,35,0,35,富邦-嘉義,2023-12-19,9692
00934,中信成長高股息,39,4,35,富邦-嘉義,2023-12-19,9692
2323,中環,34,0,34,富邦-嘉義,2023-12-19,9692
2633,台灣高鐵,34,1,33,富邦-嘉義,2023-12-19,9692
1102,亞泥,33,1,32,富邦-嘉義,2023-12-19,9692
1582,信錦,35,3,32,富邦-嘉義,2023-12-19,9692
8054,安國,170,138,32,富邦-嘉義,2023-12-19,9692
00936,台新永續高息中小,31,0,31,富邦-嘉義,2023-12-19,9692
00680L,元大美債20正2,62,31,31,富邦-嘉義,2023-12-19,9692
9802,鈺齊-KY,30,0,30,富邦-嘉義,2023-12-19,9692
2106,建大,29,0,29,富邦-嘉義,2023-12-19,9692
2892,第一金,29,1,28,富邦-嘉義,2023-12-19,9692
5351,鈺創,40,12,28,富邦-嘉義,2023-12-19,9692
2382,廣達,782,302,480,富邦-嘉義,2023-12-20,9692
00720B,元大投資級公司債,207,0,207,富邦-嘉義,2023-12-20,9692
1732,毛寶,800,606,194,富邦-嘉義,2023-12-20,9692
2888,新光金,139,9,130,富邦-嘉義,2023-12-20,9692
2883,凱基金,111,0,111,富邦-嘉義,2023-12-20,9692
00688L,國泰20年美債正2,100,1,99,富邦-嘉義,2023-12-20,9692
00919,群益台灣精選高息,122,25,97,富邦-嘉義,2023-12-20,9692
00929,復華台灣科技優息,126,31,95,富邦-嘉義,2023-12-20,9692
2609,陽明,1119,1029,90,富邦-嘉義,2023-12-20,9692
00937B,群益ESG投等債20,97,21,76,富邦-嘉義,2023-12-20,9692
2801,彰銀,110,41,69,富邦-嘉義,2023-12-20,9692
00933B,國泰10Y+金融債,65,5,60,富邦-嘉義,2023-12-20,9692
00687B,國泰20年美債,51,3,48,富邦-嘉義,2023-12-20,9692
3576,聯合再生,48,3,45,富邦-嘉義,2023-12-20,9692
6244,茂迪,47,4,43,富邦-嘉義,2023-12-20,9692
00673R,期元大S＆P原油反1,42,0,42,富邦-嘉義,2023-12-20,9692
00857B,永豐20年美公債,41,0,41,富邦-嘉義,2023-12-20,9692
2547,日勝生,50,9,41,富邦-嘉義,2023-12-20,9692
2891,中信金,44,4,40,富邦-嘉義,2023-12-20,9692
2014,中鴻,271,235,36,富邦-嘉義,2023-12-20,9692
7402,邑錡,33,0,33,富邦-嘉義,2023-12-20,9692
8054,安國,98,65,33,富邦-嘉義,2023-12-20,9692
4904,遠傳,31,0,31,富邦-嘉義,2023-12-20,9692
2365,昆盈,136,105,31,富邦-嘉義,2023-12-20,9692
3086,華義,31,1,30,富邦-嘉義,2023-12-20,9692
3217,優群,32,4,28,富邦-嘉義,2023-12-20,9692
3694,海華,55,27,28,富邦-嘉義,2023-12-20,9692
5880,合庫金,33,5,28,富邦-嘉義,2023-12-20,9692
3006,晶豪科,36,8,28,富邦-嘉義,2023-12-20,9692
2880,華南金,27,1,26,富邦-嘉義,2023-12-20,9692
2009,第一銅,33,7,26,富邦-嘉義,2023-12-20,9692
6451,訊芯-KY,26,2,24,富邦-嘉義,2023-12-20,9692
1609,大亞,29,5,24,富邦-嘉義,2023-12-20,9692
9935,慶豐富,31,7,24,富邦-嘉義,2023-12-20,9692
3024,憶聲,23,0,23,富邦-嘉義,2023-12-20,9692
2537,聯上發,23,0,23,富邦-嘉義,2023-12-20,9692
2425,承啟,26,4,22,富邦-嘉義,2023-12-20,9692
3264,欣銓,22,1,21,富邦-嘉義,2023-12-20,9692
2501,國建,21,0,21,富邦-嘉義,2023-12-20,9692
2303,聯電,35,14,21,富邦-嘉義,2023-12-20,9692
1524,耿鼎,22,1,21,富邦-嘉義,2023-12-20,9692
2516,新建,82,61,21,富邦-嘉義,2023-12-20,9692
2027,大成鋼,53,32,21,富邦-嘉義,2023-12-20,9692
2881,富邦金,20,0,20,富邦-嘉義,2023-12-20,9692
6117,迎廣,21,1,20,富邦-嘉義,2023-12-20,9692
3260,威剛,24,4,20,富邦-嘉義,2023-12-20,9692
1815,富喬,30,11,19,富邦-嘉義,2023-12-20,9692
3715,定穎投控,31,13,18,富邦-嘉義,2023-12-20,9692
1905,華紙,36,18,18,富邦-嘉義,2023-12-20,9692
1213,大飲,17,0,17,富邦-嘉義,2023-12-20,9692
2515,中工,3878,2377,1501,富邦-嘉義,2023-12-21,9692
4979,華星光,441,24,417,富邦-嘉義,2023-12-21,9692
00919,群益台灣精選高息,325,96,229,富邦-嘉義,2023-12-21,9692
9105,泰金寶-DR,293,69,224,富邦-嘉義,2023-12-21,9692
6233,旺玖,188,18,170,富邦-嘉義,2023-12-21,9692
2367,燿華,159,6,153,富邦-嘉義,2023-12-21,9692
00929,復華台灣科技優息,208,79,129,富邦-嘉義,2023-12-21,9692
2615,萬海,487,376,111,富邦-嘉義,2023-12-21,9692
00878,國泰永續高股息,94,10,84,富邦-嘉義,2023-12-21,9692
2382,廣達,576,505,71,富邦-嘉義,2023-12-21,9692
2883,凱基金,70,0,70,富邦-嘉義,2023-12-21,9692
2801,彰銀,70,0,70,富邦-嘉義,2023-12-21,9692
2641,正德,106,38,68,富邦-嘉義,2023-12-21,9692
2516,新建,60,0,60,富邦-嘉義,2023-12-21,9692
00882,中信中國高股息,58,0,58,富邦-嘉義,2023-12-21,9692
2329,華泰,61,6,55,富邦-嘉義,2023-12-21,9692
2610,華航,68,14,54,富邦-嘉義,2023-12-21,9692
2303,聯電,60,8,52,富邦-嘉義,2023-12-21,9692
5469,瀚宇博,44,0,44,富邦-嘉義,2023-12-21,9692
5426,振發,252,209,43,富邦-嘉義,2023-12-21,9692
8112,至上,80,38,42,富邦-嘉義,2023-12-21,9692
3287,廣寰科,40,0,40,富邦-嘉義,2023-12-21,9692
3047,訊舟,40,0,40,富邦-嘉義,2023-12-21,9692
5210,寶碩,51,12,39,富邦-嘉義,2023-12-21,9692
8110,華東,76,37,39,富邦-嘉義,2023-12-21,9692
6285,啟��,40,2,38,富邦-嘉義,2023-12-21,9692
2387,精元,42,5,37,富邦-嘉義,2023-12-21,9692
1319,東陽,47,11,36,富邦-嘉義,2023-12-21,9692
2201,裕隆,31,0,31,富邦-嘉義,2023-12-21,9692
1313,聯成,30,1,29,富邦-嘉義,2023-12-21,9692
00937B,群益ESG投等債20,251,225,26,富邦-嘉義,2023-12-21,9692
2634,漢翔,256,231,25,富邦-嘉義,2023-12-21,9692
2547,日勝生,30,5,25,富邦-嘉義,2023-12-21,9692
2331,精英,35,11,24,富邦-嘉義,2023-12-21,9692
2330,台積電,25,1,24,富邦-嘉義,2023-12-21,9692
1722,台肥,23,0,23,富邦-嘉義,2023-12-21,9692
3322,建舜電,26,3,23,富邦-嘉義,2023-12-21,9692
00893,國泰智能電動車,33,10,23,富邦-嘉義,2023-12-21,9692
1609,大亞,32,9,23,富邦-嘉義,2023-12-21,9692
2886,兆豐金,21,0,21,富邦-嘉義,2023-12-21,9692
1504,東元,23,2,21,富邦-嘉義,2023-12-21,9692
5521,工信,204,183,21,富邦-嘉義,2023-12-21,9692
4303,信立,22,1,21,富邦-嘉義,2023-12-21,9692
1513,中興電,26,7,19,富邦-嘉義,2023-12-21,9692
2002,中鋼,24,5,19,富邦-嘉義,2023-12-21,9692
8046,南電,25,6,19,富邦-嘉義,2023-12-21,9692
00637L,元大滬深300正2,24,5,19,富邦-嘉義,2023-12-21,9692
2363,矽統,48,29,19,富邦-嘉義,2023-12-21,9692
5871,中租-KY,22,3,19,富邦-嘉義,2023-12-21,9692
2353,宏��,199,182,17,富邦-嘉義,2023-12-21,9692
2609,陽明,3110,2342,768,富邦-嘉義,2023-12-22,9692
2301,光寶科,818,59,759,富邦-嘉義,2023-12-22,9692
00632R,元大台灣50反1,228,7,221,富邦-嘉義,2023-12-22,9692
00937B,群益ESG投等債20,244,33,211,富邦-嘉義,2023-12-22,9692
00680L,元大美債20正2,160,13,147,富邦-嘉義,2023-12-22,9692
2324,仁寶,197,91,106,富邦-嘉義,2023-12-22,9692
00673R,期元大S＆P原油反1,95,0,95,富邦-嘉義,2023-12-22,9692
2329,華泰,150,61,89,富邦-嘉義,2023-12-22,9692
9950,萬國通,84,0,84,富邦-嘉義,2023-12-22,9692
8054,安國,350,275,75,富邦-嘉義,2023-12-22,9692
1313,聯成,70,0,70,富邦-嘉義,2023-12-22,9692
2883,凱基金,68,0,68,富邦-嘉義,2023-12-22,9692
00919,群益台灣精選高息,106,39,67,富邦-嘉義,2023-12-22,9692
00706L,期元大S＆P日圓正2,78,16,62,富邦-嘉義,2023-12-22,9692
00720B,元大投資級公司債,67,10,57,富邦-嘉義,2023-12-22,9692
00708L,期元大S＆P黃金正2,57,0,57,富邦-嘉義,2023-12-22,9692
1312,國喬,55,0,55,富邦-嘉義,2023-12-22,9692
2408,南亞科,189,135,54,富邦-嘉義,2023-12-22,9692
5009,榮剛,74,20,54,富邦-嘉義,2023-12-22,9692
2882,國泰金,51,0,51,富邦-嘉義,2023-12-22,9692
2344,華邦電,314,271,43,富邦-嘉義,2023-12-22,9692
4909,新復興,63,21,42,富邦-嘉義,2023-12-22,9692
2610,華航,3271,3231,40,富邦-嘉義,2023-12-22,9692
2516,新建,49,11,38,富邦-嘉義,2023-12-22,9692
4763,材料-KY,45,8,37,富邦-嘉義,2023-12-22,9692
00710B,復華彭博非投等債,36,0,36,富邦-嘉義,2023-12-22,9692
2356,英業達,140,104,36,富邦-嘉義,2023-12-22,9692
00882,中信中國高股息,47,12,35,富邦-嘉義,2023-12-22,9692
2312,金寶,38,4,34,富邦-嘉義,2023-12-22,9692
2603,長榮,716,682,34,富邦-嘉義,2023-12-22,9692
00687B,國泰20年美債,52,20,32,富邦-嘉義,2023-12-22,9692
4121,優盛,31,0,31,富邦-嘉義,2023-12-22,9692
00931B,統一美債20年,35,4,31,富邦-嘉義,2023-12-22,9692
2105,正新,31,1,30,富邦-嘉義,2023-12-22,9692
2547,日勝生,30,0,30,富邦-嘉義,2023-12-22,9692
2402,毅嘉,48,19,29,富邦-嘉義,2023-12-22,9692
2601,益航,29,0,29,富邦-嘉義,2023-12-22,9692
2353,宏��,312,284,28,富邦-嘉義,2023-12-22,9692
2606,裕民,43,16,27,富邦-嘉義,2023-12-22,9692
6116,彩晶,96,70,26,富邦-嘉義,2023-12-22,9692
2355,敬鵬,43,17,26,富邦-嘉義,2023-12-22,9692
4967,十銓,78,53,25,富邦-嘉義,2023-12-22,9692
1612,宏泰,26,1,25,富邦-嘉義,2023-12-22,9692
00933B,國泰10Y+金融債,36,12,24,富邦-嘉義,2023-12-22,9692
6117,迎廣,331,307,24,富邦-嘉義,2023-12-22,9692
6770,力積電,31,8,23,富邦-嘉義,2023-12-22,9692
1514,亞力,31,9,22,富邦-嘉義,2023-12-22,9692
3189,景碩,22,0,22,富邦-嘉義,2023-12-22,9692
1314,中石化,37,16,21,富邦-嘉義,2023-12-22,9692
2367,燿華,36,15,21,富邦-嘉義,2023-12-22,9692
3231,緯創,1354,712,642,富邦-嘉義,2023-12-25,9692
00919,群益台灣精選高息,268,39,229,富邦-嘉義,2023-12-25,9692
00688L,國泰20年美債正2,165,0,165,富邦-嘉義,2023-12-25,9692
00937B,群益ESG投等債20,168,15,153,富邦-嘉義,2023-12-25,9692
2367,燿華,101,5,96,富邦-嘉義,2023-12-25,9692
2323,中環,92,0,92,富邦-嘉義,2023-12-25,9692
00929,復華台灣科技優息,134,42,92,富邦-嘉義,2023-12-25,9692
2883,凱基金,67,4,63,富邦-嘉義,2023-12-25,9692
2034,允強,61,0,61,富邦-嘉義,2023-12-25,9692
00720B,元大投資級公司債,58,3,55,富邦-嘉義,2023-12-25,9692
2376,技嘉,356,302,54,富邦-嘉義,2023-12-25,9692
9950,萬國通,52,0,52,富邦-嘉義,2023-12-25,9692
2601,益航,53,1,52,富邦-嘉義,2023-12-25,9692
1313,聯成,50,1,49,富邦-嘉義,2023-12-25,9692
2014,中鴻,87,43,44,富邦-嘉義,2023-12-25,9692
8088,品安,140,97,43,富邦-嘉義,2023-12-25,9692
1522,堤維西,45,3,42,富邦-嘉義,2023-12-25,9692
2204,中華,42,2,40,富邦-嘉義,2023-12-25,9692
2033,佳大,43,9,34,富邦-嘉義,2023-12-25,9692
1312,國喬,47,16,31,富邦-嘉義,2023-12-25,9692
3027,盛達,53,23,30,富邦-嘉義,2023-12-25,9692
00637L,元大滬深300正2,54,25,29,富邦-嘉義,2023-12-25,9692
2349,錸德,29,0,29,富邦-嘉義,2023-12-25,9692
1718,中纖,29,0,29,富邦-嘉義,2023-12-25,9692
2501,國建,30,2,28,富邦-嘉義,2023-12-25,9692
8426,紅木-KY,31,3,28,富邦-嘉義,2023-12-25,9692
1717,長興,26,0,26,富邦-嘉義,2023-12-25,9692
2867,三商壽,30,5,25,富邦-嘉義,2023-12-25,9692
00710B,復華彭博非投等債,25,0,25,富邦-嘉義,2023-12-25,9692
00679B,元大美債20年,56,32,24,富邦-嘉義,2023-12-25,9692
3362,先進光,30,6,24,富邦-嘉義,2023-12-25,9692
6147,頎邦,26,2,24,富邦-嘉義,2023-12-25,9692
6550,北極星藥業-KY,55,32,23,富邦-嘉義,2023-12-25,9692
3024,憶聲,29,6,23,富邦-嘉義,2023-12-25,9692
00936,台新永續高息中小,23,0,23,富邦-嘉義,2023-12-25,9692
1514,亞力,60,38,22,富邦-嘉義,2023-12-25,9692
3042,晶技,21,0,21,富邦-嘉義,2023-12-25,9692
00931B,統一美債20年,26,5,21,富邦-嘉義,2023-12-25,9692
00715L,期街口布蘭特正2,43,23,20,富邦-嘉義,2023-12-25,9692
00687B,國泰20年美債,45,26,19,富邦-嘉義,2023-12-25,9692
6120,達運,18,0,18,富邦-嘉義,2023-12-25,9692
5009,榮剛,25,7,18,富邦-嘉義,2023-12-25,9692
2363,矽統,37,19,18,富邦-嘉義,2023-12-25,9692
3576,聯合再生,19,2,17,富邦-嘉義,2023-12-25,9692
8096,擎亞,18,1,17,富邦-嘉義,2023-12-25,9692
8085,福華,23,6,17,富邦-嘉義,2023-12-25,9692
2515,中工,21,4,17,富邦-嘉義,2023-12-25,9692
00900,富邦特選高股息30,23,6,17,富邦-嘉義,2023-12-25,9692
6116,彩晶,20,5,15,富邦-嘉義,2023-12-25,9692
00713,元大台灣高息低波,15,0,15,富邦-嘉義,2023-12-25,9692
2888,新光金,708,30,678,富邦-嘉義,2023-12-26,9692
3231,緯創,297,131,166,富邦-嘉義,2023-12-26,9692
3325,旭品,116,6,110,富邦-嘉義,2023-12-26,9692
00712,復華富時不動產,106,1,105,富邦-嘉義,2023-12-26,9692
3346,麗清,123,22,101,富邦-嘉義,2023-12-26,9692
6117,迎廣,200,105,95,富邦-嘉義,2023-12-26,9692
2355,敬鵬,142,52,90,富邦-嘉義,2023-12-26,9692
2356,英業達,651,567,84,富邦-嘉義,2023-12-26,9692
2883,凱基金,123,49,74,富邦-嘉義,2023-12-26,9692
00929,復華台灣科技優息,107,33,74,富邦-嘉義,2023-12-26,9692
00632R,元大台灣50反1,82,10,72,富邦-嘉義,2023-12-26,9692
00937B,群益ESG投等債20,75,3,72,富邦-嘉義,2023-12-26,9692
00680L,元大美債20正2,73,2,71,富邦-嘉義,2023-12-26,9692
2331,精英,66,8,58,富邦-嘉義,2023-12-26,9692
3706,神達,60,8,52,富邦-嘉義,2023-12-26,9692
3437,榮創,56,10,46,富邦-嘉義,2023-12-26,9692
6695,芯鼎,47,4,43,富邦-嘉義,2023-12-26,9692
1616,億泰,41,0,41,富邦-嘉義,2023-12-26,9692
00710B,復華彭博非投等債,40,0,40,富邦-嘉義,2023-12-26,9692
3694,海華,120,80,40,富邦-嘉義,2023-12-26,9692
1513,中興電,43,3,40,富邦-嘉義,2023-12-26,9692
00933B,國泰10Y+金融債,38,0,38,富邦-嘉義,2023-12-26,9692
00679B,元大美債20年,40,5,35,富邦-嘉義,2023-12-26,9692
4712,福格創新,33,0,33,富邦-嘉義,2023-12-26,9692
00673R,期元大S＆P原油反1,32,0,32,富邦-嘉義,2023-12-26,9692
2313,華通,57,25,32,富邦-嘉義,2023-12-26,9692
00934,中信成長高股息,34,4,30,富邦-嘉義,2023-12-26,9692
00717,富邦美國特別股,30,0,30,富邦-嘉義,2023-12-26,9692
2363,矽統,52,24,28,富邦-嘉義,2023-12-26,9692
2618,長榮航,62,36,26,富邦-嘉義,2023-12-26,9692
00720B,元大投資級公司債,26,0,26,富邦-嘉義,2023-12-26,9692
4939,亞電,104,79,25,富邦-嘉義,2023-12-26,9692
4968,立積,30,5,25,富邦-嘉義,2023-12-26,9692
1312,國喬,43,18,25,富邦-嘉義,2023-12-26,9692
2027,大成鋼,26,2,24,富邦-嘉義,2023-12-26,9692
2607,榮運,23,2,21,富邦-嘉義,2023-12-26,9692
00753L,中信中國50正2,21,0,21,富邦-嘉義,2023-12-26,9692
6668,中揚光,35,14,21,富邦-嘉義,2023-12-26,9692
5426,振發,27,6,21,富邦-嘉義,2023-12-26,9692
8050,廣積,21,0,21,富邦-嘉義,2023-12-26,9692
2610,華航,29,8,21,富邦-嘉義,2023-12-26,9692
3548,兆利,23,3,20,富邦-嘉義,2023-12-26,9692
6129,普誠,20,0,20,富邦-嘉義,2023-12-26,9692
4909,新復興,21,1,20,富邦-嘉義,2023-12-26,9692
5009,榮剛,32,12,20,富邦-嘉義,2023-12-26,9692
2002,中鋼,29,9,20,富邦-嘉義,2023-12-26,9692
3264,欣銓,28,9,19,富邦-嘉義,2023-12-26,9692
00687B,國泰20年美債,20,1,19,富邦-嘉義,2023-12-26,9692
00719B,元大美債1-3,20,2,18,富邦-嘉義,2023-12-26,9692
00882,中信中國高股息,18,0,18,富邦-嘉義,2023-12-26,9692
00937B,群益ESG投等債20,787,44,743,富邦-嘉義,2023-12-27,9692
8096,擎亞,1510,1049,461,富邦-嘉義,2023-12-27,9692
2356,英業達,617,205,412,富邦-嘉義,2023-12-27,9692
6270,倍微,205,1,204,富邦-嘉義,2023-12-27,9692
2014,中鴻,184,38,146,富邦-嘉義,2023-12-27,9692
2618,長榮航,193,58,135,富邦-嘉義,2023-12-27,9692
2313,華通,149,15,134,富邦-嘉義,2023-12-27,9692
00632R,元大台灣50反1,118,0,118,富邦-嘉義,2023-12-27,9692
2515,中工,110,7,103,富邦-嘉義,2023-12-27,9692
3376,新日興,133,34,99,富邦-嘉義,2023-12-27,9692
00687B,國泰20年美債,93,2,91,富邦-嘉義,2023-12-27,9692
2421,建準,90,17,73,富邦-嘉義,2023-12-27,9692
00882,中信中國高股息,90,30,60,富邦-嘉義,2023-12-27,9692
6233,旺玖,143,87,56,富邦-嘉義,2023-12-27,9692
5521,工信,58,4,54,富邦-嘉義,2023-12-27,9692
2436,偉詮電,65,14,51,富邦-嘉義,2023-12-27,9692
00710B,復華彭博非投等債,48,0,48,富邦-嘉義,2023-12-27,9692
00688L,國泰20年美債正2,46,0,46,富邦-嘉義,2023-12-27,9692
2010,春源,48,2,46,富邦-嘉義,2023-12-27,9692
9919,康那香,60,15,45,富邦-嘉義,2023-12-27,9692
00673R,期元大S＆P原油反1,42,0,42,富邦-嘉義,2023-12-27,9692
4712,福格創新,42,0,42,富邦-嘉義,2023-12-27,9692
2637,慧洋-KY,70,28,42,富邦-嘉義,2023-12-27,9692
2337,旺宏,74,33,41,富邦-嘉義,2023-12-27,9692
2607,榮運,40,0,40,富邦-嘉義,2023-12-27,9692
6668,中揚光,49,10,39,富邦-嘉義,2023-12-27,9692
9950,萬國通,36,0,36,富邦-嘉義,2023-12-27,9692
6799,來頡,44,9,35,富邦-嘉義,2023-12-27,9692
3305,昇貿,37,2,35,富邦-嘉義,2023-12-27,9692
3260,威剛,50,15,35,富邦-嘉義,2023-12-27,9692
00708L,期元大S＆P黃金正2,35,0,35,富邦-嘉義,2023-12-27,9692
3231,緯創,58,26,32,富邦-嘉義,2023-12-27,9692
00934,中信成長高股息,51,19,32,富邦-嘉義,2023-12-27,9692
2365,昆盈,84,54,30,富邦-嘉義,2023-12-27,9692
4123,晟德,31,2,29,富邦-嘉義,2023-12-27,9692
1524,耿鼎,30,1,29,富邦-嘉義,2023-12-27,9692
5351,鈺創,49,20,29,富邦-嘉義,2023-12-27,9692
6531,愛普*,32,4,28,富邦-嘉義,2023-12-27,9692
6805,富世達,27,0,27,富邦-嘉義,2023-12-27,9692
2402,毅嘉,40,13,27,富邦-嘉義,2023-12-27,9692
2363,矽統,52,26,26,富邦-嘉義,2023-12-27,9692
00918,大華優利高填息30,28,3,25,富邦-嘉義,2023-12-27,9692
2630,亞航,27,2,25,富邦-嘉義,2023-12-27,9692
2027,大成鋼,27,3,24,富邦-嘉義,2023-12-27,9692
2390,云辰,20,0,20,富邦-嘉義,2023-12-27,9692
3265,台星科,20,0,20,富邦-嘉義,2023-12-27,9692
8034,榮群,27,8,19,富邦-嘉義,2023-12-27,9692
00717,富邦美國特別股,19,0,19,富邦-嘉義,2023-12-27,9692
8936,國統,25,6,19,富邦-嘉義,2023-12-27,9692
2029,盛餘,20,1,19,富邦-嘉義,2023-12-27,9692
00937B,群益ESG投等債20,657,13,644,富邦-嘉義,2023-12-28,9692
3706,神達,2145,1825,320,富邦-嘉義,2023-12-28,9692
00715L,期街口布蘭特正2,190,0,190,富邦-嘉義,2023-12-28,9692
00919,群益台灣精選高息,304,121,183,富邦-嘉義,2023-12-28,9692
2515,中工,260,85,175,富邦-嘉義,2023-12-28,9692
00676R,富邦臺灣加權反1,179,20,159,富邦-嘉義,2023-12-28,9692
6187,萬潤,181,40,141,富邦-嘉義,2023-12-28,9692
00719B,元大美債1-3,139,2,137,富邦-嘉義,2023-12-28,9692
3006,晶豪科,142,19,123,富邦-嘉義,2023-12-28,9692
3035,智原,111,5,106,富邦-嘉義,2023-12-28,9692
00632R,元大台灣50反1,105,0,105,富邦-嘉義,2023-12-28,9692
2367,燿華,103,0,103,富邦-嘉義,2023-12-28,9692
00712,復華富時不動產,116,23,93,富邦-嘉義,2023-12-28,9692
3338,泰碩,119,45,74,富邦-嘉義,2023-12-28,9692
00679B,元大美債20年,86,14,72,富邦-嘉義,2023-12-28,9692
1514,亞力,570,504,66,富邦-嘉義,2023-12-28,9692
6548,長科*,51,0,51,富邦-嘉義,2023-12-28,9692
00933B,國泰10Y+金融債,50,0,50,富邦-嘉義,2023-12-28,9692
2607,榮運,48,0,48,富邦-嘉義,2023-12-28,9692
1503,士電,142,95,47,富邦-嘉義,2023-12-28,9692
2408,南亞科,81,34,47,富邦-嘉義,2023-12-28,9692
00891,中信關鍵半導體,49,5,44,富邦-嘉義,2023-12-28,9692
2313,華通,93,49,44,富邦-嘉義,2023-12-28,9692
2405,輔信,162,118,44,富邦-嘉義,2023-12-28,9692
6237,驊訊,47,5,42,富邦-嘉義,2023-12-28,9692
3450,聯鈞,58,20,38,富邦-嘉義,2023-12-28,9692
6139,亞翔,74,36,38,富邦-嘉義,2023-12-28,9692
2610,華航,43,5,38,富邦-嘉義,2023-12-28,9692
2014,中鴻,43,6,37,富邦-嘉義,2023-12-28,9692
2506,太設,43,8,35,富邦-嘉義,2023-12-28,9692
9904,寶成,33,0,33,富邦-嘉義,2023-12-28,9692
1618,合機,70,38,32,富邦-嘉義,2023-12-28,9692
3047,訊舟,31,0,31,富邦-嘉義,2023-12-28,9692
3231,緯創,78,47,31,富邦-嘉義,2023-12-28,9692
00710B,復華彭博非投等債,30,0,30,富邦-嘉義,2023-12-28,9692
3376,新日興,38,12,26,富邦-嘉義,2023-12-28,9692
3019,亞光,25,0,25,富邦-嘉義,2023-12-28,9692
00900,富邦特選高股息30,29,5,24,富邦-嘉義,2023-12-28,9692
5864,致和證,26,2,24,富邦-嘉義,2023-12-28,9692
1529,樂事綠能,128,105,23,富邦-嘉義,2023-12-28,9692
2027,大成鋼,31,8,23,富邦-嘉義,2023-12-28,9692
1815,富喬,24,1,23,富邦-嘉義,2023-12-28,9692
5521,工信,33,10,23,富邦-嘉義,2023-12-28,9692
1513,中興電,434,412,22,富邦-嘉義,2023-12-28,9692
2449,京元電子,26,4,22,富邦-嘉義,2023-12-28,9692
00687B,國泰20年美債,69,47,22,富邦-嘉義,2023-12-28,9692
4979,華星光,57,36,21,富邦-嘉義,2023-12-28,9692
2365,昆盈,756,735,21,富邦-嘉義,2023-12-28,9692
8110,華東,39,18,21,富邦-嘉義,2023-12-28,9692
6265,方土昶,20,0,20,富邦-嘉義,2023-12-28,9692
00937B,群益ESG投等債20,490,31,459,富邦-嘉義,2023-12-29,9692
5521,工信,1287,912,375,富邦-嘉義,2023-12-29,9692
00929,復華台灣科技優息,268,53,215,富邦-嘉義,2023-12-29,9692
00715L,期街口布蘭特正2,207,0,207,富邦-嘉義,2023-12-29,9692
3706,神達,313,147,166,富邦-嘉義,2023-12-29,9692
2362,藍天,410,262,148,富邦-嘉義,2023-12-29,9692
5351,鈺創,176,32,144,富邦-嘉義,2023-12-29,9692
2356,英業達,295,161,134,富邦-嘉義,2023-12-29,9692
3338,泰碩,219,92,127,富邦-嘉義,2023-12-29,9692
2421,建準,174,60,114,富邦-嘉義,2023-12-29,9692
2888,新光金,118,6,112,富邦-嘉義,2023-12-29,9692
00632R,元大台灣50反1,169,70,99,富邦-嘉義,2023-12-29,9692
6113,亞矽,703,616,87,富邦-嘉義,2023-12-29,9692
3390,旭軟,221,136,85,富邦-嘉義,2023-12-29,9692
6233,旺玖,78,3,75,富邦-嘉義,2023-12-29,9692
00933B,國泰10Y+金融債,75,2,73,富邦-嘉義,2023-12-29,9692
00720B,元大投資級公司債,62,1,61,富邦-嘉義,2023-12-29,9692
00680L,元大美債20正2,61,0,61,富邦-嘉義,2023-12-29,9692
3483,力致,54,3,51,富邦-嘉義,2023-12-29,9692
6274,台燿,51,1,50,富邦-嘉義,2023-12-29,9692
00637L,元大滬深300正2,93,44,49,富邦-嘉義,2023-12-29,9692
2367,燿華,50,1,49,富邦-嘉義,2023-12-29,9692
00934,中信成長高股息,66,17,49,富邦-嘉義,2023-12-29,9692
00919,群益台灣精選高息,103,55,48,富邦-嘉義,2023-12-29,9692
00902,中信電池及儲能,50,6,44,富邦-嘉義,2023-12-29,9692
2344,華邦電,177,134,43,富邦-嘉義,2023-12-29,9692
1312,國喬,51,11,40,富邦-嘉義,2023-12-29,9692
6243,迅杰,43,4,39,富邦-嘉義,2023-12-29,9692
8940,新天地,38,0,38,富邦-嘉義,2023-12-29,9692
3325,旭品,31,1,30,富邦-嘉義,2023-12-29,9692
00918,大華優利高填息30,45,15,30,富邦-嘉義,2023-12-29,9692
00642U,期元大S＆P石油,28,0,28,富邦-嘉義,2023-12-29,9692
2324,仁寶,466,438,28,富邦-嘉義,2023-12-29,9692
1519,華城,73,48,25,富邦-嘉義,2023-12-29,9692
00882,中信中國高股息,90,65,25,富邦-嘉義,2023-12-29,9692
00891,中信關鍵半導體,27,3,24,富邦-嘉義,2023-12-29,9692
2603,長榮,30,7,23,富邦-嘉義,2023-12-29,9692
2331,精英,52,29,23,富邦-嘉義,2023-12-29,9692
9105,泰金寶-DR,22,0,22,富邦-嘉義,2023-12-29,9692
00710B,復華彭博非投等債,22,0,22,富邦-嘉義,2023-12-29,9692
8088,品安,76,54,22,富邦-嘉義,2023-12-29,9692
2313,華通,24,2,22,富邦-嘉義,2023-12-29,9692
00633L,富邦上証正2,26,5,21,富邦-嘉義,2023-12-29,9692
1584,精剛,21,0,21,富邦-嘉義,2023-12-29,9692
3260,威剛,451,430,21,富邦-嘉義,2023-12-29,9692
1409,新纖,20,0,20,富邦-嘉義,2023-12-29,9692
6695,芯鼎,63,43,20,富邦-嘉義,2023-12-29,9692
00687B,國泰20年美債,21,1,20,富邦-嘉義,2023-12-29,9692
2323,中環,20,1,19,富邦-嘉義,2023-12-29,9692
3380,明泰,22,3,19,富邦-嘉義,2023-12-29,9692
2618,長榮航,3394,696,2698,富邦-嘉義,2024-01-02,9692
6113,亞矽,621,213,408,富邦-嘉義,2024-01-02,9692
00937B,群益ESG投等債20,368,10,358,富邦-嘉義,2024-01-02,9692
3035,智原,315,2,313,富邦-嘉義,2024-01-02,9692
2362,藍天,839,597,242,富邦-嘉義,2024-01-02,9692
2344,華邦電,205,85,120,富邦-嘉義,2024-01-02,9692
00720B,元大投資級公司債,118,0,118,富邦-嘉義,2024-01-02,9692
2888,新光金,113,0,113,富邦-嘉義,2024-01-02,9692
00715L,期街口布蘭特正2,123,12,111,富邦-嘉義,2024-01-02,9692
2609,陽明,1485,1392,93,富邦-嘉義,2024-01-02,9692
00665L,富邦�琤肭磪囓�2,110,20,90,富邦-嘉義,2024-01-02,9692
8054,安國,203,120,83,富邦-嘉義,2024-01-02,9692
2352,佳世達,107,29,78,富邦-嘉義,2024-01-02,9692
6140,訊達,179,106,73,富邦-嘉義,2024-01-02,9692
00929,復華台灣科技優息,296,226,70,富邦-嘉義,2024-01-02,9692
3086,華義,80,14,66,富邦-嘉義,2024-01-02,9692
00687B,國泰20年美債,69,6,63,富邦-嘉義,2024-01-02,9692
2313,華通,74,15,59,富邦-嘉義,2024-01-02,9692
00679B,元大美債20年,111,54,57,富邦-嘉義,2024-01-02,9692
00717,富邦美國特別股,56,0,56,富邦-嘉義,2024-01-02,9692
3390,旭軟,242,186,56,富邦-嘉義,2024-01-02,9692
6274,台燿,54,3,51,富邦-嘉義,2024-01-02,9692
3022,威強電,51,0,51,富邦-嘉義,2024-01-02,9692
4904,遠傳,39,0,39,富邦-嘉義,2024-01-02,9692
00933B,國泰10Y+金融債,44,5,39,富邦-嘉義,2024-01-02,9692
3217,優群,73,35,38,富邦-嘉義,2024-01-02,9692
00637L,元大滬深300正2,51,15,36,富邦-嘉義,2024-01-02,9692
1314,中石化,41,7,34,富邦-嘉義,2024-01-02,9692
2615,萬海,82,51,31,富邦-嘉義,2024-01-02,9692
00655L,國泰中國A50正2,30,0,30,富邦-嘉義,2024-01-02,9692
00891,中信關鍵半導體,32,3,29,富邦-嘉義,2024-01-02,9692
1718,中纖,29,0,29,富邦-嘉義,2024-01-02,9692
3661,世芯-KY,37,8,29,富邦-嘉義,2024-01-02,9692
00751B,元大AAA至A公司債,32,4,28,富邦-嘉義,2024-01-02,9692
00919,群益台灣精選高息,128,100,28,富邦-嘉義,2024-01-02,9692
1524,耿鼎,30,2,28,富邦-嘉義,2024-01-02,9692
8088,品安,27,1,26,富邦-嘉義,2024-01-02,9692
6667,信紘科,40,17,23,富邦-嘉義,2024-01-02,9692
2337,旺宏,28,5,23,富邦-嘉義,2024-01-02,9692
1802,台玻,28,5,23,富邦-嘉義,2024-01-02,9692
3002,歐格,22,0,22,富邦-嘉義,2024-01-02,9692
2023,燁輝,26,4,22,富邦-嘉義,2024-01-02,9692
6243,迅杰,83,62,21,富邦-嘉義,2024-01-02,9692
2363,矽統,22,2,20,富邦-嘉義,2024-01-02,9692
3049,精金,20,0,20,富邦-嘉義,2024-01-02,9692
3163,波若威,20,0,20,富邦-嘉義,2024-01-02,9692
3707,漢磊,19,0,19,富邦-嘉義,2024-01-02,9692
5425,台半,19,1,18,富邦-嘉義,2024-01-02,9692
6625,必應,19,1,18,富邦-嘉義,2024-01-02,9692
2408,南亞科,59,41,18,富邦-嘉義,2024-01-02,9692
00929,復華台灣科技優息,799,150,649,富邦-嘉義,2024-01-03,9692
2515,中工,590,121,469,富邦-嘉義,2024-01-03,9692
00671R,富邦NASDAQ反1,460,0,460,富邦-嘉義,2024-01-03,9692
9919,康那香,1257,907,350,富邦-嘉義,2024-01-03,9692
00937B,群益ESG投等債20,328,17,311,富邦-嘉義,2024-01-03,9692
1325,恆大,346,39,307,富邦-嘉義,2024-01-03,9692
8096,擎亞,429,144,285,富邦-嘉義,2024-01-03,9692
00715L,期街口布蘭特正2,256,0,256,富邦-嘉義,2024-01-03,9692
2609,陽明,1533,1302,231,富邦-嘉義,2024-01-03,9692
2388,威盛,555,356,199,富邦-嘉義,2024-01-03,9692
2486,一詮,1138,942,196,富邦-嘉義,2024-01-03,9692
00919,群益台灣精選高息,254,61,193,富邦-嘉義,2024-01-03,9692
00708L,期元大S＆P黃金正2,162,0,162,富邦-嘉義,2024-01-03,9692
2301,光寶科,131,0,131,富邦-嘉義,2024-01-03,9692
00688L,國泰20年美債正2,125,0,125,富邦-嘉義,2024-01-03,9692
00881,國泰台灣5G+,120,2,118,富邦-嘉義,2024-01-03,9692
3325,旭品,334,228,106,富邦-嘉義,2024-01-03,9692
2303,聯電,119,21,98,富邦-嘉義,2024-01-03,9692
2323,中環,103,7,96,富邦-嘉義,2024-01-03,9692
2331,精英,634,552,82,富邦-嘉義,2024-01-03,9692
00633L,富邦上証正2,70,1,69,富邦-嘉義,2024-01-03,9692
2352,佳世達,133,69,64,富邦-嘉義,2024-01-03,9692
2324,仁寶,111,49,62,富邦-嘉義,2024-01-03,9692
6668,中揚光,61,0,61,富邦-嘉義,2024-01-03,9692
2101,南港,51,2,49,富邦-嘉義,2024-01-03,9692
00720B,元大投資級公司債,47,0,47,富邦-嘉義,2024-01-03,9692
00933B,國泰10Y+金融債,50,4,46,富邦-嘉義,2024-01-03,9692
2883,凱基金,49,4,45,富邦-嘉義,2024-01-03,9692
4130,健亞,45,0,45,富邦-嘉義,2024-01-03,9692
6117,迎廣,492,447,45,富邦-嘉義,2024-01-03,9692
2605,新興,79,36,43,富邦-嘉義,2024-01-03,9692
2603,長榮,120,78,42,富邦-嘉義,2024-01-03,9692
0056,元大高股息,139,98,41,富邦-嘉義,2024-01-03,9692
2002,中鋼,50,13,37,富邦-嘉義,2024-01-03,9692
2607,榮運,71,35,36,富邦-嘉義,2024-01-03,9692
00665L,富邦�琤肭磪囓�2,35,0,35,富邦-嘉義,2024-01-03,9692
9945,潤泰新,34,0,34,富邦-嘉義,2024-01-03,9692
1732,毛寶,144,110,34,富邦-嘉義,2024-01-03,9692
3338,泰碩,45,11,34,富邦-嘉義,2024-01-03,9692
00935,野村臺灣新科技50,30,0,30,富邦-嘉義,2024-01-03,9692
6108,競國,36,6,30,富邦-嘉義,2024-01-03,9692
3231,緯創,58,29,29,富邦-嘉義,2024-01-03,9692
5521,工信,57,28,29,富邦-嘉義,2024-01-03,9692
2349,錸德,29,0,29,富邦-嘉義,2024-01-03,9692
2606,裕民,88,61,27,富邦-嘉義,2024-01-03,9692
00891,中信關鍵半導體,35,9,26,富邦-嘉義,2024-01-03,9692
2427,三商電,31,5,26,富邦-嘉義,2024-01-03,9692
00642U,期元大S＆P石油,25,0,25,富邦-嘉義,2024-01-03,9692
1432,大魯閣,26,1,25,富邦-嘉義,2024-01-03,9692
2206,三陽工業,51,26,25,富邦-嘉義,2024-01-03,9692
8096,擎亞,1757,1229,528,富邦-嘉義,2024-01-04,9692
00929,復華台灣科技優息,531,23,508,富邦-嘉義,2024-01-04,9692
2388,威盛,690,257,433,富邦-嘉義,2024-01-04,9692
00937B,群益ESG投等債20,245,30,215,富邦-嘉義,2024-01-04,9692
2607,榮運,941,752,189,富邦-嘉義,2024-01-04,9692
00712,復華富時不動產,160,4,156,富邦-嘉義,2024-01-04,9692
2367,燿華,144,0,144,富邦-嘉義,2024-01-04,9692
1732,毛寶,252,150,102,富邦-嘉義,2024-01-04,9692
00933B,國泰10Y+金融債,91,0,91,富邦-嘉義,2024-01-04,9692
00720B,元大投資級公司債,90,0,90,富邦-嘉義,2024-01-04,9692
5521,工信,64,9,55,富邦-嘉義,2024-01-04,9692
2611,志信,1263,1212,51,富邦-嘉義,2024-01-04,9692
2515,中工,127,76,51,富邦-嘉義,2024-01-04,9692
00637L,元大滬深300正2,55,6,49,富邦-嘉義,2024-01-04,9692
00673R,期元大S＆P原油反1,50,5,45,富邦-嘉義,2024-01-04,9692
8054,安國,164,120,44,富邦-嘉義,2024-01-04,9692
2605,新興,113,70,43,富邦-嘉義,2024-01-04,9692
2504,國產,43,1,42,富邦-嘉義,2024-01-04,9692
2356,英業達,146,107,39,富邦-嘉義,2024-01-04,9692
8046,南電,42,3,39,富邦-嘉義,2024-01-04,9692
2002,中鋼,40,3,37,富邦-嘉義,2024-01-04,9692
0056,元大高股息,77,40,37,富邦-嘉義,2024-01-04,9692
8467,波力-KY,54,19,35,富邦-嘉義,2024-01-04,9692
6462,神盾,82,47,35,富邦-嘉義,2024-01-04,9692
2206,三陽工業,68,33,35,富邦-嘉義,2024-01-04,9692
2610,華航,41,10,31,富邦-嘉義,2024-01-04,9692
3037,欣興,41,11,30,富邦-嘉義,2024-01-04,9692
00713,元大台灣高息低波,31,2,29,富邦-嘉義,2024-01-04,9692
6164,華興,63,35,28,富邦-嘉義,2024-01-04,9692
1618,合機,41,13,28,富邦-嘉義,2024-01-04,9692
1514,亞力,58,31,27,富邦-嘉義,2024-01-04,9692
00751B,元大AAA至A公司債,27,1,26,富邦-嘉義,2024-01-04,9692
2399,映泰,32,7,25,富邦-嘉義,2024-01-04,9692
00891,中信關鍵半導體,27,2,25,富邦-嘉義,2024-01-04,9692
2613,中櫃,55,30,25,富邦-嘉義,2024-01-04,9692
6275,元山,24,0,24,富邦-嘉義,2024-01-04,9692
00680L,元大美債20正2,38,15,23,富邦-嘉義,2024-01-04,9692
5258,虹堡,27,4,23,富邦-嘉義,2024-01-04,9692
3006,晶豪科,46,24,22,富邦-嘉義,2024-01-04,9692
2332,友訊,22,0,22,富邦-嘉義,2024-01-04,9692
2069,運錩,22,0,22,富邦-嘉義,2024-01-04,9692
8926,台汽電,22,2,20,富邦-嘉義,2024-01-04,9692
6243,迅杰,31,11,20,富邦-嘉義,2024-01-04,9692
2401,凌陽,28,8,20,富邦-嘉義,2024-01-04,9692
1314,中石化,32,12,20,富邦-嘉義,2024-01-04,9692
1903,士紙,20,0,20,富邦-嘉義,2024-01-04,9692
6129,普誠,22,2,20,富邦-嘉義,2024-01-04,9692
4533,協易機,80,61,19,富邦-嘉義,2024-01-04,9692
00878,國泰永續高股息,42,24,18,富邦-嘉義,2024-01-04,9692
00632R,元大台灣50反1,31,13,18,富邦-嘉義,2024-01-04,9692
00929,復華台灣科技優息,550,18,532,富邦-嘉義,2024-01-05,9692
00937B,群益ESG投等債20,358,30,328,富邦-嘉義,2024-01-05,9692
2352,佳世達,228,59,169,富邦-嘉義,2024-01-05,9692
6531,愛普*,402,243,159,富邦-嘉義,2024-01-05,9692
2323,中環,144,21,123,富邦-嘉義,2024-01-05,9692
00933B,國泰10Y+金融債,136,16,120,富邦-嘉義,2024-01-05,9692
2610,華航,142,23,119,富邦-嘉義,2024-01-05,9692
00919,群益台灣精選高息,142,29,113,富邦-嘉義,2024-01-05,9692
2489,瑞軒,219,119,100,富邦-嘉義,2024-01-05,9692
00720B,元大投資級公司債,103,3,100,富邦-嘉義,2024-01-05,9692
00934,中信成長高股息,78,0,78,富邦-嘉義,2024-01-05,9692
2609,陽明,518,441,77,富邦-嘉義,2024-01-05,9692
6770,力積電,5113,5039,74,富邦-嘉義,2024-01-05,9692
00679B,元大美債20年,96,23,73,富邦-嘉義,2024-01-05,9692
00878,國泰永續高股息,79,14,65,富邦-嘉義,2024-01-05,9692
2630,亞航,73,12,61,富邦-嘉義,2024-01-05,9692
2504,國產,60,1,59,富邦-嘉義,2024-01-05,9692
3025,星通,55,1,54,富邦-嘉義,2024-01-05,9692
00715L,期街口布蘭特正2,52,0,52,富邦-嘉義,2024-01-05,9692
00632R,元大台灣50反1,130,78,52,富邦-嘉義,2024-01-05,9692
4906,正文,54,2,52,富邦-嘉義,2024-01-05,9692
3588,通嘉,184,135,49,富邦-嘉義,2024-01-05,9692
00687B,國泰20年美債,66,19,47,富邦-嘉義,2024-01-05,9692
2891,中信金,51,4,47,富邦-嘉義,2024-01-05,9692
6462,神盾,453,406,47,富邦-嘉義,2024-01-05,9692
2881,富邦金,46,0,46,富邦-嘉義,2024-01-05,9692
2362,藍天,338,294,44,富邦-嘉義,2024-01-05,9692
1795,美時,59,16,43,富邦-嘉義,2024-01-05,9692
2801,彰銀,36,0,36,富邦-嘉義,2024-01-05,9692
00712,復華富時不動產,42,7,35,富邦-嘉義,2024-01-05,9692
1101,台泥,38,5,33,富邦-嘉義,2024-01-05,9692
00888,永豐台灣ESG,33,0,33,富邦-嘉義,2024-01-05,9692
00665L,富邦�琤肭磪囓�2,40,10,30,富邦-嘉義,2024-01-05,9692
2301,光寶科,31,2,29,富邦-嘉義,2024-01-05,9692
0056,元大高股息,40,11,29,富邦-嘉義,2024-01-05,9692
00915,凱基優選高股息30,29,0,29,富邦-嘉義,2024-01-05,9692
5258,虹堡,26,0,26,富邦-嘉義,2024-01-05,9692
6451,訊芯-KY,27,2,25,富邦-嘉義,2024-01-05,9692
2353,宏��,88,64,24,富邦-嘉義,2024-01-05,9692
6805,富世達,25,1,24,富邦-嘉義,2024-01-05,9692
4162,智擎,30,6,24,富邦-嘉義,2024-01-05,9692
00927,群益半導體收益,24,0,24,富邦-嘉義,2024-01-05,9692
1721,三晃,23,0,23,富邦-嘉義,2024-01-05,9692
2486,一詮,40,17,23,富邦-嘉義,2024-01-05,9692
2356,英業達,81,59,22,富邦-嘉義,2024-01-05,9692
00904,新光臺灣半導體30,21,0,21,富邦-嘉義,2024-01-05,9692
5355,佳總,22,1,21,富邦-嘉義,2024-01-05,9692
3010,華立,21,0,21,富邦-嘉義,2024-01-05,9692
00912,中信臺灣智慧50,20,0,20,富邦-嘉義,2024-01-05,9692
3046,建��,20,0,20,富邦-嘉義,2024-01-05,9692
3231,緯創,1750,29,1721,富邦-嘉義,2024-01-08,9692
00929,復華台灣科技優息,721,12,709,富邦-嘉義,2024-01-08,9692
4956,光鋐,574,9,565,富邦-嘉義,2024-01-08,9692
00933B,國泰10Y+金融債,376,15,361,富邦-嘉義,2024-01-08,9692
2356,英業達,317,22,295,富邦-嘉義,2024-01-08,9692
2323,中環,236,0,236,富邦-嘉義,2024-01-08,9692
2883,凱基金,211,11,200,富邦-嘉義,2024-01-08,9692
3025,星通,310,126,184,富邦-嘉義,2024-01-08,9692
00655L,國泰中國A50正2,170,0,170,富邦-嘉義,2024-01-08,9692
00937B,群益ESG投等債20,201,36,165,富邦-嘉義,2024-01-08,9692
2362,藍天,1542,1409,133,富邦-嘉義,2024-01-08,9692
3481,群創,430,308,122,富邦-嘉義,2024-01-08,9692
2489,瑞軒,230,110,120,富邦-嘉義,2024-01-08,9692
00878,國泰永續高股息,131,15,116,富邦-嘉義,2024-01-08,9692
2382,廣達,214,102,112,富邦-嘉義,2024-01-08,9692
5880,合庫金,120,11,109,富邦-嘉義,2024-01-08,9692
00927,群益半導體收益,78,0,78,富邦-嘉義,2024-01-08,9692
00720B,元大投資級公司債,74,3,71,富邦-嘉義,2024-01-08,9692
00931B,統一美債20年,92,24,68,富邦-嘉義,2024-01-08,9692
8088,品安,66,2,64,富邦-嘉義,2024-01-08,9692
0056,元大高股息,63,6,57,富邦-嘉義,2024-01-08,9692
1605,華新,53,1,52,富邦-嘉義,2024-01-08,9692
8085,福華,50,0,50,富邦-嘉義,2024-01-08,9692
3260,威剛,54,7,47,富邦-嘉義,2024-01-08,9692
2498,宏達電,1120,1074,46,富邦-嘉義,2024-01-08,9692
2884,玉山金,76,32,44,富邦-嘉義,2024-01-08,9692
3209,全科,43,0,43,富邦-嘉義,2024-01-08,9692
00882,中信中國高股息,38,0,38,富邦-嘉義,2024-01-08,9692
1815,富喬,37,0,37,富邦-嘉義,2024-01-08,9692
3287,廣寰科,45,8,37,富邦-嘉義,2024-01-08,9692
5351,鈺創,79,43,36,富邦-嘉義,2024-01-08,9692
6835,圓裕,36,0,36,富邦-嘉義,2024-01-08,9692
8011,台通,39,4,35,富邦-嘉義,2024-01-08,9692
2303,聯電,36,2,34,富邦-嘉義,2024-01-08,9692
00888,永豐台灣ESG,40,7,33,富邦-嘉義,2024-01-08,9692
2353,宏��,578,545,33,富邦-嘉義,2024-01-08,9692
1409,新纖,36,5,31,富邦-嘉義,2024-01-08,9692
2349,錸德,30,0,30,富邦-嘉義,2024-01-08,9692
2615,萬海,95,66,29,富邦-嘉義,2024-01-08,9692
2888,新光金,34,6,28,富邦-嘉義,2024-01-08,9692
00637L,元大滬深300正2,36,8,28,富邦-嘉義,2024-01-08,9692
00881,國泰台灣5G+,27,0,27,富邦-嘉義,2024-01-08,9692
3046,建��,158,132,26,富邦-嘉義,2024-01-08,9692
3042,晶技,25,0,25,富邦-嘉義,2024-01-08,9692
2317,鴻海,43,18,25,富邦-嘉義,2024-01-08,9692
2002,中鋼,25,1,24,富邦-嘉義,2024-01-08,9692
3066,李洲,24,0,24,富邦-嘉義,2024-01-08,9692
00919,群益台灣精選高息,117,95,22,富邦-嘉義,2024-01-08,9692
8930,青鋼,22,1,21,富邦-嘉義,2024-01-08,9692
8046,南電,20,0,20,富邦-嘉義,2024-01-08,9692
00919,群益台灣精選高息,420,37,383,富邦-嘉義,2024-01-09,9692
00715L,期街口布蘭特正2,196,5,191,富邦-嘉義,2024-01-09,9692
2609,陽明,775,617,158,富邦-嘉義,2024-01-09,9692
00933B,國泰10Y+金融債,155,1,154,富邦-嘉義,2024-01-09,9692
1519,華城,207,79,128,富邦-嘉義,2024-01-09,9692
00929,復華台灣科技優息,288,162,126,富邦-嘉義,2024-01-09,9692
00680L,元大美債20正2,122,1,121,富邦-嘉義,2024-01-09,9692
00937B,群益ESG投等債20,106,7,99,富邦-嘉義,2024-01-09,9692
6140,訊達,607,524,83,富邦-嘉義,2024-01-09,9692
2353,宏��,433,351,82,富邦-嘉義,2024-01-09,9692
2888,新光金,184,105,79,富邦-嘉義,2024-01-09,9692
1314,中石化,78,0,78,富邦-嘉義,2024-01-09,9692
00878,國泰永續高股息,113,36,77,富邦-嘉義,2024-01-09,9692
6187,萬潤,84,10,74,富邦-嘉義,2024-01-09,9692
5426,振發,74,3,71,富邦-嘉義,2024-01-09,9692
2637,慧洋-KY,99,39,60,富邦-嘉義,2024-01-09,9692
2367,燿華,63,5,58,富邦-嘉義,2024-01-09,9692
6531,愛普*,114,57,57,富邦-嘉義,2024-01-09,9692
2002,中鋼,65,8,57,富邦-嘉義,2024-01-09,9692
00927,群益半導體收益,66,10,56,富邦-嘉義,2024-01-09,9692
1522,堤維西,51,0,51,富邦-嘉義,2024-01-09,9692
3499,環天科,50,1,49,富邦-嘉義,2024-01-09,9692
6546,正基,50,2,48,富邦-嘉義,2024-01-09,9692
2405,輔信,47,1,46,富邦-嘉義,2024-01-09,9692
6770,力積電,89,45,44,富邦-嘉義,2024-01-09,9692
5533,皇鼎,42,0,42,富邦-嘉義,2024-01-09,9692
2610,華航,49,7,42,富邦-嘉義,2024-01-09,9692
2324,仁寶,78,38,40,富邦-嘉義,2024-01-09,9692
1605,華新,44,5,39,富邦-嘉義,2024-01-09,9692
2897,王道銀行,38,0,38,富邦-嘉義,2024-01-09,9692
00753L,中信中國50正2,35,0,35,富邦-嘉義,2024-01-09,9692
1722,台肥,35,0,35,富邦-嘉義,2024-01-09,9692
6462,神盾,78,46,32,富邦-嘉義,2024-01-09,9692
8096,擎亞,199,167,32,富邦-嘉義,2024-01-09,9692
6163,華電網,32,0,32,富邦-嘉義,2024-01-09,9692
2014,中鴻,31,0,31,富邦-嘉義,2024-01-09,9692
4533,協易機,39,9,30,富邦-嘉義,2024-01-09,9692
2634,漢翔,32,4,28,富邦-嘉義,2024-01-09,9692
5309,系統電,41,13,28,富邦-嘉義,2024-01-09,9692
3051,力特,35,8,27,富邦-嘉義,2024-01-09,9692
8111,立��,504,478,26,富邦-嘉義,2024-01-09,9692
5355,佳總,26,1,25,富邦-嘉義,2024-01-09,9692
2601,益航,25,0,25,富邦-嘉義,2024-01-09,9692
8930,青鋼,25,0,25,富邦-嘉義,2024-01-09,9692
2486,一詮,28,4,24,富邦-嘉義,2024-01-09,9692
2641,正德,34,10,24,富邦-嘉義,2024-01-09,9692
00931B,統一美債20年,31,7,24,富邦-嘉義,2024-01-09,9692
1582,信錦,24,1,23,富邦-嘉義,2024-01-09,9692
3047,訊舟,22,0,22,富邦-嘉義,2024-01-09,9692
6244,茂迪,23,1,22,富邦-嘉義,2024-01-09,9692
8096,擎亞,1187,723,464,富邦-嘉義,2024-01-10,9692
6120,達運,839,444,395,富邦-嘉義,2024-01-10,9692
6140,訊達,378,165,213,富邦-嘉義,2024-01-10,9692
00929,復華台灣科技優息,196,8,188,富邦-嘉義,2024-01-10,9692
00688L,國泰20年美債正2,120,0,120,富邦-嘉義,2024-01-10,9692
00679B,元大美債20年,114,0,114,富邦-嘉義,2024-01-10,9692
00919,群益台灣精選高息,143,30,113,富邦-嘉義,2024-01-10,9692
6695,芯鼎,770,658,112,富邦-嘉義,2024-01-10,9692
2609,陽明,450,352,98,富邦-嘉義,2024-01-10,9692
9105,泰金寶-DR,95,4,91,富邦-嘉義,2024-01-10,9692
6684,安格,475,392,83,富邦-嘉義,2024-01-10,9692
2357,華碩,87,6,81,富邦-嘉義,2024-01-10,9692
00751B,元大AAA至A公司債,82,1,81,富邦-嘉義,2024-01-10,9692
2382,廣達,102,21,81,富邦-嘉義,2024-01-10,9692
00882,中信中國高股息,71,0,71,富邦-嘉義,2024-01-10,9692
3481,群創,91,21,70,富邦-嘉義,2024-01-10,9692
5426,振發,162,94,68,富邦-嘉義,2024-01-10,9692
1722,台肥,62,0,62,富邦-嘉義,2024-01-10,9692
2615,萬海,80,22,58,富邦-嘉義,2024-01-10,9692
6770,力積電,65,8,57,富邦-嘉義,2024-01-10,9692
3025,星通,87,31,56,富邦-嘉義,2024-01-10,9692
2371,大同,153,99,54,富邦-嘉義,2024-01-10,9692
3706,神達,94,40,54,富邦-嘉義,2024-01-10,9692
00680L,元大美債20正2,54,2,52,富邦-嘉義,2024-01-10,9692
2323,中環,63,12,51,富邦-嘉義,2024-01-10,9692
1313,聯成,51,0,51,富邦-嘉義,2024-01-10,9692
3548,兆利,71,23,48,富邦-嘉義,2024-01-10,9692
00933B,國泰10Y+金融債,67,20,47,富邦-嘉義,2024-01-10,9692
8054,安國,66,20,46,富邦-嘉義,2024-01-10,9692
00687B,國泰20年美債,51,6,45,富邦-嘉義,2024-01-10,9692
2618,長榮航,100,56,44,富邦-嘉義,2024-01-10,9692
6113,亞矽,194,150,44,富邦-嘉義,2024-01-10,9692
0056,元大高股息,54,12,42,富邦-嘉義,2024-01-10,9692
2485,兆赫,42,0,42,富邦-嘉義,2024-01-10,9692
1314,中石化,51,10,41,富邦-嘉義,2024-01-10,9692
00878,國泰永續高股息,51,10,41,富邦-嘉義,2024-01-10,9692
2356,英業達,86,48,38,富邦-嘉義,2024-01-10,9692
00937B,群益ESG投等債20,42,4,38,富邦-嘉義,2024-01-10,9692
2301,光寶科,37,1,36,富邦-嘉義,2024-01-10,9692
2312,金寶,35,0,35,富邦-嘉義,2024-01-10,9692
2324,仁寶,48,16,32,富邦-嘉義,2024-01-10,9692
9907,統一實,33,2,31,富邦-嘉義,2024-01-10,9692
2641,正德,35,4,31,富邦-嘉義,2024-01-10,9692
00927,群益半導體收益,31,0,31,富邦-嘉義,2024-01-10,9692
2498,宏達電,38,7,31,富邦-嘉義,2024-01-10,9692
5876,上海商銀,30,0,30,富邦-嘉義,2024-01-10,9692
5457,宣德,30,0,30,富邦-嘉義,2024-01-10,9692
1718,中纖,29,0,29,富邦-嘉義,2024-01-10,9692
2603,長榮,142,114,28,富邦-嘉義,2024-01-10,9692
2450,神腦,25,0,25,富邦-嘉義,2024-01-10,9692
2356,英業達,465,88,377,富邦-嘉義,2024-01-11,9692
8096,擎亞,1622,1296,326,富邦-嘉義,2024-01-11,9692
5426,振發,431,188,243,富邦-嘉義,2024-01-11,9692
1528,恩德,202,4,198,富邦-嘉義,2024-01-11,9692
3622,洋華,265,81,184,富邦-嘉義,2024-01-11,9692
00929,復華台灣科技優息,204,27,177,富邦-嘉義,2024-01-11,9692
3706,神達,290,122,168,富邦-嘉義,2024-01-11,9692
6451,訊芯-KY,560,396,164,富邦-嘉義,2024-01-11,9692
2382,廣達,196,71,125,富邦-嘉義,2024-01-11,9692
00919,群益台灣精選高息,112,9,103,富邦-嘉義,2024-01-11,9692
00671R,富邦NASDAQ反1,100,0,100,富邦-嘉義,2024-01-11,9692
00712,復華富時不動產,95,3,92,富邦-嘉義,2024-01-11,9692
00665L,富邦�琤肭磪囓�2,190,100,90,富邦-嘉義,2024-01-11,9692
6533,晶心科,81,3,78,富邦-嘉義,2024-01-11,9692
1312,國喬,68,1,67,富邦-嘉義,2024-01-11,9692
2329,華泰,131,73,58,富邦-嘉義,2024-01-11,9692
00934,中信成長高股息,57,1,56,富邦-嘉義,2024-01-11,9692
3363,上詮,68,15,53,富邦-嘉義,2024-01-11,9692
00937B,群益ESG投等債20,52,0,52,富邦-嘉義,2024-01-11,9692
2423,固緯,61,10,51,富邦-嘉義,2024-01-11,9692
5355,佳總,47,0,47,富邦-嘉義,2024-01-11,9692
2409,友達,80,35,45,富邦-嘉義,2024-01-11,9692
2353,宏��,107,62,45,富邦-嘉義,2024-01-11,9692
2371,大同,89,45,44,富邦-嘉義,2024-01-11,9692
6116,彩晶,58,16,42,富邦-嘉義,2024-01-11,9692
6874,倍力,41,0,41,富邦-嘉義,2024-01-11,9692
5258,虹堡,68,29,39,富邦-嘉義,2024-01-11,9692
2303,聯電,46,7,39,富邦-嘉義,2024-01-11,9692
00770,國泰北美科技,38,0,38,富邦-嘉義,2024-01-11,9692
2376,技嘉,449,411,38,富邦-嘉義,2024-01-11,9692
00715L,期街口布蘭特正2,45,8,37,富邦-嘉義,2024-01-11,9692
3694,海華,37,2,35,富邦-嘉義,2024-01-11,9692
00927,群益半導體收益,34,0,34,富邦-嘉義,2024-01-11,9692
3025,星通,941,907,34,富邦-嘉義,2024-01-11,9692
00930,永豐ESG低碳高息,33,0,33,富邦-嘉義,2024-01-11,9692
00633L,富邦上証正2,30,0,30,富邦-嘉義,2024-01-11,9692
2344,華邦電,50,20,30,富邦-嘉義,2024-01-11,9692
2387,精元,30,1,29,富邦-嘉義,2024-01-11,9692
00679B,元大美債20年,28,0,28,富邦-嘉義,2024-01-11,9692
1301,台塑,33,5,28,富邦-嘉義,2024-01-11,9692
3017,奇鋐,250,222,28,富邦-嘉義,2024-01-11,9692
5469,瀚宇博,31,3,28,富邦-嘉義,2024-01-11,9692
2317,鴻海,37,10,27,富邦-嘉義,2024-01-11,9692
3501,維熹,25,0,25,富邦-嘉義,2024-01-11,9692
2002,中鋼,26,2,24,富邦-嘉義,2024-01-11,9692
2449,京元電子,33,9,24,富邦-嘉義,2024-01-11,9692
8089,康全電訊,37,13,24,富邦-嘉義,2024-01-11,9692
5521,工信,26,2,24,富邦-嘉義,2024-01-11,9692
2313,華通,55,31,24,富邦-嘉義,2024-01-11,9692
3006,晶豪科,30,7,23,富邦-嘉義,2024-01-11,9692
00673R,期元大S＆P原油反1,360,0,360,富邦-嘉義,2024-01-12,9692
3231,緯創,964,625,339,富邦-嘉義,2024-01-12,9692
00929,復華台灣科技優息,366,76,290,富邦-嘉義,2024-01-12,9692
2329,華泰,266,55,211,富邦-嘉義,2024-01-12,9692
00904,新光臺灣半導體30,129,4,125,富邦-嘉義,2024-01-12,9692
2353,宏��,243,137,106,富邦-嘉義,2024-01-12,9692
6116,彩晶,113,11,102,富邦-嘉義,2024-01-12,9692
2867,三商壽,100,5,95,富邦-嘉義,2024-01-12,9692
6120,達運,152,68,84,富邦-嘉義,2024-01-12,9692
2611,志信,83,1,82,富邦-嘉義,2024-01-12,9692
4909,新復興,381,301,80,富邦-嘉義,2024-01-12,9692
6770,力積電,98,21,77,富邦-嘉義,2024-01-12,9692
00937B,群益ESG投等債20,102,27,75,富邦-嘉義,2024-01-12,9692
0056,元大高股息,81,12,69,富邦-嘉義,2024-01-12,9692
2515,中工,122,53,69,富邦-嘉義,2024-01-12,9692
00919,群益台灣精選高息,86,20,66,富邦-嘉義,2024-01-12,9692
2344,華邦電,76,10,66,富邦-嘉義,2024-01-12,9692
2324,仁寶,69,6,63,富邦-嘉義,2024-01-12,9692
8034,榮群,93,34,59,富邦-嘉義,2024-01-12,9692
2501,國建,56,0,56,富邦-嘉義,2024-01-12,9692
4904,遠傳,55,0,55,富邦-嘉義,2024-01-12,9692
2801,彰銀,52,0,52,富邦-嘉義,2024-01-12,9692
8201,無敵,45,1,44,富邦-嘉義,2024-01-12,9692
3714,富采,40,0,40,富邦-嘉義,2024-01-12,9692
2317,鴻海,45,10,35,富邦-嘉義,2024-01-12,9692
00927,群益半導體收益,34,0,34,富邦-嘉義,2024-01-12,9692
1325,恆大,41,8,33,富邦-嘉義,2024-01-12,9692
6668,中揚光,35,2,33,富邦-嘉義,2024-01-12,9692
2401,凌陽,36,4,32,富邦-嘉義,2024-01-12,9692
2834,臺企銀,30,0,30,富邦-嘉義,2024-01-12,9692
3481,群創,45,17,28,富邦-嘉義,2024-01-12,9692
00687B,國泰20年美債,31,4,27,富邦-嘉義,2024-01-12,9692
8150,南茂,31,5,26,富邦-嘉義,2024-01-12,9692
2303,聯電,44,19,25,富邦-嘉義,2024-01-12,9692
2365,昆盈,34,10,24,富邦-嘉義,2024-01-12,9692
5225,東科-KY,25,1,24,富邦-嘉義,2024-01-12,9692
1303,南亞,35,12,23,富邦-嘉義,2024-01-12,9692
8176,智捷,23,0,23,富邦-嘉義,2024-01-12,9692
6217,中探針,22,0,22,富邦-嘉義,2024-01-12,9692
3055,蔚華科,25,3,22,富邦-嘉義,2024-01-12,9692
2444,兆勁,22,0,22,富邦-嘉義,2024-01-12,9692
2208,台船,50,29,21,富邦-嘉義,2024-01-12,9692
00918,大華優利高填息30,21,0,21,富邦-嘉義,2024-01-12,9692
1815,富喬,22,1,21,富邦-嘉義,2024-01-12,9692
2888,新光金,57,36,21,富邦-嘉義,2024-01-12,9692
1605,華新,20,0,20,富邦-嘉義,2024-01-12,9692
3583,辛耘,20,0,20,富邦-嘉義,2024-01-12,9692
00679B,元大美債20年,19,0,19,富邦-嘉義,2024-01-12,9692
2383,台光電,22,4,18,富邦-嘉義,2024-01-12,9692
4402,郡都開發,18,0,18,富邦-嘉義,2024-01-12,9692
2486,一詮,2283,1634,649,富邦-嘉義,2024-01-15,9692
6140,訊達,899,602,297,富邦-嘉義,2024-01-15,9692
6695,芯鼎,577,289,288,富邦-嘉義,2024-01-15,9692
6243,迅杰,795,526,269,富邦-嘉義,2024-01-15,9692
8096,擎亞,1135,884,251,富邦-嘉義,2024-01-15,9692
2888,新光金,252,2,250,富邦-嘉義,2024-01-15,9692
00929,復華台灣科技優息,266,77,189,富邦-嘉義,2024-01-15,9692
6120,達運,319,131,188,富邦-嘉義,2024-01-15,9692
0056,元大高股息,196,21,175,富邦-嘉義,2024-01-15,9692
3287,廣寰科,182,17,165,富邦-嘉義,2024-01-15,9692
2301,光寶科,151,2,149,富邦-嘉義,2024-01-15,9692
3712,永崴投控,149,6,143,富邦-嘉義,2024-01-15,9692
8210,勤誠,161,18,143,富邦-嘉義,2024-01-15,9692
6684,安格,353,214,139,富邦-嘉義,2024-01-15,9692
3025,星通,144,24,120,富邦-嘉義,2024-01-15,9692
3694,海華,257,149,108,富邦-嘉義,2024-01-15,9692
2356,英業達,108,8,100,富邦-嘉義,2024-01-15,9692
2812,台中銀,100,1,99,富邦-嘉義,2024-01-15,9692
2801,彰銀,98,0,98,富邦-嘉義,2024-01-15,9692
2618,長榮航,184,87,97,富邦-嘉義,2024-01-15,9692
2208,台船,90,6,84,富邦-嘉義,2024-01-15,9692
6113,亞矽,209,130,79,富邦-嘉義,2024-01-15,9692
00878,國泰永續高股息,89,17,72,富邦-嘉義,2024-01-15,9692
6451,訊芯-KY,278,207,71,富邦-嘉義,2024-01-15,9692
00671R,富邦NASDAQ反1,70,0,70,富邦-嘉義,2024-01-15,9692
2610,華航,73,6,67,富邦-嘉義,2024-01-15,9692
5426,振發,410,345,65,富邦-嘉義,2024-01-15,9692
2405,輔信,82,17,65,富邦-嘉義,2024-01-15,9692
2883,凱基金,63,2,61,富邦-嘉義,2024-01-15,9692
5398,慕康生醫,59,0,59,富邦-嘉義,2024-01-15,9692
2353,宏��,114,57,57,富邦-嘉義,2024-01-15,9692
00725B,國泰投資級公司債,54,1,53,富邦-嘉義,2024-01-15,9692
3437,榮創,81,28,53,富邦-嘉義,2024-01-15,9692
6139,亞翔,74,23,51,富邦-嘉義,2024-01-15,9692
2409,友達,51,2,49,富邦-嘉義,2024-01-15,9692
8054,安國,125,76,49,富邦-嘉義,2024-01-15,9692
00632R,元大台灣50反1,130,84,46,富邦-嘉義,2024-01-15,9692
3363,上詮,54,8,46,富邦-嘉義,2024-01-15,9692
6443,元晶,81,39,42,富邦-嘉義,2024-01-15,9692
6698,旭暉應材,40,2,38,富邦-嘉義,2024-01-15,9692
3622,洋華,51,17,34,富邦-嘉義,2024-01-15,9692
6669,緯穎,52,18,34,富邦-嘉義,2024-01-15,9692
3036,文曄,40,8,32,富邦-嘉義,2024-01-15,9692
4934,太極,49,19,30,富邦-嘉義,2024-01-15,9692
2890,永豐金,30,1,29,富邦-嘉義,2024-01-15,9692
2382,廣達,123,95,28,富邦-嘉義,2024-01-15,9692
00927,群益半導體收益,27,0,27,富邦-嘉義,2024-01-15,9692
8027,鈦昇,401,375,26,富邦-嘉義,2024-01-15,9692
00679B,元大美債20年,33,7,26,富邦-嘉義,2024-01-15,9692
6179,亞通,25,0,25,富邦-嘉義,2024-01-15,9692
1528,恩德,855,323,532,富邦-嘉義,2024-01-16,9692
0056,元大高股息,342,20,322,富邦-嘉義,2024-01-16,9692
00929,復華台灣科技優息,265,66,199,富邦-嘉義,2024-01-16,9692
2801,彰銀,141,8,133,富邦-嘉義,2024-01-16,9692
2888,新光金,128,0,128,富邦-嘉義,2024-01-16,9692
00665L,富邦�琤肭磪囓�2,154,31,123,富邦-嘉義,2024-01-16,9692
3306,鼎天,121,10,111,富邦-嘉義,2024-01-16,9692
00919,群益台灣精選高息,138,34,104,富邦-嘉義,2024-01-16,9692
4939,亞電,126,25,101,富邦-嘉義,2024-01-16,9692
00937B,群益ESG投等債20,110,13,97,富邦-嘉義,2024-01-16,9692
3354,律勝,100,4,96,富邦-嘉義,2024-01-16,9692
1815,富喬,93,3,90,富邦-嘉義,2024-01-16,9692
00927,群益半導體收益,95,9,86,富邦-嘉義,2024-01-16,9692
2867,三商壽,85,0,85,富邦-嘉義,2024-01-16,9692
2324,仁寶,110,26,84,富邦-嘉義,2024-01-16,9692
6425,易發,155,74,81,富邦-嘉義,2024-01-16,9692
2002,中鋼,106,30,76,富邦-嘉義,2024-01-16,9692
2883,凱基金,94,19,75,富邦-嘉義,2024-01-16,9692
2610,華航,78,5,73,富邦-嘉義,2024-01-16,9692
00655L,國泰中國A50正2,242,170,72,富邦-嘉義,2024-01-16,9692
00878,國泰永續高股息,87,30,57,富邦-嘉義,2024-01-16,9692
1609,大亞,79,26,53,富邦-嘉義,2024-01-16,9692
00688L,國泰20年美債正2,47,0,47,富邦-嘉義,2024-01-16,9692
1326,台化,45,0,45,富邦-嘉義,2024-01-16,9692
2344,華邦電,66,22,44,富邦-嘉義,2024-01-16,9692
2887,台新金,44,2,42,富邦-嘉義,2024-01-16,9692
00679B,元大美債20年,43,4,39,富邦-嘉義,2024-01-16,9692
1301,台塑,42,3,39,富邦-嘉義,2024-01-16,9692
4906,正文,52,13,39,富邦-嘉義,2024-01-16,9692
00676R,富邦臺灣加權反1,40,2,38,富邦-嘉義,2024-01-16,9692
6669,緯穎,38,0,38,富邦-嘉義,2024-01-16,9692
3576,聯合再生,41,4,37,富邦-嘉義,2024-01-16,9692
6770,力積電,47,10,37,富邦-嘉義,2024-01-16,9692
00680L,元大美債20正2,37,2,35,富邦-嘉義,2024-01-16,9692
1718,中纖,35,0,35,富邦-嘉義,2024-01-16,9692
6806,森崴能源,37,3,34,富邦-嘉義,2024-01-16,9692
1605,華新,42,10,32,富邦-嘉義,2024-01-16,9692
3207,耀勝,34,2,32,富邦-嘉義,2024-01-16,9692
2601,益航,32,0,32,富邦-嘉義,2024-01-16,9692
2834,臺企銀,33,1,32,富邦-嘉義,2024-01-16,9692
00632R,元大台灣50反1,101,71,30,富邦-嘉義,2024-01-16,9692
00881,國泰台灣5G+,30,0,30,富邦-嘉義,2024-01-16,9692
2882,國泰金,31,2,29,富邦-嘉義,2024-01-16,9692
2371,大同,30,1,29,富邦-嘉義,2024-01-16,9692
3017,奇鋐,36,7,29,富邦-嘉義,2024-01-16,9692
5880,合庫金,41,12,29,富邦-嘉義,2024-01-16,9692
00918,大華優利高填息30,29,0,29,富邦-嘉義,2024-01-16,9692
6233,旺玖,79,51,28,富邦-嘉義,2024-01-16,9692
00751B,元大AAA至A公司債,86,58,28,富邦-嘉義,2024-01-16,9692
5244,弘凱,31,5,26,富邦-嘉義,2024-01-16,9692
00753L,中信中國50正2,445,5,440,富邦-嘉義,2024-01-17,9692
00929,復華台灣科技優息,435,32,403,富邦-嘉義,2024-01-17,9692
0056,元大高股息,407,12,395,富邦-嘉義,2024-01-17,9692
00882,中信中國高股息,319,7,312,富邦-嘉義,2024-01-17,9692
00919,群益台灣精選高息,384,80,304,富邦-嘉義,2024-01-17,9692
00904,新光臺灣半導體30,196,0,196,富邦-嘉義,2024-01-17,9692
2303,聯電,169,12,157,富邦-嘉義,2024-01-17,9692
00937B,群益ESG投等債20,150,10,140,富邦-嘉義,2024-01-17,9692
6770,力積電,138,0,138,富邦-嘉義,2024-01-17,9692
2892,第一金,127,0,127,富邦-嘉義,2024-01-17,9692
4956,光鋐,431,315,116,富邦-嘉義,2024-01-17,9692
2801,彰銀,112,0,112,富邦-嘉義,2024-01-17,9692
2867,三商壽,141,32,109,富邦-嘉義,2024-01-17,9692
4414,如興,108,0,108,富邦-嘉義,2024-01-17,9692
3576,聯合再生,111,8,103,富邦-嘉義,2024-01-17,9692
8096,擎亞,849,755,94,富邦-嘉義,2024-01-17,9692
00720B,元大投資級公司債,93,0,93,富邦-嘉義,2024-01-17,9692
2002,中鋼,106,15,91,富邦-嘉義,2024-01-17,9692
00878,國泰永續高股息,120,29,91,富邦-嘉義,2024-01-17,9692
00655L,國泰中國A50正2,95,10,85,富邦-嘉義,2024-01-17,9692
2353,宏��,146,65,81,富邦-嘉義,2024-01-17,9692
2367,燿華,80,0,80,富邦-嘉義,2024-01-17,9692
2888,新光金,114,36,78,富邦-嘉義,2024-01-17,9692
2371,大同,83,7,76,富邦-嘉義,2024-01-17,9692
6451,訊芯-KY,204,128,76,富邦-嘉義,2024-01-17,9692
3005,神基,70,1,69,富邦-嘉義,2024-01-17,9692
2883,凱基金,71,4,67,富邦-嘉義,2024-01-17,9692
2344,華邦電,90,25,65,富邦-嘉義,2024-01-17,9692
2618,長榮航,102,38,64,富邦-嘉義,2024-01-17,9692
2382,廣達,139,77,62,富邦-嘉義,2024-01-17,9692
2356,英業達,87,28,59,富邦-嘉義,2024-01-17,9692
9904,寶成,58,0,58,富邦-嘉義,2024-01-17,9692
00927,群益半導體收益,73,17,56,富邦-嘉義,2024-01-17,9692
2884,玉山金,56,1,55,富邦-嘉義,2024-01-17,9692
3265,台星科,60,6,54,富邦-嘉義,2024-01-17,9692
1605,華新,89,38,51,富邦-嘉義,2024-01-17,9692
00688L,國泰20年美債正2,49,0,49,富邦-嘉義,2024-01-17,9692
1314,中石化,49,0,49,富邦-嘉義,2024-01-17,9692
6535,順藥,53,5,48,富邦-嘉義,2024-01-17,9692
3702,大聯大,52,4,48,富邦-嘉義,2024-01-17,9692
3360,尚立,45,0,45,富邦-嘉義,2024-01-17,9692
1325,恆大,67,23,44,富邦-嘉義,2024-01-17,9692
2408,南亞科,45,1,44,富邦-嘉義,2024-01-17,9692
2329,華泰,115,71,44,富邦-嘉義,2024-01-17,9692
3006,晶豪科,53,9,44,富邦-嘉義,2024-01-17,9692
1718,中纖,42,0,42,富邦-嘉義,2024-01-17,9692
1815,富喬,40,0,40,富邦-嘉義,2024-01-17,9692
00679B,元大美債20年,59,22,37,富邦-嘉義,2024-01-17,9692
00770,國泰北美科技,37,1,36,富邦-嘉義,2024-01-17,9692
2323,中環,36,0,36,富邦-嘉義,2024-01-17,9692
00929,復華台灣科技優息,336,95,241,富邦-嘉義,2024-01-18,9692
0056,元大高股息,259,42,217,富邦-嘉義,2024-01-18,9692
6187,萬潤,207,6,201,富邦-嘉義,2024-01-18,9692
00919,群益台灣精選高息,193,28,165,富邦-嘉義,2024-01-18,9692
4960,誠美材,269,112,157,富邦-嘉義,2024-01-18,9692
3437,榮創,313,209,104,富邦-嘉義,2024-01-18,9692
2324,仁寶,220,123,97,富邦-嘉義,2024-01-18,9692
6117,迎廣,171,82,89,富邦-嘉義,2024-01-18,9692
2303,聯電,137,50,87,富邦-嘉義,2024-01-18,9692
2888,新光金,86,3,83,富邦-嘉義,2024-01-18,9692
00878,國泰永續高股息,134,61,73,富邦-嘉義,2024-01-18,9692
00882,中信中國高股息,68,10,58,富邦-嘉義,2024-01-18,9692
00937B,群益ESG投等債20,60,6,54,富邦-嘉義,2024-01-18,9692
5426,振發,692,643,49,富邦-嘉義,2024-01-18,9692
5328,華容,66,18,48,富邦-嘉義,2024-01-18,9692
1582,信錦,33,0,33,富邦-嘉義,2024-01-18,9692
4956,光鋐,138,105,33,富邦-嘉義,2024-01-18,9692
1301,台塑,53,20,33,富邦-嘉義,2024-01-18,9692
6669,緯穎,156,126,30,富邦-嘉義,2024-01-18,9692
00654R,富邦印度反1,30,0,30,富邦-嘉義,2024-01-18,9692
2405,輔信,44,14,30,富邦-嘉義,2024-01-18,9692
2323,中環,35,5,30,富邦-嘉義,2024-01-18,9692
1605,華新,34,6,28,富邦-嘉義,2024-01-18,9692
00680L,元大美債20正2,28,0,28,富邦-嘉義,2024-01-18,9692
2302,麗正,29,1,28,富邦-嘉義,2024-01-18,9692
6770,力積電,29,2,27,富邦-嘉義,2024-01-18,9692
2002,中鋼,28,2,26,富邦-嘉義,2024-01-18,9692
2610,華航,30,4,26,富邦-嘉義,2024-01-18,9692
8068,全達,25,0,25,富邦-嘉義,2024-01-18,9692
8059,凱碩,25,0,25,富邦-嘉義,2024-01-18,9692
00676R,富邦臺灣加權反1,25,0,25,富邦-嘉義,2024-01-18,9692
1101,台泥,26,2,24,富邦-嘉義,2024-01-18,9692
2884,玉山金,23,0,23,富邦-嘉義,2024-01-18,9692
3006,晶豪科,23,0,23,富邦-嘉義,2024-01-18,9692
1303,南亞,23,0,23,富邦-嘉義,2024-01-18,9692
2603,長榮,40,18,22,富邦-嘉義,2024-01-18,9692
3025,星通,157,135,22,富邦-嘉義,2024-01-18,9692
2887,台新金,24,2,22,富邦-嘉義,2024-01-18,9692
1713,國化,20,0,20,富邦-嘉義,2024-01-18,9692
3576,聯合再生,23,3,20,富邦-嘉義,2024-01-18,9692
3234,光環,20,0,20,富邦-嘉義,2024-01-18,9692
3652,精聯,21,1,20,富邦-嘉義,2024-01-18,9692
5498,凱崴,20,0,20,富邦-嘉義,2024-01-18,9692
5880,合庫金,20,1,19,富邦-嘉義,2024-01-18,9692
2409,友達,156,137,19,富邦-嘉義,2024-01-18,9692
4979,華星光,71,52,19,富邦-嘉義,2024-01-18,9692
00881,國泰台灣5G+,21,2,19,富邦-嘉義,2024-01-18,9692
4746,台耀,34,15,19,富邦-嘉義,2024-01-18,9692
4402,郡都開發,18,0,18,富邦-嘉義,2024-01-18,9692
2633,台灣高鐵,17,0,17,富邦-嘉義,2024-01-18,9692
00929,復華台灣科技優息,284,51,233,富邦-嘉義,2024-01-19,9692
00671R,富邦NASDAQ反1,180,1,179,富邦-嘉義,2024-01-19,9692
00878,國泰永續高股息,177,26,151,富邦-嘉義,2024-01-19,9692
00687B,國泰20年美債,149,9,140,富邦-嘉義,2024-01-19,9692
3520,華盈,352,225,127,富邦-嘉義,2024-01-19,9692
00720B,元大投資級公司債,122,0,122,富邦-嘉義,2024-01-19,9692
00937B,群益ESG投等債20,166,47,119,富邦-嘉義,2024-01-19,9692
3066,李洲,132,22,110,富邦-嘉義,2024-01-19,9692
00679B,元大美債20年,104,1,103,富邦-嘉義,2024-01-19,9692
00919,群益台灣精選高息,111,8,103,富邦-嘉義,2024-01-19,9692
6257,矽格,176,75,101,富邦-嘉義,2024-01-19,9692
1528,恩德,93,16,77,富邦-嘉義,2024-01-19,9692
5521,工信,72,2,70,富邦-嘉義,2024-01-19,9692
4960,誠美材,95,35,60,富邦-嘉義,2024-01-19,9692
2353,宏��,113,53,60,富邦-嘉義,2024-01-19,9692
00680L,元大美債20正2,129,70,59,富邦-嘉義,2024-01-19,9692
2610,華航,61,2,59,富邦-嘉義,2024-01-19,9692
0056,元大高股息,93,37,56,富邦-嘉義,2024-01-19,9692
1714,和桐,55,0,55,富邦-嘉義,2024-01-19,9692
00882,中信中國高股息,55,0,55,富邦-嘉義,2024-01-19,9692
1313,聯成,50,0,50,富邦-嘉義,2024-01-19,9692
2002,中鋼,60,12,48,富邦-嘉義,2024-01-19,9692
3580,友威科,51,5,46,富邦-嘉義,2024-01-19,9692
2409,友達,119,73,46,富邦-嘉義,2024-01-19,9692
2880,華南金,45,0,45,富邦-嘉義,2024-01-19,9692
2324,仁寶,101,56,45,富邦-嘉義,2024-01-19,9692
3714,富采,44,0,44,富邦-嘉義,2024-01-19,9692
8034,榮群,83,40,43,富邦-嘉義,2024-01-19,9692
2618,長榮航,105,63,42,富邦-嘉義,2024-01-19,9692
3694,海華,58,18,40,富邦-嘉義,2024-01-19,9692
00927,群益半導體收益,82,42,40,富邦-嘉義,2024-01-19,9692
00632R,元大台灣50反1,140,101,39,富邦-嘉義,2024-01-19,9692
6140,訊達,263,227,36,富邦-嘉義,2024-01-19,9692
3706,神達,86,54,32,富邦-嘉義,2024-01-19,9692
00918,大華優利高填息30,32,0,32,富邦-嘉義,2024-01-19,9692
3479,安勤,31,0,31,富邦-嘉義,2024-01-19,9692
2609,陽明,60,31,29,富邦-嘉義,2024-01-19,9692
4909,新復興,39,11,28,富邦-嘉義,2024-01-19,9692
2405,輔信,32,5,27,富邦-嘉義,2024-01-19,9692
00857B,永豐20年美公債,25,0,25,富邦-嘉義,2024-01-19,9692
00673R,期元大S＆P原油反1,25,0,25,富邦-嘉義,2024-01-19,9692
3029,零壹,32,8,24,富邦-嘉義,2024-01-19,9692
2105,正新,28,6,22,富邦-嘉義,2024-01-19,9692
2486,一詮,31,10,21,富邦-嘉義,2024-01-19,9692
2812,台中銀,23,2,21,富邦-嘉義,2024-01-19,9692
4188,安克,23,2,21,富邦-嘉義,2024-01-19,9692
4938,和碩,23,2,21,富邦-嘉義,2024-01-19,9692
2882,國泰金,45,24,21,富邦-嘉義,2024-01-19,9692
00751B,元大AAA至A公司債,21,1,20,富邦-嘉義,2024-01-19,9692
2886,兆豐金,21,1,20,富邦-嘉義,2024-01-19,9692
00882,中信中國高股息,208,20,188,富邦-嘉義,2024-01-22,9692
00929,復華台灣科技優息,262,110,152,富邦-嘉義,2024-01-22,9692
00665L,富邦�琤肭磪囓�2,246,106,140,富邦-嘉義,2024-01-22,9692
00637L,元大滬深300正2,164,35,129,富邦-嘉義,2024-01-22,9692
00680L,元大美債20正2,130,3,127,富邦-嘉義,2024-01-22,9692
1101,台泥,117,4,113,富邦-嘉義,2024-01-22,9692
6140,訊達,189,111,78,富邦-嘉義,2024-01-22,9692
6125,廣運,141,76,65,富邦-嘉義,2024-01-22,9692
6668,中揚光,79,17,62,富邦-嘉義,2024-01-22,9692
2606,裕民,59,0,59,富邦-嘉義,2024-01-22,9692
6237,驊訊,117,58,59,富邦-嘉義,2024-01-22,9692
6770,力積電,59,2,57,富邦-嘉義,2024-01-22,9692
00933B,國泰10Y+金融債,56,0,56,富邦-嘉義,2024-01-22,9692
00900,富邦特選高股息30,85,29,56,富邦-嘉義,2024-01-22,9692
3005,神基,55,0,55,富邦-嘉義,2024-01-22,9692
00688L,國泰20年美債正2,54,0,54,富邦-嘉義,2024-01-22,9692
4402,郡都開發,53,0,53,富邦-嘉義,2024-01-22,9692
8040,九暘,66,20,46,富邦-嘉義,2024-01-22,9692
2353,宏��,162,118,44,富邦-嘉義,2024-01-22,9692
00937B,群益ESG投等債20,93,49,44,富邦-嘉義,2024-01-22,9692
00885,富邦越南,41,0,41,富邦-嘉義,2024-01-22,9692
1528,恩德,39,2,37,富邦-嘉義,2024-01-22,9692
3623,富晶通,56,19,37,富邦-嘉義,2024-01-22,9692
2634,漢翔,38,2,36,富邦-嘉義,2024-01-22,9692
2867,三商壽,35,0,35,富邦-嘉義,2024-01-22,9692
2887,台新金,41,9,32,富邦-嘉義,2024-01-22,9692
2313,華通,63,31,32,富邦-嘉義,2024-01-22,9692
2408,南亞科,37,6,31,富邦-嘉義,2024-01-22,9692
2618,長榮航,179,148,31,富邦-嘉義,2024-01-22,9692
2883,凱基金,39,8,31,富邦-嘉義,2024-01-22,9692
1447,力鵬,30,0,30,富邦-嘉義,2024-01-22,9692
6443,元晶,30,1,29,富邦-嘉義,2024-01-22,9692
00753L,中信中國50正2,28,0,28,富邦-嘉義,2024-01-22,9692
2344,華邦電,45,17,28,富邦-嘉義,2024-01-22,9692
2363,矽統,97,69,28,富邦-嘉義,2024-01-22,9692
00734B,台新JPM新興債,27,0,27,富邦-嘉義,2024-01-22,9692
5432,新門,72,46,26,富邦-嘉義,2024-01-22,9692
6113,亞矽,55,29,26,富邦-嘉義,2024-01-22,9692
8201,無敵,31,8,23,富邦-嘉義,2024-01-22,9692
3339,泰谷,41,18,23,富邦-嘉義,2024-01-22,9692
3715,定穎投控,37,14,23,富邦-嘉義,2024-01-22,9692
2603,長榮,534,512,22,富邦-嘉義,2024-01-22,9692
6111,大宇資,40,18,22,富邦-嘉義,2024-01-22,9692
00919,群益台灣精選高息,52,31,21,富邦-嘉義,2024-01-22,9692
00715L,期街口布蘭特正2,21,0,21,富邦-嘉義,2024-01-22,9692
2609,陽明,49,28,21,富邦-嘉義,2024-01-22,9692
2329,華泰,225,204,21,富邦-嘉義,2024-01-22,9692
2409,友達,30,9,21,富邦-嘉義,2024-01-22,9692
2905,三商,20,0,20,富邦-嘉義,2024-01-22,9692
2332,友訊,20,0,20,富邦-嘉義,2024-01-22,9692
3231,緯創,2749,620,2129,富邦-嘉義,2024-01-23,9692
8034,榮群,301,48,253,富邦-嘉義,2024-01-23,9692
2369,菱生,684,447,237,富邦-嘉義,2024-01-23,9692
00878,國泰永續高股息,489,252,237,富邦-嘉義,2024-01-23,9692
2356,英業達,478,343,135,富邦-嘉義,2024-01-23,9692
00937B,群益ESG投等債20,120,2,118,富邦-嘉義,2024-01-23,9692
3712,永崴投控,123,20,103,富邦-嘉義,2024-01-23,9692
00933B,國泰10Y+金融債,106,5,101,富邦-嘉義,2024-01-23,9692
3055,蔚華科,265,164,101,富邦-嘉義,2024-01-23,9692
6425,易發,128,30,98,富邦-嘉義,2024-01-23,9692
2888,新光金,103,6,97,富邦-嘉義,2024-01-23,9692
00673R,期元大S＆P原油反1,96,0,96,富邦-嘉義,2024-01-23,9692
1314,中石化,90,5,85,富邦-嘉義,2024-01-23,9692
2367,燿華,80,4,76,富邦-嘉義,2024-01-23,9692
2324,仁寶,113,39,74,富邦-嘉義,2024-01-23,9692
6669,緯穎,160,90,70,富邦-嘉義,2024-01-23,9692
5426,振發,1141,1072,69,富邦-嘉義,2024-01-23,9692
2609,陽明,92,26,66,富邦-嘉義,2024-01-23,9692
3354,律勝,100,41,59,富邦-嘉義,2024-01-23,9692
2467,志聖,59,1,58,富邦-嘉義,2024-01-23,9692
1447,力鵬,50,0,50,富邦-嘉義,2024-01-23,9692
00712,復華富時不動產,46,0,46,富邦-嘉義,2024-01-23,9692
00650L,復華香港正2,45,0,45,富邦-嘉義,2024-01-23,9692
00919,群益台灣精選高息,50,7,43,富邦-嘉義,2024-01-23,9692
2887,台新金,47,5,42,富邦-嘉義,2024-01-23,9692
00655L,國泰中國A50正2,56,20,36,富邦-嘉義,2024-01-23,9692
6113,亞矽,179,146,33,富邦-嘉義,2024-01-23,9692
8089,康全電訊,138,110,28,富邦-嘉義,2024-01-23,9692
00927,群益半導體收益,27,2,25,富邦-嘉義,2024-01-23,9692
2891,中信金,25,1,24,富邦-嘉義,2024-01-23,9692
3059,華晶科,76,53,23,富邦-嘉義,2024-01-23,9692
3380,明泰,41,19,22,富邦-嘉義,2024-01-23,9692
3041,揚智,24,2,22,富邦-嘉義,2024-01-23,9692
2382,廣達,88,66,22,富邦-嘉義,2024-01-23,9692
2002,中鋼,31,9,22,富邦-嘉義,2024-01-23,9692
6217,中探針,21,0,21,富邦-嘉義,2024-01-23,9692
2329,華泰,122,101,21,富邦-嘉義,2024-01-23,9692
6016,康和證,21,1,20,富邦-嘉義,2024-01-23,9692
2485,兆赫,20,0,20,富邦-嘉義,2024-01-23,9692
00687B,國泰20年美債,21,2,19,富邦-嘉義,2024-01-23,9692
2486,一詮,45,26,19,富邦-嘉義,2024-01-23,9692
9919,康那香,16,0,16,富邦-嘉義,2024-01-23,9692
6147,頎邦,17,2,15,富邦-嘉義,2024-01-23,9692
6593,台灣銘板,20,5,15,富邦-嘉義,2024-01-23,9692
00770,國泰北美科技,14,0,14,富邦-嘉義,2024-01-23,9692
2352,佳世達,28,14,14,富邦-嘉義,2024-01-23,9692
3260,威剛,14,1,13,富邦-嘉義,2024-01-23,9692
6462,神盾,223,210,13,富邦-嘉義,2024-01-23,9692
2534,宏盛,13,0,13,富邦-嘉義,2024-01-23,9692
1471,首利,13,0,13,富邦-嘉義,2024-01-23,9692
8096,擎亞,596,348,248,富邦-嘉義,2024-01-24,9692
00637L,元大滬深300正2,272,104,168,富邦-嘉義,2024-01-24,9692
00937B,群益ESG投等債20,168,3,165,富邦-嘉義,2024-01-24,9692
00665L,富邦�琤肭磪囓�2,195,43,152,富邦-嘉義,2024-01-24,9692
1314,中石化,105,0,105,富邦-嘉義,2024-01-24,9692
00720B,元大投資級公司債,103,1,102,富邦-嘉義,2024-01-24,9692
00687B,國泰20年美債,82,0,82,富邦-嘉義,2024-01-24,9692
00679B,元大美債20年,69,3,66,富邦-嘉義,2024-01-24,9692
3520,華盈,74,14,60,富邦-嘉義,2024-01-24,9692
2467,志聖,164,107,57,富邦-嘉義,2024-01-24,9692
3260,威剛,92,35,57,富邦-嘉義,2024-01-24,9692
6770,力積電,61,6,55,富邦-嘉義,2024-01-24,9692
6140,訊達,164,119,45,富邦-嘉義,2024-01-24,9692
00632R,元大台灣50反1,46,2,44,富邦-嘉義,2024-01-24,9692
5478,智冠,76,34,42,富邦-嘉義,2024-01-24,9692
4714,永捷,42,0,42,富邦-嘉義,2024-01-24,9692
3622,洋華,327,286,41,富邦-嘉義,2024-01-24,9692
2374,佳能,108,69,39,富邦-嘉義,2024-01-24,9692
00712,復華富時不動產,40,1,39,富邦-嘉義,2024-01-24,9692
2888,新光金,41,2,39,富邦-嘉義,2024-01-24,9692
2884,玉山金,35,0,35,富邦-嘉義,2024-01-24,9692
3017,奇鋐,59,24,35,富邦-嘉義,2024-01-24,9692
2324,仁寶,64,30,34,富邦-嘉義,2024-01-24,9692
9919,康那香,35,2,33,富邦-嘉義,2024-01-24,9692
00927,群益半導體收益,31,0,31,富邦-嘉義,2024-01-24,9692
4402,郡都開發,34,4,30,富邦-嘉義,2024-01-24,9692
00753L,中信中國50正2,29,1,28,富邦-嘉義,2024-01-24,9692
00673R,期元大S＆P原油反1,27,0,27,富邦-嘉義,2024-01-24,9692
3416,融程電,25,0,25,富邦-嘉義,2024-01-24,9692
00902,中信電池及儲能,24,0,24,富邦-嘉義,2024-01-24,9692
8467,波力-KY,30,6,24,富邦-嘉義,2024-01-24,9692
00680L,元大美債20正2,22,0,22,富邦-嘉義,2024-01-24,9692
2390,云辰,22,0,22,富邦-嘉義,2024-01-24,9692
6695,芯鼎,48,26,22,富邦-嘉義,2024-01-24,9692
00734B,台新JPM新興債,21,0,21,富邦-嘉義,2024-01-24,9692
3545,敦泰,108,87,21,富邦-嘉義,2024-01-24,9692
4306,炎洲,20,0,20,富邦-嘉義,2024-01-24,9692
5009,榮剛,25,5,20,富邦-嘉義,2024-01-24,9692
3037,欣興,29,11,18,富邦-嘉義,2024-01-24,9692
8059,凱碩,252,234,18,富邦-嘉義,2024-01-24,9692
00933B,國泰10Y+金融債,16,0,16,富邦-嘉義,2024-01-24,9692
3535,晶彩科,34,18,16,富邦-嘉義,2024-01-24,9692
3490,單井,130,114,16,富邦-嘉義,2024-01-24,9692
3036,文曄,30,14,16,富邦-嘉義,2024-01-24,9692
2409,友達,36,21,15,富邦-嘉義,2024-01-24,9692
8105,凌巨,40,26,14,富邦-嘉義,2024-01-24,9692
8210,勤誠,20,6,14,富邦-嘉義,2024-01-24,9692
8027,鈦昇,19,6,13,富邦-嘉義,2024-01-24,9692
3025,星通,39,26,13,富邦-嘉義,2024-01-24,9692
00688L,國泰20年美債正2,14,1,13,富邦-嘉義,2024-01-24,9692
3035,智原,572,249,323,富邦-嘉義,2024-01-25,9692
2618,長榮航,317,22,295,富邦-嘉義,2024-01-25,9692
2365,昆盈,593,315,278,富邦-嘉義,2024-01-25,9692
3694,海華,401,231,170,富邦-嘉義,2024-01-25,9692
00937B,群益ESG投等債20,198,35,163,富邦-嘉義,2024-01-25,9692
6229,研通,212,50,162,富邦-嘉義,2024-01-25,9692
00931B,統一美債20年,141,2,139,富邦-嘉義,2024-01-25,9692
00687B,國泰20年美債,134,0,134,富邦-嘉義,2024-01-25,9692
00882,中信中國高股息,181,49,132,富邦-嘉義,2024-01-25,9692
3481,群創,444,326,118,富邦-嘉義,2024-01-25,9692
3005,神基,126,14,112,富邦-嘉義,2024-01-25,9692
3066,李洲,151,46,105,富邦-嘉義,2024-01-25,9692
2356,英業達,269,167,102,富邦-嘉義,2024-01-25,9692
2359,所羅門,99,1,98,富邦-嘉義,2024-01-25,9692
00633L,富邦上証正2,96,14,82,富邦-嘉義,2024-01-25,9692
2405,輔信,142,60,82,富邦-嘉義,2024-01-25,9692
3623,富晶通,152,71,81,富邦-嘉義,2024-01-25,9692
00720B,元大投資級公司債,79,1,78,富邦-嘉義,2024-01-25,9692
00680L,元大美債20正2,66,0,66,富邦-嘉義,2024-01-25,9692
2301,光寶科,86,23,63,富邦-嘉義,2024-01-25,9692
00679B,元大美債20年,84,27,57,富邦-嘉義,2024-01-25,9692
00734B,台新JPM新興債,54,0,54,富邦-嘉義,2024-01-25,9692
2344,華邦電,62,8,54,富邦-嘉義,2024-01-25,9692
2610,華航,43,0,43,富邦-嘉義,2024-01-25,9692
6116,彩晶,47,6,41,富邦-嘉義,2024-01-25,9692
5398,慕康生醫,43,3,40,富邦-嘉義,2024-01-25,9692
00753L,中信中國50正2,77,41,36,富邦-嘉義,2024-01-25,9692
2485,兆赫,36,1,35,富邦-嘉義,2024-01-25,9692
4402,郡都開發,40,5,35,富邦-嘉義,2024-01-25,9692
4909,新復興,235,201,34,富邦-嘉義,2024-01-25,9692
00673R,期元大S＆P原油反1,34,0,34,富邦-嘉義,2024-01-25,9692
00712,復華富時不動產,32,0,32,富邦-嘉義,2024-01-25,9692
2634,漢翔,31,1,30,富邦-嘉義,2024-01-25,9692
6182,合晶,30,1,29,富邦-嘉義,2024-01-25,9692
2369,菱生,40,12,28,富邦-嘉義,2024-01-25,9692
2002,中鋼,30,2,28,富邦-嘉義,2024-01-25,9692
6108,競國,53,26,27,富邦-嘉義,2024-01-25,9692
2880,華南金,26,0,26,富邦-嘉義,2024-01-25,9692
2329,華泰,210,185,25,富邦-嘉義,2024-01-25,9692
3033,威健,27,3,24,富邦-嘉義,2024-01-25,9692
00795B,中信美國公債20年,22,0,22,富邦-嘉義,2024-01-25,9692
1524,耿鼎,22,1,21,富邦-嘉義,2024-01-25,9692
2511,太子,20,0,20,富邦-嘉義,2024-01-25,9692
1717,長興,20,0,20,富邦-嘉義,2024-01-25,9692
6196,帆宣,20,1,19,富邦-嘉義,2024-01-25,9692
2313,華通,62,44,18,富邦-嘉義,2024-01-25,9692
6462,神盾,50,32,18,富邦-嘉義,2024-01-25,9692
5244,弘凱,24,6,18,富邦-嘉義,2024-01-25,9692
2605,新興,18,0,18,富邦-嘉義,2024-01-25,9692
8390,金益鼎,17,0,17,富邦-嘉義,2024-01-25,9692
3231,緯創,1487,496,991,富邦-嘉義,2024-01-26,9692
2303,聯電,289,34,255,富邦-嘉義,2024-01-26,9692
00665L,富邦�琤肭磪囓�2,301,56,245,富邦-嘉義,2024-01-26,9692
00753L,中信中國50正2,135,1,134,富邦-嘉義,2024-01-26,9692
00919,群益台灣精選高息,121,5,116,富邦-嘉義,2024-01-26,9692
2431,聯昌,109,5,104,富邦-嘉義,2024-01-26,9692
1313,聯成,100,0,100,富邦-嘉義,2024-01-26,9692
2324,仁寶,138,45,93,富邦-嘉義,2024-01-26,9692
00673R,期元大S＆P原油反1,89,2,87,富邦-嘉義,2024-01-26,9692
00882,中信中國高股息,88,10,78,富邦-嘉義,2024-01-26,9692
00929,復華台灣科技優息,222,144,78,富邦-嘉義,2024-01-26,9692
2301,光寶科,73,3,70,富邦-嘉義,2024-01-26,9692
3024,憶聲,70,0,70,富邦-嘉義,2024-01-26,9692
00637L,元大滬深300正2,76,15,61,富邦-嘉義,2024-01-26,9692
00937B,群益ESG投等債20,86,28,58,富邦-嘉義,2024-01-26,9692
6116,彩晶,64,14,50,富邦-嘉義,2024-01-26,9692
00892,富邦台灣半導體,50,3,47,富邦-嘉義,2024-01-26,9692
3622,洋華,53,9,44,富邦-嘉義,2024-01-26,9692
00687B,國泰20年美債,44,1,43,富邦-嘉義,2024-01-26,9692
00650L,復華香港正2,50,8,42,富邦-嘉義,2024-01-26,9692
3360,尚立,519,479,40,富邦-嘉義,2024-01-26,9692
2353,宏��,90,54,36,富邦-嘉義,2024-01-26,9692
8085,福華,45,11,34,富邦-嘉義,2024-01-26,9692
9105,泰金寶-DR,87,56,31,富邦-嘉義,2024-01-26,9692
6546,正基,32,2,30,富邦-嘉義,2024-01-26,9692
3706,神達,40,10,30,富邦-嘉義,2024-01-26,9692
00923,群益台ESG低碳50,29,1,28,富邦-嘉義,2024-01-26,9692
2382,廣達,76,48,28,富邦-嘉義,2024-01-26,9692
00918,大華優利高填息30,30,3,27,富邦-嘉義,2024-01-26,9692
3535,晶彩科,72,46,26,富邦-嘉義,2024-01-26,9692
00679B,元大美債20年,26,0,26,富邦-嘉義,2024-01-26,9692
00688L,國泰20年美債正2,25,0,25,富邦-嘉義,2024-01-26,9692
00639,富邦深100,24,0,24,富邦-嘉義,2024-01-26,9692
9919,康那香,24,0,24,富邦-嘉義,2024-01-26,9692
3047,訊舟,24,1,23,富邦-嘉義,2024-01-26,9692
1732,毛寶,23,0,23,富邦-嘉義,2024-01-26,9692
6237,驊訊,41,18,23,富邦-嘉義,2024-01-26,9692
2801,彰銀,29,7,22,富邦-嘉義,2024-01-26,9692
2317,鴻海,40,18,22,富邦-嘉義,2024-01-26,9692
5905,南仁湖,21,0,21,富邦-嘉義,2024-01-26,9692
00725B,國泰投資級公司債,20,0,20,富邦-嘉義,2024-01-26,9692
2206,三陽工業,20,0,20,富邦-嘉義,2024-01-26,9692
4908,前鼎,22,2,20,富邦-嘉義,2024-01-26,9692
6180,橘子,20,0,20,富邦-嘉義,2024-01-26,9692
6120,達運,43,23,20,富邦-嘉義,2024-01-26,9692
3563,牧德,25,5,20,富邦-嘉義,2024-01-26,9692
8111,立��,71,52,19,富邦-嘉義,2024-01-26,9692
5347,世界,19,1,18,富邦-嘉義,2024-01-26,9692
5351,鈺創,21,4,17,富邦-嘉義,2024-01-26,9692
2323,中環,19,2,17,富邦-嘉義,2024-01-26,9692
6113,亞矽,1413,574,839,富邦-嘉義,2024-01-29,9692
3297,杭特,392,10,382,富邦-嘉義,2024-01-29,9692
00673R,期元大S＆P原油反1,239,0,239,富邦-嘉義,2024-01-29,9692
3231,緯創,566,348,218,富邦-嘉義,2024-01-29,9692
00937B,群益ESG投等債20,263,50,213,富邦-嘉義,2024-01-29,9692
00720B,元大投資級公司債,205,30,175,富邦-嘉義,2024-01-29,9692
4909,新復興,159,12,147,富邦-嘉義,2024-01-29,9692
2376,技嘉,148,11,137,富邦-嘉義,2024-01-29,9692
2618,長榮航,1314,1179,135,富邦-嘉義,2024-01-29,9692
2313,華通,185,53,132,富邦-嘉義,2024-01-29,9692
3694,海華,238,108,130,富邦-嘉義,2024-01-29,9692
6442,光聖,150,51,99,富邦-嘉義,2024-01-29,9692
6462,神盾,477,396,81,富邦-嘉義,2024-01-29,9692
9105,泰金寶-DR,96,17,79,富邦-嘉義,2024-01-29,9692
5426,振發,240,162,78,富邦-嘉義,2024-01-29,9692
2457,飛宏,65,2,63,富邦-嘉義,2024-01-29,9692
00650L,復華香港正2,69,10,59,富邦-嘉義,2024-01-29,9692
3434,哲固,65,7,58,富邦-嘉義,2024-01-29,9692
3615,安可,102,45,57,富邦-嘉義,2024-01-29,9692
00933B,國泰10Y+金融債,54,0,54,富邦-嘉義,2024-01-29,9692
1102,亞泥,55,3,52,富邦-嘉義,2024-01-29,9692
4529,淳紳,52,0,52,富邦-嘉義,2024-01-29,9692
2467,志聖,191,140,51,富邦-嘉義,2024-01-29,9692
00679B,元大美債20年,50,0,50,富邦-嘉義,2024-01-29,9692
5251,天鉞電,50,1,49,富邦-嘉義,2024-01-29,9692
3287,廣寰科,46,0,46,富邦-嘉義,2024-01-29,9692
00687B,國泰20年美債,45,0,45,富邦-嘉義,2024-01-29,9692
6140,訊達,58,14,44,富邦-嘉義,2024-01-29,9692
6425,易發,44,0,44,富邦-嘉義,2024-01-29,9692
8227,巨有科技,164,122,42,富邦-嘉義,2024-01-29,9692
3356,奇偶,40,0,40,富邦-嘉義,2024-01-29,9692
2303,聯電,55,15,40,富邦-嘉義,2024-01-29,9692
2610,華航,45,8,37,富邦-嘉義,2024-01-29,9692
1316,上曜,46,9,37,富邦-嘉義,2024-01-29,9692
2534,宏盛,35,0,35,富邦-嘉義,2024-01-29,9692
4906,正文,35,2,33,富邦-嘉義,2024-01-29,9692
5498,凱崴,29,0,29,富邦-嘉義,2024-01-29,9692
00665L,富邦�琤肭磪囓�2,26,0,26,富邦-嘉義,2024-01-29,9692
00919,群益台灣精選高息,31,7,24,富邦-嘉義,2024-01-29,9692
2344,華邦電,56,32,24,富邦-嘉義,2024-01-29,9692
3376,新日興,103,79,24,富邦-嘉義,2024-01-29,9692
5469,瀚宇博,29,6,23,富邦-嘉義,2024-01-29,9692
00751B,元大AAA至A公司債,25,4,21,富邦-嘉義,2024-01-29,9692
8111,立��,21,0,21,富邦-嘉義,2024-01-29,9692
8996,高力,22,1,21,富邦-嘉義,2024-01-29,9692
2882,國泰金,21,0,21,富邦-嘉義,2024-01-29,9692
2356,英業達,128,108,20,富邦-嘉義,2024-01-29,9692
8105,凌巨,21,2,19,富邦-嘉義,2024-01-29,9692
1605,華新,22,4,18,富邦-嘉義,2024-01-29,9692
8034,榮群,22,4,18,富邦-嘉義,2024-01-29,9692
3360,尚立,1985,1075,910,富邦-嘉義,2024-01-30,9692
00937B,群益ESG投等債20,252,5,247,富邦-嘉義,2024-01-30,9692
00933B,國泰10Y+金融債,241,0,241,富邦-嘉義,2024-01-30,9692
2369,菱生,1184,993,191,富邦-嘉義,2024-01-30,9692
2382,廣達,372,189,183,富邦-嘉義,2024-01-30,9692
3049,精金,172,0,172,富邦-嘉義,2024-01-30,9692
3481,群創,214,53,161,富邦-嘉義,2024-01-30,9692
8059,凱碩,198,49,149,富邦-嘉義,2024-01-30,9692
3055,蔚華科,282,168,114,富邦-嘉義,2024-01-30,9692
00655L,國泰中國A50正2,107,10,97,富邦-嘉義,2024-01-30,9692
2365,昆盈,115,19,96,富邦-嘉義,2024-01-30,9692
8489,三貝德,93,0,93,富邦-嘉義,2024-01-30,9692
00687B,國泰20年美債,88,2,86,富邦-嘉義,2024-01-30,9692
3354,律勝,91,7,84,富邦-嘉義,2024-01-30,9692
00637L,元大滬深300正2,175,92,83,富邦-嘉義,2024-01-30,9692
1101,台泥,87,5,82,富邦-嘉義,2024-01-30,9692
3017,奇鋐,372,304,68,富邦-嘉義,2024-01-30,9692
6139,亞翔,133,71,62,富邦-嘉義,2024-01-30,9692
6770,力積電,64,6,58,富邦-嘉義,2024-01-30,9692
00688L,國泰20年美債正2,57,0,57,富邦-嘉義,2024-01-30,9692
00882,中信中國高股息,61,5,56,富邦-嘉義,2024-01-30,9692
6217,中探針,68,13,55,富邦-嘉義,2024-01-30,9692
2888,新光金,58,7,51,富邦-嘉義,2024-01-30,9692
4729,熒茂,62,11,51,富邦-嘉義,2024-01-30,9692
2834,臺企銀,48,0,48,富邦-嘉義,2024-01-30,9692
2409,友達,62,14,48,富邦-嘉義,2024-01-30,9692
00679B,元大美債20年,61,13,48,富邦-嘉義,2024-01-30,9692
4908,前鼎,169,122,47,富邦-嘉義,2024-01-30,9692
00632R,元大台灣50反1,43,3,40,富邦-嘉義,2024-01-30,9692
3362,先進光,47,8,39,富邦-嘉義,2024-01-30,9692
1325,恆大,37,0,37,富邦-嘉義,2024-01-30,9692
8054,安國,368,332,36,富邦-嘉義,2024-01-30,9692
3312,弘憶股,38,4,34,富邦-嘉義,2024-01-30,9692
2344,華邦電,37,4,33,富邦-嘉義,2024-01-30,9692
8064,東捷,49,18,31,富邦-嘉義,2024-01-30,9692
00665L,富邦�琤肭磪囓�2,74,43,31,富邦-嘉義,2024-01-30,9692
3051,力特,30,0,30,富邦-嘉義,2024-01-30,9692
2421,建準,439,410,29,富邦-嘉義,2024-01-30,9692
1718,中纖,29,0,29,富邦-嘉義,2024-01-30,9692
00706L,期元大S＆P日圓正2,28,0,28,富邦-嘉義,2024-01-30,9692
00753L,中信中國50正2,48,20,28,富邦-嘉義,2024-01-30,9692
1722,台肥,37,12,25,富邦-嘉義,2024-01-30,9692
6265,方土昶,54,29,25,富邦-嘉義,2024-01-30,9692
2882,國泰金,29,5,24,富邦-嘉義,2024-01-30,9692
2059,川湖,25,2,23,富邦-嘉義,2024-01-30,9692
3047,訊舟,26,3,23,富邦-嘉義,2024-01-30,9692
2465,麗臺,31,8,23,富邦-嘉義,2024-01-30,9692
6451,訊芯-KY,59,37,22,富邦-嘉義,2024-01-30,9692
2615,萬海,22,0,22,富邦-嘉義,2024-01-30,9692
2486,一詮,39,17,22,富邦-嘉義,2024-01-30,9692
6265,方土昶,430,36,394,富邦-嘉義,2024-01-31,9692
2303,聯電,251,25,226,富邦-嘉義,2024-01-31,9692
00919,群益台灣精選高息,198,4,194,富邦-嘉義,2024-01-31,9692
8054,安國,397,218,179,富邦-嘉義,2024-01-31,9692
3049,精金,150,1,149,富邦-嘉義,2024-01-31,9692
3535,晶彩科,134,4,130,富邦-嘉義,2024-01-31,9692
00937B,群益ESG投等債20,149,20,129,富邦-嘉義,2024-01-31,9692
1732,毛寶,124,16,108,富邦-嘉義,2024-01-31,9692
1806,冠軍,100,0,100,富邦-嘉義,2024-01-31,9692
6684,安格,210,117,93,富邦-嘉義,2024-01-31,9692
00882,中信中國高股息,84,5,79,富邦-嘉義,2024-01-31,9692
00679B,元大美債20年,97,20,77,富邦-嘉義,2024-01-31,9692
2365,昆盈,211,135,76,富邦-嘉義,2024-01-31,9692
00688L,國泰20年美債正2,64,0,64,富邦-嘉義,2024-01-31,9692
0056,元大高股息,70,6,64,富邦-嘉義,2024-01-31,9692
00720B,元大投資級公司債,213,150,63,富邦-嘉義,2024-01-31,9692
3450,聯鈞,109,46,63,富邦-嘉義,2024-01-31,9692
8936,國統,205,143,62,富邦-嘉義,2024-01-31,9692
6530,創威,117,62,55,富邦-嘉義,2024-01-31,9692
3437,榮創,100,48,52,富邦-嘉義,2024-01-31,9692
2356,英業達,112,60,52,富邦-嘉義,2024-01-31,9692
6257,矽格,52,2,50,富邦-嘉義,2024-01-31,9692
6770,力積電,49,0,49,富邦-嘉義,2024-01-31,9692
2618,長榮航,43,4,39,富邦-嘉義,2024-01-31,9692
8111,立��,40,1,39,富邦-嘉義,2024-01-31,9692
3622,洋華,70,34,36,富邦-嘉義,2024-01-31,9692
00915,凱基優選高股息30,35,0,35,富邦-嘉義,2024-01-31,9692
9919,康那香,67,32,35,富邦-嘉義,2024-01-31,9692
6585,鼎基,54,20,34,富邦-嘉義,2024-01-31,9692
6462,神盾,252,219,33,富邦-嘉義,2024-01-31,9692
00933B,國泰10Y+金融債,38,5,33,富邦-嘉義,2024-01-31,9692
2323,中環,34,1,33,富邦-嘉義,2024-01-31,9692
00753L,中信中國50正2,81,50,31,富邦-嘉義,2024-01-31,9692
2002,中鋼,31,1,30,富邦-嘉義,2024-01-31,9692
4960,誠美材,50,20,30,富邦-嘉義,2024-01-31,9692
2353,宏��,45,16,29,富邦-嘉義,2024-01-31,9692
00877,復華中國5G,28,0,28,富邦-嘉義,2024-01-31,9692
3006,晶豪科,39,11,28,富邦-嘉義,2024-01-31,9692
3694,海華,107,79,28,富邦-嘉義,2024-01-31,9692
5426,振發,156,129,27,富邦-嘉義,2024-01-31,9692
8085,福華,47,21,26,富邦-嘉義,2024-01-31,9692
00850,元大臺灣ESG永續,25,0,25,富邦-嘉義,2024-01-31,9692
8040,九暘,125,103,22,富邦-嘉義,2024-01-31,9692
2888,新光金,41,19,22,富邦-嘉義,2024-01-31,9692
1514,亞力,45,25,20,富邦-嘉義,2024-01-31,9692
006205,富邦上証,20,0,20,富邦-嘉義,2024-01-31,9692
5356,協益,20,0,20,富邦-嘉義,2024-01-31,9692
2886,兆豐金,39,19,20,富邦-嘉義,2024-01-31,9692
00918,大華優利高填息30,20,0,20,富邦-嘉義,2024-01-31,9692
2330,台積電,31,12,19,富邦-嘉義,2024-01-31,9692
1528,恩德,1263,972,291,富邦-嘉義,2024-02-01,9692
2376,技嘉,235,16,219,富邦-嘉義,2024-02-01,9692
6265,方土昶,2184,1971,213,富邦-嘉義,2024-02-01,9692
3049,精金,164,0,164,富邦-嘉義,2024-02-01,9692
00720B,元大投資級公司債,264,123,141,富邦-嘉義,2024-02-01,9692
00712,復華富時不動產,127,0,127,富邦-嘉義,2024-02-01,9692
3615,安可,169,43,126,富邦-嘉義,2024-02-01,9692
00929,復華台灣科技優息,183,64,119,富邦-嘉義,2024-02-01,9692
00753L,中信中國50正2,102,0,102,富邦-嘉義,2024-02-01,9692
00919,群益台灣精選高息,111,21,90,富邦-嘉義,2024-02-01,9692
3287,廣寰科,241,155,86,富邦-嘉義,2024-02-01,9692
00687B,國泰20年美債,101,18,83,富邦-嘉義,2024-02-01,9692
5905,南仁湖,60,0,60,富邦-嘉義,2024-02-01,9692
2409,友達,99,42,57,富邦-嘉義,2024-02-01,9692
6229,研通,190,135,55,富邦-嘉義,2024-02-01,9692
4729,熒茂,57,7,50,富邦-嘉義,2024-02-01,9692
3481,群創,96,52,44,富邦-嘉義,2024-02-01,9692
1806,冠軍,50,6,44,富邦-嘉義,2024-02-01,9692
1815,富喬,41,0,41,富邦-嘉義,2024-02-01,9692
2353,宏��,48,8,40,富邦-嘉義,2024-02-01,9692
00878,國泰永續高股息,160,120,40,富邦-嘉義,2024-02-01,9692
9105,泰金寶-DR,41,2,39,富邦-嘉義,2024-02-01,9692
3622,洋華,166,128,38,富邦-嘉義,2024-02-01,9692
00937B,群益ESG投等債20,57,23,34,富邦-嘉義,2024-02-01,9692
00686R,群益臺灣加權反1,30,0,30,富邦-嘉義,2024-02-01,9692
3312,弘憶股,150,123,27,富邦-嘉義,2024-02-01,9692
3548,兆利,128,102,26,富邦-嘉義,2024-02-01,9692
2383,台光電,33,7,26,富邦-嘉義,2024-02-01,9692
6282,康舒,73,48,25,富邦-嘉義,2024-02-01,9692
00637L,元大滬深300正2,28,4,24,富邦-嘉義,2024-02-01,9692
8070,長華*,29,5,24,富邦-嘉義,2024-02-01,9692
6116,彩晶,66,42,24,富邦-嘉義,2024-02-01,9692
6113,亞矽,176,152,24,富邦-嘉義,2024-02-01,9692
00933B,國泰10Y+金融債,24,0,24,富邦-嘉義,2024-02-01,9692
2836,高雄銀,22,0,22,富邦-嘉義,2024-02-01,9692
3489,森寶,22,0,22,富邦-嘉義,2024-02-01,9692
5388,中磊,22,1,21,富邦-嘉義,2024-02-01,9692
2641,正德,21,0,21,富邦-嘉義,2024-02-01,9692
00882,中信中國高股息,44,23,21,富邦-嘉義,2024-02-01,9692
00922,國泰台灣領袖50,20,0,20,富邦-嘉義,2024-02-01,9692
2408,南亞科,20,0,20,富邦-嘉義,2024-02-01,9692
3441,聯一光,20,0,20,富邦-嘉義,2024-02-01,9692
1514,亞力,64,44,20,富邦-嘉義,2024-02-01,9692
3313,斐成,20,0,20,富邦-嘉義,2024-02-01,9692
6179,亞通,34,15,19,富邦-嘉義,2024-02-01,9692
6535,順藥,29,10,19,富邦-嘉義,2024-02-01,9692
00900,富邦特選高股息30,20,1,19,富邦-嘉義,2024-02-01,9692
00877,復華中國5G,19,0,19,富邦-嘉義,2024-02-01,9692
5347,世界,18,0,18,富邦-嘉義,2024-02-01,9692
2461,光群雷,21,3,18,富邦-嘉義,2024-02-01,9692
3231,緯創,2626,1916,710,富邦-嘉義,2024-02-02,9692
1528,恩德,1383,891,492,富邦-嘉義,2024-02-02,9692
00715L,期街口布蘭特正2,268,0,268,富邦-嘉義,2024-02-02,9692
00720B,元大投資級公司債,255,1,254,富邦-嘉義,2024-02-02,9692
2365,昆盈,1493,1329,164,富邦-嘉義,2024-02-02,9692
00937B,群益ESG投等債20,197,40,157,富邦-嘉義,2024-02-02,9692
2303,聯電,157,21,136,富邦-嘉義,2024-02-02,9692
1616,億泰,132,8,124,富邦-嘉義,2024-02-02,9692
00655L,國泰中國A50正2,130,20,110,富邦-嘉義,2024-02-02,9692
3011,今皓,109,2,107,富邦-嘉義,2024-02-02,9692
2352,佳世達,105,17,88,富邦-嘉義,2024-02-02,9692
2609,陽明,102,18,84,富邦-嘉義,2024-02-02,9692
2329,華泰,178,95,83,富邦-嘉義,2024-02-02,9692
00929,復華台灣科技優息,114,32,82,富邦-嘉義,2024-02-02,9692
3047,訊舟,219,144,75,富邦-嘉義,2024-02-02,9692
5381,合正,74,3,71,富邦-嘉義,2024-02-02,9692
3055,蔚華科,131,64,67,富邦-嘉義,2024-02-02,9692
00637L,元大滬深300正2,68,3,65,富邦-嘉義,2024-02-02,9692
00687B,國泰20年美債,91,27,64,富邦-嘉義,2024-02-02,9692
00772B,中信高評級公司債,67,3,64,富邦-嘉義,2024-02-02,9692
6770,力積電,68,13,55,富邦-嘉義,2024-02-02,9692
2421,建準,231,179,52,富邦-嘉義,2024-02-02,9692
00902,中信電池及儲能,45,2,43,富邦-嘉義,2024-02-02,9692
6113,亞矽,81,43,38,富邦-嘉義,2024-02-02,9692
3287,廣寰科,50,12,38,富邦-嘉義,2024-02-02,9692
8040,九暘,61,24,37,富邦-嘉義,2024-02-02,9692
00712,復華富時不動產,35,0,35,富邦-嘉義,2024-02-02,9692
6243,迅杰,225,192,33,富邦-嘉義,2024-02-02,9692
6233,旺玖,52,19,33,富邦-嘉義,2024-02-02,9692
00679B,元大美債20年,122,89,33,富邦-嘉義,2024-02-02,9692
4908,前鼎,86,55,31,富邦-嘉義,2024-02-02,9692
6282,康舒,50,19,31,富邦-嘉義,2024-02-02,9692
00882,中信中國高股息,30,0,30,富邦-嘉義,2024-02-02,9692
00734B,台新JPM新興債,30,0,30,富邦-嘉義,2024-02-02,9692
2408,南亞科,30,0,30,富邦-嘉義,2024-02-02,9692
6237,驊訊,44,15,29,富邦-嘉義,2024-02-02,9692
3530,晶相光,104,77,27,富邦-嘉義,2024-02-02,9692
6541,泰福-KY,26,0,26,富邦-嘉義,2024-02-02,9692
2486,一詮,27,1,26,富邦-嘉義,2024-02-02,9692
4906,正文,109,84,25,富邦-嘉義,2024-02-02,9692
2634,漢翔,28,3,25,富邦-嘉義,2024-02-02,9692
2891,中信金,25,1,24,富邦-嘉義,2024-02-02,9692
1303,南亞,31,7,24,富邦-嘉義,2024-02-02,9692
6584,南俊國際,36,12,24,富邦-嘉義,2024-02-02,9692
6125,廣運,34,11,23,富邦-嘉義,2024-02-02,9692
3324,雙鴻,140,117,23,富邦-嘉義,2024-02-02,9692
5364,力麗店,22,0,22,富邦-嘉義,2024-02-02,9692
8176,智捷,26,4,22,富邦-嘉義,2024-02-02,9692
2002,中鋼,36,15,21,富邦-嘉義,2024-02-02,9692
2603,長榮,22,1,21,富邦-嘉義,2024-02-02,9692
00715L,期街口布蘭特正2,379,6,373,富邦-嘉義,2024-02-05,9692
6246,臺龍,291,2,289,富邦-嘉義,2024-02-05,9692
00933B,國泰10Y+金融債,242,5,237,富邦-嘉義,2024-02-05,9692
00712,復華富時不動產,181,6,175,富邦-嘉義,2024-02-05,9692
4714,永捷,585,431,154,富邦-嘉義,2024-02-05,9692
3036,文曄,155,9,146,富邦-嘉義,2024-02-05,9692
00937B,群益ESG投等債20,186,46,140,富邦-嘉義,2024-02-05,9692
2303,聯電,173,37,136,富邦-嘉義,2024-02-05,9692
00679B,元大美債20年,161,26,135,富邦-嘉義,2024-02-05,9692
00720B,元大投資級公司債,122,0,122,富邦-嘉義,2024-02-05,9692
00680L,元大美債20正2,135,23,112,富邦-嘉義,2024-02-05,9692
00687B,國泰20年美債,130,22,108,富邦-嘉義,2024-02-05,9692
2365,昆盈,2807,2714,93,富邦-嘉義,2024-02-05,9692
00671R,富邦NASDAQ反1,90,0,90,富邦-嘉義,2024-02-05,9692
3011,今皓,72,3,69,富邦-嘉義,2024-02-05,9692
2889,國票金,66,1,65,富邦-嘉義,2024-02-05,9692
2356,英業達,144,79,65,富邦-嘉義,2024-02-05,9692
00882,中信中國高股息,64,0,64,富邦-嘉義,2024-02-05,9692
3287,廣寰科,105,41,64,富邦-嘉義,2024-02-05,9692
00632R,元大台灣50反1,63,0,63,富邦-嘉義,2024-02-05,9692
2913,農林,60,0,60,富邦-嘉義,2024-02-05,9692
3548,兆利,159,101,58,富邦-嘉義,2024-02-05,9692
2329,華泰,221,167,54,富邦-嘉義,2024-02-05,9692
6541,泰福-KY,50,0,50,富邦-嘉義,2024-02-05,9692
3047,訊舟,58,9,49,富邦-嘉義,2024-02-05,9692
2887,台新金,45,2,43,富邦-嘉義,2024-02-05,9692
00900,富邦特選高股息30,43,3,40,富邦-嘉義,2024-02-05,9692
1718,中纖,38,0,38,富邦-嘉義,2024-02-05,9692
1616,億泰,37,0,37,富邦-嘉義,2024-02-05,9692
2002,中鋼,41,5,36,富邦-嘉義,2024-02-05,9692
2485,兆赫,56,20,36,富邦-嘉義,2024-02-05,9692
6112,邁達特,141,108,33,富邦-嘉義,2024-02-05,9692
2884,玉山金,48,16,32,富邦-嘉義,2024-02-05,9692
3260,威剛,31,0,31,富邦-嘉義,2024-02-05,9692
2323,中環,36,5,31,富邦-嘉義,2024-02-05,9692
3689,湧德,30,0,30,富邦-嘉義,2024-02-05,9692
3605,宏致,32,2,30,富邦-嘉義,2024-02-05,9692
00772B,中信高評級公司債,32,3,29,富邦-嘉義,2024-02-05,9692
1605,華新,28,0,28,富邦-嘉義,2024-02-05,9692
6153,嘉聯益,42,15,27,富邦-嘉義,2024-02-05,9692
2534,宏盛,25,0,25,富邦-嘉義,2024-02-05,9692
6187,萬潤,31,6,25,富邦-嘉義,2024-02-05,9692
2027,大成鋼,23,0,23,富邦-嘉義,2024-02-05,9692
5381,合正,22,0,22,富邦-嘉義,2024-02-05,9692
00931B,統一美債20年,21,0,21,富邦-嘉義,2024-02-05,9692
2201,裕隆,22,2,20,富邦-嘉義,2024-02-05,9692
00795B,中信美國公債20年,20,0,20,富邦-嘉義,2024-02-05,9692
1611,中電,20,0,20,富邦-嘉義,2024-02-05,9692
8215,明基材,20,0,20,富邦-嘉義,2024-02-05,9692
1325,恆大,35,15,20,富邦-嘉義,2024-02-05,9692
2329,華泰,1831,1094,737,富邦-嘉義,2024-02-15,9692
00937B,群益ESG投等債20,512,23,489,富邦-嘉義,2024-02-15,9692
00933B,國泰10Y+金融債,396,50,346,富邦-嘉義,2024-02-15,9692
00679B,元大美債20年,325,18,307,富邦-嘉義,2024-02-15,9692
2376,技嘉,784,479,305,富邦-嘉義,2024-02-15,9692
6789,采鈺,287,1,286,富邦-嘉義,2024-02-15,9692
2365,昆盈,1155,877,278,富邦-嘉義,2024-02-15,9692
00687B,國泰20年美債,267,11,256,富邦-嘉義,2024-02-15,9692
00720B,元大投資級公司債,212,1,211,富邦-嘉義,2024-02-15,9692
3437,榮創,249,42,207,富邦-嘉義,2024-02-15,9692
00929,復華台灣科技優息,318,125,193,富邦-嘉義,2024-02-15,9692
00680L,元大美債20正2,197,10,187,富邦-嘉義,2024-02-15,9692
00673R,期元大S＆P原油反1,184,0,184,富邦-嘉義,2024-02-15,9692
00891,中信關鍵半導體,203,23,180,富邦-嘉義,2024-02-15,9692
3049,精金,169,2,167,富邦-嘉義,2024-02-15,9692
2344,華邦電,197,68,129,富邦-嘉義,2024-02-15,9692
5443,均豪,127,4,123,富邦-嘉義,2024-02-15,9692
00712,復華富時不動產,148,39,109,富邦-嘉義,2024-02-15,9692
6179,亞通,102,2,100,富邦-嘉義,2024-02-15,9692
00632R,元大台灣50反1,231,132,99,富邦-嘉義,2024-02-15,9692
3481,群創,175,80,95,富邦-嘉義,2024-02-15,9692
3483,力致,189,97,92,富邦-嘉義,2024-02-15,9692
2408,南亞科,84,4,80,富邦-嘉義,2024-02-15,9692
00650L,復華香港正2,85,12,73,富邦-嘉義,2024-02-15,9692
3324,雙鴻,146,79,67,富邦-嘉義,2024-02-15,9692
00931B,統一美債20年,66,0,66,富邦-嘉義,2024-02-15,9692
00882,中信中國高股息,76,10,66,富邦-嘉義,2024-02-15,9692
00795B,中信美國公債20年,61,0,61,富邦-嘉義,2024-02-15,9692
2913,農林,59,0,59,富邦-嘉義,2024-02-15,9692
6274,台燿,340,283,57,富邦-嘉義,2024-02-15,9692
00664R,國泰臺灣加權反1,55,0,55,富邦-嘉義,2024-02-15,9692
8936,國統,81,28,53,富邦-嘉義,2024-02-15,9692
00830,國泰費城半導體,52,2,50,富邦-嘉義,2024-02-15,9692
4729,熒茂,47,0,47,富邦-嘉義,2024-02-15,9692
2353,宏��,76,30,46,富邦-嘉義,2024-02-15,9692
2609,陽明,67,23,44,富邦-嘉義,2024-02-15,9692
4968,立積,183,140,43,富邦-嘉義,2024-02-15,9692
2486,一詮,62,20,42,富邦-嘉義,2024-02-15,9692
1785,光洋科,59,18,41,富邦-嘉義,2024-02-15,9692
5284,jpp-KY,46,9,37,富邦-嘉義,2024-02-15,9692
2515,中工,51,15,36,富邦-嘉義,2024-02-15,9692
00706L,期元大S＆P日圓正2,49,15,34,富邦-嘉義,2024-02-15,9692
9105,泰金寶-DR,50,16,34,富邦-嘉義,2024-02-15,9692
6494,九齊,55,24,31,富邦-嘉義,2024-02-15,9692
4532,瑞智,32,2,30,富邦-嘉義,2024-02-15,9692
6015,宏遠證,30,0,30,富邦-嘉義,2024-02-15,9692
2367,燿華,28,0,28,富邦-嘉義,2024-02-15,9692
6770,力積電,31,3,28,富邦-嘉義,2024-02-15,9692
8011,台通,27,1,26,富邦-嘉義,2024-02-15,9692
2399,映泰,260,235,25,富邦-嘉義,2024-02-15,9692
2369,菱生,2995,1968,1027,富邦-嘉義,2024-02-16,9692
00673R,期元大S＆P原油反1,979,0,979,富邦-嘉義,2024-02-16,9692
8096,擎亞,919,88,831,富邦-嘉義,2024-02-16,9692
5443,均豪,577,43,534,富邦-嘉義,2024-02-16,9692
4714,永捷,709,227,482,富邦-嘉義,2024-02-16,9692
00891,中信關鍵半導體,306,1,305,富邦-嘉義,2024-02-16,9692
5381,合正,407,135,272,富邦-嘉義,2024-02-16,9692
2467,志聖,286,64,222,富邦-嘉義,2024-02-16,9692
2888,新光金,323,106,217,富邦-嘉義,2024-02-16,9692
6789,采鈺,225,8,217,富邦-嘉義,2024-02-16,9692
00679B,元大美債20年,223,20,203,富邦-嘉義,2024-02-16,9692
3049,精金,168,3,165,富邦-嘉義,2024-02-16,9692
4909,新復興,211,65,146,富邦-嘉義,2024-02-16,9692
3234,光環,147,13,134,富邦-嘉義,2024-02-16,9692
00937B,群益ESG投等債20,126,0,126,富邦-嘉義,2024-02-16,9692
3360,尚立,164,51,113,富邦-嘉義,2024-02-16,9692
3055,蔚華科,138,26,112,富邦-嘉義,2024-02-16,9692
3363,上詮,353,245,108,富邦-嘉義,2024-02-16,9692
8210,勤誠,112,9,103,富邦-嘉義,2024-02-16,9692
00680L,元大美債20正2,117,17,100,富邦-嘉義,2024-02-16,9692
2059,川湖,102,6,96,富邦-嘉義,2024-02-16,9692
2382,廣達,1089,994,95,富邦-嘉義,2024-02-16,9692
6117,迎廣,100,5,95,富邦-嘉義,2024-02-16,9692
2204,中華,92,2,90,富邦-嘉義,2024-02-16,9692
00933B,國泰10Y+金融債,93,7,86,富邦-嘉義,2024-02-16,9692
2887,台新金,81,3,78,富邦-嘉義,2024-02-16,9692
00687B,國泰20年美債,156,80,76,富邦-嘉義,2024-02-16,9692
2405,輔信,146,73,73,富邦-嘉義,2024-02-16,9692
00720B,元大投資級公司債,70,0,70,富邦-嘉義,2024-02-16,9692
00712,復華富時不動產,70,0,70,富邦-嘉義,2024-02-16,9692
6425,易發,90,24,66,富邦-嘉義,2024-02-16,9692
00929,復華台灣科技優息,156,94,62,富邦-嘉義,2024-02-16,9692
6442,光聖,62,0,62,富邦-嘉義,2024-02-16,9692
4968,立積,164,110,54,富邦-嘉義,2024-02-16,9692
3147,大綜,61,9,52,富邦-嘉義,2024-02-16,9692
4979,華星光,52,2,50,富邦-嘉義,2024-02-16,9692
3025,星通,150,100,50,富邦-嘉義,2024-02-16,9692
1503,士電,240,195,45,富邦-嘉義,2024-02-16,9692
3715,定穎投控,46,3,43,富邦-嘉義,2024-02-16,9692
2303,聯電,110,68,42,富邦-嘉義,2024-02-16,9692
1785,光洋科,61,22,39,富邦-嘉義,2024-02-16,9692
00919,群益台灣精選高息,111,72,39,富邦-嘉義,2024-02-16,9692
2515,中工,48,10,38,富邦-嘉義,2024-02-16,9692
2363,矽統,138,103,35,富邦-嘉義,2024-02-16,9692
3372,典範,72,37,35,富邦-嘉義,2024-02-16,9692
1616,億泰,44,11,33,富邦-嘉義,2024-02-16,9692
5488,松普,35,2,33,富邦-嘉義,2024-02-16,9692
00795B,中信美國公債20年,31,0,31,富邦-嘉義,2024-02-16,9692
00857B,永豐20年美公債,31,0,31,富邦-嘉義,2024-02-16,9692
8110,華東,40,9,31,富邦-嘉義,2024-02-16,9692
8086,宏捷科,790,144,646,富邦-嘉義,2024-02-19,9692
2489,瑞軒,2417,1833,584,富邦-嘉義,2024-02-19,9692
00933B,國泰10Y+金融債,486,0,486,富邦-嘉義,2024-02-19,9692
6126,信音,761,395,366,富邦-嘉義,2024-02-19,9692
1455,集盛,353,17,336,富邦-嘉義,2024-02-19,9692
1806,冠軍,776,511,265,富邦-嘉義,2024-02-19,9692
8059,凱碩,230,3,227,富邦-嘉義,2024-02-19,9692
2460,建通,420,215,205,富邦-嘉義,2024-02-19,9692
2883,凱基金,242,44,198,富邦-嘉義,2024-02-19,9692
3712,永崴投控,369,176,193,富邦-嘉義,2024-02-19,9692
00673R,期元大S＆P原油反1,158,0,158,富邦-嘉義,2024-02-19,9692
3663,鑫科,147,4,143,富邦-嘉義,2024-02-19,9692
3047,訊舟,193,53,140,富邦-嘉義,2024-02-19,9692
00929,復華台灣科技優息,224,91,133,富邦-嘉義,2024-02-19,9692
2353,宏��,230,98,132,富邦-嘉義,2024-02-19,9692
00937B,群益ESG投等債20,173,47,126,富邦-嘉義,2024-02-19,9692
5315,光聯,126,0,126,富邦-嘉義,2024-02-19,9692
00687B,國泰20年美債,127,7,120,富邦-嘉義,2024-02-19,9692
6425,易發,307,189,118,富邦-嘉義,2024-02-19,9692
00878,國泰永續高股息,157,47,110,富邦-嘉義,2024-02-19,9692
2367,燿華,114,9,105,富邦-嘉義,2024-02-19,9692
8996,高力,119,18,101,富邦-嘉義,2024-02-19,9692
00720B,元大投資級公司債,98,0,98,富邦-嘉義,2024-02-19,9692
3041,揚智,243,151,92,富邦-嘉義,2024-02-19,9692
00919,群益台灣精選高息,107,22,85,富邦-嘉義,2024-02-19,9692
00679B,元大美債20年,84,0,84,富邦-嘉義,2024-02-19,9692
00637L,元大滬深300正2,84,1,83,富邦-嘉義,2024-02-19,9692
00650L,復華香港正2,145,66,79,富邦-嘉義,2024-02-19,9692
2888,新光金,100,28,72,富邦-嘉義,2024-02-19,9692
8011,台通,71,5,66,富邦-嘉義,2024-02-19,9692
3541,西柏,51,0,51,富邦-嘉義,2024-02-19,9692
4513,福裕,50,0,50,富邦-嘉義,2024-02-19,9692
00665L,富邦�琤肭磪囓�2,56,11,45,富邦-嘉義,2024-02-19,9692
2330,台積電,48,6,42,富邦-嘉義,2024-02-19,9692
2543,皇昌,51,10,41,富邦-嘉義,2024-02-19,9692
2380,虹光,40,0,40,富邦-嘉義,2024-02-19,9692
2383,台光電,41,2,39,富邦-嘉義,2024-02-19,9692
1319,東陽,40,3,37,富邦-嘉義,2024-02-19,9692
6270,倍微,37,0,37,富邦-嘉義,2024-02-19,9692
1795,美時,43,7,36,富邦-嘉義,2024-02-19,9692
1714,和桐,35,0,35,富邦-嘉義,2024-02-19,9692
3105,穩懋,37,3,34,富邦-嘉義,2024-02-19,9692
3055,蔚華科,407,375,32,富邦-嘉義,2024-02-19,9692
4945,陞達科技,32,1,31,富邦-嘉義,2024-02-19,9692
2356,英業達,68,38,30,富邦-嘉義,2024-02-19,9692
2401,凌陽,36,6,30,富邦-嘉義,2024-02-19,9692
3022,威強電,30,0,30,富邦-嘉義,2024-02-19,9692
8927,北基,30,0,30,富邦-嘉義,2024-02-19,9692
2465,麗臺,30,1,29,富邦-嘉義,2024-02-19,9692
3038,全台,44,16,28,富邦-嘉義,2024-02-19,9692
3047,訊舟,2131,1226,905,富邦-嘉義,2024-02-20,9692
1316,上曜,1345,504,841,富邦-嘉義,2024-02-20,9692
4953,緯軟,665,169,496,富邦-嘉義,2024-02-20,9692
2460,建通,667,271,396,富邦-嘉義,2024-02-20,9692
00929,復華台灣科技優息,418,113,305,富邦-嘉義,2024-02-20,9692
6164,華興,525,260,265,富邦-嘉義,2024-02-20,9692
5443,均豪,323,66,257,富邦-嘉義,2024-02-20,9692
3005,神基,207,23,184,富邦-嘉義,2024-02-20,9692
00937B,群益ESG投等債20,166,14,152,富邦-嘉義,2024-02-20,9692
8110,華東,803,656,147,富邦-嘉義,2024-02-20,9692
2888,新光金,115,2,113,富邦-嘉義,2024-02-20,9692
4714,永捷,312,202,110,富邦-嘉義,2024-02-20,9692
2405,輔信,2375,2283,92,富邦-嘉義,2024-02-20,9692
3712,永崴投控,261,171,90,富邦-嘉義,2024-02-20,9692
2382,廣達,277,190,87,富邦-嘉義,2024-02-20,9692
3466,德晉,87,0,87,富邦-嘉義,2024-02-20,9692
8089,康全電訊,91,7,84,富邦-嘉義,2024-02-20,9692
00720B,元大投資級公司債,79,1,78,富邦-嘉義,2024-02-20,9692
3312,弘憶股,285,214,71,富邦-嘉義,2024-02-20,9692
2812,台中銀,67,0,67,富邦-嘉義,2024-02-20,9692
2344,華邦電,75,11,64,富邦-嘉義,2024-02-20,9692
5315,光聯,61,0,61,富邦-嘉義,2024-02-20,9692
5381,合正,662,602,60,富邦-嘉義,2024-02-20,9692
3437,榮創,107,48,59,富邦-嘉義,2024-02-20,9692
00679B,元大美債20年,61,3,58,富邦-嘉義,2024-02-20,9692
00673R,期元大S＆P原油反1,56,0,56,富邦-嘉義,2024-02-20,9692
2329,華泰,376,323,53,富邦-嘉義,2024-02-20,9692
00878,國泰永續高股息,75,22,53,富邦-嘉義,2024-02-20,9692
3541,西柏,53,0,53,富邦-嘉義,2024-02-20,9692
1616,億泰,71,19,52,富邦-嘉義,2024-02-20,9692
00753L,中信中國50正2,50,0,50,富邦-嘉義,2024-02-20,9692
00933B,國泰10Y+金融債,49,0,49,富邦-嘉義,2024-02-20,9692
5272,笙科,50,1,49,富邦-嘉義,2024-02-20,9692
6116,彩晶,45,1,44,富邦-嘉義,2024-02-20,9692
4961,天鈺,138,94,44,富邦-嘉義,2024-02-20,9692
2801,彰銀,43,0,43,富邦-嘉義,2024-02-20,9692
00712,復華富時不動產,52,10,42,富邦-嘉義,2024-02-20,9692
5880,合庫金,63,21,42,富邦-嘉義,2024-02-20,9692
2409,友達,45,3,42,富邦-嘉義,2024-02-20,9692
2534,宏盛,39,0,39,富邦-嘉義,2024-02-20,9692
6290,良維,147,108,39,富邦-嘉義,2024-02-20,9692
00680L,元大美債20正2,56,20,36,富邦-嘉義,2024-02-20,9692
4968,立積,56,21,35,富邦-嘉義,2024-02-20,9692
6770,力積電,43,8,35,富邦-嘉義,2024-02-20,9692
3038,全台,41,7,34,富邦-嘉義,2024-02-20,9692
00772B,中信高評級公司債,32,2,30,富邦-嘉義,2024-02-20,9692
00687B,國泰20年美債,41,11,30,富邦-嘉義,2024-02-20,9692
2867,三商壽,50,20,30,富邦-嘉義,2024-02-20,9692
2457,飛宏,33,5,28,富邦-嘉義,2024-02-20,9692
6189,豐藝,50,23,27,富邦-嘉義,2024-02-20,9692
1503,士電,1830,1048,782,富邦-嘉義,2024-02-21,9692
3221,台嘉碩,719,59,660,富邦-嘉義,2024-02-21,9692
2329,華泰,1633,1067,566,富邦-嘉義,2024-02-21,9692
4909,新復興,516,175,341,富邦-嘉義,2024-02-21,9692
2367,燿華,290,7,283,富邦-嘉義,2024-02-21,9692
00687B,國泰20年美債,198,4,194,富邦-嘉義,2024-02-21,9692
2365,昆盈,226,39,187,富邦-嘉義,2024-02-21,9692
6425,易發,325,144,181,富邦-嘉義,2024-02-21,9692
1809,中釉,278,115,163,富邦-嘉義,2024-02-21,9692
2204,中華,142,0,142,富邦-嘉義,2024-02-21,9692
00878,國泰永續高股息,172,44,128,富邦-嘉義,2024-02-21,9692
00937B,群益ESG投等債20,153,28,125,富邦-嘉義,2024-02-21,9692
6442,光聖,180,60,120,富邦-嘉義,2024-02-21,9692
3663,鑫科,116,7,109,富邦-嘉義,2024-02-21,9692
6668,中揚光,676,570,106,富邦-嘉義,2024-02-21,9692
3025,星通,459,355,104,富邦-嘉義,2024-02-21,9692
3312,弘憶股,224,133,91,富邦-嘉義,2024-02-21,9692
3481,群創,97,9,88,富邦-嘉義,2024-02-21,9692
00933B,國泰10Y+金融債,110,32,78,富邦-嘉義,2024-02-21,9692
00679B,元大美債20年,69,0,69,富邦-嘉義,2024-02-21,9692
00712,復華富時不動產,220,152,68,富邦-嘉義,2024-02-21,9692
6451,訊芯-KY,454,387,67,富邦-嘉義,2024-02-21,9692
00931B,統一美債20年,67,1,66,富邦-嘉義,2024-02-21,9692
4714,永捷,141,76,65,富邦-嘉義,2024-02-21,9692
3231,緯創,135,71,64,富邦-嘉義,2024-02-21,9692
6207,雷科,71,9,62,富邦-嘉義,2024-02-21,9692
2897,王道銀行,60,2,58,富邦-嘉義,2024-02-21,9692
6530,創威,183,126,57,富邦-嘉義,2024-02-21,9692
3615,安可,65,8,57,富邦-嘉義,2024-02-21,9692
6125,廣運,144,90,54,富邦-嘉義,2024-02-21,9692
00891,中信關鍵半導體,52,1,51,富邦-嘉義,2024-02-21,9692
8047,星雲,51,0,51,富邦-嘉義,2024-02-21,9692
2609,陽明,101,52,49,富邦-嘉義,2024-02-21,9692
2303,聯電,146,97,49,富邦-嘉義,2024-02-21,9692
2025,千興,92,43,49,富邦-嘉義,2024-02-21,9692
8088,品安,50,1,49,富邦-嘉義,2024-02-21,9692
2489,瑞軒,476,429,47,富邦-嘉義,2024-02-21,9692
4588,玖鼎電力,47,3,44,富邦-嘉義,2024-02-21,9692
8092,建暐,42,0,42,富邦-嘉義,2024-02-21,9692
1313,聯成,40,2,38,富邦-嘉義,2024-02-21,9692
2883,凱基金,40,2,38,富邦-嘉義,2024-02-21,9692
6806,森崴能源,58,21,37,富邦-嘉義,2024-02-21,9692
00715L,期街口布蘭特正2,31,0,31,富邦-嘉義,2024-02-21,9692
1802,台玻,31,0,31,富邦-嘉義,2024-02-21,9692
6282,康舒,74,46,28,富邦-嘉義,2024-02-21,9692
3035,智原,312,285,27,富邦-嘉義,2024-02-21,9692
2353,宏��,68,42,26,富邦-嘉義,2024-02-21,9692
00772B,中信高評級公司債,26,0,26,富邦-嘉義,2024-02-21,9692
8261,富鼎,24,0,24,富邦-嘉義,2024-02-21,9692
6578,達邦蛋白,24,0,24,富邦-嘉義,2024-02-21,9692
3049,精金,462,29,433,富邦-嘉義,2024-02-22,9692
00937B,群益ESG投等債20,401,17,384,富邦-嘉義,2024-02-22,9692
00878,國泰永續高股息,359,58,301,富邦-嘉義,2024-02-22,9692
2313,華通,1187,923,264,富邦-嘉義,2024-02-22,9692
00665L,富邦�琤肭磪囓�2,257,39,218,富邦-嘉義,2024-02-22,9692
2303,聯電,183,13,170,富邦-嘉義,2024-02-22,9692
00637L,元大滬深300正2,179,14,165,富邦-嘉義,2024-02-22,9692
3025,星通,601,478,123,富邦-嘉義,2024-02-22,9692
00929,復華台灣科技優息,265,156,109,富邦-嘉義,2024-02-22,9692
3081,聯亞,441,340,101,富邦-嘉義,2024-02-22,9692
4556,旭然,102,4,98,富邦-嘉義,2024-02-22,9692
2356,英業達,216,125,91,富邦-嘉義,2024-02-22,9692
00753L,中信中國50正2,128,50,78,富邦-嘉義,2024-02-22,9692
00679B,元大美債20年,75,0,75,富邦-嘉義,2024-02-22,9692
2369,菱生,112,39,73,富邦-嘉義,2024-02-22,9692
3689,湧德,104,40,64,富邦-嘉義,2024-02-22,9692
00712,復華富時不動產,88,26,62,富邦-嘉義,2024-02-22,9692
1806,冠軍,165,105,60,富邦-嘉義,2024-02-22,9692
2618,長榮航,64,5,59,富邦-嘉義,2024-02-22,9692
00933B,國泰10Y+金融債,58,0,58,富邦-嘉義,2024-02-22,9692
2376,技嘉,97,40,57,富邦-嘉義,2024-02-22,9692
6189,豐藝,74,17,57,富邦-嘉義,2024-02-22,9692
00687B,國泰20年美債,58,2,56,富邦-嘉義,2024-02-22,9692
00923,群益台ESG低碳50,58,5,53,富邦-嘉義,2024-02-22,9692
1316,上曜,177,124,53,富邦-嘉義,2024-02-22,9692
3715,定穎投控,56,5,51,富邦-嘉義,2024-02-22,9692
4588,玖鼎電力,55,6,49,富邦-嘉義,2024-02-22,9692
3479,安勤,50,2,48,富邦-嘉義,2024-02-22,9692
8105,凌巨,164,118,46,富邦-嘉義,2024-02-22,9692
4526,東台,82,36,46,富邦-嘉義,2024-02-22,9692
6526,達發,59,13,46,富邦-嘉義,2024-02-22,9692
2887,台新金,51,5,46,富邦-嘉義,2024-02-22,9692
0056,元大高股息,80,36,44,富邦-嘉義,2024-02-22,9692
1522,堤維西,47,3,44,富邦-嘉義,2024-02-22,9692
00650L,復華香港正2,44,0,44,富邦-嘉義,2024-02-22,9692
1527,鑽全,43,0,43,富邦-嘉義,2024-02-22,9692
3437,榮創,91,49,42,富邦-嘉義,2024-02-22,9692
2371,大同,1195,1153,42,富邦-嘉義,2024-02-22,9692
6290,良維,50,9,41,富邦-嘉義,2024-02-22,9692
8064,東捷,276,235,41,富邦-嘉義,2024-02-22,9692
5471,松翰,38,0,38,富邦-嘉義,2024-02-22,9692
8059,凱碩,135,98,37,富邦-嘉義,2024-02-22,9692
00919,群益台灣精選高息,129,93,36,富邦-嘉義,2024-02-22,9692
2417,圓剛,700,664,36,富邦-嘉義,2024-02-22,9692
3576,聯合再生,34,0,34,富邦-嘉義,2024-02-22,9692
8249,菱光,34,0,34,富邦-嘉義,2024-02-22,9692
5272,笙科,49,15,34,富邦-嘉義,2024-02-22,9692
4979,華星光,50,18,32,富邦-嘉義,2024-02-22,9692
5381,合正,134,102,32,富邦-嘉義,2024-02-22,9692
2382,廣達,160,129,31,富邦-嘉義,2024-02-22,9692
2367,燿華,630,16,614,富邦-嘉義,2024-02-23,9692
1809,中釉,1938,1439,499,富邦-嘉義,2024-02-23,9692
3049,精金,385,0,385,富邦-嘉義,2024-02-23,9692
5381,合正,432,141,291,富邦-嘉義,2024-02-23,9692
00937B,群益ESG投等債20,294,39,255,富邦-嘉義,2024-02-23,9692
1503,士電,1125,901,224,富邦-嘉義,2024-02-23,9692
3390,旭軟,1319,1114,205,富邦-嘉義,2024-02-23,9692
3583,辛耘,264,73,191,富邦-嘉義,2024-02-23,9692
6532,瑞耘,252,78,174,富邦-嘉義,2024-02-23,9692
5315,光聯,174,5,169,富邦-嘉義,2024-02-23,9692
6113,亞矽,210,75,135,富邦-嘉義,2024-02-23,9692
3231,緯創,746,611,135,富邦-嘉義,2024-02-23,9692
4526,東台,192,83,109,富邦-嘉義,2024-02-23,9692
2609,陽明,155,49,106,富邦-嘉義,2024-02-23,9692
3354,律勝,123,21,102,富邦-嘉義,2024-02-23,9692
3363,上詮,1005,905,100,富邦-嘉義,2024-02-23,9692
3265,台星科,106,7,99,富邦-嘉義,2024-02-23,9692
3360,尚立,272,180,92,富邦-嘉義,2024-02-23,9692
00679B,元大美債20年,96,12,84,富邦-嘉義,2024-02-23,9692
00632R,元大台灣50反1,83,2,81,富邦-嘉義,2024-02-23,9692
3689,湧德,208,127,81,富邦-嘉義,2024-02-23,9692
00933B,國泰10Y+金融債,80,12,68,富邦-嘉義,2024-02-23,9692
6669,緯穎,66,1,65,富邦-嘉義,2024-02-23,9692
4303,信立,551,492,59,富邦-嘉義,2024-02-23,9692
00753L,中信中國50正2,108,50,58,富邦-嘉義,2024-02-23,9692
5469,瀚宇博,68,11,57,富邦-嘉義,2024-02-23,9692
8936,國統,85,30,55,富邦-嘉義,2024-02-23,9692
3047,訊舟,169,114,55,富邦-嘉義,2024-02-23,9692
6153,嘉聯益,51,0,51,富邦-嘉義,2024-02-23,9692
6288,聯嘉,118,70,48,富邦-嘉義,2024-02-23,9692
6167,久正,137,89,48,富邦-嘉義,2024-02-23,9692
00637L,元大滬深300正2,85,37,48,富邦-嘉義,2024-02-23,9692
2303,聯電,178,130,48,富邦-嘉義,2024-02-23,9692
3481,群創,97,51,46,富邦-嘉義,2024-02-23,9692
3313,斐成,60,14,46,富邦-嘉義,2024-02-23,9692
1312,國喬,45,5,40,富邦-嘉義,2024-02-23,9692
3040,遠見,40,0,40,富邦-嘉義,2024-02-23,9692
3234,光環,45,8,37,富邦-嘉義,2024-02-23,9692
3551,世禾,44,8,36,富邦-嘉義,2024-02-23,9692
4148,全宇生技-KY,44,9,35,富邦-嘉義,2024-02-23,9692
00882,中信中國高股息,53,18,35,富邦-嘉義,2024-02-23,9692
8092,建暐,34,0,34,富邦-嘉義,2024-02-23,9692
1718,中纖,34,0,34,富邦-嘉義,2024-02-23,9692
6126,信音,81,49,32,富邦-嘉義,2024-02-23,9692
2353,宏��,104,72,32,富邦-嘉義,2024-02-23,9692
2489,瑞軒,172,143,29,富邦-嘉義,2024-02-23,9692
00687B,國泰20年美債,35,7,28,富邦-嘉義,2024-02-23,9692
1303,南亞,31,3,28,富邦-嘉義,2024-02-23,9692
3006,晶豪科,38,11,27,富邦-嘉義,2024-02-23,9692
2352,佳世達,28,1,27,富邦-嘉義,2024-02-23,9692
3354,律勝,595,5,590,富邦-嘉義,2024-02-26,9692
3450,聯鈞,654,110,544,富邦-嘉義,2024-02-26,9692
6237,驊訊,683,239,444,富邦-嘉義,2024-02-26,9692
4979,華星光,467,37,430,富邦-嘉義,2024-02-26,9692
8096,擎亞,948,522,426,富邦-嘉義,2024-02-26,9692
1316,上曜,573,162,411,富邦-嘉義,2024-02-26,9692
6113,亞矽,786,375,411,富邦-嘉義,2024-02-26,9692
1503,士電,1721,1361,360,富邦-嘉義,2024-02-26,9692
00632R,元大台灣50反1,334,0,334,富邦-嘉義,2024-02-26,9692
3049,精金,322,0,322,富邦-嘉義,2024-02-26,9692
6530,創威,848,537,311,富邦-嘉義,2024-02-26,9692
1721,三晃,403,144,259,富邦-嘉義,2024-02-26,9692
3005,神基,1031,790,241,富邦-嘉義,2024-02-26,9692
00878,國泰永續高股息,352,117,235,富邦-嘉義,2024-02-26,9692
2363,矽統,278,102,176,富邦-嘉義,2024-02-26,9692
3588,通嘉,199,34,165,富邦-嘉義,2024-02-26,9692
00933B,國泰10Y+金融債,177,24,153,富邦-嘉義,2024-02-26,9692
2301,光寶科,131,0,131,富邦-嘉義,2024-02-26,9692
3360,尚立,171,58,113,富邦-嘉義,2024-02-26,9692
00937B,群益ESG投等債20,126,29,97,富邦-嘉義,2024-02-26,9692
3040,遠見,93,0,93,富邦-嘉義,2024-02-26,9692
3047,訊舟,94,5,89,富邦-嘉義,2024-02-26,9692
2365,昆盈,86,2,84,富邦-嘉義,2024-02-26,9692
3583,辛耘,414,339,75,富邦-嘉義,2024-02-26,9692
2323,中環,83,10,73,富邦-嘉義,2024-02-26,9692
1711,永光,201,131,70,富邦-嘉義,2024-02-26,9692
9105,泰金寶-DR,102,34,68,富邦-嘉義,2024-02-26,9692
2313,華通,182,117,65,富邦-嘉義,2024-02-26,9692
2002,中鋼,83,19,64,富邦-嘉義,2024-02-26,9692
00720B,元大投資級公司債,65,1,64,富邦-嘉義,2024-02-26,9692
2405,輔信,458,396,62,富邦-嘉義,2024-02-26,9692
3041,揚智,110,48,62,富邦-嘉義,2024-02-26,9692
6168,宏齊,75,15,60,富邦-嘉義,2024-02-26,9692
6770,力積電,65,9,56,富邦-嘉義,2024-02-26,9692
3265,台星科,55,1,54,富邦-嘉義,2024-02-26,9692
00680L,元大美債20正2,76,23,53,富邦-嘉義,2024-02-26,9692
2467,志聖,76,24,52,富邦-嘉義,2024-02-26,9692
2609,陽明,112,67,45,富邦-嘉義,2024-02-26,9692
00885,富邦越南,59,17,42,富邦-嘉義,2024-02-26,9692
2369,菱生,249,208,41,富邦-嘉義,2024-02-26,9692
3312,弘憶股,81,43,38,富邦-嘉義,2024-02-26,9692
4989,榮科,38,0,38,富邦-嘉義,2024-02-26,9692
8040,九暘,425,390,35,富邦-嘉義,2024-02-26,9692
8064,東捷,42,8,34,富邦-嘉義,2024-02-26,9692
6229,研通,110,78,32,富邦-嘉義,2024-02-26,9692
2329,華泰,97,66,31,富邦-嘉義,2024-02-26,9692
1513,中興電,952,922,30,富邦-嘉義,2024-02-26,9692
2383,台光電,31,1,30,富邦-嘉義,2024-02-26,9692
3706,神達,35,6,29,富邦-嘉義,2024-02-26,9692
1314,中石化,29,3,26,富邦-嘉義,2024-02-26,9692
6290,良維,803,18,785,富邦-嘉義,2024-02-27,9692
3049,精金,629,0,629,富邦-嘉義,2024-02-27,9692
8064,東捷,655,276,379,富邦-嘉義,2024-02-27,9692
00937B,群益ESG投等債20,302,20,282,富邦-嘉義,2024-02-27,9692
1522,堤維西,1098,877,221,富邦-嘉義,2024-02-27,9692
00878,國泰永續高股息,389,194,195,富邦-嘉義,2024-02-27,9692
6288,聯嘉,214,39,175,富邦-嘉義,2024-02-27,9692
1524,耿鼎,1070,930,140,富邦-嘉義,2024-02-27,9692
1727,中華化,399,277,122,富邦-嘉義,2024-02-27,9692
6167,久正,243,124,119,富邦-嘉義,2024-02-27,9692
00679B,元大美債20年,114,1,113,富邦-嘉義,2024-02-27,9692
00720B,元大投資級公司債,127,16,111,富邦-嘉義,2024-02-27,9692
00712,復華富時不動產,102,0,102,富邦-嘉義,2024-02-27,9692
00933B,國泰10Y+金融債,102,4,98,富邦-嘉義,2024-02-27,9692
2408,南亞科,101,6,95,富邦-嘉義,2024-02-27,9692
00665L,富邦�琤肭磪囓�2,83,1,82,富邦-嘉義,2024-02-27,9692
00687B,國泰20年美債,76,0,76,富邦-嘉義,2024-02-27,9692
2002,中鋼,66,3,63,富邦-嘉義,2024-02-27,9692
2059,川湖,105,43,62,富邦-嘉義,2024-02-27,9692
5355,佳總,85,23,62,富邦-嘉義,2024-02-27,9692
2369,菱生,78,20,58,富邦-嘉義,2024-02-27,9692
3221,台嘉碩,54,1,53,富邦-嘉義,2024-02-27,9692
1608,華榮,69,21,48,富邦-嘉義,2024-02-27,9692
2883B,凱基金乙特,48,0,48,富邦-嘉義,2024-02-27,9692
3022,威強電,51,4,47,富邦-嘉義,2024-02-27,9692
00688L,國泰20年美債正2,46,0,46,富邦-嘉義,2024-02-27,9692
1609,大亞,62,20,42,富邦-嘉義,2024-02-27,9692
2329,華泰,113,71,42,富邦-嘉義,2024-02-27,9692
3031,佰鴻,42,0,42,富邦-嘉義,2024-02-27,9692
00680L,元大美債20正2,41,0,41,富邦-嘉義,2024-02-27,9692
6126,信音,179,141,38,富邦-嘉義,2024-02-27,9692
8092,建暐,39,2,37,富邦-嘉義,2024-02-27,9692
3037,欣興,72,36,36,富邦-嘉義,2024-02-27,9692
2486,一詮,72,39,33,富邦-嘉義,2024-02-27,9692
6125,廣運,118,87,31,富邦-嘉義,2024-02-27,9692
4973,廣穎,210,180,30,富邦-嘉義,2024-02-27,9692
6165,浪凡,35,5,30,富邦-嘉義,2024-02-27,9692
6160,欣技,30,0,30,富邦-嘉義,2024-02-27,9692
1303,南亞,31,2,29,富邦-嘉義,2024-02-27,9692
4909,新復興,63,34,29,富邦-嘉義,2024-02-27,9692
3706,神達,31,3,28,富邦-嘉義,2024-02-27,9692
6116,彩晶,32,4,28,富邦-嘉義,2024-02-27,9692
00919,群益台灣精選高息,258,230,28,富邦-嘉義,2024-02-27,9692
8271,宇瞻,306,279,27,富邦-嘉義,2024-02-27,9692
00632R,元大台灣50反1,54,27,27,富邦-嘉義,2024-02-27,9692
2409,友達,29,3,26,富邦-嘉義,2024-02-27,9692
2614,東森,26,0,26,富邦-嘉義,2024-02-27,9692
3010,華立,30,4,26,富邦-嘉義,2024-02-27,9692
6668,中揚光,60,34,26,富邦-嘉義,2024-02-27,9692
3689,湧德,131,105,26,富邦-嘉義,2024-02-27,9692
3231,緯創,2070,77,1993,富邦-嘉義,2024-02-29,9692
3360,尚立,619,155,464,富邦-嘉義,2024-02-29,9692
3372,典範,525,93,432,富邦-嘉義,2024-02-29,9692
5386,青雲,410,14,396,富邦-嘉義,2024-02-29,9692
00937B,群益ESG投等債20,386,20,366,富邦-嘉義,2024-02-29,9692
1514,亞力,579,366,213,富邦-嘉義,2024-02-29,9692
3049,精金,159,0,159,富邦-嘉義,2024-02-29,9692
00919,群益台灣精選高息,306,149,157,富邦-嘉義,2024-02-29,9692
3437,榮創,159,2,157,富邦-嘉義,2024-02-29,9692
00929,復華台灣科技優息,360,207,153,富邦-嘉義,2024-02-29,9692
2329,華泰,205,66,139,富邦-嘉義,2024-02-29,9692
2301,光寶科,142,38,104,富邦-嘉義,2024-02-29,9692
00687B,國泰20年美債,106,8,98,富邦-嘉義,2024-02-29,9692
2330,台積電,103,14,89,富邦-嘉義,2024-02-29,9692
9105,泰金寶-DR,101,22,79,富邦-嘉義,2024-02-29,9692
4714,永捷,127,48,79,富邦-嘉義,2024-02-29,9692
4909,新復興,711,632,79,富邦-嘉義,2024-02-29,9692
1101,台泥,58,0,58,富邦-嘉義,2024-02-29,9692
00665L,富邦�琤肭磪囓�2,73,21,52,富邦-嘉義,2024-02-29,9692
6462,神盾,303,252,51,富邦-嘉義,2024-02-29,9692
9907,統一實,50,0,50,富邦-嘉義,2024-02-29,9692
2204,中華,50,2,48,富邦-嘉義,2024-02-29,9692
8092,建暐,66,20,46,富邦-嘉義,2024-02-29,9692
6229,研通,87,41,46,富邦-嘉義,2024-02-29,9692
2002,中鋼,54,14,40,富邦-嘉義,2024-02-29,9692
00770,國泰北美科技,40,0,40,富邦-嘉義,2024-02-29,9692
4303,信立,227,187,40,富邦-嘉義,2024-02-29,9692
8033,雷虎,41,3,38,富邦-嘉義,2024-02-29,9692
00679B,元大美債20年,36,0,36,富邦-嘉義,2024-02-29,9692
2812,台中銀,50,14,36,富邦-嘉義,2024-02-29,9692
2605,新興,137,104,33,富邦-嘉義,2024-02-29,9692
2534,宏盛,36,3,33,富邦-嘉義,2024-02-29,9692
3071,協禧,50,17,33,富邦-嘉義,2024-02-29,9692
6116,彩晶,41,8,33,富邦-嘉義,2024-02-29,9692
8473,山林水,42,10,32,富邦-嘉義,2024-02-29,9692
4588,玖鼎電力,36,5,31,富邦-嘉義,2024-02-29,9692
3522,御嵿,31,0,31,富邦-嘉義,2024-02-29,9692
5452,佶優,52,21,31,富邦-嘉義,2024-02-29,9692
00706L,期元大S＆P日圓正2,30,0,30,富邦-嘉義,2024-02-29,9692
8926,台汽電,113,83,30,富邦-嘉義,2024-02-29,9692
3321,同泰,29,0,29,富邦-嘉義,2024-02-29,9692
3268,海德威,29,1,28,富邦-嘉義,2024-02-29,9692
6179,亞通,36,9,27,富邦-嘉義,2024-02-29,9692
6669,緯穎,116,89,27,富邦-嘉義,2024-02-29,9692
00795B,中信美國公債20年,27,0,27,富邦-嘉義,2024-02-29,9692
2324,仁寶,61,34,27,富邦-嘉義,2024-02-29,9692
6125,廣運,439,413,26,富邦-嘉義,2024-02-29,9692
2362,藍天,25,0,25,富邦-嘉義,2024-02-29,9692
3362,先進光,33,8,25,富邦-嘉義,2024-02-29,9692
3055,蔚華科,385,361,24,富邦-嘉義,2024-02-29,9692
00919,群益台灣精選高息,646,60,586,富邦-嘉義,2024-03-01,9692
3372,典範,2051,1605,446,富邦-嘉義,2024-03-01,9692
2313,華通,334,51,283,富邦-嘉義,2024-03-01,9692
3013,晟銘電,479,204,275,富邦-嘉義,2024-03-01,9692
00937B,群益ESG投等債20,358,101,257,富邦-嘉義,2024-03-01,9692
3390,旭軟,231,47,184,富邦-嘉義,2024-03-01,9692
4968,立積,374,208,166,富邦-嘉義,2024-03-01,9692
2365,昆盈,311,148,163,富邦-嘉義,2024-03-01,9692
00918,大華優利高填息30,151,10,141,富邦-嘉義,2024-03-01,9692
2834,臺企銀,166,25,141,富邦-嘉義,2024-03-01,9692
2543,皇昌,696,560,136,富邦-嘉義,2024-03-01,9692
3049,精金,135,0,135,富邦-嘉義,2024-03-01,9692
1513,中興電,510,380,130,富邦-嘉義,2024-03-01,9692
00637L,元大滬深300正2,106,0,106,富邦-嘉義,2024-03-01,9692
9907,統一實,103,4,99,富邦-嘉義,2024-03-01,9692
2812,台中銀,108,17,91,富邦-嘉義,2024-03-01,9692
6139,亞翔,101,15,86,富邦-嘉義,2024-03-01,9692
00665L,富邦�琤肭磪囓�2,112,30,82,富邦-嘉義,2024-03-01,9692
3376,新日興,348,275,73,富邦-嘉義,2024-03-01,9692
2897,王道銀行,71,0,71,富邦-嘉義,2024-03-01,9692
9105,泰金寶-DR,115,48,67,富邦-嘉義,2024-03-01,9692
3533,嘉澤,62,1,61,富邦-嘉義,2024-03-01,9692
3363,上詮,144,85,59,富邦-嘉義,2024-03-01,9692
00632R,元大台灣50反1,60,3,57,富邦-嘉義,2024-03-01,9692
3005,神基,263,210,53,富邦-嘉義,2024-03-01,9692
2609,陽明,84,31,53,富邦-嘉義,2024-03-01,9692
4906,正文,54,2,52,富邦-嘉義,2024-03-01,9692
3356,奇偶,92,41,51,富邦-嘉義,2024-03-01,9692
1101,台泥,56,5,51,富邦-嘉義,2024-03-01,9692
00929,復華台灣科技優息,137,86,51,富邦-嘉義,2024-03-01,9692
1313,聯成,50,0,50,富邦-嘉義,2024-03-01,9692
1815,富喬,59,9,50,富邦-嘉義,2024-03-01,9692
2882,國泰金,52,3,49,富邦-嘉義,2024-03-01,9692
00706L,期元大S＆P日圓正2,48,0,48,富邦-嘉義,2024-03-01,9692
2409,友達,48,3,45,富邦-嘉義,2024-03-01,9692
2002,中鋼,91,46,45,富邦-嘉義,2024-03-01,9692
00679B,元大美債20年,51,7,44,富邦-嘉義,2024-03-01,9692
2369,菱生,49,5,44,富邦-嘉義,2024-03-01,9692
8401,白紗科,46,2,44,富邦-嘉義,2024-03-01,9692
6026,福邦證,50,8,42,富邦-嘉義,2024-03-01,9692
8011,台通,37,2,35,富邦-嘉義,2024-03-01,9692
00687B,國泰20年美債,39,5,34,富邦-嘉義,2024-03-01,9692
00891,中信關鍵半導體,35,1,34,富邦-嘉義,2024-03-01,9692
2615,萬海,42,8,34,富邦-嘉義,2024-03-01,9692
1522,堤維西,109,76,33,富邦-嘉義,2024-03-01,9692
6168,宏齊,33,0,33,富邦-嘉義,2024-03-01,9692
2637,慧洋-KY,34,2,32,富邦-嘉義,2024-03-01,9692
6176,瑞儀,31,1,30,富邦-嘉義,2024-03-01,9692
1108,幸福,33,3,30,富邦-嘉義,2024-03-01,9692
2408,南亞科,29,0,29,富邦-嘉義,2024-03-01,9692
2317,鴻海,1235,153,1082,富邦-嘉義,2024-03-04,9692
5258,虹堡,1005,5,1000,富邦-嘉義,2024-03-04,9692
2887,台新金,567,4,563,富邦-嘉義,2024-03-04,9692
6806,森崴能源,574,160,414,富邦-嘉義,2024-03-04,9692
8011,台通,1116,737,379,富邦-嘉義,2024-03-04,9692
00915,凱基優選高股息30,374,5,369,富邦-嘉義,2024-03-04,9692
2485,兆赫,318,37,281,富邦-嘉義,2024-03-04,9692
2313,華通,683,421,262,富邦-嘉義,2024-03-04,9692
3049,精金,229,0,229,富邦-嘉義,2024-03-04,9692
1522,堤維西,305,80,225,富邦-嘉義,2024-03-04,9692
1725,元禎,205,5,200,富邦-嘉義,2024-03-04,9692
00918,大華優利高填息30,169,4,165,富邦-嘉義,2024-03-04,9692
4109,加捷生醫,182,19,163,富邦-嘉義,2024-03-04,9692
00720B,元大投資級公司債,144,0,144,富邦-嘉義,2024-03-04,9692
00673R,期元大S＆P原油反1,127,0,127,富邦-嘉義,2024-03-04,9692
1316,上曜,157,35,122,富邦-嘉義,2024-03-04,9692
00937B,群益ESG投等債20,140,26,114,富邦-嘉義,2024-03-04,9692
3036,文曄,280,179,101,富邦-嘉義,2024-03-04,9692
3297,杭特,107,10,97,富邦-嘉義,2024-03-04,9692
2609,陽明,113,30,83,富邦-嘉義,2024-03-04,9692
3354,律勝,82,7,75,富邦-嘉義,2024-03-04,9692
5452,佶優,72,0,72,富邦-嘉義,2024-03-04,9692
2014,中鴻,78,8,70,富邦-嘉義,2024-03-04,9692
2405,輔信,82,15,67,富邦-嘉義,2024-03-04,9692
1314,中石化,69,3,66,富邦-嘉義,2024-03-04,9692
2371,大同,124,67,57,富邦-嘉義,2024-03-04,9692
00632R,元大台灣50反1,215,160,55,富邦-嘉義,2024-03-04,9692
4303,信立,56,3,53,富邦-嘉義,2024-03-04,9692
2801,彰銀,51,3,48,富邦-嘉義,2024-03-04,9692
1609,大亞,90,42,48,富邦-嘉義,2024-03-04,9692
6691,洋基工程,48,2,46,富邦-嘉義,2024-03-04,9692
3701,大眾控,43,2,41,富邦-嘉義,2024-03-04,9692
8996,高力,133,92,41,富邦-嘉義,2024-03-04,9692
2890,永豐金,42,2,40,富邦-嘉義,2024-03-04,9692
2344,華邦電,66,27,39,富邦-嘉義,2024-03-04,9692
4532,瑞智,38,0,38,富邦-嘉義,2024-03-04,9692
2534,宏盛,39,1,38,富邦-嘉義,2024-03-04,9692
2633,台灣高鐵,40,3,37,富邦-嘉義,2024-03-04,9692
3033,威健,66,30,36,富邦-嘉義,2024-03-04,9692
8936,國統,39,4,35,富邦-嘉義,2024-03-04,9692
9950,萬國通,34,0,34,富邦-嘉義,2024-03-04,9692
2002,中鋼,70,36,34,富邦-嘉義,2024-03-04,9692
8101,華冠,33,0,33,富邦-嘉義,2024-03-04,9692
2332,友訊,52,19,33,富邦-嘉義,2024-03-04,9692
2867,三商壽,32,0,32,富邦-嘉義,2024-03-04,9692
6126,信音,41,10,31,富邦-嘉義,2024-03-04,9692
2329,華泰,71,41,30,富邦-嘉義,2024-03-04,9692
2230,泰茂,271,242,29,富邦-嘉義,2024-03-04,9692
2515,中工,28,0,28,富邦-嘉義,2024-03-04,9692
2066,世德,28,0,28,富邦-嘉義,2024-03-04,9692
6163,華電網,581,87,494,富邦-嘉義,2024-03-05,9692
00919,群益台灣精選高息,536,51,485,富邦-嘉義,2024-03-05,9692
6117,迎廣,484,138,346,富邦-嘉義,2024-03-05,9692
00915,凱基優選高股息30,323,2,321,富邦-嘉義,2024-03-05,9692
4906,正文,505,249,256,富邦-嘉義,2024-03-05,9692
5498,凱崴,258,5,253,富邦-嘉義,2024-03-05,9692
2888,新光金,226,8,218,富邦-嘉義,2024-03-05,9692
8011,台通,2075,1859,216,富邦-嘉義,2024-03-05,9692
3450,聯鈞,304,92,212,富邦-嘉義,2024-03-05,9692
6275,元山,431,221,210,富邦-嘉義,2024-03-05,9692
2301,光寶科,209,3,206,富邦-嘉義,2024-03-05,9692
3049,精金,191,10,181,富邦-嘉義,2024-03-05,9692
8163,達方,455,282,173,富邦-嘉義,2024-03-05,9692
2501,國建,166,0,166,富邦-嘉義,2024-03-05,9692
6770,力積電,189,32,157,富邦-嘉義,2024-03-05,9692
00918,大華優利高填息30,154,3,151,富邦-嘉義,2024-03-05,9692
6116,彩晶,126,3,123,富邦-嘉義,2024-03-05,9692
5426,振發,261,146,115,富邦-嘉義,2024-03-05,9692
4714,永捷,142,30,112,富邦-嘉義,2024-03-05,9692
00706L,期元大S＆P日圓正2,110,11,99,富邦-嘉義,2024-03-05,9692
3481,群創,168,70,98,富邦-嘉義,2024-03-05,9692
6669,緯穎,153,60,93,富邦-嘉義,2024-03-05,9692
00665L,富邦�琤肭磪囓�2,119,30,89,富邦-嘉義,2024-03-05,9692
2812,台中銀,85,2,83,富邦-嘉義,2024-03-05,9692
00712,復華富時不動產,91,10,81,富邦-嘉義,2024-03-05,9692
1316,上曜,835,759,76,富邦-嘉義,2024-03-05,9692
00753L,中信中國50正2,71,0,71,富邦-嘉義,2024-03-05,9692
2618,長榮航,79,9,70,富邦-嘉義,2024-03-05,9692
00937B,群益ESG投等債20,189,122,67,富邦-嘉義,2024-03-05,9692
3047,訊舟,66,1,65,富邦-嘉義,2024-03-05,9692
2313,華通,264,199,65,富邦-嘉義,2024-03-05,9692
2543,皇昌,288,225,63,富邦-嘉義,2024-03-05,9692
2890,永豐金,67,6,61,富邦-嘉義,2024-03-05,9692
3515,華擎,179,120,59,富邦-嘉義,2024-03-05,9692
3576,聯合再生,57,3,54,富邦-嘉義,2024-03-05,9692
2206,三陽工業,56,4,52,富邦-嘉義,2024-03-05,9692
1609,大亞,68,16,52,富邦-嘉義,2024-03-05,9692
1718,中纖,52,1,51,富邦-嘉義,2024-03-05,9692
00632R,元大台灣50反1,51,2,49,富邦-嘉義,2024-03-05,9692
4188,安克,50,1,49,富邦-嘉義,2024-03-05,9692
3363,上詮,53,7,46,富邦-嘉義,2024-03-05,9692
3376,新日興,291,246,45,富邦-嘉義,2024-03-05,9692
5251,天鉞電,52,11,41,富邦-嘉義,2024-03-05,9692
4960,誠美材,49,9,40,富邦-嘉義,2024-03-05,9692
00650L,復華香港正2,90,50,40,富邦-嘉義,2024-03-05,9692
3360,尚立,61,22,39,富邦-嘉義,2024-03-05,9692
2892,第一金,39,0,39,富邦-嘉義,2024-03-05,9692
2362,藍天,46,8,38,富邦-嘉義,2024-03-05,9692
2884,玉山金,51,14,37,富邦-嘉義,2024-03-05,9692
3669,圓展,404,367,37,富邦-嘉義,2024-03-05,9692
8034,榮群,1383,913,470,富邦-嘉義,2024-03-06,9692
6275,元山,1262,874,388,富邦-嘉義,2024-03-06,9692
00919,群益台灣精選高息,456,105,351,富邦-嘉義,2024-03-06,9692
3338,泰碩,1235,900,335,富邦-嘉義,2024-03-06,9692
00915,凱基優選高股息30,318,2,316,富邦-嘉義,2024-03-06,9692
2365,昆盈,433,240,193,富邦-嘉義,2024-03-06,9692
00918,大華優利高填息30,186,5,181,富邦-嘉義,2024-03-06,9692
5521,工信,935,767,168,富邦-嘉義,2024-03-06,9692
8401,白紗科,150,3,147,富邦-嘉義,2024-03-06,9692
3147,大綜,131,16,115,富邦-嘉義,2024-03-06,9692
5498,凱崴,464,359,105,富邦-嘉義,2024-03-06,9692
5443,均豪,185,86,99,富邦-嘉義,2024-03-06,9692
00632R,元大台灣50反1,93,0,93,富邦-嘉義,2024-03-06,9692
00720B,元大投資級公司債,101,9,92,富邦-嘉義,2024-03-06,9692
2002,中鋼,95,10,85,富邦-嘉義,2024-03-06,9692
5225,東科-KY,154,73,81,富邦-嘉義,2024-03-06,9692
2467,志聖,181,103,78,富邦-嘉義,2024-03-06,9692
2505,國揚,77,0,77,富邦-嘉義,2024-03-06,9692
2204,中華,90,20,70,富邦-嘉義,2024-03-06,9692
3231,緯創,96,26,70,富邦-嘉義,2024-03-06,9692
2845,遠東銀,129,64,65,富邦-嘉義,2024-03-06,9692
2383,台光電,68,6,62,富邦-嘉義,2024-03-06,9692
00924,復華S＆P500成長,61,1,60,富邦-嘉義,2024-03-06,9692
1303,南亞,65,6,59,富邦-嘉義,2024-03-06,9692
00733,富邦臺灣中小,88,30,58,富邦-嘉義,2024-03-06,9692
3321,同泰,69,12,57,富邦-嘉義,2024-03-06,9692
2417,圓剛,107,54,53,富邦-嘉義,2024-03-06,9692
3669,圓展,122,72,50,富邦-嘉義,2024-03-06,9692
2014,中鴻,50,0,50,富邦-嘉義,2024-03-06,9692
00687B,國泰20年美債,116,67,49,富邦-嘉義,2024-03-06,9692
2344,華邦電,52,5,47,富邦-嘉義,2024-03-06,9692
1471,首利,62,16,46,富邦-嘉義,2024-03-06,9692
5310,天剛,44,2,42,富邦-嘉義,2024-03-06,9692
2812,台中銀,54,13,41,富邦-嘉義,2024-03-06,9692
2408,南亞科,93,53,40,富邦-嘉義,2024-03-06,9692
4414,如興,40,0,40,富邦-嘉義,2024-03-06,9692
6197,佳必琪,114,77,37,富邦-嘉義,2024-03-06,9692
2358,廷鑫,41,5,36,富邦-嘉義,2024-03-06,9692
2601,益航,34,0,34,富邦-嘉義,2024-03-06,9692
6016,康和證,44,11,33,富邦-嘉義,2024-03-06,9692
3049,精金,40,8,32,富邦-嘉義,2024-03-06,9692
6425,易發,47,15,32,富邦-嘉義,2024-03-06,9692
3025,星通,33,1,32,富邦-嘉義,2024-03-06,9692
5381,合正,35,3,32,富邦-嘉義,2024-03-06,9692
00933B,國泰10Y+金融債,40,9,31,富邦-嘉義,2024-03-06,9692
2355,敬鵬,65,34,31,富邦-嘉義,2024-03-06,9692
2401,凌陽,31,0,31,富邦-嘉義,2024-03-06,9692
2324,仁寶,41,11,30,富邦-嘉義,2024-03-06,9692
3564,其陽,98,68,30,富邦-嘉義,2024-03-06,9692
2498,宏達電,31,2,29,富邦-嘉義,2024-03-06,9692
00679B,元大美債20年,2667,513,2154,富邦-嘉義,2024-03-07,9692
2367,燿華,1387,598,789,富邦-嘉義,2024-03-07,9692
00919,群益台灣精選高息,606,83,523,富邦-嘉義,2024-03-07,9692
00664R,國泰臺灣加權反1,435,0,435,富邦-嘉義,2024-03-07,9692
00915,凱基優選高股息30,344,13,331,富邦-嘉義,2024-03-07,9692
3540,曜越,427,212,215,富邦-嘉義,2024-03-07,9692
3163,波若威,585,434,151,富邦-嘉義,2024-03-07,9692
3548,兆利,493,361,132,富邦-嘉義,2024-03-07,9692
2409,友達,129,11,118,富邦-嘉義,2024-03-07,9692
3047,訊舟,116,2,114,富邦-嘉義,2024-03-07,9692
2505,國揚,109,0,109,富邦-嘉義,2024-03-07,9692
3308,聯德,102,6,96,富邦-嘉義,2024-03-07,9692
4147,中裕,142,52,90,富邦-嘉義,2024-03-07,9692
2404,漢唐,117,44,73,富邦-嘉義,2024-03-07,9692
8040,九暘,74,2,72,富邦-嘉義,2024-03-07,9692
00632R,元大台灣50反1,172,101,71,富邦-嘉義,2024-03-07,9692
00706L,期元大S＆P日圓正2,60,0,60,富邦-嘉義,2024-03-07,9692
2383,台光電,516,457,59,富邦-嘉義,2024-03-07,9692
2449,京元電子,497,439,58,富邦-嘉義,2024-03-07,9692
4556,旭然,58,0,58,富邦-嘉義,2024-03-07,9692
1815,富喬,170,113,57,富邦-嘉義,2024-03-07,9692
5355,佳總,56,0,56,富邦-嘉義,2024-03-07,9692
1711,永光,62,7,55,富邦-嘉義,2024-03-07,9692
00720B,元大投資級公司債,64,11,53,富邦-嘉義,2024-03-07,9692
3049,精金,50,0,50,富邦-嘉義,2024-03-07,9692
6205,詮欣,51,1,50,富邦-嘉義,2024-03-07,9692
2355,敬鵬,56,7,49,富邦-嘉義,2024-03-07,9692
3711,日月光投控,636,589,47,富邦-嘉義,2024-03-07,9692
6285,啟��,43,1,42,富邦-嘉義,2024-03-07,9692
8011,台通,78,37,41,富邦-嘉義,2024-03-07,9692
1464,得力,39,0,39,富邦-嘉義,2024-03-07,9692
3481,群創,109,71,38,富邦-嘉義,2024-03-07,9692
6016,康和證,48,10,38,富邦-嘉義,2024-03-07,9692
6125,廣運,120,82,38,富邦-嘉義,2024-03-07,9692
3006,晶豪科,46,9,37,富邦-嘉義,2024-03-07,9692
1717,長興,304,267,37,富邦-嘉義,2024-03-07,9692
3231,緯創,105,71,34,富邦-嘉義,2024-03-07,9692
5452,佶優,52,20,32,富邦-嘉義,2024-03-07,9692
00934,中信成長高股息,41,9,32,富邦-嘉義,2024-03-07,9692
3346,麗清,31,0,31,富邦-嘉義,2024-03-07,9692
1301,台塑,34,3,31,富邦-嘉義,2024-03-07,9692
2486,一詮,104,74,30,富邦-嘉義,2024-03-07,9692
2601,益航,31,1,30,富邦-嘉義,2024-03-07,9692
6274,台燿,379,351,28,富邦-嘉義,2024-03-07,9692
1905,華紙,33,5,28,富邦-嘉義,2024-03-07,9692
6282,康舒,30,3,27,富邦-嘉義,2024-03-07,9692
3044,健鼎,41,15,26,富邦-嘉義,2024-03-07,9692
2002,中鋼,38,12,26,富邦-嘉義,2024-03-07,9692
6108,競國,26,0,26,富邦-嘉義,2024-03-07,9692
3376,新日興,445,419,26,富邦-嘉義,2024-03-07,9692
2367,燿華,1489,362,1127,富邦-嘉義,2024-03-08,9692
00919,群益台灣精選高息,914,311,603,富邦-嘉義,2024-03-08,9692
2313,華通,707,421,286,富邦-嘉義,2024-03-08,9692
00632R,元大台灣50反1,625,355,270,富邦-嘉義,2024-03-08,9692
2890,永豐金,261,18,243,富邦-嘉義,2024-03-08,9692
00680L,元大美債20正2,231,5,226,富邦-嘉義,2024-03-08,9692
2382,廣達,471,250,221,富邦-嘉義,2024-03-08,9692
4906,正文,231,43,188,富邦-嘉義,2024-03-08,9692
1313,聯成,174,0,174,富邦-嘉義,2024-03-08,9692
2301,光寶科,364,222,142,富邦-嘉義,2024-03-08,9692
3231,緯創,2505,2389,116,富邦-嘉義,2024-03-08,9692
2353,宏��,132,23,109,富邦-嘉義,2024-03-08,9692
2025,千興,159,61,98,富邦-嘉義,2024-03-08,9692
2609,陽明,259,163,96,富邦-嘉義,2024-03-08,9692
2323,中環,87,0,87,富邦-嘉義,2024-03-08,9692
3372,典範,294,208,86,富邦-嘉義,2024-03-08,9692
1513,中興電,250,168,82,富邦-嘉義,2024-03-08,9692
00933B,國泰10Y+金融債,92,15,77,富邦-嘉義,2024-03-08,9692
3481,群創,120,45,75,富邦-嘉義,2024-03-08,9692
6274,台燿,134,59,75,富邦-嘉義,2024-03-08,9692
2913,農林,71,0,71,富邦-嘉義,2024-03-08,9692
1815,富喬,154,87,67,富邦-嘉義,2024-03-08,9692
3047,訊舟,98,35,63,富邦-嘉義,2024-03-08,9692
5310,天剛,64,1,63,富邦-嘉義,2024-03-08,9692
3006,晶豪科,65,3,62,富邦-嘉義,2024-03-08,9692
2603,長榮,832,771,61,富邦-嘉義,2024-03-08,9692
3669,圓展,64,3,61,富邦-嘉義,2024-03-08,9692
1722,台肥,59,0,59,富邦-嘉義,2024-03-08,9692
2316,楠梓電,64,5,59,富邦-嘉義,2024-03-08,9692
00918,大華優利高填息30,187,130,57,富邦-嘉義,2024-03-08,9692
2486,一詮,134,81,53,富邦-嘉義,2024-03-08,9692
0056,元大高股息,108,56,52,富邦-嘉義,2024-03-08,9692
4147,中裕,90,40,50,富邦-嘉義,2024-03-08,9692
1714,和桐,50,0,50,富邦-嘉義,2024-03-08,9692
9950,萬國通,49,0,49,富邦-嘉義,2024-03-08,9692
2324,仁寶,67,19,48,富邦-嘉義,2024-03-08,9692
3049,精金,48,2,46,富邦-嘉義,2024-03-08,9692
6016,康和證,87,43,44,富邦-嘉義,2024-03-08,9692
2812,台中銀,46,2,44,富邦-嘉義,2024-03-08,9692
2405,輔信,64,21,43,富邦-嘉義,2024-03-08,9692
1522,堤維西,61,20,41,富邦-嘉義,2024-03-08,9692
1718,中纖,39,0,39,富邦-嘉義,2024-03-08,9692
3576,聯合再生,68,30,38,富邦-嘉義,2024-03-08,9692
3551,世禾,41,5,36,富邦-嘉義,2024-03-08,9692
6005,群益證,56,22,34,富邦-嘉義,2024-03-08,9692
00713,元大台灣高息低波,46,13,33,富邦-嘉義,2024-03-08,9692
3711,日月光投控,324,291,33,富邦-嘉義,2024-03-08,9692
1785,光洋科,41,9,32,富邦-嘉義,2024-03-08,9692
2888,新光金,68,37,31,富邦-嘉義,2024-03-08,9692
6164,華興,41,10,31,富邦-嘉義,2024-03-08,9692
3231,緯創,2884,1106,1778,富邦-嘉義,2024-03-11,9692
00937B,群益ESG投等債20,969,32,937,富邦-嘉義,2024-03-11,9692
8011,台通,982,222,760,富邦-嘉義,2024-03-11,9692
1513,中興電,1011,380,631,富邦-嘉義,2024-03-11,9692
00918,大華優利高填息30,601,17,584,富邦-嘉義,2024-03-11,9692
00632R,元大台灣50反1,454,68,386,富邦-嘉義,2024-03-11,9692
4420,光明,223,15,208,富邦-嘉義,2024-03-11,9692
5310,天剛,165,0,165,富邦-嘉義,2024-03-11,9692
2543,皇昌,242,95,147,富邦-嘉義,2024-03-11,9692
3284,太普高,141,0,141,富邦-嘉義,2024-03-11,9692
00915,凱基優選高股息30,144,7,137,富邦-嘉義,2024-03-11,9692
00720B,元大投資級公司債,161,32,129,富邦-嘉義,2024-03-11,9692
1582,信錦,157,30,127,富邦-嘉義,2024-03-11,9692
00751B,元大AAA至A公司債,104,0,104,富邦-嘉義,2024-03-11,9692
00706L,期元大S＆P日圓正2,93,0,93,富邦-嘉義,2024-03-11,9692
9902,台火,188,99,89,富邦-嘉義,2024-03-11,9692
2303,聯電,166,77,89,富邦-嘉義,2024-03-11,9692
6120,達運,1521,1437,84,富邦-嘉義,2024-03-11,9692
6274,台燿,115,38,77,富邦-嘉義,2024-03-11,9692
6015,宏遠證,80,12,68,富邦-嘉義,2024-03-11,9692
2834,臺企銀,85,23,62,富邦-嘉義,2024-03-11,9692
2059,川湖,71,11,60,富邦-嘉義,2024-03-11,9692
3313,斐成,60,0,60,富邦-嘉義,2024-03-11,9692
6290,良維,66,6,60,富邦-嘉義,2024-03-11,9692
3669,圓展,249,190,59,富邦-嘉義,2024-03-11,9692
3390,旭軟,60,1,59,富邦-嘉義,2024-03-11,9692
2618,長榮航,118,60,58,富邦-嘉義,2024-03-11,9692
4906,正文,67,12,55,富邦-嘉義,2024-03-11,9692
8933,愛地雅,84,33,51,富邦-嘉義,2024-03-11,9692
2312,金寶,52,1,51,富邦-嘉義,2024-03-11,9692
3548,兆利,78,28,50,富邦-嘉義,2024-03-11,9692
2353,宏��,102,55,47,富邦-嘉義,2024-03-11,9692
6735,美達科技,72,25,47,富邦-嘉義,2024-03-11,9692
4994,傳奇,62,16,46,富邦-嘉義,2024-03-11,9692
3013,晟銘電,215,173,42,富邦-嘉義,2024-03-11,9692
3294,英濟,51,10,41,富邦-嘉義,2024-03-11,9692
3163,波若威,553,513,40,富邦-嘉義,2024-03-11,9692
5381,合正,40,0,40,富邦-嘉義,2024-03-11,9692
1101,台泥,58,20,38,富邦-嘉義,2024-03-11,9692
2358,廷鑫,42,5,37,富邦-嘉義,2024-03-11,9692
5225,東科-KY,37,5,32,富邦-嘉義,2024-03-11,9692
2330,台積電,45,13,32,富邦-嘉義,2024-03-11,9692
4147,中裕,32,1,31,富邦-嘉義,2024-03-11,9692
1313,聯成,30,0,30,富邦-嘉義,2024-03-11,9692
2867,三商壽,30,0,30,富邦-嘉義,2024-03-11,9692
5230,雷笛克光學,30,0,30,富邦-嘉義,2024-03-11,9692
4414,如興,30,0,30,富邦-嘉義,2024-03-11,9692
4961,天鈺,38,8,30,富邦-嘉義,2024-03-11,9692
2344,華邦電,39,10,29,富邦-嘉義,2024-03-11,9692
6442,光聖,42,13,29,富邦-嘉義,2024-03-11,9692
2382,廣達,1066,434,632,富邦-嘉義,2024-03-12,9692
5258,虹堡,519,121,398,富邦-嘉義,2024-03-12,9692
5386,青雲,248,11,237,富邦-嘉義,2024-03-12,9692
4909,新復興,712,505,207,富邦-嘉義,2024-03-12,9692
8040,九暘,428,221,207,富邦-嘉義,2024-03-12,9692
2367,燿華,1627,1451,176,富邦-嘉義,2024-03-12,9692
8064,東捷,236,83,153,富邦-嘉義,2024-03-12,9692
5508,永信建,151,17,134,富邦-嘉義,2024-03-12,9692
6117,迎廣,197,76,121,富邦-嘉義,2024-03-12,9692
3360,尚立,138,19,119,富邦-嘉義,2024-03-12,9692
00918,大華優利高填息30,128,12,116,富邦-嘉義,2024-03-12,9692
2354,鴻準,273,160,113,富邦-嘉義,2024-03-12,9692
00687B,國泰20年美債,121,18,103,富邦-嘉義,2024-03-12,9692
6139,亞翔,107,7,100,富邦-嘉義,2024-03-12,9692
2025,千興,94,3,91,富邦-嘉義,2024-03-12,9692
2365,昆盈,104,19,85,富邦-嘉義,2024-03-12,9692
5381,合正,114,41,73,富邦-嘉義,2024-03-12,9692
1312,國喬,72,1,71,富邦-嘉義,2024-03-12,9692
2349,錸德,80,11,69,富邦-嘉義,2024-03-12,9692
00720B,元大投資級公司債,67,1,66,富邦-嘉義,2024-03-12,9692
2344,華邦電,73,7,66,富邦-嘉義,2024-03-12,9692
5443,均豪,170,104,66,富邦-嘉義,2024-03-12,9692
3563,牧德,93,28,65,富邦-嘉義,2024-03-12,9692
6584,南俊國際,68,4,64,富邦-嘉義,2024-03-12,9692
3234,光環,76,16,60,富邦-嘉義,2024-03-12,9692
3062,建漢,244,184,60,富邦-嘉義,2024-03-12,9692
3171,炎洲流通,70,12,58,富邦-嘉義,2024-03-12,9692
00919,群益台灣精選高息,377,320,57,富邦-嘉義,2024-03-12,9692
6290,良維,107,53,54,富邦-嘉義,2024-03-12,9692
6275,元山,102,49,53,富邦-嘉義,2024-03-12,9692
8105,凌巨,96,43,53,富邦-嘉義,2024-03-12,9692
00935,野村臺灣新科技50,52,0,52,富邦-嘉義,2024-03-12,9692
6161,捷波,70,19,51,富邦-嘉義,2024-03-12,9692
1514,亞力,499,452,47,富邦-嘉義,2024-03-12,9692
1711,永光,45,1,44,富邦-嘉義,2024-03-12,9692
5243,乙盛-KY,73,30,43,富邦-嘉義,2024-03-12,9692
2352,佳世達,46,4,42,富邦-嘉義,2024-03-12,9692
3363,上詮,74,34,40,富邦-嘉義,2024-03-12,9692
3564,其陽,135,96,39,富邦-嘉義,2024-03-12,9692
8110,華東,37,1,36,富邦-嘉義,2024-03-12,9692
00712,復華富時不動產,41,6,35,富邦-嘉義,2024-03-12,9692
3324,雙鴻,219,184,35,富邦-嘉義,2024-03-12,9692
2329,華泰,51,16,35,富邦-嘉義,2024-03-12,9692
4714,永捷,121,86,35,富邦-嘉義,2024-03-12,9692
4306,炎洲,32,0,32,富邦-嘉義,2024-03-12,9692
3312,弘憶股,42,11,31,富邦-嘉義,2024-03-12,9692
6179,亞通,43,12,31,富邦-嘉義,2024-03-12,9692
5905,南仁湖,31,0,31,富邦-嘉義,2024-03-12,9692
00706L,期元大S＆P日圓正2,28,0,28,富邦-嘉義,2024-03-12,9692
00734B,台新JPM新興債,27,0,27,富邦-嘉義,2024-03-12,9692
2317,鴻海,5263,1751,3512,富邦-嘉義,2024-03-13,9692
1319,東陽,817,58,759,富邦-嘉義,2024-03-13,9692
00919,群益台灣精選高息,724,95,629,富邦-嘉義,2024-03-13,9692
2367,燿華,316,49,267,富邦-嘉義,2024-03-13,9692
00915,凱基優選高股息30,179,20,159,富邦-嘉義,2024-03-13,9692
1313,聯成,158,4,154,富邦-嘉義,2024-03-13,9692
00720B,元大投資級公司債,152,2,150,富邦-嘉義,2024-03-13,9692
00679B,元大美債20年,164,17,147,富邦-嘉義,2024-03-13,9692
00918,大華優利高填息30,196,61,135,富邦-嘉義,2024-03-13,9692
1455,集盛,120,0,120,富邦-嘉義,2024-03-13,9692
2301,光寶科,123,13,110,富邦-嘉義,2024-03-13,9692
2408,南亞科,100,0,100,富邦-嘉義,2024-03-13,9692
8926,台汽電,220,123,97,富邦-嘉義,2024-03-13,9692
5355,佳總,95,0,95,富邦-嘉義,2024-03-13,9692
2882,國泰金,133,40,93,富邦-嘉義,2024-03-13,9692
9902,台火,426,340,86,富邦-嘉義,2024-03-13,9692
1503,士電,1018,942,76,富邦-嘉義,2024-03-13,9692
2344,華邦電,89,17,72,富邦-嘉義,2024-03-13,9692
2002,中鋼,83,11,72,富邦-嘉義,2024-03-13,9692
00937B,群益ESG投等債20,66,8,58,富邦-嘉義,2024-03-13,9692
6290,良維,76,19,57,富邦-嘉義,2024-03-13,9692
4906,正文,58,3,55,富邦-嘉義,2024-03-13,9692
2465,麗臺,78,23,55,富邦-嘉義,2024-03-13,9692
5310,天剛,54,5,49,富邦-嘉義,2024-03-13,9692
6282,康舒,52,5,47,富邦-嘉義,2024-03-13,9692
2834,臺企銀,76,32,44,富邦-嘉義,2024-03-13,9692
2883,凱基金,242,199,43,富邦-嘉義,2024-03-13,9692
1519,華城,279,240,39,富邦-嘉義,2024-03-13,9692
1101,台泥,51,14,37,富邦-嘉義,2024-03-13,9692
00712,復華富時不動產,57,21,36,富邦-嘉義,2024-03-13,9692
00931B,統一美債20年,37,2,35,富邦-嘉義,2024-03-13,9692
00734B,台新JPM新興債,33,0,33,富邦-嘉義,2024-03-13,9692
00934,中信成長高股息,45,12,33,富邦-嘉義,2024-03-13,9692
3715,定穎投控,36,3,33,富邦-嘉義,2024-03-13,9692
3163,波若威,822,790,32,富邦-嘉義,2024-03-13,9692
3373,熱映,30,0,30,富邦-嘉義,2024-03-13,9692
3047,訊舟,73,43,30,富邦-嘉義,2024-03-13,9692
00907,永豐優息存股,33,3,30,富邦-嘉義,2024-03-13,9692
3596,智易,35,6,29,富邦-嘉義,2024-03-13,9692
2103,台橡,29,0,29,富邦-嘉義,2024-03-13,9692
1325,恆大,28,0,28,富邦-嘉義,2024-03-13,9692
3260,威剛,29,1,28,富邦-嘉義,2024-03-13,9692
5521,工信,32,5,27,富邦-嘉義,2024-03-13,9692
6274,台燿,34,8,26,富邦-嘉義,2024-03-13,9692
6016,康和證,43,17,26,富邦-嘉義,2024-03-13,9692
4960,誠美材,26,0,26,富邦-嘉義,2024-03-13,9692
6770,力積電,34,8,26,富邦-嘉義,2024-03-13,9692
2312,金寶,25,0,25,富邦-嘉義,2024-03-13,9692
3576,聯合再生,24,0,24,富邦-嘉義,2024-03-13,9692
6412,群電,84,60,24,富邦-嘉義,2024-03-13,9692
2834,臺企銀,1685,171,1514,富邦-嘉義,2024-03-14,9692
2022,聚亨,1000,0,1000,富邦-嘉義,2024-03-14,9692
2883,凱基金,1072,234,838,富邦-嘉義,2024-03-14,9692
00937B,群益ESG投等債20,399,16,383,富邦-嘉義,2024-03-14,9692
2618,長榮航,292,68,224,富邦-嘉義,2024-03-14,9692
00919,群益台灣精選高息,912,703,209,富邦-嘉義,2024-03-14,9692
00679B,元大美債20年,178,4,174,富邦-嘉義,2024-03-14,9692
00918,大華優利高填息30,195,53,142,富邦-嘉義,2024-03-14,9692
4714,永捷,197,65,132,富邦-嘉義,2024-03-14,9692
6770,力積電,132,3,129,富邦-嘉義,2024-03-14,9692
1616,億泰,167,48,119,富邦-嘉義,2024-03-14,9692
1402,遠東新,127,10,117,富邦-嘉義,2024-03-14,9692
00929,復華台灣科技優息,370,258,112,富邦-嘉義,2024-03-14,9692
00687B,國泰20年美債,112,7,105,富邦-嘉義,2024-03-14,9692
2020,美亞,149,47,102,富邦-嘉義,2024-03-14,9692
2354,鴻準,322,233,89,富邦-嘉義,2024-03-14,9692
2801,彰銀,111,23,88,富邦-嘉義,2024-03-14,9692
5258,虹堡,174,87,87,富邦-嘉義,2024-03-14,9692
2882,國泰金,187,101,86,富邦-嘉義,2024-03-14,9692
00933B,國泰10Y+金融債,81,1,80,富邦-嘉義,2024-03-14,9692
00720B,元大投資級公司債,96,17,79,富邦-嘉義,2024-03-14,9692
2889,國票金,1724,1647,77,富邦-嘉義,2024-03-14,9692
00915,凱基優選高股息30,146,71,75,富邦-嘉義,2024-03-14,9692
1316,上曜,1044,972,72,富邦-嘉義,2024-03-14,9692
3049,精金,243,172,71,富邦-嘉義,2024-03-14,9692
5310,天剛,110,45,65,富邦-嘉義,2024-03-14,9692
3576,聯合再生,61,1,60,富邦-嘉義,2024-03-14,9692
1608,華榮,81,21,60,富邦-嘉義,2024-03-14,9692
00706L,期元大S＆P日圓正2,50,0,50,富邦-嘉義,2024-03-14,9692
2887,台新金,63,16,47,富邦-嘉義,2024-03-14,9692
00931B,統一美債20年,43,0,43,富邦-嘉義,2024-03-14,9692
2323,中環,62,19,43,富邦-嘉義,2024-03-14,9692
3071,協禧,44,2,42,富邦-嘉義,2024-03-14,9692
1603,華電,57,15,42,富邦-嘉義,2024-03-14,9692
00633L,富邦上証正2,40,1,39,富邦-嘉義,2024-03-14,9692
2615,萬海,41,3,38,富邦-嘉義,2024-03-14,9692
2009,第一銅,118,80,38,富邦-嘉義,2024-03-14,9692
6274,台燿,110,73,37,富邦-嘉義,2024-03-14,9692
2603,長榮,66,29,37,富邦-嘉義,2024-03-14,9692
3540,曜越,347,311,36,富邦-嘉義,2024-03-14,9692
00878,國泰永續高股息,78,43,35,富邦-嘉義,2024-03-14,9692
2356,英業達,61,28,33,富邦-嘉義,2024-03-14,9692
00907,永豐優息存股,33,2,31,富邦-嘉義,2024-03-14,9692
1712,興農,31,1,30,富邦-嘉義,2024-03-14,9692
2609,陽明,45,16,29,富邦-嘉義,2024-03-14,9692
2601,益航,36,8,28,富邦-嘉義,2024-03-14,9692
2845,遠東銀,27,0,27,富邦-嘉義,2024-03-14,9692
2605,新興,26,1,25,富邦-嘉義,2024-03-14,9692
2465,麗臺,46,21,25,富邦-嘉義,2024-03-14,9692
2344,華邦電,32,7,25,富邦-嘉義,2024-03-14,9692
00919,群益台灣精選高息,1009,254,755,富邦-嘉義,2024-03-15,9692
3049,精金,408,33,375,富邦-嘉義,2024-03-15,9692
00937B,群益ESG投等債20,379,46,333,富邦-嘉義,2024-03-15,9692
00673R,期元大S＆P原油反1,280,0,280,富邦-嘉義,2024-03-15,9692
2834,臺企銀,483,291,192,富邦-嘉義,2024-03-15,9692
2367,燿華,230,41,189,富邦-嘉義,2024-03-15,9692
00687B,國泰20年美債,168,5,163,富邦-嘉義,2024-03-15,9692
2897A,王道銀甲特,150,0,150,富邦-嘉義,2024-03-15,9692
2882,國泰金,213,67,146,富邦-嘉義,2024-03-15,9692
2330,台積電,154,11,143,富邦-嘉義,2024-03-15,9692
2313,華通,198,55,143,富邦-嘉義,2024-03-15,9692
3706,神達,214,85,129,富邦-嘉義,2024-03-15,9692
1313,聯成,121,0,121,富邦-嘉義,2024-03-15,9692
1210,大成,146,26,120,富邦-嘉義,2024-03-15,9692
2618,長榮航,158,45,113,富邦-嘉義,2024-03-15,9692
2382,廣達,1309,1201,108,富邦-嘉義,2024-03-15,9692
3466,德晉,98,0,98,富邦-嘉義,2024-03-15,9692
6230,尼得科超眾,235,143,92,富邦-嘉義,2024-03-15,9692
6274,台燿,152,68,84,富邦-嘉義,2024-03-15,9692
3294,英濟,453,375,78,富邦-嘉義,2024-03-15,9692
2615,萬海,106,32,74,富邦-嘉義,2024-03-15,9692
2888,新光金,78,10,68,富邦-嘉義,2024-03-15,9692
2603,長榮,103,38,65,富邦-嘉義,2024-03-15,9692
6207,雷科,74,11,63,富邦-嘉義,2024-03-15,9692
2485,兆赫,58,0,58,富邦-嘉義,2024-03-15,9692
00680L,元大美債20正2,58,1,57,富邦-嘉義,2024-03-15,9692
00915,凱基優選高股息30,83,28,55,富邦-嘉義,2024-03-15,9692
00712,復華富時不動產,59,5,54,富邦-嘉義,2024-03-15,9692
00669R,國泰美國道瓊反1,50,0,50,富邦-嘉義,2024-03-15,9692
2371,大同,49,1,48,富邦-嘉義,2024-03-15,9692
00830,國泰費城半導體,45,1,44,富邦-嘉義,2024-03-15,9692
5508,永信建,46,2,44,富邦-嘉義,2024-03-15,9692
1722,台肥,42,0,42,富邦-嘉義,2024-03-15,9692
3576,聯合再生,65,27,38,富邦-嘉義,2024-03-15,9692
6139,亞翔,51,13,38,富邦-嘉義,2024-03-15,9692
2009,第一銅,123,88,35,富邦-嘉義,2024-03-15,9692
2408,南亞科,35,0,35,富邦-嘉義,2024-03-15,9692
1303,南亞,42,9,33,富邦-嘉義,2024-03-15,9692
00907,永豐優息存股,33,1,32,富邦-嘉義,2024-03-15,9692
2911,麗嬰房,32,0,32,富邦-嘉義,2024-03-15,9692
2801,彰銀,42,11,31,富邦-嘉義,2024-03-15,9692
2349,錸德,36,5,31,富邦-嘉義,2024-03-15,9692
3325,旭品,32,1,31,富邦-嘉義,2024-03-15,9692
2609,陽明,76,45,31,富邦-嘉義,2024-03-15,9692
6486,互動,30,0,30,富邦-嘉義,2024-03-15,9692
6190,萬泰科,32,3,29,富邦-嘉義,2024-03-15,9692
00933B,國泰10Y+金融債,32,3,29,富邦-嘉義,2024-03-15,9692
3714,富采,29,0,29,富邦-嘉義,2024-03-15,9692
2353,宏��,79,50,29,富邦-嘉義,2024-03-15,9692
6015,宏遠證,33,5,28,富邦-嘉義,2024-03-15,9692
00919,群益台灣精選高息,538,244,294,富邦-嘉義,2024-03-18,9692
00687B,國泰20年美債,220,1,219,富邦-嘉義,2024-03-18,9692
00941,中信上游半導體,215,1,214,富邦-嘉義,2024-03-18,9692
00673R,期元大S＆P原油反1,202,50,152,富邦-嘉義,2024-03-18,9692
2409,友達,176,29,147,富邦-嘉義,2024-03-18,9692
00937B,群益ESG投等債20,165,31,134,富邦-嘉義,2024-03-18,9692
4909,新復興,250,127,123,富邦-嘉義,2024-03-18,9692
00650L,復華香港正2,101,0,101,富邦-嘉義,2024-03-18,9692
00753L,中信中國50正2,100,0,100,富邦-嘉義,2024-03-18,9692
00679B,元大美債20年,101,4,97,富邦-嘉義,2024-03-18,9692
1503,士電,276,180,96,富邦-嘉義,2024-03-18,9692
4961,天鈺,124,29,95,富邦-嘉義,2024-03-18,9692
2834,臺企銀,296,215,81,富邦-嘉義,2024-03-18,9692
6425,易發,72,3,69,富邦-嘉義,2024-03-18,9692
2855,統一證,69,3,66,富邦-嘉義,2024-03-18,9692
8011,台通,326,261,65,富邦-嘉義,2024-03-18,9692
2883,凱基金,147,84,63,富邦-嘉義,2024-03-18,9692
3294,英濟,293,232,61,富邦-嘉義,2024-03-18,9692
3466,德晉,56,1,55,富邦-嘉義,2024-03-18,9692
00857B,永豐20年美公債,51,0,51,富邦-嘉義,2024-03-18,9692
8112,至上,68,17,51,富邦-嘉義,2024-03-18,9692
2059,川湖,130,80,50,富邦-嘉義,2024-03-18,9692
4109,加捷生醫,48,0,48,富邦-嘉義,2024-03-18,9692
5608,四維航,48,0,48,富邦-嘉義,2024-03-18,9692
00751B,元大AAA至A公司債,47,1,46,富邦-嘉義,2024-03-18,9692
1514,亞力,274,230,44,富邦-嘉義,2024-03-18,9692
6770,力積電,64,22,42,富邦-嘉義,2024-03-18,9692
2845,遠東銀,41,2,39,富邦-嘉義,2024-03-18,9692
3481,群創,52,13,39,富邦-嘉義,2024-03-18,9692
00795B,中信美國公債20年,38,1,37,富邦-嘉義,2024-03-18,9692
1445,大宇,36,0,36,富邦-嘉義,2024-03-18,9692
2323,中環,147,112,35,富邦-嘉義,2024-03-18,9692
2467,志聖,55,21,34,富邦-嘉義,2024-03-18,9692
2002,中鋼,53,20,33,富邦-嘉義,2024-03-18,9692
1604,聲寶,34,1,33,富邦-嘉義,2024-03-18,9692
2356,英業達,74,41,33,富邦-嘉義,2024-03-18,9692
9902,台火,43,11,32,富邦-嘉義,2024-03-18,9692
3498,陽程,40,9,31,富邦-嘉義,2024-03-18,9692
8467,波力-KY,116,85,31,富邦-嘉義,2024-03-18,9692
2812,台中銀,36,5,31,富邦-嘉義,2024-03-18,9692
5880,合庫金,32,2,30,富邦-嘉義,2024-03-18,9692
2486,一詮,1609,1579,30,富邦-嘉義,2024-03-18,9692
4420,光明,31,2,29,富邦-嘉義,2024-03-18,9692
1101,台泥,36,7,29,富邦-嘉義,2024-03-18,9692
2449,京元電子,84,55,29,富邦-嘉義,2024-03-18,9692
1615,大山,29,2,27,富邦-嘉義,2024-03-18,9692
6116,彩晶,29,2,27,富邦-嘉義,2024-03-18,9692
00931B,統一美債20年,26,0,26,富邦-嘉義,2024-03-18,9692
6933,AMAX-KY,27,1,26,富邦-嘉義,2024-03-18,9692
6462,神盾,37,12,25,富邦-嘉義,2024-03-18,9692
2367,燿華,1736,735,1001,富邦-嘉義,2024-03-19,9692
3706,神達,2342,1626,716,富邦-嘉義,2024-03-19,9692
6188,廣明,393,48,345,富邦-嘉義,2024-03-19,9692
2888,新光金,345,12,333,富邦-嘉義,2024-03-19,9692
2313,華通,434,107,327,富邦-嘉義,2024-03-19,9692
4938,和碩,761,508,253,富邦-嘉義,2024-03-19,9692
2515,中工,1226,1004,222,富邦-嘉義,2024-03-19,9692
00937B,群益ESG投等債20,211,13,198,富邦-嘉義,2024-03-19,9692
2836,高雄銀,160,2,158,富邦-嘉義,2024-03-19,9692
00891,中信關鍵半導體,122,1,121,富邦-嘉義,2024-03-19,9692
00919,群益台灣精選高息,294,175,119,富邦-嘉義,2024-03-19,9692
00857B,永豐20年美公債,85,0,85,富邦-嘉義,2024-03-19,9692
6735,美達科技,193,109,84,富邦-嘉義,2024-03-19,9692
5443,均豪,145,63,82,富邦-嘉義,2024-03-19,9692
00687B,國泰20年美債,125,44,81,富邦-嘉義,2024-03-19,9692
00679B,元大美債20年,83,5,78,富邦-嘉義,2024-03-19,9692
1101,台泥,110,32,78,富邦-嘉義,2024-03-19,9692
3563,牧德,252,179,73,富邦-嘉義,2024-03-19,9692
00680L,元大美債20正2,72,0,72,富邦-嘉義,2024-03-19,9692
3147,大綜,87,22,65,富邦-嘉義,2024-03-19,9692
2301,光寶科,332,269,63,富邦-嘉義,2024-03-19,9692
3576,聯合再生,65,3,62,富邦-嘉義,2024-03-19,9692
2488,漢平,57,2,55,富邦-嘉義,2024-03-19,9692
3481,群創,61,7,54,富邦-嘉義,2024-03-19,9692
2834,臺企銀,86,34,52,富邦-嘉義,2024-03-19,9692
00673R,期元大S＆P原油反1,50,0,50,富邦-嘉義,2024-03-19,9692
00931B,統一美債20年,67,19,48,富邦-嘉義,2024-03-19,9692
6605,帝寶,50,7,43,富邦-嘉義,2024-03-19,9692
2353,宏��,155,113,42,富邦-嘉義,2024-03-19,9692
1504,東元,499,457,42,富邦-嘉義,2024-03-19,9692
2464,盟立,510,471,39,富邦-嘉義,2024-03-19,9692
5498,凱崴,41,2,39,富邦-嘉義,2024-03-19,9692
2009,第一銅,39,1,38,富邦-嘉義,2024-03-19,9692
1303,南亞,39,1,38,富邦-嘉義,2024-03-19,9692
8936,國統,80,44,36,富邦-嘉義,2024-03-19,9692
2387,精元,38,3,35,富邦-嘉義,2024-03-19,9692
1618,合機,49,15,34,富邦-嘉義,2024-03-19,9692
00941,中信上游半導體,55,22,33,富邦-嘉義,2024-03-19,9692
1325,恆大,33,0,33,富邦-嘉義,2024-03-19,9692
00893,國泰智能電動車,36,4,32,富邦-嘉義,2024-03-19,9692
2349,錸德,30,0,30,富邦-嘉義,2024-03-19,9692
1301,台塑,32,3,29,富邦-嘉義,2024-03-19,9692
8011,台通,51,22,29,富邦-嘉義,2024-03-19,9692
3013,晟銘電,30,2,28,富邦-嘉義,2024-03-19,9692
2801,彰銀,31,3,28,富邦-嘉義,2024-03-19,9692
1722,台肥,27,0,27,富邦-嘉義,2024-03-19,9692
2208,台船,154,127,27,富邦-嘉義,2024-03-19,9692
1519,華城,32,5,27,富邦-嘉義,2024-03-19,9692
6278,台表科,29,4,25,富邦-嘉義,2024-03-19,9692
3005,神基,79,55,24,富邦-嘉義,2024-03-19,9692
3706,神達,5336,3772,1564,富邦-嘉義,2024-03-20,9692
00939,統一台灣高息動能,1758,425,1333,富邦-嘉義,2024-03-20,9692
2367,燿華,970,71,899,富邦-嘉義,2024-03-20,9692
00673R,期元大S＆P原油反1,660,10,650,富邦-嘉義,2024-03-20,9692
00919,群益台灣精選高息,1074,426,648,富邦-嘉義,2024-03-20,9692
2887,台新金,540,0,540,富邦-嘉義,2024-03-20,9692
2324,仁寶,449,60,389,富邦-嘉義,2024-03-20,9692
2353,宏��,468,82,386,富邦-嘉義,2024-03-20,9692
6191,精成科,976,678,298,富邦-嘉義,2024-03-20,9692
3005,神基,915,617,298,富邦-嘉義,2024-03-20,9692
2313,華通,361,205,156,富邦-嘉義,2024-03-20,9692
2611,志信,149,11,138,富邦-嘉義,2024-03-20,9692
2801,彰銀,125,0,125,富邦-嘉義,2024-03-20,9692
00857B,永豐20年美公債,111,0,111,富邦-嘉義,2024-03-20,9692
2356,英業達,147,36,111,富邦-嘉義,2024-03-20,9692
3576,聯合再生,109,0,109,富邦-嘉義,2024-03-20,9692
1101,台泥,117,19,98,富邦-嘉義,2024-03-20,9692
00679B,元大美債20年,98,2,96,富邦-嘉義,2024-03-20,9692
8112,至上,107,14,93,富邦-嘉義,2024-03-20,9692
8234,新漢,1421,1330,91,富邦-嘉義,2024-03-20,9692
4127,天良,105,27,78,富邦-嘉義,2024-03-20,9692
1215,卜蜂,70,0,70,富邦-嘉義,2024-03-20,9692
3481,群創,66,4,62,富邦-嘉義,2024-03-20,9692
00751B,元大AAA至A公司債,59,0,59,富邦-嘉義,2024-03-20,9692
2641,正德,52,0,52,富邦-嘉義,2024-03-20,9692
00753L,中信中國50正2,51,0,51,富邦-嘉義,2024-03-20,9692
2344,華邦電,75,25,50,富邦-嘉義,2024-03-20,9692
5432,新門,49,3,46,富邦-嘉義,2024-03-20,9692
3406,玉晶光,121,76,45,富邦-嘉義,2024-03-20,9692
2489,瑞軒,55,12,43,富邦-嘉義,2024-03-20,9692
1301,台塑,48,5,43,富邦-嘉義,2024-03-20,9692
3312,弘憶股,60,21,39,富邦-嘉義,2024-03-20,9692
2892,第一金,39,2,37,富邦-嘉義,2024-03-20,9692
5493,三聯,46,9,37,富邦-嘉義,2024-03-20,9692
6274,台燿,48,14,34,富邦-嘉義,2024-03-20,9692
2002,中鋼,46,11,35,富邦-嘉義,2024-03-20,9692
00706L,期元大S＆P日圓正2,39,5,34,富邦-嘉義,2024-03-20,9692
2885,元大金,38,4,34,富邦-嘉義,2024-03-20,9692
1815,富喬,41,8,33,富邦-嘉義,2024-03-20,9692
2882,國泰金,49,17,32,富邦-嘉義,2024-03-20,9692
3508,位速,34,2,32,富邦-嘉義,2024-03-20,9692
3059,華晶科,41,9,32,富邦-嘉義,2024-03-20,9692
2374,佳能,380,350,30,富邦-嘉義,2024-03-20,9692
1303,南亞,32,4,28,富邦-嘉義,2024-03-20,9692
8092,建暐,29,1,28,富邦-嘉義,2024-03-20,9692
1217,愛之味,27,0,27,富邦-嘉義,2024-03-20,9692
2385,群光,36,9,27,富邦-嘉義,2024-03-20,9692
2485,兆赫,26,0,26,富邦-嘉義,2024-03-20,9692
2880,華南金,30,5,25,富邦-嘉義,2024-03-20,9692
2618,長榮航,48,23,25,富邦-嘉義,2024-03-20,9692
00939,統一台灣高息動能,1213,215,998,富邦-嘉義,2024-03-21,9692
00632R,元大台灣50反1,809,3,806,富邦-嘉義,2024-03-21,9692
2408,南亞科,877,495,382,富邦-嘉義,2024-03-21,9692
00937B,群益ESG投等債20,420,92,328,富邦-嘉義,2024-03-21,9692
2358,廷鑫,382,56,326,富邦-嘉義,2024-03-21,9692
8271,宇瞻,546,230,316,富邦-嘉義,2024-03-21,9692
2353,宏��,326,14,312,富邦-嘉義,2024-03-21,9692
2486,一詮,534,270,264,富邦-嘉義,2024-03-21,9692
1314,中石化,239,17,222,富邦-嘉義,2024-03-21,9692
2406,國碩,610,427,183,富邦-嘉義,2024-03-21,9692
00720B,元大投資級公司債,186,21,165,富邦-嘉義,2024-03-21,9692
2324,仁寶,213,51,162,富邦-嘉義,2024-03-21,9692
00857B,永豐20年美公債,131,0,131,富邦-嘉義,2024-03-21,9692
2354,鴻準,839,720,119,富邦-嘉義,2024-03-21,9692
00665L,富邦�琤肭磪囓�2,184,65,119,富邦-嘉義,2024-03-21,9692
00929,復華台灣科技優息,299,189,110,富邦-嘉義,2024-03-21,9692
3083,網龍,110,4,106,富邦-嘉義,2024-03-21,9692
00687B,國泰20年美債,107,16,91,富邦-嘉義,2024-03-21,9692
3581,博磊,156,66,90,富邦-嘉義,2024-03-21,9692
00679B,元大美債20年,83,0,83,富邦-嘉義,2024-03-21,9692
3322,建舜電,80,2,78,富邦-嘉義,2024-03-21,9692
3686,達能,77,0,77,富邦-嘉義,2024-03-21,9692
00751B,元大AAA至A公司債,75,2,73,富邦-嘉義,2024-03-21,9692
00676R,富邦臺灣加權反1,68,10,58,富邦-嘉義,2024-03-21,9692
2801,彰銀,62,7,55,富邦-嘉義,2024-03-21,9692
4938,和碩,134,80,54,富邦-嘉義,2024-03-21,9692
8088,品安,62,11,51,富邦-嘉義,2024-03-21,9692
00688L,國泰20年美債正2,50,0,50,富邦-嘉義,2024-03-21,9692
6290,良維,57,9,48,富邦-嘉義,2024-03-21,9692
00878,國泰永續高股息,116,68,48,富邦-嘉義,2024-03-21,9692
3706,神達,4336,4289,47,富邦-嘉義,2024-03-21,9692
6139,亞翔,64,18,46,富邦-嘉義,2024-03-21,9692
8996,高力,160,114,46,富邦-嘉義,2024-03-21,9692
4909,新復興,85,41,44,富邦-嘉義,2024-03-21,9692
2365,昆盈,48,5,43,富邦-嘉義,2024-03-21,9692
2327,國巨,44,1,43,富邦-嘉義,2024-03-21,9692
2236,百達-KY,161,121,40,富邦-嘉義,2024-03-21,9692
00680L,元大美債20正2,67,30,37,富邦-嘉義,2024-03-21,9692
1108,幸福,37,1,36,富邦-嘉義,2024-03-21,9692
8299,群聯,92,57,35,富邦-嘉義,2024-03-21,9692
8150,南茂,35,1,34,富邦-嘉義,2024-03-21,9692
4915,致伸,44,11,33,富邦-嘉義,2024-03-21,9692
1101,台泥,43,11,32,富邦-嘉義,2024-03-21,9692
1503,士電,681,650,31,富邦-嘉義,2024-03-21,9692
4960,誠美材,55,25,30,富邦-嘉義,2024-03-21,9692
00673R,期元大S＆P原油反1,30,1,29,富邦-嘉義,2024-03-21,9692
1514,亞力,301,273,28,富邦-嘉義,2024-03-21,9692
3264,欣銓,58,30,28,富邦-嘉義,2024-03-21,9692
2374,佳能,143,115,28,富邦-嘉義,2024-03-21,9692
6488,環球晶,33,7,26,富邦-嘉義,2024-03-21,9692
2356,英業達,7139,5987,1152,富邦-嘉義,2024-03-22,9692
1609,大亞,2265,1148,1117,富邦-嘉義,2024-03-22,9692
2634,漢翔,706,245,461,富邦-嘉義,2024-03-22,9692
2464,盟立,452,48,404,富邦-嘉義,2024-03-22,9692
00632R,元大台灣50反1,343,25,318,富邦-嘉義,2024-03-22,9692
00753L,中信中國50正2,250,0,250,富邦-嘉義,2024-03-22,9692
00939,統一台灣高息動能,429,183,246,富邦-嘉義,2024-03-22,9692
00919,群益台灣精選高息,619,397,222,富邦-嘉義,2024-03-22,9692
00937B,群益ESG投等債20,299,92,207,富邦-嘉義,2024-03-22,9692
6189,豐藝,722,520,202,富邦-嘉義,2024-03-22,9692
3708,上緯投控,521,347,174,富邦-嘉義,2024-03-22,9692
2883,凱基金,184,21,163,富邦-嘉義,2024-03-22,9692
1402,遠東新,156,30,126,富邦-嘉義,2024-03-22,9692
6139,亞翔,265,153,112,富邦-嘉義,2024-03-22,9692
2313,華通,117,14,103,富邦-嘉義,2024-03-22,9692
00720B,元大投資級公司債,101,0,101,富邦-嘉義,2024-03-22,9692
8147,正淩,195,98,97,富邦-嘉義,2024-03-22,9692
2330,台積電,92,7,85,富邦-嘉義,2024-03-22,9692
00679B,元大美債20年,103,22,81,富邦-嘉義,2024-03-22,9692
3049,精金,80,0,80,富邦-嘉義,2024-03-22,9692
2511,太子,74,0,74,富邦-嘉義,2024-03-22,9692
00929,復華台灣科技優息,174,104,70,富邦-嘉義,2024-03-22,9692
4915,致伸,56,0,56,富邦-嘉義,2024-03-22,9692
2002,中鋼,88,33,55,富邦-嘉義,2024-03-22,9692
2367,燿華,943,892,51,富邦-嘉義,2024-03-22,9692
2467,志聖,53,5,48,富邦-嘉義,2024-03-22,9692
2376,技嘉,217,171,46,富邦-嘉義,2024-03-22,9692
2618,長榮航,69,23,46,富邦-嘉義,2024-03-22,9692
8996,高力,264,220,44,富邦-嘉義,2024-03-22,9692
3294,英濟,226,183,43,富邦-嘉義,2024-03-22,9692
3406,玉晶光,36,0,36,富邦-嘉義,2024-03-22,9692
2025,千興,36,0,36,富邦-嘉義,2024-03-22,9692
6442,光聖,145,111,34,富邦-嘉義,2024-03-22,9692
00687B,國泰20年美債,105,72,33,富邦-嘉義,2024-03-22,9692
1815,富喬,39,7,32,富邦-嘉義,2024-03-22,9692
1314,中石化,34,2,32,富邦-嘉義,2024-03-22,9692
2851,中再保,30,0,30,富邦-嘉義,2024-03-22,9692
6541,泰福-KY,29,0,29,富邦-嘉義,2024-03-22,9692
6290,良維,57,28,29,富邦-嘉義,2024-03-22,9692
2801,彰銀,26,0,26,富邦-嘉義,2024-03-22,9692
3313,斐成,24,0,24,富邦-嘉義,2024-03-22,9692
5871,中租-KY,24,0,24,富邦-嘉義,2024-03-22,9692
2006,東和鋼鐵,24,1,23,富邦-嘉義,2024-03-22,9692
9950,萬國通,23,0,23,富邦-嘉義,2024-03-22,9692
00891,中信關鍵半導體,47,24,23,富邦-嘉義,2024-03-22,9692
9902,台火,23,1,22,富邦-嘉義,2024-03-22,9692
3147,大綜,23,2,21,富邦-嘉義,2024-03-22,9692
4916,事欣科,31,10,21,富邦-嘉義,2024-03-22,9692
2344,華邦電,119,99,20,富邦-嘉義,2024-03-22,9692
00676R,富邦臺灣加權反1,30,10,20,富邦-嘉義,2024-03-22,9692
6125,廣運,1832,1017,815,富邦-嘉義,2024-03-25,9692
6274,台燿,740,318,422,富邦-嘉義,2024-03-25,9692
5258,虹堡,435,137,298,富邦-嘉義,2024-03-25,9692
6290,良維,674,407,267,富邦-嘉義,2024-03-25,9692
6668,中揚光,277,18,259,富邦-嘉義,2024-03-25,9692
00720B,元大投資級公司債,251,0,251,富邦-嘉義,2024-03-25,9692
5426,振發,290,59,231,富邦-嘉義,2024-03-25,9692
00939,統一台灣高息動能,329,99,230,富邦-嘉義,2024-03-25,9692
00712,復華富時不動產,219,11,208,富邦-嘉義,2024-03-25,9692
00941,中信上游半導體,333,144,189,富邦-嘉義,2024-03-25,9692
2388,威盛,188,13,175,富邦-嘉義,2024-03-25,9692
6530,創威,230,84,146,富邦-嘉義,2024-03-25,9692
00937B,群益ESG投等債20,264,126,138,富邦-嘉義,2024-03-25,9692
2301,光寶科,141,11,130,富邦-嘉義,2024-03-25,9692
4526,東台,511,382,129,富邦-嘉義,2024-03-25,9692
00632R,元大台灣50反1,108,3,105,富邦-嘉義,2024-03-25,9692
00885,富邦越南,107,6,101,富邦-嘉義,2024-03-25,9692
3312,弘憶股,212,115,97,富邦-嘉義,2024-03-25,9692
00679B,元大美債20年,106,12,94,富邦-嘉義,2024-03-25,9692
9917,中保科,105,15,90,富邦-嘉義,2024-03-25,9692
6517,保勝光學,95,23,72,富邦-嘉義,2024-03-25,9692
2888,新光金,106,38,68,富邦-嘉義,2024-03-25,9692
2353,宏��,228,164,64,富邦-嘉義,2024-03-25,9692
00919,群益台灣精選高息,310,255,55,富邦-嘉義,2024-03-25,9692
2323,中環,61,10,51,富邦-嘉義,2024-03-25,9692
3607,谷崧,50,0,50,富邦-嘉義,2024-03-25,9692
5469,瀚宇博,93,43,50,富邦-嘉義,2024-03-25,9692
4148,全宇生技-KY,73,28,45,富邦-嘉義,2024-03-25,9692
00687B,國泰20年美債,56,12,44,富邦-嘉義,2024-03-25,9692
2049,上銀,52,13,39,富邦-嘉義,2024-03-25,9692
2303,聯電,92,54,38,富邦-嘉義,2024-03-25,9692
4420,光明,37,0,37,富邦-嘉義,2024-03-25,9692
1514,亞力,353,317,36,富邦-嘉義,2024-03-25,9692
2515,中工,49,14,35,富邦-嘉義,2024-03-25,9692
2486,一詮,1978,1944,34,富邦-嘉義,2024-03-25,9692
2867,三商壽,34,0,34,富邦-嘉義,2024-03-25,9692
8163,達方,34,2,32,富邦-嘉義,2024-03-25,9692
5498,凱崴,33,1,32,富邦-嘉義,2024-03-25,9692
3050,鈺德,34,2,32,富邦-嘉義,2024-03-25,9692
1725,元禎,30,0,30,富邦-嘉義,2024-03-25,9692
00650L,復華香港正2,30,0,30,富邦-嘉義,2024-03-25,9692
6147,頎邦,36,6,30,富邦-嘉義,2024-03-25,9692
3231,緯創,290,260,30,富邦-嘉義,2024-03-25,9692
6166,凌華,208,179,29,富邦-嘉義,2024-03-25,9692
1717,長興,47,18,29,富邦-嘉義,2024-03-25,9692
00795B,中信美國公債20年,28,0,28,富邦-嘉義,2024-03-25,9692
2317,鴻海,627,599,28,富邦-嘉義,2024-03-25,9692
2002,中鋼,26,0,26,富邦-嘉義,2024-03-25,9692
1513,中興電,978,952,26,富邦-嘉義,2024-03-25,9692
3704,合勤控,27,2,25,富邦-嘉義,2024-03-25,9692
2371,大同,1836,540,1296,富邦-嘉義,2024-03-26,9692
1608,華榮,2503,1829,674,富邦-嘉義,2024-03-26,9692
00664R,國泰臺灣加權反1,430,0,430,富邦-嘉義,2024-03-26,9692
2382,廣達,714,485,229,富邦-嘉義,2024-03-26,9692
6163,華電網,433,223,210,富邦-嘉義,2024-03-26,9692
00720B,元大投資級公司債,207,0,207,富邦-嘉義,2024-03-26,9692
00937B,群益ESG投等債20,201,23,178,富邦-嘉義,2024-03-26,9692
1603,華電,1211,1048,163,富邦-嘉義,2024-03-26,9692
1313,聯成,150,0,150,富邦-嘉義,2024-03-26,9692
6179,亞通,257,108,149,富邦-嘉義,2024-03-26,9692
6139,亞翔,147,2,145,富邦-嘉義,2024-03-26,9692
1616,億泰,378,243,135,富邦-嘉義,2024-03-26,9692
00939,統一台灣高息動能,407,289,118,富邦-嘉義,2024-03-26,9692
00632R,元大台灣50反1,308,216,92,富邦-嘉義,2024-03-26,9692
00673R,期元大S＆P原油反1,91,0,91,富邦-嘉義,2024-03-26,9692
6215,和椿,363,292,71,富邦-嘉義,2024-03-26,9692
2465,麗臺,77,8,69,富邦-嘉義,2024-03-26,9692
2464,盟立,108,41,67,富邦-嘉義,2024-03-26,9692
2883,凱基金,102,41,61,富邦-嘉義,2024-03-26,9692
2349,錸德,60,2,58,富邦-嘉義,2024-03-26,9692
2489,瑞軒,55,1,54,富邦-嘉義,2024-03-26,9692
1540,喬福,56,2,54,富邦-嘉義,2024-03-26,9692
1513,中興電,3599,3545,54,富邦-嘉義,2024-03-26,9692
00679B,元大美債20年,85,32,53,富邦-嘉義,2024-03-26,9692
4157,太景*-KY,51,2,49,富邦-嘉義,2024-03-26,9692
8092,建暐,107,59,48,富邦-嘉義,2024-03-26,9692
3622,洋華,84,37,47,富邦-嘉義,2024-03-26,9692
2618,長榮航,84,40,44,富邦-嘉義,2024-03-26,9692
2609,陽明,70,26,44,富邦-嘉義,2024-03-26,9692
2313,華通,61,19,42,富邦-嘉義,2024-03-26,9692
3163,波若威,60,19,41,富邦-嘉義,2024-03-26,9692
2303,聯電,70,30,40,富邦-嘉義,2024-03-26,9692
2344,華邦電,164,125,39,富邦-嘉義,2024-03-26,9692
3294,英濟,64,26,38,富邦-嘉義,2024-03-26,9692
5386,青雲,56,20,36,富邦-嘉義,2024-03-26,9692
5608,四維航,42,7,35,富邦-嘉義,2024-03-26,9692
2478,大毅,35,0,35,富邦-嘉義,2024-03-26,9692
2603,長榮,157,123,34,富邦-嘉義,2024-03-26,9692
2421,建準,61,28,33,富邦-嘉義,2024-03-26,9692
8936,國統,101,69,32,富邦-嘉義,2024-03-26,9692
6425,易發,139,108,31,富邦-嘉義,2024-03-26,9692
3062,建漢,37,6,31,富邦-嘉義,2024-03-26,9692
3036,文曄,37,7,30,富邦-嘉義,2024-03-26,9692
1808,潤隆,53,23,30,富邦-嘉義,2024-03-26,9692
2637,慧洋-KY,52,24,28,富邦-嘉義,2024-03-26,9692
2889,國票金,39,11,28,富邦-嘉義,2024-03-26,9692
6121,新普,57,29,28,富邦-嘉義,2024-03-26,9692
2317,鴻海,1141,1115,26,富邦-嘉義,2024-03-26,9692
1587,吉茂,28,3,25,富邦-嘉義,2024-03-26,9692
3686,達能,25,0,25,富邦-嘉義,2024-03-26,9692
2356,英業達,464,79,385,富邦-嘉義,2024-03-27,9692
3062,建漢,680,366,314,富邦-嘉義,2024-03-27,9692
4526,東台,676,435,241,富邦-嘉義,2024-03-27,9692
00939,統一台灣高息動能,257,35,222,富邦-嘉義,2024-03-27,9692
2354,鴻準,1124,904,220,富邦-嘉義,2024-03-27,9692
5515,建國,295,126,169,富邦-嘉義,2024-03-27,9692
2486,一詮,179,29,150,富邦-嘉義,2024-03-27,9692
2317,鴻海,1341,1191,150,富邦-嘉義,2024-03-27,9692
00937B,群益ESG投等債20,175,29,146,富邦-嘉義,2024-03-27,9692
00857B,永豐20年美公債,122,0,122,富邦-嘉義,2024-03-27,9692
2367,燿華,196,85,111,富邦-嘉義,2024-03-27,9692
00679B,元大美債20年,117,8,109,富邦-嘉義,2024-03-27,9692
8201,無敵,108,6,102,富邦-嘉義,2024-03-27,9692
2329,華泰,111,12,99,富邦-嘉義,2024-03-27,9692
1316,上曜,598,499,99,富邦-嘉義,2024-03-27,9692
2049,上銀,153,62,91,富邦-嘉義,2024-03-27,9692
8011,台通,92,7,85,富邦-嘉義,2024-03-27,9692
00919,群益台灣精選高息,456,383,73,富邦-嘉義,2024-03-27,9692
8033,雷虎,124,55,69,富邦-嘉義,2024-03-27,9692
6274,台燿,261,192,69,富邦-嘉義,2024-03-27,9692
2359,所羅門,185,117,68,富邦-嘉義,2024-03-27,9692
3583,辛耘,124,57,67,富邦-嘉義,2024-03-27,9692
00771,元大US高息特別股,56,0,56,富邦-嘉義,2024-03-27,9692
1560,中砂,98,43,55,富邦-嘉義,2024-03-27,9692
8996,高力,69,15,54,富邦-嘉義,2024-03-27,9692
5324,士開,53,0,53,富邦-嘉義,2024-03-27,9692
3231,緯創,85,33,52,富邦-嘉義,2024-03-27,9692
2610,華航,61,10,51,富邦-嘉義,2024-03-27,9692
00632R,元大台灣50反1,64,15,49,富邦-嘉義,2024-03-27,9692
1612,宏泰,77,28,49,富邦-嘉義,2024-03-27,9692
8064,東捷,64,15,49,富邦-嘉義,2024-03-27,9692
4510,高鋒,51,5,46,富邦-嘉義,2024-03-27,9692
8936,國統,48,6,42,富邦-嘉義,2024-03-27,9692
6605,帝寶,56,14,42,富邦-嘉義,2024-03-27,9692
2637,慧洋-KY,43,2,41,富邦-嘉義,2024-03-27,9692
00909,國泰數位支付服務,40,0,40,富邦-嘉義,2024-03-27,9692
2328,廣宇,58,23,35,富邦-嘉義,2024-03-27,9692
5483,中美晶,175,141,34,富邦-嘉義,2024-03-27,9692
8110,華東,34,1,33,富邦-嘉義,2024-03-27,9692
4148,全宇生技-KY,42,9,33,富邦-嘉義,2024-03-27,9692
2337,旺宏,32,0,32,富邦-嘉義,2024-03-27,9692
2603,長榮,550,518,32,富邦-嘉義,2024-03-27,9692
2301,光寶科,46,15,31,富邦-嘉義,2024-03-27,9692
2312,金寶,30,0,30,富邦-嘉義,2024-03-27,9692
4420,光明,30,0,30,富邦-嘉義,2024-03-27,9692
8467,波力-KY,30,1,29,富邦-嘉義,2024-03-27,9692
2881,富邦金,39,10,29,富邦-嘉義,2024-03-27,9692
2882,國泰金,41,12,29,富邦-嘉義,2024-03-27,9692
2913,農林,220,192,28,富邦-嘉義,2024-03-27,9692
6505,台塑化,27,0,27,富邦-嘉義,2024-03-27,9692
00939,統一台灣高息動能,345,49,296,富邦-嘉義,2024-03-28,9692
00937B,群益ESG投等債20,349,64,285,富邦-嘉義,2024-03-28,9692
3013,晟銘電,622,405,217,富邦-嘉義,2024-03-28,9692
2382,廣達,1202,1004,198,富邦-嘉義,2024-03-28,9692
3294,英濟,238,58,180,富邦-嘉義,2024-03-28,9692
2344,華邦電,176,13,163,富邦-嘉義,2024-03-28,9692
1609,大亞,288,129,159,富邦-嘉義,2024-03-28,9692
8033,雷虎,214,94,120,富邦-嘉義,2024-03-28,9692
2634,漢翔,201,82,119,富邦-嘉義,2024-03-28,9692
2328,廣宇,2499,2385,114,富邦-嘉義,2024-03-28,9692
3710,連展投控,112,2,110,富邦-嘉義,2024-03-28,9692
8147,正淩,180,72,108,富邦-嘉義,2024-03-28,9692
3025,星通,139,34,105,富邦-嘉義,2024-03-28,9692
3664,安瑞-KY,92,0,92,富邦-嘉義,2024-03-28,9692
4714,永捷,438,355,83,富邦-嘉義,2024-03-28,9692
00720B,元大投資級公司債,91,9,82,富邦-嘉義,2024-03-28,9692
1591,駿吉-KY,75,0,75,富邦-嘉義,2024-03-28,9692
2883,凱基金,271,200,71,富邦-嘉義,2024-03-28,9692
3706,神達,176,112,64,富邦-嘉義,2024-03-28,9692
6189,豐藝,101,38,63,富邦-嘉義,2024-03-28,9692
1612,宏泰,62,8,54,富邦-嘉義,2024-03-28,9692
7402,邑錡,68,25,43,富邦-嘉義,2024-03-28,9692
2371,大同,838,798,40,富邦-嘉義,2024-03-28,9692
3052,夆典,40,0,40,富邦-嘉義,2024-03-28,9692
2323,中環,39,0,39,富邦-嘉義,2024-03-28,9692
2301,光寶科,72,33,39,富邦-嘉義,2024-03-28,9692
2801,彰銀,37,0,37,富邦-嘉義,2024-03-28,9692
00679B,元大美債20年,64,28,36,富邦-嘉義,2024-03-28,9692
3563,牧德,80,44,36,富邦-嘉義,2024-03-28,9692
6770,力積電,60,28,32,富邦-嘉義,2024-03-28,9692
1808,潤隆,41,10,31,富邦-嘉義,2024-03-28,9692
1617,榮星,38,10,28,富邦-嘉義,2024-03-28,9692
2103,台橡,28,0,28,富邦-嘉義,2024-03-28,9692
1616,億泰,55,28,27,富邦-嘉義,2024-03-28,9692
4938,和碩,46,20,26,富邦-嘉義,2024-03-28,9692
00753L,中信中國50正2,25,0,25,富邦-嘉義,2024-03-28,9692
2889,國票金,30,6,24,富邦-嘉義,2024-03-28,9692
2002,中鋼,26,3,23,富邦-嘉義,2024-03-28,9692
2618,長榮航,39,17,22,富邦-嘉義,2024-03-28,9692
2337,旺宏,24,3,21,富邦-嘉義,2024-03-28,9692
1789,神隆,68,48,20,富邦-嘉義,2024-03-28,9692
1319,東陽,33,13,20,富邦-嘉義,2024-03-28,9692
00882,中信中國高股息,32,12,20,富邦-嘉義,2024-03-28,9692
5498,凱崴,20,0,20,富邦-嘉義,2024-03-28,9692
5521,工信,22,2,20,富邦-嘉義,2024-03-28,9692
2609,陽明,32,12,20,富邦-嘉義,2024-03-28,9692
2834,臺企銀,40,20,20,富邦-嘉義,2024-03-28,9692
2615,萬海,19,0,19,富邦-嘉義,2024-03-28,9692
00687B,國泰20年美債,60,42,18,富邦-嘉義,2024-03-28,9692
8085,福華,91,73,18,富邦-嘉義,2024-03-28,9692
2371,大同,569,139,430,富邦-嘉義,2024-03-29,9692
2313,華通,417,121,296,富邦-嘉義,2024-03-29,9692
4303,信立,202,63,139,富邦-嘉義,2024-03-29,9692
2324,仁寶,135,13,122,富邦-嘉義,2024-03-29,9692
4938,和碩,230,121,109,富邦-嘉義,2024-03-29,9692
00941,中信上游半導體,116,8,108,富邦-嘉義,2024-03-29,9692
3548,兆利,190,87,103,富邦-嘉義,2024-03-29,9692
2421,建準,369,277,92,富邦-嘉義,2024-03-29,9692
3234,光環,100,12,88,富邦-嘉義,2024-03-29,9692
1591,駿吉-KY,75,2,73,富邦-嘉義,2024-03-29,9692
2637,慧洋-KY,72,0,72,富邦-嘉義,2024-03-29,9692
00673R,期元大S＆P原油反1,103,40,63,富邦-嘉義,2024-03-29,9692
6443,元晶,84,23,61,富邦-嘉義,2024-03-29,9692
1616,億泰,67,11,56,富邦-嘉義,2024-03-29,9692
6187,萬潤,63,10,53,富邦-嘉義,2024-03-29,9692
3294,英濟,465,412,53,富邦-嘉義,2024-03-29,9692
00720B,元大投資級公司債,60,8,52,富邦-嘉義,2024-03-29,9692
4909,新復興,79,29,50,富邦-嘉義,2024-03-29,9692
4147,中裕,52,2,50,富邦-嘉義,2024-03-29,9692
2009,第一銅,74,25,49,富邦-嘉義,2024-03-29,9692
2301,光寶科,96,50,46,富邦-嘉義,2024-03-29,9692
3289,宜特,45,1,44,富邦-嘉義,2024-03-29,9692
2392,正崴,56,14,42,富邦-嘉義,2024-03-29,9692
8255,朋程,48,7,41,富邦-嘉義,2024-03-29,9692
1612,宏泰,41,4,37,富邦-嘉義,2024-03-29,9692
1582,信錦,80,45,35,富邦-嘉義,2024-03-29,9692
2405,輔信,45,10,35,富邦-嘉義,2024-03-29,9692
3481,群創,46,12,34,富邦-嘉義,2024-03-29,9692
2464,盟立,37,5,32,富邦-嘉義,2024-03-29,9692
2485,兆赫,32,0,32,富邦-嘉義,2024-03-29,9692
2359,所羅門,49,17,32,富邦-嘉義,2024-03-29,9692
6414,樺漢,150,119,31,富邦-嘉義,2024-03-29,9692
2323,中環,32,1,31,富邦-嘉義,2024-03-29,9692
2316,楠梓電,35,4,31,富邦-嘉義,2024-03-29,9692
1324,地球,30,0,30,富邦-嘉義,2024-03-29,9692
00696B,富邦美債20年,30,0,30,富邦-嘉義,2024-03-29,9692
2409,友達,50,22,28,富邦-嘉義,2024-03-29,9692
2002,中鋼,25,0,25,富邦-嘉義,2024-03-29,9692
3551,世禾,30,5,25,富邦-嘉義,2024-03-29,9692
2537,聯上發,41,17,24,富邦-嘉義,2024-03-29,9692
6191,精成科,37,14,23,富邦-嘉義,2024-03-29,9692
5210,寶碩,22,0,22,富邦-嘉義,2024-03-29,9692
4979,華星光,55,33,22,富邦-嘉義,2024-03-29,9692
5201,凱衛,22,0,22,富邦-嘉義,2024-03-29,9692
00688L,國泰20年美債正2,21,0,21,富邦-嘉義,2024-03-29,9692
1722,台肥,21,0,21,富邦-嘉義,2024-03-29,9692
00919,群益台灣精選高息,147,126,21,富邦-嘉義,2024-03-29,9692
00706L,期元大S＆P日圓正2,20,0,20,富邦-嘉義,2024-03-29,9692
5498,凱崴,20,0,20,富邦-嘉義,2024-03-29,9692
3666,光耀,20,0,20,富邦-嘉義,2024-03-29,9692
00940,元大台灣價值高息,2578,796,1782,富邦-嘉義,2024-04-01,9692
00632R,元大台灣50反1,535,108,427,富邦-嘉義,2024-04-01,9692
00937B,群益ESG投等債20,303,28,275,富邦-嘉義,2024-04-01,9692
4909,新復興,447,185,262,富邦-嘉義,2024-04-01,9692
00753L,中信中國50正2,201,20,181,富邦-嘉義,2024-04-01,9692
5443,均豪,457,281,176,富邦-嘉義,2024-04-01,9692
3363,上詮,172,1,171,富邦-嘉義,2024-04-01,9692
3535,晶彩科,157,0,157,富邦-嘉義,2024-04-01,9692
00919,群益台灣精選高息,267,111,156,富邦-嘉義,2024-04-01,9692
6667,信紘科,422,279,143,富邦-嘉義,2024-04-01,9692
2492,華新科,171,28,143,富邦-嘉義,2024-04-01,9692
6189,豐藝,807,675,132,富邦-嘉義,2024-04-01,9692
6197,佳必琪,231,106,125,富邦-嘉義,2024-04-01,9692
00936,台新永續高息中小,113,0,113,富邦-嘉義,2024-04-01,9692
3231,緯創,2564,2459,105,富邦-嘉義,2024-04-01,9692
6438,迅得,102,2,100,富邦-嘉義,2024-04-01,9692
8932,智通*,100,0,100,富邦-嘉義,2024-04-01,9692
8033,雷虎,190,92,98,富邦-嘉義,2024-04-01,9692
00687B,國泰20年美債,98,2,96,富邦-嘉義,2024-04-01,9692
1522,堤維西,164,75,89,富邦-嘉義,2024-04-01,9692
5386,青雲,206,119,87,富邦-嘉義,2024-04-01,9692
3707,漢磊,208,128,80,富邦-嘉義,2024-04-01,9692
3059,華晶科,143,72,71,富邦-嘉義,2024-04-01,9692
2891,中信金,72,8,64,富邦-嘉義,2024-04-01,9692
2303,聯電,72,14,58,富邦-嘉義,2024-04-01,9692
8040,九暘,81,28,53,富邦-嘉義,2024-04-01,9692
8096,擎亞,619,569,50,富邦-嘉義,2024-04-01,9692
00939,統一台灣高息動能,106,57,49,富邦-嘉義,2024-04-01,9692
00720B,元大投資級公司債,52,4,48,富邦-嘉義,2024-04-01,9692
0056,元大高股息,53,6,47,富邦-嘉義,2024-04-01,9692
1326,台化,52,7,45,富邦-嘉義,2024-04-01,9692
3711,日月光投控,82,38,44,富邦-嘉義,2024-04-01,9692
5324,士開,43,0,43,富邦-嘉義,2024-04-01,9692
2359,所羅門,75,36,39,富邦-嘉義,2024-04-01,9692
2834,臺企銀,70,34,36,富邦-嘉義,2024-04-01,9692
1725,元禎,37,1,36,富邦-嘉義,2024-04-01,9692
2855,統一證,35,1,34,富邦-嘉義,2024-04-01,9692
1504,東元,49,18,31,富邦-嘉義,2024-04-01,9692
2836,高雄銀,31,0,31,富邦-嘉義,2024-04-01,9692
3188,鑫龍騰,30,0,30,富邦-嘉義,2024-04-01,9692
2328,廣宇,35,6,29,富邦-嘉義,2024-04-01,9692
1609,大亞,49,20,29,富邦-嘉義,2024-04-01,9692
2301,光寶科,52,23,29,富邦-嘉義,2024-04-01,9692
5439,高技,30,2,28,富邦-嘉義,2024-04-01,9692
5225,東科-KY,54,27,27,富邦-嘉義,2024-04-01,9692
3481,群創,28,2,26,富邦-嘉義,2024-04-01,9692
1560,中砂,95,70,25,富邦-嘉義,2024-04-01,9692
2887,台新金,23,0,23,富邦-嘉義,2024-04-01,9692
00712,復華富時不動產,26,4,22,富邦-嘉義,2024-04-01,9692
00680L,元大美債20正2,23,2,21,富邦-嘉義,2024-04-01,9692
5443,均豪,1299,445,854,富邦-嘉義,2024-04-02,9692
00940,元大台灣價值高息,944,236,708,富邦-嘉義,2024-04-02,9692
00929,復華台灣科技優息,763,81,682,富邦-嘉義,2024-04-02,9692
2374,佳能,837,184,653,富邦-嘉義,2024-04-02,9692
2486,一詮,981,444,537,富邦-嘉義,2024-04-02,9692
3231,緯創,1752,1295,457,富邦-嘉義,2024-04-02,9692
00937B,群益ESG投等債20,478,74,404,富邦-嘉義,2024-04-02,9692
2367,燿華,305,45,260,富邦-嘉義,2024-04-02,9692
00632R,元大台灣50反1,315,80,235,富邦-嘉義,2024-04-02,9692
8054,安國,322,113,209,富邦-嘉義,2024-04-02,9692
00673R,期元大S＆P原油反1,207,0,207,富邦-嘉義,2024-04-02,9692
2354,鴻準,268,75,193,富邦-嘉義,2024-04-02,9692
2382,廣達,651,466,185,富邦-嘉義,2024-04-02,9692
00665L,富邦�琤肭磪囓�2,282,110,172,富邦-嘉義,2024-04-02,9692
2344,華邦電,193,29,164,富邦-嘉義,2024-04-02,9692
00720B,元大投資級公司債,162,0,162,富邦-嘉義,2024-04-02,9692
00927,群益半導體收益,130,0,130,富邦-嘉義,2024-04-02,9692
00941,中信上游半導體,134,7,127,富邦-嘉義,2024-04-02,9692
3583,辛耘,243,122,121,富邦-嘉義,2024-04-02,9692
00679B,元大美債20年,113,5,108,富邦-嘉義,2024-04-02,9692
3706,神達,124,17,107,富邦-嘉義,2024-04-02,9692
00687B,國泰20年美債,155,51,104,富邦-嘉義,2024-04-02,9692
6207,雷科,184,87,97,富邦-嘉義,2024-04-02,9692
2618,長榮航,108,15,93,富邦-嘉義,2024-04-02,9692
3010,華立,260,185,75,富邦-嘉義,2024-04-02,9692
00878,國泰永續高股息,107,34,73,富邦-嘉義,2024-04-02,9692
8112,至上,107,35,72,富邦-嘉義,2024-04-02,9692
3059,華晶科,189,123,66,富邦-嘉義,2024-04-02,9692
6442,光聖,74,12,62,富邦-嘉義,2024-04-02,9692
2888,新光金,113,54,59,富邦-嘉義,2024-04-02,9692
2371,大同,152,95,57,富邦-嘉義,2024-04-02,9692
6227,茂綸,56,3,53,富邦-嘉義,2024-04-02,9692
2356,英業達,128,76,52,富邦-嘉義,2024-04-02,9692
911608,明輝-DR,50,0,50,富邦-嘉義,2024-04-02,9692
8096,擎亞,99,55,44,富邦-嘉義,2024-04-02,9692
2603,長榮,78,36,42,富邦-嘉義,2024-04-02,9692
6139,亞翔,299,257,42,富邦-嘉義,2024-04-02,9692
0056,元大高股息,44,3,41,富邦-嘉義,2024-04-02,9692
1504,東元,53,13,40,富邦-嘉義,2024-04-02,9692
00933B,國泰10Y+金融債,75,36,39,富邦-嘉義,2024-04-02,9692
6005,群益證,39,0,39,富邦-嘉義,2024-04-02,9692
5234,達興材料,95,58,37,富邦-嘉義,2024-04-02,9692
6438,迅得,232,197,35,富邦-嘉義,2024-04-02,9692
00713,元大台灣高息低波,32,0,32,富邦-嘉義,2024-04-02,9692
00650L,復華香港正2,31,0,31,富邦-嘉義,2024-04-02,9692
4958,臻鼎-KY,886,856,30,富邦-嘉義,2024-04-02,9692
1815,富喬,86,56,30,富邦-嘉義,2024-04-02,9692
2330,台積電,86,56,30,富邦-嘉義,2024-04-02,9692
6213,聯茂,476,446,30,富邦-嘉義,2024-04-02,9692
1304,台聚,30,1,29,富邦-嘉義,2024-04-02,9692
00929,復華台灣科技優息,823,43,780,富邦-嘉義,2024-04-03,9692
00937B,群益ESG投等債20,338,46,292,富邦-嘉義,2024-04-03,9692
2382,廣達,545,327,218,富邦-嘉義,2024-04-03,9692
6117,迎廣,315,102,213,富邦-嘉義,2024-04-03,9692
00687B,國泰20年美債,200,0,200,富邦-嘉義,2024-04-03,9692
00720B,元大投資級公司債,186,0,186,富邦-嘉義,2024-04-03,9692
2374,佳能,593,424,169,富邦-嘉義,2024-04-03,9692
2303,聯電,152,8,144,富邦-嘉義,2024-04-03,9692
00673R,期元大S＆P原油反1,126,0,126,富邦-嘉義,2024-04-03,9692
8096,擎亞,136,28,108,富邦-嘉義,2024-04-03,9692
2888,新光金,111,11,100,富邦-嘉義,2024-04-03,9692
2601,益航,98,0,98,富邦-嘉義,2024-04-03,9692
3481,群創,102,5,97,富邦-嘉義,2024-04-03,9692
6753,龍德造船,86,17,69,富邦-嘉義,2024-04-03,9692
00680L,元大美債20正2,118,55,63,富邦-嘉義,2024-04-03,9692
2025,千興,60,1,59,富邦-嘉義,2024-04-03,9692
1608,華榮,67,9,58,富邦-嘉義,2024-04-03,9692
00941,中信上游半導體,70,13,57,富邦-嘉義,2024-04-03,9692
2884,玉山金,67,11,56,富邦-嘉義,2024-04-03,9692
6227,茂綸,428,374,54,富邦-嘉義,2024-04-03,9692
00679B,元大美債20年,114,61,53,富邦-嘉義,2024-04-03,9692
2106,建大,50,0,50,富邦-嘉義,2024-04-03,9692
2010,春源,84,37,47,富邦-嘉義,2024-04-03,9692
3015,全漢,65,22,43,富邦-嘉義,2024-04-03,9692
1815,富喬,56,14,42,富邦-嘉義,2024-04-03,9692
2409,友達,61,19,42,富邦-嘉義,2024-04-03,9692
2317,鴻海,138,96,42,富邦-嘉義,2024-04-03,9692
00650L,復華香港正2,42,1,41,富邦-嘉義,2024-04-03,9692
0056,元大高股息,61,20,41,富邦-嘉義,2024-04-03,9692
1108,幸福,40,0,40,富邦-嘉義,2024-04-03,9692
2618,長榮航,47,7,40,富邦-嘉義,2024-04-03,9692
2301,光寶科,52,15,37,富邦-嘉義,2024-04-03,9692
1524,耿鼎,73,41,32,富邦-嘉義,2024-04-03,9692
6667,信紘科,38,7,31,富邦-嘉義,2024-04-03,9692
00712,復華富時不動產,31,0,31,富邦-嘉義,2024-04-03,9692
3013,晟銘電,1164,1134,30,富邦-嘉義,2024-04-03,9692
8027,鈦昇,36,7,29,富邦-嘉義,2024-04-03,9692
6188,廣明,40,11,29,富邦-嘉義,2024-04-03,9692
00764B,群益25年美債,29,1,28,富邦-嘉義,2024-04-03,9692
2892,第一金,27,0,27,富邦-嘉義,2024-04-03,9692
6282,康舒,28,1,27,富邦-嘉義,2024-04-03,9692
6189,豐藝,37,11,26,富邦-嘉義,2024-04-03,9692
912000,晨訊科-DR,25,0,25,富邦-嘉義,2024-04-03,9692
2408,南亞科,32,7,25,富邦-嘉義,2024-04-03,9692
00919,群益台灣精選高息,57,32,25,富邦-嘉義,2024-04-03,9692
4908,前鼎,45,21,24,富邦-嘉義,2024-04-03,9692
2367,燿華,48,24,24,富邦-嘉義,2024-04-03,9692
6770,力積電,32,9,23,富邦-嘉義,2024-04-03,9692
2014,中鴻,182,159,23,富邦-嘉義,2024-04-03,9692
6015,宏遠證,23,0,23,富邦-嘉義,2024-04-03,9692
8096,擎亞,1832,1179,653,富邦-嘉義,2024-04-08,9692
6117,迎廣,1227,610,617,富邦-嘉義,2024-04-08,9692
00929,復華台灣科技優息,585,44,541,富邦-嘉義,2024-04-08,9692
2365,昆盈,1245,838,407,富邦-嘉義,2024-04-08,9692
00940,元大台灣價值高息,568,200,368,富邦-嘉義,2024-04-08,9692
2883,凱基金,244,24,220,富邦-嘉義,2024-04-08,9692
00937B,群益ESG投等債20,192,11,181,富邦-嘉義,2024-04-08,9692
2486,一詮,574,400,174,富邦-嘉義,2024-04-08,9692
00687B,國泰20年美債,167,11,156,富邦-嘉義,2024-04-08,9692
1608,華榮,218,70,148,富邦-嘉義,2024-04-08,9692
3013,晟銘電,240,107,133,富邦-嘉義,2024-04-08,9692
4533,協易機,716,601,115,富邦-嘉義,2024-04-08,9692
1616,億泰,134,26,108,富邦-嘉義,2024-04-08,9692
2317,鴻海,179,71,108,富邦-嘉義,2024-04-08,9692
6188,廣明,593,504,89,富邦-嘉義,2024-04-08,9692
6120,達運,120,31,89,富邦-嘉義,2024-04-08,9692
2356,英業達,104,18,86,富邦-嘉義,2024-04-08,9692
5443,均豪,279,201,78,富邦-嘉義,2024-04-08,9692
3231,緯創,2456,2387,69,富邦-嘉義,2024-04-08,9692
2537,聯上發,70,3,67,富邦-嘉義,2024-04-08,9692
3058,立德,73,13,60,富邦-嘉義,2024-04-08,9692
6187,萬潤,117,58,59,富邦-嘉義,2024-04-08,9692
00720B,元大投資級公司債,53,0,53,富邦-嘉義,2024-04-08,9692
2009,第一銅,1001,950,51,富邦-嘉義,2024-04-08,9692
2402,毅嘉,72,22,50,富邦-嘉義,2024-04-08,9692
8047,星雲,50,0,50,富邦-嘉義,2024-04-08,9692
3027,盛達,53,3,50,富邦-嘉義,2024-04-08,9692
4716,大立,64,14,50,富邦-嘉義,2024-04-08,9692
00673R,期元大S＆P原油反1,46,0,46,富邦-嘉義,2024-04-08,9692
3706,神達,59,14,45,富邦-嘉義,2024-04-08,9692
2349,錸德,52,8,44,富邦-嘉義,2024-04-08,9692
2534,宏盛,45,2,43,富邦-嘉義,2024-04-08,9692
2851,中再保,52,10,42,富邦-嘉義,2024-04-08,9692
2618,長榮航,81,42,39,富邦-嘉義,2024-04-08,9692
5324,士開,42,3,39,富邦-嘉義,2024-04-08,9692
4714,永捷,90,51,39,富邦-嘉義,2024-04-08,9692
2353,宏��,55,21,34,富邦-嘉義,2024-04-08,9692
00923,群益台ESG低碳50,36,3,33,富邦-嘉義,2024-04-08,9692
2324,仁寶,49,16,33,富邦-嘉義,2024-04-08,9692
2405,輔信,38,6,32,富邦-嘉義,2024-04-08,9692
2467,志聖,79,48,31,富邦-嘉義,2024-04-08,9692
2634,漢翔,55,25,30,富邦-嘉義,2024-04-08,9692
0056,元大高股息,43,15,28,富邦-嘉義,2024-04-08,9692
2371,大同,63,35,28,富邦-嘉義,2024-04-08,9692
3622,洋華,38,10,28,富邦-嘉義,2024-04-08,9692
8110,華東,33,5,28,富邦-嘉義,2024-04-08,9692
2888,新光金,26,0,26,富邦-嘉義,2024-04-08,9692
2449,京元電子,46,20,26,富邦-嘉義,2024-04-08,9692
1524,耿鼎,79,54,25,富邦-嘉義,2024-04-08,9692
00885,富邦越南,49,25,24,富邦-嘉義,2024-04-08,9692
2515,中工,1141,351,790,富邦-嘉義,2024-04-09,9692
2537,聯上發,898,238,660,富邦-嘉義,2024-04-09,9692
2009,第一銅,1485,827,658,富邦-嘉義,2024-04-09,9692
2363,矽統,1382,902,480,富邦-嘉義,2024-04-09,9692
4533,協易機,715,302,413,富邦-嘉義,2024-04-09,9692
2038,海光,473,163,310,富邦-嘉義,2024-04-09,9692
00937B,群益ESG投等債20,240,13,227,富邦-嘉義,2024-04-09,9692
3294,英濟,563,347,216,富邦-嘉義,2024-04-09,9692
3231,緯創,1867,1663,204,富邦-嘉義,2024-04-09,9692
6215,和椿,202,9,193,富邦-嘉義,2024-04-09,9692
1514,亞力,433,241,192,富邦-嘉義,2024-04-09,9692
2464,盟立,1948,1772,176,富邦-嘉義,2024-04-09,9692
00929,復華台灣科技優息,195,34,161,富邦-嘉義,2024-04-09,9692
00720B,元大投資級公司債,155,0,155,富邦-嘉義,2024-04-09,9692
2014,中鴻,589,436,153,富邦-嘉義,2024-04-09,9692
3466,德晉,158,30,128,富邦-嘉義,2024-04-09,9692
2025,千興,126,5,121,富邦-嘉義,2024-04-09,9692
2534,宏盛,142,25,117,富邦-嘉義,2024-04-09,9692
00637L,元大滬深300正2,105,0,105,富邦-嘉義,2024-04-09,9692
1316,上曜,109,8,101,富邦-嘉義,2024-04-09,9692
2371,大同,249,151,98,富邦-嘉義,2024-04-09,9692
1503,士電,202,112,90,富邦-嘉義,2024-04-09,9692
00940,元大台灣價值高息,176,102,74,富邦-嘉義,2024-04-09,9692
00878,國泰永續高股息,98,31,67,富邦-嘉義,2024-04-09,9692
2359,所羅門,133,70,63,富邦-嘉義,2024-04-09,9692
6753,龍德造船,197,137,60,富邦-嘉義,2024-04-09,9692
8096,擎亞,304,247,57,富邦-嘉義,2024-04-09,9692
1513,中興電,1023,970,53,富邦-嘉義,2024-04-09,9692
2354,鴻準,82,29,53,富邦-嘉義,2024-04-09,9692
3059,華晶科,62,10,52,富邦-嘉義,2024-04-09,9692
4526,東台,46,0,46,富邦-嘉義,2024-04-09,9692
00679B,元大美債20年,52,7,45,富邦-嘉義,2024-04-09,9692
00633L,富邦上証正2,45,1,44,富邦-嘉義,2024-04-09,9692
6207,雷科,543,500,43,富邦-嘉義,2024-04-09,9692
5521,工信,194,153,41,富邦-嘉義,2024-04-09,9692
00655L,國泰中國A50正2,40,0,40,富邦-嘉義,2024-04-09,9692
6425,易發,199,163,36,富邦-嘉義,2024-04-09,9692
8432,東生華,35,0,35,富邦-嘉義,2024-04-09,9692
2356,英業達,67,33,34,富邦-嘉義,2024-04-09,9692
1467,南緯,34,0,34,富邦-嘉義,2024-04-09,9692
00939,統一台灣高息動能,36,2,34,富邦-嘉義,2024-04-09,9692
1313,聯成,33,0,33,富邦-嘉義,2024-04-09,9692
3339,泰谷,86,53,33,富邦-嘉義,2024-04-09,9692
2393,億光,39,7,32,富邦-嘉義,2024-04-09,9692
2010,春源,51,20,31,富邦-嘉義,2024-04-09,9692
6244,茂迪,32,1,31,富邦-嘉義,2024-04-09,9692
00664R,國泰臺灣加權反1,30,0,30,富邦-嘉義,2024-04-09,9692
6208,日揚,30,2,28,富邦-嘉義,2024-04-09,9692
0056,元大高股息,38,12,26,富邦-嘉義,2024-04-09,9692
8112,至上,123,98,25,富邦-嘉義,2024-04-09,9692
00929,復華台灣科技優息,411,48,363,富邦-嘉義,2024-04-10,9692
2367,燿華,370,56,314,富邦-嘉義,2024-04-10,9692
1603,華電,245,43,202,富邦-嘉義,2024-04-10,9692
5443,均豪,240,49,191,富邦-嘉義,2024-04-10,9692
2630,亞航,200,14,186,富邦-嘉義,2024-04-10,9692
3013,晟銘電,734,550,184,富邦-嘉義,2024-04-10,9692
3363,上詮,657,488,169,富邦-嘉義,2024-04-10,9692
00937B,群益ESG投等債20,174,13,161,富邦-嘉義,2024-04-10,9692
3576,聯合再生,339,189,150,富邦-嘉義,2024-04-10,9692
6120,達運,166,17,149,富邦-嘉義,2024-04-10,9692
3260,威剛,782,649,133,富邦-嘉義,2024-04-10,9692
2888,新光金,257,144,113,富邦-嘉義,2024-04-10,9692
00720B,元大投資級公司債,115,12,103,富邦-嘉義,2024-04-10,9692
00673R,期元大S＆P原油反1,101,0,101,富邦-嘉義,2024-04-10,9692
2645,長榮航太,156,62,94,富邦-嘉義,2024-04-10,9692
2897A,王道銀甲特,87,0,87,富邦-嘉義,2024-04-10,9692
2883,凱基金,91,6,85,富邦-嘉義,2024-04-10,9692
5371,中光電,736,653,83,富邦-嘉義,2024-04-10,9692
1612,宏泰,92,9,83,富邦-嘉義,2024-04-10,9692
1609,大亞,443,366,77,富邦-嘉義,2024-04-10,9692
2359,所羅門,130,57,73,富邦-嘉義,2024-04-10,9692
00637L,元大滬深300正2,74,5,69,富邦-嘉義,2024-04-10,9692
00632R,元大台灣50反1,113,49,64,富邦-嘉義,2024-04-10,9692
2002,中鋼,116,54,62,富邦-嘉義,2024-04-10,9692
2317,鴻海,146,96,50,富邦-嘉義,2024-04-10,9692
2609,陽明,60,10,50,富邦-嘉義,2024-04-10,9692
00940,元大台灣價值高息,352,312,40,富邦-嘉義,2024-04-10,9692
6026,福邦證,58,19,39,富邦-嘉義,2024-04-10,9692
3481,群創,126,88,38,富邦-嘉義,2024-04-10,9692
1474,弘裕,37,0,37,富邦-嘉義,2024-04-10,9692
2374,佳能,91,56,35,富邦-嘉義,2024-04-10,9692
912000,晨訊科-DR,35,0,35,富邦-嘉義,2024-04-10,9692
00939,統一台灣高息動能,64,31,33,富邦-嘉義,2024-04-10,9692
6667,信紘科,35,3,32,富邦-嘉義,2024-04-10,9692
2736,富野,31,0,31,富邦-嘉義,2024-04-10,9692
1605,華新,55,25,30,富邦-嘉義,2024-04-10,9692
4729,熒茂,30,0,30,富邦-嘉義,2024-04-10,9692
6016,康和證,50,20,30,富邦-嘉義,2024-04-10,9692
00885,富邦越南,31,2,29,富邦-嘉義,2024-04-10,9692
3372,典範,46,18,28,富邦-嘉義,2024-04-10,9692
2465,麗臺,28,0,28,富邦-嘉義,2024-04-10,9692
3450,聯鈞,194,166,28,富邦-嘉義,2024-04-10,9692
2356,英業達,39,12,27,富邦-嘉義,2024-04-10,9692
5324,士開,64,37,27,富邦-嘉義,2024-04-10,9692
1587,吉茂,41,14,27,富邦-嘉義,2024-04-10,9692
5515,建國,28,2,26,富邦-嘉義,2024-04-10,9692
3715,定穎投控,30,7,23,富邦-嘉義,2024-04-10,9692
1618,合機,27,4,23,富邦-嘉義,2024-04-10,9692
2330,台積電,32,10,22,富邦-嘉義,2024-04-10,9692
2408,南亞科,62,40,22,富邦-嘉義,2024-04-10,9692
2363,矽統,2798,1930,868,富邦-嘉義,2024-04-11,9692
2353,宏��,1551,685,866,富邦-嘉義,2024-04-11,9692
2374,佳能,1451,848,603,富邦-嘉義,2024-04-11,9692
3312,弘憶股,1279,780,499,富邦-嘉義,2024-04-11,9692
2506,太設,689,228,461,富邦-嘉義,2024-04-11,9692
3481,群創,357,11,346,富邦-嘉義,2024-04-11,9692
00929,復華台灣科技優息,313,21,292,富邦-嘉義,2024-04-11,9692
00687B,國泰20年美債,236,11,225,富邦-嘉義,2024-04-11,9692
00937B,群益ESG投等債20,224,4,220,富邦-嘉義,2024-04-11,9692
2607,榮運,206,12,194,富邦-嘉義,2024-04-11,9692
00712,復華富時不動產,155,2,153,富邦-嘉義,2024-04-11,9692
6213,聯茂,146,3,143,富邦-嘉義,2024-04-11,9692
00940,元大台灣價值高息,299,161,138,富邦-嘉義,2024-04-11,9692
8112,至上,138,24,114,富邦-嘉義,2024-04-11,9692
2382,廣達,285,175,110,富邦-嘉義,2024-04-11,9692
00933B,國泰10Y+金融債,103,0,103,富邦-嘉義,2024-04-11,9692
1514,亞力,1592,1493,99,富邦-嘉義,2024-04-11,9692
8011,台通,288,198,90,富邦-嘉義,2024-04-11,9692
2313,華通,98,10,88,富邦-嘉義,2024-04-11,9692
2409,友達,98,14,84,富邦-嘉義,2024-04-11,9692
3287,廣寰科,86,6,80,富邦-嘉義,2024-04-11,9692
00680L,元大美債20正2,101,22,79,富邦-嘉義,2024-04-11,9692
6207,雷科,225,149,76,富邦-嘉義,2024-04-11,9692
3516,亞帝歐,73,0,73,富邦-嘉義,2024-04-11,9692
3666,光耀,79,6,73,富邦-嘉義,2024-04-11,9692
2464,盟立,84,19,65,富邦-嘉義,2024-04-11,9692
2010,春源,66,3,63,富邦-嘉義,2024-04-11,9692
9945,潤泰新,61,0,61,富邦-嘉義,2024-04-11,9692
2329,華泰,161,102,59,富邦-嘉義,2024-04-11,9692
00679B,元大美債20年,158,100,58,富邦-嘉義,2024-04-11,9692
00720B,元大投資級公司債,69,13,56,富邦-嘉義,2024-04-11,9692
2303,聯電,100,44,56,富邦-嘉義,2024-04-11,9692
1104,環泥,55,0,55,富邦-嘉義,2024-04-11,9692
0056,元大高股息,60,7,53,富邦-嘉義,2024-04-11,9692
3686,達能,66,15,51,富邦-嘉義,2024-04-11,9692
3402,漢科,71,20,51,富邦-嘉義,2024-04-11,9692
00650L,復華香港正2,52,3,49,富邦-嘉義,2024-04-11,9692
2354,鴻準,80,32,48,富邦-嘉義,2024-04-11,9692
1612,宏泰,69,22,47,富邦-嘉義,2024-04-11,9692
4532,瑞智,43,0,43,富邦-嘉義,2024-04-11,9692
00931B,統一美債20年,48,5,43,富邦-嘉義,2024-04-11,9692
8096,擎亞,182,142,40,富邦-嘉義,2024-04-11,9692
00941,中信上游半導體,45,5,40,富邦-嘉義,2024-04-11,9692
6290,良維,105,67,38,富邦-嘉義,2024-04-11,9692
2509,全坤建,63,25,38,富邦-嘉義,2024-04-11,9692
1909,榮成,40,2,38,富邦-嘉義,2024-04-11,9692
6139,亞翔,103,66,37,富邦-嘉義,2024-04-11,9692
2534,宏盛,35,0,35,富邦-嘉義,2024-04-11,9692
2317,鴻海,3701,3667,34,富邦-嘉義,2024-04-11,9692
00751B,元大AAA至A公司債,35,2,33,富邦-嘉義,2024-04-11,9692
1608,華榮,1188,381,807,富邦-嘉義,2024-04-12,9692
1618,合機,1359,671,688,富邦-嘉義,2024-04-12,9692
1609,大亞,1634,1310,324,富邦-嘉義,2024-04-12,9692
00929,復華台灣科技優息,287,74,213,富邦-嘉義,2024-04-12,9692
2883,凱基金,192,10,182,富邦-嘉義,2024-04-12,9692
2618,長榮航,191,11,180,富邦-嘉義,2024-04-12,9692
3312,弘憶股,1973,1800,173,富邦-嘉義,2024-04-12,9692
00937B,群益ESG投等債20,203,35,168,富邦-嘉義,2024-04-12,9692
00720B,元大投資級公司債,155,0,155,富邦-嘉義,2024-04-12,9692
2101,南港,304,169,135,富邦-嘉義,2024-04-12,9692
2405,輔信,135,13,122,富邦-嘉義,2024-04-12,9692
00940,元大台灣價值高息,291,175,116,富邦-嘉義,2024-04-12,9692
4533,協易機,1352,1245,107,富邦-嘉義,2024-04-12,9692
2867,三商壽,140,37,103,富邦-嘉義,2024-04-12,9692
5864,致和證,103,1,102,富邦-嘉義,2024-04-12,9692
2607,榮運,100,0,100,富邦-嘉義,2024-04-12,9692
2630,亞航,97,7,90,富邦-嘉義,2024-04-12,9692
1616,億泰,137,48,89,富邦-嘉義,2024-04-12,9692
00933B,國泰10Y+金融債,81,0,81,富邦-嘉義,2024-04-12,9692
3059,華晶科,92,16,76,富邦-嘉義,2024-04-12,9692
00679B,元大美債20年,76,1,75,富邦-嘉義,2024-04-12,9692
2888,新光金,191,117,74,富邦-嘉義,2024-04-12,9692
00687B,國泰20年美債,178,106,72,富邦-嘉義,2024-04-12,9692
2371,大同,2387,2315,72,富邦-嘉義,2024-04-12,9692
1453,大將,373,302,71,富邦-嘉義,2024-04-12,9692
2002,中鋼,64,1,63,富邦-嘉義,2024-04-12,9692
3402,漢科,137,75,62,富邦-嘉義,2024-04-12,9692
00680L,元大美債20正2,94,33,61,富邦-嘉義,2024-04-12,9692
2344,華邦電,68,13,55,富邦-嘉義,2024-04-12,9692
6223,旺矽,95,40,55,富邦-嘉義,2024-04-12,9692
3711,日月光投控,58,4,54,富邦-嘉義,2024-04-12,9692
1503,士電,161,110,51,富邦-嘉義,2024-04-12,9692
2349,錸德,50,0,50,富邦-嘉義,2024-04-12,9692
4402,郡都開發,59,9,50,富邦-嘉義,2024-04-12,9692
5234,達興材料,71,22,49,富邦-嘉義,2024-04-12,9692
2543,皇昌,115,66,49,富邦-嘉義,2024-04-12,9692
6290,良維,146,100,46,富邦-嘉義,2024-04-12,9692
3706,神達,63,21,42,富邦-嘉義,2024-04-12,9692
2834,臺企銀,45,6,39,富邦-嘉義,2024-04-12,9692
00878,國泰永續高股息,50,11,39,富邦-嘉義,2024-04-12,9692
2352,佳世達,39,1,38,富邦-嘉義,2024-04-12,9692
2812,台中銀,42,5,37,富邦-嘉義,2024-04-12,9692
00857B,永豐20年美公債,42,5,37,富邦-嘉義,2024-04-12,9692
3715,定穎投控,41,6,35,富邦-嘉義,2024-04-12,9692
1587,吉茂,228,193,35,富邦-嘉義,2024-04-12,9692
2316,楠梓電,44,9,35,富邦-嘉義,2024-04-12,9692
6197,佳必琪,122,88,34,富邦-嘉義,2024-04-12,9692
00712,復華富時不動產,36,2,34,富邦-嘉義,2024-04-12,9692
0056,元大高股息,36,2,34,富邦-嘉義,2024-04-12,9692
00919,群益台灣精選高息,51,18,33,富邦-嘉義,2024-04-12,9692
2367,燿華,2248,286,1962,富邦-嘉義,2024-04-15,9692
00929,復華台灣科技優息,588,36,552,富邦-嘉義,2024-04-15,9692
00632R,元大台灣50反1,502,34,468,富邦-嘉義,2024-04-15,9692
2371,大同,2306,2090,216,富邦-嘉義,2024-04-15,9692
00940,元大台灣價值高息,265,51,214,富邦-嘉義,2024-04-15,9692
2317,鴻海,1728,1578,150,富邦-嘉義,2024-04-15,9692
1609,大亞,4199,4064,135,富邦-嘉義,2024-04-15,9692
1504,東元,197,81,116,富邦-嘉義,2024-04-15,9692
2009,第一銅,786,678,108,富邦-嘉義,2024-04-15,9692
00772B,中信高評級公司債,108,1,107,富邦-嘉義,2024-04-15,9692
00720B,元大投資級公司債,98,1,97,富邦-嘉義,2024-04-15,9692
5371,中光電,510,415,95,富邦-嘉義,2024-04-15,9692
2316,楠梓電,95,0,95,富邦-嘉義,2024-04-15,9692
2630,亞航,779,685,94,富邦-嘉義,2024-04-15,9692
4127,天良,128,34,94,富邦-嘉義,2024-04-15,9692
3666,光耀,182,98,84,富邦-嘉義,2024-04-15,9692
00939,統一台灣高息動能,108,26,82,富邦-嘉義,2024-04-15,9692
2313,華通,117,40,77,富邦-嘉義,2024-04-15,9692
00909,國泰數位支付服務,76,0,76,富邦-嘉義,2024-04-15,9692
2103,台橡,76,2,74,富邦-嘉義,2024-04-15,9692
4960,誠美材,162,95,67,富邦-嘉義,2024-04-15,9692
2888,新光金,153,91,62,富邦-嘉義,2024-04-15,9692
2605,新興,74,14,60,富邦-嘉義,2024-04-15,9692
4716,大立,117,57,60,富邦-嘉義,2024-04-15,9692
1514,亞力,1586,1527,59,富邦-嘉義,2024-04-15,9692
3013,晟銘電,71,12,59,富邦-嘉義,2024-04-15,9692
00919,群益台灣精選高息,81,22,59,富邦-嘉義,2024-04-15,9692
4541,晟田,64,6,58,富邦-嘉義,2024-04-15,9692
3037,欣興,58,4,54,富邦-嘉義,2024-04-15,9692
3481,群創,62,12,50,富邦-嘉義,2024-04-15,9692
2344,華邦電,56,6,50,富邦-嘉義,2024-04-15,9692
5498,凱崴,51,1,50,富邦-嘉義,2024-04-15,9692
2329,華泰,66,17,49,富邦-嘉義,2024-04-15,9692
2303,聯電,58,11,47,富邦-嘉義,2024-04-15,9692
2618,長榮航,47,3,44,富邦-嘉義,2024-04-15,9692
1612,宏泰,266,224,42,富邦-嘉義,2024-04-15,9692
2641,正德,54,13,41,富邦-嘉義,2024-04-15,9692
1108,幸福,42,1,41,富邦-嘉義,2024-04-15,9692
2449,京元電子,48,7,41,富邦-嘉義,2024-04-15,9692
2356,英業達,98,59,39,富邦-嘉義,2024-04-15,9692
00941,中信上游半導體,42,6,36,富邦-嘉義,2024-04-15,9692
1815,富喬,50,18,32,富邦-嘉義,2024-04-15,9692
6239,力成,34,3,31,富邦-嘉義,2024-04-15,9692
1617,榮星,63,32,31,富邦-嘉義,2024-04-15,9692
2349,錸德,30,0,30,富邦-嘉義,2024-04-15,9692
1316,上曜,36,7,29,富邦-嘉義,2024-04-15,9692
6438,迅得,32,3,29,富邦-嘉義,2024-04-15,9692
4714,永捷,35,7,28,富邦-嘉義,2024-04-15,9692
8440,綠電,37,9,28,富邦-嘉義,2024-04-15,9692
3231,緯創,104,78,26,富邦-嘉義,2024-04-15,9692
00940,元大台灣價值高息,1216,249,967,富邦-嘉義,2024-04-16,9692
00929,復華台灣科技優息,887,264,623,富邦-嘉義,2024-04-16,9692
00937B,群益ESG投等債20,676,139,537,富邦-嘉義,2024-04-16,9692
3706,神達,561,35,526,富邦-嘉義,2024-04-16,9692
1810,和成,814,452,362,富邦-嘉義,2024-04-16,9692
9955,佳龍,474,177,297,富邦-嘉義,2024-04-16,9692
0056,元大高股息,304,23,281,富邦-嘉義,2024-04-16,9692
00939,統一台灣高息動能,330,79,251,富邦-嘉義,2024-04-16,9692
2845,遠東銀,218,0,218,富邦-嘉義,2024-04-16,9692
2374,佳能,370,170,200,富邦-嘉義,2024-04-16,9692
2888,新光金,298,122,176,富邦-嘉義,2024-04-16,9692
2014,中鴻,162,7,155,富邦-嘉義,2024-04-16,9692
1101,台泥,154,18,136,富邦-嘉義,2024-04-16,9692
2303,聯電,163,30,133,富邦-嘉義,2024-04-16,9692
00878,國泰永續高股息,259,130,129,富邦-嘉義,2024-04-16,9692
4960,誠美材,144,18,126,富邦-嘉義,2024-04-16,9692
2344,華邦電,128,5,123,富邦-嘉義,2024-04-16,9692
00919,群益台灣精選高息,499,379,120,富邦-嘉義,2024-04-16,9692
2367,燿華,379,262,117,富邦-嘉義,2024-04-16,9692
2884,玉山金,129,23,106,富邦-嘉義,2024-04-16,9692
2618,長榮航,137,34,103,富邦-嘉義,2024-04-16,9692
3481,群創,164,71,93,富邦-嘉義,2024-04-16,9692
00712,復華富時不動產,99,17,82,富邦-嘉義,2024-04-16,9692
3059,華晶科,81,1,80,富邦-嘉義,2024-04-16,9692
00720B,元大投資級公司債,82,9,73,富邦-嘉義,2024-04-16,9692
00664R,國泰臺灣加權反1,72,0,72,富邦-嘉義,2024-04-16,9692
2892,第一金,89,18,71,富邦-嘉義,2024-04-16,9692
2405,輔信,77,6,71,富邦-嘉義,2024-04-16,9692
2356,英業達,100,33,67,富邦-嘉義,2024-04-16,9692
2025,千興,85,20,65,富邦-嘉義,2024-04-16,9692
6283,淳安,72,8,64,富邦-嘉義,2024-04-16,9692
00679B,元大美債20年,79,16,63,富邦-嘉義,2024-04-16,9692
2897A,王道銀甲特,60,0,60,富邦-嘉義,2024-04-16,9692
1314,中石化,66,10,56,富邦-嘉義,2024-04-16,9692
2887,台新金,90,35,55,富邦-嘉義,2024-04-16,9692
6015,宏遠證,58,5,53,富邦-嘉義,2024-04-16,9692
3006,晶豪科,60,7,53,富邦-嘉義,2024-04-16,9692
2538,基泰,52,0,52,富邦-嘉義,2024-04-16,9692
2317,鴻海,3711,3660,51,富邦-嘉義,2024-04-16,9692
2801,彰銀,54,3,51,富邦-嘉義,2024-04-16,9692
4906,正文,51,3,48,富邦-嘉義,2024-04-16,9692
2323,中環,52,12,40,富邦-嘉義,2024-04-16,9692
8064,東捷,43,3,40,富邦-嘉義,2024-04-16,9692
9902,台火,40,0,40,富邦-嘉義,2024-04-16,9692
1104,環泥,47,8,39,富邦-嘉義,2024-04-16,9692
2353,宏��,171,132,39,富邦-嘉義,2024-04-16,9692
2881,富邦金,44,7,37,富邦-嘉義,2024-04-16,9692
00715L,期街口布蘭特正2,43,7,36,富邦-嘉義,2024-04-16,9692
2630,亞航,531,497,34,富邦-嘉義,2024-04-16,9692
2002,中鋼,41,8,33,富邦-嘉義,2024-04-16,9692
1608,華榮,1193,387,806,富邦-嘉義,2024-04-17,9692
2371,大同,1789,1010,779,富邦-嘉義,2024-04-17,9692
1618,合機,802,176,626,富邦-嘉義,2024-04-17,9692
00632R,元大台灣50反1,631,57,574,富邦-嘉義,2024-04-17,9692
2329,華泰,679,370,309,富邦-嘉義,2024-04-17,9692
00929,復華台灣科技優息,312,39,273,富邦-嘉義,2024-04-17,9692
0056,元大高股息,264,15,249,富邦-嘉義,2024-04-17,9692
00937B,群益ESG投等債20,597,355,242,富邦-嘉義,2024-04-17,9692
1612,宏泰,367,139,228,富邦-嘉義,2024-04-17,9692
2374,佳能,639,415,224,富邦-嘉義,2024-04-17,9692
3707,漢磊,210,5,205,富邦-嘉義,2024-04-17,9692
00919,群益台灣精選高息,212,20,192,富邦-嘉義,2024-04-17,9692
2363,矽統,874,696,178,富邦-嘉義,2024-04-17,9692
1503,士電,689,517,172,富邦-嘉義,2024-04-17,9692
2880,華南金,146,1,145,富邦-嘉義,2024-04-17,9692
2465,麗臺,145,6,139,富邦-嘉義,2024-04-17,9692
00720B,元大投資級公司債,140,30,110,富邦-嘉義,2024-04-17,9692
3666,光耀,104,8,96,富邦-嘉義,2024-04-17,9692
5515,建國,234,149,85,富邦-嘉義,2024-04-17,9692
00679B,元大美債20年,84,3,81,富邦-嘉義,2024-04-17,9692
3231,緯創,614,541,73,富邦-嘉義,2024-04-17,9692
6016,康和證,73,0,73,富邦-嘉義,2024-04-17,9692
3339,泰谷,124,53,71,富邦-嘉義,2024-04-17,9692
00857B,永豐20年美公債,85,14,71,富邦-嘉義,2024-04-17,9692
00878,國泰永續高股息,104,35,69,富邦-嘉義,2024-04-17,9692
00687B,國泰20年美債,98,30,68,富邦-嘉義,2024-04-17,9692
00940,元大台灣價值高息,146,79,67,富邦-嘉義,2024-04-17,9692
2618,長榮航,69,4,65,富邦-嘉義,2024-04-17,9692
2330,台積電,83,22,61,富邦-嘉義,2024-04-17,9692
1603,華電,111,54,57,富邦-嘉義,2024-04-17,9692
3481,群創,58,2,56,富邦-嘉義,2024-04-17,9692
2313,華通,63,9,54,富邦-嘉義,2024-04-17,9692
2881,富邦金,53,1,52,富邦-嘉義,2024-04-17,9692
2303,聯電,54,2,52,富邦-嘉義,2024-04-17,9692
6283,淳安,53,4,49,富邦-嘉義,2024-04-17,9692
00941,中信上游半導體,62,14,48,富邦-嘉義,2024-04-17,9692
3036,文曄,53,6,47,富邦-嘉義,2024-04-17,9692
00712,復華富時不動產,133,90,43,富邦-嘉義,2024-04-17,9692
3016,嘉晶,52,10,42,富邦-嘉義,2024-04-17,9692
6770,力積電,79,37,42,富邦-嘉義,2024-04-17,9692
2412,中華電,41,0,41,富邦-嘉義,2024-04-17,9692
1617,榮星,165,124,41,富邦-嘉義,2024-04-17,9692
2897,王道銀行,41,0,41,富邦-嘉義,2024-04-17,9692
1529,樂事綠能,49,9,40,富邦-嘉義,2024-04-17,9692
4960,誠美材,42,4,38,富邦-嘉義,2024-04-17,9692
1513,中興電,862,826,36,富邦-嘉義,2024-04-17,9692
2888,新光金,81,45,36,富邦-嘉義,2024-04-17,9692
2356,英業達,51,16,35,富邦-嘉義,2024-04-17,9692
3060,銘異,55,22,33,富邦-嘉義,2024-04-17,9692
2515,中工,94,61,33,富邦-嘉義,2024-04-17,9692
2515,中工,8497,2832,5665,富邦-嘉義,2024-04-18,9692
2371,大同,3497,2901,596,富邦-嘉義,2024-04-18,9692
00937B,群益ESG投等債20,416,33,383,富邦-嘉義,2024-04-18,9692
2537,聯上發,399,39,360,富邦-嘉義,2024-04-18,9692
5521,工信,400,65,335,富邦-嘉義,2024-04-18,9692
2427,三商電,276,23,253,富邦-嘉義,2024-04-18,9692
5512,力麒,1091,882,209,富邦-嘉義,2024-04-18,9692
1617,榮星,204,0,204,富邦-嘉義,2024-04-18,9692
2634,漢翔,370,181,189,富邦-嘉義,2024-04-18,9692
1609,大亞,600,484,116,富邦-嘉義,2024-04-18,9692
0056,元大高股息,116,4,112,富邦-嘉義,2024-04-18,9692
2388,威盛,131,21,110,富邦-嘉義,2024-04-18,9692
4909,新復興,91,1,90,富邦-嘉義,2024-04-18,9692
00632R,元大台灣50反1,82,0,82,富邦-嘉義,2024-04-18,9692
2025,千興,81,0,81,富邦-嘉義,2024-04-18,9692
8473,山林水,178,112,66,富邦-嘉義,2024-04-18,9692
1603,華電,643,578,65,富邦-嘉義,2024-04-18,9692
2506,太設,94,29,65,富邦-嘉義,2024-04-18,9692
8089,康全電訊,70,11,59,富邦-嘉義,2024-04-18,9692
2543,皇昌,86,31,55,富邦-嘉義,2024-04-18,9692
8936,國統,168,114,54,富邦-嘉義,2024-04-18,9692
2886,兆豐金,52,0,52,富邦-嘉義,2024-04-18,9692
00641R,富邦日本反1,50,0,50,富邦-嘉義,2024-04-18,9692
2897,王道銀行,50,0,50,富邦-嘉義,2024-04-18,9692
3013,晟銘電,394,344,50,富邦-嘉義,2024-04-18,9692
2548,華固,54,4,50,富邦-嘉義,2024-04-18,9692
3231,緯創,154,108,46,富邦-嘉義,2024-04-18,9692
00942B,台新美A公司債20+,65,19,46,富邦-嘉義,2024-04-18,9692
1611,中電,129,87,42,富邦-嘉義,2024-04-18,9692
00878,國泰永續高股息,54,12,42,富邦-嘉義,2024-04-18,9692
2303,聯電,43,3,40,富邦-嘉義,2024-04-18,9692
2104,國際中橡,35,0,35,富邦-嘉義,2024-04-18,9692
2316,楠梓電,36,1,35,富邦-嘉義,2024-04-18,9692
1303,南亞,34,0,34,富邦-嘉義,2024-04-18,9692
2409,友達,50,16,34,富邦-嘉義,2024-04-18,9692
4157,太景*-KY,37,5,32,富邦-嘉義,2024-04-18,9692
5523,豐謙,32,0,32,富邦-嘉義,2024-04-18,9692
1615,大山,55,23,32,富邦-嘉義,2024-04-18,9692
1605,華新,198,166,32,富邦-嘉義,2024-04-18,9692
2464,盟立,38,7,31,富邦-嘉義,2024-04-18,9692
1584,精剛,47,16,31,富邦-嘉義,2024-04-18,9692
2610,華航,160,129,31,富邦-嘉義,2024-04-18,9692
3317,尼克森,31,0,31,富邦-嘉義,2024-04-18,9692
2630,亞航,149,119,30,富邦-嘉義,2024-04-18,9692
2353,宏��,33,5,28,富邦-嘉義,2024-04-18,9692
00939,統一台灣高息動能,32,5,27,富邦-嘉義,2024-04-18,9692
3708,上緯投控,169,142,27,富邦-嘉義,2024-04-18,9692
9933,中鼎,131,105,26,富邦-嘉義,2024-04-18,9692
5880,合庫金,30,4,26,富邦-嘉義,2024-04-18,9692
1736,喬山,25,0,25,富邦-嘉義,2024-04-18,9692
2515,中工,3844,2304,1540,富邦-嘉義,2024-04-19,9692
00929,復華台灣科技優息,1419,411,1008,富邦-嘉義,2024-04-19,9692
00940,元大台灣價值高息,990,258,732,富邦-嘉義,2024-04-19,9692
2371,大同,6189,5467,722,富邦-嘉義,2024-04-19,9692
2367,燿華,1124,515,609,富邦-嘉義,2024-04-19,9692
1618,合機,1508,1153,355,富邦-嘉義,2024-04-19,9692
2303,聯電,373,81,292,富邦-嘉義,2024-04-19,9692
00939,統一台灣高息動能,328,52,276,富邦-嘉義,2024-04-19,9692
1314,中石化,268,69,199,富邦-嘉義,2024-04-19,9692
2317,鴻海,2339,2140,199,富邦-嘉義,2024-04-19,9692
3287,廣寰科,201,5,196,富邦-嘉義,2024-04-19,9692
00664R,國泰臺灣加權反1,200,5,195,富邦-嘉義,2024-04-19,9692
9902,台火,357,164,193,富邦-嘉義,2024-04-19,9692
2618,長榮航,230,57,173,富邦-嘉義,2024-04-19,9692
00878,國泰永續高股息,240,67,173,富邦-嘉義,2024-04-19,9692
2543,皇昌,1165,1031,134,富邦-嘉義,2024-04-19,9692
2330,台積電,348,217,131,富邦-嘉義,2024-04-19,9692
2892,第一金,134,10,124,富邦-嘉義,2024-04-19,9692
3563,牧德,145,27,118,富邦-嘉義,2024-04-19,9692
0056,元大高股息,221,104,117,富邦-嘉義,2024-04-19,9692
2888,新光金,144,30,114,富邦-嘉義,2024-04-19,9692
00915,凱基優選高股息30,121,10,111,富邦-嘉義,2024-04-19,9692
2014,中鴻,114,11,103,富邦-嘉義,2024-04-19,9692
2845,遠東銀,98,0,98,富邦-嘉義,2024-04-19,9692
5230,雷笛克光學,129,35,94,富邦-嘉義,2024-04-19,9692
2883,凱基金,124,32,92,富邦-嘉義,2024-04-19,9692
1609,大亞,1845,1757,88,富邦-嘉義,2024-04-19,9692
2501,國建,109,22,87,富邦-嘉義,2024-04-19,9692
3703,欣陸,431,346,85,富邦-嘉義,2024-04-19,9692
8054,安國,750,672,78,富邦-嘉義,2024-04-19,9692
2409,友達,115,38,77,富邦-嘉義,2024-04-19,9692
3702A,大聯大甲特,70,0,70,富邦-嘉義,2024-04-19,9692
2880,華南金,73,4,69,富邦-嘉義,2024-04-19,9692
4157,太景*-KY,136,69,67,富邦-嘉義,2024-04-19,9692
2009,第一銅,244,180,64,富邦-嘉義,2024-04-19,9692
2356,英業達,90,26,64,富邦-嘉義,2024-04-19,9692
2610,華航,173,111,62,富邦-嘉義,2024-04-19,9692
1101,台泥,69,7,62,富邦-嘉義,2024-04-19,9692
6125,廣運,244,183,61,富邦-嘉義,2024-04-19,9692
6264,富裔,60,0,60,富邦-嘉義,2024-04-19,9692
2353,宏��,106,46,60,富邦-嘉義,2024-04-19,9692
6213,聯茂,72,14,58,富邦-嘉義,2024-04-19,9692
4148,全宇生技-KY,60,5,55,富邦-嘉義,2024-04-19,9692
1104,環泥,55,0,55,富邦-嘉義,2024-04-19,9692
2344,華邦電,73,21,52,富邦-嘉義,2024-04-19,9692
2316,楠梓電,54,5,49,富邦-嘉義,2024-04-19,9692
4956,光鋐,71,22,49,富邦-嘉義,2024-04-19,9692
3006,晶豪科,51,3,48,富邦-嘉義,2024-04-19,9692
2548,華固,53,5,48,富邦-嘉義,2024-04-19,9692
3058,立德,57,9,48,富邦-嘉義,2024-04-19,9692
2515,中工,5840,4706,1134,富邦-嘉義,2024-04-22,9692
00929,復華台灣科技優息,1057,98,959,富邦-嘉義,2024-04-22,9692
2367,燿華,469,85,384,富邦-嘉義,2024-04-22,9692
00940,元大台灣價值高息,394,67,327,富邦-嘉義,2024-04-22,9692
6264,富裔,264,59,205,富邦-嘉義,2024-04-22,9692
2867,三商壽,167,8,159,富邦-嘉義,2024-04-22,9692
00882,中信中國高股息,162,7,155,富邦-嘉義,2024-04-22,9692
5512,力麒,494,343,151,富邦-嘉義,2024-04-22,9692
0056,元大高股息,140,28,112,富邦-嘉義,2024-04-22,9692
1316,上曜,175,70,105,富邦-嘉義,2024-04-22,9692
2303,聯電,150,61,89,富邦-嘉義,2024-04-22,9692
3231,緯創,674,588,86,富邦-嘉義,2024-04-22,9692
00939,統一台灣高息動能,149,74,75,富邦-嘉義,2024-04-22,9692
3313,斐成,80,5,75,富邦-嘉義,2024-04-22,9692
2534,宏盛,75,3,72,富邦-嘉義,2024-04-22,9692
2363,矽統,938,868,70,富邦-嘉義,2024-04-22,9692
4148,全宇生技-KY,114,44,70,富邦-嘉義,2024-04-22,9692
2634,漢翔,235,165,70,富邦-嘉義,2024-04-22,9692
2609,陽明,298,234,64,富邦-嘉義,2024-04-22,9692
2516,新建,80,18,62,富邦-嘉義,2024-04-22,9692
2344,華邦電,76,17,59,富邦-嘉義,2024-04-22,9692
1605,華新,97,41,56,富邦-嘉義,2024-04-22,9692
00878,國泰永續高股息,65,10,55,富邦-嘉義,2024-04-22,9692
1795,美時,54,3,51,富邦-嘉義,2024-04-22,9692
9105,泰金寶-DR,50,0,50,富邦-嘉義,2024-04-22,9692
3025,星通,52,3,49,富邦-嘉義,2024-04-22,9692
1603,華電,82,37,45,富邦-嘉義,2024-04-22,9692
1616,億泰,110,68,42,富邦-嘉義,2024-04-22,9692
1513,中興電,175,137,38,富邦-嘉義,2024-04-22,9692
00772B,中信高評級公司債,37,0,37,富邦-嘉義,2024-04-22,9692
8064,東捷,66,29,37,富邦-嘉義,2024-04-22,9692
2329,華泰,123,87,36,富邦-嘉義,2024-04-22,9692
3563,牧德,111,80,31,富邦-嘉義,2024-04-22,9692
1584,精剛,31,0,31,富邦-嘉義,2024-04-22,9692
2603,長榮,198,170,28,富邦-嘉義,2024-04-22,9692
5531,鄉林,145,117,28,富邦-嘉義,2024-04-22,9692
5324,士開,45,19,26,富邦-嘉義,2024-04-22,9692
2408,南亞科,26,1,25,富邦-嘉義,2024-04-22,9692
2606,裕民,201,177,24,富邦-嘉義,2024-04-22,9692
1455,集盛,60,38,22,富邦-嘉義,2024-04-22,9692
1608,華榮,218,197,21,富邦-嘉義,2024-04-22,9692
3645,達邁,21,1,20,富邦-嘉義,2024-04-22,9692
2104,國際中橡,20,0,20,富邦-嘉義,2024-04-22,9692
3712,永崴投控,20,0,20,富邦-嘉義,2024-04-22,9692
3234,光環,20,0,20,富邦-嘉義,2024-04-22,9692
6274,台燿,21,1,20,富邦-嘉義,2024-04-22,9692
3715,定穎投控,21,2,19,富邦-嘉義,2024-04-22,9692
1617,榮星,533,515,18,富邦-嘉義,2024-04-22,9692
00753L,中信中國50正2,30,12,18,富邦-嘉義,2024-04-22,9692
6005,群益證,60,42,18,富邦-嘉義,2024-04-22,9692
00929,復華台灣科技優息,617,51,566,富邦-嘉義,2024-04-23,9692
6215,和椿,529,94,435,富邦-嘉義,2024-04-23,9692
2371,大同,2170,1922,248,富邦-嘉義,2024-04-23,9692
2812,台中銀,210,34,176,富邦-嘉義,2024-04-23,9692
2509,全坤建,712,556,156,富邦-嘉義,2024-04-23,9692
2317,鴻海,188,39,149,富邦-嘉義,2024-04-23,9692
2515,中工,1303,1176,127,富邦-嘉義,2024-04-23,9692
2374,佳能,1557,1435,122,富邦-嘉義,2024-04-23,9692
00939,統一台灣高息動能,116,21,95,富邦-嘉義,2024-04-23,9692
3703,欣陸,124,29,95,富邦-嘉義,2024-04-23,9692
2888,新光金,193,104,89,富邦-嘉義,2024-04-23,9692
2303,聯電,88,10,78,富邦-嘉義,2024-04-23,9692
00940,元大台灣價值高息,172,94,78,富邦-嘉義,2024-04-23,9692
1702,南僑,70,2,68,富邦-嘉義,2024-04-23,9692
5251,天鉞電,72,10,62,富邦-嘉義,2024-04-23,9692
5512,力麒,230,176,54,富邦-嘉義,2024-04-23,9692
2359,所羅門,102,50,52,富邦-嘉義,2024-04-23,9692
2363,矽統,389,340,49,富邦-嘉義,2024-04-23,9692
3715,定穎投控,113,65,48,富邦-嘉義,2024-04-23,9692
1617,榮星,52,4,48,富邦-嘉義,2024-04-23,9692
2367,燿華,112,70,42,富邦-嘉義,2024-04-23,9692
4716,大立,85,52,33,富邦-嘉義,2024-04-23,9692
00753L,中信中國50正2,44,11,33,富邦-嘉義,2024-04-23,9692
2610,華航,85,53,32,富邦-嘉義,2024-04-23,9692
2913,農林,32,0,32,富邦-嘉義,2024-04-23,9692
1584,精剛,31,0,31,富邦-嘉義,2024-04-23,9692
5521,工信,36,5,31,富邦-嘉義,2024-04-23,9692
3306,鼎天,31,0,31,富邦-嘉義,2024-04-23,9692
2332,友訊,29,0,29,富邦-嘉義,2024-04-23,9692
1616,億泰,48,20,28,富邦-嘉義,2024-04-23,9692
2313,華通,39,12,27,富邦-嘉義,2024-04-23,9692
6425,易發,61,35,26,富邦-嘉義,2024-04-23,9692
00679B,元大美債20年,27,2,25,富邦-嘉義,2024-04-23,9692
4714,永捷,34,9,25,富邦-嘉義,2024-04-23,9692
00878,國泰永續高股息,36,14,22,富邦-嘉義,2024-04-23,9692
4160,訊聯基因,20,0,20,富邦-嘉義,2024-04-23,9692
5009,榮剛,31,11,20,富邦-嘉義,2024-04-23,9692
2356,英業達,32,13,19,富邦-嘉義,2024-04-23,9692
8213,志超,21,2,19,富邦-嘉義,2024-04-23,9692
2301,光寶科,24,5,19,富邦-嘉義,2024-04-23,9692
1587,吉茂,27,9,18,富邦-嘉義,2024-04-23,9692
2506,太設,80,62,18,富邦-嘉義,2024-04-23,9692
4961,天鈺,20,2,18,富邦-嘉義,2024-04-23,9692
5880,合庫金,20,4,16,富邦-嘉義,2024-04-23,9692
2637,慧洋-KY,36,20,16,富邦-嘉義,2024-04-23,9692
1608,華榮,119,103,16,富邦-嘉義,2024-04-23,9692
6282,康舒,16,1,15,富邦-嘉義,2024-04-23,9692
2023,燁輝,15,0,15,富邦-嘉義,2024-04-23,9692
2474,可成,17,2,15,富邦-嘉義,2024-04-23,9692
5523,豐謙,14,0,14,富邦-嘉義,2024-04-23,9692
1587,吉茂,465,4,461,富邦-嘉義,2024-04-24,9692
00673R,期元大S＆P原油反1,292,10,282,富邦-嘉義,2024-04-24,9692
3013,晟銘電,630,378,252,富邦-嘉義,2024-04-24,9692
5531,鄉林,265,26,239,富邦-嘉義,2024-04-24,9692
3037,欣興,236,34,202,富邦-嘉義,2024-04-24,9692
00919,群益台灣精選高息,245,50,195,富邦-嘉義,2024-04-24,9692
2363,矽統,582,411,171,富邦-嘉義,2024-04-24,9692
2515,中工,1777,1625,152,富邦-嘉義,2024-04-24,9692
6207,雷科,304,155,149,富邦-嘉義,2024-04-24,9692
6188,廣明,605,483,122,富邦-嘉義,2024-04-24,9692
00679B,元大美債20年,99,2,97,富邦-嘉義,2024-04-24,9692
3481,群創,183,86,97,富邦-嘉義,2024-04-24,9692
6016,康和證,98,1,97,富邦-嘉義,2024-04-24,9692
8210,勤誠,158,62,96,富邦-嘉義,2024-04-24,9692
2511,太子,82,0,82,富邦-嘉義,2024-04-24,9692
2409,友達,109,27,82,富邦-嘉義,2024-04-24,9692
00687B,國泰20年美債,74,0,74,富邦-嘉義,2024-04-24,9692
8070,長華*,80,8,72,富邦-嘉義,2024-04-24,9692
6770,力積電,85,19,66,富邦-嘉義,2024-04-24,9692
6425,易發,124,68,56,富邦-嘉義,2024-04-24,9692
2886,兆豐金,56,1,55,富邦-嘉義,2024-04-24,9692
2547,日勝生,74,23,51,富邦-嘉義,2024-04-24,9692
00941,中信上游半導體,61,10,51,富邦-嘉義,2024-04-24,9692
1313,聯成,50,0,50,富邦-嘉義,2024-04-24,9692
3207,耀勝,50,0,50,富邦-嘉義,2024-04-24,9692
3715,定穎投控,112,65,47,富邦-嘉義,2024-04-24,9692
00772B,中信高評級公司債,45,0,45,富邦-嘉義,2024-04-24,9692
5251,天鉞電,51,6,45,富邦-嘉義,2024-04-24,9692
1514,亞力,49,4,45,富邦-嘉義,2024-04-24,9692
1605,華新,59,19,40,富邦-嘉義,2024-04-24,9692
6449,鈺邦,43,6,37,富邦-嘉義,2024-04-24,9692
1618,合機,905,869,36,富邦-嘉義,2024-04-24,9692
1314,中石化,51,16,35,富邦-嘉義,2024-04-24,9692
6230,尼得科超眾,35,0,35,富邦-嘉義,2024-04-24,9692
2615,萬海,41,9,32,富邦-嘉義,2024-04-24,9692
1608,華榮,190,159,31,富邦-嘉義,2024-04-24,9692
00680L,元大美債20正2,31,0,31,富邦-嘉義,2024-04-24,9692
2905,三商,30,0,30,富邦-嘉義,2024-04-24,9692
2027,大成鋼,34,4,30,富邦-嘉義,2024-04-24,9692
4716,大立,32,5,27,富邦-嘉義,2024-04-24,9692
1617,榮星,68,41,27,富邦-嘉義,2024-04-24,9692
8054,安國,251,224,27,富邦-嘉義,2024-04-24,9692
2506,太設,41,15,26,富邦-嘉義,2024-04-24,9692
3516,亞帝歐,26,0,26,富邦-嘉義,2024-04-24,9692
1108,幸福,31,6,25,富邦-嘉義,2024-04-24,9692
5880,合庫金,25,2,23,富邦-嘉義,2024-04-24,9692
5324,士開,24,2,22,富邦-嘉義,2024-04-24,9692
2851,中再保,43,22,21,富邦-嘉義,2024-04-24,9692
1810,和成,21,0,21,富邦-嘉義,2024-04-24,9692
00878,國泰永續高股息,27,6,21,富邦-嘉義,2024-04-24,9692
2371,大同,1832,847,985,富邦-嘉義,2024-04-25,9692
00665L,富邦�琤肭磪囓�2,308,49,259,富邦-嘉義,2024-04-25,9692
6264,富裔,226,0,226,富邦-嘉義,2024-04-25,9692
6425,易發,613,401,212,富邦-嘉義,2024-04-25,9692
3234,光環,230,31,199,富邦-嘉義,2024-04-25,9692
2888,新光金,187,2,185,富邦-嘉義,2024-04-25,9692
1440,南紡,3290,3112,178,富邦-嘉義,2024-04-25,9692
3312,弘憶股,167,21,146,富邦-嘉義,2024-04-25,9692
2367,燿華,138,4,134,富邦-嘉義,2024-04-25,9692
2618,長榮航,600,480,120,富邦-嘉義,2024-04-25,9692
1609,大亞,320,202,118,富邦-嘉義,2024-04-25,9692
00937B,群益ESG投等債20,113,0,113,富邦-嘉義,2024-04-25,9692
00940,元大台灣價值高息,141,43,98,富邦-嘉義,2024-04-25,9692
00929,復華台灣科技優息,133,40,93,富邦-嘉義,2024-04-25,9692
00878,國泰永續高股息,105,13,92,富邦-嘉義,2024-04-25,9692
1503,士電,304,212,92,富邦-嘉義,2024-04-25,9692
00919,群益台灣精選高息,89,7,82,富邦-嘉義,2024-04-25,9692
1314,中石化,70,0,70,富邦-嘉義,2024-04-25,9692
4716,大立,137,70,67,富邦-嘉義,2024-04-25,9692
1725,元禎,76,10,66,富邦-嘉義,2024-04-25,9692
2845,遠東銀,63,0,63,富邦-嘉義,2024-04-25,9692
2537,聯上發,62,0,62,富邦-嘉義,2024-04-25,9692
5493,三聯,72,11,61,富邦-嘉義,2024-04-25,9692
2745,五福,77,22,55,富邦-嘉義,2024-04-25,9692
8070,長華*,56,4,52,富邦-嘉義,2024-04-25,9692
3231,緯創,120,69,51,富邦-嘉義,2024-04-25,9692
00679B,元大美債20年,51,0,51,富邦-嘉義,2024-04-25,9692
2516,新建,45,0,45,富邦-嘉義,2024-04-25,9692
2359,所羅門,523,478,45,富邦-嘉義,2024-04-25,9692
00687B,國泰20年美債,54,10,44,富邦-嘉義,2024-04-25,9692
2736,富野,94,51,43,富邦-嘉義,2024-04-25,9692
3617,碩天,53,14,39,富邦-嘉義,2024-04-25,9692
6207,雷科,288,252,36,富邦-嘉義,2024-04-25,9692
1101,台泥,42,8,34,富邦-嘉義,2024-04-25,9692
2892,第一金,34,1,33,富邦-嘉義,2024-04-25,9692
2547,日勝生,35,2,33,富邦-嘉義,2024-04-25,9692
2303,聯電,36,6,30,富邦-嘉義,2024-04-25,9692
5512,力麒,105,75,30,富邦-嘉義,2024-04-25,9692
3230,錦明,30,0,30,富邦-嘉義,2024-04-25,9692
8105,凌巨,30,0,30,富邦-嘉義,2024-04-25,9692
2317,鴻海,1929,1900,29,富邦-嘉義,2024-04-25,9692
6176,瑞儀,124,95,29,富邦-嘉義,2024-04-25,9692
3501,維熹,30,2,28,富邦-嘉義,2024-04-25,9692
2330,台積電,38,10,28,富邦-嘉義,2024-04-25,9692
8040,九暘,27,0,27,富邦-嘉義,2024-04-25,9692
3306,鼎天,82,56,26,富邦-嘉義,2024-04-25,9692
9904,寶成,29,3,26,富邦-嘉義,2024-04-25,9692
4532,瑞智,26,0,26,富邦-嘉義,2024-04-25,9692
5521,工信,128,103,25,富邦-嘉義,2024-04-25,9692
1584,精剛,30,5,25,富邦-嘉義,2024-04-25,9692
2323,中環,2027,443,1584,富邦-嘉義,2024-04-26,9692
2501,國建,765,217,548,富邦-嘉義,2024-04-26,9692
00632R,元大台灣50反1,348,3,345,富邦-嘉義,2024-04-26,9692
1314,中石化,428,136,292,富邦-嘉義,2024-04-26,9692
2609,陽明,986,742,244,富邦-嘉義,2024-04-26,9692
00937B,群益ESG投等債20,215,5,210,富邦-嘉義,2024-04-26,9692
8996,高力,688,483,205,富邦-嘉義,2024-04-26,9692
00942B,台新美A公司債20+,144,0,144,富邦-嘉義,2024-04-26,9692
5230,雷笛克光學,156,27,129,富邦-嘉義,2024-04-26,9692
00857B,永豐20年美公債,118,0,118,富邦-嘉義,2024-04-26,9692
00679B,元大美債20年,103,0,103,富邦-嘉義,2024-04-26,9692
3287,廣寰科,112,13,99,富邦-嘉義,2024-04-26,9692
2367,燿華,100,6,94,富邦-嘉義,2024-04-26,9692
3481,群創,168,82,86,富邦-嘉義,2024-04-26,9692
00878,國泰永續高股息,104,18,86,富邦-嘉義,2024-04-26,9692
6449,鈺邦,123,47,76,富邦-嘉義,2024-04-26,9692
6215,和椿,101,28,73,富邦-嘉義,2024-04-26,9692
2101,南港,496,429,67,富邦-嘉義,2024-04-26,9692
4127,天良,69,8,61,富邦-嘉義,2024-04-26,9692
4909,新復興,170,111,59,富邦-嘉義,2024-04-26,9692
3059,華晶科,59,0,59,富邦-嘉義,2024-04-26,9692
3363,上詮,321,263,58,富邦-嘉義,2024-04-26,9692
2486,一詮,2042,1991,51,富邦-嘉義,2024-04-26,9692
6190,萬泰科,61,11,50,富邦-嘉義,2024-04-26,9692
1710,東聯,50,0,50,富邦-嘉義,2024-04-26,9692
2611,志信,1843,1797,46,富邦-嘉義,2024-04-26,9692
00929,復華台灣科技優息,132,89,43,富邦-嘉義,2024-04-26,9692
5531,鄉林,335,295,40,富邦-嘉義,2024-04-26,9692
1587,吉茂,581,541,40,富邦-嘉義,2024-04-26,9692
2208,台船,38,0,38,富邦-嘉義,2024-04-26,9692
00676R,富邦臺灣加權反1,38,1,37,富邦-嘉義,2024-04-26,9692
8064,東捷,111,75,36,富邦-嘉義,2024-04-26,9692
00687B,國泰20年美債,57,22,35,富邦-嘉義,2024-04-26,9692
3058,立德,35,2,33,富邦-嘉義,2024-04-26,9692
2547,日勝生,140,107,33,富邦-嘉義,2024-04-26,9692
1447,力鵬,32,0,32,富邦-嘉義,2024-04-26,9692
2911,麗嬰房,31,0,31,富邦-嘉義,2024-04-26,9692
4933,友輝,30,0,30,富邦-嘉義,2024-04-26,9692
1101,台泥,35,5,30,富邦-嘉義,2024-04-26,9692
00680L,元大美債20正2,29,0,29,富邦-嘉義,2024-04-26,9692
1702,南僑,30,2,28,富邦-嘉義,2024-04-26,9692
00712,復華富時不動產,26,0,26,富邦-嘉義,2024-04-26,9692
1605,華新,33,8,25,富邦-嘉義,2024-04-26,9692
2881,富邦金,40,14,26,富邦-嘉義,2024-04-26,9692
1617,榮星,23,0,23,富邦-嘉義,2024-04-26,9692
5871,中租-KY,25,2,23,富邦-嘉義,2024-04-26,9692
2511,太子,168,146,22,富邦-嘉義,2024-04-26,9692
2630,亞航,29,8,21,富邦-嘉義,2024-04-26,9692
1725,元禎,27,6,21,富邦-嘉義,2024-04-26,9692
3466,德晉,29,8,21,富邦-嘉義,2024-04-26,9692
1314,中石化,9444,6933,2511,富邦-嘉義,2024-04-29,9692
5531,鄉林,1286,481,805,富邦-嘉義,2024-04-29,9692
8096,擎亞,978,243,735,富邦-嘉義,2024-04-29,9692
2537,聯上發,1948,1519,429,富邦-嘉義,2024-04-29,9692
2317,鴻海,926,622,304,富邦-嘉義,2024-04-29,9692
1725,元禎,298,0,298,富邦-嘉義,2024-04-29,9692
00706L,期元大S＆P日圓正2,265,30,235,富邦-嘉義,2024-04-29,9692
2104,國際中橡,230,20,210,富邦-嘉義,2024-04-29,9692
1316,上曜,1069,865,204,富邦-嘉義,2024-04-29,9692
00632R,元大台灣50反1,308,110,198,富邦-嘉義,2024-04-29,9692
2618,長榮航,261,63,198,富邦-嘉義,2024-04-29,9692
00937B,群益ESG投等債20,170,10,160,富邦-嘉義,2024-04-29,9692
2801,彰銀,151,2,149,富邦-嘉義,2024-04-29,9692
1584,精剛,138,1,137,富邦-嘉義,2024-04-29,9692
3363,上詮,280,147,133,富邦-嘉義,2024-04-29,9692
4127,天良,368,252,116,富邦-嘉義,2024-04-29,9692
2547,日勝生,102,3,99,富邦-嘉義,2024-04-29,9692
3287,廣寰科,110,20,90,富邦-嘉義,2024-04-29,9692
3006,晶豪科,92,7,85,富邦-嘉義,2024-04-29,9692
2101,南港,176,93,83,富邦-嘉義,2024-04-29,9692
2611,志信,99,19,80,富邦-嘉義,2024-04-29,9692
2610,華航,149,76,73,富邦-嘉義,2024-04-29,9692
2534,宏盛,90,17,73,富邦-嘉義,2024-04-29,9692
2332,友訊,71,0,71,富邦-嘉義,2024-04-29,9692
2316,楠梓電,72,5,67,富邦-嘉義,2024-04-29,9692
6283,淳安,51,0,51,富邦-嘉義,2024-04-29,9692
2897A,王道銀甲特,46,0,46,富邦-嘉義,2024-04-29,9692
1440,南紡,165,121,44,富邦-嘉義,2024-04-29,9692
5251,天鉞電,60,18,42,富邦-嘉義,2024-04-29,9692
2913,農林,695,655,40,富邦-嘉義,2024-04-29,9692
8028,昇陽半導體,43,4,39,富邦-嘉義,2024-04-29,9692
2449,京元電子,392,355,37,富邦-嘉義,2024-04-29,9692
00687B,國泰20年美債,47,12,35,富邦-嘉義,2024-04-29,9692
6120,達運,42,13,29,富邦-嘉義,2024-04-29,9692
6190,萬泰科,32,3,29,富邦-嘉義,2024-04-29,9692
3376,新日興,31,3,28,富邦-嘉義,2024-04-29,9692
2009,第一銅,77,49,28,富邦-嘉義,2024-04-29,9692
8936,國統,37,10,27,富邦-嘉義,2024-04-29,9692
1617,榮星,40,13,27,富邦-嘉義,2024-04-29,9692
3312,弘憶股,52,25,27,富邦-嘉義,2024-04-29,9692
2511,太子,60,34,26,富邦-嘉義,2024-04-29,9692
1514,亞力,69,44,25,富邦-嘉義,2024-04-29,9692
4303,信立,145,121,24,富邦-嘉義,2024-04-29,9692
00665L,富邦�琤肭磪囓�2,25,1,24,富邦-嘉義,2024-04-29,9692
3264,欣銓,35,12,23,富邦-嘉義,2024-04-29,9692
2603,長榮,347,325,22,富邦-嘉義,2024-04-29,9692
3703,欣陸,135,113,22,富邦-嘉義,2024-04-29,9692
6425,易發,25,4,21,富邦-嘉義,2024-04-29,9692
4919,新唐,26,5,21,富邦-嘉義,2024-04-29,9692
00650L,復華香港正2,64,43,21,富邦-嘉義,2024-04-29,9692
00632R,元大台灣50反1,505,30,475,富邦-嘉義,2024-04-30,9692
2888,新光金,358,26,332,富邦-嘉義,2024-04-30,9692
00929,復華台灣科技優息,140,14,126,富邦-嘉義,2024-04-30,9692
2615,萬海,128,28,100,富邦-嘉義,2024-04-30,9692
2332,友訊,105,6,99,富邦-嘉義,2024-04-30,9692
2356,英業達,104,6,98,富邦-嘉義,2024-04-30,9692
2010,春源,95,3,92,富邦-嘉義,2024-04-30,9692
2609,陽明,222,140,82,富邦-嘉義,2024-04-30,9692
8996,高力,962,886,76,富邦-嘉義,2024-04-30,9692
00940,元大台灣價值高息,73,2,71,富邦-嘉義,2024-04-30,9692
2367,燿華,97,29,68,富邦-嘉義,2024-04-30,9692
00919,群益台灣精選高息,79,14,65,富邦-嘉義,2024-04-30,9692
3147,大綜,114,52,62,富邦-嘉義,2024-04-30,9692
3312,弘憶股,99,39,60,富邦-嘉義,2024-04-30,9692
3289,宜特,66,8,58,富邦-嘉義,2024-04-30,9692
2497,怡利電,61,4,57,富邦-嘉義,2024-04-30,9692
1587,吉茂,213,160,53,富邦-嘉義,2024-04-30,9692
1718,中纖,55,2,53,富邦-嘉義,2024-04-30,9692
4532,瑞智,56,5,51,富邦-嘉義,2024-04-30,9692
2801,彰銀,60,10,50,富邦-嘉義,2024-04-30,9692
6230,尼得科超眾,201,156,45,富邦-嘉義,2024-04-30,9692
6442,光聖,105,61,44,富邦-嘉義,2024-04-30,9692
3017,奇鋐,265,222,43,富邦-嘉義,2024-04-30,9692
00712,復華富時不動產,40,0,40,富邦-嘉義,2024-04-30,9692
5512,力麒,44,5,39,富邦-嘉義,2024-04-30,9692
2880,華南金,255,221,34,富邦-嘉義,2024-04-30,9692
3708,上緯投控,35,2,33,富邦-嘉義,2024-04-30,9692
2506,太設,56,24,32,富邦-嘉義,2024-04-30,9692
2883,凱基金,248,217,31,富邦-嘉義,2024-04-30,9692
2408,南亞科,30,0,30,富邦-嘉義,2024-04-30,9692
4123,晟德,31,2,29,富邦-嘉義,2024-04-30,9692
6113,亞矽,30,1,29,富邦-嘉義,2024-04-30,9692
2630,亞航,28,0,28,富邦-嘉義,2024-04-30,9692
00680L,元大美債20正2,30,2,28,富邦-嘉義,2024-04-30,9692
2845,遠東銀,34,6,28,富邦-嘉義,2024-04-30,9692
00937B,群益ESG投等債20,54,27,27,富邦-嘉義,2024-04-30,9692
00939,統一台灣高息動能,28,2,26,富邦-嘉義,2024-04-30,9692
3686,達能,26,0,26,富邦-嘉義,2024-04-30,9692
2465,麗臺,99,73,26,富邦-嘉義,2024-04-30,9692
6177,達麗,184,160,24,富邦-嘉義,2024-04-30,9692
00850,元大臺灣ESG永續,23,0,23,富邦-嘉義,2024-04-30,9692
8064,東捷,57,34,23,富邦-嘉義,2024-04-30,9692
2603,長榮,64,41,23,富邦-嘉義,2024-04-30,9692
6290,良維,22,0,22,富邦-嘉義,2024-04-30,9692
3703,欣陸,32,11,21,富邦-嘉義,2024-04-30,9692
1605,華新,27,6,21,富邦-嘉義,2024-04-30,9692
2547,日勝生,29,8,21,富邦-嘉義,2024-04-30,9692
3013,晟銘電,39,18,21,富邦-嘉義,2024-04-30,9692
2348A,海悅甲特,20,0,20,富邦-嘉義,2024-04-30,9692
6770,力積電,31,12,19,富邦-嘉義,2024-04-30,9692
5521,工信,1877,68,1809,富邦-嘉義,2024-05-02,9692
1316,上曜,1742,696,1046,富邦-嘉義,2024-05-02,9692
3481,群創,641,39,602,富邦-嘉義,2024-05-02,9692
2537,聯上發,556,57,499,富邦-嘉義,2024-05-02,9692
5531,鄉林,591,263,328,富邦-嘉義,2024-05-02,9692
00929,復華台灣科技優息,301,11,290,富邦-嘉義,2024-05-02,9692
00878,國泰永續高股息,392,115,277,富邦-嘉義,2024-05-02,9692
4714,永捷,305,46,259,富邦-嘉義,2024-05-02,9692
8096,擎亞,275,46,229,富邦-嘉義,2024-05-02,9692
2504,國產,269,74,195,富邦-嘉義,2024-05-02,9692
2382,廣達,513,319,194,富邦-嘉義,2024-05-02,9692
4533,協易機,1089,898,191,富邦-嘉義,2024-05-02,9692
5512,力麒,1915,1730,185,富邦-嘉義,2024-05-02,9692
1717,長興,180,0,180,富邦-嘉義,2024-05-02,9692
2543,皇昌,360,187,173,富邦-嘉義,2024-05-02,9692
5230,雷笛克光學,243,100,143,富邦-嘉義,2024-05-02,9692
2852,第一保,144,21,123,富邦-嘉義,2024-05-02,9692
1453,大將,279,170,109,富邦-嘉義,2024-05-02,9692
4303,信立,115,6,109,富邦-嘉義,2024-05-02,9692
3188,鑫龍騰,236,134,102,富邦-嘉義,2024-05-02,9692
2409,友達,114,13,101,富邦-嘉義,2024-05-02,9692
00936,台新永續高息中小,101,1,100,富邦-嘉義,2024-05-02,9692
3234,光環,92,2,90,富邦-嘉義,2024-05-02,9692
2374,佳能,93,6,87,富邦-嘉義,2024-05-02,9692
912000,晨訊科-DR,80,0,80,富邦-嘉義,2024-05-02,9692
1440,南紡,90,13,77,富邦-嘉義,2024-05-02,9692
00919,群益台灣精選高息,119,43,76,富邦-嘉義,2024-05-02,9692
3013,晟銘電,375,304,71,富邦-嘉義,2024-05-02,9692
3060,銘異,67,0,67,富邦-嘉義,2024-05-02,9692
2515,中工,345,285,60,富邦-嘉義,2024-05-02,9692
00940,元大台灣價值高息,105,47,58,富邦-嘉義,2024-05-02,9692
2330,台積電,56,5,51,富邦-嘉義,2024-05-02,9692
2108,南帝,49,0,49,富邦-嘉義,2024-05-02,9692
1609,大亞,1216,1169,47,富邦-嘉義,2024-05-02,9692
2303,聯電,54,8,46,富邦-嘉義,2024-05-02,9692
9904,寶成,42,0,42,富邦-嘉義,2024-05-02,9692
3017,奇鋐,118,77,41,富邦-嘉義,2024-05-02,9692
2891,中信金,52,12,40,富邦-嘉義,2024-05-02,9692
2324,仁寶,45,6,39,富邦-嘉義,2024-05-02,9692
6207,雷科,113,75,38,富邦-嘉義,2024-05-02,9692
3289,宜特,40,3,37,富邦-嘉義,2024-05-02,9692
1514,亞力,56,20,36,富邦-嘉義,2024-05-02,9692
2204,中華,40,4,36,富邦-嘉義,2024-05-02,9692
1101,台泥,63,28,35,富邦-嘉義,2024-05-02,9692
2739,寒舍,94,59,35,富邦-嘉義,2024-05-02,9692
2332,友訊,37,4,33,富邦-嘉義,2024-05-02,9692
6261,久元,40,8,32,富邦-嘉義,2024-05-02,9692
2516,新建,50,19,31,富邦-嘉義,2024-05-02,9692
2888,新光金,58,28,30,富邦-嘉義,2024-05-02,9692
4960,誠美材,27,0,27,富邦-嘉義,2024-05-02,9692
00937B,群益ESG投等債20,569,101,468,富邦-嘉義,2024-05-03,9692
9907,統一實,232,2,230,富邦-嘉義,2024-05-03,9692
00632R,元大台灣50反1,243,14,229,富邦-嘉義,2024-05-03,9692
00929,復華台灣科技優息,173,50,123,富邦-嘉義,2024-05-03,9692
00891,中信關鍵半導體,115,0,115,富邦-嘉義,2024-05-03,9692
6120,達運,117,13,104,富邦-嘉義,2024-05-03,9692
2486,一詮,184,80,104,富邦-嘉義,2024-05-03,9692
4906,正文,100,0,100,富邦-嘉義,2024-05-03,9692
2852,第一保,105,7,98,富邦-嘉義,2024-05-03,9692
00650L,復華香港正2,103,10,93,富邦-嘉義,2024-05-03,9692
6016,康和證,115,26,89,富邦-嘉義,2024-05-03,9692
1591,駿吉-KY,85,0,85,富邦-嘉義,2024-05-03,9692
4714,永捷,826,746,80,富邦-嘉義,2024-05-03,9692
2615,萬海,91,13,78,富邦-嘉義,2024-05-03,9692
3231,緯創,1211,1143,68,富邦-嘉義,2024-05-03,9692
912000,晨訊科-DR,70,4,66,富邦-嘉義,2024-05-03,9692
00878,國泰永續高股息,73,9,64,富邦-嘉義,2024-05-03,9692
2609,陽明,122,61,61,富邦-嘉義,2024-05-03,9692
2516,新建,61,0,61,富邦-嘉義,2024-05-03,9692
2603,長榮,120,60,60,富邦-嘉義,2024-05-03,9692
00687B,國泰20年美債,69,10,59,富邦-嘉義,2024-05-03,9692
1219,福壽,54,0,54,富邦-嘉義,2024-05-03,9692
1103,嘉泥,50,0,50,富邦-嘉義,2024-05-03,9692
8096,擎亞,1887,1837,50,富邦-嘉義,2024-05-03,9692
1313,聯成,51,2,49,富邦-嘉義,2024-05-03,9692
2316,楠梓電,51,2,49,富邦-嘉義,2024-05-03,9692
6442,光聖,174,127,47,富邦-嘉義,2024-05-03,9692
2344,華邦電,87,40,47,富邦-嘉義,2024-05-03,9692
1413,宏洲,72,26,46,富邦-嘉義,2024-05-03,9692
2014,中鴻,46,0,46,富邦-嘉義,2024-05-03,9692
2506,太設,93,50,43,富邦-嘉義,2024-05-03,9692
5469,瀚宇博,40,0,40,富邦-嘉義,2024-05-03,9692
6449,鈺邦,211,171,40,富邦-嘉義,2024-05-03,9692
2547,日勝生,112,73,39,富邦-嘉義,2024-05-03,9692
3312,弘憶股,112,74,38,富邦-嘉義,2024-05-03,9692
4716,大立,41,3,38,富邦-嘉義,2024-05-03,9692
2492,華新科,227,191,36,富邦-嘉義,2024-05-03,9692
2836,高雄銀,38,3,35,富邦-嘉義,2024-05-03,9692
1514,亞力,237,202,35,富邦-嘉義,2024-05-03,9692
2332,友訊,37,5,32,富邦-嘉義,2024-05-03,9692
2488,漢平,31,0,31,富邦-嘉義,2024-05-03,9692
2356,英業達,33,2,31,富邦-嘉義,2024-05-03,9692
4414,如興,30,0,30,富邦-嘉義,2024-05-03,9692
1587,吉茂,38,8,30,富邦-嘉義,2024-05-03,9692
6129,普誠,29,0,29,富邦-嘉義,2024-05-03,9692
00679B,元大美債20年,35,6,29,富邦-嘉義,2024-05-03,9692
9945,潤泰新,117,89,28,富邦-嘉義,2024-05-03,9692
2515,中工,231,205,26,富邦-嘉義,2024-05-03,9692
2630,亞航,28,2,26,富邦-嘉義,2024-05-03,9692
2442,新美齊,25,0,25,富邦-嘉義,2024-05-03,9692
4967,十銓,1295,661,634,富邦-嘉義,2024-05-06,9692
3260,威剛,594,190,404,富邦-嘉義,2024-05-06,9692
00937B,群益ESG投等債20,329,11,318,富邦-嘉義,2024-05-06,9692
2353,宏��,883,598,285,富邦-嘉義,2024-05-06,9692
2883,凱基金,327,92,235,富邦-嘉義,2024-05-06,9692
3363,上詮,473,258,215,富邦-嘉義,2024-05-06,9692
3356,奇偶,249,61,188,富邦-嘉義,2024-05-06,9692
4127,天良,190,6,184,富邦-嘉義,2024-05-06,9692
2888,新光金,377,216,161,富邦-嘉義,2024-05-06,9692
1587,吉茂,157,1,156,富邦-嘉義,2024-05-06,9692
6207,雷科,206,60,146,富邦-嘉義,2024-05-06,9692
1570,力肯,134,2,132,富邦-嘉義,2024-05-06,9692
00632R,元大台灣50反1,271,139,132,富邦-嘉義,2024-05-06,9692
2317,鴻海,1158,1036,122,富邦-嘉義,2024-05-06,9692
8071,能率網通,100,0,100,富邦-嘉義,2024-05-06,9692
9907,統一實,99,0,99,富邦-嘉義,2024-05-06,9692
1582,信錦,561,466,95,富邦-嘉義,2024-05-06,9692
00878,國泰永續高股息,121,29,92,富邦-嘉義,2024-05-06,9692
2538,基泰,207,118,89,富邦-嘉義,2024-05-06,9692
3013,晟銘電,177,90,87,富邦-嘉義,2024-05-06,9692
00929,復華台灣科技優息,133,57,76,富邦-嘉義,2024-05-06,9692
5512,力麒,99,28,71,富邦-嘉義,2024-05-06,9692
5498,凱崴,72,2,70,富邦-嘉義,2024-05-06,9692
1453,大將,189,120,69,富邦-嘉義,2024-05-06,9692
2332,友訊,65,0,65,富邦-嘉義,2024-05-06,9692
2313,華通,64,1,63,富邦-嘉義,2024-05-06,9692
1219,福壽,60,0,60,富邦-嘉義,2024-05-06,9692
9904,寶成,71,12,59,富邦-嘉義,2024-05-06,9692
1103,嘉泥,60,2,58,富邦-嘉義,2024-05-06,9692
2449,京元電子,83,28,55,富邦-嘉義,2024-05-06,9692
8047,星雲,55,0,55,富邦-嘉義,2024-05-06,9692
6770,力積電,126,72,54,富邦-嘉義,2024-05-06,9692
2516,新建,55,1,54,富邦-嘉義,2024-05-06,9692
3006,晶豪科,80,30,50,富邦-嘉義,2024-05-06,9692
4157,太景*-KY,55,6,49,富邦-嘉義,2024-05-06,9692
2618,長榮航,162,115,47,富邦-嘉義,2024-05-06,9692
6190,萬泰科,58,11,47,富邦-嘉義,2024-05-06,9692
2374,佳能,58,12,46,富邦-嘉義,2024-05-06,9692
3024,憶聲,65,20,45,富邦-嘉義,2024-05-06,9692
9933,中鼎,63,18,45,富邦-嘉義,2024-05-06,9692
8096,擎亞,1346,1302,44,富邦-嘉義,2024-05-06,9692
1591,駿吉-KY,55,11,44,富邦-嘉義,2024-05-06,9692
00857B,永豐20年美公債,42,0,42,富邦-嘉義,2024-05-06,9692
3207,耀勝,40,1,39,富邦-嘉義,2024-05-06,9692
1584,精剛,40,5,35,富邦-嘉義,2024-05-06,9692
2630,亞航,90,55,35,富邦-嘉義,2024-05-06,9692
3376,新日興,64,30,34,富邦-嘉義,2024-05-06,9692
1616,億泰,57,26,31,富邦-嘉義,2024-05-06,9692
4716,大立,31,0,31,富邦-嘉義,2024-05-06,9692
1605,華新,35,4,31,富邦-嘉義,2024-05-06,9692
1618,合機,1803,1338,465,富邦-嘉義,2024-05-07,9692
4561,健椿,448,0,448,富邦-嘉義,2024-05-07,9692
1608,華榮,1277,862,415,富邦-嘉義,2024-05-07,9692
00937B,群益ESG投等債20,444,70,374,富邦-嘉義,2024-05-07,9692
3481,群創,419,50,369,富邦-嘉義,2024-05-07,9692
2374,佳能,1931,1583,348,富邦-嘉義,2024-05-07,9692
00878,國泰永續高股息,358,22,336,富邦-嘉義,2024-05-07,9692
3260,威剛,1641,1428,213,富邦-嘉義,2024-05-07,9692
3287,廣寰科,282,79,203,富邦-嘉義,2024-05-07,9692
8112,至上,218,24,194,富邦-嘉義,2024-05-07,9692
2515,中工,284,119,165,富邦-嘉義,2024-05-07,9692
6442,光聖,296,137,159,富邦-嘉義,2024-05-07,9692
2367,燿華,183,32,151,富邦-嘉義,2024-05-07,9692
3609,三一東林,145,6,139,富邦-嘉義,2024-05-07,9692
5512,力麒,199,69,130,富邦-嘉義,2024-05-07,9692
4973,廣穎,124,2,122,富邦-嘉義,2024-05-07,9692
1609,大亞,864,757,107,富邦-嘉義,2024-05-07,9692
6188,廣明,558,457,101,富邦-嘉義,2024-05-07,9692
6215,和椿,346,253,93,富邦-嘉義,2024-05-07,9692
1612,宏泰,606,514,92,富邦-嘉義,2024-05-07,9692
00751B,元大AAA至A公司債,106,16,90,富邦-嘉義,2024-05-07,9692
2359,所羅門,105,21,84,富邦-嘉義,2024-05-07,9692
2465,麗臺,94,11,83,富邦-嘉義,2024-05-07,9692
3234,光環,87,6,81,富邦-嘉義,2024-05-07,9692
3563,牧德,86,12,74,富邦-嘉義,2024-05-07,9692
00940,元大台灣價值高息,162,90,72,富邦-嘉義,2024-05-07,9692
6005,群益證,77,5,72,富邦-嘉義,2024-05-07,9692
4967,十銓,1252,1186,66,富邦-嘉義,2024-05-07,9692
2323,中環,81,20,61,富邦-嘉義,2024-05-07,9692
2905,三商,60,0,60,富邦-嘉義,2024-05-07,9692
1219,福壽,60,0,60,富邦-嘉義,2024-05-07,9692
1514,亞力,343,286,57,富邦-嘉義,2024-05-07,9692
2489,瑞軒,57,0,57,富邦-嘉義,2024-05-07,9692
1303,南亞,58,1,57,富邦-嘉義,2024-05-07,9692
6596,寬宏藝術,56,0,56,富邦-嘉義,2024-05-07,9692
2511,太子,68,15,53,富邦-嘉義,2024-05-07,9692
2547,日勝生,54,2,52,富邦-嘉義,2024-05-07,9692
00945B,凱基美國非投等債,51,0,51,富邦-嘉義,2024-05-07,9692
4760,勤凱,106,55,51,富邦-嘉義,2024-05-07,9692
3033,威健,122,73,49,富邦-嘉義,2024-05-07,9692
8071,能率網通,49,1,48,富邦-嘉義,2024-05-07,9692
2401,凌陽,53,6,47,富邦-嘉義,2024-05-07,9692
5498,凱崴,67,20,47,富邦-嘉義,2024-05-07,9692
5880,合庫金,50,3,47,富邦-嘉義,2024-05-07,9692
6143,振曜,55,14,41,富邦-嘉義,2024-05-07,9692
2888,新光金,83,42,41,富邦-嘉義,2024-05-07,9692
1616,億泰,112,74,38,富邦-嘉義,2024-05-07,9692
00919,群益台灣精選高息,59,21,38,富邦-嘉義,2024-05-07,9692
2883,凱基金,52,15,37,富邦-嘉義,2024-05-07,9692
1717,長興,37,1,36,富邦-嘉義,2024-05-07,9692
00632R,元大台灣50反1,876,12,864,富邦-嘉義,2024-05-08,9692
2317,鴻海,1806,1265,541,富邦-嘉義,2024-05-08,9692
2605,新興,1360,1057,303,富邦-嘉義,2024-05-08,9692
2313,華通,295,19,276,富邦-嘉義,2024-05-08,9692
2606,裕民,1334,1100,234,富邦-嘉義,2024-05-08,9692
2515,中工,358,195,163,富邦-嘉義,2024-05-08,9692
1314,中石化,188,66,122,富邦-嘉義,2024-05-08,9692
3481,群創,116,1,115,富邦-嘉義,2024-05-08,9692
00929,復華台灣科技優息,138,33,105,富邦-嘉義,2024-05-08,9692
6213,聯茂,157,56,101,富邦-嘉義,2024-05-08,9692
00945B,凱基美國非投等債,91,0,91,富邦-嘉義,2024-05-08,9692
00665L,富邦�琤肭磪囓�2,122,33,89,富邦-嘉義,2024-05-08,9692
8071,能率網通,81,4,77,富邦-嘉義,2024-05-08,9692
5871,中租-KY,78,3,75,富邦-嘉義,2024-05-08,9692
6207,雷科,145,78,67,富邦-嘉義,2024-05-08,9692
2618,長榮航,175,109,66,富邦-嘉義,2024-05-08,9692
2534,宏盛,68,3,65,富邦-嘉義,2024-05-08,9692
6189,豐藝,83,22,61,富邦-嘉義,2024-05-08,9692
3609,三一東林,65,5,60,富邦-嘉義,2024-05-08,9692
4533,協易機,64,9,55,富邦-嘉義,2024-05-08,9692
00680L,元大美債20正2,61,6,55,富邦-嘉義,2024-05-08,9692
2101,南港,66,13,53,富邦-嘉義,2024-05-08,9692
1219,福壽,50,0,50,富邦-嘉義,2024-05-08,9692
1612,宏泰,253,203,50,富邦-嘉義,2024-05-08,9692
1582,信錦,48,4,44,富邦-嘉義,2024-05-08,9692
3060,銘異,50,9,41,富邦-嘉義,2024-05-08,9692
2014,中鴻,40,1,39,富邦-嘉義,2024-05-08,9692
2002,中鋼,46,8,38,富邦-嘉義,2024-05-08,9692
6005,群益證,75,39,36,富邦-嘉義,2024-05-08,9692
5009,榮剛,38,2,36,富邦-嘉義,2024-05-08,9692
00679B,元大美債20年,54,19,35,富邦-嘉義,2024-05-08,9692
2376,技嘉,60,25,35,富邦-嘉義,2024-05-08,9692
00933B,國泰10Y+金融債,38,3,35,富邦-嘉義,2024-05-08,9692
1101,台泥,48,14,34,富邦-嘉義,2024-05-08,9692
2634,漢翔,126,93,33,富邦-嘉義,2024-05-08,9692
3036,文曄,36,5,31,富邦-嘉義,2024-05-08,9692
3044,健鼎,148,117,31,富邦-嘉義,2024-05-08,9692
00764B,群益25年美債,30,0,30,富邦-嘉義,2024-05-08,9692
912000,晨訊科-DR,30,0,30,富邦-嘉義,2024-05-08,9692
2603,長榮,58,28,30,富邦-嘉義,2024-05-08,9692
5258,虹堡,29,2,27,富邦-嘉義,2024-05-08,9692
2887,台新金,39,12,27,富邦-嘉義,2024-05-08,9692
2845,遠東銀,26,0,26,富邦-嘉義,2024-05-08,9692
2506,太設,27,1,26,富邦-嘉義,2024-05-08,9692
1464,得力,25,0,25,富邦-嘉義,2024-05-08,9692
4542,科嶠,30,7,23,富邦-嘉義,2024-05-08,9692
2486,一詮,158,135,23,富邦-嘉義,2024-05-08,9692
1717,長興,22,0,22,富邦-嘉義,2024-05-08,9692
1326,台化,26,4,22,富邦-嘉義,2024-05-08,9692
1532,勤美,27,6,21,富邦-嘉義,2024-05-08,9692
2610,華航,324,30,294,富邦-嘉義,2024-05-09,9692
00929,復華台灣科技優息,255,6,249,富邦-嘉義,2024-05-09,9692
00940,元大台灣價值高息,188,10,178,富邦-嘉義,2024-05-09,9692
00944,野村趨勢動能高息,221,47,174,富邦-嘉義,2024-05-09,9692
00946,群益科技高息成長,217,44,173,富邦-嘉義,2024-05-09,9692
00937B,群益ESG投等債20,171,0,171,富邦-嘉義,2024-05-09,9692
3564,其陽,188,29,159,富邦-嘉義,2024-05-09,9692
4714,永捷,157,2,155,富邦-嘉義,2024-05-09,9692
1316,上曜,152,27,125,富邦-嘉義,2024-05-09,9692
2618,長榮航,230,107,123,富邦-嘉義,2024-05-09,9692
2609,陽明,3542,3434,108,富邦-嘉義,2024-05-09,9692
3231,緯創,2424,2318,106,富邦-嘉義,2024-05-09,9692
2344,華邦電,102,0,102,富邦-嘉義,2024-05-09,9692
2838A,聯邦銀甲特,100,0,100,富邦-嘉義,2024-05-09,9692
00679B,元大美債20年,106,7,99,富邦-嘉義,2024-05-09,9692
6770,力積電,142,44,98,富邦-嘉義,2024-05-09,9692
1314,中石化,156,64,92,富邦-嘉義,2024-05-09,9692
00665L,富邦�琤肭磪囓�2,122,31,91,富邦-嘉義,2024-05-09,9692
2328,廣宇,75,1,74,富邦-嘉義,2024-05-09,9692
2008,高興昌,134,62,72,富邦-嘉義,2024-05-09,9692
00878,國泰永續高股息,239,168,71,富邦-嘉義,2024-05-09,9692
4558,寶緯,70,1,69,富邦-嘉義,2024-05-09,9692
00632R,元大台灣50反1,79,22,57,富邦-嘉義,2024-05-09,9692
2367,燿華,761,706,55,富邦-嘉義,2024-05-09,9692
00715L,期街口布蘭特正2,50,0,50,富邦-嘉義,2024-05-09,9692
9105,泰金寶-DR,50,0,50,富邦-嘉義,2024-05-09,9692
2371,大同,1466,1417,49,富邦-嘉義,2024-05-09,9692
1815,富喬,114,67,47,富邦-嘉義,2024-05-09,9692
3324,雙鴻,53,7,46,富邦-嘉義,2024-05-09,9692
4562,穎漢,82,38,44,富邦-嘉義,2024-05-09,9692
2834,臺企銀,70,27,43,富邦-嘉義,2024-05-09,9692
3005,神基,51,9,42,富邦-嘉義,2024-05-09,9692
3013,晟銘電,326,286,40,富邦-嘉義,2024-05-09,9692
2515,中工,102,63,39,富邦-嘉義,2024-05-09,9692
5871,中租-KY,42,5,37,富邦-嘉義,2024-05-09,9692
8110,華東,36,0,36,富邦-嘉義,2024-05-09,9692
2025,千興,45,9,36,富邦-嘉義,2024-05-09,9692
00687B,國泰20年美債,36,0,36,富邦-嘉義,2024-05-09,9692
3036,文曄,44,9,35,富邦-嘉義,2024-05-09,9692
1325,恆大,35,0,35,富邦-嘉義,2024-05-09,9692
4909,新復興,52,17,35,富邦-嘉義,2024-05-09,9692
00882,中信中國高股息,100,65,35,富邦-嘉義,2024-05-09,9692
5351,鈺創,40,6,34,富邦-嘉義,2024-05-09,9692
1101,台泥,44,10,34,富邦-嘉義,2024-05-09,9692
3006,晶豪科,35,2,33,富邦-嘉義,2024-05-09,9692
2511,太子,33,1,32,富邦-嘉義,2024-05-09,9692
00751B,元大AAA至A公司債,32,0,32,富邦-嘉義,2024-05-09,9692
00932,兆豐永續高息等權,30,0,30,富邦-嘉義,2024-05-09,9692
1587,吉茂,94,64,30,富邦-嘉義,2024-05-09,9692
5498,凱崴,28,1,27,富邦-嘉義,2024-05-09,9692
2313,華通,841,136,705,富邦-嘉義,2024-05-10,9692
00929,復華台灣科技優息,693,57,636,富邦-嘉義,2024-05-10,9692
2615,萬海,2665,2207,458,富邦-嘉義,2024-05-10,9692
3481,群創,386,12,374,富邦-嘉義,2024-05-10,9692
00946,群益科技高息成長,264,16,248,富邦-嘉義,2024-05-10,9692
2241,艾姆勒,209,32,177,富邦-嘉義,2024-05-10,9692
1612,宏泰,233,67,166,富邦-嘉義,2024-05-10,9692
2406,國碩,152,28,124,富邦-嘉義,2024-05-10,9692
8070,長華*,102,3,99,富邦-嘉義,2024-05-10,9692
3563,牧德,84,4,80,富邦-嘉義,2024-05-10,9692
00937B,群益ESG投等債20,111,31,80,富邦-嘉義,2024-05-10,9692
3501,維熹,76,0,76,富邦-嘉義,2024-05-10,9692
2371,大同,87,12,75,富邦-嘉義,2024-05-10,9692
2537,聯上發,71,2,69,富邦-嘉義,2024-05-10,9692
00753L,中信中國50正2,81,13,68,富邦-嘉義,2024-05-10,9692
8033,雷虎,74,14,60,富邦-嘉義,2024-05-10,9692
00679B,元大美債20年,62,4,58,富邦-嘉義,2024-05-10,9692
3303,岱稜,163,112,51,富邦-嘉義,2024-05-10,9692
2362,藍天,51,3,48,富邦-嘉義,2024-05-10,9692
8112,至上,102,55,47,富邦-嘉義,2024-05-10,9692
00751B,元大AAA至A公司債,83,38,45,富邦-嘉義,2024-05-10,9692
2409,友達,126,82,44,富邦-嘉義,2024-05-10,9692
1446,宏和,126,83,43,富邦-嘉義,2024-05-10,9692
1618,合機,58,16,42,富邦-嘉義,2024-05-10,9692
2359,所羅門,99,59,40,富邦-嘉義,2024-05-10,9692
4967,十銓,318,281,37,富邦-嘉義,2024-05-10,9692
2352,佳世達,45,8,37,富邦-嘉義,2024-05-10,9692
1608,華榮,56,22,34,富邦-嘉義,2024-05-10,9692
2636,台驊控股,142,108,34,富邦-嘉義,2024-05-10,9692
9933,中鼎,33,3,30,富邦-嘉義,2024-05-10,9692
00734B,台新JPM新興債,30,0,30,富邦-嘉義,2024-05-10,9692
00711B,復華彭博新興債,30,0,30,富邦-嘉義,2024-05-10,9692
1815,富喬,86,56,30,富邦-嘉義,2024-05-10,9692
6770,力積電,33,5,28,富邦-嘉義,2024-05-10,9692
6283,淳安,45,17,28,富邦-嘉義,2024-05-10,9692
2405,輔信,29,2,27,富邦-嘉義,2024-05-10,9692
3019,亞光,26,0,26,富邦-嘉義,2024-05-10,9692
3706,神達,50,25,25,富邦-嘉義,2024-05-10,9692
3313,斐成,25,0,25,富邦-嘉義,2024-05-10,9692
8150,南茂,26,1,25,富邦-嘉義,2024-05-10,9692
3576,聯合再生,144,120,24,富邦-嘉義,2024-05-10,9692
3013,晟銘電,478,455,23,富邦-嘉義,2024-05-10,9692
6026,福邦證,48,25,23,富邦-嘉義,2024-05-10,9692
1609,大亞,68,46,22,富邦-嘉義,2024-05-10,9692
4909,新復興,42,20,22,富邦-嘉義,2024-05-10,9692
3088,艾訊,22,0,22,富邦-嘉義,2024-05-10,9692
00715L,期街口布蘭特正2,21,0,21,富邦-嘉義,2024-05-10,9692
00864B,中信美國公債0-1,20,0,20,富邦-嘉義,2024-05-10,9692
4533,協易機,38,18,20,富邦-嘉義,2024-05-10,9692
8096,擎亞,37,18,19,富邦-嘉義,2024-05-10,9692
00940,元大台灣價值高息,560,68,492,富邦-嘉義,2024-05-13,9692
00929,復華台灣科技優息,521,50,471,富邦-嘉義,2024-05-13,9692
2374,佳能,1009,716,293,富邦-嘉義,2024-05-13,9692
3047,訊舟,464,236,228,富邦-嘉義,2024-05-13,9692
00878,國泰永續高股息,280,54,226,富邦-嘉義,2024-05-13,9692
00937B,群益ESG投等債20,215,38,177,富邦-嘉義,2024-05-13,9692
2609,陽明,4234,4066,168,富邦-嘉義,2024-05-13,9692
1522,堤維西,329,165,164,富邦-嘉義,2024-05-13,9692
00632R,元大台灣50反1,163,6,157,富邦-嘉義,2024-05-13,9692
00679B,元大美債20年,126,0,126,富邦-嘉義,2024-05-13,9692
3481,群創,139,21,118,富邦-嘉義,2024-05-13,9692
2313,華通,153,43,110,富邦-嘉義,2024-05-13,9692
2362,藍天,628,522,106,富邦-嘉義,2024-05-13,9692
00637L,元大滬深300正2,112,7,105,富邦-嘉義,2024-05-13,9692
3234,光環,95,3,92,富邦-嘉義,2024-05-13,9692
00650L,復華香港正2,99,9,90,富邦-嘉義,2024-05-13,9692
2615,萬海,3304,3225,79,富邦-嘉義,2024-05-13,9692
2801,彰銀,75,0,75,富邦-嘉義,2024-05-13,9692
3231,緯創,117,46,71,富邦-嘉義,2024-05-13,9692
2613,中櫃,891,824,67,富邦-嘉義,2024-05-13,9692
2611,志信,145,83,62,富邦-嘉義,2024-05-13,9692
2392,正崴,79,18,61,富邦-嘉義,2024-05-13,9692
8096,擎亞,71,13,58,富邦-嘉義,2024-05-13,9692
2891,中信金,68,13,55,富邦-嘉義,2024-05-13,9692
2359,所羅門,109,54,55,富邦-嘉義,2024-05-13,9692
00918,大華優利高填息30,53,0,53,富邦-嘉義,2024-05-13,9692
2641,正德,82,30,52,富邦-嘉義,2024-05-13,9692
6770,力積電,57,6,51,富邦-嘉義,2024-05-13,9692
8150,南茂,44,1,43,富邦-嘉義,2024-05-13,9692
1101,台泥,137,94,43,富邦-嘉義,2024-05-13,9692
2356,英業達,73,31,42,富邦-嘉義,2024-05-13,9692
00944,野村趨勢動能高息,42,0,42,富邦-嘉義,2024-05-13,9692
3563,牧德,51,9,42,富邦-嘉義,2024-05-13,9692
00687B,國泰20年美債,46,5,41,富邦-嘉義,2024-05-13,9692
4123,晟德,44,7,37,富邦-嘉義,2024-05-13,9692
5608,四維航,69,33,36,富邦-嘉義,2024-05-13,9692
00919,群益台灣精選高息,40,4,36,富邦-嘉義,2024-05-13,9692
2029,盛餘,35,0,35,富邦-嘉義,2024-05-13,9692
3031,佰鴻,35,1,34,富邦-嘉義,2024-05-13,9692
3520,華盈,84,52,32,富邦-嘉義,2024-05-13,9692
2547,日勝生,40,9,31,富邦-嘉義,2024-05-13,9692
1314,中石化,52,22,30,富邦-嘉義,2024-05-13,9692
00936,台新永續高息中小,29,0,29,富邦-嘉義,2024-05-13,9692
00715L,期街口布蘭特正2,29,0,29,富邦-嘉義,2024-05-13,9692
4961,天鈺,30,1,29,富邦-嘉義,2024-05-13,9692
00676R,富邦臺灣加權反1,28,0,28,富邦-嘉義,2024-05-13,9692
00665L,富邦�琤肭磪囓�2,42,15,27,富邦-嘉義,2024-05-13,9692
1104,環泥,66,40,26,富邦-嘉義,2024-05-13,9692
6425,易發,66,40,26,富邦-嘉義,2024-05-13,9692
2506,太設,31,5,26,富邦-嘉義,2024-05-13,9692
2317,鴻海,5604,2547,3057,富邦-嘉義,2024-05-14,9692
2406,國碩,448,42,406,富邦-嘉義,2024-05-14,9692
00940,元大台灣價值高息,466,99,367,富邦-嘉義,2024-05-14,9692
00929,復華台灣科技優息,335,146,189,富邦-嘉義,2024-05-14,9692
6753,龍德造船,203,17,186,富邦-嘉義,2024-05-14,9692
00878,國泰永續高股息,241,75,166,富邦-嘉義,2024-05-14,9692
00937B,群益ESG投等債20,148,2,146,富邦-嘉義,2024-05-14,9692
5392,能率,223,86,137,富邦-嘉義,2024-05-14,9692
6213,聯茂,114,6,108,富邦-嘉義,2024-05-14,9692
1101,台泥,100,4,96,富邦-嘉義,2024-05-14,9692
2476,鉅祥,204,115,89,富邦-嘉義,2024-05-14,9692
00933B,國泰10Y+金融債,98,11,87,富邦-嘉義,2024-05-14,9692
2362,藍天,673,588,85,富邦-嘉義,2024-05-14,9692
00720B,元大投資級公司債,82,0,82,富邦-嘉義,2024-05-14,9692
3576,聯合再生,80,0,80,富邦-嘉義,2024-05-14,9692
1725,元禎,101,27,74,富邦-嘉義,2024-05-14,9692
00679B,元大美債20年,84,11,73,富邦-嘉義,2024-05-14,9692
2405,輔信,174,107,67,富邦-嘉義,2024-05-14,9692
3481,群創,75,9,66,富邦-嘉義,2024-05-14,9692
5009,榮剛,104,39,65,富邦-嘉義,2024-05-14,9692
00637L,元大滬深300正2,66,1,65,富邦-嘉義,2024-05-14,9692
2376,技嘉,75,10,65,富邦-嘉義,2024-05-14,9692
2603,長榮,3037,2979,58,富邦-嘉義,2024-05-14,9692
1104,環泥,58,0,58,富邦-嘉義,2024-05-14,9692
3231,緯創,71,14,57,富邦-嘉義,2024-05-14,9692
00665L,富邦�琤肭磪囓�2,59,4,55,富邦-嘉義,2024-05-14,9692
3706,神達,124,70,54,富邦-嘉義,2024-05-14,9692
00772B,中信高評級公司債,51,0,51,富邦-嘉義,2024-05-14,9692
2349,錸德,50,0,50,富邦-嘉義,2024-05-14,9692
4562,穎漢,106,61,45,富邦-嘉義,2024-05-14,9692
4960,誠美材,45,1,44,富邦-嘉義,2024-05-14,9692
2485,兆赫,44,0,44,富邦-嘉義,2024-05-14,9692
00941,中信上游半導體,48,5,43,富邦-嘉義,2024-05-14,9692
00944,野村趨勢動能高息,43,0,43,富邦-嘉義,2024-05-14,9692
2359,所羅門,585,542,43,富邦-嘉義,2024-05-14,9692
00713,元大台灣高息低波,43,0,43,富邦-嘉義,2024-05-14,9692
00712,復華富時不動產,42,1,41,富邦-嘉義,2024-05-14,9692
6770,力積電,66,27,39,富邦-嘉義,2024-05-14,9692
1722,台肥,36,0,36,富邦-嘉義,2024-05-14,9692
2630,亞航,159,126,33,富邦-嘉義,2024-05-14,9692
00751B,元大AAA至A公司債,32,1,31,富邦-嘉義,2024-05-14,9692
2534,宏盛,30,0,30,富邦-嘉義,2024-05-14,9692
8150,南茂,29,0,29,富邦-嘉義,2024-05-14,9692
2027,大成鋼,28,0,28,富邦-嘉義,2024-05-14,9692
2641,正德,39,13,26,富邦-嘉義,2024-05-14,9692
2882,國泰金,33,7,26,富邦-嘉義,2024-05-14,9692
6442,光聖,51,26,25,富邦-嘉義,2024-05-14,9692
5871,中租-KY,26,3,23,富邦-嘉義,2024-05-14,9692
2891,中信金,30,8,22,富邦-嘉義,2024-05-14,9692
6215,和椿,259,237,22,富邦-嘉義,2024-05-14,9692
2365,昆盈,1512,524,988,富邦-嘉義,2024-05-15,9692
2374,佳能,1586,1051,535,富邦-嘉義,2024-05-15,9692
8096,擎亞,1705,1233,472,富邦-嘉義,2024-05-15,9692
4533,協易機,374,33,341,富邦-嘉義,2024-05-15,9692
9945,潤泰新,314,98,216,富邦-嘉義,2024-05-15,9692
2241,艾姆勒,284,69,215,富邦-嘉義,2024-05-15,9692
2359,所羅門,431,223,208,富邦-嘉義,2024-05-15,9692
2836,高雄銀,205,1,204,富邦-嘉義,2024-05-15,9692
5392,能率,574,376,198,富邦-嘉義,2024-05-15,9692
00946,群益科技高息成長,215,22,193,富邦-嘉義,2024-05-15,9692
6005,群益證,201,8,193,富邦-嘉義,2024-05-15,9692
3363,上詮,465,325,140,富邦-嘉義,2024-05-15,9692
00937B,群益ESG投等債20,370,254,116,富邦-嘉義,2024-05-15,9692
3047,訊舟,491,380,111,富邦-嘉義,2024-05-15,9692
2743,山富,105,1,104,富邦-嘉義,2024-05-15,9692
2323,中環,161,58,103,富邦-嘉義,2024-05-15,9692
00680L,元大美債20正2,126,24,102,富邦-嘉義,2024-05-15,9692
00878,國泰永續高股息,181,88,93,富邦-嘉義,2024-05-15,9692
1587,吉茂,112,19,93,富邦-嘉義,2024-05-15,9692
2382,廣達,504,418,86,富邦-嘉義,2024-05-15,9692
2618,長榮航,137,51,86,富邦-嘉義,2024-05-15,9692
00665L,富邦�琤肭磪囓�2,84,0,84,富邦-嘉義,2024-05-15,9692
2303,聯電,116,37,79,富邦-嘉義,2024-05-15,9692
00919,群益台灣精選高息,108,29,79,富邦-嘉義,2024-05-15,9692
4414,如興,114,40,74,富邦-嘉義,2024-05-15,9692
00933B,國泰10Y+金融債,128,64,64,富邦-嘉義,2024-05-15,9692
2515,中工,69,6,63,富邦-嘉義,2024-05-15,9692
2486,一詮,103,42,61,富邦-嘉義,2024-05-15,9692
00929,復華台灣科技優息,127,66,61,富邦-嘉義,2024-05-15,9692
00679B,元大美債20年,63,6,57,富邦-嘉義,2024-05-15,9692
2905,三商,66,10,56,富邦-嘉義,2024-05-15,9692
6443,元晶,147,95,52,富邦-嘉義,2024-05-15,9692
1609,大亞,77,25,52,富邦-嘉義,2024-05-15,9692
2852,第一保,50,0,50,富邦-嘉義,2024-05-15,9692
00671R,富邦NASDAQ反1,50,0,50,富邦-嘉義,2024-05-15,9692
2332,友訊,49,0,49,富邦-嘉義,2024-05-15,9692
3060,銘異,80,33,47,富邦-嘉義,2024-05-15,9692
4127,天良,45,2,43,富邦-嘉義,2024-05-15,9692
00676R,富邦臺灣加權反1,42,1,41,富邦-嘉義,2024-05-15,9692
1537,廣隆,40,0,40,富邦-嘉義,2024-05-15,9692
5512,力麒,47,10,37,富邦-嘉義,2024-05-15,9692
2351,順德,73,37,36,富邦-嘉義,2024-05-15,9692
3481,群創,76,40,36,富邦-嘉義,2024-05-15,9692
1722,台肥,36,0,36,富邦-嘉義,2024-05-15,9692
00632R,元大台灣50反1,361,328,33,富邦-嘉義,2024-05-15,9692
2331,精英,373,341,32,富邦-嘉義,2024-05-15,9692
2025,千興,31,0,31,富邦-嘉義,2024-05-15,9692
9919,康那香,24,0,24,富邦-嘉義,2024-05-15,9692
1524,耿鼎,31,7,24,富邦-嘉義,2024-05-15,9692
3163,波若威,68,46,22,富邦-嘉義,2024-05-15,9692
2489,瑞軒,939,143,796,富邦-嘉義,2024-05-16,9692
1455,集盛,412,26,386,富邦-嘉義,2024-05-16,9692
6005,群益證,304,59,245,富邦-嘉義,2024-05-16,9692
5392,能率,759,566,193,富邦-嘉義,2024-05-16,9692
2323,中環,568,377,191,富邦-嘉義,2024-05-16,9692
2332,友訊,165,15,150,富邦-嘉義,2024-05-16,9692
00937B,群益ESG投等債20,262,132,130,富邦-嘉義,2024-05-16,9692
9902,台火,259,135,124,富邦-嘉義,2024-05-16,9692
00878,國泰永續高股息,343,227,116,富邦-嘉義,2024-05-16,9692
2356,英業達,134,20,114,富邦-嘉義,2024-05-16,9692
00632R,元大台灣50反1,163,50,113,富邦-嘉義,2024-05-16,9692
00680L,元大美債20正2,121,20,101,富邦-嘉義,2024-05-16,9692
3231,緯創,697,596,101,富邦-嘉義,2024-05-16,9692
8071,能率網通,429,329,100,富邦-嘉義,2024-05-16,9692
2852,第一保,100,0,100,富邦-嘉義,2024-05-16,9692
8358,金居,323,225,98,富邦-嘉義,2024-05-16,9692
00933B,國泰10Y+金融債,142,51,91,富邦-嘉義,2024-05-16,9692
9105,泰金寶-DR,103,13,90,富邦-嘉義,2024-05-16,9692
00751B,元大AAA至A公司債,101,15,86,富邦-嘉義,2024-05-16,9692
3260,威剛,104,19,85,富邦-嘉義,2024-05-16,9692
2855,統一證,85,0,85,富邦-嘉義,2024-05-16,9692
2417,圓剛,130,49,81,富邦-嘉義,2024-05-16,9692
00676R,富邦臺灣加權反1,90,20,70,富邦-嘉義,2024-05-16,9692
2836,高雄銀,65,1,64,富邦-嘉義,2024-05-16,9692
2615,萬海,376,312,64,富邦-嘉義,2024-05-16,9692
2915,潤泰全,137,76,61,富邦-嘉義,2024-05-16,9692
00946,群益科技高息成長,74,19,55,富邦-嘉義,2024-05-16,9692
00929,復華台灣科技優息,160,106,54,富邦-嘉義,2024-05-16,9692
2348,海悅,54,0,54,富邦-嘉義,2024-05-16,9692
3060,銘異,596,543,53,富邦-嘉義,2024-05-16,9692
1524,耿鼎,52,0,52,富邦-嘉義,2024-05-16,9692
2363,矽統,85,41,44,富邦-嘉義,2024-05-16,9692
5469,瀚宇博,48,4,44,富邦-嘉義,2024-05-16,9692
00945B,凱基美國非投等債,56,12,44,富邦-嘉義,2024-05-16,9692
2401,凌陽,46,5,41,富邦-嘉義,2024-05-16,9692
2731,雄獅,47,12,35,富邦-嘉義,2024-05-16,9692
2049,上銀,35,0,35,富邦-嘉義,2024-05-16,9692
00753L,中信中國50正2,52,20,32,富邦-嘉義,2024-05-16,9692
1612,宏泰,40,9,31,富邦-嘉義,2024-05-16,9692
00633L,富邦上証正2,30,0,30,富邦-嘉義,2024-05-16,9692
1785,光洋科,35,6,29,富邦-嘉義,2024-05-16,9692
3390,旭軟,83,54,29,富邦-嘉義,2024-05-16,9692
9934,成霖,28,1,27,富邦-嘉義,2024-05-16,9692
9905,大華,27,0,27,富邦-嘉義,2024-05-16,9692
6285,啟��,52,25,27,富邦-嘉義,2024-05-16,9692
8110,華東,54,29,25,富邦-嘉義,2024-05-16,9692
3706,神達,33,8,25,富邦-嘉義,2024-05-16,9692
4952,凌通,23,0,23,富邦-嘉義,2024-05-16,9692
3376,新日興,36,13,23,富邦-嘉義,2024-05-16,9692
8150,南茂,21,0,21,富邦-嘉義,2024-05-16,9692
4533,協易機,827,198,629,富邦-嘉義,2024-05-17,9692
2313,華通,356,8,348,富邦-嘉義,2024-05-17,9692
00929,復華台灣科技優息,339,51,288,富邦-嘉義,2024-05-17,9692
00940,元大台灣價值高息,351,108,243,富邦-嘉義,2024-05-17,9692
3481,群創,208,4,204,富邦-嘉義,2024-05-17,9692
00751B,元大AAA至A公司債,183,4,179,富邦-嘉義,2024-05-17,9692
2609,陽明,448,276,172,富邦-嘉義,2024-05-17,9692
6215,和椿,755,597,158,富邦-嘉義,2024-05-17,9692
4976,佳凌,250,97,153,富邦-嘉義,2024-05-17,9692
1314,中石化,151,18,133,富邦-嘉義,2024-05-17,9692
00679B,元大美債20年,135,13,122,富邦-嘉義,2024-05-17,9692
6770,力積電,134,17,117,富邦-嘉義,2024-05-17,9692
2514,龍邦,122,8,114,富邦-嘉義,2024-05-17,9692
2317,鴻海,1858,1745,113,富邦-嘉義,2024-05-17,9692
8096,擎亞,204,96,108,富邦-嘉義,2024-05-17,9692
00919,群益台灣精選高息,128,22,106,富邦-嘉義,2024-05-17,9692
6125,廣運,130,37,93,富邦-嘉義,2024-05-17,9692
2392,正崴,152,62,90,富邦-嘉義,2024-05-17,9692
3013,晟銘電,114,32,82,富邦-嘉義,2024-05-17,9692
2356,英業達,95,15,80,富邦-嘉義,2024-05-17,9692
2610,華航,256,182,74,富邦-嘉義,2024-05-17,9692
2467,志聖,144,72,72,富邦-嘉義,2024-05-17,9692
00946,群益科技高息成長,67,0,67,富邦-嘉義,2024-05-17,9692
2603,長榮,100,37,63,富邦-嘉義,2024-05-17,9692
3294,英濟,153,91,62,富邦-嘉義,2024-05-17,9692
5432,新門,86,26,60,富邦-嘉義,2024-05-17,9692
2801,彰銀,61,4,57,富邦-嘉義,2024-05-17,9692
4561,健椿,135,81,54,富邦-嘉義,2024-05-17,9692
00650L,復華香港正2,59,5,54,富邦-嘉義,2024-05-17,9692
00720B,元大投資級公司債,60,11,49,富邦-嘉義,2024-05-17,9692
8110,華東,47,1,46,富邦-嘉義,2024-05-17,9692
5469,瀚宇博,58,14,44,富邦-嘉義,2024-05-17,9692
00937B,群益ESG投等債20,86,42,44,富邦-嘉義,2024-05-17,9692
912000,晨訊科-DR,43,0,43,富邦-嘉義,2024-05-17,9692
1722,台肥,38,0,38,富邦-嘉義,2024-05-17,9692
2312,金寶,42,7,35,富邦-嘉義,2024-05-17,9692
1612,宏泰,88,53,35,富邦-嘉義,2024-05-17,9692
0055,元大MSCI金融,37,2,35,富邦-嘉義,2024-05-17,9692
3483,力致,105,71,34,富邦-嘉義,2024-05-17,9692
3312,弘憶股,782,750,32,富邦-嘉義,2024-05-17,9692
2323,中環,55,23,32,富邦-嘉義,2024-05-17,9692
1537,廣隆,30,0,30,富邦-嘉義,2024-05-17,9692
00633L,富邦上証正2,30,0,30,富邦-嘉義,2024-05-17,9692
2408,南亞科,41,12,29,富邦-嘉義,2024-05-17,9692
2605,新興,66,37,29,富邦-嘉義,2024-05-17,9692
3563,牧德,45,16,29,富邦-嘉義,2024-05-17,9692
3715,定穎投控,37,8,29,富邦-嘉義,2024-05-17,9692
5475,德宏,27,0,27,富邦-嘉義,2024-05-17,9692
00878,國泰永續高股息,222,196,26,富邦-嘉義,2024-05-17,9692
3231,緯創,44,18,26,富邦-嘉義,2024-05-17,9692
4960,誠美材,499,17,482,富邦-嘉義,2024-05-20,9692
00929,復華台灣科技優息,461,22,439,富邦-嘉義,2024-05-20,9692
00940,元大台灣價值高息,599,260,339,富邦-嘉義,2024-05-20,9692
4123,晟德,300,4,296,富邦-嘉義,2024-05-20,9692
2706,第一店,206,0,206,富邦-嘉義,2024-05-20,9692
00927,群益半導體收益,203,0,203,富邦-嘉義,2024-05-20,9692
8096,擎亞,249,55,194,富邦-嘉義,2024-05-20,9692
00915,凱基優選高股息30,183,6,177,富邦-嘉義,2024-05-20,9692
00751B,元大AAA至A公司債,165,1,164,富邦-嘉義,2024-05-20,9692
8071,能率網通,204,54,150,富邦-嘉義,2024-05-20,9692
00882,中信中國高股息,158,37,121,富邦-嘉義,2024-05-20,9692
00679B,元大美債20年,114,0,114,富邦-嘉義,2024-05-20,9692
2515,中工,109,5,104,富邦-嘉義,2024-05-20,9692
3609,三一東林,106,10,96,富邦-嘉義,2024-05-20,9692
1313,聯成,101,8,93,富邦-嘉義,2024-05-20,9692
00693U,期街口S＆P黃豆,75,0,75,富邦-嘉義,2024-05-20,9692
3031,佰鴻,70,1,69,富邦-嘉義,2024-05-20,9692
2317,鴻海,589,529,60,富邦-嘉義,2024-05-20,9692
5392,能率,167,113,54,富邦-嘉義,2024-05-20,9692
00720B,元大投資級公司債,56,5,51,富邦-嘉義,2024-05-20,9692
2880,華南金,66,20,46,富邦-嘉義,2024-05-20,9692
2897,王道銀行,54,8,46,富邦-嘉義,2024-05-20,9692
2367,燿華,212,167,45,富邦-嘉義,2024-05-20,9692
2349,錸德,47,3,44,富邦-嘉義,2024-05-20,9692
2603,長榮,562,519,43,富邦-嘉義,2024-05-20,9692
00676R,富邦臺灣加權反1,40,0,40,富邦-嘉義,2024-05-20,9692
2637,慧洋-KY,39,4,35,富邦-嘉義,2024-05-20,9692
00687B,國泰20年美債,46,12,34,富邦-嘉義,2024-05-20,9692
6016,康和證,54,20,34,富邦-嘉義,2024-05-20,9692
3338,泰碩,75,41,34,富邦-嘉義,2024-05-20,9692
1312,國喬,38,5,33,富邦-嘉義,2024-05-20,9692
3231,緯創,246,213,33,富邦-嘉義,2024-05-20,9692
1101,台泥,42,11,31,富邦-嘉義,2024-05-20,9692
1416,廣豐,30,0,30,富邦-嘉義,2024-05-20,9692
2838A,聯邦銀甲特,30,0,30,富邦-嘉義,2024-05-20,9692
1537,廣隆,30,1,29,富邦-嘉義,2024-05-20,9692
6446,藥華藥,38,10,28,富邦-嘉義,2024-05-20,9692
00878,國泰永續高股息,161,132,29,富邦-嘉義,2024-05-20,9692
00946,群益科技高息成長,39,11,28,富邦-嘉義,2024-05-20,9692
00772B,中信高評級公司債,25,0,25,富邦-嘉義,2024-05-20,9692
1217,愛之味,25,0,25,富邦-嘉義,2024-05-20,9692
8070,長華*,38,13,25,富邦-嘉義,2024-05-20,9692
2365,昆盈,38,14,24,富邦-嘉義,2024-05-20,9692
2329,華泰,125,101,24,富邦-嘉義,2024-05-20,9692
1587,吉茂,166,143,23,富邦-嘉義,2024-05-20,9692
912000,晨訊科-DR,23,0,23,富邦-嘉義,2024-05-20,9692
00919,群益台灣精選高息,138,115,23,富邦-嘉義,2024-05-20,9692
00864B,中信美國公債0-1,21,0,21,富邦-嘉義,2024-05-20,9692
2208,台船,26,5,21,富邦-嘉義,2024-05-20,9692
00944,野村趨勢動能高息,20,0,20,富邦-嘉義,2024-05-20,9692
2706,第一店,659,0,659,富邦-嘉義,2024-05-21,9692
2618,長榮航,660,297,363,富邦-嘉義,2024-05-21,9692
6188,廣明,1020,703,317,富邦-嘉義,2024-05-21,9692
2009,第一銅,573,301,272,富邦-嘉義,2024-05-21,9692
1809,中釉,233,3,230,富邦-嘉義,2024-05-21,9692
6125,廣運,682,489,193,富邦-嘉義,2024-05-21,9692
2888,新光金,291,104,187,富邦-嘉義,2024-05-21,9692
2374,佳能,790,643,147,富邦-嘉義,2024-05-21,9692
2359,所羅門,1111,970,141,富邦-嘉義,2024-05-21,9692
3013,晟銘電,1053,912,141,富邦-嘉義,2024-05-21,9692
00927,群益半導體收益,140,3,137,富邦-嘉義,2024-05-21,9692
2323,中環,132,1,131,富邦-嘉義,2024-05-21,9692
8071,能率網通,562,441,121,富邦-嘉義,2024-05-21,9692
4952,凌通,173,62,111,富邦-嘉義,2024-05-21,9692
6207,雷科,318,209,109,富邦-嘉義,2024-05-21,9692
5392,能率,427,320,107,富邦-嘉義,2024-05-21,9692
2880,華南金,106,0,106,富邦-嘉義,2024-05-21,9692
2382,廣達,113,7,106,富邦-嘉義,2024-05-21,9692
00878,國泰永續高股息,134,32,102,富邦-嘉義,2024-05-21,9692
2883,凱基金,109,9,100,富邦-嘉義,2024-05-21,9692
00937B,群益ESG投等債20,123,24,99,富邦-嘉義,2024-05-21,9692
2449,京元電子,105,7,98,富邦-嘉義,2024-05-21,9692
5475,德宏,111,28,83,富邦-嘉義,2024-05-21,9692
00940,元大台灣價值高息,116,33,83,富邦-嘉義,2024-05-21,9692
1752,南光,87,6,81,富邦-嘉義,2024-05-21,9692
2376,技嘉,84,5,79,富邦-嘉義,2024-05-21,9692
2409,友達,106,29,77,富邦-嘉義,2024-05-21,9692
3609,三一東林,89,13,76,富邦-嘉義,2024-05-21,9692
2489,瑞軒,153,77,76,富邦-嘉義,2024-05-21,9692
2356,英業達,118,42,76,富邦-嘉義,2024-05-21,9692
8110,華東,1098,1023,75,富邦-嘉義,2024-05-21,9692
2836,高雄銀,74,2,72,富邦-嘉義,2024-05-21,9692
6117,迎廣,135,64,71,富邦-嘉義,2024-05-21,9692
5432,新門,70,4,66,富邦-嘉義,2024-05-21,9692
1314,中石化,74,10,64,富邦-嘉義,2024-05-21,9692
5426,振發,491,428,63,富邦-嘉義,2024-05-21,9692
1587,吉茂,236,174,62,富邦-嘉義,2024-05-21,9692
4545,銘鈺,67,11,56,富邦-嘉義,2024-05-21,9692
1101,台泥,63,10,53,富邦-嘉義,2024-05-21,9692
2332,友訊,56,4,52,富邦-嘉義,2024-05-21,9692
00919,群益台灣精選高息,54,10,44,富邦-嘉義,2024-05-21,9692
00650L,復華香港正2,46,2,44,富邦-嘉義,2024-05-21,9692
6230,尼得科超眾,144,100,44,富邦-嘉義,2024-05-21,9692
4562,穎漢,91,49,42,富邦-嘉義,2024-05-21,9692
00687B,國泰20年美債,43,4,39,富邦-嘉義,2024-05-21,9692
00679B,元大美債20年,41,3,38,富邦-嘉義,2024-05-21,9692
2520,冠德,43,5,38,富邦-嘉義,2024-05-21,9692
6770,力積電,41,4,37,富邦-嘉義,2024-05-21,9692
1409,新纖,43,7,36,富邦-嘉義,2024-05-21,9692
2365,昆盈,324,288,36,富邦-嘉義,2024-05-21,9692
2609,陽明,1536,852,684,富邦-嘉義,2024-05-22,9692
5258,虹堡,612,17,595,富邦-嘉義,2024-05-22,9692
2353,宏��,4290,3877,413,富邦-嘉義,2024-05-22,9692
2392,正崴,442,162,280,富邦-嘉義,2024-05-22,9692
6209,今國光,890,616,274,富邦-嘉義,2024-05-22,9692
5443,均豪,305,78,227,富邦-嘉義,2024-05-22,9692
2365,昆盈,528,302,226,富邦-嘉義,2024-05-22,9692
00937B,群益ESG投等債20,245,44,201,富邦-嘉義,2024-05-22,9692
2453,凌群,290,115,175,富邦-嘉義,2024-05-22,9692
4127,天良,176,21,155,富邦-嘉義,2024-05-22,9692
2464,盟立,637,483,154,富邦-嘉義,2024-05-22,9692
2706,第一店,149,0,149,富邦-嘉義,2024-05-22,9692
2332,友訊,156,9,147,富邦-嘉義,2024-05-22,9692
3047,訊舟,410,269,141,富邦-嘉義,2024-05-22,9692
2618,長榮航,199,63,136,富邦-嘉義,2024-05-22,9692
00751B,元大AAA至A公司債,136,2,134,富邦-嘉義,2024-05-22,9692
4979,華星光,189,61,128,富邦-嘉義,2024-05-22,9692
00927,群益半導體收益,123,13,110,富邦-嘉義,2024-05-22,9692
6005,群益證,105,0,105,富邦-嘉義,2024-05-22,9692
6276,安鈦克,101,4,97,富邦-嘉義,2024-05-22,9692
5512,力麒,95,1,94,富邦-嘉義,2024-05-22,9692
2610,華航,133,41,92,富邦-嘉義,2024-05-22,9692
2002,中鋼,91,0,91,富邦-嘉義,2024-05-22,9692
2613,中櫃,195,113,82,富邦-嘉義,2024-05-22,9692
8374,羅昇,110,30,80,富邦-嘉義,2024-05-22,9692
1303,南亞,68,0,68,富邦-嘉義,2024-05-22,9692
1815,富喬,931,864,67,富邦-嘉義,2024-05-22,9692
4533,協易機,244,180,64,富邦-嘉義,2024-05-22,9692
2615,萬海,118,56,62,富邦-嘉義,2024-05-22,9692
1909,榮成,63,4,59,富邦-嘉義,2024-05-22,9692
5251,天鉞電,67,9,58,富邦-嘉義,2024-05-22,9692
2354,鴻準,77,23,54,富邦-嘉義,2024-05-22,9692
5880,合庫金,50,0,50,富邦-嘉義,2024-05-22,9692
2362,藍天,304,265,39,富邦-嘉義,2024-05-22,9692
5371,中光電,279,240,39,富邦-嘉義,2024-05-22,9692
6117,迎廣,132,94,38,富邦-嘉義,2024-05-22,9692
1609,大亞,40,5,35,富邦-嘉義,2024-05-22,9692
00946,群益科技高息成長,45,10,35,富邦-嘉義,2024-05-22,9692
5498,凱崴,481,447,34,富邦-嘉義,2024-05-22,9692
00936,台新永續高息中小,37,3,34,富邦-嘉義,2024-05-22,9692
8936,國統,44,11,33,富邦-嘉義,2024-05-22,9692
2504,國產,38,5,33,富邦-嘉義,2024-05-22,9692
3207,耀勝,34,2,32,富邦-嘉義,2024-05-22,9692
2344,華邦電,49,19,30,富邦-嘉義,2024-05-22,9692
2547,日勝生,30,0,30,富邦-嘉義,2024-05-22,9692
3057,喬鼎,32,2,30,富邦-嘉義,2024-05-22,9692
2887,台新金,30,1,29,富邦-嘉義,2024-05-22,9692
3686,達能,30,2,28,富邦-嘉義,2024-05-22,9692
1722,台肥,27,0,27,富邦-嘉義,2024-05-22,9692
00637L,元大滬深300正2,27,0,27,富邦-嘉義,2024-05-22,9692
1815,富喬,6664,1478,5186,富邦-嘉義,2024-05-23,9692
1810,和成,956,277,679,富邦-嘉義,2024-05-23,9692
3481,群創,769,106,663,富邦-嘉義,2024-05-23,9692
6125,廣運,1754,1105,649,富邦-嘉義,2024-05-23,9692
00937B,群益ESG投等債20,357,21,336,富邦-嘉義,2024-05-23,9692
00753L,中信中國50正2,339,16,323,富邦-嘉義,2024-05-23,9692
6117,迎廣,599,413,186,富邦-嘉義,2024-05-23,9692
3563,牧德,187,9,178,富邦-嘉義,2024-05-23,9692
00751B,元大AAA至A公司債,160,0,160,富邦-嘉義,2024-05-23,9692
00919,群益台灣精選高息,204,49,155,富邦-嘉義,2024-05-23,9692
2392,正崴,662,528,134,富邦-嘉義,2024-05-23,9692
2002,中鋼,131,4,127,富邦-嘉義,2024-05-23,9692
2615,萬海,172,49,123,富邦-嘉義,2024-05-23,9692
00720B,元大投資級公司債,116,1,115,富邦-嘉義,2024-05-23,9692
2014,中鴻,110,2,108,富邦-嘉義,2024-05-23,9692
2812,台中銀,108,5,103,富邦-嘉義,2024-05-23,9692
2301,光寶科,344,243,101,富邦-嘉義,2024-05-23,9692
2313,華通,204,106,98,富邦-嘉義,2024-05-23,9692
2515,中工,125,31,94,富邦-嘉義,2024-05-23,9692
6770,力積電,218,126,92,富邦-嘉義,2024-05-23,9692
00929,復華台灣科技優息,302,216,86,富邦-嘉義,2024-05-23,9692
2409,友達,105,19,86,富邦-嘉義,2024-05-23,9692
1802,台玻,123,42,81,富邦-嘉義,2024-05-23,9692
3535,晶彩科,137,58,79,富邦-嘉義,2024-05-23,9692
6188,廣明,557,485,72,富邦-嘉義,2024-05-23,9692
1314,中石化,170,100,70,富邦-嘉義,2024-05-23,9692
6213,聯茂,85,20,65,富邦-嘉義,2024-05-23,9692
1101,台泥,63,2,61,富邦-嘉義,2024-05-23,9692
6215,和椿,97,38,59,富邦-嘉義,2024-05-23,9692
6147,頎邦,59,1,58,富邦-嘉義,2024-05-23,9692
2371,大同,91,34,57,富邦-嘉義,2024-05-23,9692
00632R,元大台灣50反1,60,7,53,富邦-嘉義,2024-05-23,9692
8110,華東,53,1,52,富邦-嘉義,2024-05-23,9692
2851,中再保,51,0,51,富邦-嘉義,2024-05-23,9692
4707,磐亞,50,0,50,富邦-嘉義,2024-05-23,9692
2618,長榮航,150,100,50,富邦-嘉義,2024-05-23,9692
2363,矽統,104,56,48,富邦-嘉義,2024-05-23,9692
1608,華榮,56,10,46,富邦-嘉義,2024-05-23,9692
00715L,期街口布蘭特正2,61,15,46,富邦-嘉義,2024-05-23,9692
2359,所羅門,2594,2550,44,富邦-嘉義,2024-05-23,9692
1409,新纖,42,0,42,富邦-嘉義,2024-05-23,9692
3055,蔚華科,137,96,41,富邦-嘉義,2024-05-23,9692
2881,富邦金,46,6,40,富邦-嘉義,2024-05-23,9692
5871,中租-KY,40,1,39,富邦-嘉義,2024-05-23,9692
4908,前鼎,102,64,38,富邦-嘉義,2024-05-23,9692
4533,協易機,153,115,38,富邦-嘉義,2024-05-23,9692
2880,華南金,38,2,36,富邦-嘉義,2024-05-23,9692
6190,萬泰科,56,21,35,富邦-嘉義,2024-05-23,9692
8089,康全電訊,40,5,35,富邦-嘉義,2024-05-23,9692
00719B,元大美債1-3,34,0,34,富邦-嘉義,2024-05-23,9692
3047,訊舟,938,469,469,富邦-嘉義,2024-05-24,9692
2489,瑞軒,1591,1128,463,富邦-嘉義,2024-05-24,9692
6125,廣運,756,327,429,富邦-嘉義,2024-05-24,9692
2867,三商壽,494,84,410,富邦-嘉義,2024-05-24,9692
2353,宏��,1257,984,273,富邦-嘉義,2024-05-24,9692
1314,中石化,289,16,273,富邦-嘉義,2024-05-24,9692
5498,凱崴,549,293,256,富邦-嘉義,2024-05-24,9692
2609,陽明,419,194,225,富邦-嘉義,2024-05-24,9692
00937B,群益ESG投等債20,259,39,220,富邦-嘉義,2024-05-24,9692
3338,泰碩,754,535,219,富邦-嘉義,2024-05-24,9692
00712,復華富時不動產,215,4,211,富邦-嘉義,2024-05-24,9692
3450,聯鈞,335,151,184,富邦-嘉義,2024-05-24,9692
2615,萬海,457,290,167,富邦-嘉義,2024-05-24,9692
00753L,中信中國50正2,136,6,130,富邦-嘉義,2024-05-24,9692
00946,群益科技高息成長,129,0,129,富邦-嘉義,2024-05-24,9692
2323,中環,110,3,107,富邦-嘉義,2024-05-24,9692
5258,虹堡,100,0,100,富邦-嘉義,2024-05-24,9692
2618,長榮航,163,83,80,富邦-嘉義,2024-05-24,9692
00665L,富邦�琤肭磪囓�2,83,5,78,富邦-嘉義,2024-05-24,9692
2891,中信金,78,3,75,富邦-嘉義,2024-05-24,9692
2027,大成鋼,78,5,73,富邦-嘉義,2024-05-24,9692
6770,力積電,81,9,72,富邦-嘉義,2024-05-24,9692
2506,太設,66,0,66,富邦-嘉義,2024-05-24,9692
8028,昇陽半導體,163,101,62,富邦-嘉義,2024-05-24,9692
2250,IKKA-KY,62,1,61,富邦-嘉義,2024-05-24,9692
5488,松普,57,0,57,富邦-嘉義,2024-05-24,9692
4545,銘鈺,56,2,54,富邦-嘉義,2024-05-24,9692
1516,川飛,58,5,53,富邦-嘉義,2024-05-24,9692
1313,聯成,51,0,51,富邦-嘉義,2024-05-24,9692
2515,中工,67,18,49,富邦-嘉義,2024-05-24,9692
2892,第一金,49,6,43,富邦-嘉義,2024-05-24,9692
6147,頎邦,45,2,43,富邦-嘉義,2024-05-24,9692
00632R,元大台灣50反1,54,13,41,富邦-嘉義,2024-05-24,9692
2317,鴻海,1184,1144,40,富邦-嘉義,2024-05-24,9692
2303,聯電,101,61,40,富邦-嘉義,2024-05-24,9692
00919,群益台灣精選高息,59,20,39,富邦-嘉義,2024-05-24,9692
3306,鼎天,108,71,37,富邦-嘉義,2024-05-24,9692
00751B,元大AAA至A公司債,35,1,34,富邦-嘉義,2024-05-24,9692
2313,華通,90,58,32,富邦-嘉義,2024-05-24,9692
5234,達興材料,40,8,32,富邦-嘉義,2024-05-24,9692
00650L,復華香港正2,31,0,31,富邦-嘉義,2024-05-24,9692
2464,盟立,202,172,30,富邦-嘉義,2024-05-24,9692
00676R,富邦臺灣加權反1,30,0,30,富邦-嘉義,2024-05-24,9692
6015,宏遠證,29,0,29,富邦-嘉義,2024-05-24,9692
3064,泰偉,29,0,29,富邦-嘉義,2024-05-24,9692
1815,富喬,1308,1279,29,富邦-嘉義,2024-05-24,9692
3481,群創,84,56,28,富邦-嘉義,2024-05-24,9692
1303,南亞,35,7,28,富邦-嘉義,2024-05-24,9692
5880,合庫金,28,1,27,富邦-嘉義,2024-05-24,9692
3537,堡達,41,14,27,富邦-嘉義,2024-05-24,9692
2354,鴻準,1554,1112,442,富邦-嘉義,2024-05-27,9692
8064,東捷,515,82,433,富邦-嘉義,2024-05-27,9692
2883,凱基金,371,11,360,富邦-嘉義,2024-05-27,9692
2486,一詮,570,264,306,富邦-嘉義,2024-05-27,9692
2382,廣達,694,413,281,富邦-嘉義,2024-05-27,9692
6188,廣明,475,222,253,富邦-嘉義,2024-05-27,9692
2603,長榮,1121,887,234,富邦-嘉義,2024-05-27,9692
3535,晶彩科,215,39,176,富邦-嘉義,2024-05-27,9692
2495,普安,596,424,172,富邦-嘉義,2024-05-27,9692
2464,盟立,944,774,170,富邦-嘉義,2024-05-27,9692
3450,聯鈞,165,23,142,富邦-嘉義,2024-05-27,9692
00665L,富邦�琤肭磪囓�2,145,4,141,富邦-嘉義,2024-05-27,9692
00632R,元大台灣50反1,243,110,133,富邦-嘉義,2024-05-27,9692
5371,中光電,164,42,122,富邦-嘉義,2024-05-27,9692
5426,振發,220,114,106,富邦-嘉義,2024-05-27,9692
3706,神達,131,26,105,富邦-嘉義,2024-05-27,9692
2845,遠東銀,101,0,101,富邦-嘉義,2024-05-27,9692
2867,三商壽,158,57,101,富邦-嘉義,2024-05-27,9692
2002,中鋼,134,35,99,富邦-嘉義,2024-05-27,9692
00687B,國泰20年美債,104,14,90,富邦-嘉義,2024-05-27,9692
00919,群益台灣精選高息,136,50,86,富邦-嘉義,2024-05-27,9692
2515,中工,89,5,84,富邦-嘉義,2024-05-27,9692
00937B,群益ESG投等債20,102,19,83,富邦-嘉義,2024-05-27,9692
4979,華星光,140,63,77,富邦-嘉義,2024-05-27,9692
00679B,元大美債20年,85,24,61,富邦-嘉義,2024-05-27,9692
8210,勤誠,134,78,56,富邦-嘉義,2024-05-27,9692
1313,聯成,53,1,52,富邦-嘉義,2024-05-27,9692
2324,仁寶,81,31,50,富邦-嘉義,2024-05-27,9692
4967,十銓,62,15,47,富邦-嘉義,2024-05-27,9692
3537,堡達,52,6,46,富邦-嘉義,2024-05-27,9692
6197,佳必琪,67,21,46,富邦-嘉義,2024-05-27,9692
1714,和桐,47,1,46,富邦-嘉義,2024-05-27,9692
1570,力肯,69,24,45,富邦-嘉義,2024-05-27,9692
2344,華邦電,57,15,42,富邦-嘉義,2024-05-27,9692
2886,兆豐金,41,2,39,富邦-嘉義,2024-05-27,9692
4952,凌通,66,28,38,富邦-嘉義,2024-05-27,9692
1409,新纖,39,1,38,富邦-嘉義,2024-05-27,9692
2801,彰銀,41,4,37,富邦-嘉義,2024-05-27,9692
1471,首利,37,0,37,富邦-嘉義,2024-05-27,9692
3306,鼎天,116,79,37,富邦-嘉義,2024-05-27,9692
2454,聯發科,65,32,33,富邦-嘉義,2024-05-27,9692
1312,國喬,32,0,32,富邦-嘉義,2024-05-27,9692
2610,華航,108,76,32,富邦-嘉義,2024-05-27,9692
4562,穎漢,48,16,32,富邦-嘉義,2024-05-27,9692
6215,和椿,61,30,31,富邦-嘉義,2024-05-27,9692
2618,長榮航,64,33,31,富邦-嘉義,2024-05-27,9692
4714,永捷,31,2,29,富邦-嘉義,2024-05-27,9692
6227,茂綸,97,69,28,富邦-嘉義,2024-05-27,9692
4543,萬在,112,85,27,富邦-嘉義,2024-05-27,9692
6265,方土昶,218,191,27,富邦-嘉義,2024-05-27,9692
1815,富喬,1746,787,959,富邦-嘉義,2024-05-28,9692
3047,訊舟,1811,868,943,富邦-嘉義,2024-05-28,9692
6125,廣運,840,474,366,富邦-嘉義,2024-05-28,9692
6189,豐藝,359,83,276,富邦-嘉義,2024-05-28,9692
3312,弘憶股,285,13,272,富邦-嘉義,2024-05-28,9692
4714,永捷,321,102,219,富邦-嘉義,2024-05-28,9692
6270,倍微,261,72,189,富邦-嘉義,2024-05-28,9692
2887,台新金,179,2,177,富邦-嘉義,2024-05-28,9692
2888,新光金,210,48,162,富邦-嘉義,2024-05-28,9692
6117,迎廣,293,154,139,富邦-嘉義,2024-05-28,9692
00751B,元大AAA至A公司債,138,0,138,富邦-嘉義,2024-05-28,9692
5230,雷笛克光學,166,33,133,富邦-嘉義,2024-05-28,9692
2301,光寶科,137,5,132,富邦-嘉義,2024-05-28,9692
00937B,群益ESG投等債20,225,101,124,富邦-嘉義,2024-05-28,9692
2891,中信金,118,9,109,富邦-嘉義,2024-05-28,9692
5351,鈺創,133,26,107,富邦-嘉義,2024-05-28,9692
5258,虹堡,100,1,99,富邦-嘉義,2024-05-28,9692
2324,仁寶,125,34,91,富邦-嘉義,2024-05-28,9692
00713,元大台灣高息低波,95,10,85,富邦-嘉義,2024-05-28,9692
2409,友達,104,23,81,富邦-嘉義,2024-05-28,9692
2641,正德,978,897,81,富邦-嘉義,2024-05-28,9692
2392,正崴,344,268,76,富邦-嘉義,2024-05-28,9692
3303,岱稜,85,9,76,富邦-嘉義,2024-05-28,9692
2353,宏��,151,76,75,富邦-嘉義,2024-05-28,9692
2867,三商壽,103,28,75,富邦-嘉義,2024-05-28,9692
2317,鴻海,154,80,74,富邦-嘉義,2024-05-28,9692
00946,群益科技高息成長,74,2,72,富邦-嘉義,2024-05-28,9692
3231,緯創,1634,1566,68,富邦-嘉義,2024-05-28,9692
2495,普安,344,277,67,富邦-嘉義,2024-05-28,9692
6113,亞矽,64,1,63,富邦-嘉義,2024-05-28,9692
2359,所羅門,179,127,52,富邦-嘉義,2024-05-28,9692
2363,矽統,148,98,50,富邦-嘉義,2024-05-28,9692
6114,久威,50,0,50,富邦-嘉義,2024-05-28,9692
3060,銘異,103,55,48,富邦-嘉義,2024-05-28,9692
00679B,元大美債20年,49,5,44,富邦-嘉義,2024-05-28,9692
2369,菱生,138,95,43,富邦-嘉義,2024-05-28,9692
00673R,期元大S＆P原油反1,40,0,40,富邦-嘉義,2024-05-28,9692
1522,堤維西,50,10,40,富邦-嘉義,2024-05-28,9692
00919,群益台灣精選高息,95,60,35,富邦-嘉義,2024-05-28,9692
3594,磐儀,60,29,31,富邦-嘉義,2024-05-28,9692
4903,聯光通,42,11,31,富邦-嘉義,2024-05-28,9692
5234,達興材料,31,0,31,富邦-嘉義,2024-05-28,9692
2492,華新科,32,1,31,富邦-嘉義,2024-05-28,9692
00696B,富邦美債20年,30,0,30,富邦-嘉義,2024-05-28,9692
1402,遠東新,30,0,30,富邦-嘉義,2024-05-28,9692
2613,中櫃,51,22,29,富邦-嘉義,2024-05-28,9692
2313,華通,29,2,27,富邦-嘉義,2024-05-28,9692
5864,致和證,26,0,26,富邦-嘉義,2024-05-28,9692
2405,輔信,46,20,26,富邦-嘉義,2024-05-28,9692
1316,上曜,166,141,25,富邦-嘉義,2024-05-28,9692
1815,富喬,1942,880,1062,富邦-嘉義,2024-05-29,9692
00937B,群益ESG投等債20,706,32,674,富邦-嘉義,2024-05-29,9692
2888,新光金,532,47,485,富邦-嘉義,2024-05-29,9692
2349,錸德,458,16,442,富邦-嘉義,2024-05-29,9692
2405,輔信,674,236,438,富邦-嘉義,2024-05-29,9692
5258,虹堡,237,0,237,富邦-嘉義,2024-05-29,9692
2353,宏��,284,103,181,富邦-嘉義,2024-05-29,9692
2409,友達,198,30,168,富邦-嘉義,2024-05-29,9692
8105,凌巨,279,113,166,富邦-嘉義,2024-05-29,9692
2354,鴻準,1536,1377,159,富邦-嘉義,2024-05-29,9692
6160,欣技,471,320,151,富邦-嘉義,2024-05-29,9692
00946,群益科技高息成長,156,6,150,富邦-嘉義,2024-05-29,9692
6113,亞矽,153,6,147,富邦-嘉義,2024-05-29,9692
00679B,元大美債20年,220,75,145,富邦-嘉義,2024-05-29,9692
2722,夏都,169,27,142,富邦-嘉義,2024-05-29,9692
2543,皇昌,425,288,137,富邦-嘉義,2024-05-29,9692
2489,瑞軒,1545,1415,130,富邦-嘉義,2024-05-29,9692
4533,協易機,432,312,120,富邦-嘉義,2024-05-29,9692
6209,今國光,221,108,113,富邦-嘉義,2024-05-29,9692
2316,楠梓電,110,0,110,富邦-嘉義,2024-05-29,9692
00927,群益半導體收益,135,31,104,富邦-嘉義,2024-05-29,9692
2303,聯電,141,39,102,富邦-嘉義,2024-05-29,9692
2609,陽明,249,149,100,富邦-嘉義,2024-05-29,9692
3564,其陽,413,313,100,富邦-嘉義,2024-05-29,9692
3380,明泰,243,145,98,富邦-嘉義,2024-05-29,9692
00650L,復華香港正2,110,17,93,富邦-嘉義,2024-05-29,9692
5608,四維航,140,48,92,富邦-嘉義,2024-05-29,9692
00940,元大台灣價值高息,116,33,83,富邦-嘉義,2024-05-29,9692
00878,國泰永續高股息,99,19,80,富邦-嘉義,2024-05-29,9692
00687B,國泰20年美債,75,1,74,富邦-嘉義,2024-05-29,9692
2886,兆豐金,71,1,70,富邦-嘉義,2024-05-29,9692
2883,凱基金,67,0,67,富邦-嘉義,2024-05-29,9692
00713,元大台灣高息低波,65,2,63,富邦-嘉義,2024-05-29,9692
2867,三商壽,227,167,60,富邦-嘉義,2024-05-29,9692
2025,千興,58,1,57,富邦-嘉義,2024-05-29,9692
5880,合庫金,60,3,57,富邦-嘉義,2024-05-29,9692
2412,中華電,54,0,54,富邦-嘉義,2024-05-29,9692
1101,台泥,61,9,52,富邦-嘉義,2024-05-29,9692
00918,大華優利高填息30,52,0,52,富邦-嘉義,2024-05-29,9692
2880,華南金,55,4,51,富邦-嘉義,2024-05-29,9692
3406,玉晶光,56,6,50,富邦-嘉義,2024-05-29,9692
2514,龍邦,121,71,50,富邦-嘉義,2024-05-29,9692
00919,群益台灣精選高息,105,56,49,富邦-嘉義,2024-05-29,9692
2892,第一金,48,1,47,富邦-嘉義,2024-05-29,9692
3714,富采,67,20,47,富邦-嘉義,2024-05-29,9692
2887,台新金,47,1,46,富邦-嘉義,2024-05-29,9692
00680L,元大美債20正2,45,0,45,富邦-嘉義,2024-05-29,9692
2464,盟立,63,18,45,富邦-嘉義,2024-05-29,9692
2492,華新科,47,2,45,富邦-嘉義,2024-05-29,9692
2317,鴻海,137,93,44,富邦-嘉義,2024-05-29,9692
00937B,群益ESG投等債20,493,71,422,富邦-嘉義,2024-05-30,9692
3047,訊舟,451,68,383,富邦-嘉義,2024-05-30,9692
2399,映泰,595,254,341,富邦-嘉義,2024-05-30,9692
6140,訊達,522,248,274,富邦-嘉義,2024-05-30,9692
00929,復華台灣科技優息,336,79,257,富邦-嘉義,2024-05-30,9692
00927,群益半導體收益,245,0,245,富邦-嘉義,2024-05-30,9692
1725,元禎,469,288,181,富邦-嘉義,2024-05-30,9692
6125,廣運,518,337,181,富邦-嘉義,2024-05-30,9692
2615,萬海,266,106,160,富邦-嘉義,2024-05-30,9692
1536,和大,281,122,159,富邦-嘉義,2024-05-30,9692
2867,三商壽,161,5,156,富邦-嘉義,2024-05-30,9692
2609,陽明,316,167,149,富邦-嘉義,2024-05-30,9692
4903,聯光通,232,89,143,富邦-嘉義,2024-05-30,9692
00679B,元大美債20年,142,14,128,富邦-嘉義,2024-05-30,9692
6695,芯鼎,129,4,125,富邦-嘉義,2024-05-30,9692
2464,盟立,124,13,111,富邦-嘉義,2024-05-30,9692
2353,宏��,160,54,106,富邦-嘉義,2024-05-30,9692
1815,富喬,1735,1632,103,富邦-嘉義,2024-05-30,9692
2002,中鋼,102,1,101,富邦-嘉義,2024-05-30,9692
00940,元大台灣價值高息,178,78,100,富邦-嘉義,2024-05-30,9692
5258,虹堡,100,1,99,富邦-嘉義,2024-05-30,9692
2313,華通,99,3,96,富邦-嘉義,2024-05-30,9692
2344,華邦電,99,8,91,富邦-嘉義,2024-05-30,9692
2356,英業達,86,3,83,富邦-嘉義,2024-05-30,9692
00632R,元大台灣50反1,185,104,81,富邦-嘉義,2024-05-30,9692
00680L,元大美債20正2,80,0,80,富邦-嘉義,2024-05-30,9692
3202,樺晟,123,43,80,富邦-嘉義,2024-05-30,9692
1303,南亞,79,1,78,富邦-嘉義,2024-05-30,9692
00665L,富邦�琤肭磪囓�2,84,10,74,富邦-嘉義,2024-05-30,9692
2812,台中銀,73,0,73,富邦-嘉義,2024-05-30,9692
2409,友達,86,13,73,富邦-嘉義,2024-05-30,9692
2316,楠梓電,90,17,73,富邦-嘉義,2024-05-30,9692
2610,華航,76,7,69,富邦-嘉義,2024-05-30,9692
2324,仁寶,132,64,68,富邦-嘉義,2024-05-30,9692
4967,十銓,242,176,66,富邦-嘉義,2024-05-30,9692
6770,力積電,73,9,64,富邦-嘉義,2024-05-30,9692
2317,鴻海,604,543,61,富邦-嘉義,2024-05-30,9692
2883,凱基金,79,19,60,富邦-嘉義,2024-05-30,9692
2618,長榮航,120,61,59,富邦-嘉義,2024-05-30,9692
00676R,富邦臺灣加權反1,58,0,58,富邦-嘉義,2024-05-30,9692
4763,材料-KY,62,4,58,富邦-嘉義,2024-05-30,9692
00687B,國泰20年美債,55,0,55,富邦-嘉義,2024-05-30,9692
2613,中櫃,278,223,55,富邦-嘉義,2024-05-30,9692
1532,勤美,54,1,53,富邦-嘉義,2024-05-30,9692
1313,聯成,53,0,53,富邦-嘉義,2024-05-30,9692
5880,合庫金,53,1,52,富邦-嘉義,2024-05-30,9692
3231,緯創,98,48,50,富邦-嘉義,2024-05-30,9692
2323,中環,50,0,50,富邦-嘉義,2024-05-30,9692
2838A,聯邦銀甲特,50,0,50,富邦-嘉義,2024-05-30,9692
2301,光寶科,50,1,49,富邦-嘉義,2024-05-30,9692
6188,廣明,1630,1058,572,富邦-嘉義,2024-05-31,9692
00919,群益台灣精選高息,445,78,367,富邦-嘉義,2024-05-31,9692
3372,典範,416,208,208,富邦-嘉義,2024-05-31,9692
3047,訊舟,247,47,200,富邦-嘉義,2024-05-31,9692
2353,宏��,319,137,182,富邦-嘉義,2024-05-31,9692
6270,倍微,267,93,174,富邦-嘉義,2024-05-31,9692
2101,南港,256,90,166,富邦-嘉義,2024-05-31,9692
00878,國泰永續高股息,183,26,157,富邦-嘉義,2024-05-31,9692
6125,廣運,638,485,153,富邦-嘉義,2024-05-31,9692
2002,中鋼,174,34,140,富邦-嘉義,2024-05-31,9692
2609,陽明,4120,3984,136,富邦-嘉義,2024-05-31,9692
2537,聯上發,215,91,124,富邦-嘉義,2024-05-31,9692
2344,華邦電,123,4,119,富邦-嘉義,2024-05-31,9692
00929,復華台灣科技優息,258,148,110,富邦-嘉義,2024-05-31,9692
3231,緯創,124,15,109,富邦-嘉義,2024-05-31,9692
9105,泰金寶-DR,111,14,97,富邦-嘉義,2024-05-31,9692
4533,協易機,366,270,96,富邦-嘉義,2024-05-31,9692
6117,迎廣,171,85,86,富邦-嘉義,2024-05-31,9692
5258,虹堡,81,1,80,富邦-嘉義,2024-05-31,9692
2317,鴻海,1720,1646,74,富邦-嘉義,2024-05-31,9692
8110,華東,91,21,70,富邦-嘉義,2024-05-31,9692
3490,單井,123,58,65,富邦-嘉義,2024-05-31,9692
2365,昆盈,266,204,62,富邦-嘉義,2024-05-31,9692
2610,華航,72,14,58,富邦-嘉義,2024-05-31,9692
4903,聯光通,84,27,57,富邦-嘉義,2024-05-31,9692
00946,群益科技高息成長,59,3,56,富邦-嘉義,2024-05-31,9692
3048,益登,59,4,55,富邦-嘉義,2024-05-31,9692
00650L,復華香港正2,54,0,54,富邦-嘉義,2024-05-31,9692
2324,仁寶,80,28,52,富邦-嘉義,2024-05-31,9692
8070,長華*,60,8,52,富邦-嘉義,2024-05-31,9692
1416,廣豐,53,1,52,富邦-嘉義,2024-05-31,9692
00939,統一台灣高息動能,49,2,47,富邦-嘉義,2024-05-31,9692
3564,其陽,62,17,45,富邦-嘉義,2024-05-31,9692
00712,復華富時不動產,56,11,45,富邦-嘉義,2024-05-31,9692
2301,光寶科,102,58,44,富邦-嘉義,2024-05-31,9692
2538,基泰,87,45,42,富邦-嘉義,2024-05-31,9692
6215,和椿,108,66,42,富邦-嘉義,2024-05-31,9692
00937B,群益ESG投等債20,65,23,42,富邦-嘉義,2024-05-31,9692
2330,台積電,48,9,39,富邦-嘉義,2024-05-31,9692
6770,力積電,42,7,35,富邦-嘉義,2024-05-31,9692
5880,合庫金,36,2,34,富邦-嘉義,2024-05-31,9692
00715L,期街口布蘭特正2,36,2,34,富邦-嘉義,2024-05-31,9692
8374,羅昇,36,2,34,富邦-嘉義,2024-05-31,9692
2025,千興,34,1,33,富邦-嘉義,2024-05-31,9692
3024,憶聲,35,3,32,富邦-嘉義,2024-05-31,9692
00915,凱基優選高股息30,41,10,31,富邦-嘉義,2024-05-31,9692
1303,南亞,33,4,29,富邦-嘉義,2024-05-31,9692
2382,廣達,82,54,28,富邦-嘉義,2024-05-31,9692
2351,順德,70,42,28,富邦-嘉義,2024-05-31,9692
2352,佳世達,26,0,26,富邦-嘉義,2024-05-31,9692
00919,群益台灣精選高息,425,3,422,富邦-嘉義,2024-06-03,9692
2331,精英,350,7,343,富邦-嘉義,2024-06-03,9692
3312,弘憶股,513,250,263,富邦-嘉義,2024-06-03,9692
4967,十銓,437,199,238,富邦-嘉義,2024-06-03,9692
2417,圓剛,300,147,153,富邦-嘉義,2024-06-03,9692
2618,長榮航,158,30,128,富邦-嘉義,2024-06-03,9692
00929,復華台灣科技優息,235,108,127,富邦-嘉義,2024-06-03,9692
00679B,元大美債20年,133,9,124,富邦-嘉義,2024-06-03,9692
3047,訊舟,169,51,118,富邦-嘉義,2024-06-03,9692
2324,仁寶,177,71,106,富邦-嘉義,2024-06-03,9692
2313,華通,96,0,96,富邦-嘉義,2024-06-03,9692
3048,益登,108,12,96,富邦-嘉義,2024-06-03,9692
00715L,期街口布蘭特正2,95,0,95,富邦-嘉義,2024-06-03,9692
4562,穎漢,349,271,78,富邦-嘉義,2024-06-03,9692
6177,達麗,83,6,77,富邦-嘉義,2024-06-03,9692
6215,和椿,668,591,77,富邦-嘉義,2024-06-03,9692
8358,金居,87,13,74,富邦-嘉義,2024-06-03,9692
2486,一詮,548,476,72,富邦-嘉義,2024-06-03,9692
2014,中鴻,102,30,72,富邦-嘉義,2024-06-03,9692
8147,正淩,115,44,71,富邦-嘉義,2024-06-03,9692
2312,金寶,77,10,67,富邦-嘉義,2024-06-03,9692
8234,新漢,286,220,66,富邦-嘉義,2024-06-03,9692
2880,華南金,68,3,65,富邦-嘉義,2024-06-03,9692
00918,大華優利高填息30,66,1,65,富邦-嘉義,2024-06-03,9692
3481,群創,84,26,58,富邦-嘉義,2024-06-03,9692
00946,群益科技高息成長,59,1,58,富邦-嘉義,2024-06-03,9692
2383,台光電,170,114,56,富邦-嘉義,2024-06-03,9692
2834,臺企銀,62,6,56,富邦-嘉義,2024-06-03,9692
2489,瑞軒,87,35,52,富邦-嘉義,2024-06-03,9692
6770,力積電,99,48,51,富邦-嘉義,2024-06-03,9692
1313,聯成,51,0,51,富邦-嘉義,2024-06-03,9692
2615,萬海,355,306,49,富邦-嘉義,2024-06-03,9692
2465,麗臺,54,11,43,富邦-嘉義,2024-06-03,9692
5371,中光電,156,113,43,富邦-嘉義,2024-06-03,9692
8121,越峰,42,0,42,富邦-嘉義,2024-06-03,9692
1218,泰山,46,7,39,富邦-嘉義,2024-06-03,9692
00923,群益台ESG低碳50,36,0,36,富邦-嘉義,2024-06-03,9692
5880,合庫金,35,0,35,富邦-嘉義,2024-06-03,9692
8070,長華*,40,5,35,富邦-嘉義,2024-06-03,9692
2374,佳能,104,70,34,富邦-嘉義,2024-06-03,9692
2303,聯電,48,16,32,富邦-嘉義,2024-06-03,9692
3033,威健,36,5,31,富邦-嘉義,2024-06-03,9692
9904,寶成,30,0,30,富邦-嘉義,2024-06-03,9692
3537,堡達,31,1,30,富邦-嘉義,2024-06-03,9692
3231,緯創,100,73,27,富邦-嘉義,2024-06-03,9692
8027,鈦昇,29,3,26,富邦-嘉義,2024-06-03,9692
00665L,富邦�琤肭磪囓�2,57,31,26,富邦-嘉義,2024-06-03,9692
2405,輔信,37,11,26,富邦-嘉義,2024-06-03,9692
2367,燿華,43,19,24,富邦-嘉義,2024-06-03,9692
2349,錸德,121,97,24,富邦-嘉義,2024-06-03,9692
3048,益登,785,16,769,富邦-嘉義,2024-06-04,9692
1815,富喬,1201,629,572,富邦-嘉義,2024-06-04,9692
2537,聯上發,1104,572,532,富邦-嘉義,2024-06-04,9692
2417,圓剛,782,253,529,富邦-嘉義,2024-06-04,9692
1504,東元,406,11,395,富邦-嘉義,2024-06-04,9692
00936,台新永續高息中小,394,13,381,富邦-嘉義,2024-06-04,9692
00715L,期街口布蘭特正2,330,0,330,富邦-嘉義,2024-06-04,9692
00929,復華台灣科技優息,433,144,289,富邦-嘉義,2024-06-04,9692
2344,華邦電,266,33,233,富邦-嘉義,2024-06-04,9692
4967,十銓,884,684,200,富邦-嘉義,2024-06-04,9692
1314,中石化,206,12,194,富邦-嘉義,2024-06-04,9692
2501,國建,217,31,186,富邦-嘉義,2024-06-04,9692
2312,金寶,240,77,163,富邦-嘉義,2024-06-04,9692
00919,群益台灣精選高息,221,71,150,富邦-嘉義,2024-06-04,9692
00915,凱基優選高股息30,140,1,139,富邦-嘉義,2024-06-04,9692
00918,大華優利高填息30,197,65,132,富邦-嘉義,2024-06-04,9692
2495,普安,544,416,128,富邦-嘉義,2024-06-04,9692
5258,虹堡,180,52,128,富邦-嘉義,2024-06-04,9692
2867,三商壽,131,6,125,富邦-嘉義,2024-06-04,9692
6451,訊芯-KY,107,3,104,富邦-嘉義,2024-06-04,9692
00942B,台新美A公司債20+,107,8,99,富邦-嘉義,2024-06-04,9692
8277,商丞,102,4,98,富邦-嘉義,2024-06-04,9692
2324,仁寶,126,33,93,富邦-嘉義,2024-06-04,9692
00878,國泰永續高股息,110,33,77,富邦-嘉義,2024-06-04,9692
2888,新光金,496,426,70,富邦-嘉義,2024-06-04,9692
6161,捷波,76,8,68,富邦-嘉義,2024-06-04,9692
2492,華新科,67,1,66,富邦-嘉義,2024-06-04,9692
2515,中工,136,70,66,富邦-嘉義,2024-06-04,9692
2489,瑞軒,80,15,65,富邦-嘉義,2024-06-04,9692
2313,華通,69,5,64,富邦-嘉義,2024-06-04,9692
00713,元大台灣高息低波,55,0,55,富邦-嘉義,2024-06-04,9692
3706,神達,77,22,55,富邦-嘉義,2024-06-04,9692
2002,中鋼,58,3,55,富邦-嘉義,2024-06-04,9692
2880,華南金,58,4,54,富邦-嘉義,2024-06-04,9692
2303,聯電,101,50,51,富邦-嘉義,2024-06-04,9692
3260,威剛,67,17,50,富邦-嘉義,2024-06-04,9692
6770,力積電,60,14,46,富邦-嘉義,2024-06-04,9692
2453,凌群,55,13,42,富邦-嘉義,2024-06-04,9692
5880,合庫金,41,0,41,富邦-嘉義,2024-06-04,9692
4526,東台,45,5,40,富邦-嘉義,2024-06-04,9692
2023,燁輝,40,0,40,富邦-嘉義,2024-06-04,9692
3231,緯創,51,11,40,富邦-嘉義,2024-06-04,9692
1303,南亞,41,2,39,富邦-嘉義,2024-06-04,9692
1605,華新,45,7,38,富邦-嘉義,2024-06-04,9692
00665L,富邦�琤肭磪囓�2,39,2,37,富邦-嘉義,2024-06-04,9692
2301,光寶科,40,4,36,富邦-嘉義,2024-06-04,9692
2351,順德,62,26,36,富邦-嘉義,2024-06-04,9692
9105,泰金寶-DR,42,7,35,富邦-嘉義,2024-06-04,9692
2354,鴻準,134,100,34,富邦-嘉義,2024-06-04,9692
3006,晶豪科,43,9,34,富邦-嘉義,2024-06-04,9692
1815,富喬,3126,1957,1169,富邦-嘉義,2024-06-05,9692
2328,廣宇,1204,429,775,富邦-嘉義,2024-06-05,9692
2888,新光金,645,5,640,富邦-嘉義,2024-06-05,9692
2317,鴻海,1170,636,534,富邦-嘉義,2024-06-05,9692
00936,台新永續高息中小,416,11,405,富邦-嘉義,2024-06-05,9692
00715L,期街口布蘭特正2,261,4,257,富邦-嘉義,2024-06-05,9692
00918,大華優利高填息30,252,1,251,富邦-嘉義,2024-06-05,9692
5392,能率,283,68,215,富邦-嘉義,2024-06-05,9692
2383,台光電,191,0,191,富邦-嘉義,2024-06-05,9692
1522,堤維西,191,7,184,富邦-嘉義,2024-06-05,9692
00878,國泰永續高股息,198,46,152,富邦-嘉義,2024-06-05,9692
00915,凱基優選高股息30,237,108,129,富邦-嘉義,2024-06-05,9692
5258,虹堡,105,0,105,富邦-嘉義,2024-06-05,9692
8358,金居,79,0,79,富邦-嘉義,2024-06-05,9692
2002,中鋼,78,4,74,富邦-嘉義,2024-06-05,9692
00665L,富邦�琤肭磪囓�2,131,59,72,富邦-嘉義,2024-06-05,9692
6197,佳必琪,147,78,69,富邦-嘉義,2024-06-05,9692
2812,台中銀,65,0,65,富邦-嘉義,2024-06-05,9692
5880,合庫金,72,11,61,富邦-嘉義,2024-06-05,9692
1310,台苯,60,0,60,富邦-嘉義,2024-06-05,9692
2834,臺企銀,72,13,59,富邦-嘉義,2024-06-05,9692
2374,佳能,209,153,56,富邦-嘉義,2024-06-05,9692
2313,華通,67,12,55,富邦-嘉義,2024-06-05,9692
2637,慧洋-KY,63,10,53,富邦-嘉義,2024-06-05,9692
3231,緯創,99,50,49,富邦-嘉義,2024-06-05,9692
4534,慶騰,51,4,47,富邦-嘉義,2024-06-05,9692
1313,聯成,46,0,46,富邦-嘉義,2024-06-05,9692
2349,錸德,47,1,46,富邦-嘉義,2024-06-05,9692
2101,南港,104,60,44,富邦-嘉義,2024-06-05,9692
2344,華邦電,67,26,41,富邦-嘉義,2024-06-05,9692
2105,正新,48,8,40,富邦-嘉義,2024-06-05,9692
2324,仁寶,43,8,35,富邦-嘉義,2024-06-05,9692
4549,桓達,69,35,34,富邦-嘉義,2024-06-05,9692
00650L,復華香港正2,33,0,33,富邦-嘉義,2024-06-05,9692
3006,晶豪科,54,21,33,富邦-嘉義,2024-06-05,9692
6265,方土昶,33,1,32,富邦-嘉義,2024-06-05,9692
6160,欣技,30,1,29,富邦-嘉義,2024-06-05,9692
1785,光洋科,31,2,29,富邦-嘉義,2024-06-05,9692
2609,陽明,2012,1984,28,富邦-嘉義,2024-06-05,9692
2464,盟立,42,14,28,富邦-嘉義,2024-06-05,9692
2303,聯電,72,44,28,富邦-嘉義,2024-06-05,9692
2353,宏��,90,62,28,富邦-嘉義,2024-06-05,9692
4960,誠美材,27,0,27,富邦-嘉義,2024-06-05,9692
8110,華東,36,9,27,富邦-嘉義,2024-06-05,9692
1464,得力,28,2,26,富邦-嘉義,2024-06-05,9692
2014,中鴻,30,5,25,富邦-嘉義,2024-06-05,9692
2365,昆盈,72,47,25,富邦-嘉義,2024-06-05,9692
1301,台塑,39,15,24,富邦-嘉義,2024-06-05,9692
3483,力致,29,5,24,富邦-嘉義,2024-06-05,9692
8070,長華*,27,3,24,富邦-嘉義,2024-06-05,9692
2367,燿華,873,81,792,富邦-嘉義,2024-06-06,9692
2867,三商壽,441,21,420,富邦-嘉義,2024-06-06,9692
2613,中櫃,1326,1065,261,富邦-嘉義,2024-06-06,9692
00937B,群益ESG投等債20,286,58,228,富邦-嘉義,2024-06-06,9692
2888,新光金,467,242,225,富邦-嘉義,2024-06-06,9692
2344,華邦電,200,2,198,富邦-嘉義,2024-06-06,9692
00919,群益台灣精選高息,211,36,175,富邦-嘉義,2024-06-06,9692
00936,台新永續高息中小,273,106,167,富邦-嘉義,2024-06-06,9692
2615,萬海,752,597,155,富邦-嘉義,2024-06-06,9692
2330,台積電,312,163,149,富邦-嘉義,2024-06-06,9692
00664R,國泰臺灣加權反1,115,0,115,富邦-嘉義,2024-06-06,9692
1314,中石化,113,12,101,富邦-嘉義,2024-06-06,9692
3481,群創,113,12,101,富邦-嘉義,2024-06-06,9692
2301,光寶科,100,1,99,富邦-嘉義,2024-06-06,9692
3376,新日興,140,43,97,富邦-嘉義,2024-06-06,9692
2605,新興,111,22,89,富邦-嘉義,2024-06-06,9692
00676R,富邦臺灣加權反1,110,32,78,富邦-嘉義,2024-06-06,9692
2312,金寶,574,506,68,富邦-嘉義,2024-06-06,9692
8277,商丞,71,5,66,富邦-嘉義,2024-06-06,9692
5258,虹堡,65,0,65,富邦-嘉義,2024-06-06,9692
6290,良維,100,47,53,富邦-嘉義,2024-06-06,9692
8933,愛地雅,53,0,53,富邦-嘉義,2024-06-06,9692
3231,緯創,112,61,51,富邦-嘉義,2024-06-06,9692
1532,勤美,51,0,51,富邦-嘉義,2024-06-06,9692
00946,群益科技高息成長,52,1,51,富邦-嘉義,2024-06-06,9692
00933B,國泰10Y+金融債,50,0,50,富邦-嘉義,2024-06-06,9692
4543,萬在,56,9,47,富邦-嘉義,2024-06-06,9692
2454,聯發科,136,90,46,富邦-嘉義,2024-06-06,9692
8110,華東,49,6,43,富邦-嘉義,2024-06-06,9692
4956,光鋐,271,231,40,富邦-嘉義,2024-06-06,9692
2002,中鋼,42,2,40,富邦-嘉義,2024-06-06,9692
2359,所羅門,209,169,40,富邦-嘉義,2024-06-06,9692
2323,中環,49,10,39,富邦-嘉義,2024-06-06,9692
00918,大華優利高填息30,59,21,38,富邦-嘉義,2024-06-06,9692
3062,建漢,41,3,38,富邦-嘉義,2024-06-06,9692
4566,時碩工業,315,278,37,富邦-嘉義,2024-06-06,9692
1524,耿鼎,34,0,34,富邦-嘉義,2024-06-06,9692
3297,杭特,38,5,33,富邦-嘉義,2024-06-06,9692
5302,太欣,45,13,32,富邦-嘉義,2024-06-06,9692
2489,瑞軒,31,1,30,富邦-嘉義,2024-06-06,9692
6442,光聖,216,186,30,富邦-嘉義,2024-06-06,9692
4533,協易機,69,39,30,富邦-嘉義,2024-06-06,9692
6215,和椿,197,167,30,富邦-嘉義,2024-06-06,9692
2547,日勝生,30,0,30,富邦-嘉義,2024-06-06,9692
8358,金居,32,2,30,富邦-嘉義,2024-06-06,9692
6160,欣技,29,0,29,富邦-嘉義,2024-06-06,9692
2442,新美齊,30,1,29,富邦-嘉義,2024-06-06,9692
00632R,元大台灣50反1,682,654,28,富邦-嘉義,2024-06-06,9692
6112,邁達特,33,5,28,富邦-嘉義,2024-06-06,9692
4967,十銓,214,186,28,富邦-嘉義,2024-06-06,9692
1815,富喬,3111,1934,1177,富邦-嘉義,2024-06-07,9692
3047,訊舟,2164,1299,865,富邦-嘉義,2024-06-07,9692
1316,上曜,961,417,544,富邦-嘉義,2024-06-07,9692
00940,元大台灣價值高息,527,159,368,富邦-嘉義,2024-06-07,9692
2312,金寶,707,372,335,富邦-嘉義,2024-06-07,9692
00929,復華台灣科技優息,255,0,255,富邦-嘉義,2024-06-07,9692
2371,大同,282,44,238,富邦-嘉義,2024-06-07,9692
6140,訊達,366,138,228,富邦-嘉義,2024-06-07,9692
1618,合機,369,167,202,富邦-嘉義,2024-06-07,9692
9105,泰金寶-DR,283,84,199,富邦-嘉義,2024-06-07,9692
1514,亞力,476,279,197,富邦-嘉義,2024-06-07,9692
9958,世紀鋼,291,103,188,富邦-嘉義,2024-06-07,9692
00936,台新永續高息中小,198,42,156,富邦-嘉義,2024-06-07,9692
1513,中興電,422,277,145,富邦-嘉義,2024-06-07,9692
1609,大亞,561,426,135,富邦-嘉義,2024-06-07,9692
00918,大華優利高填息30,144,19,125,富邦-嘉義,2024-06-07,9692
00655L,國泰中國A50正2,118,1,117,富邦-嘉義,2024-06-07,9692
4714,永捷,515,399,116,富邦-嘉義,2024-06-07,9692
1608,華榮,200,93,107,富邦-嘉義,2024-06-07,9692
1615,大山,204,100,104,富邦-嘉義,2024-06-07,9692
6213,聯茂,110,6,104,富邦-嘉義,2024-06-07,9692
2537,聯上發,314,219,95,富邦-嘉義,2024-06-07,9692
2486,一詮,1005,911,94,富邦-嘉義,2024-06-07,9692
2353,宏��,168,75,93,富邦-嘉義,2024-06-07,9692
2427,三商電,109,16,93,富邦-嘉義,2024-06-07,9692
00937B,群益ESG投等債20,198,116,82,富邦-嘉義,2024-06-07,9692
2603,長榮,535,455,80,富邦-嘉義,2024-06-07,9692
5263,智崴,63,2,61,富邦-嘉義,2024-06-07,9692
00679B,元大美債20年,63,5,58,富邦-嘉義,2024-06-07,9692
2883,凱基金,463,405,58,富邦-嘉義,2024-06-07,9692
5302,太欣,53,0,53,富邦-嘉義,2024-06-07,9692
4157,太景*-KY,54,2,52,富邦-嘉義,2024-06-07,9692
9945,潤泰新,158,106,52,富邦-嘉義,2024-06-07,9692
8358,金居,153,104,49,富邦-嘉義,2024-06-07,9692
00919,群益台灣精選高息,81,35,46,富邦-嘉義,2024-06-07,9692
2356,英業達,63,18,45,富邦-嘉義,2024-06-07,9692
3231,緯創,103,58,45,富邦-嘉義,2024-06-07,9692
00687B,國泰20年美債,58,14,44,富邦-嘉義,2024-06-07,9692
3455,由田,387,348,39,富邦-嘉義,2024-06-07,9692
00878,國泰永續高股息,49,13,36,富邦-嘉義,2024-06-07,9692
2025,千興,36,0,36,富邦-嘉義,2024-06-07,9692
4513,福裕,57,23,34,富邦-嘉義,2024-06-07,9692
3706,神達,33,0,33,富邦-嘉義,2024-06-07,9692
4906,正文,64,31,33,富邦-嘉義,2024-06-07,9692
00637L,元大滬深300正2,31,0,31,富邦-嘉義,2024-06-07,9692
3537,堡達,31,0,31,富邦-嘉義,2024-06-07,9692
2442,新美齊,34,3,31,富邦-嘉義,2024-06-07,9692
2331,精英,40,11,29,富邦-嘉義,2024-06-07,9692
2605,新興,33,4,29,富邦-嘉義,2024-06-07,9692
2017,官田鋼,27,0,27,富邦-嘉義,2024-06-07,9692
2888,新光金,802,373,429,富邦-嘉義,2024-06-11,9692
2615,萬海,871,526,345,富邦-嘉義,2024-06-11,9692
00929,復華台灣科技優息,395,128,267,富邦-嘉義,2024-06-11,9692
00687B,國泰20年美債,310,70,240,富邦-嘉義,2024-06-11,9692
00919,群益台灣精選高息,242,23,219,富邦-嘉義,2024-06-11,9692
3376,新日興,662,463,199,富邦-嘉義,2024-06-11,9692
00679B,元大美債20年,199,0,199,富邦-嘉義,2024-06-11,9692
2609,陽明,1141,954,187,富邦-嘉義,2024-06-11,9692
2002,中鋼,185,3,182,富邦-嘉義,2024-06-11,9692
00918,大華優利高填息30,148,2,146,富邦-嘉義,2024-06-11,9692
3122,笙泉,225,89,136,富邦-嘉義,2024-06-11,9692
2867,三商壽,156,30,126,富邦-嘉義,2024-06-11,9692
00680L,元大美債20正2,133,10,123,富邦-嘉義,2024-06-11,9692
2349,錸德,118,2,116,富邦-嘉義,2024-06-11,9692
2351,順德,117,4,113,富邦-嘉義,2024-06-11,9692
4967,十銓,247,140,107,富邦-嘉義,2024-06-11,9692
5258,虹堡,113,10,103,富邦-嘉義,2024-06-11,9692
9105,泰金寶-DR,120,27,93,富邦-嘉義,2024-06-11,9692
00688L,國泰20年美債正2,80,0,80,富邦-嘉義,2024-06-11,9692
00937B,群益ESG投等債20,170,91,79,富邦-嘉義,2024-06-11,9692
2460,建通,159,80,79,富邦-嘉義,2024-06-11,9692
3231,緯創,93,19,74,富邦-嘉義,2024-06-11,9692
6217,中探針,72,0,72,富邦-嘉義,2024-06-11,9692
00933B,國泰10Y+金融債,87,17,70,富邦-嘉義,2024-06-11,9692
00936,台新永續高息中小,80,10,70,富邦-嘉義,2024-06-11,9692
6290,良維,144,76,68,富邦-嘉義,2024-06-11,9692
5608,四維航,125,67,58,富邦-嘉義,2024-06-11,9692
2359,所羅門,231,174,57,富邦-嘉義,2024-06-11,9692
3481,群創,79,22,57,富邦-嘉義,2024-06-11,9692
2515,中工,82,25,57,富邦-嘉義,2024-06-11,9692
2323,中環,56,1,55,富邦-嘉義,2024-06-11,9692
4903,聯光通,66,13,53,富邦-嘉義,2024-06-11,9692
3056,富華新,52,0,52,富邦-嘉義,2024-06-11,9692
00946,群益科技高息成長,51,1,50,富邦-嘉義,2024-06-11,9692
3312,弘憶股,105,55,50,富邦-嘉義,2024-06-11,9692
6117,迎廣,66,18,48,富邦-嘉義,2024-06-11,9692
2605,新興,918,871,47,富邦-嘉義,2024-06-11,9692
2706,第一店,54,7,47,富邦-嘉義,2024-06-11,9692
00650L,復華香港正2,51,6,45,富邦-嘉義,2024-06-11,9692
6175,立敦,44,0,44,富邦-嘉義,2024-06-11,9692
2356,英業達,52,10,42,富邦-嘉義,2024-06-11,9692
2834,臺企銀,49,10,39,富邦-嘉義,2024-06-11,9692
2020,美亞,39,0,39,富邦-嘉義,2024-06-11,9692
00878,國泰永續高股息,78,41,37,富邦-嘉義,2024-06-11,9692
6552,易華電,131,96,35,富邦-嘉義,2024-06-11,9692
3374,精材,193,160,33,富邦-嘉義,2024-06-11,9692
1522,堤維西,181,148,33,富邦-嘉義,2024-06-11,9692
00753L,中信中國50正2,34,1,33,富邦-嘉義,2024-06-11,9692
1442,名軒,35,2,33,富邦-嘉義,2024-06-11,9692
2891,中信金,34,2,32,富邦-嘉義,2024-06-11,9692
2317,鴻海,2217,1340,877,富邦-嘉義,2024-06-12,9692
2365,昆盈,410,20,390,富邦-嘉義,2024-06-12,9692
2464,盟立,473,83,390,富邦-嘉義,2024-06-12,9692
2367,燿華,587,268,319,富邦-嘉義,2024-06-12,9692
3048,益登,593,291,302,富邦-嘉義,2024-06-12,9692
00632R,元大台灣50反1,302,48,254,富邦-嘉義,2024-06-12,9692
2344,華邦電,193,9,184,富邦-嘉義,2024-06-12,9692
6125,廣運,636,465,171,富邦-嘉義,2024-06-12,9692
6215,和椿,295,157,138,富邦-嘉義,2024-06-12,9692
4562,穎漢,157,27,130,富邦-嘉義,2024-06-12,9692
00936,台新永續高息中小,219,94,125,富邦-嘉義,2024-06-12,9692
00948B,中信優息投資級債,120,0,120,富邦-嘉義,2024-06-12,9692
8358,金居,196,79,117,富邦-嘉義,2024-06-12,9692
2002,中鋼,124,8,116,富邦-嘉義,2024-06-12,9692
2883,凱基金,397,286,111,富邦-嘉義,2024-06-12,9692
00918,大華優利高填息30,92,1,91,富邦-嘉義,2024-06-12,9692
00937B,群益ESG投等債20,158,71,87,富邦-嘉義,2024-06-12,9692
00919,群益台灣精選高息,189,104,85,富邦-嘉義,2024-06-12,9692
3231,緯創,142,58,84,富邦-嘉義,2024-06-12,9692
2323,中環,78,0,78,富邦-嘉義,2024-06-12,9692
00687B,國泰20年美債,90,16,74,富邦-嘉義,2024-06-12,9692
4545,銘鈺,246,172,74,富邦-嘉義,2024-06-12,9692
6216,居易,449,388,61,富邦-嘉義,2024-06-12,9692
00664R,國泰臺灣加權反1,60,0,60,富邦-嘉義,2024-06-12,9692
6274,台燿,104,47,57,富邦-嘉義,2024-06-12,9692
2454,聯發科,88,31,57,富邦-嘉義,2024-06-12,9692
1815,富喬,277,222,55,富邦-嘉義,2024-06-12,9692
00944,野村趨勢動能高息,52,1,51,富邦-嘉義,2024-06-12,9692
8071,能率網通,50,0,50,富邦-嘉義,2024-06-12,9692
2101,南港,51,2,49,富邦-嘉義,2024-06-12,9692
00676R,富邦臺灣加權反1,168,120,48,富邦-嘉義,2024-06-12,9692
8028,昇陽半導體,513,466,47,富邦-嘉義,2024-06-12,9692
6116,彩晶,59,12,47,富邦-嘉義,2024-06-12,9692
00680L,元大美債20正2,50,4,46,富邦-嘉義,2024-06-12,9692
2515,中工,84,40,44,富邦-嘉義,2024-06-12,9692
2480,敦陽科,40,0,40,富邦-嘉義,2024-06-12,9692
1101,台泥,44,4,40,富邦-嘉義,2024-06-12,9692
2615,萬海,190,151,39,富邦-嘉義,2024-06-12,9692
2603,長榮,485,447,38,富邦-嘉義,2024-06-12,9692
00673R,期元大S＆P原油反1,37,0,37,富邦-嘉義,2024-06-12,9692
3010,華立,105,69,36,富邦-嘉義,2024-06-12,9692
2506,太設,37,2,35,富邦-嘉義,2024-06-12,9692
2606,裕民,41,6,35,富邦-嘉義,2024-06-12,9692
6770,力積電,38,4,34,富邦-嘉義,2024-06-12,9692
2356,英業達,56,23,33,富邦-嘉義,2024-06-12,9692
4566,時碩工業,34,2,32,富邦-嘉義,2024-06-12,9692
1455,集盛,32,0,32,富邦-嘉義,2024-06-12,9692
6190,萬泰科,56,26,30,富邦-嘉義,2024-06-12,9692
2387,精元,30,0,30,富邦-嘉義,2024-06-12,9692
5530,龍巖,30,0,30,富邦-嘉義,2024-06-12,9692
5880,合庫金,503,1,502,富邦-嘉義,2024-06-13,9692
3048,益登,982,575,407,富邦-嘉義,2024-06-13,9692
00948B,中信優息投資級債,278,0,278,富邦-嘉義,2024-06-13,9692
2392,正崴,228,48,180,富邦-嘉義,2024-06-13,9692
2486,一詮,692,517,175,富邦-嘉義,2024-06-13,9692
00632R,元大台灣50反1,262,137,125,富邦-嘉義,2024-06-13,9692
6789,采鈺,176,51,125,富邦-嘉義,2024-06-13,9692
00929,復華台灣科技優息,224,102,122,富邦-嘉義,2024-06-13,9692
00919,群益台灣精選高息,189,74,115,富邦-嘉義,2024-06-13,9692
3231,緯創,136,33,103,富邦-嘉義,2024-06-13,9692
2867,三商壽,136,36,100,富邦-嘉義,2024-06-13,9692
1785,光洋科,597,502,95,富邦-嘉義,2024-06-13,9692
3376,新日興,152,58,94,富邦-嘉義,2024-06-13,9692
1815,富喬,776,699,77,富邦-嘉義,2024-06-13,9692
4562,穎漢,378,302,76,富邦-嘉義,2024-06-13,9692
1313,聯成,101,26,75,富邦-嘉義,2024-06-13,9692
3537,堡達,70,0,70,富邦-嘉義,2024-06-13,9692
2801,彰銀,70,2,68,富邦-嘉義,2024-06-13,9692
00665L,富邦�琤肭磪囓�2,73,5,68,富邦-嘉義,2024-06-13,9692
2002,中鋼,74,11,63,富邦-嘉義,2024-06-13,9692
2618,長榮航,100,41,59,富邦-嘉義,2024-06-13,9692
6160,欣技,64,9,55,富邦-嘉義,2024-06-13,9692
00680L,元大美債20正2,110,57,53,富邦-嘉義,2024-06-13,9692
2504,國產,56,3,53,富邦-嘉義,2024-06-13,9692
5533,皇鼎,51,0,51,富邦-嘉義,2024-06-13,9692
2427,三商電,83,32,51,富邦-嘉義,2024-06-13,9692
00933B,國泰10Y+金融債,53,5,48,富邦-嘉義,2024-06-13,9692
8040,九暘,57,11,46,富邦-嘉義,2024-06-13,9692
1617,榮星,206,163,43,富邦-嘉義,2024-06-13,9692
00947,台新臺灣IC設計,42,0,42,富邦-嘉義,2024-06-13,9692
3312,弘憶股,98,60,38,富邦-嘉義,2024-06-13,9692
2359,所羅門,578,540,38,富邦-嘉義,2024-06-13,9692
6152,百一,39,2,37,富邦-嘉義,2024-06-13,9692
00892,富邦台灣半導體,65,28,37,富邦-嘉義,2024-06-13,9692
5258,虹堡,61,26,35,富邦-嘉義,2024-06-13,9692
2324,仁寶,39,5,34,富邦-嘉義,2024-06-13,9692
2313,華通,42,9,33,富邦-嘉義,2024-06-13,9692
00937B,群益ESG投等債20,146,114,32,富邦-嘉義,2024-06-13,9692
1447,力鵬,42,11,31,富邦-嘉義,2024-06-13,9692
8906,花王,45,14,31,富邦-嘉義,2024-06-13,9692
2353,宏��,64,37,27,富邦-嘉義,2024-06-13,9692
6188,廣明,29,3,26,富邦-嘉義,2024-06-13,9692
2882,國泰金,31,5,26,富邦-嘉義,2024-06-13,9692
6207,雷科,148,124,24,富邦-嘉義,2024-06-13,9692
3030,德律,30,6,24,富邦-嘉義,2024-06-13,9692
00946,群益科技高息成長,39,17,22,富邦-嘉義,2024-06-13,9692
4534,慶騰,22,0,22,富邦-嘉義,2024-06-13,9692
5871,中租-KY,22,2,20,富邦-嘉義,2024-06-13,9692
00637L,元大滬深300正2,28,8,20,富邦-嘉義,2024-06-13,9692
3047,訊舟,38,18,20,富邦-嘉義,2024-06-13,9692
00948B,中信優息投資級債,636,4,632,富邦-嘉義,2024-06-14,9692
2025,千興,248,11,237,富邦-嘉義,2024-06-14,9692
2486,一詮,1039,802,237,富邦-嘉義,2024-06-14,9692
00919,群益台灣精選高息,276,41,235,富邦-嘉義,2024-06-14,9692
9105,泰金寶-DR,2607,2376,231,富邦-嘉義,2024-06-14,9692
00673R,期元大S＆P原油反1,210,0,210,富邦-嘉義,2024-06-14,9692
1618,合機,224,43,181,富邦-嘉義,2024-06-14,9692
3622,洋華,387,223,164,富邦-嘉義,2024-06-14,9692
1514,亞力,693,545,148,富邦-嘉義,2024-06-14,9692
2371,大同,296,200,96,富邦-嘉義,2024-06-14,9692
1587,吉茂,138,49,89,富邦-嘉義,2024-06-14,9692
3710,連展投控,100,23,77,富邦-嘉義,2024-06-14,9692
6116,彩晶,69,4,65,富邦-嘉義,2024-06-14,9692
00937B,群益ESG投等債20,353,289,64,富邦-嘉義,2024-06-14,9692
2002,中鋼,94,36,58,富邦-嘉義,2024-06-14,9692
2303,聯電,81,25,56,富邦-嘉義,2024-06-14,9692
00946,群益科技高息成長,53,0,53,富邦-嘉義,2024-06-14,9692
1503,士電,86,33,53,富邦-嘉義,2024-06-14,9692
3056,富華新,50,0,50,富邦-嘉義,2024-06-14,9692
1722,台肥,58,10,48,富邦-嘉義,2024-06-14,9692
3122,笙泉,114,68,46,富邦-嘉義,2024-06-14,9692
3712,永崴投控,50,5,45,富邦-嘉義,2024-06-14,9692
5880,合庫金,45,1,44,富邦-嘉義,2024-06-14,9692
4534,慶騰,67,23,44,富邦-嘉義,2024-06-14,9692
6197,佳必琪,338,295,43,富邦-嘉義,2024-06-14,9692
4960,誠美材,48,5,43,富邦-嘉義,2024-06-14,9692
2313,華通,50,8,42,富邦-嘉義,2024-06-14,9692
00936,台新永續高息中小,48,7,41,富邦-嘉義,2024-06-14,9692
00878,國泰永續高股息,68,29,39,富邦-嘉義,2024-06-14,9692
3037,欣興,41,3,38,富邦-嘉義,2024-06-14,9692
2383,台光電,52,14,38,富邦-嘉義,2024-06-14,9692
8096,擎亞,687,650,37,富邦-嘉義,2024-06-14,9692
00632R,元大台灣50反1,237,200,37,富邦-嘉義,2024-06-14,9692
2022,聚亨,36,1,35,富邦-嘉義,2024-06-14,9692
5230,雷笛克光學,43,8,35,富邦-嘉義,2024-06-14,9692
2609,陽明,364,329,35,富邦-嘉義,2024-06-14,9692
9904,寶成,31,0,31,富邦-嘉義,2024-06-14,9692
00942B,台新美A公司債20+,30,2,28,富邦-嘉義,2024-06-14,9692
2897,王道銀行,29,2,27,富邦-嘉義,2024-06-14,9692
1301,台塑,31,4,27,富邦-嘉義,2024-06-14,9692
00944,野村趨勢動能高息,37,10,27,富邦-嘉義,2024-06-14,9692
00947,台新臺灣IC設計,46,20,26,富邦-嘉義,2024-06-14,9692
6005,群益證,28,3,25,富邦-嘉義,2024-06-14,9692
3501,維熹,30,5,25,富邦-嘉義,2024-06-14,9692
2603,長榮,191,166,25,富邦-嘉義,2024-06-14,9692
6187,萬潤,41,17,24,富邦-嘉義,2024-06-14,9692
2506,太設,27,3,24,富邦-嘉義,2024-06-14,9692
6161,捷波,231,208,23,富邦-嘉義,2024-06-14,9692
3715,定穎投控,24,2,22,富邦-嘉義,2024-06-14,9692
1313,聯成,100,78,22,富邦-嘉義,2024-06-14,9692
1815,富喬,1350,787,563,富邦-嘉義,2024-06-17,9692
8096,擎亞,689,263,426,富邦-嘉義,2024-06-17,9692
00948B,中信優息投資級債,314,35,279,富邦-嘉義,2024-06-17,9692
00673R,期元大S＆P原油反1,260,0,260,富邦-嘉義,2024-06-17,9692
3048,益登,473,242,231,富邦-嘉義,2024-06-17,9692
2371,大同,2703,2492,211,富邦-嘉義,2024-06-17,9692
00679B,元大美債20年,231,25,206,富邦-嘉義,2024-06-17,9692
6706,惠特,216,22,194,富邦-嘉義,2024-06-17,9692
2365,昆盈,289,102,187,富邦-嘉義,2024-06-17,9692
00918,大華優利高填息30,203,16,187,富邦-嘉義,2024-06-17,9692
9105,泰金寶-DR,281,97,184,富邦-嘉義,2024-06-17,9692
00929,復華台灣科技優息,239,94,145,富邦-嘉義,2024-06-17,9692
00946,群益科技高息成長,138,2,136,富邦-嘉義,2024-06-17,9692
2615,萬海,309,186,123,富邦-嘉義,2024-06-17,9692
2897,王道銀行,119,0,119,富邦-嘉義,2024-06-17,9692
00936,台新永續高息中小,136,21,115,富邦-嘉義,2024-06-17,9692
4534,慶騰,153,50,103,富邦-嘉義,2024-06-17,9692
1313,聯成,101,0,101,富邦-嘉義,2024-06-17,9692
2002,中鋼,84,9,75,富邦-嘉義,2024-06-17,9692
2392,正崴,123,59,64,富邦-嘉義,2024-06-17,9692
00712,復華富時不動產,62,0,62,富邦-嘉義,2024-06-17,9692
00687B,國泰20年美債,70,9,61,富邦-嘉義,2024-06-17,9692
2515,中工,62,1,61,富邦-嘉義,2024-06-17,9692
5258,虹堡,101,41,60,富邦-嘉義,2024-06-17,9692
6834,天二科技,60,0,60,富邦-嘉義,2024-06-17,9692
2359,所羅門,235,177,58,富邦-嘉義,2024-06-17,9692
8039,台虹,65,10,55,富邦-嘉義,2024-06-17,9692
00919,群益台灣精選高息,87,36,51,富邦-嘉義,2024-06-17,9692
2317,鴻海,1008,960,48,富邦-嘉義,2024-06-17,9692
3379,彬台,68,21,47,富邦-嘉義,2024-06-17,9692
00941,中信上游半導體,49,6,43,富邦-嘉義,2024-06-17,9692
1101,台泥,49,7,42,富邦-嘉義,2024-06-17,9692
1522,堤維西,45,3,42,富邦-嘉義,2024-06-17,9692
1608,華榮,87,46,41,富邦-嘉義,2024-06-17,9692
2101,南港,54,14,40,富邦-嘉義,2024-06-17,9692
1616,億泰,181,141,40,富邦-嘉義,2024-06-17,9692
2618,長榮航,576,538,38,富邦-嘉義,2024-06-17,9692
5243,乙盛-KY,55,17,38,富邦-嘉義,2024-06-17,9692
00680L,元大美債20正2,42,4,38,富邦-嘉義,2024-06-17,9692
00933B,國泰10Y+金融債,46,9,37,富邦-嘉義,2024-06-17,9692
2881,富邦金,37,2,35,富邦-嘉義,2024-06-17,9692
1609,大亞,101,66,35,富邦-嘉義,2024-06-17,9692
3056,富華新,35,1,34,富邦-嘉義,2024-06-17,9692
2360,致茂,52,19,33,富邦-嘉義,2024-06-17,9692
5490,同亨,79,48,31,富邦-嘉義,2024-06-17,9692
00945B,凱基美國非投等債,30,0,30,富邦-嘉義,2024-06-17,9692
1605,華新,31,1,30,富邦-嘉義,2024-06-17,9692
8064,東捷,79,50,29,富邦-嘉義,2024-06-17,9692
2351,順德,35,7,28,富邦-嘉義,2024-06-17,9692
00753L,中信中國50正2,37,12,25,富邦-嘉義,2024-06-17,9692
6770,力積電,472,48,424,富邦-嘉義,2024-06-18,9692
3450,聯鈞,609,352,257,富邦-嘉義,2024-06-18,9692
6190,萬泰科,214,21,193,富邦-嘉義,2024-06-18,9692
3062,建漢,309,135,174,富邦-嘉義,2024-06-18,9692
4561,健椿,630,466,164,富邦-嘉義,2024-06-18,9692
3481,群創,231,99,132,富邦-嘉義,2024-06-18,9692
3048,益登,449,326,123,富邦-嘉義,2024-06-18,9692
00679B,元大美債20年,142,32,110,富邦-嘉義,2024-06-18,9692
3122,笙泉,129,22,107,富邦-嘉義,2024-06-18,9692
00751B,元大AAA至A公司債,129,23,106,富邦-嘉義,2024-06-18,9692
3312,弘憶股,465,359,106,富邦-嘉義,2024-06-18,9692
6152,百一,152,48,104,富邦-嘉義,2024-06-18,9692
1313,聯成,100,0,100,富邦-嘉義,2024-06-18,9692
9105,泰金寶-DR,267,175,92,富邦-嘉義,2024-06-18,9692
2025,千興,106,17,89,富邦-嘉義,2024-06-18,9692
6197,佳必琪,148,62,86,富邦-嘉義,2024-06-18,9692
4534,慶騰,155,78,77,富邦-嘉義,2024-06-18,9692
00929,復華台灣科技優息,202,125,77,富邦-嘉義,2024-06-18,9692
2365,昆盈,202,128,74,富邦-嘉義,2024-06-18,9692
3665,貿聯-KY,70,1,69,富邦-嘉義,2024-06-18,9692
00713,元大台灣高息低波,69,0,69,富邦-嘉義,2024-06-18,9692
5443,均豪,194,127,67,富邦-嘉義,2024-06-18,9692
6451,訊芯-KY,172,107,65,富邦-嘉義,2024-06-18,9692
00948B,中信優息投資級債,61,0,61,富邦-嘉義,2024-06-18,9692
00673R,期元大S＆P原油反1,61,0,61,富邦-嘉義,2024-06-18,9692
00687B,國泰20年美債,60,0,60,富邦-嘉義,2024-06-18,9692
8358,金居,66,7,59,富邦-嘉義,2024-06-18,9692
3287,廣寰科,243,186,57,富邦-嘉義,2024-06-18,9692
2367,燿華,83,27,56,富邦-嘉義,2024-06-18,9692
5474,聰泰,93,43,50,富邦-嘉義,2024-06-18,9692
3374,精材,83,34,49,富邦-嘉義,2024-06-18,9692
4903,聯光通,49,1,48,富邦-嘉義,2024-06-18,9692
5371,中光電,54,7,47,富邦-嘉義,2024-06-18,9692
00918,大華優利高填息30,97,52,45,富邦-嘉義,2024-06-18,9692
1504,東元,98,55,43,富邦-嘉義,2024-06-18,9692
1785,光洋科,82,39,43,富邦-嘉義,2024-06-18,9692
2363,矽統,100,57,43,富邦-嘉義,2024-06-18,9692
2353,宏��,53,12,41,富邦-嘉義,2024-06-18,9692
2374,佳能,52,11,41,富邦-嘉義,2024-06-18,9692
3710,連展投控,39,2,37,富邦-嘉義,2024-06-18,9692
00712,復華富時不動產,47,11,36,富邦-嘉義,2024-06-18,9692
00933B,國泰10Y+金融債,80,44,36,富邦-嘉義,2024-06-18,9692
4532,瑞智,35,0,35,富邦-嘉義,2024-06-18,9692
6026,福邦證,35,1,34,富邦-嘉義,2024-06-18,9692
1301,台塑,36,4,32,富邦-嘉義,2024-06-18,9692
6117,迎廣,43,11,32,富邦-嘉義,2024-06-18,9692
3372,典範,331,300,31,富邦-嘉義,2024-06-18,9692
00720B,元大投資級公司債,45,16,29,富邦-嘉義,2024-06-18,9692
2020,美亞,30,1,29,富邦-嘉義,2024-06-18,9692
6265,方土昶,29,1,28,富邦-嘉義,2024-06-18,9692
2486,一詮,1023,514,509,富邦-嘉義,2024-06-19,9692
00673R,期元大S＆P原油反1,495,0,495,富邦-嘉義,2024-06-19,9692
2382,廣達,1714,1244,470,富邦-嘉義,2024-06-19,9692
00751B,元大AAA至A公司債,423,2,421,富邦-嘉義,2024-06-19,9692
4909,新復興,555,219,336,富邦-嘉義,2024-06-19,9692
00919,群益台灣精選高息,455,156,299,富邦-嘉義,2024-06-19,9692
2367,燿華,320,26,294,富邦-嘉義,2024-06-19,9692
00918,大華優利高填息30,288,14,274,富邦-嘉義,2024-06-19,9692
4526,東台,189,17,172,富邦-嘉義,2024-06-19,9692
00937B,群益ESG投等債20,230,72,158,富邦-嘉義,2024-06-19,9692
2834,臺企銀,174,35,139,富邦-嘉義,2024-06-19,9692
1314,中石化,175,50,125,富邦-嘉義,2024-06-19,9692
00712,復華富時不動產,130,8,122,富邦-嘉義,2024-06-19,9692
3576,聯合再生,112,0,112,富邦-嘉義,2024-06-19,9692
00857B,永豐20年美公債,104,1,103,富邦-嘉義,2024-06-19,9692
2014,中鴻,101,13,88,富邦-嘉義,2024-06-19,9692
2618,長榮航,260,176,84,富邦-嘉義,2024-06-19,9692
00929,復華台灣科技優息,244,162,82,富邦-嘉義,2024-06-19,9692
6015,宏遠證,91,11,80,富邦-嘉義,2024-06-19,9692
00936,台新永續高息中小,83,10,73,富邦-嘉義,2024-06-19,9692
1313,聯成,67,0,67,富邦-嘉義,2024-06-19,9692
3047,訊舟,71,8,63,富邦-嘉義,2024-06-19,9692
8358,金居,87,26,61,富邦-嘉義,2024-06-19,9692
00713,元大台灣高息低波,62,1,61,富邦-嘉義,2024-06-19,9692
8096,擎亞,315,257,58,富邦-嘉義,2024-06-19,9692
6216,居易,160,102,58,富邦-嘉義,2024-06-19,9692
2882,國泰金,77,20,57,富邦-嘉義,2024-06-19,9692
2303,聯電,86,33,53,富邦-嘉義,2024-06-19,9692
4545,銘鈺,341,294,47,富邦-嘉義,2024-06-19,9692
00753L,中信中國50正2,60,13,47,富邦-嘉義,2024-06-19,9692
00946,群益科技高息成長,96,50,46,富邦-嘉義,2024-06-19,9692
00665L,富邦�琤肭磪囓�2,347,304,43,富邦-嘉義,2024-06-19,9692
3033,威健,64,21,43,富邦-嘉義,2024-06-19,9692
6213,聯茂,44,3,41,富邦-嘉義,2024-06-19,9692
2409,友達,67,26,41,富邦-嘉義,2024-06-19,9692
6282,康舒,59,19,40,富邦-嘉義,2024-06-19,9692
1802,台玻,52,13,39,富邦-嘉義,2024-06-19,9692
6180,橘子,36,1,35,富邦-嘉義,2024-06-19,9692
1514,亞力,126,91,35,富邦-嘉義,2024-06-19,9692
1319,東陽,34,0,34,富邦-嘉義,2024-06-19,9692
1301,台塑,73,42,31,富邦-嘉義,2024-06-19,9692
00945B,凱基美國非投等債,30,0,30,富邦-嘉義,2024-06-19,9692
1618,合機,68,38,30,富邦-嘉義,2024-06-19,9692
8112,至上,34,5,29,富邦-嘉義,2024-06-19,9692
3715,定穎投控,32,4,28,富邦-嘉義,2024-06-19,9692
8070,長華*,31,6,25,富邦-嘉義,2024-06-19,9692
00907,永豐優息存股,25,0,25,富邦-嘉義,2024-06-19,9692
2836,高雄銀,30,5,25,富邦-嘉義,2024-06-19,9692
2888,新光金,394,370,24,富邦-嘉義,2024-06-19,9692
1615,大山,24,0,24,富邦-嘉義,2024-06-19,9692
00751B,元大AAA至A公司債,717,0,717,富邦-嘉義,2024-06-20,9692
9105,泰金寶-DR,480,116,364,富邦-嘉義,2024-06-20,9692
00687B,國泰20年美債,376,38,338,富邦-嘉義,2024-06-20,9692
2888,新光金,346,64,282,富邦-嘉義,2024-06-20,9692
3450,聯鈞,391,126,265,富邦-嘉義,2024-06-20,9692
00948B,中信優息投資級債,266,2,264,富邦-嘉義,2024-06-20,9692
00679B,元大美債20年,209,8,201,富邦-嘉義,2024-06-20,9692
00919,群益台灣精選高息,250,63,187,富邦-嘉義,2024-06-20,9692
4562,穎漢,980,797,183,富邦-嘉義,2024-06-20,9692
00936,台新永續高息中小,185,2,183,富邦-嘉義,2024-06-20,9692
2615,萬海,328,160,168,富邦-嘉義,2024-06-20,9692
6770,力積電,376,210,166,富邦-嘉義,2024-06-20,9692
2801,彰銀,162,3,159,富邦-嘉義,2024-06-20,9692
6695,芯鼎,192,58,134,富邦-嘉義,2024-06-20,9692
3297,杭特,154,38,116,富邦-嘉義,2024-06-20,9692
00946,群益科技高息成長,132,17,115,富邦-嘉義,2024-06-20,9692
3030,德律,119,4,115,富邦-嘉義,2024-06-20,9692
00933B,國泰10Y+金融債,170,57,113,富邦-嘉義,2024-06-20,9692
1605,華新,119,8,111,富邦-嘉義,2024-06-20,9692
6472,保瑞,116,8,108,富邦-嘉義,2024-06-20,9692
00673R,期元大S＆P原油反1,103,0,103,富邦-嘉義,2024-06-20,9692
8054,安國,136,33,103,富邦-嘉義,2024-06-20,9692
3483,力致,279,185,94,富邦-嘉義,2024-06-20,9692
3081,聯亞,130,40,90,富邦-嘉義,2024-06-20,9692
3048,益登,149,60,89,富邦-嘉義,2024-06-20,9692
6282,康舒,78,17,61,富邦-嘉義,2024-06-20,9692
2542,興富發,73,15,58,富邦-嘉義,2024-06-20,9692
5864,致和證,57,0,57,富邦-嘉義,2024-06-20,9692
8374,羅昇,423,369,54,富邦-嘉義,2024-06-20,9692
00929,復華台灣科技優息,303,256,47,富邦-嘉義,2024-06-20,9692
3231,緯創,95,49,46,富邦-嘉義,2024-06-20,9692
2349,錸德,64,18,46,富邦-嘉義,2024-06-20,9692
8027,鈦昇,179,133,46,富邦-嘉義,2024-06-20,9692
6441,廣錠,46,1,45,富邦-嘉義,2024-06-20,9692
2323,中環,54,10,44,富邦-嘉義,2024-06-20,9692
00650L,復華香港正2,50,7,43,富邦-嘉義,2024-06-20,9692
8103,瀚荃,93,50,43,富邦-嘉義,2024-06-20,9692
00907,永豐優息存股,41,0,41,富邦-嘉義,2024-06-20,9692
8028,昇陽半導體,121,82,39,富邦-嘉義,2024-06-20,9692
4958,臻鼎-KY,51,15,36,富邦-嘉義,2024-06-20,9692
2498,宏達電,153,117,36,富邦-嘉義,2024-06-20,9692
5443,均豪,110,75,35,富邦-嘉義,2024-06-20,9692
2353,宏��,68,33,35,富邦-嘉義,2024-06-20,9692
5533,皇鼎,35,0,35,富邦-嘉義,2024-06-20,9692
8354,冠好,54,20,34,富邦-嘉義,2024-06-20,9692
1313,聯成,33,0,33,富邦-嘉義,2024-06-20,9692
00941,中信上游半導體,38,8,30,富邦-嘉義,2024-06-20,9692
6451,訊芯-KY,156,126,30,富邦-嘉義,2024-06-20,9692
2897,王道銀行,30,2,28,富邦-嘉義,2024-06-20,9692
2330,台積電,39,12,27,富邦-嘉義,2024-06-20,9692
3481,群創,19950,11871,8079,富邦-嘉義,2024-06-21,9692
1815,富喬,1595,107,1488,富邦-嘉義,2024-06-21,9692
2367,燿華,867,0,867,富邦-嘉義,2024-06-21,9692
4956,光鋐,612,121,491,富邦-嘉義,2024-06-21,9692
3047,訊舟,1132,663,469,富邦-嘉義,2024-06-21,9692
9105,泰金寶-DR,801,405,396,富邦-嘉義,2024-06-21,9692
00936,台新永續高息中小,262,0,262,富邦-嘉義,2024-06-21,9692
00937B,群益ESG投等債20,375,162,213,富邦-嘉義,2024-06-21,9692
2607,榮運,210,2,208,富邦-嘉義,2024-06-21,9692
3062,建漢,758,551,207,富邦-嘉義,2024-06-21,9692
00929,復華台灣科技優息,281,77,204,富邦-嘉義,2024-06-21,9692
2349,錸德,276,74,202,富邦-嘉義,2024-06-21,9692
3056,富華新,200,1,199,富邦-嘉義,2024-06-21,9692
00940,元大台灣價值高息,232,52,180,富邦-嘉義,2024-06-21,9692
8064,東捷,981,828,153,富邦-嘉義,2024-06-21,9692
2382,廣達,363,213,150,富邦-嘉義,2024-06-21,9692
00632R,元大台灣50反1,144,12,132,富邦-嘉義,2024-06-21,9692
00673R,期元大S＆P原油反1,102,0,102,富邦-嘉義,2024-06-21,9692
2317,鴻海,1195,1093,102,富邦-嘉義,2024-06-21,9692
00933B,國泰10Y+金融債,98,0,98,富邦-嘉義,2024-06-21,9692
1301,台塑,124,26,98,富邦-嘉義,2024-06-21,9692
3289,宜特,117,23,94,富邦-嘉義,2024-06-21,9692
2801,彰銀,93,3,90,富邦-嘉義,2024-06-21,9692
2365,昆盈,421,337,84,富邦-嘉義,2024-06-21,9692
00946,群益科技高息成長,84,4,80,富邦-嘉義,2024-06-21,9692
5014,建錩,80,2,78,富邦-嘉義,2024-06-21,9692
2515,中工,139,63,76,富邦-嘉義,2024-06-21,9692
00687B,國泰20年美債,78,3,75,富邦-嘉義,2024-06-21,9692
2014,中鴻,60,0,60,富邦-嘉義,2024-06-21,9692
3715,定穎投控,59,0,59,富邦-嘉義,2024-06-21,9692
6706,惠特,158,101,57,富邦-嘉義,2024-06-21,9692
5864,致和證,63,6,57,富邦-嘉義,2024-06-21,9692
6770,力積電,131,75,56,富邦-嘉義,2024-06-21,9692
2897,王道銀行,56,0,56,富邦-嘉義,2024-06-21,9692
2609,陽明,522,469,53,富邦-嘉義,2024-06-21,9692
2313,華通,86,35,51,富邦-嘉義,2024-06-21,9692
8093,保銳,52,9,43,富邦-嘉義,2024-06-21,9692
6197,佳必琪,252,211,41,富邦-嘉義,2024-06-21,9692
2501,國建,42,2,40,富邦-嘉義,2024-06-21,9692
2354,鴻準,82,43,39,富邦-嘉義,2024-06-21,9692
1612,宏泰,44,7,37,富邦-嘉義,2024-06-21,9692
3580,友威科,85,48,37,富邦-嘉義,2024-06-21,9692
00947,台新臺灣IC設計,36,0,36,富邦-嘉義,2024-06-21,9692
2498,宏達電,65,31,34,富邦-嘉義,2024-06-21,9692
00939,統一台灣高息動能,78,44,34,富邦-嘉義,2024-06-21,9692
00753L,中信中國50正2,33,0,33,富邦-嘉義,2024-06-21,9692
4534,慶騰,56,24,32,富邦-嘉義,2024-06-21,9692
3532,台勝科,30,2,28,富邦-嘉義,2024-06-21,9692
00720B,元大投資級公司債,34,6,28,富邦-嘉義,2024-06-21,9692
2548,華固,27,0,27,富邦-嘉義,2024-06-21,9692
00929,復華台灣科技優息,818,254,564,富邦-嘉義,2024-06-24,9692
2356,英業達,565,52,513,富邦-嘉義,2024-06-24,9692
8110,華東,617,105,512,富邦-嘉義,2024-06-24,9692
00937B,群益ESG投等債20,279,32,247,富邦-嘉義,2024-06-24,9692
2367,燿華,261,15,246,富邦-嘉義,2024-06-24,9692
00919,群益台灣精選高息,537,302,235,富邦-嘉義,2024-06-24,9692
2014,中鴻,202,3,199,富邦-嘉義,2024-06-24,9692
2313,華通,233,44,189,富邦-嘉義,2024-06-24,9692
2409,友達,293,137,156,富邦-嘉義,2024-06-24,9692
2303,聯電,185,41,144,富邦-嘉義,2024-06-24,9692
00936,台新永續高息中小,141,0,141,富邦-嘉義,2024-06-24,9692
2002,中鋼,128,16,112,富邦-嘉義,2024-06-24,9692
3535,晶彩科,245,141,104,富邦-嘉義,2024-06-24,9692
3049,精金,104,4,100,富邦-嘉義,2024-06-24,9692
6152,百一,124,26,98,富邦-嘉義,2024-06-24,9692
00946,群益科技高息成長,99,6,93,富邦-嘉義,2024-06-24,9692
2369,菱生,164,80,84,富邦-嘉義,2024-06-24,9692
5328,華容,992,910,82,富邦-嘉義,2024-06-24,9692
00948B,中信優息投資級債,77,0,77,富邦-嘉義,2024-06-24,9692
5905,南仁湖,75,0,75,富邦-嘉義,2024-06-24,9692
3652,精聯,83,10,73,富邦-嘉義,2024-06-24,9692
5512,力麒,78,9,69,富邦-嘉義,2024-06-24,9692
3048,益登,97,33,64,富邦-嘉義,2024-06-24,9692
1605,華新,72,9,63,富邦-嘉義,2024-06-24,9692
3663,鑫科,160,99,61,富邦-嘉義,2024-06-24,9692
2615,萬海,181,121,60,富邦-嘉義,2024-06-24,9692
2897,王道銀行,60,0,60,富邦-嘉義,2024-06-24,9692
00918,大華優利高填息30,86,32,54,富邦-嘉義,2024-06-24,9692
1785,光洋科,173,120,53,富邦-嘉義,2024-06-24,9692
5351,鈺創,73,20,53,富邦-嘉義,2024-06-24,9692
00687B,國泰20年美債,118,66,52,富邦-嘉義,2024-06-24,9692
1301,台塑,67,15,52,富邦-嘉義,2024-06-24,9692
6431,光麗-KY,51,0,51,富邦-嘉義,2024-06-24,9692
3406,玉晶光,57,9,48,富邦-嘉義,2024-06-24,9692
2353,宏��,65,18,47,富邦-嘉義,2024-06-24,9692
2347,聯強,86,40,46,富邦-嘉義,2024-06-24,9692
5014,建錩,45,0,45,富邦-嘉義,2024-06-24,9692
00680L,元大美債20正2,45,0,45,富邦-嘉義,2024-06-24,9692
2359,所羅門,70,29,41,富邦-嘉義,2024-06-24,9692
2101,南港,39,0,39,富邦-嘉義,2024-06-24,9692
3231,緯創,65,27,38,富邦-嘉義,2024-06-24,9692
8027,鈦昇,46,8,38,富邦-嘉義,2024-06-24,9692
2609,陽明,618,582,36,富邦-嘉義,2024-06-24,9692
4306,炎洲,35,0,35,富邦-嘉義,2024-06-24,9692
2834,臺企銀,61,26,35,富邦-嘉義,2024-06-24,9692
3016,嘉晶,37,3,34,富邦-嘉義,2024-06-24,9692
5880,合庫金,34,0,34,富邦-嘉義,2024-06-24,9692
1725,元禎,34,0,34,富邦-嘉義,2024-06-24,9692
4534,慶騰,83,50,33,富邦-嘉義,2024-06-24,9692
00933B,國泰10Y+金融債,67,35,32,富邦-嘉義,2024-06-24,9692
912000,晨訊科-DR,704,23,681,富邦-嘉義,2024-06-25,9692
00632R,元大台灣50反1,419,33,386,富邦-嘉義,2024-06-25,9692
2439,美律,304,3,301,富邦-嘉義,2024-06-25,9692
00929,復華台灣科技優息,527,281,246,富邦-嘉義,2024-06-25,9692
5452,佶優,247,59,188,富邦-嘉義,2024-06-25,9692
00936,台新永續高息中小,194,18,176,富邦-嘉義,2024-06-25,9692
1815,富喬,1075,903,172,富邦-嘉義,2024-06-25,9692
2344,華邦電,129,5,124,富邦-嘉義,2024-06-25,9692
00946,群益科技高息成長,137,15,122,富邦-嘉義,2024-06-25,9692
2409,友達,130,10,120,富邦-嘉義,2024-06-25,9692
911868,同方友友-DR,122,2,120,富邦-嘉義,2024-06-25,9692
2323,中環,110,2,108,富邦-嘉義,2024-06-25,9692
2014,中鴻,108,3,105,富邦-嘉義,2024-06-25,9692
6695,芯鼎,237,136,101,富邦-嘉義,2024-06-25,9692
2801,彰銀,100,5,95,富邦-嘉義,2024-06-25,9692
2610,華航,134,39,95,富邦-嘉義,2024-06-25,9692
1605,華新,95,5,90,富邦-嘉義,2024-06-25,9692
00919,群益台灣精選高息,227,150,77,富邦-嘉義,2024-06-25,9692
00937B,群益ESG投等債20,106,37,69,富邦-嘉義,2024-06-25,9692
3297,杭特,105,36,69,富邦-嘉義,2024-06-25,9692
4526,東台,197,129,68,富邦-嘉義,2024-06-25,9692
6116,彩晶,72,8,64,富邦-嘉義,2024-06-25,9692
2406,國碩,194,132,62,富邦-嘉義,2024-06-25,9692
2002,中鋼,60,4,56,富邦-嘉義,2024-06-25,9692
3231,緯創,1059,1012,47,富邦-嘉義,2024-06-25,9692
8374,羅昇,278,236,42,富邦-嘉義,2024-06-25,9692
1314,中石化,113,72,41,富邦-嘉義,2024-06-25,9692
4534,慶騰,87,47,40,富邦-嘉義,2024-06-25,9692
3008,大立光,50,10,40,富邦-嘉義,2024-06-25,9692
2542,興富發,52,15,37,富邦-嘉義,2024-06-25,9692
5468,凱鈺,33,0,33,富邦-嘉義,2024-06-25,9692
3047,訊舟,113,81,32,富邦-嘉義,2024-06-25,9692
00935,野村臺灣新科技50,30,0,30,富邦-嘉義,2024-06-25,9692
9945,潤泰新,31,1,30,富邦-嘉義,2024-06-25,9692
1514,亞力,320,291,29,富邦-嘉義,2024-06-25,9692
6265,方土昶,30,1,29,富邦-嘉義,2024-06-25,9692
3016,嘉晶,30,1,29,富邦-嘉義,2024-06-25,9692
2449,京元電子,126,98,28,富邦-嘉義,2024-06-25,9692
3037,欣興,36,9,27,富邦-嘉義,2024-06-25,9692
2618,長榮航,65,40,25,富邦-嘉義,2024-06-25,9692
4414,如興,25,0,25,富邦-嘉義,2024-06-25,9692
00720B,元大投資級公司債,26,2,24,富邦-嘉義,2024-06-25,9692
2317,鴻海,1834,1810,24,富邦-嘉義,2024-06-25,9692
6869,雲豹能源,141,118,23,富邦-嘉義,2024-06-25,9692
2485,兆赫,23,0,23,富邦-嘉義,2024-06-25,9692
3624,光頡,35,13,22,富邦-嘉義,2024-06-25,9692
1305,華夏,21,0,21,富邦-嘉義,2024-06-25,9692
6180,橘子,22,1,21,富邦-嘉義,2024-06-25,9692
2365,昆盈,108,87,21,富邦-嘉義,2024-06-25,9692
2347,聯強,50,29,21,富邦-嘉義,2024-06-25,9692
3047,訊舟,1322,474,848,富邦-嘉義,2024-06-26,9692
00929,復華台灣科技優息,583,122,461,富邦-嘉義,2024-06-26,9692
1709,和益,417,101,316,富邦-嘉義,2024-06-26,9692
4167,松瑞藥,490,264,226,富邦-嘉義,2024-06-26,9692
2888,新光金,262,41,221,富邦-嘉義,2024-06-26,9692
2367,燿華,172,18,154,富邦-嘉義,2024-06-26,9692
00673R,期元大S＆P原油反1,131,0,131,富邦-嘉義,2024-06-26,9692
00946,群益科技高息成長,116,0,116,富邦-嘉義,2024-06-26,9692
2014,中鴻,144,29,115,富邦-嘉義,2024-06-26,9692
2002,中鋼,136,22,114,富邦-嘉義,2024-06-26,9692
3312,弘憶股,286,179,107,富邦-嘉義,2024-06-26,9692
6472,保瑞,103,5,98,富邦-嘉義,2024-06-26,9692
5443,均豪,522,429,93,富邦-嘉義,2024-06-26,9692
2409,友達,150,60,90,富邦-嘉義,2024-06-26,9692
2344,華邦電,193,103,90,富邦-嘉義,2024-06-26,9692
3580,友威科,218,130,88,富邦-嘉義,2024-06-26,9692
4153,鈺緯,83,3,80,富邦-嘉義,2024-06-26,9692
00937B,群益ESG投等債20,117,38,79,富邦-嘉義,2024-06-26,9692
00933B,國泰10Y+金融債,113,38,75,富邦-嘉義,2024-06-26,9692
4956,光鋐,89,15,74,富邦-嘉義,2024-06-26,9692
00878,國泰永續高股息,86,13,73,富邦-嘉義,2024-06-26,9692
2834,臺企銀,72,0,72,富邦-嘉義,2024-06-26,9692
00753L,中信中國50正2,71,0,71,富邦-嘉義,2024-06-26,9692
3581,博磊,172,103,69,富邦-嘉義,2024-06-26,9692
6869,雲豹能源,110,43,67,富邦-嘉義,2024-06-26,9692
3149,正達,112,45,67,富邦-嘉義,2024-06-26,9692
8076,伍豐,209,143,66,富邦-嘉義,2024-06-26,9692
2349,錸德,109,46,63,富邦-嘉義,2024-06-26,9692
2883,凱基金,78,16,62,富邦-嘉義,2024-06-26,9692
6116,彩晶,73,12,61,富邦-嘉義,2024-06-26,9692
6197,佳必琪,71,13,58,富邦-嘉義,2024-06-26,9692
2882,國泰金,61,4,57,富邦-嘉義,2024-06-26,9692
00936,台新永續高息中小,56,0,56,富邦-嘉義,2024-06-26,9692
2354,鴻準,91,36,55,富邦-嘉義,2024-06-26,9692
00632R,元大台灣50反1,149,97,52,富邦-嘉義,2024-06-26,9692
2609,陽明,74,24,50,富邦-嘉義,2024-06-26,9692
2867,三商壽,52,2,50,富邦-嘉義,2024-06-26,9692
1815,富喬,173,124,49,富邦-嘉義,2024-06-26,9692
2312,金寶,79,31,48,富邦-嘉義,2024-06-26,9692
2812,台中銀,46,1,45,富邦-嘉義,2024-06-26,9692
4976,佳凌,247,203,44,富邦-嘉義,2024-06-26,9692
2353,宏��,52,9,43,富邦-嘉義,2024-06-26,9692
6806,森崴能源,158,116,42,富邦-嘉義,2024-06-26,9692
3663,鑫科,131,89,42,富邦-嘉義,2024-06-26,9692
5880,合庫金,41,1,40,富邦-嘉義,2024-06-26,9692
912000,晨訊科-DR,200,160,40,富邦-嘉義,2024-06-26,9692
2352,佳世達,47,7,40,富邦-嘉義,2024-06-26,9692
3481,群創,201,162,39,富邦-嘉義,2024-06-26,9692
1301,台塑,46,7,39,富邦-嘉義,2024-06-26,9692
1326,台化,42,6,36,富邦-嘉義,2024-06-26,9692
2367,燿華,793,14,779,富邦-嘉義,2024-06-27,9692
3202,樺晟,590,110,480,富邦-嘉義,2024-06-27,9692
00929,復華台灣科技優息,438,32,406,富邦-嘉義,2024-06-27,9692
00687B,國泰20年美債,302,23,279,富邦-嘉義,2024-06-27,9692
00937B,群益ESG投等債20,438,162,276,富邦-嘉義,2024-06-27,9692
00665L,富邦�琤肭磪囓�2,293,25,268,富邦-嘉義,2024-06-27,9692
00933B,國泰10Y+金融債,162,16,146,富邦-嘉義,2024-06-27,9692
2515,中工,143,2,141,富邦-嘉義,2024-06-27,9692
2344,華邦電,119,2,117,富邦-嘉義,2024-06-27,9692
2014,中鴻,207,91,116,富邦-嘉義,2024-06-27,9692
00919,群益台灣精選高息,276,160,116,富邦-嘉義,2024-06-27,9692
2607,榮運,106,0,106,富邦-嘉義,2024-06-27,9692
00942B,台新美A公司債20+,105,0,105,富邦-嘉義,2024-06-27,9692
1605,華新,108,4,104,富邦-嘉義,2024-06-27,9692
00751B,元大AAA至A公司債,102,0,102,富邦-嘉義,2024-06-27,9692
1714,和桐,100,2,98,富邦-嘉義,2024-06-27,9692
2611,志信,102,5,97,富邦-嘉義,2024-06-27,9692
3481,群創,192,95,97,富邦-嘉義,2024-06-27,9692
00936,台新永續高息中小,106,12,94,富邦-嘉義,2024-06-27,9692
2406,國碩,323,229,94,富邦-嘉義,2024-06-27,9692
2382,廣達,99,7,92,富邦-嘉義,2024-06-27,9692
5905,南仁湖,101,15,86,富邦-嘉義,2024-06-27,9692
2449,京元電子,107,27,80,富邦-嘉義,2024-06-27,9692
2349,錸德,213,135,78,富邦-嘉義,2024-06-27,9692
00679B,元大美債20年,79,1,78,富邦-嘉義,2024-06-27,9692
5475,德宏,76,0,76,富邦-嘉義,2024-06-27,9692
00948B,中信優息投資級債,75,0,75,富邦-嘉義,2024-06-27,9692
00881,國泰台灣5G+,78,3,75,富邦-嘉義,2024-06-27,9692
3501,維熹,72,0,72,富邦-嘉義,2024-06-27,9692
0056,元大高股息,73,4,69,富邦-嘉義,2024-06-27,9692
2885,元大金,65,3,62,富邦-嘉義,2024-06-27,9692
6706,惠特,60,0,60,富邦-嘉義,2024-06-27,9692
00939,統一台灣高息動能,70,13,57,富邦-嘉義,2024-06-27,9692
1514,亞力,240,184,56,富邦-嘉義,2024-06-27,9692
6753,龍德造船,135,83,52,富邦-嘉義,2024-06-27,9692
8421,旭源,50,0,50,富邦-嘉義,2024-06-27,9692
3056,富華新,49,1,48,富邦-嘉義,2024-06-27,9692
2851,中再保,47,0,47,富邦-嘉義,2024-06-27,9692
6244,茂迪,646,599,47,富邦-嘉義,2024-06-27,9692
1785,光洋科,108,62,46,富邦-嘉義,2024-06-27,9692
1722,台肥,45,0,45,富邦-嘉義,2024-06-27,9692
8277,商丞,46,3,43,富邦-嘉義,2024-06-27,9692
2101,南港,44,2,42,富邦-嘉義,2024-06-27,9692
3050,鈺德,130,88,42,富邦-嘉義,2024-06-27,9692
00878,國泰永續高股息,65,24,41,富邦-嘉義,2024-06-27,9692
6598,ABC-KY,41,0,41,富邦-嘉義,2024-06-27,9692
2834,臺企銀,43,2,41,富邦-嘉義,2024-06-27,9692
2883,凱基金,55,16,39,富邦-嘉義,2024-06-27,9692
4909,新復興,89,53,36,富邦-嘉義,2024-06-27,9692
00720B,元大投資級公司債,35,0,35,富邦-嘉義,2024-06-27,9692
2313,華通,665,190,475,富邦-嘉義,2024-06-28,9692
5452,佶優,483,88,395,富邦-嘉義,2024-06-28,9692
00673R,期元大S＆P原油反1,385,0,385,富邦-嘉義,2024-06-28,9692
4562,穎漢,330,40,290,富邦-嘉義,2024-06-28,9692
9105,泰金寶-DR,275,30,245,富邦-嘉義,2024-06-28,9692
00929,復華台灣科技優息,228,4,224,富邦-嘉義,2024-06-28,9692
5443,均豪,418,217,201,富邦-嘉義,2024-06-28,9692
2351,順德,203,8,195,富邦-嘉義,2024-06-28,9692
4534,慶騰,197,5,192,富邦-嘉義,2024-06-28,9692
3481,群創,456,293,163,富邦-嘉義,2024-06-28,9692
8358,金居,161,1,160,富邦-嘉義,2024-06-28,9692
3535,晶彩科,195,38,157,富邦-嘉義,2024-06-28,9692
2359,所羅門,190,34,156,富邦-嘉義,2024-06-28,9692
3576,聯合再生,268,128,140,富邦-嘉義,2024-06-28,9692
2317,鴻海,211,75,136,富邦-嘉義,2024-06-28,9692
2618,長榮航,170,40,130,富邦-嘉義,2024-06-28,9692
8076,伍豐,314,186,128,富邦-嘉義,2024-06-28,9692
3663,鑫科,158,50,108,富邦-嘉義,2024-06-28,9692
8374,羅昇,121,14,107,富邦-嘉義,2024-06-28,9692
2607,榮運,102,0,102,富邦-嘉義,2024-06-28,9692
00936,台新永續高息中小,114,12,102,富邦-嘉義,2024-06-28,9692
2365,昆盈,292,191,101,富邦-嘉義,2024-06-28,9692
3374,精材,104,9,95,富邦-嘉義,2024-06-28,9692
6188,廣明,500,414,86,富邦-嘉義,2024-06-28,9692
00687B,國泰20年美債,108,27,81,富邦-嘉義,2024-06-28,9692
2337,旺宏,81,9,72,富邦-嘉義,2024-06-28,9692
6125,廣運,267,197,70,富邦-嘉義,2024-06-28,9692
00919,群益台灣精選高息,165,97,68,富邦-嘉義,2024-06-28,9692
3048,益登,783,716,67,富邦-嘉義,2024-06-28,9692
2610,華航,154,89,65,富邦-嘉義,2024-06-28,9692
8176,智捷,69,6,63,富邦-嘉義,2024-06-28,9692
2883,凱基金,88,29,59,富邦-嘉義,2024-06-28,9692
00948B,中信優息投資級債,58,0,58,富邦-嘉義,2024-06-28,9692
8071,能率網通,112,55,57,富邦-嘉義,2024-06-28,9692
00679B,元大美債20年,76,23,53,富邦-嘉義,2024-06-28,9692
3312,弘憶股,704,655,49,富邦-嘉義,2024-06-28,9692
6869,雲豹能源,107,59,48,富邦-嘉義,2024-06-28,9692
00937B,群益ESG投等債20,69,22,47,富邦-嘉義,2024-06-28,9692
2637,慧洋-KY,58,14,44,富邦-嘉義,2024-06-28,9692
2303,聯電,93,51,42,富邦-嘉義,2024-06-28,9692
4545,銘鈺,40,0,40,富邦-嘉義,2024-06-28,9692
2409,友達,65,26,39,富邦-嘉義,2024-06-28,9692
6770,力積電,61,23,38,富邦-嘉義,2024-06-28,9692
8085,福華,42,6,36,富邦-嘉義,2024-06-28,9692
00632R,元大台灣50反1,44,8,36,富邦-嘉義,2024-06-28,9692
2408,南亞科,47,12,35,富邦-嘉義,2024-06-28,9692
4526,東台,81,46,35,富邦-嘉義,2024-06-28,9692
00944,野村趨勢動能高息,46,11,35,富邦-嘉義,2024-06-28,9692
2352,佳世達,37,2,35,富邦-嘉義,2024-06-28,9692
2354,鴻準,52,19,33,富邦-嘉義,2024-06-28,9692
00937B,群益ESG投等債20,724,67,657,富邦-嘉義,2024-07-01,9692
2495,普安,425,35,390,富邦-嘉義,2024-07-01,9692
3047,訊舟,1719,1338,381,富邦-嘉義,2024-07-01,9692
00679B,元大美債20年,343,7,336,富邦-嘉義,2024-07-01,9692
8064,東捷,687,429,258,富邦-嘉義,2024-07-01,9692
00687B,國泰20年美債,249,19,230,富邦-嘉義,2024-07-01,9692
00948B,中信優息投資級債,222,2,220,富邦-嘉義,2024-07-01,9692
2313,華通,230,29,201,富邦-嘉義,2024-07-01,9692
0056,元大高股息,166,7,159,富邦-嘉義,2024-07-01,9692
3289,宜特,152,10,142,富邦-嘉義,2024-07-01,9692
00929,復華台灣科技優息,297,179,118,富邦-嘉義,2024-07-01,9692
2014,中鴻,142,34,108,富邦-嘉義,2024-07-01,9692
2317,鴻海,739,635,104,富邦-嘉義,2024-07-01,9692
9105,泰金寶-DR,350,248,102,富邦-嘉義,2024-07-01,9692
1815,富喬,206,105,101,富邦-嘉義,2024-07-01,9692
2834,臺企銀,112,14,98,富邦-嘉義,2024-07-01,9692
3413,京鼎,147,59,88,富邦-嘉義,2024-07-01,9692
00936,台新永續高息中小,83,0,83,富邦-嘉義,2024-07-01,9692
6189,豐藝,194,116,78,富邦-嘉義,2024-07-01,9692
5452,佶優,132,66,66,富邦-嘉義,2024-07-01,9692
8374,羅昇,235,178,57,富邦-嘉義,2024-07-01,9692
2409,友達,58,4,54,富邦-嘉義,2024-07-01,9692
3580,友威科,431,379,52,富邦-嘉義,2024-07-01,9692
8440,綠電,104,52,52,富邦-嘉義,2024-07-01,9692
3535,晶彩科,243,193,50,富邦-嘉義,2024-07-01,9692
00688L,國泰20年美債正2,59,12,47,富邦-嘉義,2024-07-01,9692
00680L,元大美債20正2,46,0,46,富邦-嘉義,2024-07-01,9692
2883,凱基金,59,15,44,富邦-嘉義,2024-07-01,9692
4120,友華,95,51,44,富邦-嘉義,2024-07-01,9692
1781,合世,42,0,42,富邦-嘉義,2024-07-01,9692
1612,宏泰,42,1,41,富邦-嘉義,2024-07-01,9692
3455,由田,84,46,38,富邦-嘉義,2024-07-01,9692
5347,世界,208,170,38,富邦-嘉義,2024-07-01,9692
912000,晨訊科-DR,45,9,36,富邦-嘉義,2024-07-01,9692
6176,瑞儀,35,0,35,富邦-嘉義,2024-07-01,9692
00942B,台新美A公司債20+,36,2,34,富邦-嘉義,2024-07-01,9692
2352,佳世達,156,122,34,富邦-嘉義,2024-07-01,9692
1609,大亞,46,13,33,富邦-嘉義,2024-07-01,9692
00923,群益台ESG低碳50,34,2,32,富邦-嘉義,2024-07-01,9692
8096,擎亞,35,7,28,富邦-嘉義,2024-07-01,9692
2382,廣達,46,17,29,富邦-嘉義,2024-07-01,9692
3379,彬台,28,0,28,富邦-嘉義,2024-07-01,9692
00720B,元大投資級公司債,63,36,27,富邦-嘉義,2024-07-01,9692
00935,野村臺灣新科技50,25,0,25,富邦-嘉義,2024-07-01,9692
9934,成霖,26,1,25,富邦-嘉義,2024-07-01,9692
2438,翔耀,26,1,25,富邦-嘉義,2024-07-01,9692
8085,福華,27,3,24,富邦-嘉義,2024-07-01,9692
2371,大同,43,20,23,富邦-嘉義,2024-07-01,9692
2009,第一銅,25,2,23,富邦-嘉義,2024-07-01,9692
2882,國泰金,57,35,22,富邦-嘉義,2024-07-01,9692
6244,茂迪,2217,1504,713,富邦-嘉義,2024-07-02,9692
00934,中信成長高股息,646,3,643,富邦-嘉義,2024-07-02,9692
2888,新光金,851,233,618,富邦-嘉義,2024-07-02,9692
3374,精材,830,428,402,富邦-嘉義,2024-07-02,9692
00673R,期元大S＆P原油反1,344,0,344,富邦-嘉義,2024-07-02,9692
2406,國碩,1090,756,334,富邦-嘉義,2024-07-02,9692
2303,聯電,356,61,295,富邦-嘉義,2024-07-02,9692
0056,元大高股息,247,1,246,富邦-嘉義,2024-07-02,9692
4906,正文,995,758,237,富邦-嘉義,2024-07-02,9692
2349,錸德,1327,1135,192,富邦-嘉義,2024-07-02,9692
00679B,元大美債20年,195,7,188,富邦-嘉義,2024-07-02,9692
2402,毅嘉,2026,1855,171,富邦-嘉義,2024-07-02,9692
3686,達能,174,23,151,富邦-嘉義,2024-07-02,9692
00680L,元大美債20正2,132,0,132,富邦-嘉義,2024-07-02,9692
3576,聯合再生,1133,1008,125,富邦-嘉義,2024-07-02,9692
3663,鑫科,122,10,112,富邦-嘉義,2024-07-02,9692
00665L,富邦�琤肭磪囓�2,124,14,110,富邦-嘉義,2024-07-02,9692
00948B,中信優息投資級債,109,0,109,富邦-嘉義,2024-07-02,9692
4956,光鋐,109,1,108,富邦-嘉義,2024-07-02,9692
2344,華邦電,122,14,108,富邦-嘉義,2024-07-02,9692
00936,台新永續高息中小,118,20,98,富邦-嘉義,2024-07-02,9692
6477,安集,501,408,93,富邦-嘉義,2024-07-02,9692
2014,中鴻,93,2,91,富邦-嘉義,2024-07-02,9692
3490,單井,177,86,91,富邦-嘉義,2024-07-02,9692
00688L,國泰20年美債正2,86,1,85,富邦-嘉義,2024-07-02,9692
2201,裕隆,84,8,76,富邦-嘉義,2024-07-02,9692
6176,瑞儀,79,3,76,富邦-嘉義,2024-07-02,9692
1316,上曜,69,0,69,富邦-嘉義,2024-07-02,9692
6443,元晶,2662,2597,65,富邦-嘉義,2024-07-02,9692
3324,雙鴻,74,9,65,富邦-嘉義,2024-07-02,9692
3027,盛達,69,7,62,富邦-嘉義,2024-07-02,9692
1301,台塑,81,19,62,富邦-嘉義,2024-07-02,9692
00676R,富邦臺灣加權反1,60,0,60,富邦-嘉義,2024-07-02,9692
2464,盟立,187,132,55,富邦-嘉義,2024-07-02,9692
4526,東台,71,17,54,富邦-嘉義,2024-07-02,9692
1312,國喬,52,0,52,富邦-嘉義,2024-07-02,9692
5009,榮剛,49,2,47,富邦-嘉義,2024-07-02,9692
3537,堡達,101,54,47,富邦-嘉義,2024-07-02,9692
6285,啟��,50,4,46,富邦-嘉義,2024-07-02,9692
4109,加捷生醫,52,6,46,富邦-嘉義,2024-07-02,9692
2359,所羅門,326,281,45,富邦-嘉義,2024-07-02,9692
4934,太極,48,6,42,富邦-嘉義,2024-07-02,9692
1605,華新,48,9,39,富邦-嘉義,2024-07-02,9692
00933B,國泰10Y+金融債,93,55,38,富邦-嘉義,2024-07-02,9692
00919,群益台灣精選高息,80,44,36,富邦-嘉義,2024-07-02,9692
8110,華東,35,1,34,富邦-嘉義,2024-07-02,9692
2609,陽明,49,15,34,富邦-嘉義,2024-07-02,9692
2314,台揚,32,0,32,富邦-嘉義,2024-07-02,9692
1514,亞力,71,39,32,富邦-嘉義,2024-07-02,9692
2317,鴻海,2453,2422,31,富邦-嘉義,2024-07-02,9692
00934,中信成長高股息,494,85,409,富邦-嘉義,2024-07-03,9692
3312,弘憶股,479,161,318,富邦-嘉義,2024-07-03,9692
8071,能率網通,537,273,264,富邦-嘉義,2024-07-03,9692
2867,三商壽,364,162,202,富邦-嘉義,2024-07-03,9692
9105,泰金寶-DR,356,161,195,富邦-嘉義,2024-07-03,9692
2409,友達,166,10,156,富邦-嘉義,2024-07-03,9692
1785,光洋科,373,224,149,富邦-嘉義,2024-07-03,9692
00632R,元大台灣50反1,148,0,148,富邦-嘉義,2024-07-03,9692
00946,群益科技高息成長,140,0,140,富邦-嘉義,2024-07-03,9692
2365,昆盈,1002,862,140,富邦-嘉義,2024-07-03,9692
2317,鴻海,193,56,137,富邦-嘉義,2024-07-03,9692
4562,穎漢,934,799,135,富邦-嘉義,2024-07-03,9692
6188,廣明,347,220,127,富邦-嘉義,2024-07-03,9692
2312,金寶,146,19,127,富邦-嘉義,2024-07-03,9692
3576,聯合再生,451,327,124,富邦-嘉義,2024-07-03,9692
00937B,群益ESG投等債20,139,20,119,富邦-嘉義,2024-07-03,9692
0056,元大高股息,128,11,117,富邦-嘉義,2024-07-03,9692
8104,錸寶,292,183,109,富邦-嘉義,2024-07-03,9692
3535,晶彩科,151,42,109,富邦-嘉義,2024-07-03,9692
3050,鈺德,592,487,105,富邦-嘉義,2024-07-03,9692
3581,博磊,128,24,104,富邦-嘉義,2024-07-03,9692
3379,彬台,100,1,99,富邦-嘉義,2024-07-03,9692
6005,群益證,100,2,98,富邦-嘉義,2024-07-03,9692
00918,大華優利高填息30,122,44,78,富邦-嘉義,2024-07-03,9692
00679B,元大美債20年,82,12,70,富邦-嘉義,2024-07-03,9692
00680L,元大美債20正2,69,0,69,富邦-嘉義,2024-07-03,9692
4906,正文,306,238,68,富邦-嘉義,2024-07-03,9692
00936,台新永續高息中小,66,0,66,富邦-嘉義,2024-07-03,9692
2349,錸德,132,70,62,富邦-嘉義,2024-07-03,9692
2467,志聖,281,219,62,富邦-嘉義,2024-07-03,9692
2537,聯上發,60,0,60,富邦-嘉義,2024-07-03,9692
3450,聯鈞,197,137,60,富邦-嘉義,2024-07-03,9692
00688L,國泰20年美債正2,56,0,56,富邦-嘉義,2024-07-03,9692
5452,佶優,352,301,51,富邦-嘉義,2024-07-03,9692
2890,永豐金,51,0,51,富邦-嘉義,2024-07-03,9692
00673R,期元大S＆P原油反1,50,0,50,富邦-嘉義,2024-07-03,9692
4938,和碩,54,4,50,富邦-嘉義,2024-07-03,9692
00687B,國泰20年美債,64,15,49,富邦-嘉義,2024-07-03,9692
2367,燿華,199,153,46,富邦-嘉義,2024-07-03,9692
3297,杭特,128,85,43,富邦-嘉義,2024-07-03,9692
6127,九豪,43,2,41,富邦-嘉義,2024-07-03,9692
00919,群益台灣精選高息,81,41,40,富邦-嘉義,2024-07-03,9692
00751B,元大AAA至A公司債,40,0,40,富邦-嘉義,2024-07-03,9692
00882,中信中國高股息,59,19,40,富邦-嘉義,2024-07-03,9692
6189,豐藝,353,315,38,富邦-嘉義,2024-07-03,9692
2201,裕隆,48,11,37,富邦-嘉義,2024-07-03,9692
6152,百一,45,9,36,富邦-嘉義,2024-07-03,9692
2002,中鋼,38,2,36,富邦-嘉義,2024-07-03,9692
3167,大量,46,11,35,富邦-嘉義,2024-07-03,9692
6187,萬潤,58,25,33,富邦-嘉義,2024-07-03,9692
2312,金寶,5443,674,4769,富邦-嘉義,2024-07-04,9692
00632R,元大台灣50反1,1372,447,925,富邦-嘉義,2024-07-04,9692
1513,中興電,1428,964,464,富邦-嘉義,2024-07-04,9692
2365,昆盈,352,107,245,富邦-嘉義,2024-07-04,9692
2867,三商壽,379,140,239,富邦-嘉義,2024-07-04,9692
3048,益登,305,86,219,富邦-嘉義,2024-07-04,9692
00934,中信成長高股息,221,6,215,富邦-嘉義,2024-07-04,9692
2464,盟立,480,270,210,富邦-嘉義,2024-07-04,9692
00680L,元大美債20正2,194,12,182,富邦-嘉義,2024-07-04,9692
6244,茂迪,265,95,170,富邦-嘉義,2024-07-04,9692
2367,燿華,201,37,164,富邦-嘉義,2024-07-04,9692
6207,雷科,299,178,121,富邦-嘉義,2024-07-04,9692
2412,中華電,117,5,112,富邦-嘉義,2024-07-04,9692
00945B,凱基美國非投等債,112,0,112,富邦-嘉義,2024-07-04,9692
9105,泰金寶-DR,792,702,90,富邦-嘉義,2024-07-04,9692
2405,輔信,493,403,90,富邦-嘉義,2024-07-04,9692
3686,達能,125,41,84,富邦-嘉義,2024-07-04,9692
5386,青雲,81,0,81,富邦-嘉義,2024-07-04,9692
3535,晶彩科,347,273,74,富邦-嘉義,2024-07-04,9692
3455,由田,419,345,74,富邦-嘉義,2024-07-04,9692
1718,中纖,95,27,68,富邦-嘉義,2024-07-04,9692
2344,華邦電,91,24,67,富邦-嘉義,2024-07-04,9692
4109,加捷生醫,130,65,65,富邦-嘉義,2024-07-04,9692
00687B,國泰20年美債,57,2,55,富邦-嘉義,2024-07-04,9692
2427,三商電,79,25,54,富邦-嘉義,2024-07-04,9692
1815,富喬,284,233,51,富邦-嘉義,2024-07-04,9692
3583,辛耘,67,18,49,富邦-嘉義,2024-07-04,9692
2609,陽明,58,10,48,富邦-嘉義,2024-07-04,9692
1444,力麗,46,0,46,富邦-嘉義,2024-07-04,9692
00772B,中信高評級公司債,45,0,45,富邦-嘉義,2024-07-04,9692
6706,惠特,195,151,44,富邦-嘉義,2024-07-04,9692
3047,訊舟,268,225,43,富邦-嘉義,2024-07-04,9692
6257,矽格,44,3,41,富邦-嘉義,2024-07-04,9692
2201,裕隆,42,1,41,富邦-嘉義,2024-07-04,9692
4588,玖鼎電力,40,1,39,富邦-嘉義,2024-07-04,9692
3563,牧德,73,35,38,富邦-嘉義,2024-07-04,9692
6139,亞翔,103,65,38,富邦-嘉義,2024-07-04,9692
2603,長榮,37,2,35,富邦-嘉義,2024-07-04,9692
00679B,元大美債20年,61,27,34,富邦-嘉義,2024-07-04,9692
3057,喬鼎,56,24,32,富邦-嘉義,2024-07-04,9692
1101,台泥,34,3,31,富邦-嘉義,2024-07-04,9692
3010,華立,33,2,31,富邦-嘉義,2024-07-04,9692
3402,漢科,145,114,31,富邦-嘉義,2024-07-04,9692
8064,東捷,241,213,28,富邦-嘉義,2024-07-04,9692
6477,安集,37,9,28,富邦-嘉義,2024-07-04,9692
8028,昇陽半導體,67,39,28,富邦-嘉義,2024-07-04,9692
4904,遠傳,30,3,27,富邦-嘉義,2024-07-04,9692
5347,世界,51,24,27,富邦-嘉義,2024-07-04,9692
6142,友勁,28,2,26,富邦-嘉義,2024-07-04,9692
2324,仁寶,55,29,26,富邦-嘉義,2024-07-04,9692
2312,金寶,2297,1533,764,富邦-嘉義,2024-07-05,9692
2417,圓剛,691,246,445,富邦-嘉義,2024-07-05,9692
3576,聯合再生,1009,709,300,富邦-嘉義,2024-07-05,9692
2374,佳能,765,465,300,富邦-嘉義,2024-07-05,9692
1528,恩德,307,10,297,富邦-嘉義,2024-07-05,9692
6160,欣技,570,281,289,富邦-嘉義,2024-07-05,9692
1785,光洋科,635,356,279,富邦-嘉義,2024-07-05,9692
00934,中信成長高股息,299,93,206,富邦-嘉義,2024-07-05,9692
8064,東捷,636,467,169,富邦-嘉義,2024-07-05,9692
2301,光寶科,166,3,163,富邦-嘉義,2024-07-05,9692
2834,臺企銀,165,8,157,富邦-嘉義,2024-07-05,9692
5443,均豪,898,744,154,富邦-嘉義,2024-07-05,9692
2382,廣達,154,17,137,富邦-嘉義,2024-07-05,9692
00949,復華日本龍頭,131,0,131,富邦-嘉義,2024-07-05,9692
8110,華東,153,33,120,富邦-嘉義,2024-07-05,9692
00673R,期元大S＆P原油反1,117,0,117,富邦-嘉義,2024-07-05,9692
1597,直得,145,33,112,富邦-嘉義,2024-07-05,9692
2610,華航,130,19,111,富邦-嘉義,2024-07-05,9692
6443,元晶,150,46,104,富邦-嘉義,2024-07-05,9692
1514,亞力,494,393,101,富邦-嘉義,2024-07-05,9692
1316,上曜,130,30,100,富邦-嘉義,2024-07-05,9692
6706,惠特,160,68,92,富邦-嘉義,2024-07-05,9692
2609,陽明,136,45,91,富邦-嘉義,2024-07-05,9692
2313,華通,209,128,81,富邦-嘉義,2024-07-05,9692
6217,中探針,504,427,77,富邦-嘉義,2024-07-05,9692
3537,堡達,251,178,73,富邦-嘉義,2024-07-05,9692
1718,中纖,206,134,72,富邦-嘉義,2024-07-05,9692
3535,晶彩科,294,222,72,富邦-嘉義,2024-07-05,9692
00712,復華富時不動產,68,0,68,富邦-嘉義,2024-07-05,9692
6472,保瑞,78,10,68,富邦-嘉義,2024-07-05,9692
4526,東台,259,191,68,富邦-嘉義,2024-07-05,9692
2323,中環,1213,1147,66,富邦-嘉義,2024-07-05,9692
00751B,元大AAA至A公司債,64,3,61,富邦-嘉義,2024-07-05,9692
3374,精材,66,5,61,富邦-嘉義,2024-07-05,9692
6133,金橋,63,3,60,富邦-嘉義,2024-07-05,9692
00933B,國泰10Y+金融債,97,38,59,富邦-嘉義,2024-07-05,9692
00937B,群益ESG投等債20,168,110,58,富邦-嘉義,2024-07-05,9692
00946,群益科技高息成長,73,15,58,富邦-嘉義,2024-07-05,9692
6142,友勁,60,4,56,富邦-嘉義,2024-07-05,9692
00942B,台新美A公司債20+,55,0,55,富邦-嘉義,2024-07-05,9692
6179,亞通,123,68,55,富邦-嘉義,2024-07-05,9692
00637L,元大滬深300正2,59,5,54,富邦-嘉義,2024-07-05,9692
00948B,中信優息投資級債,53,0,53,富邦-嘉義,2024-07-05,9692
00929,復華台灣科技優息,192,141,51,富邦-嘉義,2024-07-05,9692
6770,力積電,59,10,49,富邦-嘉義,2024-07-05,9692
1815,富喬,72,26,46,富邦-嘉義,2024-07-05,9692
5484,慧友,78,32,46,富邦-嘉義,2024-07-05,9692
2397,友通,42,1,41,富邦-嘉義,2024-07-05,9692
3050,鈺德,215,174,41,富邦-嘉義,2024-07-05,9692
2427,三商電,217,177,40,富邦-嘉義,2024-07-05,9692
2392,正崴,1097,203,894,富邦-嘉義,2024-07-08,9692
00934,中信成長高股息,450,11,439,富邦-嘉義,2024-07-08,9692
3050,鈺德,884,573,311,富邦-嘉義,2024-07-08,9692
3062,建漢,619,309,310,富邦-嘉義,2024-07-08,9692
3047,訊舟,529,247,282,富邦-嘉義,2024-07-08,9692
1711,永光,250,1,249,富邦-嘉義,2024-07-08,9692
1718,中纖,256,21,235,富邦-嘉義,2024-07-08,9692
4960,誠美材,1054,829,225,富邦-嘉義,2024-07-08,9692
8071,能率網通,583,361,222,富邦-嘉義,2024-07-08,9692
9105,泰金寶-DR,359,158,201,富邦-嘉義,2024-07-08,9692
1536,和大,562,376,186,富邦-嘉義,2024-07-08,9692
6443,元晶,317,133,184,富邦-嘉義,2024-07-08,9692
1460,宏遠,188,10,178,富邦-嘉義,2024-07-08,9692
2344,華邦電,154,0,154,富邦-嘉義,2024-07-08,9692
00687B,國泰20年美債,191,38,153,富邦-嘉義,2024-07-08,9692
5328,華容,1074,926,148,富邦-嘉義,2024-07-08,9692
3511,矽瑪,132,1,131,富邦-嘉義,2024-07-08,9692
2618,長榮航,201,73,128,富邦-嘉義,2024-07-08,9692
1784,訊聯,127,16,111,富邦-嘉義,2024-07-08,9692
6152,百一,108,1,107,富邦-嘉義,2024-07-08,9692
2382,廣達,621,517,104,富邦-嘉義,2024-07-08,9692
2014,中鴻,93,1,92,富邦-嘉義,2024-07-08,9692
3374,精材,459,373,86,富邦-嘉義,2024-07-08,9692
3481,群創,1143,1059,84,富邦-嘉義,2024-07-08,9692
6015,宏遠證,84,4,80,富邦-嘉義,2024-07-08,9692
8110,華東,83,4,79,富邦-嘉義,2024-07-08,9692
6127,九豪,94,18,76,富邦-嘉義,2024-07-08,9692
00679B,元大美債20年,85,14,71,富邦-嘉義,2024-07-08,9692
00878,國泰永續高股息,113,42,71,富邦-嘉義,2024-07-08,9692
2449,京元電子,1752,1685,67,富邦-嘉義,2024-07-08,9692
2363,矽統,177,113,64,富邦-嘉義,2024-07-08,9692
4904,遠傳,56,1,55,富邦-嘉義,2024-07-08,9692
6126,信音,115,60,55,富邦-嘉義,2024-07-08,9692
00881,國泰台灣5G+,67,15,52,富邦-嘉義,2024-07-08,9692
6164,華興,101,50,51,富邦-嘉義,2024-07-08,9692
00712,復華富時不動產,48,2,46,富邦-嘉義,2024-07-08,9692
2606,裕民,54,9,45,富邦-嘉義,2024-07-08,9692
5302,太欣,55,10,45,富邦-嘉義,2024-07-08,9692
2201,裕隆,48,4,44,富邦-嘉義,2024-07-08,9692
2883,凱基金,112,68,44,富邦-嘉義,2024-07-08,9692
3016,嘉晶,45,2,43,富邦-嘉義,2024-07-08,9692
4160,訊聯基因,69,27,42,富邦-嘉義,2024-07-08,9692
8085,福華,127,86,41,富邦-嘉義,2024-07-08,9692
3450,聯鈞,65,27,38,富邦-嘉義,2024-07-08,9692
6217,中探針,135,97,38,富邦-嘉義,2024-07-08,9692
2495,普安,46,9,37,富邦-嘉義,2024-07-08,9692
8249,菱光,35,0,35,富邦-嘉義,2024-07-08,9692
1709,和益,41,6,35,富邦-嘉義,2024-07-08,9692
00944,野村趨勢動能高息,32,0,32,富邦-嘉義,2024-07-08,9692
00918,大華優利高填息30,33,1,32,富邦-嘉義,2024-07-08,9692
2367,燿華,984,433,551,富邦-嘉義,2024-07-09,9692
2313,華通,679,145,534,富邦-嘉義,2024-07-09,9692
2867,三商壽,536,31,505,富邦-嘉義,2024-07-09,9692
3312,弘憶股,954,569,385,富邦-嘉義,2024-07-09,9692
2392,正崴,1188,820,368,富邦-嘉義,2024-07-09,9692
00665L,富邦�琤肭磪囓�2,294,0,294,富邦-嘉義,2024-07-09,9692
00632R,元大台灣50反1,256,1,255,富邦-嘉義,2024-07-09,9692
1618,合機,1154,919,235,富邦-嘉義,2024-07-09,9692
6218,豪勉,390,156,234,富邦-嘉義,2024-07-09,9692
6443,元晶,550,328,222,富邦-嘉義,2024-07-09,9692
2405,輔信,462,256,206,富邦-嘉義,2024-07-09,9692
6806,森崴能源,442,272,170,富邦-嘉義,2024-07-09,9692
3710,連展投控,164,16,148,富邦-嘉義,2024-07-09,9692
1616,億泰,171,34,137,富邦-嘉義,2024-07-09,9692
4533,協易機,1056,921,135,富邦-嘉義,2024-07-09,9692
5225,東科-KY,161,32,129,富邦-嘉義,2024-07-09,9692
2618,長榮航,159,33,126,富邦-嘉義,2024-07-09,9692
5452,佶優,162,49,113,富邦-嘉義,2024-07-09,9692
6213,聯茂,129,21,108,富邦-嘉義,2024-07-09,9692
00881,國泰台灣5G+,112,9,103,富邦-嘉義,2024-07-09,9692
6015,宏遠證,178,80,98,富邦-嘉義,2024-07-09,9692
2543,皇昌,113,22,91,富邦-嘉義,2024-07-09,9692
00936,台新永續高息中小,95,6,89,富邦-嘉義,2024-07-09,9692
4510,高鋒,315,228,87,富邦-嘉義,2024-07-09,9692
2834,臺企銀,150,65,85,富邦-嘉義,2024-07-09,9692
00934,中信成長高股息,169,93,76,富邦-嘉義,2024-07-09,9692
1326,台化,73,1,72,富邦-嘉義,2024-07-09,9692
2002,中鋼,67,2,65,富邦-嘉義,2024-07-09,9692
2609,陽明,88,23,65,富邦-嘉義,2024-07-09,9692
2353,宏��,77,15,62,富邦-嘉義,2024-07-09,9692
2515,中工,87,26,61,富邦-嘉義,2024-07-09,9692
2349,錸德,135,75,60,富邦-嘉義,2024-07-09,9692
2406,國碩,102,44,58,富邦-嘉義,2024-07-09,9692
00676R,富邦臺灣加權反1,51,0,51,富邦-嘉義,2024-07-09,9692
4157,太景*-KY,62,15,47,富邦-嘉義,2024-07-09,9692
3715,定穎投控,48,3,45,富邦-嘉義,2024-07-09,9692
6160,欣技,56,11,45,富邦-嘉義,2024-07-09,9692
3260,威剛,49,5,44,富邦-嘉義,2024-07-09,9692
2409,友達,59,18,41,富邦-嘉義,2024-07-09,9692
2344,華邦電,55,14,41,富邦-嘉義,2024-07-09,9692
3481,群創,154,114,40,富邦-嘉義,2024-07-09,9692
8096,擎亞,67,27,40,富邦-嘉義,2024-07-09,9692
2889,國票金,38,1,37,富邦-嘉義,2024-07-09,9692
8390,金益鼎,37,0,37,富邦-嘉義,2024-07-09,9692
3712,永崴投控,332,295,37,富邦-嘉義,2024-07-09,9692
6116,彩晶,35,2,33,富邦-嘉義,2024-07-09,9692
4128,中天,39,6,33,富邦-嘉義,2024-07-09,9692
00680L,元大美債20正2,32,0,32,富邦-嘉義,2024-07-09,9692
00935,野村臺灣新科技50,31,0,31,富邦-嘉義,2024-07-09,9692
1608,華榮,411,381,30,富邦-嘉義,2024-07-09,9692
00937B,群益ESG投等債20,1132,50,1082,富邦-嘉義,2024-07-10,9692
2367,燿華,1265,460,805,富邦-嘉義,2024-07-10,9692
3048,益登,1364,682,682,富邦-嘉義,2024-07-10,9692
2888,新光金,2677,2085,592,富邦-嘉義,2024-07-10,9692
1785,光洋科,568,227,341,富邦-嘉義,2024-07-10,9692
2365,昆盈,1057,718,339,富邦-嘉義,2024-07-10,9692
6706,惠特,380,192,188,富邦-嘉義,2024-07-10,9692
00945B,凱基美國非投等債,184,0,184,富邦-嘉義,2024-07-10,9692
8064,東捷,599,436,163,富邦-嘉義,2024-07-10,9692
5309,系統電,204,64,140,富邦-嘉義,2024-07-10,9692
3363,上詮,169,32,137,富邦-嘉義,2024-07-10,9692
3163,波若威,262,137,125,富邦-嘉義,2024-07-10,9692
3450,聯鈞,286,164,122,富邦-嘉義,2024-07-10,9692
6530,創威,167,67,100,富邦-嘉義,2024-07-10,9692
00934,中信成長高股息,137,42,95,富邦-嘉義,2024-07-10,9692
8105,凌巨,137,47,90,富邦-嘉義,2024-07-10,9692
2317,鴻海,120,46,74,富邦-嘉義,2024-07-10,9692
2316,楠梓電,484,414,70,富邦-嘉義,2024-07-10,9692
6438,迅得,70,4,66,富邦-嘉義,2024-07-10,9692
8107,大億金茂,66,1,65,富邦-嘉義,2024-07-10,9692
00946,群益科技高息成長,83,23,60,富邦-嘉義,2024-07-10,9692
3663,鑫科,67,7,60,富邦-嘉義,2024-07-10,9692
2609,陽明,102,49,53,富邦-嘉義,2024-07-10,9692
5880,合庫金,54,2,52,富邦-嘉義,2024-07-10,9692
2618,長榮航,88,36,52,富邦-嘉義,2024-07-10,9692
2498,宏達電,59,8,51,富邦-嘉義,2024-07-10,9692
9904,寶成,51,0,51,富邦-嘉義,2024-07-10,9692
2460,建通,50,0,50,富邦-嘉義,2024-07-10,9692
3231,緯創,59,10,49,富邦-嘉義,2024-07-10,9692
00905,FT臺灣Smart,50,2,48,富邦-嘉義,2024-07-10,9692
8092,建暐,52,5,47,富邦-嘉義,2024-07-10,9692
3019,亞光,80,34,46,富邦-嘉義,2024-07-10,9692
00933B,國泰10Y+金融債,45,0,45,富邦-嘉義,2024-07-10,9692
2449,京元電子,117,74,43,富邦-嘉義,2024-07-10,9692
4960,誠美材,110,69,41,富邦-嘉義,2024-07-10,9692
00688L,國泰20年美債正2,40,0,40,富邦-嘉義,2024-07-10,9692
3501,維熹,54,15,39,富邦-嘉義,2024-07-10,9692
6133,金橋,86,49,37,富邦-嘉義,2024-07-10,9692
1514,亞力,831,795,36,富邦-嘉義,2024-07-10,9692
2362,藍天,118,82,36,富邦-嘉義,2024-07-10,9692
00918,大華優利高填息30,51,16,35,富邦-嘉義,2024-07-10,9692
2464,盟立,1228,1193,35,富邦-嘉義,2024-07-10,9692
2438,翔耀,36,2,34,富邦-嘉義,2024-07-10,9692
8028,昇陽半導體,296,262,34,富邦-嘉義,2024-07-10,9692
2208,台船,33,0,33,富邦-嘉義,2024-07-10,9692
6442,光聖,41,8,33,富邦-嘉義,2024-07-10,9692
8069,元太,32,0,32,富邦-嘉義,2024-07-10,9692
9945,潤泰新,106,74,32,富邦-嘉義,2024-07-10,9692
00713,元大台灣高息低波,44,13,31,富邦-嘉義,2024-07-10,9692
4414,如興,30,0,30,富邦-嘉義,2024-07-10,9692
3013,晟銘電,1152,201,951,富邦-嘉義,2024-07-11,9692
00937B,群益ESG投等債20,879,78,801,富邦-嘉義,2024-07-11,9692
1316,上曜,830,192,638,富邦-嘉義,2024-07-11,9692
2312,金寶,2799,2333,466,富邦-嘉義,2024-07-11,9692
2888,新光金,769,371,398,富邦-嘉義,2024-07-11,9692
5880,合庫金,320,1,319,富邦-嘉義,2024-07-11,9692
3712,永崴投控,430,165,265,富邦-嘉義,2024-07-11,9692
9105,泰金寶-DR,4678,4456,222,富邦-嘉義,2024-07-11,9692
3019,亞光,442,223,219,富邦-嘉義,2024-07-11,9692
00934,中信成長高股息,197,36,161,富邦-嘉義,2024-07-11,9692
1447,力鵬,144,0,144,富邦-嘉義,2024-07-11,9692
00673R,期元大S＆P原油反1,120,0,120,富邦-嘉義,2024-07-11,9692
1569,濱川,131,21,110,富邦-嘉義,2024-07-11,9692
2383,台光電,112,2,110,富邦-嘉義,2024-07-11,9692
3189,景碩,177,77,100,富邦-嘉義,2024-07-11,9692
0056,元大高股息,127,28,99,富邦-嘉義,2024-07-11,9692
2367,燿華,324,225,99,富邦-嘉義,2024-07-11,9692
3710,連展投控,176,78,98,富邦-嘉義,2024-07-11,9692
1540,喬福,125,28,97,富邦-嘉義,2024-07-11,9692
4306,炎洲,358,270,88,富邦-嘉義,2024-07-11,9692
5871,中租-KY,100,14,86,富邦-嘉義,2024-07-11,9692
00936,台新永續高息中小,91,6,85,富邦-嘉義,2024-07-11,9692
5905,南仁湖,84,4,80,富邦-嘉義,2024-07-11,9692
6126,信音,448,372,76,富邦-嘉義,2024-07-11,9692
4906,正文,171,101,70,富邦-嘉義,2024-07-11,9692
3047,訊舟,1111,1049,62,富邦-嘉義,2024-07-11,9692
00933B,國泰10Y+金融債,75,17,58,富邦-嘉義,2024-07-11,9692
2303,聯電,140,82,58,富邦-嘉義,2024-07-11,9692
1718,中纖,55,1,54,富邦-嘉義,2024-07-11,9692
4109,加捷生醫,314,261,53,富邦-嘉義,2024-07-11,9692
4566,時碩工業,589,537,52,富邦-嘉義,2024-07-11,9692
2352,佳世達,55,4,51,富邦-嘉義,2024-07-11,9692
2405,輔信,148,99,49,富邦-嘉義,2024-07-11,9692
4534,慶騰,53,4,49,富邦-嘉義,2024-07-11,9692
1314,中石化,52,4,48,富邦-嘉義,2024-07-11,9692
2002,中鋼,69,21,48,富邦-嘉義,2024-07-11,9692
2349,錸德,164,117,47,富邦-嘉義,2024-07-11,9692
6142,友勁,50,3,47,富邦-嘉義,2024-07-11,9692
2354,鴻準,99,55,44,富邦-嘉義,2024-07-11,9692
2317,鴻海,513,470,43,富邦-嘉義,2024-07-11,9692
00905,FT臺灣Smart,54,12,42,富邦-嘉義,2024-07-11,9692
1609,大亞,101,62,39,富邦-嘉義,2024-07-11,9692
5607,遠雄港,34,1,33,富邦-嘉義,2024-07-11,9692
00632R,元大台灣50反1,163,130,33,富邦-嘉義,2024-07-11,9692
4414,如興,32,0,32,富邦-嘉義,2024-07-11,9692
1795,美時,30,0,30,富邦-嘉義,2024-07-11,9692
6658,聯策,30,0,30,富邦-嘉義,2024-07-11,9692
6438,迅得,41,11,30,富邦-嘉義,2024-07-11,9692
4960,誠美材,46,17,29,富邦-嘉義,2024-07-11,9692
2543,皇昌,49,20,29,富邦-嘉義,2024-07-11,9692
00929,復華台灣科技優息,790,66,724,富邦-嘉義,2024-07-12,9692
1608,華榮,1501,789,712,富邦-嘉義,2024-07-12,9692
1721,三晃,844,297,547,富邦-嘉義,2024-07-12,9692
2406,國碩,1287,863,424,富邦-嘉義,2024-07-12,9692
00937B,群益ESG投等債20,387,16,371,富邦-嘉義,2024-07-12,9692
00934,中信成長高股息,368,6,362,富邦-嘉義,2024-07-12,9692
2313,華通,328,102,226,富邦-嘉義,2024-07-12,9692
00919,群益台灣精選高息,308,85,223,富邦-嘉義,2024-07-12,9692
2367,燿華,255,45,210,富邦-嘉義,2024-07-12,9692
5381,合正,488,296,192,富邦-嘉義,2024-07-12,9692
1597,直得,375,190,185,富邦-嘉義,2024-07-12,9692
3050,鈺德,233,49,184,富邦-嘉義,2024-07-12,9692
00945B,凱基美國非投等債,183,0,183,富邦-嘉義,2024-07-12,9692
9955,佳龍,246,91,155,富邦-嘉義,2024-07-12,9692
00720B,元大投資級公司債,142,1,141,富邦-嘉義,2024-07-12,9692
8103,瀚荃,166,29,137,富邦-嘉義,2024-07-12,9692
00882,中信中國高股息,131,0,131,富邦-嘉義,2024-07-12,9692
3379,彬台,591,477,114,富邦-嘉義,2024-07-12,9692
2349,錸德,264,159,105,富邦-嘉義,2024-07-12,9692
3535,晶彩科,179,74,105,富邦-嘉義,2024-07-12,9692
0056,元大高股息,112,9,103,富邦-嘉義,2024-07-12,9692
3686,達能,112,10,102,富邦-嘉義,2024-07-12,9692
00881,國泰台灣5G+,103,11,92,富邦-嘉義,2024-07-12,9692
00946,群益科技高息成長,96,5,91,富邦-嘉義,2024-07-12,9692
00751B,元大AAA至A公司債,93,2,91,富邦-嘉義,2024-07-12,9692
2881,富邦金,99,21,78,富邦-嘉義,2024-07-12,9692
6264,富裔,78,1,77,富邦-嘉義,2024-07-12,9692
00927,群益半導體收益,77,1,76,富邦-嘉義,2024-07-12,9692
00632R,元大台灣50反1,112,37,75,富邦-嘉義,2024-07-12,9692
3673,TPK-KY,493,419,74,富邦-嘉義,2024-07-12,9692
1312,國喬,82,10,72,富邦-嘉義,2024-07-12,9692
5498,凱崴,73,2,71,富邦-嘉義,2024-07-12,9692
00935,野村臺灣新科技50,74,8,66,富邦-嘉義,2024-07-12,9692
4956,光鋐,152,95,57,富邦-嘉義,2024-07-12,9692
00878,國泰永續高股息,100,43,57,富邦-嘉義,2024-07-12,9692
2330,台積電,76,20,56,富邦-嘉義,2024-07-12,9692
8114,振樺電,52,0,52,富邦-嘉義,2024-07-12,9692
2477,美隆電,145,97,48,富邦-嘉義,2024-07-12,9692
1815,富喬,112,69,43,富邦-嘉義,2024-07-12,9692
1540,喬福,1257,1214,43,富邦-嘉義,2024-07-12,9692
1605,華新,50,8,42,富邦-嘉義,2024-07-12,9692
2618,長榮航,49,8,41,富邦-嘉義,2024-07-12,9692
2359,所羅門,125,86,39,富邦-嘉義,2024-07-12,9692
006208,富邦台50,43,4,39,富邦-嘉義,2024-07-12,9692
4714,永捷,61,27,34,富邦-嘉義,2024-07-12,9692
1723,中碳,35,1,34,富邦-嘉義,2024-07-12,9692
5347,世界,46,13,33,富邦-嘉義,2024-07-12,9692
2449,京元電子,41,8,33,富邦-嘉義,2024-07-12,9692
2393,億光,33,0,33,富邦-嘉義,2024-07-12,9692
3665,貿聯-KY,33,0,33,富邦-嘉義,2024-07-12,9692
2489,瑞軒,5571,2256,3315,富邦-嘉義,2024-07-15,9692
00706L,期元大S＆P日圓正2,503,4,499,富邦-嘉義,2024-07-15,9692
2537,聯上發,1310,812,498,富邦-嘉義,2024-07-15,9692
00934,中信成長高股息,422,51,371,富邦-嘉義,2024-07-15,9692
2891,中信金,366,3,363,富邦-嘉義,2024-07-15,9692
2888,新光金,438,93,345,富邦-嘉義,2024-07-15,9692
3050,鈺德,390,63,327,富邦-嘉義,2024-07-15,9692
1815,富喬,361,45,316,富邦-嘉義,2024-07-15,9692
3013,晟銘電,521,213,308,富邦-嘉義,2024-07-15,9692
00632R,元大台灣50反1,206,25,181,富邦-嘉義,2024-07-15,9692
6695,芯鼎,226,57,169,富邦-嘉義,2024-07-15,9692
00929,復華台灣科技優息,189,33,156,富邦-嘉義,2024-07-15,9692
2867,三商壽,194,40,154,富邦-嘉義,2024-07-15,9692
2409,友達,162,25,137,富邦-嘉義,2024-07-15,9692
00650L,復華香港正2,130,0,130,富邦-嘉義,2024-07-15,9692
00933B,國泰10Y+金融債,163,42,121,富邦-嘉義,2024-07-15,9692
00919,群益台灣精選高息,120,20,100,富邦-嘉義,2024-07-15,9692
2312,金寶,2845,2749,96,富邦-嘉義,2024-07-15,9692
8105,凌巨,102,10,92,富邦-嘉義,2024-07-15,9692
1609,大亞,596,511,85,富邦-嘉義,2024-07-15,9692
2465,麗臺,161,76,85,富邦-嘉義,2024-07-15,9692
00918,大華優利高填息30,95,11,84,富邦-嘉義,2024-07-15,9692
00680L,元大美債20正2,83,5,78,富邦-嘉義,2024-07-15,9692
5498,凱崴,81,5,76,富邦-嘉義,2024-07-15,9692
4909,新復興,639,567,72,富邦-嘉義,2024-07-15,9692
5309,系統電,318,247,71,富邦-嘉義,2024-07-15,9692
4562,穎漢,72,1,71,富邦-嘉義,2024-07-15,9692
2365,昆盈,283,214,69,富邦-嘉義,2024-07-15,9692
0056,元大高股息,79,13,66,富邦-嘉義,2024-07-15,9692
3016,嘉晶,67,2,65,富邦-嘉義,2024-07-15,9692
00937B,群益ESG投等債20,353,294,59,富邦-嘉義,2024-07-15,9692
00687B,國泰20年美債,70,19,51,富邦-嘉義,2024-07-15,9692
2344,華邦電,55,4,51,富邦-嘉義,2024-07-15,9692
00633L,富邦上証正2,50,0,50,富邦-嘉義,2024-07-15,9692
00679B,元大美債20年,63,15,48,富邦-嘉義,2024-07-15,9692
8054,安國,80,32,48,富邦-嘉義,2024-07-15,9692
1409,新纖,51,4,47,富邦-嘉義,2024-07-15,9692
2605,新興,56,10,46,富邦-嘉義,2024-07-15,9692
00882,中信中國高股息,73,30,43,富邦-嘉義,2024-07-15,9692
1326,台化,43,1,42,富邦-嘉義,2024-07-15,9692
2347,聯強,41,0,41,富邦-嘉義,2024-07-15,9692
00948B,中信優息投資級債,50,10,40,富邦-嘉義,2024-07-15,9692
1727,中華化,63,24,39,富邦-嘉義,2024-07-15,9692
2467,志聖,39,0,39,富邦-嘉義,2024-07-15,9692
2457,飛宏,42,4,38,富邦-嘉義,2024-07-15,9692
9945,潤泰新,64,27,37,富邦-嘉義,2024-07-15,9692
6449,鈺邦,114,77,37,富邦-嘉義,2024-07-15,9692
00927,群益半導體收益,37,1,36,富邦-嘉義,2024-07-15,9692
6116,彩晶,38,2,36,富邦-嘉義,2024-07-15,9692
6546,正基,40,5,35,富邦-嘉義,2024-07-15,9692
1597,直得,633,171,462,富邦-嘉義,2024-07-16,9692
2402,毅嘉,382,37,345,富邦-嘉義,2024-07-16,9692
4906,正文,468,131,337,富邦-嘉義,2024-07-16,9692
2317,鴻海,312,62,250,富邦-嘉義,2024-07-16,9692
3673,TPK-KY,1258,1031,227,富邦-嘉義,2024-07-16,9692
00753L,中信中國50正2,205,0,205,富邦-嘉義,2024-07-16,9692
00919,群益台灣精選高息,212,15,197,富邦-嘉義,2024-07-16,9692
00937B,群益ESG投等債20,237,68,169,富邦-嘉義,2024-07-16,9692
00905,FT臺灣Smart,166,1,165,富邦-嘉義,2024-07-16,9692
5328,華容,693,556,137,富邦-嘉義,2024-07-16,9692
6492,生華科,139,8,131,富邦-嘉義,2024-07-16,9692
00680L,元大美債20正2,133,14,119,富邦-嘉義,2024-07-16,9692
2888,新光金,233,117,116,富邦-嘉義,2024-07-16,9692
6127,九豪,345,231,114,富邦-嘉義,2024-07-16,9692
3189,景碩,120,8,112,富邦-嘉義,2024-07-16,9692
6116,彩晶,110,2,108,富邦-嘉義,2024-07-16,9692
6834,天二科技,490,386,104,富邦-嘉義,2024-07-16,9692
00934,中信成長高股息,139,42,97,富邦-嘉義,2024-07-16,9692
3297,杭特,91,1,90,富邦-嘉義,2024-07-16,9692
2332,友訊,91,3,88,富邦-嘉義,2024-07-16,9692
5309,系統電,126,47,79,富邦-嘉義,2024-07-16,9692
2356,英業達,101,27,74,富邦-嘉義,2024-07-16,9692
00929,復華台灣科技優息,181,111,70,富邦-嘉義,2024-07-16,9692
3294,英濟,127,60,67,富邦-嘉義,2024-07-16,9692
1301,台塑,66,2,64,富邦-嘉義,2024-07-16,9692
4956,光鋐,80,16,64,富邦-嘉義,2024-07-16,9692
2609,陽明,77,15,62,富邦-嘉義,2024-07-16,9692
8089,康全電訊,75,15,60,富邦-嘉義,2024-07-16,9692
00949,復華日本龍頭,59,0,59,富邦-嘉義,2024-07-16,9692
1815,富喬,71,13,58,富邦-嘉義,2024-07-16,9692
1314,中石化,61,4,57,富邦-嘉義,2024-07-16,9692
4960,誠美材,63,6,57,富邦-嘉義,2024-07-16,9692
00927,群益半導體收益,58,1,57,富邦-嘉義,2024-07-16,9692
00665L,富邦�琤肭磪囓�2,58,3,55,富邦-嘉義,2024-07-16,9692
1447,力鵬,51,0,51,富邦-嘉義,2024-07-16,9692
00687B,國泰20年美債,58,9,49,富邦-嘉義,2024-07-16,9692
00946,群益科技高息成長,53,4,49,富邦-嘉義,2024-07-16,9692
2547,日勝生,50,3,47,富邦-嘉義,2024-07-16,9692
1785,光洋科,87,41,46,富邦-嘉義,2024-07-16,9692
0056,元大高股息,59,14,45,富邦-嘉義,2024-07-16,9692
3163,波若威,172,133,39,富邦-嘉義,2024-07-16,9692
3048,益登,45,8,37,富邦-嘉義,2024-07-16,9692
1513,中興電,76,40,36,富邦-嘉義,2024-07-16,9692
1303,南亞,35,0,35,富邦-嘉義,2024-07-16,9692
00945B,凱基美國非投等債,35,0,35,富邦-嘉義,2024-07-16,9692
2615,萬海,257,222,35,富邦-嘉義,2024-07-16,9692
5519,隆大,38,4,34,富邦-嘉義,2024-07-16,9692
2610,華航,72,38,34,富邦-嘉義,2024-07-16,9692
3325,旭品,32,1,31,富邦-嘉義,2024-07-16,9692
00710B,復華彭博非投等債,31,0,31,富邦-嘉義,2024-07-16,9692
2520,冠德,1146,116,1030,富邦-嘉義,2024-07-17,9692
2365,昆盈,1045,449,596,富邦-嘉義,2024-07-17,9692
00929,復華台灣科技優息,653,76,577,富邦-嘉義,2024-07-17,9692
1709,和益,634,68,566,富邦-嘉義,2024-07-17,9692
00665L,富邦�琤肭磪囓�2,479,0,479,富邦-嘉義,2024-07-17,9692
00937B,群益ESG投等債20,477,28,449,富邦-嘉義,2024-07-17,9692
9955,佳龍,561,346,215,富邦-嘉義,2024-07-17,9692
2888,新光金,306,115,191,富邦-嘉義,2024-07-17,9692
4566,時碩工業,562,395,167,富邦-嘉義,2024-07-17,9692
2419,仲琦,209,63,146,富邦-嘉義,2024-07-17,9692
3231,緯創,169,29,140,富邦-嘉義,2024-07-17,9692
00753L,中信中國50正2,139,5,134,富邦-嘉義,2024-07-17,9692
1409,新纖,576,457,119,富邦-嘉義,2024-07-17,9692
3163,波若威,544,439,105,富邦-嘉義,2024-07-17,9692
5905,南仁湖,104,2,102,富邦-嘉義,2024-07-17,9692
5225,東科-KY,100,0,100,富邦-嘉義,2024-07-17,9692
00934,中信成長高股息,104,5,99,富邦-嘉義,2024-07-17,9692
8105,凌巨,435,336,99,富邦-嘉義,2024-07-17,9692
00919,群益台灣精選高息,203,104,99,富邦-嘉義,2024-07-17,9692
3189,景碩,298,202,96,富邦-嘉義,2024-07-17,9692
3652,精聯,92,2,90,富邦-嘉義,2024-07-17,9692
3058,立德,83,0,83,富邦-嘉義,2024-07-17,9692
1314,中石化,748,669,79,富邦-嘉義,2024-07-17,9692
5443,均豪,164,87,77,富邦-嘉義,2024-07-17,9692
2538,基泰,185,109,76,富邦-嘉義,2024-07-17,9692
2349,錸德,108,36,72,富邦-嘉義,2024-07-17,9692
1611,中電,530,459,71,富邦-嘉義,2024-07-17,9692
6770,力積電,139,71,68,富邦-嘉義,2024-07-17,9692
2401,凌陽,70,6,64,富邦-嘉義,2024-07-17,9692
1609,大亞,1027,964,63,富邦-嘉義,2024-07-17,9692
8054,安國,220,158,62,富邦-嘉義,2024-07-17,9692
2362,藍天,66,8,58,富邦-嘉義,2024-07-17,9692
1540,喬福,295,239,56,富邦-嘉義,2024-07-17,9692
2633,台灣高鐵,56,1,55,富邦-嘉義,2024-07-17,9692
2408,南亞科,56,5,51,富邦-嘉義,2024-07-17,9692
2515,中工,72,22,50,富邦-嘉義,2024-07-17,9692
3312,弘憶股,352,303,49,富邦-嘉義,2024-07-17,9692
3710,連展投控,73,27,46,富邦-嘉義,2024-07-17,9692
6125,廣運,1147,1102,45,富邦-嘉義,2024-07-17,9692
00878,國泰永續高股息,46,2,44,富邦-嘉義,2024-07-17,9692
2376,技嘉,123,79,44,富邦-嘉義,2024-07-17,9692
2330,台積電,49,5,44,富邦-嘉義,2024-07-17,9692
2618,長榮航,51,9,42,富邦-嘉義,2024-07-17,9692
2303,聯電,55,13,42,富邦-嘉義,2024-07-17,9692
5452,佶優,58,16,42,富邦-嘉義,2024-07-17,9692
0056,元大高股息,46,6,40,富邦-嘉義,2024-07-17,9692
00688L,國泰20年美債正2,41,1,40,富邦-嘉義,2024-07-17,9692
00712,復華富時不動產,122,84,38,富邦-嘉義,2024-07-17,9692
2301,光寶科,42,4,38,富邦-嘉義,2024-07-17,9692
4956,光鋐,68,32,36,富邦-嘉義,2024-07-17,9692
00919,群益台灣精選高息,256,18,238,富邦-嘉義,2024-07-18,9692
00934,中信成長高股息,231,10,221,富邦-嘉義,2024-07-18,9692
2537,聯上發,332,119,213,富邦-嘉義,2024-07-18,9692
00937B,群益ESG投等債20,213,4,209,富邦-嘉義,2024-07-18,9692
3481,群創,527,320,207,富邦-嘉義,2024-07-18,9692
6015,宏遠證,184,3,181,富邦-嘉義,2024-07-18,9692
2356,英業達,192,21,171,富邦-嘉義,2024-07-18,9692
1784,訊聯,207,40,167,富邦-嘉義,2024-07-18,9692
2801,彰銀,151,5,146,富邦-嘉義,2024-07-18,9692
4160,訊聯基因,247,113,134,富邦-嘉義,2024-07-18,9692
2867,三商壽,181,49,132,富邦-嘉義,2024-07-18,9692
00948B,中信優息投資級債,131,6,125,富邦-嘉義,2024-07-18,9692
1597,直得,446,325,121,富邦-嘉義,2024-07-18,9692
2317,鴻海,1760,1644,116,富邦-嘉義,2024-07-18,9692
0056,元大高股息,99,5,94,富邦-嘉義,2024-07-18,9692
2367,燿華,101,11,90,富邦-嘉義,2024-07-18,9692
3518,柏騰,241,155,86,富邦-嘉義,2024-07-18,9692
00947,台新臺灣IC設計,85,0,85,富邦-嘉義,2024-07-18,9692
4109,加捷生醫,200,129,71,富邦-嘉義,2024-07-18,9692
00665L,富邦�琤肭磪囓�2,73,7,66,富邦-嘉義,2024-07-18,9692
2402,毅嘉,252,189,63,富邦-嘉義,2024-07-18,9692
00933B,國泰10Y+金融債,125,63,62,富邦-嘉義,2024-07-18,9692
4967,十銓,73,12,61,富邦-嘉義,2024-07-18,9692
4960,誠美材,62,3,59,富邦-嘉義,2024-07-18,9692
00878,國泰永續高股息,150,92,58,富邦-嘉義,2024-07-18,9692
2330,台積電,490,432,58,富邦-嘉義,2024-07-18,9692
1540,喬福,913,857,56,富邦-嘉義,2024-07-18,9692
00905,FT臺灣Smart,56,2,54,富邦-嘉義,2024-07-18,9692
3048,益登,66,12,54,富邦-嘉義,2024-07-18,9692
00687B,國泰20年美債,72,22,50,富邦-嘉義,2024-07-18,9692
2243,宏旭-KY,55,5,50,富邦-嘉義,2024-07-18,9692
2363,矽統,86,39,47,富邦-嘉義,2024-07-18,9692
2449,京元電子,53,5,48,富邦-嘉義,2024-07-18,9692
8467,波力-KY,46,0,46,富邦-嘉義,2024-07-18,9692
2891,中信金,53,8,45,富邦-嘉義,2024-07-18,9692
3062,建漢,262,218,44,富邦-嘉義,2024-07-18,9692
00927,群益半導體收益,59,15,44,富邦-嘉義,2024-07-18,9692
8937,合騏,46,3,43,富邦-嘉義,2024-07-18,9692
3073,天方能源,179,137,42,富邦-嘉義,2024-07-18,9692
6869,雲豹能源,41,1,40,富邦-嘉義,2024-07-18,9692
4303,信立,100,60,40,富邦-嘉義,2024-07-18,9692
3231,緯創,68,29,39,富邦-嘉義,2024-07-18,9692
5328,華容,50,11,39,富邦-嘉義,2024-07-18,9692
2344,華邦電,40,4,36,富邦-嘉義,2024-07-18,9692
5905,南仁湖,38,2,36,富邦-嘉義,2024-07-18,9692
00891,中信關鍵半導體,37,2,35,富邦-嘉義,2024-07-18,9692
1402,遠東新,35,0,35,富邦-嘉義,2024-07-18,9692
2546,根基,34,0,34,富邦-嘉義,2024-07-18,9692
2610,華航,41,8,33,富邦-嘉義,2024-07-18,9692
4526,東台,35,2,33,富邦-嘉義,2024-07-18,9692
5512,力麒,2642,1393,1249,富邦-嘉義,2024-07-19,9692
1529,樂事綠能,1021,334,687,富邦-嘉義,2024-07-19,9692
3481,群創,867,419,448,富邦-嘉義,2024-07-19,9692
2888,新光金,463,177,286,富邦-嘉義,2024-07-19,9692
00919,群益台灣精選高息,325,97,228,富邦-嘉義,2024-07-19,9692
00929,復華台灣科技優息,495,273,222,富邦-嘉義,2024-07-19,9692
00937B,群益ESG投等債20,320,121,199,富邦-嘉義,2024-07-19,9692
4566,時碩工業,586,388,198,富邦-嘉義,2024-07-19,9692
8473,山林水,255,58,197,富邦-嘉義,2024-07-19,9692
2867,三商壽,203,27,176,富邦-嘉義,2024-07-19,9692
00946,群益科技高息成長,161,0,161,富邦-嘉義,2024-07-19,9692
2349,錸德,260,103,157,富邦-嘉義,2024-07-19,9692
9105,泰金寶-DR,152,23,129,富邦-嘉義,2024-07-19,9692
1313,聯成,120,0,120,富邦-嘉義,2024-07-19,9692
2801,彰銀,120,1,119,富邦-嘉義,2024-07-19,9692
0056,元大高股息,156,43,113,富邦-嘉義,2024-07-19,9692
3029,零壹,114,4,110,富邦-嘉義,2024-07-19,9692
6477,安集,109,7,102,富邦-嘉義,2024-07-19,9692
2891,中信金,110,12,98,富邦-嘉義,2024-07-19,9692
1477,聚陽,110,12,98,富邦-嘉義,2024-07-19,9692
1316,上曜,99,6,93,富邦-嘉義,2024-07-19,9692
5533,皇鼎,90,0,90,富邦-嘉義,2024-07-19,9692
4534,慶騰,97,10,87,富邦-嘉義,2024-07-19,9692
3339,泰谷,115,36,79,富邦-嘉義,2024-07-19,9692
2618,長榮航,114,38,76,富邦-嘉義,2024-07-19,9692
00679B,元大美債20年,89,14,75,富邦-嘉義,2024-07-19,9692
1802,台玻,85,10,75,富邦-嘉義,2024-07-19,9692
00905,FT臺灣Smart,71,0,71,富邦-嘉義,2024-07-19,9692
2633,台灣高鐵,70,0,70,富邦-嘉義,2024-07-19,9692
6770,力積電,80,10,70,富邦-嘉義,2024-07-19,9692
2330,台積電,275,206,69,富邦-嘉義,2024-07-19,9692
1102,亞泥,68,0,68,富邦-嘉義,2024-07-19,9692
1709,和益,575,507,68,富邦-嘉義,2024-07-19,9692
8105,凌巨,117,53,64,富邦-嘉義,2024-07-19,9692
00878,國泰永續高股息,178,118,60,富邦-嘉義,2024-07-19,9692
2506,太設,55,0,55,富邦-嘉義,2024-07-19,9692
2312,金寶,119,65,54,富邦-嘉義,2024-07-19,9692
6598,ABC-KY,59,9,50,富邦-嘉義,2024-07-19,9692
2511,太子,50,0,50,富邦-嘉義,2024-07-19,9692
4743,合一,53,4,49,富邦-嘉義,2024-07-19,9692
2356,英業達,75,28,47,富邦-嘉義,2024-07-19,9692
3163,波若威,197,151,46,富邦-嘉義,2024-07-19,9692
2834,臺企銀,104,59,45,富邦-嘉義,2024-07-19,9692
2344,華邦電,54,10,44,富邦-嘉義,2024-07-19,9692
00934,中信成長高股息,108,65,43,富邦-嘉義,2024-07-19,9692
2408,南亞科,48,4,44,富邦-嘉義,2024-07-19,9692
2317,鴻海,966,923,43,富邦-嘉義,2024-07-19,9692
3576,聯合再生,101,60,41,富邦-嘉義,2024-07-19,9692
3149,正達,45,4,41,富邦-嘉義,2024-07-19,9692
3057,喬鼎,41,0,41,富邦-嘉義,2024-07-19,9692
1609,大亞,704,102,602,富邦-嘉義,2024-07-22,9692
6125,廣運,759,257,502,富邦-嘉義,2024-07-22,9692
00929,復華台灣科技優息,1084,607,477,富邦-嘉義,2024-07-22,9692
00946,群益科技高息成長,453,14,439,富邦-嘉義,2024-07-22,9692
4743,合一,478,118,360,富邦-嘉義,2024-07-22,9692
00940,元大台灣價值高息,528,178,350,富邦-嘉義,2024-07-22,9692
3663,鑫科,538,235,303,富邦-嘉義,2024-07-22,9692
4128,中天,367,85,282,富邦-嘉義,2024-07-22,9692
00919,群益台灣精選高息,556,301,255,富邦-嘉義,2024-07-22,9692
00878,國泰永續高股息,349,136,213,富邦-嘉義,2024-07-22,9692
2317,鴻海,2350,2150,200,富邦-嘉義,2024-07-22,9692
0056,元大高股息,174,29,145,富邦-嘉義,2024-07-22,9692
8440,綠電,156,18,138,富邦-嘉義,2024-07-22,9692
3686,達能,152,18,134,富邦-嘉義,2024-07-22,9692
2365,昆盈,591,494,97,富邦-嘉義,2024-07-22,9692
00937B,群益ESG投等債20,175,80,95,富邦-嘉義,2024-07-22,9692
1714,和桐,100,6,94,富邦-嘉義,2024-07-22,9692
00934,中信成長高股息,127,38,89,富邦-嘉義,2024-07-22,9692
3580,友威科,221,139,82,富邦-嘉義,2024-07-22,9692
6806,森崴能源,324,242,82,富邦-嘉義,2024-07-22,9692
8096,擎亞,90,11,79,富邦-嘉義,2024-07-22,9692
00936,台新永續高息中小,73,3,70,富邦-嘉義,2024-07-22,9692
1709,和益,151,85,66,富邦-嘉義,2024-07-22,9692
00945B,凱基美國非投等債,64,0,64,富邦-嘉義,2024-07-22,9692
2316,楠梓電,206,142,64,富邦-嘉義,2024-07-22,9692
2610,華航,84,25,59,富邦-嘉義,2024-07-22,9692
8374,羅昇,127,69,58,富邦-嘉義,2024-07-22,9692
2344,華邦電,62,5,57,富邦-嘉義,2024-07-22,9692
00915,凱基優選高股息30,69,13,56,富邦-嘉義,2024-07-22,9692
1447,力鵬,113,59,54,富邦-嘉義,2024-07-22,9692
2359,所羅門,560,508,52,富邦-嘉義,2024-07-22,9692
6015,宏遠證,53,3,50,富邦-嘉義,2024-07-22,9692
6443,元晶,65,15,50,富邦-嘉義,2024-07-22,9692
4916,事欣科,161,113,48,富邦-嘉義,2024-07-22,9692
1313,聯成,47,1,46,富邦-嘉義,2024-07-22,9692
2891,中信金,103,59,44,富邦-嘉義,2024-07-22,9692
5443,均豪,93,48,45,富邦-嘉義,2024-07-22,9692
3016,嘉晶,54,12,42,富邦-嘉義,2024-07-22,9692
2486,一詮,70,30,40,富邦-嘉義,2024-07-22,9692
3013,晟銘電,139,100,39,富邦-嘉義,2024-07-22,9692
1710,東聯,41,2,39,富邦-嘉義,2024-07-22,9692
2485,兆赫,40,2,38,富邦-嘉義,2024-07-22,9692
3231,緯創,96,59,37,富邦-嘉義,2024-07-22,9692
3563,牧德,91,55,36,富邦-嘉義,2024-07-22,9692
3576,聯合再生,53,18,35,富邦-嘉義,2024-07-22,9692
4306,炎洲,33,3,30,富邦-嘉義,2024-07-22,9692
3689,湧德,50,22,28,富邦-嘉義,2024-07-22,9692
00935,野村臺灣新科技50,28,1,27,富邦-嘉義,2024-07-22,9692
1712,興農,73,46,27,富邦-嘉義,2024-07-22,9692
2356,英業達,74,47,27,富邦-嘉義,2024-07-22,9692
00937B,群益ESG投等債20,348,5,343,富邦-嘉義,2024-07-23,9692
00720B,元大投資級公司債,259,1,258,富邦-嘉義,2024-07-23,9692
00929,復華台灣科技優息,297,43,254,富邦-嘉義,2024-07-23,9692
1540,喬福,558,322,236,富邦-嘉義,2024-07-23,9692
2409,友達,198,1,197,富邦-嘉義,2024-07-23,9692
00919,群益台灣精選高息,167,18,149,富邦-嘉義,2024-07-23,9692
2812,台中銀,157,11,146,富邦-嘉義,2024-07-23,9692
00632R,元大台灣50反1,293,192,101,富邦-嘉義,2024-07-23,9692
2301,光寶科,103,11,92,富邦-嘉義,2024-07-23,9692
00905,FT臺灣Smart,93,2,91,富邦-嘉義,2024-07-23,9692
5512,力麒,137,54,83,富邦-嘉義,2024-07-23,9692
00946,群益科技高息成長,82,0,82,富邦-嘉義,2024-07-23,9692
2408,南亞科,75,1,74,富邦-嘉義,2024-07-23,9692
00940,元大台灣價值高息,79,7,72,富邦-嘉義,2024-07-23,9692
2504,國產,123,52,71,富邦-嘉義,2024-07-23,9692
2467,志聖,106,41,65,富邦-嘉義,2024-07-23,9692
00881,國泰台灣5G+,65,2,63,富邦-嘉義,2024-07-23,9692
8054,安國,280,219,61,富邦-嘉義,2024-07-23,9692
00878,國泰永續高股息,75,16,59,富邦-嘉義,2024-07-23,9692
00934,中信成長高股息,58,1,57,富邦-嘉義,2024-07-23,9692
2891,中信金,58,3,55,富邦-嘉義,2024-07-23,9692
3339,泰谷,52,0,52,富邦-嘉義,2024-07-23,9692
00680L,元大美債20正2,59,10,49,富邦-嘉義,2024-07-23,9692
4526,東台,51,6,45,富邦-嘉義,2024-07-23,9692
2489,瑞軒,65,24,41,富邦-嘉義,2024-07-23,9692
00942B,台新美A公司債20+,40,0,40,富邦-嘉義,2024-07-23,9692
00933B,國泰10Y+金融債,42,6,36,富邦-嘉義,2024-07-23,9692
00664R,國泰臺灣加權反1,36,0,36,富邦-嘉義,2024-07-23,9692
3047,訊舟,81,45,36,富邦-嘉義,2024-07-23,9692
6215,和椿,86,50,36,富邦-嘉義,2024-07-23,9692
00679B,元大美債20年,53,18,35,富邦-嘉義,2024-07-23,9692
00676R,富邦臺灣加權反1,35,0,35,富邦-嘉義,2024-07-23,9692
4534,慶騰,50,16,34,富邦-嘉義,2024-07-23,9692
00948B,中信優息投資級債,33,0,33,富邦-嘉義,2024-07-23,9692
2330,台積電,141,111,30,富邦-嘉義,2024-07-23,9692
2316,楠梓電,119,89,30,富邦-嘉義,2024-07-23,9692
1308,亞聚,34,5,29,富邦-嘉義,2024-07-23,9692
1312,國喬,27,0,27,富邦-嘉義,2024-07-23,9692
6770,力積電,27,0,27,富邦-嘉義,2024-07-23,9692
1301,台塑,28,2,26,富邦-嘉義,2024-07-23,9692
1449,佳和,47,22,25,富邦-嘉義,2024-07-23,9692
4927,泰鼎-KY,25,0,25,富邦-嘉義,2024-07-23,9692
8028,昇陽半導體,220,196,24,富邦-嘉義,2024-07-23,9692
2515,中工,40,16,24,富邦-嘉義,2024-07-23,9692
3163,波若威,111,88,23,富邦-嘉義,2024-07-23,9692
9105,泰金寶-DR,36,14,22,富邦-嘉義,2024-07-23,9692
00918,大華優利高填息30,28,6,22,富邦-嘉義,2024-07-23,9692
4551,智伸科,21,0,21,富邦-嘉義,2024-07-23,9692
8085,福華,76,55,21,富邦-嘉義,2024-07-23,9692
00712,復華富時不動產,35,14,21,富邦-嘉義,2024-07-23,9692
00929,復華台灣科技優息,514,109,405,富邦-嘉義,2024-07-26,9692
1815,富喬,305,3,302,富邦-嘉義,2024-07-26,9692
00878,國泰永續高股息,304,24,280,富邦-嘉義,2024-07-26,9692
00937B,群益ESG投等債20,417,158,259,富邦-嘉義,2024-07-26,9692
00919,群益台灣精選高息,280,26,254,富邦-嘉義,2024-07-26,9692
00940,元大台灣價值高息,259,6,253,富邦-嘉義,2024-07-26,9692
00946,群益科技高息成長,265,33,232,富邦-嘉義,2024-07-26,9692
00918,大華優利高填息30,140,14,126,富邦-嘉義,2024-07-26,9692
2888,新光金,182,57,125,富邦-嘉義,2024-07-26,9692
2316,楠梓電,130,10,120,富邦-嘉義,2024-07-26,9692
0056,元大高股息,144,35,109,富邦-嘉義,2024-07-26,9692
00934,中信成長高股息,118,16,102,富邦-嘉義,2024-07-26,9692
2884,玉山金,150,54,96,富邦-嘉義,2024-07-26,9692
2002,中鋼,114,26,88,富邦-嘉義,2024-07-26,9692
2027,大成鋼,131,45,86,富邦-嘉義,2024-07-26,9692
2317,鴻海,435,353,82,富邦-嘉義,2024-07-26,9692
00679B,元大美債20年,164,87,77,富邦-嘉義,2024-07-26,9692
2330,台積電,184,108,76,富邦-嘉義,2024-07-26,9692
00713,元大台灣高息低波,69,2,67,富邦-嘉義,2024-07-26,9692
3710,連展投控,70,5,65,富邦-嘉義,2024-07-26,9692
00951,台新日本半導體,61,0,61,富邦-嘉義,2024-07-26,9692
2834,臺企銀,87,30,57,富邦-嘉義,2024-07-26,9692
00712,復華富時不動產,62,6,56,富邦-嘉義,2024-07-26,9692
3711,日月光投控,57,1,56,富邦-嘉義,2024-07-26,9692
006208,富邦台50,61,8,53,富邦-嘉義,2024-07-26,9692
00795B,中信美國公債20年,53,1,52,富邦-嘉義,2024-07-26,9692
2356,英業達,63,12,51,富邦-嘉義,2024-07-26,9692
2812,台中銀,69,23,46,富邦-嘉義,2024-07-26,9692
1714,和桐,50,6,44,富邦-嘉義,2024-07-26,9692
3689,湧德,42,1,41,富邦-嘉義,2024-07-26,9692
6770,力積電,39,1,38,富邦-嘉義,2024-07-26,9692
00923,群益台ESG低碳50,38,0,38,富邦-嘉義,2024-07-26,9692
1712,興農,42,4,38,富邦-嘉義,2024-07-26,9692
2464,盟立,51,13,38,富邦-嘉義,2024-07-26,9692
2408,南亞科,41,3,38,富邦-嘉義,2024-07-26,9692
00687B,國泰20年美債,51,14,37,富邦-嘉義,2024-07-26,9692
00751B,元大AAA至A公司債,37,0,37,富邦-嘉義,2024-07-26,9692
2303,聯電,158,121,37,富邦-嘉義,2024-07-26,9692
1444,力麗,81,44,37,富邦-嘉義,2024-07-26,9692
00655L,國泰中國A50正2,46,10,36,富邦-嘉義,2024-07-26,9692
1314,中石化,55,20,35,富邦-嘉義,2024-07-26,9692
2243,宏旭-KY,36,1,35,富邦-嘉義,2024-07-26,9692
2382,廣達,37,2,35,富邦-嘉義,2024-07-26,9692
2524,京城,99,65,34,富邦-嘉義,2024-07-26,9692
2409,友達,46,12,34,富邦-嘉義,2024-07-26,9692
6188,廣明,33,0,33,富邦-嘉義,2024-07-26,9692
3663,鑫科,457,425,32,富邦-嘉義,2024-07-26,9692
4956,光鋐,35,5,30,富邦-嘉義,2024-07-26,9692
1313,聯成,30,0,30,富邦-嘉義,2024-07-26,9692
6768,志強-KY,28,0,28,富邦-嘉義,2024-07-26,9692
1316,上曜,763,74,689,富邦-嘉義,2024-07-29,9692
1815,富喬,833,328,505,富邦-嘉義,2024-07-29,9692
00929,復華台灣科技優息,444,62,382,富邦-嘉義,2024-07-29,9692
00937B,群益ESG投等債20,447,90,357,富邦-嘉義,2024-07-29,9692
00680L,元大美債20正2,300,7,293,富邦-嘉義,2024-07-29,9692
2349,錸德,437,245,192,富邦-嘉義,2024-07-29,9692
00934,中信成長高股息,171,5,166,富邦-嘉義,2024-07-29,9692
00878,國泰永續高股息,177,31,146,富邦-嘉義,2024-07-29,9692
2062,橋椿,144,5,139,富邦-嘉義,2024-07-29,9692
00940,元大台灣價值高息,175,40,135,富邦-嘉義,2024-07-29,9692
2489,瑞軒,149,31,118,富邦-嘉義,2024-07-29,9692
2316,楠梓電,123,7,116,富邦-嘉義,2024-07-29,9692
2367,燿華,126,22,104,富邦-嘉義,2024-07-29,9692
5258,虹堡,100,0,100,富邦-嘉義,2024-07-29,9692
0056,元大高股息,113,21,92,富邦-嘉義,2024-07-29,9692
00946,群益科技高息成長,93,12,81,富邦-嘉義,2024-07-29,9692
2344,華邦電,75,7,68,富邦-嘉義,2024-07-29,9692
9946,三發地產,64,2,62,富邦-嘉義,2024-07-29,9692
5213,亞昕,61,0,61,富邦-嘉義,2024-07-29,9692
2884,玉山金,85,25,60,富邦-嘉義,2024-07-29,9692
1513,中興電,83,27,56,富邦-嘉義,2024-07-29,9692
2356,英業達,72,17,55,富邦-嘉義,2024-07-29,9692
00679B,元大美債20年,67,19,48,富邦-嘉義,2024-07-29,9692
1717,長興,47,0,47,富邦-嘉義,2024-07-29,9692
2303,聯電,50,6,44,富邦-嘉義,2024-07-29,9692
00632R,元大台灣50反1,55,12,43,富邦-嘉義,2024-07-29,9692
2867,三商壽,46,5,41,富邦-嘉義,2024-07-29,9692
2313,華通,44,4,40,富邦-嘉義,2024-07-29,9692
8104,錸寶,61,23,38,富邦-嘉義,2024-07-29,9692
3006,晶豪科,49,12,37,富邦-嘉義,2024-07-29,9692
3713,新晶投控,37,0,37,富邦-嘉義,2024-07-29,9692
1444,力麗,33,0,33,富邦-嘉義,2024-07-29,9692
6217,中探針,34,1,33,富邦-嘉義,2024-07-29,9692
3163,波若威,172,139,33,富邦-嘉義,2024-07-29,9692
3481,群創,56,24,32,富邦-嘉義,2024-07-29,9692
2409,友達,37,6,31,富邦-嘉義,2024-07-29,9692
1529,樂事綠能,33,2,31,富邦-嘉義,2024-07-29,9692
6112,邁達特,30,0,30,富邦-嘉義,2024-07-29,9692
6776,展�眥篕�,30,0,30,富邦-嘉義,2024-07-29,9692
2520,冠德,33,3,30,富邦-嘉義,2024-07-29,9692
3231,緯創,49,19,30,富邦-嘉義,2024-07-29,9692
1808,潤隆,34,5,29,富邦-嘉義,2024-07-29,9692
5443,均豪,379,352,27,富邦-嘉義,2024-07-29,9692
00939,統一台灣高息動能,32,5,27,富邦-嘉義,2024-07-29,9692
1608,華榮,45,19,26,富邦-嘉義,2024-07-29,9692
3710,連展投控,31,6,25,富邦-嘉義,2024-07-29,9692
00931B,統一美債20年,25,0,25,富邦-嘉義,2024-07-29,9692
2801,彰銀,45,20,25,富邦-嘉義,2024-07-29,9692
00664R,國泰臺灣加權反1,26,1,25,富邦-嘉義,2024-07-29,9692
00706L,期元大S＆P日圓正2,24,0,24,富邦-嘉義,2024-07-29,9692
00945B,凱基美國非投等債,453,0,453,富邦-嘉義,2024-07-30,9692
3047,訊舟,738,466,272,富邦-嘉義,2024-07-30,9692
00940,元大台灣價值高息,298,42,256,富邦-嘉義,2024-07-30,9692
00946,群益科技高息成長,249,1,248,富邦-嘉義,2024-07-30,9692
00937B,群益ESG投等債20,258,24,234,富邦-嘉義,2024-07-30,9692
00715L,期街口布蘭特正2,203,0,203,富邦-嘉義,2024-07-30,9692
00679B,元大美債20年,232,42,190,富邦-嘉義,2024-07-30,9692
00929,復華台灣科技優息,395,229,166,富邦-嘉義,2024-07-30,9692
00878,國泰永續高股息,190,44,146,富邦-嘉義,2024-07-30,9692
2383,台光電,121,1,120,富邦-嘉義,2024-07-30,9692
3481,群創,156,54,102,富邦-嘉義,2024-07-30,9692
3013,晟銘電,104,15,89,富邦-嘉義,2024-07-30,9692
2891,中信金,87,10,77,富邦-嘉義,2024-07-30,9692
2359,所羅門,111,39,72,富邦-嘉義,2024-07-30,9692
0056,元大高股息,142,74,68,富邦-嘉義,2024-07-30,9692
2349,錸德,1816,1749,67,富邦-嘉義,2024-07-30,9692
8440,綠電,91,25,66,富邦-嘉義,2024-07-30,9692
2303,聯電,116,50,66,富邦-嘉義,2024-07-30,9692
2867,三商壽,72,7,65,富邦-嘉義,2024-07-30,9692
00665L,富邦�琤肭磪囓�2,202,140,62,富邦-嘉義,2024-07-30,9692
3535,晶彩科,84,24,60,富邦-嘉義,2024-07-30,9692
4513,福裕,192,132,60,富邦-嘉義,2024-07-30,9692
8064,東捷,223,163,60,富邦-嘉義,2024-07-30,9692
1449,佳和,88,31,57,富邦-嘉義,2024-07-30,9692
2344,華邦電,79,24,55,富邦-嘉義,2024-07-30,9692
00936,台新永續高息中小,55,3,52,富邦-嘉義,2024-07-30,9692
00931B,統一美債20年,55,3,52,富邦-嘉義,2024-07-30,9692
1529,樂事綠能,53,1,52,富邦-嘉義,2024-07-30,9692
4927,泰鼎-KY,72,23,49,富邦-嘉義,2024-07-30,9692
6133,金橋,43,0,43,富邦-嘉義,2024-07-30,9692
8028,昇陽半導體,618,575,43,富邦-嘉義,2024-07-30,9692
8374,羅昇,66,24,42,富邦-嘉義,2024-07-30,9692
2524,京城,145,103,42,富邦-嘉義,2024-07-30,9692
5310,天剛,43,1,42,富邦-嘉義,2024-07-30,9692
1808,潤隆,54,14,40,富邦-嘉義,2024-07-30,9692
2408,南亞科,53,13,40,富邦-嘉義,2024-07-30,9692
2442,新美齊,44,5,39,富邦-嘉義,2024-07-30,9692
1712,興農,37,0,37,富邦-嘉義,2024-07-30,9692
9906,欣巴巴,63,27,36,富邦-嘉義,2024-07-30,9692
2313,華通,44,9,35,富邦-嘉義,2024-07-30,9692
2834,臺企銀,53,21,32,富邦-嘉義,2024-07-30,9692
3712,永崴投控,35,4,31,富邦-嘉義,2024-07-30,9692
3518,柏騰,166,136,30,富邦-嘉義,2024-07-30,9692
00942B,台新美A公司債20+,30,0,30,富邦-嘉義,2024-07-30,9692
5530,龍巖,30,0,30,富邦-嘉義,2024-07-30,9692
5443,均豪,147,118,29,富邦-嘉義,2024-07-30,9692
2610,華航,42,14,28,富邦-嘉義,2024-07-30,9692
2365,昆盈,167,139,28,富邦-嘉義,2024-07-30,9692
6505,台塑化,28,1,27,富邦-嘉義,2024-07-30,9692
2317,鴻海,110,84,26,富邦-嘉義,2024-07-30,9692
2337,旺宏,1108,852,256,富邦-嘉義,2024-07-31,9692
3481,群創,397,201,196,富邦-嘉義,2024-07-31,9692
00632R,元大台灣50反1,245,67,178,富邦-嘉義,2024-07-31,9692
00715L,期街口布蘭特正2,160,0,160,富邦-嘉義,2024-07-31,9692
3663,鑫科,391,242,149,富邦-嘉義,2024-07-31,9692
2409,友達,114,4,110,富邦-嘉義,2024-07-31,9692
00919,群益台灣精選高息,142,33,109,富邦-嘉義,2024-07-31,9692
00940,元大台灣價值高息,131,23,108,富邦-嘉義,2024-07-31,9692
2061,風青,131,27,104,富邦-嘉義,2024-07-31,9692
9902,台火,248,158,90,富邦-嘉義,2024-07-31,9692
2489,瑞軒,182,102,80,富邦-嘉義,2024-07-31,9692
2897,王道銀行,80,0,80,富邦-嘉義,2024-07-31,9692
00946,群益科技高息成長,84,5,79,富邦-嘉義,2024-07-31,9692
8011,台通,81,5,76,富邦-嘉義,2024-07-31,9692
00680L,元大美債20正2,69,0,69,富邦-嘉義,2024-07-31,9692
00878,國泰永續高股息,74,8,66,富邦-嘉義,2024-07-31,9692
2362,藍天,88,23,65,富邦-嘉義,2024-07-31,9692
2515,中工,65,4,61,富邦-嘉義,2024-07-31,9692
2303,聯電,56,8,48,富邦-嘉義,2024-07-31,9692
1808,潤隆,52,5,47,富邦-嘉義,2024-07-31,9692
2439,美律,46,0,46,富邦-嘉義,2024-07-31,9692
2867,三商壽,72,34,38,富邦-嘉義,2024-07-31,9692
00891,中信關鍵半導體,37,0,37,富邦-嘉義,2024-07-31,9692
2801,彰銀,49,12,37,富邦-嘉義,2024-07-31,9692
9955,佳龍,42,9,33,富邦-嘉義,2024-07-31,9692
2344,華邦電,233,202,31,富邦-嘉義,2024-07-31,9692
00895,富邦未來車,30,0,30,富邦-嘉義,2024-07-31,9692
2464,盟立,43,14,29,富邦-嘉義,2024-07-31,9692
0056,元大高股息,36,7,29,富邦-嘉義,2024-07-31,9692
2486,一詮,67,39,28,富邦-嘉義,2024-07-31,9692
2201,裕隆,31,3,28,富邦-嘉義,2024-07-31,9692
3498,陽程,31,5,26,富邦-嘉義,2024-07-31,9692
2356,英業達,39,13,26,富邦-嘉義,2024-07-31,9692
6112,邁達特,30,4,26,富邦-嘉義,2024-07-31,9692
00929,復華台灣科技優息,157,131,26,富邦-嘉義,2024-07-31,9692
00720B,元大投資級公司債,26,0,26,富邦-嘉義,2024-07-31,9692
4564,元翎,54,30,24,富邦-嘉義,2024-07-31,9692
00927,群益半導體收益,24,0,24,富邦-嘉義,2024-07-31,9692
6265,方土昶,23,0,23,富邦-嘉義,2024-07-31,9692
1714,和桐,31,8,23,富邦-嘉義,2024-07-31,9692
2889,國票金,31,9,22,富邦-嘉義,2024-07-31,9692
6239,力成,22,1,21,富邦-嘉義,2024-07-31,9692
3535,晶彩科,319,298,21,富邦-嘉義,2024-07-31,9692
3339,泰谷,22,1,21,富邦-嘉義,2024-07-31,9692
00751B,元大AAA至A公司債,21,1,20,富邦-嘉義,2024-07-31,9692
3037,欣興,36,15,21,富邦-嘉義,2024-07-31,9692
3105,穩懋,47,26,21,富邦-嘉義,2024-07-31,9692
6492,生華科,21,1,20,富邦-嘉義,2024-07-31,9692
2027,大成鋼,29,9,20,富邦-嘉義,2024-07-31,9692
00905,FT臺灣Smart,19,0,19,富邦-嘉義,2024-07-31,9692
1316,上曜,2442,416,2026,富邦-嘉義,2024-08-01,9692
00946,群益科技高息成長,313,13,300,富邦-嘉義,2024-08-01,9692
2543,皇昌,325,85,240,富邦-嘉義,2024-08-01,9692
4303,信立,383,158,225,富邦-嘉義,2024-08-01,9692
2615,萬海,404,179,225,富邦-嘉義,2024-08-01,9692
2362,藍天,365,189,176,富邦-嘉義,2024-08-01,9692
2524,京城,204,49,155,富邦-嘉義,2024-08-01,9692
2610,華航,160,8,152,富邦-嘉義,2024-08-01,9692
00940,元大台灣價值高息,197,46,151,富邦-嘉義,2024-08-01,9692
4714,永捷,443,297,146,富邦-嘉義,2024-08-01,9692
2402,毅嘉,184,40,144,富邦-嘉義,2024-08-01,9692
00706L,期元大S＆P日圓正2,180,65,115,富邦-嘉義,2024-08-01,9692
2884,玉山金,127,18,109,富邦-嘉義,2024-08-01,9692
4510,高鋒,409,301,108,富邦-嘉義,2024-08-01,9692
00878,國泰永續高股息,117,11,106,富邦-嘉義,2024-08-01,9692
00942B,台新美A公司債20+,124,30,94,富邦-嘉義,2024-08-01,9692
00905,FT臺灣Smart,83,2,81,富邦-嘉義,2024-08-01,9692
3230,錦明,75,5,70,富邦-嘉義,2024-08-01,9692
1540,喬福,552,484,68,富邦-嘉義,2024-08-01,9692
2867,三商壽,68,1,67,富邦-嘉義,2024-08-01,9692
00688L,國泰20年美債正2,90,25,65,富邦-嘉義,2024-08-01,9692
8011,台通,97,36,61,富邦-嘉義,2024-08-01,9692
6264,富裔,60,1,59,富邦-嘉義,2024-08-01,9692
4562,穎漢,217,161,56,富邦-嘉義,2024-08-01,9692
2409,友達,62,6,56,富邦-嘉義,2024-08-01,9692
00881,國泰台灣5G+,60,9,51,富邦-嘉義,2024-08-01,9692
8183,精星,50,0,50,富邦-嘉義,2024-08-01,9692
5519,隆大,53,5,48,富邦-嘉義,2024-08-01,9692
00934,中信成長高股息,70,25,45,富邦-嘉義,2024-08-01,9692
9906,欣巴巴,49,4,45,富邦-嘉義,2024-08-01,9692
1717,長興,42,1,41,富邦-嘉義,2024-08-01,9692
9921,巨大,41,0,41,富邦-嘉義,2024-08-01,9692
2801,彰銀,42,1,41,富邦-嘉義,2024-08-01,9692
00687B,國泰20年美債,97,57,40,富邦-嘉義,2024-08-01,9692
00919,群益台灣精選高息,76,37,39,富邦-嘉義,2024-08-01,9692
8114,振樺電,40,1,39,富邦-嘉義,2024-08-01,9692
3710,連展投控,54,16,38,富邦-嘉義,2024-08-01,9692
00676R,富邦臺灣加權反1,38,0,38,富邦-嘉義,2024-08-01,9692
4927,泰鼎-KY,73,35,38,富邦-嘉義,2024-08-01,9692
2313,華通,46,10,36,富邦-嘉義,2024-08-01,9692
00931B,統一美債20年,34,0,34,富邦-嘉義,2024-08-01,9692
00945B,凱基美國非投等債,32,0,32,富邦-嘉義,2024-08-01,9692
2312,金寶,55,24,31,富邦-嘉義,2024-08-01,9692
0056,元大高股息,54,24,30,富邦-嘉義,2024-08-01,9692
3686,達能,32,2,30,富邦-嘉義,2024-08-01,9692
00655L,國泰中國A50正2,30,0,30,富邦-嘉義,2024-08-01,9692
8374,羅昇,30,0,30,富邦-嘉義,2024-08-01,9692
2442,新美齊,41,12,29,富邦-嘉義,2024-08-01,9692
2634,漢翔,30,2,28,富邦-嘉義,2024-08-01,9692
2536,宏普,28,1,27,富邦-嘉義,2024-08-01,9692
00929,復華台灣科技優息,916,100,816,富邦-嘉義,2024-08-02,9692
2515,中工,549,13,536,富邦-嘉義,2024-08-02,9692
00878,國泰永續高股息,565,44,521,富邦-嘉義,2024-08-02,9692
2317,鴻海,952,647,305,富邦-嘉義,2024-08-02,9692
00919,群益台灣精選高息,256,25,231,富邦-嘉義,2024-08-02,9692
00940,元大台灣價值高息,245,31,214,富邦-嘉義,2024-08-02,9692
00915,凱基優選高股息30,207,1,206,富邦-嘉義,2024-08-02,9692
00665L,富邦�琤肭磪囓�2,177,15,162,富邦-嘉義,2024-08-02,9692
00937B,群益ESG投等債20,257,95,162,富邦-嘉義,2024-08-02,9692
5512,力麒,143,19,124,富邦-嘉義,2024-08-02,9692
00680L,元大美債20正2,136,19,117,富邦-嘉義,2024-08-02,9692
00679B,元大美債20年,161,45,116,富邦-嘉義,2024-08-02,9692
9955,佳龍,229,114,115,富邦-嘉義,2024-08-02,9692
2316,楠梓電,119,9,110,富邦-嘉義,2024-08-02,9692
2344,華邦電,220,114,106,富邦-嘉義,2024-08-02,9692
00712,復華富時不動產,123,18,105,富邦-嘉義,2024-08-02,9692
2867,三商壽,140,35,105,富邦-嘉義,2024-08-02,9692
2365,昆盈,1095,994,101,富邦-嘉義,2024-08-02,9692
2511,太子,104,5,99,富邦-嘉義,2024-08-02,9692
0056,元大高股息,131,32,99,富邦-嘉義,2024-08-02,9692
00946,群益科技高息成長,107,10,97,富邦-嘉義,2024-08-02,9692
1447,力鵬,91,1,90,富邦-嘉義,2024-08-02,9692
00951,台新日本半導體,120,31,89,富邦-嘉義,2024-08-02,9692
2409,友達,124,40,84,富邦-嘉義,2024-08-02,9692
2330,台積電,406,323,83,富邦-嘉義,2024-08-02,9692
2506,太設,85,2,83,富邦-嘉義,2024-08-02,9692
00949,復華日本龍頭,77,0,77,富邦-嘉義,2024-08-02,9692
2337,旺宏,102,29,73,富邦-嘉義,2024-08-02,9692
8374,羅昇,232,160,72,富邦-嘉義,2024-08-02,9692
2891,中信金,72,3,69,富邦-嘉義,2024-08-02,9692
3006,晶豪科,67,0,67,富邦-嘉義,2024-08-02,9692
00931B,統一美債20年,67,1,66,富邦-嘉義,2024-08-02,9692
00881,國泰台灣5G+,100,34,66,富邦-嘉義,2024-08-02,9692
00936,台新永續高息中小,87,23,64,富邦-嘉義,2024-08-02,9692
2303,聯電,97,33,64,富邦-嘉義,2024-08-02,9692
2884,玉山金,68,6,62,富邦-嘉義,2024-08-02,9692
1528,恩德,61,2,59,富邦-嘉義,2024-08-02,9692
4510,高鋒,585,526,59,富邦-嘉義,2024-08-02,9692
00923,群益台ESG低碳50,69,10,59,富邦-嘉義,2024-08-02,9692
3037,欣興,79,21,58,富邦-嘉義,2024-08-02,9692
4534,慶騰,81,23,58,富邦-嘉義,2024-08-02,9692
00922,國泰台灣領袖50,54,0,54,富邦-嘉義,2024-08-02,9692
3710,連展投控,50,0,50,富邦-嘉義,2024-08-02,9692
2313,華通,56,9,47,富邦-嘉義,2024-08-02,9692
00753L,中信中國50正2,46,0,46,富邦-嘉義,2024-08-02,9692
2353,宏��,61,17,44,富邦-嘉義,2024-08-02,9692
1815,富喬,49,5,44,富邦-嘉義,2024-08-02,9692
00927,群益半導體收益,40,0,40,富邦-嘉義,2024-08-02,9692
00696B,富邦美債20年,42,2,40,富邦-嘉義,2024-08-02,9692
0050,元大台灣50,54,15,39,富邦-嘉義,2024-08-02,9692
00929,復華台灣科技優息,1672,500,1172,富邦-嘉義,2024-08-05,9692
00940,元大台灣價值高息,1292,185,1107,富邦-嘉義,2024-08-05,9692
00715L,期街口布蘭特正2,951,5,946,富邦-嘉義,2024-08-05,9692
00706L,期元大S＆P日圓正2,499,9,490,富邦-嘉義,2024-08-05,9692
00878,國泰永續高股息,721,292,429,富邦-嘉義,2024-08-05,9692
1314,中石化,329,11,318,富邦-嘉義,2024-08-05,9692
3481,群創,477,219,258,富邦-嘉義,2024-08-05,9692
2409,友達,281,41,240,富邦-嘉義,2024-08-05,9692
3710,連展投控,225,0,225,富邦-嘉義,2024-08-05,9692
00946,群益科技高息成長,255,45,210,富邦-嘉義,2024-08-05,9692
2834,臺企銀,274,117,157,富邦-嘉義,2024-08-05,9692
2323,中環,154,8,146,富邦-嘉義,2024-08-05,9692
2316,楠梓電,157,14,143,富邦-嘉義,2024-08-05,9692
2892,第一金,202,62,140,富邦-嘉義,2024-08-05,9692
2515,中工,145,19,126,富邦-嘉義,2024-08-05,9692
00923,群益台ESG低碳50,159,38,121,富邦-嘉義,2024-08-05,9692
2317,鴻海,2442,2326,116,富邦-嘉義,2024-08-05,9692
0056,元大高股息,236,121,115,富邦-嘉義,2024-08-05,9692
6015,宏遠證,114,0,114,富邦-嘉義,2024-08-05,9692
00680L,元大美債20正2,467,361,106,富邦-嘉義,2024-08-05,9692
1218,泰山,102,0,102,富邦-嘉義,2024-08-05,9692
3576,聯合再生,111,12,99,富邦-嘉義,2024-08-05,9692
00679B,元大美債20年,269,182,87,富邦-嘉義,2024-08-05,9692
1712,興農,110,27,83,富邦-嘉義,2024-08-05,9692
00936,台新永續高息中小,101,23,78,富邦-嘉義,2024-08-05,9692
2489,瑞軒,79,2,77,富邦-嘉義,2024-08-05,9692
2330,台積電,923,853,70,富邦-嘉義,2024-08-05,9692
2506,太設,60,0,60,富邦-嘉義,2024-08-05,9692
2845,遠東銀,57,0,57,富邦-嘉義,2024-08-05,9692
1714,和桐,57,0,57,富邦-嘉義,2024-08-05,9692
3016,嘉晶,91,38,53,富邦-嘉義,2024-08-05,9692
006208,富邦台50,72,20,52,富邦-嘉義,2024-08-05,9692
00687B,國泰20年美債,138,87,51,富邦-嘉義,2024-08-05,9692
1785,光洋科,72,21,51,富邦-嘉義,2024-08-05,9692
2405,輔信,84,33,51,富邦-嘉義,2024-08-05,9692
2107,厚生,51,0,51,富邦-嘉義,2024-08-05,9692
3609,三一東林,50,0,50,富邦-嘉義,2024-08-05,9692
8071,能率網通,50,0,50,富邦-嘉義,2024-08-05,9692
0050,元大台灣50,79,30,49,富邦-嘉義,2024-08-05,9692
1802,台玻,54,6,48,富邦-嘉義,2024-08-05,9692
3501,維熹,52,4,48,富邦-嘉義,2024-08-05,9692
2486,一詮,147,100,47,富邦-嘉義,2024-08-05,9692
2337,旺宏,203,156,47,富邦-嘉義,2024-08-05,9692
2313,華通,52,5,47,富邦-嘉義,2024-08-05,9692
2887,台新金,117,70,47,富邦-嘉義,2024-08-05,9692
3163,波若威,192,147,45,富邦-嘉義,2024-08-05,9692
00922,國泰台灣領袖50,45,2,43,富邦-嘉義,2024-08-05,9692
1522,堤維西,41,0,41,富邦-嘉義,2024-08-05,9692
1608,華榮,47,6,41,富邦-嘉義,2024-08-05,9692
4906,正文,48,9,39,富邦-嘉義,2024-08-05,9692
00632R,元大台灣50反1,1065,649,416,富邦-嘉義,2024-08-06,9692
00933B,國泰10Y+金融債,264,41,223,富邦-嘉義,2024-08-06,9692
4510,高鋒,937,721,216,富邦-嘉義,2024-08-06,9692
00679B,元大美債20年,348,136,212,富邦-嘉義,2024-08-06,9692
1314,中石化,203,35,168,富邦-嘉義,2024-08-06,9692
2603,長榮,375,233,142,富邦-嘉義,2024-08-06,9692
2409,友達,134,7,127,富邦-嘉義,2024-08-06,9692
00878,國泰永續高股息,300,184,116,富邦-嘉義,2024-08-06,9692
2888,新光金,322,213,109,富邦-嘉義,2024-08-06,9692
00935,野村臺灣新科技50,107,5,102,富邦-嘉義,2024-08-06,9692
1540,喬福,1159,1058,101,富邦-嘉義,2024-08-06,9692
00940,元大台灣價值高息,296,195,101,富邦-嘉義,2024-08-06,9692
2317,鴻海,4154,4058,96,富邦-嘉義,2024-08-06,9692
2615,萬海,487,394,93,富邦-嘉義,2024-08-06,9692
2383,台光電,106,22,84,富邦-嘉義,2024-08-06,9692
2887,台新金,101,18,83,富邦-嘉義,2024-08-06,9692
00929,復華台灣科技優息,897,818,79,富邦-嘉義,2024-08-06,9692
2337,旺宏,144,68,76,富邦-嘉義,2024-08-06,9692
00918,大華優利高填息30,81,8,73,富邦-嘉義,2024-08-06,9692
9105,泰金寶-DR,78,8,70,富邦-嘉義,2024-08-06,9692
00715L,期街口布蘭特正2,90,22,68,富邦-嘉義,2024-08-06,9692
00948B,中信優息投資級債,68,0,68,富邦-嘉義,2024-08-06,9692
9955,佳龍,114,51,63,富邦-嘉義,2024-08-06,9692
3563,牧德,68,8,60,富邦-嘉義,2024-08-06,9692
3284,太普高,60,0,60,富邦-嘉義,2024-08-06,9692
00900,富邦特選高股息30,73,16,57,富邦-嘉義,2024-08-06,9692
2609,陽明,345,288,57,富邦-嘉義,2024-08-06,9692
4414,如興,50,0,50,富邦-嘉義,2024-08-06,9692
2243,宏旭-KY,50,0,50,富邦-嘉義,2024-08-06,9692
3189,景碩,211,164,47,富邦-嘉義,2024-08-06,9692
2402,毅嘉,55,9,46,富邦-嘉義,2024-08-06,9692
00664R,國泰臺灣加權反1,46,0,46,富邦-嘉義,2024-08-06,9692
2542,興富發,57,13,44,富邦-嘉義,2024-08-06,9692
2537,聯上發,42,1,41,富邦-嘉義,2024-08-06,9692
00936,台新永續高息中小,47,7,40,富邦-嘉義,2024-08-06,9692
3047,訊舟,49,10,39,富邦-嘉義,2024-08-06,9692
3013,晟銘電,64,27,37,富邦-嘉義,2024-08-06,9692
2374,佳能,40,6,34,富邦-嘉義,2024-08-06,9692
2365,昆盈,264,230,34,富邦-嘉義,2024-08-06,9692
3710,連展投控,45,13,32,富邦-嘉義,2024-08-06,9692
2388,威盛,68,37,31,富邦-嘉義,2024-08-06,9692
3593,力銘,41,10,31,富邦-嘉義,2024-08-06,9692
5880,合庫金,48,17,31,富邦-嘉義,2024-08-06,9692
2316,楠梓電,36,5,31,富邦-嘉義,2024-08-06,9692
8021,尖點,30,0,30,富邦-嘉義,2024-08-06,9692
2913,農林,30,0,30,富邦-嘉義,2024-08-06,9692
1785,光洋科,67,38,29,富邦-嘉義,2024-08-06,9692
2405,輔信,35,7,28,富邦-嘉義,2024-08-06,9692
0050,元大台灣50,49,23,26,富邦-嘉義,2024-08-06,9692
2489,瑞軒,129,103,26,富邦-嘉義,2024-08-06,9692
00632R,元大台灣50反1,1199,7,1192,富邦-嘉義,2024-08-07,9692
00929,復華台灣科技優息,612,276,336,富邦-嘉義,2024-08-07,9692
00715L,期街口布蘭特正2,295,3,292,富邦-嘉義,2024-08-07,9692
2537,聯上發,220,6,214,富邦-嘉義,2024-08-07,9692
2538,基泰,180,2,178,富邦-嘉義,2024-08-07,9692
00878,國泰永續高股息,197,27,170,富邦-嘉義,2024-08-07,9692
00919,群益台灣精選高息,190,30,160,富邦-嘉義,2024-08-07,9692
2892,第一金,175,21,154,富邦-嘉義,2024-08-07,9692
2801,彰銀,158,6,152,富邦-嘉義,2024-08-07,9692
2349,錸德,178,39,139,富邦-嘉義,2024-08-07,9692
2880,華南金,95,0,95,富邦-嘉義,2024-08-07,9692
2337,旺宏,98,12,86,富邦-嘉義,2024-08-07,9692
2344,華邦電,99,16,83,富邦-嘉義,2024-08-07,9692
00680L,元大美債20正2,208,128,80,富邦-嘉義,2024-08-07,9692
2408,南亞科,86,8,78,富邦-嘉義,2024-08-07,9692
2317,鴻海,3791,3714,77,富邦-嘉義,2024-08-07,9692
00945B,凱基美國非投等債,76,0,76,富邦-嘉義,2024-08-07,9692
2887,台新金,91,17,74,富邦-嘉義,2024-08-07,9692
4562,穎漢,131,63,68,富邦-嘉義,2024-08-07,9692
00918,大華優利高填息30,78,11,67,富邦-嘉義,2024-08-07,9692
8374,羅昇,149,85,64,富邦-嘉義,2024-08-07,9692
00641R,富邦日本反1,61,0,61,富邦-嘉義,2024-08-07,9692
00795B,中信美國公債20年,58,11,47,富邦-嘉義,2024-08-07,9692
3047,訊舟,75,28,47,富邦-嘉義,2024-08-07,9692
2542,興富發,60,15,45,富邦-嘉義,2024-08-07,9692
00948B,中信優息投資級債,53,8,45,富邦-嘉義,2024-08-07,9692
1301,台塑,59,14,45,富邦-嘉義,2024-08-07,9692
1229,聯華,60,16,44,富邦-嘉義,2024-08-07,9692
2312,金寶,171,129,42,富邦-嘉義,2024-08-07,9692
3481,群創,75,37,38,富邦-嘉義,2024-08-07,9692
2367,燿華,43,9,34,富邦-嘉義,2024-08-07,9692
2382,廣達,89,56,33,富邦-嘉義,2024-08-07,9692
00670L,富邦NASDAQ正2,31,0,31,富邦-嘉義,2024-08-07,9692
6213,聯茂,68,38,30,富邦-嘉義,2024-08-07,9692
00688L,國泰20年美債正2,42,12,30,富邦-嘉義,2024-08-07,9692
1711,永光,30,1,29,富邦-嘉義,2024-08-07,9692
2442,新美齊,29,0,29,富邦-嘉義,2024-08-07,9692
00902,中信電池及儲能,28,0,28,富邦-嘉義,2024-08-07,9692
3037,欣興,42,15,27,富邦-嘉義,2024-08-07,9692
6163,華電網,27,0,27,富邦-嘉義,2024-08-07,9692
00764B,群益25年美債,25,0,25,富邦-嘉義,2024-08-07,9692
00676R,富邦臺灣加權反1,25,0,25,富邦-嘉義,2024-08-07,9692
3663,鑫科,55,31,24,富邦-嘉義,2024-08-07,9692
8028,昇陽半導體,59,35,24,富邦-嘉義,2024-08-07,9692
3321,同泰,23,0,23,富邦-嘉義,2024-08-07,9692
2006,東和鋼鐵,26,4,22,富邦-嘉義,2024-08-07,9692
5443,均豪,52,30,22,富邦-嘉義,2024-08-07,9692
00679B,元大美債20年,172,151,21,富邦-嘉義,2024-08-07,9692
1104,環泥,21,0,21,富邦-嘉義,2024-08-07,9692
6578,達邦蛋白,21,0,21,富邦-嘉義,2024-08-07,9692
00632R,元大台灣50反1,275,15,260,富邦-嘉義,2024-08-08,9692
00679B,元大美債20年,351,94,257,富邦-嘉義,2024-08-08,9692
2834,臺企銀,308,76,232,富邦-嘉義,2024-08-08,9692
00929,復華台灣科技優息,390,160,230,富邦-嘉義,2024-08-08,9692
00687B,國泰20年美債,230,72,158,富邦-嘉義,2024-08-08,9692
4174,浩鼎,211,59,152,富邦-嘉義,2024-08-08,9692
00878,國泰永續高股息,151,6,145,富邦-嘉義,2024-08-08,9692
00937B,群益ESG投等債20,151,20,131,富邦-嘉義,2024-08-08,9692
2801,彰銀,140,21,119,富邦-嘉義,2024-08-08,9692
2886,兆豐金,110,0,110,富邦-嘉義,2024-08-08,9692
00715L,期街口布蘭特正2,145,50,95,富邦-嘉義,2024-08-08,9692
2603,長榮,183,92,91,富邦-嘉義,2024-08-08,9692
00680L,元大美債20正2,90,0,90,富邦-嘉義,2024-08-08,9692
8064,東捷,82,13,69,富邦-嘉義,2024-08-08,9692
6113,亞矽,65,0,65,富邦-嘉義,2024-08-08,9692
00918,大華優利高填息30,183,118,65,富邦-嘉義,2024-08-08,9692
1714,和桐,66,2,64,富邦-嘉義,2024-08-08,9692
2344,華邦電,63,1,62,富邦-嘉義,2024-08-08,9692
3167,大量,61,2,59,富邦-嘉義,2024-08-08,9692
00706L,期元大S＆P日圓正2,60,5,55,富邦-嘉義,2024-08-08,9692
2609,陽明,95,40,55,富邦-嘉義,2024-08-08,9692
2610,華航,68,16,52,富邦-嘉義,2024-08-08,9692
2317,鴻海,1293,1246,47,富邦-嘉義,2024-08-08,9692
2892,第一金,54,7,47,富邦-嘉義,2024-08-08,9692
00951,台新日本半導體,44,0,44,富邦-嘉義,2024-08-08,9692
3450,聯鈞,232,189,43,富邦-嘉義,2024-08-08,9692
1301,台塑,47,7,40,富邦-嘉義,2024-08-08,9692
1540,喬福,302,263,39,富邦-嘉義,2024-08-08,9692
00688L,國泰20年美債正2,39,0,39,富邦-嘉義,2024-08-08,9692
2489,瑞軒,1068,1031,37,富邦-嘉義,2024-08-08,9692
1316,上曜,41,4,37,富邦-嘉義,2024-08-08,9692
2543,皇昌,77,41,36,富邦-嘉義,2024-08-08,9692
1326,台化,39,4,35,富邦-嘉義,2024-08-08,9692
00940,元大台灣價值高息,125,94,31,富邦-嘉義,2024-08-08,9692
5512,力麒,33,2,31,富邦-嘉義,2024-08-08,9692
1447,力鵬,30,0,30,富邦-嘉義,2024-08-08,9692
4583,台灣精銳,33,3,30,富邦-嘉義,2024-08-08,9692
2515,中工,37,8,29,富邦-嘉義,2024-08-08,9692
1597,直得,109,82,27,富邦-嘉義,2024-08-08,9692
3580,友威科,54,27,27,富邦-嘉義,2024-08-08,9692
3312,弘憶股,51,25,26,富邦-嘉義,2024-08-08,9692
00948B,中信優息投資級債,41,16,25,富邦-嘉義,2024-08-08,9692
00881,國泰台灣5G+,31,6,25,富邦-嘉義,2024-08-08,9692
1503,士電,45,21,24,富邦-嘉義,2024-08-08,9692
4513,福裕,42,18,24,富邦-嘉義,2024-08-08,9692
2330,台積電,39,15,24,富邦-嘉義,2024-08-08,9692
00933B,國泰10Y+金融債,48,25,23,富邦-嘉義,2024-08-08,9692
00919,群益台灣精選高息,130,107,23,富邦-嘉義,2024-08-08,9692
3481,群創,58,37,21,富邦-嘉義,2024-08-08,9692
2382,廣達,216,195,21,富邦-嘉義,2024-08-08,9692
2618,長榮航,1082,41,1041,富邦-嘉義,2024-08-09,9692
2312,金寶,1126,422,704,富邦-嘉義,2024-08-09,9692
00937B,群益ESG投等債20,543,71,472,富邦-嘉義,2024-08-09,9692
4562,穎漢,777,362,415,富邦-嘉義,2024-08-09,9692
00929,復華台灣科技優息,578,197,381,富邦-嘉義,2024-08-09,9692
00679B,元大美債20年,334,74,260,富邦-嘉義,2024-08-09,9692
00680L,元大美債20正2,263,32,231,富邦-嘉義,2024-08-09,9692
8374,羅昇,206,21,185,富邦-嘉義,2024-08-09,9692
2365,昆盈,828,675,153,富邦-嘉義,2024-08-09,9692
00948B,中信優息投資級債,121,0,121,富邦-嘉義,2024-08-09,9692
4513,福裕,131,17,114,富邦-嘉義,2024-08-09,9692
2489,瑞軒,244,152,92,富邦-嘉義,2024-08-09,9692
1513,中興電,142,51,91,富邦-嘉義,2024-08-09,9692
00687B,國泰20年美債,174,106,68,富邦-嘉義,2024-08-09,9692
6215,和椿,320,256,64,富邦-嘉義,2024-08-09,9692
00881,國泰台灣5G+,68,7,61,富邦-嘉義,2024-08-09,9692
6658,聯策,64,5,59,富邦-嘉義,2024-08-09,9692
1714,和桐,64,6,58,富邦-嘉義,2024-08-09,9692
00795B,中信美國公債20年,58,0,58,富邦-嘉義,2024-08-09,9692
8028,昇陽半導體,73,15,58,富邦-嘉義,2024-08-09,9692
00713,元大台灣高息低波,58,1,57,富邦-嘉義,2024-08-09,9692
3535,晶彩科,138,85,53,富邦-嘉義,2024-08-09,9692
2543,皇昌,110,62,48,富邦-嘉義,2024-08-09,9692
9105,泰金寶-DR,387,342,45,富邦-嘉義,2024-08-09,9692
4526,東台,58,15,43,富邦-嘉義,2024-08-09,9692
3013,晟銘電,50,7,43,富邦-嘉義,2024-08-09,9692
00919,群益台灣精選高息,98,57,41,富邦-嘉義,2024-08-09,9692
00918,大華優利高填息30,42,1,41,富邦-嘉義,2024-08-09,9692
00751B,元大AAA至A公司債,39,0,39,富邦-嘉義,2024-08-09,9692
00936,台新永續高息中小,43,7,36,富邦-嘉義,2024-08-09,9692
00878,國泰永續高股息,62,28,34,富邦-嘉義,2024-08-09,9692
2449,京元電子,180,146,34,富邦-嘉義,2024-08-09,9692
3715,定穎投控,78,45,33,富邦-嘉義,2024-08-09,9692
2359,所羅門,78,46,32,富邦-嘉義,2024-08-09,9692
8071,能率網通,37,5,32,富邦-嘉義,2024-08-09,9692
1536,和大,50,18,32,富邦-嘉義,2024-08-09,9692
2388,威盛,36,5,31,富邦-嘉義,2024-08-09,9692
00665L,富邦�琤肭磪囓�2,33,2,31,富邦-嘉義,2024-08-09,9692
2014,中鴻,30,0,30,富邦-嘉義,2024-08-09,9692
1312,國喬,26,0,26,富邦-嘉義,2024-08-09,9692
4909,新復興,126,100,26,富邦-嘉義,2024-08-09,9692
00951,台新日本半導體,26,0,26,富邦-嘉義,2024-08-09,9692
8085,福華,26,0,26,富邦-嘉義,2024-08-09,9692
9955,佳龍,33,7,26,富邦-嘉義,2024-08-09,9692
2353,宏��,36,10,26,富邦-嘉義,2024-08-09,9692
2337,旺宏,58,33,25,富邦-嘉義,2024-08-09,9692
3312,弘憶股,61,37,24,富邦-嘉義,2024-08-09,9692
00664R,國泰臺灣加權反1,22,0,22,富邦-嘉義,2024-08-09,9692
2314,台揚,27,5,22,富邦-嘉義,2024-08-09,9692
4534,慶騰,22,0,22,富邦-嘉義,2024-08-09,9692
1815,富喬,2548,1053,1495,富邦-嘉義,2024-08-12,9692
3062,建漢,449,51,398,富邦-嘉義,2024-08-12,9692
00679B,元大美債20年,321,6,315,富邦-嘉義,2024-08-12,9692
00632R,元大台灣50反1,360,46,314,富邦-嘉義,2024-08-12,9692
2609,陽明,591,316,275,富邦-嘉義,2024-08-12,9692
2615,萬海,522,325,197,富邦-嘉義,2024-08-12,9692
3013,晟銘電,263,76,187,富邦-嘉義,2024-08-12,9692
8043,蜜望實,417,232,185,富邦-嘉義,2024-08-12,9692
00680L,元大美債20正2,168,10,158,富邦-嘉義,2024-08-12,9692
2610,華航,136,3,133,富邦-嘉義,2024-08-12,9692
00715L,期街口布蘭特正2,150,20,130,富邦-嘉義,2024-08-12,9692
00878,國泰永續高股息,136,25,111,富邦-嘉義,2024-08-12,9692
5213,亞昕,90,0,90,富邦-嘉義,2024-08-12,9692
00923,群益台ESG低碳50,80,0,80,富邦-嘉義,2024-08-12,9692
00937B,群益ESG投等債20,86,9,77,富邦-嘉義,2024-08-12,9692
5880,合庫金,66,2,64,富邦-嘉義,2024-08-12,9692
00918,大華優利高填息30,62,1,61,富邦-嘉義,2024-08-12,9692
00900,富邦特選高股息30,64,7,57,富邦-嘉義,2024-08-12,9692
9906,欣巴巴,76,26,50,富邦-嘉義,2024-08-12,9692
00720B,元大投資級公司債,55,5,50,富邦-嘉義,2024-08-12,9692
2515,中工,54,11,43,富邦-嘉義,2024-08-12,9692
2543,皇昌,72,30,42,富邦-嘉義,2024-08-12,9692
2891,中信金,42,0,42,富邦-嘉義,2024-08-12,9692
2801,彰銀,107,67,40,富邦-嘉義,2024-08-12,9692
3481,群創,205,167,38,富邦-嘉義,2024-08-12,9692
00795B,中信美國公債20年,37,0,37,富邦-嘉義,2024-08-12,9692
5310,天剛,43,7,36,富邦-嘉義,2024-08-12,9692
3163,波若威,78,44,34,富邦-嘉義,2024-08-12,9692
2485,兆赫,35,2,33,富邦-嘉義,2024-08-12,9692
4566,時碩工業,151,118,33,富邦-嘉義,2024-08-12,9692
1709,和益,32,0,32,富邦-嘉義,2024-08-12,9692
3710,連展投控,56,24,32,富邦-嘉義,2024-08-12,9692
4109,加捷生醫,34,3,31,富邦-嘉義,2024-08-12,9692
1301,台塑,46,15,31,富邦-嘉義,2024-08-12,9692
3339,泰谷,32,1,31,富邦-嘉義,2024-08-12,9692
3048,益登,71,40,31,富邦-嘉義,2024-08-12,9692
00710B,復華彭博非投等債,30,0,30,富邦-嘉義,2024-08-12,9692
00687B,國泰20年美債,50,20,30,富邦-嘉義,2024-08-12,9692
00936,台新永續高息中小,44,15,29,富邦-嘉義,2024-08-12,9692
6116,彩晶,30,1,29,富邦-嘉義,2024-08-12,9692
2883,凱基金,38,10,28,富邦-嘉義,2024-08-12,9692
00915,凱基優選高股息30,25,0,25,富邦-嘉義,2024-08-12,9692
00676R,富邦臺灣加權反1,33,8,25,富邦-嘉義,2024-08-12,9692
1608,華榮,79,55,24,富邦-嘉義,2024-08-12,9692
4576,大銀微系統,48,25,23,富邦-嘉義,2024-08-12,9692
5498,凱崴,22,0,22,富邦-嘉義,2024-08-12,9692
3706,神達,28,7,21,富邦-嘉義,2024-08-12,9692
1217,愛之味,20,0,20,富邦-嘉義,2024-08-12,9692
1806,冠軍,21,1,20,富邦-嘉義,2024-08-12,9692
3663,鑫科,207,187,20,富邦-嘉義,2024-08-12,9692
00632R,元大台灣50反1,691,10,681,富邦-嘉義,2024-08-13,9692
00940,元大台灣價值高息,380,9,371,富邦-嘉義,2024-08-13,9692
00937B,群益ESG投等債20,358,35,323,富邦-嘉義,2024-08-13,9692
2801,彰銀,210,0,210,富邦-嘉義,2024-08-13,9692
2888,新光金,250,77,173,富邦-嘉義,2024-08-13,9692
2880,華南金,164,4,160,富邦-嘉義,2024-08-13,9692
00715L,期街口布蘭特正2,207,73,134,富邦-嘉義,2024-08-13,9692
2365,昆盈,270,145,125,富邦-嘉義,2024-08-13,9692
00948B,中信優息投資級債,124,1,123,富邦-嘉義,2024-08-13,9692
00878,國泰永續高股息,154,39,115,富邦-嘉義,2024-08-13,9692
3481,群創,158,46,112,富邦-嘉義,2024-08-13,9692
8096,擎亞,765,654,111,富邦-嘉義,2024-08-13,9692
3019,亞光,422,334,88,富邦-嘉義,2024-08-13,9692
6215,和椿,195,113,82,富邦-嘉義,2024-08-13,9692
00929,復華台灣科技優息,148,71,77,富邦-嘉義,2024-08-13,9692
00900,富邦特選高股息30,92,16,76,富邦-嘉義,2024-08-13,9692
00907,永豐優息存股,58,0,58,富邦-嘉義,2024-08-13,9692
1316,上曜,60,8,52,富邦-嘉義,2024-08-13,9692
4513,福裕,208,156,52,富邦-嘉義,2024-08-13,9692
3663,鑫科,209,158,51,富邦-嘉義,2024-08-13,9692
5443,均豪,211,163,48,富邦-嘉義,2024-08-13,9692
5263,智崴,58,18,40,富邦-嘉義,2024-08-13,9692
8089,康全電訊,42,3,39,富邦-嘉義,2024-08-13,9692
1301,台塑,43,5,38,富邦-嘉義,2024-08-13,9692
2515,中工,38,0,38,富邦-嘉義,2024-08-13,9692
00680L,元大美債20正2,58,20,38,富邦-嘉義,2024-08-13,9692
3231,緯創,58,20,38,富邦-嘉義,2024-08-13,9692
3047,訊舟,225,188,37,富邦-嘉義,2024-08-13,9692
6505,台塑化,35,0,35,富邦-嘉義,2024-08-13,9692
3048,益登,95,61,34,富邦-嘉義,2024-08-13,9692
2208,台船,53,20,33,富邦-嘉義,2024-08-13,9692
5880,合庫金,36,5,31,富邦-嘉義,2024-08-13,9692
2610,華航,34,5,29,富邦-嘉義,2024-08-13,9692
4549,桓達,31,4,27,富邦-嘉義,2024-08-13,9692
00712,復華富時不動產,46,20,26,富邦-嘉義,2024-08-13,9692
2886,兆豐金,26,1,25,富邦-嘉義,2024-08-13,9692
3501,維熹,36,11,25,富邦-嘉義,2024-08-13,9692
00688L,國泰20年美債正2,24,0,24,富邦-嘉義,2024-08-13,9692
2889,國票金,31,8,23,富邦-嘉義,2024-08-13,9692
3056,富華新,25,3,22,富邦-嘉義,2024-08-13,9692
8046,南電,21,0,21,富邦-嘉義,2024-08-13,9692
6207,雷科,57,36,21,富邦-嘉義,2024-08-13,9692
00665L,富邦�琤肭磪囓�2,20,0,20,富邦-嘉義,2024-08-13,9692
4554,橙的,20,0,20,富邦-嘉義,2024-08-13,9692
2891,中信金,79,59,20,富邦-嘉義,2024-08-13,9692
3706,神達,36,17,19,富邦-嘉義,2024-08-13,9692
00915,凱基優選高股息30,19,0,19,富邦-嘉義,2024-08-13,9692
1584,精剛,30,12,18,富邦-嘉義,2024-08-13,9692
2374,佳能,105,87,18,富邦-嘉義,2024-08-13,9692
1314,中石化,17,0,17,富邦-嘉義,2024-08-13,9692
00632R,元大台灣50反1,1329,116,1213,富邦-嘉義,2024-08-14,9692
00900,富邦特選高股息30,378,44,334,富邦-嘉義,2024-08-14,9692
1815,富喬,897,581,316,富邦-嘉義,2024-08-14,9692
00680L,元大美債20正2,236,11,225,富邦-嘉義,2024-08-14,9692
2867,三商壽,252,45,207,富邦-嘉義,2024-08-14,9692
00929,復華台灣科技優息,250,118,132,富邦-嘉義,2024-08-14,9692
00795B,中信美國公債20年,112,0,112,富邦-嘉義,2024-08-14,9692
2101,南港,100,4,96,富邦-嘉義,2024-08-14,9692
00937B,群益ESG投等債20,156,61,95,富邦-嘉義,2024-08-14,9692
00918,大華優利高填息30,92,2,90,富邦-嘉義,2024-08-14,9692
00881,國泰台灣5G+,89,8,81,富邦-嘉義,2024-08-14,9692
2801,彰銀,79,2,77,富邦-嘉義,2024-08-14,9692
1316,上曜,70,1,69,富邦-嘉義,2024-08-14,9692
00679B,元大美債20年,123,63,60,富邦-嘉義,2024-08-14,9692
8071,能率網通,83,26,57,富邦-嘉義,2024-08-14,9692
3481,群創,244,189,55,富邦-嘉義,2024-08-14,9692
4909,新復興,64,11,53,富邦-嘉義,2024-08-14,9692
2514,龍邦,51,0,51,富邦-嘉義,2024-08-14,9692
00948B,中信優息投資級債,50,0,50,富邦-嘉義,2024-08-14,9692
4540,全球傳動,69,25,44,富邦-嘉義,2024-08-14,9692
3284,太普高,38,0,38,富邦-嘉義,2024-08-14,9692
2356,英業達,51,15,36,富邦-嘉義,2024-08-14,9692
3189,景碩,51,15,36,富邦-嘉義,2024-08-14,9692
00712,復華富時不動產,41,10,31,富邦-嘉義,2024-08-14,9692
2609,陽明,59,28,31,富邦-嘉義,2024-08-14,9692
00940,元大台灣價值高息,84,54,30,富邦-嘉義,2024-08-14,9692
00905,FT臺灣Smart,28,1,27,富邦-嘉義,2024-08-14,9692
5864,致和證,26,0,26,富邦-嘉義,2024-08-14,9692
00878,國泰永續高股息,102,77,25,富邦-嘉義,2024-08-14,9692
2615,萬海,77,52,25,富邦-嘉義,2024-08-14,9692
00637L,元大滬深300正2,25,0,25,富邦-嘉義,2024-08-14,9692
1805,寶徠,24,2,22,富邦-嘉義,2024-08-14,9692
2405,輔信,25,3,22,富邦-嘉義,2024-08-14,9692
5905,南仁湖,28,6,22,富邦-嘉義,2024-08-14,9692
6257,矽格,21,0,21,富邦-嘉義,2024-08-14,9692
2886,兆豐金,22,2,20,富邦-嘉義,2024-08-14,9692
3037,欣興,34,14,20,富邦-嘉義,2024-08-14,9692
4303,信立,21,1,20,富邦-嘉義,2024-08-14,9692
1513,中興電,356,336,20,富邦-嘉義,2024-08-14,9692
2486,一詮,23,3,20,富邦-嘉義,2024-08-14,9692
4958,臻鼎-KY,19,0,19,富邦-嘉義,2024-08-14,9692
4566,時碩工業,138,119,19,富邦-嘉義,2024-08-14,9692
00670L,富邦NASDAQ正2,19,0,19,富邦-嘉義,2024-08-14,9692
4564,元翎,31,12,19,富邦-嘉義,2024-08-14,9692
2880,華南金,25,6,19,富邦-嘉義,2024-08-14,9692
2401,凌陽,25,6,19,富邦-嘉義,2024-08-14,9692
1416,廣豐,18,0,18,富邦-嘉義,2024-08-14,9692
5452,佶優,18,1,17,富邦-嘉義,2024-08-14,9692
3715,定穎投控,27,10,17,富邦-嘉義,2024-08-14,9692
1609,大亞,39,22,17,富邦-嘉義,2024-08-14,9692
6133,金橋,701,11,690,富邦-嘉義,2024-08-15,9692
00937B,群益ESG投等債20,558,43,515,富邦-嘉義,2024-08-15,9692
3227,原相,581,90,491,富邦-嘉義,2024-08-15,9692
2323,中環,2748,2282,466,富邦-嘉義,2024-08-15,9692
00878,國泰永續高股息,454,27,427,富邦-嘉義,2024-08-15,9692
2867,三商壽,478,128,350,富邦-嘉義,2024-08-15,9692
8043,蜜望實,382,75,307,富邦-嘉義,2024-08-15,9692
00632R,元大台灣50反1,318,24,294,富邦-嘉義,2024-08-15,9692
2543,皇昌,295,23,272,富邦-嘉義,2024-08-15,9692
00680L,元大美債20正2,245,14,231,富邦-嘉義,2024-08-15,9692
00900,富邦特選高股息30,216,0,216,富邦-嘉義,2024-08-15,9692
00687B,國泰20年美債,211,1,210,富邦-嘉義,2024-08-15,9692
2801,彰銀,221,30,191,富邦-嘉義,2024-08-15,9692
00881,國泰台灣5G+,142,6,136,富邦-嘉義,2024-08-15,9692
9906,欣巴巴,170,44,126,富邦-嘉義,2024-08-15,9692
3047,訊舟,435,311,124,富邦-嘉義,2024-08-15,9692
2002,中鋼,120,3,117,富邦-嘉義,2024-08-15,9692
6877,鏵友益,212,99,113,富邦-嘉義,2024-08-15,9692
1101,台泥,111,4,107,富邦-嘉義,2024-08-15,9692
00929,復華台灣科技優息,198,107,91,富邦-嘉義,2024-08-15,9692
5202,力新,102,17,85,富邦-嘉義,2024-08-15,9692
00679B,元大美債20年,294,214,80,富邦-嘉義,2024-08-15,9692
00934,中信成長高股息,70,4,66,富邦-嘉義,2024-08-15,9692
4510,高鋒,106,41,65,富邦-嘉義,2024-08-15,9692
2892,第一金,65,1,64,富邦-嘉義,2024-08-15,9692
00795B,中信美國公債20年,53,1,52,富邦-嘉義,2024-08-15,9692
3581,博磊,52,1,51,富邦-嘉義,2024-08-15,9692
3013,晟銘電,77,27,50,富邦-嘉義,2024-08-15,9692
4561,健椿,524,478,46,富邦-嘉義,2024-08-15,9692
00946,群益科技高息成長,49,5,44,富邦-嘉義,2024-08-15,9692
3673,TPK-KY,75,32,43,富邦-嘉義,2024-08-15,9692
00948B,中信優息投資級債,42,1,41,富邦-嘉義,2024-08-15,9692
3714,富采,40,0,40,富邦-嘉義,2024-08-15,9692
2633,台灣高鐵,40,0,40,富邦-嘉義,2024-08-15,9692
2337,旺宏,46,7,39,富邦-嘉義,2024-08-15,9692
4960,誠美材,36,0,36,富邦-嘉義,2024-08-15,9692
3593,力銘,42,6,36,富邦-嘉義,2024-08-15,9692
8064,東捷,53,18,35,富邦-嘉義,2024-08-15,9692
1712,興農,33,0,33,富邦-嘉義,2024-08-15,9692
3230,錦明,34,2,32,富邦-嘉義,2024-08-15,9692
3163,波若威,40,8,32,富邦-嘉義,2024-08-15,9692
2524,京城,74,43,31,富邦-嘉義,2024-08-15,9692
4919,新唐,30,0,30,富邦-嘉義,2024-08-15,9692
00915,凱基優選高股息30,32,3,29,富邦-嘉義,2024-08-15,9692
00918,大華優利高填息30,32,5,27,富邦-嘉義,2024-08-15,9692
2618,長榮航,31,5,26,富邦-嘉義,2024-08-15,9692
3303,岱稜,47,24,23,富邦-嘉義,2024-08-15,9692
00713,元大台灣高息低波,23,1,22,富邦-嘉義,2024-08-15,9692
2317,鴻海,846,824,22,富邦-嘉義,2024-08-15,9692
3715,定穎投控,101,79,22,富邦-嘉義,2024-08-15,9692
8028,昇陽半導體,676,157,519,富邦-嘉義,2024-08-16,9692
2867,三商壽,279,2,277,富邦-嘉義,2024-08-16,9692
2537,聯上發,1003,735,268,富邦-嘉義,2024-08-16,9692
2062,橋椿,649,408,241,富邦-嘉義,2024-08-16,9692
00687B,國泰20年美債,305,110,195,富邦-嘉義,2024-08-16,9692
5905,南仁湖,433,254,179,富邦-嘉義,2024-08-16,9692
00679B,元大美債20年,198,22,176,富邦-嘉義,2024-08-16,9692
6177,達麗,228,62,166,富邦-嘉義,2024-08-16,9692
00632R,元大台灣50反1,330,176,154,富邦-嘉義,2024-08-16,9692
2542,興富發,202,54,148,富邦-嘉義,2024-08-16,9692
00931B,統一美債20年,112,0,112,富邦-嘉義,2024-08-16,9692
8064,東捷,133,35,98,富邦-嘉義,2024-08-16,9692
5452,佶優,117,23,94,富邦-嘉義,2024-08-16,9692
5443,均豪,417,329,88,富邦-嘉義,2024-08-16,9692
6207,雷科,95,21,74,富邦-嘉義,2024-08-16,9692
4532,瑞智,73,1,72,富邦-嘉義,2024-08-16,9692
00919,群益台灣精選高息,161,91,70,富邦-嘉義,2024-08-16,9692
3712,永崴投控,73,4,69,富邦-嘉義,2024-08-16,9692
3645,達邁,101,36,65,富邦-嘉義,2024-08-16,9692
00795B,中信美國公債20年,63,0,63,富邦-嘉義,2024-08-16,9692
2913,農林,68,10,58,富邦-嘉義,2024-08-16,9692
00923,群益台ESG低碳50,69,13,56,富邦-嘉義,2024-08-16,9692
00929,復華台灣科技優息,164,110,54,富邦-嘉義,2024-08-16,9692
00948B,中信優息投資級債,53,0,53,富邦-嘉義,2024-08-16,9692
2359,所羅門,1014,964,50,富邦-嘉義,2024-08-16,9692
00731,復華富時高息低波,46,0,46,富邦-嘉義,2024-08-16,9692
3580,友威科,238,194,44,富邦-嘉義,2024-08-16,9692
6505,台塑化,42,0,42,富邦-嘉義,2024-08-16,9692
2365,昆盈,292,251,41,富邦-嘉義,2024-08-16,9692
6244,茂迪,41,0,41,富邦-嘉義,2024-08-16,9692
2511,太子,39,0,39,富邦-嘉義,2024-08-16,9692
8374,羅昇,317,279,38,富邦-嘉義,2024-08-16,9692
4109,加捷生醫,36,0,36,富邦-嘉義,2024-08-16,9692
00878,國泰永續高股息,99,64,35,富邦-嘉義,2024-08-16,9692
00936,台新永續高息中小,29,0,29,富邦-嘉義,2024-08-16,9692
2543,皇昌,49,20,29,富邦-嘉義,2024-08-16,9692
2371,大同,32,4,28,富邦-嘉義,2024-08-16,9692
1459,聯發,27,0,27,富邦-嘉義,2024-08-16,9692
2070,精湛,60,33,27,富邦-嘉義,2024-08-16,9692
00902,中信電池及儲能,26,0,26,富邦-嘉義,2024-08-16,9692
6532,瑞耘,43,17,26,富邦-嘉義,2024-08-16,9692
00688L,國泰20年美債正2,37,12,25,富邦-嘉義,2024-08-16,9692
00892,富邦台灣半導體,25,0,25,富邦-嘉義,2024-08-16,9692
2489,瑞軒,52,28,24,富邦-嘉義,2024-08-16,9692
2609,陽明,65,42,23,富邦-嘉義,2024-08-16,9692
2905,三商,23,0,23,富邦-嘉義,2024-08-16,9692
4555,氣立,27,4,23,富邦-嘉義,2024-08-16,9692
1611,中電,97,75,22,富邦-嘉義,2024-08-16,9692
00670L,富邦NASDAQ正2,22,1,21,富邦-嘉義,2024-08-16,9692
1326,台化,23,2,21,富邦-嘉義,2024-08-16,9692
00929,復華台灣科技優息,423,42,381,富邦-嘉義,2024-08-19,9692
6609,瀧澤科,387,111,276,富邦-嘉義,2024-08-19,9692
1316,上曜,289,43,246,富邦-嘉義,2024-08-19,9692
00687B,國泰20年美債,258,25,233,富邦-嘉義,2024-08-19,9692
3535,晶彩科,357,148,209,富邦-嘉義,2024-08-19,9692
3047,訊舟,509,331,178,富邦-嘉義,2024-08-19,9692
5443,均豪,394,232,162,富邦-嘉義,2024-08-19,9692
00918,大華優利高填息30,146,7,139,富邦-嘉義,2024-08-19,9692
00679B,元大美債20年,144,10,134,富邦-嘉義,2024-08-19,9692
2417,圓剛,220,88,132,富邦-嘉義,2024-08-19,9692
00915,凱基優選高股息30,128,2,126,富邦-嘉義,2024-08-19,9692
00951,台新日本半導體,108,1,107,富邦-嘉義,2024-08-19,9692
00753L,中信中國50正2,100,0,100,富邦-嘉義,2024-08-19,9692
3580,友威科,182,103,79,富邦-嘉義,2024-08-19,9692
1711,永光,74,0,74,富邦-嘉義,2024-08-19,9692
2354,鴻準,160,90,70,富邦-嘉義,2024-08-19,9692
2313,華通,72,7,65,富邦-嘉義,2024-08-19,9692
6218,豪勉,70,5,65,富邦-嘉義,2024-08-19,9692
3663,鑫科,115,52,63,富邦-嘉義,2024-08-19,9692
9105,泰金寶-DR,141,79,62,富邦-嘉義,2024-08-19,9692
00641R,富邦日本反1,62,1,61,富邦-嘉義,2024-08-19,9692
3062,建漢,136,78,58,富邦-嘉義,2024-08-19,9692
8064,東捷,186,133,53,富邦-嘉義,2024-08-19,9692
8089,康全電訊,47,11,36,富邦-嘉義,2024-08-19,9692
2062,橋椿,121,90,31,富邦-嘉義,2024-08-19,9692
2002,中鋼,43,13,30,富邦-嘉義,2024-08-19,9692
1326,台化,33,3,30,富邦-嘉義,2024-08-19,9692
00933B,國泰10Y+金融債,29,0,29,富邦-嘉義,2024-08-19,9692
2323,中環,108,79,29,富邦-嘉義,2024-08-19,9692
2239,英利-KY,30,1,29,富邦-嘉義,2024-08-19,9692
4979,華星光,40,11,29,富邦-嘉義,2024-08-19,9692
3231,緯創,35,6,29,富邦-嘉義,2024-08-19,9692
00751B,元大AAA至A公司債,28,0,28,富邦-嘉義,2024-08-19,9692
00900,富邦特選高股息30,29,2,27,富邦-嘉義,2024-08-19,9692
1712,興農,27,0,27,富邦-嘉義,2024-08-19,9692
2615,萬海,42,16,26,富邦-嘉義,2024-08-19,9692
00931B,統一美債20年,25,0,25,富邦-嘉義,2024-08-19,9692
00706L,期元大S＆P日圓正2,25,0,25,富邦-嘉義,2024-08-19,9692
2344,華邦電,137,112,25,富邦-嘉義,2024-08-19,9692
4562,穎漢,67,42,25,富邦-嘉義,2024-08-19,9692
6005,群益證,23,0,23,富邦-嘉義,2024-08-19,9692
4576,大銀微系統,39,16,23,富邦-嘉義,2024-08-19,9692
2883,凱基金,101,78,23,富邦-嘉義,2024-08-19,9692
6179,亞通,22,0,22,富邦-嘉義,2024-08-19,9692
3652,精聯,90,68,22,富邦-嘉義,2024-08-19,9692
4513,福裕,32,10,22,富邦-嘉義,2024-08-19,9692
00795B,中信美國公債20年,41,20,21,富邦-嘉義,2024-08-19,9692
9935,慶豐富,24,3,21,富邦-嘉義,2024-08-19,9692
2464,盟立,38,17,21,富邦-嘉義,2024-08-19,9692
4510,高鋒,24,3,21,富邦-嘉義,2024-08-19,9692
2888,新光金,10833,9392,1441,富邦-嘉義,2024-08-20,9692
00665L,富邦�琤肭磪囓�2,1155,8,1147,富邦-嘉義,2024-08-20,9692
1815,富喬,2218,1231,987,富邦-嘉義,2024-08-20,9692
3227,原相,611,114,497,富邦-嘉義,2024-08-20,9692
00715L,期街口布蘭特正2,335,2,333,富邦-嘉義,2024-08-20,9692
5905,南仁湖,1489,1190,299,富邦-嘉義,2024-08-20,9692
1316,上曜,500,213,287,富邦-嘉義,2024-08-20,9692
3147,大綜,201,2,199,富邦-嘉義,2024-08-20,9692
00923,群益台ESG低碳50,146,1,145,富邦-嘉義,2024-08-20,9692
00948B,中信優息投資級債,137,0,137,富邦-嘉義,2024-08-20,9692
6869,雲豹能源,144,17,127,富邦-嘉義,2024-08-20,9692
00687B,國泰20年美債,150,25,125,富邦-嘉義,2024-08-20,9692
00632R,元大台灣50反1,230,109,121,富邦-嘉義,2024-08-20,9692
00650L,復華香港正2,111,0,111,富邦-嘉義,2024-08-20,9692
3163,波若威,163,59,104,富邦-嘉義,2024-08-20,9692
1301,台塑,126,29,97,富邦-嘉義,2024-08-20,9692
2301,光寶科,108,11,97,富邦-嘉義,2024-08-20,9692
00706L,期元大S＆P日圓正2,120,25,95,富邦-嘉義,2024-08-20,9692
3645,達邁,102,17,85,富邦-嘉義,2024-08-20,9692
8096,擎亞,224,145,79,富邦-嘉義,2024-08-20,9692
00679B,元大美債20年,110,32,78,富邦-嘉義,2024-08-20,9692
2405,輔信,94,20,74,富邦-嘉義,2024-08-20,9692
8440,綠電,211,140,71,富邦-嘉義,2024-08-20,9692
9105,泰金寶-DR,72,2,70,富邦-嘉義,2024-08-20,9692
2520,冠德,89,19,70,富邦-嘉義,2024-08-20,9692
8105,凌巨,90,22,68,富邦-嘉義,2024-08-20,9692
2356,英業達,203,142,61,富邦-嘉義,2024-08-20,9692
00633L,富邦上証正2,60,0,60,富邦-嘉義,2024-08-20,9692
4303,信立,80,25,55,富邦-嘉義,2024-08-20,9692
3062,建漢,81,27,54,富邦-嘉義,2024-08-20,9692
2489,瑞軒,85,34,51,富邦-嘉義,2024-08-20,9692
00641R,富邦日本反1,50,0,50,富邦-嘉義,2024-08-20,9692
4960,誠美材,50,0,50,富邦-嘉義,2024-08-20,9692
6284,佳邦,50,2,48,富邦-嘉義,2024-08-20,9692
2515,中工,55,8,47,富邦-嘉義,2024-08-20,9692
2317,鴻海,577,530,47,富邦-嘉義,2024-08-20,9692
2543,皇昌,186,144,42,富邦-嘉義,2024-08-20,9692
1326,台化,40,0,40,富邦-嘉義,2024-08-20,9692
3581,博磊,56,16,40,富邦-嘉義,2024-08-20,9692
3167,大量,232,193,39,富邦-嘉義,2024-08-20,9692
3073,天方能源,85,47,38,富邦-嘉義,2024-08-20,9692
4306,炎洲,34,0,34,富邦-嘉義,2024-08-20,9692
2545,皇翔,37,4,33,富邦-嘉義,2024-08-20,9692
4174,浩鼎,80,48,32,富邦-嘉義,2024-08-20,9692
2331,精英,32,0,32,富邦-嘉義,2024-08-20,9692
8043,蜜望實,170,139,31,富邦-嘉義,2024-08-20,9692
6570,維田,50,22,28,富邦-嘉義,2024-08-20,9692
00931B,統一美債20年,27,0,27,富邦-嘉義,2024-08-20,9692
00919,群益台灣精選高息,155,128,27,富邦-嘉義,2024-08-20,9692
2442,新美齊,29,5,24,富邦-嘉義,2024-08-20,9692
8096,擎亞,1080,128,952,富邦-嘉義,2024-08-21,9692
3019,亞光,582,21,561,富邦-嘉義,2024-08-21,9692
00632R,元大台灣50反1,475,16,459,富邦-嘉義,2024-08-21,9692
2891,中信金,349,11,338,富邦-嘉義,2024-08-21,9692
2062,橋椿,402,152,250,富邦-嘉義,2024-08-21,9692
00715L,期街口布蘭特正2,238,1,237,富邦-嘉義,2024-08-21,9692
2867,三商壽,302,104,198,富邦-嘉義,2024-08-21,9692
9955,佳龍,552,358,194,富邦-嘉義,2024-08-21,9692
6133,金橋,182,4,178,富邦-嘉義,2024-08-21,9692
00919,群益台灣精選高息,169,20,149,富邦-嘉義,2024-08-21,9692
00951,台新日本半導體,139,2,137,富邦-嘉義,2024-08-21,9692
3047,訊舟,3703,3588,115,富邦-嘉義,2024-08-21,9692
2618,長榮航,128,15,113,富邦-嘉義,2024-08-21,9692
6177,達麗,109,8,101,富邦-嘉義,2024-08-21,9692
00929,復華台灣科技優息,167,84,83,富邦-嘉義,2024-08-21,9692
1314,中石化,71,5,66,富邦-嘉義,2024-08-21,9692
00946,群益科技高息成長,64,3,61,富邦-嘉義,2024-08-21,9692
2359,所羅門,64,3,61,富邦-嘉義,2024-08-21,9692
00720B,元大投資級公司債,55,1,54,富邦-嘉義,2024-08-21,9692
2002,中鋼,66,12,54,富邦-嘉義,2024-08-21,9692
5443,均豪,789,736,53,富邦-嘉義,2024-08-21,9692
1709,和益,63,10,53,富邦-嘉義,2024-08-21,9692
2352,佳世達,56,5,51,富邦-嘉義,2024-08-21,9692
2349,錸德,448,397,51,富邦-嘉義,2024-08-21,9692
00650L,復華香港正2,60,10,50,富邦-嘉義,2024-08-21,9692
2542,興富發,50,0,50,富邦-嘉義,2024-08-21,9692
2489,瑞軒,42,1,41,富邦-嘉義,2024-08-21,9692
00878,國泰永續高股息,44,6,38,富邦-嘉義,2024-08-21,9692
2401,凌陽,48,11,37,富邦-嘉義,2024-08-21,9692
3036A,文曄甲特,35,0,35,富邦-嘉義,2024-08-21,9692
5225,東科-KY,33,1,32,富邦-嘉義,2024-08-21,9692
00881,國泰台灣5G+,45,14,31,富邦-嘉義,2024-08-21,9692
2317,鴻海,59,29,30,富邦-嘉義,2024-08-21,9692
8104,錸寶,143,115,28,富邦-嘉義,2024-08-21,9692
2337,旺宏,57,30,27,富邦-嘉義,2024-08-21,9692
4306,炎洲,27,0,27,富邦-嘉義,2024-08-21,9692
1409,新纖,65,41,24,富邦-嘉義,2024-08-21,9692
3013,晟銘電,245,222,23,富邦-嘉義,2024-08-21,9692
00954,中信日本半導體,23,0,23,富邦-嘉義,2024-08-21,9692
2330,台積電,29,6,23,富邦-嘉義,2024-08-21,9692
2881,富邦金,27,4,23,富邦-嘉義,2024-08-21,9692
2356,英業達,42,20,22,富邦-嘉義,2024-08-21,9692
2905,三商,22,0,22,富邦-嘉義,2024-08-21,9692
6207,雷科,30,9,21,富邦-嘉義,2024-08-21,9692
8054,安國,34,14,20,富邦-嘉義,2024-08-21,9692
00945B,凱基美國非投等債,20,0,20,富邦-嘉義,2024-08-21,9692
3024,憶聲,20,0,20,富邦-嘉義,2024-08-21,9692
3563,牧德,61,41,20,富邦-嘉義,2024-08-21,9692
3303,岱稜,50,30,20,富邦-嘉義,2024-08-21,9692
2323,中環,43,23,20,富邦-嘉義,2024-08-21,9692
2867,三商壽,360,10,350,富邦-嘉義,2024-08-22,9692
2349,錸德,935,587,348,富邦-嘉義,2024-08-22,9692
00715L,期街口布蘭特正2,286,0,286,富邦-嘉義,2024-08-22,9692
2409,友達,333,84,249,富邦-嘉義,2024-08-22,9692
00632R,元大台灣50反1,324,129,195,富邦-嘉義,2024-08-22,9692
00953B,群益優選非投等債,232,60,172,富邦-嘉義,2024-08-22,9692
00929,復華台灣科技優息,188,18,170,富邦-嘉義,2024-08-22,9692
8089,康全電訊,170,28,142,富邦-嘉義,2024-08-22,9692
5481,新華,119,0,119,富邦-嘉義,2024-08-22,9692
1721,三晃,377,262,115,富邦-嘉義,2024-08-22,9692
2891,中信金,147,35,112,富邦-嘉義,2024-08-22,9692
8039,台虹,121,9,112,富邦-嘉義,2024-08-22,9692
5452,佶優,143,38,105,富邦-嘉義,2024-08-22,9692
00687B,國泰20年美債,108,7,101,富邦-嘉義,2024-08-22,9692
2890,永豐金,100,1,99,富邦-嘉義,2024-08-22,9692
6218,豪勉,304,206,98,富邦-嘉義,2024-08-22,9692
5225,東科-KY,99,4,95,富邦-嘉義,2024-08-22,9692
6133,金橋,644,556,88,富邦-嘉義,2024-08-22,9692
2442,新美齊,87,0,87,富邦-嘉義,2024-08-22,9692
2317,鴻海,436,354,82,富邦-嘉義,2024-08-22,9692
1708,東鹼,356,276,80,富邦-嘉義,2024-08-22,9692
1104,環泥,76,0,76,富邦-嘉義,2024-08-22,9692
3686,達能,70,1,69,富邦-嘉義,2024-08-22,9692
00919,群益台灣精選高息,70,5,65,富邦-嘉義,2024-08-22,9692
00878,國泰永續高股息,75,11,64,富邦-嘉義,2024-08-22,9692
8438,昶昕,79,16,63,富邦-嘉義,2024-08-22,9692
9955,佳龍,67,6,61,富邦-嘉義,2024-08-22,9692
2489,瑞軒,180,120,60,富邦-嘉義,2024-08-22,9692
3455,由田,61,1,60,富邦-嘉義,2024-08-22,9692
00688L,國泰20年美債正2,59,0,59,富邦-嘉義,2024-08-22,9692
00664R,國泰臺灣加權反1,55,0,55,富邦-嘉義,2024-08-22,9692
1314,中石化,56,3,53,富邦-嘉義,2024-08-22,9692
0056,元大高股息,70,17,53,富邦-嘉義,2024-08-22,9692
00641R,富邦日本反1,52,0,52,富邦-嘉義,2024-08-22,9692
00907,永豐優息存股,50,0,50,富邦-嘉義,2024-08-22,9692
00940,元大台灣價值高息,55,6,49,富邦-嘉義,2024-08-22,9692
2524,京城,57,10,47,富邦-嘉義,2024-08-22,9692
8104,錸寶,76,31,45,富邦-嘉義,2024-08-22,9692
2515,中工,55,10,45,富邦-嘉義,2024-08-22,9692
00937B,群益ESG投等債20,82,41,41,富邦-嘉義,2024-08-22,9692
3580,友威科,57,18,39,富邦-嘉義,2024-08-22,9692
4513,福裕,226,187,39,富邦-嘉義,2024-08-22,9692
2851,中再保,36,3,33,富邦-嘉義,2024-08-22,9692
5905,南仁湖,244,212,32,富邦-嘉義,2024-08-22,9692
00665L,富邦�琤肭磪囓�2,32,0,32,富邦-嘉義,2024-08-22,9692
4729,熒茂,40,9,31,富邦-嘉義,2024-08-22,9692
3652,精聯,73,43,30,富邦-嘉義,2024-08-22,9692
2369,菱生,30,0,30,富邦-嘉義,2024-08-22,9692
4903,聯光通,47,18,29,富邦-嘉義,2024-08-22,9692
00680L,元大美債20正2,38,10,28,富邦-嘉義,2024-08-22,9692
2888,新光金,23701,21555,2146,富邦-嘉義,2024-08-23,9692
00680L,元大美債20正2,387,30,357,富邦-嘉義,2024-08-23,9692
3019,亞光,930,606,324,富邦-嘉義,2024-08-23,9692
1314,中石化,1007,763,244,富邦-嘉義,2024-08-23,9692
00929,復華台灣科技優息,214,51,163,富邦-嘉義,2024-08-23,9692
00919,群益台灣精選高息,143,11,132,富邦-嘉義,2024-08-23,9692
00687B,國泰20年美債,130,10,120,富邦-嘉義,2024-08-23,9692
2851,中再保,111,4,107,富邦-嘉義,2024-08-23,9692
8064,東捷,1365,1259,106,富邦-嘉義,2024-08-23,9692
1409,新纖,294,191,103,富邦-嘉義,2024-08-23,9692
1815,富喬,105,5,100,富邦-嘉義,2024-08-23,9692
2891,中信金,113,15,98,富邦-嘉義,2024-08-23,9692
3149,正達,117,29,88,富邦-嘉義,2024-08-23,9692
6770,力積電,87,3,84,富邦-嘉義,2024-08-23,9692
8043,蜜望實,94,17,77,富邦-嘉義,2024-08-23,9692
3189,景碩,113,41,72,富邦-嘉義,2024-08-23,9692
2402,毅嘉,125,61,64,富邦-嘉義,2024-08-23,9692
3047,訊舟,101,37,64,富邦-嘉義,2024-08-23,9692
00679B,元大美債20年,101,49,52,富邦-嘉義,2024-08-23,9692
3535,晶彩科,227,176,51,富邦-嘉義,2024-08-23,9692
4510,高鋒,61,13,48,富邦-嘉義,2024-08-23,9692
00895,富邦未來車,44,1,43,富邦-嘉義,2024-08-23,9692
00940,元大台灣價值高息,56,15,41,富邦-嘉義,2024-08-23,9692
00795B,中信美國公債20年,40,0,40,富邦-嘉義,2024-08-23,9692
00946,群益科技高息成長,44,5,39,富邦-嘉義,2024-08-23,9692
6753,龍德造船,81,44,37,富邦-嘉義,2024-08-23,9692
00720B,元大投資級公司債,37,0,37,富邦-嘉義,2024-08-23,9692
1618,合機,51,16,35,富邦-嘉義,2024-08-23,9692
3037,欣興,53,19,34,富邦-嘉義,2024-08-23,9692
3073,天方能源,70,39,31,富邦-嘉義,2024-08-23,9692
3312,弘憶股,68,38,30,富邦-嘉義,2024-08-23,9692
8071,能率網通,649,619,30,富邦-嘉義,2024-08-23,9692
00683L,期元大美元指正2,30,0,30,富邦-嘉義,2024-08-23,9692
6869,雲豹能源,118,89,29,富邦-嘉義,2024-08-23,9692
4555,氣立,29,0,29,富邦-嘉義,2024-08-23,9692
6609,瀧澤科,33,4,29,富邦-嘉義,2024-08-23,9692
2897,王道銀行,28,0,28,富邦-嘉義,2024-08-23,9692
5905,南仁湖,239,212,27,富邦-嘉義,2024-08-23,9692
00936,台新永續高息中小,37,10,27,富邦-嘉義,2024-08-23,9692
00937B,群益ESG投等債20,41,16,25,富邦-嘉義,2024-08-23,9692
2353,宏��,25,1,24,富邦-嘉義,2024-08-23,9692
3686,達能,30,6,24,富邦-嘉義,2024-08-23,9692
6239,力成,25,1,24,富邦-嘉義,2024-08-23,9692
6667,信紘科,26,2,24,富邦-嘉義,2024-08-23,9692
00931B,統一美債20年,23,0,23,富邦-嘉義,2024-08-23,9692
2401,凌陽,24,1,23,富邦-嘉義,2024-08-23,9692
2323,中環,25,2,23,富邦-嘉義,2024-08-23,9692
00878,國泰永續高股息,42,20,22,富邦-嘉義,2024-08-23,9692
00907,永豐優息存股,28,6,22,富邦-嘉義,2024-08-23,9692
2344,華邦電,45,23,22,富邦-嘉義,2024-08-23,9692
2867,三商壽,2164,304,1860,富邦-嘉義,2024-08-26,9692
00632R,元大台灣50反1,579,211,368,富邦-嘉義,2024-08-26,9692
2377,微星,1054,751,303,富邦-嘉義,2024-08-26,9692
00679B,元大美債20年,268,28,240,富邦-嘉義,2024-08-26,9692
3481,群創,243,43,200,富邦-嘉義,2024-08-26,9692
00937B,群益ESG投等債20,223,25,198,富邦-嘉義,2024-08-26,9692
00751B,元大AAA至A公司債,185,0,185,富邦-嘉義,2024-08-26,9692
2891,中信金,132,11,121,富邦-嘉義,2024-08-26,9692
2323,中環,116,3,113,富邦-嘉義,2024-08-26,9692
00919,群益台灣精選高息,115,6,109,富邦-嘉義,2024-08-26,9692
00687B,國泰20年美債,112,11,101,富邦-嘉義,2024-08-26,9692
00929,復華台灣科技優息,135,47,88,富邦-嘉義,2024-08-26,9692
5481,新華,178,96,82,富邦-嘉義,2024-08-26,9692
3501,維熹,55,0,55,富邦-嘉義,2024-08-26,9692
2349,錸德,79,26,53,富邦-嘉義,2024-08-26,9692
00680L,元大美債20正2,63,13,50,富邦-嘉義,2024-08-26,9692
2851,中再保,52,2,50,富邦-嘉義,2024-08-26,9692
1609,大亞,59,13,46,富邦-嘉義,2024-08-26,9692
2365,昆盈,65,20,45,富邦-嘉義,2024-08-26,9692
2409,友達,304,260,44,富邦-嘉義,2024-08-26,9692
8027,鈦昇,58,16,42,富邦-嘉義,2024-08-26,9692
2890,永豐金,40,0,40,富邦-嘉義,2024-08-26,9692
2331,精英,262,222,40,富邦-嘉義,2024-08-26,9692
1721,三晃,46,7,39,富邦-嘉義,2024-08-26,9692
8028,昇陽半導體,132,94,38,富邦-嘉義,2024-08-26,9692
2313,華通,41,5,36,富邦-嘉義,2024-08-26,9692
00918,大華優利高填息30,45,11,34,富邦-嘉義,2024-08-26,9692
3673,TPK-KY,45,11,34,富邦-嘉義,2024-08-26,9692
6275,元山,34,0,34,富邦-嘉義,2024-08-26,9692
2486,一詮,38,4,34,富邦-嘉義,2024-08-26,9692
2461,光群雷,33,0,33,富邦-嘉義,2024-08-26,9692
00945B,凱基美國非投等債,30,0,30,富邦-嘉義,2024-08-26,9692
00676R,富邦臺灣加權反1,30,0,30,富邦-嘉義,2024-08-26,9692
2374,佳能,31,3,28,富邦-嘉義,2024-08-26,9692
8070,長華*,268,241,27,富邦-嘉義,2024-08-26,9692
3515,華擎,34,7,27,富邦-嘉義,2024-08-26,9692
5469,瀚宇博,32,6,26,富邦-嘉義,2024-08-26,9692
1708,東鹼,34,8,26,富邦-嘉義,2024-08-26,9692
1722,台肥,25,0,25,富邦-嘉義,2024-08-26,9692
1568,倉佑,24,0,24,富邦-嘉義,2024-08-26,9692
00715L,期街口布蘭特正2,73,50,23,富邦-嘉義,2024-08-26,9692
00779B,凱基美債25+,23,0,23,富邦-嘉義,2024-08-26,9692
5498,凱崴,23,0,23,富邦-嘉義,2024-08-26,9692
4903,聯光通,26,4,22,富邦-嘉義,2024-08-26,9692
3686,達能,27,6,21,富邦-嘉義,2024-08-26,9692
1540,喬福,82,62,20,富邦-嘉義,2024-08-26,9692
00641R,富邦日本反1,20,0,20,富邦-嘉義,2024-08-26,9692
00650L,復華香港正2,30,10,20,富邦-嘉義,2024-08-26,9692
6177,達麗,27,7,20,富邦-嘉義,2024-08-26,9692
6150,撼訊,22,2,20,富邦-嘉義,2024-08-26,9692
3450,聯鈞,1552,1021,531,富邦-嘉義,2024-08-27,9692
3481,群創,544,222,322,富邦-嘉義,2024-08-27,9692
2891,中信金,296,24,272,富邦-嘉義,2024-08-27,9692
3374,精材,826,583,243,富邦-嘉義,2024-08-27,9692
5443,均豪,1180,989,191,富邦-嘉義,2024-08-27,9692
4526,東台,436,248,188,富邦-嘉義,2024-08-27,9692
00929,復華台灣科技優息,196,11,185,富邦-嘉義,2024-08-27,9692
00919,群益台灣精選高息,171,8,163,富邦-嘉義,2024-08-27,9692
2515,中工,177,30,147,富邦-嘉義,2024-08-27,9692
8039,台虹,373,232,141,富邦-嘉義,2024-08-27,9692
00932,兆豐永續高息等權,132,0,132,富邦-嘉義,2024-08-27,9692
00687B,國泰20年美債,106,6,100,富邦-嘉義,2024-08-27,9692
2409,友達,110,11,99,富邦-嘉義,2024-08-27,9692
00915,凱基優選高股息30,92,0,92,富邦-嘉義,2024-08-27,9692
2867,三商壽,106,17,89,富邦-嘉義,2024-08-27,9692
4561,健椿,85,3,82,富邦-嘉義,2024-08-27,9692
8374,羅昇,416,334,82,富邦-嘉義,2024-08-27,9692
8070,長華*,88,13,75,富邦-嘉義,2024-08-27,9692
3580,友威科,221,149,72,富邦-嘉義,2024-08-27,9692
3550,聯穎,275,206,69,富邦-嘉義,2024-08-27,9692
1540,喬福,361,295,66,富邦-嘉義,2024-08-27,9692
2609,陽明,83,17,66,富邦-嘉義,2024-08-27,9692
2887,台新金,90,29,61,富邦-嘉義,2024-08-27,9692
6151,晉倫,80,19,61,富邦-嘉義,2024-08-27,9692
4303,信立,148,87,61,富邦-嘉義,2024-08-27,9692
00679B,元大美債20年,59,1,58,富邦-嘉義,2024-08-27,9692
3163,波若威,328,270,58,富邦-嘉義,2024-08-27,9692
4562,穎漢,98,41,57,富邦-嘉義,2024-08-27,9692
2467,志聖,117,61,56,富邦-嘉義,2024-08-27,9692
3033,威健,83,29,54,富邦-嘉義,2024-08-27,9692
1597,直得,104,53,51,富邦-嘉義,2024-08-27,9692
1722,台肥,51,1,50,富邦-嘉義,2024-08-27,9692
5905,南仁湖,85,35,50,富邦-嘉義,2024-08-27,9692
3303,岱稜,59,10,49,富邦-嘉義,2024-08-27,9692
2002,中鋼,64,19,45,富邦-嘉義,2024-08-27,9692
00753L,中信中國50正2,40,0,40,富邦-嘉義,2024-08-27,9692
00662,富邦NASDAQ,42,2,40,富邦-嘉義,2024-08-27,9692
6609,瀧澤科,48,9,39,富邦-嘉義,2024-08-27,9692
3019,亞光,895,857,38,富邦-嘉義,2024-08-27,9692
4540,全球傳動,103,65,38,富邦-嘉義,2024-08-27,9692
8096,擎亞,673,635,38,富邦-嘉義,2024-08-27,9692
2834,臺企銀,38,1,37,富邦-嘉義,2024-08-27,9692
3673,TPK-KY,54,17,37,富邦-嘉義,2024-08-27,9692
5469,瀚宇博,140,104,36,富邦-嘉義,2024-08-27,9692
8064,東捷,371,336,35,富邦-嘉義,2024-08-27,9692
1303,南亞,35,1,34,富邦-嘉義,2024-08-27,9692
6658,聯策,49,15,34,富邦-嘉義,2024-08-27,9692
2317,鴻海,59,25,34,富邦-嘉義,2024-08-27,9692
2615,萬海,47,15,32,富邦-嘉義,2024-08-27,9692
3016,嘉晶,31,0,31,富邦-嘉義,2024-08-27,9692
3312,弘憶股,476,36,440,富邦-嘉義,2024-08-28,9692
4510,高鋒,413,71,342,富邦-嘉義,2024-08-28,9692
1540,喬福,839,540,299,富邦-嘉義,2024-08-28,9692
2543,皇昌,303,51,252,富邦-嘉義,2024-08-28,9692
6770,力積電,186,3,183,富邦-嘉義,2024-08-28,9692
2891,中信金,150,20,130,富邦-嘉義,2024-08-28,9692
2425,承啟,139,23,116,富邦-嘉義,2024-08-28,9692
2867,三商壽,116,3,113,富邦-嘉義,2024-08-28,9692
3189,景碩,133,29,104,富邦-嘉義,2024-08-28,9692
00679B,元大美債20年,106,9,97,富邦-嘉義,2024-08-28,9692
00959B,大華投等美債15Y+,85,0,85,富邦-嘉義,2024-08-28,9692
1528,恩德,205,121,84,富邦-嘉義,2024-08-28,9692
3149,正達,201,125,76,富邦-嘉義,2024-08-28,9692
6152,百一,75,2,73,富邦-嘉義,2024-08-28,9692
2367,燿華,203,141,62,富邦-嘉義,2024-08-28,9692
2801,彰銀,57,0,57,富邦-嘉義,2024-08-28,9692
00932,兆豐永續高息等權,55,0,55,富邦-嘉義,2024-08-28,9692
00939,統一台灣高息動能,52,0,52,富邦-嘉義,2024-08-28,9692
6873,泓德能源,51,0,51,富邦-嘉義,2024-08-28,9692
1314,中石化,56,6,50,富邦-嘉義,2024-08-28,9692
00687B,國泰20年美債,54,8,46,富邦-嘉義,2024-08-28,9692
3710,連展投控,52,6,46,富邦-嘉義,2024-08-28,9692
00655L,國泰中國A50正2,109,63,46,富邦-嘉義,2024-08-28,9692
00882,中信中國高股息,50,6,44,富邦-嘉義,2024-08-28,9692
4566,時碩工業,174,130,44,富邦-嘉義,2024-08-28,9692
2489,瑞軒,43,0,43,富邦-嘉義,2024-08-28,9692
2002,中鋼,43,4,39,富邦-嘉義,2024-08-28,9692
1727,中華化,50,12,38,富邦-嘉義,2024-08-28,9692
2349,錸德,69,33,36,富邦-嘉義,2024-08-28,9692
00940,元大台灣價值高息,35,1,34,富邦-嘉義,2024-08-28,9692
2353,宏��,39,8,31,富邦-嘉義,2024-08-28,9692
00632R,元大台灣50反1,31,0,31,富邦-嘉義,2024-08-28,9692
00900,富邦特選高股息30,28,0,28,富邦-嘉義,2024-08-28,9692
8064,東捷,115,88,27,富邦-嘉義,2024-08-28,9692
2324,仁寶,30,3,27,富邦-嘉義,2024-08-28,9692
2408,南亞科,32,6,26,富邦-嘉義,2024-08-28,9692
00878,國泰永續高股息,61,36,25,富邦-嘉義,2024-08-28,9692
00919,群益台灣精選高息,46,21,25,富邦-嘉義,2024-08-28,9692
2603,長榮,24,0,24,富邦-嘉義,2024-08-28,9692
00715L,期街口布蘭特正2,37,14,23,富邦-嘉義,2024-08-28,9692
5498,凱崴,25,2,23,富邦-嘉義,2024-08-28,9692
4306,炎洲,22,0,22,富邦-嘉義,2024-08-28,9692
4960,誠美材,21,0,21,富邦-嘉義,2024-08-28,9692
00688L,國泰20年美債正2,26,5,21,富邦-嘉義,2024-08-28,9692
3522,御嵿,29,9,20,富邦-嘉義,2024-08-28,9692
2402,毅嘉,134,115,19,富邦-嘉義,2024-08-28,9692
00712,復華富時不動產,23,4,19,富邦-嘉義,2024-08-28,9692
4549,桓達,68,50,18,富邦-嘉義,2024-08-28,9692
8086,宏捷科,17,0,17,富邦-嘉義,2024-08-28,9692
9958,世紀鋼,35,19,16,富邦-嘉義,2024-08-28,9692
3019,亞光,1914,1162,752,富邦-嘉義,2024-08-29,9692
1326,台化,377,156,221,富邦-嘉義,2024-08-29,9692
4566,時碩工業,247,65,182,富邦-嘉義,2024-08-29,9692
1325,恆大,147,3,144,富邦-嘉義,2024-08-29,9692
4526,東台,1007,863,144,富邦-嘉義,2024-08-29,9692
00915,凱基優選高股息30,123,0,123,富邦-嘉義,2024-08-29,9692
4561,健椿,279,156,123,富邦-嘉義,2024-08-29,9692
4711,永純,169,47,122,富邦-嘉義,2024-08-29,9692
00929,復華台灣科技優息,146,33,113,富邦-嘉義,2024-08-29,9692
2845,遠東銀,109,0,109,富邦-嘉義,2024-08-29,9692
2891,中信金,152,49,103,富邦-嘉義,2024-08-29,9692
00937B,群益ESG投等債20,111,11,100,富邦-嘉義,2024-08-29,9692
3362,先進光,128,31,97,富邦-嘉義,2024-08-29,9692
00679B,元大美債20年,82,9,73,富邦-嘉義,2024-08-29,9692
00878,國泰永續高股息,72,2,70,富邦-嘉義,2024-08-29,9692
2356,英業達,77,8,69,富邦-嘉義,2024-08-29,9692
00687B,國泰20年美債,105,38,67,富邦-嘉義,2024-08-29,9692
6770,力積電,73,7,66,富邦-嘉義,2024-08-29,9692
00931B,統一美債20年,64,1,63,富邦-嘉義,2024-08-29,9692
1727,中華化,346,286,60,富邦-嘉義,2024-08-29,9692
1314,中石化,66,8,58,富邦-嘉義,2024-08-29,9692
3081,聯亞,294,236,58,富邦-嘉義,2024-08-29,9692
00919,群益台灣精選高息,62,6,56,富邦-嘉義,2024-08-29,9692
00751B,元大AAA至A公司債,68,13,55,富邦-嘉義,2024-08-29,9692
00933B,國泰10Y+金融債,49,0,49,富邦-嘉義,2024-08-29,9692
6143,振曜,54,7,47,富邦-嘉義,2024-08-29,9692
00665L,富邦�琤肭磪囓�2,49,3,46,富邦-嘉義,2024-08-29,9692
00680L,元大美債20正2,74,30,44,富邦-嘉義,2024-08-29,9692
2515,中工,106,62,44,富邦-嘉義,2024-08-29,9692
6104,創惟,42,0,42,富邦-嘉義,2024-08-29,9692
6546,正基,64,23,41,富邦-嘉義,2024-08-29,9692
8039,台虹,141,101,40,富邦-嘉義,2024-08-29,9692
2382,廣達,61,22,39,富邦-嘉義,2024-08-29,9692
00637L,元大滬深300正2,47,10,37,富邦-嘉義,2024-08-29,9692
00895,富邦未來車,35,0,35,富邦-嘉義,2024-08-29,9692
00959B,大華投等美債15Y+,35,0,35,富邦-嘉義,2024-08-29,9692
00948B,中信優息投資級債,33,0,33,富邦-嘉義,2024-08-29,9692
2314,台揚,34,1,33,富邦-嘉義,2024-08-29,9692
4909,新復興,343,310,33,富邦-嘉義,2024-08-29,9692
2542,興富發,33,1,32,富邦-嘉義,2024-08-29,9692
3481,群創,61,29,32,富邦-嘉義,2024-08-29,9692
4716,大立,40,9,31,富邦-嘉義,2024-08-29,9692
6156,松上,44,14,30,富邦-嘉義,2024-08-29,9692
2887,台新金,38,8,30,富邦-嘉義,2024-08-29,9692
2330,台積電,41,12,29,富邦-嘉義,2024-08-29,9692
3078,僑威,30,1,29,富邦-嘉義,2024-08-29,9692
3008,大立光,42,14,28,富邦-嘉義,2024-08-29,9692
00900,富邦特選高股息30,29,1,28,富邦-嘉義,2024-08-29,9692
2610,華航,33,5,28,富邦-嘉義,2024-08-29,9692
2405,輔信,28,0,28,富邦-嘉義,2024-08-29,9692
00632R,元大台灣50反1,529,15,514,富邦-嘉義,2024-08-30,9692
1539,巨庭,540,59,481,富邦-嘉義,2024-08-30,9692
3227,原相,654,256,398,富邦-嘉義,2024-08-30,9692
8105,凌巨,415,117,298,富邦-嘉義,2024-08-30,9692
00955,中信日本商社,202,0,202,富邦-嘉義,2024-08-30,9692
6658,聯策,416,226,190,富邦-嘉義,2024-08-30,9692
00937B,群益ESG投等債20,209,34,175,富邦-嘉義,2024-08-30,9692
8043,蜜望實,196,44,152,富邦-嘉義,2024-08-30,9692
1584,精剛,152,7,145,富邦-嘉義,2024-08-30,9692
3481,群創,170,36,134,富邦-嘉義,2024-08-30,9692
2618,長榮航,124,6,118,富邦-嘉義,2024-08-30,9692
00687B,國泰20年美債,132,23,109,富邦-嘉義,2024-08-30,9692
2543,皇昌,340,241,99,富邦-嘉義,2024-08-30,9692
00919,群益台灣精選高息,126,28,98,富邦-嘉義,2024-08-30,9692
1808,潤隆,130,39,91,富邦-嘉義,2024-08-30,9692
00929,復華台灣科技優息,138,52,86,富邦-嘉義,2024-08-30,9692
2402,毅嘉,106,22,84,富邦-嘉義,2024-08-30,9692
4743,合一,80,5,75,富邦-嘉義,2024-08-30,9692
6151,晉倫,77,5,72,富邦-嘉義,2024-08-30,9692
6706,惠特,324,256,68,富邦-嘉義,2024-08-30,9692
00959B,大華投等美債15Y+,66,0,66,富邦-嘉義,2024-08-30,9692
2409,友達,61,8,53,富邦-嘉義,2024-08-30,9692
2367,燿華,178,125,53,富邦-嘉義,2024-08-30,9692
8028,昇陽半導體,86,34,52,富邦-嘉義,2024-08-30,9692
1314,中石化,72,21,51,富邦-嘉義,2024-08-30,9692
2891,中信金,55,10,45,富邦-嘉義,2024-08-30,9692
8085,福華,49,4,45,富邦-嘉義,2024-08-30,9692
5245,智晶,54,11,43,富邦-嘉義,2024-08-30,9692
6541,泰福-KY,47,7,40,富邦-嘉義,2024-08-30,9692
6937,天虹,65,31,34,富邦-嘉義,2024-08-30,9692
8354,冠好,32,0,32,富邦-嘉義,2024-08-30,9692
00688L,國泰20年美債正2,32,0,32,富邦-嘉義,2024-08-30,9692
3189,景碩,49,18,31,富邦-嘉義,2024-08-30,9692
3105,穩懋,47,18,29,富邦-嘉義,2024-08-30,9692
2313,華通,101,72,29,富邦-嘉義,2024-08-30,9692
2610,華航,31,3,28,富邦-嘉義,2024-08-30,9692
4513,福裕,61,33,28,富邦-嘉義,2024-08-30,9692
00679B,元大美債20年,73,46,27,富邦-嘉義,2024-08-30,9692
2002,中鋼,41,14,27,富邦-嘉義,2024-08-30,9692
00948B,中信優息投資級債,26,0,26,富邦-嘉義,2024-08-30,9692
2312,金寶,136,111,25,富邦-嘉義,2024-08-30,9692
3037,欣興,33,13,20,富邦-嘉義,2024-08-30,9692
00680L,元大美債20正2,20,0,20,富邦-嘉義,2024-08-30,9692
4174,浩鼎,21,1,20,富邦-嘉義,2024-08-30,9692
00676R,富邦臺灣加權反1,70,50,20,富邦-嘉義,2024-08-30,9692
3149,正達,52,32,20,富邦-嘉義,2024-08-30,9692
4564,元翎,28,9,19,富邦-嘉義,2024-08-30,9692
6873,泓德能源,19,0,19,富邦-嘉義,2024-08-30,9692
3006,晶豪科,20,1,19,富邦-嘉義,2024-08-30,9692
3338,泰碩,20,1,19,富邦-嘉義,2024-08-30,9692
4909,新復興,1119,424,695,富邦-嘉義,2024-09-02,9692
2867,三商壽,479,44,435,富邦-嘉義,2024-09-02,9692
00753L,中信中國50正2,371,5,366,富邦-嘉義,2024-09-02,9692
00715L,期街口布蘭特正2,334,0,334,富邦-嘉義,2024-09-02,9692
4566,時碩工業,279,61,218,富邦-嘉義,2024-09-02,9692
00919,群益台灣精選高息,248,40,208,富邦-嘉義,2024-09-02,9692
00915,凱基優選高股息30,194,0,194,富邦-嘉義,2024-09-02,9692
00687B,國泰20年美債,190,14,176,富邦-嘉義,2024-09-02,9692
00688L,國泰20年美債正2,118,2,116,富邦-嘉義,2024-09-02,9692
00959B,大華投等美債15Y+,110,0,110,富邦-嘉義,2024-09-02,9692
2357,華碩,156,61,95,富邦-嘉義,2024-09-02,9692
2497,怡利電,120,28,92,富邦-嘉義,2024-09-02,9692
2537,聯上發,108,24,84,富邦-嘉義,2024-09-02,9692
3550,聯穎,81,0,81,富邦-嘉義,2024-09-02,9692
2891,中信金,84,9,75,富邦-嘉義,2024-09-02,9692
2836,高雄銀,73,1,72,富邦-嘉義,2024-09-02,9692
00680L,元大美債20正2,100,30,70,富邦-嘉義,2024-09-02,9692
00934,中信成長高股息,69,0,69,富邦-嘉義,2024-09-02,9692
6152,百一,66,7,59,富邦-嘉義,2024-09-02,9692
1316,上曜,58,2,56,富邦-嘉義,2024-09-02,9692
00878,國泰永續高股息,76,20,56,富邦-嘉義,2024-09-02,9692
2515,中工,153,100,53,富邦-嘉義,2024-09-02,9692
00713,元大台灣高息低波,51,4,47,富邦-嘉義,2024-09-02,9692
2609,陽明,60,15,45,富邦-嘉義,2024-09-02,9692
3047,訊舟,506,462,44,富邦-嘉義,2024-09-02,9692
00655L,國泰中國A50正2,42,0,42,富邦-嘉義,2024-09-02,9692
00637L,元大滬深300正2,39,1,38,富邦-嘉義,2024-09-02,9692
3062,建漢,80,42,38,富邦-嘉義,2024-09-02,9692
00679B,元大美債20年,77,42,35,富邦-嘉義,2024-09-02,9692
00882,中信中國高股息,35,0,35,富邦-嘉義,2024-09-02,9692
8927,北基,39,6,33,富邦-嘉義,2024-09-02,9692
00918,大華優利高填息30,46,14,32,富邦-嘉義,2024-09-02,9692
00948B,中信優息投資級債,32,0,32,富邦-嘉義,2024-09-02,9692
4510,高鋒,312,280,32,富邦-嘉義,2024-09-02,9692
2323,中環,32,2,30,富邦-嘉義,2024-09-02,9692
2313,華通,117,89,28,富邦-嘉義,2024-09-02,9692
4960,誠美材,30,3,27,富邦-嘉義,2024-09-02,9692
2543,皇昌,66,40,26,富邦-嘉義,2024-09-02,9692
1301,台塑,27,1,26,富邦-嘉義,2024-09-02,9692
00932,兆豐永續高息等權,25,0,25,富邦-嘉義,2024-09-02,9692
4571,鈞興-KY,27,2,25,富邦-嘉義,2024-09-02,9692
6603,富強鑫,34,10,24,富邦-嘉義,2024-09-02,9692
1314,中石化,27,4,23,富邦-嘉義,2024-09-02,9692
1815,富喬,572,549,23,富邦-嘉義,2024-09-02,9692
2317,鴻海,31,8,23,富邦-嘉義,2024-09-02,9692
3289,宜特,22,0,22,富邦-嘉義,2024-09-02,9692
2314,台揚,22,0,22,富邦-嘉義,2024-09-02,9692
2070,精湛,36,15,21,富邦-嘉義,2024-09-02,9692
1722,台肥,20,0,20,富邦-嘉義,2024-09-02,9692
00900,富邦特選高股息30,20,0,20,富邦-嘉義,2024-09-02,9692
00921,兆豐龍頭等權重,558,28,530,富邦-嘉義,2024-09-03,9692
00937B,群益ESG投等債20,354,6,348,富邦-嘉義,2024-09-03,9692
00919,群益台灣精選高息,356,27,329,富邦-嘉義,2024-09-03,9692
4909,新復興,525,207,318,富邦-嘉義,2024-09-03,9692
1540,喬福,512,288,224,富邦-嘉義,2024-09-03,9692
00687B,國泰20年美債,197,0,197,富邦-嘉義,2024-09-03,9692
00918,大華優利高填息30,193,0,193,富邦-嘉義,2024-09-03,9692
3066,李洲,296,121,175,富邦-嘉義,2024-09-03,9692
2891,中信金,189,19,170,富邦-嘉義,2024-09-03,9692
4510,高鋒,367,223,144,富邦-嘉義,2024-09-03,9692
00878,國泰永續高股息,111,20,91,富邦-嘉義,2024-09-03,9692
00948B,中信優息投資級債,81,0,81,富邦-嘉義,2024-09-03,9692
00915,凱基優選高股息30,72,0,72,富邦-嘉義,2024-09-03,9692
00931B,統一美債20年,70,0,70,富邦-嘉義,2024-09-03,9692
2420,新巨,80,10,70,富邦-嘉義,2024-09-03,9692
1722,台肥,70,0,70,富邦-嘉義,2024-09-03,9692
2323,中環,64,1,63,富邦-嘉義,2024-09-03,9692
2397,友通,97,37,60,富邦-嘉義,2024-09-03,9692
2515,中工,56,0,56,富邦-嘉義,2024-09-03,9692
4763,材料-KY,105,50,55,富邦-嘉義,2024-09-03,9692
2101,南港,52,1,51,富邦-嘉義,2024-09-03,9692
2887,台新金,59,12,47,富邦-嘉義,2024-09-03,9692
00940,元大台灣價值高息,76,35,41,富邦-嘉義,2024-09-03,9692
2409,友達,62,21,41,富邦-嘉義,2024-09-03,9692
2382,廣達,108,67,41,富邦-嘉義,2024-09-03,9692
3609,三一東林,40,0,40,富邦-嘉義,2024-09-03,9692
4526,東台,262,224,38,富邦-嘉義,2024-09-03,9692
00680L,元大美債20正2,38,0,38,富邦-嘉義,2024-09-03,9692
3062,建漢,122,86,36,富邦-嘉義,2024-09-03,9692
00753L,中信中國50正2,36,0,36,富邦-嘉義,2024-09-03,9692
00959B,大華投等美債15Y+,36,0,36,富邦-嘉義,2024-09-03,9692
3037,欣興,43,9,34,富邦-嘉義,2024-09-03,9692
2609,陽明,40,10,30,富邦-嘉義,2024-09-03,9692
00930,永豐ESG低碳高息,30,0,30,富邦-嘉義,2024-09-03,9692
3163,波若威,74,44,30,富邦-嘉義,2024-09-03,9692
6213,聯茂,56,27,29,富邦-嘉義,2024-09-03,9692
2002,中鋼,30,3,27,富邦-嘉義,2024-09-03,9692
1718,中纖,25,0,25,富邦-嘉義,2024-09-03,9692
00688L,國泰20年美債正2,25,0,25,富邦-嘉義,2024-09-03,9692
2486,一詮,55,31,24,富邦-嘉義,2024-09-03,9692
2543,皇昌,34,10,24,富邦-嘉義,2024-09-03,9692
8033,雷虎,23,0,23,富邦-嘉義,2024-09-03,9692
00679B,元大美債20年,23,2,21,富邦-嘉義,2024-09-03,9692
2610,華航,39,18,21,富邦-嘉義,2024-09-03,9692
2892,第一金,21,0,21,富邦-嘉義,2024-09-03,9692
00637L,元大滬深300正2,45,25,20,富邦-嘉義,2024-09-03,9692
8933,愛地雅,20,0,20,富邦-嘉義,2024-09-03,9692
2313,華通,29,9,20,富邦-嘉義,2024-09-03,9692
2402,毅嘉,39,19,20,富邦-嘉義,2024-09-03,9692
2408,南亞科,33,14,19,富邦-嘉義,2024-09-03,9692
2888,新光金,2374,278,2096,富邦-嘉義,2024-09-04,9692
2834,臺企銀,1370,29,1341,富邦-嘉義,2024-09-04,9692
00919,群益台灣精選高息,873,65,808,富邦-嘉義,2024-09-04,9692
00715L,期街口布蘭特正2,392,6,386,富邦-嘉義,2024-09-04,9692
2316,楠梓電,383,1,382,富邦-嘉義,2024-09-04,9692
00878,國泰永續高股息,419,145,274,富邦-嘉義,2024-09-04,9692
00940,元大台灣價值高息,403,154,249,富邦-嘉義,2024-09-04,9692
00929,復華台灣科技優息,630,390,240,富邦-嘉義,2024-09-04,9692
00918,大華優利高填息30,307,71,236,富邦-嘉義,2024-09-04,9692
4909,新復興,362,148,214,富邦-嘉義,2024-09-04,9692
00915,凱基優選高股息30,177,13,164,富邦-嘉義,2024-09-04,9692
2867,三商壽,234,72,162,富邦-嘉義,2024-09-04,9692
2891,中信金,149,11,138,富邦-嘉義,2024-09-04,9692
0056,元大高股息,151,15,136,富邦-嘉義,2024-09-04,9692
2881,富邦金,131,5,126,富邦-嘉義,2024-09-04,9692
2330,台積電,834,730,104,富邦-嘉義,2024-09-04,9692
5880,合庫金,85,0,85,富邦-嘉義,2024-09-04,9692
4960,誠美材,82,3,79,富邦-嘉義,2024-09-04,9692
00946,群益科技高息成長,135,60,75,富邦-嘉義,2024-09-04,9692
2883,凱基金,98,25,73,富邦-嘉義,2024-09-04,9692
8374,羅昇,1116,1044,72,富邦-嘉義,2024-09-04,9692
2002,中鋼,77,6,71,富邦-嘉義,2024-09-04,9692
1718,中纖,74,4,70,富邦-嘉義,2024-09-04,9692
2801,彰銀,66,0,66,富邦-嘉義,2024-09-04,9692
1326,台化,66,1,65,富邦-嘉義,2024-09-04,9692
2409,友達,69,5,64,富邦-嘉義,2024-09-04,9692
00664R,國泰臺灣加權反1,65,2,63,富邦-嘉義,2024-09-04,9692
5905,南仁湖,86,32,54,富邦-嘉義,2024-09-04,9692
2344,華邦電,58,5,53,富邦-嘉義,2024-09-04,9692
6152,百一,91,40,51,富邦-嘉義,2024-09-04,9692
1451,年興,50,0,50,富邦-嘉義,2024-09-04,9692
00930,永豐ESG低碳高息,55,5,50,富邦-嘉義,2024-09-04,9692
4576,大銀微系統,127,77,50,富邦-嘉義,2024-09-04,9692
1539,巨庭,113,63,50,富邦-嘉義,2024-09-04,9692
1608,華榮,50,1,49,富邦-嘉義,2024-09-04,9692
3019,亞光,63,15,48,富邦-嘉義,2024-09-04,9692
8071,能率網通,48,0,48,富邦-嘉義,2024-09-04,9692
00706L,期元大S＆P日圓正2,50,4,46,富邦-嘉義,2024-09-04,9692
00951,台新日本半導體,45,0,45,富邦-嘉義,2024-09-04,9692
2892,第一金,56,11,45,富邦-嘉義,2024-09-04,9692
2880,華南金,49,5,44,富邦-嘉義,2024-09-04,9692
1301,台塑,51,7,44,富邦-嘉義,2024-09-04,9692
00713,元大台灣高息低波,52,9,43,富邦-嘉義,2024-09-04,9692
1584,精剛,43,0,43,富邦-嘉義,2024-09-04,9692
006208,富邦台50,65,22,43,富邦-嘉義,2024-09-04,9692
00881,國泰台灣5G+,46,4,42,富邦-嘉義,2024-09-04,9692
00753L,中信中國50正2,42,0,42,富邦-嘉義,2024-09-04,9692
1303,南亞,43,2,41,富邦-嘉義,2024-09-04,9692
2886,兆豐金,47,6,41,富邦-嘉義,2024-09-04,9692
00665L,富邦�琤肭磪囓�2,80,40,40,富邦-嘉義,2024-09-04,9692
1815,富喬,948,77,871,富邦-嘉義,2024-09-05,9692
00715L,期街口布蘭特正2,683,5,678,富邦-嘉義,2024-09-05,9692
00679B,元大美債20年,726,49,677,富邦-嘉義,2024-09-05,9692
00919,群益台灣精選高息,300,7,293,富邦-嘉義,2024-09-05,9692
00632R,元大台灣50反1,769,502,267,富邦-嘉義,2024-09-05,9692
00943,兆豐電子高息等權,264,10,254,富邦-嘉義,2024-09-05,9692
2497,怡利電,242,86,156,富邦-嘉義,2024-09-05,9692
00929,復華台灣科技優息,289,134,155,富邦-嘉義,2024-09-05,9692
00664R,國泰臺灣加權反1,152,0,152,富邦-嘉義,2024-09-05,9692
00952,凱基台灣AI50,239,122,117,富邦-嘉義,2024-09-05,9692
3631,晟楠,111,1,110,富邦-嘉義,2024-09-05,9692
6770,力積電,133,23,110,富邦-嘉義,2024-09-05,9692
00937B,群益ESG投等債20,160,53,107,富邦-嘉義,2024-09-05,9692
1722,台肥,83,0,83,富邦-嘉義,2024-09-05,9692
5905,南仁湖,234,151,83,富邦-嘉義,2024-09-05,9692
00878,國泰永續高股息,93,15,78,富邦-嘉義,2024-09-05,9692
2317,鴻海,105,32,73,富邦-嘉義,2024-09-05,9692
2834,臺企銀,133,65,68,富邦-嘉義,2024-09-05,9692
2316,楠梓電,70,2,68,富邦-嘉義,2024-09-05,9692
2891,中信金,86,18,68,富邦-嘉義,2024-09-05,9692
6114,久威,73,6,67,富邦-嘉義,2024-09-05,9692
00946,群益科技高息成長,82,18,64,富邦-嘉義,2024-09-05,9692
00918,大華優利高填息30,68,5,63,富邦-嘉義,2024-09-05,9692
2408,南亞科,59,3,56,富邦-嘉義,2024-09-05,9692
2323,中環,51,0,51,富邦-嘉義,2024-09-05,9692
2367,燿華,63,12,51,富邦-嘉義,2024-09-05,9692
00915,凱基優選高股息30,49,1,48,富邦-嘉義,2024-09-05,9692
2349,錸德,103,56,47,富邦-嘉義,2024-09-05,9692
4714,永捷,96,54,42,富邦-嘉義,2024-09-05,9692
1314,中石化,44,2,42,富邦-嘉義,2024-09-05,9692
00951,台新日本半導體,40,0,40,富邦-嘉義,2024-09-05,9692
1301,台塑,55,16,39,富邦-嘉義,2024-09-05,9692
00940,元大台灣價值高息,89,53,36,富邦-嘉義,2024-09-05,9692
2344,華邦電,79,43,36,富邦-嘉義,2024-09-05,9692
3062,建漢,44,9,35,富邦-嘉義,2024-09-05,9692
3481,群創,74,39,35,富邦-嘉義,2024-09-05,9692
00959B,大華投等美債15Y+,35,0,35,富邦-嘉義,2024-09-05,9692
2409,友達,57,25,32,富邦-嘉義,2024-09-05,9692
3047,訊舟,124,93,31,富邦-嘉義,2024-09-05,9692
00642U,期元大S＆P石油,29,0,29,富邦-嘉義,2024-09-05,9692
00713,元大台灣高息低波,29,1,28,富邦-嘉義,2024-09-05,9692
0056,元大高股息,31,3,28,富邦-嘉義,2024-09-05,9692
2486,一詮,33,6,27,富邦-嘉義,2024-09-05,9692
3437,榮創,50,23,27,富邦-嘉義,2024-09-05,9692
2337,旺宏,25,0,25,富邦-嘉義,2024-09-05,9692
1303,南亞,35,10,25,富邦-嘉義,2024-09-05,9692
2354,鴻準,38,14,24,富邦-嘉義,2024-09-05,9692
3581,博磊,384,360,24,富邦-嘉義,2024-09-05,9692
1326,台化,31,8,23,富邦-嘉義,2024-09-05,9692
3706,神達,40,17,23,富邦-嘉義,2024-09-05,9692
00632R,元大台灣50反1,1402,40,1362,富邦-嘉義,2024-09-06,9692
2888,新光金,616,55,561,富邦-嘉義,2024-09-06,9692
00679B,元大美債20年,658,152,506,富邦-嘉義,2024-09-06,9692
2382,廣達,415,23,392,富邦-嘉義,2024-09-06,9692
00715L,期街口布蘭特正2,368,10,358,富邦-嘉義,2024-09-06,9692
00673R,期元大S＆P原油反1,300,25,275,富邦-嘉義,2024-09-06,9692
00918,大華優利高填息30,242,0,242,富邦-嘉義,2024-09-06,9692
00919,群益台灣精選高息,218,35,183,富邦-嘉義,2024-09-06,9692
00929,復華台灣科技優息,239,112,127,富邦-嘉義,2024-09-06,9692
3481,群創,94,9,85,富邦-嘉義,2024-09-06,9692
2801,彰銀,96,22,74,富邦-嘉義,2024-09-06,9692
4956,光鋐,338,279,59,富邦-嘉義,2024-09-06,9692
00946,群益科技高息成長,57,0,57,富邦-嘉義,2024-09-06,9692
2337,旺宏,56,0,56,富邦-嘉義,2024-09-06,9692
4510,高鋒,476,424,52,富邦-嘉義,2024-09-06,9692
2316,楠梓電,50,0,50,富邦-嘉義,2024-09-06,9692
6127,九豪,52,2,50,富邦-嘉義,2024-09-06,9692
00931B,統一美債20年,51,2,49,富邦-嘉義,2024-09-06,9692
2497,怡利電,318,269,49,富邦-嘉義,2024-09-06,9692
00933B,國泰10Y+金融債,48,0,48,富邦-嘉義,2024-09-06,9692
6609,瀧澤科,97,49,48,富邦-嘉義,2024-09-06,9692
1815,富喬,145,105,40,富邦-嘉義,2024-09-06,9692
2489,瑞軒,58,20,38,富邦-嘉義,2024-09-06,9692
3580,友威科,40,3,37,富邦-嘉義,2024-09-06,9692
2017,官田鋼,34,0,34,富邦-嘉義,2024-09-06,9692
00951,台新日本半導體,30,0,30,富邦-嘉義,2024-09-06,9692
00895,富邦未來車,29,1,28,富邦-嘉義,2024-09-06,9692
8021,尖點,28,0,28,富邦-嘉義,2024-09-06,9692
00915,凱基優選高股息30,29,1,28,富邦-嘉義,2024-09-06,9692
00665L,富邦�琤肭磪囓�2,27,0,27,富邦-嘉義,2024-09-06,9692
5905,南仁湖,40,14,26,富邦-嘉義,2024-09-06,9692
2409,友達,32,6,26,富邦-嘉義,2024-09-06,9692
1303,南亞,43,17,26,富邦-嘉義,2024-09-06,9692
1539,巨庭,103,78,25,富邦-嘉義,2024-09-06,9692
00943,兆豐電子高息等權,24,0,24,富邦-嘉義,2024-09-06,9692
8076,伍豐,54,30,24,富邦-嘉義,2024-09-06,9692
2344,華邦電,27,3,24,富邦-嘉義,2024-09-06,9692
2349,錸德,43,22,21,富邦-嘉義,2024-09-06,9692
1735,日勝化,21,0,21,富邦-嘉義,2024-09-06,9692
1528,恩德,20,0,20,富邦-嘉義,2024-09-06,9692
6152,百一,20,0,20,富邦-嘉義,2024-09-06,9692
00948B,中信優息投資級債,20,0,20,富邦-嘉義,2024-09-06,9692
2002,中鋼,34,15,19,富邦-嘉義,2024-09-06,9692
6770,力積電,21,2,19,富邦-嘉義,2024-09-06,9692
2314,台揚,19,0,19,富邦-嘉義,2024-09-06,9692
00941,中信上游半導體,20,3,17,富邦-嘉義,2024-09-06,9692
00664R,國泰臺灣加權反1,17,0,17,富邦-嘉義,2024-09-06,9692
9105,泰金寶-DR,17,0,17,富邦-嘉義,2024-09-06,9692
00795B,中信美國公債20年,27,11,16,富邦-嘉義,2024-09-06,9692
2426,鼎元,32,16,16,富邦-嘉義,2024-09-06,9692
2883,凱基金,383,17,366,富邦-嘉義,2024-09-09,9692
00919,群益台灣精選高息,386,41,345,富邦-嘉義,2024-09-09,9692
5460,同協,481,164,317,富邦-嘉義,2024-09-09,9692
2834,臺企銀,280,1,279,富邦-嘉義,2024-09-09,9692
00929,復華台灣科技優息,346,126,220,富邦-嘉義,2024-09-09,9692
00878,國泰永續高股息,193,27,166,富邦-嘉義,2024-09-09,9692
2867,三商壽,171,23,148,富邦-嘉義,2024-09-09,9692
1326,台化,149,2,147,富邦-嘉義,2024-09-09,9692
00680L,元大美債20正2,167,35,132,富邦-嘉義,2024-09-09,9692
4526,東台,151,21,130,富邦-嘉義,2024-09-09,9692
00915,凱基優選高股息30,131,5,126,富邦-嘉義,2024-09-09,9692
4510,高鋒,191,71,120,富邦-嘉義,2024-09-09,9692
00715L,期街口布蘭特正2,115,6,109,富邦-嘉義,2024-09-09,9692
2881,富邦金,102,3,99,富邦-嘉義,2024-09-09,9692
1540,喬福,580,485,95,富邦-嘉義,2024-09-09,9692
4128,中天,108,16,92,富邦-嘉義,2024-09-09,9692
2317,鴻海,763,675,88,富邦-嘉義,2024-09-09,9692
4974,亞泰,270,186,84,富邦-嘉義,2024-09-09,9692
3715,定穎投控,91,8,83,富邦-嘉義,2024-09-09,9692
1524,耿鼎,77,0,77,富邦-嘉義,2024-09-09,9692
8374,羅昇,438,368,70,富邦-嘉義,2024-09-09,9692
2891,中信金,90,21,69,富邦-嘉義,2024-09-09,9692
00687B,國泰20年美債,89,26,63,富邦-嘉義,2024-09-09,9692
9945,潤泰新,62,1,61,富邦-嘉義,2024-09-09,9692
00948B,中信優息投資級債,59,0,59,富邦-嘉義,2024-09-09,9692
3481,群創,62,4,58,富邦-嘉義,2024-09-09,9692
3081,聯亞,147,94,53,富邦-嘉義,2024-09-09,9692
00918,大華優利高填息30,52,0,52,富邦-嘉義,2024-09-09,9692
8039,台虹,51,0,51,富邦-嘉義,2024-09-09,9692
00940,元大台灣價值高息,51,7,44,富邦-嘉義,2024-09-09,9692
2330,台積電,148,106,42,富邦-嘉義,2024-09-09,9692
00679B,元大美債20年,84,43,41,富邦-嘉義,2024-09-09,9692
2002,中鋼,45,5,40,富邦-嘉義,2024-09-09,9692
8111,立��,40,0,40,富邦-嘉義,2024-09-09,9692
00676R,富邦臺灣加權反1,40,0,40,富邦-嘉義,2024-09-09,9692
00857B,永豐20年美公債,38,0,38,富邦-嘉義,2024-09-09,9692
00713,元大台灣高息低波,39,5,34,富邦-嘉義,2024-09-09,9692
2101,南港,32,0,32,富邦-嘉義,2024-09-09,9692
00675L,富邦臺灣加權正2,33,2,31,富邦-嘉義,2024-09-09,9692
2618,長榮航,32,1,31,富邦-嘉義,2024-09-09,9692
2885,元大金,45,16,29,富邦-嘉義,2024-09-09,9692
6147,頎邦,30,1,29,富邦-嘉義,2024-09-09,9692
00946,群益科技高息成長,30,1,29,富邦-嘉義,2024-09-09,9692
1711,永光,88,61,27,富邦-嘉義,2024-09-09,9692
00881,國泰台灣5G+,27,0,27,富邦-嘉義,2024-09-09,9692
00943,兆豐電子高息等權,25,0,25,富邦-嘉義,2024-09-09,9692
00631L,元大台灣50正2,25,0,25,富邦-嘉義,2024-09-09,9692
00882,中信中國高股息,29,4,25,富邦-嘉義,2024-09-09,9692
3033,威健,24,0,24,富邦-嘉義,2024-09-09,9692
00921,兆豐龍頭等權重,23,0,23,富邦-嘉義,2024-09-09,9692
00919,群益台灣精選高息,364,24,340,富邦-嘉義,2024-09-10,9692
1815,富喬,1057,905,152,富邦-嘉義,2024-09-10,9692
00957B,兆豐US優選投等債,150,0,150,富邦-嘉義,2024-09-10,9692
00929,復華台灣科技優息,149,5,144,富邦-嘉義,2024-09-10,9692
00715L,期街口布蘭特正2,145,25,120,富邦-嘉義,2024-09-10,9692
00940,元大台灣價值高息,115,0,115,富邦-嘉義,2024-09-10,9692
00937B,群益ESG投等債20,155,54,101,富邦-嘉義,2024-09-10,9692
00918,大華優利高填息30,101,5,96,富邦-嘉義,2024-09-10,9692
00878,國泰永續高股息,124,30,94,富邦-嘉義,2024-09-10,9692
00687B,國泰20年美債,132,51,81,富邦-嘉義,2024-09-10,9692
0056,元大高股息,97,16,81,富邦-嘉義,2024-09-10,9692
2867,三商壽,70,1,69,富邦-嘉義,2024-09-10,9692
3501,維熹,66,0,66,富邦-嘉義,2024-09-10,9692
2888,新光金,219,156,63,富邦-嘉義,2024-09-10,9692
2313,華通,83,23,60,富邦-嘉義,2024-09-10,9692
1735,日勝化,56,0,56,富邦-嘉義,2024-09-10,9692
1316,上曜,66,11,55,富邦-嘉義,2024-09-10,9692
2892,第一金,101,47,54,富邦-嘉義,2024-09-10,9692
2316,楠梓電,53,0,53,富邦-嘉義,2024-09-10,9692
2408,南亞科,54,3,51,富邦-嘉義,2024-09-10,9692
2401,凌陽,57,6,51,富邦-嘉義,2024-09-10,9692
3481,群創,65,17,48,富邦-嘉義,2024-09-10,9692
8071,能率網通,47,1,46,富邦-嘉義,2024-09-10,9692
2323,中環,50,4,46,富邦-嘉義,2024-09-10,9692
4564,元翎,45,1,44,富邦-嘉義,2024-09-10,9692
2101,南港,46,2,44,富邦-嘉義,2024-09-10,9692
00706L,期元大S＆P日圓正2,40,0,40,富邦-嘉義,2024-09-10,9692
4533,協易機,44,5,39,富邦-嘉義,2024-09-10,9692
2002,中鋼,49,11,38,富邦-嘉義,2024-09-10,9692
00680L,元大美債20正2,161,127,34,富邦-嘉義,2024-09-10,9692
00686R,群益臺灣加權反1,33,0,33,富邦-嘉義,2024-09-10,9692
2317,鴻海,639,606,33,富邦-嘉義,2024-09-10,9692
00946,群益科技高息成長,32,0,32,富邦-嘉義,2024-09-10,9692
2891,中信金,33,3,30,富邦-嘉義,2024-09-10,9692
2344,華邦電,43,14,29,富邦-嘉義,2024-09-10,9692
3189,景碩,34,5,29,富邦-嘉義,2024-09-10,9692
2353,宏��,31,2,29,富邦-嘉義,2024-09-10,9692
3362,先進光,29,1,28,富邦-嘉義,2024-09-10,9692
4513,福裕,38,10,28,富邦-嘉義,2024-09-10,9692
00943,兆豐電子高息等權,28,0,28,富邦-嘉義,2024-09-10,9692
3535,晶彩科,86,58,28,富邦-嘉義,2024-09-10,9692
2409,友達,29,2,27,富邦-嘉義,2024-09-10,9692
2442,新美齊,27,0,27,富邦-嘉義,2024-09-10,9692
00936,台新永續高息中小,28,2,26,富邦-嘉義,2024-09-10,9692
00688L,國泰20年美債正2,27,1,26,富邦-嘉義,2024-09-10,9692
00650L,復華香港正2,25,0,25,富邦-嘉義,2024-09-10,9692
2609,陽明,47,23,24,富邦-嘉義,2024-09-10,9692
2402,毅嘉,53,29,24,富邦-嘉義,2024-09-10,9692
1714,和桐,24,0,24,富邦-嘉義,2024-09-10,9692
2022,聚亨,26,2,24,富邦-嘉義,2024-09-10,9692
2888,新光金,11536,10679,857,富邦-嘉義,2024-09-11,9692
00715L,期街口布蘭特正2,530,11,519,富邦-嘉義,2024-09-11,9692
3227,原相,651,265,386,富邦-嘉義,2024-09-11,9692
00680L,元大美債20正2,338,142,196,富邦-嘉義,2024-09-11,9692
00687B,國泰20年美債,152,29,123,富邦-嘉義,2024-09-11,9692
00937B,群益ESG投等債20,182,60,122,富邦-嘉義,2024-09-11,9692
3498,陽程,122,8,114,富邦-嘉義,2024-09-11,9692
00706L,期元大S＆P日圓正2,113,2,111,富邦-嘉義,2024-09-11,9692
6194,育富,161,52,109,富邦-嘉義,2024-09-11,9692
00915,凱基優選高股息30,107,0,107,富邦-嘉義,2024-09-11,9692
00753L,中信中國50正2,105,0,105,富邦-嘉義,2024-09-11,9692
9105,泰金寶-DR,93,0,93,富邦-嘉義,2024-09-11,9692
00878,國泰永續高股息,72,2,70,富邦-嘉義,2024-09-11,9692
3481,群創,89,29,60,富邦-嘉義,2024-09-11,9692
5460,同協,56,7,49,富邦-嘉義,2024-09-11,9692
4417,金洲,50,1,49,富邦-嘉義,2024-09-11,9692
3360,尚立,52,4,48,富邦-嘉義,2024-09-11,9692
2542,興富發,46,2,44,富邦-嘉義,2024-09-11,9692
1815,富喬,53,10,43,富邦-嘉義,2024-09-11,9692
00665L,富邦�琤肭磪囓�2,40,0,40,富邦-嘉義,2024-09-11,9692
00919,群益台灣精選高息,64,27,37,富邦-嘉義,2024-09-11,9692
2883,凱基金,36,0,36,富邦-嘉義,2024-09-11,9692
3623,富晶通,62,30,32,富邦-嘉義,2024-09-11,9692
00712,復華富時不動產,32,0,32,富邦-嘉義,2024-09-11,9692
00882,中信中國高股息,35,4,31,富邦-嘉義,2024-09-11,9692
0056,元大高股息,42,11,31,富邦-嘉義,2024-09-11,9692
00713,元大台灣高息低波,31,0,31,富邦-嘉義,2024-09-11,9692
1710,東聯,30,0,30,富邦-嘉義,2024-09-11,9692
3563,牧德,44,14,30,富邦-嘉義,2024-09-11,9692
5905,南仁湖,36,6,30,富邦-嘉義,2024-09-11,9692
2881,富邦金,28,1,27,富邦-嘉義,2024-09-11,9692
6405,悅城,46,19,27,富邦-嘉義,2024-09-11,9692
2905,三商,37,10,27,富邦-嘉義,2024-09-11,9692
00679B,元大美債20年,71,45,26,富邦-嘉義,2024-09-11,9692
8076,伍豐,37,13,24,富邦-嘉義,2024-09-11,9692
6431,光麗-KY,24,0,24,富邦-嘉義,2024-09-11,9692
2851,中再保,22,0,22,富邦-嘉義,2024-09-11,9692
00957B,兆豐US優選投等債,22,0,22,富邦-嘉義,2024-09-11,9692
4306,炎洲,22,0,22,富邦-嘉義,2024-09-11,9692
8011,台通,33,12,21,富邦-嘉義,2024-09-11,9692
1314,中石化,26,5,21,富邦-嘉義,2024-09-11,9692
00948B,中信優息投資級債,21,0,21,富邦-嘉義,2024-09-11,9692
00642U,期元大S＆P石油,21,0,21,富邦-嘉義,2024-09-11,9692
00959B,大華投等美債15Y+,21,0,21,富邦-嘉義,2024-09-11,9692
1904,正隆,20,0,20,富邦-嘉義,2024-09-11,9692
1522,堤維西,24,4,20,富邦-嘉義,2024-09-11,9692
00640L,富邦日本正2,28,8,20,富邦-嘉義,2024-09-11,9692
3088,艾訊,20,0,20,富邦-嘉義,2024-09-11,9692
2540,愛山林,32,13,19,富邦-嘉義,2024-09-11,9692
2313,華通,43,24,19,富邦-嘉義,2024-09-11,9692
4909,新復興,1129,536,593,富邦-嘉義,2024-09-12,9692
1540,喬福,745,461,284,富邦-嘉義,2024-09-12,9692
8249,菱光,769,489,280,富邦-嘉義,2024-09-12,9692
00632R,元大台灣50反1,444,205,239,富邦-嘉義,2024-09-12,9692
2497,怡利電,271,69,202,富邦-嘉義,2024-09-12,9692
00687B,國泰20年美債,185,66,119,富邦-嘉義,2024-09-12,9692
2891,中信金,139,30,109,富邦-嘉義,2024-09-12,9692
4526,東台,188,108,80,富邦-嘉義,2024-09-12,9692
2540,愛山林,82,18,64,富邦-嘉義,2024-09-12,9692
00688L,國泰20年美債正2,71,14,57,富邦-嘉義,2024-09-12,9692
6405,悅城,58,2,56,富邦-嘉義,2024-09-12,9692
00857B,永豐20年美公債,69,13,56,富邦-嘉義,2024-09-12,9692
2867,三商壽,61,10,51,富邦-嘉義,2024-09-12,9692
00720B,元大投資級公司債,57,6,51,富邦-嘉義,2024-09-12,9692
4128,中天,51,3,48,富邦-嘉義,2024-09-12,9692
00915,凱基優選高股息30,43,1,42,富邦-嘉義,2024-09-12,9692
4561,健椿,63,23,40,富邦-嘉義,2024-09-12,9692
4743,合一,40,1,39,富邦-嘉義,2024-09-12,9692
3049,精金,49,10,39,富邦-嘉義,2024-09-12,9692
00664R,國泰臺灣加權反1,55,20,35,富邦-嘉義,2024-09-12,9692
3013,晟銘電,64,31,33,富邦-嘉義,2024-09-12,9692
8039,台虹,163,132,31,富邦-嘉義,2024-09-12,9692
8277,商丞,28,0,28,富邦-嘉義,2024-09-12,9692
2348,海悅,29,2,27,富邦-嘉義,2024-09-12,9692
2520,冠德,36,9,27,富邦-嘉義,2024-09-12,9692
00918,大華優利高填息30,29,3,26,富邦-嘉義,2024-09-12,9692
2420,新巨,30,6,24,富邦-嘉義,2024-09-12,9692
3047,訊舟,32,9,23,富邦-嘉義,2024-09-12,9692
00948B,中信優息投資級債,23,0,23,富邦-嘉義,2024-09-12,9692
6139,亞翔,27,4,23,富邦-嘉義,2024-09-12,9692
1524,耿鼎,24,2,22,富邦-嘉義,2024-09-12,9692
2399,映泰,259,237,22,富邦-嘉義,2024-09-12,9692
00637L,元大滬深300正2,22,0,22,富邦-嘉義,2024-09-12,9692
3535,晶彩科,22,1,21,富邦-嘉義,2024-09-12,9692
8112,至上,20,0,20,富邦-嘉義,2024-09-12,9692
01010T,京城樂富R1,20,0,20,富邦-嘉義,2024-09-12,9692
2382,廣達,366,346,20,富邦-嘉義,2024-09-12,9692
2880,華南金,41,22,19,富邦-嘉義,2024-09-12,9692
1584,精剛,22,3,19,富邦-嘉義,2024-09-12,9692
00713,元大台灣高息低波,19,0,19,富邦-嘉義,2024-09-12,9692
5475,德宏,24,6,18,富邦-嘉義,2024-09-12,9692
00957B,兆豐US優選投等債,17,0,17,富邦-嘉義,2024-09-12,9692
00673R,期元大S＆P原油反1,16,0,16,富邦-嘉義,2024-09-12,9692
6727,亞泰金屬,22,6,16,富邦-嘉義,2024-09-12,9692
6869,雲豹能源,15,0,15,富邦-嘉義,2024-09-12,9692
00943,兆豐電子高息等權,15,0,15,富邦-嘉義,2024-09-12,9692
8096,擎亞,18,3,15,富邦-嘉義,2024-09-12,9692
00933B,國泰10Y+金融債,13,0,13,富邦-嘉義,2024-09-12,9692
2425,承啟,13,0,13,富邦-嘉義,2024-09-12,9692
6142,友勁,18,5,13,富邦-嘉義,2024-09-12,9692
2388,威盛,418,10,408,富邦-嘉義,2024-09-13,9692
4974,亞泰,612,227,385,富邦-嘉義,2024-09-13,9692
3550,聯穎,529,287,242,富邦-嘉義,2024-09-13,9692
00687B,國泰20年美債,214,10,204,富邦-嘉義,2024-09-13,9692
00918,大華優利高填息30,213,15,198,富邦-嘉義,2024-09-13,9692
00919,群益台灣精選高息,146,4,142,富邦-嘉義,2024-09-13,9692
3303,岱稜,176,39,137,富邦-嘉義,2024-09-13,9692
8032,光菱,140,33,107,富邦-嘉義,2024-09-13,9692
2834,臺企銀,141,36,105,富邦-嘉義,2024-09-13,9692
00929,復華台灣科技優息,158,57,101,富邦-嘉義,2024-09-13,9692
00937B,群益ESG投等債20,134,44,90,富邦-嘉義,2024-09-13,9692
2303,聯電,103,25,78,富邦-嘉義,2024-09-13,9692
2349,錸德,93,23,70,富邦-嘉義,2024-09-13,9692
00795B,中信美國公債20年,62,3,59,富邦-嘉義,2024-09-13,9692
6530,創威,103,45,58,富邦-嘉義,2024-09-13,9692
2477,美隆電,68,23,45,富邦-嘉義,2024-09-13,9692
3231,緯創,84,45,39,富邦-嘉義,2024-09-13,9692
00632R,元大台灣50反1,90,53,37,富邦-嘉義,2024-09-13,9692
00680L,元大美債20正2,33,0,33,富邦-嘉義,2024-09-13,9692
6405,悅城,62,31,31,富邦-嘉義,2024-09-13,9692
2867,三商壽,50,20,30,富邦-嘉義,2024-09-13,9692
2101,南港,30,0,30,富邦-嘉義,2024-09-13,9692
8111,立��,157,127,30,富邦-嘉義,2024-09-13,9692
1711,永光,66,37,29,富邦-嘉義,2024-09-13,9692
6114,久威,27,0,27,富邦-嘉義,2024-09-13,9692
5905,南仁湖,29,3,26,富邦-嘉義,2024-09-13,9692
00946,群益科技高息成長,28,2,26,富邦-嘉義,2024-09-13,9692
9955,佳龍,47,22,25,富邦-嘉義,2024-09-13,9692
00940,元大台灣價值高息,25,0,25,富邦-嘉義,2024-09-13,9692
6275,元山,25,0,25,富邦-嘉義,2024-09-13,9692
8064,東捷,48,24,24,富邦-嘉義,2024-09-13,9692
1806,冠軍,24,0,24,富邦-嘉義,2024-09-13,9692
3033,威健,38,15,23,富邦-嘉義,2024-09-13,9692
1524,耿鼎,42,19,23,富邦-嘉義,2024-09-13,9692
00943,兆豐電子高息等權,22,0,22,富邦-嘉義,2024-09-13,9692
6706,惠特,143,122,21,富邦-嘉義,2024-09-13,9692
2029,盛餘,21,0,21,富邦-嘉義,2024-09-13,9692
3498,陽程,21,0,21,富邦-嘉義,2024-09-13,9692
6609,瀧澤科,37,16,21,富邦-嘉義,2024-09-13,9692
3339,泰谷,20,0,20,富邦-嘉義,2024-09-13,9692
00664R,國泰臺灣加權反1,20,0,20,富邦-嘉義,2024-09-13,9692
2317,鴻海,30,10,20,富邦-嘉義,2024-09-13,9692
6152,百一,28,9,19,富邦-嘉義,2024-09-13,9692
5443,均豪,74,56,18,富邦-嘉義,2024-09-13,9692
0056,元大高股息,32,15,17,富邦-嘉義,2024-09-13,9692
3706,神達,41,25,16,富邦-嘉義,2024-09-13,9692
2889,國票金,15,0,15,富邦-嘉義,2024-09-13,9692
6698,旭暉應材,15,1,14,富邦-嘉義,2024-09-13,9692
2426,鼎元,14,0,14,富邦-嘉義,2024-09-13,9692
3312,弘憶股,15,2,13,富邦-嘉義,2024-09-13,9692
2867,三商壽,1017,63,954,富邦-嘉義,2024-09-16,9692
4977,眾達-KY,703,82,621,富邦-嘉義,2024-09-16,9692
00715L,期街口布蘭特正2,397,32,365,富邦-嘉義,2024-09-16,9692
2905,三商,423,100,323,富邦-嘉義,2024-09-16,9692
1721,三晃,940,631,309,富邦-嘉義,2024-09-16,9692
1326,台化,510,241,269,富邦-嘉義,2024-09-16,9692
5443,均豪,336,138,198,富邦-嘉義,2024-09-16,9692
3550,聯穎,435,250,185,富邦-嘉義,2024-09-16,9692
00706L,期元大S＆P日圓正2,178,0,178,富邦-嘉義,2024-09-16,9692
00687B,國泰20年美債,157,22,135,富邦-嘉義,2024-09-16,9692
0056,元大高股息,149,15,134,富邦-嘉義,2024-09-16,9692
2845,遠東銀,131,3,128,富邦-嘉義,2024-09-16,9692
2426,鼎元,196,71,125,富邦-嘉義,2024-09-16,9692
2891,中信金,128,13,115,富邦-嘉義,2024-09-16,9692
00919,群益台灣精選高息,153,40,113,富邦-嘉義,2024-09-16,9692
5460,同協,114,10,104,富邦-嘉義,2024-09-16,9692
3607,谷崧,105,23,82,富邦-嘉義,2024-09-16,9692
00918,大華優利高填息30,129,48,81,富邦-嘉義,2024-09-16,9692
00937B,群益ESG投等債20,147,81,66,富邦-嘉義,2024-09-16,9692
5905,南仁湖,197,131,66,富邦-嘉義,2024-09-16,9692
1709,和益,75,15,60,富邦-嘉義,2024-09-16,9692
00637L,元大滬深300正2,59,0,59,富邦-嘉義,2024-09-16,9692
00665L,富邦�琤肭磪囓�2,86,30,56,富邦-嘉義,2024-09-16,9692
6609,瀧澤科,146,93,53,富邦-嘉義,2024-09-16,9692
00720B,元大投資級公司債,53,1,52,富邦-嘉義,2024-09-16,9692
00915,凱基優選高股息30,55,4,51,富邦-嘉義,2024-09-16,9692
3360,尚立,127,77,50,富邦-嘉義,2024-09-16,9692
4526,東台,216,170,46,富邦-嘉義,2024-09-16,9692
1714,和桐,51,6,45,富邦-嘉義,2024-09-16,9692
00713,元大台灣高息低波,38,0,38,富邦-嘉義,2024-09-16,9692
4903,聯光通,63,27,36,富邦-嘉義,2024-09-16,9692
00779B,凱基美債25+,35,0,35,富邦-嘉義,2024-09-16,9692
8111,立��,177,142,35,富邦-嘉義,2024-09-16,9692
00946,群益科技高息成長,41,7,34,富邦-嘉義,2024-09-16,9692
8096,擎亞,53,21,32,富邦-嘉義,2024-09-16,9692
2618,長榮航,41,11,30,富邦-嘉義,2024-09-16,9692
5438,東友,257,228,29,富邦-嘉義,2024-09-16,9692
1815,富喬,57,28,29,富邦-嘉義,2024-09-16,9692
00673R,期元大S＆P原油反1,30,2,28,富邦-嘉義,2024-09-16,9692
1907,永豐餘,22,0,22,富邦-嘉義,2024-09-16,9692
3019,亞光,32,12,20,富邦-嘉義,2024-09-16,9692
00931B,統一美債20年,20,0,20,富邦-嘉義,2024-09-16,9692
1465,偉全,20,0,20,富邦-嘉義,2024-09-16,9692
2614,東森,20,0,20,富邦-嘉義,2024-09-16,9692
1904,正隆,20,0,20,富邦-嘉義,2024-09-16,9692
9907,統一實,20,0,20,富邦-嘉義,2024-09-16,9692
2399,映泰,33,14,19,富邦-嘉義,2024-09-16,9692
1727,中華化,149,130,19,富邦-嘉義,2024-09-16,9692
4743,合一,18,1,17,富邦-嘉義,2024-09-16,9692
00696B,富邦美債20年,16,0,16,富邦-嘉義,2024-09-16,9692
3049,精金,1002,52,950,富邦-嘉義,2024-09-18,9692
2867,三商壽,995,48,947,富邦-嘉義,2024-09-18,9692
3167,大量,898,61,837,富邦-嘉義,2024-09-18,9692
4977,眾達-KY,837,409,428,富邦-嘉義,2024-09-18,9692
2399,映泰,1058,720,338,富邦-嘉義,2024-09-18,9692
00929,復華台灣科技優息,361,64,297,富邦-嘉義,2024-09-18,9692
00958B,永豐ESG銀行債15,214,0,214,富邦-嘉義,2024-09-18,9692
00919,群益台灣精選高息,245,51,194,富邦-嘉義,2024-09-18,9692
3581,博磊,187,14,173,富邦-嘉義,2024-09-18,9692
00946,群益科技高息成長,126,0,126,富邦-嘉義,2024-09-18,9692
2349,錸德,613,492,121,富邦-嘉義,2024-09-18,9692
00921,兆豐龍頭等權重,114,0,114,富邦-嘉義,2024-09-18,9692
00878,國泰永續高股息,118,8,110,富邦-嘉義,2024-09-18,9692
00915,凱基優選高股息30,107,0,107,富邦-嘉義,2024-09-18,9692
6869,雲豹能源,128,37,91,富邦-嘉義,2024-09-18,9692
2317,鴻海,1052,962,90,富邦-嘉義,2024-09-18,9692
2836,高雄銀,81,0,81,富邦-嘉義,2024-09-18,9692
1711,永光,710,630,80,富邦-嘉義,2024-09-18,9692
3481,群創,109,35,74,富邦-嘉義,2024-09-18,9692
2887,台新金,73,4,69,富邦-嘉義,2024-09-18,9692
5460,同協,698,630,68,富邦-嘉義,2024-09-18,9692
2425,承啟,147,79,68,富邦-嘉義,2024-09-18,9692
00934,中信成長高股息,66,0,66,富邦-嘉義,2024-09-18,9692
2344,華邦電,83,18,65,富邦-嘉義,2024-09-18,9692
00948B,中信優息投資級債,64,0,64,富邦-嘉義,2024-09-18,9692
6116,彩晶,67,8,59,富邦-嘉義,2024-09-18,9692
00687B,國泰20年美債,92,35,57,富邦-嘉義,2024-09-18,9692
3062,建漢,178,123,55,富邦-嘉義,2024-09-18,9692
3712,永崴投控,55,0,55,富邦-嘉義,2024-09-18,9692
2515,中工,54,1,53,富邦-嘉義,2024-09-18,9692
0056,元大高股息,52,1,51,富邦-嘉義,2024-09-18,9692
00779B,凱基美債25+,50,0,50,富邦-嘉義,2024-09-18,9692
00764B,群益25年美債,50,0,50,富邦-嘉義,2024-09-18,9692
00632R,元大台灣50反1,49,1,48,富邦-嘉義,2024-09-18,9692
2313,華通,66,19,47,富邦-嘉義,2024-09-18,9692
3354,律勝,44,1,43,富邦-嘉義,2024-09-18,9692
00935,野村臺灣新科技50,41,0,41,富邦-嘉義,2024-09-18,9692
00713,元大台灣高息低波,43,3,40,富邦-嘉義,2024-09-18,9692
2477,美隆電,55,15,40,富邦-嘉義,2024-09-18,9692
00936,台新永續高息中小,45,5,40,富邦-嘉義,2024-09-18,9692
00933B,國泰10Y+金融債,44,7,37,富邦-嘉義,2024-09-18,9692
8086,宏捷科,39,3,36,富邦-嘉義,2024-09-18,9692
4711,永純,35,0,35,富邦-嘉義,2024-09-18,9692
4979,華星光,800,765,35,富邦-嘉義,2024-09-18,9692
00939,統一台灣高息動能,41,6,35,富邦-嘉義,2024-09-18,9692
3607,谷崧,36,3,33,富邦-嘉義,2024-09-18,9692
3234,光環,38,6,32,富邦-嘉義,2024-09-18,9692
5438,東友,167,136,31,富邦-嘉義,2024-09-18,9692
00930,永豐ESG低碳高息,30,1,29,富邦-嘉義,2024-09-18,9692
8110,華東,77,51,26,富邦-嘉義,2024-09-18,9692
00919,群益台灣精選高息,533,14,519,富邦-嘉義,2024-09-19,9692
3227,原相,527,135,392,富邦-嘉義,2024-09-19,9692
2889,國票金,307,2,305,富邦-嘉義,2024-09-19,9692
00929,復華台灣科技優息,251,5,246,富邦-嘉義,2024-09-19,9692
00958B,永豐ESG銀行債15,230,0,230,富邦-嘉義,2024-09-19,9692
00918,大華優利高填息30,221,5,216,富邦-嘉義,2024-09-19,9692
00715L,期街口布蘭特正2,228,21,207,富邦-嘉義,2024-09-19,9692
4716,大立,613,428,185,富邦-嘉義,2024-09-19,9692
4526,東台,443,277,166,富邦-嘉義,2024-09-19,9692
00680L,元大美債20正2,209,62,147,富邦-嘉義,2024-09-19,9692
00687B,國泰20年美債,250,117,133,富邦-嘉義,2024-09-19,9692
2888,新光金,592,466,126,富邦-嘉義,2024-09-19,9692
5481,新華,101,3,98,富邦-嘉義,2024-09-19,9692
00915,凱基優選高股息30,100,4,96,富邦-嘉義,2024-09-19,9692
4939,亞電,97,1,96,富邦-嘉義,2024-09-19,9692
2062,橋椿,107,24,83,富邦-嘉義,2024-09-19,9692
5905,南仁湖,251,171,80,富邦-嘉義,2024-09-19,9692
1785,光洋科,118,45,73,富邦-嘉義,2024-09-19,9692
3430,奇鈦科,77,11,66,富邦-嘉義,2024-09-19,9692
00637L,元大滬深300正2,75,14,61,富邦-嘉義,2024-09-19,9692
3230,錦明,68,7,61,富邦-嘉義,2024-09-19,9692
5210,寶碩,60,1,59,富邦-嘉義,2024-09-19,9692
00857B,永豐20年美公債,61,2,59,富邦-嘉義,2024-09-19,9692
2425,承啟,199,147,52,富邦-嘉義,2024-09-19,9692
2382,廣達,55,6,49,富邦-嘉義,2024-09-19,9692
2610,華航,72,23,49,富邦-嘉義,2024-09-19,9692
2344,華邦電,51,5,46,富邦-嘉義,2024-09-19,9692
2033,佳大,91,46,45,富邦-嘉義,2024-09-19,9692
1717,長興,69,28,41,富邦-嘉義,2024-09-19,9692
2905,三商,50,10,40,富邦-嘉義,2024-09-19,9692
3303,岱稜,47,8,39,富邦-嘉義,2024-09-19,9692
3019,亞光,56,18,38,富邦-嘉義,2024-09-19,9692
3597,映興,36,0,36,富邦-嘉義,2024-09-19,9692
4513,福裕,75,39,36,富邦-嘉義,2024-09-19,9692
6257,矽格,35,0,35,富邦-嘉義,2024-09-19,9692
2409,友達,34,0,34,富邦-嘉義,2024-09-19,9692
00933B,國泰10Y+金融債,35,2,33,富邦-嘉義,2024-09-19,9692
00948B,中信優息投資級債,40,8,32,富邦-嘉義,2024-09-19,9692
3714,富采,41,11,30,富邦-嘉義,2024-09-19,9692
4571,鈞興-KY,34,4,30,富邦-嘉義,2024-09-19,9692
00946,群益科技高息成長,29,0,29,富邦-嘉義,2024-09-19,9692
00930,永豐ESG低碳高息,35,6,29,富邦-嘉義,2024-09-19,9692
4510,高鋒,66,38,28,富邦-嘉義,2024-09-19,9692
2243,宏旭-KY,154,128,26,富邦-嘉義,2024-09-19,9692
2374,佳能,70,44,26,富邦-嘉義,2024-09-19,9692
2385,群光,28,2,26,富邦-嘉義,2024-09-19,9692
00937B,群益ESG投等債20,108,83,25,富邦-嘉義,2024-09-19,9692
2504,國產,25,0,25,富邦-嘉義,2024-09-19,9692
00664R,國泰臺灣加權反1,28,3,25,富邦-嘉義,2024-09-19,9692
00936,台新永續高息中小,25,1,24,富邦-嘉義,2024-09-19,9692
00680L,元大美債20正2,530,13,517,富邦-嘉義,2024-09-20,9692
2867,三商壽,416,35,381,富邦-嘉義,2024-09-20,9692
00919,群益台灣精選高息,441,86,355,富邦-嘉義,2024-09-20,9692
3049,精金,750,430,320,富邦-嘉義,2024-09-20,9692
2425,承啟,457,224,233,富邦-嘉義,2024-09-20,9692
00679B,元大美債20年,198,46,152,富邦-嘉義,2024-09-20,9692
2542,興富發,178,39,139,富邦-嘉義,2024-09-20,9692
1314,中石化,156,18,138,富邦-嘉義,2024-09-20,9692
1727,中華化,129,13,116,富邦-嘉義,2024-09-20,9692
00637L,元大滬深300正2,115,0,115,富邦-嘉義,2024-09-20,9692
2062,橋椿,233,132,101,富邦-嘉義,2024-09-20,9692
4716,大立,265,178,87,富邦-嘉義,2024-09-20,9692
5340,建榮,105,26,79,富邦-嘉義,2024-09-20,9692
00929,復華台灣科技優息,132,56,76,富邦-嘉義,2024-09-20,9692
3062,建漢,214,140,74,富邦-嘉義,2024-09-20,9692
00948B,中信優息投資級債,70,0,70,富邦-嘉義,2024-09-20,9692
3689,湧德,115,46,69,富邦-嘉義,2024-09-20,9692
00958B,永豐ESG銀行債15,67,0,67,富邦-嘉義,2024-09-20,9692
2070,精湛,86,20,66,富邦-嘉義,2024-09-20,9692
00665L,富邦�琤肭磪囓�2,90,28,62,富邦-嘉義,2024-09-20,9692
6431,光麗-KY,62,1,61,富邦-嘉義,2024-09-20,9692
1316,上曜,108,50,58,富邦-嘉義,2024-09-20,9692
00751B,元大AAA至A公司債,65,10,55,富邦-嘉義,2024-09-20,9692
1806,冠軍,54,0,54,富邦-嘉義,2024-09-20,9692
2347,聯強,50,1,49,富邦-嘉義,2024-09-20,9692
8112,至上,48,0,48,富邦-嘉義,2024-09-20,9692
5210,寶碩,50,4,46,富邦-嘉義,2024-09-20,9692
2538,基泰,47,1,46,富邦-嘉義,2024-09-20,9692
5905,南仁湖,199,155,44,富邦-嘉義,2024-09-20,9692
4711,永純,68,24,44,富邦-嘉義,2024-09-20,9692
2633,台灣高鐵,43,7,36,富邦-嘉義,2024-09-20,9692
1735,日勝化,59,23,36,富邦-嘉義,2024-09-20,9692
8249,菱光,46,10,36,富邦-嘉義,2024-09-20,9692
3149,正達,240,205,35,富邦-嘉義,2024-09-20,9692
9945,潤泰新,57,23,34,富邦-嘉義,2024-09-20,9692
8039,台虹,37,4,33,富邦-嘉義,2024-09-20,9692
2887,台新金,52,21,31,富邦-嘉義,2024-09-20,9692
4720,德淵,33,2,31,富邦-嘉義,2024-09-20,9692
2313,華通,62,31,31,富邦-嘉義,2024-09-20,9692
2002,中鋼,35,6,29,富邦-嘉義,2024-09-20,9692
1808,潤隆,32,3,29,富邦-嘉義,2024-09-20,9692
4306,炎洲,39,11,28,富邦-嘉義,2024-09-20,9692
8085,福華,28,0,28,富邦-嘉義,2024-09-20,9692
2537,聯上發,51,24,27,富邦-嘉義,2024-09-20,9692
6005,群益證,36,12,24,富邦-嘉義,2024-09-20,9692
3550,聯穎,72,48,24,富邦-嘉義,2024-09-20,9692
5475,德宏,24,0,24,富邦-嘉義,2024-09-20,9692
6492,生華科,23,0,23,富邦-嘉義,2024-09-20,9692
00915,凱基優選高股息30,43,20,23,富邦-嘉義,2024-09-20,9692
2442,新美齊,22,0,22,富邦-嘉義,2024-09-20,9692
1539,巨庭,256,51,205,富邦-嘉義,2024-09-23,9692
3550,聯穎,296,94,202,富邦-嘉義,2024-09-23,9692
2867,三商壽,179,10,169,富邦-嘉義,2024-09-23,9692
3149,正達,297,152,145,富邦-嘉義,2024-09-23,9692
4729,熒茂,210,80,130,富邦-嘉義,2024-09-23,9692
00706L,期元大S＆P日圓正2,111,0,111,富邦-嘉義,2024-09-23,9692
00919,群益台灣精選高息,147,41,106,富邦-嘉義,2024-09-23,9692
1524,耿鼎,168,63,105,富邦-嘉義,2024-09-23,9692
3481,群創,286,184,102,富邦-嘉義,2024-09-23,9692
2349,錸德,418,318,100,富邦-嘉義,2024-09-23,9692
5210,寶碩,113,26,87,富邦-嘉義,2024-09-23,9692
00929,復華台灣科技優息,113,29,84,富邦-嘉義,2024-09-23,9692
2495,普安,101,31,70,富邦-嘉義,2024-09-23,9692
00937B,群益ESG投等債20,145,79,66,富邦-嘉義,2024-09-23,9692
1711,永光,206,142,64,富邦-嘉義,2024-09-23,9692
4707,磐亞,130,66,64,富邦-嘉義,2024-09-23,9692
00673R,期元大S＆P原油反1,62,0,62,富邦-嘉義,2024-09-23,9692
4533,協易機,64,20,44,富邦-嘉義,2024-09-23,9692
8032,光菱,50,8,42,富邦-嘉義,2024-09-23,9692
3605,宏致,76,34,42,富邦-嘉義,2024-09-23,9692
3715,定穎投控,170,129,41,富邦-嘉義,2024-09-23,9692
00632R,元大台灣50反1,51,10,41,富邦-嘉義,2024-09-23,9692
1722,台肥,40,0,40,富邦-嘉義,2024-09-23,9692
3450,聯鈞,392,355,37,富邦-嘉義,2024-09-23,9692
4903,聯光通,85,48,37,富邦-嘉義,2024-09-23,9692
6405,悅城,175,141,34,富邦-嘉義,2024-09-23,9692
5438,東友,35,1,34,富邦-嘉義,2024-09-23,9692
3081,聯亞,80,47,33,富邦-嘉義,2024-09-23,9692
3227,原相,66,34,32,富邦-嘉義,2024-09-23,9692
2228,劍麟,32,2,30,富邦-嘉義,2024-09-23,9692
2062,橋椿,134,104,30,富邦-嘉義,2024-09-23,9692
00943,兆豐電子高息等權,30,0,30,富邦-嘉義,2024-09-23,9692
2464,盟立,71,42,29,富邦-嘉義,2024-09-23,9692
3073,天方能源,72,45,27,富邦-嘉義,2024-09-23,9692
6257,矽格,27,0,27,富邦-嘉義,2024-09-23,9692
8105,凌巨,27,0,27,富邦-嘉義,2024-09-23,9692
00958B,永豐ESG銀行債15,27,0,27,富邦-嘉義,2024-09-23,9692
6279,胡連,37,10,27,富邦-嘉義,2024-09-23,9692
2399,映泰,166,140,26,富邦-嘉義,2024-09-23,9692
00942B,台新美A公司債20+,25,0,25,富邦-嘉義,2024-09-23,9692
6873,泓德能源,26,3,23,富邦-嘉義,2024-09-23,9692
5245,智晶,24,1,23,富邦-嘉義,2024-09-23,9692
00915,凱基優選高股息30,23,0,23,富邦-嘉義,2024-09-23,9692
00931B,統一美債20年,25,3,22,富邦-嘉義,2024-09-23,9692
00637L,元大滬深300正2,29,7,22,富邦-嘉義,2024-09-23,9692
3631,晟楠,22,0,22,富邦-嘉義,2024-09-23,9692
2332,友訊,23,1,22,富邦-嘉義,2024-09-23,9692
2385,群光,22,1,21,富邦-嘉義,2024-09-23,9692
3050,鈺德,22,1,21,富邦-嘉義,2024-09-23,9692
00948B,中信優息投資級債,21,0,21,富邦-嘉義,2024-09-23,9692
2399,映泰,1636,782,854,富邦-嘉義,2024-09-24,9692
4903,聯光通,971,504,467,富邦-嘉義,2024-09-24,9692
00753L,中信中國50正2,235,16,219,富邦-嘉義,2024-09-24,9692
3622,洋華,365,157,208,富邦-嘉義,2024-09-24,9692
8111,立��,228,67,161,富邦-嘉義,2024-09-24,9692
4977,眾達-KY,151,29,122,富邦-嘉義,2024-09-24,9692
00937B,群益ESG投等債20,165,46,119,富邦-嘉義,2024-09-24,9692
00958B,永豐ESG銀行債15,118,0,118,富邦-嘉義,2024-09-24,9692
1569,濱川,126,9,117,富邦-嘉義,2024-09-24,9692
00632R,元大台灣50反1,129,14,115,富邦-嘉義,2024-09-24,9692
4716,大立,126,14,112,富邦-嘉義,2024-09-24,9692
2303,聯電,100,2,98,富邦-嘉義,2024-09-24,9692
00922,國泰台灣領袖50,96,0,96,富邦-嘉義,2024-09-24,9692
00929,復華台灣科技優息,164,70,94,富邦-嘉義,2024-09-24,9692
6163,華電網,94,5,89,富邦-嘉義,2024-09-24,9692
1524,耿鼎,87,12,75,富邦-嘉義,2024-09-24,9692
00679B,元大美債20年,88,17,71,富邦-嘉義,2024-09-24,9692
6257,矽格,83,26,57,富邦-嘉義,2024-09-24,9692
00960,野村全球航運龍頭,79,25,54,富邦-嘉義,2024-09-24,9692
2609,陽明,524,474,50,富邦-嘉義,2024-09-24,9692
00715L,期街口布蘭特正2,49,8,41,富邦-嘉義,2024-09-24,9692
00945B,凱基美國非投等債,40,0,40,富邦-嘉義,2024-09-24,9692
6609,瀧澤科,40,0,40,富邦-嘉義,2024-09-24,9692
4979,華星光,51,12,39,富邦-嘉義,2024-09-24,9692
00687B,國泰20年美債,100,63,37,富邦-嘉義,2024-09-24,9692
2313,華通,64,27,37,富邦-嘉義,2024-09-24,9692
00878,國泰永續高股息,46,10,36,富邦-嘉義,2024-09-24,9692
8070,長華*,54,21,33,富邦-嘉義,2024-09-24,9692
1584,精剛,99,67,32,富邦-嘉義,2024-09-24,9692
1314,中石化,58,26,32,富邦-嘉義,2024-09-24,9692
0056,元大高股息,35,3,32,富邦-嘉義,2024-09-24,9692
3501,維熹,38,7,31,富邦-嘉義,2024-09-24,9692
2344,華邦電,45,15,30,富邦-嘉義,2024-09-24,9692
4533,協易機,30,0,30,富邦-嘉義,2024-09-24,9692
00751B,元大AAA至A公司債,35,6,29,富邦-嘉義,2024-09-24,9692
1721,三晃,64,36,28,富邦-嘉義,2024-09-24,9692
2634,漢翔,32,4,28,富邦-嘉義,2024-09-24,9692
00795B,中信美國公債20年,28,0,28,富邦-嘉義,2024-09-24,9692
00712,復華富時不動產,34,8,26,富邦-嘉義,2024-09-24,9692
2537,聯上發,29,4,25,富邦-嘉義,2024-09-24,9692
6134,萬旭,36,13,23,富邦-嘉義,2024-09-24,9692
01010T,京城樂富R1,23,0,23,富邦-嘉義,2024-09-24,9692
3037,欣興,27,5,22,富邦-嘉義,2024-09-24,9692
1563,巧新,21,0,21,富邦-嘉義,2024-09-24,9692
6177,達麗,29,9,20,富邦-嘉義,2024-09-24,9692
1905,華紙,20,0,20,富邦-嘉義,2024-09-24,9692
3346,麗清,20,0,20,富邦-嘉義,2024-09-24,9692
2243,宏旭-KY,26,7,19,富邦-嘉義,2024-09-24,9692
3363,上詮,31,12,19,富邦-嘉義,2024-09-24,9692
00639,富邦深100,18,0,18,富邦-嘉義,2024-09-24,9692
6188,廣明,1356,618,738,富邦-嘉義,2024-09-25,9692
3019,亞光,626,91,535,富邦-嘉義,2024-09-25,9692
1326,台化,722,242,480,富邦-嘉義,2024-09-25,9692
1721,三晃,323,135,188,富邦-嘉義,2024-09-25,9692
3605,宏致,238,58,180,富邦-嘉義,2024-09-25,9692
3013,晟銘電,1095,921,174,富邦-嘉義,2024-09-25,9692
2497,怡利電,552,384,168,富邦-嘉義,2024-09-25,9692
3047,訊舟,1049,905,144,富邦-嘉義,2024-09-25,9692
00937B,群益ESG投等債20,151,12,139,富邦-嘉義,2024-09-25,9692
1540,喬福,190,58,132,富邦-嘉義,2024-09-25,9692
00687B,國泰20年美債,167,46,121,富邦-嘉義,2024-09-25,9692
6438,迅得,207,99,108,富邦-嘉義,2024-09-25,9692
1524,耿鼎,130,34,96,富邦-嘉義,2024-09-25,9692
1727,中華化,106,11,95,富邦-嘉義,2024-09-25,9692
6548,長科*,223,131,92,富邦-嘉義,2024-09-25,9692
3167,大量,123,48,75,富邦-嘉義,2024-09-25,9692
1316,上曜,71,1,70,富邦-嘉義,2024-09-25,9692
00679B,元大美債20年,95,33,62,富邦-嘉義,2024-09-25,9692
00907,永豐優息存股,60,0,60,富邦-嘉義,2024-09-25,9692
1304,台聚,60,0,60,富邦-嘉義,2024-09-25,9692
2362,藍天,72,12,60,富邦-嘉義,2024-09-25,9692
3715,定穎投控,127,68,59,富邦-嘉義,2024-09-25,9692
2888,新光金,71,14,57,富邦-嘉義,2024-09-25,9692
2062,橋椿,59,7,52,富邦-嘉義,2024-09-25,9692
6405,悅城,57,5,52,富邦-嘉義,2024-09-25,9692
3443,創意,53,2,51,富邦-嘉義,2024-09-25,9692
00958B,永豐ESG銀行債15,50,0,50,富邦-嘉義,2024-09-25,9692
3149,正達,113,63,50,富邦-嘉義,2024-09-25,9692
00712,復華富時不動產,48,0,48,富邦-嘉義,2024-09-25,9692
1308,亞聚,36,0,36,富邦-嘉義,2024-09-25,9692
6770,力積電,58,23,35,富邦-嘉義,2024-09-25,9692
6873,泓德能源,49,15,34,富邦-嘉義,2024-09-25,9692
4974,亞泰,68,35,33,富邦-嘉義,2024-09-25,9692
00688L,國泰20年美債正2,35,3,32,富邦-嘉義,2024-09-25,9692
2302,麗正,31,2,29,富邦-嘉義,2024-09-25,9692
6104,創惟,229,201,28,富邦-嘉義,2024-09-25,9692
2367,燿華,120,93,27,富邦-嘉義,2024-09-25,9692
2615,萬海,715,693,22,富邦-嘉義,2024-09-25,9692
6869,雲豹能源,31,10,21,富邦-嘉義,2024-09-25,9692
3450,聯鈞,73,53,20,富邦-嘉義,2024-09-25,9692
2233,宇隆,20,0,20,富邦-嘉義,2024-09-25,9692
6279,胡連,20,2,18,富邦-嘉義,2024-09-25,9692
5272,笙科,22,4,18,富邦-嘉義,2024-09-25,9692
00706L,期元大S＆P日圓正2,20,2,18,富邦-嘉義,2024-09-25,9692
00945B,凱基美國非投等債,18,0,18,富邦-嘉義,2024-09-25,9692
2618,長榮航,69,51,18,富邦-嘉義,2024-09-25,9692
2388,威盛,20,3,17,富邦-嘉義,2024-09-25,9692
2349,錸德,80,63,17,富邦-嘉義,2024-09-25,9692
2605,新興,522,506,16,富邦-嘉義,2024-09-25,9692
1217,愛之味,22,6,16,富邦-嘉義,2024-09-25,9692
4979,華星光,1084,140,944,富邦-嘉義,2024-09-26,9692
00632R,元大台灣50反1,315,0,315,富邦-嘉義,2024-09-26,9692
00687B,國泰20年美債,295,28,267,富邦-嘉義,2024-09-26,9692
00936,台新永續高息中小,245,8,237,富邦-嘉義,2024-09-26,9692
6243,迅杰,348,202,146,富邦-嘉義,2024-09-26,9692
1314,中石化,144,2,142,富邦-嘉義,2024-09-26,9692
1326,台化,141,11,130,富邦-嘉義,2024-09-26,9692
1524,耿鼎,131,1,130,富邦-嘉義,2024-09-26,9692
5202,力新,133,8,125,富邦-嘉義,2024-09-26,9692
3293,鈊象,134,12,122,富邦-嘉義,2024-09-26,9692
2495,普安,131,16,115,富邦-嘉義,2024-09-26,9692
00937B,群益ESG投等債20,139,31,108,富邦-嘉義,2024-09-26,9692
6969,成信實業*-創,104,0,104,富邦-嘉義,2024-09-26,9692
2363,矽統,280,183,97,富邦-嘉義,2024-09-26,9692
00948B,中信優息投資級債,88,0,88,富邦-嘉義,2024-09-26,9692
00712,復華富時不動產,89,2,87,富邦-嘉義,2024-09-26,9692
5905,南仁湖,82,4,78,富邦-嘉義,2024-09-26,9692
2867,三商壽,115,40,75,富邦-嘉義,2024-09-26,9692
2312,金寶,259,195,64,富邦-嘉義,2024-09-26,9692
3715,定穎投控,129,65,64,富邦-嘉義,2024-09-26,9692
00679B,元大美債20年,160,99,61,富邦-嘉義,2024-09-26,9692
2388,威盛,403,343,60,富邦-嘉義,2024-09-26,9692
2408,南亞科,100,40,60,富邦-嘉義,2024-09-26,9692
1336,台翰,84,25,59,富邦-嘉義,2024-09-26,9692
3450,聯鈞,1010,953,57,富邦-嘉義,2024-09-26,9692
00934,中信成長高股息,60,8,52,富邦-嘉義,2024-09-26,9692
00671R,富邦NASDAQ反1,50,0,50,富邦-嘉義,2024-09-26,9692
3533,嘉澤,51,1,50,富邦-嘉義,2024-09-26,9692
00960,野村全球航運龍頭,918,870,48,富邦-嘉義,2024-09-26,9692
2887,台新金,48,5,43,富邦-嘉義,2024-09-26,9692
3163,波若威,54,12,42,富邦-嘉義,2024-09-26,9692
00688L,國泰20年美債正2,50,10,40,富邦-嘉義,2024-09-26,9692
1722,台肥,46,8,38,富邦-嘉義,2024-09-26,9692
00958B,永豐ESG銀行債15,36,0,36,富邦-嘉義,2024-09-26,9692
2367,燿華,51,16,35,富邦-嘉義,2024-09-26,9692
1808,潤隆,94,59,35,富邦-嘉義,2024-09-26,9692
00945B,凱基美國非投等債,35,0,35,富邦-嘉義,2024-09-26,9692
2605,新興,40,7,33,富邦-嘉義,2024-09-26,9692
00715L,期街口布蘭特正2,51,20,31,富邦-嘉義,2024-09-26,9692
1584,精剛,48,17,31,富邦-嘉義,2024-09-26,9692
6241,易通展,33,3,30,富邦-嘉義,2024-09-26,9692
2376,技嘉,33,5,28,富邦-嘉義,2024-09-26,9692
2402,毅嘉,29,1,28,富邦-嘉義,2024-09-26,9692
1709,和益,38,10,28,富邦-嘉義,2024-09-26,9692
3217,優群,28,2,26,富邦-嘉義,2024-09-26,9692
00650L,復華香港正2,137,111,26,富邦-嘉義,2024-09-26,9692
6770,力積電,31,6,25,富邦-嘉義,2024-09-26,9692
2365,昆盈,51,26,25,富邦-嘉義,2024-09-26,9692
6449,鈺邦,28,4,24,富邦-嘉義,2024-09-26,9692
3363,上詮,33,10,23,富邦-嘉義,2024-09-26,9692
4977,眾達-KY,1813,1011,802,富邦-嘉義,2024-09-27,9692
3481,群創,615,144,471,富邦-嘉義,2024-09-27,9692
00753L,中信中國50正2,525,156,369,富邦-嘉義,2024-09-27,9692
00715L,期街口布蘭特正2,283,27,256,富邦-嘉義,2024-09-27,9692
00948B,中信優息投資級債,223,0,223,富邦-嘉義,2024-09-27,9692
3483,力致,206,2,204,富邦-嘉義,2024-09-27,9692
3041,揚智,185,0,185,富邦-嘉義,2024-09-27,9692
00915,凱基優選高股息30,191,16,175,富邦-嘉義,2024-09-27,9692
00687B,國泰20年美債,175,21,154,富邦-嘉義,2024-09-27,9692
1313,聯成,230,90,140,富邦-嘉義,2024-09-27,9692
00958B,永豐ESG銀行債15,116,0,116,富邦-嘉義,2024-09-27,9692
00679B,元大美債20年,125,20,105,富邦-嘉義,2024-09-27,9692
00671R,富邦NASDAQ反1,90,0,90,富邦-嘉義,2024-09-27,9692
00680L,元大美債20正2,103,19,84,富邦-嘉義,2024-09-27,9692
1309,台達化,588,504,84,富邦-嘉義,2024-09-27,9692
4979,華星光,1234,1150,84,富邦-嘉義,2024-09-27,9692
2613,中櫃,186,105,81,富邦-嘉義,2024-09-27,9692
2038,海光,85,6,79,富邦-嘉義,2024-09-27,9692
3167,大量,176,102,74,富邦-嘉義,2024-09-27,9692
00929,復華台灣科技優息,144,70,74,富邦-嘉義,2024-09-27,9692
2891,中信金,95,25,70,富邦-嘉義,2024-09-27,9692
2014,中鴻,813,751,62,富邦-嘉義,2024-09-27,9692
2605,新興,762,704,58,富邦-嘉義,2024-09-27,9692
2070,精湛,192,139,53,富邦-嘉義,2024-09-27,9692
8104,錸寶,50,0,50,富邦-嘉義,2024-09-27,9692
8249,菱光,49,0,49,富邦-嘉義,2024-09-27,9692
6237,驊訊,79,30,49,富邦-嘉義,2024-09-27,9692
4903,聯光通,342,294,48,富邦-嘉義,2024-09-27,9692
1721,三晃,45,4,41,富邦-嘉義,2024-09-27,9692
00712,復華富時不動產,41,0,41,富邦-嘉義,2024-09-27,9692
00665L,富邦�琤肭磪囓�2,91,51,40,富邦-嘉義,2024-09-27,9692
2313,華通,47,7,40,富邦-嘉義,2024-09-27,9692
00882,中信中國高股息,262,228,34,富邦-嘉義,2024-09-27,9692
6548,長科*,52,20,32,富邦-嘉義,2024-09-27,9692
6530,創威,475,443,32,富邦-嘉義,2024-09-27,9692
2025,千興,31,0,31,富邦-嘉義,2024-09-27,9692
00688L,國泰20年美債正2,31,0,31,富邦-嘉義,2024-09-27,9692
6179,亞通,37,8,29,富邦-嘉義,2024-09-27,9692
5608,四維航,149,121,28,富邦-嘉義,2024-09-27,9692
00877,復華中國5G,30,2,28,富邦-嘉義,2024-09-27,9692
00946,群益科技高息成長,37,11,26,富邦-嘉義,2024-09-27,9692
00936,台新永續高息中小,47,21,26,富邦-嘉義,2024-09-27,9692
3264,欣銓,26,1,25,富邦-嘉義,2024-09-27,9692
2637,慧洋-KY,265,240,25,富邦-嘉義,2024-09-27,9692
1326,台化,99,75,24,富邦-嘉義,2024-09-27,9692
00945B,凱基美國非投等債,24,0,24,富邦-嘉義,2024-09-27,9692
00696B,富邦美債20年,24,0,24,富邦-嘉義,2024-09-27,9692
8150,南茂,30,6,24,富邦-嘉義,2024-09-27,9692
2359,所羅門,75,52,23,富邦-嘉義,2024-09-27,9692
4526,東台,28,5,23,富邦-嘉義,2024-09-27,9692
00637L,元大滬深300正2,1353,486,867,富邦-嘉義,2024-09-30,9692
1314,中石化,377,0,377,富邦-嘉義,2024-09-30,9692
00919,群益台灣精選高息,396,88,308,富邦-嘉義,2024-09-30,9692
00929,復華台灣科技優息,322,17,305,富邦-嘉義,2024-09-30,9692
2609,陽明,535,239,296,富邦-嘉義,2024-09-30,9692
2890,永豐金,278,4,274,富邦-嘉義,2024-09-30,9692
2615,萬海,479,233,246,富邦-嘉義,2024-09-30,9692
0061,元大寶滬深,161,0,161,富邦-嘉義,2024-09-30,9692
00706L,期元大S＆P日圓正2,154,6,148,富邦-嘉義,2024-09-30,9692
00940,元大台灣價值高息,198,53,145,富邦-嘉義,2024-09-30,9692
00671R,富邦NASDAQ反1,130,1,129,富邦-嘉義,2024-09-30,9692
00679B,元大美債20年,158,31,127,富邦-嘉義,2024-09-30,9692
00882,中信中國高股息,229,111,118,富邦-嘉義,2024-09-30,9692
1326,台化,139,21,118,富邦-嘉義,2024-09-30,9692
00687B,國泰20年美債,134,18,116,富邦-嘉義,2024-09-30,9692
00948B,中信優息投資級債,110,0,110,富邦-嘉義,2024-09-30,9692
2834,臺企銀,110,4,106,富邦-嘉義,2024-09-30,9692
1721,三晃,449,347,102,富邦-嘉義,2024-09-30,9692
00915,凱基優選高股息30,91,1,90,富邦-嘉義,2024-09-30,9692
4919,新唐,94,9,85,富邦-嘉義,2024-09-30,9692
2243,宏旭-KY,108,25,83,富邦-嘉義,2024-09-30,9692
1584,精剛,87,6,81,富邦-嘉義,2024-09-30,9692
00676R,富邦臺灣加權反1,110,31,79,富邦-嘉義,2024-09-30,9692
00878,國泰永續高股息,149,71,78,富邦-嘉義,2024-09-30,9692
00946,群益科技高息成長,61,2,59,富邦-嘉義,2024-09-30,9692
2891,中信金,73,15,58,富邦-嘉義,2024-09-30,9692
4533,協易機,57,0,57,富邦-嘉義,2024-09-30,9692
1301,台塑,81,25,56,富邦-嘉義,2024-09-30,9692
2330,台積電,56,5,51,富邦-嘉義,2024-09-30,9692
2603,長榮,806,758,48,富邦-嘉義,2024-09-30,9692
9938,百和,57,19,38,富邦-嘉義,2024-09-30,9692
2905,三商,33,0,33,富邦-嘉義,2024-09-30,9692
2020,美亞,32,0,32,富邦-嘉義,2024-09-30,9692
00953B,群益優選非投等債,32,0,32,富邦-嘉義,2024-09-30,9692
00927,群益半導體收益,31,0,31,富邦-嘉義,2024-09-30,9692
2881,富邦金,43,12,31,富邦-嘉義,2024-09-30,9692
3081,聯亞,372,342,30,富邦-嘉義,2024-09-30,9692
4306,炎洲,30,0,30,富邦-嘉義,2024-09-30,9692
00726B,國泰新興投等債,30,0,30,富邦-嘉義,2024-09-30,9692
00715L,期街口布蘭特正2,46,17,29,富邦-嘉義,2024-09-30,9692
00945B,凱基美國非投等債,28,0,28,富邦-嘉義,2024-09-30,9692
2611,志信,28,0,28,富邦-嘉義,2024-09-30,9692
00952,凱基台灣AI50,68,40,28,富邦-嘉義,2024-09-30,9692
00943,兆豐電子高息等權,28,0,28,富邦-嘉義,2024-09-30,9692
00632R,元大台灣50反1,168,141,27,富邦-嘉義,2024-09-30,9692
4123,晟德,38,11,27,富邦-嘉義,2024-09-30,9692
00959B,大華投等美債15Y+,26,0,26,富邦-嘉義,2024-09-30,9692
00892,富邦台灣半導體,26,0,26,富邦-嘉義,2024-09-30,9692
6113,亞矽,34,10,24,富邦-嘉義,2024-09-30,9692
2030,彰源,28,4,24,富邦-嘉義,2024-09-30,9692
00937B,群益ESG投等債20,938,131,807,富邦-嘉義,2024-10-01,9692
6530,創威,1660,969,691,富邦-嘉義,2024-10-01,9692
2014,中鴻,531,104,427,富邦-嘉義,2024-10-01,9692
00637L,元大滬深300正2,405,35,370,富邦-嘉義,2024-10-01,9692
00679B,元大美債20年,363,24,339,富邦-嘉義,2024-10-01,9692
00929,復華台灣科技優息,265,41,224,富邦-嘉義,2024-10-01,9692
1721,三晃,329,214,115,富邦-嘉義,2024-10-01,9692
0056,元大高股息,119,8,111,富邦-嘉義,2024-10-01,9692
1584,精剛,89,2,87,富邦-嘉義,2024-10-01,9692
00948B,中信優息投資級債,85,0,85,富邦-嘉義,2024-10-01,9692
1722,台肥,75,0,75,富邦-嘉義,2024-10-01,9692
4903,聯光通,364,290,74,富邦-嘉義,2024-10-01,9692
2867,三商壽,77,7,70,富邦-嘉義,2024-10-01,9692
1314,中石化,59,1,58,富邦-嘉義,2024-10-01,9692
2406,國碩,96,39,57,富邦-嘉義,2024-10-01,9692
00752,中信中國50,59,2,57,富邦-嘉義,2024-10-01,9692
6118,建達,74,20,54,富邦-嘉義,2024-10-01,9692
00946,群益科技高息成長,49,0,49,富邦-嘉義,2024-10-01,9692
00878,國泰永續高股息,74,30,44,富邦-嘉義,2024-10-01,9692
6505,台塑化,42,0,42,富邦-嘉義,2024-10-01,9692
5907,大洋-KY,413,373,40,富邦-嘉義,2024-10-01,9692
00715L,期街口布蘭特正2,204,168,36,富邦-嘉義,2024-10-01,9692
3149,正達,85,54,31,富邦-嘉義,2024-10-01,9692
2888,新光金,35,5,30,富邦-嘉義,2024-10-01,9692
00756B,群益投等新興公債,30,0,30,富邦-嘉義,2024-10-01,9692
3481,群創,46,17,29,富邦-嘉義,2024-10-01,9692
2408,南亞科,32,3,29,富邦-嘉義,2024-10-01,9692
2880,華南金,38,10,28,富邦-嘉義,2024-10-01,9692
00919,群益台灣精選高息,96,68,28,富邦-嘉義,2024-10-01,9692
1326,台化,29,4,25,富邦-嘉義,2024-10-01,9692
00687B,國泰20年美債,80,57,23,富邦-嘉義,2024-10-01,9692
6706,惠特,97,75,22,富邦-嘉義,2024-10-01,9692
6698,旭暉應材,23,2,21,富邦-嘉義,2024-10-01,9692
2029,盛餘,20,0,20,富邦-嘉義,2024-10-01,9692
1434,福懋,20,0,20,富邦-嘉義,2024-10-01,9692
00664R,國泰臺灣加權反1,20,0,20,富邦-嘉義,2024-10-01,9692
4303,信立,41,21,20,富邦-嘉義,2024-10-01,9692
00927,群益半導體收益,19,0,19,富邦-嘉義,2024-10-01,9692
1905,華紙,21,2,19,富邦-嘉義,2024-10-01,9692
2330,台積電,30,12,18,富邦-嘉義,2024-10-01,9692
2887,台新金,20,1,19,富邦-嘉義,2024-10-01,9692
00922,國泰台灣領袖50,19,0,19,富邦-嘉義,2024-10-01,9692
2371,大同,24,6,18,富邦-嘉義,2024-10-01,9692
2317,鴻海,32,14,18,富邦-嘉義,2024-10-01,9692
6438,迅得,46,28,18,富邦-嘉義,2024-10-01,9692
2313,華通,24,6,18,富邦-嘉義,2024-10-01,9692
3498,陽程,23,5,18,富邦-嘉義,2024-10-01,9692
3019,亞光,29,12,17,富邦-嘉義,2024-10-01,9692
3624,光頡,20,3,17,富邦-嘉義,2024-10-01,9692
2367,燿華,32,16,16,富邦-嘉義,2024-10-01,9692
00642U,期元大S＆P石油,630,11,619,富邦-嘉義,2024-10-04,9692
8111,立��,501,48,453,富邦-嘉義,2024-10-04,9692
3049,精金,422,33,389,富邦-嘉義,2024-10-04,9692
2618,長榮航,411,116,295,富邦-嘉義,2024-10-04,9692
00919,群益台灣精選高息,509,231,278,富邦-嘉義,2024-10-04,9692
1721,三晃,488,253,235,富邦-嘉義,2024-10-04,9692
00937B,群益ESG投等債20,316,82,234,富邦-嘉義,2024-10-04,9692
2609,陽明,446,276,170,富邦-嘉義,2024-10-04,9692
3025,星通,312,172,140,富邦-嘉義,2024-10-04,9692
0056,元大高股息,142,11,131,富邦-嘉義,2024-10-04,9692
3234,光環,151,31,120,富邦-嘉義,2024-10-04,9692
00922,國泰台灣領袖50,113,0,113,富邦-嘉義,2024-10-04,9692
00918,大華優利高填息30,111,6,105,富邦-嘉義,2024-10-04,9692
2303,聯電,106,3,103,富邦-嘉義,2024-10-04,9692
2610,華航,92,1,91,富邦-嘉義,2024-10-04,9692
00753L,中信中國50正2,105,23,82,富邦-嘉義,2024-10-04,9692
1595,川寶,270,189,81,富邦-嘉義,2024-10-04,9692
5014,建錩,1261,1185,76,富邦-嘉義,2024-10-04,9692
2408,南亞科,68,0,68,富邦-嘉義,2024-10-04,9692
00679B,元大美債20年,68,1,67,富邦-嘉義,2024-10-04,9692
00948B,中信優息投資級債,66,0,66,富邦-嘉義,2024-10-04,9692
2543,皇昌,97,32,65,富邦-嘉義,2024-10-04,9692
00673R,期元大S＆P原油反1,63,0,63,富邦-嘉義,2024-10-04,9692
00940,元大台灣價值高息,106,44,62,富邦-嘉義,2024-10-04,9692
00878,國泰永續高股息,126,63,63,富邦-嘉義,2024-10-04,9692
00680L,元大美債20正2,101,42,59,富邦-嘉義,2024-10-04,9692
2867,三商壽,61,3,58,富邦-嘉義,2024-10-04,9692
00637L,元大滬深300正2,199,146,53,富邦-嘉義,2024-10-04,9692
2929,淘帝-KY,155,103,52,富邦-嘉義,2024-10-04,9692
2834,臺企銀,57,5,52,富邦-嘉義,2024-10-04,9692
6152,百一,51,0,51,富邦-嘉義,2024-10-04,9692
00687B,國泰20年美債,80,30,50,富邦-嘉義,2024-10-04,9692
00686R,群益臺灣加權反1,50,0,50,富邦-嘉義,2024-10-04,9692
2515,中工,50,0,50,富邦-嘉義,2024-10-04,9692
2880,華南金,52,4,48,富邦-嘉義,2024-10-04,9692
00946,群益科技高息成長,45,0,45,富邦-嘉義,2024-10-04,9692
2603,長榮,55,11,44,富邦-嘉義,2024-10-04,9692
2542,興富發,46,3,43,富邦-嘉義,2024-10-04,9692
00960,野村全球航運龍頭,66,24,42,富邦-嘉義,2024-10-04,9692
2887,台新金,41,0,41,富邦-嘉義,2024-10-04,9692
2332,友訊,41,0,41,富邦-嘉義,2024-10-04,9692
0061,元大寶滬深,63,24,39,富邦-嘉義,2024-10-04,9692
6257,矽格,39,2,37,富邦-嘉義,2024-10-04,9692
00915,凱基優選高股息30,68,31,37,富邦-嘉義,2024-10-04,9692
00632R,元大台灣50反1,62,26,36,富邦-嘉義,2024-10-04,9692
4526,東台,35,2,33,富邦-嘉義,2024-10-04,9692
2425,承啟,303,271,32,富邦-嘉義,2024-10-04,9692
00651R,復華香港反1,32,0,32,富邦-嘉義,2024-10-04,9692
2313,華通,44,14,30,富邦-嘉義,2024-10-04,9692
00671R,富邦NASDAQ反1,30,0,30,富邦-嘉義,2024-10-04,9692
3363,上詮,501,63,438,富邦-嘉義,2024-10-07,9692
2388,威盛,409,5,404,富邦-嘉義,2024-10-07,9692
00632R,元大台灣50反1,470,160,310,富邦-嘉義,2024-10-07,9692
00680L,元大美債20正2,283,29,254,富邦-嘉義,2024-10-07,9692
00719B,元大美債1-3,200,2,198,富邦-嘉義,2024-10-07,9692
00902,中信電池及儲能,300,118,182,富邦-嘉義,2024-10-07,9692
00637L,元大滬深300正2,253,94,159,富邦-嘉義,2024-10-07,9692
3149,正達,241,97,144,富邦-嘉義,2024-10-07,9692
2801,彰銀,142,0,142,富邦-嘉義,2024-10-07,9692
2515,中工,280,152,128,富邦-嘉義,2024-10-07,9692
2867,三商壽,118,2,116,富邦-嘉義,2024-10-07,9692
5443,均豪,147,38,109,富邦-嘉義,2024-10-07,9692
6405,悅城,310,208,102,富邦-嘉義,2024-10-07,9692
2345,智邦,100,0,100,富邦-嘉義,2024-10-07,9692
0056,元大高股息,103,18,85,富邦-嘉義,2024-10-07,9692
1727,中華化,91,7,84,富邦-嘉義,2024-10-07,9692
3715,定穎投控,122,45,77,富邦-嘉義,2024-10-07,9692
3049,精金,2920,2846,74,富邦-嘉義,2024-10-07,9692
1584,精剛,70,0,70,富邦-嘉義,2024-10-07,9692
00878,國泰永續高股息,85,16,69,富邦-嘉義,2024-10-07,9692
3481,群創,76,11,65,富邦-嘉義,2024-10-07,9692
2353,宏��,115,53,62,富邦-嘉義,2024-10-07,9692
2323,中環,100,40,60,富邦-嘉義,2024-10-07,9692
00943,兆豐電子高息等權,59,0,59,富邦-嘉義,2024-10-07,9692
1711,永光,67,12,55,富邦-嘉義,2024-10-07,9692
2317,鴻海,279,224,55,富邦-嘉義,2024-10-07,9692
3591,艾笛森,434,383,51,富邦-嘉義,2024-10-07,9692
4971,IET-KY,53,3,50,富邦-嘉義,2024-10-07,9692
00919,群益台灣精選高息,147,99,48,富邦-嘉義,2024-10-07,9692
1595,川寶,203,155,48,富邦-嘉義,2024-10-07,9692
6530,創威,71,23,48,富邦-嘉義,2024-10-07,9692
00937B,群益ESG投等債20,113,70,43,富邦-嘉義,2024-10-07,9692
00633L,富邦上証正2,49,6,43,富邦-嘉義,2024-10-07,9692
1714,和桐,40,0,40,富邦-嘉義,2024-10-07,9692
912000,晨訊科-DR,96,56,40,富邦-嘉義,2024-10-07,9692
2303,聯電,41,3,38,富邦-嘉義,2024-10-07,9692
00922,國泰台灣領袖50,38,0,38,富邦-嘉義,2024-10-07,9692
2362,藍天,73,36,37,富邦-嘉義,2024-10-07,9692
2425,承啟,177,141,36,富邦-嘉義,2024-10-07,9692
00927,群益半導體收益,45,10,35,富邦-嘉義,2024-10-07,9692
00740B,富邦全球投等債,35,1,34,富邦-嘉義,2024-10-07,9692
6805,富世達,68,34,34,富邦-嘉義,2024-10-07,9692
2344,華邦電,35,1,34,富邦-嘉義,2024-10-07,9692
00673R,期元大S＆P原油反1,31,0,31,富邦-嘉義,2024-10-07,9692
00929,復華台灣科技優息,199,169,30,富邦-嘉義,2024-10-07,9692
2834,臺企銀,30,0,30,富邦-嘉義,2024-10-07,9692
00958B,永豐ESG銀行債15,68,38,30,富邦-嘉義,2024-10-07,9692
6152,百一,31,1,30,富邦-嘉義,2024-10-07,9692
5210,寶碩,30,1,29,富邦-嘉義,2024-10-07,9692
00712,復華富時不動產,29,3,26,富邦-嘉義,2024-10-07,9692
8028,昇陽半導體,940,170,770,富邦-嘉義,2024-10-08,9692
6207,雷科,1057,407,650,富邦-嘉義,2024-10-08,9692
2363,矽統,2893,2380,513,富邦-嘉義,2024-10-08,9692
6134,萬旭,635,161,474,富邦-嘉義,2024-10-08,9692
00929,復華台灣科技優息,344,41,303,富邦-嘉義,2024-10-08,9692
4977,眾達-KY,390,127,263,富邦-嘉義,2024-10-08,9692
2399,映泰,419,203,216,富邦-嘉義,2024-10-08,9692
3481,群創,187,29,158,富邦-嘉義,2024-10-08,9692
0056,元大高股息,157,5,152,富邦-嘉義,2024-10-08,9692
00664R,國泰臺灣加權反1,155,7,148,富邦-嘉義,2024-10-08,9692
00712,復華富時不動產,151,5,146,富邦-嘉義,2024-10-08,9692
00719B,元大美債1-3,141,0,141,富邦-嘉義,2024-10-08,9692
00919,群益台灣精選高息,133,4,129,富邦-嘉義,2024-10-08,9692
1314,中石化,145,21,124,富邦-嘉義,2024-10-08,9692
00680L,元大美債20正2,189,65,124,富邦-嘉義,2024-10-08,9692
00887,永豐中國科技50大,639,520,119,富邦-嘉義,2024-10-08,9692
4956,光鋐,174,59,115,富邦-嘉義,2024-10-08,9692
00948B,中信優息投資級債,103,0,103,富邦-嘉義,2024-10-08,9692
00878,國泰永續高股息,111,12,99,富邦-嘉義,2024-10-08,9692
5014,建錩,129,39,90,富邦-嘉義,2024-10-08,9692
4971,IET-KY,148,73,75,富邦-嘉義,2024-10-08,9692
00673R,期元大S＆P原油反1,75,0,75,富邦-嘉義,2024-10-08,9692
3550,聯穎,153,84,69,富邦-嘉義,2024-10-08,9692
2022,聚亨,63,2,61,富邦-嘉義,2024-10-08,9692
6546,正基,57,0,57,富邦-嘉義,2024-10-08,9692
1101,台泥,61,4,57,富邦-嘉義,2024-10-08,9692
2887,台新金,52,0,52,富邦-嘉義,2024-10-08,9692
2436,偉詮電,67,17,50,富邦-嘉義,2024-10-08,9692
8163,達方,51,1,50,富邦-嘉義,2024-10-08,9692
00697B,元大美債7-10,50,0,50,富邦-嘉義,2024-10-08,9692
00687B,國泰20年美債,109,61,48,富邦-嘉義,2024-10-08,9692
2323,中環,51,5,46,富邦-嘉義,2024-10-08,9692
00633L,富邦上証正2,142,96,46,富邦-嘉義,2024-10-08,9692
3363,上詮,1142,1098,44,富邦-嘉義,2024-10-08,9692
3025,星通,676,632,44,富邦-嘉義,2024-10-08,9692
00958B,永豐ESG銀行債15,104,60,44,富邦-嘉義,2024-10-08,9692
00692,富邦公司治理,40,1,39,富邦-嘉義,2024-10-08,9692
3037,欣興,44,5,39,富邦-嘉義,2024-10-08,9692
2845,遠東銀,38,2,36,富邦-嘉義,2024-10-08,9692
00927,群益半導體收益,35,0,35,富邦-嘉義,2024-10-08,9692
2486,一詮,107,71,36,富邦-嘉義,2024-10-08,9692
2892,第一金,39,5,34,富邦-嘉義,2024-10-08,9692
2408,南亞科,41,7,34,富邦-嘉義,2024-10-08,9692
2409,友達,34,1,33,富邦-嘉義,2024-10-08,9692
00939,統一台灣高息動能,33,0,33,富邦-嘉義,2024-10-08,9692
2371,大同,35,2,33,富邦-嘉義,2024-10-08,9692
00933B,國泰10Y+金融債,34,2,32,富邦-嘉義,2024-10-08,9692
3576,聯合再生,32,0,32,富邦-嘉義,2024-10-08,9692
1714,和桐,31,1,30,富邦-嘉義,2024-10-08,9692
1584,精剛,33,3,30,富邦-嘉義,2024-10-08,9692
00937B,群益ESG投等債20,1422,15,1407,富邦-嘉義,2024-10-09,9692
2363,矽統,3294,2260,1034,富邦-嘉義,2024-10-09,9692
2449,京元電子,1523,815,708,富邦-嘉義,2024-10-09,9692
8111,立��,667,53,614,富邦-嘉義,2024-10-09,9692
00632R,元大台灣50反1,418,66,352,富邦-嘉義,2024-10-09,9692
00948B,中信優息投資級債,304,15,289,富邦-嘉義,2024-10-09,9692
00665L,富邦�琤肭磪囓�2,262,51,211,富邦-嘉義,2024-10-09,9692
5438,東友,973,763,210,富邦-嘉義,2024-10-09,9692
00882,中信中國高股息,359,192,167,富邦-嘉義,2024-10-09,9692
00679B,元大美債20年,189,34,155,富邦-嘉義,2024-10-09,9692
1721,三晃,166,13,153,富邦-嘉義,2024-10-09,9692
00958B,永豐ESG銀行債15,150,0,150,富邦-嘉義,2024-10-09,9692
2892,第一金,132,0,132,富邦-嘉義,2024-10-09,9692
00687B,國泰20年美債,148,23,125,富邦-嘉義,2024-10-09,9692
00753L,中信中國50正2,364,245,119,富邦-嘉義,2024-10-09,9692
2845,遠東銀,121,20,101,富邦-嘉義,2024-10-09,9692
00650L,復華香港正2,302,211,91,富邦-嘉義,2024-10-09,9692
8032,光菱,89,2,87,富邦-嘉義,2024-10-09,9692
00639,富邦深100,89,7,82,富邦-嘉義,2024-10-09,9692
6141,柏承,81,0,81,富邦-嘉義,2024-10-09,9692
9904,寶成,76,1,75,富邦-嘉義,2024-10-09,9692
2891,中信金,106,40,66,富邦-嘉義,2024-10-09,9692
1101,台泥,64,2,62,富邦-嘉義,2024-10-09,9692
1718,中纖,56,0,56,富邦-嘉義,2024-10-09,9692
00680L,元大美債20正2,71,15,56,富邦-嘉義,2024-10-09,9692
2601,益航,73,17,56,富邦-嘉義,2024-10-09,9692
6152,百一,60,5,55,富邦-嘉義,2024-10-09,9692
2408,南亞科,56,1,55,富邦-嘉義,2024-10-09,9692
00922,國泰台灣領袖50,64,11,53,富邦-嘉義,2024-10-09,9692
2801,彰銀,52,1,51,富邦-嘉義,2024-10-09,9692
9105,泰金寶-DR,91,40,51,富邦-嘉義,2024-10-09,9692
00919,群益台灣精選高息,85,36,49,富邦-嘉義,2024-10-09,9692
2887,台新金,51,2,49,富邦-嘉義,2024-10-09,9692
1714,和桐,46,0,46,富邦-嘉義,2024-10-09,9692
1815,富喬,85,39,46,富邦-嘉義,2024-10-09,9692
00688L,國泰20年美債正2,45,0,45,富邦-嘉義,2024-10-09,9692
00719B,元大美債1-3,64,20,44,富邦-嘉義,2024-10-09,9692
1584,精剛,51,7,44,富邦-嘉義,2024-10-09,9692
0056,元大高股息,61,19,42,富邦-嘉義,2024-10-09,9692
00697B,元大美債7-10,40,0,40,富邦-嘉義,2024-10-09,9692
4956,光鋐,332,292,40,富邦-嘉義,2024-10-09,9692
2002,中鋼,61,23,38,富邦-嘉義,2024-10-09,9692
00655L,國泰中國A50正2,40,2,38,富邦-嘉義,2024-10-09,9692
5009,榮剛,39,1,38,富邦-嘉義,2024-10-09,9692
2344,華邦電,37,1,36,富邦-嘉義,2024-10-09,9692
1717,長興,44,8,36,富邦-嘉義,2024-10-09,9692
3481,群創,41,6,35,富邦-嘉義,2024-10-09,9692
4903,聯光通,224,191,33,富邦-嘉義,2024-10-09,9692
2867,三商壽,34,1,33,富邦-嘉義,2024-10-09,9692
3576,聯合再生,45,14,31,富邦-嘉義,2024-10-09,9692
2312,金寶,603,119,484,富邦-嘉義,2024-10-11,9692
3163,波若威,837,470,367,富邦-嘉義,2024-10-11,9692
00753L,中信中國50正2,391,40,351,富邦-嘉義,2024-10-11,9692
3227,原相,537,241,296,富邦-嘉義,2024-10-11,9692
00937B,群益ESG投等債20,330,51,279,富邦-嘉義,2024-10-11,9692
00946,群益科技高息成長,192,1,191,富邦-嘉義,2024-10-11,9692
00719B,元大美債1-3,180,0,180,富邦-嘉義,2024-10-11,9692
1584,精剛,200,53,147,富邦-嘉義,2024-10-11,9692
00948B,中信優息投資級債,128,0,128,富邦-嘉義,2024-10-11,9692
2618,長榮航,113,2,111,富邦-嘉義,2024-10-11,9692
00933B,國泰10Y+金融債,104,0,104,富邦-嘉義,2024-10-11,9692
3363,上詮,420,316,104,富邦-嘉義,2024-10-11,9692
00929,復華台灣科技優息,312,220,92,富邦-嘉義,2024-10-11,9692
00922,國泰台灣領袖50,155,67,88,富邦-嘉義,2024-10-11,9692
00679B,元大美債20年,226,139,87,富邦-嘉義,2024-10-11,9692
00943,兆豐電子高息等權,82,0,82,富邦-嘉義,2024-10-11,9692
3591,艾笛森,175,95,80,富邦-嘉義,2024-10-11,9692
00637L,元大滬深300正2,560,495,65,富邦-嘉義,2024-10-11,9692
3481,群創,57,2,55,富邦-嘉義,2024-10-11,9692
00673R,期元大S＆P原油反1,53,0,53,富邦-嘉義,2024-10-11,9692
2887,台新金,66,13,53,富邦-嘉義,2024-10-11,9692
5871,中租-KY,53,2,51,富邦-嘉義,2024-10-11,9692
1314,中石化,147,100,47,富邦-嘉義,2024-10-11,9692
00878,國泰永續高股息,64,18,46,富邦-嘉義,2024-10-11,9692
3209,全科,56,12,44,富邦-嘉義,2024-10-11,9692
2834,臺企銀,51,9,42,富邦-嘉義,2024-10-11,9692
00945B,凱基美國非投等債,40,0,40,富邦-嘉義,2024-10-11,9692
3705,永信,40,1,39,富邦-嘉義,2024-10-11,9692
00912,中信臺灣智慧50,37,0,37,富邦-嘉義,2024-10-11,9692
2344,華邦電,37,1,36,富邦-嘉義,2024-10-11,9692
2867,三商壽,33,1,32,富邦-嘉義,2024-10-11,9692
0056,元大高股息,46,14,32,富邦-嘉義,2024-10-11,9692
2399,映泰,289,258,31,富邦-嘉義,2024-10-11,9692
2905,三商,41,10,31,富邦-嘉義,2024-10-11,9692
3032,偉訓,30,0,30,富邦-嘉義,2024-10-11,9692
5347,世界,41,11,30,富邦-嘉義,2024-10-11,9692
6134,萬旭,35,6,29,富邦-嘉義,2024-10-11,9692
2402,毅嘉,33,5,28,富邦-嘉義,2024-10-11,9692
5876,上海商銀,28,0,28,富邦-嘉義,2024-10-11,9692
4977,眾達-KY,73,46,27,富邦-嘉義,2024-10-11,9692
2388,威盛,45,18,27,富邦-嘉義,2024-10-11,9692
2610,華航,31,4,27,富邦-嘉義,2024-10-11,9692
3049,精金,144,118,26,富邦-嘉義,2024-10-11,9692
00725B,國泰投資級公司債,25,1,24,富邦-嘉義,2024-10-11,9692
4967,十銓,30,6,24,富邦-嘉義,2024-10-11,9692
4533,協易機,34,11,23,富邦-嘉義,2024-10-11,9692
6257,矽格,28,5,23,富邦-嘉義,2024-10-11,9692
2892,第一金,28,6,22,富邦-嘉義,2024-10-11,9692
2436,偉詮電,26,4,22,富邦-嘉義,2024-10-11,9692
2002,中鋼,39,17,22,富邦-嘉義,2024-10-11,9692
4977,眾達-KY,1346,561,785,富邦-嘉義,2024-10-14,9692
00948B,中信優息投資級債,652,0,652,富邦-嘉義,2024-10-14,9692
3013,晟銘電,1660,1161,499,富邦-嘉義,2024-10-14,9692
00887,永豐中國科技50大,434,0,434,富邦-嘉義,2024-10-14,9692
6156,松上,829,526,303,富邦-嘉義,2024-10-14,9692
3450,聯鈞,1077,780,297,富邦-嘉義,2024-10-14,9692
5452,佶優,290,30,260,富邦-嘉義,2024-10-14,9692
3149,正達,377,121,256,富邦-嘉義,2024-10-14,9692
2399,映泰,605,377,228,富邦-嘉義,2024-10-14,9692
00639,富邦深100,179,12,167,富邦-嘉義,2024-10-14,9692
00679B,元大美債20年,307,143,164,富邦-嘉義,2024-10-14,9692
8032,光菱,234,76,158,富邦-嘉義,2024-10-14,9692
6530,創威,402,245,157,富邦-嘉義,2024-10-14,9692
00680L,元大美債20正2,189,61,128,富邦-嘉義,2024-10-14,9692
5314,世紀,132,7,125,富邦-嘉義,2024-10-14,9692
4903,聯光通,181,58,123,富邦-嘉義,2024-10-14,9692
4956,光鋐,402,310,92,富邦-嘉義,2024-10-14,9692
00958B,永豐ESG銀行債15,91,0,91,富邦-嘉義,2024-10-14,9692
3498,陽程,292,203,89,富邦-嘉義,2024-10-14,9692
3062,建漢,117,29,88,富邦-嘉義,2024-10-14,9692
4991,環宇-KY,385,301,84,富邦-嘉義,2024-10-14,9692
3709,鑫聯大投控,80,2,78,富邦-嘉義,2024-10-14,9692
4979,華星光,94,21,73,富邦-嘉義,2024-10-14,9692
00725B,國泰投資級公司債,67,0,67,富邦-嘉義,2024-10-14,9692
5014,建錩,65,1,64,富邦-嘉義,2024-10-14,9692
00715L,期街口布蘭特正2,113,50,63,富邦-嘉義,2024-10-14,9692
4909,新復興,76,19,57,富邦-嘉義,2024-10-14,9692
0056,元大高股息,63,10,53,富邦-嘉義,2024-10-14,9692
2344,華邦電,50,0,50,富邦-嘉義,2024-10-14,9692
6609,瀧澤科,309,260,49,富邦-嘉義,2024-10-14,9692
4510,高鋒,49,1,48,富邦-嘉義,2024-10-14,9692
2426,鼎元,91,43,48,富邦-嘉義,2024-10-14,9692
3710,連展投控,87,41,46,富邦-嘉義,2024-10-14,9692
00713,元大台灣高息低波,44,0,44,富邦-嘉義,2024-10-14,9692
2615,萬海,49,8,41,富邦-嘉義,2024-10-14,9692
00919,群益台灣精選高息,75,37,38,富邦-嘉義,2024-10-14,9692
2436,偉詮電,42,4,38,富邦-嘉義,2024-10-14,9692
00943,兆豐電子高息等權,36,0,36,富邦-嘉義,2024-10-14,9692
00665L,富邦�琤肭磪囓�2,83,47,36,富邦-嘉義,2024-10-14,9692
1316,上曜,36,2,34,富邦-嘉義,2024-10-14,9692
2834,臺企銀,56,23,33,富邦-嘉義,2024-10-14,9692
00712,復華富時不動產,37,5,32,富邦-嘉義,2024-10-14,9692
6442,光聖,66,36,30,富邦-嘉義,2024-10-14,9692
4414,如興,30,0,30,富邦-嘉義,2024-10-14,9692
00664R,國泰臺灣加權反1,30,0,30,富邦-嘉義,2024-10-14,9692
6830,汎銓,126,96,30,富邦-嘉義,2024-10-14,9692
2610,華航,30,3,27,富邦-嘉義,2024-10-14,9692
3049,精金,29,2,27,富邦-嘉義,2024-10-14,9692
2317,鴻海,58,33,25,富邦-嘉義,2024-10-14,9692
8033,雷虎,88,64,24,富邦-嘉義,2024-10-14,9692
5481,新華,413,51,362,富邦-嘉義,2024-10-15,9692
4576,大銀微系統,389,100,289,富邦-嘉義,2024-10-15,9692
2888,新光金,378,98,280,富邦-嘉義,2024-10-15,9692
00922,國泰台灣領袖50,199,2,197,富邦-嘉義,2024-10-15,9692
1528,恩德,198,8,190,富邦-嘉義,2024-10-15,9692
1314,中石化,212,48,164,富邦-嘉義,2024-10-15,9692
6658,聯策,161,23,138,富邦-嘉義,2024-10-15,9692
00679B,元大美債20年,160,28,132,富邦-嘉義,2024-10-15,9692
00632R,元大台灣50反1,228,111,117,富邦-嘉義,2024-10-15,9692
00915,凱基優選高股息30,114,5,109,富邦-嘉義,2024-10-15,9692
00706L,期元大S＆P日圓正2,113,4,109,富邦-嘉義,2024-10-15,9692
2323,中環,107,11,96,富邦-嘉義,2024-10-15,9692
1313,聯成,102,16,86,富邦-嘉義,2024-10-15,9692
00687B,國泰20年美債,106,25,81,富邦-嘉義,2024-10-15,9692
2330,台積電,261,191,70,富邦-嘉義,2024-10-15,9692
3501,維熹,66,0,66,富邦-嘉義,2024-10-15,9692
6609,瀧澤科,82,21,61,富邦-嘉義,2024-10-15,9692
6763,綠界科技*,78,22,56,富邦-嘉義,2024-10-15,9692
8404,百和興業-KY,104,50,54,富邦-嘉義,2024-10-15,9692
00680L,元大美債20正2,56,5,51,富邦-嘉義,2024-10-15,9692
2515,中工,53,7,46,富邦-嘉義,2024-10-15,9692
6134,萬旭,91,45,46,富邦-嘉義,2024-10-15,9692
2312,金寶,235,194,41,富邦-嘉義,2024-10-15,9692
6152,百一,41,0,41,富邦-嘉義,2024-10-15,9692
6112,邁達特,40,0,40,富邦-嘉義,2024-10-15,9692
00960,野村全球航運龍頭,44,4,40,富邦-嘉義,2024-10-15,9692
00725B,國泰投資級公司債,39,0,39,富邦-嘉義,2024-10-15,9692
00637L,元大滬深300正2,110,72,38,富邦-嘉義,2024-10-15,9692
00937B,群益ESG投等債20,132,95,37,富邦-嘉義,2024-10-15,9692
00712,復華富時不動產,35,1,34,富邦-嘉義,2024-10-15,9692
2486,一詮,52,21,31,富邦-嘉義,2024-10-15,9692
2033,佳大,32,2,30,富邦-嘉義,2024-10-15,9692
00688L,國泰20年美債正2,30,0,30,富邦-嘉義,2024-10-15,9692
1714,和桐,29,0,29,富邦-嘉義,2024-10-15,9692
2303,聯電,29,2,27,富邦-嘉義,2024-10-15,9692
00673R,期元大S＆P原油反1,100,73,27,富邦-嘉義,2024-10-15,9692
00953B,群益優選非投等債,27,0,27,富邦-嘉義,2024-10-15,9692
3033,威健,31,4,27,富邦-嘉義,2024-10-15,9692
00665L,富邦�琤肭磪囓�2,33,6,27,富邦-嘉義,2024-10-15,9692
6505,台塑化,40,15,25,富邦-嘉義,2024-10-15,9692
00715L,期街口布蘭特正2,135,110,25,富邦-嘉義,2024-10-15,9692
2605,新興,27,3,24,富邦-嘉義,2024-10-15,9692
1785,光洋科,30,6,24,富邦-嘉義,2024-10-15,9692
00943,兆豐電子高息等權,23,0,23,富邦-嘉義,2024-10-15,9692
8033,雷虎,25,3,22,富邦-嘉義,2024-10-15,9692
4173,久裕,21,0,21,富邦-嘉義,2024-10-15,9692
912000,晨訊科-DR,20,0,20,富邦-嘉義,2024-10-15,9692
6180,橘子,21,1,20,富邦-嘉義,2024-10-15,9692
4979,華星光,979,960,19,富邦-嘉義,2024-10-15,9692
5484,慧友,19,0,19,富邦-嘉義,2024-10-15,9692
2399,映泰,3967,1445,2522,富邦-嘉義,2024-10-16,9692
00642U,期元大S＆P石油,788,0,788,富邦-嘉義,2024-10-16,9692
1528,恩德,1162,415,747,富邦-嘉義,2024-10-16,9692
8111,立��,902,284,618,富邦-嘉義,2024-10-16,9692
4977,眾達-KY,640,114,526,富邦-嘉義,2024-10-16,9692
6770,力積電,530,5,525,富邦-嘉義,2024-10-16,9692
0056,元大高股息,289,27,262,富邦-嘉義,2024-10-16,9692
00715L,期街口布蘭特正2,250,0,250,富邦-嘉義,2024-10-16,9692
5452,佶優,487,257,230,富邦-嘉義,2024-10-16,9692
6156,松上,210,11,199,富邦-嘉義,2024-10-16,9692
3710,連展投控,224,37,187,富邦-嘉義,2024-10-16,9692
00922,國泰台灣領袖50,193,8,185,富邦-嘉義,2024-10-16,9692
3209,全科,212,31,181,富邦-嘉義,2024-10-16,9692
4956,光鋐,597,453,144,富邦-嘉義,2024-10-16,9692
00680L,元大美債20正2,144,7,137,富邦-嘉義,2024-10-16,9692
2845,遠東銀,137,0,137,富邦-嘉義,2024-10-16,9692
00887,永豐中國科技50大,160,43,117,富邦-嘉義,2024-10-16,9692
1313,聯成,102,0,102,富邦-嘉義,2024-10-16,9692
00960,野村全球航運龍頭,97,0,97,富邦-嘉義,2024-10-16,9692
00943,兆豐電子高息等權,90,0,90,富邦-嘉義,2024-10-16,9692
00725B,國泰投資級公司債,88,6,82,富邦-嘉義,2024-10-16,9692
3013,晟銘電,185,106,79,富邦-嘉義,2024-10-16,9692
4562,穎漢,102,25,77,富邦-嘉義,2024-10-16,9692
3498,陽程,276,202,74,富邦-嘉義,2024-10-16,9692
2023,燁輝,70,0,70,富邦-嘉義,2024-10-16,9692
6141,柏承,63,0,63,富邦-嘉義,2024-10-16,9692
3615,安可,201,139,62,富邦-嘉義,2024-10-16,9692
2834,臺企銀,62,2,60,富邦-嘉義,2024-10-16,9692
4510,高鋒,98,39,59,富邦-嘉義,2024-10-16,9692
00915,凱基優選高股息30,59,0,59,富邦-嘉義,2024-10-16,9692
8374,羅昇,114,56,58,富邦-嘉義,2024-10-16,9692
00905,FT臺灣Smart,53,0,53,富邦-嘉義,2024-10-16,9692
6505,台塑化,45,1,44,富邦-嘉義,2024-10-16,9692
00878,國泰永續高股息,70,26,44,富邦-嘉義,2024-10-16,9692
8404,百和興業-KY,131,89,42,富邦-嘉義,2024-10-16,9692
2897,王道銀行,41,0,41,富邦-嘉義,2024-10-16,9692
3189,景碩,47,7,40,富邦-嘉義,2024-10-16,9692
2344,華邦電,55,19,36,富邦-嘉義,2024-10-16,9692
00948B,中信優息投資級債,43,7,36,富邦-嘉義,2024-10-16,9692
6425,易發,50,16,34,富邦-嘉義,2024-10-16,9692
00912,中信臺灣智慧50,35,2,33,富邦-嘉義,2024-10-16,9692
6530,創威,229,196,33,富邦-嘉義,2024-10-16,9692
2881,富邦金,43,10,33,富邦-嘉義,2024-10-16,9692
00945B,凱基美國非投等債,30,0,30,富邦-嘉義,2024-10-16,9692
4532,瑞智,30,0,30,富邦-嘉義,2024-10-16,9692
00676R,富邦臺灣加權反1,30,0,30,富邦-嘉義,2024-10-16,9692
00665L,富邦�琤肭磪囓�2,60,30,30,富邦-嘉義,2024-10-16,9692
4542,科嶠,32,2,30,富邦-嘉義,2024-10-16,9692
1785,光洋科,29,2,27,富邦-嘉義,2024-10-16,9692
1605,華新,27,0,27,富邦-嘉義,2024-10-16,9692
3450,聯鈞,897,370,527,富邦-嘉義,2024-10-17,9692
3031,佰鴻,673,251,422,富邦-嘉義,2024-10-17,9692
00945B,凱基美國非投等債,364,5,359,富邦-嘉義,2024-10-17,9692
2382,廣達,323,24,299,富邦-嘉義,2024-10-17,9692
1540,喬福,355,150,205,富邦-嘉義,2024-10-17,9692
1314,中石化,184,35,149,富邦-嘉義,2024-10-17,9692
00922,國泰台灣領袖50,131,1,130,富邦-嘉義,2024-10-17,9692
1326,台化,329,207,122,富邦-嘉義,2024-10-17,9692
4562,穎漢,290,171,119,富邦-嘉義,2024-10-17,9692
00665L,富邦�琤肭磪囓�2,154,36,118,富邦-嘉義,2024-10-17,9692
3049,精金,106,1,105,富邦-嘉義,2024-10-17,9692
00687B,國泰20年美債,118,17,101,富邦-嘉義,2024-10-17,9692
3017,奇鋐,111,11,100,富邦-嘉義,2024-10-17,9692
9105,泰金寶-DR,879,786,93,富邦-嘉義,2024-10-17,9692
4542,科嶠,349,257,92,富邦-嘉義,2024-10-17,9692
0056,元大高股息,94,5,89,富邦-嘉義,2024-10-17,9692
2883,凱基金,202,121,81,富邦-嘉義,2024-10-17,9692
00887,永豐中國科技50大,86,12,74,富邦-嘉義,2024-10-17,9692
00680L,元大美債20正2,86,21,65,富邦-嘉義,2024-10-17,9692
5438,東友,181,125,56,富邦-嘉義,2024-10-17,9692
00632R,元大台灣50反1,101,50,51,富邦-嘉義,2024-10-17,9692
1597,直得,105,55,50,富邦-嘉義,2024-10-17,9692
2845,遠東銀,49,0,49,富邦-嘉義,2024-10-17,9692
4903,聯光通,228,184,44,富邦-嘉義,2024-10-17,9692
4510,高鋒,107,68,39,富邦-嘉義,2024-10-17,9692
00912,中信臺灣智慧50,37,0,37,富邦-嘉義,2024-10-17,9692
00795B,中信美國公債20年,36,0,36,富邦-嘉義,2024-10-17,9692
00637L,元大滬深300正2,63,27,36,富邦-嘉義,2024-10-17,9692
6134,萬旭,130,96,34,富邦-嘉義,2024-10-17,9692
3535,晶彩科,33,0,33,富邦-嘉義,2024-10-17,9692
00948B,中信優息投資級債,62,30,32,富邦-嘉義,2024-10-17,9692
00655L,國泰中國A50正2,32,0,32,富邦-嘉義,2024-10-17,9692
2543,皇昌,67,37,30,富邦-嘉義,2024-10-17,9692
6274,台燿,34,4,30,富邦-嘉義,2024-10-17,9692
2468,華經,30,0,30,富邦-嘉義,2024-10-17,9692
2495,普安,62,33,29,富邦-嘉義,2024-10-17,9692
4906,正文,33,5,28,富邦-嘉義,2024-10-17,9692
4576,大銀微系統,222,195,27,富邦-嘉義,2024-10-17,9692
4532,瑞智,26,0,26,富邦-嘉義,2024-10-17,9692
4566,時碩工業,351,326,25,富邦-嘉義,2024-10-17,9692
8028,昇陽半導體,117,93,24,富邦-嘉義,2024-10-17,9692
8150,南茂,27,3,24,富邦-嘉義,2024-10-17,9692
00930,永豐ESG低碳高息,25,1,24,富邦-嘉義,2024-10-17,9692
4979,華星光,59,35,24,富邦-嘉義,2024-10-17,9692
3056,富華新,23,0,23,富邦-嘉義,2024-10-17,9692
6197,佳必琪,23,1,22,富邦-嘉義,2024-10-17,9692
00706L,期元大S＆P日圓正2,30,8,22,富邦-嘉義,2024-10-17,9692
3209,全科,48,26,22,富邦-嘉義,2024-10-17,9692
00951,台新日本半導體,21,0,21,富邦-嘉義,2024-10-17,9692
6763,綠界科技*,35,14,21,富邦-嘉義,2024-10-17,9692
00937B,群益ESG投等債20,1530,44,1486,富邦-嘉義,2024-10-18,9692
00632R,元大台灣50反1,969,210,759,富邦-嘉義,2024-10-18,9692
00679B,元大美債20年,650,39,611,富邦-嘉義,2024-10-18,9692
2312,金寶,3575,3183,392,富邦-嘉義,2024-10-18,9692
00948B,中信優息投資級債,384,1,383,富邦-嘉義,2024-10-18,9692
2363,矽統,541,266,275,富邦-嘉義,2024-10-18,9692
8028,昇陽半導體,712,459,253,富邦-嘉義,2024-10-18,9692
3354,律勝,331,95,236,富邦-嘉義,2024-10-18,9692
6609,瀧澤科,226,2,224,富邦-嘉義,2024-10-18,9692
1721,三晃,339,136,203,富邦-嘉義,2024-10-18,9692
3049,精金,399,202,197,富邦-嘉義,2024-10-18,9692
00753L,中信中國50正2,231,43,188,富邦-嘉義,2024-10-18,9692
2374,佳能,236,54,182,富邦-嘉義,2024-10-18,9692
00687B,國泰20年美債,192,25,167,富邦-嘉義,2024-10-18,9692
2303,聯電,189,36,153,富邦-嘉義,2024-10-18,9692
2867,三商壽,169,30,139,富邦-嘉義,2024-10-18,9692
4510,高鋒,491,369,122,富邦-嘉義,2024-10-18,9692
4561,健椿,503,392,111,富邦-嘉義,2024-10-18,9692
00933B,國泰10Y+金融債,113,5,108,富邦-嘉義,2024-10-18,9692
4903,聯光通,100,1,99,富邦-嘉義,2024-10-18,9692
4729,熒茂,1369,1270,99,富邦-嘉義,2024-10-18,9692
00919,群益台灣精選高息,143,48,95,富邦-嘉義,2024-10-18,9692
00637L,元大滬深300正2,2211,2119,92,富邦-嘉義,2024-10-18,9692
00915,凱基優選高股息30,96,6,90,富邦-嘉義,2024-10-18,9692
00887,永豐中國科技50大,117,32,85,富邦-嘉義,2024-10-18,9692
0056,元大高股息,94,13,81,富邦-嘉義,2024-10-18,9692
1307,三芳,140,60,80,富邦-嘉義,2024-10-18,9692
5230,雷笛克光學,75,2,73,富邦-嘉義,2024-10-18,9692
2313,華通,80,24,56,富邦-嘉義,2024-10-18,9692
00686R,群益臺灣加權反1,50,0,50,富邦-嘉義,2024-10-18,9692
8097,常珵,48,1,47,富邦-嘉義,2024-10-18,9692
00795B,中信美國公債20年,45,0,45,富邦-嘉義,2024-10-18,9692
3013,晟銘電,575,530,45,富邦-嘉義,2024-10-18,9692
4979,華星光,82,38,44,富邦-嘉義,2024-10-18,9692
1584,精剛,44,0,44,富邦-嘉義,2024-10-18,9692
00927,群益半導體收益,46,2,44,富邦-嘉義,2024-10-18,9692
3581,博磊,366,325,41,富邦-嘉義,2024-10-18,9692
2401,凌陽,45,5,40,富邦-嘉義,2024-10-18,9692
6763,綠界科技*,132,92,40,富邦-嘉義,2024-10-18,9692
00688L,國泰20年美債正2,40,1,39,富邦-嘉義,2024-10-18,9692
1815,富喬,38,4,34,富邦-嘉義,2024-10-18,9692
1609,大亞,38,4,34,富邦-嘉義,2024-10-18,9692
6142,友勁,32,0,32,富邦-嘉義,2024-10-18,9692
6770,力積電,34,4,30,富邦-嘉義,2024-10-18,9692
2449,京元電子,60,31,29,富邦-嘉義,2024-10-18,9692
6667,信紘科,34,5,29,富邦-嘉義,2024-10-18,9692
6290,良維,27,0,27,富邦-嘉義,2024-10-18,9692
8240,華宏,32,6,26,富邦-嘉義,2024-10-18,9692
4540,全球傳動,41,16,25,富邦-嘉義,2024-10-18,9692
5302,太欣,24,0,24,富邦-嘉義,2024-10-18,9692
2399,映泰,2254,1501,753,富邦-嘉義,2024-10-21,9692
00937B,群益ESG投等債20,688,6,682,富邦-嘉義,2024-10-21,9692
4576,大銀微系統,1038,513,525,富邦-嘉義,2024-10-21,9692
00753L,中信中國50正2,323,69,254,富邦-嘉義,2024-10-21,9692
2363,矽統,541,304,237,富邦-嘉義,2024-10-21,9692
3581,博磊,424,191,233,富邦-嘉義,2024-10-21,9692
00639,富邦深100,237,16,221,富邦-嘉義,2024-10-21,9692
00715L,期街口布蘭特正2,219,1,218,富邦-嘉義,2024-10-21,9692
3535,晶彩科,440,223,217,富邦-嘉義,2024-10-21,9692
00637L,元大滬深300正2,274,59,215,富邦-嘉義,2024-10-21,9692
3550,聯穎,193,3,190,富邦-嘉義,2024-10-21,9692
2883,凱基金,213,25,188,富邦-嘉義,2024-10-21,9692
6451,訊芯-KY,229,49,180,富邦-嘉義,2024-10-21,9692
00948B,中信優息投資級債,177,0,177,富邦-嘉義,2024-10-21,9692
3189,景碩,1044,873,171,富邦-嘉義,2024-10-21,9692
00687B,國泰20年美債,144,10,134,富邦-嘉義,2024-10-21,9692
3062,建漢,226,99,127,富邦-嘉義,2024-10-21,9692
8032,光菱,134,7,127,富邦-嘉義,2024-10-21,9692
2888,新光金,172,46,126,富邦-嘉義,2024-10-21,9692
0056,元大高股息,144,26,118,富邦-嘉義,2024-10-21,9692
3537,堡達,122,4,118,富邦-嘉義,2024-10-21,9692
2891,中信金,108,12,96,富邦-嘉義,2024-10-21,9692
3615,安可,109,32,77,富邦-嘉義,2024-10-21,9692
00751B,元大AAA至A公司債,72,0,72,富邦-嘉義,2024-10-21,9692
2312,金寶,173,101,72,富邦-嘉義,2024-10-21,9692
3551,世禾,615,545,70,富邦-嘉義,2024-10-21,9692
6405,悅城,147,87,60,富邦-嘉義,2024-10-21,9692
2303,聯電,95,35,60,富邦-嘉義,2024-10-21,9692
5905,南仁湖,59,1,58,富邦-嘉義,2024-10-21,9692
2881,富邦金,62,5,57,富邦-嘉義,2024-10-21,9692
00905,FT臺灣Smart,106,51,55,富邦-嘉義,2024-10-21,9692
00632R,元大台灣50反1,96,42,54,富邦-嘉義,2024-10-21,9692
00719B,元大美債1-3,51,0,51,富邦-嘉義,2024-10-21,9692
6151,晉倫,170,120,50,富邦-嘉義,2024-10-21,9692
3710,連展投控,66,18,48,富邦-嘉義,2024-10-21,9692
8374,羅昇,53,6,47,富邦-嘉義,2024-10-21,9692
2884,玉山金,47,3,44,富邦-嘉義,2024-10-21,9692
2374,佳能,72,29,43,富邦-嘉義,2024-10-21,9692
00650L,復華香港正2,54,11,43,富邦-嘉義,2024-10-21,9692
00891,中信關鍵半導體,44,2,42,富邦-嘉義,2024-10-21,9692
6134,萬旭,173,132,41,富邦-嘉義,2024-10-21,9692
00958B,永豐ESG銀行債15,40,0,40,富邦-嘉義,2024-10-21,9692
9950,萬國通,43,4,39,富邦-嘉義,2024-10-21,9692
2890,永豐金,45,7,38,富邦-嘉義,2024-10-21,9692
1303,南亞,40,3,37,富邦-嘉義,2024-10-21,9692
4540,全球傳動,90,54,36,富邦-嘉義,2024-10-21,9692
1314,中石化,69,34,35,富邦-嘉義,2024-10-21,9692
2356,英業達,57,23,34,富邦-嘉義,2024-10-21,9692
00953B,群益優選非投等債,34,0,34,富邦-嘉義,2024-10-21,9692
2002,中鋼,36,2,34,富邦-嘉義,2024-10-21,9692
4716,大立,2132,936,1196,富邦-嘉義,2024-10-22,9692
00679B,元大美債20年,538,33,505,富邦-嘉義,2024-10-22,9692
3189,景碩,1153,671,482,富邦-嘉義,2024-10-22,9692
00687B,國泰20年美債,385,63,322,富邦-嘉義,2024-10-22,9692
00937B,群益ESG投等債20,488,171,317,富邦-嘉義,2024-10-22,9692
6197,佳必琪,640,345,295,富邦-嘉義,2024-10-22,9692
00948B,中信優息投資級債,252,0,252,富邦-嘉義,2024-10-22,9692
3013,晟銘電,293,52,241,富邦-嘉義,2024-10-22,9692
1735,日勝化,234,2,232,富邦-嘉義,2024-10-22,9692
2329,華泰,264,46,218,富邦-嘉義,2024-10-22,9692
2449,京元電子,782,629,153,富邦-嘉義,2024-10-22,9692
2543,皇昌,206,58,148,富邦-嘉義,2024-10-22,9692
6405,悅城,511,370,141,富邦-嘉義,2024-10-22,9692
00688L,國泰20年美債正2,154,13,141,富邦-嘉義,2024-10-22,9692
00945B,凱基美國非投等債,122,0,122,富邦-嘉義,2024-10-22,9692
2888,新光金,256,147,109,富邦-嘉義,2024-10-22,9692
00712,復華富時不動產,111,13,98,富邦-嘉義,2024-10-22,9692
2399,映泰,1057,966,91,富邦-嘉義,2024-10-22,9692
6290,良維,91,1,90,富邦-嘉義,2024-10-22,9692
4414,如興,90,0,90,富邦-嘉義,2024-10-22,9692
00919,群益台灣精選高息,103,18,85,富邦-嘉義,2024-10-22,9692
1528,恩德,126,41,85,富邦-嘉義,2024-10-22,9692
4729,熒茂,127,44,83,富邦-嘉義,2024-10-22,9692
00927,群益半導體收益,73,2,71,富邦-嘉義,2024-10-22,9692
00795B,中信美國公債20年,70,0,70,富邦-嘉義,2024-10-22,9692
6658,聯策,198,128,70,富邦-嘉義,2024-10-22,9692
2332,友訊,51,1,50,富邦-嘉義,2024-10-22,9692
2313,華通,91,44,47,富邦-嘉義,2024-10-22,9692
3031,佰鴻,46,0,46,富邦-嘉義,2024-10-22,9692
00676R,富邦臺灣加權反1,45,5,40,富邦-嘉義,2024-10-22,9692
2303,聯電,51,12,39,富邦-嘉義,2024-10-22,9692
1314,中石化,69,31,38,富邦-嘉義,2024-10-22,9692
4533,協易機,57,20,37,富邦-嘉義,2024-10-22,9692
4956,光鋐,76,40,36,富邦-嘉義,2024-10-22,9692
2369,菱生,66,31,35,富邦-嘉義,2024-10-22,9692
2887,台新金,35,1,34,富邦-嘉義,2024-10-22,9692
8064,東捷,122,89,33,富邦-嘉義,2024-10-22,9692
2374,佳能,33,1,32,富邦-嘉義,2024-10-22,9692
00725B,國泰投資級公司債,32,0,32,富邦-嘉義,2024-10-22,9692
6742,澤米,105,76,29,富邦-嘉義,2024-10-22,9692
2356,英業達,32,3,29,富邦-嘉義,2024-10-22,9692
00878,國泰永續高股息,43,16,27,富邦-嘉義,2024-10-22,9692
2426,鼎元,33,6,27,富邦-嘉義,2024-10-22,9692
6127,九豪,47,20,27,富邦-嘉義,2024-10-22,9692
5315,光聯,136,109,27,富邦-嘉義,2024-10-22,9692
00929,復華台灣科技優息,115,88,27,富邦-嘉義,2024-10-22,9692
2884,玉山金,28,3,25,富邦-嘉義,2024-10-22,9692
4562,穎漢,55,30,25,富邦-嘉義,2024-10-22,9692
00905,FT臺灣Smart,24,0,24,富邦-嘉義,2024-10-22,9692
00680L,元大美債20正2,70,46,24,富邦-嘉義,2024-10-22,9692
00679B,元大美債20年,2527,0,2527,富邦-嘉義,2024-10-23,9692
3167,大量,766,286,480,富邦-嘉義,2024-10-23,9692
1721,三晃,615,197,418,富邦-嘉義,2024-10-23,9692
6156,松上,371,63,308,富邦-嘉義,2024-10-23,9692
3481,群創,437,184,253,富邦-嘉義,2024-10-23,9692
6104,創惟,700,452,248,富邦-嘉義,2024-10-23,9692
3450,聯鈞,1087,876,211,富邦-嘉義,2024-10-23,9692
00937B,群益ESG投等債20,180,1,179,富邦-嘉義,2024-10-23,9692
00637L,元大滬深300正2,179,16,163,富邦-嘉義,2024-10-23,9692
00882,中信中國高股息,165,4,161,富邦-嘉義,2024-10-23,9692
2884,玉山金,167,6,161,富邦-嘉義,2024-10-23,9692
4545,銘鈺,286,138,148,富邦-嘉義,2024-10-23,9692
3581,博磊,213,67,146,富邦-嘉義,2024-10-23,9692
3580,友威科,157,18,139,富邦-嘉義,2024-10-23,9692
4903,聯光通,157,33,124,富邦-嘉義,2024-10-23,9692
3049,精金,113,1,112,富邦-嘉義,2024-10-23,9692
00878,國泰永續高股息,125,23,102,富邦-嘉義,2024-10-23,9692
3551,世禾,235,144,91,富邦-嘉義,2024-10-23,9692
4303,信立,91,10,81,富邦-嘉義,2024-10-23,9692
00948B,中信優息投資級債,68,0,68,富邦-嘉義,2024-10-23,9692
2601,益航,71,3,68,富邦-嘉義,2024-10-23,9692
00887,永豐中國科技50大,69,7,62,富邦-嘉義,2024-10-23,9692
0056,元大高股息,79,19,60,富邦-嘉義,2024-10-23,9692
5202,力新,91,31,60,富邦-嘉義,2024-10-23,9692
00712,復華富時不動產,61,2,59,富邦-嘉義,2024-10-23,9692
00919,群益台灣精選高息,62,4,58,富邦-嘉義,2024-10-23,9692
2845,遠東銀,51,0,51,富邦-嘉義,2024-10-23,9692
2834,臺企銀,49,0,49,富邦-嘉義,2024-10-23,9692
5425,台半,98,49,49,富邦-嘉義,2024-10-23,9692
2316,楠梓電,52,4,48,富邦-嘉義,2024-10-23,9692
3037,欣興,100,52,48,富邦-嘉義,2024-10-23,9692
1303,南亞,49,1,48,富邦-嘉義,2024-10-23,9692
2303,聯電,63,18,45,富邦-嘉義,2024-10-23,9692
6442,光聖,121,76,45,富邦-嘉義,2024-10-23,9692
6218,豪勉,165,122,43,富邦-嘉義,2024-10-23,9692
00857B,永豐20年美公債,43,0,43,富邦-嘉義,2024-10-23,9692
00726B,國泰新興投等債,40,0,40,富邦-嘉義,2024-10-23,9692
00943,兆豐電子高息等權,40,0,40,富邦-嘉義,2024-10-23,9692
6667,信紘科,42,4,38,富邦-嘉義,2024-10-23,9692
3290,東浦,617,581,36,富邦-嘉義,2024-10-23,9692
6770,力積電,41,5,36,富邦-嘉義,2024-10-23,9692
2431,聯昌,821,787,34,富邦-嘉義,2024-10-23,9692
9105,泰金寶-DR,34,0,34,富邦-嘉義,2024-10-23,9692
3031,佰鴻,41,8,33,富邦-嘉義,2024-10-23,9692
6213,聯茂,64,31,33,富邦-嘉義,2024-10-23,9692
2888,新光金,69,37,32,富邦-嘉義,2024-10-23,9692
00680L,元大美債20正2,72,40,32,富邦-嘉義,2024-10-23,9692
00938,凱基優選30,32,0,32,富邦-嘉義,2024-10-23,9692
00650L,復華香港正2,36,4,32,富邦-嘉義,2024-10-23,9692
4542,科嶠,62,32,30,富邦-嘉義,2024-10-23,9692
3029,零壹,899,311,588,富邦-嘉義,2024-10-24,9692
6609,瀧澤科,728,179,549,富邦-嘉義,2024-10-24,9692
5202,力新,478,111,367,富邦-嘉義,2024-10-24,9692
8249,菱光,335,40,295,富邦-嘉義,2024-10-24,9692
3481,群創,269,142,127,富邦-嘉義,2024-10-24,9692
00929,復華台灣科技優息,169,42,127,富邦-嘉義,2024-10-24,9692
0056,元大高股息,139,21,118,富邦-嘉義,2024-10-24,9692
2405,輔信,334,226,108,富邦-嘉義,2024-10-24,9692
00753L,中信中國50正2,101,3,98,富邦-嘉義,2024-10-24,9692
00919,群益台灣精選高息,117,20,97,富邦-嘉義,2024-10-24,9692
4527,方土霖,114,25,89,富邦-嘉義,2024-10-24,9692
00878,國泰永續高股息,98,12,86,富邦-嘉義,2024-10-24,9692
1595,川寶,170,88,82,富邦-嘉義,2024-10-24,9692
00937B,群益ESG投等債20,108,26,82,富邦-嘉義,2024-10-24,9692
3049,精金,79,3,76,富邦-嘉義,2024-10-24,9692
00922,國泰台灣領袖50,78,3,75,富邦-嘉義,2024-10-24,9692
2883,凱基金,65,3,62,富邦-嘉義,2024-10-24,9692
2303,聯電,63,4,59,富邦-嘉義,2024-10-24,9692
00887,永豐中國科技50大,60,2,58,富邦-嘉義,2024-10-24,9692
8032,光菱,119,62,57,富邦-嘉義,2024-10-24,9692
2317,鴻海,776,720,56,富邦-嘉義,2024-10-24,9692
00665L,富邦�琤肭磪囓�2,81,26,55,富邦-嘉義,2024-10-24,9692
2891,中信金,63,8,55,富邦-嘉義,2024-10-24,9692
2892,第一金,54,0,54,富邦-嘉義,2024-10-24,9692
1528,恩德,291,239,52,富邦-嘉義,2024-10-24,9692
00712,復華富時不動產,51,0,51,富邦-嘉義,2024-10-24,9692
2323,中環,50,0,50,富邦-嘉義,2024-10-24,9692
00943,兆豐電子高息等權,45,0,45,富邦-嘉義,2024-10-24,9692
1524,耿鼎,71,29,42,富邦-嘉義,2024-10-24,9692
3011,今皓,47,10,37,富邦-嘉義,2024-10-24,9692
00960,野村全球航運龍頭,47,14,33,富邦-嘉義,2024-10-24,9692
1591,駿吉-KY,31,0,31,富邦-嘉義,2024-10-24,9692
2884,玉山金,39,8,31,富邦-嘉義,2024-10-24,9692
2388,威盛,50,22,28,富邦-嘉義,2024-10-24,9692
2489,瑞軒,43,15,28,富邦-嘉義,2024-10-24,9692
00680L,元大美債20正2,31,3,28,富邦-嘉義,2024-10-24,9692
2344,華邦電,35,8,27,富邦-嘉義,2024-10-24,9692
6667,信紘科,30,3,27,富邦-嘉義,2024-10-24,9692
2382,廣達,81,55,26,富邦-嘉義,2024-10-24,9692
4533,協易機,46,20,26,富邦-嘉義,2024-10-24,9692
3037,欣興,50,24,26,富邦-嘉義,2024-10-24,9692
5515,建國,25,0,25,富邦-嘉義,2024-10-24,9692
2880,華南金,25,1,24,富邦-嘉義,2024-10-24,9692
00946,群益科技高息成長,24,0,24,富邦-嘉義,2024-10-24,9692
8431,匯鑽科,45,21,24,富邦-嘉義,2024-10-24,9692
00918,大華優利高填息30,29,6,23,富邦-嘉義,2024-10-24,9692
1229,聯華,23,0,23,富邦-嘉義,2024-10-24,9692
6158,禾昌,26,3,23,富邦-嘉義,2024-10-24,9692
3663,鑫科,210,188,22,富邦-嘉義,2024-10-24,9692
3689,湧德,49,27,22,富邦-嘉義,2024-10-24,9692
00937B,群益ESG投等債20,1962,21,1941,富邦-嘉義,2024-10-25,9692
2354,鴻準,1557,105,1452,富邦-嘉義,2024-10-25,9692
6530,創威,843,306,537,富邦-嘉義,2024-10-25,9692
2431,聯昌,504,33,471,富邦-嘉義,2024-10-25,9692
00959B,大華投等美債15Y+,327,0,327,富邦-嘉義,2024-10-25,9692
6288,聯嘉,270,46,224,富邦-嘉義,2024-10-25,9692
00715L,期街口布蘭特正2,219,15,204,富邦-嘉義,2024-10-25,9692
6235,華孚,186,30,156,富邦-嘉義,2024-10-25,9692
2312,金寶,176,76,100,富邦-嘉義,2024-10-25,9692
2454,聯發科,101,4,97,富邦-嘉義,2024-10-25,9692
1307,三芳,151,62,89,富邦-嘉義,2024-10-25,9692
2399,映泰,102,16,86,富邦-嘉義,2024-10-25,9692
2439,美律,86,3,83,富邦-嘉義,2024-10-25,9692
6197,佳必琪,386,309,77,富邦-嘉義,2024-10-25,9692
00680L,元大美債20正2,81,5,76,富邦-嘉義,2024-10-25,9692
5386,青雲,161,88,73,富邦-嘉義,2024-10-25,9692
2302,麗正,376,304,72,富邦-嘉義,2024-10-25,9692
00887,永豐中國科技50大,85,13,72,富邦-嘉義,2024-10-25,9692
6151,晉倫,111,44,67,富邦-嘉義,2024-10-25,9692
4576,大銀微系統,76,11,65,富邦-嘉義,2024-10-25,9692
2344,華邦電,61,0,61,富邦-嘉義,2024-10-25,9692
2317,鴻海,182,122,60,富邦-嘉義,2024-10-25,9692
2477,美隆電,246,186,60,富邦-嘉義,2024-10-25,9692
00753L,中信中國50正2,79,20,59,富邦-嘉義,2024-10-25,9692
2374,佳能,96,37,59,富邦-嘉義,2024-10-25,9692
8932,智通*,52,0,52,富邦-嘉義,2024-10-25,9692
2337,旺宏,52,0,52,富邦-嘉義,2024-10-25,9692
2303,聯電,60,13,47,富邦-嘉義,2024-10-25,9692
00919,群益台灣精選高息,50,5,45,富邦-嘉義,2024-10-25,9692
1524,耿鼎,96,55,41,富邦-嘉義,2024-10-25,9692
00720B,元大投資級公司債,48,7,41,富邦-嘉義,2024-10-25,9692
00687B,國泰20年美債,44,4,40,富邦-嘉義,2024-10-25,9692
2845,遠東銀,36,3,33,富邦-嘉義,2024-10-25,9692
2867,三商壽,32,0,32,富邦-嘉義,2024-10-25,9692
2884,玉山金,31,1,30,富邦-嘉義,2024-10-25,9692
2392,正崴,38,10,28,富邦-嘉義,2024-10-25,9692
6770,力積電,43,15,28,富邦-嘉義,2024-10-25,9692
8043,蜜望實,151,124,27,富邦-嘉義,2024-10-25,9692
00918,大華優利高填息30,30,5,25,富邦-嘉義,2024-10-25,9692
00664R,國泰臺灣加權反1,24,0,24,富邦-嘉義,2024-10-25,9692
4510,高鋒,57,34,23,富邦-嘉義,2024-10-25,9692
6285,啟��,53,31,22,富邦-嘉義,2024-10-25,9692
2515,中工,21,0,21,富邦-嘉義,2024-10-25,9692
00665L,富邦�琤肭磪囓�2,27,6,21,富邦-嘉義,2024-10-25,9692
3609,三一東林,20,0,20,富邦-嘉義,2024-10-25,9692
2489,瑞軒,29,9,20,富邦-嘉義,2024-10-25,9692
8044,網家,20,0,20,富邦-嘉義,2024-10-25,9692
2889,國票金,20,0,20,富邦-嘉義,2024-10-25,9692
00929,復華台灣科技優息,39,20,19,富邦-嘉義,2024-10-25,9692
3021,鴻名,21,3,18,富邦-嘉義,2024-10-25,9692
2354,鴻準,1365,856,509,富邦-嘉義,2024-10-28,9692
00715L,期街口布蘭特正2,402,7,395,富邦-嘉義,2024-10-28,9692
8249,菱光,757,523,234,富邦-嘉義,2024-10-28,9692
1449,佳和,596,425,171,富邦-嘉義,2024-10-28,9692
00680L,元大美債20正2,184,23,161,富邦-嘉義,2024-10-28,9692
2883,凱基金,194,51,143,富邦-嘉義,2024-10-28,9692
5488,松普,863,720,143,富邦-嘉義,2024-10-28,9692
2413,環科,160,20,140,富邦-嘉義,2024-10-28,9692
1528,恩德,163,56,107,富邦-嘉義,2024-10-28,9692
2303,聯電,110,6,104,富邦-嘉義,2024-10-28,9692
00753L,中信中國50正2,90,1,89,富邦-嘉義,2024-10-28,9692
00687B,國泰20年美債,151,65,86,富邦-嘉義,2024-10-28,9692
00679B,元大美債20年,111,28,83,富邦-嘉義,2024-10-28,9692
3051,力特,84,1,83,富邦-嘉義,2024-10-28,9692
00772B,中信高評級公司債,70,0,70,富邦-嘉義,2024-10-28,9692
3481,群創,138,68,70,富邦-嘉義,2024-10-28,9692
00937B,群益ESG投等債20,123,62,61,富邦-嘉義,2024-10-28,9692
00676R,富邦臺灣加權反1,60,0,60,富邦-嘉義,2024-10-28,9692
9105,泰金寶-DR,56,1,55,富邦-嘉義,2024-10-28,9692
2888,新光金,64,11,53,富邦-嘉義,2024-10-28,9692
2601,益航,51,0,51,富邦-嘉義,2024-10-28,9692
1802,台玻,903,858,45,富邦-嘉義,2024-10-28,9692
4576,大銀微系統,146,106,40,富邦-嘉義,2024-10-28,9692
8044,網家,40,2,38,富邦-嘉義,2024-10-28,9692
00712,復華富時不動產,52,15,37,富邦-嘉義,2024-10-28,9692
6492,生華科,69,35,34,富邦-嘉義,2024-10-28,9692
3615,安可,48,14,34,富邦-嘉義,2024-10-28,9692
6791,虎門科技,46,12,34,富邦-嘉義,2024-10-28,9692
3552,同致,172,138,34,富邦-嘉義,2024-10-28,9692
00922,國泰台灣領袖50,40,8,32,富邦-嘉義,2024-10-28,9692
2369,菱生,34,2,32,富邦-嘉義,2024-10-28,9692
3231,緯創,73,42,31,富邦-嘉義,2024-10-28,9692
00943,兆豐電子高息等權,30,0,30,富邦-嘉義,2024-10-28,9692
0056,元大高股息,60,30,30,富邦-嘉義,2024-10-28,9692
5210,寶碩,30,0,30,富邦-嘉義,2024-10-28,9692
1524,耿鼎,33,3,30,富邦-嘉義,2024-10-28,9692
8932,智通*,30,1,29,富邦-嘉義,2024-10-28,9692
2892,第一金,32,4,28,富邦-嘉義,2024-10-28,9692
5498,凱崴,26,0,26,富邦-嘉義,2024-10-28,9692
2605,新興,26,0,26,富邦-嘉義,2024-10-28,9692
3360,尚立,29,4,25,富邦-嘉義,2024-10-28,9692
00948B,中信優息投資級債,24,0,24,富邦-嘉義,2024-10-28,9692
00915,凱基優選高股息30,40,16,24,富邦-嘉義,2024-10-28,9692
4533,協易機,44,20,24,富邦-嘉義,2024-10-28,9692
8054,安國,23,0,23,富邦-嘉義,2024-10-28,9692
00725B,國泰投資級公司債,22,0,22,富邦-嘉義,2024-10-28,9692
4569,六方科-KY,77,55,22,富邦-嘉義,2024-10-28,9692
8021,尖點,40,18,22,富邦-嘉義,2024-10-28,9692
2439,美律,27,5,22,富邦-嘉義,2024-10-28,9692
1229,聯華,21,0,21,富邦-嘉義,2024-10-28,9692
3450,聯鈞,430,25,405,富邦-嘉義,2024-10-29,9692
3167,大量,919,525,394,富邦-嘉義,2024-10-29,9692
1528,恩德,751,427,324,富邦-嘉義,2024-10-29,9692
2477,美隆電,332,27,305,富邦-嘉義,2024-10-29,9692
00919,群益台灣精選高息,329,65,264,富邦-嘉義,2024-10-29,9692
2888,新光金,268,11,257,富邦-嘉義,2024-10-29,9692
2303,聯電,262,20,242,富邦-嘉義,2024-10-29,9692
00929,復華台灣科技優息,251,53,198,富邦-嘉義,2024-10-29,9692
00706L,期元大S＆P日圓正2,160,1,159,富邦-嘉義,2024-10-29,9692
00878,國泰永續高股息,180,28,152,富邦-嘉義,2024-10-29,9692
00715L,期街口布蘭特正2,181,30,151,富邦-嘉義,2024-10-29,9692
00940,元大台灣價值高息,167,32,135,富邦-嘉義,2024-10-29,9692
00665L,富邦�琤肭磪囓�2,139,29,110,富邦-嘉義,2024-10-29,9692
00959B,大華投等美債15Y+,106,0,106,富邦-嘉義,2024-10-29,9692
0056,元大高股息,153,55,98,富邦-嘉義,2024-10-29,9692
3687,歐買尬,119,27,92,富邦-嘉義,2024-10-29,9692
8044,網家,165,81,84,富邦-嘉義,2024-10-29,9692
2543,皇昌,109,31,78,富邦-嘉義,2024-10-29,9692
2642,宅配通,218,149,69,富邦-嘉義,2024-10-29,9692
4533,協易機,64,0,64,富邦-嘉義,2024-10-29,9692
2646,星宇航空,105,41,64,富邦-嘉義,2024-10-29,9692
2883,凱基金,72,12,60,富邦-嘉義,2024-10-29,9692
00946,群益科技高息成長,60,0,60,富邦-嘉義,2024-10-29,9692
1101,台泥,59,1,58,富邦-嘉義,2024-10-29,9692
5202,力新,245,191,54,富邦-嘉義,2024-10-29,9692
3551,世禾,93,40,53,富邦-嘉義,2024-10-29,9692
006208,富邦台50,55,2,53,富邦-嘉義,2024-10-29,9692
00934,中信成長高股息,51,0,51,富邦-嘉義,2024-10-29,9692
00676R,富邦臺灣加權反1,50,2,48,富邦-嘉義,2024-10-29,9692
00918,大華優利高填息30,55,10,45,富邦-嘉義,2024-10-29,9692
2495,普安,188,145,43,富邦-嘉義,2024-10-29,9692
00943,兆豐電子高息等權,43,0,43,富邦-嘉義,2024-10-29,9692
4919,新唐,329,287,42,富邦-嘉義,2024-10-29,9692
6142,友勁,52,12,40,富邦-嘉義,2024-10-29,9692
2892,第一金,39,1,38,富邦-嘉義,2024-10-29,9692
6151,晉倫,92,56,36,富邦-嘉義,2024-10-29,9692
8176,智捷,43,8,35,富邦-嘉義,2024-10-29,9692
2317,鴻海,310,276,34,富邦-嘉義,2024-10-29,9692
1301,台塑,36,1,35,富邦-嘉義,2024-10-29,9692
8032,光菱,260,226,34,富邦-嘉義,2024-10-29,9692
6838,台新藥,32,0,32,富邦-嘉義,2024-10-29,9692
00935,野村臺灣新科技50,34,3,31,富邦-嘉義,2024-10-29,9692
00712,復華富時不動產,30,0,30,富邦-嘉義,2024-10-29,9692
3189,景碩,61,31,30,富邦-嘉義,2024-10-29,9692
3715,定穎投控,34,5,29,富邦-嘉義,2024-10-29,9692
00948B,中信優息投資級債,29,1,28,富邦-嘉義,2024-10-29,9692
2884,玉山金,34,7,27,富邦-嘉義,2024-10-29,9692
3049,精金,32,5,27,富邦-嘉義,2024-10-29,9692
2401,凌陽,29,2,27,富邦-嘉義,2024-10-29,9692
00922,國泰台灣領袖50,40,15,25,富邦-嘉義,2024-10-29,9692
2354,鴻準,2499,1752,747,富邦-嘉義,2024-10-30,9692
00929,復華台灣科技優息,167,27,140,富邦-嘉義,2024-10-30,9692
6216,居易,461,326,135,富邦-嘉義,2024-10-30,9692
00922,國泰台灣領袖50,114,0,114,富邦-嘉義,2024-10-30,9692
5438,東友,134,28,106,富邦-嘉義,2024-10-30,9692
2888,新光金,109,9,100,富邦-嘉義,2024-10-30,9692
00715L,期街口布蘭特正2,97,0,97,富邦-嘉義,2024-10-30,9692
1101,台泥,85,1,84,富邦-嘉義,2024-10-30,9692
1307,三芳,150,76,74,富邦-嘉義,2024-10-30,9692
2302,麗正,73,1,72,富邦-嘉義,2024-10-30,9692
6142,友勁,73,4,69,富邦-嘉義,2024-10-30,9692
00919,群益台灣精選高息,100,35,65,富邦-嘉義,2024-10-30,9692
0056,元大高股息,79,17,62,富邦-嘉義,2024-10-30,9692
00882,中信中國高股息,78,16,62,富邦-嘉義,2024-10-30,9692
00948B,中信優息投資級債,68,7,61,富邦-嘉義,2024-10-30,9692
5202,力新,96,41,55,富邦-嘉義,2024-10-30,9692
00650L,復華香港正2,59,5,54,富邦-嘉義,2024-10-30,9692
2352,佳世達,52,0,52,富邦-嘉義,2024-10-30,9692
2303,聯電,57,6,51,富邦-嘉義,2024-10-30,9692
6191,精成科,54,6,48,富邦-嘉義,2024-10-30,9692
3481,群創,216,170,46,富邦-嘉義,2024-10-30,9692
4414,如興,40,0,40,富邦-嘉義,2024-10-30,9692
2887,台新金,36,0,36,富邦-嘉義,2024-10-30,9692
8176,智捷,38,4,34,富邦-嘉義,2024-10-30,9692
2867,三商壽,34,1,33,富邦-嘉義,2024-10-30,9692
2884,玉山金,30,0,30,富邦-嘉義,2024-10-30,9692
00633L,富邦上証正2,28,0,28,富邦-嘉義,2024-10-30,9692
00940,元大台灣價值高息,44,16,28,富邦-嘉義,2024-10-30,9692
00937B,群益ESG投等債20,40,13,27,富邦-嘉義,2024-10-30,9692
6134,萬旭,43,16,27,富邦-嘉義,2024-10-30,9692
00946,群益科技高息成長,36,10,26,富邦-嘉義,2024-10-30,9692
2328,廣宇,89,64,25,富邦-嘉義,2024-10-30,9692
2337,旺宏,38,13,25,富邦-嘉義,2024-10-30,9692
4533,協易機,25,0,25,富邦-嘉義,2024-10-30,9692
3037,欣興,56,32,24,富邦-嘉義,2024-10-30,9692
00938,凱基優選30,25,2,23,富邦-嘉義,2024-10-30,9692
00679B,元大美債20年,50,27,23,富邦-嘉義,2024-10-30,9692
00878,國泰永續高股息,41,19,22,富邦-嘉義,2024-10-30,9692
8431,匯鑽科,21,0,21,富邦-嘉義,2024-10-30,9692
8426,紅木-KY,21,0,21,富邦-嘉義,2024-10-30,9692
3062,建漢,103,83,20,富邦-嘉義,2024-10-30,9692
006208,富邦台50,25,5,20,富邦-嘉義,2024-10-30,9692
2489,瑞軒,24,4,20,富邦-嘉義,2024-10-30,9692
4991,環宇-KY,62,42,20,富邦-嘉義,2024-10-30,9692
8021,尖點,52,32,20,富邦-嘉義,2024-10-30,9692
00725B,國泰投資級公司債,20,0,20,富邦-嘉義,2024-10-30,9692
00676R,富邦臺灣加權反1,20,0,20,富邦-嘉義,2024-10-30,9692
6257,矽格,22,2,20,富邦-嘉義,2024-10-30,9692
2327,國巨,20,0,20,富邦-嘉義,2024-10-30,9692
00947,台新臺灣IC設計,20,1,19,富邦-嘉義,2024-10-30,9692
2354,鴻準,2808,1288,1520,富邦-嘉義,2024-11-01,9692
2609,陽明,1689,1143,546,富邦-嘉義,2024-11-01,9692
2431,聯昌,1389,1005,384,富邦-嘉義,2024-11-01,9692
2543,皇昌,409,48,361,富邦-嘉義,2024-11-01,9692
1595,川寶,447,124,323,富邦-嘉義,2024-11-01,9692
6133,金橋,335,108,227,富邦-嘉義,2024-11-01,9692
2413,環科,312,91,221,富邦-嘉義,2024-11-01,9692
2883,凱基金,206,0,206,富邦-嘉義,2024-11-01,9692
00929,復華台灣科技優息,234,84,150,富邦-嘉義,2024-11-01,9692
2615,萬海,755,627,128,富邦-嘉義,2024-11-01,9692
2603,長榮,226,104,122,富邦-嘉義,2024-11-01,9692
2303,聯電,138,17,121,富邦-嘉義,2024-11-01,9692
00919,群益台灣精選高息,131,12,119,富邦-嘉義,2024-11-01,9692
2888,新光金,128,27,101,富邦-嘉義,2024-11-01,9692
4991,環宇-KY,242,143,99,富邦-嘉義,2024-11-01,9692
00878,國泰永續高股息,109,19,90,富邦-嘉義,2024-11-01,9692
00915,凱基優選高股息30,87,4,83,富邦-嘉義,2024-11-01,9692
4903,聯光通,188,110,78,富邦-嘉義,2024-11-01,9692
2646,星宇航空,98,25,73,富邦-嘉義,2024-11-01,9692
2337,旺宏,74,1,73,富邦-嘉義,2024-11-01,9692
2317,鴻海,796,726,70,富邦-嘉義,2024-11-01,9692
00937B,群益ESG投等債20,79,11,68,富邦-嘉義,2024-11-01,9692
00712,復華富時不動產,69,3,66,富邦-嘉義,2024-11-01,9692
2881,富邦金,71,8,63,富邦-嘉義,2024-11-01,9692
2867,三商壽,61,0,61,富邦-嘉義,2024-11-01,9692
3447,展達,77,16,61,富邦-嘉義,2024-11-01,9692
3701,大眾控,62,7,55,富邦-嘉義,2024-11-01,9692
00795B,中信美國公債20年,54,0,54,富邦-嘉義,2024-11-01,9692
2891,中信金,58,13,45,富邦-嘉義,2024-11-01,9692
8176,智捷,43,0,43,富邦-嘉義,2024-11-01,9692
5880,合庫金,42,1,41,富邦-嘉義,2024-11-01,9692
1310,台苯,41,0,41,富邦-嘉義,2024-11-01,9692
8032,光菱,176,137,39,富邦-嘉義,2024-11-01,9692
3167,大量,585,549,36,富邦-嘉義,2024-11-01,9692
6151,晉倫,65,30,35,富邦-嘉義,2024-11-01,9692
00713,元大台灣高息低波,37,3,34,富邦-嘉義,2024-11-01,9692
5460,同協,161,128,33,富邦-嘉義,2024-11-01,9692
2353,宏��,35,2,33,富邦-嘉義,2024-11-01,9692
2884,玉山金,32,2,30,富邦-嘉義,2024-11-01,9692
2887,台新金,31,0,31,富邦-嘉義,2024-11-01,9692
8240,華宏,30,0,30,富邦-嘉義,2024-11-01,9692
00752,中信中國50,30,1,29,富邦-嘉義,2024-11-01,9692
6191,精成科,41,12,29,富邦-嘉義,2024-11-01,9692
00673R,期元大S＆P原油反1,28,0,28,富邦-嘉義,2024-11-01,9692
00948B,中信優息投資級債,37,10,27,富邦-嘉義,2024-11-01,9692
1785,光洋科,41,14,27,富邦-嘉義,2024-11-01,9692
6257,矽格,32,5,27,富邦-嘉義,2024-11-01,9692
2312,金寶,33,6,27,富邦-嘉義,2024-11-01,9692
00945B,凱基美國非投等債,29,3,26,富邦-嘉義,2024-11-01,9692
2880,華南金,26,0,26,富邦-嘉義,2024-11-01,9692
00937B,群益ESG投等債20,1493,10,1483,富邦-嘉義,2024-11-04,9692
3049,精金,4422,3629,793,富邦-嘉義,2024-11-04,9692
2867,三商壽,307,4,303,富邦-嘉義,2024-11-04,9692
4977,眾達-KY,512,216,296,富邦-嘉義,2024-11-04,9692
00878,國泰永續高股息,239,11,228,富邦-嘉義,2024-11-04,9692
5460,同協,247,58,189,富邦-嘉義,2024-11-04,9692
00948B,中信優息投資級債,182,0,182,富邦-嘉義,2024-11-04,9692
3013,晟銘電,411,252,159,富邦-嘉義,2024-11-04,9692
6442,光聖,166,17,149,富邦-嘉義,2024-11-04,9692
00919,群益台灣精選高息,164,47,117,富邦-嘉義,2024-11-04,9692
00918,大華優利高填息30,135,26,109,富邦-嘉義,2024-11-04,9692
3481,群創,114,7,107,富邦-嘉義,2024-11-04,9692
00687B,國泰20年美債,113,9,104,富邦-嘉義,2024-11-04,9692
3062,建漢,202,114,88,富邦-嘉義,2024-11-04,9692
00945B,凱基美國非投等債,80,1,79,富邦-嘉義,2024-11-04,9692
00632R,元大台灣50反1,82,4,78,富邦-嘉義,2024-11-04,9692
00943,兆豐電子高息等權,78,0,78,富邦-嘉義,2024-11-04,9692
00715L,期街口布蘭特正2,207,132,75,富邦-嘉義,2024-11-04,9692
3490,單井,85,23,62,富邦-嘉義,2024-11-04,9692
00712,復華富時不動產,103,41,62,富邦-嘉義,2024-11-04,9692
5452,佶優,63,2,61,富邦-嘉義,2024-11-04,9692
2303,聯電,70,11,59,富邦-嘉義,2024-11-04,9692
00952,凱基台灣AI50,58,0,58,富邦-嘉義,2024-11-04,9692
00905,FT臺灣Smart,67,10,57,富邦-嘉義,2024-11-04,9692
2354,鴻準,945,893,52,富邦-嘉義,2024-11-04,9692
1449,佳和,94,43,51,富邦-嘉義,2024-11-04,9692
2883,凱基金,57,6,51,富邦-嘉義,2024-11-04,9692
00719B,元大美債1-3,50,0,50,富邦-嘉義,2024-11-04,9692
2511,太子,50,0,50,富邦-嘉義,2024-11-04,9692
2337,旺宏,49,0,49,富邦-嘉義,2024-11-04,9692
5426,振發,165,116,49,富邦-嘉義,2024-11-04,9692
6530,創威,169,121,48,富邦-嘉義,2024-11-04,9692
00882,中信中國高股息,47,0,47,富邦-嘉義,2024-11-04,9692
2504,國產,49,2,47,富邦-嘉義,2024-11-04,9692
00679B,元大美債20年,58,13,45,富邦-嘉義,2024-11-04,9692
00915,凱基優選高股息30,66,22,44,富邦-嘉義,2024-11-04,9692
00753L,中信中國50正2,40,0,40,富邦-嘉義,2024-11-04,9692
1310,台苯,40,0,40,富邦-嘉義,2024-11-04,9692
1808,潤隆,46,7,39,富邦-嘉義,2024-11-04,9692
00930,永豐ESG低碳高息,37,0,37,富邦-嘉義,2024-11-04,9692
00713,元大台灣高息低波,50,13,37,富邦-嘉義,2024-11-04,9692
00795B,中信美國公債20年,45,10,35,富邦-嘉義,2024-11-04,9692
1584,精剛,35,0,35,富邦-嘉義,2024-11-04,9692
1722,台肥,35,0,35,富邦-嘉義,2024-11-04,9692
2328,廣宇,101,66,35,富邦-嘉義,2024-11-04,9692
8064,東捷,55,21,34,富邦-嘉義,2024-11-04,9692
5315,光聯,77,43,34,富邦-嘉義,2024-11-04,9692
9939,宏全,33,0,33,富邦-嘉義,2024-11-04,9692
8044,網家,87,55,32,富邦-嘉義,2024-11-04,9692
00932,兆豐永續高息等權,33,2,31,富邦-嘉義,2024-11-04,9692
2356,英業達,2146,736,1410,富邦-嘉義,2024-11-05,9692
2431,聯昌,1057,702,355,富邦-嘉義,2024-11-05,9692
00919,群益台灣精選高息,275,32,243,富邦-嘉義,2024-11-05,9692
3167,大量,668,456,212,富邦-嘉義,2024-11-05,9692
4729,熒茂,598,420,178,富邦-嘉義,2024-11-05,9692
2439,美律,162,6,156,富邦-嘉義,2024-11-05,9692
6405,悅城,1830,1679,151,富邦-嘉義,2024-11-05,9692
8374,羅昇,213,82,131,富邦-嘉義,2024-11-05,9692
00712,復華富時不動產,109,1,108,富邦-嘉義,2024-11-05,9692
4526,東台,137,46,91,富邦-嘉義,2024-11-05,9692
00878,國泰永續高股息,110,22,88,富邦-嘉義,2024-11-05,9692
2303,聯電,159,72,87,富邦-嘉義,2024-11-05,9692
8249,菱光,361,278,83,富邦-嘉義,2024-11-05,9692
3481,群創,108,33,75,富邦-嘉義,2024-11-05,9692
2646,星宇航空,88,19,69,富邦-嘉義,2024-11-05,9692
00932,兆豐永續高息等權,68,0,68,富邦-嘉義,2024-11-05,9692
2419,仲琦,89,28,61,富邦-嘉義,2024-11-05,9692
00632R,元大台灣50反1,103,43,60,富邦-嘉義,2024-11-05,9692
2888,新光金,56,0,56,富邦-嘉義,2024-11-05,9692
4576,大銀微系統,136,82,54,富邦-嘉義,2024-11-05,9692
8261,富鼎,163,111,52,富邦-嘉義,2024-11-05,9692
00882,中信中國高股息,81,34,47,富邦-嘉義,2024-11-05,9692
2354,鴻準,1542,1496,46,富邦-嘉義,2024-11-05,9692
00960,野村全球航運龍頭,43,0,43,富邦-嘉義,2024-11-05,9692
2408,南亞科,54,12,42,富邦-嘉義,2024-11-05,9692
00948B,中信優息投資級債,41,3,38,富邦-嘉義,2024-11-05,9692
00891,中信關鍵半導體,37,2,35,富邦-嘉義,2024-11-05,9692
00671R,富邦NASDAQ反1,35,0,35,富邦-嘉義,2024-11-05,9692
00753L,中信中國50正2,67,32,35,富邦-嘉義,2024-11-05,9692
6156,松上,36,3,33,富邦-嘉義,2024-11-05,9692
00946,群益科技高息成長,32,0,32,富邦-嘉義,2024-11-05,9692
00643,群益深証中小,30,0,30,富邦-嘉義,2024-11-05,9692
3005,神基,30,0,30,富邦-嘉義,2024-11-05,9692
1584,精剛,30,0,30,富邦-嘉義,2024-11-05,9692
6854,錼創科技-KY創,30,0,30,富邦-嘉義,2024-11-05,9692
1515,力山,29,0,29,富邦-嘉義,2024-11-05,9692
8429,金麗-KY,115,86,29,富邦-嘉義,2024-11-05,9692
0056,元大高股息,65,36,29,富邦-嘉義,2024-11-05,9692
00933B,國泰10Y+金融債,29,4,25,富邦-嘉義,2024-11-05,9692
2867,三商壽,25,0,25,富邦-嘉義,2024-11-05,9692
6257,矽格,23,2,21,富邦-嘉義,2024-11-05,9692
00947,台新臺灣IC設計,20,0,20,富邦-嘉義,2024-11-05,9692
1528,恩德,301,281,20,富邦-嘉義,2024-11-05,9692
6443,元晶,20,0,20,富邦-嘉義,2024-11-05,9692
2103,台橡,20,0,20,富邦-嘉義,2024-11-05,9692
00857B,永豐20年美公債,20,0,20,富邦-嘉義,2024-11-05,9692
4747,強生,20,0,20,富邦-嘉義,2024-11-05,9692
00922,國泰台灣領袖50,21,1,20,富邦-嘉義,2024-11-05,9692
00930,永豐ESG低碳高息,19,0,19,富邦-嘉義,2024-11-05,9692
00706L,期元大S＆P日圓正2,20,1,19,富邦-嘉義,2024-11-05,9692
00948B,中信優息投資級債,362,1,361,富邦-嘉義,2024-11-06,9692
00687B,國泰20年美債,390,62,328,富邦-嘉義,2024-11-06,9692
00905,FT臺灣Smart,306,1,305,富邦-嘉義,2024-11-06,9692
00679B,元大美債20年,320,133,187,富邦-嘉義,2024-11-06,9692
9105,泰金寶-DR,1217,1033,184,富邦-嘉義,2024-11-06,9692
8044,網家,239,99,140,富邦-嘉義,2024-11-06,9692
4991,環宇-KY,560,430,130,富邦-嘉義,2024-11-06,9692
00878,國泰永續高股息,155,64,91,富邦-嘉義,2024-11-06,9692
00933B,國泰10Y+金融債,140,54,86,富邦-嘉義,2024-11-06,9692
2312,金寶,2461,2377,84,富邦-嘉義,2024-11-06,9692
2303,聯電,115,37,78,富邦-嘉義,2024-11-06,9692
00706L,期元大S＆P日圓正2,76,0,76,富邦-嘉義,2024-11-06,9692
2425,承啟,181,110,71,富邦-嘉義,2024-11-06,9692
00943,兆豐電子高息等權,60,0,60,富邦-嘉義,2024-11-06,9692
00680L,元大美債20正2,200,141,59,富邦-嘉義,2024-11-06,9692
00932,兆豐永續高息等權,56,0,56,富邦-嘉義,2024-11-06,9692
00753L,中信中國50正2,53,0,53,富邦-嘉義,2024-11-06,9692
00937B,群益ESG投等債20,196,145,51,富邦-嘉義,2024-11-06,9692
00952,凱基台灣AI50,50,0,50,富邦-嘉義,2024-11-06,9692
1722,台肥,50,0,50,富邦-嘉義,2024-11-06,9692
2344,華邦電,52,3,49,富邦-嘉義,2024-11-06,9692
6873,泓德能源,47,0,47,富邦-嘉義,2024-11-06,9692
2881,富邦金,48,2,46,富邦-嘉義,2024-11-06,9692
4919,新唐,60,17,43,富邦-嘉義,2024-11-06,9692
6288,聯嘉,114,72,42,富邦-嘉義,2024-11-06,9692
00643,群益深証中小,40,0,40,富邦-嘉義,2024-11-06,9692
6176,瑞儀,41,1,40,富邦-嘉義,2024-11-06,9692
00688L,國泰20年美債正2,132,93,39,富邦-嘉義,2024-11-06,9692
00632R,元大台灣50反1,55,16,39,富邦-嘉義,2024-11-06,9692
00795B,中信美國公債20年,37,0,37,富邦-嘉義,2024-11-06,9692
3552,同致,43,9,34,富邦-嘉義,2024-11-06,9692
00953B,群益優選非投等債,227,193,34,富邦-嘉義,2024-11-06,9692
3105,穩懋,33,0,33,富邦-嘉義,2024-11-06,9692
3615,安可,56,24,32,富邦-嘉義,2024-11-06,9692
6763,綠界科技*,31,0,31,富邦-嘉義,2024-11-06,9692
00665L,富邦�琤肭磪囓�2,37,7,30,富邦-嘉義,2024-11-06,9692
2401,凌陽,30,0,30,富邦-嘉義,2024-11-06,9692
3078,僑威,30,0,30,富邦-嘉義,2024-11-06,9692
00712,復華富時不動產,29,0,29,富邦-嘉義,2024-11-06,9692
00918,大華優利高填息30,130,101,29,富邦-嘉義,2024-11-06,9692
00915,凱基優選高股息30,40,12,28,富邦-嘉義,2024-11-06,9692
1449,佳和,871,843,28,富邦-嘉義,2024-11-06,9692
00857B,永豐20年美公債,33,6,27,富邦-嘉義,2024-11-06,9692
3447,展達,39,12,27,富邦-嘉義,2024-11-06,9692
8150,南茂,27,1,26,富邦-嘉義,2024-11-06,9692
6821,聯寶,35,10,25,富邦-嘉義,2024-11-06,9692
3705,永信,25,1,24,富邦-嘉義,2024-11-06,9692
4950,牧東,30,9,21,富邦-嘉義,2024-11-06,9692
2399,映泰,155,134,21,富邦-嘉義,2024-11-06,9692
2892,第一金,20,0,20,富邦-嘉義,2024-11-06,9692
3062,建漢,1738,1043,695,富邦-嘉義,2024-11-07,9692
00753L,中信中國50正2,442,0,442,富邦-嘉義,2024-11-07,9692
2392,正崴,609,215,394,富邦-嘉義,2024-11-07,9692
00688L,國泰20年美債正2,268,8,260,富邦-嘉義,2024-11-07,9692
8028,昇陽半導體,410,212,198,富邦-嘉義,2024-11-07,9692
1595,川寶,180,9,171,富邦-嘉義,2024-11-07,9692
3706,神達,366,242,124,富邦-嘉義,2024-11-07,9692
00937B,群益ESG投等債20,244,134,110,富邦-嘉義,2024-11-07,9692
00922,國泰台灣領袖50,113,7,106,富邦-嘉義,2024-11-07,9692
4991,環宇-KY,489,384,105,富邦-嘉義,2024-11-07,9692
2886,兆豐金,101,11,90,富邦-嘉義,2024-11-07,9692
2439,美律,80,3,77,富邦-嘉義,2024-11-07,9692
2356,英業達,158,82,76,富邦-嘉義,2024-11-07,9692
00706L,期元大S＆P日圓正2,75,0,75,富邦-嘉義,2024-11-07,9692
00687B,國泰20年美債,103,31,72,富邦-嘉義,2024-11-07,9692
3047,訊舟,274,208,66,富邦-嘉義,2024-11-07,9692
00878,國泰永續高股息,80,14,66,富邦-嘉義,2024-11-07,9692
3455,由田,67,7,60,富邦-嘉義,2024-11-07,9692
00933B,國泰10Y+金融債,113,53,60,富邦-嘉義,2024-11-07,9692
6176,瑞儀,59,0,59,富邦-嘉義,2024-11-07,9692
3303,岱稜,122,64,58,富邦-嘉義,2024-11-07,9692
2303,聯電,140,83,57,富邦-嘉義,2024-11-07,9692
1531,高林股,53,1,52,富邦-嘉義,2024-11-07,9692
8240,華宏,51,0,51,富邦-嘉義,2024-11-07,9692
3498,陽程,664,614,50,富邦-嘉義,2024-11-07,9692
2014,中鴻,120,76,44,富邦-嘉義,2024-11-07,9692
00669R,國泰美國道瓊反1,43,0,43,富邦-嘉義,2024-11-07,9692
6854,錼創科技-KY創,42,0,42,富邦-嘉義,2024-11-07,9692
2892,第一金,39,0,39,富邦-嘉義,2024-11-07,9692
2646,星宇航空,76,37,39,富邦-嘉義,2024-11-07,9692
1808,潤隆,38,0,38,富邦-嘉義,2024-11-07,9692
00946,群益科技高息成長,39,5,34,富邦-嘉義,2024-11-07,9692
00632R,元大台灣50反1,167,133,34,富邦-嘉義,2024-11-07,9692
2887,台新金,33,0,33,富邦-嘉義,2024-11-07,9692
8374,羅昇,66,33,33,富邦-嘉義,2024-11-07,9692
8047,星雲,56,24,32,富邦-嘉義,2024-11-07,9692
00919,群益台灣精選高息,37,6,31,富邦-嘉義,2024-11-07,9692
6505,台塑化,55,24,31,富邦-嘉義,2024-11-07,9692
2313,華通,106,75,31,富邦-嘉義,2024-11-07,9692
2027,大成鋼,153,123,30,富邦-嘉義,2024-11-07,9692
6658,聯策,171,141,30,富邦-嘉義,2024-11-07,9692
6768,志強-KY,31,1,30,富邦-嘉義,2024-11-07,9692
00915,凱基優選高股息30,30,2,28,富邦-嘉義,2024-11-07,9692
00948B,中信優息投資級債,32,4,28,富邦-嘉義,2024-11-07,9692
5426,振發,86,59,27,富邦-嘉義,2024-11-07,9692
00639,富邦深100,26,0,26,富邦-嘉義,2024-11-07,9692
2328,廣宇,64,42,22,富邦-嘉義,2024-11-07,9692
4916,事欣科,45,23,22,富邦-嘉義,2024-11-07,9692
6869,雲豹能源,23,2,21,富邦-嘉義,2024-11-07,9692
6109,亞元,20,0,20,富邦-嘉義,2024-11-07,9692
3706,神達,3307,1258,2049,富邦-嘉義,2024-11-08,9692
00632R,元大台灣50反1,1188,85,1103,富邦-嘉義,2024-11-08,9692
8240,華宏,806,498,308,富邦-嘉義,2024-11-08,9692
3481,群創,319,80,239,富邦-嘉義,2024-11-08,9692
3231,緯創,2504,2266,238,富邦-嘉義,2024-11-08,9692
00945B,凱基美國非投等債,207,2,205,富邦-嘉義,2024-11-08,9692
00878,國泰永續高股息,215,23,192,富邦-嘉義,2024-11-08,9692
3303,岱稜,296,123,173,富邦-嘉義,2024-11-08,9692
4533,協易機,192,19,173,富邦-嘉義,2024-11-08,9692
2439,美律,166,0,166,富邦-嘉義,2024-11-08,9692
00943,兆豐電子高息等權,136,2,134,富邦-嘉義,2024-11-08,9692
1466,聚隆,114,1,113,富邦-嘉義,2024-11-08,9692
2515,中工,103,10,93,富邦-嘉義,2024-11-08,9692
00948B,中信優息投資級債,183,92,91,富邦-嘉義,2024-11-08,9692
1714,和桐,100,10,90,富邦-嘉義,2024-11-08,9692
2884,玉山金,88,0,88,富邦-嘉義,2024-11-08,9692
6505,台塑化,91,5,86,富邦-嘉義,2024-11-08,9692
3049,精金,87,2,85,富邦-嘉義,2024-11-08,9692
1449,佳和,186,103,83,富邦-嘉義,2024-11-08,9692
2609,陽明,598,516,82,富邦-嘉義,2024-11-08,9692
00918,大華優利高填息30,104,35,69,富邦-嘉義,2024-11-08,9692
2892,第一金,58,0,58,富邦-嘉義,2024-11-08,9692
2303,聯電,105,51,54,富邦-嘉義,2024-11-08,9692
9105,泰金寶-DR,683,630,53,富邦-嘉義,2024-11-08,9692
6152,百一,52,0,52,富邦-嘉義,2024-11-08,9692
2313,華通,97,46,51,富邦-嘉義,2024-11-08,9692
2337,旺宏,51,1,50,富邦-嘉義,2024-11-08,9692
8021,尖點,150,105,45,富邦-嘉義,2024-11-08,9692
1802,台玻,60,18,42,富邦-嘉義,2024-11-08,9692
2353,宏��,41,2,39,富邦-嘉義,2024-11-08,9692
6257,矽格,42,3,39,富邦-嘉義,2024-11-08,9692
2543,皇昌,52,14,38,富邦-嘉義,2024-11-08,9692
8070,長華*,41,3,38,富邦-嘉義,2024-11-08,9692
2402,毅嘉,42,6,36,富邦-嘉義,2024-11-08,9692
1326,台化,71,36,35,富邦-嘉義,2024-11-08,9692
00932,兆豐永續高息等權,35,0,35,富邦-嘉義,2024-11-08,9692
3211,順達,94,59,35,富邦-嘉義,2024-11-08,9692
2388,威盛,53,19,34,富邦-嘉義,2024-11-08,9692
5871,中租-KY,37,4,33,富邦-嘉義,2024-11-08,9692
6669,緯穎,31,0,31,富邦-嘉義,2024-11-08,9692
00751B,元大AAA至A公司債,30,0,30,富邦-嘉義,2024-11-08,9692
2103,台橡,30,0,30,富邦-嘉義,2024-11-08,9692
6134,萬旭,30,1,29,富邦-嘉義,2024-11-08,9692
2489,瑞軒,45,16,29,富邦-嘉義,2024-11-08,9692
6176,瑞儀,28,0,28,富邦-嘉義,2024-11-08,9692
2615,萬海,225,199,26,富邦-嘉義,2024-11-08,9692
6005,群益證,25,0,25,富邦-嘉義,2024-11-08,9692
0056,元大高股息,47,23,24,富邦-嘉義,2024-11-08,9692
00919,群益台灣精選高息,64,40,24,富邦-嘉義,2024-11-08,9692
00713,元大台灣高息低波,25,1,24,富邦-嘉義,2024-11-08,9692
00673R,期元大S＆P原油反1,1020,23,997,富邦-嘉義,2024-11-11,9692
8028,昇陽半導體,752,229,523,富邦-嘉義,2024-11-11,9692
00665L,富邦�琤肭磪囓�2,482,20,462,富邦-嘉義,2024-11-11,9692
3706,神達,362,83,279,富邦-嘉義,2024-11-11,9692
00948B,中信優息投資級債,227,10,217,富邦-嘉義,2024-11-11,9692
00878,國泰永續高股息,220,17,203,富邦-嘉義,2024-11-11,9692
4977,眾達-KY,736,577,159,富邦-嘉義,2024-11-11,9692
3712,永崴投控,359,205,154,富邦-嘉義,2024-11-11,9692
00915,凱基優選高股息30,143,15,128,富邦-嘉義,2024-11-11,9692
2354,鴻準,1400,1278,122,富邦-嘉義,2024-11-11,9692
00919,群益台灣精選高息,110,3,107,富邦-嘉義,2024-11-11,9692
4931,新盛力,211,123,88,富邦-嘉義,2024-11-11,9692
3013,晟銘電,300,215,85,富邦-嘉義,2024-11-11,9692
2439,美律,83,0,83,富邦-嘉義,2024-11-11,9692
2615,萬海,325,248,77,富邦-嘉義,2024-11-11,9692
2603,長榮,121,53,68,富邦-嘉義,2024-11-11,9692
00753L,中信中國50正2,95,33,62,富邦-嘉義,2024-11-11,9692
5608,四維航,68,6,62,富邦-嘉義,2024-11-11,9692
2834,臺企銀,66,5,61,富邦-嘉義,2024-11-11,9692
2545,皇翔,60,0,60,富邦-嘉義,2024-11-11,9692
00946,群益科技高息成長,64,7,57,富邦-嘉義,2024-11-11,9692
1314,中石化,57,3,54,富邦-嘉義,2024-11-11,9692
1605,華新,60,6,54,富邦-嘉義,2024-11-11,9692
3234,光環,64,11,53,富邦-嘉義,2024-11-11,9692
2369,菱生,59,7,52,富邦-嘉義,2024-11-11,9692
2303,聯電,70,19,51,富邦-嘉義,2024-11-11,9692
00932,兆豐永續高息等權,47,0,47,富邦-嘉義,2024-11-11,9692
2314,台揚,51,5,46,富邦-嘉義,2024-11-11,9692
0056,元大高股息,62,23,39,富邦-嘉義,2024-11-11,9692
00930,永豐ESG低碳高息,35,0,35,富邦-嘉義,2024-11-11,9692
3419,譁裕,38,5,33,富邦-嘉義,2024-11-11,9692
2881,富邦金,32,0,32,富邦-嘉義,2024-11-11,9692
2353,宏��,37,6,31,富邦-嘉義,2024-11-11,9692
8110,華東,32,1,31,富邦-嘉義,2024-11-11,9692
00943,兆豐電子高息等權,30,0,30,富邦-嘉義,2024-11-11,9692
1466,聚隆,30,0,30,富邦-嘉義,2024-11-11,9692
1722,台肥,30,0,30,富邦-嘉義,2024-11-11,9692
4916,事欣科,43,13,30,富邦-嘉義,2024-11-11,9692
00922,國泰台灣領袖50,29,0,29,富邦-嘉義,2024-11-11,9692
1309,台達化,29,0,29,富邦-嘉義,2024-11-11,9692
6168,宏齊,38,9,29,富邦-嘉義,2024-11-11,9692
00713,元大台灣高息低波,34,6,28,富邦-嘉義,2024-11-11,9692
1524,耿鼎,185,158,27,富邦-嘉義,2024-11-11,9692
1584,精剛,30,4,26,富邦-嘉義,2024-11-11,9692
4967,十銓,35,9,26,富邦-嘉義,2024-11-11,9692
2402,毅嘉,30,5,25,富邦-嘉義,2024-11-11,9692
3211,順達,51,26,25,富邦-嘉義,2024-11-11,9692
00650L,復華香港正2,30,6,24,富邦-嘉義,2024-11-11,9692
3701,大眾控,25,1,24,富邦-嘉義,2024-11-11,9692
2646,星宇航空,33,10,23,富邦-嘉義,2024-11-11,9692
2603,長榮,835,345,490,富邦-嘉義,2024-11-12,9692
00878,國泰永續高股息,470,13,457,富邦-嘉義,2024-11-12,9692
2349,錸德,872,483,389,富邦-嘉義,2024-11-12,9692
00715L,期街口布蘭特正2,345,10,335,富邦-嘉義,2024-11-12,9692
3013,晟銘電,898,586,312,富邦-嘉義,2024-11-12,9692
4931,新盛力,816,517,299,富邦-嘉義,2024-11-12,9692
00887,永豐中國科技50大,286,61,225,富邦-嘉義,2024-11-12,9692
0056,元大高股息,173,9,164,富邦-嘉義,2024-11-12,9692
1466,聚隆,160,1,159,富邦-嘉義,2024-11-12,9692
3049,精金,148,1,147,富邦-嘉義,2024-11-12,9692
2892,第一金,146,1,145,富邦-嘉義,2024-11-12,9692
2618,長榮航,239,99,140,富邦-嘉義,2024-11-12,9692
2328,廣宇,226,87,139,富邦-嘉義,2024-11-12,9692
2888,新光金,135,9,126,富邦-嘉義,2024-11-12,9692
00915,凱基優選高股息30,116,16,100,富邦-嘉義,2024-11-12,9692
2834,臺企銀,97,2,95,富邦-嘉義,2024-11-12,9692
2301,光寶科,107,17,90,富邦-嘉義,2024-11-12,9692
00929,復華台灣科技優息,210,120,90,富邦-嘉義,2024-11-12,9692
00919,群益台灣精選高息,109,25,84,富邦-嘉義,2024-11-12,9692
5871,中租-KY,99,16,83,富邦-嘉義,2024-11-12,9692
00720B,元大投資級公司債,94,14,80,富邦-嘉義,2024-11-12,9692
4155,訊映,76,0,76,富邦-嘉義,2024-11-12,9692
1101,台泥,86,13,73,富邦-嘉義,2024-11-12,9692
2002,中鋼,75,3,72,富邦-嘉義,2024-11-12,9692
2520,冠德,80,10,70,富邦-嘉義,2024-11-12,9692
00943,兆豐電子高息等權,69,0,69,富邦-嘉義,2024-11-12,9692
00905,FT臺灣Smart,78,10,68,富邦-嘉義,2024-11-12,9692
2851,中再保,63,0,63,富邦-嘉義,2024-11-12,9692
3501,維熹,62,0,62,富邦-嘉義,2024-11-12,9692
2387,精元,65,4,61,富邦-嘉義,2024-11-12,9692
2353,宏��,60,1,59,富邦-嘉義,2024-11-12,9692
2801,彰銀,54,0,54,富邦-嘉義,2024-11-12,9692
1314,中石化,64,10,54,富邦-嘉義,2024-11-12,9692
00932,兆豐永續高息等權,51,0,51,富邦-嘉義,2024-11-12,9692
2845,遠東銀,50,0,50,富邦-嘉義,2024-11-12,9692
00680L,元大美債20正2,122,76,46,富邦-嘉義,2024-11-12,9692
4747,強生,46,0,46,富邦-嘉義,2024-11-12,9692
2883,凱基金,41,2,39,富邦-嘉義,2024-11-12,9692
00930,永豐ESG低碳高息,38,1,37,富邦-嘉義,2024-11-12,9692
8089,康全電訊,135,98,37,富邦-嘉義,2024-11-12,9692
1449,佳和,104,67,37,富邦-嘉義,2024-11-12,9692
4977,眾達-KY,253,217,36,富邦-嘉義,2024-11-12,9692
006208,富邦台50,47,11,36,富邦-嘉義,2024-11-12,9692
2409,友達,46,11,35,富邦-嘉義,2024-11-12,9692
5452,佶優,39,4,35,富邦-嘉義,2024-11-12,9692
2609,陽明,734,699,35,富邦-嘉義,2024-11-12,9692
00922,國泰台灣領袖50,56,22,34,富邦-嘉義,2024-11-12,9692
3515,華擎,37,3,34,富邦-嘉義,2024-11-12,9692
2330,台積電,47,14,33,富邦-嘉義,2024-11-12,9692
1301,台塑,42,10,32,富邦-嘉義,2024-11-12,9692
00642U,期元大S＆P石油,800,2,798,富邦-嘉義,2024-11-13,9692
1326,台化,599,10,589,富邦-嘉義,2024-11-13,9692
2312,金寶,971,651,320,富邦-嘉義,2024-11-13,9692
3015,全漢,545,262,283,富邦-嘉義,2024-11-13,9692
1524,耿鼎,267,19,248,富邦-嘉義,2024-11-13,9692
2883,凱基金,221,1,220,富邦-嘉義,2024-11-13,9692
00664R,國泰臺灣加權反1,220,10,210,富邦-嘉義,2024-11-13,9692
6282,康舒,281,84,197,富邦-嘉義,2024-11-13,9692
2392,正崴,918,723,195,富邦-嘉義,2024-11-13,9692
3211,順達,459,269,190,富邦-嘉義,2024-11-13,9692
0056,元大高股息,154,5,149,富邦-嘉義,2024-11-13,9692
00918,大華優利高填息30,129,2,127,富邦-嘉義,2024-11-13,9692
00795B,中信美國公債20年,95,0,95,富邦-嘉義,2024-11-13,9692
00680L,元大美債20正2,85,0,85,富邦-嘉義,2024-11-13,9692
2834,臺企銀,114,29,85,富邦-嘉義,2024-11-13,9692
00878,國泰永續高股息,215,130,85,富邦-嘉義,2024-11-13,9692
1301,台塑,82,0,82,富邦-嘉義,2024-11-13,9692
00948B,中信優息投資級債,212,145,67,富邦-嘉義,2024-11-13,9692
2356,英業達,108,49,59,富邦-嘉義,2024-11-13,9692
2881,富邦金,58,1,57,富邦-嘉義,2024-11-13,9692
2892,第一金,72,16,56,富邦-嘉義,2024-11-13,9692
00687B,國泰20年美債,136,84,52,富邦-嘉義,2024-11-13,9692
2317,鴻海,1185,1134,51,富邦-嘉義,2024-11-13,9692
1714,和桐,50,0,50,富邦-嘉義,2024-11-13,9692
00641R,富邦日本反1,50,0,50,富邦-嘉義,2024-11-13,9692
00953B,群益優選非投等債,60,11,49,富邦-嘉義,2024-11-13,9692
2353,宏��,78,31,47,富邦-嘉義,2024-11-13,9692
1446,宏和,47,2,45,富邦-嘉義,2024-11-13,9692
00753L,中信中國50正2,71,26,45,富邦-嘉義,2024-11-13,9692
1708,東鹼,67,23,44,富邦-嘉義,2024-11-13,9692
2323,中環,42,0,42,富邦-嘉義,2024-11-13,9692
2303,聯電,56,14,42,富邦-嘉義,2024-11-13,9692
1528,恩德,45,4,41,富邦-嘉義,2024-11-13,9692
2801,彰銀,37,0,37,富邦-嘉義,2024-11-13,9692
6147,頎邦,34,0,34,富邦-嘉義,2024-11-13,9692
00712,復華富時不動產,40,6,34,富邦-嘉義,2024-11-13,9692
6669,緯穎,33,1,32,富邦-嘉義,2024-11-13,9692
00919,群益台灣精選高息,113,81,32,富邦-嘉義,2024-11-13,9692
3003,健和興,55,23,32,富邦-嘉義,2024-11-13,9692
9945,潤泰新,32,1,31,富邦-嘉義,2024-11-13,9692
2603,長榮,567,537,30,富邦-嘉義,2024-11-13,9692
6505,台塑化,31,0,31,富邦-嘉義,2024-11-13,9692
5871,中租-KY,37,7,30,富邦-嘉義,2024-11-13,9692
2477,美隆電,50,22,28,富邦-嘉義,2024-11-13,9692
3189,景碩,36,8,28,富邦-嘉義,2024-11-13,9692
6152,百一,27,0,27,富邦-嘉義,2024-11-13,9692
2891,中信金,33,7,26,富邦-嘉義,2024-11-13,9692
00725B,國泰投資級公司債,26,0,26,富邦-嘉義,2024-11-13,9692
3511,矽瑪,27,1,26,富邦-嘉義,2024-11-13,9692
2882,國泰金,31,5,26,富邦-嘉義,2024-11-13,9692
00878,國泰永續高股息,675,80,595,富邦-嘉義,2024-11-14,9692
6405,悅城,2943,2423,520,富邦-嘉義,2024-11-14,9692
3211,順達,1650,1207,443,富邦-嘉義,2024-11-14,9692
00929,復華台灣科技優息,302,36,266,富邦-嘉義,2024-11-14,9692
00937B,群益ESG投等債20,304,43,261,富邦-嘉義,2024-11-14,9692
2324,仁寶,235,14,221,富邦-嘉義,2024-11-14,9692
2892,第一金,218,0,218,富邦-嘉義,2024-11-14,9692
5398,慕康生醫,242,48,194,富邦-嘉義,2024-11-14,9692
00688L,國泰20年美債正2,182,11,171,富邦-嘉義,2024-11-14,9692
00919,群益台灣精選高息,167,8,159,富邦-嘉義,2024-11-14,9692
00679B,元大美債20年,161,5,156,富邦-嘉義,2024-11-14,9692
0056,元大高股息,169,17,152,富邦-嘉義,2024-11-14,9692
1524,耿鼎,168,26,142,富邦-嘉義,2024-11-14,9692
2303,聯電,174,34,140,富邦-嘉義,2024-11-14,9692
3665,貿聯-KY,111,3,108,富邦-嘉義,2024-11-14,9692
00940,元大台灣價值高息,107,3,104,富邦-嘉義,2024-11-14,9692
6558,興能高,100,0,100,富邦-嘉義,2024-11-14,9692
3625,西勝,100,2,98,富邦-嘉義,2024-11-14,9692
3481,群創,132,37,95,富邦-嘉義,2024-11-14,9692
6757,台灣虎航,100,10,90,富邦-嘉義,2024-11-14,9692
1528,恩德,169,82,87,富邦-嘉義,2024-11-14,9692
00948B,中信優息投資級債,85,0,85,富邦-嘉義,2024-11-14,9692
3706,神達,3288,3203,85,富邦-嘉義,2024-11-14,9692
3580,友威科,89,5,84,富邦-嘉義,2024-11-14,9692
2884,玉山金,111,33,78,富邦-嘉義,2024-11-14,9692
00915,凱基優選高股息30,81,4,77,富邦-嘉義,2024-11-14,9692
00632R,元大台灣50反1,240,164,76,富邦-嘉義,2024-11-14,9692
2027,大成鋼,78,12,66,富邦-嘉義,2024-11-14,9692
2317,鴻海,1095,1032,63,富邦-嘉義,2024-11-14,9692
3499,環天科,82,20,62,富邦-嘉義,2024-11-14,9692
00753L,中信中國50正2,99,37,62,富邦-嘉義,2024-11-14,9692
5880,合庫金,66,5,61,富邦-嘉義,2024-11-14,9692
2606,裕民,59,6,53,富邦-嘉義,2024-11-14,9692
9105,泰金寶-DR,136,84,52,富邦-嘉義,2024-11-14,9692
5871,中租-KY,55,4,51,富邦-嘉義,2024-11-14,9692
2887,台新金,47,1,46,富邦-嘉義,2024-11-14,9692
00927,群益半導體收益,41,0,41,富邦-嘉義,2024-11-14,9692
00891,中信關鍵半導體,43,2,41,富邦-嘉義,2024-11-14,9692
3231,緯創,64,24,40,富邦-嘉義,2024-11-14,9692
1301,台塑,96,56,40,富邦-嘉義,2024-11-14,9692
2312,金寶,114,74,40,富邦-嘉義,2024-11-14,9692
00665L,富邦�琤肭磪囓�2,49,9,40,富邦-嘉義,2024-11-14,9692
3576,聯合再生,47,7,40,富邦-嘉義,2024-11-14,9692
2431,聯昌,39,3,36,富邦-嘉義,2024-11-14,9692
00680L,元大美債20正2,34,1,33,富邦-嘉義,2024-11-14,9692
2488,漢平,33,0,33,富邦-嘉義,2024-11-14,9692
4729,熒茂,75,42,33,富邦-嘉義,2024-11-14,9692
00943,兆豐電子高息等權,32,0,32,富邦-嘉義,2024-11-14,9692
2353,宏��,78,47,31,富邦-嘉義,2024-11-14,9692
00945B,凱基美國非投等債,31,0,31,富邦-嘉義,2024-11-14,9692
2312,金寶,10020,7427,2593,富邦-嘉義,2024-11-15,9692
2354,鴻準,2842,1839,1003,富邦-嘉義,2024-11-15,9692
00878,國泰永續高股息,537,46,491,富邦-嘉義,2024-11-15,9692
8044,網家,580,248,332,富邦-嘉義,2024-11-15,9692
00929,復華台灣科技優息,464,156,308,富邦-嘉義,2024-11-15,9692
00932,兆豐永續高息等權,157,1,156,富邦-嘉義,2024-11-15,9692
1319,東陽,108,5,103,富邦-嘉義,2024-11-15,9692
00963,中信全球高股息,95,0,95,富邦-嘉義,2024-11-15,9692
00937B,群益ESG投等債20,150,61,89,富邦-嘉義,2024-11-15,9692
1524,耿鼎,128,47,81,富邦-嘉義,2024-11-15,9692
1522,堤維西,82,7,75,富邦-嘉義,2024-11-15,9692
1611,中電,72,4,68,富邦-嘉義,2024-11-15,9692
00950B,凱基A級公司債,60,0,60,富邦-嘉義,2024-11-15,9692
2317,鴻海,185,126,59,富邦-嘉義,2024-11-15,9692
00882,中信中國高股息,49,0,49,富邦-嘉義,2024-11-15,9692
1326,台化,581,536,45,富邦-嘉義,2024-11-15,9692
2646,星宇航空,52,11,41,富邦-嘉義,2024-11-15,9692
2618,長榮航,1676,1638,38,富邦-嘉義,2024-11-15,9692
2344,華邦電,39,2,37,富邦-嘉義,2024-11-15,9692
1532,勤美,35,0,35,富邦-嘉義,2024-11-15,9692
3231,緯創,95,60,35,富邦-嘉義,2024-11-15,9692
2392,正崴,85,55,30,富邦-嘉義,2024-11-15,9692
2615,萬海,51,21,30,富邦-嘉義,2024-11-15,9692
3447,展達,175,145,30,富邦-嘉義,2024-11-15,9692
9939,宏全,32,2,30,富邦-嘉義,2024-11-15,9692
2887,台新金,28,0,28,富邦-嘉義,2024-11-15,9692
1717,長興,26,0,26,富邦-嘉義,2024-11-15,9692
8996,高力,32,7,25,富邦-嘉義,2024-11-15,9692
8104,錸寶,56,32,24,富邦-嘉義,2024-11-15,9692
6217,中探針,27,3,24,富邦-嘉義,2024-11-15,9692
9105,泰金寶-DR,3029,3007,22,富邦-嘉義,2024-11-15,9692
2905,三商,24,2,22,富邦-嘉義,2024-11-15,9692
3073,天方能源,22,0,22,富邦-嘉義,2024-11-15,9692
0056,元大高股息,22,0,22,富邦-嘉義,2024-11-15,9692
00945B,凱基美國非投等債,20,0,20,富邦-嘉義,2024-11-15,9692
2415,錩新,20,0,20,富邦-嘉義,2024-11-15,9692
00930,永豐ESG低碳高息,21,1,20,富邦-嘉義,2024-11-15,9692
3090,日電貿,622,602,20,富邦-嘉義,2024-11-15,9692
2303,聯電,82,62,20,富邦-嘉義,2024-11-15,9692
2301,光寶科,19,1,18,富邦-嘉義,2024-11-15,9692
1312,國喬,19,2,17,富邦-嘉義,2024-11-15,9692
3323,加百裕,106,90,16,富邦-嘉義,2024-11-15,9692
3017,奇鋐,16,0,16,富邦-嘉義,2024-11-15,9692
00715L,期街口布蘭特正2,18,2,16,富邦-嘉義,2024-11-15,9692
3209,全科,19,4,15,富邦-嘉義,2024-11-15,9692
2488,漢平,16,1,15,富邦-嘉義,2024-11-15,9692
00933B,國泰10Y+金融債,24,10,14,富邦-嘉義,2024-11-15,9692
5321,美而快,14,0,14,富邦-嘉義,2024-11-15,9692
3013,晟銘電,29,15,14,富邦-嘉義,2024-11-15,9692
2002,中鋼,13,0,13,富邦-嘉義,2024-11-15,9692
2618,長榮航,471,42,429,富邦-嘉義,2024-11-18,9692
00715L,期街口布蘭特正2,347,1,346,富邦-嘉義,2024-11-18,9692
00929,復華台灣科技優息,379,90,289,富邦-嘉義,2024-11-18,9692
00878,國泰永續高股息,301,20,281,富邦-嘉義,2024-11-18,9692
00915,凱基優選高股息30,187,3,184,富邦-嘉義,2024-11-18,9692
00664R,國泰臺灣加權反1,150,0,150,富邦-嘉義,2024-11-18,9692
00937B,群益ESG投等債20,129,14,115,富邦-嘉義,2024-11-18,9692
2409,友達,109,2,107,富邦-嘉義,2024-11-18,9692
3323,加百裕,183,82,101,富邦-嘉義,2024-11-18,9692
00948B,中信優息投資級債,100,20,80,富邦-嘉義,2024-11-18,9692
1446,宏和,97,22,75,富邦-嘉義,2024-11-18,9692
00918,大華優利高填息30,124,55,69,富邦-嘉義,2024-11-18,9692
00919,群益台灣精選高息,70,4,66,富邦-嘉義,2024-11-18,9692
2374,佳能,67,1,66,富邦-嘉義,2024-11-18,9692
00943,兆豐電子高息等權,69,8,61,富邦-嘉義,2024-11-18,9692
8104,錸寶,392,335,57,富邦-嘉義,2024-11-18,9692
2408,南亞科,57,1,56,富邦-嘉義,2024-11-18,9692
2316,楠梓電,50,0,50,富邦-嘉義,2024-11-18,9692
2881,富邦金,49,11,38,富邦-嘉義,2024-11-18,9692
5315,光聯,42,6,36,富邦-嘉義,2024-11-18,9692
00953B,群益優選非投等債,37,2,35,富邦-嘉義,2024-11-18,9692
1785,光洋科,42,7,35,富邦-嘉義,2024-11-18,9692
3050,鈺德,159,125,34,富邦-嘉義,2024-11-18,9692
006208,富邦台50,38,5,33,富邦-嘉義,2024-11-18,9692
3231,緯創,63,30,33,富邦-嘉義,2024-11-18,9692
8429,金麗-KY,73,40,33,富邦-嘉義,2024-11-18,9692
9105,泰金寶-DR,200,168,32,富邦-嘉義,2024-11-18,9692
5481,新華,30,0,30,富邦-嘉義,2024-11-18,9692
2883,凱基金,42,12,30,富邦-嘉義,2024-11-18,9692
00935,野村臺灣新科技50,31,1,30,富邦-嘉義,2024-11-18,9692
3501,維熹,46,17,29,富邦-嘉義,2024-11-18,9692
2317,鴻海,98,69,29,富邦-嘉義,2024-11-18,9692
0050,元大台灣50,29,1,28,富邦-嘉義,2024-11-18,9692
5452,佶優,28,2,26,富邦-嘉義,2024-11-18,9692
00891,中信關鍵半導體,25,1,24,富邦-嘉義,2024-11-18,9692
6257,矽格,20,0,20,富邦-嘉義,2024-11-18,9692
3704,合勤控,20,1,19,富邦-嘉義,2024-11-18,9692
00887,永豐中國科技50大,38,19,19,富邦-嘉義,2024-11-18,9692
2880,華南金,22,4,18,富邦-嘉義,2024-11-18,9692
2887,台新金,18,0,18,富邦-嘉義,2024-11-18,9692
2314,台揚,21,4,17,富邦-嘉義,2024-11-18,9692
3663,鑫科,21,4,17,富邦-嘉義,2024-11-18,9692
3374,精材,23,7,16,富邦-嘉義,2024-11-18,9692
3706,神達,1736,1720,16,富邦-嘉義,2024-11-18,9692
2867,三商壽,16,0,16,富邦-嘉義,2024-11-18,9692
1712,興農,18,2,16,富邦-嘉義,2024-11-18,9692
3062,建漢,41,25,16,富邦-嘉義,2024-11-18,9692
3712,永崴投控,45,29,16,富邦-嘉義,2024-11-18,9692
00922,國泰台灣領袖50,32,16,16,富邦-嘉義,2024-11-18,9692
3356,奇偶,15,0,15,富邦-嘉義,2024-11-18,9692
2354,鴻準,3047,1327,1720,富邦-嘉義,2024-11-19,9692
00673R,期元大S＆P原油反1,606,0,606,富邦-嘉義,2024-11-19,9692
3706,神達,2846,2311,535,富邦-嘉義,2024-11-19,9692
00753L,中信中國50正2,329,19,310,富邦-嘉義,2024-11-19,9692
2413,環科,310,61,249,富邦-嘉義,2024-11-19,9692
6558,興能高,294,99,195,富邦-嘉義,2024-11-19,9692
00937B,群益ESG投等債20,248,66,182,富邦-嘉義,2024-11-19,9692
3447,展達,255,79,176,富邦-嘉義,2024-11-19,9692
3481,群創,247,73,174,富邦-嘉義,2024-11-19,9692
5243,乙盛-KY,320,174,146,富邦-嘉義,2024-11-19,9692
1569,濱川,129,3,126,富邦-嘉義,2024-11-19,9692
4931,新盛力,285,166,119,富邦-嘉義,2024-11-19,9692
00953B,群益優選非投等債,80,0,80,富邦-嘉義,2024-11-19,9692
4729,熒茂,94,16,78,富邦-嘉義,2024-11-19,9692
6438,迅得,116,41,75,富邦-嘉義,2024-11-19,9692
2303,聯電,84,15,69,富邦-嘉義,2024-11-19,9692
1102,亞泥,61,0,61,富邦-嘉義,2024-11-19,9692
8032,光菱,107,56,51,富邦-嘉義,2024-11-19,9692
2317,鴻海,77,31,46,富邦-嘉義,2024-11-19,9692
3323,加百裕,175,131,44,富邦-嘉義,2024-11-19,9692
4956,光鋐,54,12,42,富邦-嘉義,2024-11-19,9692
1471,首利,36,1,35,富邦-嘉義,2024-11-19,9692
2646,星宇航空,42,8,34,富邦-嘉義,2024-11-19,9692
3552,同致,76,42,34,富邦-嘉義,2024-11-19,9692
00945B,凱基美國非投等債,32,0,32,富邦-嘉義,2024-11-19,9692
00756B,群益投等新興公債,32,0,32,富邦-嘉義,2024-11-19,9692
3625,西勝,32,2,30,富邦-嘉義,2024-11-19,9692
3338,泰碩,47,18,29,富邦-嘉義,2024-11-19,9692
00637L,元大滬深300正2,55,29,26,富邦-嘉義,2024-11-19,9692
3231,緯創,52,26,26,富邦-嘉義,2024-11-19,9692
3593,力銘,25,0,25,富邦-嘉義,2024-11-19,9692
00878,國泰永續高股息,80,55,25,富邦-嘉義,2024-11-19,9692
3062,建漢,149,125,24,富邦-嘉義,2024-11-19,9692
2543,皇昌,33,10,23,富邦-嘉義,2024-11-19,9692
2382,廣達,32,10,22,富邦-嘉義,2024-11-19,9692
1528,恩德,32,10,22,富邦-嘉義,2024-11-19,9692
4903,聯光通,542,520,22,富邦-嘉義,2024-11-19,9692
2887,台新金,23,2,21,富邦-嘉義,2024-11-19,9692
00941,中信上游半導體,21,0,21,富邦-嘉義,2024-11-19,9692
00761B,國泰A級公司債,20,0,20,富邦-嘉義,2024-11-19,9692
2630,亞航,20,0,20,富邦-嘉義,2024-11-19,9692
006205,富邦上証,21,1,20,富邦-嘉義,2024-11-19,9692
6246,臺龍,20,0,20,富邦-嘉義,2024-11-19,9692
3049,精金,21,2,19,富邦-嘉義,2024-11-19,9692
3211,順達,77,58,19,富邦-嘉義,2024-11-19,9692
0056,元大高股息,51,32,19,富邦-嘉義,2024-11-19,9692
1301,台塑,72,54,18,富邦-嘉義,2024-11-19,9692
00633L,富邦上証正2,16,0,16,富邦-嘉義,2024-11-19,9692
2890,永豐金,15,0,15,富邦-嘉義,2024-11-19,9692
00943,兆豐電子高息等權,15,0,15,富邦-嘉義,2024-11-19,9692
2609,陽明,4149,1633,2516,富邦-嘉義,2024-11-20,9692
00715L,期街口布蘭特正2,754,17,737,富邦-嘉義,2024-11-20,9692
2413,環科,5684,5024,660,富邦-嘉義,2024-11-20,9692
00937B,群益ESG投等債20,275,10,265,富邦-嘉義,2024-11-20,9692
00932,兆豐永續高息等權,242,2,240,富邦-嘉義,2024-11-20,9692
00753L,中信中國50正2,209,23,186,富邦-嘉義,2024-11-20,9692
2204,中華,171,9,162,富邦-嘉義,2024-11-20,9692
2349,錸德,1723,1583,140,富邦-嘉義,2024-11-20,9692
00878,國泰永續高股息,123,3,120,富邦-嘉義,2024-11-20,9692
2834,臺企銀,109,3,106,富邦-嘉義,2024-11-20,9692
00650L,復華香港正2,102,5,97,富邦-嘉義,2024-11-20,9692
8929,富堡,178,106,72,富邦-嘉義,2024-11-20,9692
1449,佳和,73,14,59,富邦-嘉義,2024-11-20,9692
2317,鴻海,83,26,57,富邦-嘉義,2024-11-20,9692
00632R,元大台灣50反1,131,76,55,富邦-嘉義,2024-11-20,9692
5880,合庫金,52,1,51,富邦-嘉義,2024-11-20,9692
00930,永豐ESG低碳高息,45,0,45,富邦-嘉義,2024-11-20,9692
006208,富邦台50,47,7,40,富邦-嘉義,2024-11-20,9692
2303,聯電,101,65,36,富邦-嘉義,2024-11-20,9692
00950B,凱基A級公司債,35,0,35,富邦-嘉義,2024-11-20,9692
1326,台化,147,115,32,富邦-嘉義,2024-11-20,9692
00953B,群益優選非投等債,30,0,30,富邦-嘉義,2024-11-20,9692
6142,友勁,45,19,26,富邦-嘉義,2024-11-20,9692
3088,艾訊,35,9,26,富邦-嘉義,2024-11-20,9692
3594,磐儀,49,24,25,富邦-嘉義,2024-11-20,9692
4119,旭富,25,0,25,富邦-嘉義,2024-11-20,9692
00679B,元大美債20年,28,4,24,富邦-嘉義,2024-11-20,9692
8261,富鼎,35,11,24,富邦-嘉義,2024-11-20,9692
2356,英業達,139,116,23,富邦-嘉義,2024-11-20,9692
2409,友達,41,20,21,富邦-嘉義,2024-11-20,9692
00945B,凱基美國非投等債,21,0,21,富邦-嘉義,2024-11-20,9692
2603,長榮,1313,1294,19,富邦-嘉義,2024-11-20,9692
00922,國泰台灣領袖50,19,1,18,富邦-嘉義,2024-11-20,9692
6919,康霈*,18,0,18,富邦-嘉義,2024-11-20,9692
2313,華通,20,2,18,富邦-嘉義,2024-11-20,9692
2489,瑞軒,18,0,18,富邦-嘉義,2024-11-20,9692
00938,凱基優選30,18,0,18,富邦-嘉義,2024-11-20,9692
3231,緯創,43,26,17,富邦-嘉義,2024-11-20,9692
3338,泰碩,69,52,17,富邦-嘉義,2024-11-20,9692
2885,元大金,17,0,17,富邦-嘉義,2024-11-20,9692
00935,野村臺灣新科技50,16,0,16,富邦-嘉義,2024-11-20,9692
1722,台肥,15,0,15,富邦-嘉義,2024-11-20,9692
3580,友威科,16,1,15,富邦-嘉義,2024-11-20,9692
6443,元晶,15,0,15,富邦-嘉義,2024-11-20,9692
6282,康舒,130,116,14,富邦-嘉義,2024-11-20,9692
3511,矽瑪,44,30,14,富邦-嘉義,2024-11-20,9692
2353,宏��,13,0,13,富邦-嘉義,2024-11-20,9692
00713,元大台灣高息低波,14,1,13,富邦-嘉義,2024-11-20,9692
5871,中租-KY,14,1,13,富邦-嘉義,2024-11-20,9692
2324,仁寶,14,2,12,富邦-嘉義,2024-11-20,9692
2312,金寶,2357,427,1930,富邦-嘉義,2024-11-21,9692
1815,富喬,509,226,283,富邦-嘉義,2024-11-21,9692
00959B,大華投等美債15Y+,262,0,262,富邦-嘉義,2024-11-21,9692
00953B,群益優選非投等債,256,0,256,富邦-嘉義,2024-11-21,9692
3323,加百裕,464,271,193,富邦-嘉義,2024-11-21,9692
2354,鴻準,783,652,131,富邦-嘉義,2024-11-21,9692
6138,茂達,124,0,124,富邦-嘉義,2024-11-21,9692
6274,台燿,504,387,117,富邦-嘉義,2024-11-21,9692
00901,永豐智能車供應鏈,116,0,116,富邦-嘉義,2024-11-21,9692
00650L,復華香港正2,107,2,105,富邦-嘉義,2024-11-21,9692
00753L,中信中國50正2,77,8,69,富邦-嘉義,2024-11-21,9692
2303,聯電,71,5,66,富邦-嘉義,2024-11-21,9692
006208,富邦台50,65,0,65,富邦-嘉義,2024-11-21,9692
2881,富邦金,63,4,59,富邦-嘉義,2024-11-21,9692
2408,南亞科,65,8,57,富邦-嘉義,2024-11-21,9692
2371,大同,90,40,50,富邦-嘉義,2024-11-21,9692
3511,矽瑪,264,214,50,富邦-嘉義,2024-11-21,9692
2337,旺宏,51,3,48,富邦-嘉義,2024-11-21,9692
6558,興能高,69,23,46,富邦-嘉義,2024-11-21,9692
8038,長園科,49,7,42,富邦-嘉義,2024-11-21,9692
3712,永崴投控,45,4,41,富邦-嘉義,2024-11-21,9692
2537,聯上發,42,1,41,富邦-嘉義,2024-11-21,9692
2618,長榮航,195,156,39,富邦-嘉義,2024-11-21,9692
1449,佳和,129,90,39,富邦-嘉義,2024-11-21,9692
3062,建漢,47,10,37,富邦-嘉義,2024-11-21,9692
3290,東浦,45,10,35,富邦-嘉義,2024-11-21,9692
00919,群益台灣精選高息,60,26,34,富邦-嘉義,2024-11-21,9692
4931,新盛力,252,219,33,富邦-嘉義,2024-11-21,9692
2330,台積電,83,50,33,富邦-嘉義,2024-11-21,9692
3211,順達,125,93,32,富邦-嘉義,2024-11-21,9692
00922,國泰台灣領袖50,32,0,32,富邦-嘉義,2024-11-21,9692
2884,玉山金,34,3,31,富邦-嘉義,2024-11-21,9692
2605,新興,31,0,31,富邦-嘉義,2024-11-21,9692
2905,三商,30,0,30,富邦-嘉義,2024-11-21,9692
4971,IET-KY,65,38,27,富邦-嘉義,2024-11-21,9692
8929,富堡,61,35,26,富邦-嘉義,2024-11-21,9692
1303,南亞,37,15,22,富邦-嘉義,2024-11-21,9692
3625,西勝,24,4,20,富邦-嘉義,2024-11-21,9692
0050,元大台灣50,19,0,19,富邦-嘉義,2024-11-21,9692
3032,偉訓,64,45,19,富邦-嘉義,2024-11-21,9692
2915,潤泰全,21,2,19,富邦-嘉義,2024-11-21,9692
3597,映興,30,11,19,富邦-嘉義,2024-11-21,9692
4956,光鋐,47,28,19,富邦-嘉義,2024-11-21,9692
00878,國泰永續高股息,60,42,18,富邦-嘉義,2024-11-21,9692
5347,世界,25,8,17,富邦-嘉義,2024-11-21,9692
3088,艾訊,23,6,17,富邦-嘉義,2024-11-21,9692
00930,永豐ESG低碳高息,17,0,17,富邦-嘉義,2024-11-21,9692
2880,華南金,28,12,16,富邦-嘉義,2024-11-21,9692
3450,聯鈞,251,235,16,富邦-嘉義,2024-11-21,9692
1708,東鹼,20,4,16,富邦-嘉義,2024-11-21,9692
2371,大同,3351,380,2971,富邦-嘉義,2024-11-22,9692
2312,金寶,2457,1041,1416,富邦-嘉義,2024-11-22,9692
00887,永豐中國科技50大,430,9,421,富邦-嘉義,2024-11-22,9692
00919,群益台灣精選高息,298,47,251,富邦-嘉義,2024-11-22,9692
1809,中釉,880,678,202,富邦-嘉義,2024-11-22,9692
00930,永豐ESG低碳高息,173,0,173,富邦-嘉義,2024-11-22,9692
2392,正崴,200,38,162,富邦-嘉義,2024-11-22,9692
00953B,群益優選非投等債,144,42,102,富邦-嘉義,2024-11-22,9692
9105,泰金寶-DR,1976,1880,96,富邦-嘉義,2024-11-22,9692
00632R,元大台灣50反1,162,81,81,富邦-嘉義,2024-11-22,9692
3712,永崴投控,728,649,79,富邦-嘉義,2024-11-22,9692
00948B,中信優息投資級債,69,0,69,富邦-嘉義,2024-11-22,9692
2834,臺企銀,66,1,65,富邦-嘉義,2024-11-22,9692
00959B,大華投等美債15Y+,57,0,57,富邦-嘉義,2024-11-22,9692
5309,系統電,312,263,49,富邦-嘉義,2024-11-22,9692
2356,英業達,166,118,48,富邦-嘉義,2024-11-22,9692
2609,陽明,97,52,45,富邦-嘉義,2024-11-22,9692
1722,台肥,43,0,43,富邦-嘉義,2024-11-22,9692
2354,鴻準,111,71,40,富邦-嘉義,2024-11-22,9692
2317,鴻海,57,20,37,富邦-嘉義,2024-11-22,9692
6770,力積電,39,2,37,富邦-嘉義,2024-11-22,9692
3027,盛達,1001,965,36,富邦-嘉義,2024-11-22,9692
00915,凱基優選高股息30,48,13,35,富邦-嘉義,2024-11-22,9692
00713,元大台灣高息低波,35,1,34,富邦-嘉義,2024-11-22,9692
1303,南亞,42,10,32,富邦-嘉義,2024-11-22,9692
3499,環天科,49,19,30,富邦-嘉義,2024-11-22,9692
8171,天宇,109,79,30,富邦-嘉義,2024-11-22,9692
1587,吉茂,27,0,27,富邦-嘉義,2024-11-22,9692
3597,映興,57,31,26,富邦-嘉義,2024-11-22,9692
00753L,中信中國50正2,30,7,23,富邦-嘉義,2024-11-22,9692
2413,環科,38,15,23,富邦-嘉義,2024-11-22,9692
2204,中華,37,15,22,富邦-嘉義,2024-11-22,9692
2891,中信金,24,2,22,富邦-嘉義,2024-11-22,9692
4571,鈞興-KY,31,9,22,富邦-嘉義,2024-11-22,9692
00679B,元大美債20年,33,11,22,富邦-嘉義,2024-11-22,9692
4958,臻鼎-KY,33,12,21,富邦-嘉義,2024-11-22,9692
2547,日勝生,22,1,21,富邦-嘉義,2024-11-22,9692
5608,四維航,21,0,21,富邦-嘉義,2024-11-22,9692
2867,三商壽,95,75,20,富邦-嘉義,2024-11-22,9692
1708,東鹼,25,6,19,富邦-嘉義,2024-11-22,9692
2233,宇隆,38,20,18,富邦-嘉義,2024-11-22,9692
1449,佳和,26,9,17,富邦-嘉義,2024-11-22,9692
2905,三商,17,0,17,富邦-嘉義,2024-11-22,9692
2881,富邦金,18,3,15,富邦-嘉義,2024-11-22,9692
2887,台新金,16,1,15,富邦-嘉義,2024-11-22,9692
00751B,元大AAA至A公司債,15,1,14,富邦-嘉義,2024-11-22,9692
3702,大聯大,14,0,14,富邦-嘉義,2024-11-22,9692
8111,立��,32,18,14,富邦-嘉義,2024-11-22,9692
6134,萬旭,59,45,14,富邦-嘉義,2024-11-22,9692
2070,精湛,18,4,14,富邦-嘉義,2024-11-22,9692
2312,金寶,2303,1062,1241,富邦-嘉義,2024-11-25,9692
3706,神達,3743,3204,539,富邦-嘉義,2024-11-25,9692
6558,興能高,539,201,338,富邦-嘉義,2024-11-25,9692
9105,泰金寶-DR,1665,1433,232,富邦-嘉義,2024-11-25,9692
3323,加百裕,746,539,207,富邦-嘉義,2024-11-25,9692
00953B,群益優選非投等債,180,9,171,富邦-嘉義,2024-11-25,9692
3090,日電貿,174,38,136,富邦-嘉義,2024-11-25,9692
00950B,凱基A級公司債,130,5,125,富邦-嘉義,2024-11-25,9692
00901,永豐智能車供應鏈,116,0,116,富邦-嘉義,2024-11-25,9692
4979,華星光,213,101,112,富邦-嘉義,2024-11-25,9692
2891,中信金,112,10,102,富邦-嘉義,2024-11-25,9692
00948B,中信優息投資級債,100,10,90,富邦-嘉義,2024-11-25,9692
2392,正崴,5014,4925,89,富邦-嘉義,2024-11-25,9692
2316,楠梓電,139,51,88,富邦-嘉義,2024-11-25,9692
00919,群益台灣精選高息,78,13,65,富邦-嘉義,2024-11-25,9692
2834,臺企銀,63,4,59,富邦-嘉義,2024-11-25,9692
3032,偉訓,59,5,54,富邦-嘉義,2024-11-25,9692
2002,中鋼,50,2,48,富邦-嘉義,2024-11-25,9692
4303,信立,149,103,46,富邦-嘉義,2024-11-25,9692
2618,長榮航,163,117,46,富邦-嘉義,2024-11-25,9692
8171,天宇,84,42,42,富邦-嘉義,2024-11-25,9692
5880,合庫金,41,0,41,富邦-嘉義,2024-11-25,9692
1714,和桐,51,12,39,富邦-嘉義,2024-11-25,9692
1432,大魯閣,38,1,37,富邦-嘉義,2024-11-25,9692
2012,春雨,36,0,36,富邦-嘉義,2024-11-25,9692
3363,上詮,45,10,35,富邦-嘉義,2024-11-25,9692
2027,大成鋼,34,0,34,富邦-嘉義,2024-11-25,9692
6877,鏵友益,34,0,34,富邦-嘉義,2024-11-25,9692
3715,定穎投控,36,3,33,富邦-嘉義,2024-11-25,9692
2603,長榮,56,24,32,富邦-嘉義,2024-11-25,9692
2449,京元電子,38,7,31,富邦-嘉義,2024-11-25,9692
00945B,凱基美國非投等債,40,10,30,富邦-嘉義,2024-11-25,9692
3293,鈊象,33,3,30,富邦-嘉義,2024-11-25,9692
2444,兆勁,36,7,29,富邦-嘉義,2024-11-25,9692
5426,振發,37,9,28,富邦-嘉義,2024-11-25,9692
6282,康舒,169,143,26,富邦-嘉義,2024-11-25,9692
2615,萬海,37,13,24,富邦-嘉義,2024-11-25,9692
3056,富華新,24,0,24,富邦-嘉義,2024-11-25,9692
8926,台汽電,23,0,23,富邦-嘉義,2024-11-25,9692
5876,上海商銀,21,0,21,富邦-嘉義,2024-11-25,9692
2344,華邦電,25,4,21,富邦-嘉義,2024-11-25,9692
00664R,國泰臺灣加權反1,20,0,20,富邦-嘉義,2024-11-25,9692
2609,陽明,88,68,20,富邦-嘉義,2024-11-25,9692
3710,連展投控,30,11,19,富邦-嘉義,2024-11-25,9692
2367,燿華,38,19,19,富邦-嘉義,2024-11-25,9692
2313,華通,38,19,19,富邦-嘉義,2024-11-25,9692
8038,長園科,23,5,18,富邦-嘉義,2024-11-25,9692
2323,中環,18,0,18,富邦-嘉義,2024-11-25,9692
2332,友訊,51,33,18,富邦-嘉義,2024-11-25,9692
2330,台積電,19,1,18,富邦-嘉義,2024-11-25,9692
8028,昇陽半導體,506,3,503,富邦-嘉義,2024-11-26,9692
00887,永豐中國科技50大,393,1,392,富邦-嘉義,2024-11-26,9692
4510,高鋒,800,488,312,富邦-嘉義,2024-11-26,9692
2312,金寶,1250,1056,194,富邦-嘉義,2024-11-26,9692
2317,鴻海,206,69,137,富邦-嘉義,2024-11-26,9692
2316,楠梓電,149,20,129,富邦-嘉義,2024-11-26,9692
1536,和大,640,524,116,富邦-嘉義,2024-11-26,9692
9105,泰金寶-DR,231,132,99,富邦-嘉義,2024-11-26,9692
00915,凱基優選高股息30,93,0,93,富邦-嘉義,2024-11-26,9692
00965,元大航太防衛科技,87,4,83,富邦-嘉義,2024-11-26,9692
2419,仲琦,306,225,81,富邦-嘉義,2024-11-26,9692
3231,緯創,107,39,68,富邦-嘉義,2024-11-26,9692
2547,日勝生,58,2,56,富邦-嘉義,2024-11-26,9692
4562,穎漢,201,145,56,富邦-嘉義,2024-11-26,9692
00878,國泰永續高股息,68,14,54,富邦-嘉義,2024-11-26,9692
2834,臺企銀,63,11,52,富邦-嘉義,2024-11-26,9692
00919,群益台灣精選高息,63,12,51,富邦-嘉義,2024-11-26,9692
006208,富邦台50,55,6,49,富邦-嘉義,2024-11-26,9692
5309,系統電,286,237,49,富邦-嘉義,2024-11-26,9692
3481,群創,57,9,48,富邦-嘉義,2024-11-26,9692
00882,中信中國高股息,47,0,47,富邦-嘉義,2024-11-26,9692
4956,光鋐,55,9,46,富邦-嘉義,2024-11-26,9692
2103,台橡,42,0,42,富邦-嘉義,2024-11-26,9692
1449,佳和,46,7,39,富邦-嘉義,2024-11-26,9692
2609,陽明,55,18,37,富邦-嘉義,2024-11-26,9692
2439,美律,37,1,36,富邦-嘉義,2024-11-26,9692
3710,連展投控,49,13,36,富邦-嘉義,2024-11-26,9692
00930,永豐ESG低碳高息,36,0,36,富邦-嘉義,2024-11-26,9692
5880,合庫金,35,0,35,富邦-嘉義,2024-11-26,9692
00951,台新日本半導體,30,0,30,富邦-嘉義,2024-11-26,9692
3515,華擎,35,6,29,富邦-嘉義,2024-11-26,9692
2431,聯昌,31,4,27,富邦-嘉義,2024-11-26,9692
6877,鏵友益,26,0,26,富邦-嘉義,2024-11-26,9692
2344,華邦電,33,7,26,富邦-嘉義,2024-11-26,9692
3712,永崴投控,44,19,25,富邦-嘉義,2024-11-26,9692
00922,國泰台灣領袖50,22,0,22,富邦-嘉義,2024-11-26,9692
4931,新盛力,169,148,21,富邦-嘉義,2024-11-26,9692
2332,友訊,24,4,20,富邦-嘉義,2024-11-26,9692
00934,中信成長高股息,20,0,20,富邦-嘉義,2024-11-26,9692
00725B,國泰投資級公司債,20,0,20,富邦-嘉義,2024-11-26,9692
2206,三陽工業,20,0,20,富邦-嘉義,2024-11-26,9692
00715L,期街口布蘭特正2,31,13,18,富邦-嘉義,2024-11-26,9692
1522,堤維西,25,7,18,富邦-嘉義,2024-11-26,9692
6282,康舒,26,8,18,富邦-嘉義,2024-11-26,9692
4991,環宇-KY,38,20,18,富邦-嘉義,2024-11-26,9692
2426,鼎元,79,62,17,富邦-嘉義,2024-11-26,9692
2020,美亞,17,0,17,富邦-嘉義,2024-11-26,9692
2354,鴻準,31,15,16,富邦-嘉義,2024-11-26,9692
6134,萬旭,19,3,16,富邦-嘉義,2024-11-26,9692
1726,永記,16,0,16,富邦-嘉義,2024-11-26,9692
3706,神達,4783,4318,465,富邦-嘉義,2024-11-27,9692
00919,群益台灣精選高息,470,60,410,富邦-嘉義,2024-11-27,9692
2312,金寶,3228,2832,396,富邦-嘉義,2024-11-27,9692
00673R,期元大S＆P原油反1,309,2,307,富邦-嘉義,2024-11-27,9692
2303,聯電,338,58,280,富邦-嘉義,2024-11-27,9692
0056,元大高股息,301,62,239,富邦-嘉義,2024-11-27,9692
00878,國泰永續高股息,304,75,229,富邦-嘉義,2024-11-27,9692
00664R,國泰臺灣加權反1,210,0,210,富邦-嘉義,2024-11-27,9692
00918,大華優利高填息30,233,47,186,富邦-嘉義,2024-11-27,9692
2316,楠梓電,187,5,182,富邦-嘉義,2024-11-27,9692
8038,長園科,162,9,153,富邦-嘉義,2024-11-27,9692
00940,元大台灣價值高息,159,7,152,富邦-嘉義,2024-11-27,9692
3231,緯創,164,32,132,富邦-嘉義,2024-11-27,9692
00932,兆豐永續高息等權,116,0,116,富邦-嘉義,2024-11-27,9692
2609,陽明,192,87,105,富邦-嘉義,2024-11-27,9692
2301,光寶科,123,22,101,富邦-嘉義,2024-11-27,9692
2374,佳能,100,3,97,富邦-嘉義,2024-11-27,9692
6142,友勁,92,1,91,富邦-嘉義,2024-11-27,9692
5452,佶優,82,1,81,富邦-嘉義,2024-11-27,9692
6770,力積電,91,12,79,富邦-嘉義,2024-11-27,9692
2344,華邦電,74,7,67,富邦-嘉義,2024-11-27,9692
2409,友達,66,0,66,富邦-嘉義,2024-11-27,9692
6138,茂達,66,1,65,富邦-嘉義,2024-11-27,9692
006208,富邦台50,81,17,64,富邦-嘉義,2024-11-27,9692
2392,正崴,492,432,60,富邦-嘉義,2024-11-27,9692
00921,兆豐龍頭等權重,60,0,60,富邦-嘉義,2024-11-27,9692
2890,永豐金,60,1,59,富邦-嘉義,2024-11-27,9692
00891,中信關鍵半導體,57,0,57,富邦-嘉義,2024-11-27,9692
2371,大同,78,23,55,富邦-嘉義,2024-11-27,9692
4971,IET-KY,91,37,54,富邦-嘉義,2024-11-27,9692
2317,鴻海,161,108,53,富邦-嘉義,2024-11-27,9692
2408,南亞科,58,6,52,富邦-嘉義,2024-11-27,9692
2330,台積電,62,11,51,富邦-嘉義,2024-11-27,9692
2834,臺企銀,51,1,50,富邦-嘉義,2024-11-27,9692
00715L,期街口布蘭特正2,47,1,46,富邦-嘉義,2024-11-27,9692
2615,萬海,60,22,38,富邦-嘉義,2024-11-27,9692
3209,全科,37,0,37,富邦-嘉義,2024-11-27,9692
00950B,凱基A級公司債,35,0,35,富邦-嘉義,2024-11-27,9692
2881,富邦金,35,1,34,富邦-嘉義,2024-11-27,9692
2547,日勝生,35,1,34,富邦-嘉義,2024-11-27,9692
2070,精湛,81,48,33,富邦-嘉義,2024-11-27,9692
3597,映興,117,87,30,富邦-嘉義,2024-11-27,9692
9934,成霖,30,0,30,富邦-嘉義,2024-11-27,9692
00706L,期元大S＆P日圓正2,30,0,30,富邦-嘉義,2024-11-27,9692
6505,台塑化,32,3,29,富邦-嘉義,2024-11-27,9692
2356,英業達,34,5,29,富邦-嘉義,2024-11-27,9692
8163,達方,187,158,29,富邦-嘉義,2024-11-27,9692
4526,東台,485,457,28,富邦-嘉義,2024-11-27,9692
2603,長榮,572,546,26,富邦-嘉義,2024-11-27,9692
2323,中環,26,0,26,富邦-嘉義,2024-11-27,9692
00950B,凱基A級公司債,491,0,491,富邦-嘉義,2024-11-28,9692
00919,群益台灣精選高息,454,42,412,富邦-嘉義,2024-11-28,9692
1815,富喬,1591,1267,324,富邦-嘉義,2024-11-28,9692
00878,國泰永續高股息,340,38,302,富邦-嘉義,2024-11-28,9692
6530,創威,289,85,204,富邦-嘉義,2024-11-28,9692
00664R,國泰臺灣加權反1,200,5,195,富邦-嘉義,2024-11-28,9692
2316,楠梓電,166,11,155,富邦-嘉義,2024-11-28,9692
0056,元大高股息,155,18,137,富邦-嘉義,2024-11-28,9692
9105,泰金寶-DR,638,518,120,富邦-嘉義,2024-11-28,9692
4927,泰鼎-KY,158,44,114,富邦-嘉義,2024-11-28,9692
3323,加百裕,189,95,94,富邦-嘉義,2024-11-28,9692
3481,群創,114,35,79,富邦-嘉義,2024-11-28,9692
2303,聯電,220,142,78,富邦-嘉義,2024-11-28,9692
3090,日電貿,391,320,71,富邦-嘉義,2024-11-28,9692
6558,興能高,200,133,67,富邦-嘉義,2024-11-28,9692
3014,聯陽,67,1,66,富邦-嘉義,2024-11-28,9692
00927,群益半導體收益,66,0,66,富邦-嘉義,2024-11-28,9692
00929,復華台灣科技優息,166,102,64,富邦-嘉義,2024-11-28,9692
3625,西勝,69,9,60,富邦-嘉義,2024-11-28,9692
00940,元大台灣價值高息,70,10,60,富邦-嘉義,2024-11-28,9692
00921,兆豐龍頭等權重,56,0,56,富邦-嘉義,2024-11-28,9692
8028,昇陽半導體,60,5,55,富邦-嘉義,2024-11-28,9692
00715L,期街口布蘭特正2,43,0,43,富邦-嘉義,2024-11-28,9692
2344,華邦電,58,16,42,富邦-嘉義,2024-11-28,9692
00915,凱基優選高股息30,41,1,40,富邦-嘉義,2024-11-28,9692
8240,華宏,48,9,39,富邦-嘉義,2024-11-28,9692
5452,佶優,39,0,39,富邦-嘉義,2024-11-28,9692
00753L,中信中國50正2,99,60,39,富邦-嘉義,2024-11-28,9692
2408,南亞科,50,13,37,富邦-嘉義,2024-11-28,9692
006208,富邦台50,42,10,32,富邦-嘉義,2024-11-28,9692
3211,順達,229,198,31,富邦-嘉義,2024-11-28,9692
00935,野村臺灣新科技50,31,0,31,富邦-嘉義,2024-11-28,9692
00922,國泰台灣領袖50,48,17,31,富邦-嘉義,2024-11-28,9692
1304,台聚,31,0,31,富邦-嘉義,2024-11-28,9692
2905,三商,34,4,30,富邦-嘉義,2024-11-28,9692
3071,協禧,30,0,30,富邦-嘉義,2024-11-28,9692
2419,仲琦,32,2,30,富邦-嘉義,2024-11-28,9692
3515,華擎,30,0,30,富邦-嘉義,2024-11-28,9692
00637L,元大滬深300正2,45,16,29,富邦-嘉義,2024-11-28,9692
6505,台塑化,37,9,28,富邦-嘉義,2024-11-28,9692
2332,友訊,150,122,28,富邦-嘉義,2024-11-28,9692
00725B,國泰投資級公司債,30,3,27,富邦-嘉義,2024-11-28,9692
1711,永光,32,5,27,富邦-嘉義,2024-11-28,9692
4306,炎洲,27,0,27,富邦-嘉義,2024-11-28,9692
00930,永豐ESG低碳高息,26,0,26,富邦-嘉義,2024-11-28,9692
2313,華通,42,17,25,富邦-嘉義,2024-11-28,9692
00706L,期元大S＆P日圓正2,23,0,23,富邦-嘉義,2024-11-28,9692
00905,FT臺灣Smart,28,6,22,富邦-嘉義,2024-11-28,9692
2834,臺企銀,21,1,20,富邦-嘉義,2024-11-28,9692
2204,中華,26,6,20,富邦-嘉義,2024-11-28,9692
00632R,元大台灣50反1,467,2,465,富邦-嘉義,2024-11-29,9692
00878,國泰永續高股息,211,10,201,富邦-嘉義,2024-11-29,9692
6558,興能高,640,464,176,富邦-嘉義,2024-11-29,9692
00919,群益台灣精選高息,151,26,125,富邦-嘉義,2024-11-29,9692
1301,台塑,130,5,125,富邦-嘉義,2024-11-29,9692
2312,金寶,1418,1317,101,富邦-嘉義,2024-11-29,9692
3211,順達,794,700,94,富邦-嘉義,2024-11-29,9692
4726,永昕,129,36,93,富邦-嘉義,2024-11-29,9692
2834,臺企銀,73,1,72,富邦-嘉義,2024-11-29,9692
00909,國泰數位支付服務,75,7,68,富邦-嘉義,2024-11-29,9692
4931,新盛力,506,443,63,富邦-嘉義,2024-11-29,9692
00713,元大台灣高息低波,63,1,62,富邦-嘉義,2024-11-29,9692
00953B,群益優選非投等債,63,2,61,富邦-嘉義,2024-11-29,9692
2344,華邦電,62,8,54,富邦-嘉義,2024-11-29,9692
5244,弘凱,209,155,54,富邦-嘉義,2024-11-29,9692
5880,合庫金,63,14,49,富邦-嘉義,2024-11-29,9692
1722,台肥,45,0,45,富邦-嘉義,2024-11-29,9692
1304,台聚,43,0,43,富邦-嘉義,2024-11-29,9692
0056,元大高股息,60,18,42,富邦-嘉義,2024-11-29,9692
6257,矽格,42,0,42,富邦-嘉義,2024-11-29,9692
2002,中鋼,52,10,42,富邦-嘉義,2024-11-29,9692
4968,立積,57,16,41,富邦-嘉義,2024-11-29,9692
6505,台塑化,117,77,40,富邦-嘉義,2024-11-29,9692
8038,長園科,45,5,40,富邦-嘉義,2024-11-29,9692
2547,日勝生,40,0,40,富邦-嘉義,2024-11-29,9692
4510,高鋒,69,31,38,富邦-嘉義,2024-11-29,9692
4927,泰鼎-KY,49,13,36,富邦-嘉義,2024-11-29,9692
2881,富邦金,37,1,36,富邦-嘉義,2024-11-29,9692
6288,聯嘉,34,1,33,富邦-嘉義,2024-11-29,9692
2303,聯電,45,12,33,富邦-嘉義,2024-11-29,9692
2615,萬海,47,15,32,富邦-嘉義,2024-11-29,9692
00960,野村全球航運龍頭,32,0,32,富邦-嘉義,2024-11-29,9692
00918,大華優利高填息30,42,10,32,富邦-嘉義,2024-11-29,9692
2801,彰銀,30,0,30,富邦-嘉義,2024-11-29,9692
2609,陽明,62,33,29,富邦-嘉義,2024-11-29,9692
2332,友訊,61,35,26,富邦-嘉義,2024-11-29,9692
5871,中租-KY,54,30,24,富邦-嘉義,2024-11-29,9692
2392,正崴,60,37,23,富邦-嘉義,2024-11-29,9692
00959B,大華投等美債15Y+,22,0,22,富邦-嘉義,2024-11-29,9692
2374,佳能,23,2,21,富邦-嘉義,2024-11-29,9692
4562,穎漢,41,23,18,富邦-嘉義,2024-11-29,9692
3202,樺晟,19,1,18,富邦-嘉義,2024-11-29,9692
2317,鴻海,746,728,18,富邦-嘉義,2024-11-29,9692
2891,中信金,17,0,17,富邦-嘉義,2024-11-29,9692
2884,玉山金,23,7,16,富邦-嘉義,2024-11-29,9692
3673,TPK-KY,16,0,16,富邦-嘉義,2024-11-29,9692
1799,易威,16,0,16,富邦-嘉義,2024-11-29,9692
4960,誠美材,16,0,16,富邦-嘉義,2024-11-29,9692
1605,華新,36,21,15,富邦-嘉義,2024-11-29,9692
1563,巧新,15,0,15,富邦-嘉義,2024-11-29,9692
00918,大華優利高填息30,383,1,382,富邦-嘉義,2024-12-02,9692
2324,仁寶,355,37,318,富邦-嘉義,2024-12-02,9692
00632R,元大台灣50反1,197,8,189,富邦-嘉義,2024-12-02,9692
4977,眾達-KY,268,144,124,富邦-嘉義,2024-12-02,9692
9105,泰金寶-DR,183,61,122,富邦-嘉義,2024-12-02,9692
2387,精元,100,0,100,富邦-嘉義,2024-12-02,9692
5907,大洋-KY,113,13,100,富邦-嘉義,2024-12-02,9692
00945B,凱基美國非投等債,121,30,91,富邦-嘉義,2024-12-02,9692
5328,華容,250,161,89,富邦-嘉義,2024-12-02,9692
3209,全科,65,3,62,富邦-嘉義,2024-12-02,9692
2317,鴻海,68,19,49,富邦-嘉義,2024-12-02,9692
00715L,期街口布蘭特正2,54,8,46,富邦-嘉義,2024-12-02,9692
2002,中鋼,47,2,45,富邦-嘉義,2024-12-02,9692
00919,群益台灣精選高息,137,93,44,富邦-嘉義,2024-12-02,9692
2312,金寶,229,185,44,富邦-嘉義,2024-12-02,9692
2444,兆勁,59,18,41,富邦-嘉義,2024-12-02,9692
1605,華新,57,22,35,富邦-嘉義,2024-12-02,9692
2419,仲琦,110,76,34,富邦-嘉義,2024-12-02,9692
00948B,中信優息投資級債,41,10,31,富邦-嘉義,2024-12-02,9692
5439,高技,35,4,31,富邦-嘉義,2024-12-02,9692
3013,晟銘電,31,1,30,富邦-嘉義,2024-12-02,9692
6962,ITH-KY,43,13,30,富邦-嘉義,2024-12-02,9692
4123,晟德,43,14,29,富邦-嘉義,2024-12-02,9692
2354,鴻準,63,39,24,富邦-嘉義,2024-12-02,9692
00922,國泰台灣領袖50,24,0,24,富邦-嘉義,2024-12-02,9692
2344,華邦電,70,47,23,富邦-嘉義,2024-12-02,9692
4979,華星光,590,567,23,富邦-嘉義,2024-12-02,9692
8042,金山電,149,127,22,富邦-嘉義,2024-12-02,9692
1584,精剛,20,0,20,富邦-嘉義,2024-12-02,9692
2836,高雄銀,20,0,20,富邦-嘉義,2024-12-02,9692
3354,律勝,20,0,20,富邦-嘉義,2024-12-02,9692
1802,台玻,49,29,20,富邦-嘉義,2024-12-02,9692
00942B,台新美A公司債20+,20,0,20,富邦-嘉義,2024-12-02,9692
5498,凱崴,20,0,20,富邦-嘉義,2024-12-02,9692
1722,台肥,20,0,20,富邦-嘉義,2024-12-02,9692
3024,憶聲,24,7,17,富邦-嘉義,2024-12-02,9692
3230,錦明,18,1,17,富邦-嘉義,2024-12-02,9692
5210,寶碩,17,0,17,富邦-嘉義,2024-12-02,9692
6770,力積電,21,5,16,富邦-嘉義,2024-12-02,9692
6117,迎廣,30,14,16,富邦-嘉義,2024-12-02,9692
4960,誠美材,16,0,16,富邦-嘉義,2024-12-02,9692
2426,鼎元,125,109,16,富邦-嘉義,2024-12-02,9692
5465,富驊,22,6,16,富邦-嘉義,2024-12-02,9692
5371,中光電,97,82,15,富邦-嘉義,2024-12-02,9692
2547,日勝生,15,0,15,富邦-嘉義,2024-12-02,9692
2314,台揚,14,0,14,富邦-嘉義,2024-12-02,9692
8171,天宇,79,65,14,富邦-嘉義,2024-12-02,9692
4991,環宇-KY,308,294,14,富邦-嘉義,2024-12-02,9692
2371,大同,22,8,14,富邦-嘉義,2024-12-02,9692
3548,兆利,30,16,14,富邦-嘉義,2024-12-02,9692
3706,神達,4484,1566,2918,富邦-嘉義,2024-12-03,9692
3211,順達,655,171,484,富邦-嘉義,2024-12-03,9692
00919,群益台灣精選高息,697,245,452,富邦-嘉義,2024-12-03,9692
00918,大華優利高填息30,332,2,330,富邦-嘉義,2024-12-03,9692
00959B,大華投等美債15Y+,265,28,237,富邦-嘉義,2024-12-03,9692
5880,合庫金,208,7,201,富邦-嘉義,2024-12-03,9692
3024,憶聲,209,10,199,富邦-嘉義,2024-12-03,9692
00915,凱基優選高股息30,197,4,193,富邦-嘉義,2024-12-03,9692
00665L,富邦�琤肭磪囓�2,101,0,101,富邦-嘉義,2024-12-03,9692
1449,佳和,334,238,96,富邦-嘉義,2024-12-03,9692
00715L,期街口布蘭特正2,68,0,68,富邦-嘉義,2024-12-03,9692
00878,國泰永續高股息,105,39,66,富邦-嘉義,2024-12-03,9692
2317,鴻海,586,522,64,富邦-嘉義,2024-12-03,9692
00930,永豐ESG低碳高息,60,0,60,富邦-嘉義,2024-12-03,9692
3481,群創,177,120,57,富邦-嘉義,2024-12-03,9692
6558,興能高,216,160,56,富邦-嘉義,2024-12-03,9692
1522,堤維西,60,8,52,富邦-嘉義,2024-12-03,9692
5309,系統電,94,43,51,富邦-嘉義,2024-12-03,9692
1319,東陽,52,2,50,富邦-嘉義,2024-12-03,9692
6781,AES-KY,79,31,48,富邦-嘉義,2024-12-03,9692
4931,新盛力,177,129,48,富邦-嘉義,2024-12-03,9692
2387,精元,50,4,46,富邦-嘉義,2024-12-03,9692
5244,弘凱,65,20,45,富邦-嘉義,2024-12-03,9692
1605,華新,44,1,43,富邦-嘉義,2024-12-03,9692
3323,加百裕,252,211,41,富邦-嘉義,2024-12-03,9692
3380,明泰,150,114,36,富邦-嘉義,2024-12-03,9692
00650L,復華香港正2,38,2,36,富邦-嘉義,2024-12-03,9692
2303,聯電,48,14,34,富邦-嘉義,2024-12-03,9692
1524,耿鼎,84,51,33,富邦-嘉義,2024-12-03,9692
2354,鴻準,54,22,32,富邦-嘉義,2024-12-03,9692
00905,FT臺灣Smart,31,3,28,富邦-嘉義,2024-12-03,9692
3710,連展投控,39,11,28,富邦-嘉義,2024-12-03,9692
00927,群益半導體收益,35,8,27,富邦-嘉義,2024-12-03,9692
6530,創威,89,64,25,富邦-嘉義,2024-12-03,9692
2337,旺宏,23,2,21,富邦-嘉義,2024-12-03,9692
00948B,中信優息投資級債,55,34,21,富邦-嘉義,2024-12-03,9692
3501,維熹,21,0,21,富邦-嘉義,2024-12-03,9692
2501,國建,20,0,20,富邦-嘉義,2024-12-03,9692
3013,晟銘電,28,8,20,富邦-嘉義,2024-12-03,9692
2855,統一證,20,0,20,富邦-嘉義,2024-12-03,9692
2476,鉅祥,23,4,19,富邦-嘉義,2024-12-03,9692
5210,寶碩,18,0,18,富邦-嘉義,2024-12-03,9692
2929,淘帝-KY,34,17,17,富邦-嘉義,2024-12-03,9692
2344,華邦電,24,8,16,富邦-嘉義,2024-12-03,9692
00922,國泰台灣領袖50,29,13,16,富邦-嘉義,2024-12-03,9692
2375,凱美,25,10,15,富邦-嘉義,2024-12-03,9692
4991,環宇-KY,491,476,15,富邦-嘉義,2024-12-03,9692
3029,零壹,18,4,14,富邦-嘉義,2024-12-03,9692
00945B,凱基美國非投等債,14,0,14,富邦-嘉義,2024-12-03,9692
3049,精金,16,2,14,富邦-嘉義,2024-12-03,9692
6104,創惟,555,56,499,富邦-嘉義,2024-12-04,9692
00918,大華優利高填息30,379,2,377,富邦-嘉義,2024-12-04,9692
5328,華容,725,381,344,富邦-嘉義,2024-12-04,9692
00673R,期元大S＆P原油反1,330,0,330,富邦-嘉義,2024-12-04,9692
00887,永豐中國科技50大,353,23,330,富邦-嘉義,2024-12-04,9692
4931,新盛力,509,302,207,富邦-嘉義,2024-12-04,9692
00687B,國泰20年美債,223,31,192,富邦-嘉義,2024-12-04,9692
9105,泰金寶-DR,435,253,182,富邦-嘉義,2024-12-04,9692
2344,華邦電,179,1,178,富邦-嘉義,2024-12-04,9692
8042,金山電,159,27,132,富邦-嘉義,2024-12-04,9692
00650L,復華香港正2,120,0,120,富邦-嘉義,2024-12-04,9692
00665L,富邦�琤肭磪囓�2,161,42,119,富邦-嘉義,2024-12-04,9692
2312,金寶,164,48,116,富邦-嘉義,2024-12-04,9692
2888,新光金,126,38,88,富邦-嘉義,2024-12-04,9692
00919,群益台灣精選高息,305,226,79,富邦-嘉義,2024-12-04,9692
4977,眾達-KY,129,57,72,富邦-嘉義,2024-12-04,9692
00945B,凱基美國非投等債,134,65,69,富邦-嘉義,2024-12-04,9692
3015,全漢,435,371,64,富邦-嘉義,2024-12-04,9692
00915,凱基優選高股息30,65,2,63,富邦-嘉義,2024-12-04,9692
2392,正崴,82,22,60,富邦-嘉義,2024-12-04,9692
1326,台化,143,84,59,富邦-嘉義,2024-12-04,9692
6558,興能高,513,454,59,富邦-嘉義,2024-12-04,9692
2891,中信金,112,54,58,富邦-嘉義,2024-12-04,9692
1303,南亞,56,2,54,富邦-嘉義,2024-12-04,9692
3548,兆利,93,42,51,富邦-嘉義,2024-12-04,9692
3704,合勤控,79,28,51,富邦-嘉義,2024-12-04,9692
00926,凱基全球菁英55,49,1,48,富邦-嘉義,2024-12-04,9692
00953B,群益優選非投等債,43,0,43,富邦-嘉義,2024-12-04,9692
2303,聯電,54,13,41,富邦-嘉義,2024-12-04,9692
2834,臺企銀,42,1,41,富邦-嘉義,2024-12-04,9692
1722,台肥,36,0,36,富邦-嘉義,2024-12-04,9692
00959B,大華投等美債15Y+,85,50,35,富邦-嘉義,2024-12-04,9692
3234,光環,50,16,34,富邦-嘉義,2024-12-04,9692
1301,台塑,47,13,34,富邦-嘉義,2024-12-04,9692
2337,旺宏,43,11,32,富邦-嘉義,2024-12-04,9692
1504,東元,31,1,30,富邦-嘉義,2024-12-04,9692
2383,台光電,42,12,30,富邦-嘉義,2024-12-04,9692
00950B,凱基A級公司債,100,73,27,富邦-嘉義,2024-12-04,9692
3563,牧德,36,9,27,富邦-嘉義,2024-12-04,9692
2905,三商,26,0,26,富邦-嘉義,2024-12-04,9692
00751B,元大AAA至A公司債,25,0,25,富邦-嘉義,2024-12-04,9692
2349,錸德,296,272,24,富邦-嘉義,2024-12-04,9692
3712,永崴投控,24,0,24,富邦-嘉義,2024-12-04,9692
6505,台塑化,36,12,24,富邦-嘉義,2024-12-04,9692
2405,輔信,25,2,23,富邦-嘉義,2024-12-04,9692
3260,威剛,22,0,22,富邦-嘉義,2024-12-04,9692
6962,ITH-KY,32,10,22,富邦-嘉義,2024-12-04,9692
6174,安��,30,8,22,富邦-嘉義,2024-12-04,9692
2605,新興,25,4,21,富邦-嘉義,2024-12-04,9692
00933B,國泰10Y+金融債,26,5,21,富邦-嘉義,2024-12-04,9692
5457,宣德,1147,99,1048,富邦-嘉義,2024-12-05,9692
00715L,期街口布蘭特正2,238,2,236,富邦-嘉義,2024-12-05,9692
00919,群益台灣精選高息,258,32,226,富邦-嘉義,2024-12-05,9692
3481,群創,178,6,172,富邦-嘉義,2024-12-05,9692
00918,大華優利高填息30,144,8,136,富邦-嘉義,2024-12-05,9692
1595,川寶,255,122,133,富邦-嘉義,2024-12-05,9692
1605,華新,131,5,126,富邦-嘉義,2024-12-05,9692
00953B,群益優選非投等債,106,0,106,富邦-嘉義,2024-12-05,9692
5284,jpp-KY,94,4,90,富邦-嘉義,2024-12-05,9692
2891,中信金,93,14,79,富邦-嘉義,2024-12-05,9692
3380,明泰,88,13,75,富邦-嘉義,2024-12-05,9692
3211,順達,290,217,73,富邦-嘉義,2024-12-05,9692
4919,新唐,168,97,71,富邦-嘉義,2024-12-05,9692
00665L,富邦�琤肭磪囓�2,70,10,60,富邦-嘉義,2024-12-05,9692
2027,大成鋼,56,2,54,富邦-嘉義,2024-12-05,9692
2486,一詮,86,44,42,富邦-嘉義,2024-12-05,9692
00945B,凱基美國非投等債,42,1,41,富邦-嘉義,2024-12-05,9692
2344,華邦電,198,157,41,富邦-嘉義,2024-12-05,9692
3710,連展投控,50,10,40,富邦-嘉義,2024-12-05,9692
1301,台塑,71,33,38,富邦-嘉義,2024-12-05,9692
3024,憶聲,85,47,38,富邦-嘉義,2024-12-05,9692
6962,ITH-KY,39,2,37,富邦-嘉義,2024-12-05,9692
2371,大同,53,17,36,富邦-嘉義,2024-12-05,9692
3003,健和興,60,24,36,富邦-嘉義,2024-12-05,9692
1471,首利,38,5,33,富邦-嘉義,2024-12-05,9692
1304,台聚,33,0,33,富邦-嘉義,2024-12-05,9692
2601,益航,32,0,32,富邦-嘉義,2024-12-05,9692
3090,日電貿,134,102,32,富邦-嘉義,2024-12-05,9692
5880,合庫金,112,80,32,富邦-嘉義,2024-12-05,9692
2444,兆勁,67,37,30,富邦-嘉義,2024-12-05,9692
2547,日勝生,30,0,30,富邦-嘉義,2024-12-05,9692
8249,菱光,36,7,29,富邦-嘉義,2024-12-05,9692
6426,統新,107,78,29,富邦-嘉義,2024-12-05,9692
2375,凱美,313,286,27,富邦-嘉義,2024-12-05,9692
6127,九豪,107,81,26,富邦-嘉義,2024-12-05,9692
9105,泰金寶-DR,188,163,25,富邦-嘉義,2024-12-05,9692
00753L,中信中國50正2,28,3,25,富邦-嘉義,2024-12-05,9692
5309,系統電,56,32,24,富邦-嘉義,2024-12-05,9692
2457,飛宏,27,4,23,富邦-嘉義,2024-12-05,9692
6901,鑽石投資,24,1,23,富邦-嘉義,2024-12-05,9692
1402,遠東新,22,0,22,富邦-嘉義,2024-12-05,9692
2392,正崴,73,51,22,富邦-嘉義,2024-12-05,9692
3062,建漢,120,100,20,富邦-嘉義,2024-12-05,9692
1563,巧新,20,0,20,富邦-嘉義,2024-12-05,9692
6176,瑞儀,20,0,20,富邦-嘉義,2024-12-05,9692
1718,中纖,20,0,20,富邦-嘉義,2024-12-05,9692
2472,立隆電,33,14,19,富邦-嘉義,2024-12-05,9692
3625,西勝,60,42,18,富邦-嘉義,2024-12-05,9692
5244,弘凱,35,17,18,富邦-嘉義,2024-12-05,9692
4979,華星光,446,429,17,富邦-嘉義,2024-12-05,9692
3706,神達,8384,6330,2054,富邦-嘉義,2024-12-06,9692
2317,鴻海,2052,1038,1014,富邦-嘉義,2024-12-06,9692
2324,仁寶,502,40,462,富邦-嘉義,2024-12-06,9692
6104,創惟,418,65,353,富邦-嘉義,2024-12-06,9692
00715L,期街口布蘭特正2,302,0,302,富邦-嘉義,2024-12-06,9692
2436,偉詮電,285,53,232,富邦-嘉義,2024-12-06,9692
00938,凱基優選30,203,0,203,富邦-嘉義,2024-12-06,9692
2312,金寶,179,38,141,富邦-嘉義,2024-12-06,9692
00946,群益科技高息成長,124,0,124,富邦-嘉義,2024-12-06,9692
00953B,群益優選非投等債,115,0,115,富邦-嘉義,2024-12-06,9692
9105,泰金寶-DR,195,95,100,富邦-嘉義,2024-12-06,9692
00665L,富邦�琤肭磪囓�2,105,7,98,富邦-嘉義,2024-12-06,9692
00918,大華優利高填息30,85,1,84,富邦-嘉義,2024-12-06,9692
2812,台中銀,85,13,72,富邦-嘉義,2024-12-06,9692
6877,鏵友益,81,11,70,富邦-嘉義,2024-12-06,9692
4931,新盛力,847,778,69,富邦-嘉義,2024-12-06,9692
2468,華經,104,37,67,富邦-嘉義,2024-12-06,9692
2399,映泰,412,345,67,富邦-嘉義,2024-12-06,9692
00915,凱基優選高股息30,63,1,62,富邦-嘉義,2024-12-06,9692
00753L,中信中國50正2,81,23,58,富邦-嘉義,2024-12-06,9692
1605,華新,54,5,49,富邦-嘉義,2024-12-06,9692
2354,鴻準,3340,3293,47,富邦-嘉義,2024-12-06,9692
6443,元晶,39,5,34,富邦-嘉義,2024-12-06,9692
8249,菱光,60,33,27,富邦-嘉義,2024-12-06,9692
8069,元太,27,0,27,富邦-嘉義,2024-12-06,9692
6584,南俊國際,27,1,26,富邦-嘉義,2024-12-06,9692
3234,光環,29,3,26,富邦-嘉義,2024-12-06,9692
2388,威盛,33,10,23,富邦-嘉義,2024-12-06,9692
2405,輔信,96,73,23,富邦-嘉義,2024-12-06,9692
2617,台航,23,0,23,富邦-嘉義,2024-12-06,9692
00909,國泰數位支付服務,27,5,22,富邦-嘉義,2024-12-06,9692
4128,中天,36,14,22,富邦-嘉義,2024-12-06,9692
1815,富喬,153,131,22,富邦-嘉義,2024-12-06,9692
5536,聖暉*,23,1,22,富邦-嘉義,2024-12-06,9692
9958,世紀鋼,25,3,22,富邦-嘉義,2024-12-06,9692
6117,迎廣,24,3,21,富邦-嘉義,2024-12-06,9692
1303,南亞,47,26,21,富邦-嘉義,2024-12-06,9692
2332,友訊,23,2,21,富邦-嘉義,2024-12-06,9692
1301,台塑,56,36,20,富邦-嘉義,2024-12-06,9692
00959B,大華投等美債15Y+,20,0,20,富邦-嘉義,2024-12-06,9692
00941,中信上游半導體,19,1,18,富邦-嘉義,2024-12-06,9692
00712,復華富時不動產,38,20,18,富邦-嘉義,2024-12-06,9692
00650L,復華香港正2,20,2,18,富邦-嘉義,2024-12-06,9692
0056,元大高股息,21,3,18,富邦-嘉義,2024-12-06,9692
1471,首利,29,12,17,富邦-嘉義,2024-12-06,9692
00646,元大S＆P500,17,0,17,富邦-嘉義,2024-12-06,9692
4979,華星光,105,88,17,富邦-嘉義,2024-12-06,9692
2646,星宇航空,23,6,17,富邦-嘉義,2024-12-06,9692
00878,國泰永續高股息,35,18,17,富邦-嘉義,2024-12-06,9692
2547,日勝生,16,0,16,富邦-嘉義,2024-12-06,9692
2609,陽明,6945,5142,1803,富邦-嘉義,2024-12-09,9692
3019,亞光,611,16,595,富邦-嘉義,2024-12-09,9692
00715L,期街口布蘭特正2,360,0,360,富邦-嘉義,2024-12-09,9692
00918,大華優利高填息30,421,128,293,富邦-嘉義,2024-12-09,9692
00665L,富邦�琤肭磪囓�2,303,30,273,富邦-嘉義,2024-12-09,9692
2344,華邦電,151,3,148,富邦-嘉義,2024-12-09,9692
2887,台新金,191,61,130,富邦-嘉義,2024-12-09,9692
00959B,大華投等美債15Y+,102,6,96,富邦-嘉義,2024-12-09,9692
1304,台聚,87,0,87,富邦-嘉義,2024-12-09,9692
4979,華星光,215,138,77,富邦-嘉義,2024-12-09,9692
2317,鴻海,80,12,68,富邦-嘉義,2024-12-09,9692
00919,群益台灣精選高息,135,69,66,富邦-嘉義,2024-12-09,9692
2801,彰銀,65,2,63,富邦-嘉義,2024-12-09,9692
1471,首利,72,10,62,富邦-嘉義,2024-12-09,9692
3049,精金,100,39,61,富邦-嘉義,2024-12-09,9692
00713,元大台灣高息低波,65,4,61,富邦-嘉義,2024-12-09,9692
6877,鏵友益,95,38,57,富邦-嘉義,2024-12-09,9692
2027,大成鋼,53,1,52,富邦-嘉義,2024-12-09,9692
2615,萬海,143,93,50,富邦-嘉義,2024-12-09,9692
8054,安國,90,46,44,富邦-嘉義,2024-12-09,9692
2495,普安,58,15,43,富邦-嘉義,2024-12-09,9692
2316,楠梓電,48,6,42,富邦-嘉義,2024-12-09,9692
6163,華電網,43,1,42,富邦-嘉義,2024-12-09,9692
2312,金寶,55,18,37,富邦-嘉義,2024-12-09,9692
2201,裕隆,32,0,32,富邦-嘉義,2024-12-09,9692
9105,泰金寶-DR,57,27,30,富邦-嘉義,2024-12-09,9692
1447,力鵬,30,0,30,富邦-嘉義,2024-12-09,9692
6494,九齊,31,1,30,富邦-嘉義,2024-12-09,9692
2812,台中銀,56,27,29,富邦-嘉義,2024-12-09,9692
3712,永崴投控,31,3,28,富邦-嘉義,2024-12-09,9692
00664R,國泰臺灣加權反1,28,0,28,富邦-嘉義,2024-12-09,9692
00878,國泰永續高股息,64,37,27,富邦-嘉義,2024-12-09,9692
2449,京元電子,37,10,27,富邦-嘉義,2024-12-09,9692
00946,群益科技高息成長,27,0,27,富邦-嘉義,2024-12-09,9692
2402,毅嘉,35,9,26,富邦-嘉義,2024-12-09,9692
2332,友訊,37,11,26,富邦-嘉義,2024-12-09,9692
3715,定穎投控,49,24,25,富邦-嘉義,2024-12-09,9692
3710,連展投控,25,0,25,富邦-嘉義,2024-12-09,9692
1709,和益,21,0,21,富邦-嘉義,2024-12-09,9692
2630,亞航,20,0,20,富邦-嘉義,2024-12-09,9692
00725B,國泰投資級公司債,20,0,20,富邦-嘉義,2024-12-09,9692
1708,東鹼,23,4,19,富邦-嘉義,2024-12-09,9692
2301,光寶科,25,6,19,富邦-嘉義,2024-12-09,9692
6443,元晶,24,5,19,富邦-嘉義,2024-12-09,9692
00909,國泰數位支付服務,27,9,18,富邦-嘉義,2024-12-09,9692
2613,中櫃,138,120,18,富邦-嘉義,2024-12-09,9692
2913,農林,26,10,16,富邦-嘉義,2024-12-09,9692
4919,新唐,20,4,16,富邦-嘉義,2024-12-09,9692
1301,台塑,48,32,16,富邦-嘉義,2024-12-09,9692
00922,國泰台灣領袖50,18,2,16,富邦-嘉義,2024-12-09,9692
2354,鴻準,1544,60,1484,富邦-嘉義,2024-12-10,9692
00937B,群益ESG投等債20,353,79,274,富邦-嘉義,2024-12-10,9692
00918,大華優利高填息30,212,30,182,富邦-嘉義,2024-12-10,9692
00637L,元大滬深300正2,227,74,153,富邦-嘉義,2024-12-10,9692
3607,谷崧,293,146,147,富邦-嘉義,2024-12-10,9692
00938,凱基優選30,135,0,135,富邦-嘉義,2024-12-10,9692
6274,台燿,156,22,134,富邦-嘉義,2024-12-10,9692
4977,眾達-KY,162,39,123,富邦-嘉義,2024-12-10,9692
00915,凱基優選高股息30,97,1,96,富邦-嘉義,2024-12-10,9692
1449,佳和,152,60,92,富邦-嘉義,2024-12-10,9692
2317,鴻海,117,36,81,富邦-嘉義,2024-12-10,9692
6140,訊達,83,6,77,富邦-嘉義,2024-12-10,9692
00953B,群益優選非投等債,68,0,68,富邦-嘉義,2024-12-10,9692
9105,泰金寶-DR,98,39,59,富邦-嘉義,2024-12-10,9692
2834,臺企銀,74,16,58,富邦-嘉義,2024-12-10,9692
3209,全科,58,0,58,富邦-嘉義,2024-12-10,9692
6706,惠特,64,14,50,富邦-嘉義,2024-12-10,9692
00946,群益科技高息成長,39,0,39,富邦-嘉義,2024-12-10,9692
1446,宏和,36,1,35,富邦-嘉義,2024-12-10,9692
8404,百和興業-KY,37,2,35,富邦-嘉義,2024-12-10,9692
1584,精剛,31,0,31,富邦-嘉義,2024-12-10,9692
0056,元大高股息,42,11,31,富邦-嘉義,2024-12-10,9692
00687B,國泰20年美債,87,57,30,富邦-嘉義,2024-12-10,9692
00720B,元大投資級公司債,28,1,27,富邦-嘉義,2024-12-10,9692
00909,國泰數位支付服務,28,0,28,富邦-嘉義,2024-12-10,9692
00751B,元大AAA至A公司債,27,1,26,富邦-嘉義,2024-12-10,9692
00713,元大台灣高息低波,26,0,26,富邦-嘉義,2024-12-10,9692
00665L,富邦�琤肭磪囓�2,101,76,25,富邦-嘉義,2024-12-10,9692
00650L,復華香港正2,35,11,24,富邦-嘉義,2024-12-10,9692
2468,華經,25,1,24,富邦-嘉義,2024-12-10,9692
2303,聯電,46,23,23,富邦-嘉義,2024-12-10,9692
3338,泰碩,23,0,23,富邦-嘉義,2024-12-10,9692
6180,橘子,24,1,23,富邦-嘉義,2024-12-10,9692
8096,擎亞,29,6,23,富邦-嘉義,2024-12-10,9692
2801,彰銀,23,1,22,富邦-嘉義,2024-12-10,9692
2812,台中銀,22,0,22,富邦-嘉義,2024-12-10,9692
2002,中鋼,27,7,20,富邦-嘉義,2024-12-10,9692
3003,健和興,22,2,20,富邦-嘉義,2024-12-10,9692
3563,牧德,23,3,20,富邦-嘉義,2024-12-10,9692
1605,華新,33,13,20,富邦-嘉義,2024-12-10,9692
3535,晶彩科,32,13,19,富邦-嘉義,2024-12-10,9692
1591,駿吉-KY,21,2,19,富邦-嘉義,2024-12-10,9692
6535,順藥,34,15,19,富邦-嘉義,2024-12-10,9692
4148,全宇生技-KY,19,1,18,富邦-嘉義,2024-12-10,9692
6174,安��,23,5,18,富邦-嘉義,2024-12-10,9692
1301,台塑,25,8,17,富邦-嘉義,2024-12-10,9692
1513,中興電,17,0,17,富邦-嘉義,2024-12-10,9692
4303,信立,30,13,17,富邦-嘉義,2024-12-10,9692
6505,台塑化,29,13,16,富邦-嘉義,2024-12-10,9692
2474,可成,16,0,16,富邦-嘉義,2024-12-10,9692
3041,揚智,595,103,492,富邦-嘉義,2024-12-11,9692
3019,亞光,750,362,388,富邦-嘉義,2024-12-11,9692
2359,所羅門,540,151,389,富邦-嘉義,2024-12-11,9692
3706,神達,916,657,259,富邦-嘉義,2024-12-11,9692
1815,富喬,388,140,248,富邦-嘉義,2024-12-11,9692
00919,群益台灣精選高息,247,3,244,富邦-嘉義,2024-12-11,9692
00918,大華優利高填息30,225,16,209,富邦-嘉義,2024-12-11,9692
2383,台光電,210,19,191,富邦-嘉義,2024-12-11,9692
6558,興能高,229,88,141,富邦-嘉義,2024-12-11,9692
4908,前鼎,117,6,111,富邦-嘉義,2024-12-11,9692
00676R,富邦臺灣加權反1,100,0,100,富邦-嘉義,2024-12-11,9692
4953,緯軟,175,78,97,富邦-嘉義,2024-12-11,9692
2809,京城銀,90,2,88,富邦-嘉義,2024-12-11,9692
3709,鑫聯大投控,75,6,69,富邦-嘉義,2024-12-11,9692
2515,中工,77,12,65,富邦-嘉義,2024-12-11,9692
0056,元大高股息,77,14,63,富邦-嘉義,2024-12-11,9692
00650L,復華香港正2,91,30,61,富邦-嘉義,2024-12-11,9692
1301,台塑,79,20,59,富邦-嘉義,2024-12-11,9692
00665L,富邦�琤肭磪囓�2,67,10,57,富邦-嘉義,2024-12-11,9692
00930,永豐ESG低碳高息,53,0,53,富邦-嘉義,2024-12-11,9692
2303,聯電,66,14,52,富邦-嘉義,2024-12-11,9692
6770,力積電,67,18,49,富邦-嘉義,2024-12-11,9692
2352,佳世達,51,3,48,富邦-嘉義,2024-12-11,9692
6220,岳豐,49,1,48,富邦-嘉義,2024-12-11,9692
3607,谷崧,51,6,45,富邦-嘉義,2024-12-11,9692
00940,元大台灣價值高息,43,0,43,富邦-嘉義,2024-12-11,9692
2317,鴻海,87,44,43,富邦-嘉義,2024-12-11,9692
6214,精誠,75,35,40,富邦-嘉義,2024-12-11,9692
3234,光環,55,17,38,富邦-嘉義,2024-12-11,9692
00878,國泰永續高股息,49,13,36,富邦-嘉義,2024-12-11,9692
00687B,國泰20年美債,45,12,33,富邦-嘉義,2024-12-11,9692
00938,凱基優選30,33,0,33,富邦-嘉義,2024-12-11,9692
2887,台新金,31,2,29,富邦-嘉義,2024-12-11,9692
00664R,國泰臺灣加權反1,29,0,29,富邦-嘉義,2024-12-11,9692
4540,全球傳動,82,53,29,富邦-嘉義,2024-12-11,9692
3147,大綜,43,15,28,富邦-嘉義,2024-12-11,9692
5425,台半,34,7,27,富邦-嘉義,2024-12-11,9692
2891,中信金,35,8,27,富邦-嘉義,2024-12-11,9692
2344,華邦電,57,30,27,富邦-嘉義,2024-12-11,9692
2406,國碩,27,1,26,富邦-嘉義,2024-12-11,9692
00951,台新日本半導體,26,0,26,富邦-嘉義,2024-12-11,9692
00946,群益科技高息成長,39,14,25,富邦-嘉義,2024-12-11,9692
1605,華新,37,13,24,富邦-嘉義,2024-12-11,9692
4906,正文,24,0,24,富邦-嘉義,2024-12-11,9692
1326,台化,89,66,23,富邦-嘉義,2024-12-11,9692
00915,凱基優選高股息30,24,1,23,富邦-嘉義,2024-12-11,9692
3501,維熹,25,2,23,富邦-嘉義,2024-12-11,9692
2316,楠梓電,28,5,23,富邦-嘉義,2024-12-11,9692
4931,新盛力,245,223,22,富邦-嘉義,2024-12-11,9692
006208,富邦台50,36,15,21,富邦-嘉義,2024-12-11,9692
1522,堤維西,318,6,312,富邦-嘉義,2024-12-12,9692
00679B,元大美債20年,247,5,242,富邦-嘉義,2024-12-12,9692
00688L,國泰20年美債正2,238,1,237,富邦-嘉義,2024-12-12,9692
00687B,國泰20年美債,250,24,226,富邦-嘉義,2024-12-12,9692
3029,零壹,445,244,201,富邦-嘉義,2024-12-12,9692
2809,京城銀,137,0,137,富邦-嘉義,2024-12-12,9692
00673R,期元大S＆P原油反1,136,0,136,富邦-嘉義,2024-12-12,9692
00918,大華優利高填息30,129,0,129,富邦-嘉義,2024-12-12,9692
00953B,群益優選非投等債,128,26,102,富邦-嘉義,2024-12-12,9692
3710,連展投控,92,1,91,富邦-嘉義,2024-12-12,9692
6140,訊達,106,17,89,富邦-嘉義,2024-12-12,9692
00915,凱基優選高股息30,72,1,71,富邦-嘉義,2024-12-12,9692
00919,群益台灣精選高息,93,28,65,富邦-嘉義,2024-12-12,9692
00712,復華富時不動產,61,1,60,富邦-嘉義,2024-12-12,9692
2303,聯電,127,69,58,富邦-嘉義,2024-12-12,9692
2834,臺企銀,57,1,56,富邦-嘉義,2024-12-12,9692
1301,台塑,115,61,54,富邦-嘉義,2024-12-12,9692
2317,鴻海,585,531,54,富邦-嘉義,2024-12-12,9692
00680L,元大美債20正2,52,2,50,富邦-嘉義,2024-12-12,9692
00713,元大台灣高息低波,47,1,46,富邦-嘉義,2024-12-12,9692
4120,友華,46,1,45,富邦-嘉義,2024-12-12,9692
2515,中工,65,20,45,富邦-嘉義,2024-12-12,9692
2367,燿華,48,6,42,富邦-嘉義,2024-12-12,9692
00720B,元大投資級公司債,42,1,41,富邦-嘉義,2024-12-12,9692
2312,金寶,82,41,41,富邦-嘉義,2024-12-12,9692
3706,神達,148,107,41,富邦-嘉義,2024-12-12,9692
1303,南亞,44,4,40,富邦-嘉義,2024-12-12,9692
6215,和椿,260,221,39,富邦-嘉義,2024-12-12,9692
2344,華邦電,93,55,38,富邦-嘉義,2024-12-12,9692
2401,凌陽,44,6,38,富邦-嘉義,2024-12-12,9692
0056,元大高股息,41,7,34,富邦-嘉義,2024-12-12,9692
00945B,凱基美國非投等債,32,0,32,富邦-嘉義,2024-12-12,9692
6505,台塑化,39,9,30,富邦-嘉義,2024-12-12,9692
2104,國際中橡,27,0,27,富邦-嘉義,2024-12-12,9692
5392,能率,45,18,27,富邦-嘉義,2024-12-12,9692
00795B,中信美國公債20年,27,1,26,富邦-嘉義,2024-12-12,9692
00887,永豐中國科技50大,42,17,25,富邦-嘉義,2024-12-12,9692
1432,大魯閣,25,0,25,富邦-嘉義,2024-12-12,9692
00665L,富邦�琤肭磪囓�2,40,15,25,富邦-嘉義,2024-12-12,9692
3013,晟銘電,77,52,25,富邦-嘉義,2024-12-12,9692
00932,兆豐永續高息等權,24,0,24,富邦-嘉義,2024-12-12,9692
1326,台化,155,131,24,富邦-嘉義,2024-12-12,9692
2002,中鋼,22,0,22,富邦-嘉義,2024-12-12,9692
8021,尖點,24,2,22,富邦-嘉義,2024-12-12,9692
8054,安國,27,5,22,富邦-嘉義,2024-12-12,9692
1514,亞力,21,0,21,富邦-嘉義,2024-12-12,9692
1584,精剛,20,0,20,富邦-嘉義,2024-12-12,9692
1616,億泰,20,0,20,富邦-嘉義,2024-12-12,9692
2609,陽明,94,74,20,富邦-嘉義,2024-12-12,9692
2328,廣宇,72,53,19,富邦-嘉義,2024-12-12,9692
3019,亞光,675,391,284,富邦-嘉義,2024-12-13,9692
00919,群益台灣精選高息,361,83,278,富邦-嘉義,2024-12-13,9692
4931,新盛力,487,245,242,富邦-嘉義,2024-12-13,9692
00679B,元大美債20年,203,29,174,富邦-嘉義,2024-12-13,9692
00687B,國泰20年美債,169,8,161,富邦-嘉義,2024-12-13,9692
00918,大華優利高填息30,161,11,150,富邦-嘉義,2024-12-13,9692
0056,元大高股息,126,2,124,富邦-嘉義,2024-12-13,9692
2883,凱基金,122,1,121,富邦-嘉義,2024-12-13,9692
00915,凱基優選高股息30,122,6,116,富邦-嘉義,2024-12-13,9692
2834,臺企銀,99,0,99,富邦-嘉義,2024-12-13,9692
00926,凱基全球菁英55,92,0,92,富邦-嘉義,2024-12-13,9692
00948B,中信優息投資級債,90,0,90,富邦-嘉義,2024-12-13,9692
2812,台中銀,103,15,88,富邦-嘉義,2024-12-13,9692
6558,興能高,632,545,87,富邦-嘉義,2024-12-13,9692
3323,加百裕,322,240,82,富邦-嘉義,2024-12-13,9692
6603,富強鑫,80,0,80,富邦-嘉義,2024-12-13,9692
00952,凱基台灣AI50,75,3,72,富邦-嘉義,2024-12-13,9692
2367,燿華,103,32,71,富邦-嘉義,2024-12-13,9692
00945B,凱基美國非投等債,119,50,69,富邦-嘉義,2024-12-13,9692
2332,友訊,82,15,67,富邦-嘉義,2024-12-13,9692
2845,遠東銀,55,0,55,富邦-嘉義,2024-12-13,9692
00688L,國泰20年美債正2,60,5,55,富邦-嘉義,2024-12-13,9692
00878,國泰永續高股息,101,47,54,富邦-嘉義,2024-12-13,9692
3594,磐儀,113,60,53,富邦-嘉義,2024-12-13,9692
3041,揚智,52,0,52,富邦-嘉義,2024-12-13,9692
3710,連展投控,53,2,51,富邦-嘉義,2024-12-13,9692
1584,精剛,50,0,50,富邦-嘉義,2024-12-13,9692
3231,緯創,57,7,50,富邦-嘉義,2024-12-13,9692
2317,鴻海,86,43,43,富邦-嘉義,2024-12-13,9692
2605,新興,40,0,40,富邦-嘉義,2024-12-13,9692
00946,群益科技高息成長,39,0,39,富邦-嘉義,2024-12-13,9692
2618,長榮航,67,28,39,富邦-嘉義,2024-12-13,9692
5880,合庫金,35,0,35,富邦-嘉義,2024-12-13,9692
4906,正文,45,10,35,富邦-嘉義,2024-12-13,9692
2353,宏��,34,0,34,富邦-嘉義,2024-12-13,9692
00953B,群益優選非投等債,36,2,34,富邦-嘉義,2024-12-13,9692
3037,欣興,38,8,30,富邦-嘉義,2024-12-13,9692
1446,宏和,31,1,30,富邦-嘉義,2024-12-13,9692
4571,鈞興-KY,31,2,29,富邦-嘉義,2024-12-13,9692
00795B,中信美國公債20年,31,3,28,富邦-嘉義,2024-12-13,9692
2324,仁寶,27,0,27,富邦-嘉義,2024-12-13,9692
00637L,元大滬深300正2,34,8,26,富邦-嘉義,2024-12-13,9692
2354,鴻準,40,14,26,富邦-嘉義,2024-12-13,9692
2002,中鋼,37,11,26,富邦-嘉義,2024-12-13,9692
00720B,元大投資級公司債,25,1,24,富邦-嘉義,2024-12-13,9692
1513,中興電,27,3,24,富邦-嘉義,2024-12-13,9692
3211,順達,53,29,24,富邦-嘉義,2024-12-13,9692
3016,嘉晶,23,0,23,富邦-嘉義,2024-12-13,9692
8150,南茂,22,0,22,富邦-嘉義,2024-12-13,9692
1304,台聚,21,0,21,富邦-嘉義,2024-12-13,9692
00937B,群益ESG投等債20,425,38,387,富邦-嘉義,2024-12-16,9692
00919,群益台灣精選高息,352,44,308,富邦-嘉義,2024-12-16,9692
00673R,期元大S＆P原油反1,311,25,286,富邦-嘉義,2024-12-16,9692
00918,大華優利高填息30,281,22,259,富邦-嘉義,2024-12-16,9692
00915,凱基優選高股息30,209,7,202,富邦-嘉義,2024-12-16,9692
00679B,元大美債20年,216,24,192,富邦-嘉義,2024-12-16,9692
3019,亞光,616,442,174,富邦-嘉義,2024-12-16,9692
2344,華邦電,212,94,118,富邦-嘉義,2024-12-16,9692
00632R,元大台灣50反1,113,2,111,富邦-嘉義,2024-12-16,9692
1304,台聚,110,2,108,富邦-嘉義,2024-12-16,9692
00969B,元大零息超長美債,101,0,101,富邦-嘉義,2024-12-16,9692
00952,凱基台灣AI50,84,0,84,富邦-嘉義,2024-12-16,9692
2354,鴻準,102,22,80,富邦-嘉義,2024-12-16,9692
0056,元大高股息,144,66,78,富邦-嘉義,2024-12-16,9692
00924,復華S＆P500成長,76,0,76,富邦-嘉義,2024-12-16,9692
6153,嘉聯益,70,0,70,富邦-嘉義,2024-12-16,9692
00687B,國泰20年美債,183,114,69,富邦-嘉義,2024-12-16,9692
2609,陽明,138,70,68,富邦-嘉義,2024-12-16,9692
00948B,中信優息投資級債,72,5,67,富邦-嘉義,2024-12-16,9692
00950B,凱基A級公司債,65,0,65,富邦-嘉義,2024-12-16,9692
00878,國泰永續高股息,99,34,65,富邦-嘉義,2024-12-16,9692
2466,冠西電,63,0,63,富邦-嘉義,2024-12-16,9692
3231,緯創,84,23,61,富邦-嘉義,2024-12-16,9692
00688L,國泰20年美債正2,60,0,60,富邦-嘉義,2024-12-16,9692
2317,鴻海,626,571,55,富邦-嘉義,2024-12-16,9692
2605,新興,51,1,50,富邦-嘉義,2024-12-16,9692
8163,達方,52,5,47,富邦-嘉義,2024-12-16,9692
00959B,大華投等美債15Y+,46,0,46,富邦-嘉義,2024-12-16,9692
00712,復華富時不動產,53,10,43,富邦-嘉義,2024-12-16,9692
2332,友訊,55,17,38,富邦-嘉義,2024-12-16,9692
5880,合庫金,38,6,32,富邦-嘉義,2024-12-16,9692
2615,萬海,48,16,32,富邦-嘉義,2024-12-16,9692
2409,友達,32,1,31,富邦-嘉義,2024-12-16,9692
3338,泰碩,30,0,30,富邦-嘉義,2024-12-16,9692
6112,邁達特,30,0,30,富邦-嘉義,2024-12-16,9692
00650L,復華香港正2,30,0,30,富邦-嘉義,2024-12-16,9692
00751B,元大AAA至A公司債,31,6,25,富邦-嘉義,2024-12-16,9692
00926,凱基全球菁英55,97,74,23,富邦-嘉義,2024-12-16,9692
00932,兆豐永續高息等權,23,0,23,富邦-嘉義,2024-12-16,9692
2905,三商,22,0,22,富邦-嘉義,2024-12-16,9692
3022,威強電,22,0,22,富邦-嘉義,2024-12-16,9692
1802,台玻,21,0,21,富邦-嘉義,2024-12-16,9692
2328,廣宇,21,1,20,富邦-嘉義,2024-12-16,9692
3706,神達,665,645,20,富邦-嘉義,2024-12-16,9692
00946,群益科技高息成長,20,0,20,富邦-嘉義,2024-12-16,9692
1536,和大,45,25,20,富邦-嘉義,2024-12-16,9692
4974,亞泰,36,17,19,富邦-嘉義,2024-12-16,9692
2382,廣達,26,8,18,富邦-嘉義,2024-12-16,9692
00713,元大台灣高息低波,34,16,18,富邦-嘉義,2024-12-16,9692
2312,金寶,29,12,17,富邦-嘉義,2024-12-16,9692
4540,全球傳動,800,191,609,富邦-嘉義,2024-12-17,9692
00680L,元大美債20正2,323,0,323,富邦-嘉義,2024-12-17,9692
00937B,群益ESG投等債20,336,21,315,富邦-嘉義,2024-12-17,9692
2049,上銀,240,24,216,富邦-嘉義,2024-12-17,9692
6531,愛普*,388,227,161,富邦-嘉義,2024-12-17,9692
6215,和椿,662,523,139,富邦-嘉義,2024-12-17,9692
00918,大華優利高填息30,150,15,135,富邦-嘉義,2024-12-17,9692
3481,群創,138,19,119,富邦-嘉義,2024-12-17,9692
00915,凱基優選高股息30,122,5,117,富邦-嘉義,2024-12-17,9692
00969B,元大零息超長美債,100,0,100,富邦-嘉義,2024-12-17,9692
5880,合庫金,102,7,95,富邦-嘉義,2024-12-17,9692
2359,所羅門,459,368,91,富邦-嘉義,2024-12-17,9692
1101,台泥,86,4,82,富邦-嘉義,2024-12-17,9692
00679B,元大美債20年,81,0,81,富邦-嘉義,2024-12-17,9692
00950B,凱基A級公司債,78,0,78,富邦-嘉義,2024-12-17,9692
2883,凱基金,90,15,75,富邦-嘉義,2024-12-17,9692
00687B,國泰20年美債,86,12,74,富邦-嘉義,2024-12-17,9692
0056,元大高股息,83,16,67,富邦-嘉義,2024-12-17,9692
00948B,中信優息投資級債,67,0,67,富邦-嘉義,2024-12-17,9692
2801,彰銀,65,0,65,富邦-嘉義,2024-12-17,9692
8227,巨有科技,117,53,64,富邦-嘉義,2024-12-17,9692
00713,元大台灣高息低波,60,2,58,富邦-嘉義,2024-12-17,9692
2303,聯電,117,59,58,富邦-嘉義,2024-12-17,9692
2317,鴻海,90,33,57,富邦-嘉義,2024-12-17,9692
1722,台肥,56,0,56,富邦-嘉義,2024-12-17,9692
4571,鈞興-KY,172,116,56,富邦-嘉義,2024-12-17,9692
00720B,元大投資級公司債,53,1,52,富邦-嘉義,2024-12-17,9692
1710,東聯,54,5,49,富邦-嘉義,2024-12-17,9692
5439,高技,50,1,49,富邦-嘉義,2024-12-17,9692
2344,華邦電,192,143,49,富邦-嘉義,2024-12-17,9692
1301,台塑,50,1,49,富邦-嘉義,2024-12-17,9692
2002,中鋼,48,2,46,富邦-嘉義,2024-12-17,9692
4510,高鋒,663,618,45,富邦-嘉義,2024-12-17,9692
00959B,大華投等美債15Y+,44,0,44,富邦-嘉義,2024-12-17,9692
1326,台化,91,53,38,富邦-嘉義,2024-12-17,9692
8047,星雲,108,70,38,富邦-嘉義,2024-12-17,9692
1785,光洋科,66,30,36,富邦-嘉義,2024-12-17,9692
00878,國泰永續高股息,39,4,35,富邦-嘉義,2024-12-17,9692
2834,臺企銀,57,26,31,富邦-嘉義,2024-12-17,9692
00688L,國泰20年美債正2,40,10,30,富邦-嘉義,2024-12-17,9692
8054,安國,46,17,29,富邦-嘉義,2024-12-17,9692
2891,中信金,43,14,29,富邦-嘉義,2024-12-17,9692
4960,誠美材,28,0,28,富邦-嘉義,2024-12-17,9692
3515,華擎,30,2,28,富邦-嘉義,2024-12-17,9692
1303,南亞,42,14,28,富邦-嘉義,2024-12-17,9692
1304,台聚,29,2,27,富邦-嘉義,2024-12-17,9692
3706,神達,1995,1969,26,富邦-嘉義,2024-12-17,9692
1605,華新,34,9,25,富邦-嘉義,2024-12-17,9692
1718,中纖,25,0,25,富邦-嘉義,2024-12-17,9692
1815,富喬,62,37,25,富邦-嘉義,2024-12-17,9692
00948B,中信優息投資級債,573,0,573,富邦-嘉義,2024-12-18,9692
4931,新盛力,912,422,490,富邦-嘉義,2024-12-18,9692
4991,環宇-KY,528,182,346,富邦-嘉義,2024-12-18,9692
6558,興能高,562,347,215,富邦-嘉義,2024-12-18,9692
00918,大華優利高填息30,289,132,157,富邦-嘉義,2024-12-18,9692
6215,和椿,197,49,148,富邦-嘉義,2024-12-18,9692
3323,加百裕,427,295,132,富邦-嘉義,2024-12-18,9692
3019,亞光,301,177,124,富邦-嘉義,2024-12-18,9692
00679B,元大美債20年,112,0,112,富邦-嘉義,2024-12-18,9692
3625,西勝,92,1,91,富邦-嘉義,2024-12-18,9692
3706,神達,187,97,90,富邦-嘉義,2024-12-18,9692
00712,復華富時不動產,87,0,87,富邦-嘉義,2024-12-18,9692
1711,永光,100,37,63,富邦-嘉義,2024-12-18,9692
2495,普安,56,0,56,富邦-嘉義,2024-12-18,9692
2303,聯電,109,56,53,富邦-嘉義,2024-12-18,9692
2383,台光電,92,41,51,富邦-嘉義,2024-12-18,9692
00720B,元大投資級公司債,50,0,50,富邦-嘉義,2024-12-18,9692
00687B,國泰20年美債,53,4,49,富邦-嘉義,2024-12-18,9692
1303,南亞,53,5,48,富邦-嘉義,2024-12-18,9692
6209,今國光,118,72,46,富邦-嘉義,2024-12-18,9692
8249,菱光,91,46,45,富邦-嘉義,2024-12-18,9692
2891,中信金,46,7,39,富邦-嘉義,2024-12-18,9692
2610,華航,64,27,37,富邦-嘉義,2024-12-18,9692
2312,金寶,50,13,37,富邦-嘉義,2024-12-18,9692
5880,合庫金,35,0,35,富邦-嘉義,2024-12-18,9692
2332,友訊,33,1,32,富邦-嘉義,2024-12-18,9692
2736,富野,34,2,32,富邦-嘉義,2024-12-18,9692
2349,錸德,149,118,31,富邦-嘉義,2024-12-18,9692
00725B,國泰投資級公司債,30,0,30,富邦-嘉義,2024-12-18,9692
00852L,國泰美國道瓊正2,30,0,30,富邦-嘉義,2024-12-18,9692
00950B,凱基A級公司債,30,0,30,富邦-嘉義,2024-12-18,9692
1785,光洋科,39,11,28,富邦-嘉義,2024-12-18,9692
00878,國泰永續高股息,75,47,28,富邦-嘉義,2024-12-18,9692
2739,寒舍,26,0,26,富邦-嘉義,2024-12-18,9692
3059,華晶科,32,7,25,富邦-嘉義,2024-12-18,9692
00665L,富邦�琤肭磪囓�2,26,2,24,富邦-嘉義,2024-12-18,9692
2354,鴻準,28,5,23,富邦-嘉義,2024-12-18,9692
2515,中工,24,1,23,富邦-嘉義,2024-12-18,9692
6770,力積電,58,36,22,富邦-嘉義,2024-12-18,9692
4510,高鋒,27,5,22,富邦-嘉義,2024-12-18,9692
3169,亞信,22,0,22,富邦-嘉義,2024-12-18,9692
2454,聯發科,21,0,21,富邦-嘉義,2024-12-18,9692
5905,南仁湖,21,0,21,富邦-嘉義,2024-12-18,9692
2890,永豐金,21,0,21,富邦-嘉義,2024-12-18,9692
8047,星雲,23,2,21,富邦-嘉義,2024-12-18,9692
3211,順達,68,47,21,富邦-嘉義,2024-12-18,9692
00637L,元大滬深300正2,26,6,20,富邦-嘉義,2024-12-18,9692
1799,易威,19,0,19,富邦-嘉義,2024-12-18,9692
5371,中光電,37,20,17,富邦-嘉義,2024-12-18,9692
2618,長榮航,40,23,17,富邦-嘉義,2024-12-18,9692
4977,眾達-KY,406,33,373,富邦-嘉義,2024-12-19,9692
00679B,元大美債20年,373,100,273,富邦-嘉義,2024-12-19,9692
4991,環宇-KY,692,471,221,富邦-嘉義,2024-12-19,9692
3706,神達,1013,841,172,富邦-嘉義,2024-12-19,9692
00687B,國泰20年美債,179,21,158,富邦-嘉義,2024-12-19,9692
00926,凱基全球菁英55,155,0,155,富邦-嘉義,2024-12-19,9692
2409,友達,152,0,152,富邦-嘉義,2024-12-19,9692
00937B,群益ESG投等債20,223,84,139,富邦-嘉義,2024-12-19,9692
00918,大華優利高填息30,178,45,133,富邦-嘉義,2024-12-19,9692
00878,國泰永續高股息,168,38,130,富邦-嘉義,2024-12-19,9692
00680L,元大美債20正2,271,152,119,富邦-嘉義,2024-12-19,9692
2883,凱基金,131,20,111,富邦-嘉義,2024-12-19,9692
2374,佳能,495,389,106,富邦-嘉義,2024-12-19,9692
2486,一詮,116,11,105,富邦-嘉義,2024-12-19,9692
00712,復華富時不動產,109,8,101,富邦-嘉義,2024-12-19,9692
3630,新鉅科,100,1,99,富邦-嘉義,2024-12-19,9692
1326,台化,190,91,99,富邦-嘉義,2024-12-19,9692
2317,鴻海,103,12,91,富邦-嘉義,2024-12-19,9692
5880,合庫金,90,0,90,富邦-嘉義,2024-12-19,9692
00948B,中信優息投資級債,100,11,89,富邦-嘉義,2024-12-19,9692
00706L,期元大S＆P日圓正2,84,0,84,富邦-嘉義,2024-12-19,9692
2834,臺企銀,76,1,75,富邦-嘉義,2024-12-19,9692
2354,鴻準,83,17,66,富邦-嘉義,2024-12-19,9692
5392,能率,119,53,66,富邦-嘉義,2024-12-19,9692
2881,富邦金,72,7,65,富邦-嘉義,2024-12-19,9692
0056,元大高股息,77,21,56,富邦-嘉義,2024-12-19,9692
3481,群創,57,2,55,富邦-嘉義,2024-12-19,9692
2890,永豐金,55,2,53,富邦-嘉義,2024-12-19,9692
2609,陽明,91,41,50,富邦-嘉義,2024-12-19,9692
2891,中信金,51,3,48,富邦-嘉義,2024-12-19,9692
00646,元大S＆P500,45,0,45,富邦-嘉義,2024-12-19,9692
2801,彰銀,45,0,45,富邦-嘉義,2024-12-19,9692
00662,富邦NASDAQ,46,2,44,富邦-嘉義,2024-12-19,9692
006208,富邦台50,49,7,42,富邦-嘉義,2024-12-19,9692
2618,長榮航,53,13,40,富邦-嘉義,2024-12-19,9692
1303,南亞,70,31,39,富邦-嘉義,2024-12-19,9692
8111,立��,230,191,39,富邦-嘉義,2024-12-19,9692
1301,台塑,86,48,38,富邦-嘉義,2024-12-19,9692
00665L,富邦�琤肭磪囓�2,35,0,35,富邦-嘉義,2024-12-19,9692
4533,協易機,57,23,34,富邦-嘉義,2024-12-19,9692
2049,上銀,67,33,34,富邦-嘉義,2024-12-19,9692
2646,星宇航空,38,5,33,富邦-嘉義,2024-12-19,9692
3594,磐儀,43,11,32,富邦-嘉義,2024-12-19,9692
2880,華南金,32,0,32,富邦-嘉義,2024-12-19,9692
00670L,富邦NASDAQ正2,31,0,31,富邦-嘉義,2024-12-19,9692
00922,國泰台灣領袖50,54,24,30,富邦-嘉義,2024-12-19,9692
00882,中信中國高股息,41,11,30,富邦-嘉義,2024-12-19,9692
6191,精成科,30,1,29,富邦-嘉義,2024-12-19,9692
5512,力麒,28,0,28,富邦-嘉義,2024-12-19,9692
2002,中鋼,35,8,27,富邦-嘉義,2024-12-19,9692
