Ticker,Name,buy,sell,diff,Branch,Date,Branch_Code
6806,森崴能源,69,18,51,富邦-新營,2023-01-03,9693
00632R,元大台灣50反1,45,0,45,富邦-新營,2023-01-03,9693
1605,華新,38,6,32,富邦-新營,2023-01-03,9693
2881,富邦金,30,1,29,富邦-新營,2023-01-03,9693
1720,生達,31,5,26,富邦-新營,2023-01-03,9693
00878,國泰永續高股息,23,1,22,富邦-新營,2023-01-03,9693
3705,永信,22,0,22,富邦-新營,2023-01-03,9693
6443,元晶,20,3,17,富邦-新營,2023-01-03,9693
2603,長榮,20,4,16,富邦-新營,2023-01-03,9693
3481,群創,42,30,12,富邦-新營,2023-01-03,9693
2317,鴻海,16,4,12,富邦-新營,2023-01-03,9693
5009,榮剛,11,0,11,富邦-新營,2023-01-03,9693
1718,中纖,12,1,11,富邦-新營,2023-01-03,9693
2609,陽明,11,0,11,富邦-新營,2023-01-03,9693
2444,兆勁,10,0,10,富邦-新營,2023-01-03,9693
2610,華航,10,0,10,富邦-新營,2023-01-03,9693
3710,連展投控,10,0,10,富邦-新營,2023-01-03,9693
5608,四維航,10,0,10,富邦-新營,2023-01-03,9693
6152,百一,10,0,10,富邦-新營,2023-01-03,9693
1810,和成,19,10,9,富邦-新營,2023-01-03,9693
2352,佳世達,9,0,9,富邦-新營,2023-01-03,9693
2023,燁輝,8,0,8,富邦-新營,2023-01-03,9693
0050,元大台灣50,7,0,7,富邦-新營,2023-01-03,9693
00885,富邦越南,7,0,7,富邦-新營,2023-01-03,9693
00895,富邦未來車,6,0,6,富邦-新營,2023-01-03,9693
1609,大亞,6,1,5,富邦-新營,2023-01-03,9693
00633L,富邦上証正2,5,0,5,富邦-新營,2023-01-03,9693
2890,永豐金,5,0,5,富邦-新營,2023-01-03,9693
3221,台嘉碩,5,0,5,富邦-新營,2023-01-03,9693
3441,聯一光,5,0,5,富邦-新營,2023-01-03,9693
4114,健喬,7,3,4,富邦-新營,2023-01-03,9693
00670L,富邦NASDAQ正2,4,0,4,富邦-新營,2023-01-03,9693
2615,萬海,5,1,4,富邦-新營,2023-01-03,9693
2886,兆豐金,4,0,4,富邦-新營,2023-01-03,9693
3083,網龍,6,2,4,富邦-新營,2023-01-03,9693
3687,歐買尬,5,1,4,富邦-新營,2023-01-03,9693
4536,拓凱,4,0,4,富邦-新營,2023-01-03,9693
6741,91APP*-KY,6,2,4,富邦-新營,2023-01-03,9693
006208,富邦台50,3,0,3,富邦-新營,2023-01-03,9693
00647L,元大S＆P500正2,3,0,3,富邦-新營,2023-01-03,9693
1522,堤維西,3,0,3,富邦-新營,2023-01-03,9693
1752,南光,11,8,3,富邦-新營,2023-01-03,9693
2014,中鴻,3,0,3,富邦-新營,2023-01-03,9693
4563,百德,3,0,3,富邦-新營,2023-01-03,9693
8277,商丞,3,0,3,富邦-新營,2023-01-03,9693
9103,美德醫療-DR,3,0,3,富邦-新營,2023-01-03,9693
2498,宏達電,15,12,3,富邦-新營,2023-01-03,9693
2887,台新金,3,0,3,富邦-新營,2023-01-03,9693
00888,永豐台灣ESG,3,0,3,富邦-新營,2023-01-03,9693
2884,玉山金,2,0,2,富邦-新營,2023-01-03,9693
00715L,期街口布蘭特正2,73,0,73,富邦-新營,2023-01-04,9693
6806,森崴能源,64,11,53,富邦-新營,2023-01-04,9693
1701,中化,62,10,52,富邦-新營,2023-01-04,9693
1440,南紡,28,0,28,富邦-新營,2023-01-04,9693
1718,中纖,27,0,27,富邦-新營,2023-01-04,9693
2809,京城銀,25,0,25,富邦-新營,2023-01-04,9693
4747,強生,23,0,23,富邦-新營,2023-01-04,9693
2812,台中銀,15,0,15,富邦-新營,2023-01-04,9693
5608,四維航,17,2,15,富邦-新營,2023-01-04,9693
2303,聯電,13,0,13,富邦-新營,2023-01-04,9693
6550,北極星藥業-KY,40,27,13,富邦-新營,2023-01-04,9693
3105,穩懋,11,0,11,富邦-新營,2023-01-04,9693
00905,FT臺灣Smart,10,0,10,富邦-新營,2023-01-04,9693
1319,東陽,10,0,10,富邦-新營,2023-01-04,9693
2014,中鴻,13,3,10,富邦-新營,2023-01-04,9693
2637,慧洋-KY,10,0,10,富邦-新營,2023-01-04,9693
4763,材料-KY,29,19,10,富邦-新營,2023-01-04,9693
8222,寶一,10,0,10,富邦-新營,2023-01-04,9693
2317,鴻海,11,2,9,富邦-新營,2023-01-04,9693
2618,長榮航,10,1,9,富邦-新營,2023-01-04,9693
2884,玉山金,8,0,8,富邦-新營,2023-01-04,9693
2603,長榮,16,8,8,富邦-新營,2023-01-04,9693
1102,亞泥,8,0,8,富邦-新營,2023-01-04,9693
00897,富邦基因免疫生技,8,0,8,富邦-新營,2023-01-04,9693
4979,華星光,22,14,8,富邦-新營,2023-01-04,9693
1536,和大,7,0,7,富邦-新營,2023-01-04,9693
00655L,國泰中國A50正2,6,1,5,富邦-新營,2023-01-04,9693
1909,榮成,10,5,5,富邦-新營,2023-01-04,9693
4968,立積,6,1,5,富邦-新營,2023-01-04,9693
9955,佳龍,5,0,5,富邦-新營,2023-01-04,9693
00893,國泰智能電動車,4,0,4,富邦-新營,2023-01-04,9693
8046,南電,19,15,4,富邦-新營,2023-01-04,9693
2023,燁輝,4,0,4,富邦-新營,2023-01-04,9693
3090,日電貿,4,0,4,富邦-新營,2023-01-04,9693
5014,建錩,4,0,4,富邦-新營,2023-01-04,9693
6235,華孚,38,34,4,富邦-新營,2023-01-04,9693
6274,台燿,5,1,4,富邦-新營,2023-01-04,9693
5321,美而快,4,0,4,富邦-新營,2023-01-04,9693
2886,兆豐金,3,0,3,富邦-新營,2023-01-04,9693
6180,橘子,4,1,3,富邦-新營,2023-01-04,9693
00642U,期元大S＆P石油,3,0,3,富邦-新營,2023-01-04,9693
00664R,國泰臺灣加權反1,3,0,3,富邦-新營,2023-01-04,9693
1101,台泥,5,2,3,富邦-新營,2023-01-04,9693
1711,永光,3,0,3,富邦-新營,2023-01-04,9693
1810,和成,15,12,3,富邦-新營,2023-01-04,9693
2344,華邦電,4,1,3,富邦-新營,2023-01-04,9693
2609,陽明,4,1,3,富邦-新營,2023-01-04,9693
2610,華航,5,2,3,富邦-新營,2023-01-04,9693
2617,台航,4,1,3,富邦-新營,2023-01-04,9693
2851,中再保,5,2,3,富邦-新營,2023-01-04,9693
1519,華城,62,11,51,富邦-新營,2023-01-05,9693
5483,中美晶,30,0,30,富邦-新營,2023-01-05,9693
2891,中信金,31,4,27,富邦-新營,2023-01-05,9693
00715L,期街口布蘭特正2,41,20,21,富邦-新營,2023-01-05,9693
1513,中興電,31,10,21,富邦-新營,2023-01-05,9693
8933,愛地雅,20,0,20,富邦-新營,2023-01-05,9693
00885,富邦越南,21,2,19,富邦-新營,2023-01-05,9693
2609,陽明,17,3,14,富邦-新營,2023-01-05,9693
4747,強生,14,0,14,富邦-新營,2023-01-05,9693
0050,元大台灣50,13,1,12,富邦-新營,2023-01-05,9693
6517,保勝光學,12,0,12,富邦-新營,2023-01-05,9693
3704,合勤控,15,4,11,富邦-新營,2023-01-05,9693
00680L,元大美債20正2,10,0,10,富邦-新營,2023-01-05,9693
1529,樂事綠能,11,1,10,富邦-新營,2023-01-05,9693
1612,宏泰,10,0,10,富邦-新營,2023-01-05,9693
3027,盛達,10,0,10,富邦-新營,2023-01-05,9693
3289,宜特,10,0,10,富邦-新營,2023-01-05,9693
6152,百一,10,0,10,富邦-新營,2023-01-05,9693
6274,台燿,10,0,10,富邦-新營,2023-01-05,9693
1440,南紡,11,2,9,富邦-新營,2023-01-05,9693
00878,國泰永續高股息,8,0,8,富邦-新營,2023-01-05,9693
3290,東浦,8,0,8,富邦-新營,2023-01-05,9693
6163,華電網,8,0,8,富邦-新營,2023-01-05,9693
6443,元晶,33,25,8,富邦-新營,2023-01-05,9693
1718,中纖,8,1,7,富邦-新營,2023-01-05,9693
3508,位速,8,1,7,富邦-新營,2023-01-05,9693
2610,華航,11,5,6,富邦-新營,2023-01-05,9693
2641,正德,6,0,6,富邦-新營,2023-01-05,9693
5905,南仁湖,8,2,6,富邦-新營,2023-01-05,9693
00637L,元大滬深300正2,20,15,5,富邦-新營,2023-01-05,9693
2344,華邦電,6,1,5,富邦-新營,2023-01-05,9693
2537,聯上發,8,3,5,富邦-新營,2023-01-05,9693
3083,網龍,5,0,5,富邦-新營,2023-01-05,9693
4958,臻鼎-KY,5,0,5,富邦-新營,2023-01-05,9693
8131,福懋科,5,0,5,富邦-新營,2023-01-05,9693
9955,佳龍,5,0,5,富邦-新營,2023-01-05,9693
6257,矽格,4,0,4,富邦-新營,2023-01-05,9693
00830,國泰費城半導體,5,1,4,富邦-新營,2023-01-05,9693
1503,士電,5,1,4,富邦-新營,2023-01-05,9693
1506,正道,4,0,4,富邦-新營,2023-01-05,9693
2371,大同,5,1,4,富邦-新營,2023-01-05,9693
2390,云辰,6,2,4,富邦-新營,2023-01-05,9693
2614,東森,6,2,4,富邦-新營,2023-01-05,9693
3022,威強電,4,0,4,富邦-新營,2023-01-05,9693
4121,優盛,4,0,4,富邦-新營,2023-01-05,9693
3037,欣興,4,0,4,富邦-新營,2023-01-05,9693
2498,宏達電,14,11,3,富邦-新營,2023-01-05,9693
3443,創意,9,6,3,富邦-新營,2023-01-05,9693
1314,中石化,3,0,3,富邦-新營,2023-01-05,9693
1309,台達化,3,0,3,富邦-新營,2023-01-05,9693
2834,臺企銀,117,0,117,富邦-新營,2023-01-06,9693
00680L,元大美債20正2,100,0,100,富邦-新營,2023-01-06,9693
2812,台中銀,69,0,69,富邦-新營,2023-01-06,9693
2883,凱基金,42,1,41,富邦-新營,2023-01-06,9693
00641R,富邦日本反1,30,0,30,富邦-新營,2023-01-06,9693
1605,華新,43,18,25,富邦-新營,2023-01-06,9693
4104,佳醫,23,0,23,富邦-新營,2023-01-06,9693
9939,宏全,19,1,18,富邦-新營,2023-01-06,9693
6581,鋼聯,16,0,16,富邦-新營,2023-01-06,9693
6517,保勝光學,15,0,15,富邦-新營,2023-01-06,9693
8046,南電,25,10,15,富邦-新營,2023-01-06,9693
1519,華城,17,5,12,富邦-新營,2023-01-06,9693
2385,群光,10,0,10,富邦-新營,2023-01-06,9693
2537,聯上發,10,0,10,富邦-新營,2023-01-06,9693
3209,全科,10,0,10,富邦-新營,2023-01-06,9693
2317,鴻海,10,0,10,富邦-新營,2023-01-06,9693
3162,精確,9,0,9,富邦-新營,2023-01-06,9693
4114,健喬,19,11,8,富邦-新營,2023-01-06,9693
6446,藥華藥,8,0,8,富邦-新營,2023-01-06,9693
0050,元大台灣50,8,0,8,富邦-新營,2023-01-06,9693
00633L,富邦上証正2,7,0,7,富邦-新營,2023-01-06,9693
00720B,元大投資級公司債,7,0,7,富邦-新營,2023-01-06,9693
6125,廣運,8,1,7,富邦-新營,2023-01-06,9693
6589,台康生技,10,3,7,富邦-新營,2023-01-06,9693
1714,和桐,6,0,6,富邦-新營,2023-01-06,9693
1783,和康生,5,0,5,富邦-新營,2023-01-06,9693
2609,陽明,5,0,5,富邦-新營,2023-01-06,9693
2891,中信金,5,0,5,富邦-新營,2023-01-06,9693
6152,百一,5,0,5,富邦-新營,2023-01-06,9693
1342,八貫,8,4,4,富邦-新營,2023-01-06,9693
3556,禾瑞亞,4,0,4,富邦-新營,2023-01-06,9693
4958,臻鼎-KY,4,0,4,富邦-新營,2023-01-06,9693
00888,永豐台灣ESG,3,0,3,富邦-新營,2023-01-06,9693
00664R,國泰臺灣加權反1,3,0,3,富邦-新營,2023-01-06,9693
00738U,期元大道瓊白銀,3,0,3,富邦-新營,2023-01-06,9693
2371,大同,3,0,3,富邦-新營,2023-01-06,9693
2888B,新光金乙特,3,0,3,富邦-新營,2023-01-06,9693
3078,僑威,3,0,3,富邦-新營,2023-01-06,9693
3294,英濟,3,0,3,富邦-新營,2023-01-06,9693
4979,華星光,18,15,3,富邦-新營,2023-01-06,9693
8033,雷虎,3,0,3,富邦-新營,2023-01-06,9693
8440,綠電,3,0,3,富邦-新營,2023-01-06,9693
1101,台泥,3,1,2,富邦-新營,2023-01-06,9693
1409,新纖,2,0,2,富邦-新營,2023-01-06,9693
00904,新光臺灣半導體30,2,0,2,富邦-新營,2023-01-06,9693
00900,富邦特選高股息30,2,0,2,富邦-新營,2023-01-06,9693
1584,精剛,4,2,2,富邦-新營,2023-01-06,9693
1609,大亞,2,0,2,富邦-新營,2023-01-06,9693
2031,新光鋼,2,0,2,富邦-新營,2023-01-06,9693
2038,海光,2,0,2,富邦-新營,2023-01-06,9693
2881,富邦金,50,6,44,富邦-新營,2023-01-09,9693
2897,王道銀行,35,0,35,富邦-新營,2023-01-09,9693
1605,華新,52,22,30,富邦-新營,2023-01-09,9693
6770,力積電,29,3,26,富邦-新營,2023-01-09,9693
00905,FT臺灣Smart,21,0,21,富邦-新營,2023-01-09,9693
2887,台新金,22,1,21,富邦-新營,2023-01-09,9693
5531,鄉林,20,0,20,富邦-新營,2023-01-09,9693
3576,聯合再生,14,0,14,富邦-新營,2023-01-09,9693
4747,強生,14,0,14,富邦-新營,2023-01-09,9693
6139,亞翔,23,9,14,富邦-新營,2023-01-09,9693
2023,燁輝,13,1,12,富邦-新營,2023-01-09,9693
2812,台中銀,12,0,12,富邦-新營,2023-01-09,9693
00632R,元大台灣50反1,10,0,10,富邦-新營,2023-01-09,9693
2406,國碩,10,0,10,富邦-新營,2023-01-09,9693
00655L,國泰中國A50正2,9,0,9,富邦-新營,2023-01-09,9693
1710,東聯,8,0,8,富邦-新營,2023-01-09,9693
2049,上銀,7,0,7,富邦-新營,2023-01-09,9693
2444,兆勁,10,3,7,富邦-新營,2023-01-09,9693
1309,台達化,6,0,6,富邦-新營,2023-01-09,9693
3711,日月光投控,10,4,6,富邦-新營,2023-01-09,9693
8171,天宇,11,5,6,富邦-新營,2023-01-09,9693
3443,創意,6,1,5,富邦-新營,2023-01-09,9693
00715L,期街口布蘭特正2,5,0,5,富邦-新營,2023-01-09,9693
1506,正道,5,0,5,富邦-新營,2023-01-09,9693
2344,華邦電,7,2,5,富邦-新營,2023-01-09,9693
3027,盛達,105,100,5,富邦-新營,2023-01-09,9693
5469,瀚宇博,5,0,5,富邦-新營,2023-01-09,9693
8040,九暘,5,0,5,富邦-新營,2023-01-09,9693
9933,中鼎,5,0,5,富邦-新營,2023-01-09,9693
8299,群聯,5,0,5,富邦-新營,2023-01-09,9693
3141,晶宏,4,0,4,富邦-新營,2023-01-09,9693
6215,和椿,4,0,4,富邦-新營,2023-01-09,9693
8358,金居,11,7,4,富邦-新營,2023-01-09,9693
2379,瑞昱,4,0,4,富邦-新營,2023-01-09,9693
0050,元大台灣50,6,2,4,富邦-新營,2023-01-09,9693
1447,力鵬,3,0,3,富邦-新營,2023-01-09,9693
1504,東元,3,0,3,富邦-新營,2023-01-09,9693
1810,和成,13,10,3,富邦-新營,2023-01-09,9693
2228,劍麟,3,0,3,富邦-新營,2023-01-09,9693
2329,華泰,3,0,3,富邦-新營,2023-01-09,9693
2338,光罩,10,7,3,富邦-新營,2023-01-09,9693
2402,毅嘉,3,0,3,富邦-新營,2023-01-09,9693
3048,益登,3,0,3,富邦-新營,2023-01-09,9693
3294,英濟,3,0,3,富邦-新營,2023-01-09,9693
4114,健喬,18,15,3,富邦-新營,2023-01-09,9693
5227,立凱-KY,3,0,3,富邦-新營,2023-01-09,9693
5236,凌陽創新,3,0,3,富邦-新營,2023-01-09,9693
6570,維田,3,0,3,富邦-新營,2023-01-09,9693
6741,91APP*-KY,3,0,3,富邦-新營,2023-01-09,9693
8429,金麗-KY,3,0,3,富邦-新營,2023-01-09,9693
2881,富邦金,33,3,30,富邦-新營,2023-01-10,9693
00885,富邦越南,41,15,26,富邦-新營,2023-01-10,9693
2312,金寶,21,0,21,富邦-新營,2023-01-10,9693
2753,八方雲集,18,0,18,富邦-新營,2023-01-10,9693
2444,兆勁,17,0,17,富邦-新營,2023-01-10,9693
00715L,期街口布蘭特正2,15,0,15,富邦-新營,2023-01-10,9693
1810,和成,16,1,15,富邦-新營,2023-01-10,9693
6770,力積電,17,6,11,富邦-新營,2023-01-10,9693
00642U,期元大S＆P石油,10,0,10,富邦-新營,2023-01-10,9693
2897,王道銀行,10,0,10,富邦-新營,2023-01-10,9693
8121,越峰,10,0,10,富邦-新營,2023-01-10,9693
1443,立益物流,9,0,9,富邦-新營,2023-01-10,9693
2888,新光金,10,1,9,富邦-新營,2023-01-10,9693
3454,晶睿,29,20,9,富邦-新營,2023-01-10,9693
6133,金橋,10,1,9,富邦-新營,2023-01-10,9693
3163,波若威,13,5,8,富邦-新營,2023-01-10,9693
5014,建錩,7,0,7,富邦-新營,2023-01-10,9693
8358,金居,12,5,7,富邦-新營,2023-01-10,9693
1440,南紡,6,0,6,富邦-新營,2023-01-10,9693
3374,精材,8,2,6,富邦-新營,2023-01-10,9693
8171,天宇,8,2,6,富邦-新營,2023-01-10,9693
00915,凱基優選高股息30,5,0,5,富邦-新營,2023-01-10,9693
1313,聯成,5,0,5,富邦-新營,2023-01-10,9693
2812,台中銀,10,5,5,富邦-新營,2023-01-10,9693
6789,采鈺,5,0,5,富邦-新營,2023-01-10,9693
2883,凱基金,6,2,4,富邦-新營,2023-01-10,9693
2887,台新金,5,1,4,富邦-新營,2023-01-10,9693
2367,燿華,14,10,4,富邦-新營,2023-01-10,9693
2618,長榮航,10,6,4,富邦-新營,2023-01-10,9693
5321,美而快,6,2,4,富邦-新營,2023-01-10,9693
8033,雷虎,4,0,4,富邦-新營,2023-01-10,9693
1795,美時,4,0,4,富邦-新營,2023-01-10,9693
0050,元大台灣50,4,0,4,富邦-新營,2023-01-10,9693
1720,生達,6,3,3,富邦-新營,2023-01-10,9693
2882,國泰金,3,0,3,富邦-新營,2023-01-10,9693
2642,宅配通,5,2,3,富邦-新營,2023-01-10,9693
3027,盛達,3,0,3,富邦-新營,2023-01-10,9693
3680,家登,3,0,3,富邦-新營,2023-01-10,9693
5236,凌陽創新,3,0,3,富邦-新營,2023-01-10,9693
6148,驊宏資,3,0,3,富邦-新營,2023-01-10,9693
9941,裕融,3,0,3,富邦-新營,2023-01-10,9693
2884,玉山金,3,0,3,富邦-新營,2023-01-10,9693
2603,長榮,6,4,2,富邦-新營,2023-01-10,9693
00683L,期元大美元指正2,2,0,2,富邦-新營,2023-01-10,9693
1516,川飛,2,0,2,富邦-新營,2023-01-10,9693
1609,大亞,4,2,2,富邦-新營,2023-01-10,9693
1736,喬山,4,2,2,富邦-新營,2023-01-10,9693
2028,威致,2,0,2,富邦-新營,2023-01-10,9693
2301,光寶科,2,0,2,富邦-新營,2023-01-10,9693
2338,光罩,9,7,2,富邦-新營,2023-01-10,9693
2812,台中銀,226,0,226,富邦-新營,2023-01-11,9693
2887,台新金,25,0,25,富邦-新營,2023-01-11,9693
2611,志信,20,0,20,富邦-新營,2023-01-11,9693
3715,定穎投控,20,0,20,富邦-新營,2023-01-11,9693
8227,巨有科技,20,0,20,富邦-新營,2023-01-11,9693
6550,北極星藥業-KY,16,1,15,富邦-新營,2023-01-11,9693
4162,智擎,21,7,14,富邦-新營,2023-01-11,9693
1718,中纖,17,5,12,富邦-新營,2023-01-11,9693
2888,新光金,12,0,12,富邦-新營,2023-01-11,9693
2436,偉詮電,20,9,11,富邦-新營,2023-01-11,9693
2888B,新光金乙特,11,0,11,富邦-新營,2023-01-11,9693
00637L,元大滬深300正2,10,0,10,富邦-新營,2023-01-11,9693
2406,國碩,10,0,10,富邦-新營,2023-01-11,9693
3003,健和興,10,0,10,富邦-新營,2023-01-11,9693
1522,堤維西,8,0,8,富邦-新營,2023-01-11,9693
6788,華景電,8,0,8,富邦-新營,2023-01-11,9693
3665,貿聯-KY,7,0,7,富邦-新營,2023-01-11,9693
4906,正文,7,0,7,富邦-新營,2023-01-11,9693
00720B,元大投資級公司債,6,0,6,富邦-新營,2023-01-11,9693
1319,東陽,6,0,6,富邦-新營,2023-01-11,9693
1506,正道,6,0,6,富邦-新營,2023-01-11,9693
2367,燿華,6,0,6,富邦-新營,2023-01-11,9693
2368,金像電,6,0,6,富邦-新營,2023-01-11,9693
3083,網龍,6,0,6,富邦-新營,2023-01-11,9693
6148,驊宏資,6,0,6,富邦-新營,2023-01-11,9693
8429,金麗-KY,6,0,6,富邦-新營,2023-01-11,9693
2317,鴻海,7,1,6,富邦-新營,2023-01-11,9693
2884,玉山金,5,0,5,富邦-新營,2023-01-11,9693
4747,強生,5,0,5,富邦-新營,2023-01-11,9693
5258,虹堡,7,2,5,富邦-新營,2023-01-11,9693
00772B,中信高評級公司債,5,0,5,富邦-新營,2023-01-11,9693
2637,慧洋-KY,5,0,5,富邦-新營,2023-01-11,9693
2915,潤泰全,5,0,5,富邦-新營,2023-01-11,9693
3441,聯一光,5,0,5,富邦-新營,2023-01-11,9693
4147,中裕,5,0,5,富邦-新營,2023-01-11,9693
4958,臻鼎-KY,5,0,5,富邦-新營,2023-01-11,9693
6488,環球晶,5,0,5,富邦-新營,2023-01-11,9693
8171,天宇,9,4,5,富邦-新營,2023-01-11,9693
3704,合勤控,12,8,4,富邦-新營,2023-01-11,9693
1513,中興電,4,0,4,富邦-新營,2023-01-11,9693
1609,大亞,4,0,4,富邦-新營,2023-01-11,9693
2344,華邦電,5,1,4,富邦-新營,2023-01-11,9693
3290,東浦,4,0,4,富邦-新營,2023-01-11,9693
4167,松瑞藥,4,0,4,富邦-新營,2023-01-11,9693
4576,大銀微系統,4,0,4,富邦-新營,2023-01-11,9693
6167,久正,4,0,4,富邦-新營,2023-01-11,9693
00679B,元大美債20年,3,0,3,富邦-新營,2023-01-11,9693
3481,群創,175,172,3,富邦-新營,2023-01-11,9693
4979,華星光,17,14,3,富邦-新營,2023-01-11,9693
00738U,期元大道瓊白銀,3,0,3,富邦-新營,2023-01-11,9693
2812,台中銀,45,0,45,富邦-新營,2023-01-12,9693
00878,國泰永續高股息,37,7,30,富邦-新營,2023-01-12,9693
00882,中信中國高股息,18,0,18,富邦-新營,2023-01-12,9693
00888,永豐台灣ESG,14,0,14,富邦-新營,2023-01-12,9693
2610,華航,16,3,13,富邦-新營,2023-01-12,9693
4162,智擎,15,3,12,富邦-新營,2023-01-12,9693
2887,台新金,11,0,11,富邦-新營,2023-01-12,9693
00897,富邦基因免疫生技,12,1,11,富邦-新營,2023-01-12,9693
4167,松瑞藥,12,1,11,富邦-新營,2023-01-12,9693
5009,榮剛,13,2,11,富邦-新營,2023-01-12,9693
1102,亞泥,10,0,10,富邦-新營,2023-01-12,9693
00770,國泰北美科技,10,0,10,富邦-新營,2023-01-12,9693
1519,華城,11,1,10,富邦-新營,2023-01-12,9693
2405,輔信,11,1,10,富邦-新營,2023-01-12,9693
3322,建舜電,10,0,10,富邦-新營,2023-01-12,9693
2537,聯上發,9,0,9,富邦-新營,2023-01-12,9693
00728,第一金工業30,7,0,7,富邦-新營,2023-01-12,9693
00633L,富邦上証正2,9,2,7,富邦-新營,2023-01-12,9693
1506,正道,7,0,7,富邦-新營,2023-01-12,9693
2014,中鴻,9,2,7,富邦-新營,2023-01-12,9693
2609,陽明,16,10,6,富邦-新營,2023-01-12,9693
6282,康舒,6,0,6,富邦-新營,2023-01-12,9693
00676R,富邦臺灣加權反1,5,0,5,富邦-新營,2023-01-12,9693
00673R,期元大S＆P原油反1,5,0,5,富邦-新營,2023-01-12,9693
00669R,國泰美國道瓊反1,5,0,5,富邦-新營,2023-01-12,9693
00664R,國泰臺灣加權反1,5,0,5,富邦-新營,2023-01-12,9693
00632R,元大台灣50反1,5,0,5,富邦-新營,2023-01-12,9693
1314,中石化,5,0,5,富邦-新營,2023-01-12,9693
1605,華新,24,19,5,富邦-新營,2023-01-12,9693
2436,偉詮電,7,2,5,富邦-新營,2023-01-12,9693
2611,志信,5,0,5,富邦-新營,2023-01-12,9693
3163,波若威,6,1,5,富邦-新營,2023-01-12,9693
3558,神準,5,0,5,富邦-新營,2023-01-12,9693
2884,玉山金,4,0,4,富邦-新營,2023-01-12,9693
2308,台達電,4,0,4,富邦-新營,2023-01-12,9693
8033,雷虎,5,1,4,富邦-新營,2023-01-12,9693
00900,富邦特選高股息30,14,10,4,富邦-新營,2023-01-12,9693
00905,FT臺灣Smart,5,1,4,富邦-新營,2023-01-12,9693
1718,中纖,4,0,4,富邦-新營,2023-01-12,9693
1795,美時,5,1,4,富邦-新營,2023-01-12,9693
2402,毅嘉,6,2,4,富邦-新營,2023-01-12,9693
3128,昇銳,4,0,4,富邦-新營,2023-01-12,9693
3714,富采,8,4,4,富邦-新營,2023-01-12,9693
4114,健喬,4,0,4,富邦-新營,2023-01-12,9693
6605,帝寶,4,0,4,富邦-新營,2023-01-12,9693
8171,天宇,4,0,4,富邦-新營,2023-01-12,9693
00753L,中信中國50正2,3,0,3,富邦-新營,2023-01-12,9693
00915,凱基優選高股息30,3,0,3,富邦-新營,2023-01-12,9693
1471,首利,3,0,3,富邦-新營,2023-01-12,9693
1513,中興電,8,5,3,富邦-新營,2023-01-12,9693
00680L,元大美債20正2,200,0,200,富邦-新營,2023-01-13,9693
2897,王道銀行,40,0,40,富邦-新營,2023-01-13,9693
1609,大亞,31,0,31,富邦-新營,2023-01-13,9693
2399,映泰,30,0,30,富邦-新營,2023-01-13,9693
2887,台新金,25,0,25,富邦-新營,2023-01-13,9693
2812,台中銀,21,0,21,富邦-新營,2023-01-13,9693
6133,金橋,20,0,20,富邦-新營,2023-01-13,9693
3710,連展投控,19,0,19,富邦-新營,2023-01-13,9693
00882,中信中國高股息,19,2,17,富邦-新營,2023-01-13,9693
00772B,中信高評級公司債,14,0,14,富邦-新營,2023-01-13,9693
3443,創意,17,5,12,富邦-新營,2023-01-13,9693
4906,正文,11,0,11,富邦-新營,2023-01-13,9693
00637L,元大滬深300正2,10,0,10,富邦-新營,2023-01-13,9693
1701,中化,10,0,10,富邦-新營,2023-01-13,9693
2358,廷鑫,13,3,10,富邦-新營,2023-01-13,9693
2537,聯上發,10,0,10,富邦-新營,2023-01-13,9693
3289,宜特,10,0,10,富邦-新營,2023-01-13,9693
1440,南紡,9,0,9,富邦-新營,2023-01-13,9693
2889,國票金,10,3,7,富邦-新營,2023-01-13,9693
1513,中興電,7,0,7,富邦-新營,2023-01-13,9693
1605,華新,12,5,7,富邦-新營,2023-01-13,9693
3576,聯合再生,7,0,7,富邦-新營,2023-01-13,9693
9955,佳龍,15,8,7,富邦-新營,2023-01-13,9693
1720,生達,6,0,6,富邦-新營,2023-01-13,9693
4162,智擎,12,6,6,富邦-新營,2023-01-13,9693
00632R,元大台灣50反1,6,0,6,富邦-新營,2023-01-13,9693
3163,波若威,8,2,6,富邦-新營,2023-01-13,9693
4526,東台,6,0,6,富邦-新營,2023-01-13,9693
2607,榮運,6,0,6,富邦-新營,2023-01-13,9693
00888,永豐台灣ESG,5,0,5,富邦-新營,2023-01-13,9693
2385,群光,5,0,5,富邦-新營,2023-01-13,9693
00669R,國泰美國道瓊反1,5,0,5,富邦-新營,2023-01-13,9693
1102,亞泥,5,0,5,富邦-新營,2023-01-13,9693
2883,凱基金,6,1,5,富邦-新營,2023-01-13,9693
2888B,新光金乙特,5,0,5,富邦-新營,2023-01-13,9693
2915,潤泰全,5,0,5,富邦-新營,2023-01-13,9693
3322,建舜電,5,0,5,富邦-新營,2023-01-13,9693
3707,漢磊,17,12,5,富邦-新營,2023-01-13,9693
3714,富采,5,0,5,富邦-新營,2023-01-13,9693
4702,中美實,5,0,5,富邦-新營,2023-01-13,9693
6120,達運,5,0,5,富邦-新營,2023-01-13,9693
6770,力積電,21,16,5,富邦-新營,2023-01-13,9693
00655L,國泰中國A50正2,10,5,5,富邦-新營,2023-01-13,9693
2498,宏達電,9,5,4,富邦-新營,2023-01-13,9693
8429,金麗-KY,4,0,4,富邦-新營,2023-01-13,9693
2331,精英,4,0,4,富邦-新營,2023-01-13,9693
2344,華邦電,7,3,4,富邦-新營,2023-01-13,9693
2916,滿心,4,0,4,富邦-新營,2023-01-13,9693
4746,台耀,5,1,4,富邦-新營,2023-01-13,9693
5299,杰力,3,0,3,富邦-新營,2023-01-13,9693
2371,大同,110,0,110,富邦-新營,2023-01-16,9693
2812,台中銀,45,0,45,富邦-新營,2023-01-16,9693
4164,承業醫,32,4,28,富邦-新營,2023-01-16,9693
2317,鴻海,22,0,22,富邦-新營,2023-01-16,9693
4540,全球傳動,16,0,16,富邦-新營,2023-01-16,9693
6770,力積電,15,0,15,富邦-新營,2023-01-16,9693
4162,智擎,17,3,14,富邦-新營,2023-01-16,9693
1440,南紡,11,0,11,富邦-新營,2023-01-16,9693
2897,王道銀行,11,0,11,富邦-新營,2023-01-16,9693
4104,佳醫,11,0,11,富邦-新營,2023-01-16,9693
00632R,元大台灣50反1,10,0,10,富邦-新營,2023-01-16,9693
00680L,元大美債20正2,10,0,10,富邦-新營,2023-01-16,9693
3710,連展投控,10,0,10,富邦-新營,2023-01-16,9693
6120,達運,10,0,10,富邦-新營,2023-01-16,9693
6142,友勁,10,0,10,富邦-新營,2023-01-16,9693
6461,益得,10,0,10,富邦-新營,2023-01-16,9693
6492,生華科,10,0,10,富邦-新營,2023-01-16,9693
1701,中化,15,6,9,富邦-新營,2023-01-16,9693
2402,毅嘉,8,0,8,富邦-新營,2023-01-16,9693
4168,醣聯,8,0,8,富邦-新營,2023-01-16,9693
4906,正文,9,1,8,富邦-新營,2023-01-16,9693
00772B,中信高評級公司債,6,0,6,富邦-新營,2023-01-16,9693
2399,映泰,6,0,6,富邦-新營,2023-01-16,9693
3163,波若威,6,0,6,富邦-新營,2023-01-16,9693
8044,網家,7,1,6,富邦-新營,2023-01-16,9693
00679B,元大美債20年,5,0,5,富邦-新營,2023-01-16,9693
00671R,富邦NASDAQ反1,5,0,5,富邦-新營,2023-01-16,9693
1605,華新,9,4,5,富邦-新營,2023-01-16,9693
2014,中鴻,55,50,5,富邦-新營,2023-01-16,9693
2032,新鋼,5,0,5,富邦-新營,2023-01-16,9693
5536,聖暉*,5,0,5,富邦-新營,2023-01-16,9693
4974,亞泰,5,0,5,富邦-新營,2023-01-16,9693
00633L,富邦上証正2,4,0,4,富邦-新營,2023-01-16,9693
00720B,元大投資級公司債,3,0,3,富邦-新營,2023-01-16,9693
00665L,富邦�琤肭磪囓�2,3,0,3,富邦-新營,2023-01-16,9693
00673R,期元大S＆P原油反1,3,0,3,富邦-新營,2023-01-16,9693
00900,富邦特選高股息30,3,0,3,富邦-新營,2023-01-16,9693
2028,威致,3,0,3,富邦-新營,2023-01-16,9693
2498,宏達電,3,0,3,富邦-新營,2023-01-16,9693
2915,潤泰全,3,0,3,富邦-新營,2023-01-16,9693
3162,精確,3,0,3,富邦-新營,2023-01-16,9693
3520,華盈,3,0,3,富邦-新營,2023-01-16,9693
4105,東洋,3,0,3,富邦-新營,2023-01-16,9693
4155,訊映,4,1,3,富邦-新營,2023-01-16,9693
5243,乙盛-KY,3,0,3,富邦-新營,2023-01-16,9693
2454,聯發科,3,0,3,富邦-新營,2023-01-16,9693
00892,富邦台灣半導體,3,1,2,富邦-新營,2023-01-16,9693
2009,第一銅,2,0,2,富邦-新營,2023-01-16,9693
2313,華通,3,1,2,富邦-新營,2023-01-16,9693
2337,旺宏,2,0,2,富邦-新營,2023-01-16,9693
2882,國泰金,71,1,70,富邦-新營,2023-01-17,9693
4540,全球傳動,34,0,34,富邦-新營,2023-01-17,9693
2409,友達,37,5,32,富邦-新營,2023-01-17,9693
00632R,元大台灣50反1,24,0,24,富邦-新營,2023-01-17,9693
2851,中再保,25,1,24,富邦-新營,2023-01-17,9693
4157,太景*-KY,20,0,20,富邦-新營,2023-01-17,9693
2317,鴻海,25,8,17,富邦-新營,2023-01-17,9693
0050,元大台灣50,16,0,16,富邦-新營,2023-01-17,9693
3707,漢磊,15,0,15,富邦-新營,2023-01-17,9693
2610,華航,11,0,11,富邦-新營,2023-01-17,9693
1101,台泥,10,0,10,富邦-新營,2023-01-17,9693
00686R,群益臺灣加權反1,10,0,10,富邦-新營,2023-01-17,9693
00669R,國泰美國道瓊反1,10,0,10,富邦-新營,2023-01-17,9693
3693,營邦,23,15,8,富邦-新營,2023-01-17,9693
1752,南光,21,13,8,富邦-新營,2023-01-17,9693
4168,醣聯,8,0,8,富邦-新營,2023-01-17,9693
6461,益得,9,1,8,富邦-新營,2023-01-17,9693
6770,力積電,14,6,8,富邦-新營,2023-01-17,9693
00633L,富邦上証正2,7,0,7,富邦-新營,2023-01-17,9693
00648R,元大S＆P500反1,7,0,7,富邦-新營,2023-01-17,9693
6609,瀧澤科,9,2,7,富邦-新營,2023-01-17,9693
00882,中信中國高股息,9,3,6,富邦-新營,2023-01-17,9693
3443,創意,11,5,6,富邦-新營,2023-01-17,9693
6153,嘉聯益,5,0,5,富邦-新營,2023-01-17,9693
00676R,富邦臺灣加權反1,5,0,5,富邦-新營,2023-01-17,9693
00673R,期元大S＆P原油反1,5,0,5,富邦-新營,2023-01-17,9693
00664R,國泰臺灣加權反1,5,0,5,富邦-新營,2023-01-17,9693
4943,康控-KY,5,0,5,富邦-新營,2023-01-17,9693
6235,華孚,5,0,5,富邦-新營,2023-01-17,9693
00878,國泰永續高股息,9,5,4,富邦-新營,2023-01-17,9693
1443,立益物流,4,0,4,富邦-新營,2023-01-17,9693
2351,順德,4,0,4,富邦-新營,2023-01-17,9693
3011,今皓,4,0,4,富邦-新營,2023-01-17,9693
3163,波若威,4,0,4,富邦-新營,2023-01-17,9693
4155,訊映,4,0,4,富邦-新營,2023-01-17,9693
4906,正文,8,4,4,富邦-新營,2023-01-17,9693
5236,凌陽創新,4,0,4,富邦-新營,2023-01-17,9693
5299,杰力,4,0,4,富邦-新營,2023-01-17,9693
5608,四維航,4,0,4,富邦-新營,2023-01-17,9693
4979,華星光,12,8,4,富邦-新營,2023-01-17,9693
2812,台中銀,5,2,3,富邦-新營,2023-01-17,9693
00772B,中信高評級公司債,3,0,3,富邦-新營,2023-01-17,9693
00665L,富邦�琤肭磪囓�2,3,0,3,富邦-新營,2023-01-17,9693
1529,樂事綠能,3,0,3,富邦-新營,2023-01-17,9693
1560,中砂,3,0,3,富邦-新營,2023-01-17,9693
1701,中化,3,0,3,富邦-新營,2023-01-17,9693
1727,中華化,3,0,3,富邦-新營,2023-01-17,9693
2028,威致,3,0,3,富邦-新營,2023-01-17,9693
2888B,新光金乙特,3,0,3,富邦-新營,2023-01-17,9693
3162,精確,3,0,3,富邦-新營,2023-01-17,9693
4157,太景*-KY,50,0,50,富邦-新營,2023-01-30,9693
5371,中光電,45,3,42,富邦-新營,2023-01-30,9693
00632R,元大台灣50反1,35,0,35,富邦-新營,2023-01-30,9693
2530,華建,30,0,30,富邦-新營,2023-01-30,9693
00878,國泰永續高股息,29,2,27,富邦-新營,2023-01-30,9693
6477,安集,21,0,21,富邦-新營,2023-01-30,9693
2834,臺企銀,26,5,21,富邦-新營,2023-01-30,9693
2317,鴻海,20,0,20,富邦-新營,2023-01-30,9693
3027,盛達,20,0,20,富邦-新營,2023-01-30,9693
4968,立積,11,0,11,富邦-新營,2023-01-30,9693
00720B,元大投資級公司債,10,0,10,富邦-新營,2023-01-30,9693
2539,櫻花建,10,0,10,富邦-新營,2023-01-30,9693
3711,日月光投控,10,0,10,富邦-新營,2023-01-30,9693
2637,慧洋-KY,9,0,9,富邦-新營,2023-01-30,9693
2014,中鴻,14,6,8,富邦-新營,2023-01-30,9693
4979,華星光,15,7,8,富邦-新營,2023-01-30,9693
2890,永豐金,9,1,8,富邦-新營,2023-01-30,9693
1305,華夏,10,3,7,富邦-新營,2023-01-30,9693
2028,威致,8,1,7,富邦-新營,2023-01-30,9693
4105,東洋,7,0,7,富邦-新營,2023-01-30,9693
6456,GIS-KY,7,0,7,富邦-新營,2023-01-30,9693
1513,中興電,23,16,7,富邦-新營,2023-01-30,9693
00673R,期元大S＆P原油反1,6,0,6,富邦-新營,2023-01-30,9693
1442,名軒,6,0,6,富邦-新營,2023-01-30,9693
3162,精確,6,0,6,富邦-新營,2023-01-30,9693
3693,營邦,50,44,6,富邦-新營,2023-01-30,9693
8429,金麗-KY,15,9,6,富邦-新營,2023-01-30,9693
2885,元大金,6,0,6,富邦-新營,2023-01-30,9693
00751B,元大AAA至A公司債,5,0,5,富邦-新營,2023-01-30,9693
3051,力特,5,0,5,富邦-新營,2023-01-30,9693
3362,先進光,5,0,5,富邦-新營,2023-01-30,9693
4114,健喬,53,48,5,富邦-新營,2023-01-30,9693
5236,凌陽創新,5,0,5,富邦-新營,2023-01-30,9693
6541,泰福-KY,6,1,5,富邦-新營,2023-01-30,9693
8033,雷虎,5,0,5,富邦-新營,2023-01-30,9693
8054,安國,5,0,5,富邦-新營,2023-01-30,9693
9933,中鼎,5,0,5,富邦-新營,2023-01-30,9693
9941,裕融,7,2,5,富邦-新營,2023-01-30,9693
00633L,富邦上証正2,9,5,4,富邦-新營,2023-01-30,9693
1909,榮成,4,0,4,富邦-新營,2023-01-30,9693
2038,海光,5,1,4,富邦-新營,2023-01-30,9693
3680,家登,6,2,4,富邦-新營,2023-01-30,9693
4540,全球傳動,5,1,4,富邦-新營,2023-01-30,9693
8996,高力,13,9,4,富邦-新營,2023-01-30,9693
00772B,中信高評級公司債,3,0,3,富邦-新營,2023-01-30,9693
00725B,國泰投資級公司債,3,0,3,富邦-新營,2023-01-30,9693
00905,FT臺灣Smart,3,0,3,富邦-新營,2023-01-30,9693
1210,大成,3,0,3,富邦-新營,2023-01-30,9693
2230,泰茂,6,3,3,富邦-新營,2023-01-30,9693
3189,景碩,5,2,3,富邦-新營,2023-01-30,9693
00905,FT臺灣Smart,103,2,101,富邦-新營,2023-01-31,9693
2465,麗臺,100,2,98,富邦-新營,2023-01-31,9693
1609,大亞,35,9,26,富邦-新營,2023-01-31,9693
8926,台汽電,25,0,25,富邦-新營,2023-01-31,9693
00878,國泰永續高股息,29,4,25,富邦-新營,2023-01-31,9693
5371,中光電,24,0,24,富邦-新營,2023-01-31,9693
3081,聯亞,24,2,22,富邦-新營,2023-01-31,9693
3163,波若威,20,0,20,富邦-新營,2023-01-31,9693
3454,晶睿,66,46,20,富邦-新營,2023-01-31,9693
2887,台新金,17,0,17,富邦-新營,2023-01-31,9693
1524,耿鼎,36,20,16,富邦-新營,2023-01-31,9693
1519,華城,15,0,15,富邦-新營,2023-01-31,9693
2317,鴻海,19,6,13,富邦-新營,2023-01-31,9693
2834,臺企銀,13,0,13,富邦-新營,2023-01-31,9693
00720B,元大投資級公司債,13,0,13,富邦-新營,2023-01-31,9693
00882,中信中國高股息,11,0,11,富邦-新營,2023-01-31,9693
8358,金居,14,3,11,富邦-新營,2023-01-31,9693
8933,愛地雅,11,0,11,富邦-新營,2023-01-31,9693
2029,盛餘,10,0,10,富邦-新營,2023-01-31,9693
2069,運錩,11,1,10,富邦-新營,2023-01-31,9693
2328,廣宇,10,0,10,富邦-新營,2023-01-31,9693
2542,興富發,10,0,10,富邦-新營,2023-01-31,9693
4540,全球傳動,10,0,10,富邦-新營,2023-01-31,9693
4554,橙的,10,0,10,富邦-新營,2023-01-31,9693
6190,萬泰科,10,0,10,富邦-新營,2023-01-31,9693
00673R,期元大S＆P原油反1,9,0,9,富邦-新營,2023-01-31,9693
00885,富邦越南,19,10,9,富邦-新營,2023-01-31,9693
2912,統一超,10,1,9,富邦-新營,2023-01-31,9693
8033,雷虎,10,2,8,富邦-新營,2023-01-31,9693
2330,台積電,10,2,8,富邦-新營,2023-01-31,9693
00772B,中信高評級公司債,7,0,7,富邦-新營,2023-01-31,9693
2892,第一金,7,0,7,富邦-新營,2023-01-31,9693
4162,智擎,7,0,7,富邦-新營,2023-01-31,9693
6182,合晶,7,0,7,富邦-新營,2023-01-31,9693
6188,廣明,6,0,6,富邦-新營,2023-01-31,9693
00680L,元大美債20正2,5,0,5,富邦-新營,2023-01-31,9693
00893,國泰智能電動車,5,0,5,富邦-新營,2023-01-31,9693
1504,東元,5,0,5,富邦-新營,2023-01-31,9693
1809,中釉,5,0,5,富邦-新營,2023-01-31,9693
2032,新鋼,5,0,5,富邦-新營,2023-01-31,9693
2347,聯強,5,0,5,富邦-新營,2023-01-31,9693
2358,廷鑫,5,0,5,富邦-新營,2023-01-31,9693
2812,台中銀,5,0,5,富邦-新營,2023-01-31,9693
2885,元大金,5,0,5,富邦-新營,2023-01-31,9693
4114,健喬,4,0,4,富邦-新營,2023-01-31,9693
2880,華南金,4,0,4,富邦-新營,2023-01-31,9693
1442,名軒,4,0,4,富邦-新營,2023-01-31,9693
1701,中化,6,2,4,富邦-新營,2023-01-31,9693
2882,國泰金,4,0,4,富邦-新營,2023-01-31,9693
2891,中信金,4,0,4,富邦-新營,2023-01-31,9693
2601,益航,80,0,80,富邦-新營,2023-02-01,9693
00878,國泰永續高股息,44,0,44,富邦-新營,2023-02-01,9693
2897,王道銀行,36,0,36,富邦-新營,2023-02-01,9693
00753L,中信中國50正2,35,0,35,富邦-新營,2023-02-01,9693
1584,精剛,188,155,33,富邦-新營,2023-02-01,9693
6788,華景電,33,0,33,富邦-新營,2023-02-01,9693
2014,中鴻,29,2,27,富邦-新營,2023-02-01,9693
2009,第一銅,49,26,23,富邦-新營,2023-02-01,9693
2890,永豐金,23,0,23,富邦-新營,2023-02-01,9693
3372,典範,22,0,22,富邦-新營,2023-02-01,9693
4968,立積,52,30,22,富邦-新營,2023-02-01,9693
00885,富邦越南,30,12,18,富邦-新營,2023-02-01,9693
5876,上海商銀,15,0,15,富邦-新營,2023-02-01,9693
6202,盛群,13,0,13,富邦-新營,2023-02-01,9693
2506,太設,12,0,12,富邦-新營,2023-02-01,9693
00673R,期元大S＆P原油反1,10,0,10,富邦-新營,2023-02-01,9693
00720B,元大投資級公司債,10,0,10,富邦-新營,2023-02-01,9693
2358,廷鑫,14,4,10,富邦-新營,2023-02-01,9693
3051,力特,10,0,10,富邦-新營,2023-02-01,9693
5483,中美晶,10,0,10,富邦-新營,2023-02-01,9693
3406,玉晶光,11,1,10,富邦-新營,2023-02-01,9693
2812,台中銀,9,0,9,富邦-新營,2023-02-01,9693
2354,鴻準,10,1,9,富邦-新營,2023-02-01,9693
3675,德微,12,3,9,富邦-新營,2023-02-01,9693
5388,中磊,8,0,8,富邦-新營,2023-02-01,9693
2603,長榮,9,2,7,富邦-新營,2023-02-01,9693
2317,鴻海,7,0,7,富邦-新營,2023-02-01,9693
2915,潤泰全,7,0,7,富邦-新營,2023-02-01,9693
2929,淘帝-KY,10,3,7,富邦-新營,2023-02-01,9693
1519,華城,6,0,6,富邦-新營,2023-02-01,9693
2038,海光,8,2,6,富邦-新營,2023-02-01,9693
2885,元大金,6,0,6,富邦-新營,2023-02-01,9693
2887,台新金,7,1,6,富邦-新營,2023-02-01,9693
3042,晶技,7,1,6,富邦-新營,2023-02-01,9693
8046,南電,19,13,6,富邦-新營,2023-02-01,9693
8222,寶一,11,5,6,富邦-新營,2023-02-01,9693
2614,東森,8,2,6,富邦-新營,2023-02-01,9693
4114,健喬,5,0,5,富邦-新營,2023-02-01,9693
2409,友達,5,0,5,富邦-新營,2023-02-01,9693
1444,力麗,5,0,5,富邦-新營,2023-02-01,9693
2033,佳大,5,0,5,富邦-新營,2023-02-01,9693
2371,大同,5,0,5,富邦-新營,2023-02-01,9693
3317,尼克森,5,0,5,富邦-新營,2023-02-01,9693
4729,熒茂,5,0,5,富邦-新營,2023-02-01,9693
1513,中興電,10,5,5,富邦-新營,2023-02-01,9693
5347,世界,5,0,5,富邦-新營,2023-02-01,9693
2412,中華電,4,0,4,富邦-新營,2023-02-01,9693
6806,森崴能源,4,0,4,富邦-新營,2023-02-01,9693
00905,FT臺灣Smart,4,0,4,富邦-新營,2023-02-01,9693
2606,裕民,6,2,4,富邦-新營,2023-02-01,9693
2883,凱基金,224,3,221,富邦-新營,2023-02-02,9693
2881,富邦金,201,1,200,富邦-新營,2023-02-02,9693
00885,富邦越南,101,0,101,富邦-新營,2023-02-02,9693
2351,順德,81,6,75,富邦-新營,2023-02-02,9693
2867,三商壽,50,0,50,富邦-新營,2023-02-02,9693
2812,台中銀,44,0,44,富邦-新營,2023-02-02,9693
1611,中電,41,0,41,富邦-新營,2023-02-02,9693
2601,益航,50,10,40,富邦-新營,2023-02-02,9693
00900,富邦特選高股息30,53,19,34,富邦-新營,2023-02-02,9693
00632R,元大台灣50反1,32,0,32,富邦-新營,2023-02-02,9693
5236,凌陽創新,35,3,32,富邦-新營,2023-02-02,9693
2884,玉山金,30,0,30,富邦-新營,2023-02-02,9693
2338,光罩,30,1,29,富邦-新營,2023-02-02,9693
0056,元大高股息,30,3,27,富邦-新營,2023-02-02,9693
3454,晶睿,23,2,21,富邦-新營,2023-02-02,9693
1605,華新,46,26,20,富邦-新營,2023-02-02,9693
3594,磐儀,18,0,18,富邦-新營,2023-02-02,9693
2891,中信金,18,1,17,富邦-新營,2023-02-02,9693
2201,裕隆,35,18,17,富邦-新營,2023-02-02,9693
6770,力積電,17,4,13,富邦-新營,2023-02-02,9693
4979,華星光,164,152,12,富邦-新營,2023-02-02,9693
2929,淘帝-KY,16,5,11,富邦-新營,2023-02-02,9693
2880,華南金,11,0,11,富邦-新營,2023-02-02,9693
00753L,中信中國50正2,10,0,10,富邦-新營,2023-02-02,9693
1464,得力,10,0,10,富邦-新營,2023-02-02,9693
2409,友達,10,0,10,富邦-新營,2023-02-02,9693
9938,百和,10,0,10,富邦-新營,2023-02-02,9693
2312,金寶,22,13,9,富邦-新營,2023-02-02,9693
6118,建達,10,1,9,富邦-新營,2023-02-02,9693
2317,鴻海,10,3,7,富邦-新營,2023-02-02,9693
00715L,期街口布蘭特正2,7,0,7,富邦-新營,2023-02-02,9693
2618,長榮航,21,14,7,富邦-新營,2023-02-02,9693
1506,正道,6,0,6,富邦-新營,2023-02-02,9693
3202,樺晟,6,0,6,富邦-新營,2023-02-02,9693
5284,jpp-KY,8,2,6,富邦-新營,2023-02-02,9693
6438,迅得,6,0,6,富邦-新營,2023-02-02,9693
3443,創意,24,18,6,富邦-新營,2023-02-02,9693
6670,復盛應用,5,0,5,富邦-新營,2023-02-02,9693
2014,中鴻,6,1,5,富邦-新營,2023-02-02,9693
2038,海光,5,0,5,富邦-新營,2023-02-02,9693
2492,華新科,7,2,5,富邦-新營,2023-02-02,9693
3013,晟銘電,12,7,5,富邦-新營,2023-02-02,9693
3033,威健,5,0,5,富邦-新營,2023-02-02,9693
3062,建漢,6,1,5,富邦-新營,2023-02-02,9693
4106,雃博,5,0,5,富邦-新營,2023-02-02,9693
4108,懷特,5,0,5,富邦-新營,2023-02-02,9693
4540,全球傳動,5,0,5,富邦-新營,2023-02-02,9693
6173,信昌電,5,0,5,富邦-新營,2023-02-02,9693
6443,元晶,9,4,5,富邦-新營,2023-02-02,9693
2615,萬海,21,16,5,富邦-新營,2023-02-02,9693
4919,新唐,113,4,109,富邦-新營,2023-02-03,9693
2890,永豐金,60,0,60,富邦-新營,2023-02-03,9693
2312,金寶,60,12,48,富邦-新營,2023-02-03,9693
2888,新光金,39,0,39,富邦-新營,2023-02-03,9693
00878,國泰永續高股息,40,1,39,富邦-新營,2023-02-03,9693
00680L,元大美債20正2,30,0,30,富邦-新營,2023-02-03,9693
2897,王道銀行,30,0,30,富邦-新營,2023-02-03,9693
00882,中信中國高股息,21,0,21,富邦-新營,2023-02-03,9693
1611,中電,20,0,20,富邦-新營,2023-02-03,9693
3508,位速,41,22,19,富邦-新營,2023-02-03,9693
00885,富邦越南,23,6,17,富邦-新營,2023-02-03,9693
2014,中鴻,16,0,16,富邦-新營,2023-02-03,9693
3704,合勤控,13,1,12,富邦-新營,2023-02-03,9693
1305,華夏,11,0,11,富邦-新營,2023-02-03,9693
2388,威盛,12,1,11,富邦-新營,2023-02-03,9693
8429,金麗-KY,11,0,11,富邦-新營,2023-02-03,9693
00917,中信特選金融,10,0,10,富邦-新營,2023-02-03,9693
1809,中釉,10,0,10,富邦-新營,2023-02-03,9693
2702,華園,10,0,10,富邦-新營,2023-02-03,9693
2867,三商壽,10,0,10,富邦-新營,2023-02-03,9693
2929,淘帝-KY,10,0,10,富邦-新營,2023-02-03,9693
6202,盛群,10,0,10,富邦-新營,2023-02-03,9693
8215,明基材,9,0,9,富邦-新營,2023-02-03,9693
8289,泰藝,8,0,8,富邦-新營,2023-02-03,9693
3594,磐儀,7,0,7,富邦-新營,2023-02-03,9693
6217,中探針,7,0,7,富邦-新營,2023-02-03,9693
4142,國光生,6,0,6,富邦-新營,2023-02-03,9693
6806,森崴能源,6,0,6,富邦-新營,2023-02-03,9693
2458,義隆,6,0,6,富邦-新營,2023-02-03,9693
3141,晶宏,14,8,6,富邦-新營,2023-02-03,9693
4747,強生,6,0,6,富邦-新營,2023-02-03,9693
5907,大洋-KY,6,0,6,富邦-新營,2023-02-03,9693
1108,幸福,5,0,5,富邦-新營,2023-02-03,9693
00905,FT臺灣Smart,5,0,5,富邦-新營,2023-02-03,9693
00752,中信中國50,5,0,5,富邦-新營,2023-02-03,9693
00665L,富邦�琤肭磪囓�2,6,1,5,富邦-新營,2023-02-03,9693
00632R,元大台灣50反1,5,0,5,富邦-新營,2023-02-03,9693
1708,東鹼,7,2,5,富邦-新營,2023-02-03,9693
2230,泰茂,8,3,5,富邦-新營,2023-02-03,9693
2618,長榮航,8,3,5,富邦-新營,2023-02-03,9693
2892,第一金,5,0,5,富邦-新營,2023-02-03,9693
5344,立衛,5,0,5,富邦-新營,2023-02-03,9693
6589,台康生技,5,0,5,富邦-新營,2023-02-03,9693
6708,天擎,5,0,5,富邦-新營,2023-02-03,9693
2882,國泰金,5,0,5,富邦-新營,2023-02-03,9693
3231,緯創,5,0,5,富邦-新營,2023-02-03,9693
2409,友達,5,1,4,富邦-新營,2023-02-03,9693
2891,中信金,5,1,4,富邦-新營,2023-02-03,9693
00642U,期元大S＆P石油,4,0,4,富邦-新營,2023-02-03,9693
1701,中化,6,2,4,富邦-新營,2023-02-03,9693
00878,國泰永續高股息,119,8,111,富邦-新營,2023-02-06,9693
2890,永豐金,99,0,99,富邦-新營,2023-02-06,9693
00632R,元大台灣50反1,80,3,77,富邦-新營,2023-02-06,9693
00680L,元大美債20正2,86,10,76,富邦-新營,2023-02-06,9693
3322,建舜電,70,0,70,富邦-新營,2023-02-06,9693
00885,富邦越南,51,3,48,富邦-新營,2023-02-06,9693
6133,金橋,40,0,40,富邦-新營,2023-02-06,9693
3454,晶睿,81,47,34,富邦-新營,2023-02-06,9693
00720B,元大投資級公司債,22,0,22,富邦-新營,2023-02-06,9693
2897,王道銀行,22,0,22,富邦-新營,2023-02-06,9693
00715L,期街口布蘭特正2,20,0,20,富邦-新營,2023-02-06,9693
2603,長榮,24,4,20,富邦-新營,2023-02-06,9693
3481,群創,20,3,17,富邦-新營,2023-02-06,9693
2880,華南金,17,0,17,富邦-新營,2023-02-06,9693
00772B,中信高評級公司債,17,0,17,富邦-新營,2023-02-06,9693
00679B,元大美債20年,18,2,16,富邦-新營,2023-02-06,9693
3013,晟銘電,45,31,14,富邦-新營,2023-02-06,9693
3443,創意,18,4,14,富邦-新營,2023-02-06,9693
00751B,元大AAA至A公司債,13,0,13,富邦-新營,2023-02-06,9693
1605,華新,40,27,13,富邦-新營,2023-02-06,9693
00900,富邦特選高股息30,12,0,12,富邦-新營,2023-02-06,9693
00882,中信中國高股息,12,0,12,富邦-新營,2023-02-06,9693
2891,中信金,11,0,11,富邦-新營,2023-02-06,9693
3041,揚智,11,0,11,富邦-新營,2023-02-06,9693
3701,大眾控,11,0,11,富邦-新營,2023-02-06,9693
5483,中美晶,10,0,10,富邦-新營,2023-02-06,9693
2312,金寶,10,0,10,富邦-新營,2023-02-06,9693
2615,萬海,10,0,10,富邦-新營,2023-02-06,9693
3042,晶技,11,1,10,富邦-新營,2023-02-06,9693
3259,鑫創,10,0,10,富邦-新營,2023-02-06,9693
4121,優盛,10,0,10,富邦-新營,2023-02-06,9693
2812,台中銀,9,0,9,富邦-新營,2023-02-06,9693
3447,展達,9,0,9,富邦-新營,2023-02-06,9693
00891,中信關鍵半導體,8,0,8,富邦-新營,2023-02-06,9693
1216,統一,8,0,8,富邦-新營,2023-02-06,9693
00665L,富邦�琤肭磪囓�2,8,0,8,富邦-新營,2023-02-06,9693
2317,鴻海,10,3,7,富邦-新營,2023-02-06,9693
5880,合庫金,7,0,7,富邦-新營,2023-02-06,9693
2368,金像電,8,1,7,富邦-新營,2023-02-06,9693
2458,義隆,7,0,7,富邦-新營,2023-02-06,9693
6461,益得,26,19,7,富邦-新營,2023-02-06,9693
2002,中鋼,6,0,6,富邦-新營,2023-02-06,9693
2303,聯電,16,10,6,富邦-新營,2023-02-06,9693
2201,裕隆,10,4,6,富邦-新營,2023-02-06,9693
2330,台積電,7,1,6,富邦-新營,2023-02-06,9693
2609,陽明,11,6,5,富邦-新營,2023-02-06,9693
0056,元大高股息,5,0,5,富邦-新營,2023-02-06,9693
00753L,中信中國50正2,5,0,5,富邦-新營,2023-02-06,9693
00642U,期元大S＆P石油,5,0,5,富邦-新營,2023-02-06,9693
00637L,元大滬深300正2,7,2,5,富邦-新營,2023-02-06,9693
2897,王道銀行,53,0,53,富邦-新營,2023-02-07,9693
4168,醣聯,50,0,50,富邦-新營,2023-02-07,9693
3322,建舜電,40,0,40,富邦-新營,2023-02-07,9693
1605,華新,51,17,34,富邦-新營,2023-02-07,9693
6235,華孚,98,68,30,富邦-新營,2023-02-07,9693
00878,國泰永續高股息,27,1,26,富邦-新營,2023-02-07,9693
00712,復華富時不動產,25,0,25,富邦-新營,2023-02-07,9693
00680L,元大美債20正2,23,0,23,富邦-新營,2023-02-07,9693
1752,南光,143,121,22,富邦-新營,2023-02-07,9693
2025,千興,20,0,20,富邦-新營,2023-02-07,9693
3675,德微,20,0,20,富邦-新營,2023-02-07,9693
3489,森寶,18,0,18,富邦-新營,2023-02-07,9693
3481,群創,23,8,15,富邦-新營,2023-02-07,9693
00780B,國泰A級金融債,13,0,13,富邦-新營,2023-02-07,9693
2313,華通,13,0,13,富邦-新營,2023-02-07,9693
00772B,中信高評級公司債,12,0,12,富邦-新營,2023-02-07,9693
2609,陽明,12,0,12,富邦-新營,2023-02-07,9693
9958,世紀鋼,12,0,12,富邦-新營,2023-02-07,9693
2812,台中銀,11,0,11,富邦-新營,2023-02-07,9693
00900,富邦特選高股息30,11,0,11,富邦-新營,2023-02-07,9693
00885,富邦越南,15,4,11,富邦-新營,2023-02-07,9693
3006,晶豪科,13,2,11,富邦-新營,2023-02-07,9693
8916,光隆,11,0,11,富邦-新營,2023-02-07,9693
00715L,期街口布蘭特正2,10,0,10,富邦-新營,2023-02-07,9693
2481,強茂,10,0,10,富邦-新營,2023-02-07,9693
2537,聯上發,10,0,10,富邦-新營,2023-02-07,9693
2906,高林,10,0,10,富邦-新營,2023-02-07,9693
3536,誠創,10,0,10,富邦-新營,2023-02-07,9693
2891,中信金,10,1,9,富邦-新營,2023-02-07,9693
2317,鴻海,9,1,8,富邦-新營,2023-02-07,9693
1319,東陽,7,0,7,富邦-新營,2023-02-07,9693
0056,元大高股息,7,0,7,富邦-新營,2023-02-07,9693
5009,榮剛,6,0,6,富邦-新營,2023-02-07,9693
1506,正道,6,0,6,富邦-新營,2023-02-07,9693
5299,杰力,6,0,6,富邦-新營,2023-02-07,9693
6414,樺漢,6,0,6,富邦-新營,2023-02-07,9693
2457,飛宏,6,1,5,富邦-新營,2023-02-07,9693
3317,尼克森,5,0,5,富邦-新營,2023-02-07,9693
4129,聯合,7,2,5,富邦-新營,2023-02-07,9693
4746,台耀,5,0,5,富邦-新營,2023-02-07,9693
4934,太極,5,0,5,富邦-新營,2023-02-07,9693
5464,霖宏,6,1,5,富邦-新營,2023-02-07,9693
5907,大洋-KY,5,0,5,富邦-新營,2023-02-07,9693
6770,力積電,6,1,5,富邦-新營,2023-02-07,9693
8289,泰藝,5,0,5,富邦-新營,2023-02-07,9693
2330,台積電,4,0,4,富邦-新營,2023-02-07,9693
2884,玉山金,4,0,4,富邦-新營,2023-02-07,9693
00751B,元大AAA至A公司債,4,0,4,富邦-新營,2023-02-07,9693
00665L,富邦�琤肭磪囓�2,4,0,4,富邦-新營,2023-02-07,9693
1785,光洋科,4,0,4,富邦-新營,2023-02-07,9693
00878,國泰永續高股息,166,2,164,富邦-新營,2023-02-08,9693
6235,華孚,177,38,139,富邦-新營,2023-02-08,9693
2498,宏達電,182,48,134,富邦-新營,2023-02-08,9693
00632R,元大台灣50反1,61,0,61,富邦-新營,2023-02-08,9693
3046,建��,50,2,48,富邦-新營,2023-02-08,9693
2614,東森,42,0,42,富邦-新營,2023-02-08,9693
00680L,元大美債20正2,40,0,40,富邦-新營,2023-02-08,9693
00885,富邦越南,40,0,40,富邦-新營,2023-02-08,9693
1584,精剛,53,16,37,富邦-新營,2023-02-08,9693
1795,美時,33,2,31,富邦-新營,2023-02-08,9693
00905,FT臺灣Smart,26,0,26,富邦-新營,2023-02-08,9693
3691,碩禾,26,0,26,富邦-新營,2023-02-08,9693
4128,中天,20,0,20,富邦-新營,2023-02-08,9693
5351,鈺創,22,2,20,富邦-新營,2023-02-08,9693
6282,康舒,44,24,20,富邦-新營,2023-02-08,9693
2888,新光金,14,0,14,富邦-新營,2023-02-08,9693
4174,浩鼎,14,0,14,富邦-新營,2023-02-08,9693
1524,耿鼎,13,0,13,富邦-新營,2023-02-08,9693
6217,中探針,15,2,13,富邦-新營,2023-02-08,9693
00679B,元大美債20年,12,0,12,富邦-新營,2023-02-08,9693
00688L,國泰20年美債正2,12,0,12,富邦-新營,2023-02-08,9693
00772B,中信高評級公司債,11,0,11,富邦-新營,2023-02-08,9693
00780B,國泰A級金融債,10,0,10,富邦-新營,2023-02-08,9693
00637L,元大滬深300正2,10,0,10,富邦-新營,2023-02-08,9693
00673R,期元大S＆P原油反1,10,0,10,富邦-新營,2023-02-08,9693
1217,愛之味,10,0,10,富邦-新營,2023-02-08,9693
1721,三晃,10,0,10,富邦-新營,2023-02-08,9693
2882,國泰金,10,0,10,富邦-新營,2023-02-08,9693
6578,達邦蛋白,10,0,10,富邦-新營,2023-02-08,9693
2481,強茂,9,0,9,富邦-新營,2023-02-08,9693
1506,正道,10,1,9,富邦-新營,2023-02-08,9693
4958,臻鼎-KY,9,0,9,富邦-新營,2023-02-08,9693
1783,和康生,9,1,8,富邦-新營,2023-02-08,9693
2344,華邦電,10,2,8,富邦-新營,2023-02-08,9693
4114,健喬,15,7,8,富邦-新營,2023-02-08,9693
6104,創惟,9,1,8,富邦-新營,2023-02-08,9693
6243,迅杰,8,0,8,富邦-新營,2023-02-08,9693
2883,凱基金,7,0,7,富邦-新營,2023-02-08,9693
00665L,富邦�琤肭磪囓�2,7,0,7,富邦-新營,2023-02-08,9693
3094,聯傑,7,0,7,富邦-新營,2023-02-08,9693
3259,鑫創,7,0,7,富邦-新營,2023-02-08,9693
2457,飛宏,6,0,6,富邦-新營,2023-02-08,9693
0056,元大高股息,9,3,6,富邦-新營,2023-02-08,9693
2812,台中銀,6,0,6,富邦-新營,2023-02-08,9693
2897,王道銀行,6,0,6,富邦-新營,2023-02-08,9693
3141,晶宏,6,0,6,富邦-新營,2023-02-08,9693
4105,東洋,6,0,6,富邦-新營,2023-02-08,9693
2884,玉山金,5,0,5,富邦-新營,2023-02-08,9693
6153,嘉聯益,5,0,5,富邦-新營,2023-02-08,9693
00720B,元大投資級公司債,5,0,5,富邦-新營,2023-02-08,9693
00878,國泰永續高股息,94,1,93,富邦-新營,2023-02-09,9693
2812,台中銀,51,0,51,富邦-新營,2023-02-09,9693
6235,華孚,43,14,29,富邦-新營,2023-02-09,9693
1718,中纖,26,0,26,富邦-新營,2023-02-09,9693
1506,正道,21,0,21,富邦-新營,2023-02-09,9693
5351,鈺創,28,7,21,富邦-新營,2023-02-09,9693
00637L,元大滬深300正2,31,11,20,富邦-新營,2023-02-09,9693
3491,昇達科,17,0,17,富邦-新營,2023-02-09,9693
2883,凱基金,15,0,15,富邦-新營,2023-02-09,9693
2498,宏達電,255,240,15,富邦-新營,2023-02-09,9693
6138,茂達,12,0,12,富邦-新營,2023-02-09,9693
3188,鑫龍騰,11,0,11,富邦-新營,2023-02-09,9693
3289,宜特,14,3,11,富邦-新營,2023-02-09,9693
2425,承啟,19,9,10,富邦-新營,2023-02-09,9693
3046,建��,10,0,10,富邦-新營,2023-02-09,9693
6531,愛普*,10,1,9,富邦-新營,2023-02-09,9693
4931,新盛力,15,6,9,富邦-新營,2023-02-09,9693
8171,天宇,19,10,9,富邦-新營,2023-02-09,9693
00772B,中信高評級公司債,8,0,8,富邦-新營,2023-02-09,9693
2342,茂矽,8,0,8,富邦-新營,2023-02-09,9693
2369,菱生,10,2,8,富邦-新營,2023-02-09,9693
1710,東聯,7,0,7,富邦-新營,2023-02-09,9693
2888,新光金,7,0,7,富邦-新營,2023-02-09,9693
3322,建舜電,7,0,7,富邦-新營,2023-02-09,9693
2344,華邦電,14,8,6,富邦-新營,2023-02-09,9693
00720B,元大投資級公司債,6,0,6,富邦-新營,2023-02-09,9693
2049,上銀,6,0,6,富邦-新營,2023-02-09,9693
2340,台亞,8,2,6,富邦-新營,2023-02-09,9693
3481,群創,10,5,5,富邦-新營,2023-02-09,9693
00712,復華富時不動產,5,0,5,富邦-新營,2023-02-09,9693
6223,旺矽,5,0,5,富邦-新營,2023-02-09,9693
00900,富邦特選高股息30,5,0,5,富邦-新營,2023-02-09,9693
3704,合勤控,5,0,5,富邦-新營,2023-02-09,9693
1467,南緯,5,0,5,富邦-新營,2023-02-09,9693
1909,榮成,5,0,5,富邦-新營,2023-02-09,9693
2211,長榮鋼,5,0,5,富邦-新營,2023-02-09,9693
2302,麗正,5,0,5,富邦-新營,2023-02-09,9693
3236,千如,5,0,5,富邦-新營,2023-02-09,9693
3710,連展投控,10,5,5,富邦-新營,2023-02-09,9693
5475,德宏,8,3,5,富邦-新營,2023-02-09,9693
5608,四維航,5,0,5,富邦-新營,2023-02-09,9693
6550,北極星藥業-KY,6,1,5,富邦-新營,2023-02-09,9693
6796,晉弘,12,7,5,富邦-新營,2023-02-09,9693
8261,富鼎,6,1,5,富邦-新營,2023-02-09,9693
9103,美德醫療-DR,5,0,5,富邦-新營,2023-02-09,9693
9933,中鼎,5,0,5,富邦-新營,2023-02-09,9693
00679B,元大美債20年,4,0,4,富邦-新營,2023-02-09,9693
2457,飛宏,5,1,4,富邦-新營,2023-02-09,9693
1437,勤益控,7,3,4,富邦-新營,2023-02-09,9693
00885,富邦越南,4,0,4,富邦-新營,2023-02-09,9693
00632R,元大台灣50反1,285,0,285,富邦-新營,2023-02-10,9693
00878,國泰永續高股息,140,0,140,富邦-新營,2023-02-10,9693
00664R,國泰臺灣加權反1,103,0,103,富邦-新營,2023-02-10,9693
2812,台中銀,50,0,50,富邦-新營,2023-02-10,9693
00772B,中信高評級公司債,45,0,45,富邦-新營,2023-02-10,9693
8227,巨有科技,38,9,29,富邦-新營,2023-02-10,9693
2453,凌群,25,0,25,富邦-新營,2023-02-10,9693
2388,威盛,20,0,20,富邦-新營,2023-02-10,9693
3147,大綜,20,0,20,富邦-新營,2023-02-10,9693
4533,協易機,20,0,20,富邦-新營,2023-02-10,9693
00637L,元大滬深300正2,27,10,17,富邦-新營,2023-02-10,9693
1810,和成,17,0,17,富邦-新營,2023-02-10,9693
00680L,元大美債20正2,16,0,16,富邦-新營,2023-02-10,9693
8289,泰藝,16,0,16,富邦-新營,2023-02-10,9693
00712,復華富時不動產,14,0,14,富邦-新營,2023-02-10,9693
5258,虹堡,14,0,14,富邦-新營,2023-02-10,9693
0056,元大高股息,13,0,13,富邦-新營,2023-02-10,9693
1440,南紡,14,2,12,富邦-新營,2023-02-10,9693
6282,康舒,25,13,12,富邦-新營,2023-02-10,9693
1309,台達化,11,0,11,富邦-新營,2023-02-10,9693
2887,台新金,11,0,11,富邦-新營,2023-02-10,9693
2101,南港,10,0,10,富邦-新營,2023-02-10,9693
2425,承啟,18,8,10,富邦-新營,2023-02-10,9693
2610,華航,10,0,10,富邦-新營,2023-02-10,9693
3027,盛達,23,13,10,富邦-新營,2023-02-10,9693
5388,中磊,10,0,10,富邦-新營,2023-02-10,9693
5608,四維航,10,0,10,富邦-新營,2023-02-10,9693
5902,德記,10,0,10,富邦-新營,2023-02-10,9693
6235,華孚,33,23,10,富邦-新營,2023-02-10,9693
2603,長榮,13,4,9,富邦-新營,2023-02-10,9693
00885,富邦越南,9,0,9,富邦-新營,2023-02-10,9693
2618,長榮航,16,7,9,富邦-新營,2023-02-10,9693
3051,力特,10,1,9,富邦-新營,2023-02-10,9693
6104,創惟,9,0,9,富邦-新營,2023-02-10,9693
1584,精剛,145,136,9,富邦-新營,2023-02-10,9693
1513,中興電,11,2,9,富邦-新營,2023-02-10,9693
1101,台泥,8,0,8,富邦-新營,2023-02-10,9693
4906,正文,8,0,8,富邦-新營,2023-02-10,9693
00903,富邦元宇宙,7,0,7,富邦-新營,2023-02-10,9693
1409,新纖,7,0,7,富邦-新營,2023-02-10,9693
1455,集盛,7,0,7,富邦-新營,2023-02-10,9693
2888,新光金,13,6,7,富邦-新營,2023-02-10,9693
3037,欣興,7,0,7,富邦-新營,2023-02-10,9693
3322,建舜電,7,0,7,富邦-新營,2023-02-10,9693
6796,晉弘,23,16,7,富邦-新營,2023-02-10,9693
00679B,元大美債20年,6,0,6,富邦-新營,2023-02-10,9693
3443,創意,18,12,6,富邦-新營,2023-02-10,9693
1710,東聯,6,0,6,富邦-新營,2023-02-10,9693
3332,幸康,6,0,6,富邦-新營,2023-02-10,9693
3447,展達,6,0,6,富邦-新營,2023-02-10,9693
00878,國泰永續高股息,107,2,105,富邦-新營,2023-02-13,9693
2634,漢翔,58,7,51,富邦-新營,2023-02-13,9693
00680L,元大美債20正2,36,0,36,富邦-新營,2023-02-13,9693
1718,中纖,36,0,36,富邦-新營,2023-02-13,9693
00903,富邦元宇宙,33,0,33,富邦-新營,2023-02-13,9693
2812,台中銀,25,0,25,富邦-新營,2023-02-13,9693
1605,華新,29,7,22,富邦-新營,2023-02-13,9693
5608,四維航,19,0,19,富邦-新營,2023-02-13,9693
3481,群創,21,4,17,富邦-新營,2023-02-13,9693
00679B,元大美債20年,15,0,15,富邦-新營,2023-02-13,9693
00885,富邦越南,20,6,14,富邦-新營,2023-02-13,9693
1584,精剛,28,15,13,富邦-新營,2023-02-13,9693
3289,宜特,12,0,12,富邦-新營,2023-02-13,9693
2892,第一金,11,0,11,富邦-新營,2023-02-13,9693
6163,華電網,11,0,11,富邦-新營,2023-02-13,9693
6770,力積電,15,5,10,富邦-新營,2023-02-13,9693
2409,友達,8,0,8,富邦-新營,2023-02-13,9693
00637L,元大滬深300正2,27,19,8,富邦-新營,2023-02-13,9693
3447,展達,8,0,8,富邦-新營,2023-02-13,9693
2897,王道銀行,8,0,8,富邦-新營,2023-02-13,9693
1710,東聯,7,0,7,富邦-新營,2023-02-13,9693
3508,位速,7,0,7,富邦-新營,2023-02-13,9693
6235,華孚,22,15,7,富邦-新營,2023-02-13,9693
8933,愛地雅,7,0,7,富邦-新營,2023-02-13,9693
1217,愛之味,6,0,6,富邦-新營,2023-02-13,9693
00900,富邦特選高股息30,6,0,6,富邦-新營,2023-02-13,9693
0056,元大高股息,11,5,6,富邦-新營,2023-02-13,9693
6843,進典,6,0,6,富邦-新營,2023-02-13,9693
2002,中鋼,7,1,6,富邦-新營,2023-02-13,9693
00772B,中信高評級公司債,6,0,6,富邦-新營,2023-02-13,9693
6605,帝寶,6,1,5,富邦-新營,2023-02-13,9693
6269,台郡,5,0,5,富邦-新營,2023-02-13,9693
1795,美時,44,39,5,富邦-新營,2023-02-13,9693
2329,華泰,5,0,5,富邦-新營,2023-02-13,9693
2610,華航,25,20,5,富邦-新營,2023-02-13,9693
2702,華園,5,0,5,富邦-新營,2023-02-13,9693
3013,晟銘電,5,0,5,富邦-新營,2023-02-13,9693
3147,大綜,5,0,5,富邦-新營,2023-02-13,9693
4155,訊映,5,0,5,富邦-新營,2023-02-13,9693
4167,松瑞藥,5,0,5,富邦-新營,2023-02-13,9693
5902,德記,5,0,5,富邦-新營,2023-02-13,9693
2609,陽明,11,7,4,富邦-新營,2023-02-13,9693
00673R,期元大S＆P原油反1,4,0,4,富邦-新營,2023-02-13,9693
2317,鴻海,4,0,4,富邦-新營,2023-02-13,9693
2457,飛宏,5,1,4,富邦-新營,2023-02-13,9693
4114,健喬,9,5,4,富邦-新營,2023-02-13,9693
4162,智擎,4,0,4,富邦-新營,2023-02-13,9693
4747,強生,5,1,4,富邦-新營,2023-02-13,9693
5351,鈺創,4,0,4,富邦-新營,2023-02-13,9693
8936,國統,4,0,4,富邦-新營,2023-02-13,9693
2482,連宇,101,0,101,富邦-新營,2023-02-14,9693
5371,中光電,62,1,61,富邦-新營,2023-02-14,9693
2897,王道銀行,60,0,60,富邦-新營,2023-02-14,9693
9945,潤泰新,58,0,58,富邦-新營,2023-02-14,9693
6235,華孚,165,131,34,富邦-新營,2023-02-14,9693
8222,寶一,40,6,34,富邦-新營,2023-02-14,9693
2436,偉詮電,30,0,30,富邦-新營,2023-02-14,9693
6517,保勝光學,30,0,30,富邦-新營,2023-02-14,9693
5009,榮剛,43,18,25,富邦-新營,2023-02-14,9693
6578,達邦蛋白,25,0,25,富邦-新營,2023-02-14,9693
00637L,元大滬深300正2,31,10,21,富邦-新營,2023-02-14,9693
2888,新光金,21,0,21,富邦-新營,2023-02-14,9693
3481,群創,40,21,19,富邦-新營,2023-02-14,9693
2884,玉山金,18,1,17,富邦-新營,2023-02-14,9693
3596,智易,16,0,16,富邦-新營,2023-02-14,9693
4916,事欣科,14,0,14,富邦-新營,2023-02-14,9693
2834,臺企銀,13,1,12,富邦-新營,2023-02-14,9693
6147,頎邦,12,0,12,富邦-新營,2023-02-14,9693
1102,亞泥,10,0,10,富邦-新營,2023-02-14,9693
2034,允強,10,0,10,富邦-新營,2023-02-14,9693
2392,正崴,10,0,10,富邦-新營,2023-02-14,9693
5483,中美晶,10,0,10,富邦-新營,2023-02-14,9693
3037,欣興,10,1,9,富邦-新營,2023-02-14,9693
00673R,期元大S＆P原油反1,8,0,8,富邦-新營,2023-02-14,9693
2349,錸德,10,2,8,富邦-新營,2023-02-14,9693
2427,三商電,8,0,8,富邦-新營,2023-02-14,9693
3138,耀登,8,0,8,富邦-新營,2023-02-14,9693
6266,泰詠,8,1,7,富邦-新營,2023-02-14,9693
6180,橘子,7,1,6,富邦-新營,2023-02-14,9693
00665L,富邦�琤肭磪囓�2,6,0,6,富邦-新營,2023-02-14,9693
1101,台泥,11,5,6,富邦-新營,2023-02-14,9693
2481,強茂,6,0,6,富邦-新營,2023-02-14,9693
3047,訊舟,6,0,6,富邦-新營,2023-02-14,9693
5902,德記,6,0,6,富邦-新營,2023-02-14,9693
8409,商之器,6,0,6,富邦-新營,2023-02-14,9693
5351,鈺創,7,2,5,富邦-新營,2023-02-14,9693
2634,漢翔,6,1,5,富邦-新營,2023-02-14,9693
00885,富邦越南,5,0,5,富邦-新營,2023-02-14,9693
00780B,國泰A級金融債,5,0,5,富邦-新營,2023-02-14,9693
00680L,元大美債20正2,5,0,5,富邦-新營,2023-02-14,9693
1219,福壽,7,2,5,富邦-新營,2023-02-14,9693
2017,官田鋼,5,0,5,富邦-新營,2023-02-14,9693
2201,裕隆,7,2,5,富邦-新營,2023-02-14,9693
2388,威盛,6,1,5,富邦-新營,2023-02-14,9693
6752,叡揚,5,0,5,富邦-新營,2023-02-14,9693
8069,元太,7,2,5,富邦-新營,2023-02-14,9693
6443,元晶,4,0,4,富邦-新營,2023-02-14,9693
1506,正道,4,0,4,富邦-新營,2023-02-14,9693
6142,友勁,4,0,4,富邦-新營,2023-02-14,9693
6290,良維,5,1,4,富邦-新營,2023-02-14,9693
00878,國泰永續高股息,129,0,129,富邦-新營,2023-02-15,9693
4543,萬在,35,0,35,富邦-新營,2023-02-15,9693
00780B,國泰A級金融債,30,0,30,富邦-新營,2023-02-15,9693
6266,泰詠,35,6,29,富邦-新營,2023-02-15,9693
2351,順德,32,8,24,富邦-新營,2023-02-15,9693
2834,臺企銀,20,0,20,富邦-新營,2023-02-15,9693
2601,益航,20,0,20,富邦-新營,2023-02-15,9693
2884,玉山金,19,0,19,富邦-新營,2023-02-15,9693
00900,富邦特選高股息30,17,0,17,富邦-新營,2023-02-15,9693
2453,凌群,117,101,16,富邦-新營,2023-02-15,9693
2618,長榮航,19,4,15,富邦-新營,2023-02-15,9693
3691,碩禾,15,0,15,富邦-新營,2023-02-15,9693
00637L,元大滬深300正2,39,25,14,富邦-新營,2023-02-15,9693
2330,台積電,19,6,13,富邦-新營,2023-02-15,9693
2027,大成鋼,12,1,11,富邦-新營,2023-02-15,9693
2809,京城銀,11,0,11,富邦-新營,2023-02-15,9693
00679B,元大美債20年,11,0,11,富邦-新營,2023-02-15,9693
2206,三陽工業,13,2,11,富邦-新營,2023-02-15,9693
3624,光頡,11,0,11,富邦-新營,2023-02-15,9693
8358,金居,11,0,11,富邦-新營,2023-02-15,9693
2317,鴻海,12,1,11,富邦-新營,2023-02-15,9693
4533,協易機,10,0,10,富邦-新營,2023-02-15,9693
1218,泰山,10,0,10,富邦-新營,2023-02-15,9693
00673R,期元大S＆P原油反1,10,0,10,富邦-新營,2023-02-15,9693
1584,精剛,13,3,10,富邦-新營,2023-02-15,9693
2017,官田鋼,10,0,10,富邦-新營,2023-02-15,9693
2392,正崴,10,0,10,富邦-新營,2023-02-15,9693
2436,偉詮電,10,0,10,富邦-新營,2023-02-15,9693
2887,台新金,9,0,9,富邦-新營,2023-02-15,9693
2609,陽明,10,1,9,富邦-新營,2023-02-15,9693
00885,富邦越南,9,0,9,富邦-新營,2023-02-15,9693
2337,旺宏,11,2,9,富邦-新營,2023-02-15,9693
6180,橘子,10,2,8,富邦-新營,2023-02-15,9693
2888,新光金,10,2,8,富邦-新營,2023-02-15,9693
3576,聯合再生,10,2,8,富邦-新營,2023-02-15,9693
4906,正文,8,0,8,富邦-新營,2023-02-15,9693
6282,康舒,12,4,8,富邦-新營,2023-02-15,9693
0056,元大高股息,7,0,7,富邦-新營,2023-02-15,9693
5351,鈺創,15,8,7,富邦-新營,2023-02-15,9693
00665L,富邦�琤肭磪囓�2,7,0,7,富邦-新營,2023-02-15,9693
2314,台揚,7,0,7,富邦-新營,2023-02-15,9693
2897,王道銀行,7,0,7,富邦-新營,2023-02-15,9693
3540,曜越,8,1,7,富邦-新營,2023-02-15,9693
006208,富邦台50,6,0,6,富邦-新營,2023-02-15,9693
2349,錸德,6,0,6,富邦-新營,2023-02-15,9693
3207,耀勝,6,0,6,富邦-新營,2023-02-15,9693
3710,連展投控,6,0,6,富邦-新營,2023-02-15,9693
2881,富邦金,5,0,5,富邦-新營,2023-02-15,9693
00713,元大台灣高息低波,5,0,5,富邦-新營,2023-02-15,9693
1432,大魯閣,6,1,5,富邦-新營,2023-02-15,9693
00878,國泰永續高股息,143,18,125,富邦-新營,2023-02-16,9693
4979,華星光,184,82,102,富邦-新營,2023-02-16,9693
00632R,元大台灣50反1,51,20,31,富邦-新營,2023-02-16,9693
00885,富邦越南,22,0,22,富邦-新營,2023-02-16,9693
1718,中纖,21,0,21,富邦-新營,2023-02-16,9693
3035,智原,21,0,21,富邦-新營,2023-02-16,9693
00772B,中信高評級公司債,17,0,17,富邦-新營,2023-02-16,9693
1784,訊聯,16,0,16,富邦-新營,2023-02-16,9693
3037,欣興,24,9,15,富邦-新營,2023-02-16,9693
00673R,期元大S＆P原油反1,15,0,15,富邦-新營,2023-02-16,9693
1609,大亞,17,4,13,富邦-新營,2023-02-16,9693
3675,德微,17,4,13,富邦-新營,2023-02-16,9693
6517,保勝光學,15,2,13,富邦-新營,2023-02-16,9693
00679B,元大美債20年,12,0,12,富邦-新營,2023-02-16,9693
00720B,元大投資級公司債,12,0,12,富邦-新營,2023-02-16,9693
3264,欣銓,12,0,12,富邦-新營,2023-02-16,9693
2017,官田鋼,13,2,11,富邦-新營,2023-02-16,9693
00680L,元大美債20正2,10,0,10,富邦-新營,2023-02-16,9693
1455,集盛,12,2,10,富邦-新營,2023-02-16,9693
2888,新光金,10,0,10,富邦-新營,2023-02-16,9693
2929,淘帝-KY,10,0,10,富邦-新營,2023-02-16,9693
3289,宜特,10,0,10,富邦-新營,2023-02-16,9693
8105,凌巨,10,0,10,富邦-新營,2023-02-16,9693
1314,中石化,11,2,9,富邦-新營,2023-02-16,9693
2014,中鴻,10,1,9,富邦-新營,2023-02-16,9693
2743,山富,11,2,9,富邦-新營,2023-02-16,9693
9105,泰金寶-DR,9,0,9,富邦-新營,2023-02-16,9693
00713,元大台灣高息低波,8,0,8,富邦-新營,2023-02-16,9693
2206,三陽工業,19,11,8,富邦-新營,2023-02-16,9693
6234,高僑,8,0,8,富邦-新營,2023-02-16,9693
6285,啟��,10,2,8,富邦-新營,2023-02-16,9693
8277,商丞,8,0,8,富邦-新營,2023-02-16,9693
1514,亞力,8,1,7,富邦-新營,2023-02-16,9693
2034,允強,7,0,7,富邦-新營,2023-02-16,9693
3141,晶宏,10,3,7,富邦-新營,2023-02-16,9693
6788,華景電,7,0,7,富邦-新營,2023-02-16,9693
4909,新復興,6,0,6,富邦-新營,2023-02-16,9693
1711,永光,6,0,6,富邦-新營,2023-02-16,9693
2471,資通,16,10,6,富邦-新營,2023-02-16,9693
2812,台中銀,6,0,6,富邦-新營,2023-02-16,9693
3356,奇偶,6,0,6,富邦-新營,2023-02-16,9693
3454,晶睿,14,8,6,富邦-新營,2023-02-16,9693
6603,富強鑫,7,1,6,富邦-新營,2023-02-16,9693
00706L,期元大S＆P日圓正2,5,0,5,富邦-新營,2023-02-16,9693
00830,國泰費城半導體,5,0,5,富邦-新營,2023-02-16,9693
1708,東鹼,6,1,5,富邦-新營,2023-02-16,9693
2208,台船,5,0,5,富邦-新營,2023-02-16,9693
5011,久陽,5,0,5,富邦-新營,2023-02-16,9693
6191,精成科,5,0,5,富邦-新營,2023-02-16,9693
00655L,國泰中國A50正2,5,0,5,富邦-新營,2023-02-16,9693
00637L,元大滬深300正2,118,24,94,富邦-新營,2023-02-17,9693
5371,中光電,58,0,58,富邦-新營,2023-02-17,9693
2610,華航,69,12,57,富邦-新營,2023-02-17,9693
2834,臺企銀,52,2,50,富邦-新營,2023-02-17,9693
00680L,元大美債20正2,47,0,47,富邦-新營,2023-02-17,9693
00878,國泰永續高股息,46,3,43,富邦-新營,2023-02-17,9693
9945,潤泰新,43,2,41,富邦-新營,2023-02-17,9693
6235,華孚,49,17,32,富邦-新營,2023-02-17,9693
2618,長榮航,44,16,28,富邦-新營,2023-02-17,9693
4977,眾達-KY,30,2,28,富邦-新營,2023-02-17,9693
2498,宏達電,22,3,19,富邦-新營,2023-02-17,9693
3037,欣興,16,2,14,富邦-新營,2023-02-17,9693
00772B,中信高評級公司債,14,0,14,富邦-新營,2023-02-17,9693
0056,元大高股息,13,1,12,富邦-新營,2023-02-17,9693
1611,中電,10,0,10,富邦-新營,2023-02-17,9693
2534,宏盛,10,0,10,富邦-新營,2023-02-17,9693
2539,櫻花建,10,0,10,富邦-新營,2023-02-17,9693
5701,劍湖山,10,0,10,富邦-新營,2023-02-17,9693
8033,雷虎,10,0,10,富邦-新營,2023-02-17,9693
1504,東元,9,0,9,富邦-新營,2023-02-17,9693
1783,和康生,11,2,9,富邦-新營,2023-02-17,9693
1810,和成,10,1,9,富邦-新營,2023-02-17,9693
2330,台積電,14,5,9,富邦-新營,2023-02-17,9693
00679B,元大美債20年,8,0,8,富邦-新營,2023-02-17,9693
1718,中纖,15,7,8,富邦-新營,2023-02-17,9693
00902,中信電池及儲能,7,0,7,富邦-新營,2023-02-17,9693
1440,南紡,8,1,7,富邦-新營,2023-02-17,9693
2243,宏旭-KY,7,0,7,富邦-新營,2023-02-17,9693
2892,第一金,7,0,7,富邦-新營,2023-02-17,9693
5009,榮剛,14,7,7,富邦-新營,2023-02-17,9693
3289,宜特,6,0,6,富邦-新營,2023-02-17,9693
3443,創意,14,8,6,富邦-新營,2023-02-17,9693
00665L,富邦�琤肭磪囓�2,6,0,6,富邦-新營,2023-02-17,9693
2010,春源,6,0,6,富邦-新營,2023-02-17,9693
2332,友訊,6,0,6,富邦-新營,2023-02-17,9693
3264,欣銓,6,0,6,富邦-新營,2023-02-17,9693
5351,鈺創,7,1,6,富邦-新營,2023-02-17,9693
006208,富邦台50,5,0,5,富邦-新營,2023-02-17,9693
00893,國泰智能電動車,5,0,5,富邦-新營,2023-02-17,9693
00892,富邦台灣半導體,10,5,5,富邦-新營,2023-02-17,9693
1451,年興,5,0,5,富邦-新營,2023-02-17,9693
1455,集盛,5,0,5,富邦-新營,2023-02-17,9693
1506,正道,5,0,5,富邦-新營,2023-02-17,9693
2439,美律,5,0,5,富邦-新營,2023-02-17,9693
3051,力特,5,0,5,富邦-新營,2023-02-17,9693
6245,立端,58,53,5,富邦-新營,2023-02-17,9693
9103,美德醫療-DR,5,0,5,富邦-新營,2023-02-17,9693
9904,寶成,5,0,5,富邦-新營,2023-02-17,9693
2375,凱美,5,0,5,富邦-新營,2023-02-17,9693
00688L,國泰20年美債正2,4,0,4,富邦-新營,2023-02-17,9693
5371,中光電,118,0,118,富邦-新營,2023-02-20,9693
00637L,元大滬深300正2,123,10,113,富邦-新營,2023-02-20,9693
2201,裕隆,133,27,106,富邦-新營,2023-02-20,9693
8131,福懋科,77,0,77,富邦-新營,2023-02-20,9693
2897,王道銀行,40,0,40,富邦-新營,2023-02-20,9693
4538,大詠城,40,0,40,富邦-新營,2023-02-20,9693
1609,大亞,49,14,35,富邦-新營,2023-02-20,9693
00715L,期街口布蘭特正2,33,0,33,富邦-新營,2023-02-20,9693
3481,群創,71,39,32,富邦-新營,2023-02-20,9693
8358,金居,33,4,29,富邦-新營,2023-02-20,9693
00878,國泰永續高股息,36,9,27,富邦-新營,2023-02-20,9693
3693,營邦,30,4,26,富邦-新營,2023-02-20,9693
00902,中信電池及儲能,23,0,23,富邦-新營,2023-02-20,9693
1605,華新,42,22,20,富邦-新營,2023-02-20,9693
2208,台船,47,27,20,富邦-新營,2023-02-20,9693
6517,保勝光學,20,1,19,富邦-新營,2023-02-20,9693
2367,燿華,22,6,16,富邦-新營,2023-02-20,9693
2610,華航,31,15,16,富邦-新營,2023-02-20,9693
2882,國泰金,21,6,15,富邦-新營,2023-02-20,9693
3037,欣興,15,1,14,富邦-新營,2023-02-20,9693
2883,凱基金,15,2,13,富邦-新營,2023-02-20,9693
8940,新天地,12,1,11,富邦-新營,2023-02-20,9693
1218,泰山,10,0,10,富邦-新營,2023-02-20,9693
1217,愛之味,20,10,10,富邦-新營,2023-02-20,9693
2105,正新,10,0,10,富邦-新營,2023-02-20,9693
2392,正崴,11,1,10,富邦-新營,2023-02-20,9693
2605,新興,10,0,10,富邦-新營,2023-02-20,9693
2889,國票金,10,0,10,富邦-新營,2023-02-20,9693
8021,尖點,10,0,10,富邦-新營,2023-02-20,9693
911622,泰聚亨-DR,10,0,10,富邦-新營,2023-02-20,9693
1762,中化生,10,0,10,富邦-新營,2023-02-20,9693
2887,台新金,11,2,9,富邦-新營,2023-02-20,9693
5902,德記,9,0,9,富邦-新營,2023-02-20,9693
6104,創惟,109,101,8,富邦-新營,2023-02-20,9693
3090,日電貿,8,0,8,富邦-新營,2023-02-20,9693
1503,士電,8,1,7,富邦-新營,2023-02-20,9693
2486,一詮,7,0,7,富邦-新營,2023-02-20,9693
3062,建漢,11,4,7,富邦-新營,2023-02-20,9693
1513,中興電,10,3,7,富邦-新營,2023-02-20,9693
0050,元大台灣50,6,0,6,富邦-新營,2023-02-20,9693
0056,元大高股息,7,1,6,富邦-新營,2023-02-20,9693
2401,凌陽,22,16,6,富邦-新營,2023-02-20,9693
2705,六福,7,1,6,富邦-新營,2023-02-20,9693
6125,廣運,18,12,6,富邦-新營,2023-02-20,9693
6215,和椿,6,0,6,富邦-新營,2023-02-20,9693
1314,中石化,6,0,6,富邦-新營,2023-02-20,9693
2884,玉山金,8,2,6,富邦-新營,2023-02-20,9693
00680L,元大美債20正2,5,0,5,富邦-新營,2023-02-20,9693
00679B,元大美債20年,5,0,5,富邦-新營,2023-02-20,9693
1417,嘉裕,5,0,5,富邦-新營,2023-02-20,9693
6288,聯嘉,216,24,192,富邦-新營,2023-02-21,9693
2884,玉山金,105,33,72,富邦-新營,2023-02-21,9693
2897,王道銀行,55,0,55,富邦-新營,2023-02-21,9693
2457,飛宏,93,48,45,富邦-新營,2023-02-21,9693
5425,台半,44,0,44,富邦-新營,2023-02-21,9693
8182,加高,40,0,40,富邦-新營,2023-02-21,9693
1417,嘉裕,37,0,37,富邦-新營,2023-02-21,9693
1605,華新,56,26,30,富邦-新營,2023-02-21,9693
8131,福懋科,29,0,29,富邦-新營,2023-02-21,9693
6541,泰福-KY,23,0,23,富邦-新營,2023-02-21,9693
00878,國泰永續高股息,24,2,22,富邦-新營,2023-02-21,9693
3710,連展投控,22,0,22,富邦-新營,2023-02-21,9693
00888,永豐台灣ESG,20,0,20,富邦-新營,2023-02-21,9693
3231,緯創,20,0,20,富邦-新營,2023-02-21,9693
2618,長榮航,135,116,19,富邦-新營,2023-02-21,9693
00725B,國泰投資級公司債,17,0,17,富邦-新營,2023-02-21,9693
2017,官田鋼,18,1,17,富邦-新營,2023-02-21,9693
2027,大成鋼,17,0,17,富邦-新營,2023-02-21,9693
2883,凱基金,16,0,16,富邦-新營,2023-02-21,9693
4543,萬在,15,0,15,富邦-新營,2023-02-21,9693
3504,揚明光,13,0,13,富邦-新營,2023-02-21,9693
2349,錸德,12,0,12,富邦-新營,2023-02-21,9693
1108,幸福,11,0,11,富邦-新營,2023-02-21,9693
2313,華通,11,0,11,富邦-新營,2023-02-21,9693
6116,彩晶,11,0,11,富邦-新營,2023-02-21,9693
00915,凱基優選高股息30,10,0,10,富邦-新營,2023-02-21,9693
1529,樂事綠能,20,10,10,富邦-新營,2023-02-21,9693
2614,東森,12,2,10,富邦-新營,2023-02-21,9693
1316,上曜,9,0,9,富邦-新營,2023-02-21,9693
1314,中石化,8,0,8,富邦-新營,2023-02-21,9693
2476,鉅祥,9,1,8,富邦-新營,2023-02-21,9693
4977,眾達-KY,10,2,8,富邦-新營,2023-02-21,9693
6625,必應,8,0,8,富邦-新營,2023-02-21,9693
8358,金居,22,14,8,富邦-新營,2023-02-21,9693
8936,國統,13,5,8,富邦-新營,2023-02-21,9693
00772B,中信高評級公司債,7,0,7,富邦-新營,2023-02-21,9693
00720B,元大投資級公司債,7,0,7,富邦-新營,2023-02-21,9693
4564,元翎,7,0,7,富邦-新營,2023-02-21,9693
5706,鳳凰,10,3,7,富邦-新營,2023-02-21,9693
8086,宏捷科,7,0,7,富邦-新營,2023-02-21,9693
8103,瀚荃,7,0,7,富邦-新營,2023-02-21,9693
2882,國泰金,7,0,7,富邦-新營,2023-02-21,9693
00665L,富邦�琤肭磪囓�2,6,0,6,富邦-新營,2023-02-21,9693
2208,台船,35,29,6,富邦-新營,2023-02-21,9693
2634,漢翔,11,5,6,富邦-新營,2023-02-21,9693
2887,台新金,5,0,5,富邦-新營,2023-02-21,9693
3025,星通,5,0,5,富邦-新營,2023-02-21,9693
1513,中興電,48,43,5,富邦-新營,2023-02-21,9693
1609,大亞,11,6,5,富邦-新營,2023-02-21,9693
2323,中環,5,0,5,富邦-新營,2023-02-21,9693
00878,國泰永續高股息,270,23,247,富邦-新營,2023-02-22,9693
2834,臺企銀,178,67,111,富邦-新營,2023-02-22,9693
3594,磐儀,64,5,59,富邦-新營,2023-02-22,9693
00680L,元大美債20正2,58,0,58,富邦-新營,2023-02-22,9693
6116,彩晶,47,1,46,富邦-新營,2023-02-22,9693
3037,欣興,38,2,36,富邦-新營,2023-02-22,9693
00772B,中信高評級公司債,35,0,35,富邦-新營,2023-02-22,9693
5258,虹堡,38,7,31,富邦-新營,2023-02-22,9693
2812,台中銀,30,0,30,富邦-新營,2023-02-22,9693
3147,大綜,30,0,30,富邦-新營,2023-02-22,9693
3027,盛達,27,3,24,富邦-新營,2023-02-22,9693
4168,醣聯,72,51,21,富邦-新營,2023-02-22,9693
6282,康舒,27,6,21,富邦-新營,2023-02-22,9693
2025,千興,20,0,20,富邦-新營,2023-02-22,9693
9105,泰金寶-DR,20,0,20,富邦-新營,2023-02-22,9693
00902,中信電池及儲能,17,0,17,富邦-新營,2023-02-22,9693
2882,國泰金,17,0,17,富邦-新營,2023-02-22,9693
2889,國票金,20,3,17,富邦-新營,2023-02-22,9693
1519,華城,18,2,16,富邦-新營,2023-02-22,9693
00720B,元大投資級公司債,15,0,15,富邦-新營,2023-02-22,9693
2211,長榮鋼,15,0,15,富邦-新營,2023-02-22,9693
2303,聯電,14,1,13,富邦-新營,2023-02-22,9693
2337,旺宏,13,0,13,富邦-新營,2023-02-22,9693
6266,泰詠,14,1,13,富邦-新營,2023-02-22,9693
00893,國泰智能電動車,12,0,12,富邦-新營,2023-02-22,9693
2897,王道銀行,16,5,11,富邦-新營,2023-02-22,9693
3550,聯穎,10,0,10,富邦-新營,2023-02-22,9693
00753L,中信中國50正2,10,0,10,富邦-新營,2023-02-22,9693
1308,亞聚,10,0,10,富邦-新營,2023-02-22,9693
2539,櫻花建,10,0,10,富邦-新營,2023-02-22,9693
00665L,富邦�琤肭磪囓�2,9,0,9,富邦-新營,2023-02-22,9693
1752,南光,9,0,9,富邦-新營,2023-02-22,9693
2617,台航,10,1,9,富邦-新營,2023-02-22,9693
2618,長榮航,9,0,9,富邦-新營,2023-02-22,9693
1513,中興電,10,2,8,富邦-新營,2023-02-22,9693
00712,復華富時不動產,8,0,8,富邦-新營,2023-02-22,9693
1417,嘉裕,8,0,8,富邦-新營,2023-02-22,9693
1432,大魯閣,8,0,8,富邦-新營,2023-02-22,9693
2010,春源,8,0,8,富邦-新營,2023-02-22,9693
2105,正新,10,2,8,富邦-新營,2023-02-22,9693
5009,榮剛,11,3,8,富邦-新營,2023-02-22,9693
00881,國泰台灣5G+,7,0,7,富邦-新營,2023-02-22,9693
00679B,元大美債20年,7,0,7,富邦-新營,2023-02-22,9693
1605,華新,24,17,7,富邦-新營,2023-02-22,9693
3031,佰鴻,7,0,7,富邦-新營,2023-02-22,9693
4906,正文,7,0,7,富邦-新營,2023-02-22,9693
6770,力積電,10,3,7,富邦-新營,2023-02-22,9693
8182,加高,7,0,7,富邦-新營,2023-02-22,9693
2330,台積電,7,0,7,富邦-新營,2023-02-22,9693
2884,玉山金,7,1,6,富邦-新營,2023-02-22,9693
2812,台中銀,131,1,130,富邦-新營,2023-02-23,9693
1605,華新,116,8,108,富邦-新營,2023-02-23,9693
3624,光頡,100,4,96,富邦-新營,2023-02-23,9693
8033,雷虎,75,2,73,富邦-新營,2023-02-23,9693
00715L,期街口布蘭特正2,72,0,72,富邦-新營,2023-02-23,9693
00632R,元大台灣50反1,112,50,62,富邦-新營,2023-02-23,9693
2344,華邦電,59,0,59,富邦-新營,2023-02-23,9693
1444,力麗,36,3,33,富邦-新營,2023-02-23,9693
00885,富邦越南,28,0,28,富邦-新營,2023-02-23,9693
2303,聯電,39,11,28,富邦-新營,2023-02-23,9693
6277,宏正,20,0,20,富邦-新營,2023-02-23,9693
2883,凱基金,20,0,20,富邦-新營,2023-02-23,9693
3037,欣興,24,6,18,富邦-新營,2023-02-23,9693
2748,雲品,19,2,17,富邦-新營,2023-02-23,9693
6285,啟��,18,1,17,富邦-新營,2023-02-23,9693
00720B,元大投資級公司債,15,0,15,富邦-新營,2023-02-23,9693
2601,益航,14,0,14,富邦-新營,2023-02-23,9693
00664R,國泰臺灣加權反1,12,0,12,富邦-新營,2023-02-23,9693
1514,亞力,13,1,12,富邦-新營,2023-02-23,9693
4114,健喬,23,11,12,富邦-新營,2023-02-23,9693
1417,嘉裕,11,0,11,富邦-新營,2023-02-23,9693
5512,力麒,21,10,11,富邦-新營,2023-02-23,9693
2409,友達,14,4,10,富邦-新營,2023-02-23,9693
00773B,中信優先金融債,10,0,10,富邦-新營,2023-02-23,9693
00751B,元大AAA至A公司債,10,0,10,富邦-新營,2023-02-23,9693
00688L,國泰20年美債正2,10,0,10,富邦-新營,2023-02-23,9693
1815,富喬,10,0,10,富邦-新營,2023-02-23,9693
2332,友訊,10,0,10,富邦-新營,2023-02-23,9693
3105,穩懋,10,0,10,富邦-新營,2023-02-23,9693
4155,訊映,10,0,10,富邦-新營,2023-02-23,9693
00665L,富邦�琤肭磪囓�2,9,0,9,富邦-新營,2023-02-23,9693
2641,正德,16,7,9,富邦-新營,2023-02-23,9693
4906,正文,11,2,9,富邦-新營,2023-02-23,9693
8050,廣積,10,1,9,富邦-新營,2023-02-23,9693
2610,華航,10,1,9,富邦-新營,2023-02-23,9693
5425,台半,10,1,9,富邦-新營,2023-02-23,9693
2436,偉詮電,9,1,8,富邦-新營,2023-02-23,9693
6235,華孚,15,7,8,富邦-新營,2023-02-23,9693
5351,鈺創,8,0,8,富邦-新營,2023-02-23,9693
00714,群益道瓊美國地產,7,0,7,富邦-新營,2023-02-23,9693
1437,勤益控,7,0,7,富邦-新營,2023-02-23,9693
4931,新盛力,7,0,7,富邦-新營,2023-02-23,9693
5706,鳳凰,7,0,7,富邦-新營,2023-02-23,9693
3289,宜特,10,4,6,富邦-新營,2023-02-23,9693
2881,富邦金,6,0,6,富邦-新營,2023-02-23,9693
2211,長榮鋼,5,0,5,富邦-新營,2023-02-23,9693
2368,金像電,6,1,5,富邦-新營,2023-02-23,9693
2705,六福,10,5,5,富邦-新營,2023-02-23,9693
3094,聯傑,18,13,5,富邦-新營,2023-02-23,9693
4952,凌通,6,1,5,富邦-新營,2023-02-23,9693
00637L,元大滬深300正2,138,0,138,富邦-新營,2023-02-24,9693
3037,欣興,35,6,29,富邦-新營,2023-02-24,9693
2611,志信,65,39,26,富邦-新營,2023-02-24,9693
2014,中鴻,21,0,21,富邦-新營,2023-02-24,9693
3704,合勤控,23,2,21,富邦-新營,2023-02-24,9693
5512,力麒,22,1,21,富邦-新營,2023-02-24,9693
1102,亞泥,20,0,20,富邦-新營,2023-02-24,9693
00900,富邦特選高股息30,20,0,20,富邦-新營,2023-02-24,9693
1609,大亞,17,0,17,富邦-新營,2023-02-24,9693
6005,群益證,17,0,17,富邦-新營,2023-02-24,9693
00665L,富邦�琤肭磪囓�2,16,0,16,富邦-新營,2023-02-24,9693
00753L,中信中國50正2,15,0,15,富邦-新營,2023-02-24,9693
1417,嘉裕,15,0,15,富邦-新營,2023-02-24,9693
2349,錸德,13,0,13,富邦-新營,2023-02-24,9693
3047,訊舟,12,0,12,富邦-新營,2023-02-24,9693
00882,中信中國高股息,11,0,11,富邦-新營,2023-02-24,9693
2883,凱基金,10,0,10,富邦-新營,2023-02-24,9693
1219,福壽,10,0,10,富邦-新營,2023-02-24,9693
1513,中興電,9,0,9,富邦-新營,2023-02-24,9693
6285,啟��,26,17,9,富邦-新營,2023-02-24,9693
2243,宏旭-KY,8,0,8,富邦-新營,2023-02-24,9693
5701,劍湖山,8,0,8,富邦-新營,2023-02-24,9693
6282,康舒,10,2,8,富邦-新營,2023-02-24,9693
2615,萬海,10,2,8,富邦-新營,2023-02-24,9693
2027,大成鋼,7,0,7,富邦-新營,2023-02-24,9693
2748,雲品,9,2,7,富邦-新營,2023-02-24,9693
2317,鴻海,7,0,7,富邦-新營,2023-02-24,9693
00897,富邦基因免疫生技,6,0,6,富邦-新營,2023-02-24,9693
1101,台泥,6,0,6,富邦-新營,2023-02-24,9693
1605,華新,11,5,6,富邦-新營,2023-02-24,9693
2367,燿華,6,0,6,富邦-新營,2023-02-24,9693
2419,仲琦,6,0,6,富邦-新營,2023-02-24,9693
2614,東森,6,0,6,富邦-新營,2023-02-24,9693
2618,長榮航,8,2,6,富邦-新營,2023-02-24,9693
2812,台中銀,6,0,6,富邦-新營,2023-02-24,9693
4147,中裕,6,0,6,富邦-新營,2023-02-24,9693
00712,復華富時不動產,6,0,6,富邦-新營,2023-02-24,9693
3576,聯合再生,5,0,5,富邦-新營,2023-02-24,9693
00773B,中信優先金融債,5,0,5,富邦-新營,2023-02-24,9693
00673R,期元大S＆P原油反1,5,0,5,富邦-新營,2023-02-24,9693
1710,東聯,5,0,5,富邦-新營,2023-02-24,9693
2393,億光,5,0,5,富邦-新營,2023-02-24,9693
2641,正德,26,21,5,富邦-新營,2023-02-24,9693
2832,台產,5,0,5,富邦-新營,2023-02-24,9693
2897,王道銀行,5,0,5,富邦-新營,2023-02-24,9693
4526,東台,10,5,5,富邦-新營,2023-02-24,9693
4906,正文,5,0,5,富邦-新營,2023-02-24,9693
4919,新唐,10,5,5,富邦-新營,2023-02-24,9693
6806,森崴能源,5,0,5,富邦-新營,2023-02-24,9693
6843,進典,5,0,5,富邦-新營,2023-02-24,9693
1605,華新,86,12,74,富邦-新營,2023-03-01,9693
2303,聯電,109,35,74,富邦-新營,2023-03-01,9693
00878,國泰永續高股息,81,8,73,富邦-新營,2023-03-01,9693
2897,王道銀行,60,6,54,富邦-新營,2023-03-01,9693
1326,台化,38,0,38,富邦-新營,2023-03-01,9693
2002,中鋼,37,1,36,富邦-新營,2023-03-01,9693
00712,復華富時不動產,56,20,36,富邦-新營,2023-03-01,9693
1101,台泥,63,29,34,富邦-新營,2023-03-01,9693
00903,富邦元宇宙,31,0,31,富邦-新營,2023-03-01,9693
2881,富邦金,21,0,21,富邦-新營,2023-03-01,9693
00885,富邦越南,22,2,20,富邦-新營,2023-03-01,9693
4977,眾達-KY,19,0,19,富邦-新營,2023-03-01,9693
2601,益航,36,17,19,富邦-新營,2023-03-01,9693
1718,中纖,16,0,16,富邦-新營,2023-03-01,9693
5512,力麒,17,4,13,富邦-新營,2023-03-01,9693
2883,凱基金,18,6,12,富邦-新營,2023-03-01,9693
1584,精剛,12,0,12,富邦-新營,2023-03-01,9693
2014,中鴻,17,5,12,富邦-新營,2023-03-01,9693
00679B,元大美債20年,10,0,10,富邦-新營,2023-03-01,9693
00680L,元大美債20正2,10,0,10,富邦-新營,2023-03-01,9693
1437,勤益控,10,0,10,富邦-新營,2023-03-01,9693
2211,長榮鋼,11,1,10,富邦-新營,2023-03-01,9693
2349,錸德,10,0,10,富邦-新營,2023-03-01,9693
3051,力特,10,0,10,富邦-新營,2023-03-01,9693
6461,益得,10,0,10,富邦-新營,2023-03-01,9693
1316,上曜,9,0,9,富邦-新營,2023-03-01,9693
2201,裕隆,23,14,9,富邦-新營,2023-03-01,9693
6163,華電網,9,0,9,富邦-新營,2023-03-01,9693
3264,欣銓,8,0,8,富邦-新營,2023-03-01,9693
2611,志信,8,0,8,富邦-新營,2023-03-01,9693
2882,國泰金,8,0,8,富邦-新營,2023-03-01,9693
4114,健喬,9,1,8,富邦-新營,2023-03-01,9693
00900,富邦特選高股息30,7,0,7,富邦-新營,2023-03-01,9693
1319,東陽,9,2,7,富邦-新營,2023-03-01,9693
6147,頎邦,7,0,7,富邦-新營,2023-03-01,9693
4931,新盛力,6,0,6,富邦-新營,2023-03-01,9693
2634,漢翔,6,0,6,富邦-新營,2023-03-01,9693
6116,彩晶,6,0,6,富邦-新營,2023-03-01,9693
00665L,富邦�琤肭磪囓�2,7,1,6,富邦-新營,2023-03-01,9693
1609,大亞,6,0,6,富邦-新營,2023-03-01,9693
1762,中化生,6,0,6,富邦-新營,2023-03-01,9693
2534,宏盛,6,0,6,富邦-新營,2023-03-01,9693
2609,陽明,19,13,6,富邦-新營,2023-03-01,9693
2618,長榮航,6,0,6,富邦-新營,2023-03-01,9693
3231,緯創,16,10,6,富邦-新營,2023-03-01,9693
4763,材料-KY,5,0,5,富邦-新營,2023-03-01,9693
9945,潤泰新,5,0,5,富邦-新營,2023-03-01,9693
00908,富邦入息REITs+,5,0,5,富邦-新營,2023-03-01,9693
00753L,中信中國50正2,10,5,5,富邦-新營,2023-03-01,9693
1506,正道,22,17,5,富邦-新營,2023-03-01,9693
2834,臺企銀,109,0,109,富邦-新營,2023-03-02,9693
00878,國泰永續高股息,98,0,98,富邦-新營,2023-03-02,9693
2897,王道銀行,72,0,72,富邦-新營,2023-03-02,9693
2888,新光金,70,0,70,富邦-新營,2023-03-02,9693
2706,第一店,50,0,50,富邦-新營,2023-03-02,9693
00712,復華富時不動產,29,0,29,富邦-新營,2023-03-02,9693
2892,第一金,30,3,27,富邦-新營,2023-03-02,9693
3027,盛達,27,0,27,富邦-新營,2023-03-02,9693
2365,昆盈,20,0,20,富邦-新營,2023-03-02,9693
6155,鈞寶,20,0,20,富邦-新營,2023-03-02,9693
2201,裕隆,38,20,18,富邦-新營,2023-03-02,9693
3231,緯創,20,6,14,富邦-新營,2023-03-02,9693
6266,泰詠,18,5,13,富邦-新營,2023-03-02,9693
2498,宏達電,13,2,11,富邦-新營,2023-03-02,9693
3481,群創,26,15,11,富邦-新營,2023-03-02,9693
3704,合勤控,16,5,11,富邦-新營,2023-03-02,9693
00680L,元大美債20正2,10,0,10,富邦-新營,2023-03-02,9693
1218,泰山,10,0,10,富邦-新營,2023-03-02,9693
1701,中化,20,10,10,富邦-新營,2023-03-02,9693
5353,台林,14,4,10,富邦-新營,2023-03-02,9693
5902,德記,10,0,10,富邦-新營,2023-03-02,9693
6843,進典,10,0,10,富邦-新營,2023-03-02,9693
1437,勤益控,10,1,9,富邦-新營,2023-03-02,9693
6129,普誠,9,0,9,富邦-新營,2023-03-02,9693
00903,富邦元宇宙,8,0,8,富邦-新營,2023-03-02,9693
1417,嘉裕,8,0,8,富邦-新營,2023-03-02,9693
6005,群益證,10,2,8,富邦-新營,2023-03-02,9693
2812,台中銀,11,4,7,富邦-新營,2023-03-02,9693
00885,富邦越南,7,0,7,富邦-新營,2023-03-02,9693
2014,中鴻,12,5,7,富邦-新營,2023-03-02,9693
4541,晟田,7,0,7,富邦-新營,2023-03-02,9693
00772B,中信高評級公司債,6,0,6,富邦-新營,2023-03-02,9693
4979,華星光,7,1,6,富邦-新營,2023-03-02,9693
00900,富邦特選高股息30,18,12,6,富邦-新營,2023-03-02,9693
2884,玉山金,7,1,6,富邦-新營,2023-03-02,9693
1720,生達,11,5,6,富邦-新營,2023-03-02,9693
00773B,中信優先金融債,5,0,5,富邦-新營,2023-03-02,9693
2409,友達,5,0,5,富邦-新營,2023-03-02,9693
1210,大成,5,0,5,富邦-新營,2023-03-02,9693
00637L,元大滬深300正2,5,0,5,富邦-新營,2023-03-02,9693
00673R,期元大S＆P原油反1,5,0,5,富邦-新營,2023-03-02,9693
1591,駿吉-KY,5,0,5,富邦-新營,2023-03-02,9693
2349,錸德,5,0,5,富邦-新營,2023-03-02,9693
2359,所羅門,5,0,5,富邦-新營,2023-03-02,9693
2408,南亞科,5,0,5,富邦-新營,2023-03-02,9693
2504,國產,5,0,5,富邦-新營,2023-03-02,9693
4931,新盛力,5,0,5,富邦-新營,2023-03-02,9693
5315,光聯,5,0,5,富邦-新營,2023-03-02,9693
6163,華電網,5,0,5,富邦-新營,2023-03-02,9693
00679B,元大美債20年,4,0,4,富邦-新營,2023-03-02,9693
2605,新興,302,103,199,富邦-新營,2023-03-03,9693
2897,王道銀行,59,0,59,富邦-新營,2023-03-03,9693
3163,波若威,40,0,40,富邦-新營,2023-03-03,9693
2883,凱基金,39,0,39,富邦-新營,2023-03-03,9693
00885,富邦越南,33,0,33,富邦-新營,2023-03-03,9693
006205,富邦上証,30,0,30,富邦-新營,2023-03-03,9693
5512,力麒,23,0,23,富邦-新營,2023-03-03,9693
1708,東鹼,26,5,21,富邦-新營,2023-03-03,9693
2211,長榮鋼,20,0,20,富邦-新營,2023-03-03,9693
00712,復華富時不動產,17,0,17,富邦-新營,2023-03-03,9693
1314,中石化,22,5,17,富邦-新營,2023-03-03,9693
6155,鈞寶,20,3,17,富邦-新營,2023-03-03,9693
5701,劍湖山,16,0,16,富邦-新營,2023-03-03,9693
00679B,元大美債20年,14,0,14,富邦-新營,2023-03-03,9693
2495,普安,14,0,14,富邦-新營,2023-03-03,9693
3380,明泰,15,3,12,富邦-新營,2023-03-03,9693
3441,聯一光,12,0,12,富邦-新營,2023-03-03,9693
3652,精聯,20,8,12,富邦-新營,2023-03-03,9693
1710,東聯,11,0,11,富邦-新營,2023-03-03,9693
4207,環泰,10,0,10,富邦-新營,2023-03-03,9693
6235,華孚,20,10,10,富邦-新營,2023-03-03,9693
00897,富邦基因免疫生技,10,0,10,富邦-新營,2023-03-03,9693
00680L,元大美債20正2,10,0,10,富邦-新營,2023-03-03,9693
1809,中釉,10,0,10,富邦-新營,2023-03-03,9693
3051,力特,10,0,10,富邦-新營,2023-03-03,9693
3438,類比科,10,0,10,富邦-新營,2023-03-03,9693
4968,立積,10,0,10,富邦-新營,2023-03-03,9693
6112,邁達特,10,0,10,富邦-新營,2023-03-03,9693
6120,達運,10,0,10,富邦-新營,2023-03-03,9693
6177,達麗,10,0,10,富邦-新營,2023-03-03,9693
3705,永信,10,1,9,富邦-新營,2023-03-03,9693
6147,頎邦,9,0,9,富邦-新營,2023-03-03,9693
2301,光寶科,10,1,9,富邦-新營,2023-03-03,9693
1720,生達,9,0,9,富邦-新營,2023-03-03,9693
2371,大同,8,0,8,富邦-新營,2023-03-03,9693
2722,夏都,7,0,7,富邦-新營,2023-03-03,9693
8033,雷虎,10,3,7,富邦-新營,2023-03-03,9693
1102,亞泥,6,0,6,富邦-新營,2023-03-03,9693
1584,精剛,6,0,6,富邦-新營,2023-03-03,9693
2812,台中銀,7,1,6,富邦-新營,2023-03-03,9693
3372,典範,10,4,6,富邦-新營,2023-03-03,9693
3406,玉晶光,7,1,6,富邦-新營,2023-03-03,9693
5902,德記,6,0,6,富邦-新營,2023-03-03,9693
6125,廣運,6,0,6,富邦-新營,2023-03-03,9693
8277,商丞,6,0,6,富邦-新營,2023-03-03,9693
2471,資通,6,0,6,富邦-新營,2023-03-03,9693
5608,四維航,11,5,6,富邦-新營,2023-03-03,9693
00706L,期元大S＆P日圓正2,5,0,5,富邦-新營,2023-03-03,9693
00632R,元大台灣50反1,5,0,5,富邦-新營,2023-03-03,9693
00665L,富邦�琤肭磪囓�2,5,0,5,富邦-新營,2023-03-03,9693
3027,盛達,112,1,111,富邦-新營,2023-03-06,9693
00637L,元大滬深300正2,104,0,104,富邦-新營,2023-03-06,9693
4961,天鈺,50,1,49,富邦-新營,2023-03-06,9693
00632R,元大台灣50反1,48,0,48,富邦-新營,2023-03-06,9693
6155,鈞寶,30,0,30,富邦-新營,2023-03-06,9693
00712,復華富時不動產,30,2,28,富邦-新營,2023-03-06,9693
2603,長榮,28,7,21,富邦-新營,2023-03-06,9693
2330,台積電,22,2,20,富邦-新營,2023-03-06,9693
1524,耿鼎,20,0,20,富邦-新營,2023-03-06,9693
3036,文曄,20,0,20,富邦-新營,2023-03-06,9693
6116,彩晶,31,11,20,富邦-新營,2023-03-06,9693
2611,志信,17,0,17,富邦-新營,2023-03-06,9693
1591,駿吉-KY,17,0,17,富邦-新營,2023-03-06,9693
8110,華東,16,0,16,富邦-新營,2023-03-06,9693
5309,系統電,15,1,14,富邦-新營,2023-03-06,9693
00878,國泰永續高股息,54,41,13,富邦-新營,2023-03-06,9693
1444,力麗,13,0,13,富邦-新營,2023-03-06,9693
3321,同泰,14,1,13,富邦-新營,2023-03-06,9693
2367,燿華,12,0,12,富邦-新營,2023-03-06,9693
2883,凱基金,23,11,12,富邦-新營,2023-03-06,9693
8046,南電,19,9,10,富邦-新營,2023-03-06,9693
6443,元晶,12,2,10,富邦-新營,2023-03-06,9693
3443,創意,14,4,10,富邦-新營,2023-03-06,9693
00665L,富邦�琤肭磪囓�2,10,0,10,富邦-新營,2023-03-06,9693
1909,榮成,10,0,10,富邦-新營,2023-03-06,9693
2014,中鴻,10,0,10,富邦-新營,2023-03-06,9693
4541,晟田,10,0,10,富邦-新營,2023-03-06,9693
4903,聯光通,10,0,10,富邦-新營,2023-03-06,9693
6442,光聖,10,0,10,富邦-新營,2023-03-06,9693
8478,東哥遊艇,10,0,10,富邦-新營,2023-03-06,9693
2834,臺企銀,13,4,9,富邦-新營,2023-03-06,9693
6182,合晶,10,1,9,富邦-新營,2023-03-06,9693
6426,統新,9,0,9,富邦-新營,2023-03-06,9693
3189,景碩,10,1,9,富邦-新營,2023-03-06,9693
5009,榮剛,11,3,8,富邦-新營,2023-03-06,9693
8105,凌巨,16,8,8,富邦-新營,2023-03-06,9693
3141,晶宏,10,2,8,富邦-新營,2023-03-06,9693
1219,福壽,7,0,7,富邦-新營,2023-03-06,9693
2408,南亞科,9,2,7,富邦-新營,2023-03-06,9693
2867,三商壽,7,0,7,富邦-新營,2023-03-06,9693
6153,嘉聯益,7,0,7,富邦-新營,2023-03-06,9693
2344,華邦電,19,12,7,富邦-新營,2023-03-06,9693
00650L,復華香港正2,6,0,6,富邦-新營,2023-03-06,9693
00633L,富邦上証正2,20,14,6,富邦-新營,2023-03-06,9693
3058,立德,6,0,6,富邦-新營,2023-03-06,9693
5498,凱崴,6,0,6,富邦-新營,2023-03-06,9693
6288,聯嘉,7,1,6,富邦-新營,2023-03-06,9693
6470,宇智,7,1,6,富邦-新營,2023-03-06,9693
9802,鈺齊-KY,6,0,6,富邦-新營,2023-03-06,9693
3059,華晶科,6,0,6,富邦-新營,2023-03-06,9693
2303,聯電,106,7,99,富邦-新營,2023-03-07,9693
2812,台中銀,44,3,41,富邦-新營,2023-03-07,9693
3047,訊舟,39,0,39,富邦-新營,2023-03-07,9693
2897,王道銀行,35,1,34,富邦-新營,2023-03-07,9693
00878,國泰永續高股息,58,35,23,富邦-新營,2023-03-07,9693
00680L,元大美債20正2,20,0,20,富邦-新營,2023-03-07,9693
1810,和成,17,0,17,富邦-新營,2023-03-07,9693
3380,明泰,49,33,16,富邦-新營,2023-03-07,9693
2014,中鴻,13,0,13,富邦-新營,2023-03-07,9693
3287,廣寰科,13,0,13,富邦-新營,2023-03-07,9693
6235,華孚,26,14,12,富邦-新營,2023-03-07,9693
00637L,元大滬深300正2,14,2,12,富邦-新營,2023-03-07,9693
3013,晟銘電,56,44,12,富邦-新營,2023-03-07,9693
3703,欣陸,12,0,12,富邦-新營,2023-03-07,9693
0050,元大台灣50,12,1,11,富邦-新營,2023-03-07,9693
1101,台泥,11,0,11,富邦-新營,2023-03-07,9693
1437,勤益控,11,0,11,富邦-新營,2023-03-07,9693
1455,集盛,11,0,11,富邦-新營,2023-03-07,9693
00712,復華富時不動產,11,0,11,富邦-新營,2023-03-07,9693
00673R,期元大S＆P原油反1,10,0,10,富邦-新營,2023-03-07,9693
1444,力麗,10,0,10,富邦-新營,2023-03-07,9693
1609,大亞,47,37,10,富邦-新營,2023-03-07,9693
2352,佳世達,11,1,10,富邦-新營,2023-03-07,9693
4114,健喬,18,8,10,富邦-新營,2023-03-07,9693
5309,系統電,11,1,10,富邦-新營,2023-03-07,9693
6266,泰詠,26,16,10,富邦-新營,2023-03-07,9693
2323,中環,10,0,10,富邦-新營,2023-03-07,9693
2426,鼎元,9,0,9,富邦-新營,2023-03-07,9693
2457,飛宏,48,40,8,富邦-新營,2023-03-07,9693
8033,雷虎,9,1,8,富邦-新營,2023-03-07,9693
1591,駿吉-KY,8,0,8,富邦-新營,2023-03-07,9693
6104,創惟,9,1,8,富邦-新營,2023-03-07,9693
2892,第一金,7,0,7,富邦-新營,2023-03-07,9693
1584,精剛,12,5,7,富邦-新營,2023-03-07,9693
00679B,元大美債20年,7,0,7,富邦-新營,2023-03-07,9693
2634,漢翔,11,4,7,富邦-新營,2023-03-07,9693
5321,美而快,7,0,7,富邦-新營,2023-03-07,9693
6197,佳必琪,7,0,7,富邦-新營,2023-03-07,9693
1513,中興電,14,8,6,富邦-新營,2023-03-07,9693
6005,群益證,10,4,6,富邦-新營,2023-03-07,9693
1220,台榮,6,0,6,富邦-新營,2023-03-07,9693
1309,台達化,6,0,6,富邦-新營,2023-03-07,9693
2023,燁輝,6,0,6,富邦-新營,2023-03-07,9693
3265,台星科,6,0,6,富邦-新營,2023-03-07,9693
5498,凱崴,6,0,6,富邦-新營,2023-03-07,9693
6570,維田,6,0,6,富邦-新營,2023-03-07,9693
00907,永豐優息存股,5,0,5,富邦-新營,2023-03-07,9693
1316,上曜,5,0,5,富邦-新營,2023-03-07,9693
4960,誠美材,5,0,5,富邦-新營,2023-03-07,9693
4967,十銓,5,0,5,富邦-新營,2023-03-07,9693
6443,元晶,164,19,145,富邦-新營,2023-03-08,9693
00637L,元大滬深300正2,105,0,105,富邦-新營,2023-03-08,9693
00715L,期街口布蘭特正2,55,0,55,富邦-新營,2023-03-08,9693
00897,富邦基因免疫生技,51,0,51,富邦-新營,2023-03-08,9693
2634,漢翔,74,36,38,富邦-新營,2023-03-08,9693
2609,陽明,37,2,35,富邦-新營,2023-03-08,9693
00712,復華富時不動產,33,0,33,富邦-新營,2023-03-08,9693
00882,中信中國高股息,34,1,33,富邦-新營,2023-03-08,9693
2489,瑞軒,30,1,29,富邦-新營,2023-03-08,9693
2834,臺企銀,43,14,29,富邦-新營,2023-03-08,9693
2897,王道銀行,28,0,28,富邦-新營,2023-03-08,9693
00885,富邦越南,29,3,26,富邦-新營,2023-03-08,9693
1102,亞泥,24,0,24,富邦-新營,2023-03-08,9693
3013,晟銘電,44,22,22,富邦-新營,2023-03-08,9693
2883,凱基金,20,0,20,富邦-新營,2023-03-08,9693
4114,健喬,20,0,20,富邦-新營,2023-03-08,9693
3162,精確,19,0,19,富邦-新營,2023-03-08,9693
00753L,中信中國50正2,19,0,19,富邦-新營,2023-03-08,9693
00665L,富邦�琤肭磪囓�2,17,1,16,富邦-新營,2023-03-08,9693
00878,國泰永續高股息,17,1,16,富邦-新營,2023-03-08,9693
6806,森崴能源,16,2,14,富邦-新營,2023-03-08,9693
3209,全科,13,0,13,富邦-新營,2023-03-08,9693
2359,所羅門,17,5,12,富邦-新營,2023-03-08,9693
2444,兆勁,12,0,12,富邦-新營,2023-03-08,9693
8227,巨有科技,14,2,12,富邦-新營,2023-03-08,9693
5009,榮剛,35,24,11,富邦-新營,2023-03-08,9693
8933,愛地雅,11,0,11,富邦-新營,2023-03-08,9693
1710,東聯,10,0,10,富邦-新營,2023-03-08,9693
2349,錸德,10,0,10,富邦-新營,2023-03-08,9693
3045,台灣大,10,0,10,富邦-新營,2023-03-08,9693
3447,展達,10,0,10,富邦-新營,2023-03-08,9693
4953,緯軟,10,0,10,富邦-新營,2023-03-08,9693
1762,中化生,10,0,10,富邦-新營,2023-03-08,9693
3029,零壹,12,2,10,富邦-新營,2023-03-08,9693
6770,力積電,10,2,8,富邦-新營,2023-03-08,9693
00633L,富邦上証正2,15,7,8,富邦-新營,2023-03-08,9693
1101,台泥,10,3,7,富邦-新營,2023-03-08,9693
1584,精剛,14,7,7,富邦-新營,2023-03-08,9693
2371,大同,9,2,7,富邦-新營,2023-03-08,9693
3046,建��,17,10,7,富邦-新營,2023-03-08,9693
4109,加捷生醫,7,0,7,富邦-新營,2023-03-08,9693
4976,佳凌,17,10,7,富邦-新營,2023-03-08,9693
6269,台郡,7,0,7,富邦-新營,2023-03-08,9693
2498,宏達電,8,2,6,富邦-新營,2023-03-08,9693
5410,國眾,6,0,6,富邦-新營,2023-03-08,9693
2201,裕隆,6,0,6,富邦-新營,2023-03-08,9693
6235,華孚,22,16,6,富邦-新營,2023-03-08,9693
9907,統一實,6,0,6,富邦-新營,2023-03-08,9693
2886,兆豐金,10,4,6,富邦-新營,2023-03-08,9693
3081,聯亞,5,0,5,富邦-新營,2023-03-08,9693
2812,台中銀,81,3,78,富邦-新營,2023-03-09,9693
6841,長佳智能,49,1,48,富邦-新營,2023-03-09,9693
3481,群創,64,19,45,富邦-新營,2023-03-09,9693
1506,正道,33,0,33,富邦-新營,2023-03-09,9693
8222,寶一,47,17,30,富邦-新營,2023-03-09,9693
1718,中纖,35,10,25,富邦-新營,2023-03-09,9693
5315,光聯,25,0,25,富邦-新營,2023-03-09,9693
2402,毅嘉,25,1,24,富邦-新營,2023-03-09,9693
2211,長榮鋼,23,0,23,富邦-新營,2023-03-09,9693
2409,友達,23,0,23,富邦-新營,2023-03-09,9693
1440,南紡,21,0,21,富邦-新營,2023-03-09,9693
1536,和大,21,0,21,富邦-新營,2023-03-09,9693
00715L,期街口布蘭特正2,20,0,20,富邦-新營,2023-03-09,9693
6189,豐藝,20,0,20,富邦-新營,2023-03-09,9693
8182,加高,20,0,20,富邦-新營,2023-03-09,9693
1102,亞泥,18,0,18,富邦-新營,2023-03-09,9693
1605,華新,22,4,18,富邦-新營,2023-03-09,9693
2883,凱基金,17,0,17,富邦-新營,2023-03-09,9693
5410,國眾,17,0,17,富邦-新營,2023-03-09,9693
00712,復華富時不動產,15,0,15,富邦-新營,2023-03-09,9693
2314,台揚,15,0,15,富邦-新營,2023-03-09,9693
2609,陽明,29,14,15,富邦-新營,2023-03-09,9693
1591,駿吉-KY,13,0,13,富邦-新營,2023-03-09,9693
1810,和成,13,0,13,富邦-新營,2023-03-09,9693
8936,國統,12,0,12,富邦-新營,2023-03-09,9693
2337,旺宏,20,8,12,富邦-新營,2023-03-09,9693
2344,華邦電,12,0,12,富邦-新營,2023-03-09,9693
2634,漢翔,20,8,12,富邦-新營,2023-03-09,9693
5309,系統電,11,0,11,富邦-新營,2023-03-09,9693
6016,康和證,11,0,11,富邦-新營,2023-03-09,9693
8046,南電,32,21,11,富邦-新營,2023-03-09,9693
6266,泰詠,15,5,10,富邦-新營,2023-03-09,9693
6546,正基,10,0,10,富邦-新營,2023-03-09,9693
6796,晉弘,10,0,10,富邦-新營,2023-03-09,9693
3289,宜特,13,3,10,富邦-新營,2023-03-09,9693
6806,森崴能源,27,18,9,富邦-新營,2023-03-09,9693
1785,光洋科,14,5,9,富邦-新營,2023-03-09,9693
2605,新興,9,0,9,富邦-新營,2023-03-09,9693
2884,玉山金,13,4,9,富邦-新營,2023-03-09,9693
3162,精確,9,0,9,富邦-新營,2023-03-09,9693
5512,力麒,9,0,9,富邦-新營,2023-03-09,9693
8358,金居,10,1,9,富邦-新營,2023-03-09,9693
00713,元大台灣高息低波,9,0,9,富邦-新營,2023-03-09,9693
5009,榮剛,25,17,8,富邦-新營,2023-03-09,9693
6290,良維,8,0,8,富邦-新營,2023-03-09,9693
2610,華航,11,3,8,富邦-新營,2023-03-09,9693
8033,雷虎,8,1,7,富邦-新營,2023-03-09,9693
3209,全科,8,1,7,富邦-新營,2023-03-09,9693
3013,晟銘電,17,10,7,富邦-新營,2023-03-09,9693
5498,凱崴,7,0,7,富邦-新營,2023-03-09,9693
00878,國泰永續高股息,148,16,132,富邦-新營,2023-03-10,9693
2609,陽明,295,195,100,富邦-新營,2023-03-10,9693
00715L,期街口布蘭特正2,88,0,88,富邦-新營,2023-03-10,9693
2812,台中銀,71,0,71,富邦-新營,2023-03-10,9693
2897,王道銀行,65,0,65,富邦-新營,2023-03-10,9693
6116,彩晶,62,0,62,富邦-新營,2023-03-10,9693
2409,友達,72,14,58,富邦-新營,2023-03-10,9693
2610,華航,70,14,56,富邦-新營,2023-03-10,9693
2882,國泰金,67,17,50,富邦-新營,2023-03-10,9693
00713,元大台灣高息低波,50,0,50,富邦-新營,2023-03-10,9693
5425,台半,52,4,48,富邦-新營,2023-03-10,9693
2888,新光金,52,12,40,富邦-新營,2023-03-10,9693
2883,凱基金,40,1,39,富邦-新營,2023-03-10,9693
3209,全科,41,4,37,富邦-新營,2023-03-10,9693
2881,富邦金,37,0,37,富邦-新營,2023-03-10,9693
00882,中信中國高股息,32,0,32,富邦-新營,2023-03-10,9693
1609,大亞,32,1,31,富邦-新營,2023-03-10,9693
1440,南紡,30,0,30,富邦-新營,2023-03-10,9693
1536,和大,30,0,30,富邦-新營,2023-03-10,9693
6461,益得,30,0,30,富邦-新營,2023-03-10,9693
1101,台泥,32,2,30,富邦-新營,2023-03-10,9693
0056,元大高股息,25,1,24,富邦-新營,2023-03-10,9693
2880,華南金,21,0,21,富邦-新營,2023-03-10,9693
5388,中磊,24,4,20,富邦-新營,2023-03-10,9693
2891,中信金,20,0,20,富邦-新營,2023-03-10,9693
7402,邑錡,18,0,18,富邦-新營,2023-03-10,9693
00665L,富邦�琤肭磪囓�2,24,6,18,富邦-新營,2023-03-10,9693
6235,華孚,26,8,18,富邦-新營,2023-03-10,9693
2331,精英,28,11,17,富邦-新營,2023-03-10,9693
1102,亞泥,16,0,16,富邦-新營,2023-03-10,9693
1718,中纖,25,10,15,富邦-新營,2023-03-10,9693
2929,淘帝-KY,16,1,15,富邦-新營,2023-03-10,9693
006208,富邦台50,15,0,15,富邦-新營,2023-03-10,9693
1437,勤益控,14,0,14,富邦-新營,2023-03-10,9693
1584,精剛,33,19,14,富邦-新營,2023-03-10,9693
2834,臺企銀,14,0,14,富邦-新營,2023-03-10,9693
2887,台新金,14,0,14,富邦-新營,2023-03-10,9693
6005,群益證,14,0,14,富邦-新營,2023-03-10,9693
00923,群益台ESG低碳50,14,0,14,富邦-新營,2023-03-10,9693
00712,復華富時不動產,13,0,13,富邦-新營,2023-03-10,9693
2498,宏達電,14,1,13,富邦-新營,2023-03-10,9693
6753,龍德造船,13,0,13,富邦-新營,2023-03-10,9693
00902,中信電池及儲能,13,0,13,富邦-新營,2023-03-10,9693
2618,長榮航,16,3,13,富邦-新營,2023-03-10,9693
6796,晉弘,13,0,13,富邦-新營,2023-03-10,9693
1605,華新,20,8,12,富邦-新營,2023-03-10,9693
2317,鴻海,12,0,12,富邦-新營,2023-03-10,9693
1519,華城,16,4,12,富邦-新營,2023-03-10,9693
1524,耿鼎,52,41,11,富邦-新營,2023-03-10,9693
1720,生達,11,0,11,富邦-新營,2023-03-10,9693
00712,復華富時不動產,134,0,134,富邦-新營,2023-03-13,9693
2812,台中銀,78,1,77,富邦-新營,2023-03-13,9693
3481,群創,54,0,54,富邦-新營,2023-03-13,9693
00632R,元大台灣50反1,100,52,48,富邦-新營,2023-03-13,9693
2897,王道銀行,46,0,46,富邦-新營,2023-03-13,9693
1506,正道,35,0,35,富邦-新營,2023-03-13,9693
6248,沛波,30,0,30,富邦-新營,2023-03-13,9693
2883,凱基金,28,1,27,富邦-新營,2023-03-13,9693
8933,愛地雅,25,0,25,富邦-新營,2023-03-13,9693
2880,華南金,24,1,23,富邦-新營,2023-03-13,9693
1718,中纖,25,2,23,富邦-新營,2023-03-13,9693
00713,元大台灣高息低波,27,5,22,富邦-新營,2023-03-13,9693
2337,旺宏,22,0,22,富邦-新營,2023-03-13,9693
2884,玉山金,22,0,22,富邦-新營,2023-03-13,9693
3715,定穎投控,21,0,21,富邦-新營,2023-03-13,9693
3046,建��,59,39,20,富邦-新營,2023-03-13,9693
1229,聯華,20,0,20,富邦-新營,2023-03-13,9693
2801,彰銀,20,1,19,富邦-新營,2023-03-13,9693
1231,聯華食,18,0,18,富邦-新營,2023-03-13,9693
2834,臺企銀,18,0,18,富邦-新營,2023-03-13,9693
2317,鴻海,20,3,17,富邦-新營,2023-03-13,9693
8064,東捷,17,0,17,富邦-新營,2023-03-13,9693
1440,南紡,18,5,13,富邦-新營,2023-03-13,9693
2891,中信金,13,0,13,富邦-新營,2023-03-13,9693
3058,立德,13,0,13,富邦-新營,2023-03-13,9693
3390,旭軟,13,0,13,富邦-新營,2023-03-13,9693
6770,力積電,11,0,11,富邦-新營,2023-03-13,9693
2634,漢翔,22,11,11,富邦-新營,2023-03-13,9693
2888,新光金,13,2,11,富邦-新營,2023-03-13,9693
2017,官田鋼,11,0,11,富邦-新營,2023-03-13,9693
6180,橘子,10,0,10,富邦-新營,2023-03-13,9693
5701,劍湖山,10,0,10,富邦-新營,2023-03-13,9693
3376,新日興,10,0,10,富邦-新營,2023-03-13,9693
6153,嘉聯益,10,0,10,富邦-新營,2023-03-13,9693
9904,寶成,10,0,10,富邦-新營,2023-03-13,9693
5608,四維航,11,2,9,富邦-新營,2023-03-13,9693
2340,台亞,11,3,8,富邦-新營,2023-03-13,9693
6142,友勁,8,0,8,富邦-新營,2023-03-13,9693
8222,寶一,9,1,8,富邦-新營,2023-03-13,9693
6443,元晶,8,1,7,富邦-新營,2023-03-13,9693
00679B,元大美債20年,9,2,7,富邦-新營,2023-03-13,9693
00717,富邦美國特別股,7,0,7,富邦-新營,2023-03-13,9693
1316,上曜,16,9,7,富邦-新營,2023-03-13,9693
2312,金寶,12,5,7,富邦-新營,2023-03-13,9693
3419,譁裕,8,1,7,富邦-新營,2023-03-13,9693
00923,群益台ESG低碳50,7,0,7,富邦-新營,2023-03-13,9693
2881,富邦金,6,0,6,富邦-新營,2023-03-13,9693
2409,友達,8,2,6,富邦-新營,2023-03-13,9693
1455,集盛,6,0,6,富邦-新營,2023-03-13,9693
2457,飛宏,87,82,5,富邦-新營,2023-03-13,9693
00878,國泰永續高股息,251,1,250,富邦-新營,2023-03-14,9693
00715L,期街口布蘭特正2,132,0,132,富邦-新營,2023-03-14,9693
00753L,中信中國50正2,100,0,100,富邦-新營,2023-03-14,9693
2883,凱基金,65,10,55,富邦-新營,2023-03-14,9693
2891,中信金,54,1,53,富邦-新營,2023-03-14,9693
2897,王道銀行,50,0,50,富邦-新營,2023-03-14,9693
1536,和大,40,0,40,富邦-新營,2023-03-14,9693
2888,新光金,57,22,35,富邦-新營,2023-03-14,9693
00915,凱基優選高股息30,31,0,31,富邦-新營,2023-03-14,9693
4157,太景*-KY,30,0,30,富邦-新營,2023-03-14,9693
2303,聯電,30,3,27,富邦-新營,2023-03-14,9693
2812,台中銀,26,0,26,富邦-新營,2023-03-14,9693
3481,群創,26,1,25,富邦-新營,2023-03-14,9693
2834,臺企銀,25,3,22,富邦-新營,2023-03-14,9693
2615,萬海,22,1,21,富邦-新營,2023-03-14,9693
2017,官田鋼,22,1,21,富邦-新營,2023-03-14,9693
3027,盛達,21,0,21,富邦-新營,2023-03-14,9693
2880,華南金,20,0,20,富邦-新營,2023-03-14,9693
3376,新日興,20,0,20,富邦-新營,2023-03-14,9693
2881,富邦金,18,0,18,富邦-新營,2023-03-14,9693
5512,力麒,17,0,17,富邦-新營,2023-03-14,9693
2409,友達,17,1,16,富邦-新營,2023-03-14,9693
00882,中信中國高股息,16,0,16,富邦-新營,2023-03-14,9693
8933,愛地雅,16,0,16,富邦-新營,2023-03-14,9693
3058,立德,14,0,14,富邦-新營,2023-03-14,9693
1718,中纖,12,0,12,富邦-新營,2023-03-14,9693
1316,上曜,15,3,12,富邦-新營,2023-03-14,9693
2014,中鴻,13,1,12,富邦-新營,2023-03-14,9693
2002,中鋼,12,0,12,富邦-新營,2023-03-14,9693
00885,富邦越南,17,5,12,富邦-新營,2023-03-14,9693
00888,永豐台灣ESG,11,0,11,富邦-新營,2023-03-14,9693
2022,聚亨,11,0,11,富邦-新營,2023-03-14,9693
1440,南紡,11,1,10,富邦-新營,2023-03-14,9693
3372,典範,10,0,10,富邦-新營,2023-03-14,9693
4968,立積,11,1,10,富邦-新營,2023-03-14,9693
4976,佳凌,10,0,10,富邦-新營,2023-03-14,9693
6005,群益證,10,0,10,富邦-新營,2023-03-14,9693
4707,磐亞,10,0,10,富邦-新營,2023-03-14,9693
2892,第一金,10,0,10,富邦-新營,2023-03-14,9693
00712,復華富時不動產,9,0,9,富邦-新營,2023-03-14,9693
00902,中信電池及儲能,9,0,9,富邦-新營,2023-03-14,9693
1455,集盛,9,0,9,富邦-新營,2023-03-14,9693
2344,華邦電,9,0,9,富邦-新營,2023-03-14,9693
2852,第一保,8,0,8,富邦-新營,2023-03-14,9693
2885,元大金,7,0,7,富邦-新營,2023-03-14,9693
00713,元大台灣高息低波,7,0,7,富邦-新營,2023-03-14,9693
8227,巨有科技,8,1,7,富邦-新營,2023-03-14,9693
2887,台新金,10,3,7,富邦-新營,2023-03-14,9693
5880,合庫金,7,0,7,富邦-新營,2023-03-14,9693
1605,華新,10,3,7,富邦-新營,2023-03-14,9693
3056,富華新,320,1,319,富邦-新營,2023-03-15,9693
00715L,期街口布蘭特正2,135,5,130,富邦-新營,2023-03-15,9693
00713,元大台灣高息低波,63,0,63,富邦-新營,2023-03-15,9693
2891,中信金,57,0,57,富邦-新營,2023-03-15,9693
2603,長榮,78,35,43,富邦-新營,2023-03-15,9693
2897,王道銀行,40,0,40,富邦-新營,2023-03-15,9693
2888,新光金,26,0,26,富邦-新營,2023-03-15,9693
3147,大綜,26,0,26,富邦-新營,2023-03-15,9693
2027,大成鋼,28,6,22,富邦-新營,2023-03-15,9693
9958,世紀鋼,22,0,22,富邦-新營,2023-03-15,9693
2457,飛宏,94,73,21,富邦-新營,2023-03-15,9693
2883,凱基金,21,1,20,富邦-新營,2023-03-15,9693
2359,所羅門,21,3,18,富邦-新營,2023-03-15,9693
6770,力積電,17,3,14,富邦-新營,2023-03-15,9693
1712,興農,14,0,14,富邦-新營,2023-03-15,9693
2495,普安,14,0,14,富邦-新營,2023-03-15,9693
2881,富邦金,14,2,12,富邦-新營,2023-03-15,9693
2702,華園,11,0,11,富邦-新營,2023-03-15,9693
5608,四維航,43,32,11,富邦-新營,2023-03-15,9693
9904,寶成,11,0,11,富邦-新營,2023-03-15,9693
2314,台揚,10,0,10,富邦-新營,2023-03-15,9693
2371,大同,20,10,10,富邦-新營,2023-03-15,9693
3372,典範,10,0,10,富邦-新營,2023-03-15,9693
3576,聯合再生,12,3,9,富邦-新營,2023-03-15,9693
6244,茂迪,27,18,9,富邦-新營,2023-03-15,9693
2892,第一金,9,1,8,富邦-新營,2023-03-15,9693
4934,太極,11,3,8,富邦-新營,2023-03-15,9693
3264,欣銓,11,3,8,富邦-新營,2023-03-15,9693
00679B,元大美債20年,7,0,7,富邦-新營,2023-03-15,9693
4109,加捷生醫,7,0,7,富邦-新營,2023-03-15,9693
2880,華南金,10,4,6,富邦-新營,2023-03-15,9693
1303,南亞,6,0,6,富邦-新營,2023-03-15,9693
2601,益航,10,4,6,富邦-新營,2023-03-15,9693
8358,金居,6,0,6,富邦-新營,2023-03-15,9693
1102,亞泥,5,0,5,富邦-新營,2023-03-15,9693
2108,南帝,5,0,5,富邦-新營,2023-03-15,9693
2349,錸德,5,0,5,富邦-新營,2023-03-15,9693
3163,波若威,8,3,5,富邦-新營,2023-03-15,9693
3189,景碩,6,1,5,富邦-新營,2023-03-15,9693
3294,英濟,5,0,5,富邦-新營,2023-03-15,9693
3707,漢磊,6,1,5,富邦-新營,2023-03-15,9693
4911,德英,5,0,5,富邦-新營,2023-03-15,9693
2801,彰銀,4,0,4,富邦-新營,2023-03-15,9693
5425,台半,8,4,4,富邦-新營,2023-03-15,9693
3078,僑威,7,3,4,富邦-新營,2023-03-15,9693
4938,和碩,4,0,4,富邦-新營,2023-03-15,9693
00902,中信電池及儲能,4,0,4,富邦-新營,2023-03-15,9693
00720B,元大投資級公司債,4,0,4,富邦-新營,2023-03-15,9693
1455,集盛,4,0,4,富邦-新營,2023-03-15,9693
1710,東聯,4,0,4,富邦-新營,2023-03-15,9693
00715L,期街口布蘭特正2,2070,100,1970,富邦-新營,2023-03-16,9693
2834,臺企銀,97,14,83,富邦-新營,2023-03-16,9693
00878,國泰永續高股息,116,40,76,富邦-新營,2023-03-16,9693
2883,凱基金,74,0,74,富邦-新營,2023-03-16,9693
2891,中信金,77,3,74,富邦-新營,2023-03-16,9693
2609,陽明,74,11,63,富邦-新營,2023-03-16,9693
00713,元大台灣高息低波,55,0,55,富邦-新營,2023-03-16,9693
2603,長榮,50,4,46,富邦-新營,2023-03-16,9693
2027,大成鋼,31,0,31,富邦-新營,2023-03-16,9693
1536,和大,30,0,30,富邦-新營,2023-03-16,9693
3666,光耀,30,0,30,富邦-新營,2023-03-16,9693
4958,臻鼎-KY,30,0,30,富邦-新營,2023-03-16,9693
1720,生達,28,0,28,富邦-新營,2023-03-16,9693
2317,鴻海,29,1,28,富邦-新營,2023-03-16,9693
1102,亞泥,25,0,25,富邦-新營,2023-03-16,9693
2884,玉山金,29,5,24,富邦-新營,2023-03-16,9693
00712,復華富時不動產,22,0,22,富邦-新營,2023-03-16,9693
6182,合晶,24,2,22,富邦-新營,2023-03-16,9693
3704,合勤控,20,0,20,富邦-新營,2023-03-16,9693
3094,聯傑,20,0,20,富邦-新營,2023-03-16,9693
6152,百一,20,0,20,富邦-新營,2023-03-16,9693
1316,上曜,22,6,16,富邦-新營,2023-03-16,9693
1101,台泥,17,1,16,富邦-新營,2023-03-16,9693
1409,新纖,15,0,15,富邦-新營,2023-03-16,9693
1506,正道,25,10,15,富邦-新營,2023-03-16,9693
4109,加捷生醫,15,0,15,富邦-新營,2023-03-16,9693
6005,群益證,14,0,14,富邦-新營,2023-03-16,9693
6550,北極星藥業-KY,16,3,13,富邦-新營,2023-03-16,9693
00642U,期元大S＆P石油,13,0,13,富邦-新營,2023-03-16,9693
2498,宏達電,14,2,12,富邦-新營,2023-03-16,9693
2887,台新金,16,4,12,富邦-新營,2023-03-16,9693
2892,第一金,12,0,12,富邦-新營,2023-03-16,9693
5009,榮剛,19,7,12,富邦-新營,2023-03-16,9693
1440,南紡,10,0,10,富邦-新營,2023-03-16,9693
3376,新日興,10,0,10,富邦-新營,2023-03-16,9693
6266,泰詠,10,0,10,富邦-新營,2023-03-16,9693
6535,順藥,10,0,10,富邦-新營,2023-03-16,9693
6541,泰福-KY,10,0,10,富邦-新營,2023-03-16,9693
8171,天宇,10,0,10,富邦-新營,2023-03-16,9693
1417,嘉裕,9,0,9,富邦-新營,2023-03-16,9693
2453,凌群,11,2,9,富邦-新營,2023-03-16,9693
6122,擎邦,9,0,9,富邦-新營,2023-03-16,9693
2702,華園,10,2,8,富邦-新營,2023-03-16,9693
4540,全球傳動,10,2,8,富邦-新營,2023-03-16,9693
0056,元大高股息,19,11,8,富邦-新營,2023-03-16,9693
2867,三商壽,7,0,7,富邦-新營,2023-03-16,9693
3481,群創,7,1,6,富邦-新營,2023-03-16,9693
00902,中信電池及儲能,6,0,6,富邦-新營,2023-03-16,9693
00905,FT臺灣Smart,6,0,6,富邦-新營,2023-03-16,9693
2897,王道銀行,6,0,6,富邦-新營,2023-03-16,9693
2362,藍天,350,0,350,富邦-新營,2023-03-17,9693
2891,中信金,97,0,97,富邦-新營,2023-03-17,9693
1611,中電,72,8,64,富邦-新營,2023-03-17,9693
00885,富邦越南,58,1,57,富邦-新營,2023-03-17,9693
5340,建榮,50,0,50,富邦-新營,2023-03-17,9693
00715L,期街口布蘭特正2,34,0,34,富邦-新營,2023-03-17,9693
9907,統一實,30,0,30,富邦-新營,2023-03-17,9693
00679B,元大美債20年,27,0,27,富邦-新營,2023-03-17,9693
2887,台新金,23,1,22,富邦-新營,2023-03-17,9693
3010,華立,18,0,18,富邦-新營,2023-03-17,9693
3147,大綜,17,0,17,富邦-新營,2023-03-17,9693
3162,精確,17,1,16,富邦-新營,2023-03-17,9693
2892,第一金,15,0,15,富邦-新營,2023-03-17,9693
0056,元大高股息,15,1,14,富邦-新營,2023-03-17,9693
00878,國泰永續高股息,19,6,13,富邦-新營,2023-03-17,9693
2609,陽明,25,12,13,富邦-新營,2023-03-17,9693
3046,建��,15,2,13,富邦-新營,2023-03-17,9693
5483,中美晶,13,1,12,富邦-新營,2023-03-17,9693
3406,玉晶光,12,0,12,富邦-新營,2023-03-17,9693
9904,寶成,14,3,11,富邦-新營,2023-03-17,9693
00712,復華富時不動產,10,0,10,富邦-新營,2023-03-17,9693
2009,第一銅,10,0,10,富邦-新營,2023-03-17,9693
3289,宜特,10,0,10,富邦-新營,2023-03-17,9693
8033,雷虎,10,0,10,富邦-新營,2023-03-17,9693
8103,瀚荃,10,0,10,富邦-新營,2023-03-17,9693
2603,長榮,21,11,10,富邦-新營,2023-03-17,9693
1440,南紡,12,3,9,富邦-新營,2023-03-17,9693
6541,泰福-KY,9,0,9,富邦-新營,2023-03-17,9693
1604,聲寶,8,0,8,富邦-新營,2023-03-17,9693
2399,映泰,15,7,8,富邦-新營,2023-03-17,9693
2419,仲琦,8,0,8,富邦-新營,2023-03-17,9693
3029,零壹,17,9,8,富邦-新營,2023-03-17,9693
3051,力特,8,0,8,富邦-新營,2023-03-17,9693
3576,聯合再生,15,7,8,富邦-新營,2023-03-17,9693
1227,佳格,7,0,7,富邦-新營,2023-03-17,9693
1909,榮成,17,10,7,富邦-新營,2023-03-17,9693
3093,港建*,8,1,7,富邦-新營,2023-03-17,9693
4540,全球傳動,7,0,7,富邦-新營,2023-03-17,9693
1720,生達,6,0,6,富邦-新營,2023-03-17,9693
00902,中信電池及儲能,6,0,6,富邦-新營,2023-03-17,9693
00671R,富邦NASDAQ反1,6,0,6,富邦-新營,2023-03-17,9693
2014,中鴻,6,0,6,富邦-新營,2023-03-17,9693
2618,長榮航,7,1,6,富邦-新營,2023-03-17,9693
2883,凱基金,22,17,5,富邦-新營,2023-03-17,9693
1101,台泥,6,1,5,富邦-新營,2023-03-17,9693
1777,生泰,5,0,5,富邦-新營,2023-03-17,9693
00642U,期元大S＆P石油,5,0,5,富邦-新營,2023-03-17,9693
2385,群光,5,0,5,富邦-新營,2023-03-17,9693
2442,新美齊,5,0,5,富邦-新營,2023-03-17,9693
2915,潤泰全,5,0,5,富邦-新營,2023-03-17,9693
00637L,元大滬深300正2,161,0,161,富邦-新營,2023-03-20,9693
00712,復華富時不動產,97,6,91,富邦-新營,2023-03-20,9693
2891,中信金,62,0,62,富邦-新營,2023-03-20,9693
00885,富邦越南,62,0,62,富邦-新營,2023-03-20,9693
00715L,期街口布蘭特正2,72,14,58,富邦-新營,2023-03-20,9693
2881,富邦金,53,0,53,富邦-新營,2023-03-20,9693
00878,國泰永續高股息,44,0,44,富邦-新營,2023-03-20,9693
3027,盛達,227,193,34,富邦-新營,2023-03-20,9693
3081,聯亞,31,0,31,富邦-新營,2023-03-20,9693
2834,臺企銀,38,9,29,富邦-新營,2023-03-20,9693
2890,永豐金,34,6,28,富邦-新營,2023-03-20,9693
1301,台塑,22,0,22,富邦-新營,2023-03-20,9693
6163,華電網,26,5,21,富邦-新營,2023-03-20,9693
1102,亞泥,20,0,20,富邦-新營,2023-03-20,9693
6477,安集,23,3,20,富邦-新營,2023-03-20,9693
2609,陽明,33,13,20,富邦-新營,2023-03-20,9693
00642U,期元大S＆P石油,18,0,18,富邦-新營,2023-03-20,9693
2009,第一銅,15,0,15,富邦-新營,2023-03-20,9693
3624,光頡,99,84,15,富邦-新營,2023-03-20,9693
1605,華新,19,5,14,富邦-新營,2023-03-20,9693
2330,台積電,13,0,13,富邦-新營,2023-03-20,9693
0056,元大高股息,13,0,13,富邦-新營,2023-03-20,9693
6244,茂迪,24,11,13,富邦-新營,2023-03-20,9693
2636,台驊控股,11,0,11,富邦-新營,2023-03-20,9693
5425,台半,12,1,11,富邦-新營,2023-03-20,9693
1440,南紡,10,0,10,富邦-新營,2023-03-20,9693
2014,中鴻,10,0,10,富邦-新營,2023-03-20,9693
8358,金居,10,0,10,富邦-新營,2023-03-20,9693
9955,佳龍,10,0,10,富邦-新營,2023-03-20,9693
2313,華通,10,1,9,富邦-新營,2023-03-20,9693
2368,金像電,9,0,9,富邦-新營,2023-03-20,9693
2641,正德,11,2,9,富邦-新營,2023-03-20,9693
2888,新光金,13,4,9,富邦-新營,2023-03-20,9693
3147,大綜,26,17,9,富邦-新營,2023-03-20,9693
3481,群創,9,0,9,富邦-新營,2023-03-20,9693
00902,中信電池及儲能,7,0,7,富邦-新營,2023-03-20,9693
2390,云辰,7,0,7,富邦-新營,2023-03-20,9693
3231,緯創,11,4,7,富邦-新營,2023-03-20,9693
2481,強茂,16,10,6,富邦-新營,2023-03-20,9693
8933,愛地雅,6,0,6,富邦-新營,2023-03-20,9693
2883,凱基金,6,0,6,富邦-新營,2023-03-20,9693
2458,義隆,5,0,5,富邦-新營,2023-03-20,9693
2610,華航,5,0,5,富邦-新營,2023-03-20,9693
5483,中美晶,5,0,5,富邦-新營,2023-03-20,9693
1217,愛之味,5,0,5,富邦-新營,2023-03-20,9693
2022,聚亨,5,0,5,富邦-新營,2023-03-20,9693
2329,華泰,5,0,5,富邦-新營,2023-03-20,9693
2354,鴻準,5,0,5,富邦-新營,2023-03-20,9693
2845,遠東銀,5,0,5,富邦-新營,2023-03-20,9693
3005,神基,5,0,5,富邦-新營,2023-03-20,9693
1611,中電,343,43,300,富邦-新營,2023-03-21,9693
2834,臺企銀,154,5,149,富邦-新營,2023-03-21,9693
2006,東和鋼鐵,100,0,100,富邦-新營,2023-03-21,9693
6288,聯嘉,100,1,99,富邦-新營,2023-03-21,9693
6235,華孚,118,23,95,富邦-新營,2023-03-21,9693
2891,中信金,80,0,80,富邦-新營,2023-03-21,9693
2344,華邦電,59,4,55,富邦-新營,2023-03-21,9693
2615,萬海,53,0,53,富邦-新營,2023-03-21,9693
00753L,中信中國50正2,52,0,52,富邦-新營,2023-03-21,9693
1720,生達,50,0,50,富邦-新營,2023-03-21,9693
5258,虹堡,96,47,49,富邦-新營,2023-03-21,9693
2888,新光金,45,4,41,富邦-新營,2023-03-21,9693
2495,普安,40,1,39,富邦-新營,2023-03-21,9693
00885,富邦越南,26,0,26,富邦-新營,2023-03-21,9693
3481,群創,25,1,24,富邦-新營,2023-03-21,9693
2371,大同,20,0,20,富邦-新營,2023-03-21,9693
3432,台端,20,0,20,富邦-新營,2023-03-21,9693
3576,聯合再生,20,0,20,富邦-新營,2023-03-21,9693
6443,元晶,32,12,20,富邦-新營,2023-03-21,9693
1309,台達化,19,0,19,富邦-新營,2023-03-21,9693
2457,飛宏,77,59,18,富邦-新營,2023-03-21,9693
3029,零壹,22,8,14,富邦-新營,2023-03-21,9693
00878,國泰永續高股息,14,2,12,富邦-新營,2023-03-21,9693
6182,合晶,14,3,11,富邦-新營,2023-03-21,9693
1524,耿鼎,14,3,11,富邦-新營,2023-03-21,9693
00888,永豐台灣ESG,10,0,10,富邦-新營,2023-03-21,9693
5483,中美晶,10,0,10,富邦-新營,2023-03-21,9693
4540,全球傳動,10,0,10,富邦-新營,2023-03-21,9693
6689,伊雲谷,11,1,10,富邦-新營,2023-03-21,9693
00712,復華富時不動產,10,0,10,富邦-新營,2023-03-21,9693
2409,友達,16,7,9,富邦-新營,2023-03-21,9693
4934,太極,10,1,9,富邦-新營,2023-03-21,9693
3078,僑威,10,1,9,富邦-新營,2023-03-21,9693
6796,晉弘,9,0,9,富邦-新營,2023-03-21,9693
5009,榮剛,31,23,8,富邦-新營,2023-03-21,9693
6143,振曜,8,0,8,富邦-新營,2023-03-21,9693
6191,精成科,12,5,7,富邦-新營,2023-03-21,9693
3046,建��,28,21,7,富邦-新營,2023-03-21,9693
2603,長榮,9,3,6,富邦-新營,2023-03-21,9693
2887,台新金,6,0,6,富邦-新營,2023-03-21,9693
1227,佳格,6,0,6,富邦-新營,2023-03-21,9693
1810,和成,8,2,6,富邦-新營,2023-03-21,9693
2388,威盛,16,10,6,富邦-新營,2023-03-21,9693
2402,毅嘉,8,2,6,富邦-新營,2023-03-21,9693
3038,全台,6,0,6,富邦-新營,2023-03-21,9693
6233,旺玖,6,0,6,富邦-新營,2023-03-21,9693
1217,愛之味,5,0,5,富邦-新營,2023-03-21,9693
1802,台玻,5,0,5,富邦-新營,2023-03-21,9693
2323,中環,5,0,5,富邦-新營,2023-03-21,9693
2884,玉山金,10,5,5,富邦-新營,2023-03-21,9693
2471,資通,120,11,109,富邦-新營,2023-03-22,9693
2897,王道銀行,92,0,92,富邦-新營,2023-03-22,9693
2883,凱基金,81,20,61,富邦-新營,2023-03-22,9693
2881,富邦金,54,1,53,富邦-新營,2023-03-22,9693
2891,中信金,47,1,46,富邦-新營,2023-03-22,9693
3029,零壹,57,14,43,富邦-新營,2023-03-22,9693
6153,嘉聯益,42,5,37,富邦-新營,2023-03-22,9693
1504,東元,43,16,27,富邦-新營,2023-03-22,9693
00679B,元大美債20年,21,0,21,富邦-新營,2023-03-22,9693
00885,富邦越南,20,0,20,富邦-新營,2023-03-22,9693
6733,博晟生醫,22,2,20,富邦-新營,2023-03-22,9693
1611,中電,64,46,18,富邦-新營,2023-03-22,9693
1309,台達化,18,0,18,富邦-新營,2023-03-22,9693
6231,系微,62,44,18,富邦-新營,2023-03-22,9693
3576,聯合再生,16,0,16,富邦-新營,2023-03-22,9693
1463,強盛新,15,0,15,富邦-新營,2023-03-22,9693
8234,新漢,16,1,15,富邦-新營,2023-03-22,9693
2457,飛宏,45,31,14,富邦-新營,2023-03-22,9693
00680L,元大美債20正2,34,20,14,富邦-新營,2023-03-22,9693
2449,京元電子,16,2,14,富邦-新營,2023-03-22,9693
1529,樂事綠能,16,5,11,富邦-新營,2023-03-22,9693
3209,全科,11,0,11,富邦-新營,2023-03-22,9693
1314,中石化,10,0,10,富邦-新營,2023-03-22,9693
1342,八貫,10,0,10,富邦-新營,2023-03-22,9693
2867,三商壽,10,0,10,富邦-新營,2023-03-22,9693
3673,TPK-KY,10,0,10,富邦-新營,2023-03-22,9693
6167,久正,10,0,10,富邦-新營,2023-03-22,9693
6190,萬泰科,10,0,10,富邦-新營,2023-03-22,9693
6196,帆宣,10,0,10,富邦-新營,2023-03-22,9693
9955,佳龍,10,0,10,富邦-新營,2023-03-22,9693
2472,立隆電,10,0,10,富邦-新營,2023-03-22,9693
2382,廣達,10,0,10,富邦-新營,2023-03-22,9693
6282,康舒,9,0,9,富邦-新營,2023-03-22,9693
6790,永豐實,9,0,9,富邦-新營,2023-03-22,9693
8033,雷虎,10,1,9,富邦-新營,2023-03-22,9693
1227,佳格,8,0,8,富邦-新營,2023-03-22,9693
2312,金寶,8,0,8,富邦-新營,2023-03-22,9693
1718,中纖,8,1,7,富邦-新營,2023-03-22,9693
2641,正德,10,3,7,富邦-新營,2023-03-22,9693
2812,台中銀,7,0,7,富邦-新營,2023-03-22,9693
2409,友達,6,0,6,富邦-新營,2023-03-22,9693
00720B,元大投資級公司債,6,0,6,富邦-新營,2023-03-22,9693
1584,精剛,6,0,6,富邦-新營,2023-03-22,9693
2486,一詮,6,0,6,富邦-新營,2023-03-22,9693
3360,尚立,6,0,6,富邦-新營,2023-03-22,9693
5512,力麒,18,12,6,富邦-新營,2023-03-22,9693
6767,台微醫,6,0,6,富邦-新營,2023-03-22,9693
2345,智邦,6,0,6,富邦-新營,2023-03-22,9693
00712,復華富時不動產,5,0,5,富邦-新營,2023-03-22,9693
2027,大成鋼,5,0,5,富邦-新營,2023-03-22,9693
2897,王道銀行,228,0,228,富邦-新營,2023-03-23,9693
3703,欣陸,50,0,50,富邦-新營,2023-03-23,9693
2891,中信金,46,0,46,富邦-新營,2023-03-23,9693
00905,FT臺灣Smart,40,0,40,富邦-新營,2023-03-23,9693
1605,華新,35,4,31,富邦-新營,2023-03-23,9693
6591,動力-KY,31,0,31,富邦-新營,2023-03-23,9693
2221,大甲,30,0,30,富邦-新營,2023-03-23,9693
6148,驊宏資,67,37,30,富邦-新營,2023-03-23,9693
5211,蒙恬,38,9,29,富邦-新營,2023-03-23,9693
2453,凌群,48,21,27,富邦-新營,2023-03-23,9693
3322,建舜電,65,40,25,富邦-新營,2023-03-23,9693
2402,毅嘉,88,66,22,富邦-新營,2023-03-23,9693
6129,普誠,20,0,20,富邦-新營,2023-03-23,9693
2359,所羅門,21,2,19,富邦-新營,2023-03-23,9693
2457,飛宏,20,4,16,富邦-新營,2023-03-23,9693
5210,寶碩,15,0,15,富邦-新營,2023-03-23,9693
6140,訊達,15,0,15,富邦-新營,2023-03-23,9693
3558,神準,16,1,15,富邦-新營,2023-03-23,9693
3029,零壹,26,12,14,富邦-新營,2023-03-23,9693
6176,瑞儀,14,0,14,富邦-新營,2023-03-23,9693
2206,三陽工業,12,0,12,富邦-新營,2023-03-23,9693
2618,長榮航,43,32,11,富邦-新營,2023-03-23,9693
2027,大成鋼,11,0,11,富邦-新營,2023-03-23,9693
6235,華孚,14,3,11,富邦-新營,2023-03-23,9693
2495,普安,11,0,11,富邦-新營,2023-03-23,9693
2812,台中銀,11,0,11,富邦-新營,2023-03-23,9693
3481,群創,24,14,10,富邦-新營,2023-03-23,9693
00717,富邦美國特別股,10,0,10,富邦-新營,2023-03-23,9693
00753L,中信中國50正2,10,0,10,富邦-新營,2023-03-23,9693
00664R,國泰臺灣加權反1,10,0,10,富邦-新營,2023-03-23,9693
00637L,元大滬深300正2,10,0,10,富邦-新營,2023-03-23,9693
1437,勤益控,13,3,10,富邦-新營,2023-03-23,9693
2474,可成,10,0,10,富邦-新營,2023-03-23,9693
4968,立積,10,0,10,富邦-新營,2023-03-23,9693
6270,倍微,10,0,10,富邦-新營,2023-03-23,9693
6697,東捷資訊,10,0,10,富邦-新營,2023-03-23,9693
8176,智捷,10,0,10,富邦-新營,2023-03-23,9693
00679B,元大美債20年,9,0,9,富邦-新營,2023-03-23,9693
1524,耿鼎,17,8,9,富邦-新營,2023-03-23,9693
3006,晶豪科,10,1,9,富邦-新營,2023-03-23,9693
00751B,元大AAA至A公司債,8,0,8,富邦-新營,2023-03-23,9693
2615,萬海,7,0,7,富邦-新營,2023-03-23,9693
2929,淘帝-KY,7,0,7,富邦-新營,2023-03-23,9693
1712,興農,6,0,6,富邦-新營,2023-03-23,9693
2605,新興,6,0,6,富邦-新營,2023-03-23,9693
2880,華南金,6,0,6,富邦-新營,2023-03-23,9693
3209,全科,6,0,6,富邦-新營,2023-03-23,9693
6244,茂迪,88,82,6,富邦-新營,2023-03-23,9693
1319,東陽,7,1,6,富邦-新營,2023-03-23,9693
00885,富邦越南,9,4,5,富邦-新營,2023-03-23,9693
00637L,元大滬深300正2,150,0,150,富邦-新營,2023-03-24,9693
8088,品安,100,0,100,富邦-新營,2023-03-24,9693
5425,台半,91,4,87,富邦-新營,2023-03-24,9693
2867,三商壽,51,0,51,富邦-新營,2023-03-24,9693
2891,中信金,48,0,48,富邦-新營,2023-03-24,9693
2106,建大,40,0,40,富邦-新營,2023-03-24,9693
4707,磐亞,40,0,40,富邦-新營,2023-03-24,9693
1503,士電,37,0,37,富邦-新營,2023-03-24,9693
1909,榮成,33,0,33,富邦-新營,2023-03-24,9693
6288,聯嘉,95,65,30,富邦-新營,2023-03-24,9693
1513,中興電,30,0,30,富邦-新營,2023-03-24,9693
3147,大綜,25,0,25,富邦-新營,2023-03-24,9693
4903,聯光通,26,1,25,富邦-新營,2023-03-24,9693
2206,三陽工業,22,0,22,富邦-新營,2023-03-24,9693
2014,中鴻,24,3,21,富邦-新營,2023-03-24,9693
3322,建舜電,21,0,21,富邦-新營,2023-03-24,9693
2897,王道銀行,20,0,20,富邦-新營,2023-03-24,9693
00712,復華富時不動產,18,0,18,富邦-新營,2023-03-24,9693
2476,鉅祥,26,8,18,富邦-新營,2023-03-24,9693
6843,進典,15,0,15,富邦-新營,2023-03-24,9693
2392,正崴,17,3,14,富邦-新營,2023-03-24,9693
6443,元晶,24,11,13,富邦-新營,2023-03-24,9693
2618,長榮航,14,2,12,富邦-新營,2023-03-24,9693
2211,長榮鋼,10,0,10,富邦-新營,2023-03-24,9693
1591,駿吉-KY,16,6,10,富邦-新營,2023-03-24,9693
2025,千興,10,0,10,富邦-新營,2023-03-24,9693
2812,台中銀,10,0,10,富邦-新營,2023-03-24,9693
3019,亞光,10,0,10,富邦-新營,2023-03-24,9693
3441,聯一光,10,0,10,富邦-新營,2023-03-24,9693
6142,友勁,10,0,10,富邦-新營,2023-03-24,9693
6697,東捷資訊,10,0,10,富邦-新營,2023-03-24,9693
8150,南茂,10,0,10,富邦-新營,2023-03-24,9693
2303,聯電,10,1,9,富邦-新營,2023-03-24,9693
2601,益航,12,3,9,富邦-新營,2023-03-24,9693
6180,橘子,9,0,9,富邦-新營,2023-03-24,9693
8234,新漢,9,0,9,富邦-新營,2023-03-24,9693
00772B,中信高評級公司債,9,0,9,富邦-新營,2023-03-24,9693
2009,第一銅,8,0,8,富邦-新營,2023-03-24,9693
3362,先進光,8,0,8,富邦-新營,2023-03-24,9693
5512,力麒,8,0,8,富邦-新營,2023-03-24,9693
4541,晟田,7,0,7,富邦-新營,2023-03-24,9693
6122,擎邦,14,7,7,富邦-新營,2023-03-24,9693
2105,正新,8,1,7,富邦-新營,2023-03-24,9693
2881,富邦金,6,0,6,富邦-新營,2023-03-24,9693
4129,聯合,6,0,6,富邦-新營,2023-03-24,9693
5211,蒙恬,6,0,6,富邦-新營,2023-03-24,9693
6538,倉和,6,0,6,富邦-新營,2023-03-24,9693
6840,東研信超,6,0,6,富邦-新營,2023-03-24,9693
00902,中信電池及儲能,5,0,5,富邦-新營,2023-03-24,9693
00688L,國泰20年美債正2,5,0,5,富邦-新營,2023-03-24,9693
00878,國泰永續高股息,140,21,119,富邦-新營,2023-03-27,9693
00637L,元大滬深300正2,110,0,110,富邦-新營,2023-03-27,9693
00665L,富邦�琤肭磪囓�2,62,0,62,富邦-新營,2023-03-27,9693
6156,松上,55,0,55,富邦-新營,2023-03-27,9693
6266,泰詠,50,0,50,富邦-新營,2023-03-27,9693
6235,華孚,52,15,37,富邦-新營,2023-03-27,9693
1718,中纖,36,0,36,富邦-新營,2023-03-27,9693
00632R,元大台灣50反1,32,2,30,富邦-新營,2023-03-27,9693
6288,聯嘉,118,92,26,富邦-新營,2023-03-27,9693
1605,華新,39,15,24,富邦-新營,2023-03-27,9693
1102,亞泥,23,0,23,富邦-新營,2023-03-27,9693
00882,中信中國高股息,16,0,16,富邦-新營,2023-03-27,9693
3027,盛達,16,0,16,富邦-新營,2023-03-27,9693
6116,彩晶,24,8,16,富邦-新營,2023-03-27,9693
6697,東捷資訊,16,0,16,富邦-新營,2023-03-27,9693
3035,智原,16,1,15,富邦-新營,2023-03-27,9693
3703,欣陸,15,0,15,富邦-新營,2023-03-27,9693
1319,東陽,14,0,14,富邦-新營,2023-03-27,9693
1506,正道,13,0,13,富邦-新營,2023-03-27,9693
6538,倉和,13,0,13,富邦-新營,2023-03-27,9693
00715L,期街口布蘭特正2,12,0,12,富邦-新營,2023-03-27,9693
1227,佳格,12,0,12,富邦-新營,2023-03-27,9693
2317,鴻海,12,1,11,富邦-新營,2023-03-27,9693
8096,擎亞,11,0,11,富邦-新營,2023-03-27,9693
2106,建大,10,0,10,富邦-新營,2023-03-27,9693
1201,味全,10,0,10,富邦-新營,2023-03-27,9693
2413,環科,11,1,10,富邦-新營,2023-03-27,9693
2530,華建,10,0,10,富邦-新營,2023-03-27,9693
6477,安集,20,10,10,富邦-新營,2023-03-27,9693
1101,台泥,10,0,10,富邦-新營,2023-03-27,9693
6770,力積電,17,8,9,富邦-新營,2023-03-27,9693
5512,力麒,9,0,9,富邦-新營,2023-03-27,9693
2402,毅嘉,34,25,9,富邦-新營,2023-03-27,9693
1440,南紡,9,0,9,富邦-新營,2023-03-27,9693
1312,國喬,9,1,8,富邦-新營,2023-03-27,9693
2392,正崴,8,0,8,富邦-新營,2023-03-27,9693
2485,兆赫,10,2,8,富邦-新營,2023-03-27,9693
2344,華邦電,13,5,8,富邦-新營,2023-03-27,9693
00902,中信電池及儲能,7,0,7,富邦-新營,2023-03-27,9693
2014,中鴻,8,1,7,富邦-新營,2023-03-27,9693
2897,王道銀行,7,0,7,富邦-新營,2023-03-27,9693
3356,奇偶,7,0,7,富邦-新營,2023-03-27,9693
3105,穩懋,8,2,6,富邦-新營,2023-03-27,9693
3406,玉晶光,18,12,6,富邦-新營,2023-03-27,9693
1309,台達化,6,0,6,富邦-新營,2023-03-27,9693
1708,東鹼,6,0,6,富邦-新營,2023-03-27,9693
2461,光群雷,6,0,6,富邦-新營,2023-03-27,9693
3483,力致,6,0,6,富邦-新營,2023-03-27,9693
3715,定穎投控,6,0,6,富邦-新營,2023-03-27,9693
6241,易通展,6,0,6,富邦-新營,2023-03-27,9693
9962,有益,46,0,46,富邦-新營,2023-03-28,9693
2867,三商壽,40,0,40,富邦-新營,2023-03-28,9693
00679B,元大美債20年,40,0,40,富邦-新營,2023-03-28,9693
1605,華新,44,17,27,富邦-新營,2023-03-28,9693
1810,和成,27,0,27,富邦-新營,2023-03-28,9693
00878,國泰永續高股息,27,2,25,富邦-新營,2023-03-28,9693
1609,大亞,28,4,24,富邦-新營,2023-03-28,9693
00680L,元大美債20正2,23,0,23,富邦-新營,2023-03-28,9693
1102,亞泥,23,0,23,富邦-新營,2023-03-28,9693
00891,中信關鍵半導體,20,0,20,富邦-新營,2023-03-28,9693
0056,元大高股息,23,3,20,富邦-新營,2023-03-28,9693
5009,榮剛,42,24,18,富邦-新營,2023-03-28,9693
8222,寶一,21,4,17,富邦-新營,2023-03-28,9693
3224,三顧,17,0,17,富邦-新營,2023-03-28,9693
00673R,期元大S＆P原油反1,16,0,16,富邦-新營,2023-03-28,9693
1312,國喬,15,0,15,富邦-新營,2023-03-28,9693
6770,力積電,16,2,14,富邦-新營,2023-03-28,9693
3037,欣興,17,3,14,富邦-新營,2023-03-28,9693
2211,長榮鋼,13,0,13,富邦-新營,2023-03-28,9693
3035,智原,13,0,13,富邦-新營,2023-03-28,9693
2303,聯電,16,3,13,富邦-新營,2023-03-28,9693
3406,玉晶光,12,0,12,富邦-新營,2023-03-28,9693
1417,嘉裕,12,0,12,富邦-新營,2023-03-28,9693
6697,東捷資訊,12,0,12,富邦-新營,2023-03-28,9693
1101,台泥,15,3,12,富邦-新營,2023-03-28,9693
00922,國泰台灣領袖50,11,0,11,富邦-新營,2023-03-28,9693
3231,緯創,11,0,11,富邦-新營,2023-03-28,9693
1584,精剛,28,17,11,富邦-新營,2023-03-28,9693
3047,訊舟,13,2,11,富邦-新營,2023-03-28,9693
00632R,元大台灣50反1,10,0,10,富邦-新營,2023-03-28,9693
00665L,富邦�琤肭磪囓�2,10,0,10,富邦-新營,2023-03-28,9693
1342,八貫,29,19,10,富邦-新營,2023-03-28,9693
1591,駿吉-KY,10,0,10,富邦-新營,2023-03-28,9693
2034,允強,10,0,10,富邦-新營,2023-03-28,9693
2105,正新,13,3,10,富邦-新營,2023-03-28,9693
2419,仲琦,10,0,10,富邦-新營,2023-03-28,9693
3715,定穎投控,20,10,10,富邦-新營,2023-03-28,9693
00713,元大台灣高息低波,10,0,10,富邦-新營,2023-03-28,9693
00772B,中信高評級公司債,9,0,9,富邦-新營,2023-03-28,9693
3374,精材,9,0,9,富邦-新營,2023-03-28,9693
6477,安集,10,1,9,富邦-新營,2023-03-28,9693
6241,易通展,8,0,8,富邦-新營,2023-03-28,9693
1504,東元,16,9,7,富邦-新營,2023-03-28,9693
00751B,元大AAA至A公司債,7,0,7,富邦-新營,2023-03-28,9693
00892,富邦台灣半導體,7,0,7,富邦-新營,2023-03-28,9693
00900,富邦特選高股息30,7,0,7,富邦-新營,2023-03-28,9693
00720B,元大投資級公司債,7,0,7,富邦-新營,2023-03-28,9693
4916,事欣科,7,0,7,富邦-新營,2023-03-28,9693
2732,六角,7,0,7,富邦-新營,2023-03-28,9693
2342,茂矽,31,25,6,富邦-新營,2023-03-28,9693
2371,大同,48,1,47,富邦-新營,2023-03-29,9693
1784,訊聯,30,2,28,富邦-新營,2023-03-29,9693
2734,易飛網,25,0,25,富邦-新營,2023-03-29,9693
1102,亞泥,23,0,23,富邦-新營,2023-03-29,9693
1437,勤益控,23,0,23,富邦-新營,2023-03-29,9693
9962,有益,23,0,23,富邦-新營,2023-03-29,9693
6125,廣運,20,0,20,富邦-新營,2023-03-29,9693
8046,南電,19,2,17,富邦-新營,2023-03-29,9693
1712,興農,14,0,14,富邦-新營,2023-03-29,9693
3035,智原,15,2,13,富邦-新營,2023-03-29,9693
2812,台中銀,24,11,13,富邦-新營,2023-03-29,9693
2303,聯電,20,7,13,富邦-新營,2023-03-29,9693
1504,東元,35,22,13,富邦-新營,2023-03-29,9693
6770,力積電,16,4,12,富邦-新營,2023-03-29,9693
2314,台揚,12,0,12,富邦-新營,2023-03-29,9693
3703,欣陸,12,0,12,富邦-新營,2023-03-29,9693
5289,宜鼎,11,0,11,富邦-新營,2023-03-29,9693
6147,頎邦,11,0,11,富邦-新營,2023-03-29,9693
00877,復華中國5G,10,0,10,富邦-新營,2023-03-29,9693
2337,旺宏,10,0,10,富邦-新營,2023-03-29,9693
3715,定穎投控,29,20,9,富邦-新營,2023-03-29,9693
00892,富邦台灣半導體,9,0,9,富邦-新營,2023-03-29,9693
1609,大亞,23,14,9,富邦-新營,2023-03-29,9693
2208,台船,9,0,9,富邦-新營,2023-03-29,9693
2349,錸德,9,0,9,富邦-新營,2023-03-29,9693
2388,威盛,10,1,9,富邦-新營,2023-03-29,9693
2481,強茂,12,3,9,富邦-新營,2023-03-29,9693
6241,易通展,9,0,9,富邦-新營,2023-03-29,9693
5425,台半,9,1,8,富邦-新營,2023-03-29,9693
1810,和成,8,0,8,富邦-新營,2023-03-29,9693
3447,展達,8,0,8,富邦-新營,2023-03-29,9693
6843,進典,8,0,8,富邦-新營,2023-03-29,9693
3289,宜特,10,3,7,富邦-新營,2023-03-29,9693
2609,陽明,15,8,7,富邦-新營,2023-03-29,9693
6796,晉弘,7,0,7,富邦-新營,2023-03-29,9693
2457,飛宏,18,11,7,富邦-新營,2023-03-29,9693
00680L,元大美債20正2,6,0,6,富邦-新營,2023-03-29,9693
00713,元大台灣高息低波,6,0,6,富邦-新營,2023-03-29,9693
00679B,元大美債20年,6,0,6,富邦-新營,2023-03-29,9693
2461,光群雷,6,0,6,富邦-新營,2023-03-29,9693
00885,富邦越南,7,2,5,富邦-新營,2023-03-29,9693
00669R,國泰美國道瓊反1,5,0,5,富邦-新營,2023-03-29,9693
00922,國泰台灣領袖50,5,0,5,富邦-新營,2023-03-29,9693
1417,嘉裕,5,0,5,富邦-新營,2023-03-29,9693
3006,晶豪科,5,0,5,富邦-新營,2023-03-29,9693
3023,信邦,5,0,5,富邦-新營,2023-03-29,9693
1101,台泥,5,0,5,富邦-新營,2023-03-29,9693
1605,華新,10,6,4,富邦-新營,2023-03-29,9693
8069,元太,4,0,4,富邦-新營,2023-03-29,9693
00696B,富邦美債20年,4,0,4,富邦-新營,2023-03-29,9693
3715,定穎投控,208,34,174,富邦-新營,2023-03-30,9693
2867,三商壽,50,0,50,富邦-新營,2023-03-30,9693
2734,易飛網,33,0,33,富邦-新營,2023-03-30,9693
9921,巨大,29,0,29,富邦-新營,2023-03-30,9693
00680L,元大美債20正2,22,0,22,富邦-新營,2023-03-30,9693
3406,玉晶光,25,5,20,富邦-新營,2023-03-30,9693
6282,康舒,16,0,16,富邦-新營,2023-03-30,9693
2618,長榮航,15,0,15,富邦-新營,2023-03-30,9693
2889,國票金,17,2,15,富邦-新營,2023-03-30,9693
00700,富邦�琤肭磪�,13,0,13,富邦-新營,2023-03-30,9693
2897,王道銀行,11,0,11,富邦-新營,2023-03-30,9693
2634,漢翔,11,0,11,富邦-新營,2023-03-30,9693
2881,富邦金,10,0,10,富邦-新營,2023-03-30,9693
2748,雲品,14,4,10,富邦-新營,2023-03-30,9693
2382,廣達,11,1,10,富邦-新營,2023-03-30,9693
2610,華航,18,10,8,富邦-新營,2023-03-30,9693
3504,揚明光,8,0,8,富邦-新營,2023-03-30,9693
6160,欣技,8,0,8,富邦-新營,2023-03-30,9693
2409,友達,7,0,7,富邦-新營,2023-03-30,9693
6244,茂迪,14,7,7,富邦-新營,2023-03-30,9693
8249,菱光,8,1,7,富邦-新營,2023-03-30,9693
8931,大汽電,6,0,6,富邦-新營,2023-03-30,9693
3236,千如,6,0,6,富邦-新營,2023-03-30,9693
00882,中信中國高股息,6,0,6,富邦-新營,2023-03-30,9693
2458,義隆,6,0,6,富邦-新營,2023-03-30,9693
00669R,國泰美國道瓊反1,5,0,5,富邦-新營,2023-03-30,9693
1608,華榮,5,0,5,富邦-新營,2023-03-30,9693
2211,長榮鋼,5,0,5,富邦-新營,2023-03-30,9693
2332,友訊,5,0,5,富邦-新營,2023-03-30,9693
2359,所羅門,7,2,5,富邦-新營,2023-03-30,9693
2426,鼎元,5,0,5,富邦-新營,2023-03-30,9693
3481,群創,7,2,5,富邦-新營,2023-03-30,9693
5258,虹堡,7,2,5,富邦-新營,2023-03-30,9693
5309,系統電,16,11,5,富邦-新營,2023-03-30,9693
1752,南光,5,1,4,富邦-新營,2023-03-30,9693
2883,凱基金,4,0,4,富邦-新營,2023-03-30,9693
00679B,元大美債20年,4,0,4,富邦-新營,2023-03-30,9693
1227,佳格,4,0,4,富邦-新營,2023-03-30,9693
1609,大亞,12,8,4,富邦-新營,2023-03-30,9693
2393,億光,5,1,4,富邦-新營,2023-03-30,9693
6182,合晶,4,0,4,富邦-新營,2023-03-30,9693
6143,振曜,8,5,3,富邦-新營,2023-03-30,9693
3029,零壹,3,0,3,富邦-新營,2023-03-30,9693
00908,富邦入息REITs+,3,0,3,富邦-新營,2023-03-30,9693
00673R,期元大S＆P原油反1,3,0,3,富邦-新營,2023-03-30,9693
2344,華邦電,12,9,3,富邦-新營,2023-03-30,9693
2402,毅嘉,6,3,3,富邦-新營,2023-03-30,9693
2428,興勤,3,0,3,富邦-新營,2023-03-30,9693
2495,普安,3,0,3,富邦-新營,2023-03-30,9693
3022,威強電,15,12,3,富邦-新營,2023-03-30,9693
9945,潤泰新,41,1,40,富邦-新營,2023-03-31,9693
6770,力積電,28,1,27,富邦-新營,2023-03-31,9693
2027,大成鋼,24,1,23,富邦-新營,2023-03-31,9693
00676R,富邦臺灣加權反1,20,0,20,富邦-新營,2023-03-31,9693
3711,日月光投控,24,5,19,富邦-新營,2023-03-31,9693
3675,德微,18,0,18,富邦-新營,2023-03-31,9693
5531,鄉林,16,0,16,富邦-新營,2023-03-31,9693
1314,中石化,17,2,15,富邦-新營,2023-03-31,9693
3027,盛達,15,0,15,富邦-新營,2023-03-31,9693
3236,千如,17,2,15,富邦-新營,2023-03-31,9693
5289,宜鼎,14,0,14,富邦-新營,2023-03-31,9693
1506,正道,13,0,13,富邦-新營,2023-03-31,9693
1605,華新,20,8,12,富邦-新營,2023-03-31,9693
2889,國票金,12,1,11,富邦-新營,2023-03-31,9693
1532,勤美,11,0,11,富邦-新營,2023-03-31,9693
2601,益航,14,3,11,富邦-新營,2023-03-31,9693
2105,正新,10,0,10,富邦-新營,2023-03-31,9693
2408,南亞科,15,5,10,富邦-新營,2023-03-31,9693
2915,潤泰全,10,0,10,富邦-新營,2023-03-31,9693
3227,原相,10,0,10,富邦-新營,2023-03-31,9693
3540,曜越,10,0,10,富邦-新營,2023-03-31,9693
6125,廣運,10,0,10,富邦-新營,2023-03-31,9693
8096,擎亞,9,0,9,富邦-新營,2023-03-31,9693
2495,普安,8,0,8,富邦-新營,2023-03-31,9693
4148,全宇生技-KY,8,0,8,富邦-新營,2023-03-31,9693
5512,力麒,7,0,7,富邦-新營,2023-03-31,9693
3037,欣興,14,7,7,富邦-新營,2023-03-31,9693
3035,智原,8,2,6,富邦-新營,2023-03-31,9693
6241,易通展,6,0,6,富邦-新營,2023-03-31,9693
1618,合機,6,0,6,富邦-新營,2023-03-31,9693
2419,仲琦,7,1,6,富邦-新營,2023-03-31,9693
3224,三顧,7,1,6,富邦-新營,2023-03-31,9693
6288,聯嘉,6,0,6,富邦-新營,2023-03-31,9693
6806,森崴能源,7,1,6,富邦-新營,2023-03-31,9693
00877,復華中國5G,5,0,5,富邦-新營,2023-03-31,9693
00852L,國泰美國道瓊正2,5,0,5,富邦-新營,2023-03-31,9693
1316,上曜,10,5,5,富邦-新營,2023-03-31,9693
1611,中電,17,12,5,富邦-新營,2023-03-31,9693
8271,宇瞻,5,0,5,富邦-新營,2023-03-31,9693
2324,仁寶,5,0,5,富邦-新營,2023-03-31,9693
00679B,元大美債20年,4,0,4,富邦-新營,2023-03-31,9693
2471,資通,4,0,4,富邦-新營,2023-03-31,9693
3260,威剛,6,2,4,富邦-新營,2023-03-31,9693
1326,台化,3,0,3,富邦-新營,2023-03-31,9693
1810,和成,3,0,3,富邦-新營,2023-03-31,9693
2388,威盛,3,0,3,富邦-新營,2023-03-31,9693
2727,王品,4,1,3,富邦-新營,2023-03-31,9693
3231,緯創,14,11,3,富邦-新營,2023-03-31,9693
3362,先進光,3,0,3,富邦-新營,2023-03-31,9693
3596,智易,3,0,3,富邦-新營,2023-03-31,9693
00673R,期元大S＆P原油反1,3330,1,3329,富邦-新營,2023-04-06,9693
00637L,元大滬深300正2,212,0,212,富邦-新營,2023-04-06,9693
00753L,中信中國50正2,90,0,90,富邦-新營,2023-04-06,9693
4157,太景*-KY,30,0,30,富邦-新營,2023-04-06,9693
00902,中信電池及儲能,28,0,28,富邦-新營,2023-04-06,9693
3056,富華新,30,3,27,富邦-新營,2023-04-06,9693
3046,建��,69,43,26,富邦-新營,2023-04-06,9693
8046,南電,29,5,24,富邦-新營,2023-04-06,9693
00882,中信中國高股息,22,0,22,富邦-新營,2023-04-06,9693
2358,廷鑫,20,0,20,富邦-新營,2023-04-06,9693
00922,國泰台灣領袖50,18,0,18,富邦-新營,2023-04-06,9693
2884,玉山金,20,3,17,富邦-新營,2023-04-06,9693
00665L,富邦�琤肭磪囓�2,15,0,15,富邦-新營,2023-04-06,9693
3322,建舜電,15,0,15,富邦-新營,2023-04-06,9693
00900,富邦特選高股息30,14,0,14,富邦-新營,2023-04-06,9693
6770,力積電,14,0,14,富邦-新營,2023-04-06,9693
1455,集盛,14,0,14,富邦-新營,2023-04-06,9693
1102,亞泥,11,0,11,富邦-新營,2023-04-06,9693
1752,南光,11,0,11,富邦-新營,2023-04-06,9693
2027,大成鋼,11,0,11,富邦-新營,2023-04-06,9693
2340,台亞,15,4,11,富邦-新營,2023-04-06,9693
3017,奇鋐,13,2,11,富邦-新營,2023-04-06,9693
8069,元太,13,2,11,富邦-新營,2023-04-06,9693
3406,玉晶光,14,4,10,富邦-新營,2023-04-06,9693
00679B,元大美債20年,12,2,10,富邦-新營,2023-04-06,9693
1506,正道,10,0,10,富邦-新營,2023-04-06,9693
3006,晶豪科,10,0,10,富邦-新營,2023-04-06,9693
3596,智易,13,3,10,富邦-新營,2023-04-06,9693
4417,金洲,10,0,10,富邦-新營,2023-04-06,9693
5608,四維航,10,0,10,富邦-新營,2023-04-06,9693
6134,萬旭,10,0,10,富邦-新營,2023-04-06,9693
4906,正文,10,0,10,富邦-新營,2023-04-06,9693
6288,聯嘉,10,1,9,富邦-新營,2023-04-06,9693
1810,和成,20,12,8,富邦-新營,2023-04-06,9693
4155,訊映,8,0,8,富邦-新營,2023-04-06,9693
6548,長科*,14,6,8,富邦-新營,2023-04-06,9693
6285,啟��,7,0,7,富邦-新營,2023-04-06,9693
1440,南紡,6,0,6,富邦-新營,2023-04-06,9693
2208,台船,107,101,6,富邦-新營,2023-04-06,9693
3032,偉訓,8,2,6,富邦-新營,2023-04-06,9693
3236,千如,6,0,6,富邦-新營,2023-04-06,9693
4702,中美實,6,0,6,富邦-新營,2023-04-06,9693
2603,長榮,7,1,6,富邦-新營,2023-04-06,9693
2317,鴻海,7,2,5,富邦-新營,2023-04-06,9693
00674R,期元大S＆P黃金反1,5,0,5,富邦-新營,2023-04-06,9693
00713,元大台灣高息低波,5,0,5,富邦-新營,2023-04-06,9693
00669R,國泰美國道瓊反1,5,0,5,富邦-新營,2023-04-06,9693
2028,威致,5,0,5,富邦-新營,2023-04-06,9693
2498,宏達電,6,1,5,富邦-新營,2023-04-06,9693
3294,英濟,5,0,5,富邦-新營,2023-04-06,9693
00632R,元大台灣50反1,110,10,100,富邦-新營,2023-04-07,9693
2609,陽明,105,20,85,富邦-新營,2023-04-07,9693
2457,飛宏,217,138,79,富邦-新營,2023-04-07,9693
00712,復華富時不動產,70,2,68,富邦-新營,2023-04-07,9693
6485,點序,51,0,51,富邦-新營,2023-04-07,9693
3056,富華新,54,7,47,富邦-新營,2023-04-07,9693
6116,彩晶,37,0,37,富邦-新營,2023-04-07,9693
2208,台船,33,0,33,富邦-新營,2023-04-07,9693
00679B,元大美債20年,27,1,26,富邦-新營,2023-04-07,9693
00885,富邦越南,23,0,23,富邦-新營,2023-04-07,9693
5289,宜鼎,21,0,21,富邦-新營,2023-04-07,9693
1219,福壽,20,0,20,富邦-新營,2023-04-07,9693
2009,第一銅,20,0,20,富邦-新營,2023-04-07,9693
3094,聯傑,20,0,20,富邦-新營,2023-04-07,9693
6548,長科*,23,4,19,富邦-新營,2023-04-07,9693
8028,昇陽半導體,20,2,18,富邦-新營,2023-04-07,9693
3025,星通,15,0,15,富邦-新營,2023-04-07,9693
1102,亞泥,14,0,14,富邦-新營,2023-04-07,9693
6443,元晶,15,1,14,富邦-新營,2023-04-07,9693
6829,千附精密,15,1,14,富邦-新營,2023-04-07,9693
00665L,富邦�琤肭磪囓�2,20,7,13,富邦-新營,2023-04-07,9693
2409,友達,13,1,12,富邦-新營,2023-04-07,9693
2349,錸德,10,0,10,富邦-新營,2023-04-07,9693
3231,緯創,17,7,10,富邦-新營,2023-04-07,9693
3362,先進光,10,0,10,富邦-新營,2023-04-07,9693
3708,上緯投控,10,0,10,富邦-新營,2023-04-07,9693
6806,森崴能源,10,0,10,富邦-新營,2023-04-07,9693
8183,精星,10,0,10,富邦-新營,2023-04-07,9693
6133,金橋,10,1,9,富邦-新營,2023-04-07,9693
2484,希華,8,0,8,富邦-新營,2023-04-07,9693
4148,全宇生技-KY,8,0,8,富邦-新營,2023-04-07,9693
8069,元太,8,2,6,富邦-新營,2023-04-07,9693
1584,精剛,9,3,6,富邦-新營,2023-04-07,9693
00673R,期元大S＆P原油反1,6,0,6,富邦-新營,2023-04-07,9693
2427,三商電,6,0,6,富邦-新營,2023-04-07,9693
2495,普安,9,3,6,富邦-新營,2023-04-07,9693
3051,力特,6,0,6,富邦-新營,2023-04-07,9693
5328,華容,6,0,6,富邦-新營,2023-04-07,9693
5512,力麒,6,0,6,富邦-新營,2023-04-07,9693
6461,益得,6,0,6,富邦-新營,2023-04-07,9693
5009,榮剛,7,2,5,富邦-新營,2023-04-07,9693
5309,系統電,6,1,5,富邦-新營,2023-04-07,9693
2539,櫻花建,5,0,5,富邦-新營,2023-04-07,9693
1455,集盛,5,0,5,富邦-新營,2023-04-07,9693
1514,亞力,5,0,5,富邦-新營,2023-04-07,9693
1524,耿鼎,5,0,5,富邦-新營,2023-04-07,9693
2345,智邦,5,0,5,富邦-新營,2023-04-07,9693
5469,瀚宇博,5,0,5,富邦-新營,2023-04-07,9693
6282,康舒,6,1,5,富邦-新營,2023-04-07,9693
2002,中鋼,5,0,5,富邦-新營,2023-04-07,9693
2027,大成鋼,107,1,106,富邦-新營,2023-04-10,9693
1227,佳格,75,0,75,富邦-新營,2023-04-10,9693
2344,華邦電,67,23,44,富邦-新營,2023-04-10,9693
00888,永豐台灣ESG,38,0,38,富邦-新營,2023-04-10,9693
00679B,元大美債20年,36,3,33,富邦-新營,2023-04-10,9693
1513,中興電,51,18,33,富邦-新營,2023-04-10,9693
8046,南電,58,35,23,富邦-新營,2023-04-10,9693
2302,麗正,33,12,21,富邦-新營,2023-04-10,9693
3504,揚明光,21,0,21,富邦-新營,2023-04-10,9693
2002,中鋼,23,4,19,富邦-新營,2023-04-10,9693
8926,台汽電,19,0,19,富邦-新營,2023-04-10,9693
2303,聯電,19,0,19,富邦-新營,2023-04-10,9693
2885,元大金,20,1,19,富邦-新營,2023-04-10,9693
2498,宏達電,19,3,16,富邦-新營,2023-04-10,9693
6285,啟��,25,10,15,富邦-新營,2023-04-10,9693
1519,華城,18,3,15,富邦-新營,2023-04-10,9693
8996,高力,15,0,15,富邦-新營,2023-04-10,9693
6770,力積電,14,0,14,富邦-新營,2023-04-10,9693
6753,龍德造船,13,0,13,富邦-新營,2023-04-10,9693
1717,長興,12,0,12,富邦-新營,2023-04-10,9693
4148,全宇生技-KY,12,0,12,富邦-新營,2023-04-10,9693
9955,佳龍,13,1,12,富邦-新營,2023-04-10,9693
9945,潤泰新,11,0,11,富邦-新營,2023-04-10,9693
1609,大亞,15,4,11,富邦-新營,2023-04-10,9693
2342,茂矽,11,0,11,富邦-新營,2023-04-10,9693
3162,精確,12,1,11,富邦-新營,2023-04-10,9693
3056,富華新,10,0,10,富邦-新營,2023-04-10,9693
00642U,期元大S＆P石油,10,0,10,富邦-新營,2023-04-10,9693
6160,欣技,11,1,10,富邦-新營,2023-04-10,9693
6277,宏正,10,0,10,富邦-新營,2023-04-10,9693
9105,泰金寶-DR,10,0,10,富邦-新營,2023-04-10,9693
6829,千附精密,20,10,10,富邦-新營,2023-04-10,9693
2323,中環,10,0,10,富邦-新營,2023-04-10,9693
00632R,元大台灣50反1,9,0,9,富邦-新營,2023-04-10,9693
1437,勤益控,10,1,9,富邦-新營,2023-04-10,9693
2449,京元電子,10,1,9,富邦-新營,2023-04-10,9693
2615,萬海,10,1,9,富邦-新營,2023-04-10,9693
6561,是方,9,0,9,富邦-新營,2023-04-10,9693
1506,正道,8,0,8,富邦-新營,2023-04-10,9693
4129,聯合,8,0,8,富邦-新營,2023-04-10,9693
6461,益得,13,5,8,富邦-新營,2023-04-10,9693
2601,益航,10,3,7,富邦-新營,2023-04-10,9693
1319,東陽,7,0,7,富邦-新營,2023-04-10,9693
2359,所羅門,7,0,7,富邦-新營,2023-04-10,9693
3078,僑威,9,2,7,富邦-新營,2023-04-10,9693
6104,創惟,7,0,7,富邦-新營,2023-04-10,9693
4114,健喬,9,3,6,富邦-新營,2023-04-10,9693
4417,金洲,6,0,6,富邦-新營,2023-04-10,9693
1417,嘉裕,5,0,5,富邦-新營,2023-04-10,9693
2388,威盛,8,3,5,富邦-新營,2023-04-10,9693
2027,大成鋼,216,0,216,富邦-新營,2023-04-11,9693
00712,復華富時不動產,33,0,33,富邦-新營,2023-04-11,9693
6806,森崴能源,53,20,33,富邦-新營,2023-04-11,9693
2492,華新科,30,1,29,富邦-新營,2023-04-11,9693
2634,漢翔,46,19,27,富邦-新營,2023-04-11,9693
2303,聯電,26,0,26,富邦-新營,2023-04-11,9693
6125,廣運,25,0,25,富邦-新營,2023-04-11,9693
6770,力積電,28,3,25,富邦-新營,2023-04-11,9693
1504,東元,53,31,22,富邦-新營,2023-04-11,9693
2457,飛宏,32,10,22,富邦-新營,2023-04-11,9693
6194,育富,21,0,21,富邦-新營,2023-04-11,9693
2601,益航,20,0,20,富邦-新營,2023-04-11,9693
4961,天鈺,23,3,20,富邦-新營,2023-04-11,9693
6285,啟��,20,4,16,富邦-新營,2023-04-11,9693
3708,上緯投控,16,1,15,富邦-新營,2023-04-11,9693
9951,皇田,15,0,15,富邦-新營,2023-04-11,9693
4927,泰鼎-KY,14,0,14,富邦-新營,2023-04-11,9693
1605,華新,13,1,12,富邦-新營,2023-04-11,9693
00679B,元大美債20年,11,0,11,富邦-新營,2023-04-11,9693
00680L,元大美債20正2,11,0,11,富邦-新營,2023-04-11,9693
2356,英業達,11,0,11,富邦-新營,2023-04-11,9693
6591,動力-KY,11,0,11,富邦-新營,2023-04-11,9693
00673R,期元大S＆P原油反1,10,0,10,富邦-新營,2023-04-11,9693
1314,中石化,10,0,10,富邦-新營,2023-04-11,9693
1506,正道,10,0,10,富邦-新營,2023-04-11,9693
1708,東鹼,10,0,10,富邦-新營,2023-04-11,9693
1717,長興,10,0,10,富邦-新營,2023-04-11,9693
2436,偉詮電,10,0,10,富邦-新營,2023-04-11,9693
5471,松翰,10,0,10,富邦-新營,2023-04-11,9693
5608,四維航,10,0,10,富邦-新營,2023-04-11,9693
6133,金橋,10,0,10,富邦-新營,2023-04-11,9693
6160,欣技,11,1,10,富邦-新營,2023-04-11,9693
6443,元晶,10,0,10,富邦-新營,2023-04-11,9693
4541,晟田,10,1,9,富邦-新營,2023-04-11,9693
6163,華電網,39,30,9,富邦-新營,2023-04-11,9693
00751B,元大AAA至A公司債,8,0,8,富邦-新營,2023-04-11,9693
1437,勤益控,8,0,8,富邦-新營,2023-04-11,9693
1608,華榮,8,0,8,富邦-新營,2023-04-11,9693
3441,聯一光,8,0,8,富邦-新營,2023-04-11,9693
8033,雷虎,10,2,8,富邦-新營,2023-04-11,9693
6235,華孚,77,69,8,富邦-新營,2023-04-11,9693
4109,加捷生醫,7,0,7,富邦-新營,2023-04-11,9693
6244,茂迪,8,1,7,富邦-新營,2023-04-11,9693
8234,新漢,7,0,7,富邦-新營,2023-04-11,9693
00772B,中信高評級公司債,6,0,6,富邦-新營,2023-04-11,9693
8050,廣積,8,2,6,富邦-新營,2023-04-11,9693
1409,新纖,6,0,6,富邦-新營,2023-04-11,9693
1444,力麗,6,0,6,富邦-新營,2023-04-11,9693
2201,裕隆,7,1,6,富邦-新營,2023-04-11,9693
5905,南仁湖,6,0,6,富邦-新營,2023-04-11,9693
00637L,元大滬深300正2,160,0,160,富邦-新營,2023-04-12,9693
9945,潤泰新,130,0,130,富邦-新營,2023-04-12,9693
3006,晶豪科,63,2,61,富邦-新營,2023-04-12,9693
00632R,元大台灣50反1,53,1,52,富邦-新營,2023-04-12,9693
2601,益航,50,2,48,富邦-新營,2023-04-12,9693
00712,復華富時不動產,45,0,45,富邦-新營,2023-04-12,9693
2834,臺企銀,33,1,32,富邦-新營,2023-04-12,9693
2838,聯邦銀,30,0,30,富邦-新營,2023-04-12,9693
6248,沛波,32,6,26,富邦-新營,2023-04-12,9693
8046,南電,47,23,24,富邦-新營,2023-04-12,9693
00878,國泰永續高股息,27,6,21,富邦-新營,2023-04-12,9693
1229,聯華,20,0,20,富邦-新營,2023-04-12,9693
1524,耿鼎,20,0,20,富邦-新營,2023-04-12,9693
2887,台新金,20,0,20,富邦-新營,2023-04-12,9693
3056,富華新,22,2,20,富邦-新營,2023-04-12,9693
2883,凱基金,25,6,19,富邦-新營,2023-04-12,9693
1513,中興電,44,26,18,富邦-新營,2023-04-12,9693
6591,動力-KY,19,1,18,富邦-新營,2023-04-12,9693
5425,台半,27,11,16,富邦-新營,2023-04-12,9693
6188,廣明,17,1,16,富邦-新營,2023-04-12,9693
3027,盛達,19,4,15,富邦-新營,2023-04-12,9693
1618,合機,13,0,13,富邦-新營,2023-04-12,9693
2349,錸德,15,2,13,富邦-新營,2023-04-12,9693
4153,鈺緯,23,10,13,富邦-新營,2023-04-12,9693
2303,聯電,13,0,13,富邦-新營,2023-04-12,9693
3430,奇鈦科,12,0,12,富邦-新營,2023-04-12,9693
4927,泰鼎-KY,13,1,12,富邦-新營,2023-04-12,9693
6461,益得,14,2,12,富邦-新營,2023-04-12,9693
8038,長園科,12,0,12,富邦-新營,2023-04-12,9693
00673R,期元大S＆P原油反1,11,0,11,富邦-新營,2023-04-12,9693
2208,台船,25,14,11,富邦-新營,2023-04-12,9693
1506,正道,10,0,10,富邦-新營,2023-04-12,9693
1608,華榮,40,30,10,富邦-新營,2023-04-12,9693
2201,裕隆,10,0,10,富邦-新營,2023-04-12,9693
2356,英業達,10,0,10,富邦-新營,2023-04-12,9693
3432,台端,10,0,10,富邦-新營,2023-04-12,9693
3059,華晶科,10,0,10,富邦-新營,2023-04-12,9693
2330,台積電,10,1,9,富邦-新營,2023-04-12,9693
1326,台化,9,0,9,富邦-新營,2023-04-12,9693
2427,三商電,10,1,9,富邦-新營,2023-04-12,9693
6578,達邦蛋白,10,1,9,富邦-新營,2023-04-12,9693
2317,鴻海,10,1,9,富邦-新營,2023-04-12,9693
1108,幸福,10,2,8,富邦-新營,2023-04-12,9693
2301,光寶科,8,0,8,富邦-新營,2023-04-12,9693
5439,高技,8,0,8,富邦-新營,2023-04-12,9693
1101,台泥,9,1,8,富邦-新營,2023-04-12,9693
1219,福壽,7,0,7,富邦-新營,2023-04-12,9693
00902,中信電池及儲能,7,0,7,富邦-新營,2023-04-12,9693
3162,精確,8,1,7,富邦-新營,2023-04-12,9693
2457,飛宏,10,3,7,富邦-新營,2023-04-12,9693
00712,復華富時不動產,228,0,228,富邦-新營,2023-04-13,9693
1314,中石化,42,0,42,富邦-新營,2023-04-13,9693
2402,毅嘉,40,4,36,富邦-新營,2023-04-13,9693
2427,三商電,32,0,32,富邦-新營,2023-04-13,9693
3711,日月光投控,32,0,32,富邦-新營,2023-04-13,9693
6163,華電網,34,2,32,富邦-新營,2023-04-13,9693
4746,台耀,28,0,28,富邦-新營,2023-04-13,9693
2887,台新金,30,3,27,富邦-新營,2023-04-13,9693
2634,漢翔,61,38,23,富邦-新營,2023-04-13,9693
1218,泰山,20,0,20,富邦-新營,2023-04-13,9693
00772B,中信高評級公司債,18,0,18,富邦-新營,2023-04-13,9693
2495,普安,22,4,18,富邦-新營,2023-04-13,9693
6209,今國光,18,0,18,富邦-新營,2023-04-13,9693
1503,士電,20,2,18,富邦-新營,2023-04-13,9693
3006,晶豪科,16,0,16,富邦-新營,2023-04-13,9693
1618,合機,16,0,16,富邦-新營,2023-04-13,9693
6443,元晶,16,0,16,富邦-新營,2023-04-13,9693
5353,台林,14,0,14,富邦-新營,2023-04-13,9693
2344,華邦電,18,5,13,富邦-新營,2023-04-13,9693
00679B,元大美債20年,12,0,12,富邦-新營,2023-04-13,9693
3037,欣興,12,0,12,富邦-新營,2023-04-13,9693
8033,雷虎,12,0,12,富邦-新營,2023-04-13,9693
1504,東元,91,80,11,富邦-新營,2023-04-13,9693
1708,東鹼,11,0,11,富邦-新營,2023-04-13,9693
2329,華泰,14,3,11,富邦-新營,2023-04-13,9693
3363,上詮,12,1,11,富邦-新營,2023-04-13,9693
4164,承業醫,14,3,11,富邦-新營,2023-04-13,9693
6116,彩晶,16,5,11,富邦-新營,2023-04-13,9693
00753L,中信中國50正2,10,0,10,富邦-新營,2023-04-13,9693
00637L,元大滬深300正2,10,0,10,富邦-新營,2023-04-13,9693
1455,集盛,10,0,10,富邦-新營,2023-04-13,9693
2481,強茂,10,0,10,富邦-新營,2023-04-13,9693
2002,中鋼,10,0,10,富邦-新營,2023-04-13,9693
2441,超豐,10,0,10,富邦-新營,2023-04-13,9693
00882,中信中國高股息,11,2,9,富邦-新營,2023-04-13,9693
1605,華新,17,8,9,富邦-新營,2023-04-13,9693
4927,泰鼎-KY,9,0,9,富邦-新營,2023-04-13,9693
2236,百達-KY,8,0,8,富邦-新營,2023-04-13,9693
3231,緯創,8,1,7,富邦-新營,2023-04-13,9693
6244,茂迪,8,1,7,富邦-新營,2023-04-13,9693
6248,沛波,10,3,7,富邦-新營,2023-04-13,9693
2388,威盛,6,0,6,富邦-新營,2023-04-13,9693
2617,台航,6,0,6,富邦-新營,2023-04-13,9693
3576,聯合再生,30,24,6,富邦-新營,2023-04-13,9693
4977,眾達-KY,5,0,5,富邦-新營,2023-04-13,9693
006208,富邦台50,5,0,5,富邦-新營,2023-04-13,9693
2206,三陽工業,5,0,5,富邦-新營,2023-04-13,9693
1316,上曜,5,0,5,富邦-新營,2023-04-13,9693
1904,正隆,6,1,5,富邦-新營,2023-04-13,9693
2049,上銀,5,0,5,富邦-新營,2023-04-13,9693
00712,復華富時不動產,122,0,122,富邦-新營,2023-04-14,9693
2634,漢翔,112,50,62,富邦-新營,2023-04-14,9693
00632R,元大台灣50反1,53,0,53,富邦-新營,2023-04-14,9693
1216,統一,37,0,37,富邦-新營,2023-04-14,9693
8046,南電,51,19,32,富邦-新營,2023-04-14,9693
00637L,元大滬深300正2,30,0,30,富邦-新營,2023-04-14,9693
4168,醣聯,30,0,30,富邦-新營,2023-04-14,9693
6753,龍德造船,30,3,27,富邦-新營,2023-04-14,9693
00772B,中信高評級公司債,26,0,26,富邦-新營,2023-04-14,9693
2208,台船,73,47,26,富邦-新營,2023-04-14,9693
8163,達方,21,0,21,富邦-新營,2023-04-14,9693
2883B,凱基金乙特,20,0,20,富邦-新營,2023-04-14,9693
1514,亞力,21,2,19,富邦-新營,2023-04-14,9693
1524,耿鼎,18,0,18,富邦-新營,2023-04-14,9693
2515,中工,128,111,17,富邦-新營,2023-04-14,9693
6796,晉弘,16,0,16,富邦-新營,2023-04-14,9693
1504,東元,43,27,16,富邦-新營,2023-04-14,9693
2358,廷鑫,14,0,14,富邦-新營,2023-04-14,9693
00679B,元大美債20年,13,0,13,富邦-新營,2023-04-14,9693
0056,元大高股息,13,0,13,富邦-新營,2023-04-14,9693
00680L,元大美債20正2,12,0,12,富邦-新營,2023-04-14,9693
1506,正道,11,0,11,富邦-新營,2023-04-14,9693
2312,金寶,11,0,11,富邦-新營,2023-04-14,9693
3587,閎康,13,2,11,富邦-新營,2023-04-14,9693
4953,緯軟,11,0,11,富邦-新營,2023-04-14,9693
6770,力積電,13,2,11,富邦-新營,2023-04-14,9693
3481,群創,30,19,11,富邦-新營,2023-04-14,9693
5388,中磊,10,0,10,富邦-新營,2023-04-14,9693
8069,元太,13,3,10,富邦-新營,2023-04-14,9693
1815,富喬,10,0,10,富邦-新營,2023-04-14,9693
3025,星通,10,0,10,富邦-新營,2023-04-14,9693
3052,夆典,10,0,10,富邦-新營,2023-04-14,9693
6284,佳邦,10,0,10,富邦-新營,2023-04-14,9693
8234,新漢,10,0,10,富邦-新營,2023-04-14,9693
8931,大汽電,10,0,10,富邦-新營,2023-04-14,9693
8383,千附,11,2,9,富邦-新營,2023-04-14,9693
5701,劍湖山,10,1,9,富邦-新營,2023-04-14,9693
2002,中鋼,10,1,9,富邦-新營,2023-04-14,9693
2883,凱基金,19,10,9,富邦-新營,2023-04-14,9693
3661,世芯-KY,14,5,9,富邦-新營,2023-04-14,9693
6167,久正,9,0,9,富邦-新營,2023-04-14,9693
2329,華泰,8,0,8,富邦-新營,2023-04-14,9693
3362,先進光,10,2,8,富邦-新營,2023-04-14,9693
6266,泰詠,8,0,8,富邦-新營,2023-04-14,9693
6461,益得,8,0,8,富邦-新營,2023-04-14,9693
6776,展�眥篕�,9,1,8,富邦-新營,2023-04-14,9693
6829,千附精密,9,1,8,富邦-新營,2023-04-14,9693
00720B,元大投資級公司債,7,0,7,富邦-新營,2023-04-14,9693
2492,華新科,7,0,7,富邦-新營,2023-04-14,9693
6182,合晶,7,0,7,富邦-新營,2023-04-14,9693
00712,復華富時不動產,136,0,136,富邦-新營,2023-04-17,9693
8033,雷虎,107,33,74,富邦-新營,2023-04-17,9693
00673R,期元大S＆P原油反1,56,0,56,富邦-新營,2023-04-17,9693
3322,建舜電,50,0,50,富邦-新營,2023-04-17,9693
2634,漢翔,193,149,44,富邦-新營,2023-04-17,9693
4541,晟田,49,16,33,富邦-新營,2023-04-17,9693
00680L,元大美債20正2,30,0,30,富邦-新營,2023-04-17,9693
4967,十銓,45,15,30,富邦-新營,2023-04-17,9693
5521,工信,30,0,30,富邦-新營,2023-04-17,9693
8222,寶一,50,22,28,富邦-新營,2023-04-17,9693
2208,台船,213,186,27,富邦-新營,2023-04-17,9693
6163,華電網,31,4,27,富邦-新營,2023-04-17,9693
1312,國喬,24,1,23,富邦-新營,2023-04-17,9693
1905,華紙,20,0,20,富邦-新營,2023-04-17,9693
1618,合機,18,0,18,富邦-新營,2023-04-17,9693
2201,裕隆,41,24,17,富邦-新營,2023-04-17,9693
1101,台泥,21,4,17,富邦-新營,2023-04-17,9693
3025,星通,16,0,16,富邦-新營,2023-04-17,9693
8104,錸寶,16,0,16,富邦-新營,2023-04-17,9693
3058,立德,20,5,15,富邦-新營,2023-04-17,9693
8097,常珵,15,0,15,富邦-新營,2023-04-17,9693
8046,南電,23,10,13,富邦-新營,2023-04-17,9693
00878,國泰永續高股息,23,10,13,富邦-新營,2023-04-17,9693
2206,三陽工業,76,63,13,富邦-新營,2023-04-17,9693
3481,群創,17,4,13,富邦-新營,2023-04-17,9693
00912,中信臺灣智慧50,13,0,13,富邦-新營,2023-04-17,9693
6140,訊達,12,0,12,富邦-新營,2023-04-17,9693
6179,亞通,12,0,12,富邦-新營,2023-04-17,9693
2891,中信金,12,1,11,富邦-新營,2023-04-17,9693
7402,邑錡,12,1,11,富邦-新營,2023-04-17,9693
1310,台苯,10,0,10,富邦-新營,2023-04-17,9693
1718,中纖,10,0,10,富邦-新營,2023-04-17,9693
1733,五鼎,10,0,10,富邦-新營,2023-04-17,9693
2888,新光金,11,1,10,富邦-新營,2023-04-17,9693
4513,福裕,10,0,10,富邦-新營,2023-04-17,9693
4973,廣穎,10,0,10,富邦-新營,2023-04-17,9693
6112,邁達特,10,0,10,富邦-新營,2023-04-17,9693
6133,金橋,10,0,10,富邦-新營,2023-04-17,9693
6153,嘉聯益,10,0,10,富邦-新營,2023-04-17,9693
8110,華東,10,0,10,富邦-新營,2023-04-17,9693
8271,宇瞻,10,0,10,富邦-新營,2023-04-17,9693
6263,普萊德,9,0,9,富邦-新營,2023-04-17,9693
1309,台達化,9,0,9,富邦-新營,2023-04-17,9693
3028,增你強,10,1,9,富邦-新營,2023-04-17,9693
3715,定穎投控,13,4,9,富邦-新營,2023-04-17,9693
6751,智聯服務,9,0,9,富邦-新營,2023-04-17,9693
6443,元晶,11,3,8,富邦-新營,2023-04-17,9693
00922,國泰台灣領袖50,8,0,8,富邦-新營,2023-04-17,9693
2359,所羅門,24,16,8,富邦-新營,2023-04-17,9693
2886,兆豐金,8,0,8,富邦-新營,2023-04-17,9693
8155,博智,101,1,100,富邦-新營,2023-04-18,9693
00680L,元大美債20正2,97,0,97,富邦-新營,2023-04-18,9693
00679B,元大美債20年,47,0,47,富邦-新營,2023-04-18,9693
6134,萬旭,40,0,40,富邦-新營,2023-04-18,9693
00712,復華富時不動產,42,6,36,富邦-新營,2023-04-18,9693
00753L,中信中國50正2,38,5,33,富邦-新營,2023-04-18,9693
8033,雷虎,164,140,24,富邦-新營,2023-04-18,9693
1528,恩德,23,0,23,富邦-新營,2023-04-18,9693
3025,星通,44,22,22,富邦-新營,2023-04-18,9693
3322,建舜電,20,0,20,富邦-新營,2023-04-18,9693
4157,太景*-KY,20,0,20,富邦-新營,2023-04-18,9693
00878,國泰永續高股息,20,1,19,富邦-新營,2023-04-18,9693
2313,華通,28,11,17,富邦-新營,2023-04-18,9693
8105,凌巨,21,5,16,富邦-新營,2023-04-18,9693
6244,茂迪,23,7,16,富邦-新營,2023-04-18,9693
4207,環泰,15,0,15,富邦-新營,2023-04-18,9693
5009,榮剛,25,10,15,富邦-新營,2023-04-18,9693
2457,飛宏,140,126,14,富邦-新營,2023-04-18,9693
2208,台船,26,13,13,富邦-新營,2023-04-18,9693
5512,力麒,13,0,13,富邦-新營,2023-04-18,9693
1504,東元,40,28,12,富邦-新營,2023-04-18,9693
1506,正道,12,0,12,富邦-新營,2023-04-18,9693
2356,英業達,12,0,12,富邦-新營,2023-04-18,9693
8104,錸寶,12,0,12,富邦-新營,2023-04-18,9693
9962,有益,12,0,12,富邦-新營,2023-04-18,9693
3056,富華新,11,0,11,富邦-新營,2023-04-18,9693
3231,緯創,11,0,11,富邦-新營,2023-04-18,9693
6182,合晶,11,0,11,富邦-新營,2023-04-18,9693
1584,精剛,38,28,10,富邦-新營,2023-04-18,9693
1437,勤益控,12,2,10,富邦-新營,2023-04-18,9693
2427,三商電,13,3,10,富邦-新營,2023-04-18,9693
3028,增你強,10,0,10,富邦-新營,2023-04-18,9693
6160,欣技,10,0,10,富邦-新營,2023-04-18,9693
6190,萬泰科,16,6,10,富邦-新營,2023-04-18,9693
1608,華榮,12,3,9,富邦-新營,2023-04-18,9693
2482,連宇,9,0,9,富邦-新營,2023-04-18,9693
3715,定穎投控,30,21,9,富邦-新營,2023-04-18,9693
4541,晟田,11,3,8,富邦-新營,2023-04-18,9693
00923,群益台ESG低碳50,8,0,8,富邦-新營,2023-04-18,9693
2471,資通,9,1,8,富邦-新營,2023-04-18,9693
4927,泰鼎-KY,8,0,8,富邦-新營,2023-04-18,9693
6140,訊達,8,0,8,富邦-新營,2023-04-18,9693
00772B,中信高評級公司債,8,0,8,富邦-新營,2023-04-18,9693
00720B,元大投資級公司債,7,0,7,富邦-新營,2023-04-18,9693
00688L,國泰20年美債正2,7,0,7,富邦-新營,2023-04-18,9693
1432,大魯閣,7,0,7,富邦-新營,2023-04-18,9693
2105,正新,7,0,7,富邦-新營,2023-04-18,9693
4109,加捷生醫,7,0,7,富邦-新營,2023-04-18,9693
6148,驊宏資,7,0,7,富邦-新營,2023-04-18,9693
6715,嘉基,7,0,7,富邦-新營,2023-04-18,9693
00637L,元大滬深300正2,188,0,188,富邦-新營,2023-04-19,9693
1810,和成,37,3,34,富邦-新營,2023-04-19,9693
00878,國泰永續高股息,42,8,34,富邦-新營,2023-04-19,9693
6167,久正,38,5,33,富邦-新營,2023-04-19,9693
4157,太景*-KY,30,1,29,富邦-新營,2023-04-19,9693
1314,中石化,30,2,28,富邦-新營,2023-04-19,9693
2337,旺宏,30,2,28,富邦-新營,2023-04-19,9693
3013,晟銘電,24,0,24,富邦-新營,2023-04-19,9693
00712,復華富時不動產,24,0,24,富邦-新營,2023-04-19,9693
3576,聯合再生,241,218,23,富邦-新營,2023-04-19,9693
2515,中工,22,1,21,富邦-新營,2023-04-19,9693
2883B,凱基金乙特,20,0,20,富邦-新營,2023-04-19,9693
3025,星通,20,0,20,富邦-新營,2023-04-19,9693
4707,磐亞,17,0,17,富邦-新營,2023-04-19,9693
3037,欣興,18,2,16,富邦-新營,2023-04-19,9693
2303,聯電,16,2,14,富邦-新營,2023-04-19,9693
2201,裕隆,46,33,13,富邦-新營,2023-04-19,9693
0056,元大高股息,13,0,13,富邦-新營,2023-04-19,9693
2409,友達,15,2,13,富邦-新營,2023-04-19,9693
5371,中光電,13,0,13,富邦-新營,2023-04-19,9693
00888,永豐台灣ESG,13,0,13,富邦-新營,2023-04-19,9693
00892,富邦台灣半導體,12,0,12,富邦-新營,2023-04-19,9693
2495,普安,13,1,12,富邦-新營,2023-04-19,9693
5243,乙盛-KY,18,6,12,富邦-新營,2023-04-19,9693
00679B,元大美債20年,11,0,11,富邦-新營,2023-04-19,9693
1809,中釉,11,0,11,富邦-新營,2023-04-19,9693
6829,千附精密,24,13,11,富邦-新營,2023-04-19,9693
2886,兆豐金,11,0,11,富邦-新營,2023-04-19,9693
3481,群創,56,46,10,富邦-新營,2023-04-19,9693
1417,嘉裕,10,0,10,富邦-新營,2023-04-19,9693
2369,菱生,10,0,10,富邦-新營,2023-04-19,9693
5512,力麒,10,0,10,富邦-新營,2023-04-19,9693
6125,廣運,10,0,10,富邦-新營,2023-04-19,9693
3466,德晉,10,0,10,富邦-新營,2023-04-19,9693
2406,國碩,12,3,9,富邦-新營,2023-04-19,9693
00923,群益台ESG低碳50,10,1,9,富邦-新營,2023-04-19,9693
2855,統一證,9,0,9,富邦-新營,2023-04-19,9693
4116,明基醫,9,0,9,富邦-新營,2023-04-19,9693
6770,力積電,13,5,8,富邦-新營,2023-04-19,9693
6245,立端,8,0,8,富邦-新營,2023-04-19,9693
00895,富邦未來車,10,2,8,富邦-新營,2023-04-19,9693
2329,華泰,8,0,8,富邦-新營,2023-04-19,9693
6751,智聯服務,14,6,8,富邦-新營,2023-04-19,9693
00696B,富邦美債20年,7,0,7,富邦-新營,2023-04-19,9693
2328,廣宇,8,1,7,富邦-新營,2023-04-19,9693
2634,漢翔,14,7,7,富邦-新營,2023-04-19,9693
3652,精聯,7,0,7,富邦-新營,2023-04-19,9693
4953,緯軟,19,12,7,富邦-新營,2023-04-19,9693
6509,聚和,9,2,7,富邦-新營,2023-04-19,9693
00919,群益台灣精選高息,10,4,6,富邦-新營,2023-04-19,9693
1710,東聯,65,15,50,富邦-新營,2023-04-20,9693
6841,長佳智能,44,0,44,富邦-新營,2023-04-20,9693
00632R,元大台灣50反1,40,7,33,富邦-新營,2023-04-20,9693
4127,天良,31,0,31,富邦-新營,2023-04-20,9693
2342,茂矽,33,3,30,富邦-新營,2023-04-20,9693
00720B,元大投資級公司債,29,0,29,富邦-新營,2023-04-20,9693
1905,華紙,30,3,27,富邦-新營,2023-04-20,9693
00713,元大台灣高息低波,24,0,24,富邦-新營,2023-04-20,9693
6235,華孚,31,7,24,富邦-新營,2023-04-20,9693
4707,磐亞,23,0,23,富邦-新營,2023-04-20,9693
4162,智擎,31,9,22,富邦-新營,2023-04-20,9693
2359,所羅門,19,0,19,富邦-新營,2023-04-20,9693
6443,元晶,21,2,19,富邦-新營,2023-04-20,9693
3234,光環,16,0,16,富邦-新營,2023-04-20,9693
2324,仁寶,15,0,15,富邦-新營,2023-04-20,9693
2634,漢翔,17,3,14,富邦-新營,2023-04-20,9693
2498,宏達電,16,2,14,富邦-新營,2023-04-20,9693
00878,國泰永續高股息,20,7,13,富邦-新營,2023-04-20,9693
1513,中興電,14,1,13,富邦-新營,2023-04-20,9693
6770,力積電,12,0,12,富邦-新營,2023-04-20,9693
1529,樂事綠能,14,2,12,富邦-新營,2023-04-20,9693
2313,華通,12,1,11,富邦-新營,2023-04-20,9693
1417,嘉裕,11,0,11,富邦-新營,2023-04-20,9693
6796,晉弘,13,2,11,富邦-新營,2023-04-20,9693
2002,中鋼,12,1,11,富邦-新營,2023-04-20,9693
3289,宜特,10,0,10,富邦-新營,2023-04-20,9693
2020,美亞,10,0,10,富邦-新營,2023-04-20,9693
2883B,凱基金乙特,10,0,10,富邦-新營,2023-04-20,9693
3206,志豐,10,0,10,富邦-新營,2023-04-20,9693
3705,永信,10,0,10,富邦-新營,2023-04-20,9693
4979,華星光,13,3,10,富邦-新營,2023-04-20,9693
8097,常珵,10,0,10,富邦-新營,2023-04-20,9693
1309,台達化,9,0,9,富邦-新營,2023-04-20,9693
1718,中纖,9,0,9,富邦-新營,2023-04-20,9693
4934,太極,10,1,9,富邦-新營,2023-04-20,9693
6282,康舒,48,39,9,富邦-新營,2023-04-20,9693
4114,健喬,12,4,8,富邦-新營,2023-04-20,9693
6290,良維,8,0,8,富邦-新營,2023-04-20,9693
00885,富邦越南,8,0,8,富邦-新營,2023-04-20,9693
3025,星通,10,2,8,富邦-新營,2023-04-20,9693
4541,晟田,10,2,8,富邦-新營,2023-04-20,9693
6285,啟��,9,1,8,富邦-新營,2023-04-20,9693
6865,偉康科技,8,0,8,富邦-新營,2023-04-20,9693
8111,立��,11,3,8,富邦-新營,2023-04-20,9693
00892,富邦台灣半導體,7,0,7,富邦-新營,2023-04-20,9693
2402,毅嘉,11,4,7,富邦-新營,2023-04-20,9693
3363,上詮,7,0,7,富邦-新營,2023-04-20,9693
4102,永日,10,3,7,富邦-新營,2023-04-20,9693
6109,亞元,7,0,7,富邦-新營,2023-04-20,9693
6461,益得,7,0,7,富邦-新營,2023-04-20,9693
00637L,元大滬深300正2,110,0,110,富邦-新營,2023-04-21,9693
2328,廣宇,101,0,101,富邦-新營,2023-04-21,9693
2883B,凱基金乙特,50,0,50,富邦-新營,2023-04-21,9693
2312,金寶,50,1,49,富邦-新營,2023-04-21,9693
1506,正道,46,0,46,富邦-新營,2023-04-21,9693
5351,鈺創,43,2,41,富邦-新營,2023-04-21,9693
5609,中菲行,34,0,34,富邦-新營,2023-04-21,9693
1609,大亞,34,1,33,富邦-新營,2023-04-21,9693
2034,允強,31,0,31,富邦-新營,2023-04-21,9693
2017,官田鋼,30,0,30,富邦-新營,2023-04-21,9693
3033,威健,26,0,26,富邦-新營,2023-04-21,9693
00878,國泰永續高股息,25,1,24,富邦-新營,2023-04-21,9693
6477,安集,22,2,20,富邦-新營,2023-04-21,9693
2891,中信金,21,2,19,富邦-新營,2023-04-21,9693
6163,華電網,21,2,19,富邦-新營,2023-04-21,9693
1319,東陽,17,1,16,富邦-新營,2023-04-21,9693
2427,三商電,16,0,16,富邦-新營,2023-04-21,9693
2913,農林,31,17,14,富邦-新營,2023-04-21,9693
2884,玉山金,13,0,13,富邦-新營,2023-04-21,9693
3025,星通,14,1,13,富邦-新營,2023-04-21,9693
2208,台船,21,9,12,富邦-新營,2023-04-21,9693
2329,華泰,12,0,12,富邦-新營,2023-04-21,9693
2609,陽明,11,0,11,富邦-新營,2023-04-21,9693
00892,富邦台灣半導體,11,0,11,富邦-新營,2023-04-21,9693
6182,合晶,10,0,10,富邦-新營,2023-04-21,9693
1101,台泥,30,20,10,富邦-新營,2023-04-21,9693
1218,泰山,10,0,10,富邦-新營,2023-04-21,9693
1310,台苯,11,1,10,富邦-新營,2023-04-21,9693
2419,仲琦,11,1,10,富邦-新營,2023-04-21,9693
3363,上詮,10,0,10,富邦-新營,2023-04-21,9693
6443,元晶,11,1,10,富邦-新營,2023-04-21,9693
8215,明基材,10,0,10,富邦-新營,2023-04-21,9693
1904,正隆,13,3,10,富邦-新營,2023-04-21,9693
2303,聯電,12,3,9,富邦-新營,2023-04-21,9693
2359,所羅門,9,0,9,富邦-新營,2023-04-21,9693
6796,晉弘,9,0,9,富邦-新營,2023-04-21,9693
00900,富邦特選高股息30,9,0,9,富邦-新營,2023-04-21,9693
0056,元大高股息,8,0,8,富邦-新營,2023-04-21,9693
00923,群益台ESG低碳50,8,0,8,富邦-新營,2023-04-21,9693
1718,中纖,18,10,8,富邦-新營,2023-04-21,9693
1906,寶隆,8,0,8,富邦-新營,2023-04-21,9693
3294,英濟,12,4,8,富邦-新營,2023-04-21,9693
3715,定穎投控,10,2,8,富邦-新營,2023-04-21,9693
6153,嘉聯益,10,2,8,富邦-新營,2023-04-21,9693
00902,中信電池及儲能,7,0,7,富邦-新營,2023-04-21,9693
1437,勤益控,7,0,7,富邦-新營,2023-04-21,9693
2618,長榮航,12,5,7,富邦-新營,2023-04-21,9693
4510,高鋒,9,2,7,富邦-新營,2023-04-21,9693
6456,GIS-KY,7,0,7,富邦-新營,2023-04-21,9693
00891,中信關鍵半導體,7,0,7,富邦-新營,2023-04-21,9693
00632R,元大台灣50反1,271,40,231,富邦-新營,2023-04-24,9693
2485,兆赫,83,0,83,富邦-新營,2023-04-24,9693
6116,彩晶,55,0,55,富邦-新營,2023-04-24,9693
2883B,凱基金乙特,38,0,38,富邦-新營,2023-04-24,9693
6770,力積電,33,0,33,富邦-新營,2023-04-24,9693
00637L,元大滬深300正2,119,97,22,富邦-新營,2023-04-24,9693
00902,中信電池及儲能,20,0,20,富邦-新營,2023-04-24,9693
3576,聯合再生,21,2,19,富邦-新營,2023-04-24,9693
1304,台聚,15,0,15,富邦-新營,2023-04-24,9693
1101,台泥,33,21,12,富邦-新營,2023-04-24,9693
5355,佳總,12,0,12,富邦-新營,2023-04-24,9693
2031,新光鋼,11,0,11,富邦-新營,2023-04-24,9693
3006,晶豪科,11,0,11,富邦-新營,2023-04-24,9693
2331,精英,10,0,10,富邦-新營,2023-04-24,9693
3518,柏騰,10,0,10,富邦-新營,2023-04-24,9693
3673,TPK-KY,10,0,10,富邦-新營,2023-04-24,9693
4953,緯軟,10,0,10,富邦-新營,2023-04-24,9693
5425,台半,10,0,10,富邦-新營,2023-04-24,9693
5608,四維航,10,0,10,富邦-新營,2023-04-24,9693
3231,緯創,17,8,9,富邦-新營,2023-04-24,9693
00878,國泰永續高股息,10,1,9,富邦-新營,2023-04-24,9693
1711,永光,12,4,8,富邦-新營,2023-04-24,9693
5258,虹堡,10,2,8,富邦-新營,2023-04-24,9693
2303,聯電,12,5,7,富邦-新營,2023-04-24,9693
4960,誠美材,11,5,6,富邦-新營,2023-04-24,9693
00905,FT臺灣Smart,6,0,6,富邦-新營,2023-04-24,9693
00680L,元大美債20正2,6,0,6,富邦-新營,2023-04-24,9693
00715L,期街口布蘭特正2,6,0,6,富邦-新營,2023-04-24,9693
2329,華泰,6,0,6,富邦-新營,2023-04-24,9693
2436,偉詮電,6,0,6,富邦-新營,2023-04-24,9693
4102,永日,6,0,6,富邦-新營,2023-04-24,9693
6282,康舒,61,55,6,富邦-新營,2023-04-24,9693
00772B,中信高評級公司債,5,0,5,富邦-新營,2023-04-24,9693
00881,國泰台灣5G+,5,0,5,富邦-新營,2023-04-24,9693
3047,訊舟,5,0,5,富邦-新營,2023-04-24,9693
6120,達運,5,0,5,富邦-新營,2023-04-24,9693
6139,亞翔,5,0,5,富邦-新營,2023-04-24,9693
6142,友勁,5,0,5,富邦-新營,2023-04-24,9693
6257,矽格,5,0,5,富邦-新營,2023-04-24,9693
4541,晟田,6,2,4,富邦-新營,2023-04-24,9693
00893,國泰智能電動車,6,2,4,富邦-新營,2023-04-24,9693
0056,元大高股息,4,0,4,富邦-新營,2023-04-24,9693
1709,和益,4,0,4,富邦-新營,2023-04-24,9693
2312,金寶,4,0,4,富邦-新營,2023-04-24,9693
2472,立隆電,5,1,4,富邦-新營,2023-04-24,9693
2609,陽明,7,3,4,富邦-新營,2023-04-24,9693
2610,華航,4,0,4,富邦-新營,2023-04-24,9693
2634,漢翔,24,20,4,富邦-新營,2023-04-24,9693
2739,寒舍,4,0,4,富邦-新營,2023-04-24,9693
2913,農林,16,12,4,富邦-新營,2023-04-24,9693
00878,國泰永續高股息,74,3,71,富邦-新營,2023-04-25,9693
00632R,元大台灣50反1,51,0,51,富邦-新營,2023-04-25,9693
2312,金寶,50,0,50,富邦-新營,2023-04-25,9693
00637L,元大滬深300正2,46,5,41,富邦-新營,2023-04-25,9693
00665L,富邦�琤肭磪囓�2,37,0,37,富邦-新營,2023-04-25,9693
1504,東元,32,3,29,富邦-新營,2023-04-25,9693
4109,加捷生醫,32,3,29,富邦-新營,2023-04-25,9693
2329,華泰,29,3,26,富邦-新營,2023-04-25,9693
2634,漢翔,138,113,25,富邦-新營,2023-04-25,9693
6282,康舒,58,33,25,富邦-新營,2023-04-25,9693
5009,榮剛,30,7,23,富邦-新營,2023-04-25,9693
1536,和大,22,0,22,富邦-新營,2023-04-25,9693
2485,兆赫,17,0,17,富邦-新營,2023-04-25,9693
00923,群益台ESG低碳50,16,0,16,富邦-新營,2023-04-25,9693
0056,元大高股息,17,1,16,富邦-新營,2023-04-25,9693
00905,FT臺灣Smart,16,0,16,富邦-新營,2023-04-25,9693
1605,華新,17,1,16,富邦-新營,2023-04-25,9693
5351,鈺創,15,0,15,富邦-新營,2023-04-25,9693
2409,友達,15,0,15,富邦-新營,2023-04-25,9693
2457,飛宏,21,7,14,富邦-新營,2023-04-25,9693
2317,鴻海,13,0,13,富邦-新營,2023-04-25,9693
1503,士電,15,2,13,富邦-新營,2023-04-25,9693
1310,台苯,35,22,13,富邦-新營,2023-04-25,9693
3231,緯創,30,17,13,富邦-新營,2023-04-25,9693
2104,國際中橡,12,0,12,富邦-新營,2023-04-25,9693
2419,仲琦,12,0,12,富邦-新營,2023-04-25,9693
1455,集盛,11,0,11,富邦-新營,2023-04-25,9693
1519,華城,11,0,11,富邦-新營,2023-04-25,9693
2344,華邦電,12,1,11,富邦-新營,2023-04-25,9693
1227,佳格,10,0,10,富邦-新營,2023-04-25,9693
1733,五鼎,10,0,10,富邦-新營,2023-04-25,9693
1734,杏輝,10,0,10,富邦-新營,2023-04-25,9693
1907,永豐餘,26,16,10,富邦-新營,2023-04-25,9693
2002,中鋼,11,1,10,富邦-新營,2023-04-25,9693
2301,光寶科,10,0,10,富邦-新營,2023-04-25,9693
2338,光罩,10,0,10,富邦-新營,2023-04-25,9693
2330,台積電,13,4,9,富邦-新營,2023-04-25,9693
00902,中信電池及儲能,9,0,9,富邦-新營,2023-04-25,9693
00892,富邦台灣半導體,9,0,9,富邦-新營,2023-04-25,9693
2851,中再保,9,0,9,富邦-新營,2023-04-25,9693
006208,富邦台50,9,0,9,富邦-新營,2023-04-25,9693
00900,富邦特選高股息30,8,0,8,富邦-新營,2023-04-25,9693
00882,中信中國高股息,8,0,8,富邦-新營,2023-04-25,9693
2337,旺宏,8,0,8,富邦-新營,2023-04-25,9693
2476,鉅祥,8,0,8,富邦-新營,2023-04-25,9693
2852,第一保,8,0,8,富邦-新營,2023-04-25,9693
3673,TPK-KY,18,10,8,富邦-新營,2023-04-25,9693
6133,金橋,10,2,8,富邦-新營,2023-04-25,9693
6269,台郡,8,0,8,富邦-新營,2023-04-25,9693
00713,元大台灣高息低波,8,0,8,富邦-新營,2023-04-25,9693
1905,華紙,396,262,134,富邦-新營,2023-04-26,9693
8046,南電,44,4,40,富邦-新營,2023-04-26,9693
1609,大亞,41,2,39,富邦-新營,2023-04-26,9693
00712,復華富時不動產,36,1,35,富邦-新營,2023-04-26,9693
2317,鴻海,31,2,29,富邦-新營,2023-04-26,9693
6116,彩晶,20,0,20,富邦-新營,2023-04-26,9693
00715L,期街口布蘭特正2,20,1,19,富邦-新營,2023-04-26,9693
6443,元晶,23,6,17,富邦-新營,2023-04-26,9693
2014,中鴻,15,0,15,富邦-新營,2023-04-26,9693
4939,亞電,15,0,15,富邦-新營,2023-04-26,9693
2329,華泰,14,1,13,富邦-新營,2023-04-26,9693
2634,漢翔,26,13,13,富邦-新營,2023-04-26,9693
4130,健亞,12,0,12,富邦-新營,2023-04-26,9693
6182,合晶,12,0,12,富邦-新營,2023-04-26,9693
2002,中鋼,11,0,11,富邦-新營,2023-04-26,9693
2834,臺企銀,11,0,11,富邦-新營,2023-04-26,9693
00772B,中信高評級公司債,26,16,10,富邦-新營,2023-04-26,9693
2409,友達,10,0,10,富邦-新營,2023-04-26,9693
4906,正文,10,0,10,富邦-新營,2023-04-26,9693
5608,四維航,10,0,10,富邦-新營,2023-04-26,9693
8093,保銳,10,0,10,富邦-新營,2023-04-26,9693
2330,台積電,10,1,9,富邦-新營,2023-04-26,9693
1310,台苯,170,161,9,富邦-新營,2023-04-26,9693
2495,普安,14,5,9,富邦-新營,2023-04-26,9693
4109,加捷生醫,9,0,9,富邦-新營,2023-04-26,9693
3231,緯創,13,4,9,富邦-新營,2023-04-26,9693
00892,富邦台灣半導體,8,0,8,富邦-新營,2023-04-26,9693
4566,時碩工業,12,4,8,富邦-新營,2023-04-26,9693
6190,萬泰科,8,0,8,富邦-新營,2023-04-26,9693
2609,陽明,9,2,7,富邦-新營,2023-04-26,9693
00885,富邦越南,7,0,7,富邦-新營,2023-04-26,9693
4960,誠美材,7,0,7,富邦-新營,2023-04-26,9693
3711,日月光投控,7,0,7,富邦-新營,2023-04-26,9693
5309,系統電,7,0,7,富邦-新營,2023-04-26,9693
2337,旺宏,11,5,6,富邦-新營,2023-04-26,9693
006208,富邦台50,6,0,6,富邦-新營,2023-04-26,9693
00680L,元大美債20正2,11,5,6,富邦-新營,2023-04-26,9693
2427,三商電,6,0,6,富邦-新營,2023-04-26,9693
6163,華電網,6,0,6,富邦-新營,2023-04-26,9693
1417,嘉裕,15,10,5,富邦-新營,2023-04-26,9693
1710,東聯,5,0,5,富邦-新營,2023-04-26,9693
1762,中化生,5,0,5,富邦-新營,2023-04-26,9693
3046,建��,5,0,5,富邦-新營,2023-04-26,9693
4702,中美實,5,0,5,富邦-新營,2023-04-26,9693
4714,永捷,10,5,5,富邦-新營,2023-04-26,9693
5351,鈺創,5,0,5,富邦-新營,2023-04-26,9693
6477,安集,10,5,5,富邦-新營,2023-04-26,9693
3705,永信,5,0,5,富邦-新營,2023-04-26,9693
0050,元大台灣50,5,0,5,富邦-新營,2023-04-26,9693
3035,智原,5,1,4,富邦-新營,2023-04-26,9693
00715L,期街口布蘭特正2,120,1,119,富邦-新營,2023-04-27,9693
3231,緯創,104,18,86,富邦-新營,2023-04-27,9693
1310,台苯,65,29,36,富邦-新營,2023-04-27,9693
00720B,元大投資級公司債,36,3,33,富邦-新營,2023-04-27,9693
6235,華孚,30,0,30,富邦-新營,2023-04-27,9693
6541,泰福-KY,30,0,30,富邦-新營,2023-04-27,9693
00712,復華富時不動產,28,0,28,富邦-新營,2023-04-27,9693
00885,富邦越南,24,0,24,富邦-新營,2023-04-27,9693
1717,長興,17,0,17,富邦-新營,2023-04-27,9693
2609,陽明,17,1,16,富邦-新營,2023-04-27,9693
00888,永豐台灣ESG,15,0,15,富邦-新營,2023-04-27,9693
5009,榮剛,55,40,15,富邦-新營,2023-04-27,9693
4743,合一,12,0,12,富邦-新營,2023-04-27,9693
00679B,元大美債20年,12,1,11,富邦-新營,2023-04-27,9693
3338,泰碩,11,0,11,富邦-新營,2023-04-27,9693
1536,和大,10,0,10,富邦-新營,2023-04-27,9693
2009,第一銅,10,0,10,富邦-新營,2023-04-27,9693
4956,光鋐,10,0,10,富邦-新營,2023-04-27,9693
4976,佳凌,10,0,10,富邦-新營,2023-04-27,9693
8215,明基材,12,2,10,富邦-新營,2023-04-27,9693
00772B,中信高評級公司債,9,0,9,富邦-新營,2023-04-27,9693
2329,華泰,13,4,9,富邦-新營,2023-04-27,9693
6142,友勁,9,0,9,富邦-新營,2023-04-27,9693
1440,南紡,8,0,8,富邦-新營,2023-04-27,9693
2323,中環,10,2,8,富邦-新營,2023-04-27,9693
2409,友達,8,0,8,富邦-新營,2023-04-27,9693
5512,力麒,8,0,8,富邦-新營,2023-04-27,9693
6770,力積電,8,0,8,富邦-新營,2023-04-27,9693
8261,富鼎,10,2,8,富邦-新營,2023-04-27,9693
1101,台泥,7,0,7,富邦-新營,2023-04-27,9693
2867,三商壽,9,2,7,富邦-新營,2023-04-27,9693
6163,華電網,20,14,6,富邦-新營,2023-04-27,9693
2317,鴻海,6,1,5,富邦-新營,2023-04-27,9693
2303,聯電,6,1,5,富邦-新營,2023-04-27,9693
00680L,元大美債20正2,5,0,5,富邦-新營,2023-04-27,9693
00830,國泰費城半導體,5,0,5,富邦-新營,2023-04-27,9693
1312,國喬,5,0,5,富邦-新營,2023-04-27,9693
2206,三陽工業,10,5,5,富邦-新營,2023-04-27,9693
2230,泰茂,5,0,5,富邦-新營,2023-04-27,9693
2495,普安,9,4,5,富邦-新營,2023-04-27,9693
4114,健喬,5,0,5,富邦-新營,2023-04-27,9693
8110,華東,5,0,5,富邦-新營,2023-04-27,9693
2002,中鋼,5,0,5,富邦-新營,2023-04-27,9693
2330,台積電,8,3,5,富邦-新營,2023-04-27,9693
1108,幸福,4,0,4,富邦-新營,2023-04-27,9693
00923,群益台ESG低碳50,4,0,4,富邦-新營,2023-04-27,9693
00670L,富邦NASDAQ正2,4,0,4,富邦-新營,2023-04-27,9693
1604,聲寶,5,1,4,富邦-新營,2023-04-27,9693
1710,東聯,11,7,4,富邦-新營,2023-04-27,9693
2645,長榮航太,4,0,4,富邦-新營,2023-04-27,9693
2409,友達,86,1,85,富邦-新營,2023-04-28,9693
2880,華南金,105,20,85,富邦-新營,2023-04-28,9693
2337,旺宏,74,5,69,富邦-新營,2023-04-28,9693
2344,華邦電,47,4,43,富邦-新營,2023-04-28,9693
2002,中鋼,38,0,38,富邦-新營,2023-04-28,9693
8046,南電,39,8,31,富邦-新營,2023-04-28,9693
6116,彩晶,31,1,30,富邦-新營,2023-04-28,9693
5011,久陽,25,0,25,富邦-新營,2023-04-28,9693
00877,復華中國5G,20,0,20,富邦-新營,2023-04-28,9693
6182,合晶,20,0,20,富邦-新營,2023-04-28,9693
00772B,中信高評級公司債,17,0,17,富邦-新營,2023-04-28,9693
3025,星通,22,5,17,富邦-新營,2023-04-28,9693
3322,建舜電,15,0,15,富邦-新營,2023-04-28,9693
2618,長榮航,14,0,14,富邦-新營,2023-04-28,9693
3003,健和興,14,0,14,富邦-新營,2023-04-28,9693
3419,譁裕,13,0,13,富邦-新營,2023-04-28,9693
2609,陽明,14,2,12,富邦-新營,2023-04-28,9693
1524,耿鼎,11,0,11,富邦-新營,2023-04-28,9693
3058,立德,13,2,11,富邦-新營,2023-04-28,9693
2457,飛宏,21,11,10,富邦-新營,2023-04-28,9693
00753L,中信中國50正2,10,0,10,富邦-新營,2023-04-28,9693
00669R,國泰美國道瓊反1,10,0,10,富邦-新營,2023-04-28,9693
1455,集盛,10,0,10,富邦-新營,2023-04-28,9693
1786,科妍,10,0,10,富邦-新營,2023-04-28,9693
2515,中工,11,1,10,富邦-新營,2023-04-28,9693
6266,泰詠,13,3,10,富邦-新營,2023-04-28,9693
8033,雷虎,10,0,10,富邦-新營,2023-04-28,9693
8110,華東,10,0,10,富邦-新營,2023-04-28,9693
3481,群創,14,5,9,富邦-新營,2023-04-28,9693
2630,亞航,16,7,9,富邦-新營,2023-04-28,9693
6271,同欣電,10,1,9,富邦-新營,2023-04-28,9693
6558,興能高,9,0,9,富邦-新營,2023-04-28,9693
3704,合勤控,10,1,9,富邦-新營,2023-04-28,9693
1513,中興電,8,0,8,富邦-新營,2023-04-28,9693
6282,康舒,16,8,8,富邦-新營,2023-04-28,9693
6865,偉康科技,8,0,8,富邦-新營,2023-04-28,9693
1216,統一,9,2,7,富邦-新營,2023-04-28,9693
1905,華紙,31,24,7,富邦-新營,2023-04-28,9693
3576,聯合再生,7,0,7,富邦-新營,2023-04-28,9693
1101,台泥,8,2,6,富邦-新營,2023-04-28,9693
1532,勤美,6,0,6,富邦-新營,2023-04-28,9693
2419,仲琦,6,0,6,富邦-新營,2023-04-28,9693
3715,定穎投控,7,1,6,富邦-新營,2023-04-28,9693
5608,四維航,6,0,6,富邦-新營,2023-04-28,9693
00680L,元大美債20正2,7,1,6,富邦-新營,2023-04-28,9693
1711,永光,7,2,5,富邦-新營,2023-04-28,9693
2363,矽統,5,0,5,富邦-新營,2023-04-28,9693
2867,三商壽,5,0,5,富邦-新營,2023-04-28,9693
4510,高鋒,5,0,5,富邦-新營,2023-04-28,9693
5488,松普,5,0,5,富邦-新營,2023-04-28,9693
6148,驊宏資,195,95,100,富邦-新營,2023-05-02,9693
2457,飛宏,222,129,93,富邦-新營,2023-05-02,9693
5465,富驊,61,6,55,富邦-新營,2023-05-02,9693
1905,華紙,486,432,54,富邦-新營,2023-05-02,9693
2913,農林,58,7,51,富邦-新營,2023-05-02,9693
2603,長榮,47,3,44,富邦-新營,2023-05-02,9693
2002,中鋼,37,0,37,富邦-新營,2023-05-02,9693
6244,茂迪,34,5,29,富邦-新營,2023-05-02,9693
2801,彰銀,24,0,24,富邦-新營,2023-05-02,9693
3033,威健,26,5,21,富邦-新營,2023-05-02,9693
1710,東聯,21,2,19,富邦-新營,2023-05-02,9693
00680L,元大美債20正2,18,0,18,富邦-新營,2023-05-02,9693
2609,陽明,20,4,16,富邦-新營,2023-05-02,9693
3105,穩懋,15,0,15,富邦-新營,2023-05-02,9693
00795B,中信美國公債20年,15,0,15,富邦-新營,2023-05-02,9693
1437,勤益控,15,0,15,富邦-新營,2023-05-02,9693
2634,漢翔,17,3,14,富邦-新營,2023-05-02,9693
1440,南紡,16,3,13,富邦-新營,2023-05-02,9693
1618,合機,13,0,13,富邦-新營,2023-05-02,9693
00720B,元大投資級公司債,13,0,13,富邦-新營,2023-05-02,9693
8110,華東,12,0,12,富邦-新營,2023-05-02,9693
00706L,期元大S＆P日圓正2,11,0,11,富邦-新營,2023-05-02,9693
5876,上海商銀,10,0,10,富邦-新營,2023-05-02,9693
3078,僑威,60,50,10,富邦-新營,2023-05-02,9693
00772B,中信高評級公司債,10,0,10,富邦-新營,2023-05-02,9693
9925,新保,10,0,10,富邦-新營,2023-05-02,9693
2884,玉山金,10,0,10,富邦-新營,2023-05-02,9693
3202,樺晟,12,2,10,富邦-新營,2023-05-02,9693
6751,智聯服務,11,1,10,富邦-新營,2023-05-02,9693
7402,邑錡,10,0,10,富邦-新營,2023-05-02,9693
5009,榮剛,13,4,9,富邦-新營,2023-05-02,9693
1529,樂事綠能,9,0,9,富邦-新營,2023-05-02,9693
6116,彩晶,12,3,9,富邦-新營,2023-05-02,9693
2482,連宇,7,0,7,富邦-新營,2023-05-02,9693
3013,晟銘電,7,0,7,富邦-新營,2023-05-02,9693
4744,皇將,7,0,7,富邦-新營,2023-05-02,9693
1776,展宇,6,0,6,富邦-新營,2023-05-02,9693
2329,華泰,6,0,6,富邦-新營,2023-05-02,9693
3363,上詮,8,2,6,富邦-新營,2023-05-02,9693
2880,華南金,5,0,5,富邦-新營,2023-05-02,9693
00679B,元大美債20年,5,0,5,富邦-新營,2023-05-02,9693
1720,生達,7,2,5,富邦-新營,2023-05-02,9693
00877,復華中國5G,5,0,5,富邦-新營,2023-05-02,9693
1727,中華化,5,0,5,富邦-新營,2023-05-02,9693
1783,和康生,5,0,5,富邦-新營,2023-05-02,9693
2630,亞航,10,5,5,富邦-新營,2023-05-02,9693
3236,千如,5,0,5,富邦-新營,2023-05-02,9693
3708,上緯投控,5,0,5,富邦-新營,2023-05-02,9693
6234,高僑,11,6,5,富邦-新營,2023-05-02,9693
6461,益得,5,0,5,富邦-新營,2023-05-02,9693
00715L,期街口布蘭特正2,208,1,207,富邦-新營,2023-05-03,9693
00712,復華富時不動產,109,0,109,富邦-新營,2023-05-03,9693
00679B,元大美債20年,104,0,104,富邦-新營,2023-05-03,9693
00772B,中信高評級公司債,100,0,100,富邦-新營,2023-05-03,9693
4121,優盛,139,49,90,富邦-新營,2023-05-03,9693
2801,彰銀,87,0,87,富邦-新營,2023-05-03,9693
6112,邁達特,56,3,53,富邦-新營,2023-05-03,9693
3078,僑威,53,6,47,富邦-新營,2023-05-03,9693
2409,友達,37,0,37,富邦-新營,2023-05-03,9693
1514,亞力,94,59,35,富邦-新營,2023-05-03,9693
2002,中鋼,34,0,34,富邦-新營,2023-05-03,9693
2609,陽明,35,5,30,富邦-新營,2023-05-03,9693
00878,國泰永續高股息,29,0,29,富邦-新營,2023-05-03,9693
00665L,富邦�琤肭磪囓�2,23,0,23,富邦-新營,2023-05-03,9693
1101,台泥,25,3,22,富邦-新營,2023-05-03,9693
6625,必應,21,0,21,富邦-新營,2023-05-03,9693
2603,長榮,24,4,20,富邦-新營,2023-05-03,9693
1471,首利,20,2,18,富邦-新營,2023-05-03,9693
2495,普安,18,0,18,富邦-新營,2023-05-03,9693
2419,仲琦,17,0,17,富邦-新營,2023-05-03,9693
3363,上詮,19,2,17,富邦-新營,2023-05-03,9693
00882,中信中國高股息,14,0,14,富邦-新營,2023-05-03,9693
3481,群創,13,0,13,富邦-新營,2023-05-03,9693
6697,東捷資訊,13,0,13,富邦-新營,2023-05-03,9693
2201,裕隆,12,0,12,富邦-新營,2023-05-03,9693
6282,康舒,12,1,11,富邦-新營,2023-05-03,9693
2634,漢翔,42,31,11,富邦-新營,2023-05-03,9693
3231,緯創,12,1,11,富邦-新營,2023-05-03,9693
00706L,期元大S＆P日圓正2,10,0,10,富邦-新營,2023-05-03,9693
5512,力麒,10,0,10,富邦-新營,2023-05-03,9693
2890,永豐金,10,1,9,富邦-新營,2023-05-03,9693
4510,高鋒,10,1,9,富邦-新營,2023-05-03,9693
3707,漢磊,10,1,9,富邦-新營,2023-05-03,9693
00642U,期元大S＆P石油,8,0,8,富邦-新營,2023-05-03,9693
1310,台苯,25,17,8,富邦-新營,2023-05-03,9693
2014,中鴻,8,0,8,富邦-新營,2023-05-03,9693
2852,第一保,8,0,8,富邦-新營,2023-05-03,9693
3715,定穎投控,20,12,8,富邦-新營,2023-05-03,9693
1711,永光,11,4,7,富邦-新營,2023-05-03,9693
6770,力積電,8,1,7,富邦-新營,2023-05-03,9693
1809,中釉,8,1,7,富邦-新營,2023-05-03,9693
1709,和益,6,0,6,富邦-新營,2023-05-03,9693
1810,和成,6,0,6,富邦-新營,2023-05-03,9693
2610,華航,7,1,6,富邦-新營,2023-05-03,9693
6550,北極星藥業-KY,6,0,6,富邦-新營,2023-05-03,9693
1316,上曜,5,0,5,富邦-新營,2023-05-03,9693
1104,環泥,37,32,5,富邦-新營,2023-05-03,9693
00902,中信電池及儲能,5,0,5,富邦-新營,2023-05-03,9693
00680L,元大美債20正2,5,0,5,富邦-新營,2023-05-03,9693
1519,華城,8,3,5,富邦-新營,2023-05-03,9693
00715L,期街口布蘭特正2,3067,5,3062,富邦-新營,2023-05-04,9693
4566,時碩工業,102,6,96,富邦-新營,2023-05-04,9693
1503,士電,75,3,72,富邦-新營,2023-05-04,9693
00712,復華富時不動產,51,0,51,富邦-新營,2023-05-04,9693
2002,中鋼,22,0,22,富邦-新營,2023-05-04,9693
2885,元大金,19,0,19,富邦-新營,2023-05-04,9693
3147,大綜,19,0,19,富邦-新營,2023-05-04,9693
1710,東聯,18,0,18,富邦-新營,2023-05-04,9693
00642U,期元大S＆P石油,15,0,15,富邦-新營,2023-05-04,9693
4541,晟田,27,12,15,富邦-新營,2023-05-04,9693
00878,國泰永續高股息,17,2,15,富邦-新營,2023-05-04,9693
1711,永光,14,1,13,富邦-新營,2023-05-04,9693
3046,建��,20,7,13,富邦-新營,2023-05-04,9693
1309,台達化,12,0,12,富邦-新營,2023-05-04,9693
1611,中電,12,0,12,富邦-新營,2023-05-04,9693
1907,永豐餘,23,11,12,富邦-新營,2023-05-04,9693
3078,僑威,11,0,11,富邦-新營,2023-05-04,9693
6244,茂迪,13,2,11,富邦-新營,2023-05-04,9693
2449,京元電子,10,0,10,富邦-新營,2023-05-04,9693
2611,志信,10,0,10,富邦-新營,2023-05-04,9693
3038,全台,10,0,10,富邦-新營,2023-05-04,9693
3625,西勝,10,0,10,富邦-新營,2023-05-04,9693
3711,日月光投控,10,0,10,富邦-新營,2023-05-04,9693
6152,百一,10,0,10,富邦-新營,2023-05-04,9693
2329,華泰,9,0,9,富邦-新營,2023-05-04,9693
2489,瑞軒,9,0,9,富邦-新營,2023-05-04,9693
1809,中釉,8,0,8,富邦-新營,2023-05-04,9693
2495,普安,8,0,8,富邦-新營,2023-05-04,9693
8403,盛弘,11,4,7,富邦-新營,2023-05-04,9693
1101,台泥,12,6,6,富邦-新營,2023-05-04,9693
00690,兆豐藍籌30,6,0,6,富邦-新營,2023-05-04,9693
1437,勤益控,6,0,6,富邦-新營,2023-05-04,9693
1528,恩德,6,0,6,富邦-新營,2023-05-04,9693
3013,晟銘電,6,0,6,富邦-新營,2023-05-04,9693
3207,耀勝,6,0,6,富邦-新營,2023-05-04,9693
2457,飛宏,27,22,5,富邦-新營,2023-05-04,9693
00639,富邦深100,5,0,5,富邦-新營,2023-05-04,9693
00877,復華中國5G,5,0,5,富邦-新營,2023-05-04,9693
1612,宏泰,5,0,5,富邦-新營,2023-05-04,9693
1618,合機,5,0,5,富邦-新營,2023-05-04,9693
1717,長興,5,0,5,富邦-新營,2023-05-04,9693
1786,科妍,5,0,5,富邦-新營,2023-05-04,9693
2436,偉詮電,5,0,5,富邦-新營,2023-05-04,9693
2630,亞航,5,0,5,富邦-新營,2023-05-04,9693
4744,皇將,7,2,5,富邦-新營,2023-05-04,9693
5512,力麒,5,0,5,富邦-新營,2023-05-04,9693
6125,廣運,5,0,5,富邦-新營,2023-05-04,9693
6465,威潤,5,0,5,富邦-新營,2023-05-04,9693
8916,光隆,5,0,5,富邦-新營,2023-05-04,9693
4953,緯軟,7,2,5,富邦-新營,2023-05-04,9693
2349,錸德,191,0,191,富邦-新營,2023-05-05,9693
00715L,期街口布蘭特正2,133,32,101,富邦-新營,2023-05-05,9693
6806,森崴能源,103,2,101,富邦-新營,2023-05-05,9693
00712,復華富時不動產,88,35,53,富邦-新營,2023-05-05,9693
3693,營邦,50,0,50,富邦-新營,2023-05-05,9693
2731,雄獅,50,0,50,富邦-新營,2023-05-05,9693
00878,國泰永續高股息,35,0,35,富邦-新營,2023-05-05,9693
2867,三商壽,22,0,22,富邦-新營,2023-05-05,9693
2630,亞航,23,3,20,富邦-新營,2023-05-05,9693
2885,元大金,25,5,20,富邦-新營,2023-05-05,9693
6127,九豪,19,0,19,富邦-新營,2023-05-05,9693
6461,益得,21,4,17,富邦-新營,2023-05-05,9693
2482,連宇,15,0,15,富邦-新營,2023-05-05,9693
1309,台達化,16,2,14,富邦-新營,2023-05-05,9693
00720B,元大投資級公司債,13,0,13,富邦-新營,2023-05-05,9693
1810,和成,11,0,11,富邦-新營,2023-05-05,9693
2609,陽明,19,8,11,富邦-新營,2023-05-05,9693
8093,保銳,11,0,11,富邦-新營,2023-05-05,9693
1538,正峰,10,0,10,富邦-新營,2023-05-05,9693
1710,東聯,10,0,10,富邦-新營,2023-05-05,9693
3006,晶豪科,10,0,10,富邦-新營,2023-05-05,9693
4121,優盛,30,20,10,富邦-新營,2023-05-05,9693
5328,華容,10,0,10,富邦-新營,2023-05-05,9693
6697,東捷資訊,10,0,10,富邦-新營,2023-05-05,9693
2489,瑞軒,9,0,9,富邦-新營,2023-05-05,9693
6129,普誠,9,0,9,富邦-新營,2023-05-05,9693
4979,華星光,9,1,8,富邦-新營,2023-05-05,9693
2458,義隆,23,16,7,富邦-新營,2023-05-05,9693
2492,華新科,10,3,7,富邦-新營,2023-05-05,9693
3443,創意,8,1,7,富邦-新營,2023-05-05,9693
2457,飛宏,11,5,6,富邦-新營,2023-05-05,9693
1905,華紙,7,1,6,富邦-新營,2023-05-05,9693
00751B,元大AAA至A公司債,6,0,6,富邦-新營,2023-05-05,9693
2453,凌群,9,3,6,富邦-新營,2023-05-05,9693
6578,達邦蛋白,6,0,6,富邦-新營,2023-05-05,9693
8215,明基材,6,0,6,富邦-新營,2023-05-05,9693
1504,東元,20,15,5,富邦-新營,2023-05-05,9693
00679B,元大美債20年,14,9,5,富邦-新營,2023-05-05,9693
00877,復華中國5G,8,3,5,富邦-新營,2023-05-05,9693
1336,台翰,5,0,5,富邦-新營,2023-05-05,9693
2425,承啟,5,0,5,富邦-新營,2023-05-05,9693
2427,三商電,5,0,5,富邦-新營,2023-05-05,9693
2539,櫻花建,5,0,5,富邦-新營,2023-05-05,9693
3036,文曄,5,0,5,富邦-新營,2023-05-05,9693
3236,千如,7,2,5,富邦-新營,2023-05-05,9693
5371,中光電,6,1,5,富邦-新營,2023-05-05,9693
6191,精成科,6,1,5,富邦-新營,2023-05-05,9693
6432,今展科,5,0,5,富邦-新營,2023-05-05,9693
8054,安國,5,0,5,富邦-新營,2023-05-05,9693
8916,光隆,5,0,5,富邦-新營,2023-05-05,9693
00673R,期元大S＆P原油反1,135,0,135,富邦-新營,2023-05-08,9693
2206,三陽工業,145,43,102,富邦-新營,2023-05-08,9693
6245,立端,93,0,93,富邦-新營,2023-05-08,9693
4541,晟田,90,26,64,富邦-新營,2023-05-08,9693
2801,彰銀,56,0,56,富邦-新營,2023-05-08,9693
1456,怡華,42,0,42,富邦-新營,2023-05-08,9693
2344,華邦電,41,0,41,富邦-新營,2023-05-08,9693
3056,富華新,40,0,40,富邦-新營,2023-05-08,9693
1568,倉佑,32,0,32,富邦-新營,2023-05-08,9693
3050,鈺德,32,0,32,富邦-新營,2023-05-08,9693
3703,欣陸,32,0,32,富邦-新營,2023-05-08,9693
2883,凱基金,59,30,29,富邦-新營,2023-05-08,9693
1605,華新,40,12,28,富邦-新營,2023-05-08,9693
6271,同欣電,24,0,24,富邦-新營,2023-05-08,9693
6125,廣運,20,3,17,富邦-新營,2023-05-08,9693
00878,國泰永續高股息,19,2,17,富邦-新營,2023-05-08,9693
1316,上曜,15,0,15,富邦-新營,2023-05-08,9693
1101,台泥,17,3,14,富邦-新營,2023-05-08,9693
00789B,復華公司債A3,13,0,13,富邦-新營,2023-05-08,9693
8112,至上,13,0,13,富邦-新營,2023-05-08,9693
6179,亞通,12,0,12,富邦-新營,2023-05-08,9693
2603,長榮,11,0,11,富邦-新營,2023-05-08,9693
3481,群創,16,5,11,富邦-新營,2023-05-08,9693
4746,台耀,22,12,10,富邦-新營,2023-05-08,9693
6182,合晶,10,0,10,富邦-新營,2023-05-08,9693
6190,萬泰科,10,0,10,富邦-新營,2023-05-08,9693
6248,沛波,10,0,10,富邦-新營,2023-05-08,9693
2317,鴻海,10,0,10,富邦-新營,2023-05-08,9693
00690,兆豐藍籌30,9,0,9,富邦-新營,2023-05-08,9693
3294,英濟,9,0,9,富邦-新營,2023-05-08,9693
2495,普安,19,11,8,富邦-新營,2023-05-08,9693
2610,華航,8,0,8,富邦-新營,2023-05-08,9693
4130,健亞,8,0,8,富邦-新營,2023-05-08,9693
2449,京元電子,7,0,7,富邦-新營,2023-05-08,9693
2468,華經,12,5,7,富邦-新營,2023-05-08,9693
2634,漢翔,15,8,7,富邦-新營,2023-05-08,9693
6443,元晶,8,1,7,富邦-新營,2023-05-08,9693
00680L,元大美債20正2,6,0,6,富邦-新營,2023-05-08,9693
1447,力鵬,6,0,6,富邦-新營,2023-05-08,9693
2108,南帝,6,0,6,富邦-新營,2023-05-08,9693
5356,協益,10,4,6,富邦-新營,2023-05-08,9693
5608,四維航,15,9,6,富邦-新營,2023-05-08,9693
6244,茂迪,6,0,6,富邦-新營,2023-05-08,9693
8215,明基材,6,0,6,富邦-新營,2023-05-08,9693
2812,台中銀,6,0,6,富邦-新營,2023-05-08,9693
5425,台半,5,0,5,富邦-新營,2023-05-08,9693
00877,復華中國5G,5,0,5,富邦-新營,2023-05-08,9693
1810,和成,5,0,5,富邦-新營,2023-05-08,9693
2851,中再保,5,0,5,富邦-新營,2023-05-08,9693
3036,文曄,5,0,5,富邦-新營,2023-05-08,9693
6275,元山,89,9,80,富邦-新營,2023-05-09,9693
6112,邁達特,64,5,59,富邦-新營,2023-05-09,9693
3017,奇鋐,53,3,50,富邦-新營,2023-05-09,9693
1417,嘉裕,48,0,48,富邦-新營,2023-05-09,9693
00680L,元大美債20正2,46,0,46,富邦-新營,2023-05-09,9693
6477,安集,33,1,32,富邦-新營,2023-05-09,9693
3324,雙鴻,46,15,31,富邦-新營,2023-05-09,9693
2888,新光金,30,0,30,富邦-新營,2023-05-09,9693
3025,星通,28,0,28,富邦-新營,2023-05-09,9693
00713,元大台灣高息低波,27,0,27,富邦-新營,2023-05-09,9693
2609,陽明,27,1,26,富邦-新營,2023-05-09,9693
00878,國泰永續高股息,26,1,25,富邦-新營,2023-05-09,9693
6282,康舒,24,0,24,富邦-新營,2023-05-09,9693
00720B,元大投資級公司債,26,3,23,富邦-新營,2023-05-09,9693
1513,中興電,22,2,20,富邦-新營,2023-05-09,9693
1440,南紡,25,5,20,富邦-新營,2023-05-09,9693
8234,新漢,20,0,20,富邦-新營,2023-05-09,9693
00772B,中信高評級公司債,19,0,19,富邦-新營,2023-05-09,9693
1529,樂事綠能,20,2,18,富邦-新營,2023-05-09,9693
00789B,復華公司債A3,17,0,17,富邦-新營,2023-05-09,9693
2610,華航,25,9,16,富邦-新營,2023-05-09,9693
4114,健喬,16,1,15,富邦-新營,2023-05-09,9693
1618,合機,15,0,15,富邦-新營,2023-05-09,9693
1471,首利,14,0,14,富邦-新營,2023-05-09,9693
8429,金麗-KY,13,0,13,富邦-新營,2023-05-09,9693
6125,廣運,17,5,12,富邦-新營,2023-05-09,9693
1504,東元,35,24,11,富邦-新營,2023-05-09,9693
2634,漢翔,16,5,11,富邦-新營,2023-05-09,9693
1907,永豐餘,19,8,11,富邦-新營,2023-05-09,9693
00891,中信關鍵半導體,10,0,10,富邦-新營,2023-05-09,9693
00687B,國泰20年美債,10,0,10,富邦-新營,2023-05-09,9693
1711,永光,10,0,10,富邦-新營,2023-05-09,9693
3027,盛達,22,12,10,富邦-新營,2023-05-09,9693
3322,建舜電,10,0,10,富邦-新營,2023-05-09,9693
6248,沛波,10,0,10,富邦-新營,2023-05-09,9693
2897,王道銀行,9,0,9,富邦-新營,2023-05-09,9693
2208,台船,9,0,9,富邦-新營,2023-05-09,9693
2402,毅嘉,26,17,9,富邦-新營,2023-05-09,9693
2412,中華電,10,1,9,富邦-新營,2023-05-09,9693
1720,生達,10,1,9,富邦-新營,2023-05-09,9693
1605,華新,8,0,8,富邦-新營,2023-05-09,9693
4111,濟生,12,4,8,富邦-新營,2023-05-09,9693
1584,精剛,22,14,8,富邦-新營,2023-05-09,9693
5009,榮剛,16,8,8,富邦-新營,2023-05-09,9693
4979,華星光,10,2,8,富邦-新營,2023-05-09,9693
6443,元晶,20,12,8,富邦-新營,2023-05-09,9693
00679B,元大美債20年,7,0,7,富邦-新營,2023-05-09,9693
1409,新纖,7,0,7,富邦-新營,2023-05-09,9693
1514,亞力,13,6,7,富邦-新營,2023-05-09,9693
2038,海光,7,0,7,富邦-新營,2023-05-09,9693
00632R,元大台灣50反1,254,0,254,富邦-新營,2023-05-10,9693
00680L,元大美債20正2,74,0,74,富邦-新營,2023-05-10,9693
00878,國泰永續高股息,59,0,59,富邦-新營,2023-05-10,9693
00637L,元大滬深300正2,100,50,50,富邦-新營,2023-05-10,9693
6152,百一,50,0,50,富邦-新營,2023-05-10,9693
1456,怡華,30,0,30,富邦-新營,2023-05-10,9693
4979,華星光,24,0,24,富邦-新營,2023-05-10,9693
4919,新唐,21,0,21,富邦-新營,2023-05-10,9693
6235,華孚,23,9,14,富邦-新營,2023-05-10,9693
1440,南紡,12,0,12,富邦-新營,2023-05-10,9693
5371,中光電,12,0,12,富邦-新營,2023-05-10,9693
1529,樂事綠能,19,8,11,富邦-新營,2023-05-10,9693
3294,英濟,11,0,11,富邦-新營,2023-05-10,9693
4916,事欣科,11,0,11,富邦-新營,2023-05-10,9693
3380,明泰,10,0,10,富邦-新營,2023-05-10,9693
1609,大亞,25,16,9,富邦-新營,2023-05-10,9693
3363,上詮,11,2,9,富邦-新營,2023-05-10,9693
6191,精成科,21,12,9,富邦-新營,2023-05-10,9693
2883,凱基金,12,4,8,富邦-新營,2023-05-10,9693
0056,元大高股息,8,0,8,富邦-新營,2023-05-10,9693
00751B,元大AAA至A公司債,8,0,8,富邦-新營,2023-05-10,9693
6122,擎邦,8,0,8,富邦-新營,2023-05-10,9693
00772B,中信高評級公司債,7,0,7,富邦-新營,2023-05-10,9693
00720B,元大投資級公司債,7,0,7,富邦-新營,2023-05-10,9693
4147,中裕,7,0,7,富邦-新營,2023-05-10,9693
00888,永豐台灣ESG,6,0,6,富邦-新營,2023-05-10,9693
1565,精華,6,0,6,富邦-新營,2023-05-10,9693
3231,緯創,15,9,6,富邦-新營,2023-05-10,9693
3481,群創,10,4,6,富邦-新營,2023-05-10,9693
4167,松瑞藥,6,0,6,富邦-新營,2023-05-10,9693
5211,蒙恬,6,0,6,富邦-新營,2023-05-10,9693
8222,寶一,9,3,6,富邦-新營,2023-05-10,9693
9939,宏全,14,8,6,富邦-新營,2023-05-10,9693
2330,台積電,6,0,6,富邦-新營,2023-05-10,9693
00712,復華富時不動產,5,0,5,富邦-新營,2023-05-10,9693
2303,聯電,5,0,5,富邦-新營,2023-05-10,9693
5222,全訊,8,3,5,富邦-新營,2023-05-10,9693
3059,華晶科,6,1,5,富邦-新營,2023-05-10,9693
2482,連宇,5,0,5,富邦-新營,2023-05-10,9693
6443,元晶,5,0,5,富邦-新營,2023-05-10,9693
00789B,復華公司債A3,5,0,5,富邦-新營,2023-05-10,9693
1514,亞力,7,2,5,富邦-新營,2023-05-10,9693
1718,中纖,5,0,5,富邦-新營,2023-05-10,9693
1720,生達,9,4,5,富邦-新營,2023-05-10,9693
2882,國泰金,5,0,5,富邦-新營,2023-05-10,9693
5902,德記,5,0,5,富邦-新營,2023-05-10,9693
6114,久威,5,0,5,富邦-新營,2023-05-10,9693
6142,友勁,5,0,5,富邦-新營,2023-05-10,9693
6263,普萊德,5,0,5,富邦-新營,2023-05-10,9693
6558,興能高,5,0,5,富邦-新營,2023-05-10,9693
00680L,元大美債20正2,205,0,205,富邦-新營,2023-05-11,9693
00773B,中信優先金融債,140,0,140,富邦-新營,2023-05-11,9693
1609,大亞,86,34,52,富邦-新營,2023-05-11,9693
3322,建舜電,31,0,31,富邦-新營,2023-05-11,9693
1529,樂事綠能,30,7,23,富邦-新營,2023-05-11,9693
00632R,元大台灣50反1,20,0,20,富邦-新營,2023-05-11,9693
1456,怡華,20,0,20,富邦-新營,2023-05-11,9693
1905,華紙,20,0,20,富邦-新營,2023-05-11,9693
4114,健喬,17,1,16,富邦-新營,2023-05-11,9693
3704,合勤控,16,1,15,富邦-新營,2023-05-11,9693
6016,康和證,15,1,14,富邦-新營,2023-05-11,9693
6285,啟��,15,1,14,富邦-新營,2023-05-11,9693
00712,復華富時不動產,12,0,12,富邦-新營,2023-05-11,9693
1506,正道,12,0,12,富邦-新營,2023-05-11,9693
2201,裕隆,14,2,12,富邦-新營,2023-05-11,9693
6807,峰源-KY,12,0,12,富邦-新營,2023-05-11,9693
1789,神隆,11,0,11,富邦-新營,2023-05-11,9693
4979,華星光,11,0,11,富邦-新營,2023-05-11,9693
00789B,復華公司債A3,10,0,10,富邦-新營,2023-05-11,9693
1310,台苯,10,0,10,富邦-新營,2023-05-11,9693
2329,華泰,10,0,10,富邦-新營,2023-05-11,9693
3289,宜特,10,0,10,富邦-新營,2023-05-11,9693
4526,東台,10,0,10,富邦-新營,2023-05-11,9693
5475,德宏,10,0,10,富邦-新營,2023-05-11,9693
00878,國泰永續高股息,12,2,10,富邦-新營,2023-05-11,9693
1314,中石化,10,1,9,富邦-新營,2023-05-11,9693
1514,亞力,9,0,9,富邦-新營,2023-05-11,9693
1568,倉佑,8,0,8,富邦-新營,2023-05-11,9693
2324,仁寶,11,3,8,富邦-新營,2023-05-11,9693
5498,凱崴,9,1,8,富邦-新營,2023-05-11,9693
8358,金居,10,2,8,富邦-新營,2023-05-11,9693
1513,中興電,7,0,7,富邦-新營,2023-05-11,9693
3576,聯合再生,7,0,7,富邦-新營,2023-05-11,9693
1762,中化生,8,1,7,富邦-新營,2023-05-11,9693
2402,毅嘉,14,7,7,富邦-新營,2023-05-11,9693
2929,淘帝-KY,7,0,7,富邦-新營,2023-05-11,9693
3715,定穎投控,22,15,7,富邦-新營,2023-05-11,9693
5009,榮剛,9,2,7,富邦-新營,2023-05-11,9693
3062,建漢,6,0,6,富邦-新營,2023-05-11,9693
6274,台燿,6,0,6,富邦-新營,2023-05-11,9693
8938,明安,6,0,6,富邦-新營,2023-05-11,9693
3558,神準,6,0,6,富邦-新營,2023-05-11,9693
1218,泰山,6,0,6,富邦-新營,2023-05-11,9693
2515,中工,6,0,6,富邦-新營,2023-05-11,9693
2867,三商壽,6,0,6,富邦-新營,2023-05-11,9693
6167,久正,6,0,6,富邦-新營,2023-05-11,9693
6548,長科*,6,0,6,富邦-新營,2023-05-11,9693
1101,台泥,6,1,5,富邦-新營,2023-05-11,9693
1584,精剛,10,5,5,富邦-新營,2023-05-11,9693
1589,永冠-KY,12,7,5,富邦-新營,2023-05-11,9693
1101,台泥,51,2,49,富邦-新營,2023-05-12,9693
3037,欣興,22,2,20,富邦-新營,2023-05-12,9693
1409,新纖,20,0,20,富邦-新營,2023-05-12,9693
2419,仲琦,20,0,20,富邦-新營,2023-05-12,9693
3058,立德,21,1,20,富邦-新營,2023-05-12,9693
6609,瀧澤科,20,0,20,富邦-新營,2023-05-12,9693
4541,晟田,19,2,17,富邦-新營,2023-05-12,9693
00882,中信中國高股息,15,0,15,富邦-新營,2023-05-12,9693
5609,中菲行,16,1,15,富邦-新營,2023-05-12,9693
2888,新光金,16,3,13,富邦-新營,2023-05-12,9693
6791,虎門科技,13,0,13,富邦-新營,2023-05-12,9693
00888,永豐台灣ESG,12,0,12,富邦-新營,2023-05-12,9693
3715,定穎投控,17,6,11,富邦-新營,2023-05-12,9693
2882,國泰金,11,0,11,富邦-新營,2023-05-12,9693
6278,台表科,11,0,11,富邦-新營,2023-05-12,9693
2317,鴻海,11,1,10,富邦-新營,2023-05-12,9693
4763,材料-KY,59,49,10,富邦-新營,2023-05-12,9693
2542,興富發,10,0,10,富邦-新營,2023-05-12,9693
00637L,元大滬深300正2,10,0,10,富邦-新營,2023-05-12,9693
2408,南亞科,10,0,10,富邦-新營,2023-05-12,9693
2618,長榮航,11,1,10,富邦-新營,2023-05-12,9693
6770,力積電,10,0,10,富邦-新營,2023-05-12,9693
6799,來頡,10,0,10,富邦-新營,2023-05-12,9693
2371,大同,19,10,9,富邦-新營,2023-05-12,9693
2889,國票金,9,0,9,富邦-新營,2023-05-12,9693
5608,四維航,10,1,9,富邦-新營,2023-05-12,9693
8046,南電,19,11,8,富邦-新營,2023-05-12,9693
00922,國泰台灣領袖50,8,0,8,富邦-新營,2023-05-12,9693
00912,中信臺灣智慧50,8,0,8,富邦-新營,2023-05-12,9693
1712,興農,8,0,8,富邦-新營,2023-05-12,9693
6282,康舒,7,0,7,富邦-新營,2023-05-12,9693
1506,正道,6,0,6,富邦-新營,2023-05-12,9693
4581,光隆精密-KY,6,0,6,富邦-新營,2023-05-12,9693
1440,南紡,5,0,5,富邦-新營,2023-05-12,9693
00642U,期元大S＆P石油,6,1,5,富邦-新營,2023-05-12,9693
00902,中信電池及儲能,5,0,5,富邦-新營,2023-05-12,9693
1524,耿鼎,5,0,5,富邦-新營,2023-05-12,9693
1611,中電,10,5,5,富邦-新營,2023-05-12,9693
1718,中纖,5,0,5,富邦-新營,2023-05-12,9693
1720,生達,5,0,5,富邦-新營,2023-05-12,9693
1802,台玻,5,0,5,富邦-新營,2023-05-12,9693
2409,友達,6,1,5,富邦-新營,2023-05-12,9693
3016,嘉晶,5,0,5,富邦-新營,2023-05-12,9693
4109,加捷生醫,5,0,5,富邦-新營,2023-05-12,9693
4114,健喬,5,0,5,富邦-新營,2023-05-12,9693
5425,台半,7,2,5,富邦-新營,2023-05-12,9693
00900,富邦特選高股息30,4,0,4,富邦-新營,2023-05-12,9693
1337,再生-KY,11,7,4,富邦-新營,2023-05-12,9693
1609,大亞,14,10,4,富邦-新營,2023-05-12,9693
2201,裕隆,4,0,4,富邦-新營,2023-05-12,9693
00715L,期街口布蘭特正2,290,3,287,富邦-新營,2023-05-15,9693
1504,東元,141,10,131,富邦-新營,2023-05-15,9693
3231,緯創,126,82,44,富邦-新營,2023-05-15,9693
00878,國泰永續高股息,54,14,40,富邦-新營,2023-05-15,9693
2374,佳能,36,0,36,富邦-新營,2023-05-15,9693
2371,大同,32,11,21,富邦-新營,2023-05-15,9693
00679B,元大美債20年,20,0,20,富邦-新營,2023-05-15,9693
6288,聯嘉,16,0,16,富邦-新營,2023-05-15,9693
1456,怡華,13,0,13,富邦-新營,2023-05-15,9693
3046,建��,30,17,13,富邦-新營,2023-05-15,9693
00687B,國泰20年美債,12,0,12,富邦-新營,2023-05-15,9693
2457,飛宏,49,37,12,富邦-新營,2023-05-15,9693
4979,華星光,12,0,12,富邦-新營,2023-05-15,9693
2303,聯電,17,6,11,富邦-新營,2023-05-15,9693
00665L,富邦�琤肭磪囓�2,12,1,11,富邦-新營,2023-05-15,9693
3037,欣興,11,0,11,富邦-新營,2023-05-15,9693
1101,台泥,10,0,10,富邦-新營,2023-05-15,9693
2317,鴻海,11,1,10,富邦-新營,2023-05-15,9693
4707,磐亞,10,0,10,富邦-新營,2023-05-15,9693
6248,沛波,10,0,10,富邦-新營,2023-05-15,9693
9105,泰金寶-DR,10,0,10,富邦-新營,2023-05-15,9693
9944,新麗,10,0,10,富邦-新營,2023-05-15,9693
2634,漢翔,13,4,9,富邦-新營,2023-05-15,9693
5258,虹堡,9,0,9,富邦-新營,2023-05-15,9693
6806,森崴能源,12,4,8,富邦-新營,2023-05-15,9693
00751B,元大AAA至A公司債,8,0,8,富邦-新營,2023-05-15,9693
2208,台船,13,5,8,富邦-新營,2023-05-15,9693
2633,台灣高鐵,13,6,7,富邦-新營,2023-05-15,9693
2906,高林,7,0,7,富邦-新營,2023-05-15,9693
6234,高僑,7,0,7,富邦-新營,2023-05-15,9693
00912,中信臺灣智慧50,6,0,6,富邦-新營,2023-05-15,9693
00882,中信中國高股息,6,0,6,富邦-新營,2023-05-15,9693
2002,中鋼,6,0,6,富邦-新營,2023-05-15,9693
2453,凌群,6,0,6,富邦-新營,2023-05-15,9693
2601,益航,6,0,6,富邦-新營,2023-05-15,9693
2618,長榮航,13,7,6,富邦-新營,2023-05-15,9693
3228,金麗科,6,0,6,富邦-新營,2023-05-15,9693
6443,元晶,7,1,6,富邦-新營,2023-05-15,9693
6578,達邦蛋白,6,0,6,富邦-新營,2023-05-15,9693
8916,光隆,6,0,6,富邦-新營,2023-05-15,9693
3705,永信,5,0,5,富邦-新營,2023-05-15,9693
0056,元大高股息,5,0,5,富邦-新營,2023-05-15,9693
00637L,元大滬深300正2,5,0,5,富邦-新營,2023-05-15,9693
1710,東聯,5,0,5,富邦-新營,2023-05-15,9693
2329,華泰,5,0,5,富邦-新營,2023-05-15,9693
2530,華建,5,0,5,富邦-新營,2023-05-15,9693
2845,遠東銀,5,0,5,富邦-新營,2023-05-15,9693
6015,宏遠證,5,0,5,富邦-新營,2023-05-15,9693
6163,華電網,6,1,5,富邦-新營,2023-05-15,9693
6191,精成科,5,0,5,富邦-新營,2023-05-15,9693
00773B,中信優先金融債,140,0,140,富邦-新營,2023-05-16,9693
00885,富邦越南,100,0,100,富邦-新營,2023-05-16,9693
1504,東元,87,19,68,富邦-新營,2023-05-16,9693
2353,宏��,100,50,50,富邦-新營,2023-05-16,9693
00680L,元大美債20正2,43,0,43,富邦-新營,2023-05-16,9693
00712,復華富時不動產,40,0,40,富邦-新營,2023-05-16,9693
00772B,中信高評級公司債,35,0,35,富邦-新營,2023-05-16,9693
00720B,元大投資級公司債,29,0,29,富邦-新營,2023-05-16,9693
6625,必應,30,1,29,富邦-新營,2023-05-16,9693
2323,中環,17,0,17,富邦-新營,2023-05-16,9693
00679B,元大美債20年,13,0,13,富邦-新營,2023-05-16,9693
1905,華紙,12,0,12,富邦-新營,2023-05-16,9693
2409,友達,12,0,12,富邦-新營,2023-05-16,9693
6558,興能高,12,0,12,富邦-新營,2023-05-16,9693
00902,中信電池及儲能,10,0,10,富邦-新營,2023-05-16,9693
6285,啟��,12,2,10,富邦-新營,2023-05-16,9693
6443,元晶,10,0,10,富邦-新營,2023-05-16,9693
2371,大同,15,5,10,富邦-新營,2023-05-16,9693
1618,合機,11,2,9,富邦-新營,2023-05-16,9693
6121,新普,9,0,9,富邦-新營,2023-05-16,9693
2317,鴻海,8,0,8,富邦-新營,2023-05-16,9693
1712,興農,7,0,7,富邦-新營,2023-05-16,9693
6245,立端,8,2,6,富邦-新營,2023-05-16,9693
3002,歐格,6,0,6,富邦-新營,2023-05-16,9693
00923,群益台ESG低碳50,5,0,5,富邦-新營,2023-05-16,9693
2453,凌群,7,2,5,富邦-新營,2023-05-16,9693
2515,中工,7,2,5,富邦-新營,2023-05-16,9693
5483,中美晶,5,0,5,富邦-新營,2023-05-16,9693
6547,高端疫苗,5,0,5,富邦-新營,2023-05-16,9693
6712,長聖,7,3,4,富邦-新營,2023-05-16,9693
2603,長榮,7,3,4,富邦-新營,2023-05-16,9693
1409,新纖,4,0,4,富邦-新營,2023-05-16,9693
3033,威健,4,0,4,富邦-新營,2023-05-16,9693
4979,華星光,4,0,4,富邦-新營,2023-05-16,9693
6160,欣技,4,0,4,富邦-新營,2023-05-16,9693
5009,榮剛,15,12,3,富邦-新營,2023-05-16,9693
1314,中石化,3,0,3,富邦-新營,2023-05-16,9693
00687B,國泰20年美債,3,0,3,富邦-新營,2023-05-16,9693
00642U,期元大S＆P石油,3,0,3,富邦-新營,2023-05-16,9693
00751B,元大AAA至A公司債,3,0,3,富邦-新營,2023-05-16,9693
1513,中興電,3,0,3,富邦-新營,2023-05-16,9693
2344,華邦電,6,3,3,富邦-新營,2023-05-16,9693
3294,英濟,3,0,3,富邦-新營,2023-05-16,9693
4908,前鼎,5,2,3,富邦-新營,2023-05-16,9693
5880,合庫金,5,2,3,富邦-新營,2023-05-16,9693
6005,群益證,3,0,3,富邦-新營,2023-05-16,9693
8234,新漢,3,0,3,富邦-新營,2023-05-16,9693
9105,泰金寶-DR,5,2,3,富邦-新營,2023-05-16,9693
4919,新唐,2,0,2,富邦-新營,2023-05-16,9693
00789B,復華公司債A3,2,0,2,富邦-新營,2023-05-16,9693
00680L,元大美債20正2,145,0,145,富邦-新營,2023-05-17,9693
00772B,中信高評級公司債,109,0,109,富邦-新營,2023-05-17,9693
00878,國泰永續高股息,102,26,76,富邦-新營,2023-05-17,9693
6874,倍力,76,2,74,富邦-新營,2023-05-17,9693
00773B,中信優先金融債,40,0,40,富邦-新營,2023-05-17,9693
2618,長榮航,43,9,34,富邦-新營,2023-05-17,9693
1609,大亞,44,14,30,富邦-新營,2023-05-17,9693
2603,長榮,26,4,22,富邦-新營,2023-05-17,9693
4109,加捷生醫,22,0,22,富邦-新營,2023-05-17,9693
00632R,元大台灣50反1,256,235,21,富邦-新營,2023-05-17,9693
1810,和成,41,21,20,富邦-新營,2023-05-17,9693
2601,益航,20,0,20,富邦-新營,2023-05-17,9693
3675,德微,23,3,20,富邦-新營,2023-05-17,9693
6156,松上,20,0,20,富邦-新營,2023-05-17,9693
3380,明泰,21,2,19,富邦-新營,2023-05-17,9693
3715,定穎投控,21,4,17,富邦-新營,2023-05-17,9693
00751B,元大AAA至A公司債,14,0,14,富邦-新營,2023-05-17,9693
8046,南電,20,8,12,富邦-新營,2023-05-17,9693
00712,復華富時不動產,11,0,11,富邦-新營,2023-05-17,9693
6005,群益證,11,0,11,富邦-新營,2023-05-17,9693
6271,同欣電,11,0,11,富邦-新營,2023-05-17,9693
00725B,國泰投資級公司債,10,0,10,富邦-新營,2023-05-17,9693
00902,中信電池及儲能,10,0,10,富邦-新營,2023-05-17,9693
00673R,期元大S＆P原油反1,10,0,10,富邦-新營,2023-05-17,9693
2211,長榮鋼,10,0,10,富邦-新營,2023-05-17,9693
8086,宏捷科,10,0,10,富邦-新營,2023-05-17,9693
8926,台汽電,10,0,10,富邦-新營,2023-05-17,9693
1608,華榮,12,3,9,富邦-新營,2023-05-17,9693
5534,長虹,9,0,9,富邦-新營,2023-05-17,9693
6266,泰詠,9,0,9,富邦-新營,2023-05-17,9693
2610,華航,15,7,8,富邦-新營,2023-05-17,9693
6461,益得,10,2,8,富邦-新營,2023-05-17,9693
00687B,國泰20年美債,7,0,7,富邦-新營,2023-05-17,9693
1519,華城,18,11,7,富邦-新營,2023-05-17,9693
3363,上詮,120,113,7,富邦-新營,2023-05-17,9693
6139,亞翔,8,1,7,富邦-新營,2023-05-17,9693
00679B,元大美債20年,6,0,6,富邦-新營,2023-05-17,9693
2323,中環,11,5,6,富邦-新營,2023-05-17,9693
2736,富野,6,0,6,富邦-新營,2023-05-17,9693
3029,零壹,8,2,6,富邦-新營,2023-05-17,9693
2609,陽明,10,4,6,富邦-新營,2023-05-17,9693
00720B,元大投資級公司債,6,1,5,富邦-新營,2023-05-17,9693
6285,啟��,9,4,5,富邦-新營,2023-05-17,9693
00852L,國泰美國道瓊正2,5,0,5,富邦-新營,2023-05-17,9693
00637L,元大滬深300正2,5,0,5,富邦-新營,2023-05-17,9693
00922,國泰台灣領袖50,5,0,5,富邦-新營,2023-05-17,9693
1417,嘉裕,5,0,5,富邦-新營,2023-05-17,9693
1587,吉茂,5,0,5,富邦-新營,2023-05-17,9693
4114,健喬,6,1,5,富邦-新營,2023-05-17,9693
5351,鈺創,13,8,5,富邦-新營,2023-05-17,9693
00773B,中信優先金融債,65,0,65,富邦-新營,2023-05-18,9693
3033,威健,50,0,50,富邦-新營,2023-05-18,9693
00674R,期元大S＆P黃金反1,50,2,48,富邦-新營,2023-05-18,9693
00632R,元大台灣50反1,38,0,38,富邦-新營,2023-05-18,9693
3362,先進光,25,2,23,富邦-新營,2023-05-18,9693
6271,同欣電,20,0,20,富邦-新營,2023-05-18,9693
00676R,富邦臺灣加權反1,20,0,20,富邦-新營,2023-05-18,9693
1616,億泰,20,0,20,富邦-新營,2023-05-18,9693
8046,南電,18,0,18,富邦-新營,2023-05-18,9693
00679B,元大美債20年,17,0,17,富邦-新營,2023-05-18,9693
1319,東陽,15,0,15,富邦-新營,2023-05-18,9693
2890,永豐金,15,0,15,富邦-新營,2023-05-18,9693
3011,今皓,15,0,15,富邦-新營,2023-05-18,9693
00665L,富邦�琤肭磪囓�2,16,2,14,富邦-新營,2023-05-18,9693
1617,榮星,14,0,14,富邦-新營,2023-05-18,9693
2491,吉祥全,14,0,14,富邦-新營,2023-05-18,9693
1718,中纖,16,3,13,富邦-新營,2023-05-18,9693
4541,晟田,15,2,13,富邦-新營,2023-05-18,9693
4744,皇將,70,58,12,富邦-新營,2023-05-18,9693
4746,台耀,23,11,12,富邦-新營,2023-05-18,9693
6122,擎邦,12,0,12,富邦-新營,2023-05-18,9693
00902,中信電池及儲能,12,1,11,富邦-新營,2023-05-18,9693
3013,晟銘電,12,1,11,富邦-新營,2023-05-18,9693
2206,三陽工業,24,14,10,富邦-新營,2023-05-18,9693
00687B,國泰20年美債,12,2,10,富邦-新營,2023-05-18,9693
2349,錸德,10,0,10,富邦-新營,2023-05-18,9693
6163,華電網,12,2,10,富邦-新營,2023-05-18,9693
8011,台通,18,8,10,富邦-新營,2023-05-18,9693
8942,森鉅,10,0,10,富邦-新營,2023-05-18,9693
2371,大同,41,31,10,富邦-新營,2023-05-18,9693
6770,力積電,9,0,9,富邦-新營,2023-05-18,9693
00772B,中信高評級公司債,9,0,9,富邦-新營,2023-05-18,9693
1713,國化,8,0,8,富邦-新營,2023-05-18,9693
6160,欣技,16,8,8,富邦-新營,2023-05-18,9693
3704,合勤控,31,23,8,富邦-新營,2023-05-18,9693
6550,北極星藥業-KY,8,1,7,富邦-新營,2023-05-18,9693
00637L,元大滬深300正2,7,0,7,富邦-新營,2023-05-18,9693
3058,立德,13,6,7,富邦-新營,2023-05-18,9693
6121,新普,7,0,7,富邦-新營,2023-05-18,9693
6243,迅杰,7,0,7,富邦-新營,2023-05-18,9693
1304,台聚,6,0,6,富邦-新營,2023-05-18,9693
1904,正隆,8,2,6,富邦-新營,2023-05-18,9693
3607,谷崧,6,0,6,富邦-新營,2023-05-18,9693
6112,邁達特,86,80,6,富邦-新營,2023-05-18,9693
00720B,元大投資級公司債,5,0,5,富邦-新營,2023-05-18,9693
00751B,元大AAA至A公司債,5,0,5,富邦-新營,2023-05-18,9693
3576,聯合再生,12,7,5,富邦-新營,2023-05-18,9693
2603,長榮,5,0,5,富邦-新營,2023-05-18,9693
00655L,國泰中國A50正2,5,0,5,富邦-新營,2023-05-18,9693
2313,華通,7,2,5,富邦-新營,2023-05-18,9693
2332,友訊,102,3,99,富邦-新營,2023-05-19,9693
4173,久裕,50,3,47,富邦-新營,2023-05-19,9693
5009,榮剛,84,40,44,富邦-新營,2023-05-19,9693
00665L,富邦�琤肭磪囓�2,36,0,36,富邦-新營,2023-05-19,9693
00674R,期元大S＆P黃金反1,35,0,35,富邦-新營,2023-05-19,9693
4919,新唐,32,0,32,富邦-新營,2023-05-19,9693
3037,欣興,35,3,32,富邦-新營,2023-05-19,9693
2453,凌群,43,12,31,富邦-新營,2023-05-19,9693
4168,醣聯,30,0,30,富邦-新營,2023-05-19,9693
3011,今皓,21,0,21,富邦-新營,2023-05-19,9693
00753L,中信中國50正2,20,0,20,富邦-新營,2023-05-19,9693
3346,麗清,20,0,20,富邦-新營,2023-05-19,9693
3548,兆利,20,0,20,富邦-新營,2023-05-19,9693
6477,安集,20,0,20,富邦-新營,2023-05-19,9693
6163,華電網,19,1,18,富邦-新營,2023-05-19,9693
3058,立德,27,11,16,富邦-新營,2023-05-19,9693
00680L,元大美債20正2,15,0,15,富邦-新營,2023-05-19,9693
2313,華通,23,8,15,富邦-新營,2023-05-19,9693
6147,頎邦,15,0,15,富邦-新營,2023-05-19,9693
8234,新漢,15,0,15,富邦-新營,2023-05-19,9693
2734,易飛網,14,0,14,富邦-新營,2023-05-19,9693
00687B,國泰20年美債,16,3,13,富邦-新營,2023-05-19,9693
00720B,元大投資級公司債,13,0,13,富邦-新營,2023-05-19,9693
3617,碩天,23,10,13,富邦-新營,2023-05-19,9693
2317,鴻海,12,0,12,富邦-新營,2023-05-19,9693
00772B,中信高評級公司債,12,0,12,富邦-新營,2023-05-19,9693
3576,聯合再生,15,3,12,富邦-新營,2023-05-19,9693
00676R,富邦臺灣加權反1,10,0,10,富邦-新營,2023-05-19,9693
3447,展達,10,0,10,富邦-新營,2023-05-19,9693
4931,新盛力,10,0,10,富邦-新營,2023-05-19,9693
00632R,元大台灣50反1,9,1,8,富邦-新營,2023-05-19,9693
1608,華榮,8,0,8,富邦-新營,2023-05-19,9693
3260,威剛,10,2,8,富邦-新營,2023-05-19,9693
1718,中纖,8,1,7,富邦-新營,2023-05-19,9693
2603,長榮,8,2,6,富邦-新營,2023-05-19,9693
00923,群益台ESG低碳50,6,0,6,富邦-新營,2023-05-19,9693
1319,東陽,6,0,6,富邦-新營,2023-05-19,9693
1584,精剛,15,9,6,富邦-新營,2023-05-19,9693
2482,連宇,6,0,6,富邦-新營,2023-05-19,9693
3002,歐格,6,0,6,富邦-新營,2023-05-19,9693
4109,加捷生醫,6,0,6,富邦-新營,2023-05-19,9693
5483,中美晶,7,1,6,富邦-新營,2023-05-19,9693
6214,精誠,6,0,6,富邦-新營,2023-05-19,9693
6235,華孚,126,120,6,富邦-新營,2023-05-19,9693
2881,富邦金,10,4,6,富邦-新營,2023-05-19,9693
2442,新美齊,7,1,6,富邦-新營,2023-05-19,9693
6443,元晶,5,0,5,富邦-新營,2023-05-19,9693
00751B,元大AAA至A公司債,5,0,5,富邦-新營,2023-05-19,9693
00773B,中信優先金融債,5,0,5,富邦-新營,2023-05-19,9693
00637L,元大滬深300正2,55,50,5,富邦-新營,2023-05-19,9693
00715L,期街口布蘭特正2,285,12,273,富邦-新營,2023-05-22,9693
2201,裕隆,178,101,77,富邦-新營,2023-05-22,9693
00687B,國泰20年美債,56,0,56,富邦-新營,2023-05-22,9693
4919,新唐,31,0,31,富邦-新營,2023-05-22,9693
2303,聯電,28,0,28,富邦-新營,2023-05-22,9693
1618,合機,24,2,22,富邦-新營,2023-05-22,9693
8059,凱碩,25,3,22,富邦-新營,2023-05-22,9693
2885,元大金,21,1,20,富邦-新營,2023-05-22,9693
2610,華航,31,12,19,富邦-新營,2023-05-22,9693
1617,榮星,18,0,18,富邦-新營,2023-05-22,9693
3548,兆利,17,0,17,富邦-新營,2023-05-22,9693
5009,榮剛,33,16,17,富邦-新營,2023-05-22,9693
9105,泰金寶-DR,17,0,17,富邦-新營,2023-05-22,9693
00900,富邦特選高股息30,16,0,16,富邦-新營,2023-05-22,9693
3003,健和興,15,0,15,富邦-新營,2023-05-22,9693
2208,台船,20,7,13,富邦-新營,2023-05-22,9693
00919,群益台灣精選高息,12,0,12,富邦-新營,2023-05-22,9693
1612,宏泰,12,0,12,富邦-新營,2023-05-22,9693
2399,映泰,11,0,11,富邦-新營,2023-05-22,9693
5469,瀚宇博,10,0,10,富邦-新營,2023-05-22,9693
00720B,元大投資級公司債,11,1,10,富邦-新營,2023-05-22,9693
00680L,元大美債20正2,10,0,10,富邦-新營,2023-05-22,9693
00664R,國泰臺灣加權反1,10,0,10,富邦-新營,2023-05-22,9693
1721,三晃,10,0,10,富邦-新營,2023-05-22,9693
2332,友訊,11,1,10,富邦-新營,2023-05-22,9693
2371,大同,10,0,10,富邦-新營,2023-05-22,9693
3056,富華新,10,0,10,富邦-新營,2023-05-22,9693
5443,均豪,10,0,10,富邦-新營,2023-05-22,9693
8935,邦泰,10,0,10,富邦-新營,2023-05-22,9693
2801,彰銀,10,0,10,富邦-新營,2023-05-22,9693
9945,潤泰新,10,1,9,富邦-新營,2023-05-22,9693
1440,南紡,13,4,9,富邦-新營,2023-05-22,9693
4503,金雨,9,0,9,富邦-新營,2023-05-22,9693
6461,益得,10,1,9,富邦-新營,2023-05-22,9693
3231,緯創,12,3,9,富邦-新營,2023-05-22,9693
6282,康舒,23,14,9,富邦-新營,2023-05-22,9693
0056,元大高股息,10,2,8,富邦-新營,2023-05-22,9693
1608,華榮,14,6,8,富邦-新營,2023-05-22,9693
2382,廣達,10,2,8,富邦-新營,2023-05-22,9693
3088,艾訊,10,2,8,富邦-新營,2023-05-22,9693
1314,中石化,7,0,7,富邦-新營,2023-05-22,9693
2495,普安,10,3,7,富邦-新營,2023-05-22,9693
1609,大亞,15,8,7,富邦-新營,2023-05-22,9693
3481,群創,32,26,6,富邦-新營,2023-05-22,9693
1504,東元,7,1,6,富邦-新營,2023-05-22,9693
2421,建準,43,37,6,富邦-新營,2023-05-22,9693
2867,三商壽,6,0,6,富邦-新營,2023-05-22,9693
4155,訊映,6,0,6,富邦-新營,2023-05-22,9693
6188,廣明,8,3,5,富邦-新營,2023-05-22,9693
00772B,中信高評級公司債,5,0,5,富邦-新營,2023-05-22,9693
2368,金像電,107,2,105,富邦-新營,2023-05-23,9693
3058,立德,94,2,92,富邦-新營,2023-05-23,9693
00882,中信中國高股息,52,0,52,富邦-新營,2023-05-23,9693
4108,懷特,51,0,51,富邦-新營,2023-05-23,9693
00878,國泰永續高股息,61,11,50,富邦-新營,2023-05-23,9693
1218,泰山,50,0,50,富邦-新營,2023-05-23,9693
2885,元大金,42,1,41,富邦-新營,2023-05-23,9693
6776,展�眥篕�,32,0,32,富邦-新營,2023-05-23,9693
1312,國喬,25,0,25,富邦-新營,2023-05-23,9693
8121,越峰,24,1,23,富邦-新營,2023-05-23,9693
8358,金居,23,0,23,富邦-新營,2023-05-23,9693
1718,中纖,22,0,22,富邦-新營,2023-05-23,9693
00680L,元大美債20正2,21,0,21,富邦-新營,2023-05-23,9693
2601,益航,20,0,20,富邦-新營,2023-05-23,9693
9105,泰金寶-DR,20,2,18,富邦-新營,2023-05-23,9693
00687B,國泰20年美債,17,0,17,富邦-新營,2023-05-23,9693
2302,麗正,17,0,17,富邦-新營,2023-05-23,9693
00712,復華富時不動產,16,0,16,富邦-新營,2023-05-23,9693
00795B,中信美國公債20年,16,0,16,富邦-新營,2023-05-23,9693
1533,車王電,16,0,16,富邦-新營,2023-05-23,9693
1417,嘉裕,15,0,15,富邦-新營,2023-05-23,9693
1514,亞力,29,14,15,富邦-新營,2023-05-23,9693
8099,大世科,16,1,15,富邦-新營,2023-05-23,9693
2609,陽明,21,7,14,富邦-新營,2023-05-23,9693
2371,大同,14,1,13,富邦-新營,2023-05-23,9693
00772B,中信高評級公司債,13,0,13,富邦-新營,2023-05-23,9693
3481,群創,13,1,12,富邦-新營,2023-05-23,9693
4541,晟田,26,14,12,富邦-新營,2023-05-23,9693
00924,復華S＆P500成長,10,0,10,富邦-新營,2023-05-23,9693
2483,百容,10,0,10,富邦-新營,2023-05-23,9693
2614,東森,10,0,10,富邦-新營,2023-05-23,9693
2739,寒舍,10,0,10,富邦-新營,2023-05-23,9693
5905,南仁湖,15,5,10,富邦-新營,2023-05-23,9693
6570,維田,10,0,10,富邦-新營,2023-05-23,9693
1504,東元,13,4,9,富邦-新營,2023-05-23,9693
1618,合機,12,4,8,富邦-新營,2023-05-23,9693
2442,新美齊,41,33,8,富邦-新營,2023-05-23,9693
5488,松普,8,0,8,富邦-新營,2023-05-23,9693
2329,華泰,7,0,7,富邦-新營,2023-05-23,9693
00637L,元大滬深300正2,6,0,6,富邦-新營,2023-05-23,9693
1437,勤益控,6,0,6,富邦-新營,2023-05-23,9693
3162,精確,10,4,6,富邦-新營,2023-05-23,9693
5388,中磊,6,0,6,富邦-新營,2023-05-23,9693
6288,聯嘉,10,4,6,富邦-新營,2023-05-23,9693
8926,台汽電,8,2,6,富邦-新營,2023-05-23,9693
2404,漢唐,5,0,5,富邦-新營,2023-05-23,9693
3025,星通,8,3,5,富邦-新營,2023-05-23,9693
3673,TPK-KY,5,0,5,富邦-新營,2023-05-23,9693
4909,新復興,5,0,5,富邦-新營,2023-05-23,9693
4977,眾達-KY,5,0,5,富邦-新營,2023-05-23,9693
00637L,元大滬深300正2,110,1,109,富邦-新營,2023-05-24,9693
3050,鈺德,100,0,100,富邦-新營,2023-05-24,9693
00665L,富邦�琤肭磪囓�2,79,4,75,富邦-新營,2023-05-24,9693
2421,建準,54,2,52,富邦-新營,2023-05-24,9693
2887,台新金,50,0,50,富邦-新營,2023-05-24,9693
2748,雲品,100,61,39,富邦-新營,2023-05-24,9693
2115,六暉-KY,40,2,38,富邦-新營,2023-05-24,9693
4108,懷特,38,0,38,富邦-新營,2023-05-24,9693
2885,元大金,33,1,32,富邦-新營,2023-05-24,9693
00882,中信中國高股息,32,0,32,富邦-新營,2023-05-24,9693
1718,中纖,33,2,31,富邦-新營,2023-05-24,9693
2630,亞航,57,26,31,富邦-新營,2023-05-24,9693
1710,東聯,32,2,30,富邦-新營,2023-05-24,9693
00903,富邦元宇宙,30,1,29,富邦-新營,2023-05-24,9693
00878,國泰永續高股息,36,13,23,富邦-新營,2023-05-24,9693
2702,華園,23,3,20,富邦-新營,2023-05-24,9693
00919,群益台灣精選高息,15,0,15,富邦-新營,2023-05-24,9693
1616,億泰,15,0,15,富邦-新營,2023-05-24,9693
2371,大同,15,0,15,富邦-新營,2023-05-24,9693
2382,廣達,15,0,15,富邦-新營,2023-05-24,9693
1905,華紙,16,2,14,富邦-新營,2023-05-24,9693
2888,新光金,13,0,13,富邦-新營,2023-05-24,9693
8076,伍豐,37,24,13,富邦-新營,2023-05-24,9693
8358,金居,11,0,11,富邦-新營,2023-05-24,9693
2645,長榮航太,12,1,11,富邦-新營,2023-05-24,9693
00751B,元大AAA至A公司債,11,0,11,富邦-新營,2023-05-24,9693
00902,中信電池及儲能,10,0,10,富邦-新營,2023-05-24,9693
00753L,中信中國50正2,10,0,10,富邦-新營,2023-05-24,9693
00676R,富邦臺灣加權反1,10,0,10,富邦-新營,2023-05-24,9693
1618,合機,10,0,10,富邦-新營,2023-05-24,9693
2211,長榮鋼,10,0,10,富邦-新營,2023-05-24,9693
6142,友勁,10,0,10,富邦-新營,2023-05-24,9693
00632R,元大台灣50反1,10,1,9,富邦-新營,2023-05-24,9693
4120,友華,9,0,9,富邦-新營,2023-05-24,9693
1605,華新,12,4,8,富邦-新營,2023-05-24,9693
00772B,中信高評級公司債,9,1,8,富邦-新營,2023-05-24,9693
1444,力麗,8,0,8,富邦-新營,2023-05-24,9693
2201,裕隆,100,92,8,富邦-新營,2023-05-24,9693
2399,映泰,25,17,8,富邦-新營,2023-05-24,9693
2610,華航,11,3,8,富邦-新營,2023-05-24,9693
3715,定穎投控,28,20,8,富邦-新營,2023-05-24,9693
9802,鈺齊-KY,8,0,8,富邦-新營,2023-05-24,9693
2486,一詮,8,1,7,富邦-新營,2023-05-24,9693
8121,越峰,7,0,7,富邦-新營,2023-05-24,9693
8234,新漢,7,0,7,富邦-新營,2023-05-24,9693
1101,台泥,9,3,6,富邦-新營,2023-05-24,9693
1795,美時,6,0,6,富邦-新營,2023-05-24,9693
1584,精剛,11,5,6,富邦-新營,2023-05-24,9693
1809,中釉,11,5,6,富邦-新營,2023-05-24,9693
2329,華泰,8,2,6,富邦-新營,2023-05-24,9693
00637L,元大滬深300正2,265,10,255,富邦-新營,2023-05-25,9693
00680L,元大美債20正2,128,0,128,富邦-新營,2023-05-25,9693
3265,台星科,110,6,104,富邦-新營,2023-05-25,9693
00882,中信中國高股息,73,0,73,富邦-新營,2023-05-25,9693
6112,邁達特,64,1,63,富邦-新營,2023-05-25,9693
00715L,期街口布蘭特正2,100,58,42,富邦-新營,2023-05-25,9693
00712,復華富時不動產,39,0,39,富邦-新營,2023-05-25,9693
2457,飛宏,38,9,29,富邦-新營,2023-05-25,9693
4554,橙的,23,0,23,富邦-新營,2023-05-25,9693
2618,長榮航,44,22,22,富邦-新營,2023-05-25,9693
00753L,中信中國50正2,20,0,20,富邦-新營,2023-05-25,9693
8046,南電,36,18,18,富邦-新營,2023-05-25,9693
1440,南紡,18,0,18,富邦-新營,2023-05-25,9693
2349,錸德,24,8,16,富邦-新營,2023-05-25,9693
1460,宏遠,15,0,15,富邦-新營,2023-05-25,9693
2344,華邦電,46,31,15,富邦-新營,2023-05-25,9693
00665L,富邦�琤肭磪囓�2,14,0,14,富邦-新營,2023-05-25,9693
2883,凱基金,14,0,14,富邦-新營,2023-05-25,9693
00795B,中信美國公債20年,12,0,12,富邦-新營,2023-05-25,9693
2611,志信,33,21,12,富邦-新營,2023-05-25,9693
5704,老爺知,12,0,12,富邦-新營,2023-05-25,9693
1609,大亞,23,12,11,富邦-新營,2023-05-25,9693
2317,鴻海,14,3,11,富邦-新營,2023-05-25,9693
5531,鄉林,11,0,11,富邦-新營,2023-05-25,9693
8011,台通,12,1,11,富邦-新營,2023-05-25,9693
1718,中纖,10,0,10,富邦-新營,2023-05-25,9693
2002,中鋼,10,0,10,富邦-新營,2023-05-25,9693
2745,五福,10,0,10,富邦-新營,2023-05-25,9693
3003,健和興,12,2,10,富邦-新營,2023-05-25,9693
3419,譁裕,11,1,10,富邦-新營,2023-05-25,9693
4109,加捷生醫,10,0,10,富邦-新營,2023-05-25,9693
00679B,元大美債20年,10,2,8,富邦-新營,2023-05-25,9693
00772B,中信高評級公司債,8,0,8,富邦-新營,2023-05-25,9693
2885,元大金,8,0,8,富邦-新營,2023-05-25,9693
5512,力麒,10,2,8,富邦-新營,2023-05-25,9693
5880,合庫金,10,2,8,富邦-新營,2023-05-25,9693
2324,仁寶,7,0,7,富邦-新營,2023-05-25,9693
2888,新光金,7,0,7,富邦-新營,2023-05-25,9693
6288,聯嘉,7,0,7,富邦-新營,2023-05-25,9693
8033,雷虎,7,0,7,富邦-新營,2023-05-25,9693
9940,信義,7,0,7,富邦-新營,2023-05-25,9693
1101,台泥,6,0,6,富邦-新營,2023-05-25,9693
2402,毅嘉,11,5,6,富邦-新營,2023-05-25,9693
2701,萬企,6,0,6,富邦-新營,2023-05-25,9693
3017,奇鋐,50,44,6,富邦-新營,2023-05-25,9693
3363,上詮,103,97,6,富邦-新營,2023-05-25,9693
6116,彩晶,6,0,6,富邦-新營,2023-05-25,9693
6605,帝寶,6,0,6,富邦-新營,2023-05-25,9693
1319,東陽,5,0,5,富邦-新營,2023-05-25,9693
2303,聯電,5,0,5,富邦-新營,2023-05-25,9693
00715L,期街口布蘭特正2,215,0,215,富邦-新營,2023-05-26,9693
2421,建準,314,202,112,富邦-新營,2023-05-26,9693
2323,中環,145,61,84,富邦-新營,2023-05-26,9693
2801,彰銀,66,0,66,富邦-新營,2023-05-26,9693
3231,緯創,190,128,62,富邦-新營,2023-05-26,9693
00680L,元大美債20正2,51,0,51,富邦-新營,2023-05-26,9693
6535,順藥,50,1,49,富邦-新營,2023-05-26,9693
00712,復華富時不動產,41,1,40,富邦-新營,2023-05-26,9693
1463,強盛新,36,0,36,富邦-新營,2023-05-26,9693
5905,南仁湖,37,1,36,富邦-新營,2023-05-26,9693
1718,中纖,35,0,35,富邦-新營,2023-05-26,9693
4554,橙的,30,0,30,富邦-新營,2023-05-26,9693
1440,南紡,20,0,20,富邦-新營,2023-05-26,9693
9907,統一實,20,0,20,富邦-新營,2023-05-26,9693
00720B,元大投資級公司債,18,0,18,富邦-新營,2023-05-26,9693
00882,中信中國高股息,20,2,18,富邦-新營,2023-05-26,9693
3481,群創,28,11,17,富邦-新營,2023-05-26,9693
1618,合機,16,0,16,富邦-新營,2023-05-26,9693
2601,益航,16,0,16,富邦-新營,2023-05-26,9693
8234,新漢,15,0,15,富邦-新營,2023-05-26,9693
6125,廣運,16,2,14,富邦-新營,2023-05-26,9693
8926,台汽電,14,0,14,富邦-新營,2023-05-26,9693
1584,精剛,15,3,12,富邦-新營,2023-05-26,9693
00857B,永豐20年美公債,12,0,12,富邦-新營,2023-05-26,9693
2441,超豐,13,1,12,富邦-新營,2023-05-26,9693
6163,華電網,12,0,12,富邦-新營,2023-05-26,9693
2328,廣宇,11,0,11,富邦-新營,2023-05-26,9693
8227,巨有科技,21,11,10,富邦-新營,2023-05-26,9693
2630,亞航,44,34,10,富邦-新營,2023-05-26,9693
00679B,元大美債20年,27,17,10,富邦-新營,2023-05-26,9693
00902,中信電池及儲能,10,0,10,富邦-新營,2023-05-26,9693
1231,聯華食,10,0,10,富邦-新營,2023-05-26,9693
1905,華紙,15,5,10,富邦-新營,2023-05-26,9693
2495,普安,10,0,10,富邦-新營,2023-05-26,9693
3596,智易,11,1,10,富邦-新營,2023-05-26,9693
4760,勤凱,10,0,10,富邦-新營,2023-05-26,9693
6139,亞翔,11,1,10,富邦-新營,2023-05-26,9693
6248,沛波,10,0,10,富邦-新營,2023-05-26,9693
3029,零壹,10,1,9,富邦-新營,2023-05-26,9693
2634,漢翔,14,5,9,富邦-新營,2023-05-26,9693
3680,家登,13,4,9,富邦-新營,2023-05-26,9693
2481,強茂,9,0,9,富邦-新營,2023-05-26,9693
2605,新興,10,1,9,富邦-新營,2023-05-26,9693
3625,西勝,9,0,9,富邦-新營,2023-05-26,9693
4564,元翎,46,37,9,富邦-新營,2023-05-26,9693
1605,華新,11,3,8,富邦-新營,2023-05-26,9693
00665L,富邦�琤肭磪囓�2,7,0,7,富邦-新營,2023-05-26,9693
1796,金穎生技,7,0,7,富邦-新營,2023-05-26,9693
2834,臺企銀,7,0,7,富邦-新營,2023-05-26,9693
6796,晉弘,7,0,7,富邦-新營,2023-05-26,9693
8099,大世科,151,55,96,富邦-新營,2023-05-29,9693
00680L,元大美債20正2,62,0,62,富邦-新營,2023-05-29,9693
00715L,期街口布蘭特正2,60,2,58,富邦-新營,2023-05-29,9693
2913,農林,57,0,57,富邦-新營,2023-05-29,9693
2324,仁寶,56,4,52,富邦-新營,2023-05-29,9693
00878,國泰永續高股息,53,12,41,富邦-新營,2023-05-29,9693
6244,茂迪,30,0,30,富邦-新營,2023-05-29,9693
2412,中華電,29,0,29,富邦-新營,2023-05-29,9693
3037,欣興,36,8,28,富邦-新營,2023-05-29,9693
2382,廣達,26,2,24,富邦-新營,2023-05-29,9693
5512,力麒,23,0,23,富邦-新營,2023-05-29,9693
6026,福邦證,20,0,20,富邦-新營,2023-05-29,9693
1314,中石化,20,0,20,富邦-新營,2023-05-29,9693
2211,長榮鋼,20,0,20,富邦-新營,2023-05-29,9693
2614,東森,20,0,20,富邦-新營,2023-05-29,9693
2743,山富,20,0,20,富邦-新營,2023-05-29,9693
5425,台半,20,2,18,富邦-新營,2023-05-29,9693
0056,元大高股息,17,1,16,富邦-新營,2023-05-29,9693
1513,中興電,17,2,15,富邦-新營,2023-05-29,9693
00687B,國泰20年美債,14,0,14,富邦-新營,2023-05-29,9693
3071,協禧,14,0,14,富邦-新營,2023-05-29,9693
3499,環天科,14,0,14,富邦-新營,2023-05-29,9693
6285,啟��,18,4,14,富邦-新營,2023-05-29,9693
6282,康舒,215,202,13,富邦-新營,2023-05-29,9693
1503,士電,15,2,13,富邦-新營,2023-05-29,9693
1708,東鹼,13,0,13,富邦-新營,2023-05-29,9693
1718,中纖,12,0,12,富邦-新營,2023-05-29,9693
4541,晟田,12,0,12,富邦-新營,2023-05-29,9693
4904,遠傳,12,0,12,富邦-新營,2023-05-29,9693
00688L,國泰20年美債正2,11,0,11,富邦-新營,2023-05-29,9693
1309,台達化,11,0,11,富邦-新營,2023-05-29,9693
3481,群創,22,12,10,富邦-新營,2023-05-29,9693
00882,中信中國高股息,10,0,10,富邦-新營,2023-05-29,9693
3231,緯創,95,85,10,富邦-新營,2023-05-29,9693
3625,西勝,10,0,10,富邦-新營,2023-05-29,9693
6239,力成,12,2,10,富邦-新營,2023-05-29,9693
6461,益得,10,0,10,富邦-新營,2023-05-29,9693
1101,台泥,9,0,9,富邦-新營,2023-05-29,9693
2421,建準,92,83,9,富邦-新營,2023-05-29,9693
2376,技嘉,17,9,8,富邦-新營,2023-05-29,9693
3508,位速,8,0,8,富邦-新營,2023-05-29,9693
5388,中磊,8,1,7,富邦-新營,2023-05-29,9693
00679B,元大美債20年,7,0,7,富邦-新營,2023-05-29,9693
1460,宏遠,6,0,6,富邦-新營,2023-05-29,9693
1525,江申,6,0,6,富邦-新營,2023-05-29,9693
2371,大同,43,37,6,富邦-新營,2023-05-29,9693
3715,定穎投控,30,24,6,富邦-新營,2023-05-29,9693
6142,友勁,6,0,6,富邦-新營,2023-05-29,9693
6477,安集,6,0,6,富邦-新營,2023-05-29,9693
00888,永豐台灣ESG,5,0,5,富邦-新營,2023-05-29,9693
00637L,元大滬深300正2,92,0,92,富邦-新營,2023-05-30,9693
00715L,期街口布蘭特正2,93,3,90,富邦-新營,2023-05-30,9693
1503,士電,87,9,78,富邦-新營,2023-05-30,9693
8926,台汽電,42,0,42,富邦-新營,2023-05-30,9693
2356,英業達,52,16,36,富邦-新營,2023-05-30,9693
2368,金像電,37,2,35,富邦-新營,2023-05-30,9693
6016,康和證,30,0,30,富邦-新營,2023-05-30,9693
6689,伊雲谷,32,2,30,富邦-新營,2023-05-30,9693
0056,元大高股息,29,0,29,富邦-新營,2023-05-30,9693
00882,中信中國高股息,26,0,26,富邦-新營,2023-05-30,9693
3706,神達,25,3,22,富邦-新營,2023-05-30,9693
1524,耿鼎,21,0,21,富邦-新營,2023-05-30,9693
1608,華榮,30,12,18,富邦-新營,2023-05-30,9693
2634,漢翔,31,13,18,富邦-新營,2023-05-30,9693
5498,凱崴,219,203,16,富邦-新營,2023-05-30,9693
6196,帆宣,15,0,15,富邦-新營,2023-05-30,9693
2812,台中銀,14,0,14,富邦-新營,2023-05-30,9693
2002,中鋼,14,1,13,富邦-新營,2023-05-30,9693
2421,建準,16,3,13,富邦-新營,2023-05-30,9693
9105,泰金寶-DR,13,0,13,富邦-新營,2023-05-30,9693
2371,大同,31,18,13,富邦-新營,2023-05-30,9693
00687B,國泰20年美債,12,0,12,富邦-新營,2023-05-30,9693
00751B,元大AAA至A公司債,12,0,12,富邦-新營,2023-05-30,9693
1504,東元,16,4,12,富邦-新營,2023-05-30,9693
3714,富采,12,0,12,富邦-新營,2023-05-30,9693
00772B,中信高評級公司債,11,0,11,富邦-新營,2023-05-30,9693
00725B,國泰投資級公司債,11,0,11,富邦-新營,2023-05-30,9693
2425,承啟,18,7,11,富邦-新營,2023-05-30,9693
6160,欣技,72,61,11,富邦-新營,2023-05-30,9693
2331,精英,11,0,11,富邦-新營,2023-05-30,9693
3231,緯創,42,31,11,富邦-新營,2023-05-30,9693
00904,新光臺灣半導體30,10,0,10,富邦-新營,2023-05-30,9693
1440,南紡,11,1,10,富邦-新營,2023-05-30,9693
1460,宏遠,10,0,10,富邦-新營,2023-05-30,9693
2344,華邦電,11,1,10,富邦-新營,2023-05-30,9693
3071,協禧,13,3,10,富邦-新營,2023-05-30,9693
00712,復華富時不動產,10,1,9,富邦-新營,2023-05-30,9693
3564,其陽,8,0,8,富邦-新營,2023-05-30,9693
6438,迅得,8,0,8,富邦-新營,2023-05-30,9693
2388,威盛,18,10,8,富邦-新營,2023-05-30,9693
1718,中纖,18,11,7,富邦-新營,2023-05-30,9693
2637,慧洋-KY,7,0,7,富邦-新營,2023-05-30,9693
4564,元翎,8,1,7,富邦-新營,2023-05-30,9693
2867,三商壽,8,2,6,富邦-新營,2023-05-30,9693
3032,偉訓,10,4,6,富邦-新營,2023-05-30,9693
3088,艾訊,6,0,6,富邦-新營,2023-05-30,9693
4114,健喬,7,1,6,富邦-新營,2023-05-30,9693
5009,榮剛,8,2,6,富邦-新營,2023-05-30,9693
5328,華容,6,0,6,富邦-新營,2023-05-30,9693
6591,動力-KY,6,0,6,富邦-新營,2023-05-30,9693
00715L,期街口布蘭特正2,235,1,234,富邦-新營,2023-05-31,9693
8099,大世科,50,0,50,富邦-新營,2023-05-31,9693
3704,合勤控,51,5,46,富邦-新營,2023-05-31,9693
4967,十銓,49,6,43,富邦-新營,2023-05-31,9693
2371,大同,87,47,40,富邦-新營,2023-05-31,9693
00637L,元大滬深300正2,29,0,29,富邦-新營,2023-05-31,9693
2891,中信金,23,0,23,富邦-新營,2023-05-31,9693
3231,緯創,51,28,23,富邦-新營,2023-05-31,9693
00632R,元大台灣50反1,20,0,20,富邦-新營,2023-05-31,9693
00753L,中信中國50正2,15,0,15,富邦-新營,2023-05-31,9693
3706,神達,29,14,15,富邦-新營,2023-05-31,9693
00882,中信中國高股息,13,0,13,富邦-新營,2023-05-31,9693
00687B,國泰20年美債,12,1,11,富邦-新營,2023-05-31,9693
4114,健喬,11,0,11,富邦-新營,2023-05-31,9693
0056,元大高股息,10,0,10,富邦-新營,2023-05-31,9693
00712,復華富時不動產,10,0,10,富邦-新營,2023-05-31,9693
00664R,國泰臺灣加權反1,10,0,10,富邦-新營,2023-05-31,9693
1104,環泥,10,0,10,富邦-新營,2023-05-31,9693
5443,均豪,10,0,10,富邦-新營,2023-05-31,9693
00878,國泰永續高股息,11,2,9,富邦-新營,2023-05-31,9693
2421,建準,10,2,8,富邦-新營,2023-05-31,9693
2356,英業達,40,32,8,富邦-新營,2023-05-31,9693
2641,正德,8,0,8,富邦-新營,2023-05-31,9693
2409,友達,10,2,8,富邦-新營,2023-05-31,9693
2457,飛宏,161,154,7,富邦-新營,2023-05-31,9693
00642U,期元大S＆P石油,7,0,7,富邦-新營,2023-05-31,9693
3272,東碩,8,1,7,富邦-新營,2023-05-31,9693
4976,佳凌,7,0,7,富邦-新營,2023-05-31,9693
6266,泰詠,7,0,7,富邦-新營,2023-05-31,9693
2014,中鴻,6,0,6,富邦-新營,2023-05-31,9693
00679B,元大美債20年,5,0,5,富邦-新營,2023-05-31,9693
6288,聯嘉,5,0,5,富邦-新營,2023-05-31,9693
00752,中信中國50,5,0,5,富邦-新營,2023-05-31,9693
00706L,期元大S＆P日圓正2,5,0,5,富邦-新營,2023-05-31,9693
2349,錸德,10,5,5,富邦-新營,2023-05-31,9693
2352,佳世達,6,1,5,富邦-新營,2023-05-31,9693
2354,鴻準,5,0,5,富邦-新營,2023-05-31,9693
2867,三商壽,5,0,5,富邦-新營,2023-05-31,9693
2888,新光金,21,16,5,富邦-新營,2023-05-31,9693
3003,健和興,5,0,5,富邦-新營,2023-05-31,9693
3051,力特,5,0,5,富邦-新營,2023-05-31,9693
3056,富華新,5,0,5,富邦-新營,2023-05-31,9693
3576,聯合再生,5,0,5,富邦-新營,2023-05-31,9693
4961,天鈺,5,0,5,富邦-新營,2023-05-31,9693
6443,元晶,5,0,5,富邦-新營,2023-05-31,9693
6477,安集,5,0,5,富邦-新營,2023-05-31,9693
1319,東陽,4,0,4,富邦-新營,2023-05-31,9693
1445,大宇,4,0,4,富邦-新營,2023-05-31,9693
2388,威盛,6,2,4,富邦-新營,2023-05-31,9693
2451,創見,5,1,4,富邦-新營,2023-05-31,9693
2421,建準,231,48,183,富邦-新營,2023-06-01,9693
1905,華紙,561,491,70,富邦-新營,2023-06-01,9693
00715L,期街口布蘭特正2,55,2,53,富邦-新營,2023-06-01,9693
4968,立積,54,13,41,富邦-新營,2023-06-01,9693
00878,國泰永續高股息,44,9,35,富邦-新營,2023-06-01,9693
6282,康舒,140,112,28,富邦-新營,2023-06-01,9693
2323,中環,43,18,25,富邦-新營,2023-06-01,9693
3013,晟銘電,49,27,22,富邦-新營,2023-06-01,9693
1909,榮成,20,0,20,富邦-新營,2023-06-01,9693
6015,宏遠證,20,0,20,富邦-新營,2023-06-01,9693
2371,大同,47,28,19,富邦-新營,2023-06-01,9693
2444,兆勁,21,2,19,富邦-新營,2023-06-01,9693
2706,第一店,21,2,19,富邦-新營,2023-06-01,9693
8210,勤誠,23,6,17,富邦-新營,2023-06-01,9693
3673,TPK-KY,17,0,17,富邦-新營,2023-06-01,9693
6185,幃翔,19,2,17,富邦-新營,2023-06-01,9693
00753L,中信中國50正2,14,0,14,富邦-新營,2023-06-01,9693
2328,廣宇,26,12,14,富邦-新營,2023-06-01,9693
2888,新光金,14,0,14,富邦-新營,2023-06-01,9693
2201,裕隆,28,15,13,富邦-新營,2023-06-01,9693
00882,中信中國高股息,13,0,13,富邦-新營,2023-06-01,9693
3706,神達,63,52,11,富邦-新營,2023-06-01,9693
2913,農林,114,103,11,富邦-新營,2023-06-01,9693
2356,英業達,11,0,11,富邦-新營,2023-06-01,9693
2412,中華電,10,0,10,富邦-新營,2023-06-01,9693
1319,東陽,10,0,10,富邦-新營,2023-06-01,9693
2390,云辰,10,0,10,富邦-新營,2023-06-01,9693
3576,聯合再生,10,0,10,富邦-新營,2023-06-01,9693
6591,動力-KY,10,0,10,富邦-新營,2023-06-01,9693
1513,中興電,9,1,8,富邦-新營,2023-06-01,9693
1605,華新,8,1,7,富邦-新營,2023-06-01,9693
3046,建��,9,2,7,富邦-新營,2023-06-01,9693
3705,永信,7,0,7,富邦-新營,2023-06-01,9693
4562,穎漢,7,0,7,富邦-新營,2023-06-01,9693
6005,群益證,7,0,7,富邦-新營,2023-06-01,9693
9802,鈺齊-KY,7,0,7,富邦-新營,2023-06-01,9693
2303,聯電,19,12,7,富邦-新營,2023-06-01,9693
2882,國泰金,6,0,6,富邦-新營,2023-06-01,9693
00642U,期元大S＆P石油,6,0,6,富邦-新營,2023-06-01,9693
00637L,元大滬深300正2,6,0,6,富邦-新營,2023-06-01,9693
2399,映泰,6,0,6,富邦-新營,2023-06-01,9693
2449,京元電子,7,1,6,富邦-新營,2023-06-01,9693
3360,尚立,10,4,6,富邦-新營,2023-06-01,9693
4114,健喬,7,1,6,富邦-新營,2023-06-01,9693
5315,光聯,6,0,6,富邦-新營,2023-06-01,9693
6114,久威,6,0,6,富邦-新營,2023-06-01,9693
2542,興富發,6,0,6,富邦-新營,2023-06-01,9693
2609,陽明,5,0,5,富邦-新營,2023-06-01,9693
3037,欣興,9,4,5,富邦-新營,2023-06-01,9693
1608,華榮,6,1,5,富邦-新營,2023-06-01,9693
00919,群益台灣精選高息,69,0,69,富邦-新營,2023-06-02,9693
5706,鳳凰,233,167,66,富邦-新營,2023-06-02,9693
2481,強茂,65,0,65,富邦-新營,2023-06-02,9693
8059,凱碩,34,0,34,富邦-新營,2023-06-02,9693
2489,瑞軒,36,8,28,富邦-新營,2023-06-02,9693
2867,三商壽,30,3,27,富邦-新營,2023-06-02,9693
2387,精元,22,0,22,富邦-新營,2023-06-02,9693
3706,神達,28,7,21,富邦-新營,2023-06-02,9693
3576,聯合再生,20,0,20,富邦-新營,2023-06-02,9693
6015,宏遠證,22,2,20,富邦-新營,2023-06-02,9693
2371,大同,35,17,18,富邦-新營,2023-06-02,9693
2888,新光金,21,5,16,富邦-新營,2023-06-02,9693
6153,嘉聯益,16,0,16,富邦-新營,2023-06-02,9693
3532,台勝科,15,0,15,富邦-新營,2023-06-02,9693
1440,南紡,20,8,12,富邦-新營,2023-06-02,9693
1733,五鼎,11,0,11,富邦-新營,2023-06-02,9693
1504,東元,20,9,11,富邦-新營,2023-06-02,9693
3479,安勤,11,1,10,富邦-新營,2023-06-02,9693
5309,系統電,10,0,10,富邦-新營,2023-06-02,9693
6266,泰詠,10,0,10,富邦-新營,2023-06-02,9693
6509,聚和,15,5,10,富邦-新營,2023-06-02,9693
8271,宇瞻,10,0,10,富邦-新營,2023-06-02,9693
1513,中興電,34,25,9,富邦-新營,2023-06-02,9693
3078,僑威,11,2,9,富邦-新營,2023-06-02,9693
5512,力麒,10,1,9,富邦-新營,2023-06-02,9693
6591,動力-KY,10,1,9,富邦-新營,2023-06-02,9693
6235,華孚,16,8,8,富邦-新營,2023-06-02,9693
2603,長榮,13,5,8,富邦-新營,2023-06-02,9693
2379,瑞昱,7,0,7,富邦-新營,2023-06-02,9693
3013,晟銘電,53,46,7,富邦-新營,2023-06-02,9693
6288,聯嘉,8,1,7,富邦-新營,2023-06-02,9693
2356,英業達,25,19,6,富邦-新營,2023-06-02,9693
2515,中工,11,5,6,富邦-新營,2023-06-02,9693
3188,鑫龍騰,6,0,6,富邦-新營,2023-06-02,9693
3260,威剛,7,1,6,富邦-新營,2023-06-02,9693
3306,鼎天,6,0,6,富邦-新營,2023-06-02,9693
6456,GIS-KY,6,0,6,富邦-新營,2023-06-02,9693
3704,合勤控,5,0,5,富邦-新營,2023-06-02,9693
00650L,復華香港正2,5,0,5,富邦-新營,2023-06-02,9693
1727,中華化,5,0,5,富邦-新營,2023-06-02,9693
2425,承啟,14,9,5,富邦-新營,2023-06-02,9693
4121,優盛,5,0,5,富邦-新營,2023-06-02,9693
5468,凱鈺,5,0,5,富邦-新營,2023-06-02,9693
6142,友勁,5,0,5,富邦-新營,2023-06-02,9693
6187,萬潤,5,0,5,富邦-新營,2023-06-02,9693
6188,廣明,19,14,5,富邦-新營,2023-06-02,9693
6606,建德工業,5,0,5,富邦-新營,2023-06-02,9693
8104,錸寶,5,0,5,富邦-新營,2023-06-02,9693
2317,鴻海,7,2,5,富邦-新營,2023-06-02,9693
6625,必應,5,0,5,富邦-新營,2023-06-02,9693
6806,森崴能源,109,0,109,富邦-新營,2023-06-05,9693
2353,宏��,61,5,56,富邦-新營,2023-06-05,9693
2618,長榮航,122,71,51,富邦-新營,2023-06-05,9693
00637L,元大滬深300正2,50,0,50,富邦-新營,2023-06-05,9693
2515,中工,75,30,45,富邦-新營,2023-06-05,9693
1785,光洋科,40,1,39,富邦-新營,2023-06-05,9693
00878,國泰永續高股息,51,15,36,富邦-新營,2023-06-05,9693
2889,國票金,28,0,28,富邦-新營,2023-06-05,9693
2356,英業達,24,1,23,富邦-新營,2023-06-05,9693
3231,緯創,28,7,21,富邦-新營,2023-06-05,9693
3362,先進光,50,31,19,富邦-新營,2023-06-05,9693
00919,群益台灣精選高息,19,0,19,富邦-新營,2023-06-05,9693
00857B,永豐20年美公債,18,0,18,富邦-新營,2023-06-05,9693
00680L,元大美債20正2,18,0,18,富邦-新營,2023-06-05,9693
3706,神達,34,17,17,富邦-新營,2023-06-05,9693
0056,元大高股息,18,1,17,富邦-新營,2023-06-05,9693
1218,泰山,16,0,16,富邦-新營,2023-06-05,9693
00720B,元大投資級公司債,15,0,15,富邦-新營,2023-06-05,9693
6282,康舒,39,24,15,富邦-新營,2023-06-05,9693
3406,玉晶光,18,3,15,富邦-新營,2023-06-05,9693
4931,新盛力,25,10,15,富邦-新營,2023-06-05,9693
2382,廣達,14,0,14,富邦-新營,2023-06-05,9693
2809,京城銀,14,0,14,富邦-新營,2023-06-05,9693
2883,凱基金,32,18,14,富邦-新營,2023-06-05,9693
5511,德昌,13,0,13,富邦-新營,2023-06-05,9693
6167,久正,12,0,12,富邦-新營,2023-06-05,9693
3346,麗清,11,0,11,富邦-新營,2023-06-05,9693
1503,士電,23,12,11,富邦-新營,2023-06-05,9693
00679B,元大美債20年,10,0,10,富邦-新營,2023-06-05,9693
00902,中信電池及儲能,10,0,10,富邦-新營,2023-06-05,9693
2349,錸德,10,0,10,富邦-新營,2023-06-05,9693
3050,鈺德,10,0,10,富邦-新營,2023-06-05,9693
3094,聯傑,10,0,10,富邦-新營,2023-06-05,9693
4121,優盛,10,0,10,富邦-新營,2023-06-05,9693
8358,金居,14,4,10,富邦-新營,2023-06-05,9693
3006,晶豪科,10,0,10,富邦-新營,2023-06-05,9693
3306,鼎天,12,2,10,富邦-新營,2023-06-05,9693
1603,華電,10,1,9,富邦-新營,2023-06-05,9693
5512,力麒,10,1,9,富邦-新營,2023-06-05,9693
2303,聯電,18,9,9,富邦-新營,2023-06-05,9693
2609,陽明,9,1,8,富邦-新營,2023-06-05,9693
2913,農林,8,0,8,富邦-新營,2023-06-05,9693
6112,邁達特,8,0,8,富邦-新營,2023-06-05,9693
2371,大同,14,6,8,富邦-新營,2023-06-05,9693
00882,中信中國高股息,12,4,8,富邦-新營,2023-06-05,9693
6118,建達,7,0,7,富邦-新營,2023-06-05,9693
6185,幃翔,10,3,7,富邦-新營,2023-06-05,9693
1529,樂事綠能,7,1,6,富邦-新營,2023-06-05,9693
1513,中興電,8,2,6,富邦-新營,2023-06-05,9693
00669R,國泰美國道瓊反1,6,0,6,富邦-新營,2023-06-05,9693
4543,萬在,111,2,109,富邦-新營,2023-06-06,9693
00927,群益半導體收益,100,0,100,富邦-新營,2023-06-06,9693
00679B,元大美債20年,89,0,89,富邦-新營,2023-06-06,9693
3231,緯創,45,6,39,富邦-新營,2023-06-06,9693
2402,毅嘉,34,2,32,富邦-新營,2023-06-06,9693
00680L,元大美債20正2,27,0,27,富邦-新營,2023-06-06,9693
1310,台苯,20,0,20,富邦-新營,2023-06-06,9693
1603,華電,20,0,20,富邦-新營,2023-06-06,9693
1611,中電,24,6,18,富邦-新營,2023-06-06,9693
6125,廣運,29,13,16,富邦-新營,2023-06-06,9693
00924,復華S＆P500成長,15,0,15,富邦-新營,2023-06-06,9693
3479,安勤,16,1,15,富邦-新營,2023-06-06,9693
6116,彩晶,37,22,15,富邦-新營,2023-06-06,9693
4906,正文,13,0,13,富邦-新營,2023-06-06,9693
00720B,元大投資級公司債,13,0,13,富邦-新營,2023-06-06,9693
00715L,期街口布蘭特正2,137,124,13,富邦-新營,2023-06-06,9693
2457,飛宏,23,11,12,富邦-新營,2023-06-06,9693
5284,jpp-KY,12,0,12,富邦-新營,2023-06-06,9693
8403,盛弘,19,7,12,富邦-新營,2023-06-06,9693
3058,立德,13,1,12,富邦-新營,2023-06-06,9693
00772B,中信高評級公司債,11,0,11,富邦-新營,2023-06-06,9693
2461,光群雷,11,0,11,富邦-新營,2023-06-06,9693
1218,泰山,10,0,10,富邦-新營,2023-06-06,9693
1605,華新,16,6,10,富邦-新營,2023-06-06,9693
2002,中鋼,10,0,10,富邦-新營,2023-06-06,9693
2801,彰銀,10,0,10,富邦-新營,2023-06-06,9693
3056,富華新,10,0,10,富邦-新營,2023-06-06,9693
5905,南仁湖,10,0,10,富邦-新營,2023-06-06,9693
6443,元晶,10,0,10,富邦-新營,2023-06-06,9693
3545,敦泰,10,0,10,富邦-新營,2023-06-06,9693
2498,宏達電,11,2,9,富邦-新營,2023-06-06,9693
1513,中興電,10,1,9,富邦-新營,2023-06-06,9693
4938,和碩,9,0,9,富邦-新營,2023-06-06,9693
00713,元大台灣高息低波,8,0,8,富邦-新營,2023-06-06,9693
2516,新建,8,0,8,富邦-新營,2023-06-06,9693
6163,華電網,8,0,8,富邦-新營,2023-06-06,9693
2303,聯電,10,3,7,富邦-新營,2023-06-06,9693
1514,亞力,8,1,7,富邦-新營,2023-06-06,9693
2390,云辰,7,0,7,富邦-新營,2023-06-06,9693
2489,瑞軒,12,5,7,富邦-新營,2023-06-06,9693
00751B,元大AAA至A公司債,6,0,6,富邦-新營,2023-06-06,9693
2337,旺宏,6,0,6,富邦-新營,2023-06-06,9693
3047,訊舟,6,0,6,富邦-新營,2023-06-06,9693
3714,富采,6,0,6,富邦-新營,2023-06-06,9693
5356,協益,6,0,6,富邦-新營,2023-06-06,9693
6182,合晶,10,4,6,富邦-新營,2023-06-06,9693
4979,華星光,7,1,6,富邦-新營,2023-06-06,9693
00878,國泰永續高股息,9,3,6,富邦-新營,2023-06-06,9693
1104,環泥,5,0,5,富邦-新營,2023-06-06,9693
6770,力積電,5,0,5,富邦-新營,2023-06-06,9693
2206,三陽工業,164,9,155,富邦-新營,2023-06-07,9693
00715L,期街口布蘭特正2,91,23,68,富邦-新營,2023-06-07,9693
2913,農林,62,0,62,富邦-新營,2023-06-07,9693
8076,伍豐,42,0,42,富邦-新營,2023-06-07,9693
00712,復華富時不動產,42,5,37,富邦-新營,2023-06-07,9693
6125,廣運,43,12,31,富邦-新營,2023-06-07,9693
2023,燁輝,30,0,30,富邦-新營,2023-06-07,9693
2618,長榮航,46,19,27,富邦-新營,2023-06-07,9693
3231,緯創,54,29,25,富邦-新營,2023-06-07,9693
1314,中石化,23,0,23,富邦-新營,2023-06-07,9693
2888,新光金,37,14,23,富邦-新營,2023-06-07,9693
5706,鳳凰,33,11,22,富邦-新營,2023-06-07,9693
00679B,元大美債20年,20,0,20,富邦-新營,2023-06-07,9693
3324,雙鴻,20,1,19,富邦-新營,2023-06-07,9693
3703,欣陸,19,0,19,富邦-新營,2023-06-07,9693
2401,凌陽,20,2,18,富邦-新營,2023-06-07,9693
8046,南電,31,14,17,富邦-新營,2023-06-07,9693
6233,旺玖,17,1,16,富邦-新營,2023-06-07,9693
00878,國泰永續高股息,27,12,15,富邦-新營,2023-06-07,9693
2353,宏��,18,3,15,富邦-新營,2023-06-07,9693
1504,東元,23,10,13,富邦-新營,2023-06-07,9693
2347,聯強,12,0,12,富邦-新營,2023-06-07,9693
2736,富野,12,0,12,富邦-新營,2023-06-07,9693
00885,富邦越南,14,3,11,富邦-新營,2023-06-07,9693
2889,國票金,10,0,10,富邦-新營,2023-06-07,9693
2520,冠德,10,0,10,富邦-新營,2023-06-07,9693
3027,盛達,17,7,10,富邦-新營,2023-06-07,9693
3624,光頡,11,1,10,富邦-新營,2023-06-07,9693
4114,健喬,12,2,10,富邦-新營,2023-06-07,9693
4564,元翎,10,0,10,富邦-新營,2023-06-07,9693
8038,長園科,10,0,10,富邦-新營,2023-06-07,9693
6248,沛波,10,1,9,富邦-新營,2023-06-07,9693
3325,旭品,13,5,8,富邦-新營,2023-06-07,9693
5009,榮剛,13,5,8,富邦-新營,2023-06-07,9693
3406,玉晶光,12,5,7,富邦-新營,2023-06-07,9693
1409,新纖,7,0,7,富邦-新營,2023-06-07,9693
3029,零壹,8,1,7,富邦-新營,2023-06-07,9693
6733,博晟生醫,7,0,7,富邦-新營,2023-06-07,9693
1605,華新,9,3,6,富邦-新營,2023-06-07,9693
2337,旺宏,6,0,6,富邦-新營,2023-06-07,9693
2504,國產,14,8,6,富邦-新營,2023-06-07,9693
3663,鑫科,6,0,6,富邦-新營,2023-06-07,9693
8028,昇陽半導體,11,5,6,富邦-新營,2023-06-07,9693
2603,長榮,10,4,6,富邦-新營,2023-06-07,9693
00639,富邦深100,5,0,5,富邦-新營,2023-06-07,9693
1514,亞力,8,3,5,富邦-新營,2023-06-07,9693
1608,華榮,183,178,5,富邦-新營,2023-06-07,9693
2399,映泰,6,1,5,富邦-新營,2023-06-07,9693
2615,萬海,8,3,5,富邦-新營,2023-06-07,9693
2705,六福,5,0,5,富邦-新營,2023-06-07,9693
00773B,中信優先金融債,250,0,250,富邦-新營,2023-06-08,9693
00919,群益台灣精選高息,106,3,103,富邦-新營,2023-06-08,9693
2892,第一金,100,0,100,富邦-新營,2023-06-08,9693
2634,漢翔,135,59,76,富邦-新營,2023-06-08,9693
00680L,元大美債20正2,67,0,67,富邦-新營,2023-06-08,9693
00687B,國泰20年美債,53,0,53,富邦-新營,2023-06-08,9693
1609,大亞,123,72,51,富邦-新營,2023-06-08,9693
00679B,元大美債20年,48,0,48,富邦-新營,2023-06-08,9693
00878,國泰永續高股息,65,20,45,富邦-新營,2023-06-08,9693
2618,長榮航,61,20,41,富邦-新營,2023-06-08,9693
0056,元大高股息,34,4,30,富邦-新營,2023-06-08,9693
00885,富邦越南,31,2,29,富邦-新營,2023-06-08,9693
00764B,群益25年美債,26,0,26,富邦-新營,2023-06-08,9693
2338,光罩,25,0,25,富邦-新營,2023-06-08,9693
1612,宏泰,28,5,23,富邦-新營,2023-06-08,9693
3038,全台,23,0,23,富邦-新營,2023-06-08,9693
1618,合機,22,1,21,富邦-新營,2023-06-08,9693
2457,飛宏,41,23,18,富邦-新營,2023-06-08,9693
2344,華邦電,27,10,17,富邦-新營,2023-06-08,9693
9933,中鼎,16,0,16,富邦-新營,2023-06-08,9693
1513,中興電,23,7,16,富邦-新營,2023-06-08,9693
00688L,國泰20年美債正2,15,0,15,富邦-新營,2023-06-08,9693
00795B,中信美國公債20年,14,0,14,富邦-新營,2023-06-08,9693
3029,零壹,14,0,14,富邦-新營,2023-06-08,9693
3545,敦泰,14,0,14,富邦-新營,2023-06-08,9693
1720,生達,14,1,13,富邦-新營,2023-06-08,9693
2420,新巨,13,0,13,富邦-新營,2023-06-08,9693
4931,新盛力,14,2,12,富邦-新營,2023-06-08,9693
1503,士電,23,11,12,富邦-新營,2023-06-08,9693
2882,國泰金,11,0,11,富邦-新營,2023-06-08,9693
1514,亞力,14,3,11,富邦-新營,2023-06-08,9693
1905,華紙,12,1,11,富邦-新營,2023-06-08,9693
2413,環科,11,0,11,富邦-新營,2023-06-08,9693
2706,第一店,16,5,11,富邦-新營,2023-06-08,9693
2889,國票金,11,0,11,富邦-新營,2023-06-08,9693
3406,玉晶光,11,1,10,富邦-新營,2023-06-08,9693
1217,愛之味,10,0,10,富邦-新營,2023-06-08,9693
1785,光洋科,10,0,10,富邦-新營,2023-06-08,9693
6122,擎邦,10,0,10,富邦-新營,2023-06-08,9693
8096,擎亞,10,0,10,富邦-新營,2023-06-08,9693
3481,群創,9,0,9,富邦-新營,2023-06-08,9693
2023,燁輝,10,1,9,富邦-新營,2023-06-08,9693
3374,精材,15,6,9,富邦-新營,2023-06-08,9693
00720B,元大投資級公司債,8,0,8,富邦-新營,2023-06-08,9693
2337,旺宏,8,0,8,富邦-新營,2023-06-08,9693
5340,建榮,8,0,8,富邦-新營,2023-06-08,9693
6174,安��,8,0,8,富邦-新營,2023-06-08,9693
00772B,中信高評級公司債,8,1,7,富邦-新營,2023-06-08,9693
1605,華新,29,22,7,富邦-新營,2023-06-08,9693
00664R,國泰臺灣加權反1,7,0,7,富邦-新營,2023-06-08,9693
2382,廣達,100,38,62,富邦-新營,2023-06-09,9693
6625,必應,84,31,53,富邦-新營,2023-06-09,9693
2323,中環,176,126,50,富邦-新營,2023-06-09,9693
1217,愛之味,50,0,50,富邦-新營,2023-06-09,9693
00919,群益台灣精選高息,60,12,48,富邦-新營,2023-06-09,9693
6122,擎邦,68,20,48,富邦-新營,2023-06-09,9693
00929,復華台灣科技優息,78,34,44,富邦-新營,2023-06-09,9693
00715L,期街口布蘭特正2,48,5,43,富邦-新營,2023-06-09,9693
00712,復華富時不動產,36,3,33,富邦-新營,2023-06-09,9693
6282,康舒,47,18,29,富邦-新營,2023-06-09,9693
2344,華邦電,40,16,24,富邦-新營,2023-06-09,9693
1609,大亞,44,20,24,富邦-新營,2023-06-09,9693
2705,六福,22,0,22,富邦-新營,2023-06-09,9693
2337,旺宏,17,0,17,富邦-新營,2023-06-09,9693
3374,精材,24,7,17,富邦-新營,2023-06-09,9693
5512,力麒,15,0,15,富邦-新營,2023-06-09,9693
6576,逸達,15,0,15,富邦-新營,2023-06-09,9693
2630,亞航,232,219,13,富邦-新營,2023-06-09,9693
2371,大同,15,3,12,富邦-新營,2023-06-09,9693
2495,普安,11,0,11,富邦-新營,2023-06-09,9693
3498,陽程,12,1,11,富邦-新營,2023-06-09,9693
1605,華新,14,3,11,富邦-新營,2023-06-09,9693
00895,富邦未來車,10,0,10,富邦-新營,2023-06-09,9693
2458,義隆,10,0,10,富邦-新營,2023-06-09,9693
2482,連宇,20,10,10,富邦-新營,2023-06-09,9693
2601,益航,16,6,10,富邦-新營,2023-06-09,9693
3024,憶聲,10,0,10,富邦-新營,2023-06-09,9693
5608,四維航,10,0,10,富邦-新營,2023-06-09,9693
8046,南電,24,14,10,富邦-新營,2023-06-09,9693
1104,環泥,11,1,10,富邦-新營,2023-06-09,9693
2801,彰銀,10,0,10,富邦-新營,2023-06-09,9693
8034,榮群,10,1,9,富邦-新營,2023-06-09,9693
2731,雄獅,17,9,8,富邦-新營,2023-06-09,9693
6770,力積電,8,0,8,富邦-新營,2023-06-09,9693
00882,中信中國高股息,10,2,8,富邦-新營,2023-06-09,9693
1456,怡華,12,4,8,富邦-新營,2023-06-09,9693
1513,中興電,8,0,8,富邦-新營,2023-06-09,9693
1612,宏泰,12,4,8,富邦-新營,2023-06-09,9693
2014,中鴻,8,0,8,富邦-新營,2023-06-09,9693
3703,欣陸,8,0,8,富邦-新營,2023-06-09,9693
3055,蔚華科,7,0,7,富邦-新營,2023-06-09,9693
5009,榮剛,7,0,7,富邦-新營,2023-06-09,9693
6712,長聖,7,0,7,富邦-新營,2023-06-09,9693
8038,長園科,9,2,7,富邦-新營,2023-06-09,9693
1560,中砂,7,0,7,富邦-新營,2023-06-09,9693
2618,長榮航,20,13,7,富邦-新營,2023-06-09,9693
00679B,元大美債20年,6,0,6,富邦-新營,2023-06-09,9693
2743,山富,17,11,6,富邦-新營,2023-06-09,9693
1529,樂事綠能,7,1,6,富邦-新營,2023-06-09,9693
1533,車王電,8,2,6,富邦-新營,2023-06-09,9693
00715L,期街口布蘭特正2,123,0,123,富邦-新營,2023-06-12,9693
2888,新光金,161,59,102,富邦-新營,2023-06-12,9693
5425,台半,101,23,78,富邦-新營,2023-06-12,9693
00712,復華富時不動產,42,1,41,富邦-新營,2023-06-12,9693
2705,六福,48,9,39,富邦-新營,2023-06-12,9693
00919,群益台灣精選高息,50,16,34,富邦-新營,2023-06-12,9693
00929,復華台灣科技優息,32,1,31,富邦-新營,2023-06-12,9693
2489,瑞軒,30,0,30,富邦-新營,2023-06-12,9693
00764B,群益25年美債,25,0,25,富邦-新營,2023-06-12,9693
1529,樂事綠能,37,12,25,富邦-新營,2023-06-12,9693
2495,普安,25,0,25,富邦-新營,2023-06-12,9693
3231,緯創,42,20,22,富邦-新營,2023-06-12,9693
3704,合勤控,23,1,22,富邦-新營,2023-06-12,9693
1905,華紙,22,1,21,富邦-新營,2023-06-12,9693
1605,華新,17,0,17,富邦-新營,2023-06-12,9693
2421,建準,19,3,16,富邦-新營,2023-06-12,9693
3078,僑威,19,3,16,富邦-新營,2023-06-12,9693
9958,世紀鋼,15,0,15,富邦-新營,2023-06-12,9693
5519,隆大,14,0,14,富邦-新營,2023-06-12,9693
5009,榮剛,17,4,13,富邦-新營,2023-06-12,9693
2323,中環,15,3,12,富邦-新營,2023-06-12,9693
2206,三陽工業,23,12,11,富邦-新營,2023-06-12,9693
1409,新纖,11,0,11,富邦-新營,2023-06-12,9693
00907,永豐優息存股,10,0,10,富邦-新營,2023-06-12,9693
2537,聯上發,10,0,10,富邦-新營,2023-06-12,9693
2834,臺企銀,10,0,10,富邦-新營,2023-06-12,9693
4306,炎洲,10,0,10,富邦-新營,2023-06-12,9693
6197,佳必琪,10,0,10,富邦-新營,2023-06-12,9693
6282,康舒,12,2,10,富邦-新營,2023-06-12,9693
9907,統一實,10,0,10,富邦-新營,2023-06-12,9693
3025,星通,11,2,9,富邦-新營,2023-06-12,9693
2801,彰銀,10,1,9,富邦-新營,2023-06-12,9693
3058,立德,19,10,9,富邦-新營,2023-06-12,9693
2382,廣達,18,9,9,富邦-新營,2023-06-12,9693
00713,元大台灣高息低波,9,1,8,富邦-新營,2023-06-12,9693
3576,聯合再生,11,3,8,富邦-新營,2023-06-12,9693
3594,磐儀,8,0,8,富邦-新營,2023-06-12,9693
4533,協易機,13,5,8,富邦-新營,2023-06-12,9693
4543,萬在,8,0,8,富邦-新營,2023-06-12,9693
5439,高技,8,0,8,富邦-新營,2023-06-12,9693
2356,英業達,25,18,7,富邦-新營,2023-06-12,9693
2882,國泰金,7,0,7,富邦-新營,2023-06-12,9693
2352,佳世達,11,4,7,富邦-新營,2023-06-12,9693
1618,合機,10,3,7,富邦-新營,2023-06-12,9693
00679B,元大美債20年,7,0,7,富邦-新營,2023-06-12,9693
1584,精剛,8,2,6,富邦-新營,2023-06-12,9693
3163,波若威,6,0,6,富邦-新營,2023-06-12,9693
3548,兆利,6,0,6,富邦-新營,2023-06-12,9693
6829,千附精密,6,0,6,富邦-新營,2023-06-12,9693
8271,宇瞻,6,0,6,富邦-新營,2023-06-12,9693
2888,新光金,154,19,135,富邦-新營,2023-06-13,9693
00715L,期街口布蘭特正2,124,4,120,富邦-新營,2023-06-13,9693
3078,僑威,209,117,92,富邦-新營,2023-06-13,9693
3032,偉訓,74,2,72,富邦-新營,2023-06-13,9693
00878,國泰永續高股息,69,20,49,富邦-新營,2023-06-13,9693
6116,彩晶,45,4,41,富邦-新營,2023-06-13,9693
2323,中環,48,8,40,富邦-新營,2023-06-13,9693
2380,虹光,37,0,37,富邦-新營,2023-06-13,9693
00927,群益半導體收益,36,0,36,富邦-新營,2023-06-13,9693
1605,華新,32,2,30,富邦-新營,2023-06-13,9693
2376,技嘉,62,38,24,富邦-新營,2023-06-13,9693
00919,群益台灣精選高息,21,0,21,富邦-新營,2023-06-13,9693
1504,東元,34,16,18,富邦-新營,2023-06-13,9693
00642U,期元大S＆P石油,17,0,17,富邦-新營,2023-06-13,9693
00885,富邦越南,17,0,17,富邦-新營,2023-06-13,9693
1612,宏泰,17,0,17,富邦-新營,2023-06-13,9693
2850,新產,15,0,15,富邦-新營,2023-06-13,9693
9958,世紀鋼,15,0,15,富邦-新營,2023-06-13,9693
3548,兆利,14,0,14,富邦-新營,2023-06-13,9693
5706,鳳凰,16,2,14,富邦-新營,2023-06-13,9693
1609,大亞,26,13,13,富邦-新營,2023-06-13,9693
1301,台塑,11,0,11,富邦-新營,2023-06-13,9693
2883,凱基金,15,5,10,富邦-新營,2023-06-13,9693
2329,華泰,10,0,10,富邦-新營,2023-06-13,9693
2883B,凱基金乙特,10,0,10,富邦-新營,2023-06-13,9693
3013,晟銘電,24,15,9,富邦-新營,2023-06-13,9693
6191,精成科,10,1,9,富邦-新營,2023-06-13,9693
2312,金寶,9,0,9,富邦-新營,2023-06-13,9693
8222,寶一,9,0,9,富邦-新營,2023-06-13,9693
00712,復華富時不動產,17,8,9,富邦-新營,2023-06-13,9693
00882,中信中國高股息,10,2,8,富邦-新營,2023-06-13,9693
2489,瑞軒,8,0,8,富邦-新營,2023-06-13,9693
4977,眾達-KY,8,0,8,富邦-新營,2023-06-13,9693
6282,康舒,9,1,8,富邦-新營,2023-06-13,9693
3002,歐格,7,0,7,富邦-新營,2023-06-13,9693
3356,奇偶,8,1,7,富邦-新營,2023-06-13,9693
6550,北極星藥業-KY,7,0,7,富邦-新營,2023-06-13,9693
2027,大成鋼,8,1,7,富邦-新營,2023-06-13,9693
1216,統一,6,0,6,富邦-新營,2023-06-13,9693
2375,凱美,6,0,6,富邦-新營,2023-06-13,9693
2882,國泰金,6,0,6,富邦-新營,2023-06-13,9693
5009,榮剛,9,3,6,富邦-新營,2023-06-13,9693
5511,德昌,6,0,6,富邦-新營,2023-06-13,9693
2301,光寶科,6,0,6,富邦-新營,2023-06-13,9693
00713,元大台灣高息低波,5,0,5,富邦-新營,2023-06-13,9693
1102,亞泥,5,0,5,富邦-新營,2023-06-13,9693
2362,藍天,5,0,5,富邦-新營,2023-06-13,9693
2371,大同,7,2,5,富邦-新營,2023-06-13,9693
2392,正崴,5,0,5,富邦-新營,2023-06-13,9693
2486,一詮,5,0,5,富邦-新營,2023-06-13,9693
2356,英業達,251,162,89,富邦-新營,2023-06-14,9693
2606,裕民,90,8,82,富邦-新營,2023-06-14,9693
3583,辛耘,82,0,82,富邦-新營,2023-06-14,9693
00633L,富邦上証正2,50,0,50,富邦-新營,2023-06-14,9693
00712,復華富時不動產,51,4,47,富邦-新營,2023-06-14,9693
2705,六福,44,5,39,富邦-新營,2023-06-14,9693
3011,今皓,33,0,33,富邦-新營,2023-06-14,9693
2888,新光金,88,56,32,富邦-新營,2023-06-14,9693
00680L,元大美債20正2,31,2,29,富邦-新營,2023-06-14,9693
8446,華研,29,1,28,富邦-新營,2023-06-14,9693
1718,中纖,27,0,27,富邦-新營,2023-06-14,9693
2601,益航,40,15,25,富邦-新營,2023-06-14,9693
00919,群益台灣精選高息,124,100,24,富邦-新營,2023-06-14,9693
3147,大綜,23,1,22,富邦-新營,2023-06-14,9693
3037,欣興,45,23,22,富邦-新營,2023-06-14,9693
00878,國泰永續高股息,36,15,21,富邦-新營,2023-06-14,9693
3050,鈺德,20,0,20,富邦-新營,2023-06-14,9693
9907,統一實,20,0,20,富邦-新營,2023-06-14,9693
6770,力積電,29,12,17,富邦-新營,2023-06-14,9693
00772B,中信高評級公司債,17,0,17,富邦-新營,2023-06-14,9693
2382,廣達,31,14,17,富邦-新營,2023-06-14,9693
2412,中華電,15,0,15,富邦-新營,2023-06-14,9693
1513,中興電,17,5,12,富邦-新營,2023-06-14,9693
00922,國泰台灣領袖50,13,1,12,富邦-新營,2023-06-14,9693
1524,耿鼎,12,0,12,富邦-新營,2023-06-14,9693
8049,晶采,12,0,12,富邦-新營,2023-06-14,9693
00679B,元大美債20年,11,0,11,富邦-新營,2023-06-14,9693
1101,台泥,11,0,11,富邦-新營,2023-06-14,9693
2323,中環,19,8,11,富邦-新營,2023-06-14,9693
3711,日月光投控,17,6,11,富邦-新營,2023-06-14,9693
1609,大亞,20,10,10,富邦-新營,2023-06-14,9693
2363,矽統,17,7,10,富邦-新營,2023-06-14,9693
2489,瑞軒,22,12,10,富邦-新營,2023-06-14,9693
3025,星通,22,12,10,富邦-新營,2023-06-14,9693
3049,精金,10,0,10,富邦-新營,2023-06-14,9693
3661,世芯-KY,10,0,10,富邦-新營,2023-06-14,9693
9958,世紀鋼,10,0,10,富邦-新營,2023-06-14,9693
6257,矽格,10,0,10,富邦-新營,2023-06-14,9693
6477,安集,10,0,10,富邦-新營,2023-06-14,9693
2449,京元電子,22,12,10,富邦-新營,2023-06-14,9693
1471,首利,10,1,9,富邦-新營,2023-06-14,9693
1522,堤維西,23,15,8,富邦-新營,2023-06-14,9693
2338,光罩,8,0,8,富邦-新營,2023-06-14,9693
2436,偉詮電,8,0,8,富邦-新營,2023-06-14,9693
5258,虹堡,32,24,8,富邦-新營,2023-06-14,9693
1319,東陽,8,0,8,富邦-新營,2023-06-14,9693
2390,云辰,9,2,7,富邦-新營,2023-06-14,9693
2405,輔信,18,11,7,富邦-新營,2023-06-14,9693
3128,昇銳,7,0,7,富邦-新營,2023-06-14,9693
3532,台勝科,9,2,7,富邦-新營,2023-06-14,9693
1522,堤維西,301,119,182,富邦-新營,2023-06-15,9693
00715L,期街口布蘭特正2,137,6,131,富邦-新營,2023-06-15,9693
3706,神達,217,130,87,富邦-新營,2023-06-15,9693
2888,新光金,108,37,71,富邦-新營,2023-06-15,9693
2913,農林,73,5,68,富邦-新營,2023-06-15,9693
00632R,元大台灣50反1,60,0,60,富邦-新營,2023-06-15,9693
8049,晶采,44,0,44,富邦-新營,2023-06-15,9693
3479,安勤,40,0,40,富邦-新營,2023-06-15,9693
00679B,元大美債20年,36,0,36,富邦-新營,2023-06-15,9693
4938,和碩,31,1,30,富邦-新營,2023-06-15,9693
0056,元大高股息,34,7,27,富邦-新營,2023-06-15,9693
00919,群益台灣精選高息,72,46,26,富邦-新營,2023-06-15,9693
5306,桂盟,26,0,26,富邦-新營,2023-06-15,9693
1528,恩德,20,0,20,富邦-新營,2023-06-15,9693
6116,彩晶,20,0,20,富邦-新營,2023-06-15,9693
3011,今皓,28,9,19,富邦-新營,2023-06-15,9693
1605,華新,19,0,19,富邦-新營,2023-06-15,9693
2317,鴻海,20,3,17,富邦-新營,2023-06-15,9693
3055,蔚華科,17,1,16,富邦-新營,2023-06-15,9693
1718,中纖,15,0,15,富邦-新營,2023-06-15,9693
6163,華電網,15,1,14,富邦-新營,2023-06-15,9693
2618,長榮航,339,326,13,富邦-新營,2023-06-15,9693
6770,力積電,13,0,13,富邦-新營,2023-06-15,9693
6282,康舒,21,9,12,富邦-新營,2023-06-15,9693
4973,廣穎,12,0,12,富邦-新營,2023-06-15,9693
8034,榮群,12,0,12,富邦-新營,2023-06-15,9693
1409,新纖,11,0,11,富邦-新營,2023-06-15,9693
3346,麗清,25,14,11,富邦-新營,2023-06-15,9693
3189,景碩,12,1,11,富邦-新營,2023-06-15,9693
2891,中信金,11,0,11,富邦-新營,2023-06-15,9693
2489,瑞軒,10,0,10,富邦-新營,2023-06-15,9693
2633,台灣高鐵,10,0,10,富邦-新營,2023-06-15,9693
2855,統一證,10,0,10,富邦-新營,2023-06-15,9693
3322,建舜電,10,0,10,富邦-新營,2023-06-15,9693
1307,三芳,10,1,9,富邦-新營,2023-06-15,9693
3013,晟銘電,44,35,9,富邦-新營,2023-06-15,9693
1504,東元,20,11,9,富邦-新營,2023-06-15,9693
3289,宜特,12,4,8,富邦-新營,2023-06-15,9693
2615,萬海,8,0,8,富邦-新營,2023-06-15,9693
1806,冠軍,10,2,8,富邦-新營,2023-06-15,9693
4121,優盛,8,0,8,富邦-新營,2023-06-15,9693
6142,友勁,10,2,8,富邦-新營,2023-06-15,9693
00751B,元大AAA至A公司債,7,0,7,富邦-新營,2023-06-15,9693
00885,富邦越南,7,0,7,富邦-新營,2023-06-15,9693
1611,中電,27,20,7,富邦-新營,2023-06-15,9693
2352,佳世達,10,4,6,富邦-新營,2023-06-15,9693
3443,創意,30,24,6,富邦-新營,2023-06-15,9693
1437,勤益控,6,0,6,富邦-新營,2023-06-15,9693
1618,合機,6,0,6,富邦-新營,2023-06-15,9693
2421,建準,12,6,6,富邦-新營,2023-06-15,9693
3706,神達,207,98,109,富邦-新營,2023-06-16,9693
2610,華航,220,135,85,富邦-新營,2023-06-16,9693
2888,新光金,112,28,84,富邦-新營,2023-06-16,9693
00919,群益台灣精選高息,65,0,65,富邦-新營,2023-06-16,9693
2618,長榮航,174,112,62,富邦-新營,2023-06-16,9693
1605,華新,64,16,48,富邦-新營,2023-06-16,9693
3498,陽程,43,0,43,富邦-新營,2023-06-16,9693
00712,復華富時不動產,42,6,36,富邦-新營,2023-06-16,9693
1611,中電,46,12,34,富邦-新營,2023-06-16,9693
2913,農林,34,0,34,富邦-新營,2023-06-16,9693
1905,華紙,45,15,30,富邦-新營,2023-06-16,9693
2892,第一金,35,9,26,富邦-新營,2023-06-16,9693
3037,欣興,30,4,26,富邦-新營,2023-06-16,9693
2371,大同,112,87,25,富邦-新營,2023-06-16,9693
8076,伍豐,23,0,23,富邦-新營,2023-06-16,9693
2201,裕隆,32,10,22,富邦-新營,2023-06-16,9693
00929,復華台灣科技優息,22,1,21,富邦-新營,2023-06-16,9693
00673R,期元大S＆P原油反1,15,0,15,富邦-新營,2023-06-16,9693
00713,元大台灣高息低波,15,2,13,富邦-新營,2023-06-16,9693
1319,東陽,12,0,12,富邦-新營,2023-06-16,9693
2332,友訊,18,6,12,富邦-新營,2023-06-16,9693
5443,均豪,12,0,12,富邦-新營,2023-06-16,9693
3481,群創,35,23,12,富邦-新營,2023-06-16,9693
6770,力積電,11,0,11,富邦-新營,2023-06-16,9693
2457,飛宏,23,12,11,富邦-新營,2023-06-16,9693
3548,兆利,12,1,11,富邦-新營,2023-06-16,9693
4538,大詠城,11,0,11,富邦-新營,2023-06-16,9693
5876,上海商銀,12,1,11,富邦-新營,2023-06-16,9693
6275,元山,15,4,11,富邦-新營,2023-06-16,9693
2850,新產,10,0,10,富邦-新營,2023-06-16,9693
1718,中纖,17,7,10,富邦-新營,2023-06-16,9693
2359,所羅門,31,21,10,富邦-新營,2023-06-16,9693
2834,臺企銀,11,1,10,富邦-新營,2023-06-16,9693
5864,致和證,10,0,10,富邦-新營,2023-06-16,9693
2301,光寶科,11,1,10,富邦-新營,2023-06-16,9693
3231,緯創,298,289,9,富邦-新營,2023-06-16,9693
3711,日月光投控,10,1,9,富邦-新營,2023-06-16,9693
2023,燁輝,10,1,9,富邦-新營,2023-06-16,9693
2105,正新,10,1,9,富邦-新營,2023-06-16,9693
2449,京元電子,10,1,9,富邦-新營,2023-06-16,9693
2886,兆豐金,12,3,9,富邦-新營,2023-06-16,9693
4510,高鋒,9,0,9,富邦-新營,2023-06-16,9693
00687B,國泰20年美債,8,0,8,富邦-新營,2023-06-16,9693
2489,瑞軒,15,7,8,富邦-新營,2023-06-16,9693
3024,憶聲,15,7,8,富邦-新營,2023-06-16,9693
6550,北極星藥業-KY,16,9,7,富邦-新營,2023-06-16,9693
1519,華城,20,13,7,富邦-新營,2023-06-16,9693
1409,新纖,8,1,7,富邦-新營,2023-06-16,9693
1529,樂事綠能,175,168,7,富邦-新營,2023-06-16,9693
2401,凌陽,9,2,7,富邦-新營,2023-06-16,9693
2610,華航,484,115,369,富邦-新營,2023-06-19,9693
2482,連宇,149,2,147,富邦-新營,2023-06-19,9693
00637L,元大滬深300正2,293,160,133,富邦-新營,2023-06-19,9693
00650L,復華香港正2,130,0,130,富邦-新營,2023-06-19,9693
2353,宏��,40,0,40,富邦-新營,2023-06-19,9693
2303,聯電,40,1,39,富邦-新營,2023-06-19,9693
00712,復華富時不動產,60,21,39,富邦-新營,2023-06-19,9693
1513,中興電,47,11,36,富邦-新營,2023-06-19,9693
2615,萬海,41,6,35,富邦-新營,2023-06-19,9693
2332,友訊,35,0,35,富邦-新營,2023-06-19,9693
2609,陽明,34,3,31,富邦-新營,2023-06-19,9693
2883,凱基金,53,23,30,富邦-新營,2023-06-19,9693
00929,復華台灣科技優息,27,0,27,富邦-新營,2023-06-19,9693
1528,恩德,26,2,24,富邦-新營,2023-06-19,9693
00919,群益台灣精選高息,22,0,22,富邦-新營,2023-06-19,9693
2603,長榮,25,4,21,富邦-新營,2023-06-19,9693
2606,裕民,21,0,21,富邦-新營,2023-06-19,9693
00903,富邦元宇宙,20,0,20,富邦-新營,2023-06-19,9693
00715L,期街口布蘭特正2,23,3,20,富邦-新營,2023-06-19,9693
6282,康舒,19,0,19,富邦-新營,2023-06-19,9693
4538,大詠城,20,1,19,富邦-新營,2023-06-19,9693
2630,亞航,124,108,16,富邦-新營,2023-06-19,9693
0056,元大高股息,23,8,15,富邦-新營,2023-06-19,9693
3231,緯創,24,9,15,富邦-新營,2023-06-19,9693
5443,均豪,15,0,15,富邦-新營,2023-06-19,9693
2324,仁寶,17,3,14,富邦-新營,2023-06-19,9693
6127,九豪,13,0,13,富邦-新營,2023-06-19,9693
6120,達運,54,41,13,富邦-新營,2023-06-19,9693
2458,義隆,11,0,11,富邦-新營,2023-06-19,9693
6116,彩晶,81,70,11,富邦-新營,2023-06-19,9693
2486,一詮,10,0,10,富邦-新營,2023-06-19,9693
2611,志信,10,0,10,富邦-新營,2023-06-19,9693
2820,華票,10,0,10,富邦-新營,2023-06-19,9693
2867,三商壽,10,0,10,富邦-新營,2023-06-19,9693
3022,威強電,10,0,10,富邦-新營,2023-06-19,9693
3078,僑威,15,5,10,富邦-新營,2023-06-19,9693
8021,尖點,10,0,10,富邦-新營,2023-06-19,9693
2388,威盛,9,0,9,富邦-新營,2023-06-19,9693
6235,華孚,25,16,9,富邦-新營,2023-06-19,9693
00882,中信中國高股息,9,0,9,富邦-新營,2023-06-19,9693
00924,復華S＆P500成長,10,1,9,富邦-新營,2023-06-19,9693
6266,泰詠,10,1,9,富邦-新營,2023-06-19,9693
3034,聯詠,9,0,9,富邦-新營,2023-06-19,9693
1806,冠軍,8,0,8,富邦-新營,2023-06-19,9693
3360,尚立,10,2,8,富邦-新營,2023-06-19,9693
4906,正文,8,0,8,富邦-新營,2023-06-19,9693
1609,大亞,13,6,7,富邦-新營,2023-06-19,9693
00673R,期元大S＆P原油反1,8,1,7,富邦-新營,2023-06-19,9693
1612,宏泰,7,0,7,富邦-新營,2023-06-19,9693
2371,大同,14,7,7,富邦-新營,2023-06-19,9693
2634,漢翔,471,128,343,富邦-新營,2023-06-20,9693
00664R,國泰臺灣加權反1,150,0,150,富邦-新營,2023-06-20,9693
00632R,元大台灣50反1,110,1,109,富邦-新營,2023-06-20,9693
00637L,元大滬深300正2,60,0,60,富邦-新營,2023-06-20,9693
1528,恩德,52,26,26,富邦-新營,2023-06-20,9693
00712,復華富時不動產,22,0,22,富邦-新營,2023-06-20,9693
2105,正新,21,0,21,富邦-新營,2023-06-20,9693
5009,榮剛,22,2,20,富邦-新營,2023-06-20,9693
1802,台玻,19,0,19,富邦-新營,2023-06-20,9693
5876,上海商銀,19,0,19,富邦-新營,2023-06-20,9693
2618,長榮航,22,4,18,富邦-新營,2023-06-20,9693
5905,南仁湖,20,2,18,富邦-新營,2023-06-20,9693
2739,寒舍,17,0,17,富邦-新營,2023-06-20,9693
2888,新光金,26,9,17,富邦-新營,2023-06-20,9693
3049,精金,16,0,16,富邦-新營,2023-06-20,9693
2356,英業達,82,67,15,富邦-新營,2023-06-20,9693
4720,德淵,15,0,15,富邦-新營,2023-06-20,9693
2409,友達,18,4,14,富邦-新營,2023-06-20,9693
8046,南電,14,0,14,富邦-新營,2023-06-20,9693
2323,中環,540,527,13,富邦-新營,2023-06-20,9693
4109,加捷生醫,13,0,13,富邦-新營,2023-06-20,9693
6244,茂迪,342,329,13,富邦-新營,2023-06-20,9693
00885,富邦越南,12,0,12,富邦-新營,2023-06-20,9693
4526,東台,12,0,12,富邦-新營,2023-06-20,9693
00929,復華台灣科技優息,13,1,12,富邦-新營,2023-06-20,9693
6443,元晶,14,3,11,富邦-新營,2023-06-20,9693
1905,華紙,11,0,11,富邦-新營,2023-06-20,9693
2382,廣達,16,6,10,富邦-新營,2023-06-20,9693
1417,嘉裕,10,0,10,富邦-新營,2023-06-20,9693
1432,大魯閣,10,0,10,富邦-新營,2023-06-20,9693
2337,旺宏,10,0,10,富邦-新營,2023-06-20,9693
2630,亞航,10,0,10,富邦-新營,2023-06-20,9693
3363,上詮,21,11,10,富邦-新營,2023-06-20,9693
8222,寶一,11,1,10,富邦-新營,2023-06-20,9693
0056,元大高股息,19,10,9,富邦-新營,2023-06-20,9693
3704,合勤控,9,0,9,富邦-新營,2023-06-20,9693
2454,聯發科,10,1,9,富邦-新營,2023-06-20,9693
2104,國際中橡,9,0,9,富邦-新營,2023-06-20,9693
3002,歐格,9,0,9,富邦-新營,2023-06-20,9693
5309,系統電,9,0,9,富邦-新營,2023-06-20,9693
1103,嘉泥,13,5,8,富邦-新營,2023-06-20,9693
1609,大亞,26,18,8,富邦-新營,2023-06-20,9693
3027,盛達,8,0,8,富邦-新營,2023-06-20,9693
6266,泰詠,8,1,7,富邦-新營,2023-06-20,9693
2425,承啟,7,0,7,富邦-新營,2023-06-20,9693
2883,凱基金,8,1,7,富邦-新營,2023-06-20,9693
3264,欣銓,8,1,7,富邦-新營,2023-06-20,9693
2867,三商壽,6,0,6,富邦-新營,2023-06-20,9693
2208,台船,6,0,6,富邦-新營,2023-06-20,9693
2889,國票金,6,0,6,富邦-新營,2023-06-20,9693
3231,緯創,209,28,181,富邦-新營,2023-06-21,9693
2913,農林,93,19,74,富邦-新營,2023-06-21,9693
5340,建榮,50,0,50,富邦-新營,2023-06-21,9693
00632R,元大台灣50反1,40,0,40,富邦-新營,2023-06-21,9693
4916,事欣科,43,5,38,富邦-新營,2023-06-21,9693
3706,神達,45,11,34,富邦-新營,2023-06-21,9693
2609,陽明,26,1,25,富邦-新營,2023-06-21,9693
2706,第一店,47,24,23,富邦-新營,2023-06-21,9693
1609,大亞,22,0,22,富邦-新營,2023-06-21,9693
3443,創意,30,8,22,富邦-新營,2023-06-21,9693
3705,永信,21,0,21,富邦-新營,2023-06-21,9693
2399,映泰,23,2,21,富邦-新營,2023-06-21,9693
00713,元大台灣高息低波,22,2,20,富邦-新營,2023-06-21,9693
2603,長榮,27,7,20,富邦-新營,2023-06-21,9693
5426,振發,30,10,20,富邦-新營,2023-06-21,9693
2885,元大金,20,1,19,富邦-新營,2023-06-21,9693
5388,中磊,18,0,18,富邦-新營,2023-06-21,9693
6120,達運,49,32,17,富邦-新營,2023-06-21,9693
2312,金寶,19,3,16,富邦-新營,2023-06-21,9693
00753L,中信中國50正2,15,0,15,富邦-新營,2023-06-21,9693
2201,裕隆,14,0,14,富邦-新營,2023-06-21,9693
2838,聯邦銀,14,0,14,富邦-新營,2023-06-21,9693
2705,六福,429,416,13,富邦-新營,2023-06-21,9693
00882,中信中國高股息,12,0,12,富邦-新營,2023-06-21,9693
3025,星通,13,1,12,富邦-新營,2023-06-21,9693
2408,南亞科,12,1,11,富邦-新營,2023-06-21,9693
8105,凌巨,12,1,11,富邦-新營,2023-06-21,9693
4915,致伸,10,0,10,富邦-新營,2023-06-21,9693
1513,中興電,13,3,10,富邦-新營,2023-06-21,9693
1337,再生-KY,10,0,10,富邦-新營,2023-06-21,9693
3252,海灣,10,0,10,富邦-新營,2023-06-21,9693
3306,鼎天,10,0,10,富邦-新營,2023-06-21,9693
3550,聯穎,10,0,10,富邦-新營,2023-06-21,9693
00892,富邦台灣半導體,9,0,9,富邦-新營,2023-06-21,9693
2889,國票金,9,0,9,富邦-新營,2023-06-21,9693
1103,嘉泥,10,1,9,富邦-新營,2023-06-21,9693
3027,盛達,30,21,9,富邦-新營,2023-06-21,9693
3715,定穎投控,11,2,9,富邦-新營,2023-06-21,9693
2323,中環,145,137,8,富邦-新營,2023-06-21,9693
3029,零壹,23,15,8,富邦-新營,2023-06-21,9693
6462,神盾,8,0,8,富邦-新營,2023-06-21,9693
2337,旺宏,7,0,7,富邦-新營,2023-06-21,9693
6441,廣錠,7,0,7,富邦-新營,2023-06-21,9693
2504,國產,7,0,7,富邦-新營,2023-06-21,9693
5704,老爺知,7,0,7,富邦-新營,2023-06-21,9693
2382,廣達,24,17,7,富邦-新營,2023-06-21,9693
2409,友達,20,13,7,富邦-新營,2023-06-21,9693
2748,雲品,17,11,6,富邦-新營,2023-06-21,9693
8222,寶一,6,0,6,富邦-新營,2023-06-21,9693
2457,飛宏,14,8,6,富邦-新營,2023-06-21,9693
1907,永豐餘,534,353,181,富邦-新營,2023-06-26,9693
00715L,期街口布蘭特正2,180,5,175,富邦-新營,2023-06-26,9693
2618,長榮航,163,25,138,富邦-新營,2023-06-26,9693
00637L,元大滬深300正2,131,0,131,富邦-新營,2023-06-26,9693
3231,緯創,231,118,113,富邦-新營,2023-06-26,9693
4123,晟德,91,0,91,富邦-新營,2023-06-26,9693
9105,泰金寶-DR,81,2,79,富邦-新營,2023-06-26,9693
2883,凱基金,45,0,45,富邦-新營,2023-06-26,9693
00929,復華台灣科技優息,42,6,36,富邦-新營,2023-06-26,9693
2382,廣達,34,2,32,富邦-新營,2023-06-26,9693
6282,康舒,31,0,31,富邦-新營,2023-06-26,9693
00878,國泰永續高股息,26,0,26,富邦-新營,2023-06-26,9693
3481,群創,40,16,24,富邦-新營,2023-06-26,9693
1504,東元,24,0,24,富邦-新營,2023-06-26,9693
1905,華紙,74,50,24,富邦-新營,2023-06-26,9693
2892,第一金,20,0,20,富邦-新營,2023-06-26,9693
1906,寶隆,20,0,20,富邦-新營,2023-06-26,9693
2601,益航,20,1,19,富邦-新營,2023-06-26,9693
3363,上詮,21,2,19,富邦-新營,2023-06-26,9693
3049,精金,20,2,18,富邦-新營,2023-06-26,9693
2323,中環,27,12,15,富邦-新營,2023-06-26,9693
1605,華新,18,3,15,富邦-新營,2023-06-26,9693
2609,陽明,15,0,15,富邦-新營,2023-06-26,9693
2303,聯電,34,21,13,富邦-新營,2023-06-26,9693
1616,億泰,23,10,13,富邦-新營,2023-06-26,9693
2002,中鋼,13,0,13,富邦-新營,2023-06-26,9693
3032,偉訓,13,0,13,富邦-新營,2023-06-26,9693
6217,中探針,14,1,13,富邦-新營,2023-06-26,9693
2482,連宇,12,0,12,富邦-新營,2023-06-26,9693
6243,迅杰,15,3,12,富邦-新營,2023-06-26,9693
2356,英業達,62,51,11,富邦-新營,2023-06-26,9693
5465,富驊,11,0,11,富邦-新營,2023-06-26,9693
00882,中信中國高股息,11,0,11,富邦-新營,2023-06-26,9693
00664R,國泰臺灣加權反1,10,0,10,富邦-新營,2023-06-26,9693
00642U,期元大S＆P石油,10,0,10,富邦-新營,2023-06-26,9693
00632R,元大台灣50反1,10,0,10,富邦-新營,2023-06-26,9693
1711,永光,10,0,10,富邦-新營,2023-06-26,9693
1785,光洋科,10,0,10,富邦-新營,2023-06-26,9693
5426,振發,10,0,10,富邦-新營,2023-06-26,9693
6179,亞通,10,0,10,富邦-新營,2023-06-26,9693
6265,方土昶,10,0,10,富邦-新營,2023-06-26,9693
6125,廣運,125,115,10,富邦-新營,2023-06-26,9693
4915,致伸,10,1,9,富邦-新營,2023-06-26,9693
2340,台亞,21,12,9,富邦-新營,2023-06-26,9693
00712,復華富時不動產,22,14,8,富邦-新營,2023-06-26,9693
0056,元大高股息,8,0,8,富邦-新營,2023-06-26,9693
1437,勤益控,8,0,8,富邦-新營,2023-06-26,9693
2468,華經,8,0,8,富邦-新營,2023-06-26,9693
2913,農林,73,65,8,富邦-新營,2023-06-26,9693
2453,凌群,7,0,7,富邦-新營,2023-06-26,9693
3481,群創,93,2,91,富邦-新營,2023-06-27,9693
1402,遠東新,62,0,62,富邦-新營,2023-06-27,9693
2303,聯電,55,0,55,富邦-新營,2023-06-27,9693
1471,首利,54,1,53,富邦-新營,2023-06-27,9693
1785,光洋科,60,15,45,富邦-新營,2023-06-27,9693
2890,永豐金,40,0,40,富邦-新營,2023-06-27,9693
2409,友達,46,8,38,富邦-新營,2023-06-27,9693
4123,晟德,38,6,32,富邦-新營,2023-06-27,9693
0056,元大高股息,31,4,27,富邦-新營,2023-06-27,9693
1718,中纖,26,0,26,富邦-新營,2023-06-27,9693
2883,凱基金,26,0,26,富邦-新營,2023-06-27,9693
5512,力麒,26,0,26,富邦-新營,2023-06-27,9693
2353,宏��,24,0,24,富邦-新營,2023-06-27,9693
00637L,元大滬深300正2,20,0,20,富邦-新營,2023-06-27,9693
00753L,中信中國50正2,20,0,20,富邦-新營,2023-06-27,9693
1231,聯華食,20,0,20,富邦-新營,2023-06-27,9693
2427,三商電,34,14,20,富邦-新營,2023-06-27,9693
2845,遠東銀,20,0,20,富邦-新營,2023-06-27,9693
00751B,元大AAA至A公司債,18,0,18,富邦-新營,2023-06-27,9693
8046,南電,16,0,16,富邦-新營,2023-06-27,9693
00929,復華台灣科技優息,25,10,15,富邦-新營,2023-06-27,9693
2382,廣達,15,1,14,富邦-新營,2023-06-27,9693
4543,萬在,13,0,13,富邦-新營,2023-06-27,9693
6558,興能高,13,0,13,富邦-新營,2023-06-27,9693
3078,僑威,19,7,12,富邦-新營,2023-06-27,9693
2104,國際中橡,12,0,12,富邦-新營,2023-06-27,9693
6120,達運,12,0,12,富邦-新營,2023-06-27,9693
2388,威盛,13,2,11,富邦-新營,2023-06-27,9693
00919,群益台灣精選高息,10,0,10,富邦-新營,2023-06-27,9693
00878,國泰永續高股息,57,47,10,富邦-新營,2023-06-27,9693
1533,車王電,11,1,10,富邦-新營,2023-06-27,9693
2365,昆盈,11,1,10,富邦-新營,2023-06-27,9693
2392,正崴,10,0,10,富邦-新營,2023-06-27,9693
3002,歐格,10,0,10,富邦-新營,2023-06-27,9693
3083,網龍,10,0,10,富邦-新營,2023-06-27,9693
3322,建舜電,10,0,10,富邦-新營,2023-06-27,9693
1609,大亞,17,8,9,富邦-新營,2023-06-27,9693
2356,英業達,28,19,9,富邦-新營,2023-06-27,9693
6276,安鈦克,61,52,9,富邦-新營,2023-06-27,9693
5706,鳳凰,8,0,8,富邦-新營,2023-06-27,9693
1608,華榮,9,1,8,富邦-新營,2023-06-27,9693
2468,華經,10,2,8,富邦-新營,2023-06-27,9693
6160,欣技,8,0,8,富邦-新營,2023-06-27,9693
8069,元太,11,3,8,富邦-新營,2023-06-27,9693
1734,杏輝,57,50,7,富邦-新營,2023-06-27,9693
1905,華紙,7,0,7,富邦-新營,2023-06-27,9693
2457,飛宏,13,6,7,富邦-新營,2023-06-27,9693
3038,全台,11,4,7,富邦-新營,2023-06-27,9693
6188,廣明,35,28,7,富邦-新營,2023-06-27,9693
9105,泰金寶-DR,7,0,7,富邦-新營,2023-06-27,9693
2618,長榮航,394,36,358,富邦-新營,2023-06-28,9693
00715L,期街口布蘭特正2,180,90,90,富邦-新營,2023-06-28,9693
2382,廣達,99,16,83,富邦-新營,2023-06-28,9693
2344,華邦電,55,1,54,富邦-新營,2023-06-28,9693
5388,中磊,64,20,44,富邦-新營,2023-06-28,9693
1605,華新,57,15,42,富邦-新營,2023-06-28,9693
00893,國泰智能電動車,45,5,40,富邦-新營,2023-06-28,9693
3715,定穎投控,33,2,31,富邦-新營,2023-06-28,9693
2801,彰銀,30,0,30,富邦-新營,2023-06-28,9693
2409,友達,33,4,29,富邦-新營,2023-06-28,9693
2850,新產,25,0,25,富邦-新營,2023-06-28,9693
2609,陽明,31,6,25,富邦-新營,2023-06-28,9693
2633,台灣高鐵,23,0,23,富邦-新營,2023-06-28,9693
4123,晟德,24,2,22,富邦-新營,2023-06-28,9693
1319,東陽,19,2,17,富邦-新營,2023-06-28,9693
4916,事欣科,17,0,17,富邦-新營,2023-06-28,9693
2356,英業達,24,8,16,富邦-新營,2023-06-28,9693
1718,中纖,12,0,12,富邦-新營,2023-06-28,9693
2412,中華電,12,0,12,富邦-新營,2023-06-28,9693
2634,漢翔,19,7,12,富邦-新營,2023-06-28,9693
2883,凱基金,11,0,11,富邦-新營,2023-06-28,9693
00642U,期元大S＆P石油,11,0,11,富邦-新營,2023-06-28,9693
00929,復華台灣科技優息,10,0,10,富邦-新營,2023-06-28,9693
6276,安鈦克,83,73,10,富邦-新營,2023-06-28,9693
2104,國際中橡,10,0,10,富邦-新營,2023-06-28,9693
2436,偉詮電,10,0,10,富邦-新營,2023-06-28,9693
4113,聯上,10,0,10,富邦-新營,2023-06-28,9693
4510,高鋒,10,0,10,富邦-新營,2023-06-28,9693
2332,友訊,18,9,9,富邦-新營,2023-06-28,9693
5426,振發,8,0,8,富邦-新營,2023-06-28,9693
6282,康舒,8,0,8,富邦-新營,2023-06-28,9693
4106,雃博,7,0,7,富邦-新營,2023-06-28,9693
1513,中興電,21,14,7,富邦-新營,2023-06-28,9693
1504,東元,14,7,7,富邦-新營,2023-06-28,9693
4747,強生,8,1,7,富邦-新營,2023-06-28,9693
2352,佳世達,7,0,7,富邦-新營,2023-06-28,9693
0056,元大高股息,10,4,6,富邦-新營,2023-06-28,9693
00720B,元大投資級公司債,6,0,6,富邦-新營,2023-06-28,9693
3058,立德,6,0,6,富邦-新營,2023-06-28,9693
1616,億泰,6,0,6,富邦-新營,2023-06-28,9693
2312,金寶,11,5,6,富邦-新營,2023-06-28,9693
3205,佰研,6,0,6,富邦-新營,2023-06-28,9693
8033,雷虎,8,2,6,富邦-新營,2023-06-28,9693
2340,台亞,8,2,6,富邦-新營,2023-06-28,9693
2603,長榮,18,13,5,富邦-新營,2023-06-28,9693
00762,元大全球AI,5,0,5,富邦-新營,2023-06-28,9693
1303,南亞,5,0,5,富邦-新營,2023-06-28,9693
1608,華榮,10,5,5,富邦-新營,2023-06-28,9693
2002,中鋼,6,1,5,富邦-新營,2023-06-28,9693
3002,歐格,5,0,5,富邦-新營,2023-06-28,9693
00715L,期街口布蘭特正2,89,10,79,富邦-新營,2023-06-29,9693
00929,復華台灣科技優息,77,0,77,富邦-新營,2023-06-29,9693
00637L,元大滬深300正2,55,0,55,富邦-新營,2023-06-29,9693
1605,華新,35,3,32,富邦-新營,2023-06-29,9693
00650L,復華香港正2,30,0,30,富邦-新營,2023-06-29,9693
2498,宏達電,29,3,26,富邦-新營,2023-06-29,9693
2317,鴻海,22,2,20,富邦-新營,2023-06-29,9693
2009,第一銅,20,0,20,富邦-新營,2023-06-29,9693
3711,日月光投控,20,1,19,富邦-新營,2023-06-29,9693
2889,國票金,14,0,14,富邦-新營,2023-06-29,9693
1446,宏和,14,0,14,富邦-新營,2023-06-29,9693
3481,群創,28,14,14,富邦-新營,2023-06-29,9693
5512,力麒,14,0,14,富邦-新營,2023-06-29,9693
2419,仲琦,24,12,12,富邦-新營,2023-06-29,9693
3013,晟銘電,23,11,12,富邦-新營,2023-06-29,9693
8072,陞泰,12,0,12,富邦-新營,2023-06-29,9693
4104,佳醫,22,10,12,富邦-新營,2023-06-29,9693
00919,群益台灣精選高息,10,0,10,富邦-新營,2023-06-29,9693
1319,東陽,10,0,10,富邦-新營,2023-06-29,9693
2353,宏��,10,0,10,富邦-新營,2023-06-29,9693
2431,聯昌,10,0,10,富邦-新營,2023-06-29,9693
2891,中信金,10,0,10,富邦-新營,2023-06-29,9693
2913,農林,25,15,10,富邦-新營,2023-06-29,9693
3205,佰研,10,0,10,富邦-新營,2023-06-29,9693
3294,英濟,10,0,10,富邦-新營,2023-06-29,9693
2324,仁寶,12,2,10,富邦-新營,2023-06-29,9693
0056,元大高股息,13,4,9,富邦-新營,2023-06-29,9693
5425,台半,10,1,9,富邦-新營,2023-06-29,9693
00751B,元大AAA至A公司債,9,0,9,富邦-新營,2023-06-29,9693
2002,中鋼,9,0,9,富邦-新營,2023-06-29,9693
6282,康舒,9,0,9,富邦-新營,2023-06-29,9693
2888,新光金,9,1,8,富邦-新營,2023-06-29,9693
2609,陽明,11,3,8,富邦-新營,2023-06-29,9693
4123,晟德,8,0,8,富邦-新營,2023-06-29,9693
4967,十銓,15,7,8,富邦-新營,2023-06-29,9693
6589,台康生技,9,1,8,富邦-新營,2023-06-29,9693
00712,復華富時不動產,7,0,7,富邦-新營,2023-06-29,9693
1471,首利,7,0,7,富邦-新營,2023-06-29,9693
1504,東元,11,4,7,富邦-新營,2023-06-29,9693
2412,中華電,7,0,7,富邦-新營,2023-06-29,9693
2409,友達,7,1,6,富邦-新營,2023-06-29,9693
3005,神基,6,0,6,富邦-新營,2023-06-29,9693
4157,太景*-KY,17,11,6,富邦-新營,2023-06-29,9693
6005,群益證,6,0,6,富邦-新營,2023-06-29,9693
6796,晉弘,6,0,6,富邦-新營,2023-06-29,9693
6245,立端,5,0,5,富邦-新營,2023-06-29,9693
1437,勤益控,5,0,5,富邦-新營,2023-06-29,9693
1718,中纖,5,0,5,富邦-新營,2023-06-29,9693
2312,金寶,5,0,5,富邦-新營,2023-06-29,9693
2734,易飛網,5,0,5,富邦-新營,2023-06-29,9693
2801,彰銀,163,0,163,富邦-新營,2023-06-30,9693
1528,恩德,61,1,60,富邦-新營,2023-06-30,9693
00632R,元大台灣50反1,60,1,59,富邦-新營,2023-06-30,9693
00680L,元大美債20正2,52,0,52,富邦-新營,2023-06-30,9693
6276,安鈦克,50,12,38,富邦-新營,2023-06-30,9693
3322,建舜電,30,0,30,富邦-新營,2023-06-30,9693
2610,華航,36,9,27,富邦-新營,2023-06-30,9693
2312,金寶,24,1,23,富邦-新營,2023-06-30,9693
2344,華邦電,23,1,22,富邦-新營,2023-06-30,9693
6625,必應,22,0,22,富邦-新營,2023-06-30,9693
5425,台半,22,0,22,富邦-新營,2023-06-30,9693
2890,永豐金,22,1,21,富邦-新營,2023-06-30,9693
2892,第一金,21,0,21,富邦-新營,2023-06-30,9693
3715,定穎投控,42,21,21,富邦-新營,2023-06-30,9693
4414,如興,30,10,20,富邦-新營,2023-06-30,9693
4747,強生,20,0,20,富邦-新營,2023-06-30,9693
3481,群創,36,20,16,富邦-新營,2023-06-30,9693
2419,仲琦,26,10,16,富邦-新營,2023-06-30,9693
2468,華經,15,0,15,富邦-新營,2023-06-30,9693
2885,元大金,15,0,15,富邦-新營,2023-06-30,9693
1605,華新,14,1,13,富邦-新營,2023-06-30,9693
00929,復華台灣科技優息,51,38,13,富邦-新營,2023-06-30,9693
2002,中鋼,13,0,13,富邦-新營,2023-06-30,9693
1217,愛之味,15,2,13,富邦-新營,2023-06-30,9693
1611,中電,12,0,12,富邦-新營,2023-06-30,9693
2317,鴻海,23,11,12,富邦-新營,2023-06-30,9693
2323,中環,74,63,11,富邦-新營,2023-06-30,9693
4533,協易機,111,100,11,富邦-新營,2023-06-30,9693
8050,廣積,21,10,11,富邦-新營,2023-06-30,9693
2880,華南金,10,0,10,富邦-新營,2023-06-30,9693
3049,精金,10,0,10,富邦-新營,2023-06-30,9693
3163,波若威,10,0,10,富邦-新營,2023-06-30,9693
3252,海灣,10,0,10,富邦-新營,2023-06-30,9693
3564,其陽,10,0,10,富邦-新營,2023-06-30,9693
3706,神達,11,1,10,富邦-新營,2023-06-30,9693
4123,晟德,11,1,10,富邦-新營,2023-06-30,9693
4720,德淵,10,0,10,富邦-新營,2023-06-30,9693
5512,力麒,10,0,10,富邦-新營,2023-06-30,9693
6245,立端,10,0,10,富邦-新營,2023-06-30,9693
6188,廣明,19,9,10,富邦-新營,2023-06-30,9693
2356,英業達,11,2,9,富邦-新營,2023-06-30,9693
2324,仁寶,9,0,9,富邦-新營,2023-06-30,9693
3363,上詮,9,1,8,富邦-新營,2023-06-30,9693
3044,健鼎,10,2,8,富邦-新營,2023-06-30,9693
3593,力銘,7,0,7,富邦-新營,2023-06-30,9693
6153,嘉聯益,29,22,7,富邦-新營,2023-06-30,9693
00679B,元大美債20年,6,0,6,富邦-新營,2023-06-30,9693
8049,晶采,6,0,6,富邦-新營,2023-06-30,9693
1301,台塑,6,0,6,富邦-新營,2023-06-30,9693
1533,車王電,68,62,6,富邦-新營,2023-06-30,9693
00773B,中信優先金融債,239,0,239,富邦-新營,2023-07-03,9693
00772B,中信高評級公司債,122,0,122,富邦-新營,2023-07-03,9693
6806,森崴能源,61,2,59,富邦-新營,2023-07-03,9693
2468,華經,77,20,57,富邦-新營,2023-07-03,9693
2801,彰銀,53,0,53,富邦-新營,2023-07-03,9693
5608,四維航,50,3,47,富邦-新營,2023-07-03,9693
00877,復華中國5G,39,0,39,富邦-新營,2023-07-03,9693
6116,彩晶,30,0,30,富邦-新營,2023-07-03,9693
8358,金居,30,0,30,富邦-新營,2023-07-03,9693
2303,聯電,28,1,27,富邦-新營,2023-07-03,9693
2317,鴻海,32,11,21,富邦-新營,2023-07-03,9693
00878,國泰永續高股息,37,17,20,富邦-新營,2023-07-03,9693
3564,其陽,20,0,20,富邦-新營,2023-07-03,9693
2427,三商電,122,103,19,富邦-新營,2023-07-03,9693
6235,華孚,45,26,19,富邦-新營,2023-07-03,9693
00919,群益台灣精選高息,20,2,18,富邦-新營,2023-07-03,9693
6279,胡連,17,0,17,富邦-新營,2023-07-03,9693
3231,緯創,138,122,16,富邦-新營,2023-07-03,9693
3481,群創,18,3,15,富邦-新營,2023-07-03,9693
6163,華電網,15,0,15,富邦-新營,2023-07-03,9693
1514,亞力,23,9,14,富邦-新營,2023-07-03,9693
2206,三陽工業,12,0,12,富邦-新營,2023-07-03,9693
2328,廣宇,12,0,12,富邦-新營,2023-07-03,9693
4160,訊聯基因,12,0,12,富邦-新營,2023-07-03,9693
2617,台航,11,0,11,富邦-新營,2023-07-03,9693
1460,宏遠,10,0,10,富邦-新營,2023-07-03,9693
2392,正崴,10,0,10,富邦-新營,2023-07-03,9693
3207,耀勝,10,0,10,富邦-新營,2023-07-03,9693
4414,如興,10,0,10,富邦-新營,2023-07-03,9693
6213,聯茂,10,0,10,富邦-新營,2023-07-03,9693
6275,元山,10,0,10,富邦-新營,2023-07-03,9693
8215,明基材,10,0,10,富邦-新營,2023-07-03,9693
4114,健喬,10,0,10,富邦-新營,2023-07-03,9693
8110,華東,9,0,9,富邦-新營,2023-07-03,9693
5009,榮剛,16,8,8,富邦-新營,2023-07-03,9693
1437,勤益控,8,0,8,富邦-新營,2023-07-03,9693
1616,億泰,8,0,8,富邦-新營,2023-07-03,9693
4162,智擎,12,4,8,富邦-新營,2023-07-03,9693
4906,正文,9,1,8,富邦-新營,2023-07-03,9693
8926,台汽電,8,0,8,富邦-新營,2023-07-03,9693
1319,東陽,8,1,7,富邦-新營,2023-07-03,9693
1909,榮成,8,1,7,富邦-新營,2023-07-03,9693
2201,裕隆,14,7,7,富邦-新營,2023-07-03,9693
2482,連宇,7,0,7,富邦-新營,2023-07-03,9693
3306,鼎天,10,3,7,富邦-新營,2023-07-03,9693
4564,元翎,9,2,7,富邦-新營,2023-07-03,9693
2356,英業達,32,25,7,富邦-新營,2023-07-03,9693
1570,力肯,7,1,6,富邦-新營,2023-07-03,9693
2331,精英,123,117,6,富邦-新營,2023-07-03,9693
2332,友訊,8,2,6,富邦-新營,2023-07-03,9693
00715L,期街口布蘭特正2,100,26,74,富邦-新營,2023-07-04,9693
2634,漢翔,69,8,61,富邦-新營,2023-07-04,9693
2801,彰銀,53,0,53,富邦-新營,2023-07-04,9693
0056,元大高股息,53,9,44,富邦-新營,2023-07-04,9693
3564,其陽,35,0,35,富邦-新營,2023-07-04,9693
2317,鴻海,39,6,33,富邦-新營,2023-07-04,9693
2883,凱基金,31,0,31,富邦-新營,2023-07-04,9693
2618,長榮航,103,76,27,富邦-新營,2023-07-04,9693
00929,復華台灣科技優息,25,1,24,富邦-新營,2023-07-04,9693
1785,光洋科,22,1,21,富邦-新營,2023-07-04,9693
2409,友達,21,0,21,富邦-新營,2023-07-04,9693
6578,達邦蛋白,21,0,21,富邦-新營,2023-07-04,9693
2392,正崴,20,0,20,富邦-新營,2023-07-04,9693
2890,永豐金,20,0,20,富邦-新營,2023-07-04,9693
3056,富華新,22,2,20,富邦-新營,2023-07-04,9693
2603,長榮,52,33,19,富邦-新營,2023-07-04,9693
3481,群創,30,11,19,富邦-新營,2023-07-04,9693
2352,佳世達,20,2,18,富邦-新營,2023-07-04,9693
2353,宏��,15,0,15,富邦-新營,2023-07-04,9693
4414,如興,20,5,15,富邦-新營,2023-07-04,9693
2363,矽統,14,0,14,富邦-新營,2023-07-04,9693
2891,中信金,14,0,14,富邦-新營,2023-07-04,9693
6125,廣運,15,2,13,富邦-新營,2023-07-04,9693
2892,第一金,15,2,13,富邦-新營,2023-07-04,9693
4157,太景*-KY,17,5,12,富邦-新營,2023-07-04,9693
1907,永豐餘,12,0,12,富邦-新營,2023-07-04,9693
4155,訊映,14,3,11,富邦-新營,2023-07-04,9693
1504,東元,12,1,11,富邦-新營,2023-07-04,9693
5512,力麒,11,0,11,富邦-新營,2023-07-04,9693
6288,聯嘉,13,2,11,富邦-新營,2023-07-04,9693
8926,台汽電,11,0,11,富邦-新營,2023-07-04,9693
00632R,元大台灣50反1,10,0,10,富邦-新營,2023-07-04,9693
00892,富邦台灣半導體,10,0,10,富邦-新營,2023-07-04,9693
1104,環泥,10,0,10,富邦-新營,2023-07-04,9693
1319,東陽,10,0,10,富邦-新營,2023-07-04,9693
2002,中鋼,16,6,10,富邦-新營,2023-07-04,9693
2337,旺宏,10,0,10,富邦-新營,2023-07-04,9693
2423,固緯,10,0,10,富邦-新營,2023-07-04,9693
3252,海灣,10,0,10,富邦-新營,2023-07-04,9693
6216,居易,10,0,10,富邦-新營,2023-07-04,9693
6112,邁達特,14,4,10,富邦-新營,2023-07-04,9693
2323,中環,174,164,10,富邦-新營,2023-07-04,9693
2014,中鴻,10,1,9,富邦-新營,2023-07-04,9693
6657,華安,9,0,9,富邦-新營,2023-07-04,9693
3078,僑威,8,0,8,富邦-新營,2023-07-04,9693
1314,中石化,8,0,8,富邦-新營,2023-07-04,9693
1417,嘉裕,8,0,8,富邦-新營,2023-07-04,9693
2399,映泰,48,40,8,富邦-新營,2023-07-04,9693
2449,京元電子,9,1,8,富邦-新營,2023-07-04,9693
4121,優盛,8,0,8,富邦-新營,2023-07-04,9693
2356,英業達,124,43,81,富邦-新營,2023-07-05,9693
1227,佳格,80,0,80,富邦-新營,2023-07-05,9693
00637L,元大滬深300正2,71,0,71,富邦-新營,2023-07-05,9693
2801,彰銀,58,0,58,富邦-新營,2023-07-05,9693
2609,陽明,111,65,46,富邦-新營,2023-07-05,9693
2312,金寶,38,2,36,富邦-新營,2023-07-05,9693
4906,正文,32,0,32,富邦-新營,2023-07-05,9693
00665L,富邦�琤肭磪囓�2,31,0,31,富邦-新營,2023-07-05,9693
3515,華擎,31,0,31,富邦-新營,2023-07-05,9693
8112,至上,31,0,31,富邦-新營,2023-07-05,9693
5381,合正,30,0,30,富邦-新營,2023-07-05,9693
00878,國泰永續高股息,38,10,28,富邦-新營,2023-07-05,9693
0056,元大高股息,34,6,28,富邦-新營,2023-07-05,9693
8210,勤誠,29,2,27,富邦-新營,2023-07-05,9693
3372,典範,51,25,26,富邦-新營,2023-07-05,9693
4510,高鋒,27,2,25,富邦-新營,2023-07-05,9693
1514,亞力,23,0,23,富邦-新營,2023-07-05,9693
3011,今皓,22,0,22,富邦-新營,2023-07-05,9693
6190,萬泰科,21,0,21,富邦-新營,2023-07-05,9693
1313,聯成,20,0,20,富邦-新營,2023-07-05,9693
2392,正崴,20,0,20,富邦-新營,2023-07-05,9693
4306,炎洲,20,0,20,富邦-新營,2023-07-05,9693
2610,華航,25,6,19,富邦-新營,2023-07-05,9693
6770,力積電,20,1,19,富邦-新營,2023-07-05,9693
6550,北極星藥業-KY,18,0,18,富邦-新營,2023-07-05,9693
2331,精英,17,0,17,富邦-新營,2023-07-05,9693
2547,日勝生,16,0,16,富邦-新營,2023-07-05,9693
1605,華新,15,0,15,富邦-新營,2023-07-05,9693
1504,東元,14,0,14,富邦-新營,2023-07-05,9693
6282,康舒,48,34,14,富邦-新營,2023-07-05,9693
00927,群益半導體收益,13,0,13,富邦-新營,2023-07-05,9693
1417,嘉裕,13,0,13,富邦-新營,2023-07-05,9693
6578,達邦蛋白,13,0,13,富邦-新營,2023-07-05,9693
3231,緯創,29,16,13,富邦-新營,2023-07-05,9693
1609,大亞,35,23,12,富邦-新營,2023-07-05,9693
2409,友達,12,0,12,富邦-新營,2023-07-05,9693
2913,農林,12,0,12,富邦-新營,2023-07-05,9693
3013,晟銘電,24,12,12,富邦-新營,2023-07-05,9693
1530,亞崴,10,0,10,富邦-新營,2023-07-05,9693
1710,東聯,10,0,10,富邦-新營,2023-07-05,9693
2369,菱生,21,11,10,富邦-新營,2023-07-05,9693
2605,新興,10,0,10,富邦-新營,2023-07-05,9693
6116,彩晶,10,0,10,富邦-新營,2023-07-05,9693
6147,頎邦,10,0,10,富邦-新營,2023-07-05,9693
6182,合晶,10,0,10,富邦-新營,2023-07-05,9693
6153,嘉聯益,11,2,9,富邦-新營,2023-07-05,9693
3481,群創,8,1,7,富邦-新營,2023-07-05,9693
8046,南電,8,1,7,富邦-新營,2023-07-05,9693
2486,一詮,7,0,7,富邦-新營,2023-07-05,9693
4938,和碩,7,0,7,富邦-新營,2023-07-05,9693
1809,中釉,95,3,92,富邦-新營,2023-07-06,9693
2888,新光金,85,8,77,富邦-新營,2023-07-06,9693
00929,復華台灣科技優息,72,0,72,富邦-新營,2023-07-06,9693
2883,凱基金,67,2,65,富邦-新營,2023-07-06,9693
2801,彰銀,63,0,63,富邦-新營,2023-07-06,9693
00665L,富邦�琤肭磪囓�2,54,0,54,富邦-新營,2023-07-06,9693
00893,國泰智能電動車,50,0,50,富邦-新營,2023-07-06,9693
2618,長榮航,121,77,44,富邦-新營,2023-07-06,9693
2409,友達,40,8,32,富邦-新營,2023-07-06,9693
6282,康舒,48,23,25,富邦-新營,2023-07-06,9693
2891,中信金,21,1,20,富邦-新營,2023-07-06,9693
00676R,富邦臺灣加權反1,20,0,20,富邦-新營,2023-07-06,9693
6142,友勁,20,0,20,富邦-新營,2023-07-06,9693
00882,中信中國高股息,19,0,19,富邦-新營,2023-07-06,9693
00680L,元大美債20正2,18,0,18,富邦-新營,2023-07-06,9693
2883B,凱基金乙特,18,0,18,富邦-新營,2023-07-06,9693
3661,世芯-KY,18,0,18,富邦-新營,2023-07-06,9693
8215,明基材,49,32,17,富邦-新營,2023-07-06,9693
3037,欣興,20,4,16,富邦-新營,2023-07-06,9693
2002,中鋼,29,13,16,富邦-新營,2023-07-06,9693
1471,首利,17,1,16,富邦-新營,2023-07-06,9693
2399,映泰,15,0,15,富邦-新營,2023-07-06,9693
1440,南紡,15,0,15,富邦-新營,2023-07-06,9693
8936,國統,20,5,15,富邦-新營,2023-07-06,9693
3703,欣陸,14,0,14,富邦-新營,2023-07-06,9693
2610,華航,18,4,14,富邦-新營,2023-07-06,9693
2633,台灣高鐵,15,1,14,富邦-新營,2023-07-06,9693
4958,臻鼎-KY,14,0,14,富邦-新營,2023-07-06,9693
1314,中石化,13,0,13,富邦-新營,2023-07-06,9693
00922,國泰台灣領袖50,14,2,12,富邦-新營,2023-07-06,9693
2892,第一金,12,0,12,富邦-新營,2023-07-06,9693
6550,北極星藥業-KY,12,0,12,富邦-新營,2023-07-06,9693
1785,光洋科,11,0,11,富邦-新營,2023-07-06,9693
2449,京元電子,12,1,11,富邦-新營,2023-07-06,9693
5009,榮剛,19,8,11,富邦-新營,2023-07-06,9693
00713,元大台灣高息低波,11,0,11,富邦-新營,2023-07-06,9693
2317,鴻海,24,13,11,富邦-新營,2023-07-06,9693
00891,中信關鍵半導體,12,2,10,富邦-新營,2023-07-06,9693
1227,佳格,10,0,10,富邦-新營,2023-07-06,9693
8046,南電,10,0,10,富邦-新營,2023-07-06,9693
00673R,期元大S＆P原油反1,10,0,10,富邦-新營,2023-07-06,9693
1506,正道,10,0,10,富邦-新營,2023-07-06,9693
2423,固緯,10,0,10,富邦-新營,2023-07-06,9693
3548,兆利,10,0,10,富邦-新營,2023-07-06,9693
3682,亞太電,10,0,10,富邦-新營,2023-07-06,9693
4532,瑞智,16,6,10,富邦-新營,2023-07-06,9693
6153,嘉聯益,10,0,10,富邦-新營,2023-07-06,9693
8933,愛地雅,10,0,10,富邦-新營,2023-07-06,9693
4906,正文,11,1,10,富邦-新營,2023-07-06,9693
4155,訊映,9,0,9,富邦-新營,2023-07-06,9693
00878,國泰永續高股息,59,4,55,富邦-新營,2023-07-07,9693
6122,擎邦,50,0,50,富邦-新營,2023-07-07,9693
2609,陽明,54,10,44,富邦-新營,2023-07-07,9693
2356,英業達,60,20,40,富邦-新營,2023-07-07,9693
3231,緯創,97,58,39,富邦-新營,2023-07-07,9693
2885,元大金,36,0,36,富邦-新營,2023-07-07,9693
00882,中信中國高股息,32,0,32,富邦-新營,2023-07-07,9693
0056,元大高股息,33,1,32,富邦-新營,2023-07-07,9693
5009,榮剛,31,5,26,富邦-新營,2023-07-07,9693
3033,威健,36,10,26,富邦-新營,2023-07-07,9693
4532,瑞智,34,9,25,富邦-新營,2023-07-07,9693
2427,三商電,25,1,24,富邦-新營,2023-07-07,9693
00679B,元大美債20年,22,0,22,富邦-新營,2023-07-07,9693
00632R,元大台灣50反1,24,2,22,富邦-新營,2023-07-07,9693
2303,聯電,24,2,22,富邦-新營,2023-07-07,9693
00680L,元大美債20正2,22,0,22,富邦-新營,2023-07-07,9693
2633,台灣高鐵,21,0,21,富邦-新營,2023-07-07,9693
3046,建��,22,1,21,富邦-新營,2023-07-07,9693
00688L,國泰20年美債正2,20,0,20,富邦-新營,2023-07-07,9693
2883,凱基金,19,0,19,富邦-新營,2023-07-07,9693
2340,台亞,20,1,19,富邦-新營,2023-07-07,9693
1589,永冠-KY,18,0,18,富邦-新營,2023-07-07,9693
2881,富邦金,17,0,17,富邦-新營,2023-07-07,9693
3163,波若威,19,3,16,富邦-新營,2023-07-07,9693
00929,復華台灣科技優息,16,0,16,富邦-新營,2023-07-07,9693
2344,華邦電,17,2,15,富邦-新營,2023-07-07,9693
1104,環泥,15,0,15,富邦-新營,2023-07-07,9693
3443,創意,24,10,14,富邦-新營,2023-07-07,9693
2002,中鋼,16,3,13,富邦-新營,2023-07-07,9693
00712,復華富時不動產,24,11,13,富邦-新營,2023-07-07,9693
4967,十銓,14,1,13,富邦-新營,2023-07-07,9693
4979,華星光,105,92,13,富邦-新營,2023-07-07,9693
2888,新光金,19,7,12,富邦-新營,2023-07-07,9693
6578,達邦蛋白,12,0,12,富邦-新營,2023-07-07,9693
8049,晶采,12,0,12,富邦-新營,2023-07-07,9693
4523,永彰,11,0,11,富邦-新營,2023-07-07,9693
1786,科妍,12,1,11,富邦-新營,2023-07-07,9693
2855,統一證,10,0,10,富邦-新營,2023-07-07,9693
00665L,富邦�琤肭磪囓�2,10,0,10,富邦-新營,2023-07-07,9693
00922,國泰台灣領袖50,10,0,10,富邦-新營,2023-07-07,9693
2377,微星,10,0,10,富邦-新營,2023-07-07,9693
3380,明泰,12,2,10,富邦-新營,2023-07-07,9693
6163,華電網,10,0,10,富邦-新營,2023-07-07,9693
6558,興能高,10,0,10,富邦-新營,2023-07-07,9693
8016,矽創,11,1,10,富邦-新營,2023-07-07,9693
1513,中興電,10,1,9,富邦-新營,2023-07-07,9693
3372,典範,11,2,9,富邦-新營,2023-07-07,9693
6120,達運,9,0,9,富邦-新營,2023-07-07,9693
8926,台汽電,11,2,9,富邦-新營,2023-07-07,9693
1301,台塑,8,0,8,富邦-新營,2023-07-07,9693
00673R,期元大S＆P原油反1,4210,3,4207,富邦-新營,2023-07-10,9693
4510,高鋒,78,0,78,富邦-新營,2023-07-10,9693
4532,瑞智,117,50,67,富邦-新營,2023-07-10,9693
6152,百一,54,0,54,富邦-新營,2023-07-10,9693
6550,北極星藥業-KY,53,0,53,富邦-新營,2023-07-10,9693
00680L,元大美債20正2,43,0,43,富邦-新營,2023-07-10,9693
2887,台新金,32,0,32,富邦-新營,2023-07-10,9693
00772B,中信高評級公司債,32,0,32,富邦-新營,2023-07-10,9693
3071,協禧,32,0,32,富邦-新營,2023-07-10,9693
1101,台泥,27,0,27,富邦-新營,2023-07-10,9693
8478,東哥遊艇,25,0,25,富邦-新營,2023-07-10,9693
3711,日月光投控,20,0,20,富邦-新營,2023-07-10,9693
3047,訊舟,20,0,20,富邦-新營,2023-07-10,9693
6005,群益證,20,0,20,富邦-新營,2023-07-10,9693
2317,鴻海,20,0,20,富邦-新營,2023-07-10,9693
2883,凱基金,23,4,19,富邦-新營,2023-07-10,9693
3450,聯鈞,21,3,18,富邦-新營,2023-07-10,9693
6282,康舒,76,61,15,富邦-新營,2023-07-10,9693
4533,協易機,17,2,15,富邦-新營,2023-07-10,9693
2419,仲琦,76,62,14,富邦-新營,2023-07-10,9693
8049,晶采,14,0,14,富邦-新營,2023-07-10,9693
2303,聯電,14,0,14,富邦-新營,2023-07-10,9693
2313,華通,14,1,13,富邦-新營,2023-07-10,9693
5351,鈺創,13,0,13,富邦-新營,2023-07-10,9693
8358,金居,13,0,13,富邦-新營,2023-07-10,9693
6117,迎廣,12,0,12,富邦-新營,2023-07-10,9693
00679B,元大美債20年,12,0,12,富邦-新營,2023-07-10,9693
3046,建��,11,0,11,富邦-新營,2023-07-10,9693
3706,神達,14,3,11,富邦-新營,2023-07-10,9693
4938,和碩,12,1,11,富邦-新營,2023-07-10,9693
00929,復華台灣科技優息,11,1,10,富邦-新營,2023-07-10,9693
4119,旭富,10,0,10,富邦-新營,2023-07-10,9693
00665L,富邦�琤肭磪囓�2,10,0,10,富邦-新營,2023-07-10,9693
4566,時碩工業,20,10,10,富邦-新營,2023-07-10,9693
4739,康普,10,0,10,富邦-新營,2023-07-10,9693
4915,致伸,10,0,10,富邦-新營,2023-07-10,9693
5236,凌陽創新,10,0,10,富邦-新營,2023-07-10,9693
6182,合晶,12,2,10,富邦-新營,2023-07-10,9693
6220,岳豐,11,1,10,富邦-新營,2023-07-10,9693
8110,華東,10,0,10,富邦-新營,2023-07-10,9693
9929,秋雨,10,0,10,富邦-新營,2023-07-10,9693
00882,中信中國高股息,9,0,9,富邦-新營,2023-07-10,9693
2324,仁寶,10,1,9,富邦-新營,2023-07-10,9693
5864,致和證,9,0,9,富邦-新營,2023-07-10,9693
8926,台汽電,10,1,9,富邦-新營,2023-07-10,9693
2329,華泰,11,3,8,富邦-新營,2023-07-10,9693
3705,永信,8,0,8,富邦-新營,2023-07-10,9693
1440,南紡,7,0,7,富邦-新營,2023-07-10,9693
6697,東捷資訊,7,0,7,富邦-新營,2023-07-10,9693
8930,青鋼,8,1,7,富邦-新營,2023-07-10,9693
3362,先進光,120,68,52,富邦-新營,2023-07-11,9693
00882,中信中國高股息,50,0,50,富邦-新營,2023-07-11,9693
8071,能率網通,47,1,46,富邦-新營,2023-07-11,9693
2344,華邦電,40,2,38,富邦-新營,2023-07-11,9693
1417,嘉裕,24,0,24,富邦-新營,2023-07-11,9693
3356,奇偶,21,1,20,富邦-新營,2023-07-11,9693
2371,大同,27,8,19,富邦-新營,2023-07-11,9693
2883,凱基金,22,4,18,富邦-新營,2023-07-11,9693
00632R,元大台灣50反1,16,0,16,富邦-新營,2023-07-11,9693
2340,台亞,36,21,15,富邦-新營,2023-07-11,9693
6115,鎰勝,15,0,15,富邦-新營,2023-07-11,9693
5483,中美晶,15,0,15,富邦-新營,2023-07-11,9693
6285,啟��,54,40,14,富邦-新營,2023-07-11,9693
3707,漢磊,16,3,13,富邦-新營,2023-07-11,9693
4526,東台,17,5,12,富邦-新營,2023-07-11,9693
3025,星通,40,29,11,富邦-新營,2023-07-11,9693
1762,中化生,11,0,11,富邦-新營,2023-07-11,9693
1504,東元,11,0,11,富邦-新營,2023-07-11,9693
3033,威健,11,0,11,富邦-新營,2023-07-11,9693
2308,台達電,10,0,10,富邦-新營,2023-07-11,9693
2468,華經,10,0,10,富邦-新營,2023-07-11,9693
2537,聯上發,10,0,10,富邦-新營,2023-07-11,9693
3019,亞光,11,1,10,富邦-新營,2023-07-11,9693
3706,神達,16,6,10,富邦-新營,2023-07-11,9693
5355,佳總,10,0,10,富邦-新營,2023-07-11,9693
6122,擎邦,17,7,10,富邦-新營,2023-07-11,9693
8049,晶采,10,0,10,富邦-新營,2023-07-11,9693
2312,金寶,20,11,9,富邦-新營,2023-07-11,9693
4119,旭富,9,0,9,富邦-新營,2023-07-11,9693
6153,嘉聯益,9,0,9,富邦-新營,2023-07-11,9693
2457,飛宏,27,19,8,富邦-新營,2023-07-11,9693
4414,如興,8,0,8,富邦-新營,2023-07-11,9693
5328,華容,10,2,8,富邦-新營,2023-07-11,9693
1533,車王電,7,0,7,富邦-新營,2023-07-11,9693
2332,友訊,7,0,7,富邦-新營,2023-07-11,9693
3207,耀勝,7,0,7,富邦-新營,2023-07-11,9693
3294,英濟,7,0,7,富邦-新營,2023-07-11,9693
8429,金麗-KY,9,2,7,富邦-新營,2023-07-11,9693
8383,千附,7,0,7,富邦-新營,2023-07-11,9693
3047,訊舟,10,3,7,富邦-新營,2023-07-11,9693
8940,新天地,6,0,6,富邦-新營,2023-07-11,9693
00679B,元大美債20年,6,0,6,富邦-新營,2023-07-11,9693
3016,嘉晶,6,0,6,富邦-新營,2023-07-11,9693
4934,太極,18,12,6,富邦-新營,2023-07-11,9693
8016,矽創,6,0,6,富邦-新營,2023-07-11,9693
2515,中工,10,4,6,富邦-新營,2023-07-11,9693
00680L,元大美債20正2,5,0,5,富邦-新營,2023-07-11,9693
1795,美時,5,0,5,富邦-新營,2023-07-11,9693
00892,富邦台灣半導體,5,0,5,富邦-新營,2023-07-11,9693
1312,國喬,5,0,5,富邦-新營,2023-07-11,9693
6120,達運,295,19,276,富邦-新營,2023-07-12,9693
2356,英業達,348,91,257,富邦-新營,2023-07-12,9693
2886,兆豐金,160,0,160,富邦-新營,2023-07-12,9693
4979,華星光,80,0,80,富邦-新營,2023-07-12,9693
00882,中信中國高股息,54,0,54,富邦-新營,2023-07-12,9693
6117,迎廣,42,0,42,富邦-新營,2023-07-12,9693
2323,中環,78,38,40,富邦-新營,2023-07-12,9693
4532,瑞智,254,215,39,富邦-新營,2023-07-12,9693
6129,普誠,37,0,37,富邦-新營,2023-07-12,9693
2610,華航,55,18,37,富邦-新營,2023-07-12,9693
2609,陽明,58,32,26,富邦-新營,2023-07-12,9693
2603,長榮,34,8,26,富邦-新營,2023-07-12,9693
1762,中化生,24,0,24,富邦-新營,2023-07-12,9693
2881,富邦金,24,2,22,富邦-新營,2023-07-12,9693
00722B,群益投資級電信債,20,0,20,富邦-新營,2023-07-12,9693
2852,第一保,20,0,20,富邦-新營,2023-07-12,9693
5876,上海商銀,20,0,20,富邦-新營,2023-07-12,9693
6142,友勁,20,0,20,富邦-新營,2023-07-12,9693
2409,友達,21,2,19,富邦-新營,2023-07-12,9693
00673R,期元大S＆P原油反1,18,0,18,富邦-新營,2023-07-12,9693
1584,精剛,25,8,17,富邦-新營,2023-07-12,9693
6419,京晨科,16,0,16,富邦-新營,2023-07-12,9693
2303,聯電,18,2,16,富邦-新營,2023-07-12,9693
5512,力麒,15,0,15,富邦-新營,2023-07-12,9693
00885,富邦越南,15,1,14,富邦-新營,2023-07-12,9693
2399,映泰,22,8,14,富邦-新營,2023-07-12,9693
2413,環科,15,1,14,富邦-新營,2023-07-12,9693
2328,廣宇,32,18,14,富邦-新營,2023-07-12,9693
2317,鴻海,32,19,13,富邦-新營,2023-07-12,9693
6188,廣明,22,9,13,富邦-新營,2023-07-12,9693
00679B,元大美債20年,13,0,13,富邦-新營,2023-07-12,9693
2312,金寶,32,19,13,富邦-新營,2023-07-12,9693
3025,星通,43,30,13,富邦-新營,2023-07-12,9693
1529,樂事綠能,15,4,11,富邦-新營,2023-07-12,9693
3306,鼎天,13,2,11,富邦-新營,2023-07-12,9693
5608,四維航,11,0,11,富邦-新營,2023-07-12,9693
2705,六福,10,0,10,富邦-新營,2023-07-12,9693
5344,立衛,10,0,10,富邦-新營,2023-07-12,9693
2883,凱基金,10,1,9,富邦-新營,2023-07-12,9693
4414,如興,9,0,9,富邦-新營,2023-07-12,9693
4968,立積,11,2,9,富邦-新營,2023-07-12,9693
8050,廣積,10,1,9,富邦-新營,2023-07-12,9693
2633,台灣高鐵,8,0,8,富邦-新營,2023-07-12,9693
2354,鴻準,7,0,7,富邦-新營,2023-07-12,9693
2834,臺企銀,12,5,7,富邦-新營,2023-07-12,9693
3047,訊舟,10,3,7,富邦-新營,2023-07-12,9693
6285,啟��,11,4,7,富邦-新營,2023-07-12,9693
1417,嘉裕,6,0,6,富邦-新營,2023-07-12,9693
1608,華榮,10,4,6,富邦-新營,2023-07-12,9693
1718,中纖,8,2,6,富邦-新營,2023-07-12,9693
00680L,元大美債20正2,108,0,108,富邦-新營,2023-07-13,9693
00712,復華富時不動產,105,15,90,富邦-新營,2023-07-13,9693
2618,長榮航,100,26,74,富邦-新營,2023-07-13,9693
6111,大宇資,250,178,72,富邦-新營,2023-07-13,9693
00772B,中信高評級公司債,67,1,66,富邦-新營,2023-07-13,9693
5443,均豪,71,20,51,富邦-新營,2023-07-13,9693
00930,永豐ESG低碳高息,48,0,48,富邦-新營,2023-07-13,9693
1789,神隆,35,0,35,富邦-新營,2023-07-13,9693
1536,和大,31,1,30,富邦-新營,2023-07-13,9693
2329,華泰,39,10,29,富邦-新營,2023-07-13,9693
5608,四維航,26,0,26,富邦-新營,2023-07-13,9693
3231,緯創,54,29,25,富邦-新營,2023-07-13,9693
2324,仁寶,249,226,23,富邦-新營,2023-07-13,9693
2353,宏��,23,0,23,富邦-新營,2023-07-13,9693
3322,建舜電,22,1,21,富邦-新營,2023-07-13,9693
6538,倉和,21,0,21,富邦-新營,2023-07-13,9693
2603,長榮,41,22,19,富邦-新營,2023-07-13,9693
1455,集盛,18,0,18,富邦-新營,2023-07-13,9693
00673R,期元大S＆P原油反1,16,0,16,富邦-新營,2023-07-13,9693
2332,友訊,15,0,15,富邦-新營,2023-07-13,9693
2449,京元電子,41,26,15,富邦-新營,2023-07-13,9693
3147,大綜,15,0,15,富邦-新營,2023-07-13,9693
6576,逸達,16,1,15,富邦-新營,2023-07-13,9693
8436,大江,15,0,15,富邦-新營,2023-07-13,9693
0056,元大高股息,22,9,13,富邦-新營,2023-07-13,9693
4716,大立,12,0,12,富邦-新營,2023-07-13,9693
2382,廣達,26,14,12,富邦-新營,2023-07-13,9693
2352,佳世達,21,9,12,富邦-新營,2023-07-13,9693
2328,廣宇,48,37,11,富邦-新營,2023-07-13,9693
2641,正德,13,2,11,富邦-新營,2023-07-13,9693
6578,達邦蛋白,11,0,11,富邦-新營,2023-07-13,9693
2303,聯電,39,28,11,富邦-新營,2023-07-13,9693
1220,台榮,10,0,10,富邦-新營,2023-07-13,9693
2489,瑞軒,10,0,10,富邦-新營,2023-07-13,9693
2601,益航,10,0,10,富邦-新營,2023-07-13,9693
2633,台灣高鐵,10,0,10,富邦-新營,2023-07-13,9693
2881,富邦金,10,0,10,富邦-新營,2023-07-13,9693
3029,零壹,10,0,10,富邦-新營,2023-07-13,9693
3078,僑威,19,9,10,富邦-新營,2023-07-13,9693
4976,佳凌,10,0,10,富邦-新營,2023-07-13,9693
5243,乙盛-KY,10,0,10,富邦-新營,2023-07-13,9693
5328,華容,10,0,10,富邦-新營,2023-07-13,9693
5864,致和證,10,0,10,富邦-新營,2023-07-13,9693
2388,威盛,75,65,10,富邦-新營,2023-07-13,9693
2891,中信金,11,1,10,富邦-新營,2023-07-13,9693
00885,富邦越南,10,1,9,富邦-新營,2023-07-13,9693
2883,凱基金,11,2,9,富邦-新營,2023-07-13,9693
3189,景碩,12,3,9,富邦-新營,2023-07-13,9693
4543,萬在,9,0,9,富邦-新營,2023-07-13,9693
6207,雷科,10,1,9,富邦-新營,2023-07-13,9693
00929,復華台灣科技優息,117,0,117,富邦-新營,2023-07-14,9693
00882,中信中國高股息,71,2,69,富邦-新營,2023-07-14,9693
2481,強茂,69,4,65,富邦-新營,2023-07-14,9693
00679B,元大美債20年,62,0,62,富邦-新營,2023-07-14,9693
2392,正崴,45,0,45,富邦-新營,2023-07-14,9693
6116,彩晶,41,2,39,富邦-新營,2023-07-14,9693
2610,華航,73,39,34,富邦-新營,2023-07-14,9693
00632R,元大台灣50反1,55,21,34,富邦-新營,2023-07-14,9693
2329,華泰,89,56,33,富邦-新營,2023-07-14,9693
2618,長榮航,78,45,33,富邦-新營,2023-07-14,9693
2834,臺企銀,30,2,28,富邦-新營,2023-07-14,9693
6578,達邦蛋白,28,0,28,富邦-新營,2023-07-14,9693
2014,中鴻,25,0,25,富邦-新營,2023-07-14,9693
2888,新光金,55,31,24,富邦-新營,2023-07-14,9693
1513,中興電,25,5,20,富邦-新營,2023-07-14,9693
1101,台泥,20,1,19,富邦-新營,2023-07-14,9693
6548,長科*,19,0,19,富邦-新營,2023-07-14,9693
2449,京元電子,29,11,18,富邦-新營,2023-07-14,9693
4162,智擎,18,0,18,富邦-新營,2023-07-14,9693
3002,歐格,17,0,17,富邦-新營,2023-07-14,9693
2328,廣宇,22,8,14,富邦-新營,2023-07-14,9693
2889,國票金,20,6,14,富邦-新營,2023-07-14,9693
6288,聯嘉,15,2,13,富邦-新營,2023-07-14,9693
1609,大亞,21,8,13,富邦-新營,2023-07-14,9693
2312,金寶,47,35,12,富邦-新營,2023-07-14,9693
8086,宏捷科,12,0,12,富邦-新營,2023-07-14,9693
2801,彰銀,31,20,11,富邦-新營,2023-07-14,9693
00905,FT臺灣Smart,11,0,11,富邦-新營,2023-07-14,9693
3032,偉訓,17,6,11,富邦-新營,2023-07-14,9693
5309,系統電,12,1,11,富邦-新營,2023-07-14,9693
1220,台榮,10,0,10,富邦-新營,2023-07-14,9693
3071,協禧,12,2,10,富邦-新營,2023-07-14,9693
00712,復華富時不動產,17,8,9,富邦-新營,2023-07-14,9693
1504,東元,12,3,9,富邦-新營,2023-07-14,9693
8071,能率網通,9,0,9,富邦-新營,2023-07-14,9693
1608,華榮,15,7,8,富邦-新營,2023-07-14,9693
3058,立德,8,0,8,富邦-新營,2023-07-14,9693
3234,光環,9,2,7,富邦-新營,2023-07-14,9693
4746,台耀,62,55,7,富邦-新營,2023-07-14,9693
6139,亞翔,10,3,7,富邦-新營,2023-07-14,9693
1718,中纖,16,10,6,富邦-新營,2023-07-14,9693
6235,華孚,26,20,6,富邦-新營,2023-07-14,9693
5483,中美晶,10,4,6,富邦-新營,2023-07-14,9693
00673R,期元大S＆P原油反1,6,0,6,富邦-新營,2023-07-14,9693
1455,集盛,6,0,6,富邦-新營,2023-07-14,9693
1529,樂事綠能,17,11,6,富邦-新營,2023-07-14,9693
3594,磐儀,54,48,6,富邦-新營,2023-07-14,9693
6213,聯茂,16,10,6,富邦-新營,2023-07-14,9693
8112,至上,8,2,6,富邦-新營,2023-07-14,9693
0050,元大台灣50,7,1,6,富邦-新營,2023-07-14,9693
00637L,元大滬深300正2,260,11,249,富邦-新營,2023-07-17,9693
2356,英業達,246,28,218,富邦-新營,2023-07-17,9693
2353,宏��,520,351,169,富邦-新營,2023-07-17,9693
2801,彰銀,166,10,156,富邦-新營,2023-07-17,9693
00715L,期街口布蘭特正2,134,3,131,富邦-新營,2023-07-17,9693
2881,富邦金,102,7,95,富邦-新營,2023-07-17,9693
2371,大同,96,2,94,富邦-新營,2023-07-17,9693
0056,元大高股息,72,25,47,富邦-新營,2023-07-17,9693
2312,金寶,311,276,35,富邦-新營,2023-07-17,9693
00632R,元大台灣50反1,30,0,30,富邦-新營,2023-07-17,9693
2515,中工,30,2,28,富邦-新營,2023-07-17,9693
6451,訊芯-KY,30,3,27,富邦-新營,2023-07-17,9693
3706,神達,30,4,26,富邦-新營,2023-07-17,9693
00706L,期元大S＆P日圓正2,24,0,24,富邦-新營,2023-07-17,9693
2834,臺企銀,25,1,24,富邦-新營,2023-07-17,9693
3025,星通,24,2,22,富邦-新營,2023-07-17,9693
00929,復華台灣科技優息,22,0,22,富邦-新營,2023-07-17,9693
2324,仁寶,30,10,20,富邦-新營,2023-07-17,9693
2331,精英,16,1,15,富邦-新營,2023-07-17,9693
00688L,國泰20年美債正2,16,1,15,富邦-新營,2023-07-17,9693
1402,遠東新,16,1,15,富邦-新營,2023-07-17,9693
1506,正道,15,0,15,富邦-新營,2023-07-17,9693
6245,立端,15,0,15,富邦-新營,2023-07-17,9693
2498,宏達電,15,2,13,富邦-新營,2023-07-17,9693
1471,首利,12,0,12,富邦-新營,2023-07-17,9693
2610,華航,37,25,12,富邦-新營,2023-07-17,9693
6207,雷科,13,1,12,富邦-新營,2023-07-17,9693
4934,太極,17,6,11,富邦-新營,2023-07-17,9693
1717,長興,10,0,10,富邦-新營,2023-07-17,9693
2453,凌群,11,1,10,富邦-新營,2023-07-17,9693
6266,泰詠,10,0,10,富邦-新營,2023-07-17,9693
8050,廣積,20,11,9,富邦-新營,2023-07-17,9693
6235,華孚,10,1,9,富邦-新營,2023-07-17,9693
3231,緯創,17,8,9,富邦-新營,2023-07-17,9693
3711,日月光投控,11,2,9,富邦-新營,2023-07-17,9693
8064,東捷,10,1,9,富邦-新營,2023-07-17,9693
2481,強茂,16,7,9,富邦-新營,2023-07-17,9693
1314,中石化,10,2,8,富邦-新營,2023-07-17,9693
1504,東元,8,0,8,富邦-新營,2023-07-17,9693
1611,中電,10,2,8,富邦-新營,2023-07-17,9693
2382,廣達,20,12,8,富邦-新營,2023-07-17,9693
6187,萬潤,10,2,8,富邦-新營,2023-07-17,9693
2323,中環,9,1,8,富邦-新營,2023-07-17,9693
2409,友達,7,0,7,富邦-新營,2023-07-17,9693
3532,台勝科,7,0,7,富邦-新營,2023-07-17,9693
3545,敦泰,7,0,7,富邦-新營,2023-07-17,9693
3583,辛耘,54,47,7,富邦-新營,2023-07-17,9693
5426,振發,7,0,7,富邦-新營,2023-07-17,9693
6152,百一,7,0,7,富邦-新營,2023-07-17,9693
6191,精成科,7,0,7,富邦-新營,2023-07-17,9693
00680L,元大美債20正2,100,0,100,富邦-新營,2023-07-18,9693
00882,中信中國高股息,100,2,98,富邦-新營,2023-07-18,9693
00929,復華台灣科技優息,124,32,92,富邦-新營,2023-07-18,9693
2388,威盛,171,95,76,富邦-新營,2023-07-18,9693
00632R,元大台灣50反1,62,0,62,富邦-新營,2023-07-18,9693
1711,永光,58,7,51,富邦-新營,2023-07-18,9693
1514,亞力,68,20,48,富邦-新營,2023-07-18,9693
6282,康舒,69,24,45,富邦-新營,2023-07-18,9693
2324,仁寶,186,149,37,富邦-新營,2023-07-18,9693
3163,波若威,49,20,29,富邦-新營,2023-07-18,9693
6116,彩晶,50,22,28,富邦-新營,2023-07-18,9693
4938,和碩,153,129,24,富邦-新營,2023-07-18,9693
2801,彰銀,63,40,23,富邦-新營,2023-07-18,9693
2312,金寶,112,89,23,富邦-新營,2023-07-18,9693
2352,佳世達,75,53,22,富邦-新營,2023-07-18,9693
3706,神達,233,212,21,富邦-新營,2023-07-18,9693
2867,三商壽,20,0,20,富邦-新營,2023-07-18,9693
8996,高力,20,0,20,富邦-新營,2023-07-18,9693
2618,長榮航,36,16,20,富邦-新營,2023-07-18,9693
2888,新光金,22,4,18,富邦-新營,2023-07-18,9693
4533,協易機,35,18,17,富邦-新營,2023-07-18,9693
1432,大魯閣,16,0,16,富邦-新營,2023-07-18,9693
5381,合正,16,0,16,富邦-新營,2023-07-18,9693
1609,大亞,28,14,14,富邦-新營,2023-07-18,9693
2371,大同,29,15,14,富邦-新營,2023-07-18,9693
4908,前鼎,14,0,14,富邦-新營,2023-07-18,9693
00712,復華富時不動產,19,6,13,富邦-新營,2023-07-18,9693
3704,合勤控,21,8,13,富邦-新營,2023-07-18,9693
1417,嘉裕,13,0,13,富邦-新營,2023-07-18,9693
1718,中纖,13,0,13,富邦-新營,2023-07-18,9693
5512,力麒,13,0,13,富邦-新營,2023-07-18,9693
3035,智原,49,36,13,富邦-新營,2023-07-18,9693
5608,四維航,13,1,12,富邦-新營,2023-07-18,9693
2211,長榮鋼,12,0,12,富邦-新營,2023-07-18,9693
1471,首利,13,1,12,富邦-新營,2023-07-18,9693
3058,立德,11,0,11,富邦-新營,2023-07-18,9693
1313,聯成,13,2,11,富邦-新營,2023-07-18,9693
1319,東陽,12,1,11,富邦-新營,2023-07-18,9693
2105,正新,10,0,10,富邦-新營,2023-07-18,9693
3005,神基,16,6,10,富邦-新營,2023-07-18,9693
6179,亞通,10,0,10,富邦-新營,2023-07-18,9693
8227,巨有科技,20,10,10,富邦-新營,2023-07-18,9693
2498,宏達電,12,3,9,富邦-新營,2023-07-18,9693
1605,華新,11,2,9,富邦-新營,2023-07-18,9693
2329,華泰,22,13,9,富邦-新營,2023-07-18,9693
3047,訊舟,12,3,9,富邦-新營,2023-07-18,9693
00720B,元大投資級公司債,8,0,8,富邦-新營,2023-07-18,9693
2206,三陽工業,8,0,8,富邦-新營,2023-07-18,9693
1402,遠東新,8,0,8,富邦-新營,2023-07-18,9693
2405,輔信,8,0,8,富邦-新營,2023-07-18,9693
3706,神達,345,158,187,富邦-新營,2023-07-19,9693
6550,北極星藥業-KY,124,11,113,富邦-新營,2023-07-19,9693
00929,復華台灣科技優息,94,0,94,富邦-新營,2023-07-19,9693
6150,撼訊,85,5,80,富邦-新營,2023-07-19,9693
2324,仁寶,93,19,74,富邦-新營,2023-07-19,9693
00676R,富邦臺灣加權反1,50,0,50,富邦-新營,2023-07-19,9693
00882,中信中國高股息,40,0,40,富邦-新營,2023-07-19,9693
2498,宏達電,38,2,36,富邦-新營,2023-07-19,9693
3037,欣興,71,36,35,富邦-新營,2023-07-19,9693
6116,彩晶,35,4,31,富邦-新營,2023-07-19,9693
5876,上海商銀,30,0,30,富邦-新營,2023-07-19,9693
2363,矽統,30,0,30,富邦-新營,2023-07-19,9693
1455,集盛,27,0,27,富邦-新營,2023-07-19,9693
00753L,中信中國50正2,25,0,25,富邦-新營,2023-07-19,9693
00632R,元大台灣50反1,23,0,23,富邦-新營,2023-07-19,9693
3441,聯一光,23,0,23,富邦-新營,2023-07-19,9693
00664R,國泰臺灣加權反1,20,0,20,富邦-新營,2023-07-19,9693
1227,佳格,20,0,20,富邦-新營,2023-07-19,9693
2855,統一證,20,0,20,富邦-新營,2023-07-19,9693
3481,群創,35,15,20,富邦-新營,2023-07-19,9693
2303,聯電,32,12,20,富邦-新營,2023-07-19,9693
3231,緯創,34,15,19,富邦-新營,2023-07-19,9693
2353,宏��,53,35,18,富邦-新營,2023-07-19,9693
2885,元大金,20,2,18,富邦-新營,2023-07-19,9693
4938,和碩,27,10,17,富邦-新營,2023-07-19,9693
2457,飛宏,20,3,17,富邦-新營,2023-07-19,9693
2610,華航,30,13,17,富邦-新營,2023-07-19,9693
2374,佳能,16,0,16,富邦-新營,2023-07-19,9693
2461,光群雷,23,7,16,富邦-新營,2023-07-19,9693
8050,廣積,16,0,16,富邦-新營,2023-07-19,9693
00900,富邦特選高股息30,15,0,15,富邦-新營,2023-07-19,9693
1789,神隆,16,1,15,富邦-新營,2023-07-19,9693
2812,台中銀,12,0,12,富邦-新營,2023-07-19,9693
2887,台新金,11,0,11,富邦-新營,2023-07-19,9693
1718,中纖,11,0,11,富邦-新營,2023-07-19,9693
2409,友達,11,0,11,富邦-新營,2023-07-19,9693
1605,華新,11,1,10,富邦-新營,2023-07-19,9693
1319,東陽,10,0,10,富邦-新營,2023-07-19,9693
2834,臺企銀,10,0,10,富邦-新營,2023-07-19,9693
4566,時碩工業,21,11,10,富邦-新營,2023-07-19,9693
5009,榮剛,9,0,9,富邦-新營,2023-07-19,9693
2888,新光金,15,6,9,富邦-新營,2023-07-19,9693
2482,連宇,10,1,9,富邦-新營,2023-07-19,9693
3047,訊舟,11,2,9,富邦-新營,2023-07-19,9693
3105,穩懋,16,7,9,富邦-新營,2023-07-19,9693
6578,達邦蛋白,9,0,9,富邦-新營,2023-07-19,9693
3702,大聯大,8,0,8,富邦-新營,2023-07-19,9693
00665L,富邦�琤肭磪囓�2,9,1,8,富邦-新營,2023-07-19,9693
2634,漢翔,9,1,8,富邦-新營,2023-07-19,9693
2882,國泰金,8,0,8,富邦-新營,2023-07-19,9693
2303,聯電,143,13,130,富邦-新營,2023-07-20,9693
1102,亞泥,113,0,113,富邦-新營,2023-07-20,9693
6016,康和證,100,0,100,富邦-新營,2023-07-20,9693
2405,輔信,73,8,65,富邦-新營,2023-07-20,9693
2352,佳世達,41,8,33,富邦-新營,2023-07-20,9693
00929,復華台灣科技優息,33,1,32,富邦-新營,2023-07-20,9693
1519,華城,30,0,30,富邦-新營,2023-07-20,9693
4532,瑞智,28,1,27,富邦-新營,2023-07-20,9693
3322,建舜電,26,0,26,富邦-新營,2023-07-20,9693
6796,晉弘,25,2,23,富邦-新營,2023-07-20,9693
6811,宏�硌穈T,21,0,21,富邦-新營,2023-07-20,9693
00923,群益台ESG低碳50,20,0,20,富邦-新營,2023-07-20,9693
00900,富邦特選高股息30,20,0,20,富邦-新營,2023-07-20,9693
2881,富邦金,20,0,20,富邦-新營,2023-07-20,9693
6282,康舒,45,26,19,富邦-新營,2023-07-20,9693
4168,醣聯,17,0,17,富邦-新營,2023-07-20,9693
00751B,元大AAA至A公司債,16,0,16,富邦-新營,2023-07-20,9693
2317,鴻海,19,3,16,富邦-新營,2023-07-20,9693
6116,彩晶,17,4,13,富邦-新營,2023-07-20,9693
2027,大成鋼,12,0,12,富邦-新營,2023-07-20,9693
2316,楠梓電,80,69,11,富邦-新營,2023-07-20,9693
2453,凌群,11,0,11,富邦-新營,2023-07-20,9693
3002,歐格,10,0,10,富邦-新營,2023-07-20,9693
3715,定穎投控,12,2,10,富邦-新營,2023-07-20,9693
3661,世芯-KY,10,0,10,富邦-新營,2023-07-20,9693
2355,敬鵬,10,0,10,富邦-新營,2023-07-20,9693
6770,力積電,16,7,9,富邦-新營,2023-07-20,9693
2387,精元,10,1,9,富邦-新營,2023-07-20,9693
3051,力特,11,2,9,富邦-新營,2023-07-20,9693
4123,晟德,16,7,9,富邦-新營,2023-07-20,9693
4967,十銓,8,0,8,富邦-新營,2023-07-20,9693
00710B,復華彭博非投等債,8,0,8,富邦-新營,2023-07-20,9693
4938,和碩,12,4,8,富邦-新營,2023-07-20,9693
3481,群創,16,9,7,富邦-新營,2023-07-20,9693
00679B,元大美債20年,9,2,7,富邦-新營,2023-07-20,9693
00882,中信中國高股息,9,2,7,富邦-新營,2023-07-20,9693
2722,夏都,8,1,7,富邦-新營,2023-07-20,9693
8222,寶一,8,1,7,富邦-新營,2023-07-20,9693
00885,富邦越南,6,0,6,富邦-新營,2023-07-20,9693
2634,漢翔,18,12,6,富邦-新營,2023-07-20,9693
2353,宏��,9,3,6,富邦-新營,2023-07-20,9693
2482,連宇,10,4,6,富邦-新營,2023-07-20,9693
4977,眾達-KY,8,2,6,富邦-新營,2023-07-20,9693
1789,神隆,14,9,5,富邦-新營,2023-07-20,9693
2332,友訊,5,0,5,富邦-新營,2023-07-20,9693
3032,偉訓,16,11,5,富邦-新營,2023-07-20,9693
3163,波若威,15,10,5,富邦-新營,2023-07-20,9693
3289,宜特,34,29,5,富邦-新營,2023-07-20,9693
5512,力麒,5,0,5,富邦-新營,2023-07-20,9693
6188,廣明,13,8,5,富邦-新營,2023-07-20,9693
1513,中興電,244,43,201,富邦-新營,2023-07-21,9693
2382,廣達,363,239,124,富邦-新營,2023-07-21,9693
2328,廣宇,134,11,123,富邦-新營,2023-07-21,9693
2344,華邦電,73,1,72,富邦-新營,2023-07-21,9693
00929,復華台灣科技優息,59,2,57,富邦-新營,2023-07-21,9693
5347,世界,51,0,51,富邦-新營,2023-07-21,9693
00900,富邦特選高股息30,46,0,46,富邦-新營,2023-07-21,9693
2303,聯電,46,5,41,富邦-新營,2023-07-21,9693
00680L,元大美債20正2,32,0,32,富邦-新營,2023-07-21,9693
6116,彩晶,32,1,31,富邦-新營,2023-07-21,9693
00676R,富邦臺灣加權反1,30,0,30,富邦-新營,2023-07-21,9693
2888,新光金,50,20,30,富邦-新營,2023-07-21,9693
6120,達運,31,1,30,富邦-新營,2023-07-21,9693
5864,致和證,35,7,28,富邦-新營,2023-07-21,9693
2634,漢翔,30,4,26,富邦-新營,2023-07-21,9693
3231,緯創,33,8,25,富邦-新營,2023-07-21,9693
4532,瑞智,25,0,25,富邦-新營,2023-07-21,9693
2369,菱生,20,0,20,富邦-新營,2023-07-21,9693
6142,友勁,20,0,20,富邦-新營,2023-07-21,9693
00891,中信關鍵半導體,19,1,18,富邦-新營,2023-07-21,9693
3338,泰碩,78,61,17,富邦-新營,2023-07-21,9693
2801,彰銀,16,0,16,富邦-新營,2023-07-21,9693
2748,雲品,16,0,16,富邦-新營,2023-07-21,9693
5009,榮剛,15,0,15,富邦-新營,2023-07-21,9693
2206,三陽工業,19,6,13,富邦-新營,2023-07-21,9693
1471,首利,14,1,13,富邦-新營,2023-07-21,9693
6182,合晶,17,4,13,富邦-新營,2023-07-21,9693
00888,永豐台灣ESG,12,0,12,富邦-新營,2023-07-21,9693
2812,台中銀,12,0,12,富邦-新營,2023-07-21,9693
1301,台塑,14,2,12,富邦-新營,2023-07-21,9693
3227,原相,12,0,12,富邦-新營,2023-07-21,9693
1101,台泥,11,0,11,富邦-新營,2023-07-21,9693
2482,連宇,11,0,11,富邦-新營,2023-07-21,9693
3450,聯鈞,11,0,11,富邦-新營,2023-07-21,9693
4916,事欣科,12,1,11,富邦-新營,2023-07-21,9693
8215,明基材,11,0,11,富邦-新營,2023-07-21,9693
2498,宏達電,12,1,11,富邦-新營,2023-07-21,9693
3706,神達,18,8,10,富邦-新營,2023-07-21,9693
8436,大江,10,0,10,富邦-新營,2023-07-21,9693
00795B,中信美國公債20年,10,0,10,富邦-新營,2023-07-21,9693
1536,和大,10,0,10,富邦-新營,2023-07-21,9693
2458,義隆,10,0,10,富邦-新營,2023-07-21,9693
3046,建��,10,0,10,富邦-新營,2023-07-21,9693
6288,聯嘉,10,0,10,富邦-新營,2023-07-21,9693
2330,台積電,10,0,10,富邦-新營,2023-07-21,9693
1440,南紡,8,0,8,富邦-新營,2023-07-21,9693
1783,和康生,9,1,8,富邦-新營,2023-07-21,9693
6158,禾昌,13,5,8,富邦-新營,2023-07-21,9693
2834,臺企銀,10,2,8,富邦-新營,2023-07-21,9693
5483,中美晶,9,1,8,富邦-新營,2023-07-21,9693
2421,建準,98,32,66,富邦-新營,2023-07-24,9693
2371,大同,79,28,51,富邦-新營,2023-07-24,9693
00882,中信中國高股息,48,3,45,富邦-新營,2023-07-24,9693
00929,復華台灣科技優息,47,12,35,富邦-新營,2023-07-24,9693
6282,康舒,45,14,31,富邦-新營,2023-07-24,9693
6578,達邦蛋白,31,0,31,富邦-新營,2023-07-24,9693
6125,廣運,41,12,29,富邦-新營,2023-07-24,9693
2609,陽明,29,1,28,富邦-新營,2023-07-24,9693
3035,智原,40,13,27,富邦-新營,2023-07-24,9693
1609,大亞,76,49,27,富邦-新營,2023-07-24,9693
2369,菱生,20,0,20,富邦-新營,2023-07-24,9693
2537,聯上發,20,0,20,富邦-新營,2023-07-24,9693
3308,聯德,20,0,20,富邦-新營,2023-07-24,9693
2324,仁寶,25,6,19,富邦-新營,2023-07-24,9693
2891,中信金,18,3,15,富邦-新營,2023-07-24,9693
1102,亞泥,14,0,14,富邦-新營,2023-07-24,9693
3265,台星科,16,2,14,富邦-新營,2023-07-24,9693
6550,北極星藥業-KY,17,3,14,富邦-新營,2023-07-24,9693
3481,群創,15,2,13,富邦-新營,2023-07-24,9693
2618,長榮航,25,12,13,富邦-新營,2023-07-24,9693
2338,光罩,13,0,13,富邦-新營,2023-07-24,9693
6116,彩晶,20,7,13,富邦-新營,2023-07-24,9693
2634,漢翔,16,4,12,富邦-新營,2023-07-24,9693
5512,力麒,12,0,12,富邦-新營,2023-07-24,9693
2867,三商壽,10,0,10,富邦-新營,2023-07-24,9693
6112,邁達特,12,2,10,富邦-新營,2023-07-24,9693
2303,聯電,12,3,9,富邦-新營,2023-07-24,9693
2002,中鋼,10,1,9,富邦-新營,2023-07-24,9693
2457,飛宏,23,14,9,富邦-新營,2023-07-24,9693
4967,十銓,8,0,8,富邦-新營,2023-07-24,9693
3443,創意,12,4,8,富邦-新營,2023-07-24,9693
2323,中環,21,13,8,富邦-新營,2023-07-24,9693
2352,佳世達,8,0,8,富邦-新營,2023-07-24,9693
3450,聯鈞,10,2,8,富邦-新營,2023-07-24,9693
8033,雷虎,8,0,8,富邦-新營,2023-07-24,9693
00713,元大台灣高息低波,12,4,8,富邦-新營,2023-07-24,9693
2603,長榮,20,13,7,富邦-新營,2023-07-24,9693
1514,亞力,21,14,7,富邦-新營,2023-07-24,9693
2230,泰茂,8,1,7,富邦-新營,2023-07-24,9693
2889,國票金,7,0,7,富邦-新營,2023-07-24,9693
4533,協易機,7,0,7,富邦-新營,2023-07-24,9693
6257,矽格,7,0,7,富邦-新營,2023-07-24,9693
8436,大江,7,0,7,富邦-新營,2023-07-24,9693
2461,光群雷,8,1,7,富邦-新營,2023-07-24,9693
6182,合晶,7,1,6,富邦-新營,2023-07-24,9693
2812,台中銀,6,0,6,富邦-新營,2023-07-24,9693
1718,中纖,6,0,6,富邦-新營,2023-07-24,9693
2615,萬海,6,0,6,富邦-新營,2023-07-24,9693
2641,正德,6,0,6,富邦-新營,2023-07-24,9693
3305,昇貿,9,3,6,富邦-新營,2023-07-24,9693
2885,元大金,250,0,250,富邦-新營,2023-07-25,9693
00715L,期街口布蘭特正2,114,25,89,富邦-新營,2023-07-25,9693
5392,能率,74,2,72,富邦-新營,2023-07-25,9693
2892,第一金,72,5,67,富邦-新營,2023-07-25,9693
6657,華安,42,0,42,富邦-新營,2023-07-25,9693
2355,敬鵬,30,0,30,富邦-新營,2023-07-25,9693
1102,亞泥,30,1,29,富邦-新營,2023-07-25,9693
2028,威致,29,0,29,富邦-新營,2023-07-25,9693
4938,和碩,31,6,25,富邦-新營,2023-07-25,9693
00929,復華台灣科技優息,36,14,22,富邦-新營,2023-07-25,9693
3706,神達,24,2,22,富邦-新營,2023-07-25,9693
2834,臺企銀,41,20,21,富邦-新營,2023-07-25,9693
00722B,群益投資級電信債,20,0,20,富邦-新營,2023-07-25,9693
2812,台中銀,20,0,20,富邦-新營,2023-07-25,9693
2382,廣達,134,115,19,富邦-新營,2023-07-25,9693
1402,遠東新,18,0,18,富邦-新營,2023-07-25,9693
3024,憶聲,80,63,17,富邦-新營,2023-07-25,9693
5009,榮剛,19,4,15,富邦-新營,2023-07-25,9693
2014,中鴻,15,0,15,富邦-新營,2023-07-25,9693
2324,仁寶,26,11,15,富邦-新營,2023-07-25,9693
4113,聯上,15,0,15,富邦-新營,2023-07-25,9693
3037,欣興,31,17,14,富邦-新營,2023-07-25,9693
4931,新盛力,15,1,14,富邦-新營,2023-07-25,9693
6865,偉康科技,12,0,12,富邦-新營,2023-07-25,9693
2449,京元電子,14,3,11,富邦-新營,2023-07-25,9693
2353,宏��,51,40,11,富邦-新營,2023-07-25,9693
3027,盛達,11,0,11,富邦-新營,2023-07-25,9693
2371,大同,15,4,11,富邦-新營,2023-07-25,9693
2201,裕隆,24,13,11,富邦-新營,2023-07-25,9693
00885,富邦越南,21,11,10,富邦-新營,2023-07-25,9693
1506,正道,10,0,10,富邦-新營,2023-07-25,9693
2023,燁輝,10,0,10,富邦-新營,2023-07-25,9693
2610,華航,20,10,10,富邦-新營,2023-07-25,9693
2801,彰銀,10,0,10,富邦-新營,2023-07-25,9693
6578,達邦蛋白,10,0,10,富邦-新營,2023-07-25,9693
1217,愛之味,10,0,10,富邦-新營,2023-07-25,9693
6472,保瑞,11,1,10,富邦-新營,2023-07-25,9693
4953,緯軟,41,32,9,富邦-新營,2023-07-25,9693
2301,光寶科,21,13,8,富邦-新營,2023-07-25,9693
00673R,期元大S＆P原油反1,10,2,8,富邦-新營,2023-07-25,9693
1314,中石化,8,0,8,富邦-新營,2023-07-25,9693
1905,華紙,18,10,8,富邦-新營,2023-07-25,9693
2340,台亞,18,10,8,富邦-新營,2023-07-25,9693
3711,日月光投控,13,5,8,富邦-新營,2023-07-25,9693
6796,晉弘,82,74,8,富邦-新營,2023-07-25,9693
3702,大聯大,7,0,7,富邦-新營,2023-07-25,9693
2328,廣宇,10,3,7,富邦-新營,2023-07-25,9693
2883,凱基金,12,5,7,富邦-新營,2023-07-25,9693
3583,辛耘,10,3,7,富邦-新營,2023-07-25,9693
1609,大亞,9,3,6,富邦-新營,2023-07-25,9693
2359,所羅門,214,14,200,富邦-新營,2023-07-26,9693
2855,統一證,110,0,110,富邦-新營,2023-07-26,9693
1504,東元,129,43,86,富邦-新營,2023-07-26,9693
2382,廣達,108,27,81,富邦-新營,2023-07-26,9693
2329,華泰,89,18,71,富邦-新營,2023-07-26,9693
2812,台中銀,60,1,59,富邦-新營,2023-07-26,9693
3231,緯創,130,79,51,富邦-新營,2023-07-26,9693
2913,農林,53,3,50,富邦-新營,2023-07-26,9693
4414,如興,60,20,40,富邦-新營,2023-07-26,9693
1609,大亞,37,0,37,富邦-新營,2023-07-26,9693
1217,愛之味,33,7,26,富邦-新營,2023-07-26,9693
6120,達運,25,0,25,富邦-新營,2023-07-26,9693
8358,金居,42,17,25,富邦-新營,2023-07-26,9693
1102,亞泥,26,3,23,富邦-新營,2023-07-26,9693
00764B,群益25年美債,20,0,20,富邦-新營,2023-07-26,9693
3322,建舜電,30,10,20,富邦-新營,2023-07-26,9693
2885,元大金,20,1,19,富邦-新營,2023-07-26,9693
2371,大同,19,1,18,富邦-新營,2023-07-26,9693
00930,永豐ESG低碳高息,17,0,17,富邦-新營,2023-07-26,9693
2303,聯電,20,3,17,富邦-新營,2023-07-26,9693
2338,光罩,16,0,16,富邦-新營,2023-07-26,9693
6015,宏遠證,15,1,14,富邦-新營,2023-07-26,9693
2427,三商電,13,0,13,富邦-新營,2023-07-26,9693
3531,先益,12,0,12,富邦-新營,2023-07-26,9693
6217,中探針,12,0,12,富邦-新營,2023-07-26,9693
8227,巨有科技,20,8,12,富邦-新營,2023-07-26,9693
1605,華新,12,1,11,富邦-新營,2023-07-26,9693
1618,合機,20,9,11,富邦-新營,2023-07-26,9693
00679B,元大美債20年,10,0,10,富邦-新營,2023-07-26,9693
8050,廣積,10,0,10,富邦-新營,2023-07-26,9693
00664R,國泰臺灣加權反1,10,0,10,富邦-新營,2023-07-26,9693
2425,承啟,16,6,10,富邦-新營,2023-07-26,9693
2426,鼎元,10,0,10,富邦-新營,2023-07-26,9693
2498,宏達電,12,2,10,富邦-新營,2023-07-26,9693
3018,隆銘綠能,10,0,10,富邦-新營,2023-07-26,9693
3033,威健,10,0,10,富邦-新營,2023-07-26,9693
3227,原相,10,0,10,富邦-新營,2023-07-26,9693
4967,十銓,10,0,10,富邦-新營,2023-07-26,9693
5356,協益,10,0,10,富邦-新營,2023-07-26,9693
6188,廣明,23,14,9,富邦-新營,2023-07-26,9693
6125,廣運,11,2,9,富邦-新營,2023-07-26,9693
2421,建準,24,15,9,富邦-新營,2023-07-26,9693
3715,定穎投控,9,0,9,富邦-新營,2023-07-26,9693
1612,宏泰,12,4,8,富邦-新營,2023-07-26,9693
4934,太極,8,0,8,富邦-新營,2023-07-26,9693
00924,復華S＆P500成長,8,0,8,富邦-新營,2023-07-26,9693
1903,士紙,9,1,8,富邦-新營,2023-07-26,9693
8201,無敵,9,1,8,富邦-新營,2023-07-26,9693
3702,大聯大,8,0,8,富邦-新營,2023-07-26,9693
2344,華邦電,12,5,7,富邦-新營,2023-07-26,9693
00637L,元大滬深300正2,180,5,175,富邦-新營,2023-07-27,9693
2855,統一證,70,0,70,富邦-新營,2023-07-27,9693
6015,宏遠證,73,3,70,富邦-新營,2023-07-27,9693
2405,輔信,57,16,41,富邦-新營,2023-07-27,9693
2601,益航,43,5,38,富邦-新營,2023-07-27,9693
00673R,期元大S＆P原油反1,37,0,37,富邦-新營,2023-07-27,9693
1907,永豐餘,249,212,37,富邦-新營,2023-07-27,9693
8112,至上,37,0,37,富邦-新營,2023-07-27,9693
3715,定穎投控,31,1,30,富邦-新營,2023-07-27,9693
6026,福邦證,30,0,30,富邦-新營,2023-07-27,9693
2324,仁寶,30,1,29,富邦-新營,2023-07-27,9693
2002,中鋼,26,1,25,富邦-新營,2023-07-27,9693
00902,中信電池及儲能,25,0,25,富邦-新營,2023-07-27,9693
2885,元大金,31,8,23,富邦-新營,2023-07-27,9693
2023,燁輝,20,0,20,富邦-新營,2023-07-27,9693
2317,鴻海,16,0,16,富邦-新營,2023-07-27,9693
2387,精元,16,0,16,富邦-新營,2023-07-27,9693
6591,動力-KY,15,0,15,富邦-新營,2023-07-27,9693
2891,中信金,15,0,15,富邦-新營,2023-07-27,9693
6213,聯茂,13,0,13,富邦-新營,2023-07-27,9693
3037,欣興,22,10,12,富邦-新營,2023-07-27,9693
00679B,元大美債20年,12,0,12,富邦-新營,2023-07-27,9693
2913,農林,21,9,12,富邦-新營,2023-07-27,9693
4532,瑞智,22,11,11,富邦-新營,2023-07-27,9693
2301,光寶科,17,7,10,富邦-新營,2023-07-27,9693
6125,廣運,31,21,10,富邦-新營,2023-07-27,9693
00764B,群益25年美債,10,0,10,富邦-新營,2023-07-27,9693
00676R,富邦臺灣加權反1,10,0,10,富邦-新營,2023-07-27,9693
1104,環泥,10,0,10,富邦-新營,2023-07-27,9693
2020,美亞,10,0,10,富邦-新營,2023-07-27,9693
2025,千興,10,0,10,富邦-新營,2023-07-27,9693
2353,宏��,11,1,10,富邦-新營,2023-07-27,9693
1612,宏泰,10,1,9,富邦-新營,2023-07-27,9693
6751,智聯服務,9,0,9,富邦-新營,2023-07-27,9693
2887,台新金,9,0,9,富邦-新營,2023-07-27,9693
1319,東陽,12,4,8,富邦-新營,2023-07-27,9693
1217,愛之味,12,4,8,富邦-新營,2023-07-27,9693
1904,正隆,14,7,7,富邦-新營,2023-07-27,9693
00919,群益台灣精選高息,7,0,7,富邦-新營,2023-07-27,9693
2892,第一金,10,3,7,富邦-新營,2023-07-27,9693
3044,健鼎,7,0,7,富邦-新營,2023-07-27,9693
3609,三一東林,7,0,7,富邦-新營,2023-07-27,9693
6790,永豐實,7,0,7,富邦-新營,2023-07-27,9693
00929,復華台灣科技優息,8,1,7,富邦-新營,2023-07-27,9693
2359,所羅門,7,1,6,富邦-新營,2023-07-27,9693
4174,浩鼎,6,0,6,富邦-新營,2023-07-27,9693
4188,安克,6,0,6,富邦-新營,2023-07-27,9693
5452,佶優,6,0,6,富邦-新營,2023-07-27,9693
6196,帆宣,13,7,6,富邦-新營,2023-07-27,9693
8926,台汽電,7,1,6,富邦-新營,2023-07-27,9693
2610,華航,63,0,63,富邦-新營,2023-07-28,9693
2382,廣達,140,81,59,富邦-新營,2023-07-28,9693
2301,光寶科,179,131,48,富邦-新營,2023-07-28,9693
00679B,元大美債20年,47,2,45,富邦-新營,2023-07-28,9693
6548,長科*,30,0,30,富邦-新營,2023-07-28,9693
1217,愛之味,30,1,29,富邦-新營,2023-07-28,9693
00680L,元大美債20正2,27,0,27,富邦-新營,2023-07-28,9693
6116,彩晶,52,25,27,富邦-新營,2023-07-28,9693
1802,台玻,32,5,27,富邦-新營,2023-07-28,9693
5608,四維航,26,0,26,富邦-新營,2023-07-28,9693
1907,永豐餘,25,2,23,富邦-新營,2023-07-28,9693
2329,華泰,62,40,22,富邦-新營,2023-07-28,9693
1904,正隆,48,26,22,富邦-新營,2023-07-28,9693
3052,夆典,22,0,22,富邦-新營,2023-07-28,9693
1905,華紙,79,58,21,富邦-新營,2023-07-28,9693
00929,復華台灣科技優息,22,1,21,富邦-新營,2023-07-28,9693
00632R,元大台灣50反1,20,0,20,富邦-新營,2023-07-28,9693
2027,大成鋼,22,3,19,富邦-新營,2023-07-28,9693
2888,新光金,16,0,16,富邦-新營,2023-07-28,9693
1612,宏泰,15,0,15,富邦-新營,2023-07-28,9693
6153,嘉聯益,15,0,15,富邦-新營,2023-07-28,9693
2002,中鋼,19,7,12,富邦-新營,2023-07-28,9693
00688L,國泰20年美債正2,12,0,12,富邦-新營,2023-07-28,9693
6133,金橋,17,5,12,富邦-新營,2023-07-28,9693
1609,大亞,15,4,11,富邦-新營,2023-07-28,9693
2731,雄獅,11,0,11,富邦-新營,2023-07-28,9693
00720B,元大投資級公司債,11,0,11,富邦-新營,2023-07-28,9693
1101,台泥,10,0,10,富邦-新營,2023-07-28,9693
00764B,群益25年美債,10,0,10,富邦-新營,2023-07-28,9693
1591,駿吉-KY,10,0,10,富邦-新營,2023-07-28,9693
2605,新興,12,2,10,富邦-新營,2023-07-28,9693
3322,建舜電,40,30,10,富邦-新營,2023-07-28,9693
5009,榮剛,12,2,10,富邦-新營,2023-07-28,9693
8409,商之器,10,0,10,富邦-新營,2023-07-28,9693
3231,緯創,149,140,9,富邦-新營,2023-07-28,9693
00687B,國泰20年美債,9,0,9,富邦-新營,2023-07-28,9693
1532,勤美,9,0,9,富邦-新營,2023-07-28,9693
1783,和康生,9,0,9,富邦-新營,2023-07-28,9693
2355,敬鵬,10,1,9,富邦-新營,2023-07-28,9693
2892,第一金,10,1,9,富邦-新營,2023-07-28,9693
3289,宜特,17,9,8,富邦-新營,2023-07-28,9693
6125,廣運,8,0,8,富邦-新營,2023-07-28,9693
5388,中磊,7,0,7,富邦-新營,2023-07-28,9693
006208,富邦台50,7,0,7,富邦-新營,2023-07-28,9693
00751B,元大AAA至A公司債,7,0,7,富邦-新營,2023-07-28,9693
1809,中釉,10,3,7,富邦-新營,2023-07-28,9693
2607,榮運,7,0,7,富邦-新營,2023-07-28,9693
2614,東森,7,0,7,富邦-新營,2023-07-28,9693
2883,凱基金,8,1,7,富邦-新營,2023-07-28,9693
5871,中租-KY,6,0,6,富邦-新營,2023-07-28,9693
00632R,元大台灣50反1,176,0,176,富邦-新營,2023-07-31,9693
00878,國泰永續高股息,199,53,146,富邦-新營,2023-07-31,9693
6005,群益證,115,8,107,富邦-新營,2023-07-31,9693
00929,復華台灣科技優息,135,35,100,富邦-新營,2023-07-31,9693
2025,千興,50,0,50,富邦-新營,2023-07-31,9693
8085,福華,50,0,50,富邦-新營,2023-07-31,9693
2329,華泰,88,44,44,富邦-新營,2023-07-31,9693
2887,台新金,43,0,43,富邦-新營,2023-07-31,9693
1815,富喬,58,18,40,富邦-新營,2023-07-31,9693
2002,中鋼,39,1,38,富邦-新營,2023-07-31,9693
00680L,元大美債20正2,35,0,35,富邦-新營,2023-07-31,9693
2618,長榮航,31,1,30,富邦-新營,2023-07-31,9693
1616,億泰,30,0,30,富邦-新營,2023-07-31,9693
2352,佳世達,28,0,28,富邦-新營,2023-07-31,9693
00679B,元大美債20年,27,0,27,富邦-新營,2023-07-31,9693
5388,中磊,30,6,24,富邦-新營,2023-07-31,9693
2610,華航,27,4,23,富邦-新營,2023-07-31,9693
00897,富邦基因免疫生技,25,2,23,富邦-新營,2023-07-31,9693
6550,北極星藥業-KY,21,0,21,富邦-新營,2023-07-31,9693
6179,亞通,20,0,20,富邦-新營,2023-07-31,9693
3322,建舜電,18,0,18,富邦-新營,2023-07-31,9693
1904,正隆,21,4,17,富邦-新營,2023-07-31,9693
5009,榮剛,22,5,17,富邦-新營,2023-07-31,9693
00919,群益台灣精選高息,16,0,16,富邦-新營,2023-07-31,9693
2889,國票金,20,5,15,富邦-新營,2023-07-31,9693
2850,新產,15,0,15,富邦-新營,2023-07-31,9693
2888,新光金,77,62,15,富邦-新營,2023-07-31,9693
4720,德淵,15,0,15,富邦-新營,2023-07-31,9693
1326,台化,15,1,14,富邦-新營,2023-07-31,9693
2401,凌陽,21,7,14,富邦-新營,2023-07-31,9693
2462,良得電,13,0,13,富邦-新營,2023-07-31,9693
5512,力麒,13,0,13,富邦-新營,2023-07-31,9693
2457,飛宏,14,1,13,富邦-新營,2023-07-31,9693
1608,華榮,13,1,12,富邦-新營,2023-07-31,9693
3702,大聯大,12,0,12,富邦-新營,2023-07-31,9693
4906,正文,12,0,12,富邦-新營,2023-07-31,9693
6285,啟��,21,10,11,富邦-新營,2023-07-31,9693
00923,群益台ESG低碳50,11,0,11,富邦-新營,2023-07-31,9693
6269,台郡,10,0,10,富邦-新營,2023-07-31,9693
00673R,期元大S＆P原油反1,10,0,10,富邦-新營,2023-07-31,9693
020028,元大特選電動車N,10,0,10,富邦-新營,2023-07-31,9693
2104,國際中橡,10,0,10,富邦-新營,2023-07-31,9693
2641,正德,10,0,10,富邦-新營,2023-07-31,9693
2748,雲品,10,0,10,富邦-新營,2023-07-31,9693
3048,益登,10,0,10,富邦-新營,2023-07-31,9693
3372,典範,10,0,10,富邦-新營,2023-07-31,9693
3530,晶相光,11,1,10,富邦-新營,2023-07-31,9693
8021,尖點,11,1,10,富邦-新營,2023-07-31,9693
8183,精星,10,0,10,富邦-新營,2023-07-31,9693
8110,華東,10,0,10,富邦-新營,2023-07-31,9693
00878,國泰永續高股息,153,31,122,富邦-新營,2023-08-01,9693
2382,廣達,45,13,32,富邦-新營,2023-08-01,9693
2834,臺企銀,29,0,29,富邦-新營,2023-08-01,9693
1314,中石化,26,0,26,富邦-新營,2023-08-01,9693
3704,合勤控,36,14,22,富邦-新營,2023-08-01,9693
00929,復華台灣科技優息,77,55,22,富邦-新營,2023-08-01,9693
00916,國泰全球品牌50,20,0,20,富邦-新營,2023-08-01,9693
3035,智原,19,1,18,富邦-新營,2023-08-01,9693
1815,富喬,21,4,17,富邦-新營,2023-08-01,9693
3714,富采,20,3,17,富邦-新營,2023-08-01,9693
1802,台玻,30,13,17,富邦-新營,2023-08-01,9693
2352,佳世達,16,1,15,富邦-新營,2023-08-01,9693
00882,中信中國高股息,14,0,14,富邦-新營,2023-08-01,9693
3706,神達,18,4,14,富邦-新營,2023-08-01,9693
1514,亞力,18,5,13,富邦-新營,2023-08-01,9693
2312,金寶,161,148,13,富邦-新營,2023-08-01,9693
1326,台化,12,0,12,富邦-新營,2023-08-01,9693
1504,東元,13,1,12,富邦-新營,2023-08-01,9693
2408,南亞科,13,1,12,富邦-新營,2023-08-01,9693
6443,元晶,12,0,12,富邦-新營,2023-08-01,9693
2388,威盛,18,7,11,富邦-新營,2023-08-01,9693
00706L,期元大S＆P日圓正2,12,1,11,富邦-新營,2023-08-01,9693
1522,堤維西,11,0,11,富邦-新營,2023-08-01,9693
6550,北極星藥業-KY,22,12,10,富邦-新營,2023-08-01,9693
2303,聯電,10,0,10,富邦-新營,2023-08-01,9693
2482,連宇,10,0,10,富邦-新營,2023-08-01,9693
2547,日勝生,10,0,10,富邦-新營,2023-08-01,9693
2606,裕民,10,0,10,富邦-新營,2023-08-01,9693
1513,中興電,9,0,9,富邦-新營,2023-08-01,9693
00923,群益台ESG低碳50,9,0,9,富邦-新營,2023-08-01,9693
3037,欣興,10,2,8,富邦-新營,2023-08-01,9693
5371,中光電,12,4,8,富邦-新營,2023-08-01,9693
6239,力成,9,1,8,富邦-新營,2023-08-01,9693
3033,威健,20,12,8,富邦-新營,2023-08-01,9693
2338,光罩,7,0,7,富邦-新營,2023-08-01,9693
5388,中磊,12,5,7,富邦-新營,2023-08-01,9693
2402,毅嘉,13,7,6,富邦-新營,2023-08-01,9693
2412,中華電,6,0,6,富邦-新營,2023-08-01,9693
2495,普安,6,0,6,富邦-新營,2023-08-01,9693
3011,今皓,6,0,6,富邦-新營,2023-08-01,9693
3596,智易,6,0,6,富邦-新營,2023-08-01,9693
5009,榮剛,8,2,6,富邦-新營,2023-08-01,9693
8112,至上,6,0,6,富邦-新營,2023-08-01,9693
3056,富華新,7,1,6,富邦-新營,2023-08-01,9693
3044,健鼎,5,0,5,富邦-新營,2023-08-01,9693
00673R,期元大S＆P原油反1,5,0,5,富邦-新營,2023-08-01,9693
00772B,中信高評級公司債,10,5,5,富邦-新營,2023-08-01,9693
1455,集盛,5,0,5,富邦-新營,2023-08-01,9693
3211,順達,5,0,5,富邦-新營,2023-08-01,9693
5351,鈺創,6,1,5,富邦-新營,2023-08-01,9693
00929,復華台灣科技優息,151,22,129,富邦-新營,2023-08-02,9693
00637L,元大滬深300正2,120,5,115,富邦-新營,2023-08-02,9693
00900,富邦特選高股息30,124,10,114,富邦-新營,2023-08-02,9693
00878,國泰永續高股息,202,93,109,富邦-新營,2023-08-02,9693
2851,中再保,100,0,100,富邦-新營,2023-08-02,9693
1326,台化,55,0,55,富邦-新營,2023-08-02,9693
00680L,元大美債20正2,48,0,48,富邦-新營,2023-08-02,9693
2601,益航,43,1,42,富邦-新營,2023-08-02,9693
00923,群益台ESG低碳50,39,0,39,富邦-新營,2023-08-02,9693
2356,英業達,38,1,37,富邦-新營,2023-08-02,9693
00885,富邦越南,37,1,36,富邦-新營,2023-08-02,9693
6116,彩晶,45,10,35,富邦-新營,2023-08-02,9693
00712,復華富時不動產,34,0,34,富邦-新營,2023-08-02,9693
1536,和大,32,0,32,富邦-新營,2023-08-02,9693
2382,廣達,52,21,31,富邦-新營,2023-08-02,9693
2834,臺企銀,34,3,31,富邦-新營,2023-08-02,9693
6282,康舒,49,20,29,富邦-新營,2023-08-02,9693
3231,緯創,52,25,27,富邦-新營,2023-08-02,9693
2301,光寶科,27,3,24,富邦-新營,2023-08-02,9693
3033,威健,28,5,23,富邦-新營,2023-08-02,9693
00632R,元大台灣50反1,25,3,22,富邦-新營,2023-08-02,9693
6505,台塑化,21,0,21,富邦-新營,2023-08-02,9693
2887,台新金,34,14,20,富邦-新營,2023-08-02,9693
2530,華建,19,0,19,富邦-新營,2023-08-02,9693
2883,凱基金,20,1,19,富邦-新營,2023-08-02,9693
4746,台耀,62,43,19,富邦-新營,2023-08-02,9693
6285,啟��,35,17,18,富邦-新營,2023-08-02,9693
00679B,元大美債20年,19,2,17,富邦-新營,2023-08-02,9693
2002,中鋼,17,0,17,富邦-新營,2023-08-02,9693
2886,兆豐金,17,0,17,富邦-新營,2023-08-02,9693
00892,富邦台灣半導體,17,1,16,富邦-新營,2023-08-02,9693
2324,仁寶,20,5,15,富邦-新營,2023-08-02,9693
00919,群益台灣精選高息,16,1,15,富邦-新營,2023-08-02,9693
2353,宏��,15,0,15,富邦-新營,2023-08-02,9693
2913,農林,34,20,14,富邦-新營,2023-08-02,9693
1605,華新,99,86,13,富邦-新營,2023-08-02,9693
5452,佶優,13,0,13,富邦-新營,2023-08-02,9693
3704,合勤控,15,3,12,富邦-新營,2023-08-02,9693
2402,毅嘉,48,36,12,富邦-新營,2023-08-02,9693
6188,廣明,18,7,11,富邦-新營,2023-08-02,9693
00772B,中信高評級公司債,11,0,11,富邦-新營,2023-08-02,9693
1314,中石化,36,25,11,富邦-新營,2023-08-02,9693
2388,威盛,12,1,11,富邦-新營,2023-08-02,9693
3702,大聯大,12,1,11,富邦-新營,2023-08-02,9693
4532,瑞智,21,10,11,富邦-新營,2023-08-02,9693
6190,萬泰科,14,3,11,富邦-新營,2023-08-02,9693
1513,中興電,12,2,10,富邦-新營,2023-08-02,9693
2880,華南金,10,0,10,富邦-新營,2023-08-02,9693
00688L,國泰20年美債正2,10,0,10,富邦-新營,2023-08-02,9693
2482,連宇,20,10,10,富邦-新營,2023-08-02,9693
2027,大成鋼,374,0,374,富邦-新營,2023-08-04,9693
00773B,中信優先金融債,209,0,209,富邦-新營,2023-08-04,9693
00772B,中信高評級公司債,207,0,207,富邦-新營,2023-08-04,9693
00688L,國泰20年美債正2,171,0,171,富邦-新營,2023-08-04,9693
2344,華邦電,180,13,167,富邦-新營,2023-08-04,9693
00650L,復華香港正2,121,0,121,富邦-新營,2023-08-04,9693
2883,凱基金,107,1,106,富邦-新營,2023-08-04,9693
00680L,元大美債20正2,91,0,91,富邦-新營,2023-08-04,9693
00929,復華台灣科技優息,83,0,83,富邦-新營,2023-08-04,9693
1608,華榮,49,8,41,富邦-新營,2023-08-04,9693
1605,華新,38,3,35,富邦-新營,2023-08-04,9693
2891,中信金,34,0,34,富邦-新營,2023-08-04,9693
00687B,國泰20年美債,26,1,25,富邦-新營,2023-08-04,9693
2352,佳世達,23,4,19,富邦-新營,2023-08-04,9693
3706,神達,28,11,17,富邦-新營,2023-08-04,9693
2356,英業達,90,74,16,富邦-新營,2023-08-04,9693
8215,明基材,17,2,15,富邦-新營,2023-08-04,9693
1609,大亞,24,11,13,富邦-新營,2023-08-04,9693
3704,合勤控,12,0,12,富邦-新營,2023-08-04,9693
2303,聯電,18,6,12,富邦-新營,2023-08-04,9693
2489,瑞軒,12,0,12,富邦-新營,2023-08-04,9693
4746,台耀,17,5,12,富邦-新營,2023-08-04,9693
1785,光洋科,13,2,11,富邦-新營,2023-08-04,9693
3163,波若威,11,0,11,富邦-新營,2023-08-04,9693
00764B,群益25年美債,10,0,10,富邦-新營,2023-08-04,9693
2392,正崴,10,0,10,富邦-新營,2023-08-04,9693
00673R,期元大S＆P原油反1,10,0,10,富邦-新營,2023-08-04,9693
4721,美琪瑪,10,0,10,富邦-新營,2023-08-04,9693
3481,群創,11,2,9,富邦-新營,2023-08-04,9693
1513,中興電,24,15,9,富邦-新營,2023-08-04,9693
00912,中信臺灣智慧50,9,0,9,富邦-新營,2023-08-04,9693
00930,永豐ESG低碳高息,9,0,9,富邦-新營,2023-08-04,9693
6548,長科*,11,3,8,富邦-新營,2023-08-04,9693
00679B,元大美債20年,57,50,7,富邦-新營,2023-08-04,9693
00738U,期元大道瓊白銀,7,0,7,富邦-新營,2023-08-04,9693
00885,富邦越南,9,2,7,富邦-新營,2023-08-04,9693
00923,群益台ESG低碳50,7,0,7,富邦-新營,2023-08-04,9693
3013,晟銘電,9,2,7,富邦-新營,2023-08-04,9693
00919,群益台灣精選高息,6,0,6,富邦-新營,2023-08-04,9693
1616,億泰,7,1,6,富邦-新營,2023-08-04,9693
3033,威健,10,4,6,富邦-新營,2023-08-04,9693
6153,嘉聯益,6,0,6,富邦-新營,2023-08-04,9693
6274,台燿,12,6,6,富邦-新營,2023-08-04,9693
1907,永豐餘,6,0,6,富邦-新營,2023-08-04,9693
00795B,中信美國公債20年,6,0,6,富邦-新營,2023-08-04,9693
3576,聯合再生,7,2,5,富邦-新營,2023-08-04,9693
3037,欣興,6,1,5,富邦-新營,2023-08-04,9693
2637,慧洋-KY,5,0,5,富邦-新營,2023-08-04,9693
00722B,群益投資級電信債,5,0,5,富邦-新營,2023-08-04,9693
00665L,富邦�琤肭磪囓�2,15,10,5,富邦-新營,2023-08-04,9693
2913,農林,91,1,90,富邦-新營,2023-08-07,9693
2851,中再保,89,1,88,富邦-新營,2023-08-07,9693
00929,復華台灣科技優息,113,36,77,富邦-新營,2023-08-07,9693
6285,啟��,53,4,49,富邦-新營,2023-08-07,9693
3362,先進光,42,0,42,富邦-新營,2023-08-07,9693
2303,聯電,52,12,40,富邦-新營,2023-08-07,9693
5009,榮剛,40,5,35,富邦-新營,2023-08-07,9693
2382,廣達,260,230,30,富邦-新營,2023-08-07,9693
00923,群益台ESG低碳50,28,0,28,富邦-新營,2023-08-07,9693
1609,大亞,28,3,25,富邦-新營,2023-08-07,9693
00900,富邦特選高股息30,29,4,25,富邦-新營,2023-08-07,9693
2367,燿華,25,0,25,富邦-新營,2023-08-07,9693
2317,鴻海,24,1,23,富邦-新營,2023-08-07,9693
3033,威健,24,1,23,富邦-新營,2023-08-07,9693
00931B,統一美債20年,32,10,22,富邦-新營,2023-08-07,9693
2892,第一金,18,0,18,富邦-新營,2023-08-07,9693
3013,晟銘電,16,0,16,富邦-新營,2023-08-07,9693
1314,中石化,16,1,15,富邦-新營,2023-08-07,9693
5880,合庫金,15,0,15,富邦-新營,2023-08-07,9693
2610,華航,15,1,14,富邦-新營,2023-08-07,9693
1909,榮成,14,0,14,富邦-新營,2023-08-07,9693
2618,長榮航,27,13,14,富邦-新營,2023-08-07,9693
2312,金寶,63,50,13,富邦-新營,2023-08-07,9693
2481,強茂,14,1,13,富邦-新營,2023-08-07,9693
6116,彩晶,17,4,13,富邦-新營,2023-08-07,9693
8150,南茂,14,1,13,富邦-新營,2023-08-07,9693
4906,正文,20,7,13,富邦-新營,2023-08-07,9693
1608,華榮,16,4,12,富邦-新營,2023-08-07,9693
5371,中光電,13,1,12,富邦-新營,2023-08-07,9693
2603,長榮,13,2,11,富邦-新營,2023-08-07,9693
2419,仲琦,18,7,11,富邦-新營,2023-08-07,9693
6015,宏遠證,11,0,11,富邦-新營,2023-08-07,9693
00673R,期元大S＆P原油反1,10,0,10,富邦-新營,2023-08-07,9693
6219,富旺,10,0,10,富邦-新營,2023-08-07,9693
2891,中信金,10,0,10,富邦-新營,2023-08-07,9693
1905,華紙,11,2,9,富邦-新營,2023-08-07,9693
2812,台中銀,9,0,9,富邦-新營,2023-08-07,9693
6217,中探針,10,1,9,富邦-新營,2023-08-07,9693
1108,幸福,8,0,8,富邦-新營,2023-08-07,9693
1455,集盛,8,0,8,富邦-新營,2023-08-07,9693
2458,義隆,7,0,7,富邦-新營,2023-08-07,9693
1785,光洋科,7,0,7,富邦-新營,2023-08-07,9693
2516,新建,7,0,7,富邦-新營,2023-08-07,9693
8390,金益鼎,13,6,7,富邦-新營,2023-08-07,9693
1904,正隆,7,0,7,富邦-新營,2023-08-07,9693
1513,中興電,7,1,6,富邦-新營,2023-08-07,9693
2324,仁寶,9,3,6,富邦-新營,2023-08-07,9693
2609,陽明,20,14,6,富邦-新營,2023-08-07,9693
3017,奇鋐,44,39,5,富邦-新營,2023-08-07,9693
00680L,元大美債20正2,5,0,5,富邦-新營,2023-08-07,9693
2516,新建,55,0,55,富邦-新營,2023-08-08,9693
00772B,中信高評級公司債,50,0,50,富邦-新營,2023-08-08,9693
00878,國泰永續高股息,108,59,49,富邦-新營,2023-08-08,9693
2329,華泰,245,204,41,富邦-新營,2023-08-08,9693
3231,緯創,178,138,40,富邦-新營,2023-08-08,9693
4916,事欣科,40,0,40,富邦-新營,2023-08-08,9693
00929,復華台灣科技優息,74,34,40,富邦-新營,2023-08-08,9693
2376,技嘉,52,13,39,富邦-新營,2023-08-08,9693
00900,富邦特選高股息30,31,0,31,富邦-新營,2023-08-08,9693
00931B,統一美債20年,28,0,28,富邦-新營,2023-08-08,9693
2809,京城銀,30,2,28,富邦-新營,2023-08-08,9693
2301,光寶科,32,10,22,富邦-新營,2023-08-08,9693
2027,大成鋼,23,1,22,富邦-新營,2023-08-08,9693
2356,英業達,61,39,22,富邦-新營,2023-08-08,9693
2851,中再保,22,0,22,富邦-新營,2023-08-08,9693
2387,精元,20,0,20,富邦-新營,2023-08-08,9693
3163,波若威,30,12,18,富邦-新營,2023-08-08,9693
00923,群益台ESG低碳50,15,0,15,富邦-新營,2023-08-08,9693
2303,聯電,20,5,15,富邦-新營,2023-08-08,9693
00680L,元大美債20正2,15,0,15,富邦-新營,2023-08-08,9693
00712,復華富時不動產,15,0,15,富邦-新營,2023-08-08,9693
2834,臺企銀,14,0,14,富邦-新營,2023-08-08,9693
3706,神達,26,12,14,富邦-新營,2023-08-08,9693
00751B,元大AAA至A公司債,13,0,13,富邦-新營,2023-08-08,9693
2440,太空梭,13,0,13,富邦-新營,2023-08-08,9693
2515,中工,13,0,13,富邦-新營,2023-08-08,9693
5905,南仁湖,13,0,13,富邦-新營,2023-08-08,9693
2801,彰銀,12,0,12,富邦-新營,2023-08-08,9693
3037,欣興,13,1,12,富邦-新營,2023-08-08,9693
3207,耀勝,13,1,12,富邦-新營,2023-08-08,9693
5484,慧友,12,0,12,富邦-新營,2023-08-08,9693
2385,群光,11,0,11,富邦-新營,2023-08-08,9693
6104,創惟,12,1,11,富邦-新營,2023-08-08,9693
3023,信邦,10,0,10,富邦-新營,2023-08-08,9693
00706L,期元大S＆P日圓正2,10,0,10,富邦-新營,2023-08-08,9693
1720,生達,10,0,10,富邦-新營,2023-08-08,9693
2338,光罩,10,0,10,富邦-新營,2023-08-08,9693
2482,連宇,10,0,10,富邦-新營,2023-08-08,9693
3711,日月光投控,11,1,10,富邦-新營,2023-08-08,9693
00795B,中信美國公債20年,9,0,9,富邦-新營,2023-08-08,9693
5347,世界,9,0,9,富邦-新營,2023-08-08,9693
00892,富邦台灣半導體,19,10,9,富邦-新營,2023-08-08,9693
1319,東陽,9,0,9,富邦-新營,2023-08-08,9693
1909,榮成,9,0,9,富邦-新營,2023-08-08,9693
2344,華邦電,9,0,9,富邦-新營,2023-08-08,9693
3545,敦泰,10,1,9,富邦-新營,2023-08-08,9693
3715,定穎投控,10,1,9,富邦-新營,2023-08-08,9693
6182,合晶,9,0,9,富邦-新營,2023-08-08,9693
2419,仲琦,16,8,8,富邦-新營,2023-08-08,9693
6625,必應,8,0,8,富邦-新營,2023-08-08,9693
00795B,中信美國公債20年,140,2,138,富邦-新營,2023-08-09,9693
00715L,期街口布蘭特正2,101,3,98,富邦-新營,2023-08-09,9693
00772B,中信高評級公司債,101,16,85,富邦-新營,2023-08-09,9693
00929,復華台灣科技優息,70,2,68,富邦-新營,2023-08-09,9693
2329,華泰,43,1,42,富邦-新營,2023-08-09,9693
2618,長榮航,59,19,40,富邦-新營,2023-08-09,9693
2409,友達,32,1,31,富邦-新營,2023-08-09,9693
00878,國泰永續高股息,53,25,28,富邦-新營,2023-08-09,9693
1605,華新,23,1,22,富邦-新營,2023-08-09,9693
2382,廣達,33,12,21,富邦-新營,2023-08-09,9693
2027,大成鋼,24,3,21,富邦-新營,2023-08-09,9693
4908,前鼎,21,0,21,富邦-新營,2023-08-09,9693
2385,群光,19,0,19,富邦-新營,2023-08-09,9693
3231,緯創,53,35,18,富邦-新營,2023-08-09,9693
1802,台玻,39,22,17,富邦-新營,2023-08-09,9693
00900,富邦特選高股息30,15,0,15,富邦-新營,2023-08-09,9693
2834,臺企銀,15,1,14,富邦-新營,2023-08-09,9693
1217,愛之味,13,0,13,富邦-新營,2023-08-09,9693
2002,中鋼,12,0,12,富邦-新營,2023-08-09,9693
00919,群益台灣精選高息,12,0,12,富邦-新營,2023-08-09,9693
00931B,統一美債20年,11,0,11,富邦-新營,2023-08-09,9693
2344,華邦電,12,1,11,富邦-新營,2023-08-09,9693
2516,新建,11,0,11,富邦-新營,2023-08-09,9693
00915,凱基優選高股息30,10,0,10,富邦-新營,2023-08-09,9693
1536,和大,10,0,10,富邦-新營,2023-08-09,9693
2460,建通,10,0,10,富邦-新營,2023-08-09,9693
4960,誠美材,10,0,10,富邦-新營,2023-08-09,9693
2883B,凱基金乙特,10,0,10,富邦-新營,2023-08-09,9693
5009,榮剛,15,6,9,富邦-新營,2023-08-09,9693
4533,協易機,9,0,9,富邦-新營,2023-08-09,9693
2353,宏��,33,25,8,富邦-新營,2023-08-09,9693
3038,全台,8,0,8,富邦-新營,2023-08-09,9693
5512,力麒,8,0,8,富邦-新營,2023-08-09,9693
2301,光寶科,26,19,7,富邦-新營,2023-08-09,9693
1909,榮成,7,0,7,富邦-新營,2023-08-09,9693
3710,連展投控,7,0,7,富邦-新營,2023-08-09,9693
4532,瑞智,10,3,7,富邦-新營,2023-08-09,9693
3362,先進光,7,1,6,富邦-新營,2023-08-09,9693
00923,群益台ESG低碳50,6,0,6,富邦-新營,2023-08-09,9693
2356,英業達,39,33,6,富邦-新營,2023-08-09,9693
3583,辛耘,29,23,6,富邦-新營,2023-08-09,9693
8926,台汽電,21,16,5,富邦-新營,2023-08-09,9693
3706,神達,9,4,5,富邦-新營,2023-08-09,9693
2915,潤泰全,5,0,5,富邦-新營,2023-08-09,9693
1608,華榮,8,3,5,富邦-新營,2023-08-09,9693
00892,富邦台灣半導體,5,0,5,富邦-新營,2023-08-09,9693
1524,耿鼎,5,0,5,富邦-新營,2023-08-09,9693
1609,大亞,7,2,5,富邦-新營,2023-08-09,9693
2201,裕隆,7,2,5,富邦-新營,2023-08-09,9693
2367,燿華,5,0,5,富邦-新營,2023-08-09,9693
00929,復華台灣科技優息,282,102,180,富邦-新營,2023-08-10,9693
00706L,期元大S＆P日圓正2,154,0,154,富邦-新營,2023-08-10,9693
2801,彰銀,137,0,137,富邦-新營,2023-08-10,9693
00673R,期元大S＆P原油反1,101,4,97,富邦-新營,2023-08-10,9693
00900,富邦特選高股息30,88,2,86,富邦-新營,2023-08-10,9693
00665L,富邦�琤肭磪囓�2,70,0,70,富邦-新營,2023-08-10,9693
2409,友達,78,13,65,富邦-新營,2023-08-10,9693
00878,國泰永續高股息,94,52,42,富邦-新營,2023-08-10,9693
2888,新光金,79,37,42,富邦-新營,2023-08-10,9693
2610,華航,50,11,39,富邦-新營,2023-08-10,9693
00720B,元大投資級公司債,36,0,36,富邦-新營,2023-08-10,9693
6116,彩晶,36,0,36,富邦-新營,2023-08-10,9693
6282,康舒,43,8,35,富邦-新營,2023-08-10,9693
00753L,中信中國50正2,30,0,30,富邦-新營,2023-08-10,9693
2515,中工,30,0,30,富邦-新營,2023-08-10,9693
6591,動力-KY,30,0,30,富邦-新營,2023-08-10,9693
3481,群創,38,8,30,富邦-新營,2023-08-10,9693
2382,廣達,36,8,28,富邦-新營,2023-08-10,9693
1904,正隆,21,0,21,富邦-新營,2023-08-10,9693
2891,中信金,19,0,19,富邦-新營,2023-08-10,9693
2408,南亞科,18,0,18,富邦-新營,2023-08-10,9693
2324,仁寶,22,5,17,富邦-新營,2023-08-10,9693
00642U,期元大S＆P石油,16,1,15,富邦-新營,2023-08-10,9693
3047,訊舟,20,6,14,富邦-新營,2023-08-10,9693
6153,嘉聯益,14,0,14,富邦-新營,2023-08-10,9693
2886,兆豐金,13,0,13,富邦-新營,2023-08-10,9693
1718,中纖,13,0,13,富邦-新營,2023-08-10,9693
4906,正文,13,0,13,富邦-新營,2023-08-10,9693
6796,晉弘,15,2,13,富邦-新營,2023-08-10,9693
00919,群益台灣精選高息,12,0,12,富邦-新營,2023-08-10,9693
1712,興農,12,0,12,富邦-新營,2023-08-10,9693
2312,金寶,22,10,12,富邦-新營,2023-08-10,9693
2323,中環,14,2,12,富邦-新營,2023-08-10,9693
2338,光罩,13,1,12,富邦-新營,2023-08-10,9693
2883,凱基金,12,0,12,富邦-新營,2023-08-10,9693
4958,臻鼎-KY,14,2,12,富邦-新營,2023-08-10,9693
2002,中鋼,15,4,11,富邦-新營,2023-08-10,9693
2412,中華電,11,0,11,富邦-新營,2023-08-10,9693
3032,偉訓,11,0,11,富邦-新營,2023-08-10,9693
3231,緯創,223,213,10,富邦-新營,2023-08-10,9693
00930,永豐ESG低碳高息,10,0,10,富邦-新營,2023-08-10,9693
00773B,中信優先金融債,10,0,10,富邦-新營,2023-08-10,9693
1536,和大,10,0,10,富邦-新營,2023-08-10,9693
2208,台船,10,0,10,富邦-新營,2023-08-10,9693
2883B,凱基金乙特,10,0,10,富邦-新營,2023-08-10,9693
6625,必應,10,0,10,富邦-新營,2023-08-10,9693
1504,東元,11,2,9,富邦-新營,2023-08-10,9693
0056,元大高股息,9,0,9,富邦-新營,2023-08-10,9693
00888,永豐台灣ESG,9,0,9,富邦-新營,2023-08-10,9693
2406,國碩,10,1,9,富邦-新營,2023-08-10,9693
00706L,期元大S＆P日圓正2,3595,0,3595,富邦-新營,2023-08-11,9693
00772B,中信高評級公司債,402,0,402,富邦-新營,2023-08-11,9693
2892,第一金,170,0,170,富邦-新營,2023-08-11,9693
2851,中再保,90,11,79,富邦-新營,2023-08-11,9693
4906,正文,78,0,78,富邦-新營,2023-08-11,9693
00929,復華台灣科技優息,49,3,46,富邦-新營,2023-08-11,9693
2618,長榮航,58,21,37,富邦-新營,2023-08-11,9693
2409,友達,36,4,32,富邦-新營,2023-08-11,9693
2356,英業達,51,22,29,富邦-新營,2023-08-11,9693
00665L,富邦�琤肭磪囓�2,25,0,25,富邦-新營,2023-08-11,9693
00900,富邦特選高股息30,24,0,24,富邦-新營,2023-08-11,9693
6116,彩晶,53,30,23,富邦-新營,2023-08-11,9693
3231,緯創,53,31,22,富邦-新營,2023-08-11,9693
1109,信大,22,0,22,富邦-新營,2023-08-11,9693
3706,神達,32,10,22,富邦-新營,2023-08-11,9693
6153,嘉聯益,21,0,21,富邦-新營,2023-08-11,9693
2002,中鋼,19,1,18,富邦-新營,2023-08-11,9693
2317,鴻海,23,5,18,富邦-新營,2023-08-11,9693
8112,至上,15,1,14,富邦-新營,2023-08-11,9693
00680L,元大美債20正2,12,0,12,富邦-新營,2023-08-11,9693
1536,和大,11,0,11,富邦-新營,2023-08-11,9693
00687B,國泰20年美債,11,0,11,富邦-新營,2023-08-11,9693
1504,東元,16,5,11,富邦-新營,2023-08-11,9693
00679B,元大美債20年,10,0,10,富邦-新營,2023-08-11,9693
2206,三陽工業,16,6,10,富邦-新營,2023-08-11,9693
5009,榮剛,13,3,10,富邦-新營,2023-08-11,9693
1217,愛之味,10,0,10,富邦-新營,2023-08-11,9693
2883B,凱基金乙特,10,0,10,富邦-新營,2023-08-11,9693
4168,醣聯,10,0,10,富邦-新營,2023-08-11,9693
6605,帝寶,10,0,10,富邦-新營,2023-08-11,9693
1319,東陽,11,1,10,富邦-新營,2023-08-11,9693
1108,幸福,10,0,10,富邦-新營,2023-08-11,9693
3481,群創,16,7,9,富邦-新營,2023-08-11,9693
4533,協易機,10,1,9,富邦-新營,2023-08-11,9693
5902,德記,9,0,9,富邦-新營,2023-08-11,9693
6219,富旺,9,0,9,富邦-新營,2023-08-11,9693
6796,晉弘,9,0,9,富邦-新營,2023-08-11,9693
3707,漢磊,9,0,9,富邦-新營,2023-08-11,9693
2609,陽明,12,4,8,富邦-新營,2023-08-11,9693
3037,欣興,13,5,8,富邦-新營,2023-08-11,9693
5512,力麒,8,0,8,富邦-新營,2023-08-11,9693
6712,長聖,8,0,8,富邦-新營,2023-08-11,9693
1795,美時,7,0,7,富邦-新營,2023-08-11,9693
00888,永豐台灣ESG,7,0,7,富邦-新營,2023-08-11,9693
2886,兆豐金,7,0,7,富邦-新營,2023-08-11,9693
2314,台揚,7,0,7,富邦-新營,2023-08-11,9693
3483,力致,7,0,7,富邦-新營,2023-08-11,9693
2330,台積電,8,1,7,富邦-新營,2023-08-11,9693
00931B,統一美債20年,6,0,6,富邦-新營,2023-08-11,9693
2495,普安,6,0,6,富邦-新營,2023-08-11,9693
00706L,期元大S＆P日圓正2,585,0,585,富邦-新營,2023-08-14,9693
00929,復華台灣科技優息,339,0,339,富邦-新營,2023-08-14,9693
00900,富邦特選高股息30,153,10,143,富邦-新營,2023-08-14,9693
00632R,元大台灣50反1,105,2,103,富邦-新營,2023-08-14,9693
3481,群創,84,1,83,富邦-新營,2023-08-14,9693
2801,彰銀,81,11,70,富邦-新營,2023-08-14,9693
4109,加捷生醫,50,0,50,富邦-新營,2023-08-14,9693
2409,友達,42,0,42,富邦-新營,2023-08-14,9693
2610,華航,46,10,36,富邦-新營,2023-08-14,9693
2834,臺企銀,35,1,34,富邦-新營,2023-08-14,9693
2888,新光金,35,2,33,富邦-新營,2023-08-14,9693
00720B,元大投資級公司債,31,0,31,富邦-新營,2023-08-14,9693
1217,愛之味,30,0,30,富邦-新營,2023-08-14,9693
2851,中再保,30,0,30,富邦-新營,2023-08-14,9693
2891,中信金,32,2,30,富邦-新營,2023-08-14,9693
2892,第一金,27,0,27,富邦-新營,2023-08-14,9693
00753L,中信中國50正2,25,0,25,富邦-新營,2023-08-14,9693
00923,群益台ESG低碳50,33,10,23,富邦-新營,2023-08-14,9693
1513,中興電,22,0,22,富邦-新營,2023-08-14,9693
2349,錸德,20,0,20,富邦-新營,2023-08-14,9693
6116,彩晶,19,0,19,富邦-新營,2023-08-14,9693
3231,緯創,38,20,18,富邦-新營,2023-08-14,9693
2356,英業達,44,27,17,富邦-新營,2023-08-14,9693
2363,矽統,24,7,17,富邦-新營,2023-08-14,9693
00931B,統一美債20年,16,0,16,富邦-新營,2023-08-14,9693
2634,漢翔,19,3,16,富邦-新營,2023-08-14,9693
1314,中石化,20,5,15,富邦-新營,2023-08-14,9693
2609,陽明,20,5,15,富邦-新營,2023-08-14,9693
3047,訊舟,15,0,15,富邦-新營,2023-08-14,9693
2880,華南金,14,0,14,富邦-新營,2023-08-14,9693
2603,長榮,14,2,12,富邦-新營,2023-08-14,9693
1533,車王電,12,0,12,富邦-新營,2023-08-14,9693
2425,承啟,12,0,12,富邦-新營,2023-08-14,9693
2897,王道銀行,12,0,12,富邦-新營,2023-08-14,9693
3322,建舜電,14,2,12,富邦-新營,2023-08-14,9693
2027,大成鋼,11,0,11,富邦-新營,2023-08-14,9693
00679B,元大美債20年,11,0,11,富邦-新營,2023-08-14,9693
00696B,富邦美債20年,10,0,10,富邦-新營,2023-08-14,9693
1409,新纖,10,0,10,富邦-新營,2023-08-14,9693
1712,興農,10,0,10,富邦-新營,2023-08-14,9693
1718,中纖,10,0,10,富邦-新營,2023-08-14,9693
2516,新建,10,0,10,富邦-新營,2023-08-14,9693
2543,皇昌,10,0,10,富邦-新營,2023-08-14,9693
6796,晉弘,10,0,10,富邦-新營,2023-08-14,9693
2618,長榮航,22,12,10,富邦-新營,2023-08-14,9693
00773B,中信優先金融債,9,0,9,富邦-新營,2023-08-14,9693
2323,中環,27,18,9,富邦-新營,2023-08-14,9693
2460,建通,9,0,9,富邦-新營,2023-08-14,9693
6546,正基,10,1,9,富邦-新營,2023-08-14,9693
8112,至上,11,2,9,富邦-新營,2023-08-14,9693
00923,群益台ESG低碳50,420,2,418,富邦-新營,2023-08-15,9693
2515,中工,101,6,95,富邦-新營,2023-08-15,9693
00706L,期元大S＆P日圓正2,50,0,50,富邦-新營,2023-08-15,9693
6153,嘉聯益,46,0,46,富邦-新營,2023-08-15,9693
00931B,統一美債20年,35,0,35,富邦-新營,2023-08-15,9693
2317,鴻海,33,4,29,富邦-新營,2023-08-15,9693
00929,復華台灣科技優息,27,1,26,富邦-新營,2023-08-15,9693
2883,凱基金,23,1,22,富邦-新營,2023-08-15,9693
1467,南緯,22,0,22,富邦-新營,2023-08-15,9693
2027,大成鋼,20,0,20,富邦-新營,2023-08-15,9693
2801,彰銀,20,0,20,富邦-新營,2023-08-15,9693
2888,新光金,24,6,18,富邦-新營,2023-08-15,9693
00900,富邦特選高股息30,22,5,17,富邦-新營,2023-08-15,9693
00878,國泰永續高股息,32,15,17,富邦-新營,2023-08-15,9693
00712,復華富時不動產,16,0,16,富邦-新營,2023-08-15,9693
2609,陽明,14,1,13,富邦-新營,2023-08-15,9693
3481,群創,63,50,13,富邦-新營,2023-08-15,9693
2897,王道銀行,11,0,11,富邦-新營,2023-08-15,9693
8086,宏捷科,11,0,11,富邦-新營,2023-08-15,9693
2884,玉山金,12,2,10,富邦-新營,2023-08-15,9693
2851,中再保,15,5,10,富邦-新營,2023-08-15,9693
00895,富邦未來車,10,0,10,富邦-新營,2023-08-15,9693
1514,亞力,10,0,10,富邦-新營,2023-08-15,9693
2606,裕民,10,0,10,富邦-新營,2023-08-15,9693
5452,佶優,10,0,10,富邦-新營,2023-08-15,9693
2323,中環,19,10,9,富邦-新營,2023-08-15,9693
2891,中信金,24,15,9,富邦-新營,2023-08-15,9693
3231,緯創,48,40,8,富邦-新營,2023-08-15,9693
3689,湧德,7,0,7,富邦-新營,2023-08-15,9693
00679B,元大美債20年,6,0,6,富邦-新營,2023-08-15,9693
00924,復華S＆P500成長,6,0,6,富邦-新營,2023-08-15,9693
00680L,元大美債20正2,6,0,6,富邦-新營,2023-08-15,9693
00751B,元大AAA至A公司債,6,0,6,富邦-新營,2023-08-15,9693
00665L,富邦�琤肭磪囓�2,6,0,6,富邦-新營,2023-08-15,9693
1309,台達化,6,0,6,富邦-新營,2023-08-15,9693
00753L,中信中國50正2,5,0,5,富邦-新營,2023-08-15,9693
00673R,期元大S＆P原油反1,5,0,5,富邦-新營,2023-08-15,9693
00631L,元大台灣50正2,5,0,5,富邦-新營,2023-08-15,9693
1789,神隆,5,0,5,富邦-新營,2023-08-15,9693
2349,錸德,5,0,5,富邦-新營,2023-08-15,9693
2618,長榮航,5,0,5,富邦-新營,2023-08-15,9693
3163,波若威,6,1,5,富邦-新營,2023-08-15,9693
6005,群益證,5,0,5,富邦-新營,2023-08-15,9693
2014,中鴻,4,0,4,富邦-新營,2023-08-15,9693
2890,永豐金,4,0,4,富邦-新營,2023-08-15,9693
1101,台泥,4,0,4,富邦-新營,2023-08-15,9693
00637L,元大滬深300正2,5,1,4,富邦-新營,2023-08-15,9693
2614,東森,4,0,4,富邦-新營,2023-08-15,9693
2880,華南金,4,0,4,富邦-新營,2023-08-15,9693
3264,欣銓,4,0,4,富邦-新營,2023-08-15,9693
00929,復華台灣科技優息,154,4,150,富邦-新營,2023-08-16,9693
2303,聯電,121,2,119,富邦-新營,2023-08-16,9693
2515,中工,100,0,100,富邦-新營,2023-08-16,9693
2883B,凱基金乙特,100,0,100,富邦-新營,2023-08-16,9693
2516,新建,90,0,90,富邦-新營,2023-08-16,9693
00878,國泰永續高股息,68,5,63,富邦-新營,2023-08-16,9693
3481,群創,55,0,55,富邦-新營,2023-08-16,9693
2892,第一金,50,0,50,富邦-新營,2023-08-16,9693
00712,復華富時不動產,44,0,44,富邦-新營,2023-08-16,9693
2002,中鋼,40,0,40,富邦-新營,2023-08-16,9693
2834,臺企銀,52,12,40,富邦-新營,2023-08-16,9693
2382,廣達,103,72,31,富邦-新營,2023-08-16,9693
2801,彰銀,30,0,30,富邦-新營,2023-08-16,9693
00706L,期元大S＆P日圓正2,30,0,30,富邦-新營,2023-08-16,9693
6244,茂迪,30,1,29,富邦-新營,2023-08-16,9693
00923,群益台ESG低碳50,28,3,25,富邦-新營,2023-08-16,9693
1101,台泥,29,5,24,富邦-新營,2023-08-16,9693
2317,鴻海,26,2,24,富邦-新營,2023-08-16,9693
6116,彩晶,40,17,23,富邦-新營,2023-08-16,9693
6282,康舒,23,0,23,富邦-新營,2023-08-16,9693
2883,凱基金,24,3,21,富邦-新營,2023-08-16,9693
2329,華泰,293,272,21,富邦-新營,2023-08-16,9693
00900,富邦特選高股息30,21,0,21,富邦-新營,2023-08-16,9693
3693,營邦,60,41,19,富邦-新營,2023-08-16,9693
4123,晟德,20,1,19,富邦-新營,2023-08-16,9693
2609,陽明,20,3,17,富邦-新營,2023-08-16,9693
1513,中興電,19,3,16,富邦-新營,2023-08-16,9693
00882,中信中國高股息,25,10,15,富邦-新營,2023-08-16,9693
2610,華航,33,18,15,富邦-新營,2023-08-16,9693
00680L,元大美債20正2,13,0,13,富邦-新營,2023-08-16,9693
1108,幸福,13,0,13,富邦-新營,2023-08-16,9693
1608,華榮,16,4,12,富邦-新營,2023-08-16,9693
1609,大亞,13,1,12,富邦-新營,2023-08-16,9693
6114,久威,12,0,12,富邦-新營,2023-08-16,9693
00688L,國泰20年美債正2,11,0,11,富邦-新營,2023-08-16,9693
2323,中環,26,15,11,富邦-新營,2023-08-16,9693
2324,仁寶,75,65,10,富邦-新營,2023-08-16,9693
2855,統一證,10,0,10,富邦-新營,2023-08-16,9693
2889,國票金,10,0,10,富邦-新營,2023-08-16,9693
2903,遠百,10,0,10,富邦-新營,2023-08-16,9693
4919,新唐,10,0,10,富邦-新營,2023-08-16,9693
00888,永豐台灣ESG,9,0,9,富邦-新營,2023-08-16,9693
2344,華邦電,10,1,9,富邦-新營,2023-08-16,9693
3338,泰碩,10,1,9,富邦-新營,2023-08-16,9693
2023,燁輝,10,1,9,富邦-新營,2023-08-16,9693
1309,台達化,8,0,8,富邦-新營,2023-08-16,9693
2014,中鴻,8,0,8,富邦-新營,2023-08-16,9693
3260,威剛,8,0,8,富邦-新營,2023-08-16,9693
2884,玉山金,8,0,8,富邦-新營,2023-08-16,9693
2891,中信金,13,5,8,富邦-新營,2023-08-16,9693
2363,矽統,101,16,85,富邦-新營,2023-08-17,9693
3231,緯創,209,156,53,富邦-新營,2023-08-17,9693
00929,復華台灣科技優息,74,27,47,富邦-新營,2023-08-17,9693
2324,仁寶,200,169,31,富邦-新營,2023-08-17,9693
2002,中鋼,35,4,31,富邦-新營,2023-08-17,9693
00923,群益台ESG低碳50,28,0,28,富邦-新營,2023-08-17,9693
00680L,元大美債20正2,27,0,27,富邦-新營,2023-08-17,9693
2883,凱基金,24,0,24,富邦-新營,2023-08-17,9693
00878,國泰永續高股息,45,25,20,富邦-新營,2023-08-17,9693
1326,台化,19,0,19,富邦-新營,2023-08-17,9693
1718,中纖,20,1,19,富邦-新營,2023-08-17,9693
2409,友達,17,0,17,富邦-新營,2023-08-17,9693
00877,復華中國5G,15,0,15,富邦-新營,2023-08-17,9693
3147,大綜,15,0,15,富邦-新營,2023-08-17,9693
4162,智擎,15,0,15,富邦-新營,2023-08-17,9693
2431,聯昌,14,0,14,富邦-新營,2023-08-17,9693
00772B,中信高評級公司債,13,0,13,富邦-新營,2023-08-17,9693
1101,台泥,13,0,13,富邦-新營,2023-08-17,9693
3443,創意,25,12,13,富邦-新營,2023-08-17,9693
3622,洋華,13,0,13,富邦-新營,2023-08-17,9693
1789,神隆,11,0,11,富邦-新營,2023-08-17,9693
00931B,統一美債20年,10,0,10,富邦-新營,2023-08-17,9693
1455,集盛,10,0,10,富邦-新營,2023-08-17,9693
2610,華航,20,10,10,富邦-新營,2023-08-17,9693
5864,致和證,10,0,10,富邦-新營,2023-08-17,9693
2891,中信金,12,2,10,富邦-新營,2023-08-17,9693
2888,新光金,10,0,10,富邦-新營,2023-08-17,9693
00720B,元大投資級公司債,11,2,9,富邦-新營,2023-08-17,9693
2419,仲琦,8,0,8,富邦-新營,2023-08-17,9693
2462,良得電,8,0,8,富邦-新營,2023-08-17,9693
8049,晶采,8,0,8,富邦-新營,2023-08-17,9693
2356,英業達,19,11,8,富邦-新營,2023-08-17,9693
6770,力積電,8,1,7,富邦-新營,2023-08-17,9693
3056,富華新,7,0,7,富邦-新營,2023-08-17,9693
5483,中美晶,7,0,7,富邦-新營,2023-08-17,9693
00722B,群益投資級電信債,7,0,7,富邦-新營,2023-08-17,9693
00715L,期街口布蘭特正2,7,0,7,富邦-新營,2023-08-17,9693
4968,立積,7,0,7,富邦-新營,2023-08-17,9693
9929,秋雨,10,3,7,富邦-新營,2023-08-17,9693
00679B,元大美債20年,7,0,7,富邦-新營,2023-08-17,9693
2892,第一金,6,0,6,富邦-新營,2023-08-17,9693
00712,復華富時不動產,6,0,6,富邦-新營,2023-08-17,9693
2368,金像電,9,3,6,富邦-新營,2023-08-17,9693
00882,中信中國高股息,5,0,5,富邦-新營,2023-08-17,9693
00687B,國泰20年美債,5,0,5,富邦-新營,2023-08-17,9693
1309,台達化,9,4,5,富邦-新營,2023-08-17,9693
2340,台亞,6,1,5,富邦-新營,2023-08-17,9693
00753L,中信中國50正2,10,5,5,富邦-新營,2023-08-17,9693
1417,嘉裕,5,0,5,富邦-新營,2023-08-17,9693
1504,東元,5,0,5,富邦-新營,2023-08-17,9693
00706L,期元大S＆P日圓正2,201,0,201,富邦-新營,2023-08-18,9693
00878,國泰永續高股息,84,14,70,富邦-新營,2023-08-18,9693
2027,大成鋼,145,90,55,富邦-新營,2023-08-18,9693
00900,富邦特選高股息30,52,0,52,富邦-新營,2023-08-18,9693
3231,緯創,93,54,39,富邦-新營,2023-08-18,9693
3149,正達,35,0,35,富邦-新營,2023-08-18,9693
3362,先進光,60,26,34,富邦-新營,2023-08-18,9693
00712,復華富時不動產,35,1,34,富邦-新營,2023-08-18,9693
2610,華航,26,1,25,富邦-新營,2023-08-18,9693
2324,仁寶,147,125,22,富邦-新營,2023-08-18,9693
00919,群益台灣精選高息,22,0,22,富邦-新營,2023-08-18,9693
2340,台亞,21,0,21,富邦-新營,2023-08-18,9693
6282,康舒,25,4,21,富邦-新營,2023-08-18,9693
00881,國泰台灣5G+,20,0,20,富邦-新營,2023-08-18,9693
4157,太景*-KY,20,0,20,富邦-新營,2023-08-18,9693
3308,聯德,30,11,19,富邦-新營,2023-08-18,9693
1789,神隆,18,0,18,富邦-新營,2023-08-18,9693
2421,建準,28,11,17,富邦-新營,2023-08-18,9693
6285,啟��,16,3,13,富邦-新營,2023-08-18,9693
2303,聯電,17,5,12,富邦-新營,2023-08-18,9693
6443,元晶,12,0,12,富邦-新營,2023-08-18,9693
3704,合勤控,12,1,11,富邦-新營,2023-08-18,9693
1565,精華,10,0,10,富邦-新營,2023-08-18,9693
1905,華紙,11,1,10,富邦-新營,2023-08-18,9693
2349,錸德,10,0,10,富邦-新營,2023-08-18,9693
4960,誠美材,10,0,10,富邦-新營,2023-08-18,9693
3706,神達,138,129,9,富邦-新營,2023-08-18,9693
2801,彰銀,10,1,9,富邦-新營,2023-08-18,9693
1471,首利,9,0,9,富邦-新營,2023-08-18,9693
1504,東元,13,4,9,富邦-新營,2023-08-18,9693
2337,旺宏,9,0,9,富邦-新營,2023-08-18,9693
2371,大同,16,7,9,富邦-新營,2023-08-18,9693
0056,元大高股息,11,2,9,富邦-新營,2023-08-18,9693
2489,瑞軒,8,0,8,富邦-新營,2023-08-18,9693
2495,普安,10,2,8,富邦-新營,2023-08-18,9693
3294,英濟,8,0,8,富邦-新營,2023-08-18,9693
1101,台泥,7,0,7,富邦-新營,2023-08-18,9693
2323,中環,12,5,7,富邦-新營,2023-08-18,9693
2880,華南金,7,0,7,富邦-新營,2023-08-18,9693
00713,元大台灣高息低波,7,0,7,富邦-新營,2023-08-18,9693
6120,達運,7,0,7,富邦-新營,2023-08-18,9693
2382,廣達,109,102,7,富邦-新營,2023-08-18,9693
2409,友達,6,0,6,富邦-新營,2023-08-18,9693
2617,台航,10,4,6,富邦-新營,2023-08-18,9693
2888,新光金,7,1,6,富邦-新營,2023-08-18,9693
6116,彩晶,6,0,6,富邦-新營,2023-08-18,9693
6274,台燿,12,6,6,富邦-新營,2023-08-18,9693
2002,中鋼,14,9,5,富邦-新營,2023-08-18,9693
6188,廣明,13,8,5,富邦-新營,2023-08-18,9693
00753L,中信中國50正2,5,0,5,富邦-新營,2023-08-18,9693
2515,中工,100,0,100,富邦-新營,2023-08-21,9693
00688L,國泰20年美債正2,103,5,98,富邦-新營,2023-08-21,9693
00929,復華台灣科技優息,96,8,88,富邦-新營,2023-08-21,9693
2883B,凱基金乙特,70,0,70,富邦-新營,2023-08-21,9693
2645,長榮航太,52,1,51,富邦-新營,2023-08-21,9693
00680L,元大美債20正2,44,0,44,富邦-新營,2023-08-21,9693
2323,中環,44,0,44,富邦-新營,2023-08-21,9693
2801,彰銀,35,0,35,富邦-新營,2023-08-21,9693
3583,辛耘,36,2,34,富邦-新營,2023-08-21,9693
5608,四維航,32,0,32,富邦-新營,2023-08-21,9693
00712,復華富時不動產,33,2,31,富邦-新營,2023-08-21,9693
2885,元大金,24,0,24,富邦-新營,2023-08-21,9693
2301,光寶科,26,4,22,富邦-新營,2023-08-21,9693
1219,福壽,20,0,20,富邦-新營,2023-08-21,9693
3149,正達,20,0,20,富邦-新營,2023-08-21,9693
00878,國泰永續高股息,42,23,19,富邦-新營,2023-08-21,9693
9907,統一實,15,0,15,富邦-新營,2023-08-21,9693
2888,新光金,12,0,12,富邦-新營,2023-08-21,9693
3689,湧德,81,70,11,富邦-新營,2023-08-21,9693
2516,新建,10,0,10,富邦-新營,2023-08-21,9693
00753L,中信中國50正2,10,0,10,富邦-新營,2023-08-21,9693
00773B,中信優先金融債,10,0,10,富邦-新營,2023-08-21,9693
1210,大成,10,0,10,富邦-新營,2023-08-21,9693
3306,鼎天,26,16,10,富邦-新營,2023-08-21,9693
2617,台航,10,0,10,富邦-新營,2023-08-21,9693
00679B,元大美債20年,9,0,9,富邦-新營,2023-08-21,9693
00772B,中信高評級公司債,8,0,8,富邦-新營,2023-08-21,9693
3078,僑威,9,1,8,富邦-新營,2023-08-21,9693
4129,聯合,8,0,8,富邦-新營,2023-08-21,9693
6108,競國,8,0,8,富邦-新營,2023-08-21,9693
2609,陽明,9,1,8,富邦-新營,2023-08-21,9693
1303,南亞,7,0,7,富邦-新營,2023-08-21,9693
6139,亞翔,10,3,7,富邦-新營,2023-08-21,9693
2330,台積電,6,0,6,富邦-新營,2023-08-21,9693
00882,中信中國高股息,6,0,6,富邦-新營,2023-08-21,9693
2393,億光,6,0,6,富邦-新營,2023-08-21,9693
00902,中信電池及儲能,6,0,6,富邦-新營,2023-08-21,9693
1240,茂生農經,6,0,6,富邦-新營,2023-08-21,9693
1504,東元,7,1,6,富邦-新營,2023-08-21,9693
2344,華邦電,6,0,6,富邦-新營,2023-08-21,9693
2606,裕民,7,1,6,富邦-新營,2023-08-21,9693
2884,玉山金,6,0,6,富邦-新營,2023-08-21,9693
6116,彩晶,7,1,6,富邦-新營,2023-08-21,9693
00931B,統一美債20年,5,0,5,富邦-新營,2023-08-21,9693
2303,聯電,6,1,5,富邦-新營,2023-08-21,9693
1301,台塑,5,0,5,富邦-新營,2023-08-21,9693
2338,光罩,5,0,5,富邦-新營,2023-08-21,9693
2356,英業達,10,5,5,富邦-新營,2023-08-21,9693
2441,超豐,5,0,5,富邦-新營,2023-08-21,9693
3033,威健,6,1,5,富邦-新營,2023-08-21,9693
2344,華邦電,49,0,49,富邦-新營,2023-08-22,9693
2324,仁寶,71,22,49,富邦-新營,2023-08-22,9693
2515,中工,40,0,40,富邦-新營,2023-08-22,9693
6266,泰詠,39,0,39,富邦-新營,2023-08-22,9693
00885,富邦越南,38,0,38,富邦-新營,2023-08-22,9693
2363,矽統,292,256,36,富邦-新營,2023-08-22,9693
1513,中興電,35,4,31,富邦-新營,2023-08-22,9693
1309,台達化,29,0,29,富邦-新營,2023-08-22,9693
4906,正文,30,1,29,富邦-新營,2023-08-22,9693
2353,宏��,50,23,27,富邦-新營,2023-08-22,9693
2002,中鋼,27,1,26,富邦-新營,2023-08-22,9693
00929,復華台灣科技優息,24,3,21,富邦-新營,2023-08-22,9693
2323,中環,40,20,20,富邦-新營,2023-08-22,9693
2883,凱基金,19,0,19,富邦-新營,2023-08-22,9693
00712,復華富時不動產,19,1,18,富邦-新營,2023-08-22,9693
00753L,中信中國50正2,15,0,15,富邦-新營,2023-08-22,9693
2891,中信金,15,0,15,富邦-新營,2023-08-22,9693
3013,晟銘電,226,211,15,富邦-新營,2023-08-22,9693
00751B,元大AAA至A公司債,12,0,12,富邦-新營,2023-08-22,9693
2884,玉山金,12,0,12,富邦-新營,2023-08-22,9693
8358,金居,12,1,11,富邦-新營,2023-08-22,9693
2382,廣達,48,38,10,富邦-新營,2023-08-22,9693
00688L,國泰20年美債正2,10,0,10,富邦-新營,2023-08-22,9693
3149,正達,10,0,10,富邦-新營,2023-08-22,9693
6605,帝寶,11,1,10,富邦-新營,2023-08-22,9693
00679B,元大美債20年,20,10,10,富邦-新營,2023-08-22,9693
2211,長榮鋼,9,0,9,富邦-新營,2023-08-22,9693
00637L,元大滬深300正2,10,1,9,富邦-新營,2023-08-22,9693
2356,英業達,33,24,9,富邦-新營,2023-08-22,9693
3035,智原,15,7,8,富邦-新營,2023-08-22,9693
1471,首利,10,2,8,富邦-新營,2023-08-22,9693
2887,台新金,8,0,8,富邦-新營,2023-08-22,9693
3163,波若威,14,6,8,富邦-新營,2023-08-22,9693
5243,乙盛-KY,8,0,8,富邦-新營,2023-08-22,9693
8049,晶采,8,0,8,富邦-新營,2023-08-22,9693
3032,偉訓,8,1,7,富邦-新營,2023-08-22,9693
1316,上曜,6,0,6,富邦-新營,2023-08-22,9693
1789,神隆,6,0,6,富邦-新營,2023-08-22,9693
2634,漢翔,7,1,6,富邦-新營,2023-08-22,9693
6443,元晶,7,1,6,富邦-新營,2023-08-22,9693
6456,GIS-KY,6,0,6,富邦-新營,2023-08-22,9693
6693,廣閎科,6,0,6,富邦-新營,2023-08-22,9693
00882,中信中國高股息,5,0,5,富邦-新營,2023-08-22,9693
2892,第一金,5,0,5,富邦-新營,2023-08-22,9693
00931B,統一美債20年,5,0,5,富邦-新營,2023-08-22,9693
00738U,期元大道瓊白銀,5,0,5,富邦-新營,2023-08-22,9693
1108,幸福,5,0,5,富邦-新營,2023-08-22,9693
1618,合機,5,0,5,富邦-新營,2023-08-22,9693
3025,星通,6,1,5,富邦-新營,2023-08-22,9693
3217,優群,5,0,5,富邦-新營,2023-08-22,9693
2440,太空梭,51,0,51,富邦-新營,2023-08-23,9693
2883B,凱基金乙特,50,0,50,富邦-新營,2023-08-23,9693
00751B,元大AAA至A公司債,40,0,40,富邦-新營,2023-08-23,9693
2888,新光金,24,0,24,富邦-新營,2023-08-23,9693
6282,康舒,27,5,22,富邦-新營,2023-08-23,9693
00679B,元大美債20年,22,0,22,富邦-新營,2023-08-23,9693
2618,長榮航,25,3,22,富邦-新營,2023-08-23,9693
00712,復華富時不動產,29,10,19,富邦-新營,2023-08-23,9693
00902,中信電池及儲能,18,0,18,富邦-新營,2023-08-23,9693
2913,農林,16,0,16,富邦-新營,2023-08-23,9693
2329,華泰,32,18,14,富邦-新營,2023-08-23,9693
2884,玉山金,12,0,12,富邦-新營,2023-08-23,9693
1789,神隆,12,0,12,富邦-新營,2023-08-23,9693
3567,逸昌,12,0,12,富邦-新營,2023-08-23,9693
00680L,元大美債20正2,10,0,10,富邦-新營,2023-08-23,9693
00931B,統一美債20年,15,5,10,富邦-新營,2023-08-23,9693
2105,正新,10,0,10,富邦-新營,2023-08-23,9693
2889,國票金,10,0,10,富邦-新營,2023-08-23,9693
00772B,中信高評級公司債,9,0,9,富邦-新營,2023-08-23,9693
1504,東元,11,2,9,富邦-新營,2023-08-23,9693
2883,凱基金,10,1,9,富邦-新營,2023-08-23,9693
3689,湧德,10,1,9,富邦-新營,2023-08-23,9693
1718,中纖,8,0,8,富邦-新營,2023-08-23,9693
2415,錩新,8,0,8,富邦-新營,2023-08-23,9693
6120,達運,8,0,8,富邦-新營,2023-08-23,9693
9902,台火,8,0,8,富邦-新營,2023-08-23,9693
2382,廣達,13,6,7,富邦-新營,2023-08-23,9693
6117,迎廣,112,105,7,富邦-新營,2023-08-23,9693
6244,茂迪,8,1,7,富邦-新營,2023-08-23,9693
00923,群益台ESG低碳50,6,0,6,富邦-新營,2023-08-23,9693
2383,台光電,12,6,6,富邦-新營,2023-08-23,9693
3056,富華新,6,1,5,富邦-新營,2023-08-23,9693
00882,中信中國高股息,5,0,5,富邦-新營,2023-08-23,9693
1316,上曜,5,0,5,富邦-新營,2023-08-23,9693
1455,集盛,5,0,5,富邦-新營,2023-08-23,9693
1471,首利,8,3,5,富邦-新營,2023-08-23,9693
1604,聲寶,5,0,5,富邦-新營,2023-08-23,9693
1762,中化生,5,0,5,富邦-新營,2023-08-23,9693
2421,建準,15,10,5,富邦-新營,2023-08-23,9693
3322,建舜電,5,0,5,富邦-新營,2023-08-23,9693
2880,華南金,4,0,4,富邦-新營,2023-08-23,9693
1101,台泥,10,6,4,富邦-新營,2023-08-23,9693
2468,華經,4,0,4,富邦-新營,2023-08-23,9693
2516,新建,4,0,4,富邦-新營,2023-08-23,9693
2630,亞航,10,6,4,富邦-新營,2023-08-23,9693
3047,訊舟,10,6,4,富邦-新營,2023-08-23,9693
3078,僑威,4,0,4,富邦-新營,2023-08-23,9693
5706,鳳凰,6,2,4,富邦-新營,2023-08-23,9693
9919,康那香,4,0,4,富邦-新營,2023-08-23,9693
00888,永豐台灣ESG,4,0,4,富邦-新營,2023-08-23,9693
00929,復華台灣科技優息,152,46,106,富邦-新營,2023-08-24,9693
00919,群益台灣精選高息,61,0,61,富邦-新營,2023-08-24,9693
5009,榮剛,58,2,56,富邦-新營,2023-08-24,9693
4979,華星光,119,71,48,富邦-新營,2023-08-24,9693
2891,中信金,57,11,46,富邦-新營,2023-08-24,9693
2884,玉山金,41,0,41,富邦-新營,2023-08-24,9693
00688L,國泰20年美債正2,40,0,40,富邦-新營,2023-08-24,9693
4906,正文,45,6,39,富邦-新營,2023-08-24,9693
2609,陽明,35,1,34,富邦-新營,2023-08-24,9693
2888,新光金,34,3,31,富邦-新營,2023-08-24,9693
2356,英業達,44,21,23,富邦-新營,2023-08-24,9693
3042,晶技,24,1,23,富邦-新營,2023-08-24,9693
00712,復華富時不動產,22,0,22,富邦-新營,2023-08-24,9693
2105,正新,20,0,20,富邦-新營,2023-08-24,9693
6605,帝寶,20,0,20,富邦-新營,2023-08-24,9693
2382,廣達,46,27,19,富邦-新營,2023-08-24,9693
3706,神達,28,10,18,富邦-新營,2023-08-24,9693
2419,仲琦,60,43,17,富邦-新營,2023-08-24,9693
2399,映泰,18,1,17,富邦-新營,2023-08-24,9693
2344,華邦電,16,0,16,富邦-新營,2023-08-24,9693
2002,中鋼,16,0,16,富邦-新營,2023-08-24,9693
1417,嘉裕,15,0,15,富邦-新營,2023-08-24,9693
6120,達運,25,10,15,富邦-新營,2023-08-24,9693
2618,長榮航,16,2,14,富邦-新營,2023-08-24,9693
2363,矽統,366,353,13,富邦-新營,2023-08-24,9693
2883,凱基金,12,0,12,富邦-新營,2023-08-24,9693
6116,彩晶,12,0,12,富邦-新營,2023-08-24,9693
2409,友達,11,0,11,富邦-新營,2023-08-24,9693
3032,偉訓,11,0,11,富邦-新營,2023-08-24,9693
6188,廣明,12,1,11,富邦-新營,2023-08-24,9693
00900,富邦特選高股息30,12,2,10,富邦-新營,2023-08-24,9693
1789,神隆,10,0,10,富邦-新營,2023-08-24,9693
2027,大成鋼,10,0,10,富邦-新營,2023-08-24,9693
2867,三商壽,10,0,10,富邦-新營,2023-08-24,9693
3047,訊舟,10,0,10,富邦-新營,2023-08-24,9693
5381,合正,10,0,10,富邦-新營,2023-08-24,9693
6770,力積電,10,0,10,富邦-新營,2023-08-24,9693
6125,廣運,19,9,10,富邦-新營,2023-08-24,9693
2359,所羅門,9,0,9,富邦-新營,2023-08-24,9693
4533,協易機,10,2,8,富邦-新營,2023-08-24,9693
2834,臺企銀,7,0,7,富邦-新營,2023-08-24,9693
00885,富邦越南,7,0,7,富邦-新營,2023-08-24,9693
00923,群益台ESG低碳50,14,7,7,富邦-新營,2023-08-24,9693
2449,京元電子,44,37,7,富邦-新營,2023-08-24,9693
2637,慧洋-KY,7,0,7,富邦-新營,2023-08-24,9693
9950,萬國通,7,0,7,富邦-新營,2023-08-24,9693
2317,鴻海,17,10,7,富邦-新營,2023-08-24,9693
3035,智原,12,6,6,富邦-新營,2023-08-24,9693
00907,永豐優息存股,6,0,6,富邦-新營,2023-08-24,9693
1560,中砂,7,1,6,富邦-新營,2023-08-24,9693
9934,成霖,170,2,168,富邦-新營,2023-08-25,9693
00878,國泰永續高股息,102,13,89,富邦-新營,2023-08-25,9693
00929,復華台灣科技優息,109,25,84,富邦-新營,2023-08-25,9693
6116,彩晶,70,3,67,富邦-新營,2023-08-25,9693
2323,中環,55,0,55,富邦-新營,2023-08-25,9693
2891,中信金,48,0,48,富邦-新營,2023-08-25,9693
2301,光寶科,57,9,48,富邦-新營,2023-08-25,9693
2440,太空梭,45,0,45,富邦-新營,2023-08-25,9693
3231,緯創,86,45,41,富邦-新營,2023-08-25,9693
00680L,元大美債20正2,45,10,35,富邦-新營,2023-08-25,9693
00931B,統一美債20年,30,0,30,富邦-新營,2023-08-25,9693
00919,群益台灣精選高息,24,0,24,富邦-新營,2023-08-25,9693
1217,愛之味,21,0,21,富邦-新營,2023-08-25,9693
2618,長榮航,24,4,20,富邦-新營,2023-08-25,9693
6023,元大期,20,0,20,富邦-新營,2023-08-25,9693
2303,聯電,19,0,19,富邦-新營,2023-08-25,9693
2705,六福,27,8,19,富邦-新營,2023-08-25,9693
2425,承啟,17,0,17,富邦-新營,2023-08-25,9693
2356,英業達,28,12,16,富邦-新營,2023-08-25,9693
3037,欣興,18,2,16,富邦-新營,2023-08-25,9693
00907,永豐優息存股,15,0,15,富邦-新營,2023-08-25,9693
00688L,國泰20年美債正2,15,0,15,富邦-新營,2023-08-25,9693
2363,矽統,240,225,15,富邦-新營,2023-08-25,9693
0056,元大高股息,15,1,14,富邦-新營,2023-08-25,9693
00900,富邦特選高股息30,14,0,14,富邦-新營,2023-08-25,9693
00923,群益台ESG低碳50,13,0,13,富邦-新營,2023-08-25,9693
2884,玉山金,12,0,12,富邦-新營,2023-08-25,9693
3706,神達,19,7,12,富邦-新營,2023-08-25,9693
2867,三商壽,11,0,11,富邦-新營,2023-08-25,9693
2892,第一金,10,0,10,富邦-新營,2023-08-25,9693
00712,復華富時不動產,10,0,10,富邦-新營,2023-08-25,9693
00753L,中信中國50正2,10,0,10,富邦-新營,2023-08-25,9693
2409,友達,10,0,10,富邦-新營,2023-08-25,9693
9919,康那香,10,0,10,富邦-新營,2023-08-25,9693
2880,華南金,10,1,9,富邦-新營,2023-08-25,9693
2353,宏��,15,6,9,富邦-新營,2023-08-25,9693
2516,新建,11,2,9,富邦-新營,2023-08-25,9693
3308,聯德,10,1,9,富邦-新營,2023-08-25,9693
2002,中鋼,23,15,8,富邦-新營,2023-08-25,9693
2382,廣達,153,145,8,富邦-新營,2023-08-25,9693
00715L,期街口布蘭特正2,7,0,7,富邦-新營,2023-08-25,9693
2330,台積電,8,1,7,富邦-新營,2023-08-25,9693
00692,富邦公司治理,6,0,6,富邦-新營,2023-08-25,9693
4128,中天,6,0,6,富邦-新營,2023-08-25,9693
6266,泰詠,6,0,6,富邦-新營,2023-08-25,9693
6657,華安,6,0,6,富邦-新營,2023-08-25,9693
9945,潤泰新,7,1,6,富邦-新營,2023-08-25,9693
00679B,元大美債20年,5,0,5,富邦-新營,2023-08-25,9693
1722,台肥,5,0,5,富邦-新營,2023-08-25,9693
1417,嘉裕,5,0,5,富邦-新營,2023-08-25,9693
00929,復華台灣科技優息,88,1,87,富邦-新營,2023-08-28,9693
8222,寶一,76,4,72,富邦-新營,2023-08-28,9693
00712,復華富時不動產,54,1,53,富邦-新營,2023-08-28,9693
6605,帝寶,41,1,40,富邦-新營,2023-08-28,9693
3094,聯傑,31,0,31,富邦-新營,2023-08-28,9693
2002,中鋼,34,4,30,富邦-新營,2023-08-28,9693
2401,凌陽,26,0,26,富邦-新營,2023-08-28,9693
2323,中環,24,0,24,富邦-新營,2023-08-28,9693
2485,兆赫,134,110,24,富邦-新營,2023-08-28,9693
6120,達運,21,0,21,富邦-新營,2023-08-28,9693
1810,和成,20,0,20,富邦-新營,2023-08-28,9693
00878,國泰永續高股息,45,27,18,富邦-新營,2023-08-28,9693
2618,長榮航,19,2,17,富邦-新營,2023-08-28,9693
1314,中石化,20,5,15,富邦-新營,2023-08-28,9693
00919,群益台灣精選高息,15,0,15,富邦-新營,2023-08-28,9693
3004,豐達科,16,1,15,富邦-新營,2023-08-28,9693
6125,廣運,26,11,15,富邦-新營,2023-08-28,9693
2609,陽明,15,1,14,富邦-新營,2023-08-28,9693
3037,欣興,14,1,13,富邦-新營,2023-08-28,9693
3481,群創,12,1,11,富邦-新營,2023-08-28,9693
1789,神隆,10,0,10,富邦-新營,2023-08-28,9693
2482,連宇,50,40,10,富邦-新營,2023-08-28,9693
3033,威健,10,0,10,富邦-新營,2023-08-28,9693
4916,事欣科,29,19,10,富邦-新營,2023-08-28,9693
6796,晉弘,10,0,10,富邦-新營,2023-08-28,9693
00772B,中信高評級公司債,10,1,9,富邦-新營,2023-08-28,9693
2634,漢翔,24,15,9,富邦-新營,2023-08-28,9693
3058,立德,9,0,9,富邦-新營,2023-08-28,9693
5009,榮剛,13,4,9,富邦-新營,2023-08-28,9693
1504,東元,8,0,8,富邦-新營,2023-08-28,9693
2610,華航,26,18,8,富邦-新營,2023-08-28,9693
3260,威剛,8,0,8,富邦-新營,2023-08-28,9693
6550,北極星藥業-KY,8,0,8,富邦-新營,2023-08-28,9693
00713,元大台灣高息低波,7,0,7,富邦-新營,2023-08-28,9693
3051,力特,33,26,7,富邦-新營,2023-08-28,9693
1737,臺鹽,10,3,7,富邦-新營,2023-08-28,9693
9945,潤泰新,7,0,7,富邦-新營,2023-08-28,9693
6517,保勝光學,6,0,6,富邦-新營,2023-08-28,9693
00720B,元大投資級公司債,6,0,6,富邦-新營,2023-08-28,9693
1514,亞力,6,0,6,富邦-新營,2023-08-28,9693
1718,中纖,6,0,6,富邦-新營,2023-08-28,9693
2201,裕隆,15,9,6,富邦-新營,2023-08-28,9693
2449,京元電子,6,0,6,富邦-新營,2023-08-28,9693
5381,合正,15,9,6,富邦-新營,2023-08-28,9693
0056,元大高股息,10,4,6,富邦-新營,2023-08-28,9693
2603,長榮,6,0,6,富邦-新營,2023-08-28,9693
1308,亞聚,5,0,5,富邦-新營,2023-08-28,9693
1417,嘉裕,5,0,5,富邦-新營,2023-08-28,9693
2355,敬鵬,17,12,5,富邦-新營,2023-08-28,9693
2425,承啟,6,1,5,富邦-新營,2023-08-28,9693
00650L,復華香港正2,100,0,100,富邦-新營,2023-08-29,9693
00706L,期元大S＆P日圓正2,100,0,100,富邦-新營,2023-08-29,9693
00929,復華台灣科技優息,71,0,71,富邦-新營,2023-08-29,9693
2883B,凱基金乙特,30,0,30,富邦-新營,2023-08-29,9693
2634,漢翔,25,1,24,富邦-新營,2023-08-29,9693
2002,中鋼,19,0,19,富邦-新營,2023-08-29,9693
3231,緯創,22,5,17,富邦-新營,2023-08-29,9693
00753L,中信中國50正2,25,10,15,富邦-新營,2023-08-29,9693
2369,菱生,16,2,14,富邦-新營,2023-08-29,9693
2816,旺旺保,14,0,14,富邦-新營,2023-08-29,9693
6285,啟��,17,3,14,富邦-新營,2023-08-29,9693
6443,元晶,16,2,14,富邦-新營,2023-08-29,9693
2618,長榮航,31,19,12,富邦-新營,2023-08-29,9693
4906,正文,19,7,12,富邦-新營,2023-08-29,9693
3163,波若威,11,0,11,富邦-新營,2023-08-29,9693
2317,鴻海,16,6,10,富邦-新營,2023-08-29,9693
1402,遠東新,10,0,10,富邦-新營,2023-08-29,9693
00923,群益台ESG低碳50,10,0,10,富邦-新營,2023-08-29,9693
1789,神隆,10,0,10,富邦-新營,2023-08-29,9693
2440,太空梭,10,0,10,富邦-新營,2023-08-29,9693
6558,興能高,10,0,10,富邦-新營,2023-08-29,9693
2363,矽統,374,365,9,富邦-新營,2023-08-29,9693
2888,新光金,10,1,9,富邦-新營,2023-08-29,9693
2419,仲琦,13,5,8,富邦-新營,2023-08-29,9693
1609,大亞,8,0,8,富邦-新營,2023-08-29,9693
2340,台亞,11,4,7,富邦-新營,2023-08-29,9693
3029,零壹,6,0,6,富邦-新營,2023-08-29,9693
00668,國泰美國道瓊,6,0,6,富邦-新營,2023-08-29,9693
1718,中纖,6,0,6,富邦-新營,2023-08-29,9693
2371,大同,7,1,6,富邦-新營,2023-08-29,9693
2492,華新科,6,0,6,富邦-新營,2023-08-29,9693
3032,偉訓,7,1,6,富邦-新營,2023-08-29,9693
2027,大成鋼,5,0,5,富邦-新營,2023-08-29,9693
6223,旺矽,5,0,5,富邦-新營,2023-08-29,9693
1455,集盛,5,0,5,富邦-新營,2023-08-29,9693
1216,統一,5,0,5,富邦-新營,2023-08-29,9693
1905,華紙,5,0,5,富邦-新營,2023-08-29,9693
2007,燁興,5,0,5,富邦-新營,2023-08-29,9693
2014,中鴻,5,0,5,富邦-新營,2023-08-29,9693
2323,中環,10,5,5,富邦-新營,2023-08-29,9693
2605,新興,5,0,5,富邦-新營,2023-08-29,9693
3058,立德,6,1,5,富邦-新營,2023-08-29,9693
3689,湧德,5,0,5,富邦-新營,2023-08-29,9693
5443,均豪,5,0,5,富邦-新營,2023-08-29,9693
6152,百一,5,0,5,富邦-新營,2023-08-29,9693
6664,群翊,5,0,5,富邦-新營,2023-08-29,9693
6770,力積電,5,0,5,富邦-新營,2023-08-29,9693
2834,臺企銀,5,0,5,富邦-新營,2023-08-29,9693
3481,群創,7,3,4,富邦-新營,2023-08-29,9693
2312,金寶,52,48,4,富邦-新營,2023-08-29,9693
00706L,期元大S＆P日圓正2,50,0,50,富邦-新營,2023-08-30,9693
5009,榮剛,30,3,27,富邦-新營,2023-08-30,9693
1789,神隆,14,0,14,富邦-新營,2023-08-30,9693
2014,中鴻,13,0,13,富邦-新營,2023-08-30,9693
3481,群創,12,0,12,富邦-新營,2023-08-30,9693
3032,偉訓,12,0,12,富邦-新營,2023-08-30,9693
6282,康舒,11,0,11,富邦-新營,2023-08-30,9693
00680L,元大美債20正2,20,10,10,富邦-新營,2023-08-30,9693
00751B,元大AAA至A公司債,10,0,10,富邦-新營,2023-08-30,9693
2458,義隆,10,0,10,富邦-新營,2023-08-30,9693
2801,彰銀,10,0,10,富邦-新營,2023-08-30,9693
2891,中信金,10,0,10,富邦-新營,2023-08-30,9693
6104,創惟,10,0,10,富邦-新營,2023-08-30,9693
6152,百一,10,0,10,富邦-新營,2023-08-30,9693
1609,大亞,10,1,9,富邦-新營,2023-08-30,9693
1612,宏泰,9,0,9,富邦-新營,2023-08-30,9693
3308,聯德,20,11,9,富邦-新營,2023-08-30,9693
00722B,群益投資級電信債,8,0,8,富邦-新營,2023-08-30,9693
2485,兆赫,12,4,8,富邦-新營,2023-08-30,9693
3567,逸昌,8,0,8,富邦-新營,2023-08-30,9693
3588,通嘉,15,7,8,富邦-新營,2023-08-30,9693
5225,東科-KY,8,0,8,富邦-新營,2023-08-30,9693
1305,華夏,8,0,8,富邦-新營,2023-08-30,9693
2610,華航,7,0,7,富邦-新營,2023-08-30,9693
3058,立德,7,0,7,富邦-新營,2023-08-30,9693
3078,僑威,8,1,7,富邦-新營,2023-08-30,9693
3231,緯創,22,15,7,富邦-新營,2023-08-30,9693
1319,東陽,54,48,6,富邦-新營,2023-08-30,9693
2618,長榮航,7,1,6,富邦-新營,2023-08-30,9693
1718,中纖,6,0,6,富邦-新營,2023-08-30,9693
2340,台亞,8,2,6,富邦-新營,2023-08-30,9693
2449,京元電子,14,8,6,富邦-新營,2023-08-30,9693
2537,聯上發,6,0,6,富邦-新營,2023-08-30,9693
3617,碩天,7,1,6,富邦-新營,2023-08-30,9693
5607,遠雄港,6,0,6,富邦-新營,2023-08-30,9693
6150,撼訊,7,1,6,富邦-新營,2023-08-30,9693
2104,國際中橡,6,0,6,富邦-新營,2023-08-30,9693
2303,聯電,19,13,6,富邦-新營,2023-08-30,9693
1786,科妍,5,0,5,富邦-新營,2023-08-30,9693
2440,太空梭,5,0,5,富邦-新營,2023-08-30,9693
3051,力特,7,2,5,富邦-新營,2023-08-30,9693
3264,欣銓,5,0,5,富邦-新營,2023-08-30,9693
4906,正文,7,2,5,富邦-新營,2023-08-30,9693
5392,能率,5,0,5,富邦-新營,2023-08-30,9693
8086,宏捷科,6,1,5,富邦-新營,2023-08-30,9693
2364,倫飛,6,1,5,富邦-新營,2023-08-30,9693
1101,台泥,4,0,4,富邦-新營,2023-08-30,9693
1301,台塑,4,0,4,富邦-新營,2023-08-30,9693
2886,兆豐金,4,0,4,富邦-新營,2023-08-30,9693
00665L,富邦�琤肭磪囓�2,4,0,4,富邦-新營,2023-08-30,9693
2027,大成鋼,124,0,124,富邦-新營,2023-08-31,9693
2014,中鴻,70,5,65,富邦-新營,2023-08-31,9693
1904,正隆,61,0,61,富邦-新營,2023-08-31,9693
2363,矽統,91,38,53,富邦-新營,2023-08-31,9693
2885,元大金,51,0,51,富邦-新營,2023-08-31,9693
00650L,復華香港正2,50,0,50,富邦-新營,2023-08-31,9693
1540,喬福,26,0,26,富邦-新營,2023-08-31,9693
00680L,元大美債20正2,25,0,25,富邦-新營,2023-08-31,9693
2834,臺企銀,25,0,25,富邦-新營,2023-08-31,9693
00878,國泰永續高股息,24,0,24,富邦-新營,2023-08-31,9693
1718,中纖,23,0,23,富邦-新營,2023-08-31,9693
2312,金寶,20,0,20,富邦-新營,2023-08-31,9693
2440,太空梭,20,1,19,富邦-新營,2023-08-31,9693
6111,大宇資,18,0,18,富邦-新營,2023-08-31,9693
2618,長榮航,21,4,17,富邦-新營,2023-08-31,9693
2883,凱基金,16,0,16,富邦-新營,2023-08-31,9693
00919,群益台灣精選高息,16,0,16,富邦-新營,2023-08-31,9693
00753L,中信中國50正2,15,0,15,富邦-新營,2023-08-31,9693
2891,中信金,14,0,14,富邦-新營,2023-08-31,9693
2801,彰銀,13,0,13,富邦-新營,2023-08-31,9693
3363,上詮,13,0,13,富邦-新營,2023-08-31,9693
2880,華南金,12,0,12,富邦-新營,2023-08-31,9693
2402,毅嘉,62,50,12,富邦-新營,2023-08-31,9693
2892,第一金,11,0,11,富邦-新營,2023-08-31,9693
1802,台玻,25,14,11,富邦-新營,2023-08-31,9693
2303,聯電,20,10,10,富邦-新營,2023-08-31,9693
1101,台泥,10,0,10,富邦-新營,2023-08-31,9693
6770,力積電,10,0,10,富邦-新營,2023-08-31,9693
2412,中華電,10,0,10,富邦-新營,2023-08-31,9693
1216,統一,10,0,10,富邦-新營,2023-08-31,9693
00679B,元大美債20年,10,0,10,富邦-新營,2023-08-31,9693
1584,精剛,17,7,10,富邦-新營,2023-08-31,9693
1789,神隆,10,0,10,富邦-新營,2023-08-31,9693
5512,力麒,10,0,10,富邦-新營,2023-08-31,9693
3443,創意,9,1,8,富邦-新營,2023-08-31,9693
2206,三陽工業,8,0,8,富邦-新營,2023-08-31,9693
2884,玉山金,8,0,8,富邦-新營,2023-08-31,9693
4114,健喬,10,2,8,富邦-新營,2023-08-31,9693
00675L,富邦臺灣加權正2,7,0,7,富邦-新營,2023-08-31,9693
2337,旺宏,19,12,7,富邦-新營,2023-08-31,9693
2390,云辰,9,2,7,富邦-新營,2023-08-31,9693
6191,精成科,6,0,6,富邦-新營,2023-08-31,9693
3706,神達,12,6,6,富邦-新營,2023-08-31,9693
2888,新光金,6,0,6,富邦-新營,2023-08-31,9693
6282,康舒,6,0,6,富邦-新營,2023-08-31,9693
6438,迅得,16,10,6,富邦-新營,2023-08-31,9693
00916,國泰全球品牌50,5,0,5,富邦-新營,2023-08-31,9693
1612,宏泰,6,1,5,富邦-新營,2023-08-31,9693
2495,普安,5,0,5,富邦-新營,2023-08-31,9693
3715,定穎投控,15,10,5,富邦-新營,2023-08-31,9693
00929,復華台灣科技優息,197,1,196,富邦-新營,2023-09-01,9693
00932,兆豐永續高息等權,143,14,129,富邦-新營,2023-09-01,9693
00919,群益台灣精選高息,112,0,112,富邦-新營,2023-09-01,9693
6147,頎邦,55,0,55,富邦-新營,2023-09-01,9693
2329,華泰,48,16,32,富邦-新營,2023-09-01,9693
2402,毅嘉,105,75,30,富邦-新營,2023-09-01,9693
2485,兆赫,38,13,25,富邦-新營,2023-09-01,9693
2888,新光金,29,4,25,富邦-新營,2023-09-01,9693
2323,中環,23,2,21,富邦-新營,2023-09-01,9693
2867,三商壽,20,0,20,富邦-新營,2023-09-01,9693
5328,華容,22,2,20,富邦-新營,2023-09-01,9693
2356,英業達,25,8,17,富邦-新營,2023-09-01,9693
5386,青雲,16,0,16,富邦-新營,2023-09-01,9693
00680L,元大美債20正2,15,0,15,富邦-新營,2023-09-01,9693
2034,允強,15,0,15,富邦-新營,2023-09-01,9693
2449,京元電子,15,0,15,富邦-新營,2023-09-01,9693
1522,堤維西,23,10,13,富邦-新營,2023-09-01,9693
5864,致和證,13,0,13,富邦-新營,2023-09-01,9693
00679B,元大美債20年,12,0,12,富邦-新營,2023-09-01,9693
2515,中工,14,3,11,富邦-新營,2023-09-01,9693
00665L,富邦�琤肭磪囓�2,10,0,10,富邦-新營,2023-09-01,9693
1524,耿鼎,10,0,10,富邦-新營,2023-09-01,9693
1789,神隆,10,0,10,富邦-新營,2023-09-01,9693
2401,凌陽,10,0,10,富邦-新營,2023-09-01,9693
00715L,期街口布蘭特正2,16,7,9,富邦-新營,2023-09-01,9693
6282,康舒,15,6,9,富邦-新營,2023-09-01,9693
2883,凱基金,8,0,8,富邦-新營,2023-09-01,9693
3078,僑威,17,9,8,富邦-新營,2023-09-01,9693
1417,嘉裕,8,0,8,富邦-新營,2023-09-01,9693
1101,台泥,8,0,8,富邦-新營,2023-09-01,9693
2892,第一金,13,5,8,富邦-新營,2023-09-01,9693
4960,誠美材,8,0,8,富邦-新營,2023-09-01,9693
2383,台光電,10,2,8,富邦-新營,2023-09-01,9693
2399,映泰,10,3,7,富邦-新營,2023-09-01,9693
2516,新建,7,0,7,富邦-新營,2023-09-01,9693
1605,華新,11,4,7,富邦-新營,2023-09-01,9693
2457,飛宏,9,3,6,富邦-新營,2023-09-01,9693
3037,欣興,7,1,6,富邦-新營,2023-09-01,9693
00923,群益台ESG低碳50,7,1,6,富邦-新營,2023-09-01,9693
2340,台亞,8,2,6,富邦-新營,2023-09-01,9693
6285,啟��,6,0,6,富邦-新營,2023-09-01,9693
8210,勤誠,6,0,6,富邦-新營,2023-09-01,9693
00885,富邦越南,5,0,5,富邦-新營,2023-09-01,9693
0056,元大高股息,5,0,5,富邦-新營,2023-09-01,9693
1708,東鹼,5,0,5,富邦-新營,2023-09-01,9693
2324,仁寶,7,2,5,富邦-新營,2023-09-01,9693
2332,友訊,6,1,5,富邦-新營,2023-09-01,9693
2495,普安,5,0,5,富邦-新營,2023-09-01,9693
2880,華南金,5,0,5,富邦-新營,2023-09-01,9693
3390,旭軟,5,0,5,富邦-新營,2023-09-01,9693
3231,緯創,246,32,214,富邦-新營,2023-09-04,9693
00772B,中信高評級公司債,203,0,203,富邦-新營,2023-09-04,9693
00773B,中信優先金融債,202,0,202,富邦-新營,2023-09-04,9693
2382,廣達,96,7,89,富邦-新營,2023-09-04,9693
2409,友達,76,0,76,富邦-新營,2023-09-04,9693
00929,復華台灣科技優息,92,51,41,富邦-新營,2023-09-04,9693
6147,頎邦,39,0,39,富邦-新營,2023-09-04,9693
1802,台玻,46,9,37,富邦-新營,2023-09-04,9693
2323,中環,34,0,34,富邦-新營,2023-09-04,9693
2371,大同,35,2,33,富邦-新營,2023-09-04,9693
2363,矽統,99,69,30,富邦-新營,2023-09-04,9693
2520,冠德,31,1,30,富邦-新營,2023-09-04,9693
4147,中裕,52,22,30,富邦-新營,2023-09-04,9693
2369,菱生,26,2,24,富邦-新營,2023-09-04,9693
2208,台船,23,0,23,富邦-新營,2023-09-04,9693
1504,東元,23,0,23,富邦-新營,2023-09-04,9693
2034,允強,22,0,22,富邦-新營,2023-09-04,9693
3257,虹冠電,31,10,21,富邦-新營,2023-09-04,9693
6796,晉弘,23,2,21,富邦-新營,2023-09-04,9693
2009,第一銅,20,0,20,富邦-新營,2023-09-04,9693
3035,智原,24,4,20,富邦-新營,2023-09-04,9693
00919,群益台灣精選高息,29,10,19,富邦-新營,2023-09-04,9693
6282,康舒,20,2,18,富邦-新營,2023-09-04,9693
2850,新產,16,0,16,富邦-新營,2023-09-04,9693
2492,華新科,19,4,15,富邦-新營,2023-09-04,9693
1417,嘉裕,14,0,14,富邦-新營,2023-09-04,9693
00680L,元大美債20正2,16,2,14,富邦-新營,2023-09-04,9693
1513,中興電,19,6,13,富邦-新營,2023-09-04,9693
3228,金麗科,13,0,13,富邦-新營,2023-09-04,9693
6213,聯茂,13,0,13,富邦-新營,2023-09-04,9693
3693,營邦,26,14,12,富邦-新營,2023-09-04,9693
4563,百德,12,0,12,富邦-新營,2023-09-04,9693
2610,華航,11,0,11,富邦-新營,2023-09-04,9693
4746,台耀,11,0,11,富邦-新營,2023-09-04,9693
00720B,元大投資級公司債,10,0,10,富邦-新營,2023-09-04,9693
1604,聲寶,10,0,10,富邦-新營,2023-09-04,9693
2312,金寶,20,10,10,富邦-新營,2023-09-04,9693
3518,柏騰,10,0,10,富邦-新營,2023-09-04,9693
5347,世界,10,0,10,富邦-新營,2023-09-04,9693
6625,必應,10,0,10,富邦-新營,2023-09-04,9693
2324,仁寶,9,0,9,富邦-新營,2023-09-04,9693
3290,東浦,10,1,9,富邦-新營,2023-09-04,9693
3715,定穎投控,117,108,9,富邦-新營,2023-09-04,9693
2201,裕隆,46,38,8,富邦-新營,2023-09-04,9693
00751B,元大AAA至A公司債,8,0,8,富邦-新營,2023-09-04,9693
2402,毅嘉,56,48,8,富邦-新營,2023-09-04,9693
3006,晶豪科,10,2,8,富邦-新營,2023-09-04,9693
00715L,期街口布蘭特正2,21,14,7,富邦-新營,2023-09-04,9693
00795B,中信美國公債20年,6,0,6,富邦-新營,2023-09-04,9693
2436,偉詮電,215,209,6,富邦-新營,2023-09-04,9693
2027,大成鋼,301,1,300,富邦-新營,2023-09-05,9693
00929,復華台灣科技優息,192,41,151,富邦-新營,2023-09-05,9693
00919,群益台灣精選高息,63,12,51,富邦-新營,2023-09-05,9693
00706L,期元大S＆P日圓正2,50,0,50,富邦-新營,2023-09-05,9693
00720B,元大投資級公司債,45,0,45,富邦-新營,2023-09-05,9693
8086,宏捷科,45,3,42,富邦-新營,2023-09-05,9693
00679B,元大美債20年,25,0,25,富邦-新營,2023-09-05,9693
00878,國泰永續高股息,28,5,23,富邦-新營,2023-09-05,9693
2618,長榮航,20,0,20,富邦-新營,2023-09-05,9693
2883,凱基金,20,1,19,富邦-新營,2023-09-05,9693
2485,兆赫,18,1,17,富邦-新營,2023-09-05,9693
2363,矽統,225,209,16,富邦-新營,2023-09-05,9693
2409,友達,15,0,15,富邦-新營,2023-09-05,9693
4906,正文,18,4,14,富邦-新營,2023-09-05,9693
2324,仁寶,20,7,13,富邦-新營,2023-09-05,9693
6796,晉弘,13,0,13,富邦-新營,2023-09-05,9693
3481,群創,16,3,13,富邦-新營,2023-09-05,9693
2610,華航,12,0,12,富邦-新營,2023-09-05,9693
8150,南茂,12,0,12,富邦-新營,2023-09-05,9693
3105,穩懋,11,0,11,富邦-新營,2023-09-05,9693
2906,高林,11,0,11,富邦-新營,2023-09-05,9693
00900,富邦特選高股息30,10,0,10,富邦-新營,2023-09-05,9693
1219,福壽,10,0,10,富邦-新營,2023-09-05,9693
2349,錸德,10,0,10,富邦-新營,2023-09-05,9693
3257,虹冠電,10,0,10,富邦-新營,2023-09-05,9693
3231,緯創,76,67,9,富邦-新營,2023-09-05,9693
1514,亞力,10,1,9,富邦-新營,2023-09-05,9693
3035,智原,78,69,9,富邦-新營,2023-09-05,9693
6235,華孚,22,13,9,富邦-新營,2023-09-05,9693
2436,偉詮電,47,39,8,富邦-新營,2023-09-05,9693
1789,神隆,8,0,8,富邦-新營,2023-09-05,9693
1101,台泥,7,0,7,富邦-新營,2023-09-05,9693
8046,南電,7,0,7,富邦-新營,2023-09-05,9693
1444,力麗,7,0,7,富邦-新營,2023-09-05,9693
3051,力特,8,1,7,富邦-新營,2023-09-05,9693
4552,力達-KY,7,0,7,富邦-新營,2023-09-05,9693
5905,南仁湖,7,0,7,富邦-新營,2023-09-05,9693
1718,中纖,6,0,6,富邦-新營,2023-09-05,9693
2609,陽明,23,17,6,富邦-新營,2023-09-05,9693
2913,農林,6,0,6,富邦-新營,2023-09-05,9693
5443,均豪,6,0,6,富邦-新營,2023-09-05,9693
6282,康舒,17,11,6,富邦-新營,2023-09-05,9693
00753L,中信中國50正2,5,0,5,富邦-新營,2023-09-05,9693
2206,三陽工業,5,0,5,富邦-新營,2023-09-05,9693
2376,技嘉,8,3,5,富邦-新營,2023-09-05,9693
3545,敦泰,9,4,5,富邦-新營,2023-09-05,9693
4743,合一,5,0,5,富邦-新營,2023-09-05,9693
00918,大華優利高填息30,4,0,4,富邦-新營,2023-09-05,9693
1504,東元,4,0,4,富邦-新營,2023-09-05,9693
1584,精剛,16,12,4,富邦-新營,2023-09-05,9693
2409,友達,177,5,172,富邦-新營,2023-09-06,9693
6116,彩晶,92,0,92,富邦-新營,2023-09-06,9693
6147,頎邦,79,6,73,富邦-新營,2023-09-06,9693
2886,兆豐金,61,0,61,富邦-新營,2023-09-06,9693
3481,群創,48,7,41,富邦-新營,2023-09-06,9693
2801,彰銀,36,0,36,富邦-新營,2023-09-06,9693
00751B,元大AAA至A公司債,36,0,36,富邦-新營,2023-09-06,9693
2906,高林,33,0,33,富邦-新營,2023-09-06,9693
00688L,國泰20年美債正2,30,0,30,富邦-新營,2023-09-06,9693
00679B,元大美債20年,25,0,25,富邦-新營,2023-09-06,9693
00772B,中信高評級公司債,24,0,24,富邦-新營,2023-09-06,9693
1101,台泥,22,0,22,富邦-新營,2023-09-06,9693
6443,元晶,20,0,20,富邦-新營,2023-09-06,9693
00720B,元大投資級公司債,19,0,19,富邦-新營,2023-09-06,9693
1718,中纖,18,0,18,富邦-新營,2023-09-06,9693
1802,台玻,24,7,17,富邦-新營,2023-09-06,9693
2504,國產,16,0,16,富邦-新營,2023-09-06,9693
0056,元大高股息,22,7,15,富邦-新營,2023-09-06,9693
1409,新纖,15,0,15,富邦-新營,2023-09-06,9693
1471,首利,14,0,14,富邦-新營,2023-09-06,9693
3706,神達,16,2,14,富邦-新營,2023-09-06,9693
6120,達運,15,1,14,富邦-新營,2023-09-06,9693
6578,達邦蛋白,14,0,14,富邦-新營,2023-09-06,9693
9945,潤泰新,13,0,13,富邦-新營,2023-09-06,9693
2303,聯電,15,2,13,富邦-新營,2023-09-06,9693
3308,聯德,23,10,13,富邦-新營,2023-09-06,9693
2812,台中銀,12,0,12,富邦-新營,2023-09-06,9693
00878,國泰永續高股息,13,2,11,富邦-新營,2023-09-06,9693
00753L,中信中國50正2,11,0,11,富邦-新營,2023-09-06,9693
1784,訊聯,11,0,11,富邦-新營,2023-09-06,9693
3094,聯傑,17,6,11,富邦-新營,2023-09-06,9693
3306,鼎天,12,1,11,富邦-新營,2023-09-06,9693
4916,事欣科,17,6,11,富邦-新營,2023-09-06,9693
6274,台燿,15,5,10,富邦-新營,2023-09-06,9693
2884,玉山金,10,0,10,富邦-新營,2023-09-06,9693
1540,喬福,10,0,10,富邦-新營,2023-09-06,9693
2369,菱生,10,0,10,富邦-新營,2023-09-06,9693
2867,三商壽,10,0,10,富邦-新營,2023-09-06,9693
3714,富采,10,0,10,富邦-新營,2023-09-06,9693
6651,全宇昕,10,0,10,富邦-新營,2023-09-06,9693
8016,矽創,10,0,10,富邦-新營,2023-09-06,9693
9904,寶成,10,0,10,富邦-新營,2023-09-06,9693
3682,亞太電,10,0,10,富邦-新營,2023-09-06,9693
2419,仲琦,15,6,9,富邦-新營,2023-09-06,9693
3013,晟銘電,12,3,9,富邦-新營,2023-09-06,9693
2002,中鋼,10,2,8,富邦-新營,2023-09-06,9693
1210,大成,8,0,8,富邦-新營,2023-09-06,9693
2355,敬鵬,9,1,8,富邦-新營,2023-09-06,9693
3594,磐儀,8,0,8,富邦-新營,2023-09-06,9693
6125,廣運,11,3,8,富邦-新營,2023-09-06,9693
00929,復華台灣科技優息,193,34,159,富邦-新營,2023-09-07,9693
2409,友達,60,0,60,富邦-新營,2023-09-07,9693
1718,中纖,58,0,58,富邦-新營,2023-09-07,9693
00900,富邦特選高股息30,43,2,41,富邦-新營,2023-09-07,9693
4906,正文,34,3,31,富邦-新營,2023-09-07,9693
6116,彩晶,31,0,31,富邦-新營,2023-09-07,9693
1802,台玻,30,2,28,富邦-新營,2023-09-07,9693
1217,愛之味,27,0,27,富邦-新營,2023-09-07,9693
2303,聯電,34,8,26,富邦-新營,2023-09-07,9693
00919,群益台灣精選高息,26,0,26,富邦-新營,2023-09-07,9693
2323,中環,25,2,23,富邦-新營,2023-09-07,9693
00673R,期元大S＆P原油反1,20,0,20,富邦-新營,2023-09-07,9693
2034,允強,20,0,20,富邦-新營,2023-09-07,9693
4157,太景*-KY,20,0,20,富邦-新營,2023-09-07,9693
6120,達運,20,0,20,富邦-新營,2023-09-07,9693
00878,國泰永續高股息,18,0,18,富邦-新營,2023-09-07,9693
00932,兆豐永續高息等權,18,0,18,富邦-新營,2023-09-07,9693
6182,合晶,18,1,17,富邦-新營,2023-09-07,9693
3481,群創,16,0,16,富邦-新營,2023-09-07,9693
4533,協易機,36,21,15,富邦-新營,2023-09-07,9693
6125,廣運,15,0,15,富邦-新營,2023-09-07,9693
00902,中信電池及儲能,14,0,14,富邦-新營,2023-09-07,9693
1324,地球,14,0,14,富邦-新營,2023-09-07,9693
2204,中華,14,0,14,富邦-新營,2023-09-07,9693
2486,一詮,29,15,14,富邦-新營,2023-09-07,9693
1101,台泥,11,0,11,富邦-新營,2023-09-07,9693
3078,僑威,13,2,11,富邦-新營,2023-09-07,9693
5469,瀚宇博,11,0,11,富邦-新營,2023-09-07,9693
6173,信昌電,11,0,11,富邦-新營,2023-09-07,9693
3704,合勤控,32,21,11,富邦-新營,2023-09-07,9693
1513,中興電,12,1,11,富邦-新營,2023-09-07,9693
2002,中鋼,10,0,10,富邦-新營,2023-09-07,9693
1229,聯華,10,0,10,富邦-新營,2023-09-07,9693
00665L,富邦�琤肭磪囓�2,10,0,10,富邦-新營,2023-09-07,9693
00753L,中信中國50正2,10,0,10,富邦-新營,2023-09-07,9693
2402,毅嘉,14,4,10,富邦-新營,2023-09-07,9693
2461,光群雷,10,0,10,富邦-新營,2023-09-07,9693
3055,蔚華科,10,0,10,富邦-新營,2023-09-07,9693
3062,建漢,10,0,10,富邦-新營,2023-09-07,9693
4162,智擎,10,0,10,富邦-新營,2023-09-07,9693
6168,宏齊,11,1,10,富邦-新營,2023-09-07,9693
00885,富邦越南,14,4,10,富邦-新營,2023-09-07,9693
1786,科妍,11,2,9,富邦-新營,2023-09-07,9693
2618,長榮航,13,4,9,富邦-新營,2023-09-07,9693
1440,南紡,8,0,8,富邦-新營,2023-09-07,9693
6187,萬潤,8,0,8,富邦-新營,2023-09-07,9693
2313,華通,16,8,8,富邦-新營,2023-09-07,9693
2884,玉山金,7,0,7,富邦-新營,2023-09-07,9693
1319,東陽,7,0,7,富邦-新營,2023-09-07,9693
00915,凱基優選高股息30,7,0,7,富邦-新營,2023-09-07,9693
6274,台燿,315,7,308,富邦-新營,2023-09-08,9693
00919,群益台灣精選高息,195,0,195,富邦-新營,2023-09-08,9693
00929,復華台灣科技優息,345,173,172,富邦-新營,2023-09-08,9693
00696B,富邦美債20年,100,0,100,富邦-新營,2023-09-08,9693
6266,泰詠,51,0,51,富邦-新營,2023-09-08,9693
3264,欣銓,53,2,51,富邦-新營,2023-09-08,9693
00918,大華優利高填息30,26,0,26,富邦-新營,2023-09-08,9693
2323,中環,41,20,21,富邦-新營,2023-09-08,9693
1718,中纖,20,0,20,富邦-新營,2023-09-08,9693
3308,聯德,20,0,20,富邦-新營,2023-09-08,9693
6116,彩晶,20,0,20,富邦-新營,2023-09-08,9693
1802,台玻,24,5,19,富邦-新營,2023-09-08,9693
2329,華泰,32,13,19,富邦-新營,2023-09-08,9693
3025,星通,26,9,17,富邦-新營,2023-09-08,9693
00900,富邦特選高股息30,15,0,15,富邦-新營,2023-09-08,9693
00673R,期元大S＆P原油反1,15,0,15,富邦-新營,2023-09-08,9693
2034,允強,15,0,15,富邦-新營,2023-09-08,9693
3363,上詮,35,21,14,富邦-新營,2023-09-08,9693
00679B,元大美債20年,12,0,12,富邦-新營,2023-09-08,9693
4162,智擎,12,0,12,富邦-新營,2023-09-08,9693
5009,榮剛,12,0,12,富邦-新營,2023-09-08,9693
1316,上曜,11,0,11,富邦-新營,2023-09-08,9693
00753L,中信中國50正2,11,0,11,富邦-新營,2023-09-08,9693
1540,喬福,10,0,10,富邦-新營,2023-09-08,9693
1440,南紡,11,1,10,富邦-新營,2023-09-08,9693
2020,美亞,10,0,10,富邦-新營,2023-09-08,9693
2618,長榮航,11,1,10,富邦-新營,2023-09-08,9693
3693,營邦,14,4,10,富邦-新營,2023-09-08,9693
00902,中信電池及儲能,10,1,9,富邦-新營,2023-09-08,9693
2358,廷鑫,17,8,9,富邦-新營,2023-09-08,9693
2402,毅嘉,17,8,9,富邦-新營,2023-09-08,9693
3481,群創,10,1,9,富邦-新營,2023-09-08,9693
6158,禾昌,9,0,9,富邦-新營,2023-09-08,9693
00932,兆豐永續高息等權,7,0,7,富邦-新營,2023-09-08,9693
1786,科妍,7,0,7,富邦-新營,2023-09-08,9693
2324,仁寶,7,0,7,富邦-新營,2023-09-08,9693
3622,洋華,7,0,7,富邦-新營,2023-09-08,9693
4934,太極,7,0,7,富邦-新營,2023-09-08,9693
1101,台泥,6,0,6,富邦-新營,2023-09-08,9693
2330,台積電,6,0,6,富邦-新營,2023-09-08,9693
00882,中信中國高股息,6,0,6,富邦-新營,2023-09-08,9693
4566,時碩工業,6,0,6,富邦-新營,2023-09-08,9693
6770,力積電,6,0,6,富邦-新營,2023-09-08,9693
6191,精成科,7,1,6,富邦-新營,2023-09-08,9693
00915,凱基優選高股息30,5,0,5,富邦-新營,2023-09-08,9693
00639,富邦深100,5,0,5,富邦-新營,2023-09-08,9693
1417,嘉裕,5,0,5,富邦-新營,2023-09-08,9693
2605,新興,5,0,5,富邦-新營,2023-09-08,9693
2890,永豐金,5,0,5,富邦-新營,2023-09-08,9693
3380,明泰,5,0,5,富邦-新營,2023-09-08,9693
00929,復華台灣科技優息,255,32,223,富邦-新營,2023-09-11,9693
00919,群益台灣精選高息,211,0,211,富邦-新營,2023-09-11,9693
00650L,復華香港正2,120,0,120,富邦-新營,2023-09-11,9693
2382,廣達,127,25,102,富邦-新營,2023-09-11,9693
2886,兆豐金,100,0,100,富邦-新營,2023-09-11,9693
00878,國泰永續高股息,166,66,100,富邦-新營,2023-09-11,9693
6266,泰詠,50,0,50,富邦-新營,2023-09-11,9693
6116,彩晶,70,21,49,富邦-新營,2023-09-11,9693
2363,矽統,81,40,41,富邦-新營,2023-09-11,9693
1618,合機,44,5,39,富邦-新營,2023-09-11,9693
3481,群創,41,11,30,富邦-新營,2023-09-11,9693
2324,仁寶,37,8,29,富邦-新營,2023-09-11,9693
2301,光寶科,31,4,27,富邦-新營,2023-09-11,9693
1609,大亞,31,7,24,富邦-新營,2023-09-11,9693
00915,凱基優選高股息30,23,0,23,富邦-新營,2023-09-11,9693
1216,統一,23,0,23,富邦-新營,2023-09-11,9693
00918,大華優利高填息30,21,0,21,富邦-新營,2023-09-11,9693
3078,僑威,21,2,19,富邦-新營,2023-09-11,9693
1417,嘉裕,17,0,17,富邦-新營,2023-09-11,9693
6125,廣運,19,3,16,富邦-新營,2023-09-11,9693
2323,中環,20,4,16,富邦-新營,2023-09-11,9693
2801,彰銀,15,0,15,富邦-新營,2023-09-11,9693
1528,恩德,15,0,15,富邦-新營,2023-09-11,9693
3325,旭品,15,0,15,富邦-新營,2023-09-11,9693
4916,事欣科,15,0,15,富邦-新營,2023-09-11,9693
00932,兆豐永續高息等權,14,0,14,富邦-新營,2023-09-11,9693
2409,友達,24,11,13,富邦-新營,2023-09-11,9693
2630,亞航,26,13,13,富邦-新營,2023-09-11,9693
00900,富邦特選高股息30,12,0,12,富邦-新營,2023-09-11,9693
1504,東元,13,1,12,富邦-新營,2023-09-11,9693
2376,技嘉,28,17,11,富邦-新營,2023-09-11,9693
2427,三商電,12,1,11,富邦-新營,2023-09-11,9693
2834,臺企銀,13,2,11,富邦-新營,2023-09-11,9693
1762,中化生,10,0,10,富邦-新營,2023-09-11,9693
3043,科風,10,0,10,富邦-新營,2023-09-11,9693
6285,啟��,12,2,10,富邦-新營,2023-09-11,9693
9907,統一實,10,0,10,富邦-新營,2023-09-11,9693
2401,凌陽,9,0,9,富邦-新營,2023-09-11,9693
00923,群益台ESG低碳50,8,0,8,富邦-新營,2023-09-11,9693
00664R,國泰臺灣加權反1,10,2,8,富邦-新營,2023-09-11,9693
1527,鑽全,8,0,8,富邦-新營,2023-09-11,9693
2312,金寶,9,1,8,富邦-新營,2023-09-11,9693
6275,元山,8,0,8,富邦-新營,2023-09-11,9693
6796,晉弘,8,0,8,富邦-新營,2023-09-11,9693
2356,英業達,13,5,8,富邦-新營,2023-09-11,9693
2002,中鋼,9,1,8,富邦-新營,2023-09-11,9693
1513,中興電,9,2,7,富邦-新營,2023-09-11,9693
00679B,元大美債20年,7,0,7,富邦-新營,2023-09-11,9693
00882,中信中國高股息,7,0,7,富邦-新營,2023-09-11,9693
1307,三芳,7,0,7,富邦-新營,2023-09-11,9693
00929,復華台灣科技優息,193,77,116,富邦-新營,2023-09-12,9693
00919,群益台灣精選高息,90,0,90,富邦-新營,2023-09-12,9693
6282,康舒,73,6,67,富邦-新營,2023-09-12,9693
6116,彩晶,35,1,34,富邦-新營,2023-09-12,9693
2883B,凱基金乙特,30,0,30,富邦-新營,2023-09-12,9693
00650L,復華香港正2,25,0,25,富邦-新營,2023-09-12,9693
2002,中鋼,23,3,20,富邦-新營,2023-09-12,9693
1101,台泥,19,0,19,富邦-新營,2023-09-12,9693
2610,華航,21,3,18,富邦-新營,2023-09-12,9693
6443,元晶,17,0,17,富邦-新營,2023-09-12,9693
1584,精剛,56,40,16,富邦-新營,2023-09-12,9693
00706L,期元大S＆P日圓正2,15,0,15,富邦-新營,2023-09-12,9693
2034,允強,15,0,15,富邦-新營,2023-09-12,9693
00885,富邦越南,17,4,13,富邦-新營,2023-09-12,9693
3078,僑威,16,4,12,富邦-新營,2023-09-12,9693
00882,中信中國高股息,12,0,12,富邦-新營,2023-09-12,9693
6120,達運,24,12,12,富邦-新營,2023-09-12,9693
6770,力積電,12,0,12,富邦-新營,2023-09-12,9693
2834,臺企銀,11,0,11,富邦-新營,2023-09-12,9693
00902,中信電池及儲能,11,0,11,富邦-新營,2023-09-12,9693
1471,首利,12,1,11,富邦-新營,2023-09-12,9693
1102,亞泥,10,0,10,富邦-新營,2023-09-12,9693
00738U,期元大道瓊白銀,10,0,10,富邦-新營,2023-09-12,9693
00688L,國泰20年美債正2,10,0,10,富邦-新營,2023-09-12,9693
1708,東鹼,10,0,10,富邦-新營,2023-09-12,9693
2482,連宇,10,0,10,富邦-新營,2023-09-12,9693
5512,力麒,10,0,10,富邦-新營,2023-09-12,9693
00931B,統一美債20年,9,0,9,富邦-新營,2023-09-12,9693
2538,基泰,10,2,8,富邦-新營,2023-09-12,9693
00679B,元大美債20年,7,0,7,富邦-新營,2023-09-12,9693
2356,英業達,13,6,7,富邦-新營,2023-09-12,9693
6191,精成科,8,2,6,富邦-新營,2023-09-12,9693
2488,漢平,6,0,6,富邦-新營,2023-09-12,9693
3027,盛達,6,0,6,富邦-新營,2023-09-12,9693
3443,創意,9,3,6,富邦-新營,2023-09-12,9693
4142,國光生,7,1,6,富邦-新營,2023-09-12,9693
5009,榮剛,6,0,6,富邦-新營,2023-09-12,9693
8033,雷虎,9,3,6,富邦-新營,2023-09-12,9693
00878,國泰永續高股息,32,26,6,富邦-新營,2023-09-12,9693
1316,上曜,5,0,5,富邦-新營,2023-09-12,9693
00920,富邦ESG綠色電力,5,0,5,富邦-新營,2023-09-12,9693
2634,漢翔,7,2,5,富邦-新營,2023-09-12,9693
6266,泰詠,5,0,5,富邦-新營,2023-09-12,9693
8068,全達,5,0,5,富邦-新營,2023-09-12,9693
3680,家登,4,0,4,富邦-新營,2023-09-12,9693
3715,定穎投控,12,8,4,富邦-新營,2023-09-12,9693
3545,敦泰,7,3,4,富邦-新營,2023-09-12,9693
5351,鈺創,6,2,4,富邦-新營,2023-09-12,9693
2382,廣達,10,7,3,富邦-新營,2023-09-12,9693
2376,技嘉,8,5,3,富邦-新營,2023-09-12,9693
00929,復華台灣科技優息,199,33,166,富邦-新營,2023-09-13,9693
00706L,期元大S＆P日圓正2,101,20,81,富邦-新營,2023-09-13,9693
2913,農林,50,0,50,富邦-新營,2023-09-13,9693
5371,中光電,40,8,32,富邦-新營,2023-09-13,9693
00878,國泰永續高股息,33,3,30,富邦-新營,2023-09-13,9693
00919,群益台灣精選高息,35,12,23,富邦-新營,2023-09-13,9693
3308,聯德,20,0,20,富邦-新營,2023-09-13,9693
00773B,中信優先金融債,16,0,16,富邦-新營,2023-09-13,9693
4763,材料-KY,20,5,15,富邦-新營,2023-09-13,9693
8112,至上,22,8,14,富邦-新營,2023-09-13,9693
2313,華通,14,1,13,富邦-新營,2023-09-13,9693
1584,精剛,12,0,12,富邦-新營,2023-09-13,9693
2489,瑞軒,12,1,11,富邦-新營,2023-09-13,9693
2630,亞航,12,1,11,富邦-新營,2023-09-13,9693
00900,富邦特選高股息30,14,4,10,富邦-新營,2023-09-13,9693
1568,倉佑,10,0,10,富邦-新營,2023-09-13,9693
6550,北極星藥業-KY,10,0,10,富邦-新營,2023-09-13,9693
2409,友達,10,1,9,富邦-新營,2023-09-13,9693
2486,一詮,16,7,9,富邦-新營,2023-09-13,9693
6288,聯嘉,13,4,9,富邦-新營,2023-09-13,9693
2340,台亞,34,26,8,富邦-新營,2023-09-13,9693
2618,長榮航,8,0,8,富邦-新營,2023-09-13,9693
2211,長榮鋼,7,0,7,富邦-新營,2023-09-13,9693
2330,台積電,7,0,7,富邦-新營,2023-09-13,9693
1218,泰山,7,0,7,富邦-新營,2023-09-13,9693
4906,正文,12,5,7,富邦-新營,2023-09-13,9693
00902,中信電池及儲能,7,0,7,富邦-新營,2023-09-13,9693
3704,合勤控,6,0,6,富邦-新營,2023-09-13,9693
1314,中石化,6,0,6,富邦-新營,2023-09-13,9693
00882,中信中國高股息,6,0,6,富邦-新營,2023-09-13,9693
00918,大華優利高填息30,6,0,6,富邦-新營,2023-09-13,9693
1618,合機,9,3,6,富邦-新營,2023-09-13,9693
6147,頎邦,6,0,6,富邦-新營,2023-09-13,9693
3264,欣銓,6,0,6,富邦-新營,2023-09-13,9693
4977,眾達-KY,9,4,5,富邦-新營,2023-09-13,9693
2002,中鋼,10,5,5,富邦-新營,2023-09-13,9693
2388,威盛,23,18,5,富邦-新營,2023-09-13,9693
00633L,富邦上証正2,6,1,5,富邦-新營,2023-09-13,9693
00738U,期元大道瓊白銀,5,0,5,富邦-新營,2023-09-13,9693
2364,倫飛,5,0,5,富邦-新營,2023-09-13,9693
2472,立隆電,5,0,5,富邦-新營,2023-09-13,9693
5011,久陽,5,0,5,富邦-新營,2023-09-13,9693
5902,德記,5,0,5,富邦-新營,2023-09-13,9693
6120,達運,6,1,5,富邦-新營,2023-09-13,9693
6173,信昌電,5,0,5,富邦-新營,2023-09-13,9693
6285,啟��,7,2,5,富邦-新營,2023-09-13,9693
9930,中聯資源,5,0,5,富邦-新營,2023-09-13,9693
6125,廣運,5,1,4,富邦-新營,2023-09-13,9693
2352,佳世達,32,28,4,富邦-新營,2023-09-13,9693
0056,元大高股息,4,0,4,富邦-新營,2023-09-13,9693
00929,復華台灣科技優息,369,84,285,富邦-新營,2023-09-14,9693
00919,群益台灣精選高息,105,0,105,富邦-新營,2023-09-14,9693
2344,華邦電,73,0,73,富邦-新營,2023-09-14,9693
00885,富邦越南,66,2,64,富邦-新營,2023-09-14,9693
2449,京元電子,31,2,29,富邦-新營,2023-09-14,9693
2371,大同,43,16,27,富邦-新營,2023-09-14,9693
2881,富邦金,29,2,27,富邦-新營,2023-09-14,9693
2486,一詮,199,174,25,富邦-新營,2023-09-14,9693
6288,聯嘉,20,0,20,富邦-新營,2023-09-14,9693
2363,矽統,34,16,18,富邦-新營,2023-09-14,9693
6168,宏齊,16,0,16,富邦-新營,2023-09-14,9693
00673R,期元大S＆P原油反1,15,0,15,富邦-新營,2023-09-14,9693
2634,漢翔,17,2,15,富邦-新營,2023-09-14,9693
4942,嘉彰,15,0,15,富邦-新營,2023-09-14,9693
2402,毅嘉,17,4,13,富邦-新營,2023-09-14,9693
2324,仁寶,14,1,13,富邦-新營,2023-09-14,9693
1568,倉佑,10,0,10,富邦-新營,2023-09-14,9693
2530,華建,10,0,10,富邦-新營,2023-09-14,9693
3443,創意,27,17,10,富邦-新營,2023-09-14,9693
3682,亞太電,10,0,10,富邦-新營,2023-09-14,9693
6147,頎邦,17,7,10,富邦-新營,2023-09-14,9693
00632R,元大台灣50反1,9,0,9,富邦-新營,2023-09-14,9693
5258,虹堡,10,1,9,富邦-新營,2023-09-14,9693
00915,凱基優選高股息30,8,0,8,富邦-新營,2023-09-14,9693
00932,兆豐永續高息等權,7,0,7,富邦-新營,2023-09-14,9693
00633L,富邦上証正2,8,1,7,富邦-新營,2023-09-14,9693
1326,台化,7,0,7,富邦-新營,2023-09-14,9693
2332,友訊,7,0,7,富邦-新營,2023-09-14,9693
2610,華航,9,2,7,富邦-新營,2023-09-14,9693
3276,宇環,7,0,7,富邦-新營,2023-09-14,9693
5475,德宏,7,0,7,富邦-新營,2023-09-14,9693
6282,康舒,14,7,7,富邦-新營,2023-09-14,9693
00902,中信電池及儲能,6,0,6,富邦-新營,2023-09-14,9693
1718,中纖,6,0,6,富邦-新營,2023-09-14,9693
2618,長榮航,6,0,6,富邦-新營,2023-09-14,9693
2706,第一店,6,0,6,富邦-新營,2023-09-14,9693
6438,迅得,6,0,6,富邦-新營,2023-09-14,9693
8088,品安,6,0,6,富邦-新營,2023-09-14,9693
1417,嘉裕,5,0,5,富邦-新營,2023-09-14,9693
1612,宏泰,5,0,5,富邦-新營,2023-09-14,9693
2392,正崴,5,0,5,富邦-新營,2023-09-14,9693
2405,輔信,7,2,5,富邦-新營,2023-09-14,9693
2601,益航,10,5,5,富邦-新營,2023-09-14,9693
3710,連展投控,5,0,5,富邦-新營,2023-09-14,9693
5351,鈺創,5,0,5,富邦-新營,2023-09-14,9693
5425,台半,5,0,5,富邦-新營,2023-09-14,9693
6108,競國,6,1,5,富邦-新營,2023-09-14,9693
9103,美德醫療-DR,5,0,5,富邦-新營,2023-09-14,9693
1784,訊聯,4,0,4,富邦-新營,2023-09-14,9693
1108,幸福,4,0,4,富邦-新營,2023-09-14,9693
00929,復華台灣科技優息,369,63,306,富邦-新營,2023-09-15,9693
1522,堤維西,100,2,98,富邦-新營,2023-09-15,9693
2610,華航,57,5,52,富邦-新營,2023-09-15,9693
3058,立德,38,1,37,富邦-新營,2023-09-15,9693
2634,漢翔,37,3,34,富邦-新營,2023-09-15,9693
6016,康和證,30,0,30,富邦-新營,2023-09-15,9693
4906,正文,34,5,29,富邦-新營,2023-09-15,9693
3363,上詮,31,5,26,富邦-新營,2023-09-15,9693
00878,國泰永續高股息,42,16,26,富邦-新營,2023-09-15,9693
1718,中纖,21,0,21,富邦-新營,2023-09-15,9693
2867,三商壽,20,0,20,富邦-新營,2023-09-15,9693
2618,長榮航,19,0,19,富邦-新營,2023-09-15,9693
00919,群益台灣精選高息,57,39,18,富邦-新營,2023-09-15,9693
1417,嘉裕,16,0,16,富邦-新營,2023-09-15,9693
2002,中鋼,16,0,16,富邦-新營,2023-09-15,9693
1802,台玻,20,6,14,富邦-新營,2023-09-15,9693
8054,安國,15,1,14,富邦-新營,2023-09-15,9693
00885,富邦越南,13,0,13,富邦-新營,2023-09-15,9693
3025,星通,12,0,12,富邦-新營,2023-09-15,9693
00673R,期元大S＆P原油反1,11,0,11,富邦-新營,2023-09-15,9693
2457,飛宏,11,0,11,富邦-新營,2023-09-15,9693
3231,緯創,16,6,10,富邦-新營,2023-09-15,9693
00753L,中信中國50正2,10,0,10,富邦-新營,2023-09-15,9693
1102,亞泥,10,0,10,富邦-新營,2023-09-15,9693
2211,長榮鋼,10,0,10,富邦-新營,2023-09-15,9693
2367,燿華,10,0,10,富邦-新營,2023-09-15,9693
3380,明泰,10,0,10,富邦-新營,2023-09-15,9693
6213,聯茂,10,0,10,富邦-新營,2023-09-15,9693
2356,英業達,11,2,9,富邦-新營,2023-09-15,9693
6770,力積電,9,0,9,富邦-新營,2023-09-15,9693
1584,精剛,9,0,9,富邦-新營,2023-09-15,9693
3081,聯亞,11,2,9,富邦-新營,2023-09-15,9693
00679B,元大美債20年,8,0,8,富邦-新營,2023-09-15,9693
2317,鴻海,8,0,8,富邦-新營,2023-09-15,9693
2538,基泰,11,3,8,富邦-新營,2023-09-15,9693
4916,事欣科,13,5,8,富邦-新營,2023-09-15,9693
00773B,中信優先金融債,7,0,7,富邦-新營,2023-09-15,9693
6192,巨路,7,0,7,富邦-新營,2023-09-15,9693
8088,品安,9,2,7,富邦-新營,2023-09-15,9693
2382,廣達,8,2,6,富邦-新營,2023-09-15,9693
1904,正隆,6,0,6,富邦-新營,2023-09-15,9693
2706,第一店,6,0,6,富邦-新營,2023-09-15,9693
2884,玉山金,6,0,6,富邦-新營,2023-09-15,9693
3483,力致,6,0,6,富邦-新營,2023-09-15,9693
4979,華星光,6,0,6,富邦-新營,2023-09-15,9693
2328,廣宇,5,0,5,富邦-新營,2023-09-15,9693
00918,大華優利高填息30,5,0,5,富邦-新營,2023-09-15,9693
2488,漢平,5,0,5,富邦-新營,2023-09-15,9693
2617,台航,5,0,5,富邦-新營,2023-09-15,9693
3390,旭軟,5,0,5,富邦-新營,2023-09-15,9693
2313,華通,328,27,301,富邦-新營,2023-09-18,9693
6284,佳邦,200,0,200,富邦-新營,2023-09-18,9693
00929,復華台灣科技優息,201,62,139,富邦-新營,2023-09-18,9693
00650L,復華香港正2,110,0,110,富邦-新營,2023-09-18,9693
00878,國泰永續高股息,71,3,68,富邦-新營,2023-09-18,9693
4908,前鼎,60,0,60,富邦-新營,2023-09-18,9693
00680L,元大美債20正2,52,0,52,富邦-新營,2023-09-18,9693
3481,群創,48,0,48,富邦-新營,2023-09-18,9693
00751B,元大AAA至A公司債,36,0,36,富邦-新營,2023-09-18,9693
8081,致新,31,0,31,富邦-新營,2023-09-18,9693
00919,群益台灣精選高息,30,0,30,富邦-新營,2023-09-18,9693
2337,旺宏,28,2,26,富邦-新營,2023-09-18,9693
2641,正德,25,2,23,富邦-新營,2023-09-18,9693
2618,長榮航,23,1,22,富邦-新營,2023-09-18,9693
2883B,凱基金乙特,20,0,20,富邦-新營,2023-09-18,9693
8942,森鉅,20,0,20,富邦-新營,2023-09-18,9693
2025,千興,20,1,19,富邦-新營,2023-09-18,9693
2610,華航,22,3,19,富邦-新營,2023-09-18,9693
00772B,中信高評級公司債,18,0,18,富邦-新營,2023-09-18,9693
2355,敬鵬,40,22,18,富邦-新營,2023-09-18,9693
00679B,元大美債20年,18,0,18,富邦-新營,2023-09-18,9693
2344,華邦電,21,4,17,富邦-新營,2023-09-18,9693
00795B,中信美國公債20年,16,0,16,富邦-新營,2023-09-18,9693
2330,台積電,16,0,16,富邦-新營,2023-09-18,9693
1417,嘉裕,15,0,15,富邦-新營,2023-09-18,9693
2392,正崴,15,0,15,富邦-新營,2023-09-18,9693
3706,神達,17,2,15,富邦-新營,2023-09-18,9693
5607,遠雄港,14,0,14,富邦-新營,2023-09-18,9693
2301,光寶科,15,2,13,富邦-新營,2023-09-18,9693
2317,鴻海,13,0,13,富邦-新營,2023-09-18,9693
2601,益航,12,0,12,富邦-新營,2023-09-18,9693
3231,緯創,14,2,12,富邦-新營,2023-09-18,9693
00931B,統一美債20年,12,1,11,富邦-新營,2023-09-18,9693
2356,英業達,13,3,10,富邦-新營,2023-09-18,9693
00725B,國泰投資級公司債,10,0,10,富邦-新營,2023-09-18,9693
2363,矽統,118,108,10,富邦-新營,2023-09-18,9693
4105,東洋,10,0,10,富邦-新營,2023-09-18,9693
5701,劍湖山,10,0,10,富邦-新營,2023-09-18,9693
2634,漢翔,14,5,9,富邦-新營,2023-09-18,9693
3363,上詮,15,6,9,富邦-新營,2023-09-18,9693
5608,四維航,10,1,9,富邦-新營,2023-09-18,9693
5902,德記,9,0,9,富邦-新營,2023-09-18,9693
2382,廣達,9,0,9,富邦-新營,2023-09-18,9693
1582,信錦,8,0,8,富邦-新營,2023-09-18,9693
1102,亞泥,8,0,8,富邦-新營,2023-09-18,9693
2419,仲琦,11,4,7,富邦-新營,2023-09-18,9693
00687B,國泰20年美債,7,0,7,富邦-新營,2023-09-18,9693
00896,中信綠能及電動車,7,0,7,富邦-新營,2023-09-18,9693
2312,金寶,8,1,7,富邦-新營,2023-09-18,9693
2329,華泰,7,0,7,富邦-新營,2023-09-18,9693
00929,復華台灣科技優息,155,63,92,富邦-新營,2023-09-19,9693
2324,仁寶,50,1,49,富邦-新營,2023-09-19,9693
00921,兆豐龍頭等權重,46,0,46,富邦-新營,2023-09-19,9693
4120,友華,35,0,35,富邦-新營,2023-09-19,9693
00919,群益台灣精選高息,32,0,32,富邦-新營,2023-09-19,9693
00650L,復華香港正2,60,30,30,富邦-新營,2023-09-19,9693
2634,漢翔,26,2,24,富邦-新營,2023-09-19,9693
0056,元大高股息,22,0,22,富邦-新營,2023-09-19,9693
1809,中釉,20,0,20,富邦-新營,2023-09-19,9693
2211,長榮鋼,20,0,20,富邦-新營,2023-09-19,9693
2332,友訊,21,1,20,富邦-新營,2023-09-19,9693
2367,燿華,26,8,18,富邦-新營,2023-09-19,9693
6282,康舒,18,1,17,富邦-新營,2023-09-19,9693
2331,精英,16,0,16,富邦-新營,2023-09-19,9693
2609,陽明,24,9,15,富邦-新營,2023-09-19,9693
3531,先益,15,0,15,富邦-新營,2023-09-19,9693
00918,大華優利高填息30,14,0,14,富邦-新營,2023-09-19,9693
1229,聯華,13,0,13,富邦-新營,2023-09-19,9693
2371,大同,20,7,13,富邦-新營,2023-09-19,9693
00712,復華富時不動產,12,0,12,富邦-新營,2023-09-19,9693
2344,華邦電,15,3,12,富邦-新營,2023-09-19,9693
6550,北極星藥業-KY,12,0,12,富邦-新營,2023-09-19,9693
2313,華通,41,30,11,富邦-新營,2023-09-19,9693
2355,敬鵬,11,0,11,富邦-新營,2023-09-19,9693
2330,台積電,10,0,10,富邦-新營,2023-09-19,9693
00665L,富邦�琤肭磪囓�2,10,0,10,富邦-新營,2023-09-19,9693
00687B,國泰20年美債,10,0,10,富邦-新營,2023-09-19,9693
1310,台苯,10,0,10,富邦-新營,2023-09-19,9693
2323,中環,10,0,10,富邦-新營,2023-09-19,9693
3056,富華新,10,0,10,富邦-新營,2023-09-19,9693
5347,世界,11,1,10,富邦-新營,2023-09-19,9693
6168,宏齊,10,0,10,富邦-新營,2023-09-19,9693
00888,永豐台灣ESG,9,0,9,富邦-新營,2023-09-19,9693
4979,華星光,16,7,9,富邦-新營,2023-09-19,9693
2027,大成鋼,11,2,9,富邦-新營,2023-09-19,9693
9904,寶成,10,1,9,富邦-新營,2023-09-19,9693
00753L,中信中國50正2,8,0,8,富邦-新營,2023-09-19,9693
00900,富邦特選高股息30,8,0,8,富邦-新營,2023-09-19,9693
2492,華新科,8,0,8,富邦-新營,2023-09-19,9693
2855,統一證,8,0,8,富邦-新營,2023-09-19,9693
3062,建漢,8,0,8,富邦-新營,2023-09-19,9693
8033,雷虎,8,0,8,富邦-新營,2023-09-19,9693
3317,尼克森,7,0,7,富邦-新營,2023-09-19,9693
2374,佳能,7,1,6,富邦-新營,2023-09-19,9693
2457,飛宏,7,1,6,富邦-新營,2023-09-19,9693
4532,瑞智,6,0,6,富邦-新營,2023-09-19,9693
5225,東科-KY,6,0,6,富邦-新營,2023-09-19,9693
2436,偉詮電,5,0,5,富邦-新營,2023-09-19,9693
2891,中信金,10,5,5,富邦-新營,2023-09-19,9693
1108,幸福,5,0,5,富邦-新營,2023-09-19,9693
00929,復華台灣科技優息,356,25,331,富邦-新營,2023-09-20,9693
2313,華通,81,5,76,富邦-新營,2023-09-20,9693
00919,群益台灣精選高息,60,2,58,富邦-新營,2023-09-20,9693
2367,燿華,89,33,56,富邦-新營,2023-09-20,9693
00680L,元大美債20正2,54,0,54,富邦-新營,2023-09-20,9693
2801,彰銀,40,0,40,富邦-新營,2023-09-20,9693
00921,兆豐龍頭等權重,32,0,32,富邦-新營,2023-09-20,9693
2020,美亞,31,0,31,富邦-新營,2023-09-20,9693
5381,合正,31,0,31,富邦-新營,2023-09-20,9693
00878,國泰永續高股息,33,5,28,富邦-新營,2023-09-20,9693
2324,仁寶,25,0,25,富邦-新營,2023-09-20,9693
00923,群益台ESG低碳50,27,2,25,富邦-新營,2023-09-20,9693
3036,文曄,31,8,23,富邦-新營,2023-09-20,9693
2618,長榮航,22,1,21,富邦-新營,2023-09-20,9693
3531,先益,23,2,21,富邦-新營,2023-09-20,9693
00753L,中信中國50正2,20,0,20,富邦-新營,2023-09-20,9693
1218,泰山,20,0,20,富邦-新營,2023-09-20,9693
4188,安克,19,0,19,富邦-新營,2023-09-20,9693
00687B,國泰20年美債,17,0,17,富邦-新營,2023-09-20,9693
2892,第一金,17,0,17,富邦-新營,2023-09-20,9693
2888,新光金,16,0,16,富邦-新營,2023-09-20,9693
4916,事欣科,15,0,15,富邦-新營,2023-09-20,9693
8942,森鉅,15,0,15,富邦-新營,2023-09-20,9693
5009,榮剛,14,0,14,富邦-新營,2023-09-20,9693
6901,鑽石投資,16,2,14,富邦-新營,2023-09-20,9693
2330,台積電,14,0,14,富邦-新營,2023-09-20,9693
3704,合勤控,13,1,12,富邦-新營,2023-09-20,9693
00892,富邦台灣半導體,12,0,12,富邦-新營,2023-09-20,9693
3163,波若威,13,1,12,富邦-新營,2023-09-20,9693
6442,光聖,14,2,12,富邦-新營,2023-09-20,9693
3260,威剛,22,10,12,富邦-新營,2023-09-20,9693
3709,鑫聯大投控,11,0,11,富邦-新營,2023-09-20,9693
3481,群創,31,20,11,富邦-新營,2023-09-20,9693
00665L,富邦�琤肭磪囓�2,10,0,10,富邦-新營,2023-09-20,9693
00722B,群益投資級電信債,10,0,10,富邦-新營,2023-09-20,9693
2031,新光鋼,10,0,10,富邦-新營,2023-09-20,9693
2409,友達,10,0,10,富邦-新營,2023-09-20,9693
00900,富邦特選高股息30,9,0,9,富邦-新營,2023-09-20,9693
2610,華航,10,1,9,富邦-新營,2023-09-20,9693
3545,敦泰,9,0,9,富邦-新營,2023-09-20,9693
1101,台泥,9,0,9,富邦-新營,2023-09-20,9693
00891,中信關鍵半導體,8,0,8,富邦-新營,2023-09-20,9693
3037,欣興,9,1,8,富邦-新營,2023-09-20,9693
0056,元大高股息,7,0,7,富邦-新營,2023-09-20,9693
2354,鴻準,7,0,7,富邦-新營,2023-09-20,9693
2371,大同,7,0,7,富邦-新營,2023-09-20,9693
5475,德宏,7,0,7,富邦-新營,2023-09-20,9693
2317,鴻海,7,1,6,富邦-新營,2023-09-20,9693
2436,偉詮電,11,5,6,富邦-新營,2023-09-20,9693
2329,華泰,11,5,6,富邦-新營,2023-09-20,9693
00929,復華台灣科技優息,143,33,110,富邦-新營,2023-09-21,9693
00680L,元大美債20正2,100,0,100,富邦-新營,2023-09-21,9693
2883,凱基金,39,0,39,富邦-新營,2023-09-21,9693
00923,群益台ESG低碳50,33,0,33,富邦-新營,2023-09-21,9693
2002,中鋼,26,0,26,富邦-新營,2023-09-21,9693
8942,森鉅,25,0,25,富邦-新營,2023-09-21,9693
00720B,元大投資級公司債,24,0,24,富邦-新營,2023-09-21,9693
3027,盛達,21,0,21,富邦-新營,2023-09-21,9693
2537,聯上發,22,2,20,富邦-新營,2023-09-21,9693
2891,中信金,19,0,19,富邦-新營,2023-09-21,9693
1417,嘉裕,19,0,19,富邦-新營,2023-09-21,9693
4916,事欣科,18,0,18,富邦-新營,2023-09-21,9693
2834,臺企銀,17,0,17,富邦-新營,2023-09-21,9693
2332,友訊,28,11,17,富邦-新營,2023-09-21,9693
2610,華航,19,2,17,富邦-新營,2023-09-21,9693
2888,新光金,27,10,17,富邦-新營,2023-09-21,9693
0056,元大高股息,26,11,15,富邦-新營,2023-09-21,9693
2880,華南金,15,0,15,富邦-新營,2023-09-21,9693
2892,第一金,15,0,15,富邦-新營,2023-09-21,9693
00655L,國泰中國A50正2,15,0,15,富邦-新營,2023-09-21,9693
2887,台新金,15,0,15,富邦-新營,2023-09-21,9693
2882,國泰金,15,0,15,富邦-新營,2023-09-21,9693
2330,台積電,14,0,14,富邦-新營,2023-09-21,9693
3163,波若威,24,11,13,富邦-新營,2023-09-21,9693
6901,鑽石投資,13,0,13,富邦-新營,2023-09-21,9693
5880,合庫金,12,0,12,富邦-新營,2023-09-21,9693
2412,中華電,12,0,12,富邦-新營,2023-09-21,9693
2324,仁寶,12,0,12,富邦-新營,2023-09-21,9693
00679B,元大美債20年,16,4,12,富邦-新營,2023-09-21,9693
2884,玉山金,11,0,11,富邦-新營,2023-09-21,9693
1101,台泥,11,0,11,富邦-新營,2023-09-21,9693
2382,廣達,69,58,11,富邦-新營,2023-09-21,9693
1718,中纖,11,0,11,富邦-新營,2023-09-21,9693
1909,榮成,11,0,11,富邦-新營,2023-09-21,9693
2367,燿華,34,23,11,富邦-新營,2023-09-21,9693
2633,台灣高鐵,11,0,11,富邦-新營,2023-09-21,9693
00722B,群益投資級電信債,10,0,10,富邦-新營,2023-09-21,9693
00687B,國泰20年美債,10,0,10,富邦-新營,2023-09-21,9693
1218,泰山,10,0,10,富邦-新營,2023-09-21,9693
2634,漢翔,10,0,10,富邦-新營,2023-09-21,9693
5344,立衛,10,0,10,富邦-新營,2023-09-21,9693
00902,中信電池及儲能,9,0,9,富邦-新營,2023-09-21,9693
3704,合勤控,9,0,9,富邦-新營,2023-09-21,9693
2344,華邦電,11,2,9,富邦-新營,2023-09-21,9693
6153,嘉聯益,10,1,9,富邦-新營,2023-09-21,9693
1324,地球,8,0,8,富邦-新營,2023-09-21,9693
2402,毅嘉,11,3,8,富邦-新營,2023-09-21,9693
2460,建通,8,0,8,富邦-新營,2023-09-21,9693
6550,北極星藥業-KY,10,2,8,富邦-新營,2023-09-21,9693
2329,華泰,8,1,7,富邦-新營,2023-09-21,9693
00632R,元大台灣50反1,230,0,230,富邦-新營,2023-09-22,9693
3231,緯創,79,8,71,富邦-新營,2023-09-22,9693
00679B,元大美債20年,56,0,56,富邦-新營,2023-09-22,9693
00688L,國泰20年美債正2,53,0,53,富邦-新營,2023-09-22,9693
2331,精英,51,0,51,富邦-新營,2023-09-22,9693
00680L,元大美債20正2,50,0,50,富邦-新營,2023-09-22,9693
2641,正德,48,2,46,富邦-新營,2023-09-22,9693
00885,富邦越南,41,0,41,富邦-新營,2023-09-22,9693
00919,群益台灣精選高息,39,0,39,富邦-新營,2023-09-22,9693
2884,玉山金,34,1,33,富邦-新營,2023-09-22,9693
00720B,元大投資級公司債,29,0,29,富邦-新營,2023-09-22,9693
1609,大亞,26,0,26,富邦-新營,2023-09-22,9693
4162,智擎,23,0,23,富邦-新營,2023-09-22,9693
2303,聯電,23,2,21,富邦-新營,2023-09-22,9693
1227,佳格,20,0,20,富邦-新營,2023-09-22,9693
2618,長榮航,21,1,20,富邦-新營,2023-09-22,9693
00687B,國泰20年美債,19,1,18,富邦-新營,2023-09-22,9693
2332,友訊,18,1,17,富邦-新營,2023-09-22,9693
2201,裕隆,16,0,16,富邦-新營,2023-09-22,9693
00929,復華台灣科技優息,136,121,15,富邦-新營,2023-09-22,9693
00712,復華富時不動產,14,0,14,富邦-新營,2023-09-22,9693
00893,國泰智能電動車,13,0,13,富邦-新營,2023-09-22,9693
2301,光寶科,13,0,13,富邦-新營,2023-09-22,9693
1314,中石化,13,1,12,富邦-新營,2023-09-22,9693
6901,鑽石投資,12,0,12,富邦-新營,2023-09-22,9693
00931B,統一美債20年,12,0,12,富邦-新營,2023-09-22,9693
00772B,中信高評級公司債,11,0,11,富邦-新營,2023-09-22,9693
5009,榮剛,14,3,11,富邦-新營,2023-09-22,9693
00902,中信電池及儲能,11,0,11,富邦-新營,2023-09-22,9693
1324,地球,11,0,11,富邦-新營,2023-09-22,9693
2883,凱基金,11,0,11,富邦-新營,2023-09-22,9693
00722B,群益投資級電信債,10,0,10,富邦-新營,2023-09-22,9693
1316,上曜,10,0,10,富邦-新營,2023-09-22,9693
2489,瑞軒,10,0,10,富邦-新營,2023-09-22,9693
2609,陽明,11,1,10,富邦-新營,2023-09-22,9693
4157,太景*-KY,10,0,10,富邦-新營,2023-09-22,9693
6153,嘉聯益,10,0,10,富邦-新營,2023-09-22,9693
9928,中視,10,0,10,富邦-新營,2023-09-22,9693
1101,台泥,10,0,10,富邦-新營,2023-09-22,9693
2634,漢翔,10,1,9,富邦-新營,2023-09-22,9693
2206,三陽工業,8,0,8,富邦-新營,2023-09-22,9693
2329,華泰,8,0,8,富邦-新營,2023-09-22,9693
3236,千如,8,0,8,富邦-新營,2023-09-22,9693
1444,力麗,7,0,7,富邦-新營,2023-09-22,9693
2882,國泰金,7,0,7,富邦-新營,2023-09-22,9693
3325,旭品,8,1,7,富邦-新營,2023-09-22,9693
2468,華經,7,0,7,富邦-新營,2023-09-22,9693
00751B,元大AAA至A公司債,6,0,6,富邦-新營,2023-09-22,9693
3037,欣興,8,2,6,富邦-新營,2023-09-22,9693
5306,桂盟,6,0,6,富邦-新營,2023-09-22,9693
1522,堤維西,154,31,123,富邦-新營,2023-09-25,9693
00919,群益台灣精選高息,44,1,43,富邦-新營,2023-09-25,9693
00929,復華台灣科技優息,50,8,42,富邦-新營,2023-09-25,9693
2376,技嘉,42,3,39,富邦-新營,2023-09-25,9693
00712,復華富時不動產,34,0,34,富邦-新營,2023-09-25,9693
00753L,中信中國50正2,30,0,30,富邦-新營,2023-09-25,9693
1101,台泥,20,0,20,富邦-新營,2023-09-25,9693
2367,燿華,35,17,18,富邦-新營,2023-09-25,9693
6901,鑽石投資,17,0,17,富邦-新營,2023-09-25,9693
1718,中纖,16,0,16,富邦-新營,2023-09-25,9693
3322,建舜電,135,119,16,富邦-新營,2023-09-25,9693
4960,誠美材,15,0,15,富邦-新營,2023-09-25,9693
2421,建準,14,0,14,富邦-新營,2023-09-25,9693
2883,凱基金,19,6,13,富邦-新營,2023-09-25,9693
3703,欣陸,13,0,13,富邦-新營,2023-09-25,9693
00772B,中信高評級公司債,13,1,12,富邦-新營,2023-09-25,9693
2002,中鋼,12,0,12,富邦-新營,2023-09-25,9693
00720B,元大投資級公司債,11,0,11,富邦-新營,2023-09-25,9693
2888,新光金,11,0,11,富邦-新營,2023-09-25,9693
9907,統一實,11,0,11,富邦-新營,2023-09-25,9693
1417,嘉裕,10,0,10,富邦-新營,2023-09-25,9693
2313,華通,12,2,10,富邦-新營,2023-09-25,9693
5512,力麒,10,0,10,富邦-新營,2023-09-25,9693
4542,科嶠,10,1,9,富邦-新營,2023-09-25,9693
3706,神達,16,8,8,富邦-新營,2023-09-25,9693
2355,敬鵬,8,0,8,富邦-新營,2023-09-25,9693
3588,通嘉,8,0,8,富邦-新營,2023-09-25,9693
8034,榮群,8,0,8,富邦-新營,2023-09-25,9693
2317,鴻海,8,1,7,富邦-新營,2023-09-25,9693
2542,興富發,6,0,6,富邦-新營,2023-09-25,9693
00679B,元大美債20年,6,0,6,富邦-新營,2023-09-25,9693
1514,亞力,6,0,6,富邦-新營,2023-09-25,9693
4908,前鼎,11,5,6,富邦-新營,2023-09-25,9693
1440,南紡,5,0,5,富邦-新營,2023-09-25,9693
00902,中信電池及儲能,5,0,5,富邦-新營,2023-09-25,9693
00773B,中信優先金融債,5,0,5,富邦-新營,2023-09-25,9693
2363,矽統,45,40,5,富邦-新營,2023-09-25,9693
2609,陽明,6,1,5,富邦-新營,2023-09-25,9693
4532,瑞智,5,0,5,富邦-新營,2023-09-25,9693
6770,力積電,5,0,5,富邦-新營,2023-09-25,9693
3037,欣興,5,1,4,富邦-新營,2023-09-25,9693
1504,東元,8,4,4,富邦-新營,2023-09-25,9693
1717,長興,6,2,4,富邦-新營,2023-09-25,9693
2417,圓剛,5,1,4,富邦-新營,2023-09-25,9693
2537,聯上發,4,0,4,富邦-新營,2023-09-25,9693
2610,華航,9,5,4,富邦-新營,2023-09-25,9693
3583,辛耘,4,0,4,富邦-新營,2023-09-25,9693
3615,安可,6,2,4,富邦-新營,2023-09-25,9693
4129,聯合,4,0,4,富邦-新營,2023-09-25,9693
9927,泰銘,4,0,4,富邦-新營,2023-09-25,9693
00929,復華台灣科技優息,124,1,123,富邦-新營,2023-09-26,9693
00679B,元大美債20年,62,4,58,富邦-新營,2023-09-26,9693
2883,凱基金,53,0,53,富邦-新營,2023-09-26,9693
00885,富邦越南,43,1,42,富邦-新營,2023-09-26,9693
00919,群益台灣精選高息,41,0,41,富邦-新營,2023-09-26,9693
3163,波若威,44,10,34,富邦-新營,2023-09-26,9693
1584,精剛,36,3,33,富邦-新營,2023-09-26,9693
2516,新建,31,0,31,富邦-新營,2023-09-26,9693
2324,仁寶,30,0,30,富邦-新營,2023-09-26,9693
2634,漢翔,30,0,30,富邦-新營,2023-09-26,9693
2303,聯電,31,4,27,富邦-新營,2023-09-26,9693
6122,擎邦,27,4,23,富邦-新營,2023-09-26,9693
00671R,富邦NASDAQ反1,21,0,21,富邦-新營,2023-09-26,9693
2881,富邦金,22,3,19,富邦-新營,2023-09-26,9693
2034,允強,19,0,19,富邦-新營,2023-09-26,9693
00772B,中信高評級公司債,17,1,16,富邦-新營,2023-09-26,9693
2392,正崴,13,0,13,富邦-新營,2023-09-26,9693
00688L,國泰20年美債正2,12,0,12,富邦-新營,2023-09-26,9693
3006,晶豪科,12,0,12,富邦-新營,2023-09-26,9693
2542,興富發,15,3,12,富邦-新營,2023-09-26,9693
2201,裕隆,13,2,11,富邦-新營,2023-09-26,9693
00712,復華富時不動產,11,0,11,富邦-新營,2023-09-26,9693
6139,亞翔,18,7,11,富邦-新營,2023-09-26,9693
2330,台積電,11,0,11,富邦-新營,2023-09-26,9693
2892,第一金,14,3,11,富邦-新營,2023-09-26,9693
00878,國泰永續高股息,10,0,10,富邦-新營,2023-09-26,9693
2880,華南金,10,0,10,富邦-新營,2023-09-26,9693
00753L,中信中國50正2,10,0,10,富邦-新營,2023-09-26,9693
2455,全新,10,0,10,富邦-新營,2023-09-26,9693
3322,建舜電,10,0,10,富邦-新營,2023-09-26,9693
4157,太景*-KY,10,0,10,富邦-新營,2023-09-26,9693
2329,華泰,9,0,9,富邦-新營,2023-09-26,9693
2363,矽統,19,10,9,富邦-新營,2023-09-26,9693
5009,榮剛,9,0,9,富邦-新營,2023-09-26,9693
5880,合庫金,8,0,8,富邦-新營,2023-09-26,9693
2313,華通,8,0,8,富邦-新營,2023-09-26,9693
3481,群創,10,3,7,富邦-新營,2023-09-26,9693
1718,中纖,7,0,7,富邦-新營,2023-09-26,9693
1417,嘉裕,8,1,7,富邦-新營,2023-09-26,9693
2356,英業達,8,1,7,富邦-新營,2023-09-26,9693
1101,台泥,7,0,7,富邦-新營,2023-09-26,9693
2204,中華,6,0,6,富邦-新營,2023-09-26,9693
2352,佳世達,6,0,6,富邦-新營,2023-09-26,9693
2538,基泰,12,6,6,富邦-新營,2023-09-26,9693
2211,長榮鋼,6,0,6,富邦-新營,2023-09-26,9693
2382,廣達,8,2,6,富邦-新營,2023-09-26,9693
6770,力積電,5,0,5,富邦-新營,2023-09-26,9693
3023,信邦,5,0,5,富邦-新營,2023-09-26,9693
00637L,元大滬深300正2,5,0,5,富邦-新營,2023-09-26,9693
00918,大華優利高填息30,5,0,5,富邦-新營,2023-09-26,9693
00637L,元大滬深300正2,100,0,100,富邦-新營,2023-09-27,9693
00680L,元大美債20正2,100,0,100,富邦-新營,2023-09-27,9693
00929,復華台灣科技優息,72,3,69,富邦-新營,2023-09-27,9693
2337,旺宏,52,0,52,富邦-新營,2023-09-27,9693
3149,正達,50,0,50,富邦-新營,2023-09-27,9693
2601,益航,40,0,40,富邦-新營,2023-09-27,9693
6806,森崴能源,32,3,29,富邦-新營,2023-09-27,9693
2002,中鋼,40,14,26,富邦-新營,2023-09-27,9693
1618,合機,58,32,26,富邦-新營,2023-09-27,9693
2014,中鴻,24,0,24,富邦-新營,2023-09-27,9693
6901,鑽石投資,23,0,23,富邦-新營,2023-09-27,9693
00753L,中信中國50正2,31,10,21,富邦-新營,2023-09-27,9693
00720B,元大投資級公司債,20,0,20,富邦-新營,2023-09-27,9693
2303,聯電,18,1,17,富邦-新營,2023-09-27,9693
00712,復華富時不動產,12,0,12,富邦-新營,2023-09-27,9693
1718,中纖,11,0,11,富邦-新營,2023-09-27,9693
00687B,國泰20年美債,11,0,11,富邦-新營,2023-09-27,9693
00772B,中信高評級公司債,12,2,10,富邦-新營,2023-09-27,9693
1785,光洋科,10,0,10,富邦-新營,2023-09-27,9693
3171,炎洲流通,10,0,10,富邦-新營,2023-09-27,9693
3673,TPK-KY,10,0,10,富邦-新營,2023-09-27,9693
5457,宣德,10,0,10,富邦-新營,2023-09-27,9693
9907,統一實,10,0,10,富邦-新營,2023-09-27,9693
3443,創意,14,5,9,富邦-新營,2023-09-27,9693
2634,漢翔,9,0,9,富邦-新營,2023-09-27,9693
2641,正德,14,5,9,富邦-新營,2023-09-27,9693
6770,力積電,9,0,9,富邦-新營,2023-09-27,9693
1609,大亞,21,13,8,富邦-新營,2023-09-27,9693
2344,華邦電,8,0,8,富邦-新營,2023-09-27,9693
00919,群益台灣精選高息,16,8,8,富邦-新營,2023-09-27,9693
00633L,富邦上証正2,7,0,7,富邦-新營,2023-09-27,9693
1584,精剛,7,0,7,富邦-新營,2023-09-27,9693
2421,建準,10,3,7,富邦-新營,2023-09-27,9693
2883,凱基金,7,0,7,富邦-新營,2023-09-27,9693
2801,彰銀,7,0,7,富邦-新營,2023-09-27,9693
3704,合勤控,9,3,6,富邦-新營,2023-09-27,9693
00679B,元大美債20年,6,0,6,富邦-新營,2023-09-27,9693
1605,華新,6,0,6,富邦-新營,2023-09-27,9693
2332,友訊,6,0,6,富邦-新營,2023-09-27,9693
3006,晶豪科,6,0,6,富邦-新營,2023-09-27,9693
8938,明安,8,2,6,富邦-新營,2023-09-27,9693
3035,智原,11,5,6,富邦-新營,2023-09-27,9693
2892,第一金,6,0,6,富邦-新營,2023-09-27,9693
3231,緯創,13,8,5,富邦-新營,2023-09-27,9693
2603,長榮,5,0,5,富邦-新營,2023-09-27,9693
1301,台塑,5,0,5,富邦-新營,2023-09-27,9693
2539,櫻花建,5,0,5,富邦-新營,2023-09-27,9693
2609,陽明,7,2,5,富邦-新營,2023-09-27,9693
00722B,群益投資級電信債,5,0,5,富邦-新營,2023-09-27,9693
1524,耿鼎,5,0,5,富邦-新營,2023-09-27,9693
00929,復華台灣科技優息,106,46,60,富邦-新營,2023-09-28,9693
3231,緯創,64,9,55,富邦-新營,2023-09-28,9693
1314,中石化,50,0,50,富邦-新營,2023-09-28,9693
2382,廣達,108,62,46,富邦-新營,2023-09-28,9693
3363,上詮,34,2,32,富邦-新營,2023-09-28,9693
00712,復華富時不動產,31,0,31,富邦-新營,2023-09-28,9693
00720B,元大投資級公司債,24,0,24,富邦-新營,2023-09-28,9693
00679B,元大美債20年,23,0,23,富邦-新營,2023-09-28,9693
00680L,元大美債20正2,30,10,20,富邦-新營,2023-09-28,9693
2316,楠梓電,47,27,20,富邦-新營,2023-09-28,9693
2332,友訊,20,0,20,富邦-新營,2023-09-28,9693
2409,友達,14,1,13,富邦-新營,2023-09-28,9693
1305,華夏,13,1,12,富邦-新營,2023-09-28,9693
2610,華航,12,0,12,富邦-新營,2023-09-28,9693
3706,神達,15,3,12,富邦-新營,2023-09-28,9693
2421,建準,12,1,11,富邦-新營,2023-09-28,9693
00688L,國泰20年美債正2,11,0,11,富邦-新營,2023-09-28,9693
2498,宏達電,12,1,11,富邦-新營,2023-09-28,9693
2408,南亞科,13,3,10,富邦-新營,2023-09-28,9693
00919,群益台灣精選高息,10,0,10,富邦-新營,2023-09-28,9693
00665L,富邦�琤肭磪囓�2,11,1,10,富邦-新營,2023-09-28,9693
1802,台玻,10,0,10,富邦-新營,2023-09-28,9693
2611,志信,10,0,10,富邦-新營,2023-09-28,9693
3038,全台,10,0,10,富邦-新營,2023-09-28,9693
2206,三陽工業,10,1,9,富邦-新營,2023-09-28,9693
2543,皇昌,8,0,8,富邦-新營,2023-09-28,9693
00931B,統一美債20年,7,0,7,富邦-新營,2023-09-28,9693
1605,華新,10,3,7,富邦-新營,2023-09-28,9693
1471,首利,9,2,7,富邦-新營,2023-09-28,9693
2449,京元電子,7,0,7,富邦-新營,2023-09-28,9693
3006,晶豪科,7,0,7,富邦-新營,2023-09-28,9693
3163,波若威,8,1,7,富邦-新營,2023-09-28,9693
2002,中鋼,23,17,6,富邦-新營,2023-09-28,9693
00738U,期元大道瓊白銀,6,0,6,富邦-新營,2023-09-28,9693
2618,長榮航,6,0,6,富邦-新營,2023-09-28,9693
2883,凱基金,7,1,6,富邦-新營,2023-09-28,9693
00637L,元大滬深300正2,5,0,5,富邦-新營,2023-09-28,9693
00652,富邦印度,5,0,5,富邦-新營,2023-09-28,9693
2888,新光金,5,0,5,富邦-新營,2023-09-28,9693
4532,瑞智,5,0,5,富邦-新營,2023-09-28,9693
5475,德宏,5,0,5,富邦-新營,2023-09-28,9693
6415,矽力*-KY,5,0,5,富邦-新營,2023-09-28,9693
8222,寶一,5,0,5,富邦-新營,2023-09-28,9693
00772B,中信高評級公司債,7,3,4,富邦-新營,2023-09-28,9693
3703,欣陸,4,0,4,富邦-新營,2023-09-28,9693
00773B,中信優先金融債,4,0,4,富邦-新營,2023-09-28,9693
00932,兆豐永續高息等權,4,0,4,富邦-新營,2023-09-28,9693
3548,兆利,4,0,4,富邦-新營,2023-09-28,9693
8150,南茂,4,0,4,富邦-新營,2023-09-28,9693
2376,技嘉,53,49,4,富邦-新營,2023-09-28,9693
00673R,期元大S＆P原油反1,100,3,97,富邦-新營,2023-10-02,9693
00919,群益台灣精選高息,53,0,53,富邦-新營,2023-10-02,9693
3036,文曄,127,78,49,富邦-新營,2023-10-02,9693
2382,廣達,133,93,40,富邦-新營,2023-10-02,9693
2002,中鋼,33,6,27,富邦-新營,2023-10-02,9693
2641,正德,24,0,24,富邦-新營,2023-10-02,9693
2365,昆盈,21,0,21,富邦-新營,2023-10-02,9693
8927,北基,21,0,21,富邦-新營,2023-10-02,9693
2402,毅嘉,22,2,20,富邦-新營,2023-10-02,9693
6016,康和證,20,0,20,富邦-新營,2023-10-02,9693
2889,國票金,16,0,16,富邦-新營,2023-10-02,9693
2637,慧洋-KY,16,0,16,富邦-新營,2023-10-02,9693
00680L,元大美債20正2,16,0,16,富邦-新營,2023-10-02,9693
00679B,元大美債20年,20,5,15,富邦-新營,2023-10-02,9693
3322,建舜電,15,0,15,富邦-新營,2023-10-02,9693
4763,材料-KY,15,0,15,富邦-新營,2023-10-02,9693
1513,中興電,16,3,13,富邦-新營,2023-10-02,9693
2516,新建,13,0,13,富邦-新營,2023-10-02,9693
2618,長榮航,12,1,11,富邦-新營,2023-10-02,9693
00751B,元大AAA至A公司債,11,0,11,富邦-新營,2023-10-02,9693
3481,群創,17,7,10,富邦-新營,2023-10-02,9693
1218,泰山,10,0,10,富邦-新營,2023-10-02,9693
1503,士電,10,0,10,富邦-新營,2023-10-02,9693
1514,亞力,10,1,9,富邦-新營,2023-10-02,9693
1515,力山,8,0,8,富邦-新營,2023-10-02,9693
1584,精剛,10,2,8,富邦-新營,2023-10-02,9693
2323,中環,13,5,8,富邦-新營,2023-10-02,9693
3715,定穎投控,15,8,7,富邦-新營,2023-10-02,9693
2409,友達,9,2,7,富邦-新營,2023-10-02,9693
2201,裕隆,7,0,7,富邦-新營,2023-10-02,9693
00738U,期元大道瓊白銀,7,0,7,富邦-新營,2023-10-02,9693
2530,華建,7,0,7,富邦-新營,2023-10-02,9693
8112,至上,7,0,7,富邦-新營,2023-10-02,9693
00772B,中信高評級公司債,6,0,6,富邦-新營,2023-10-02,9693
1802,台玻,10,4,6,富邦-新營,2023-10-02,9693
2329,華泰,29,23,6,富邦-新營,2023-10-02,9693
3122,笙泉,11,5,6,富邦-新營,2023-10-02,9693
3630,新鉅科,6,0,6,富邦-新營,2023-10-02,9693
5425,台半,6,0,6,富邦-新營,2023-10-02,9693
2605,新興,5,0,5,富邦-新營,2023-10-02,9693
00708L,期元大S＆P黃金正2,5,0,5,富邦-新營,2023-10-02,9693
00725B,國泰投資級公司債,5,0,5,富邦-新營,2023-10-02,9693
1108,幸福,5,0,5,富邦-新營,2023-10-02,9693
00688L,國泰20年美債正2,5,0,5,富邦-新營,2023-10-02,9693
1303,南亞,5,0,5,富邦-新營,2023-10-02,9693
1527,鑽全,5,0,5,富邦-新營,2023-10-02,9693
2883,凱基金,11,6,5,富邦-新營,2023-10-02,9693
3024,憶聲,5,0,5,富邦-新營,2023-10-02,9693
4120,友華,5,0,5,富邦-新營,2023-10-02,9693
6122,擎邦,7,2,5,富邦-新營,2023-10-02,9693
3231,緯創,81,16,65,富邦-新營,2023-10-03,9693
00713,元大台灣高息低波,78,15,63,富邦-新營,2023-10-03,9693
00712,復華富時不動產,58,0,58,富邦-新營,2023-10-03,9693
3032,偉訓,54,1,53,富邦-新營,2023-10-03,9693
6156,松上,45,0,45,富邦-新營,2023-10-03,9693
2888,新光金,37,0,37,富邦-新營,2023-10-03,9693
00929,復華台灣科技優息,33,0,33,富邦-新營,2023-10-03,9693
2332,友訊,35,3,32,富邦-新營,2023-10-03,9693
2409,友達,30,1,29,富邦-新營,2023-10-03,9693
0056,元大高股息,43,18,25,富邦-新營,2023-10-03,9693
2002,中鋼,23,0,23,富邦-新營,2023-10-03,9693
2329,華泰,24,3,21,富邦-新營,2023-10-03,9693
6257,矽格,21,0,21,富邦-新營,2023-10-03,9693
1216,統一,20,0,20,富邦-新營,2023-10-03,9693
8112,至上,25,10,15,富邦-新營,2023-10-03,9693
2634,漢翔,14,0,14,富邦-新營,2023-10-03,9693
1605,華新,17,4,13,富邦-新營,2023-10-03,9693
1417,嘉裕,13,0,13,富邦-新營,2023-10-03,9693
1736,喬山,13,0,13,富邦-新營,2023-10-03,9693
2455,全新,13,0,13,富邦-新營,2023-10-03,9693
3081,聯亞,15,2,13,富邦-新營,2023-10-03,9693
3481,群創,15,3,12,富邦-新營,2023-10-03,9693
2603,長榮,14,2,12,富邦-新營,2023-10-03,9693
3056,富華新,13,1,12,富邦-新營,2023-10-03,9693
00632R,元大台灣50反1,12,0,12,富邦-新營,2023-10-03,9693
1215,卜蜂,12,0,12,富邦-新營,2023-10-03,9693
3149,正達,12,0,12,富邦-新營,2023-10-03,9693
6235,華孚,22,10,12,富邦-新營,2023-10-03,9693
00720B,元大投資級公司債,12,0,12,富邦-新營,2023-10-03,9693
00679B,元大美債20年,11,0,11,富邦-新營,2023-10-03,9693
1524,耿鼎,11,0,11,富邦-新營,2023-10-03,9693
2301,光寶科,13,2,11,富邦-新營,2023-10-03,9693
2618,長榮航,12,1,11,富邦-新營,2023-10-03,9693
00882,中信中國高股息,10,0,10,富邦-新營,2023-10-03,9693
00753L,中信中國50正2,10,0,10,富邦-新營,2023-10-03,9693
2312,金寶,10,0,10,富邦-新營,2023-10-03,9693
4906,正文,10,0,10,富邦-新營,2023-10-03,9693
6005,群益證,10,0,10,富邦-新營,2023-10-03,9693
6530,創威,10,0,10,富邦-新營,2023-10-03,9693
4543,萬在,15,5,10,富邦-新營,2023-10-03,9693
3078,僑威,12,2,10,富邦-新營,2023-10-03,9693
3617,碩天,12,3,9,富邦-新營,2023-10-03,9693
00772B,中信高評級公司債,9,0,9,富邦-新營,2023-10-03,9693
2880,華南金,9,0,9,富邦-新營,2023-10-03,9693
2883,凱基金,8,0,8,富邦-新營,2023-10-03,9693
4960,誠美材,8,0,8,富邦-新營,2023-10-03,9693
5388,中磊,7,0,7,富邦-新營,2023-10-03,9693
00665L,富邦�琤肭磪囓�2,7,0,7,富邦-新營,2023-10-03,9693
6116,彩晶,7,0,7,富邦-新營,2023-10-03,9693
6288,聯嘉,16,9,7,富邦-新營,2023-10-03,9693
6288,聯嘉,211,20,191,富邦-新營,2023-10-04,9693
3715,定穎投控,155,8,147,富邦-新營,2023-10-04,9693
00680L,元大美債20正2,254,203,51,富邦-新營,2023-10-04,9693
6213,聯茂,51,0,51,富邦-新營,2023-10-04,9693
3163,波若威,45,2,43,富邦-新營,2023-10-04,9693
5009,榮剛,37,0,37,富邦-新營,2023-10-04,9693
00679B,元大美債20年,35,0,35,富邦-新營,2023-10-04,9693
2892,第一金,32,0,32,富邦-新營,2023-10-04,9693
2427,三商電,31,2,29,富邦-新營,2023-10-04,9693
2002,中鋼,37,8,29,富邦-新營,2023-10-04,9693
00712,復華富時不動產,28,0,28,富邦-新營,2023-10-04,9693
2888,新光金,77,50,27,富邦-新營,2023-10-04,9693
2891,中信金,26,0,26,富邦-新營,2023-10-04,9693
1605,華新,28,2,26,富邦-新營,2023-10-04,9693
00632R,元大台灣50反1,30,5,25,富邦-新營,2023-10-04,9693
3481,群創,21,0,21,富邦-新營,2023-10-04,9693
00688L,國泰20年美債正2,21,0,21,富邦-新營,2023-10-04,9693
2884,玉山金,21,0,21,富邦-新營,2023-10-04,9693
2851,中再保,20,0,20,富邦-新營,2023-10-04,9693
2409,友達,25,7,18,富邦-新營,2023-10-04,9693
00687B,國泰20年美債,18,0,18,富邦-新營,2023-10-04,9693
00664R,國泰臺灣加權反1,20,2,18,富邦-新營,2023-10-04,9693
00922,國泰台灣領袖50,17,0,17,富邦-新營,2023-10-04,9693
3231,緯創,32,16,16,富邦-新營,2023-10-04,9693
3056,富華新,15,0,15,富邦-新營,2023-10-04,9693
1417,嘉裕,14,0,14,富邦-新營,2023-10-04,9693
1909,榮成,14,0,14,富邦-新營,2023-10-04,9693
3006,晶豪科,16,2,14,富邦-新營,2023-10-04,9693
0056,元大高股息,13,0,13,富邦-新營,2023-10-04,9693
5880,合庫金,13,0,13,富邦-新營,2023-10-04,9693
2882,國泰金,13,0,13,富邦-新營,2023-10-04,9693
2886,兆豐金,14,1,13,富邦-新營,2023-10-04,9693
2618,長榮航,13,0,13,富邦-新營,2023-10-04,9693
00919,群益台灣精選高息,12,0,12,富邦-新營,2023-10-04,9693
00772B,中信高評級公司債,12,0,12,富邦-新營,2023-10-04,9693
1301,台塑,28,16,12,富邦-新營,2023-10-04,9693
2324,仁寶,11,0,11,富邦-新營,2023-10-04,9693
2838,聯邦銀,11,0,11,富邦-新營,2023-10-04,9693
2330,台積電,11,0,11,富邦-新營,2023-10-04,9693
2449,京元電子,11,1,10,富邦-新營,2023-10-04,9693
1402,遠東新,10,0,10,富邦-新營,2023-10-04,9693
00882,中信中國高股息,10,0,10,富邦-新營,2023-10-04,9693
2034,允強,10,0,10,富邦-新營,2023-10-04,9693
2406,國碩,10,0,10,富邦-新營,2023-10-04,9693
2516,新建,10,0,10,富邦-新營,2023-10-04,9693
3027,盛達,10,0,10,富邦-新營,2023-10-04,9693
3055,蔚華科,16,6,10,富邦-新營,2023-10-04,9693
3703,欣陸,10,0,10,富邦-新營,2023-10-04,9693
2303,聯電,12,3,9,富邦-新營,2023-10-04,9693
3693,營邦,12,3,9,富邦-新營,2023-10-04,9693
00712,復華富時不動產,77,0,77,富邦-新營,2023-10-05,9693
2382,廣達,105,34,71,富邦-新營,2023-10-05,9693
2883,凱基金,68,1,67,富邦-新營,2023-10-05,9693
6274,台燿,54,2,52,富邦-新營,2023-10-05,9693
2538,基泰,51,9,42,富邦-新營,2023-10-05,9693
3217,優群,40,0,40,富邦-新營,2023-10-05,9693
00929,復華台灣科技優息,39,6,33,富邦-新營,2023-10-05,9693
3051,力特,32,0,32,富邦-新營,2023-10-05,9693
00919,群益台灣精選高息,31,1,30,富邦-新營,2023-10-05,9693
2610,華航,33,8,25,富邦-新營,2023-10-05,9693
5381,合正,22,0,22,富邦-新營,2023-10-05,9693
00680L,元大美債20正2,20,0,20,富邦-新營,2023-10-05,9693
6244,茂迪,20,1,19,富邦-新營,2023-10-05,9693
8358,金居,20,2,18,富邦-新營,2023-10-05,9693
3163,波若威,14,2,12,富邦-新營,2023-10-05,9693
6288,聯嘉,12,0,12,富邦-新營,2023-10-05,9693
6442,光聖,11,0,11,富邦-新營,2023-10-05,9693
1522,堤維西,11,1,10,富邦-新營,2023-10-05,9693
1785,光洋科,10,0,10,富邦-新營,2023-10-05,9693
2323,中環,10,0,10,富邦-新營,2023-10-05,9693
2367,燿華,10,0,10,富邦-新營,2023-10-05,9693
0056,元大高股息,11,2,9,富邦-新營,2023-10-05,9693
00715L,期街口布蘭特正2,10,1,9,富邦-新營,2023-10-05,9693
2609,陽明,12,3,9,富邦-新營,2023-10-05,9693
2618,長榮航,19,10,9,富邦-新營,2023-10-05,9693
6197,佳必琪,10,1,9,富邦-新營,2023-10-05,9693
2371,大同,10,1,9,富邦-新營,2023-10-05,9693
2208,台船,7,0,7,富邦-新營,2023-10-05,9693
3481,群創,8,2,6,富邦-新營,2023-10-05,9693
2342,茂矽,6,0,6,富邦-新營,2023-10-05,9693
3013,晟銘電,9,3,6,富邦-新營,2023-10-05,9693
5009,榮剛,6,0,6,富邦-新營,2023-10-05,9693
8054,安國,10,4,6,富邦-新營,2023-10-05,9693
8088,品安,6,0,6,富邦-新營,2023-10-05,9693
00900,富邦特選高股息30,6,1,5,富邦-新營,2023-10-05,9693
00637L,元大滬深300正2,5,0,5,富邦-新營,2023-10-05,9693
00706L,期元大S＆P日圓正2,5,0,5,富邦-新營,2023-10-05,9693
1710,東聯,5,0,5,富邦-新營,2023-10-05,9693
2634,漢翔,5,0,5,富邦-新營,2023-10-05,9693
5439,高技,5,0,5,富邦-新營,2023-10-05,9693
6684,安格,5,0,5,富邦-新營,2023-10-05,9693
6865,偉康科技,5,0,5,富邦-新營,2023-10-05,9693
00679B,元大美債20年,4,0,4,富邦-新營,2023-10-05,9693
2002,中鋼,7,3,4,富邦-新營,2023-10-05,9693
00891,中信關鍵半導體,5,1,4,富邦-新營,2023-10-05,9693
1909,榮成,4,0,4,富邦-新營,2023-10-05,9693
2017,官田鋼,4,0,4,富邦-新營,2023-10-05,9693
2393,億光,4,0,4,富邦-新營,2023-10-05,9693
2408,南亞科,4,0,4,富邦-新營,2023-10-05,9693
2465,麗臺,4,0,4,富邦-新營,2023-10-05,9693
00929,復華台灣科技優息,67,2,65,富邦-新營,2023-10-06,9693
00680L,元大美債20正2,60,0,60,富邦-新營,2023-10-06,9693
00712,復華富時不動產,38,0,38,富邦-新營,2023-10-06,9693
0056,元大高股息,32,1,31,富邦-新營,2023-10-06,9693
00679B,元大美債20年,28,0,28,富邦-新營,2023-10-06,9693
2344,華邦電,65,39,26,富邦-新營,2023-10-06,9693
8076,伍豐,24,0,24,富邦-新營,2023-10-06,9693
2883,凱基金,25,4,21,富邦-新營,2023-10-06,9693
9105,泰金寶-DR,24,3,21,富邦-新營,2023-10-06,9693
2206,三陽工業,21,1,20,富邦-新營,2023-10-06,9693
6605,帝寶,20,0,20,富邦-新營,2023-10-06,9693
00720B,元大投資級公司債,16,0,16,富邦-新營,2023-10-06,9693
3704,合勤控,15,1,14,富邦-新營,2023-10-06,9693
00671R,富邦NASDAQ反1,11,0,11,富邦-新營,2023-10-06,9693
00717,富邦美國特別股,11,0,11,富邦-新營,2023-10-06,9693
2399,映泰,18,8,10,富邦-新營,2023-10-06,9693
4906,正文,10,0,10,富邦-新營,2023-10-06,9693
00902,中信電池及儲能,9,0,9,富邦-新營,2023-10-06,9693
2409,友達,8,1,7,富邦-新營,2023-10-06,9693
00919,群益台灣精選高息,7,0,7,富邦-新營,2023-10-06,9693
00715L,期街口布蘭特正2,8,1,7,富邦-新營,2023-10-06,9693
00664R,國泰臺灣加權反1,7,0,7,富邦-新營,2023-10-06,9693
2427,三商電,7,0,7,富邦-新營,2023-10-06,9693
6684,安格,15,9,6,富邦-新營,2023-10-06,9693
00655L,國泰中國A50正2,7,1,6,富邦-新營,2023-10-06,9693
1524,耿鼎,12,6,6,富邦-新營,2023-10-06,9693
1718,中纖,6,0,6,富邦-新營,2023-10-06,9693
2208,台船,6,0,6,富邦-新營,2023-10-06,9693
3047,訊舟,6,0,6,富邦-新營,2023-10-06,9693
3276,宇環,6,0,6,富邦-新營,2023-10-06,9693
6443,元晶,6,0,6,富邦-新營,2023-10-06,9693
3231,緯創,14,9,5,富邦-新營,2023-10-06,9693
2486,一詮,8,3,5,富邦-新營,2023-10-06,9693
3171,炎洲流通,5,0,5,富邦-新營,2023-10-06,9693
5880,合庫金,5,0,5,富邦-新營,2023-10-06,9693
6114,久威,5,0,5,富邦-新營,2023-10-06,9693
6550,北極星藥業-KY,6,1,5,富邦-新營,2023-10-06,9693
8942,森鉅,5,0,5,富邦-新營,2023-10-06,9693
2603,長榮,5,0,5,富邦-新營,2023-10-06,9693
1101,台泥,4,0,4,富邦-新營,2023-10-06,9693
2449,京元電子,4,0,4,富邦-新營,2023-10-06,9693
2605,新興,6,2,4,富邦-新營,2023-10-06,9693
3669,圓展,5,1,4,富邦-新營,2023-10-06,9693
6191,精成科,5,1,4,富邦-新營,2023-10-06,9693
6285,啟��,4,0,4,富邦-新營,2023-10-06,9693
2610,華航,4,1,3,富邦-新營,2023-10-06,9693
00885,富邦越南,6,3,3,富邦-新營,2023-10-06,9693
2618,長榮航,6,3,3,富邦-新營,2023-10-06,9693
00641R,富邦日本反1,3,0,3,富邦-新營,2023-10-06,9693
1304,台聚,3,0,3,富邦-新營,2023-10-06,9693
00715L,期街口布蘭特正2,1662,1,1661,富邦-新營,2023-10-11,9693
00687B,國泰20年美債,101,0,101,富邦-新營,2023-10-11,9693
3231,緯創,210,122,88,富邦-新營,2023-10-11,9693
2618,長榮航,68,3,65,富邦-新營,2023-10-11,9693
2888,新光金,40,3,37,富邦-新營,2023-10-11,9693
0056,元大高股息,38,4,34,富邦-新營,2023-10-11,9693
1711,永光,27,0,27,富邦-新營,2023-10-11,9693
2851,中再保,25,0,25,富邦-新營,2023-10-11,9693
2482,連宇,22,0,22,富邦-新營,2023-10-11,9693
00712,復華富時不動產,28,6,22,富邦-新營,2023-10-11,9693
8076,伍豐,22,1,21,富邦-新營,2023-10-11,9693
6015,宏遠證,20,0,20,富邦-新營,2023-10-11,9693
1720,生達,18,0,18,富邦-新營,2023-10-11,9693
2444,兆勁,20,2,18,富邦-新營,2023-10-11,9693
3481,群創,18,0,18,富邦-新營,2023-10-11,9693
2801,彰銀,17,0,17,富邦-新營,2023-10-11,9693
1909,榮成,16,0,16,富邦-新營,2023-10-11,9693
3163,波若威,19,3,16,富邦-新營,2023-10-11,9693
6153,嘉聯益,16,0,16,富邦-新營,2023-10-11,9693
3715,定穎投控,42,27,15,富邦-新營,2023-10-11,9693
2364,倫飛,72,57,15,富邦-新營,2023-10-11,9693
6796,晉弘,15,1,14,富邦-新營,2023-10-11,9693
2353,宏��,14,1,13,富邦-新營,2023-10-11,9693
3706,神達,14,1,13,富邦-新營,2023-10-11,9693
3322,建舜電,11,0,11,富邦-新營,2023-10-11,9693
2603,長榮,11,0,11,富邦-新營,2023-10-11,9693
1229,聯華,10,0,10,富邦-新營,2023-10-11,9693
6282,康舒,16,6,10,富邦-新營,2023-10-11,9693
2332,友訊,11,1,10,富邦-新營,2023-10-11,9693
2436,偉詮電,10,0,10,富邦-新營,2023-10-11,9693
9105,泰金寶-DR,10,0,10,富邦-新營,2023-10-11,9693
2002,中鋼,13,4,9,富邦-新營,2023-10-11,9693
2486,一詮,12,3,9,富邦-新營,2023-10-11,9693
6220,岳豐,9,0,9,富邦-新營,2023-10-11,9693
2014,中鴻,8,0,8,富邦-新營,2023-10-11,9693
2201,裕隆,8,0,8,富邦-新營,2023-10-11,9693
2329,華泰,9,1,8,富邦-新營,2023-10-11,9693
3567,逸昌,8,0,8,富邦-新營,2023-10-11,9693
5512,力麒,8,0,8,富邦-新營,2023-10-11,9693
1529,樂事綠能,13,6,7,富邦-新營,2023-10-11,9693
2208,台船,7,0,7,富邦-新營,2023-10-11,9693
3027,盛達,7,0,7,富邦-新營,2023-10-11,9693
1612,宏泰,7,0,7,富邦-新營,2023-10-11,9693
1515,力山,6,0,6,富邦-新營,2023-10-11,9693
3545,敦泰,6,0,6,富邦-新營,2023-10-11,9693
6125,廣運,9,3,6,富邦-新營,2023-10-11,9693
2356,英業達,17,12,5,富邦-新營,2023-10-11,9693
1584,精剛,5,0,5,富邦-新營,2023-10-11,9693
2017,官田鋼,5,0,5,富邦-新營,2023-10-11,9693
2105,正新,5,0,5,富邦-新營,2023-10-11,9693
00637L,元大滬深300正2,95,0,95,富邦-新營,2023-10-12,9693
2363,矽統,304,247,57,富邦-新營,2023-10-12,9693
6213,聯茂,51,1,50,富邦-新營,2023-10-12,9693
00679B,元大美債20年,30,4,26,富邦-新營,2023-10-12,9693
0056,元大高股息,26,3,23,富邦-新營,2023-10-12,9693
1409,新纖,23,0,23,富邦-新營,2023-10-12,9693
1522,堤維西,21,0,21,富邦-新營,2023-10-12,9693
5512,力麒,17,0,17,富邦-新營,2023-10-12,9693
1802,台玻,15,0,15,富邦-新營,2023-10-12,9693
2884,玉山金,20,6,14,富邦-新營,2023-10-12,9693
2547,日勝生,12,0,12,富邦-新營,2023-10-12,9693
00905,FT臺灣Smart,11,0,11,富邦-新營,2023-10-12,9693
3056,富華新,10,0,10,富邦-新營,2023-10-12,9693
1416,廣豐,10,0,10,富邦-新營,2023-10-12,9693
2606,裕民,10,0,10,富邦-新營,2023-10-12,9693
3037,欣興,10,0,10,富邦-新營,2023-10-12,9693
4906,正文,10,0,10,富邦-新營,2023-10-12,9693
2392,正崴,10,1,9,富邦-新營,2023-10-12,9693
1720,生達,7,0,7,富邦-新營,2023-10-12,9693
6216,居易,7,0,7,富邦-新營,2023-10-12,9693
00858,永豐美國500大,6,0,6,富邦-新營,2023-10-12,9693
1909,榮成,6,0,6,富邦-新營,2023-10-12,9693
2356,英業達,6,0,6,富邦-新營,2023-10-12,9693
2417,圓剛,6,0,6,富邦-新營,2023-10-12,9693
9945,潤泰新,6,0,6,富邦-新營,2023-10-12,9693
1815,富喬,5,0,5,富邦-新營,2023-10-12,9693
3149,正達,5,0,5,富邦-新營,2023-10-12,9693
6160,欣技,5,0,5,富邦-新營,2023-10-12,9693
00720B,元大投資級公司債,8,4,4,富邦-新營,2023-10-12,9693
1584,精剛,7,3,4,富邦-新營,2023-10-12,9693
1609,大亞,4,0,4,富邦-新營,2023-10-12,9693
2352,佳世達,4,0,4,富邦-新營,2023-10-12,9693
4552,力達-KY,4,0,4,富邦-新營,2023-10-12,9693
6116,彩晶,4,0,4,富邦-新營,2023-10-12,9693
6412,群電,4,0,4,富邦-新營,2023-10-12,9693
00715L,期街口布蘭特正2,3,0,3,富邦-新營,2023-10-12,9693
00680L,元大美債20正2,3,0,3,富邦-新營,2023-10-12,9693
1618,合機,3,0,3,富邦-新營,2023-10-12,9693
2377,微星,3,0,3,富邦-新營,2023-10-12,9693
2399,映泰,3,0,3,富邦-新營,2023-10-12,9693
2427,三商電,10,7,3,富邦-新營,2023-10-12,9693
2537,聯上發,3,0,3,富邦-新營,2023-10-12,9693
2610,華航,4,1,3,富邦-新營,2023-10-12,9693
3346,麗清,8,5,3,富邦-新營,2023-10-12,9693
6129,普誠,3,0,3,富邦-新營,2023-10-12,9693
6282,康舒,11,8,3,富邦-新營,2023-10-12,9693
6288,聯嘉,3,0,3,富邦-新營,2023-10-12,9693
6550,北極星藥業-KY,3,0,3,富邦-新營,2023-10-12,9693
5351,鈺創,5,2,3,富邦-新營,2023-10-12,9693
00919,群益台灣精選高息,6,4,2,富邦-新營,2023-10-12,9693
00671R,富邦NASDAQ反1,150,0,150,富邦-新營,2023-10-13,9693
6244,茂迪,119,0,119,富邦-新營,2023-10-13,9693
2601,益航,40,0,40,富邦-新營,2023-10-13,9693
00713,元大台灣高息低波,35,0,35,富邦-新營,2023-10-13,9693
3231,緯創,39,11,28,富邦-新營,2023-10-13,9693
0056,元大高股息,28,1,27,富邦-新營,2023-10-13,9693
2883,凱基金,23,1,22,富邦-新營,2023-10-13,9693
3056,富華新,22,0,22,富邦-新營,2023-10-13,9693
00919,群益台灣精選高息,20,0,20,富邦-新營,2023-10-13,9693
00665L,富邦�琤肭磪囓�2,20,0,20,富邦-新營,2023-10-13,9693
00712,復華富時不動產,20,0,20,富邦-新營,2023-10-13,9693
2618,長榮航,19,0,19,富邦-新營,2023-10-13,9693
3025,星通,23,4,19,富邦-新營,2023-10-13,9693
00680L,元大美債20正2,18,0,18,富邦-新營,2023-10-13,9693
00878,國泰永續高股息,17,0,17,富邦-新營,2023-10-13,9693
3481,群創,20,3,17,富邦-新營,2023-10-13,9693
9904,寶成,17,0,17,富邦-新營,2023-10-13,9693
3264,欣銓,16,0,16,富邦-新營,2023-10-13,9693
3163,波若威,45,30,15,富邦-新營,2023-10-13,9693
2886,兆豐金,20,6,14,富邦-新營,2023-10-13,9693
2736,富野,13,0,13,富邦-新營,2023-10-13,9693
2301,光寶科,13,1,12,富邦-新營,2023-10-13,9693
9945,潤泰新,12,0,12,富邦-新營,2023-10-13,9693
00687B,國泰20年美債,11,0,11,富邦-新營,2023-10-13,9693
2020,美亞,11,0,11,富邦-新營,2023-10-13,9693
2324,仁寶,12,1,11,富邦-新營,2023-10-13,9693
2425,承啟,12,1,11,富邦-新營,2023-10-13,9693
9907,統一實,11,0,11,富邦-新營,2023-10-13,9693
00632R,元大台灣50反1,10,0,10,富邦-新營,2023-10-13,9693
00753L,中信中國50正2,10,0,10,富邦-新營,2023-10-13,9693
00688L,國泰20年美債正2,10,0,10,富邦-新營,2023-10-13,9693
2027,大成鋼,10,0,10,富邦-新營,2023-10-13,9693
2358,廷鑫,10,0,10,富邦-新營,2023-10-13,9693
6213,聯茂,10,0,10,富邦-新營,2023-10-13,9693
8086,宏捷科,10,0,10,富邦-新營,2023-10-13,9693
2382,廣達,16,6,10,富邦-新營,2023-10-13,9693
6684,安格,16,6,10,富邦-新營,2023-10-13,9693
00720B,元大投資級公司債,9,0,9,富邦-新營,2023-10-13,9693
1904,正隆,10,1,9,富邦-新營,2023-10-13,9693
1815,富喬,21,12,9,富邦-新營,2023-10-13,9693
2913,農林,8,0,8,富邦-新營,2023-10-13,9693
3325,旭品,17,9,8,富邦-新營,2023-10-13,9693
5519,隆大,8,0,8,富邦-新營,2023-10-13,9693
3324,雙鴻,7,0,7,富邦-新營,2023-10-13,9693
1609,大亞,7,0,7,富邦-新營,2023-10-13,9693
00773B,中信優先金融債,6,0,6,富邦-新營,2023-10-13,9693
00931B,統一美債20年,6,0,6,富邦-新營,2023-10-13,9693
2329,華泰,7,1,6,富邦-新營,2023-10-13,9693
3704,合勤控,8,2,6,富邦-新營,2023-10-13,9693
4967,十銓,8,2,6,富邦-新營,2023-10-13,9693
00671R,富邦NASDAQ反1,100,0,100,富邦-新營,2023-10-16,9693
00919,群益台灣精選高息,88,0,88,富邦-新營,2023-10-16,9693
2913,農林,100,16,84,富邦-新營,2023-10-16,9693
2324,仁寶,66,3,63,富邦-新營,2023-10-16,9693
00929,復華台灣科技優息,61,1,60,富邦-新營,2023-10-16,9693
00715L,期街口布蘭特正2,71,14,57,富邦-新營,2023-10-16,9693
00712,復華富時不動產,41,4,37,富邦-新營,2023-10-16,9693
2344,華邦電,36,0,36,富邦-新營,2023-10-16,9693
2515,中工,59,25,34,富邦-新營,2023-10-16,9693
6443,元晶,33,0,33,富邦-新營,2023-10-16,9693
2363,矽統,328,301,27,富邦-新營,2023-10-16,9693
3035,智原,47,26,21,富邦-新營,2023-10-16,9693
2482,連宇,20,0,20,富邦-新營,2023-10-16,9693
2610,華航,16,1,15,富邦-新營,2023-10-16,9693
00753L,中信中國50正2,15,0,15,富邦-新營,2023-10-16,9693
4162,智擎,15,0,15,富邦-新營,2023-10-16,9693
6770,力積電,18,4,14,富邦-新營,2023-10-16,9693
2201,裕隆,36,22,14,富邦-新營,2023-10-16,9693
2449,京元電子,17,4,13,富邦-新營,2023-10-16,9693
0056,元大高股息,13,0,13,富邦-新營,2023-10-16,9693
2374,佳能,12,0,12,富邦-新營,2023-10-16,9693
3706,神達,21,9,12,富邦-新營,2023-10-16,9693
00878,國泰永續高股息,14,3,11,富邦-新營,2023-10-16,9693
3056,富華新,10,0,10,富邦-新營,2023-10-16,9693
00923,群益台ESG低碳50,10,0,10,富邦-新營,2023-10-16,9693
2618,長榮航,10,0,10,富邦-新營,2023-10-16,9693
2867,三商壽,10,0,10,富邦-新營,2023-10-16,9693
6015,宏遠證,10,0,10,富邦-新營,2023-10-16,9693
6120,達運,10,0,10,富邦-新營,2023-10-16,9693
9907,統一實,10,0,10,富邦-新營,2023-10-16,9693
4763,材料-KY,15,5,10,富邦-新營,2023-10-16,9693
4908,前鼎,18,9,9,富邦-新營,2023-10-16,9693
5880,合庫金,10,1,9,富邦-新營,2023-10-16,9693
00722B,群益投資級電信債,8,0,8,富邦-新營,2023-10-16,9693
6264,富裔,8,0,8,富邦-新營,2023-10-16,9693
1605,華新,10,3,7,富邦-新營,2023-10-16,9693
1101,台泥,7,0,7,富邦-新營,2023-10-16,9693
1319,東陽,7,0,7,富邦-新營,2023-10-16,9693
00673R,期元大S＆P原油反1,7,0,7,富邦-新營,2023-10-16,9693
2609,陽明,7,0,7,富邦-新營,2023-10-16,9693
6505,台塑化,7,0,7,富邦-新營,2023-10-16,9693
1609,大亞,6,0,6,富邦-新營,2023-10-16,9693
00922,國泰台灣領袖50,6,0,6,富邦-新營,2023-10-16,9693
00679B,元大美債20年,6,0,6,富邦-新營,2023-10-16,9693
6426,統新,6,0,6,富邦-新營,2023-10-16,9693
3715,定穎投控,12,7,5,富邦-新營,2023-10-16,9693
9945,潤泰新,5,0,5,富邦-新營,2023-10-16,9693
00902,中信電池及儲能,5,0,5,富邦-新營,2023-10-16,9693
3202,樺晟,5,0,5,富邦-新營,2023-10-16,9693
5443,均豪,5,0,5,富邦-新營,2023-10-16,9693
00680L,元大美債20正2,165,0,165,富邦-新營,2023-10-17,9693
8054,安國,162,2,160,富邦-新營,2023-10-17,9693
6530,創威,103,0,103,富邦-新營,2023-10-17,9693
2601,益航,81,0,81,富邦-新營,2023-10-17,9693
00688L,國泰20年美債正2,54,0,54,富邦-新營,2023-10-17,9693
4960,誠美材,26,2,24,富邦-新營,2023-10-17,9693
2634,漢翔,22,0,22,富邦-新營,2023-10-17,9693
6114,久威,23,1,22,富邦-新營,2023-10-17,9693
00687B,國泰20年美債,21,0,21,富邦-新營,2023-10-17,9693
2355,敬鵬,20,0,20,富邦-新營,2023-10-17,9693
4908,前鼎,21,1,20,富邦-新營,2023-10-17,9693
00679B,元大美債20年,19,0,19,富邦-新營,2023-10-17,9693
00878,國泰永續高股息,36,18,18,富邦-新營,2023-10-17,9693
2888,新光金,16,0,16,富邦-新營,2023-10-17,9693
2801,彰銀,15,0,15,富邦-新營,2023-10-17,9693
3363,上詮,23,8,15,富邦-新營,2023-10-17,9693
2409,友達,12,0,12,富邦-新營,2023-10-17,9693
6104,創惟,12,0,12,富邦-新營,2023-10-17,9693
2401,凌陽,20,9,11,富邦-新營,2023-10-17,9693
3227,原相,10,0,10,富邦-新營,2023-10-17,9693
00712,復華富時不動產,10,1,9,富邦-新營,2023-10-17,9693
2317,鴻海,10,1,9,富邦-新營,2023-10-17,9693
4533,協易機,10,1,9,富邦-新營,2023-10-17,9693
5347,世界,20,11,9,富邦-新營,2023-10-17,9693
2834,臺企銀,8,0,8,富邦-新營,2023-10-17,9693
0056,元大高股息,13,5,8,富邦-新營,2023-10-17,9693
2201,裕隆,7,0,7,富邦-新營,2023-10-17,9693
4162,智擎,6,0,6,富邦-新營,2023-10-17,9693
4207,環泰,6,0,6,富邦-新營,2023-10-17,9693
6264,富裔,6,0,6,富邦-新營,2023-10-17,9693
1513,中興電,5,0,5,富邦-新營,2023-10-17,9693
1319,東陽,10,5,5,富邦-新營,2023-10-17,9693
2356,英業達,8,3,5,富邦-新營,2023-10-17,9693
8227,巨有科技,5,0,5,富邦-新營,2023-10-17,9693
00669R,國泰美國道瓊反1,5,0,5,富邦-新營,2023-10-17,9693
00637L,元大滬深300正2,5,0,5,富邦-新營,2023-10-17,9693
1584,精剛,5,0,5,富邦-新營,2023-10-17,9693
2009,第一銅,5,0,5,富邦-新營,2023-10-17,9693
3005,神基,5,0,5,富邦-新營,2023-10-17,9693
3027,盛達,5,0,5,富邦-新營,2023-10-17,9693
3481,群創,13,8,5,富邦-新營,2023-10-17,9693
6139,亞翔,8,3,5,富邦-新營,2023-10-17,9693
6153,嘉聯益,5,0,5,富邦-新營,2023-10-17,9693
8938,明安,5,0,5,富邦-新營,2023-10-17,9693
00720B,元大投資級公司債,5,0,5,富邦-新營,2023-10-17,9693
2014,中鴻,5,1,4,富邦-新營,2023-10-17,9693
2020,美亞,4,0,4,富邦-新營,2023-10-17,9693
2425,承啟,4,0,4,富邦-新營,2023-10-17,9693
2449,京元電子,9,5,4,富邦-新營,2023-10-17,9693
2516,新建,6,2,4,富邦-新營,2023-10-17,9693
00680L,元大美債20正2,143,0,143,富邦-新營,2023-10-18,9693
00929,復華台灣科技優息,152,15,137,富邦-新營,2023-10-18,9693
0056,元大高股息,140,15,125,富邦-新營,2023-10-18,9693
00878,國泰永續高股息,100,7,93,富邦-新營,2023-10-18,9693
00919,群益台灣精選高息,76,0,76,富邦-新營,2023-10-18,9693
1314,中石化,90,18,72,富邦-新營,2023-10-18,9693
5439,高技,54,1,53,富邦-新營,2023-10-18,9693
00715L,期街口布蘭特正2,50,4,46,富邦-新營,2023-10-18,9693
3078,僑威,44,13,31,富邦-新營,2023-10-18,9693
2498,宏達電,28,0,28,富邦-新營,2023-10-18,9693
1909,榮成,30,5,25,富邦-新營,2023-10-18,9693
5009,榮剛,21,0,21,富邦-新營,2023-10-18,9693
00922,國泰台灣領袖50,21,0,21,富邦-新營,2023-10-18,9693
2002,中鋼,19,1,18,富邦-新營,2023-10-18,9693
1815,富喬,16,0,16,富邦-新營,2023-10-18,9693
00722B,群益投資級電信債,15,0,15,富邦-新營,2023-10-18,9693
2399,映泰,16,1,15,富邦-新營,2023-10-18,9693
3025,星通,16,2,14,富邦-新營,2023-10-18,9693
1101,台泥,14,0,14,富邦-新營,2023-10-18,9693
3094,聯傑,15,2,13,富邦-新營,2023-10-18,9693
2355,敬鵬,12,0,12,富邦-新營,2023-10-18,9693
6197,佳必琪,14,2,12,富邦-新營,2023-10-18,9693
2610,華航,12,1,11,富邦-新營,2023-10-18,9693
2201,裕隆,24,13,11,富邦-新營,2023-10-18,9693
3105,穩懋,10,0,10,富邦-新營,2023-10-18,9693
00687B,國泰20年美債,10,0,10,富邦-新營,2023-10-18,9693
00632R,元大台灣50反1,20,10,10,富邦-新營,2023-10-18,9693
1218,泰山,10,0,10,富邦-新營,2023-10-18,9693
2461,光群雷,10,0,10,富邦-新營,2023-10-18,9693
2851,中再保,10,0,10,富邦-新營,2023-10-18,9693
3033,威健,10,0,10,富邦-新營,2023-10-18,9693
6153,嘉聯益,10,0,10,富邦-新營,2023-10-18,9693
6168,宏齊,38,28,10,富邦-新營,2023-10-18,9693
6550,北極星藥業-KY,10,0,10,富邦-新營,2023-10-18,9693
6770,力積電,11,1,10,富邦-新營,2023-10-18,9693
2441,超豐,9,0,9,富邦-新營,2023-10-18,9693
1102,亞泥,9,0,9,富邦-新營,2023-10-18,9693
1785,光洋科,10,2,8,富邦-新營,2023-10-18,9693
2465,麗臺,8,0,8,富邦-新營,2023-10-18,9693
4967,十銓,12,4,8,富邦-新營,2023-10-18,9693
00882,中信中國高股息,7,0,7,富邦-新營,2023-10-18,9693
3706,神達,7,0,7,富邦-新營,2023-10-18,9693
00679B,元大美債20年,7,0,7,富邦-新營,2023-10-18,9693
00932,兆豐永續高息等權,7,0,7,富邦-新營,2023-10-18,9693
2388,威盛,32,25,7,富邦-新營,2023-10-18,9693
3481,群創,7,0,7,富邦-新營,2023-10-18,9693
00712,復華富時不動產,7,1,6,富邦-新營,2023-10-18,9693
2880,華南金,6,0,6,富邦-新營,2023-10-18,9693
3704,合勤控,18,12,6,富邦-新營,2023-10-18,9693
1304,台聚,6,0,6,富邦-新營,2023-10-18,9693
00712,復華富時不動產,317,0,317,富邦-新營,2023-10-19,9693
00929,復華台灣科技優息,117,16,101,富邦-新營,2023-10-19,9693
00933B,國泰10Y+金融債,86,0,86,富邦-新營,2023-10-19,9693
0056,元大高股息,68,0,68,富邦-新營,2023-10-19,9693
00680L,元大美債20正2,56,0,56,富邦-新營,2023-10-19,9693
2344,華邦電,53,3,50,富邦-新營,2023-10-19,9693
2883,凱基金,34,0,34,富邦-新營,2023-10-19,9693
00885,富邦越南,33,0,33,富邦-新營,2023-10-19,9693
6244,茂迪,32,0,32,富邦-新營,2023-10-19,9693
00878,國泰永續高股息,33,2,31,富邦-新營,2023-10-19,9693
6120,達運,26,0,26,富邦-新營,2023-10-19,9693
2002,中鋼,23,0,23,富邦-新營,2023-10-19,9693
8054,安國,23,2,21,富邦-新營,2023-10-19,9693
00679B,元大美債20年,19,0,19,富邦-新營,2023-10-19,9693
00687B,國泰20年美債,17,0,17,富邦-新營,2023-10-19,9693
1101,台泥,17,0,17,富邦-新營,2023-10-19,9693
2382,廣達,22,7,15,富邦-新營,2023-10-19,9693
8227,巨有科技,15,0,15,富邦-新營,2023-10-19,9693
00893,國泰智能電動車,13,0,13,富邦-新營,2023-10-19,9693
1609,大亞,13,0,13,富邦-新營,2023-10-19,9693
2201,裕隆,15,2,13,富邦-新營,2023-10-19,9693
9907,統一實,13,0,13,富邦-新營,2023-10-19,9693
2409,友達,14,1,13,富邦-新營,2023-10-19,9693
2317,鴻海,13,1,12,富邦-新營,2023-10-19,9693
3231,緯創,34,21,13,富邦-新營,2023-10-19,9693
2610,華航,13,1,12,富邦-新營,2023-10-19,9693
2618,長榮航,15,3,12,富邦-新營,2023-10-19,9693
00720B,元大投資級公司債,12,0,12,富邦-新營,2023-10-19,9693
00922,國泰台灣領袖50,11,0,11,富邦-新營,2023-10-19,9693
2356,英業達,14,3,11,富邦-新營,2023-10-19,9693
00753L,中信中國50正2,10,0,10,富邦-新營,2023-10-19,9693
1455,集盛,10,0,10,富邦-新營,2023-10-19,9693
2392,正崴,10,0,10,富邦-新營,2023-10-19,9693
4906,正文,10,0,10,富邦-新營,2023-10-19,9693
8261,富鼎,10,0,10,富邦-新營,2023-10-19,9693
2886,兆豐金,10,0,10,富邦-新營,2023-10-19,9693
8112,至上,10,1,9,富邦-新營,2023-10-19,9693
8429,金麗-KY,13,4,9,富邦-新營,2023-10-19,9693
2892,第一金,9,0,9,富邦-新營,2023-10-19,9693
00772B,中信高評級公司債,8,0,8,富邦-新營,2023-10-19,9693
00751B,元大AAA至A公司債,8,0,8,富邦-新營,2023-10-19,9693
1442,名軒,8,0,8,富邦-新營,2023-10-19,9693
2388,威盛,21,13,8,富邦-新營,2023-10-19,9693
00915,凱基優選高股息30,7,0,7,富邦-新營,2023-10-19,9693
2313,華通,8,1,7,富邦-新營,2023-10-19,9693
3714,富采,7,0,7,富邦-新營,2023-10-19,9693
6530,創威,9,2,7,富邦-新營,2023-10-19,9693
9958,世紀鋼,7,0,7,富邦-新營,2023-10-19,9693
2421,建準,7,1,6,富邦-新營,2023-10-19,9693
1303,南亞,6,0,6,富邦-新營,2023-10-19,9693
4967,十銓,150,7,143,富邦-新營,2023-10-20,9693
00712,復華富時不動產,105,0,105,富邦-新營,2023-10-20,9693
00680L,元大美債20正2,66,0,66,富邦-新營,2023-10-20,9693
2363,矽統,64,13,51,富邦-新營,2023-10-20,9693
5439,高技,39,0,39,富邦-新營,2023-10-20,9693
00632R,元大台灣50反1,40,3,37,富邦-新營,2023-10-20,9693
1314,中石化,46,10,36,富邦-新營,2023-10-20,9693
3322,建舜電,31,0,31,富邦-新營,2023-10-20,9693
2888,新光金,27,1,26,富邦-新營,2023-10-20,9693
00878,國泰永續高股息,29,3,26,富邦-新營,2023-10-20,9693
2002,中鋼,23,0,23,富邦-新營,2023-10-20,9693
2892,第一金,23,0,23,富邦-新營,2023-10-20,9693
00933B,國泰10Y+金融債,22,0,22,富邦-新營,2023-10-20,9693
2516,新建,22,0,22,富邦-新營,2023-10-20,9693
00673R,期元大S＆P原油反1,17,0,17,富邦-新營,2023-10-20,9693
1513,中興電,18,1,17,富邦-新營,2023-10-20,9693
3163,波若威,19,3,16,富邦-新營,2023-10-20,9693
3308,聯德,15,0,15,富邦-新營,2023-10-20,9693
4938,和碩,15,0,15,富邦-新營,2023-10-20,9693
00919,群益台灣精選高息,16,3,13,富邦-新營,2023-10-20,9693
1605,華新,13,0,13,富邦-新營,2023-10-20,9693
2409,友達,13,0,13,富邦-新營,2023-10-20,9693
2634,漢翔,13,0,13,富邦-新營,2023-10-20,9693
2201,裕隆,16,4,12,富邦-新營,2023-10-20,9693
5009,榮剛,12,0,12,富邦-新營,2023-10-20,9693
00679B,元大美債20年,11,0,11,富邦-新營,2023-10-20,9693
1504,東元,12,1,11,富邦-新營,2023-10-20,9693
1536,和大,11,0,11,富邦-新營,2023-10-20,9693
2303,聯電,48,37,11,富邦-新營,2023-10-20,9693
4763,材料-KY,11,1,10,富邦-新營,2023-10-20,9693
2392,正崴,10,0,10,富邦-新營,2023-10-20,9693
1442,名軒,10,0,10,富邦-新營,2023-10-20,9693
3092,鴻碩,10,0,10,富邦-新營,2023-10-20,9693
4304,勝昱,10,0,10,富邦-新營,2023-10-20,9693
00720B,元大投資級公司債,9,0,9,富邦-新營,2023-10-20,9693
3006,晶豪科,12,3,9,富邦-新營,2023-10-20,9693
3264,欣銓,9,0,9,富邦-新營,2023-10-20,9693
3005,神基,7,0,7,富邦-新營,2023-10-20,9693
6530,創威,18,11,7,富邦-新營,2023-10-20,9693
3025,星通,17,11,6,富邦-新營,2023-10-20,9693
2886,兆豐金,10,4,6,富邦-新營,2023-10-20,9693
2317,鴻海,7,1,6,富邦-新營,2023-10-20,9693
1718,中纖,6,0,6,富邦-新營,2023-10-20,9693
2897,王道銀行,6,0,6,富邦-新營,2023-10-20,9693
8112,至上,6,0,6,富邦-新營,2023-10-20,9693
2891,中信金,6,0,6,富邦-新營,2023-10-20,9693
2884,玉山金,5,0,5,富邦-新營,2023-10-20,9693
00891,中信關鍵半導體,5,0,5,富邦-新營,2023-10-20,9693
3032,偉訓,5,0,5,富邦-新營,2023-10-20,9693
3363,上詮,5,0,5,富邦-新營,2023-10-20,9693
00929,復華台灣科技優息,376,30,346,富邦-新營,2023-10-23,9693
00632R,元大台灣50反1,250,0,250,富邦-新營,2023-10-23,9693
2369,菱生,444,281,163,富邦-新營,2023-10-23,9693
2363,矽統,307,230,77,富邦-新營,2023-10-23,9693
2409,友達,75,0,75,富邦-新營,2023-10-23,9693
2317,鴻海,45,7,38,富邦-新營,2023-10-23,9693
00720B,元大投資級公司債,31,0,31,富邦-新營,2023-10-23,9693
00712,復華富時不動產,29,0,29,富邦-新營,2023-10-23,9693
00878,國泰永續高股息,30,2,28,富邦-新營,2023-10-23,9693
00919,群益台灣精選高息,30,3,27,富邦-新營,2023-10-23,9693
2834,臺企銀,26,0,26,富邦-新營,2023-10-23,9693
00892,富邦台灣半導體,23,0,23,富邦-新營,2023-10-23,9693
3481,群創,21,0,21,富邦-新營,2023-10-23,9693
6158,禾昌,21,0,21,富邦-新營,2023-10-23,9693
00933B,國泰10Y+金融債,21,0,21,富邦-新營,2023-10-23,9693
00922,國泰台灣領袖50,21,1,20,富邦-新營,2023-10-23,9693
00679B,元大美債20年,20,0,20,富邦-新營,2023-10-23,9693
00773B,中信優先金融債,19,0,19,富邦-新營,2023-10-23,9693
2449,京元電子,18,0,18,富邦-新營,2023-10-23,9693
2002,中鋼,18,0,18,富邦-新營,2023-10-23,9693
2402,毅嘉,20,2,18,富邦-新營,2023-10-23,9693
2892,第一金,18,0,18,富邦-新營,2023-10-23,9693
2610,華航,23,7,16,富邦-新營,2023-10-23,9693
1785,光洋科,14,4,10,富邦-新營,2023-10-23,9693
4167,松瑞藥,10,0,10,富邦-新營,2023-10-23,9693
3264,欣銓,10,0,10,富邦-新營,2023-10-23,9693
5009,榮剛,13,4,9,富邦-新營,2023-10-23,9693
2337,旺宏,10,1,9,富邦-新營,2023-10-23,9693
2201,裕隆,11,3,8,富邦-新營,2023-10-23,9693
2886,兆豐金,8,0,8,富邦-新營,2023-10-23,9693
00772B,中信高評級公司債,7,0,7,富邦-新營,2023-10-23,9693
1442,名軒,7,0,7,富邦-新營,2023-10-23,9693
3163,波若威,11,4,7,富邦-新營,2023-10-23,9693
1721,三晃,7,0,7,富邦-新營,2023-10-23,9693
1723,中碳,8,1,7,富邦-新營,2023-10-23,9693
2388,威盛,9,2,7,富邦-新營,2023-10-23,9693
8069,元太,7,1,6,富邦-新營,2023-10-23,9693
2883,凱基金,6,0,6,富邦-新營,2023-10-23,9693
6187,萬潤,7,1,6,富邦-新營,2023-10-23,9693
2330,台積電,6,0,6,富邦-新營,2023-10-23,9693
2344,華邦電,5,0,5,富邦-新營,2023-10-23,9693
3715,定穎投控,9,4,5,富邦-新營,2023-10-23,9693
6770,力積電,5,0,5,富邦-新營,2023-10-23,9693
2324,仁寶,5,0,5,富邦-新營,2023-10-23,9693
2882,國泰金,6,1,5,富邦-新營,2023-10-23,9693
1101,台泥,5,0,5,富邦-新營,2023-10-23,9693
00891,中信關鍵半導體,5,0,5,富邦-新營,2023-10-23,9693
00688L,國泰20年美債正2,5,0,5,富邦-新營,2023-10-23,9693
2441,超豐,5,0,5,富邦-新營,2023-10-23,9693
8213,志超,5,0,5,富邦-新營,2023-10-23,9693
1524,耿鼎,97,12,85,富邦-新營,2023-10-24,9693
00712,復華富時不動產,75,0,75,富邦-新營,2023-10-24,9693
2317,鴻海,61,7,54,富邦-新營,2023-10-24,9693
4908,前鼎,149,109,40,富邦-新營,2023-10-24,9693
6530,創威,31,1,30,富邦-新營,2023-10-24,9693
2543,皇昌,30,1,29,富邦-新營,2023-10-24,9693
00929,復華台灣科技優息,82,55,27,富邦-新營,2023-10-24,9693
6244,茂迪,20,0,20,富邦-新營,2023-10-24,9693
00919,群益台灣精選高息,17,1,16,富邦-新營,2023-10-24,9693
00687B,國泰20年美債,16,1,15,富邦-新營,2023-10-24,9693
2449,京元電子,13,1,12,富邦-新營,2023-10-24,9693
2401,凌陽,28,17,11,富邦-新營,2023-10-24,9693
1314,中石化,10,0,10,富邦-新營,2023-10-24,9693
00753L,中信中國50正2,10,0,10,富邦-新營,2023-10-24,9693
00904,新光臺灣半導體30,10,0,10,富邦-新營,2023-10-24,9693
00902,中信電池及儲能,11,1,10,富邦-新營,2023-10-24,9693
2002,中鋼,9,0,9,富邦-新營,2023-10-24,9693
2816,旺旺保,8,0,8,富邦-新營,2023-10-24,9693
3617,碩天,9,1,8,富邦-新營,2023-10-24,9693
3037,欣興,9,2,7,富邦-新營,2023-10-24,9693
2606,裕民,7,0,7,富邦-新營,2023-10-24,9693
1215,卜蜂,6,0,6,富邦-新營,2023-10-24,9693
2303,聯電,35,29,6,富邦-新營,2023-10-24,9693
2610,華航,12,6,6,富邦-新營,2023-10-24,9693
5880,合庫金,6,0,6,富邦-新營,2023-10-24,9693
9955,佳龍,6,0,6,富邦-新營,2023-10-24,9693
2371,大同,5,0,5,富邦-新營,2023-10-24,9693
2352,佳世達,5,0,5,富邦-新營,2023-10-24,9693
2405,輔信,7,2,5,富邦-新營,2023-10-24,9693
5465,富驊,5,0,5,富邦-新營,2023-10-24,9693
6005,群益證,5,0,5,富邦-新營,2023-10-24,9693
6233,旺玖,5,0,5,富邦-新營,2023-10-24,9693
8110,華東,5,0,5,富邦-新營,2023-10-24,9693
9105,泰金寶-DR,5,0,5,富邦-新營,2023-10-24,9693
1603,華電,4,0,4,富邦-新營,2023-10-24,9693
2344,華邦電,4,0,4,富邦-新營,2023-10-24,9693
2436,偉詮電,4,0,4,富邦-新營,2023-10-24,9693
2892,第一金,4,0,4,富邦-新營,2023-10-24,9693
3706,神達,6,2,4,富邦-新營,2023-10-24,9693
6756,威鋒電子,4,0,4,富邦-新營,2023-10-24,9693
8176,智捷,5,1,4,富邦-新營,2023-10-24,9693
00679B,元大美債20年,4,0,4,富邦-新營,2023-10-24,9693
3715,定穎投控,7,3,4,富邦-新營,2023-10-24,9693
00637L,元大滬深300正2,3,0,3,富邦-新營,2023-10-24,9693
1303,南亞,3,0,3,富邦-新營,2023-10-24,9693
1584,精剛,3,0,3,富邦-新營,2023-10-24,9693
1799,易威,3,0,3,富邦-新營,2023-10-24,9693
2374,佳能,3,0,3,富邦-新營,2023-10-24,9693
2427,三商電,8,5,3,富邦-新營,2023-10-24,9693
3710,連展投控,3,0,3,富邦-新營,2023-10-24,9693
8110,華東,329,15,314,富邦-新營,2023-10-25,9693
2888,新光金,50,0,50,富邦-新營,2023-10-25,9693
2382,廣達,53,5,48,富邦-新營,2023-10-25,9693
8210,勤誠,82,34,48,富邦-新營,2023-10-25,9693
00712,復華富時不動產,36,0,36,富邦-新營,2023-10-25,9693
2002,中鋼,32,1,31,富邦-新營,2023-10-25,9693
6139,亞翔,63,34,29,富邦-新營,2023-10-25,9693
00878,國泰永續高股息,30,1,29,富邦-新營,2023-10-25,9693
2405,輔信,34,13,21,富邦-新營,2023-10-25,9693
00650L,復華香港正2,20,0,20,富邦-新營,2023-10-25,9693
2317,鴻海,23,5,18,富邦-新營,2023-10-25,9693
1324,地球,21,4,17,富邦-新營,2023-10-25,9693
00632R,元大台灣50反1,20,5,15,富邦-新營,2023-10-25,9693
2409,友達,14,1,13,富邦-新營,2023-10-25,9693
1314,中石化,17,5,12,富邦-新營,2023-10-25,9693
00679B,元大美債20年,15,3,12,富邦-新營,2023-10-25,9693
8112,至上,10,0,10,富邦-新營,2023-10-25,9693
00720B,元大投資級公司債,10,0,10,富邦-新營,2023-10-25,9693
6593,台灣銘板,10,0,10,富邦-新營,2023-10-25,9693
1514,亞力,15,6,9,富邦-新營,2023-10-25,9693
3450,聯鈞,18,9,9,富邦-新營,2023-10-25,9693
6443,元晶,10,1,9,富邦-新營,2023-10-25,9693
4162,智擎,16,7,9,富邦-新營,2023-10-25,9693
00919,群益台灣精選高息,17,9,8,富邦-新營,2023-10-25,9693
2313,華通,10,3,7,富邦-新營,2023-10-25,9693
2353,宏��,7,0,7,富邦-新營,2023-10-25,9693
2883,凱基金,9,2,7,富邦-新營,2023-10-25,9693
3374,精材,7,0,7,富邦-新營,2023-10-25,9693
3481,群創,10,3,7,富邦-新營,2023-10-25,9693
1471,首利,7,1,6,富邦-新營,2023-10-25,9693
3363,上詮,7,1,6,富邦-新營,2023-10-25,9693
2834,臺企銀,6,0,6,富邦-新營,2023-10-25,9693
0056,元大高股息,6,1,5,富邦-新營,2023-10-25,9693
1101,台泥,6,1,5,富邦-新營,2023-10-25,9693
020039,元大加權N,5,0,5,富邦-新營,2023-10-25,9693
00717,富邦美國特別股,5,0,5,富邦-新營,2023-10-25,9693
00888,永豐台灣ESG,5,0,5,富邦-新營,2023-10-25,9693
00902,中信電池及儲能,5,0,5,富邦-新營,2023-10-25,9693
2323,中環,5,0,5,富邦-新營,2023-10-25,9693
2355,敬鵬,5,0,5,富邦-新營,2023-10-25,9693
3041,揚智,23,18,5,富邦-新營,2023-10-25,9693
3051,力特,5,0,5,富邦-新營,2023-10-25,9693
6426,統新,6,1,5,富邦-新營,2023-10-25,9693
00915,凱基優選高股息30,5,0,5,富邦-新營,2023-10-25,9693
2886,兆豐金,5,1,4,富邦-新營,2023-10-25,9693
00713,元大台灣高息低波,4,0,4,富邦-新營,2023-10-25,9693
1605,華新,4,0,4,富邦-新營,2023-10-25,9693
2049,上銀,4,0,4,富邦-新營,2023-10-25,9693
2303,聯電,12,8,4,富邦-新營,2023-10-25,9693
2356,英業達,6,2,4,富邦-新營,2023-10-25,9693
3041,揚智,155,5,150,富邦-新營,2023-10-26,9693
00929,復華台灣科技優息,95,2,93,富邦-新營,2023-10-26,9693
2369,菱生,74,5,69,富邦-新營,2023-10-26,9693
2303,聯電,71,28,43,富邦-新營,2023-10-26,9693
00680L,元大美債20正2,41,0,41,富邦-新營,2023-10-26,9693
00712,復華富時不動產,34,0,34,富邦-新營,2023-10-26,9693
2344,華邦電,34,2,32,富邦-新營,2023-10-26,9693
2002,中鋼,29,0,29,富邦-新營,2023-10-26,9693
3709,鑫聯大投控,33,4,29,富邦-新營,2023-10-26,9693
2883,凱基金,28,1,27,富邦-新營,2023-10-26,9693
00688L,國泰20年美債正2,21,0,21,富邦-新營,2023-10-26,9693
00878,國泰永續高股息,19,0,19,富邦-新營,2023-10-26,9693
3032,偉訓,22,6,16,富邦-新營,2023-10-26,9693
3481,群創,18,3,15,富邦-新營,2023-10-26,9693
6117,迎廣,34,19,15,富邦-新營,2023-10-26,9693
2618,長榮航,14,0,14,富邦-新營,2023-10-26,9693
00679B,元大美債20年,14,1,13,富邦-新營,2023-10-26,9693
2337,旺宏,13,0,13,富邦-新營,2023-10-26,9693
2515,中工,20,7,13,富邦-新營,2023-10-26,9693
3290,東浦,14,1,13,富邦-新營,2023-10-26,9693
2330,台積電,13,0,13,富邦-新營,2023-10-26,9693
00919,群益台灣精選高息,15,3,12,富邦-新營,2023-10-26,9693
2498,宏達電,13,1,12,富邦-新營,2023-10-26,9693
00632R,元大台灣50反1,17,5,12,富邦-新營,2023-10-26,9693
6684,安格,12,1,11,富邦-新營,2023-10-26,9693
3037,欣興,15,5,10,富邦-新營,2023-10-26,9693
1533,車王電,10,0,10,富邦-新營,2023-10-26,9693
1789,神隆,10,0,10,富邦-新營,2023-10-26,9693
2427,三商電,13,3,10,富邦-新營,2023-10-26,9693
3265,台星科,10,0,10,富邦-新營,2023-10-26,9693
5439,高技,12,2,10,富邦-新營,2023-10-26,9693
5880,合庫金,10,0,10,富邦-新營,2023-10-26,9693
00885,富邦越南,9,0,9,富邦-新營,2023-10-26,9693
2317,鴻海,43,34,9,富邦-新營,2023-10-26,9693
2882,國泰金,8,0,8,富邦-新營,2023-10-26,9693
00900,富邦特選高股息30,7,0,7,富邦-新營,2023-10-26,9693
2201,裕隆,10,3,7,富邦-新營,2023-10-26,9693
2887,台新金,7,0,7,富邦-新營,2023-10-26,9693
3028,增你強,7,0,7,富邦-新營,2023-10-26,9693
00888,永豐台灣ESG,6,0,6,富邦-新營,2023-10-26,9693
1101,台泥,6,0,6,富邦-新營,2023-10-26,9693
1718,中纖,6,0,6,富邦-新營,2023-10-26,9693
3545,敦泰,6,0,6,富邦-新營,2023-10-26,9693
5321,美而快,6,0,6,富邦-新營,2023-10-26,9693
6550,北極星藥業-KY,7,1,6,富邦-新營,2023-10-26,9693
6796,晉弘,6,0,6,富邦-新營,2023-10-26,9693
0050,元大台灣50,6,0,6,富邦-新營,2023-10-26,9693
0056,元大高股息,8,2,6,富邦-新營,2023-10-26,9693
8069,元太,5,0,5,富邦-新營,2023-10-26,9693
00933B,國泰10Y+金融債,5,0,5,富邦-新營,2023-10-26,9693
3231,緯創,122,34,88,富邦-新營,2023-10-27,9693
6139,亞翔,114,36,78,富邦-新營,2023-10-27,9693
2883,凱基金,68,3,65,富邦-新營,2023-10-27,9693
00919,群益台灣精選高息,54,1,53,富邦-新營,2023-10-27,9693
00712,復華富時不動產,26,0,26,富邦-新營,2023-10-27,9693
8227,巨有科技,25,0,25,富邦-新營,2023-10-27,9693
00680L,元大美債20正2,20,0,20,富邦-新營,2023-10-27,9693
2329,華泰,20,0,20,富邦-新營,2023-10-27,9693
5460,同協,26,7,19,富邦-新營,2023-10-27,9693
00632R,元大台灣50反1,21,2,19,富邦-新營,2023-10-27,9693
1909,榮成,17,0,17,富邦-新營,2023-10-27,9693
2408,南亞科,16,0,16,富邦-新營,2023-10-27,9693
5905,南仁湖,15,0,15,富邦-新營,2023-10-27,9693
00885,富邦越南,14,0,14,富邦-新營,2023-10-27,9693
2543,皇昌,13,0,13,富邦-新營,2023-10-27,9693
2409,友達,12,0,12,富邦-新營,2023-10-27,9693
2462,良得電,13,1,12,富邦-新營,2023-10-27,9693
6442,光聖,17,5,12,富邦-新營,2023-10-27,9693
8358,金居,13,2,11,富邦-新營,2023-10-27,9693
2344,華邦電,11,0,11,富邦-新營,2023-10-27,9693
00929,復華台灣科技優息,63,53,10,富邦-新營,2023-10-27,9693
2707,晶華,10,0,10,富邦-新營,2023-10-27,9693
4168,醣聯,10,0,10,富邦-新營,2023-10-27,9693
6443,元晶,10,0,10,富邦-新營,2023-10-27,9693
6770,力積電,10,1,9,富邦-新營,2023-10-27,9693
00679B,元大美債20年,10,2,8,富邦-新營,2023-10-27,9693
00688L,國泰20年美債正2,12,5,7,富邦-新營,2023-10-27,9693
2812,台中銀,7,0,7,富邦-新營,2023-10-27,9693
3162,精確,8,1,7,富邦-新營,2023-10-27,9693
4908,前鼎,16,9,7,富邦-新營,2023-10-27,9693
6593,台灣銘板,9,2,7,富邦-新營,2023-10-27,9693
2317,鴻海,6,0,6,富邦-新營,2023-10-27,9693
1584,精剛,8,2,6,富邦-新營,2023-10-27,9693
1718,中纖,6,0,6,富邦-新營,2023-10-27,9693
2340,台亞,6,0,6,富邦-新營,2023-10-27,9693
6237,驊訊,12,6,6,富邦-新營,2023-10-27,9693
6257,矽格,6,0,6,富邦-新營,2023-10-27,9693
6499,益安,6,0,6,富邦-新營,2023-10-27,9693
2206,三陽工業,5,0,5,富邦-新營,2023-10-27,9693
2002,中鋼,5,0,5,富邦-新營,2023-10-27,9693
1440,南紡,5,0,5,富邦-新營,2023-10-27,9693
00642U,期元大S＆P石油,5,0,5,富邦-新營,2023-10-27,9693
00717,富邦美國特別股,5,0,5,富邦-新營,2023-10-27,9693
2014,中鴻,5,0,5,富邦-新營,2023-10-27,9693
2355,敬鵬,5,0,5,富邦-新營,2023-10-27,9693
2356,英業達,6,1,5,富邦-新營,2023-10-27,9693
2603,長榮,10,5,5,富邦-新營,2023-10-27,9693
2887,台新金,5,0,5,富邦-新營,2023-10-27,9693
3499,環天科,5,0,5,富邦-新營,2023-10-27,9693
3545,敦泰,5,0,5,富邦-新營,2023-10-27,9693
4979,華星光,105,5,100,富邦-新營,2023-10-30,9693
5258,虹堡,51,2,49,富邦-新營,2023-10-30,9693
3715,定穎投控,49,11,38,富邦-新營,2023-10-30,9693
6117,迎廣,52,18,34,富邦-新營,2023-10-30,9693
00679B,元大美債20年,31,0,31,富邦-新營,2023-10-30,9693
1101,台泥,28,1,27,富邦-新營,2023-10-30,9693
8110,華東,30,5,25,富邦-新營,2023-10-30,9693
2485,兆赫,28,4,24,富邦-新營,2023-10-30,9693
2317,鴻海,75,52,23,富邦-新營,2023-10-30,9693
2515,中工,35,12,23,富邦-新營,2023-10-30,9693
9105,泰金寶-DR,22,0,22,富邦-新營,2023-10-30,9693
2603,長榮,30,8,22,富邦-新營,2023-10-30,9693
2615,萬海,20,0,20,富邦-新營,2023-10-30,9693
2609,陽明,21,5,16,富邦-新營,2023-10-30,9693
00878,國泰永續高股息,14,1,13,富邦-新營,2023-10-30,9693
3576,聯合再生,22,9,13,富邦-新營,2023-10-30,9693
2891,中信金,12,0,12,富邦-新營,2023-10-30,9693
2886,兆豐金,11,0,11,富邦-新營,2023-10-30,9693
1314,中石化,10,0,10,富邦-新營,2023-10-30,9693
00680L,元大美債20正2,10,0,10,富邦-新營,2023-10-30,9693
5347,世界,10,0,10,富邦-新營,2023-10-30,9693
5905,南仁湖,10,0,10,富邦-新營,2023-10-30,9693
6189,豐藝,10,0,10,富邦-新營,2023-10-30,9693
3176,基亞,10,1,9,富邦-新營,2023-10-30,9693
2356,英業達,9,1,8,富邦-新營,2023-10-30,9693
00633L,富邦上証正2,13,5,8,富邦-新營,2023-10-30,9693
00885,富邦越南,7,0,7,富邦-新營,2023-10-30,9693
1303,南亞,7,0,7,富邦-新營,2023-10-30,9693
2390,云辰,15,8,7,富邦-新營,2023-10-30,9693
00929,復華台灣科技優息,17,11,6,富邦-新營,2023-10-30,9693
00933B,國泰10Y+金融債,6,0,6,富邦-新營,2023-10-30,9693
2337,旺宏,6,0,6,富邦-新營,2023-10-30,9693
5465,富驊,6,0,6,富邦-新營,2023-10-30,9693
5876,上海商銀,6,0,6,富邦-新營,2023-10-30,9693
1718,中纖,5,0,5,富邦-新營,2023-10-30,9693
2887,台新金,5,0,5,富邦-新營,2023-10-30,9693
00923,群益台ESG低碳50,5,0,5,富邦-新營,2023-10-30,9693
00688L,國泰20年美債正2,5,0,5,富邦-新營,2023-10-30,9693
2610,華航,5,0,5,富邦-新營,2023-10-30,9693
4532,瑞智,5,0,5,富邦-新營,2023-10-30,9693
4906,正文,5,0,5,富邦-新營,2023-10-30,9693
4909,新復興,5,0,5,富邦-新營,2023-10-30,9693
5512,力麒,5,0,5,富邦-新營,2023-10-30,9693
5880,合庫金,5,0,5,富邦-新營,2023-10-30,9693
00720B,元大投資級公司債,4,0,4,富邦-新營,2023-10-30,9693
3231,緯創,9,5,4,富邦-新營,2023-10-30,9693
1301,台塑,4,0,4,富邦-新營,2023-10-30,9693
00900,富邦特選高股息30,4,0,4,富邦-新營,2023-10-30,9693
1568,倉佑,5,1,4,富邦-新營,2023-10-30,9693
1609,大亞,4,0,4,富邦-新營,2023-10-30,9693
00712,復華富時不動產,60,0,60,富邦-新營,2023-10-31,9693
3033,威健,51,0,51,富邦-新營,2023-10-31,9693
00878,國泰永續高股息,44,3,41,富邦-新營,2023-10-31,9693
2002,中鋼,40,0,40,富邦-新營,2023-10-31,9693
00632R,元大台灣50反1,306,270,36,富邦-新營,2023-10-31,9693
0056,元大高股息,28,1,27,富邦-新營,2023-10-31,9693
2356,英業達,25,0,25,富邦-新營,2023-10-31,9693
2465,麗臺,30,6,24,富邦-新營,2023-10-31,9693
1101,台泥,27,3,24,富邦-新營,2023-10-31,9693
00919,群益台灣精選高息,24,0,24,富邦-新營,2023-10-31,9693
2006,東和鋼鐵,24,2,22,富邦-新營,2023-10-31,9693
4108,懷特,21,1,20,富邦-新營,2023-10-31,9693
00753L,中信中國50正2,15,0,15,富邦-新營,2023-10-31,9693
2344,華邦電,19,5,14,富邦-新營,2023-10-31,9693
2347,聯強,15,1,14,富邦-新營,2023-10-31,9693
3481,群創,15,3,12,富邦-新營,2023-10-31,9693
2498,宏達電,14,2,12,富邦-新營,2023-10-31,9693
00885,富邦越南,11,0,11,富邦-新營,2023-10-31,9693
2516,新建,11,0,11,富邦-新營,2023-10-31,9693
2201,裕隆,14,4,10,富邦-新營,2023-10-31,9693
00662,富邦NASDAQ,10,0,10,富邦-新營,2023-10-31,9693
1229,聯華,10,0,10,富邦-新營,2023-10-31,9693
1789,神隆,10,0,10,富邦-新營,2023-10-31,9693
2105,正新,10,0,10,富邦-新營,2023-10-31,9693
2449,京元電子,16,6,10,富邦-新營,2023-10-31,9693
3027,盛達,10,0,10,富邦-新營,2023-10-31,9693
6153,嘉聯益,10,0,10,富邦-新營,2023-10-31,9693
1718,中纖,9,0,9,富邦-新營,2023-10-31,9693
2427,三商電,112,103,9,富邦-新營,2023-10-31,9693
4529,淳紳,10,2,8,富邦-新營,2023-10-31,9693
6550,北極星藥業-KY,8,0,8,富邦-新營,2023-10-31,9693
1314,中石化,13,6,7,富邦-新營,2023-10-31,9693
1513,中興電,10,3,7,富邦-新營,2023-10-31,9693
00893,國泰智能電動車,7,0,7,富邦-新營,2023-10-31,9693
00902,中信電池及儲能,7,0,7,富邦-新營,2023-10-31,9693
1524,耿鼎,95,88,7,富邦-新營,2023-10-31,9693
1618,合機,12,5,7,富邦-新營,2023-10-31,9693
2337,旺宏,9,2,7,富邦-新營,2023-10-31,9693
2834,臺企銀,7,0,7,富邦-新營,2023-10-31,9693
4906,正文,7,0,7,富邦-新營,2023-10-31,9693
6191,精成科,12,5,7,富邦-新營,2023-10-31,9693
6282,康舒,6,0,6,富邦-新營,2023-10-31,9693
00922,國泰台灣領袖50,6,0,6,富邦-新營,2023-10-31,9693
2301,光寶科,6,0,6,富邦-新營,2023-10-31,9693
2363,矽統,7,1,6,富邦-新營,2023-10-31,9693
2371,大同,7,1,6,富邦-新營,2023-10-31,9693
3567,逸昌,7,1,6,富邦-新營,2023-10-31,9693
4960,誠美材,8,2,6,富邦-新營,2023-10-31,9693
6657,華安,6,0,6,富邦-新營,2023-10-31,9693
8429,金麗-KY,6,0,6,富邦-新營,2023-10-31,9693
00934,中信成長高股息,164,19,145,富邦-新營,2023-11-01,9693
00929,復華台灣科技優息,130,2,128,富邦-新營,2023-11-01,9693
00712,復華富時不動產,42,0,42,富邦-新營,2023-11-01,9693
00878,國泰永續高股息,41,0,41,富邦-新營,2023-11-01,9693
9105,泰金寶-DR,25,0,25,富邦-新營,2023-11-01,9693
2369,菱生,20,0,20,富邦-新營,2023-11-01,9693
2405,輔信,24,5,19,富邦-新營,2023-11-01,9693
6285,啟��,18,0,18,富邦-新營,2023-11-01,9693
3686,達能,16,0,16,富邦-新營,2023-11-01,9693
00737,國泰AI+Robo,15,0,15,富邦-新營,2023-11-01,9693
00679B,元大美債20年,15,0,15,富邦-新營,2023-11-01,9693
3704,合勤控,19,5,14,富邦-新營,2023-11-01,9693
00632R,元大台灣50反1,112,100,12,富邦-新營,2023-11-01,9693
2409,友達,10,0,10,富邦-新營,2023-11-01,9693
00933B,國泰10Y+金融債,10,0,10,富邦-新營,2023-11-01,9693
3231,緯創,20,10,10,富邦-新營,2023-11-01,9693
00680L,元大美債20正2,10,0,10,富邦-新營,2023-11-01,9693
3058,立德,10,0,10,富邦-新營,2023-11-01,9693
6213,聯茂,10,0,10,富邦-新營,2023-11-01,9693
2337,旺宏,12,3,9,富邦-新營,2023-11-01,9693
2886,兆豐金,10,2,8,富邦-新營,2023-11-01,9693
00715L,期街口布蘭特正2,8,0,8,富邦-新營,2023-11-01,9693
2363,矽統,10,2,8,富邦-新營,2023-11-01,9693
2516,新建,8,0,8,富邦-新營,2023-11-01,9693
5880,合庫金,8,0,8,富邦-新營,2023-11-01,9693
00919,群益台灣精選高息,10,2,8,富邦-新營,2023-11-01,9693
00751B,元大AAA至A公司債,7,0,7,富邦-新營,2023-11-01,9693
2884,玉山金,6,0,6,富邦-新營,2023-11-01,9693
2317,鴻海,8,3,5,富邦-新營,2023-11-01,9693
2610,華航,7,2,5,富邦-新營,2023-11-01,9693
00688L,國泰20年美債正2,5,0,5,富邦-新營,2023-11-01,9693
2105,正新,6,1,5,富邦-新營,2023-11-01,9693
2485,兆赫,6,1,5,富邦-新營,2023-11-01,9693
5469,瀚宇博,6,1,5,富邦-新營,2023-11-01,9693
2834,臺企銀,4,0,4,富邦-新營,2023-11-01,9693
2406,國碩,4,0,4,富邦-新營,2023-11-01,9693
2892,第一金,4,0,4,富邦-新營,2023-11-01,9693
4743,合一,3,0,3,富邦-新營,2023-11-01,9693
2382,廣達,9,6,3,富邦-新營,2023-11-01,9693
9921,巨大,3,0,3,富邦-新營,2023-11-01,9693
00738U,期元大道瓊白銀,3,0,3,富邦-新營,2023-11-01,9693
2436,偉詮電,3,0,3,富邦-新營,2023-11-01,9693
2637,慧洋-KY,3,0,3,富邦-新營,2023-11-01,9693
2641,正德,6,3,3,富邦-新營,2023-11-01,9693
2897,王道銀行,3,0,3,富邦-新營,2023-11-01,9693
3105,穩懋,14,11,3,富邦-新營,2023-11-01,9693
3122,笙泉,3,0,3,富邦-新營,2023-11-01,9693
3260,威剛,20,17,3,富邦-新營,2023-11-01,9693
3588,通嘉,3,0,3,富邦-新營,2023-11-01,9693
3596,智易,3,0,3,富邦-新營,2023-11-01,9693
00715L,期街口布蘭特正2,1700,50,1650,富邦-新營,2023-11-02,9693
00687B,國泰20年美債,100,1,99,富邦-新營,2023-11-02,9693
00934,中信成長高股息,54,1,53,富邦-新營,2023-11-02,9693
2883,凱基金,26,0,26,富邦-新營,2023-11-02,9693
4979,華星光,20,0,20,富邦-新營,2023-11-02,9693
3013,晟銘電,20,1,19,富邦-新營,2023-11-02,9693
00929,復華台灣科技優息,121,102,19,富邦-新營,2023-11-02,9693
00712,復華富時不動產,19,0,19,富邦-新營,2023-11-02,9693
1305,華夏,15,0,15,富邦-新營,2023-11-02,9693
1455,集盛,15,0,15,富邦-新營,2023-11-02,9693
1524,耿鼎,22,8,14,富邦-新營,2023-11-02,9693
2449,京元電子,13,2,11,富邦-新營,2023-11-02,9693
3078,僑威,12,1,11,富邦-新營,2023-11-02,9693
2020,美亞,10,0,10,富邦-新營,2023-11-02,9693
2439,美律,10,0,10,富邦-新營,2023-11-02,9693
2515,中工,10,0,10,富邦-新營,2023-11-02,9693
4934,太極,10,0,10,富邦-新營,2023-11-02,9693
5905,南仁湖,10,0,10,富邦-新營,2023-11-02,9693
6219,富旺,10,0,10,富邦-新營,2023-11-02,9693
00662,富邦NASDAQ,10,0,10,富邦-新營,2023-11-02,9693
00878,國泰永續高股息,14,5,9,富邦-新營,2023-11-02,9693
1718,中纖,9,0,9,富邦-新營,2023-11-02,9693
1440,南紡,8,0,8,富邦-新營,2023-11-02,9693
00679B,元大美債20年,7,0,7,富邦-新營,2023-11-02,9693
3264,欣銓,12,5,7,富邦-新營,2023-11-02,9693
2317,鴻海,9,2,7,富邦-新營,2023-11-02,9693
1515,力山,6,0,6,富邦-新營,2023-11-02,9693
2376,技嘉,10,4,6,富邦-新營,2023-11-02,9693
2485,兆赫,8,2,6,富邦-新營,2023-11-02,9693
6220,岳豐,6,0,6,富邦-新營,2023-11-02,9693
00885,富邦越南,7,2,5,富邦-新營,2023-11-02,9693
00680L,元大美債20正2,5,0,5,富邦-新營,2023-11-02,9693
00655L,國泰中國A50正2,5,0,5,富邦-新營,2023-11-02,9693
00720B,元大投資級公司債,5,0,5,富邦-新營,2023-11-02,9693
2367,燿華,7,2,5,富邦-新營,2023-11-02,9693
2915,潤泰全,5,0,5,富邦-新營,2023-11-02,9693
5234,達興材料,5,0,5,富邦-新營,2023-11-02,9693
00713,元大台灣高息低波,5,0,5,富邦-新營,2023-11-02,9693
00919,群益台灣精選高息,5,1,4,富邦-新營,2023-11-02,9693
2834,臺企銀,6,2,4,富邦-新營,2023-11-02,9693
1314,中石化,11,7,4,富邦-新營,2023-11-02,9693
1584,精剛,8,4,4,富邦-新營,2023-11-02,9693
5434,崇越,4,0,4,富邦-新營,2023-11-02,9693
6187,萬潤,4,0,4,富邦-新營,2023-11-02,9693
1303,南亞,5,1,4,富邦-新營,2023-11-02,9693
0056,元大高股息,13,9,4,富邦-新營,2023-11-02,9693
2206,三陽工業,4,0,4,富邦-新營,2023-11-02,9693
2457,飛宏,5,2,3,富邦-新營,2023-11-02,9693
9939,宏全,3,0,3,富邦-新營,2023-11-02,9693
00735,國泰臺韓科技,3,0,3,富邦-新營,2023-11-02,9693
00929,復華台灣科技優息,71,7,64,富邦-新營,2023-11-03,9693
00934,中信成長高股息,45,6,39,富邦-新營,2023-11-03,9693
3322,建舜電,48,14,34,富邦-新營,2023-11-03,9693
00679B,元大美債20年,38,4,34,富邦-新營,2023-11-03,9693
2436,偉詮電,30,0,30,富邦-新營,2023-11-03,9693
2363,矽統,127,98,29,富邦-新營,2023-11-03,9693
2344,華邦電,33,5,28,富邦-新營,2023-11-03,9693
00878,國泰永續高股息,30,5,25,富邦-新營,2023-11-03,9693
2317,鴻海,32,10,22,富邦-新營,2023-11-03,9693
6290,良維,22,0,22,富邦-新營,2023-11-03,9693
2002,中鋼,24,3,21,富邦-新營,2023-11-03,9693
2374,佳能,20,0,20,富邦-新營,2023-11-03,9693
6190,萬泰科,19,0,19,富邦-新營,2023-11-03,9693
1101,台泥,18,2,16,富邦-新營,2023-11-03,9693
2382,廣達,17,2,15,富邦-新營,2023-11-03,9693
2609,陽明,20,6,14,富邦-新營,2023-11-03,9693
1720,生達,11,0,11,富邦-新營,2023-11-03,9693
5351,鈺創,11,0,11,富邦-新營,2023-11-03,9693
6156,松上,12,1,11,富邦-新營,2023-11-03,9693
3055,蔚華科,11,1,10,富邦-新營,2023-11-03,9693
3090,日電貿,10,0,10,富邦-新營,2023-11-03,9693
3703,欣陸,10,0,10,富邦-新營,2023-11-03,9693
3163,波若威,12,3,9,富邦-新營,2023-11-03,9693
2458,義隆,9,1,8,富邦-新營,2023-11-03,9693
1314,中石化,8,0,8,富邦-新營,2023-11-03,9693
2543,皇昌,8,0,8,富邦-新營,2023-11-03,9693
00687B,國泰20年美債,11,4,7,富邦-新營,2023-11-03,9693
2356,英業達,10,3,7,富邦-新營,2023-11-03,9693
3217,優群,8,1,7,富邦-新營,2023-11-03,9693
1815,富喬,20,14,6,富邦-新營,2023-11-03,9693
2399,映泰,7,1,6,富邦-新營,2023-11-03,9693
3545,敦泰,6,0,6,富邦-新營,2023-11-03,9693
8086,宏捷科,11,5,6,富邦-新營,2023-11-03,9693
8176,智捷,6,0,6,富邦-新營,2023-11-03,9693
8215,明基材,6,0,6,富邦-新營,2023-11-03,9693
1217,愛之味,6,1,5,富邦-新營,2023-11-03,9693
1568,倉佑,9,4,5,富邦-新營,2023-11-03,9693
2371,大同,5,0,5,富邦-新營,2023-11-03,9693
2515,中工,10,5,5,富邦-新營,2023-11-03,9693
2867,三商壽,5,0,5,富邦-新營,2023-11-03,9693
3294,英濟,5,0,5,富邦-新營,2023-11-03,9693
00919,群益台灣精選高息,4,0,4,富邦-新營,2023-11-03,9693
3704,合勤控,5,1,4,富邦-新營,2023-11-03,9693
1711,永光,4,0,4,富邦-新營,2023-11-03,9693
2332,友訊,5,1,4,富邦-新營,2023-11-03,9693
2353,宏��,4,0,4,富邦-新營,2023-11-03,9693
2441,超豐,4,0,4,富邦-新營,2023-11-03,9693
2516,新建,4,0,4,富邦-新營,2023-11-03,9693
8150,南茂,3,0,3,富邦-新營,2023-11-03,9693
00921,兆豐龍頭等權重,3,0,3,富邦-新營,2023-11-03,9693
2913,農林,67,3,64,富邦-新營,2023-11-06,9693
2610,華航,70,8,62,富邦-新營,2023-11-06,9693
2883,凱基金,64,17,47,富邦-新營,2023-11-06,9693
4967,十銓,61,15,46,富邦-新營,2023-11-06,9693
00878,國泰永續高股息,43,2,41,富邦-新營,2023-11-06,9693
2303,聯電,41,7,34,富邦-新營,2023-11-06,9693
00679B,元大美債20年,34,3,31,富邦-新營,2023-11-06,9693
8210,勤誠,30,10,20,富邦-新營,2023-11-06,9693
1313,聯成,20,0,20,富邦-新營,2023-11-06,9693
6530,創威,21,1,20,富邦-新營,2023-11-06,9693
1802,台玻,20,2,18,富邦-新營,2023-11-06,9693
00715L,期街口布蘭特正2,16,0,16,富邦-新營,2023-11-06,9693
00680L,元大美債20正2,15,0,15,富邦-新營,2023-11-06,9693
8069,元太,14,1,13,富邦-新營,2023-11-06,9693
1440,南紡,12,0,12,富邦-新營,2023-11-06,9693
2889,國票金,12,0,12,富邦-新營,2023-11-06,9693
3704,合勤控,15,4,11,富邦-新營,2023-11-06,9693
00687B,國泰20年美債,15,4,11,富邦-新營,2023-11-06,9693
2388,威盛,25,14,11,富邦-新營,2023-11-06,9693
2002,中鋼,14,4,10,富邦-新營,2023-11-06,9693
00934,中信成長高股息,38,28,10,富邦-新營,2023-11-06,9693
2421,建準,13,3,10,富邦-新營,2023-11-06,9693
2890,永豐金,10,0,10,富邦-新營,2023-11-06,9693
3058,立德,10,0,10,富邦-新營,2023-11-06,9693
9105,泰金寶-DR,10,0,10,富邦-新營,2023-11-06,9693
1101,台泥,10,1,9,富邦-新營,2023-11-06,9693
2204,中華,10,1,9,富邦-新營,2023-11-06,9693
4542,科嶠,12,3,9,富邦-新營,2023-11-06,9693
4938,和碩,10,1,9,富邦-新營,2023-11-06,9693
00633L,富邦上証正2,8,0,8,富邦-新營,2023-11-06,9693
1504,東元,8,0,8,富邦-新營,2023-11-06,9693
2465,麗臺,8,0,8,富邦-新營,2023-11-06,9693
00902,中信電池及儲能,10,3,7,富邦-新營,2023-11-06,9693
2486,一詮,7,0,7,富邦-新營,2023-11-06,9693
00713,元大台灣高息低波,6,0,6,富邦-新營,2023-11-06,9693
2020,美亞,6,0,6,富邦-新營,2023-11-06,9693
5880,合庫金,6,0,6,富邦-新營,2023-11-06,9693
00751B,元大AAA至A公司債,5,0,5,富邦-新營,2023-11-06,9693
2017,官田鋼,5,0,5,富邦-新營,2023-11-06,9693
2641,正德,7,2,5,富邦-新營,2023-11-06,9693
6121,新普,5,0,5,富邦-新營,2023-11-06,9693
2301,光寶科,5,0,5,富邦-新營,2023-11-06,9693
6223,旺矽,4,0,4,富邦-新營,2023-11-06,9693
1513,中興電,5,1,4,富邦-新營,2023-11-06,9693
00935,野村臺灣新科技50,4,0,4,富邦-新營,2023-11-06,9693
1514,亞力,4,0,4,富邦-新營,2023-11-06,9693
5371,中光電,4,0,4,富邦-新營,2023-11-06,9693
3032,偉訓,4,0,4,富邦-新營,2023-11-06,9693
2376,技嘉,28,25,3,富邦-新營,2023-11-06,9693
00688L,國泰20年美債正2,3,0,3,富邦-新營,2023-11-06,9693
2344,華邦電,31,0,31,富邦-新營,2023-11-07,9693
2883,凱基金,28,1,27,富邦-新營,2023-11-07,9693
3704,合勤控,24,2,22,富邦-新營,2023-11-07,9693
2482,連宇,20,0,20,富邦-新營,2023-11-07,9693
2498,宏達電,19,1,18,富邦-新營,2023-11-07,9693
00680L,元大美債20正2,16,0,16,富邦-新營,2023-11-07,9693
2739,寒舍,17,2,15,富邦-新營,2023-11-07,9693
2889,國票金,15,0,15,富邦-新營,2023-11-07,9693
6116,彩晶,13,0,13,富邦-新營,2023-11-07,9693
2317,鴻海,14,1,13,富邦-新營,2023-11-07,9693
2312,金寶,12,0,12,富邦-新營,2023-11-07,9693
00687B,國泰20年美債,11,0,11,富邦-新營,2023-11-07,9693
00934,中信成長高股息,14,3,11,富邦-新營,2023-11-07,9693
2408,南亞科,14,4,10,富邦-新營,2023-11-07,9693
2610,華航,31,21,10,富邦-新營,2023-11-07,9693
2736,富野,27,17,10,富邦-新營,2023-11-07,9693
2888,新光金,10,0,10,富邦-新營,2023-11-07,9693
3033,威健,10,0,10,富邦-新營,2023-11-07,9693
3372,典範,10,0,10,富邦-新營,2023-11-07,9693
4168,醣聯,10,0,10,富邦-新營,2023-11-07,9693
2359,所羅門,9,0,9,富邦-新營,2023-11-07,9693
8210,勤誠,13,4,9,富邦-新營,2023-11-07,9693
2453,凌群,8,0,8,富邦-新營,2023-11-07,9693
2634,漢翔,12,5,7,富邦-新營,2023-11-07,9693
1584,精剛,7,0,7,富邦-新營,2023-11-07,9693
2369,菱生,8,1,7,富邦-新營,2023-11-07,9693
2887,台新金,7,0,7,富邦-新營,2023-11-07,9693
3032,偉訓,7,0,7,富邦-新營,2023-11-07,9693
3363,上詮,7,0,7,富邦-新營,2023-11-07,9693
6182,合晶,7,0,7,富邦-新營,2023-11-07,9693
2451,創見,8,1,7,富邦-新營,2023-11-07,9693
2002,中鋼,9,2,7,富邦-新營,2023-11-07,9693
00919,群益台灣精選高息,8,2,6,富邦-新營,2023-11-07,9693
00878,國泰永續高股息,7,1,6,富邦-新營,2023-11-07,9693
1721,三晃,7,1,6,富邦-新營,2023-11-07,9693
2734,易飛網,6,0,6,富邦-新營,2023-11-07,9693
3094,聯傑,6,0,6,富邦-新營,2023-11-07,9693
6806,森崴能源,8,2,6,富邦-新營,2023-11-07,9693
1101,台泥,7,1,6,富邦-新營,2023-11-07,9693
00633L,富邦上証正2,5,0,5,富邦-新營,2023-11-07,9693
1565,精華,5,0,5,富邦-新營,2023-11-07,9693
1785,光洋科,5,0,5,富邦-新營,2023-11-07,9693
1809,中釉,5,0,5,富邦-新營,2023-11-07,9693
2025,千興,5,0,5,富邦-新營,2023-11-07,9693
2401,凌陽,19,14,5,富邦-新營,2023-11-07,9693
2603,長榮,5,0,5,富邦-新營,2023-11-07,9693
3265,台星科,5,0,5,富邦-新營,2023-11-07,9693
3454,晶睿,5,0,5,富邦-新營,2023-11-07,9693
8110,華東,5,0,5,富邦-新營,2023-11-07,9693
9955,佳龍,5,0,5,富邦-新營,2023-11-07,9693
00936,台新永續高息中小,242,60,182,富邦-新營,2023-11-08,9693
00673R,期元大S＆P原油反1,155,5,150,富邦-新營,2023-11-08,9693
3217,優群,86,16,70,富邦-新營,2023-11-08,9693
2618,長榮航,33,4,29,富邦-新營,2023-11-08,9693
8093,保銳,25,1,24,富邦-新營,2023-11-08,9693
4938,和碩,23,0,23,富邦-新營,2023-11-08,9693
4167,松瑞藥,23,1,22,富邦-新營,2023-11-08,9693
2538,基泰,20,0,20,富邦-新營,2023-11-08,9693
8210,勤誠,23,5,18,富邦-新營,2023-11-08,9693
00934,中信成長高股息,16,1,15,富邦-新營,2023-11-08,9693
3032,偉訓,14,0,14,富邦-新營,2023-11-08,9693
6901,鑽石投資,21,7,14,富邦-新營,2023-11-08,9693
00680L,元大美債20正2,11,0,11,富邦-新營,2023-11-08,9693
2313,華通,11,0,11,富邦-新營,2023-11-08,9693
00920,富邦ESG綠色電力,10,0,10,富邦-新營,2023-11-08,9693
00676R,富邦臺灣加權反1,10,0,10,富邦-新營,2023-11-08,9693
00696B,富邦美債20年,10,0,10,富邦-新營,2023-11-08,9693
2515,中工,10,2,8,富邦-新營,2023-11-08,9693
1731,美吾華,7,0,7,富邦-新營,2023-11-08,9693
2353,宏��,10,3,7,富邦-新營,2023-11-08,9693
4108,懷特,7,0,7,富邦-新營,2023-11-08,9693
6432,今展科,7,0,7,富邦-新營,2023-11-08,9693
2002,中鋼,6,0,6,富邦-新營,2023-11-08,9693
00712,復華富時不動產,12,6,6,富邦-新營,2023-11-08,9693
00935,野村臺灣新科技50,6,0,6,富邦-新營,2023-11-08,9693
2347,聯強,6,0,6,富邦-新營,2023-11-08,9693
2425,承啟,6,0,6,富邦-新營,2023-11-08,9693
2488,漢平,6,0,6,富邦-新營,2023-11-08,9693
2516,新建,6,0,6,富邦-新營,2023-11-08,9693
3346,麗清,6,0,6,富邦-新營,2023-11-08,9693
4128,中天,27,21,6,富邦-新營,2023-11-08,9693
00882,中信中國高股息,5,0,5,富邦-新營,2023-11-08,9693
00664R,國泰臺灣加權反1,5,0,5,富邦-新營,2023-11-08,9693
1522,堤維西,5,0,5,富邦-新營,2023-11-08,9693
3545,敦泰,10,5,5,富邦-新營,2023-11-08,9693
6288,聯嘉,5,0,5,富邦-新營,2023-11-08,9693
6546,正基,5,0,5,富邦-新營,2023-11-08,9693
8905,裕國,5,0,5,富邦-新營,2023-11-08,9693
9950,萬國通,5,0,5,富邦-新營,2023-11-08,9693
2609,陽明,4,0,4,富邦-新營,2023-11-08,9693
3702,大聯大,6,2,4,富邦-新營,2023-11-08,9693
00688L,國泰20年美債正2,4,0,4,富邦-新營,2023-11-08,9693
00642U,期元大S＆P石油,4,0,4,富邦-新營,2023-11-08,9693
1504,東元,4,0,4,富邦-新營,2023-11-08,9693
2014,中鴻,4,0,4,富邦-新營,2023-11-08,9693
2388,威盛,17,13,4,富邦-新營,2023-11-08,9693
2401,凌陽,7,3,4,富邦-新營,2023-11-08,9693
2419,仲琦,4,0,4,富邦-新營,2023-11-08,9693
2453,凌群,4,0,4,富邦-新營,2023-11-08,9693
3567,逸昌,4,0,4,富邦-新營,2023-11-08,9693
00679B,元大美債20年,38,1,37,富邦-新營,2023-11-09,9693
6189,豐藝,34,0,34,富邦-新營,2023-11-09,9693
6901,鑽石投資,38,4,34,富邦-新營,2023-11-09,9693
2332,友訊,32,0,32,富邦-新營,2023-11-09,9693
00936,台新永續高息中小,52,20,32,富邦-新營,2023-11-09,9693
00676R,富邦臺灣加權反1,40,10,30,富邦-新營,2023-11-09,9693
2356,英業達,33,8,25,富邦-新營,2023-11-09,9693
00929,復華台灣科技優息,31,8,23,富邦-新營,2023-11-09,9693
8210,勤誠,27,4,23,富邦-新營,2023-11-09,9693
00688L,國泰20年美債正2,22,0,22,富邦-新營,2023-11-09,9693
2610,華航,20,0,20,富邦-新營,2023-11-09,9693
00669R,國泰美國道瓊反1,20,0,20,富邦-新營,2023-11-09,9693
6593,台灣銘板,20,0,20,富邦-新營,2023-11-09,9693
2329,華泰,19,1,18,富邦-新營,2023-11-09,9693
2344,華邦電,18,0,18,富邦-新營,2023-11-09,9693
2331,精英,16,0,16,富邦-新營,2023-11-09,9693
2390,云辰,16,0,16,富邦-新營,2023-11-09,9693
3013,晟銘電,19,3,16,富邦-新營,2023-11-09,9693
2363,矽統,63,47,16,富邦-新營,2023-11-09,9693
00878,國泰永續高股息,15,0,15,富邦-新營,2023-11-09,9693
6219,富旺,20,7,13,富邦-新營,2023-11-09,9693
00919,群益台灣精選高息,13,1,12,富邦-新營,2023-11-09,9693
6541,泰福-KY,12,0,12,富邦-新營,2023-11-09,9693
00686R,群益臺灣加權反1,10,0,10,富邦-新營,2023-11-09,9693
3704,合勤控,12,3,9,富邦-新營,2023-11-09,9693
4119,旭富,9,0,9,富邦-新營,2023-11-09,9693
2427,三商電,8,0,8,富邦-新營,2023-11-09,9693
00877,復華中國5G,8,0,8,富邦-新營,2023-11-09,9693
2449,京元電子,11,3,8,富邦-新營,2023-11-09,9693
8163,達方,9,1,8,富邦-新營,2023-11-09,9693
9911,櫻花,8,0,8,富邦-新營,2023-11-09,9693
2634,漢翔,10,3,7,富邦-新營,2023-11-09,9693
3122,笙泉,13,6,7,富邦-新營,2023-11-09,9693
9955,佳龍,7,0,7,富邦-新營,2023-11-09,9693
2419,仲琦,6,0,6,富邦-新營,2023-11-09,9693
2537,聯上發,6,0,6,富邦-新營,2023-11-09,9693
3702,大聯大,6,1,5,富邦-新營,2023-11-09,9693
2609,陽明,6,1,5,富邦-新營,2023-11-09,9693
00664R,國泰臺灣加權反1,5,0,5,富邦-新營,2023-11-09,9693
00633L,富邦上証正2,6,1,5,富邦-新營,2023-11-09,9693
00632R,元大台灣50反1,5,0,5,富邦-新營,2023-11-09,9693
1591,駿吉-KY,5,0,5,富邦-新營,2023-11-09,9693
1731,美吾華,5,0,5,富邦-新營,2023-11-09,9693
2387,精元,5,0,5,富邦-新營,2023-11-09,9693
3051,力特,5,0,5,富邦-新營,2023-11-09,9693
5905,南仁湖,5,0,5,富邦-新營,2023-11-09,9693
6170,統振,5,0,5,富邦-新營,2023-11-09,9693
6527,明達醫,5,0,5,富邦-新營,2023-11-09,9693
8227,巨有科技,10,5,5,富邦-新營,2023-11-09,9693
8255,朋程,5,0,5,富邦-新營,2023-11-09,9693
00632R,元大台灣50反1,272,0,272,富邦-新營,2023-11-10,9693
2610,華航,105,2,103,富邦-新營,2023-11-10,9693
00935,野村臺灣新科技50,100,0,100,富邦-新營,2023-11-10,9693
00713,元大台灣高息低波,65,0,65,富邦-新營,2023-11-10,9693
00936,台新永續高息中小,53,1,52,富邦-新營,2023-11-10,9693
00878,國泰永續高股息,46,2,44,富邦-新營,2023-11-10,9693
3231,緯創,73,38,35,富邦-新營,2023-11-10,9693
3176,基亞,26,0,26,富邦-新營,2023-11-10,9693
6605,帝寶,20,0,20,富邦-新營,2023-11-10,9693
4162,智擎,23,6,17,富邦-新營,2023-11-10,9693
00665L,富邦�琤肭磪囓�2,16,0,16,富邦-新營,2023-11-10,9693
2338,光罩,15,0,15,富邦-新營,2023-11-10,9693
8905,裕國,15,0,15,富邦-新營,2023-11-10,9693
00934,中信成長高股息,16,2,14,富邦-新營,2023-11-10,9693
2313,華通,30,18,12,富邦-新營,2023-11-10,9693
2382,廣達,11,0,11,富邦-新營,2023-11-10,9693
1718,中纖,11,0,11,富邦-新營,2023-11-10,9693
2344,華邦電,11,0,11,富邦-新營,2023-11-10,9693
8210,勤誠,13,2,11,富邦-新營,2023-11-10,9693
3032,偉訓,12,1,11,富邦-新營,2023-11-10,9693
00919,群益台灣精選高息,10,0,10,富邦-新營,2023-11-10,9693
00907,永豐優息存股,10,0,10,富邦-新營,2023-11-10,9693
2387,精元,16,6,10,富邦-新營,2023-11-10,9693
2436,偉詮電,10,0,10,富邦-新營,2023-11-10,9693
6156,松上,10,0,10,富邦-新營,2023-11-10,9693
8942,森鉅,10,0,10,富邦-新營,2023-11-10,9693
6446,藥華藥,14,5,9,富邦-新營,2023-11-10,9693
2388,威盛,13,4,9,富邦-新營,2023-11-10,9693
2607,榮運,9,0,9,富邦-新營,2023-11-10,9693
0056,元大高股息,8,0,8,富邦-新營,2023-11-10,9693
1714,和桐,8,0,8,富邦-新營,2023-11-10,9693
2736,富野,11,3,8,富邦-新營,2023-11-10,9693
3481,群創,8,1,7,富邦-新營,2023-11-10,9693
00720B,元大投資級公司債,7,0,7,富邦-新營,2023-11-10,9693
00688L,國泰20年美債正2,7,0,7,富邦-新營,2023-11-10,9693
1504,東元,7,0,7,富邦-新營,2023-11-10,9693
3294,英濟,7,0,7,富邦-新營,2023-11-10,9693
2408,南亞科,6,0,6,富邦-新營,2023-11-10,9693
3704,合勤控,7,1,6,富邦-新營,2023-11-10,9693
2208,台船,6,0,6,富邦-新營,2023-11-10,9693
2634,漢翔,6,0,6,富邦-新營,2023-11-10,9693
2897,王道銀行,6,0,6,富邦-新營,2023-11-10,9693
3029,零壹,6,0,6,富邦-新營,2023-11-10,9693
3372,典範,6,0,6,富邦-新營,2023-11-10,9693
4188,安克,6,0,6,富邦-新營,2023-11-10,9693
4905,台聯電,6,0,6,富邦-新營,2023-11-10,9693
8038,長園科,6,0,6,富邦-新營,2023-11-10,9693
2891,中信金,13,7,6,富邦-新營,2023-11-10,9693
00931B,統一美債20年,6,1,5,富邦-新營,2023-11-10,9693
00687B,國泰20年美債,5,0,5,富邦-新營,2023-11-10,9693
1101,台泥,121,0,121,富邦-新營,2023-11-13,9693
00929,復華台灣科技優息,90,23,67,富邦-新營,2023-11-13,9693
2382,廣達,48,1,47,富邦-新營,2023-11-13,9693
5381,合正,27,4,23,富邦-新營,2023-11-13,9693
1815,富喬,22,0,22,富邦-新營,2023-11-13,9693
6005,群益證,20,0,20,富邦-新營,2023-11-13,9693
00712,復華富時不動產,19,1,18,富邦-新營,2023-11-13,9693
3078,僑威,22,6,16,富邦-新營,2023-11-13,9693
6290,良維,16,0,16,富邦-新營,2023-11-13,9693
2883,凱基金,16,1,15,富邦-新營,2023-11-13,9693
6117,迎廣,18,5,13,富邦-新營,2023-11-13,9693
2888,新光金,12,0,12,富邦-新營,2023-11-13,9693
00885,富邦越南,10,0,10,富邦-新營,2023-11-13,9693
00633L,富邦上証正2,10,0,10,富邦-新營,2023-11-13,9693
2105,正新,10,0,10,富邦-新營,2023-11-13,9693
9907,統一實,10,0,10,富邦-新營,2023-11-13,9693
00936,台新永續高息中小,10,0,10,富邦-新營,2023-11-13,9693
1522,堤維西,10,1,9,富邦-新營,2023-11-13,9693
3545,敦泰,9,0,9,富邦-新營,2023-11-13,9693
00688L,國泰20年美債正2,8,0,8,富邦-新營,2023-11-13,9693
2376,技嘉,15,9,6,富邦-新營,2023-11-13,9693
00751B,元大AAA至A公司債,6,0,6,富邦-新營,2023-11-13,9693
1309,台達化,6,0,6,富邦-新營,2023-11-13,9693
1718,中纖,6,0,6,富邦-新營,2023-11-13,9693
6142,友勁,6,0,6,富邦-新營,2023-11-13,9693
00878,國泰永續高股息,28,23,5,富邦-新營,2023-11-13,9693
00882,中信中國高股息,5,0,5,富邦-新營,2023-11-13,9693
2347,聯強,5,0,5,富邦-新營,2023-11-13,9693
4743,合一,8,3,5,富邦-新營,2023-11-13,9693
00753L,中信中國50正2,5,0,5,富邦-新營,2023-11-13,9693
2027,大成鋼,5,0,5,富邦-新營,2023-11-13,9693
2340,台亞,5,0,5,富邦-新營,2023-11-13,9693
2408,南亞科,5,0,5,富邦-新營,2023-11-13,9693
2634,漢翔,11,6,5,富邦-新營,2023-11-13,9693
3266,昇陽,5,0,5,富邦-新營,2023-11-13,9693
8033,雷虎,5,0,5,富邦-新營,2023-11-13,9693
8034,榮群,14,9,5,富邦-新營,2023-11-13,9693
8150,南茂,5,0,5,富邦-新營,2023-11-13,9693
9950,萬國通,5,0,5,富邦-新營,2023-11-13,9693
2353,宏��,4,0,4,富邦-新營,2023-11-13,9693
2610,華航,5,1,4,富邦-新營,2023-11-13,9693
1785,光洋科,5,1,4,富邦-新營,2023-11-13,9693
2421,建準,5,1,4,富邦-新營,2023-11-13,9693
2462,良得電,4,0,4,富邦-新營,2023-11-13,9693
3062,建漢,4,0,4,富邦-新營,2023-11-13,9693
3294,英濟,4,0,4,富邦-新營,2023-11-13,9693
3363,上詮,5,1,4,富邦-新營,2023-11-13,9693
3704,合勤控,6,2,4,富邦-新營,2023-11-13,9693
6139,亞翔,19,15,4,富邦-新營,2023-11-13,9693
6191,精成科,4,0,4,富邦-新營,2023-11-13,9693
2609,陽明,42,12,30,富邦-新營,2023-11-14,9693
2516,新建,30,1,29,富邦-新營,2023-11-14,9693
00679B,元大美債20年,26,0,26,富邦-新營,2023-11-14,9693
3481,群創,85,60,25,富邦-新營,2023-11-14,9693
1522,堤維西,31,10,21,富邦-新營,2023-11-14,9693
8210,勤誠,23,2,21,富邦-新營,2023-11-14,9693
9924,福興,18,0,18,富邦-新營,2023-11-14,9693
00680L,元大美債20正2,16,0,16,富邦-新營,2023-11-14,9693
2476,鉅祥,15,0,15,富邦-新營,2023-11-14,9693
6285,啟��,12,0,12,富邦-新營,2023-11-14,9693
5483,中美晶,11,0,11,富邦-新營,2023-11-14,9693
2884,玉山金,11,0,11,富邦-新營,2023-11-14,9693
1536,和大,10,0,10,富邦-新營,2023-11-14,9693
3217,優群,13,3,10,富邦-新營,2023-11-14,9693
6191,精成科,10,0,10,富邦-新營,2023-11-14,9693
8112,至上,10,0,10,富邦-新營,2023-11-14,9693
2211,長榮鋼,10,0,10,富邦-新營,2023-11-14,9693
00936,台新永續高息中小,11,2,9,富邦-新營,2023-11-14,9693
6139,亞翔,12,3,9,富邦-新營,2023-11-14,9693
6443,元晶,10,1,9,富邦-新營,2023-11-14,9693
6282,康舒,9,1,8,富邦-新營,2023-11-14,9693
00933B,國泰10Y+金融債,8,0,8,富邦-新營,2023-11-14,9693
1568,倉佑,9,1,8,富邦-新營,2023-11-14,9693
2465,麗臺,7,0,7,富邦-新營,2023-11-14,9693
2364,倫飛,7,0,7,富邦-新營,2023-11-14,9693
8429,金麗-KY,8,1,7,富邦-新營,2023-11-14,9693
5347,世界,10,3,7,富邦-新營,2023-11-14,9693
2329,華泰,16,10,6,富邦-新營,2023-11-14,9693
3062,建漢,8,2,6,富邦-新營,2023-11-14,9693
5215,科嘉-KY,6,0,6,富邦-新營,2023-11-14,9693
5351,鈺創,10,4,6,富邦-新營,2023-11-14,9693
6796,晉弘,6,0,6,富邦-新營,2023-11-14,9693
00878,國泰永續高股息,12,7,5,富邦-新營,2023-11-14,9693
2606,裕民,5,0,5,富邦-新營,2023-11-14,9693
2485,兆赫,5,0,5,富邦-新營,2023-11-14,9693
4915,致伸,5,0,5,富邦-新營,2023-11-14,9693
1504,東元,8,3,5,富邦-新營,2023-11-14,9693
2002,中鋼,4,0,4,富邦-新營,2023-11-14,9693
00885,富邦越南,4,0,4,富邦-新營,2023-11-14,9693
1515,力山,107,103,4,富邦-新營,2023-11-14,9693
2020,美亞,4,0,4,富邦-新營,2023-11-14,9693
2313,華通,14,10,4,富邦-新營,2023-11-14,9693
2402,毅嘉,8,4,4,富邦-新營,2023-11-14,9693
3228,金麗科,4,0,4,富邦-新營,2023-11-14,9693
5230,雷笛克光學,4,0,4,富邦-新營,2023-11-14,9693
5403,中菲,4,0,4,富邦-新營,2023-11-14,9693
6419,京晨科,4,0,4,富邦-新營,2023-11-14,9693
00915,凱基優選高股息30,3,0,3,富邦-新營,2023-11-14,9693
00772B,中信高評級公司債,3,0,3,富邦-新營,2023-11-14,9693
1342,八貫,3,0,3,富邦-新營,2023-11-14,9693
00715L,期街口布蘭特正2,1099,8,1091,富邦-新營,2023-11-15,9693
00878,國泰永續高股息,54,1,53,富邦-新營,2023-11-15,9693
2241,艾姆勒,39,0,39,富邦-新營,2023-11-15,9693
2317,鴻海,35,6,29,富邦-新營,2023-11-15,9693
2103,台橡,30,2,28,富邦-新營,2023-11-15,9693
00795B,中信美國公債20年,26,0,26,富邦-新營,2023-11-15,9693
2482,連宇,21,0,21,富邦-新營,2023-11-15,9693
00679B,元大美債20年,22,2,20,富邦-新營,2023-11-15,9693
2449,京元電子,23,4,19,富邦-新營,2023-11-15,9693
1815,富喬,17,3,14,富邦-新營,2023-11-15,9693
3147,大綜,14,0,14,富邦-新營,2023-11-15,9693
4960,誠美材,12,0,12,富邦-新營,2023-11-15,9693
3715,定穎投控,13,2,11,富邦-新營,2023-11-15,9693
00692,富邦公司治理,17,6,11,富邦-新營,2023-11-15,9693
2323,中環,11,0,11,富邦-新營,2023-11-15,9693
2607,榮運,13,2,11,富邦-新營,2023-11-15,9693
2329,華泰,130,120,10,富邦-新營,2023-11-15,9693
3056,富華新,10,0,10,富邦-新營,2023-11-15,9693
6133,金橋,10,0,10,富邦-新營,2023-11-15,9693
8227,巨有科技,10,0,10,富邦-新營,2023-11-15,9693
8261,富鼎,10,0,10,富邦-新營,2023-11-15,9693
3704,合勤控,9,0,9,富邦-新營,2023-11-15,9693
00687B,國泰20年美債,9,1,8,富邦-新營,2023-11-15,9693
2460,建通,8,0,8,富邦-新營,2023-11-15,9693
00720B,元大投資級公司債,6,0,6,富邦-新營,2023-11-15,9693
3078,僑威,6,0,6,富邦-新營,2023-11-15,9693
3260,威剛,6,0,6,富邦-新營,2023-11-15,9693
4128,中天,6,0,6,富邦-新營,2023-11-15,9693
6216,居易,6,0,6,富邦-新營,2023-11-15,9693
3413,京鼎,6,0,6,富邦-新營,2023-11-15,9693
2363,矽統,77,72,5,富邦-新營,2023-11-15,9693
2542,興富發,5,0,5,富邦-新營,2023-11-15,9693
6261,久元,5,0,5,富邦-新營,2023-11-15,9693
6515,穎崴,5,0,5,富邦-新營,2023-11-15,9693
00772B,中信高評級公司債,6,1,5,富邦-新營,2023-11-15,9693
00931B,統一美債20年,5,0,5,富邦-新營,2023-11-15,9693
2312,金寶,5,0,5,富邦-新營,2023-11-15,9693
3535,晶彩科,5,0,5,富邦-新營,2023-11-15,9693
4979,華星光,6,1,5,富邦-新營,2023-11-15,9693
6546,正基,5,0,5,富邦-新營,2023-11-15,9693
9928,中視,5,0,5,富邦-新營,2023-11-15,9693
2356,英業達,12,8,4,富邦-新營,2023-11-15,9693
6288,聯嘉,4,0,4,富邦-新營,2023-11-15,9693
2353,宏��,3,0,3,富邦-新營,2023-11-15,9693
6492,生華科,3,0,3,富邦-新營,2023-11-15,9693
00671R,富邦NASDAQ反1,3,0,3,富邦-新營,2023-11-15,9693
00915,凱基優選高股息30,3,0,3,富邦-新營,2023-11-15,9693
2029,盛餘,5,2,3,富邦-新營,2023-11-15,9693
2337,旺宏,5,2,3,富邦-新營,2023-11-15,9693
2354,鴻準,3,0,3,富邦-新營,2023-11-15,9693
00878,國泰永續高股息,121,1,120,富邦-新營,2023-11-16,9693
00673R,期元大S＆P原油反1,105,5,100,富邦-新營,2023-11-16,9693
2610,華航,54,1,53,富邦-新營,2023-11-16,9693
2241,艾姆勒,41,0,41,富邦-新營,2023-11-16,9693
00679B,元大美債20年,29,0,29,富邦-新營,2023-11-16,9693
3257,虹冠電,23,2,21,富邦-新營,2023-11-16,9693
1808,潤隆,20,0,20,富邦-新營,2023-11-16,9693
3033,威健,20,0,20,富邦-新營,2023-11-16,9693
1909,榮成,20,1,19,富邦-新營,2023-11-16,9693
6264,富裔,18,0,18,富邦-新營,2023-11-16,9693
1101,台泥,15,0,15,富邦-新營,2023-11-16,9693
8227,巨有科技,15,0,15,富邦-新營,2023-11-16,9693
00632R,元大台灣50反1,12,0,12,富邦-新營,2023-11-16,9693
8033,雷虎,12,0,12,富邦-新營,2023-11-16,9693
2607,榮運,21,9,12,富邦-新營,2023-11-16,9693
2303,聯電,11,0,11,富邦-新營,2023-11-16,9693
2369,菱生,12,2,10,富邦-新營,2023-11-16,9693
2376,技嘉,13,3,10,富邦-新營,2023-11-16,9693
00933B,國泰10Y+金融債,9,0,9,富邦-新營,2023-11-16,9693
2337,旺宏,11,2,9,富邦-新營,2023-11-16,9693
2421,建準,10,1,9,富邦-新營,2023-11-16,9693
4945,陞達科技,9,0,9,富邦-新營,2023-11-16,9693
6117,迎廣,9,0,9,富邦-新營,2023-11-16,9693
5009,榮剛,22,13,9,富邦-新營,2023-11-16,9693
00772B,中信高評級公司債,8,0,8,富邦-新營,2023-11-16,9693
0056,元大高股息,10,2,8,富邦-新營,2023-11-16,9693
00751B,元大AAA至A公司債,8,0,8,富邦-新營,2023-11-16,9693
00712,復華富時不動產,20,12,8,富邦-新營,2023-11-16,9693
2352,佳世達,8,0,8,富邦-新營,2023-11-16,9693
2537,聯上發,8,0,8,富邦-新營,2023-11-16,9693
4960,誠美材,10,2,8,富邦-新營,2023-11-16,9693
8034,榮群,22,14,8,富邦-新營,2023-11-16,9693
8110,華東,8,0,8,富邦-新營,2023-11-16,9693
2317,鴻海,11,3,8,富邦-新營,2023-11-16,9693
3276,宇環,17,11,6,富邦-新營,2023-11-16,9693
4967,十銓,10,4,6,富邦-新營,2023-11-16,9693
3443,創意,9,4,5,富邦-新營,2023-11-16,9693
00890B,凱基ESG BBB債,5,0,5,富邦-新營,2023-11-16,9693
1324,地球,5,0,5,富邦-新營,2023-11-16,9693
1504,東元,8,3,5,富邦-新營,2023-11-16,9693
2417,圓剛,140,135,5,富邦-新營,2023-11-16,9693
3363,上詮,35,30,5,富邦-新營,2023-11-16,9693
3704,合勤控,6,1,5,富邦-新營,2023-11-16,9693
5460,同協,5,0,5,富邦-新營,2023-11-16,9693
8940,新天地,5,0,5,富邦-新營,2023-11-16,9693
00885,富邦越南,4,0,4,富邦-新營,2023-11-16,9693
00687B,國泰20年美債,5,1,4,富邦-新營,2023-11-16,9693
3058,立德,4,0,4,富邦-新營,2023-11-16,9693
8054,安國,4,0,4,富邦-新營,2023-11-16,9693
00929,復華台灣科技優息,16,13,3,富邦-新營,2023-11-16,9693
2241,艾姆勒,66,1,65,富邦-新營,2023-11-17,9693
4960,誠美材,51,0,51,富邦-新營,2023-11-17,9693
2618,長榮航,65,21,44,富邦-新營,2023-11-17,9693
3041,揚智,62,26,36,富邦-新營,2023-11-17,9693
1524,耿鼎,35,4,31,富邦-新營,2023-11-17,9693
00919,群益台灣精選高息,62,31,31,富邦-新營,2023-11-17,9693
00751B,元大AAA至A公司債,25,0,25,富邦-新營,2023-11-17,9693
5009,榮剛,25,2,23,富邦-新營,2023-11-17,9693
00720B,元大投資級公司債,22,0,22,富邦-新營,2023-11-17,9693
1808,潤隆,20,0,20,富邦-新營,2023-11-17,9693
2465,麗臺,17,0,17,富邦-新營,2023-11-17,9693
00753L,中信中國50正2,15,0,15,富邦-新營,2023-11-17,9693
3051,力特,15,0,15,富邦-新營,2023-11-17,9693
00712,復華富時不動產,33,19,14,富邦-新營,2023-11-17,9693
2801,彰銀,14,0,14,富邦-新營,2023-11-17,9693
9950,萬國通,22,10,12,富邦-新營,2023-11-17,9693
0056,元大高股息,11,0,11,富邦-新營,2023-11-17,9693
3322,建舜電,11,0,11,富邦-新營,2023-11-17,9693
5213,亞昕,11,0,11,富邦-新營,2023-11-17,9693
1582,信錦,12,1,11,富邦-新營,2023-11-17,9693
00890B,凱基ESG BBB債,10,0,10,富邦-新營,2023-11-17,9693
1464,得力,10,0,10,富邦-新營,2023-11-17,9693
1568,倉佑,10,0,10,富邦-新營,2023-11-17,9693
1720,生達,12,2,10,富邦-新營,2023-11-17,9693
9105,泰金寶-DR,10,0,10,富邦-新營,2023-11-17,9693
6285,啟��,10,0,10,富邦-新營,2023-11-17,9693
2344,華邦電,10,1,9,富邦-新營,2023-11-17,9693
2401,凌陽,31,23,8,富邦-新營,2023-11-17,9693
2610,華航,17,10,7,富邦-新營,2023-11-17,9693
2312,金寶,7,0,7,富邦-新營,2023-11-17,9693
2457,飛宏,7,0,7,富邦-新營,2023-11-17,9693
2354,鴻準,7,0,7,富邦-新營,2023-11-17,9693
1815,富喬,11,4,7,富邦-新營,2023-11-17,9693
00679B,元大美債20年,7,0,7,富邦-新營,2023-11-17,9693
00665L,富邦�琤肭磪囓�2,7,1,6,富邦-新營,2023-11-17,9693
2353,宏��,6,0,6,富邦-新營,2023-11-17,9693
2634,漢翔,6,0,6,富邦-新營,2023-11-17,9693
6261,久元,6,0,6,富邦-新營,2023-11-17,9693
00772B,中信高評級公司債,6,0,6,富邦-新營,2023-11-17,9693
2887,台新金,5,0,5,富邦-新營,2023-11-17,9693
2606,裕民,5,0,5,富邦-新營,2023-11-17,9693
1805,寶徠,5,0,5,富邦-新營,2023-11-17,9693
2885,元大金,5,0,5,富邦-新營,2023-11-17,9693
2897,王道銀行,5,0,5,富邦-新營,2023-11-17,9693
3078,僑威,5,0,5,富邦-新營,2023-11-17,9693
3545,敦泰,7,2,5,富邦-新營,2023-11-17,9693
6127,九豪,5,0,5,富邦-新營,2023-11-17,9693
6494,九齊,5,0,5,富邦-新營,2023-11-17,9693
8043,蜜望實,5,0,5,富邦-新營,2023-11-17,9693
8086,宏捷科,6,1,5,富邦-新營,2023-11-17,9693
2388,威盛,186,67,119,富邦-新營,2023-11-20,9693
6117,迎廣,149,40,109,富邦-新營,2023-11-20,9693
2834,臺企銀,80,0,80,富邦-新營,2023-11-20,9693
2241,艾姆勒,65,0,65,富邦-新營,2023-11-20,9693
00751B,元大AAA至A公司債,25,0,25,富邦-新營,2023-11-20,9693
00712,復華富時不動產,22,0,22,富邦-新營,2023-11-20,9693
00720B,元大投資級公司債,21,0,21,富邦-新營,2023-11-20,9693
6933,AMAX-KY,21,0,21,富邦-新營,2023-11-20,9693
3704,合勤控,20,0,20,富邦-新營,2023-11-20,9693
2547,日勝生,20,1,19,富邦-新營,2023-11-20,9693
2363,矽統,47,31,16,富邦-新營,2023-11-20,9693
2312,金寶,20,5,15,富邦-新營,2023-11-20,9693
3379,彬台,15,0,15,富邦-新營,2023-11-20,9693
00878,國泰永續高股息,18,5,13,富邦-新營,2023-11-20,9693
00688L,國泰20年美債正2,12,0,12,富邦-新營,2023-11-20,9693
3094,聯傑,12,0,12,富邦-新營,2023-11-20,9693
2610,華航,13,2,11,富邦-新營,2023-11-20,9693
1447,力鵬,10,0,10,富邦-新營,2023-11-20,9693
1718,中纖,10,0,10,富邦-新營,2023-11-20,9693
00885,富邦越南,9,0,9,富邦-新營,2023-11-20,9693
00882,中信中國高股息,9,0,9,富邦-新營,2023-11-20,9693
4162,智擎,12,3,9,富邦-新營,2023-11-20,9693
1598,岱宇,9,1,8,富邦-新營,2023-11-20,9693
2618,長榮航,14,6,8,富邦-新營,2023-11-20,9693
6125,廣運,54,46,8,富邦-新營,2023-11-20,9693
6418,詠昇,8,0,8,富邦-新營,2023-11-20,9693
3545,敦泰,10,2,8,富邦-新營,2023-11-20,9693
3363,上詮,41,34,7,富邦-新營,2023-11-20,9693
2314,台揚,8,1,7,富邦-新營,2023-11-20,9693
2401,凌陽,25,18,7,富邦-新營,2023-11-20,9693
5706,鳳凰,10,4,6,富邦-新營,2023-11-20,9693
00690,兆豐藍籌30,6,0,6,富邦-新營,2023-11-20,9693
2465,麗臺,10,4,6,富邦-新營,2023-11-20,9693
2486,一詮,7,1,6,富邦-新營,2023-11-20,9693
5244,弘凱,6,0,6,富邦-新營,2023-11-20,9693
5508,永信建,6,0,6,富邦-新營,2023-11-20,9693
6216,居易,6,0,6,富邦-新營,2023-11-20,9693
6290,良維,6,0,6,富邦-新營,2023-11-20,9693
3078,僑威,7,1,6,富邦-新營,2023-11-20,9693
2731,雄獅,7,2,5,富邦-新營,2023-11-20,9693
2303,聯電,13,8,5,富邦-新營,2023-11-20,9693
00891,中信關鍵半導體,5,0,5,富邦-新營,2023-11-20,9693
00637L,元大滬深300正2,5,0,5,富邦-新營,2023-11-20,9693
1444,力麗,5,0,5,富邦-新營,2023-11-20,9693
2355,敬鵬,17,12,5,富邦-新營,2023-11-20,9693
2387,精元,5,0,5,富邦-新營,2023-11-20,9693
2606,裕民,5,0,5,富邦-新營,2023-11-20,9693
2801,彰銀,6,1,5,富邦-新營,2023-11-20,9693
3037,欣興,13,8,5,富邦-新營,2023-11-20,9693
3535,晶彩科,5,0,5,富邦-新營,2023-11-20,9693
00929,復華台灣科技優息,106,12,94,富邦-新營,2023-11-21,9693
2537,聯上發,80,11,69,富邦-新營,2023-11-21,9693
2913,農林,62,1,61,富邦-新營,2023-11-21,9693
2382,廣達,58,12,46,富邦-新營,2023-11-21,9693
2344,華邦電,46,0,46,富邦-新營,2023-11-21,9693
2367,燿華,62,20,42,富邦-新營,2023-11-21,9693
2610,華航,42,6,36,富邦-新營,2023-11-21,9693
00632R,元大台灣50反1,35,0,35,富邦-新營,2023-11-21,9693
5512,力麒,34,0,34,富邦-新營,2023-11-21,9693
2002,中鋼,47,17,30,富邦-新營,2023-11-21,9693
1447,力鵬,30,0,30,富邦-新營,2023-11-21,9693
00919,群益台灣精選高息,31,6,25,富邦-新營,2023-11-21,9693
6282,康舒,35,11,24,富邦-新營,2023-11-21,9693
2634,漢翔,22,0,22,富邦-新營,2023-11-21,9693
1718,中纖,20,0,20,富邦-新營,2023-11-21,9693
3564,其陽,20,0,20,富邦-新營,2023-11-21,9693
5351,鈺創,39,22,17,富邦-新營,2023-11-21,9693
3308,聯德,15,0,15,富邦-新營,2023-11-21,9693
8261,富鼎,15,0,15,富邦-新營,2023-11-21,9693
00915,凱基優選高股息30,13,0,13,富邦-新營,2023-11-21,9693
2355,敬鵬,19,6,13,富邦-新營,2023-11-21,9693
00751B,元大AAA至A公司債,12,0,12,富邦-新營,2023-11-21,9693
3715,定穎投控,65,53,12,富邦-新營,2023-11-21,9693
00904,新光臺灣半導體30,11,0,11,富邦-新營,2023-11-21,9693
2607,榮運,13,2,11,富邦-新營,2023-11-21,9693
6122,擎邦,12,1,11,富邦-新營,2023-11-21,9693
6168,宏齊,14,3,11,富邦-新營,2023-11-21,9693
3483,力致,117,106,11,富邦-新營,2023-11-21,9693
1714,和桐,10,0,10,富邦-新營,2023-11-21,9693
2208,台船,10,0,10,富邦-新營,2023-11-21,9693
2515,中工,10,0,10,富邦-新營,2023-11-21,9693
2641,正德,10,0,10,富邦-新營,2023-11-21,9693
3234,光環,10,0,10,富邦-新營,2023-11-21,9693
3276,宇環,11,1,10,富邦-新營,2023-11-21,9693
00936,台新永續高息中小,12,3,9,富邦-新營,2023-11-21,9693
6182,合晶,9,0,9,富邦-新營,2023-11-21,9693
3257,虹冠電,8,0,8,富邦-新營,2023-11-21,9693
5347,世界,33,25,8,富邦-新營,2023-11-21,9693
6237,驊訊,13,5,8,富邦-新營,2023-11-21,9693
00712,復華富時不動產,8,1,7,富邦-新營,2023-11-21,9693
2314,台揚,12,5,7,富邦-新營,2023-11-21,9693
5292,華懋,8,1,7,富邦-新營,2023-11-21,9693
6217,中探針,7,0,7,富邦-新營,2023-11-21,9693
00885,富邦越南,14,8,6,富邦-新營,2023-11-21,9693
6125,廣運,11,5,6,富邦-新營,2023-11-21,9693
1720,生達,6,0,6,富邦-新營,2023-11-21,9693
2387,精元,6,0,6,富邦-新營,2023-11-21,9693
2486,一詮,7,1,6,富邦-新營,2023-11-21,9693
2337,旺宏,6,1,5,富邦-新營,2023-11-21,9693
2731,雄獅,6,1,5,富邦-新營,2023-11-21,9693
00919,群益台灣精選高息,109,0,109,富邦-新營,2023-11-22,9693
3059,華晶科,116,16,100,富邦-新營,2023-11-22,9693
00905,FT臺灣Smart,99,0,99,富邦-新營,2023-11-22,9693
6770,力積電,33,2,31,富邦-新營,2023-11-22,9693
3231,緯創,52,25,27,富邦-新營,2023-11-22,9693
2382,廣達,27,0,27,富邦-新營,2023-11-22,9693
2353,宏��,28,2,26,富邦-新營,2023-11-22,9693
3024,憶聲,24,0,24,富邦-新營,2023-11-22,9693
4960,誠美材,23,0,23,富邦-新營,2023-11-22,9693
2834,臺企銀,22,0,22,富邦-新營,2023-11-22,9693
3041,揚智,491,470,21,富邦-新營,2023-11-22,9693
2356,英業達,23,2,21,富邦-新營,2023-11-22,9693
2241,艾姆勒,20,0,20,富邦-新營,2023-11-22,9693
00706L,期元大S＆P日圓正2,20,1,19,富邦-新營,2023-11-22,9693
00679B,元大美債20年,15,0,15,富邦-新營,2023-11-22,9693
2376,技嘉,32,19,13,富邦-新營,2023-11-22,9693
4744,皇將,13,0,13,富邦-新營,2023-11-22,9693
6233,旺玖,14,1,13,富邦-新營,2023-11-22,9693
2427,三商電,13,1,12,富邦-新營,2023-11-22,9693
5533,皇鼎,23,11,12,富邦-新營,2023-11-22,9693
00680L,元大美債20正2,11,0,11,富邦-新營,2023-11-22,9693
00882,中信中國高股息,11,0,11,富邦-新營,2023-11-22,9693
3266,昇陽,12,1,11,富邦-新營,2023-11-22,9693
2030,彰源,10,0,10,富邦-新營,2023-11-22,9693
2344,華邦電,10,0,10,富邦-新營,2023-11-22,9693
2465,麗臺,10,0,10,富邦-新營,2023-11-22,9693
3019,亞光,10,0,10,富邦-新營,2023-11-22,9693
4729,熒茂,10,0,10,富邦-新營,2023-11-22,9693
8110,華東,10,0,10,富邦-新營,2023-11-22,9693
8234,新漢,10,0,10,富邦-新營,2023-11-22,9693
00885,富邦越南,11,2,9,富邦-新營,2023-11-22,9693
2358,廷鑫,14,5,9,富邦-新營,2023-11-22,9693
2449,京元電子,10,1,9,富邦-新營,2023-11-22,9693
2014,中鴻,13,5,8,富邦-新營,2023-11-22,9693
2421,建準,8,0,8,富邦-新營,2023-11-22,9693
5471,松翰,10,2,8,富邦-新營,2023-11-22,9693
00891,中信關鍵半導體,12,5,7,富邦-新營,2023-11-22,9693
9950,萬國通,8,1,7,富邦-新營,2023-11-22,9693
1101,台泥,7,1,6,富邦-新營,2023-11-22,9693
00751B,元大AAA至A公司債,6,0,6,富邦-新營,2023-11-22,9693
2201,裕隆,6,0,6,富邦-新營,2023-11-22,9693
2610,華航,18,12,6,富邦-新營,2023-11-22,9693
3005,神基,7,1,6,富邦-新營,2023-11-22,9693
3285,微端,6,0,6,富邦-新營,2023-11-22,9693
5386,青雲,6,0,6,富邦-新營,2023-11-22,9693
3545,敦泰,11,5,6,富邦-新營,2023-11-22,9693
2330,台積電,7,1,6,富邦-新營,2023-11-22,9693
6191,精成科,12,7,5,富邦-新營,2023-11-22,9693
2887,台新金,6,1,5,富邦-新營,2023-11-22,9693
00665L,富邦�琤肭磪囓�2,5,0,5,富邦-新營,2023-11-22,9693
00929,復華台灣科技優息,149,22,127,富邦-新營,2023-11-23,9693
00936,台新永續高息中小,65,0,65,富邦-新營,2023-11-23,9693
00933B,國泰10Y+金融債,65,0,65,富邦-新營,2023-11-23,9693
3024,憶聲,64,0,64,富邦-新營,2023-11-23,9693
00673R,期元大S＆P原油反1,60,0,60,富邦-新營,2023-11-23,9693
6243,迅杰,169,118,51,富邦-新營,2023-11-23,9693
6530,創威,51,2,49,富邦-新營,2023-11-23,9693
3059,華晶科,45,21,24,富邦-新營,2023-11-23,9693
3122,笙泉,39,17,22,富邦-新營,2023-11-23,9693
00878,國泰永續高股息,27,5,22,富邦-新營,2023-11-23,9693
00706L,期元大S＆P日圓正2,20,0,20,富邦-新營,2023-11-23,9693
2030,彰源,20,0,20,富邦-新營,2023-11-23,9693
00919,群益台灣精選高息,19,0,19,富邦-新營,2023-11-23,9693
1815,富喬,20,1,19,富邦-新營,2023-11-23,9693
2388,威盛,47,28,19,富邦-新營,2023-11-23,9693
2401,凌陽,23,5,18,富邦-新營,2023-11-23,9693
2387,精元,16,0,16,富邦-新營,2023-11-23,9693
1717,長興,15,0,15,富邦-新營,2023-11-23,9693
2516,新建,15,0,15,富邦-新營,2023-11-23,9693
1504,東元,19,6,13,富邦-新營,2023-11-23,9693
2439,美律,14,1,13,富邦-新營,2023-11-23,9693
5521,工信,15,3,12,富邦-新營,2023-11-23,9693
1455,集盛,12,0,12,富邦-新營,2023-11-23,9693
2329,華泰,24,12,12,富邦-新營,2023-11-23,9693
3231,緯創,25,15,10,富邦-新營,2023-11-23,9693
6139,亞翔,10,0,10,富邦-新營,2023-11-23,9693
1337,再生-KY,10,0,10,富邦-新營,2023-11-23,9693
2464,盟立,10,0,10,富邦-新營,2023-11-23,9693
2736,富野,10,0,10,富邦-新營,2023-11-23,9693
4729,熒茂,10,0,10,富邦-新營,2023-11-23,9693
8068,全達,10,0,10,富邦-新營,2023-11-23,9693
2481,強茂,10,1,9,富邦-新營,2023-11-23,9693
4973,廣穎,9,0,9,富邦-新營,2023-11-23,9693
3443,創意,16,8,8,富邦-新營,2023-11-23,9693
6125,廣運,119,111,8,富邦-新營,2023-11-23,9693
2002,中鋼,10,2,8,富邦-新營,2023-11-23,9693
00679B,元大美債20年,7,0,7,富邦-新營,2023-11-23,9693
2515,中工,7,0,7,富邦-新營,2023-11-23,9693
3704,合勤控,10,3,7,富邦-新營,2023-11-23,9693
4945,陞達科技,7,0,7,富邦-新營,2023-11-23,9693
8261,富鼎,8,1,7,富邦-新營,2023-11-23,9693
00935,野村臺灣新科技50,6,0,6,富邦-新營,2023-11-23,9693
00715L,期街口布蘭特正2,6,0,6,富邦-新營,2023-11-23,9693
00688L,國泰20年美債正2,6,0,6,富邦-新營,2023-11-23,9693
5272,笙科,6,0,6,富邦-新營,2023-11-23,9693
8358,金居,14,8,6,富邦-新營,2023-11-23,9693
5471,松翰,6,0,6,富邦-新營,2023-11-23,9693
8054,安國,10,4,6,富邦-新營,2023-11-23,9693
00687B,國泰20年美債,6,0,6,富邦-新營,2023-11-23,9693
2014,中鴻,8,3,5,富邦-新營,2023-11-23,9693
8086,宏捷科,101,9,92,富邦-新營,2023-11-24,9693
1326,台化,52,0,52,富邦-新營,2023-11-24,9693
2618,長榮航,42,4,38,富邦-新營,2023-11-24,9693
5512,力麒,30,0,30,富邦-新營,2023-11-24,9693
00687B,國泰20年美債,27,0,27,富邦-新營,2023-11-24,9693
2610,華航,26,1,25,富邦-新營,2023-11-24,9693
3006,晶豪科,22,1,21,富邦-新營,2023-11-24,9693
00933B,國泰10Y+金融債,20,0,20,富邦-新營,2023-11-24,9693
1718,中纖,20,0,20,富邦-新營,2023-11-24,9693
00720B,元大投資級公司債,19,2,17,富邦-新營,2023-11-24,9693
5351,鈺創,24,7,17,富邦-新營,2023-11-24,9693
3701,大眾控,17,1,16,富邦-新營,2023-11-24,9693
4960,誠美材,16,1,15,富邦-新營,2023-11-24,9693
3576,聯合再生,15,0,15,富邦-新營,2023-11-24,9693
1229,聯華,13,0,13,富邦-新營,2023-11-24,9693
2408,南亞科,13,1,12,富邦-新營,2023-11-24,9693
00878,國泰永續高股息,11,0,11,富邦-新營,2023-11-24,9693
2465,麗臺,15,4,11,富邦-新營,2023-11-24,9693
2611,志信,11,0,11,富邦-新營,2023-11-24,9693
00712,復華富時不動產,10,0,10,富邦-新營,2023-11-24,9693
5706,鳳凰,9,0,9,富邦-新營,2023-11-24,9693
00885,富邦越南,8,0,8,富邦-新營,2023-11-24,9693
2010,春源,8,0,8,富邦-新營,2023-11-24,9693
2405,輔信,10,2,8,富邦-新營,2023-11-24,9693
2371,大同,14,7,7,富邦-新營,2023-11-24,9693
2442,新美齊,7,0,7,富邦-新營,2023-11-24,9693
3078,僑威,8,1,7,富邦-新營,2023-11-24,9693
6550,北極星藥業-KY,13,6,7,富邦-新營,2023-11-24,9693
3041,揚智,6,0,6,富邦-新營,2023-11-24,9693
2731,雄獅,7,1,6,富邦-新營,2023-11-24,9693
2313,華通,231,225,6,富邦-新營,2023-11-24,9693
2363,矽統,14,8,6,富邦-新營,2023-11-24,9693
3037,欣興,6,0,6,富邦-新營,2023-11-24,9693
5465,富驊,6,0,6,富邦-新營,2023-11-24,9693
6684,安格,8,2,6,富邦-新營,2023-11-24,9693
2888,新光金,15,9,6,富邦-新營,2023-11-24,9693
00751B,元大AAA至A公司債,5,0,5,富邦-新營,2023-11-24,9693
1603,華電,5,0,5,富邦-新營,2023-11-24,9693
2314,台揚,5,0,5,富邦-新營,2023-11-24,9693
2359,所羅門,5,0,5,富邦-新營,2023-11-24,9693
2516,新建,5,0,5,富邦-新營,2023-11-24,9693
2897,王道銀行,5,0,5,富邦-新營,2023-11-24,9693
4188,安克,5,0,5,富邦-新營,2023-11-24,9693
4542,科嶠,7,2,5,富邦-新營,2023-11-24,9693
4938,和碩,5,0,5,富邦-新營,2023-11-24,9693
6117,迎廣,84,79,5,富邦-新營,2023-11-24,9693
6161,捷波,6,1,5,富邦-新營,2023-11-24,9693
8942,森鉅,6,1,5,富邦-新營,2023-11-24,9693
2002,中鋼,12,8,4,富邦-新營,2023-11-24,9693
3443,創意,10,6,4,富邦-新營,2023-11-24,9693
00919,群益台灣精選高息,144,2,142,富邦-新營,2023-11-27,9693
00706L,期元大S＆P日圓正2,95,0,95,富邦-新營,2023-11-27,9693
1514,亞力,175,108,67,富邦-新營,2023-11-27,9693
00929,復華台灣科技優息,87,20,67,富邦-新營,2023-11-27,9693
2855,統一證,50,0,50,富邦-新營,2023-11-27,9693
2610,華航,46,0,46,富邦-新營,2023-11-27,9693
2601,益航,46,0,46,富邦-新營,2023-11-27,9693
00687B,國泰20年美債,33,0,33,富邦-新營,2023-11-27,9693
00715L,期街口布蘭特正2,42,10,32,富邦-新營,2023-11-27,9693
2303,聯電,23,0,23,富邦-新營,2023-11-27,9693
1815,富喬,20,0,20,富邦-新營,2023-11-27,9693
5009,榮剛,23,3,20,富邦-新營,2023-11-27,9693
9103,美德醫療-DR,20,0,20,富邦-新營,2023-11-27,9693
1718,中纖,19,0,19,富邦-新營,2023-11-27,9693
2010,春源,17,0,17,富邦-新營,2023-11-27,9693
2382,廣達,19,2,17,富邦-新營,2023-11-27,9693
00665L,富邦�琤肭磪囓�2,15,0,15,富邦-新營,2023-11-27,9693
1437,勤益控,15,0,15,富邦-新營,2023-11-27,9693
9919,康那香,15,0,15,富邦-新營,2023-11-27,9693
3231,緯創,21,7,14,富邦-新營,2023-11-27,9693
2201,裕隆,14,0,14,富邦-新營,2023-11-27,9693
3260,威剛,14,0,14,富邦-新營,2023-11-27,9693
6668,中揚光,14,0,14,富邦-新營,2023-11-27,9693
9950,萬國通,15,1,14,富邦-新營,2023-11-27,9693
2330,台積電,13,1,12,富邦-新營,2023-11-27,9693
2356,英業達,11,0,11,富邦-新營,2023-11-27,9693
0056,元大高股息,10,0,10,富邦-新營,2023-11-27,9693
2614,東森,10,0,10,富邦-新營,2023-11-27,9693
00720B,元大投資級公司債,10,0,10,富邦-新營,2023-11-27,9693
5351,鈺創,21,11,10,富邦-新營,2023-11-27,9693
2069,運錩,10,0,10,富邦-新營,2023-11-27,9693
2449,京元電子,10,0,10,富邦-新營,2023-11-27,9693
3046,建��,10,0,10,富邦-新營,2023-11-27,9693
3715,定穎投控,18,8,10,富邦-新營,2023-11-27,9693
4173,久裕,10,0,10,富邦-新營,2023-11-27,9693
8069,元太,10,0,10,富邦-新營,2023-11-27,9693
00679B,元大美債20年,9,1,8,富邦-新營,2023-11-27,9693
00936,台新永續高息中小,8,0,8,富邦-新營,2023-11-27,9693
2363,矽統,8,0,8,富邦-新營,2023-11-27,9693
3024,憶聲,8,0,8,富邦-新營,2023-11-27,9693
3530,晶相光,8,0,8,富邦-新營,2023-11-27,9693
5292,華懋,8,0,8,富邦-新營,2023-11-27,9693
2605,新興,17,10,7,富邦-新營,2023-11-27,9693
3322,建舜電,11,4,7,富邦-新營,2023-11-27,9693
00637L,元大滬深300正2,6,0,6,富邦-新營,2023-11-27,9693
00934,中信成長高股息,7,1,6,富邦-新營,2023-11-27,9693
3257,虹冠電,6,0,6,富邦-新營,2023-11-27,9693
3308,聯德,6,0,6,富邦-新營,2023-11-27,9693
4506,崇友,6,0,6,富邦-新營,2023-11-27,9693
5222,全訊,6,0,6,富邦-新營,2023-11-27,9693
00919,群益台灣精選高息,62,2,60,富邦-新營,2023-11-28,9693
4157,太景*-KY,38,0,38,富邦-新營,2023-11-28,9693
00935,野村臺灣新科技50,30,0,30,富邦-新營,2023-11-28,9693
5347,世界,29,0,29,富邦-新營,2023-11-28,9693
00850,元大臺灣ESG永續,20,0,20,富邦-新營,2023-11-28,9693
6284,佳邦,18,0,18,富邦-新營,2023-11-28,9693
1720,生達,21,4,17,富邦-新營,2023-11-28,9693
2303,聯電,17,1,16,富邦-新營,2023-11-28,9693
1514,亞力,28,14,14,富邦-新營,2023-11-28,9693
00934,中信成長高股息,14,1,13,富邦-新營,2023-11-28,9693
1101,台泥,21,8,13,富邦-新營,2023-11-28,9693
00885,富邦越南,13,2,11,富邦-新營,2023-11-28,9693
2363,矽統,23,12,11,富邦-新營,2023-11-28,9693
3576,聯合再生,10,0,10,富邦-新營,2023-11-28,9693
00712,復華富時不動產,10,0,10,富邦-新營,2023-11-28,9693
00904,新光臺灣半導體30,10,0,10,富邦-新營,2023-11-28,9693
3047,訊舟,10,0,10,富邦-新營,2023-11-28,9693
5512,力麒,10,0,10,富邦-新營,2023-11-28,9693
2612,中航,10,0,10,富邦-新營,2023-11-28,9693
2605,新興,117,109,8,富邦-新營,2023-11-28,9693
1605,華新,10,2,8,富邦-新營,2023-11-28,9693
1701,中化,10,2,8,富邦-新營,2023-11-28,9693
2344,華邦電,11,3,8,富邦-新營,2023-11-28,9693
1781,合世,9,2,7,富邦-新營,2023-11-28,9693
4114,健喬,8,1,7,富邦-新營,2023-11-28,9693
3227,原相,7,1,6,富邦-新營,2023-11-28,9693
3437,榮創,20,14,6,富邦-新營,2023-11-28,9693
3443,創意,8,2,6,富邦-新營,2023-11-28,9693
2356,英業達,8,3,5,富邦-新營,2023-11-28,9693
2371,大同,5,0,5,富邦-新營,2023-11-28,9693
00639,富邦深100,5,0,5,富邦-新營,2023-11-28,9693
2323,中環,5,0,5,富邦-新營,2023-11-28,9693
3003,健和興,5,0,5,富邦-新營,2023-11-28,9693
3176,基亞,5,0,5,富邦-新營,2023-11-28,9693
3706,神達,6,1,5,富邦-新營,2023-11-28,9693
6147,頎邦,5,0,5,富邦-新營,2023-11-28,9693
6188,廣明,5,0,5,富邦-新營,2023-11-28,9693
6546,正基,5,0,5,富邦-新營,2023-11-28,9693
8028,昇陽半導體,5,0,5,富邦-新營,2023-11-28,9693
9950,萬國通,5,0,5,富邦-新營,2023-11-28,9693
6271,同欣電,5,0,5,富邦-新營,2023-11-28,9693
1210,大成,5,0,5,富邦-新營,2023-11-28,9693
3374,精材,8,3,5,富邦-新營,2023-11-28,9693
2457,飛宏,6,2,4,富邦-新營,2023-11-28,9693
3564,其陽,4,0,4,富邦-新營,2023-11-28,9693
8086,宏捷科,4,0,4,富邦-新營,2023-11-28,9693
1760,寶齡富錦,18,14,4,富邦-新營,2023-11-28,9693
00680L,元大美債20正2,4,1,3,富邦-新營,2023-11-28,9693
2301,光寶科,3,0,3,富邦-新營,2023-11-28,9693
2402,毅嘉,9,6,3,富邦-新營,2023-11-28,9693
9904,寶成,132,0,132,富邦-新營,2023-11-29,9693
4960,誠美材,100,6,94,富邦-新營,2023-11-29,9693
2313,華通,106,37,69,富邦-新營,2023-11-29,9693
1701,中化,66,0,66,富邦-新營,2023-11-29,9693
2543,皇昌,110,62,48,富邦-新營,2023-11-29,9693
2017,官田鋼,30,0,30,富邦-新營,2023-11-29,9693
00665L,富邦�琤肭磪囓�2,28,0,28,富邦-新營,2023-11-29,9693
1718,中纖,26,0,26,富邦-新營,2023-11-29,9693
2329,華泰,154,132,22,富邦-新營,2023-11-29,9693
2312,金寶,20,1,19,富邦-新營,2023-11-29,9693
00882,中信中國高股息,21,2,19,富邦-新營,2023-11-29,9693
00680L,元大美債20正2,18,0,18,富邦-新營,2023-11-29,9693
3032,偉訓,20,2,18,富邦-新營,2023-11-29,9693
00720B,元大投資級公司債,20,3,17,富邦-新營,2023-11-29,9693
1727,中華化,16,0,16,富邦-新營,2023-11-29,9693
6695,芯鼎,15,1,14,富邦-新營,2023-11-29,9693
2355,敬鵬,15,2,13,富邦-新營,2023-11-29,9693
2883,凱基金,24,12,12,富邦-新營,2023-11-29,9693
1101,台泥,12,0,12,富邦-新營,2023-11-29,9693
00679B,元大美債20年,15,4,11,富邦-新營,2023-11-29,9693
2401,凌陽,38,27,11,富邦-新營,2023-11-29,9693
5512,力麒,11,0,11,富邦-新營,2023-11-29,9693
5347,世界,12,2,10,富邦-新營,2023-11-29,9693
2539,櫻花建,10,0,10,富邦-新營,2023-11-29,9693
00753L,中信中國50正2,10,0,10,富邦-新營,2023-11-29,9693
3049,精金,10,0,10,富邦-新營,2023-11-29,9693
3083,網龍,10,0,10,富邦-新營,2023-11-29,9693
3025,星通,13,3,10,富邦-新營,2023-11-29,9693
2010,春源,8,0,8,富邦-新營,2023-11-29,9693
2369,菱生,24,16,8,富邦-新營,2023-11-29,9693
2537,聯上發,13,5,8,富邦-新營,2023-11-29,9693
5351,鈺創,13,5,8,富邦-新營,2023-11-29,9693
00712,復華富時不動產,8,1,7,富邦-新營,2023-11-29,9693
00687B,國泰20年美債,10,3,7,富邦-新營,2023-11-29,9693
2351,順德,7,0,7,富邦-新營,2023-11-29,9693
3317,尼克森,7,0,7,富邦-新營,2023-11-29,9693
3545,敦泰,8,1,7,富邦-新營,2023-11-29,9693
3036,文曄,12,6,6,富邦-新營,2023-11-29,9693
1720,生達,6,0,6,富邦-新營,2023-11-29,9693
6243,迅杰,12,6,6,富邦-新營,2023-11-29,9693
2891,中信金,6,0,6,富邦-新營,2023-11-29,9693
2371,大同,9,4,5,富邦-新營,2023-11-29,9693
2610,華航,10,5,5,富邦-新營,2023-11-29,9693
2867,三商壽,5,0,5,富邦-新營,2023-11-29,9693
3308,聯德,5,0,5,富邦-新營,2023-11-29,9693
3617,碩天,5,0,5,富邦-新營,2023-11-29,9693
8054,安國,10,5,5,富邦-新營,2023-11-29,9693
9950,萬國通,5,0,5,富邦-新營,2023-11-29,9693
6271,同欣電,8,3,5,富邦-新營,2023-11-29,9693
00931B,統一美債20年,4,0,4,富邦-新營,2023-11-29,9693
2543,皇昌,61,1,60,富邦-新營,2023-11-30,9693
3217,優群,73,25,48,富邦-新營,2023-11-30,9693
00665L,富邦�琤肭磪囓�2,51,7,44,富邦-新營,2023-11-30,9693
00753L,中信中國50正2,32,0,32,富邦-新營,2023-11-30,9693
9907,統一實,30,0,30,富邦-新營,2023-11-30,9693
3228,金麗科,30,0,30,富邦-新營,2023-11-30,9693
00919,群益台灣精選高息,29,0,29,富邦-新營,2023-11-30,9693
5425,台半,35,6,29,富邦-新營,2023-11-30,9693
00680L,元大美債20正2,27,0,27,富邦-新營,2023-11-30,9693
00882,中信中國高股息,22,0,22,富邦-新營,2023-11-30,9693
2329,華泰,222,202,20,富邦-新營,2023-11-30,9693
2883,凱基金,20,0,20,富邦-新營,2023-11-30,9693
2610,華航,18,0,18,富邦-新營,2023-11-30,9693
00915,凱基優選高股息30,17,0,17,富邦-新營,2023-11-30,9693
2905,三商,15,0,15,富邦-新營,2023-11-30,9693
5469,瀚宇博,21,7,14,富邦-新營,2023-11-30,9693
2607,榮運,13,0,13,富邦-新營,2023-11-30,9693
5347,世界,17,4,13,富邦-新營,2023-11-30,9693
1718,中纖,11,0,11,富邦-新營,2023-11-30,9693
5381,合正,19,8,11,富邦-新營,2023-11-30,9693
6111,大宇資,11,0,11,富邦-新營,2023-11-30,9693
6147,頎邦,12,1,11,富邦-新營,2023-11-30,9693
6284,佳邦,11,0,11,富邦-新營,2023-11-30,9693
00679B,元大美債20年,13,3,10,富邦-新營,2023-11-30,9693
3615,安可,11,1,10,富邦-新營,2023-11-30,9693
6456,GIS-KY,10,0,10,富邦-新營,2023-11-30,9693
8034,榮群,10,0,10,富邦-新營,2023-11-30,9693
8112,至上,12,2,10,富邦-新營,2023-11-30,9693
2834,臺企銀,9,0,9,富邦-新營,2023-11-30,9693
3260,威剛,12,3,9,富邦-新營,2023-11-30,9693
4563,百德,10,1,9,富邦-新營,2023-11-30,9693
6550,北極星藥業-KY,10,1,9,富邦-新營,2023-11-30,9693
4114,健喬,11,2,9,富邦-新營,2023-11-30,9693
2457,飛宏,12,4,8,富邦-新營,2023-11-30,9693
00712,復華富時不動產,9,1,8,富邦-新營,2023-11-30,9693
00933B,國泰10Y+金融債,8,0,8,富邦-新營,2023-11-30,9693
1319,東陽,10,2,8,富邦-新營,2023-11-30,9693
3060,銘異,10,2,8,富邦-新營,2023-11-30,9693
2313,華通,16,8,8,富邦-新營,2023-11-30,9693
00936,台新永續高息中小,7,0,7,富邦-新營,2023-11-30,9693
2010,春源,7,0,7,富邦-新營,2023-11-30,9693
2369,菱生,8,1,7,富邦-新營,2023-11-30,9693
3645,達邁,8,1,7,富邦-新營,2023-11-30,9693
6680,鑫創電子,7,0,7,富邦-新營,2023-11-30,9693
9919,康那香,18,11,7,富邦-新營,2023-11-30,9693
2618,長榮航,6,0,6,富邦-新營,2023-11-30,9693
00687B,國泰20年美債,8,2,6,富邦-新營,2023-11-30,9693
1777,生泰,6,0,6,富邦-新營,2023-11-30,9693
2323,中環,6,0,6,富邦-新營,2023-11-30,9693
2460,建通,6,0,6,富邦-新營,2023-11-30,9693
4960,誠美材,300,10,290,富邦-新營,2023-12-01,9693
2388,威盛,132,5,127,富邦-新營,2023-12-01,9693
00688L,國泰20年美債正2,33,0,33,富邦-新營,2023-12-01,9693
00919,群益台灣精選高息,34,2,32,富邦-新營,2023-12-01,9693
00687B,國泰20年美債,25,0,25,富邦-新營,2023-12-01,9693
2543,皇昌,70,45,25,富邦-新營,2023-12-01,9693
2317,鴻海,33,10,23,富邦-新營,2023-12-01,9693
00885,富邦越南,22,0,22,富邦-新營,2023-12-01,9693
3702,大聯大,21,0,21,富邦-新營,2023-12-01,9693
00900,富邦特選高股息30,21,0,21,富邦-新營,2023-12-01,9693
00665L,富邦�琤肭磪囓�2,21,0,21,富邦-新營,2023-12-01,9693
4109,加捷生醫,21,1,20,富邦-新營,2023-12-01,9693
6477,安集,20,0,20,富邦-新營,2023-12-01,9693
3706,神達,38,19,19,富邦-新營,2023-12-01,9693
5347,世界,22,3,19,富邦-新營,2023-12-01,9693
00715L,期街口布蘭特正2,19,0,19,富邦-新營,2023-12-01,9693
3231,緯創,29,11,18,富邦-新營,2023-12-01,9693
6550,北極星藥業-KY,27,10,17,富邦-新營,2023-12-01,9693
2615,萬海,20,4,16,富邦-新營,2023-12-01,9693
2002,中鋼,19,4,15,富邦-新營,2023-12-01,9693
2891,中信金,16,1,15,富邦-新營,2023-12-01,9693
00712,復華富時不動產,16,1,15,富邦-新營,2023-12-01,9693
2883,凱基金,15,0,15,富邦-新營,2023-12-01,9693
5512,力麒,15,0,15,富邦-新營,2023-12-01,9693
8027,鈦昇,15,0,15,富邦-新營,2023-12-01,9693
3163,波若威,15,1,14,富邦-新營,2023-12-01,9693
2609,陽明,23,10,13,富邦-新營,2023-12-01,9693
00680L,元大美債20正2,13,0,13,富邦-新營,2023-12-01,9693
2382,廣達,12,0,12,富邦-新營,2023-12-01,9693
3704,合勤控,18,6,12,富邦-新營,2023-12-01,9693
1582,信錦,24,12,12,富邦-新營,2023-12-01,9693
00679B,元大美債20年,12,0,12,富邦-新營,2023-12-01,9693
00933B,國泰10Y+金融債,21,10,11,富邦-新營,2023-12-01,9693
1720,生達,12,1,11,富邦-新營,2023-12-01,9693
2481,強茂,12,1,11,富邦-新營,2023-12-01,9693
00720B,元大投資級公司債,10,0,10,富邦-新營,2023-12-01,9693
00923,群益台ESG低碳50,10,0,10,富邦-新營,2023-12-01,9693
2610,華航,11,1,10,富邦-新營,2023-12-01,9693
9924,福興,10,0,10,富邦-新營,2023-12-01,9693
00882,中信中國高股息,9,0,9,富邦-新營,2023-12-01,9693
1442,名軒,10,1,9,富邦-新營,2023-12-01,9693
5355,佳總,9,0,9,富邦-新營,2023-12-01,9693
6117,迎廣,33,24,9,富邦-新營,2023-12-01,9693
6282,康舒,17,8,9,富邦-新營,2023-12-01,9693
8429,金麗-KY,9,0,9,富邦-新營,2023-12-01,9693
1101,台泥,8,0,8,富邦-新營,2023-12-01,9693
00934,中信成長高股息,8,0,8,富邦-新營,2023-12-01,9693
00915,凱基優選高股息30,7,0,7,富邦-新營,2023-12-01,9693
2409,友達,7,0,7,富邦-新營,2023-12-01,9693
2515,中工,7,0,7,富邦-新營,2023-12-01,9693
2855,統一證,200,0,200,富邦-新營,2023-12-04,9693
00715L,期街口布蘭特正2,186,2,184,富邦-新營,2023-12-04,9693
00919,群益台灣精選高息,172,5,167,富邦-新營,2023-12-04,9693
5439,高技,112,1,111,富邦-新營,2023-12-04,9693
6016,康和證,100,0,100,富邦-新營,2023-12-04,9693
2609,陽明,302,244,58,富邦-新營,2023-12-04,9693
2492,華新科,58,4,54,富邦-新營,2023-12-04,9693
3390,旭軟,54,3,51,富邦-新營,2023-12-04,9693
9919,康那香,200,150,50,富邦-新營,2023-12-04,9693
00665L,富邦�琤肭磪囓�2,46,2,44,富邦-新營,2023-12-04,9693
2313,華通,46,4,42,富邦-新營,2023-12-04,9693
1605,華新,45,4,41,富邦-新營,2023-12-04,9693
1337,再生-KY,39,0,39,富邦-新營,2023-12-04,9693
00713,元大台灣高息低波,35,0,35,富邦-新營,2023-12-04,9693
2883,凱基金,36,3,33,富邦-新營,2023-12-04,9693
3013,晟銘電,62,31,31,富邦-新營,2023-12-04,9693
00687B,國泰20年美債,32,4,28,富邦-新營,2023-12-04,9693
1339,昭輝,24,0,24,富邦-新營,2023-12-04,9693
2329,華泰,139,116,23,富邦-新營,2023-12-04,9693
2834,臺企銀,22,0,22,富邦-新營,2023-12-04,9693
2376,技嘉,21,0,21,富邦-新營,2023-12-04,9693
4961,天鈺,22,2,20,富邦-新營,2023-12-04,9693
2606,裕民,140,120,20,富邦-新營,2023-12-04,9693
00720B,元大投資級公司債,20,0,20,富邦-新營,2023-12-04,9693
00915,凱基優選高股息30,18,1,17,富邦-新營,2023-12-04,9693
4114,健喬,17,0,17,富邦-新營,2023-12-04,9693
2002,中鋼,20,4,16,富邦-新營,2023-12-04,9693
4109,加捷生醫,15,0,15,富邦-新營,2023-12-04,9693
00753L,中信中國50正2,15,0,15,富邦-新營,2023-12-04,9693
6933,AMAX-KY,13,0,13,富邦-新營,2023-12-04,9693
4909,新復興,16,3,13,富邦-新營,2023-12-04,9693
00900,富邦特選高股息30,10,0,10,富邦-新營,2023-12-04,9693
2913,農林,15,5,10,富邦-新營,2023-12-04,9693
00642U,期元大S＆P石油,10,0,10,富邦-新營,2023-12-04,9693
2801,彰銀,10,0,10,富邦-新營,2023-12-04,9693
3163,波若威,10,0,10,富邦-新營,2023-12-04,9693
3706,神達,15,5,10,富邦-新營,2023-12-04,9693
5324,士開,10,0,10,富邦-新營,2023-12-04,9693
8261,富鼎,10,0,10,富邦-新營,2023-12-04,9693
4960,誠美材,10,1,9,富邦-新營,2023-12-04,9693
2630,亞航,9,0,9,富邦-新營,2023-12-04,9693
6122,擎邦,9,0,9,富邦-新營,2023-12-04,9693
6125,廣運,98,89,9,富邦-新營,2023-12-04,9693
00881,國泰台灣5G+,10,1,9,富邦-新營,2023-12-04,9693
2356,英業達,13,5,8,富邦-新營,2023-12-04,9693
2382,廣達,10,2,8,富邦-新營,2023-12-04,9693
2401,凌陽,8,0,8,富邦-新營,2023-12-04,9693
2739,寒舍,10,2,8,富邦-新營,2023-12-04,9693
2867,三商壽,7,0,7,富邦-新營,2023-12-04,9693
6275,元山,8,1,7,富邦-新營,2023-12-04,9693
00918,大華優利高填息30,327,0,327,富邦-新營,2023-12-05,9693
00919,群益台灣精選高息,200,26,174,富邦-新營,2023-12-05,9693
00665L,富邦�琤肭磪囓�2,115,1,114,富邦-新營,2023-12-05,9693
4909,新復興,107,19,88,富邦-新營,2023-12-05,9693
00929,復華台灣科技優息,77,19,58,富邦-新營,2023-12-05,9693
00937B,群益ESG投等債20,138,84,54,富邦-新營,2023-12-05,9693
2601,益航,51,0,51,富邦-新營,2023-12-05,9693
00715L,期街口布蘭特正2,41,0,41,富邦-新營,2023-12-05,9693
3013,晟銘電,44,5,39,富邦-新營,2023-12-05,9693
2641,正德,67,30,37,富邦-新營,2023-12-05,9693
5347,世界,35,0,35,富邦-新營,2023-12-05,9693
6114,久威,29,0,29,富邦-新營,2023-12-05,9693
00882,中信中國高股息,26,0,26,富邦-新營,2023-12-05,9693
2312,金寶,24,0,24,富邦-新營,2023-12-05,9693
2883,凱基金,25,2,23,富邦-新營,2023-12-05,9693
00713,元大台灣高息低波,22,0,22,富邦-新營,2023-12-05,9693
3147,大綜,22,0,22,富邦-新營,2023-12-05,9693
00753L,中信中國50正2,20,0,20,富邦-新營,2023-12-05,9693
1905,華紙,20,0,20,富邦-新營,2023-12-05,9693
2888,新光金,19,0,19,富邦-新營,2023-12-05,9693
5426,振發,20,2,18,富邦-新營,2023-12-05,9693
2101,南港,20,4,16,富邦-新營,2023-12-05,9693
00878,國泰永續高股息,20,4,16,富邦-新營,2023-12-05,9693
1605,華新,19,4,15,富邦-新營,2023-12-05,9693
2329,華泰,193,178,15,富邦-新營,2023-12-05,9693
2929,淘帝-KY,20,5,15,富邦-新營,2023-12-05,9693
2617,台航,49,35,14,富邦-新營,2023-12-05,9693
00692,富邦公司治理,13,0,13,富邦-新營,2023-12-05,9693
00923,群益台ESG低碳50,13,0,13,富邦-新營,2023-12-05,9693
1504,東元,13,0,13,富邦-新營,2023-12-05,9693
2367,燿華,19,6,13,富邦-新營,2023-12-05,9693
2489,瑞軒,13,0,13,富邦-新營,2023-12-05,9693
3576,聯合再生,25,13,12,富邦-新營,2023-12-05,9693
8429,金麗-KY,25,13,12,富邦-新營,2023-12-05,9693
5880,合庫金,12,0,12,富邦-新營,2023-12-05,9693
1701,中化,12,1,11,富邦-新營,2023-12-05,9693
2482,連宇,11,0,11,富邦-新營,2023-12-05,9693
4167,松瑞藥,22,11,11,富邦-新營,2023-12-05,9693
6806,森崴能源,13,3,10,富邦-新營,2023-12-05,9693
00920,富邦ESG綠色電力,10,0,10,富邦-新營,2023-12-05,9693
2390,云辰,10,0,10,富邦-新營,2023-12-05,9693
2605,新興,48,38,10,富邦-新營,2023-12-05,9693
2356,英業達,11,2,9,富邦-新營,2023-12-05,9693
2332,友訊,12,3,9,富邦-新營,2023-12-05,9693
1618,合機,9,0,9,富邦-新營,2023-12-05,9693
2891,中信金,10,2,8,富邦-新營,2023-12-05,9693
1786,科妍,8,0,8,富邦-新營,2023-12-05,9693
2739,寒舍,10,2,8,富邦-新營,2023-12-05,9693
5443,均豪,9,1,8,富邦-新營,2023-12-05,9693
8086,宏捷科,17,9,8,富邦-新營,2023-12-05,9693
00918,大華優利高填息30,143,0,143,富邦-新營,2023-12-06,9693
00795B,中信美國公債20年,138,7,131,富邦-新營,2023-12-06,9693
00706L,期元大S＆P日圓正2,116,0,116,富邦-新營,2023-12-06,9693
00937B,群益ESG投等債20,84,8,76,富邦-新營,2023-12-06,9693
00722B,群益投資級電信債,30,0,30,富邦-新營,2023-12-06,9693
2645,長榮航太,30,0,30,富邦-新營,2023-12-06,9693
2419,仲琦,35,6,29,富邦-新營,2023-12-06,9693
2611,志信,25,2,23,富邦-新營,2023-12-06,9693
00923,群益台ESG低碳50,21,0,21,富邦-新營,2023-12-06,9693
1605,華新,23,2,21,富邦-新營,2023-12-06,9693
2303,聯電,24,4,20,富邦-新營,2023-12-06,9693
00922,國泰台灣領袖50,20,0,20,富邦-新營,2023-12-06,9693
00753L,中信中國50正2,20,0,20,富邦-新營,2023-12-06,9693
2905,三商,20,0,20,富邦-新營,2023-12-06,9693
5272,笙科,33,14,19,富邦-新營,2023-12-06,9693
6117,迎廣,35,17,18,富邦-新營,2023-12-06,9693
2349,錸德,17,0,17,富邦-新營,2023-12-06,9693
1440,南紡,23,7,16,富邦-新營,2023-12-06,9693
2329,華泰,123,108,15,富邦-新營,2023-12-06,9693
00688L,國泰20年美債正2,15,0,15,富邦-新營,2023-12-06,9693
5302,太欣,15,0,15,富邦-新營,2023-12-06,9693
2603,長榮,16,2,14,富邦-新營,2023-12-06,9693
00931B,統一美債20年,14,0,14,富邦-新營,2023-12-06,9693
3390,旭軟,16,2,14,富邦-新營,2023-12-06,9693
00882,中信中國高股息,13,0,13,富邦-新營,2023-12-06,9693
2363,矽統,13,0,13,富邦-新營,2023-12-06,9693
2367,燿華,25,13,12,富邦-新營,2023-12-06,9693
3706,神達,13,1,12,富邦-新營,2023-12-06,9693
4552,力達-KY,12,0,12,富邦-新營,2023-12-06,9693
4563,百德,12,0,12,富邦-新營,2023-12-06,9693
1720,生達,16,5,11,富邦-新營,2023-12-06,9693
2605,新興,36,25,11,富邦-新營,2023-12-06,9693
00878,國泰永續高股息,23,12,11,富邦-新營,2023-12-06,9693
3443,創意,27,16,11,富邦-新營,2023-12-06,9693
1727,中華化,11,0,11,富邦-新營,2023-12-06,9693
4109,加捷生醫,11,0,11,富邦-新營,2023-12-06,9693
00933B,國泰10Y+金融債,10,0,10,富邦-新營,2023-12-06,9693
4167,松瑞藥,14,4,10,富邦-新營,2023-12-06,9693
5864,致和證,10,0,10,富邦-新營,2023-12-06,9693
00712,復華富時不動產,13,4,9,富邦-新營,2023-12-06,9693
2376,技嘉,15,6,9,富邦-新營,2023-12-06,9693
1514,亞力,28,19,9,富邦-新營,2023-12-06,9693
3050,鈺德,19,10,9,富邦-新營,2023-12-06,9693
00687B,國泰20年美債,10,2,8,富邦-新營,2023-12-06,9693
006205,富邦上証,10,2,8,富邦-新營,2023-12-06,9693
3594,磐儀,8,0,8,富邦-新營,2023-12-06,9693
6182,合晶,8,0,8,富邦-新營,2023-12-06,9693
2355,敬鵬,231,224,7,富邦-新營,2023-12-06,9693
2617,台航,8,1,7,富邦-新營,2023-12-06,9693
3321,同泰,7,0,7,富邦-新營,2023-12-06,9693
00665L,富邦�琤肭磪囓�2,204,3,201,富邦-新營,2023-12-07,9693
00937B,群益ESG投等債20,281,102,179,富邦-新營,2023-12-07,9693
00687B,國泰20年美債,189,21,168,富邦-新營,2023-12-07,9693
00918,大華優利高填息30,96,0,96,富邦-新營,2023-12-07,9693
00712,復華富時不動產,79,0,79,富邦-新營,2023-12-07,9693
00679B,元大美債20年,84,7,77,富邦-新營,2023-12-07,9693
2888,新光金,50,0,50,富邦-新營,2023-12-07,9693
2485,兆赫,45,0,45,富邦-新營,2023-12-07,9693
2882,國泰金,43,0,43,富邦-新營,2023-12-07,9693
00715L,期街口布蘭特正2,43,0,43,富邦-新營,2023-12-07,9693
00676R,富邦臺灣加權反1,40,0,40,富邦-新營,2023-12-07,9693
9907,統一實,41,3,38,富邦-新營,2023-12-07,9693
3041,揚智,43,13,30,富邦-新營,2023-12-07,9693
2367,燿華,36,9,27,富邦-新營,2023-12-07,9693
00929,復華台灣科技優息,31,4,27,富邦-新營,2023-12-07,9693
00882,中信中國高股息,27,0,27,富邦-新營,2023-12-07,9693
4906,正文,30,7,23,富邦-新營,2023-12-07,9693
2618,長榮航,24,2,22,富邦-新營,2023-12-07,9693
5009,榮剛,22,0,22,富邦-新營,2023-12-07,9693
4806,桂田文創,21,0,21,富邦-新營,2023-12-07,9693
00688L,國泰20年美債正2,20,0,20,富邦-新營,2023-12-07,9693
2355,敬鵬,25,5,20,富邦-新營,2023-12-07,9693
2739,寒舍,20,0,20,富邦-新營,2023-12-07,9693
6770,力積電,20,0,20,富邦-新營,2023-12-07,9693
00931B,統一美債20年,21,2,19,富邦-新營,2023-12-07,9693
6194,育富,20,1,19,富邦-新營,2023-12-07,9693
1319,東陽,28,10,18,富邦-新營,2023-12-07,9693
6284,佳邦,17,0,17,富邦-新營,2023-12-07,9693
8936,國統,20,3,17,富邦-新營,2023-12-07,9693
2324,仁寶,22,6,16,富邦-新營,2023-12-07,9693
2332,友訊,16,0,16,富邦-新營,2023-12-07,9693
1504,東元,18,5,13,富邦-新營,2023-12-07,9693
2605,新興,20,7,13,富邦-新營,2023-12-07,9693
2303,聯電,15,3,12,富邦-新營,2023-12-07,9693
1616,億泰,16,4,12,富邦-新營,2023-12-07,9693
1718,中纖,12,0,12,富邦-新營,2023-12-07,9693
2359,所羅門,114,102,12,富邦-新營,2023-12-07,9693
1603,華電,11,0,11,富邦-新營,2023-12-07,9693
8054,安國,21,10,11,富邦-新營,2023-12-07,9693
00664R,國泰臺灣加權反1,10,0,10,富邦-新營,2023-12-07,9693
2465,麗臺,10,0,10,富邦-新營,2023-12-07,9693
2516,新建,10,0,10,富邦-新營,2023-12-07,9693
3006,晶豪科,11,1,10,富邦-新營,2023-12-07,9693
3046,建��,10,0,10,富邦-新營,2023-12-07,9693
3701,大眾控,10,0,10,富邦-新營,2023-12-07,9693
8176,智捷,10,0,10,富邦-新營,2023-12-07,9693
8420,明揚,10,0,10,富邦-新營,2023-12-07,9693
2201,裕隆,10,1,9,富邦-新營,2023-12-07,9693
00900,富邦特選高股息30,10,2,8,富邦-新營,2023-12-07,9693
1618,合機,12,4,8,富邦-新營,2023-12-07,9693
00706L,期元大S＆P日圓正2,121,1,120,富邦-新營,2023-12-08,9693
6116,彩晶,90,0,90,富邦-新營,2023-12-08,9693
00937B,群益ESG投等債20,96,22,74,富邦-新營,2023-12-08,9693
2241,艾姆勒,73,1,72,富邦-新營,2023-12-08,9693
1514,亞力,54,19,35,富邦-新營,2023-12-08,9693
00882,中信中國高股息,31,0,31,富邦-新營,2023-12-08,9693
1440,南紡,31,2,29,富邦-新營,2023-12-08,9693
2888,新光金,29,1,28,富邦-新營,2023-12-08,9693
00679B,元大美債20年,26,0,26,富邦-新營,2023-12-08,9693
5009,榮剛,25,0,25,富邦-新營,2023-12-08,9693
6024,群益期,24,0,24,富邦-新營,2023-12-08,9693
4806,桂田文創,20,0,20,富邦-新營,2023-12-08,9693
00715L,期街口布蘭特正2,24,4,20,富邦-新營,2023-12-08,9693
4939,亞電,20,1,19,富邦-新營,2023-12-08,9693
2358,廷鑫,17,0,17,富邦-新營,2023-12-08,9693
00687B,國泰20年美債,17,2,15,富邦-新營,2023-12-08,9693
2363,矽統,16,1,15,富邦-新營,2023-12-08,9693
4167,松瑞藥,19,4,15,富邦-新營,2023-12-08,9693
1409,新纖,14,0,14,富邦-新營,2023-12-08,9693
1609,大亞,22,8,14,富邦-新營,2023-12-08,9693
1616,億泰,18,4,14,富邦-新營,2023-12-08,9693
6233,旺玖,20,7,13,富邦-新營,2023-12-08,9693
2303,聯電,15,2,13,富邦-新營,2023-12-08,9693
1524,耿鼎,52,40,12,富邦-新營,2023-12-08,9693
2449,京元電子,19,8,11,富邦-新營,2023-12-08,9693
3545,敦泰,12,1,11,富邦-新營,2023-12-08,9693
5512,力麒,20,9,11,富邦-新營,2023-12-08,9693
00637L,元大滬深300正2,10,0,10,富邦-新營,2023-12-08,9693
1314,中石化,10,0,10,富邦-新營,2023-12-08,9693
2601,益航,10,0,10,富邦-新營,2023-12-08,9693
3013,晟銘電,15,5,10,富邦-新營,2023-12-08,9693
6015,宏遠證,11,1,10,富邦-新營,2023-12-08,9693
3231,緯創,16,7,9,富邦-新營,2023-12-08,9693
1608,華榮,11,2,9,富邦-新營,2023-12-08,9693
2208,台船,9,0,9,富邦-新營,2023-12-08,9693
00633L,富邦上証正2,22,14,8,富邦-新營,2023-12-08,9693
6217,中探針,8,0,8,富邦-新營,2023-12-08,9693
6770,力積電,8,0,8,富邦-新營,2023-12-08,9693
3260,威剛,14,6,8,富邦-新營,2023-12-08,9693
2344,華邦電,7,0,7,富邦-新營,2023-12-08,9693
8034,榮群,7,0,7,富邦-新營,2023-12-08,9693
1720,生達,6,0,6,富邦-新營,2023-12-08,9693
1786,科妍,6,0,6,富邦-新營,2023-12-08,9693
2401,凌陽,26,20,6,富邦-新營,2023-12-08,9693
2376,技嘉,23,18,5,富邦-新營,2023-12-08,9693
00632R,元大台灣50反1,5,0,5,富邦-新營,2023-12-08,9693
00665L,富邦�琤肭磪囓�2,5,0,5,富邦-新營,2023-12-08,9693
00688L,國泰20年美債正2,5,0,5,富邦-新營,2023-12-08,9693
1568,倉佑,8,3,5,富邦-新營,2023-12-08,9693
1718,中纖,5,0,5,富邦-新營,2023-12-08,9693
00687B,國泰20年美債,111,0,111,富邦-新營,2023-12-11,9693
00665L,富邦�琤肭磪囓�2,107,0,107,富邦-新營,2023-12-11,9693
2888,新光金,103,2,101,富邦-新營,2023-12-11,9693
2913,農林,77,7,70,富邦-新營,2023-12-11,9693
00753L,中信中國50正2,65,0,65,富邦-新營,2023-12-11,9693
00937B,群益ESG投等債20,110,49,61,富邦-新營,2023-12-11,9693
00919,群益台灣精選高息,55,0,55,富邦-新營,2023-12-11,9693
5340,建榮,40,0,40,富邦-新營,2023-12-11,9693
00715L,期街口布蘭特正2,40,1,39,富邦-新營,2023-12-11,9693
00680L,元大美債20正2,38,0,38,富邦-新營,2023-12-11,9693
2618,長榮航,37,7,30,富邦-新營,2023-12-11,9693
2002,中鋼,40,13,27,富邦-新營,2023-12-11,9693
1524,耿鼎,243,218,25,富邦-新營,2023-12-11,9693
2609,陽明,24,1,23,富邦-新營,2023-12-11,9693
2365,昆盈,32,12,20,富邦-新營,2023-12-11,9693
2388,威盛,36,16,20,富邦-新營,2023-12-11,9693
2401,凌陽,20,0,20,富邦-新營,2023-12-11,9693
3390,旭軟,20,0,20,富邦-新營,2023-12-11,9693
2408,南亞科,15,0,15,富邦-新營,2023-12-11,9693
3231,緯創,20,6,14,富邦-新營,2023-12-11,9693
1605,華新,13,0,13,富邦-新營,2023-12-11,9693
2834,臺企銀,22,10,12,富邦-新營,2023-12-11,9693
1785,光洋科,11,0,11,富邦-新營,2023-12-11,9693
8429,金麗-KY,11,0,11,富邦-新營,2023-12-11,9693
00662,富邦NASDAQ,10,0,10,富邦-新營,2023-12-11,9693
1733,五鼎,10,0,10,富邦-新營,2023-12-11,9693
2312,金寶,22,12,10,富邦-新營,2023-12-11,9693
3006,晶豪科,13,3,10,富邦-新營,2023-12-11,9693
6477,安集,10,0,10,富邦-新營,2023-12-11,9693
9919,康那香,11,1,10,富邦-新營,2023-12-11,9693
3443,創意,14,4,10,富邦-新營,2023-12-11,9693
00795B,中信美國公債20年,10,0,10,富邦-新營,2023-12-11,9693
2371,大同,15,5,10,富邦-新營,2023-12-11,9693
4906,正文,8,0,8,富邦-新營,2023-12-11,9693
5009,榮剛,8,1,7,富邦-新營,2023-12-11,9693
00706L,期元大S＆P日圓正2,7,0,7,富邦-新營,2023-12-11,9693
00688L,國泰20年美債正2,7,0,7,富邦-新營,2023-12-11,9693
1515,力山,7,0,7,富邦-新營,2023-12-11,9693
3013,晟銘電,13,6,7,富邦-新營,2023-12-11,9693
5519,隆大,7,0,7,富邦-新營,2023-12-11,9693
6547,高端疫苗,8,1,7,富邦-新營,2023-12-11,9693
00929,復華台灣科技優息,42,36,6,富邦-新營,2023-12-11,9693
2317,鴻海,11,5,6,富邦-新營,2023-12-11,9693
1815,富喬,6,0,6,富邦-新營,2023-12-11,9693
2881,富邦金,6,0,6,富邦-新營,2023-12-11,9693
3715,定穎投控,7,2,5,富邦-新營,2023-12-11,9693
00637L,元大滬深300正2,5,0,5,富邦-新營,2023-12-11,9693
1466,聚隆,5,0,5,富邦-新營,2023-12-11,9693
1608,華榮,6,1,5,富邦-新營,2023-12-11,9693
2314,台揚,5,0,5,富邦-新營,2023-12-11,9693
00919,群益台灣精選高息,231,11,220,富邦-新營,2023-12-12,9693
00687B,國泰20年美債,115,0,115,富邦-新營,2023-12-12,9693
00936,台新永續高息中小,106,0,106,富邦-新營,2023-12-12,9693
00937B,群益ESG投等債20,88,3,85,富邦-新營,2023-12-12,9693
2313,華通,74,13,61,富邦-新營,2023-12-12,9693
00712,復華富時不動產,60,0,60,富邦-新營,2023-12-12,9693
2241,艾姆勒,33,0,33,富邦-新營,2023-12-12,9693
6115,鎰勝,32,0,32,富邦-新營,2023-12-12,9693
1612,宏泰,31,6,25,富邦-新營,2023-12-12,9693
2344,華邦電,23,1,22,富邦-新營,2023-12-12,9693
2402,毅嘉,30,8,22,富邦-新營,2023-12-12,9693
2542,興富發,21,0,21,富邦-新營,2023-12-12,9693
2883,凱基金,21,0,21,富邦-新營,2023-12-12,9693
00918,大華優利高填息30,18,0,18,富邦-新營,2023-12-12,9693
00679B,元大美債20年,19,1,18,富邦-新營,2023-12-12,9693
1314,中石化,17,0,17,富邦-新營,2023-12-12,9693
3033,威健,17,0,17,富邦-新營,2023-12-12,9693
2867,三商壽,16,0,16,富邦-新營,2023-12-12,9693
00713,元大台灣高息低波,25,9,16,富邦-新營,2023-12-12,9693
1618,合機,38,23,15,富邦-新營,2023-12-12,9693
8034,榮群,119,104,15,富邦-新營,2023-12-12,9693
2618,長榮航,17,5,12,富邦-新營,2023-12-12,9693
3694,海華,12,0,12,富邦-新營,2023-12-12,9693
00720B,元大投資級公司債,13,2,11,富邦-新營,2023-12-12,9693
00882,中信中國高股息,21,10,11,富邦-新營,2023-12-12,9693
00772B,中信高評級公司債,12,1,11,富邦-新營,2023-12-12,9693
1605,華新,15,4,11,富邦-新營,2023-12-12,9693
2363,矽統,13,2,11,富邦-新營,2023-12-12,9693
2002,中鋼,18,8,10,富邦-新營,2023-12-12,9693
5706,鳳凰,10,0,10,富邦-新營,2023-12-12,9693
00795B,中信美國公債20年,10,0,10,富邦-新營,2023-12-12,9693
1734,杏輝,10,0,10,富邦-新營,2023-12-12,9693
2358,廷鑫,10,0,10,富邦-新營,2023-12-12,9693
2615,萬海,12,2,10,富邦-新營,2023-12-12,9693
3023,信邦,10,0,10,富邦-新營,2023-12-12,9693
3390,旭軟,10,0,10,富邦-新營,2023-12-12,9693
6605,帝寶,10,0,10,富邦-新營,2023-12-12,9693
3532,台勝科,10,0,10,富邦-新營,2023-12-12,9693
1609,大亞,16,6,10,富邦-新營,2023-12-12,9693
1904,正隆,9,0,9,富邦-新營,2023-12-12,9693
2609,陽明,13,4,9,富邦-新營,2023-12-12,9693
6741,91APP*-KY,9,0,9,富邦-新營,2023-12-12,9693
8054,安國,9,1,8,富邦-新營,2023-12-12,9693
1608,華榮,26,18,8,富邦-新營,2023-12-12,9693
2539,櫻花建,7,0,7,富邦-新營,2023-12-12,9693
1432,大魯閣,8,1,7,富邦-新營,2023-12-12,9693
1909,榮成,7,0,7,富邦-新營,2023-12-12,9693
8358,金居,8,1,7,富邦-新營,2023-12-12,9693
3380,明泰,7,1,6,富邦-新營,2023-12-12,9693
6271,同欣電,7,1,6,富邦-新營,2023-12-12,9693
00715L,期街口布蘭特正2,124,1,123,富邦-新營,2023-12-13,9693
00918,大華優利高填息30,97,0,97,富邦-新營,2023-12-13,9693
00919,群益台灣精選高息,72,9,63,富邦-新營,2023-12-13,9693
00937B,群益ESG投等債20,51,0,51,富邦-新營,2023-12-13,9693
2241,艾姆勒,48,0,48,富邦-新營,2023-12-13,9693
2883,凱基金,31,1,30,富邦-新營,2023-12-13,9693
2887,台新金,29,0,29,富邦-新營,2023-12-13,9693
3706,神達,139,111,28,富邦-新營,2023-12-13,9693
2618,長榮航,30,4,26,富邦-新營,2023-12-13,9693
00933B,國泰10Y+金融債,25,0,25,富邦-新營,2023-12-13,9693
00882,中信中國高股息,23,0,23,富邦-新營,2023-12-13,9693
1216,統一,21,0,21,富邦-新營,2023-12-13,9693
5432,新門,32,11,21,富邦-新營,2023-12-13,9693
1532,勤美,20,0,20,富邦-新營,2023-12-13,9693
00687B,國泰20年美債,19,0,19,富邦-新營,2023-12-13,9693
6282,康舒,19,0,19,富邦-新營,2023-12-13,9693
9105,泰金寶-DR,21,3,18,富邦-新營,2023-12-13,9693
2201,裕隆,17,0,17,富邦-新營,2023-12-13,9693
00934,中信成長高股息,17,0,17,富邦-新營,2023-12-13,9693
1524,耿鼎,16,0,16,富邦-新營,2023-12-13,9693
3231,緯創,26,11,15,富邦-新營,2023-12-13,9693
8110,華東,15,0,15,富邦-新營,2023-12-13,9693
00679B,元大美債20年,18,5,13,富邦-新營,2023-12-13,9693
2002,中鋼,18,7,11,富邦-新營,2023-12-13,9693
2606,裕民,13,2,11,富邦-新營,2023-12-13,9693
9919,康那香,13,2,11,富邦-新營,2023-12-13,9693
3437,榮創,10,0,10,富邦-新營,2023-12-13,9693
1324,地球,10,0,10,富邦-新營,2023-12-13,9693
2312,金寶,240,230,10,富邦-新營,2023-12-13,9693
5469,瀚宇博,10,0,10,富邦-新營,2023-12-13,9693
6104,創惟,9,0,9,富邦-新營,2023-12-13,9693
2601,益航,10,1,9,富邦-新營,2023-12-13,9693
6191,精成科,10,1,9,富邦-新營,2023-12-13,9693
6290,良維,10,1,9,富邦-新營,2023-12-13,9693
2539,櫻花建,8,0,8,富邦-新營,2023-12-13,9693
2303,聯電,25,17,8,富邦-新營,2023-12-13,9693
6288,聯嘉,10,2,8,富邦-新營,2023-12-13,9693
5521,工信,9,2,7,富邦-新營,2023-12-13,9693
6241,易通展,7,0,7,富邦-新營,2023-12-13,9693
1584,精剛,31,24,7,富邦-新營,2023-12-13,9693
1326,台化,6,0,6,富邦-新營,2023-12-13,9693
00637L,元大滬深300正2,6,0,6,富邦-新營,2023-12-13,9693
2382,廣達,6,1,5,富邦-新營,2023-12-13,9693
00753L,中信中國50正2,5,0,5,富邦-新營,2023-12-13,9693
00688L,國泰20年美債正2,5,0,5,富邦-新營,2023-12-13,9693
1904,正隆,5,0,5,富邦-新營,2023-12-13,9693
2371,大同,9,4,5,富邦-新營,2023-12-13,9693
2484,希華,5,0,5,富邦-新營,2023-12-13,9693
3027,盛達,5,0,5,富邦-新營,2023-12-13,9693
3322,建舜電,5,0,5,富邦-新營,2023-12-13,9693
3390,旭軟,183,24,159,富邦-新營,2023-12-14,9693
00937B,群益ESG投等債20,127,26,101,富邦-新營,2023-12-14,9693
1326,台化,62,1,61,富邦-新營,2023-12-14,9693
6117,迎廣,60,2,58,富邦-新營,2023-12-14,9693
00687B,國泰20年美債,55,0,55,富邦-新營,2023-12-14,9693
00929,復華台灣科技優息,93,42,51,富邦-新營,2023-12-14,9693
2241,艾姆勒,35,0,35,富邦-新營,2023-12-14,9693
6770,力積電,30,0,30,富邦-新營,2023-12-14,9693
1536,和大,30,0,30,富邦-新營,2023-12-14,9693
2515,中工,39,12,27,富邦-新營,2023-12-14,9693
00918,大華優利高填息30,26,1,25,富邦-新營,2023-12-14,9693
1314,中石化,20,0,20,富邦-新營,2023-12-14,9693
6233,旺玖,23,4,19,富邦-新營,2023-12-14,9693
00934,中信成長高股息,20,2,18,富邦-新營,2023-12-14,9693
00919,群益台灣精選高息,23,7,16,富邦-新營,2023-12-14,9693
2913,農林,17,1,16,富邦-新營,2023-12-14,9693
00680L,元大美債20正2,20,5,15,富邦-新營,2023-12-14,9693
00679B,元大美債20年,14,0,14,富邦-新營,2023-12-14,9693
00795B,中信美國公債20年,13,0,13,富邦-新營,2023-12-14,9693
8112,至上,15,2,13,富邦-新營,2023-12-14,9693
2516,新建,14,2,12,富邦-新營,2023-12-14,9693
1584,精剛,11,0,11,富邦-新營,2023-12-14,9693
00633L,富邦上証正2,11,0,11,富邦-新營,2023-12-14,9693
00751B,元大AAA至A公司債,11,0,11,富邦-新營,2023-12-14,9693
1591,駿吉-KY,11,0,11,富邦-新營,2023-12-14,9693
3694,海華,11,0,11,富邦-新營,2023-12-14,9693
8011,台通,11,0,11,富邦-新營,2023-12-14,9693
1319,東陽,11,0,11,富邦-新營,2023-12-14,9693
1309,台達化,10,0,10,富邦-新營,2023-12-14,9693
1417,嘉裕,10,0,10,富邦-新營,2023-12-14,9693
2637,慧洋-KY,10,0,10,富邦-新營,2023-12-14,9693
5512,力麒,16,6,10,富邦-新營,2023-12-14,9693
8034,榮群,10,0,10,富邦-新營,2023-12-14,9693
2332,友訊,9,0,9,富邦-新營,2023-12-14,9693
2383,台光電,9,0,9,富邦-新營,2023-12-14,9693
2419,仲琦,11,2,9,富邦-新營,2023-12-14,9693
3025,星通,15,6,9,富邦-新營,2023-12-14,9693
00772B,中信高評級公司債,10,1,9,富邦-新營,2023-12-14,9693
00720B,元大投資級公司債,12,4,8,富邦-新營,2023-12-14,9693
2329,華泰,51,43,8,富邦-新營,2023-12-14,9693
2365,昆盈,33,25,8,富邦-新營,2023-12-14,9693
4167,松瑞藥,10,2,8,富邦-新營,2023-12-14,9693
8044,網家,8,0,8,富邦-新營,2023-12-14,9693
2609,陽明,9,2,7,富邦-新營,2023-12-14,9693
5009,榮剛,9,2,7,富邦-新營,2023-12-14,9693
3051,力特,11,4,7,富邦-新營,2023-12-14,9693
00931B,統一美債20年,6,0,6,富邦-新營,2023-12-14,9693
5292,華懋,6,0,6,富邦-新營,2023-12-14,9693
00753L,中信中國50正2,6,0,6,富邦-新營,2023-12-14,9693
00933B,國泰10Y+金融債,6,0,6,富邦-新營,2023-12-14,9693
2356,英業達,280,137,143,富邦-新營,2023-12-15,9693
00679B,元大美債20年,109,1,108,富邦-新營,2023-12-15,9693
00688L,國泰20年美債正2,90,1,89,富邦-新營,2023-12-15,9693
00919,群益台灣精選高息,156,94,62,富邦-新營,2023-12-15,9693
3686,達能,47,0,47,富邦-新營,2023-12-15,9693
00934,中信成長高股息,51,6,45,富邦-新營,2023-12-15,9693
00929,復華台灣科技優息,51,8,43,富邦-新營,2023-12-15,9693
00915,凱基優選高股息30,33,0,33,富邦-新營,2023-12-15,9693
2363,矽統,85,53,32,富邦-新營,2023-12-15,9693
6127,九豪,33,1,32,富邦-新營,2023-12-15,9693
00696B,富邦美債20年,31,0,31,富邦-新營,2023-12-15,9693
5864,致和證,30,0,30,富邦-新營,2023-12-15,9693
00918,大華優利高填息30,28,6,22,富邦-新營,2023-12-15,9693
2002,中鋼,69,47,22,富邦-新營,2023-12-15,9693
2465,麗臺,23,3,20,富邦-新營,2023-12-15,9693
6016,康和證,22,2,20,富邦-新營,2023-12-15,9693
00878,國泰永續高股息,26,7,19,富邦-新營,2023-12-15,9693
9105,泰金寶-DR,20,2,18,富邦-新營,2023-12-15,9693
2317,鴻海,20,3,17,富邦-新營,2023-12-15,9693
2547,日勝生,17,0,17,富邦-新營,2023-12-15,9693
2891,中信金,22,5,17,富邦-新營,2023-12-15,9693
4188,安克,15,0,15,富邦-新營,2023-12-15,9693
6182,合晶,23,8,15,富邦-新營,2023-12-15,9693
00933B,國泰10Y+金融債,13,0,13,富邦-新營,2023-12-15,9693
2313,華通,12,0,12,富邦-新營,2023-12-15,9693
2371,大同,13,1,12,富邦-新營,2023-12-15,9693
1101,台泥,11,0,11,富邦-新營,2023-12-15,9693
2606,裕民,12,1,11,富邦-新營,2023-12-15,9693
2412,中華電,10,0,10,富邦-新營,2023-12-15,9693
00637L,元大滬深300正2,60,50,10,富邦-新營,2023-12-15,9693
00905,FT臺灣Smart,10,0,10,富邦-新營,2023-12-15,9693
3701,大眾控,10,0,10,富邦-新營,2023-12-15,9693
4109,加捷生醫,11,1,10,富邦-新營,2023-12-15,9693
4168,醣聯,10,0,10,富邦-新營,2023-12-15,9693
5324,士開,10,0,10,富邦-新營,2023-12-15,9693
6015,宏遠證,10,0,10,富邦-新營,2023-12-15,9693
2385,群光,10,0,10,富邦-新營,2023-12-15,9693
2886,兆豐金,10,1,9,富邦-新營,2023-12-15,9693
6005,群益證,10,1,9,富邦-新營,2023-12-15,9693
6235,華孚,10,1,9,富邦-新營,2023-12-15,9693
1785,光洋科,10,1,9,富邦-新營,2023-12-15,9693
2027,大成鋼,27,20,7,富邦-新營,2023-12-15,9693
00937B,群益ESG投等債20,14,7,7,富邦-新營,2023-12-15,9693
3023,信邦,7,0,7,富邦-新營,2023-12-15,9693
3265,台星科,9,2,7,富邦-新營,2023-12-15,9693
6456,GIS-KY,7,0,7,富邦-新營,2023-12-15,9693
00923,群益台ESG低碳50,7,0,7,富邦-新營,2023-12-15,9693
2419,仲琦,7,1,6,富邦-新營,2023-12-15,9693
2352,佳世達,6,0,6,富邦-新營,2023-12-15,9693
00885,富邦越南,8,2,6,富邦-新營,2023-12-15,9693
00929,復華台灣科技優息,182,75,107,富邦-新營,2023-12-18,9693
00687B,國泰20年美債,101,0,101,富邦-新營,2023-12-18,9693
00679B,元大美債20年,94,0,94,富邦-新營,2023-12-18,9693
00919,群益台灣精選高息,109,38,71,富邦-新營,2023-12-18,9693
2344,華邦電,81,18,63,富邦-新營,2023-12-18,9693
00918,大華優利高填息30,51,0,51,富邦-新營,2023-12-18,9693
2356,英業達,56,6,50,富邦-新營,2023-12-18,9693
9105,泰金寶-DR,50,8,42,富邦-新營,2023-12-18,9693
00720B,元大投資級公司債,40,0,40,富邦-新營,2023-12-18,9693
2030,彰源,33,0,33,富邦-新營,2023-12-18,9693
2241,艾姆勒,33,0,33,富邦-新營,2023-12-18,9693
00712,復華富時不動產,31,0,31,富邦-新營,2023-12-18,9693
3706,神達,33,5,28,富邦-新營,2023-12-18,9693
2618,長榮航,36,9,27,富邦-新營,2023-12-18,9693
2023,燁輝,27,1,26,富邦-新營,2023-12-18,9693
2002,中鋼,38,15,23,富邦-新營,2023-12-18,9693
5521,工信,162,139,23,富邦-新營,2023-12-18,9693
1605,華新,47,24,23,富邦-新營,2023-12-18,9693
3051,力特,21,1,20,富邦-新營,2023-12-18,9693
1584,精剛,18,1,17,富邦-新營,2023-12-18,9693
1440,南紡,17,2,15,富邦-新營,2023-12-18,9693
00931B,統一美債20年,14,0,14,富邦-新營,2023-12-18,9693
910861,神州-DR,13,0,13,富邦-新營,2023-12-18,9693
00935,野村臺灣新科技50,13,0,13,富邦-新營,2023-12-18,9693
00878,國泰永續高股息,14,1,13,富邦-新營,2023-12-18,9693
00936,台新永續高息中小,12,0,12,富邦-新營,2023-12-18,9693
2208,台船,12,0,12,富邦-新營,2023-12-18,9693
2014,中鴻,122,111,11,富邦-新營,2023-12-18,9693
1309,台達化,11,0,11,富邦-新營,2023-12-18,9693
2031,新光鋼,11,0,11,富邦-新營,2023-12-18,9693
2505,國揚,11,0,11,富邦-新營,2023-12-18,9693
00751B,元大AAA至A公司債,10,0,10,富邦-新營,2023-12-18,9693
00933B,國泰10Y+金融債,20,10,10,富邦-新營,2023-12-18,9693
2612,中航,10,0,10,富邦-新營,2023-12-18,9693
3036,文曄,10,0,10,富邦-新營,2023-12-18,9693
3548,兆利,23,13,10,富邦-新營,2023-12-18,9693
4939,亞電,10,0,10,富邦-新營,2023-12-18,9693
2363,矽統,12,3,9,富邦-新營,2023-12-18,9693
2462,良得電,10,1,9,富邦-新營,2023-12-18,9693
2641,正德,11,2,9,富邦-新營,2023-12-18,9693
8150,南茂,10,1,9,富邦-新營,2023-12-18,9693
00680L,元大美債20正2,50,42,8,富邦-新營,2023-12-18,9693
2340,台亞,8,0,8,富邦-新營,2023-12-18,9693
3047,訊舟,21,13,8,富邦-新營,2023-12-18,9693
1503,士電,8,0,8,富邦-新營,2023-12-18,9693
2610,華航,10,3,7,富邦-新營,2023-12-18,9693
2637,慧洋-KY,9,2,7,富邦-新營,2023-12-18,9693
8044,網家,7,0,7,富邦-新營,2023-12-18,9693
3037,欣興,9,2,7,富邦-新營,2023-12-18,9693
1471,首利,6,0,6,富邦-新營,2023-12-18,9693
00929,復華台灣科技優息,249,87,162,富邦-新營,2023-12-19,9693
00919,群益台灣精選高息,105,14,91,富邦-新營,2023-12-19,9693
00688L,國泰20年美債正2,106,20,86,富邦-新營,2023-12-19,9693
6116,彩晶,62,0,62,富邦-新營,2023-12-19,9693
1605,華新,54,4,50,富邦-新營,2023-12-19,9693
0056,元大高股息,49,1,48,富邦-新營,2023-12-19,9693
00937B,群益ESG投等債20,42,3,39,富邦-新營,2023-12-19,9693
2618,長榮航,44,9,35,富邦-新營,2023-12-19,9693
00680L,元大美債20正2,33,3,30,富邦-新營,2023-12-19,9693
2888,新光金,29,0,29,富邦-新營,2023-12-19,9693
2356,英業達,34,7,27,富邦-新營,2023-12-19,9693
2610,華航,26,0,26,富邦-新營,2023-12-19,9693
00923,群益台ESG低碳50,21,0,21,富邦-新營,2023-12-19,9693
5425,台半,23,2,21,富邦-新營,2023-12-19,9693
00712,復華富時不動產,44,24,20,富邦-新營,2023-12-19,9693
00934,中信成長高股息,20,0,20,富邦-新營,2023-12-19,9693
6153,嘉聯益,18,0,18,富邦-新營,2023-12-19,9693
5009,榮剛,23,6,17,富邦-新營,2023-12-19,9693
5347,世界,16,0,16,富邦-新營,2023-12-19,9693
2312,金寶,16,0,16,富邦-新營,2023-12-19,9693
5512,力麒,16,0,16,富邦-新營,2023-12-19,9693
00639,富邦深100,15,0,15,富邦-新營,2023-12-19,9693
3322,建舜電,20,5,15,富邦-新營,2023-12-19,9693
00931B,統一美債20年,14,0,14,富邦-新營,2023-12-19,9693
2344,華邦電,15,1,14,富邦-新營,2023-12-19,9693
4967,十銓,14,0,14,富邦-新營,2023-12-19,9693
00905,FT臺灣Smart,13,0,13,富邦-新營,2023-12-19,9693
2801,彰銀,13,0,13,富邦-新營,2023-12-19,9693
1584,精剛,13,0,13,富邦-新營,2023-12-19,9693
3051,力特,17,5,12,富邦-新營,2023-12-19,9693
2409,友達,12,0,12,富邦-新營,2023-12-19,9693
3704,合勤控,15,4,11,富邦-新營,2023-12-19,9693
2449,京元電子,13,2,11,富邦-新營,2023-12-19,9693
00885,富邦越南,10,0,10,富邦-新營,2023-12-19,9693
6176,瑞儀,10,0,10,富邦-新營,2023-12-19,9693
00637L,元大滬深300正2,10,0,10,富邦-新營,2023-12-19,9693
2007,燁興,12,2,10,富邦-新營,2023-12-19,9693
2332,友訊,10,0,10,富邦-新營,2023-12-19,9693
2897,王道銀行,10,0,10,富邦-新營,2023-12-19,9693
3438,類比科,10,0,10,富邦-新營,2023-12-19,9693
5864,致和證,10,0,10,富邦-新營,2023-12-19,9693
6187,萬潤,10,0,10,富邦-新營,2023-12-19,9693
3308,聯德,10,0,10,富邦-新營,2023-12-19,9693
6269,台郡,17,8,9,富邦-新營,2023-12-19,9693
2324,仁寶,10,1,9,富邦-新營,2023-12-19,9693
6443,元晶,14,5,9,富邦-新營,2023-12-19,9693
2812,台中銀,8,0,8,富邦-新營,2023-12-19,9693
3443,創意,10,2,8,富邦-新營,2023-12-19,9693
2615,萬海,54,46,8,富邦-新營,2023-12-19,9693
2882,國泰金,8,0,8,富邦-新營,2023-12-19,9693
2609,陽明,231,61,170,富邦-新營,2023-12-20,9693
2913,農林,102,1,101,富邦-新營,2023-12-20,9693
00919,群益台灣精選高息,87,1,86,富邦-新營,2023-12-20,9693
9105,泰金寶-DR,72,9,63,富邦-新營,2023-12-20,9693
2886,兆豐金,53,0,53,富邦-新營,2023-12-20,9693
00679B,元大美債20年,54,6,48,富邦-新營,2023-12-20,9693
00882,中信中國高股息,36,0,36,富邦-新營,2023-12-20,9693
00688L,國泰20年美債正2,30,0,30,富邦-新營,2023-12-20,9693
2014,中鴻,56,30,26,富邦-新營,2023-12-20,9693
2027,大成鋼,30,6,24,富邦-新營,2023-12-20,9693
2303,聯電,22,0,22,富邦-新營,2023-12-20,9693
2888,新光金,22,0,22,富邦-新營,2023-12-20,9693
2009,第一銅,21,0,21,富邦-新營,2023-12-20,9693
1733,五鼎,20,0,20,富邦-新營,2023-12-20,9693
00929,復華台灣科技優息,20,2,18,富邦-新營,2023-12-20,9693
00933B,國泰10Y+金融債,15,0,15,富邦-新營,2023-12-20,9693
1618,合機,15,1,14,富邦-新營,2023-12-20,9693
2405,輔信,14,0,14,富邦-新營,2023-12-20,9693
2634,漢翔,15,1,14,富邦-新營,2023-12-20,9693
1905,華紙,15,2,13,富邦-新營,2023-12-20,9693
00934,中信成長高股息,12,0,12,富邦-新營,2023-12-20,9693
4960,誠美材,12,0,12,富邦-新營,2023-12-20,9693
00931B,統一美債20年,11,0,11,富邦-新營,2023-12-20,9693
4167,松瑞藥,19,8,11,富邦-新營,2023-12-20,9693
6191,精成科,10,0,10,富邦-新營,2023-12-20,9693
1218,泰山,10,0,10,富邦-新營,2023-12-20,9693
3105,穩懋,10,0,10,富邦-新營,2023-12-20,9693
6477,安集,10,0,10,富邦-新營,2023-12-20,9693
6901,鑽石投資,10,0,10,富邦-新營,2023-12-20,9693
3037,欣興,10,0,10,富邦-新營,2023-12-20,9693
3006,晶豪科,10,1,9,富邦-新營,2023-12-20,9693
00937B,群益ESG投等債20,16,7,9,富邦-新營,2023-12-20,9693
2891,中信金,10,2,8,富邦-新營,2023-12-20,9693
1101,台泥,10,2,8,富邦-新營,2023-12-20,9693
2892,第一金,9,1,8,富邦-新營,2023-12-20,9693
6147,頎邦,8,0,8,富邦-新營,2023-12-20,9693
9919,康那香,12,4,8,富邦-新營,2023-12-20,9693
00687B,國泰20年美債,7,0,7,富邦-新營,2023-12-20,9693
1736,喬山,7,0,7,富邦-新營,2023-12-20,9693
2101,南港,7,0,7,富邦-新營,2023-12-20,9693
5521,工信,32,25,7,富邦-新營,2023-12-20,9693
00757,統一FANG+,6,0,6,富邦-新營,2023-12-20,9693
1532,勤美,6,0,6,富邦-新營,2023-12-20,9693
1616,億泰,6,0,6,富邦-新營,2023-12-20,9693
2323,中環,13,7,6,富邦-新營,2023-12-20,9693
8390,金益鼎,6,0,6,富邦-新營,2023-12-20,9693
00885,富邦越南,6,1,5,富邦-新營,2023-12-20,9693
00712,復華富時不動產,6,1,5,富邦-新營,2023-12-20,9693
2539,櫻花建,5,0,5,富邦-新營,2023-12-20,9693
2887,台新金,5,0,5,富邦-新營,2023-12-20,9693
1806,冠軍,157,0,157,富邦-新營,2023-12-21,9693
00632R,元大台灣50反1,100,0,100,富邦-新營,2023-12-21,9693
4906,正文,102,2,100,富邦-新營,2023-12-21,9693
00882,中信中國高股息,82,0,82,富邦-新營,2023-12-21,9693
1536,和大,75,0,75,富邦-新營,2023-12-21,9693
00937B,群益ESG投等債20,75,11,64,富邦-新營,2023-12-21,9693
00919,群益台灣精選高息,66,20,46,富邦-新營,2023-12-21,9693
6461,益得,40,5,35,富邦-新營,2023-12-21,9693
00688L,國泰20年美債正2,28,0,28,富邦-新營,2023-12-21,9693
2610,華航,25,0,25,富邦-新營,2023-12-21,9693
4303,信立,29,4,25,富邦-新營,2023-12-21,9693
1325,恆大,32,11,21,富邦-新營,2023-12-21,9693
5426,振發,20,0,20,富邦-新營,2023-12-21,9693
2324,仁寶,47,28,19,富邦-新營,2023-12-21,9693
2323,中環,24,6,18,富邦-新營,2023-12-21,9693
9945,潤泰新,18,0,18,富邦-新營,2023-12-21,9693
00878,國泰永續高股息,19,1,18,富邦-新營,2023-12-21,9693
00934,中信成長高股息,18,0,18,富邦-新營,2023-12-21,9693
1720,生達,19,5,14,富邦-新營,2023-12-21,9693
1504,東元,13,0,13,富邦-新營,2023-12-21,9693
1618,合機,13,0,13,富邦-新營,2023-12-21,9693
5880,合庫金,12,0,12,富邦-新營,2023-12-21,9693
00931B,統一美債20年,15,3,12,富邦-新營,2023-12-21,9693
00687B,國泰20年美債,16,5,11,富邦-新營,2023-12-21,9693
2892,第一金,10,0,10,富邦-新營,2023-12-21,9693
1434,福懋,10,0,10,富邦-新營,2023-12-21,9693
5469,瀚宇博,10,0,10,富邦-新營,2023-12-21,9693
2201,裕隆,10,0,10,富邦-新營,2023-12-21,9693
00637L,元大滬深300正2,10,0,10,富邦-新營,2023-12-21,9693
2363,矽統,10,0,10,富邦-新營,2023-12-21,9693
6278,台表科,10,0,10,富邦-新營,2023-12-21,9693
8092,建暐,10,0,10,富邦-新營,2023-12-21,9693
2605,新興,18,8,10,富邦-新營,2023-12-21,9693
1312,國喬,9,0,9,富邦-新營,2023-12-21,9693
1732,毛寶,55,46,9,富邦-新營,2023-12-21,9693
2365,昆盈,11,2,9,富邦-新營,2023-12-21,9693
2409,友達,10,1,9,富邦-新營,2023-12-21,9693
5864,致和證,8,0,8,富邦-新營,2023-12-21,9693
6140,訊達,8,0,8,富邦-新營,2023-12-21,9693
6233,旺玖,8,0,8,富邦-新營,2023-12-21,9693
8110,華東,13,5,8,富邦-新營,2023-12-21,9693
2812,台中銀,8,0,8,富邦-新營,2023-12-21,9693
2337,旺宏,8,1,7,富邦-新營,2023-12-21,9693
2603,長榮,16,9,7,富邦-新營,2023-12-21,9693
2303,聯電,20,14,6,富邦-新營,2023-12-21,9693
3704,合勤控,9,3,6,富邦-新營,2023-12-21,9693
2506,太設,6,0,6,富邦-新營,2023-12-21,9693
1591,駿吉-KY,6,0,6,富邦-新營,2023-12-21,9693
2332,友訊,7,1,6,富邦-新營,2023-12-21,9693
6443,元晶,6,0,6,富邦-新營,2023-12-21,9693
1806,冠軍,591,0,591,富邦-新營,2023-12-22,9693
2610,華航,143,16,127,富邦-新營,2023-12-22,9693
5009,榮剛,97,0,97,富邦-新營,2023-12-22,9693
2344,華邦電,88,12,76,富邦-新營,2023-12-22,9693
2331,精英,34,1,33,富邦-新營,2023-12-22,9693
00680L,元大美債20正2,41,10,31,富邦-新營,2023-12-22,9693
1907,永豐餘,30,0,30,富邦-新營,2023-12-22,9693
00688L,國泰20年美債正2,39,10,29,富邦-新營,2023-12-22,9693
2356,英業達,56,34,22,富邦-新營,2023-12-22,9693
00919,群益台灣精選高息,24,2,22,富邦-新營,2023-12-22,9693
1314,中石化,20,0,20,富邦-新營,2023-12-22,9693
3390,旭軟,20,0,20,富邦-新營,2023-12-22,9693
6120,達運,20,0,20,富邦-新營,2023-12-22,9693
1102,亞泥,19,0,19,富邦-新營,2023-12-22,9693
00720B,元大投資級公司債,18,0,18,富邦-新營,2023-12-22,9693
2891,中信金,21,3,18,富邦-新營,2023-12-22,9693
1309,台達化,17,0,17,富邦-新營,2023-12-22,9693
00753L,中信中國50正2,16,0,16,富邦-新營,2023-12-22,9693
5512,力麒,19,3,16,富邦-新營,2023-12-22,9693
3322,建舜電,15,0,15,富邦-新營,2023-12-22,9693
2323,中環,19,6,13,富邦-新營,2023-12-22,9693
2105,正新,16,4,12,富邦-新營,2023-12-22,9693
2409,友達,50,39,11,富邦-新營,2023-12-22,9693
3594,磐儀,13,2,11,富邦-新營,2023-12-22,9693
00935,野村臺灣新科技50,10,0,10,富邦-新營,2023-12-22,9693
00687B,國泰20年美債,15,5,10,富邦-新營,2023-12-22,9693
2312,金寶,10,0,10,富邦-新營,2023-12-22,9693
2883B,凱基金乙特,10,0,10,富邦-新營,2023-12-22,9693
2382,廣達,14,5,9,富邦-新營,2023-12-22,9693
1325,恆大,11,2,9,富邦-新營,2023-12-22,9693
00679B,元大美債20年,8,0,8,富邦-新營,2023-12-22,9693
3231,緯創,14,6,8,富邦-新營,2023-12-22,9693
1524,耿鼎,7,0,7,富邦-新營,2023-12-22,9693
4167,松瑞藥,8,1,7,富邦-新營,2023-12-22,9693
00933B,國泰10Y+金融債,11,4,7,富邦-新營,2023-12-22,9693
00929,復華台灣科技優息,16,10,6,富邦-新營,2023-12-22,9693
2014,中鴻,9,3,6,富邦-新營,2023-12-22,9693
2031,新光鋼,6,0,6,富邦-新營,2023-12-22,9693
2388,威盛,24,18,6,富邦-新營,2023-12-22,9693
3049,精金,6,0,6,富邦-新營,2023-12-22,9693
3607,谷崧,10,4,6,富邦-新營,2023-12-22,9693
5314,世紀,8,2,6,富邦-新營,2023-12-22,9693
6233,旺玖,159,153,6,富邦-新營,2023-12-22,9693
2539,櫻花建,5,0,5,富邦-新營,2023-12-22,9693
2327,國巨,7,2,5,富邦-新營,2023-12-22,9693
00713,元大台灣高息低波,5,0,5,富邦-新營,2023-12-22,9693
00931B,統一美債20年,7,2,5,富邦-新營,2023-12-22,9693
1417,嘉裕,5,0,5,富邦-新營,2023-12-22,9693
2023,燁輝,5,0,5,富邦-新營,2023-12-22,9693
2739,寒舍,10,5,5,富邦-新營,2023-12-22,9693
1806,冠軍,843,0,843,富邦-新營,2023-12-25,9693
2609,陽明,120,63,57,富邦-新營,2023-12-25,9693
00882,中信中國高股息,50,0,50,富邦-新營,2023-12-25,9693
4968,立積,41,0,41,富邦-新營,2023-12-25,9693
2331,精英,50,11,39,富邦-新營,2023-12-25,9693
00937B,群益ESG投等債20,75,45,30,富邦-新營,2023-12-25,9693
00680L,元大美債20正2,29,0,29,富邦-新營,2023-12-25,9693
5009,榮剛,29,2,27,富邦-新營,2023-12-25,9693
4303,信立,26,0,26,富邦-新營,2023-12-25,9693
2883B,凱基金乙特,19,0,19,富邦-新營,2023-12-25,9693
00918,大華優利高填息30,18,0,18,富邦-新營,2023-12-25,9693
2610,華航,24,7,17,富邦-新營,2023-12-25,9693
00712,復華富時不動產,20,5,15,富邦-新營,2023-12-25,9693
6548,長科*,12,0,12,富邦-新營,2023-12-25,9693
3372,典範,11,0,11,富邦-新營,2023-12-25,9693
3390,旭軟,11,0,11,富邦-新營,2023-12-25,9693
9105,泰金寶-DR,11,0,11,富邦-新營,2023-12-25,9693
1514,亞力,13,3,10,富邦-新營,2023-12-25,9693
00688L,國泰20年美債正2,10,0,10,富邦-新營,2023-12-25,9693
2032,新鋼,10,0,10,富邦-新營,2023-12-25,9693
3715,定穎投控,12,2,10,富邦-新營,2023-12-25,9693
4533,協易機,10,0,10,富邦-新營,2023-12-25,9693
8467,波力-KY,9,0,9,富邦-新營,2023-12-25,9693
6139,亞翔,9,0,9,富邦-新營,2023-12-25,9693
3036,文曄,10,2,8,富邦-新營,2023-12-25,9693
1609,大亞,8,1,7,富邦-新營,2023-12-25,9693
2359,所羅門,10,3,7,富邦-新營,2023-12-25,9693
5213,亞昕,7,0,7,富邦-新營,2023-12-25,9693
4906,正文,6,0,6,富邦-新營,2023-12-25,9693
1618,合機,6,0,6,富邦-新營,2023-12-25,9693
2419,仲琦,6,0,6,富邦-新營,2023-12-25,9693
3047,訊舟,6,0,6,富邦-新營,2023-12-25,9693
6104,創惟,6,0,6,富邦-新營,2023-12-25,9693
6117,迎廣,21,15,6,富邦-新營,2023-12-25,9693
6443,元晶,6,0,6,富邦-新營,2023-12-25,9693
6589,台康生技,6,0,6,富邦-新營,2023-12-25,9693
4123,晟德,5,0,5,富邦-新營,2023-12-25,9693
00896,中信綠能及電動車,5,0,5,富邦-新營,2023-12-25,9693
00687B,國泰20年美債,5,0,5,富邦-新營,2023-12-25,9693
00637L,元大滬深300正2,5,0,5,富邦-新營,2023-12-25,9693
2312,金寶,5,0,5,富邦-新營,2023-12-25,9693
2363,矽統,5,0,5,富邦-新營,2023-12-25,9693
2367,燿華,5,0,5,富邦-新營,2023-12-25,9693
2369,菱生,16,11,5,富邦-新營,2023-12-25,9693
3163,波若威,5,0,5,富邦-新營,2023-12-25,9693
4142,國光生,5,0,5,富邦-新營,2023-12-25,9693
6182,合晶,6,1,5,富邦-新營,2023-12-25,9693
6278,台表科,5,0,5,富邦-新營,2023-12-25,9693
8054,安國,6,1,5,富邦-新營,2023-12-25,9693
2027,大成鋼,5,1,4,富邦-新營,2023-12-25,9693
1806,冠軍,1764,30,1734,富邦-新營,2023-12-26,9693
2382,廣達,80,2,78,富邦-新營,2023-12-26,9693
00929,復華台灣科技優息,59,16,43,富邦-新營,2023-12-26,9693
8112,至上,41,3,38,富邦-新營,2023-12-26,9693
2363,矽統,31,1,30,富邦-新營,2023-12-26,9693
00934,中信成長高股息,30,0,30,富邦-新營,2023-12-26,9693
00919,群益台灣精選高息,21,5,16,富邦-新營,2023-12-26,9693
1325,恆大,15,0,15,富邦-新營,2023-12-26,9693
6282,康舒,14,0,14,富邦-新營,2023-12-26,9693
00937B,群益ESG投等債20,19,5,14,富邦-新營,2023-12-26,9693
00933B,國泰10Y+金融債,13,0,13,富邦-新營,2023-12-26,9693
2208,台船,13,0,13,富邦-新營,2023-12-26,9693
2401,凌陽,14,1,13,富邦-新營,2023-12-26,9693
00687B,國泰20年美債,11,0,11,富邦-新營,2023-12-26,9693
2610,華航,11,1,10,富邦-新營,2023-12-26,9693
1618,合機,10,0,10,富邦-新營,2023-12-26,9693
2736,富野,10,0,10,富邦-新營,2023-12-26,9693
1536,和大,9,0,9,富邦-新營,2023-12-26,9693
2312,金寶,20,11,9,富邦-新營,2023-12-26,9693
2388,威盛,15,6,9,富邦-新營,2023-12-26,9693
2331,精英,12,4,8,富邦-新營,2023-12-26,9693
3094,聯傑,7,0,7,富邦-新營,2023-12-26,9693
5521,工信,7,1,6,富邦-新營,2023-12-26,9693
6550,北極星藥業-KY,6,0,6,富邦-新營,2023-12-26,9693
8068,全達,6,0,6,富邦-新營,2023-12-26,9693
2377,微星,11,5,6,富邦-新營,2023-12-26,9693
2353,宏��,64,58,6,富邦-新營,2023-12-26,9693
8039,台虹,7,1,6,富邦-新營,2023-12-26,9693
00636,國泰中國A50,5,0,5,富邦-新營,2023-12-26,9693
2439,美律,5,0,5,富邦-新營,2023-12-26,9693
2442,新美齊,5,0,5,富邦-新營,2023-12-26,9693
2516,新建,10,5,5,富邦-新營,2023-12-26,9693
3041,揚智,5,0,5,富邦-新營,2023-12-26,9693
3376,新日興,5,0,5,富邦-新營,2023-12-26,9693
5512,力麒,5,0,5,富邦-新營,2023-12-26,9693
6796,晉弘,5,0,5,富邦-新營,2023-12-26,9693
8131,福懋科,5,0,5,富邦-新營,2023-12-26,9693
9919,康那香,7,2,5,富邦-新營,2023-12-26,9693
2615,萬海,10,5,5,富邦-新營,2023-12-26,9693
00757,統一FANG+,4,0,4,富邦-新營,2023-12-26,9693
2605,新興,10,6,4,富邦-新營,2023-12-26,9693
3019,亞光,5,1,4,富邦-新營,2023-12-26,9693
3645,達邁,4,0,4,富邦-新營,2023-12-26,9693
3694,海華,5,1,4,富邦-新營,2023-12-26,9693
6182,合晶,4,0,4,富邦-新營,2023-12-26,9693
2618,長榮航,5,2,3,富邦-新營,2023-12-26,9693
1309,台達化,3,0,3,富邦-新營,2023-12-26,9693
1503,士電,4,1,3,富邦-新營,2023-12-26,9693
1537,廣隆,3,0,3,富邦-新營,2023-12-26,9693
2337,旺宏,3,0,3,富邦-新營,2023-12-26,9693
2353,宏��,192,51,141,富邦-新營,2023-12-27,9693
00937B,群益ESG投等債20,173,83,90,富邦-新營,2023-12-27,9693
6835,圓裕,50,0,50,富邦-新營,2023-12-27,9693
2409,友達,111,64,47,富邦-新營,2023-12-27,9693
2405,輔信,97,66,31,富邦-新營,2023-12-27,9693
3390,旭軟,61,32,29,富邦-新營,2023-12-27,9693
00687B,國泰20年美債,23,0,23,富邦-新營,2023-12-27,9693
2241,艾姆勒,15,0,15,富邦-新營,2023-12-27,9693
1101,台泥,21,7,14,富邦-新營,2023-12-27,9693
3481,群創,21,8,13,富邦-新營,2023-12-27,9693
6239,力成,12,0,12,富邦-新營,2023-12-27,9693
00857B,永豐20年美公債,12,1,11,富邦-新營,2023-12-27,9693
00900,富邦特選高股息30,16,5,11,富邦-新營,2023-12-27,9693
2462,良得電,11,0,11,富邦-新營,2023-12-27,9693
2883B,凱基金乙特,11,0,11,富邦-新營,2023-12-27,9693
3231,緯創,14,3,11,富邦-新營,2023-12-27,9693
2449,京元電子,11,0,11,富邦-新營,2023-12-27,9693
00915,凱基優選高股息30,10,0,10,富邦-新營,2023-12-27,9693
1815,富喬,10,0,10,富邦-新營,2023-12-27,9693
3689,湧德,10,0,10,富邦-新營,2023-12-27,9693
4303,信立,10,0,10,富邦-新營,2023-12-27,9693
5512,力麒,10,0,10,富邦-新營,2023-12-27,9693
8255,朋程,10,0,10,富邦-新營,2023-12-27,9693
6142,友勁,9,0,9,富邦-新營,2023-12-27,9693
00680L,元大美債20正2,20,12,8,富邦-新營,2023-12-27,9693
1503,士電,8,0,8,富邦-新營,2023-12-27,9693
2542,興富發,7,0,7,富邦-新營,2023-12-27,9693
00935,野村臺灣新科技50,6,0,6,富邦-新營,2023-12-27,9693
2401,凌陽,6,0,6,富邦-新營,2023-12-27,9693
3346,麗清,7,1,6,富邦-新營,2023-12-27,9693
00633L,富邦上証正2,6,1,5,富邦-新營,2023-12-27,9693
00712,復華富時不動產,5,0,5,富邦-新營,2023-12-27,9693
2312,金寶,5,0,5,富邦-新營,2023-12-27,9693
2380,虹光,5,0,5,富邦-新營,2023-12-27,9693
3609,三一東林,5,0,5,富邦-新營,2023-12-27,9693
4960,誠美材,5,0,5,富邦-新營,2023-12-27,9693
6116,彩晶,5,0,5,富邦-新營,2023-12-27,9693
8068,全達,15,10,5,富邦-新營,2023-12-27,9693
2606,裕民,5,0,5,富邦-新營,2023-12-27,9693
3264,欣銓,5,0,5,富邦-新營,2023-12-27,9693
1605,華新,19,14,5,富邦-新營,2023-12-27,9693
1447,力鵬,4,0,4,富邦-新營,2023-12-27,9693
1504,東元,4,0,4,富邦-新營,2023-12-27,9693
2101,南港,5,1,4,富邦-新營,2023-12-27,9693
2903,遠百,4,0,4,富邦-新營,2023-12-27,9693
3024,憶聲,4,0,4,富邦-新營,2023-12-27,9693
3706,神達,9,5,4,富邦-新營,2023-12-27,9693
5011,久陽,4,0,4,富邦-新營,2023-12-27,9693
8059,凱碩,16,12,4,富邦-新營,2023-12-27,9693
3051,力特,5,1,4,富邦-新營,2023-12-27,9693
00937B,群益ESG投等債20,227,5,222,富邦-新營,2023-12-28,9693
2324,仁寶,78,14,64,富邦-新營,2023-12-28,9693
2323,中環,53,12,41,富邦-新營,2023-12-28,9693
2516,新建,40,0,40,富邦-新營,2023-12-28,9693
00933B,國泰10Y+金融債,39,0,39,富邦-新營,2023-12-28,9693
00715L,期街口布蘭特正2,37,0,37,富邦-新營,2023-12-28,9693
2485,兆赫,30,1,29,富邦-新營,2023-12-28,9693
00918,大華優利高填息30,26,0,26,富邦-新營,2023-12-28,9693
5356,協益,26,0,26,富邦-新營,2023-12-28,9693
3322,建舜電,45,20,25,富邦-新營,2023-12-28,9693
1609,大亞,34,10,24,富邦-新營,2023-12-28,9693
6233,旺玖,21,0,21,富邦-新營,2023-12-28,9693
00680L,元大美債20正2,20,0,20,富邦-新營,2023-12-28,9693
3031,佰鴻,20,0,20,富邦-新營,2023-12-28,9693
2301,光寶科,25,7,18,富邦-新營,2023-12-28,9693
3706,神達,68,51,17,富邦-新營,2023-12-28,9693
5351,鈺創,17,1,16,富邦-新營,2023-12-28,9693
2009,第一銅,15,0,15,富邦-新營,2023-12-28,9693
1514,亞力,47,32,15,富邦-新營,2023-12-28,9693
6770,力積電,14,1,13,富邦-新營,2023-12-28,9693
00772B,中信高評級公司債,12,0,12,富邦-新營,2023-12-28,9693
1529,樂事綠能,13,1,12,富邦-新營,2023-12-28,9693
2393,億光,15,3,12,富邦-新營,2023-12-28,9693
1733,五鼎,16,6,10,富邦-新營,2023-12-28,9693
2337,旺宏,32,22,10,富邦-新營,2023-12-28,9693
2367,燿華,10,0,10,富邦-新營,2023-12-28,9693
3712,永崴投控,10,0,10,富邦-新營,2023-12-28,9693
5525,順天,10,0,10,富邦-新營,2023-12-28,9693
2457,飛宏,11,2,9,富邦-新營,2023-12-28,9693
3376,新日興,18,9,9,富邦-新營,2023-12-28,9693
4609,唐鋒,9,0,9,富邦-新營,2023-12-28,9693
5371,中光電,10,1,9,富邦-新營,2023-12-28,9693
00931B,統一美債20年,8,0,8,富邦-新營,2023-12-28,9693
2352,佳世達,9,1,8,富邦-新營,2023-12-28,9693
2748,雲品,8,0,8,富邦-新營,2023-12-28,9693
2313,華通,8,0,8,富邦-新營,2023-12-28,9693
2439,美律,7,0,7,富邦-新營,2023-12-28,9693
2211,長榮鋼,10,3,7,富邦-新營,2023-12-28,9693
5512,力麒,7,0,7,富邦-新營,2023-12-28,9693
00679B,元大美債20年,9,2,7,富邦-新營,2023-12-28,9693
2603,長榮,13,6,7,富邦-新營,2023-12-28,9693
1582,信錦,7,1,6,富邦-新營,2023-12-28,9693
2412,中華電,7,1,6,富邦-新營,2023-12-28,9693
2419,仲琦,6,0,6,富邦-新營,2023-12-28,9693
2618,長榮航,7,1,6,富邦-新營,2023-12-28,9693
6668,中揚光,7,1,6,富邦-新營,2023-12-28,9693
2353,宏��,186,180,6,富邦-新營,2023-12-28,9693
00936,台新永續高息中小,5,0,5,富邦-新營,2023-12-28,9693
1522,堤維西,5,0,5,富邦-新營,2023-12-28,9693
1796,金穎生技,5,0,5,富邦-新營,2023-12-28,9693
00929,復華台灣科技優息,121,3,118,富邦-新營,2023-12-29,9693
00706L,期元大S＆P日圓正2,107,0,107,富邦-新營,2023-12-29,9693
00937B,群益ESG投等債20,102,2,100,富邦-新營,2023-12-29,9693
00715L,期街口布蘭特正2,72,1,71,富邦-新營,2023-12-29,9693
1608,華榮,40,0,40,富邦-新營,2023-12-29,9693
00687B,國泰20年美債,37,0,37,富邦-新營,2023-12-29,9693
00919,群益台灣精選高息,35,0,35,富邦-新營,2023-12-29,9693
3390,旭軟,39,8,31,富邦-新營,2023-12-29,9693
00680L,元大美債20正2,26,0,26,富邦-新營,2023-12-29,9693
6274,台燿,23,1,22,富邦-新營,2023-12-29,9693
6605,帝寶,20,0,20,富邦-新營,2023-12-29,9693
00688L,國泰20年美債正2,18,0,18,富邦-新營,2023-12-29,9693
6770,力積電,16,0,16,富邦-新營,2023-12-29,9693
1514,亞力,17,2,15,富邦-新營,2023-12-29,9693
2609,陽明,18,6,12,富邦-新營,2023-12-29,9693
2312,金寶,32,20,12,富邦-新營,2023-12-29,9693
2888,新光金,12,0,12,富邦-新營,2023-12-29,9693
1513,中興電,13,2,11,富邦-新營,2023-12-29,9693
8011,台通,30,19,11,富邦-新營,2023-12-29,9693
3006,晶豪科,51,41,10,富邦-新營,2023-12-29,9693
5371,中光電,10,0,10,富邦-新營,2023-12-29,9693
00753L,中信中國50正2,10,0,10,富邦-新營,2023-12-29,9693
6016,康和證,10,0,10,富邦-新營,2023-12-29,9693
6485,點序,10,0,10,富邦-新營,2023-12-29,9693
9944,新麗,10,0,10,富邦-新營,2023-12-29,9693
2359,所羅門,10,1,9,富邦-新營,2023-12-29,9693
8096,擎亞,15,6,9,富邦-新營,2023-12-29,9693
8429,金麗-KY,12,3,9,富邦-新營,2023-12-29,9693
1101,台泥,8,0,8,富邦-新營,2023-12-29,9693
00720B,元大投資級公司債,7,0,7,富邦-新營,2023-12-29,9693
1584,精剛,7,0,7,富邦-新營,2023-12-29,9693
2845,遠東銀,7,0,7,富邦-新營,2023-12-29,9693
6182,合晶,7,0,7,富邦-新營,2023-12-29,9693
2506,太設,6,0,6,富邦-新營,2023-12-29,9693
2634,漢翔,6,0,6,富邦-新營,2023-12-29,9693
00882,中信中國高股息,10,4,6,富邦-新營,2023-12-29,9693
2101,南港,6,0,6,富邦-新營,2023-12-29,9693
2615,萬海,9,3,6,富邦-新營,2023-12-29,9693
2903,遠百,6,0,6,富邦-新營,2023-12-29,9693
3031,佰鴻,6,0,6,富邦-新營,2023-12-29,9693
8112,至上,6,0,6,富邦-新營,2023-12-29,9693
00922,國泰台灣領袖50,7,2,5,富邦-新營,2023-12-29,9693
1718,中纖,5,0,5,富邦-新營,2023-12-29,9693
00679B,元大美債20年,6,1,5,富邦-新營,2023-12-29,9693
1503,士電,10,5,5,富邦-新營,2023-12-29,9693
1616,億泰,5,0,5,富邦-新營,2023-12-29,9693
2356,英業達,37,32,5,富邦-新營,2023-12-29,9693
2462,良得電,5,0,5,富邦-新營,2023-12-29,9693
2514,龍邦,5,0,5,富邦-新營,2023-12-29,9693
2834,臺企銀,6,1,5,富邦-新營,2023-12-29,9693
00929,復華台灣科技優息,138,11,127,富邦-新營,2024-01-02,9693
00687B,國泰20年美債,92,0,92,富邦-新營,2024-01-02,9693
3231,緯創,64,8,56,富邦-新營,2024-01-02,9693
00680L,元大美債20正2,42,0,42,富邦-新營,2024-01-02,9693
2356,英業達,43,7,36,富邦-新營,2024-01-02,9693
0056,元大高股息,37,3,34,富邦-新營,2024-01-02,9693
1904,正隆,27,0,27,富邦-新營,2024-01-02,9693
3706,神達,27,5,22,富邦-新營,2024-01-02,9693
00878,國泰永續高股息,33,11,22,富邦-新營,2024-01-02,9693
00688L,國泰20年美債正2,20,0,20,富邦-新營,2024-01-02,9693
2409,友達,32,13,19,富邦-新營,2024-01-02,9693
3481,群創,20,2,18,富邦-新營,2024-01-02,9693
2303,聯電,26,9,17,富邦-新營,2024-01-02,9693
4967,十銓,16,1,15,富邦-新營,2024-01-02,9693
8011,台通,14,1,13,富邦-新營,2024-01-02,9693
8096,擎亞,12,0,12,富邦-新營,2024-01-02,9693
4105,東洋,11,0,11,富邦-新營,2024-01-02,9693
2353,宏��,75,64,11,富邦-新營,2024-01-02,9693
4979,華星光,10,0,10,富邦-新營,2024-01-02,9693
3051,力特,12,2,10,富邦-新營,2024-01-02,9693
3443,創意,12,2,10,富邦-新營,2024-01-02,9693
2312,金寶,10,0,10,富邦-新營,2024-01-02,9693
6835,圓裕,9,0,9,富邦-新營,2024-01-02,9693
1718,中纖,7,0,7,富邦-新營,2024-01-02,9693
2208,台船,7,0,7,富邦-新營,2024-01-02,9693
00636,國泰中國A50,7,0,7,富邦-新營,2024-01-02,9693
3504,揚明光,7,0,7,富邦-新營,2024-01-02,9693
5471,松翰,7,0,7,富邦-新營,2024-01-02,9693
5521,工信,68,61,7,富邦-新營,2024-01-02,9693
2382,廣達,8,1,7,富邦-新營,2024-01-02,9693
2352,佳世達,18,11,7,富邦-新營,2024-01-02,9693
00679B,元大美債20年,6,0,6,富邦-新營,2024-01-02,9693
2883,凱基金,6,0,6,富邦-新營,2024-01-02,9693
5512,力麒,6,0,6,富邦-新營,2024-01-02,9693
6113,亞矽,8,2,6,富邦-新營,2024-01-02,9693
00933B,國泰10Y+金融債,6,1,5,富邦-新營,2024-01-02,9693
00772B,中信高評級公司債,5,0,5,富邦-新營,2024-01-02,9693
3702,大聯大,5,0,5,富邦-新營,2024-01-02,9693
6770,力積電,5,0,5,富邦-新營,2024-01-02,9693
00633L,富邦上証正2,5,0,5,富邦-新營,2024-01-02,9693
1514,亞力,22,17,5,富邦-新營,2024-01-02,9693
2913,農林,5,0,5,富邦-新營,2024-01-02,9693
3545,敦泰,11,6,5,富邦-新營,2024-01-02,9693
5351,鈺創,5,0,5,富邦-新營,2024-01-02,9693
5876,上海商銀,5,0,5,富邦-新營,2024-01-02,9693
6550,北極星藥業-KY,5,0,5,富邦-新營,2024-01-02,9693
8477,創業家,5,0,5,富邦-新營,2024-01-02,9693
1319,東陽,6,1,5,富邦-新營,2024-01-02,9693
1609,大亞,16,12,4,富邦-新營,2024-01-02,9693
2359,所羅門,4,0,4,富邦-新營,2024-01-02,9693
00929,復華台灣科技優息,146,10,136,富邦-新營,2024-01-03,9693
00715L,期街口布蘭特正2,96,0,96,富邦-新營,2024-01-03,9693
6274,台燿,81,0,81,富邦-新營,2024-01-03,9693
9105,泰金寶-DR,110,30,80,富邦-新營,2024-01-03,9693
00878,國泰永續高股息,90,14,76,富邦-新營,2024-01-03,9693
00919,群益台灣精選高息,45,3,42,富邦-新營,2024-01-03,9693
00637L,元大滬深300正2,40,0,40,富邦-新營,2024-01-03,9693
6167,久正,39,0,39,富邦-新營,2024-01-03,9693
6770,力積電,35,0,35,富邦-新營,2024-01-03,9693
5521,工信,91,62,29,富邦-新營,2024-01-03,9693
1101,台泥,25,0,25,富邦-新營,2024-01-03,9693
0056,元大高股息,29,5,24,富邦-新營,2024-01-03,9693
2352,佳世達,24,2,22,富邦-新營,2024-01-03,9693
2331,精英,35,13,22,富邦-新營,2024-01-03,9693
00680L,元大美債20正2,20,0,20,富邦-新營,2024-01-03,9693
6531,愛普*,22,3,19,富邦-新營,2024-01-03,9693
5425,台半,20,3,17,富邦-新營,2024-01-03,9693
2330,台積電,18,1,17,富邦-新營,2024-01-03,9693
00892,富邦台灣半導體,16,0,16,富邦-新營,2024-01-03,9693
2353,宏��,43,27,16,富邦-新營,2024-01-03,9693
00720B,元大投資級公司債,16,0,16,富邦-新營,2024-01-03,9693
00772B,中信高評級公司債,16,0,16,富邦-新營,2024-01-03,9693
2356,英業達,27,11,16,富邦-新營,2024-01-03,9693
2618,長榮航,54,39,15,富邦-新營,2024-01-03,9693
2881,富邦金,15,1,14,富邦-新營,2024-01-03,9693
00688L,國泰20年美債正2,15,1,14,富邦-新營,2024-01-03,9693
2515,中工,64,50,14,富邦-新營,2024-01-03,9693
2303,聯電,45,31,14,富邦-新營,2024-01-03,9693
2362,藍天,25,12,13,富邦-新營,2024-01-03,9693
2376,技嘉,13,1,12,富邦-新營,2024-01-03,9693
00934,中信成長高股息,13,1,12,富邦-新營,2024-01-03,9693
2002,中鋼,13,1,12,富邦-新營,2024-01-03,9693
2324,仁寶,14,2,12,富邦-新營,2024-01-03,9693
00935,野村臺灣新科技50,12,0,12,富邦-新營,2024-01-03,9693
2344,華邦電,24,12,12,富邦-新營,2024-01-03,9693
1568,倉佑,11,0,11,富邦-新營,2024-01-03,9693
1608,華榮,11,0,11,富邦-新營,2024-01-03,9693
2605,新興,18,7,11,富邦-新營,2024-01-03,9693
2634,漢翔,11,0,11,富邦-新營,2024-01-03,9693
1618,合機,20,10,10,富邦-新營,2024-01-03,9693
2485,兆赫,10,0,10,富邦-新營,2024-01-03,9693
2897,王道銀行,10,0,10,富邦-新營,2024-01-03,9693
3083,網龍,10,0,10,富邦-新營,2024-01-03,9693
6120,達運,10,0,10,富邦-新營,2024-01-03,9693
6182,合晶,10,0,10,富邦-新營,2024-01-03,9693
2888,新光金,14,5,9,富邦-新營,2024-01-03,9693
00888,永豐台灣ESG,11,2,9,富邦-新營,2024-01-03,9693
6477,安集,8,0,8,富邦-新營,2024-01-03,9693
3522,御嵿,10,2,8,富邦-新營,2024-01-03,9693
3704,合勤控,8,0,8,富邦-新營,2024-01-03,9693
00937B,群益ESG投等債20,160,10,150,富邦-新營,2024-01-04,9693
00927,群益半導體收益,137,0,137,富邦-新營,2024-01-04,9693
2241,艾姆勒,90,0,90,富邦-新營,2024-01-04,9693
3035,智原,55,1,54,富邦-新營,2024-01-04,9693
00929,復華台灣科技優息,64,12,52,富邦-新營,2024-01-04,9693
2303,聯電,59,13,46,富邦-新營,2024-01-04,9693
00712,復華富時不動產,46,4,42,富邦-新營,2024-01-04,9693
00637L,元大滬深300正2,41,0,41,富邦-新營,2024-01-04,9693
8064,東捷,40,0,40,富邦-新營,2024-01-04,9693
00878,國泰永續高股息,55,16,39,富邦-新營,2024-01-04,9693
2014,中鴻,40,2,38,富邦-新營,2024-01-04,9693
00650L,復華香港正2,35,0,35,富邦-新營,2024-01-04,9693
2636,台驊控股,32,0,32,富邦-新營,2024-01-04,9693
3228,金麗科,30,0,30,富邦-新營,2024-01-04,9693
2331,精英,44,16,28,富邦-新營,2024-01-04,9693
3032,偉訓,25,0,25,富邦-新營,2024-01-04,9693
2801,彰銀,24,0,24,富邦-新營,2024-01-04,9693
1101,台泥,26,5,21,富邦-新營,2024-01-04,9693
5324,士開,20,0,20,富邦-新營,2024-01-04,9693
00725B,國泰投資級公司債,19,0,19,富邦-新營,2024-01-04,9693
6153,嘉聯益,17,0,17,富邦-新營,2024-01-04,9693
8096,擎亞,21,4,17,富邦-新營,2024-01-04,9693
0056,元大高股息,23,6,17,富邦-新營,2024-01-04,9693
2486,一詮,18,2,16,富邦-新營,2024-01-04,9693
00720B,元大投資級公司債,15,0,15,富邦-新營,2024-01-04,9693
00935,野村臺灣新科技50,15,1,14,富邦-新營,2024-01-04,9693
2465,麗臺,15,1,14,富邦-新營,2024-01-04,9693
8429,金麗-KY,14,0,14,富邦-新營,2024-01-04,9693
2356,英業達,18,5,13,富邦-新營,2024-01-04,9693
00633L,富邦上証正2,14,2,12,富邦-新營,2024-01-04,9693
2009,第一銅,28,16,12,富邦-新營,2024-01-04,9693
2392,正崴,13,1,12,富邦-新營,2024-01-04,9693
00892,富邦台灣半導體,11,0,11,富邦-新營,2024-01-04,9693
1802,台玻,11,0,11,富邦-新營,2024-01-04,9693
2007,燁興,13,2,11,富邦-新營,2024-01-04,9693
4162,智擎,12,1,11,富邦-新營,2024-01-04,9693
00753L,中信中國50正2,10,0,10,富邦-新營,2024-01-04,9693
00751B,元大AAA至A公司債,10,0,10,富邦-新營,2024-01-04,9693
1618,合機,30,20,10,富邦-新營,2024-01-04,9693
1733,五鼎,10,0,10,富邦-新營,2024-01-04,9693
2516,新建,10,0,10,富邦-新營,2024-01-04,9693
5521,工信,31,21,10,富邦-新營,2024-01-04,9693
6167,久正,10,0,10,富邦-新營,2024-01-04,9693
3338,泰碩,9,0,9,富邦-新營,2024-01-04,9693
5425,台半,9,0,9,富邦-新營,2024-01-04,9693
00919,群益台灣精選高息,27,19,8,富邦-新營,2024-01-04,9693
3037,欣興,7,0,7,富邦-新營,2024-01-04,9693
3706,神達,7,0,7,富邦-新營,2024-01-04,9693
1303,南亞,7,0,7,富邦-新營,2024-01-04,9693
2332,友訊,10,3,7,富邦-新營,2024-01-04,9693
00680L,元大美債20正2,292,0,292,富邦-新營,2024-01-05,9693
00929,復華台灣科技優息,89,1,88,富邦-新營,2024-01-05,9693
00650L,復華香港正2,85,0,85,富邦-新營,2024-01-05,9693
2241,艾姆勒,69,0,69,富邦-新營,2024-01-05,9693
9105,泰金寶-DR,50,0,50,富邦-新營,2024-01-05,9693
2609,陽明,104,60,44,富邦-新營,2024-01-05,9693
00881,國泰台灣5G+,41,2,39,富邦-新營,2024-01-05,9693
00688L,國泰20年美債正2,27,0,27,富邦-新營,2024-01-05,9693
3390,旭軟,30,3,27,富邦-新營,2024-01-05,9693
6182,合晶,25,0,25,富邦-新營,2024-01-05,9693
2353,宏��,51,28,23,富邦-新營,2024-01-05,9693
00918,大華優利高填息30,20,0,20,富邦-新營,2024-01-05,9693
2323,中環,18,1,17,富邦-新營,2024-01-05,9693
00706L,期元大S＆P日圓正2,16,0,16,富邦-新營,2024-01-05,9693
1598,岱宇,15,0,15,富邦-新營,2024-01-05,9693
2344,華邦電,15,0,15,富邦-新營,2024-01-05,9693
2014,中鴻,14,0,14,富邦-新營,2024-01-05,9693
00687B,國泰20年美債,21,8,13,富邦-新營,2024-01-05,9693
00933B,國泰10Y+金融債,13,0,13,富邦-新營,2024-01-05,9693
2637,慧洋-KY,15,3,12,富邦-新營,2024-01-05,9693
2332,友訊,11,0,11,富邦-新營,2024-01-05,9693
2855,統一證,11,0,11,富邦-新營,2024-01-05,9693
00720B,元大投資級公司債,10,0,10,富邦-新營,2024-01-05,9693
1514,亞力,12,2,10,富邦-新營,2024-01-05,9693
2455,全新,10,0,10,富邦-新營,2024-01-05,9693
1736,喬山,10,0,10,富邦-新營,2024-01-05,9693
2031,新光鋼,10,0,10,富邦-新營,2024-01-05,9693
4908,前鼎,10,0,10,富邦-新營,2024-01-05,9693
6113,亞矽,61,51,10,富邦-新營,2024-01-05,9693
00934,中信成長高股息,10,0,10,富邦-新營,2024-01-05,9693
1101,台泥,15,6,9,富邦-新營,2024-01-05,9693
2356,英業達,47,38,9,富邦-新營,2024-01-05,9693
2736,富野,10,1,9,富邦-新營,2024-01-05,9693
00927,群益半導體收益,13,6,7,富邦-新營,2024-01-05,9693
00712,復華富時不動產,7,0,7,富邦-新營,2024-01-05,9693
1605,華新,7,0,7,富邦-新營,2024-01-05,9693
3031,佰鴻,7,0,7,富邦-新營,2024-01-05,9693
6117,迎廣,16,9,7,富邦-新營,2024-01-05,9693
00772B,中信高評級公司債,7,0,7,富邦-新營,2024-01-05,9693
3406,玉晶光,6,0,6,富邦-新營,2024-01-05,9693
00936,台新永續高息中小,6,0,6,富邦-新營,2024-01-05,9693
3006,晶豪科,30,24,6,富邦-新營,2024-01-05,9693
00931B,統一美債20年,5,0,5,富邦-新營,2024-01-05,9693
8210,勤誠,6,1,5,富邦-新營,2024-01-05,9693
00773B,中信優先金融債,5,0,5,富邦-新營,2024-01-05,9693
00738U,期元大道瓊白銀,5,0,5,富邦-新營,2024-01-05,9693
1733,五鼎,5,0,5,富邦-新營,2024-01-05,9693
2017,官田鋼,5,0,5,富邦-新營,2024-01-05,9693
2108,南帝,5,0,5,富邦-新營,2024-01-05,9693
2329,華泰,8,3,5,富邦-新營,2024-01-05,9693
00637L,元大滬深300正2,205,0,205,富邦-新營,2024-01-08,9693
00680L,元大美債20正2,101,0,101,富邦-新營,2024-01-08,9693
00929,復華台灣科技優息,64,0,64,富邦-新營,2024-01-08,9693
00679B,元大美債20年,42,0,42,富邦-新營,2024-01-08,9693
00919,群益台灣精選高息,39,1,38,富邦-新營,2024-01-08,9693
3017,奇鋐,41,4,37,富邦-新營,2024-01-08,9693
6026,福邦證,32,0,32,富邦-新營,2024-01-08,9693
00720B,元大投資級公司債,25,0,25,富邦-新營,2024-01-08,9693
00937B,群益ESG投等債20,26,1,25,富邦-新營,2024-01-08,9693
00687B,國泰20年美債,70,46,24,富邦-新營,2024-01-08,9693
00753L,中信中國50正2,21,0,21,富邦-新營,2024-01-08,9693
2888,新光金,21,0,21,富邦-新營,2024-01-08,9693
2609,陽明,76,55,21,富邦-新營,2024-01-08,9693
00918,大華優利高填息30,20,0,20,富邦-新營,2024-01-08,9693
00900,富邦特選高股息30,15,0,15,富邦-新營,2024-01-08,9693
2915,潤泰全,15,0,15,富邦-新營,2024-01-08,9693
3231,緯創,25,11,14,富邦-新營,2024-01-08,9693
4109,加捷生醫,15,1,14,富邦-新營,2024-01-08,9693
00772B,中信高評級公司債,12,0,12,富邦-新營,2024-01-08,9693
00882,中信中國高股息,11,0,11,富邦-新營,2024-01-08,9693
00639,富邦深100,10,0,10,富邦-新營,2024-01-08,9693
00665L,富邦�琤肭磪囓�2,10,0,10,富邦-新營,2024-01-08,9693
00738U,期元大道瓊白銀,10,0,10,富邦-新營,2024-01-08,9693
2388,威盛,32,22,10,富邦-新營,2024-01-08,9693
2883B,凱基金乙特,10,0,10,富邦-新營,2024-01-08,9693
3390,旭軟,11,1,10,富邦-新營,2024-01-08,9693
5381,合正,10,0,10,富邦-新營,2024-01-08,9693
5608,四維航,10,0,10,富邦-新營,2024-01-08,9693
8021,尖點,10,0,10,富邦-新營,2024-01-08,9693
2603,長榮,13,3,10,富邦-新營,2024-01-08,9693
00688L,國泰20年美債正2,9,0,9,富邦-新營,2024-01-08,9693
2332,友訊,9,0,9,富邦-新營,2024-01-08,9693
6153,嘉聯益,9,0,9,富邦-新營,2024-01-08,9693
2607,榮運,11,3,8,富邦-新營,2024-01-08,9693
2027,大成鋼,7,0,7,富邦-新營,2024-01-08,9693
6446,藥華藥,7,0,7,富邦-新營,2024-01-08,9693
1721,三晃,14,7,7,富邦-新營,2024-01-08,9693
5508,永信建,7,0,7,富邦-新營,2024-01-08,9693
6140,訊達,9,2,7,富邦-新營,2024-01-08,9693
1568,倉佑,6,0,6,富邦-新營,2024-01-08,9693
2417,圓剛,7,1,6,富邦-新營,2024-01-08,9693
3049,精金,6,0,6,富邦-新營,2024-01-08,9693
6285,啟��,6,0,6,富邦-新營,2024-01-08,9693
8096,擎亞,212,206,6,富邦-新營,2024-01-08,9693
2303,聯電,8,3,5,富邦-新營,2024-01-08,9693
00633L,富邦上証正2,15,10,5,富邦-新營,2024-01-08,9693
1319,東陽,5,0,5,富邦-新營,2024-01-08,9693
1582,信錦,7,2,5,富邦-新營,2024-01-08,9693
2634,漢翔,14,9,5,富邦-新營,2024-01-08,9693
2882,國泰金,5,0,5,富邦-新營,2024-01-08,9693
00919,群益台灣精選高息,86,5,81,富邦-新營,2024-01-09,9693
2356,英業達,104,28,76,富邦-新營,2024-01-09,9693
00929,復華台灣科技優息,87,13,74,富邦-新營,2024-01-09,9693
00637L,元大滬深300正2,60,0,60,富邦-新營,2024-01-09,9693
2609,陽明,91,37,54,富邦-新營,2024-01-09,9693
9907,統一實,51,0,51,富邦-新營,2024-01-09,9693
2634,漢翔,39,0,39,富邦-新營,2024-01-09,9693
1301,台塑,34,0,34,富邦-新營,2024-01-09,9693
00937B,群益ESG投等債20,33,0,33,富邦-新營,2024-01-09,9693
2888,新光金,40,10,30,富邦-新營,2024-01-09,9693
6805,富世達,32,2,30,富邦-新營,2024-01-09,9693
2603,長榮,47,18,29,富邦-新營,2024-01-09,9693
2606,裕民,21,0,21,富邦-新營,2024-01-09,9693
2363,矽統,35,15,20,富邦-新營,2024-01-09,9693
6477,安集,20,0,20,富邦-新營,2024-01-09,9693
6770,力積電,19,0,19,富邦-新營,2024-01-09,9693
2489,瑞軒,17,0,17,富邦-新營,2024-01-09,9693
6167,久正,16,0,16,富邦-新營,2024-01-09,9693
1718,中纖,15,0,15,富邦-新營,2024-01-09,9693
3322,建舜電,15,0,15,富邦-新營,2024-01-09,9693
00722B,群益投資級電信債,14,0,14,富邦-新營,2024-01-09,9693
2636,台驊控股,13,0,13,富邦-新營,2024-01-09,9693
3056,富華新,13,0,13,富邦-新營,2024-01-09,9693
1603,華電,12,0,12,富邦-新營,2024-01-09,9693
1721,三晃,13,1,12,富邦-新營,2024-01-09,9693
2332,友訊,12,0,12,富邦-新營,2024-01-09,9693
2516,新建,12,0,12,富邦-新營,2024-01-09,9693
4114,健喬,12,0,12,富邦-新營,2024-01-09,9693
5009,榮剛,12,0,12,富邦-新營,2024-01-09,9693
3051,力特,23,12,11,富邦-新營,2024-01-09,9693
3046,建��,11,0,11,富邦-新營,2024-01-09,9693
1605,華新,11,1,10,富邦-新營,2024-01-09,9693
1815,富喬,11,1,10,富邦-新營,2024-01-09,9693
2501,國建,10,0,10,富邦-新營,2024-01-09,9693
3701,大眾控,10,0,10,富邦-新營,2024-01-09,9693
00934,中信成長高股息,9,0,9,富邦-新營,2024-01-09,9693
3622,洋華,12,3,9,富邦-新營,2024-01-09,9693
6116,彩晶,9,0,9,富邦-新營,2024-01-09,9693
6153,嘉聯益,9,0,9,富邦-新營,2024-01-09,9693
8096,擎亞,12,3,9,富邦-新營,2024-01-09,9693
2014,中鴻,9,1,8,富邦-新營,2024-01-09,9693
2027,大成鋼,9,1,8,富邦-新營,2024-01-09,9693
00881,國泰台灣5G+,8,0,8,富邦-新營,2024-01-09,9693
00715L,期街口布蘭特正2,8,0,8,富邦-新營,2024-01-09,9693
2618,長榮航,9,1,8,富邦-新營,2024-01-09,9693
2324,仁寶,43,35,8,富邦-新營,2024-01-09,9693
2610,華航,13,6,7,富邦-新營,2024-01-09,9693
1325,恆大,9,2,7,富邦-新營,2024-01-09,9693
3346,麗清,7,0,7,富邦-新營,2024-01-09,9693
4303,信立,7,0,7,富邦-新營,2024-01-09,9693
00679B,元大美債20年,117,0,117,富邦-新營,2024-01-10,9693
00680L,元大美債20正2,112,0,112,富邦-新營,2024-01-10,9693
2329,華泰,107,8,99,富邦-新營,2024-01-10,9693
00929,復華台灣科技優息,77,8,69,富邦-新營,2024-01-10,9693
2241,艾姆勒,60,0,60,富邦-新營,2024-01-10,9693
2888,新光金,77,20,57,富邦-新營,2024-01-10,9693
00632R,元大台灣50反1,45,0,45,富邦-新營,2024-01-10,9693
2609,陽明,162,120,42,富邦-新營,2024-01-10,9693
2610,華航,43,2,41,富邦-新營,2024-01-10,9693
6120,達運,43,9,34,富邦-新營,2024-01-10,9693
2601,益航,31,0,31,富邦-新營,2024-01-10,9693
6116,彩晶,40,9,31,富邦-新營,2024-01-10,9693
2323,中環,30,0,30,富邦-新營,2024-01-10,9693
1618,合機,30,0,30,富邦-新營,2024-01-10,9693
2883B,凱基金乙特,30,0,30,富邦-新營,2024-01-10,9693
9907,統一實,24,0,24,富邦-新營,2024-01-10,9693
2317,鴻海,23,0,23,富邦-新營,2024-01-10,9693
2618,長榮航,26,3,23,富邦-新營,2024-01-10,9693
00722B,群益投資級電信債,23,0,23,富邦-新營,2024-01-10,9693
1605,華新,23,0,23,富邦-新營,2024-01-10,9693
00712,復華富時不動產,22,1,21,富邦-新營,2024-01-10,9693
00878,國泰永續高股息,20,0,20,富邦-新營,2024-01-10,9693
1718,中纖,20,0,20,富邦-新營,2024-01-10,9693
6139,亞翔,24,4,20,富邦-新營,2024-01-10,9693
9950,萬國通,20,0,20,富邦-新營,2024-01-10,9693
2301,光寶科,21,2,19,富邦-新營,2024-01-10,9693
2027,大成鋼,20,2,18,富邦-新營,2024-01-10,9693
2356,英業達,40,24,16,富邦-新營,2024-01-10,9693
2603,長榮,18,4,14,富邦-新營,2024-01-10,9693
6167,久正,14,0,14,富邦-新營,2024-01-10,9693
9919,康那香,18,4,14,富邦-新營,2024-01-10,9693
2014,中鴻,12,0,12,富邦-新營,2024-01-10,9693
2331,精英,12,0,12,富邦-新營,2024-01-10,9693
2409,友達,32,20,12,富邦-新營,2024-01-10,9693
2303,聯電,14,3,11,富邦-新營,2024-01-10,9693
2884,玉山金,10,0,10,富邦-新營,2024-01-10,9693
6770,力積電,10,0,10,富邦-新營,2024-01-10,9693
00930,永豐ESG低碳高息,10,0,10,富邦-新營,2024-01-10,9693
00665L,富邦�琤肭磪囓�2,10,0,10,富邦-新營,2024-01-10,9693
2312,金寶,13,3,10,富邦-新營,2024-01-10,9693
2340,台亞,10,0,10,富邦-新營,2024-01-10,9693
2501,國建,10,0,10,富邦-新營,2024-01-10,9693
5009,榮剛,10,0,10,富邦-新營,2024-01-10,9693
6233,旺玖,10,0,10,富邦-新營,2024-01-10,9693
8068,全達,12,2,10,富邦-新營,2024-01-10,9693
1710,東聯,9,0,9,富邦-新營,2024-01-10,9693
00904,新光臺灣半導體30,8,0,8,富邦-新營,2024-01-10,9693
3027,盛達,10,3,7,富邦-新營,2024-01-10,9693
3032,偉訓,8,1,7,富邦-新營,2024-01-10,9693
5871,中租-KY,7,0,7,富邦-新營,2024-01-10,9693
00929,復華台灣科技優息,121,1,120,富邦-新營,2024-01-11,9693
6799,來頡,101,1,100,富邦-新營,2024-01-11,9693
3017,奇鋐,109,41,68,富邦-新營,2024-01-11,9693
00706L,期元大S＆P日圓正2,62,0,62,富邦-新營,2024-01-11,9693
2887,台新金,60,0,60,富邦-新營,2024-01-11,9693
2329,華泰,225,168,57,富邦-新營,2024-01-11,9693
6770,力積電,32,0,32,富邦-新營,2024-01-11,9693
00637L,元大滬深300正2,30,0,30,富邦-新營,2024-01-11,9693
2409,友達,43,20,23,富邦-新營,2024-01-11,9693
2317,鴻海,22,0,22,富邦-新營,2024-01-11,9693
6231,系微,21,0,21,富邦-新營,2024-01-11,9693
00919,群益台灣精選高息,24,3,21,富邦-新營,2024-01-11,9693
1326,台化,20,0,20,富邦-新營,2024-01-11,9693
2609,陽明,78,58,20,富邦-新營,2024-01-11,9693
3224,三顧,20,0,20,富邦-新營,2024-01-11,9693
6695,芯鼎,27,7,20,富邦-新營,2024-01-11,9693
2449,京元電子,16,0,16,富邦-新營,2024-01-11,9693
2371,大同,22,6,16,富邦-新營,2024-01-11,9693
2353,宏��,60,47,13,富邦-新營,2024-01-11,9693
2801,彰銀,13,0,13,富邦-新營,2024-01-11,9693
3287,廣寰科,30,17,13,富邦-新營,2024-01-11,9693
1504,東元,12,0,12,富邦-新營,2024-01-11,9693
2344,華邦電,13,1,12,富邦-新營,2024-01-11,9693
6226,光鼎,12,0,12,富邦-新營,2024-01-11,9693
2241,艾姆勒,11,0,11,富邦-新營,2024-01-11,9693
00927,群益半導體收益,10,0,10,富邦-新營,2024-01-11,9693
00679B,元大美債20年,10,0,10,富邦-新營,2024-01-11,9693
00931B,統一美債20年,10,0,10,富邦-新營,2024-01-11,9693
2897,王道銀行,10,0,10,富邦-新營,2024-01-11,9693
3149,正達,10,0,10,富邦-新營,2024-01-11,9693
3260,威剛,11,1,10,富邦-新營,2024-01-11,9693
5512,力麒,10,0,10,富邦-新營,2024-01-11,9693
9904,寶成,10,0,10,富邦-新營,2024-01-11,9693
2884,玉山金,10,0,10,富邦-新營,2024-01-11,9693
2634,漢翔,9,0,9,富邦-新營,2024-01-11,9693
2606,裕民,10,1,9,富邦-新營,2024-01-11,9693
6164,華興,9,0,9,富邦-新營,2024-01-11,9693
00937B,群益ESG投等債20,9,0,9,富邦-新營,2024-01-11,9693
00904,新光臺灣半導體30,9,1,8,富邦-新營,2024-01-11,9693
6285,啟��,7,0,7,富邦-新營,2024-01-11,9693
00930,永豐ESG低碳高息,7,0,7,富邦-新營,2024-01-11,9693
1301,台塑,7,0,7,富邦-新營,2024-01-11,9693
00687B,國泰20年美債,6,0,6,富邦-新營,2024-01-11,9693
2408,南亞科,6,0,6,富邦-新營,2024-01-11,9693
2426,鼎元,6,0,6,富邦-新營,2024-01-11,9693
2484,希華,6,0,6,富邦-新營,2024-01-11,9693
3264,欣銓,6,0,6,富邦-新營,2024-01-11,9693
2603,長榮,11,6,5,富邦-新營,2024-01-11,9693
00680L,元大美債20正2,5,0,5,富邦-新營,2024-01-11,9693
0056,元大高股息,8,3,5,富邦-新營,2024-01-11,9693
00929,復華台灣科技優息,370,0,370,富邦-新營,2024-01-12,9693
00650L,復華香港正2,150,0,150,富邦-新營,2024-01-12,9693
2356,英業達,140,9,131,富邦-新營,2024-01-12,9693
2382,廣達,172,48,124,富邦-新營,2024-01-12,9693
6120,達運,108,7,101,富邦-新營,2024-01-12,9693
00680L,元大美債20正2,100,0,100,富邦-新營,2024-01-12,9693
2344,華邦電,74,1,73,富邦-新營,2024-01-12,9693
3231,緯創,128,55,73,富邦-新營,2024-01-12,9693
00712,復華富時不動產,32,0,32,富邦-新營,2024-01-12,9693
6016,康和證,30,0,30,富邦-新營,2024-01-12,9693
2365,昆盈,27,0,27,富邦-新營,2024-01-12,9693
2329,華泰,26,4,22,富邦-新營,2024-01-12,9693
9934,成霖,20,0,20,富邦-新營,2024-01-12,9693
00933B,國泰10Y+金融債,15,0,15,富邦-新營,2024-01-12,9693
0056,元大高股息,15,0,15,富邦-新營,2024-01-12,9693
2208,台船,16,3,13,富邦-新營,2024-01-12,9693
2101,南港,12,0,12,富邦-新營,2024-01-12,9693
6530,創威,16,4,12,富邦-新營,2024-01-12,9693
3027,盛達,13,2,11,富邦-新營,2024-01-12,9693
2498,宏達電,11,1,10,富邦-新營,2024-01-12,9693
4960,誠美材,30,20,10,富邦-新營,2024-01-12,9693
5880,合庫金,11,1,10,富邦-新營,2024-01-12,9693
6194,育富,10,0,10,富邦-新營,2024-01-12,9693
00919,群益台灣精選高息,12,2,10,富邦-新營,2024-01-12,9693
2618,長榮航,11,2,9,富邦-新營,2024-01-12,9693
8150,南茂,9,0,9,富邦-新營,2024-01-12,9693
2883,凱基金,8,0,8,富邦-新營,2024-01-12,9693
8227,巨有科技,52,44,8,富邦-新營,2024-01-12,9693
2402,毅嘉,8,0,8,富邦-新營,2024-01-12,9693
2888,新光金,33,25,8,富邦-新營,2024-01-12,9693
3704,合勤控,8,0,8,富邦-新營,2024-01-12,9693
2353,宏��,48,41,7,富邦-新營,2024-01-12,9693
4123,晟德,9,2,7,富邦-新營,2024-01-12,9693
2892,第一金,6,0,6,富邦-新營,2024-01-12,9693
2897,王道銀行,6,0,6,富邦-新營,2024-01-12,9693
2388,威盛,25,19,6,富邦-新營,2024-01-12,9693
2449,京元電子,9,3,6,富邦-新營,2024-01-12,9693
2301,光寶科,7,1,6,富邦-新營,2024-01-12,9693
1309,台達化,6,0,6,富邦-新營,2024-01-12,9693
2317,鴻海,7,2,5,富邦-新營,2024-01-12,9693
00632R,元大台灣50反1,5,0,5,富邦-新營,2024-01-12,9693
1609,大亞,5,0,5,富邦-新營,2024-01-12,9693
2405,輔信,5,0,5,富邦-新營,2024-01-12,9693
3363,上詮,6,1,5,富邦-新營,2024-01-12,9693
3686,達能,5,0,5,富邦-新營,2024-01-12,9693
5483,中美晶,5,0,5,富邦-新營,2024-01-12,9693
5515,建國,5,0,5,富邦-新營,2024-01-12,9693
6164,華興,8,3,5,富邦-新營,2024-01-12,9693
6791,虎門科技,5,0,5,富邦-新營,2024-01-12,9693
00927,群益半導體收益,4,0,4,富邦-新營,2024-01-12,9693
00687B,國泰20年美債,106,10,96,富邦-新營,2024-01-15,9693
00929,復華台灣科技優息,100,15,85,富邦-新營,2024-01-15,9693
2888,新光金,74,0,74,富邦-新營,2024-01-15,9693
8210,勤誠,45,5,40,富邦-新營,2024-01-15,9693
3390,旭軟,32,1,31,富邦-新營,2024-01-15,9693
3017,奇鋐,46,19,27,富邦-新營,2024-01-15,9693
00878,國泰永續高股息,22,1,21,富邦-新營,2024-01-15,9693
2618,長榮航,21,0,21,富邦-新營,2024-01-15,9693
2883,凱基金,19,0,19,富邦-新營,2024-01-15,9693
2610,華航,18,0,18,富邦-新營,2024-01-15,9693
00927,群益半導體收益,23,6,17,富邦-新營,2024-01-15,9693
3481,群創,15,0,15,富邦-新營,2024-01-15,9693
2356,英業達,30,15,15,富邦-新營,2024-01-15,9693
00937B,群益ESG投等債20,11,0,11,富邦-新營,2024-01-15,9693
2340,台亞,11,0,11,富邦-新營,2024-01-15,9693
3715,定穎投控,13,2,11,富邦-新營,2024-01-15,9693
3231,緯創,47,36,11,富邦-新營,2024-01-15,9693
2409,友達,11,0,11,富邦-新營,2024-01-15,9693
2353,宏��,40,30,10,富邦-新營,2024-01-15,9693
00679B,元大美債20年,10,0,10,富邦-新營,2024-01-15,9693
1733,五鼎,10,0,10,富邦-新營,2024-01-15,9693
3033,威健,10,0,10,富邦-新營,2024-01-15,9693
3062,建漢,10,0,10,富邦-新營,2024-01-15,9693
2736,富野,10,1,9,富邦-新營,2024-01-15,9693
2634,漢翔,15,7,8,富邦-新營,2024-01-15,9693
3006,晶豪科,12,5,7,富邦-新營,2024-01-15,9693
5706,鳳凰,7,0,7,富邦-新營,2024-01-15,9693
0056,元大高股息,8,1,7,富邦-新營,2024-01-15,9693
2241,艾姆勒,10,4,6,富邦-新營,2024-01-15,9693
2897,王道銀行,6,0,6,富邦-新營,2024-01-15,9693
2887,台新金,6,0,6,富邦-新營,2024-01-15,9693
5351,鈺創,14,8,6,富邦-新營,2024-01-15,9693
3037,欣興,5,0,5,富邦-新營,2024-01-15,9693
2317,鴻海,5,0,5,富邦-新營,2024-01-15,9693
1718,中纖,5,0,5,富邦-新營,2024-01-15,9693
00738U,期元大道瓊白銀,5,0,5,富邦-新營,2024-01-15,9693
00688L,國泰20年美債正2,5,0,5,富邦-新營,2024-01-15,9693
1710,東聯,5,0,5,富邦-新營,2024-01-15,9693
3149,正達,5,0,5,富邦-新營,2024-01-15,9693
3264,欣銓,6,1,5,富邦-新營,2024-01-15,9693
3583,辛耘,5,0,5,富邦-新營,2024-01-15,9693
6233,旺玖,5,0,5,富邦-新營,2024-01-15,9693
6191,精成科,5,0,5,富邦-新營,2024-01-15,9693
3443,創意,8,4,4,富邦-新營,2024-01-15,9693
1503,士電,35,31,4,富邦-新營,2024-01-15,9693
2208,台船,6,2,4,富邦-新營,2024-01-15,9693
2748,雲品,4,0,4,富邦-新營,2024-01-15,9693
3035,智原,10,7,3,富邦-新營,2024-01-15,9693
00922,國泰台灣領袖50,3,0,3,富邦-新營,2024-01-15,9693
00713,元大台灣高息低波,3,0,3,富邦-新營,2024-01-15,9693
00688L,國泰20年美債正2,201,0,201,富邦-新營,2024-01-16,9693
00929,復華台灣科技優息,178,2,176,富邦-新營,2024-01-16,9693
00753L,中信中國50正2,125,0,125,富邦-新營,2024-01-16,9693
4960,誠美材,100,0,100,富邦-新營,2024-01-16,9693
00680L,元大美債20正2,81,0,81,富邦-新營,2024-01-16,9693
2883,凱基金,80,2,78,富邦-新營,2024-01-16,9693
2888,新光金,65,3,62,富邦-新營,2024-01-16,9693
2382,廣達,58,3,55,富邦-新營,2024-01-16,9693
00919,群益台灣精選高息,44,0,44,富邦-新營,2024-01-16,9693
6120,達運,93,55,38,富邦-新營,2024-01-16,9693
8096,擎亞,76,38,38,富邦-新營,2024-01-16,9693
2610,華航,37,0,37,富邦-新營,2024-01-16,9693
00878,國泰永續高股息,37,0,37,富邦-新營,2024-01-16,9693
2405,輔信,72,36,36,富邦-新營,2024-01-16,9693
00881,國泰台灣5G+,32,0,32,富邦-新營,2024-01-16,9693
0056,元大高股息,38,7,31,富邦-新營,2024-01-16,9693
1718,中纖,27,0,27,富邦-新營,2024-01-16,9693
9945,潤泰新,27,0,27,富邦-新營,2024-01-16,9693
6695,芯鼎,91,67,24,富邦-新營,2024-01-16,9693
3033,威健,26,3,23,富邦-新營,2024-01-16,9693
6770,力積電,23,0,23,富邦-新營,2024-01-16,9693
2892,第一金,22,0,22,富邦-新營,2024-01-16,9693
3231,緯創,28,6,22,富邦-新營,2024-01-16,9693
2303,聯電,24,3,21,富邦-新營,2024-01-16,9693
5880,合庫金,21,0,21,富邦-新營,2024-01-16,9693
2897,王道銀行,20,0,20,富邦-新營,2024-01-16,9693
6116,彩晶,20,0,20,富邦-新營,2024-01-16,9693
6207,雷科,20,0,20,富邦-新營,2024-01-16,9693
9907,統一實,20,0,20,富邦-新營,2024-01-16,9693
3287,廣寰科,25,6,19,富邦-新營,2024-01-16,9693
2344,華邦電,25,7,18,富邦-新營,2024-01-16,9693
2801,彰銀,16,0,16,富邦-新營,2024-01-16,9693
2609,陽明,45,29,16,富邦-新營,2024-01-16,9693
00725B,國泰投資級公司債,15,0,15,富邦-新營,2024-01-16,9693
00687B,國泰20年美債,15,0,15,富邦-新營,2024-01-16,9693
1609,大亞,18,3,15,富邦-新營,2024-01-16,9693
2603,長榮,21,7,14,富邦-新營,2024-01-16,9693
2317,鴻海,15,1,14,富邦-新營,2024-01-16,9693
2323,中環,13,0,13,富邦-新營,2024-01-16,9693
6194,育富,13,0,13,富邦-新營,2024-01-16,9693
2884,玉山金,13,0,13,富邦-新營,2024-01-16,9693
00720B,元大投資級公司債,12,0,12,富邦-新營,2024-01-16,9693
00927,群益半導體收益,12,0,12,富邦-新營,2024-01-16,9693
1312,國喬,12,0,12,富邦-新營,2024-01-16,9693
2882,國泰金,12,0,12,富邦-新營,2024-01-16,9693
1455,集盛,11,0,11,富邦-新營,2024-01-16,9693
5483,中美晶,11,0,11,富邦-新營,2024-01-16,9693
1309,台達化,10,0,10,富邦-新營,2024-01-16,9693
1731,美吾華,10,0,10,富邦-新營,2024-01-16,9693
2352,佳世達,10,0,10,富邦-新營,2024-01-16,9693
00929,復華台灣科技優息,189,18,171,富邦-新營,2024-01-17,9693
00753L,中信中國50正2,120,0,120,富邦-新營,2024-01-17,9693
00919,群益台灣精選高息,95,20,75,富邦-新營,2024-01-17,9693
0056,元大高股息,69,2,67,富邦-新營,2024-01-17,9693
00650L,復華香港正2,61,0,61,富邦-新營,2024-01-17,9693
2801,彰銀,61,0,61,富邦-新營,2024-01-17,9693
2888,新光金,56,0,56,富邦-新營,2024-01-17,9693
00680L,元大美債20正2,54,0,54,富邦-新營,2024-01-17,9693
00688L,國泰20年美債正2,53,0,53,富邦-新營,2024-01-17,9693
2867,三商壽,52,0,52,富邦-新營,2024-01-17,9693
6120,達運,50,1,49,富邦-新營,2024-01-17,9693
6451,訊芯-KY,150,101,49,富邦-新營,2024-01-17,9693
1718,中纖,58,10,48,富邦-新營,2024-01-17,9693
00715L,期街口布蘭特正2,45,0,45,富邦-新營,2024-01-17,9693
00882,中信中國高股息,49,5,44,富邦-新營,2024-01-17,9693
2241,艾姆勒,42,0,42,富邦-新營,2024-01-17,9693
00706L,期元大S＆P日圓正2,41,0,41,富邦-新營,2024-01-17,9693
2356,英業達,39,2,37,富邦-新營,2024-01-17,9693
2409,友達,35,1,34,富邦-新營,2024-01-17,9693
4909,新復興,48,17,31,富邦-新營,2024-01-17,9693
5880,合庫金,30,0,30,富邦-新營,2024-01-17,9693
00713,元大台灣高息低波,32,2,30,富邦-新營,2024-01-17,9693
2344,華邦電,39,11,28,富邦-新營,2024-01-17,9693
00878,國泰永續高股息,57,31,26,富邦-新營,2024-01-17,9693
2486,一詮,44,18,26,富邦-新營,2024-01-17,9693
2610,華航,25,2,23,富邦-新營,2024-01-17,9693
3499,環天科,23,0,23,富邦-新營,2024-01-17,9693
1325,恆大,23,2,21,富邦-新營,2024-01-17,9693
3049,精金,21,0,21,富邦-新營,2024-01-17,9693
8429,金麗-KY,21,0,21,富邦-新營,2024-01-17,9693
3046,建��,30,10,20,富邦-新營,2024-01-17,9693
6770,力積電,20,0,20,富邦-新營,2024-01-17,9693
6550,北極星藥業-KY,23,4,19,富邦-新營,2024-01-17,9693
00927,群益半導體收益,19,0,19,富邦-新營,2024-01-17,9693
2317,鴻海,18,0,18,富邦-新營,2024-01-17,9693
1528,恩德,56,38,18,富邦-新營,2024-01-17,9693
1605,華新,18,1,17,富邦-新營,2024-01-17,9693
2887,台新金,17,0,17,富邦-新營,2024-01-17,9693
2002,中鋼,16,0,16,富邦-新營,2024-01-17,9693
3027,盛達,15,0,15,富邦-新營,2024-01-17,9693
3163,波若威,15,0,15,富邦-新營,2024-01-17,9693
2303,聯電,42,28,14,富邦-新營,2024-01-17,9693
1503,士電,16,2,14,富邦-新營,2024-01-17,9693
2892,第一金,14,0,14,富邦-新營,2024-01-17,9693
2014,中鴻,12,0,12,富邦-新營,2024-01-17,9693
2498,宏達電,18,6,12,富邦-新營,2024-01-17,9693
6167,久正,12,0,12,富邦-新營,2024-01-17,9693
1584,精剛,11,0,11,富邦-新營,2024-01-17,9693
2340,台亞,11,0,11,富邦-新營,2024-01-17,9693
2371,大同,11,0,11,富邦-新營,2024-01-17,9693
00706L,期元大S＆P日圓正2,140,0,140,富邦-新營,2024-01-18,9693
9907,統一實,100,0,100,富邦-新營,2024-01-18,9693
8096,擎亞,136,38,98,富邦-新營,2024-01-18,9693
00929,復華台灣科技優息,115,40,75,富邦-新營,2024-01-18,9693
00650L,復華香港正2,67,0,67,富邦-新營,2024-01-18,9693
00712,復華富時不動產,52,0,52,富邦-新營,2024-01-18,9693
6117,迎廣,154,115,39,富邦-新營,2024-01-18,9693
2241,艾姆勒,38,0,38,富邦-新營,2024-01-18,9693
3025,星通,37,7,30,富邦-新營,2024-01-18,9693
2303,聯電,26,0,26,富邦-新營,2024-01-18,9693
00687B,國泰20年美債,32,10,22,富邦-新營,2024-01-18,9693
2409,友達,37,17,20,富邦-新營,2024-01-18,9693
9904,寶成,20,0,20,富邦-新營,2024-01-18,9693
3017,奇鋐,38,19,19,富邦-新營,2024-01-18,9693
00882,中信中國高股息,19,0,19,富邦-新營,2024-01-18,9693
00919,群益台灣精選高息,54,37,17,富邦-新營,2024-01-18,9693
00636,國泰中國A50,17,0,17,富邦-新營,2024-01-18,9693
2332,友訊,18,1,17,富邦-新營,2024-01-18,9693
0056,元大高股息,15,0,15,富邦-新營,2024-01-18,9693
3051,力特,12,1,11,富邦-新營,2024-01-18,9693
1529,樂事綠能,10,0,10,富邦-新營,2024-01-18,9693
1533,車王電,10,0,10,富邦-新營,2024-01-18,9693
1101,台泥,9,0,9,富邦-新營,2024-01-18,9693
2323,中環,13,4,9,富邦-新營,2024-01-18,9693
5351,鈺創,11,3,8,富邦-新營,2024-01-18,9693
6116,彩晶,18,10,8,富邦-新營,2024-01-18,9693
2885,元大金,7,0,7,富邦-新營,2024-01-18,9693
1503,士電,7,0,7,富邦-新營,2024-01-18,9693
2204,中華,7,0,7,富邦-新營,2024-01-18,9693
6770,力積電,7,0,7,富邦-新營,2024-01-18,9693
2882,國泰金,7,1,6,富邦-新營,2024-01-18,9693
00679B,元大美債20年,6,0,6,富邦-新營,2024-01-18,9693
5426,振發,350,344,6,富邦-新營,2024-01-18,9693
6122,擎邦,6,0,6,富邦-新營,2024-01-18,9693
2382,廣達,5,0,5,富邦-新營,2024-01-18,9693
2887,台新金,5,0,5,富邦-新營,2024-01-18,9693
00720B,元大投資級公司債,5,0,5,富邦-新營,2024-01-18,9693
00751B,元大AAA至A公司債,5,0,5,富邦-新營,2024-01-18,9693
1326,台化,5,0,5,富邦-新營,2024-01-18,9693
1609,大亞,5,0,5,富邦-新營,2024-01-18,9693
2739,寒舍,5,0,5,富邦-新營,2024-01-18,9693
3059,華晶科,6,1,5,富邦-新營,2024-01-18,9693
6129,普誠,5,0,5,富邦-新營,2024-01-18,9693
1309,台達化,5,0,5,富邦-新營,2024-01-18,9693
2002,中鋼,4,0,4,富邦-新營,2024-01-18,9693
2610,華航,5,0,5,富邦-新營,2024-01-18,9693
00904,新光臺灣半導體30,4,0,4,富邦-新營,2024-01-18,9693
00795B,中信美國公債20年,4,0,4,富邦-新營,2024-01-18,9693
2329,華泰,10,6,4,富邦-新營,2024-01-18,9693
2356,英業達,8,4,4,富邦-新營,2024-01-18,9693
00929,復華台灣科技優息,114,5,109,富邦-新營,2024-01-19,9693
00650L,復華香港正2,270,200,70,富邦-新營,2024-01-19,9693
2382,廣達,192,132,60,富邦-新營,2024-01-19,9693
2208,台船,57,0,57,富邦-新營,2024-01-19,9693
00687B,國泰20年美債,43,0,43,富邦-新營,2024-01-19,9693
2409,友達,44,1,43,富邦-新營,2024-01-19,9693
2241,艾姆勒,40,0,40,富邦-新營,2024-01-19,9693
00679B,元大美債20年,35,0,35,富邦-新營,2024-01-19,9693
00720B,元大投資級公司債,34,0,34,富邦-新營,2024-01-19,9693
2834,臺企銀,30,0,30,富邦-新營,2024-01-19,9693
00706L,期元大S＆P日圓正2,30,0,30,富邦-新營,2024-01-19,9693
9907,統一實,30,0,30,富邦-新營,2024-01-19,9693
2618,長榮航,35,8,27,富邦-新營,2024-01-19,9693
00919,群益台灣精選高息,41,14,27,富邦-新營,2024-01-19,9693
1528,恩德,50,28,22,富邦-新營,2024-01-19,9693
00885,富邦越南,20,2,18,富邦-新營,2024-01-19,9693
6116,彩晶,20,2,18,富邦-新營,2024-01-19,9693
00882,中信中國高股息,17,0,17,富邦-新營,2024-01-19,9693
1325,恆大,17,0,17,富邦-新營,2024-01-19,9693
6695,芯鼎,26,9,17,富邦-新營,2024-01-19,9693
00937B,群益ESG投等債20,26,9,17,富邦-新營,2024-01-19,9693
6770,力積電,13,0,13,富邦-新營,2024-01-19,9693
2610,華航,12,0,12,富邦-新營,2024-01-19,9693
00904,新光臺灣半導體30,12,0,12,富邦-新營,2024-01-19,9693
2399,映泰,11,0,11,富邦-新營,2024-01-19,9693
3006,晶豪科,54,43,11,富邦-新營,2024-01-19,9693
00665L,富邦�琤肭磪囓�2,10,0,10,富邦-新營,2024-01-19,9693
1303,南亞,10,0,10,富邦-新營,2024-01-19,9693
1529,樂事綠能,10,0,10,富邦-新營,2024-01-19,9693
3664,安瑞-KY,10,0,10,富邦-新營,2024-01-19,9693
5521,工信,10,0,10,富邦-新營,2024-01-19,9693
9928,中視,10,0,10,富邦-新營,2024-01-19,9693
1301,台塑,9,0,9,富邦-新營,2024-01-19,9693
00772B,中信高評級公司債,10,1,9,富邦-新營,2024-01-19,9693
2014,中鴻,14,5,9,富邦-新營,2024-01-19,9693
4960,誠美材,21,12,9,富邦-新營,2024-01-19,9693
00751B,元大AAA至A公司債,8,0,8,富邦-新營,2024-01-19,9693
1464,得力,8,0,8,富邦-新營,2024-01-19,9693
2312,金寶,8,0,8,富邦-新營,2024-01-19,9693
6443,元晶,8,0,8,富邦-新營,2024-01-19,9693
2603,長榮,12,4,8,富邦-新營,2024-01-19,9693
00900,富邦特選高股息30,7,0,7,富邦-新營,2024-01-19,9693
2609,陽明,17,10,7,富邦-新營,2024-01-19,9693
1609,大亞,9,2,7,富邦-新營,2024-01-19,9693
2344,華邦電,11,4,7,富邦-新營,2024-01-19,9693
6163,華電網,7,0,7,富邦-新營,2024-01-19,9693
9945,潤泰新,8,1,7,富邦-新營,2024-01-19,9693
2887,台新金,6,0,6,富邦-新營,2024-01-19,9693
2002,中鋼,6,1,5,富邦-新營,2024-01-19,9693
00931B,統一美債20年,8,3,5,富邦-新營,2024-01-19,9693
4960,誠美材,1417,13,1404,富邦-新營,2024-01-22,9693
3231,緯創,260,65,195,富邦-新營,2024-01-22,9693
00753L,中信中國50正2,207,33,174,富邦-新營,2024-01-22,9693
2913,農林,80,4,76,富邦-新營,2024-01-22,9693
6120,達運,65,0,65,富邦-新營,2024-01-22,9693
00882,中信中國高股息,63,0,63,富邦-新營,2024-01-22,9693
00715L,期街口布蘭特正2,50,0,50,富邦-新營,2024-01-22,9693
00688L,國泰20年美債正2,54,5,49,富邦-新營,2024-01-22,9693
3287,廣寰科,35,10,25,富邦-新營,2024-01-22,9693
00897,富邦基因免疫生技,20,0,20,富邦-新營,2024-01-22,9693
3322,建舜電,20,0,20,富邦-新營,2024-01-22,9693
6163,華電網,20,0,20,富邦-新營,2024-01-22,9693
1101,台泥,20,1,19,富邦-新營,2024-01-22,9693
5880,合庫金,19,0,19,富邦-新營,2024-01-22,9693
00665L,富邦�琤肭磪囓�2,18,0,18,富邦-新營,2024-01-22,9693
1216,統一,15,0,15,富邦-新營,2024-01-22,9693
2609,陽明,34,19,15,富邦-新營,2024-01-22,9693
2332,友訊,15,0,15,富邦-新營,2024-01-22,9693
00900,富邦特選高股息30,15,1,14,富邦-新營,2024-01-22,9693
2002,中鋼,14,0,14,富邦-新營,2024-01-22,9693
2316,楠梓電,13,0,13,富邦-新營,2024-01-22,9693
2801,彰銀,13,0,13,富邦-新營,2024-01-22,9693
6282,康舒,13,0,13,富邦-新營,2024-01-22,9693
3694,海華,12,0,12,富邦-新營,2024-01-22,9693
6233,旺玖,14,2,12,富邦-新營,2024-01-22,9693
00937B,群益ESG投等債20,21,10,11,富邦-新營,2024-01-22,9693
2323,中環,12,1,11,富邦-新營,2024-01-22,9693
4806,桂田文創,11,0,11,富邦-新營,2024-01-22,9693
2834,臺企銀,10,0,10,富邦-新營,2024-01-22,9693
6188,廣明,10,0,10,富邦-新營,2024-01-22,9693
00726B,國泰新興投等債,10,0,10,富邦-新營,2024-01-22,9693
1528,恩德,10,0,10,富邦-新營,2024-01-22,9693
3522,御嵿,10,0,10,富邦-新營,2024-01-22,9693
4909,新復興,85,75,10,富邦-新營,2024-01-22,9693
5488,松普,10,0,10,富邦-新營,2024-01-22,9693
2303,聯電,22,12,10,富邦-新營,2024-01-22,9693
00679B,元大美債20年,10,1,9,富邦-新營,2024-01-22,9693
2892,第一金,9,0,9,富邦-新營,2024-01-22,9693
6142,友勁,9,0,9,富邦-新營,2024-01-22,9693
8096,擎亞,9,0,9,富邦-新營,2024-01-22,9693
00687B,國泰20年美債,8,0,8,富邦-新營,2024-01-22,9693
8059,凱碩,7,0,7,富邦-新營,2024-01-22,9693
3049,精金,10,3,7,富邦-新營,2024-01-22,9693
2449,京元電子,26,19,7,富邦-新營,2024-01-22,9693
9939,宏全,8,2,6,富邦-新營,2024-01-22,9693
2344,華邦電,6,0,6,富邦-新營,2024-01-22,9693
2405,輔信,11,5,6,富邦-新營,2024-01-22,9693
3033,威健,21,15,6,富邦-新營,2024-01-22,9693
6139,亞翔,10,4,6,富邦-新營,2024-01-22,9693
2353,宏��,36,30,6,富邦-新營,2024-01-22,9693
3231,緯創,175,31,144,富邦-新營,2024-01-23,9693
1314,中石化,80,0,80,富邦-新營,2024-01-23,9693
00680L,元大美債20正2,50,0,50,富邦-新營,2024-01-23,9693
3706,神達,58,8,50,富邦-新營,2024-01-23,9693
2382,廣達,46,8,38,富邦-新營,2024-01-23,9693
00673R,期元大S＆P原油反1,25,0,25,富邦-新營,2024-01-23,9693
2002,中鋼,24,1,23,富邦-新營,2024-01-23,9693
2610,華航,25,3,22,富邦-新營,2024-01-23,9693
00676R,富邦臺灣加權反1,20,0,20,富邦-新營,2024-01-23,9693
0056,元大高股息,20,4,16,富邦-新營,2024-01-23,9693
2609,陽明,76,60,16,富邦-新營,2024-01-23,9693
4960,誠美材,21,5,16,富邦-新營,2024-01-23,9693
00937B,群益ESG投等債20,15,0,15,富邦-新營,2024-01-23,9693
00688L,國泰20年美債正2,15,0,15,富邦-新營,2024-01-23,9693
6116,彩晶,39,27,12,富邦-新營,2024-01-23,9693
00882,中信中國高股息,11,0,11,富邦-新營,2024-01-23,9693
1101,台泥,12,1,11,富邦-新營,2024-01-23,9693
1618,合機,11,0,11,富邦-新營,2024-01-23,9693
2331,精英,20,9,11,富邦-新營,2024-01-23,9693
00795B,中信美國公債20年,10,0,10,富邦-新營,2024-01-23,9693
1102,亞泥,10,0,10,富邦-新營,2024-01-23,9693
00636,國泰中國A50,10,0,10,富邦-新營,2024-01-23,9693
2527,宏璟,10,0,10,富邦-新營,2024-01-23,9693
8034,榮群,20,10,10,富邦-新營,2024-01-23,9693
9105,泰金寶-DR,10,0,10,富邦-新營,2024-01-23,9693
00919,群益台灣精選高息,24,15,9,富邦-新營,2024-01-23,9693
2537,聯上發,10,1,9,富邦-新營,2024-01-23,9693
6550,北極星藥業-KY,10,1,9,富邦-新營,2024-01-23,9693
2887,台新金,10,3,7,富邦-新營,2024-01-23,9693
2618,長榮航,9,2,7,富邦-新營,2024-01-23,9693
2014,中鴻,11,5,6,富邦-新營,2024-01-23,9693
2489,瑞軒,7,1,6,富邦-新營,2024-01-23,9693
2515,中工,6,0,6,富邦-新營,2024-01-23,9693
2801,彰銀,6,0,6,富邦-新營,2024-01-23,9693
3287,廣寰科,15,9,6,富邦-新營,2024-01-23,9693
6120,達運,18,12,6,富邦-新營,2024-01-23,9693
6153,嘉聯益,6,0,6,富邦-新營,2024-01-23,9693
3035,智原,6,1,5,富邦-新營,2024-01-23,9693
00633L,富邦上証正2,14,9,5,富邦-新營,2024-01-23,9693
2031,新光鋼,5,0,5,富邦-新營,2024-01-23,9693
2316,楠梓電,5,0,5,富邦-新營,2024-01-23,9693
2457,飛宏,5,0,5,富邦-新營,2024-01-23,9693
3058,立德,5,0,5,富邦-新營,2024-01-23,9693
3535,晶彩科,5,0,5,富邦-新營,2024-01-23,9693
3712,永崴投控,11,6,5,富邦-新營,2024-01-23,9693
6109,亞元,5,0,5,富邦-新營,2024-01-23,9693
6446,藥華藥,5,0,5,富邦-新營,2024-01-23,9693
8936,國統,5,1,4,富邦-新營,2024-01-23,9693
2419,仲琦,4,0,4,富邦-新營,2024-01-23,9693
3059,華晶科,14,10,4,富邦-新營,2024-01-23,9693
4960,誠美材,1197,0,1197,富邦-新營,2024-01-24,9693
00680L,元大美債20正2,72,0,72,富邦-新營,2024-01-24,9693
00937B,群益ESG投等債20,62,7,55,富邦-新營,2024-01-24,9693
3437,榮創,33,0,33,富邦-新營,2024-01-24,9693
00679B,元大美債20年,32,0,32,富邦-新營,2024-01-24,9693
8054,安國,31,0,31,富邦-新營,2024-01-24,9693
00715L,期街口布蘭特正2,40,10,30,富邦-新營,2024-01-24,9693
2344,華邦電,48,21,27,富邦-新營,2024-01-24,9693
00637L,元大滬深300正2,21,0,21,富邦-新營,2024-01-24,9693
00688L,國泰20年美債正2,21,0,21,富邦-新營,2024-01-24,9693
6111,大宇資,32,12,20,富邦-新營,2024-01-24,9693
6530,創威,20,0,20,富邦-新營,2024-01-24,9693
3481,群創,57,38,19,富邦-新營,2024-01-24,9693
2515,中工,16,0,16,富邦-新營,2024-01-24,9693
2618,長榮航,18,3,15,富邦-新營,2024-01-24,9693
2409,友達,19,4,15,富邦-新營,2024-01-24,9693
3055,蔚華科,26,12,14,富邦-新營,2024-01-24,9693
2369,菱生,47,34,13,富邦-新營,2024-01-24,9693
00919,群益台灣精選高息,14,1,13,富邦-新營,2024-01-24,9693
00933B,國泰10Y+金融債,12,0,12,富邦-新營,2024-01-24,9693
2374,佳能,42,30,12,富邦-新營,2024-01-24,9693
6237,驊訊,22,10,12,富邦-新營,2024-01-24,9693
6120,達運,11,0,11,富邦-新營,2024-01-24,9693
00687B,國泰20年美債,10,0,10,富邦-新營,2024-01-24,9693
3023,信邦,10,0,10,富邦-新營,2024-01-24,9693
9105,泰金寶-DR,10,0,10,富邦-新營,2024-01-24,9693
1504,東元,10,1,9,富邦-新營,2024-01-24,9693
1618,合機,9,0,9,富邦-新營,2024-01-24,9693
8936,國統,18,9,9,富邦-新營,2024-01-24,9693
00902,中信電池及儲能,7,0,7,富邦-新營,2024-01-24,9693
3260,威剛,8,1,7,富邦-新營,2024-01-24,9693
1612,宏泰,7,0,7,富邦-新營,2024-01-24,9693
1718,中纖,10,3,7,富邦-新營,2024-01-24,9693
2324,仁寶,7,0,7,富邦-新營,2024-01-24,9693
2329,華泰,18,11,7,富邦-新營,2024-01-24,9693
2612,中航,7,0,7,富邦-新營,2024-01-24,9693
2421,建準,31,24,7,富邦-新營,2024-01-24,9693
2313,華通,22,15,7,富邦-新營,2024-01-24,9693
3265,台星科,9,3,6,富邦-新營,2024-01-24,9693
3504,揚明光,11,5,6,富邦-新營,2024-01-24,9693
5426,振發,15,9,6,富邦-新營,2024-01-24,9693
00929,復華台灣科技優息,11,6,5,富邦-新營,2024-01-24,9693
00795B,中信美國公債20年,5,0,5,富邦-新營,2024-01-24,9693
2031,新光鋼,5,0,5,富邦-新營,2024-01-24,9693
3027,盛達,5,0,5,富邦-新營,2024-01-24,9693
3530,晶相光,5,0,5,富邦-新營,2024-01-24,9693
3545,敦泰,6,1,5,富邦-新營,2024-01-24,9693
4414,如興,5,0,5,富邦-新營,2024-01-24,9693
5351,鈺創,8,3,5,富邦-新營,2024-01-24,9693
6605,帝寶,5,0,5,富邦-新營,2024-01-24,9693
00680L,元大美債20正2,76,0,76,富邦-新營,2024-01-25,9693
00937B,群益ESG投等債20,71,0,71,富邦-新營,2024-01-25,9693
00687B,國泰20年美債,52,0,52,富邦-新營,2024-01-25,9693
8105,凌巨,37,2,35,富邦-新營,2024-01-25,9693
1536,和大,33,0,33,富邦-新營,2024-01-25,9693
1618,合機,30,0,30,富邦-新營,2024-01-25,9693
00637L,元大滬深300正2,50,26,24,富邦-新營,2024-01-25,9693
8064,東捷,25,1,24,富邦-新營,2024-01-25,9693
6167,久正,23,0,23,富邦-新營,2024-01-25,9693
2486,一詮,22,0,22,富邦-新營,2024-01-25,9693
2484,希華,20,0,20,富邦-新營,2024-01-25,9693
8096,擎亞,55,35,20,富邦-新營,2024-01-25,9693
00720B,元大投資級公司債,18,0,18,富邦-新營,2024-01-25,9693
1612,宏泰,16,0,16,富邦-新營,2024-01-25,9693
2365,昆盈,36,20,16,富邦-新營,2024-01-25,9693
2241,艾姆勒,13,0,13,富邦-新營,2024-01-25,9693
2515,中工,12,0,12,富邦-新營,2024-01-25,9693
5521,工信,12,1,11,富邦-新營,2024-01-25,9693
00679B,元大美債20年,12,2,10,富邦-新營,2024-01-25,9693
00688L,國泰20年美債正2,10,0,10,富邦-新營,2024-01-25,9693
00712,復華富時不動產,10,0,10,富邦-新營,2024-01-25,9693
1907,永豐餘,10,0,10,富邦-新營,2024-01-25,9693
2363,矽統,10,0,10,富邦-新營,2024-01-25,9693
2739,寒舍,11,1,10,富邦-新營,2024-01-25,9693
2915,潤泰全,10,0,10,富邦-新營,2024-01-25,9693
6229,研通,10,0,10,富邦-新營,2024-01-25,9693
6244,茂迪,10,0,10,富邦-新營,2024-01-25,9693
00927,群益半導體收益,20,10,10,富邦-新營,2024-01-25,9693
2609,陽明,9,0,9,富邦-新營,2024-01-25,9693
1718,中纖,9,0,9,富邦-新營,2024-01-25,9693
5478,智冠,9,0,9,富邦-新營,2024-01-25,9693
00891,中信關鍵半導體,10,2,8,富邦-新營,2024-01-25,9693
6237,驊訊,10,2,8,富邦-新營,2024-01-25,9693
2369,菱生,30,22,8,富邦-新營,2024-01-25,9693
2409,友達,19,12,7,富邦-新營,2024-01-25,9693
5483,中美晶,7,0,7,富邦-新營,2024-01-25,9693
2505,國揚,7,0,7,富邦-新營,2024-01-25,9693
4129,聯合,8,1,7,富邦-新營,2024-01-25,9693
6274,台燿,8,1,7,富邦-新營,2024-01-25,9693
6547,高端疫苗,7,0,7,富邦-新營,2024-01-25,9693
6182,合晶,7,1,6,富邦-新營,2024-01-25,9693
00931B,統一美債20年,6,0,6,富邦-新營,2024-01-25,9693
2401,凌陽,6,0,6,富邦-新營,2024-01-25,9693
2618,長榮航,10,4,6,富邦-新營,2024-01-25,9693
3704,合勤控,6,0,6,富邦-新營,2024-01-25,9693
8423,保綠-KY,6,0,6,富邦-新營,2024-01-25,9693
2344,華邦電,12,6,6,富邦-新營,2024-01-25,9693
2634,漢翔,5,0,5,富邦-新營,2024-01-25,9693
00706L,期元大S＆P日圓正2,5,0,5,富邦-新營,2024-01-25,9693
00727B,國泰優選非投等債,5,0,5,富邦-新營,2024-01-25,9693
00650L,復華香港正2,200,0,200,富邦-新營,2024-01-26,9693
2303,聯電,87,15,72,富邦-新營,2024-01-26,9693
00929,復華台灣科技優息,66,8,58,富邦-新營,2024-01-26,9693
00885,富邦越南,54,0,54,富邦-新營,2024-01-26,9693
5284,jpp-KY,50,0,50,富邦-新營,2024-01-26,9693
8105,凌巨,52,5,47,富邦-新營,2024-01-26,9693
00937B,群益ESG投等債20,45,2,43,富邦-新營,2024-01-26,9693
2409,友達,45,4,41,富邦-新營,2024-01-26,9693
00878,國泰永續高股息,32,2,30,富邦-新營,2024-01-26,9693
00882,中信中國高股息,29,4,25,富邦-新營,2024-01-26,9693
2324,仁寶,93,70,23,富邦-新營,2024-01-26,9693
2313,華通,33,10,23,富邦-新營,2024-01-26,9693
00918,大華優利高填息30,22,0,22,富邦-新營,2024-01-26,9693
3231,緯創,44,22,22,富邦-新營,2024-01-26,9693
00764B,群益25年美債,21,0,21,富邦-新營,2024-01-26,9693
0056,元大高股息,21,0,21,富邦-新營,2024-01-26,9693
2353,宏��,34,14,20,富邦-新營,2024-01-26,9693
2601,益航,20,0,20,富邦-新營,2024-01-26,9693
2329,華泰,20,2,18,富邦-新營,2024-01-26,9693
2356,英業達,64,46,18,富邦-新營,2024-01-26,9693
00665L,富邦�琤肭磪囓�2,17,0,17,富邦-新營,2024-01-26,9693
1528,恩德,15,0,15,富邦-新營,2024-01-26,9693
2241,艾姆勒,13,0,13,富邦-新營,2024-01-26,9693
00927,群益半導體收益,12,0,12,富邦-新營,2024-01-26,9693
00687B,國泰20年美債,12,0,12,富邦-新營,2024-01-26,9693
3027,盛達,11,0,11,富邦-新營,2024-01-26,9693
00915,凱基優選高股息30,11,0,11,富邦-新營,2024-01-26,9693
00688L,國泰20年美債正2,10,0,10,富邦-新營,2024-01-26,9693
00632R,元大台灣50反1,10,0,10,富邦-新營,2024-01-26,9693
1539,巨庭,10,0,10,富邦-新營,2024-01-26,9693
2707,晶華,10,0,10,富邦-新營,2024-01-26,9693
4960,誠美材,10,0,10,富邦-新營,2024-01-26,9693
8034,榮群,10,0,10,富邦-新營,2024-01-26,9693
6462,神盾,18,8,10,富邦-新營,2024-01-26,9693
3033,威健,10,1,9,富邦-新營,2024-01-26,9693
2421,建準,13,4,9,富邦-新營,2024-01-26,9693
00680L,元大美債20正2,8,0,8,富邦-新營,2024-01-26,9693
1907,永豐餘,10,2,8,富邦-新營,2024-01-26,9693
3047,訊舟,10,2,8,富邦-新營,2024-01-26,9693
5223,安力-KY,8,0,8,富邦-新營,2024-01-26,9693
6133,金橋,10,2,8,富邦-新營,2024-01-26,9693
2419,仲琦,10,2,8,富邦-新營,2024-01-26,9693
00633L,富邦上証正2,10,3,7,富邦-新營,2024-01-26,9693
4909,新復興,19,12,7,富邦-新營,2024-01-26,9693
6113,亞矽,35,28,7,富邦-新營,2024-01-26,9693
2344,華邦電,9,3,6,富邦-新營,2024-01-26,9693
00753L,中信中國50正2,10,4,6,富邦-新營,2024-01-26,9693
1718,中纖,6,0,6,富邦-新營,2024-01-26,9693
1785,光洋科,6,0,6,富邦-新營,2024-01-26,9693
2365,昆盈,55,49,6,富邦-新營,2024-01-26,9693
00937B,群益ESG投等債20,134,0,134,富邦-新營,2024-01-29,9693
9907,統一實,70,0,70,富邦-新營,2024-01-29,9693
00687B,國泰20年美債,62,0,62,富邦-新營,2024-01-29,9693
00706L,期元大S＆P日圓正2,60,0,60,富邦-新營,2024-01-29,9693
1101,台泥,36,0,36,富邦-新營,2024-01-29,9693
00679B,元大美債20年,33,0,33,富邦-新營,2024-01-29,9693
00712,復華富時不動產,30,0,30,富邦-新營,2024-01-29,9693
1519,華城,35,6,29,富邦-新營,2024-01-29,9693
2324,仁寶,26,2,24,富邦-新營,2024-01-29,9693
1326,台化,21,0,21,富邦-新營,2024-01-29,9693
2880,華南金,20,0,20,富邦-新營,2024-01-29,9693
5009,榮剛,20,6,14,富邦-新營,2024-01-29,9693
5284,jpp-KY,13,0,13,富邦-新營,2024-01-29,9693
00688L,國泰20年美債正2,12,0,12,富邦-新營,2024-01-29,9693
1301,台塑,11,0,11,富邦-新營,2024-01-29,9693
2409,友達,12,2,10,富邦-新營,2024-01-29,9693
00637L,元大滬深300正2,10,0,10,富邦-新營,2024-01-29,9693
1316,上曜,10,0,10,富邦-新營,2024-01-29,9693
2399,映泰,10,0,10,富邦-新營,2024-01-29,9693
3535,晶彩科,14,4,10,富邦-新營,2024-01-29,9693
8034,榮群,15,5,10,富邦-新營,2024-01-29,9693
2442,新美齊,10,0,10,富邦-新營,2024-01-29,9693
2834,臺企銀,10,2,8,富邦-新營,2024-01-29,9693
3360,尚立,77,69,8,富邦-新營,2024-01-29,9693
2618,長榮航,16,8,8,富邦-新營,2024-01-29,9693
2453,凌群,12,4,8,富邦-新營,2024-01-29,9693
2597,潤弘,7,0,7,富邦-新營,2024-01-29,9693
8064,東捷,234,227,7,富邦-新營,2024-01-29,9693
6462,神盾,33,26,7,富邦-新營,2024-01-29,9693
2303,聯電,8,2,6,富邦-新營,2024-01-29,9693
2609,陽明,8,2,6,富邦-新營,2024-01-29,9693
2337,旺宏,6,0,6,富邦-新營,2024-01-29,9693
4188,安克,6,0,6,富邦-新營,2024-01-29,9693
8429,金麗-KY,6,0,6,富邦-新營,2024-01-29,9693
2610,華航,6,1,5,富邦-新營,2024-01-29,9693
00877,復華中國5G,5,0,5,富邦-新營,2024-01-29,9693
1909,榮成,5,0,5,富邦-新營,2024-01-29,9693
2369,菱生,8,3,5,富邦-新營,2024-01-29,9693
2748,雲品,9,4,5,富邦-新營,2024-01-29,9693
3490,單井,5,0,5,富邦-新營,2024-01-29,9693
4588,玖鼎電力,5,0,5,富邦-新營,2024-01-29,9693
4909,新復興,5,0,5,富邦-新營,2024-01-29,9693
00751B,元大AAA至A公司債,5,0,5,富邦-新營,2024-01-29,9693
2382,廣達,9,5,4,富邦-新營,2024-01-29,9693
00727B,國泰優選非投等債,4,0,4,富邦-新營,2024-01-29,9693
00882,中信中國高股息,5,1,4,富邦-新營,2024-01-29,9693
00891,中信關鍵半導體,6,2,4,富邦-新營,2024-01-29,9693
2340,台亞,4,0,4,富邦-新營,2024-01-29,9693
2634,漢翔,4,0,4,富邦-新營,2024-01-29,9693
6589,台康生技,4,0,4,富邦-新營,2024-01-29,9693
00753L,中信中國50正2,80,0,80,富邦-新營,2024-01-30,9693
2382,廣達,81,11,70,富邦-新營,2024-01-30,9693
1584,精剛,51,0,51,富邦-新營,2024-01-30,9693
2501,國建,42,0,42,富邦-新營,2024-01-30,9693
1718,中纖,35,0,35,富邦-新營,2024-01-30,9693
2353,宏��,50,15,35,富邦-新營,2024-01-30,9693
2409,友達,26,0,26,富邦-新營,2024-01-30,9693
2881,富邦金,26,2,24,富邦-新營,2024-01-30,9693
00687B,國泰20年美債,30,9,21,富邦-新營,2024-01-30,9693
00637L,元大滬深300正2,37,16,21,富邦-新營,2024-01-30,9693
2356,英業達,61,45,16,富邦-新營,2024-01-30,9693
2337,旺宏,15,0,15,富邦-新營,2024-01-30,9693
4707,磐亞,15,0,15,富邦-新營,2024-01-30,9693
00929,復華台灣科技優息,27,12,15,富邦-新營,2024-01-30,9693
3231,緯創,164,149,15,富邦-新營,2024-01-30,9693
2442,新美齊,14,0,14,富邦-新營,2024-01-30,9693
2498,宏達電,11,0,11,富邦-新營,2024-01-30,9693
2609,陽明,10,0,10,富邦-新營,2024-01-30,9693
2515,中工,10,0,10,富邦-新營,2024-01-30,9693
00764B,群益25年美債,10,0,10,富邦-新營,2024-01-30,9693
6213,聯茂,10,0,10,富邦-新營,2024-01-30,9693
3437,榮創,9,0,9,富邦-新營,2024-01-30,9693
6140,訊達,10,1,9,富邦-新營,2024-01-30,9693
2355,敬鵬,8,0,8,富邦-新營,2024-01-30,9693
3615,安可,8,0,8,富邦-新營,2024-01-30,9693
6217,中探針,8,0,8,富邦-新營,2024-01-30,9693
2888,新光金,11,3,8,富邦-新營,2024-01-30,9693
2027,大成鋼,7,0,7,富邦-新營,2024-01-30,9693
6282,康舒,14,7,7,富邦-新營,2024-01-30,9693
8040,九暘,13,6,7,富邦-新營,2024-01-30,9693
8227,巨有科技,18,12,6,富邦-新營,2024-01-30,9693
1909,榮成,6,0,6,富邦-新營,2024-01-30,9693
2867,三商壽,11,5,6,富邦-新營,2024-01-30,9693
2324,仁寶,5,0,5,富邦-新營,2024-01-30,9693
00933B,國泰10Y+金融債,5,0,5,富邦-新營,2024-01-30,9693
1442,名軒,5,0,5,富邦-新營,2024-01-30,9693
1905,華紙,5,0,5,富邦-新營,2024-01-30,9693
2365,昆盈,12,7,5,富邦-新營,2024-01-30,9693
3027,盛達,5,0,5,富邦-新營,2024-01-30,9693
3049,精金,5,0,5,富邦-新營,2024-01-30,9693
3264,欣銓,5,0,5,富邦-新營,2024-01-30,9693
3339,泰谷,5,0,5,富邦-新營,2024-01-30,9693
3380,明泰,7,2,5,富邦-新營,2024-01-30,9693
5483,中美晶,5,0,5,富邦-新營,2024-01-30,9693
6165,浪凡,30,25,5,富邦-新營,2024-01-30,9693
6275,元山,5,0,5,富邦-新營,2024-01-30,9693
8059,凱碩,8,3,5,富邦-新營,2024-01-30,9693
2303,聯電,5,0,5,富邦-新營,2024-01-30,9693
2883,凱基金,8,3,5,富邦-新營,2024-01-30,9693
4105,東洋,4,0,4,富邦-新營,2024-01-30,9693
1560,中砂,55,6,49,富邦-新營,2024-01-31,9693
00753L,中信中國50正2,61,20,41,富邦-新營,2024-01-31,9693
6442,光聖,33,3,30,富邦-新營,2024-01-31,9693
2356,英業達,71,42,29,富邦-新營,2024-01-31,9693
00882,中信中國高股息,28,0,28,富邦-新營,2024-01-31,9693
6113,亞矽,40,13,27,富邦-新營,2024-01-31,9693
00929,復華台灣科技優息,44,18,26,富邦-新營,2024-01-31,9693
2883,凱基金,26,2,24,富邦-新營,2024-01-31,9693
3228,金麗科,23,0,23,富邦-新營,2024-01-31,9693
3360,尚立,57,36,21,富邦-新營,2024-01-31,9693
00637L,元大滬深300正2,20,0,20,富邦-新營,2024-01-31,9693
2515,中工,20,0,20,富邦-新營,2024-01-31,9693
4960,誠美材,19,0,19,富邦-新營,2024-01-31,9693
2355,敬鵬,16,0,16,富邦-新營,2024-01-31,9693
8096,擎亞,48,34,14,富邦-新營,2024-01-31,9693
2449,京元電子,15,1,14,富邦-新營,2024-01-31,9693
2388,威盛,13,0,13,富邦-新營,2024-01-31,9693
6770,力積電,12,0,12,富邦-新營,2024-01-31,9693
2002,中鋼,13,1,12,富邦-新營,2024-01-31,9693
00937B,群益ESG投等債20,28,16,12,富邦-新營,2024-01-31,9693
00687B,國泰20年美債,14,3,11,富邦-新營,2024-01-31,9693
1718,中纖,11,0,11,富邦-新營,2024-01-31,9693
2867,三商壽,11,0,11,富邦-新營,2024-01-31,9693
9105,泰金寶-DR,11,0,11,富邦-新營,2024-01-31,9693
2707,晶華,10,0,10,富邦-新營,2024-01-31,9693
1101,台泥,17,7,10,富邦-新營,2024-01-31,9693
00931B,統一美債20年,10,1,9,富邦-新營,2024-01-31,9693
3354,律勝,18,9,9,富邦-新營,2024-01-31,9693
5439,高技,9,0,9,富邦-新營,2024-01-31,9693
6462,神盾,104,95,9,富邦-新營,2024-01-31,9693
4529,淳紳,8,0,8,富邦-新營,2024-01-31,9693
3041,揚智,7,0,7,富邦-新營,2024-01-31,9693
4188,安克,8,1,7,富邦-新營,2024-01-31,9693
2308,台達電,7,1,6,富邦-新營,2024-01-31,9693
00633L,富邦上証正2,11,5,6,富邦-新營,2024-01-31,9693
1760,寶齡富錦,6,0,6,富邦-新營,2024-01-31,9693
2329,華泰,11,5,6,富邦-新營,2024-01-31,9693
2498,宏達電,11,5,6,富邦-新營,2024-01-31,9693
3706,神達,5,0,5,富邦-新營,2024-01-31,9693
2609,陽明,57,52,5,富邦-新營,2024-01-31,9693
00712,復華富時不動產,5,0,5,富邦-新營,2024-01-31,9693
2314,台揚,7,2,5,富邦-新營,2024-01-31,9693
2352,佳世達,12,7,5,富邦-新營,2024-01-31,9693
2485,兆赫,5,0,5,富邦-新營,2024-01-31,9693
2514,龍邦,5,0,5,富邦-新營,2024-01-31,9693
2618,長榮航,5,0,5,富邦-新營,2024-01-31,9693
2748,雲品,5,0,5,富邦-新營,2024-01-31,9693
2897,王道銀行,5,0,5,富邦-新營,2024-01-31,9693
3014,聯陽,5,0,5,富邦-新營,2024-01-31,9693
4414,如興,5,0,5,富邦-新營,2024-01-31,9693
00679B,元大美債20年,150,0,150,富邦-新營,2024-02-01,9693
00937B,群益ESG投等債20,134,23,111,富邦-新營,2024-02-01,9693
3530,晶相光,150,51,99,富邦-新營,2024-02-01,9693
00715L,期街口布蘭特正2,100,10,90,富邦-新營,2024-02-01,9693
2409,友達,72,3,69,富邦-新營,2024-02-01,9693
2501,國建,65,0,65,富邦-新營,2024-02-01,9693
00929,復華台灣科技優息,69,7,62,富邦-新營,2024-02-01,9693
2376,技嘉,61,0,61,富邦-新營,2024-02-01,9693
00665L,富邦�琤肭磪囓�2,60,0,60,富邦-新營,2024-02-01,9693
1560,中砂,51,1,50,富邦-新營,2024-02-01,9693
00687B,國泰20年美債,61,20,41,富邦-新營,2024-02-01,9693
00878,國泰永續高股息,41,1,40,富邦-新營,2024-02-01,9693
00712,復華富時不動產,36,0,36,富邦-新營,2024-02-01,9693
00885,富邦越南,30,0,30,富邦-新營,2024-02-01,9693
1718,中纖,30,0,30,富邦-新營,2024-02-01,9693
3390,旭軟,30,0,30,富邦-新營,2024-02-01,9693
6442,光聖,32,6,26,富邦-新營,2024-02-01,9693
2485,兆赫,24,0,24,富邦-新營,2024-02-01,9693
9919,康那香,38,14,24,富邦-新營,2024-02-01,9693
6139,亞翔,21,1,20,富邦-新營,2024-02-01,9693
3163,波若威,19,0,19,富邦-新營,2024-02-01,9693
3025,星通,13,0,13,富邦-新營,2024-02-01,9693
3041,揚智,14,1,13,富邦-新營,2024-02-01,9693
6695,芯鼎,46,33,13,富邦-新營,2024-02-01,9693
3312,弘憶股,26,14,12,富邦-新營,2024-02-01,9693
3354,律勝,25,13,12,富邦-新營,2024-02-01,9693
3704,合勤控,12,0,12,富邦-新營,2024-02-01,9693
6116,彩晶,12,0,12,富邦-新營,2024-02-01,9693
3664,安瑞-KY,11,0,11,富邦-新營,2024-02-01,9693
2425,承啟,10,0,10,富邦-新營,2024-02-01,9693
2867,三商壽,10,0,10,富邦-新營,2024-02-01,9693
3663,鑫科,10,0,10,富邦-新營,2024-02-01,9693
3694,海華,19,9,10,富邦-新營,2024-02-01,9693
3029,零壹,10,0,10,富邦-新營,2024-02-01,9693
2707,晶華,9,0,9,富邦-新營,2024-02-01,9693
2303,聯電,13,4,9,富邦-新營,2024-02-01,9693
2812,台中銀,24,16,8,富邦-新營,2024-02-01,9693
2369,菱生,8,0,8,富邦-新營,2024-02-01,9693
6667,信紘科,8,0,8,富邦-新營,2024-02-01,9693
2454,聯發科,7,0,7,富邦-新營,2024-02-01,9693
00882,中信中國高股息,7,0,7,富邦-新營,2024-02-01,9693
4303,信立,7,0,7,富邦-新營,2024-02-01,9693
6285,啟��,7,0,7,富邦-新營,2024-02-01,9693
8034,榮群,12,5,7,富邦-新營,2024-02-01,9693
2401,凌陽,6,0,6,富邦-新營,2024-02-01,9693
3149,正達,6,0,6,富邦-新營,2024-02-01,9693
5236,凌陽創新,6,0,6,富邦-新營,2024-02-01,9693
6179,亞通,10,4,6,富邦-新營,2024-02-01,9693
6237,驊訊,7,1,6,富邦-新營,2024-02-01,9693
006208,富邦台50,5,0,5,富邦-新營,2024-02-01,9693
3231,緯創,222,55,167,富邦-新營,2024-02-02,9693
00929,復華台灣科技優息,136,20,116,富邦-新營,2024-02-02,9693
6274,台燿,106,1,105,富邦-新營,2024-02-02,9693
6695,芯鼎,80,3,77,富邦-新營,2024-02-02,9693
1536,和大,60,0,60,富邦-新營,2024-02-02,9693
00933B,國泰10Y+金融債,53,0,53,富邦-新營,2024-02-02,9693
2883,凱基金,55,4,51,富邦-新營,2024-02-02,9693
6266,泰詠,40,0,40,富邦-新營,2024-02-02,9693
00937B,群益ESG投等債20,35,0,35,富邦-新營,2024-02-02,9693
6770,力積電,34,4,30,富邦-新營,2024-02-02,9693
2303,聯電,32,7,25,富邦-新營,2024-02-02,9693
00751B,元大AAA至A公司債,24,0,24,富邦-新營,2024-02-02,9693
4906,正文,24,0,24,富邦-新營,2024-02-02,9693
00919,群益台灣精選高息,24,0,24,富邦-新營,2024-02-02,9693
2453,凌群,23,0,23,富邦-新營,2024-02-02,9693
00715L,期街口布蘭特正2,22,0,22,富邦-新營,2024-02-02,9693
2317,鴻海,21,0,21,富邦-新營,2024-02-02,9693
1101,台泥,21,1,20,富邦-新營,2024-02-02,9693
3031,佰鴻,20,0,20,富邦-新營,2024-02-02,9693
4162,智擎,25,5,20,富邦-新營,2024-02-02,9693
4916,事欣科,20,0,20,富邦-新營,2024-02-02,9693
2313,華通,20,3,17,富邦-新營,2024-02-02,9693
2609,陽明,17,2,15,富邦-新營,2024-02-02,9693
6116,彩晶,12,0,12,富邦-新營,2024-02-02,9693
2329,華泰,37,26,11,富邦-新營,2024-02-02,9693
6113,亞矽,11,1,10,富邦-新營,2024-02-02,9693
2707,晶華,10,0,10,富邦-新營,2024-02-02,9693
4806,桂田文創,10,0,10,富邦-新營,2024-02-02,9693
9105,泰金寶-DR,10,0,10,富邦-新營,2024-02-02,9693
3163,波若威,10,0,10,富邦-新營,2024-02-02,9693
00712,復華富時不動產,12,2,10,富邦-新營,2024-02-02,9693
6605,帝寶,10,0,10,富邦-新營,2024-02-02,9693
1514,亞力,9,0,9,富邦-新營,2024-02-02,9693
00882,中信中國高股息,8,0,8,富邦-新營,2024-02-02,9693
3294,英濟,8,0,8,富邦-新營,2024-02-02,9693
4979,華星光,9,1,8,富邦-新營,2024-02-02,9693
1718,中纖,7,0,7,富邦-新營,2024-02-02,9693
2002,中鋼,8,1,7,富邦-新營,2024-02-02,9693
2369,菱生,11,4,7,富邦-新營,2024-02-02,9693
2388,威盛,19,12,7,富邦-新營,2024-02-02,9693
2748,雲品,7,0,7,富邦-新營,2024-02-02,9693
3081,聯亞,9,2,7,富邦-新營,2024-02-02,9693
4529,淳紳,8,1,7,富邦-新營,2024-02-02,9693
2330,台積電,7,1,6,富邦-新營,2024-02-02,9693
00753L,中信中國50正2,10,4,6,富邦-新營,2024-02-02,9693
3033,威健,8,2,6,富邦-新營,2024-02-02,9693
3360,尚立,7,1,6,富邦-新營,2024-02-02,9693
2408,南亞科,6,1,5,富邦-新營,2024-02-02,9693
00639,富邦深100,5,0,5,富邦-新營,2024-02-02,9693
1817,凱撒衛,5,0,5,富邦-新營,2024-02-02,9693
2485,兆赫,126,0,126,富邦-新營,2024-02-05,9693
3081,聯亞,93,8,85,富邦-新營,2024-02-05,9693
00919,群益台灣精選高息,67,1,66,富邦-新營,2024-02-05,9693
00877,復華中國5G,64,4,60,富邦-新營,2024-02-05,9693
6266,泰詠,60,0,60,富邦-新營,2024-02-05,9693
6547,高端疫苗,63,6,57,富邦-新營,2024-02-05,9693
3149,正達,50,0,50,富邦-新營,2024-02-05,9693
00929,復華台灣科技優息,51,3,48,富邦-新營,2024-02-05,9693
00878,國泰永續高股息,60,12,48,富邦-新營,2024-02-05,9693
00753L,中信中國50正2,61,15,46,富邦-新營,2024-02-05,9693
00687B,國泰20年美債,43,0,43,富邦-新營,2024-02-05,9693
2409,友達,38,0,38,富邦-新營,2024-02-05,9693
6116,彩晶,37,0,37,富邦-新營,2024-02-05,9693
00679B,元大美債20年,32,0,32,富邦-新營,2024-02-05,9693
6461,益得,24,0,24,富邦-新營,2024-02-05,9693
3031,佰鴻,22,0,22,富邦-新營,2024-02-05,9693
2603,長榮,21,0,21,富邦-新營,2024-02-05,9693
00706L,期元大S＆P日圓正2,21,0,21,富邦-新營,2024-02-05,9693
2801,彰銀,21,0,21,富邦-新營,2024-02-05,9693
9945,潤泰新,21,0,21,富邦-新營,2024-02-05,9693
2002,中鋼,20,0,20,富邦-新營,2024-02-05,9693
2834,臺企銀,20,0,20,富邦-新營,2024-02-05,9693
3308,聯德,20,0,20,富邦-新營,2024-02-05,9693
3481,群創,19,0,19,富邦-新營,2024-02-05,9693
2303,聯電,19,1,18,富邦-新營,2024-02-05,9693
2419,仲琦,22,4,18,富邦-新營,2024-02-05,9693
00937B,群益ESG投等債20,29,11,18,富邦-新營,2024-02-05,9693
1718,中纖,20,3,17,富邦-新營,2024-02-05,9693
2421,建準,33,17,16,富邦-新營,2024-02-05,9693
2025,千興,15,0,15,富邦-新營,2024-02-05,9693
00933B,國泰10Y+金融債,14,0,14,富邦-新營,2024-02-05,9693
00688L,國泰20年美債正2,13,0,13,富邦-新營,2024-02-05,9693
4303,信立,13,0,13,富邦-新營,2024-02-05,9693
00712,復華富時不動產,12,0,12,富邦-新營,2024-02-05,9693
1529,樂事綠能,12,0,12,富邦-新營,2024-02-05,9693
8086,宏捷科,17,6,11,富邦-新營,2024-02-05,9693
1102,亞泥,11,0,11,富邦-新營,2024-02-05,9693
6684,安格,17,6,11,富邦-新營,2024-02-05,9693
2374,佳能,10,0,10,富邦-新營,2024-02-05,9693
3294,英濟,12,2,10,富邦-新營,2024-02-05,9693
3360,尚立,11,1,10,富邦-新營,2024-02-05,9693
8040,九暘,10,0,10,富邦-新營,2024-02-05,9693
9928,中視,10,0,10,富邦-新營,2024-02-05,9693
00662,富邦NASDAQ,10,0,10,富邦-新營,2024-02-05,9693
1101,台泥,9,0,9,富邦-新營,2024-02-05,9693
2329,華泰,16,7,9,富邦-新營,2024-02-05,9693
2355,敬鵬,10,1,9,富邦-新營,2024-02-05,9693
2365,昆盈,36,27,9,富邦-新營,2024-02-05,9693
3711,日月光投控,8,0,8,富邦-新營,2024-02-05,9693
2313,華通,24,17,7,富邦-新營,2024-02-05,9693
00688L,國泰20年美債正2,232,0,232,富邦-新營,2024-02-15,9693
00680L,元大美債20正2,188,0,188,富邦-新營,2024-02-15,9693
2886,兆豐金,100,2,98,富邦-新營,2024-02-15,9693
00937B,群益ESG投等債20,93,0,93,富邦-新營,2024-02-15,9693
00929,復華台灣科技優息,146,63,83,富邦-新營,2024-02-15,9693
00687B,國泰20年美債,76,12,64,富邦-新營,2024-02-15,9693
00679B,元大美債20年,61,0,61,富邦-新營,2024-02-15,9693
00650L,復華香港正2,75,30,45,富邦-新營,2024-02-15,9693
00712,復華富時不動產,50,10,40,富邦-新營,2024-02-15,9693
3228,金麗科,35,1,34,富邦-新營,2024-02-15,9693
1325,恆大,30,0,30,富邦-新營,2024-02-15,9693
2344,華邦電,30,0,30,富邦-新營,2024-02-15,9693
2356,英業達,78,49,29,富邦-新營,2024-02-15,9693
00751B,元大AAA至A公司債,27,0,27,富邦-新營,2024-02-15,9693
00720B,元大投資級公司債,25,0,25,富邦-新營,2024-02-15,9693
00795B,中信美國公債20年,25,0,25,富邦-新營,2024-02-15,9693
2025,千興,26,3,23,富邦-新營,2024-02-15,9693
2603,長榮,21,2,19,富邦-新營,2024-02-15,9693
00632R,元大台灣50反1,31,13,18,富邦-新營,2024-02-15,9693
2486,一詮,18,0,18,富邦-新營,2024-02-15,9693
2618,長榮航,35,17,18,富邦-新營,2024-02-15,9693
00637L,元大滬深300正2,16,0,16,富邦-新營,2024-02-15,9693
2636,台驊控股,16,0,16,富邦-新營,2024-02-15,9693
2303,聯電,27,12,15,富邦-新營,2024-02-15,9693
1101,台泥,15,0,15,富邦-新營,2024-02-15,9693
1733,五鼎,16,1,15,富邦-新營,2024-02-15,9693
3105,穩懋,15,2,13,富邦-新營,2024-02-15,9693
00772B,中信高評級公司債,15,2,13,富邦-新營,2024-02-15,9693
3023,信邦,12,0,12,富邦-新營,2024-02-15,9693
2408,南亞科,12,0,12,富邦-新營,2024-02-15,9693
2211,長榮鋼,12,0,12,富邦-新營,2024-02-15,9693
1447,力鵬,12,1,11,富邦-新營,2024-02-15,9693
2707,晶華,10,0,10,富邦-新營,2024-02-15,9693
2615,萬海,10,0,10,富邦-新營,2024-02-15,9693
3163,波若威,10,0,10,富邦-新營,2024-02-15,9693
2609,陽明,23,14,9,富邦-新營,2024-02-15,9693
6153,嘉聯益,30,21,9,富邦-新營,2024-02-15,9693
3294,英濟,10,2,8,富邦-新營,2024-02-15,9693
2365,昆盈,13,5,8,富邦-新營,2024-02-15,9693
00933B,國泰10Y+金融債,13,6,7,富邦-新營,2024-02-15,9693
2610,華航,11,4,7,富邦-新營,2024-02-15,9693
2409,友達,61,54,7,富邦-新營,2024-02-15,9693
2363,矽統,15,8,7,富邦-新營,2024-02-15,9693
2464,盟立,8,1,7,富邦-新營,2024-02-15,9693
4303,信立,7,0,7,富邦-新營,2024-02-15,9693
6244,茂迪,7,0,7,富邦-新營,2024-02-15,9693
9904,寶成,7,0,7,富邦-新營,2024-02-15,9693
6245,立端,6,0,6,富邦-新營,2024-02-15,9693
2929,淘帝-KY,6,0,6,富邦-新營,2024-02-15,9693
00857B,永豐20年美公債,6,0,6,富邦-新營,2024-02-15,9693
00937B,群益ESG投等債20,166,30,136,富邦-新營,2024-02-16,9693
00688L,國泰20年美債正2,127,0,127,富邦-新營,2024-02-16,9693
00680L,元大美債20正2,44,0,44,富邦-新營,2024-02-16,9693
2344,華邦電,47,5,42,富邦-新營,2024-02-16,9693
00687B,國泰20年美債,40,0,40,富邦-新營,2024-02-16,9693
00637L,元大滬深300正2,32,5,27,富邦-新營,2024-02-16,9693
2382,廣達,79,54,25,富邦-新營,2024-02-16,9693
00673R,期元大S＆P原油反1,25,0,25,富邦-新營,2024-02-16,9693
4162,智擎,24,0,24,富邦-新營,2024-02-16,9693
2368,金像電,45,23,22,富邦-新營,2024-02-16,9693
2337,旺宏,21,0,21,富邦-新營,2024-02-16,9693
00679B,元大美債20年,20,0,20,富邦-新營,2024-02-16,9693
1616,億泰,20,1,19,富邦-新營,2024-02-16,9693
8070,長華*,16,0,16,富邦-新營,2024-02-16,9693
2365,昆盈,33,17,16,富邦-新營,2024-02-16,9693
00878,國泰永續高股息,44,28,16,富邦-新營,2024-02-16,9693
6016,康和證,15,0,15,富邦-新營,2024-02-16,9693
6197,佳必琪,18,4,14,富邦-新營,2024-02-16,9693
2603,長榮,16,3,13,富邦-新營,2024-02-16,9693
3038,全台,16,4,12,富邦-新營,2024-02-16,9693
2618,長榮航,14,2,12,富邦-新營,2024-02-16,9693
3231,緯創,39,28,11,富邦-新營,2024-02-16,9693
4908,前鼎,44,33,11,富邦-新營,2024-02-16,9693
00795B,中信美國公債20年,10,0,10,富邦-新營,2024-02-16,9693
00712,復華富時不動產,11,1,10,富邦-新營,2024-02-16,9693
00764B,群益25年美債,10,0,10,富邦-新營,2024-02-16,9693
2449,京元電子,14,4,10,富邦-新營,2024-02-16,9693
2855,統一證,10,0,10,富邦-新營,2024-02-16,9693
3006,晶豪科,11,1,10,富邦-新營,2024-02-16,9693
3062,建漢,10,0,10,富邦-新營,2024-02-16,9693
4130,健亞,10,0,10,富邦-新營,2024-02-16,9693
4188,安克,10,0,10,富邦-新營,2024-02-16,9693
5488,松普,10,0,10,富邦-新營,2024-02-16,9693
8420,明揚,10,0,10,富邦-新營,2024-02-16,9693
1319,東陽,17,7,10,富邦-新營,2024-02-16,9693
0056,元大高股息,21,11,10,富邦-新營,2024-02-16,9693
2027,大成鋼,9,0,9,富邦-新營,2024-02-16,9693
2371,大同,14,5,9,富邦-新營,2024-02-16,9693
6451,訊芯-KY,11,2,9,富邦-新營,2024-02-16,9693
00772B,中信高評級公司債,8,0,8,富邦-新營,2024-02-16,9693
00933B,國泰10Y+金融債,8,0,8,富邦-新營,2024-02-16,9693
3023,信邦,8,0,8,富邦-新營,2024-02-16,9693
2208,台船,8,0,8,富邦-新營,2024-02-16,9693
3622,洋華,9,1,8,富邦-新營,2024-02-16,9693
3260,威剛,7,0,7,富邦-新營,2024-02-16,9693
3036,文曄,7,0,7,富邦-新營,2024-02-16,9693
5351,鈺創,24,17,7,富邦-新營,2024-02-16,9693
2476,鉅祥,7,0,7,富邦-新營,2024-02-16,9693
6153,嘉聯益,30,23,7,富邦-新營,2024-02-16,9693
2425,承啟,9,3,6,富邦-新營,2024-02-16,9693
00706L,期元大S＆P日圓正2,1870,0,1870,富邦-新營,2024-02-19,9693
3363,上詮,152,19,133,富邦-新營,2024-02-19,9693
00878,國泰永續高股息,113,5,108,富邦-新營,2024-02-19,9693
2855,統一證,85,0,85,富邦-新營,2024-02-19,9693
6153,嘉聯益,60,2,58,富邦-新營,2024-02-19,9693
2376,技嘉,45,4,41,富邦-新營,2024-02-19,9693
2353,宏��,43,4,39,富邦-新營,2024-02-19,9693
2515,中工,35,3,32,富邦-新營,2024-02-19,9693
00712,復華富時不動產,31,0,31,富邦-新營,2024-02-19,9693
00933B,國泰10Y+金融債,31,1,30,富邦-新營,2024-02-19,9693
1608,華榮,30,0,30,富邦-新營,2024-02-19,9693
1907,永豐餘,30,0,30,富邦-新營,2024-02-19,9693
6266,泰詠,30,0,30,富邦-新營,2024-02-19,9693
00679B,元大美債20年,31,2,29,富邦-新營,2024-02-19,9693
2543,皇昌,30,1,29,富邦-新營,2024-02-19,9693
00687B,國泰20年美債,42,16,26,富邦-新營,2024-02-19,9693
2365,昆盈,111,86,25,富邦-新營,2024-02-19,9693
2329,華泰,64,46,18,富邦-新營,2024-02-19,9693
2363,矽統,15,3,12,富邦-新營,2024-02-19,9693
3047,訊舟,23,11,12,富邦-新營,2024-02-19,9693
910322,康師傅-DR,11,0,11,富邦-新營,2024-02-19,9693
00680L,元大美債20正2,11,0,11,富邦-新營,2024-02-19,9693
2355,敬鵬,17,6,11,富邦-新營,2024-02-19,9693
3521,鴻翊,11,0,11,富邦-新營,2024-02-19,9693
00882,中信中國高股息,12,1,11,富邦-新營,2024-02-19,9693
1522,堤維西,13,3,10,富邦-新營,2024-02-19,9693
3167,大量,10,0,10,富邦-新營,2024-02-19,9693
3266,昇陽,10,0,10,富邦-新營,2024-02-19,9693
3380,明泰,10,0,10,富邦-新營,2024-02-19,9693
6117,迎廣,16,6,10,富邦-新營,2024-02-19,9693
6194,育富,10,0,10,富邦-新營,2024-02-19,9693
8085,福華,10,0,10,富邦-新營,2024-02-19,9693
2382,廣達,12,2,10,富邦-新營,2024-02-19,9693
3706,神達,15,6,9,富邦-新營,2024-02-19,9693
2601,益航,9,0,9,富邦-新營,2024-02-19,9693
3038,全台,9,0,9,富邦-新營,2024-02-19,9693
5483,中美晶,9,0,9,富邦-新營,2024-02-19,9693
3035,智原,9,1,8,富邦-新營,2024-02-19,9693
00850,元大臺灣ESG永續,8,0,8,富邦-新營,2024-02-19,9693
00664R,國泰臺灣加權反1,8,0,8,富邦-新營,2024-02-19,9693
1806,冠軍,11,3,8,富邦-新營,2024-02-19,9693
2002,中鋼,10,2,8,富邦-新營,2024-02-19,9693
2867,三商壽,10,2,8,富邦-新營,2024-02-19,9693
3437,榮創,19,11,8,富邦-新營,2024-02-19,9693
4162,智擎,8,0,8,富邦-新營,2024-02-19,9693
00931B,統一美債20年,7,0,7,富邦-新營,2024-02-19,9693
4167,松瑞藥,7,0,7,富邦-新營,2024-02-19,9693
4908,前鼎,23,16,7,富邦-新營,2024-02-19,9693
5533,皇鼎,7,0,7,富邦-新營,2024-02-19,9693
2388,威盛,8,1,7,富邦-新營,2024-02-19,9693
00937B,群益ESG投等債20,161,0,161,富邦-新營,2024-02-20,9693
00878,國泰永續高股息,158,15,143,富邦-新營,2024-02-20,9693
2332,友訊,68,10,58,富邦-新營,2024-02-20,9693
00688L,國泰20年美債正2,50,0,50,富邦-新營,2024-02-20,9693
2365,昆盈,48,4,44,富邦-新營,2024-02-20,9693
8110,華東,53,16,37,富邦-新營,2024-02-20,9693
3481,群創,40,10,30,富邦-新營,2024-02-20,9693
1722,台肥,30,0,30,富邦-新營,2024-02-20,9693
2888,新光金,30,0,30,富邦-新營,2024-02-20,9693
00679B,元大美債20年,28,0,28,富邦-新營,2024-02-20,9693
3710,連展投控,27,0,27,富邦-新營,2024-02-20,9693
00637L,元大滬深300正2,25,0,25,富邦-新營,2024-02-20,9693
00665L,富邦�琤肭磪囓�2,24,0,24,富邦-新營,2024-02-20,9693
00933B,國泰10Y+金融債,24,0,24,富邦-新營,2024-02-20,9693
00690,兆豐藍籌30,23,0,23,富邦-新營,2024-02-20,9693
2913,農林,22,0,22,富邦-新營,2024-02-20,9693
6266,泰詠,20,0,20,富邦-新營,2024-02-20,9693
8059,凱碩,20,0,20,富邦-新營,2024-02-20,9693
1217,愛之味,20,0,20,富邦-新營,2024-02-20,9693
1455,集盛,18,0,18,富邦-新營,2024-02-20,9693
3363,上詮,57,39,18,富邦-新營,2024-02-20,9693
3231,緯創,27,10,17,富邦-新營,2024-02-20,9693
1815,富喬,55,39,16,富邦-新營,2024-02-20,9693
2405,輔信,22,6,16,富邦-新營,2024-02-20,9693
2371,大同,15,0,15,富邦-新營,2024-02-20,9693
6153,嘉聯益,15,0,15,富邦-新營,2024-02-20,9693
00712,復華富時不動產,14,0,14,富邦-新營,2024-02-20,9693
00680L,元大美債20正2,14,0,14,富邦-新營,2024-02-20,9693
4956,光鋐,13,0,13,富邦-新營,2024-02-20,9693
1503,士電,23,10,13,富邦-新營,2024-02-20,9693
2353,宏��,23,11,12,富邦-新營,2024-02-20,9693
2406,國碩,12,0,12,富邦-新營,2024-02-20,9693
2369,菱生,23,13,10,富邦-新營,2024-02-20,9693
2059,川湖,10,0,10,富邦-新營,2024-02-20,9693
2409,友達,10,0,10,富邦-新營,2024-02-20,9693
2511,太子,10,0,10,富邦-新營,2024-02-20,9693
3038,全台,11,1,10,富邦-新營,2024-02-20,9693
4303,信立,10,0,10,富邦-新營,2024-02-20,9693
4714,永捷,22,12,10,富邦-新營,2024-02-20,9693
4906,正文,10,0,10,富邦-新營,2024-02-20,9693
00687B,國泰20年美債,9,0,9,富邦-新營,2024-02-20,9693
6492,生華科,9,0,9,富邦-新營,2024-02-20,9693
8150,南茂,10,1,9,富邦-新營,2024-02-20,9693
2388,威盛,11,3,8,富邦-新營,2024-02-20,9693
4162,智擎,11,3,8,富邦-新營,2024-02-20,9693
5009,榮剛,8,0,8,富邦-新營,2024-02-20,9693
3229,晟鈦,9,2,7,富邦-新營,2024-02-20,9693
3437,榮創,17,10,7,富邦-新營,2024-02-20,9693
6712,長聖,7,0,7,富邦-新營,2024-02-20,9693
6442,光聖,58,51,7,富邦-新營,2024-02-20,9693
3312,弘憶股,234,135,99,富邦-新營,2024-02-21,9693
00929,復華台灣科技優息,106,27,79,富邦-新營,2024-02-21,9693
00878,國泰永續高股息,89,12,77,富邦-新營,2024-02-21,9693
00637L,元大滬深300正2,80,20,60,富邦-新營,2024-02-21,9693
4908,前鼎,60,7,53,富邦-新營,2024-02-21,9693
2610,華航,50,3,47,富邦-新營,2024-02-21,9693
6530,創威,93,48,45,富邦-新營,2024-02-21,9693
2356,英業達,66,23,43,富邦-新營,2024-02-21,9693
00937B,群益ESG投等債20,45,4,41,富邦-新營,2024-02-21,9693
1540,喬福,40,0,40,富邦-新營,2024-02-21,9693
2460,建通,37,5,32,富邦-新營,2024-02-21,9693
1316,上曜,31,4,27,富邦-新營,2024-02-21,9693
3047,訊舟,52,26,26,富邦-新營,2024-02-21,9693
2303,聯電,36,12,24,富邦-新營,2024-02-21,9693
6282,康舒,25,2,23,富邦-新營,2024-02-21,9693
00933B,國泰10Y+金融債,22,0,22,富邦-新營,2024-02-21,9693
4414,如興,21,0,21,富邦-新營,2024-02-21,9693
2353,宏��,23,3,20,富邦-新營,2024-02-21,9693
3055,蔚華科,24,5,19,富邦-新營,2024-02-21,9693
00680L,元大美債20正2,17,0,17,富邦-新營,2024-02-21,9693
1314,中石化,16,0,16,富邦-新營,2024-02-21,9693
2332,友訊,16,0,16,富邦-新營,2024-02-21,9693
3234,光環,16,0,16,富邦-新營,2024-02-21,9693
3710,連展投控,16,0,16,富邦-新營,2024-02-21,9693
3545,敦泰,21,6,15,富邦-新營,2024-02-21,9693
00891,中信關鍵半導體,15,1,14,富邦-新營,2024-02-21,9693
00687B,國泰20年美債,13,0,13,富邦-新營,2024-02-21,9693
1455,集盛,13,0,13,富邦-新營,2024-02-21,9693
3413,京鼎,13,0,13,富邦-新營,2024-02-21,9693
6116,彩晶,13,0,13,富邦-新營,2024-02-21,9693
8936,國統,22,9,13,富邦-新營,2024-02-21,9693
3035,智原,15,3,12,富邦-新營,2024-02-21,9693
2115,六暉-KY,12,0,12,富邦-新營,2024-02-21,9693
5880,合庫金,12,0,12,富邦-新營,2024-02-21,9693
3229,晟鈦,11,0,11,富邦-新營,2024-02-21,9693
6126,信音,17,6,11,富邦-新營,2024-02-21,9693
3105,穩懋,11,1,10,富邦-新營,2024-02-21,9693
00696B,富邦美債20年,10,0,10,富邦-新營,2024-02-21,9693
1217,愛之味,10,0,10,富邦-新營,2024-02-21,9693
1337,再生-KY,10,0,10,富邦-新營,2024-02-21,9693
2025,千興,10,0,10,富邦-新營,2024-02-21,9693
2365,昆盈,10,0,10,富邦-新營,2024-02-21,9693
2889,國票金,10,0,10,富邦-新營,2024-02-21,9693
5488,松普,10,0,10,富邦-新營,2024-02-21,9693
6153,嘉聯益,15,5,10,富邦-新營,2024-02-21,9693
6209,今國光,10,0,10,富邦-新營,2024-02-21,9693
6266,泰詠,10,0,10,富邦-新營,2024-02-21,9693
8930,青鋼,19,9,10,富邦-新營,2024-02-21,9693
6805,富世達,10,0,10,富邦-新營,2024-02-21,9693
2481,強茂,10,1,9,富邦-新營,2024-02-21,9693
00665L,富邦�琤肭磪囓�2,70,0,70,富邦-新營,2024-02-22,9693
2913,農林,51,0,51,富邦-新營,2024-02-22,9693
2329,華泰,107,68,39,富邦-新營,2024-02-22,9693
00937B,群益ESG投等債20,32,0,32,富邦-新營,2024-02-22,9693
00878,國泰永續高股息,60,28,32,富邦-新營,2024-02-22,9693
00687B,國泰20年美債,30,0,30,富邦-新營,2024-02-22,9693
00688L,國泰20年美債正2,57,30,27,富邦-新營,2024-02-22,9693
8064,東捷,30,5,25,富邦-新營,2024-02-22,9693
2489,瑞軒,32,8,24,富邦-新營,2024-02-22,9693
1314,中石化,25,2,23,富邦-新營,2024-02-22,9693
3221,台嘉碩,21,1,20,富邦-新營,2024-02-22,9693
00933B,國泰10Y+金融債,20,0,20,富邦-新營,2024-02-22,9693
6153,嘉聯益,17,0,17,富邦-新營,2024-02-22,9693
00680L,元大美債20正2,17,0,17,富邦-新營,2024-02-22,9693
1815,富喬,18,1,17,富邦-新營,2024-02-22,9693
2371,大同,490,473,17,富邦-新營,2024-02-22,9693
2356,英業達,53,37,16,富邦-新營,2024-02-22,9693
2369,菱生,16,0,16,富邦-新營,2024-02-22,9693
2365,昆盈,18,2,16,富邦-新營,2024-02-22,9693
2615,萬海,26,12,14,富邦-新營,2024-02-22,9693
6164,華興,14,0,14,富邦-新營,2024-02-22,9693
00712,復華富時不動產,13,0,13,富邦-新營,2024-02-22,9693
1316,上曜,14,1,13,富邦-新營,2024-02-22,9693
00679B,元大美債20年,12,0,12,富邦-新營,2024-02-22,9693
3576,聯合再生,11,0,11,富邦-新營,2024-02-22,9693
3711,日月光投控,11,0,11,富邦-新營,2024-02-22,9693
00753L,中信中國50正2,10,0,10,富邦-新營,2024-02-22,9693
2331,精英,10,0,10,富邦-新營,2024-02-22,9693
2630,亞航,10,0,10,富邦-新營,2024-02-22,9693
5202,力新,10,0,10,富邦-新營,2024-02-22,9693
6425,易發,14,4,10,富邦-新營,2024-02-22,9693
8924,大田,10,0,10,富邦-新營,2024-02-22,9693
00662,富邦NASDAQ,10,0,10,富邦-新營,2024-02-22,9693
2505,國揚,8,0,8,富邦-新營,2024-02-22,9693
2409,友達,8,0,8,富邦-新營,2024-02-22,9693
3450,聯鈞,10,3,7,富邦-新營,2024-02-22,9693
1504,東元,7,0,7,富邦-新營,2024-02-22,9693
1718,中纖,7,0,7,富邦-新營,2024-02-22,9693
2883,凱基金,7,0,7,富邦-新營,2024-02-22,9693
3042,晶技,8,1,7,富邦-新營,2024-02-22,9693
4188,安克,7,0,7,富邦-新營,2024-02-22,9693
6117,迎廣,7,0,7,富邦-新營,2024-02-22,9693
8110,華東,9,2,7,富邦-新營,2024-02-22,9693
3231,緯創,27,20,7,富邦-新營,2024-02-22,9693
2376,技嘉,19,13,6,富邦-新營,2024-02-22,9693
1608,華榮,6,0,6,富邦-新營,2024-02-22,9693
2421,建準,14,8,6,富邦-新營,2024-02-22,9693
2641,正德,6,0,6,富邦-新營,2024-02-22,9693
5315,光聯,6,0,6,富邦-新營,2024-02-22,9693
6139,亞翔,8,2,6,富邦-新營,2024-02-22,9693
00937B,群益ESG投等債20,301,17,284,富邦-新營,2024-02-23,9693
8936,國統,163,0,163,富邦-新營,2024-02-23,9693
3363,上詮,106,14,92,富邦-新營,2024-02-23,9693
2241,艾姆勒,88,0,88,富邦-新營,2024-02-23,9693
6438,迅得,85,2,83,富邦-新營,2024-02-23,9693
00929,復華台灣科技優息,120,55,65,富邦-新營,2024-02-23,9693
6120,達運,63,0,63,富邦-新營,2024-02-23,9693
2329,華泰,274,228,46,富邦-新營,2024-02-23,9693
2610,華航,35,3,32,富邦-新營,2024-02-23,9693
00637L,元大滬深300正2,40,11,29,富邦-新營,2024-02-23,9693
00918,大華優利高填息30,33,4,29,富邦-新營,2024-02-23,9693
00933B,國泰10Y+金融債,28,0,28,富邦-新營,2024-02-23,9693
00919,群益台灣精選高息,55,29,26,富邦-新營,2024-02-23,9693
1718,中纖,25,0,25,富邦-新營,2024-02-23,9693
2313,華通,68,44,24,富邦-新營,2024-02-23,9693
6462,神盾,23,1,22,富邦-新營,2024-02-23,9693
1785,光洋科,23,1,22,富邦-新營,2024-02-23,9693
00885,富邦越南,30,10,20,富邦-新營,2024-02-23,9693
8064,東捷,26,6,20,富邦-新營,2024-02-23,9693
2323,中環,20,2,18,富邦-新營,2024-02-23,9693
3062,建漢,17,0,17,富邦-新營,2024-02-23,9693
00922,國泰台灣領袖50,18,1,17,富邦-新營,2024-02-23,9693
1325,恆大,16,0,16,富邦-新營,2024-02-23,9693
3360,尚立,25,9,16,富邦-新營,2024-02-23,9693
2353,宏��,19,4,15,富邦-新營,2024-02-23,9693
2302,麗正,16,1,15,富邦-新營,2024-02-23,9693
2405,輔信,229,214,15,富邦-新營,2024-02-23,9693
6442,光聖,23,9,14,富邦-新營,2024-02-23,9693
2408,南亞科,17,3,14,富邦-新營,2024-02-23,9693
2006,東和鋼鐵,14,1,13,富邦-新營,2024-02-23,9693
2882,國泰金,13,0,13,富邦-新營,2024-02-23,9693
00891,中信關鍵半導體,15,2,13,富邦-新營,2024-02-23,9693
3147,大綜,13,0,13,富邦-新營,2024-02-23,9693
4956,光鋐,13,0,13,富邦-新營,2024-02-23,9693
2332,友訊,12,0,12,富邦-新營,2024-02-23,9693
3689,湧德,14,2,12,富邦-新營,2024-02-23,9693
0056,元大高股息,20,9,11,富邦-新營,2024-02-23,9693
8044,網家,12,1,11,富邦-新營,2024-02-23,9693
00665L,富邦�琤肭磪囓�2,20,10,10,富邦-新營,2024-02-23,9693
2641,正德,10,0,10,富邦-新營,2024-02-23,9693
6668,中揚光,13,3,10,富邦-新營,2024-02-23,9693
8033,雷虎,10,0,10,富邦-新營,2024-02-23,9693
6147,頎邦,13,3,10,富邦-新營,2024-02-23,9693
3206,志豐,14,4,10,富邦-新營,2024-02-23,9693
6282,康舒,9,0,9,富邦-新營,2024-02-23,9693
2365,昆盈,12,3,9,富邦-新營,2024-02-23,9693
6125,廣運,11,2,9,富邦-新營,2024-02-23,9693
6189,豐藝,14,5,9,富邦-新營,2024-02-23,9693
2489,瑞軒,8,0,8,富邦-新營,2024-02-23,9693
3450,聯鈞,19,11,8,富邦-新營,2024-02-23,9693
00679B,元大美債20年,208,0,208,富邦-新營,2024-02-26,9693
00878,國泰永續高股息,124,16,108,富邦-新營,2024-02-26,9693
2888,新光金,105,0,105,富邦-新營,2024-02-26,9693
2855,統一證,100,0,100,富邦-新營,2024-02-26,9693
00918,大華優利高填息30,90,3,87,富邦-新營,2024-02-26,9693
00690,兆豐藍籌30,50,0,50,富邦-新營,2024-02-26,9693
6016,康和證,50,0,50,富邦-新營,2024-02-26,9693
3036,文曄,80,31,49,富邦-新營,2024-02-26,9693
2365,昆盈,43,2,41,富邦-新營,2024-02-26,9693
2457,飛宏,33,0,33,富邦-新營,2024-02-26,9693
00637L,元大滬深300正2,29,0,29,富邦-新營,2024-02-26,9693
1314,中石化,26,0,26,富邦-新營,2024-02-26,9693
1609,大亞,31,6,25,富邦-新營,2024-02-26,9693
2303,聯電,26,2,24,富邦-新營,2024-02-26,9693
6770,力積電,23,0,23,富邦-新營,2024-02-26,9693
00885,富邦越南,24,1,23,富邦-新營,2024-02-26,9693
00937B,群益ESG投等債20,145,123,22,富邦-新營,2024-02-26,9693
00933B,國泰10Y+金融債,27,5,22,富邦-新營,2024-02-26,9693
6120,達運,21,0,21,富邦-新營,2024-02-26,9693
1907,永豐餘,20,0,20,富邦-新營,2024-02-26,9693
3322,建舜電,20,0,20,富邦-新營,2024-02-26,9693
00891,中信關鍵半導體,19,0,19,富邦-新營,2024-02-26,9693
2206,三陽工業,18,0,18,富邦-新營,2024-02-26,9693
00892,富邦台灣半導體,17,0,17,富邦-新營,2024-02-26,9693
2302,麗正,19,2,17,富邦-新營,2024-02-26,9693
2332,友訊,20,3,17,富邦-新營,2024-02-26,9693
1316,上曜,106,90,16,富邦-新營,2024-02-26,9693
2337,旺宏,16,0,16,富邦-新營,2024-02-26,9693
4588,玖鼎電力,20,6,14,富邦-新營,2024-02-26,9693
2409,友達,16,2,14,富邦-新營,2024-02-26,9693
2356,英業達,15,2,13,富邦-新營,2024-02-26,9693
2812,台中銀,18,5,13,富邦-新營,2024-02-26,9693
3481,群創,17,4,13,富邦-新營,2024-02-26,9693
3028,增你強,13,0,13,富邦-新營,2024-02-26,9693
1809,中釉,20,7,13,富邦-新營,2024-02-26,9693
1802,台玻,12,0,12,富邦-新營,2024-02-26,9693
8429,金麗-KY,12,0,12,富邦-新營,2024-02-26,9693
6257,矽格,12,1,11,富邦-新營,2024-02-26,9693
1455,集盛,10,0,10,富邦-新營,2024-02-26,9693
1584,精剛,10,0,10,富邦-新營,2024-02-26,9693
2340,台亞,10,0,10,富邦-新營,2024-02-26,9693
2605,新興,10,0,10,富邦-新營,2024-02-26,9693
3689,湧德,12,2,10,富邦-新營,2024-02-26,9693
6147,頎邦,10,0,10,富邦-新營,2024-02-26,9693
00929,復華台灣科技優息,20,10,10,富邦-新營,2024-02-26,9693
1503,士電,26,16,10,富邦-新營,2024-02-26,9693
3049,精金,9,0,9,富邦-新營,2024-02-26,9693
3062,建漢,10,1,9,富邦-新營,2024-02-26,9693
3419,譁裕,10,1,9,富邦-新營,2024-02-26,9693
3622,洋華,9,0,9,富邦-新營,2024-02-26,9693
8064,東捷,486,325,161,富邦-新營,2024-02-27,9693
00878,國泰永續高股息,125,28,97,富邦-新營,2024-02-27,9693
5009,榮剛,62,0,62,富邦-新營,2024-02-27,9693
00929,復華台灣科技優息,97,41,56,富邦-新營,2024-02-27,9693
00632R,元大台灣50反1,85,30,55,富邦-新營,2024-02-27,9693
2241,艾姆勒,50,0,50,富邦-新營,2024-02-27,9693
1815,富喬,53,4,49,富邦-新營,2024-02-27,9693
8926,台汽電,61,13,48,富邦-新營,2024-02-27,9693
6153,嘉聯益,44,1,43,富邦-新營,2024-02-27,9693
00933B,國泰10Y+金融債,38,0,38,富邦-新營,2024-02-27,9693
00679B,元大美債20年,38,0,38,富邦-新營,2024-02-27,9693
3017,奇鋐,55,26,29,富邦-新營,2024-02-27,9693
3228,金麗科,30,2,28,富邦-新營,2024-02-27,9693
1316,上曜,37,11,26,富邦-新營,2024-02-27,9693
3231,緯創,37,12,25,富邦-新營,2024-02-27,9693
3037,欣興,27,5,22,富邦-新營,2024-02-27,9693
1711,永光,68,47,21,富邦-新營,2024-02-27,9693
1618,合機,27,6,21,富邦-新營,2024-02-27,9693
8182,加高,23,5,18,富邦-新營,2024-02-27,9693
2812,台中銀,21,5,16,富邦-新營,2024-02-27,9693
2855,統一證,16,0,16,富邦-新營,2024-02-27,9693
6126,信音,118,102,16,富邦-新營,2024-02-27,9693
00712,復華富時不動產,18,2,16,富邦-新營,2024-02-27,9693
2301,光寶科,23,9,14,富邦-新營,2024-02-27,9693
2382,廣達,13,0,13,富邦-新營,2024-02-27,9693
2610,華航,17,4,13,富邦-新營,2024-02-27,9693
3028,增你強,13,0,13,富邦-新營,2024-02-27,9693
3481,群創,24,12,12,富邦-新營,2024-02-27,9693
1809,中釉,13,1,12,富邦-新營,2024-02-27,9693
1514,亞力,23,12,11,富邦-新營,2024-02-27,9693
3450,聯鈞,26,15,11,富邦-新營,2024-02-27,9693
2834,臺企銀,11,1,10,富邦-新營,2024-02-27,9693
2332,友訊,10,0,10,富邦-新營,2024-02-27,9693
00680L,元大美債20正2,11,1,10,富邦-新營,2024-02-27,9693
00751B,元大AAA至A公司債,10,0,10,富邦-新營,2024-02-27,9693
1455,集盛,10,0,10,富邦-新營,2024-02-27,9693
2101,南港,10,0,10,富邦-新營,2024-02-27,9693
2331,精英,10,0,10,富邦-新營,2024-02-27,9693
2340,台亞,10,0,10,富邦-新營,2024-02-27,9693
3027,盛達,10,0,10,富邦-新營,2024-02-27,9693
2915,潤泰全,10,0,10,富邦-新營,2024-02-27,9693
00919,群益台灣精選高息,24,15,9,富邦-新營,2024-02-27,9693
00795B,中信美國公債20年,9,0,9,富邦-新營,2024-02-27,9693
1303,南亞,9,0,9,富邦-新營,2024-02-27,9693
5351,鈺創,22,13,9,富邦-新營,2024-02-27,9693
1721,三晃,37,28,9,富邦-新營,2024-02-27,9693
2002,中鋼,9,1,8,富邦-新營,2024-02-27,9693
6532,瑞耘,11,3,8,富邦-新營,2024-02-27,9693
2891,中信金,8,0,8,富邦-新營,2024-02-27,9693
1314,中石化,8,0,8,富邦-新營,2024-02-27,9693
00937B,群益ESG投等債20,127,43,84,富邦-新營,2024-02-29,9693
00929,復華台灣科技優息,81,7,74,富邦-新營,2024-02-29,9693
00665L,富邦�琤肭磪囓�2,50,2,48,富邦-新營,2024-02-29,9693
5880,合庫金,41,0,41,富邦-新營,2024-02-29,9693
3362,先進光,49,9,40,富邦-新營,2024-02-29,9693
6116,彩晶,36,0,36,富邦-新營,2024-02-29,9693
00878,國泰永續高股息,42,8,34,富邦-新營,2024-02-29,9693
6026,福邦證,32,3,29,富邦-新營,2024-02-29,9693
2615,萬海,28,1,27,富邦-新營,2024-02-29,9693
2485,兆赫,25,0,25,富邦-新營,2024-02-29,9693
6016,康和證,25,1,24,富邦-新營,2024-02-29,9693
2375,凱美,23,0,23,富邦-新營,2024-02-29,9693
2511,太子,21,0,21,富邦-新營,2024-02-29,9693
2618,長榮航,33,12,21,富邦-新營,2024-02-29,9693
00919,群益台灣精選高息,22,1,21,富邦-新營,2024-02-29,9693
2353,宏��,23,3,20,富邦-新營,2024-02-29,9693
1786,科妍,20,0,20,富邦-新營,2024-02-29,9693
2025,千興,20,0,20,富邦-新營,2024-02-29,9693
2913,農林,20,0,20,富邦-新營,2024-02-29,9693
00687B,國泰20年美債,59,40,19,富邦-新營,2024-02-29,9693
1455,集盛,20,1,19,富邦-新營,2024-02-29,9693
2329,華泰,70,51,19,富邦-新營,2024-02-29,9693
00679B,元大美債20年,18,0,18,富邦-新營,2024-02-29,9693
3481,群創,16,0,16,富邦-新營,2024-02-29,9693
00696B,富邦美債20年,15,0,15,富邦-新營,2024-02-29,9693
2405,輔信,48,33,15,富邦-新營,2024-02-29,9693
2888,新光金,12,0,12,富邦-新營,2024-02-29,9693
2002,中鋼,11,0,11,富邦-新營,2024-02-29,9693
3028,增你強,11,0,11,富邦-新營,2024-02-29,9693
3390,旭軟,16,5,11,富邦-新營,2024-02-29,9693
9105,泰金寶-DR,14,3,11,富邦-新營,2024-02-29,9693
2812,台中銀,12,1,11,富邦-新營,2024-02-29,9693
2302,麗正,10,0,10,富邦-新營,2024-02-29,9693
2838,聯邦銀,10,0,10,富邦-新營,2024-02-29,9693
3058,立德,10,0,10,富邦-新營,2024-02-29,9693
3062,建漢,10,0,10,富邦-新營,2024-02-29,9693
3163,波若威,11,1,10,富邦-新營,2024-02-29,9693
3228,金麗科,30,20,10,富邦-新營,2024-02-29,9693
3710,連展投控,10,0,10,富邦-新營,2024-02-29,9693
4513,福裕,11,1,10,富邦-新營,2024-02-29,9693
6113,亞矽,15,5,10,富邦-新營,2024-02-29,9693
00712,復華富時不動產,10,1,9,富邦-新營,2024-02-29,9693
2884,玉山金,10,1,9,富邦-新營,2024-02-29,9693
5534,長虹,9,0,9,富邦-新營,2024-02-29,9693
1522,堤維西,20,11,9,富邦-新營,2024-02-29,9693
6237,驊訊,12,4,8,富邦-新營,2024-02-29,9693
2492,華新科,10,2,8,富邦-新營,2024-02-29,9693
2409,友達,8,0,8,富邦-新營,2024-02-29,9693
00830,國泰費城半導體,7,0,7,富邦-新營,2024-02-29,9693
1101,台泥,21,14,7,富邦-新營,2024-02-29,9693
3390,旭軟,161,3,158,富邦-新營,2024-03-01,9693
6290,良維,154,2,152,富邦-新營,2024-03-01,9693
00919,群益台灣精選高息,152,3,149,富邦-新營,2024-03-01,9693
2485,兆赫,127,0,127,富邦-新營,2024-03-01,9693
2365,昆盈,269,164,105,富邦-新營,2024-03-01,9693
00687B,國泰20年美債,87,0,87,富邦-新營,2024-03-01,9693
6016,康和證,76,0,76,富邦-新營,2024-03-01,9693
00918,大華優利高填息30,64,0,64,富邦-新營,2024-03-01,9693
00929,復華台灣科技優息,84,37,47,富邦-新營,2024-03-01,9693
00937B,群益ESG投等債20,48,1,47,富邦-新營,2024-03-01,9693
6153,嘉聯益,38,0,38,富邦-新營,2024-03-01,9693
00933B,國泰10Y+金融債,30,0,30,富邦-新營,2024-03-01,9693
6120,達運,30,0,30,富邦-新營,2024-03-01,9693
2371,大同,31,11,20,富邦-新營,2024-03-01,9693
1513,中興電,38,19,19,富邦-新營,2024-03-01,9693
2887,台新金,17,0,17,富邦-新營,2024-03-01,9693
2329,華泰,24,7,17,富邦-新營,2024-03-01,9693
2618,長榮航,15,0,15,富邦-新營,2024-03-01,9693
5533,皇鼎,15,0,15,富邦-新營,2024-03-01,9693
6684,安格,24,9,15,富邦-新營,2024-03-01,9693
4973,廣穎,14,0,14,富邦-新營,2024-03-01,9693
6026,福邦證,14,0,14,富邦-新營,2024-03-01,9693
6125,廣運,115,102,13,富邦-新營,2024-03-01,9693
3028,增你強,13,0,13,富邦-新營,2024-03-01,9693
6805,富世達,13,0,13,富邦-新營,2024-03-01,9693
8926,台汽電,14,1,13,富邦-新營,2024-03-01,9693
2303,聯電,14,2,12,富邦-新營,2024-03-01,9693
2609,陽明,14,2,12,富邦-新營,2024-03-01,9693
00662,富邦NASDAQ,12,0,12,富邦-新營,2024-03-01,9693
4303,信立,18,6,12,富邦-新營,2024-03-01,9693
2409,友達,11,0,11,富邦-新營,2024-03-01,9693
3322,建舜電,14,3,11,富邦-新營,2024-03-01,9693
5426,振發,12,1,11,富邦-新營,2024-03-01,9693
6116,彩晶,11,0,11,富邦-新營,2024-03-01,9693
1533,車王電,10,0,10,富邦-新營,2024-03-01,9693
2489,瑞軒,10,0,10,富邦-新營,2024-03-01,9693
2498,宏達電,11,1,10,富邦-新營,2024-03-01,9693
3710,連展投控,10,0,10,富邦-新營,2024-03-01,9693
4909,新復興,53,43,10,富邦-新營,2024-03-01,9693
8473,山林水,10,0,10,富邦-新營,2024-03-01,9693
1316,上曜,17,7,10,富邦-新營,2024-03-01,9693
2317,鴻海,9,0,9,富邦-新營,2024-03-01,9693
1785,光洋科,10,1,9,富邦-新營,2024-03-01,9693
1718,中纖,8,0,8,富邦-新營,2024-03-01,9693
2897,王道銀行,11,3,8,富邦-新營,2024-03-01,9693
2002,中鋼,17,9,8,富邦-新營,2024-03-01,9693
3055,蔚華科,16,9,7,富邦-新營,2024-03-01,9693
3036,文曄,8,2,6,富邦-新營,2024-03-01,9693
2388,威盛,6,0,6,富邦-新營,2024-03-01,9693
3380,明泰,6,0,6,富邦-新營,2024-03-01,9693
2855,統一證,320,20,300,富邦-新營,2024-03-04,9693
6016,康和證,170,2,168,富邦-新營,2024-03-04,9693
1522,堤維西,146,0,146,富邦-新營,2024-03-04,9693
00937B,群益ESG投等債20,95,6,89,富邦-新營,2024-03-04,9693
00918,大華優利高填息30,75,0,75,富邦-新營,2024-03-04,9693
6125,廣運,172,99,73,富邦-新營,2024-03-04,9693
00712,復華富時不動產,70,0,70,富邦-新營,2024-03-04,9693
00919,群益台灣精選高息,127,66,61,富邦-新營,2024-03-04,9693
3363,上詮,45,0,45,富邦-新營,2024-03-04,9693
2359,所羅門,50,6,44,富邦-新營,2024-03-04,9693
00676R,富邦臺灣加權反1,40,0,40,富邦-新營,2024-03-04,9693
2365,昆盈,174,138,36,富邦-新營,2024-03-04,9693
4995,晶達,30,0,30,富邦-新營,2024-03-04,9693
2913,農林,30,2,28,富邦-新營,2024-03-04,9693
00915,凱基優選高股息30,28,0,28,富邦-新營,2024-03-04,9693
6245,立端,24,1,23,富邦-新營,2024-03-04,9693
00679B,元大美債20年,20,0,20,富邦-新營,2024-03-04,9693
00690,兆豐藍籌30,20,0,20,富邦-新營,2024-03-04,9693
4563,百德,20,0,20,富邦-新營,2024-03-04,9693
4707,磐亞,20,0,20,富邦-新營,2024-03-04,9693
3450,聯鈞,32,13,19,富邦-新營,2024-03-04,9693
00637L,元大滬深300正2,27,10,17,富邦-新營,2024-03-04,9693
1609,大亞,16,0,16,富邦-新營,2024-03-04,9693
2618,長榮航,14,0,14,富邦-新營,2024-03-04,9693
6233,旺玖,13,0,13,富邦-新營,2024-03-04,9693
6139,亞翔,33,21,12,富邦-新營,2024-03-04,9693
3622,洋華,17,5,12,富邦-新營,2024-03-04,9693
00857B,永豐20年美公債,11,0,11,富邦-新營,2024-03-04,9693
1815,富喬,11,0,11,富邦-新營,2024-03-04,9693
2405,輔信,11,0,11,富邦-新營,2024-03-04,9693
6120,達運,11,0,11,富邦-新營,2024-03-04,9693
00632R,元大台灣50反1,10,0,10,富邦-新營,2024-03-04,9693
4968,立積,17,7,10,富邦-新營,2024-03-04,9693
00882,中信中國高股息,10,0,10,富邦-新營,2024-03-04,9693
1218,泰山,10,0,10,富邦-新營,2024-03-04,9693
1316,上曜,19,9,10,富邦-新營,2024-03-04,9693
2302,麗正,10,0,10,富邦-新營,2024-03-04,9693
2485,兆赫,10,0,10,富邦-新營,2024-03-04,9693
3025,星通,10,0,10,富邦-新營,2024-03-04,9693
3081,聯亞,36,26,10,富邦-新營,2024-03-04,9693
6153,嘉聯益,10,0,10,富邦-新營,2024-03-04,9693
9904,寶成,10,0,10,富邦-新營,2024-03-04,9693
1584,精剛,19,10,9,富邦-新營,2024-03-04,9693
3664,安瑞-KY,9,0,9,富邦-新營,2024-03-04,9693
5488,松普,10,1,9,富邦-新營,2024-03-04,9693
8034,榮群,9,0,9,富邦-新營,2024-03-04,9693
1514,亞力,23,14,9,富邦-新營,2024-03-04,9693
2634,漢翔,8,0,8,富邦-新營,2024-03-04,9693
3481,群創,11,2,9,富邦-新營,2024-03-04,9693
1718,中纖,8,0,8,富邦-新營,2024-03-04,9693
3450,聯鈞,369,170,199,富邦-新營,2024-03-05,9693
00937B,群益ESG投等債20,110,16,94,富邦-新營,2024-03-05,9693
6770,力積電,73,4,69,富邦-新營,2024-03-05,9693
00919,群益台灣精選高息,86,20,66,富邦-新營,2024-03-05,9693
00712,復華富時不動產,59,2,57,富邦-新營,2024-03-05,9693
2353,宏��,60,3,57,富邦-新營,2024-03-05,9693
2417,圓剛,55,4,51,富邦-新營,2024-03-05,9693
2359,所羅門,50,0,50,富邦-新營,2024-03-05,9693
2356,英業達,65,18,47,富邦-新營,2024-03-05,9693
00933B,國泰10Y+金融債,47,1,46,富邦-新營,2024-03-05,9693
00665L,富邦�琤肭磪囓�2,42,0,42,富邦-新營,2024-03-05,9693
1409,新纖,63,24,39,富邦-新營,2024-03-05,9693
4714,永捷,33,0,33,富邦-新營,2024-03-05,9693
8054,安國,37,5,32,富邦-新營,2024-03-05,9693
2331,精英,31,0,31,富邦-新營,2024-03-05,9693
4906,正文,32,1,31,富邦-新營,2024-03-05,9693
1785,光洋科,40,10,30,富邦-新營,2024-03-05,9693
00679B,元大美債20年,49,20,29,富邦-新營,2024-03-05,9693
2618,長榮航,35,7,28,富邦-新營,2024-03-05,9693
2371,大同,40,13,27,富邦-新營,2024-03-05,9693
3163,波若威,27,2,25,富邦-新營,2024-03-05,9693
00918,大華優利高填息30,24,0,24,富邦-新營,2024-03-05,9693
3027,盛達,25,2,23,富邦-新營,2024-03-05,9693
3062,建漢,23,0,23,富邦-新營,2024-03-05,9693
2355,敬鵬,22,0,22,富邦-新營,2024-03-05,9693
2610,華航,23,1,22,富邦-新營,2024-03-05,9693
3149,正達,20,0,20,富邦-新營,2024-03-05,9693
4543,萬在,20,0,20,富邦-新營,2024-03-05,9693
00713,元大台灣高息低波,20,1,19,富邦-新營,2024-03-05,9693
00637L,元大滬深300正2,25,6,19,富邦-新營,2024-03-05,9693
1455,集盛,21,2,19,富邦-新營,2024-03-05,9693
3025,星通,17,0,17,富邦-新營,2024-03-05,9693
00636,國泰中國A50,14,0,14,富邦-新營,2024-03-05,9693
8011,台通,20,6,14,富邦-新營,2024-03-05,9693
00753L,中信中國50正2,13,0,13,富邦-新營,2024-03-05,9693
00752,中信中國50,12,0,12,富邦-新營,2024-03-05,9693
00720B,元大投資級公司債,12,0,12,富邦-新營,2024-03-05,9693
3260,威剛,10,0,10,富邦-新營,2024-03-05,9693
8086,宏捷科,22,12,10,富邦-新營,2024-03-05,9693
00882,中信中國高股息,10,0,10,富邦-新營,2024-03-05,9693
1303,南亞,10,0,10,富邦-新營,2024-03-05,9693
1773,勝一,15,5,10,富邦-新營,2024-03-05,9693
2025,千興,10,0,10,富邦-新營,2024-03-05,9693
2412,中華電,10,0,10,富邦-新營,2024-03-05,9693
3047,訊舟,11,1,10,富邦-新營,2024-03-05,9693
5474,聰泰,11,1,10,富邦-新營,2024-03-05,9693
5521,工信,10,0,10,富邦-新營,2024-03-05,9693
6153,嘉聯益,10,0,10,富邦-新營,2024-03-05,9693
00935,野村臺灣新科技50,10,1,9,富邦-新營,2024-03-05,9693
2206,三陽工業,10,1,9,富邦-新營,2024-03-05,9693
00679B,元大美債20年,105,0,105,富邦-新營,2024-03-06,9693
1513,中興電,135,44,91,富邦-新營,2024-03-06,9693
00937B,群益ESG投等債20,95,15,80,富邦-新營,2024-03-06,9693
2002,中鋼,73,4,69,富邦-新營,2024-03-06,9693
4995,晶達,48,0,48,富邦-新營,2024-03-06,9693
2359,所羅門,45,0,45,富邦-新營,2024-03-06,9693
2888,新光金,61,26,35,富邦-新營,2024-03-06,9693
00918,大華優利高填息30,34,0,34,富邦-新營,2024-03-06,9693
3481,群創,31,0,31,富邦-新營,2024-03-06,9693
00933B,國泰10Y+金融債,27,1,26,富邦-新營,2024-03-06,9693
1455,集盛,25,0,25,富邦-新營,2024-03-06,9693
1463,強盛新,25,0,25,富邦-新營,2024-03-06,9693
2867,三商壽,25,0,25,富邦-新營,2024-03-06,9693
3062,建漢,26,1,25,富邦-新營,2024-03-06,9693
3149,正達,23,1,22,富邦-新營,2024-03-06,9693
4960,誠美材,22,0,22,富邦-新營,2024-03-06,9693
3228,金麗科,20,0,20,富邦-新營,2024-03-06,9693
2882,國泰金,16,0,16,富邦-新營,2024-03-06,9693
6153,嘉聯益,16,0,16,富邦-新營,2024-03-06,9693
8996,高力,15,1,14,富邦-新營,2024-03-06,9693
2610,華航,14,0,14,富邦-新營,2024-03-06,9693
1718,中纖,26,12,14,富邦-新營,2024-03-06,9693
2356,英業達,18,4,14,富邦-新營,2024-03-06,9693
3231,緯創,23,10,13,富邦-新營,2024-03-06,9693
4906,正文,14,1,13,富邦-新營,2024-03-06,9693
1316,上曜,59,46,13,富邦-新營,2024-03-06,9693
6770,力積電,13,1,12,富邦-新營,2024-03-06,9693
3017,奇鋐,26,14,12,富邦-新營,2024-03-06,9693
2845,遠東銀,13,1,12,富邦-新營,2024-03-06,9693
1568,倉佑,11,0,11,富邦-新營,2024-03-06,9693
1802,台玻,11,0,11,富邦-新營,2024-03-06,9693
1504,東元,22,11,11,富邦-新營,2024-03-06,9693
2436,偉詮電,10,0,10,富邦-新營,2024-03-06,9693
2615,萬海,10,0,10,富邦-新營,2024-03-06,9693
2739,寒舍,10,0,10,富邦-新營,2024-03-06,9693
6126,信音,20,10,10,富邦-新營,2024-03-06,9693
9904,寶成,11,1,10,富邦-新營,2024-03-06,9693
2634,漢翔,9,0,9,富邦-新營,2024-03-06,9693
3325,旭品,17,8,9,富邦-新營,2024-03-06,9693
4938,和碩,11,2,9,富邦-新營,2024-03-06,9693
8011,台通,38,29,9,富邦-新營,2024-03-06,9693
3163,波若威,11,2,9,富邦-新營,2024-03-06,9693
00637L,元大滬深300正2,20,12,8,富邦-新營,2024-03-06,9693
8054,安國,23,15,8,富邦-新營,2024-03-06,9693
1303,南亞,8,0,8,富邦-新營,2024-03-06,9693
2408,南亞科,9,2,7,富邦-新營,2024-03-06,9693
2352,佳世達,12,5,7,富邦-新營,2024-03-06,9693
3287,廣寰科,7,0,7,富邦-新營,2024-03-06,9693
3689,湧德,7,0,7,富邦-新營,2024-03-06,9693
2516,新建,10,3,7,富邦-新營,2024-03-06,9693
00632R,元大台灣50反1,152,20,132,富邦-新營,2024-03-07,9693
00919,群益台灣精選高息,166,36,130,富邦-新營,2024-03-07,9693
6016,康和證,125,2,123,富邦-新營,2024-03-07,9693
00679B,元大美債20年,105,5,100,富邦-新營,2024-03-07,9693
00937B,群益ESG投等債20,62,1,61,富邦-新營,2024-03-07,9693
00706L,期元大S＆P日圓正2,57,0,57,富邦-新營,2024-03-07,9693
1815,富喬,121,80,41,富邦-新營,2024-03-07,9693
3046,建��,40,0,40,富邦-新營,2024-03-07,9693
1316,上曜,76,39,37,富邦-新營,2024-03-07,9693
2365,昆盈,36,3,33,富邦-新營,2024-03-07,9693
5488,松普,35,4,31,富邦-新營,2024-03-07,9693
6120,達運,32,1,31,富邦-新營,2024-03-07,9693
2371,大同,42,12,30,富邦-新營,2024-03-07,9693
2845,遠東銀,31,2,29,富邦-新營,2024-03-07,9693
1773,勝一,42,14,28,富邦-新營,2024-03-07,9693
3481,群創,28,1,27,富邦-新營,2024-03-07,9693
00637L,元大滬深300正2,25,0,25,富邦-新營,2024-03-07,9693
00922,國泰台灣領袖50,24,2,22,富邦-新營,2024-03-07,9693
2409,友達,23,1,22,富邦-新營,2024-03-07,9693
00712,復華富時不動產,27,7,20,富邦-新營,2024-03-07,9693
1227,佳格,20,0,20,富邦-新營,2024-03-07,9693
2634,漢翔,19,0,19,富邦-新營,2024-03-07,9693
00892,富邦台灣半導體,20,2,18,富邦-新營,2024-03-07,9693
3231,緯創,29,12,17,富邦-新營,2024-03-07,9693
3294,英濟,16,0,16,富邦-新營,2024-03-07,9693
1471,首利,17,2,15,富邦-新營,2024-03-07,9693
2331,精英,15,0,15,富邦-新營,2024-03-07,9693
2324,仁寶,17,3,14,富邦-新營,2024-03-07,9693
00918,大華優利高填息30,22,8,14,富邦-新營,2024-03-07,9693
00933B,國泰10Y+金融債,15,1,14,富邦-新營,2024-03-07,9693
2369,菱生,14,0,14,富邦-新營,2024-03-07,9693
1609,大亞,15,2,13,富邦-新營,2024-03-07,9693
3706,神達,21,8,13,富邦-新營,2024-03-07,9693
6125,廣運,27,15,12,富邦-新營,2024-03-07,9693
00687B,國泰20年美債,18,7,11,富邦-新營,2024-03-07,9693
1303,南亞,12,1,11,富邦-新營,2024-03-07,9693
2312,金寶,11,0,11,富邦-新營,2024-03-07,9693
8429,金麗-KY,11,0,11,富邦-新營,2024-03-07,9693
6282,康舒,11,0,11,富邦-新營,2024-03-07,9693
1101,台泥,20,10,10,富邦-新營,2024-03-07,9693
1527,鑽全,10,0,10,富邦-新營,2024-03-07,9693
1708,東鹼,10,0,10,富邦-新營,2024-03-07,9693
2302,麗正,10,0,10,富邦-新營,2024-03-07,9693
2332,友訊,10,0,10,富邦-新營,2024-03-07,9693
2739,寒舍,10,0,10,富邦-新營,2024-03-07,9693
4702,中美實,10,0,10,富邦-新營,2024-03-07,9693
5202,力新,10,0,10,富邦-新營,2024-03-07,9693
6118,建達,12,2,10,富邦-新營,2024-03-07,9693
6153,嘉聯益,10,0,10,富邦-新營,2024-03-07,9693
6233,旺玖,10,0,10,富邦-新營,2024-03-07,9693
2855,統一證,202,42,160,富邦-新營,2024-03-08,9693
00632R,元大台灣50反1,158,8,150,富邦-新營,2024-03-08,9693
2834,臺企銀,159,13,146,富邦-新營,2024-03-08,9693
6550,北極星藥業-KY,120,1,119,富邦-新營,2024-03-08,9693
6116,彩晶,113,1,112,富邦-新營,2024-03-08,9693
4142,國光生,100,0,100,富邦-新營,2024-03-08,9693
1718,中纖,83,11,72,富邦-新營,2024-03-08,9693
00680L,元大美債20正2,69,3,66,富邦-新營,2024-03-08,9693
00919,群益台灣精選高息,115,61,54,富邦-新營,2024-03-08,9693
00885,富邦越南,52,7,45,富邦-新營,2024-03-08,9693
3450,聯鈞,50,10,40,富邦-新營,2024-03-08,9693
00929,復華台灣科技優息,138,100,38,富邦-新營,2024-03-08,9693
3481,群創,36,2,34,富邦-新營,2024-03-08,9693
1785,光洋科,34,2,32,富邦-新營,2024-03-08,9693
1101,台泥,37,6,31,富邦-新營,2024-03-08,9693
3046,建��,30,0,30,富邦-新營,2024-03-08,9693
00937B,群益ESG投等債20,38,8,30,富邦-新營,2024-03-08,9693
3322,建舜電,30,3,27,富邦-新營,2024-03-08,9693
5498,凱崴,48,21,27,富邦-新營,2024-03-08,9693
00927,群益半導體收益,26,0,26,富邦-新營,2024-03-08,9693
1227,佳格,26,0,26,富邦-新營,2024-03-08,9693
2371,大同,33,8,25,富邦-新營,2024-03-08,9693
00637L,元大滬深300正2,30,7,23,富邦-新營,2024-03-08,9693
3049,精金,23,0,23,富邦-新營,2024-03-08,9693
00918,大華優利高填息30,38,15,23,富邦-新營,2024-03-08,9693
2374,佳能,23,2,21,富邦-新營,2024-03-08,9693
3308,聯德,20,0,20,富邦-新營,2024-03-08,9693
3706,神達,19,1,18,富邦-新營,2024-03-08,9693
00922,國泰台灣領袖50,18,0,18,富邦-新營,2024-03-08,9693
3163,波若威,28,12,16,富邦-新營,2024-03-08,9693
1301,台塑,14,0,14,富邦-新營,2024-03-08,9693
3171,炎洲流通,16,2,14,富邦-新營,2024-03-08,9693
6223,旺矽,13,0,13,富邦-新營,2024-03-08,9693
2409,友達,17,5,12,富邦-新營,2024-03-08,9693
00733,富邦臺灣中小,11,0,11,富邦-新營,2024-03-08,9693
2408,南亞科,11,0,11,富邦-新營,2024-03-08,9693
00687B,國泰20年美債,16,5,11,富邦-新營,2024-03-08,9693
1815,富喬,21,10,11,富邦-新營,2024-03-08,9693
2611,志信,13,2,11,富邦-新營,2024-03-08,9693
4934,太極,11,0,11,富邦-新營,2024-03-08,9693
6589,台康生技,11,0,11,富邦-新營,2024-03-08,9693
8942,森鉅,10,0,10,富邦-新營,2024-03-08,9693
2369,菱生,16,6,10,富邦-新營,2024-03-08,9693
3289,宜特,11,1,10,富邦-新營,2024-03-08,9693
3338,泰碩,14,4,10,富邦-新營,2024-03-08,9693
2323,中環,15,5,10,富邦-新營,2024-03-08,9693
2337,旺宏,10,0,10,富邦-新營,2024-03-08,9693
2511,太子,10,0,10,富邦-新營,2024-03-08,9693
2867,三商壽,10,0,10,富邦-新營,2024-03-08,9693
3028,增你強,10,0,10,富邦-新營,2024-03-08,9693
2834,臺企銀,453,2,451,富邦-新營,2024-03-11,9693
00706L,期元大S＆P日圓正2,300,0,300,富邦-新營,2024-03-11,9693
2882,國泰金,112,16,96,富邦-新營,2024-03-11,9693
00919,群益台灣精選高息,123,36,87,富邦-新營,2024-03-11,9693
00929,復華台灣科技優息,81,14,67,富邦-新營,2024-03-11,9693
2610,華航,55,1,54,富邦-新營,2024-03-11,9693
00712,復華富時不動產,53,4,49,富邦-新營,2024-03-11,9693
3481,群創,57,15,42,富邦-新營,2024-03-11,9693
2002,中鋼,40,5,35,富邦-新營,2024-03-11,9693
2365,昆盈,33,0,33,富邦-新營,2024-03-11,9693
6016,康和證,41,10,31,富邦-新營,2024-03-11,9693
00885,富邦越南,22,1,21,富邦-新營,2024-03-11,9693
3294,英濟,28,7,21,富邦-新營,2024-03-11,9693
1616,億泰,20,1,19,富邦-新營,2024-03-11,9693
2449,京元電子,29,10,19,富邦-新營,2024-03-11,9693
3312,弘憶股,20,3,17,富邦-新營,2024-03-11,9693
2109,華豐,16,0,16,富邦-新營,2024-03-11,9693
00922,國泰台灣領袖50,15,0,15,富邦-新營,2024-03-11,9693
2465,麗臺,14,0,14,富邦-新營,2024-03-11,9693
2344,華邦電,14,1,13,富邦-新營,2024-03-11,9693
3701,大眾控,15,2,13,富邦-新營,2024-03-11,9693
2516,新建,12,0,12,富邦-新營,2024-03-11,9693
5351,鈺創,12,1,11,富邦-新營,2024-03-11,9693
2820,華票,11,0,11,富邦-新營,2024-03-11,9693
3293,鈊象,19,8,11,富邦-新營,2024-03-11,9693
2603,長榮,11,1,10,富邦-新營,2024-03-11,9693
00679B,元大美債20年,20,10,10,富邦-新營,2024-03-11,9693
00753L,中信中國50正2,10,0,10,富邦-新營,2024-03-11,9693
1444,力麗,10,0,10,富邦-新營,2024-03-11,9693
1455,集盛,10,0,10,富邦-新營,2024-03-11,9693
1773,勝一,15,5,10,富邦-新營,2024-03-11,9693
2025,千興,10,0,10,富邦-新營,2024-03-11,9693
2641,正德,14,4,10,富邦-新營,2024-03-11,9693
5309,系統電,10,0,10,富邦-新營,2024-03-11,9693
8234,新漢,10,0,10,富邦-新營,2024-03-11,9693
8933,愛地雅,10,0,10,富邦-新營,2024-03-11,9693
8926,台汽電,10,1,9,富邦-新營,2024-03-11,9693
6182,合晶,11,2,9,富邦-新營,2024-03-11,9693
00751B,元大AAA至A公司債,10,1,9,富邦-新營,2024-03-11,9693
1733,五鼎,9,0,9,富邦-新營,2024-03-11,9693
1815,富喬,12,3,9,富邦-新營,2024-03-11,9693
2301,光寶科,10,1,9,富邦-新營,2024-03-11,9693
6139,亞翔,9,0,9,富邦-新營,2024-03-11,9693
2330,台積電,9,1,8,富邦-新營,2024-03-11,9693
00662,富邦NASDAQ,8,0,8,富邦-新營,2024-03-11,9693
1605,華新,8,0,8,富邦-新營,2024-03-11,9693
2618,長榮航,10,2,8,富邦-新營,2024-03-11,9693
2303,聯電,30,23,7,富邦-新營,2024-03-11,9693
00687B,國泰20年美債,7,0,7,富邦-新營,2024-03-11,9693
4167,松瑞藥,15,8,7,富邦-新營,2024-03-11,9693
00712,復華富時不動產,500,0,500,富邦-新營,2024-03-12,9693
2834,臺企銀,215,7,208,富邦-新營,2024-03-12,9693
2382,廣達,152,24,128,富邦-新營,2024-03-12,9693
6016,康和證,130,3,127,富邦-新營,2024-03-12,9693
8064,東捷,100,0,100,富邦-新營,2024-03-12,9693
2892,第一金,53,0,53,富邦-新營,2024-03-12,9693
2618,長榮航,66,14,52,富邦-新營,2024-03-12,9693
00885,富邦越南,52,0,52,富邦-新營,2024-03-12,9693
2547,日勝生,50,0,50,富邦-新營,2024-03-12,9693
5483,中美晶,50,1,49,富邦-新營,2024-03-12,9693
00930,永豐ESG低碳高息,40,1,39,富邦-新營,2024-03-12,9693
1582,信錦,136,104,32,富邦-新營,2024-03-12,9693
00919,群益台灣精選高息,50,19,31,富邦-新營,2024-03-12,9693
2365,昆盈,28,3,25,富邦-新營,2024-03-12,9693
2367,燿華,53,29,24,富邦-新營,2024-03-12,9693
1815,富喬,39,15,24,富邦-新營,2024-03-12,9693
3563,牧德,28,4,24,富邦-新營,2024-03-12,9693
2329,華泰,29,7,22,富邦-新營,2024-03-12,9693
2025,千興,21,0,21,富邦-新營,2024-03-12,9693
00753L,中信中國50正2,20,0,20,富邦-新營,2024-03-12,9693
5706,鳳凰,20,0,20,富邦-新營,2024-03-12,9693
2354,鴻準,21,2,19,富邦-新營,2024-03-12,9693
1101,台泥,16,0,16,富邦-新營,2024-03-12,9693
00857B,永豐20年美公債,15,1,14,富邦-新營,2024-03-12,9693
3046,建��,14,0,14,富邦-新營,2024-03-12,9693
5498,凱崴,16,2,14,富邦-新營,2024-03-12,9693
00706L,期元大S＆P日圓正2,13,0,13,富邦-新營,2024-03-12,9693
6505,台塑化,12,0,12,富邦-新營,2024-03-12,9693
8926,台汽電,14,2,12,富邦-新營,2024-03-12,9693
2405,輔信,11,0,11,富邦-新營,2024-03-12,9693
2443,昶虹,10,0,10,富邦-新營,2024-03-12,9693
9955,佳龍,10,0,10,富邦-新營,2024-03-12,9693
00918,大華優利高填息30,10,0,10,富邦-新營,2024-03-12,9693
2883,凱基金,24,15,9,富邦-新營,2024-03-12,9693
1316,上曜,11,2,9,富邦-新營,2024-03-12,9693
4934,太極,20,11,9,富邦-新營,2024-03-12,9693
3231,緯創,25,16,9,富邦-新營,2024-03-12,9693
1471,首利,10,2,8,富邦-新營,2024-03-12,9693
2355,敬鵬,8,0,8,富邦-新營,2024-03-12,9693
3265,台星科,8,0,8,富邦-新營,2024-03-12,9693
3545,敦泰,8,1,7,富邦-新營,2024-03-12,9693
00687B,國泰20年美債,18,12,6,富邦-新營,2024-03-12,9693
1605,華新,6,0,6,富邦-新營,2024-03-12,9693
1711,永光,7,1,6,富邦-新營,2024-03-12,9693
2371,大同,6,0,6,富邦-新營,2024-03-12,9693
2450,神腦,6,0,6,富邦-新營,2024-03-12,9693
2465,麗臺,11,5,6,富邦-新營,2024-03-12,9693
3016,嘉晶,9,3,6,富邦-新營,2024-03-12,9693
3663,鑫科,6,0,6,富邦-新營,2024-03-12,9693
4714,永捷,34,28,6,富邦-新營,2024-03-12,9693
00632R,元大台灣50反1,350,30,320,富邦-新營,2024-03-13,9693
00706L,期元大S＆P日圓正2,201,0,201,富邦-新營,2024-03-13,9693
00712,復華富時不動產,200,2,198,富邦-新營,2024-03-13,9693
00919,群益台灣精選高息,201,97,104,富邦-新營,2024-03-13,9693
00688L,國泰20年美債正2,104,0,104,富邦-新營,2024-03-13,9693
1608,華榮,106,24,82,富邦-新營,2024-03-13,9693
1219,福壽,60,0,60,富邦-新營,2024-03-13,9693
6005,群益證,55,0,55,富邦-新營,2024-03-13,9693
1718,中纖,54,2,52,富邦-新營,2024-03-13,9693
2881,富邦金,52,1,51,富邦-新營,2024-03-13,9693
2888,新光金,52,2,50,富邦-新營,2024-03-13,9693
2408,南亞科,47,0,47,富邦-新營,2024-03-13,9693
4714,永捷,55,12,43,富邦-新營,2024-03-13,9693
8064,東捷,51,14,37,富邦-新營,2024-03-13,9693
2354,鴻準,157,123,34,富邦-新營,2024-03-13,9693
8349,�矬�,33,0,33,富邦-新營,2024-03-13,9693
00915,凱基優選高股息30,33,2,31,富邦-新營,2024-03-13,9693
2025,千興,30,0,30,富邦-新營,2024-03-13,9693
2312,金寶,30,0,30,富邦-新營,2024-03-13,9693
2365,昆盈,43,13,30,富邦-新營,2024-03-13,9693
5498,凱崴,41,11,30,富邦-新營,2024-03-13,9693
8926,台汽電,40,16,24,富邦-新營,2024-03-13,9693
4960,誠美材,24,0,24,富邦-新營,2024-03-13,9693
2002,中鋼,24,2,22,富邦-新營,2024-03-13,9693
2812,台中銀,23,1,22,富邦-新營,2024-03-13,9693
2353,宏��,32,11,21,富邦-新營,2024-03-13,9693
2359,所羅門,21,0,21,富邦-新營,2024-03-13,9693
5426,振發,25,4,21,富邦-新營,2024-03-13,9693
2852,第一保,20,0,20,富邦-新營,2024-03-13,9693
4142,國光生,22,3,19,富邦-新營,2024-03-13,9693
8011,台通,80,62,18,富邦-新營,2024-03-13,9693
3163,波若威,34,21,13,富邦-新營,2024-03-13,9693
00933B,國泰10Y+金融債,15,2,13,富邦-新營,2024-03-13,9693
1305,華夏,13,0,13,富邦-新營,2024-03-13,9693
6125,廣運,15,2,13,富邦-新營,2024-03-13,9693
3231,緯創,33,20,13,富邦-新營,2024-03-13,9693
6284,佳邦,12,0,12,富邦-新營,2024-03-13,9693
2376,技嘉,14,2,12,富邦-新營,2024-03-13,9693
00772B,中信高評級公司債,21,10,11,富邦-新營,2024-03-13,9693
1455,集盛,11,0,11,富邦-新營,2024-03-13,9693
5355,佳總,11,0,11,富邦-新營,2024-03-13,9693
6451,訊芯-KY,13,2,11,富邦-新營,2024-03-13,9693
00679B,元大美債20年,35,25,10,富邦-新營,2024-03-13,9693
3025,星通,10,0,10,富邦-新營,2024-03-13,9693
00720B,元大投資級公司債,10,0,10,富邦-新營,2024-03-13,9693
1582,信錦,12,2,10,富邦-新營,2024-03-13,9693
2450,神腦,10,0,10,富邦-新營,2024-03-13,9693
3710,連展投控,10,0,10,富邦-新營,2024-03-13,9693
4576,大銀微系統,10,0,10,富邦-新營,2024-03-13,9693
4939,亞電,10,0,10,富邦-新營,2024-03-13,9693
00919,群益台灣精選高息,421,95,326,富邦-新營,2024-03-14,9693
00688L,國泰20年美債正2,102,0,102,富邦-新營,2024-03-14,9693
00632R,元大台灣50反1,60,0,60,富邦-新營,2024-03-14,9693
00687B,國泰20年美債,58,4,54,富邦-新營,2024-03-14,9693
2344,華邦電,54,0,54,富邦-新營,2024-03-14,9693
4960,誠美材,45,0,45,富邦-新營,2024-03-14,9693
2889,國票金,59,24,35,富邦-新營,2024-03-14,9693
00918,大華優利高填息30,35,2,33,富邦-新營,2024-03-14,9693
00679B,元大美債20年,32,0,32,富邦-新營,2024-03-14,9693
00937B,群益ESG投等債20,35,5,30,富邦-新營,2024-03-14,9693
4142,國光生,26,0,26,富邦-新營,2024-03-14,9693
2834,臺企銀,30,4,26,富邦-新營,2024-03-14,9693
2634,漢翔,23,2,21,富邦-新營,2024-03-14,9693
2354,鴻準,33,13,20,富邦-新營,2024-03-14,9693
00772B,中信高評級公司債,21,1,20,富邦-新營,2024-03-14,9693
2543,皇昌,20,0,20,富邦-新營,2024-03-14,9693
8046,南電,20,0,20,富邦-新營,2024-03-14,9693
6005,群益證,29,11,18,富邦-新營,2024-03-14,9693
2885,元大金,26,7,19,富邦-新營,2024-03-14,9693
1718,中纖,18,0,18,富邦-新營,2024-03-14,9693
2211,長榮鋼,26,8,18,富邦-新營,2024-03-14,9693
00922,國泰台灣領袖50,16,0,16,富邦-新營,2024-03-14,9693
00933B,國泰10Y+金融債,21,7,14,富邦-新營,2024-03-14,9693
6770,力積電,12,0,12,富邦-新營,2024-03-14,9693
2109,華豐,15,3,12,富邦-新營,2024-03-14,9693
2324,仁寶,12,0,12,富邦-新營,2024-03-14,9693
4576,大銀微系統,12,0,12,富邦-新營,2024-03-14,9693
8011,台通,37,25,12,富邦-新營,2024-03-14,9693
2892,第一金,11,0,11,富邦-新營,2024-03-14,9693
3231,緯創,33,22,11,富邦-新營,2024-03-14,9693
1314,中石化,11,0,11,富邦-新營,2024-03-14,9693
2880,華南金,11,0,11,富邦-新營,2024-03-14,9693
3163,波若威,13,3,10,富邦-新營,2024-03-14,9693
00680L,元大美債20正2,10,0,10,富邦-新營,2024-03-14,9693
00673R,期元大S＆P原油反1,10,0,10,富邦-新營,2024-03-14,9693
1455,集盛,13,3,10,富邦-新營,2024-03-14,9693
2014,中鴻,12,2,10,富邦-新營,2024-03-14,9693
6153,嘉聯益,10,0,10,富邦-新營,2024-03-14,9693
0056,元大高股息,11,2,9,富邦-新營,2024-03-14,9693
1802,台玻,12,3,9,富邦-新營,2024-03-14,9693
00927,群益半導體收益,8,0,8,富邦-新營,2024-03-14,9693
3702,大聯大,9,1,8,富邦-新營,2024-03-14,9693
6117,迎廣,12,4,8,富邦-新營,2024-03-14,9693
1503,士電,11,3,8,富邦-新營,2024-03-14,9693
1513,中興電,31,23,8,富邦-新營,2024-03-14,9693
1316,上曜,12,5,7,富邦-新營,2024-03-14,9693
2383,台光電,40,33,7,富邦-新營,2024-03-14,9693
1609,大亞,21,15,6,富邦-新營,2024-03-14,9693
00733,富邦臺灣中小,6,0,6,富邦-新營,2024-03-14,9693
2002,中鋼,7,1,6,富邦-新營,2024-03-14,9693
00919,群益台灣精選高息,388,28,360,富邦-新營,2024-03-15,9693
2834,臺企銀,228,13,215,富邦-新營,2024-03-15,9693
6120,達運,124,0,124,富邦-新營,2024-03-15,9693
00688L,國泰20年美債正2,115,0,115,富邦-新營,2024-03-15,9693
00941,中信上游半導體,138,26,112,富邦-新營,2024-03-15,9693
00753L,中信中國50正2,90,0,90,富邦-新營,2024-03-15,9693
2359,所羅門,78,0,78,富邦-新營,2024-03-15,9693
00937B,群益ESG投等債20,96,28,68,富邦-新營,2024-03-15,9693
00681R,元大美債20反1,50,0,50,富邦-新營,2024-03-15,9693
4142,國光生,50,0,50,富邦-新營,2024-03-15,9693
2610,華航,42,0,42,富邦-新營,2024-03-15,9693
2801,彰銀,64,25,39,富邦-新營,2024-03-15,9693
2609,陽明,38,5,33,富邦-新營,2024-03-15,9693
2880,華南金,50,18,32,富邦-新營,2024-03-15,9693
00679B,元大美債20年,32,0,32,富邦-新營,2024-03-15,9693
00903,富邦元宇宙,30,0,30,富邦-新營,2024-03-15,9693
00706L,期元大S＆P日圓正2,30,0,30,富邦-新營,2024-03-15,9693
2882,國泰金,30,1,29,富邦-新營,2024-03-15,9693
6770,力積電,33,4,29,富邦-新營,2024-03-15,9693
2884,玉山金,37,9,28,富邦-新營,2024-03-15,9693
3163,波若威,21,0,21,富邦-新營,2024-03-15,9693
1718,中纖,26,5,21,富邦-新營,2024-03-15,9693
2025,千興,71,50,21,富邦-新營,2024-03-15,9693
00665L,富邦�琤肭磪囓�2,20,0,20,富邦-新營,2024-03-15,9693
2883B,凱基金乙特,20,0,20,富邦-新營,2024-03-15,9693
2615,萬海,22,3,19,富邦-新營,2024-03-15,9693
2356,英業達,21,3,18,富邦-新營,2024-03-15,9693
00857B,永豐20年美公債,21,4,17,富邦-新營,2024-03-15,9693
2382,廣達,366,349,17,富邦-新營,2024-03-15,9693
00918,大華優利高填息30,17,0,17,富邦-新營,2024-03-15,9693
2355,敬鵬,16,0,16,富邦-新營,2024-03-15,9693
3260,威剛,16,0,16,富邦-新營,2024-03-15,9693
3481,群創,43,27,16,富邦-新營,2024-03-15,9693
2603,長榮,50,35,15,富邦-新營,2024-03-15,9693
00885,富邦越南,24,9,15,富邦-新營,2024-03-15,9693
2328,廣宇,15,1,14,富邦-新營,2024-03-15,9693
2020,美亞,14,0,14,富邦-新營,2024-03-15,9693
2889,國票金,21,7,14,富邦-新營,2024-03-15,9693
2371,大同,15,2,13,富邦-新營,2024-03-15,9693
1101,台泥,15,2,13,富邦-新營,2024-03-15,9693
1303,南亞,12,0,12,富邦-新營,2024-03-15,9693
2888,新光金,12,0,12,富邦-新營,2024-03-15,9693
2891,中信金,12,0,12,富邦-新營,2024-03-15,9693
2887,台新金,12,0,12,富邦-新營,2024-03-15,9693
2363,矽統,11,0,11,富邦-新營,2024-03-15,9693
00915,凱基優選高股息30,11,0,11,富邦-新營,2024-03-15,9693
2022,聚亨,11,0,11,富邦-新營,2024-03-15,9693
2597,潤弘,11,0,11,富邦-新營,2024-03-15,9693
2465,麗臺,11,0,11,富邦-新營,2024-03-15,9693
00712,復華富時不動產,10,0,10,富邦-新營,2024-03-15,9693
00919,群益台灣精選高息,260,11,249,富邦-新營,2024-03-18,9693
00937B,群益ESG投等債20,231,0,231,富邦-新營,2024-03-18,9693
00706L,期元大S＆P日圓正2,100,0,100,富邦-新營,2024-03-18,9693
2834,臺企銀,75,3,72,富邦-新營,2024-03-18,9693
00885,富邦越南,62,5,57,富邦-新營,2024-03-18,9693
4714,永捷,62,8,54,富邦-新營,2024-03-18,9693
00687B,國泰20年美債,49,0,49,富邦-新營,2024-03-18,9693
00941,中信上游半導體,41,2,39,富邦-新營,2024-03-18,9693
2618,長榮航,39,1,38,富邦-新營,2024-03-18,9693
00915,凱基優選高股息30,33,0,33,富邦-新營,2024-03-18,9693
3583,辛耘,35,4,31,富邦-新營,2024-03-18,9693
1314,中石化,30,0,30,富邦-新營,2024-03-18,9693
3231,緯創,36,7,29,富邦-新營,2024-03-18,9693
5347,世界,33,4,29,富邦-新營,2024-03-18,9693
2323,中環,38,12,26,富邦-新營,2024-03-18,9693
2812,台中銀,26,0,26,富邦-新營,2024-03-18,9693
2353,宏��,25,0,25,富邦-新營,2024-03-18,9693
6116,彩晶,23,0,23,富邦-新營,2024-03-18,9693
2337,旺宏,22,1,21,富邦-新營,2024-03-18,9693
00673R,期元大S＆P原油反1,20,0,20,富邦-新營,2024-03-18,9693
2547,日勝生,20,0,20,富邦-新營,2024-03-18,9693
3294,英濟,27,7,20,富邦-新營,2024-03-18,9693
00679B,元大美債20年,18,0,18,富邦-新營,2024-03-18,9693
2609,陽明,20,3,17,富邦-新營,2024-03-18,9693
2855,統一證,17,0,17,富邦-新營,2024-03-18,9693
2367,燿華,31,15,16,富邦-新營,2024-03-18,9693
2354,鴻準,21,5,16,富邦-新營,2024-03-18,9693
2601,益航,16,0,16,富邦-新營,2024-03-18,9693
1101,台泥,15,1,14,富邦-新營,2024-03-18,9693
2610,華航,15,1,14,富邦-新營,2024-03-18,9693
5515,建國,13,0,13,富邦-新營,2024-03-18,9693
2542,興富發,11,0,11,富邦-新營,2024-03-18,9693
5880,合庫金,11,0,11,富邦-新營,2024-03-18,9693
6589,台康生技,11,1,10,富邦-新營,2024-03-18,9693
00918,大華優利高填息30,11,1,10,富邦-新營,2024-03-18,9693
8011,台通,43,33,10,富邦-新營,2024-03-18,9693
2362,藍天,10,0,10,富邦-新營,2024-03-18,9693
1108,幸福,10,0,10,富邦-新營,2024-03-18,9693
2365,昆盈,10,0,10,富邦-新營,2024-03-18,9693
2374,佳能,10,0,10,富邦-新營,2024-03-18,9693
2392,正崴,10,0,10,富邦-新營,2024-03-18,9693
2399,映泰,10,0,10,富邦-新營,2024-03-18,9693
4162,智擎,10,0,10,富邦-新營,2024-03-18,9693
6016,康和證,10,0,10,富邦-新營,2024-03-18,9693
1718,中纖,10,0,10,富邦-新營,2024-03-18,9693
6182,合晶,10,1,9,富邦-新營,2024-03-18,9693
2611,志信,43,34,9,富邦-新營,2024-03-18,9693
8349,�矬�,8,0,8,富邦-新營,2024-03-18,9693
1522,堤維西,13,5,8,富邦-新營,2024-03-18,9693
00933B,國泰10Y+金融債,17,10,7,富邦-新營,2024-03-18,9693
2855,統一證,330,0,330,富邦-新營,2024-03-19,9693
00937B,群益ESG投等債20,173,0,173,富邦-新營,2024-03-19,9693
2453,凌群,137,0,137,富邦-新營,2024-03-19,9693
3231,緯創,111,13,98,富邦-新營,2024-03-19,9693
3322,建舜電,60,0,60,富邦-新營,2024-03-19,9693
1720,生達,50,0,50,富邦-新營,2024-03-19,9693
00929,復華台灣科技優息,125,79,46,富邦-新營,2024-03-19,9693
00665L,富邦�琤肭磪囓�2,40,0,40,富邦-新營,2024-03-19,9693
00753L,中信中國50正2,33,0,33,富邦-新營,2024-03-19,9693
2515,中工,47,16,31,富邦-新營,2024-03-19,9693
00941,中信上游半導體,36,5,31,富邦-新營,2024-03-19,9693
2601,益航,30,0,30,富邦-新營,2024-03-19,9693
00687B,國泰20年美債,30,5,25,富邦-新營,2024-03-19,9693
1582,信錦,20,0,20,富邦-新營,2024-03-19,9693
1718,中纖,20,0,20,富邦-新營,2024-03-19,9693
2633,台灣高鐵,20,0,20,富邦-新營,2024-03-19,9693
4576,大銀微系統,20,0,20,富邦-新營,2024-03-19,9693
00891,中信關鍵半導體,22,4,18,富邦-新營,2024-03-19,9693
2401,凌陽,17,0,17,富邦-新營,2024-03-19,9693
2451,創見,17,0,17,富邦-新營,2024-03-19,9693
3481,群創,35,20,15,富邦-新營,2024-03-19,9693
4771,望隼,15,0,15,富邦-新營,2024-03-19,9693
6182,合晶,16,1,15,富邦-新營,2024-03-19,9693
2356,英業達,24,9,15,富邦-新營,2024-03-19,9693
3017,奇鋐,32,18,14,富邦-新營,2024-03-19,9693
00680L,元大美債20正2,14,0,14,富邦-新營,2024-03-19,9693
6505,台塑化,14,0,14,富邦-新營,2024-03-19,9693
1101,台泥,14,1,13,富邦-新營,2024-03-19,9693
2337,旺宏,13,0,13,富邦-新營,2024-03-19,9693
8011,台通,25,12,13,富邦-新營,2024-03-19,9693
3312,弘憶股,33,21,12,富邦-新營,2024-03-19,9693
2329,華泰,36,24,12,富邦-新營,2024-03-19,9693
2618,長榮航,11,0,11,富邦-新營,2024-03-19,9693
2834,臺企銀,37,26,11,富邦-新營,2024-03-19,9693
00673R,期元大S＆P原油反1,10,0,10,富邦-新營,2024-03-19,9693
00688L,國泰20年美債正2,10,0,10,富邦-新營,2024-03-19,9693
1710,東聯,10,0,10,富邦-新營,2024-03-19,9693
1786,科妍,10,0,10,富邦-新營,2024-03-19,9693
2353,宏��,13,3,10,富邦-新營,2024-03-19,9693
2889,國票金,10,0,10,富邦-新營,2024-03-19,9693
3564,其陽,20,10,10,富邦-新營,2024-03-19,9693
8926,台汽電,10,0,10,富邦-新營,2024-03-19,9693
5347,世界,26,17,9,富邦-新營,2024-03-19,9693
8050,廣積,9,0,9,富邦-新營,2024-03-19,9693
00857B,永豐20年美公債,11,2,9,富邦-新營,2024-03-19,9693
2539,櫻花建,9,0,9,富邦-新營,2024-03-19,9693
6005,群益證,9,0,9,富邦-新營,2024-03-19,9693
2603,長榮,15,6,9,富邦-新營,2024-03-19,9693
2301,光寶科,12,4,8,富邦-新營,2024-03-19,9693
6233,旺玖,14,6,8,富邦-新營,2024-03-19,9693
00939,統一台灣高息動能,419,204,215,富邦-新營,2024-03-20,9693
00937B,群益ESG投等債20,152,0,152,富邦-新營,2024-03-20,9693
2886,兆豐金,110,3,107,富邦-新營,2024-03-20,9693
2618,長榮航,96,0,96,富邦-新營,2024-03-20,9693
2344,華邦電,95,47,48,富邦-新營,2024-03-20,9693
2356,英業達,66,19,47,富邦-新營,2024-03-20,9693
6116,彩晶,40,0,40,富邦-新營,2024-03-20,9693
00878,國泰永續高股息,55,18,37,富邦-新營,2024-03-20,9693
1618,合機,32,0,32,富邦-新營,2024-03-20,9693
1907,永豐餘,30,0,30,富邦-新營,2024-03-20,9693
2888,新光金,30,0,30,富邦-新營,2024-03-20,9693
4121,優盛,24,0,24,富邦-新營,2024-03-20,9693
4938,和碩,39,15,24,富邦-新營,2024-03-20,9693
2897,王道銀行,22,0,22,富邦-新營,2024-03-20,9693
6770,力積電,22,1,21,富邦-新營,2024-03-20,9693
2420,新巨,21,0,21,富邦-新營,2024-03-20,9693
1582,信錦,20,0,20,富邦-新營,2024-03-20,9693
00753L,中信中國50正2,18,0,18,富邦-新營,2024-03-20,9693
2834,臺企銀,18,2,16,富邦-新營,2024-03-20,9693
3017,奇鋐,32,16,16,富邦-新營,2024-03-20,9693
1608,華榮,22,6,16,富邦-新營,2024-03-20,9693
3481,群創,16,0,16,富邦-新營,2024-03-20,9693
2382,廣達,17,1,16,富邦-新營,2024-03-20,9693
6274,台燿,22,8,14,富邦-新營,2024-03-20,9693
1718,中纖,14,0,14,富邦-新營,2024-03-20,9693
1504,東元,22,8,14,富邦-新營,2024-03-20,9693
1303,南亞,14,1,13,富邦-新營,2024-03-20,9693
00712,復華富時不動產,14,1,13,富邦-新營,2024-03-20,9693
3147,大綜,14,1,13,富邦-新營,2024-03-20,9693
6139,亞翔,13,1,12,富邦-新營,2024-03-20,9693
2323,中環,21,10,11,富邦-新營,2024-03-20,9693
5498,凱崴,11,0,11,富邦-新營,2024-03-20,9693
00665L,富邦�琤肭磪囓�2,10,0,10,富邦-新營,2024-03-20,9693
00688L,國泰20年美債正2,10,0,10,富邦-新營,2024-03-20,9693
1786,科妍,10,0,10,富邦-新營,2024-03-20,9693
3062,建漢,10,0,10,富邦-新營,2024-03-20,9693
5512,力麒,10,0,10,富邦-新營,2024-03-20,9693
6168,宏齊,10,0,10,富邦-新營,2024-03-20,9693
00918,大華優利高填息30,10,0,10,富邦-新營,2024-03-20,9693
2609,陽明,11,2,9,富邦-新營,2024-03-20,9693
1432,大魯閣,9,0,9,富邦-新營,2024-03-20,9693
6233,旺玖,9,0,9,富邦-新營,2024-03-20,9693
1605,華新,8,0,8,富邦-新營,2024-03-20,9693
4561,健椿,8,0,8,富邦-新營,2024-03-20,9693
5351,鈺創,8,0,8,富邦-新營,2024-03-20,9693
0056,元大高股息,10,2,8,富邦-新營,2024-03-20,9693
00679B,元大美債20年,7,0,7,富邦-新營,2024-03-20,9693
2303,聯電,40,33,7,富邦-新營,2024-03-20,9693
1611,中電,7,0,7,富邦-新營,2024-03-20,9693
3711,日月光投控,7,0,7,富邦-新營,2024-03-20,9693
2855,統一證,160,0,160,富邦-新營,2024-03-21,9693
00939,統一台灣高息動能,181,23,158,富邦-新營,2024-03-21,9693
00937B,群益ESG投等債20,144,0,144,富邦-新營,2024-03-21,9693
00632R,元大台灣50反1,136,0,136,富邦-新營,2024-03-21,9693
4938,和碩,117,8,109,富邦-新營,2024-03-21,9693
6188,廣明,118,33,85,富邦-新營,2024-03-21,9693
00929,復華台灣科技優息,104,20,84,富邦-新營,2024-03-21,9693
00919,群益台灣精選高息,139,75,64,富邦-新營,2024-03-21,9693
3042,晶技,60,4,56,富邦-新營,2024-03-21,9693
1608,華榮,43,1,42,富邦-新營,2024-03-21,9693
00679B,元大美債20年,39,1,38,富邦-新營,2024-03-21,9693
00687B,國泰20年美債,37,0,37,富邦-新營,2024-03-21,9693
2547,日勝生,30,0,30,富邦-新營,2024-03-21,9693
2888,新光金,30,2,28,富邦-新營,2024-03-21,9693
00857B,永豐20年美公債,25,0,25,富邦-新營,2024-03-21,9693
2371,大同,27,6,21,富邦-新營,2024-03-21,9693
2618,長榮航,20,0,20,富邦-新營,2024-03-21,9693
2603,長榮,37,18,19,富邦-新營,2024-03-21,9693
2405,輔信,43,24,19,富邦-新營,2024-03-21,9693
8374,羅昇,20,1,19,富邦-新營,2024-03-21,9693
00941,中信上游半導體,20,5,15,富邦-新營,2024-03-21,9693
3005,神基,23,9,14,富邦-新營,2024-03-21,9693
6605,帝寶,16,3,13,富邦-新營,2024-03-21,9693
2331,精英,20,7,13,富邦-新營,2024-03-21,9693
2880,華南金,13,0,13,富邦-新營,2024-03-21,9693
2354,鴻準,28,15,13,富邦-新營,2024-03-21,9693
2332,友訊,12,0,12,富邦-新營,2024-03-21,9693
2401,凌陽,12,0,12,富邦-新營,2024-03-21,9693
00637L,元大滬深300正2,10,0,10,富邦-新營,2024-03-21,9693
1786,科妍,10,0,10,富邦-新營,2024-03-21,9693
2303,聯電,22,12,10,富邦-新營,2024-03-21,9693
3372,典範,10,0,10,富邦-新營,2024-03-21,9693
4571,鈞興-KY,10,0,10,富邦-新營,2024-03-21,9693
4960,誠美材,10,0,10,富邦-新營,2024-03-21,9693
2834,臺企銀,11,2,9,富邦-新營,2024-03-21,9693
1609,大亞,23,14,9,富邦-新營,2024-03-21,9693
2206,三陽工業,9,0,9,富邦-新營,2024-03-21,9693
2376,技嘉,14,5,9,富邦-新營,2024-03-21,9693
2812,台中銀,8,0,8,富邦-新營,2024-03-21,9693
00751B,元大AAA至A公司債,7,0,7,富邦-新營,2024-03-21,9693
6015,宏遠證,10,3,7,富邦-新營,2024-03-21,9693
2360,致茂,6,0,6,富邦-新營,2024-03-21,9693
2464,盟立,6,0,6,富邦-新營,2024-03-21,9693
6122,擎邦,6,0,6,富邦-新營,2024-03-21,9693
8234,新漢,7,1,6,富邦-新營,2024-03-21,9693
00931B,統一美債20年,5,0,5,富邦-新營,2024-03-21,9693
5347,世界,6,1,5,富邦-新營,2024-03-21,9693
00720B,元大投資級公司債,5,0,5,富邦-新營,2024-03-21,9693
1309,台達化,6,1,5,富邦-新營,2024-03-21,9693
2030,彰源,5,0,5,富邦-新營,2024-03-21,9693
4960,誠美材,600,1,599,富邦-新營,2024-03-22,9693
2356,英業達,757,611,146,富邦-新營,2024-03-22,9693
3231,緯創,250,114,136,富邦-新營,2024-03-22,9693
00753L,中信中國50正2,100,0,100,富邦-新營,2024-03-22,9693
6442,光聖,90,0,90,富邦-新營,2024-03-22,9693
00665L,富邦�琤肭磪囓�2,85,0,85,富邦-新營,2024-03-22,9693
00929,復華台灣科技優息,80,14,66,富邦-新營,2024-03-22,9693
2344,華邦電,63,10,53,富邦-新營,2024-03-22,9693
00687B,國泰20年美債,56,12,44,富邦-新營,2024-03-22,9693
00939,統一台灣高息動能,66,22,44,富邦-新營,2024-03-22,9693
00680L,元大美債20正2,37,0,37,富邦-新營,2024-03-22,9693
2358,廷鑫,40,5,35,富邦-新營,2024-03-22,9693
00941,中信上游半導體,46,12,34,富邦-新營,2024-03-22,9693
2332,友訊,34,2,32,富邦-新營,2024-03-22,9693
1810,和成,31,0,31,富邦-新營,2024-03-22,9693
1504,東元,38,12,26,富邦-新營,2024-03-22,9693
2324,仁寶,29,4,25,富邦-新營,2024-03-22,9693
2330,台積電,23,1,22,富邦-新營,2024-03-22,9693
2002,中鋼,21,0,21,富邦-新營,2024-03-22,9693
00706L,期元大S＆P日圓正2,20,0,20,富邦-新營,2024-03-22,9693
2408,南亞科,31,12,19,富邦-新營,2024-03-22,9693
2323,中環,27,8,19,富邦-新營,2024-03-22,9693
2331,精英,21,2,19,富邦-新營,2024-03-22,9693
00900,富邦特選高股息30,19,0,19,富邦-新營,2024-03-22,9693
2353,宏��,261,244,17,富邦-新營,2024-03-22,9693
2006,東和鋼鐵,17,0,17,富邦-新營,2024-03-22,9693
1540,喬福,16,0,16,富邦-新營,2024-03-22,9693
00651R,復華香港反1,15,0,15,富邦-新營,2024-03-22,9693
00679B,元大美債20年,14,0,14,富邦-新營,2024-03-22,9693
2314,台揚,12,0,12,富邦-新營,2024-03-22,9693
2603,長榮,16,4,12,富邦-新營,2024-03-22,9693
1718,中纖,11,0,11,富邦-新營,2024-03-22,9693
2329,華泰,14,3,11,富邦-新營,2024-03-22,9693
2486,一詮,14,3,11,富邦-新營,2024-03-22,9693
00915,凱基優選高股息30,11,0,11,富邦-新營,2024-03-22,9693
5905,南仁湖,10,0,10,富邦-新營,2024-03-22,9693
2417,圓剛,13,3,10,富邦-新營,2024-03-22,9693
4571,鈞興-KY,10,0,10,富邦-新營,2024-03-22,9693
5488,松普,10,0,10,富邦-新營,2024-03-22,9693
6182,合晶,10,0,10,富邦-新營,2024-03-22,9693
2881,富邦金,10,0,10,富邦-新營,2024-03-22,9693
2882,國泰金,10,0,10,富邦-新營,2024-03-22,9693
2634,漢翔,13,4,9,富邦-新營,2024-03-22,9693
3260,威剛,10,1,9,富邦-新營,2024-03-22,9693
2376,技嘉,21,13,8,富邦-新營,2024-03-22,9693
1909,榮成,10,2,8,富邦-新營,2024-03-22,9693
2888,新光金,8,0,8,富邦-新營,2024-03-22,9693
3363,上詮,10,2,8,富邦-新營,2024-03-22,9693
8234,新漢,8,0,8,富邦-新營,2024-03-22,9693
3005,神基,17,9,8,富邦-新營,2024-03-22,9693
6188,廣明,111,10,101,富邦-新營,2024-03-25,9693
00919,群益台灣精選高息,68,14,54,富邦-新營,2024-03-25,9693
8040,九暘,50,2,48,富邦-新營,2024-03-25,9693
1609,大亞,120,76,44,富邦-新營,2024-03-25,9693
00679B,元大美債20年,44,4,40,富邦-新營,2024-03-25,9693
2356,英業達,73,34,39,富邦-新營,2024-03-25,9693
00929,復華台灣科技優息,86,50,36,富邦-新營,2024-03-25,9693
1605,華新,36,3,33,富邦-新營,2024-03-25,9693
00937B,群益ESG投等債20,41,10,31,富邦-新營,2024-03-25,9693
2380,虹光,29,0,29,富邦-新營,2024-03-25,9693
2337,旺宏,28,0,28,富邦-新營,2024-03-25,9693
2483,百容,27,0,27,富邦-新營,2024-03-25,9693
2303,聯電,31,7,24,富邦-新營,2024-03-25,9693
00650L,復華香港正2,25,2,23,富邦-新營,2024-03-25,9693
6215,和椿,24,1,23,富邦-新營,2024-03-25,9693
00720B,元大投資級公司債,22,0,22,富邦-新營,2024-03-25,9693
4571,鈞興-KY,22,0,22,富邦-新營,2024-03-25,9693
2367,燿華,73,51,22,富邦-新營,2024-03-25,9693
3583,辛耘,72,51,21,富邦-新營,2024-03-25,9693
1786,科妍,20,0,20,富邦-新營,2024-03-25,9693
4414,如興,20,0,20,富邦-新營,2024-03-25,9693
00751B,元大AAA至A公司債,20,2,18,富邦-新營,2024-03-25,9693
2498,宏達電,19,2,17,富邦-新營,2024-03-25,9693
5880,合庫金,16,1,15,富邦-新營,2024-03-25,9693
2489,瑞軒,15,0,15,富邦-新營,2024-03-25,9693
2845,遠東銀,15,0,15,富邦-新營,2024-03-25,9693
6207,雷科,15,0,15,富邦-新營,2024-03-25,9693
6806,森崴能源,16,2,14,富邦-新營,2024-03-25,9693
4542,科嶠,12,0,12,富邦-新營,2024-03-25,9693
2206,三陽工業,12,0,12,富邦-新營,2024-03-25,9693
1612,宏泰,17,6,11,富邦-新營,2024-03-25,9693
4960,誠美材,11,0,11,富邦-新營,2024-03-25,9693
5498,凱崴,11,0,11,富邦-新營,2024-03-25,9693
2330,台積電,21,10,11,富邦-新營,2024-03-25,9693
6191,精成科,10,0,10,富邦-新營,2024-03-25,9693
00706L,期元大S＆P日圓正2,10,0,10,富邦-新營,2024-03-25,9693
1905,華紙,10,0,10,富邦-新營,2024-03-25,9693
2027,大成鋼,10,0,10,富邦-新營,2024-03-25,9693
2888,新光金,20,10,10,富邦-新營,2024-03-25,9693
4931,新盛力,10,0,10,富邦-新營,2024-03-25,9693
2002,中鋼,9,0,9,富邦-新營,2024-03-25,9693
5009,榮剛,11,2,9,富邦-新營,2024-03-25,9693
5302,太欣,9,0,9,富邦-新營,2024-03-25,9693
3264,欣銓,10,1,9,富邦-新營,2024-03-25,9693
3704,合勤控,10,1,9,富邦-新營,2024-03-25,9693
3481,群創,17,8,9,富邦-新營,2024-03-25,9693
00892,富邦台灣半導體,8,0,8,富邦-新營,2024-03-25,9693
1909,榮成,20,12,8,富邦-新營,2024-03-25,9693
2009,第一銅,8,0,8,富邦-新營,2024-03-25,9693
2208,台船,10,2,8,富邦-新營,2024-03-25,9693
2359,所羅門,179,41,138,富邦-新營,2024-03-26,9693
00939,統一台灣高息動能,183,50,133,富邦-新營,2024-03-26,9693
00937B,群益ESG投等債20,106,5,101,富邦-新營,2024-03-26,9693
6274,台燿,66,9,57,富邦-新營,2024-03-26,9693
1616,億泰,54,0,54,富邦-新營,2024-03-26,9693
00929,復華台灣科技優息,261,207,54,富邦-新營,2024-03-26,9693
00632R,元大台灣50反1,50,0,50,富邦-新營,2024-03-26,9693
9105,泰金寶-DR,50,5,45,富邦-新營,2024-03-26,9693
6139,亞翔,102,58,44,富邦-新營,2024-03-26,9693
00941,中信上游半導體,128,94,34,富邦-新營,2024-03-26,9693
00751B,元大AAA至A公司債,27,0,27,富邦-新營,2024-03-26,9693
2303,聯電,32,5,27,富邦-新營,2024-03-26,9693
2332,友訊,26,0,26,富邦-新營,2024-03-26,9693
2417,圓剛,83,61,22,富邦-新營,2024-03-26,9693
2610,華航,18,0,18,富邦-新營,2024-03-26,9693
6125,廣運,31,13,18,富邦-新營,2024-03-26,9693
2208,台船,17,0,17,富邦-新營,2024-03-26,9693
4995,晶達,17,0,17,富邦-新營,2024-03-26,9693
3231,緯創,43,27,16,富邦-新營,2024-03-26,9693
5498,凱崴,15,0,15,富邦-新營,2024-03-26,9693
3027,盛達,12,0,12,富邦-新營,2024-03-26,9693
3228,金麗科,12,0,12,富邦-新營,2024-03-26,9693
3704,合勤控,11,0,11,富邦-新營,2024-03-26,9693
2025,千興,11,0,11,富邦-新營,2024-03-26,9693
2369,菱生,11,0,11,富邦-新營,2024-03-26,9693
2464,盟立,12,1,11,富邦-新營,2024-03-26,9693
2888,新光金,14,3,11,富邦-新營,2024-03-26,9693
3046,建��,11,0,11,富邦-新營,2024-03-26,9693
5351,鈺創,15,4,11,富邦-新營,2024-03-26,9693
1439,雋揚,10,0,10,富邦-新營,2024-03-26,9693
1617,榮星,10,0,10,富邦-新營,2024-03-26,9693
1718,中纖,10,0,10,富邦-新營,2024-03-26,9693
3163,波若威,12,2,10,富邦-新營,2024-03-26,9693
6284,佳邦,10,0,10,富邦-新營,2024-03-26,9693
8926,台汽電,12,2,10,富邦-新營,2024-03-26,9693
2313,華通,21,11,10,富邦-新營,2024-03-26,9693
1612,宏泰,150,141,9,富邦-新營,2024-03-26,9693
8936,國統,15,6,9,富邦-新營,2024-03-26,9693
00679B,元大美債20年,9,1,8,富邦-新營,2024-03-26,9693
3481,群創,12,4,8,富邦-新營,2024-03-26,9693
2402,毅嘉,9,1,8,富邦-新營,2024-03-26,9693
3037,欣興,16,8,8,富邦-新營,2024-03-26,9693
1513,中興電,20,13,7,富邦-新營,2024-03-26,9693
4979,華星光,10,3,7,富邦-新營,2024-03-26,9693
2344,華邦電,18,11,7,富邦-新營,2024-03-26,9693
3071,協禧,7,0,7,富邦-新營,2024-03-26,9693
3325,旭品,10,3,7,富邦-新營,2024-03-26,9693
3622,洋華,8,1,7,富邦-新營,2024-03-26,9693
8059,凱碩,8,1,7,富邦-新營,2024-03-26,9693
3702,大聯大,7,0,7,富邦-新營,2024-03-26,9693
2603,長榮,152,5,147,富邦-新營,2024-03-27,9693
00937B,群益ESG投等債20,95,10,85,富邦-新營,2024-03-27,9693
3706,神達,324,259,65,富邦-新營,2024-03-27,9693
2834,臺企銀,67,6,61,富邦-新營,2024-03-27,9693
00753L,中信中國50正2,50,0,50,富邦-新營,2024-03-27,9693
00665L,富邦�琤肭磪囓�2,50,0,50,富邦-新營,2024-03-27,9693
2409,友達,42,2,40,富邦-新營,2024-03-27,9693
00939,統一台灣高息動能,93,54,39,富邦-新營,2024-03-27,9693
00941,中信上游半導體,36,6,30,富邦-新營,2024-03-27,9693
2301,光寶科,28,0,28,富邦-新營,2024-03-27,9693
1786,科妍,27,0,27,富邦-新營,2024-03-27,9693
2371,大同,66,41,25,富邦-新營,2024-03-27,9693
4542,科嶠,25,0,25,富邦-新營,2024-03-27,9693
2312,金寶,20,0,20,富邦-新營,2024-03-27,9693
6505,台塑化,19,0,19,富邦-新營,2024-03-27,9693
1513,中興電,34,16,18,富邦-新營,2024-03-27,9693
00930,永豐ESG低碳高息,17,0,17,富邦-新營,2024-03-27,9693
2337,旺宏,18,1,17,富邦-新營,2024-03-27,9693
1301,台塑,16,0,16,富邦-新營,2024-03-27,9693
1616,億泰,21,5,16,富邦-新營,2024-03-27,9693
5603,陸海,15,0,15,富邦-新營,2024-03-27,9693
6207,雷科,15,0,15,富邦-新營,2024-03-27,9693
3481,群創,20,5,15,富邦-新營,2024-03-27,9693
5521,工信,15,1,14,富邦-新營,2024-03-27,9693
8234,新漢,13,0,13,富邦-新營,2024-03-27,9693
3211,順達,13,0,13,富邦-新營,2024-03-27,9693
006208,富邦台50,12,0,12,富邦-新營,2024-03-27,9693
00933B,國泰10Y+金融債,11,0,11,富邦-新營,2024-03-27,9693
1785,光洋科,51,40,11,富邦-新營,2024-03-27,9693
00923,群益台ESG低碳50,11,1,10,富邦-新營,2024-03-27,9693
00751B,元大AAA至A公司債,10,0,10,富邦-新營,2024-03-27,9693
1442,名軒,10,0,10,富邦-新營,2024-03-27,9693
1612,宏泰,18,8,10,富邦-新營,2024-03-27,9693
2367,燿華,26,16,10,富邦-新營,2024-03-27,9693
2483,百容,10,0,10,富邦-新營,2024-03-27,9693
2609,陽明,10,0,10,富邦-新營,2024-03-27,9693
2706,第一店,10,0,10,富邦-新營,2024-03-27,9693
5426,振發,14,4,10,富邦-新營,2024-03-27,9693
6209,今國光,10,0,10,富邦-新營,2024-03-27,9693
3231,緯創,24,14,10,富邦-新營,2024-03-27,9693
2002,中鋼,9,0,9,富邦-新營,2024-03-27,9693
2611,志信,14,5,9,富邦-新營,2024-03-27,9693
2630,亞航,11,2,9,富邦-新營,2024-03-27,9693
3163,波若威,11,2,9,富邦-新營,2024-03-27,9693
2303,聯電,11,2,9,富邦-新營,2024-03-27,9693
6770,力積電,10,2,8,富邦-新營,2024-03-27,9693
1808,潤隆,8,0,8,富邦-新營,2024-03-27,9693
00885,富邦越南,8,0,8,富邦-新營,2024-03-27,9693
00720B,元大投資級公司債,8,0,8,富邦-新營,2024-03-27,9693
00679B,元大美債20年,8,0,8,富邦-新營,2024-03-27,9693
3481,群創,96,1,95,富邦-新營,2024-03-28,9693
2888,新光金,89,0,89,富邦-新營,2024-03-28,9693
00937B,群益ESG投等債20,80,0,80,富邦-新營,2024-03-28,9693
00919,群益台灣精選高息,86,25,61,富邦-新營,2024-03-28,9693
2891,中信金,50,1,49,富邦-新營,2024-03-28,9693
6005,群益證,41,0,41,富邦-新營,2024-03-28,9693
2354,鴻準,252,214,38,富邦-新營,2024-03-28,9693
2883,凱基金,36,4,32,富邦-新營,2024-03-28,9693
2417,圓剛,41,11,30,富邦-新營,2024-03-28,9693
2371,大同,63,38,25,富邦-新營,2024-03-28,9693
4909,新復興,25,1,24,富邦-新營,2024-03-28,9693
2301,光寶科,24,1,23,富邦-新營,2024-03-28,9693
1316,上曜,26,4,22,富邦-新營,2024-03-28,9693
1616,億泰,22,0,22,富邦-新營,2024-03-28,9693
8033,雷虎,37,16,21,富邦-新營,2024-03-28,9693
3706,神達,32,12,20,富邦-新營,2024-03-28,9693
1536,和大,20,0,20,富邦-新營,2024-03-28,9693
3339,泰谷,20,1,19,富邦-新營,2024-03-28,9693
3324,雙鴻,21,3,18,富邦-新營,2024-03-28,9693
00939,統一台灣高息動能,44,26,18,富邦-新營,2024-03-28,9693
6191,精成科,16,0,16,富邦-新營,2024-03-28,9693
5425,台半,15,0,15,富邦-新營,2024-03-28,9693
1608,華榮,46,32,14,富邦-新營,2024-03-28,9693
2002,中鋼,16,2,14,富邦-新營,2024-03-28,9693
9105,泰金寶-DR,22,8,14,富邦-新營,2024-03-28,9693
3023,信邦,12,0,12,富邦-新營,2024-03-28,9693
1618,合機,12,0,12,富邦-新營,2024-03-28,9693
00878,國泰永續高股息,27,15,12,富邦-新營,2024-03-28,9693
00933B,國泰10Y+金融債,11,0,11,富邦-新營,2024-03-28,9693
5521,工信,11,0,11,富邦-新營,2024-03-28,9693
00892,富邦台灣半導體,11,0,11,富邦-新營,2024-03-28,9693
3005,神基,14,3,11,富邦-新營,2024-03-28,9693
2303,聯電,15,5,10,富邦-新營,2024-03-28,9693
00669R,國泰美國道瓊反1,10,0,10,富邦-新營,2024-03-28,9693
1773,勝一,12,2,10,富邦-新營,2024-03-28,9693
2358,廷鑫,10,0,10,富邦-新營,2024-03-28,9693
2883B,凱基金乙特,10,0,10,富邦-新營,2024-03-28,9693
4806,桂田文創,10,0,10,富邦-新營,2024-03-28,9693
6153,嘉聯益,10,0,10,富邦-新營,2024-03-28,9693
00941,中信上游半導體,9,0,9,富邦-新營,2024-03-28,9693
4755,三福化,9,0,9,富邦-新營,2024-03-28,9693
2314,台揚,12,4,8,富邦-新營,2024-03-28,9693
4162,智擎,10,2,8,富邦-新營,2024-03-28,9693
4768,晶呈科技,9,2,7,富邦-新營,2024-03-28,9693
6128,上福,7,0,7,富邦-新營,2024-03-28,9693
2356,英業達,17,11,6,富邦-新營,2024-03-28,9693
00927,群益半導體收益,6,0,6,富邦-新營,2024-03-28,9693
7402,邑錡,10,4,6,富邦-新營,2024-03-28,9693
1611,中電,6,0,6,富邦-新營,2024-03-28,9693
2457,飛宏,6,0,6,富邦-新營,2024-03-28,9693
6120,達運,150,0,150,富邦-新營,2024-03-29,9693
00939,統一台灣高息動能,159,12,147,富邦-新營,2024-03-29,9693
2317,鴻海,75,26,49,富邦-新營,2024-03-29,9693
2324,仁寶,31,5,26,富邦-新營,2024-03-29,9693
1503,士電,50,26,24,富邦-新營,2024-03-29,9693
3023,信邦,23,0,23,富邦-新營,2024-03-29,9693
2303,聯電,33,11,22,富邦-新營,2024-03-29,9693
5515,建國,29,7,22,富邦-新營,2024-03-29,9693
6514,芮特-KY,20,0,20,富邦-新營,2024-03-29,9693
6196,帆宣,19,0,19,富邦-新營,2024-03-29,9693
1524,耿鼎,20,2,18,富邦-新營,2024-03-29,9693
00929,復華台灣科技優息,17,1,16,富邦-新營,2024-03-29,9693
1815,富喬,39,23,16,富邦-新營,2024-03-29,9693
00919,群益台灣精選高息,23,8,15,富邦-新營,2024-03-29,9693
2332,友訊,15,1,14,富邦-新營,2024-03-29,9693
9105,泰金寶-DR,15,1,14,富邦-新營,2024-03-29,9693
2328,廣宇,16,3,13,富邦-新營,2024-03-29,9693
2337,旺宏,13,0,13,富邦-新營,2024-03-29,9693
2371,大同,42,29,13,富邦-新營,2024-03-29,9693
2409,友達,31,20,11,富邦-新營,2024-03-29,9693
3149,正達,11,0,11,富邦-新營,2024-03-29,9693
1451,年興,10,0,10,富邦-新營,2024-03-29,9693
2537,聯上發,10,0,10,富邦-新營,2024-03-29,9693
6191,精成科,8,0,8,富邦-新營,2024-03-29,9693
1440,南紡,8,0,8,富邦-新營,2024-03-29,9693
1603,華電,10,2,8,富邦-新營,2024-03-29,9693
3163,波若威,8,0,8,富邦-新營,2024-03-29,9693
2376,技嘉,18,10,8,富邦-新營,2024-03-29,9693
1718,中纖,7,0,7,富邦-新營,2024-03-29,9693
5523,豐謙,7,0,7,富邦-新營,2024-03-29,9693
1618,合機,7,1,6,富邦-新營,2024-03-29,9693
2329,華泰,9,3,6,富邦-新營,2024-03-29,9693
2388,威盛,7,1,6,富邦-新營,2024-03-29,9693
3062,建漢,12,6,6,富邦-新營,2024-03-29,9693
4714,永捷,6,0,6,富邦-新營,2024-03-29,9693
7402,邑錡,8,2,6,富邦-新營,2024-03-29,9693
3704,合勤控,5,0,5,富邦-新營,2024-03-29,9693
2354,鴻準,29,24,5,富邦-新營,2024-03-29,9693
1609,大亞,32,27,5,富邦-新營,2024-03-29,9693
00915,凱基優選高股息30,5,0,5,富邦-新營,2024-03-29,9693
00713,元大台灣高息低波,5,0,5,富邦-新營,2024-03-29,9693
00706L,期元大S＆P日圓正2,5,0,5,富邦-新營,2024-03-29,9693
00674R,期元大S＆P黃金反1,5,0,5,富邦-新營,2024-03-29,9693
1439,雋揚,5,0,5,富邦-新營,2024-03-29,9693
2331,精英,20,15,5,富邦-新營,2024-03-29,9693
2369,菱生,5,0,5,富邦-新營,2024-03-29,9693
2492,華新科,10,5,5,富邦-新營,2024-03-29,9693
4104,佳醫,5,0,5,富邦-新營,2024-03-29,9693
5388,中磊,6,1,5,富邦-新營,2024-03-29,9693
6163,華電網,5,0,5,富邦-新營,2024-03-29,9693
00940,元大台灣價值高息,864,240,624,富邦-新營,2024-04-01,9693
00937B,群益ESG投等債20,385,35,350,富邦-新營,2024-04-01,9693
2887,台新金,310,1,309,富邦-新營,2024-04-01,9693
6213,聯茂,195,14,181,富邦-新營,2024-04-01,9693
3481,群創,38,0,38,富邦-新營,2024-04-01,9693
00919,群益台灣精選高息,40,3,37,富邦-新營,2024-04-01,9693
2371,大同,36,9,27,富邦-新營,2024-04-01,9693
00751B,元大AAA至A公司債,25,0,25,富邦-新營,2024-04-01,9693
2834,臺企銀,37,15,22,富邦-新營,2024-04-01,9693
2382,廣達,27,8,19,富邦-新營,2024-04-01,9693
2354,鴻準,22,3,19,富邦-新營,2024-04-01,9693
00665L,富邦�琤肭磪囓�2,20,2,18,富邦-新營,2024-04-01,9693
00857B,永豐20年美公債,18,0,18,富邦-新營,2024-04-01,9693
00929,復華台灣科技優息,18,0,18,富邦-新營,2024-04-01,9693
3228,金麗科,17,0,17,富邦-新營,2024-04-01,9693
00687B,國泰20年美債,16,1,15,富邦-新營,2024-04-01,9693
5351,鈺創,17,2,15,富邦-新營,2024-04-01,9693
1609,大亞,19,7,12,富邦-新營,2024-04-01,9693
2303,聯電,12,1,11,富邦-新營,2024-04-01,9693
2891,中信金,11,0,11,富邦-新營,2024-04-01,9693
1440,南紡,21,10,11,富邦-新營,2024-04-01,9693
3168,眾福科,11,0,11,富邦-新營,2024-04-01,9693
6116,彩晶,20,9,11,富邦-新營,2024-04-01,9693
2486,一詮,17,7,10,富邦-新營,2024-04-01,9693
00640L,富邦日本正2,10,0,10,富邦-新營,2024-04-01,9693
1712,興農,10,0,10,富邦-新營,2024-04-01,9693
2323,中環,10,0,10,富邦-新營,2024-04-01,9693
2451,創見,10,0,10,富邦-新營,2024-04-01,9693
2412,中華電,10,0,10,富邦-新營,2024-04-01,9693
3023,信邦,9,0,9,富邦-新營,2024-04-01,9693
2880,華南金,9,0,9,富邦-新營,2024-04-01,9693
6173,信昌電,10,1,9,富邦-新營,2024-04-01,9693
2301,光寶科,9,1,8,富邦-新營,2024-04-01,9693
3036,文曄,9,1,8,富邦-新營,2024-04-01,9693
8358,金居,16,8,8,富邦-新營,2024-04-01,9693
2317,鴻海,19,11,8,富邦-新營,2024-04-01,9693
0056,元大高股息,8,1,7,富邦-新營,2024-04-01,9693
1216,統一,7,0,7,富邦-新營,2024-04-01,9693
1582,信錦,7,0,7,富邦-新營,2024-04-01,9693
2485,兆赫,7,0,7,富邦-新營,2024-04-01,9693
3014,聯陽,7,0,7,富邦-新營,2024-04-01,9693
00753L,中信中國50正2,6,0,6,富邦-新營,2024-04-01,9693
1603,華電,7,1,6,富邦-新營,2024-04-01,9693
1785,光洋科,6,0,6,富邦-新營,2024-04-01,9693
2025,千興,6,0,6,富邦-新營,2024-04-01,9693
6170,統振,6,0,6,富邦-新營,2024-04-01,9693
1304,台聚,6,0,6,富邦-新營,2024-04-01,9693
2344,華邦電,10,5,5,富邦-新營,2024-04-01,9693
1439,雋揚,5,0,5,富邦-新營,2024-04-01,9693
2013,中鋼構,5,0,5,富邦-新營,2024-04-01,9693
00937B,群益ESG投等債20,169,0,169,富邦-新營,2024-04-02,9693
00680L,元大美債20正2,104,0,104,富邦-新營,2024-04-02,9693
00688L,國泰20年美債正2,102,0,102,富邦-新營,2024-04-02,9693
2887,台新金,91,0,91,富邦-新營,2024-04-02,9693
2317,鴻海,218,156,62,富邦-新營,2024-04-02,9693
00940,元大台灣價值高息,240,179,61,富邦-新營,2024-04-02,9693
8110,華東,60,0,60,富邦-新營,2024-04-02,9693
00679B,元大美債20年,43,0,43,富邦-新營,2024-04-02,9693
00929,復華台灣科技優息,52,11,41,富邦-新營,2024-04-02,9693
00720B,元大投資級公司債,39,0,39,富邦-新營,2024-04-02,9693
2382,廣達,102,66,36,富邦-新營,2024-04-02,9693
00941,中信上游半導體,46,22,24,富邦-新營,2024-04-02,9693
2002,中鋼,30,6,24,富邦-新營,2024-04-02,9693
2356,英業達,32,10,22,富邦-新營,2024-04-02,9693
2409,友達,32,10,22,富邦-新營,2024-04-02,9693
00687B,國泰20年美債,21,0,21,富邦-新營,2024-04-02,9693
2344,華邦電,22,2,20,富邦-新營,2024-04-02,9693
2331,精英,20,0,20,富邦-新營,2024-04-02,9693
2301,光寶科,23,3,20,富邦-新營,2024-04-02,9693
1326,台化,15,0,15,富邦-新營,2024-04-02,9693
2009,第一銅,38,24,14,富邦-新營,2024-04-02,9693
00933B,國泰10Y+金融債,13,0,13,富邦-新營,2024-04-02,9693
5381,合正,12,0,12,富邦-新營,2024-04-02,9693
2634,漢翔,13,1,12,富邦-新營,2024-04-02,9693
00632R,元大台灣50反1,11,0,11,富邦-新營,2024-04-02,9693
3231,緯創,21,11,10,富邦-新營,2024-04-02,9693
5880,合庫金,10,0,10,富邦-新營,2024-04-02,9693
6285,啟��,10,0,10,富邦-新營,2024-04-02,9693
1439,雋揚,10,0,10,富邦-新營,2024-04-02,9693
2883B,凱基金乙特,10,0,10,富邦-新營,2024-04-02,9693
3062,建漢,10,0,10,富邦-新營,2024-04-02,9693
5386,青雲,11,1,10,富邦-新營,2024-04-02,9693
6578,達邦蛋白,10,0,10,富邦-新營,2024-04-02,9693
8074,鉅橡,10,0,10,富邦-新營,2024-04-02,9693
8182,加高,10,0,10,富邦-新營,2024-04-02,9693
910322,康師傅-DR,10,0,10,富邦-新營,2024-04-02,9693
1416,廣豐,10,1,9,富邦-新營,2024-04-02,9693
6189,豐藝,12,3,9,富邦-新營,2024-04-02,9693
8926,台汽電,15,6,9,富邦-新營,2024-04-02,9693
2888,新光金,8,0,8,富邦-新營,2024-04-02,9693
6179,亞通,9,1,8,富邦-新營,2024-04-02,9693
6207,雷科,11,3,8,富邦-新營,2024-04-02,9693
2812,台中銀,7,0,7,富邦-新營,2024-04-02,9693
2913,農林,7,0,7,富邦-新營,2024-04-02,9693
3622,洋華,11,4,7,富邦-新營,2024-04-02,9693
2206,三陽工業,6,0,6,富邦-新營,2024-04-02,9693
1605,華新,8,2,6,富邦-新營,2024-04-02,9693
1584,精剛,6,0,6,富邦-新營,2024-04-02,9693
1718,中纖,6,0,6,富邦-新營,2024-04-02,9693
1907,永豐餘,6,0,6,富邦-新營,2024-04-02,9693
00940,元大台灣價值高息,410,108,302,富邦-新營,2024-04-03,9693
00688L,國泰20年美債正2,191,0,191,富邦-新營,2024-04-03,9693
00929,復華台灣科技優息,152,6,146,富邦-新營,2024-04-03,9693
2358,廷鑫,130,0,130,富邦-新營,2024-04-03,9693
00937B,群益ESG投等債20,127,0,127,富邦-新營,2024-04-03,9693
00919,群益台灣精選高息,127,18,109,富邦-新營,2024-04-03,9693
00679B,元大美債20年,89,0,89,富邦-新營,2024-04-03,9693
6120,達運,105,19,86,富邦-新營,2024-04-03,9693
2382,廣達,96,10,86,富邦-新營,2024-04-03,9693
2515,中工,72,17,55,富邦-新營,2024-04-03,9693
00680L,元大美債20正2,43,0,43,富邦-新營,2024-04-03,9693
8110,華東,45,5,40,富邦-新營,2024-04-03,9693
00687B,國泰20年美債,38,0,38,富邦-新營,2024-04-03,9693
2409,友達,35,0,35,富邦-新營,2024-04-03,9693
3481,群創,52,21,31,富邦-新營,2024-04-03,9693
00665L,富邦�琤肭磪囓�2,80,50,30,富邦-新營,2024-04-03,9693
3706,神達,30,7,23,富邦-新營,2024-04-03,9693
9933,中鼎,22,0,22,富邦-新營,2024-04-03,9693
2030,彰源,21,0,21,富邦-新營,2024-04-03,9693
1907,永豐餘,20,0,20,富邦-新營,2024-04-03,9693
2596,綠意,20,0,20,富邦-新營,2024-04-03,9693
2332,友訊,19,0,19,富邦-新營,2024-04-03,9693
2537,聯上發,20,1,19,富邦-新營,2024-04-03,9693
2009,第一銅,26,8,18,富邦-新營,2024-04-03,9693
00941,中信上游半導體,17,0,17,富邦-新營,2024-04-03,9693
4207,環泰,15,0,15,富邦-新營,2024-04-03,9693
6261,久元,15,0,15,富邦-新營,2024-04-03,9693
2006,東和鋼鐵,22,8,14,富邦-新營,2024-04-03,9693
2408,南亞科,18,4,14,富邦-新營,2024-04-03,9693
5386,青雲,22,10,12,富邦-新營,2024-04-03,9693
1612,宏泰,10,0,10,富邦-新營,2024-04-03,9693
1712,興農,10,0,10,富邦-新營,2024-04-03,9693
3105,穩懋,10,0,10,富邦-新營,2024-04-03,9693
3207,耀勝,10,0,10,富邦-新營,2024-04-03,9693
5302,太欣,10,0,10,富邦-新營,2024-04-03,9693
6126,信音,10,0,10,富邦-新營,2024-04-03,9693
2892,第一金,10,0,10,富邦-新營,2024-04-03,9693
1785,光洋科,9,0,9,富邦-新營,2024-04-03,9693
8215,明基材,11,2,9,富邦-新營,2024-04-03,9693
00712,復華富時不動產,8,0,8,富邦-新營,2024-04-03,9693
1316,上曜,8,0,8,富邦-新營,2024-04-03,9693
2002,中鋼,18,11,7,富邦-新營,2024-04-03,9693
00696B,富邦美債20年,7,0,7,富邦-新營,2024-04-03,9693
00720B,元大投資級公司債,7,0,7,富邦-新營,2024-04-03,9693
2208,台船,8,1,7,富邦-新營,2024-04-03,9693
3046,建��,7,0,7,富邦-新營,2024-04-03,9693
5515,建國,20,13,7,富邦-新營,2024-04-03,9693
6901,鑽石投資,7,0,7,富邦-新營,2024-04-03,9693
8059,凱碩,7,0,7,富邦-新營,2024-04-03,9693
3010,華立,7,0,7,富邦-新營,2024-04-03,9693
00937B,群益ESG投等債20,191,10,181,富邦-新營,2024-04-08,9693
3231,緯創,168,27,141,富邦-新營,2024-04-08,9693
6120,達運,132,38,94,富邦-新營,2024-04-08,9693
00940,元大台灣價值高息,127,40,87,富邦-新營,2024-04-08,9693
6213,聯茂,61,1,60,富邦-新營,2024-04-08,9693
2374,佳能,114,56,58,富邦-新營,2024-04-08,9693
00919,群益台灣精選高息,61,8,53,富邦-新營,2024-04-08,9693
00929,復華台灣科技優息,54,2,52,富邦-新營,2024-04-08,9693
00679B,元大美債20年,34,0,34,富邦-新營,2024-04-08,9693
2380,虹光,32,0,32,富邦-新營,2024-04-08,9693
6550,北極星藥業-KY,30,0,30,富邦-新營,2024-04-08,9693
00687B,國泰20年美債,36,6,30,富邦-新營,2024-04-08,9693
2356,英業達,37,9,28,富邦-新營,2024-04-08,9693
1101,台泥,25,1,24,富邦-新營,2024-04-08,9693
00933B,國泰10Y+金融債,32,10,22,富邦-新營,2024-04-08,9693
00885,富邦越南,21,1,20,富邦-新營,2024-04-08,9693
00753L,中信中國50正2,20,0,20,富邦-新營,2024-04-08,9693
2025,千興,20,0,20,富邦-新營,2024-04-08,9693
2038,海光,20,0,20,富邦-新營,2024-04-08,9693
2501,國建,20,0,20,富邦-新營,2024-04-08,9693
1612,宏泰,22,7,15,富邦-新營,2024-04-08,9693
9105,泰金寶-DR,15,0,15,富邦-新營,2024-04-08,9693
6207,雷科,27,12,15,富邦-新營,2024-04-08,9693
1460,宏遠,15,1,14,富邦-新營,2024-04-08,9693
00941,中信上游半導體,14,1,13,富邦-新營,2024-04-08,9693
00892,富邦台灣半導體,15,3,12,富邦-新營,2024-04-08,9693
2338,光罩,12,0,12,富邦-新營,2024-04-08,9693
3005,神基,14,2,12,富邦-新營,2024-04-08,9693
8064,東捷,12,1,11,富邦-新營,2024-04-08,9693
00795B,中信美國公債20年,11,0,11,富邦-新營,2024-04-08,9693
2610,華航,12,1,11,富邦-新營,2024-04-08,9693
2324,仁寶,11,0,11,富邦-新營,2024-04-08,9693
2354,鴻準,17,7,10,富邦-新營,2024-04-08,9693
00712,復華富時不動產,11,1,10,富邦-新營,2024-04-08,9693
2492,華新科,11,2,9,富邦-新營,2024-04-08,9693
6770,力積電,9,0,9,富邦-新營,2024-04-08,9693
2323,中環,9,0,9,富邦-新營,2024-04-08,9693
3031,佰鴻,9,0,9,富邦-新營,2024-04-08,9693
4109,加捷生醫,12,3,9,富邦-新營,2024-04-08,9693
6488,環球晶,12,4,8,富邦-新營,2024-04-08,9693
2489,瑞軒,8,0,8,富邦-新營,2024-04-08,9693
3049,精金,8,0,8,富邦-新營,2024-04-08,9693
1815,富喬,10,2,8,富邦-新營,2024-04-08,9693
2883,凱基金,10,2,8,富邦-新營,2024-04-08,9693
00923,群益台ESG低碳50,7,0,7,富邦-新營,2024-04-08,9693
1587,吉茂,7,0,7,富邦-新營,2024-04-08,9693
3380,明泰,7,0,7,富邦-新營,2024-04-08,9693
6142,友勁,7,0,7,富邦-新營,2024-04-08,9693
2542,興富發,8,1,7,富邦-新營,2024-04-08,9693
3017,奇鋐,8,2,6,富邦-新營,2024-04-08,9693
2515,中工,423,34,389,富邦-新營,2024-04-09,9693
2464,盟立,340,122,218,富邦-新營,2024-04-09,9693
00929,復華台灣科技優息,70,1,69,富邦-新營,2024-04-09,9693
2882,國泰金,73,4,69,富邦-新營,2024-04-09,9693
2002,中鋼,83,40,43,富邦-新營,2024-04-09,9693
2501,國建,43,0,43,富邦-新營,2024-04-09,9693
4533,協易機,33,3,30,富邦-新營,2024-04-09,9693
2025,千興,27,0,27,富邦-新營,2024-04-09,9693
00632R,元大台灣50反1,26,0,26,富邦-新營,2024-04-09,9693
6189,豐藝,29,5,24,富邦-新營,2024-04-09,9693
00885,富邦越南,23,0,23,富邦-新營,2024-04-09,9693
00941,中信上游半導體,33,11,22,富邦-新營,2024-04-09,9693
00939,統一台灣高息動能,29,7,22,富邦-新營,2024-04-09,9693
6285,啟��,20,0,20,富邦-新營,2024-04-09,9693
2440,太空梭,19,0,19,富邦-新營,2024-04-09,9693
4303,信立,21,2,19,富邦-新營,2024-04-09,9693
1618,合機,25,7,18,富邦-新營,2024-04-09,9693
00679B,元大美債20年,25,10,15,富邦-新營,2024-04-09,9693
3013,晟銘電,156,141,15,富邦-新營,2024-04-09,9693
6163,華電網,15,0,15,富邦-新營,2024-04-09,9693
1101,台泥,16,2,14,富邦-新營,2024-04-09,9693
8112,至上,19,6,13,富邦-新營,2024-04-09,9693
6432,今展科,13,0,13,富邦-新營,2024-04-09,9693
2023,燁輝,13,2,11,富邦-新營,2024-04-09,9693
2332,友訊,12,1,11,富邦-新營,2024-04-09,9693
2537,聯上發,41,30,11,富邦-新營,2024-04-09,9693
1503,士電,10,0,10,富邦-新營,2024-04-09,9693
2010,春源,10,0,10,富邦-新營,2024-04-09,9693
3306,鼎天,11,1,10,富邦-新營,2024-04-09,9693
4402,郡都開發,10,0,10,富邦-新營,2024-04-09,9693
6514,芮特-KY,10,0,10,富邦-新營,2024-04-09,9693
1789,神隆,10,0,10,富邦-新營,2024-04-09,9693
2344,華邦電,17,8,9,富邦-新營,2024-04-09,9693
6288,聯嘉,9,0,9,富邦-新營,2024-04-09,9693
2303,聯電,15,6,9,富邦-新營,2024-04-09,9693
5347,世界,9,0,9,富邦-新營,2024-04-09,9693
2337,旺宏,17,8,9,富邦-新營,2024-04-09,9693
3260,威剛,12,3,9,富邦-新營,2024-04-09,9693
2313,華通,16,7,9,富邦-新營,2024-04-09,9693
1504,東元,10,2,8,富邦-新營,2024-04-09,9693
2365,昆盈,11,3,8,富邦-新營,2024-04-09,9693
2618,長榮航,10,2,8,富邦-新營,2024-04-09,9693
2892,第一金,8,0,8,富邦-新營,2024-04-09,9693
3014,聯陽,8,0,8,富邦-新營,2024-04-09,9693
6233,旺玖,8,0,8,富邦-新營,2024-04-09,9693
00919,群益台灣精選高息,11,3,8,富邦-新營,2024-04-09,9693
2449,京元電子,8,1,7,富邦-新營,2024-04-09,9693
2301,光寶科,7,0,7,富邦-新營,2024-04-09,9693
1733,五鼎,7,0,7,富邦-新營,2024-04-09,9693
2338,光罩,7,0,7,富邦-新營,2024-04-09,9693
8110,華東,101,0,101,富邦-新營,2024-04-10,9693
3013,晟銘電,205,108,97,富邦-新營,2024-04-10,9693
6177,達麗,63,5,58,富邦-新營,2024-04-10,9693
2542,興富發,38,0,38,富邦-新營,2024-04-10,9693
8033,雷虎,37,1,36,富邦-新營,2024-04-10,9693
2025,千興,54,22,32,富邦-新營,2024-04-10,9693
1608,華榮,47,20,27,富邦-新營,2024-04-10,9693
1618,合機,42,15,27,富邦-新營,2024-04-10,9693
00940,元大台灣價值高息,97,71,26,富邦-新營,2024-04-10,9693
6770,力積電,29,3,26,富邦-新營,2024-04-10,9693
2382,廣達,25,0,25,富邦-新營,2024-04-10,9693
00857B,永豐20年美公債,24,0,24,富邦-新營,2024-04-10,9693
2208,台船,47,25,22,富邦-新營,2024-04-10,9693
3706,神達,27,5,22,富邦-新營,2024-04-10,9693
2610,華航,21,0,21,富邦-新營,2024-04-10,9693
6016,康和證,21,0,21,富邦-新營,2024-04-10,9693
1616,億泰,20,0,20,富邦-新營,2024-04-10,9693
5351,鈺創,21,2,19,富邦-新營,2024-04-10,9693
4533,協易機,44,25,19,富邦-新營,2024-04-10,9693
2618,長榮航,20,2,18,富邦-新營,2024-04-10,9693
4168,醣聯,17,0,17,富邦-新營,2024-04-10,9693
1503,士電,23,6,17,富邦-新營,2024-04-10,9693
3049,精金,16,0,16,富邦-新營,2024-04-10,9693
3481,群創,18,4,14,富邦-新營,2024-04-10,9693
2313,華通,22,9,13,富邦-新營,2024-04-10,9693
5009,榮剛,27,15,12,富邦-新營,2024-04-10,9693
2537,聯上發,12,0,12,富邦-新營,2024-04-10,9693
3324,雙鴻,20,10,10,富邦-新營,2024-04-10,9693
1810,和成,11,1,10,富邦-新營,2024-04-10,9693
2365,昆盈,13,3,10,富邦-新營,2024-04-10,9693
2337,旺宏,15,6,9,富邦-新營,2024-04-10,9693
2634,漢翔,21,12,9,富邦-新營,2024-04-10,9693
3666,光耀,9,0,9,富邦-新營,2024-04-10,9693
6197,佳必琪,11,2,9,富邦-新營,2024-04-10,9693
2882,國泰金,8,0,8,富邦-新營,2024-04-10,9693
00919,群益台灣精選高息,11,2,9,富邦-新營,2024-04-10,9693
6207,雷科,10,2,8,富邦-新營,2024-04-10,9693
3710,連展投控,10,2,8,富邦-新營,2024-04-10,9693
2027,大成鋼,12,4,8,富邦-新營,2024-04-10,9693
1605,華新,32,24,8,富邦-新營,2024-04-10,9693
1513,中興電,27,20,7,富邦-新營,2024-04-10,9693
2376,技嘉,11,4,7,富邦-新營,2024-04-10,9693
4909,新復興,7,0,7,富邦-新營,2024-04-10,9693
3576,聯合再生,7,0,7,富邦-新營,2024-04-10,9693
5519,隆大,6,0,6,富邦-新營,2024-04-10,9693
2383,台光電,6,0,6,富邦-新營,2024-04-10,9693
2301,光寶科,7,1,6,富邦-新營,2024-04-10,9693
1326,台化,6,0,6,富邦-新營,2024-04-10,9693
2014,中鴻,14,8,6,富邦-新營,2024-04-10,9693
4967,十銓,13,7,6,富邦-新營,2024-04-10,9693
3481,群創,295,17,278,富邦-新營,2024-04-11,9693
00680L,元大美債20正2,133,1,132,富邦-新營,2024-04-11,9693
00688L,國泰20年美債正2,104,0,104,富邦-新營,2024-04-11,9693
3013,晟銘電,109,23,86,富邦-新營,2024-04-11,9693
2913,農林,72,0,72,富邦-新營,2024-04-11,9693
00632R,元大台灣50反1,70,4,66,富邦-新營,2024-04-11,9693
00679B,元大美債20年,63,0,63,富邦-新營,2024-04-11,9693
6016,康和證,52,0,52,富邦-新營,2024-04-11,9693
00665L,富邦�琤肭磪囓�2,80,30,50,富邦-新營,2024-04-11,9693
4306,炎洲,50,0,50,富邦-新營,2024-04-11,9693
00687B,國泰20年美債,68,19,49,富邦-新營,2024-04-11,9693
2610,華航,62,16,46,富邦-新營,2024-04-11,9693
00937B,群益ESG投等債20,83,46,37,富邦-新營,2024-04-11,9693
1514,亞力,57,22,35,富邦-新營,2024-04-11,9693
00933B,國泰10Y+金融債,31,0,31,富邦-新營,2024-04-11,9693
00712,復華富時不動產,33,2,31,富邦-新營,2024-04-11,9693
00664R,國泰臺灣加權反1,30,0,30,富邦-新營,2024-04-11,9693
00929,復華台灣科技優息,31,4,27,富邦-新營,2024-04-11,9693
2382,廣達,28,4,24,富邦-新營,2024-04-11,9693
3231,緯創,28,7,21,富邦-新營,2024-04-11,9693
00753L,中信中國50正2,20,0,20,富邦-新營,2024-04-11,9693
6248,沛波,20,0,20,富邦-新營,2024-04-11,9693
2464,盟立,28,9,19,富邦-新營,2024-04-11,9693
00637L,元大滬深300正2,20,1,19,富邦-新營,2024-04-11,9693
2332,友訊,19,0,19,富邦-新營,2024-04-11,9693
0056,元大高股息,17,0,17,富邦-新營,2024-04-11,9693
2371,大同,42,25,17,富邦-新營,2024-04-11,9693
2317,鴻海,63,47,16,富邦-新營,2024-04-11,9693
2630,亞航,21,5,16,富邦-新營,2024-04-11,9693
8488,吉源-KY,15,0,15,富邦-新營,2024-04-11,9693
3260,威剛,20,6,14,富邦-新營,2024-04-11,9693
1718,中纖,13,0,13,富邦-新營,2024-04-11,9693
4109,加捷生醫,15,2,13,富邦-新營,2024-04-11,9693
2002,中鋼,20,7,13,富邦-新營,2024-04-11,9693
00751B,元大AAA至A公司債,12,0,12,富邦-新營,2024-04-11,9693
00922,國泰台灣領袖50,12,0,12,富邦-新營,2024-04-11,9693
00878,國泰永續高股息,12,1,11,富邦-新營,2024-04-11,9693
3324,雙鴻,16,5,11,富邦-新營,2024-04-11,9693
1618,合機,11,0,11,富邦-新營,2024-04-11,9693
2501,國建,18,7,11,富邦-新營,2024-04-11,9693
1789,神隆,10,0,10,富邦-新營,2024-04-11,9693
3712,永崴投控,10,0,10,富邦-新營,2024-04-11,9693
6164,華興,10,0,10,富邦-新營,2024-04-11,9693
6264,富裔,10,0,10,富邦-新營,2024-04-11,9693
6461,益得,10,0,10,富邦-新營,2024-04-11,9693
3206,志豐,9,0,9,富邦-新營,2024-04-11,9693
4909,新復興,9,0,9,富邦-新營,2024-04-11,9693
5381,合正,17,8,9,富邦-新營,2024-04-11,9693
2812,台中銀,9,0,9,富邦-新營,2024-04-11,9693
2405,輔信,8,0,8,富邦-新營,2024-04-11,9693
00940,元大台灣價值高息,197,32,165,富邦-新營,2024-04-12,9693
4306,炎洲,52,0,52,富邦-新營,2024-04-12,9693
2888,新光金,57,9,48,富邦-新營,2024-04-12,9693
00937B,群益ESG投等債20,58,10,48,富邦-新營,2024-04-12,9693
2380,虹光,42,0,42,富邦-新營,2024-04-12,9693
00687B,國泰20年美債,46,5,41,富邦-新營,2024-04-12,9693
6026,福邦證,41,2,39,富邦-新營,2024-04-12,9693
00679B,元大美債20年,37,0,37,富邦-新營,2024-04-12,9693
2363,矽統,170,134,36,富邦-新營,2024-04-12,9693
00929,復華台灣科技優息,39,3,36,富邦-新營,2024-04-12,9693
2501,國建,40,6,34,富邦-新營,2024-04-12,9693
6120,達運,31,0,31,富邦-新營,2024-04-12,9693
2382,廣達,33,2,31,富邦-新營,2024-04-12,9693
00665L,富邦�琤肭磪囓�2,30,0,30,富邦-新營,2024-04-12,9693
00941,中信上游半導體,31,2,29,富邦-新營,2024-04-12,9693
2367,燿華,53,25,28,富邦-新營,2024-04-12,9693
2241,艾姆勒,28,0,28,富邦-新營,2024-04-12,9693
00680L,元大美債20正2,24,0,24,富邦-新營,2024-04-12,9693
3481,群創,32,11,21,富邦-新營,2024-04-12,9693
2610,華航,24,4,20,富邦-新營,2024-04-12,9693
1101,台泥,20,0,20,富邦-新營,2024-04-12,9693
1314,中石化,30,10,20,富邦-新營,2024-04-12,9693
6197,佳必琪,60,41,19,富邦-新營,2024-04-12,9693
2353,宏��,40,21,19,富邦-新營,2024-04-12,9693
2409,友達,19,1,18,富邦-新營,2024-04-12,9693
2609,陽明,19,4,15,富邦-新營,2024-04-12,9693
00751B,元大AAA至A公司債,13,0,13,富邦-新營,2024-04-12,9693
1608,華榮,110,97,13,富邦-新營,2024-04-12,9693
4995,晶達,13,0,13,富邦-新營,2024-04-12,9693
2308,台達電,13,1,12,富邦-新營,2024-04-12,9693
00927,群益半導體收益,12,0,12,富邦-新營,2024-04-12,9693
2892,第一金,12,0,12,富邦-新營,2024-04-12,9693
2002,中鋼,22,10,12,富邦-新營,2024-04-12,9693
00933B,國泰10Y+金融債,13,1,12,富邦-新營,2024-04-12,9693
4526,東台,12,1,11,富邦-新營,2024-04-12,9693
1305,華夏,10,0,10,富邦-新營,2024-04-12,9693
2520,冠德,10,0,10,富邦-新營,2024-04-12,9693
2630,亞航,10,0,10,富邦-新營,2024-04-12,9693
3023,信邦,10,0,10,富邦-新營,2024-04-12,9693
3712,永崴投控,14,4,10,富邦-新營,2024-04-12,9693
3680,家登,12,2,10,富邦-新營,2024-04-12,9693
2408,南亞科,35,26,9,富邦-新營,2024-04-12,9693
3260,威剛,24,15,9,富邦-新營,2024-04-12,9693
1522,堤維西,10,1,9,富邦-新營,2024-04-12,9693
5351,鈺創,12,3,9,富邦-新營,2024-04-12,9693
2881,富邦金,8,0,8,富邦-新營,2024-04-12,9693
2329,華泰,17,9,8,富邦-新營,2024-04-12,9693
2736,富野,9,1,8,富邦-新營,2024-04-12,9693
2743,山富,11,3,8,富邦-新營,2024-04-12,9693
8088,品安,10,2,8,富邦-新營,2024-04-12,9693
00937B,群益ESG投等債20,590,58,532,富邦-新營,2024-04-15,9693
00929,復華台灣科技優息,181,8,173,富邦-新營,2024-04-15,9693
00940,元大台灣價值高息,132,6,126,富邦-新營,2024-04-15,9693
3260,威剛,113,9,104,富邦-新營,2024-04-15,9693
1608,華榮,118,17,101,富邦-新營,2024-04-15,9693
00753L,中信中國50正2,65,0,65,富邦-新營,2024-04-15,9693
2888,新光金,66,2,64,富邦-新營,2024-04-15,9693
00919,群益台灣精選高息,62,7,55,富邦-新營,2024-04-15,9693
2371,大同,236,183,53,富邦-新營,2024-04-15,9693
2883,凱基金,53,2,51,富邦-新營,2024-04-15,9693
00679B,元大美債20年,46,0,46,富邦-新營,2024-04-15,9693
1504,東元,54,10,44,富邦-新營,2024-04-15,9693
00878,國泰永續高股息,48,4,44,富邦-新營,2024-04-15,9693
00665L,富邦�琤肭磪囓�2,90,50,40,富邦-新營,2024-04-15,9693
0056,元大高股息,35,1,34,富邦-新營,2024-04-15,9693
00712,復華富時不動產,42,9,33,富邦-新營,2024-04-15,9693
00933B,國泰10Y+金融債,30,0,30,富邦-新營,2024-04-15,9693
3017,奇鋐,51,22,29,富邦-新營,2024-04-15,9693
4513,福裕,26,0,26,富邦-新營,2024-04-15,9693
1605,華新,52,27,25,富邦-新營,2024-04-15,9693
3231,緯創,29,4,25,富邦-新營,2024-04-15,9693
00632R,元大台灣50反1,50,27,23,富邦-新營,2024-04-15,9693
00939,統一台灣高息動能,34,13,21,富邦-新營,2024-04-15,9693
2002,中鋼,28,7,21,富邦-新營,2024-04-15,9693
2344,華邦電,20,0,20,富邦-新營,2024-04-15,9693
2408,南亞科,21,1,20,富邦-新營,2024-04-15,9693
6120,達運,19,0,19,富邦-新營,2024-04-15,9693
2367,燿華,25,7,18,富邦-新營,2024-04-15,9693
2356,英業達,27,9,18,富邦-新營,2024-04-15,9693
1513,中興電,32,16,16,富邦-新營,2024-04-15,9693
2317,鴻海,24,9,15,富邦-新營,2024-04-15,9693
6589,台康生技,14,0,14,富邦-新營,2024-04-15,9693
5324,士開,12,0,12,富邦-新營,2024-04-15,9693
2409,友達,11,0,11,富邦-新營,2024-04-15,9693
2303,聯電,15,4,11,富邦-新營,2024-04-15,9693
6446,藥華藥,13,2,11,富邦-新營,2024-04-15,9693
3622,洋華,16,5,11,富邦-新營,2024-04-15,9693
8436,大江,11,0,11,富邦-新營,2024-04-15,9693
2009,第一銅,18,7,11,富邦-新營,2024-04-15,9693
6129,普誠,10,0,10,富邦-新營,2024-04-15,9693
2337,旺宏,10,0,10,富邦-新營,2024-04-15,9693
5426,振發,12,2,10,富邦-新營,2024-04-15,9693
2332,友訊,9,0,9,富邦-新營,2024-04-15,9693
3312,弘憶股,33,24,9,富邦-新營,2024-04-15,9693
00881,國泰台灣5G+,7,0,7,富邦-新營,2024-04-15,9693
2454,聯發科,7,0,7,富邦-新營,2024-04-15,9693
2355,敬鵬,7,0,7,富邦-新營,2024-04-15,9693
2610,華航,7,0,7,富邦-新營,2024-04-15,9693
6235,華孚,7,0,7,富邦-新營,2024-04-15,9693
5347,世界,10,3,7,富邦-新營,2024-04-15,9693
00940,元大台灣價值高息,386,7,379,富邦-新營,2024-04-16,9693
00929,復華台灣科技優息,259,37,222,富邦-新營,2024-04-16,9693
2363,矽統,304,115,189,富邦-新營,2024-04-16,9693
00665L,富邦�琤肭磪囓�2,170,0,170,富邦-新營,2024-04-16,9693
00939,統一台灣高息動能,160,3,157,富邦-新營,2024-04-16,9693
00919,群益台灣精選高息,213,130,83,富邦-新營,2024-04-16,9693
2344,華邦電,94,27,67,富邦-新營,2024-04-16,9693
00878,國泰永續高股息,75,8,67,富邦-新營,2024-04-16,9693
3481,群創,64,3,61,富邦-新營,2024-04-16,9693
0056,元大高股息,63,5,58,富邦-新營,2024-04-16,9693
2883,凱基金,69,13,56,富邦-新營,2024-04-16,9693
2371,大同,128,74,54,富邦-新營,2024-04-16,9693
1609,大亞,118,68,50,富邦-新營,2024-04-16,9693
00753L,中信中國50正2,50,0,50,富邦-新營,2024-04-16,9693
00937B,群益ESG投等債20,136,87,49,富邦-新營,2024-04-16,9693
2913,農林,50,2,48,富邦-新營,2024-04-16,9693
2834,臺企銀,47,1,46,富邦-新營,2024-04-16,9693
00763U,期街口道瓊銅,42,0,42,富邦-新營,2024-04-16,9693
2867,三商壽,55,14,41,富邦-新營,2024-04-16,9693
1616,億泰,40,0,40,富邦-新營,2024-04-16,9693
3390,旭軟,42,2,40,富邦-新營,2024-04-16,9693
2317,鴻海,53,15,38,富邦-新營,2024-04-16,9693
4960,誠美材,44,6,38,富邦-新營,2024-04-16,9693
3231,緯創,50,14,36,富邦-新營,2024-04-16,9693
00679B,元大美債20年,38,2,36,富邦-新營,2024-04-16,9693
2897,王道銀行,36,0,36,富邦-新營,2024-04-16,9693
2353,宏��,37,1,36,富邦-新營,2024-04-16,9693
2892,第一金,35,0,35,富邦-新營,2024-04-16,9693
4306,炎洲,32,0,32,富邦-新營,2024-04-16,9693
3372,典範,31,0,31,富邦-新營,2024-04-16,9693
2303,聯電,34,4,30,富邦-新營,2024-04-16,9693
00941,中信上游半導體,30,2,28,富邦-新營,2024-04-16,9693
2356,英業達,34,7,27,富邦-新營,2024-04-16,9693
2618,長榮航,38,11,27,富邦-新營,2024-04-16,9693
2330,台積電,28,3,25,富邦-新營,2024-04-16,9693
00715L,期街口布蘭特正2,30,5,25,富邦-新營,2024-04-16,9693
00687B,國泰20年美債,25,1,24,富邦-新營,2024-04-16,9693
4513,福裕,26,2,24,富邦-新營,2024-04-16,9693
2421,建準,21,0,21,富邦-新營,2024-04-16,9693
00885,富邦越南,51,30,21,富邦-新營,2024-04-16,9693
1608,華榮,42,21,21,富邦-新營,2024-04-16,9693
1802,台玻,31,10,21,富邦-新營,2024-04-16,9693
2915,潤泰全,20,0,20,富邦-新營,2024-04-16,9693
4142,國光生,20,1,19,富邦-新營,2024-04-16,9693
00918,大華優利高填息30,18,0,18,富邦-新營,2024-04-16,9693
2002,中鋼,25,7,18,富邦-新營,2024-04-16,9693
2440,太空梭,18,0,18,富邦-新營,2024-04-16,9693
2382,廣達,22,5,17,富邦-新營,2024-04-16,9693
2889,國票金,17,0,17,富邦-新營,2024-04-16,9693
5371,中光電,31,14,17,富邦-新營,2024-04-16,9693
00937B,群益ESG投等債20,126,4,122,富邦-新營,2024-04-17,9693
00929,復華台灣科技優息,103,3,100,富邦-新營,2024-04-17,9693
00665L,富邦�琤肭磪囓�2,70,0,70,富邦-新營,2024-04-17,9693
00940,元大台灣價值高息,95,31,64,富邦-新營,2024-04-17,9693
1514,亞力,76,24,52,富邦-新營,2024-04-17,9693
2514,龍邦,51,5,46,富邦-新營,2024-04-17,9693
0056,元大高股息,42,5,37,富邦-新營,2024-04-17,9693
00878,國泰永續高股息,39,3,36,富邦-新營,2024-04-17,9693
2380,虹光,33,0,33,富邦-新營,2024-04-17,9693
00933B,國泰10Y+金融債,32,0,32,富邦-新營,2024-04-17,9693
00720B,元大投資級公司債,31,0,31,富邦-新營,2024-04-17,9693
2353,宏��,35,5,30,富邦-新營,2024-04-17,9693
00637L,元大滬深300正2,30,0,30,富邦-新營,2024-04-17,9693
2630,亞航,41,17,24,富邦-新營,2024-04-17,9693
2889,國票金,23,0,23,富邦-新營,2024-04-17,9693
2417,圓剛,21,0,21,富邦-新營,2024-04-17,9693
00927,群益半導體收益,20,0,20,富邦-新營,2024-04-17,9693
00715L,期街口布蘭特正2,20,0,20,富邦-新營,2024-04-17,9693
2501,國建,22,2,20,富邦-新營,2024-04-17,9693
2601,益航,22,2,20,富邦-新營,2024-04-17,9693
6541,泰福-KY,20,0,20,富邦-新營,2024-04-17,9693
00679B,元大美債20年,28,10,18,富邦-新營,2024-04-17,9693
2355,敬鵬,20,2,18,富邦-新營,2024-04-17,9693
00941,中信上游半導體,17,0,17,富邦-新營,2024-04-17,9693
3231,緯創,40,23,17,富邦-新營,2024-04-17,9693
3031,佰鴻,16,0,16,富邦-新營,2024-04-17,9693
4533,協易機,17,1,16,富邦-新營,2024-04-17,9693
2367,燿華,23,7,16,富邦-新營,2024-04-17,9693
00680L,元大美債20正2,27,12,15,富邦-新營,2024-04-17,9693
2537,聯上發,15,0,15,富邦-新營,2024-04-17,9693
1718,中纖,14,0,14,富邦-新營,2024-04-17,9693
3481,群創,25,12,13,富邦-新營,2024-04-17,9693
2317,鴻海,27,14,13,富邦-新營,2024-04-17,9693
2344,華邦電,28,15,13,富邦-新營,2024-04-17,9693
5351,鈺創,14,1,13,富邦-新營,2024-04-17,9693
2002,中鋼,12,0,12,富邦-新營,2024-04-17,9693
5371,中光電,13,1,12,富邦-新營,2024-04-17,9693
6288,聯嘉,12,0,12,富邦-新營,2024-04-17,9693
8064,東捷,15,3,12,富邦-新營,2024-04-17,9693
2303,聯電,15,4,11,富邦-新營,2024-04-17,9693
2408,南亞科,14,3,11,富邦-新營,2024-04-17,9693
1617,榮星,13,2,11,富邦-新營,2024-04-17,9693
5356,協益,11,0,11,富邦-新營,2024-04-17,9693
6244,茂迪,11,1,10,富邦-新營,2024-04-17,9693
00688L,國泰20年美債正2,10,0,10,富邦-新營,2024-04-17,9693
00905,FT臺灣Smart,10,0,10,富邦-新營,2024-04-17,9693
1313,聯成,10,0,10,富邦-新營,2024-04-17,9693
1570,力肯,10,0,10,富邦-新營,2024-04-17,9693
2883B,凱基金乙特,10,0,10,富邦-新營,2024-04-17,9693
3490,單井,16,6,10,富邦-新營,2024-04-17,9693
00940,元大台灣價值高息,77,2,75,富邦-新營,2024-04-18,9693
5512,力麒,72,0,72,富邦-新營,2024-04-18,9693
00929,復華台灣科技優息,78,23,55,富邦-新營,2024-04-18,9693
00632R,元大台灣50反1,50,0,50,富邦-新營,2024-04-18,9693
4960,誠美材,50,1,49,富邦-新營,2024-04-18,9693
00941,中信上游半導體,42,0,42,富邦-新營,2024-04-18,9693
0056,元大高股息,37,1,36,富邦-新營,2024-04-18,9693
2832,台產,35,0,35,富邦-新營,2024-04-18,9693
2371,大同,189,154,35,富邦-新營,2024-04-18,9693
6207,雷科,40,8,32,富邦-新營,2024-04-18,9693
2374,佳能,77,46,31,富邦-新營,2024-04-18,9693
8033,雷虎,33,3,30,富邦-新營,2024-04-18,9693
00903,富邦元宇宙,30,0,30,富邦-新營,2024-04-18,9693
1314,中石化,30,6,24,富邦-新營,2024-04-18,9693
00919,群益台灣精選高息,24,0,24,富邦-新營,2024-04-18,9693
00933B,國泰10Y+金融債,20,0,20,富邦-新營,2024-04-18,9693
2630,亞航,53,33,20,富邦-新營,2024-04-18,9693
1605,華新,87,67,20,富邦-新營,2024-04-18,9693
3441,聯一光,19,0,19,富邦-新營,2024-04-18,9693
2303,聯電,17,0,17,富邦-新營,2024-04-18,9693
2417,圓剛,16,0,16,富邦-新營,2024-04-18,9693
2515,中工,37,23,14,富邦-新營,2024-04-18,9693
4142,國光生,13,0,13,富邦-新營,2024-04-18,9693
00939,統一台灣高息動能,13,1,12,富邦-新營,2024-04-18,9693
3260,威剛,12,0,12,富邦-新營,2024-04-18,9693
5251,天鉞電,16,4,12,富邦-新營,2024-04-18,9693
2542,興富發,16,4,12,富邦-新營,2024-04-18,9693
6153,嘉聯益,11,0,11,富邦-新營,2024-04-18,9693
1301,台塑,10,0,10,富邦-新營,2024-04-18,9693
3324,雙鴻,19,9,10,富邦-新營,2024-04-18,9693
00885,富邦越南,10,0,10,富邦-新營,2024-04-18,9693
00680L,元大美債20正2,10,0,10,富邦-新營,2024-04-18,9693
1517,利奇,10,0,10,富邦-新營,2024-04-18,9693
3047,訊舟,10,0,10,富邦-新營,2024-04-18,9693
3296,勝德,10,0,10,富邦-新營,2024-04-18,9693
6264,富裔,10,0,10,富邦-新營,2024-04-18,9693
9103,美德醫療-DR,10,0,10,富邦-新營,2024-04-18,9693
00655L,國泰中國A50正2,10,0,10,富邦-新營,2024-04-18,9693
2610,華航,10,0,10,富邦-新營,2024-04-18,9693
3707,漢磊,18,10,8,富邦-新營,2024-04-18,9693
3005,神基,10,2,8,富邦-新營,2024-04-18,9693
6163,華電網,8,0,8,富邦-新營,2024-04-18,9693
1504,東元,36,29,7,富邦-新營,2024-04-18,9693
00687B,國泰20年美債,8,1,7,富邦-新營,2024-04-18,9693
2025,千興,7,0,7,富邦-新營,2024-04-18,9693
2457,飛宏,9,2,7,富邦-新營,2024-04-18,9693
4402,郡都開發,7,0,7,富邦-新營,2024-04-18,9693
1417,嘉裕,6,0,6,富邦-新營,2024-04-18,9693
6664,群翊,6,0,6,富邦-新營,2024-04-18,9693
1101,台泥,5,0,5,富邦-新營,2024-04-18,9693
00940,元大台灣價值高息,410,25,385,富邦-新營,2024-04-19,9693
00929,復華台灣科技優息,304,95,209,富邦-新營,2024-04-19,9693
00665L,富邦�琤肭磪囓�2,150,0,150,富邦-新營,2024-04-19,9693
2883B,凱基金乙特,70,0,70,富邦-新營,2024-04-19,9693
3322,建舜電,65,0,65,富邦-新營,2024-04-19,9693
4960,誠美材,65,0,65,富邦-新營,2024-04-19,9693
00878,國泰永續高股息,65,1,64,富邦-新營,2024-04-19,9693
2515,中工,100,39,61,富邦-新營,2024-04-19,9693
5347,世界,65,6,59,富邦-新營,2024-04-19,9693
2409,友達,56,1,55,富邦-新營,2024-04-19,9693
2303,聯電,61,5,56,富邦-新營,2024-04-19,9693
00941,中信上游半導體,47,0,47,富邦-新營,2024-04-19,9693
00939,統一台灣高息動能,75,28,47,富邦-新營,2024-04-19,9693
1605,華新,82,36,46,富邦-新營,2024-04-19,9693
2330,台積電,53,10,43,富邦-新營,2024-04-19,9693
1609,大亞,198,155,43,富邦-新營,2024-04-19,9693
2892,第一金,39,0,39,富邦-新營,2024-04-19,9693
3260,威剛,49,10,39,富邦-新營,2024-04-19,9693
1611,中電,38,0,38,富邦-新營,2024-04-19,9693
2002,中鋼,45,9,36,富邦-新營,2024-04-19,9693
0056,元大高股息,49,14,35,富邦-新營,2024-04-19,9693
2888,新光金,34,0,34,富邦-新營,2024-04-19,9693
00918,大華優利高填息30,34,0,34,富邦-新營,2024-04-19,9693
00905,FT臺灣Smart,33,0,33,富邦-新營,2024-04-19,9693
2101,南港,30,2,28,富邦-新營,2024-04-19,9693
00900,富邦特選高股息30,25,0,25,富邦-新營,2024-04-19,9693
6116,彩晶,28,4,24,富邦-新營,2024-04-19,9693
1532,勤美,23,0,23,富邦-新營,2024-04-19,9693
2801,彰銀,38,15,23,富邦-新營,2024-04-19,9693
2610,華航,22,0,22,富邦-新營,2024-04-19,9693
2363,矽統,34,13,21,富邦-新營,2024-04-19,9693
2641,正德,21,0,21,富邦-新營,2024-04-19,9693
2832,台產,20,0,20,富邦-新營,2024-04-19,9693
3312,弘憶股,28,8,20,富邦-新營,2024-04-19,9693
6155,鈞寶,20,0,20,富邦-新營,2024-04-19,9693
6443,元晶,22,2,20,富邦-新營,2024-04-19,9693
3481,群創,47,27,20,富邦-新營,2024-04-19,9693
2337,旺宏,24,5,19,富邦-新營,2024-04-19,9693
006208,富邦台50,19,1,18,富邦-新營,2024-04-19,9693
00888,永豐台灣ESG,18,0,18,富邦-新營,2024-04-19,9693
2867,三商壽,18,1,17,富邦-新營,2024-04-19,9693
2881,富邦金,17,1,16,富邦-新營,2024-04-19,9693
3324,雙鴻,34,18,16,富邦-新營,2024-04-19,9693
2353,宏��,19,4,15,富邦-新營,2024-04-19,9693
3706,神達,15,0,15,富邦-新營,2024-04-19,9693
8215,明基材,15,0,15,富邦-新營,2024-04-19,9693
00830,國泰費城半導體,14,0,14,富邦-新營,2024-04-19,9693
2618,長榮航,15,1,14,富邦-新營,2024-04-19,9693
5351,鈺創,21,8,13,富邦-新營,2024-04-19,9693
8926,台汽電,22,9,13,富邦-新營,2024-04-19,9693
00940,元大台灣價值高息,234,9,225,富邦-新營,2024-04-22,9693
00929,復華台灣科技優息,204,70,134,富邦-新營,2024-04-22,9693
00632R,元大台灣50反1,100,0,100,富邦-新營,2024-04-22,9693
00939,統一台灣高息動能,80,3,77,富邦-新營,2024-04-22,9693
2371,大同,231,157,74,富邦-新營,2024-04-22,9693
1608,華榮,216,143,73,富邦-新營,2024-04-22,9693
2913,農林,93,30,63,富邦-新營,2024-04-22,9693
2610,華航,54,3,51,富邦-新營,2024-04-22,9693
2515,中工,490,441,49,富邦-新營,2024-04-22,9693
00937B,群益ESG投等債20,50,6,44,富邦-新營,2024-04-22,9693
1616,億泰,42,2,40,富邦-新營,2024-04-22,9693
00919,群益台灣精選高息,71,33,38,富邦-新營,2024-04-22,9693
00679B,元大美債20年,26,0,26,富邦-新營,2024-04-22,9693
3481,群創,65,38,27,富邦-新營,2024-04-22,9693
2303,聯電,34,8,26,富邦-新營,2024-04-22,9693
2101,南港,28,4,24,富邦-新營,2024-04-22,9693
3231,緯創,30,10,20,富邦-新營,2024-04-22,9693
3710,連展投控,20,0,20,富邦-新營,2024-04-22,9693
00878,國泰永續高股息,26,7,19,富邦-新營,2024-04-22,9693
2027,大成鋼,21,3,18,富邦-新營,2024-04-22,9693
1603,華電,21,6,15,富邦-新營,2024-04-22,9693
0056,元大高股息,14,0,14,富邦-新營,2024-04-22,9693
1513,中興電,21,7,14,富邦-新營,2024-04-22,9693
3266,昇陽,14,0,14,富邦-新營,2024-04-22,9693
6125,廣運,25,11,14,富邦-新營,2024-04-22,9693
8415,大國鋼,14,0,14,富邦-新營,2024-04-22,9693
00896,中信綠能及電動車,12,0,12,富邦-新營,2024-04-22,9693
2442,新美齊,12,0,12,富邦-新營,2024-04-22,9693
2611,志信,23,11,12,富邦-新營,2024-04-22,9693
3205,佰研,12,0,12,富邦-新營,2024-04-22,9693
5381,合正,26,14,12,富邦-新營,2024-04-22,9693
2542,興富發,17,5,12,富邦-新營,2024-04-22,9693
5531,鄉林,16,5,11,富邦-新營,2024-04-22,9693
00772B,中信高評級公司債,10,0,10,富邦-新營,2024-04-22,9693
00680L,元大美債20正2,10,0,10,富邦-新營,2024-04-22,9693
2010,春源,10,0,10,富邦-新營,2024-04-22,9693
3025,星通,10,0,10,富邦-新營,2024-04-22,9693
6179,亞通,10,0,10,富邦-新營,2024-04-22,9693
6226,光鼎,10,0,10,富邦-新營,2024-04-22,9693
8215,明基材,15,5,10,富邦-新營,2024-04-22,9693
1612,宏泰,15,6,9,富邦-新營,2024-04-22,9693
5508,永信建,12,3,9,富邦-新營,2024-04-22,9693
6770,力積電,10,1,9,富邦-新營,2024-04-22,9693
2330,台積電,9,1,8,富邦-新營,2024-04-22,9693
2409,友達,8,0,8,富邦-新營,2024-04-22,9693
2634,漢翔,19,11,8,富邦-新營,2024-04-22,9693
2449,京元電子,8,0,8,富邦-新營,2024-04-22,9693
00688L,國泰20年美債正2,8,0,8,富邦-新營,2024-04-22,9693
00830,國泰費城半導體,8,0,8,富邦-新營,2024-04-22,9693
3094,聯傑,8,0,8,富邦-新營,2024-04-22,9693
00929,復華台灣科技優息,284,41,243,富邦-新營,2024-04-23,9693
00940,元大台灣價值高息,173,2,171,富邦-新營,2024-04-23,9693
00676R,富邦臺灣加權反1,90,0,90,富邦-新營,2024-04-23,9693
00939,統一台灣高息動能,71,1,70,富邦-新營,2024-04-23,9693
8011,台通,70,18,52,富邦-新營,2024-04-23,9693
4960,誠美材,40,0,40,富邦-新營,2024-04-23,9693
3033,威健,35,0,35,富邦-新營,2024-04-23,9693
4167,松瑞藥,34,0,34,富邦-新營,2024-04-23,9693
2303,聯電,30,0,30,富邦-新營,2024-04-23,9693
2492,華新科,20,0,20,富邦-新營,2024-04-23,9693
1104,環泥,16,1,15,富邦-新營,2024-04-23,9693
2017,官田鋼,15,0,15,富邦-新營,2024-04-23,9693
2344,華邦電,20,6,14,富邦-新營,2024-04-23,9693
2547,日勝生,18,4,14,富邦-新營,2024-04-23,9693
5351,鈺創,14,1,13,富邦-新營,2024-04-23,9693
2371,大同,110,98,12,富邦-新營,2024-04-23,9693
3715,定穎投控,10,0,10,富邦-新營,2024-04-23,9693
2208,台船,10,0,10,富邦-新營,2024-04-23,9693
3322,建舜電,10,0,10,富邦-新營,2024-04-23,9693
4909,新復興,47,37,10,富邦-新營,2024-04-23,9693
5251,天鉞電,10,0,10,富邦-新營,2024-04-23,9693
6449,鈺邦,10,0,10,富邦-新營,2024-04-23,9693
1101,台泥,9,0,9,富邦-新營,2024-04-23,9693
2607,榮運,10,1,9,富邦-新營,2024-04-23,9693
3260,威剛,9,0,9,富邦-新營,2024-04-23,9693
00878,國泰永續高股息,9,1,8,富邦-新營,2024-04-23,9693
4979,華星光,8,0,8,富邦-新營,2024-04-23,9693
3708,上緯投控,13,5,8,富邦-新營,2024-04-23,9693
1314,中石化,10,2,8,富邦-新營,2024-04-23,9693
1618,合機,12,5,7,富邦-新營,2024-04-23,9693
2505,國揚,7,0,7,富邦-新營,2024-04-23,9693
00918,大華優利高填息30,7,0,7,富邦-新營,2024-04-23,9693
3024,憶聲,6,0,6,富邦-新營,2024-04-23,9693
5521,工信,8,2,6,富邦-新營,2024-04-23,9693
6264,富裔,6,0,6,富邦-新營,2024-04-23,9693
1108,幸福,5,0,5,富邦-新營,2024-04-23,9693
1504,東元,40,35,5,富邦-新營,2024-04-23,9693
2484,希華,5,0,5,富邦-新營,2024-04-23,9693
2867,三商壽,5,0,5,富邦-新營,2024-04-23,9693
3062,建漢,5,0,5,富邦-新營,2024-04-23,9693
3680,家登,6,1,5,富邦-新營,2024-04-23,9693
5523,豐謙,5,0,5,富邦-新營,2024-04-23,9693
2354,鴻準,11,6,5,富邦-新營,2024-04-23,9693
6005,群益證,10,6,4,富邦-新營,2024-04-23,9693
00933B,國泰10Y+金融債,4,0,4,富邦-新營,2024-04-23,9693
2301,光寶科,6,2,4,富邦-新營,2024-04-23,9693
6806,森崴能源,4,0,4,富邦-新營,2024-04-23,9693
00881,國泰台灣5G+,4,0,4,富邦-新營,2024-04-23,9693
00941,中信上游半導體,4,0,4,富邦-新營,2024-04-23,9693
2365,昆盈,4,0,4,富邦-新營,2024-04-23,9693
3481,群創,95,4,91,富邦-新營,2024-04-24,9693
1605,華新,54,2,52,富邦-新營,2024-04-24,9693
00929,復華台灣科技優息,50,3,47,富邦-新營,2024-04-24,9693
2409,友達,45,0,45,富邦-新營,2024-04-24,9693
00885,富邦越南,41,0,41,富邦-新營,2024-04-24,9693
4960,誠美材,40,0,40,富邦-新營,2024-04-24,9693
5498,凱崴,40,0,40,富邦-新營,2024-04-24,9693
00933B,國泰10Y+金融債,39,0,39,富邦-新營,2024-04-24,9693
00937B,群益ESG投等債20,37,1,36,富邦-新營,2024-04-24,9693
2630,亞航,33,0,33,富邦-新營,2024-04-24,9693
4562,穎漢,30,0,30,富邦-新營,2024-04-24,9693
1608,華榮,70,42,28,富邦-新營,2024-04-24,9693
00679B,元大美債20年,21,1,20,富邦-新營,2024-04-24,9693
2892,第一金,20,0,20,富邦-新營,2024-04-24,9693
5508,永信建,22,2,20,富邦-新營,2024-04-24,9693
00687B,國泰20年美債,19,0,19,富邦-新營,2024-04-24,9693
2812,台中銀,18,0,18,富邦-新營,2024-04-24,9693
2729,瓦城,17,0,17,富邦-新營,2024-04-24,9693
9938,百和,18,1,17,富邦-新營,2024-04-24,9693
00919,群益台灣精選高息,18,3,15,富邦-新營,2024-04-24,9693
00680L,元大美債20正2,15,0,15,富邦-新營,2024-04-24,9693
00877,復華中國5G,15,0,15,富邦-新營,2024-04-24,9693
3027,盛達,16,1,15,富邦-新營,2024-04-24,9693
1609,大亞,300,286,14,富邦-新營,2024-04-24,9693
8358,金居,14,1,13,富邦-新營,2024-04-24,9693
1616,億泰,15,3,12,富邦-新營,2024-04-24,9693
2489,瑞軒,12,0,12,富邦-新營,2024-04-24,9693
3049,精金,13,1,12,富邦-新營,2024-04-24,9693
3294,英濟,12,0,12,富邦-新營,2024-04-24,9693
2634,漢翔,13,1,12,富邦-新營,2024-04-24,9693
1442,名軒,11,1,10,富邦-新營,2024-04-24,9693
1455,集盛,10,0,10,富邦-新營,2024-04-24,9693
2337,旺宏,12,2,10,富邦-新營,2024-04-24,9693
2885,元大金,10,0,10,富邦-新營,2024-04-24,9693
2929,淘帝-KY,10,0,10,富邦-新營,2024-04-24,9693
4806,桂田文創,10,0,10,富邦-新營,2024-04-24,9693
3035,智原,13,4,9,富邦-新營,2024-04-24,9693
5348,正能量智能,9,0,9,富邦-新營,2024-04-24,9693
5432,新門,9,0,9,富邦-新營,2024-04-24,9693
00941,中信上游半導體,9,0,9,富邦-新營,2024-04-24,9693
1710,東聯,8,0,8,富邦-新營,2024-04-24,9693
6219,富旺,7,0,7,富邦-新營,2024-04-24,9693
3707,漢磊,6,0,6,富邦-新營,2024-04-24,9693
3231,緯創,37,31,6,富邦-新營,2024-04-24,9693
1603,華電,6,0,6,富邦-新營,2024-04-24,9693
5230,雷笛克光學,6,0,6,富邦-新營,2024-04-24,9693
6207,雷科,11,5,6,富邦-新營,2024-04-24,9693
2206,三陽工業,11,5,6,富邦-新營,2024-04-24,9693
00795B,中信美國公債20年,6,0,6,富邦-新營,2024-04-24,9693
2027,大成鋼,8,2,6,富邦-新營,2024-04-24,9693
2489,瑞軒,144,0,144,富邦-新營,2024-04-25,9693
2371,大同,227,97,130,富邦-新營,2024-04-25,9693
2363,矽統,311,213,98,富邦-新營,2024-04-25,9693
2405,輔信,50,0,50,富邦-新營,2024-04-25,9693
00687B,國泰20年美債,45,0,45,富邦-新營,2024-04-25,9693
2890,永豐金,42,2,40,富邦-新營,2024-04-25,9693
3481,群創,41,3,38,富邦-新營,2024-04-25,9693
1457,宜進,33,0,33,富邦-新營,2024-04-25,9693
00878,國泰永續高股息,32,0,32,富邦-新營,2024-04-25,9693
00929,復華台灣科技優息,39,9,30,富邦-新營,2024-04-25,9693
2892,第一金,27,0,27,富邦-新營,2024-04-25,9693
2380,虹光,27,0,27,富邦-新營,2024-04-25,9693
2867,三商壽,50,24,26,富邦-新營,2024-04-25,9693
2881,富邦金,25,0,25,富邦-新營,2024-04-25,9693
00933B,國泰10Y+金融債,23,0,23,富邦-新營,2024-04-25,9693
1504,東元,19,0,19,富邦-新營,2024-04-25,9693
00939,統一台灣高息動能,18,0,18,富邦-新營,2024-04-25,9693
1301,台塑,16,0,16,富邦-新營,2024-04-25,9693
2002,中鋼,15,0,15,富邦-新營,2024-04-25,9693
00919,群益台灣精選高息,20,5,15,富邦-新營,2024-04-25,9693
00679B,元大美債20年,15,0,15,富邦-新營,2024-04-25,9693
3013,晟銘電,27,13,14,富邦-新營,2024-04-25,9693
2330,台積電,12,1,11,富邦-新營,2024-04-25,9693
4966,譜瑞-KY,11,0,11,富邦-新營,2024-04-25,9693
2888,新光金,10,0,10,富邦-新營,2024-04-25,9693
2317,鴻海,23,13,10,富邦-新營,2024-04-25,9693
2539,櫻花建,9,0,9,富邦-新營,2024-04-25,9693
5251,天鉞電,12,3,9,富邦-新營,2024-04-25,9693
2464,盟立,11,2,9,富邦-新營,2024-04-25,9693
00877,復華中國5G,8,0,8,富邦-新營,2024-04-25,9693
2736,富野,8,0,8,富邦-新營,2024-04-25,9693
3231,緯創,10,3,7,富邦-新營,2024-04-25,9693
2344,華邦電,9,2,7,富邦-新營,2024-04-25,9693
2323,中環,12,5,7,富邦-新營,2024-04-25,9693
2506,太設,7,0,7,富邦-新營,2024-04-25,9693
2534,宏盛,7,0,7,富邦-新營,2024-04-25,9693
2382,廣達,10,4,6,富邦-新營,2024-04-25,9693
00882,中信中國高股息,9,3,6,富邦-新營,2024-04-25,9693
3704,合勤控,6,0,6,富邦-新營,2024-04-25,9693
4726,永昕,7,1,6,富邦-新營,2024-04-25,9693
5230,雷笛克光學,8,2,6,富邦-新營,2024-04-25,9693
6263,普萊德,6,0,6,富邦-新營,2024-04-25,9693
2368,金像電,5,0,5,富邦-新營,2024-04-25,9693
0056,元大高股息,5,0,5,富邦-新營,2024-04-25,9693
2412,中華電,5,0,5,富邦-新營,2024-04-25,9693
00930,永豐ESG低碳高息,5,0,5,富邦-新營,2024-04-25,9693
00935,野村臺灣新科技50,5,0,5,富邦-新營,2024-04-25,9693
00637L,元大滬深300正2,25,20,5,富邦-新營,2024-04-25,9693
2801,彰銀,5,0,5,富邦-新營,2024-04-25,9693
2834,臺企銀,5,0,5,富邦-新營,2024-04-25,9693
3363,上詮,258,110,148,富邦-新營,2024-04-26,9693
00650L,復華香港正2,150,5,145,富邦-新營,2024-04-26,9693
6215,和椿,81,6,75,富邦-新營,2024-04-26,9693
00897,富邦基因免疫生技,50,0,50,富邦-新營,2024-04-26,9693
3481,群創,60,17,43,富邦-新營,2024-04-26,9693
2511,太子,38,10,28,富邦-新營,2024-04-26,9693
00942B,台新美A公司債20+,20,0,20,富邦-新營,2024-04-26,9693
2009,第一銅,26,7,19,富邦-新營,2024-04-26,9693
00679B,元大美債20年,23,5,18,富邦-新營,2024-04-26,9693
00680L,元大美債20正2,17,0,17,富邦-新營,2024-04-26,9693
3372,典範,16,0,16,富邦-新營,2024-04-26,9693
2344,華邦電,17,2,15,富邦-新營,2024-04-26,9693
5905,南仁湖,15,0,15,富邦-新營,2024-04-26,9693
3260,威剛,18,4,14,富邦-新營,2024-04-26,9693
00878,國泰永續高股息,17,3,14,富邦-新營,2024-04-26,9693
2611,志信,24,12,12,富邦-新營,2024-04-26,9693
6244,茂迪,11,0,11,富邦-新營,2024-04-26,9693
00662,富邦NASDAQ,10,0,10,富邦-新營,2024-04-26,9693
1608,華榮,35,25,10,富邦-新營,2024-04-26,9693
2101,南港,24,14,10,富邦-新營,2024-04-26,9693
3025,星通,12,2,10,富邦-新營,2024-04-26,9693
4714,永捷,10,0,10,富邦-新營,2024-04-26,9693
4726,永昕,10,0,10,富邦-新營,2024-04-26,9693
9103,美德醫療-DR,10,0,10,富邦-新營,2024-04-26,9693
3017,奇鋐,19,10,9,富邦-新營,2024-04-26,9693
1440,南紡,111,102,9,富邦-新營,2024-04-26,9693
1605,華新,14,5,9,富邦-新營,2024-04-26,9693
3013,晟銘電,27,18,9,富邦-新營,2024-04-26,9693
6209,今國光,9,0,9,富邦-新營,2024-04-26,9693
2505,國揚,15,6,9,富邦-新營,2024-04-26,9693
2892,第一金,8,0,8,富邦-新營,2024-04-26,9693
6204,艾華,8,0,8,富邦-新營,2024-04-26,9693
2883,凱基金,7,0,7,富邦-新營,2024-04-26,9693
1513,中興電,10,4,6,富邦-新營,2024-04-26,9693
00632R,元大台灣50反1,6,0,6,富邦-新營,2024-04-26,9693
00857B,永豐20年美公債,6,0,6,富邦-新營,2024-04-26,9693
3016,嘉晶,6,0,6,富邦-新營,2024-04-26,9693
3027,盛達,6,0,6,富邦-新營,2024-04-26,9693
3441,聯一光,7,1,6,富邦-新營,2024-04-26,9693
6120,達運,7,1,6,富邦-新營,2024-04-26,9693
6282,康舒,5,0,5,富邦-新營,2024-04-26,9693
1402,遠東新,5,0,5,富邦-新營,2024-04-26,9693
00877,復華中國5G,5,0,5,富邦-新營,2024-04-26,9693
00795B,中信美國公債20年,5,0,5,富邦-新營,2024-04-26,9693
1304,台聚,5,0,5,富邦-新營,2024-04-26,9693
1319,東陽,5,0,5,富邦-新營,2024-04-26,9693
1725,元禎,5,0,5,富邦-新營,2024-04-26,9693
2329,華泰,5,0,5,富邦-新營,2024-04-26,9693
2376,技嘉,5,0,5,富邦-新營,2024-04-26,9693
2436,偉詮電,5,0,5,富邦-新營,2024-04-26,9693
2537,聯上發,534,233,301,富邦-新營,2024-04-29,9693
2501,國建,222,7,215,富邦-新營,2024-04-29,9693
1457,宜進,50,5,45,富邦-新營,2024-04-29,9693
2363,矽統,64,23,41,富邦-新營,2024-04-29,9693
2101,南港,44,16,28,富邦-新營,2024-04-29,9693
1815,富喬,28,1,27,富邦-新營,2024-04-29,9693
9945,潤泰新,26,0,26,富邦-新營,2024-04-29,9693
2417,圓剛,24,0,24,富邦-新營,2024-04-29,9693
2371,大同,53,30,23,富邦-新營,2024-04-29,9693
2515,中工,79,57,22,富邦-新營,2024-04-29,9693
4533,協易機,21,0,21,富邦-新營,2024-04-29,9693
00930,永豐ESG低碳高息,20,0,20,富邦-新營,2024-04-29,9693
1616,億泰,29,10,19,富邦-新營,2024-04-29,9693
2511,太子,29,10,19,富邦-新營,2024-04-29,9693
00706L,期元大S＆P日圓正2,18,0,18,富邦-新營,2024-04-29,9693
2323,中環,47,29,18,富邦-新營,2024-04-29,9693
3049,精金,14,0,14,富邦-新營,2024-04-29,9693
2504,國產,16,3,13,富邦-新營,2024-04-29,9693
2929,淘帝-KY,13,0,13,富邦-新營,2024-04-29,9693
2367,燿華,12,0,12,富邦-新營,2024-04-29,9693
2409,友達,31,19,12,富邦-新營,2024-04-29,9693
00680L,元大美債20正2,10,0,10,富邦-新營,2024-04-29,9693
2329,華泰,10,0,10,富邦-新營,2024-04-29,9693
3312,弘憶股,16,6,10,富邦-新營,2024-04-29,9693
5392,能率,10,0,10,富邦-新營,2024-04-29,9693
6449,鈺邦,10,0,10,富邦-新營,2024-04-29,9693
1714,和桐,10,1,9,富邦-新營,2024-04-29,9693
2017,官田鋼,10,1,9,富邦-新營,2024-04-29,9693
3013,晟銘電,12,3,9,富邦-新營,2024-04-29,9693
3024,憶聲,9,0,9,富邦-新營,2024-04-29,9693
4526,東台,9,0,9,富邦-新營,2024-04-29,9693
3324,雙鴻,14,6,8,富邦-新營,2024-04-29,9693
4806,桂田文創,8,0,8,富邦-新營,2024-04-29,9693
8110,華東,12,4,8,富邦-新營,2024-04-29,9693
00632R,元大台灣50反1,7,0,7,富邦-新營,2024-04-29,9693
1471,首利,7,0,7,富邦-新營,2024-04-29,9693
6244,茂迪,7,0,7,富邦-新營,2024-04-29,9693
2527,宏璟,7,0,7,富邦-新營,2024-04-29,9693
2449,京元電子,23,17,6,富邦-新營,2024-04-29,9693
3416,融程電,6,0,6,富邦-新營,2024-04-29,9693
3481,群創,14,8,6,富邦-新營,2024-04-29,9693
3704,合勤控,6,0,6,富邦-新營,2024-04-29,9693
6016,康和證,10,4,6,富邦-新營,2024-04-29,9693
00733,富邦臺灣中小,6,0,6,富邦-新營,2024-04-29,9693
2882,國泰金,22,16,6,富邦-新營,2024-04-29,9693
2617,台航,5,0,5,富邦-新營,2024-04-29,9693
00687B,國泰20年美債,5,0,5,富邦-新營,2024-04-29,9693
1587,吉茂,32,27,5,富邦-新營,2024-04-29,9693
1905,華紙,6,1,5,富邦-新營,2024-04-29,9693
2365,昆盈,5,0,5,富邦-新營,2024-04-29,9693
00637L,元大滬深300正2,200,0,200,富邦-新營,2024-04-30,9693
00892,富邦台灣半導體,55,0,55,富邦-新營,2024-04-30,9693
6230,尼得科超眾,153,107,46,富邦-新營,2024-04-30,9693
2884,玉山金,47,2,45,富邦-新營,2024-04-30,9693
3481,群創,82,40,42,富邦-新營,2024-04-30,9693
00919,群益台灣精選高息,32,1,31,富邦-新營,2024-04-30,9693
00665L,富邦�琤肭磪囓�2,50,20,30,富邦-新營,2024-04-30,9693
00940,元大台灣價值高息,42,14,28,富邦-新營,2024-04-30,9693
2609,陽明,33,6,27,富邦-新營,2024-04-30,9693
2892,第一金,20,0,20,富邦-新營,2024-04-30,9693
1905,華紙,20,0,20,富邦-新營,2024-04-30,9693
2888,新光金,18,0,18,富邦-新營,2024-04-30,9693
3441,聯一光,25,7,18,富邦-新營,2024-04-30,9693
1524,耿鼎,17,0,17,富邦-新營,2024-04-30,9693
2449,京元電子,17,0,17,富邦-新營,2024-04-30,9693
00939,統一台灣高息動能,16,0,16,富邦-新營,2024-04-30,9693
5531,鄉林,30,14,16,富邦-新營,2024-04-30,9693
1605,華新,15,0,15,富邦-新營,2024-04-30,9693
2317,鴻海,27,13,14,富邦-新營,2024-04-30,9693
1608,華榮,17,3,14,富邦-新營,2024-04-30,9693
2371,大同,70,56,14,富邦-新營,2024-04-30,9693
2009,第一銅,16,3,13,富邦-新營,2024-04-30,9693
2413,環科,11,0,11,富邦-新營,2024-04-30,9693
2630,亞航,11,1,10,富邦-新營,2024-04-30,9693
00934,中信成長高股息,10,0,10,富邦-新營,2024-04-30,9693
1789,神隆,10,0,10,富邦-新營,2024-04-30,9693
4533,協易機,12,2,10,富邦-新營,2024-04-30,9693
5381,合正,10,0,10,富邦-新營,2024-04-30,9693
2913,農林,12,3,9,富邦-新營,2024-04-30,9693
6125,廣運,18,9,9,富邦-新營,2024-04-30,9693
6282,康舒,11,2,9,富邦-新營,2024-04-30,9693
2323,中環,10,2,8,富邦-新營,2024-04-30,9693
3324,雙鴻,12,4,8,富邦-新營,2024-04-30,9693
00680L,元大美債20正2,7,0,7,富邦-新營,2024-04-30,9693
1618,合機,9,2,7,富邦-新營,2024-04-30,9693
2705,六福,7,0,7,富邦-新營,2024-04-30,9693
2208,台船,6,0,6,富邦-新營,2024-04-30,9693
2436,偉詮電,6,0,6,富邦-新營,2024-04-30,9693
3206,志豐,6,0,6,富邦-新營,2024-04-30,9693
8429,金麗-KY,6,0,6,富邦-新營,2024-04-30,9693
1103,嘉泥,5,0,5,富邦-新營,2024-04-30,9693
1714,和桐,5,0,5,富邦-新營,2024-04-30,9693
2312,金寶,5,0,5,富邦-新營,2024-04-30,9693
3033,威健,7,2,5,富邦-新營,2024-04-30,9693
3564,其陽,5,0,5,富邦-新營,2024-04-30,9693
3666,光耀,5,0,5,富邦-新營,2024-04-30,9693
4588,玖鼎電力,5,0,5,富邦-新營,2024-04-30,9693
4909,新復興,7,2,5,富邦-新營,2024-04-30,9693
5469,瀚宇博,5,0,5,富邦-新營,2024-04-30,9693
8096,擎亞,12,7,5,富邦-新營,2024-04-30,9693
2501,國建,134,48,86,富邦-新營,2024-05-02,9693
3024,憶聲,75,1,74,富邦-新營,2024-05-02,9693
00937B,群益ESG投等債20,65,1,64,富邦-新營,2024-05-02,9693
00940,元大台灣價值高息,42,1,41,富邦-新營,2024-05-02,9693
00878,國泰永續高股息,82,43,39,富邦-新營,2024-05-02,9693
2371,大同,69,32,37,富邦-新營,2024-05-02,9693
00929,復華台灣科技優息,50,15,35,富邦-新營,2024-05-02,9693
3481,群創,43,13,30,富邦-新營,2024-05-02,9693
3287,廣寰科,48,18,30,富邦-新營,2024-05-02,9693
8064,東捷,47,19,28,富邦-新營,2024-05-02,9693
00919,群益台灣精選高息,27,0,27,富邦-新營,2024-05-02,9693
6770,力積電,27,3,24,富邦-新營,2024-05-02,9693
2330,台積電,21,1,20,富邦-新營,2024-05-02,9693
2323,中環,31,12,19,富邦-新營,2024-05-02,9693
2889,國票金,26,8,18,富邦-新營,2024-05-02,9693
2409,友達,32,16,16,富邦-新營,2024-05-02,9693
2609,陽明,42,26,16,富邦-新營,2024-05-02,9693
4526,東台,14,0,14,富邦-新營,2024-05-02,9693
1618,合機,22,9,13,富邦-新營,2024-05-02,9693
2615,萬海,20,8,12,富邦-新營,2024-05-02,9693
6125,廣運,14,2,12,富邦-新營,2024-05-02,9693
8401,白紗科,12,0,12,富邦-新營,2024-05-02,9693
2884,玉山金,11,0,11,富邦-新營,2024-05-02,9693
00662,富邦NASDAQ,10,0,10,富邦-新營,2024-05-02,9693
1312,國喬,10,0,10,富邦-新營,2024-05-02,9693
1463,強盛新,10,0,10,富邦-新營,2024-05-02,9693
1806,冠軍,10,0,10,富邦-新營,2024-05-02,9693
2367,燿華,10,0,10,富邦-新營,2024-05-02,9693
2413,環科,10,0,10,富邦-新營,2024-05-02,9693
2892,第一金,10,0,10,富邦-新營,2024-05-02,9693
2887,台新金,10,0,10,富邦-新營,2024-05-02,9693
5864,致和證,13,3,10,富邦-新營,2024-05-02,9693
2337,旺宏,12,3,9,富邦-新營,2024-05-02,9693
1609,大亞,73,64,9,富邦-新營,2024-05-02,9693
2547,日勝生,10,1,9,富邦-新營,2024-05-02,9693
3363,上詮,36,27,9,富邦-新營,2024-05-02,9693
00679B,元大美債20年,8,0,8,富邦-新營,2024-05-02,9693
1616,億泰,8,0,8,富邦-新營,2024-05-02,9693
2324,仁寶,11,3,8,富邦-新營,2024-05-02,9693
2897,王道銀行,17,9,8,富邦-新營,2024-05-02,9693
2913,農林,20,12,8,富邦-新營,2024-05-02,9693
2356,英業達,7,0,7,富邦-新營,2024-05-02,9693
3714,富采,7,0,7,富邦-新營,2024-05-02,9693
00945B,凱基美國非投等債,7,0,7,富邦-新營,2024-05-02,9693
00751B,元大AAA至A公司債,6,0,6,富邦-新營,2024-05-02,9693
1513,中興電,7,1,6,富邦-新營,2024-05-02,9693
6451,訊芯-KY,8,2,6,富邦-新營,2024-05-02,9693
9955,佳龍,6,0,6,富邦-新營,2024-05-02,9693
3438,類比科,7,1,6,富邦-新營,2024-05-02,9693
5371,中光電,5,0,5,富邦-新營,2024-05-02,9693
1587,吉茂,100,0,100,富邦-新營,2024-05-03,9693
2344,華邦電,89,2,87,富邦-新營,2024-05-03,9693
00937B,群益ESG投等債20,107,53,54,富邦-新營,2024-05-03,9693
6770,力積電,64,23,41,富邦-新營,2024-05-03,9693
00919,群益台灣精選高息,40,2,38,富邦-新營,2024-05-03,9693
00665L,富邦�琤肭磪囓�2,57,20,37,富邦-新營,2024-05-03,9693
00878,國泰永續高股息,34,4,30,富邦-新營,2024-05-03,9693
1101,台泥,33,3,30,富邦-新營,2024-05-03,9693
3231,緯創,33,3,30,富邦-新營,2024-05-03,9693
5508,永信建,28,2,26,富邦-新營,2024-05-03,9693
1514,亞力,27,2,25,富邦-新營,2024-05-03,9693
00679B,元大美債20年,24,0,24,富邦-新營,2024-05-03,9693
2371,大同,47,24,23,富邦-新營,2024-05-03,9693
1316,上曜,35,12,23,富邦-新營,2024-05-03,9693
6026,福邦證,23,0,23,富邦-新營,2024-05-03,9693
1617,榮星,18,0,18,富邦-新營,2024-05-03,9693
2836,高雄銀,20,2,18,富邦-新營,2024-05-03,9693
6207,雷科,18,2,16,富邦-新營,2024-05-03,9693
2881,富邦金,15,0,15,富邦-新營,2024-05-03,9693
4526,東台,14,0,14,富邦-新營,2024-05-03,9693
9945,潤泰新,44,31,13,富邦-新營,2024-05-03,9693
8064,東捷,15,2,13,富邦-新營,2024-05-03,9693
1608,華榮,33,21,12,富邦-新營,2024-05-03,9693
1718,中纖,12,0,12,富邦-新營,2024-05-03,9693
2324,仁寶,12,0,12,富邦-新營,2024-05-03,9693
5230,雷笛克光學,15,3,12,富邦-新營,2024-05-03,9693
00650L,復華香港正2,22,11,11,富邦-新營,2024-05-03,9693
00687B,國泰20年美債,11,0,11,富邦-新營,2024-05-03,9693
1605,華新,16,5,11,富邦-新營,2024-05-03,9693
1416,廣豐,12,1,11,富邦-新營,2024-05-03,9693
1611,中電,11,0,11,富邦-新營,2024-05-03,9693
5512,力麒,14,3,11,富邦-新營,2024-05-03,9693
2014,中鴻,13,2,11,富邦-新營,2024-05-03,9693
00891,中信關鍵半導體,10,0,10,富邦-新營,2024-05-03,9693
2368,金像電,11,1,10,富邦-新營,2024-05-03,9693
2206,三陽工業,19,9,10,富邦-新營,2024-05-03,9693
00772B,中信高評級公司債,10,0,10,富邦-新營,2024-05-03,9693
00637L,元大滬深300正2,10,0,10,富邦-新營,2024-05-03,9693
00686R,群益臺灣加權反1,10,0,10,富邦-新營,2024-05-03,9693
00676R,富邦臺灣加權反1,10,0,10,富邦-新營,2024-05-03,9693
00664R,國泰臺灣加權反1,10,0,10,富邦-新營,2024-05-03,9693
00669R,國泰美國道瓊反1,10,0,10,富邦-新營,2024-05-03,9693
1776,展宇,10,0,10,富邦-新營,2024-05-03,9693
2408,南亞科,10,0,10,富邦-新營,2024-05-03,9693
2867,三商壽,10,0,10,富邦-新營,2024-05-03,9693
3052,夆典,10,0,10,富邦-新營,2024-05-03,9693
3209,全科,10,0,10,富邦-新營,2024-05-03,9693
3540,曜越,10,0,10,富邦-新營,2024-05-03,9693
4960,誠美材,10,0,10,富邦-新營,2024-05-03,9693
6016,康和證,11,1,10,富邦-新營,2024-05-03,9693
00929,復華台灣科技優息,357,1,356,富邦-新營,2024-05-06,9693
2486,一詮,211,13,198,富邦-新營,2024-05-06,9693
8096,擎亞,642,448,194,富邦-新營,2024-05-06,9693
00650L,復華香港正2,182,2,180,富邦-新營,2024-05-06,9693
3033,威健,203,40,163,富邦-新營,2024-05-06,9693
00665L,富邦�琤肭磪囓�2,132,1,131,富邦-新營,2024-05-06,9693
00937B,群益ESG投等債20,29,3,26,富邦-新營,2024-05-06,9693
2449,京元電子,33,9,24,富邦-新營,2024-05-06,9693
2891,中信金,25,8,17,富邦-新營,2024-05-06,9693
5347,世界,16,1,15,富邦-新營,2024-05-06,9693
2484,希華,15,0,15,富邦-新營,2024-05-06,9693
2630,亞航,16,1,15,富邦-新營,2024-05-06,9693
5531,鄉林,15,0,15,富邦-新營,2024-05-06,9693
1446,宏和,14,0,14,富邦-新營,2024-05-06,9693
1605,華新,14,0,14,富邦-新營,2024-05-06,9693
2492,華新科,14,0,14,富邦-新營,2024-05-06,9693
00679B,元大美債20年,14,0,14,富邦-新營,2024-05-06,9693
2520,冠德,16,4,12,富邦-新營,2024-05-06,9693
3265,台星科,15,3,12,富邦-新營,2024-05-06,9693
6451,訊芯-KY,20,8,12,富邦-新營,2024-05-06,9693
00878,國泰永續高股息,18,7,11,富邦-新營,2024-05-06,9693
1101,台泥,21,10,11,富邦-新營,2024-05-06,9693
4714,永捷,20,9,11,富邦-新營,2024-05-06,9693
6125,廣運,27,16,11,富邦-新營,2024-05-06,9693
3025,星通,10,0,10,富邦-新營,2024-05-06,9693
3324,雙鴻,14,4,10,富邦-新營,2024-05-06,9693
9933,中鼎,10,0,10,富邦-新營,2024-05-06,9693
1618,合機,10,0,10,富邦-新營,2024-05-06,9693
3303,岱稜,10,0,10,富邦-新營,2024-05-06,9693
4716,大立,10,0,10,富邦-新營,2024-05-06,9693
6120,達運,11,2,9,富邦-新營,2024-05-06,9693
1584,精剛,8,0,8,富邦-新營,2024-05-06,9693
3234,光環,9,1,8,富邦-新營,2024-05-06,9693
1609,大亞,45,37,8,富邦-新營,2024-05-06,9693
2344,華邦電,20,13,7,富邦-新營,2024-05-06,9693
6770,力積電,12,6,6,富邦-新營,2024-05-06,9693
2464,盟立,7,1,6,富邦-新營,2024-05-06,9693
2537,聯上發,10,4,6,富邦-新營,2024-05-06,9693
5469,瀚宇博,6,0,6,富邦-新營,2024-05-06,9693
5508,永信建,17,11,6,富邦-新營,2024-05-06,9693
6139,亞翔,6,0,6,富邦-新營,2024-05-06,9693
3006,晶豪科,5,0,5,富邦-新營,2024-05-06,9693
2409,友達,12,7,5,富邦-新營,2024-05-06,9693
2634,漢翔,9,4,5,富邦-新營,2024-05-06,9693
8070,長華*,5,0,5,富邦-新營,2024-05-06,9693
1440,南紡,8,3,5,富邦-新營,2024-05-06,9693
1474,弘裕,5,0,5,富邦-新營,2024-05-06,9693
1612,宏泰,5,0,5,富邦-新營,2024-05-06,9693
2010,春源,5,0,5,富邦-新營,2024-05-06,9693
2356,英業達,10,5,5,富邦-新營,2024-05-06,9693
00929,復華台灣科技優息,160,2,158,富邦-新營,2024-05-07,9693
1605,華新,47,3,44,富邦-新營,2024-05-07,9693
2486,一詮,76,34,42,富邦-新營,2024-05-07,9693
8033,雷虎,35,0,35,富邦-新營,2024-05-07,9693
6770,力積電,34,3,31,富邦-新營,2024-05-07,9693
00940,元大台灣價值高息,50,21,29,富邦-新營,2024-05-07,9693
00878,國泰永續高股息,72,46,26,富邦-新營,2024-05-07,9693
00919,群益台灣精選高息,32,6,26,富邦-新營,2024-05-07,9693
2515,中工,25,0,25,富邦-新營,2024-05-07,9693
2464,盟立,29,6,23,富邦-新營,2024-05-07,9693
1609,大亞,489,469,20,富邦-新營,2024-05-07,9693
00665L,富邦�琤肭磪囓�2,50,30,20,富邦-新營,2024-05-07,9693
2312,金寶,21,1,20,富邦-新營,2024-05-07,9693
2888,新光金,24,4,20,富邦-新營,2024-05-07,9693
2897,王道銀行,18,0,18,富邦-新營,2024-05-07,9693
2317,鴻海,67,50,17,富邦-新營,2024-05-07,9693
2883,凱基金,20,3,17,富邦-新營,2024-05-07,9693
00679B,元大美債20年,16,0,16,富邦-新營,2024-05-07,9693
2101,南港,19,3,16,富邦-新營,2024-05-07,9693
2501,國建,21,5,16,富邦-新營,2024-05-07,9693
4966,譜瑞-KY,16,0,16,富邦-新營,2024-05-07,9693
1101,台泥,16,0,16,富邦-新營,2024-05-07,9693
2363,矽統,33,18,15,富邦-新營,2024-05-07,9693
1598,岱宇,15,0,15,富邦-新營,2024-05-07,9693
2881,富邦金,15,0,15,富邦-新營,2024-05-07,9693
9945,潤泰新,20,6,14,富邦-新營,2024-05-07,9693
2014,中鴻,13,0,13,富邦-新營,2024-05-07,9693
2511,太子,16,3,13,富邦-新營,2024-05-07,9693
8215,明基材,12,0,12,富邦-新營,2024-05-07,9693
2367,燿華,12,0,12,富邦-新營,2024-05-07,9693
3013,晟銘電,33,21,12,富邦-新營,2024-05-07,9693
3025,星通,18,6,12,富邦-新營,2024-05-07,9693
00918,大華優利高填息30,12,1,11,富邦-新營,2024-05-07,9693
2313,華通,11,1,10,富邦-新營,2024-05-07,9693
2059,川湖,10,0,10,富邦-新營,2024-05-07,9693
2115,六暉-KY,10,0,10,富邦-新營,2024-05-07,9693
2462,良得電,10,0,10,富邦-新營,2024-05-07,9693
2634,漢翔,14,4,10,富邦-新營,2024-05-07,9693
3296,勝德,10,0,10,富邦-新營,2024-05-07,9693
3372,典範,10,0,10,富邦-新營,2024-05-07,9693
4960,誠美材,10,0,10,富邦-新營,2024-05-07,9693
5864,致和證,23,13,10,富邦-新營,2024-05-07,9693
3033,威健,15,6,9,富邦-新營,2024-05-07,9693
5508,永信建,14,5,9,富邦-新營,2024-05-07,9693
6117,迎廣,14,5,9,富邦-新營,2024-05-07,9693
5009,榮剛,13,4,9,富邦-新營,2024-05-07,9693
1617,榮星,10,1,9,富邦-新營,2024-05-07,9693
1309,台達化,8,0,8,富邦-新營,2024-05-07,9693
2838,聯邦銀,8,0,8,富邦-新營,2024-05-07,9693
8121,越峰,7,0,7,富邦-新營,2024-05-07,9693
2618,長榮航,322,17,305,富邦-新營,2024-05-08,9693
2486,一詮,362,220,142,富邦-新營,2024-05-08,9693
00665L,富邦�琤肭磪囓�2,130,0,130,富邦-新營,2024-05-08,9693
2889,國票金,62,1,61,富邦-新營,2024-05-08,9693
00940,元大台灣價值高息,58,0,58,富邦-新營,2024-05-08,9693
2374,佳能,49,0,49,富邦-新營,2024-05-08,9693
2101,南港,50,2,48,富邦-新營,2024-05-08,9693
00679B,元大美債20年,36,3,33,富邦-新營,2024-05-08,9693
3564,其陽,32,0,32,富邦-新營,2024-05-08,9693
00919,群益台灣精選高息,33,2,31,富邦-新營,2024-05-08,9693
2883,凱基金,36,5,31,富邦-新營,2024-05-08,9693
6026,福邦證,30,0,30,富邦-新營,2024-05-08,9693
2603,長榮,32,3,29,富邦-新營,2024-05-08,9693
2596,綠意,25,0,25,富邦-新營,2024-05-08,9693
2601,益航,25,0,25,富邦-新營,2024-05-08,9693
00929,復華台灣科技優息,35,11,24,富邦-新營,2024-05-08,9693
5392,能率,20,2,18,富邦-新營,2024-05-08,9693
5864,致和證,18,0,18,富邦-新營,2024-05-08,9693
1616,億泰,17,0,17,富邦-新營,2024-05-08,9693
00878,國泰永續高股息,28,11,17,富邦-新營,2024-05-08,9693
1440,南紡,22,6,16,富邦-新營,2024-05-08,9693
1618,合機,21,5,16,富邦-新營,2024-05-08,9693
6016,康和證,16,0,16,富邦-新營,2024-05-08,9693
6215,和椿,38,22,16,富邦-新營,2024-05-08,9693
2611,志信,30,15,15,富邦-新營,2024-05-08,9693
3481,群創,14,0,14,富邦-新營,2024-05-08,9693
1734,杏輝,14,0,14,富邦-新營,2024-05-08,9693
2312,金寶,16,2,14,富邦-新營,2024-05-08,9693
00937B,群益ESG投等債20,18,5,13,富邦-新營,2024-05-08,9693
8277,商丞,13,0,13,富邦-新營,2024-05-08,9693
2409,友達,12,0,12,富邦-新營,2024-05-08,9693
1605,華新,12,0,12,富邦-新營,2024-05-08,9693
00932,兆豐永續高息等權,11,0,11,富邦-新營,2024-05-08,9693
4966,譜瑞-KY,11,0,11,富邦-新營,2024-05-08,9693
8429,金麗-KY,11,0,11,富邦-新營,2024-05-08,9693
1603,華電,13,2,11,富邦-新營,2024-05-08,9693
3036,文曄,11,1,10,富邦-新營,2024-05-08,9693
1604,聲寶,10,0,10,富邦-新營,2024-05-08,9693
3372,典範,10,0,10,富邦-新營,2024-05-08,9693
4543,萬在,16,6,10,富邦-新營,2024-05-08,9693
4806,桂田文創,10,0,10,富邦-新營,2024-05-08,9693
8071,能率網通,10,0,10,富邦-新營,2024-05-08,9693
1514,亞力,21,12,9,富邦-新營,2024-05-08,9693
0056,元大高股息,10,1,9,富邦-新營,2024-05-08,9693
6120,達運,10,1,9,富邦-新營,2024-05-08,9693
5512,力麒,10,2,8,富邦-新營,2024-05-08,9693
5871,中租-KY,9,1,8,富邦-新營,2024-05-08,9693
2450,神腦,7,0,7,富邦-新營,2024-05-08,9693
2913,農林,7,0,7,富邦-新營,2024-05-08,9693
3049,精金,7,0,7,富邦-新營,2024-05-08,9693
00946,群益科技高息成長,171,4,167,富邦-新營,2024-05-09,9693
1582,信錦,104,7,97,富邦-新營,2024-05-09,9693
2881,富邦金,57,0,57,富邦-新營,2024-05-09,9693
00929,復華台灣科技優息,51,2,49,富邦-新營,2024-05-09,9693
2897,王道銀行,45,0,45,富邦-新營,2024-05-09,9693
00919,群益台灣精選高息,43,0,43,富邦-新營,2024-05-09,9693
5355,佳總,40,0,40,富邦-新營,2024-05-09,9693
8110,華東,40,0,40,富邦-新營,2024-05-09,9693
2889,國票金,69,34,35,富邦-新營,2024-05-09,9693
2888,新光金,53,19,34,富邦-新營,2024-05-09,9693
4513,福裕,31,0,31,富邦-新營,2024-05-09,9693
2367,燿華,57,29,28,富邦-新營,2024-05-09,9693
8112,至上,27,1,26,富邦-新營,2024-05-09,9693
00940,元大台灣價值高息,33,11,22,富邦-新營,2024-05-09,9693
3481,群創,22,0,22,富邦-新營,2024-05-09,9693
3706,神達,25,3,22,富邦-新營,2024-05-09,9693
1409,新纖,21,0,21,富邦-新營,2024-05-09,9693
00944,野村趨勢動能高息,20,0,20,富邦-新營,2024-05-09,9693
00637L,元大滬深300正2,20,0,20,富邦-新營,2024-05-09,9693
6016,康和證,20,0,20,富邦-新營,2024-05-09,9693
3231,緯創,22,2,20,富邦-新營,2024-05-09,9693
0056,元大高股息,21,3,18,富邦-新營,2024-05-09,9693
2409,友達,18,0,18,富邦-新營,2024-05-09,9693
8215,明基材,18,0,18,富邦-新營,2024-05-09,9693
5351,鈺創,17,1,16,富邦-新營,2024-05-09,9693
4949,有成精密,14,0,14,富邦-新營,2024-05-09,9693
1605,華新,15,2,13,富邦-新營,2024-05-09,9693
1301,台塑,13,0,13,富邦-新營,2024-05-09,9693
2101,南港,13,1,12,富邦-新營,2024-05-09,9693
2913,農林,12,0,12,富邦-新營,2024-05-09,9693
6187,萬潤,12,0,12,富邦-新營,2024-05-09,9693
2363,矽統,43,32,11,富邦-新營,2024-05-09,9693
2328,廣宇,12,1,11,富邦-新營,2024-05-09,9693
3264,欣銓,11,0,11,富邦-新營,2024-05-09,9693
3312,弘憶股,16,5,11,富邦-新營,2024-05-09,9693
6207,雷科,19,8,11,富邦-新營,2024-05-09,9693
8054,安國,11,1,10,富邦-新營,2024-05-09,9693
4966,譜瑞-KY,10,0,10,富邦-新營,2024-05-09,9693
1618,合機,12,2,10,富邦-新營,2024-05-09,9693
6505,台塑化,9,0,9,富邦-新營,2024-05-09,9693
00932,兆豐永續高息等權,9,0,9,富邦-新營,2024-05-09,9693
2371,大同,35,26,9,富邦-新營,2024-05-09,9693
3313,斐成,10,1,9,富邦-新營,2024-05-09,9693
6257,矽格,9,0,9,富邦-新營,2024-05-09,9693
2206,三陽工業,13,5,8,富邦-新營,2024-05-09,9693
2408,南亞科,9,1,8,富邦-新營,2024-05-09,9693
2476,鉅祥,8,0,8,富邦-新營,2024-05-09,9693
2605,新興,15,7,8,富邦-新營,2024-05-09,9693
4714,永捷,8,0,8,富邦-新營,2024-05-09,9693
3230,錦明,8,0,8,富邦-新營,2024-05-09,9693
00929,復華台灣科技優息,173,2,171,富邦-新營,2024-05-10,9693
4306,炎洲,50,0,50,富邦-新營,2024-05-10,9693
8112,至上,55,5,50,富邦-新營,2024-05-10,9693
2881,富邦金,52,3,49,富邦-新營,2024-05-10,9693
2915,潤泰全,40,1,39,富邦-新營,2024-05-10,9693
00753L,中信中國50正2,34,1,33,富邦-新營,2024-05-10,9693
3706,神達,59,26,33,富邦-新營,2024-05-10,9693
2101,南港,34,2,32,富邦-新營,2024-05-10,9693
00946,群益科技高息成長,31,0,31,富邦-新營,2024-05-10,9693
6026,福邦證,29,1,28,富邦-新營,2024-05-10,9693
00930,永豐ESG低碳高息,25,0,25,富邦-新營,2024-05-10,9693
2317,鴻海,39,14,25,富邦-新營,2024-05-10,9693
2353,宏��,28,5,23,富邦-新營,2024-05-10,9693
3363,上詮,21,1,20,富邦-新營,2024-05-10,9693
3576,聯合再生,20,0,20,富邦-新營,2024-05-10,9693
2313,華通,18,0,18,富邦-新營,2024-05-10,9693
00650L,復華香港正2,20,2,18,富邦-新營,2024-05-10,9693
2371,大同,35,19,16,富邦-新營,2024-05-10,9693
8054,安國,15,0,15,富邦-新營,2024-05-10,9693
2323,中環,19,4,15,富邦-新營,2024-05-10,9693
3356,奇偶,20,5,15,富邦-新營,2024-05-10,9693
2501,國建,29,15,14,富邦-新營,2024-05-10,9693
4909,新復興,19,6,13,富邦-新營,2024-05-10,9693
2409,友達,12,0,12,富邦-新營,2024-05-10,9693
8086,宏捷科,12,0,12,富邦-新營,2024-05-10,9693
1316,上曜,15,3,12,富邦-新營,2024-05-10,9693
8401,白紗科,12,0,12,富邦-新營,2024-05-10,9693
8926,台汽電,12,0,12,富邦-新營,2024-05-10,9693
1504,東元,12,1,11,富邦-新營,2024-05-10,9693
6509,聚和,10,0,10,富邦-新營,2024-05-10,9693
3402,漢科,9,0,9,富邦-新營,2024-05-10,9693
00941,中信上游半導體,15,6,9,富邦-新營,2024-05-10,9693
5871,中租-KY,9,0,9,富邦-新營,2024-05-10,9693
6139,亞翔,8,0,8,富邦-新營,2024-05-10,9693
2359,所羅門,19,11,8,富邦-新營,2024-05-10,9693
2427,三商電,8,0,8,富邦-新營,2024-05-10,9693
2634,漢翔,11,3,8,富邦-新營,2024-05-10,9693
6269,台郡,9,1,8,富邦-新營,2024-05-10,9693
9105,泰金寶-DR,8,0,8,富邦-新營,2024-05-10,9693
9933,中鼎,10,2,8,富邦-新營,2024-05-10,9693
00877,復華中國5G,7,0,7,富邦-新營,2024-05-10,9693
3703,欣陸,7,0,7,富邦-新營,2024-05-10,9693
00944,野村趨勢動能高息,6,0,6,富邦-新營,2024-05-10,9693
2617,台航,9,3,6,富邦-新營,2024-05-10,9693
6239,力成,8,2,6,富邦-新營,2024-05-10,9693
2509,全坤建,6,0,6,富邦-新營,2024-05-10,9693
3708,上緯投控,6,0,6,富邦-新營,2024-05-10,9693
6120,達運,6,0,6,富邦-新營,2024-05-10,9693
3033,威健,9,3,6,富邦-新營,2024-05-10,9693
2457,飛宏,6,0,6,富邦-新營,2024-05-10,9693
00929,復華台灣科技優息,248,62,186,富邦-新營,2024-05-13,9693
2359,所羅門,102,7,95,富邦-新營,2024-05-13,9693
1447,力鵬,80,0,80,富邦-新營,2024-05-13,9693
00937B,群益ESG投等債20,98,27,71,富邦-新營,2024-05-13,9693
2881,富邦金,51,1,50,富邦-新營,2024-05-13,9693
2371,大同,82,37,45,富邦-新營,2024-05-13,9693
1314,中石化,40,0,40,富邦-新營,2024-05-13,9693
2317,鴻海,33,12,21,富邦-新營,2024-05-13,9693
3231,緯創,24,5,19,富邦-新營,2024-05-13,9693
2511,太子,18,0,18,富邦-新營,2024-05-13,9693
00919,群益台灣精選高息,23,5,18,富邦-新營,2024-05-13,9693
6026,福邦證,15,0,15,富邦-新營,2024-05-13,9693
2882,國泰金,20,6,14,富邦-新營,2024-05-13,9693
00939,統一台灣高息動能,13,0,13,富邦-新營,2024-05-13,9693
2449,京元電子,14,1,13,富邦-新營,2024-05-13,9693
3712,永崴投控,13,0,13,富邦-新營,2024-05-13,9693
00878,國泰永續高股息,26,14,12,富邦-新營,2024-05-13,9693
2641,正德,44,33,11,富邦-新營,2024-05-13,9693
5392,能率,12,1,11,富邦-新營,2024-05-13,9693
00632R,元大台灣50反1,10,0,10,富邦-新營,2024-05-13,9693
2406,國碩,14,4,10,富邦-新營,2024-05-13,9693
2855,統一證,10,0,10,富邦-新營,2024-05-13,9693
2542,興富發,10,0,10,富邦-新營,2024-05-13,9693
8033,雷虎,17,8,9,富邦-新營,2024-05-13,9693
00687B,國泰20年美債,8,0,8,富邦-新營,2024-05-13,9693
00941,中信上游半導體,8,0,8,富邦-新營,2024-05-13,9693
2634,漢翔,10,2,8,富邦-新營,2024-05-13,9693
6547,高端疫苗,8,0,8,富邦-新營,2024-05-13,9693
8429,金麗-KY,8,0,8,富邦-新營,2024-05-13,9693
1524,耿鼎,10,2,8,富邦-新營,2024-05-13,9693
2609,陽明,70,62,8,富邦-新營,2024-05-13,9693
00946,群益科技高息成長,10,3,7,富邦-新營,2024-05-13,9693
1587,吉茂,9,2,7,富邦-新營,2024-05-13,9693
2611,志信,20,13,7,富邦-新營,2024-05-13,9693
3013,晟銘電,14,7,7,富邦-新營,2024-05-13,9693
3083,網龍,7,0,7,富邦-新營,2024-05-13,9693
4207,環泰,7,0,7,富邦-新營,2024-05-13,9693
5519,隆大,8,1,7,富邦-新營,2024-05-13,9693
2603,長榮,29,22,7,富邦-新營,2024-05-13,9693
00944,野村趨勢動能高息,6,0,6,富邦-新營,2024-05-13,9693
1618,合機,7,1,6,富邦-新營,2024-05-13,9693
00885,富邦越南,6,0,6,富邦-新營,2024-05-13,9693
00932,兆豐永續高息等權,6,0,6,富邦-新營,2024-05-13,9693
2020,美亞,6,0,6,富邦-新營,2024-05-13,9693
2352,佳世達,6,0,6,富邦-新營,2024-05-13,9693
2913,農林,6,0,6,富邦-新營,2024-05-13,9693
4147,中裕,6,0,6,富邦-新營,2024-05-13,9693
4562,穎漢,7,1,6,富邦-新營,2024-05-13,9693
4903,聯光通,12,6,6,富邦-新營,2024-05-13,9693
5608,四維航,35,29,6,富邦-新營,2024-05-13,9693
00665L,富邦�琤肭磪囓�2,202,0,202,富邦-新營,2024-05-14,9693
00878,國泰永續高股息,138,19,119,富邦-新營,2024-05-14,9693
00937B,群益ESG投等債20,73,0,73,富邦-新營,2024-05-14,9693
9105,泰金寶-DR,68,11,57,富邦-新營,2024-05-14,9693
1301,台塑,35,0,35,富邦-新營,2024-05-14,9693
2892,第一金,33,0,33,富邦-新營,2024-05-14,9693
2371,大同,48,18,30,富邦-新營,2024-05-14,9693
1305,華夏,31,1,30,富邦-新營,2024-05-14,9693
1609,大亞,31,3,28,富邦-新營,2024-05-14,9693
00946,群益科技高息成長,31,3,28,富邦-新營,2024-05-14,9693
2615,萬海,417,389,28,富邦-新營,2024-05-14,9693
1447,力鵬,27,0,27,富邦-新營,2024-05-14,9693
3088,艾訊,25,0,25,富邦-新營,2024-05-14,9693
2323,中環,23,0,23,富邦-新營,2024-05-14,9693
5864,致和證,23,1,22,富邦-新營,2024-05-14,9693
2630,亞航,24,2,22,富邦-新營,2024-05-14,9693
1616,億泰,21,0,21,富邦-新營,2024-05-14,9693
2374,佳能,97,77,20,富邦-新營,2024-05-14,9693
3481,群創,63,43,20,富邦-新營,2024-05-14,9693
2317,鴻海,186,166,20,富邦-新營,2024-05-14,9693
3230,錦明,18,0,18,富邦-新營,2024-05-14,9693
2618,長榮航,15,0,15,富邦-新營,2024-05-14,9693
9945,潤泰新,20,5,15,富邦-新營,2024-05-14,9693
00679B,元大美債20年,14,0,14,富邦-新營,2024-05-14,9693
00752,中信中國50,14,0,14,富邦-新營,2024-05-14,9693
1608,華榮,14,1,13,富邦-新營,2024-05-14,9693
1227,佳格,13,0,13,富邦-新營,2024-05-14,9693
1815,富喬,13,0,13,富邦-新營,2024-05-14,9693
2489,瑞軒,13,0,13,富邦-新營,2024-05-14,9693
3576,聯合再生,13,0,13,富邦-新營,2024-05-14,9693
00930,永豐ESG低碳高息,12,0,12,富邦-新營,2024-05-14,9693
2641,正德,18,6,12,富邦-新營,2024-05-14,9693
2882,國泰金,11,0,11,富邦-新營,2024-05-14,9693
1457,宜進,11,0,11,富邦-新營,2024-05-14,9693
6743,安普新,11,0,11,富邦-新營,2024-05-14,9693
3231,緯創,19,9,10,富邦-新營,2024-05-14,9693
2891,中信金,10,0,10,富邦-新營,2024-05-14,9693
00936,台新永續高息中小,11,1,10,富邦-新營,2024-05-14,9693
1909,榮成,10,0,10,富邦-新營,2024-05-14,9693
2515,中工,12,2,10,富邦-新營,2024-05-14,9693
2537,聯上發,10,0,10,富邦-新營,2024-05-14,9693
5531,鄉林,10,0,10,富邦-新營,2024-05-14,9693
3047,訊舟,10,0,10,富邦-新營,2024-05-14,9693
5508,永信建,13,4,9,富邦-新營,2024-05-14,9693
3324,雙鴻,12,4,8,富邦-新營,2024-05-14,9693
1524,耿鼎,8,0,8,富邦-新營,2024-05-14,9693
6550,北極星藥業-KY,8,0,8,富邦-新營,2024-05-14,9693
2884,玉山金,7,0,7,富邦-新營,2024-05-14,9693
8234,新漢,8,1,7,富邦-新營,2024-05-14,9693
2886,兆豐金,6,0,6,富邦-新營,2024-05-14,9693
2855,統一證,200,0,200,富邦-新營,2024-05-15,9693
00632R,元大台灣50反1,110,8,102,富邦-新營,2024-05-15,9693
00937B,群益ESG投等債20,87,10,77,富邦-新營,2024-05-15,9693
2356,英業達,99,23,76,富邦-新營,2024-05-15,9693
2359,所羅門,238,193,45,富邦-新營,2024-05-15,9693
2208,台船,50,10,40,富邦-新營,2024-05-15,9693
00919,群益台灣精選高息,43,6,37,富邦-新營,2024-05-15,9693
00929,復華台灣科技優息,33,8,25,富邦-新營,2024-05-15,9693
2020,美亞,30,5,25,富邦-新營,2024-05-15,9693
00665L,富邦�琤肭磪囓�2,23,0,23,富邦-新營,2024-05-15,9693
8064,東捷,25,4,21,富邦-新營,2024-05-15,9693
2634,漢翔,32,12,20,富邦-新營,2024-05-15,9693
1409,新纖,20,0,20,富邦-新營,2024-05-15,9693
5530,龍巖,20,0,20,富邦-新營,2024-05-15,9693
1514,亞力,22,3,19,富邦-新營,2024-05-15,9693
1608,華榮,160,143,17,富邦-新營,2024-05-15,9693
2014,中鴻,26,10,16,富邦-新營,2024-05-15,9693
2630,亞航,20,5,15,富邦-新營,2024-05-15,9693
1718,中纖,15,0,15,富邦-新營,2024-05-15,9693
4532,瑞智,29,14,15,富邦-新營,2024-05-15,9693
6215,和椿,450,436,14,富邦-新營,2024-05-15,9693
2449,京元電子,14,0,14,富邦-新營,2024-05-15,9693
2406,國碩,49,36,13,富邦-新營,2024-05-15,9693
6244,茂迪,14,1,13,富邦-新營,2024-05-15,9693
2002,中鋼,12,0,12,富邦-新營,2024-05-15,9693
2611,志信,12,0,12,富邦-新營,2024-05-15,9693
6753,龍德造船,16,4,12,富邦-新營,2024-05-15,9693
2337,旺宏,11,0,11,富邦-新營,2024-05-15,9693
1609,大亞,26,16,10,富邦-新營,2024-05-15,9693
00941,中信上游半導體,10,0,10,富邦-新營,2024-05-15,9693
3022,威強電,10,0,10,富邦-新營,2024-05-15,9693
3049,精金,10,0,10,富邦-新營,2024-05-15,9693
6449,鈺邦,10,0,10,富邦-新營,2024-05-15,9693
6546,正基,10,0,10,富邦-新營,2024-05-15,9693
2363,矽統,62,52,10,富邦-新營,2024-05-15,9693
2851,中再保,11,1,10,富邦-新營,2024-05-15,9693
3481,群創,11,2,9,富邦-新營,2024-05-15,9693
4806,桂田文創,9,0,9,富邦-新營,2024-05-15,9693
6125,廣運,15,6,9,富邦-新營,2024-05-15,9693
5469,瀚宇博,11,2,9,富邦-新營,2024-05-15,9693
2603,長榮,23,14,9,富邦-新營,2024-05-15,9693
2542,興富發,9,0,9,富邦-新營,2024-05-15,9693
5371,中光電,12,4,8,富邦-新營,2024-05-15,9693
6197,佳必琪,7,0,7,富邦-新營,2024-05-15,9693
3706,神達,13,6,7,富邦-新營,2024-05-15,9693
2486,一詮,19,12,7,富邦-新營,2024-05-15,9693
6743,安普新,7,0,7,富邦-新營,2024-05-15,9693
2809,京城銀,6,0,6,富邦-新營,2024-05-15,9693
00933B,國泰10Y+金融債,6,0,6,富邦-新營,2024-05-15,9693
1316,上曜,8,2,6,富邦-新營,2024-05-15,9693
00687B,國泰20年美債,323,2,321,富邦-新營,2024-05-16,9693
00650L,復華香港正2,192,4,188,富邦-新營,2024-05-16,9693
1587,吉茂,132,56,76,富邦-新營,2024-05-16,9693
00940,元大台灣價值高息,60,10,50,富邦-新營,2024-05-16,9693
2356,英業達,84,43,41,富邦-新營,2024-05-16,9693
00680L,元大美債20正2,38,0,38,富邦-新營,2024-05-16,9693
2603,長榮,51,15,36,富邦-新營,2024-05-16,9693
2349,錸德,27,0,27,富邦-新營,2024-05-16,9693
00915,凱基優選高股息30,27,3,24,富邦-新營,2024-05-16,9693
6451,訊芯-KY,23,1,22,富邦-新營,2024-05-16,9693
2014,中鴻,25,5,20,富邦-新營,2024-05-16,9693
5512,力麒,30,10,20,富邦-新營,2024-05-16,9693
2382,廣達,21,6,15,富邦-新營,2024-05-16,9693
00878,國泰永續高股息,32,17,15,富邦-新營,2024-05-16,9693
3022,威強電,15,0,15,富邦-新營,2024-05-16,9693
2365,昆盈,310,295,15,富邦-新營,2024-05-16,9693
3305,昇貿,25,12,13,富邦-新營,2024-05-16,9693
1608,華榮,14,1,13,富邦-新營,2024-05-16,9693
00857B,永豐20年美公債,12,0,12,富邦-新營,2024-05-16,9693
1440,南紡,20,8,12,富邦-新營,2024-05-16,9693
2303,聯電,16,6,10,富邦-新營,2024-05-16,9693
2006,東和鋼鐵,10,0,10,富邦-新營,2024-05-16,9693
2406,國碩,10,0,10,富邦-新營,2024-05-16,9693
3052,夆典,10,0,10,富邦-新營,2024-05-16,9693
6742,澤米,11,1,10,富邦-新營,2024-05-16,9693
1210,大成,10,0,10,富邦-新營,2024-05-16,9693
3163,波若威,9,0,9,富邦-新營,2024-05-16,9693
3712,永崴投控,10,1,9,富邦-新營,2024-05-16,9693
6743,安普新,9,0,9,富邦-新營,2024-05-16,9693
2352,佳世達,8,0,8,富邦-新營,2024-05-16,9693
2250,IKKA-KY,8,0,8,富邦-新營,2024-05-16,9693
2344,華邦電,11,3,8,富邦-新營,2024-05-16,9693
3694,海華,10,2,8,富邦-新營,2024-05-16,9693
3706,神達,7,0,7,富邦-新營,2024-05-16,9693
1609,大亞,7,0,7,富邦-新營,2024-05-16,9693
2449,京元電子,8,1,7,富邦-新營,2024-05-16,9693
2913,農林,7,0,7,富邦-新營,2024-05-16,9693
8054,安國,8,1,7,富邦-新營,2024-05-16,9693
3231,緯創,18,12,6,富邦-新營,2024-05-16,9693
2025,千興,13,7,6,富邦-新營,2024-05-16,9693
8064,東捷,6,0,6,富邦-新營,2024-05-16,9693
1612,宏泰,7,1,6,富邦-新營,2024-05-16,9693
2615,萬海,11,5,6,富邦-新營,2024-05-16,9693
1524,耿鼎,5,0,5,富邦-新營,2024-05-16,9693
1718,中纖,5,0,5,富邦-新營,2024-05-16,9693
2442,新美齊,5,0,5,富邦-新營,2024-05-16,9693
2867,三商壽,10,5,5,富邦-新營,2024-05-16,9693
3356,奇偶,5,0,5,富邦-新營,2024-05-16,9693
6591,動力-KY,5,0,5,富邦-新營,2024-05-16,9693
6928,攸泰科技,6,1,5,富邦-新營,2024-05-16,9693
3376,新日興,104,5,99,富邦-新營,2024-05-17,9693
00929,復華台灣科技優息,90,13,77,富邦-新營,2024-05-17,9693
2344,華邦電,51,2,49,富邦-新營,2024-05-17,9693
00878,國泰永續高股息,54,13,41,富邦-新營,2024-05-17,9693
2417,圓剛,57,16,41,富邦-新營,2024-05-17,9693
5355,佳總,35,0,35,富邦-新營,2024-05-17,9693
2009,第一銅,32,1,31,富邦-新營,2024-05-17,9693
00940,元大台灣價值高息,39,9,30,富邦-新營,2024-05-17,9693
00665L,富邦�琤肭磪囓�2,50,20,30,富邦-新營,2024-05-17,9693
00919,群益台灣精選高息,35,6,29,富邦-新營,2024-05-17,9693
5392,能率,43,16,27,富邦-新營,2024-05-17,9693
2881,富邦金,32,6,26,富邦-新營,2024-05-17,9693
2367,燿華,103,78,25,富邦-新營,2024-05-17,9693
2630,亞航,25,2,23,富邦-新營,2024-05-17,9693
2374,佳能,140,118,22,富邦-新營,2024-05-17,9693
00935,野村臺灣新科技50,20,0,20,富邦-新營,2024-05-17,9693
00700,富邦�琤肭磪�,20,0,20,富邦-新營,2024-05-17,9693
3059,華晶科,34,14,20,富邦-新營,2024-05-17,9693
00632R,元大台灣50反1,19,0,19,富邦-新營,2024-05-17,9693
3047,訊舟,28,9,19,富邦-新營,2024-05-17,9693
2408,南亞科,18,0,18,富邦-新營,2024-05-17,9693
00946,群益科技高息成長,18,0,18,富邦-新營,2024-05-17,9693
1616,億泰,20,2,18,富邦-新營,2024-05-17,9693
2537,聯上發,18,0,18,富邦-新營,2024-05-17,9693
2883,凱基金,20,2,18,富邦-新營,2024-05-17,9693
00944,野村趨勢動能高息,12,0,12,富邦-新營,2024-05-17,9693
2324,仁寶,12,0,12,富邦-新營,2024-05-17,9693
3060,銘異,16,4,12,富邦-新營,2024-05-17,9693
2409,友達,13,2,11,富邦-新營,2024-05-17,9693
1904,正隆,10,0,10,富邦-新營,2024-05-17,9693
2349,錸德,14,4,10,富邦-新營,2024-05-17,9693
2542,興富發,12,2,10,富邦-新營,2024-05-17,9693
4542,科嶠,9,0,9,富邦-新營,2024-05-17,9693
3312,弘憶股,12,4,8,富邦-新營,2024-05-17,9693
00650L,復華香港正2,13,5,8,富邦-新營,2024-05-17,9693
00679B,元大美債20年,8,0,8,富邦-新營,2024-05-17,9693
2356,英業達,10,2,8,富邦-新營,2024-05-17,9693
3363,上詮,11,3,8,富邦-新營,2024-05-17,9693
2882,國泰金,9,2,7,富邦-新營,2024-05-17,9693
2211,長榮鋼,7,0,7,富邦-新營,2024-05-17,9693
2365,昆盈,7,0,7,富邦-新營,2024-05-17,9693
2405,輔信,9,2,7,富邦-新營,2024-05-17,9693
2605,新興,7,0,7,富邦-新營,2024-05-17,9693
4549,桓達,7,0,7,富邦-新營,2024-05-17,9693
1522,堤維西,6,0,6,富邦-新營,2024-05-17,9693
00706L,期元大S＆P日圓正2,6,0,6,富邦-新營,2024-05-17,9693
1582,信錦,6,0,6,富邦-新營,2024-05-17,9693
1603,華電,6,0,6,富邦-新營,2024-05-17,9693
2002,中鋼,6,0,6,富邦-新營,2024-05-17,9693
2425,承啟,6,0,6,富邦-新營,2024-05-17,9693
00937B,群益ESG投等債20,143,41,102,富邦-新營,2024-05-20,9693
00929,復華台灣科技優息,85,14,71,富邦-新營,2024-05-20,9693
00665L,富邦�琤肭磪囓�2,70,0,70,富邦-新營,2024-05-20,9693
2610,華航,88,18,70,富邦-新營,2024-05-20,9693
00878,國泰永續高股息,47,7,40,富邦-新營,2024-05-20,9693
1314,中石化,50,11,39,富邦-新營,2024-05-20,9693
2515,中工,50,11,39,富邦-新營,2024-05-20,9693
2618,長榮航,42,8,34,富邦-新營,2024-05-20,9693
2317,鴻海,35,3,32,富邦-新營,2024-05-20,9693
2836,高雄銀,30,0,30,富邦-新營,2024-05-20,9693
3141,晶宏,30,0,30,富邦-新營,2024-05-20,9693
2867,三商壽,51,23,28,富邦-新營,2024-05-20,9693
00679B,元大美債20年,26,0,26,富邦-新營,2024-05-20,9693
8033,雷虎,27,1,26,富邦-新營,2024-05-20,9693
3324,雙鴻,28,8,20,富邦-新營,2024-05-20,9693
00933B,國泰10Y+金融債,20,0,20,富邦-新營,2024-05-20,9693
4533,協易機,56,37,19,富邦-新營,2024-05-20,9693
3231,緯創,23,4,19,富邦-新營,2024-05-20,9693
6207,雷科,23,5,18,富邦-新營,2024-05-20,9693
2363,矽統,47,29,18,富邦-新營,2024-05-20,9693
5508,永信建,17,1,16,富邦-新營,2024-05-20,9693
00946,群益科技高息成長,16,0,16,富邦-新營,2024-05-20,9693
6005,群益證,16,0,16,富邦-新營,2024-05-20,9693
2880,華南金,20,5,15,富邦-新營,2024-05-20,9693
3049,精金,20,6,14,富邦-新營,2024-05-20,9693
3564,其陽,20,6,14,富邦-新營,2024-05-20,9693
1603,華電,13,0,13,富邦-新營,2024-05-20,9693
2537,聯上發,14,1,13,富邦-新營,2024-05-20,9693
5009,榮剛,22,9,13,富邦-新營,2024-05-20,9693
8401,白紗科,12,0,12,富邦-新營,2024-05-20,9693
00632R,元大台灣50反1,11,0,11,富邦-新營,2024-05-20,9693
3016,嘉晶,11,0,11,富邦-新營,2024-05-20,9693
3402,漢科,12,1,11,富邦-新營,2024-05-20,9693
6139,亞翔,10,0,10,富邦-新營,2024-05-20,9693
00637L,元大滬深300正2,16,6,10,富邦-新營,2024-05-20,9693
00706L,期元大S＆P日圓正2,10,0,10,富邦-新營,2024-05-20,9693
1536,和大,10,0,10,富邦-新營,2024-05-20,9693
3022,威強電,10,0,10,富邦-新營,2024-05-20,9693
3052,夆典,10,0,10,富邦-新營,2024-05-20,9693
2888,新光金,12,2,10,富邦-新營,2024-05-20,9693
3312,弘憶股,11,2,9,富邦-新營,2024-05-20,9693
3687,歐買尬,9,0,9,富邦-新營,2024-05-20,9693
4167,松瑞藥,10,1,9,富邦-新營,2024-05-20,9693
9946,三發地產,9,0,9,富邦-新營,2024-05-20,9693
2330,台積電,9,0,9,富邦-新營,2024-05-20,9693
2834,臺企銀,9,1,8,富邦-新營,2024-05-20,9693
2353,宏��,14,6,8,富邦-新營,2024-05-20,9693
2392,正崴,8,1,7,富邦-新營,2024-05-20,9693
4542,科嶠,7,0,7,富邦-新營,2024-05-20,9693
6425,易發,7,0,7,富邦-新營,2024-05-20,9693
00665L,富邦�琤肭磪囓�2,106,0,106,富邦-新營,2024-05-21,9693
00929,復華台灣科技優息,105,4,101,富邦-新營,2024-05-21,9693
2897,王道銀行,54,0,54,富邦-新營,2024-05-21,9693
00940,元大台灣價值高息,45,0,45,富邦-新營,2024-05-21,9693
00878,國泰永續高股息,55,11,44,富邦-新營,2024-05-21,9693
6541,泰福-KY,36,0,36,富邦-新營,2024-05-21,9693
8033,雷虎,43,8,35,富邦-新營,2024-05-21,9693
4533,協易機,68,34,34,富邦-新營,2024-05-21,9693
2374,佳能,358,327,31,富邦-新營,2024-05-21,9693
6005,群益證,31,1,30,富邦-新營,2024-05-21,9693
2312,金寶,32,5,27,富邦-新營,2024-05-21,9693
00753L,中信中國50正2,24,0,24,富邦-新營,2024-05-21,9693
5392,能率,283,260,23,富邦-新營,2024-05-21,9693
00937B,群益ESG投等債20,24,2,22,富邦-新營,2024-05-21,9693
2408,南亞科,22,0,22,富邦-新營,2024-05-21,9693
1609,大亞,22,1,21,富邦-新營,2024-05-21,9693
2607,榮運,21,0,21,富邦-新營,2024-05-21,9693
5371,中光電,24,3,21,富邦-新營,2024-05-21,9693
2344,華邦電,20,1,19,富邦-新營,2024-05-21,9693
0056,元大高股息,20,2,18,富邦-新營,2024-05-21,9693
2324,仁寶,18,0,18,富邦-新營,2024-05-21,9693
1314,中石化,27,11,16,富邦-新營,2024-05-21,9693
3022,威強電,15,0,15,富邦-新營,2024-05-21,9693
6230,尼得科超眾,16,1,15,富邦-新營,2024-05-21,9693
2630,亞航,68,54,14,富邦-新營,2024-05-21,9693
00650L,復華香港正2,13,0,13,富邦-新營,2024-05-21,9693
2353,宏��,14,1,13,富邦-新營,2024-05-21,9693
2888,新光金,12,0,12,富邦-新營,2024-05-21,9693
00891,中信關鍵半導體,11,0,11,富邦-新營,2024-05-21,9693
2367,燿華,365,354,11,富邦-新營,2024-05-21,9693
2880,華南金,11,0,11,富邦-新營,2024-05-21,9693
3437,榮創,11,0,11,富邦-新營,2024-05-21,9693
3712,永崴投控,12,1,11,富邦-新營,2024-05-21,9693
6207,雷科,29,18,11,富邦-新營,2024-05-21,9693
00919,群益台灣精選高息,11,0,11,富邦-新營,2024-05-21,9693
00731,復華富時高息低波,10,0,10,富邦-新營,2024-05-21,9693
2834,臺企銀,10,0,10,富邦-新營,2024-05-21,9693
00637L,元大滬深300正2,10,0,10,富邦-新營,2024-05-21,9693
00688L,國泰20年美債正2,10,0,10,富邦-新營,2024-05-21,9693
2405,輔信,15,5,10,富邦-新營,2024-05-21,9693
2002,中鋼,10,0,10,富邦-新營,2024-05-21,9693
2618,長榮航,43,33,10,富邦-新營,2024-05-21,9693
00751B,元大AAA至A公司債,9,0,9,富邦-新營,2024-05-21,9693
2323,中環,9,0,9,富邦-新營,2024-05-21,9693
2731,雄獅,9,0,9,富邦-新營,2024-05-21,9693
5388,中磊,10,1,9,富邦-新營,2024-05-21,9693
6770,力積電,9,0,9,富邦-新營,2024-05-21,9693
2610,華航,21,13,8,富邦-新營,2024-05-21,9693
00679B,元大美債20年,8,0,8,富邦-新營,2024-05-21,9693
3663,鑫科,8,0,8,富邦-新營,2024-05-21,9693
3450,聯鈞,156,3,153,富邦-新營,2024-05-22,9693
00937B,群益ESG投等債20,84,5,79,富邦-新營,2024-05-22,9693
00940,元大台灣價值高息,80,15,65,富邦-新營,2024-05-22,9693
4533,協易機,85,32,53,富邦-新營,2024-05-22,9693
8076,伍豐,50,0,50,富邦-新營,2024-05-22,9693
2002,中鋼,55,6,49,富邦-新營,2024-05-22,9693
2464,盟立,175,127,48,富邦-新營,2024-05-22,9693
00712,復華富時不動產,60,14,46,富邦-新營,2024-05-22,9693
1605,華新,47,4,43,富邦-新營,2024-05-22,9693
2618,長榮航,48,6,42,富邦-新營,2024-05-22,9693
2634,漢翔,35,1,34,富邦-新營,2024-05-22,9693
2014,中鴻,32,0,32,富邦-新營,2024-05-22,9693
00753L,中信中國50正2,30,0,30,富邦-新營,2024-05-22,9693
2331,精英,35,5,30,富邦-新營,2024-05-22,9693
2323,中環,25,0,25,富邦-新營,2024-05-22,9693
3706,神達,33,9,24,富邦-新營,2024-05-22,9693
00941,中信上游半導體,22,0,22,富邦-新營,2024-05-22,9693
2489,瑞軒,20,0,20,富邦-新營,2024-05-22,9693
2539,櫻花建,20,0,20,富邦-新營,2024-05-22,9693
6443,元晶,20,1,19,富邦-新營,2024-05-22,9693
6125,廣運,33,15,18,富邦-新營,2024-05-22,9693
5351,鈺創,22,5,17,富邦-新營,2024-05-22,9693
2855,統一證,16,0,16,富邦-新營,2024-05-22,9693
3490,單井,17,1,16,富邦-新營,2024-05-22,9693
5392,能率,135,119,16,富邦-新營,2024-05-22,9693
3013,晟銘電,48,33,15,富邦-新營,2024-05-22,9693
00933B,國泰10Y+金融債,15,0,15,富邦-新營,2024-05-22,9693
1609,大亞,19,4,15,富邦-新營,2024-05-22,9693
8110,華東,15,0,15,富邦-新營,2024-05-22,9693
00929,復華台灣科技優息,33,19,14,富邦-新營,2024-05-22,9693
1303,南亞,14,0,14,富邦-新營,2024-05-22,9693
2312,金寶,20,6,14,富邦-新營,2024-05-22,9693
2367,燿華,41,27,14,富邦-新營,2024-05-22,9693
3231,緯創,17,3,14,富邦-新營,2024-05-22,9693
2009,第一銅,145,132,13,富邦-新營,2024-05-22,9693
1909,榮成,12,0,12,富邦-新營,2024-05-22,9693
6190,萬泰科,19,7,12,富邦-新營,2024-05-22,9693
2450,神腦,11,0,11,富邦-新營,2024-05-22,9693
00637L,元大滬深300正2,10,0,10,富邦-新營,2024-05-22,9693
1313,聯成,10,0,10,富邦-新營,2024-05-22,9693
1314,中石化,10,0,10,富邦-新營,2024-05-22,9693
2449,京元電子,10,0,10,富邦-新營,2024-05-22,9693
6120,達運,10,0,10,富邦-新營,2024-05-22,9693
6244,茂迪,11,1,10,富邦-新營,2024-05-22,9693
6834,天二科技,10,0,10,富邦-新營,2024-05-22,9693
2610,華航,11,2,9,富邦-新營,2024-05-22,9693
2241,艾姆勒,21,12,9,富邦-新營,2024-05-22,9693
6116,彩晶,12,3,9,富邦-新營,2024-05-22,9693
8064,東捷,19,10,9,富邦-新營,2024-05-22,9693
2206,三陽工業,10,1,9,富邦-新營,2024-05-22,9693
5371,中光電,313,150,163,富邦-新營,2024-05-23,9693
6188,廣明,160,20,140,富邦-新營,2024-05-23,9693
2371,大同,109,2,107,富邦-新營,2024-05-23,9693
00665L,富邦�琤肭磪囓�2,102,0,102,富邦-新營,2024-05-23,9693
00937B,群益ESG投等債20,78,1,77,富邦-新營,2024-05-23,9693
2392,正崴,257,192,65,富邦-新營,2024-05-23,9693
1815,富喬,118,60,58,富邦-新營,2024-05-23,9693
1314,中石化,51,0,51,富邦-新營,2024-05-23,9693
00712,復華富時不動產,41,0,41,富邦-新營,2024-05-23,9693
2405,輔信,44,4,40,富邦-新營,2024-05-23,9693
00940,元大台灣價值高息,49,10,39,富邦-新營,2024-05-23,9693
2886,兆豐金,35,0,35,富邦-新營,2024-05-23,9693
4513,福裕,35,0,35,富邦-新營,2024-05-23,9693
0056,元大高股息,50,17,33,富邦-新營,2024-05-23,9693
2359,所羅門,226,198,28,富邦-新營,2024-05-23,9693
00753L,中信中國50正2,27,0,27,富邦-新營,2024-05-23,9693
5864,致和證,29,2,27,富邦-新營,2024-05-23,9693
2618,長榮航,35,9,26,富邦-新營,2024-05-23,9693
2356,英業達,29,4,25,富邦-新營,2024-05-23,9693
2344,華邦電,25,1,24,富邦-新營,2024-05-23,9693
2062,橋椿,23,0,23,富邦-新營,2024-05-23,9693
1609,大亞,33,11,22,富邦-新營,2024-05-23,9693
2007,燁興,20,0,20,富邦-新營,2024-05-23,9693
4906,正文,20,0,20,富邦-新營,2024-05-23,9693
8076,伍豐,20,0,20,富邦-新營,2024-05-23,9693
2014,中鴻,17,0,17,富邦-新營,2024-05-23,9693
3312,弘憶股,25,9,16,富邦-新營,2024-05-23,9693
5880,合庫金,22,7,15,富邦-新營,2024-05-23,9693
2542,興富發,15,0,15,富邦-新營,2024-05-23,9693
1568,倉佑,14,0,14,富邦-新營,2024-05-23,9693
2897,王道銀行,14,0,14,富邦-新營,2024-05-23,9693
2892,第一金,13,0,13,富邦-新營,2024-05-23,9693
6217,中探針,13,0,13,富邦-新營,2024-05-23,9693
1303,南亞,13,1,12,富邦-新營,2024-05-23,9693
2002,中鋼,15,3,12,富邦-新營,2024-05-23,9693
3576,聯合再生,12,0,12,富邦-新營,2024-05-23,9693
1304,台聚,11,0,11,富邦-新營,2024-05-23,9693
1789,神隆,11,0,11,富邦-新營,2024-05-23,9693
4938,和碩,14,3,11,富邦-新營,2024-05-23,9693
00650L,復華香港正2,10,0,10,富邦-新營,2024-05-23,9693
2915,潤泰全,10,0,10,富邦-新營,2024-05-23,9693
00918,大華優利高填息30,10,0,10,富邦-新營,2024-05-23,9693
2889,國票金,10,0,10,富邦-新營,2024-05-23,9693
00671R,富邦NASDAQ反1,10,0,10,富邦-新營,2024-05-23,9693
3052,夆典,10,0,10,富邦-新營,2024-05-23,9693
3081,聯亞,10,0,10,富邦-新營,2024-05-23,9693
3322,建舜電,10,0,10,富邦-新營,2024-05-23,9693
5523,豐謙,10,0,10,富邦-新營,2024-05-23,9693
6290,良維,10,0,10,富邦-新營,2024-05-23,9693
8011,台通,10,0,10,富邦-新營,2024-05-23,9693
2615,萬海,265,4,261,富邦-新營,2024-05-24,9693
00946,群益科技高息成長,102,0,102,富邦-新營,2024-05-24,9693
00937B,群益ESG投等債20,82,5,77,富邦-新營,2024-05-24,9693
2365,昆盈,344,268,76,富邦-新營,2024-05-24,9693
1101,台泥,71,1,70,富邦-新營,2024-05-24,9693
3163,波若威,82,17,65,富邦-新營,2024-05-24,9693
6188,廣明,68,14,54,富邦-新營,2024-05-24,9693
2855,統一證,50,0,50,富邦-新營,2024-05-24,9693
2603,長榮,52,12,40,富邦-新營,2024-05-24,9693
00665L,富邦�琤肭磪囓�2,31,0,31,富邦-新營,2024-05-24,9693
2406,國碩,30,0,30,富邦-新營,2024-05-24,9693
6584,南俊國際,23,0,23,富邦-新營,2024-05-24,9693
1609,大亞,28,6,22,富邦-新營,2024-05-24,9693
2002,中鋼,20,0,20,富邦-新營,2024-05-24,9693
00902,中信電池及儲能,20,0,20,富邦-新營,2024-05-24,9693
1810,和成,39,19,20,富邦-新營,2024-05-24,9693
1584,精剛,19,0,19,富邦-新營,2024-05-24,9693
2618,長榮航,20,1,19,富邦-新營,2024-05-24,9693
2891,中信金,23,6,17,富邦-新營,2024-05-24,9693
2367,燿華,56,39,17,富邦-新營,2024-05-24,9693
00712,復華富時不動產,16,0,16,富邦-新營,2024-05-24,9693
6770,力積電,16,0,16,富邦-新營,2024-05-24,9693
3022,威強電,20,5,15,富邦-新營,2024-05-24,9693
2464,盟立,19,5,14,富邦-新營,2024-05-24,9693
00679B,元大美債20年,13,0,13,富邦-新營,2024-05-24,9693
3363,上詮,221,208,13,富邦-新營,2024-05-24,9693
6202,盛群,13,0,13,富邦-新營,2024-05-24,9693
1909,榮成,12,0,12,富邦-新營,2024-05-24,9693
5302,太欣,11,0,11,富邦-新營,2024-05-24,9693
2888,新光金,13,2,11,富邦-新營,2024-05-24,9693
00930,永豐ESG低碳高息,11,1,10,富邦-新營,2024-05-24,9693
00919,群益台灣精選高息,12,2,10,富邦-新營,2024-05-24,9693
1313,聯成,10,0,10,富邦-新營,2024-05-24,9693
2337,旺宏,10,0,10,富邦-新營,2024-05-24,9693
8076,伍豐,10,0,10,富邦-新營,2024-05-24,9693
3013,晟銘電,24,14,10,富邦-新營,2024-05-24,9693
2208,台船,9,0,9,富邦-新營,2024-05-24,9693
3037,欣興,10,1,9,富邦-新營,2024-05-24,9693
2450,神腦,8,0,8,富邦-新營,2024-05-24,9693
6609,瀧澤科,8,0,8,富邦-新營,2024-05-24,9693
5515,建國,7,0,7,富邦-新營,2024-05-24,9693
00637L,元大滬深300正2,7,0,7,富邦-新營,2024-05-24,9693
3221,台嘉碩,8,1,7,富邦-新營,2024-05-24,9693
3430,奇鈦科,7,0,7,富邦-新營,2024-05-24,9693
4960,誠美材,7,0,7,富邦-新營,2024-05-24,9693
5432,新門,8,1,7,富邦-新營,2024-05-24,9693
8034,榮群,7,0,7,富邦-新營,2024-05-24,9693
2201,裕隆,7,0,7,富邦-新營,2024-05-24,9693
1904,正隆,6,0,6,富邦-新營,2024-05-24,9693
2017,官田鋼,6,0,6,富邦-新營,2024-05-24,9693
2855,統一證,304,0,304,富邦-新營,2024-05-27,9693
3306,鼎天,105,7,98,富邦-新營,2024-05-27,9693
6197,佳必琪,162,80,82,富邦-新營,2024-05-27,9693
2382,廣達,52,11,41,富邦-新營,2024-05-27,9693
00937B,群益ESG投等債20,38,0,38,富邦-新營,2024-05-27,9693
9105,泰金寶-DR,37,5,32,富邦-新營,2024-05-27,9693
00753L,中信中國50正2,32,0,32,富邦-新營,2024-05-27,9693
6550,北極星藥業-KY,30,0,30,富邦-新營,2024-05-27,9693
1815,富喬,41,14,27,富邦-新營,2024-05-27,9693
00946,群益科技高息成長,24,0,24,富邦-新營,2024-05-27,9693
3047,訊舟,673,649,24,富邦-新營,2024-05-27,9693
3631,晟楠,22,0,22,富邦-新營,2024-05-27,9693
00712,復華富時不動產,21,0,21,富邦-新營,2024-05-27,9693
2002,中鋼,21,1,20,富邦-新營,2024-05-27,9693
3234,光環,20,2,18,富邦-新營,2024-05-27,9693
5880,合庫金,18,0,18,富邦-新營,2024-05-27,9693
2344,華邦電,16,0,16,富邦-新營,2024-05-27,9693
4806,桂田文創,15,0,15,富邦-新營,2024-05-27,9693
2353,宏��,210,196,14,富邦-新營,2024-05-27,9693
2543,皇昌,14,0,14,富邦-新營,2024-05-27,9693
3338,泰碩,16,2,14,富邦-新營,2024-05-27,9693
00933B,國泰10Y+金融債,14,0,14,富邦-新營,2024-05-27,9693
2014,中鴻,13,0,13,富邦-新營,2024-05-27,9693
4542,科嶠,13,0,13,富邦-新營,2024-05-27,9693
6292,迅德,13,0,13,富邦-新營,2024-05-27,9693
5876,上海商銀,12,0,12,富邦-新營,2024-05-27,9693
5302,太欣,13,1,12,富邦-新營,2024-05-27,9693
5498,凱崴,26,14,12,富邦-新營,2024-05-27,9693
1524,耿鼎,11,0,11,富邦-新營,2024-05-27,9693
2483,百容,11,0,11,富邦-新營,2024-05-27,9693
5340,建榮,11,1,10,富邦-新營,2024-05-27,9693
00899,FT潔淨能源,10,0,10,富邦-新營,2024-05-27,9693
2374,佳能,10,0,10,富邦-新營,2024-05-27,9693
3060,銘異,13,3,10,富邦-新營,2024-05-27,9693
4414,如興,10,0,10,富邦-新營,2024-05-27,9693
00885,富邦越南,11,2,9,富邦-新營,2024-05-27,9693
2617,台航,10,1,9,富邦-新營,2024-05-27,9693
00897,富邦基因免疫生技,8,0,8,富邦-新營,2024-05-27,9693
8028,昇陽半導體,35,27,8,富邦-新營,2024-05-27,9693
6125,廣運,30,23,7,富邦-新營,2024-05-27,9693
6153,嘉聯益,7,0,7,富邦-新營,2024-05-27,9693
3163,波若威,11,4,7,富邦-新營,2024-05-27,9693
2801,彰銀,6,0,6,富邦-新營,2024-05-27,9693
2611,志信,11,5,6,富邦-新營,2024-05-27,9693
2812,台中銀,6,0,6,富邦-新營,2024-05-27,9693
6016,康和證,7,1,6,富邦-新營,2024-05-27,9693
8234,新漢,6,0,6,富邦-新營,2024-05-27,9693
8358,金居,8,2,6,富邦-新營,2024-05-27,9693
5474,聰泰,8,2,6,富邦-新營,2024-05-27,9693
3062,建漢,7,1,6,富邦-新營,2024-05-27,9693
3455,由田,117,25,92,富邦-新營,2024-05-28,9693
00937B,群益ESG投等債20,108,30,78,富邦-新營,2024-05-28,9693
2353,宏��,61,19,42,富邦-新營,2024-05-28,9693
00929,復華台灣科技優息,39,0,39,富邦-新營,2024-05-28,9693
6005,群益證,35,0,35,富邦-新營,2024-05-28,9693
2891,中信金,35,2,33,富邦-新營,2024-05-28,9693
2812,台中銀,30,0,30,富邦-新營,2024-05-28,9693
5871,中租-KY,29,1,28,富邦-新營,2024-05-28,9693
2609,陽明,34,7,27,富邦-新營,2024-05-28,9693
2002,中鋼,26,2,24,富邦-新營,2024-05-28,9693
00933B,國泰10Y+金融債,23,0,23,富邦-新營,2024-05-28,9693
2312,金寶,23,0,23,富邦-新營,2024-05-28,9693
9105,泰金寶-DR,42,20,22,富邦-新營,2024-05-28,9693
2610,華航,35,13,22,富邦-新營,2024-05-28,9693
2313,華通,21,0,21,富邦-新營,2024-05-28,9693
3450,聯鈞,135,114,21,富邦-新營,2024-05-28,9693
00712,復華富時不動產,21,0,21,富邦-新營,2024-05-28,9693
2363,矽統,32,12,20,富邦-新營,2024-05-28,9693
2464,盟立,50,32,18,富邦-新營,2024-05-28,9693
3631,晟楠,18,0,18,富邦-新營,2024-05-28,9693
2354,鴻準,290,274,16,富邦-新營,2024-05-28,9693
3202,樺晟,16,0,16,富邦-新營,2024-05-28,9693
8064,東捷,261,245,16,富邦-新營,2024-05-28,9693
2301,光寶科,21,5,16,富邦-新營,2024-05-28,9693
00946,群益科技高息成長,15,0,15,富邦-新營,2024-05-28,9693
1216,統一,15,0,15,富邦-新營,2024-05-28,9693
3055,蔚華科,18,3,15,富邦-新營,2024-05-28,9693
3481,群創,18,3,15,富邦-新營,2024-05-28,9693
3594,磐儀,22,8,14,富邦-新營,2024-05-28,9693
5302,太欣,15,1,14,富邦-新營,2024-05-28,9693
8271,宇瞻,20,7,13,富邦-新營,2024-05-28,9693
3324,雙鴻,17,6,11,富邦-新營,2024-05-28,9693
00940,元大台灣價值高息,18,7,11,富邦-新營,2024-05-28,9693
3006,晶豪科,11,0,11,富邦-新營,2024-05-28,9693
3059,華晶科,11,0,11,富邦-新營,2024-05-28,9693
9955,佳龍,11,0,11,富邦-新營,2024-05-28,9693
00679B,元大美債20年,12,2,10,富邦-新營,2024-05-28,9693
00643,群益深証中小,10,0,10,富邦-新營,2024-05-28,9693
00639,富邦深100,10,0,10,富邦-新營,2024-05-28,9693
00637L,元大滬深300正2,10,0,10,富邦-新營,2024-05-28,9693
00892,富邦台灣半導體,10,0,10,富邦-新營,2024-05-28,9693
00909,國泰數位支付服務,10,0,10,富邦-新營,2024-05-28,9693
2101,南港,10,0,10,富邦-新營,2024-05-28,9693
2615,萬海,14,4,10,富邦-新營,2024-05-28,9693
3466,德晉,10,1,9,富邦-新營,2024-05-28,9693
6292,迅德,9,0,9,富邦-新營,2024-05-28,9693
2462,良得電,10,1,9,富邦-新營,2024-05-28,9693
1513,中興電,8,0,8,富邦-新營,2024-05-28,9693
3576,聯合再生,10,2,8,富邦-新營,2024-05-28,9693
4533,協易機,19,11,8,富邦-新營,2024-05-28,9693
00937B,群益ESG投等債20,203,35,168,富邦-新營,2024-05-29,9693
00679B,元大美債20年,93,0,93,富邦-新營,2024-05-29,9693
00753L,中信中國50正2,77,0,77,富邦-新營,2024-05-29,9693
2353,宏��,95,23,72,富邦-新營,2024-05-29,9693
00946,群益科技高息成長,64,0,64,富邦-新營,2024-05-29,9693
2401,凌陽,78,14,64,富邦-新營,2024-05-29,9693
3047,訊舟,83,20,63,富邦-新營,2024-05-29,9693
3013,晟銘電,70,10,60,富邦-新營,2024-05-29,9693
00919,群益台灣精選高息,64,6,58,富邦-新營,2024-05-29,9693
00665L,富邦�琤肭磪囓�2,52,0,52,富邦-新營,2024-05-29,9693
2486,一詮,44,3,41,富邦-新營,2024-05-29,9693
2485,兆赫,40,0,40,富邦-新營,2024-05-29,9693
00878,國泰永續高股息,46,8,38,富邦-新營,2024-05-29,9693
2867,三商壽,36,2,34,富邦-新營,2024-05-29,9693
2464,盟立,35,4,31,富邦-新營,2024-05-29,9693
2892,第一金,29,0,29,富邦-新營,2024-05-29,9693
2891,中信金,28,1,27,富邦-新營,2024-05-29,9693
6005,群益證,26,0,26,富邦-新營,2024-05-29,9693
6227,茂綸,46,20,26,富邦-新營,2024-05-29,9693
2017,官田鋼,25,0,25,富邦-新營,2024-05-29,9693
00687B,國泰20年美債,22,0,22,富邦-新營,2024-05-29,9693
6189,豐藝,23,2,21,富邦-新營,2024-05-29,9693
8234,新漢,23,2,21,富邦-新營,2024-05-29,9693
00651R,復華香港反1,20,0,20,富邦-新營,2024-05-29,9693
3372,典範,25,5,20,富邦-新營,2024-05-29,9693
2002,中鋼,19,0,19,富邦-新營,2024-05-29,9693
2314,台揚,21,2,19,富邦-新營,2024-05-29,9693
6462,神盾,19,1,18,富邦-新營,2024-05-29,9693
00933B,國泰10Y+金融債,18,0,18,富邦-新營,2024-05-29,9693
2317,鴻海,27,9,18,富邦-新營,2024-05-29,9693
00712,復華富時不動產,17,0,17,富邦-新營,2024-05-29,9693
1303,南亞,17,0,17,富邦-新營,2024-05-29,9693
2887,台新金,17,0,17,富邦-新營,2024-05-29,9693
6125,廣運,32,16,16,富邦-新營,2024-05-29,9693
2328,廣宇,27,11,16,富邦-新營,2024-05-29,9693
3466,德晉,16,0,16,富邦-新營,2024-05-29,9693
00940,元大台灣價值高息,17,1,16,富邦-新營,2024-05-29,9693
1532,勤美,15,0,15,富邦-新營,2024-05-29,9693
8933,愛地雅,15,0,15,富邦-新營,2024-05-29,9693
2882,國泰金,16,1,15,富邦-新營,2024-05-29,9693
00896,中信綠能及電動車,14,0,14,富邦-新營,2024-05-29,9693
3380,明泰,51,37,14,富邦-新營,2024-05-29,9693
2614,東森,12,0,12,富邦-新營,2024-05-29,9693
2605,新興,181,169,12,富邦-新營,2024-05-29,9693
5498,凱崴,13,1,12,富邦-新營,2024-05-29,9693
3059,華晶科,12,0,12,富邦-新營,2024-05-29,9693
00915,凱基優選高股息30,11,0,11,富邦-新營,2024-05-29,9693
00752,中信中國50,11,0,11,富邦-新營,2024-05-29,9693
2884,玉山金,12,1,11,富邦-新營,2024-05-29,9693
3450,聯鈞,19,8,11,富邦-新營,2024-05-29,9693
00937B,群益ESG投等債20,150,10,140,富邦-新營,2024-05-30,9693
00688L,國泰20年美債正2,63,0,63,富邦-新營,2024-05-30,9693
00632R,元大台灣50反1,50,0,50,富邦-新營,2024-05-30,9693
1316,上曜,57,9,48,富邦-新營,2024-05-30,9693
4533,協易機,71,29,42,富邦-新營,2024-05-30,9693
00665L,富邦�琤肭磪囓�2,41,0,41,富邦-新營,2024-05-30,9693
2405,輔信,76,35,41,富邦-新營,2024-05-30,9693
00946,群益科技高息成長,41,2,39,富邦-新營,2024-05-30,9693
2002,中鋼,35,0,35,富邦-新營,2024-05-30,9693
3450,聯鈞,37,3,34,富邦-新營,2024-05-30,9693
00878,國泰永續高股息,29,1,28,富邦-新營,2024-05-30,9693
1815,富喬,269,241,28,富邦-新營,2024-05-30,9693
2317,鴻海,42,16,26,富邦-新營,2024-05-30,9693
2363,矽統,34,11,23,富邦-新營,2024-05-30,9693
2303,聯電,35,13,22,富邦-新營,2024-05-30,9693
2892,第一金,22,0,22,富邦-新營,2024-05-30,9693
00933B,國泰10Y+金融債,20,0,20,富邦-新營,2024-05-30,9693
2610,華航,23,3,20,富邦-新營,2024-05-30,9693
2883,凱基金,21,1,20,富邦-新營,2024-05-30,9693
2330,台積電,20,0,20,富邦-新營,2024-05-30,9693
00881,國泰台灣5G+,19,0,19,富邦-新營,2024-05-30,9693
2609,陽明,19,2,17,富邦-新營,2024-05-30,9693
00687B,國泰20年美債,19,2,17,富邦-新營,2024-05-30,9693
2354,鴻準,30,13,17,富邦-新營,2024-05-30,9693
2633,台灣高鐵,17,0,17,富邦-新營,2024-05-30,9693
1303,南亞,16,0,16,富邦-新營,2024-05-30,9693
8054,安國,19,3,16,富邦-新營,2024-05-30,9693
6005,群益證,15,0,15,富邦-新營,2024-05-30,9693
5508,永信建,18,3,15,富邦-新營,2024-05-30,9693
6435,大中,16,1,15,富邦-新營,2024-05-30,9693
00679B,元大美債20年,19,5,14,富邦-新營,2024-05-30,9693
8438,昶昕,18,4,14,富邦-新營,2024-05-30,9693
00712,復華富時不動產,15,1,14,富邦-新營,2024-05-30,9693
2489,瑞軒,55,42,13,富邦-新營,2024-05-30,9693
2834,臺企銀,14,2,12,富邦-新營,2024-05-30,9693
00753L,中信中國50正2,12,0,12,富邦-新營,2024-05-30,9693
2498,宏達電,12,0,12,富邦-新營,2024-05-30,9693
2538,基泰,16,4,12,富邦-新營,2024-05-30,9693
6275,元山,12,0,12,富邦-新營,2024-05-30,9693
2344,華邦電,12,1,11,富邦-新營,2024-05-30,9693
4562,穎漢,12,1,11,富邦-新營,2024-05-30,9693
2353,宏��,29,18,11,富邦-新營,2024-05-30,9693
3005,神基,11,0,11,富邦-新營,2024-05-30,9693
2356,英業達,15,5,10,富邦-新營,2024-05-30,9693
2867,三商壽,10,0,10,富邦-新營,2024-05-30,9693
6462,神盾,12,2,10,富邦-新營,2024-05-30,9693
3022,威強電,10,0,10,富邦-新營,2024-05-30,9693
00915,凱基優選高股息30,11,1,10,富邦-新營,2024-05-30,9693
2537,聯上發,10,0,10,富邦-新營,2024-05-30,9693
3354,律勝,10,0,10,富邦-新營,2024-05-30,9693
00929,復華台灣科技優息,289,6,283,富邦-新營,2024-05-31,9693
6125,廣運,328,67,261,富邦-新營,2024-05-31,9693
00650L,復華香港正2,175,2,173,富邦-新營,2024-05-31,9693
1314,中石化,90,0,90,富邦-新營,2024-05-31,9693
2609,陽明,147,91,56,富邦-新營,2024-05-31,9693
2331,精英,52,1,51,富邦-新營,2024-05-31,9693
2409,友達,42,0,42,富邦-新營,2024-05-31,9693
4549,桓達,41,0,41,富邦-新營,2024-05-31,9693
00922,國泰台灣領袖50,38,0,38,富邦-新營,2024-05-31,9693
2485,兆赫,33,0,33,富邦-新營,2024-05-31,9693
2615,萬海,34,3,31,富邦-新營,2024-05-31,9693
00946,群益科技高息成長,30,0,30,富邦-新營,2024-05-31,9693
00665L,富邦�琤肭磪囓�2,50,20,30,富邦-新營,2024-05-31,9693
4973,廣穎,30,0,30,富邦-新營,2024-05-31,9693
2330,台積電,30,0,30,富邦-新營,2024-05-31,9693
2353,宏��,34,4,30,富邦-新營,2024-05-31,9693
2317,鴻海,36,6,30,富邦-新營,2024-05-31,9693
2365,昆盈,31,3,28,富邦-新營,2024-05-31,9693
3312,弘憶股,55,27,28,富邦-新營,2024-05-31,9693
2504,國產,25,0,25,富邦-新營,2024-05-31,9693
00881,國泰台灣5G+,22,0,22,富邦-新營,2024-05-31,9693
00919,群益台灣精選高息,22,2,20,富邦-新營,2024-05-31,9693
00933B,國泰10Y+金融債,20,0,20,富邦-新營,2024-05-31,9693
2363,矽統,20,1,19,富邦-新營,2024-05-31,9693
3231,緯創,23,4,19,富邦-新營,2024-05-31,9693
3687,歐買尬,21,4,17,富邦-新營,2024-05-31,9693
2382,廣達,17,1,16,富邦-新營,2024-05-31,9693
00918,大華優利高填息30,16,0,16,富邦-新營,2024-05-31,9693
2356,英業達,20,5,15,富邦-新營,2024-05-31,9693
2332,友訊,15,0,15,富邦-新營,2024-05-31,9693
00923,群益台ESG低碳50,14,0,14,富邦-新營,2024-05-31,9693
3380,明泰,14,0,14,富邦-新營,2024-05-31,9693
2344,華邦電,14,1,13,富邦-新營,2024-05-31,9693
2889,國票金,13,0,13,富邦-新營,2024-05-31,9693
1815,富喬,34,22,12,富邦-新營,2024-05-31,9693
2101,南港,22,11,11,富邦-新營,2024-05-31,9693
1442,名軒,10,0,10,富邦-新營,2024-05-31,9693
00679B,元大美債20年,15,5,10,富邦-新營,2024-05-31,9693
2002,中鋼,13,3,10,富邦-新營,2024-05-31,9693
3236,千如,10,0,10,富邦-新營,2024-05-31,9693
6213,聯茂,11,1,10,富邦-新營,2024-05-31,9693
8050,廣積,10,0,10,富邦-新營,2024-05-31,9693
8071,能率網通,10,0,10,富邦-新營,2024-05-31,9693
8076,伍豐,10,0,10,富邦-新營,2024-05-31,9693
9955,佳龍,10,0,10,富邦-新營,2024-05-31,9693
2301,光寶科,18,8,10,富邦-新營,2024-05-31,9693
2324,仁寶,22,12,10,富邦-新營,2024-05-31,9693
1227,佳格,10,1,9,富邦-新營,2024-05-31,9693
3712,永崴投控,9,0,9,富邦-新營,2024-05-31,9693
6160,欣技,10,1,9,富邦-新營,2024-05-31,9693
1815,富喬,600,168,432,富邦-新營,2024-06-03,9693
3013,晟銘電,162,34,128,富邦-新營,2024-06-03,9693
6173,信昌電,80,0,80,富邦-新營,2024-06-03,9693
2344,華邦電,82,5,77,富邦-新營,2024-06-03,9693
4533,協易機,107,47,60,富邦-新營,2024-06-03,9693
1316,上曜,52,0,52,富邦-新營,2024-06-03,9693
2867,三商壽,60,10,50,富邦-新營,2024-06-03,9693
2331,精英,50,1,49,富邦-新營,2024-06-03,9693
2855,統一證,45,0,45,富邦-新營,2024-06-03,9693
3481,群創,41,9,32,富邦-新營,2024-06-03,9693
2365,昆盈,32,1,31,富邦-新營,2024-06-03,9693
1616,億泰,30,0,30,富邦-新營,2024-06-03,9693
00929,復華台灣科技優息,36,6,30,富邦-新營,2024-06-03,9693
9105,泰金寶-DR,29,0,29,富邦-新營,2024-06-03,9693
6175,立敦,26,0,26,富邦-新營,2024-06-03,9693
00937B,群益ESG投等債20,24,3,21,富邦-新營,2024-06-03,9693
00676R,富邦臺灣加權反1,20,0,20,富邦-新營,2024-06-03,9693
4973,廣穎,19,0,19,富邦-新營,2024-06-03,9693
6125,廣運,20,1,19,富邦-新營,2024-06-03,9693
00919,群益台灣精選高息,17,0,17,富邦-新營,2024-06-03,9693
2353,宏��,23,7,16,富邦-新營,2024-06-03,9693
2801,彰銀,15,0,15,富邦-新營,2024-06-03,9693
00918,大華優利高填息30,16,1,15,富邦-新營,2024-06-03,9693
2317,鴻海,22,7,15,富邦-新營,2024-06-03,9693
5880,合庫金,14,0,14,富邦-新營,2024-06-03,9693
4960,誠美材,13,0,13,富邦-新營,2024-06-03,9693
5355,佳總,13,0,13,富邦-新營,2024-06-03,9693
2618,長榮航,39,27,12,富邦-新營,2024-06-03,9693
1101,台泥,12,0,12,富邦-新營,2024-06-03,9693
2495,普安,12,0,12,富邦-新營,2024-06-03,9693
2880,華南金,12,0,12,富邦-新營,2024-06-03,9693
8163,達方,13,1,12,富邦-新營,2024-06-03,9693
2337,旺宏,11,0,11,富邦-新營,2024-06-03,9693
2338,光罩,11,0,11,富邦-新營,2024-06-03,9693
2371,大同,11,0,11,富邦-新營,2024-06-03,9693
2504,國產,11,1,10,富邦-新營,2024-06-03,9693
1312,國喬,10,0,10,富邦-新營,2024-06-03,9693
2450,神腦,10,0,10,富邦-新營,2024-06-03,9693
00679B,元大美債20年,13,3,10,富邦-新營,2024-06-03,9693
2313,華通,9,0,9,富邦-新營,2024-06-03,9693
2301,光寶科,15,6,9,富邦-新營,2024-06-03,9693
6204,艾華,10,1,9,富邦-新營,2024-06-03,9693
5493,三聯,9,0,9,富邦-新營,2024-06-03,9693
2241,艾姆勒,9,1,8,富邦-新營,2024-06-03,9693
2329,華泰,9,1,8,富邦-新營,2024-06-03,9693
2363,矽統,8,0,8,富邦-新營,2024-06-03,9693
2405,輔信,12,4,8,富邦-新營,2024-06-03,9693
0050,元大台灣50,8,1,7,富邦-新營,2024-06-03,9693
00715L,期街口布蘭特正2,7,0,7,富邦-新營,2024-06-03,9693
00939,統一台灣高息動能,7,0,7,富邦-新營,2024-06-03,9693
6173,信昌電,167,0,167,富邦-新營,2024-06-04,9693
00919,群益台灣精選高息,147,2,145,富邦-新營,2024-06-04,9693
3013,晟銘電,154,36,118,富邦-新營,2024-06-04,9693
2453,凌群,117,4,113,富邦-新營,2024-06-04,9693
2888,新光金,61,1,60,富邦-新營,2024-06-04,9693
2317,鴻海,63,4,59,富邦-新營,2024-06-04,9693
3062,建漢,52,5,47,富邦-新營,2024-06-04,9693
2409,友達,49,3,46,富邦-新營,2024-06-04,9693
2312,金寶,72,29,43,富邦-新營,2024-06-04,9693
6005,群益證,39,0,39,富邦-新營,2024-06-04,9693
00929,復華台灣科技優息,130,93,37,富邦-新營,2024-06-04,9693
5355,佳總,35,0,35,富邦-新營,2024-06-04,9693
3481,群創,37,3,34,富邦-新營,2024-06-04,9693
00922,國泰台灣領袖50,40,6,34,富邦-新營,2024-06-04,9693
4562,穎漢,32,0,32,富邦-新營,2024-06-04,9693
1314,中石化,30,0,30,富邦-新營,2024-06-04,9693
00715L,期街口布蘭特正2,27,0,27,富邦-新營,2024-06-04,9693
2324,仁寶,34,7,27,富邦-新營,2024-06-04,9693
5864,致和證,25,0,25,富邦-新營,2024-06-04,9693
9105,泰金寶-DR,25,0,25,富邦-新營,2024-06-04,9693
00936,台新永續高息中小,26,2,24,富邦-新營,2024-06-04,9693
00753L,中信中國50正2,23,0,23,富邦-新營,2024-06-04,9693
2344,華邦電,28,6,22,富邦-新營,2024-06-04,9693
2303,聯電,25,4,21,富邦-新營,2024-06-04,9693
6116,彩晶,21,0,21,富邦-新營,2024-06-04,9693
2323,中環,20,0,20,富邦-新營,2024-06-04,9693
6016,康和證,20,0,20,富邦-新營,2024-06-04,9693
4533,協易機,274,255,19,富邦-新營,2024-06-04,9693
2002,中鋼,19,1,18,富邦-新營,2024-06-04,9693
2349,錸德,21,3,18,富邦-新營,2024-06-04,9693
1605,華新,16,0,16,富邦-新營,2024-06-04,9693
2365,昆盈,18,2,16,富邦-新營,2024-06-04,9693
2301,光寶科,20,5,15,富邦-新營,2024-06-04,9693
2371,大同,15,0,15,富邦-新營,2024-06-04,9693
2537,聯上發,32,18,14,富邦-新營,2024-06-04,9693
3027,盛達,14,0,14,富邦-新營,2024-06-04,9693
3260,威剛,16,4,12,富邦-新營,2024-06-04,9693
1101,台泥,13,1,12,富邦-新營,2024-06-04,9693
1785,光洋科,12,0,12,富邦-新營,2024-06-04,9693
2605,新興,12,0,12,富邦-新營,2024-06-04,9693
3017,奇鋐,11,0,11,富邦-新營,2024-06-04,9693
3231,緯創,13,2,11,富邦-新營,2024-06-04,9693
2332,友訊,11,0,11,富邦-新營,2024-06-04,9693
3086,華義,11,0,11,富邦-新營,2024-06-04,9693
2330,台積電,11,0,11,富邦-新營,2024-06-04,9693
2408,南亞科,11,1,10,富邦-新營,2024-06-04,9693
1909,榮成,10,0,10,富邦-新營,2024-06-04,9693
6451,訊芯-KY,11,1,10,富邦-新營,2024-06-04,9693
00918,大華優利高填息30,11,1,10,富邦-新營,2024-06-04,9693
2495,普安,22,13,9,富邦-新營,2024-06-04,9693
00936,台新永續高息中小,101,3,98,富邦-新營,2024-06-05,9693
00929,復華台灣科技優息,106,9,97,富邦-新營,2024-06-05,9693
00650L,復華香港正2,90,0,90,富邦-新營,2024-06-05,9693
2855,統一證,45,0,45,富邦-新營,2024-06-05,9693
00878,國泰永續高股息,50,7,43,富邦-新營,2024-06-05,9693
2303,聯電,40,0,40,富邦-新營,2024-06-05,9693
6116,彩晶,40,0,40,富邦-新營,2024-06-05,9693
1314,中石化,30,0,30,富邦-新營,2024-06-05,9693
2888,新光金,31,2,29,富邦-新營,2024-06-05,9693
2324,仁寶,29,7,22,富邦-新營,2024-06-05,9693
6120,達運,21,0,21,富邦-新營,2024-06-05,9693
4533,協易機,35,15,20,富邦-新營,2024-06-05,9693
2417,圓剛,33,13,20,富邦-新營,2024-06-05,9693
2801,彰銀,21,2,19,富邦-新營,2024-06-05,9693
3324,雙鴻,29,11,18,富邦-新營,2024-06-05,9693
00919,群益台灣精選高息,17,0,17,富邦-新營,2024-06-05,9693
2328,廣宇,25,9,16,富邦-新營,2024-06-05,9693
00715L,期街口布蘭特正2,15,0,15,富邦-新營,2024-06-05,9693
00939,統一台灣高息動能,14,0,14,富邦-新營,2024-06-05,9693
00645,富邦日本,14,0,14,富邦-新營,2024-06-05,9693
2489,瑞軒,14,1,13,富邦-新營,2024-06-05,9693
3576,聯合再生,16,3,13,富邦-新營,2024-06-05,9693
1301,台塑,15,3,12,富邦-新營,2024-06-05,9693
2889,國票金,23,11,12,富邦-新營,2024-06-05,9693
3048,益登,18,6,12,富邦-新營,2024-06-05,9693
2313,華通,12,0,12,富邦-新營,2024-06-05,9693
2409,友達,12,0,12,富邦-新營,2024-06-05,9693
2401,凌陽,11,0,11,富邦-新營,2024-06-05,9693
2543,皇昌,12,1,11,富邦-新營,2024-06-05,9693
5880,合庫金,11,0,11,富邦-新營,2024-06-05,9693
3013,晟銘電,21,10,11,富邦-新營,2024-06-05,9693
00764B,群益25年美債,10,0,10,富邦-新營,2024-06-05,9693
4806,桂田文創,10,0,10,富邦-新營,2024-06-05,9693
6016,康和證,10,0,10,富邦-新營,2024-06-05,9693
6173,信昌電,10,0,10,富邦-新營,2024-06-05,9693
6112,邁達特,10,0,10,富邦-新營,2024-06-05,9693
00881,國泰台灣5G+,9,0,9,富邦-新營,2024-06-05,9693
00696B,富邦美債20年,10,1,9,富邦-新營,2024-06-05,9693
00918,大華優利高填息30,8,0,8,富邦-新營,2024-06-05,9693
2349,錸德,8,0,8,富邦-新營,2024-06-05,9693
2367,燿華,13,5,8,富邦-新營,2024-06-05,9693
3356,奇偶,9,1,8,富邦-新營,2024-06-05,9693
9105,泰金寶-DR,8,0,8,富邦-新營,2024-06-05,9693
3312,弘憶股,11,3,8,富邦-新營,2024-06-05,9693
00712,復華富時不動產,7,0,7,富邦-新營,2024-06-05,9693
0056,元大高股息,8,1,7,富邦-新營,2024-06-05,9693
2359,所羅門,8,1,7,富邦-新營,2024-06-05,9693
00637L,元大滬深300正2,7,0,7,富邦-新營,2024-06-05,9693
1324,地球,7,0,7,富邦-新營,2024-06-05,9693
2362,藍天,7,0,7,富邦-新營,2024-06-05,9693
1802,台玻,503,0,503,富邦-新營,2024-06-06,9693
00919,群益台灣精選高息,116,14,102,富邦-新營,2024-06-06,9693
00680L,元大美債20正2,100,0,100,富邦-新營,2024-06-06,9693
00946,群益科技高息成長,81,0,81,富邦-新營,2024-06-06,9693
00864B,中信美國公債0-1,73,0,73,富邦-新營,2024-06-06,9693
00936,台新永續高息中小,73,0,73,富邦-新營,2024-06-06,9693
00665L,富邦�琤肭磪囓�2,60,0,60,富邦-新營,2024-06-06,9693
3376,新日興,56,6,50,富邦-新營,2024-06-06,9693
2312,金寶,79,36,43,富邦-新營,2024-06-06,9693
3706,神達,41,1,40,富邦-新營,2024-06-06,9693
00918,大華優利高填息30,37,0,37,富邦-新營,2024-06-06,9693
00753L,中信中國50正2,47,12,35,富邦-新營,2024-06-06,9693
2354,鴻準,47,17,30,富邦-新營,2024-06-06,9693
3051,力特,25,0,25,富邦-新營,2024-06-06,9693
2365,昆盈,27,3,24,富邦-新營,2024-06-06,9693
6770,力積電,23,0,23,富邦-新營,2024-06-06,9693
2353,宏��,31,9,22,富邦-新營,2024-06-06,9693
1815,富喬,52,30,22,富邦-新營,2024-06-06,9693
2317,鴻海,47,27,20,富邦-新營,2024-06-06,9693
2356,英業達,22,2,20,富邦-新營,2024-06-06,9693
6418,詠昇,20,0,20,富邦-新營,2024-06-06,9693
2537,聯上發,24,5,19,富邦-新營,2024-06-06,9693
5351,鈺創,20,1,19,富邦-新營,2024-06-06,9693
2338,光罩,17,0,17,富邦-新營,2024-06-06,9693
4533,協易機,17,1,16,富邦-新營,2024-06-06,9693
5864,致和證,18,2,16,富邦-新營,2024-06-06,9693
2609,陽明,468,452,16,富邦-新營,2024-06-06,9693
5009,榮剛,15,0,15,富邦-新營,2024-06-06,9693
3231,緯創,24,10,14,富邦-新營,2024-06-06,9693
1504,東元,20,6,14,富邦-新營,2024-06-06,9693
6546,正基,16,2,14,富邦-新營,2024-06-06,9693
00942B,台新美A公司債20+,14,1,13,富邦-新營,2024-06-06,9693
2363,矽統,14,1,13,富邦-新營,2024-06-06,9693
00687B,國泰20年美債,13,0,13,富邦-新營,2024-06-06,9693
1303,南亞,13,1,12,富邦-新營,2024-06-06,9693
6541,泰福-KY,12,0,12,富邦-新營,2024-06-06,9693
2324,仁寶,21,9,12,富邦-新營,2024-06-06,9693
5347,世界,23,13,10,富邦-新營,2024-06-06,9693
3025,星通,10,0,10,富邦-新營,2024-06-06,9693
00671R,富邦NASDAQ反1,10,0,10,富邦-新營,2024-06-06,9693
00650L,復華香港正2,12,2,10,富邦-新營,2024-06-06,9693
00645,富邦日本,10,0,10,富邦-新營,2024-06-06,9693
2495,普安,10,0,10,富邦-新營,2024-06-06,9693
2612,中航,10,0,10,富邦-新營,2024-06-06,9693
2883B,凱基金乙特,10,0,10,富邦-新營,2024-06-06,9693
3591,艾笛森,10,0,10,富邦-新營,2024-06-06,9693
2611,志信,49,42,7,富邦-新營,2024-06-06,9693
4513,福裕,8,1,7,富邦-新營,2024-06-06,9693
6841,長佳智能,7,0,7,富邦-新營,2024-06-06,9693
1304,台聚,6,0,6,富邦-新營,2024-06-06,9693
3122,笙泉,206,88,118,富邦-新營,2024-06-07,9693
00918,大華優利高填息30,74,0,74,富邦-新營,2024-06-07,9693
3455,由田,151,84,67,富邦-新營,2024-06-07,9693
00929,復華台灣科技優息,74,11,63,富邦-新營,2024-06-07,9693
8064,東捷,52,0,52,富邦-新營,2024-06-07,9693
3481,群創,63,15,48,富邦-新營,2024-06-07,9693
2312,金寶,60,13,47,富邦-新營,2024-06-07,9693
00936,台新永續高息中小,46,0,46,富邦-新營,2024-06-07,9693
00882,中信中國高股息,40,0,40,富邦-新營,2024-06-07,9693
3231,緯創,38,1,37,富邦-新營,2024-06-07,9693
2610,華航,42,6,36,富邦-新營,2024-06-07,9693
00753L,中信中國50正2,35,0,35,富邦-新營,2024-06-07,9693
00680L,元大美債20正2,32,0,32,富邦-新營,2024-06-07,9693
00688L,國泰20年美債正2,30,0,30,富邦-新營,2024-06-07,9693
5512,力麒,35,7,28,富邦-新營,2024-06-07,9693
2834,臺企銀,40,12,28,富邦-新營,2024-06-07,9693
2615,萬海,122,95,27,富邦-新營,2024-06-07,9693
2367,燿華,32,8,24,富邦-新營,2024-06-07,9693
2356,英業達,24,1,23,富邦-新營,2024-06-07,9693
1101,台泥,26,3,23,富邦-新營,2024-06-07,9693
00665L,富邦�琤肭磪囓�2,20,0,20,富邦-新營,2024-06-07,9693
4533,協易機,33,15,18,富邦-新營,2024-06-07,9693
2330,台積電,18,0,18,富邦-新營,2024-06-07,9693
3260,威剛,17,0,17,富邦-新營,2024-06-07,9693
2542,興富發,22,5,17,富邦-新營,2024-06-07,9693
5531,鄉林,18,2,16,富邦-新營,2024-06-07,9693
9105,泰金寶-DR,43,28,15,富邦-新營,2024-06-07,9693
2353,宏��,19,5,14,富邦-新營,2024-06-07,9693
2867,三商壽,18,5,13,富邦-新營,2024-06-07,9693
00637L,元大滬深300正2,13,0,13,富邦-新營,2024-06-07,9693
6215,和椿,24,12,12,富邦-新營,2024-06-07,9693
2025,千興,20,9,11,富邦-新營,2024-06-07,9693
9955,佳龍,10,0,10,富邦-新營,2024-06-07,9693
3015,全漢,10,0,10,富邦-新營,2024-06-07,9693
5426,振發,10,0,10,富邦-新營,2024-06-07,9693
6125,廣運,12,2,10,富邦-新營,2024-06-07,9693
6207,雷科,27,18,9,富邦-新營,2024-06-07,9693
1503,士電,15,7,8,富邦-新營,2024-06-07,9693
4956,光鋐,8,0,8,富邦-新營,2024-06-07,9693
8112,至上,11,3,8,富邦-新營,2024-06-07,9693
00687B,國泰20年美債,32,24,8,富邦-新營,2024-06-07,9693
4938,和碩,10,2,8,富邦-新營,2024-06-07,9693
5493,三聯,13,6,7,富邦-新營,2024-06-07,9693
00942B,台新美A公司債20+,7,0,7,富邦-新營,2024-06-07,9693
2605,新興,10,3,7,富邦-新營,2024-06-07,9693
1608,華榮,14,8,6,富邦-新營,2024-06-07,9693
2352,佳世達,6,0,6,富邦-新營,2024-06-07,9693
2365,昆盈,26,20,6,富邦-新營,2024-06-07,9693
2613,中櫃,23,17,6,富邦-新營,2024-06-07,9693
2313,華通,17,11,6,富邦-新營,2024-06-07,9693
00680L,元大美債20正2,204,0,204,富邦-新營,2024-06-11,9693
00712,復華富時不動產,109,9,100,富邦-新營,2024-06-11,9693
3122,笙泉,151,52,99,富邦-新營,2024-06-11,9693
00936,台新永續高息中小,89,0,89,富邦-新營,2024-06-11,9693
2609,陽明,121,48,73,富邦-新營,2024-06-11,9693
2867,三商壽,93,22,71,富邦-新營,2024-06-11,9693
6770,力積電,68,2,66,富邦-新營,2024-06-11,9693
00918,大華優利高填息30,64,3,61,富邦-新營,2024-06-11,9693
6163,華電網,60,0,60,富邦-新營,2024-06-11,9693
2615,萬海,86,29,57,富邦-新營,2024-06-11,9693
00937B,群益ESG投等債20,58,5,53,富邦-新營,2024-06-11,9693
1316,上曜,78,27,51,富邦-新營,2024-06-11,9693
2002,中鋼,50,0,50,富邦-新營,2024-06-11,9693
00929,復華台灣科技優息,100,50,50,富邦-新營,2024-06-11,9693
00679B,元大美債20年,49,0,49,富邦-新營,2024-06-11,9693
3047,訊舟,54,7,47,富邦-新營,2024-06-11,9693
00919,群益台灣精選高息,47,2,45,富邦-新營,2024-06-11,9693
00687B,國泰20年美債,36,2,34,富邦-新營,2024-06-11,9693
4967,十銓,47,16,31,富邦-新營,2024-06-11,9693
00665L,富邦�琤肭磪囓�2,35,5,30,富邦-新營,2024-06-11,9693
4726,永昕,41,14,27,富邦-新營,2024-06-11,9693
00795B,中信美國公債20年,24,0,24,富邦-新營,2024-06-11,9693
1101,台泥,24,1,23,富邦-新營,2024-06-11,9693
2374,佳能,26,5,21,富邦-新營,2024-06-11,9693
2406,國碩,20,0,20,富邦-新營,2024-06-11,9693
8064,東捷,20,0,20,富邦-新營,2024-06-11,9693
2353,宏��,20,1,19,富邦-新營,2024-06-11,9693
5432,新門,28,10,18,富邦-新營,2024-06-11,9693
8033,雷虎,18,0,18,富邦-新營,2024-06-11,9693
2603,長榮,135,118,17,富邦-新營,2024-06-11,9693
2511,太子,18,1,17,富邦-新營,2024-06-11,9693
3481,群創,18,1,17,富邦-新營,2024-06-11,9693
00940,元大台灣價值高息,34,17,17,富邦-新營,2024-06-11,9693
2344,華邦電,17,1,16,富邦-新營,2024-06-11,9693
5347,世界,19,3,16,富邦-新營,2024-06-11,9693
8076,伍豐,19,3,16,富邦-新營,2024-06-11,9693
6229,研通,14,1,13,富邦-新營,2024-06-11,9693
00933B,國泰10Y+金融債,13,0,13,富邦-新營,2024-06-11,9693
2365,昆盈,12,0,12,富邦-新營,2024-06-11,9693
2888,新光金,15,3,12,富邦-新營,2024-06-11,9693
5426,振發,15,4,11,富邦-新營,2024-06-11,9693
2634,漢翔,11,0,11,富邦-新營,2024-06-11,9693
2356,英業達,11,1,10,富邦-新營,2024-06-11,9693
3231,緯創,17,7,10,富邦-新營,2024-06-11,9693
00753L,中信中國50正2,10,0,10,富邦-新營,2024-06-11,9693
1584,精剛,10,0,10,富邦-新營,2024-06-11,9693
2405,輔信,11,1,10,富邦-新營,2024-06-11,9693
2495,普安,10,0,10,富邦-新營,2024-06-11,9693
3024,憶聲,10,0,10,富邦-新營,2024-06-11,9693
3322,建舜電,10,0,10,富邦-新營,2024-06-11,9693
1314,中石化,233,0,233,富邦-新營,2024-06-12,9693
00942B,台新美A公司債20+,149,0,149,富邦-新營,2024-06-12,9693
00937B,群益ESG投等債20,113,0,113,富邦-新營,2024-06-12,9693
00712,復華富時不動產,108,0,108,富邦-新營,2024-06-12,9693
2855,統一證,101,24,77,富邦-新營,2024-06-12,9693
00948B,中信優息投資級債,56,0,56,富邦-新營,2024-06-12,9693
00720B,元大投資級公司債,50,0,50,富邦-新營,2024-06-12,9693
1527,鑽全,43,0,43,富邦-新營,2024-06-12,9693
00919,群益台灣精選高息,50,14,36,富邦-新營,2024-06-12,9693
2883,凱基金,36,2,34,富邦-新營,2024-06-12,9693
2312,金寶,32,0,32,富邦-新營,2024-06-12,9693
00947,台新臺灣IC設計,31,0,31,富邦-新營,2024-06-12,9693
1609,大亞,76,45,31,富邦-新營,2024-06-12,9693
00918,大華優利高填息30,29,0,29,富邦-新營,2024-06-12,9693
00645,富邦日本,29,0,29,富邦-新營,2024-06-12,9693
2323,中環,28,0,28,富邦-新營,2024-06-12,9693
4967,十銓,56,29,27,富邦-新營,2024-06-12,9693
3231,緯創,34,7,27,富邦-新營,2024-06-12,9693
9946,三發地產,27,1,26,富邦-新營,2024-06-12,9693
2324,仁寶,23,2,21,富邦-新營,2024-06-12,9693
2888,新光金,32,11,21,富邦-新營,2024-06-12,9693
2303,聯電,19,1,18,富邦-新營,2024-06-12,9693
2105,正新,17,0,17,富邦-新營,2024-06-12,9693
00936,台新永續高息中小,29,12,17,富邦-新營,2024-06-12,9693
1101,台泥,26,9,17,富邦-新營,2024-06-12,9693
1616,億泰,15,0,15,富邦-新營,2024-06-12,9693
3031,佰鴻,15,0,15,富邦-新營,2024-06-12,9693
3047,訊舟,23,9,14,富邦-新營,2024-06-12,9693
6788,華景電,13,0,13,富邦-新營,2024-06-12,9693
5608,四維航,13,2,11,富邦-新營,2024-06-12,9693
5009,榮剛,11,0,11,富邦-新營,2024-06-12,9693
2889,國票金,11,0,11,富邦-新營,2024-06-12,9693
2617,台航,14,4,10,富邦-新營,2024-06-12,9693
3706,神達,10,0,10,富邦-新營,2024-06-12,9693
00701,國泰股利精選30,10,0,10,富邦-新營,2024-06-12,9693
00753L,中信中國50正2,10,0,10,富邦-新營,2024-06-12,9693
00740B,富邦全球投等債,10,0,10,富邦-新營,2024-06-12,9693
1789,神隆,10,0,10,富邦-新營,2024-06-12,9693
2409,友達,10,0,10,富邦-新營,2024-06-12,9693
6706,惠特,11,1,10,富邦-新營,2024-06-12,9693
2603,長榮,19,10,9,富邦-新營,2024-06-12,9693
3013,晟銘電,14,5,9,富邦-新營,2024-06-12,9693
6164,華興,14,5,9,富邦-新營,2024-06-12,9693
2365,昆盈,10,2,8,富邦-新營,2024-06-12,9693
00687B,國泰20年美債,15,7,8,富邦-新營,2024-06-12,9693
2464,盟立,12,4,8,富邦-新營,2024-06-12,9693
2504,國產,9,1,8,富邦-新營,2024-06-12,9693
3663,鑫科,8,0,8,富邦-新營,2024-06-12,9693
6213,聯茂,18,10,8,富邦-新營,2024-06-12,9693
0056,元大高股息,7,0,7,富邦-新營,2024-06-12,9693
2855,統一證,183,0,183,富邦-新營,2024-06-13,9693
00933B,國泰10Y+金融債,150,0,150,富邦-新營,2024-06-13,9693
00942B,台新美A公司債20+,134,0,134,富邦-新營,2024-06-13,9693
2609,陽明,91,27,64,富邦-新營,2024-06-13,9693
3466,德晉,60,11,49,富邦-新營,2024-06-13,9693
00929,復華台灣科技優息,41,1,40,富邦-新營,2024-06-13,9693
00919,群益台灣精選高息,44,6,38,富邦-新營,2024-06-13,9693
00948B,中信優息投資級債,45,10,35,富邦-新營,2024-06-13,9693
00687B,國泰20年美債,30,0,30,富邦-新營,2024-06-13,9693
00645,富邦日本,29,0,29,富邦-新營,2024-06-13,9693
5009,榮剛,29,0,29,富邦-新營,2024-06-13,9693
2637,慧洋-KY,24,1,23,富邦-新營,2024-06-13,9693
2323,中環,20,0,20,富邦-新營,2024-06-13,9693
2365,昆盈,21,1,20,富邦-新營,2024-06-13,9693
2892,第一金,20,0,20,富邦-新營,2024-06-13,9693
2303,聯電,49,29,20,富邦-新營,2024-06-13,9693
2603,長榮,25,6,19,富邦-新營,2024-06-13,9693
3481,群創,24,10,14,富邦-新營,2024-06-13,9693
2867,三商壽,14,0,14,富邦-新營,2024-06-13,9693
6290,良維,14,1,13,富邦-新營,2024-06-13,9693
2201,裕隆,13,0,13,富邦-新營,2024-06-13,9693
2352,佳世達,13,0,13,富邦-新營,2024-06-13,9693
2317,鴻海,45,32,13,富邦-新營,2024-06-13,9693
00936,台新永續高息中小,41,28,13,富邦-新營,2024-06-13,9693
7402,邑錡,12,0,12,富邦-新營,2024-06-13,9693
2359,所羅門,79,67,12,富邦-新營,2024-06-13,9693
2601,益航,11,0,11,富邦-新營,2024-06-13,9693
2881,富邦金,11,1,10,富邦-新營,2024-06-13,9693
00931B,統一美債20年,10,0,10,富邦-新營,2024-06-13,9693
00764B,群益25年美債,10,0,10,富邦-新營,2024-06-13,9693
00637L,元大滬深300正2,10,0,10,富邦-新營,2024-06-13,9693
1326,台化,10,0,10,富邦-新營,2024-06-13,9693
3163,波若威,12,2,10,富邦-新營,2024-06-13,9693
5340,建榮,30,20,10,富邦-新營,2024-06-13,9693
5905,南仁湖,10,0,10,富邦-新營,2024-06-13,9693
2401,凌陽,15,6,9,富邦-新營,2024-06-13,9693
2890,永豐金,10,1,9,富邦-新營,2024-06-13,9693
2367,燿華,34,26,8,富邦-新營,2024-06-13,9693
00671R,富邦NASDAQ反1,8,0,8,富邦-新營,2024-06-13,9693
00947,台新臺灣IC設計,8,0,8,富邦-新營,2024-06-13,9693
2461,光群雷,8,0,8,富邦-新營,2024-06-13,9693
3019,亞光,15,7,8,富邦-新營,2024-06-13,9693
8210,勤誠,8,0,8,富邦-新營,2024-06-13,9693
4588,玖鼎電力,7,0,7,富邦-新營,2024-06-13,9693
5523,豐謙,7,0,7,富邦-新營,2024-06-13,9693
2392,正崴,98,91,7,富邦-新營,2024-06-13,9693
00881,國泰台灣5G+,9,2,7,富邦-新營,2024-06-13,9693
00946,群益科技高息成長,6,0,6,富邦-新營,2024-06-13,9693
00688L,國泰20年美債正2,7,1,6,富邦-新營,2024-06-13,9693
2354,鴻準,25,19,6,富邦-新營,2024-06-13,9693
2371,大同,283,237,46,富邦-新營,2024-06-14,9693
00919,群益台灣精選高息,54,10,44,富邦-新營,2024-06-14,9693
00878,國泰永續高股息,37,0,37,富邦-新營,2024-06-14,9693
00933B,國泰10Y+金融債,37,0,37,富邦-新營,2024-06-14,9693
3048,益登,50,13,37,富邦-新營,2024-06-14,9693
2867,三商壽,35,0,35,富邦-新營,2024-06-14,9693
00948B,中信優息投資級債,39,5,34,富邦-新營,2024-06-14,9693
00688L,國泰20年美債正2,32,0,32,富邦-新營,2024-06-14,9693
3324,雙鴻,44,12,32,富邦-新營,2024-06-14,9693
00946,群益科技高息成長,29,0,29,富邦-新營,2024-06-14,9693
00679B,元大美債20年,38,9,29,富邦-新營,2024-06-14,9693
2344,華邦電,23,1,22,富邦-新營,2024-06-14,9693
6116,彩晶,21,0,21,富邦-新營,2024-06-14,9693
2605,新興,22,1,21,富邦-新營,2024-06-14,9693
6207,雷科,21,0,21,富邦-新營,2024-06-14,9693
2801,彰銀,20,1,19,富邦-新營,2024-06-14,9693
2330,台積電,22,3,19,富邦-新營,2024-06-14,9693
00687B,國泰20年美債,20,2,18,富邦-新營,2024-06-14,9693
4967,十銓,267,250,17,富邦-新營,2024-06-14,9693
2427,三商電,18,1,17,富邦-新營,2024-06-14,9693
1815,富喬,19,3,16,富邦-新營,2024-06-14,9693
2324,仁寶,15,1,14,富邦-新營,2024-06-14,9693
8107,大億金茂,14,0,14,富邦-新營,2024-06-14,9693
3105,穩懋,13,0,13,富邦-新營,2024-06-14,9693
2464,盟立,13,0,13,富邦-新營,2024-06-14,9693
2609,陽明,465,452,13,富邦-新營,2024-06-14,9693
00918,大華優利高填息30,14,1,13,富邦-新營,2024-06-14,9693
1326,台化,12,0,12,富邦-新營,2024-06-14,9693
3591,艾笛森,12,0,12,富邦-新營,2024-06-14,9693
00939,統一台灣高息動能,20,8,12,富邦-新營,2024-06-14,9693
2392,正崴,20,9,11,富邦-新營,2024-06-14,9693
00944,野村趨勢動能高息,11,0,11,富邦-新營,2024-06-14,9693
2537,聯上發,22,11,11,富邦-新營,2024-06-14,9693
3363,上詮,12,1,11,富邦-新營,2024-06-14,9693
5009,榮剛,11,0,11,富邦-新營,2024-06-14,9693
2367,燿華,19,9,10,富邦-新營,2024-06-14,9693
00931B,統一美債20年,12,2,10,富邦-新營,2024-06-14,9693
00947,台新臺灣IC設計,10,0,10,富邦-新營,2024-06-14,9693
2601,益航,10,0,10,富邦-新營,2024-06-14,9693
2891,中信金,10,0,10,富邦-新營,2024-06-14,9693
8064,東捷,10,0,10,富邦-新營,2024-06-14,9693
00857B,永豐20年美公債,10,1,9,富邦-新營,2024-06-14,9693
2489,瑞軒,10,1,9,富邦-新營,2024-06-14,9693
4726,永昕,10,1,9,富邦-新營,2024-06-14,9693
4938,和碩,10,1,9,富邦-新營,2024-06-14,9693
2405,輔信,9,1,8,富邦-新營,2024-06-14,9693
2501,國建,10,2,8,富邦-新營,2024-06-14,9693
2736,富野,8,0,8,富邦-新營,2024-06-14,9693
3086,華義,11,3,8,富邦-新營,2024-06-14,9693
3481,群創,14,6,8,富邦-新營,2024-06-14,9693
9105,泰金寶-DR,157,3,154,富邦-新營,2024-06-17,9693
00688L,國泰20年美債正2,103,0,103,富邦-新營,2024-06-17,9693
3048,益登,168,89,79,富邦-新營,2024-06-17,9693
2312,金寶,63,2,61,富邦-新營,2024-06-17,9693
00929,復華台灣科技優息,63,2,61,富邦-新營,2024-06-17,9693
2344,華邦電,50,8,42,富邦-新營,2024-06-17,9693
2615,萬海,48,10,38,富邦-新營,2024-06-17,9693
2801,彰銀,36,0,36,富邦-新營,2024-06-17,9693
2867,三商壽,35,0,35,富邦-新營,2024-06-17,9693
1609,大亞,45,13,32,富邦-新營,2024-06-17,9693
2542,興富發,30,3,27,富邦-新營,2024-06-17,9693
4967,十銓,24,0,24,富邦-新營,2024-06-17,9693
00679B,元大美債20年,36,14,22,富邦-新營,2024-06-17,9693
00712,復華富時不動產,24,2,22,富邦-新營,2024-06-17,9693
2323,中環,22,0,22,富邦-新營,2024-06-17,9693
2495,普安,22,0,22,富邦-新營,2024-06-17,9693
5213,亞昕,22,0,22,富邦-新營,2024-06-17,9693
00918,大華優利高填息30,21,0,21,富邦-新營,2024-06-17,9693
2883B,凱基金乙特,21,0,21,富邦-新營,2024-06-17,9693
2883,凱基金,22,2,20,富邦-新營,2024-06-17,9693
1503,士電,26,7,19,富邦-新營,2024-06-17,9693
1504,東元,26,8,18,富邦-新營,2024-06-17,9693
2834,臺企銀,20,2,18,富邦-新營,2024-06-17,9693
3013,晟銘電,20,4,16,富邦-新營,2024-06-17,9693
00937B,群益ESG投等債20,15,1,14,富邦-新營,2024-06-17,9693
3231,緯創,15,1,14,富邦-新營,2024-06-17,9693
2888,新光金,14,0,14,富邦-新營,2024-06-17,9693
1616,億泰,13,0,13,富邦-新營,2024-06-17,9693
1301,台塑,12,0,12,富邦-新營,2024-06-17,9693
00942B,台新美A公司債20+,32,20,12,富邦-新營,2024-06-17,9693
5009,榮剛,12,0,12,富邦-新營,2024-06-17,9693
1513,中興電,32,20,12,富邦-新營,2024-06-17,9693
1732,毛寶,15,4,11,富邦-新營,2024-06-17,9693
3086,華義,11,0,11,富邦-新營,2024-06-17,9693
6005,群益證,11,0,11,富邦-新營,2024-06-17,9693
6550,北極星藥業-KY,11,0,11,富邦-新營,2024-06-17,9693
8438,昶昕,11,0,11,富邦-新營,2024-06-17,9693
1608,華榮,28,17,11,富邦-新營,2024-06-17,9693
2612,中航,10,0,10,富邦-新營,2024-06-17,9693
5523,豐謙,10,0,10,富邦-新營,2024-06-17,9693
9904,寶成,10,0,10,富邦-新營,2024-06-17,9693
4533,協易機,27,17,10,富邦-新營,2024-06-17,9693
2382,廣達,9,0,9,富邦-新營,2024-06-17,9693
2885,元大金,10,1,9,富邦-新營,2024-06-17,9693
4167,松瑞藥,21,12,9,富邦-新營,2024-06-17,9693
9933,中鼎,10,1,9,富邦-新營,2024-06-17,9693
00919,群益台灣精選高息,18,10,8,富邦-新營,2024-06-17,9693
2460,建通,8,0,8,富邦-新營,2024-06-17,9693
00897,富邦基因免疫生技,7,0,7,富邦-新營,2024-06-17,9693
2331,精英,10,3,7,富邦-新營,2024-06-17,9693
00937B,群益ESG投等債20,279,1,278,富邦-新營,2024-06-18,9693
00929,復華台灣科技優息,64,3,61,富邦-新營,2024-06-18,9693
00942B,台新美A公司債20+,50,0,50,富邦-新營,2024-06-18,9693
9103,美德醫療-DR,56,6,50,富邦-新營,2024-06-18,9693
3312,弘憶股,101,54,47,富邦-新營,2024-06-18,9693
9105,泰金寶-DR,52,5,47,富邦-新營,2024-06-18,9693
00946,群益科技高息成長,41,0,41,富邦-新營,2024-06-18,9693
00679B,元大美債20年,39,2,37,富邦-新營,2024-06-18,9693
3363,上詮,50,13,37,富邦-新營,2024-06-18,9693
1815,富喬,81,48,33,富邦-新營,2024-06-18,9693
00948B,中信優息投資級債,41,10,31,富邦-新營,2024-06-18,9693
1325,恆大,30,0,30,富邦-新營,2024-06-18,9693
4566,時碩工業,50,20,30,富邦-新營,2024-06-18,9693
00936,台新永續高息中小,66,37,29,富邦-新營,2024-06-18,9693
912000,晨訊科-DR,30,5,25,富邦-新營,2024-06-18,9693
3041,揚智,23,0,23,富邦-新營,2024-06-18,9693
4533,協易機,232,209,23,富邦-新營,2024-06-18,9693
00713,元大台灣高息低波,20,0,20,富邦-新營,2024-06-18,9693
3419,譁裕,20,0,20,富邦-新營,2024-06-18,9693
00897,富邦基因免疫生技,17,0,17,富邦-新營,2024-06-18,9693
2609,陽明,26,10,16,富邦-新營,2024-06-18,9693
2101,南港,15,1,14,富邦-新營,2024-06-18,9693
1785,光洋科,15,2,13,富邦-新營,2024-06-18,9693
2464,盟立,29,16,13,富邦-新營,2024-06-18,9693
2392,正崴,34,22,12,富邦-新營,2024-06-18,9693
4419,皇家美食,12,0,12,富邦-新營,2024-06-18,9693
4542,科嶠,12,0,12,富邦-新營,2024-06-18,9693
00662,富邦NASDAQ,12,0,12,富邦-新營,2024-06-18,9693
1303,南亞,13,2,11,富邦-新營,2024-06-18,9693
2353,宏��,18,7,11,富邦-新營,2024-06-18,9693
5340,建榮,21,10,11,富邦-新營,2024-06-18,9693
1611,中電,17,7,10,富邦-新營,2024-06-18,9693
1806,冠軍,10,0,10,富邦-新營,2024-06-18,9693
3631,晟楠,15,5,10,富邦-新營,2024-06-18,9693
3694,海華,10,0,10,富邦-新營,2024-06-18,9693
4966,譜瑞-KY,10,0,10,富邦-新營,2024-06-18,9693
5905,南仁湖,10,0,10,富邦-新營,2024-06-18,9693
9946,三發地產,10,0,10,富邦-新營,2024-06-18,9693
1504,東元,10,0,10,富邦-新營,2024-06-18,9693
2317,鴻海,28,20,8,富邦-新營,2024-06-18,9693
8027,鈦昇,8,0,8,富邦-新營,2024-06-18,9693
3622,洋華,17,9,8,富邦-新營,2024-06-18,9693
2312,金寶,10,2,8,富邦-新營,2024-06-18,9693
2331,精英,8,0,8,富邦-新營,2024-06-18,9693
6550,北極星藥業-KY,8,0,8,富邦-新營,2024-06-18,9693
006208,富邦台50,9,1,8,富邦-新營,2024-06-18,9693
2301,光寶科,8,1,7,富邦-新營,2024-06-18,9693
2374,佳能,9,2,7,富邦-新營,2024-06-18,9693
3707,漢磊,7,0,7,富邦-新營,2024-06-18,9693
6213,聯茂,7,0,7,富邦-新營,2024-06-18,9693
00937B,群益ESG投等債20,328,0,328,富邦-新營,2024-06-19,9693
2885,元大金,158,23,135,富邦-新營,2024-06-19,9693
3234,光環,118,1,117,富邦-新營,2024-06-19,9693
1514,亞力,220,111,109,富邦-新營,2024-06-19,9693
00929,復華台灣科技優息,138,36,102,富邦-新營,2024-06-19,9693
3450,聯鈞,115,16,99,富邦-新營,2024-06-19,9693
2867,三商壽,67,4,63,富邦-新營,2024-06-19,9693
00946,群益科技高息成長,60,20,40,富邦-新營,2024-06-19,9693
00632R,元大台灣50反1,50,11,39,富邦-新營,2024-06-19,9693
5905,南仁湖,40,1,39,富邦-新營,2024-06-19,9693
00936,台新永續高息中小,39,1,38,富邦-新營,2024-06-19,9693
00940,元大台灣價值高息,44,6,38,富邦-新營,2024-06-19,9693
2365,昆盈,84,47,37,富邦-新營,2024-06-19,9693
6834,天二科技,41,4,37,富邦-新營,2024-06-19,9693
2371,大同,58,25,33,富邦-新營,2024-06-19,9693
2601,益航,32,0,32,富邦-新營,2024-06-19,9693
1815,富喬,43,12,31,富邦-新營,2024-06-19,9693
00679B,元大美債20年,27,0,27,富邦-新營,2024-06-19,9693
00933B,國泰10Y+金融債,27,1,26,富邦-新營,2024-06-19,9693
3062,建漢,52,27,25,富邦-新營,2024-06-19,9693
6550,北極星藥業-KY,24,0,24,富邦-新營,2024-06-19,9693
2537,聯上發,23,0,23,富邦-新營,2024-06-19,9693
4973,廣穎,25,2,23,富邦-新營,2024-06-19,9693
2618,長榮航,34,11,23,富邦-新營,2024-06-19,9693
1609,大亞,35,12,23,富邦-新營,2024-06-19,9693
2025,千興,22,1,21,富邦-新營,2024-06-19,9693
3324,雙鴻,22,2,20,富邦-新營,2024-06-19,9693
1463,強盛新,19,0,19,富邦-新營,2024-06-19,9693
2344,華邦電,27,8,19,富邦-新營,2024-06-19,9693
3294,英濟,17,0,17,富邦-新營,2024-06-19,9693
1616,億泰,16,0,16,富邦-新營,2024-06-19,9693
3455,由田,16,0,16,富邦-新營,2024-06-19,9693
00713,元大台灣高息低波,26,10,16,富邦-新營,2024-06-19,9693
00881,國泰台灣5G+,17,2,15,富邦-新營,2024-06-19,9693
3004,豐達科,15,0,15,富邦-新營,2024-06-19,9693
3048,益登,212,198,14,富邦-新營,2024-06-19,9693
3481,群創,37,23,14,富邦-新營,2024-06-19,9693
6462,神盾,25,11,14,富邦-新營,2024-06-19,9693
00715L,期街口布蘭特正2,15,1,14,富邦-新營,2024-06-19,9693
7402,邑錡,13,0,13,富邦-新營,2024-06-19,9693
2337,旺宏,13,1,12,富邦-新營,2024-06-19,9693
00897,富邦基因免疫生技,12,0,12,富邦-新營,2024-06-19,9693
6213,聯茂,12,0,12,富邦-新營,2024-06-19,9693
3017,奇鋐,12,0,12,富邦-新營,2024-06-19,9693
6290,良維,33,22,11,富邦-新營,2024-06-19,9693
5880,合庫金,10,0,10,富邦-新營,2024-06-19,9693
2634,漢翔,10,0,10,富邦-新營,2024-06-19,9693
00948B,中信優息投資級債,10,0,10,富邦-新營,2024-06-19,9693
2201,裕隆,10,0,10,富邦-新營,2024-06-19,9693
2363,矽統,11,1,10,富邦-新營,2024-06-19,9693
2867,三商壽,115,13,102,富邦-新營,2024-06-20,9693
6550,北極星藥業-KY,101,0,101,富邦-新營,2024-06-20,9693
00688L,國泰20年美債正2,130,50,80,富邦-新營,2024-06-20,9693
00937B,群益ESG投等債20,72,0,72,富邦-新營,2024-06-20,9693
00936,台新永續高息中小,64,1,63,富邦-新營,2024-06-20,9693
3481,群創,65,8,57,富邦-新營,2024-06-20,9693
1447,力鵬,50,0,50,富邦-新營,2024-06-20,9693
2353,宏��,48,3,45,富邦-新營,2024-06-20,9693
00687B,國泰20年美債,44,1,43,富邦-新營,2024-06-20,9693
1712,興農,40,0,40,富邦-新營,2024-06-20,9693
3260,威剛,46,9,37,富邦-新營,2024-06-20,9693
00933B,國泰10Y+金融債,34,0,34,富邦-新營,2024-06-20,9693
00665L,富邦�琤肭磪囓�2,30,0,30,富邦-新營,2024-06-20,9693
6026,福邦證,28,0,28,富邦-新營,2024-06-20,9693
00881,國泰台灣5G+,26,1,25,富邦-新營,2024-06-20,9693
00940,元大台灣價值高息,41,20,21,富邦-新營,2024-06-20,9693
2883,凱基金,22,2,20,富邦-新營,2024-06-20,9693
00753L,中信中國50正2,30,11,19,富邦-新營,2024-06-20,9693
00680L,元大美債20正2,20,1,19,富邦-新營,2024-06-20,9693
00918,大華優利高填息30,19,0,19,富邦-新營,2024-06-20,9693
2881,富邦金,18,0,18,富邦-新營,2024-06-20,9693
00679B,元大美債20年,21,5,16,富邦-新營,2024-06-20,9693
00942B,台新美A公司債20+,16,0,16,富邦-新營,2024-06-20,9693
8277,商丞,18,2,16,富邦-新營,2024-06-20,9693
2002,中鋼,26,12,14,富邦-新營,2024-06-20,9693
4533,協易機,19,5,14,富邦-新營,2024-06-20,9693
2603,長榮,17,3,14,富邦-新營,2024-06-20,9693
00929,復華台灣科技優息,58,45,13,富邦-新營,2024-06-20,9693
1326,台化,14,1,13,富邦-新營,2024-06-20,9693
1301,台塑,15,3,12,富邦-新營,2024-06-20,9693
5905,南仁湖,15,3,12,富邦-新營,2024-06-20,9693
2332,友訊,11,0,11,富邦-新營,2024-06-20,9693
2412,中華電,11,0,11,富邦-新營,2024-06-20,9693
5508,永信建,10,0,10,富邦-新營,2024-06-20,9693
00927,群益半導體收益,10,0,10,富邦-新營,2024-06-20,9693
00632R,元大台灣50反1,10,0,10,富邦-新營,2024-06-20,9693
1473,台南,10,0,10,富邦-新營,2024-06-20,9693
2615,萬海,33,23,10,富邦-新營,2024-06-20,9693
6841,長佳智能,10,0,10,富邦-新營,2024-06-20,9693
8926,台汽電,10,0,10,富邦-新營,2024-06-20,9693
2330,台積電,15,6,9,富邦-新營,2024-06-20,9693
2408,南亞科,47,38,9,富邦-新營,2024-06-20,9693
2501,國建,10,1,9,富邦-新營,2024-06-20,9693
2633,台灣高鐵,10,1,9,富邦-新營,2024-06-20,9693
3673,TPK-KY,13,4,9,富邦-新營,2024-06-20,9693
4526,東台,21,12,9,富邦-新營,2024-06-20,9693
5347,世界,10,1,9,富邦-新營,2024-06-20,9693
00713,元大台灣高息低波,9,0,9,富邦-新營,2024-06-20,9693
6834,天二科技,10,2,8,富邦-新營,2024-06-20,9693
4915,致伸,7,0,7,富邦-新營,2024-06-20,9693
8105,凌巨,129,6,123,富邦-新營,2024-06-21,9693
00919,群益台灣精選高息,106,15,91,富邦-新營,2024-06-21,9693
3163,波若威,84,7,77,富邦-新營,2024-06-21,9693
2601,益航,60,0,60,富邦-新營,2024-06-21,9693
00753L,中信中國50正2,55,0,55,富邦-新營,2024-06-21,9693
2382,廣達,62,8,54,富邦-新營,2024-06-21,9693
00665L,富邦�琤肭磪囓�2,53,0,53,富邦-新營,2024-06-21,9693
00940,元大台灣價值高息,98,50,48,富邦-新營,2024-06-21,9693
00878,國泰永續高股息,47,0,47,富邦-新營,2024-06-21,9693
2002,中鋼,43,4,39,富邦-新營,2024-06-21,9693
4966,譜瑞-KY,34,0,34,富邦-新營,2024-06-21,9693
2317,鴻海,52,19,33,富邦-新營,2024-06-21,9693
00688L,國泰20年美債正2,28,0,28,富邦-新營,2024-06-21,9693
00929,復華台灣科技優息,64,36,28,富邦-新營,2024-06-21,9693
00918,大華優利高填息30,29,2,27,富邦-新營,2024-06-21,9693
00713,元大台灣高息低波,24,0,24,富邦-新營,2024-06-21,9693
00679B,元大美債20年,25,1,24,富邦-新營,2024-06-21,9693
3438,類比科,28,4,24,富邦-新營,2024-06-21,9693
2492,華新科,27,4,23,富邦-新營,2024-06-21,9693
2409,友達,76,54,22,富邦-新營,2024-06-21,9693
4533,協易機,28,6,22,富邦-新營,2024-06-21,9693
00936,台新永續高息中小,23,3,20,富邦-新營,2024-06-21,9693
2323,中環,20,0,20,富邦-新營,2024-06-21,9693
00902,中信電池及儲能,19,0,19,富邦-新營,2024-06-21,9693
1609,大亞,20,2,18,富邦-新營,2024-06-21,9693
00933B,國泰10Y+金融債,18,0,18,富邦-新營,2024-06-21,9693
3363,上詮,17,0,17,富邦-新營,2024-06-21,9693
2353,宏��,20,4,16,富邦-新營,2024-06-21,9693
00941,中信上游半導體,16,0,16,富邦-新營,2024-06-21,9693
00948B,中信優息投資級債,15,0,15,富邦-新營,2024-06-21,9693
2330,台積電,19,5,14,富邦-新營,2024-06-21,9693
1301,台塑,15,1,14,富邦-新營,2024-06-21,9693
00946,群益科技高息成長,22,9,13,富邦-新營,2024-06-21,9693
2603,長榮,17,4,13,富邦-新營,2024-06-21,9693
00885,富邦越南,12,0,12,富邦-新營,2024-06-21,9693
1326,台化,12,0,12,富邦-新營,2024-06-21,9693
2030,彰源,12,0,12,富邦-新營,2024-06-21,9693
2314,台揚,14,2,12,富邦-新營,2024-06-21,9693
6695,芯鼎,95,84,11,富邦-新營,2024-06-21,9693
8064,東捷,21,10,11,富邦-新營,2024-06-21,9693
4967,十銓,12,2,10,富邦-新營,2024-06-21,9693
00830,國泰費城半導體,10,0,10,富邦-新營,2024-06-21,9693
2371,大同,13,3,10,富邦-新營,2024-06-21,9693
1711,永光,10,0,10,富邦-新營,2024-06-21,9693
8215,明基材,10,0,10,富邦-新營,2024-06-21,9693
9908,大台北,10,0,10,富邦-新營,2024-06-21,9693
1319,東陽,10,0,10,富邦-新營,2024-06-21,9693
2609,陽明,46,36,10,富邦-新營,2024-06-21,9693
6550,北極星藥業-KY,13,3,10,富邦-新營,2024-06-21,9693
2356,英業達,21,12,9,富邦-新營,2024-06-21,9693
6015,宏遠證,313,0,313,富邦-新營,2024-06-24,9693
3481,群創,374,102,272,富邦-新營,2024-06-24,9693
00919,群益台灣精選高息,184,49,135,富邦-新營,2024-06-24,9693
00687B,國泰20年美債,100,2,98,富邦-新營,2024-06-24,9693
00940,元大台灣價值高息,94,14,80,富邦-新營,2024-06-24,9693
00632R,元大台灣50反1,110,40,70,富邦-新營,2024-06-24,9693
00936,台新永續高息中小,67,0,67,富邦-新營,2024-06-24,9693
00933B,國泰10Y+金融債,75,10,65,富邦-新營,2024-06-24,9693
2349,錸德,60,0,60,富邦-新營,2024-06-24,9693
6116,彩晶,52,2,50,富邦-新營,2024-06-24,9693
4562,穎漢,82,33,49,富邦-新營,2024-06-24,9693
1785,光洋科,92,48,44,富邦-新營,2024-06-24,9693
6244,茂迪,30,0,30,富邦-新營,2024-06-24,9693
2892,第一金,64,35,29,富邦-新營,2024-06-24,9693
2330,台積電,31,4,27,富邦-新營,2024-06-24,9693
00937B,群益ESG投等債20,25,0,25,富邦-新營,2024-06-24,9693
1815,富喬,523,498,25,富邦-新營,2024-06-24,9693
2324,仁寶,25,1,24,富邦-新營,2024-06-24,9693
00947,台新臺灣IC設計,24,0,24,富邦-新營,2024-06-24,9693
3163,波若威,22,0,22,富邦-新營,2024-06-24,9693
00881,國泰台灣5G+,27,6,21,富邦-新營,2024-06-24,9693
2356,英業達,26,5,21,富邦-新營,2024-06-24,9693
00946,群益科技高息成長,23,2,21,富邦-新營,2024-06-24,9693
3004,豐達科,20,0,20,富邦-新營,2024-06-24,9693
5443,均豪,50,31,19,富邦-新營,2024-06-24,9693
2408,南亞科,21,2,19,富邦-新營,2024-06-24,9693
1301,台塑,18,0,18,富邦-新營,2024-06-24,9693
2353,宏��,24,7,17,富邦-新營,2024-06-24,9693
2365,昆盈,18,1,17,富邦-新營,2024-06-24,9693
2609,陽明,23,8,15,富邦-新營,2024-06-24,9693
8076,伍豐,18,3,15,富邦-新營,2024-06-24,9693
3663,鑫科,14,0,14,富邦-新營,2024-06-24,9693
5475,德宏,18,4,14,富邦-新營,2024-06-24,9693
00878,國泰永續高股息,16,3,13,富邦-新營,2024-06-24,9693
00944,野村趨勢動能高息,13,0,13,富邦-新營,2024-06-24,9693
5905,南仁湖,33,20,13,富邦-新營,2024-06-24,9693
00892,富邦台灣半導體,12,0,12,富邦-新營,2024-06-24,9693
2392,正崴,15,3,12,富邦-新營,2024-06-24,9693
3576,聯合再生,11,0,11,富邦-新營,2024-06-24,9693
00673R,期元大S＆P原油反1,10,0,10,富邦-新營,2024-06-24,9693
2537,聯上發,12,2,10,富邦-新營,2024-06-24,9693
2634,漢翔,10,0,10,富邦-新營,2024-06-24,9693
6191,精成科,10,0,10,富邦-新營,2024-06-24,9693
8071,能率網通,10,0,10,富邦-新營,2024-06-24,9693
9904,寶成,10,0,10,富邦-新營,2024-06-24,9693
1104,環泥,10,1,9,富邦-新營,2024-06-24,9693
00935,野村臺灣新科技50,10,0,10,富邦-新營,2024-06-24,9693
00918,大華優利高填息30,15,6,9,富邦-新營,2024-06-24,9693
3030,德律,9,0,9,富邦-新營,2024-06-24,9693
00891,中信關鍵半導體,12,3,9,富邦-新營,2024-06-24,9693
1514,亞力,194,96,98,富邦-新營,2024-06-25,9693
2303,聯電,70,8,62,富邦-新營,2024-06-25,9693
2834,臺企銀,61,6,55,富邦-新營,2024-06-25,9693
2409,友達,54,10,44,富邦-新營,2024-06-25,9693
5864,致和證,42,0,42,富邦-新營,2024-06-25,9693
2537,聯上發,42,0,42,富邦-新營,2024-06-25,9693
00929,復華台灣科技優息,90,52,38,富邦-新營,2024-06-25,9693
3025,星通,35,1,34,富邦-新營,2024-06-25,9693
3372,典範,28,0,28,富邦-新營,2024-06-25,9693
00830,國泰費城半導體,27,0,27,富邦-新營,2024-06-25,9693
1815,富喬,36,11,25,富邦-新營,2024-06-25,9693
6612,奈米醫材,25,0,25,富邦-新營,2024-06-25,9693
00919,群益台灣精選高息,58,34,24,富邦-新營,2024-06-25,9693
00936,台新永續高息中小,24,0,24,富邦-新營,2024-06-25,9693
2352,佳世達,27,3,24,富邦-新營,2024-06-25,9693
3481,群創,207,186,21,富邦-新營,2024-06-25,9693
2464,盟立,25,4,21,富邦-新營,2024-06-25,9693
1314,中石化,21,1,20,富邦-新營,2024-06-25,9693
4168,醣聯,20,0,20,富邦-新營,2024-06-25,9693
6120,達運,20,0,20,富邦-新營,2024-06-25,9693
00679B,元大美債20年,19,0,19,富邦-新營,2024-06-25,9693
00940,元大台灣價值高息,20,3,17,富邦-新營,2024-06-25,9693
2317,鴻海,30,15,15,富邦-新營,2024-06-25,9693
00878,國泰永續高股息,22,10,12,富邦-新營,2024-06-25,9693
0056,元大高股息,12,0,12,富邦-新營,2024-06-25,9693
6175,立敦,11,0,11,富邦-新營,2024-06-25,9693
2449,京元電子,20,9,11,富邦-新營,2024-06-25,9693
2610,華航,15,5,10,富邦-新營,2024-06-25,9693
00907,永豐優息存股,10,0,10,富邦-新營,2024-06-25,9693
00900,富邦特選高股息30,10,0,10,富邦-新營,2024-06-25,9693
00892,富邦台灣半導體,10,0,10,富邦-新營,2024-06-25,9693
00638R,元大滬深300反1,10,0,10,富邦-新營,2024-06-25,9693
1227,佳格,10,0,10,富邦-新營,2024-06-25,9693
1504,東元,10,0,10,富邦-新營,2024-06-25,9693
2023,燁輝,10,0,10,富邦-新營,2024-06-25,9693
2344,華邦電,10,0,10,富邦-新營,2024-06-25,9693
4157,太景*-KY,10,0,10,富邦-新營,2024-06-25,9693
9136,巨騰-DR,10,0,10,富邦-新營,2024-06-25,9693
1301,台塑,10,1,9,富邦-新營,2024-06-25,9693
2002,中鋼,10,1,9,富邦-新營,2024-06-25,9693
2363,矽統,10,1,9,富邦-新營,2024-06-25,9693
2365,昆盈,13,4,9,富邦-新營,2024-06-25,9693
2455,全新,10,1,9,富邦-新營,2024-06-25,9693
4167,松瑞藥,12,3,9,富邦-新營,2024-06-25,9693
1449,佳和,11,3,8,富邦-新營,2024-06-25,9693
2337,旺宏,9,1,8,富邦-新營,2024-06-25,9693
2356,英業達,15,7,8,富邦-新營,2024-06-25,9693
5490,同亨,8,0,8,富邦-新營,2024-06-25,9693
5493,三聯,8,0,8,富邦-新營,2024-06-25,9693
5512,力麒,10,2,8,富邦-新營,2024-06-25,9693
4566,時碩工業,422,205,217,富邦-新營,2024-06-26,9693
1785,光洋科,127,21,106,富邦-新營,2024-06-26,9693
2409,友達,78,4,74,富邦-新營,2024-06-26,9693
6197,佳必琪,171,105,66,富邦-新營,2024-06-26,9693
00929,復華台灣科技優息,68,5,63,富邦-新營,2024-06-26,9693
00937B,群益ESG投等債20,58,0,58,富邦-新營,2024-06-26,9693
2002,中鋼,53,6,47,富邦-新營,2024-06-26,9693
6462,神盾,47,0,47,富邦-新營,2024-06-26,9693
00919,群益台灣精選高息,46,6,40,富邦-新營,2024-06-26,9693
2537,聯上發,48,10,38,富邦-新營,2024-06-26,9693
2303,聯電,35,2,33,富邦-新營,2024-06-26,9693
00679B,元大美債20年,32,0,32,富邦-新營,2024-06-26,9693
00773B,中信優先金融債,32,0,32,富邦-新營,2024-06-26,9693
2025,千興,50,20,30,富邦-新營,2024-06-26,9693
5484,慧友,30,0,30,富邦-新營,2024-06-26,9693
2312,金寶,29,0,29,富邦-新營,2024-06-26,9693
2317,鴻海,40,14,26,富邦-新營,2024-06-26,9693
00680L,元大美債20正2,100,75,25,富邦-新營,2024-06-26,9693
2601,益航,25,0,25,富邦-新營,2024-06-26,9693
00936,台新永續高息中小,24,0,24,富邦-新營,2024-06-26,9693
2607,榮運,23,0,23,富邦-新營,2024-06-26,9693
2883,凱基金,24,2,22,富邦-新營,2024-06-26,9693
2855,統一證,25,4,21,富邦-新營,2024-06-26,9693
2609,陽明,27,7,20,富邦-新營,2024-06-26,9693
3706,神達,20,0,20,富邦-新營,2024-06-26,9693
4157,太景*-KY,20,0,20,富邦-新營,2024-06-26,9693
5009,榮剛,19,1,18,富邦-新營,2024-06-26,9693
00922,國泰台灣領袖50,18,0,18,富邦-新營,2024-06-26,9693
2884,玉山金,18,1,17,富邦-新營,2024-06-26,9693
00753L,中信中國50正2,20,3,17,富邦-新營,2024-06-26,9693
2201,裕隆,15,0,15,富邦-新營,2024-06-26,9693
2615,萬海,22,8,14,富邦-新營,2024-06-26,9693
3062,建漢,33,19,14,富邦-新營,2024-06-26,9693
911622,泰聚亨-DR,14,0,14,富邦-新營,2024-06-26,9693
3149,正達,19,6,13,富邦-新營,2024-06-26,9693
00934,中信成長高股息,13,0,13,富邦-新營,2024-06-26,9693
2374,佳能,17,4,13,富邦-新營,2024-06-26,9693
3231,緯創,14,2,12,富邦-新營,2024-06-26,9693
2365,昆盈,13,1,12,富邦-新營,2024-06-26,9693
1326,台化,11,0,11,富邦-新營,2024-06-26,9693
9904,寶成,11,0,11,富邦-新營,2024-06-26,9693
2885,元大金,11,0,11,富邦-新營,2024-06-26,9693
00772B,中信高評級公司債,10,0,10,富邦-新營,2024-06-26,9693
00638R,元大滬深300反1,10,0,10,富邦-新營,2024-06-26,9693
2023,燁輝,10,0,10,富邦-新營,2024-06-26,9693
2340,台亞,10,0,10,富邦-新營,2024-06-26,9693
4108,懷特,10,0,10,富邦-新營,2024-06-26,9693
6290,良維,10,0,10,富邦-新營,2024-06-26,9693
0056,元大高股息,9,0,9,富邦-新營,2024-06-26,9693
4562,穎漢,13,4,9,富邦-新營,2024-06-26,9693
00942B,台新美A公司債20+,193,0,193,富邦-新營,2024-06-27,9693
00650L,復華香港正2,169,0,169,富邦-新營,2024-06-27,9693
00937B,群益ESG投等債20,117,0,117,富邦-新營,2024-06-27,9693
00679B,元大美債20年,78,0,78,富邦-新營,2024-06-27,9693
00933B,國泰10Y+金融債,60,0,60,富邦-新營,2024-06-27,9693
00665L,富邦�琤肭磪囓�2,56,1,55,富邦-新營,2024-06-27,9693
00878,國泰永續高股息,51,0,51,富邦-新營,2024-06-27,9693
3576,聯合再生,82,31,51,富邦-新營,2024-06-27,9693
00929,復華台灣科技優息,42,1,41,富邦-新營,2024-06-27,9693
1815,富喬,40,4,36,富邦-新營,2024-06-27,9693
00919,群益台灣精選高息,35,2,33,富邦-新營,2024-06-27,9693
00940,元大台灣價值高息,85,52,33,富邦-新營,2024-06-27,9693
4167,松瑞藥,68,38,30,富邦-新營,2024-06-27,9693
00936,台新永續高息中小,28,0,28,富邦-新營,2024-06-27,9693
6869,雲豹能源,77,51,26,富邦-新營,2024-06-27,9693
00651R,復華香港反1,25,0,25,富邦-新營,2024-06-27,9693
4938,和碩,28,4,24,富邦-新營,2024-06-27,9693
00915,凱基優選高股息30,24,0,24,富邦-新營,2024-06-27,9693
1709,和益,34,10,24,富邦-新營,2024-06-27,9693
2834,臺企銀,27,3,24,富邦-新營,2024-06-27,9693
6116,彩晶,23,1,22,富邦-新營,2024-06-27,9693
3652,精聯,43,22,21,富邦-新營,2024-06-27,9693
00687B,國泰20年美債,22,1,21,富邦-新營,2024-06-27,9693
3294,英濟,20,0,20,富邦-新營,2024-06-27,9693
2885,元大金,21,1,20,富邦-新營,2024-06-27,9693
2401,凌陽,20,1,19,富邦-新營,2024-06-27,9693
3372,典範,19,0,19,富邦-新營,2024-06-27,9693
00918,大華優利高填息30,17,0,17,富邦-新營,2024-06-27,9693
3047,訊舟,88,73,15,富邦-新營,2024-06-27,9693
2888,新光金,15,0,15,富邦-新營,2024-06-27,9693
9904,寶成,14,0,14,富邦-新營,2024-06-27,9693
3297,杭特,14,0,14,富邦-新營,2024-06-27,9693
3663,鑫科,20,6,14,富邦-新營,2024-06-27,9693
2201,裕隆,15,2,13,富邦-新營,2024-06-27,9693
3324,雙鴻,15,2,13,富邦-新營,2024-06-27,9693
00948B,中信優息投資級債,12,0,12,富邦-新營,2024-06-27,9693
2543,皇昌,13,1,12,富邦-新營,2024-06-27,9693
4533,協易機,30,18,12,富邦-新營,2024-06-27,9693
2301,光寶科,14,2,12,富邦-新營,2024-06-27,9693
2313,華通,44,33,11,富邦-新營,2024-06-27,9693
3712,永崴投控,16,5,11,富邦-新營,2024-06-27,9693
4138,曜亞,11,0,11,富邦-新營,2024-06-27,9693
3581,博磊,16,6,10,富邦-新營,2024-06-27,9693
2303,聯電,13,3,10,富邦-新營,2024-06-27,9693
00676R,富邦臺灣加權反1,10,0,10,富邦-新營,2024-06-27,9693
00664R,國泰臺灣加權反1,10,0,10,富邦-新營,2024-06-27,9693
00686R,群益臺灣加權反1,10,0,10,富邦-新營,2024-06-27,9693
2515,中工,10,0,10,富邦-新營,2024-06-27,9693
2884,玉山金,10,0,10,富邦-新營,2024-06-27,9693
6873,泓德能源,20,10,10,富邦-新營,2024-06-27,9693
2855,統一證,291,1,290,富邦-新營,2024-06-28,9693
4562,穎漢,268,104,164,富邦-新營,2024-06-28,9693
3481,群創,99,15,84,富邦-新營,2024-06-28,9693
00937B,群益ESG投等債20,83,0,83,富邦-新營,2024-06-28,9693
6015,宏遠證,80,0,80,富邦-新營,2024-06-28,9693
00936,台新永續高息中小,48,0,48,富邦-新營,2024-06-28,9693
00679B,元大美債20年,81,45,36,富邦-新營,2024-06-28,9693
9105,泰金寶-DR,42,8,34,富邦-新營,2024-06-28,9693
1609,大亞,44,10,34,富邦-新營,2024-06-28,9693
2885,元大金,33,5,28,富邦-新營,2024-06-28,9693
9925,新保,26,0,26,富邦-新營,2024-06-28,9693
5443,均豪,42,16,26,富邦-新營,2024-06-28,9693
6182,合晶,24,0,24,富邦-新營,2024-06-28,9693
00897,富邦基因免疫生技,20,0,20,富邦-新營,2024-06-28,9693
2349,錸德,32,14,18,富邦-新營,2024-06-28,9693
6477,安集,21,3,18,富邦-新營,2024-06-28,9693
00948B,中信優息投資級債,17,0,17,富邦-新營,2024-06-28,9693
2834,臺企銀,18,1,17,富邦-新營,2024-06-28,9693
2367,燿華,23,7,16,富邦-新營,2024-06-28,9693
00933B,國泰10Y+金融債,35,20,15,富邦-新營,2024-06-28,9693
3205,佰研,15,0,15,富邦-新營,2024-06-28,9693
2610,華航,42,27,15,富邦-新營,2024-06-28,9693
00935,野村臺灣新科技50,14,0,14,富邦-新營,2024-06-28,9693
2352,佳世達,13,0,13,富邦-新營,2024-06-28,9693
6834,天二科技,15,2,13,富邦-新營,2024-06-28,9693
1301,台塑,17,5,12,富邦-新營,2024-06-28,9693
00878,國泰永續高股息,13,2,11,富邦-新營,2024-06-28,9693
00751B,元大AAA至A公司債,11,0,11,富邦-新營,2024-06-28,9693
00929,復華台灣科技優息,17,6,11,富邦-新營,2024-06-28,9693
2025,千興,10,0,10,富邦-新營,2024-06-28,9693
00720B,元大投資級公司債,10,0,10,富邦-新營,2024-06-28,9693
9917,中保科,10,0,10,富邦-新營,2024-06-28,9693
6443,元晶,14,4,10,富邦-新營,2024-06-28,9693
6472,保瑞,19,9,10,富邦-新營,2024-06-28,9693
2489,瑞軒,10,1,9,富邦-新營,2024-06-28,9693
2317,鴻海,18,10,8,富邦-新營,2024-06-28,9693
5515,建國,8,0,8,富邦-新營,2024-06-28,9693
3062,建漢,10,2,8,富邦-新營,2024-06-28,9693
4564,元翎,8,0,8,富邦-新營,2024-06-28,9693
5905,南仁湖,10,2,8,富邦-新營,2024-06-28,9693
2313,華通,10,3,7,富邦-新營,2024-06-28,9693
3581,博磊,26,19,7,富邦-新營,2024-06-28,9693
2201,裕隆,7,0,7,富邦-新營,2024-06-28,9693
2401,凌陽,7,0,7,富邦-新營,2024-06-28,9693
2409,友達,7,0,7,富邦-新營,2024-06-28,9693
2615,萬海,8,1,7,富邦-新營,2024-06-28,9693
3047,訊舟,35,28,7,富邦-新營,2024-06-28,9693
3372,典範,12,5,7,富邦-新營,2024-06-28,9693
8277,商丞,8,1,7,富邦-新營,2024-06-28,9693
3438,類比科,10,3,7,富邦-新營,2024-06-28,9693
00937B,群益ESG投等債20,216,5,211,富邦-新營,2024-07-01,9693
2006,東和鋼鐵,100,0,100,富邦-新營,2024-07-01,9693
3481,群創,108,25,83,富邦-新營,2024-07-01,9693
00680L,元大美債20正2,82,0,82,富邦-新營,2024-07-01,9693
2344,華邦電,79,0,79,富邦-新營,2024-07-01,9693
00632R,元大台灣50反1,70,0,70,富邦-新營,2024-07-01,9693
2892,第一金,96,26,70,富邦-新營,2024-07-01,9693
00720B,元大投資級公司債,55,0,55,富邦-新營,2024-07-01,9693
2312,金寶,50,0,50,富邦-新營,2024-07-01,9693
2002,中鋼,45,0,45,富邦-新營,2024-07-01,9693
00929,復華台灣科技優息,46,3,43,富邦-新營,2024-07-01,9693
00687B,國泰20年美債,46,4,42,富邦-新營,2024-07-01,9693
2845,遠東銀,42,0,42,富邦-新營,2024-07-01,9693
00679B,元大美債20年,46,5,41,富邦-新營,2024-07-01,9693
00933B,國泰10Y+金融債,48,12,36,富邦-新營,2024-07-01,9693
4566,時碩工業,36,5,31,富邦-新營,2024-07-01,9693
5905,南仁湖,30,0,30,富邦-新營,2024-07-01,9693
0056,元大高股息,29,0,29,富邦-新營,2024-07-01,9693
2365,昆盈,887,859,28,富邦-新營,2024-07-01,9693
00688L,國泰20年美債正2,36,10,26,富邦-新營,2024-07-01,9693
4562,穎漢,300,274,26,富邦-新營,2024-07-01,9693
6834,天二科技,21,0,21,富邦-新營,2024-07-01,9693
2801,彰銀,21,0,21,富邦-新營,2024-07-01,9693
00936,台新永續高息中小,20,0,20,富邦-新營,2024-07-01,9693
4909,新復興,22,2,20,富邦-新營,2024-07-01,9693
3105,穩懋,20,3,17,富邦-新營,2024-07-01,9693
2338,光罩,16,0,16,富邦-新營,2024-07-01,9693
00753L,中信中國50正2,16,0,16,富邦-新營,2024-07-01,9693
6177,達麗,16,1,15,富邦-新營,2024-07-01,9693
00946,群益科技高息成長,14,0,14,富邦-新營,2024-07-01,9693
4167,松瑞藥,23,9,14,富邦-新營,2024-07-01,9693
4958,臻鼎-KY,15,1,14,富邦-新營,2024-07-01,9693
6770,力積電,14,1,13,富邦-新營,2024-07-01,9693
2328,廣宇,12,0,12,富邦-新營,2024-07-01,9693
3060,銘異,13,1,12,富邦-新營,2024-07-01,9693
00772B,中信高評級公司債,11,0,11,富邦-新營,2024-07-01,9693
2337,旺宏,11,0,11,富邦-新營,2024-07-01,9693
2352,佳世達,13,2,11,富邦-新營,2024-07-01,9693
8429,金麗-KY,11,0,11,富邦-新營,2024-07-01,9693
00948B,中信優息投資級債,11,0,11,富邦-新營,2024-07-01,9693
2317,鴻海,18,7,11,富邦-新營,2024-07-01,9693
3004,豐達科,10,0,10,富邦-新營,2024-07-01,9693
00902,中信電池及儲能,9,0,9,富邦-新營,2024-07-01,9693
5315,光聯,9,0,9,富邦-新營,2024-07-01,9693
5484,慧友,9,0,9,富邦-新營,2024-07-01,9693
6167,久正,10,1,9,富邦-新營,2024-07-01,9693
6435,大中,9,0,9,富邦-新營,2024-07-01,9693
2834,臺企銀,8,0,8,富邦-新營,2024-07-01,9693
3324,雙鴻,8,0,8,富邦-新營,2024-07-01,9693
5009,榮剛,11,3,8,富邦-新營,2024-07-01,9693
00929,復華台灣科技優息,308,12,296,富邦-新營,2024-07-02,9693
00934,中信成長高股息,114,0,114,富邦-新營,2024-07-02,9693
00942B,台新美A公司債20+,113,0,113,富邦-新營,2024-07-02,9693
00632R,元大台灣50反1,109,0,109,富邦-新營,2024-07-02,9693
00680L,元大美債20正2,113,13,100,富邦-新營,2024-07-02,9693
2303,聯電,94,1,93,富邦-新營,2024-07-02,9693
2317,鴻海,84,12,72,富邦-新營,2024-07-02,9693
2801,彰銀,54,0,54,富邦-新營,2024-07-02,9693
2485,兆赫,47,0,47,富邦-新營,2024-07-02,9693
00948B,中信優息投資級債,37,0,37,富邦-新營,2024-07-02,9693
00679B,元大美債20年,36,0,36,富邦-新營,2024-07-02,9693
0056,元大高股息,32,0,32,富邦-新營,2024-07-02,9693
3481,群創,41,10,31,富邦-新營,2024-07-02,9693
00937B,群益ESG投等債20,32,3,29,富邦-新營,2024-07-02,9693
2609,陽明,32,6,26,富邦-新營,2024-07-02,9693
00687B,國泰20年美債,26,1,25,富邦-新營,2024-07-02,9693
6285,啟��,23,0,23,富邦-新營,2024-07-02,9693
00919,群益台灣精選高息,33,10,23,富邦-新營,2024-07-02,9693
1785,光洋科,24,6,18,富邦-新營,2024-07-02,9693
6152,百一,19,1,18,富邦-新營,2024-07-02,9693
3211,順達,16,0,16,富邦-新營,2024-07-02,9693
4973,廣穎,16,0,16,富邦-新營,2024-07-02,9693
3231,緯創,28,13,15,富邦-新營,2024-07-02,9693
00933B,國泰10Y+金融債,30,15,15,富邦-新營,2024-07-02,9693
1409,新纖,15,0,15,富邦-新營,2024-07-02,9693
7402,邑錡,15,0,15,富邦-新營,2024-07-02,9693
8076,伍豐,22,7,15,富邦-新營,2024-07-02,9693
1777,生泰,14,0,14,富邦-新營,2024-07-02,9693
00712,復華富時不動產,12,0,12,富邦-新營,2024-07-02,9693
6167,久正,12,0,12,富邦-新營,2024-07-02,9693
00946,群益科技高息成長,12,1,11,富邦-新營,2024-07-02,9693
2412,中華電,11,0,11,富邦-新營,2024-07-02,9693
1609,大亞,11,0,11,富邦-新營,2024-07-02,9693
2495,普安,42,31,11,富邦-新營,2024-07-02,9693
3050,鈺德,11,0,11,富邦-新營,2024-07-02,9693
3312,弘憶股,74,63,11,富邦-新營,2024-07-02,9693
4306,炎洲,11,0,11,富邦-新營,2024-07-02,9693
8064,東捷,139,128,11,富邦-新營,2024-07-02,9693
1301,台塑,14,4,10,富邦-新營,2024-07-02,9693
1783,和康生,14,4,10,富邦-新營,2024-07-02,9693
2436,偉詮電,10,0,10,富邦-新營,2024-07-02,9693
6176,瑞儀,10,0,10,富邦-新營,2024-07-02,9693
00902,中信電池及儲能,10,0,10,富邦-新營,2024-07-02,9693
2867,三商壽,12,2,10,富邦-新營,2024-07-02,9693
3004,豐達科,10,0,10,富邦-新營,2024-07-02,9693
3441,聯一光,10,0,10,富邦-新營,2024-07-02,9693
3528,安馳,10,0,10,富邦-新營,2024-07-02,9693
2374,佳能,9,1,8,富邦-新營,2024-07-02,9693
4979,華星光,8,0,8,富邦-新營,2024-07-02,9693
2892,第一金,8,0,8,富邦-新營,2024-07-02,9693
00937B,群益ESG投等債20,264,0,264,富邦-新營,2024-07-03,9693
6244,茂迪,126,24,102,富邦-新營,2024-07-03,9693
2359,所羅門,136,37,99,富邦-新營,2024-07-03,9693
00934,中信成長高股息,95,4,91,富邦-新營,2024-07-03,9693
00679B,元大美債20年,60,2,58,富邦-新營,2024-07-03,9693
3481,群創,61,3,58,富邦-新營,2024-07-03,9693
00929,復華台灣科技優息,79,28,51,富邦-新營,2024-07-03,9693
5905,南仁湖,49,0,49,富邦-新營,2024-07-03,9693
3576,聯合再生,171,123,48,富邦-新營,2024-07-03,9693
00936,台新永續高息中小,43,0,43,富邦-新營,2024-07-03,9693
00881,國泰台灣5G+,50,8,42,富邦-新營,2024-07-03,9693
2887,台新金,49,8,41,富邦-新營,2024-07-03,9693
6016,康和證,40,0,40,富邦-新營,2024-07-03,9693
00687B,國泰20年美債,33,1,32,富邦-新營,2024-07-03,9693
2317,鴻海,43,15,28,富邦-新營,2024-07-03,9693
2618,長榮航,28,0,28,富邦-新營,2024-07-03,9693
4960,誠美材,32,5,27,富邦-新營,2024-07-03,9693
6167,久正,25,1,24,富邦-新營,2024-07-03,9693
4938,和碩,22,0,22,富邦-新營,2024-07-03,9693
8076,伍豐,21,0,21,富邦-新營,2024-07-03,9693
5876,上海商銀,20,0,20,富邦-新營,2024-07-03,9693
00680L,元大美債20正2,20,0,20,富邦-新營,2024-07-03,9693
1532,勤美,20,0,20,富邦-新營,2024-07-03,9693
00688L,國泰20年美債正2,19,0,19,富邦-新營,2024-07-03,9693
2605,新興,23,4,19,富邦-新營,2024-07-03,9693
2344,華邦電,32,14,18,富邦-新營,2024-07-03,9693
00915,凱基優選高股息30,17,0,17,富邦-新營,2024-07-03,9693
2855,統一證,21,4,17,富邦-新營,2024-07-03,9693
3703,欣陸,15,0,15,富邦-新營,2024-07-03,9693
8096,擎亞,15,0,15,富邦-新營,2024-07-03,9693
2405,輔信,24,10,14,富邦-新營,2024-07-03,9693
5355,佳總,14,0,14,富邦-新營,2024-07-03,9693
8440,綠電,14,0,14,富邦-新營,2024-07-03,9693
3047,訊舟,42,29,13,富邦-新營,2024-07-03,9693
2409,友達,12,0,12,富邦-新營,2024-07-03,9693
4510,高鋒,12,0,12,富邦-新營,2024-07-03,9693
6182,合晶,12,0,12,富邦-新營,2024-07-03,9693
6443,元晶,29,18,11,富邦-新營,2024-07-03,9693
2388,威盛,34,24,10,富邦-新營,2024-07-03,9693
2883B,凱基金乙特,10,0,10,富邦-新營,2024-07-03,9693
3004,豐達科,10,0,10,富邦-新營,2024-07-03,9693
6477,安集,15,5,10,富邦-新營,2024-07-03,9693
6578,達邦蛋白,10,0,10,富邦-新營,2024-07-03,9693
7402,邑錡,10,0,10,富邦-新營,2024-07-03,9693
1785,光洋科,34,25,9,富邦-新營,2024-07-03,9693
4133,亞諾法,9,0,9,富邦-新營,2024-07-03,9693
4973,廣穎,10,1,9,富邦-新營,2024-07-03,9693
6277,宏正,9,0,9,富邦-新營,2024-07-03,9693
8215,明基材,14,5,9,富邦-新營,2024-07-03,9693
0056,元大高股息,19,11,8,富邦-新營,2024-07-03,9693
00632R,元大台灣50反1,150,0,150,富邦-新營,2024-07-04,9693
1314,中石化,150,61,89,富邦-新營,2024-07-04,9693
9105,泰金寶-DR,100,16,84,富邦-新營,2024-07-04,9693
2855,統一證,70,2,68,富邦-新營,2024-07-04,9693
00940,元大台灣價值高息,60,8,52,富邦-新營,2024-07-04,9693
2913,農林,50,0,50,富邦-新營,2024-07-04,9693
6443,元晶,78,29,49,富邦-新營,2024-07-04,9693
2412,中華電,34,0,34,富邦-新營,2024-07-04,9693
1815,富喬,52,19,33,富邦-新營,2024-07-04,9693
00934,中信成長高股息,33,1,32,富邦-新營,2024-07-04,9693
00897,富邦基因免疫生技,30,0,30,富邦-新營,2024-07-04,9693
2634,漢翔,30,0,30,富邦-新營,2024-07-04,9693
6869,雲豹能源,50,21,29,富邦-新營,2024-07-04,9693
00927,群益半導體收益,25,2,23,富邦-新營,2024-07-04,9693
3615,安可,214,193,21,富邦-新營,2024-07-04,9693
2401,凌陽,21,0,21,富邦-新營,2024-07-04,9693
3673,TPK-KY,21,1,20,富邦-新營,2024-07-04,9693
5347,世界,18,0,18,富邦-新營,2024-07-04,9693
5392,能率,24,6,18,富邦-新營,2024-07-04,9693
2618,長榮航,26,8,18,富邦-新營,2024-07-04,9693
00751B,元大AAA至A公司債,16,0,16,富邦-新營,2024-07-04,9693
1777,生泰,16,0,16,富邦-新營,2024-07-04,9693
1785,光洋科,93,77,16,富邦-新營,2024-07-04,9693
6202,盛群,16,0,16,富邦-新營,2024-07-04,9693
2201,裕隆,14,0,14,富邦-新營,2024-07-04,9693
6189,豐藝,18,4,14,富邦-新營,2024-07-04,9693
3312,弘憶股,49,36,13,富邦-新營,2024-07-04,9693
00946,群益科技高息成長,15,2,13,富邦-新營,2024-07-04,9693
00892,富邦台灣半導體,14,1,13,富邦-新營,2024-07-04,9693
1618,合機,16,4,12,富邦-新營,2024-07-04,9693
1227,佳格,11,0,11,富邦-新營,2024-07-04,9693
2367,燿華,11,0,11,富邦-新營,2024-07-04,9693
3450,聯鈞,30,19,11,富邦-新營,2024-07-04,9693
3591,艾笛森,11,0,11,富邦-新營,2024-07-04,9693
5443,均豪,25,15,10,富邦-新營,2024-07-04,9693
00676R,富邦臺灣加權反1,10,0,10,富邦-新營,2024-07-04,9693
00664R,國泰臺灣加權反1,10,0,10,富邦-新營,2024-07-04,9693
00688L,國泰20年美債正2,10,0,10,富邦-新營,2024-07-04,9693
2025,千興,10,0,10,富邦-新營,2024-07-04,9693
2405,輔信,32,22,10,富邦-新營,2024-07-04,9693
2883B,凱基金乙特,10,0,10,富邦-新營,2024-07-04,9693
4109,加捷生醫,14,4,10,富邦-新營,2024-07-04,9693
5426,振發,10,0,10,富邦-新營,2024-07-04,9693
8076,伍豐,10,0,10,富邦-新營,2024-07-04,9693
6176,瑞儀,11,1,10,富邦-新營,2024-07-04,9693
00949,復華日本龍頭,10,1,9,富邦-新營,2024-07-04,9693
6698,旭暉應材,15,6,9,富邦-新營,2024-07-04,9693
8429,金麗-KY,12,3,9,富邦-新營,2024-07-04,9693
3481,群創,46,37,9,富邦-新營,2024-07-04,9693
00936,台新永續高息中小,8,0,8,富邦-新營,2024-07-04,9693
3047,訊舟,711,505,206,富邦-新營,2024-07-05,9693
00679B,元大美債20年,114,0,114,富邦-新營,2024-07-05,9693
2367,燿華,147,45,102,富邦-新營,2024-07-05,9693
2467,志聖,106,6,100,富邦-新營,2024-07-05,9693
2464,盟立,450,351,99,富邦-新營,2024-07-05,9693
6244,茂迪,84,35,49,富邦-新營,2024-07-05,9693
00878,國泰永續高股息,61,13,48,富邦-新營,2024-07-05,9693
6443,元晶,48,12,36,富邦-新營,2024-07-05,9693
00929,復華台灣科技優息,40,5,35,富邦-新營,2024-07-05,9693
3481,群創,38,5,33,富邦-新營,2024-07-05,9693
2888,新光金,48,17,31,富邦-新營,2024-07-05,9693
2601,益航,30,5,25,富邦-新營,2024-07-05,9693
3313,斐成,30,6,24,富邦-新營,2024-07-05,9693
6189,豐藝,23,0,23,富邦-新營,2024-07-05,9693
00937B,群益ESG投等債20,22,0,22,富邦-新營,2024-07-05,9693
3048,益登,172,150,22,富邦-新營,2024-07-05,9693
2301,光寶科,21,1,20,富邦-新營,2024-07-05,9693
00665L,富邦�琤肭磪囓�2,20,0,20,富邦-新營,2024-07-05,9693
2103,台橡,20,0,20,富邦-新營,2024-07-05,9693
2312,金寶,24,4,20,富邦-新營,2024-07-05,9693
4906,正文,26,6,20,富邦-新營,2024-07-05,9693
8215,明基材,20,0,20,富邦-新營,2024-07-05,9693
2412,中華電,31,11,20,富邦-新營,2024-07-05,9693
4543,萬在,20,1,19,富邦-新營,2024-07-05,9693
5392,能率,19,3,16,富邦-新營,2024-07-05,9693
2618,長榮航,22,6,16,富邦-新營,2024-07-05,9693
00639,富邦深100,15,0,15,富邦-新營,2024-07-05,9693
2883,凱基金,20,5,15,富邦-新營,2024-07-05,9693
2610,華航,16,1,15,富邦-新營,2024-07-05,9693
00934,中信成長高股息,20,5,15,富邦-新營,2024-07-05,9693
2317,鴻海,30,16,14,富邦-新營,2024-07-05,9693
6770,力積電,14,0,14,富邦-新營,2024-07-05,9693
2603,長榮,15,1,14,富邦-新營,2024-07-05,9693
6152,百一,13,0,13,富邦-新營,2024-07-05,9693
00881,國泰台灣5G+,12,0,12,富邦-新營,2024-07-05,9693
1305,華夏,12,0,12,富邦-新營,2024-07-05,9693
2069,運錩,12,0,12,富邦-新營,2024-07-05,9693
4561,健椿,12,0,12,富邦-新營,2024-07-05,9693
8277,商丞,12,0,12,富邦-新營,2024-07-05,9693
6191,精成科,12,0,12,富邦-新營,2024-07-05,9693
6207,雷科,30,18,12,富邦-新營,2024-07-05,9693
2609,陽明,21,10,11,富邦-新營,2024-07-05,9693
0056,元大高股息,12,1,11,富邦-新營,2024-07-05,9693
00680L,元大美債20正2,11,0,11,富邦-新營,2024-07-05,9693
00933B,國泰10Y+金融債,11,0,11,富邦-新營,2024-07-05,9693
6005,群益證,11,0,11,富邦-新營,2024-07-05,9693
6263,普萊德,11,0,11,富邦-新營,2024-07-05,9693
00909,國泰數位支付服務,11,0,11,富邦-新營,2024-07-05,9693
00686R,群益臺灣加權反1,10,0,10,富邦-新營,2024-07-05,9693
00676R,富邦臺灣加權反1,10,0,10,富邦-新營,2024-07-05,9693
00945B,凱基美國非投等債,174,0,174,富邦-新營,2024-07-08,9693
00934,中信成長高股息,60,0,60,富邦-新營,2024-07-08,9693
2515,中工,60,1,59,富邦-新營,2024-07-08,9693
2618,長榮航,58,0,58,富邦-新營,2024-07-08,9693
00927,群益半導體收益,62,5,57,富邦-新營,2024-07-08,9693
6282,康舒,50,2,48,富邦-新營,2024-07-08,9693
00918,大華優利高填息30,48,0,48,富邦-新營,2024-07-08,9693
00929,復華台灣科技優息,59,14,45,富邦-新營,2024-07-08,9693
8150,南茂,37,1,36,富邦-新營,2024-07-08,9693
4533,協易機,32,0,32,富邦-新營,2024-07-08,9693
00665L,富邦�琤肭磪囓�2,31,0,31,富邦-新營,2024-07-08,9693
8021,尖點,30,0,30,富邦-新營,2024-07-08,9693
2417,圓剛,41,12,29,富邦-新營,2024-07-08,9693
6215,和椿,23,1,22,富邦-新營,2024-07-08,9693
8234,新漢,22,1,21,富邦-新營,2024-07-08,9693
2108,南帝,23,2,21,富邦-新營,2024-07-08,9693
6152,百一,21,0,21,富邦-新營,2024-07-08,9693
00753L,中信中國50正2,20,0,20,富邦-新營,2024-07-08,9693
00688L,國泰20年美債正2,30,10,20,富邦-新營,2024-07-08,9693
3694,海華,20,0,20,富邦-新營,2024-07-08,9693
8076,伍豐,20,0,20,富邦-新營,2024-07-08,9693
00939,統一台灣高息動能,20,1,19,富邦-新營,2024-07-08,9693
1569,濱川,20,1,19,富邦-新營,2024-07-08,9693
2337,旺宏,24,6,18,富邦-新營,2024-07-08,9693
6191,精成科,24,6,18,富邦-新營,2024-07-08,9693
2906,高林,17,0,17,富邦-新營,2024-07-08,9693
5328,華容,18,1,17,富邦-新營,2024-07-08,9693
1316,上曜,16,0,16,富邦-新營,2024-07-08,9693
6753,龍德造船,16,0,16,富邦-新營,2024-07-08,9693
00687B,國泰20年美債,15,1,14,富邦-新營,2024-07-08,9693
1709,和益,15,1,14,富邦-新營,2024-07-08,9693
1785,光洋科,28,15,13,富邦-新營,2024-07-08,9693
00632R,元大台灣50反1,232,219,13,富邦-新營,2024-07-08,9693
2324,仁寶,18,5,13,富邦-新營,2024-07-08,9693
5452,佶優,15,2,13,富邦-新營,2024-07-08,9693
8383,千附,13,0,13,富邦-新營,2024-07-08,9693
00936,台新永續高息中小,39,26,13,富邦-新營,2024-07-08,9693
5347,世界,13,1,12,富邦-新營,2024-07-08,9693
2412,中華電,14,2,12,富邦-新營,2024-07-08,9693
00935,野村臺灣新科技50,13,1,12,富邦-新營,2024-07-08,9693
00944,野村趨勢動能高息,12,0,12,富邦-新營,2024-07-08,9693
5202,力新,12,0,12,富邦-新營,2024-07-08,9693
4967,十銓,14,2,12,富邦-新營,2024-07-08,9693
6189,豐藝,25,14,11,富邦-新營,2024-07-08,9693
3042,晶技,11,0,11,富邦-新營,2024-07-08,9693
00882,中信中國高股息,10,0,10,富邦-新營,2024-07-08,9693
1806,冠軍,10,0,10,富邦-新營,2024-07-08,9693
2601,益航,10,0,10,富邦-新營,2024-07-08,9693
3055,蔚華科,13,3,10,富邦-新營,2024-07-08,9693
1789,神隆,11,2,9,富邦-新營,2024-07-08,9693
3047,訊舟,380,122,258,富邦-新營,2024-07-09,9693
9105,泰金寶-DR,303,67,236,富邦-新營,2024-07-09,9693
2888,新光金,213,74,139,富邦-新營,2024-07-09,9693
00687B,國泰20年美債,125,19,106,富邦-新營,2024-07-09,9693
4960,誠美材,130,31,99,富邦-新營,2024-07-09,9693
2367,燿華,351,255,96,富邦-新營,2024-07-09,9693
00688L,國泰20年美債正2,90,0,90,富邦-新營,2024-07-09,9693
2834,臺企銀,98,9,89,富邦-新營,2024-07-09,9693
2344,華邦電,89,2,87,富邦-新營,2024-07-09,9693
00937B,群益ESG投等債20,54,1,53,富邦-新營,2024-07-09,9693
00753L,中信中國50正2,50,0,50,富邦-新營,2024-07-09,9693
2897,王道銀行,45,0,45,富邦-新營,2024-07-09,9693
3050,鈺德,55,10,45,富邦-新營,2024-07-09,9693
00936,台新永續高息中小,51,6,45,富邦-新營,2024-07-09,9693
6806,森崴能源,56,13,43,富邦-新營,2024-07-09,9693
2312,金寶,194,157,37,富邦-新營,2024-07-09,9693
00713,元大台灣高息低波,35,0,35,富邦-新營,2024-07-09,9693
1314,中石化,36,1,35,富邦-新營,2024-07-09,9693
2353,宏��,36,1,35,富邦-新營,2024-07-09,9693
2609,陽明,45,13,32,富邦-新營,2024-07-09,9693
1305,華夏,29,0,29,富邦-新營,2024-07-09,9693
00929,復華台灣科技優息,75,48,27,富邦-新營,2024-07-09,9693
2317,鴻海,50,24,26,富邦-新營,2024-07-09,9693
2337,旺宏,24,1,23,富邦-新營,2024-07-09,9693
00927,群益半導體收益,23,2,21,富邦-新營,2024-07-09,9693
1718,中纖,20,0,20,富邦-新營,2024-07-09,9693
2406,國碩,25,5,20,富邦-新營,2024-07-09,9693
2610,華航,21,2,19,富邦-新營,2024-07-09,9693
1617,榮星,18,0,18,富邦-新營,2024-07-09,9693
6841,長佳智能,16,0,16,富邦-新營,2024-07-09,9693
2420,新巨,15,0,15,富邦-新營,2024-07-09,9693
2489,瑞軒,23,8,15,富邦-新營,2024-07-09,9693
3694,海華,15,0,15,富邦-新營,2024-07-09,9693
6615,慧智,14,0,14,富邦-新營,2024-07-09,9693
8215,明基材,15,1,14,富邦-新營,2024-07-09,9693
2618,長榮航,17,4,13,富邦-新營,2024-07-09,9693
6578,達邦蛋白,13,0,13,富邦-新營,2024-07-09,9693
5905,南仁湖,13,1,12,富邦-新營,2024-07-09,9693
1608,華榮,14,3,11,富邦-新營,2024-07-09,9693
1316,上曜,13,2,11,富邦-新營,2024-07-09,9693
912000,晨訊科-DR,11,0,11,富邦-新營,2024-07-09,9693
2464,盟立,38,27,11,富邦-新營,2024-07-09,9693
00662,富邦NASDAQ,10,0,10,富邦-新營,2024-07-09,9693
00764B,群益25年美債,10,0,10,富邦-新營,2024-07-09,9693
1536,和大,13,3,10,富邦-新營,2024-07-09,9693
1909,榮成,10,0,10,富邦-新營,2024-07-09,9693
2070,精湛,10,0,10,富邦-新營,2024-07-09,9693
2601,益航,10,0,10,富邦-新營,2024-07-09,9693
2634,漢翔,10,0,10,富邦-新營,2024-07-09,9693
4142,國光生,10,0,10,富邦-新營,2024-07-09,9693
2834,臺企銀,118,0,118,富邦-新營,2024-07-10,9693
2397,友通,103,3,100,富邦-新營,2024-07-10,9693
2489,瑞軒,418,320,98,富邦-新營,2024-07-10,9693
6869,雲豹能源,60,0,60,富邦-新營,2024-07-10,9693
2897,王道銀行,64,7,57,富邦-新營,2024-07-10,9693
2887,台新金,55,0,55,富邦-新營,2024-07-10,9693
1718,中纖,51,0,51,富邦-新營,2024-07-10,9693
3312,弘憶股,66,17,49,富邦-新營,2024-07-10,9693
00929,復華台灣科技優息,77,36,41,富邦-新營,2024-07-10,9693
2317,鴻海,51,11,40,富邦-新營,2024-07-10,9693
4510,高鋒,41,2,39,富邦-新營,2024-07-10,9693
2353,宏��,64,29,35,富邦-新營,2024-07-10,9693
2884,玉山金,37,2,35,富邦-新營,2024-07-10,9693
00772B,中信高評級公司債,33,0,33,富邦-新營,2024-07-10,9693
00712,復華富時不動產,29,0,29,富邦-新營,2024-07-10,9693
00937B,群益ESG投等債20,29,0,29,富邦-新營,2024-07-10,9693
3576,聯合再生,29,1,28,富邦-新營,2024-07-10,9693
00927,群益半導體收益,25,0,25,富邦-新營,2024-07-10,9693
3162,精確,21,0,21,富邦-新營,2024-07-10,9693
2890,永豐金,22,2,20,富邦-新營,2024-07-10,9693
1616,億泰,21,2,19,富邦-新營,2024-07-10,9693
2392,正崴,47,29,18,富邦-新營,2024-07-10,9693
00934,中信成長高股息,27,9,18,富邦-新營,2024-07-10,9693
2344,華邦電,18,2,16,富邦-新營,2024-07-10,9693
2367,燿華,56,40,16,富邦-新營,2024-07-10,9693
2405,輔信,17,1,16,富邦-新營,2024-07-10,9693
2382,廣達,18,2,16,富邦-新營,2024-07-10,9693
00947,台新臺灣IC設計,17,2,15,富邦-新營,2024-07-10,9693
1618,合機,18,3,15,富邦-新營,2024-07-10,9693
3594,磐儀,17,2,15,富邦-新營,2024-07-10,9693
5701,劍湖山,15,0,15,富邦-新營,2024-07-10,9693
2547,日勝生,15,1,14,富邦-新營,2024-07-10,9693
4904,遠傳,15,2,13,富邦-新營,2024-07-10,9693
1609,大亞,21,8,13,富邦-新營,2024-07-10,9693
2303,聯電,26,14,12,富邦-新營,2024-07-10,9693
00935,野村臺灣新科技50,11,0,11,富邦-新營,2024-07-10,9693
1325,恆大,11,0,11,富邦-新營,2024-07-10,9693
3062,建漢,20,9,11,富邦-新營,2024-07-10,9693
4976,佳凌,11,0,11,富邦-新營,2024-07-10,9693
00939,統一台灣高息動能,10,0,10,富邦-新營,2024-07-10,9693
00632R,元大台灣50反1,10,0,10,富邦-新營,2024-07-10,9693
00662,富邦NASDAQ,10,0,10,富邦-新營,2024-07-10,9693
00931B,統一美債20年,10,0,10,富邦-新營,2024-07-10,9693
00945B,凱基美國非投等債,10,0,10,富邦-新營,2024-07-10,9693
1340,勝悅-KY,10,0,10,富邦-新營,2024-07-10,9693
2514,龍邦,10,0,10,富邦-新營,2024-07-10,9693
3032,偉訓,12,2,10,富邦-新營,2024-07-10,9693
4958,臻鼎-KY,14,4,10,富邦-新營,2024-07-10,9693
6257,矽格,10,0,10,富邦-新營,2024-07-10,9693
6770,力積電,10,0,10,富邦-新營,2024-07-10,9693
2312,金寶,810,20,790,富邦-新營,2024-07-11,9693
2855,統一證,440,0,440,富邦-新營,2024-07-11,9693
3312,弘憶股,244,64,180,富邦-新營,2024-07-11,9693
2888,新光金,141,46,95,富邦-新營,2024-07-11,9693
1316,上曜,77,17,60,富邦-新營,2024-07-11,9693
5225,東科-KY,79,23,56,富邦-新營,2024-07-11,9693
2886,兆豐金,51,3,48,富邦-新營,2024-07-11,9693
2913,農林,45,0,45,富邦-新營,2024-07-11,9693
00632R,元大台灣50反1,43,2,41,富邦-新營,2024-07-11,9693
00679B,元大美債20年,41,1,40,富邦-新營,2024-07-11,9693
2025,千興,39,0,39,富邦-新營,2024-07-11,9693
6282,康舒,44,11,33,富邦-新營,2024-07-11,9693
00934,中信成長高股息,37,5,32,富邦-新營,2024-07-11,9693
2349,錸德,41,13,28,富邦-新營,2024-07-11,9693
6173,信昌電,32,5,27,富邦-新營,2024-07-11,9693
6770,力積電,48,21,27,富邦-新營,2024-07-11,9693
2365,昆盈,316,291,25,富邦-新營,2024-07-11,9693
3450,聯鈞,32,8,24,富邦-新營,2024-07-11,9693
2317,鴻海,33,12,21,富邦-新營,2024-07-11,9693
2405,輔信,23,2,21,富邦-新營,2024-07-11,9693
3372,典範,20,0,20,富邦-新營,2024-07-11,9693
8438,昶昕,22,2,20,富邦-新營,2024-07-11,9693
2882,國泰金,24,5,19,富邦-新營,2024-07-11,9693
2618,長榮航,21,2,19,富邦-新營,2024-07-11,9693
1514,亞力,25,7,18,富邦-新營,2024-07-11,9693
2354,鴻準,19,2,17,富邦-新營,2024-07-11,9693
00937B,群益ESG投等債20,16,0,16,富邦-新營,2024-07-11,9693
1532,勤美,19,3,16,富邦-新營,2024-07-11,9693
2324,仁寶,17,1,16,富邦-新營,2024-07-11,9693
2337,旺宏,63,47,16,富邦-新營,2024-07-11,9693
2362,藍天,15,0,15,富邦-新營,2024-07-11,9693
1314,中石化,14,0,14,富邦-新營,2024-07-11,9693
3062,建漢,18,4,14,富邦-新營,2024-07-11,9693
2464,盟立,41,28,13,富邦-新營,2024-07-11,9693
4510,高鋒,19,6,13,富邦-新營,2024-07-11,9693
4533,協易機,13,0,13,富邦-新營,2024-07-11,9693
00940,元大台灣價值高息,38,25,13,富邦-新營,2024-07-11,9693
2867,三商壽,29,16,13,富邦-新營,2024-07-11,9693
00905,FT臺灣Smart,11,0,11,富邦-新營,2024-07-11,9693
5009,榮剛,12,1,11,富邦-新營,2024-07-11,9693
6116,彩晶,11,0,11,富邦-新營,2024-07-11,9693
00933B,國泰10Y+金融債,10,0,10,富邦-新營,2024-07-11,9693
1709,和益,10,0,10,富邦-新營,2024-07-11,9693
4414,如興,10,0,10,富邦-新營,2024-07-11,9693
6190,萬泰科,11,1,10,富邦-新營,2024-07-11,9693
6530,創威,18,8,10,富邦-新營,2024-07-11,9693
9927,泰銘,10,0,10,富邦-新營,2024-07-11,9693
3050,鈺德,23,14,9,富邦-新營,2024-07-11,9693
4114,健喬,9,0,9,富邦-新營,2024-07-11,9693
5351,鈺創,10,1,9,富邦-新營,2024-07-11,9693
00929,復華台灣科技優息,172,5,167,富邦-新營,2024-07-12,9693
00919,群益台灣精選高息,134,2,132,富邦-新營,2024-07-12,9693
00934,中信成長高股息,85,5,80,富邦-新營,2024-07-12,9693
2317,鴻海,96,20,76,富邦-新營,2024-07-12,9693
00881,國泰台灣5G+,67,0,67,富邦-新營,2024-07-12,9693
2303,聯電,42,2,40,富邦-新營,2024-07-12,9693
5347,世界,41,8,33,富邦-新營,2024-07-12,9693
2883,凱基金,33,2,31,富邦-新營,2024-07-12,9693
2349,錸德,30,0,30,富邦-新營,2024-07-12,9693
00937B,群益ESG投等債20,30,0,30,富邦-新營,2024-07-12,9693
00927,群益半導體收益,29,0,29,富邦-新營,2024-07-12,9693
0056,元大高股息,29,0,29,富邦-新營,2024-07-12,9693
2330,台積電,28,2,26,富邦-新營,2024-07-12,9693
2610,華航,29,3,26,富邦-新營,2024-07-12,9693
00679B,元大美債20年,27,3,24,富邦-新營,2024-07-12,9693
00878,國泰永續高股息,44,20,24,富邦-新營,2024-07-12,9693
2618,長榮航,24,3,21,富邦-新營,2024-07-12,9693
6834,天二科技,23,2,21,富邦-新營,2024-07-12,9693
00671R,富邦NASDAQ反1,20,0,20,富邦-新營,2024-07-12,9693
006208,富邦台50,20,1,19,富邦-新營,2024-07-12,9693
3163,波若威,32,13,19,富邦-新營,2024-07-12,9693
3363,上詮,20,1,19,富邦-新營,2024-07-12,9693
1514,亞力,26,7,19,富邦-新營,2024-07-12,9693
3019,亞光,25,6,19,富邦-新營,2024-07-12,9693
6743,安普新,18,0,18,富邦-新營,2024-07-12,9693
4726,永昕,23,6,17,富邦-新營,2024-07-12,9693
2609,陽明,16,0,16,富邦-新營,2024-07-12,9693
00757,統一FANG+,16,0,16,富邦-新營,2024-07-12,9693
2371,大同,19,3,16,富邦-新營,2024-07-12,9693
2881,富邦金,26,11,15,富邦-新營,2024-07-12,9693
00918,大華優利高填息30,15,0,15,富邦-新營,2024-07-12,9693
1301,台塑,18,4,14,富邦-新營,2024-07-12,9693
1536,和大,21,8,13,富邦-新營,2024-07-12,9693
2855,統一證,13,0,13,富邦-新營,2024-07-12,9693
3260,威剛,11,0,11,富邦-新營,2024-07-12,9693
00662,富邦NASDAQ,11,0,11,富邦-新營,2024-07-12,9693
00928,中信上櫃ESG30,11,0,11,富邦-新營,2024-07-12,9693
4123,晟德,11,0,11,富邦-新營,2024-07-12,9693
00935,野村臺灣新科技50,11,0,11,富邦-新營,2024-07-12,9693
00905,FT臺灣Smart,10,0,10,富邦-新營,2024-07-12,9693
2030,彰源,10,0,10,富邦-新營,2024-07-12,9693
00882,中信中國高股息,10,0,10,富邦-新營,2024-07-12,9693
00669R,國泰美國道瓊反1,10,0,10,富邦-新營,2024-07-12,9693
00637L,元大滬深300正2,10,0,10,富邦-新營,2024-07-12,9693
00752,中信中國50,10,0,10,富邦-新營,2024-07-12,9693
00949,復華日本龍頭,10,0,10,富邦-新營,2024-07-12,9693
2104,國際中橡,10,0,10,富邦-新營,2024-07-12,9693
3042,晶技,10,0,10,富邦-新營,2024-07-12,9693
6733,博晟生醫,10,0,10,富邦-新營,2024-07-12,9693
8358,金居,11,1,10,富邦-新營,2024-07-12,9693
00934,中信成長高股息,185,22,163,富邦-新營,2024-07-15,9693
00942B,台新美A公司債20+,114,0,114,富邦-新營,2024-07-15,9693
1314,中石化,101,0,101,富邦-新營,2024-07-15,9693
1605,華新,102,10,92,富邦-新營,2024-07-15,9693
1304,台聚,68,8,60,富邦-新營,2024-07-15,9693
3305,昇貿,53,0,53,富邦-新營,2024-07-15,9693
4526,東台,52,7,45,富邦-新營,2024-07-15,9693
2618,長榮航,47,5,42,富邦-新營,2024-07-15,9693
1568,倉佑,32,2,30,富邦-新營,2024-07-15,9693
2356,英業達,72,45,27,富邦-新營,2024-07-15,9693
2409,友達,28,1,27,富邦-新營,2024-07-15,9693
4533,協易機,31,5,26,富邦-新營,2024-07-15,9693
00937B,群益ESG投等債20,34,9,25,富邦-新營,2024-07-15,9693
1540,喬福,25,0,25,富邦-新營,2024-07-15,9693
3021,鴻名,25,0,25,富邦-新營,2024-07-15,9693
2610,華航,24,0,24,富邦-新營,2024-07-15,9693
00918,大華優利高填息30,23,1,22,富邦-新營,2024-07-15,9693
1608,華榮,58,36,22,富邦-新營,2024-07-15,9693
00679B,元大美債20年,23,1,22,富邦-新營,2024-07-15,9693
2891,中信金,27,6,21,富邦-新營,2024-07-15,9693
6179,亞通,23,2,21,富邦-新營,2024-07-15,9693
4108,懷特,21,0,21,富邦-新營,2024-07-15,9693
00933B,國泰10Y+金融債,20,0,20,富邦-新營,2024-07-15,9693
2303,聯電,22,2,20,富邦-新營,2024-07-15,9693
3322,建舜電,20,0,20,富邦-新營,2024-07-15,9693
00878,國泰永續高股息,22,3,19,富邦-新營,2024-07-15,9693
00936,台新永續高息中小,18,0,18,富邦-新營,2024-07-15,9693
00665L,富邦�琤肭磪囓�2,20,2,18,富邦-新營,2024-07-15,9693
2329,華泰,17,0,17,富邦-新營,2024-07-15,9693
3712,永崴投控,22,5,17,富邦-新營,2024-07-15,9693
2867,三商壽,36,19,17,富邦-新營,2024-07-15,9693
6770,力積電,16,0,16,富邦-新營,2024-07-15,9693
5381,合正,25,10,15,富邦-新營,2024-07-15,9693
2438,翔耀,16,2,14,富邦-新營,2024-07-15,9693
2845,遠東銀,15,1,14,富邦-新營,2024-07-15,9693
2883,凱基金,15,2,13,富邦-新營,2024-07-15,9693
2316,楠梓電,13,1,12,富邦-新營,2024-07-15,9693
2324,仁寶,13,1,12,富邦-新營,2024-07-15,9693
1409,新纖,22,10,12,富邦-新營,2024-07-15,9693
2338,光罩,12,0,12,富邦-新營,2024-07-15,9693
2399,映泰,24,12,12,富邦-新營,2024-07-15,9693
0056,元大高股息,23,11,12,富邦-新營,2024-07-15,9693
1612,宏泰,11,0,11,富邦-新營,2024-07-15,9693
3576,聯合再生,12,1,11,富邦-新營,2024-07-15,9693
6443,元晶,11,0,11,富邦-新營,2024-07-15,9693
2408,南亞科,10,0,10,富邦-新營,2024-07-15,9693
00664R,國泰臺灣加權反1,10,0,10,富邦-新營,2024-07-15,9693
00693U,期街口S＆P黃豆,10,0,10,富邦-新營,2024-07-15,9693
00935,野村臺灣新科技50,10,0,10,富邦-新營,2024-07-15,9693
1313,聯成,10,0,10,富邦-新營,2024-07-15,9693
00929,復華台灣科技優息,168,13,155,富邦-新營,2024-07-16,9693
00680L,元大美債20正2,110,0,110,富邦-新營,2024-07-16,9693
3163,波若威,97,15,82,富邦-新營,2024-07-16,9693
4526,東台,63,2,61,富邦-新營,2024-07-16,9693
00934,中信成長高股息,55,2,53,富邦-新營,2024-07-16,9693
2312,金寶,135,83,52,富邦-新營,2024-07-16,9693
4414,如興,50,2,48,富邦-新營,2024-07-16,9693
00919,群益台灣精選高息,45,0,45,富邦-新營,2024-07-16,9693
3324,雙鴻,43,0,43,富邦-新營,2024-07-16,9693
2317,鴻海,54,11,43,富邦-新營,2024-07-16,9693
6026,福邦證,40,0,40,富邦-新營,2024-07-16,9693
00905,FT臺灣Smart,106,70,36,富邦-新營,2024-07-16,9693
2537,聯上發,34,2,32,富邦-新營,2024-07-16,9693
0056,元大高股息,32,3,29,富邦-新營,2024-07-16,9693
1304,台聚,24,0,24,富邦-新營,2024-07-16,9693
00878,國泰永續高股息,23,0,23,富邦-新營,2024-07-16,9693
00753L,中信中國50正2,23,0,23,富邦-新營,2024-07-16,9693
9945,潤泰新,26,4,22,富邦-新營,2024-07-16,9693
6104,創惟,32,10,22,富邦-新營,2024-07-16,9693
2303,聯電,27,6,21,富邦-新營,2024-07-16,9693
00671R,富邦NASDAQ反1,20,0,20,富邦-新營,2024-07-16,9693
00665L,富邦�琤肭磪囓�2,20,0,20,富邦-新營,2024-07-16,9693
00688L,國泰20年美債正2,20,0,20,富邦-新營,2024-07-16,9693
2405,輔信,32,12,20,富邦-新營,2024-07-16,9693
2409,友達,20,0,20,富邦-新營,2024-07-16,9693
4157,太景*-KY,20,0,20,富邦-新營,2024-07-16,9693
6625,必應,20,0,20,富邦-新營,2024-07-16,9693
1785,光洋科,25,5,20,富邦-新營,2024-07-16,9693
00712,復華富時不動產,25,7,18,富邦-新營,2024-07-16,9693
00720B,元大投資級公司債,17,0,17,富邦-新營,2024-07-16,9693
3021,鴻名,16,0,16,富邦-新營,2024-07-16,9693
00949,復華日本龍頭,15,0,15,富邦-新營,2024-07-16,9693
4909,新復興,44,29,15,富邦-新營,2024-07-16,9693
1513,中興電,16,1,15,富邦-新營,2024-07-16,9693
2356,英業達,19,5,14,富邦-新營,2024-07-16,9693
2211,長榮鋼,14,0,14,富邦-新營,2024-07-16,9693
1442,名軒,14,0,14,富邦-新營,2024-07-16,9693
9105,泰金寶-DR,57,43,14,富邦-新營,2024-07-16,9693
2891,中信金,15,2,13,富邦-新營,2024-07-16,9693
3576,聯合再生,15,2,13,富邦-新營,2024-07-16,9693
5302,太欣,13,0,13,富邦-新營,2024-07-16,9693
4533,協易機,13,2,11,富邦-新營,2024-07-16,9693
3234,光環,11,0,11,富邦-新營,2024-07-16,9693
1471,首利,10,0,10,富邦-新營,2024-07-16,9693
3466,德晉,10,0,10,富邦-新營,2024-07-16,9693
4743,合一,10,0,10,富邦-新營,2024-07-16,9693
5328,華容,29,19,10,富邦-新營,2024-07-16,9693
2440,太空梭,8,0,8,富邦-新營,2024-07-16,9693
3050,鈺德,8,0,8,富邦-新營,2024-07-16,9693
3708,上緯投控,8,1,7,富邦-新營,2024-07-16,9693
2489,瑞軒,547,10,537,富邦-新營,2024-07-17,9693
00929,復華台灣科技優息,128,1,127,富邦-新營,2024-07-17,9693
4960,誠美材,105,2,103,富邦-新營,2024-07-17,9693
2888,新光金,82,17,65,富邦-新營,2024-07-17,9693
00679B,元大美債20年,65,7,58,富邦-新營,2024-07-17,9693
00949,復華日本龍頭,57,0,57,富邦-新營,2024-07-17,9693
2537,聯上發,146,101,45,富邦-新營,2024-07-17,9693
00753L,中信中國50正2,49,7,42,富邦-新營,2024-07-17,9693
5263,智崴,45,5,40,富邦-新營,2024-07-17,9693
00665L,富邦�琤肭磪囓�2,40,0,40,富邦-新營,2024-07-17,9693
00680L,元大美債20正2,40,2,38,富邦-新營,2024-07-17,9693
4906,正文,68,30,38,富邦-新營,2024-07-17,9693
2449,京元電子,36,4,32,富邦-新營,2024-07-17,9693
00918,大華優利高填息30,32,1,31,富邦-新營,2024-07-17,9693
2891,中信金,29,0,29,富邦-新營,2024-07-17,9693
2884,玉山金,33,5,28,富邦-新營,2024-07-17,9693
00936,台新永續高息中小,26,1,25,富邦-新營,2024-07-17,9693
1471,首利,30,6,24,富邦-新營,2024-07-17,9693
6770,力積電,32,10,22,富邦-新營,2024-07-17,9693
00919,群益台灣精選高息,36,14,22,富邦-新營,2024-07-17,9693
00937B,群益ESG投等債20,31,9,22,富邦-新營,2024-07-17,9693
2330,台積電,24,3,21,富邦-新營,2024-07-17,9693
3047,訊舟,23,2,21,富邦-新營,2024-07-17,9693
00878,國泰永續高股息,22,2,20,富邦-新營,2024-07-17,9693
006208,富邦台50,22,2,20,富邦-新營,2024-07-17,9693
0056,元大高股息,20,0,20,富邦-新營,2024-07-17,9693
00905,FT臺灣Smart,18,0,18,富邦-新營,2024-07-17,9693
6834,天二科技,21,3,18,富邦-新營,2024-07-17,9693
1540,喬福,43,25,18,富邦-新營,2024-07-17,9693
00934,中信成長高股息,19,2,17,富邦-新營,2024-07-17,9693
1303,南亞,18,1,17,富邦-新營,2024-07-17,9693
4533,協易機,21,5,16,富邦-新營,2024-07-17,9693
1409,新纖,52,37,15,富邦-新營,2024-07-17,9693
00712,復華富時不動產,20,5,15,富邦-新營,2024-07-17,9693
00891,中信關鍵半導體,14,0,14,富邦-新營,2024-07-17,9693
00935,野村臺灣新科技50,15,1,14,富邦-新營,2024-07-17,9693
00940,元大台灣價值高息,31,18,13,富邦-新營,2024-07-17,9693
8103,瀚荃,13,1,12,富邦-新營,2024-07-17,9693
00892,富邦台灣半導體,12,0,12,富邦-新營,2024-07-17,9693
5328,華容,25,13,12,富邦-新營,2024-07-17,9693
5905,南仁湖,34,22,12,富邦-新營,2024-07-17,9693
2603,長榮,14,3,11,富邦-新營,2024-07-17,9693
2881,富邦金,11,0,11,富邦-新營,2024-07-17,9693
2301,光寶科,13,2,11,富邦-新營,2024-07-17,9693
3221,台嘉碩,11,0,11,富邦-新營,2024-07-17,9693
00881,國泰台灣5G+,12,2,10,富邦-新營,2024-07-17,9693
1474,弘裕,10,0,10,富邦-新營,2024-07-17,9693
2023,燁輝,10,0,10,富邦-新營,2024-07-17,9693
2436,偉詮電,10,0,10,富邦-新營,2024-07-17,9693
3673,TPK-KY,12,2,10,富邦-新營,2024-07-17,9693
3481,群創,1028,541,487,富邦-新營,2024-07-18,9693
00905,FT臺灣Smart,134,0,134,富邦-新營,2024-07-18,9693
2537,聯上發,391,261,130,富邦-新營,2024-07-18,9693
00929,復華台灣科技優息,104,3,101,富邦-新營,2024-07-18,9693
00919,群益台灣精選高息,99,7,92,富邦-新營,2024-07-18,9693
00680L,元大美債20正2,91,10,81,富邦-新營,2024-07-18,9693
4168,醣聯,68,0,68,富邦-新營,2024-07-18,9693
1611,中電,59,0,59,富邦-新營,2024-07-18,9693
2317,鴻海,69,11,58,富邦-新營,2024-07-18,9693
00942B,台新美A公司債20+,46,1,45,富邦-新營,2024-07-18,9693
9105,泰金寶-DR,42,0,42,富邦-新營,2024-07-18,9693
2356,英業達,45,10,35,富邦-新營,2024-07-18,9693
1540,喬福,33,0,33,富邦-新營,2024-07-18,9693
2449,京元電子,32,1,31,富邦-新營,2024-07-18,9693
6026,福邦證,30,0,30,富邦-新營,2024-07-18,9693
00935,野村臺灣新科技50,28,0,28,富邦-新營,2024-07-18,9693
9955,佳龍,32,4,28,富邦-新營,2024-07-18,9693
0056,元大高股息,35,10,25,富邦-新營,2024-07-18,9693
2891,中信金,26,2,24,富邦-新營,2024-07-18,9693
00946,群益科技高息成長,25,2,23,富邦-新營,2024-07-18,9693
00632R,元大台灣50反1,30,7,23,富邦-新營,2024-07-18,9693
00927,群益半導體收益,22,0,22,富邦-新營,2024-07-18,9693
00679B,元大美債20年,23,1,22,富邦-新營,2024-07-18,9693
1582,信錦,21,0,21,富邦-新營,2024-07-18,9693
00881,國泰台灣5G+,22,1,21,富邦-新營,2024-07-18,9693
3189,景碩,26,6,20,富邦-新營,2024-07-18,9693
5498,凱崴,20,0,20,富邦-新營,2024-07-18,9693
00933B,國泰10Y+金融債,20,0,20,富邦-新營,2024-07-18,9693
2330,台積電,26,7,19,富邦-新營,2024-07-18,9693
2331,精英,21,2,19,富邦-新營,2024-07-18,9693
4960,誠美材,20,1,19,富邦-新營,2024-07-18,9693
1709,和益,22,4,18,富邦-新營,2024-07-18,9693
3037,欣興,28,10,18,富邦-新營,2024-07-18,9693
2101,南港,17,0,17,富邦-新營,2024-07-18,9693
6753,龍德造船,32,15,17,富邦-新營,2024-07-18,9693
00891,中信關鍵半導體,16,0,16,富邦-新營,2024-07-18,9693
3596,智易,30,14,16,富邦-新營,2024-07-18,9693
3322,建舜電,15,0,15,富邦-新營,2024-07-18,9693
2313,華通,22,7,15,富邦-新營,2024-07-18,9693
00948B,中信優息投資級債,15,0,15,富邦-新營,2024-07-18,9693
5371,中光電,14,0,14,富邦-新營,2024-07-18,9693
2610,華航,16,2,14,富邦-新營,2024-07-18,9693
00939,統一台灣高息動能,18,5,13,富邦-新營,2024-07-18,9693
00690,兆豐藍籌30,13,0,13,富邦-新營,2024-07-18,9693
2838,聯邦銀,13,0,13,富邦-新營,2024-07-18,9693
2881,富邦金,27,15,12,富邦-新營,2024-07-18,9693
1810,和成,14,2,12,富邦-新營,2024-07-18,9693
8429,金麗-KY,12,0,12,富邦-新營,2024-07-18,9693
8438,昶昕,12,0,12,富邦-新營,2024-07-18,9693
4909,新復興,27,16,11,富邦-新營,2024-07-18,9693
5512,力麒,749,211,538,富邦-新營,2024-07-19,9693
00929,復華台灣科技優息,197,23,174,富邦-新營,2024-07-19,9693
00919,群益台灣精選高息,94,5,89,富邦-新營,2024-07-19,9693
00665L,富邦�琤肭磪囓�2,75,0,75,富邦-新營,2024-07-19,9693
1314,中石化,70,0,70,富邦-新營,2024-07-19,9693
2884,玉山金,64,4,60,富邦-新營,2024-07-19,9693
2312,金寶,62,3,59,富邦-新營,2024-07-19,9693
00878,國泰永續高股息,63,5,58,富邦-新營,2024-07-19,9693
5864,致和證,50,0,50,富邦-新營,2024-07-19,9693
2489,瑞軒,59,17,42,富邦-新營,2024-07-19,9693
00753L,中信中國50正2,40,0,40,富邦-新營,2024-07-19,9693
00940,元大台灣價值高息,85,46,39,富邦-新營,2024-07-19,9693
4960,誠美材,39,0,39,富邦-新營,2024-07-19,9693
00918,大華優利高填息30,38,0,38,富邦-新營,2024-07-19,9693
0056,元大高股息,41,4,37,富邦-新營,2024-07-19,9693
2337,旺宏,39,3,36,富邦-新營,2024-07-19,9693
2409,友達,33,0,33,富邦-新營,2024-07-19,9693
6890,來億-KY,33,0,33,富邦-新營,2024-07-19,9693
2618,長榮航,35,3,32,富邦-新營,2024-07-19,9693
4967,十銓,35,3,32,富邦-新營,2024-07-19,9693
4168,醣聯,30,0,30,富邦-新營,2024-07-19,9693
00937B,群益ESG投等債20,48,18,30,富邦-新營,2024-07-19,9693
00680L,元大美債20正2,39,10,29,富邦-新營,2024-07-19,9693
00881,國泰台灣5G+,27,0,27,富邦-新營,2024-07-19,9693
2408,南亞科,27,2,25,富邦-新營,2024-07-19,9693
1316,上曜,37,12,25,富邦-新營,2024-07-19,9693
6116,彩晶,25,0,25,富邦-新營,2024-07-19,9693
00927,群益半導體收益,26,2,24,富邦-新營,2024-07-19,9693
2330,台積電,33,10,23,富邦-新營,2024-07-19,9693
5608,四維航,23,0,23,富邦-新營,2024-07-19,9693
1785,光洋科,27,5,22,富邦-新營,2024-07-19,9693
2888,新光金,52,31,21,富邦-新營,2024-07-19,9693
2601,益航,21,0,21,富邦-新營,2024-07-19,9693
3294,英濟,21,0,21,富邦-新營,2024-07-19,9693
1326,台化,26,6,20,富邦-新營,2024-07-19,9693
1337,再生-KY,18,0,18,富邦-新營,2024-07-19,9693
2887,台新金,19,2,17,富邦-新營,2024-07-19,9693
2356,英業達,24,7,17,富邦-新營,2024-07-19,9693
00939,統一台灣高息動能,18,2,16,富邦-新營,2024-07-19,9693
3231,緯創,19,3,16,富邦-新營,2024-07-19,9693
2344,華邦電,15,0,15,富邦-新營,2024-07-19,9693
4526,東台,15,0,15,富邦-新營,2024-07-19,9693
1304,台聚,20,6,14,富邦-新營,2024-07-19,9693
1609,大亞,31,17,14,富邦-新營,2024-07-19,9693
8936,國統,22,8,14,富邦-新營,2024-07-19,9693
2401,凌陽,14,1,13,富邦-新營,2024-07-19,9693
6443,元晶,21,8,13,富邦-新營,2024-07-19,9693
2520,冠德,13,1,12,富邦-新營,2024-07-19,9693
1536,和大,12,0,12,富邦-新營,2024-07-19,9693
1612,宏泰,12,0,12,富邦-新營,2024-07-19,9693
00687B,國泰20年美債,377,24,353,富邦-新營,2024-07-22,9693
2349,錸德,313,0,313,富邦-新營,2024-07-22,9693
00929,復華台灣科技優息,235,18,217,富邦-新營,2024-07-22,9693
00942B,台新美A公司債20+,190,0,190,富邦-新營,2024-07-22,9693
00947,台新臺灣IC設計,109,0,109,富邦-新營,2024-07-22,9693
00637L,元大滬深300正2,100,0,100,富邦-新營,2024-07-22,9693
00940,元大台灣價值高息,144,58,86,富邦-新營,2024-07-22,9693
2601,益航,54,1,53,富邦-新營,2024-07-22,9693
00919,群益台灣精選高息,137,86,51,富邦-新營,2024-07-22,9693
3047,訊舟,47,0,47,富邦-新營,2024-07-22,9693
2409,友達,60,15,45,富邦-新營,2024-07-22,9693
2352,佳世達,38,0,38,富邦-新營,2024-07-22,9693
3481,群創,92,57,35,富邦-新營,2024-07-22,9693
1709,和益,36,2,34,富邦-新營,2024-07-22,9693
00881,國泰台灣5G+,44,10,34,富邦-新營,2024-07-22,9693
1540,喬福,35,2,33,富邦-新營,2024-07-22,9693
6234,高僑,33,0,33,富邦-新營,2024-07-22,9693
00878,國泰永續高股息,59,27,32,富邦-新營,2024-07-22,9693
2884,玉山金,40,9,31,富邦-新營,2024-07-22,9693
00665L,富邦�琤肭磪囓�2,30,0,30,富邦-新營,2024-07-22,9693
4174,浩鼎,30,0,30,富邦-新營,2024-07-22,9693
6026,福邦證,31,3,28,富邦-新營,2024-07-22,9693
2883,凱基金,39,13,26,富邦-新營,2024-07-22,9693
1409,新纖,24,0,24,富邦-新營,2024-07-22,9693
2376,技嘉,21,0,21,富邦-新營,2024-07-22,9693
00946,群益科技高息成長,27,6,21,富邦-新營,2024-07-22,9693
4526,東台,20,0,20,富邦-新營,2024-07-22,9693
8021,尖點,20,0,20,富邦-新營,2024-07-22,9693
9945,潤泰新,21,1,20,富邦-新營,2024-07-22,9693
2356,英業達,27,7,20,富邦-新營,2024-07-22,9693
1904,正隆,20,2,18,富邦-新營,2024-07-22,9693
4566,時碩工業,22,5,17,富邦-新營,2024-07-22,9693
8105,凌巨,24,7,17,富邦-新營,2024-07-22,9693
2881,富邦金,45,28,17,富邦-新營,2024-07-22,9693
1513,中興電,18,2,16,富邦-新營,2024-07-22,9693
2303,聯電,22,7,15,富邦-新營,2024-07-22,9693
00934,中信成長高股息,15,0,15,富邦-新營,2024-07-22,9693
5871,中租-KY,14,0,14,富邦-新營,2024-07-22,9693
00939,統一台灣高息動能,16,3,13,富邦-新營,2024-07-22,9693
2317,鴻海,77,64,13,富邦-新營,2024-07-22,9693
4906,正文,12,0,12,富邦-新營,2024-07-22,9693
5426,振發,11,0,11,富邦-新營,2024-07-22,9693
3704,合勤控,11,0,11,富邦-新營,2024-07-22,9693
006208,富邦台50,13,3,10,富邦-新營,2024-07-22,9693
3037,欣興,12,1,11,富邦-新營,2024-07-22,9693
2618,長榮航,17,7,10,富邦-新營,2024-07-22,9693
3231,緯創,16,6,10,富邦-新營,2024-07-22,9693
3017,奇鋐,18,8,10,富邦-新營,2024-07-22,9693
2417,圓剛,10,0,10,富邦-新營,2024-07-22,9693
2436,偉詮電,20,10,10,富邦-新營,2024-07-22,9693
00680L,元大美債20正2,101,0,101,富邦-新營,2024-07-23,9693
2409,友達,76,0,76,富邦-新營,2024-07-23,9693
3481,群創,195,125,70,富邦-新營,2024-07-23,9693
00929,復華台灣科技優息,66,6,60,富邦-新營,2024-07-23,9693
00937B,群益ESG投等債20,46,0,46,富邦-新營,2024-07-23,9693
2408,南亞科,42,4,38,富邦-新營,2024-07-23,9693
00919,群益台灣精選高息,43,8,35,富邦-新營,2024-07-23,9693
00934,中信成長高股息,38,5,33,富邦-新營,2024-07-23,9693
1314,中石化,31,1,30,富邦-新營,2024-07-23,9693
5309,系統電,50,20,30,富邦-新營,2024-07-23,9693
8064,東捷,44,14,30,富邦-新營,2024-07-23,9693
00949,復華日本龍頭,21,0,21,富邦-新營,2024-07-23,9693
6901,鑽石投資,22,2,20,富邦-新營,2024-07-23,9693
1101,台泥,20,1,19,富邦-新營,2024-07-23,9693
1301,台塑,18,1,17,富邦-新營,2024-07-23,9693
1529,樂事綠能,17,0,17,富邦-新營,2024-07-23,9693
1815,富喬,16,0,16,富邦-新營,2024-07-23,9693
0056,元大高股息,24,8,16,富邦-新營,2024-07-23,9693
00679B,元大美債20年,16,0,16,富邦-新營,2024-07-23,9693
00936,台新永續高息中小,14,0,14,富邦-新營,2024-07-23,9693
00905,FT臺灣Smart,17,3,14,富邦-新營,2024-07-23,9693
00946,群益科技高息成長,14,0,14,富邦-新營,2024-07-23,9693
2340,台亞,14,0,14,富邦-新營,2024-07-23,9693
2867,三商壽,16,2,14,富邦-新營,2024-07-23,9693
8374,羅昇,116,103,13,富邦-新營,2024-07-23,9693
2312,金寶,32,19,13,富邦-新營,2024-07-23,9693
8440,綠電,25,13,12,富邦-新營,2024-07-23,9693
2002,中鋼,11,0,11,富邦-新營,2024-07-23,9693
2365,昆盈,294,283,11,富邦-新營,2024-07-23,9693
3712,永崴投控,11,1,10,富邦-新營,2024-07-23,9693
2331,精英,10,0,10,富邦-新營,2024-07-23,9693
3686,達能,10,0,10,富邦-新營,2024-07-23,9693
4174,浩鼎,10,0,10,富邦-新營,2024-07-23,9693
5490,同亨,31,21,10,富邦-新營,2024-07-23,9693
1785,光洋科,11,1,10,富邦-新營,2024-07-23,9693
2208,台船,16,7,9,富邦-新營,2024-07-23,9693
2406,國碩,16,7,9,富邦-新營,2024-07-23,9693
3673,TPK-KY,10,1,9,富邦-新營,2024-07-23,9693
6150,撼訊,9,0,9,富邦-新營,2024-07-23,9693
6244,茂迪,10,1,9,富邦-新營,2024-07-23,9693
2449,京元電子,15,7,8,富邦-新營,2024-07-23,9693
5347,世界,8,0,8,富邦-新營,2024-07-23,9693
1417,嘉裕,9,1,8,富邦-新營,2024-07-23,9693
2371,大同,13,5,8,富邦-新營,2024-07-23,9693
2399,映泰,13,5,8,富邦-新營,2024-07-23,9693
2511,太子,21,13,8,富邦-新營,2024-07-23,9693
00927,群益半導體收益,8,0,8,富邦-新營,2024-07-23,9693
2323,中環,9,2,7,富邦-新營,2024-07-23,9693
3713,新晶投控,7,0,7,富邦-新營,2024-07-23,9693
5432,新門,15,8,7,富邦-新營,2024-07-23,9693
00929,復華台灣科技優息,150,22,128,富邦-新營,2024-07-26,9693
00680L,元大美債20正2,81,0,81,富邦-新營,2024-07-26,9693
00753L,中信中國50正2,92,24,68,富邦-新營,2024-07-26,9693
8054,安國,85,26,59,富邦-新營,2024-07-26,9693
00940,元大台灣價值高息,57,2,55,富邦-新營,2024-07-26,9693
00937B,群益ESG投等債20,53,1,52,富邦-新營,2024-07-26,9693
00900,富邦特選高股息30,51,0,51,富邦-新營,2024-07-26,9693
00892,富邦台灣半導體,50,0,50,富邦-新營,2024-07-26,9693
00878,國泰永續高股息,55,15,40,富邦-新營,2024-07-26,9693
2884,玉山金,39,0,39,富邦-新營,2024-07-26,9693
00665L,富邦�琤肭磪囓�2,37,0,37,富邦-新營,2024-07-26,9693
2323,中環,32,0,32,富邦-新營,2024-07-26,9693
0056,元大高股息,32,0,32,富邦-新營,2024-07-26,9693
5864,致和證,27,0,27,富邦-新營,2024-07-26,9693
2356,英業達,24,1,23,富邦-新營,2024-07-26,9693
00712,復華富時不動產,25,4,21,富邦-新營,2024-07-26,9693
2330,台積電,24,4,20,富邦-新營,2024-07-26,9693
00679B,元大美債20年,20,0,20,富邦-新營,2024-07-26,9693
4726,永昕,20,0,20,富邦-新營,2024-07-26,9693
6116,彩晶,26,6,20,富邦-新營,2024-07-26,9693
00918,大華優利高填息30,20,0,20,富邦-新營,2024-07-26,9693
2344,華邦電,19,0,19,富邦-新營,2024-07-26,9693
2002,中鋼,24,7,17,富邦-新營,2024-07-26,9693
00919,群益台灣精選高息,61,44,17,富邦-新營,2024-07-26,9693
00934,中信成長高股息,18,2,16,富邦-新營,2024-07-26,9693
6026,福邦證,16,0,16,富邦-新營,2024-07-26,9693
00949,復華日本龍頭,20,5,15,富邦-新營,2024-07-26,9693
2812,台中銀,15,0,15,富邦-新營,2024-07-26,9693
3324,雙鴻,12,0,12,富邦-新營,2024-07-26,9693
1909,榮成,12,0,12,富邦-新營,2024-07-26,9693
2349,錸德,17,6,11,富邦-新營,2024-07-26,9693
00896,中信綠能及電動車,11,0,11,富邦-新營,2024-07-26,9693
1456,怡華,12,1,11,富邦-新營,2024-07-26,9693
00881,國泰台灣5G+,11,0,11,富邦-新營,2024-07-26,9693
2382,廣達,10,0,10,富邦-新營,2024-07-26,9693
00951,台新日本半導體,10,0,10,富邦-新營,2024-07-26,9693
1316,上曜,10,0,10,富邦-新營,2024-07-26,9693
1815,富喬,12,2,10,富邦-新營,2024-07-26,9693
6016,康和證,10,0,10,富邦-新營,2024-07-26,9693
0050,元大台灣50,10,0,10,富邦-新營,2024-07-26,9693
00946,群益科技高息成長,10,0,10,富邦-新營,2024-07-26,9693
3711,日月光投控,12,2,10,富邦-新營,2024-07-26,9693
3231,緯創,13,4,9,富邦-新營,2024-07-26,9693
1101,台泥,9,0,9,富邦-新營,2024-07-26,9693
2409,友達,14,5,9,富邦-新營,2024-07-26,9693
3047,訊舟,9,0,9,富邦-新營,2024-07-26,9693
3294,英濟,10,1,9,富邦-新營,2024-07-26,9693
6462,神盾,17,8,9,富邦-新營,2024-07-26,9693
6550,北極星藥業-KY,9,0,9,富邦-新營,2024-07-26,9693
006208,富邦台50,9,1,8,富邦-新營,2024-07-26,9693
6153,嘉聯益,50,0,50,富邦-新營,2024-07-29,9693
00929,復華台灣科技優息,58,17,41,富邦-新營,2024-07-29,9693
00878,國泰永續高股息,46,7,39,富邦-新營,2024-07-29,9693
00919,群益台灣精選高息,47,12,35,富邦-新營,2024-07-29,9693
0056,元大高股息,42,14,28,富邦-新營,2024-07-29,9693
00946,群益科技高息成長,27,1,26,富邦-新營,2024-07-29,9693
3481,群創,34,8,26,富邦-新營,2024-07-29,9693
2520,冠德,23,2,21,富邦-新營,2024-07-29,9693
2515,中工,32,11,21,富邦-新營,2024-07-29,9693
2888,新光金,20,0,20,富邦-新營,2024-07-29,9693
2887,台新金,20,1,19,富邦-新營,2024-07-29,9693
2303,聯電,25,7,18,富邦-新營,2024-07-29,9693
2356,英業達,31,15,16,富邦-新營,2024-07-29,9693
2610,華航,15,0,15,富邦-新營,2024-07-29,9693
3313,斐成,15,0,15,富邦-新營,2024-07-29,9693
3322,建舜電,15,0,15,富邦-新營,2024-07-29,9693
4960,誠美材,15,0,15,富邦-新營,2024-07-29,9693
2363,矽統,20,6,14,富邦-新營,2024-07-29,9693
5371,中光電,15,1,14,富邦-新營,2024-07-29,9693
2206,三陽工業,14,0,14,富邦-新營,2024-07-29,9693
3231,緯創,17,3,14,富邦-新營,2024-07-29,9693
00927,群益半導體收益,14,1,13,富邦-新營,2024-07-29,9693
4532,瑞智,13,0,13,富邦-新營,2024-07-29,9693
2412,中華電,12,0,12,富邦-新營,2024-07-29,9693
2884,玉山金,12,0,12,富邦-新營,2024-07-29,9693
6462,神盾,15,3,12,富邦-新營,2024-07-29,9693
2324,仁寶,12,1,11,富邦-新營,2024-07-29,9693
1513,中興電,14,3,11,富邦-新營,2024-07-29,9693
2408,南亞科,11,0,11,富邦-新營,2024-07-29,9693
00637L,元大滬深300正2,10,0,10,富邦-新營,2024-07-29,9693
1440,南紡,22,12,10,富邦-新營,2024-07-29,9693
2436,偉詮電,10,0,10,富邦-新營,2024-07-29,9693
3205,佰研,10,0,10,富邦-新營,2024-07-29,9693
8374,羅昇,10,0,10,富邦-新營,2024-07-29,9693
00688L,國泰20年美債正2,9,0,9,富邦-新營,2024-07-29,9693
2409,友達,15,6,9,富邦-新營,2024-07-29,9693
00933B,國泰10Y+金融債,15,7,8,富邦-新營,2024-07-29,9693
00646,元大S＆P500,8,0,8,富邦-新營,2024-07-29,9693
1540,喬福,11,3,8,富邦-新營,2024-07-29,9693
2027,大成鋼,14,6,8,富邦-新營,2024-07-29,9693
5443,均豪,13,6,7,富邦-新營,2024-07-29,9693
2353,宏��,7,0,7,富邦-新營,2024-07-29,9693
1522,堤維西,7,0,7,富邦-新營,2024-07-29,9693
2374,佳能,7,0,7,富邦-新營,2024-07-29,9693
2916,滿心,7,0,7,富邦-新營,2024-07-29,9693
3026,禾伸堂,7,0,7,富邦-新營,2024-07-29,9693
5475,德宏,7,0,7,富邦-新營,2024-07-29,9693
6233,旺玖,7,0,7,富邦-新營,2024-07-29,9693
5009,榮剛,7,0,7,富邦-新營,2024-07-29,9693
00881,國泰台灣5G+,8,1,7,富邦-新營,2024-07-29,9693
3047,訊舟,459,357,102,富邦-新營,2024-07-30,9693
00940,元大台灣價值高息,79,6,73,富邦-新營,2024-07-30,9693
00929,復華台灣科技優息,86,19,67,富邦-新營,2024-07-30,9693
00942B,台新美A公司債20+,110,50,60,富邦-新營,2024-07-30,9693
00753L,中信中國50正2,74,16,58,富邦-新營,2024-07-30,9693
00937B,群益ESG投等債20,56,0,56,富邦-新營,2024-07-30,9693
00878,國泰永續高股息,62,8,54,富邦-新營,2024-07-30,9693
2801,彰銀,51,0,51,富邦-新營,2024-07-30,9693
6016,康和證,40,0,40,富邦-新營,2024-07-30,9693
00687B,國泰20年美債,39,0,39,富邦-新營,2024-07-30,9693
2344,華邦電,37,3,34,富邦-新營,2024-07-30,9693
00665L,富邦�琤肭磪囓�2,30,0,30,富邦-新營,2024-07-30,9693
4938,和碩,30,0,30,富邦-新營,2024-07-30,9693
2867,三商壽,34,5,29,富邦-新營,2024-07-30,9693
2609,陽明,35,7,28,富邦-新營,2024-07-30,9693
00715L,期街口布蘭特正2,23,0,23,富邦-新營,2024-07-30,9693
00934,中信成長高股息,25,2,23,富邦-新營,2024-07-30,9693
0056,元大高股息,27,5,22,富邦-新營,2024-07-30,9693
1904,正隆,22,1,21,富邦-新營,2024-07-30,9693
2884,玉山金,21,0,21,富邦-新營,2024-07-30,9693
00946,群益科技高息成長,27,6,21,富邦-新營,2024-07-30,9693
2408,南亞科,23,4,19,富邦-新營,2024-07-30,9693
3231,緯創,20,3,17,富邦-新營,2024-07-30,9693
2882,國泰金,19,3,16,富邦-新營,2024-07-30,9693
2323,中環,16,0,16,富邦-新營,2024-07-30,9693
1584,精剛,16,0,16,富邦-新營,2024-07-30,9693
2365,昆盈,38,23,15,富邦-新營,2024-07-30,9693
2887,台新金,15,0,15,富邦-新營,2024-07-30,9693
00936,台新永續高息中小,15,0,15,富邦-新營,2024-07-30,9693
3189,景碩,18,3,15,富邦-新營,2024-07-30,9693
2891,中信金,14,1,13,富邦-新營,2024-07-30,9693
00918,大華優利高填息30,13,0,13,富邦-新營,2024-07-30,9693
3017,奇鋐,20,7,13,富邦-新營,2024-07-30,9693
2881,富邦金,13,1,12,富邦-新營,2024-07-30,9693
00688L,國泰20年美債正2,12,0,12,富邦-新營,2024-07-30,9693
4564,元翎,21,10,11,富邦-新營,2024-07-30,9693
2349,錸德,262,251,11,富邦-新營,2024-07-30,9693
2436,偉詮電,10,0,10,富邦-新營,2024-07-30,9693
3322,建舜電,10,0,10,富邦-新營,2024-07-30,9693
4566,時碩工業,10,0,10,富邦-新營,2024-07-30,9693
3535,晶彩科,10,0,10,富邦-新營,2024-07-30,9693
4726,永昕,9,0,9,富邦-新營,2024-07-30,9693
00881,國泰台灣5G+,10,1,9,富邦-新營,2024-07-30,9693
2317,鴻海,24,15,9,富邦-新營,2024-07-30,9693
00915,凱基優選高股息30,8,0,8,富邦-新營,2024-07-30,9693
6770,力積電,7,0,7,富邦-新營,2024-07-30,9693
3481,群創,105,99,6,富邦-新營,2024-07-30,9693
2303,聯電,8,2,6,富邦-新營,2024-07-30,9693
3545,敦泰,6,0,6,富邦-新營,2024-07-30,9693
9945,潤泰新,10,4,6,富邦-新營,2024-07-30,9693
00679B,元大美債20年,237,0,237,富邦-新營,2024-07-31,9693
2511,太子,200,0,200,富邦-新營,2024-07-31,9693
2489,瑞軒,110,0,110,富邦-新營,2024-07-31,9693
3481,群創,155,107,48,富邦-新營,2024-07-31,9693
00929,復華台灣科技優息,62,15,47,富邦-新營,2024-07-31,9693
00946,群益科技高息成長,41,1,40,富邦-新營,2024-07-31,9693
00650L,復華香港正2,32,2,30,富邦-新營,2024-07-31,9693
2002,中鋼,28,3,25,富邦-新營,2024-07-31,9693
00878,國泰永續高股息,27,3,24,富邦-新營,2024-07-31,9693
2515,中工,24,1,23,富邦-新營,2024-07-31,9693
00937B,群益ESG投等債20,33,10,23,富邦-新營,2024-07-31,9693
2605,新興,20,0,20,富邦-新營,2024-07-31,9693
2615,萬海,19,1,18,富邦-新營,2024-07-31,9693
1540,喬福,20,2,18,富邦-新營,2024-07-31,9693
5347,世界,14,0,14,富邦-新營,2024-07-31,9693
00934,中信成長高股息,13,0,13,富邦-新營,2024-07-31,9693
6116,彩晶,18,5,13,富邦-新營,2024-07-31,9693
2303,聯電,15,3,12,富邦-新營,2024-07-31,9693
00919,群益台灣精選高息,14,2,12,富邦-新營,2024-07-31,9693
3663,鑫科,19,7,12,富邦-新營,2024-07-31,9693
00922,國泰台灣領袖50,11,0,11,富邦-新營,2024-07-31,9693
2609,陽明,21,10,11,富邦-新營,2024-07-31,9693
00951,台新日本半導體,10,0,10,富邦-新營,2024-07-31,9693
2103,台橡,10,0,10,富邦-新營,2024-07-31,9693
2408,南亞科,10,0,10,富邦-新營,2024-07-31,9693
4903,聯光通,12,2,10,富邦-新營,2024-07-31,9693
3037,欣興,11,2,9,富邦-新營,2024-07-31,9693
2449,京元電子,9,0,9,富邦-新營,2024-07-31,9693
2888,新光金,11,2,9,富邦-新營,2024-07-31,9693
5512,力麒,10,2,8,富邦-新營,2024-07-31,9693
2362,藍天,7,0,7,富邦-新營,2024-07-31,9693
0056,元大高股息,6,0,6,富邦-新營,2024-07-31,9693
2340,台亞,6,0,6,富邦-新營,2024-07-31,9693
2409,友達,41,35,6,富邦-新營,2024-07-31,9693
6173,信昌電,6,0,6,富邦-新營,2024-07-31,9693
8464,億豐,6,0,6,富邦-新營,2024-07-31,9693
00933B,國泰10Y+金融債,5,0,5,富邦-新營,2024-07-31,9693
1608,華榮,5,0,5,富邦-新營,2024-07-31,9693
3105,穩懋,5,0,5,富邦-新營,2024-07-31,9693
1529,樂事綠能,5,0,5,富邦-新營,2024-07-31,9693
1718,中纖,5,0,5,富邦-新營,2024-07-31,9693
2031,新光鋼,5,0,5,富邦-新營,2024-07-31,9693
2204,中華,7,2,5,富邦-新營,2024-07-31,9693
6207,雷科,6,1,5,富邦-新營,2024-07-31,9693
6561,是方,5,0,5,富邦-新營,2024-07-31,9693
00713,元大台灣高息低波,4,0,4,富邦-新營,2024-07-31,9693
3163,波若威,8,4,4,富邦-新營,2024-07-31,9693
4919,新唐,4,0,4,富邦-新營,2024-07-31,9693
00715L,期街口布蘭特正2,5,1,4,富邦-新營,2024-07-31,9693
00905,FT臺灣Smart,4,0,4,富邦-新營,2024-07-31,9693
5309,系統電,97,1,96,富邦-新營,2024-08-01,9693
2002,中鋼,92,0,92,富邦-新營,2024-08-01,9693
00687B,國泰20年美債,38,0,38,富邦-新營,2024-08-01,9693
00937B,群益ESG投等債20,31,2,29,富邦-新營,2024-08-01,9693
2515,中工,38,12,26,富邦-新營,2024-08-01,9693
3047,訊舟,61,36,25,富邦-新營,2024-08-01,9693
00934,中信成長高股息,23,0,23,富邦-新營,2024-08-01,9693
00949,復華日本龍頭,23,0,23,富邦-新營,2024-08-01,9693
00933B,國泰10Y+金融債,23,1,22,富邦-新營,2024-08-01,9693
2363,矽統,37,16,21,富邦-新營,2024-08-01,9693
2610,華航,31,10,21,富邦-新營,2024-08-01,9693
1309,台達化,20,0,20,富邦-新營,2024-08-01,9693
00919,群益台灣精選高息,20,1,19,富邦-新營,2024-08-01,9693
00878,國泰永續高股息,25,8,17,富邦-新營,2024-08-01,9693
2881,富邦金,17,0,17,富邦-新營,2024-08-01,9693
00712,復華富時不動產,16,0,16,富邦-新營,2024-08-01,9693
00631L,元大台灣50正2,18,2,16,富邦-新營,2024-08-01,9693
5392,能率,16,0,16,富邦-新營,2024-08-01,9693
00932,兆豐永續高息等權,13,0,13,富邦-新營,2024-08-01,9693
2317,鴻海,29,17,12,富邦-新營,2024-08-01,9693
5531,鄉林,13,1,12,富邦-新營,2024-08-01,9693
1529,樂事綠能,11,0,11,富邦-新營,2024-08-01,9693
1605,華新,11,0,11,富邦-新營,2024-08-01,9693
2412,中華電,11,0,11,富邦-新營,2024-08-01,9693
4160,訊聯基因,11,0,11,富邦-新營,2024-08-01,9693
00642U,期元大S＆P石油,10,0,10,富邦-新營,2024-08-01,9693
1312,國喬,10,0,10,富邦-新營,2024-08-01,9693
1718,中纖,11,2,9,富邦-新營,2024-08-01,9693
2884,玉山金,10,1,9,富邦-新營,2024-08-01,9693
00646,元大S＆P500,8,0,8,富邦-新營,2024-08-01,9693
3663,鑫科,122,114,8,富邦-新營,2024-08-01,9693
2362,藍天,11,4,7,富邦-新營,2024-08-01,9693
3711,日月光投控,7,0,7,富邦-新營,2024-08-01,9693
00662,富邦NASDAQ,6,0,6,富邦-新營,2024-08-01,9693
4979,華星光,6,0,6,富邦-新營,2024-08-01,9693
5521,工信,7,1,6,富邦-新營,2024-08-01,9693
6180,橘子,6,0,6,富邦-新營,2024-08-01,9693
2603,長榮,10,4,6,富邦-新營,2024-08-01,9693
5410,國眾,6,0,6,富邦-新營,2024-08-01,9693
3535,晶彩科,128,122,6,富邦-新營,2024-08-01,9693
2454,聯發科,7,1,6,富邦-新營,2024-08-01,9693
00929,復華台灣科技優息,25,20,5,富邦-新營,2024-08-01,9693
1711,永光,5,0,5,富邦-新營,2024-08-01,9693
00632R,元大台灣50反1,8,3,5,富邦-新營,2024-08-01,9693
1717,長興,15,10,5,富邦-新營,2024-08-01,9693
2501,國建,5,0,5,富邦-新營,2024-08-01,9693
2845,遠東銀,6,1,5,富邦-新營,2024-08-01,9693
2891,中信金,6,1,5,富邦-新營,2024-08-01,9693
3338,泰碩,5,0,5,富邦-新營,2024-08-01,9693
5905,南仁湖,5,0,5,富邦-新營,2024-08-01,9693
00929,復華台灣科技優息,132,7,125,富邦-新營,2024-08-02,9693
00940,元大台灣價值高息,147,33,114,富邦-新營,2024-08-02,9693
00878,國泰永續高股息,113,4,109,富邦-新營,2024-08-02,9693
2317,鴻海,114,8,106,富邦-新營,2024-08-02,9693
2882,國泰金,106,20,86,富邦-新營,2024-08-02,9693
00919,群益台灣精選高息,85,10,75,富邦-新營,2024-08-02,9693
00753L,中信中國50正2,49,0,49,富邦-新營,2024-08-02,9693
0056,元大高股息,62,14,48,富邦-新營,2024-08-02,9693
00937B,群益ESG投等債20,46,2,44,富邦-新營,2024-08-02,9693
2337,旺宏,67,24,43,富邦-新營,2024-08-02,9693
00679B,元大美債20年,40,0,40,富邦-新營,2024-08-02,9693
2330,台積電,36,2,34,富邦-新營,2024-08-02,9693
00951,台新日本半導體,32,0,32,富邦-新營,2024-08-02,9693
2610,華航,33,2,31,富邦-新營,2024-08-02,9693
00900,富邦特選高股息30,29,0,29,富邦-新營,2024-08-02,9693
2515,中工,33,6,27,富邦-新營,2024-08-02,9693
2409,友達,31,5,26,富邦-新營,2024-08-02,9693
00946,群益科技高息成長,29,3,26,富邦-新營,2024-08-02,9693
2891,中信金,23,0,23,富邦-新營,2024-08-02,9693
2883,凱基金,22,0,22,富邦-新營,2024-08-02,9693
00949,復華日本龍頭,23,1,22,富邦-新營,2024-08-02,9693
00881,國泰台灣5G+,22,0,22,富邦-新營,2024-08-02,9693
00665L,富邦�琤肭磪囓�2,22,1,21,富邦-新營,2024-08-02,9693
00904,新光臺灣半導體30,21,0,21,富邦-新營,2024-08-02,9693
2031,新光鋼,20,0,20,富邦-新營,2024-08-02,9693
4919,新唐,20,0,20,富邦-新營,2024-08-02,9693
00918,大華優利高填息30,21,2,19,富邦-新營,2024-08-02,9693
3037,欣興,21,3,18,富邦-新營,2024-08-02,9693
00795B,中信美國公債20年,18,0,18,富邦-新營,2024-08-02,9693
00905,FT臺灣Smart,18,0,18,富邦-新營,2024-08-02,9693
2596,綠意,18,0,18,富邦-新營,2024-08-02,9693
00885,富邦越南,17,0,17,富邦-新營,2024-08-02,9693
2834,臺企銀,23,6,17,富邦-新營,2024-08-02,9693
2501,國建,16,0,16,富邦-新營,2024-08-02,9693
1584,精剛,16,0,16,富邦-新營,2024-08-02,9693
0050,元大台灣50,15,0,15,富邦-新營,2024-08-02,9693
00688L,國泰20年美債正2,14,0,14,富邦-新營,2024-08-02,9693
3663,鑫科,46,32,14,富邦-新營,2024-08-02,9693
00947,台新臺灣IC設計,29,15,14,富邦-新營,2024-08-02,9693
00935,野村臺灣新科技50,18,5,13,富邦-新營,2024-08-02,9693
1609,大亞,14,1,13,富邦-新營,2024-08-02,9693
3231,緯創,13,1,12,富邦-新營,2024-08-02,9693
1718,中纖,12,0,12,富邦-新營,2024-08-02,9693
006208,富邦台50,12,0,12,富邦-新營,2024-08-02,9693
00662,富邦NASDAQ,15,4,11,富邦-新營,2024-08-02,9693
2406,國碩,11,0,11,富邦-新營,2024-08-02,9693
2537,聯上發,12,1,11,富邦-新營,2024-08-02,9693
3545,敦泰,11,0,11,富邦-新營,2024-08-02,9693
2867,三商壽,10,0,10,富邦-新營,2024-08-02,9693
00932,兆豐永續高息等權,10,0,10,富邦-新營,2024-08-02,9693
00929,復華台灣科技優息,348,47,301,富邦-新營,2024-08-05,9693
00940,元大台灣價值高息,250,21,229,富邦-新營,2024-08-05,9693
00878,國泰永續高股息,260,46,214,富邦-新營,2024-08-05,9693
00715L,期街口布蘭特正2,142,0,142,富邦-新營,2024-08-05,9693
2409,友達,139,12,127,富邦-新營,2024-08-05,9693
00947,台新臺灣IC設計,121,1,120,富邦-新營,2024-08-05,9693
00688L,國泰20年美債正2,109,9,100,富邦-新營,2024-08-05,9693
0056,元大高股息,125,44,81,富邦-新營,2024-08-05,9693
00937B,群益ESG投等債20,157,77,80,富邦-新營,2024-08-05,9693
00631L,元大台灣50正2,78,4,74,富邦-新營,2024-08-05,9693
00919,群益台灣精選高息,178,109,69,富邦-新營,2024-08-05,9693
1909,榮成,69,3,66,富邦-新營,2024-08-05,9693
00712,復華富時不動產,69,4,65,富邦-新營,2024-08-05,9693
1314,中石化,55,0,55,富邦-新營,2024-08-05,9693
00830,國泰費城半導體,55,2,53,富邦-新營,2024-08-05,9693
00753L,中信中國50正2,71,23,48,富邦-新營,2024-08-05,9693
2002,中鋼,50,4,46,富邦-新營,2024-08-05,9693
6151,晉倫,48,3,45,富邦-新營,2024-08-05,9693
00946,群益科技高息成長,53,10,43,富邦-新營,2024-08-05,9693
3481,群創,94,51,43,富邦-新營,2024-08-05,9693
2317,鴻海,70,28,42,富邦-新營,2024-08-05,9693
00669R,國泰美國道瓊反1,40,0,40,富邦-新營,2024-08-05,9693
00933B,國泰10Y+金融債,40,1,39,富邦-新營,2024-08-05,9693
2330,台積電,49,11,38,富邦-新營,2024-08-05,9693
00948B,中信優息投資級債,37,0,37,富邦-新營,2024-08-05,9693
2610,華航,39,3,36,富邦-新營,2024-08-05,9693
1584,精剛,36,1,35,富邦-新營,2024-08-05,9693
2515,中工,32,2,30,富邦-新營,2024-08-05,9693
2880,華南金,28,0,28,富邦-新營,2024-08-05,9693
00939,統一台灣高息動能,29,1,28,富邦-新營,2024-08-05,9693
2349,錸德,24,0,24,富邦-新營,2024-08-05,9693
9105,泰金寶-DR,26,3,23,富邦-新營,2024-08-05,9693
2891,中信金,31,8,23,富邦-新營,2024-08-05,9693
2365,昆盈,34,11,23,富邦-新營,2024-08-05,9693
4174,浩鼎,29,7,22,富邦-新營,2024-08-05,9693
0050,元大台灣50,23,1,22,富邦-新營,2024-08-05,9693
4714,永捷,21,0,21,富邦-新營,2024-08-05,9693
2596,綠意,21,1,20,富邦-新營,2024-08-05,9693
2801,彰銀,19,0,19,富邦-新營,2024-08-05,9693
8110,華東,21,2,19,富邦-新營,2024-08-05,9693
00665L,富邦�琤肭磪囓�2,20,1,19,富邦-新營,2024-08-05,9693
5009,榮剛,22,3,19,富邦-新營,2024-08-05,9693
5864,致和證,23,4,19,富邦-新營,2024-08-05,9693
6026,福邦證,20,1,19,富邦-新營,2024-08-05,9693
2881,富邦金,35,16,19,富邦-新營,2024-08-05,9693
00881,國泰台灣5G+,24,5,19,富邦-新營,2024-08-05,9693
2344,華邦電,24,6,18,富邦-新營,2024-08-05,9693
2618,長榮航,34,16,18,富邦-新營,2024-08-05,9693
2332,友訊,17,0,17,富邦-新營,2024-08-05,9693
8429,金麗-KY,17,0,17,富邦-新營,2024-08-05,9693
2409,友達,198,3,195,富邦-新營,2024-08-06,9693
2349,錸德,110,3,107,富邦-新營,2024-08-06,9693
3481,群創,97,9,88,富邦-新營,2024-08-06,9693
00712,復華富時不動產,84,2,82,富邦-新營,2024-08-06,9693
00919,群益台灣精選高息,100,22,78,富邦-新營,2024-08-06,9693
00940,元大台灣價值高息,317,242,75,富邦-新營,2024-08-06,9693
2312,金寶,80,21,59,富邦-新營,2024-08-06,9693
2834,臺企銀,58,4,54,富邦-新營,2024-08-06,9693
4714,永捷,30,3,27,富邦-新營,2024-08-06,9693
3017,奇鋐,33,8,25,富邦-新營,2024-08-06,9693
2353,宏��,28,7,21,富邦-新營,2024-08-06,9693
2331,精英,21,0,21,富邦-新營,2024-08-06,9693
00945B,凱基美國非投等債,20,0,20,富邦-新營,2024-08-06,9693
1217,愛之味,20,0,20,富邦-新營,2024-08-06,9693
2615,萬海,25,5,20,富邦-新營,2024-08-06,9693
1316,上曜,24,6,18,富邦-新營,2024-08-06,9693
2609,陽明,131,114,17,富邦-新營,2024-08-06,9693
6207,雷科,20,3,17,富邦-新營,2024-08-06,9693
2317,鴻海,102,85,17,富邦-新營,2024-08-06,9693
2515,中工,17,1,16,富邦-新營,2024-08-06,9693
00878,國泰永續高股息,72,56,16,富邦-新營,2024-08-06,9693
2888,新光金,22,7,15,富邦-新營,2024-08-06,9693
8064,東捷,28,14,14,富邦-新營,2024-08-06,9693
3163,波若威,25,12,13,富邦-新營,2024-08-06,9693
6116,彩晶,17,4,13,富邦-新營,2024-08-06,9693
00946,群益科技高息成長,32,20,12,富邦-新營,2024-08-06,9693
2002,中鋼,19,7,12,富邦-新營,2024-08-06,9693
1815,富喬,15,3,12,富邦-新營,2024-08-06,9693
2520,冠德,13,1,12,富邦-新營,2024-08-06,9693
3376,新日興,12,1,11,富邦-新營,2024-08-06,9693
9105,泰金寶-DR,35,24,11,富邦-新營,2024-08-06,9693
2645,長榮航太,10,0,10,富邦-新營,2024-08-06,9693
6625,必應,10,0,10,富邦-新營,2024-08-06,9693
8034,榮群,10,0,10,富邦-新營,2024-08-06,9693
1720,生達,9,0,9,富邦-新營,2024-08-06,9693
3011,今皓,9,0,9,富邦-新營,2024-08-06,9693
4960,誠美材,9,0,9,富邦-新營,2024-08-06,9693
5443,均豪,12,3,9,富邦-新營,2024-08-06,9693
006208,富邦台50,14,5,9,富邦-新營,2024-08-06,9693
00933B,國泰10Y+金融債,9,0,9,富邦-新營,2024-08-06,9693
5309,系統電,12,4,8,富邦-新營,2024-08-06,9693
1513,中興電,9,2,7,富邦-新營,2024-08-06,9693
8358,金居,7,0,7,富邦-新營,2024-08-06,9693
1712,興農,7,0,7,富邦-新營,2024-08-06,9693
2511,太子,7,0,7,富邦-新營,2024-08-06,9693
2596,綠意,7,0,7,富邦-新營,2024-08-06,9693
3710,連展投控,7,0,7,富邦-新營,2024-08-06,9693
8374,羅昇,28,21,7,富邦-新營,2024-08-06,9693
00929,復華台灣科技優息,83,76,7,富邦-新營,2024-08-06,9693
4739,康普,6,0,6,富邦-新營,2024-08-06,9693
00680L,元大美債20正2,89,0,89,富邦-新營,2024-08-07,9693
6550,北極星藥業-KY,82,18,64,富邦-新營,2024-08-07,9693
00830,國泰費城半導體,59,1,58,富邦-新營,2024-08-07,9693
00878,國泰永續高股息,56,2,54,富邦-新營,2024-08-07,9693
00665L,富邦�琤肭磪囓�2,50,0,50,富邦-新營,2024-08-07,9693
00679B,元大美債20年,46,6,40,富邦-新營,2024-08-07,9693
2438,翔耀,40,0,40,富邦-新營,2024-08-07,9693
2887,台新金,32,0,32,富邦-新營,2024-08-07,9693
00919,群益台灣精選高息,42,10,32,富邦-新營,2024-08-07,9693
00715L,期街口布蘭特正2,31,0,31,富邦-新營,2024-08-07,9693
2317,鴻海,49,25,24,富邦-新營,2024-08-07,9693
00688L,國泰20年美債正2,22,1,21,富邦-新營,2024-08-07,9693
00891,中信關鍵半導體,20,0,20,富邦-新營,2024-08-07,9693
00937B,群益ESG投等債20,30,13,17,富邦-新營,2024-08-07,9693
00900,富邦特選高股息30,15,0,15,富邦-新營,2024-08-07,9693
0056,元大高股息,16,1,15,富邦-新營,2024-08-07,9693
3481,群創,72,58,14,富邦-新營,2024-08-07,9693
2412,中華電,12,0,12,富邦-新營,2024-08-07,9693
6770,力積電,12,0,12,富邦-新營,2024-08-07,9693
8054,安國,120,109,11,富邦-新營,2024-08-07,9693
1440,南紡,12,2,10,富邦-新營,2024-08-07,9693
2543,皇昌,10,0,10,富邦-新營,2024-08-07,9693
4510,高鋒,20,10,10,富邦-新營,2024-08-07,9693
4960,誠美材,10,0,10,富邦-新營,2024-08-07,9693
5392,能率,10,0,10,富邦-新營,2024-08-07,9693
00933B,國泰10Y+金融債,11,2,9,富邦-新營,2024-08-07,9693
00936,台新永續高息中小,10,2,8,富邦-新營,2024-08-07,9693
1417,嘉裕,8,0,8,富邦-新營,2024-08-07,9693
4726,永昕,8,0,8,富邦-新營,2024-08-07,9693
5608,四維航,10,2,8,富邦-新營,2024-08-07,9693
6569,醫揚,8,0,8,富邦-新營,2024-08-07,9693
00946,群益科技高息成長,7,0,7,富邦-新營,2024-08-07,9693
00929,復華台灣科技優息,73,66,7,富邦-新營,2024-08-07,9693
2892,第一金,7,0,7,富邦-新營,2024-08-07,9693
2337,旺宏,10,3,7,富邦-新營,2024-08-07,9693
00939,統一台灣高息動能,6,0,6,富邦-新營,2024-08-07,9693
2884,玉山金,6,0,6,富邦-新營,2024-08-07,9693
5272,笙科,6,0,6,富邦-新營,2024-08-07,9693
1101,台泥,5,0,5,富邦-新營,2024-08-07,9693
2376,技嘉,6,1,5,富邦-新營,2024-08-07,9693
00934,中信成長高股息,8,3,5,富邦-新營,2024-08-07,9693
00930,永豐ESG低碳高息,5,0,5,富邦-新營,2024-08-07,9693
2380,虹光,5,0,5,富邦-新營,2024-08-07,9693
3048,益登,5,0,5,富邦-新營,2024-08-07,9693
3290,東浦,5,0,5,富邦-新營,2024-08-07,9693
5309,系統電,5,0,5,富邦-新營,2024-08-07,9693
5534,長虹,7,2,5,富邦-新營,2024-08-07,9693
5880,合庫金,5,0,5,富邦-新營,2024-08-07,9693
5905,南仁湖,5,0,5,富邦-新營,2024-08-07,9693
6126,信音,5,0,5,富邦-新營,2024-08-07,9693
00830,國泰費城半導體,94,9,85,富邦-新營,2024-08-08,9693
00937B,群益ESG投等債20,72,0,72,富邦-新營,2024-08-08,9693
00881,國泰台灣5G+,59,1,58,富邦-新營,2024-08-08,9693
00933B,國泰10Y+金融債,57,0,57,富邦-新營,2024-08-08,9693
00878,國泰永續高股息,102,50,52,富邦-新營,2024-08-08,9693
00680L,元大美債20正2,47,0,47,富邦-新營,2024-08-08,9693
00940,元大台灣價值高息,50,15,35,富邦-新營,2024-08-08,9693
1584,精剛,35,0,35,富邦-新營,2024-08-08,9693
2317,鴻海,63,36,27,富邦-新營,2024-08-08,9693
0056,元大高股息,26,3,23,富邦-新營,2024-08-08,9693
6151,晉倫,25,2,23,富邦-新營,2024-08-08,9693
2886,兆豐金,20,0,20,富邦-新營,2024-08-08,9693
00665L,富邦�琤肭磪囓�2,21,2,19,富邦-新營,2024-08-08,9693
2892,第一金,18,0,18,富邦-新營,2024-08-08,9693
00687B,國泰20年美債,23,6,17,富邦-新營,2024-08-08,9693
3047,訊舟,199,182,17,富邦-新營,2024-08-08,9693
00919,群益台灣精選高息,16,0,16,富邦-新營,2024-08-08,9693
2489,瑞軒,23,8,15,富邦-新營,2024-08-08,9693
2885,元大金,18,3,15,富邦-新營,2024-08-08,9693
3596,智易,15,0,15,富邦-新營,2024-08-08,9693
5443,均豪,18,4,14,富邦-新營,2024-08-08,9693
1316,上曜,23,9,14,富邦-新營,2024-08-08,9693
2834,臺企銀,14,2,12,富邦-新營,2024-08-08,9693
2303,聯電,22,10,12,富邦-新營,2024-08-08,9693
1301,台塑,12,0,12,富邦-新營,2024-08-08,9693
4919,新唐,12,0,12,富邦-新營,2024-08-08,9693
5905,南仁湖,12,0,12,富邦-新營,2024-08-08,9693
00946,群益科技高息成長,12,0,12,富邦-新營,2024-08-08,9693
00679B,元大美債20年,12,1,11,富邦-新營,2024-08-08,9693
00923,群益台ESG低碳50,11,0,11,富邦-新營,2024-08-08,9693
2884,玉山金,11,0,11,富邦-新營,2024-08-08,9693
2344,華邦電,11,0,11,富邦-新營,2024-08-08,9693
2349,錸德,35,24,11,富邦-新營,2024-08-08,9693
6770,力積電,12,1,11,富邦-新營,2024-08-08,9693
2353,宏��,11,0,11,富邦-新營,2024-08-08,9693
2630,亞航,10,0,10,富邦-新營,2024-08-08,9693
5426,振發,13,3,10,富邦-新營,2024-08-08,9693
6284,佳邦,10,0,10,富邦-新營,2024-08-08,9693
8234,新漢,10,0,10,富邦-新營,2024-08-08,9693
910322,康師傅-DR,10,0,10,富邦-新營,2024-08-08,9693
2609,陽明,9,0,9,富邦-新營,2024-08-08,9693
2603,長榮,9,0,9,富邦-新營,2024-08-08,9693
1909,榮成,9,0,9,富邦-新營,2024-08-08,9693
3712,永崴投控,9,0,9,富邦-新營,2024-08-08,9693
8064,東捷,9,0,9,富邦-新營,2024-08-08,9693
2382,廣達,14,5,9,富邦-新營,2024-08-08,9693
2340,台亞,10,2,8,富邦-新營,2024-08-08,9693
3048,益登,15,7,8,富邦-新營,2024-08-08,9693
2329,華泰,9,2,7,富邦-新營,2024-08-08,9693
6462,神盾,7,0,7,富邦-新營,2024-08-08,9693
00679B,元大美債20年,85,0,85,富邦-新營,2024-08-09,9693
9105,泰金寶-DR,45,8,37,富邦-新營,2024-08-09,9693
00680L,元大美債20正2,35,0,35,富邦-新營,2024-08-09,9693
00673R,期元大S＆P原油反1,30,0,30,富邦-新營,2024-08-09,9693
1605,華新,30,2,28,富邦-新營,2024-08-09,9693
3230,錦明,26,0,26,富邦-新營,2024-08-09,9693
2323,中環,23,0,23,富邦-新營,2024-08-09,9693
6151,晉倫,33,10,23,富邦-新營,2024-08-09,9693
00918,大華優利高填息30,21,0,21,富邦-新營,2024-08-09,9693
3044,健鼎,20,1,19,富邦-新營,2024-08-09,9693
00929,復華台灣科技優息,53,35,18,富邦-新營,2024-08-09,9693
00632R,元大台灣50反1,20,2,18,富邦-新營,2024-08-09,9693
00933B,國泰10Y+金融債,17,0,17,富邦-新營,2024-08-09,9693
1471,首利,16,0,16,富邦-新營,2024-08-09,9693
1709,和益,16,0,16,富邦-新營,2024-08-09,9693
2409,友達,77,61,16,富邦-新營,2024-08-09,9693
2353,宏��,16,1,15,富邦-新營,2024-08-09,9693
00948B,中信優息投資級債,14,0,14,富邦-新營,2024-08-09,9693
1316,上曜,15,1,14,富邦-新營,2024-08-09,9693
2634,漢翔,14,1,13,富邦-新營,2024-08-09,9693
2301,光寶科,16,3,13,富邦-新營,2024-08-09,9693
00934,中信成長高股息,12,0,12,富邦-新營,2024-08-09,9693
3105,穩懋,12,0,12,富邦-新營,2024-08-09,9693
6603,富強鑫,22,10,12,富邦-新營,2024-08-09,9693
9958,世紀鋼,12,0,12,富邦-新營,2024-08-09,9693
1326,台化,13,2,11,富邦-新營,2024-08-09,9693
3576,聯合再生,11,0,11,富邦-新營,2024-08-09,9693
3037,欣興,18,8,10,富邦-新營,2024-08-09,9693
00919,群益台灣精選高息,11,1,10,富邦-新營,2024-08-09,9693
1312,國喬,10,0,10,富邦-新營,2024-08-09,9693
1611,中電,10,0,10,富邦-新營,2024-08-09,9693
2363,矽統,14,4,10,富邦-新營,2024-08-09,9693
2516,新建,10,0,10,富邦-新營,2024-08-09,9693
5608,四維航,10,0,10,富邦-新營,2024-08-09,9693
6432,今展科,10,0,10,富邦-新營,2024-08-09,9693
4563,百德,10,0,10,富邦-新營,2024-08-09,9693
4174,浩鼎,66,57,9,富邦-新營,2024-08-09,9693
2881,富邦金,31,22,9,富邦-新營,2024-08-09,9693
2867,三商壽,13,5,8,富邦-新營,2024-08-09,9693
5388,中磊,8,0,8,富邦-新營,2024-08-09,9693
2374,佳能,13,5,8,富邦-新營,2024-08-09,9693
2515,中工,7,0,7,富邦-新營,2024-08-09,9693
4909,新復興,21,14,7,富邦-新營,2024-08-09,9693
1440,南紡,6,0,6,富邦-新營,2024-08-09,9693
3047,訊舟,29,23,6,富邦-新營,2024-08-09,9693
3450,聯鈞,20,14,6,富邦-新營,2024-08-09,9693
6153,嘉聯益,6,0,6,富邦-新營,2024-08-09,9693
6770,力積電,6,0,6,富邦-新營,2024-08-09,9693
3086,華義,10,4,6,富邦-新營,2024-08-09,9693
0056,元大高股息,7,1,6,富邦-新營,2024-08-09,9693
8043,蜜望實,96,6,90,富邦-新營,2024-08-12,9693
2349,錸德,83,16,67,富邦-新營,2024-08-12,9693
00878,國泰永續高股息,81,24,57,富邦-新營,2024-08-12,9693
2312,金寶,88,32,56,富邦-新營,2024-08-12,9693
00679B,元大美債20年,50,0,50,富邦-新營,2024-08-12,9693
00715L,期街口布蘭特正2,100,51,49,富邦-新營,2024-08-12,9693
00929,復華台灣科技優息,46,13,33,富邦-新營,2024-08-12,9693
1540,喬福,29,1,28,富邦-新營,2024-08-12,9693
3047,訊舟,57,30,27,富邦-新營,2024-08-12,9693
3663,鑫科,59,35,24,富邦-新營,2024-08-12,9693
2883,凱基金,33,12,21,富邦-新營,2024-08-12,9693
2027,大成鋼,20,0,20,富邦-新營,2024-08-12,9693
00764B,群益25年美債,20,0,20,富邦-新營,2024-08-12,9693
5309,系統電,26,10,16,富邦-新營,2024-08-12,9693
1608,華榮,22,7,15,富邦-新營,2024-08-12,9693
3260,威剛,16,1,15,富邦-新營,2024-08-12,9693
2880,華南金,14,0,14,富邦-新營,2024-08-12,9693
00933B,國泰10Y+金融債,15,2,13,富邦-新營,2024-08-12,9693
3045,台灣大,13,0,13,富邦-新營,2024-08-12,9693
2515,中工,12,0,12,富邦-新營,2024-08-12,9693
00923,群益台ESG低碳50,10,0,10,富邦-新營,2024-08-12,9693
00632R,元大台灣50反1,10,0,10,富邦-新營,2024-08-12,9693
1440,南紡,10,0,10,富邦-新營,2024-08-12,9693
2547,日勝生,10,0,10,富邦-新營,2024-08-12,9693
4157,太景*-KY,10,0,10,富邦-新營,2024-08-12,9693
4513,福裕,26,16,10,富邦-新營,2024-08-12,9693
5009,榮剛,10,0,10,富邦-新營,2024-08-12,9693
5608,四維航,10,0,10,富邦-新營,2024-08-12,9693
00949,復華日本龍頭,10,1,9,富邦-新營,2024-08-12,9693
2365,昆盈,54,45,9,富邦-新營,2024-08-12,9693
2891,中信金,10,2,8,富邦-新營,2024-08-12,9693
2359,所羅門,10,2,8,富邦-新營,2024-08-12,9693
00664R,國泰臺灣加權反1,8,0,8,富邦-新營,2024-08-12,9693
00934,中信成長高股息,10,3,7,富邦-新營,2024-08-12,9693
2002,中鋼,7,0,7,富邦-新營,2024-08-12,9693
2888,新光金,54,47,7,富邦-新營,2024-08-12,9693
2409,友達,8,1,7,富邦-新營,2024-08-12,9693
5905,南仁湖,7,0,7,富邦-新營,2024-08-12,9693
9955,佳龍,7,0,7,富邦-新營,2024-08-12,9693
4906,正文,6,0,6,富邦-新營,2024-08-12,9693
00706L,期元大S＆P日圓正2,6,0,6,富邦-新營,2024-08-12,9693
8354,冠好,6,0,6,富邦-新營,2024-08-12,9693
00662,富邦NASDAQ,10,4,6,富邦-新營,2024-08-12,9693
00948B,中信優息投資級債,6,0,6,富邦-新營,2024-08-12,9693
3481,群創,63,58,5,富邦-新營,2024-08-12,9693
00918,大華優利高填息30,5,0,5,富邦-新營,2024-08-12,9693
3564,其陽,5,0,5,富邦-新營,2024-08-12,9693
3374,精材,5,1,4,富邦-新營,2024-08-12,9693
4763,材料-KY,4,0,4,富邦-新營,2024-08-12,9693
00931B,統一美債20年,4,0,4,富邦-新營,2024-08-12,9693
00907,永豐優息存股,51,0,51,富邦-新營,2024-08-13,9693
2615,萬海,75,30,45,富邦-新營,2024-08-13,9693
4974,亞泰,40,0,40,富邦-新營,2024-08-13,9693
6727,亞泰金屬,40,0,40,富邦-新營,2024-08-13,9693
00712,復華富時不動產,34,1,33,富邦-新營,2024-08-13,9693
4716,大立,33,0,33,富邦-新營,2024-08-13,9693
5263,智崴,30,0,30,富邦-新營,2024-08-13,9693
2002,中鋼,25,1,24,富邦-新營,2024-08-13,9693
2303,聯電,32,8,24,富邦-新營,2024-08-13,9693
1540,喬福,27,3,24,富邦-新營,2024-08-13,9693
00696B,富邦美債20年,25,2,23,富邦-新營,2024-08-13,9693
2880,華南金,23,0,23,富邦-新營,2024-08-13,9693
00900,富邦特選高股息30,23,1,22,富邦-新營,2024-08-13,9693
00676R,富邦臺灣加權反1,20,0,20,富邦-新營,2024-08-13,9693
3037,欣興,21,2,19,富邦-新營,2024-08-13,9693
5880,合庫金,18,0,18,富邦-新營,2024-08-13,9693
1513,中興電,23,6,17,富邦-新營,2024-08-13,9693
00679B,元大美債20年,17,0,17,富邦-新營,2024-08-13,9693
2367,燿華,23,8,15,富邦-新營,2024-08-13,9693
3535,晶彩科,16,3,13,富邦-新營,2024-08-13,9693
2834,臺企銀,13,0,13,富邦-新營,2024-08-13,9693
00632R,元大台灣50反1,12,0,12,富邦-新營,2024-08-13,9693
2609,陽明,14,2,12,富邦-新營,2024-08-13,9693
4174,浩鼎,51,39,12,富邦-新營,2024-08-13,9693
00936,台新永續高息中小,11,0,11,富邦-新營,2024-08-13,9693
1314,中石化,21,10,11,富邦-新營,2024-08-13,9693
2610,華航,16,5,11,富邦-新營,2024-08-13,9693
9941,裕融,11,0,11,富邦-新營,2024-08-13,9693
00669R,國泰美國道瓊反1,10,0,10,富邦-新營,2024-08-13,9693
00665L,富邦�琤肭磪囓�2,10,0,10,富邦-新營,2024-08-13,9693
2399,映泰,10,0,10,富邦-新營,2024-08-13,9693
2633,台灣高鐵,10,0,10,富邦-新營,2024-08-13,9693
00919,群益台灣精選高息,9,1,8,富邦-新營,2024-08-13,9693
00687B,國泰20年美債,10,2,8,富邦-新營,2024-08-13,9693
1529,樂事綠能,10,2,8,富邦-新營,2024-08-13,9693
2027,大成鋼,8,0,8,富邦-新營,2024-08-13,9693
3013,晟銘電,33,25,8,富邦-新營,2024-08-13,9693
2886,兆豐金,7,0,7,富邦-新營,2024-08-13,9693
2458,義隆,7,0,7,富邦-新營,2024-08-13,9693
1710,東聯,7,0,7,富邦-新營,2024-08-13,9693
6443,元晶,7,0,7,富邦-新營,2024-08-13,9693
3231,緯創,17,10,7,富邦-新營,2024-08-13,9693
6217,中探針,6,0,6,富邦-新營,2024-08-13,9693
8354,冠好,6,0,6,富邦-新營,2024-08-13,9693
8415,大國鋼,6,0,6,富邦-新營,2024-08-13,9693
3706,神達,6,0,6,富邦-新營,2024-08-13,9693
2892,第一金,6,0,6,富邦-新營,2024-08-13,9693
00713,元大台灣高息低波,6,0,6,富邦-新營,2024-08-13,9693
00934,中信成長高股息,6,1,5,富邦-新營,2024-08-13,9693
2891,中信金,8,3,5,富邦-新營,2024-08-13,9693
00687B,國泰20年美債,222,0,222,富邦-新營,2024-08-14,9693
1101,台泥,106,0,106,富邦-新營,2024-08-14,9693
6550,北極星藥業-KY,65,1,64,富邦-新營,2024-08-14,9693
00680L,元大美債20正2,55,0,55,富邦-新營,2024-08-14,9693
3481,群創,92,39,53,富邦-新營,2024-08-14,9693
00637L,元大滬深300正2,50,1,49,富邦-新營,2024-08-14,9693
00679B,元大美債20年,36,4,32,富邦-新營,2024-08-14,9693
6180,橘子,30,0,30,富邦-新營,2024-08-14,9693
5905,南仁湖,37,13,24,富邦-新營,2024-08-14,9693
2489,瑞軒,27,5,22,富邦-新營,2024-08-14,9693
00929,復華台灣科技優息,37,16,21,富邦-新營,2024-08-14,9693
00891,中信關鍵半導體,20,2,18,富邦-新營,2024-08-14,9693
1417,嘉裕,18,0,18,富邦-新營,2024-08-14,9693
2332,友訊,18,0,18,富邦-新營,2024-08-14,9693
2002,中鋼,39,25,14,富邦-新營,2024-08-14,9693
2317,鴻海,35,21,14,富邦-新營,2024-08-14,9693
6695,芯鼎,18,5,13,富邦-新營,2024-08-14,9693
8415,大國鋼,13,0,13,富邦-新營,2024-08-14,9693
4510,高鋒,13,0,13,富邦-新營,2024-08-14,9693
00918,大華優利高填息30,12,0,12,富邦-新營,2024-08-14,9693
2401,凌陽,13,1,12,富邦-新營,2024-08-14,9693
2515,中工,12,0,12,富邦-新營,2024-08-14,9693
00932,兆豐永續高息等權,11,0,11,富邦-新營,2024-08-14,9693
2455,全新,11,0,11,富邦-新營,2024-08-14,9693
4967,十銓,11,1,10,富邦-新營,2024-08-14,9693
00922,國泰台灣領袖50,10,0,10,富邦-新營,2024-08-14,9693
4109,加捷生醫,11,1,10,富邦-新營,2024-08-14,9693
3019,亞光,43,33,10,富邦-新營,2024-08-14,9693
4562,穎漢,258,250,8,富邦-新營,2024-08-14,9693
8354,冠好,8,0,8,富邦-新營,2024-08-14,9693
2356,英業達,37,30,7,富邦-新營,2024-08-14,9693
00753L,中信中國50正2,7,0,7,富邦-新營,2024-08-14,9693
00706L,期元大S＆P日圓正2,10,3,7,富邦-新營,2024-08-14,9693
3303,岱稜,25,18,7,富邦-新營,2024-08-14,9693
4532,瑞智,7,0,7,富邦-新營,2024-08-14,9693
6727,亞泰金屬,7,0,7,富邦-新營,2024-08-14,9693
2892,第一金,6,0,6,富邦-新營,2024-08-14,9693
00632R,元大台灣50反1,6,0,6,富邦-新營,2024-08-14,9693
2492,華新科,6,0,6,富邦-新營,2024-08-14,9693
6757,台灣虎航,6,0,6,富邦-新營,2024-08-14,9693
00878,國泰永續高股息,6,0,6,富邦-新營,2024-08-14,9693
2845,遠東銀,6,0,6,富邦-新營,2024-08-14,9693
2324,仁寶,8,3,5,富邦-新營,2024-08-14,9693
2609,陽明,31,26,5,富邦-新營,2024-08-14,9693
2722,夏都,5,0,5,富邦-新營,2024-08-14,9693
4168,醣聯,5,0,5,富邦-新營,2024-08-14,9693
6116,彩晶,10,5,5,富邦-新營,2024-08-14,9693
6770,力積電,5,0,5,富邦-新營,2024-08-14,9693
6869,雲豹能源,41,36,5,富邦-新營,2024-08-14,9693
8028,昇陽半導體,12,7,5,富邦-新營,2024-08-14,9693
00687B,國泰20年美債,184,5,179,富邦-新營,2024-08-15,9693
4562,穎漢,278,152,126,富邦-新營,2024-08-15,9693
8374,羅昇,152,91,61,富邦-新營,2024-08-15,9693
00878,國泰永續高股息,68,11,57,富邦-新營,2024-08-15,9693
00937B,群益ESG投等債20,50,0,50,富邦-新營,2024-08-15,9693
2002,中鋼,50,0,50,富邦-新營,2024-08-15,9693
6550,北極星藥業-KY,48,0,48,富邦-新營,2024-08-15,9693
2317,鴻海,52,10,42,富邦-新營,2024-08-15,9693
00900,富邦特選高股息30,72,35,37,富邦-新營,2024-08-15,9693
2884,玉山金,33,0,33,富邦-新營,2024-08-15,9693
3390,旭軟,35,6,29,富邦-新營,2024-08-15,9693
00929,復華台灣科技優息,55,32,23,富邦-新營,2024-08-15,9693
00679B,元大美債20年,28,7,21,富邦-新營,2024-08-15,9693
2312,金寶,21,0,21,富邦-新營,2024-08-15,9693
2489,瑞軒,25,5,20,富邦-新營,2024-08-15,9693
2031,新光鋼,20,0,20,富邦-新營,2024-08-15,9693
2892,第一金,20,0,20,富邦-新營,2024-08-15,9693
8096,擎亞,31,12,19,富邦-新營,2024-08-15,9693
2303,聯電,20,2,18,富邦-新營,2024-08-15,9693
2891,中信金,18,1,17,富邦-新營,2024-08-15,9693
1527,鑽全,20,3,17,富邦-新營,2024-08-15,9693
3234,光環,17,0,17,富邦-新營,2024-08-15,9693
1314,中石化,15,0,15,富邦-新營,2024-08-15,9693
4958,臻鼎-KY,15,1,14,富邦-新營,2024-08-15,9693
2845,遠東銀,15,1,14,富邦-新營,2024-08-15,9693
3013,晟銘電,36,22,14,富邦-新營,2024-08-15,9693
00936,台新永續高息中小,12,0,12,富邦-新營,2024-08-15,9693
1301,台塑,11,0,11,富邦-新營,2024-08-15,9693
8089,康全電訊,11,0,11,富邦-新營,2024-08-15,9693
2368,金像電,11,0,11,富邦-新營,2024-08-15,9693
00881,國泰台灣5G+,10,0,10,富邦-新營,2024-08-15,9693
00948B,中信優息投資級債,10,0,10,富邦-新營,2024-08-15,9693
1785,光洋科,18,8,10,富邦-新營,2024-08-15,9693
2867,三商壽,15,5,10,富邦-新營,2024-08-15,9693
8076,伍豐,10,0,10,富邦-新營,2024-08-15,9693
00919,群益台灣精選高息,15,5,10,富邦-新營,2024-08-15,9693
2371,大同,11,2,9,富邦-新營,2024-08-15,9693
2543,皇昌,10,1,9,富邦-新營,2024-08-15,9693
6215,和椿,10,1,9,富邦-新營,2024-08-15,9693
00731,復華富時高息低波,9,0,9,富邦-新營,2024-08-15,9693
00713,元大台灣高息低波,9,1,8,富邦-新營,2024-08-15,9693
1216,統一,7,0,7,富邦-新營,2024-08-15,9693
8054,安國,10,3,7,富邦-新營,2024-08-15,9693
2337,旺宏,9,2,7,富邦-新營,2024-08-15,9693
2880,華南金,6,0,6,富邦-新營,2024-08-15,9693
00632R,元大台灣50反1,6,0,6,富邦-新營,2024-08-15,9693
00773B,中信優先金融債,6,0,6,富邦-新營,2024-08-15,9693
8064,東捷,6,0,6,富邦-新營,2024-08-15,9693
00712,復華富時不動產,6,1,5,富邦-新營,2024-08-15,9693
0056,元大高股息,6,0,6,富邦-新營,2024-08-15,9693
2323,中環,158,56,102,富邦-新營,2024-08-16,9693
00937B,群益ESG投等債20,77,5,72,富邦-新營,2024-08-16,9693
6016,康和證,67,0,67,富邦-新營,2024-08-16,9693
00680L,元大美債20正2,51,0,51,富邦-新營,2024-08-16,9693
00687B,國泰20年美債,31,1,30,富邦-新營,2024-08-16,9693
8096,擎亞,55,25,30,富邦-新營,2024-08-16,9693
2002,中鋼,28,0,28,富邦-新營,2024-08-16,9693
00900,富邦特選高股息30,27,0,27,富邦-新營,2024-08-16,9693
00679B,元大美債20年,31,5,26,富邦-新營,2024-08-16,9693
1409,新纖,25,0,25,富邦-新營,2024-08-16,9693
1527,鑽全,25,0,25,富邦-新營,2024-08-16,9693
2349,錸德,33,11,22,富邦-新營,2024-08-16,9693
5469,瀚宇博,15,0,15,富邦-新營,2024-08-16,9693
2609,陽明,16,3,13,富邦-新營,2024-08-16,9693
1785,光洋科,33,21,12,富邦-新營,2024-08-16,9693
3593,力銘,12,0,12,富邦-新營,2024-08-16,9693
5475,德宏,12,0,12,富邦-新營,2024-08-16,9693
9958,世紀鋼,12,0,12,富邦-新營,2024-08-16,9693
8477,創業家,11,0,11,富邦-新營,2024-08-16,9693
2545,皇翔,16,5,11,富邦-新營,2024-08-16,9693
00933B,國泰10Y+金融債,10,0,10,富邦-新營,2024-08-16,9693
2399,映泰,10,0,10,富邦-新營,2024-08-16,9693
00795B,中信美國公債20年,9,0,9,富邦-新營,2024-08-16,9693
2845,遠東銀,10,1,9,富邦-新營,2024-08-16,9693
4534,慶騰,10,1,9,富邦-新營,2024-08-16,9693
3037,欣興,13,4,9,富邦-新營,2024-08-16,9693
0056,元大高股息,15,6,9,富邦-新營,2024-08-16,9693
2905,三商,8,0,8,富邦-新營,2024-08-16,9693
6189,豐藝,10,2,8,富邦-新營,2024-08-16,9693
2436,偉詮電,7,0,7,富邦-新營,2024-08-16,9693
4563,百德,7,0,7,富邦-新營,2024-08-16,9693
00945B,凱基美國非投等債,7,0,7,富邦-新營,2024-08-16,9693
3324,雙鴻,17,11,6,富邦-新營,2024-08-16,9693
00753L,中信中國50正2,20,14,6,富邦-新營,2024-08-16,9693
6207,雷科,13,7,6,富邦-新營,2024-08-16,9693
6188,廣明,9,3,6,富邦-新營,2024-08-16,9693
00881,國泰台灣5G+,6,0,6,富邦-新營,2024-08-16,9693
2317,鴻海,11,5,6,富邦-新營,2024-08-16,9693
00931B,統一美債20年,5,0,5,富邦-新營,2024-08-16,9693
1904,正隆,8,3,5,富邦-新營,2024-08-16,9693
00671R,富邦NASDAQ反1,5,0,5,富邦-新營,2024-08-16,9693
1442,名軒,7,2,5,富邦-新營,2024-08-16,9693
1718,中纖,5,0,5,富邦-新營,2024-08-16,9693
2337,旺宏,6,1,5,富邦-新營,2024-08-16,9693
2706,第一店,5,0,5,富邦-新營,2024-08-16,9693
3017,奇鋐,7,2,5,富邦-新營,2024-08-16,9693
3086,華義,5,0,5,富邦-新營,2024-08-16,9693
3090,日電貿,5,0,5,富邦-新營,2024-08-16,9693
2537,聯上發,7,3,4,富邦-新營,2024-08-16,9693
4566,時碩工業,8,4,4,富邦-新營,2024-08-16,9693
2885,元大金,181,0,181,富邦-新營,2024-08-19,9693
00929,復華台灣科技優息,171,4,167,富邦-新營,2024-08-19,9693
00687B,國泰20年美債,157,0,157,富邦-新營,2024-08-19,9693
8374,羅昇,105,17,88,富邦-新營,2024-08-19,9693
00878,國泰永續高股息,67,6,61,富邦-新營,2024-08-19,9693
00937B,群益ESG投等債20,76,25,51,富邦-新營,2024-08-19,9693
1815,富喬,46,3,43,富邦-新營,2024-08-19,9693
2867,三商壽,42,0,42,富邦-新營,2024-08-19,9693
3047,訊舟,100,60,40,富邦-新營,2024-08-19,9693
2002,中鋼,37,0,37,富邦-新營,2024-08-19,9693
4904,遠傳,35,0,35,富邦-新營,2024-08-19,9693
2801,彰銀,25,0,25,富邦-新營,2024-08-19,9693
00680L,元大美債20正2,22,0,22,富邦-新營,2024-08-19,9693
5324,士開,21,0,21,富邦-新營,2024-08-19,9693
2884,玉山金,20,0,20,富邦-新營,2024-08-19,9693
00637L,元大滬深300正2,20,0,20,富邦-新營,2024-08-19,9693
1460,宏遠,20,0,20,富邦-新營,2024-08-19,9693
5452,佶優,25,6,19,富邦-新營,2024-08-19,9693
3019,亞光,166,148,18,富邦-新營,2024-08-19,9693
3498,陽程,21,6,15,富邦-新營,2024-08-19,9693
6215,和椿,21,6,15,富邦-新營,2024-08-19,9693
00945B,凱基美國非投等債,14,0,14,富邦-新營,2024-08-19,9693
3013,晟銘電,34,21,13,富邦-新營,2024-08-19,9693
00933B,國泰10Y+金融債,12,0,12,富邦-新營,2024-08-19,9693
00907,永豐優息存股,12,0,12,富邦-新營,2024-08-19,9693
1316,上曜,14,2,12,富邦-新營,2024-08-19,9693
2009,第一銅,11,0,11,富邦-新營,2024-08-19,9693
4174,浩鼎,13,2,11,富邦-新營,2024-08-19,9693
3645,達邁,21,10,11,富邦-新營,2024-08-19,9693
2354,鴻準,14,3,11,富邦-新營,2024-08-19,9693
2845,遠東銀,12,1,11,富邦-新營,2024-08-19,9693
00773B,中信優先金融債,10,0,10,富邦-新營,2024-08-19,9693
4513,福裕,31,21,10,富邦-新營,2024-08-19,9693
4806,桂田文創,10,0,10,富邦-新營,2024-08-19,9693
5475,德宏,10,0,10,富邦-新營,2024-08-19,9693
6152,百一,10,0,10,富邦-新營,2024-08-19,9693
9907,統一實,10,0,10,富邦-新營,2024-08-19,9693
2323,中環,11,2,9,富邦-新營,2024-08-19,9693
2388,威盛,30,21,9,富邦-新營,2024-08-19,9693
3374,精材,14,5,9,富邦-新營,2024-08-19,9693
8028,昇陽半導體,24,16,8,富邦-新營,2024-08-19,9693
6968,萬達寵物,8,0,8,富邦-新營,2024-08-19,9693
00795B,中信美國公債20年,8,0,8,富邦-新營,2024-08-19,9693
2615,萬海,10,2,8,富邦-新營,2024-08-19,9693
6133,金橋,10,2,8,富邦-新營,2024-08-19,9693
4562,穎漢,13,6,7,富邦-新營,2024-08-19,9693
00931B,統一美債20年,6,0,6,富邦-新營,2024-08-19,9693
1301,台塑,6,0,6,富邦-新營,2024-08-19,9693
2607,榮運,7,1,6,富邦-新營,2024-08-19,9693
4303,信立,6,0,6,富邦-新營,2024-08-19,9693
00937B,群益ESG投等債20,270,17,253,富邦-新營,2024-08-20,9693
00680L,元大美債20正2,301,49,252,富邦-新營,2024-08-20,9693
2888,新光金,795,613,182,富邦-新營,2024-08-20,9693
8096,擎亞,310,218,92,富邦-新營,2024-08-20,9693
00679B,元大美債20年,86,10,76,富邦-新營,2024-08-20,9693
3663,鑫科,178,102,76,富邦-新營,2024-08-20,9693
00929,復華台灣科技優息,85,17,68,富邦-新營,2024-08-20,9693
6156,松上,75,20,55,富邦-新營,2024-08-20,9693
00715L,期街口布蘭特正2,53,5,48,富邦-新營,2024-08-20,9693
6550,北極星藥業-KY,46,0,46,富邦-新營,2024-08-20,9693
2820,華票,45,0,45,富邦-新營,2024-08-20,9693
6207,雷科,51,9,42,富邦-新營,2024-08-20,9693
2002,中鋼,52,11,41,富邦-新營,2024-08-20,9693
00882,中信中國高股息,25,1,24,富邦-新營,2024-08-20,9693
00923,群益台ESG低碳50,23,0,23,富邦-新營,2024-08-20,9693
2801,彰銀,21,0,21,富邦-新營,2024-08-20,9693
2317,鴻海,36,17,19,富邦-新營,2024-08-20,9693
4909,新復興,50,34,16,富邦-新營,2024-08-20,9693
2867,三商壽,15,0,15,富邦-新營,2024-08-20,9693
2883,凱基金,15,0,15,富邦-新營,2024-08-20,9693
2881,富邦金,16,1,15,富邦-新營,2024-08-20,9693
2323,中環,46,32,14,富邦-新營,2024-08-20,9693
2520,冠德,16,2,14,富邦-新營,2024-08-20,9693
2543,皇昌,14,0,14,富邦-新營,2024-08-20,9693
00687B,國泰20年美債,13,0,13,富邦-新營,2024-08-20,9693
2402,毅嘉,13,0,13,富邦-新營,2024-08-20,9693
1536,和大,14,2,12,富邦-新營,2024-08-20,9693
5443,均豪,42,30,12,富邦-新營,2024-08-20,9693
6603,富強鑫,12,0,12,富邦-新營,2024-08-20,9693
5347,世界,13,1,12,富邦-新營,2024-08-20,9693
2356,英業達,13,2,11,富邦-新營,2024-08-20,9693
00936,台新永續高息中小,11,1,10,富邦-新營,2024-08-20,9693
5484,慧友,11,1,10,富邦-新營,2024-08-20,9693
1806,冠軍,10,0,10,富邦-新營,2024-08-20,9693
2367,燿華,10,0,10,富邦-新營,2024-08-20,9693
2609,陽明,14,4,10,富邦-新營,2024-08-20,9693
4960,誠美材,10,0,10,富邦-新營,2024-08-20,9693
5345,天揚,10,0,10,富邦-新營,2024-08-20,9693
5425,台半,10,0,10,富邦-新營,2024-08-20,9693
3230,錦明,11,1,10,富邦-新營,2024-08-20,9693
00671R,富邦NASDAQ反1,9,0,9,富邦-新營,2024-08-20,9693
4306,炎洲,9,0,9,富邦-新營,2024-08-20,9693
6244,茂迪,9,0,9,富邦-新營,2024-08-20,9693
2359,所羅門,13,4,9,富邦-新營,2024-08-20,9693
1301,台塑,9,0,9,富邦-新營,2024-08-20,9693
00857B,永豐20年美公債,8,0,8,富邦-新營,2024-08-20,9693
00878,國泰永續高股息,9,1,8,富邦-新營,2024-08-20,9693
3312,弘憶股,9,1,8,富邦-新營,2024-08-20,9693
8927,北基,8,0,8,富邦-新營,2024-08-20,9693
00933B,國泰10Y+金融債,7,0,7,富邦-新營,2024-08-20,9693
8096,擎亞,423,202,221,富邦-新營,2024-08-21,9693
3019,亞光,144,57,87,富邦-新營,2024-08-21,9693
00680L,元大美債20正2,100,20,80,富邦-新營,2024-08-21,9693
2891,中信金,75,1,74,富邦-新營,2024-08-21,9693
00919,群益台灣精選高息,43,4,39,富邦-新營,2024-08-21,9693
00929,復華台灣科技優息,41,2,39,富邦-新營,2024-08-21,9693
00650L,復華香港正2,32,2,30,富邦-新營,2024-08-21,9693
00940,元大台灣價值高息,25,1,24,富邦-新營,2024-08-21,9693
00679B,元大美債20年,47,23,24,富邦-新營,2024-08-21,9693
4960,誠美材,24,0,24,富邦-新營,2024-08-21,9693
5905,南仁湖,127,103,24,富邦-新營,2024-08-21,9693
4174,浩鼎,25,3,22,富邦-新營,2024-08-21,9693
8064,東捷,34,13,21,富邦-新營,2024-08-21,9693
3535,晶彩科,39,18,21,富邦-新營,2024-08-21,9693
1718,中纖,15,0,15,富邦-新營,2024-08-21,9693
2365,昆盈,22,7,15,富邦-新營,2024-08-21,9693
2633,台灣高鐵,15,0,15,富邦-新營,2024-08-21,9693
2801,彰銀,17,2,15,富邦-新營,2024-08-21,9693
6655,科定,15,0,15,富邦-新營,2024-08-21,9693
2542,興富發,13,0,13,富邦-新營,2024-08-21,9693
2845,遠東銀,12,0,12,富邦-新營,2024-08-21,9693
00923,群益台ESG低碳50,11,0,11,富邦-新營,2024-08-21,9693
00715L,期街口布蘭特正2,11,0,11,富邦-新營,2024-08-21,9693
1440,南紡,11,0,11,富邦-新營,2024-08-21,9693
8089,康全電訊,14,3,11,富邦-新營,2024-08-21,9693
2449,京元電子,11,1,10,富邦-新營,2024-08-21,9693
2886,兆豐金,10,0,10,富邦-新營,2024-08-21,9693
2892,第一金,10,0,10,富邦-新營,2024-08-21,9693
1444,力麗,10,0,10,富邦-新營,2024-08-21,9693
3593,力銘,10,0,10,富邦-新營,2024-08-21,9693
3710,連展投控,10,0,10,富邦-新營,2024-08-21,9693
2317,鴻海,13,4,9,富邦-新營,2024-08-21,9693
00713,元大台灣高息低波,8,0,8,富邦-新營,2024-08-21,9693
4160,訊聯基因,12,4,8,富邦-新營,2024-08-21,9693
5484,慧友,9,1,8,富邦-新營,2024-08-21,9693
2455,全新,7,0,7,富邦-新營,2024-08-21,9693
2356,英業達,13,6,7,富邦-新營,2024-08-21,9693
1319,東陽,6,0,6,富邦-新營,2024-08-21,9693
6703,軒郁,7,1,6,富邦-新營,2024-08-21,9693
00753L,中信中國50正2,11,5,6,富邦-新營,2024-08-21,9693
4533,協易機,6,0,6,富邦-新營,2024-08-21,9693
2330,台積電,6,1,5,富邦-新營,2024-08-21,9693
00882,中信中國高股息,5,0,5,富邦-新營,2024-08-21,9693
00642U,期元大S＆P石油,5,0,5,富邦-新營,2024-08-21,9693
2369,菱生,5,0,5,富邦-新營,2024-08-21,9693
2408,南亞科,5,0,5,富邦-新營,2024-08-21,9693
2610,華航,5,0,5,富邦-新營,2024-08-21,9693
2630,亞航,5,0,5,富邦-新營,2024-08-21,9693
2887,台新金,5,0,5,富邦-新營,2024-08-21,9693
3122,笙泉,5,0,5,富邦-新營,2024-08-21,9693
00632R,元大台灣50反1,100,1,99,富邦-新營,2024-08-22,9693
3663,鑫科,112,19,93,富邦-新營,2024-08-22,9693
00948B,中信優息投資級債,40,0,40,富邦-新營,2024-08-22,9693
8096,擎亞,210,171,39,富邦-新營,2024-08-22,9693
2891,中信金,34,2,32,富邦-新營,2024-08-22,9693
2406,國碩,31,0,31,富邦-新營,2024-08-22,9693
2867,三商壽,30,0,30,富邦-新營,2024-08-22,9693
00878,國泰永續高股息,36,8,28,富邦-新營,2024-08-22,9693
00715L,期街口布蘭特正2,41,15,26,富邦-新營,2024-08-22,9693
2881,富邦金,46,25,21,富邦-新營,2024-08-22,9693
00687B,國泰20年美債,20,0,20,富邦-新營,2024-08-22,9693
3652,精聯,71,51,20,富邦-新營,2024-08-22,9693
2208,台船,30,12,18,富邦-新營,2024-08-22,9693
8103,瀚荃,17,0,17,富邦-新營,2024-08-22,9693
3047,訊舟,191,174,17,富邦-新營,2024-08-22,9693
00680L,元大美債20正2,21,5,16,富邦-新營,2024-08-22,9693
00937B,群益ESG投等債20,16,0,16,富邦-新營,2024-08-22,9693
2845,遠東銀,16,0,16,富邦-新營,2024-08-22,9693
6133,金橋,16,1,15,富邦-新營,2024-08-22,9693
00679B,元大美債20年,15,2,13,富邦-新營,2024-08-22,9693
2062,橋椿,24,11,13,富邦-新營,2024-08-22,9693
3059,華晶科,13,0,13,富邦-新營,2024-08-22,9693
9955,佳龍,14,1,13,富邦-新營,2024-08-22,9693
2367,燿華,12,0,12,富邦-新營,2024-08-22,9693
6612,奈米醫材,11,0,11,富邦-新營,2024-08-22,9693
2548,華固,10,0,10,富邦-新營,2024-08-22,9693
00915,凱基優選高股息30,10,0,10,富邦-新營,2024-08-22,9693
3703,欣陸,10,0,10,富邦-新營,2024-08-22,9693
4526,東台,10,0,10,富邦-新營,2024-08-22,9693
1609,大亞,10,1,9,富邦-新營,2024-08-22,9693
00857B,永豐20年美公債,8,0,8,富邦-新營,2024-08-22,9693
1611,中電,8,0,8,富邦-新營,2024-08-22,9693
8089,康全電訊,101,93,8,富邦-新營,2024-08-22,9693
3013,晟銘電,7,0,7,富邦-新營,2024-08-22,9693
5371,中光電,13,6,7,富邦-新營,2024-08-22,9693
8043,蜜望實,13,6,7,富邦-新營,2024-08-22,9693
2542,興富發,9,3,6,富邦-新營,2024-08-22,9693
2312,金寶,24,18,6,富邦-新營,2024-08-22,9693
2809,京城銀,6,0,6,富邦-新營,2024-08-22,9693
6125,廣運,15,9,6,富邦-新營,2024-08-22,9693
6443,元晶,6,0,6,富邦-新營,2024-08-22,9693
4716,大立,8,2,6,富邦-新營,2024-08-22,9693
2890,永豐金,6,0,6,富邦-新營,2024-08-22,9693
4973,廣穎,5,0,5,富邦-新營,2024-08-22,9693
9945,潤泰新,6,1,5,富邦-新營,2024-08-22,9693
2317,鴻海,36,31,5,富邦-新營,2024-08-22,9693
3324,雙鴻,7,2,5,富邦-新營,2024-08-22,9693
1905,華紙,5,0,5,富邦-新營,2024-08-22,9693
2337,旺宏,6,1,5,富邦-新營,2024-08-22,9693
2409,友達,125,120,5,富邦-新營,2024-08-22,9693
2891,中信金,187,16,171,富邦-新營,2024-08-23,9693
00632R,元大台灣50反1,100,0,100,富邦-新營,2024-08-23,9693
1314,中石化,94,5,89,富邦-新營,2024-08-23,9693
2610,華航,78,0,78,富邦-新營,2024-08-23,9693
5263,智崴,69,2,67,富邦-新營,2024-08-23,9693
00680L,元大美債20正2,92,32,60,富邦-新營,2024-08-23,9693
2537,聯上發,53,0,53,富邦-新營,2024-08-23,9693
00687B,國泰20年美債,33,0,33,富邦-新營,2024-08-23,9693
00688L,國泰20年美債正2,40,15,25,富邦-新營,2024-08-23,9693
00937B,群益ESG投等債20,26,1,25,富邦-新營,2024-08-23,9693
2344,華邦電,24,1,23,富邦-新營,2024-08-23,9693
1711,永光,74,53,21,富邦-新營,2024-08-23,9693
2867,三商壽,30,10,20,富邦-新營,2024-08-23,9693
00671R,富邦NASDAQ反1,20,0,20,富邦-新營,2024-08-23,9693
00948B,中信優息投資級債,20,0,20,富邦-新營,2024-08-23,9693
6770,力積電,20,0,20,富邦-新營,2024-08-23,9693
2881,富邦金,20,1,19,富邦-新營,2024-08-23,9693
4174,浩鼎,24,7,17,富邦-新營,2024-08-23,9693
00669R,國泰美國道瓊反1,25,10,15,富邦-新營,2024-08-23,9693
2337,旺宏,16,1,15,富邦-新營,2024-08-23,9693
00857B,永豐20年美公債,14,0,14,富邦-新營,2024-08-23,9693
1409,新纖,14,0,14,富邦-新營,2024-08-23,9693
2332,友訊,14,0,14,富邦-新營,2024-08-23,9693
00929,復華台灣科技優息,13,0,13,富邦-新營,2024-08-23,9693
5309,系統電,17,5,12,富邦-新營,2024-08-23,9693
1708,東鹼,13,2,11,富邦-新營,2024-08-23,9693
1909,榮成,11,0,11,富邦-新營,2024-08-23,9693
2834,臺企銀,11,0,11,富邦-新營,2024-08-23,9693
4142,國光生,12,1,11,富邦-新營,2024-08-23,9693
6612,奈米醫材,11,0,11,富邦-新營,2024-08-23,9693
00919,群益台灣精選高息,12,1,11,富邦-新營,2024-08-23,9693
00650L,復華香港正2,10,0,10,富邦-新營,2024-08-23,9693
1301,台塑,9,0,9,富邦-新營,2024-08-23,9693
2329,華泰,9,0,9,富邦-新營,2024-08-23,9693
4729,熒茂,22,13,9,富邦-新營,2024-08-23,9693
4960,誠美材,10,1,9,富邦-新營,2024-08-23,9693
1721,三晃,11,4,7,富邦-新營,2024-08-23,9693
00715L,期街口布蘭特正2,7,0,7,富邦-新營,2024-08-23,9693
2356,英業達,7,0,7,富邦-新營,2024-08-23,9693
2515,中工,8,1,7,富邦-新營,2024-08-23,9693
8927,北基,7,0,7,富邦-新營,2024-08-23,9693
0056,元大高股息,11,5,6,富邦-新營,2024-08-23,9693
3535,晶彩科,22,16,6,富邦-新營,2024-08-23,9693
00795B,中信美國公債20年,6,0,6,富邦-新營,2024-08-23,9693
00896,中信綠能及電動車,6,0,6,富邦-新營,2024-08-23,9693
1513,中興電,6,0,6,富邦-新營,2024-08-23,9693
2845,遠東銀,6,0,6,富邦-新營,2024-08-23,9693
3042,晶技,9,3,6,富邦-新營,2024-08-23,9693
4576,大銀微系統,6,0,6,富邦-新營,2024-08-23,9693
6133,金橋,30,24,6,富邦-新營,2024-08-23,9693
00919,群益台灣精選高息,189,0,189,富邦-新營,2024-08-26,9693
2888,新光金,223,107,116,富邦-新營,2024-08-26,9693
00632R,元大台灣50反1,100,0,100,富邦-新營,2024-08-26,9693
2867,三商壽,111,17,94,富邦-新營,2024-08-26,9693
00680L,元大美債20正2,92,0,92,富邦-新營,2024-08-26,9693
2409,友達,66,16,50,富邦-新營,2024-08-26,9693
2002,中鋼,46,1,45,富邦-新營,2024-08-26,9693
2337,旺宏,43,3,40,富邦-新營,2024-08-26,9693
2349,錸德,39,2,37,富邦-新營,2024-08-26,9693
4903,聯光通,39,13,26,富邦-新營,2024-08-26,9693
00940,元大台灣價值高息,33,7,26,富邦-新營,2024-08-26,9693
1316,上曜,25,0,25,富邦-新營,2024-08-26,9693
00687B,國泰20年美債,49,25,24,富邦-新營,2024-08-26,9693
1524,耿鼎,20,0,20,富邦-新營,2024-08-26,9693
2885,元大金,20,0,20,富邦-新營,2024-08-26,9693
2891,中信金,42,25,17,富邦-新營,2024-08-26,9693
6451,訊芯-KY,18,1,17,富邦-新營,2024-08-26,9693
00937B,群益ESG投等債20,18,2,16,富邦-新營,2024-08-26,9693
2208,台船,20,4,16,富邦-新營,2024-08-26,9693
2884,玉山金,18,2,16,富邦-新營,2024-08-26,9693
5452,佶優,17,3,14,富邦-新營,2024-08-26,9693
1314,中石化,12,0,12,富邦-新營,2024-08-26,9693
00933B,國泰10Y+金融債,10,0,10,富邦-新營,2024-08-26,9693
00671R,富邦NASDAQ反1,10,0,10,富邦-新營,2024-08-26,9693
3025,星通,10,0,10,富邦-新營,2024-08-26,9693
3703,欣陸,10,0,10,富邦-新營,2024-08-26,9693
4160,訊聯基因,10,0,10,富邦-新營,2024-08-26,9693
8064,東捷,46,36,10,富邦-新營,2024-08-26,9693
2331,精英,11,2,9,富邦-新營,2024-08-26,9693
2489,瑞軒,11,2,9,富邦-新營,2024-08-26,9693
3086,華義,9,0,9,富邦-新營,2024-08-26,9693
6606,建德工業,9,0,9,富邦-新營,2024-08-26,9693
3163,波若威,15,7,8,富邦-新營,2024-08-26,9693
6706,惠特,8,0,8,富邦-新營,2024-08-26,9693
2324,仁寶,10,2,8,富邦-新營,2024-08-26,9693
2317,鴻海,16,8,8,富邦-新營,2024-08-26,9693
2439,美律,8,1,7,富邦-新營,2024-08-26,9693
00923,群益台ESG低碳50,7,0,7,富邦-新營,2024-08-26,9693
00633L,富邦上証正2,7,0,7,富邦-新營,2024-08-26,9693
2312,金寶,42,35,7,富邦-新營,2024-08-26,9693
4129,聯合,7,0,7,富邦-新營,2024-08-26,9693
8374,羅昇,7,0,7,富邦-新營,2024-08-26,9693
2365,昆盈,9,2,7,富邦-新營,2024-08-26,9693
6869,雲豹能源,13,7,6,富邦-新營,2024-08-26,9693
00881,國泰台灣5G+,6,0,6,富邦-新營,2024-08-26,9693
4540,全球傳動,8,2,6,富邦-新營,2024-08-26,9693
00931B,統一美債20年,6,0,6,富邦-新營,2024-08-26,9693
00669R,國泰美國道瓊反1,6,0,6,富邦-新營,2024-08-26,9693
1711,永光,8,2,6,富邦-新營,2024-08-26,9693
2634,漢翔,6,0,6,富邦-新營,2024-08-26,9693
2891,中信金,284,1,283,富邦-新營,2024-08-27,9693
3481,群創,172,15,157,富邦-新營,2024-08-27,9693
8039,台虹,151,49,102,富邦-新營,2024-08-27,9693
2349,錸德,94,4,90,富邦-新營,2024-08-27,9693
00940,元大台灣價值高息,80,0,80,富邦-新營,2024-08-27,9693
2399,映泰,114,43,71,富邦-新營,2024-08-27,9693
2867,三商壽,70,0,70,富邦-新營,2024-08-27,9693
6151,晉倫,52,2,50,富邦-新營,2024-08-27,9693
00919,群益台灣精選高息,42,3,39,富邦-新營,2024-08-27,9693
00753L,中信中國50正2,37,0,37,富邦-新營,2024-08-27,9693
00679B,元大美債20年,32,4,28,富邦-新營,2024-08-27,9693
0056,元大高股息,30,4,26,富邦-新營,2024-08-27,9693
2317,鴻海,26,4,22,富邦-新營,2024-08-27,9693
2303,聯電,21,0,21,富邦-新營,2024-08-27,9693
2615,萬海,27,6,21,富邦-新營,2024-08-27,9693
2014,中鴻,20,0,20,富邦-新營,2024-08-27,9693
00929,復華台灣科技優息,21,2,19,富邦-新營,2024-08-27,9693
3149,正達,50,33,17,富邦-新營,2024-08-27,9693
2324,仁寶,19,3,16,富邦-新營,2024-08-27,9693
3260,威剛,16,0,16,富邦-新營,2024-08-27,9693
00687B,國泰20年美債,15,0,15,富邦-新營,2024-08-27,9693
2603,長榮,15,2,13,富邦-新營,2024-08-27,9693
8111,立��,19,6,13,富邦-新營,2024-08-27,9693
4729,熒茂,14,2,12,富邦-新營,2024-08-27,9693
6443,元晶,17,6,11,富邦-新營,2024-08-27,9693
4960,誠美材,11,0,11,富邦-新營,2024-08-27,9693
5364,力麗店,11,0,11,富邦-新營,2024-08-27,9693
00937B,群益ESG投等債20,10,0,10,富邦-新營,2024-08-27,9693
00933B,國泰10Y+金融債,10,0,10,富邦-新營,2024-08-27,9693
3025,星通,10,0,10,富邦-新營,2024-08-27,9693
6224,聚鼎,10,0,10,富邦-新營,2024-08-27,9693
00650L,復華香港正2,10,0,10,富邦-新營,2024-08-27,9693
2630,亞航,10,0,10,富邦-新營,2024-08-27,9693
3663,鑫科,25,15,10,富邦-新營,2024-08-27,9693
4128,中天,10,0,10,富邦-新營,2024-08-27,9693
6830,汎銓,10,0,10,富邦-新營,2024-08-27,9693
5880,合庫金,10,1,9,富邦-新營,2024-08-27,9693
2388,威盛,29,21,8,富邦-新營,2024-08-27,9693
1785,光洋科,8,0,8,富邦-新營,2024-08-27,9693
2408,南亞科,9,2,7,富邦-新營,2024-08-27,9693
3522,御嵿,7,0,7,富邦-新營,2024-08-27,9693
4510,高鋒,36,29,7,富邦-新營,2024-08-27,9693
5443,均豪,26,19,7,富邦-新營,2024-08-27,9693
2515,中工,18,11,7,富邦-新營,2024-08-27,9693
00936,台新永續高息中小,6,0,6,富邦-新營,2024-08-27,9693
00918,大華優利高填息30,6,0,6,富邦-新營,2024-08-27,9693
3324,雙鴻,14,8,6,富邦-新營,2024-08-27,9693
5432,新門,8,2,6,富邦-新營,2024-08-27,9693
5608,四維航,6,0,6,富邦-新營,2024-08-27,9693
8089,康全電訊,6,0,6,富邦-新營,2024-08-27,9693
00959B,大華投等美債15Y+,48,0,48,富邦-新營,2024-08-28,9693
2891,中信金,43,3,40,富邦-新營,2024-08-28,9693
00937B,群益ESG投等債20,38,3,35,富邦-新營,2024-08-28,9693
1721,三晃,35,2,33,富邦-新營,2024-08-28,9693
2633,台灣高鐵,26,0,26,富邦-新營,2024-08-28,9693
00680L,元大美債20正2,25,0,25,富邦-新營,2024-08-28,9693
2353,宏��,23,0,23,富邦-新營,2024-08-28,9693
00687B,國泰20年美債,19,0,19,富邦-新營,2024-08-28,9693
2426,鼎元,22,3,19,富邦-新營,2024-08-28,9693
2062,橋椿,21,4,17,富邦-新營,2024-08-28,9693
3163,波若威,34,17,17,富邦-新營,2024-08-28,9693
4906,正文,17,0,17,富邦-新營,2024-08-28,9693
2609,陽明,20,4,16,富邦-新營,2024-08-28,9693
00688L,國泰20年美債正2,20,4,16,富邦-新營,2024-08-28,9693
00918,大華優利高填息30,15,0,15,富邦-新營,2024-08-28,9693
00679B,元大美債20年,15,0,15,富邦-新營,2024-08-28,9693
2464,盟立,26,11,15,富邦-新營,2024-08-28,9693
8076,伍豐,15,0,15,富邦-新營,2024-08-28,9693
00878,國泰永續高股息,14,0,14,富邦-新營,2024-08-28,9693
6016,康和證,13,0,13,富邦-新營,2024-08-28,9693
2356,英業達,14,2,12,富邦-新營,2024-08-28,9693
3576,聯合再生,12,0,12,富邦-新營,2024-08-28,9693
3580,友威科,15,3,12,富邦-新營,2024-08-28,9693
2545,皇翔,15,4,11,富邦-新營,2024-08-28,9693
4968,立積,11,0,11,富邦-新營,2024-08-28,9693
9919,康那香,11,0,11,富邦-新營,2024-08-28,9693
2812,台中銀,10,0,10,富邦-新營,2024-08-28,9693
00648R,元大S＆P500反1,10,0,10,富邦-新營,2024-08-28,9693
00633L,富邦上証正2,11,1,10,富邦-新營,2024-08-28,9693
3615,安可,17,7,10,富邦-新營,2024-08-28,9693
6761,穩得,11,1,10,富邦-新營,2024-08-28,9693
6451,訊芯-KY,11,1,10,富邦-新營,2024-08-28,9693
00753L,中信中國50正2,9,0,9,富邦-新營,2024-08-28,9693
1708,東鹼,11,2,9,富邦-新營,2024-08-28,9693
8103,瀚荃,9,0,9,富邦-新營,2024-08-28,9693
00919,群益台灣精選高息,9,1,8,富邦-新營,2024-08-28,9693
6282,康舒,8,0,8,富邦-新營,2024-08-28,9693
2515,中工,8,0,8,富邦-新營,2024-08-28,9693
3339,泰谷,8,0,8,富邦-新營,2024-08-28,9693
6294,智基,8,0,8,富邦-新營,2024-08-28,9693
5905,南仁湖,8,1,7,富邦-新營,2024-08-28,9693
3583,辛耘,7,0,7,富邦-新營,2024-08-28,9693
5386,青雲,8,1,7,富邦-新營,2024-08-28,9693
00632R,元大台灣50反1,11,5,6,富邦-新營,2024-08-28,9693
1904,正隆,6,0,6,富邦-新營,2024-08-28,9693
2405,輔信,6,0,6,富邦-新營,2024-08-28,9693
6151,晉倫,8,2,6,富邦-新營,2024-08-28,9693
8150,南茂,6,0,6,富邦-新營,2024-08-28,9693
2002,中鋼,6,0,6,富邦-新營,2024-08-28,9693
3374,精材,10,5,5,富邦-新營,2024-08-28,9693
1540,喬福,211,77,134,富邦-新營,2024-08-29,9693
2409,友達,115,0,115,富邦-新營,2024-08-29,9693
4510,高鋒,246,166,80,富邦-新營,2024-08-29,9693
2891,中信金,59,4,55,富邦-新營,2024-08-29,9693
2888,新光金,69,18,51,富邦-新營,2024-08-29,9693
00940,元大台灣價值高息,45,0,45,富邦-新營,2024-08-29,9693
00715L,期街口布蘭特正2,40,1,39,富邦-新營,2024-08-29,9693
6151,晉倫,45,12,33,富邦-新營,2024-08-29,9693
00632R,元大台灣50反1,40,10,30,富邦-新營,2024-08-29,9693
2208,台船,30,0,30,富邦-新營,2024-08-29,9693
2367,燿華,108,78,30,富邦-新營,2024-08-29,9693
00679B,元大美債20年,31,3,28,富邦-新營,2024-08-29,9693
1446,宏和,24,0,24,富邦-新營,2024-08-29,9693
00680L,元大美債20正2,25,4,21,富邦-新營,2024-08-29,9693
00753L,中信中國50正2,21,0,21,富邦-新營,2024-08-29,9693
00665L,富邦�琤肭磪囓�2,20,0,20,富邦-新營,2024-08-29,9693
1220,台榮,20,0,20,富邦-新營,2024-08-29,9693
00929,復華台灣科技優息,21,3,18,富邦-新營,2024-08-29,9693
3481,群創,22,4,18,富邦-新營,2024-08-29,9693
2353,宏��,18,1,17,富邦-新營,2024-08-29,9693
1314,中石化,41,25,16,富邦-新營,2024-08-29,9693
2610,華航,21,5,16,富邦-新營,2024-08-29,9693
00830,國泰費城半導體,14,0,14,富邦-新營,2024-08-29,9693
00919,群益台灣精選高息,19,5,14,富邦-新營,2024-08-29,9693
6209,今國光,14,0,14,富邦-新營,2024-08-29,9693
00881,國泰台灣5G+,13,0,13,富邦-新營,2024-08-29,9693
8039,台虹,11,0,11,富邦-新營,2024-08-29,9693
8927,北基,10,0,10,富邦-新營,2024-08-29,9693
00662,富邦NASDAQ,10,0,10,富邦-新營,2024-08-29,9693
00933B,國泰10Y+金融債,10,0,10,富邦-新營,2024-08-29,9693
1909,榮成,10,0,10,富邦-新營,2024-08-29,9693
2615,萬海,13,3,10,富邦-新營,2024-08-29,9693
3694,海華,10,0,10,富邦-新營,2024-08-29,9693
3231,緯創,12,3,9,富邦-新營,2024-08-29,9693
00915,凱基優選高股息30,9,0,9,富邦-新營,2024-08-29,9693
00712,復華富時不動產,15,6,9,富邦-新營,2024-08-29,9693
00918,大華優利高填息30,9,0,9,富邦-新營,2024-08-29,9693
2356,英業達,9,0,9,富邦-新營,2024-08-29,9693
00931B,統一美債20年,9,0,9,富邦-新營,2024-08-29,9693
2330,台積電,9,1,8,富邦-新營,2024-08-29,9693
00878,國泰永續高股息,18,11,7,富邦-新營,2024-08-29,9693
00795B,中信美國公債20年,7,0,7,富邦-新營,2024-08-29,9693
3607,谷崧,7,0,7,富邦-新營,2024-08-29,9693
3363,上詮,67,60,7,富邦-新營,2024-08-29,9693
2887,台新金,8,1,7,富邦-新營,2024-08-29,9693
2317,鴻海,13,7,6,富邦-新營,2024-08-29,9693
00688L,國泰20年美債正2,10,4,6,富邦-新營,2024-08-29,9693
1721,三晃,8,2,6,富邦-新營,2024-08-29,9693
3312,弘憶股,6,0,6,富邦-新營,2024-08-29,9693
5452,佶優,7,1,6,富邦-新營,2024-08-29,9693
00687B,國泰20年美債,138,8,130,富邦-新營,2024-08-30,9693
2349,錸德,57,1,56,富邦-新營,2024-08-30,9693
00680L,元大美債20正2,60,10,50,富邦-新營,2024-08-30,9693
1584,精剛,45,0,45,富邦-新營,2024-08-30,9693
00937B,群益ESG投等債20,34,0,34,富邦-新營,2024-08-30,9693
00959B,大華投等美債15Y+,34,0,34,富邦-新營,2024-08-30,9693
4526,東台,102,71,31,富邦-新營,2024-08-30,9693
00637L,元大滬深300正2,25,0,25,富邦-新營,2024-08-30,9693
2891,中信金,31,6,25,富邦-新營,2024-08-30,9693
00679B,元大美債20年,17,0,17,富邦-新營,2024-08-30,9693
2208,台船,16,0,16,富邦-新營,2024-08-30,9693
3535,晶彩科,15,0,15,富邦-新營,2024-08-30,9693
2618,長榮航,15,0,15,富邦-新營,2024-08-30,9693
2609,陽明,20,5,15,富邦-新營,2024-08-30,9693
3324,雙鴻,18,4,14,富邦-新營,2024-08-30,9693
6269,台郡,16,2,14,富邦-新營,2024-08-30,9693
1711,永光,42,29,13,富邦-新營,2024-08-30,9693
2388,威盛,57,44,13,富邦-新營,2024-08-30,9693
6215,和椿,27,14,13,富邦-新營,2024-08-30,9693
6658,聯策,13,0,13,富邦-新營,2024-08-30,9693
00915,凱基優選高股息30,12,0,12,富邦-新營,2024-08-30,9693
3466,德晉,12,0,12,富邦-新營,2024-08-30,9693
3163,波若威,23,12,11,富邦-新營,2024-08-30,9693
4561,健椿,25,14,11,富邦-新營,2024-08-30,9693
2371,大同,10,0,10,富邦-新營,2024-08-30,9693
00632R,元大台灣50反1,10,0,10,富邦-新營,2024-08-30,9693
3437,榮創,10,0,10,富邦-新營,2024-08-30,9693
3703,欣陸,10,0,10,富邦-新營,2024-08-30,9693
6168,宏齊,13,3,10,富邦-新營,2024-08-30,9693
2323,中環,11,2,9,富邦-新營,2024-08-30,9693
6612,奈米醫材,9,0,9,富邦-新營,2024-08-30,9693
2312,金寶,21,13,8,富邦-新營,2024-08-30,9693
2382,廣達,10,3,7,富邦-新營,2024-08-30,9693
1907,永豐餘,7,0,7,富邦-新營,2024-08-30,9693
2464,盟立,12,5,7,富邦-新營,2024-08-30,9693
4906,正文,7,0,7,富邦-新營,2024-08-30,9693
5443,均豪,46,39,7,富邦-新營,2024-08-30,9693
6698,旭暉應材,11,4,7,富邦-新營,2024-08-30,9693
3374,精材,7,1,6,富邦-新營,2024-08-30,9693
00918,大華優利高填息30,6,0,6,富邦-新營,2024-08-30,9693
2340,台亞,6,0,6,富邦-新營,2024-08-30,9693
3028,增你強,6,0,6,富邦-新營,2024-08-30,9693
6550,北極星藥業-KY,6,0,6,富邦-新營,2024-08-30,9693
2409,友達,8,3,5,富邦-新營,2024-08-30,9693
00706L,期元大S＆P日圓正2,5,0,5,富邦-新營,2024-08-30,9693
1809,中釉,7,2,5,富邦-新營,2024-08-30,9693
1904,正隆,5,0,5,富邦-新營,2024-08-30,9693
2401,凌陽,5,0,5,富邦-新營,2024-08-30,9693
3041,揚智,5,0,5,富邦-新營,2024-08-30,9693
3228,金麗科,5,0,5,富邦-新營,2024-08-30,9693
5443,均豪,117,15,102,富邦-新營,2024-09-02,9693
4566,時碩工業,103,4,99,富邦-新營,2024-09-02,9693
00937B,群益ESG投等債20,69,0,69,富邦-新營,2024-09-02,9693
00715L,期街口布蘭特正2,63,0,63,富邦-新營,2024-09-02,9693
00632R,元大台灣50反1,53,0,53,富邦-新營,2024-09-02,9693
2537,聯上發,53,0,53,富邦-新營,2024-09-02,9693
3481,群創,49,16,33,富邦-新營,2024-09-02,9693
00679B,元大美債20年,35,3,32,富邦-新營,2024-09-02,9693
3450,聯鈞,138,107,31,富邦-新營,2024-09-02,9693
00933B,國泰10Y+金融債,26,0,26,富邦-新營,2024-09-02,9693
00680L,元大美債20正2,30,4,26,富邦-新營,2024-09-02,9693
00919,群益台灣精選高息,65,40,25,富邦-新營,2024-09-02,9693
00687B,國泰20年美債,27,2,25,富邦-新營,2024-09-02,9693
2867,三商壽,24,0,24,富邦-新營,2024-09-02,9693
1718,中纖,20,0,20,富邦-新營,2024-09-02,9693
00959B,大華投等美債15Y+,19,0,19,富邦-新營,2024-09-02,9693
2006,東和鋼鐵,20,1,19,富邦-新營,2024-09-02,9693
6151,晉倫,21,2,19,富邦-新營,2024-09-02,9693
3294,英濟,20,2,18,富邦-新營,2024-09-02,9693
2633,台灣高鐵,17,0,17,富邦-新營,2024-09-02,9693
3017,奇鋐,24,10,14,富邦-新營,2024-09-02,9693
2303,聯電,13,0,13,富邦-新營,2024-09-02,9693
1314,中石化,18,5,13,富邦-新營,2024-09-02,9693
6187,萬潤,19,6,13,富邦-新營,2024-09-02,9693
1711,永光,16,4,12,富邦-新營,2024-09-02,9693
1609,大亞,12,0,12,富邦-新營,2024-09-02,9693
00633L,富邦上証正2,14,2,12,富邦-新營,2024-09-02,9693
2467,志聖,11,0,11,富邦-新營,2024-09-02,9693
4960,誠美材,10,0,10,富邦-新營,2024-09-02,9693
00918,大華優利高填息30,10,0,10,富邦-新營,2024-09-02,9693
3535,晶彩科,15,5,10,富邦-新營,2024-09-02,9693
00753L,中信中國50正2,10,0,10,富邦-新營,2024-09-02,9693
2365,昆盈,10,0,10,富邦-新營,2024-09-02,9693
6156,松上,10,0,10,富邦-新營,2024-09-02,9693
6612,奈米醫材,10,0,10,富邦-新營,2024-09-02,9693
8354,冠好,10,0,10,富邦-新營,2024-09-02,9693
2313,華通,15,5,10,富邦-新營,2024-09-02,9693
6152,百一,9,0,9,富邦-新營,2024-09-02,9693
8105,凌巨,20,11,9,富邦-新營,2024-09-02,9693
2317,鴻海,12,4,8,富邦-新營,2024-09-02,9693
00931B,統一美債20年,8,0,8,富邦-新營,2024-09-02,9693
00642U,期元大S＆P石油,8,0,8,富邦-新營,2024-09-02,9693
3312,弘憶股,10,2,8,富邦-新營,2024-09-02,9693
5469,瀚宇博,8,0,8,富邦-新營,2024-09-02,9693
2881,富邦金,15,7,8,富邦-新營,2024-09-02,9693
00688L,國泰20年美債正2,11,4,7,富邦-新營,2024-09-02,9693
1337,再生-KY,8,1,7,富邦-新營,2024-09-02,9693
2545,皇翔,7,0,7,富邦-新營,2024-09-02,9693
2834,臺企銀,7,0,7,富邦-新營,2024-09-02,9693
6706,惠特,14,7,7,富邦-新營,2024-09-02,9693
4909,新復興,172,15,157,富邦-新營,2024-09-03,9693
00632R,元大台灣50反1,150,0,150,富邦-新營,2024-09-03,9693
00919,群益台灣精選高息,95,0,95,富邦-新營,2024-09-03,9693
1727,中華化,47,0,47,富邦-新營,2024-09-03,9693
2610,華航,38,5,33,富邦-新營,2024-09-03,9693
1314,中石化,33,1,32,富邦-新營,2024-09-03,9693
00929,復華台灣科技優息,34,3,31,富邦-新營,2024-09-03,9693
2609,陽明,33,4,29,富邦-新營,2024-09-03,9693
00948B,中信優息投資級債,30,1,29,富邦-新營,2024-09-03,9693
00918,大華優利高填息30,27,0,27,富邦-新營,2024-09-03,9693
2241,艾姆勒,31,4,27,富邦-新營,2024-09-03,9693
2891,中信金,37,11,26,富邦-新營,2024-09-03,9693
6213,聯茂,32,6,26,富邦-新營,2024-09-03,9693
00915,凱基優選高股息30,24,0,24,富邦-新營,2024-09-03,9693
1815,富喬,118,94,24,富邦-新營,2024-09-03,9693
00687B,國泰20年美債,22,0,22,富邦-新營,2024-09-03,9693
00878,國泰永續高股息,21,0,21,富邦-新營,2024-09-03,9693
00930,永豐ESG低碳高息,20,0,20,富邦-新營,2024-09-03,9693
00877,復華中國5G,22,2,20,富邦-新營,2024-09-03,9693
00753L,中信中國50正2,20,0,20,富邦-新營,2024-09-03,9693
2337,旺宏,21,2,19,富邦-新營,2024-09-03,9693
3466,德晉,19,0,19,富邦-新營,2024-09-03,9693
0056,元大高股息,18,0,18,富邦-新營,2024-09-03,9693
2515,中工,17,0,17,富邦-新營,2024-09-03,9693
3047,訊舟,55,38,17,富邦-新營,2024-09-03,9693
00688L,國泰20年美債正2,16,0,16,富邦-新營,2024-09-03,9693
3363,上詮,25,10,15,富邦-新營,2024-09-03,9693
00712,復華富時不動產,30,16,14,富邦-新營,2024-09-03,9693
2323,中環,15,1,14,富邦-新營,2024-09-03,9693
3037,欣興,13,0,13,富邦-新營,2024-09-03,9693
6706,惠特,14,1,13,富邦-新營,2024-09-03,9693
00680L,元大美債20正2,12,0,12,富邦-新營,2024-09-03,9693
3048,益登,12,0,12,富邦-新營,2024-09-03,9693
4906,正文,18,6,12,富邦-新營,2024-09-03,9693
4960,誠美材,12,0,12,富邦-新營,2024-09-03,9693
00907,永豐優息存股,10,0,10,富邦-新營,2024-09-03,9693
00706L,期元大S＆P日圓正2,10,0,10,富邦-新營,2024-09-03,9693
1605,華新,10,0,10,富邦-新營,2024-09-03,9693
1718,中纖,13,3,10,富邦-新營,2024-09-03,9693
1909,榮成,10,0,10,富邦-新營,2024-09-03,9693
2630,亞航,10,0,10,富邦-新營,2024-09-03,9693
2852,第一保,10,0,10,富邦-新營,2024-09-03,9693
8926,台汽電,10,0,10,富邦-新營,2024-09-03,9693
3535,晶彩科,12,2,10,富邦-新營,2024-09-03,9693
1301,台塑,9,0,9,富邦-新營,2024-09-03,9693
3189,景碩,9,0,9,富邦-新營,2024-09-03,9693
5328,華容,9,0,9,富邦-新營,2024-09-03,9693
8076,伍豐,11,2,9,富邦-新營,2024-09-03,9693
3290,東浦,11,3,8,富邦-新營,2024-09-03,9693
3455,由田,8,0,8,富邦-新營,2024-09-03,9693
00919,群益台灣精選高息,166,39,127,富邦-新營,2024-09-04,9693
2891,中信金,99,5,94,富邦-新營,2024-09-04,9693
00929,復華台灣科技優息,145,65,80,富邦-新營,2024-09-04,9693
00715L,期街口布蘭特正2,75,0,75,富邦-新營,2024-09-04,9693
00830,國泰費城半導體,74,0,74,富邦-新營,2024-09-04,9693
00918,大華優利高填息30,81,8,73,富邦-新營,2024-09-04,9693
00878,國泰永續高股息,105,32,73,富邦-新營,2024-09-04,9693
00676R,富邦臺灣加權反1,70,0,70,富邦-新營,2024-09-04,9693
00930,永豐ESG低碳高息,59,0,59,富邦-新營,2024-09-04,9693
8374,羅昇,416,359,57,富邦-新營,2024-09-04,9693
2888,新光金,75,24,51,富邦-新營,2024-09-04,9693
00940,元大台灣價值高息,78,27,51,富邦-新營,2024-09-04,9693
0056,元大高股息,52,6,46,富邦-新營,2024-09-04,9693
00915,凱基優選高股息30,46,0,46,富邦-新營,2024-09-04,9693
2002,中鋼,37,0,37,富邦-新營,2024-09-04,9693
2892,第一金,35,1,34,富邦-新營,2024-09-04,9693
2618,長榮航,40,7,33,富邦-新營,2024-09-04,9693
2601,益航,32,0,32,富邦-新營,2024-09-04,9693
2881,富邦金,29,0,29,富邦-新營,2024-09-04,9693
3037,欣興,34,6,28,富邦-新營,2024-09-04,9693
2382,廣達,27,2,25,富邦-新營,2024-09-04,9693
00679B,元大美債20年,39,15,24,富邦-新營,2024-09-04,9693
006208,富邦台50,24,0,24,富邦-新營,2024-09-04,9693
3024,憶聲,23,0,23,富邦-新營,2024-09-04,9693
5009,榮剛,24,2,22,富邦-新營,2024-09-04,9693
1314,中石化,55,33,22,富邦-新營,2024-09-04,9693
1909,榮成,24,3,21,富邦-新營,2024-09-04,9693
00665L,富邦�琤肭磪囓�2,20,0,20,富邦-新營,2024-09-04,9693
5608,四維航,20,0,20,富邦-新營,2024-09-04,9693
2867,三商壽,51,32,19,富邦-新營,2024-09-04,9693
2317,鴻海,40,21,19,富邦-新營,2024-09-04,9693
00900,富邦特選高股息30,18,0,18,富邦-新營,2024-09-04,9693
00959B,大華投等美債15Y+,17,0,17,富邦-新營,2024-09-04,9693
2801,彰銀,16,0,16,富邦-新營,2024-09-04,9693
1312,國喬,16,0,16,富邦-新營,2024-09-04,9693
2436,偉詮電,21,5,16,富邦-新營,2024-09-04,9693
00881,國泰台灣5G+,16,0,16,富邦-新營,2024-09-04,9693
00946,群益科技高息成長,16,0,16,富邦-新營,2024-09-04,9693
5880,合庫金,22,7,15,富邦-新營,2024-09-04,9693
1301,台塑,14,0,14,富邦-新營,2024-09-04,9693
2330,台積電,28,14,14,富邦-新營,2024-09-04,9693
2886,兆豐金,14,0,14,富邦-新營,2024-09-04,9693
2486,一詮,14,1,13,富邦-新營,2024-09-04,9693
3535,晶彩科,17,4,13,富邦-新營,2024-09-04,9693
1326,台化,12,0,12,富邦-新營,2024-09-04,9693
00713,元大台灣高息低波,11,0,11,富邦-新營,2024-09-04,9693
00712,復華富時不動產,11,0,11,富邦-新營,2024-09-04,9693
3017,奇鋐,23,12,11,富邦-新營,2024-09-04,9693
2007,燁興,11,0,11,富邦-新營,2024-09-04,9693
0050,元大台灣50,10,0,10,富邦-新營,2024-09-04,9693
00715L,期街口布蘭特正2,1139,0,1139,富邦-新營,2024-09-05,9693
00632R,元大台灣50反1,260,5,255,富邦-新營,2024-09-05,9693
00679B,元大美債20年,93,1,92,富邦-新營,2024-09-05,9693
00919,群益台灣精選高息,71,0,71,富邦-新營,2024-09-05,9693
2241,艾姆勒,63,1,62,富邦-新營,2024-09-05,9693
2537,聯上發,51,0,51,富邦-新營,2024-09-05,9693
6153,嘉聯益,50,0,50,富邦-新營,2024-09-05,9693
2408,南亞科,42,2,40,富邦-新營,2024-09-05,9693
2317,鴻海,40,5,35,富邦-新營,2024-09-05,9693
00952,凱基台灣AI50,32,0,32,富邦-新營,2024-09-05,9693
00929,復華台灣科技優息,38,6,32,富邦-新營,2024-09-05,9693
00753L,中信中國50正2,30,0,30,富邦-新營,2024-09-05,9693
1711,永光,210,183,27,富邦-新營,2024-09-05,9693
1314,中石化,22,0,22,富邦-新營,2024-09-05,9693
00671R,富邦NASDAQ反1,20,0,20,富邦-新營,2024-09-05,9693
00878,國泰永續高股息,20,0,20,富邦-新營,2024-09-05,9693
3017,奇鋐,25,7,18,富邦-新營,2024-09-05,9693
2497,怡利電,23,5,18,富邦-新營,2024-09-05,9693
1303,南亞,16,0,16,富邦-新營,2024-09-05,9693
0056,元大高股息,17,1,16,富邦-新營,2024-09-05,9693
2409,友達,13,0,13,富邦-新營,2024-09-05,9693
2338,光罩,13,0,13,富邦-新營,2024-09-05,9693
00918,大華優利高填息30,13,1,12,富邦-新營,2024-09-05,9693
00712,復華富時不動產,13,1,12,富邦-新營,2024-09-05,9693
00881,國泰台灣5G+,12,0,12,富邦-新營,2024-09-05,9693
2337,旺宏,47,35,12,富邦-新營,2024-09-05,9693
4967,十銓,13,2,11,富邦-新營,2024-09-05,9693
00946,群益科技高息成長,11,0,11,富邦-新營,2024-09-05,9693
1539,巨庭,22,11,11,富邦-新營,2024-09-05,9693
2344,華邦電,10,0,10,富邦-新營,2024-09-05,9693
2376,技嘉,11,1,10,富邦-新營,2024-09-05,9693
00637L,元大滬深300正2,10,0,10,富邦-新營,2024-09-05,9693
00650L,復華香港正2,10,0,10,富邦-新營,2024-09-05,9693
1305,華夏,10,0,10,富邦-新營,2024-09-05,9693
1312,國喬,10,0,10,富邦-新營,2024-09-05,9693
1514,亞力,10,0,10,富邦-新營,2024-09-05,9693
2349,錸德,11,1,10,富邦-新營,2024-09-05,9693
2615,萬海,10,0,10,富邦-新營,2024-09-05,9693
3019,亞光,18,8,10,富邦-新營,2024-09-05,9693
3047,訊舟,80,70,10,富邦-新營,2024-09-05,9693
3086,華義,13,3,10,富邦-新營,2024-09-05,9693
4306,炎洲,11,1,10,富邦-新營,2024-09-05,9693
1101,台泥,10,0,10,富邦-新營,2024-09-05,9693
2891,中信金,12,2,10,富邦-新營,2024-09-05,9693
3535,晶彩科,11,2,9,富邦-新營,2024-09-05,9693
6278,台表科,10,1,9,富邦-新營,2024-09-05,9693
2312,金寶,61,52,9,富邦-新營,2024-09-05,9693
00915,凱基優選高股息30,10,1,9,富邦-新營,2024-09-05,9693
2002,中鋼,11,2,9,富邦-新營,2024-09-05,9693
6451,訊芯-KY,10,3,7,富邦-新營,2024-09-05,9693
2888,新光金,185,3,182,富邦-新營,2024-09-06,9693
00919,群益台灣精選高息,50,0,50,富邦-新營,2024-09-06,9693
00715L,期街口布蘭特正2,72,25,47,富邦-新營,2024-09-06,9693
00713,元大台灣高息低波,33,1,32,富邦-新營,2024-09-06,9693
2891,中信金,36,8,28,富邦-新營,2024-09-06,9693
6216,居易,28,0,28,富邦-新營,2024-09-06,9693
2371,大同,26,0,26,富邦-新營,2024-09-06,9693
1513,中興電,27,2,25,富邦-新營,2024-09-06,9693
00664R,國泰臺灣加權反1,25,0,25,富邦-新營,2024-09-06,9693
2317,鴻海,23,6,17,富邦-新營,2024-09-06,9693
00918,大華優利高填息30,15,0,15,富邦-新營,2024-09-06,9693
1605,華新,17,3,14,富邦-新營,2024-09-06,9693
0056,元大高股息,12,0,12,富邦-新營,2024-09-06,9693
1609,大亞,14,2,12,富邦-新營,2024-09-06,9693
6405,悅城,62,50,12,富邦-新營,2024-09-06,9693
1316,上曜,11,0,11,富邦-新營,2024-09-06,9693
6176,瑞儀,11,0,11,富邦-新營,2024-09-06,9693
00687B,國泰20年美債,11,1,10,富邦-新營,2024-09-06,9693
1464,得力,10,0,10,富邦-新營,2024-09-06,9693
00953B,群益優選非投等債,10,0,10,富邦-新營,2024-09-06,9693
1603,華電,10,0,10,富邦-新營,2024-09-06,9693
1909,榮成,10,0,10,富邦-新營,2024-09-06,9693
2401,凌陽,10,0,10,富邦-新營,2024-09-06,9693
2812,台中銀,10,0,10,富邦-新營,2024-09-06,9693
4549,桓達,11,1,10,富邦-新營,2024-09-06,9693
8070,長華*,12,2,10,富邦-新營,2024-09-06,9693
1101,台泥,10,1,9,富邦-新營,2024-09-06,9693
3086,華義,14,5,9,富邦-新營,2024-09-06,9693
00631L,元大台灣50正2,8,0,8,富邦-新營,2024-09-06,9693
1314,中石化,8,0,8,富邦-新營,2024-09-06,9693
6147,頎邦,8,0,8,富邦-新營,2024-09-06,9693
1815,富喬,53,45,8,富邦-新營,2024-09-06,9693
5905,南仁湖,17,9,8,富邦-新營,2024-09-06,9693
2313,華通,8,1,7,富邦-新營,2024-09-06,9693
2618,長榮航,7,0,7,富邦-新營,2024-09-06,9693
1503,士電,11,4,7,富邦-新營,2024-09-06,9693
3481,群創,108,102,6,富邦-新營,2024-09-06,9693
00940,元大台灣價值高息,12,6,6,富邦-新營,2024-09-06,9693
00941,中信上游半導體,6,0,6,富邦-新營,2024-09-06,9693
2241,艾姆勒,8,2,6,富邦-新營,2024-09-06,9693
3054,立萬利,6,0,6,富邦-新營,2024-09-06,9693
3230,錦明,15,9,6,富邦-新營,2024-09-06,9693
6698,旭暉應材,6,0,6,富邦-新營,2024-09-06,9693
9925,新保,6,0,6,富邦-新營,2024-09-06,9693
00930,永豐ESG低碳高息,5,0,5,富邦-新營,2024-09-06,9693
2610,華航,5,0,5,富邦-新營,2024-09-06,9693
00830,國泰費城半導體,5,0,5,富邦-新營,2024-09-06,9693
2002,中鋼,8,3,5,富邦-新營,2024-09-06,9693
00753L,中信中國50正2,5,0,5,富邦-新營,2024-09-06,9693
2409,友達,5,0,5,富邦-新營,2024-09-06,9693
00632R,元大台灣50反1,265,14,251,富邦-新營,2024-09-09,9693
00919,群益台灣精選高息,189,5,184,富邦-新營,2024-09-09,9693
00878,國泰永續高股息,167,2,165,富邦-新營,2024-09-09,9693
00715L,期街口布蘭特正2,101,0,101,富邦-新營,2024-09-09,9693
00650L,復華香港正2,65,0,65,富邦-新營,2024-09-09,9693
2891,中信金,60,1,59,富邦-新營,2024-09-09,9693
00680L,元大美債20正2,58,0,58,富邦-新營,2024-09-09,9693
00929,復華台灣科技優息,57,24,33,富邦-新營,2024-09-09,9693
3481,群創,37,4,33,富邦-新營,2024-09-09,9693
2881,富邦金,27,0,27,富邦-新營,2024-09-09,9693
2633,台灣高鐵,30,5,25,富邦-新營,2024-09-09,9693
2317,鴻海,29,5,24,富邦-新營,2024-09-09,9693
00918,大華優利高填息30,22,0,22,富邦-新營,2024-09-09,9693
00687B,國泰20年美債,24,2,22,富邦-新營,2024-09-09,9693
2515,中工,22,0,22,富邦-新營,2024-09-09,9693
00651R,復華香港反1,18,0,18,富邦-新營,2024-09-09,9693
0056,元大高股息,19,1,18,富邦-新營,2024-09-09,9693
00633L,富邦上証正2,18,4,14,富邦-新營,2024-09-09,9693
2425,承啟,14,0,14,富邦-新營,2024-09-09,9693
4303,信立,14,0,14,富邦-新營,2024-09-09,9693
4306,炎洲,14,0,14,富邦-新營,2024-09-09,9693
2002,中鋼,13,0,13,富邦-新營,2024-09-09,9693
00933B,國泰10Y+金融債,12,0,12,富邦-新營,2024-09-09,9693
1314,中石化,12,0,12,富邦-新營,2024-09-09,9693
2607,榮運,13,1,12,富邦-新營,2024-09-09,9693
2356,英業達,11,0,11,富邦-新營,2024-09-09,9693
4510,高鋒,27,16,11,富邦-新營,2024-09-09,9693
3230,錦明,12,2,10,富邦-新營,2024-09-09,9693
00915,凱基優選高股息30,11,1,10,富邦-新營,2024-09-09,9693
00679B,元大美債20年,16,6,10,富邦-新營,2024-09-09,9693
2609,陽明,11,1,10,富邦-新營,2024-09-09,9693
00753L,中信中國50正2,10,0,10,富邦-新營,2024-09-09,9693
2929,淘帝-KY,10,0,10,富邦-新營,2024-09-09,9693
5009,榮剛,10,0,10,富邦-新營,2024-09-09,9693
5392,能率,10,0,10,富邦-新營,2024-09-09,9693
8076,伍豐,10,1,9,富邦-新營,2024-09-09,9693
1909,榮成,8,0,8,富邦-新營,2024-09-09,9693
3017,奇鋐,17,9,8,富邦-新營,2024-09-09,9693
2885,元大金,7,0,7,富邦-新營,2024-09-09,9693
2241,艾姆勒,18,11,7,富邦-新營,2024-09-09,9693
2464,盟立,11,4,7,富邦-新營,2024-09-09,9693
8074,鉅橡,10,3,7,富邦-新營,2024-09-09,9693
2486,一詮,9,2,7,富邦-新營,2024-09-09,9693
00930,永豐ESG低碳高息,6,0,6,富邦-新營,2024-09-09,9693
2539,櫻花建,6,0,6,富邦-新營,2024-09-09,9693
3231,緯創,14,8,6,富邦-新營,2024-09-09,9693
00881,國泰台灣5G+,6,0,6,富邦-新營,2024-09-09,9693
1785,光洋科,8,2,6,富邦-新營,2024-09-09,9693
2382,廣達,6,0,6,富邦-新營,2024-09-09,9693
00830,國泰費城半導體,5,0,5,富邦-新營,2024-09-09,9693
6530,創威,121,3,118,富邦-新營,2024-09-10,9693
00715L,期街口布蘭特正2,127,45,82,富邦-新營,2024-09-10,9693
00929,復華台灣科技優息,70,5,65,富邦-新營,2024-09-10,9693
00919,群益台灣精選高息,56,0,56,富邦-新營,2024-09-10,9693
00753L,中信中國50正2,52,5,47,富邦-新營,2024-09-10,9693
00946,群益科技高息成長,37,0,37,富邦-新營,2024-09-10,9693
00918,大華優利高填息30,36,0,36,富邦-新營,2024-09-10,9693
00937B,群益ESG投等債20,51,16,35,富邦-新營,2024-09-10,9693
00940,元大台灣價值高息,33,0,33,富邦-新營,2024-09-10,9693
3623,富晶通,30,3,27,富邦-新營,2024-09-10,9693
2002,中鋼,24,0,24,富邦-新營,2024-09-10,9693
2241,艾姆勒,20,0,20,富邦-新營,2024-09-10,9693
2607,榮運,20,0,20,富邦-新營,2024-09-10,9693
4967,十銓,21,2,19,富邦-新營,2024-09-10,9693
00637L,元大滬深300正2,20,1,19,富邦-新營,2024-09-10,9693
2349,錸德,19,0,19,富邦-新營,2024-09-10,9693
2344,華邦電,21,4,17,富邦-新營,2024-09-10,9693
2881,富邦金,22,5,17,富邦-新營,2024-09-10,9693
2887,台新金,20,3,17,富邦-新營,2024-09-10,9693
3481,群創,16,0,16,富邦-新營,2024-09-10,9693
0056,元大高股息,16,0,16,富邦-新營,2024-09-10,9693
3535,晶彩科,16,0,16,富邦-新營,2024-09-10,9693
1605,華新,15,0,15,富邦-新營,2024-09-10,9693
3047,訊舟,42,28,14,富邦-新營,2024-09-10,9693
00881,國泰台灣5G+,14,0,14,富邦-新營,2024-09-10,9693
00931B,統一美債20年,14,1,13,富邦-新營,2024-09-10,9693
2402,毅嘉,27,14,13,富邦-新營,2024-09-10,9693
4729,熒茂,17,4,13,富邦-新營,2024-09-10,9693
2337,旺宏,13,0,13,富邦-新營,2024-09-10,9693
1513,中興電,13,1,12,富邦-新營,2024-09-10,9693
2303,聯電,13,1,12,富邦-新營,2024-09-10,9693
8076,伍豐,16,4,12,富邦-新營,2024-09-10,9693
00930,永豐ESG低碳高息,12,1,11,富邦-新營,2024-09-10,9693
2382,廣達,12,1,11,富邦-新營,2024-09-10,9693
2313,華通,11,0,11,富邦-新營,2024-09-10,9693
1806,冠軍,10,0,10,富邦-新營,2024-09-10,9693
2312,金寶,10,0,10,富邦-新營,2024-09-10,9693
2537,聯上發,10,0,10,富邦-新營,2024-09-10,9693
3686,達能,10,0,10,富邦-新營,2024-09-10,9693
2497,怡利電,73,63,10,富邦-新營,2024-09-10,9693
2301,光寶科,9,0,9,富邦-新營,2024-09-10,9693
2408,南亞科,11,2,9,富邦-新營,2024-09-10,9693
1540,喬福,24,15,9,富邦-新營,2024-09-10,9693
1101,台泥,10,1,9,富邦-新營,2024-09-10,9693
4510,高鋒,19,10,9,富邦-新營,2024-09-10,9693
1711,永光,8,0,8,富邦-新營,2024-09-10,9693
00679B,元大美債20年,13,5,8,富邦-新營,2024-09-10,9693
6147,頎邦,10,2,8,富邦-新營,2024-09-10,9693
00680L,元大美債20正2,7,0,7,富邦-新營,2024-09-10,9693
3066,李洲,7,0,7,富邦-新營,2024-09-10,9693
00715L,期街口布蘭特正2,180,0,180,富邦-新營,2024-09-11,9693
2002,中鋼,215,49,166,富邦-新營,2024-09-11,9693
2892,第一金,78,0,78,富邦-新營,2024-09-11,9693
00688L,國泰20年美債正2,80,3,77,富邦-新營,2024-09-11,9693
00937B,群益ESG投等債20,43,1,42,富邦-新營,2024-09-11,9693
00878,國泰永續高股息,41,0,41,富邦-新營,2024-09-11,9693
2497,怡利電,179,142,37,富邦-新營,2024-09-11,9693
00679B,元大美債20年,48,15,33,富邦-新營,2024-09-11,9693
2834,臺企銀,30,0,30,富邦-新營,2024-09-11,9693
00665L,富邦�琤肭磪囓�2,30,0,30,富邦-新營,2024-09-11,9693
1524,耿鼎,31,1,30,富邦-新營,2024-09-11,9693
3390,旭軟,30,3,27,富邦-新營,2024-09-11,9693
2362,藍天,25,0,25,富邦-新營,2024-09-11,9693
2881,富邦金,22,0,22,富邦-新營,2024-09-11,9693
00687B,國泰20年美債,24,5,19,富邦-新營,2024-09-11,9693
00664R,國泰臺灣加權反1,18,0,18,富邦-新營,2024-09-11,9693
00918,大華優利高填息30,16,0,16,富邦-新營,2024-09-11,9693
00959B,大華投等美債15Y+,31,15,16,富邦-新營,2024-09-11,9693
1815,富喬,16,0,16,富邦-新營,2024-09-11,9693
5009,榮剛,16,0,16,富邦-新營,2024-09-11,9693
2610,華航,15,0,15,富邦-新營,2024-09-11,9693
8021,尖點,15,0,15,富邦-新營,2024-09-11,9693
2851,中再保,13,0,13,富邦-新營,2024-09-11,9693
3047,訊舟,20,7,13,富邦-新營,2024-09-11,9693
00919,群益台灣精選高息,18,5,13,富邦-新營,2024-09-11,9693
2388,威盛,13,1,12,富邦-新營,2024-09-11,9693
0056,元大高股息,12,1,11,富邦-新營,2024-09-11,9693
2636,台驊控股,10,0,10,富邦-新營,2024-09-11,9693
3623,富晶通,15,5,10,富邦-新營,2024-09-11,9693
6603,富強鑫,10,0,10,富邦-新營,2024-09-11,9693
1316,上曜,9,0,9,富邦-新營,2024-09-11,9693
00915,凱基優選高股息30,13,5,8,富邦-新營,2024-09-11,9693
4950,牧東,8,0,8,富邦-新營,2024-09-11,9693
00929,復華台灣科技優息,23,16,7,富邦-新營,2024-09-11,9693
4974,亞泰,19,12,7,富邦-新營,2024-09-11,9693
2883,凱基金,8,2,6,富邦-新營,2024-09-11,9693
1446,宏和,6,0,6,富邦-新營,2024-09-11,9693
2323,中環,11,5,6,富邦-新營,2024-09-11,9693
3017,奇鋐,12,6,6,富邦-新營,2024-09-11,9693
2539,櫻花建,5,0,5,富邦-新營,2024-09-11,9693
2880,華南金,5,0,5,富邦-新營,2024-09-11,9693
00753L,中信中國50正2,5,0,5,富邦-新營,2024-09-11,9693
2241,艾姆勒,5,0,5,富邦-新營,2024-09-11,9693
2399,映泰,18,13,5,富邦-新營,2024-09-11,9693
3046,建��,5,0,5,富邦-新營,2024-09-11,9693
3284,太普高,6,1,5,富邦-新營,2024-09-11,9693
3322,建舜電,5,0,5,富邦-新營,2024-09-11,9693
6108,競國,6,1,5,富邦-新營,2024-09-11,9693
8074,鉅橡,5,0,5,富邦-新營,2024-09-11,9693
00891,中信關鍵半導體,4,0,4,富邦-新營,2024-09-11,9693
00919,群益台灣精選高息,111,0,111,富邦-新營,2024-09-12,9693
9919,康那香,70,0,70,富邦-新營,2024-09-12,9693
00934,中信成長高股息,46,1,45,富邦-新營,2024-09-12,9693
6770,力積電,40,1,39,富邦-新營,2024-09-12,9693
2329,華泰,36,3,33,富邦-新營,2024-09-12,9693
9105,泰金寶-DR,31,0,31,富邦-新營,2024-09-12,9693
00877,復華中國5G,30,0,30,富邦-新營,2024-09-12,9693
00712,復華富時不動產,29,0,29,富邦-新營,2024-09-12,9693
00687B,國泰20年美債,32,5,27,富邦-新營,2024-09-12,9693
00650L,復華香港正2,25,0,25,富邦-新營,2024-09-12,9693
2481,強茂,20,0,20,富邦-新營,2024-09-12,9693
0056,元大高股息,22,3,19,富邦-新營,2024-09-12,9693
2449,京元電子,22,3,19,富邦-新營,2024-09-12,9693
2241,艾姆勒,18,0,18,富邦-新營,2024-09-12,9693
6215,和椿,21,4,17,富邦-新營,2024-09-12,9693
00680L,元大美債20正2,16,0,16,富邦-新營,2024-09-12,9693
2851,中再保,16,0,16,富邦-新營,2024-09-12,9693
2332,友訊,15,0,15,富邦-新營,2024-09-12,9693
6156,松上,14,0,14,富邦-新營,2024-09-12,9693
2891,中信金,14,1,13,富邦-新營,2024-09-12,9693
2206,三陽工業,13,0,13,富邦-新營,2024-09-12,9693
3303,岱稜,18,5,13,富邦-新營,2024-09-12,9693
2421,建準,12,0,12,富邦-新營,2024-09-12,9693
4303,信立,12,0,12,富邦-新營,2024-09-12,9693
3105,穩懋,11,0,11,富邦-新營,2024-09-12,9693
6216,居易,11,0,11,富邦-新營,2024-09-12,9693
1584,精剛,10,0,10,富邦-新營,2024-09-12,9693
1806,冠軍,10,0,10,富邦-新營,2024-09-12,9693
2613,中櫃,10,0,10,富邦-新營,2024-09-12,9693
2836,高雄銀,10,0,10,富邦-新營,2024-09-12,9693
3033,威健,10,0,10,富邦-新營,2024-09-12,9693
4532,瑞智,10,0,10,富邦-新營,2024-09-12,9693
1301,台塑,11,2,9,富邦-新營,2024-09-12,9693
8358,金居,10,1,9,富邦-新營,2024-09-12,9693
1312,國喬,8,0,8,富邦-新營,2024-09-12,9693
2609,陽明,10,2,8,富邦-新營,2024-09-12,9693
2845,遠東銀,8,0,8,富邦-新營,2024-09-12,9693
2888,新光金,12,4,8,富邦-新營,2024-09-12,9693
5443,均豪,31,24,7,富邦-新營,2024-09-12,9693
6530,創威,68,61,7,富邦-新營,2024-09-12,9693
00915,凱基優選高股息30,7,0,7,富邦-新營,2024-09-12,9693
3687,歐買尬,7,0,7,富邦-新營,2024-09-12,9693
3535,晶彩科,8,2,6,富邦-新營,2024-09-12,9693
00957B,兆豐US優選投等債,5,0,5,富邦-新營,2024-09-12,9693
2337,旺宏,5,0,5,富邦-新營,2024-09-12,9693
4561,健椿,5,0,5,富邦-新營,2024-09-12,9693
6204,艾華,5,0,5,富邦-新營,2024-09-12,9693
6461,益得,5,0,5,富邦-新營,2024-09-12,9693
3324,雙鴻,7,3,4,富邦-新營,2024-09-12,9693
2392,正崴,4,0,4,富邦-新營,2024-09-12,9693
00680L,元大美債20正2,96,0,96,富邦-新營,2024-09-13,9693
00937B,群益ESG投等債20,103,27,76,富邦-新營,2024-09-13,9693
2371,大同,67,22,45,富邦-新營,2024-09-13,9693
00637L,元大滬深300正2,40,0,40,富邦-新營,2024-09-13,9693
00929,復華台灣科技優息,37,5,32,富邦-新營,2024-09-13,9693
2002,中鋼,41,10,31,富邦-新營,2024-09-13,9693
1721,三晃,30,0,30,富邦-新營,2024-09-13,9693
4950,牧東,29,0,29,富邦-新營,2024-09-13,9693
00919,群益台灣精選高息,24,1,23,富邦-新營,2024-09-13,9693
00679B,元大美債20年,25,3,22,富邦-新營,2024-09-13,9693
5460,同協,26,6,20,富邦-新營,2024-09-13,9693
6218,豪勉,18,1,17,富邦-新營,2024-09-13,9693
1815,富喬,20,6,14,富邦-新營,2024-09-13,9693
00877,復華中國5G,14,0,14,富邦-新營,2024-09-13,9693
6134,萬旭,16,2,14,富邦-新營,2024-09-13,9693
00940,元大台灣價值高息,13,0,13,富邦-新營,2024-09-13,9693
2349,錸德,15,2,13,富邦-新營,2024-09-13,9693
3580,友威科,29,16,13,富邦-新營,2024-09-13,9693
3673,TPK-KY,15,2,13,富邦-新營,2024-09-13,9693
5432,新門,15,2,13,富邦-新營,2024-09-13,9693
2891,中信金,12,0,12,富邦-新營,2024-09-13,9693
00900,富邦特選高股息30,11,0,11,富邦-新營,2024-09-13,9693
2303,聯電,11,1,10,富邦-新營,2024-09-13,9693
00931B,統一美債20年,11,0,11,富邦-新營,2024-09-13,9693
00934,中信成長高股息,10,0,10,富邦-新營,2024-09-13,9693
3324,雙鴻,10,0,10,富邦-新營,2024-09-13,9693
00664R,國泰臺灣加權反1,10,0,10,富邦-新營,2024-09-13,9693
1417,嘉裕,10,0,10,富邦-新營,2024-09-13,9693
4147,中裕,10,0,10,富邦-新營,2024-09-13,9693
6133,金橋,28,18,10,富邦-新營,2024-09-13,9693
2408,南亞科,10,0,10,富邦-新營,2024-09-13,9693
00915,凱基優選高股息30,10,0,10,富邦-新營,2024-09-13,9693
5905,南仁湖,11,2,9,富邦-新營,2024-09-13,9693
00918,大華優利高填息30,10,3,7,富邦-新營,2024-09-13,9693
1710,東聯,10,3,7,富邦-新營,2024-09-13,9693
2241,艾姆勒,7,0,7,富邦-新營,2024-09-13,9693
2609,陽明,7,0,7,富邦-新營,2024-09-13,9693
4763,材料-KY,6,0,6,富邦-新營,2024-09-13,9693
00641R,富邦日本反1,5,0,5,富邦-新營,2024-09-13,9693
00946,群益科技高息成長,5,0,5,富邦-新營,2024-09-13,9693
3484,崧騰,11,6,5,富邦-新營,2024-09-13,9693
3623,富晶通,5,0,5,富邦-新營,2024-09-13,9693
4513,福裕,5,0,5,富邦-新營,2024-09-13,9693
6405,悅城,39,34,5,富邦-新營,2024-09-13,9693
00713,元大台灣高息低波,5,0,5,富邦-新營,2024-09-13,9693
5443,均豪,28,24,4,富邦-新營,2024-09-13,9693
8076,伍豐,6,2,4,富邦-新營,2024-09-13,9693
1540,喬福,47,43,4,富邦-新營,2024-09-13,9693
2515,中工,4,0,4,富邦-新營,2024-09-13,9693
2630,亞航,4,0,4,富邦-新營,2024-09-13,9693
3231,緯創,266,8,258,富邦-新營,2024-09-16,9693
00665L,富邦�琤肭磪囓�2,100,0,100,富邦-新營,2024-09-16,9693
00679B,元大美債20年,67,1,66,富邦-新營,2024-09-16,9693
1721,三晃,50,1,49,富邦-新營,2024-09-16,9693
00919,群益台灣精選高息,36,0,36,富邦-新營,2024-09-16,9693
5230,雷笛克光學,33,2,31,富邦-新營,2024-09-16,9693
00940,元大台灣價值高息,21,0,21,富邦-新營,2024-09-16,9693
00918,大華優利高填息30,20,0,20,富邦-新營,2024-09-16,9693
1727,中華化,27,7,20,富邦-新營,2024-09-16,9693
2002,中鋼,28,9,19,富邦-新營,2024-09-16,9693
00687B,國泰20年美債,19,0,19,富邦-新營,2024-09-16,9693
00915,凱基優選高股息30,19,0,19,富邦-新營,2024-09-16,9693
1524,耿鼎,20,2,18,富邦-新營,2024-09-16,9693
8039,台虹,28,12,16,富邦-新營,2024-09-16,9693
2241,艾姆勒,30,15,15,富邦-新營,2024-09-16,9693
2399,映泰,26,11,15,富邦-新營,2024-09-16,9693
1711,永光,13,0,13,富邦-新營,2024-09-16,9693
00937B,群益ESG投等債20,12,0,12,富邦-新營,2024-09-16,9693
00952,凱基台灣AI50,11,0,11,富邦-新營,2024-09-16,9693
4950,牧東,10,0,10,富邦-新營,2024-09-16,9693
00688L,國泰20年美債正2,10,0,10,富邦-新營,2024-09-16,9693
00680L,元大美債20正2,10,0,10,富邦-新營,2024-09-16,9693
00715L,期街口布蘭特正2,11,1,10,富邦-新營,2024-09-16,9693
00892,富邦台灣半導體,10,0,10,富邦-新營,2024-09-16,9693
00959B,大華投等美債15Y+,10,0,10,富邦-新營,2024-09-16,9693
1709,和益,10,0,10,富邦-新營,2024-09-16,9693
2371,大同,10,0,10,富邦-新營,2024-09-16,9693
2402,毅嘉,10,0,10,富邦-新營,2024-09-16,9693
2317,鴻海,19,10,9,富邦-新營,2024-09-16,9693
1417,嘉裕,8,0,8,富邦-新營,2024-09-16,9693
3031,佰鴻,8,0,8,富邦-新營,2024-09-16,9693
3303,岱稜,10,2,8,富邦-新營,2024-09-16,9693
6274,台燿,14,6,8,富邦-新營,2024-09-16,9693
00934,中信成長高股息,7,0,7,富邦-新營,2024-09-16,9693
00753L,中信中國50正2,7,0,7,富邦-新營,2024-09-16,9693
00857B,永豐20年美公債,7,0,7,富邦-新營,2024-09-16,9693
4510,高鋒,17,10,7,富邦-新營,2024-09-16,9693
6279,胡連,7,0,7,富邦-新營,2024-09-16,9693
1904,正隆,9,2,7,富邦-新營,2024-09-16,9693
3360,尚立,6,0,6,富邦-新營,2024-09-16,9693
00641R,富邦日本反1,6,0,6,富邦-新營,2024-09-16,9693
1527,鑽全,6,0,6,富邦-新營,2024-09-16,9693
1540,喬福,11,5,6,富邦-新營,2024-09-16,9693
4741,泓瀚,6,0,6,富邦-新營,2024-09-16,9693
1326,台化,6,0,6,富邦-新營,2024-09-16,9693
1319,東陽,5,0,5,富邦-新營,2024-09-16,9693
3702,大聯大,6,1,5,富邦-新營,2024-09-16,9693
2338,光罩,5,0,5,富邦-新營,2024-09-16,9693
4956,光鋐,6,1,5,富邦-新營,2024-09-16,9693
9934,成霖,5,0,5,富邦-新營,2024-09-16,9693
00632R,元大台灣50反1,400,0,400,富邦-新營,2024-09-18,9693
5443,均豪,211,29,182,富邦-新營,2024-09-18,9693
4977,眾達-KY,281,143,138,富邦-新營,2024-09-18,9693
00637L,元大滬深300正2,100,0,100,富邦-新營,2024-09-18,9693
1528,恩德,75,0,75,富邦-新營,2024-09-18,9693
00929,復華台灣科技優息,75,0,75,富邦-新營,2024-09-18,9693
00687B,國泰20年美債,63,2,61,富邦-新營,2024-09-18,9693
00679B,元大美債20年,46,9,37,富邦-新營,2024-09-18,9693
6218,豪勉,37,0,37,富邦-新營,2024-09-18,9693
00857B,永豐20年美公債,40,4,36,富邦-新營,2024-09-18,9693
00918,大華優利高填息30,34,1,33,富邦-新營,2024-09-18,9693
00919,群益台灣精選高息,26,1,25,富邦-新營,2024-09-18,9693
00641R,富邦日本反1,25,0,25,富邦-新營,2024-09-18,9693
3021,鴻名,23,0,23,富邦-新營,2024-09-18,9693
00878,國泰永續高股息,29,7,22,富邦-新營,2024-09-18,9693
00713,元大台灣高息低波,23,0,23,富邦-新營,2024-09-18,9693
1326,台化,23,2,21,富邦-新營,2024-09-18,9693
00892,富邦台灣半導體,20,0,20,富邦-新營,2024-09-18,9693
00948B,中信優息投資級債,20,0,20,富邦-新營,2024-09-18,9693
2070,精湛,23,5,18,富邦-新營,2024-09-18,9693
0056,元大高股息,18,0,18,富邦-新營,2024-09-18,9693
2317,鴻海,28,11,17,富邦-新營,2024-09-18,9693
4532,瑞智,21,4,17,富邦-新營,2024-09-18,9693
3550,聯穎,34,17,17,富邦-新營,2024-09-18,9693
6530,創威,26,10,16,富邦-新營,2024-09-18,9693
2313,華通,21,5,16,富邦-新營,2024-09-18,9693
2867,三商壽,17,2,15,富邦-新營,2024-09-18,9693
1773,勝一,19,5,14,富邦-新營,2024-09-18,9693
2303,聯電,14,0,14,富邦-新營,2024-09-18,9693
00915,凱基優選高股息30,17,5,12,富邦-新營,2024-09-18,9693
4562,穎漢,12,0,12,富邦-新營,2024-09-18,9693
3062,建漢,31,20,11,富邦-新營,2024-09-18,9693
00795B,中信美國公債20年,11,0,11,富邦-新營,2024-09-18,9693
2241,艾姆勒,53,42,11,富邦-新營,2024-09-18,9693
00688L,國泰20年美債正2,10,0,10,富邦-新營,2024-09-18,9693
00680L,元大美債20正2,10,0,10,富邦-新營,2024-09-18,9693
00937B,群益ESG投等債20,10,0,10,富邦-新營,2024-09-18,9693
1806,冠軍,10,0,10,富邦-新營,2024-09-18,9693
2845,遠東銀,10,0,10,富邦-新營,2024-09-18,9693
3694,海華,10,0,10,富邦-新營,2024-09-18,9693
4561,健椿,10,0,10,富邦-新營,2024-09-18,9693
4950,牧東,10,0,10,富邦-新營,2024-09-18,9693
2449,京元電子,11,2,9,富邦-新營,2024-09-18,9693
2477,美隆電,9,0,9,富邦-新營,2024-09-18,9693
3576,聯合再生,10,1,9,富邦-新營,2024-09-18,9693
5386,青雲,8,0,8,富邦-新營,2024-09-18,9693
5493,三聯,8,0,8,富邦-新營,2024-09-18,9693
2887,台新金,17,10,7,富邦-新營,2024-09-18,9693
2324,仁寶,10,3,7,富邦-新營,2024-09-18,9693
2349,錸德,254,247,7,富邦-新營,2024-09-18,9693
00958B,永豐ESG銀行債15,69,0,69,富邦-新營,2024-09-19,9693
3354,律勝,55,7,48,富邦-新營,2024-09-19,9693
3049,精金,290,256,34,富邦-新營,2024-09-19,9693
2344,華邦電,32,0,32,富邦-新營,2024-09-19,9693
00795B,中信美國公債20年,28,0,28,富邦-新營,2024-09-19,9693
00929,復華台灣科技優息,35,8,27,富邦-新營,2024-09-19,9693
4513,福裕,42,18,24,富邦-新營,2024-09-19,9693
8011,台通,22,1,21,富邦-新營,2024-09-19,9693
1786,科妍,20,0,20,富邦-新營,2024-09-19,9693
3081,聯亞,21,4,17,富邦-新營,2024-09-19,9693
3581,博磊,17,1,16,富邦-新營,2024-09-19,9693
6288,聯嘉,20,5,15,富邦-新營,2024-09-19,9693
2349,錸德,14,1,13,富邦-新營,2024-09-19,9693
6530,創威,21,8,13,富邦-新營,2024-09-19,9693
00915,凱基優選高股息30,12,0,12,富邦-新營,2024-09-19,9693
00918,大華優利高填息30,12,1,11,富邦-新營,2024-09-19,9693
00892,富邦台灣半導體,10,0,10,富邦-新營,2024-09-19,9693
2062,橋椿,10,0,10,富邦-新營,2024-09-19,9693
2243,宏旭-KY,202,192,10,富邦-新營,2024-09-19,9693
2543,皇昌,10,0,10,富邦-新營,2024-09-19,9693
6151,晉倫,55,45,10,富邦-新營,2024-09-19,9693
6605,帝寶,10,0,10,富邦-新營,2024-09-19,9693
6215,和椿,14,5,9,富邦-新營,2024-09-19,9693
3324,雙鴻,14,5,9,富邦-新營,2024-09-19,9693
00857B,永豐20年美公債,8,0,8,富邦-新營,2024-09-19,9693
8070,長華*,13,5,8,富邦-新營,2024-09-19,9693
3360,尚立,10,2,8,富邦-新營,2024-09-19,9693
00706L,期元大S＆P日圓正2,7,0,7,富邦-新營,2024-09-19,9693
4950,牧東,7,0,7,富邦-新營,2024-09-19,9693
3017,奇鋐,9,3,6,富邦-新營,2024-09-19,9693
3062,建漢,32,26,6,富邦-新營,2024-09-19,9693
4188,安克,6,0,6,富邦-新營,2024-09-19,9693
6182,合晶,6,0,6,富邦-新營,2024-09-19,9693
6197,佳必琪,6,0,6,富邦-新營,2024-09-19,9693
6770,力積電,6,0,6,富邦-新營,2024-09-19,9693
1582,信錦,5,0,5,富邦-新營,2024-09-19,9693
1611,中電,5,0,5,富邦-新營,2024-09-19,9693
2838,聯邦銀,5,0,5,富邦-新營,2024-09-19,9693
3687,歐買尬,5,0,5,富邦-新營,2024-09-19,9693
6125,廣運,7,2,5,富邦-新營,2024-09-19,9693
8089,康全電訊,5,0,5,富邦-新營,2024-09-19,9693
9902,台火,5,0,5,富邦-新營,2024-09-19,9693
6869,雲豹能源,9,4,5,富邦-新營,2024-09-19,9693
00712,復華富時不動產,10,5,5,富邦-新營,2024-09-19,9693
2464,盟立,134,129,5,富邦-新營,2024-09-19,9693
2337,旺宏,4,0,4,富邦-新營,2024-09-19,9693
3023,信邦,4,0,4,富邦-新營,2024-09-19,9693
3363,上詮,6,2,4,富邦-新營,2024-09-19,9693
2891,中信金,7,4,3,富邦-新營,2024-09-19,9693
2025,千興,3,0,3,富邦-新營,2024-09-19,9693
00919,群益台灣精選高息,136,5,131,富邦-新營,2024-09-20,9693
00958B,永豐ESG銀行債15,91,0,91,富邦-新營,2024-09-20,9693
2888,新光金,95,20,75,富邦-新營,2024-09-20,9693
00948B,中信優息投資級債,58,5,53,富邦-新營,2024-09-20,9693
00878,國泰永續高股息,103,56,47,富邦-新營,2024-09-20,9693
00918,大華優利高填息30,44,3,41,富邦-新營,2024-09-20,9693
00679B,元大美債20年,41,0,41,富邦-新營,2024-09-20,9693
3322,建舜電,32,4,28,富邦-新營,2024-09-20,9693
2889,國票金,27,0,27,富邦-新營,2024-09-20,9693
6016,康和證,25,0,25,富邦-新營,2024-09-20,9693
5905,南仁湖,35,11,24,富邦-新營,2024-09-20,9693
4513,福裕,59,38,21,富邦-新營,2024-09-20,9693
4950,牧東,20,0,20,富邦-新營,2024-09-20,9693
6015,宏遠證,20,0,20,富邦-新營,2024-09-20,9693
2838,聯邦銀,19,0,19,富邦-新營,2024-09-20,9693
00929,復華台灣科技優息,20,1,19,富邦-新營,2024-09-20,9693
00915,凱基優選高股息30,18,0,18,富邦-新營,2024-09-20,9693
1584,精剛,18,0,18,富邦-新營,2024-09-20,9693
00641R,富邦日本反1,17,0,17,富邦-新營,2024-09-20,9693
2542,興富發,16,0,16,富邦-新營,2024-09-20,9693
1721,三晃,27,12,15,富邦-新營,2024-09-20,9693
4510,高鋒,32,17,15,富邦-新營,2024-09-20,9693
1785,光洋科,34,19,15,富邦-新營,2024-09-20,9693
1773,勝一,20,6,14,富邦-新營,2024-09-20,9693
3062,建漢,43,30,13,富邦-新營,2024-09-20,9693
3430,奇鈦科,21,8,13,富邦-新營,2024-09-20,9693
00687B,國泰20年美債,20,9,11,富邦-新營,2024-09-20,9693
9945,潤泰新,17,6,11,富邦-新營,2024-09-20,9693
3303,岱稜,30,19,11,富邦-新營,2024-09-20,9693
4977,眾達-KY,15,4,11,富邦-新營,2024-09-20,9693
2887,台新金,10,0,10,富邦-新營,2024-09-20,9693
020038,元大ESG配息N,10,0,10,富邦-新營,2024-09-20,9693
2312,金寶,10,0,10,富邦-新營,2024-09-20,9693
2820,華票,10,0,10,富邦-新營,2024-09-20,9693
2845,遠東銀,10,0,10,富邦-新營,2024-09-20,9693
3081,聯亞,26,16,10,富邦-新營,2024-09-20,9693
3511,矽瑪,11,1,10,富邦-新營,2024-09-20,9693
4188,安克,10,0,10,富邦-新營,2024-09-20,9693
6026,福邦證,10,0,10,富邦-新營,2024-09-20,9693
6191,精成科,11,1,10,富邦-新營,2024-09-20,9693
1101,台泥,10,1,9,富邦-新營,2024-09-20,9693
00900,富邦特選高股息30,9,0,9,富邦-新營,2024-09-20,9693
3550,聯穎,16,7,9,富邦-新營,2024-09-20,9693
2449,京元電子,8,0,8,富邦-新營,2024-09-20,9693
00632R,元大台灣50反1,8,0,8,富邦-新營,2024-09-20,9693
3594,磐儀,8,0,8,富邦-新營,2024-09-20,9693
3149,正達,9,2,7,富邦-新營,2024-09-20,9693
00633L,富邦上証正2,9,2,7,富邦-新營,2024-09-20,9693
2609,陽明,16,10,6,富邦-新營,2024-09-20,9693
2348,海悅,6,0,6,富邦-新營,2024-09-20,9693
3689,湧德,80,1,79,富邦-新營,2024-09-23,9693
00937B,群益ESG投等債20,99,30,69,富邦-新營,2024-09-23,9693
1721,三晃,260,212,48,富邦-新營,2024-09-23,9693
00919,群益台灣精選高息,54,9,45,富邦-新營,2024-09-23,9693
4510,高鋒,28,2,26,富邦-新營,2024-09-23,9693
3312,弘憶股,23,0,23,富邦-新營,2024-09-23,9693
5474,聰泰,21,0,21,富邦-新營,2024-09-23,9693
00687B,國泰20年美債,19,0,19,富邦-新營,2024-09-23,9693
00929,復華台灣科技優息,32,16,16,富邦-新營,2024-09-23,9693
1326,台化,15,0,15,富邦-新營,2024-09-23,9693
2344,華邦電,15,0,15,富邦-新營,2024-09-23,9693
1319,東陽,16,1,15,富邦-新營,2024-09-23,9693
3481,群創,78,64,14,富邦-新營,2024-09-23,9693
1711,永光,45,31,14,富邦-新營,2024-09-23,9693
3189,景碩,15,1,14,富邦-新營,2024-09-23,9693
00918,大華優利高填息30,14,0,14,富邦-新營,2024-09-23,9693
4563,百德,12,1,11,富邦-新營,2024-09-23,9693
8021,尖點,12,1,11,富邦-新營,2024-09-23,9693
00662,富邦NASDAQ,10,0,10,富邦-新營,2024-09-23,9693
00949,復華日本龍頭,10,0,10,富邦-新營,2024-09-23,9693
1215,卜蜂,10,0,10,富邦-新營,2024-09-23,9693
1718,中纖,10,0,10,富邦-新營,2024-09-23,9693
1904,正隆,10,0,10,富邦-新營,2024-09-23,9693
2399,映泰,29,19,10,富邦-新營,2024-09-23,9693
2495,普安,16,6,10,富邦-新營,2024-09-23,9693
3501,維熹,10,0,10,富邦-新營,2024-09-23,9693
5371,中光電,10,0,10,富邦-新營,2024-09-23,9693
2613,中櫃,10,1,9,富邦-新營,2024-09-23,9693
2834,臺企銀,10,2,8,富邦-新營,2024-09-23,9693
00931B,統一美債20年,12,5,7,富邦-新營,2024-09-23,9693
2885,元大金,8,1,7,富邦-新營,2024-09-23,9693
5213,亞昕,8,1,7,富邦-新營,2024-09-23,9693
6548,長科*,11,4,7,富邦-新營,2024-09-23,9693
6770,力積電,10,3,7,富邦-新營,2024-09-23,9693
1727,中華化,7,1,6,富邦-新營,2024-09-23,9693
2425,承啟,16,10,6,富邦-新營,2024-09-23,9693
3230,錦明,8,2,6,富邦-新營,2024-09-23,9693
4542,科嶠,11,5,6,富邦-新營,2024-09-23,9693
2385,群光,6,0,6,富邦-新營,2024-09-23,9693
2838,聯邦銀,5,0,5,富邦-新營,2024-09-23,9693
00650L,復華香港正2,20,15,5,富邦-新營,2024-09-23,9693
00958B,永豐ESG銀行債15,5,0,5,富邦-新營,2024-09-23,9693
3234,光環,5,0,5,富邦-新營,2024-09-23,9693
3580,友威科,10,5,5,富邦-新營,2024-09-23,9693
6114,久威,7,2,5,富邦-新營,2024-09-23,9693
8112,至上,6,1,5,富邦-新營,2024-09-23,9693
4707,磐亞,5,1,4,富邦-新營,2024-09-23,9693
2070,精湛,9,5,4,富邦-新營,2024-09-23,9693
1785,光洋科,9,5,4,富邦-新營,2024-09-23,9693
00795B,中信美國公債20年,4,0,4,富邦-新營,2024-09-23,9693
3013,晟銘電,127,13,114,富邦-新營,2024-09-24,9693
00937B,群益ESG投等債20,312,200,112,富邦-新營,2024-09-24,9693
00664R,國泰臺灣加權反1,100,0,100,富邦-新營,2024-09-24,9693
00680L,元大美債20正2,50,20,30,富邦-新營,2024-09-24,9693
2349,錸德,57,31,26,富邦-新營,2024-09-24,9693
1316,上曜,22,0,22,富邦-新營,2024-09-24,9693
2337,旺宏,20,0,20,富邦-新營,2024-09-24,9693
4716,大立,24,4,20,富邦-新營,2024-09-24,9693
5474,聰泰,19,0,19,富邦-新營,2024-09-24,9693
3481,群創,20,2,18,富邦-新營,2024-09-24,9693
3705,永信,17,1,16,富邦-新營,2024-09-24,9693
00948B,中信優息投資級債,15,0,15,富邦-新營,2024-09-24,9693
2241,艾姆勒,35,20,15,富邦-新營,2024-09-24,9693
3715,定穎投控,86,72,14,富邦-新營,2024-09-24,9693
00929,復華台灣科技優息,24,12,12,富邦-新營,2024-09-24,9693
2891,中信金,16,4,12,富邦-新營,2024-09-24,9693
00942B,台新美A公司債20+,12,0,12,富邦-新營,2024-09-24,9693
9105,泰金寶-DR,20,8,12,富邦-新營,2024-09-24,9693
3149,正達,28,17,11,富邦-新營,2024-09-24,9693
8043,蜜望實,14,3,11,富邦-新營,2024-09-24,9693
9927,泰銘,11,0,11,富邦-新營,2024-09-24,9693
00795B,中信美國公債20年,10,0,10,富邦-新營,2024-09-24,9693
00931B,統一美債20年,10,0,10,富邦-新營,2024-09-24,9693
4956,光鋐,10,0,10,富邦-新營,2024-09-24,9693
00632R,元大台灣50反1,9,0,9,富邦-新營,2024-09-24,9693
5432,新門,9,0,9,富邦-新營,2024-09-24,9693
8070,長華*,21,12,9,富邦-新營,2024-09-24,9693
3374,精材,9,1,8,富邦-新營,2024-09-24,9693
1314,中石化,8,0,8,富邦-新營,2024-09-24,9693
8089,康全電訊,10,2,8,富邦-新營,2024-09-24,9693
5905,南仁湖,21,14,7,富邦-新營,2024-09-24,9693
2356,英業達,7,0,7,富邦-新營,2024-09-24,9693
5523,豐謙,7,0,7,富邦-新營,2024-09-24,9693
2537,聯上發,6,0,6,富邦-新營,2024-09-24,9693
5460,同協,11,5,6,富邦-新營,2024-09-24,9693
6156,松上,10,4,6,富邦-新營,2024-09-24,9693
6257,矽格,9,3,6,富邦-新營,2024-09-24,9693
6548,長科*,6,0,6,富邦-新營,2024-09-24,9693
6505,台塑化,5,0,5,富邦-新營,2024-09-24,9693
00688L,國泰20年美債正2,5,0,5,富邦-新營,2024-09-24,9693
00945B,凱基美國非投等債,5,0,5,富邦-新營,2024-09-24,9693
2352,佳世達,5,0,5,富邦-新營,2024-09-24,9693
2515,中工,5,0,5,富邦-新營,2024-09-24,9693
3322,建舜電,5,0,5,富邦-新營,2024-09-24,9693
3360,尚立,5,0,5,富邦-新營,2024-09-24,9693
6506,雙邦,5,0,5,富邦-新營,2024-09-24,9693
6570,維田,5,0,5,富邦-新營,2024-09-24,9693
8466,美吉吉-KY,5,0,5,富邦-新營,2024-09-24,9693
4707,磐亞,5,0,5,富邦-新營,2024-09-24,9693
6873,泓德能源,5,0,5,富邦-新營,2024-09-24,9693
2888,新光金,500,2,498,富邦-新營,2024-09-25,9693
00680L,元大美債20正2,260,1,259,富邦-新營,2024-09-25,9693
3481,群創,106,0,106,富邦-新營,2024-09-25,9693
00650L,復華香港正2,117,21,96,富邦-新營,2024-09-25,9693
00937B,群益ESG投等債20,62,1,61,富邦-新營,2024-09-25,9693
6873,泓德能源,63,5,58,富邦-新營,2024-09-25,9693
1904,正隆,54,0,54,富邦-新營,2024-09-25,9693
0056,元大高股息,52,2,50,富邦-新營,2024-09-25,9693
1608,華榮,50,1,49,富邦-新營,2024-09-25,9693
00665L,富邦�琤肭磪囓�2,120,75,45,富邦-新營,2024-09-25,9693
2014,中鴻,60,15,45,富邦-新營,2024-09-25,9693
00664R,國泰臺灣加權反1,37,0,37,富邦-新營,2024-09-25,9693
00632R,元大台灣50反1,33,0,33,富邦-新營,2024-09-25,9693
00725B,國泰投資級公司債,30,0,30,富邦-新營,2024-09-25,9693
2399,映泰,29,1,28,富邦-新營,2024-09-25,9693
00679B,元大美債20年,36,10,26,富邦-新營,2024-09-25,9693
3714,富采,28,2,26,富邦-新營,2024-09-25,9693
2353,宏��,23,1,22,富邦-新營,2024-09-25,9693
1612,宏泰,20,0,20,富邦-新營,2024-09-25,9693
00720B,元大投資級公司債,19,0,19,富邦-新營,2024-09-25,9693
3045,台灣大,18,0,18,富邦-新營,2024-09-25,9693
00633L,富邦上証正2,20,2,18,富邦-新營,2024-09-25,9693
00687B,國泰20年美債,20,4,16,富邦-新營,2024-09-25,9693
2241,艾姆勒,30,15,15,富邦-新營,2024-09-25,9693
2009,第一銅,25,12,13,富邦-新營,2024-09-25,9693
6530,創威,10,0,10,富邦-新營,2024-09-25,9693
912000,晨訊科-DR,10,0,10,富邦-新營,2024-09-25,9693
00795B,中信美國公債20年,9,0,9,富邦-新營,2024-09-25,9693
1417,嘉裕,9,0,9,富邦-新營,2024-09-25,9693
2323,中環,10,1,9,富邦-新營,2024-09-25,9693
6548,長科*,18,10,8,富邦-新營,2024-09-25,9693
00945B,凱基美國非投等債,8,0,8,富邦-新營,2024-09-25,9693
3550,聯穎,49,41,8,富邦-新營,2024-09-25,9693
4729,熒茂,8,0,8,富邦-新營,2024-09-25,9693
1584,精剛,11,3,8,富邦-新營,2024-09-25,9693
1301,台塑,13,5,8,富邦-新營,2024-09-25,9693
1319,東陽,7,0,7,富邦-新營,2024-09-25,9693
2618,長榮航,9,2,7,富邦-新營,2024-09-25,9693
5202,力新,7,0,7,富邦-新營,2024-09-25,9693
2542,興富發,7,1,6,富邦-新營,2024-09-25,9693
3593,力銘,6,0,6,富邦-新營,2024-09-25,9693
4538,大詠城,6,0,6,富邦-新營,2024-09-25,9693
5371,中光電,6,0,6,富邦-新營,2024-09-25,9693
6147,頎邦,6,0,6,富邦-新營,2024-09-25,9693
2867,三商壽,5,0,5,富邦-新營,2024-09-25,9693
1522,堤維西,5,0,5,富邦-新營,2024-09-25,9693
2354,鴻準,5,0,5,富邦-新營,2024-09-25,9693
2641,正德,7,2,5,富邦-新營,2024-09-25,9693
2855,統一證,5,0,5,富邦-新營,2024-09-25,9693
3085,新零售,5,0,5,富邦-新營,2024-09-25,9693
00632R,元大台灣50反1,482,0,482,富邦-新營,2024-09-26,9693
00937B,群益ESG投等債20,213,10,203,富邦-新營,2024-09-26,9693
00637L,元大滬深300正2,150,18,132,富邦-新營,2024-09-26,9693
8111,立��,94,20,74,富邦-新營,2024-09-26,9693
00680L,元大美債20正2,70,0,70,富邦-新營,2024-09-26,9693
00706L,期元大S＆P日圓正2,57,0,57,富邦-新營,2024-09-26,9693
00679B,元大美債20年,55,0,55,富邦-新營,2024-09-26,9693
00676R,富邦臺灣加權反1,40,0,40,富邦-新營,2024-09-26,9693
00687B,國泰20年美債,51,13,38,富邦-新營,2024-09-26,9693
2883,凱基金,40,6,34,富邦-新營,2024-09-26,9693
00945B,凱基美國非投等債,33,0,33,富邦-新營,2024-09-26,9693
2312,金寶,211,179,32,富邦-新營,2024-09-26,9693
00725B,國泰投資級公司債,21,0,21,富邦-新營,2024-09-26,9693
00712,復華富時不動產,22,1,21,富邦-新營,2024-09-26,9693
00720B,元大投資級公司債,20,0,20,富邦-新營,2024-09-26,9693
1718,中纖,20,0,20,富邦-新營,2024-09-26,9693
1101,台泥,20,3,17,富邦-新營,2024-09-26,9693
4128,中天,20,3,17,富邦-新營,2024-09-26,9693
8429,金麗-KY,19,3,16,富邦-新營,2024-09-26,9693
00915,凱基優選高股息30,21,6,15,富邦-新營,2024-09-26,9693
00960,野村全球航運龍頭,41,26,15,富邦-新營,2024-09-26,9693
1540,喬福,33,20,13,富邦-新營,2024-09-26,9693
2349,錸德,15,3,12,富邦-新營,2024-09-26,9693
2542,興富發,12,0,12,富邦-新營,2024-09-26,9693
2365,昆盈,11,1,10,富邦-新營,2024-09-26,9693
00648R,元大S＆P500反1,10,0,10,富邦-新營,2024-09-26,9693
1709,和益,10,0,10,富邦-新營,2024-09-26,9693
3046,建��,10,0,10,富邦-新營,2024-09-26,9693
3264,欣銓,10,0,10,富邦-新營,2024-09-26,9693
5474,聰泰,10,0,10,富邦-新營,2024-09-26,9693
5871,中租-KY,10,0,10,富邦-新營,2024-09-26,9693
2495,普安,11,2,9,富邦-新營,2024-09-26,9693
3605,宏致,29,20,9,富邦-新營,2024-09-26,9693
4542,科嶠,10,1,9,富邦-新營,2024-09-26,9693
2317,鴻海,25,17,8,富邦-新營,2024-09-26,9693
00795B,中信美國公債20年,8,0,8,富邦-新營,2024-09-26,9693
2399,映泰,14,6,8,富邦-新營,2024-09-26,9693
8074,鉅橡,8,0,8,富邦-新營,2024-09-26,9693
3324,雙鴻,26,18,8,富邦-新營,2024-09-26,9693
2382,廣達,11,3,8,富邦-新營,2024-09-26,9693
4510,高鋒,10,3,7,富邦-新營,2024-09-26,9693
4743,合一,9,2,7,富邦-新營,2024-09-26,9693
5213,亞昕,7,0,7,富邦-新營,2024-09-26,9693
00715L,期街口布蘭特正2,6,0,6,富邦-新營,2024-09-26,9693
1815,富喬,7,1,6,富邦-新營,2024-09-26,9693
2426,鼎元,6,0,6,富邦-新營,2024-09-26,9693
3047,訊舟,6,0,6,富邦-新營,2024-09-26,9693
3086,華義,6,0,6,富邦-新營,2024-09-26,9693
9105,泰金寶-DR,6,0,6,富邦-新營,2024-09-26,9693
5347,世界,6,0,6,富邦-新營,2024-09-26,9693
00632R,元大台灣50反1,273,0,273,富邦-新營,2024-09-27,9693
00680L,元大美債20正2,271,0,271,富邦-新營,2024-09-27,9693
00706L,期元大S＆P日圓正2,215,0,215,富邦-新營,2024-09-27,9693
00933B,國泰10Y+金融債,194,4,190,富邦-新營,2024-09-27,9693
1301,台塑,145,14,131,富邦-新營,2024-09-27,9693
00937B,群益ESG投等債20,78,2,76,富邦-新營,2024-09-27,9693
00679B,元大美債20年,70,6,64,富邦-新營,2024-09-27,9693
4716,大立,110,50,60,富邦-新營,2024-09-27,9693
00687B,國泰20年美債,54,3,51,富邦-新營,2024-09-27,9693
00960,野村全球航運龍頭,53,3,50,富邦-新營,2024-09-27,9693
00887,永豐中國科技50大,50,0,50,富邦-新營,2024-09-27,9693
00945B,凱基美國非投等債,47,0,47,富邦-新營,2024-09-27,9693
00715L,期街口布蘭特正2,43,0,43,富邦-新營,2024-09-27,9693
2241,艾姆勒,106,75,31,富邦-新營,2024-09-27,9693
8249,菱光,29,0,29,富邦-新營,2024-09-27,9693
00882,中信中國高股息,55,29,26,富邦-新營,2024-09-27,9693
6182,合晶,25,0,25,富邦-新營,2024-09-27,9693
3481,群創,70,46,24,富邦-新營,2024-09-27,9693
2363,矽統,44,21,23,富邦-新營,2024-09-27,9693
2891,中信金,24,3,21,富邦-新營,2024-09-27,9693
3390,旭軟,21,0,21,富邦-新營,2024-09-27,9693
00637L,元大滬深300正2,30,10,20,富邦-新營,2024-09-27,9693
1310,台苯,20,0,20,富邦-新營,2024-09-27,9693
4906,正文,20,0,20,富邦-新營,2024-09-27,9693
00915,凱基優選高股息30,25,5,20,富邦-新營,2024-09-27,9693
5475,德宏,19,0,19,富邦-新營,2024-09-27,9693
2609,陽明,162,144,18,富邦-新營,2024-09-27,9693
3021,鴻名,20,2,18,富邦-新營,2024-09-27,9693
2303,聯電,21,4,17,富邦-新營,2024-09-27,9693
2495,普安,15,0,15,富邦-新營,2024-09-27,9693
2323,中環,15,1,14,富邦-新營,2024-09-27,9693
2349,錸德,31,17,14,富邦-新營,2024-09-27,9693
00642U,期元大S＆P石油,11,0,11,富邦-新營,2024-09-27,9693
00671R,富邦NASDAQ反1,10,0,10,富邦-新營,2024-09-27,9693
1515,力山,10,0,10,富邦-新營,2024-09-27,9693
5392,能率,10,0,10,富邦-新營,2024-09-27,9693
9105,泰金寶-DR,10,0,10,富邦-新營,2024-09-27,9693
1336,台翰,10,0,10,富邦-新營,2024-09-27,9693
00725B,國泰投資級公司債,10,1,9,富邦-新營,2024-09-27,9693
1815,富喬,10,1,9,富邦-新營,2024-09-27,9693
2388,威盛,14,5,9,富邦-新營,2024-09-27,9693
3550,聯穎,8,0,8,富邦-新營,2024-09-27,9693
5347,世界,7,0,7,富邦-新營,2024-09-27,9693
4566,時碩工業,7,0,7,富邦-新營,2024-09-27,9693
6838,台新藥,7,0,7,富邦-新營,2024-09-27,9693
2542,興富發,7,0,7,富邦-新營,2024-09-27,9693
3017,奇鋐,9,3,6,富邦-新營,2024-09-27,9693
00650L,復華香港正2,10,4,6,富邦-新營,2024-09-27,9693
00949,復華日本龍頭,10,4,6,富邦-新營,2024-09-27,9693
2641,正德,12,6,6,富邦-新營,2024-09-27,9693
00937B,群益ESG投等債20,180,30,150,富邦-新營,2024-09-30,9693
00960,野村全球航運龍頭,108,0,108,富邦-新營,2024-09-30,9693
1904,正隆,105,2,103,富邦-新營,2024-09-30,9693
00680L,元大美債20正2,98,0,98,富邦-新營,2024-09-30,9693
00919,群益台灣精選高息,106,9,97,富邦-新營,2024-09-30,9693
00929,復華台灣科技優息,103,12,91,富邦-新營,2024-09-30,9693
00830,國泰費城半導體,63,0,63,富邦-新營,2024-09-30,9693
2495,普安,55,0,55,富邦-新營,2024-09-30,9693
00892,富邦台灣半導體,50,0,50,富邦-新營,2024-09-30,9693
00715L,期街口布蘭特正2,50,0,50,富邦-新營,2024-09-30,9693
2610,華航,45,1,44,富邦-新營,2024-09-30,9693
2605,新興,59,19,40,富邦-新營,2024-09-30,9693
1314,中石化,35,0,35,富邦-新營,2024-09-30,9693
00671R,富邦NASDAQ反1,30,0,30,富邦-新營,2024-09-30,9693
2241,艾姆勒,108,83,25,富邦-新營,2024-09-30,9693
00637L,元大滬深300正2,33,9,24,富邦-新營,2024-09-30,9693
00687B,國泰20年美債,23,0,23,富邦-新營,2024-09-30,9693
00905,FT臺灣Smart,22,0,22,富邦-新營,2024-09-30,9693
00669R,國泰美國道瓊反1,20,0,20,富邦-新營,2024-09-30,9693
00900,富邦特選高股息30,20,0,20,富邦-新營,2024-09-30,9693
3322,建舜電,20,0,20,富邦-新營,2024-09-30,9693
1336,台翰,18,0,18,富邦-新營,2024-09-30,9693
4906,正文,17,0,17,富邦-新營,2024-09-30,9693
6806,森崴能源,17,0,17,富邦-新營,2024-09-30,9693
00878,國泰永續高股息,23,7,16,富邦-新營,2024-09-30,9693
2603,長榮,17,1,16,富邦-新營,2024-09-30,9693
00945B,凱基美國非投等債,16,0,16,富邦-新營,2024-09-30,9693
00952,凱基台灣AI50,15,0,15,富邦-新營,2024-09-30,9693
5474,聰泰,15,0,15,富邦-新營,2024-09-30,9693
6016,康和證,15,0,15,富邦-新營,2024-09-30,9693
6026,福邦證,15,0,15,富邦-新營,2024-09-30,9693
2330,台積電,16,2,14,富邦-新營,2024-09-30,9693
2317,鴻海,16,2,14,富邦-新營,2024-09-30,9693
2609,陽明,135,121,14,富邦-新營,2024-09-30,9693
2303,聯電,14,1,13,富邦-新營,2024-09-30,9693
00934,中信成長高股息,13,0,13,富邦-新營,2024-09-30,9693
00930,永豐ESG低碳高息,12,0,12,富邦-新營,2024-09-30,9693
00712,復華富時不動產,12,0,12,富邦-新營,2024-09-30,9693
4743,合一,11,0,11,富邦-新營,2024-09-30,9693
00638R,元大滬深300反1,10,0,10,富邦-新營,2024-09-30,9693
1515,力山,10,0,10,富邦-新營,2024-09-30,9693
2371,大同,10,0,10,富邦-新營,2024-09-30,9693
3029,零壹,10,0,10,富邦-新營,2024-09-30,9693
8033,雷虎,10,0,10,富邦-新營,2024-09-30,9693
8049,晶采,9,0,9,富邦-新營,2024-09-30,9693
00918,大華優利高填息30,9,1,8,富邦-新營,2024-09-30,9693
2239,英利-KY,8,0,8,富邦-新營,2024-09-30,9693
00881,國泰台灣5G+,7,0,7,富邦-新營,2024-09-30,9693
2892,第一金,7,0,7,富邦-新營,2024-09-30,9693
00940,元大台灣價值高息,8,1,7,富邦-新營,2024-09-30,9693
00929,復華台灣科技優息,179,10,169,富邦-新營,2024-10-01,9693
00918,大華優利高填息30,103,0,103,富邦-新營,2024-10-01,9693
3481,群創,84,2,82,富邦-新營,2024-10-01,9693
1904,正隆,78,3,75,富邦-新營,2024-10-01,9693
1447,力鵬,60,0,60,富邦-新營,2024-10-01,9693
00706L,期元大S＆P日圓正2,38,0,38,富邦-新營,2024-10-01,9693
2241,艾姆勒,51,20,31,富邦-新營,2024-10-01,9693
00945B,凱基美國非投等債,30,0,30,富邦-新營,2024-10-01,9693
00878,國泰永續高股息,27,0,27,富邦-新營,2024-10-01,9693
00919,群益台灣精選高息,28,1,27,富邦-新營,2024-10-01,9693
1802,台玻,33,9,24,富邦-新營,2024-10-01,9693
0056,元大高股息,20,0,20,富邦-新營,2024-10-01,9693
00753L,中信中國50正2,19,0,19,富邦-新營,2024-10-01,9693
2888,新光金,20,2,18,富邦-新營,2024-10-01,9693
00680L,元大美債20正2,22,5,17,富邦-新營,2024-10-01,9693
4510,高鋒,16,0,16,富邦-新營,2024-10-01,9693
2388,威盛,56,41,15,富邦-新營,2024-10-01,9693
6805,富世達,15,0,15,富邦-新營,2024-10-01,9693
8429,金麗-KY,35,20,15,富邦-新營,2024-10-01,9693
00687B,國泰20年美債,14,0,14,富邦-新營,2024-10-01,9693
3588,通嘉,15,3,12,富邦-新營,2024-10-01,9693
2497,怡利電,15,3,12,富邦-新營,2024-10-01,9693
2344,華邦電,11,0,11,富邦-新營,2024-10-01,9693
1711,永光,14,3,11,富邦-新營,2024-10-01,9693
3324,雙鴻,28,17,11,富邦-新營,2024-10-01,9693
0050,元大台灣50,10,0,10,富邦-新營,2024-10-01,9693
00656R,國泰中國A50反1,10,0,10,富邦-新營,2024-10-01,9693
2852,第一保,10,0,10,富邦-新營,2024-10-01,9693
2867,三商壽,10,0,10,富邦-新營,2024-10-01,9693
3031,佰鴻,10,0,10,富邦-新營,2024-10-01,9693
5474,聰泰,10,0,10,富邦-新營,2024-10-01,9693
6005,群益證,10,0,10,富邦-新營,2024-10-01,9693
6118,建達,10,0,10,富邦-新營,2024-10-01,9693
8086,宏捷科,10,0,10,富邦-新營,2024-10-01,9693
2356,英業達,12,3,9,富邦-新營,2024-10-01,9693
3041,揚智,9,0,9,富邦-新營,2024-10-01,9693
2426,鼎元,8,0,8,富邦-新營,2024-10-01,9693
5432,新門,8,0,8,富邦-新營,2024-10-01,9693
2313,華通,9,1,8,富邦-新營,2024-10-01,9693
3094,聯傑,7,0,7,富邦-新營,2024-10-01,9693
1108,幸福,6,0,6,富邦-新營,2024-10-01,9693
1598,岱宇,6,0,6,富邦-新營,2024-10-01,9693
2231,為升,6,0,6,富邦-新營,2024-10-01,9693
6666,羅麗芬-KY,6,0,6,富邦-新營,2024-10-01,9693
00922,國泰台灣領袖50,6,0,6,富邦-新營,2024-10-01,9693
00891,中信關鍵半導體,6,0,6,富邦-新營,2024-10-01,9693
2615,萬海,115,110,5,富邦-新營,2024-10-01,9693
3374,精材,5,0,5,富邦-新營,2024-10-01,9693
1314,中石化,5,0,5,富邦-新營,2024-10-01,9693
2363,矽統,13,8,5,富邦-新營,2024-10-01,9693
00882,中信中國高股息,272,23,249,富邦-新營,2024-10-04,9693
4979,華星光,181,22,159,富邦-新營,2024-10-04,9693
00918,大華優利高填息30,117,15,102,富邦-新營,2024-10-04,9693
00940,元大台灣價值高息,74,0,74,富邦-新營,2024-10-04,9693
2884,玉山金,64,0,64,富邦-新營,2024-10-04,9693
2610,華航,60,0,60,富邦-新營,2024-10-04,9693
00753L,中信中國50正2,150,100,50,富邦-新營,2024-10-04,9693
1447,力鵬,41,0,41,富邦-新營,2024-10-04,9693
00706L,期元大S＆P日圓正2,30,0,30,富邦-新營,2024-10-04,9693
00929,復華台灣科技優息,76,46,30,富邦-新營,2024-10-04,9693
2834,臺企銀,29,0,29,富邦-新營,2024-10-04,9693
00680L,元大美債20正2,74,45,29,富邦-新營,2024-10-04,9693
2609,陽明,38,10,28,富邦-新營,2024-10-04,9693
2070,精湛,26,0,26,富邦-新營,2024-10-04,9693
2618,長榮航,28,3,25,富邦-新營,2024-10-04,9693
2615,萬海,27,5,22,富邦-新營,2024-10-04,9693
2303,聯電,20,0,20,富邦-新營,2024-10-04,9693
5474,聰泰,20,0,20,富邦-新營,2024-10-04,9693
00939,統一台灣高息動能,19,2,17,富邦-新營,2024-10-04,9693
2388,威盛,18,1,17,富邦-新營,2024-10-04,9693
8039,台虹,25,8,17,富邦-新營,2024-10-04,9693
2603,長榮,17,0,17,富邦-新營,2024-10-04,9693
1326,台化,18,2,16,富邦-新營,2024-10-04,9693
00931B,統一美債20年,15,0,15,富邦-新營,2024-10-04,9693
2607,榮運,14,0,14,富邦-新營,2024-10-04,9693
3094,聯傑,14,0,14,富邦-新營,2024-10-04,9693
00687B,國泰20年美債,13,0,13,富邦-新營,2024-10-04,9693
00679B,元大美債20年,21,10,11,富邦-新營,2024-10-04,9693
4532,瑞智,12,1,11,富邦-新營,2024-10-04,9693
2313,華通,10,0,10,富邦-新營,2024-10-04,9693
2241,艾姆勒,50,40,10,富邦-新營,2024-10-04,9693
3031,佰鴻,10,0,10,富邦-新營,2024-10-04,9693
3033,威健,10,0,10,富邦-新營,2024-10-04,9693
6761,穩得,10,0,10,富邦-新營,2024-10-04,9693
8112,至上,10,0,10,富邦-新營,2024-10-04,9693
2613,中櫃,10,1,9,富邦-新營,2024-10-04,9693
00933B,國泰10Y+金融債,10,1,9,富邦-新營,2024-10-04,9693
00752,中信中國50,22,13,9,富邦-新營,2024-10-04,9693
6223,旺矽,15,7,8,富邦-新營,2024-10-04,9693
8111,立��,13,5,8,富邦-新營,2024-10-04,9693
2383,台光電,8,1,7,富邦-新營,2024-10-04,9693
00632R,元大台灣50反1,7,0,7,富邦-新營,2024-10-04,9693
00638R,元大滬深300反1,7,0,7,富邦-新營,2024-10-04,9693
00960,野村全球航運龍頭,9,2,7,富邦-新營,2024-10-04,9693
1742,台蠟,9,2,7,富邦-新營,2024-10-04,9693
2354,鴻準,7,0,7,富邦-新營,2024-10-04,9693
8150,南茂,7,0,7,富邦-新營,2024-10-04,9693
8249,菱光,16,9,7,富邦-新營,2024-10-04,9693
00712,復華富時不動產,8,2,6,富邦-新營,2024-10-04,9693
00952,凱基台灣AI50,6,0,6,富邦-新營,2024-10-04,9693
3049,精金,1303,1058,245,富邦-新營,2024-10-07,9693
00637L,元大滬深300正2,247,82,165,富邦-新營,2024-10-07,9693
00706L,期元大S＆P日圓正2,82,0,82,富邦-新營,2024-10-07,9693
1314,中石化,77,1,76,富邦-新營,2024-10-07,9693
4563,百德,270,216,54,富邦-新營,2024-10-07,9693
9105,泰金寶-DR,50,0,50,富邦-新營,2024-10-07,9693
2610,華航,38,0,38,富邦-新營,2024-10-07,9693
00752,中信中國50,38,3,35,富邦-新營,2024-10-07,9693
00927,群益半導體收益,26,0,26,富邦-新營,2024-10-07,9693
00902,中信電池及儲能,24,0,24,富邦-新營,2024-10-07,9693
00878,國泰永續高股息,23,1,22,富邦-新營,2024-10-07,9693
00918,大華優利高填息30,21,0,21,富邦-新營,2024-10-07,9693
2615,萬海,41,21,20,富邦-新營,2024-10-07,9693
2313,華通,22,2,20,富邦-新營,2024-10-07,9693
6719,力智,19,0,19,富邦-新營,2024-10-07,9693
2312,金寶,51,35,16,富邦-新營,2024-10-07,9693
6530,創威,24,8,16,富邦-新營,2024-10-07,9693
00650L,復華香港正2,26,12,14,富邦-新營,2024-10-07,9693
3041,揚智,22,8,14,富邦-新營,2024-10-07,9693
2515,中工,25,12,13,富邦-新營,2024-10-07,9693
1532,勤美,13,0,13,富邦-新營,2024-10-07,9693
6016,康和證,13,0,13,富邦-新營,2024-10-07,9693
00712,復華富時不動產,12,0,12,富邦-新營,2024-10-07,9693
00679B,元大美債20年,13,1,12,富邦-新營,2024-10-07,9693
1303,南亞,11,0,11,富邦-新營,2024-10-07,9693
3322,建舜電,12,1,11,富邦-新營,2024-10-07,9693
6151,晉倫,11,0,11,富邦-新營,2024-10-07,9693
6550,北極星藥業-KY,11,0,11,富邦-新營,2024-10-07,9693
2101,南港,10,0,10,富邦-新營,2024-10-07,9693
00950B,凱基A級公司債,10,0,10,富邦-新營,2024-10-07,9693
00953B,群益優選非投等債,10,0,10,富邦-新營,2024-10-07,9693
1904,正隆,10,0,10,富邦-新營,2024-10-07,9693
2344,華邦電,10,0,10,富邦-新營,2024-10-07,9693
2613,中櫃,10,0,10,富邦-新營,2024-10-07,9693
4526,東台,11,1,10,富邦-新營,2024-10-07,9693
5701,劍湖山,10,0,10,富邦-新營,2024-10-07,9693
6156,松上,10,0,10,富邦-新營,2024-10-07,9693
3025,星通,140,130,10,富邦-新營,2024-10-07,9693
3591,艾笛森,8,0,8,富邦-新營,2024-10-07,9693
6218,豪勉,12,4,8,富邦-新營,2024-10-07,9693
00688L,國泰20年美債正2,7,0,7,富邦-新營,2024-10-07,9693
2412,中華電,7,0,7,富邦-新營,2024-10-07,9693
6695,芯鼎,7,0,7,富邦-新營,2024-10-07,9693
6706,惠特,7,0,7,富邦-新營,2024-10-07,9693
6753,龍德造船,7,0,7,富邦-新營,2024-10-07,9693
1702,南僑,10,3,7,富邦-新營,2024-10-07,9693
0056,元大高股息,10,3,7,富邦-新營,2024-10-07,9693
2408,南亞科,6,0,6,富邦-新營,2024-10-07,9693
00725B,國泰投資級公司債,6,0,6,富邦-新營,2024-10-07,9693
00645,富邦日本,5,0,5,富邦-新營,2024-10-07,9693
00637L,元大滬深300正2,233,157,76,富邦-新營,2024-10-08,9693
2892,第一金,61,0,61,富邦-新營,2024-10-08,9693
00633L,富邦上証正2,88,29,59,富邦-新營,2024-10-08,9693
1314,中石化,91,34,57,富邦-新營,2024-10-08,9693
9105,泰金寶-DR,62,7,55,富邦-新營,2024-10-08,9693
00922,國泰台灣領袖50,54,0,54,富邦-新營,2024-10-08,9693
00937B,群益ESG投等債20,53,0,53,富邦-新營,2024-10-08,9693
9136,巨騰-DR,50,0,50,富邦-新營,2024-10-08,9693
00919,群益台灣精選高息,46,0,46,富邦-新營,2024-10-08,9693
2610,華航,45,0,45,富邦-新營,2024-10-08,9693
00940,元大台灣價值高息,49,7,42,富邦-新營,2024-10-08,9693
3081,聯亞,40,4,36,富邦-新營,2024-10-08,9693
0056,元大高股息,39,6,33,富邦-新營,2024-10-08,9693
00929,復華台灣科技優息,53,20,33,富邦-新營,2024-10-08,9693
3149,正達,50,20,30,富邦-新營,2024-10-08,9693
00752,中信中國50,32,6,26,富邦-新營,2024-10-08,9693
2425,承啟,49,26,23,富邦-新營,2024-10-08,9693
2515,中工,23,0,23,富邦-新營,2024-10-08,9693
2801,彰銀,20,0,20,富邦-新營,2024-10-08,9693
3260,威剛,20,0,20,富邦-新營,2024-10-08,9693
00946,群益科技高息成長,19,0,19,富邦-新營,2024-10-08,9693
2399,映泰,399,380,19,富邦-新營,2024-10-08,9693
00679B,元大美債20年,25,6,19,富邦-新營,2024-10-08,9693
00680L,元大美債20正2,18,0,18,富邦-新營,2024-10-08,9693
00706L,期元大S＆P日圓正2,16,0,16,富邦-新營,2024-10-08,9693
2886,兆豐金,16,0,16,富邦-新營,2024-10-08,9693
2104,國際中橡,15,0,15,富邦-新營,2024-10-08,9693
00713,元大台灣高息低波,14,0,14,富邦-新營,2024-10-08,9693
00688L,國泰20年美債正2,15,3,12,富邦-新營,2024-10-08,9693
2371,大同,12,0,12,富邦-新營,2024-10-08,9693
3607,谷崧,12,0,12,富邦-新營,2024-10-08,9693
6443,元晶,12,0,12,富邦-新營,2024-10-08,9693
00712,復華富時不動產,13,2,11,富邦-新營,2024-10-08,9693
2313,華通,16,5,11,富邦-新營,2024-10-08,9693
2356,英業達,11,0,11,富邦-新營,2024-10-08,9693
1727,中華化,12,1,11,富邦-新營,2024-10-08,9693
2881,富邦金,11,0,11,富邦-新營,2024-10-08,9693
3163,波若威,17,7,10,富邦-新營,2024-10-08,9693
00915,凱基優選高股息30,10,0,10,富邦-新營,2024-10-08,9693
00950B,凱基A級公司債,10,0,10,富邦-新營,2024-10-08,9693
1806,冠軍,10,0,10,富邦-新營,2024-10-08,9693
8249,菱光,11,1,10,富邦-新營,2024-10-08,9693
0050,元大台灣50,11,1,10,富邦-新營,2024-10-08,9693
4956,光鋐,10,1,9,富邦-新營,2024-10-08,9693
00953B,群益優選非投等債,10,1,9,富邦-新營,2024-10-08,9693
4903,聯光通,33,24,9,富邦-新營,2024-10-08,9693
00934,中信成長高股息,8,0,8,富邦-新營,2024-10-08,9693
5443,均豪,16,8,8,富邦-新營,2024-10-08,9693
6530,創威,53,45,8,富邦-新營,2024-10-08,9693
00958B,永豐ESG銀行債15,7,0,7,富邦-新營,2024-10-08,9693
00687B,國泰20年美債,140,0,140,富邦-新營,2024-10-09,9693
2892,第一金,116,0,116,富邦-新營,2024-10-09,9693
00753L,中信中國50正2,115,14,101,富邦-新營,2024-10-09,9693
1314,中石化,108,11,97,富邦-新營,2024-10-09,9693
00637L,元大滬深300正2,157,85,72,富邦-新營,2024-10-09,9693
00665L,富邦�琤肭磪囓�2,181,121,60,富邦-新營,2024-10-09,9693
00937B,群益ESG投等債20,59,0,59,富邦-新營,2024-10-09,9693
3481,群創,31,0,31,富邦-新營,2024-10-09,9693
1718,中纖,30,0,30,富邦-新營,2024-10-09,9693
00918,大華優利高填息30,29,0,29,富邦-新營,2024-10-09,9693
6770,力積電,28,2,26,富邦-新營,2024-10-09,9693
00679B,元大美債20年,23,2,21,富邦-新營,2024-10-09,9693
1316,上曜,22,1,21,富邦-新營,2024-10-09,9693
2388,威盛,24,3,21,富邦-新營,2024-10-09,9693
1409,新纖,20,0,20,富邦-新營,2024-10-09,9693
3483,力致,19,0,19,富邦-新營,2024-10-09,9693
00919,群益台灣精選高息,18,1,17,富邦-新營,2024-10-09,9693
6187,萬潤,24,6,18,富邦-新營,2024-10-09,9693
3322,建舜電,16,0,16,富邦-新營,2024-10-09,9693
5871,中租-KY,15,0,15,富邦-新營,2024-10-09,9693
5236,凌陽創新,15,0,15,富邦-新營,2024-10-09,9693
6279,胡連,18,3,15,富邦-新營,2024-10-09,9693
2486,一詮,33,18,15,富邦-新營,2024-10-09,9693
3048,益登,16,2,14,富邦-新營,2024-10-09,9693
00650L,復華香港正2,14,0,14,富邦-新營,2024-10-09,9693
00712,復華富時不動產,14,0,14,富邦-新營,2024-10-09,9693
00922,國泰台灣領袖50,22,8,14,富邦-新營,2024-10-09,9693
00948B,中信優息投資級債,14,0,14,富邦-新營,2024-10-09,9693
00882,中信中國高股息,63,50,13,富邦-新營,2024-10-09,9693
2303,聯電,18,5,13,富邦-新營,2024-10-09,9693
3591,艾笛森,22,9,13,富邦-新營,2024-10-09,9693
3209,全科,15,2,13,富邦-新營,2024-10-09,9693
1904,正隆,12,0,12,富邦-新營,2024-10-09,9693
1909,榮成,12,0,12,富邦-新營,2024-10-09,9693
2399,映泰,223,211,12,富邦-新營,2024-10-09,9693
2426,鼎元,15,3,12,富邦-新營,2024-10-09,9693
2615,萬海,14,2,12,富邦-新營,2024-10-09,9693
2609,陽明,14,2,12,富邦-新營,2024-10-09,9693
00933B,國泰10Y+金融債,11,0,11,富邦-新營,2024-10-09,9693
1711,永光,11,0,11,富邦-新營,2024-10-09,9693
3290,東浦,11,0,11,富邦-新營,2024-10-09,9693
5347,世界,14,3,11,富邦-新營,2024-10-09,9693
9105,泰金寶-DR,21,10,11,富邦-新營,2024-10-09,9693
00715L,期街口布蘭特正2,11,0,11,富邦-新營,2024-10-09,9693
00680L,元大美債20正2,10,0,10,富邦-新營,2024-10-09,9693
00673R,期元大S＆P原油反1,10,0,10,富邦-新營,2024-10-09,9693
00953B,群益優選非投等債,10,0,10,富邦-新營,2024-10-09,9693
1537,廣隆,10,0,10,富邦-新營,2024-10-09,9693
1616,億泰,10,0,10,富邦-新營,2024-10-09,9693
2009,第一銅,11,1,10,富邦-新營,2024-10-09,9693
2449,京元電子,220,13,207,富邦-新營,2024-10-11,9693
00919,群益台灣精選高息,189,6,183,富邦-新營,2024-10-11,9693
00679B,元大美債20年,158,21,137,富邦-新營,2024-10-11,9693
00680L,元大美債20正2,122,0,122,富邦-新營,2024-10-11,9693
1721,三晃,130,11,119,富邦-新營,2024-10-11,9693
00665L,富邦�琤肭磪囓�2,105,0,105,富邦-新營,2024-10-11,9693
2312,金寶,102,16,86,富邦-新營,2024-10-11,9693
2241,艾姆勒,213,150,63,富邦-新營,2024-10-11,9693
8111,立��,67,7,60,富邦-新營,2024-10-11,9693
3450,聯鈞,53,12,41,富邦-新營,2024-10-11,9693
0056,元大高股息,44,5,39,富邦-新營,2024-10-11,9693
2408,南亞科,36,2,34,富邦-新營,2024-10-11,9693
3081,聯亞,40,10,30,富邦-新營,2024-10-11,9693
2344,華邦電,29,0,29,富邦-新營,2024-10-11,9693
00753L,中信中國50正2,86,58,28,富邦-新營,2024-10-11,9693
4903,聯光通,37,16,21,富邦-新營,2024-10-11,9693
00937B,群益ESG投等債20,20,0,20,富邦-新營,2024-10-11,9693
2002,中鋼,20,0,20,富邦-新營,2024-10-11,9693
3149,正達,69,49,20,富邦-新營,2024-10-11,9693
2601,益航,27,11,16,富邦-新營,2024-10-11,9693
3036,文曄,18,2,16,富邦-新營,2024-10-11,9693
3019,亞光,17,1,16,富邦-新營,2024-10-11,9693
00957B,兆豐US優選投等債,15,0,15,富邦-新營,2024-10-11,9693
2436,偉詮電,15,0,15,富邦-新營,2024-10-11,9693
6546,正基,16,1,15,富邦-新營,2024-10-11,9693
2363,矽統,44,30,14,富邦-新營,2024-10-11,9693
3591,艾笛森,18,4,14,富邦-新營,2024-10-11,9693
3324,雙鴻,18,4,14,富邦-新營,2024-10-11,9693
2905,三商,16,2,14,富邦-新營,2024-10-11,9693
1711,永光,13,0,13,富邦-新營,2024-10-11,9693
3086,華義,13,0,13,富邦-新營,2024-10-11,9693
1584,精剛,20,8,12,富邦-新營,2024-10-11,9693
1447,力鵬,12,0,12,富邦-新營,2024-10-11,9693
5864,致和證,12,0,12,富邦-新營,2024-10-11,9693
6241,易通展,13,1,12,富邦-新營,2024-10-11,9693
2887,台新金,13,2,11,富邦-新營,2024-10-11,9693
2371,大同,13,2,11,富邦-新營,2024-10-11,9693
2069,運錩,10,0,10,富邦-新營,2024-10-11,9693
2208,台船,10,0,10,富邦-新營,2024-10-11,9693
3162,精確,10,0,10,富邦-新營,2024-10-11,9693
3372,典範,10,0,10,富邦-新營,2024-10-11,9693
2349,錸德,10,1,9,富邦-新營,2024-10-11,9693
3049,精金,324,315,9,富邦-新營,2024-10-11,9693
6279,胡連,9,0,9,富邦-新營,2024-10-11,9693
4401,東隆興,8,0,8,富邦-新營,2024-10-11,9693
00687B,國泰20年美債,18,10,8,富邦-新營,2024-10-11,9693
00712,復華富時不動產,7,0,7,富邦-新營,2024-10-11,9693
00948B,中信優息投資級債,7,0,7,富邦-新營,2024-10-11,9693
3576,聯合再生,20,13,7,富邦-新營,2024-10-11,9693
3605,宏致,7,0,7,富邦-新營,2024-10-11,9693
1595,川寶,188,42,146,富邦-新營,2024-10-14,9693
00680L,元大美債20正2,139,0,139,富邦-新營,2024-10-14,9693
4956,光鋐,301,209,92,富邦-新營,2024-10-14,9693
00937B,群益ESG投等債20,76,4,72,富邦-新營,2024-10-14,9693
00679B,元大美債20年,65,0,65,富邦-新營,2024-10-14,9693
00725B,國泰投資級公司債,56,0,56,富邦-新營,2024-10-14,9693
2241,艾姆勒,93,38,55,富邦-新營,2024-10-14,9693
00887,永豐中國科技50大,52,0,52,富邦-新營,2024-10-14,9693
00940,元大台灣價值高息,32,5,27,富邦-新營,2024-10-14,9693
3481,群創,27,0,27,富邦-新營,2024-10-14,9693
00942B,台新美A公司債20+,30,5,25,富邦-新營,2024-10-14,9693
2317,鴻海,28,7,21,富邦-新營,2024-10-14,9693
00650L,復華香港正2,20,0,20,富邦-新營,2024-10-14,9693
2906,高林,19,0,19,富邦-新營,2024-10-14,9693
2883,凱基金,21,5,16,富邦-新營,2024-10-14,9693
00919,群益台灣精選高息,17,1,16,富邦-新營,2024-10-14,9693
5905,南仁湖,18,3,15,富邦-新營,2024-10-14,9693
2349,錸德,16,2,14,富邦-新營,2024-10-14,9693
2887,台新金,14,0,14,富邦-新營,2024-10-14,9693
2399,映泰,634,621,13,富邦-新營,2024-10-14,9693
00948B,中信優息投資級債,12,0,12,富邦-新營,2024-10-14,9693
00713,元大台灣高息低波,11,0,11,富邦-新營,2024-10-14,9693
2615,萬海,22,11,11,富邦-新營,2024-10-14,9693
2002,中鋼,11,1,10,富邦-新營,2024-10-14,9693
3027,盛達,10,0,10,富邦-新營,2024-10-14,9693
3163,波若威,16,6,10,富邦-新營,2024-10-14,9693
4526,東台,10,0,10,富邦-新營,2024-10-14,9693
6118,建達,10,0,10,富邦-新營,2024-10-14,9693
8440,綠電,10,0,10,富邦-新營,2024-10-14,9693
2344,華邦電,21,12,9,富邦-新營,2024-10-14,9693
3162,精確,20,11,9,富邦-新營,2024-10-14,9693
00740B,富邦全球投等債,9,1,8,富邦-新營,2024-10-14,9693
1314,中石化,8,0,8,富邦-新營,2024-10-14,9693
3564,其陽,12,5,7,富邦-新營,2024-10-14,9693
2881,富邦金,6,0,6,富邦-新營,2024-10-14,9693
00706L,期元大S＆P日圓正2,6,0,6,富邦-新營,2024-10-14,9693
2243,宏旭-KY,6,0,6,富邦-新營,2024-10-14,9693
8429,金麗-KY,15,9,6,富邦-新營,2024-10-14,9693
006208,富邦台50,7,1,6,富邦-新營,2024-10-14,9693
00692,富邦公司治理,6,0,6,富邦-新營,2024-10-14,9693
00933B,國泰10Y+金融債,5,0,5,富邦-新營,2024-10-14,9693
00712,復華富時不動產,10,5,5,富邦-新營,2024-10-14,9693
2892,第一金,5,0,5,富邦-新營,2024-10-14,9693
00922,國泰台灣領袖50,5,0,5,富邦-新營,2024-10-14,9693
1711,永光,5,0,5,富邦-新營,2024-10-14,9693
2845,遠東銀,5,0,5,富邦-新營,2024-10-14,9693
00959B,大華投等美債15Y+,5,0,5,富邦-新營,2024-10-14,9693
2464,盟立,6,1,5,富邦-新營,2024-10-14,9693
3455,由田,5,0,5,富邦-新營,2024-10-14,9693
6248,沛波,5,0,5,富邦-新營,2024-10-14,9693
00680L,元大美債20正2,160,0,160,富邦-新營,2024-10-15,9693
00961,FT臺灣永續高息,73,0,73,富邦-新營,2024-10-15,9693
1314,中石化,72,4,68,富邦-新營,2024-10-15,9693
00919,群益台灣精選高息,67,16,51,富邦-新營,2024-10-15,9693
00665L,富邦�琤肭磪囓�2,62,15,47,富邦-新營,2024-10-15,9693
00753L,中信中國50正2,41,0,41,富邦-新營,2024-10-15,9693
3062,建漢,170,131,39,富邦-新營,2024-10-15,9693
2363,矽統,150,118,32,富邦-新營,2024-10-15,9693
2312,金寶,48,16,32,富邦-新營,2024-10-15,9693
5009,榮剛,30,0,30,富邦-新營,2024-10-15,9693
2887,台新金,29,0,29,富邦-新營,2024-10-15,9693
2388,威盛,34,8,26,富邦-新營,2024-10-15,9693
00637L,元大滬深300正2,64,40,24,富邦-新營,2024-10-15,9693
3149,正達,88,67,21,富邦-新營,2024-10-15,9693
2542,興富發,20,1,19,富邦-新營,2024-10-15,9693
1101,台泥,22,4,18,富邦-新營,2024-10-15,9693
2303,聯電,21,3,18,富邦-新營,2024-10-15,9693
00712,復華富時不動產,17,0,17,富邦-新營,2024-10-15,9693
1721,三晃,17,2,15,富邦-新營,2024-10-15,9693
3710,連展投控,17,2,15,富邦-新營,2024-10-15,9693
2371,大同,14,0,14,富邦-新營,2024-10-15,9693
3049,精金,14,0,14,富邦-新營,2024-10-15,9693
6741,91APP*-KY,14,0,14,富邦-新營,2024-10-15,9693
6187,萬潤,16,2,14,富邦-新營,2024-10-15,9693
2489,瑞軒,14,1,13,富邦-新營,2024-10-15,9693
2241,艾姆勒,40,27,13,富邦-新營,2024-10-15,9693
00887,永豐中國科技50大,13,1,12,富邦-新營,2024-10-15,9693
8429,金麗-KY,12,0,12,富邦-新營,2024-10-15,9693
3535,晶彩科,13,2,11,富邦-新營,2024-10-15,9693
00645,富邦日本,10,0,10,富邦-新營,2024-10-15,9693
00650L,復華香港正2,10,0,10,富邦-新營,2024-10-15,9693
00942B,台新美A公司債20+,10,0,10,富邦-新營,2024-10-15,9693
1806,冠軍,10,0,10,富邦-新營,2024-10-15,9693
3322,建舜電,10,0,10,富邦-新營,2024-10-15,9693
4114,健喬,11,1,10,富邦-新營,2024-10-15,9693
5452,佶優,249,239,10,富邦-新營,2024-10-15,9693
4931,新盛力,10,0,10,富邦-新營,2024-10-15,9693
00679B,元大美債20年,12,3,9,富邦-新營,2024-10-15,9693
00688L,國泰20年美債正2,8,0,8,富邦-新營,2024-10-15,9693
6173,信昌電,8,0,8,富邦-新營,2024-10-15,9693
5443,均豪,11,3,8,富邦-新營,2024-10-15,9693
00631L,元大台灣50正2,13,6,7,富邦-新營,2024-10-15,9693
8054,安國,12,5,7,富邦-新營,2024-10-15,9693
1319,東陽,18,11,7,富邦-新營,2024-10-15,9693
00693U,期街口S＆P黃豆,6,0,6,富邦-新營,2024-10-15,9693
00687B,國泰20年美債,6,0,6,富邦-新營,2024-10-15,9693
1909,榮成,6,0,6,富邦-新營,2024-10-15,9693
2486,一詮,15,9,6,富邦-新營,2024-10-15,9693
3306,鼎天,6,0,6,富邦-新營,2024-10-15,9693
6117,迎廣,8,2,6,富邦-新營,2024-10-15,9693
00680L,元大美債20正2,210,9,201,富邦-新營,2024-10-16,9693
3013,晟銘電,167,19,148,富邦-新營,2024-10-16,9693
2891,中信金,117,6,111,富邦-新營,2024-10-16,9693
00676R,富邦臺灣加權反1,50,0,50,富邦-新營,2024-10-16,9693
00922,國泰台灣領袖50,41,0,41,富邦-新營,2024-10-16,9693
00945B,凱基美國非投等債,40,0,40,富邦-新營,2024-10-16,9693
1314,中石化,46,10,36,富邦-新營,2024-10-16,9693
2312,金寶,326,292,34,富邦-新營,2024-10-16,9693
2887,台新金,33,0,33,富邦-新營,2024-10-16,9693
0056,元大高股息,46,16,30,富邦-新營,2024-10-16,9693
2344,華邦電,26,2,24,富邦-新營,2024-10-16,9693
00753L,中信中國50正2,47,23,24,富邦-新營,2024-10-16,9693
2014,中鴻,38,14,24,富邦-新營,2024-10-16,9693
2888,新光金,22,0,22,富邦-新營,2024-10-16,9693
00687B,國泰20年美債,20,0,20,富邦-新營,2024-10-16,9693
1721,三晃,20,0,20,富邦-新營,2024-10-16,9693
2241,艾姆勒,26,6,20,富邦-新營,2024-10-16,9693
1609,大亞,24,5,19,富邦-新營,2024-10-16,9693
00878,國泰永續高股息,20,3,17,富邦-新營,2024-10-16,9693
9105,泰金寶-DR,531,515,16,富邦-新營,2024-10-16,9693
006208,富邦台50,16,0,16,富邦-新營,2024-10-16,9693
2038,海光,15,0,15,富邦-新營,2024-10-16,9693
6829,千附精密,26,11,15,富邦-新營,2024-10-16,9693
00679B,元大美債20年,34,20,14,富邦-新營,2024-10-16,9693
00725B,國泰投資級公司債,14,0,14,富邦-新營,2024-10-16,9693
00929,復華台灣科技優息,27,14,13,富邦-新營,2024-10-16,9693
2498,宏達電,15,2,13,富邦-新營,2024-10-16,9693
3230,錦明,26,13,13,富邦-新營,2024-10-16,9693
8429,金麗-KY,32,19,13,富邦-新營,2024-10-16,9693
00919,群益台灣精選高息,16,5,11,富邦-新營,2024-10-16,9693
00887,永豐中國科技50大,24,13,11,富邦-新營,2024-10-16,9693
6579,研揚,11,0,11,富邦-新營,2024-10-16,9693
3591,艾笛森,11,0,11,富邦-新營,2024-10-16,9693
2204,中華,11,0,11,富邦-新營,2024-10-16,9693
0050,元大台灣50,11,1,10,富邦-新營,2024-10-16,9693
2303,聯電,11,1,10,富邦-新營,2024-10-16,9693
00688L,國泰20年美債正2,10,0,10,富邦-新營,2024-10-16,9693
2511,太子,10,0,10,富邦-新營,2024-10-16,9693
4908,前鼎,10,0,10,富邦-新營,2024-10-16,9693
6191,精成科,10,0,10,富邦-新營,2024-10-16,9693
1305,華夏,15,6,9,富邦-新營,2024-10-16,9693
3071,協禧,9,0,9,富邦-新營,2024-10-16,9693
6026,福邦證,9,0,9,富邦-新營,2024-10-16,9693
5864,致和證,8,0,8,富邦-新營,2024-10-16,9693
8064,東捷,9,1,8,富邦-新營,2024-10-16,9693
3708,上緯投控,8,0,8,富邦-新營,2024-10-16,9693
1597,直得,7,0,7,富邦-新營,2024-10-16,9693
00935,野村臺灣新科技50,6,0,6,富邦-新營,2024-10-16,9693
6462,神盾,6,0,6,富邦-新營,2024-10-16,9693
3209,全科,7,1,6,富邦-新營,2024-10-16,9693
00929,復華台灣科技優息,204,57,147,富邦-新營,2024-10-17,9693
3013,晟銘電,693,592,101,富邦-新營,2024-10-17,9693
00887,永豐中國科技50大,91,1,90,富邦-新營,2024-10-17,9693
1304,台聚,70,0,70,富邦-新營,2024-10-17,9693
0056,元大高股息,59,0,59,富邦-新營,2024-10-17,9693
2399,映泰,59,3,56,富邦-新營,2024-10-17,9693
3481,群創,108,69,39,富邦-新營,2024-10-17,9693
2888,新光金,44,11,33,富邦-新營,2024-10-17,9693
00637L,元大滬深300正2,49,25,24,富邦-新營,2024-10-17,9693
00922,國泰台灣領袖50,25,1,24,富邦-新營,2024-10-17,9693
2371,大同,25,2,23,富邦-新營,2024-10-17,9693
00936,台新永續高息中小,20,0,20,富邦-新營,2024-10-17,9693
1721,三晃,22,2,20,富邦-新營,2024-10-17,9693
3230,錦明,24,5,19,富邦-新營,2024-10-17,9693
00650L,復華香港正2,32,15,17,富邦-新營,2024-10-17,9693
3062,建漢,50,33,17,富邦-新營,2024-10-17,9693
1528,恩德,37,24,13,富邦-新營,2024-10-17,9693
2301,光寶科,15,2,13,富邦-新營,2024-10-17,9693
6829,千附精密,13,0,13,富邦-新營,2024-10-17,9693
2337,旺宏,12,0,12,富邦-新營,2024-10-17,9693
00753L,中信中國50正2,11,0,11,富邦-新營,2024-10-17,9693
00937B,群益ESG投等債20,10,0,10,富邦-新營,2024-10-17,9693
00948B,中信優息投資級債,10,0,10,富邦-新營,2024-10-17,9693
1440,南紡,10,0,10,富邦-新營,2024-10-17,9693
5905,南仁湖,10,0,10,富邦-新營,2024-10-17,9693
6191,精成科,10,0,10,富邦-新營,2024-10-17,9693
6743,安普新,10,0,10,富邦-新營,2024-10-17,9693
8111,立��,34,24,10,富邦-新營,2024-10-17,9693
2303,聯電,9,0,9,富邦-新營,2024-10-17,9693
2376,技嘉,11,2,9,富邦-新營,2024-10-17,9693
2314,台揚,9,0,9,富邦-新營,2024-10-17,9693
2464,盟立,12,3,9,富邦-新營,2024-10-17,9693
00877,復華中國5G,7,0,7,富邦-新營,2024-10-17,9693
3663,鑫科,7,0,7,富邦-新營,2024-10-17,9693
6274,台燿,8,1,7,富邦-新營,2024-10-17,9693
6770,力積電,7,0,7,富邦-新營,2024-10-17,9693
8076,伍豐,7,0,7,富邦-新營,2024-10-17,9693
3209,全科,13,6,7,富邦-新營,2024-10-17,9693
2603,長榮,11,4,7,富邦-新營,2024-10-17,9693
3049,精金,8,1,7,富邦-新營,2024-10-17,9693
2354,鴻準,6,0,6,富邦-新營,2024-10-17,9693
2421,建準,6,0,6,富邦-新營,2024-10-17,9693
6282,康舒,7,1,6,富邦-新營,2024-10-17,9693
2313,華通,7,2,5,富邦-新營,2024-10-17,9693
2330,台積電,6,1,5,富邦-新營,2024-10-17,9693
00905,FT臺灣Smart,5,0,5,富邦-新營,2024-10-17,9693
00688L,國泰20年美債正2,5,0,5,富邦-新營,2024-10-17,9693
00945B,凱基美國非投等債,5,0,5,富邦-新營,2024-10-17,9693
2365,昆盈,38,33,5,富邦-新營,2024-10-17,9693
3060,銘異,6,1,5,富邦-新營,2024-10-17,9693
00632R,元大台灣50反1,203,0,203,富邦-新營,2024-10-18,9693
00927,群益半導體收益,178,0,178,富邦-新營,2024-10-18,9693
00679B,元大美債20年,145,0,145,富邦-新營,2024-10-18,9693
00937B,群益ESG投等債20,85,0,85,富邦-新營,2024-10-18,9693
6609,瀧澤科,80,1,79,富邦-新營,2024-10-18,9693
00688L,國泰20年美債正2,35,0,35,富邦-新營,2024-10-18,9693
00948B,中信優息投資級債,31,0,31,富邦-新營,2024-10-18,9693
5452,佶優,44,13,31,富邦-新營,2024-10-18,9693
2317,鴻海,49,21,28,富邦-新營,2024-10-18,9693
00887,永豐中國科技50大,29,2,27,富邦-新營,2024-10-18,9693
00933B,國泰10Y+金融債,23,0,23,富邦-新營,2024-10-18,9693
2449,京元電子,30,7,23,富邦-新營,2024-10-18,9693
00637L,元大滬深300正2,247,225,22,富邦-新營,2024-10-18,9693
6829,千附精密,22,0,22,富邦-新營,2024-10-18,9693
2542,興富發,20,0,20,富邦-新營,2024-10-18,9693
00687B,國泰20年美債,20,0,20,富邦-新營,2024-10-18,9693
2374,佳能,36,17,19,富邦-新營,2024-10-18,9693
4566,時碩工業,30,11,19,富邦-新營,2024-10-18,9693
00919,群益台灣精選高息,19,0,19,富邦-新營,2024-10-18,9693
00918,大華優利高填息30,20,3,17,富邦-新營,2024-10-18,9693
1314,中石化,22,5,17,富邦-新營,2024-10-18,9693
00720B,元大投資級公司債,16,0,16,富邦-新營,2024-10-18,9693
2402,毅嘉,17,1,16,富邦-新營,2024-10-18,9693
2303,聯電,18,3,15,富邦-新營,2024-10-18,9693
00957B,兆豐US優選投等債,15,0,15,富邦-新營,2024-10-18,9693
2313,華通,13,1,12,富邦-新營,2024-10-18,9693
00936,台新永續高息中小,12,0,12,富邦-新營,2024-10-18,9693
5347,世界,13,1,12,富邦-新營,2024-10-18,9693
00696B,富邦美債20年,11,0,11,富邦-新營,2024-10-18,9693
2905,三商,11,0,11,富邦-新營,2024-10-18,9693
2887,台新金,11,0,11,富邦-新營,2024-10-18,9693
2340,台亞,10,0,10,富邦-新營,2024-10-18,9693
1337,再生-KY,10,0,10,富邦-新營,2024-10-18,9693
2855,統一證,11,1,10,富邦-新營,2024-10-18,9693
3230,錦明,15,5,10,富邦-新營,2024-10-18,9693
4950,牧東,10,0,10,富邦-新營,2024-10-18,9693
8071,能率網通,10,0,10,富邦-新營,2024-10-18,9693
912000,晨訊科-DR,10,0,10,富邦-新營,2024-10-18,9693
9938,百和,11,1,10,富邦-新營,2024-10-18,9693
2603,長榮,11,1,10,富邦-新營,2024-10-18,9693
8028,昇陽半導體,39,29,10,富邦-新營,2024-10-18,9693
2070,精湛,11,2,9,富邦-新營,2024-10-18,9693
6187,萬潤,9,0,9,富邦-新營,2024-10-18,9693
4979,華星光,12,4,8,富邦-新營,2024-10-18,9693
8105,凌巨,8,0,8,富邦-新營,2024-10-18,9693
3450,聯鈞,16,9,7,富邦-新營,2024-10-18,9693
1528,恩德,14,7,7,富邦-新營,2024-10-18,9693
6770,力積電,7,0,7,富邦-新營,2024-10-18,9693
00725B,國泰投資級公司債,6,0,6,富邦-新營,2024-10-18,9693
6462,神盾,6,0,6,富邦-新營,2024-10-18,9693
4562,穎漢,279,114,165,富邦-新營,2024-10-21,9693
1721,三晃,112,0,112,富邦-新營,2024-10-21,9693
2312,金寶,70,2,68,富邦-新營,2024-10-21,9693
00687B,國泰20年美債,66,0,66,富邦-新營,2024-10-21,9693
4576,大銀微系統,129,76,53,富邦-新營,2024-10-21,9693
2020,美亞,51,0,51,富邦-新營,2024-10-21,9693
2892,第一金,50,0,50,富邦-新營,2024-10-21,9693
6151,晉倫,50,1,49,富邦-新營,2024-10-21,9693
00948B,中信優息投資級債,65,20,45,富邦-新營,2024-10-21,9693
00877,復華中國5G,41,5,36,富邦-新營,2024-10-21,9693
00637L,元大滬深300正2,40,5,35,富邦-新營,2024-10-21,9693
6829,千附精密,35,0,35,富邦-新營,2024-10-21,9693
1605,華新,31,0,31,富邦-新營,2024-10-21,9693
2883,凱基金,31,1,30,富邦-新營,2024-10-21,9693
2303,聯電,30,1,29,富邦-新營,2024-10-21,9693
00933B,國泰10Y+金融債,26,0,26,富邦-新營,2024-10-21,9693
2881,富邦金,28,1,27,富邦-新營,2024-10-21,9693
00887,永豐中國科技50大,26,5,21,富邦-新營,2024-10-21,9693
00753L,中信中國50正2,20,2,18,富邦-新營,2024-10-21,9693
1326,台化,17,0,17,富邦-新營,2024-10-21,9693
4510,高鋒,126,109,17,富邦-新營,2024-10-21,9693
00830,國泰費城半導體,16,1,15,富邦-新營,2024-10-21,9693
00715L,期街口布蘭特正2,15,0,15,富邦-新營,2024-10-21,9693
2201,裕隆,14,1,13,富邦-新營,2024-10-21,9693
6770,力積電,14,1,13,富邦-新營,2024-10-21,9693
9105,泰金寶-DR,25,12,13,富邦-新營,2024-10-21,9693
3372,典範,11,0,11,富邦-新營,2024-10-21,9693
2464,盟立,22,11,11,富邦-新營,2024-10-21,9693
00907,永豐優息存股,10,0,10,富邦-新營,2024-10-21,9693
00942B,台新美A公司債20+,10,0,10,富邦-新營,2024-10-21,9693
3230,錦明,10,0,10,富邦-新營,2024-10-21,9693
4414,如興,10,0,10,富邦-新營,2024-10-21,9693
4950,牧東,10,0,10,富邦-新營,2024-10-21,9693
6156,松上,10,0,10,富邦-新營,2024-10-21,9693
2027,大成鋼,14,5,9,富邦-新營,2024-10-21,9693
00679B,元大美債20年,39,30,9,富邦-新營,2024-10-21,9693
00959B,大華投等美債15Y+,9,0,9,富邦-新營,2024-10-21,9693
00919,群益台灣精選高息,20,12,8,富邦-新營,2024-10-21,9693
2393,億光,11,3,8,富邦-新營,2024-10-21,9693
2455,全新,10,2,8,富邦-新營,2024-10-21,9693
8150,南茂,10,2,8,富邦-新營,2024-10-21,9693
1301,台塑,7,0,7,富邦-新營,2024-10-21,9693
2374,佳能,25,18,7,富邦-新營,2024-10-21,9693
3062,建漢,15,8,7,富邦-新營,2024-10-21,9693
6206,飛捷,7,0,7,富邦-新營,2024-10-21,9693
2317,鴻海,30,23,7,富邦-新營,2024-10-21,9693
00725B,國泰投資級公司債,12,5,7,富邦-新營,2024-10-21,9693
2891,中信金,10,4,6,富邦-新營,2024-10-21,9693
3303,岱稜,7,1,6,富邦-新營,2024-10-21,9693
3710,連展投控,6,0,6,富邦-新營,2024-10-21,9693
00937B,群益ESG投等債20,201,9,192,富邦-新營,2024-10-22,9693
3450,聯鈞,200,101,99,富邦-新營,2024-10-22,9693
2449,京元電子,107,12,95,富邦-新營,2024-10-22,9693
00948B,中信優息投資級債,94,0,94,富邦-新營,2024-10-22,9693
00679B,元大美債20年,117,24,93,富邦-新營,2024-10-22,9693
9105,泰金寶-DR,55,5,50,富邦-新營,2024-10-22,9693
3013,晟銘電,50,5,45,富邦-新營,2024-10-22,9693
2399,映泰,76,35,41,富邦-新營,2024-10-22,9693
00933B,國泰10Y+金融債,38,0,38,富邦-新營,2024-10-22,9693
00687B,國泰20年美債,53,16,37,富邦-新營,2024-10-22,9693
00720B,元大投資級公司債,35,0,35,富邦-新營,2024-10-22,9693
00712,復華富時不動產,35,5,30,富邦-新營,2024-10-22,9693
2312,金寶,467,439,28,富邦-新營,2024-10-22,9693
00950B,凱基A級公司債,20,0,20,富邦-新營,2024-10-22,9693
8110,華東,20,0,20,富邦-新營,2024-10-22,9693
00688L,國泰20年美債正2,19,0,19,富邦-新營,2024-10-22,9693
00878,國泰永續高股息,25,6,19,富邦-新營,2024-10-22,9693
2356,英業達,26,8,18,富邦-新營,2024-10-22,9693
4576,大銀微系統,76,59,17,富邦-新營,2024-10-22,9693
6742,澤米,22,5,17,富邦-新營,2024-10-22,9693
00959B,大華投等美債15Y+,17,0,17,富邦-新營,2024-10-22,9693
4906,正文,15,0,15,富邦-新營,2024-10-22,9693
00907,永豐優息存股,14,0,14,富邦-新營,2024-10-22,9693
00905,FT臺灣Smart,15,1,14,富邦-新營,2024-10-22,9693
00957B,兆豐US優選投等債,13,0,13,富邦-新營,2024-10-22,9693
8429,金麗-KY,13,0,13,富邦-新營,2024-10-22,9693
0056,元大高股息,15,3,12,富邦-新營,2024-10-22,9693
4540,全球傳動,29,17,12,富邦-新營,2024-10-22,9693
00740B,富邦全球投等債,12,0,12,富邦-新營,2024-10-22,9693
00919,群益台灣精選高息,13,2,11,富邦-新營,2024-10-22,9693
3354,律勝,11,0,11,富邦-新營,2024-10-22,9693
4909,新復興,11,0,11,富邦-新營,2024-10-22,9693
2542,興富發,11,1,10,富邦-新營,2024-10-22,9693
00650L,復華香港正2,10,0,10,富邦-新營,2024-10-22,9693
00935,野村臺灣新科技50,10,0,10,富邦-新營,2024-10-22,9693
2002,中鋼,10,0,10,富邦-新營,2024-10-22,9693
2241,艾姆勒,15,5,10,富邦-新營,2024-10-22,9693
2401,凌陽,10,0,10,富邦-新營,2024-10-22,9693
6213,聯茂,11,1,10,富邦-新營,2024-10-22,9693
2402,毅嘉,9,0,9,富邦-新營,2024-10-22,9693
00706L,期元大S＆P日圓正2,9,0,9,富邦-新營,2024-10-22,9693
5425,台半,10,1,9,富邦-新營,2024-10-22,9693
3189,景碩,29,20,9,富邦-新營,2024-10-22,9693
1597,直得,19,11,8,富邦-新營,2024-10-22,9693
2332,友訊,8,0,8,富邦-新營,2024-10-22,9693
3230,錦明,11,3,8,富邦-新營,2024-10-22,9693
4729,熒茂,10,2,8,富邦-新營,2024-10-22,9693
4974,亞泰,8,0,8,富邦-新營,2024-10-22,9693
6658,聯策,64,56,8,富邦-新營,2024-10-22,9693
8043,蜜望實,12,4,8,富邦-新營,2024-10-22,9693
9907,統一實,100,0,100,富邦-新營,2024-10-23,9693
3481,群創,104,37,67,富邦-新營,2024-10-23,9693
6151,晉倫,62,6,56,富邦-新營,2024-10-23,9693
2801,彰銀,40,0,40,富邦-新營,2024-10-23,9693
2887,台新金,39,0,39,富邦-新營,2024-10-23,9693
00753L,中信中國50正2,40,2,38,富邦-新營,2024-10-23,9693
4542,科嶠,35,2,33,富邦-新營,2024-10-23,9693
00679B,元大美債20年,30,1,29,富邦-新營,2024-10-23,9693
3372,典範,28,0,28,富邦-新營,2024-10-23,9693
00948B,中信優息投資級債,28,0,28,富邦-新營,2024-10-23,9693
2892,第一金,24,0,24,富邦-新營,2024-10-23,9693
00937B,群益ESG投等債20,56,34,22,富邦-新營,2024-10-23,9693
00637L,元大滬深300正2,53,31,22,富邦-新營,2024-10-23,9693
2542,興富發,21,1,20,富邦-新營,2024-10-23,9693
2027,大成鋼,20,0,20,富邦-新營,2024-10-23,9693
1444,力麗,20,0,20,富邦-新營,2024-10-23,9693
00706L,期元大S＆P日圓正2,17,0,17,富邦-新營,2024-10-23,9693
2601,益航,16,0,16,富邦-新營,2024-10-23,9693
00680L,元大美債20正2,15,0,15,富邦-新營,2024-10-23,9693
00926,凱基全球菁英55,15,0,15,富邦-新營,2024-10-23,9693
3702,大聯大,14,0,14,富邦-新營,2024-10-23,9693
1312,國喬,14,0,14,富邦-新營,2024-10-23,9693
2349,錸德,15,1,14,富邦-新營,2024-10-23,9693
0056,元大高股息,14,1,13,富邦-新營,2024-10-23,9693
2395,研華,12,0,12,富邦-新營,2024-10-23,9693
2312,金寶,17,5,12,富邦-新營,2024-10-23,9693
4562,穎漢,12,0,12,富邦-新營,2024-10-23,9693
00720B,元大投資級公司債,15,3,12,富邦-新營,2024-10-23,9693
00919,群益台灣精選高息,11,0,11,富邦-新營,2024-10-23,9693
00941,中信上游半導體,11,0,11,富邦-新營,2024-10-23,9693
00907,永豐優息存股,11,0,11,富邦-新營,2024-10-23,9693
2399,映泰,379,368,11,富邦-新營,2024-10-23,9693
5452,佶優,12,1,11,富邦-新營,2024-10-23,9693
1314,中石化,10,0,10,富邦-新營,2024-10-23,9693
1584,精剛,11,1,10,富邦-新營,2024-10-23,9693
4906,正文,10,0,10,富邦-新營,2024-10-23,9693
2324,仁寶,10,0,10,富邦-新營,2024-10-23,9693
6213,聯茂,10,1,9,富邦-新營,2024-10-23,9693
2241,艾姆勒,11,3,8,富邦-新營,2024-10-23,9693
2883,凱基金,12,4,8,富邦-新營,2024-10-23,9693
2317,鴻海,27,20,7,富邦-新營,2024-10-23,9693
1301,台塑,7,0,7,富邦-新營,2024-10-23,9693
00688L,國泰20年美債正2,7,0,7,富邦-新營,2024-10-23,9693
00687B,國泰20年美債,6,0,6,富邦-新營,2024-10-23,9693
2303,聯電,6,0,6,富邦-新營,2024-10-23,9693
00933B,國泰10Y+金融債,6,0,6,富邦-新營,2024-10-23,9693
1326,台化,6,0,6,富邦-新營,2024-10-23,9693
3615,安可,9,3,6,富邦-新營,2024-10-23,9693
8021,尖點,6,0,6,富邦-新營,2024-10-23,9693
00922,國泰台灣領袖50,6,0,6,富邦-新營,2024-10-23,9693
6609,瀧澤科,131,10,121,富邦-新營,2024-10-24,9693
0056,元大高股息,51,0,51,富邦-新營,2024-10-24,9693
4157,太景*-KY,45,0,45,富邦-新營,2024-10-24,9693
00753L,中信中國50正2,80,36,44,富邦-新營,2024-10-24,9693
00878,國泰永續高股息,44,2,42,富邦-新營,2024-10-24,9693
00918,大華優利高填息30,41,0,41,富邦-新營,2024-10-24,9693
6829,千附精密,38,0,38,富邦-新營,2024-10-24,9693
00712,復華富時不動產,35,0,35,富邦-新營,2024-10-24,9693
00937B,群益ESG投等債20,41,7,34,富邦-新營,2024-10-24,9693
00945B,凱基美國非投等債,21,0,21,富邦-新營,2024-10-24,9693
00665L,富邦�琤肭磪囓�2,21,1,20,富邦-新營,2024-10-24,9693
2027,大成鋼,20,0,20,富邦-新營,2024-10-24,9693
2069,運錩,20,0,20,富邦-新營,2024-10-24,9693
1569,濱川,19,0,19,富邦-新營,2024-10-24,9693
3021,鴻名,36,17,19,富邦-新營,2024-10-24,9693
2388,威盛,51,33,18,富邦-新營,2024-10-24,9693
1605,華新,17,0,17,富邦-新營,2024-10-24,9693
6506,雙邦,20,3,17,富邦-新營,2024-10-24,9693
00680L,元大美債20正2,16,0,16,富邦-新營,2024-10-24,9693
1909,榮成,16,0,16,富邦-新營,2024-10-24,9693
00938,凱基優選30,15,0,15,富邦-新營,2024-10-24,9693
2498,宏達電,18,3,15,富邦-新營,2024-10-24,9693
00948B,中信優息投資級債,15,0,15,富邦-新營,2024-10-24,9693
2882,國泰金,13,0,13,富邦-新營,2024-10-24,9693
8429,金麗-KY,16,3,13,富邦-新營,2024-10-24,9693
3481,群創,15,2,13,富邦-新營,2024-10-24,9693
00922,國泰台灣領袖50,12,0,12,富邦-新營,2024-10-24,9693
3163,波若威,12,0,12,富邦-新營,2024-10-24,9693
6443,元晶,12,0,12,富邦-新營,2024-10-24,9693
2891,中信金,11,0,11,富邦-新營,2024-10-24,9693
2431,聯昌,11,0,11,富邦-新營,2024-10-24,9693
5351,鈺創,11,0,11,富邦-新營,2024-10-24,9693
5452,佶優,12,1,11,富邦-新營,2024-10-24,9693
00720B,元大投資級公司債,10,0,10,富邦-新營,2024-10-24,9693
2303,聯電,20,10,10,富邦-新營,2024-10-24,9693
00751B,元大AAA至A公司債,10,0,10,富邦-新營,2024-10-24,9693
00960,野村全球航運龍頭,10,0,10,富邦-新營,2024-10-24,9693
2329,華泰,13,3,10,富邦-新營,2024-10-24,9693
3287,廣寰科,10,0,10,富邦-新營,2024-10-24,9693
4414,如興,10,0,10,富邦-新營,2024-10-24,9693
4716,大立,12,2,10,富邦-新營,2024-10-24,9693
2489,瑞軒,20,11,9,富邦-新營,2024-10-24,9693
6763,綠界科技*,10,1,9,富邦-新營,2024-10-24,9693
00706L,期元大S＆P日圓正2,9,0,9,富邦-新營,2024-10-24,9693
3450,聯鈞,11,2,9,富邦-新營,2024-10-24,9693
1524,耿鼎,22,13,9,富邦-新營,2024-10-24,9693
2382,廣達,8,0,8,富邦-新營,2024-10-24,9693
2367,燿華,8,0,8,富邦-新營,2024-10-24,9693
6606,建德工業,8,0,8,富邦-新營,2024-10-24,9693
2609,陽明,10,3,7,富邦-新營,2024-10-24,9693
2646,星宇航空,287,41,246,富邦-新營,2024-10-25,9693
00959B,大華投等美債15Y+,176,0,176,富邦-新營,2024-10-25,9693
8249,菱光,128,27,101,富邦-新營,2024-10-25,9693
00940,元大台灣價值高息,114,30,84,富邦-新營,2024-10-25,9693
2399,映泰,47,4,43,富邦-新營,2024-10-25,9693
2303,聯電,33,0,33,富邦-新營,2024-10-25,9693
2897,王道銀行,30,0,30,富邦-新營,2024-10-25,9693
5452,佶優,30,0,30,富邦-新營,2024-10-25,9693
1605,華新,29,0,29,富邦-新營,2024-10-25,9693
1301,台塑,32,5,27,富邦-新營,2024-10-25,9693
2388,威盛,21,0,21,富邦-新營,2024-10-25,9693
00937B,群益ESG投等債20,57,37,20,富邦-新營,2024-10-25,9693
3715,定穎投控,25,6,19,富邦-新營,2024-10-25,9693
3710,連展投控,17,0,17,富邦-新營,2024-10-25,9693
00637L,元大滬深300正2,20,5,15,富邦-新營,2024-10-25,9693
5488,松普,15,0,15,富邦-新營,2024-10-25,9693
6829,千附精密,15,0,15,富邦-新營,2024-10-25,9693
2344,華邦電,14,0,14,富邦-新營,2024-10-25,9693
00753L,中信中國50正2,12,0,12,富邦-新營,2024-10-25,9693
1721,三晃,12,0,12,富邦-新營,2024-10-25,9693
00931B,統一美債20年,10,0,10,富邦-新營,2024-10-25,9693
2887,台新金,10,0,10,富邦-新營,2024-10-25,9693
2489,瑞軒,10,0,10,富邦-新營,2024-10-25,9693
2605,新興,10,0,10,富邦-新營,2024-10-25,9693
3149,正達,17,7,10,富邦-新營,2024-10-25,9693
3230,錦明,21,11,10,富邦-新營,2024-10-25,9693
6285,啟��,12,3,9,富邦-新營,2024-10-25,9693
00679B,元大美債20年,23,14,9,富邦-新營,2024-10-25,9693
2204,中華,8,0,8,富邦-新營,2024-10-25,9693
5202,力新,15,7,8,富邦-新營,2024-10-25,9693
0056,元大高股息,9,1,8,富邦-新營,2024-10-25,9693
00960,野村全球航運龍頭,7,0,7,富邦-新營,2024-10-25,9693
1314,中石化,9,2,7,富邦-新營,2024-10-25,9693
6182,合晶,7,0,7,富邦-新營,2024-10-25,9693
8358,金居,7,0,7,富邦-新營,2024-10-25,9693
3029,零壹,7,1,6,富邦-新營,2024-10-25,9693
1905,華紙,6,0,6,富邦-新營,2024-10-25,9693
2436,偉詮電,6,0,6,富邦-新營,2024-10-25,9693
3021,鴻名,16,10,6,富邦-新營,2024-10-25,9693
3189,景碩,7,1,6,富邦-新營,2024-10-25,9693
4545,銘鈺,9,3,6,富邦-新營,2024-10-25,9693
5386,青雲,10,4,6,富邦-新營,2024-10-25,9693
3041,揚智,6,0,6,富邦-新營,2024-10-25,9693
4526,東台,7,1,6,富邦-新營,2024-10-25,9693
8096,擎亞,5,0,5,富邦-新營,2024-10-25,9693
3356,奇偶,5,0,5,富邦-新營,2024-10-25,9693
2464,盟立,5,0,5,富邦-新營,2024-10-25,9693
00722B,群益投資級電信債,5,0,5,富邦-新營,2024-10-25,9693
1217,愛之味,5,0,5,富邦-新營,2024-10-25,9693
1540,喬福,5,0,5,富邦-新營,2024-10-25,9693
00937B,群益ESG投等債20,117,10,107,富邦-新營,2024-10-28,9693
1605,華新,94,0,94,富邦-新營,2024-10-28,9693
00715L,期街口布蘭特正2,84,0,84,富邦-新營,2024-10-28,9693
00948B,中信優息投資級債,73,0,73,富邦-新營,2024-10-28,9693
1464,得力,76,5,71,富邦-新營,2024-10-28,9693
00679B,元大美債20年,64,0,64,富邦-新營,2024-10-28,9693
00680L,元大美債20正2,50,0,50,富邦-新營,2024-10-28,9693
00943,兆豐電子高息等權,50,0,50,富邦-新營,2024-10-28,9693
2601,益航,42,0,42,富邦-新營,2024-10-28,9693
3011,今皓,34,0,34,富邦-新營,2024-10-28,9693
00933B,國泰10Y+金融債,33,0,33,富邦-新營,2024-10-28,9693
2241,艾姆勒,32,0,32,富邦-新營,2024-10-28,9693
2354,鴻準,27,5,22,富邦-新營,2024-10-28,9693
00687B,國泰20年美債,30,10,20,富邦-新營,2024-10-28,9693
1584,精剛,16,1,15,富邦-新營,2024-10-28,9693
3481,群創,17,2,15,富邦-新營,2024-10-28,9693
00712,復華富時不動產,13,0,13,富邦-新營,2024-10-28,9693
4510,高鋒,13,0,13,富邦-新營,2024-10-28,9693
6134,萬旭,15,2,13,富邦-新營,2024-10-28,9693
3324,雙鴻,12,0,12,富邦-新營,2024-10-28,9693
00795B,中信美國公債20年,12,0,12,富邦-新營,2024-10-28,9693
8064,東捷,21,9,12,富邦-新營,2024-10-28,9693
8074,鉅橡,12,0,12,富邦-新營,2024-10-28,9693
00878,國泰永續高股息,13,1,12,富邦-新營,2024-10-28,9693
2449,京元電子,12,1,11,富邦-新營,2024-10-28,9693
1513,中興電,11,0,11,富邦-新營,2024-10-28,9693
00751B,元大AAA至A公司債,11,0,11,富邦-新營,2024-10-28,9693
1721,三晃,11,0,11,富邦-新營,2024-10-28,9693
00959B,大華投等美債15Y+,11,0,11,富邦-新營,2024-10-28,9693
3081,聯亞,18,8,10,富邦-新營,2024-10-28,9693
2845,遠東銀,13,3,10,富邦-新營,2024-10-28,9693
6288,聯嘉,36,26,10,富邦-新營,2024-10-28,9693
00942B,台新美A公司債20+,10,0,10,富邦-新營,2024-10-28,9693
1528,恩德,15,5,10,富邦-新營,2024-10-28,9693
6182,合晶,10,0,10,富邦-新營,2024-10-28,9693
00919,群益台灣精選高息,13,4,9,富邦-新營,2024-10-28,9693
2303,聯電,10,1,9,富邦-新營,2024-10-28,9693
5864,致和證,9,0,9,富邦-新營,2024-10-28,9693
4142,國光生,8,0,8,富邦-新營,2024-10-28,9693
00720B,元大投資級公司債,8,0,8,富邦-新營,2024-10-28,9693
6142,友勁,8,0,8,富邦-新營,2024-10-28,9693
8076,伍豐,8,0,8,富邦-新營,2024-10-28,9693
2369,菱生,7,0,7,富邦-新營,2024-10-28,9693
00905,FT臺灣Smart,6,0,6,富邦-新營,2024-10-28,9693
6505,台塑化,6,0,6,富邦-新營,2024-10-28,9693
2243,宏旭-KY,6,0,6,富邦-新營,2024-10-28,9693
2329,華泰,6,0,6,富邦-新營,2024-10-28,9693
3062,建漢,8,2,6,富邦-新營,2024-10-28,9693
6829,千附精密,16,10,6,富邦-新營,2024-10-28,9693
0056,元大高股息,5,0,5,富邦-新營,2024-10-28,9693
2633,台灣高鐵,151,0,151,富邦-新營,2024-10-29,9693
3217,優群,94,2,92,富邦-新營,2024-10-29,9693
1464,得力,85,0,85,富邦-新營,2024-10-29,9693
00929,復華台灣科技優息,92,12,80,富邦-新營,2024-10-29,9693
0056,元大高股息,79,3,76,富邦-新營,2024-10-29,9693
00953B,群益優選非投等債,70,0,70,富邦-新營,2024-10-29,9693
00959B,大華投等美債15Y+,70,0,70,富邦-新營,2024-10-29,9693
00943,兆豐電子高息等權,61,0,61,富邦-新營,2024-10-29,9693
00715L,期街口布蘭特正2,59,0,59,富邦-新營,2024-10-29,9693
00878,國泰永續高股息,56,4,52,富邦-新營,2024-10-29,9693
2303,聯電,53,3,50,富邦-新營,2024-10-29,9693
00665L,富邦�琤肭磪囓�2,50,0,50,富邦-新營,2024-10-29,9693
00918,大華優利高填息30,29,0,29,富邦-新營,2024-10-29,9693
2241,艾姆勒,25,0,25,富邦-新營,2024-10-29,9693
00712,復華富時不動產,25,1,24,富邦-新營,2024-10-29,9693
00892,富邦台灣半導體,20,0,20,富邦-新營,2024-10-29,9693
00919,群益台灣精選高息,74,56,18,富邦-新營,2024-10-29,9693
1536,和大,17,0,17,富邦-新營,2024-10-29,9693
2317,鴻海,31,15,16,富邦-新營,2024-10-29,9693
00926,凱基全球菁英55,16,0,16,富邦-新營,2024-10-29,9693
2344,華邦電,16,1,15,富邦-新營,2024-10-29,9693
1909,榮成,14,0,14,富邦-新營,2024-10-29,9693
3450,聯鈞,21,7,14,富邦-新營,2024-10-29,9693
00887,永豐中國科技50大,17,4,13,富邦-新營,2024-10-29,9693
3481,群創,13,0,13,富邦-新營,2024-10-29,9693
8032,光菱,42,30,12,富邦-新營,2024-10-29,9693
00907,永豐優息存股,12,0,12,富邦-新營,2024-10-29,9693
00692,富邦公司治理,12,0,12,富邦-新營,2024-10-29,9693
0050,元大台灣50,12,0,12,富邦-新營,2024-10-29,9693
00642U,期元大S＆P石油,11,0,11,富邦-新營,2024-10-29,9693
4147,中裕,11,0,11,富邦-新營,2024-10-29,9693
2887,台新金,12,1,11,富邦-新營,2024-10-29,9693
5880,合庫金,14,3,11,富邦-新營,2024-10-29,9693
00922,國泰台灣領袖50,14,4,10,富邦-新營,2024-10-29,9693
1513,中興電,10,0,10,富邦-新營,2024-10-29,9693
3055,蔚華科,11,1,10,富邦-新營,2024-10-29,9693
4960,誠美材,10,0,10,富邦-新營,2024-10-29,9693
6114,久威,10,0,10,富邦-新營,2024-10-29,9693
6505,台塑化,10,0,10,富邦-新營,2024-10-29,9693
5371,中光電,10,0,10,富邦-新營,2024-10-29,9693
2330,台積電,12,2,10,富邦-新營,2024-10-29,9693
1718,中纖,9,0,9,富邦-新營,2024-10-29,9693
3037,欣興,10,1,9,富邦-新營,2024-10-29,9693
3062,建漢,9,0,9,富邦-新營,2024-10-29,9693
1530,亞崴,8,0,8,富邦-新營,2024-10-29,9693
3550,聯穎,9,1,8,富邦-新營,2024-10-29,9693
2617,台航,7,0,7,富邦-新營,2024-10-29,9693
00952,凱基台灣AI50,7,0,7,富邦-新營,2024-10-29,9693
1314,中石化,7,0,7,富邦-新營,2024-10-29,9693
2883,凱基金,7,0,7,富邦-新營,2024-10-29,9693
1309,台達化,160,0,160,富邦-新營,2024-10-30,9693
00959B,大華投等美債15Y+,151,0,151,富邦-新營,2024-10-30,9693
00632R,元大台灣50反1,100,7,93,富邦-新營,2024-10-30,9693
8107,大億金茂,75,17,58,富邦-新營,2024-10-30,9693
00943,兆豐電子高息等權,56,0,56,富邦-新營,2024-10-30,9693
00665L,富邦�琤肭磪囓�2,51,0,51,富邦-新營,2024-10-30,9693
1605,華新,40,0,40,富邦-新營,2024-10-30,9693
00634R,富邦上証反1,40,0,40,富邦-新營,2024-10-30,9693
00715L,期街口布蘭特正2,35,5,30,富邦-新營,2024-10-30,9693
00679B,元大美債20年,32,2,30,富邦-新營,2024-10-30,9693
2323,中環,21,0,21,富邦-新營,2024-10-30,9693
1528,恩德,41,22,19,富邦-新營,2024-10-30,9693
2312,金寶,28,11,17,富邦-新營,2024-10-30,9693
00919,群益台灣精選高息,19,2,17,富邦-新營,2024-10-30,9693
6133,金橋,23,7,16,富邦-新營,2024-10-30,9693
3264,欣銓,15,0,15,富邦-新營,2024-10-30,9693
2303,聯電,19,5,14,富邦-新營,2024-10-30,9693
0056,元大高股息,14,0,14,富邦-新營,2024-10-30,9693
2327,國巨,18,5,13,富邦-新營,2024-10-30,9693
2241,艾姆勒,13,0,13,富邦-新營,2024-10-30,9693
00712,復華富時不動產,12,0,12,富邦-新營,2024-10-30,9693
4919,新唐,21,9,12,富邦-新營,2024-10-30,9693
6142,友勁,13,1,12,富邦-新營,2024-10-30,9693
1815,富喬,11,0,11,富邦-新營,2024-10-30,9693
2337,旺宏,11,0,11,富邦-新營,2024-10-30,9693
3086,華義,11,0,11,富邦-新營,2024-10-30,9693
6191,精成科,13,2,11,富邦-新營,2024-10-30,9693
00936,台新永續高息中小,10,0,10,富邦-新營,2024-10-30,9693
1904,正隆,10,0,10,富邦-新營,2024-10-30,9693
2408,南亞科,13,3,10,富邦-新營,2024-10-30,9693
3483,力致,10,0,10,富邦-新營,2024-10-30,9693
4714,永捷,10,0,10,富邦-新營,2024-10-30,9693
2646,星宇航空,10,1,9,富邦-新營,2024-10-30,9693
2027,大成鋼,9,0,9,富邦-新營,2024-10-30,9693
00887,永豐中國科技50大,10,2,8,富邦-新營,2024-10-30,9693
6182,合晶,8,0,8,富邦-新營,2024-10-30,9693
3149,正達,10,2,8,富邦-新營,2024-10-30,9693
1909,榮成,7,0,7,富邦-新營,2024-10-30,9693
006208,富邦台50,6,0,6,富邦-新營,2024-10-30,9693
5371,中光電,6,0,6,富邦-新營,2024-10-30,9693
4532,瑞智,6,0,6,富邦-新營,2024-10-30,9693
00637L,元大滬深300正2,16,10,6,富邦-新營,2024-10-30,9693
2406,國碩,6,0,6,富邦-新營,2024-10-30,9693
3066,李洲,8,2,6,富邦-新營,2024-10-30,9693
4935,茂林-KY,8,2,6,富邦-新營,2024-10-30,9693
8429,金麗-KY,9,3,6,富邦-新營,2024-10-30,9693
00643,群益深証中小,5,0,5,富邦-新營,2024-10-30,9693
00751B,元大AAA至A公司債,5,0,5,富邦-新營,2024-10-30,9693
2208,台船,7,2,5,富邦-新營,2024-10-30,9693
2436,偉詮電,5,0,5,富邦-新營,2024-10-30,9693
1309,台達化,112,0,112,富邦-新營,2024-11-01,9693
00712,復華富時不動產,88,0,88,富邦-新營,2024-11-01,9693
00929,復華台灣科技優息,74,5,69,富邦-新營,2024-11-01,9693
3088,艾訊,64,0,64,富邦-新營,2024-11-01,9693
00830,國泰費城半導體,54,0,54,富邦-新營,2024-11-01,9693
00919,群益台灣精選高息,54,0,54,富邦-新營,2024-11-01,9693
00943,兆豐電子高息等權,50,1,49,富邦-新營,2024-11-01,9693
00878,國泰永續高股息,52,5,47,富邦-新營,2024-11-01,9693
2303,聯電,44,2,42,富邦-新營,2024-11-01,9693
2354,鴻準,82,51,31,富邦-新營,2024-11-01,9693
1721,三晃,26,1,25,富邦-新營,2024-11-01,9693
00679B,元大美債20年,23,0,23,富邦-新營,2024-11-01,9693
2646,星宇航空,21,2,19,富邦-新營,2024-11-01,9693
0056,元大高股息,16,0,16,富邦-新營,2024-11-01,9693
00662,富邦NASDAQ,15,0,15,富邦-新營,2024-11-01,9693
2405,輔信,16,1,15,富邦-新營,2024-11-01,9693
2317,鴻海,27,13,14,富邦-新營,2024-11-01,9693
3481,群創,14,1,13,富邦-新營,2024-11-01,9693
3324,雙鴻,29,19,10,富邦-新營,2024-11-01,9693
1314,中石化,11,1,10,富邦-新營,2024-11-01,9693
2349,錸德,10,0,10,富邦-新營,2024-11-01,9693
2801,彰銀,10,0,10,富邦-新營,2024-11-01,9693
8070,長華*,10,0,10,富邦-新營,2024-11-01,9693
9103,美德醫療-DR,10,0,10,富邦-新營,2024-11-01,9693
00937B,群益ESG投等債20,15,6,9,富邦-新營,2024-11-01,9693
1524,耿鼎,9,0,9,富邦-新營,2024-11-01,9693
006208,富邦台50,8,0,8,富邦-新營,2024-11-01,9693
00900,富邦特選高股息30,8,0,8,富邦-新營,2024-11-01,9693
00945B,凱基美國非投等債,8,0,8,富邦-新營,2024-11-01,9693
6757,台灣虎航,8,0,8,富邦-新營,2024-11-01,9693
8183,精星,8,0,8,富邦-新營,2024-11-01,9693
1785,光洋科,7,0,7,富邦-新營,2024-11-01,9693
00915,凱基優選高股息30,7,0,7,富邦-新營,2024-11-01,9693
3013,晟銘電,9,2,7,富邦-新營,2024-11-01,9693
6505,台塑化,7,1,6,富邦-新營,2024-11-01,9693
3105,穩懋,10,4,6,富邦-新營,2024-11-01,9693
1326,台化,6,0,6,富邦-新營,2024-11-01,9693
00887,永豐中國科技50大,6,0,6,富邦-新營,2024-11-01,9693
4566,時碩工業,6,0,6,富邦-新營,2024-11-01,9693
6248,沛波,8,2,6,富邦-新營,2024-11-01,9693
2330,台積電,7,1,6,富邦-新營,2024-11-01,9693
6274,台燿,6,1,5,富邦-新營,2024-11-01,9693
5871,中租-KY,5,0,5,富邦-新營,2024-11-01,9693
00933B,國泰10Y+金融債,5,0,5,富邦-新營,2024-11-01,9693
00740B,富邦全球投等債,5,0,5,富邦-新營,2024-11-01,9693
00912,中信臺灣智慧50,5,0,5,富邦-新營,2024-11-01,9693
2392,正崴,5,0,5,富邦-新營,2024-11-01,9693
2601,益航,5,0,5,富邦-新營,2024-11-01,9693
3031,佰鴻,5,0,5,富邦-新營,2024-11-01,9693
3260,威剛,5,0,5,富邦-新營,2024-11-01,9693
00715L,期街口布蘭特正2,1082,54,1028,富邦-新營,2024-11-04,9693
1309,台達化,95,0,95,富邦-新營,2024-11-04,9693
00637L,元大滬深300正2,65,0,65,富邦-新營,2024-11-04,9693
00878,國泰永續高股息,63,2,61,富邦-新營,2024-11-04,9693
3088,艾訊,56,0,56,富邦-新營,2024-11-04,9693
00680L,元大美債20正2,70,15,55,富邦-新營,2024-11-04,9693
3013,晟銘電,103,54,49,富邦-新營,2024-11-04,9693
2241,艾姆勒,42,0,42,富邦-新營,2024-11-04,9693
2303,聯電,30,0,30,富邦-新營,2024-11-04,9693
9105,泰金寶-DR,50,22,28,富邦-新營,2024-11-04,9693
00712,復華富時不動產,27,0,27,富邦-新營,2024-11-04,9693
00919,群益台灣精選高息,57,30,27,富邦-新營,2024-11-04,9693
2409,友達,22,2,20,富邦-新營,2024-11-04,9693
00665L,富邦�琤肭磪囓�2,20,0,20,富邦-新營,2024-11-04,9693
1595,川寶,20,0,20,富邦-新營,2024-11-04,9693
6506,雙邦,20,0,20,富邦-新營,2024-11-04,9693
6741,91APP*-KY,18,0,18,富邦-新營,2024-11-04,9693
3702,大聯大,15,0,15,富邦-新營,2024-11-04,9693
2615,萬海,61,46,15,富邦-新營,2024-11-04,9693
6187,萬潤,52,39,13,富邦-新營,2024-11-04,9693
8249,菱光,30,17,13,富邦-新營,2024-11-04,9693
00943,兆豐電子高息等權,12,0,12,富邦-新營,2024-11-04,9693
00945B,凱基美國非投等債,12,0,12,富邦-新營,2024-11-04,9693
2887,台新金,10,0,10,富邦-新營,2024-11-04,9693
00915,凱基優選高股息30,10,0,10,富邦-新營,2024-11-04,9693
00753L,中信中國50正2,10,0,10,富邦-新營,2024-11-04,9693
2388,威盛,10,0,10,富邦-新營,2024-11-04,9693
3710,連展投控,10,0,10,富邦-新營,2024-11-04,9693
6015,宏遠證,10,0,10,富邦-新營,2024-11-04,9693
6191,精成科,10,0,10,富邦-新營,2024-11-04,9693
8429,金麗-KY,12,3,9,富邦-新營,2024-11-04,9693
0056,元大高股息,9,0,9,富邦-新營,2024-11-04,9693
2609,陽明,23,15,8,富邦-新營,2024-11-04,9693
00953B,群益優選非投等債,8,0,8,富邦-新營,2024-11-04,9693
6133,金橋,9,1,8,富邦-新營,2024-11-04,9693
6197,佳必琪,9,1,8,富邦-新營,2024-11-04,9693
2646,星宇航空,8,1,7,富邦-新營,2024-11-04,9693
00948B,中信優息投資級債,7,0,7,富邦-新營,2024-11-04,9693
1815,富喬,7,0,7,富邦-新營,2024-11-04,9693
2323,中環,7,0,7,富邦-新營,2024-11-04,9693
2426,鼎元,8,1,7,富邦-新營,2024-11-04,9693
2603,長榮,7,1,6,富邦-新營,2024-11-04,9693
00891,中信關鍵半導體,6,0,6,富邦-新營,2024-11-04,9693
2233,宇隆,6,0,6,富邦-新營,2024-11-04,9693
3062,建漢,109,103,6,富邦-新營,2024-11-04,9693
4903,聯光通,11,5,6,富邦-新營,2024-11-04,9693
6153,嘉聯益,6,0,6,富邦-新營,2024-11-04,9693
8390,金益鼎,6,0,6,富邦-新營,2024-11-04,9693
00946,群益科技高息成長,6,0,6,富邦-新營,2024-11-04,9693
00687B,國泰20年美債,5,0,5,富邦-新營,2024-11-04,9693
1309,台達化,73,0,73,富邦-新營,2024-11-05,9693
00937B,群益ESG投等債20,70,17,53,富邦-新營,2024-11-05,9693
00720B,元大投資級公司債,50,0,50,富邦-新營,2024-11-05,9693
2888,新光金,40,0,40,富邦-新營,2024-11-05,9693
00712,復華富時不動產,39,0,39,富邦-新營,2024-11-05,9693
00919,群益台灣精選高息,38,0,38,富邦-新營,2024-11-05,9693
00878,國泰永續高股息,38,4,34,富邦-新營,2024-11-05,9693
2303,聯電,34,3,31,富邦-新營,2024-11-05,9693
1409,新纖,30,0,30,富邦-新營,2024-11-05,9693
2344,華邦電,29,1,28,富邦-新營,2024-11-05,9693
00946,群益科技高息成長,22,0,22,富邦-新營,2024-11-05,9693
3372,典範,21,0,21,富邦-新營,2024-11-05,9693
2328,廣宇,19,0,19,富邦-新營,2024-11-05,9693
00679B,元大美債20年,28,11,17,富邦-新營,2024-11-05,9693
8047,星雲,31,15,16,富邦-新營,2024-11-05,9693
0056,元大高股息,15,0,15,富邦-新營,2024-11-05,9693
3062,建漢,18,3,15,富邦-新營,2024-11-05,9693
00933B,國泰10Y+金融債,12,0,12,富邦-新營,2024-11-05,9693
6274,台燿,12,2,10,富邦-新營,2024-11-05,9693
00680L,元大美債20正2,20,10,10,富邦-新營,2024-11-05,9693
00941,中信上游半導體,10,0,10,富邦-新營,2024-11-05,9693
1595,川寶,30,20,10,富邦-新營,2024-11-05,9693
3088,艾訊,10,0,10,富邦-新營,2024-11-05,9693
3390,旭軟,10,0,10,富邦-新營,2024-11-05,9693
3522,御嵿,10,0,10,富邦-新營,2024-11-05,9693
4950,牧東,10,0,10,富邦-新營,2024-11-05,9693
3060,銘異,10,0,10,富邦-新營,2024-11-05,9693
1531,高林股,13,5,8,富邦-新營,2024-11-05,9693
2399,映泰,9,1,8,富邦-新營,2024-11-05,9693
00844B,新光15年IG金融債,7,0,7,富邦-新營,2024-11-05,9693
1449,佳和,6,0,6,富邦-新營,2024-11-05,9693
1528,恩德,15,9,6,富邦-新營,2024-11-05,9693
6757,台灣虎航,6,0,6,富邦-新營,2024-11-05,9693
00905,FT臺灣Smart,6,0,6,富邦-新營,2024-11-05,9693
2887,台新金,5,0,5,富邦-新營,2024-11-05,9693
006208,富邦台50,6,1,5,富邦-新營,2024-11-05,9693
00943,兆豐電子高息等權,5,0,5,富邦-新營,2024-11-05,9693
1909,榮成,5,0,5,富邦-新營,2024-11-05,9693
2408,南亞科,6,1,5,富邦-新營,2024-11-05,9693
2498,宏達電,5,0,5,富邦-新營,2024-11-05,9693
2812,台中銀,5,0,5,富邦-新營,2024-11-05,9693
6530,創威,26,21,5,富邦-新營,2024-11-05,9693
8011,台通,5,0,5,富邦-新營,2024-11-05,9693
9103,美德醫療-DR,5,0,5,富邦-新營,2024-11-05,9693
1540,喬福,23,18,5,富邦-新營,2024-11-05,9693
8044,網家,6,2,4,富邦-新營,2024-11-05,9693
2890,永豐金,4,0,4,富邦-新營,2024-11-05,9693
2312,金寶,40,36,4,富邦-新營,2024-11-05,9693
2374,佳能,4,0,4,富邦-新營,2024-11-05,9693
3630,新鉅科,4,0,4,富邦-新營,2024-11-05,9693
00680L,元大美債20正2,307,55,252,富邦-新營,2024-11-06,9693
9907,統一實,100,0,100,富邦-新營,2024-11-06,9693
00753L,中信中國50正2,95,0,95,富邦-新營,2024-11-06,9693
00665L,富邦�琤肭磪囓�2,80,0,80,富邦-新營,2024-11-06,9693
3013,晟銘電,102,27,75,富邦-新營,2024-11-06,9693
00679B,元大美債20年,85,29,56,富邦-新營,2024-11-06,9693
00687B,國泰20年美債,44,5,39,富邦-新營,2024-11-06,9693
00637L,元大滬深300正2,90,57,33,富邦-新營,2024-11-06,9693
2241,艾姆勒,90,68,22,富邦-新營,2024-11-06,9693
8070,長華*,26,6,20,富邦-新營,2024-11-06,9693
6438,迅得,21,1,20,富邦-新營,2024-11-06,9693
00712,復華富時不動產,19,0,19,富邦-新營,2024-11-06,9693
5438,東友,20,2,18,富邦-新營,2024-11-06,9693
00937B,群益ESG投等債20,25,8,17,富邦-新營,2024-11-06,9693
00905,FT臺灣Smart,16,0,16,富邦-新營,2024-11-06,9693
2887,台新金,16,0,16,富邦-新營,2024-11-06,9693
00795B,中信美國公債20年,15,0,15,富邦-新營,2024-11-06,9693
00673R,期元大S＆P原油反1,14,0,14,富邦-新營,2024-11-06,9693
00915,凱基優選高股息30,13,0,13,富邦-新營,2024-11-06,9693
00922,國泰台灣領袖50,11,0,11,富邦-新營,2024-11-06,9693
5347,世界,12,2,10,富邦-新營,2024-11-06,9693
00715L,期街口布蘭特正2,23,13,10,富邦-新營,2024-11-06,9693
2031,新光鋼,10,0,10,富邦-新營,2024-11-06,9693
2070,精湛,10,0,10,富邦-新營,2024-11-06,9693
2338,光罩,10,0,10,富邦-新營,2024-11-06,9693
4935,茂林-KY,10,0,10,富邦-新營,2024-11-06,9693
00933B,國泰10Y+金融債,9,0,9,富邦-新營,2024-11-06,9693
1718,中纖,9,0,9,富邦-新營,2024-11-06,9693
3490,單井,9,0,9,富邦-新營,2024-11-06,9693
8429,金麗-KY,12,3,9,富邦-新營,2024-11-06,9693
2609,陽明,14,5,9,富邦-新營,2024-11-06,9693
1605,華新,8,0,8,富邦-新營,2024-11-06,9693
2399,映泰,24,16,8,富邦-新營,2024-11-06,9693
3062,建漢,19,11,8,富邦-新營,2024-11-06,9693
3715,定穎投控,9,1,8,富邦-新營,2024-11-06,9693
9914,美利達,8,0,8,富邦-新營,2024-11-06,9693
3149,正達,13,6,7,富邦-新營,2024-11-06,9693
6248,沛波,7,0,7,富邦-新營,2024-11-06,9693
2303,聯電,15,8,7,富邦-新營,2024-11-06,9693
1319,東陽,7,0,7,富邦-新營,2024-11-06,9693
2014,中鴻,10,3,7,富邦-新營,2024-11-06,9693
2419,仲琦,9,2,7,富邦-新營,2024-11-06,9693
00632R,元大台灣50反1,6,0,6,富邦-新營,2024-11-06,9693
1326,台化,8,2,6,富邦-新營,2024-11-06,9693
2328,廣宇,10,4,6,富邦-新營,2024-11-06,9693
2367,燿華,7,1,6,富邦-新營,2024-11-06,9693
8112,至上,6,0,6,富邦-新營,2024-11-06,9693
2834,臺企銀,6,0,6,富邦-新營,2024-11-06,9693
1528,恩德,18,13,5,富邦-新營,2024-11-06,9693
2486,一詮,7,2,5,富邦-新營,2024-11-06,9693
00919,群益台灣精選高息,61,8,53,富邦-新營,2024-11-07,9693
00878,國泰永續高股息,48,2,46,富邦-新營,2024-11-07,9693
00887,永豐中國科技50大,64,30,34,富邦-新營,2024-11-07,9693
00674R,期元大S＆P黃金反1,30,0,30,富邦-新營,2024-11-07,9693
1304,台聚,30,0,30,富邦-新營,2024-11-07,9693
2312,金寶,80,55,25,富邦-新營,2024-11-07,9693
1460,宏遠,30,7,23,富邦-新營,2024-11-07,9693
2014,中鴻,44,22,22,富邦-新營,2024-11-07,9693
00679B,元大美債20年,22,1,21,富邦-新營,2024-11-07,9693
2241,艾姆勒,20,0,20,富邦-新營,2024-11-07,9693
2892,第一金,19,0,19,富邦-新營,2024-11-07,9693
2399,映泰,28,9,19,富邦-新營,2024-11-07,9693
5014,建錩,20,1,19,富邦-新營,2024-11-07,9693
4903,聯光通,30,13,17,富邦-新營,2024-11-07,9693
3189,景碩,17,1,16,富邦-新營,2024-11-07,9693
0056,元大高股息,20,6,14,富邦-新營,2024-11-07,9693
9105,泰金寶-DR,147,136,11,富邦-新營,2024-11-07,9693
3083,網龍,10,0,10,富邦-新營,2024-11-07,9693
4414,如興,10,0,10,富邦-新營,2024-11-07,9693
6873,泓德能源,10,0,10,富邦-新營,2024-11-07,9693
8032,光菱,11,1,10,富邦-新營,2024-11-07,9693
00915,凱基優選高股息30,10,1,9,富邦-新營,2024-11-07,9693
00706L,期元大S＆P日圓正2,8,0,8,富邦-新營,2024-11-07,9693
2425,承啟,8,0,8,富邦-新營,2024-11-07,9693
2328,廣宇,20,13,7,富邦-新營,2024-11-07,9693
8070,長華*,7,0,7,富邦-新營,2024-11-07,9693
8112,至上,7,0,7,富邦-新營,2024-11-07,9693
2356,英業達,33,27,6,富邦-新營,2024-11-07,9693
1104,環泥,6,0,6,富邦-新營,2024-11-07,9693
00894,中信小資高價30,5,0,5,富邦-新營,2024-11-07,9693
00932,兆豐永續高息等權,5,0,5,富邦-新營,2024-11-07,9693
00943,兆豐電子高息等權,5,0,5,富邦-新營,2024-11-07,9693
3031,佰鴻,5,0,5,富邦-新營,2024-11-07,9693
3230,錦明,7,2,5,富邦-新營,2024-11-07,9693
5609,中菲行,5,0,5,富邦-新營,2024-11-07,9693
5880,合庫金,5,0,5,富邦-新營,2024-11-07,9693
6242,立康,5,0,5,富邦-新營,2024-11-07,9693
8069,元太,5,0,5,富邦-新營,2024-11-07,9693
5243,乙盛-KY,6,1,5,富邦-新營,2024-11-07,9693
3231,緯創,9,4,5,富邦-新營,2024-11-07,9693
2881,富邦金,5,0,5,富邦-新營,2024-11-07,9693
00946,群益科技高息成長,4,0,4,富邦-新營,2024-11-07,9693
2330,台積電,5,1,4,富邦-新營,2024-11-07,9693
3017,奇鋐,8,4,4,富邦-新營,2024-11-07,9693
1522,堤維西,5,1,4,富邦-新營,2024-11-07,9693
2323,中環,5,1,4,富邦-新營,2024-11-07,9693
4950,牧東,4,0,4,富邦-新營,2024-11-07,9693
5388,中磊,5,1,4,富邦-新營,2024-11-07,9693
00712,復華富時不動產,4,0,4,富邦-新營,2024-11-07,9693
2388,威盛,13,10,3,富邦-新營,2024-11-07,9693
00712,復華富時不動產,265,1,264,富邦-新營,2024-11-08,9693
9907,統一實,89,0,89,富邦-新營,2024-11-08,9693
00878,國泰永續高股息,87,1,86,富邦-新營,2024-11-08,9693
00753L,中信中國50正2,127,55,72,富邦-新營,2024-11-08,9693
2233,宇隆,55,0,55,富邦-新營,2024-11-08,9693
3062,建漢,111,70,41,富邦-新營,2024-11-08,9693
00795B,中信美國公債20年,41,0,41,富邦-新營,2024-11-08,9693
1605,華新,41,1,40,富邦-新營,2024-11-08,9693
2489,瑞軒,37,2,35,富邦-新營,2024-11-08,9693
00671R,富邦NASDAQ反1,30,0,30,富邦-新營,2024-11-08,9693
00959B,大華投等美債15Y+,30,0,30,富邦-新營,2024-11-08,9693
00891,中信關鍵半導體,27,0,27,富邦-新營,2024-11-08,9693
3710,連展投控,27,0,27,富邦-新營,2024-11-08,9693
8429,金麗-KY,37,12,25,富邦-新營,2024-11-08,9693
1325,恆大,20,0,20,富邦-新營,2024-11-08,9693
2007,燁興,20,0,20,富邦-新營,2024-11-08,9693
2241,艾姆勒,20,0,20,富邦-新營,2024-11-08,9693
2353,宏��,19,0,19,富邦-新營,2024-11-08,9693
2388,威盛,22,4,18,富邦-新營,2024-11-08,9693
8111,立��,31,13,18,富邦-新營,2024-11-08,9693
2392,正崴,39,21,18,富邦-新營,2024-11-08,9693
00937B,群益ESG投等債20,26,11,15,富邦-新營,2024-11-08,9693
1904,正隆,15,0,15,富邦-新營,2024-11-08,9693
3515,華擎,15,0,15,富邦-新營,2024-11-08,9693
1909,榮成,14,0,14,富邦-新營,2024-11-08,9693
2374,佳能,13,0,13,富邦-新營,2024-11-08,9693
2303,聯電,20,8,12,富邦-新營,2024-11-08,9693
2887,台新金,12,0,12,富邦-新營,2024-11-08,9693
00912,中信臺灣智慧50,11,0,11,富邦-新營,2024-11-08,9693
00936,台新永續高息中小,11,0,11,富邦-新營,2024-11-08,9693
1316,上曜,11,0,11,富邦-新營,2024-11-08,9693
6152,百一,11,0,11,富邦-新營,2024-11-08,9693
2613,中櫃,18,8,10,富邦-新營,2024-11-08,9693
00942B,台新美A公司債20+,10,0,10,富邦-新營,2024-11-08,9693
5488,松普,10,0,10,富邦-新營,2024-11-08,9693
6285,啟��,10,0,10,富邦-新營,2024-11-08,9693
8103,瀚荃,10,0,10,富邦-新營,2024-11-08,9693
8096,擎亞,9,0,9,富邦-新營,2024-11-08,9693
6505,台塑化,11,2,9,富邦-新營,2024-11-08,9693
00900,富邦特選高股息30,10,1,9,富邦-新營,2024-11-08,9693
1522,堤維西,9,0,9,富邦-新營,2024-11-08,9693
3049,精金,9,0,9,富邦-新營,2024-11-08,9693
8076,伍豐,9,0,9,富邦-新營,2024-11-08,9693
1815,富喬,9,1,8,富邦-新營,2024-11-08,9693
2642,宅配通,8,0,8,富邦-新營,2024-11-08,9693
3689,湧德,8,0,8,富邦-新營,2024-11-08,9693
6261,久元,8,0,8,富邦-新營,2024-11-08,9693
2317,鴻海,21,14,7,富邦-新營,2024-11-08,9693
00673R,期元大S＆P原油反1,7,0,7,富邦-新營,2024-11-08,9693
2323,中環,7,0,7,富邦-新營,2024-11-08,9693
00959B,大華投等美債15Y+,170,0,170,富邦-新營,2024-11-11,9693
00878,國泰永續高股息,121,4,117,富邦-新營,2024-11-11,9693
2317,鴻海,117,8,109,富邦-新營,2024-11-11,9693
00665L,富邦�琤肭磪囓�2,135,32,103,富邦-新營,2024-11-11,9693
3231,緯創,100,19,81,富邦-新營,2024-11-11,9693
2609,陽明,60,0,60,富邦-新營,2024-11-11,9693
2834,臺企銀,54,0,54,富邦-新營,2024-11-11,9693
1584,精剛,48,0,48,富邦-新營,2024-11-11,9693
6285,啟��,46,0,46,富邦-新營,2024-11-11,9693
9907,統一實,45,0,45,富邦-新營,2024-11-11,9693
1605,華新,39,0,39,富邦-新營,2024-11-11,9693
1447,力鵬,30,0,30,富邦-新營,2024-11-11,9693
2233,宇隆,30,0,30,富邦-新營,2024-11-11,9693
2354,鴻準,37,8,29,富邦-新營,2024-11-11,9693
00637L,元大滬深300正2,29,0,29,富邦-新營,2024-11-11,9693
00922,國泰台灣領袖50,22,1,21,富邦-新營,2024-11-11,9693
2409,友達,21,0,21,富邦-新營,2024-11-11,9693
00900,富邦特選高股息30,21,0,21,富邦-新營,2024-11-11,9693
2108,南帝,20,0,20,富邦-新營,2024-11-11,9693
00753L,中信中國50正2,17,0,17,富邦-新營,2024-11-11,9693
2855,統一證,15,0,15,富邦-新營,2024-11-11,9693
2449,京元電子,16,2,14,富邦-新營,2024-11-11,9693
1449,佳和,26,12,14,富邦-新營,2024-11-11,9693
2020,美亞,14,0,14,富邦-新營,2024-11-11,9693
5243,乙盛-KY,16,2,14,富邦-新營,2024-11-11,9693
3062,建漢,33,20,13,富邦-新營,2024-11-11,9693
00713,元大台灣高息低波,12,0,12,富邦-新營,2024-11-11,9693
3481,群創,32,21,11,富邦-新營,2024-11-11,9693
00930,永豐ESG低碳高息,11,0,11,富邦-新營,2024-11-11,9693
2408,南亞科,12,1,11,富邦-新營,2024-11-11,9693
2605,新興,12,1,11,富邦-新營,2024-11-11,9693
00918,大華優利高填息30,14,4,10,富邦-新營,2024-11-11,9693
00891,中信關鍵半導體,10,0,10,富邦-新營,2024-11-11,9693
2601,益航,10,0,10,富邦-新營,2024-11-11,9693
4414,如興,10,0,10,富邦-新營,2024-11-11,9693
5488,松普,10,0,10,富邦-新營,2024-11-11,9693
5608,四維航,10,0,10,富邦-新營,2024-11-11,9693
8032,光菱,80,70,10,富邦-新營,2024-11-11,9693
2329,華泰,10,1,9,富邦-新營,2024-11-11,9693
5536,聖暉*,9,0,9,富邦-新營,2024-11-11,9693
8043,蜜望實,9,0,9,富邦-新營,2024-11-11,9693
3303,岱稜,20,11,9,富邦-新營,2024-11-11,9693
3047,訊舟,26,18,8,富邦-新營,2024-11-11,9693
6763,綠界科技*,72,64,8,富邦-新營,2024-11-11,9693
1326,台化,7,0,7,富邦-新營,2024-11-11,9693
00673R,期元大S＆P原油反1,7,0,7,富邦-新營,2024-11-11,9693
1785,光洋科,8,1,7,富邦-新營,2024-11-11,9693
2633,台灣高鐵,7,0,7,富邦-新營,2024-11-11,9693
3580,友威科,9,2,7,富邦-新營,2024-11-11,9693
8429,金麗-KY,10,3,7,富邦-新營,2024-11-11,9693
00878,國泰永續高股息,174,0,174,富邦-新營,2024-11-12,9693
2892,第一金,158,1,157,富邦-新營,2024-11-12,9693
00676R,富邦臺灣加權反1,110,0,110,富邦-新營,2024-11-12,9693
00919,群益台灣精選高息,87,26,61,富邦-新營,2024-11-12,9693
9907,統一實,55,0,55,富邦-新營,2024-11-12,9693
2356,英業達,47,2,45,富邦-新營,2024-11-12,9693
00932,兆豐永續高息等權,42,0,42,富邦-新營,2024-11-12,9693
2344,華邦電,40,1,39,富邦-新營,2024-11-12,9693
0056,元大高股息,39,0,39,富邦-新營,2024-11-12,9693
00675L,富邦臺灣加權正2,35,0,35,富邦-新營,2024-11-12,9693
2241,艾姆勒,40,5,35,富邦-新營,2024-11-12,9693
1314,中石化,31,0,31,富邦-新營,2024-11-12,9693
2845,遠東銀,30,0,30,富邦-新營,2024-11-12,9693
2201,裕隆,30,0,30,富邦-新營,2024-11-12,9693
1447,力鵬,30,0,30,富邦-新營,2024-11-12,9693
3481,群創,27,0,27,富邦-新營,2024-11-12,9693
5880,合庫金,27,1,26,富邦-新營,2024-11-12,9693
00715L,期街口布蘭特正2,26,0,26,富邦-新營,2024-11-12,9693
2353,宏��,26,3,23,富邦-新營,2024-11-12,9693
00915,凱基優選高股息30,27,4,23,富邦-新營,2024-11-12,9693
1904,正隆,22,0,22,富邦-新營,2024-11-12,9693
006208,富邦台50,21,0,21,富邦-新營,2024-11-12,9693
00887,永豐中國科技50大,31,10,21,富邦-新營,2024-11-12,9693
2606,裕民,21,1,20,富邦-新營,2024-11-12,9693
2867,三商壽,20,0,20,富邦-新營,2024-11-12,9693
1301,台塑,19,1,18,富邦-新營,2024-11-12,9693
2615,萬海,29,12,17,富邦-新營,2024-11-12,9693
3211,順達,49,32,17,富邦-新營,2024-11-12,9693
2409,友達,18,2,16,富邦-新營,2024-11-12,9693
00900,富邦特選高股息30,15,0,15,富邦-新營,2024-11-12,9693
1584,精剛,15,0,15,富邦-新營,2024-11-12,9693
4974,亞泰,15,0,15,富邦-新營,2024-11-12,9693
4743,合一,15,1,14,富邦-新營,2024-11-12,9693
5536,聖暉*,13,0,13,富邦-新營,2024-11-12,9693
2313,華通,12,0,12,富邦-新營,2024-11-12,9693
2393,億光,12,0,12,富邦-新營,2024-11-12,9693
2312,金寶,22,11,11,富邦-新營,2024-11-12,9693
1721,三晃,11,0,11,富邦-新營,2024-11-12,9693
8240,華宏,13,2,11,富邦-新營,2024-11-12,9693
5871,中租-KY,11,0,11,富邦-新營,2024-11-12,9693
6223,旺矽,20,10,10,富邦-新營,2024-11-12,9693
3322,建舜電,10,0,10,富邦-新營,2024-11-12,9693
6288,聯嘉,10,0,10,富邦-新營,2024-11-12,9693
8121,越峰,10,0,10,富邦-新營,2024-11-12,9693
3231,緯創,14,5,9,富邦-新營,2024-11-12,9693
2834,臺企銀,9,0,9,富邦-新營,2024-11-12,9693
2330,台積電,11,2,9,富邦-新營,2024-11-12,9693
3356,奇偶,10,1,9,富邦-新營,2024-11-12,9693
2002,中鋼,9,0,9,富邦-新營,2024-11-12,9693
5398,慕康生醫,9,0,9,富邦-新營,2024-11-12,9693
00686R,群益臺灣加權反1,400,0,400,富邦-新營,2024-11-13,9693
00687B,國泰20年美債,135,0,135,富邦-新營,2024-11-13,9693
00680L,元大美債20正2,128,0,128,富邦-新營,2024-11-13,9693
00878,國泰永續高股息,96,0,96,富邦-新營,2024-11-13,9693
00948B,中信優息投資級債,100,30,70,富邦-新營,2024-11-13,9693
2303,聯電,57,1,56,富邦-新營,2024-11-13,9693
00959B,大華投等美債15Y+,50,0,50,富邦-新營,2024-11-13,9693
5488,松普,40,0,40,富邦-新營,2024-11-13,9693
2609,陽明,40,1,39,富邦-新營,2024-11-13,9693
2323,中環,32,0,32,富邦-新營,2024-11-13,9693
3481,群創,46,15,31,富邦-新營,2024-11-13,9693
2834,臺企銀,30,0,30,富邦-新營,2024-11-13,9693
2618,長榮航,36,10,26,富邦-新營,2024-11-13,9693
2605,新興,29,6,23,富邦-新營,2024-11-13,9693
0050,元大台灣50,21,0,21,富邦-新營,2024-11-13,9693
00637L,元大滬深300正2,30,10,20,富邦-新營,2024-11-13,9693
00930,永豐ESG低碳高息,20,0,20,富邦-新營,2024-11-13,9693
2845,遠東銀,20,0,20,富邦-新營,2024-11-13,9693
2409,友達,20,1,19,富邦-新營,2024-11-13,9693
2014,中鴻,20,1,19,富邦-新營,2024-11-13,9693
2887,台新金,19,0,19,富邦-新營,2024-11-13,9693
6151,晉倫,67,48,19,富邦-新營,2024-11-13,9693
2354,鴻準,28,10,18,富邦-新營,2024-11-13,9693
1605,華新,18,0,18,富邦-新營,2024-11-13,9693
3003,健和興,24,6,18,富邦-新營,2024-11-13,9693
4909,新復興,18,1,17,富邦-新營,2024-11-13,9693
2392,正崴,83,66,17,富邦-新營,2024-11-13,9693
2330,台積電,17,0,17,富邦-新營,2024-11-13,9693
3189,景碩,19,2,17,富邦-新營,2024-11-13,9693
4763,材料-KY,16,0,16,富邦-新營,2024-11-13,9693
0056,元大高股息,15,0,15,富邦-新營,2024-11-13,9693
1752,南光,15,0,15,富邦-新營,2024-11-13,9693
3230,錦明,16,1,15,富邦-新營,2024-11-13,9693
00919,群益台灣精選高息,13,0,13,富邦-新營,2024-11-13,9693
00679B,元大美債20年,15,2,13,富邦-新營,2024-11-13,9693
2882,國泰金,11,0,11,富邦-新營,2024-11-13,9693
2883,凱基金,13,2,11,富邦-新營,2024-11-13,9693
00934,中信成長高股息,11,0,11,富邦-新營,2024-11-13,9693
00712,復華富時不動產,22,12,10,富邦-新營,2024-11-13,9693
00935,野村臺灣新科技50,10,0,10,富邦-新營,2024-11-13,9693
1909,榮成,10,0,10,富邦-新營,2024-11-13,9693
2105,正新,10,0,10,富邦-新營,2024-11-13,9693
2511,太子,10,0,10,富邦-新營,2024-11-13,9693
6163,華電網,10,0,10,富邦-新營,2024-11-13,9693
8032,光菱,10,0,10,富邦-新營,2024-11-13,9693
006208,富邦台50,9,0,9,富邦-新營,2024-11-13,9693
2892,第一金,9,0,9,富邦-新營,2024-11-13,9693
1904,正隆,12,3,9,富邦-新營,2024-11-13,9693
5536,聖暉*,9,0,9,富邦-新營,2024-11-13,9693
2367,燿華,9,0,9,富邦-新營,2024-11-13,9693
00878,國泰永續高股息,195,7,188,富邦-新營,2024-11-14,9693
00680L,元大美債20正2,118,0,118,富邦-新營,2024-11-14,9693
00753L,中信中國50正2,113,3,110,富邦-新營,2024-11-14,9693
00919,群益台灣精選高息,91,0,91,富邦-新營,2024-11-14,9693
00929,復華台灣科技優息,110,28,82,富邦-新營,2024-11-14,9693
0056,元大高股息,46,0,46,富邦-新營,2024-11-14,9693
2892,第一金,45,1,44,富邦-新營,2024-11-14,9693
00687B,國泰20年美債,51,7,44,富邦-新營,2024-11-14,9693
2303,聯電,46,3,43,富邦-新營,2024-11-14,9693
00679B,元大美債20年,41,0,41,富邦-新營,2024-11-14,9693
3015,全漢,62,30,32,富邦-新營,2024-11-14,9693
00637L,元大滬深300正2,37,5,32,富邦-新營,2024-11-14,9693
2845,遠東銀,28,0,28,富邦-新營,2024-11-14,9693
00930,永豐ESG低碳高息,26,0,26,富邦-新營,2024-11-14,9693
6153,嘉聯益,24,2,22,富邦-新營,2024-11-14,9693
4956,光鋐,21,0,21,富邦-新營,2024-11-14,9693
3481,群創,41,20,21,富邦-新營,2024-11-14,9693
00937B,群益ESG投等債20,19,0,19,富邦-新營,2024-11-14,9693
00915,凱基優選高股息30,19,0,19,富邦-新營,2024-11-14,9693
2887,台新金,16,0,16,富邦-新營,2024-11-14,9693
2408,南亞科,16,1,15,富邦-新營,2024-11-14,9693
3413,京鼎,15,0,15,富邦-新營,2024-11-14,9693
2312,金寶,33,19,14,富邦-新營,2024-11-14,9693
2344,華邦電,14,1,13,富邦-新營,2024-11-14,9693
4510,高鋒,12,0,12,富邦-新營,2024-11-14,9693
00943,兆豐電子高息等權,11,0,11,富邦-新營,2024-11-14,9693
006208,富邦台50,11,0,11,富邦-新營,2024-11-14,9693
1314,中石化,11,0,11,富邦-新營,2024-11-14,9693
2449,京元電子,12,1,11,富邦-新營,2024-11-14,9693
3025,星通,10,0,10,富邦-新營,2024-11-14,9693
00963,中信全球高股息,10,0,10,富邦-新營,2024-11-14,9693
2201,裕隆,10,0,10,富邦-新營,2024-11-14,9693
2338,光罩,10,0,10,富邦-新營,2024-11-14,9693
3049,精金,10,0,10,富邦-新營,2024-11-14,9693
6116,彩晶,10,0,10,富邦-新營,2024-11-14,9693
9934,成霖,10,0,10,富邦-新營,2024-11-14,9693
2884,玉山金,10,0,10,富邦-新營,2024-11-14,9693
00959B,大華投等美債15Y+,9,0,9,富邦-新營,2024-11-14,9693
3597,映興,11,2,9,富邦-新營,2024-11-14,9693
5871,中租-KY,8,0,8,富邦-新營,2024-11-14,9693
2812,台中銀,12,4,8,富邦-新營,2024-11-14,9693
00692,富邦公司治理,8,0,8,富邦-新營,2024-11-14,9693
3189,景碩,9,1,8,富邦-新營,2024-11-14,9693
3163,波若威,7,0,7,富邦-新營,2024-11-14,9693
2392,正崴,17,10,7,富邦-新營,2024-11-14,9693
00631L,元大台灣50正2,7,0,7,富邦-新營,2024-11-14,9693
8111,立��,7,0,7,富邦-新營,2024-11-14,9693
2324,仁寶,19,12,7,富邦-新營,2024-11-14,9693
2317,鴻海,23,17,6,富邦-新營,2024-11-14,9693
00706L,期元大S＆P日圓正2,6,0,6,富邦-新營,2024-11-14,9693
00878,國泰永續高股息,322,19,303,富邦-新營,2024-11-15,9693
00929,復華台灣科技優息,221,14,207,富邦-新營,2024-11-15,9693
2027,大成鋼,61,2,59,富邦-新營,2024-11-15,9693
00830,國泰費城半導體,52,0,52,富邦-新營,2024-11-15,9693
3481,群創,45,4,41,富邦-新營,2024-11-15,9693
2382,廣達,36,2,34,富邦-新營,2024-11-15,9693
2317,鴻海,46,15,31,富邦-新營,2024-11-15,9693
6220,岳豐,25,0,25,富邦-新營,2024-11-15,9693
3706,神達,84,60,24,富邦-新營,2024-11-15,9693
1904,正隆,23,0,23,富邦-新營,2024-11-15,9693
3081,聯亞,20,0,20,富邦-新營,2024-11-15,9693
4510,高鋒,19,0,19,富邦-新營,2024-11-15,9693
00930,永豐ESG低碳高息,18,0,18,富邦-新營,2024-11-15,9693
2646,星宇航空,18,0,18,富邦-新營,2024-11-15,9693
00887,永豐中國科技50大,16,0,16,富邦-新營,2024-11-15,9693
9105,泰金寶-DR,37,24,13,富邦-新營,2024-11-15,9693
5871,中租-KY,14,2,12,富邦-新營,2024-11-15,9693
00637L,元大滬深300正2,12,0,12,富邦-新營,2024-11-15,9693
2887,台新金,11,0,11,富邦-新營,2024-11-15,9693
3230,錦明,12,1,11,富邦-新營,2024-11-15,9693
00900,富邦特選高股息30,10,0,10,富邦-新營,2024-11-15,9693
1709,和益,10,0,10,富邦-新營,2024-11-15,9693
2392,正崴,14,4,10,富邦-新營,2024-11-15,9693
2641,正德,10,0,10,富邦-新營,2024-11-15,9693
4147,中裕,10,0,10,富邦-新營,2024-11-15,9693
6405,悅城,23,13,10,富邦-新營,2024-11-15,9693
2002,中鋼,8,0,8,富邦-新營,2024-11-15,9693
3013,晟銘電,9,1,8,富邦-新營,2024-11-15,9693
00712,復華富時不動產,7,0,7,富邦-新營,2024-11-15,9693
6217,中探針,7,0,7,富邦-新營,2024-11-15,9693
2330,台積電,6,0,6,富邦-新營,2024-11-15,9693
6695,芯鼎,7,1,6,富邦-新營,2024-11-15,9693
2884,玉山金,6,0,6,富邦-新營,2024-11-15,9693
3025,星通,5,0,5,富邦-新營,2024-11-15,9693
00909,國泰數位支付服務,5,0,5,富邦-新營,2024-11-15,9693
3149,正達,5,0,5,富邦-新營,2024-11-15,9693
00665L,富邦�琤肭磪囓�2,6,1,5,富邦-新營,2024-11-15,9693
00720B,元大投資級公司債,5,0,5,富邦-新營,2024-11-15,9693
00943,兆豐電子高息等權,5,0,5,富邦-新營,2024-11-15,9693
1440,南紡,5,0,5,富邦-新營,2024-11-15,9693
1466,聚隆,5,0,5,富邦-新營,2024-11-15,9693
2425,承啟,5,0,5,富邦-新營,2024-11-15,9693
2867,三商壽,5,0,5,富邦-新營,2024-11-15,9693
2883,凱基金,5,0,5,富邦-新營,2024-11-15,9693
00713,元大台灣高息低波,4,0,4,富邦-新營,2024-11-15,9693
2374,佳能,5,1,4,富邦-新營,2024-11-15,9693
2915,潤泰全,4,0,4,富邦-新營,2024-11-15,9693
3002,歐格,4,0,4,富邦-新營,2024-11-15,9693
4931,新盛力,6,2,4,富邦-新營,2024-11-15,9693
4979,華星光,10,6,4,富邦-新營,2024-11-15,9693
00878,國泰永續高股息,150,0,150,富邦-新營,2024-11-18,9693
2646,星宇航空,107,2,105,富邦-新營,2024-11-18,9693
00929,復華台灣科技優息,77,17,60,富邦-新營,2024-11-18,9693
00892,富邦台灣半導體,48,0,48,富邦-新營,2024-11-18,9693
2312,金寶,105,57,48,富邦-新營,2024-11-18,9693
00930,永豐ESG低碳高息,34,0,34,富邦-新營,2024-11-18,9693
00887,永豐中國科技50大,30,0,30,富邦-新營,2024-11-18,9693
00654R,富邦印度反1,30,0,30,富邦-新營,2024-11-18,9693
0056,元大高股息,36,8,28,富邦-新營,2024-11-18,9693
00915,凱基優選高股息30,23,2,21,富邦-新營,2024-11-18,9693
00952,凱基台灣AI50,21,0,21,富邦-新營,2024-11-18,9693
2881,富邦金,21,0,21,富邦-新營,2024-11-18,9693
00713,元大台灣高息低波,20,0,20,富邦-新營,2024-11-18,9693
3704,合勤控,18,1,17,富邦-新營,2024-11-18,9693
2609,陽明,19,3,16,富邦-新營,2024-11-18,9693
2888,新光金,20,5,15,富邦-新營,2024-11-18,9693
4510,高鋒,15,0,15,富邦-新營,2024-11-18,9693
2241,艾姆勒,13,0,13,富邦-新營,2024-11-18,9693
006208,富邦台50,12,0,12,富邦-新營,2024-11-18,9693
1605,華新,10,0,10,富邦-新營,2024-11-18,9693
2409,友達,10,0,10,富邦-新營,2024-11-18,9693
2413,環科,10,0,10,富邦-新營,2024-11-18,9693
2354,鴻準,69,60,9,富邦-新營,2024-11-18,9693
4956,光鋐,11,2,9,富邦-新營,2024-11-18,9693
6451,訊芯-KY,9,0,9,富邦-新營,2024-11-18,9693
2356,英業達,21,13,8,富邦-新營,2024-11-18,9693
00934,中信成長高股息,7,0,7,富邦-新營,2024-11-18,9693
5871,中租-KY,7,0,7,富邦-新營,2024-11-18,9693
3231,緯創,9,2,7,富邦-新營,2024-11-18,9693
00945B,凱基美國非投等債,7,0,7,富邦-新營,2024-11-18,9693
1528,恩德,7,0,7,富邦-新營,2024-11-18,9693
1785,光洋科,6,0,6,富邦-新營,2024-11-18,9693
00891,中信關鍵半導體,6,0,6,富邦-新營,2024-11-18,9693
3535,晶彩科,6,0,6,富邦-新營,2024-11-18,9693
00715L,期街口布蘭特正2,6,0,6,富邦-新營,2024-11-18,9693
8059,凱碩,6,0,6,富邦-新營,2024-11-18,9693
8074,鉅橡,21,15,6,富邦-新營,2024-11-18,9693
2605,新興,6,0,6,富邦-新營,2024-11-18,9693
6274,台燿,5,0,5,富邦-新營,2024-11-18,9693
3689,湧德,5,0,5,富邦-新營,2024-11-18,9693
5522,遠雄,5,0,5,富邦-新營,2024-11-18,9693
2884,玉山金,5,0,5,富邦-新營,2024-11-18,9693
2330,台積電,5,0,5,富邦-新營,2024-11-18,9693
6257,矽格,5,0,5,富邦-新營,2024-11-18,9693
00932,兆豐永續高息等權,5,0,5,富邦-新營,2024-11-18,9693
1466,聚隆,5,0,5,富邦-新營,2024-11-18,9693
2340,台亞,5,0,5,富邦-新營,2024-11-18,9693
2399,映泰,5,0,5,富邦-新營,2024-11-18,9693
3081,聯亞,7,2,5,富邦-新營,2024-11-18,9693
3083,網龍,5,0,5,富邦-新營,2024-11-18,9693
00650L,復華香港正2,145,0,145,富邦-新營,2024-11-19,9693
00953B,群益優選非投等債,104,0,104,富邦-新營,2024-11-19,9693
00686R,群益臺灣加權反1,100,0,100,富邦-新營,2024-11-19,9693
00945B,凱基美國非投等債,90,0,90,富邦-新營,2024-11-19,9693
3706,神達,159,81,78,富邦-新營,2024-11-19,9693
4931,新盛力,201,132,69,富邦-新營,2024-11-19,9693
00937B,群益ESG投等債20,55,0,55,富邦-新營,2024-11-19,9693
2489,瑞軒,50,4,46,富邦-新營,2024-11-19,9693
00878,國泰永續高股息,46,3,43,富邦-新營,2024-11-19,9693
2888,新光金,50,16,34,富邦-新營,2024-11-19,9693
2349,錸德,78,46,32,富邦-新營,2024-11-19,9693
3062,建漢,38,6,32,富邦-新營,2024-11-19,9693
2317,鴻海,23,2,21,富邦-新營,2024-11-19,9693
2374,佳能,21,1,20,富邦-新營,2024-11-19,9693
3390,旭軟,20,0,20,富邦-新營,2024-11-19,9693
3481,群創,25,5,20,富邦-新營,2024-11-19,9693
2356,英業達,21,2,19,富邦-新營,2024-11-19,9693
1101,台泥,13,1,12,富邦-新營,2024-11-19,9693
1909,榮成,11,0,11,富邦-新營,2024-11-19,9693
6446,藥華藥,15,5,10,富邦-新營,2024-11-19,9693
00887,永豐中國科技50大,10,0,10,富邦-新營,2024-11-19,9693
00942B,台新美A公司債20+,10,0,10,富邦-新營,2024-11-19,9693
00948B,中信優息投資級債,10,0,10,富邦-新營,2024-11-19,9693
2103,台橡,9,0,9,富邦-新營,2024-11-19,9693
3712,永崴投控,9,0,9,富邦-新營,2024-11-19,9693
1528,恩德,9,1,8,富邦-新營,2024-11-19,9693
6763,綠界科技*,9,1,8,富邦-新營,2024-11-19,9693
2330,台積電,8,0,8,富邦-新營,2024-11-19,9693
0056,元大高股息,9,2,7,富邦-新營,2024-11-19,9693
00712,復華富時不動產,8,1,7,富邦-新營,2024-11-19,9693
00713,元大台灣高息低波,7,0,7,富邦-新營,2024-11-19,9693
00909,國泰數位支付服務,7,0,7,富邦-新營,2024-11-19,9693
00633L,富邦上証正2,18,11,7,富邦-新營,2024-11-19,9693
2481,強茂,7,0,7,富邦-新營,2024-11-19,9693
3715,定穎投控,7,0,7,富邦-新營,2024-11-19,9693
5864,致和證,7,0,7,富邦-新營,2024-11-19,9693
2881,富邦金,6,0,6,富邦-新營,2024-11-19,9693
2382,廣達,7,1,6,富邦-新營,2024-11-19,9693
00639,富邦深100,6,0,6,富邦-新營,2024-11-19,9693
8249,菱光,12,6,6,富邦-新營,2024-11-19,9693
2449,京元電子,6,0,6,富邦-新營,2024-11-19,9693
3024,憶聲,6,0,6,富邦-新營,2024-11-19,9693
00918,大華優利高填息30,5,0,5,富邦-新營,2024-11-19,9693
3576,聯合再生,5,0,5,富邦-新營,2024-11-19,9693
2884,玉山金,5,0,5,富邦-新營,2024-11-19,9693
6248,沛波,5,0,5,富邦-新營,2024-11-19,9693
00643,群益深証中小,5,0,5,富邦-新營,2024-11-19,9693
2312,金寶,638,633,5,富邦-新營,2024-11-19,9693
3338,泰碩,5,0,5,富邦-新營,2024-11-19,9693
5309,系統電,33,28,5,富邦-新營,2024-11-19,9693
3323,加百裕,110,4,106,富邦-新營,2024-11-20,9693
00632R,元大台灣50反1,100,0,100,富邦-新營,2024-11-20,9693
2303,聯電,53,0,53,富邦-新營,2024-11-20,9693
2354,鴻準,94,45,49,富邦-新營,2024-11-20,9693
00878,國泰永續高股息,44,0,44,富邦-新營,2024-11-20,9693
2312,金寶,51,15,36,富邦-新營,2024-11-20,9693
2489,瑞軒,33,1,32,富邦-新營,2024-11-20,9693
00929,復華台灣科技優息,45,20,25,富邦-新營,2024-11-20,9693
1314,中石化,20,0,20,富邦-新營,2024-11-20,9693
2834,臺企銀,17,0,17,富邦-新營,2024-11-20,9693
8032,光菱,17,0,17,富邦-新營,2024-11-20,9693
4540,全球傳動,15,0,15,富邦-新營,2024-11-20,9693
2606,裕民,15,1,14,富邦-新營,2024-11-20,9693
3447,展達,23,9,14,富邦-新營,2024-11-20,9693
3625,西勝,13,0,13,富邦-新營,2024-11-20,9693
6443,元晶,13,0,13,富邦-新營,2024-11-20,9693
00959B,大華投等美債15Y+,10,0,10,富邦-新營,2024-11-20,9693
2356,英業達,19,9,10,富邦-新營,2024-11-20,9693
3712,永崴投控,9,1,8,富邦-新營,2024-11-20,9693
5871,中租-KY,8,0,8,富邦-新營,2024-11-20,9693
6425,易發,8,0,8,富邦-新營,2024-11-20,9693
6591,動力-KY,8,0,8,富邦-新營,2024-11-20,9693
6282,康舒,21,13,8,富邦-新營,2024-11-20,9693
2881,富邦金,7,1,6,富邦-新營,2024-11-20,9693
6442,光聖,42,36,6,富邦-新營,2024-11-20,9693
2344,華邦電,6,0,6,富邦-新營,2024-11-20,9693
5523,豐謙,6,0,6,富邦-新營,2024-11-20,9693
5907,大洋-KY,6,0,6,富邦-新營,2024-11-20,9693
9934,成霖,6,0,6,富邦-新營,2024-11-20,9693
0056,元大高股息,6,1,5,富邦-新營,2024-11-20,9693
1584,精剛,5,0,5,富邦-新營,2024-11-20,9693
6187,萬潤,6,1,5,富邦-新營,2024-11-20,9693
6558,興能高,6,1,5,富邦-新營,2024-11-20,9693
6223,旺矽,6,1,5,富邦-新營,2024-11-20,9693
1540,喬福,5,0,5,富邦-新營,2024-11-20,9693
00923,群益台ESG低碳50,5,0,5,富邦-新營,2024-11-20,9693
1227,佳格,5,0,5,富邦-新營,2024-11-20,9693
2409,友達,5,0,5,富邦-新營,2024-11-20,9693
3005,神基,5,0,5,富邦-新營,2024-11-20,9693
3022,威強電,6,1,5,富邦-新營,2024-11-20,9693
3209,全科,5,0,5,富邦-新營,2024-11-20,9693
5438,東友,5,0,5,富邦-新營,2024-11-20,9693
6182,合晶,5,0,5,富邦-新營,2024-11-20,9693
00679B,元大美債20年,5,0,5,富邦-新營,2024-11-20,9693
2882,國泰金,4,0,4,富邦-新營,2024-11-20,9693
5880,合庫金,4,0,4,富邦-新營,2024-11-20,9693
5536,聖暉*,4,0,4,富邦-新營,2024-11-20,9693
00650L,復華香港正2,4,0,4,富邦-新營,2024-11-20,9693
00963,中信全球高股息,4,0,4,富邦-新營,2024-11-20,9693
00964,中信亞太高股息,4,0,4,富邦-新營,2024-11-20,9693
3552,同致,77,3,74,富邦-新營,2024-11-21,9693
00830,國泰費城半導體,60,1,59,富邦-新營,2024-11-21,9693
2027,大成鋼,54,0,54,富邦-新營,2024-11-21,9693
2888,新光金,35,0,35,富邦-新營,2024-11-21,9693
00929,復華台灣科技優息,57,22,35,富邦-新營,2024-11-21,9693
00878,國泰永續高股息,34,0,34,富邦-新營,2024-11-21,9693
3015,全漢,32,1,31,富邦-新營,2024-11-21,9693
00650L,復華香港正2,28,0,28,富邦-新營,2024-11-21,9693
2890,永豐金,22,0,22,富邦-新營,2024-11-21,9693
6505,台塑化,21,0,21,富邦-新營,2024-11-21,9693
2344,華邦電,18,2,16,富邦-新營,2024-11-21,9693
2349,錸德,79,63,16,富邦-新營,2024-11-21,9693
3264,欣銓,14,0,14,富邦-新營,2024-11-21,9693
5907,大洋-KY,20,6,14,富邦-新營,2024-11-21,9693
00713,元大台灣高息低波,12,0,12,富邦-新營,2024-11-21,9693
00948B,中信優息投資級債,12,0,12,富邦-新營,2024-11-21,9693
3481,群創,13,1,12,富邦-新營,2024-11-21,9693
00919,群益台灣精選高息,17,5,12,富邦-新營,2024-11-21,9693
006208,富邦台50,11,0,11,富邦-新營,2024-11-21,9693
2474,可成,14,3,11,富邦-新營,2024-11-21,9693
3081,聯亞,19,8,11,富邦-新營,2024-11-21,9693
3090,日電貿,14,3,11,富邦-新營,2024-11-21,9693
6275,元山,11,0,11,富邦-新營,2024-11-21,9693
2881,富邦金,10,0,10,富邦-新營,2024-11-21,9693
2201,裕隆,10,0,10,富邦-新營,2024-11-21,9693
2408,南亞科,10,0,10,富邦-新營,2024-11-21,9693
2440,太空梭,10,0,10,富邦-新營,2024-11-21,9693
2485,兆赫,10,0,10,富邦-新營,2024-11-21,9693
3234,光環,10,0,10,富邦-新營,2024-11-21,9693
4540,全球傳動,10,0,10,富邦-新營,2024-11-21,9693
9904,寶成,10,0,10,富邦-新營,2024-11-21,9693
1314,中石化,10,0,10,富邦-新營,2024-11-21,9693
2542,興富發,10,0,10,富邦-新營,2024-11-21,9693
00901,永豐智能車供應鏈,9,0,9,富邦-新營,2024-11-21,9693
00715L,期街口布蘭特正2,12,3,9,富邦-新營,2024-11-21,9693
8086,宏捷科,10,1,9,富邦-新營,2024-11-21,9693
2317,鴻海,19,10,9,富邦-新營,2024-11-21,9693
1301,台塑,8,0,8,富邦-新營,2024-11-21,9693
00946,群益科技高息成長,8,0,8,富邦-新營,2024-11-21,9693
2607,榮運,9,1,8,富邦-新營,2024-11-21,9693
8249,菱光,10,2,8,富邦-新營,2024-11-21,9693
2303,聯電,11,4,7,富邦-新營,2024-11-21,9693
2615,萬海,20,13,7,富邦-新營,2024-11-21,9693
2887,台新金,10,3,7,富邦-新營,2024-11-21,9693
4956,光鋐,15,8,7,富邦-新營,2024-11-21,9693
2330,台積電,7,0,7,富邦-新營,2024-11-21,9693
00888,永豐台灣ESG,6,0,6,富邦-新營,2024-11-21,9693
00964,中信亞太高股息,6,0,6,富邦-新營,2024-11-21,9693
6282,康舒,12,6,6,富邦-新營,2024-11-21,9693
2609,陽明,30,24,6,富邦-新營,2024-11-21,9693
00753L,中信中國50正2,50,0,50,富邦-新營,2024-11-22,9693
00650L,復華香港正2,40,0,40,富邦-新營,2024-11-22,9693
5213,亞昕,37,0,37,富邦-新營,2024-11-22,9693
2609,陽明,39,5,34,富邦-新營,2024-11-22,9693
00651R,復華香港反1,26,0,26,富邦-新營,2024-11-22,9693
2615,萬海,28,3,25,富邦-新營,2024-11-22,9693
5309,系統電,65,41,24,富邦-新營,2024-11-22,9693
00937B,群益ESG投等債20,22,0,22,富邦-新營,2024-11-22,9693
00919,群益台灣精選高息,23,2,21,富邦-新營,2024-11-22,9693
4979,華星光,43,22,21,富邦-新營,2024-11-22,9693
6151,晉倫,23,2,21,富邦-新營,2024-11-22,9693
00665L,富邦�琤肭磪囓�2,20,0,20,富邦-新營,2024-11-22,9693
2388,威盛,17,0,17,富邦-新營,2024-11-22,9693
00878,國泰永續高股息,22,6,16,富邦-新營,2024-11-22,9693
2344,華邦電,20,5,15,富邦-新營,2024-11-22,9693
4956,光鋐,26,11,15,富邦-新營,2024-11-22,9693
00909,國泰數位支付服務,13,0,13,富邦-新營,2024-11-22,9693
2002,中鋼,15,3,12,富邦-新營,2024-11-22,9693
1301,台塑,13,1,12,富邦-新營,2024-11-22,9693
3706,神達,265,254,11,富邦-新營,2024-11-22,9693
00930,永豐ESG低碳高息,11,0,11,富邦-新營,2024-11-22,9693
1305,華夏,10,0,10,富邦-新營,2024-11-22,9693
2867,三商壽,12,2,10,富邦-新營,2024-11-22,9693
00901,永豐智能車供應鏈,9,0,9,富邦-新營,2024-11-22,9693
2305,全友,10,1,9,富邦-新營,2024-11-22,9693
2613,中櫃,10,1,9,富邦-新營,2024-11-22,9693
00935,野村臺灣新科技50,8,0,8,富邦-新營,2024-11-22,9693
2889,國票金,8,0,8,富邦-新營,2024-11-22,9693
1326,台化,7,0,7,富邦-新營,2024-11-22,9693
1540,喬福,7,0,7,富邦-新營,2024-11-22,9693
3715,定穎投控,7,0,7,富邦-新營,2024-11-22,9693
4513,福裕,17,10,7,富邦-新營,2024-11-22,9693
6558,興能高,8,1,7,富邦-新營,2024-11-22,9693
2353,宏��,7,0,7,富邦-新營,2024-11-22,9693
3062,建漢,7,1,6,富邦-新營,2024-11-22,9693
3090,日電貿,7,1,6,富邦-新營,2024-11-22,9693
00953B,群益優選非投等債,6,0,6,富邦-新營,2024-11-22,9693
2890,永豐金,5,0,5,富邦-新營,2024-11-22,9693
2486,一詮,11,6,5,富邦-新營,2024-11-22,9693
2354,鴻準,52,47,5,富邦-新營,2024-11-22,9693
2352,佳世達,5,0,5,富邦-新營,2024-11-22,9693
2409,友達,5,0,5,富邦-新營,2024-11-22,9693
3447,展達,7,2,5,富邦-新營,2024-11-22,9693
5905,南仁湖,7,2,5,富邦-新營,2024-11-22,9693
6248,沛波,5,0,5,富邦-新營,2024-11-22,9693
8171,天宇,7,2,5,富邦-新營,2024-11-22,9693
3511,矽瑪,9,5,4,富邦-新營,2024-11-22,9693
2634,漢翔,5,1,4,富邦-新營,2024-11-22,9693
0061,元大寶滬深,4,0,4,富邦-新營,2024-11-22,9693
2399,映泰,5,1,4,富邦-新營,2024-11-22,9693
00715L,期街口布蘭特正2,1045,4,1041,富邦-新營,2024-11-25,9693
2392,正崴,427,37,390,富邦-新營,2024-11-25,9693
5243,乙盛-KY,301,2,299,富邦-新營,2024-11-25,9693
3323,加百裕,236,137,99,富邦-新營,2024-11-25,9693
3706,神達,185,89,96,富邦-新營,2024-11-25,9693
00887,永豐中國科技50大,59,0,59,富邦-新營,2024-11-25,9693
00919,群益台灣精選高息,58,3,55,富邦-新營,2024-11-25,9693
2615,萬海,34,0,34,富邦-新營,2024-11-25,9693
1605,華新,31,0,31,富邦-新營,2024-11-25,9693
3576,聯合再生,31,5,26,富邦-新營,2024-11-25,9693
2603,長榮,24,2,22,富邦-新營,2024-11-25,9693
3322,建舜電,20,0,20,富邦-新營,2024-11-25,9693
5347,世界,23,3,20,富邦-新營,2024-11-25,9693
6191,精成科,20,0,20,富邦-新營,2024-11-25,9693
3019,亞光,20,2,18,富邦-新營,2024-11-25,9693
2834,臺企銀,16,0,16,富邦-新營,2024-11-25,9693
00712,復華富時不動產,21,6,15,富邦-新營,2024-11-25,9693
8043,蜜望實,15,0,15,富邦-新營,2024-11-25,9693
00930,永豐ESG低碳高息,15,1,14,富邦-新營,2024-11-25,9693
00673R,期元大S＆P原油反1,14,0,14,富邦-新營,2024-11-25,9693
00650L,復華香港正2,14,0,14,富邦-新營,2024-11-25,9693
1815,富喬,314,300,14,富邦-新營,2024-11-25,9693
4931,新盛力,17,5,12,富邦-新營,2024-11-25,9693
2371,大同,13,1,12,富邦-新營,2024-11-25,9693
5876,上海商銀,10,0,10,富邦-新營,2024-11-25,9693
5483,中美晶,10,0,10,富邦-新營,2024-11-25,9693
00643,群益深証中小,10,0,10,富邦-新營,2024-11-25,9693
6175,立敦,10,0,10,富邦-新營,2024-11-25,9693
6770,力積電,10,0,10,富邦-新營,2024-11-25,9693
8942,森鉅,10,0,10,富邦-新營,2024-11-25,9693
00946,群益科技高息成長,10,1,9,富邦-新營,2024-11-25,9693
6005,群益證,9,0,9,富邦-新營,2024-11-25,9693
00878,國泰永續高股息,12,4,8,富邦-新營,2024-11-25,9693
00918,大華優利高填息30,8,0,8,富邦-新營,2024-11-25,9693
3374,精材,8,0,8,富邦-新營,2024-11-25,9693
4576,大銀微系統,17,9,8,富邦-新營,2024-11-25,9693
1569,濱川,9,3,6,富邦-新營,2024-11-25,9693
2476,鉅祥,11,5,6,富邦-新營,2024-11-25,9693
3081,聯亞,38,32,6,富邦-新營,2024-11-25,9693
2385,群光,5,0,5,富邦-新營,2024-11-25,9693
3163,波若威,5,0,5,富邦-新營,2024-11-25,9693
00915,凱基優選高股息30,5,0,5,富邦-新營,2024-11-25,9693
1227,佳格,5,0,5,富邦-新營,2024-11-25,9693
1737,臺鹽,5,0,5,富邦-新營,2024-11-25,9693
2349,錸德,5,0,5,富邦-新營,2024-11-25,9693
2374,佳能,5,0,5,富邦-新營,2024-11-25,9693
2449,京元電子,8,3,5,富邦-新營,2024-11-25,9693
2530,華建,5,0,5,富邦-新營,2024-11-25,9693
6288,聯嘉,11,6,5,富邦-新營,2024-11-25,9693
8104,錸寶,16,11,5,富邦-新營,2024-11-25,9693
4979,華星光,173,22,151,富邦-新營,2024-11-26,9693
5309,系統電,140,14,126,富邦-新營,2024-11-26,9693
00929,復華台灣科技優息,64,2,62,富邦-新營,2024-11-26,9693
2317,鴻海,59,1,58,富邦-新營,2024-11-26,9693
00892,富邦台灣半導體,51,0,51,富邦-新營,2024-11-26,9693
00878,國泰永續高股息,37,0,37,富邦-新營,2024-11-26,9693
2888,新光金,30,0,30,富邦-新營,2024-11-26,9693
6133,金橋,30,1,29,富邦-新營,2024-11-26,9693
00919,群益台灣精選高息,26,0,26,富邦-新營,2024-11-26,9693
6962,ITH-KY,23,1,22,富邦-新營,2024-11-26,9693
2329,華泰,20,0,20,富邦-新營,2024-11-26,9693
2867,三商壽,20,0,20,富邦-新營,2024-11-26,9693
4108,懷特,20,0,20,富邦-新營,2024-11-26,9693
0056,元大高股息,18,0,18,富邦-新營,2024-11-26,9693
2002,中鋼,17,0,17,富邦-新營,2024-11-26,9693
2426,鼎元,119,102,17,富邦-新營,2024-11-26,9693
2890,永豐金,16,0,16,富邦-新營,2024-11-26,9693
2312,金寶,129,113,16,富邦-新營,2024-11-26,9693
2883B,凱基金乙特,15,0,15,富邦-新營,2024-11-26,9693
4542,科嶠,15,0,15,富邦-新營,2024-11-26,9693
00713,元大台灣高息低波,15,1,14,富邦-新營,2024-11-26,9693
3501,維熹,15,1,14,富邦-新營,2024-11-26,9693
006208,富邦台50,13,0,13,富邦-新營,2024-11-26,9693
00673R,期元大S＆P原油反1,13,0,13,富邦-新營,2024-11-26,9693
2344,華邦電,13,0,13,富邦-新營,2024-11-26,9693
3234,光環,12,0,12,富邦-新營,2024-11-26,9693
1815,富喬,80,69,11,富邦-新營,2024-11-26,9693
00907,永豐優息存股,10,0,10,富邦-新營,2024-11-26,9693
00951,台新日本半導體,10,0,10,富邦-新營,2024-11-26,9693
00959B,大華投等美債15Y+,10,0,10,富邦-新營,2024-11-26,9693
1721,三晃,11,1,10,富邦-新營,2024-11-26,9693
00918,大華優利高填息30,9,0,9,富邦-新營,2024-11-26,9693
2399,映泰,9,0,9,富邦-新營,2024-11-26,9693
2330,台積電,9,0,9,富邦-新營,2024-11-26,9693
0050,元大台灣50,8,0,8,富邦-新營,2024-11-26,9693
1909,榮成,7,0,7,富邦-新營,2024-11-26,9693
9945,潤泰新,7,0,7,富邦-新營,2024-11-26,9693
3231,緯創,12,6,6,富邦-新營,2024-11-26,9693
2027,大成鋼,10,4,6,富邦-新營,2024-11-26,9693
00940,元大台灣價值高息,6,0,6,富邦-新營,2024-11-26,9693
2609,陽明,14,9,5,富邦-新營,2024-11-26,9693
00650L,復華香港正2,5,0,5,富邦-新營,2024-11-26,9693
00706L,期元大S＆P日圓正2,5,0,5,富邦-新營,2024-11-26,9693
2243,宏旭-KY,5,0,5,富邦-新營,2024-11-26,9693
2388,威盛,5,0,5,富邦-新營,2024-11-26,9693
6530,創威,5,0,5,富邦-新營,2024-11-26,9693
6578,達邦蛋白,5,0,5,富邦-新營,2024-11-26,9693
6609,瀧澤科,7,2,5,富邦-新營,2024-11-26,9693
8942,森鉅,5,0,5,富邦-新營,2024-11-26,9693
1540,喬福,18,13,5,富邦-新營,2024-11-26,9693
00676R,富邦臺灣加權反1,110,0,110,富邦-新營,2024-11-27,9693
00878,國泰永續高股息,121,11,110,富邦-新營,2024-11-27,9693
00919,群益台灣精選高息,103,0,103,富邦-新營,2024-11-27,9693
0056,元大高股息,96,0,96,富邦-新營,2024-11-27,9693
2426,鼎元,67,1,66,富邦-新營,2024-11-27,9693
00929,復華台灣科技優息,72,11,61,富邦-新營,2024-11-27,9693
00937B,群益ESG投等債20,62,4,58,富邦-新營,2024-11-27,9693
2303,聯電,51,10,41,富邦-新營,2024-11-27,9693
00936,台新永續高息中小,40,0,40,富邦-新營,2024-11-27,9693
6174,安��,40,0,40,富邦-新營,2024-11-27,9693
2317,鴻海,51,12,39,富邦-新營,2024-11-27,9693
2034,允強,36,0,36,富邦-新營,2024-11-27,9693
2356,英業達,30,3,27,富邦-新營,2024-11-27,9693
4526,東台,40,15,25,富邦-新營,2024-11-27,9693
00881,國泰台灣5G+,23,0,23,富邦-新營,2024-11-27,9693
00892,富邦台灣半導體,21,0,21,富邦-新營,2024-11-27,9693
00918,大華優利高填息30,21,0,21,富邦-新營,2024-11-27,9693
00933B,國泰10Y+金融債,20,0,20,富邦-新營,2024-11-27,9693
2603,長榮,35,16,19,富邦-新營,2024-11-27,9693
2002,中鋼,16,0,16,富邦-新營,2024-11-27,9693
3230,錦明,17,1,16,富邦-新營,2024-11-27,9693
00960,野村全球航運龍頭,15,0,15,富邦-新營,2024-11-27,9693
2233,宇隆,16,1,15,富邦-新營,2024-11-27,9693
2609,陽明,27,12,15,富邦-新營,2024-11-27,9693
2330,台積電,16,1,15,富邦-新營,2024-11-27,9693
2392,正崴,94,80,14,富邦-新營,2024-11-27,9693
2834,臺企銀,15,1,14,富邦-新營,2024-11-27,9693
1815,富喬,57,43,14,富邦-新營,2024-11-27,9693
3019,亞光,17,3,14,富邦-新營,2024-11-27,9693
2354,鴻準,18,6,12,富邦-新營,2024-11-27,9693
2344,華邦電,15,4,11,富邦-新營,2024-11-27,9693
4979,華星光,25,14,11,富邦-新營,2024-11-27,9693
5907,大洋-KY,11,0,11,富邦-新營,2024-11-27,9693
8942,森鉅,11,0,11,富邦-新營,2024-11-27,9693
1785,光洋科,10,0,10,富邦-新營,2024-11-27,9693
2409,友達,10,0,10,富邦-新營,2024-11-27,9693
00904,新光臺灣半導體30,10,0,10,富邦-新營,2024-11-27,9693
00753L,中信中國50正2,10,0,10,富邦-新營,2024-11-27,9693
00680L,元大美債20正2,15,5,10,富邦-新營,2024-11-27,9693
2316,楠梓電,10,0,10,富邦-新營,2024-11-27,9693
3090,日電貿,16,6,10,富邦-新營,2024-11-27,9693
5309,系統電,14,4,10,富邦-新營,2024-11-27,9693
2417,圓剛,10,0,10,富邦-新營,2024-11-27,9693
2615,萬海,41,31,10,富邦-新營,2024-11-27,9693
3673,TPK-KY,9,0,9,富邦-新營,2024-11-27,9693
00948B,中信優息投資級債,8,0,8,富邦-新營,2024-11-27,9693
0050,元大台灣50,7,0,7,富邦-新營,2024-11-27,9693
00905,FT臺灣Smart,7,0,7,富邦-新營,2024-11-27,9693
2324,仁寶,8,1,7,富邦-新營,2024-11-27,9693
1536,和大,32,25,7,富邦-新營,2024-11-27,9693
1815,富喬,327,126,201,富邦-新營,2024-11-28,9693
3706,神達,350,173,177,富邦-新營,2024-11-28,9693
2312,金寶,186,45,141,富邦-新營,2024-11-28,9693
3450,聯鈞,117,3,114,富邦-新營,2024-11-28,9693
00632R,元大台灣50反1,109,0,109,富邦-新營,2024-11-28,9693
4979,華星光,115,17,98,富邦-新營,2024-11-28,9693
00929,復華台灣科技優息,106,10,96,富邦-新營,2024-11-28,9693
00918,大華優利高填息30,94,0,94,富邦-新營,2024-11-28,9693
00878,國泰永續高股息,139,54,85,富邦-新營,2024-11-28,9693
00919,群益台灣精選高息,102,23,79,富邦-新營,2024-11-28,9693
9105,泰金寶-DR,72,16,56,富邦-新營,2024-11-28,9693
0056,元大高股息,55,1,54,富邦-新營,2024-11-28,9693
2332,友訊,63,29,34,富邦-新營,2024-11-28,9693
5309,系統電,49,16,33,富邦-新營,2024-11-28,9693
4510,高鋒,87,55,32,富邦-新營,2024-11-28,9693
1605,華新,27,0,27,富邦-新營,2024-11-28,9693
2426,鼎元,31,9,22,富邦-新營,2024-11-28,9693
2392,正崴,24,6,18,富邦-新營,2024-11-28,9693
1802,台玻,19,2,17,富邦-新營,2024-11-28,9693
3481,群創,16,0,16,富邦-新營,2024-11-28,9693
00936,台新永續高息中小,15,0,15,富邦-新營,2024-11-28,9693
5347,世界,15,0,15,富邦-新營,2024-11-28,9693
2867,三商壽,20,5,15,富邦-新營,2024-11-28,9693
3323,加百裕,211,196,15,富邦-新營,2024-11-28,9693
00930,永豐ESG低碳高息,13,0,13,富邦-新營,2024-11-28,9693
1909,榮成,13,0,13,富邦-新營,2024-11-28,9693
00915,凱基優選高股息30,12,0,12,富邦-新營,2024-11-28,9693
00881,國泰台灣5G+,13,1,12,富邦-新營,2024-11-28,9693
2349,錸德,16,5,11,富邦-新營,2024-11-28,9693
2371,大同,13,2,11,富邦-新營,2024-11-28,9693
00940,元大台灣價值高息,20,10,10,富邦-新營,2024-11-28,9693
3234,光環,10,0,10,富邦-新營,2024-11-28,9693
1227,佳格,10,0,10,富邦-新營,2024-11-28,9693
1806,冠軍,10,0,10,富邦-新營,2024-11-28,9693
2233,宇隆,12,2,10,富邦-新營,2024-11-28,9693
2338,光罩,10,0,10,富邦-新營,2024-11-28,9693
3322,建舜電,10,0,10,富邦-新營,2024-11-28,9693
4147,中裕,10,0,10,富邦-新營,2024-11-28,9693
4960,誠美材,10,0,10,富邦-新營,2024-11-28,9693
1536,和大,24,15,9,富邦-新營,2024-11-28,9693
00753L,中信中國50正2,23,14,9,富邦-新營,2024-11-28,9693
3591,艾笛森,17,8,9,富邦-新營,2024-11-28,9693
3715,定穎投控,12,3,9,富邦-新營,2024-11-28,9693
2303,聯電,17,8,9,富邦-新營,2024-11-28,9693
00952,凱基台灣AI50,8,0,8,富邦-新營,2024-11-28,9693
2323,中環,11,3,8,富邦-新營,2024-11-28,9693
2486,一詮,10,2,8,富邦-新營,2024-11-28,9693
3037,欣興,7,0,7,富邦-新營,2024-11-28,9693
00713,元大台灣高息低波,7,0,7,富邦-新營,2024-11-28,9693
00688L,國泰20年美債正2,12,5,7,富邦-新營,2024-11-28,9693
2633,台灣高鐵,101,0,101,富邦-新營,2024-11-29,9693
00959B,大華投等美債15Y+,70,0,70,富邦-新營,2024-11-29,9693
3548,兆利,49,0,49,富邦-新營,2024-11-29,9693
4956,光鋐,50,1,49,富邦-新營,2024-11-29,9693
1904,正隆,26,0,26,富邦-新營,2024-11-29,9693
5309,系統電,46,22,24,富邦-新營,2024-11-29,9693
4562,穎漢,33,11,22,富邦-新營,2024-11-29,9693
9105,泰金寶-DR,24,2,22,富邦-新營,2024-11-29,9693
910861,神州-DR,20,0,20,富邦-新營,2024-11-29,9693
2609,陽明,29,9,20,富邦-新營,2024-11-29,9693
00919,群益台灣精選高息,20,0,20,富邦-新營,2024-11-29,9693
2884,玉山金,18,0,18,富邦-新營,2024-11-29,9693
00915,凱基優選高股息30,17,0,17,富邦-新營,2024-11-29,9693
1301,台塑,16,0,16,富邦-新營,2024-11-29,9693
2002,中鋼,16,0,16,富邦-新營,2024-11-29,9693
2881,富邦金,16,0,16,富邦-新營,2024-11-29,9693
6005,群益證,15,0,15,富邦-新營,2024-11-29,9693
2834,臺企銀,17,3,14,富邦-新營,2024-11-29,9693
00878,國泰永續高股息,22,8,14,富邦-新營,2024-11-29,9693
2495,普安,13,0,13,富邦-新營,2024-11-29,9693
0056,元大高股息,14,2,12,富邦-新營,2024-11-29,9693
006208,富邦台50,12,0,12,富邦-新營,2024-11-29,9693
2303,聯電,13,2,11,富邦-新營,2024-11-29,9693
1446,宏和,10,0,10,富邦-新營,2024-11-29,9693
2027,大成鋼,10,0,10,富邦-新營,2024-11-29,9693
2233,宇隆,15,5,10,富邦-新營,2024-11-29,9693
2342,茂矽,10,0,10,富邦-新營,2024-11-29,9693
2413,環科,10,0,10,富邦-新營,2024-11-29,9693
5488,松普,10,0,10,富邦-新營,2024-11-29,9693
1326,台化,11,2,9,富邦-新營,2024-11-29,9693
2615,萬海,12,3,9,富邦-新營,2024-11-29,9693
3037,欣興,9,0,9,富邦-新營,2024-11-29,9693
3591,艾笛森,8,0,8,富邦-新營,2024-11-29,9693
5227,立凱-KY,10,2,8,富邦-新營,2024-11-29,9693
2211,長榮鋼,7,0,7,富邦-新營,2024-11-29,9693
2801,彰銀,7,0,7,富邦-新營,2024-11-29,9693
6505,台塑化,12,6,6,富邦-新營,2024-11-29,9693
6274,台燿,8,2,6,富邦-新營,2024-11-29,9693
5871,中租-KY,5,0,5,富邦-新營,2024-11-29,9693
00930,永豐ESG低碳高息,5,0,5,富邦-新營,2024-11-29,9693
1305,華夏,5,0,5,富邦-新營,2024-11-29,9693
1434,福懋,5,0,5,富邦-新營,2024-11-29,9693
2543,皇昌,5,0,5,富邦-新營,2024-11-29,9693
2887,台新金,5,0,5,富邦-新營,2024-11-29,9693
3419,譁裕,5,0,5,富邦-新營,2024-11-29,9693
4105,東洋,5,0,5,富邦-新營,2024-11-29,9693
8042,金山電,5,0,5,富邦-新營,2024-11-29,9693
3481,群創,5,0,5,富邦-新營,2024-11-29,9693
2330,台積電,6,1,5,富邦-新營,2024-11-29,9693
00715L,期街口布蘭特正2,24,20,4,富邦-新營,2024-11-29,9693
5371,中光電,279,38,241,富邦-新營,2024-12-02,9693
00753L,中信中國50正2,104,3,101,富邦-新營,2024-12-02,9693
00918,大華優利高填息30,96,11,85,富邦-新營,2024-12-02,9693
3211,順達,497,418,79,富邦-新營,2024-12-02,9693
3706,神達,117,55,62,富邦-新營,2024-12-02,9693
2312,金寶,75,23,52,富邦-新營,2024-12-02,9693
00650L,復華香港正2,50,0,50,富邦-新營,2024-12-02,9693
00680L,元大美債20正2,50,4,46,富邦-新營,2024-12-02,9693
5309,系統電,58,18,40,富邦-新營,2024-12-02,9693
00665L,富邦�琤肭磪囓�2,30,0,30,富邦-新營,2024-12-02,9693
4168,醣聯,30,0,30,富邦-新營,2024-12-02,9693
2888,新光金,20,1,19,富邦-新營,2024-12-02,9693
5864,致和證,21,2,19,富邦-新營,2024-12-02,9693
3322,建舜電,15,0,15,富邦-新營,2024-12-02,9693
4510,高鋒,38,24,14,富邦-新營,2024-12-02,9693
3323,加百裕,409,397,12,富邦-新營,2024-12-02,9693
6770,力積電,11,0,11,富邦-新營,2024-12-02,9693
5474,聰泰,10,0,10,富邦-新營,2024-12-02,9693
2317,鴻海,9,1,8,富邦-新營,2024-12-02,9693
1522,堤維西,12,4,8,富邦-新營,2024-12-02,9693
8059,凱碩,8,0,8,富邦-新營,2024-12-02,9693
2356,英業達,8,0,8,富邦-新營,2024-12-02,9693
2101,南港,7,0,7,富邦-新營,2024-12-02,9693
5536,聖暉*,7,0,7,富邦-新營,2024-12-02,9693
00712,復華富時不動產,9,2,7,富邦-新營,2024-12-02,9693
1528,恩德,7,0,7,富邦-新營,2024-12-02,9693
00919,群益台灣精選高息,13,7,6,富邦-新營,2024-12-02,9693
1446,宏和,6,0,6,富邦-新營,2024-12-02,9693
2408,南亞科,6,0,6,富邦-新營,2024-12-02,9693
4726,永昕,6,0,6,富邦-新營,2024-12-02,9693
5244,弘凱,11,5,6,富邦-新營,2024-12-02,9693
2344,華邦電,8,3,5,富邦-新營,2024-12-02,9693
2201,裕隆,5,0,5,富邦-新營,2024-12-02,9693
3338,泰碩,6,1,5,富邦-新營,2024-12-02,9693
00953B,群益優選非投等債,5,0,5,富邦-新營,2024-12-02,9693
1314,中石化,5,0,5,富邦-新營,2024-12-02,9693
2436,偉詮電,5,0,5,富邦-新營,2024-12-02,9693
3013,晟銘電,6,1,5,富邦-新營,2024-12-02,9693
4956,光鋐,5,0,5,富邦-新營,2024-12-02,9693
8044,網家,10,5,5,富邦-新營,2024-12-02,9693
2886,兆豐金,5,0,5,富邦-新營,2024-12-02,9693
3576,聯合再生,5,0,5,富邦-新營,2024-12-02,9693
00633L,富邦上証正2,5,1,4,富邦-新營,2024-12-02,9693
3664,安瑞-KY,4,0,4,富邦-新營,2024-12-02,9693
4739,康普,4,0,4,富邦-新營,2024-12-02,9693
6217,中探針,3,0,3,富邦-新營,2024-12-02,9693
2211,長榮鋼,3,0,3,富邦-新營,2024-12-02,9693
2540,愛山林,3,0,3,富邦-新營,2024-12-02,9693
2633,台灣高鐵,3,0,3,富邦-新營,2024-12-02,9693
3230,錦明,4,1,3,富邦-新營,2024-12-02,9693
00918,大華優利高填息30,184,1,183,富邦-新營,2024-12-03,9693
6558,興能高,178,2,176,富邦-新營,2024-12-03,9693
00712,復華富時不動產,80,1,79,富邦-新營,2024-12-03,9693
2605,新興,40,0,40,富邦-新營,2024-12-03,9693
00896,中信綠能及電動車,34,0,34,富邦-新營,2024-12-03,9693
00687B,國泰20年美債,33,0,33,富邦-新營,2024-12-03,9693
00795B,中信美國公債20年,30,1,29,富邦-新營,2024-12-03,9693
2103,台橡,30,1,29,富邦-新營,2024-12-03,9693
2349,錸德,27,0,27,富邦-新營,2024-12-03,9693
4114,健喬,26,0,26,富邦-新營,2024-12-03,9693
6005,群益證,20,0,20,富邦-新營,2024-12-03,9693
2312,金寶,73,54,19,富邦-新營,2024-12-03,9693
3380,明泰,24,5,19,富邦-新營,2024-12-03,9693
2303,聯電,39,20,19,富邦-新營,2024-12-03,9693
00679B,元大美債20年,30,14,16,富邦-新營,2024-12-03,9693
4510,高鋒,24,9,15,富邦-新營,2024-12-03,9693
1605,華新,18,5,13,富邦-新營,2024-12-03,9693
3323,加百裕,44,31,13,富邦-新營,2024-12-03,9693
3017,奇鋐,32,20,12,富邦-新營,2024-12-03,9693
1528,恩德,11,0,11,富邦-新營,2024-12-03,9693
2444,兆勁,11,0,11,富邦-新營,2024-12-03,9693
5347,世界,12,1,11,富邦-新營,2024-12-03,9693
2317,鴻海,15,4,11,富邦-新營,2024-12-03,9693
1524,耿鼎,10,0,10,富邦-新營,2024-12-03,9693
00942B,台新美A公司債20+,10,0,10,富邦-新營,2024-12-03,9693
1455,集盛,10,0,10,富邦-新營,2024-12-03,9693
6175,立敦,10,0,10,富邦-新營,2024-12-03,9693
3511,矽瑪,10,0,10,富邦-新營,2024-12-03,9693
8111,立��,11,2,9,富邦-新營,2024-12-03,9693
0056,元大高股息,9,1,8,富邦-新營,2024-12-03,9693
2468,華經,7,0,7,富邦-新營,2024-12-03,9693
4714,永捷,8,1,7,富邦-新營,2024-12-03,9693
2344,華邦電,10,4,6,富邦-新營,2024-12-03,9693
00937B,群益ESG投等債20,7,1,6,富邦-新營,2024-12-03,9693
2419,仲琦,9,3,6,富邦-新營,2024-12-03,9693
3006,晶豪科,6,0,6,富邦-新營,2024-12-03,9693
4716,大立,6,0,6,富邦-新營,2024-12-03,9693
6550,北極星藥業-KY,6,0,6,富邦-新營,2024-12-03,9693
5439,高技,11,6,5,富邦-新營,2024-12-03,9693
2867,三商壽,5,0,5,富邦-新營,2024-12-03,9693
2353,宏��,5,0,5,富邦-新營,2024-12-03,9693
2401,凌陽,5,0,5,富邦-新營,2024-12-03,9693
2883,凱基金,10,5,5,富邦-新營,2024-12-03,9693
3712,永崴投控,7,2,5,富邦-新營,2024-12-03,9693
4420,光明,5,0,5,富邦-新營,2024-12-03,9693
4903,聯光通,5,0,5,富邦-新營,2024-12-03,9693
6277,宏正,5,0,5,富邦-新營,2024-12-03,9693
8034,榮群,5,0,5,富邦-新營,2024-12-03,9693
8028,昇陽半導體,10,6,4,富邦-新營,2024-12-03,9693
1536,和大,7,3,4,富邦-新營,2024-12-03,9693
1909,榮成,130,0,130,富邦-新營,2024-12-04,9693
00959B,大華投等美債15Y+,127,0,127,富邦-新營,2024-12-04,9693
00753L,中信中國50正2,100,0,100,富邦-新營,2024-12-04,9693
2301,光寶科,83,0,83,富邦-新營,2024-12-04,9693
00950B,凱基A級公司債,73,0,73,富邦-新營,2024-12-04,9693
00712,復華富時不動產,69,0,69,富邦-新營,2024-12-04,9693
2605,新興,60,0,60,富邦-新營,2024-12-04,9693
3322,建舜電,50,0,50,富邦-新營,2024-12-04,9693
00918,大華優利高填息30,50,3,47,富邦-新營,2024-12-04,9693
00687B,國泰20年美債,36,4,32,富邦-新營,2024-12-04,9693
2888,新光金,22,0,22,富邦-新營,2024-12-04,9693
9105,泰金寶-DR,24,2,22,富邦-新營,2024-12-04,9693
2312,金寶,46,25,21,富邦-新營,2024-12-04,9693
00679B,元大美債20年,19,0,19,富邦-新營,2024-12-04,9693
1536,和大,20,3,17,富邦-新營,2024-12-04,9693
3372,典範,17,0,17,富邦-新營,2024-12-04,9693
6284,佳邦,16,0,16,富邦-新營,2024-12-04,9693
1301,台塑,16,0,16,富邦-新營,2024-12-04,9693
00715L,期街口布蘭特正2,20,5,15,富邦-新營,2024-12-04,9693
00953B,群益優選非投等債,15,0,15,富邦-新營,2024-12-04,9693
1522,堤維西,13,0,13,富邦-新營,2024-12-04,9693
3376,新日興,15,3,12,富邦-新營,2024-12-04,9693
2337,旺宏,18,7,11,富邦-新營,2024-12-04,9693
00662,富邦NASDAQ,11,0,11,富邦-新營,2024-12-04,9693
00900,富邦特選高股息30,11,0,11,富邦-新營,2024-12-04,9693
2486,一詮,13,2,11,富邦-新營,2024-12-04,9693
5388,中磊,11,0,11,富邦-新營,2024-12-04,9693
3317,尼克森,10,0,10,富邦-新營,2024-12-04,9693
3360,尚立,10,0,10,富邦-新營,2024-12-04,9693
3017,奇鋐,16,6,10,富邦-新營,2024-12-04,9693
2303,聯電,15,6,9,富邦-新營,2024-12-04,9693
00926,凱基全球菁英55,9,0,9,富邦-新營,2024-12-04,9693
2419,仲琦,9,0,9,富邦-新營,2024-12-04,9693
3413,京鼎,8,0,8,富邦-新營,2024-12-04,9693
2476,鉅祥,8,0,8,富邦-新營,2024-12-04,9693
6757,台灣虎航,8,0,8,富邦-新營,2024-12-04,9693
3694,海華,11,3,8,富邦-新營,2024-12-04,9693
2449,京元電子,9,2,7,富邦-新營,2024-12-04,9693
5871,中租-KY,7,0,7,富邦-新營,2024-12-04,9693
00713,元大台灣高息低波,7,0,7,富邦-新營,2024-12-04,9693
00915,凱基優選高股息30,7,0,7,富邦-新營,2024-12-04,9693
00948B,中信優息投資級債,6,0,6,富邦-新營,2024-12-04,9693
2891,中信金,9,3,6,富邦-新營,2024-12-04,9693
6530,創威,28,22,6,富邦-新營,2024-12-04,9693
6139,亞翔,6,0,6,富邦-新營,2024-12-04,9693
3706,神達,69,64,5,富邦-新營,2024-12-04,9693
0056,元大高股息,9,4,5,富邦-新營,2024-12-04,9693
2365,昆盈,5,0,5,富邦-新營,2024-12-04,9693
3625,西勝,5,0,5,富邦-新營,2024-12-04,9693
6235,華孚,5,0,5,富邦-新營,2024-12-04,9693
00953B,群益優選非投等債,96,0,96,富邦-新營,2024-12-05,9693
4979,華星光,89,8,81,富邦-新營,2024-12-05,9693
2349,錸德,63,1,62,富邦-新營,2024-12-05,9693
2887,台新金,54,0,54,富邦-新營,2024-12-05,9693
4991,環宇-KY,51,0,51,富邦-新營,2024-12-05,9693
00665L,富邦�琤肭磪囓�2,50,0,50,富邦-新營,2024-12-05,9693
00945B,凱基美國非投等債,50,0,50,富邦-新營,2024-12-05,9693
1303,南亞,33,0,33,富邦-新營,2024-12-05,9693
4931,新盛力,194,162,32,富邦-新營,2024-12-05,9693
2301,光寶科,31,0,31,富邦-新營,2024-12-05,9693
2312,金寶,55,26,29,富邦-新營,2024-12-05,9693
1909,榮成,26,0,26,富邦-新營,2024-12-05,9693
2888,新光金,26,0,26,富邦-新營,2024-12-05,9693
1528,恩德,24,0,24,富邦-新營,2024-12-05,9693
2303,聯電,32,8,24,富邦-新營,2024-12-05,9693
2204,中華,23,0,23,富邦-新營,2024-12-05,9693
3323,加百裕,242,224,18,富邦-新營,2024-12-05,9693
00907,永豐優息存股,17,0,17,富邦-新營,2024-12-05,9693
0050,元大台灣50,20,3,17,富邦-新營,2024-12-05,9693
1711,永光,15,2,13,富邦-新營,2024-12-05,9693
6442,光聖,14,1,13,富邦-新營,2024-12-05,9693
2392,正崴,22,11,11,富邦-新營,2024-12-05,9693
5439,高技,11,0,11,富邦-新營,2024-12-05,9693
00680L,元大美債20正2,20,10,10,富邦-新營,2024-12-05,9693
2331,精英,10,0,10,富邦-新營,2024-12-05,9693
5488,松普,10,0,10,富邦-新營,2024-12-05,9693
6901,鑽石投資,10,0,10,富邦-新營,2024-12-05,9693
00900,富邦特選高股息30,12,2,10,富邦-新營,2024-12-05,9693
00918,大華優利高填息30,11,2,9,富邦-新營,2024-12-05,9693
2880,華南金,10,1,9,富邦-新營,2024-12-05,9693
6156,松上,10,1,9,富邦-新營,2024-12-05,9693
6174,安��,9,0,9,富邦-新營,2024-12-05,9693
5328,華容,349,342,7,富邦-新營,2024-12-05,9693
2882,國泰金,6,0,6,富邦-新營,2024-12-05,9693
3015,全漢,20,14,6,富邦-新營,2024-12-05,9693
2408,南亞科,6,0,6,富邦-新營,2024-12-05,9693
5244,弘凱,6,0,6,富邦-新營,2024-12-05,9693
5309,系統電,7,1,6,富邦-新營,2024-12-05,9693
6175,立敦,6,0,6,富邦-新營,2024-12-05,9693
6191,精成科,6,0,6,富邦-新營,2024-12-05,9693
2317,鴻海,6,0,6,富邦-新營,2024-12-05,9693
6152,百一,6,0,6,富邦-新營,2024-12-05,9693
2492,華新科,7,2,5,富邦-新營,2024-12-05,9693
00696B,富邦美債20年,5,0,5,富邦-新營,2024-12-05,9693
2363,矽統,7,2,5,富邦-新營,2024-12-05,9693
2371,大同,7,2,5,富邦-新營,2024-12-05,9693
2547,日勝生,5,0,5,富邦-新營,2024-12-05,9693
2646,星宇航空,5,0,5,富邦-新營,2024-12-05,9693
3003,健和興,5,0,5,富邦-新營,2024-12-05,9693
3625,西勝,5,0,5,富邦-新營,2024-12-05,9693
6426,統新,167,13,154,富邦-新營,2024-12-06,9693
2834,臺企銀,100,0,100,富邦-新營,2024-12-06,9693
00953B,群益優選非投等債,80,0,80,富邦-新營,2024-12-06,9693
00679B,元大美債20年,48,2,46,富邦-新營,2024-12-06,9693
2349,錸德,50,10,40,富邦-新營,2024-12-06,9693
2312,金寶,135,103,32,富邦-新營,2024-12-06,9693
2337,旺宏,44,13,31,富邦-新營,2024-12-06,9693
00712,復華富時不動產,29,0,29,富邦-新營,2024-12-06,9693
2601,益航,24,0,24,富邦-新營,2024-12-06,9693
2344,華邦電,37,14,23,富邦-新營,2024-12-06,9693
2855,統一證,23,0,23,富邦-新營,2024-12-06,9693
2241,艾姆勒,34,12,22,富邦-新營,2024-12-06,9693
00662,富邦NASDAQ,20,0,20,富邦-新營,2024-12-06,9693
00900,富邦特選高股息30,20,0,20,富邦-新營,2024-12-06,9693
3202,樺晟,20,0,20,富邦-新營,2024-12-06,9693
3521,鴻翊,20,1,19,富邦-新營,2024-12-06,9693
00918,大華優利高填息30,18,0,18,富邦-新營,2024-12-06,9693
00915,凱基優選高股息30,20,3,17,富邦-新營,2024-12-06,9693
00882,中信中國高股息,17,0,17,富邦-新營,2024-12-06,9693
4956,光鋐,115,100,15,富邦-新營,2024-12-06,9693
2405,輔信,19,5,14,富邦-新營,2024-12-06,9693
8069,元太,14,0,14,富邦-新營,2024-12-06,9693
9941,裕融,13,0,13,富邦-新營,2024-12-06,9693
3259,鑫創,12,0,12,富邦-新營,2024-12-06,9693
6757,台灣虎航,13,2,11,富邦-新營,2024-12-06,9693
3189,景碩,12,1,11,富邦-新營,2024-12-06,9693
1815,富喬,31,20,11,富邦-新營,2024-12-06,9693
3576,聯合再生,10,0,10,富邦-新營,2024-12-06,9693
4571,鈞興-KY,10,0,10,富邦-新營,2024-12-06,9693
8042,金山電,12,2,10,富邦-新營,2024-12-06,9693
6151,晉倫,10,1,9,富邦-新營,2024-12-06,9693
0050,元大台灣50,9,1,8,富邦-新營,2024-12-06,9693
2888,新光金,10,2,8,富邦-新營,2024-12-06,9693
3501,維熹,8,0,8,富邦-新營,2024-12-06,9693
2303,聯電,12,5,7,富邦-新營,2024-12-06,9693
3706,神達,101,94,7,富邦-新營,2024-12-06,9693
2363,矽統,7,0,7,富邦-新營,2024-12-06,9693
3019,亞光,7,0,7,富邦-新營,2024-12-06,9693
2486,一詮,6,0,6,富邦-新營,2024-12-06,9693
00715L,期街口布蘭特正2,8,2,6,富邦-新營,2024-12-06,9693
1528,恩德,6,0,6,富邦-新營,2024-12-06,9693
1789,神隆,6,0,6,富邦-新營,2024-12-06,9693
2501,國建,6,0,6,富邦-新營,2024-12-06,9693
3380,明泰,6,0,6,富邦-新營,2024-12-06,9693
5488,松普,6,0,6,富邦-新營,2024-12-06,9693
00930,永豐ESG低碳高息,6,0,6,富邦-新營,2024-12-06,9693
2882,國泰金,5,0,5,富邦-新營,2024-12-06,9693
3025,星通,6,1,5,富邦-新營,2024-12-06,9693
00637L,元大滬深300正2,5,0,5,富邦-新營,2024-12-06,9693
2002,中鋼,7,2,5,富邦-新營,2024-12-06,9693
00953B,群益優選非投等債,155,0,155,富邦-新營,2024-12-09,9693
4977,眾達-KY,262,130,132,富邦-新營,2024-12-09,9693
00948B,中信優息投資級債,100,0,100,富邦-新營,2024-12-09,9693
00919,群益台灣精選高息,80,4,76,富邦-新營,2024-12-09,9693
6425,易發,71,7,64,富邦-新營,2024-12-09,9693
4991,環宇-KY,113,63,50,富邦-新營,2024-12-09,9693
00939,統一台灣高息動能,34,2,32,富邦-新營,2024-12-09,9693
2349,錸德,23,0,23,富邦-新營,2024-12-09,9693
2816,旺旺保,20,0,20,富邦-新營,2024-12-09,9693
00907,永豐優息存股,20,2,18,富邦-新營,2024-12-09,9693
00655L,國泰中國A50正2,18,0,18,富邦-新營,2024-12-09,9693
2883,凱基金,18,2,16,富邦-新營,2024-12-09,9693
00915,凱基優選高股息30,15,2,13,富邦-新營,2024-12-09,9693
2354,鴻準,41,29,12,富邦-新營,2024-12-09,9693
00715L,期街口布蘭特正2,10,0,10,富邦-新營,2024-12-09,9693
2010,春源,10,0,10,富邦-新營,2024-12-09,9693
5469,瀚宇博,10,0,10,富邦-新營,2024-12-09,9693
6962,ITH-KY,10,0,10,富邦-新營,2024-12-09,9693
2317,鴻海,10,1,9,富邦-新營,2024-12-09,9693
1305,華夏,9,0,9,富邦-新營,2024-12-09,9693
2449,京元電子,12,3,9,富邦-新營,2024-12-09,9693
2474,可成,8,0,8,富邦-新營,2024-12-09,9693
2374,佳能,15,7,8,富邦-新營,2024-12-09,9693
00679B,元大美債20年,32,25,7,富邦-新營,2024-12-09,9693
3211,順達,65,58,7,富邦-新營,2024-12-09,9693
2436,偉詮電,7,0,7,富邦-新營,2024-12-09,9693
8942,森鉅,7,0,7,富邦-新營,2024-12-09,9693
2323,中環,7,0,7,富邦-新營,2024-12-09,9693
3710,連展投控,10,3,7,富邦-新營,2024-12-09,9693
4192,杏國,7,0,7,富邦-新營,2024-12-09,9693
5484,慧友,7,0,7,富邦-新營,2024-12-09,9693
6695,芯鼎,17,10,7,富邦-新營,2024-12-09,9693
9941,裕融,6,0,6,富邦-新營,2024-12-09,9693
00962,台新AI優息動能,7,1,6,富邦-新營,2024-12-09,9693
5371,中光電,6,0,6,富邦-新營,2024-12-09,9693
8210,勤誠,6,0,6,富邦-新營,2024-12-09,9693
8249,菱光,9,3,6,富邦-新營,2024-12-09,9693
3706,神達,11,6,5,富邦-新營,2024-12-09,9693
00922,國泰台灣領袖50,5,0,5,富邦-新營,2024-12-09,9693
00662,富邦NASDAQ,5,0,5,富邦-新營,2024-12-09,9693
2302,麗正,5,0,5,富邦-新營,2024-12-09,9693
4526,東台,5,0,5,富邦-新營,2024-12-09,9693
4956,光鋐,6,1,5,富邦-新營,2024-12-09,9693
5324,士開,5,0,5,富邦-新營,2024-12-09,9693
5475,德宏,5,0,5,富邦-新營,2024-12-09,9693
6727,亞泰金屬,5,0,5,富邦-新營,2024-12-09,9693
3029,零壹,109,104,5,富邦-新營,2024-12-09,9693
1216,統一,4,0,4,富邦-新營,2024-12-09,9693
1532,勤美,4,0,4,富邦-新營,2024-12-09,9693
2332,友訊,4,0,4,富邦-新營,2024-12-09,9693
0056,元大高股息,86,2,84,富邦-新營,2024-12-10,9693
00665L,富邦�琤肭磪囓�2,86,11,75,富邦-新營,2024-12-10,9693
00713,元大台灣高息低波,52,0,52,富邦-新營,2024-12-10,9693
00948B,中信優息投資級債,40,0,40,富邦-新營,2024-12-10,9693
2317,鴻海,35,0,35,富邦-新營,2024-12-10,9693
00680L,元大美債20正2,30,0,30,富邦-新營,2024-12-10,9693
3706,神達,219,194,25,富邦-新營,2024-12-10,9693
00919,群益台灣精選高息,30,5,25,富邦-新營,2024-12-10,9693
00633L,富邦上証正2,55,31,24,富邦-新營,2024-12-10,9693
00878,國泰永續高股息,20,0,20,富邦-新營,2024-12-10,9693
00887,永豐中國科技50大,23,3,20,富邦-新營,2024-12-10,9693
3607,谷崧,19,0,19,富邦-新營,2024-12-10,9693
00962,台新AI優息動能,22,5,17,富邦-新營,2024-12-10,9693
00918,大華優利高填息30,29,12,17,富邦-新營,2024-12-10,9693
1101,台泥,18,3,15,富邦-新營,2024-12-10,9693
2887,台新金,20,6,14,富邦-新營,2024-12-10,9693
00662,富邦NASDAQ,12,0,12,富邦-新營,2024-12-10,9693
2455,全新,11,0,11,富邦-新營,2024-12-10,9693
2103,台橡,10,0,10,富邦-新營,2024-12-10,9693
00686R,群益臺灣加權反1,10,0,10,富邦-新營,2024-12-10,9693
1314,中石化,10,0,10,富邦-新營,2024-12-10,9693
2323,中環,10,0,10,富邦-新營,2024-12-10,9693
3264,欣銓,10,0,10,富邦-新營,2024-12-10,9693
8086,宏捷科,10,0,10,富邦-新營,2024-12-10,9693
8110,華東,10,0,10,富邦-新營,2024-12-10,9693
00795B,中信美國公債20年,10,1,9,富邦-新營,2024-12-10,9693
2359,所羅門,12,3,9,富邦-新營,2024-12-10,9693
2449,京元電子,13,4,9,富邦-新營,2024-12-10,9693
00922,國泰台灣領袖50,8,0,8,富邦-新營,2024-12-10,9693
00936,台新永續高息中小,10,2,8,富邦-新營,2024-12-10,9693
2025,千興,11,3,8,富邦-新營,2024-12-10,9693
3290,東浦,8,0,8,富邦-新營,2024-12-10,9693
3323,加百裕,27,19,8,富邦-新營,2024-12-10,9693
3625,西勝,10,2,8,富邦-新營,2024-12-10,9693
5381,合正,7,0,7,富邦-新營,2024-12-10,9693
2615,萬海,7,0,7,富邦-新營,2024-12-10,9693
2312,金寶,60,53,7,富邦-新營,2024-12-10,9693
2834,臺企銀,7,0,7,富邦-新營,2024-12-10,9693
2409,友達,7,1,6,富邦-新營,2024-12-10,9693
3019,亞光,12,6,6,富邦-新營,2024-12-10,9693
3413,京鼎,6,0,6,富邦-新營,2024-12-10,9693
4931,新盛力,7,1,6,富邦-新營,2024-12-10,9693
6142,友勁,6,0,6,富邦-新營,2024-12-10,9693
2609,陽明,56,51,5,富邦-新營,2024-12-10,9693
3017,奇鋐,5,0,5,富邦-新營,2024-12-10,9693
6180,橘子,5,0,5,富邦-新營,2024-12-10,9693
2618,長榮航,11,6,5,富邦-新營,2024-12-10,9693
6505,台塑化,11,6,5,富邦-新營,2024-12-10,9693
2399,映泰,5,0,5,富邦-新營,2024-12-10,9693
3056,富華新,7,2,5,富邦-新營,2024-12-10,9693
00686R,群益臺灣加權反1,200,0,200,富邦-新營,2024-12-11,9693
00878,國泰永續高股息,139,1,138,富邦-新營,2024-12-11,9693
00948B,中信優息投資級債,126,0,126,富邦-新營,2024-12-11,9693
00676R,富邦臺灣加權反1,120,0,120,富邦-新營,2024-12-11,9693
00959B,大華投等美債15Y+,100,2,98,富邦-新營,2024-12-11,9693
00937B,群益ESG投等債20,92,0,92,富邦-新營,2024-12-11,9693
00919,群益台灣精選高息,96,15,81,富邦-新營,2024-12-11,9693
2303,聯電,61,3,58,富邦-新營,2024-12-11,9693
00753L,中信中國50正2,56,0,56,富邦-新營,2024-12-11,9693
00665L,富邦�琤肭磪囓�2,50,5,45,富邦-新營,2024-12-11,9693
6129,普誠,30,0,30,富邦-新營,2024-12-11,9693
006208,富邦台50,30,0,30,富邦-新營,2024-12-11,9693
00900,富邦特選高股息30,25,0,25,富邦-新營,2024-12-11,9693
3379,彬台,25,0,25,富邦-新營,2024-12-11,9693
2371,大同,23,0,23,富邦-新營,2024-12-11,9693
00918,大華優利高填息30,48,25,23,富邦-新營,2024-12-11,9693
2883,凱基金,22,1,21,富邦-新營,2024-12-11,9693
8110,華東,21,0,21,富邦-新營,2024-12-11,9693
2388,威盛,31,11,20,富邦-新營,2024-12-11,9693
2436,偉詮電,21,1,20,富邦-新營,2024-12-11,9693
5381,合正,19,0,19,富邦-新營,2024-12-11,9693
3234,光環,18,2,16,富邦-新營,2024-12-11,9693
5347,世界,16,1,15,富邦-新營,2024-12-11,9693
8429,金麗-KY,15,0,15,富邦-新營,2024-12-11,9693
2408,南亞科,13,0,13,富邦-新營,2024-12-11,9693
3413,京鼎,13,0,13,富邦-新營,2024-12-11,9693
2344,華邦電,17,4,13,富邦-新營,2024-12-11,9693
0056,元大高股息,18,5,13,富邦-新營,2024-12-11,9693
00922,國泰台灣領袖50,12,0,12,富邦-新營,2024-12-11,9693
2472,立隆電,12,0,12,富邦-新營,2024-12-11,9693
8076,伍豐,12,0,12,富邦-新營,2024-12-11,9693
2002,中鋼,12,1,11,富邦-新營,2024-12-11,9693
2610,華航,13,2,11,富邦-新營,2024-12-11,9693
00930,永豐ESG低碳高息,10,0,10,富邦-新營,2024-12-11,9693
00881,國泰台灣5G+,10,0,10,富邦-新營,2024-12-11,9693
3231,緯創,14,4,10,富邦-新營,2024-12-11,9693
2329,華泰,10,0,10,富邦-新營,2024-12-11,9693
00715L,期街口布蘭特正2,20,10,10,富邦-新營,2024-12-11,9693
2349,錸德,10,0,10,富邦-新營,2024-12-11,9693
3049,精金,10,0,10,富邦-新營,2024-12-11,9693
3230,錦明,10,0,10,富邦-新營,2024-12-11,9693
4303,信立,11,1,10,富邦-新營,2024-12-11,9693
4716,大立,10,0,10,富邦-新營,2024-12-11,9693
8277,商丞,10,0,10,富邦-新營,2024-12-11,9693
00949,復華日本龍頭,10,0,10,富邦-新營,2024-12-11,9693
3704,合勤控,9,0,9,富邦-新營,2024-12-11,9693
6589,台康生技,9,0,9,富邦-新營,2024-12-11,9693
5371,中光電,61,52,9,富邦-新營,2024-12-11,9693
00915,凱基優選高股息30,13,5,8,富邦-新營,2024-12-11,9693
00680L,元大美債20正2,10,2,8,富邦-新營,2024-12-11,9693
00650L,復華香港正2,237,102,135,富邦-新營,2024-12-12,9693
2303,聯電,122,2,120,富邦-新營,2024-12-12,9693
00948B,中信優息投資級債,86,0,86,富邦-新營,2024-12-12,9693
00918,大華優利高填息30,74,0,74,富邦-新營,2024-12-12,9693
00969B,元大零息超長美債,70,0,70,富邦-新營,2024-12-12,9693
00919,群益台灣精選高息,65,4,61,富邦-新營,2024-12-12,9693
00915,凱基優選高股息30,54,0,54,富邦-新營,2024-12-12,9693
6151,晉倫,50,0,50,富邦-新營,2024-12-12,9693
00830,國泰費城半導體,50,0,50,富邦-新營,2024-12-12,9693
8249,菱光,33,3,30,富邦-新營,2024-12-12,9693
3322,建舜電,30,1,29,富邦-新營,2024-12-12,9693
00937B,群益ESG投等債20,26,0,26,富邦-新營,2024-12-12,9693
00680L,元大美債20正2,26,0,26,富邦-新營,2024-12-12,9693
2049,上銀,25,0,25,富邦-新營,2024-12-12,9693
00929,復華台灣科技優息,31,7,24,富邦-新營,2024-12-12,9693
2883B,凱基金乙特,21,0,21,富邦-新營,2024-12-12,9693
2605,新興,20,0,20,富邦-新營,2024-12-12,9693
00679B,元大美債20年,32,12,20,富邦-新營,2024-12-12,9693
1815,富喬,43,25,18,富邦-新營,2024-12-12,9693
3413,京鼎,17,0,17,富邦-新營,2024-12-12,9693
2371,大同,16,0,16,富邦-新營,2024-12-12,9693
1326,台化,22,7,15,富邦-新營,2024-12-12,9693
2609,陽明,31,16,15,富邦-新營,2024-12-12,9693
2633,台灣高鐵,15,0,15,富邦-新營,2024-12-12,9693
5381,合正,15,0,15,富邦-新營,2024-12-12,9693
6177,達麗,13,0,13,富邦-新營,2024-12-12,9693
6589,台康生技,12,0,12,富邦-新營,2024-12-12,9693
6770,力積電,12,1,11,富邦-新營,2024-12-12,9693
00960,野村全球航運龍頭,10,0,10,富邦-新營,2024-12-12,9693
2392,正崴,10,0,10,富邦-新營,2024-12-12,9693
1709,和益,10,0,10,富邦-新營,2024-12-12,9693
1722,台肥,10,0,10,富邦-新營,2024-12-12,9693
2388,威盛,22,12,10,富邦-新營,2024-12-12,9693
2883,凱基金,15,6,9,富邦-新營,2024-12-12,9693
1717,長興,9,0,9,富邦-新營,2024-12-12,9693
3049,精金,10,1,9,富邦-新營,2024-12-12,9693
3290,東浦,9,0,9,富邦-新營,2024-12-12,9693
2317,鴻海,13,4,9,富邦-新營,2024-12-12,9693
00933B,國泰10Y+金融債,8,0,8,富邦-新營,2024-12-12,9693
3041,揚智,16,8,8,富邦-新營,2024-12-12,9693
00687B,國泰20年美債,7,0,7,富邦-新營,2024-12-12,9693
00740B,富邦全球投等債,7,0,7,富邦-新營,2024-12-12,9693
1303,南亞,6,0,6,富邦-新營,2024-12-12,9693
3029,零壹,11,5,6,富邦-新營,2024-12-12,9693
8070,長華*,6,0,6,富邦-新營,2024-12-12,9693
2344,華邦電,7,1,6,富邦-新營,2024-12-12,9693
2886,兆豐金,6,0,6,富邦-新營,2024-12-12,9693
3323,加百裕,27,21,6,富邦-新營,2024-12-12,9693
4977,眾達-KY,75,69,6,富邦-新營,2024-12-12,9693
00713,元大台灣高息低波,6,0,6,富邦-新營,2024-12-12,9693
00937B,群益ESG投等債20,246,10,236,富邦-新營,2024-12-13,9693
00753L,中信中國50正2,151,0,151,富邦-新營,2024-12-13,9693
00969B,元大零息超長美債,103,0,103,富邦-新營,2024-12-13,9693
3322,建舜電,70,0,70,富邦-新營,2024-12-13,9693
00650L,復華香港正2,185,120,65,富邦-新營,2024-12-13,9693
00665L,富邦�琤肭磪囓�2,55,0,55,富邦-新營,2024-12-13,9693
00680L,元大美債20正2,51,0,51,富邦-新營,2024-12-13,9693
00919,群益台灣精選高息,56,7,49,富邦-新營,2024-12-13,9693
00933B,國泰10Y+金融債,44,0,44,富邦-新營,2024-12-13,9693
00712,復華富時不動產,56,14,42,富邦-新營,2024-12-13,9693
00918,大華優利高填息30,42,0,42,富邦-新營,2024-12-13,9693
00942B,台新美A公司債20+,29,0,29,富邦-新營,2024-12-13,9693
00915,凱基優選高股息30,27,0,27,富邦-新營,2024-12-13,9693
1605,華新,24,0,24,富邦-新營,2024-12-13,9693
2317,鴻海,25,2,23,富邦-新營,2024-12-13,9693
1409,新纖,22,0,22,富邦-新營,2024-12-13,9693
00945B,凱基美國非投等債,19,0,19,富邦-新營,2024-12-13,9693
2354,鴻準,23,5,18,富邦-新營,2024-12-13,9693
00948B,中信優息投資級債,17,0,17,富邦-新營,2024-12-13,9693
3481,群創,19,2,17,富邦-新營,2024-12-13,9693
00830,國泰費城半導體,15,0,15,富邦-新營,2024-12-13,9693
2633,台灣高鐵,15,0,15,富邦-新營,2024-12-13,9693
9938,百和,13,0,13,富邦-新營,2024-12-13,9693
2344,華邦電,13,0,13,富邦-新營,2024-12-13,9693
2371,大同,24,11,13,富邦-新營,2024-12-13,9693
6558,興能高,37,24,13,富邦-新營,2024-12-13,9693
0056,元大高股息,13,0,13,富邦-新營,2024-12-13,9693
3706,神達,62,50,12,富邦-新營,2024-12-13,9693
3037,欣興,13,1,12,富邦-新營,2024-12-13,9693
4510,高鋒,11,0,11,富邦-新營,2024-12-13,9693
6443,元晶,11,0,11,富邦-新營,2024-12-13,9693
3323,加百裕,67,56,11,富邦-新營,2024-12-13,9693
2104,國際中橡,11,0,11,富邦-新營,2024-12-13,9693
00936,台新永續高息中小,10,0,10,富邦-新營,2024-12-13,9693
2436,偉詮電,10,0,10,富邦-新營,2024-12-13,9693
2897,王道銀行,10,0,10,富邦-新營,2024-12-13,9693
4147,中裕,10,0,10,富邦-新營,2024-12-13,9693
6901,鑽石投資,10,0,10,富邦-新營,2024-12-13,9693
3231,緯創,10,1,9,富邦-新營,2024-12-13,9693
00637L,元大滬深300正2,9,0,9,富邦-新營,2024-12-13,9693
2426,鼎元,9,0,9,富邦-新營,2024-12-13,9693
6405,悅城,10,1,9,富邦-新營,2024-12-13,9693
6770,力積電,9,0,9,富邦-新營,2024-12-13,9693
00905,FT臺灣Smart,10,2,8,富邦-新營,2024-12-13,9693
2201,裕隆,8,0,8,富邦-新營,2024-12-13,9693
4743,合一,10,2,8,富邦-新營,2024-12-13,9693
6235,華孚,10,2,8,富邦-新營,2024-12-13,9693
00878,國泰永續高股息,14,6,8,富邦-新營,2024-12-13,9693
00713,元大台灣高息低波,7,0,7,富邦-新營,2024-12-13,9693
00687B,國泰20年美債,7,0,7,富邦-新營,2024-12-13,9693
00680L,元大美債20正2,138,0,138,富邦-新營,2024-12-16,9693
00918,大華優利高填息30,134,2,132,富邦-新營,2024-12-16,9693
00919,群益台灣精選高息,101,1,100,富邦-新營,2024-12-16,9693
00712,復華富時不動產,100,0,100,富邦-新營,2024-12-16,9693
00937B,群益ESG投等債20,67,3,64,富邦-新營,2024-12-16,9693
1722,台肥,50,0,50,富邦-新營,2024-12-16,9693
8374,羅昇,50,0,50,富邦-新營,2024-12-16,9693
6016,康和證,40,0,40,富邦-新營,2024-12-16,9693
00662,富邦NASDAQ,45,5,40,富邦-新營,2024-12-16,9693
1909,榮成,39,0,39,富邦-新營,2024-12-16,9693
00679B,元大美債20年,37,0,37,富邦-新營,2024-12-16,9693
3322,建舜電,35,0,35,富邦-新營,2024-12-16,9693
00753L,中信中國50正2,34,0,34,富邦-新營,2024-12-16,9693
3607,谷崧,34,0,34,富邦-新營,2024-12-16,9693
00933B,國泰10Y+金融債,30,0,30,富邦-新營,2024-12-16,9693
6005,群益證,25,1,24,富邦-新營,2024-12-16,9693
2609,陽明,71,48,23,富邦-新營,2024-12-16,9693
2317,鴻海,39,16,23,富邦-新營,2024-12-16,9693
00687B,國泰20年美債,24,3,21,富邦-新營,2024-12-16,9693
00905,FT臺灣Smart,21,0,21,富邦-新營,2024-12-16,9693
2906,高林,21,0,21,富邦-新營,2024-12-16,9693
2605,新興,20,0,20,富邦-新營,2024-12-16,9693
2409,友達,20,0,20,富邦-新營,2024-12-16,9693
3303,岱稜,20,0,20,富邦-新營,2024-12-16,9693
00632R,元大台灣50反1,20,0,20,富邦-新營,2024-12-16,9693
2002,中鋼,22,4,18,富邦-新營,2024-12-16,9693
0056,元大高股息,19,2,17,富邦-新營,2024-12-16,9693
1806,冠軍,15,0,15,富邦-新營,2024-12-16,9693
2354,鴻準,34,20,14,富邦-新營,2024-12-16,9693
00673R,期元大S＆P原油反1,14,0,14,富邦-新營,2024-12-16,9693
2486,一詮,14,0,14,富邦-新營,2024-12-16,9693
00650L,復華香港正2,13,0,13,富邦-新營,2024-12-16,9693
2313,華通,27,14,13,富邦-新營,2024-12-16,9693
00915,凱基優選高股息30,12,0,12,富邦-新營,2024-12-16,9693
1314,中石化,14,2,12,富邦-新營,2024-12-16,9693
2855,統一證,12,0,12,富邦-新營,2024-12-16,9693
00966B,統一ESG投等債15,11,0,11,富邦-新營,2024-12-16,9693
2104,國際中橡,11,0,11,富邦-新營,2024-12-16,9693
2618,長榮航,12,1,11,富邦-新營,2024-12-16,9693
8069,元太,10,0,10,富邦-新營,2024-12-16,9693
00688L,國泰20年美債正2,10,0,10,富邦-新營,2024-12-16,9693
1313,聯成,10,0,10,富邦-新營,2024-12-16,9693
2413,環科,10,0,10,富邦-新營,2024-12-16,9693
2601,益航,10,0,10,富邦-新營,2024-12-16,9693
3230,錦明,10,0,10,富邦-新營,2024-12-16,9693
6558,興能高,18,8,10,富邦-新營,2024-12-16,9693
2887,台新金,10,0,10,富邦-新營,2024-12-16,9693
2344,華邦電,9,0,9,富邦-新營,2024-12-16,9693
4109,加捷生醫,10,1,9,富邦-新營,2024-12-16,9693
4974,亞泰,12,3,9,富邦-新營,2024-12-16,9693
2374,佳能,270,66,204,富邦-新營,2024-12-17,9693
2303,聯電,145,16,129,富邦-新營,2024-12-17,9693
00948B,中信優息投資級債,105,0,105,富邦-新營,2024-12-17,9693
1536,和大,108,35,73,富邦-新營,2024-12-17,9693
3481,群創,57,2,55,富邦-新營,2024-12-17,9693
00918,大華優利高填息30,53,0,53,富邦-新營,2024-12-17,9693
00937B,群益ESG投等債20,46,0,46,富邦-新營,2024-12-17,9693
00915,凱基優選高股息30,39,5,34,富邦-新營,2024-12-17,9693
00969B,元大零息超長美債,30,0,30,富邦-新營,2024-12-17,9693
00933B,國泰10Y+金融債,23,0,23,富邦-新營,2024-12-17,9693
2609,陽明,38,15,23,富邦-新營,2024-12-17,9693
2834,臺企銀,25,3,22,富邦-新營,2024-12-17,9693
2331,精英,20,0,20,富邦-新營,2024-12-17,9693
00679B,元大美債20年,24,5,19,富邦-新營,2024-12-17,9693
6757,台灣虎航,20,2,18,富邦-新營,2024-12-17,9693
6213,聯茂,16,0,16,富邦-新營,2024-12-17,9693
2449,京元電子,15,0,15,富邦-新營,2024-12-17,9693
2883,凱基金,17,2,15,富邦-新營,2024-12-17,9693
2354,鴻準,25,11,14,富邦-新營,2024-12-17,9693
00673R,期元大S＆P原油反1,14,0,14,富邦-新營,2024-12-17,9693
00753L,中信中國50正2,12,1,11,富邦-新營,2024-12-17,9693
00910,第一金太空衛星,10,0,10,富邦-新營,2024-12-17,9693
00902,中信電池及儲能,10,0,10,富邦-新營,2024-12-17,9693
00907,永豐優息存股,10,0,10,富邦-新營,2024-12-17,9693
00650L,復華香港正2,13,3,10,富邦-新營,2024-12-17,9693
00959B,大華投等美債15Y+,11,1,10,富邦-新營,2024-12-17,9693
1217,愛之味,10,0,10,富邦-新營,2024-12-17,9693
1789,神隆,10,0,10,富邦-新營,2024-12-17,9693
4974,亞泰,12,2,10,富邦-新營,2024-12-17,9693
2353,宏��,10,0,10,富邦-新營,2024-12-17,9693
00713,元大台灣高息低波,10,0,10,富邦-新營,2024-12-17,9693
1584,精剛,9,0,9,富邦-新營,2024-12-17,9693
2405,輔信,10,1,9,富邦-新營,2024-12-17,9693
4977,眾達-KY,31,22,9,富邦-新營,2024-12-17,9693
6451,訊芯-KY,9,0,9,富邦-新營,2024-12-17,9693
0056,元大高股息,9,1,8,富邦-新營,2024-12-17,9693
00919,群益台灣精選高息,19,11,8,富邦-新營,2024-12-17,9693
2002,中鋼,10,3,7,富邦-新營,2024-12-17,9693
2301,光寶科,7,0,7,富邦-新營,2024-12-17,9693
3029,零壹,7,0,7,富邦-新營,2024-12-17,9693
2515,中工,7,0,7,富邦-新營,2024-12-17,9693
6706,惠特,7,0,7,富邦-新營,2024-12-17,9693
2812,台中銀,7,0,7,富邦-新營,2024-12-17,9693
5880,合庫金,7,0,7,富邦-新營,2024-12-17,9693
2882,國泰金,6,0,6,富邦-新營,2024-12-17,9693
1326,台化,6,0,6,富邦-新營,2024-12-17,9693
00693U,期街口S＆P黃豆,6,0,6,富邦-新營,2024-12-17,9693
1402,遠東新,6,0,6,富邦-新營,2024-12-17,9693
1718,中纖,6,0,6,富邦-新營,2024-12-17,9693
6550,北極星藥業-KY,6,0,6,富邦-新營,2024-12-17,9693
2409,友達,105,0,105,富邦-新營,2024-12-18,9693
00937B,群益ESG投等債20,84,0,84,富邦-新營,2024-12-18,9693
00918,大華優利高填息30,74,0,74,富邦-新營,2024-12-18,9693
00933B,國泰10Y+金融債,108,50,58,富邦-新營,2024-12-18,9693
1909,榮成,52,0,52,富邦-新營,2024-12-18,9693
2359,所羅門,68,17,51,富邦-新營,2024-12-18,9693
6191,精成科,36,0,36,富邦-新營,2024-12-18,9693
00919,群益台灣精選高息,88,58,30,富邦-新營,2024-12-18,9693
6962,ITH-KY,27,1,26,富邦-新營,2024-12-18,9693
00712,復華富時不動產,26,0,26,富邦-新營,2024-12-18,9693
4510,高鋒,25,1,24,富邦-新營,2024-12-18,9693
00924,復華S＆P500成長,20,0,20,富邦-新營,2024-12-18,9693
2888,新光金,20,0,20,富邦-新營,2024-12-18,9693
8249,菱光,76,59,17,富邦-新營,2024-12-18,9693
00882,中信中國高股息,16,1,15,富邦-新營,2024-12-18,9693
00959B,大華投等美債15Y+,15,0,15,富邦-新營,2024-12-18,9693
4956,光鋐,15,0,15,富邦-新營,2024-12-18,9693
00673R,期元大S＆P原油反1,14,0,14,富邦-新營,2024-12-18,9693
1314,中石化,14,0,14,富邦-新營,2024-12-18,9693
5371,中光電,15,1,14,富邦-新營,2024-12-18,9693
1597,直得,15,2,13,富邦-新營,2024-12-18,9693
6142,友勁,12,0,12,富邦-新營,2024-12-18,9693
5905,南仁湖,12,0,12,富邦-新營,2024-12-18,9693
2317,鴻海,18,7,11,富邦-新營,2024-12-18,9693
00881,國泰台灣5G+,10,0,10,富邦-新營,2024-12-18,9693
2201,裕隆,9,1,8,富邦-新營,2024-12-18,9693
2337,旺宏,8,0,8,富邦-新營,2024-12-18,9693
2498,宏達電,8,0,8,富邦-新營,2024-12-18,9693
00713,元大台灣高息低波,6,0,6,富邦-新營,2024-12-18,9693
1718,中纖,6,0,6,富邦-新營,2024-12-18,9693
2427,三商電,6,0,6,富邦-新營,2024-12-18,9693
3059,華晶科,6,0,6,富邦-新營,2024-12-18,9693
5484,慧友,11,5,6,富邦-新營,2024-12-18,9693
3013,晟銘電,6,1,5,富邦-新營,2024-12-18,9693
3017,奇鋐,13,8,5,富邦-新營,2024-12-18,9693
2609,陽明,15,10,5,富邦-新營,2024-12-18,9693
3372,典範,5,0,5,富邦-新營,2024-12-18,9693
1806,冠軍,5,0,5,富邦-新營,2024-12-18,9693
2466,冠西電,5,0,5,富邦-新營,2024-12-18,9693
3576,聯合再生,5,0,5,富邦-新營,2024-12-18,9693
4561,健椿,5,0,5,富邦-新營,2024-12-18,9693
6126,信音,5,0,5,富邦-新營,2024-12-18,9693
6695,芯鼎,15,10,5,富邦-新營,2024-12-18,9693
9938,百和,5,0,5,富邦-新營,2024-12-18,9693
8349,�矬�,5,0,5,富邦-新營,2024-12-18,9693
2382,廣達,7,2,5,富邦-新營,2024-12-18,9693
3665,貿聯-KY,4,0,4,富邦-新營,2024-12-18,9693
2354,鴻準,8,4,4,富邦-新營,2024-12-18,9693
5425,台半,4,0,4,富邦-新營,2024-12-18,9693
00720B,元大投資級公司債,5,1,4,富邦-新營,2024-12-18,9693
00919,群益台灣精選高息,197,21,176,富邦-新營,2024-12-19,9693
2464,盟立,150,0,150,富邦-新營,2024-12-19,9693
2409,友達,118,0,118,富邦-新營,2024-12-19,9693
00918,大華優利高填息30,82,2,80,富邦-新營,2024-12-19,9693
00679B,元大美債20年,48,1,47,富邦-新營,2024-12-19,9693
00937B,群益ESG投等債20,47,10,37,富邦-新營,2024-12-19,9693
2867,三商壽,35,0,35,富邦-新營,2024-12-19,9693
00753L,中信中國50正2,32,0,32,富邦-新營,2024-12-19,9693
00942B,台新美A公司債20+,31,0,31,富邦-新營,2024-12-19,9693
6558,興能高,148,118,30,富邦-新營,2024-12-19,9693
006208,富邦台50,28,0,28,富邦-新營,2024-12-19,9693
2883,凱基金,29,2,27,富邦-新營,2024-12-19,9693
2317,鴻海,32,9,23,富邦-新營,2024-12-19,9693
5009,榮剛,22,0,22,富邦-新營,2024-12-19,9693
2349,錸德,21,0,21,富邦-新營,2024-12-19,9693
3706,神達,243,224,19,富邦-新營,2024-12-19,9693
00930,永豐ESG低碳高息,17,0,17,富邦-新營,2024-12-19,9693
2002,中鋼,16,0,16,富邦-新營,2024-12-19,9693
00720B,元大投資級公司債,15,0,15,富邦-新營,2024-12-19,9693
2834,臺企銀,15,0,15,富邦-新營,2024-12-19,9693
5880,合庫金,17,3,14,富邦-新營,2024-12-19,9693
4974,亞泰,30,17,13,富邦-新營,2024-12-19,9693
2633,台灣高鐵,12,0,12,富邦-新營,2024-12-19,9693
00881,國泰台灣5G+,11,0,11,富邦-新營,2024-12-19,9693
0056,元大高股息,22,12,10,富邦-新營,2024-12-19,9693
00948B,中信優息投資級債,10,0,10,富邦-新營,2024-12-19,9693
2881,富邦金,10,0,10,富邦-新營,2024-12-19,9693
00830,國泰費城半導體,12,2,10,富邦-新營,2024-12-19,9693
2382,廣達,10,0,10,富邦-新營,2024-12-19,9693
00713,元大台灣高息低波,10,0,10,富邦-新營,2024-12-19,9693
2353,宏��,11,1,10,富邦-新營,2024-12-19,9693
4938,和碩,10,0,10,富邦-新營,2024-12-19,9693
00891,中信關鍵半導體,10,0,10,富邦-新營,2024-12-19,9693
00650L,復華香港正2,10,0,10,富邦-新營,2024-12-19,9693
00943,兆豐電子高息等權,10,0,10,富邦-新營,2024-12-19,9693
00959B,大華投等美債15Y+,10,0,10,富邦-新營,2024-12-19,9693
1806,冠軍,10,0,10,富邦-新營,2024-12-19,9693
2241,艾姆勒,33,23,10,富邦-新營,2024-12-19,9693
2337,旺宏,10,0,10,富邦-新營,2024-12-19,9693
3322,建舜電,10,0,10,富邦-新營,2024-12-19,9693
5483,中美晶,10,0,10,富邦-新營,2024-12-19,9693
2431,聯昌,9,0,9,富邦-新營,2024-12-19,9693
2303,聯電,9,1,8,富邦-新營,2024-12-19,9693
00706L,期元大S＆P日圓正2,8,0,8,富邦-新營,2024-12-19,9693
2344,華邦電,14,6,8,富邦-新營,2024-12-19,9693
2618,長榮航,10,2,8,富邦-新營,2024-12-19,9693
3669,圓展,10,2,8,富邦-新營,2024-12-19,9693
4563,百德,8,0,8,富邦-新營,2024-12-19,9693
6248,沛波,8,0,8,富邦-新營,2024-12-19,9693
6770,力積電,16,8,8,富邦-新營,2024-12-19,9693
