Ticker,Name,buy,sell,diff,Branch,Date,Branch_Code
5009,榮剛,72,1,71,元大-土城學府,2023-01-03,9822
1718,中纖,50,0,50,元大-土城學府,2023-01-03,9822
3479,安勤,66,22,44,元大-土城學府,2023-01-03,9822
4171,瑞基,35,5,30,元大-土城學府,2023-01-03,9822
6180,橘子,24,2,22,元大-土城學府,2023-01-03,9822
8933,愛地雅,24,7,17,元大-土城學府,2023-01-03,9822
00878,國泰永續高股息,14,0,14,元大-土城學府,2023-01-03,9822
1810,和成,16,4,12,元大-土城學府,2023-01-03,9822
2892,第一金,11,0,11,元大-土城學府,2023-01-03,9822
00637L,元大滬深300正2,20,10,10,元大-土城學府,2023-01-03,9822
1605,華新,25,15,10,元大-土城學府,2023-01-03,9822
1708,東鹼,10,0,10,元大-土城學府,2023-01-03,9822
1909,榮成,11,1,10,元大-土城學府,2023-01-03,9822
2027,大成鋼,10,0,10,元大-土城學府,2023-01-03,9822
2399,映泰,41,31,10,元大-土城學府,2023-01-03,9822
2891,中信金,10,0,10,元大-土城學府,2023-01-03,9822
6770,力積電,10,0,10,元大-土城學府,2023-01-03,9822
2201,裕隆,27,17,10,元大-土城學府,2023-01-03,9822
3083,網龍,14,5,9,元大-土城學府,2023-01-03,9822
6150,撼訊,10,2,8,元大-土城學府,2023-01-03,9822
0056,元大高股息,7,0,7,元大-土城學府,2023-01-03,9822
1342,八貫,7,0,7,元大-土城學府,2023-01-03,9822
1732,毛寶,7,0,7,元大-土城學府,2023-01-03,9822
6244,茂迪,7,0,7,元大-土城學府,2023-01-03,9822
8171,天宇,12,5,7,元大-土城學府,2023-01-03,9822
1701,中化,7,1,6,元大-土城學府,2023-01-03,9822
3576,聯合再生,6,0,6,元大-土城學府,2023-01-03,9822
6257,矽格,6,0,6,元大-土城學府,2023-01-03,9822
6733,博晟生醫,6,0,6,元大-土城學府,2023-01-03,9822
8072,陞泰,6,0,6,元大-土城學府,2023-01-03,9822
2612,中航,5,0,5,元大-土城學府,2023-01-03,9822
9904,寶成,6,1,5,元大-土城學府,2023-01-03,9822
1319,東陽,6,1,5,元大-土城學府,2023-01-03,9822
00891,中信關鍵半導體,5,0,5,元大-土城學府,2023-01-03,9822
3293,鈊象,5,0,5,元大-土城學府,2023-01-03,9822
8076,伍豐,5,0,5,元大-土城學府,2023-01-03,9822
1101,台泥,5,0,5,元大-土城學府,2023-01-03,9822
1409,新纖,4,0,4,元大-土城學府,2023-01-03,9822
1522,堤維西,4,0,4,元大-土城學府,2023-01-03,9822
2382,廣達,4,0,4,元大-土城學府,2023-01-03,9822
2890,永豐金,4,0,4,元大-土城學府,2023-01-03,9822
00902,中信電池及儲能,4,0,4,元大-土城學府,2023-01-03,9822
0050,元大台灣50,5,2,3,元大-土城學府,2023-01-03,9822
00751B,元大AAA至A公司債,3,0,3,元大-土城學府,2023-01-03,9822
1734,杏輝,3,0,3,元大-土城學府,2023-01-03,9822
1760,寶齡富錦,10,7,3,元大-土城學府,2023-01-03,9822
2388,威盛,5,2,3,元大-土城學府,2023-01-03,9822
2603,長榮,22,19,3,元大-土城學府,2023-01-03,9822
2867,三商壽,3,0,3,元大-土城學府,2023-01-03,9822
2887,台新金,3,0,3,元大-土城學府,2023-01-03,9822
1218,泰山,103,0,103,元大-土城學府,2023-01-04,9822
1314,中石化,51,0,51,元大-土城學府,2023-01-04,9822
3252,海灣,95,52,43,元大-土城學府,2023-01-04,9822
0056,元大高股息,26,0,26,元大-土城學府,2023-01-04,9822
5009,榮剛,24,2,22,元大-土城學府,2023-01-04,9822
3027,盛達,40,21,19,元大-土城學府,2023-01-04,9822
2014,中鴻,17,0,17,元大-土城學府,2023-01-04,9822
2615,萬海,550,534,16,元大-土城學府,2023-01-04,9822
2363,矽統,16,0,16,元大-土城學府,2023-01-04,9822
2884,玉山金,16,0,16,元大-土城學府,2023-01-04,9822
5907,大洋-KY,16,1,15,元大-土城學府,2023-01-04,9822
1605,華新,72,58,14,元大-土城學府,2023-01-04,9822
6770,力積電,14,0,14,元大-土城學府,2023-01-04,9822
00878,國泰永續高股息,15,2,13,元大-土城學府,2023-01-04,9822
2609,陽明,15,2,13,元大-土城學府,2023-01-04,9822
3545,敦泰,17,4,13,元大-土城學府,2023-01-04,9822
00893,國泰智能電動車,12,0,12,元大-土城學府,2023-01-04,9822
4155,訊映,12,0,12,元大-土城學府,2023-01-04,9822
00891,中信關鍵半導體,10,0,10,元大-土城學府,2023-01-04,9822
2206,三陽工業,10,0,10,元大-土城學府,2023-01-04,9822
2886,兆豐金,10,0,10,元大-土城學府,2023-01-04,9822
3479,安勤,23,13,10,元大-土城學府,2023-01-04,9822
8933,愛地雅,10,0,10,元大-土城學府,2023-01-04,9822
00902,中信電池及儲能,10,0,10,元大-土城學府,2023-01-04,9822
2317,鴻海,12,3,9,元大-土城學府,2023-01-04,9822
00885,富邦越南,13,5,8,元大-土城學府,2023-01-04,9822
2610,華航,8,0,8,元大-土城學府,2023-01-04,9822
3062,建漢,8,0,8,元大-土城學府,2023-01-04,9822
6111,大宇資,12,4,8,元大-土城學府,2023-01-04,9822
1444,力麗,10,3,7,元大-土城學府,2023-01-04,9822
6153,嘉聯益,7,0,7,元大-土城學府,2023-01-04,9822
1760,寶齡富錦,9,3,6,元大-土城學府,2023-01-04,9822
1810,和成,8,2,6,元大-土城學府,2023-01-04,9822
2637,慧洋-KY,6,0,6,元大-土城學府,2023-01-04,9822
9802,鈺齊-KY,7,1,6,元大-土城學府,2023-01-04,9822
4904,遠傳,5,0,5,元大-土城學府,2023-01-04,9822
00642U,期元大S＆P石油,5,0,5,元大-土城學府,2023-01-04,9822
1720,生達,5,0,5,元大-土城學府,2023-01-04,9822
1906,寶隆,5,0,5,元大-土城學府,2023-01-04,9822
2329,華泰,5,0,5,元大-土城學府,2023-01-04,9822
2359,所羅門,5,0,5,元大-土城學府,2023-01-04,9822
2390,云辰,5,0,5,元大-土城學府,2023-01-04,9822
3346,麗清,6,1,5,元大-土城學府,2023-01-04,9822
3454,晶睿,11,6,5,元大-土城學府,2023-01-04,9822
3594,磐儀,5,0,5,元大-土城學府,2023-01-04,9822
6672,騰輝電子-KY,5,0,5,元大-土城學府,2023-01-04,9822
6679,鈺太,5,0,5,元大-土城學府,2023-01-04,9822
6235,華孚,12,7,5,元大-土城學府,2023-01-04,9822
1503,士電,4,0,4,元大-土城學府,2023-01-04,9822
1701,中化,9,5,4,元大-土城學府,2023-01-04,9822
3252,海灣,93,40,53,元大-土城學府,2023-01-05,9822
1447,力鵬,50,2,48,元大-土城學府,2023-01-05,9822
5014,建錩,50,2,48,元大-土城學府,2023-01-05,9822
4977,眾達-KY,40,4,36,元大-土城學府,2023-01-05,9822
8358,金居,41,8,33,元大-土城學府,2023-01-05,9822
2883,凱基金,30,0,30,元大-土城學府,2023-01-05,9822
4979,華星光,32,2,30,元大-土城學府,2023-01-05,9822
0056,元大高股息,30,2,28,元大-土城學府,2023-01-05,9822
2495,普安,24,0,24,元大-土城學府,2023-01-05,9822
00878,國泰永續高股息,27,6,21,元大-土城學府,2023-01-05,9822
3059,華晶科,20,0,20,元大-土城學府,2023-01-05,9822
3265,台星科,20,0,20,元大-土城學府,2023-01-05,9822
3027,盛達,27,10,17,元大-土城學府,2023-01-05,9822
1519,華城,32,16,16,元大-土城學府,2023-01-05,9822
2419,仲琦,18,2,16,元大-土城學府,2023-01-05,9822
5009,榮剛,18,2,16,元大-土城學府,2023-01-05,9822
00715L,期街口布蘭特正2,15,0,15,元大-土城學府,2023-01-05,9822
3455,由田,13,0,13,元大-土城學府,2023-01-05,9822
4114,健喬,21,8,13,元大-土城學府,2023-01-05,9822
2889,國票金,12,0,12,元大-土城學府,2023-01-05,9822
6589,台康生技,15,3,12,元大-土城學府,2023-01-05,9822
3548,兆利,11,0,11,元大-土城學府,2023-01-05,9822
2328,廣宇,10,0,10,元大-土城學府,2023-01-05,9822
2441,超豐,10,0,10,元大-土城學府,2023-01-05,9822
3545,敦泰,13,3,10,元大-土城學府,2023-01-05,9822
5351,鈺創,18,8,10,元大-土城學府,2023-01-05,9822
5907,大洋-KY,11,1,10,元大-土城學府,2023-01-05,9822
6104,創惟,12,2,10,元大-土城學府,2023-01-05,9822
6202,盛群,10,0,10,元大-土城學府,2023-01-05,9822
9945,潤泰新,10,0,10,元大-土城學府,2023-01-05,9822
2317,鴻海,10,1,9,元大-土城學府,2023-01-05,9822
1513,中興電,32,23,9,元大-土城學府,2023-01-05,9822
3617,碩天,9,0,9,元大-土城學府,2023-01-05,9822
4904,遠傳,9,0,9,元大-土城學府,2023-01-05,9822
8044,網家,10,1,9,元大-土城學府,2023-01-05,9822
1504,東元,9,1,8,元大-土城學府,2023-01-05,9822
1529,樂事綠能,15,7,8,元大-土城學府,2023-01-05,9822
8072,陞泰,8,0,8,元大-土城學府,2023-01-05,9822
2642,宅配通,12,5,7,元大-土城學府,2023-01-05,9822
6443,元晶,9,2,7,元大-土城學府,2023-01-05,9822
2368,金像電,6,0,6,元大-土城學府,2023-01-05,9822
4129,聯合,6,0,6,元大-土城學府,2023-01-05,9822
5272,笙科,6,0,6,元大-土城學府,2023-01-05,9822
6806,森崴能源,48,42,6,元大-土城學府,2023-01-05,9822
8069,元太,8,3,5,元大-土城學府,2023-01-05,9822
2636,台驊控股,5,0,5,元大-土城學府,2023-01-05,9822
1609,大亞,6,1,5,元大-土城學府,2023-01-05,9822
2029,盛餘,11,6,5,元大-土城學府,2023-01-05,9822
3592,瑞鼎,5,0,5,元大-土城學府,2023-01-05,9822
9904,寶成,5,0,5,元大-土城學府,2023-01-05,9822
00720B,元大投資級公司債,130,0,130,元大-土城學府,2023-01-06,9822
8171,天宇,93,3,90,元大-土城學府,2023-01-06,9822
3363,上詮,65,0,65,元大-土城學府,2023-01-06,9822
3265,台星科,44,0,44,元大-土城學府,2023-01-06,9822
3252,海灣,34,1,33,元大-土城學府,2023-01-06,9822
1584,精剛,30,2,28,元大-土城學府,2023-01-06,9822
2642,宅配通,41,15,26,元大-土城學府,2023-01-06,9822
00664R,國泰臺灣加權反1,24,5,19,元大-土城學府,2023-01-06,9822
00632R,元大台灣50反1,32,15,17,元大-土城學府,2023-01-06,9822
1467,南緯,13,0,13,元大-土城學府,2023-01-06,9822
1519,華城,19,7,12,元大-土城學府,2023-01-06,9822
2495,普安,12,0,12,元大-土城學府,2023-01-06,9822
00753L,中信中國50正2,11,0,11,元大-土城學府,2023-01-06,9822
6589,台康生技,14,3,11,元大-土城學府,2023-01-06,9822
00669R,國泰美國道瓊反1,10,0,10,元大-土城學府,2023-01-06,9822
1810,和成,10,0,10,元大-土城學府,2023-01-06,9822
5222,全訊,10,0,10,元大-土城學府,2023-01-06,9822
6741,91APP*-KY,10,0,10,元大-土城學府,2023-01-06,9822
2206,三陽工業,10,0,10,元大-土城學府,2023-01-06,9822
3293,鈊象,10,1,9,元大-土城學府,2023-01-06,9822
4943,康控-KY,9,0,9,元大-土城學府,2023-01-06,9822
00772B,中信高評級公司債,8,0,8,元大-土城學府,2023-01-06,9822
3022,威強電,8,0,8,元大-土城學府,2023-01-06,9822
2317,鴻海,7,0,7,元大-土城學府,2023-01-06,9822
2929,淘帝-KY,10,3,7,元大-土城學府,2023-01-06,9822
4129,聯合,14,7,7,元大-土城學府,2023-01-06,9822
5284,jpp-KY,7,0,7,元大-土城學府,2023-01-06,9822
6176,瑞儀,8,1,7,元大-土城學府,2023-01-06,9822
6279,胡連,8,1,7,元大-土城學府,2023-01-06,9822
00770,國泰北美科技,6,0,6,元大-土城學府,2023-01-06,9822
2867,三商壽,6,0,6,元大-土城學府,2023-01-06,9822
3443,創意,7,2,5,元大-土城學府,2023-01-06,9822
1513,中興電,24,19,5,元大-土城學府,2023-01-06,9822
2033,佳大,5,0,5,元大-土城學府,2023-01-06,9822
2371,大同,5,0,5,元大-土城學府,2023-01-06,9822
2390,云辰,5,0,5,元大-土城學府,2023-01-06,9822
2884,玉山金,8,3,5,元大-土城學府,2023-01-06,9822
3027,盛達,7,2,5,元大-土城學府,2023-01-06,9822
6547,高端疫苗,5,0,5,元大-土城學府,2023-01-06,9822
1609,大亞,4,0,4,元大-土城學府,2023-01-06,9822
2349,錸德,4,0,4,元大-土城學府,2023-01-06,9822
3162,精確,4,0,4,元大-土城學府,2023-01-06,9822
3536,誠創,4,0,4,元大-土城學府,2023-01-06,9822
3594,磐儀,4,0,4,元大-土城學府,2023-01-06,9822
5258,虹堡,4,0,4,元大-土城學府,2023-01-06,9822
6770,力積電,13,9,4,元大-土城學府,2023-01-06,9822
9938,百和,4,0,4,元大-土城學府,2023-01-06,9822
1308,亞聚,3,0,3,元大-土城學府,2023-01-06,9822
1795,美時,6,3,3,元大-土城學府,2023-01-06,9822
2419,仲琦,3,0,3,元大-土城學府,2023-01-06,9822
00632R,元大台灣50反1,344,236,108,元大-土城學府,2023-01-09,9822
1514,亞力,90,1,89,元大-土城學府,2023-01-09,9822
6670,復盛應用,34,0,34,元大-土城學府,2023-01-09,9822
2328,廣宇,31,0,31,元大-土城學府,2023-01-09,9822
1513,中興電,56,31,25,元大-土城學府,2023-01-09,9822
2603,長榮,30,5,25,元大-土城學府,2023-01-09,9822
4961,天鈺,30,5,25,元大-土城學府,2023-01-09,9822
4931,新盛力,25,1,24,元大-土城學府,2023-01-09,9822
8171,天宇,26,3,23,元大-土城學府,2023-01-09,9822
6589,台康生技,20,1,19,元大-土城學府,2023-01-09,9822
3022,威強電,18,0,18,元大-土城學府,2023-01-09,9822
3037,欣興,21,7,14,元大-土城學府,2023-01-09,9822
2337,旺宏,14,1,13,元大-土城學府,2023-01-09,9822
3479,安勤,189,176,13,元大-土城學府,2023-01-09,9822
6133,金橋,25,13,12,元大-土城學府,2023-01-09,9822
3703,欣陸,11,0,11,元大-土城學府,2023-01-09,9822
2355,敬鵬,10,0,10,元大-土城學府,2023-01-09,9822
2465,麗臺,10,0,10,元大-土城學府,2023-01-09,9822
3494,誠研,10,0,10,元大-土城學府,2023-01-09,9822
3689,湧德,10,0,10,元大-土城學府,2023-01-09,9822
00671R,富邦NASDAQ反1,7,0,7,元大-土城學府,2023-01-09,9822
00679B,元大美債20年,7,0,7,元大-土城學府,2023-01-09,9822
00882,中信中國高股息,8,1,7,元大-土城學府,2023-01-09,9822
3624,光頡,8,1,7,元大-土城學府,2023-01-09,9822
00885,富邦越南,8,2,6,元大-土城學府,2023-01-09,9822
2354,鴻準,6,1,5,元大-土城學府,2023-01-09,9822
2605,新興,5,0,5,元大-土城學府,2023-01-09,9822
2809,京城銀,5,0,5,元大-土城學府,2023-01-09,9822
3094,聯傑,5,0,5,元大-土城學府,2023-01-09,9822
3481,群創,5,0,5,元大-土城學府,2023-01-09,9822
5410,國眾,5,0,5,元大-土城學府,2023-01-09,9822
6139,亞翔,5,0,5,元大-土城學府,2023-01-09,9822
6244,茂迪,5,0,5,元大-土城學府,2023-01-09,9822
8440,綠電,5,0,5,元大-土城學府,2023-01-09,9822
1314,中石化,4,0,4,元大-土城學府,2023-01-09,9822
00637L,元大滬深300正2,5,1,4,元大-土城學府,2023-01-09,9822
3536,誠創,4,0,4,元大-土城學府,2023-01-09,9822
4934,太極,4,0,4,元大-土城學府,2023-01-09,9822
6414,樺漢,4,0,4,元大-土城學府,2023-01-09,9822
8121,越峰,4,0,4,元大-土城學府,2023-01-09,9822
00673R,期元大S＆P原油反1,3,0,3,元大-土城學府,2023-01-09,9822
1519,華城,4,1,3,元大-土城學府,2023-01-09,9822
1536,和大,4,1,3,元大-土城學府,2023-01-09,9822
1734,杏輝,3,0,3,元大-土城學府,2023-01-09,9822
2412,中華電,3,0,3,元大-土城學府,2023-01-09,9822
3017,奇鋐,3,0,3,元大-土城學府,2023-01-09,9822
3444,利機,3,0,3,元大-土城學府,2023-01-09,9822
3552,同致,3,0,3,元大-土城學府,2023-01-09,9822
4763,材料-KY,10,7,3,元大-土城學府,2023-01-09,9822
5225,東科-KY,3,0,3,元大-土城學府,2023-01-09,9822
00632R,元大台灣50反1,139,0,139,元大-土城學府,2023-01-10,9822
1513,中興電,63,9,54,元大-土城學府,2023-01-10,9822
2883,凱基金,50,0,50,元大-土城學府,2023-01-10,9822
00753L,中信中國50正2,41,0,41,元大-土城學府,2023-01-10,9822
2610,華航,42,5,37,元大-土城學府,2023-01-10,9822
1514,亞力,41,9,32,元大-土城學府,2023-01-10,9822
1210,大成,30,0,30,元大-土城學府,2023-01-10,9822
1708,東鹼,26,0,26,元大-土城學府,2023-01-10,9822
3022,威強電,26,0,26,元大-土城學府,2023-01-10,9822
2614,東森,25,0,25,元大-土城學府,2023-01-10,9822
2834,臺企銀,24,3,21,元大-土城學府,2023-01-10,9822
1605,華新,46,27,19,元大-土城學府,2023-01-10,9822
2929,淘帝-KY,15,2,13,元大-土城學府,2023-01-10,9822
8171,天宇,12,0,12,元大-土城學府,2023-01-10,9822
00878,國泰永續高股息,14,2,12,元大-土城學府,2023-01-10,9822
6443,元晶,23,12,11,元大-土城學府,2023-01-10,9822
2851,中再保,10,0,10,元大-土城學府,2023-01-10,9822
2889,國票金,10,0,10,元大-土城學府,2023-01-10,9822
2615,萬海,401,392,9,元大-土城學府,2023-01-10,9822
3322,建舜電,9,0,9,元大-土城學府,2023-01-10,9822
8105,凌巨,12,3,9,元大-土城學府,2023-01-10,9822
2353,宏��,10,2,8,元大-土城學府,2023-01-10,9822
3317,尼克森,8,0,8,元大-土城學府,2023-01-10,9822
4114,健喬,13,5,8,元大-土城學府,2023-01-10,9822
6122,擎邦,12,4,8,元大-土城學府,2023-01-10,9822
8043,蜜望實,7,0,7,元大-土城學府,2023-01-10,9822
1612,宏泰,7,1,6,元大-土城學府,2023-01-10,9822
1701,中化,21,15,6,元大-土城學府,2023-01-10,9822
1802,台玻,6,0,6,元大-土城學府,2023-01-10,9822
2812,台中銀,8,2,6,元大-土城學府,2023-01-10,9822
3454,晶睿,16,10,6,元大-土城學府,2023-01-10,9822
6547,高端疫苗,6,0,6,元大-土城學府,2023-01-10,9822
6143,振曜,6,0,6,元大-土城學府,2023-01-10,9822
00891,中信關鍵半導體,6,1,5,元大-土城學府,2023-01-10,9822
00669R,國泰美國道瓊反1,5,0,5,元大-土城學府,2023-01-10,9822
00664R,國泰臺灣加權反1,5,0,5,元大-土城學府,2023-01-10,9822
1524,耿鼎,10,5,5,元大-土城學府,2023-01-10,9822
2312,金寶,5,0,5,元大-土城學府,2023-01-10,9822
2328,廣宇,5,0,5,元大-土城學府,2023-01-10,9822
2468,華經,5,0,5,元大-土城學府,2023-01-10,9822
2608,嘉里大榮,5,0,5,元大-土城學府,2023-01-10,9822
3265,台星科,12,7,5,元大-土城學府,2023-01-10,9822
5410,國眾,5,0,5,元大-土城學府,2023-01-10,9822
5608,四維航,5,0,5,元大-土城學府,2023-01-10,9822
2884,玉山金,5,0,5,元大-土城學府,2023-01-10,9822
2609,陽明,9,5,4,元大-土城學府,2023-01-10,9822
2317,鴻海,6,2,4,元大-土城學府,2023-01-10,9822
1443,立益物流,7,3,4,元大-土城學府,2023-01-10,9822
2351,順德,6,2,4,元大-土城學府,2023-01-10,9822
2613,中櫃,4,0,4,元大-土城學府,2023-01-10,9822
2610,華航,107,16,91,元大-土城學府,2023-01-11,9822
6485,點序,66,0,66,元大-土城學府,2023-01-11,9822
2390,云辰,33,1,32,元大-土城學府,2023-01-11,9822
00669R,國泰美國道瓊反1,30,0,30,元大-土城學府,2023-01-11,9822
1612,宏泰,20,0,20,元大-土城學府,2023-01-11,9822
0056,元大高股息,24,5,19,元大-土城學府,2023-01-11,9822
3346,麗清,20,1,19,元大-土城學府,2023-01-11,9822
00664R,國泰臺灣加權反1,16,0,16,元大-土城學府,2023-01-11,9822
6533,晶心科,15,0,15,元大-土城學府,2023-01-11,9822
00632R,元大台灣50反1,14,0,14,元大-土城學府,2023-01-11,9822
8171,天宇,17,3,14,元大-土城學府,2023-01-11,9822
2495,普安,12,0,12,元大-土城學府,2023-01-11,9822
2884,玉山金,12,0,12,元大-土城學府,2023-01-11,9822
4961,天鈺,17,5,12,元大-土城學府,2023-01-11,9822
6443,元晶,13,2,11,元大-土城學府,2023-01-11,9822
1447,力鵬,10,0,10,元大-土城學府,2023-01-11,9822
1465,偉全,10,0,10,元大-土城學府,2023-01-11,9822
3536,誠創,10,0,10,元大-土城學府,2023-01-11,9822
1258,其祥-KY,9,0,9,元大-土城學府,2023-01-11,9822
2603,長榮,13,4,9,元大-土城學府,2023-01-11,9822
2634,漢翔,8,0,8,元大-土城學府,2023-01-11,9822
3035,智原,14,6,8,元大-土城學府,2023-01-11,9822
2609,陽明,11,4,7,元大-土城學府,2023-01-11,9822
3027,盛達,10,3,7,元大-土城學府,2023-01-11,9822
5321,美而快,9,2,7,元大-土城學府,2023-01-11,9822
2615,萬海,708,702,6,元大-土城學府,2023-01-11,9822
00905,FT臺灣Smart,6,0,6,元大-土城學府,2023-01-11,9822
00715L,期街口布蘭特正2,11,5,6,元大-土城學府,2023-01-11,9822
2360,致茂,7,1,6,元大-土城學府,2023-01-11,9822
1785,光洋科,5,0,5,元大-土城學府,2023-01-11,9822
2371,大同,5,0,5,元大-土城學府,2023-01-11,9822
3022,威強電,5,0,5,元大-土城學府,2023-01-11,9822
3163,波若威,6,1,5,元大-土城學府,2023-01-11,9822
3704,合勤控,7,2,5,元大-土城學府,2023-01-11,9822
2324,仁寶,4,0,4,元大-土城學府,2023-01-11,9822
1442,名軒,5,1,4,元大-土城學府,2023-01-11,9822
2201,裕隆,5,1,4,元大-土城學府,2023-01-11,9822
2313,華通,4,0,4,元大-土城學府,2023-01-11,9822
2401,凌陽,5,1,4,元大-土城學府,2023-01-11,9822
2736,富野,4,0,4,元大-土城學府,2023-01-11,9822
2883,凱基金,4,0,4,元大-土城學府,2023-01-11,9822
5388,中磊,4,0,4,元大-土城學府,2023-01-11,9822
4904,遠傳,3,0,3,元大-土城學府,2023-01-11,9822
2357,華碩,3,0,3,元大-土城學府,2023-01-11,9822
00683L,期元大美元指正2,3,0,3,元大-土城學府,2023-01-11,9822
1605,華新,7,4,3,元大-土城學府,2023-01-11,9822
2388,威盛,4,1,3,元大-土城學府,2023-01-11,9822
2471,資通,8,5,3,元大-土城學府,2023-01-11,9822
2867,三商壽,3,0,3,元大-土城學府,2023-01-11,9822
2929,淘帝-KY,8,5,3,元大-土城學府,2023-01-11,9822
2390,云辰,163,0,163,元大-土城學府,2023-01-12,9822
2023,燁輝,105,2,103,元大-土城學府,2023-01-12,9822
5258,虹堡,135,43,92,元大-土城學府,2023-01-12,9822
2014,中鴻,57,12,45,元大-土城學府,2023-01-12,9822
6548,長科*,28,0,28,元大-土城學府,2023-01-12,9822
1442,名軒,25,0,25,元大-土城學府,2023-01-12,9822
6770,力積電,24,0,24,元大-土城學府,2023-01-12,9822
00753L,中信中國50正2,30,9,21,元大-土城學府,2023-01-12,9822
3706,神達,20,0,20,元大-土城學府,2023-01-12,9822
6531,愛普*,15,0,15,元大-土城學府,2023-01-12,9822
9945,潤泰新,14,0,14,元大-土城學府,2023-01-12,9822
6609,瀧澤科,18,5,13,元大-土城學府,2023-01-12,9822
00664R,國泰臺灣加權反1,10,0,10,元大-土城學府,2023-01-12,9822
2328,廣宇,11,1,10,元大-土城學府,2023-01-12,9822
6024,群益期,10,0,10,元大-土城學府,2023-01-12,9822
6148,驊宏資,11,1,10,元大-土城學府,2023-01-12,9822
6244,茂迪,13,3,10,元大-土城學府,2023-01-12,9822
911868,同方友友-DR,10,0,10,元大-土城學府,2023-01-12,9822
8050,廣積,11,2,9,元大-土城學府,2023-01-12,9822
2009,第一銅,11,2,9,元大-土城學府,2023-01-12,9822
2206,三陽工業,9,0,9,元大-土城學府,2023-01-12,9822
6547,高端疫苗,9,0,9,元大-土城學府,2023-01-12,9822
00905,FT臺灣Smart,8,0,8,元大-土城學府,2023-01-12,9822
00632R,元大台灣50反1,8,0,8,元大-土城學府,2023-01-12,9822
2388,威盛,7,0,7,元大-土城學府,2023-01-12,9822
00673R,期元大S＆P原油反1,6,0,6,元大-土城學府,2023-01-12,9822
00671R,富邦NASDAQ反1,6,0,6,元大-土城學府,2023-01-12,9822
2884,玉山金,6,0,6,元大-土城學府,2023-01-12,9822
3022,威強電,6,0,6,元大-土城學府,2023-01-12,9822
3479,安勤,6,0,6,元大-土城學府,2023-01-12,9822
3624,光頡,8,2,6,元大-土城學府,2023-01-12,9822
4747,強生,9,3,6,元大-土城學府,2023-01-12,9822
1444,力麗,7,2,5,元大-土城學府,2023-01-12,9822
1802,台玻,10,5,5,元大-土城學府,2023-01-12,9822
2312,金寶,5,0,5,元大-土城學府,2023-01-12,9822
2468,華經,10,5,5,元大-土城學府,2023-01-12,9822
2542,興富發,5,0,5,元大-土城學府,2023-01-12,9822
3594,磐儀,8,3,5,元大-土城學府,2023-01-12,9822
5475,德宏,5,0,5,元大-土城學府,2023-01-12,9822
2038,海光,4,0,4,元大-土城學府,2023-01-12,9822
2610,華航,5,1,4,元大-土城學府,2023-01-12,9822
3035,智原,5,1,4,元大-土城學府,2023-01-12,9822
4167,松瑞藥,4,0,4,元大-土城學府,2023-01-12,9822
2317,鴻海,6,2,4,元大-土城學府,2023-01-12,9822
2603,長榮,4,1,3,元大-土城學府,2023-01-12,9822
00907,永豐優息存股,3,0,3,元大-土城學府,2023-01-12,9822
2413,環科,3,0,3,元大-土城學府,2023-01-12,9822
2485,兆赫,3,0,3,元大-土城學府,2023-01-12,9822
3026,禾伸堂,3,0,3,元大-土城學府,2023-01-12,9822
6113,亞矽,3,0,3,元大-土城學府,2023-01-12,9822
00632R,元大台灣50反1,404,43,361,元大-土城學府,2023-01-13,9822
3005,神基,52,0,52,元大-土城學府,2023-01-13,9822
2371,大同,25,2,23,元大-土城學府,2023-01-13,9822
6770,力積電,46,26,20,元大-土城學府,2023-01-13,9822
00673R,期元大S＆P原油反1,16,0,16,元大-土城學府,2023-01-13,9822
1584,精剛,26,13,13,元大-土城學府,2023-01-13,9822
6443,元晶,14,1,13,元大-土城學府,2023-01-13,9822
1612,宏泰,12,0,12,元大-土城學府,2023-01-13,9822
00671R,富邦NASDAQ反1,10,0,10,元大-土城學府,2023-01-13,9822
00679B,元大美債20年,10,0,10,元大-土城學府,2023-01-13,9822
1443,立益物流,10,0,10,元大-土城學府,2023-01-13,9822
1447,力鵬,10,0,10,元大-土城學府,2023-01-13,9822
1609,大亞,11,1,10,元大-土城學府,2023-01-13,9822
2482,連宇,10,0,10,元大-土城學府,2023-01-13,9822
3689,湧德,10,0,10,元大-土城學府,2023-01-13,9822
00753L,中信中國50正2,9,0,9,元大-土城學府,2023-01-13,9822
00664R,國泰臺灣加權反1,8,0,8,元大-土城學府,2023-01-13,9822
00882,中信中國高股息,10,3,7,元大-土城學府,2023-01-13,9822
1605,華新,13,6,7,元大-土城學府,2023-01-13,9822
1218,泰山,6,0,6,元大-土城學府,2023-01-13,9822
00772B,中信高評級公司債,6,0,6,元大-土城學府,2023-01-13,9822
4167,松瑞藥,6,0,6,元大-土城學府,2023-01-13,9822
6165,浪凡,6,0,6,元大-土城學府,2023-01-13,9822
6285,啟��,7,1,6,元大-土城學府,2023-01-13,9822
6679,鈺太,6,0,6,元大-土城學府,2023-01-13,9822
1795,美時,6,1,5,元大-土城學府,2023-01-13,9822
2880,華南金,5,0,5,元大-土城學府,2023-01-13,9822
8358,金居,8,3,5,元大-土城學府,2023-01-13,9822
8050,廣積,13,8,5,元大-土城學府,2023-01-13,9822
2027,大成鋼,5,1,4,元大-土城學府,2023-01-13,9822
2313,華通,9,5,4,元大-土城學府,2023-01-13,9822
3264,欣銓,4,0,4,元大-土城學府,2023-01-13,9822
8261,富鼎,4,0,4,元大-土城學府,2023-01-13,9822
2465,麗臺,11,8,3,元大-土城學府,2023-01-13,9822
2498,宏達電,12,9,3,元大-土城學府,2023-01-13,9822
2609,陽明,7,4,3,元大-土城學府,2023-01-13,9822
6188,廣明,4,1,3,元大-土城學府,2023-01-13,9822
0056,元大高股息,8,5,3,元大-土城學府,2023-01-13,9822
2889,國票金,3,0,3,元大-土城學府,2023-01-13,9822
3272,東碩,3,0,3,元大-土城學府,2023-01-13,9822
3419,譁裕,3,0,3,元大-土城學府,2023-01-13,9822
3455,由田,3,0,3,元大-土城學府,2023-01-13,9822
5258,虹堡,3,0,3,元大-土城學府,2023-01-13,9822
6104,創惟,6,3,3,元大-土城學府,2023-01-13,9822
6133,金橋,6,3,3,元大-土城學府,2023-01-13,9822
6143,振曜,3,0,3,元大-土城學府,2023-01-13,9822
8121,越峰,3,0,3,元大-土城學府,2023-01-13,9822
9945,潤泰新,3,0,3,元大-土城學府,2023-01-13,9822
3443,創意,6,4,2,元大-土城學府,2023-01-13,9822
1313,聯成,2,0,2,元大-土城學府,2023-01-13,9822
2884,玉山金,1005,10,995,元大-土城學府,2023-01-16,9822
1101,台泥,107,3,104,元大-土城學府,2023-01-16,9822
3005,神基,73,0,73,元大-土城學府,2023-01-16,9822
6024,群益期,31,0,31,元大-土城學府,2023-01-16,9822
00673R,期元大S＆P原油反1,30,0,30,元大-土城學府,2023-01-16,9822
3706,神達,30,0,30,元大-土城學府,2023-01-16,9822
2618,長榮航,30,5,25,元大-土城學府,2023-01-16,9822
2495,普安,18,1,17,元大-土城學府,2023-01-16,9822
00753L,中信中國50正2,16,0,16,元大-土城學府,2023-01-16,9822
3264,欣銓,15,0,15,元大-土城學府,2023-01-16,9822
00773B,中信優先金融債,13,0,13,元大-土城學府,2023-01-16,9822
00772B,中信高評級公司債,13,0,13,元大-土城學府,2023-01-16,9822
6770,力積電,14,1,13,元大-土城學府,2023-01-16,9822
9939,宏全,13,0,13,元大-土城學府,2023-01-16,9822
2609,陽明,15,4,11,元大-土城學府,2023-01-16,9822
3163,波若威,11,0,11,元大-土城學府,2023-01-16,9822
2317,鴻海,19,8,11,元大-土城學府,2023-01-16,9822
00632R,元大台灣50反1,40,30,10,元大-土城學府,2023-01-16,9822
1447,力鵬,10,0,10,元大-土城學府,2023-01-16,9822
2014,中鴻,18,8,10,元大-土城學府,2023-01-16,9822
2485,兆赫,10,1,9,元大-土城學府,2023-01-16,9822
2610,華航,12,4,8,元大-土城學府,2023-01-16,9822
5521,工信,8,0,8,元大-土城學府,2023-01-16,9822
8121,越峰,8,0,8,元大-土城學府,2023-01-16,9822
2498,宏達電,8,1,7,元大-土城學府,2023-01-16,9822
2303,聯電,12,6,6,元大-土城學府,2023-01-16,9822
2388,威盛,7,1,6,元大-土城學府,2023-01-16,9822
6609,瀧澤科,7,1,6,元大-土城學府,2023-01-16,9822
1217,愛之味,5,0,5,元大-土城學府,2023-01-16,9822
00669R,國泰美國道瓊反1,5,0,5,元大-土城學府,2023-01-16,9822
00641R,富邦日本反1,5,0,5,元大-土城學府,2023-01-16,9822
1584,精剛,5,0,5,元大-土城學府,2023-01-16,9822
2006,東和鋼鐵,5,0,5,元大-土城學府,2023-01-16,9822
2371,大同,5,0,5,元大-土城學府,2023-01-16,9822
4804,大略-KY,5,0,5,元大-土城學府,2023-01-16,9822
6015,宏遠證,5,0,5,元大-土城學府,2023-01-16,9822
8277,商丞,5,0,5,元大-土城學府,2023-01-16,9822
2883,凱基金,4,0,4,元大-土城學府,2023-01-16,9822
00638R,元大滬深300反1,4,0,4,元大-土城學府,2023-01-16,9822
1701,中化,4,0,4,元大-土城學府,2023-01-16,9822
2023,燁輝,6,2,4,元大-土城學府,2023-01-16,9822
2444,兆勁,4,0,4,元大-土城學府,2023-01-16,9822
4102,永日,4,0,4,元大-土城學府,2023-01-16,9822
2327,國巨,4,0,4,元大-土城學府,2023-01-16,9822
00738U,期元大道瓊白銀,3,0,3,元大-土城學府,2023-01-16,9822
1707,葡萄王,4,1,3,元大-土城學府,2023-01-16,9822
2009,第一銅,8,5,3,元大-土城學府,2023-01-16,9822
2332,友訊,3,0,3,元大-土城學府,2023-01-16,9822
3611,鼎翰,3,0,3,元大-土城學府,2023-01-16,9822
5452,佶優,3,0,3,元大-土城學府,2023-01-16,9822
00770,國泰北美科技,50,0,50,元大-土城學府,2023-01-17,9822
5014,建錩,50,0,50,元大-土城學府,2023-01-17,9822
00772B,中信高評級公司債,36,0,36,元大-土城學府,2023-01-17,9822
00773B,中信優先金融債,26,0,26,元大-土城學府,2023-01-17,9822
8110,華東,20,0,20,元大-土城學府,2023-01-17,9822
00882,中信中國高股息,19,0,19,元大-土城學府,2023-01-17,9822
00632R,元大台灣50反1,35,20,15,元大-土城學府,2023-01-17,9822
2358,廷鑫,15,0,15,元大-土城學府,2023-01-17,9822
2390,云辰,15,0,15,元大-土城學府,2023-01-17,9822
1514,亞力,16,2,14,元大-土城學府,2023-01-17,9822
3013,晟銘電,14,1,13,元大-土城學府,2023-01-17,9822
3324,雙鴻,12,0,12,元大-土城學府,2023-01-17,9822
2884,玉山金,10,0,10,元大-土城學府,2023-01-17,9822
1342,八貫,12,2,10,元大-土城學府,2023-01-17,9822
1904,正隆,10,0,10,元大-土城學府,2023-01-17,9822
2498,宏達電,15,5,10,元大-土城學府,2023-01-17,9822
5521,工信,10,0,10,元大-土城學府,2023-01-17,9822
1513,中興電,25,16,9,元大-土城學府,2023-01-17,9822
2614,東森,8,0,8,元大-土城學府,2023-01-17,9822
2317,鴻海,12,4,8,元大-土城學府,2023-01-17,9822
00902,中信電池及儲能,6,0,6,元大-土城學府,2023-01-17,9822
5258,虹堡,15,9,6,元大-土城學府,2023-01-17,9822
6770,力積電,13,7,6,元大-土城學府,2023-01-17,9822
00701,國泰股利精選30,5,0,5,元大-土城學府,2023-01-17,9822
1442,名軒,5,0,5,元大-土城學府,2023-01-17,9822
1464,得力,5,0,5,元大-土城學府,2023-01-17,9822
2034,允強,5,0,5,元大-土城學府,2023-01-17,9822
2359,所羅門,5,0,5,元大-土城學府,2023-01-17,9822
2889,國票金,5,0,5,元大-土城學府,2023-01-17,9822
1303,南亞,5,1,4,元大-土城學府,2023-01-17,9822
00637L,元大滬深300正2,6,2,4,元大-土城學府,2023-01-17,9822
00713,元大台灣高息低波,4,0,4,元大-土城學府,2023-01-17,9822
2399,映泰,4,0,4,元大-土城學府,2023-01-17,9822
2880,華南金,4,0,4,元大-土城學府,2023-01-17,9822
3454,晶睿,9,5,4,元大-土城學府,2023-01-17,9822
6005,群益證,4,0,4,元大-土城學府,2023-01-17,9822
6531,愛普*,4,0,4,元大-土城學府,2023-01-17,9822
6589,台康生技,4,0,4,元大-土城學府,2023-01-17,9822
2615,萬海,300,297,3,元大-土城學府,2023-01-17,9822
3481,群創,3,0,3,元大-土城學府,2023-01-17,9822
6177,達麗,3,0,3,元大-土城學府,2023-01-17,9822
00683L,期元大美元指正2,3,0,3,元大-土城學府,2023-01-17,9822
00655L,國泰中國A50正2,3,0,3,元大-土城學府,2023-01-17,9822
00646,元大S＆P500,3,0,3,元大-土城學府,2023-01-17,9822
00641R,富邦日本反1,3,0,3,元大-土城學府,2023-01-17,9822
3693,營邦,8,5,3,元大-土城學府,2023-01-17,9822
8933,愛地雅,4,1,3,元大-土城學府,2023-01-17,9822
3293,鈊象,10,8,2,元大-土城學府,2023-01-17,9822
1752,南光,6,4,2,元大-土城學府,2023-01-17,9822
3037,欣興,5,3,2,元大-土城學府,2023-01-17,9822
00632R,元大台灣50反1,491,34,457,元大-土城學府,2023-01-30,9822
2344,華邦電,100,8,92,元大-土城學府,2023-01-30,9822
2317,鴻海,82,1,81,元大-土城學府,2023-01-30,9822
5521,工信,60,0,60,元大-土城學府,2023-01-30,9822
8050,廣積,48,0,48,元大-土城學府,2023-01-30,9822
2891,中信金,33,0,33,元大-土城學府,2023-01-30,9822
2006,東和鋼鐵,30,0,30,元大-土城學府,2023-01-30,9822
8081,致新,30,0,30,元大-土城學府,2023-01-30,9822
2845,遠東銀,26,1,25,元大-土城學府,2023-01-30,9822
8358,金居,43,18,25,元大-土城學府,2023-01-30,9822
8163,達方,20,0,20,元大-土城學府,2023-01-30,9822
00893,國泰智能電動車,36,22,14,元大-土城學府,2023-01-30,9822
6182,合晶,14,0,14,元大-土城學府,2023-01-30,9822
6122,擎邦,12,0,12,元大-土城學府,2023-01-30,9822
3653,健策,11,0,11,元大-土城學府,2023-01-30,9822
3035,智原,15,5,10,元大-土城學府,2023-01-30,9822
3312,弘憶股,10,0,10,元大-土城學府,2023-01-30,9822
5321,美而快,12,2,10,元大-土城學府,2023-01-30,9822
5483,中美晶,10,0,10,元大-土城學府,2023-01-30,9822
8110,華東,10,0,10,元大-土城學府,2023-01-30,9822
9105,泰金寶-DR,10,0,10,元大-土城學府,2023-01-30,9822
9945,潤泰新,9,0,9,元大-土城學府,2023-01-30,9822
3673,TPK-KY,9,0,9,元大-土城學府,2023-01-30,9822
00882,中信中國高股息,11,2,9,元大-土城學府,2023-01-30,9822
2324,仁寶,8,0,8,元大-土城學府,2023-01-30,9822
8069,元太,12,5,7,元大-土城學府,2023-01-30,9822
2465,麗臺,13,6,7,元大-土城學府,2023-01-30,9822
2328,廣宇,6,0,6,元大-土城學府,2023-01-30,9822
00676R,富邦臺灣加權反1,5,0,5,元大-土城學府,2023-01-30,9822
00671R,富邦NASDAQ反1,5,0,5,元大-土城學府,2023-01-30,9822
1416,廣豐,5,0,5,元大-土城學府,2023-01-30,9822
9103,美德醫療-DR,4,0,4,元大-土城學府,2023-01-30,9822
1236,宏亞,4,0,4,元大-土城學府,2023-01-30,9822
4175,杏一,5,1,4,元大-土城學府,2023-01-30,9822
6177,達麗,4,0,4,元大-土城學府,2023-01-30,9822
00905,FT臺灣Smart,3,0,3,元大-土城學府,2023-01-30,9822
00648R,元大S＆P500反1,3,0,3,元大-土城學府,2023-01-30,9822
00642U,期元大S＆P石油,3,0,3,元大-土城學府,2023-01-30,9822
1305,華夏,4,1,3,元大-土城學府,2023-01-30,9822
1529,樂事綠能,10,7,3,元大-土城學府,2023-01-30,9822
1701,中化,4,1,3,元大-土城學府,2023-01-30,9822
2204,中華,5,2,3,元大-土城學府,2023-01-30,9822
2230,泰茂,5,2,3,元大-土城學府,2023-01-30,9822
2308,台達電,3,0,3,元大-土城學府,2023-01-30,9822
2634,漢翔,3,0,3,元大-土城學府,2023-01-30,9822
2641,正德,3,0,3,元大-土城學府,2023-01-30,9822
3710,連展投控,3,0,3,元大-土城學府,2023-01-30,9822
4561,健椿,3,0,3,元大-土城學府,2023-01-30,9822
6026,福邦證,3,0,3,元大-土城學府,2023-01-30,9822
8996,高力,33,30,3,元大-土城學府,2023-01-30,9822
00753L,中信中國50正2,91,0,91,元大-土城學府,2023-01-31,9822
8358,金居,64,8,56,元大-土城學府,2023-01-31,9822
6175,立敦,55,1,54,元大-土城學府,2023-01-31,9822
2329,華泰,41,1,40,元大-土城學府,2023-01-31,9822
2022,聚亨,31,0,31,元大-土城學府,2023-01-31,9822
2324,仁寶,26,0,26,元大-土城學府,2023-01-31,9822
00905,FT臺灣Smart,23,0,23,元大-土城學府,2023-01-31,9822
00891,中信關鍵半導體,22,0,22,元大-土城學府,2023-01-31,9822
00878,國泰永續高股息,67,46,21,元大-土城學府,2023-01-31,9822
1584,精剛,21,0,21,元大-土城學府,2023-01-31,9822
00882,中信中國高股息,20,0,20,元大-土城學府,2023-01-31,9822
2885,元大金,20,0,20,元大-土城學府,2023-01-31,9822
00892,富邦台灣半導體,20,0,20,元大-土城學府,2023-01-31,9822
1465,偉全,20,0,20,元大-土城學府,2023-01-31,9822
6158,禾昌,20,0,20,元大-土城學府,2023-01-31,9822
4114,健喬,24,4,20,元大-土城學府,2023-01-31,9822
3324,雙鴻,20,1,19,元大-土城學府,2023-01-31,9822
00894,中信小資高價30,15,0,15,元大-土城學府,2023-01-31,9822
4162,智擎,15,1,14,元大-土城學府,2023-01-31,9822
00893,國泰智能電動車,14,2,12,元大-土城學府,2023-01-31,9822
2014,中鴻,17,5,12,元大-土城學府,2023-01-31,9822
2330,台積電,15,4,11,元大-土城學府,2023-01-31,9822
00885,富邦越南,13,2,11,元大-土城學府,2023-01-31,9822
2371,大同,11,0,11,元大-土城學府,2023-01-31,9822
2891,中信金,11,0,11,元大-土城學府,2023-01-31,9822
6788,華景電,11,0,11,元大-土城學府,2023-01-31,9822
8050,廣積,11,0,11,元大-土城學府,2023-01-31,9822
8110,華東,11,0,11,元大-土城學府,2023-01-31,9822
8261,富鼎,12,1,11,元大-土城學府,2023-01-31,9822
4760,勤凱,10,0,10,元大-土城學府,2023-01-31,9822
9105,泰金寶-DR,10,0,10,元大-土城學府,2023-01-31,9822
2206,三陽工業,10,0,10,元大-土城學府,2023-01-31,9822
3665,貿聯-KY,10,0,10,元大-土城學府,2023-01-31,9822
8081,致新,10,0,10,元大-土城學府,2023-01-31,9822
6770,力積電,25,16,9,元大-土城學府,2023-01-31,9822
1101,台泥,13,4,9,元大-土城學府,2023-01-31,9822
2368,金像電,9,1,8,元大-土城學府,2023-01-31,9822
00772B,中信高評級公司債,8,0,8,元大-土城學府,2023-01-31,9822
00720B,元大投資級公司債,7,0,7,元大-土城學府,2023-01-31,9822
3163,波若威,7,0,7,元大-土城學府,2023-01-31,9822
6235,華孚,9,2,7,元大-土城學府,2023-01-31,9822
6806,森崴能源,8,1,7,元大-土城學府,2023-01-31,9822
2408,南亞科,7,0,7,元大-土城學府,2023-01-31,9822
00679B,元大美債20年,6,0,6,元大-土城學府,2023-01-31,9822
2002,中鋼,9,3,6,元大-土城學府,2023-01-31,9822
2376,技嘉,9,3,6,元大-土城學府,2023-01-31,9822
2880,華南金,6,0,6,元大-土城學府,2023-01-31,9822
6589,台康生技,13,7,6,元大-土城學府,2023-01-31,9822
8429,金麗-KY,6,0,6,元大-土城學府,2023-01-31,9822
2892,第一金,6,0,6,元大-土城學府,2023-01-31,9822
5258,虹堡,417,228,189,元大-土城學府,2023-02-01,9822
2369,菱生,84,2,82,元大-土城學府,2023-02-01,9822
8183,精星,40,0,40,元大-土城學府,2023-02-01,9822
2009,第一銅,68,29,39,元大-土城學府,2023-02-01,9822
6024,群益期,33,0,33,元大-土城學府,2023-02-01,9822
3081,聯亞,35,3,32,元大-土城學府,2023-02-01,9822
2014,中鴻,37,7,30,元大-土城學府,2023-02-01,9822
2891,中信金,24,0,24,元大-土城學府,2023-02-01,9822
1519,華城,28,4,24,元大-土城學府,2023-02-01,9822
00900,富邦特選高股息30,23,0,23,元大-土城學府,2023-02-01,9822
5289,宜鼎,16,0,16,元大-土城學府,2023-02-01,9822
8050,廣積,19,3,16,元大-土城學府,2023-02-01,9822
2883,凱基金,16,1,15,元大-土城學府,2023-02-01,9822
0056,元大高股息,21,10,11,元大-土城學府,2023-02-01,9822
2324,仁寶,11,0,11,元大-土城學府,2023-02-01,9822
6691,洋基工程,11,0,11,元大-土城學府,2023-02-01,9822
8112,至上,10,0,10,元大-土城學府,2023-02-01,9822
00882,中信中國高股息,10,0,10,元大-土城學府,2023-02-01,9822
2614,東森,12,2,10,元大-土城學府,2023-02-01,9822
2851,中再保,10,0,10,元大-土城學府,2023-02-01,9822
3706,神達,10,0,10,元大-土城學府,2023-02-01,9822
1443,立益物流,11,2,9,元大-土城學府,2023-02-01,9822
4760,勤凱,9,0,9,元大-土城學府,2023-02-01,9822
6719,力智,12,4,8,元大-土城學府,2023-02-01,9822
00673R,期元大S＆P原油反1,8,0,8,元大-土城學府,2023-02-01,9822
1786,科妍,8,0,8,元大-土城學府,2023-02-01,9822
2884,玉山金,8,0,8,元大-土城學府,2023-02-01,9822
3027,盛達,9,1,8,元大-土城學府,2023-02-01,9822
2610,華航,38,30,8,元大-土城學府,2023-02-01,9822
8121,越峰,8,1,7,元大-土城學府,2023-02-01,9822
2634,漢翔,8,1,7,元大-土城學府,2023-02-01,9822
2916,滿心,7,0,7,元大-土城學府,2023-02-01,9822
3704,合勤控,18,12,6,元大-土城學府,2023-02-01,9822
6176,瑞儀,6,0,6,元大-土城學府,2023-02-01,9822
8084,巨虹,6,0,6,元大-土城學府,2023-02-01,9822
2609,陽明,11,5,6,元大-土城學府,2023-02-01,9822
2892,第一金,6,0,6,元大-土城學府,2023-02-01,9822
00905,FT臺灣Smart,5,0,5,元大-土城學府,2023-02-01,9822
1701,中化,6,1,5,元大-土城學府,2023-02-01,9822
2022,聚亨,5,0,5,元大-土城學府,2023-02-01,9822
2465,麗臺,5,0,5,元大-土城學府,2023-02-01,9822
3323,加百裕,5,0,5,元大-土城學府,2023-02-01,9822
5403,中菲,5,0,5,元大-土城學府,2023-02-01,9822
6104,創惟,7,2,5,元大-土城學府,2023-02-01,9822
8261,富鼎,5,0,5,元大-土城學府,2023-02-01,9822
9928,中視,5,0,5,元大-土城學府,2023-02-01,9822
9945,潤泰新,5,0,5,元大-土城學府,2023-02-01,9822
1504,東元,5,0,5,元大-土城學府,2023-02-01,9822
2613,中櫃,4,0,4,元大-土城學府,2023-02-01,9822
4763,材料-KY,5,1,4,元大-土城學府,2023-02-01,9822
00878,國泰永續高股息,469,45,424,元大-土城學府,2023-02-02,9822
5258,虹堡,1607,1394,213,元大-土城學府,2023-02-02,9822
2610,華航,108,9,99,元大-土城學府,2023-02-02,9822
6190,萬泰科,71,2,69,元大-土城學府,2023-02-02,9822
00632R,元大台灣50反1,82,18,64,元大-土城學府,2023-02-02,9822
1342,八貫,61,3,58,元大-土城學府,2023-02-02,9822
00891,中信關鍵半導體,55,0,55,元大-土城學府,2023-02-02,9822
2534,宏盛,51,0,51,元大-土城學府,2023-02-02,9822
3363,上詮,49,0,49,元大-土城學府,2023-02-02,9822
2363,矽統,46,1,45,元大-土城學府,2023-02-02,9822
2484,希華,40,3,37,元大-土城學府,2023-02-02,9822
1524,耿鼎,45,13,32,元大-土城學府,2023-02-02,9822
2380,虹光,30,0,30,元大-土城學府,2023-02-02,9822
2317,鴻海,27,0,27,元大-土城學府,2023-02-02,9822
1605,華新,39,14,25,元大-土城學府,2023-02-02,9822
3481,群創,28,5,23,元大-土城學府,2023-02-02,9822
3357,臺慶科,22,0,22,元大-土城學府,2023-02-02,9822
00720B,元大投資級公司債,23,2,21,元大-土城學府,2023-02-02,9822
1701,中化,25,4,21,元大-土城學府,2023-02-02,9822
3324,雙鴻,20,0,20,元大-土城學府,2023-02-02,9822
6175,立敦,20,0,20,元大-土城學府,2023-02-02,9822
00885,富邦越南,20,0,20,元大-土城學府,2023-02-02,9822
2465,麗臺,16,0,16,元大-土城學府,2023-02-02,9822
5299,杰力,15,0,15,元大-土城學府,2023-02-02,9822
2618,長榮航,13,0,13,元大-土城學府,2023-02-02,9822
6116,彩晶,32,19,13,元大-土城學府,2023-02-02,9822
00637L,元大滬深300正2,13,1,12,元大-土城學府,2023-02-02,9822
00905,FT臺灣Smart,11,0,11,元大-土城學府,2023-02-02,9822
2492,華新科,19,8,11,元大-土城學府,2023-02-02,9822
3594,磐儀,11,0,11,元大-土城學府,2023-02-02,9822
8450,霹靂,11,0,11,元大-土城學府,2023-02-02,9822
2014,中鴻,13,3,10,元大-土城學府,2023-02-02,9822
2006,東和鋼鐵,10,0,10,元大-土城學府,2023-02-02,9822
2897,王道銀行,11,1,10,元大-土城學府,2023-02-02,9822
3321,同泰,10,0,10,元大-土城學府,2023-02-02,9822
8121,越峰,12,2,10,元大-土城學府,2023-02-02,9822
9105,泰金寶-DR,10,0,10,元大-土城學府,2023-02-02,9822
2891,中信金,9,0,9,元大-土城學府,2023-02-02,9822
2542,興富發,9,0,9,元大-土城學府,2023-02-02,9822
2812,台中銀,10,1,9,元大-土城學府,2023-02-02,9822
6719,力智,11,2,9,元大-土城學府,2023-02-02,9822
6770,力積電,32,23,9,元大-土城學府,2023-02-02,9822
1810,和成,20,12,8,元大-土城學府,2023-02-02,9822
2634,漢翔,7,0,7,元大-土城學府,2023-02-02,9822
1584,精剛,11,5,6,元大-土城學府,2023-02-02,9822
3346,麗清,6,0,6,元大-土城學府,2023-02-02,9822
4532,瑞智,6,0,6,元大-土城學府,2023-02-02,9822
6177,達麗,6,0,6,元大-土城學府,2023-02-02,9822
2201,裕隆,20,15,5,元大-土城學府,2023-02-02,9822
00733,富邦臺灣中小,5,0,5,元大-土城學府,2023-02-02,9822
00753L,中信中國50正2,208,0,208,元大-土城學府,2023-02-03,9822
3479,安勤,189,107,82,元大-土城學府,2023-02-03,9822
00882,中信中國高股息,72,0,72,元大-土城學府,2023-02-03,9822
2498,宏達電,109,57,52,元大-土城學府,2023-02-03,9822
2453,凌群,40,1,39,元大-土城學府,2023-02-03,9822
00878,國泰永續高股息,38,1,37,元大-土城學府,2023-02-03,9822
00900,富邦特選高股息30,35,0,35,元大-土城學府,2023-02-03,9822
2317,鴻海,30,2,28,元大-土城學府,2023-02-03,9822
4532,瑞智,24,0,24,元大-土城學府,2023-02-03,9822
3048,益登,23,0,23,元大-土城學府,2023-02-03,9822
1216,統一,28,6,22,元大-土城學府,2023-02-03,9822
2892,第一金,22,0,22,元大-土城學府,2023-02-03,9822
6118,建達,36,14,22,元大-土城學府,2023-02-03,9822
2014,中鴻,22,1,21,元大-土城學府,2023-02-03,9822
5371,中光電,21,1,20,元大-土城學府,2023-02-03,9822
2388,威盛,24,5,19,元大-土城學府,2023-02-03,9822
3037,欣興,25,7,18,元大-土城學府,2023-02-03,9822
2369,菱生,18,0,18,元大-土城學府,2023-02-03,9822
3481,群創,18,2,16,元大-土城學府,2023-02-03,9822
6770,力積電,24,8,16,元大-土城學府,2023-02-03,9822
8081,致新,15,0,15,元大-土城學府,2023-02-03,9822
6719,力智,15,1,14,元大-土城學府,2023-02-03,9822
00632R,元大台灣50反1,114,100,14,元大-土城學府,2023-02-03,9822
3093,港建*,14,0,14,元大-土城學府,2023-02-03,9822
4760,勤凱,14,0,14,元大-土城學府,2023-02-03,9822
5521,工信,30,16,14,元大-土城學府,2023-02-03,9822
1417,嘉裕,13,0,13,元大-土城學府,2023-02-03,9822
5483,中美晶,14,1,13,元大-土城學府,2023-02-03,9822
0050,元大台灣50,14,2,12,元大-土城學府,2023-02-03,9822
4979,華星光,15,4,11,元大-土城學府,2023-02-03,9822
00674R,期元大S＆P黃金反1,10,0,10,元大-土城學府,2023-02-03,9822
2032,新鋼,10,0,10,元大-土城學府,2023-02-03,9822
6188,廣明,11,1,10,元大-土城學府,2023-02-03,9822
2881,富邦金,11,1,10,元大-土城學府,2023-02-03,9822
4167,松瑞藥,11,1,10,元大-土城學府,2023-02-03,9822
2891,中信金,9,1,8,元大-土城學府,2023-02-03,9822
5608,四維航,8,0,8,元大-土城學府,2023-02-03,9822
00637L,元大滬深300正2,7,0,7,元大-土城學府,2023-02-03,9822
2888,新光金,8,1,7,元大-土城學府,2023-02-03,9822
2031,新光鋼,6,0,6,元大-土城學府,2023-02-03,9822
2313,華通,6,0,6,元大-土城學府,2023-02-03,9822
3357,臺慶科,6,0,6,元大-土城學府,2023-02-03,9822
6244,茂迪,8,2,6,元大-土城學府,2023-02-03,9822
6418,詠昇,6,0,6,元大-土城學府,2023-02-03,9822
8084,巨虹,6,0,6,元大-土城學府,2023-02-03,9822
8044,網家,6,0,6,元大-土城學府,2023-02-03,9822
00648R,元大S＆P500反1,5,0,5,元大-土城學府,2023-02-03,9822
00712,復華富時不動產,5,0,5,元大-土城學府,2023-02-03,9822
1305,華夏,6,1,5,元大-土城學府,2023-02-03,9822
1524,耿鼎,7,2,5,元大-土城學府,2023-02-03,9822
5258,虹堡,114,5,109,元大-土城學府,2023-02-06,9822
2615,萬海,110,7,103,元大-土城學府,2023-02-06,9822
00878,國泰永續高股息,102,8,94,元大-土城學府,2023-02-06,9822
1101,台泥,63,5,58,元大-土城學府,2023-02-06,9822
00664R,國泰臺灣加權反1,50,0,50,元大-土城學府,2023-02-06,9822
00882,中信中國高股息,32,1,31,元大-土城學府,2023-02-06,9822
2379,瑞昱,31,1,30,元大-土城學府,2023-02-06,9822
3093,港建*,24,0,24,元大-土城學府,2023-02-06,9822
00715L,期街口布蘭特正2,32,10,22,元大-土城學府,2023-02-06,9822
6550,北極星藥業-KY,25,5,20,元大-土城學府,2023-02-06,9822
1605,華新,27,8,19,元大-土城學府,2023-02-06,9822
1529,樂事綠能,18,0,18,元大-土城學府,2023-02-06,9822
00772B,中信高評級公司債,14,0,14,元大-土城學府,2023-02-06,9822
0056,元大高股息,18,4,14,元大-土城學府,2023-02-06,9822
3264,欣銓,16,3,13,元大-土城學府,2023-02-06,9822
2609,陽明,19,6,13,元大-土城學府,2023-02-06,9822
00891,中信關鍵半導體,13,0,13,元大-土城學府,2023-02-06,9822
00720B,元大投資級公司債,12,0,12,元大-土城學府,2023-02-06,9822
6129,普誠,13,1,12,元大-土城學府,2023-02-06,9822
2603,長榮,11,0,11,元大-土城學府,2023-02-06,9822
5483,中美晶,11,0,11,元大-土城學府,2023-02-06,9822
5289,宜鼎,11,0,11,元大-土城學府,2023-02-06,9822
6770,力積電,21,10,11,元大-土城學府,2023-02-06,9822
00904,新光臺灣半導體30,10,0,10,元大-土城學府,2023-02-06,9822
2903,遠百,10,0,10,元大-土城學府,2023-02-06,9822
4123,晟德,10,0,10,元大-土城學府,2023-02-06,9822
4919,新唐,11,2,9,元大-土城學府,2023-02-06,9822
00637L,元大滬深300正2,14,5,9,元大-土城學府,2023-02-06,9822
1313,聯成,8,0,8,元大-土城學府,2023-02-06,9822
2455,全新,8,0,8,元大-土城學府,2023-02-06,9822
6104,創惟,14,6,8,元大-土城學府,2023-02-06,9822
3037,欣興,19,12,7,元大-土城學府,2023-02-06,9822
2376,技嘉,7,0,7,元大-土城學府,2023-02-06,9822
6116,彩晶,6,0,6,元大-土城學府,2023-02-06,9822
2884,玉山金,5,0,5,元大-土城學府,2023-02-06,9822
2368,金像電,5,0,5,元大-土城學府,2023-02-06,9822
00753L,中信中國50正2,5,0,5,元大-土城學府,2023-02-06,9822
00632R,元大台灣50反1,5,0,5,元大-土城學府,2023-02-06,9822
1786,科妍,5,0,5,元大-土城學府,2023-02-06,9822
2022,聚亨,5,0,5,元大-土城學府,2023-02-06,9822
2204,中華,5,0,5,元大-土城學府,2023-02-06,9822
2369,菱生,5,0,5,元大-土城學府,2023-02-06,9822
5347,世界,5,0,5,元大-土城學府,2023-02-06,9822
5475,德宏,5,0,5,元大-土城學府,2023-02-06,9822
6443,元晶,5,0,5,元大-土城學府,2023-02-06,9822
2534,宏盛,15,10,5,元大-土城學府,2023-02-06,9822
3293,鈊象,5,0,5,元大-土城學府,2023-02-06,9822
00679B,元大美債20年,5,0,5,元大-土城學府,2023-02-06,9822
2891,中信金,5,1,4,元大-土城學府,2023-02-06,9822
3704,合勤控,5,1,4,元大-土城學府,2023-02-06,9822
00878,國泰永續高股息,72,1,71,元大-土城學府,2023-02-07,9822
2379,瑞昱,67,2,65,元大-土城學府,2023-02-07,9822
1605,華新,53,11,42,元大-土城學府,2023-02-07,9822
1752,南光,43,5,38,元大-土城學府,2023-02-07,9822
8105,凌巨,31,0,31,元大-土城學府,2023-02-07,9822
2614,東森,30,0,30,元大-土城學府,2023-02-07,9822
2352,佳世達,23,0,23,元大-土城學府,2023-02-07,9822
00772B,中信高評級公司債,21,0,21,元大-土城學府,2023-02-07,9822
2363,矽統,20,0,20,元大-土城學府,2023-02-07,9822
2380,虹光,20,0,20,元大-土城學府,2023-02-07,9822
2344,華邦電,15,0,15,元大-土城學府,2023-02-07,9822
3264,欣銓,16,2,14,元大-土城學府,2023-02-07,9822
5258,虹堡,117,103,14,元大-土城學府,2023-02-07,9822
2498,宏達電,26,13,13,元大-土城學府,2023-02-07,9822
8038,長園科,13,0,13,元大-土城學府,2023-02-07,9822
00882,中信中國高股息,13,0,13,元大-土城學府,2023-02-07,9822
6153,嘉聯益,12,0,12,元大-土城學府,2023-02-07,9822
2603,長榮,12,1,11,元大-土城學府,2023-02-07,9822
1733,五鼎,15,4,11,元大-土城學府,2023-02-07,9822
8050,廣積,15,4,11,元大-土城學府,2023-02-07,9822
1301,台塑,10,0,10,元大-土城學府,2023-02-07,9822
00683L,期元大美元指正2,10,0,10,元大-土城學府,2023-02-07,9822
1591,駿吉-KY,10,0,10,元大-土城學府,2023-02-07,9822
4532,瑞智,10,0,10,元大-土城學府,2023-02-07,9822
6186,新潤,10,0,10,元大-土城學府,2023-02-07,9822
00900,富邦特選高股息30,10,1,9,元大-土城學府,2023-02-07,9822
1795,美時,33,24,9,元大-土城學府,2023-02-07,9822
2368,金像電,10,1,9,元大-土城學府,2023-02-07,9822
1701,中化,14,5,9,元大-土城學府,2023-02-07,9822
3141,晶宏,13,4,9,元大-土城學府,2023-02-07,9822
4747,強生,15,6,9,元大-土城學府,2023-02-07,9822
6116,彩晶,15,6,9,元大-土城學府,2023-02-07,9822
2455,全新,8,0,8,元大-土城學府,2023-02-07,9822
4167,松瑞藥,15,7,8,元大-土城學府,2023-02-07,9822
00712,復華富時不動產,7,0,7,元大-土城學府,2023-02-07,9822
3231,緯創,8,1,7,元大-土城學府,2023-02-07,9822
3037,欣興,11,5,6,元大-土城學府,2023-02-07,9822
00632R,元大台灣50反1,6,0,6,元大-土城學府,2023-02-07,9822
1432,大魯閣,10,4,6,元大-土城學府,2023-02-07,9822
2393,億光,6,0,6,元大-土城學府,2023-02-07,9822
2634,漢翔,6,0,6,元大-土城學府,2023-02-07,9822
2881,富邦金,6,0,6,元大-土城學府,2023-02-07,9822
6756,威鋒電子,6,0,6,元大-土城學府,2023-02-07,9822
2317,鴻海,9,3,6,元大-土城學府,2023-02-07,9822
00679B,元大美債20年,5,0,5,元大-土城學府,2023-02-07,9822
2354,鴻準,8,3,5,元大-土城學府,2023-02-07,9822
2618,長榮航,7,2,5,元大-土城學府,2023-02-07,9822
2887,台新金,7,2,5,元大-土城學府,2023-02-07,9822
6129,普誠,5,0,5,元大-土城學府,2023-02-07,9822
2882,國泰金,7,2,5,元大-土城學府,2023-02-07,9822
00632R,元大台灣50反1,642,50,592,元大-土城學府,2023-02-08,9822
0056,元大高股息,48,1,47,元大-土城學府,2023-02-08,9822
00882,中信中國高股息,44,0,44,元大-土城學府,2023-02-08,9822
2884,玉山金,39,0,39,元大-土城學府,2023-02-08,9822
3046,建��,36,4,32,元大-土城學府,2023-02-08,9822
2355,敬鵬,31,0,31,元大-土城學府,2023-02-08,9822
2534,宏盛,25,0,25,元大-土城學府,2023-02-08,9822
2338,光罩,34,12,22,元大-土城學府,2023-02-08,9822
2498,宏達電,43,23,20,元大-土城學府,2023-02-08,9822
6282,康舒,23,3,20,元大-土城學府,2023-02-08,9822
00772B,中信高評級公司債,18,0,18,元大-土城學府,2023-02-08,9822
2369,菱生,21,4,17,元大-土城學府,2023-02-08,9822
00720B,元大投資級公司債,14,0,14,元大-土城學府,2023-02-08,9822
8933,愛地雅,14,0,14,元大-土城學府,2023-02-08,9822
2371,大同,13,0,13,元大-土城學府,2023-02-08,9822
1513,中興電,27,14,13,元大-土城學府,2023-02-08,9822
2367,燿華,15,2,13,元大-土城學府,2023-02-08,9822
6127,九豪,12,0,12,元大-土城學府,2023-02-08,9822
3264,欣銓,14,3,11,元大-土城學府,2023-02-08,9822
00753L,中信中國50正2,10,0,10,元大-土城學府,2023-02-08,9822
6123,上奇,10,0,10,元大-土城學府,2023-02-08,9822
6202,盛群,10,0,10,元大-土城學府,2023-02-08,9822
8043,蜜望實,10,0,10,元大-土城學府,2023-02-08,9822
4960,誠美材,20,11,9,元大-土城學府,2023-02-08,9822
6733,博晟生醫,9,0,9,元大-土城學府,2023-02-08,9822
3027,盛達,23,15,8,元大-土城學府,2023-02-08,9822
3207,耀勝,8,0,8,元大-土城學府,2023-02-08,9822
00902,中信電池及儲能,8,0,8,元大-土城學府,2023-02-08,9822
5403,中菲,8,0,8,元大-土城學府,2023-02-08,9822
2888,新光金,13,5,8,元大-土城學府,2023-02-08,9822
3592,瑞鼎,11,4,7,元大-土城學府,2023-02-08,9822
1416,廣豐,7,0,7,元大-土城學府,2023-02-08,9822
1752,南光,9,2,7,元大-土城學府,2023-02-08,9822
2492,華新科,7,0,7,元大-土城學府,2023-02-08,9822
3029,零壹,7,0,7,元大-土城學府,2023-02-08,9822
4979,華星光,13,6,7,元大-土城學府,2023-02-08,9822
00893,國泰智能電動車,26,20,6,元大-土城學府,2023-02-08,9822
00906,大華元宇宙科技50,6,0,6,元大-土城學府,2023-02-08,9822
2867,三商壽,6,0,6,元大-土城學府,2023-02-08,9822
4968,立積,7,1,6,元大-土城學府,2023-02-08,9822
8996,高力,9,3,6,元大-土城學府,2023-02-08,9822
4155,訊映,6,0,6,元大-土城學府,2023-02-08,9822
00679B,元大美債20年,5,0,5,元大-土城學府,2023-02-08,9822
2892,第一金,5,0,5,元大-土城學府,2023-02-08,9822
00901,永豐智能車供應鏈,5,0,5,元大-土城學府,2023-02-08,9822
1810,和成,7,2,5,元大-土城學府,2023-02-08,9822
2014,中鴻,6,1,5,元大-土城學府,2023-02-08,9822
2353,宏��,7,2,5,元大-土城學府,2023-02-08,9822
2393,億光,5,0,5,元大-土城學府,2023-02-08,9822
2929,淘帝-KY,5,0,5,元大-土城學府,2023-02-08,9822
00878,國泰永續高股息,103,1,102,元大-土城學府,2023-02-09,9822
1584,精剛,90,9,81,元大-土城學府,2023-02-09,9822
2484,希華,81,5,76,元大-土城學府,2023-02-09,9822
2887,台新金,68,0,68,元大-土城學府,2023-02-09,9822
3014,聯陽,30,0,30,元大-土城學府,2023-02-09,9822
00632R,元大台灣50反1,223,200,23,元大-土城學府,2023-02-09,9822
4968,立積,30,8,22,元大-土城學府,2023-02-09,9822
00885,富邦越南,20,0,20,元大-土城學府,2023-02-09,9822
5351,鈺創,21,1,20,元大-土城學府,2023-02-09,9822
2344,華邦電,21,2,19,元大-土城學府,2023-02-09,9822
6509,聚和,21,2,19,元大-土城學府,2023-02-09,9822
2308,台達電,18,1,17,元大-土城學府,2023-02-09,9822
3141,晶宏,22,7,15,元大-土城學府,2023-02-09,9822
3357,臺慶科,15,0,15,元大-土城學府,2023-02-09,9822
4979,華星光,20,5,15,元大-土城學府,2023-02-09,9822
00673R,期元大S＆P原油反1,15,0,15,元大-土城學府,2023-02-09,9822
00902,中信電池及儲能,14,0,14,元大-土城學府,2023-02-09,9822
2027,大成鋼,15,1,14,元大-土城學府,2023-02-09,9822
2882,國泰金,13,0,13,元大-土城學府,2023-02-09,9822
4114,健喬,15,2,13,元大-土城學府,2023-02-09,9822
2609,陽明,15,3,12,元大-土城學府,2023-02-09,9822
2425,承啟,16,5,11,元大-土城學府,2023-02-09,9822
6770,力積電,18,7,11,元大-土城學府,2023-02-09,9822
2412,中華電,10,0,10,元大-土城學府,2023-02-09,9822
00900,富邦特選高股息30,10,0,10,元大-土城學府,2023-02-09,9822
2355,敬鵬,10,0,10,元大-土城學府,2023-02-09,9822
4919,新唐,10,0,10,元大-土城學府,2023-02-09,9822
5521,工信,10,0,10,元大-土城學府,2023-02-09,9822
8222,寶一,11,1,10,元大-土城學府,2023-02-09,9822
1513,中興電,44,34,10,元大-土城學府,2023-02-09,9822
2736,富野,9,0,9,元大-土城學府,2023-02-09,9822
4966,譜瑞-KY,8,0,8,元大-土城學府,2023-02-09,9822
1709,和益,8,0,8,元大-土城學府,2023-02-09,9822
2359,所羅門,10,2,8,元大-土城學府,2023-02-09,9822
9945,潤泰新,10,2,8,元大-土城學府,2023-02-09,9822
6719,力智,16,8,8,元大-土城學府,2023-02-09,9822
2390,云辰,7,0,7,元大-土城學府,2023-02-09,9822
6441,廣錠,7,0,7,元大-土城學府,2023-02-09,9822
6552,易華電,8,1,7,元大-土城學府,2023-02-09,9822
2368,金像電,10,3,7,元大-土城學府,2023-02-09,9822
3704,合勤控,9,3,6,元大-土城學府,2023-02-09,9822
2891,中信金,75,69,6,元大-土城學府,2023-02-09,9822
3665,貿聯-KY,6,0,6,元大-土城學府,2023-02-09,9822
1467,南緯,6,0,6,元大-土城學府,2023-02-09,9822
6697,東捷資訊,6,0,6,元大-土城學府,2023-02-09,9822
00679B,元大美債20年,6,0,6,元大-土城學府,2023-02-09,9822
2610,華航,10,5,5,元大-土城學府,2023-02-09,9822
4743,合一,12,7,5,元大-土城學府,2023-02-09,9822
00637L,元大滬深300正2,5,0,5,元大-土城學府,2023-02-09,9822
00701,國泰股利精選30,5,0,5,元大-土城學府,2023-02-09,9822
3479,安勤,1357,1183,174,元大-土城學府,2023-02-10,9822
00753L,中信中國50正2,120,0,120,元大-土城學府,2023-02-10,9822
00671R,富邦NASDAQ反1,100,0,100,元大-土城學府,2023-02-10,9822
2610,華航,56,3,53,元大-土城學府,2023-02-10,9822
2379,瑞昱,70,30,40,元大-土城學府,2023-02-10,9822
2618,長榮航,39,9,30,元大-土城學府,2023-02-10,9822
2371,大同,29,0,29,元大-土城學府,2023-02-10,9822
2498,宏達電,46,22,24,元大-土城學府,2023-02-10,9822
1701,中化,30,7,23,元大-土城學府,2023-02-10,9822
2614,東森,29,7,22,元大-土城學府,2023-02-10,9822
2888,新光金,22,2,20,元大-土城學府,2023-02-10,9822
00720B,元大投資級公司債,19,0,19,元大-土城學府,2023-02-10,9822
2401,凌陽,23,4,19,元大-土城學府,2023-02-10,9822
00679B,元大美債20年,17,0,17,元大-土城學府,2023-02-10,9822
2409,友達,15,0,15,元大-土城學府,2023-02-10,9822
00673R,期元大S＆P原油反1,14,0,14,元大-土城學府,2023-02-10,9822
0056,元大高股息,13,0,13,元大-土城學府,2023-02-10,9822
2390,云辰,23,10,13,元大-土城學府,2023-02-10,9822
5521,工信,21,8,13,元大-土城學府,2023-02-10,9822
6509,聚和,42,29,13,元大-土城學府,2023-02-10,9822
00712,復華富時不動產,12,0,12,元大-土城學府,2023-02-10,9822
1605,華新,27,15,12,元大-土城學府,2023-02-10,9822
5905,南仁湖,12,0,12,元大-土城學府,2023-02-10,9822
00900,富邦特選高股息30,12,0,12,元大-土城學府,2023-02-10,9822
2609,陽明,16,5,11,元大-土城學府,2023-02-10,9822
3037,欣興,16,5,11,元大-土城學府,2023-02-10,9822
2344,華邦電,14,3,11,元大-土城學府,2023-02-10,9822
2413,環科,15,4,11,元大-土城學府,2023-02-10,9822
3162,精確,11,0,11,元大-土城學府,2023-02-10,9822
6116,彩晶,15,4,11,元大-土城學府,2023-02-10,9822
6285,啟��,11,0,11,元大-土城學府,2023-02-10,9822
6282,康舒,17,7,10,元大-土城學府,2023-02-10,9822
2748,雲品,10,0,10,元大-土城學府,2023-02-10,9822
3669,圓展,10,0,10,元大-土城學府,2023-02-10,9822
4931,新盛力,15,5,10,元大-土城學府,2023-02-10,9822
8933,愛地雅,10,0,10,元大-土城學府,2023-02-10,9822
2457,飛宏,9,0,9,元大-土城學府,2023-02-10,9822
2027,大成鋼,10,1,9,元大-土城學府,2023-02-10,9822
2405,輔信,12,3,9,元大-土城學府,2023-02-10,9822
5388,中磊,10,1,9,元大-土城學府,2023-02-10,9822
00902,中信電池及儲能,8,0,8,元大-土城學府,2023-02-10,9822
00851,台新全球AI,8,0,8,元大-土城學府,2023-02-10,9822
1529,樂事綠能,8,0,8,元大-土城學府,2023-02-10,9822
2851,中再保,8,0,8,元大-土城學府,2023-02-10,9822
2883,凱基金,8,0,8,元大-土城學府,2023-02-10,9822
6789,采鈺,8,0,8,元大-土城學府,2023-02-10,9822
5258,虹堡,10,2,8,元大-土城學府,2023-02-10,9822
8069,元太,10,3,7,元大-土城學府,2023-02-10,9822
3264,欣銓,7,1,6,元大-土城學府,2023-02-10,9822
2881,富邦金,6,0,6,元大-土城學府,2023-02-10,9822
00648R,元大S＆P500反1,300,0,300,元大-土城學府,2023-02-13,9822
2610,華航,119,7,112,元大-土城學府,2023-02-13,9822
00632R,元大台灣50反1,102,5,97,元大-土城學府,2023-02-13,9822
00878,國泰永續高股息,101,24,77,元大-土城學府,2023-02-13,9822
2344,華邦電,67,1,66,元大-土城學府,2023-02-13,9822
00671R,富邦NASDAQ反1,50,0,50,元大-土城學府,2023-02-13,9822
00679B,元大美債20年,38,0,38,元大-土城學府,2023-02-13,9822
1584,精剛,32,4,28,元大-土城學府,2023-02-13,9822
3479,安勤,48,26,22,元大-土城學府,2023-02-13,9822
2303,聯電,28,10,18,元大-土城學府,2023-02-13,9822
00772B,中信高評級公司債,17,0,17,元大-土城學府,2023-02-13,9822
8033,雷虎,18,2,16,元大-土城學府,2023-02-13,9822
2609,陽明,23,8,15,元大-土城學府,2023-02-13,9822
00673R,期元大S＆P原油反1,15,0,15,元大-土城學府,2023-02-13,9822
1701,中化,33,18,15,元大-土城學府,2023-02-13,9822
2498,宏達電,23,8,15,元大-土城學府,2023-02-13,9822
2534,宏盛,15,0,15,元大-土城學府,2023-02-13,9822
2409,友達,18,3,15,元大-土城學府,2023-02-13,9822
2634,漢翔,15,1,14,元大-土城學府,2023-02-13,9822
00900,富邦特選高股息30,18,5,13,元大-土城學府,2023-02-13,9822
3105,穩懋,17,4,13,元大-土城學府,2023-02-13,9822
5521,工信,23,10,13,元大-土城學府,2023-02-13,9822
3447,展達,12,0,12,元大-土城學府,2023-02-13,9822
4906,正文,12,0,12,元大-土城學府,2023-02-13,9822
6165,浪凡,12,0,12,元大-土城學府,2023-02-13,9822
2618,長榮航,15,3,12,元大-土城學府,2023-02-13,9822
00893,國泰智能電動車,10,0,10,元大-土城學府,2023-02-13,9822
1506,正道,10,0,10,元大-土城學府,2023-02-13,9822
1513,中興電,34,24,10,元大-土城學府,2023-02-13,9822
1591,駿吉-KY,10,0,10,元大-土城學府,2023-02-13,9822
1809,中釉,10,0,10,元大-土城學府,2023-02-13,9822
2359,所羅門,10,0,10,元大-土城學府,2023-02-13,9822
4155,訊映,10,0,10,元大-土城學府,2023-02-13,9822
4919,新唐,17,7,10,元大-土城學府,2023-02-13,9822
00751B,元大AAA至A公司債,9,0,9,元大-土城學府,2023-02-13,9822
3494,誠研,9,0,9,元大-土城學府,2023-02-13,9822
6547,高端疫苗,7,0,7,元大-土城學府,2023-02-13,9822
2880,華南金,7,0,7,元大-土城學府,2023-02-13,9822
3162,精確,10,3,7,元大-土城學府,2023-02-13,9822
3481,群創,8,1,7,元大-土城學府,2023-02-13,9822
6282,康舒,9,2,7,元大-土城學府,2023-02-13,9822
6443,元晶,7,0,7,元大-土城學府,2023-02-13,9822
2603,長榮,7,1,6,元大-土城學府,2023-02-13,9822
2371,大同,6,0,6,元大-土城學府,2023-02-13,9822
3264,欣銓,6,0,6,元大-土城學府,2023-02-13,9822
6235,華孚,18,12,6,元大-土城學府,2023-02-13,9822
2330,台積電,6,0,6,元大-土城學府,2023-02-13,9822
3027,盛達,22,17,5,元大-土城學府,2023-02-13,9822
1718,中纖,5,0,5,元大-土城學府,2023-02-13,9822
00904,新光臺灣半導體30,5,0,5,元大-土城學府,2023-02-13,9822
00632R,元大台灣50反1,411,60,351,元大-土城學府,2023-02-14,9822
3481,群創,206,7,199,元大-土城學府,2023-02-14,9822
00878,國泰永續高股息,195,37,158,元大-土城學府,2023-02-14,9822
00679B,元大美債20年,69,3,66,元大-土城學府,2023-02-14,9822
2344,華邦電,64,1,63,元大-土城學府,2023-02-14,9822
2834,臺企銀,34,0,34,元大-土城學府,2023-02-14,9822
3447,展達,33,0,33,元大-土城學府,2023-02-14,9822
1605,華新,47,21,26,元大-土城學府,2023-02-14,9822
9904,寶成,21,0,21,元大-土城學府,2023-02-14,9822
00772B,中信高評級公司債,20,0,20,元大-土城學府,2023-02-14,9822
00673R,期元大S＆P原油反1,20,0,20,元大-土城學府,2023-02-14,9822
4536,拓凱,20,1,19,元大-土城學府,2023-02-14,9822
8038,長園科,20,1,19,元大-土城學府,2023-02-14,9822
6217,中探針,11,0,11,元大-土城學府,2023-02-14,9822
00773B,中信優先金融債,10,0,10,元大-土城學府,2023-02-14,9822
1806,冠軍,10,0,10,元大-土城學府,2023-02-14,9822
1809,中釉,10,0,10,元大-土城學府,2023-02-14,9822
2405,輔信,10,0,10,元大-土城學府,2023-02-14,9822
1810,和成,9,0,9,元大-土城學府,2023-02-14,9822
6245,立端,14,5,9,元大-土城學府,2023-02-14,9822
6538,倉和,9,0,9,元大-土城學府,2023-02-14,9822
1513,中興電,21,13,8,元大-土城學府,2023-02-14,9822
5403,中菲,8,0,8,元大-土城學府,2023-02-14,9822
2885,元大金,8,0,8,元大-土城學府,2023-02-14,9822
8050,廣積,8,1,7,元大-土城學府,2023-02-14,9822
8409,商之器,7,0,7,元大-土城學府,2023-02-14,9822
4931,新盛力,14,8,6,元大-土城學府,2023-02-14,9822
4979,華星光,10,4,6,元大-土城學府,2023-02-14,9822
5521,工信,16,10,6,元大-土城學府,2023-02-14,9822
00902,中信電池及儲能,5,0,5,元大-土城學府,2023-02-14,9822
1457,宜進,5,0,5,元大-土城學府,2023-02-14,9822
2023,燁輝,5,0,5,元大-土城學府,2023-02-14,9822
2027,大成鋼,5,0,5,元大-土城學府,2023-02-14,9822
2888,新光金,5,0,5,元大-土城學府,2023-02-14,9822
3594,磐儀,6,1,5,元大-土城學府,2023-02-14,9822
4804,大略-KY,5,0,5,元大-土城學府,2023-02-14,9822
6142,友勁,6,1,5,元大-土城學府,2023-02-14,9822
6443,元晶,5,0,5,元大-土城學府,2023-02-14,9822
8044,網家,5,0,5,元大-土城學府,2023-02-14,9822
1599,宏佳騰,4,0,4,元大-土城學府,2023-02-14,9822
2201,裕隆,26,22,4,元大-土城學府,2023-02-14,9822
2206,三陽工業,5,1,4,元大-土城學府,2023-02-14,9822
2371,大同,4,0,4,元大-土城學府,2023-02-14,9822
2465,麗臺,4,0,4,元大-土城學府,2023-02-14,9822
2486,一詮,4,0,4,元大-土城學府,2023-02-14,9822
3293,鈊象,6,2,4,元大-土城學府,2023-02-14,9822
3466,德晉,4,0,4,元大-土城學府,2023-02-14,9822
4906,正文,4,0,4,元大-土城學府,2023-02-14,9822
6123,上奇,4,0,4,元大-土城學府,2023-02-14,9822
6138,茂達,4,0,4,元大-土城學府,2023-02-14,9822
00878,國泰永續高股息,135,39,96,元大-土城學府,2023-02-15,9822
1809,中釉,65,0,65,元大-土城學府,2023-02-15,9822
2834,臺企銀,56,3,53,元大-土城學府,2023-02-15,9822
2038,海光,50,2,48,元大-土城學府,2023-02-15,9822
00905,FT臺灣Smart,41,0,41,元大-土城學府,2023-02-15,9822
2206,三陽工業,46,6,40,元大-土城學府,2023-02-15,9822
2471,資通,79,47,32,元大-土城學府,2023-02-15,9822
3260,威剛,31,0,31,元大-土城學府,2023-02-15,9822
1718,中纖,30,0,30,元大-土城學府,2023-02-15,9822
8358,金居,30,4,26,元大-土城學府,2023-02-15,9822
00885,富邦越南,25,0,25,元大-土城學府,2023-02-15,9822
4974,亞泰,20,0,20,元大-土城學府,2023-02-15,9822
6806,森崴能源,23,3,20,元大-土城學府,2023-02-15,9822
1101,台泥,22,3,19,元大-土城學府,2023-02-15,9822
5258,虹堡,38,22,16,元大-土城學府,2023-02-15,9822
4960,誠美材,17,3,14,元大-土城學府,2023-02-15,9822
2002,中鋼,13,0,13,元大-土城學府,2023-02-15,9822
8050,廣積,13,1,12,元大-土城學府,2023-02-15,9822
2027,大成鋼,13,1,12,元大-土城學府,2023-02-15,9822
6245,立端,15,3,12,元大-土城學府,2023-02-15,9822
2388,威盛,15,4,11,元大-土城學府,2023-02-15,9822
3025,星通,11,0,11,元大-土城學府,2023-02-15,9822
3479,安勤,13,2,11,元大-土城學府,2023-02-15,9822
0056,元大高股息,11,0,11,元大-土城學府,2023-02-15,9822
00900,富邦特選高股息30,20,10,10,元大-土城學府,2023-02-15,9822
00772B,中信高評級公司債,10,0,10,元大-土城學府,2023-02-15,9822
00795B,中信美國公債20年,10,0,10,元大-土城學府,2023-02-15,9822
1806,冠軍,10,0,10,元大-土城學府,2023-02-15,9822
2337,旺宏,13,3,10,元大-土城學府,2023-02-15,9822
2352,佳世達,10,0,10,元大-土城學府,2023-02-15,9822
3059,華晶科,10,0,10,元大-土城學府,2023-02-15,9822
8150,南茂,10,0,10,元大-土城學府,2023-02-15,9822
6719,力智,10,1,9,元大-土城學府,2023-02-15,9822
0050,元大台灣50,10,1,9,元大-土城學府,2023-02-15,9822
00907,永豐優息存股,10,2,8,元大-土城學府,2023-02-15,9822
2736,富野,12,4,8,元大-土城學府,2023-02-15,9822
3207,耀勝,11,3,8,元大-土城學府,2023-02-15,9822
3324,雙鴻,10,2,8,元大-土城學府,2023-02-15,9822
4919,新唐,16,8,8,元大-土城學府,2023-02-15,9822
2330,台積電,16,9,7,元大-土城學府,2023-02-15,9822
2891,中信金,7,0,7,元大-土城學府,2023-02-15,9822
4953,緯軟,10,3,7,元大-土城學府,2023-02-15,9822
3221,台嘉碩,9,3,6,元大-土城學府,2023-02-15,9822
3264,欣銓,9,3,6,元大-土城學府,2023-02-15,9822
2618,長榮航,7,1,6,元大-土城學府,2023-02-15,9822
2303,聯電,9,3,6,元大-土城學府,2023-02-15,9822
00637L,元大滬深300正2,30,24,6,元大-土城學府,2023-02-15,9822
1258,其祥-KY,6,0,6,元大-土城學府,2023-02-15,9822
1612,宏泰,6,0,6,元大-土城學府,2023-02-15,9822
2033,佳大,6,0,6,元大-土城學府,2023-02-15,9822
00632R,元大台灣50反1,566,5,561,元大-土城學府,2023-02-16,9822
6116,彩晶,216,15,201,元大-土城學府,2023-02-16,9822
2329,華泰,80,0,80,元大-土城學府,2023-02-16,9822
00878,國泰永續高股息,96,38,58,元大-土城學府,2023-02-16,9822
1809,中釉,57,0,57,元大-土城學府,2023-02-16,9822
2031,新光鋼,51,0,51,元大-土城學府,2023-02-16,9822
2038,海光,50,0,50,元大-土城學府,2023-02-16,9822
2023,燁輝,50,3,47,元大-土城學府,2023-02-16,9822
2471,資通,65,18,47,元大-土城學府,2023-02-16,9822
2492,華新科,46,1,45,元大-土城學府,2023-02-16,9822
00679B,元大美債20年,37,1,36,元大-土城學府,2023-02-16,9822
6605,帝寶,35,0,35,元大-土城學府,2023-02-16,9822
8289,泰藝,25,0,25,元大-土城學府,2023-02-16,9822
8358,金居,29,9,20,元大-土城學府,2023-02-16,9822
00673R,期元大S＆P原油反1,18,0,18,元大-土城學府,2023-02-16,9822
2615,萬海,29,12,17,元大-土城學府,2023-02-16,9822
00772B,中信高評級公司債,14,0,14,元大-土城學府,2023-02-16,9822
1611,中電,15,1,14,元大-土城學府,2023-02-16,9822
6128,上福,14,0,14,元大-土城學府,2023-02-16,9822
6217,中探針,13,0,13,元大-土城學府,2023-02-16,9822
1503,士電,12,0,12,元大-土城學府,2023-02-16,9822
00795B,中信美國公債20年,10,0,10,元大-土城學府,2023-02-16,9822
00893,國泰智能電動車,17,7,10,元大-土城學府,2023-02-16,9822
2929,淘帝-KY,10,0,10,元大-土城學府,2023-02-16,9822
3264,欣銓,10,0,10,元大-土城學府,2023-02-16,9822
1513,中興電,24,15,9,元大-土城學府,2023-02-16,9822
4960,誠美材,17,8,9,元大-土城學府,2023-02-16,9822
6138,茂達,10,1,9,元大-土城學府,2023-02-16,9822
6806,森崴能源,12,3,9,元大-土城學府,2023-02-16,9822
00751B,元大AAA至A公司債,8,0,8,元大-土城學府,2023-02-16,9822
9945,潤泰新,10,2,8,元大-土城學府,2023-02-16,9822
2393,億光,9,1,8,元大-土城學府,2023-02-16,9822
00900,富邦特選高股息30,7,0,7,元大-土城學府,2023-02-16,9822
3221,台嘉碩,7,0,7,元大-土城學府,2023-02-16,9822
2399,映泰,6,0,6,元大-土城學府,2023-02-16,9822
8171,天宇,7,1,6,元大-土城學府,2023-02-16,9822
00882,中信中國高股息,5,0,5,元大-土城學府,2023-02-16,9822
2753,八方雲集,5,0,5,元大-土城學府,2023-02-16,9822
2834,臺企銀,6,1,5,元大-土城學府,2023-02-16,9822
3522,御嵿,5,0,5,元大-土城學府,2023-02-16,9822
3536,誠創,5,0,5,元大-土城學府,2023-02-16,9822
4155,訊映,5,0,5,元大-土城學府,2023-02-16,9822
4192,杏國,5,0,5,元大-土城學府,2023-02-16,9822
6186,新潤,5,0,5,元大-土城學府,2023-02-16,9822
6266,泰詠,8,3,5,元大-土城學府,2023-02-16,9822
9904,寶成,5,0,5,元大-土城學府,2023-02-16,9822
2002,中鋼,4,0,4,元大-土城學府,2023-02-16,9822
6547,高端疫苗,4,0,4,元大-土城學府,2023-02-16,9822
1810,和成,6,2,4,元大-土城學府,2023-02-16,9822
2201,裕隆,35,31,4,元大-土城學府,2023-02-16,9822
00878,國泰永續高股息,103,23,80,元大-土城學府,2023-02-17,9822
2618,長榮航,77,8,69,元大-土城學府,2023-02-17,9822
5425,台半,83,28,55,元大-土城學府,2023-02-17,9822
00893,國泰智能電動車,31,0,31,元大-土城學府,2023-02-17,9822
00772B,中信高評級公司債,29,0,29,元大-土城學府,2023-02-17,9822
1809,中釉,28,0,28,元大-土城學府,2023-02-17,9822
2367,燿華,30,2,28,元大-土城學府,2023-02-17,9822
1752,南光,30,3,27,元大-土城學府,2023-02-17,9822
3260,威剛,23,4,19,元大-土城學府,2023-02-17,9822
00905,FT臺灣Smart,18,0,18,元大-土城學府,2023-02-17,9822
00679B,元大美債20年,46,30,16,元大-土城學府,2023-02-17,9822
6128,上福,16,0,16,元大-土城學府,2023-02-17,9822
3093,港建*,15,0,15,元大-土城學府,2023-02-17,9822
1432,大魯閣,14,0,14,元大-土城學府,2023-02-17,9822
2399,映泰,16,3,13,元大-土城學府,2023-02-17,9822
6547,高端疫苗,20,8,12,元大-土城學府,2023-02-17,9822
3013,晟銘電,12,0,12,元大-土城學府,2023-02-17,9822
4760,勤凱,12,0,12,元大-土城學府,2023-02-17,9822
6235,華孚,29,17,12,元大-土城學府,2023-02-17,9822
2330,台積電,14,3,11,元大-土城學府,2023-02-17,9822
2615,萬海,12,2,10,元大-土城學府,2023-02-17,9822
1789,神隆,10,0,10,元大-土城學府,2023-02-17,9822
4919,新唐,18,8,10,元大-土城學府,2023-02-17,9822
5475,德宏,10,0,10,元大-土城學府,2023-02-17,9822
6005,群益證,10,0,10,元大-土城學府,2023-02-17,9822
6605,帝寶,10,0,10,元大-土城學府,2023-02-17,9822
00751B,元大AAA至A公司債,9,0,9,元大-土城學府,2023-02-17,9822
3357,臺慶科,12,3,9,元大-土城學府,2023-02-17,9822
3552,同致,10,1,9,元大-土城學府,2023-02-17,9822
2885,元大金,9,0,9,元大-土城學府,2023-02-17,9822
1258,其祥-KY,8,0,8,元大-土城學府,2023-02-17,9822
00670L,富邦NASDAQ正2,8,0,8,元大-土城學府,2023-02-17,9822
2031,新光鋼,8,0,8,元大-土城學府,2023-02-17,9822
5276,達輝-KY,8,0,8,元大-土城學府,2023-02-17,9822
2413,環科,7,0,7,元大-土城學府,2023-02-17,9822
6443,元晶,16,9,7,元大-土城學府,2023-02-17,9822
00902,中信電池及儲能,16,10,6,元大-土城學府,2023-02-17,9822
00900,富邦特選高股息30,11,5,6,元大-土城學府,2023-02-17,9822
1504,東元,6,0,6,元大-土城學府,2023-02-17,9822
1701,中化,6,0,6,元大-土城學府,2023-02-17,9822
2705,六福,9,3,6,元大-土城學府,2023-02-17,9822
3231,緯創,6,0,6,元大-土城學府,2023-02-17,9822
3617,碩天,9,3,6,元大-土城學府,2023-02-17,9822
3704,合勤控,6,0,6,元大-土城學府,2023-02-17,9822
4106,雃博,6,0,6,元大-土城學府,2023-02-17,9822
4538,大詠城,8,2,6,元大-土城學府,2023-02-17,9822
2706,第一店,5,0,5,元大-土城學府,2023-02-17,9822
01009T,王道圓滿R1,5,0,5,元大-土城學府,2023-02-17,9822
00720B,元大投資級公司債,5,0,5,元大-土城學府,2023-02-17,9822
2344,華邦電,12,7,5,元大-土城學府,2023-02-17,9822
2023,燁輝,102,4,98,元大-土城學府,2023-02-20,9822
1718,中纖,50,0,50,元大-土城學府,2023-02-20,9822
00632R,元大台灣50反1,50,9,41,元大-土城學府,2023-02-20,9822
2610,華航,234,194,40,元大-土城學府,2023-02-20,9822
5521,工信,58,20,38,元大-土城學府,2023-02-20,9822
00902,中信電池及儲能,43,5,38,元大-土城學府,2023-02-20,9822
3617,碩天,35,1,34,元大-土城學府,2023-02-20,9822
1605,華新,85,53,32,元大-土城學府,2023-02-20,9822
4961,天鈺,49,19,30,元大-土城學府,2023-02-20,9822
8358,金居,31,2,29,元大-土城學府,2023-02-20,9822
1809,中釉,30,1,29,元大-土城學府,2023-02-20,9822
1513,中興電,65,38,27,元大-土城學府,2023-02-20,9822
3027,盛達,32,7,25,元大-土城學府,2023-02-20,9822
5701,劍湖山,21,0,21,元大-土城學府,2023-02-20,9822
5512,力麒,25,6,19,元大-土城學府,2023-02-20,9822
6123,上奇,17,0,17,元大-土城學府,2023-02-20,9822
1712,興農,16,0,16,元大-土城學府,2023-02-20,9822
6672,騰輝電子-KY,16,0,16,元大-土城學府,2023-02-20,9822
00885,富邦越南,15,0,15,元大-土城學府,2023-02-20,9822
8289,泰藝,15,0,15,元大-土城學府,2023-02-20,9822
4163,鐿鈦,14,0,14,元大-土城學府,2023-02-20,9822
6128,上福,14,0,14,元大-土城學府,2023-02-20,9822
1503,士電,39,26,13,元大-土城學府,2023-02-20,9822
3682,亞太電,13,0,13,元大-土城學府,2023-02-20,9822
2358,廷鑫,13,0,13,元大-土城學府,2023-02-20,9822
8028,昇陽半導體,13,0,13,元大-土城學府,2023-02-20,9822
3035,智原,14,2,12,元大-土城學府,2023-02-20,9822
00878,國泰永續高股息,20,8,12,元大-土城學府,2023-02-20,9822
4726,永昕,12,0,12,元大-土城學府,2023-02-20,9822
2883,凱基金,14,2,12,元大-土城學府,2023-02-20,9822
9904,寶成,11,0,11,元大-土城學府,2023-02-20,9822
0056,元大高股息,14,3,11,元大-土城學府,2023-02-20,9822
2031,新光鋼,10,0,10,元大-土城學府,2023-02-20,9822
2867,三商壽,10,0,10,元大-土城學府,2023-02-20,9822
4536,拓凱,11,1,10,元大-土城學府,2023-02-20,9822
6589,台康生技,12,2,10,元大-土城學府,2023-02-20,9822
00893,國泰智能電動車,19,10,9,元大-土城學府,2023-02-20,9822
1909,榮成,9,0,9,元大-土城學府,2023-02-20,9822
4402,郡都開發,9,0,9,元大-土城學府,2023-02-20,9822
6285,啟��,9,0,9,元大-土城學府,2023-02-20,9822
8390,金益鼎,9,0,9,元大-土城學府,2023-02-20,9822
6443,元晶,9,1,8,元大-土城學府,2023-02-20,9822
2324,仁寶,10,2,8,元大-土城學府,2023-02-20,9822
2906,高林,16,8,8,元大-土城學府,2023-02-20,9822
4960,誠美材,45,37,8,元大-土城學府,2023-02-20,9822
2330,台積電,11,3,8,元大-土城學府,2023-02-20,9822
6244,茂迪,7,0,7,元大-土城學府,2023-02-20,9822
3264,欣銓,7,0,7,元大-土城學府,2023-02-20,9822
2615,萬海,25,18,7,元大-土城學府,2023-02-20,9822
3022,威強電,7,0,7,元大-土城學府,2023-02-20,9822
8105,凌巨,352,4,348,元大-土城學府,2023-02-21,9822
3481,群創,117,10,107,元大-土城學府,2023-02-21,9822
1101,台泥,93,5,88,元大-土城學府,2023-02-21,9822
2030,彰源,50,4,46,元大-土城學府,2023-02-21,9822
5258,虹堡,38,5,33,元大-土城學府,2023-02-21,9822
00632R,元大台灣50反1,26,0,26,元大-土城學府,2023-02-21,9822
2367,燿華,27,2,25,元大-土城學府,2023-02-21,9822
4960,誠美材,20,0,20,元大-土城學府,2023-02-21,9822
00706L,期元大S＆P日圓正2,20,0,20,元大-土城學府,2023-02-21,9822
8433,弘帆,20,0,20,元大-土城學府,2023-02-21,9822
3049,精金,20,1,19,元大-土城學府,2023-02-21,9822
4968,立積,20,2,18,元大-土城學府,2023-02-21,9822
3673,TPK-KY,17,0,17,元大-土城學府,2023-02-21,9822
2330,台積電,20,3,17,元大-土城學府,2023-02-21,9822
4904,遠傳,15,0,15,元大-土城學府,2023-02-21,9822
6285,啟��,15,0,15,元大-土城學府,2023-02-21,9822
6509,聚和,30,15,15,元大-土城學府,2023-02-21,9822
1108,幸福,14,0,14,元大-土城學府,2023-02-21,9822
00637L,元大滬深300正2,19,6,13,元大-土城學府,2023-02-21,9822
00633L,富邦上証正2,13,0,13,元大-土城學府,2023-02-21,9822
1513,中興電,45,32,13,元大-土城學府,2023-02-21,9822
3557,嘉威,12,0,12,元大-土城學府,2023-02-21,9822
5521,工信,32,20,12,元大-土城學府,2023-02-21,9822
6266,泰詠,21,9,12,元大-土城學府,2023-02-21,9822
2634,漢翔,15,4,11,元大-土城學府,2023-02-21,9822
00679B,元大美債20年,10,0,10,元大-土城學府,2023-02-21,9822
8054,安國,12,2,10,元大-土城學府,2023-02-21,9822
1463,強盛新,10,0,10,元大-土城學府,2023-02-21,9822
2104,國際中橡,10,0,10,元大-土城學府,2023-02-21,9822
2461,光群雷,10,0,10,元大-土城學府,2023-02-21,9822
4536,拓凱,11,1,10,元大-土城學府,2023-02-21,9822
5701,劍湖山,10,0,10,元大-土城學府,2023-02-21,9822
6767,台微醫,10,0,10,元大-土城學府,2023-02-21,9822
1712,興農,10,0,10,元大-土城學府,2023-02-21,9822
5871,中租-KY,9,0,9,元大-土城學府,2023-02-21,9822
3491,昇達科,10,1,9,元大-土城學府,2023-02-21,9822
1321,大洋,8,0,8,元大-土城學府,2023-02-21,9822
2888,新光金,8,0,8,元大-土城學府,2023-02-21,9822
6697,東捷資訊,8,0,8,元大-土城學府,2023-02-21,9822
1529,樂事綠能,7,0,7,元大-土城學府,2023-02-21,9822
2358,廷鑫,7,0,7,元大-土城學府,2023-02-21,9822
6547,高端疫苗,7,0,7,元大-土城學府,2023-02-21,9822
4961,天鈺,24,18,6,元大-土城學府,2023-02-21,9822
2486,一詮,7,1,6,元大-土城學府,2023-02-21,9822
00712,復華富時不動產,6,0,6,元大-土城學府,2023-02-21,9822
00725B,國泰投資級公司債,6,0,6,元大-土城學府,2023-02-21,9822
00882,中信中國高股息,12,6,6,元大-土城學府,2023-02-21,9822
2471,資通,6,0,6,元大-土城學府,2023-02-21,9822
4952,凌通,6,0,6,元大-土城學府,2023-02-21,9822
6288,聯嘉,13,7,6,元大-土城學府,2023-02-21,9822
2634,漢翔,306,0,306,元大-土城學府,2023-02-22,9822
2379,瑞昱,95,0,95,元大-土城學府,2023-02-22,9822
00878,國泰永續高股息,94,3,91,元大-土城學府,2023-02-22,9822
8105,凌巨,83,1,82,元大-土城學府,2023-02-22,9822
1513,中興電,67,17,50,元大-土城學府,2023-02-22,9822
5425,台半,63,16,47,元大-土城學府,2023-02-22,9822
6509,聚和,44,0,44,元大-土城學府,2023-02-22,9822
0056,元大高股息,36,4,32,元大-土城學府,2023-02-22,9822
5009,榮剛,33,6,27,元大-土城學府,2023-02-22,9822
00671R,富邦NASDAQ反1,30,4,26,元大-土城學府,2023-02-22,9822
2498,宏達電,26,0,26,元大-土城學府,2023-02-22,9822
2031,新光鋼,24,0,24,元大-土城學府,2023-02-22,9822
00632R,元大台灣50反1,40,17,23,元大-土城學府,2023-02-22,9822
3029,零壹,23,5,18,元大-土城學府,2023-02-22,9822
4979,華星光,16,0,16,元大-土城學府,2023-02-22,9822
8478,東哥遊艇,30,14,16,元大-土城學府,2023-02-22,9822
1519,華城,37,22,15,元大-土城學府,2023-02-22,9822
1326,台化,14,0,14,元大-土城學府,2023-02-22,9822
2929,淘帝-KY,13,0,13,元大-土城學府,2023-02-22,9822
3037,欣興,16,4,12,元大-土城學府,2023-02-22,9822
5452,佶優,12,0,12,元大-土城學府,2023-02-22,9822
6109,亞元,12,0,12,元大-土城學府,2023-02-22,9822
6691,洋基工程,12,0,12,元大-土城學府,2023-02-22,9822
00706L,期元大S＆P日圓正2,10,0,10,元大-土城學府,2023-02-22,9822
2515,中工,10,0,10,元大-土城學府,2023-02-22,9822
2534,宏盛,10,0,10,元大-土城學府,2023-02-22,9822
3122,笙泉,10,0,10,元大-土城學府,2023-02-22,9822
6202,盛群,10,0,10,元大-土城學府,2023-02-22,9822
4919,新唐,15,5,10,元大-土城學府,2023-02-22,9822
00902,中信電池及儲能,9,0,9,元大-土城學府,2023-02-22,9822
00900,富邦特選高股息30,10,1,9,元大-土城學府,2023-02-22,9822
2882,國泰金,9,0,9,元大-土城學府,2023-02-22,9822
5706,鳳凰,12,3,9,元大-土城學府,2023-02-22,9822
2330,台積電,12,3,9,元大-土城學府,2023-02-22,9822
1712,興農,8,0,8,元大-土城學府,2023-02-22,9822
3617,碩天,9,1,8,元大-土城學府,2023-02-22,9822
6148,驊宏資,8,0,8,元大-土城學府,2023-02-22,9822
8033,雷虎,18,10,8,元大-土城學府,2023-02-22,9822
8054,安國,10,2,8,元大-土城學府,2023-02-22,9822
00893,國泰智能電動車,12,4,8,元大-土城學府,2023-02-22,9822
3504,揚明光,11,4,7,元大-土城學府,2023-02-22,9822
4561,健椿,7,0,7,元大-土城學府,2023-02-22,9822
6197,佳必琪,7,0,7,元大-土城學府,2023-02-22,9822
3293,鈊象,7,1,6,元大-土城學府,2023-02-22,9822
0050,元大台灣50,6,0,6,元大-土城學府,2023-02-22,9822
5272,笙科,6,0,6,元大-土城學府,2023-02-22,9822
2303,聯電,12,6,6,元大-土城學府,2023-02-22,9822
2328,廣宇,6,0,6,元大-土城學府,2023-02-22,9822
4977,眾達-KY,9,3,6,元大-土城學府,2023-02-22,9822
5403,中菲,6,0,6,元大-土城學府,2023-02-22,9822
00632R,元大台灣50反1,456,0,456,元大-土城學府,2023-02-23,9822
2344,華邦電,103,0,103,元大-土城學府,2023-02-23,9822
2023,燁輝,101,0,101,元大-土城學府,2023-02-23,9822
2313,華通,68,0,68,元大-土城學府,2023-02-23,9822
4919,新唐,75,32,43,元大-土城學府,2023-02-23,9822
1519,華城,37,6,31,元大-土城學府,2023-02-23,9822
00715L,期街口布蘭特正2,49,20,29,元大-土城學府,2023-02-23,9822
1444,力麗,40,14,26,元大-土城學府,2023-02-23,9822
8936,國統,35,10,25,元大-土城學府,2023-02-23,9822
6116,彩晶,21,0,21,元大-土城學府,2023-02-23,9822
4536,拓凱,21,0,21,元大-土城學府,2023-02-23,9822
5905,南仁湖,28,7,21,元大-土城學府,2023-02-23,9822
9904,寶成,21,0,21,元大-土城學府,2023-02-23,9822
2006,東和鋼鐵,20,0,20,元大-土城學府,2023-02-23,9822
00671R,富邦NASDAQ反1,20,0,20,元大-土城學府,2023-02-23,9822
6548,長科*,20,0,20,元大-土城學府,2023-02-23,9822
00720B,元大投資級公司債,18,0,18,元大-土城學府,2023-02-23,9822
1513,中興電,39,22,17,元大-土城學府,2023-02-23,9822
5512,力麒,24,7,17,元大-土城學府,2023-02-23,9822
2705,六福,15,0,15,元大-土城學府,2023-02-23,9822
00878,國泰永續高股息,29,14,15,元大-土城學府,2023-02-23,9822
6509,聚和,15,1,14,元大-土城學府,2023-02-23,9822
6770,力積電,16,2,14,元大-土城學府,2023-02-23,9822
0056,元大高股息,15,1,14,元大-土城學府,2023-02-23,9822
00773B,中信優先金融債,13,0,13,元大-土城學府,2023-02-23,9822
00780B,國泰A級金融債,13,0,13,元大-土城學府,2023-02-23,9822
2329,華泰,17,4,13,元大-土城學府,2023-02-23,9822
2734,易飛網,21,8,13,元大-土城學府,2023-02-23,9822
4513,福裕,13,0,13,元大-土城學府,2023-02-23,9822
2618,長榮航,19,7,12,元大-土城學府,2023-02-23,9822
00664R,國泰臺灣加權反1,12,0,12,元大-土城學府,2023-02-23,9822
00851,台新全球AI,12,0,12,元大-土城學府,2023-02-23,9822
2352,佳世達,12,0,12,元大-土城學府,2023-02-23,9822
5452,佶優,14,2,12,元大-土城學府,2023-02-23,9822
9945,潤泰新,12,0,12,元大-土城學府,2023-02-23,9822
00753L,中信中國50正2,11,0,11,元大-土城學府,2023-02-23,9822
2413,環科,12,1,11,元大-土城學府,2023-02-23,9822
3094,聯傑,20,9,11,元大-土城學府,2023-02-23,9822
3714,富采,15,4,11,元大-土城學府,2023-02-23,9822
4162,智擎,11,0,11,元大-土城學府,2023-02-23,9822
00633L,富邦上証正2,10,0,10,元大-土城學府,2023-02-23,9822
1463,強盛新,10,0,10,元大-土城學府,2023-02-23,9822
1524,耿鼎,10,0,10,元大-土城學府,2023-02-23,9822
2537,聯上發,10,0,10,元大-土城學府,2023-02-23,9822
5907,大洋-KY,10,0,10,元大-土城學府,2023-02-23,9822
2748,雲品,23,14,9,元大-土城學府,2023-02-23,9822
2399,映泰,10,1,9,元大-土城學府,2023-02-23,9822
2834,臺企銀,11,2,9,元大-土城學府,2023-02-23,9822
3058,立德,10,1,9,元大-土城學府,2023-02-23,9822
5210,寶碩,10,1,9,元大-土城學府,2023-02-23,9822
0056,元大高股息,107,10,97,元大-土城學府,2023-02-24,9822
2401,凌陽,60,0,60,元大-土城學府,2023-02-24,9822
2480,敦陽科,58,1,57,元大-土城學府,2023-02-24,9822
6670,復盛應用,41,0,41,元大-土城學府,2023-02-24,9822
2641,正德,57,18,39,元大-土城學府,2023-02-24,9822
8261,富鼎,37,0,37,元大-土城學府,2023-02-24,9822
1513,中興電,41,10,31,元大-土城學府,2023-02-24,9822
4167,松瑞藥,30,0,30,元大-土城學府,2023-02-24,9822
1605,華新,32,3,29,元大-土城學府,2023-02-24,9822
2453,凌群,30,1,29,元大-土城學府,2023-02-24,9822
6282,康舒,30,1,29,元大-土城學府,2023-02-24,9822
2618,長榮航,29,3,26,元大-土城學府,2023-02-24,9822
00637L,元大滬深300正2,27,1,26,元大-土城學府,2023-02-24,9822
00878,國泰永續高股息,33,11,22,元大-土城學府,2023-02-24,9822
2457,飛宏,27,5,22,元大-土城學府,2023-02-24,9822
3033,威健,20,0,20,元大-土城學府,2023-02-24,9822
2498,宏達電,26,7,19,元大-土城學府,2023-02-24,9822
00902,中信電池及儲能,19,0,19,元大-土城學府,2023-02-24,9822
2344,華邦電,21,3,18,元大-土城學府,2023-02-24,9822
5483,中美晶,18,0,18,元大-土城學府,2023-02-24,9822
2477,美隆電,16,0,16,元大-土城學府,2023-02-24,9822
6188,廣明,15,0,15,元大-土城學府,2023-02-24,9822
5258,虹堡,35,21,14,元大-土城學府,2023-02-24,9822
6443,元晶,14,0,14,元大-土城學府,2023-02-24,9822
00882,中信中國高股息,14,1,13,元大-土城學府,2023-02-24,9822
6026,福邦證,13,0,13,元大-土城學府,2023-02-24,9822
2243,宏旭-KY,13,0,13,元大-土城學府,2023-02-24,9822
2359,所羅門,13,0,13,元大-土城學府,2023-02-24,9822
3037,欣興,31,19,12,元大-土城學府,2023-02-24,9822
2379,瑞昱,12,0,12,元大-土城學府,2023-02-24,9822
3628,盈正,13,1,12,元大-土城學府,2023-02-24,9822
8938,明安,17,5,12,元大-土城學府,2023-02-24,9822
2383,台光電,12,1,11,元大-土城學府,2023-02-24,9822
8478,東哥遊艇,17,6,11,元大-土城學府,2023-02-24,9822
4968,立積,11,1,10,元大-土城學府,2023-02-24,9822
1701,中化,10,0,10,元大-土城學府,2023-02-24,9822
2363,矽統,10,0,10,元大-土城學府,2023-02-24,9822
2916,滿心,10,0,10,元大-土城學府,2023-02-24,9822
6192,巨路,10,0,10,元大-土城學府,2023-02-24,9822
2606,裕民,28,19,9,元大-土城學府,2023-02-24,9822
2881,富邦金,9,0,9,元大-土城學府,2023-02-24,9822
3163,波若威,12,3,9,元大-土城學府,2023-02-24,9822
5009,榮剛,14,6,8,元大-土城學府,2023-02-24,9822
2014,中鴻,10,2,8,元大-土城學府,2023-02-24,9822
5403,中菲,8,0,8,元大-土城學府,2023-02-24,9822
5608,四維航,32,24,8,元大-土城學府,2023-02-24,9822
2885,元大金,7,0,7,元大-土城學府,2023-02-24,9822
2360,致茂,7,0,7,元大-土城學府,2023-02-24,9822
4130,健亞,7,0,7,元大-土城學府,2023-02-24,9822
2337,旺宏,7,0,7,元大-土城學府,2023-02-24,9822
00632R,元大台灣50反1,400,34,366,元大-土城學府,2023-03-01,9822
00878,國泰永續高股息,149,4,145,元大-土城學府,2023-03-01,9822
1605,華新,147,61,86,元大-土城學府,2023-03-01,9822
2641,正德,114,52,62,元大-土城學府,2023-03-01,9822
2601,益航,68,28,40,元大-土城學府,2023-03-01,9822
6570,維田,34,1,33,元大-土城學府,2023-03-01,9822
2206,三陽工業,31,0,31,元大-土城學府,2023-03-01,9822
2002,中鋼,32,2,30,元大-土城學府,2023-03-01,9822
2755,揚秦,29,0,29,元大-土城學府,2023-03-01,9822
6192,巨路,29,0,29,元大-土城學府,2023-03-01,9822
6697,東捷資訊,33,4,29,元大-土城學府,2023-03-01,9822
1101,台泥,39,10,29,元大-土城學府,2023-03-01,9822
1513,中興電,41,13,28,元大-土城學府,2023-03-01,9822
3005,神基,31,6,25,元大-土城學府,2023-03-01,9822
9945,潤泰新,23,0,23,元大-土城學府,2023-03-01,9822
6116,彩晶,22,0,22,元大-土城學府,2023-03-01,9822
5009,榮剛,40,19,21,元大-土城學府,2023-03-01,9822
00706L,期元大S＆P日圓正2,20,0,20,元大-土城學府,2023-03-01,9822
4167,松瑞藥,20,0,20,元大-土城學府,2023-03-01,9822
2885,元大金,21,2,19,元大-土城學府,2023-03-01,9822
2610,華航,24,9,15,元大-土城學府,2023-03-01,9822
00751B,元大AAA至A公司債,15,0,15,元大-土城學府,2023-03-01,9822
00772B,中信高評級公司債,15,0,15,元大-土城學府,2023-03-01,9822
1258,其祥-KY,28,13,15,元大-土城學府,2023-03-01,9822
3714,富采,15,0,15,元大-土城學府,2023-03-01,9822
1321,大洋,14,0,14,元大-土城學府,2023-03-01,9822
2884,玉山金,14,0,14,元大-土城學府,2023-03-01,9822
8927,北基,15,1,14,元大-土城學府,2023-03-01,9822
2352,佳世達,15,2,13,元大-土城學府,2023-03-01,9822
2637,慧洋-KY,21,8,13,元大-土城學府,2023-03-01,9822
00687B,國泰20年美債,12,0,12,元大-土城學府,2023-03-01,9822
00857B,永豐20年美公債,12,0,12,元大-土城學府,2023-03-01,9822
1220,台榮,12,0,12,元大-土城學府,2023-03-01,9822
2344,華邦電,16,4,12,元大-土城學府,2023-03-01,9822
2388,威盛,55,43,12,元大-土城學府,2023-03-01,9822
3673,TPK-KY,12,0,12,元大-土城學府,2023-03-01,9822
4114,健喬,13,1,12,元大-土城學府,2023-03-01,9822
2014,中鴻,29,18,11,元大-土城學府,2023-03-01,9822
2618,長榮航,18,7,11,元大-土城學府,2023-03-01,9822
1718,中纖,11,0,11,元大-土城學府,2023-03-01,9822
2606,裕民,29,19,10,元大-土城學府,2023-03-01,9822
1447,力鵬,10,0,10,元大-土城學府,2023-03-01,9822
1717,長興,10,0,10,元大-土城學府,2023-03-01,9822
1810,和成,13,3,10,元大-土城學府,2023-03-01,9822
2027,大成鋼,10,0,10,元大-土城學府,2023-03-01,9822
2633,台灣高鐵,10,0,10,元大-土城學府,2023-03-01,9822
3704,合勤控,11,1,10,元大-土城學府,2023-03-01,9822
2881,富邦金,9,0,9,元大-土城學府,2023-03-01,9822
1708,東鹼,9,0,9,元大-土城學府,2023-03-01,9822
2105,正新,9,0,9,元大-土城學府,2023-03-01,9822
00878,國泰永續高股息,169,14,155,元大-土城學府,2023-03-02,9822
1101,台泥,122,3,119,元大-土城學府,2023-03-02,9822
1605,華新,93,11,82,元大-土城學府,2023-03-02,9822
2916,滿心,76,0,76,元大-土城學府,2023-03-02,9822
8105,凌巨,72,2,70,元大-土城學府,2023-03-02,9822
2498,宏達電,31,1,30,元大-土城學府,2023-03-02,9822
2610,華航,33,5,28,元大-土城學府,2023-03-02,9822
1513,中興電,49,23,26,元大-土城學府,2023-03-02,9822
00712,復華富時不動產,25,0,25,元大-土城學府,2023-03-02,9822
3710,連展投控,25,0,25,元大-土城學府,2023-03-02,9822
6192,巨路,25,0,25,元大-土城學府,2023-03-02,9822
2884,玉山金,23,0,23,元大-土城學府,2023-03-02,9822
6123,上奇,23,0,23,元大-土城學府,2023-03-02,9822
3029,零壹,20,1,19,元大-土城學府,2023-03-02,9822
2458,義隆,18,0,18,元大-土城學府,2023-03-02,9822
2892,第一金,16,0,16,元大-土城學府,2023-03-02,9822
2801,彰銀,20,4,16,元大-土城學府,2023-03-02,9822
2303,聯電,15,0,15,元大-土城學府,2023-03-02,9822
4155,訊映,15,0,15,元大-土城學府,2023-03-02,9822
5210,寶碩,15,0,15,元大-土城學府,2023-03-02,9822
00772B,中信高評級公司債,14,0,14,元大-土城學府,2023-03-02,9822
2002,中鋼,14,1,13,元大-土城學府,2023-03-02,9822
6161,捷波,13,0,13,元大-土城學府,2023-03-02,9822
2201,裕隆,20,7,13,元大-土城學府,2023-03-02,9822
6672,騰輝電子-KY,12,0,12,元大-土城學府,2023-03-02,9822
2208,台船,11,0,11,元大-土城學府,2023-03-02,9822
00633L,富邦上証正2,10,0,10,元大-土城學府,2023-03-02,9822
1463,強盛新,10,0,10,元大-土城學府,2023-03-02,9822
1709,和益,10,0,10,元大-土城學府,2023-03-02,9822
4960,誠美材,10,0,10,元大-土城學府,2023-03-02,9822
6733,博晟生醫,9,0,9,元大-土城學府,2023-03-02,9822
8473,山林水,9,0,9,元大-土城學府,2023-03-02,9822
2338,光罩,8,0,8,元大-土城學府,2023-03-02,9822
3447,展達,8,0,8,元大-土城學府,2023-03-02,9822
8097,常珵,8,0,8,元大-土城學府,2023-03-02,9822
8358,金居,8,0,8,元大-土城學府,2023-03-02,9822
1210,大成,13,6,7,元大-土城學府,2023-03-02,9822
2891,中信金,6,0,6,元大-土城學府,2023-03-02,9822
3545,敦泰,6,0,6,元大-土城學府,2023-03-02,9822
2353,宏��,6,0,6,元大-土城學府,2023-03-02,9822
2371,大同,6,0,6,元大-土城學府,2023-03-02,9822
2390,云辰,6,0,6,元大-土城學府,2023-03-02,9822
2755,揚秦,6,0,6,元大-土城學府,2023-03-02,9822
00679B,元大美債20年,5,0,5,元大-土城學府,2023-03-02,9822
1906,寶隆,5,0,5,元大-土城學府,2023-03-02,9822
2313,華通,6,1,5,元大-土城學府,2023-03-02,9822
2534,宏盛,10,5,5,元大-土城學府,2023-03-02,9822
6266,泰詠,5,0,5,元大-土城學府,2023-03-02,9822
2886,兆豐金,4,0,4,元大-土城學府,2023-03-02,9822
1215,卜蜂,4,0,4,元大-土城學府,2023-03-02,9822
5258,虹堡,326,41,285,元大-土城學府,2023-03-03,9822
3033,威健,51,0,51,元大-土城學府,2023-03-03,9822
2706,第一店,30,0,30,元大-土城學府,2023-03-03,9822
00712,復華富時不動產,23,0,23,元大-土城學府,2023-03-03,9822
1605,華新,25,4,21,元大-土城學府,2023-03-03,9822
1519,華城,22,2,20,元大-土城學府,2023-03-03,9822
2498,宏達電,23,3,20,元大-土城學府,2023-03-03,9822
6202,盛群,20,0,20,元大-土城學府,2023-03-03,9822
2834,臺企銀,18,0,18,元大-土城學府,2023-03-03,9822
3380,明泰,17,0,17,元大-土城學府,2023-03-03,9822
00900,富邦特選高股息30,20,3,17,元大-土城學府,2023-03-03,9822
2457,飛宏,72,56,16,元大-土城學府,2023-03-03,9822
6118,建達,16,1,15,元大-土城學府,2023-03-03,9822
2471,資通,29,15,14,元大-土城學府,2023-03-03,9822
6733,博晟生醫,14,0,14,元大-土城學府,2023-03-03,9822
2313,華通,11,0,11,元大-土城學府,2023-03-03,9822
00671R,富邦NASDAQ反1,10,0,10,元大-土城學府,2023-03-03,9822
1701,中化,11,1,10,元大-土城學府,2023-03-03,9822
1809,中釉,10,0,10,元大-土城學府,2023-03-03,9822
2049,上銀,10,0,10,元大-土城學府,2023-03-03,9822
2352,佳世達,10,0,10,元大-土城學府,2023-03-03,9822
2414,精技,10,0,10,元大-土城學府,2023-03-03,9822
4977,眾達-KY,14,4,10,元大-土城學府,2023-03-03,9822
5210,寶碩,10,0,10,元大-土城學府,2023-03-03,9822
6266,泰詠,12,2,10,元大-土城學府,2023-03-03,9822
8110,華東,10,0,10,元大-土城學府,2023-03-03,9822
8171,天宇,13,3,10,元大-土城學府,2023-03-03,9822
2441,超豐,9,0,9,元大-土城學府,2023-03-03,9822
2484,希華,9,0,9,元大-土城學府,2023-03-03,9822
4747,強生,11,2,9,元大-土城學府,2023-03-03,9822
6192,巨路,9,0,9,元大-土城學府,2023-03-03,9822
6176,瑞儀,15,6,9,元大-土城學府,2023-03-03,9822
8016,矽創,13,5,8,元大-土城學府,2023-03-03,9822
0056,元大高股息,12,4,8,元大-土城學府,2023-03-03,9822
5403,中菲,9,1,8,元大-土城學府,2023-03-03,9822
2208,台船,8,1,7,元大-土城學府,2023-03-03,9822
00673R,期元大S＆P原油反1,7,0,7,元大-土城學府,2023-03-03,9822
2748,雲品,15,8,7,元大-土城學府,2023-03-03,9822
5905,南仁湖,10,3,7,元大-土城學府,2023-03-03,9822
8921,沈氏,7,0,7,元大-土城學府,2023-03-03,9822
2230,泰茂,6,0,6,元大-土城學府,2023-03-03,9822
2359,所羅門,6,0,6,元大-土城學府,2023-03-03,9822
3141,晶宏,12,6,6,元大-土城學府,2023-03-03,9822
6167,久正,6,0,6,元大-土城學府,2023-03-03,9822
00679B,元大美債20年,5,0,5,元大-土城學府,2023-03-03,9822
3707,漢磊,17,12,5,元大-土城學府,2023-03-03,9822
00664R,國泰臺灣加權反1,5,0,5,元大-土城學府,2023-03-03,9822
1709,和益,5,0,5,元大-土城學府,2023-03-03,9822
1785,光洋科,5,0,5,元大-土城學府,2023-03-03,9822
2351,順德,6,1,5,元大-土城學府,2023-03-03,9822
3481,群創,367,183,184,元大-土城學府,2023-03-06,9822
2409,友達,208,104,104,元大-土城學府,2023-03-06,9822
1605,華新,131,27,104,元大-土城學府,2023-03-06,9822
00632R,元大台灣50反1,82,3,79,元大-土城學府,2023-03-06,9822
2344,華邦電,75,7,68,元大-土城學府,2023-03-06,9822
1447,力鵬,75,10,65,元大-土城學府,2023-03-06,9822
1314,中石化,50,0,50,元大-土城學府,2023-03-06,9822
2867,三商壽,47,0,47,元大-土城學府,2023-03-06,9822
2609,陽明,62,18,44,元大-土城學府,2023-03-06,9822
2313,華通,42,1,41,元大-土城學府,2023-03-06,9822
00673R,期元大S＆P原油反1,37,0,37,元大-土城學府,2023-03-06,9822
6175,立敦,37,0,37,元大-土城學府,2023-03-06,9822
3029,零壹,39,7,32,元大-土城學府,2023-03-06,9822
3013,晟銘電,24,3,21,元大-土城學府,2023-03-06,9822
2049,上銀,20,0,20,元大-土城學府,2023-03-06,9822
6589,台康生技,20,0,20,元大-土城學府,2023-03-06,9822
6605,帝寶,20,0,20,元大-土城學府,2023-03-06,9822
00878,國泰永續高股息,47,31,16,元大-土城學府,2023-03-06,9822
2201,裕隆,16,0,16,元大-土城學府,2023-03-06,9822
3673,TPK-KY,16,0,16,元大-土城學府,2023-03-06,9822
6517,保勝光學,18,2,16,元大-土城學府,2023-03-06,9822
1442,名軒,15,0,15,元大-土城學府,2023-03-06,9822
2457,飛宏,51,36,15,元大-土城學府,2023-03-06,9822
3432,台端,16,1,15,元大-土城學府,2023-03-06,9822
8927,北基,20,7,13,元大-土城學府,2023-03-06,9822
2363,矽統,12,0,12,元大-土城學府,2023-03-06,9822
8358,金居,12,0,12,元大-土城學府,2023-03-06,9822
00882,中信中國高股息,13,2,11,元大-土城學府,2023-03-06,9822
2429,銘旺科,11,0,11,元大-土城學府,2023-03-06,9822
2471,資通,11,0,11,元大-土城學府,2023-03-06,9822
4744,皇將,11,0,11,元大-土城學府,2023-03-06,9822
6140,訊達,12,1,11,元大-土城學府,2023-03-06,9822
6733,博晟生醫,11,0,11,元大-土城學府,2023-03-06,9822
2892,第一金,11,0,11,元大-土城學府,2023-03-06,9822
3033,威健,10,0,10,元大-土城學府,2023-03-06,9822
4129,聯合,10,0,10,元大-土城學府,2023-03-06,9822
00637L,元大滬深300正2,27,18,9,元大-土城學府,2023-03-06,9822
3056,富華新,10,1,9,元大-土城學府,2023-03-06,9822
1708,東鹼,8,0,8,元大-土城學府,2023-03-06,9822
2641,正德,12,4,8,元大-土城學府,2023-03-06,9822
8222,寶一,29,21,8,元大-土城學府,2023-03-06,9822
1220,台榮,9,2,7,元大-土城學府,2023-03-06,9822
2618,長榮航,9,2,7,元大-土城學府,2023-03-06,9822
8936,國統,10,3,7,元大-土城學府,2023-03-06,9822
1526,日馳,6,0,6,元大-土城學府,2023-03-06,9822
2637,慧洋-KY,12,6,6,元大-土城學府,2023-03-06,9822
3703,欣陸,6,0,6,元大-土城學府,2023-03-06,9822
5511,德昌,6,0,6,元大-土城學府,2023-03-06,9822
6282,康舒,24,18,6,元大-土城學府,2023-03-06,9822
8176,智捷,6,0,6,元大-土城學府,2023-03-06,9822
2615,萬海,249,18,231,元大-土城學府,2023-03-07,9822
3481,群創,106,2,104,元大-土城學府,2023-03-07,9822
5258,虹堡,70,13,57,元大-土城學府,2023-03-07,9822
2482,連宇,47,14,33,元大-土城學府,2023-03-07,9822
6175,立敦,30,0,30,元大-土城學府,2023-03-07,9822
6288,聯嘉,30,0,30,元大-土城學府,2023-03-07,9822
00673R,期元大S＆P原油反1,28,0,28,元大-土城學府,2023-03-07,9822
00878,國泰永續高股息,71,45,26,元大-土城學府,2023-03-07,9822
1609,大亞,75,53,22,元大-土城學府,2023-03-07,9822
1785,光洋科,20,0,20,元大-土城學府,2023-03-07,9822
3710,連展投控,21,2,19,元大-土城學府,2023-03-07,9822
6605,帝寶,18,0,18,元大-土城學府,2023-03-07,9822
1513,中興電,55,38,17,元大-土城學府,2023-03-07,9822
6509,聚和,18,2,16,元大-土城學府,2023-03-07,9822
8358,金居,14,0,14,元大-土城學府,2023-03-07,9822
6706,惠特,16,3,13,元大-土城學府,2023-03-07,9822
8171,天宇,12,0,12,元大-土城學府,2023-03-07,9822
1442,名軒,11,0,11,元大-土城學府,2023-03-07,9822
2108,南帝,11,0,11,元大-土城學府,2023-03-07,9822
3059,華晶科,11,0,11,元大-土城學府,2023-03-07,9822
4536,拓凱,11,0,11,元大-土城學府,2023-03-07,9822
6015,宏遠證,11,0,11,元大-土城學府,2023-03-07,9822
00706L,期元大S＆P日圓正2,10,0,10,元大-土城學府,2023-03-07,9822
2034,允強,10,0,10,元大-土城學府,2023-03-07,9822
2365,昆盈,10,0,10,元大-土城學府,2023-03-07,9822
2455,全新,10,0,10,元大-土城學府,2023-03-07,9822
2495,普安,10,0,10,元大-土城學府,2023-03-07,9822
5864,致和證,10,0,10,元大-土城學府,2023-03-07,9822
6432,今展科,10,0,10,元大-土城學府,2023-03-07,9822
6767,台微醫,10,0,10,元大-土城學府,2023-03-07,9822
2610,華航,15,5,10,元大-土城學府,2023-03-07,9822
2388,威盛,15,6,9,元大-土城學府,2023-03-07,9822
4960,誠美材,10,1,9,元大-土城學府,2023-03-07,9822
6231,系微,11,2,9,元大-土城學府,2023-03-07,9822
8937,合騏,9,0,9,元大-土城學府,2023-03-07,9822
1101,台泥,7,0,7,元大-土城學府,2023-03-07,9822
1503,士電,9,2,7,元大-土城學府,2023-03-07,9822
1760,寶齡富錦,8,1,7,元大-土城學府,2023-03-07,9822
3628,盈正,7,0,7,元大-土城學府,2023-03-07,9822
6235,華孚,54,47,7,元大-土城學府,2023-03-07,9822
6741,91APP*-KY,7,0,7,元大-土城學府,2023-03-07,9822
2723,美食-KY,8,2,6,元大-土城學府,2023-03-07,9822
2748,雲品,22,16,6,元大-土城學府,2023-03-07,9822
5315,光聯,6,0,6,元大-土城學府,2023-03-07,9822
6140,訊達,6,0,6,元大-土城學府,2023-03-07,9822
6143,振曜,6,0,6,元大-土城學府,2023-03-07,9822
00885,富邦越南,5,0,5,元大-土城學府,2023-03-07,9822
1718,中纖,5,0,5,元大-土城學府,2023-03-07,9822
1810,和成,5,0,5,元大-土城學府,2023-03-07,9822
3024,憶聲,5,0,5,元大-土城學府,2023-03-07,9822
00923,群益台ESG低碳50,141,0,141,元大-土城學府,2023-03-08,9822
4167,松瑞藥,62,0,62,元大-土城學府,2023-03-08,9822
1605,華新,221,180,41,元大-土城學府,2023-03-08,9822
2429,銘旺科,40,0,40,元大-土城學府,2023-03-08,9822
2317,鴻海,40,1,39,元大-土城學府,2023-03-08,9822
5425,台半,50,12,38,元大-土城學府,2023-03-08,9822
8111,立��,46,11,35,元大-土城學府,2023-03-08,9822
5009,榮剛,61,29,32,元大-土城學府,2023-03-08,9822
00637L,元大滬深300正2,44,15,29,元大-土城學府,2023-03-08,9822
3027,盛達,33,5,28,元大-土城學府,2023-03-08,9822
2615,萬海,26,1,25,元大-土城學府,2023-03-08,9822
00900,富邦特選高股息30,25,3,22,元大-土城學府,2023-03-08,9822
2379,瑞昱,22,0,22,元大-土城學府,2023-03-08,9822
2609,陽明,36,15,21,元大-土城學府,2023-03-08,9822
5498,凱崴,20,0,20,元大-土城學府,2023-03-08,9822
2449,京元電子,22,2,20,元大-土城學府,2023-03-08,9822
3518,柏騰,20,0,20,元大-土城學府,2023-03-08,9822
3013,晟銘電,24,5,19,元大-土城學府,2023-03-08,9822
3206,志豐,19,0,19,元大-土城學府,2023-03-08,9822
1513,中興電,49,30,19,元大-土城學府,2023-03-08,9822
1101,台泥,22,4,18,元大-土城學府,2023-03-08,9822
00712,復華富時不動產,18,0,18,元大-土城學府,2023-03-08,9822
1504,東元,19,1,18,元大-土城學府,2023-03-08,9822
2498,宏達電,20,2,18,元大-土城學府,2023-03-08,9822
6605,帝寶,18,0,18,元大-土城學府,2023-03-08,9822
0056,元大高股息,20,3,17,元大-土城學府,2023-03-08,9822
3042,晶技,21,4,17,元大-土城學府,2023-03-08,9822
9933,中鼎,16,1,15,元大-土城學府,2023-03-08,9822
1604,聲寶,15,0,15,元大-土城學府,2023-03-08,9822
3093,港建*,19,5,14,元大-土城學府,2023-03-08,9822
4536,拓凱,14,0,14,元大-土城學府,2023-03-08,9822
4934,太極,15,1,14,元大-土城學府,2023-03-08,9822
1326,台化,13,0,13,元大-土城學府,2023-03-08,9822
2031,新光鋼,13,0,13,元大-土城學府,2023-03-08,9822
6016,康和證,15,2,13,元大-土城學府,2023-03-08,9822
6223,旺矽,16,3,13,元大-土城學府,2023-03-08,9822
2201,裕隆,13,1,12,元大-土城學府,2023-03-08,9822
2486,一詮,18,7,11,元大-土城學府,2023-03-08,9822
6196,帆宣,11,0,11,元大-土城學府,2023-03-08,9822
6282,康舒,16,5,11,元大-土城學府,2023-03-08,9822
00882,中信中國高股息,11,1,10,元大-土城學府,2023-03-08,9822
6235,華孚,57,47,10,元大-土城學府,2023-03-08,9822
00673R,期元大S＆P原油反1,10,0,10,元大-土城學府,2023-03-08,9822
2548,華固,10,0,10,元大-土城學府,2023-03-08,9822
2834,臺企銀,11,1,10,元大-土城學府,2023-03-08,9822
3710,連展投控,10,0,10,元大-土城學府,2023-03-08,9822
5864,致和證,10,0,10,元大-土城學府,2023-03-08,9822
8383,千附,10,0,10,元大-土城學府,2023-03-08,9822
2606,裕民,9,0,9,元大-土城學府,2023-03-08,9822
3034,聯詠,9,0,9,元大-土城學府,2023-03-08,9822
1517,利奇,119,2,117,元大-土城學府,2023-03-09,9822
1513,中興電,92,15,77,元大-土城學府,2023-03-09,9822
6192,巨路,68,0,68,元大-土城學府,2023-03-09,9822
2537,聯上發,65,0,65,元大-土城學府,2023-03-09,9822
00878,國泰永續高股息,62,1,61,元大-土城學府,2023-03-09,9822
2641,正德,105,45,60,元大-土城學府,2023-03-09,9822
2429,銘旺科,51,0,51,元大-土城學府,2023-03-09,9822
8105,凌巨,50,0,50,元大-土城學府,2023-03-09,9822
6509,聚和,45,3,42,元大-土城學府,2023-03-09,9822
2317,鴻海,33,0,33,元大-土城學府,2023-03-09,9822
1101,台泥,30,0,30,元大-土城學府,2023-03-09,9822
2888,新光金,30,0,30,元大-土城學府,2023-03-09,9822
4167,松瑞藥,30,0,30,元大-土城學府,2023-03-09,9822
3046,建��,36,7,29,元大-土城學府,2023-03-09,9822
1701,中化,30,5,25,元大-土城學府,2023-03-09,9822
2892,第一金,22,0,22,元大-土城學府,2023-03-09,9822
3027,盛達,23,1,22,元大-土城學府,2023-03-09,9822
3432,台端,22,0,22,元大-土城學府,2023-03-09,9822
2801,彰銀,21,0,21,元大-土城學府,2023-03-09,9822
6233,旺玖,22,2,20,元大-土城學府,2023-03-09,9822
3209,全科,17,0,17,元大-土城學府,2023-03-09,9822
1516,川飛,17,0,17,元大-土城學府,2023-03-09,9822
6266,泰詠,18,1,17,元大-土城學府,2023-03-09,9822
1605,華新,29,13,16,元大-土城學府,2023-03-09,9822
2486,一詮,46,30,16,元大-土城學府,2023-03-09,9822
3029,零壹,36,20,16,元大-土城學府,2023-03-09,9822
8936,國統,22,6,16,元大-土城學府,2023-03-09,9822
8091,翔名,16,0,16,元大-土城學府,2023-03-09,9822
1442,名軒,15,0,15,元大-土城學府,2023-03-09,9822
6443,元晶,24,10,14,元大-土城學府,2023-03-09,9822
00632R,元大台灣50反1,19,6,13,元大-土城學府,2023-03-09,9822
2409,友達,14,1,13,元大-土城學府,2023-03-09,9822
2610,華航,82,69,13,元大-土城學府,2023-03-09,9822
6570,維田,13,0,13,元大-土城學府,2023-03-09,9822
6589,台康生技,14,1,13,元大-土城學府,2023-03-09,9822
00923,群益台ESG低碳50,12,0,12,元大-土城學府,2023-03-09,9822
3466,德晉,12,0,12,元大-土城學府,2023-03-09,9822
2883,凱基金,11,0,11,元大-土城學府,2023-03-09,9822
00715L,期街口布蘭特正2,11,0,11,元大-土城學府,2023-03-09,9822
2471,資通,12,1,11,元大-土城學府,2023-03-09,9822
2886,兆豐金,12,1,11,元大-土城學府,2023-03-09,9822
3552,同致,10,0,10,元大-土城學府,2023-03-09,9822
2515,中工,10,0,10,元大-土城學府,2023-03-09,9822
4934,太極,11,1,10,元大-土城學府,2023-03-09,9822
6202,盛群,10,0,10,元大-土城學府,2023-03-09,9822
6283,淳安,10,0,10,元大-土城學府,2023-03-09,9822
6288,聯嘉,11,1,10,元大-土城學府,2023-03-09,9822
9945,潤泰新,10,0,10,元大-土城學府,2023-03-09,9822
3035,智原,15,6,9,元大-土城學府,2023-03-09,9822
3266,昇陽,9,0,9,元大-土城學府,2023-03-09,9822
00878,國泰永續高股息,205,14,191,元大-土城學府,2023-03-10,9822
3481,群創,117,5,112,元大-土城學府,2023-03-10,9822
5521,工信,124,15,109,元大-土城學府,2023-03-10,9822
2609,陽明,361,275,86,元大-土城學府,2023-03-10,9822
6024,群益期,81,0,81,元大-土城學府,2023-03-10,9822
6192,巨路,63,0,63,元大-土城學府,2023-03-10,9822
2888,新光金,55,0,55,元大-土城學府,2023-03-10,9822
6605,帝寶,64,11,53,元大-土城學府,2023-03-10,9822
2611,志信,51,0,51,元大-土城學府,2023-03-10,9822
2498,宏達電,65,17,48,元大-土城學府,2023-03-10,9822
9105,泰金寶-DR,55,10,45,元大-土城學府,2023-03-10,9822
4934,太極,42,0,42,元大-土城學府,2023-03-10,9822
5258,虹堡,50,8,42,元大-土城學府,2023-03-10,9822
2618,長榮航,52,12,40,元大-土城學府,2023-03-10,9822
6443,元晶,36,2,34,元大-土城學府,2023-03-10,9822
2886,兆豐金,33,0,33,元大-土城學府,2023-03-10,9822
00712,復華富時不動產,34,5,29,元大-土城學府,2023-03-10,9822
2313,華通,32,3,29,元大-土城學府,2023-03-10,9822
3494,誠研,29,0,29,元大-土城學府,2023-03-10,9822
2801,彰銀,27,0,27,元大-土城學府,2023-03-10,9822
00713,元大台灣高息低波,27,0,27,元大-土城學府,2023-03-10,9822
8069,元太,30,4,26,元大-土城學府,2023-03-10,9822
2885,元大金,28,2,26,元大-土城學府,2023-03-10,9822
2481,強茂,26,1,25,元大-土城學府,2023-03-10,9822
1513,中興電,51,28,23,元大-土城學府,2023-03-10,9822
1101,台泥,23,0,23,元大-土城學府,2023-03-10,9822
1319,東陽,22,0,22,元大-土城學府,2023-03-10,9822
2453,凌群,60,38,22,元大-土城學府,2023-03-10,9822
4167,松瑞藥,22,0,22,元大-土城學府,2023-03-10,9822
1718,中纖,20,0,20,元大-土城學府,2023-03-10,9822
2208,台船,20,0,20,元大-土城學府,2023-03-10,9822
911868,同方友友-DR,19,0,19,元大-土城學府,2023-03-10,9822
3236,千如,18,0,18,元大-土城學府,2023-03-10,9822
6411,晶焱,18,0,18,元大-土城學府,2023-03-10,9822
2317,鴻海,25,8,17,元大-土城學府,2023-03-10,9822
3430,奇鈦科,17,0,17,元大-土城學府,2023-03-10,9822
2884,玉山金,15,0,15,元大-土城學府,2023-03-10,9822
1234,黑松,15,0,15,元大-土城學府,2023-03-10,9822
4130,健亞,28,13,15,元大-土城學府,2023-03-10,9822
6691,洋基工程,15,0,15,元大-土城學府,2023-03-10,9822
6116,彩晶,15,1,14,元大-土城學府,2023-03-10,9822
2014,中鴻,14,1,13,元大-土城學府,2023-03-10,9822
3029,零壹,17,4,13,元大-土城學府,2023-03-10,9822
4142,國光生,19,6,13,元大-土城學府,2023-03-10,9822
8937,合騏,13,0,13,元大-土城學府,2023-03-10,9822
2892,第一金,15,3,12,元大-土城學府,2023-03-10,9822
3037,欣興,16,4,12,元大-土城學府,2023-03-10,9822
00637L,元大滬深300正2,21,9,12,元大-土城學府,2023-03-10,9822
1449,佳和,12,0,12,元大-土城學府,2023-03-10,9822
1517,利奇,12,0,12,元大-土城學府,2023-03-10,9822
00878,國泰永續高股息,274,13,261,元大-土城學府,2023-03-13,9822
2603,長榮,133,16,117,元大-土城學府,2023-03-13,9822
1218,泰山,104,0,104,元大-土城學府,2023-03-13,9822
2023,燁輝,100,0,100,元大-土城學府,2023-03-13,9822
00676R,富邦臺灣加權反1,101,5,96,元大-土城學府,2023-03-13,9822
00885,富邦越南,55,0,55,元大-土城學府,2023-03-13,9822
2888,新光金,34,0,34,元大-土城學府,2023-03-13,9822
2457,飛宏,45,16,29,元大-土城學府,2023-03-13,9822
9105,泰金寶-DR,25,0,25,元大-土城學府,2023-03-13,9822
2885,元大金,24,0,24,元大-土城學府,2023-03-13,9822
6282,康舒,28,6,22,元大-土城學府,2023-03-13,9822
1708,東鹼,22,1,21,元大-土城學府,2023-03-13,9822
00712,復華富時不動產,21,0,21,元大-土城學府,2023-03-13,9822
00671R,富邦NASDAQ反1,50,30,20,元大-土城學府,2023-03-13,9822
00893,國泰智能電動車,23,3,20,元大-土城學府,2023-03-13,9822
2380,虹光,20,0,20,元大-土城學府,2023-03-13,9822
6477,安集,21,1,20,元大-土城學府,2023-03-13,9822
01009T,王道圓滿R1,18,0,18,元大-土城學府,2023-03-13,9822
1101,台泥,18,0,18,元大-土城學府,2023-03-13,9822
3710,連展投控,17,0,17,元大-土城學府,2023-03-13,9822
1513,中興電,53,37,16,元大-土城學府,2023-03-13,9822
2495,普安,17,1,16,元大-土城學府,2023-03-13,9822
2722,夏都,15,0,15,元大-土城學府,2023-03-13,9822
3209,全科,16,1,15,元大-土城學府,2023-03-13,9822
00713,元大台灣高息低波,13,0,13,元大-土城學府,2023-03-13,9822
2031,新光鋼,13,0,13,元大-土城學府,2023-03-13,9822
6248,沛波,12,0,12,元大-土城學府,2023-03-13,9822
8358,金居,12,0,12,元大-土城學府,2023-03-13,9822
1718,中纖,11,0,11,元大-土城學府,2023-03-13,9822
6274,台燿,11,0,11,元大-土城學府,2023-03-13,9822
00648R,元大S＆P500反1,10,0,10,元大-土城學府,2023-03-13,9822
00875,國泰網路資安,10,0,10,元大-土城學府,2023-03-13,9822
2108,南帝,13,3,10,元大-土城學府,2023-03-13,9822
2338,光罩,13,3,10,元大-土城學府,2023-03-13,9822
3042,晶技,10,0,10,元大-土城學府,2023-03-13,9822
8050,廣積,12,2,10,元大-土城學府,2023-03-13,9822
2891,中信金,10,1,9,元大-土城學府,2023-03-13,9822
1460,宏遠,9,0,9,元大-土城學府,2023-03-13,9822
5258,虹堡,47,38,9,元大-土城學府,2023-03-13,9822
6547,高端疫苗,8,0,8,元大-土城學府,2023-03-13,9822
3128,昇銳,10,3,7,元大-土城學府,2023-03-13,9822
6443,元晶,8,1,7,元大-土城學府,2023-03-13,9822
6770,力積電,7,0,7,元大-土城學府,2023-03-13,9822
2884,玉山金,14,8,6,元大-土城學府,2023-03-13,9822
8289,泰藝,6,0,6,元大-土城學府,2023-03-13,9822
00903,富邦元宇宙,6,0,6,元大-土城學府,2023-03-13,9822
01001T,土銀富邦R1,6,0,6,元大-土城學府,2023-03-13,9822
1536,和大,6,0,6,元大-土城學府,2023-03-13,9822
6243,迅杰,6,0,6,元大-土城學府,2023-03-13,9822
6411,晶焱,10,4,6,元大-土城學府,2023-03-13,9822
00878,國泰永續高股息,199,10,189,元大-土城學府,2023-03-14,9822
2027,大成鋼,150,20,130,元大-土城學府,2023-03-14,9822
2634,漢翔,111,5,106,元大-土城學府,2023-03-14,9822
2038,海光,100,0,100,元大-土城學府,2023-03-14,9822
2812,台中銀,55,0,55,元大-土城學府,2023-03-14,9822
2891,中信金,47,0,47,元大-土城學府,2023-03-14,9822
2618,長榮航,58,14,44,元大-土城學府,2023-03-14,9822
2883,凱基金,42,0,42,元大-土城學府,2023-03-14,9822
1314,中石化,61,20,41,元大-土城學府,2023-03-14,9822
2609,陽明,52,14,38,元大-土城學府,2023-03-14,9822
2610,華航,49,14,35,元大-土城學府,2023-03-14,9822
00715L,期街口布蘭特正2,33,0,33,元大-土城學府,2023-03-14,9822
2375,凱美,31,1,30,元大-土城學府,2023-03-14,9822
6235,華孚,86,57,29,元大-土城學府,2023-03-14,9822
2885,元大金,29,1,28,元大-土城學府,2023-03-14,9822
2727,王品,31,5,26,元大-土城學府,2023-03-14,9822
2449,京元電子,23,0,23,元大-土城學府,2023-03-14,9822
2748,雲品,22,1,21,元大-土城學府,2023-03-14,9822
00902,中信電池及儲能,20,0,20,元大-土城學府,2023-03-14,9822
1605,華新,30,11,19,元大-土城學府,2023-03-14,9822
8390,金益鼎,24,5,19,元大-土城學府,2023-03-14,9822
2377,微星,21,4,17,元大-土城學府,2023-03-14,9822
0056,元大高股息,21,4,17,元大-土城學府,2023-03-14,9822
2031,新光鋼,20,4,16,元大-土城學府,2023-03-14,9822
6279,胡連,16,0,16,元大-土城學府,2023-03-14,9822
1513,中興電,54,39,15,元大-土城學府,2023-03-14,9822
00713,元大台灣高息低波,15,0,15,元大-土城學府,2023-03-14,9822
3033,威健,17,2,15,元大-土城學府,2023-03-14,9822
3209,全科,15,0,15,元大-土城學府,2023-03-14,9822
2615,萬海,53,38,15,元大-土城學府,2023-03-14,9822
2303,聯電,27,13,14,元大-土城學府,2023-03-14,9822
1524,耿鼎,20,6,14,元大-土城學府,2023-03-14,9822
2890,永豐金,15,1,14,元大-土城學府,2023-03-14,9822
5907,大洋-KY,17,3,14,元大-土城學府,2023-03-14,9822
2886,兆豐金,16,2,14,元大-土城學府,2023-03-14,9822
9904,寶成,13,0,13,元大-土城學府,2023-03-14,9822
3037,欣興,18,5,13,元大-土城學府,2023-03-14,9822
00712,復華富時不動產,13,0,13,元大-土城學府,2023-03-14,9822
00888,永豐台灣ESG,13,0,13,元大-土城學府,2023-03-14,9822
00680L,元大美債20正2,12,0,12,元大-土城學府,2023-03-14,9822
4934,太極,25,15,10,元大-土城學府,2023-03-14,9822
6244,茂迪,18,8,10,元大-土城學府,2023-03-14,9822
2887,台新金,9,0,9,元大-土城學府,2023-03-14,9822
1514,亞力,11,2,9,元大-土城學府,2023-03-14,9822
2360,致茂,9,1,8,元大-土城學府,2023-03-14,9822
2388,威盛,14,6,8,元大-土城學府,2023-03-14,9822
2405,輔信,10,2,8,元大-土城學府,2023-03-14,9822
5364,力麗店,8,0,8,元大-土城學府,2023-03-14,9822
5483,中美晶,8,0,8,元大-土城學府,2023-03-14,9822
6122,擎邦,11,3,8,元大-土城學府,2023-03-14,9822
2534,宏盛,122,0,122,元大-土城學府,2023-03-15,9822
2867,三商壽,97,0,97,元大-土城學府,2023-03-15,9822
00878,國泰永續高股息,100,4,96,元大-土城學府,2023-03-15,9822
8150,南茂,65,0,65,元大-土城學府,2023-03-15,9822
1714,和桐,50,1,49,元大-土城學府,2023-03-15,9822
2603,長榮,97,54,43,元大-土城學府,2023-03-15,9822
2409,友達,42,0,42,元大-土城學府,2023-03-15,9822
2891,中信金,39,1,38,元大-土城學府,2023-03-15,9822
1314,中石化,33,0,33,元大-土城學府,2023-03-15,9822
2801,彰銀,24,0,24,元大-土城學府,2023-03-15,9822
1447,力鵬,35,11,24,元大-土城學府,2023-03-15,9822
2886,兆豐金,25,2,23,元大-土城學府,2023-03-15,9822
5403,中菲,22,0,22,元大-土城學府,2023-03-15,9822
1519,華城,25,4,21,元大-土城學府,2023-03-15,9822
2301,光寶科,21,0,21,元大-土城學府,2023-03-15,9822
2515,中工,29,8,21,元大-土城學府,2023-03-15,9822
2883,凱基金,21,0,21,元大-土城學府,2023-03-15,9822
3029,零壹,23,2,21,元大-土城學府,2023-03-15,9822
6770,力積電,50,29,21,元大-土城學府,2023-03-15,9822
00715L,期街口布蘭特正2,20,0,20,元大-土城學府,2023-03-15,9822
2609,陽明,45,25,20,元大-土城學府,2023-03-15,9822
2486,一詮,25,7,18,元大-土城學府,2023-03-15,9822
1513,中興電,67,51,16,元大-土城學府,2023-03-15,9822
2360,致茂,20,4,16,元大-土城學府,2023-03-15,9822
2031,新光鋼,23,8,15,元大-土城學府,2023-03-15,9822
6603,富強鑫,15,0,15,元大-土城學府,2023-03-15,9822
00679B,元大美債20年,14,0,14,元大-土城學府,2023-03-15,9822
5258,虹堡,129,115,14,元大-土城學府,2023-03-15,9822
2889,國票金,13,0,13,元大-土城學府,2023-03-15,9822
2471,資通,12,0,12,元大-土城學府,2023-03-15,9822
6672,騰輝電子-KY,12,0,12,元大-土城學府,2023-03-15,9822
5880,合庫金,11,0,11,元大-土城學府,2023-03-15,9822
6163,華電網,15,4,11,元大-土城學府,2023-03-15,9822
2618,長榮航,19,9,10,元大-土城學府,2023-03-15,9822
00687B,國泰20年美債,10,0,10,元大-土城學府,2023-03-15,9822
8111,立��,10,0,10,元大-土城學府,2023-03-15,9822
2211,長榮鋼,10,1,9,元大-土城學府,2023-03-15,9822
2887,台新金,11,2,9,元大-土城學府,2023-03-15,9822
3624,光頡,10,1,9,元大-土城學府,2023-03-15,9822
2884,玉山金,9,1,8,元大-土城學府,2023-03-15,9822
1460,宏遠,8,0,8,元大-土城學府,2023-03-15,9822
2108,南帝,20,12,8,元大-土城學府,2023-03-15,9822
2324,仁寶,8,0,8,元大-土城學府,2023-03-15,9822
6592,和潤企業,10,3,7,元大-土城學府,2023-03-15,9822
1720,生達,19,12,7,元大-土城學府,2023-03-15,9822
00713,元大台灣高息低波,9,2,7,元大-土城學府,2023-03-15,9822
2017,官田鋼,7,0,7,元大-土城學府,2023-03-15,9822
2890,永豐金,7,0,7,元大-土城學府,2023-03-15,9822
2892,第一金,7,0,7,元大-土城學府,2023-03-15,9822
00712,復華富時不動產,7,1,6,元大-土城學府,2023-03-15,9822
00712,復華富時不動產,345,12,333,元大-土城學府,2023-03-16,9822
00878,國泰永續高股息,264,19,245,元大-土城學府,2023-03-16,9822
2834,臺企銀,216,27,189,元大-土城學府,2023-03-16,9822
1218,泰山,151,3,148,元大-土城學府,2023-03-16,9822
0056,元大高股息,141,11,130,元大-土城學府,2023-03-16,9822
2031,新光鋼,75,10,65,元大-土城學府,2023-03-16,9822
5009,榮剛,57,15,42,元大-土城學府,2023-03-16,9822
2867,三商壽,45,4,41,元大-土城學府,2023-03-16,9822
2609,陽明,51,13,38,元大-土城學府,2023-03-16,9822
8111,立��,37,5,32,元大-土城學府,2023-03-16,9822
2618,長榮航,39,8,31,元大-土城學府,2023-03-16,9822
3056,富華新,34,5,29,元大-土城學府,2023-03-16,9822
6443,元晶,45,18,27,元大-土城學府,2023-03-16,9822
2515,中工,29,3,26,元大-土城學府,2023-03-16,9822
00715L,期街口布蘭特正2,24,0,24,元大-土城學府,2023-03-16,9822
2891,中信金,50,26,24,元大-土城學府,2023-03-16,9822
2885,元大金,29,6,23,元大-土城學府,2023-03-16,9822
2027,大成鋼,25,2,23,元大-土城學府,2023-03-16,9822
2360,致茂,22,0,22,元大-土城學府,2023-03-16,9822
2603,長榮,47,25,22,元大-土城學府,2023-03-16,9822
2457,飛宏,41,21,20,元大-土城學府,2023-03-16,9822
2906,高林,20,0,20,元大-土城學府,2023-03-16,9822
4142,國光生,20,0,20,元大-土城學府,2023-03-16,9822
2313,華通,17,0,17,元大-土城學府,2023-03-16,9822
3029,零壹,18,1,17,元大-土城學府,2023-03-16,9822
00642U,期元大S＆P石油,18,2,16,元大-土城學府,2023-03-16,9822
2376,技嘉,18,2,16,元大-土城學府,2023-03-16,9822
3536,誠創,16,0,16,元大-土城學府,2023-03-16,9822
6672,騰輝電子-KY,16,0,16,元大-土城學府,2023-03-16,9822
6719,力智,16,0,16,元大-土城學府,2023-03-16,9822
4919,新唐,20,5,15,元大-土城學府,2023-03-16,9822
2610,華航,42,29,13,元大-土城學府,2023-03-16,9822
2881,富邦金,13,0,13,元大-土城學府,2023-03-16,9822
00713,元大台灣高息低波,13,0,13,元大-土城學府,2023-03-16,9822
2890,永豐金,13,1,12,元大-土城學府,2023-03-16,9822
2615,萬海,12,0,12,元大-土城學府,2023-03-16,9822
2884,玉山金,42,30,12,元大-土城學府,2023-03-16,9822
4532,瑞智,12,0,12,元大-土城學府,2023-03-16,9822
8150,南茂,12,0,12,元大-土城學府,2023-03-16,9822
2880,華南金,14,2,12,元大-土城學府,2023-03-16,9822
2009,第一銅,11,0,11,元大-土城學府,2023-03-16,9822
4167,松瑞藥,11,0,11,元大-土城學府,2023-03-16,9822
2105,正新,10,0,10,元大-土城學府,2023-03-16,9822
2354,鴻準,10,0,10,元大-土城學府,2023-03-16,9822
2371,大同,10,0,10,元大-土城學府,2023-03-16,9822
2534,宏盛,10,0,10,元大-土城學府,2023-03-16,9822
2883B,凱基金乙特,10,0,10,元大-土城學府,2023-03-16,9822
6547,高端疫苗,16,6,10,元大-土城學府,2023-03-16,9822
2801,彰銀,10,1,9,元大-土城學府,2023-03-16,9822
2606,裕民,19,10,9,元大-土城學府,2023-03-16,9822
00673R,期元大S＆P原油反1,75,0,75,元大-土城學府,2023-03-17,9822
2891,中信金,75,2,73,元大-土城學府,2023-03-17,9822
2892,第一金,53,0,53,元大-土城學府,2023-03-17,9822
2454,聯發科,51,2,49,元大-土城學府,2023-03-17,9822
00679B,元大美債20年,42,6,36,元大-土城學府,2023-03-17,9822
1504,東元,41,9,32,元大-土城學府,2023-03-17,9822
2457,飛宏,76,44,32,元大-土城學府,2023-03-17,9822
2634,漢翔,30,3,27,元大-土城學府,2023-03-17,9822
2888,新光金,26,0,26,元大-土城學府,2023-03-17,9822
6116,彩晶,23,1,22,元大-土城學府,2023-03-17,9822
9904,寶成,22,1,21,元大-土城學府,2023-03-17,9822
00902,中信電池及儲能,33,12,21,元大-土城學府,2023-03-17,9822
2886,兆豐金,20,0,20,元大-土城學府,2023-03-17,9822
2534,宏盛,20,0,20,元大-土城學府,2023-03-17,9822
2610,華航,26,6,20,元大-土城學府,2023-03-17,9822
2883,凱基金,19,0,19,元大-土城學府,2023-03-17,9822
5483,中美晶,19,1,18,元大-土城學府,2023-03-17,9822
8112,至上,18,1,17,元大-土城學府,2023-03-17,9822
2603,長榮,22,7,15,元大-土城學府,2023-03-17,9822
2108,南帝,15,0,15,元大-土城學府,2023-03-17,9822
3715,定穎投控,15,0,15,元大-土城學府,2023-03-17,9822
1519,華城,14,0,14,元大-土城學府,2023-03-17,9822
1609,大亞,19,6,13,元大-土城學府,2023-03-17,9822
00713,元大台灣高息低波,12,0,12,元大-土城學府,2023-03-17,9822
2884,玉山金,14,2,12,元大-土城學府,2023-03-17,9822
2313,華通,13,1,12,元大-土城學府,2023-03-17,9822
2027,大成鋼,15,4,11,元大-土城學府,2023-03-17,9822
6282,康舒,14,3,11,元大-土城學府,2023-03-17,9822
8016,矽創,15,4,11,元大-土城學府,2023-03-17,9822
00715L,期街口布蘭特正2,11,0,11,元大-土城學府,2023-03-17,9822
00878,國泰永續高股息,20,10,10,元大-土城學府,2023-03-17,9822
2376,技嘉,12,2,10,元大-土城學府,2023-03-17,9822
2636,台驊控股,10,0,10,元大-土城學府,2023-03-17,9822
2801,彰銀,10,0,10,元大-土城學府,2023-03-17,9822
3673,TPK-KY,10,0,10,元大-土城學府,2023-03-17,9822
3701,大眾控,20,10,10,元大-土城學府,2023-03-17,9822
5403,中菲,10,0,10,元大-土城學府,2023-03-17,9822
8222,寶一,18,8,10,元大-土城學府,2023-03-17,9822
8069,元太,11,2,9,元大-土城學府,2023-03-17,9822
2618,長榮航,17,9,8,元大-土城學府,2023-03-17,9822
1465,偉全,8,0,8,元大-土城學府,2023-03-17,9822
9945,潤泰新,10,2,8,元大-土城學府,2023-03-17,9822
5880,合庫金,8,1,7,元大-土城學府,2023-03-17,9822
2031,新光鋼,7,0,7,元大-土城學府,2023-03-17,9822
2442,新美齊,7,0,7,元大-土城學府,2023-03-17,9822
2486,一詮,7,0,7,元大-土城學府,2023-03-17,9822
2605,新興,7,0,7,元大-土城學府,2023-03-17,9822
3056,富華新,48,41,7,元大-土城學府,2023-03-17,9822
4979,華星光,8,1,7,元大-土城學府,2023-03-17,9822
00631L,元大台灣50正2,6,0,6,元大-土城學府,2023-03-17,9822
00878,國泰永續高股息,71,0,71,元大-土城學府,2023-03-20,9822
00715L,期街口布蘭特正2,89,23,66,元大-土城學府,2023-03-20,9822
1605,華新,68,8,60,元大-土城學府,2023-03-20,9822
3056,富華新,60,6,54,元大-土城學府,2023-03-20,9822
2756,聯發國際,47,0,47,元大-土城學府,2023-03-20,9822
1442,名軒,35,0,35,元大-土城學府,2023-03-20,9822
2634,漢翔,52,17,35,元大-土城學府,2023-03-20,9822
2881,富邦金,32,0,32,元大-土城學府,2023-03-20,9822
00902,中信電池及儲能,28,6,22,元大-土城學府,2023-03-20,9822
00753L,中信中國50正2,21,0,21,元大-土城學府,2023-03-20,9822
1522,堤維西,21,1,20,元大-土城學府,2023-03-20,9822
2801,彰銀,21,3,18,元大-土城學府,2023-03-20,9822
1519,華城,19,3,16,元大-土城學府,2023-03-20,9822
2882,國泰金,16,1,15,元大-土城學府,2023-03-20,9822
6125,廣運,15,0,15,元大-土城學府,2023-03-20,9822
6603,富強鑫,15,0,15,元大-土城學府,2023-03-20,9822
00642U,期元大S＆P石油,13,0,13,元大-土城學府,2023-03-20,9822
2892,第一金,12,0,12,元大-土城學府,2023-03-20,9822
2454,聯發科,13,1,12,元大-土城學府,2023-03-20,9822
2812,台中銀,11,0,11,元大-土城學府,2023-03-20,9822
00900,富邦特選高股息30,11,0,11,元大-土城學府,2023-03-20,9822
2317,鴻海,11,0,11,元大-土城學府,2023-03-20,9822
2885,元大金,11,0,11,元大-土城學府,2023-03-20,9822
4977,眾達-KY,11,0,11,元大-土城學府,2023-03-20,9822
2886,兆豐金,10,0,10,元大-土城學府,2023-03-20,9822
00881,國泰台灣5G+,10,0,10,元大-土城學府,2023-03-20,9822
2023,燁輝,12,2,10,元大-土城學府,2023-03-20,9822
2457,飛宏,30,20,10,元大-土城學府,2023-03-20,9822
2884,玉山金,12,2,10,元大-土城學府,2023-03-20,9822
9907,統一實,10,1,9,元大-土城學府,2023-03-20,9822
2727,王品,9,0,9,元大-土城學府,2023-03-20,9822
00773B,中信優先金融債,8,0,8,元大-土城學府,2023-03-20,9822
00673R,期元大S＆P原油反1,8,0,8,元大-土城學府,2023-03-20,9822
6188,廣明,10,2,8,元大-土城學府,2023-03-20,9822
00632R,元大台灣50反1,7,0,7,元大-土城學府,2023-03-20,9822
1326,台化,7,0,7,元大-土城學府,2023-03-20,9822
3178,公準,7,0,7,元大-土城學府,2023-03-20,9822
3432,台端,7,0,7,元大-土城學府,2023-03-20,9822
5276,達輝-KY,7,0,7,元大-土城學府,2023-03-20,9822
2399,映泰,6,0,6,元大-土城學府,2023-03-20,9822
6477,安集,7,1,6,元大-土城學府,2023-03-20,9822
6548,長科*,7,1,6,元大-土城學府,2023-03-20,9822
1710,東聯,5,0,5,元大-土城學府,2023-03-20,9822
2108,南帝,5,0,5,元大-土城學府,2023-03-20,9822
2323,中環,5,0,5,元大-土城學府,2023-03-20,9822
2429,銘旺科,5,0,5,元大-土城學府,2023-03-20,9822
2481,強茂,25,20,5,元大-土城學府,2023-03-20,9822
2611,志信,6,1,5,元大-土城學府,2023-03-20,9822
3710,連展投控,5,0,5,元大-土城學府,2023-03-20,9822
6231,系微,5,0,5,元大-土城學府,2023-03-20,9822
3481,群創,122,8,114,元大-土城學府,2023-03-21,9822
2615,萬海,104,3,101,元大-土城學府,2023-03-21,9822
6235,華孚,105,48,57,元大-土城學府,2023-03-21,9822
2482,連宇,64,12,52,元大-土城學府,2023-03-21,9822
2890,永豐金,36,0,36,元大-土城學府,2023-03-21,9822
2610,華航,39,6,33,元大-土城學府,2023-03-21,9822
3432,台端,52,19,33,元大-土城學府,2023-03-21,9822
2392,正崴,30,0,30,元大-土城學府,2023-03-21,9822
3324,雙鴻,32,2,30,元大-土城學府,2023-03-21,9822
5009,榮剛,39,10,29,元大-土城學府,2023-03-21,9822
6443,元晶,46,17,29,元大-土城學府,2023-03-21,9822
6863,永道-KY,26,2,24,元大-土城學府,2023-03-21,9822
00632R,元大台灣50反1,23,0,23,元大-土城學府,2023-03-21,9822
6590,普鴻,23,0,23,元大-土城學府,2023-03-21,9822
9904,寶成,22,0,22,元大-土城學府,2023-03-21,9822
1609,大亞,28,6,22,元大-土城學府,2023-03-21,9822
2457,飛宏,100,78,22,元大-土城學府,2023-03-21,9822
2399,映泰,20,0,20,元大-土城學府,2023-03-21,9822
6533,晶心科,20,0,20,元大-土城學府,2023-03-21,9822
1611,中電,23,4,19,元大-土城學府,2023-03-21,9822
00715L,期街口布蘭特正2,20,2,18,元大-土城學府,2023-03-21,9822
2105,正新,16,0,16,元大-土城學府,2023-03-21,9822
3624,光頡,18,5,13,元大-土城學府,2023-03-21,9822
2388,威盛,37,25,12,元大-土城學府,2023-03-21,9822
6244,茂迪,38,26,12,元大-土城學府,2023-03-21,9822
00878,國泰永續高股息,55,44,11,元大-土城學府,2023-03-21,9822
6116,彩晶,15,4,11,元大-土城學府,2023-03-21,9822
2603,長榮,11,1,10,元大-土城學府,2023-03-21,9822
4976,佳凌,26,16,10,元大-土城學府,2023-03-21,9822
2732,六角,10,1,9,元大-土城學府,2023-03-21,9822
2609,陽明,16,7,9,元大-土城學府,2023-03-21,9822
2429,銘旺科,9,0,9,元大-土城學府,2023-03-21,9822
6148,驊宏資,14,5,9,元大-土城學府,2023-03-21,9822
6770,力積電,10,1,9,元大-土城學府,2023-03-21,9822
2317,鴻海,10,1,9,元大-土城學府,2023-03-21,9822
00673R,期元大S＆P原油反1,8,0,8,元大-土城學府,2023-03-21,9822
1506,正道,9,1,8,元大-土城學府,2023-03-21,9822
6715,嘉基,9,1,8,元大-土城學府,2023-03-21,9822
6791,虎門科技,8,0,8,元大-土城學府,2023-03-21,9822
2882,國泰金,8,0,8,元大-土城學府,2023-03-21,9822
2303,聯電,14,7,7,元大-土城學府,2023-03-21,9822
2481,強茂,11,4,7,元大-土城學府,2023-03-21,9822
9945,潤泰新,32,25,7,元大-土城學府,2023-03-21,9822
00888,永豐台灣ESG,6,0,6,元大-土城學府,2023-03-21,9822
2618,長榮航,10,4,6,元大-土城學府,2023-03-21,9822
2014,中鴻,6,0,6,元大-土城學府,2023-03-21,9822
2414,精技,6,0,6,元大-土城學府,2023-03-21,9822
3047,訊舟,6,0,6,元大-土城學府,2023-03-21,9822
8938,明安,7,1,6,元大-土城學府,2023-03-21,9822
6719,力智,5,0,5,元大-土城學府,2023-03-21,9822
00632R,元大台灣50反1,495,85,410,元大-土城學府,2023-03-22,9822
00679B,元大美債20年,78,0,78,元大-土城學府,2023-03-22,9822
00885,富邦越南,68,1,67,元大-土城學府,2023-03-22,9822
5258,虹堡,93,27,66,元大-土城學府,2023-03-22,9822
2482,連宇,95,40,55,元大-土城學府,2023-03-22,9822
2888,新光金,50,2,48,元大-土城學府,2023-03-22,9822
6244,茂迪,51,11,40,元大-土城學府,2023-03-22,9822
6509,聚和,33,3,30,元大-土城學府,2023-03-22,9822
00900,富邦特選高股息30,31,4,27,元大-土城學府,2023-03-22,9822
2834,臺企銀,22,1,21,元大-土城學府,2023-03-22,9822
6235,華孚,64,45,19,元大-土城學府,2023-03-22,9822
6282,康舒,19,0,19,元大-土城學府,2023-03-22,9822
3013,晟銘電,21,4,17,元大-土城學府,2023-03-22,9822
5309,系統電,18,1,17,元大-土城學府,2023-03-22,9822
3029,零壹,16,0,16,元大-土城學府,2023-03-22,9822
1504,東元,30,15,15,元大-土城學府,2023-03-22,9822
2344,華邦電,20,5,15,元大-土城學府,2023-03-22,9822
2457,飛宏,99,85,14,元大-土城學府,2023-03-22,9822
2208,台船,18,4,14,元大-土城學府,2023-03-22,9822
6288,聯嘉,20,6,14,元大-土城學府,2023-03-22,9822
2401,凌陽,15,2,13,元大-土城學府,2023-03-22,9822
2027,大成鋼,12,0,12,元大-土城學府,2023-03-22,9822
2542,興富發,12,0,12,元大-土城學府,2023-03-22,9822
2890,永豐金,17,5,12,元大-土城學府,2023-03-22,9822
3147,大綜,12,0,12,元大-土城學府,2023-03-22,9822
6179,亞通,12,0,12,元大-土城學府,2023-03-22,9822
00637L,元大滬深300正2,25,14,11,元大-土城學府,2023-03-22,9822
2414,精技,11,0,11,元大-土城學府,2023-03-22,9822
6767,台微醫,11,0,11,元大-土城學府,2023-03-22,9822
1313,聯成,10,0,10,元大-土城學府,2023-03-22,9822
3666,光耀,10,0,10,元大-土城學府,2023-03-22,9822
5210,寶碩,10,0,10,元大-土城學府,2023-03-22,9822
9904,寶成,10,0,10,元大-土城學府,2023-03-22,9822
2302,麗正,16,7,9,元大-土城學府,2023-03-22,9822
6491,晶碩,9,0,9,元大-土城學府,2023-03-22,9822
2886,兆豐金,10,1,9,元大-土城學府,2023-03-22,9822
2471,資通,18,11,7,元大-土城學府,2023-03-22,9822
2605,新興,10,3,7,元大-土城學府,2023-03-22,9822
2880,華南金,7,0,7,元大-土城學府,2023-03-22,9822
5880,合庫金,10,3,7,元大-土城學府,2023-03-22,9822
00673R,期元大S＆P原油反1,6,0,6,元大-土城學府,2023-03-22,9822
2645,長榮航太,6,0,6,元大-土城學府,2023-03-22,9822
3515,華擎,6,0,6,元大-土城學府,2023-03-22,9822
5351,鈺創,6,0,6,元大-土城學府,2023-03-22,9822
6191,精成科,11,5,6,元大-土城學府,2023-03-22,9822
2603,長榮,9,3,6,元大-土城學府,2023-03-22,9822
00751B,元大AAA至A公司債,5,0,5,元大-土城學府,2023-03-22,9822
00795B,中信美國公債20年,5,0,5,元大-土城學府,2023-03-22,9822
2032,新鋼,5,0,5,元大-土城學府,2023-03-22,9822
2495,普安,6,1,5,元大-土城學府,2023-03-22,9822
00632R,元大台灣50反1,259,0,259,元大-土城學府,2023-03-23,9822
00679B,元大美債20年,74,0,74,元大-土城學府,2023-03-23,9822
2329,華泰,64,4,60,元大-土城學府,2023-03-23,9822
2888,新光金,54,10,44,元大-土城學府,2023-03-23,9822
00713,元大台灣高息低波,42,3,39,元大-土城學府,2023-03-23,9822
6138,茂達,37,0,37,元大-土城學府,2023-03-23,9822
2609,陽明,35,4,31,元大-土城學府,2023-03-23,9822
2377,微星,28,0,28,元大-土城學府,2023-03-23,9822
2634,漢翔,38,11,27,元大-土城學府,2023-03-23,9822
2610,華航,26,3,23,元大-土城學府,2023-03-23,9822
6175,立敦,20,0,20,元大-土城學府,2023-03-23,9822
3479,安勤,51,32,19,元大-土城學府,2023-03-23,9822
01009T,王道圓滿R1,18,0,18,元大-土城學府,2023-03-23,9822
8050,廣積,18,1,17,元大-土城學府,2023-03-23,9822
2429,銘旺科,16,0,16,元大-土城學府,2023-03-23,9822
1701,中化,14,0,14,元大-土城學府,2023-03-23,9822
3013,晟銘電,15,1,14,元大-土城學府,2023-03-23,9822
8054,安國,14,0,14,元大-土城學府,2023-03-23,9822
1453,大將,13,1,12,元大-土城學府,2023-03-23,9822
2834,臺企銀,12,0,12,元大-土城學府,2023-03-23,9822
8222,寶一,15,3,12,元大-土城學府,2023-03-23,9822
1712,興農,10,0,10,元大-土城學府,2023-03-23,9822
6223,旺矽,23,13,10,元大-土城學府,2023-03-23,9822
01007T,兆豐國泰R2,10,0,10,元大-土城學府,2023-03-23,9822
01004T,土銀富邦R2,10,0,10,元大-土城學府,2023-03-23,9822
00720B,元大投資級公司債,10,0,10,元大-土城學府,2023-03-23,9822
2023,燁輝,12,2,10,元大-土城學府,2023-03-23,9822
2534,宏盛,10,0,10,元大-土城學府,2023-03-23,9822
5210,寶碩,10,0,10,元大-土城學府,2023-03-23,9822
5864,致和證,10,0,10,元大-土城學府,2023-03-23,9822
1529,樂事綠能,9,0,9,元大-土城學府,2023-03-23,9822
2637,慧洋-KY,9,0,9,元大-土城學府,2023-03-23,9822
00751B,元大AAA至A公司債,8,0,8,元大-土城學府,2023-03-23,9822
1442,名軒,8,0,8,元大-土城學府,2023-03-23,9822
3094,聯傑,11,3,8,元大-土城學府,2023-03-23,9822
6196,帆宣,12,4,8,元大-土城學府,2023-03-23,9822
9921,巨大,8,0,8,元大-土城學府,2023-03-23,9822
2405,輔信,7,0,7,元大-土城學府,2023-03-23,9822
3260,威剛,35,28,7,元大-土城學府,2023-03-23,9822
6411,晶焱,7,0,7,元大-土城學府,2023-03-23,9822
00673R,期元大S＆P原油反1,6,0,6,元大-土城學府,2023-03-23,9822
1568,倉佑,6,0,6,元大-土城學府,2023-03-23,9822
2611,志信,6,0,6,元大-土城學府,2023-03-23,9822
2880,華南金,6,0,6,元大-土城學府,2023-03-23,9822
2890,永豐金,6,0,6,元大-土城學府,2023-03-23,9822
2891,中信金,11,5,6,元大-土城學府,2023-03-23,9822
3047,訊舟,6,0,6,元大-土城學府,2023-03-23,9822
3520,華盈,6,0,6,元大-土城學府,2023-03-23,9822
6547,高端疫苗,6,0,6,元大-土城學府,2023-03-23,9822
0056,元大高股息,14,9,5,元大-土城學府,2023-03-23,9822
2379,瑞昱,118,0,118,元大-土城學府,2023-03-24,9822
00632R,元大台灣50反1,74,0,74,元大-土城學府,2023-03-24,9822
9904,寶成,40,0,40,元大-土城學府,2023-03-24,9822
3682,亞太電,35,1,34,元大-土城學府,2023-03-24,9822
2634,漢翔,30,0,30,元大-土城學府,2023-03-24,9822
6753,龍德造船,27,0,27,元大-土城學府,2023-03-24,9822
2889,國票金,25,0,25,元大-土城學府,2023-03-24,9822
3047,訊舟,20,0,20,元大-土城學府,2023-03-24,9822
2481,強茂,21,2,19,元大-土城學府,2023-03-24,9822
2402,毅嘉,95,76,19,元大-土城學府,2023-03-24,9822
4919,新唐,26,8,18,元大-土城學府,2023-03-24,9822
8024,佑華,21,3,18,元大-土城學府,2023-03-24,9822
00679B,元大美債20年,17,0,17,元大-土城學府,2023-03-24,9822
2883,凱基金,19,2,17,元大-土城學府,2023-03-24,9822
1514,亞力,21,4,17,元大-土城學府,2023-03-24,9822
5475,德宏,17,0,17,元大-土城學府,2023-03-24,9822
00713,元大台灣高息低波,17,2,15,元大-土城學府,2023-03-24,9822
6122,擎邦,83,70,13,元大-土城學府,2023-03-24,9822
00772B,中信高評級公司債,13,0,13,元大-土城學府,2023-03-24,9822
5351,鈺創,20,8,12,元大-土城學府,2023-03-24,9822
6116,彩晶,12,0,12,元大-土城學府,2023-03-24,9822
6235,華孚,43,31,12,元大-土城學府,2023-03-24,9822
2886,兆豐金,11,0,11,元大-土城學府,2023-03-24,9822
2880,華南金,13,2,11,元大-土城學府,2023-03-24,9822
2891,中信金,11,0,11,元大-土城學府,2023-03-24,9822
1718,中纖,10,0,10,元大-土城學府,2023-03-24,9822
1591,駿吉-KY,10,0,10,元大-土城學府,2023-03-24,9822
1710,東聯,10,0,10,元大-土城學府,2023-03-24,9822
2108,南帝,10,0,10,元大-土城學府,2023-03-24,9822
3028,增你強,10,0,10,元大-土城學府,2023-03-24,9822
3051,力特,12,2,10,元大-土城學府,2023-03-24,9822
4129,聯合,10,0,10,元大-土城學府,2023-03-24,9822
4402,郡都開發,18,8,10,元大-土城學府,2023-03-24,9822
6472,保瑞,12,2,10,元大-土城學府,2023-03-24,9822
2618,長榮航,11,1,10,元大-土城學府,2023-03-24,9822
3704,合勤控,8,0,8,元大-土城學府,2023-03-24,9822
1319,東陽,9,1,8,元大-土城學府,2023-03-24,9822
1522,堤維西,9,1,8,元大-土城學府,2023-03-24,9822
5222,全訊,12,4,8,元大-土城學府,2023-03-24,9822
1460,宏遠,7,0,7,元大-土城學府,2023-03-24,9822
2414,精技,7,0,7,元大-土城學府,2023-03-24,9822
6202,盛群,8,1,7,元大-土城學府,2023-03-24,9822
2609,陽明,11,5,6,元大-土城學府,2023-03-24,9822
6231,系微,7,1,6,元大-土城學府,2023-03-24,9822
1435,中福,6,0,6,元大-土城學府,2023-03-24,9822
1568,倉佑,6,0,6,元大-土城學府,2023-03-24,9822
2867,三商壽,6,0,6,元大-土城學府,2023-03-24,9822
3037,欣興,28,22,6,元大-土城學府,2023-03-24,9822
3520,華盈,6,0,6,元大-土城學府,2023-03-24,9822
3710,連展投控,6,0,6,元大-土城學府,2023-03-24,9822
2890,永豐金,104,0,104,元大-土城學府,2023-03-27,9822
1605,華新,109,11,98,元大-土城學府,2023-03-27,9822
3056,富華新,47,2,45,元大-土城學府,2023-03-27,9822
3047,訊舟,46,5,41,元大-土城學府,2023-03-27,9822
2885,元大金,23,1,22,元大-土城學府,2023-03-27,9822
6288,聯嘉,54,32,22,元大-土城學府,2023-03-27,9822
2317,鴻海,24,3,21,元大-土城學府,2023-03-27,9822
2634,漢翔,68,47,21,元大-土城學府,2023-03-27,9822
3260,威剛,21,0,21,元大-土城學府,2023-03-27,9822
6279,胡連,20,0,20,元大-土城學府,2023-03-27,9822
2426,鼎元,20,0,20,元大-土城學府,2023-03-27,9822
5243,乙盛-KY,20,0,20,元大-土城學府,2023-03-27,9822
00891,中信關鍵半導體,19,0,19,元大-土城學府,2023-03-27,9822
6245,立端,21,2,19,元大-土城學府,2023-03-27,9822
3231,緯創,29,12,17,元大-土城學府,2023-03-27,9822
1504,東元,40,24,16,元大-土城學府,2023-03-27,9822
00900,富邦特選高股息30,16,0,16,元大-土城學府,2023-03-27,9822
1711,永光,16,0,16,元大-土城學府,2023-03-27,9822
2402,毅嘉,25,9,16,元大-土城學府,2023-03-27,9822
1609,大亞,43,27,16,元大-土城學府,2023-03-27,9822
4919,新唐,14,0,14,元大-土城學府,2023-03-27,9822
2344,華邦電,17,4,13,元大-土城學府,2023-03-27,9822
3715,定穎投控,15,2,13,元大-土城學府,2023-03-27,9822
1584,精剛,23,11,12,元大-土城學府,2023-03-27,9822
2324,仁寶,17,5,12,元大-土城學府,2023-03-27,9822
8111,立��,11,0,11,元大-土城學府,2023-03-27,9822
3576,聯合再生,16,5,11,元大-土城學府,2023-03-27,9822
4967,十銓,11,0,11,元大-土城學府,2023-03-27,9822
6770,力積電,11,0,11,元大-土城學府,2023-03-27,9822
00881,國泰台灣5G+,10,0,10,元大-土城學府,2023-03-27,9822
1313,聯成,13,3,10,元大-土城學府,2023-03-27,9822
1402,遠東新,10,0,10,元大-土城學府,2023-03-27,9822
1909,榮成,10,0,10,元大-土城學府,2023-03-27,9822
3479,安勤,33,23,10,元大-土城學府,2023-03-27,9822
5351,鈺創,10,0,10,元大-土城學府,2023-03-27,9822
6116,彩晶,10,0,10,元大-土城學府,2023-03-27,9822
6472,保瑞,13,3,10,元大-土城學府,2023-03-27,9822
2359,所羅門,11,2,9,元大-土城學府,2023-03-27,9822
2883,凱基金,10,1,9,元大-土城學府,2023-03-27,9822
8033,雷虎,20,11,9,元大-土城學府,2023-03-27,9822
9955,佳龍,9,0,9,元大-土城學府,2023-03-27,9822
6767,台微醫,9,0,9,元大-土城學府,2023-03-27,9822
00882,中信中國高股息,19,11,8,元大-土城學府,2023-03-27,9822
1319,東陽,12,4,8,元大-土城學府,2023-03-27,9822
2002,中鋼,8,0,8,元大-土城學府,2023-03-27,9822
2388,威盛,31,23,8,元大-土城學府,2023-03-27,9822
2409,友達,9,1,8,元大-土城學府,2023-03-27,9822
8088,品安,15,8,7,元大-土城學府,2023-03-27,9822
2610,華航,13,6,7,元大-土城學府,2023-03-27,9822
5258,虹堡,20,13,7,元大-土城學府,2023-03-27,9822
3479,安勤,157,43,114,元大-土城學府,2023-03-28,9822
00679B,元大美債20年,86,0,86,元大-土城學府,2023-03-28,9822
1517,利奇,40,1,39,元大-土城學府,2023-03-28,9822
2530,華建,36,0,36,元大-土城學府,2023-03-28,9822
00882,中信中國高股息,31,0,31,元大-土城學府,2023-03-28,9822
6271,同欣電,36,5,31,元大-土城學府,2023-03-28,9822
2634,漢翔,53,24,29,元大-土城學府,2023-03-28,9822
00891,中信關鍵半導體,26,0,26,元大-土城學府,2023-03-28,9822
4919,新唐,30,4,26,元大-土城學府,2023-03-28,9822
4175,杏一,25,0,25,元大-土城學府,2023-03-28,9822
6223,旺矽,22,0,22,元大-土城學府,2023-03-28,9822
3552,同致,21,0,21,元大-土城學府,2023-03-28,9822
3037,欣興,36,16,20,元大-土城學府,2023-03-28,9822
1809,中釉,20,0,20,元大-土城學府,2023-03-28,9822
2722,夏都,20,0,20,元大-土城學府,2023-03-28,9822
0056,元大高股息,23,3,20,元大-土城學府,2023-03-28,9822
3105,穩懋,22,2,20,元大-土城學府,2023-03-28,9822
2388,威盛,26,10,16,元大-土城學府,2023-03-28,9822
5258,虹堡,36,20,16,元大-土城學府,2023-03-28,9822
8016,矽創,16,0,16,元大-土城學府,2023-03-28,9822
00922,國泰台灣領袖50,16,0,16,元大-土城學府,2023-03-28,9822
6770,力積電,17,2,15,元大-土城學府,2023-03-28,9822
2331,精英,18,5,13,元大-土城學府,2023-03-28,9822
2392,正崴,10,0,10,元大-土城學府,2023-03-28,9822
2498,宏達電,19,9,10,元大-土城學府,2023-03-28,9822
3380,明泰,10,0,10,元大-土城學府,2023-03-28,9822
6123,上奇,10,0,10,元大-土城學府,2023-03-28,9822
6570,維田,10,0,10,元大-土城學府,2023-03-28,9822
4943,康控-KY,10,0,10,元大-土城學府,2023-03-28,9822
1101,台泥,13,4,9,元大-土城學府,2023-03-28,9822
3048,益登,10,1,9,元大-土城學府,2023-03-28,9822
5516,雙喜,9,0,9,元大-土城學府,2023-03-28,9822
6547,高端疫苗,9,0,9,元大-土城學府,2023-03-28,9822
6472,保瑞,13,5,8,元大-土城學府,2023-03-28,9822
2337,旺宏,8,0,8,元大-土城學府,2023-03-28,9822
2888,新光金,8,0,8,元大-土城學府,2023-03-28,9822
6122,擎邦,20,12,8,元大-土城學府,2023-03-28,9822
6517,保勝光學,9,1,8,元大-土城學府,2023-03-28,9822
3035,智原,20,13,7,元大-土城學府,2023-03-28,9822
1319,東陽,7,0,7,元大-土城學府,2023-03-28,9822
1795,美時,11,4,7,元大-土城學府,2023-03-28,9822
3664,安瑞-KY,7,0,7,元大-土城學府,2023-03-28,9822
6288,聯嘉,7,0,7,元大-土城學府,2023-03-28,9822
3715,定穎投控,12,5,7,元大-土城學府,2023-03-28,9822
2457,飛宏,16,9,7,元大-土城學府,2023-03-28,9822
2317,鴻海,10,4,6,元大-土城學府,2023-03-28,9822
2929,淘帝-KY,6,0,6,元大-土城學府,2023-03-28,9822
2409,友達,6,0,6,元大-土城學府,2023-03-28,9822
2206,三陽工業,6,0,6,元大-土城學府,2023-03-28,9822
00665L,富邦�琤肭磪囓�2,6,0,6,元大-土城學府,2023-03-28,9822
1519,華城,82,1,81,元大-土城學府,2023-03-29,9822
3027,盛達,51,0,51,元大-土城學府,2023-03-29,9822
5258,虹堡,73,37,36,元大-土城學府,2023-03-29,9822
2368,金像電,34,2,32,元大-土城學府,2023-03-29,9822
3338,泰碩,35,6,29,元大-土城學府,2023-03-29,9822
00679B,元大美債20年,26,0,26,元大-土城學府,2023-03-29,9822
3093,港建*,25,0,25,元大-土城學府,2023-03-29,9822
2303,聯電,24,0,24,元大-土城學府,2023-03-29,9822
3105,穩懋,21,0,21,元大-土城學府,2023-03-29,9822
1101,台泥,20,0,20,元大-土城學府,2023-03-29,9822
3324,雙鴻,23,6,17,元大-土城學府,2023-03-29,9822
00882,中信中國高股息,24,10,14,元大-土城學府,2023-03-29,9822
2228,劍麟,14,0,14,元大-土城學府,2023-03-29,9822
6770,力積電,14,0,14,元大-土城學府,2023-03-29,9822
2371,大同,13,1,12,元大-土城學府,2023-03-29,9822
4919,新唐,15,3,12,元大-土城學府,2023-03-29,9822
6223,旺矽,12,0,12,元大-土城學府,2023-03-29,9822
6756,威鋒電子,12,0,12,元大-土城學府,2023-03-29,9822
8938,明安,12,0,12,元大-土城學府,2023-03-29,9822
3017,奇鋐,17,6,11,元大-土城學府,2023-03-29,9822
2481,強茂,16,5,11,元大-土城學府,2023-03-29,9822
2603,長榮,11,0,11,元大-土城學府,2023-03-29,9822
6691,洋基工程,10,0,10,元大-土城學府,2023-03-29,9822
1909,榮成,10,0,10,元大-土城學府,2023-03-29,9822
2457,飛宏,33,23,10,元大-土城學府,2023-03-29,9822
3673,TPK-KY,10,0,10,元大-土城學府,2023-03-29,9822
4943,康控-KY,10,0,10,元大-土城學府,2023-03-29,9822
5243,乙盛-KY,11,1,10,元大-土城學府,2023-03-29,9822
5533,皇鼎,10,0,10,元大-土城學府,2023-03-29,9822
3025,星通,10,1,9,元大-土城學府,2023-03-29,9822
3043,科風,9,0,9,元大-土城學府,2023-03-29,9822
3163,波若威,9,0,9,元大-土城學府,2023-03-29,9822
5351,鈺創,9,0,9,元大-土城學府,2023-03-29,9822
1504,東元,33,24,9,元大-土城學府,2023-03-29,9822
00891,中信關鍵半導體,10,2,8,元大-土城學府,2023-03-29,9822
2498,宏達電,15,7,8,元大-土城學府,2023-03-29,9822
00900,富邦特選高股息30,7,0,7,元大-土城學府,2023-03-29,9822
00772B,中信高評級公司債,7,0,7,元大-土城學府,2023-03-29,9822
00713,元大台灣高息低波,7,0,7,元大-土城學府,2023-03-29,9822
2329,華泰,8,1,7,元大-土城學府,2023-03-29,9822
3272,東碩,7,0,7,元大-土城學府,2023-03-29,9822
00773B,中信優先金融債,6,0,6,元大-土城學府,2023-03-29,9822
3545,敦泰,6,0,6,元大-土城學府,2023-03-29,9822
7402,邑錡,6,0,6,元大-土城學府,2023-03-29,9822
1605,華新,9,3,6,元大-土城學府,2023-03-29,9822
9945,潤泰新,5,0,5,元大-土城學府,2023-03-29,9822
3035,智原,16,11,5,元大-土城學府,2023-03-29,9822
5425,台半,10,5,5,元大-土城學府,2023-03-29,9822
9921,巨大,5,0,5,元大-土城學府,2023-03-29,9822
00712,復華富時不動產,5,0,5,元大-土城學府,2023-03-29,9822
3481,群創,109,1,108,元大-土城學府,2023-03-30,9822
2867,三商壽,98,0,98,元大-土城學府,2023-03-30,9822
2888,新光金,63,0,63,元大-土城學府,2023-03-30,9822
2887,台新金,50,1,49,元大-土城學府,2023-03-30,9822
5864,致和證,30,0,30,元大-土城學府,2023-03-30,9822
00922,國泰台灣領袖50,21,0,21,元大-土城學府,2023-03-30,9822
4128,中天,21,0,21,元大-土城學府,2023-03-30,9822
1234,黑松,20,0,20,元大-土城學府,2023-03-30,9822
1760,寶齡富錦,16,0,16,元大-土城學府,2023-03-30,9822
3682,亞太電,18,2,16,元大-土城學府,2023-03-30,9822
3025,星通,15,0,15,元大-土城學府,2023-03-30,9822
6245,立端,15,1,14,元大-土城學府,2023-03-30,9822
6770,力積電,14,0,14,元大-土城學府,2023-03-30,9822
2609,陽明,13,0,13,元大-土城學府,2023-03-30,9822
3013,晟銘電,12,0,12,元大-土城學府,2023-03-30,9822
6179,亞通,12,0,12,元大-土城學府,2023-03-30,9822
1609,大亞,16,5,11,元大-土城學府,2023-03-30,9822
00679B,元大美債20年,19,8,11,元大-土城學府,2023-03-30,9822
00885,富邦越南,21,10,11,元大-土城學府,2023-03-30,9822
1712,興農,11,0,11,元大-土城學府,2023-03-30,9822
2330,台積電,12,2,10,元大-土城學府,2023-03-30,9822
00875,國泰網路資安,10,0,10,元大-土城學府,2023-03-30,9822
1810,和成,10,0,10,元大-土城學府,2023-03-30,9822
5243,乙盛-KY,10,0,10,元大-土城學府,2023-03-30,9822
6148,驊宏資,10,0,10,元大-土城學府,2023-03-30,9822
6138,茂達,12,3,9,元大-土城學府,2023-03-30,9822
0055,元大MSCI金融,8,0,8,元大-土城學府,2023-03-30,9822
1504,東元,27,19,8,元大-土城學府,2023-03-30,9822
6288,聯嘉,18,10,8,元大-土城學府,2023-03-30,9822
1605,華新,10,2,8,元大-土城學府,2023-03-30,9822
9945,潤泰新,10,2,8,元大-土城學府,2023-03-30,9822
2006,東和鋼鐵,7,0,7,元大-土城學府,2023-03-30,9822
2228,劍麟,7,0,7,元大-土城學府,2023-03-30,9822
2331,精英,16,9,7,元大-土城學府,2023-03-30,9822
2375,凱美,7,0,7,元大-土城學府,2023-03-30,9822
3362,先進光,7,0,7,元大-土城學府,2023-03-30,9822
6266,泰詠,9,2,7,元大-土城學府,2023-03-30,9822
00878,國泰永續高股息,11,5,6,元大-土城學府,2023-03-30,9822
00715L,期街口布蘭特正2,6,0,6,元大-土城學府,2023-03-30,9822
2426,鼎元,6,0,6,元大-土城學府,2023-03-30,9822
2610,華航,10,4,6,元大-土城學府,2023-03-30,9822
3260,威剛,16,10,6,元大-土城學府,2023-03-30,9822
4528,江興鍛,6,0,6,元大-土城學府,2023-03-30,9822
6233,旺玖,6,0,6,元大-土城學府,2023-03-30,9822
00882,中信中國高股息,5,0,5,元大-土城學府,2023-03-30,9822
00712,復華富時不動產,5,0,5,元大-土城學府,2023-03-30,9822
3035,智原,8,3,5,元大-土城學府,2023-03-30,9822
1460,宏遠,5,0,5,元大-土城學府,2023-03-30,9822
2338,光罩,5,0,5,元大-土城學府,2023-03-30,9822
3710,連展投控,10,5,5,元大-土城學府,2023-03-30,9822
2887,台新金,210,2,208,元大-土城學府,2023-03-31,9822
2344,華邦電,151,61,90,元大-土城學府,2023-03-31,9822
3231,緯創,101,34,67,元大-土城學府,2023-03-31,9822
3037,欣興,63,13,50,元大-土城學府,2023-03-31,9822
2408,南亞科,65,20,45,元大-土城學府,2023-03-31,9822
8050,廣積,57,17,40,元大-土城學府,2023-03-31,9822
2867,三商壽,29,0,29,元大-土城學府,2023-03-31,9822
3202,樺晟,26,0,26,元大-土城學府,2023-03-31,9822
2438,翔耀,23,0,23,元大-土城學府,2023-03-31,9822
1504,東元,33,11,22,元大-土城學府,2023-03-31,9822
2409,友達,22,0,22,元大-土城學府,2023-03-31,9822
00753L,中信中國50正2,21,0,21,元大-土城學府,2023-03-31,9822
2884,玉山金,28,7,21,元大-土城學府,2023-03-31,9822
8277,商丞,21,1,20,元大-土城學府,2023-03-31,9822
3029,零壹,20,2,18,元大-土城學府,2023-03-31,9822
2449,京元電子,16,1,15,元大-土城學府,2023-03-31,9822
2640,大車隊,14,0,14,元大-土城學府,2023-03-31,9822
3714,富采,16,2,14,元大-土城學府,2023-03-31,9822
00922,國泰台灣領袖50,12,0,12,元大-土城學府,2023-03-31,9822
6863,永道-KY,11,0,11,元大-土城學府,2023-03-31,9822
4904,遠傳,18,8,10,元大-土城學府,2023-03-31,9822
00632R,元大台灣50反1,40,30,10,元大-土城學府,2023-03-31,9822
2061,風青,10,0,10,元大-土城學府,2023-03-31,9822
2352,佳世達,12,2,10,元大-土城學府,2023-03-31,9822
2401,凌陽,10,0,10,元大-土城學府,2023-03-31,9822
3324,雙鴻,10,0,10,元大-土城學府,2023-03-31,9822
2368,金像電,10,1,9,元大-土城學府,2023-03-31,9822
2535,達欣工,9,0,9,元大-土城學府,2023-03-31,9822
8024,佑華,10,1,9,元大-土城學府,2023-03-31,9822
8112,至上,9,0,9,元大-土城學府,2023-03-31,9822
3038,全台,9,1,8,元大-土城學府,2023-03-31,9822
6443,元晶,8,0,8,元大-土城學府,2023-03-31,9822
2388,威盛,11,4,7,元大-土城學府,2023-03-31,9822
4198,欣大健康,7,0,7,元大-土城學府,2023-03-31,9822
9945,潤泰新,6,0,6,元大-土城學府,2023-03-31,9822
2882,國泰金,6,0,6,元大-土城學府,2023-03-31,9822
3094,聯傑,6,0,6,元大-土城學府,2023-03-31,9822
5009,榮剛,6,0,6,元大-土城學府,2023-03-31,9822
1101,台泥,13,8,5,元大-土城學府,2023-03-31,9822
1909,榮成,5,0,5,元大-土城學府,2023-03-31,9822
2451,創見,5,0,5,元大-土城學府,2023-03-31,9822
2492,華新科,6,1,5,元大-土城學府,2023-03-31,9822
2705,六福,5,0,5,元大-土城學府,2023-03-31,9822
2834,臺企銀,13,8,5,元大-土城學府,2023-03-31,9822
3491,昇達科,10,5,5,元大-土城學府,2023-03-31,9822
8299,群聯,5,0,5,元大-土城學府,2023-03-31,9822
8926,台汽電,5,0,5,元大-土城學府,2023-03-31,9822
5258,虹堡,14,10,4,元大-土城學府,2023-03-31,9822
2301,光寶科,4,0,4,元大-土城學府,2023-03-31,9822
1529,樂事綠能,4,0,4,元大-土城學府,2023-03-31,9822
2882,國泰金,501,7,494,元大-土城學府,2023-04-06,9822
6235,華孚,225,95,130,元大-土城學府,2023-04-06,9822
2342,茂矽,66,2,64,元大-土城學府,2023-04-06,9822
2482,連宇,47,7,40,元大-土城學府,2023-04-06,9822
5864,致和證,40,0,40,元大-土城學府,2023-04-06,9822
6443,元晶,40,1,39,元大-土城學府,2023-04-06,9822
00923,群益台ESG低碳50,36,0,36,元大-土城學府,2023-04-06,9822
2891,中信金,39,4,35,元大-土城學府,2023-04-06,9822
2610,華航,37,4,33,元大-土城學府,2023-04-06,9822
2027,大成鋼,32,1,31,元大-土城學府,2023-04-06,9822
00882,中信中國高股息,49,20,29,元大-土城學府,2023-04-06,9822
00673R,期元大S＆P原油反1,29,0,29,元大-土城學府,2023-04-06,9822
3027,盛達,30,1,29,元大-土城學府,2023-04-06,9822
2897,王道銀行,30,4,26,元大-土城學府,2023-04-06,9822
1514,亞力,24,1,23,元大-土城學府,2023-04-06,9822
00878,國泰永續高股息,33,10,23,元大-土城學府,2023-04-06,9822
2603,長榮,24,2,22,元大-土城學府,2023-04-06,9822
2355,敬鵬,20,1,19,元大-土城學府,2023-04-06,9822
2449,京元電子,19,0,19,元大-土城學府,2023-04-06,9822
2618,長榮航,20,2,18,元大-土城學府,2023-04-06,9822
2886,兆豐金,19,2,17,元大-土城學府,2023-04-06,9822
3029,零壹,16,0,16,元大-土城學府,2023-04-06,9822
00680L,元大美債20正2,14,0,14,元大-土城學府,2023-04-06,9822
2228,劍麟,13,0,13,元大-土城學府,2023-04-06,9822
00632R,元大台灣50反1,23,10,13,元大-土城學府,2023-04-06,9822
2867,三商壽,13,0,13,元大-土城學府,2023-04-06,9822
8069,元太,18,6,12,元大-土城學府,2023-04-06,9822
2344,華邦電,67,55,12,元大-土城學府,2023-04-06,9822
00900,富邦特選高股息30,12,0,12,元大-土城學府,2023-04-06,9822
2337,旺宏,11,0,11,元大-土城學府,2023-04-06,9822
2705,六福,11,0,11,元大-土城學府,2023-04-06,9822
8121,越峰,11,0,11,元大-土城學府,2023-04-06,9822
2061,風青,10,0,10,元大-土城學府,2023-04-06,9822
2405,輔信,12,2,10,元大-土城學府,2023-04-06,9822
6179,亞通,10,0,10,元大-土城學府,2023-04-06,9822
1519,華城,21,13,8,元大-土城學府,2023-04-06,9822
00737,國泰AI+Robo,8,0,8,元大-土城學府,2023-04-06,9822
3466,德晉,8,0,8,元大-土城學府,2023-04-06,9822
6576,逸達,8,0,8,元大-土城學府,2023-04-06,9822
8409,商之器,10,2,8,元大-土城學府,2023-04-06,9822
00902,中信電池及儲能,8,0,8,元大-土城學府,2023-04-06,9822
3293,鈊象,7,0,7,元大-土城學府,2023-04-06,9822
3402,漢科,7,0,7,元大-土城學府,2023-04-06,9822
3511,矽瑪,7,0,7,元大-土城學府,2023-04-06,9822
2609,陽明,10,4,6,元大-土城學府,2023-04-06,9822
3037,欣興,13,7,6,元大-土城學府,2023-04-06,9822
00885,富邦越南,11,5,6,元大-土城學府,2023-04-06,9822
1101,台泥,7,1,6,元大-土城學府,2023-04-06,9822
2615,萬海,24,18,6,元大-土城學府,2023-04-06,9822
2634,漢翔,14,8,6,元大-土城學府,2023-04-06,9822
1304,台聚,100,1,99,元大-土城學府,2023-04-07,9822
2443,昶虹,60,0,60,元大-土城學府,2023-04-07,9822
6235,華孚,152,98,54,元大-土城學府,2023-04-07,9822
1305,華夏,50,1,49,元大-土城學府,2023-04-07,9822
6770,力積電,43,1,42,元大-土城學府,2023-04-07,9822
3027,盛達,44,3,41,元大-土城學府,2023-04-07,9822
00632R,元大台灣50反1,56,20,36,元大-土城學府,2023-04-07,9822
00772B,中信高評級公司債,33,1,32,元大-土城學府,2023-04-07,9822
8069,元太,35,6,29,元大-土城學府,2023-04-07,9822
2457,飛宏,51,24,27,元大-土城學府,2023-04-07,9822
3682,亞太電,20,0,20,元大-土城學府,2023-04-07,9822
00902,中信電池及儲能,18,0,18,元大-土城學府,2023-04-07,9822
2867,三商壽,24,6,18,元大-土城學府,2023-04-07,9822
3056,富華新,17,0,17,元大-土城學府,2023-04-07,9822
3231,緯創,23,6,17,元大-土城學府,2023-04-07,9822
5258,虹堡,16,0,16,元大-土城學府,2023-04-07,9822
00679B,元大美債20年,18,2,16,元大-土城學府,2023-04-07,9822
00712,復華富時不動產,15,0,15,元大-土城學府,2023-04-07,9822
00720B,元大投資級公司債,15,0,15,元大-土城學府,2023-04-07,9822
3037,欣興,21,6,15,元大-土城學府,2023-04-07,9822
2436,偉詮電,20,6,14,元大-土城學府,2023-04-07,9822
2208,台船,13,0,13,元大-土城學府,2023-04-07,9822
2359,所羅門,14,1,13,元大-土城學府,2023-04-07,9822
2884,玉山金,12,0,12,元大-土城學府,2023-04-07,9822
2371,大同,12,0,12,元大-土城學府,2023-04-07,9822
2498,宏達電,46,34,12,元大-土城學府,2023-04-07,9822
6290,良維,11,0,11,元大-土城學府,2023-04-07,9822
3673,TPK-KY,10,0,10,元大-土城學府,2023-04-07,9822
4977,眾達-KY,13,3,10,元大-土城學府,2023-04-07,9822
3481,群創,12,3,9,元大-土城學府,2023-04-07,9822
6209,今國光,10,1,9,元大-土城學府,2023-04-07,9822
5388,中磊,8,0,8,元大-土城學府,2023-04-07,9822
00637L,元大滬深300正2,42,34,8,元大-土城學府,2023-04-07,9822
3511,矽瑪,8,0,8,元大-土城學府,2023-04-07,9822
6288,聯嘉,8,0,8,元大-土城學府,2023-04-07,9822
6829,千附精密,9,1,8,元大-土城學府,2023-04-07,9822
1529,樂事綠能,7,0,7,元大-土城學府,2023-04-07,9822
4916,事欣科,8,1,7,元大-土城學府,2023-04-07,9822
6861,睿生光電,7,0,7,元大-土城學府,2023-04-07,9822
00713,元大台灣高息低波,6,0,6,元大-土城學府,2023-04-07,9822
4770,上品,6,0,6,元大-土城學府,2023-04-07,9822
8088,品安,8,2,6,元大-土城學府,2023-04-07,9822
2449,京元電子,6,0,6,元大-土城學府,2023-04-07,9822
2618,長榮航,11,5,6,元大-土城學府,2023-04-07,9822
2834,臺企銀,7,1,6,元大-土城學府,2023-04-07,9822
3518,柏騰,6,0,6,元大-土城學府,2023-04-07,9822
5211,蒙恬,6,0,6,元大-土城學府,2023-04-07,9822
6517,保勝光學,6,0,6,元大-土城學府,2023-04-07,9822
1536,和大,5,0,5,元大-土城學府,2023-04-07,9822
2471,資通,8,3,5,元大-土城學府,2023-04-07,9822
00878,國泰永續高股息,167,4,163,元大-土城學府,2023-04-10,9822
2457,飛宏,146,47,99,元大-土城學府,2023-04-10,9822
2883,凱基金,64,3,61,元大-土城學府,2023-04-10,9822
2609,陽明,44,8,36,元大-土城學府,2023-04-10,9822
00720B,元大投資級公司債,30,0,30,元大-土城學府,2023-04-10,9822
00712,復華富時不動產,26,0,26,元大-土城學府,2023-04-10,9822
3479,安勤,46,22,24,元大-土城學府,2023-04-10,9822
1442,名軒,21,0,21,元大-土城學府,2023-04-10,9822
1519,華城,25,4,21,元大-土城學府,2023-04-10,9822
6770,力積電,21,0,21,元大-土城學府,2023-04-10,9822
00902,中信電池及儲能,23,3,20,元大-土城學府,2023-04-10,9822
2443,昶虹,20,0,20,元大-土城學府,2023-04-10,9822
6180,橘子,20,0,20,元大-土城學府,2023-04-10,9822
2449,京元電子,15,1,14,元大-土城學府,2023-04-10,9822
2352,佳世達,13,0,13,元大-土城學府,2023-04-10,9822
3035,智原,12,0,12,元大-土城學府,2023-04-10,9822
2442,新美齊,11,0,11,元大-土城學府,2023-04-10,9822
3576,聯合再生,11,0,11,元大-土城學府,2023-04-10,9822
4162,智擎,12,1,11,元大-土城學府,2023-04-10,9822
6285,啟��,12,2,10,元大-土城學府,2023-04-10,9822
1909,榮成,12,2,10,元大-土城學府,2023-04-10,9822
2867,三商壽,12,2,10,元大-土城學府,2023-04-10,9822
5465,富驊,10,0,10,元大-土城學府,2023-04-10,9822
6435,大中,10,0,10,元大-土城學府,2023-04-10,9822
6606,建德工業,10,0,10,元大-土城學府,2023-04-10,9822
00713,元大台灣高息低波,10,0,10,元大-土城學府,2023-04-10,9822
4967,十銓,10,1,9,元大-土城學府,2023-04-10,9822
8409,商之器,9,0,9,元大-土城學府,2023-04-10,9822
8936,國統,11,2,9,元大-土城學府,2023-04-10,9822
00751B,元大AAA至A公司債,8,0,8,元大-土城學府,2023-04-10,9822
5403,中菲,9,1,8,元大-土城學府,2023-04-10,9822
2344,華邦電,14,7,7,元大-土城學府,2023-04-10,9822
2484,希華,7,0,7,元大-土城學府,2023-04-10,9822
5608,四維航,7,0,7,元大-土城學府,2023-04-10,9822
00679B,元大美債20年,23,17,6,元大-土城學府,2023-04-10,9822
00673R,期元大S＆P原油反1,6,0,6,元大-土城學府,2023-04-10,9822
1605,華新,22,16,6,元大-土城學府,2023-04-10,9822
2406,國碩,7,1,6,元大-土城學府,2023-04-10,9822
2637,慧洋-KY,18,12,6,元大-土城學府,2023-04-10,9822
4919,新唐,9,3,6,元大-土城學府,2023-04-10,9822
4958,臻鼎-KY,6,0,6,元大-土城學府,2023-04-10,9822
6147,頎邦,6,0,6,元大-土城學府,2023-04-10,9822
6155,鈞寶,10,4,6,元大-土城學府,2023-04-10,9822
6418,詠昇,6,0,6,元大-土城學府,2023-04-10,9822
6547,高端疫苗,6,0,6,元大-土城學府,2023-04-10,9822
8050,廣積,7,1,6,元大-土城學府,2023-04-10,9822
2886,兆豐金,5,0,5,元大-土城學府,2023-04-10,9822
00882,中信中國高股息,6,1,5,元大-土城學府,2023-04-10,9822
2317,鴻海,7,2,5,元大-土城學府,2023-04-10,9822
2323,中環,6,1,5,元大-土城學府,2023-04-10,9822
2634,漢翔,235,16,219,元大-土城學府,2023-04-11,9822
00632R,元大台灣50反1,150,3,147,元大-土城學府,2023-04-11,9822
2344,華邦電,163,43,120,元大-土城學府,2023-04-11,9822
2887,台新金,96,5,91,元大-土城學府,2023-04-11,9822
3046,建��,91,8,83,元大-土城學府,2023-04-11,9822
6175,立敦,56,1,55,元大-土城學府,2023-04-11,9822
1513,中興電,83,31,52,元大-土城學府,2023-04-11,9822
3518,柏騰,44,0,44,元大-土城學府,2023-04-11,9822
00712,復華富時不動產,43,0,43,元大-土城學府,2023-04-11,9822
1618,合機,43,2,41,元大-土城學府,2023-04-11,9822
6248,沛波,44,3,41,元大-土城學府,2023-04-11,9822
2845,遠東銀,40,0,40,元大-土城學府,2023-04-11,9822
5222,全訊,31,1,30,元大-土城學府,2023-04-11,9822
2457,飛宏,92,63,29,元大-土城學府,2023-04-11,9822
2609,陽明,30,2,28,元大-土城學府,2023-04-11,9822
00679B,元大美債20年,25,0,25,元大-土城學府,2023-04-11,9822
3094,聯傑,23,0,23,元大-土城學府,2023-04-11,9822
6443,元晶,27,5,22,元大-土城學府,2023-04-11,9822
6116,彩晶,21,0,21,元大-土城學府,2023-04-11,9822
2443,昶虹,20,0,20,元大-土城學府,2023-04-11,9822
6570,維田,20,0,20,元大-土城學府,2023-04-11,9822
00753L,中信中國50正2,20,1,19,元大-土城學府,2023-04-11,9822
5243,乙盛-KY,20,1,19,元大-土城學府,2023-04-11,9822
8097,常珵,21,4,17,元大-土城學府,2023-04-11,9822
00673R,期元大S＆P原油反1,15,0,15,元大-土城學府,2023-04-11,9822
3027,盛達,15,1,14,元大-土城學府,2023-04-11,9822
3483,力致,14,0,14,元大-土城學府,2023-04-11,9822
5608,四維航,14,0,14,元大-土城學府,2023-04-11,9822
2208,台船,13,0,13,元大-土城學府,2023-04-11,9822
2515,中工,15,2,13,元大-土城學府,2023-04-11,9822
6266,泰詠,20,7,13,元大-土城學府,2023-04-11,9822
1313,聯成,12,0,12,元大-土城學府,2023-04-11,9822
3029,零壹,12,0,12,元大-土城學府,2023-04-11,9822
3013,晟銘電,11,0,11,元大-土城學府,2023-04-11,9822
1442,名軒,10,0,10,元大-土城學府,2023-04-11,9822
5309,系統電,11,1,10,元大-土城學府,2023-04-11,9822
5351,鈺創,12,2,10,元大-土城學府,2023-04-11,9822
1609,大亞,24,14,10,元大-土城學府,2023-04-11,9822
8050,廣積,9,0,9,元大-土城學府,2023-04-11,9822
00772B,中信高評級公司債,12,3,9,元大-土城學府,2023-04-11,9822
1336,台翰,10,1,9,元大-土城學府,2023-04-11,9822
00680L,元大美債20正2,11,2,9,元大-土城學府,2023-04-11,9822
3479,安勤,20,11,9,元大-土城學府,2023-04-11,9822
3682,亞太電,10,1,9,元大-土城學府,2023-04-11,9822
6209,今國光,13,4,9,元大-土城學府,2023-04-11,9822
2303,聯電,8,0,8,元大-土城學府,2023-04-11,9822
2402,毅嘉,10,2,8,元大-土城學府,2023-04-11,9822
3217,優群,8,0,8,元大-土城學府,2023-04-11,9822
6733,博晟生醫,8,0,8,元大-土城學府,2023-04-11,9822
8261,富鼎,24,16,8,元大-土城學府,2023-04-11,9822
9105,泰金寶-DR,535,0,535,元大-土城學府,2023-04-12,9822
6248,沛波,65,2,63,元大-土城學府,2023-04-12,9822
1314,中石化,79,18,61,元大-土城學府,2023-04-12,9822
1513,中興電,99,55,44,元大-土城學府,2023-04-12,9822
00753L,中信中國50正2,40,0,40,元大-土城學府,2023-04-12,9822
2634,漢翔,136,97,39,元大-土城學府,2023-04-12,9822
00712,復華富時不動產,27,1,26,元大-土城學府,2023-04-12,9822
5209,新鼎,26,2,24,元大-土城學府,2023-04-12,9822
2329,華泰,29,5,24,元大-土城學府,2023-04-12,9822
4129,聯合,23,0,23,元大-土城學府,2023-04-12,9822
8028,昇陽半導體,24,1,23,元大-土城學府,2023-04-12,9822
9962,有益,23,0,23,元大-土城學府,2023-04-12,9822
2443,昶虹,21,0,21,元大-土城學府,2023-04-12,9822
2387,精元,21,0,21,元大-土城學府,2023-04-12,9822
1101,台泥,20,0,20,元大-土城學府,2023-04-12,9822
4127,天良,20,0,20,元大-土城學府,2023-04-12,9822
00878,國泰永續高股息,28,9,19,元大-土城學府,2023-04-12,9822
00902,中信電池及儲能,18,0,18,元大-土城學府,2023-04-12,9822
2539,櫻花建,18,0,18,元大-土城學府,2023-04-12,9822
3317,尼克森,18,0,18,元大-土城學府,2023-04-12,9822
2317,鴻海,19,1,18,元大-土城學府,2023-04-12,9822
4155,訊映,17,0,17,元大-土城學府,2023-04-12,9822
3029,零壹,16,0,16,元大-土城學府,2023-04-12,9822
6175,立敦,40,24,16,元大-土城學府,2023-04-12,9822
00679B,元大美債20年,16,1,15,元大-土城學府,2023-04-12,9822
5521,工信,48,35,13,元大-土城學府,2023-04-12,9822
2303,聯電,17,5,12,元大-土城學府,2023-04-12,9822
2881,富邦金,12,0,12,元大-土城學府,2023-04-12,9822
4961,天鈺,15,3,12,元大-土城學府,2023-04-12,9822
2330,台積電,13,1,12,元大-土城學府,2023-04-12,9822
8933,愛地雅,12,1,11,元大-土城學府,2023-04-12,9822
1217,愛之味,10,0,10,元大-土城學府,2023-04-12,9822
1342,八貫,10,0,10,元大-土城學府,2023-04-12,9822
1536,和大,15,5,10,元大-土城學府,2023-04-12,9822
2834,臺企銀,10,0,10,元大-土城學府,2023-04-12,9822
2882,國泰金,10,0,10,元大-土城學府,2023-04-12,9822
3710,連展投控,13,3,10,元大-土城學府,2023-04-12,9822
5009,榮剛,54,44,10,元大-土城學府,2023-04-12,9822
00720B,元大投資級公司債,10,1,9,元大-土城學府,2023-04-12,9822
6285,啟��,10,1,9,元大-土城學府,2023-04-12,9822
3481,群創,27,18,9,元大-土城學府,2023-04-12,9822
6150,撼訊,10,1,9,元大-土城學府,2023-04-12,9822
8261,富鼎,13,4,9,元大-土城學府,2023-04-12,9822
6606,建德工業,10,1,9,元大-土城學府,2023-04-12,9822
6767,台微醫,9,0,9,元大-土城學府,2023-04-12,9822
3005,神基,9,0,9,元大-土城學府,2023-04-12,9822
1504,東元,24,16,8,元大-土城學府,2023-04-12,9822
2344,華邦電,10,2,8,元大-土城學府,2023-04-12,9822
6863,永道-KY,10,2,8,元大-土城學府,2023-04-12,9822
6188,廣明,8,1,7,元大-土城學府,2023-04-12,9822
00712,復華富時不動產,214,7,207,元大-土城學府,2023-04-13,9822
1514,亞力,145,19,126,元大-土城學府,2023-04-13,9822
5009,榮剛,142,27,115,元大-土城學府,2023-04-13,9822
6266,泰詠,104,2,102,元大-土城學府,2023-04-13,9822
6248,沛波,86,2,84,元大-土城學府,2023-04-13,9822
9105,泰金寶-DR,47,0,47,元大-土城學府,2023-04-13,9822
3576,聯合再生,66,20,46,元大-土城學府,2023-04-13,9822
2515,中工,140,100,40,元大-土城學府,2023-04-13,9822
2603,長榮,39,3,36,元大-土城學府,2023-04-13,9822
1513,中興電,59,25,34,元大-土城學府,2023-04-13,9822
3231,緯創,39,6,33,元大-土城學府,2023-04-13,9822
1314,中石化,40,12,28,元大-土城學府,2023-04-13,9822
6234,高僑,50,27,23,元大-土城學府,2023-04-13,9822
1504,東元,53,32,21,元大-土城學府,2023-04-13,9822
8390,金益鼎,21,0,21,元大-土城學府,2023-04-13,9822
00753L,中信中國50正2,20,0,20,元大-土城學府,2023-04-13,9822
2438,翔耀,19,0,19,元大-土城學府,2023-04-13,9822
0056,元大高股息,20,1,19,元大-土城學府,2023-04-13,9822
1442,名軒,19,0,19,元大-土城學府,2023-04-13,9822
3006,晶豪科,30,12,18,元大-土城學府,2023-04-13,9822
2867,三商壽,21,3,18,元大-土城學府,2023-04-13,9822
2401,凌陽,18,0,18,元大-土城學府,2023-04-13,9822
6116,彩晶,28,10,18,元大-土城學府,2023-04-13,9822
3029,零壹,19,2,17,元大-土城學府,2023-04-13,9822
1605,華新,30,13,17,元大-土城學府,2023-04-13,9822
3094,聯傑,16,0,16,元大-土城學府,2023-04-13,9822
4147,中裕,21,6,15,元大-土城學府,2023-04-13,9822
00900,富邦特選高股息30,14,0,14,元大-土城學府,2023-04-13,9822
2481,強茂,13,0,13,元大-土城學府,2023-04-13,9822
3711,日月光投控,17,4,13,元大-土城學府,2023-04-13,9822
4919,新唐,12,0,12,元大-土城學府,2023-04-13,9822
2344,華邦電,27,15,12,元大-土城學府,2023-04-13,9822
4130,健亞,12,0,12,元大-土城學府,2023-04-13,9822
8016,矽創,11,0,11,元大-土城學府,2023-04-13,9822
2388,威盛,27,16,11,元大-土城學府,2023-04-13,9822
6148,驊宏資,11,0,11,元大-土城學府,2023-04-13,9822
2382,廣達,12,1,11,元大-土城學府,2023-04-13,9822
0050,元大台灣50,11,0,11,元大-土城學府,2023-04-13,9822
6182,合晶,10,0,10,元大-土城學府,2023-04-13,9822
00673R,期元大S＆P原油反1,20,10,10,元大-土城學府,2023-04-13,9822
2314,台揚,10,0,10,元大-土城學府,2023-04-13,9822
6443,元晶,10,0,10,元大-土城學府,2023-04-13,9822
6509,聚和,10,0,10,元大-土城學府,2023-04-13,9822
2329,華泰,16,7,9,元大-土城學府,2023-04-13,9822
1503,士電,19,10,9,元大-土城學府,2023-04-13,9822
3035,智原,13,4,9,元大-土城學府,2023-04-13,9822
5371,中光電,9,0,9,元大-土城學府,2023-04-13,9822
6282,康舒,10,1,9,元大-土城學府,2023-04-13,9822
8088,品安,10,1,9,元大-土城學府,2023-04-13,9822
6770,力積電,11,3,8,元大-土城學府,2023-04-13,9822
2634,漢翔,458,91,367,元大-土城學府,2023-04-14,9822
00632R,元大台灣50反1,145,20,125,元大-土城學府,2023-04-14,9822
3481,群創,125,3,122,元大-土城學府,2023-04-14,9822
00679B,元大美債20年,58,0,58,元大-土城學府,2023-04-14,9822
00712,復華富時不動產,50,0,50,元大-土城學府,2023-04-14,9822
2382,廣達,53,10,43,元大-土城學府,2023-04-14,9822
3078,僑威,41,0,41,元大-土城學府,2023-04-14,9822
6266,泰詠,52,12,40,元大-土城學府,2023-04-14,9822
0056,元大高股息,42,8,34,元大-土城學府,2023-04-14,9822
6175,立敦,32,1,31,元大-土城學府,2023-04-14,9822
00878,國泰永續高股息,43,13,30,元大-土城學府,2023-04-14,9822
6248,沛波,29,1,28,元大-土城學府,2023-04-14,9822
00713,元大台灣高息低波,25,0,25,元大-土城學府,2023-04-14,9822
2368,金像電,22,0,22,元大-土城學府,2023-04-14,9822
5309,系統電,22,0,22,元大-土城學府,2023-04-14,9822
2009,第一銅,24,6,18,元大-土城學府,2023-04-14,9822
1514,亞力,48,31,17,元大-土城學府,2023-04-14,9822
00673R,期元大S＆P原油反1,15,0,15,元大-土城學府,2023-04-14,9822
00706L,期元大S＆P日圓正2,15,0,15,元大-土城學府,2023-04-14,9822
3518,柏騰,15,0,15,元大-土城學府,2023-04-14,9822
6245,立端,18,3,15,元大-土城學府,2023-04-14,9822
2610,華航,23,9,14,元大-土城學府,2023-04-14,9822
2034,允強,12,0,12,元大-土城學府,2023-04-14,9822
2208,台船,42,30,12,元大-土城學府,2023-04-14,9822
6756,威鋒電子,14,2,12,元大-土城學府,2023-04-14,9822
2027,大成鋼,11,0,11,元大-土城學府,2023-04-14,9822
2329,華泰,18,7,11,元大-土城學府,2023-04-14,9822
2413,環科,17,6,11,元大-土城學府,2023-04-14,9822
2303,聯電,10,0,10,元大-土城學府,2023-04-14,9822
3211,順達,10,0,10,元大-土城學府,2023-04-14,9822
6205,詮欣,11,1,10,元大-土城學府,2023-04-14,9822
8222,寶一,24,14,10,元大-土城學府,2023-04-14,9822
6592,和潤企業,10,0,10,元大-土城學府,2023-04-14,9822
1336,台翰,9,0,9,元大-土城學府,2023-04-14,9822
2834,臺企銀,10,1,9,元大-土城學府,2023-04-14,9822
4968,立積,14,5,9,元大-土城學府,2023-04-14,9822
5371,中光電,12,3,9,元大-土城學府,2023-04-14,9822
1319,東陽,8,0,8,元大-土城學府,2023-04-14,9822
00688L,國泰20年美債正2,8,0,8,元大-土城學府,2023-04-14,9822
4114,健喬,8,0,8,元大-土城學府,2023-04-14,9822
4946,辣椒,8,0,8,元大-土城學府,2023-04-14,9822
8104,錸寶,12,4,8,元大-土城學府,2023-04-14,9822
00772B,中信高評級公司債,8,0,8,元大-土城學府,2023-04-14,9822
1584,精剛,82,75,7,元大-土城學府,2023-04-14,9822
3545,敦泰,9,2,7,元大-土城學府,2023-04-14,9822
2645,長榮航太,7,1,6,元大-土城學府,2023-04-14,9822
3231,緯創,20,14,6,元大-土城學府,2023-04-14,9822
2388,威盛,14,8,6,元大-土城學府,2023-04-14,9822
2402,毅嘉,21,15,6,元大-土城學府,2023-04-14,9822
3715,定穎投控,6,0,6,元大-土城學府,2023-04-14,9822
2457,飛宏,119,30,89,元大-土城學府,2023-04-17,9822
00679B,元大美債20年,88,1,87,元大-土城學府,2023-04-17,9822
00712,復華富時不動產,61,0,61,元大-土城學府,2023-04-17,9822
2206,三陽工業,65,8,57,元大-土城學府,2023-04-17,9822
3032,偉訓,41,1,40,元大-土城學府,2023-04-17,9822
2610,華航,46,7,39,元大-土城學府,2023-04-17,9822
2530,華建,32,0,32,元大-土城學府,2023-04-17,9822
2002,中鋼,31,0,31,元大-土城學府,2023-04-17,9822
4707,磐亞,31,0,31,元大-土城學府,2023-04-17,9822
6163,華電網,26,3,23,元大-土城學府,2023-04-17,9822
00687B,國泰20年美債,22,0,22,元大-土城學府,2023-04-17,9822
2867,三商壽,21,0,21,元大-土城學府,2023-04-17,9822
1313,聯成,20,0,20,元大-土城學府,2023-04-17,9822
1789,神隆,20,0,20,元大-土城學府,2023-04-17,9822
2208,台船,44,25,19,元大-土城學府,2023-04-17,9822
6123,上奇,18,0,18,元大-土城學府,2023-04-17,9822
6443,元晶,20,2,18,元大-土城學府,2023-04-17,9822
3043,科風,17,0,17,元大-土城學府,2023-04-17,9822
6547,高端疫苗,31,15,16,元大-土城學府,2023-04-17,9822
3684,榮昌,18,4,14,元大-土城學府,2023-04-17,9822
3481,群創,15,2,13,元大-土城學府,2023-04-17,9822
2359,所羅門,27,14,13,元大-土城學府,2023-04-17,9822
00713,元大台灣高息低波,12,0,12,元大-土城學府,2023-04-17,9822
6245,立端,15,3,12,元大-土城學府,2023-04-17,9822
6285,啟��,15,3,12,元大-土城學府,2023-04-17,9822
8249,菱光,13,1,12,元大-土城學府,2023-04-17,9822
4968,立積,18,6,12,元大-土城學府,2023-04-17,9822
1444,力麗,13,1,12,元大-土城學府,2023-04-17,9822
6223,旺矽,11,0,11,元大-土城學府,2023-04-17,9822
5258,虹堡,17,6,11,元大-土城學府,2023-04-17,9822
2382,廣達,10,0,10,元大-土城學府,2023-04-17,9822
6142,友勁,10,0,10,元大-土城學府,2023-04-17,9822
00857B,永豐20年美公債,10,0,10,元大-土城學府,2023-04-17,9822
1587,吉茂,10,0,10,元大-土城學府,2023-04-17,9822
1905,華紙,10,0,10,元大-土城學府,2023-04-17,9822
1906,寶隆,10,0,10,元大-土城學府,2023-04-17,9822
2409,友達,10,0,10,元大-土城學府,2023-04-17,9822
2851,中再保,10,0,10,元大-土城學府,2023-04-17,9822
3673,TPK-KY,14,4,10,元大-土城學府,2023-04-17,9822
1605,華新,29,20,9,元大-土城學府,2023-04-17,9822
00891,中信關鍵半導體,9,0,9,元大-土城學府,2023-04-17,9822
1336,台翰,10,1,9,元大-土城學府,2023-04-17,9822
3071,協禧,9,0,9,元大-土城學府,2023-04-17,9822
8996,高力,10,1,9,元大-土城學府,2023-04-17,9822
2609,陽明,35,27,8,元大-土城學府,2023-04-17,9822
1229,聯華,8,0,8,元大-土城學府,2023-04-17,9822
8234,新漢,8,0,8,元大-土城學府,2023-04-17,9822
9958,世紀鋼,8,0,8,元大-土城學府,2023-04-17,9822
1517,利奇,10,2,8,元大-土城學府,2023-04-17,9822
2329,華泰,13,5,8,元大-土城學府,2023-04-17,9822
2457,飛宏,289,95,194,元大-土城學府,2023-04-18,9822
8033,雷虎,65,15,50,元大-土城學府,2023-04-18,9822
00679B,元大美債20年,50,0,50,元大-土城學府,2023-04-18,9822
1444,力麗,56,22,34,元大-土城學府,2023-04-18,9822
2609,陽明,37,5,32,元大-土城學府,2023-04-18,9822
2392,正崴,31,0,31,元大-土城學府,2023-04-18,9822
2313,華通,43,13,30,元大-土城學府,2023-04-18,9822
2515,中工,37,9,28,元大-土城學府,2023-04-18,9822
00720B,元大投資級公司債,24,0,24,元大-土城學府,2023-04-18,9822
2208,台船,27,3,24,元大-土城學府,2023-04-18,9822
3362,先進光,23,1,22,元大-土城學府,2023-04-18,9822
1442,名軒,22,1,21,元大-土城學府,2023-04-18,9822
1519,華城,38,17,21,元大-土城學府,2023-04-18,9822
1605,華新,31,10,21,元大-土城學府,2023-04-18,9822
00772B,中信高評級公司債,18,0,18,元大-土城學府,2023-04-18,9822
2867,三商壽,18,1,17,元大-土城學府,2023-04-18,9822
2429,銘旺科,17,0,17,元大-土城學府,2023-04-18,9822
6142,友勁,16,0,16,元大-土城學府,2023-04-18,9822
2002,中鋼,15,0,15,元大-土城學府,2023-04-18,9822
3029,零壹,17,3,14,元大-土城學府,2023-04-18,9822
4113,聯上,14,0,14,元大-土城學府,2023-04-18,9822
2498,宏達電,17,4,13,元大-土城學府,2023-04-18,9822
00900,富邦特選高股息30,13,1,12,元大-土城學府,2023-04-18,9822
3206,志豐,12,0,12,元大-土城學府,2023-04-18,9822
4968,立積,14,2,12,元大-土城學府,2023-04-18,9822
5011,久陽,12,0,12,元大-土城學府,2023-04-18,9822
1604,聲寶,11,0,11,元大-土城學府,2023-04-18,9822
3005,神基,14,3,11,元大-土城學府,2023-04-18,9822
6209,今國光,16,5,11,元大-土城學府,2023-04-18,9822
1529,樂事綠能,32,22,10,元大-土城學府,2023-04-18,9822
1304,台聚,10,0,10,元大-土城學府,2023-04-18,9822
1906,寶隆,10,0,10,元大-土城學府,2023-04-18,9822
2402,毅嘉,12,2,10,元大-土城學府,2023-04-18,9822
2722,夏都,10,0,10,元大-土城學府,2023-04-18,9822
2891,中信金,14,4,10,元大-土城學府,2023-04-18,9822
3025,星通,26,16,10,元大-土城學府,2023-04-18,9822
3221,台嘉碩,10,0,10,元大-土城學府,2023-04-18,9822
4510,高鋒,10,0,10,元大-土城學府,2023-04-18,9822
6248,沛波,10,0,10,元大-土城學府,2023-04-18,9822
6770,力積電,20,10,10,元大-土城學府,2023-04-18,9822
2634,漢翔,168,159,9,元大-土城學府,2023-04-18,9822
2888,新光金,10,0,10,元大-土城學府,2023-04-18,9822
1609,大亞,20,11,9,元大-土城學府,2023-04-18,9822
0056,元大高股息,14,5,9,元大-土城學府,2023-04-18,9822
2349,錸德,9,0,9,元大-土城學府,2023-04-18,9822
3062,建漢,12,3,9,元大-土城學府,2023-04-18,9822
4707,磐亞,9,0,9,元大-土城學府,2023-04-18,9822
5009,榮剛,15,6,9,元大-土城學府,2023-04-18,9822
5258,虹堡,10,1,9,元大-土城學府,2023-04-18,9822
6245,立端,9,0,9,元大-土城學府,2023-04-18,9822
00888,永豐台灣ESG,77,5,72,元大-土城學府,2023-04-19,9822
00912,中信臺灣智慧50,69,0,69,元大-土城學府,2023-04-19,9822
3037,欣興,63,0,63,元大-土城學府,2023-04-19,9822
3481,群創,82,31,51,元大-土城學府,2023-04-19,9822
2208,台船,46,7,39,元大-土城學府,2023-04-19,9822
2409,友達,46,10,36,元大-土城學府,2023-04-19,9822
4971,IET-KY,35,0,35,元大-土城學府,2023-04-19,9822
2457,飛宏,69,35,34,元大-土城學府,2023-04-19,9822
2498,宏達電,43,9,34,元大-土城學府,2023-04-19,9822
3056,富華新,28,0,28,元大-土城學府,2023-04-19,9822
00679B,元大美債20年,25,0,25,元大-土城學府,2023-04-19,9822
1906,寶隆,25,0,25,元大-土城學府,2023-04-19,9822
2887,台新金,30,5,25,元大-土城學府,2023-04-19,9822
2610,華航,32,8,24,元大-土城學府,2023-04-19,9822
6125,廣運,25,2,23,元大-土城學府,2023-04-19,9822
00664R,國泰臺灣加權反1,27,5,22,元大-土城學府,2023-04-19,9822
1727,中華化,21,1,20,元大-土城學府,2023-04-19,9822
2515,中工,24,4,20,元大-土城學府,2023-04-19,9822
00687B,國泰20年美債,19,2,17,元大-土城學府,2023-04-19,9822
1802,台玻,24,8,16,元大-土城學府,2023-04-19,9822
8109,博大,16,0,16,元大-土城學府,2023-04-19,9822
00683L,期元大美元指正2,15,0,15,元大-土城學府,2023-04-19,9822
2402,毅嘉,24,9,15,元大-土城學府,2023-04-19,9822
3003,健和興,17,2,15,元大-土城學府,2023-04-19,9822
2722,夏都,15,1,14,元大-土城學府,2023-04-19,9822
3684,榮昌,14,0,14,元大-土城學府,2023-04-19,9822
0050,元大台灣50,13,0,13,元大-土城學府,2023-04-19,9822
2303,聯電,16,3,13,元大-土城學府,2023-04-19,9822
00857B,永豐20年美公債,12,0,12,元大-土城學府,2023-04-19,9822
1503,士電,18,6,12,元大-土城學府,2023-04-19,9822
1810,和成,40,29,11,元大-土城學府,2023-04-19,9822
2002,中鋼,14,3,11,元大-土城學府,2023-04-19,9822
4919,新唐,12,1,11,元大-土城學府,2023-04-19,9822
5371,中光電,11,0,11,元大-土城學府,2023-04-19,9822
6235,華孚,32,21,11,元大-土城學府,2023-04-19,9822
8088,品安,11,0,11,元大-土城學府,2023-04-19,9822
00904,新光臺灣半導體30,10,0,10,元大-土城學府,2023-04-19,9822
1447,力鵬,10,0,10,元大-土城學府,2023-04-19,9822
3430,奇鈦科,10,0,10,元大-土城學府,2023-04-19,9822
9136,巨騰-DR,10,0,10,元大-土城學府,2023-04-19,9822
6538,倉和,9,0,9,元大-土城學府,2023-04-19,9822
2014,中鴻,10,1,9,元大-土城學府,2023-04-19,9822
2601,益航,9,0,9,元大-土城學府,2023-04-19,9822
3221,台嘉碩,10,1,9,元大-土城學府,2023-04-19,9822
6202,盛群,9,0,9,元大-土城學府,2023-04-19,9822
6829,千附精密,12,3,9,元大-土城學府,2023-04-19,9822
8050,廣積,10,1,9,元大-土城學府,2023-04-19,9822
00891,中信關鍵半導體,9,0,9,元大-土城學府,2023-04-19,9822
6806,森崴能源,11,2,9,元大-土城學府,2023-04-19,9822
1104,環泥,8,0,8,元大-土城學府,2023-04-19,9822
5864,致和證,40,0,40,元大-土城學府,2023-04-20,9822
6443,元晶,52,12,40,元大-土城學府,2023-04-20,9822
00888,永豐台灣ESG,39,0,39,元大-土城學府,2023-04-20,9822
2867,三商壽,38,0,38,元大-土城學府,2023-04-20,9822
2634,漢翔,103,67,36,元大-土城學府,2023-04-20,9822
1522,堤維西,35,0,35,元大-土城學府,2023-04-20,9822
6244,茂迪,77,43,34,元大-土城學府,2023-04-20,9822
00878,國泰永續高股息,48,15,33,元大-土城學府,2023-04-20,9822
2382,廣達,32,3,29,元大-土城學府,2023-04-20,9822
2481,強茂,28,1,27,元大-土城學府,2023-04-20,9822
6282,康舒,133,107,26,元大-土城學府,2023-04-20,9822
8033,雷虎,60,35,25,元大-土城學府,2023-04-20,9822
3712,永崴投控,46,23,23,元大-土城學府,2023-04-20,9822
6235,華孚,64,43,21,元大-土城學府,2023-04-20,9822
6266,泰詠,28,8,20,元大-土城學府,2023-04-20,9822
3078,僑威,20,1,19,元大-土城學府,2023-04-20,9822
2314,台揚,21,2,19,元大-土城學府,2023-04-20,9822
6015,宏遠證,21,2,19,元大-土城學府,2023-04-20,9822
2609,陽明,26,9,17,元大-土城學府,2023-04-20,9822
6590,普鴻,17,0,17,元大-土城學府,2023-04-20,9822
1460,宏遠,21,4,17,元大-土城學府,2023-04-20,9822
3231,緯創,35,19,16,元大-土城學府,2023-04-20,9822
5403,中菲,16,0,16,元大-土城學府,2023-04-20,9822
1517,利奇,15,0,15,元大-土城學府,2023-04-20,9822
2535,達欣工,14,0,14,元大-土城學府,2023-04-20,9822
4164,承業醫,15,1,14,元大-土城學府,2023-04-20,9822
8935,邦泰,14,0,14,元大-土城學府,2023-04-20,9822
2498,宏達電,34,21,13,元大-土城學府,2023-04-20,9822
4147,中裕,27,14,13,元大-土城學府,2023-04-20,9822
2303,聯電,11,0,11,元大-土城學府,2023-04-20,9822
2457,飛宏,16,5,11,元大-土城學府,2023-04-20,9822
1101,台泥,13,2,11,元大-土城學府,2023-04-20,9822
3003,健和興,12,1,11,元大-土城學府,2023-04-20,9822
1760,寶齡富錦,13,2,11,元大-土城學府,2023-04-20,9822
5388,中磊,11,0,11,元大-土城學府,2023-04-20,9822
00918,大華優利高填息30,10,0,10,元大-土城學府,2023-04-20,9822
2022,聚亨,10,0,10,元大-土城學府,2023-04-20,9822
2429,銘旺科,10,0,10,元大-土城學府,2023-04-20,9822
3483,力致,10,0,10,元大-土城學府,2023-04-20,9822
4167,松瑞藥,10,0,10,元大-土城學府,2023-04-20,9822
5521,工信,10,0,10,元大-土城學府,2023-04-20,9822
1605,華新,12,2,10,元大-土城學府,2023-04-20,9822
2454,聯發科,11,2,9,元大-土城學府,2023-04-20,9822
2754,亞洲藏壽司,14,5,9,元大-土城學府,2023-04-20,9822
2892,第一金,15,6,9,元大-土城學府,2023-04-20,9822
3284,太普高,10,1,9,元大-土城學府,2023-04-20,9822
6148,驊宏資,14,5,9,元大-土城學府,2023-04-20,9822
6218,豪勉,12,3,9,元大-土城學府,2023-04-20,9822
6288,聯嘉,17,8,9,元大-土城學府,2023-04-20,9822
4961,天鈺,11,2,9,元大-土城學府,2023-04-20,9822
8933,愛地雅,134,0,134,元大-土城學府,2023-04-21,9822
6245,立端,130,0,130,元大-土城學府,2023-04-21,9822
3481,群創,113,22,91,元大-土城學府,2023-04-21,9822
2867,三商壽,60,0,60,元大-土城學府,2023-04-21,9822
1909,榮成,64,23,41,元大-土城學府,2023-04-21,9822
3078,僑威,43,3,40,元大-土城學府,2023-04-21,9822
5521,工信,35,0,35,元大-土城學府,2023-04-21,9822
4175,杏一,30,3,27,元大-土城學府,2023-04-21,9822
00751B,元大AAA至A公司債,25,0,25,元大-土城學府,2023-04-21,9822
2609,陽明,28,6,22,元大-土城學府,2023-04-21,9822
2314,台揚,24,2,22,元大-土城學府,2023-04-21,9822
2748,雲品,23,1,22,元大-土城學府,2023-04-21,9822
2303,聯電,23,1,22,元大-土城學府,2023-04-21,9822
00720B,元大投資級公司債,21,0,21,元大-土城學府,2023-04-21,9822
1611,中電,20,0,20,元大-土城學府,2023-04-21,9822
3071,協禧,45,25,20,元大-土城學府,2023-04-21,9822
5864,致和證,20,0,20,元大-土城學府,2023-04-21,9822
1709,和益,18,0,18,元大-土城學府,2023-04-21,9822
1907,永豐餘,57,40,17,元大-土城學府,2023-04-21,9822
6770,力積電,24,8,16,元大-土城學府,2023-04-21,9822
5009,榮剛,29,14,15,元大-土城學府,2023-04-21,9822
2615,萬海,14,1,13,元大-土城學府,2023-04-21,9822
1217,愛之味,13,0,13,元大-土城學府,2023-04-21,9822
2913,農林,21,9,12,元大-土城學府,2023-04-21,9822
3029,零壹,26,14,12,元大-土城學府,2023-04-21,9822
4968,立積,24,12,12,元大-土城學府,2023-04-21,9822
3035,智原,13,2,11,元大-土城學府,2023-04-21,9822
2382,廣達,18,7,11,元大-土城學府,2023-04-21,9822
3710,連展投控,11,0,11,元大-土城學府,2023-04-21,9822
6218,豪勉,18,7,11,元大-土城學府,2023-04-21,9822
2884,玉山金,10,0,10,元大-土城學府,2023-04-21,9822
00781B,國泰A級科技債,10,0,10,元大-土城學府,2023-04-21,9822
3032,偉訓,17,7,10,元大-土城學府,2023-04-21,9822
4714,永捷,10,0,10,元大-土城學府,2023-04-21,9822
6163,華電網,18,8,10,元大-土城學府,2023-04-21,9822
6547,高端疫苗,16,6,10,元大-土城學府,2023-04-21,9822
4919,新唐,20,11,9,元大-土城學府,2023-04-21,9822
2409,友達,11,2,9,元大-土城學府,2023-04-21,9822
00900,富邦特選高股息30,10,1,9,元大-土城學府,2023-04-21,9822
1524,耿鼎,11,3,8,元大-土城學府,2023-04-21,9822
2645,長榮航太,16,8,8,元大-土城學府,2023-04-21,9822
3430,奇鈦科,8,0,8,元大-土城學府,2023-04-21,9822
3576,聯合再生,15,7,8,元大-土城學府,2023-04-21,9822
6830,汎銓,8,0,8,元大-土城學府,2023-04-21,9822
00923,群益台ESG低碳50,7,0,7,元大-土城學府,2023-04-21,9822
00637L,元大滬深300正2,7,0,7,元大-土城學府,2023-04-21,9822
1760,寶齡富錦,18,11,7,元大-土城學府,2023-04-21,9822
2027,大成鋼,8,1,7,元大-土城學府,2023-04-21,9822
3264,欣銓,8,1,7,元大-土城學府,2023-04-21,9822
4707,磐亞,7,0,7,元大-土城學府,2023-04-21,9822
00712,復華富時不動產,113,0,113,元大-土城學府,2023-04-24,9822
1907,永豐餘,136,42,94,元大-土城學府,2023-04-24,9822
00632R,元大台灣50反1,70,0,70,元大-土城學府,2023-04-24,9822
00878,國泰永續高股息,67,2,65,元大-土城學府,2023-04-24,9822
6244,茂迪,66,11,55,元大-土城學府,2023-04-24,9822
00888,永豐台灣ESG,76,24,52,元大-土城學府,2023-04-24,9822
2208,台船,59,7,52,元大-土城學府,2023-04-24,9822
2031,新光鋼,75,25,50,元大-土城學府,2023-04-24,9822
2409,友達,43,0,43,元大-土城學府,2023-04-24,9822
00902,中信電池及儲能,43,0,43,元大-土城學府,2023-04-24,9822
00637L,元大滬深300正2,77,35,42,元大-土城學府,2023-04-24,9822
00772B,中信高評級公司債,39,10,29,元大-土城學府,2023-04-24,9822
2913,農林,51,24,27,元大-土城學府,2023-04-24,9822
1611,中電,23,0,23,元大-土城學府,2023-04-24,9822
3576,聯合再生,21,0,21,元大-土城學府,2023-04-24,9822
2867,三商壽,40,20,20,元大-土城學府,2023-04-24,9822
6116,彩晶,18,0,18,元大-土城學府,2023-04-24,9822
6443,元晶,24,6,18,元大-土城學府,2023-04-24,9822
1711,永光,23,7,16,元大-土城學府,2023-04-24,9822
5371,中光電,28,13,15,元大-土城學府,2023-04-24,9822
2303,聯電,22,7,15,元大-土城學府,2023-04-24,9822
00882,中信中國高股息,15,0,15,元大-土城學府,2023-04-24,9822
2324,仁寶,12,0,12,元大-土城學府,2023-04-24,9822
2498,宏達電,17,6,11,元大-土城學府,2023-04-24,9822
3062,建漢,11,0,11,元大-土城學府,2023-04-24,9822
4960,誠美材,10,0,10,元大-土城學府,2023-04-24,9822
2023,燁輝,12,2,10,元大-土城學府,2023-04-24,9822
2061,風青,10,0,10,元大-土城學府,2023-04-24,9822
2801,彰銀,10,0,10,元大-土城學府,2023-04-24,9822
4707,磐亞,9,0,9,元大-土城學府,2023-04-24,9822
6167,久正,11,2,9,元大-土城學府,2023-04-24,9822
2421,建準,8,0,8,元大-土城學府,2023-04-24,9822
2482,連宇,12,4,8,元大-土城學府,2023-04-24,9822
8088,品安,11,3,8,元大-土城學府,2023-04-24,9822
1605,華新,8,1,7,元大-土城學府,2023-04-24,9822
2408,南亞科,7,0,7,元大-土城學府,2023-04-24,9822
2392,正崴,6,0,6,元大-土城學府,2023-04-24,9822
4977,眾達-KY,7,1,6,元大-土城學府,2023-04-24,9822
2330,台積電,6,0,6,元大-土城學府,2023-04-24,9822
2535,達欣工,5,0,5,元大-土城學府,2023-04-24,9822
2615,萬海,5,0,5,元大-土城學府,2023-04-24,9822
2382,廣達,5,0,5,元大-土城學府,2023-04-24,9822
3019,亞光,5,0,5,元大-土城學府,2023-04-24,9822
00673R,期元大S＆P原油反1,5,0,5,元大-土城學府,2023-04-24,9822
1589,永冠-KY,5,0,5,元大-土城學府,2023-04-24,9822
6153,嘉聯益,5,0,5,元大-土城學府,2023-04-24,9822
8935,邦泰,5,0,5,元大-土城學府,2023-04-24,9822
00713,元大台灣高息低波,6,2,4,元大-土城學府,2023-04-24,9822
2884,玉山金,4,0,4,元大-土城學府,2023-04-24,9822
2929,淘帝-KY,4,0,4,元大-土城學府,2023-04-24,9822
0056,元大高股息,117,10,107,元大-土城學府,2023-04-25,9822
2610,華航,97,0,97,元大-土城學府,2023-04-25,9822
2206,三陽工業,120,43,77,元大-土城學府,2023-04-25,9822
3037,欣興,82,7,75,元大-土城學府,2023-04-25,9822
00878,國泰永續高股息,81,26,55,元大-土城學府,2023-04-25,9822
00902,中信電池及儲能,55,6,49,元大-土城學府,2023-04-25,9822
3231,緯創,46,6,40,元大-土城學府,2023-04-25,9822
1217,愛之味,41,2,39,元大-土城學府,2023-04-25,9822
3363,上詮,35,0,35,元大-土城學府,2023-04-25,9822
2748,雲品,36,8,28,元大-土城學府,2023-04-25,9822
6244,茂迪,43,16,27,元大-土城學府,2023-04-25,9822
2208,台船,29,2,27,元大-土城學府,2023-04-25,9822
2457,飛宏,57,30,27,元大-土城學府,2023-04-25,9822
2471,資通,61,36,25,元大-土城學府,2023-04-25,9822
6245,立端,25,0,25,元大-土城學府,2023-04-25,9822
5309,系統電,25,2,23,元大-土城學府,2023-04-25,9822
1471,首利,23,1,22,元大-土城學府,2023-04-25,9822
6148,驊宏資,22,0,22,元大-土城學府,2023-04-25,9822
1712,興農,20,0,20,元大-土城學府,2023-04-25,9822
00772B,中信高評級公司債,18,0,18,元大-土城學府,2023-04-25,9822
6182,合晶,21,3,18,元大-土城學府,2023-04-25,9822
1219,福壽,21,3,18,元大-土城學府,2023-04-25,9822
2634,漢翔,186,168,18,元大-土城學府,2023-04-25,9822
0050,元大台灣50,19,2,17,元大-土城學府,2023-04-25,9822
4121,優盛,22,5,17,元大-土城學府,2023-04-25,9822
6175,立敦,16,0,16,元大-土城學府,2023-04-25,9822
2867,三商壽,15,0,15,元大-土城學府,2023-04-25,9822
00753L,中信中國50正2,14,0,14,元大-土城學府,2023-04-25,9822
2498,宏達電,42,28,14,元大-土城學府,2023-04-25,9822
2618,長榮航,14,0,14,元大-土城學府,2023-04-25,9822
3430,奇鈦科,14,0,14,元大-土城學府,2023-04-25,9822
3078,僑威,19,6,13,元大-土城學府,2023-04-25,9822
4967,十銓,20,7,13,元大-土城學府,2023-04-25,9822
00713,元大台灣高息低波,19,7,12,元大-土城學府,2023-04-25,9822
1503,士電,36,25,11,元大-土城學府,2023-04-25,9822
2368,金像電,16,5,11,元大-土城學府,2023-04-25,9822
5009,榮剛,24,13,11,元大-土城學府,2023-04-25,9822
00900,富邦特選高股息30,13,2,11,元大-土城學府,2023-04-25,9822
00706L,期元大S＆P日圓正2,10,0,10,元大-土城學府,2023-04-25,9822
00918,大華優利高填息30,10,0,10,元大-土城學府,2023-04-25,9822
2102,泰豐,10,0,10,元大-土城學府,2023-04-25,9822
2913,農林,14,4,10,元大-土城學府,2023-04-25,9822
3035,智原,11,1,10,元大-土城學府,2023-04-25,9822
3504,揚明光,10,0,10,元大-土城學府,2023-04-25,9822
00923,群益台ESG低碳50,10,0,10,元大-土城學府,2023-04-25,9822
2330,台積電,14,5,9,元大-土城學府,2023-04-25,9822
2201,裕隆,9,0,9,元大-土城學府,2023-04-25,9822
2031,新光鋼,9,0,9,元大-土城學府,2023-04-25,9822
2382,廣達,10,1,9,元大-土城學府,2023-04-25,9822
6443,元晶,10,1,9,元大-土城學府,2023-04-25,9822
1217,愛之味,46,0,46,元大-土城學府,2023-04-26,9822
00712,復華富時不動產,41,0,41,元大-土城學府,2023-04-26,9822
2471,資通,93,56,37,元大-土城學府,2023-04-26,9822
00878,國泰永續高股息,37,4,33,元大-土城學府,2023-04-26,9822
6770,力積電,43,10,33,元大-土城學府,2023-04-26,9822
2610,華航,33,6,27,元大-土城學府,2023-04-26,9822
2515,中工,25,4,21,元大-土城學府,2023-04-26,9822
2002,中鋼,22,2,20,元大-土城學府,2023-04-26,9822
2375,凱美,20,0,20,元大-土城學府,2023-04-26,9822
2337,旺宏,20,1,19,元大-土城學府,2023-04-26,9822
6175,立敦,19,0,19,元大-土城學府,2023-04-26,9822
6245,立端,17,0,17,元大-土城學府,2023-04-26,9822
2314,台揚,17,2,15,元大-土城學府,2023-04-26,9822
3035,智原,15,1,14,元大-土城學府,2023-04-26,9822
8121,越峰,14,0,14,元大-土城學府,2023-04-26,9822
3078,僑威,14,0,14,元大-土城學府,2023-04-26,9822
2609,陽明,25,12,13,元大-土城學府,2023-04-26,9822
2603,長榮,15,2,13,元大-土城學府,2023-04-26,9822
00888,永豐台灣ESG,13,0,13,元大-土城學府,2023-04-26,9822
8222,寶一,30,17,13,元大-土城學府,2023-04-26,9822
6547,高端疫苗,13,1,12,元大-土城學府,2023-04-26,9822
2634,漢翔,80,69,11,元大-土城學府,2023-04-26,9822
4114,健喬,11,0,11,元大-土城學府,2023-04-26,9822
1712,興農,10,0,10,元大-土城學府,2023-04-26,9822
2438,翔耀,10,0,10,元大-土城學府,2023-04-26,9822
2481,強茂,10,0,10,元大-土城學府,2023-04-26,9822
3430,奇鈦科,10,0,10,元大-土城學府,2023-04-26,9822
1504,東元,22,12,10,元大-土城學府,2023-04-26,9822
1710,東聯,13,3,10,元大-土城學府,2023-04-26,9822
1514,亞力,11,2,9,元大-土城學府,2023-04-26,9822
6282,康舒,13,4,9,元大-土城學府,2023-04-26,9822
2482,連宇,15,7,8,元大-土城學府,2023-04-26,9822
2206,三陽工業,10,2,8,元大-土城學府,2023-04-26,9822
2344,華邦電,8,0,8,元大-土城學府,2023-04-26,9822
2915,潤泰全,8,0,8,元大-土城學府,2023-04-26,9822
6517,保勝光學,15,7,8,元大-土城學府,2023-04-26,9822
006208,富邦台50,8,0,8,元大-土城學府,2023-04-26,9822
00919,群益台灣精選高息,7,0,7,元大-土城學府,2023-04-26,9822
00673R,期元大S＆P原油反1,7,0,7,元大-土城學府,2023-04-26,9822
1101,台泥,16,9,7,元大-土城學府,2023-04-26,9822
1810,和成,7,0,7,元大-土城學府,2023-04-26,9822
4979,華星光,26,19,7,元大-土城學府,2023-04-26,9822
6156,松上,7,0,7,元大-土城學府,2023-04-26,9822
1310,台苯,17,11,6,元大-土城學府,2023-04-26,9822
1721,三晃,47,41,6,元大-土城學府,2023-04-26,9822
6218,豪勉,6,0,6,元大-土城學府,2023-04-26,9822
00637L,元大滬深300正2,18,13,5,元大-土城學府,2023-04-26,9822
2301,光寶科,5,0,5,元大-土城學府,2023-04-26,9822
2390,云辰,5,0,5,元大-土城學府,2023-04-26,9822
4566,時碩工業,10,5,5,元大-土城學府,2023-04-26,9822
00878,國泰永續高股息,252,4,248,元大-土城學府,2023-04-27,9822
1905,華紙,125,8,117,元大-土城學府,2023-04-27,9822
00713,元大台灣高息低波,94,1,93,元大-土城學府,2023-04-27,9822
2615,萬海,56,5,51,元大-土城學府,2023-04-27,9822
00676R,富邦臺灣加權反1,40,0,40,元大-土城學府,2023-04-27,9822
3443,創意,35,5,30,元大-土城學府,2023-04-27,9822
4121,優盛,30,0,30,元大-土城學府,2023-04-27,9822
8048,德勝,29,0,29,元大-土城學府,2023-04-27,9822
2801,彰銀,21,0,21,元大-土城學府,2023-04-27,9822
6770,力積電,32,11,21,元大-土城學府,2023-04-27,9822
2471,資通,38,18,20,元大-土城學府,2023-04-27,9822
00715L,期街口布蘭特正2,22,5,17,元大-土城學府,2023-04-27,9822
6244,茂迪,24,7,17,元大-土城學府,2023-04-27,9822
1809,中釉,17,3,14,元大-土城學府,2023-04-27,9822
6245,立端,15,1,14,元大-土城學府,2023-04-27,9822
2002,中鋼,13,0,13,元大-土城學府,2023-04-27,9822
6547,高端疫苗,23,11,12,元大-土城學府,2023-04-27,9822
00712,復華富時不動產,11,0,11,元大-土城學府,2023-04-27,9822
00924,復華S＆P500成長,11,0,11,元大-土城學府,2023-04-27,9822
2603,長榮,10,0,10,元大-土城學府,2023-04-27,9822
1442,名軒,10,0,10,元大-土城學府,2023-04-27,9822
2640,大車隊,10,0,10,元大-土城學府,2023-04-27,9822
3518,柏騰,10,0,10,元大-土城學府,2023-04-27,9822
6811,宏�硌穈T,10,0,10,元大-土城學府,2023-04-27,9822
1717,長興,14,5,9,元大-土城學府,2023-04-27,9822
2498,宏達電,11,2,9,元大-土城學府,2023-04-27,9822
3684,榮昌,9,0,9,元大-土城學府,2023-04-27,9822
2317,鴻海,9,2,7,元大-土城學府,2023-04-27,9822
0050,元大台灣50,8,1,7,元大-土城學府,2023-04-27,9822
2409,友達,6,0,6,元大-土城學府,2023-04-27,9822
3071,協禧,11,5,6,元大-土城學府,2023-04-27,9822
4968,立積,7,1,6,元大-土城學府,2023-04-27,9822
8215,明基材,8,2,6,元大-土城學府,2023-04-27,9822
9955,佳龍,7,1,6,元大-土城學府,2023-04-27,9822
2303,聯電,8,2,6,元大-土城學府,2023-04-27,9822
1314,中石化,5,0,5,元大-土城學府,2023-04-27,9822
00919,群益台灣精選高息,5,0,5,元大-土城學府,2023-04-27,9822
00637L,元大滬深300正2,8,3,5,元大-土城學府,2023-04-27,9822
1504,東元,6,1,5,元大-土城學府,2023-04-27,9822
1725,元禎,7,2,5,元大-土城學府,2023-04-27,9822
2347,聯強,5,0,5,元大-土城學府,2023-04-27,9822
2851,中再保,5,0,5,元大-土城學府,2023-04-27,9822
2880,華南金,5,0,5,元大-土城學府,2023-04-27,9822
3017,奇鋐,7,2,5,元大-土城學府,2023-04-27,9822
3211,順達,5,0,5,元大-土城學府,2023-04-27,9822
4130,健亞,5,0,5,元大-土城學府,2023-04-27,9822
00679B,元大美債20年,7,3,4,元大-土城學府,2023-04-27,9822
00885,富邦越南,4,0,4,元大-土城學府,2023-04-27,9822
1909,榮成,8,4,4,元大-土城學府,2023-04-27,9822
4931,新盛力,5,1,4,元大-土城學府,2023-04-27,9822
2409,友達,94,0,94,元大-土城學府,2023-04-28,9822
3518,柏騰,88,0,88,元大-土城學府,2023-04-28,9822
1310,台苯,71,0,71,元大-土城學府,2023-04-28,9822
6266,泰詠,37,0,37,元大-土城學府,2023-04-28,9822
2615,萬海,44,11,33,元大-土城學府,2023-04-28,9822
00715L,期街口布蘭特正2,37,5,32,元大-土城學府,2023-04-28,9822
2634,漢翔,111,88,23,元大-土城學府,2023-04-28,9822
00632R,元大台灣50反1,32,10,22,元大-土城學府,2023-04-28,9822
1789,神隆,22,0,22,元大-土城學府,2023-04-28,9822
2324,仁寶,23,2,21,元大-土城學府,2023-04-28,9822
2801,彰銀,21,1,20,元大-土城學府,2023-04-28,9822
00706L,期元大S＆P日圓正2,20,0,20,元大-土城學府,2023-04-28,9822
2429,銘旺科,20,0,20,元大-土城學府,2023-04-28,9822
1101,台泥,19,0,19,元大-土城學府,2023-04-28,9822
2832,台產,18,0,18,元大-土城學府,2023-04-28,9822
6741,91APP*-KY,26,9,17,元大-土城學府,2023-04-28,9822
00679B,元大美債20年,20,3,17,元大-土城學府,2023-04-28,9822
2891,中信金,35,18,17,元大-土城學府,2023-04-28,9822
6288,聯嘉,29,12,17,元大-土城學府,2023-04-28,9822
3481,群創,22,5,17,元大-土城學府,2023-04-28,9822
3264,欣銓,15,0,15,元大-土城學府,2023-04-28,9822
6114,久威,22,7,15,元大-土城學府,2023-04-28,9822
3711,日月光投控,13,0,13,元大-土城學府,2023-04-28,9822
2892,第一金,12,0,12,元大-土城學府,2023-04-28,9822
1217,愛之味,12,0,12,元大-土城學府,2023-04-28,9822
2610,華航,17,5,12,元大-土城學府,2023-04-28,9822
3017,奇鋐,21,10,11,元大-土城學府,2023-04-28,9822
6104,創惟,12,1,11,元大-土城學府,2023-04-28,9822
00923,群益台ESG低碳50,10,0,10,元大-土城學府,2023-04-28,9822
00665L,富邦�琤肭磪囓�2,10,0,10,元大-土城學府,2023-04-28,9822
00687B,國泰20年美債,10,0,10,元大-土城學府,2023-04-28,9822
3430,奇鈦科,13,3,10,元大-土城學府,2023-04-28,9822
5880,合庫金,14,4,10,元大-土城學府,2023-04-28,9822
1727,中華化,58,49,9,元大-土城學府,2023-04-28,9822
6770,力積電,22,13,9,元大-土城學府,2023-04-28,9822
1809,中釉,39,31,8,元大-土城學府,2023-04-28,9822
3071,協禧,11,3,8,元大-土城學府,2023-04-28,9822
3338,泰碩,11,3,8,元大-土城學府,2023-04-28,9822
4108,懷特,8,0,8,元大-土城學府,2023-04-28,9822
6282,康舒,43,36,7,元大-土城學府,2023-04-28,9822
1905,華紙,17,10,7,元大-土城學府,2023-04-28,9822
3374,精材,7,0,7,元大-土城學府,2023-04-28,9822
8222,寶一,45,38,7,元大-土城學府,2023-04-28,9822
00720B,元大投資級公司債,6,0,6,元大-土城學府,2023-04-28,9822
0056,元大高股息,7,1,6,元大-土城學府,2023-04-28,9822
1342,八貫,7,1,6,元大-土城學府,2023-04-28,9822
1513,中興電,11,5,6,元大-土城學府,2023-04-28,9822
6175,立敦,6,0,6,元大-土城學府,2023-04-28,9822
6269,台郡,7,1,6,元大-土城學府,2023-04-28,9822
8093,保銳,6,0,6,元大-土城學府,2023-04-28,9822
2887,台新金,155,2,153,元大-土城學府,2023-05-02,9822
2634,漢翔,103,26,77,元大-土城學府,2023-05-02,9822
4541,晟田,90,25,65,元大-土城學府,2023-05-02,9822
8403,盛弘,69,4,65,元大-土城學府,2023-05-02,9822
00878,國泰永續高股息,81,18,63,元大-土城學府,2023-05-02,9822
2603,長榮,38,4,34,元大-土城學府,2023-05-02,9822
3363,上詮,32,1,31,元大-土城學府,2023-05-02,9822
2438,翔耀,20,0,20,元大-土城學府,2023-05-02,9822
5009,榮剛,25,5,20,元大-土城學府,2023-05-02,9822
00680L,元大美債20正2,19,0,19,元大-土城學府,2023-05-02,9822
00632R,元大台灣50反1,19,0,19,元大-土城學府,2023-05-02,9822
00900,富邦特選高股息30,17,0,17,元大-土城學府,2023-05-02,9822
2002,中鋼,22,6,16,元大-土城學府,2023-05-02,9822
6741,91APP*-KY,18,2,16,元大-土城學府,2023-05-02,9822
3518,柏騰,15,0,15,元大-土城學府,2023-05-02,9822
1618,合機,14,0,14,元大-土城學府,2023-05-02,9822
2615,萬海,13,0,13,元大-土城學府,2023-05-02,9822
2609,陽明,15,2,13,元大-土城學府,2023-05-02,9822
00665L,富邦�琤肭磪囓�2,17,4,13,元大-土城學府,2023-05-02,9822
2408,南亞科,13,1,12,元大-土城學府,2023-05-02,9822
1513,中興電,24,13,11,元大-土城學府,2023-05-02,9822
6811,宏�硌穈T,12,1,11,元大-土城學府,2023-05-02,9822
2344,華邦電,15,5,10,元大-土城學府,2023-05-02,9822
5864,致和證,10,0,10,元大-土城學府,2023-05-02,9822
6123,上奇,10,0,10,元大-土城學府,2023-05-02,9822
6188,廣明,13,3,10,元大-土城學府,2023-05-02,9822
00679B,元大美債20年,10,1,9,元大-土城學府,2023-05-02,9822
1310,台苯,9,0,9,元大-土城學府,2023-05-02,9822
4903,聯光通,9,0,9,元大-土城學府,2023-05-02,9822
6234,高僑,17,8,9,元大-土城學府,2023-05-02,9822
6235,華孚,9,0,9,元大-土城學府,2023-05-02,9822
00885,富邦越南,11,3,8,元大-土城學府,2023-05-02,9822
00720B,元大投資級公司債,8,0,8,元大-土城學府,2023-05-02,9822
00772B,中信高評級公司債,8,0,8,元大-土城學府,2023-05-02,9822
1519,華城,28,20,8,元大-土城學府,2023-05-02,9822
2399,映泰,10,2,8,元大-土城學府,2023-05-02,9822
2891,中信金,18,10,8,元大-土城學府,2023-05-02,9822
5381,合正,8,0,8,元大-土城學府,2023-05-02,9822
6266,泰詠,9,1,8,元大-土城學府,2023-05-02,9822
2022,聚亨,12,5,7,元大-土城學府,2023-05-02,9822
2442,新美齊,7,0,7,元大-土城學府,2023-05-02,9822
2352,佳世達,15,8,7,元大-土城學府,2023-05-02,9822
2206,三陽工業,17,10,7,元大-土城學府,2023-05-02,9822
00751B,元大AAA至A公司債,6,0,6,元大-土城學府,2023-05-02,9822
2014,中鴻,6,0,6,元大-土城學府,2023-05-02,9822
8105,凌巨,10,4,6,元大-土城學府,2023-05-02,9822
3033,威健,6,0,6,元大-土城學府,2023-05-02,9822
1217,愛之味,5,0,5,元大-土城學府,2023-05-02,9822
00712,復華富時不動產,15,10,5,元大-土城學府,2023-05-02,9822
00692,富邦公司治理,5,0,5,元大-土城學府,2023-05-02,9822
3419,譁裕,134,8,126,元大-土城學府,2023-05-03,9822
3231,緯創,95,11,84,元大-土城學府,2023-05-03,9822
00712,復華富時不動產,57,4,53,元大-土城學府,2023-05-03,9822
00878,國泰永續高股息,57,7,50,元大-土城學府,2023-05-03,9822
1514,亞力,94,48,46,元大-土城學府,2023-05-03,9822
4541,晟田,51,7,44,元大-土城學府,2023-05-03,9822
3363,上詮,42,0,42,元大-土城學府,2023-05-03,9822
2530,華建,36,0,36,元大-土城學府,2023-05-03,9822
2609,陽明,38,6,32,元大-土城學府,2023-05-03,9822
00715L,期街口布蘭特正2,31,0,31,元大-土城學府,2023-05-03,9822
2603,長榮,36,5,31,元大-土城學府,2023-05-03,9822
2498,宏達電,29,0,29,元大-土城學府,2023-05-03,9822
1217,愛之味,25,0,25,元大-土城學府,2023-05-03,9822
00642U,期元大S＆P石油,25,0,25,元大-土城學府,2023-05-03,9822
00888,永豐台灣ESG,25,0,25,元大-土城學府,2023-05-03,9822
2867,三商壽,24,0,24,元大-土城學府,2023-05-03,9822
3481,群創,27,4,23,元大-土城學府,2023-05-03,9822
1101,台泥,36,13,23,元大-土城學府,2023-05-03,9822
00637L,元大滬深300正2,74,53,21,元大-土城學府,2023-05-03,9822
5321,美而快,20,0,20,元大-土城學府,2023-05-03,9822
1609,大亞,38,19,19,元大-土城學府,2023-05-03,9822
6167,久正,20,3,17,元大-土城學府,2023-05-03,9822
3625,西勝,15,0,15,元大-土城學府,2023-05-03,9822
2352,佳世達,14,0,14,元大-土城學府,2023-05-03,9822
2801,彰銀,14,0,14,元大-土城學府,2023-05-03,9822
1519,華城,20,7,13,元大-土城學府,2023-05-03,9822
00692,富邦公司治理,13,0,13,元大-土城學府,2023-05-03,9822
2208,台船,17,5,12,元大-土城學府,2023-05-03,9822
2892,第一金,17,6,11,元大-土城學府,2023-05-03,9822
6592,和潤企業,11,0,11,元大-土城學府,2023-05-03,9822
1809,中釉,27,16,11,元大-土城學府,2023-05-03,9822
1220,台榮,10,0,10,元大-土城學府,2023-05-03,9822
00875,國泰網路資安,10,0,10,元大-土城學府,2023-05-03,9822
3682,亞太電,10,0,10,元大-土城學府,2023-05-03,9822
4402,郡都開發,10,0,10,元大-土城學府,2023-05-03,9822
6689,伊雲谷,16,6,10,元大-土城學府,2023-05-03,9822
2615,萬海,14,4,10,元大-土城學府,2023-05-03,9822
5403,中菲,9,0,9,元大-土城學府,2023-05-03,9822
6411,晶焱,9,0,9,元大-土城學府,2023-05-03,9822
1711,永光,37,29,8,元大-土城學府,2023-05-03,9822
2344,華邦電,9,1,8,元大-土城學府,2023-05-03,9822
6547,高端疫苗,18,10,8,元大-土城學府,2023-05-03,9822
2409,友達,7,0,7,元大-土城學府,2023-05-03,9822
2201,裕隆,7,0,7,元大-土城學府,2023-05-03,9822
3029,零壹,14,7,7,元大-土城學府,2023-05-03,9822
3374,精材,7,0,7,元大-土城學府,2023-05-03,9822
4903,聯光通,8,1,7,元大-土城學府,2023-05-03,9822
5465,富驊,10,3,7,元大-土城學府,2023-05-03,9822
0056,元大高股息,10,3,7,元大-土城學府,2023-05-03,9822
1503,士電,15,9,6,元大-土城學府,2023-05-03,9822
00878,國泰永續高股息,144,7,137,元大-土城學府,2023-05-04,9822
00632R,元大台灣50反1,102,5,97,元大-土城學府,2023-05-04,9822
00712,復華富時不動產,56,21,35,元大-土城學府,2023-05-04,9822
00715L,期街口布蘭特正2,35,0,35,元大-土城學府,2023-05-04,9822
3518,柏騰,30,0,30,元大-土城學府,2023-05-04,9822
1514,亞力,30,4,26,元大-土城學府,2023-05-04,9822
5321,美而快,25,0,25,元大-土城學府,2023-05-04,9822
3032,偉訓,22,0,22,元大-土城學府,2023-05-04,9822
3078,僑威,22,1,21,元大-土城學府,2023-05-04,9822
6244,茂迪,23,2,21,元大-土城學府,2023-05-04,9822
5302,太欣,20,0,20,元大-土城學府,2023-05-04,9822
6234,高僑,25,5,20,元大-土城學府,2023-05-04,9822
2471,資通,31,16,15,元大-土城學府,2023-05-04,9822
3430,奇鈦科,15,0,15,元大-土城學府,2023-05-04,9822
4919,新唐,15,0,15,元大-土城學府,2023-05-04,9822
5309,系統電,15,0,15,元大-土城學府,2023-05-04,9822
2317,鴻海,22,8,14,元大-土城學府,2023-05-04,9822
3324,雙鴻,17,3,14,元大-土城學府,2023-05-04,9822
00650L,復華香港正2,13,0,13,元大-土城學府,2023-05-04,9822
1721,三晃,14,1,13,元大-土城學府,2023-05-04,9822
2867,三商壽,13,0,13,元大-土城學府,2023-05-04,9822
3231,緯創,50,37,13,元大-土城學府,2023-05-04,9822
2609,陽明,15,3,12,元大-土城學府,2023-05-04,9822
2634,漢翔,71,59,12,元大-土城學府,2023-05-04,9822
1529,樂事綠能,12,1,11,元大-土城學府,2023-05-04,9822
2371,大同,12,1,11,元大-土城學府,2023-05-04,9822
2482,連宇,17,6,11,元大-土城學府,2023-05-04,9822
1101,台泥,12,2,10,元大-土城學府,2023-05-04,9822
8403,盛弘,24,14,10,元大-土城學府,2023-05-04,9822
5880,合庫金,10,0,10,元大-土城學府,2023-05-04,9822
4968,立積,11,1,10,元大-土城學府,2023-05-04,9822
2352,佳世達,12,2,10,元大-土城學府,2023-05-04,9822
2367,燿華,10,0,10,元大-土城學府,2023-05-04,9822
2801,彰銀,10,0,10,元大-土城學府,2023-05-04,9822
2832,台產,10,0,10,元大-土城學府,2023-05-04,9822
3147,大綜,10,0,10,元大-土城學府,2023-05-04,9822
6169,昱泉,10,0,10,元大-土城學府,2023-05-04,9822
5475,德宏,10,1,9,元大-土城學府,2023-05-04,9822
6104,創惟,9,0,9,元大-土城學府,2023-05-04,9822
6770,力積電,11,2,9,元大-土城學府,2023-05-04,9822
2344,華邦電,14,6,8,元大-土城學府,2023-05-04,9822
2413,環科,16,8,8,元大-土城學府,2023-05-04,9822
2891,中信金,8,0,8,元大-土城學府,2023-05-04,9822
3481,群創,9,1,8,元大-土城學府,2023-05-04,9822
4108,懷特,8,0,8,元大-土城學府,2023-05-04,9822
4967,十銓,15,7,8,元大-土城學府,2023-05-04,9822
2442,新美齊,7,0,7,元大-土城學府,2023-05-04,9822
2727,王品,7,0,7,元大-土城學府,2023-05-04,9822
6167,久正,10,3,7,元大-土城學府,2023-05-04,9822
00888,永豐台灣ESG,7,0,7,元大-土城學府,2023-05-04,9822
1905,華紙,107,6,101,元大-土城學府,2023-05-05,9822
2353,宏��,106,8,98,元大-土城學府,2023-05-05,9822
00878,國泰永續高股息,55,2,53,元大-土城學府,2023-05-05,9822
2374,佳能,51,0,51,元大-土城學府,2023-05-05,9822
2206,三陽工業,45,7,38,元大-土城學府,2023-05-05,9822
00715L,期街口布蘭特正2,37,2,35,元大-土城學府,2023-05-05,9822
6244,茂迪,45,10,35,元大-土城學府,2023-05-05,9822
1504,東元,47,15,32,元大-土城學府,2023-05-05,9822
5009,榮剛,38,10,28,元大-土城學府,2023-05-05,9822
5321,美而快,33,5,28,元大-土城學府,2023-05-05,9822
1609,大亞,89,63,26,元大-土城學府,2023-05-05,9822
00712,復華富時不動產,29,8,21,元大-土城學府,2023-05-05,9822
2609,陽明,21,1,20,元大-土城學府,2023-05-05,9822
6202,盛群,20,0,20,元大-土城學府,2023-05-05,9822
00632R,元大台灣50反1,19,0,19,元大-土城學府,2023-05-05,9822
2615,萬海,23,5,18,元大-土城學府,2023-05-05,9822
4906,正文,15,0,15,元大-土城學府,2023-05-05,9822
1734,杏輝,16,1,15,元大-土城學府,2023-05-05,9822
2890,永豐金,14,0,14,元大-土城學府,2023-05-05,9822
00642U,期元大S＆P石油,14,0,14,元大-土城學府,2023-05-05,9822
1513,中興電,19,5,14,元大-土城學府,2023-05-05,9822
3712,永崴投控,16,2,14,元大-土城學府,2023-05-05,9822
6456,GIS-KY,15,1,14,元大-土城學府,2023-05-05,9822
1101,台泥,16,3,13,元大-土城學府,2023-05-05,9822
1721,三晃,15,2,13,元大-土城學府,2023-05-05,9822
2002,中鋼,13,0,13,元大-土城學府,2023-05-05,9822
00637L,元大滬深300正2,21,9,12,元大-土城學府,2023-05-05,9822
1529,樂事綠能,16,4,12,元大-土城學府,2023-05-05,9822
3576,聯合再生,14,3,11,元大-土城學府,2023-05-05,9822
00679B,元大美債20年,11,0,11,元大-土城學府,2023-05-05,9822
2453,凌群,14,3,11,元大-土城學府,2023-05-05,9822
2352,佳世達,12,1,11,元大-土城學府,2023-05-05,9822
5309,系統電,16,5,11,元大-土城學府,2023-05-05,9822
8403,盛弘,17,6,11,元大-土城學府,2023-05-05,9822
5469,瀚宇博,10,0,10,元大-土城學府,2023-05-05,9822
5351,鈺創,10,1,9,元大-土城學府,2023-05-05,9822
8938,明安,9,0,9,元大-土城學府,2023-05-05,9822
4114,健喬,12,4,8,元大-土城學府,2023-05-05,9822
6282,康舒,8,1,7,元大-土城學府,2023-05-05,9822
1727,中華化,7,0,7,元大-土城學府,2023-05-05,9822
00772B,中信高評級公司債,6,0,6,元大-土城學府,2023-05-05,9822
3029,零壹,8,2,6,元大-土城學府,2023-05-05,9822
2344,華邦電,11,6,5,元大-土城學府,2023-05-05,9822
1605,華新,24,19,5,元大-土城學府,2023-05-05,9822
1608,華榮,6,1,5,元大-土城學府,2023-05-05,9822
1795,美時,7,2,5,元大-土城學府,2023-05-05,9822
2022,聚亨,5,0,5,元大-土城學府,2023-05-05,9822
2204,中華,5,0,5,元大-土城學府,2023-05-05,9822
3078,僑威,27,22,5,元大-土城學府,2023-05-05,9822
3147,大綜,5,0,5,元大-土城學府,2023-05-05,9822
00679B,元大美債20年,61,1,60,元大-土城學府,2023-05-08,9822
00712,復華富時不動產,55,17,38,元大-土城學府,2023-05-08,9822
00751B,元大AAA至A公司債,38,0,38,元大-土城學府,2023-05-08,9822
3231,緯創,117,80,37,元大-土城學府,2023-05-08,9822
2884,玉山金,40,4,36,元大-土城學府,2023-05-08,9822
2609,陽明,37,2,35,元大-土城學府,2023-05-08,9822
2408,南亞科,34,0,34,元大-土城學府,2023-05-08,9822
6112,邁達特,36,3,33,元大-土城學府,2023-05-08,9822
8942,森鉅,33,2,31,元大-土城學府,2023-05-08,9822
2883,凱基金,80,54,26,元大-土城學府,2023-05-08,9822
3576,聯合再生,23,0,23,元大-土城學府,2023-05-08,9822
6245,立端,25,3,22,元大-土城學府,2023-05-08,9822
2614,東森,21,0,21,元大-土城學府,2023-05-08,9822
6443,元晶,23,2,21,元大-土城學府,2023-05-08,9822
6547,高端疫苗,24,4,20,元大-土城學府,2023-05-08,9822
6125,廣運,27,9,18,元大-土城學府,2023-05-08,9822
1605,華新,46,29,17,元大-土城學府,2023-05-08,9822
00715L,期街口布蘭特正2,28,11,17,元大-土城學府,2023-05-08,9822
00713,元大台灣高息低波,18,1,17,元大-土城學府,2023-05-08,9822
9962,有益,17,1,16,元大-土城學府,2023-05-08,9822
00687B,國泰20年美債,15,0,15,元大-土城學府,2023-05-08,9822
3481,群創,14,1,13,元大-土城學府,2023-05-08,9822
1101,台泥,22,9,13,元大-土城學府,2023-05-08,9822
2022,聚亨,12,0,12,元大-土城學府,2023-05-08,9822
00670L,富邦NASDAQ正2,11,0,11,元大-土城學府,2023-05-08,9822
4142,國光生,11,0,11,元大-土城學府,2023-05-08,9822
1326,台化,10,0,10,元大-土城學府,2023-05-08,9822
00877,復華中國5G,10,0,10,元大-土城學府,2023-05-08,9822
00857B,永豐20年美公債,10,0,10,元大-土城學府,2023-05-08,9822
1906,寶隆,10,0,10,元大-土城學府,2023-05-08,9822
2412,中華電,10,0,10,元大-土城學府,2023-05-08,9822
2880,華南金,10,0,10,元大-土城學府,2023-05-08,9822
8044,網家,10,0,10,元大-土城學府,2023-05-08,9822
9105,泰金寶-DR,10,0,10,元大-土城學府,2023-05-08,9822
2882,國泰金,10,1,9,元大-土城學府,2023-05-08,9822
00772B,中信高評級公司債,9,0,9,元大-土城學府,2023-05-08,9822
2359,所羅門,16,7,9,元大-土城學府,2023-05-08,9822
9955,佳龍,10,1,9,元大-土城學府,2023-05-08,9822
5608,四維航,8,0,8,元大-土城學府,2023-05-08,9822
2104,國際中橡,10,2,8,元大-土城學府,2023-05-08,9822
1810,和成,12,5,7,元大-土城學府,2023-05-08,9822
8084,巨虹,7,0,7,元大-土城學府,2023-05-08,9822
6531,愛普*,10,3,7,元大-土城學府,2023-05-08,9822
1218,泰山,6,0,6,元大-土城學府,2023-05-08,9822
1529,樂事綠能,9,3,6,元大-土城學府,2023-05-08,9822
3703,欣陸,6,0,6,元大-土城學府,2023-05-08,9822
4967,十銓,7,1,6,元大-土城學府,2023-05-08,9822
2449,京元電子,5,0,5,元大-土城學府,2023-05-08,9822
6116,彩晶,5,0,5,元大-土城學府,2023-05-08,9822
6592,和潤企業,5,0,5,元大-土城學府,2023-05-08,9822
2891,中信金,71,2,69,元大-土城學府,2023-05-09,9822
1616,億泰,53,0,53,元大-土城學府,2023-05-09,9822
3704,合勤控,45,0,45,元大-土城學府,2023-05-09,9822
3483,力致,45,3,42,元大-土城學府,2023-05-09,9822
1217,愛之味,35,0,35,元大-土城學府,2023-05-09,9822
3078,僑威,31,0,31,元大-土城學府,2023-05-09,9822
3046,建��,67,37,30,元大-土城學府,2023-05-09,9822
2530,華建,30,0,30,元大-土城學府,2023-05-09,9822
6120,達運,30,0,30,元大-土城學府,2023-05-09,9822
00878,國泰永續高股息,29,0,29,元大-土城學府,2023-05-09,9822
1101,台泥,39,11,28,元大-土城學府,2023-05-09,9822
1514,亞力,30,4,26,元大-土城學府,2023-05-09,9822
6538,倉和,26,3,23,元大-土城學府,2023-05-09,9822
00679B,元大美債20年,21,0,21,元大-土城學府,2023-05-09,9822
1519,華城,35,14,21,元大-土城學府,2023-05-09,9822
1504,東元,30,9,21,元大-土城學府,2023-05-09,9822
8403,盛弘,23,3,20,元大-土城學府,2023-05-09,9822
8033,雷虎,23,3,20,元大-土城學府,2023-05-09,9822
6589,台康生技,16,0,16,元大-土城學府,2023-05-09,9822
5483,中美晶,15,0,15,元大-土城學府,2023-05-09,9822
4919,新唐,16,3,13,元大-土城學府,2023-05-09,9822
2408,南亞科,13,0,13,元大-土城學府,2023-05-09,9822
4960,誠美材,15,2,13,元大-土城學府,2023-05-09,9822
6547,高端疫苗,20,7,13,元大-土城學府,2023-05-09,9822
00772B,中信高評級公司債,12,0,12,元大-土城學府,2023-05-09,9822
5009,榮剛,30,18,12,元大-土城學府,2023-05-09,9822
3071,協禧,22,10,12,元大-土城學府,2023-05-09,9822
00720B,元大投資級公司債,11,0,11,元大-土城學府,2023-05-09,9822
2382,廣達,12,1,11,元大-土城學府,2023-05-09,9822
5864,致和證,12,1,11,元大-土城學府,2023-05-09,9822
00680L,元大美債20正2,10,0,10,元大-土城學府,2023-05-09,9822
00632R,元大台灣50反1,10,0,10,元大-土城學府,2023-05-09,9822
00753L,中信中國50正2,10,0,10,元大-土城學府,2023-05-09,9822
1718,中纖,10,0,10,元大-土城學府,2023-05-09,9822
6531,愛普*,10,0,10,元大-土城學府,2023-05-09,9822
00751B,元大AAA至A公司債,9,0,9,元大-土城學府,2023-05-09,9822
1609,大亞,32,23,9,元大-土城學府,2023-05-09,9822
3290,東浦,9,0,9,元大-土城學府,2023-05-09,9822
4114,健喬,10,1,9,元大-土城學府,2023-05-09,9822
6129,普誠,10,1,9,元大-土城學府,2023-05-09,9822
6288,聯嘉,9,0,9,元大-土城學府,2023-05-09,9822
2640,大車隊,8,0,8,元大-土城學府,2023-05-09,9822
4951,精拓科,8,0,8,元大-土城學府,2023-05-09,9822
6218,豪勉,10,2,8,元大-土城學府,2023-05-09,9822
3466,德晉,7,0,7,元大-土城學府,2023-05-09,9822
3557,嘉威,7,0,7,元大-土城學府,2023-05-09,9822
8024,佑華,7,0,7,元大-土城學府,2023-05-09,9822
8926,台汽電,7,0,7,元大-土城學府,2023-05-09,9822
3058,立德,12,6,6,元大-土城學府,2023-05-09,9822
1584,精剛,14,8,6,元大-土城學府,2023-05-09,9822
2845,遠東銀,477,0,477,元大-土城學府,2023-05-10,9822
1609,大亞,140,40,100,元大-土城學府,2023-05-10,9822
3483,力致,67,0,67,元大-土城學府,2023-05-10,9822
5288,豐祥-KY,58,0,58,元大-土城學府,2023-05-10,9822
3027,盛達,41,0,41,元大-土城學府,2023-05-10,9822
3013,晟銘電,33,0,33,元大-土城學府,2023-05-10,9822
2421,建準,35,3,32,元大-土城學府,2023-05-10,9822
00878,國泰永續高股息,56,29,27,元大-土城學府,2023-05-10,9822
1529,樂事綠能,26,1,25,元大-土城學府,2023-05-10,9822
00680L,元大美債20正2,22,0,22,元大-土城學府,2023-05-10,9822
6125,廣運,28,6,22,元大-土城學府,2023-05-10,9822
4979,華星光,39,19,20,元大-土城學府,2023-05-10,9822
00637L,元大滬深300正2,24,6,18,元大-土城學府,2023-05-10,9822
2801,彰銀,18,0,18,元大-土城學府,2023-05-10,9822
8086,宏捷科,20,2,18,元大-土城學府,2023-05-10,9822
00673R,期元大S＆P原油反1,17,0,17,元大-土城學府,2023-05-10,9822
2884,玉山金,30,14,16,元大-土城學府,2023-05-10,9822
1504,東元,20,6,14,元大-土城學府,2023-05-10,9822
00881,國泰台灣5G+,13,0,13,元大-土城學府,2023-05-10,9822
00687B,國泰20年美債,12,0,12,元大-土城學府,2023-05-10,9822
3071,協禧,17,5,12,元大-土城學府,2023-05-10,9822
00720B,元大投資級公司債,11,0,11,元大-土城學府,2023-05-10,9822
2882,國泰金,11,0,11,元大-土城學府,2023-05-10,9822
6245,立端,12,1,11,元大-土城學府,2023-05-10,9822
3518,柏騰,11,0,11,元大-土城學府,2023-05-10,9822
3611,鼎翰,10,0,10,元大-土城學府,2023-05-10,9822
00650L,復華香港正2,10,0,10,元大-土城學府,2023-05-10,9822
2885,元大金,10,0,10,元大-土城學府,2023-05-10,9822
1337,再生-KY,97,88,9,元大-土城學府,2023-05-10,9822
2498,宏達電,10,1,9,元大-土城學府,2023-05-10,9822
2330,台積電,9,0,9,元大-土城學府,2023-05-10,9822
00885,富邦越南,8,0,8,元大-土城學府,2023-05-10,9822
4951,精拓科,8,0,8,元大-土城學府,2023-05-10,9822
00679B,元大美債20年,8,1,7,元大-土城學府,2023-05-10,9822
2886,兆豐金,15,7,8,元大-土城學府,2023-05-10,9822
2610,華航,18,11,7,元大-土城學府,2023-05-10,9822
00712,復華富時不動產,7,0,7,元大-土城學府,2023-05-10,9822
3481,群創,11,5,6,元大-土城學府,2023-05-10,9822
1605,華新,8,2,6,元大-土城學府,2023-05-10,9822
3684,榮昌,6,0,6,元大-土城學府,2023-05-10,9822
6175,立敦,6,0,6,元大-土城學府,2023-05-10,9822
6538,倉和,6,0,6,元大-土城學府,2023-05-10,9822
6672,騰輝電子-KY,6,0,6,元大-土城學府,2023-05-10,9822
1584,精剛,5,0,5,元大-土城學府,2023-05-10,9822
2412,中華電,5,0,5,元大-土城學府,2023-05-10,9822
2485,兆赫,5,0,5,元大-土城學府,2023-05-10,9822
2640,大車隊,5,0,5,元大-土城學府,2023-05-10,9822
3059,華晶科,5,0,5,元大-土城學府,2023-05-10,9822
3363,上詮,6,1,5,元大-土城學府,2023-05-10,9822
3679,新至陞,5,0,5,元大-土城學府,2023-05-10,9822
1905,華紙,118,3,115,元大-土城學府,2023-05-11,9822
6122,擎邦,135,37,98,元大-土城學府,2023-05-11,9822
3704,合勤控,84,17,67,元大-土城學府,2023-05-11,9822
2634,漢翔,79,16,63,元大-土城學府,2023-05-11,9822
00878,國泰永續高股息,53,1,52,元大-土城學府,2023-05-11,9822
00753L,中信中國50正2,50,0,50,元大-土城學府,2023-05-11,9822
3231,緯創,61,14,47,元大-土城學府,2023-05-11,9822
2421,建準,47,4,43,元大-土城學府,2023-05-11,9822
2317,鴻海,63,21,42,元大-土城學府,2023-05-11,9822
6285,啟��,40,3,37,元大-土城學府,2023-05-11,9822
2812,台中銀,33,1,32,元大-土城學府,2023-05-11,9822
2640,大車隊,25,0,25,元大-土城學府,2023-05-11,9822
3430,奇鈦科,23,0,23,元大-土城學府,2023-05-11,9822
2610,華航,34,12,22,元大-土城學府,2023-05-11,9822
2615,萬海,23,3,20,元大-土城學府,2023-05-11,9822
3013,晟銘電,20,0,20,元大-土城學府,2023-05-11,9822
3360,尚立,20,0,20,元大-土城學府,2023-05-11,9822
5521,工信,20,0,20,元大-土城學府,2023-05-11,9822
3481,群創,19,0,19,元大-土城學府,2023-05-11,9822
1101,台泥,24,6,18,元大-土城學府,2023-05-11,9822
8033,雷虎,33,15,18,元大-土城學府,2023-05-11,9822
9907,統一實,19,1,18,元大-土城學府,2023-05-11,9822
0056,元大高股息,17,1,16,元大-土城學府,2023-05-11,9822
1217,愛之味,15,0,15,元大-土城學府,2023-05-11,9822
2609,陽明,14,1,13,元大-土城學府,2023-05-11,9822
1584,精剛,17,4,13,元大-土城學府,2023-05-11,9822
6245,立端,18,5,13,元大-土城學府,2023-05-11,9822
1609,大亞,29,18,11,元大-土城學府,2023-05-11,9822
1810,和成,14,3,11,元大-土城學府,2023-05-11,9822
1904,正隆,11,0,11,元大-土城學府,2023-05-11,9822
2371,大同,13,2,11,元大-土城學府,2023-05-11,9822
6191,精成科,11,0,11,元大-土城學府,2023-05-11,9822
4979,華星光,34,24,10,元大-土城學府,2023-05-11,9822
1618,合機,10,0,10,元大-土城學府,2023-05-11,9822
2355,敬鵬,10,0,10,元大-土城學府,2023-05-11,9822
3037,欣興,18,8,10,元大-土城學府,2023-05-11,9822
5315,光聯,10,0,10,元大-土城學府,2023-05-11,9822
5403,中菲,10,0,10,元大-土城學府,2023-05-11,9822
8938,明安,10,0,10,元大-土城學府,2023-05-11,9822
6547,高端疫苗,13,4,9,元大-土城學府,2023-05-11,9822
4744,皇將,11,2,9,元大-土城學府,2023-05-11,9822
2409,友達,9,0,9,元大-土城學府,2023-05-11,9822
2387,精元,10,1,9,元大-土城學府,2023-05-11,9822
1460,宏遠,8,0,8,元大-土城學府,2023-05-11,9822
1526,日馳,8,0,8,元大-土城學府,2023-05-11,9822
1529,樂事綠能,12,4,8,元大-土城學府,2023-05-11,9822
2032,新鋼,8,0,8,元大-土城學府,2023-05-11,9822
3029,零壹,13,5,8,元大-土城學府,2023-05-11,9822
3162,精確,7,0,7,元大-土城學府,2023-05-11,9822
8261,富鼎,7,0,7,元大-土城學府,2023-05-11,9822
00751B,元大AAA至A公司債,195,1,194,元大-土城學府,2023-05-12,9822
00878,國泰永續高股息,131,1,130,元大-土城學府,2023-05-12,9822
2317,鴻海,129,2,127,元大-土城學府,2023-05-12,9822
00720B,元大投資級公司債,99,7,92,元大-土城學府,2023-05-12,9822
2743,山富,84,22,62,元大-土城學府,2023-05-12,9822
2745,五福,63,4,59,元大-土城學府,2023-05-12,9822
2409,友達,54,0,54,元大-土城學府,2023-05-12,9822
1609,大亞,72,22,50,元大-土城學府,2023-05-12,9822
2812,台中銀,41,0,41,元大-土城學府,2023-05-12,9822
00632R,元大台灣50反1,60,20,40,元大-土城學府,2023-05-12,9822
2890,永豐金,35,0,35,元大-土城學府,2023-05-12,9822
5475,德宏,32,0,32,元大-土城學府,2023-05-12,9822
00715L,期街口布蘭特正2,32,3,29,元大-土城學府,2023-05-12,9822
2888,新光金,56,30,26,元大-土城學府,2023-05-12,9822
00637L,元大滬深300正2,35,10,25,元大-土城學府,2023-05-12,9822
2736,富野,20,0,20,元大-土城學府,2023-05-12,9822
3617,碩天,20,0,20,元大-土城學府,2023-05-12,9822
6570,維田,21,2,19,元大-土城學府,2023-05-12,9822
3014,聯陽,20,2,18,元大-土城學府,2023-05-12,9822
2027,大成鋼,17,1,16,元大-土城學府,2023-05-12,9822
1101,台泥,18,3,15,元大-土城學府,2023-05-12,9822
2371,大同,33,18,15,元大-土城學府,2023-05-12,9822
00665L,富邦�琤肭磪囓�2,15,1,14,元大-土城學府,2023-05-12,9822
3483,力致,21,7,14,元大-土城學府,2023-05-12,9822
9943,好樂迪,13,0,13,元大-土城學府,2023-05-12,9822
1605,華新,19,7,12,元大-土城學府,2023-05-12,9822
1608,華榮,13,1,12,元大-土城學府,2023-05-12,9822
2421,建準,16,4,12,元大-土城學府,2023-05-12,9822
2892,第一金,12,0,12,元大-土城學府,2023-05-12,9822
2903,遠百,12,0,12,元大-土城學府,2023-05-12,9822
1712,興農,11,0,11,元大-土城學府,2023-05-12,9822
1904,正隆,12,1,11,元大-土城學府,2023-05-12,9822
2610,華航,16,5,11,元大-土城學府,2023-05-12,9822
1721,三晃,12,2,10,元大-土城學府,2023-05-12,9822
2367,燿華,11,1,10,元大-土城學府,2023-05-12,9822
8936,國統,10,0,10,元大-土城學府,2023-05-12,9822
6282,康舒,11,2,9,元大-土城學府,2023-05-12,9822
2615,萬海,9,0,9,元大-土城學府,2023-05-12,9822
4979,華星光,12,3,9,元大-土城學府,2023-05-12,9822
2885,元大金,9,1,8,元大-土城學府,2023-05-12,9822
3481,群創,10,2,8,元大-土城學府,2023-05-12,9822
2388,威盛,17,9,8,元大-土城學府,2023-05-12,9822
2882,國泰金,7,0,7,元大-土城學府,2023-05-12,9822
1218,泰山,7,0,7,元大-土城學府,2023-05-12,9822
1337,再生-KY,10,3,7,元大-土城學府,2023-05-12,9822
1432,大魯閣,9,2,7,元大-土城學府,2023-05-12,9822
2605,新興,7,0,7,元大-土城學府,2023-05-12,9822
6244,茂迪,7,0,7,元大-土城學府,2023-05-12,9822
0056,元大高股息,10,3,7,元大-土城學府,2023-05-12,9822
3702,大聯大,6,0,6,元大-土城學府,2023-05-12,9822
00878,國泰永續高股息,156,8,148,元大-土城學府,2023-05-15,9822
00751B,元大AAA至A公司債,104,0,104,元大-土城學府,2023-05-15,9822
3704,合勤控,61,1,60,元大-土城學府,2023-05-15,9822
1101,台泥,42,1,41,元大-土城學府,2023-05-15,9822
8048,德勝,63,32,31,元大-土城學府,2023-05-15,9822
00715L,期街口布蘭特正2,30,0,30,元大-土城學府,2023-05-15,9822
9943,好樂迪,33,3,30,元大-土城學府,2023-05-15,9822
2745,五福,28,0,28,元大-土城學府,2023-05-15,9822
5258,虹堡,35,7,28,元大-土城學府,2023-05-15,9822
00687B,國泰20年美債,23,0,23,元大-土城學府,2023-05-15,9822
3056,富華新,22,0,22,元大-土城學府,2023-05-15,9822
2743,山富,27,7,20,元大-土城學府,2023-05-15,9822
4138,曜亞,20,0,20,元大-土城學府,2023-05-15,9822
5521,工信,20,0,20,元大-土城學府,2023-05-15,9822
00632R,元大台灣50反1,18,1,17,元大-土城學府,2023-05-15,9822
2427,三商電,22,5,17,元大-土城學府,2023-05-15,9822
8011,台通,23,6,17,元大-土城學府,2023-05-15,9822
00679B,元大美債20年,14,0,14,元大-土城學府,2023-05-15,9822
1737,臺鹽,14,0,14,元大-土城學府,2023-05-15,9822
3202,樺晟,31,17,14,元大-土城學府,2023-05-15,9822
0056,元大高股息,13,0,13,元大-土城學府,2023-05-15,9822
3231,緯創,11,0,11,元大-土城學府,2023-05-15,9822
1229,聯華,10,0,10,元大-土城學府,2023-05-15,9822
1447,力鵬,10,0,10,元大-土城學府,2023-05-15,9822
2498,宏達電,15,5,10,元大-土城學府,2023-05-15,9822
2610,華航,12,2,10,元大-土城學府,2023-05-15,9822
6770,力積電,10,0,10,元大-土城學府,2023-05-15,9822
3105,穩懋,9,0,9,元大-土城學府,2023-05-15,9822
9907,統一實,9,0,9,元大-土城學府,2023-05-15,9822
2542,興富發,8,0,8,元大-土城學府,2023-05-15,9822
2915,潤泰全,9,1,8,元大-土城學府,2023-05-15,9822
3046,建��,22,14,8,元大-土城學府,2023-05-15,9822
6188,廣明,10,2,8,元大-土城學府,2023-05-15,9822
6288,聯嘉,8,0,8,元大-土城學府,2023-05-15,9822
2455,全新,7,0,7,元大-土城學府,2023-05-15,9822
6235,華孚,36,29,7,元大-土城學府,2023-05-15,9822
2303,聯電,8,2,6,元大-土城學府,2023-05-15,9822
3624,光頡,6,0,6,元大-土城學府,2023-05-15,9822
6570,維田,6,1,5,元大-土城學府,2023-05-15,9822
4763,材料-KY,5,0,5,元大-土城學府,2023-05-15,9822
2344,華邦電,5,0,5,元大-土城學府,2023-05-15,9822
5469,瀚宇博,5,0,5,元大-土城學府,2023-05-15,9822
5475,德宏,5,0,5,元大-土城學府,2023-05-15,9822
6005,群益證,6,1,5,元大-土城學府,2023-05-15,9822
6138,茂達,5,0,5,元大-土城學府,2023-05-15,9822
6609,瀧澤科,5,0,5,元大-土城學府,2023-05-15,9822
8069,元太,7,2,5,元大-土城學府,2023-05-15,9822
3034,聯詠,5,0,5,元大-土城學府,2023-05-15,9822
00720B,元大投資級公司債,4,0,4,元大-土城學府,2023-05-15,9822
00712,復華富時不動產,4,0,4,元大-土城學府,2023-05-15,9822
2371,大同,69,8,61,元大-土城學府,2023-05-16,9822
1314,中石化,52,1,51,元大-土城學府,2023-05-16,9822
00632R,元大台灣50反1,57,6,51,元大-土城學府,2023-05-16,9822
2892,第一金,55,12,43,元大-土城學府,2023-05-16,9822
5258,虹堡,63,20,43,元大-土城學府,2023-05-16,9822
2317,鴻海,30,2,28,元大-土城學府,2023-05-16,9822
00772B,中信高評級公司債,23,0,23,元大-土城學府,2023-05-16,9822
1721,三晃,25,2,23,元大-土城學府,2023-05-16,9822
00680L,元大美債20正2,21,0,21,元大-土城學府,2023-05-16,9822
00720B,元大投資級公司債,20,0,20,元大-土城學府,2023-05-16,9822
2743,山富,25,5,20,元大-土城學府,2023-05-16,9822
2906,高林,20,0,20,元大-土城學府,2023-05-16,9822
00751B,元大AAA至A公司債,16,0,16,元大-土城學府,2023-05-16,9822
2399,映泰,16,0,16,元大-土城學府,2023-05-16,9822
2323,中環,16,1,15,元大-土城學府,2023-05-16,9822
2867,三商壽,13,0,13,元大-土城學府,2023-05-16,9822
5475,德宏,13,0,13,元大-土城學府,2023-05-16,9822
00919,群益台灣精選高息,12,0,12,元大-土城學府,2023-05-16,9822
2603,長榮,12,1,11,元大-土城學府,2023-05-16,9822
3264,欣銓,10,0,10,元大-土城學府,2023-05-16,9822
00683L,期元大美元指正2,10,0,10,元大-土城學府,2023-05-16,9822
1734,杏輝,10,0,10,元大-土城學府,2023-05-16,9822
1904,正隆,10,0,10,元大-土城學府,2023-05-16,9822
2610,華航,14,4,10,元大-土城學府,2023-05-16,9822
4138,曜亞,10,0,10,元大-土城學府,2023-05-16,9822
6214,精誠,10,0,10,元大-土城學府,2023-05-16,9822
1712,興農,10,1,9,元大-土城學府,2023-05-16,9822
2882,國泰金,10,1,9,元大-土城學府,2023-05-16,9822
00773B,中信優先金融債,9,0,9,元大-土城學府,2023-05-16,9822
00687B,國泰20年美債,9,0,9,元大-土城學府,2023-05-16,9822
3715,定穎投控,10,1,9,元大-土城學府,2023-05-16,9822
6180,橘子,9,0,9,元大-土城學府,2023-05-16,9822
1504,東元,20,12,8,元大-土城學府,2023-05-16,9822
2633,台灣高鐵,8,0,8,元大-土城學府,2023-05-16,9822
2881,富邦金,10,2,8,元大-土城學府,2023-05-16,9822
4931,新盛力,8,0,8,元大-土城學府,2023-05-16,9822
3013,晟銘電,7,0,7,元大-土城學府,2023-05-16,9822
8076,伍豐,12,5,7,元大-土城學府,2023-05-16,9822
2206,三陽工業,10,4,6,元大-土城學府,2023-05-16,9822
4543,萬在,6,0,6,元大-土城學府,2023-05-16,9822
4919,新唐,11,5,6,元大-土城學府,2023-05-16,9822
00713,元大台灣高息低波,5,0,5,元大-土城學府,2023-05-16,9822
1605,華新,9,4,5,元大-土城學府,2023-05-16,9822
1711,永光,6,1,5,元大-土城學府,2023-05-16,9822
2352,佳世達,10,5,5,元大-土城學府,2023-05-16,9822
2548,華固,5,0,5,元大-土城學府,2023-05-16,9822
3673,TPK-KY,5,0,5,元大-土城學府,2023-05-16,9822
4967,十銓,7,2,5,元大-土城學府,2023-05-16,9822
6147,頎邦,5,0,5,元大-土城學府,2023-05-16,9822
8092,建暐,5,0,5,元大-土城學府,2023-05-16,9822
00632R,元大台灣50反1,793,0,793,元大-土城學府,2023-05-17,9822
2887,台新金,202,1,201,元大-土城學府,2023-05-17,9822
2530,華建,78,0,78,元大-土城學府,2023-05-17,9822
6198,瑞築,61,0,61,元大-土城學府,2023-05-17,9822
00680L,元大美債20正2,40,1,39,元大-土城學府,2023-05-17,9822
2371,大同,37,7,30,元大-土城學府,2023-05-17,9822
8048,德勝,34,9,25,元大-土城學府,2023-05-17,9822
2745,五福,25,3,22,元大-土城學府,2023-05-17,9822
00712,復華富時不動產,21,0,21,元大-土城學府,2023-05-17,9822
2743,山富,22,1,21,元大-土城學府,2023-05-17,9822
2443,昶虹,20,0,20,元大-土城學府,2023-05-17,9822
3617,碩天,20,0,20,元大-土城學府,2023-05-17,9822
2427,三商電,21,3,18,元大-土城學府,2023-05-17,9822
3715,定穎投控,19,1,18,元大-土城學府,2023-05-17,9822
3071,協禧,17,0,17,元大-土城學府,2023-05-17,9822
6116,彩晶,19,2,17,元大-土城學府,2023-05-17,9822
6609,瀧澤科,15,0,15,元大-土城學府,2023-05-17,9822
00637L,元大滬深300正2,20,6,14,元大-土城學府,2023-05-17,9822
2618,長榮航,14,0,14,元大-土城學府,2023-05-17,9822
2303,聯電,16,3,13,元大-土城學府,2023-05-17,9822
1337,再生-KY,15,3,12,元大-土城學府,2023-05-17,9822
5475,德宏,10,0,10,元大-土城學府,2023-05-17,9822
00713,元大台灣高息低波,10,0,10,元大-土城學府,2023-05-17,9822
00679B,元大美債20年,9,0,9,元大-土城學府,2023-05-17,9822
1727,中華化,9,0,9,元大-土城學府,2023-05-17,9822
00882,中信中國高股息,8,0,8,元大-土城學府,2023-05-17,9822
5258,虹堡,27,20,7,元大-土城學府,2023-05-17,9822
6285,啟��,9,2,7,元大-土城學府,2023-05-17,9822
00772B,中信高評級公司債,7,0,7,元大-土城學府,2023-05-17,9822
2313,華通,8,1,7,元大-土城學府,2023-05-17,9822
2409,友達,15,8,7,元大-土城學府,2023-05-17,9822
3046,建��,26,19,7,元大-土城學府,2023-05-17,9822
3232,昱捷,6,0,6,元大-土城學府,2023-05-17,9822
4760,勤凱,6,0,6,元大-土城學府,2023-05-17,9822
1519,華城,17,11,6,元大-土城學府,2023-05-17,9822
00687B,國泰20年美債,5,0,5,元大-土城學府,2023-05-17,9822
2731,雄獅,5,0,5,元大-土城學府,2023-05-17,9822
00664R,國泰臺灣加權反1,5,0,5,元大-土城學府,2023-05-17,9822
1513,中興電,7,2,5,元大-土城學府,2023-05-17,9822
2352,佳世達,10,5,5,元大-土城學府,2023-05-17,9822
2399,映泰,5,0,5,元大-土城學府,2023-05-17,9822
4161,聿新科,5,0,5,元大-土城學府,2023-05-17,9822
4967,十銓,5,0,5,元大-土城學府,2023-05-17,9822
8111,立��,5,0,5,元大-土城學府,2023-05-17,9822
1605,華新,4,0,4,元大-土城學府,2023-05-17,9822
3231,緯創,18,14,4,元大-土城學府,2023-05-17,9822
6160,欣技,9,6,3,元大-土城學府,2023-05-17,9822
00688L,國泰20年美債正2,3,0,3,元大-土城學府,2023-05-17,9822
1471,首利,3,0,3,元大-土城學府,2023-05-17,9822
1528,恩德,3,0,3,元大-土城學府,2023-05-17,9822
00632R,元大台灣50反1,177,0,177,元大-土城學府,2023-05-18,9822
2801,彰銀,50,3,47,元大-土城學府,2023-05-18,9822
6112,邁達特,80,43,37,元大-土城學府,2023-05-18,9822
00878,國泰永續高股息,70,34,36,元大-土城學府,2023-05-18,9822
00687B,國泰20年美債,26,0,26,元大-土城學府,2023-05-18,9822
3078,僑威,53,28,25,元大-土城學府,2023-05-18,9822
6266,泰詠,57,32,25,元大-土城學府,2023-05-18,9822
6770,力積電,24,0,24,元大-土城學府,2023-05-18,9822
3032,偉訓,22,0,22,元大-土城學府,2023-05-18,9822
1313,聯成,20,0,20,元大-土城學府,2023-05-18,9822
2025,千興,20,0,20,元大-土城學府,2023-05-18,9822
8446,華研,20,0,20,元大-土城學府,2023-05-18,9822
4931,新盛力,30,11,19,元大-土城學府,2023-05-18,9822
1906,寶隆,18,0,18,元大-土城學府,2023-05-18,9822
00882,中信中國高股息,13,0,13,元大-土城學府,2023-05-18,9822
2530,華建,13,0,13,元大-土城學府,2023-05-18,9822
6285,啟��,17,4,13,元大-土城學府,2023-05-18,9822
00725B,國泰投資級公司債,12,0,12,元大-土城學府,2023-05-18,9822
1218,泰山,12,0,12,元大-土城學府,2023-05-18,9822
00690,兆豐藍籌30,10,0,10,元大-土城學府,2023-05-18,9822
2601,益航,10,0,10,元大-土城學府,2023-05-18,9822
3615,安可,10,0,10,元大-土城學府,2023-05-18,9822
3617,碩天,15,5,10,元大-土城學府,2023-05-18,9822
4138,曜亞,10,0,10,元大-土城學府,2023-05-18,9822
4707,磐亞,10,0,10,元大-土城學府,2023-05-18,9822
5251,天鉞電,41,31,10,元大-土城學府,2023-05-18,9822
1101,台泥,17,8,9,元大-土城學府,2023-05-18,9822
2867,三商壽,9,0,9,元大-土城學府,2023-05-18,9822
3715,定穎投控,9,0,9,元大-土城學府,2023-05-18,9822
4906,正文,11,2,9,元大-土城學府,2023-05-18,9822
5475,德宏,9,0,9,元大-土城學府,2023-05-18,9822
6589,台康生技,20,11,9,元大-土城學府,2023-05-18,9822
00923,群益台ESG低碳50,14,5,9,元大-土城學府,2023-05-18,9822
1471,首利,8,0,8,元大-土城學府,2023-05-18,9822
2402,毅嘉,27,20,7,元大-土城學府,2023-05-18,9822
2887,台新金,7,0,7,元大-土城學府,2023-05-18,9822
3712,永崴投控,7,0,7,元大-土城學府,2023-05-18,9822
00713,元大台灣高息低波,7,0,7,元大-土城學府,2023-05-18,9822
2498,宏達電,18,12,6,元大-土城學府,2023-05-18,9822
2727,王品,6,0,6,元大-土城學府,2023-05-18,9822
4915,致伸,6,0,6,元大-土城學府,2023-05-18,9822
8222,寶一,48,42,6,元大-土城學府,2023-05-18,9822
2103,台橡,5,0,5,元大-土城學府,2023-05-18,9822
8069,元太,12,7,5,元大-土城學府,2023-05-18,9822
3090,日電貿,5,0,5,元大-土城學府,2023-05-18,9822
00772B,中信高評級公司債,10,5,5,元大-土城學府,2023-05-18,9822
00773B,中信優先金融債,5,0,5,元大-土城學府,2023-05-18,9822
00680L,元大美債20正2,5,0,5,元大-土城學府,2023-05-18,9822
00673R,期元大S＆P原油反1,5,0,5,元大-土城學府,2023-05-18,9822
00857B,永豐20年美公債,5,0,5,元大-土城學府,2023-05-18,9822
00632R,元大台灣50反1,108,0,108,元大-土城學府,2023-05-19,9822
2845,遠東銀,70,0,70,元大-土城學府,2023-05-19,9822
00753L,中信中國50正2,57,0,57,元大-土城學府,2023-05-19,9822
6190,萬泰科,54,0,54,元大-土城學府,2023-05-19,9822
8011,台通,52,0,52,元大-土城學府,2023-05-19,9822
1504,東元,112,61,51,元大-土城學府,2023-05-19,9822
9943,好樂迪,41,0,41,元大-土城學府,2023-05-19,9822
00720B,元大投資級公司債,38,0,38,元大-土城學府,2023-05-19,9822
3029,零壹,52,16,36,元大-土城學府,2023-05-19,9822
2610,華航,107,71,36,元大-土城學府,2023-05-19,9822
3071,協禧,34,0,34,元大-土城學府,2023-05-19,9822
1906,寶隆,27,0,27,元大-土城學府,2023-05-19,9822
2377,微星,24,0,24,元大-土城學府,2023-05-19,9822
00687B,國泰20年美債,21,0,21,元大-土城學府,2023-05-19,9822
5864,致和證,20,0,20,元大-土城學府,2023-05-19,9822
00690,兆豐藍籌30,19,0,19,元大-土城學府,2023-05-19,9822
6116,彩晶,20,2,18,元大-土城學府,2023-05-19,9822
1514,亞力,29,12,17,元大-土城學府,2023-05-19,9822
4919,新唐,17,3,14,元大-土城學府,2023-05-19,9822
3078,僑威,29,15,14,元大-土城學府,2023-05-19,9822
6517,保勝光學,29,15,14,元大-土城學府,2023-05-19,9822
00665L,富邦�琤肭磪囓�2,15,2,13,元大-土城學府,2023-05-19,9822
6112,邁達特,20,7,13,元大-土城學府,2023-05-19,9822
00637L,元大滬深300正2,54,42,12,元大-土城學府,2023-05-19,9822
2303,聯電,14,2,12,元大-土城學府,2023-05-19,9822
2471,資通,26,14,12,元大-土城學府,2023-05-19,9822
4138,曜亞,12,0,12,元大-土城學府,2023-05-19,9822
00725B,國泰投資級公司債,12,0,12,元大-土城學府,2023-05-19,9822
00679B,元大美債20年,13,2,11,元大-土城學府,2023-05-19,9822
1584,精剛,20,9,11,元大-土城學府,2023-05-19,9822
2453,凌群,19,8,11,元大-土城學府,2023-05-19,9822
00882,中信中國高股息,16,6,10,元大-土城學府,2023-05-19,9822
2206,三陽工業,27,17,10,元大-土城學府,2023-05-19,9822
00923,群益台ESG低碳50,10,0,10,元大-土城學府,2023-05-19,9822
2634,漢翔,28,18,10,元大-土城學府,2023-05-19,9822
4906,正文,10,0,10,元大-土城學府,2023-05-19,9822
00772B,中信高評級公司債,9,0,9,元大-土城學府,2023-05-19,9822
2851,中再保,9,0,9,元大-土城學府,2023-05-19,9822
3056,富華新,9,0,9,元大-土城學府,2023-05-19,9822
2482,連宇,9,1,8,元大-土城學府,2023-05-19,9822
3363,上詮,16,8,8,元大-土城學府,2023-05-19,9822
3558,神準,8,0,8,元大-土城學府,2023-05-19,9822
6122,擎邦,15,7,8,元大-土城學府,2023-05-19,9822
4967,十銓,7,0,7,元大-土城學府,2023-05-19,9822
5324,士開,7,0,7,元大-土城學府,2023-05-19,9822
6234,高僑,10,3,7,元大-土城學府,2023-05-19,9822
8261,富鼎,10,3,7,元大-土城學府,2023-05-19,9822
2317,鴻海,6,0,6,元大-土城學府,2023-05-19,9822
1721,三晃,16,10,6,元大-土城學府,2023-05-19,9822
1762,中化生,8,2,6,元大-土城學府,2023-05-19,9822
2618,長榮航,239,43,196,元大-土城學府,2023-05-22,9822
4109,加捷生醫,78,0,78,元大-土城學府,2023-05-22,9822
3231,緯創,76,15,61,元大-土城學府,2023-05-22,9822
1718,中纖,50,0,50,元大-土城學府,2023-05-22,9822
00632R,元大台灣50反1,51,10,41,元大-土城學府,2023-05-22,9822
6223,旺矽,46,6,40,元大-土城學府,2023-05-22,9822
2421,建準,43,8,35,元大-土城學府,2023-05-22,9822
2888,新光金,37,3,34,元大-土城學府,2023-05-22,9822
00715L,期街口布蘭特正2,30,0,30,元大-土城學府,2023-05-22,9822
1905,華紙,36,6,30,元大-土城學府,2023-05-22,9822
4157,太景*-KY,30,0,30,元大-土城學府,2023-05-22,9822
2743,山富,29,1,28,元大-土城學府,2023-05-22,9822
6116,彩晶,30,2,28,元大-土城學府,2023-05-22,9822
00878,國泰永續高股息,39,11,28,元大-土城學府,2023-05-22,9822
3032,偉訓,31,5,26,元大-土城學府,2023-05-22,9822
8059,凱碩,26,0,26,元大-土城學府,2023-05-22,9822
3017,奇鋐,22,0,22,元大-土城學府,2023-05-22,9822
2615,萬海,23,2,21,元大-土城學府,2023-05-22,9822
0056,元大高股息,27,6,21,元大-土城學府,2023-05-22,9822
00690,兆豐藍籌30,22,2,20,元大-土城學府,2023-05-22,9822
1727,中華化,21,1,20,元大-土城學府,2023-05-22,9822
2303,聯電,23,6,17,元大-土城學府,2023-05-22,9822
3264,欣銓,17,0,17,元大-土城學府,2023-05-22,9822
00720B,元大投資級公司債,17,0,17,元大-土城學府,2023-05-22,9822
1605,華新,16,0,16,元大-土城學府,2023-05-22,9822
2882,國泰金,16,1,15,元大-土城學府,2023-05-22,9822
2344,華邦電,31,16,15,元大-土城學府,2023-05-22,9822
6531,愛普*,18,3,15,元大-土城學府,2023-05-22,9822
00687B,國泰20年美債,12,0,12,元大-土城學府,2023-05-22,9822
1584,精剛,12,0,12,元大-土城學府,2023-05-22,9822
4968,立積,12,0,12,元大-土城學府,2023-05-22,9822
3232,昱捷,11,0,11,元大-土城學府,2023-05-22,9822
2027,大成鋼,14,4,10,元大-土城學府,2023-05-22,9822
2313,華通,11,1,10,元大-土城學府,2023-05-22,9822
6517,保勝光學,12,2,10,元大-土城學府,2023-05-22,9822
3005,神基,9,0,9,元大-土城學府,2023-05-22,9822
4967,十銓,9,0,9,元大-土城學府,2023-05-22,9822
1503,士電,35,26,9,元大-土城學府,2023-05-22,9822
1432,大魯閣,11,3,8,元大-土城學府,2023-05-22,9822
6109,亞元,8,0,8,元大-土城學府,2023-05-22,9822
00772B,中信高評級公司債,8,0,8,元大-土城學府,2023-05-22,9822
00712,復華富時不動產,7,0,7,元大-土城學府,2023-05-22,9822
2371,大同,14,7,7,元大-土城學府,2023-05-22,9822
3037,欣興,27,20,7,元大-土城學府,2023-05-22,9822
6207,雷科,7,0,7,元大-土城學府,2023-05-22,9822
00795B,中信美國公債20年,6,0,6,元大-土城學府,2023-05-22,9822
2302,麗正,6,0,6,元大-土城學府,2023-05-22,9822
2323,中環,19,13,6,元大-土城學府,2023-05-22,9822
2427,三商電,22,16,6,元大-土城學府,2023-05-22,9822
2834,臺企銀,6,0,6,元大-土城學府,2023-05-22,9822
00753L,中信中國50正2,150,0,150,元大-土城學府,2023-05-23,9822
00637L,元大滬深300正2,93,5,88,元大-土城學府,2023-05-23,9822
1701,中化,55,0,55,元大-土城學府,2023-05-23,9822
1313,聯成,35,0,35,元大-土城學府,2023-05-23,9822
1513,中興電,71,39,32,元大-土城學府,2023-05-23,9822
00706L,期元大S＆P日圓正2,30,0,30,元大-土城學府,2023-05-23,9822
1528,恩德,33,4,29,元大-土城學府,2023-05-23,9822
00687B,國泰20年美債,27,0,27,元大-土城學府,2023-05-23,9822
2640,大車隊,26,0,26,元大-土城學府,2023-05-23,9822
00882,中信中國高股息,24,0,24,元大-土城學府,2023-05-23,9822
3607,谷崧,21,0,21,元大-土城學府,2023-05-23,9822
00795B,中信美國公債20年,20,0,20,元大-土城學府,2023-05-23,9822
3481,群創,26,6,20,元大-土城學府,2023-05-23,9822
2706,第一店,19,0,19,元大-土城學府,2023-05-23,9822
3078,僑威,24,5,19,元大-土城學府,2023-05-23,9822
2421,建準,24,7,17,元大-土城學府,2023-05-23,9822
2888,新光金,17,0,17,元大-土城學府,2023-05-23,9822
2303,聯電,16,1,15,元大-土城學府,2023-05-23,9822
1514,亞力,44,29,15,元大-土城學府,2023-05-23,9822
00679B,元大美債20年,19,4,15,元大-土城學府,2023-05-23,9822
1905,華紙,57,42,15,元大-土城學府,2023-05-23,9822
2603,長榮,16,1,15,元大-土城學府,2023-05-23,9822
2409,友達,14,0,14,元大-土城學府,2023-05-23,9822
2615,萬海,15,1,14,元大-土城學府,2023-05-23,9822
8011,台通,32,18,14,元大-土城學府,2023-05-23,9822
2468,華經,13,0,13,元大-土城學府,2023-05-23,9822
2504,國產,13,0,13,元大-土城學府,2023-05-23,9822
2705,六福,33,20,13,元大-土城學府,2023-05-23,9822
00772B,中信高評級公司債,11,0,11,元大-土城學府,2023-05-23,9822
1460,宏遠,15,4,11,元大-土城學府,2023-05-23,9822
2454,聯發科,11,0,11,元大-土城學府,2023-05-23,9822
2313,華通,10,0,10,元大-土城學府,2023-05-23,9822
3017,奇鋐,11,1,10,元大-土城學府,2023-05-23,9822
3056,富華新,10,0,10,元大-土城學府,2023-05-23,9822
8121,越峰,11,1,10,元大-土城學府,2023-05-23,9822
1605,華新,15,6,9,元大-土城學府,2023-05-23,9822
2022,聚亨,9,0,9,元大-土城學府,2023-05-23,9822
6190,萬泰科,9,0,9,元大-土城學府,2023-05-23,9822
00878,國泰永續高股息,44,37,7,元大-土城學府,2023-05-23,9822
2368,金像電,10,3,7,元大-土城學府,2023-05-23,9822
2515,中工,7,0,7,元大-土城學府,2023-05-23,9822
2851,中再保,10,3,7,元大-土城學府,2023-05-23,9822
3308,聯德,10,3,7,元大-土城學府,2023-05-23,9822
6689,伊雲谷,9,2,7,元大-土城學府,2023-05-23,9822
8099,大世科,9,2,7,元大-土城學府,2023-05-23,9822
8171,天宇,6,0,6,元大-土城學府,2023-05-23,9822
00751B,元大AAA至A公司債,6,0,6,元大-土城學府,2023-05-23,9822
1519,華城,23,17,6,元大-土城學府,2023-05-23,9822
2206,三陽工業,10,4,6,元大-土城學府,2023-05-23,9822
2634,漢翔,31,25,6,元大-土城學府,2023-05-23,9822
00637L,元大滬深300正2,185,9,176,元大-土城學府,2023-05-24,9822
2618,長榮航,81,30,51,元大-土城學府,2023-05-24,9822
2634,漢翔,120,85,35,元大-土城學府,2023-05-24,9822
4109,加捷生醫,34,0,34,元大-土城學府,2023-05-24,9822
3481,群創,36,4,32,元大-土城學府,2023-05-24,9822
5905,南仁湖,39,7,32,元大-土城學府,2023-05-24,9822
00753L,中信中國50正2,31,0,31,元大-土城學府,2023-05-24,9822
3540,曜越,30,0,30,元大-土城學府,2023-05-24,9822
00882,中信中國高股息,27,0,27,元大-土城學府,2023-05-24,9822
3014,聯陽,21,0,21,元大-土城學府,2023-05-24,9822
2405,輔信,20,0,20,元大-土城學府,2023-05-24,9822
3617,碩天,20,0,20,元大-土城學府,2023-05-24,9822
2886,兆豐金,20,1,19,元大-土城學府,2023-05-24,9822
00679B,元大美債20年,19,0,19,元大-土城學府,2023-05-24,9822
2888,新光金,20,1,19,元大-土城學府,2023-05-24,9822
00632R,元大台灣50反1,45,28,17,元大-土城學府,2023-05-24,9822
2353,宏��,31,14,17,元大-土城學府,2023-05-24,9822
2457,飛宏,71,55,16,元大-土城學府,2023-05-24,9822
8176,智捷,16,0,16,元大-土城學府,2023-05-24,9822
6245,立端,16,2,14,元大-土城學府,2023-05-24,9822
00665L,富邦�琤肭磪囓�2,14,0,14,元大-土城學府,2023-05-24,9822
1101,台泥,16,3,13,元大-土城學府,2023-05-24,9822
2314,台揚,13,0,13,元大-土城學府,2023-05-24,9822
2640,大車隊,12,0,12,元大-土城學府,2023-05-24,9822
6182,合晶,17,5,12,元大-土城學府,2023-05-24,9822
2515,中工,11,0,11,元大-土城學府,2023-05-24,9822
3287,廣寰科,11,0,11,元大-土城學府,2023-05-24,9822
3504,揚明光,11,0,11,元大-土城學府,2023-05-24,9822
00795B,中信美國公債20年,10,0,10,元大-土城學府,2023-05-24,9822
2442,新美齊,14,4,10,元大-土城學府,2023-05-24,9822
3646,艾恩特,10,0,10,元大-土城學府,2023-05-24,9822
6005,群益證,10,0,10,元大-土城學府,2023-05-24,9822
6116,彩晶,10,0,10,元大-土城學府,2023-05-24,9822
8121,越峰,10,0,10,元大-土城學府,2023-05-24,9822
8076,伍豐,13,4,9,元大-土城學府,2023-05-24,9822
1527,鑽全,9,0,9,元大-土城學府,2023-05-24,9822
1906,寶隆,10,1,9,元大-土城學府,2023-05-24,9822
00680L,元大美債20正2,13,5,8,元大-土城學府,2023-05-24,9822
3596,智易,10,2,8,元大-土城學府,2023-05-24,9822
3704,合勤控,11,3,8,元大-土城學府,2023-05-24,9822
00878,國泰永續高股息,36,29,7,元大-土城學府,2023-05-24,9822
1809,中釉,24,17,7,元大-土城學府,2023-05-24,9822
2401,凌陽,7,0,7,元大-土城學府,2023-05-24,9822
3205,佰研,9,2,7,元大-土城學府,2023-05-24,9822
6202,盛群,7,0,7,元大-土城學府,2023-05-24,9822
6226,光鼎,7,0,7,元大-土城學府,2023-05-24,9822
6282,康舒,19,12,7,元大-土城學府,2023-05-24,9822
3035,智原,8,1,7,元大-土城學府,2023-05-24,9822
2734,易飛網,7,1,6,元大-土城學府,2023-05-24,9822
3701,大眾控,10,4,6,元大-土城學府,2023-05-24,9822
00706L,期元大S＆P日圓正2,130,0,130,元大-土城學府,2023-05-25,9822
00637L,元大滬深300正2,63,15,48,元大-土城學府,2023-05-25,9822
5244,弘凱,43,0,43,元大-土城學府,2023-05-25,9822
5512,力麒,40,1,39,元大-土城學府,2023-05-25,9822
00882,中信中國高股息,76,41,35,元大-土城學府,2023-05-25,9822
6112,邁達特,56,26,30,元大-土城學府,2023-05-25,9822
00632R,元大台灣50反1,130,100,30,元大-土城學府,2023-05-25,9822
1584,精剛,29,0,29,元大-土城學府,2023-05-25,9822
8121,越峰,30,1,29,元大-土城學府,2023-05-25,9822
1514,亞力,44,16,28,元大-土城學府,2023-05-25,9822
00753L,中信中國50正2,26,0,26,元大-土城學府,2023-05-25,9822
2421,建準,30,5,25,元大-土城學府,2023-05-25,9822
6016,康和證,25,0,25,元大-土城學府,2023-05-25,9822
00687B,國泰20年美債,22,0,22,元大-土城學府,2023-05-25,9822
3308,聯德,22,0,22,元大-土城學府,2023-05-25,9822
6164,華興,23,1,22,元大-土城學府,2023-05-25,9822
1905,華紙,21,0,21,元大-土城學府,2023-05-25,9822
4114,健喬,21,1,20,元大-土城學府,2023-05-25,9822
00712,復華富時不動產,20,2,18,元大-土城學府,2023-05-25,9822
3078,僑威,23,6,17,元大-土城學府,2023-05-25,9822
3707,漢磊,19,2,17,元大-土城學府,2023-05-25,9822
6190,萬泰科,20,3,17,元大-土城學府,2023-05-25,9822
2344,華邦電,23,7,16,元大-土城學府,2023-05-25,9822
3481,群創,15,0,15,元大-土城學府,2023-05-25,9822
2883,凱基金,15,1,14,元大-土城學府,2023-05-25,9822
6806,森崴能源,13,0,13,元大-土城學府,2023-05-25,9822
2457,飛宏,17,4,13,元大-土城學府,2023-05-25,9822
00673R,期元大S＆P原油反1,12,0,12,元大-土城學府,2023-05-25,9822
2377,微星,19,7,12,元大-土城學府,2023-05-25,9822
2489,瑞軒,12,0,12,元大-土城學府,2023-05-25,9822
2603,長榮,14,3,11,元大-土城學府,2023-05-25,9822
1101,台泥,11,0,11,元大-土城學府,2023-05-25,9822
1519,華城,20,9,11,元大-土城學府,2023-05-25,9822
2548,華固,11,0,11,元大-土城學府,2023-05-25,9822
2748,雲品,48,37,11,元大-土城學府,2023-05-25,9822
1108,幸福,10,0,10,元大-土城學府,2023-05-25,9822
1718,中纖,10,0,10,元大-土城學府,2023-05-25,9822
9928,中視,10,0,10,元大-土城學府,2023-05-25,9822
2640,大車隊,9,0,9,元大-土城學府,2023-05-25,9822
6547,高端疫苗,11,2,9,元大-土城學府,2023-05-25,9822
6756,威鋒電子,9,0,9,元大-土城學府,2023-05-25,9822
8940,新天地,9,0,9,元大-土城學府,2023-05-25,9822
2402,毅嘉,8,0,8,元大-土城學府,2023-05-25,9822
2610,華航,29,21,8,元大-土城學府,2023-05-25,9822
2630,亞航,20,12,8,元大-土城學府,2023-05-25,9822
1504,東元,12,5,7,元大-土城學府,2023-05-25,9822
1721,三晃,14,7,7,元大-土城學府,2023-05-25,9822
2208,台船,10,3,7,元大-土城學府,2023-05-25,9822
2449,京元電子,9,2,7,元大-土城學府,2023-05-25,9822
2705,六福,7,0,7,元大-土城學府,2023-05-25,9822
2881,富邦金,224,0,224,元大-土城學府,2023-05-26,9822
2421,建準,200,52,148,元大-土城學府,2023-05-26,9822
00712,復華富時不動產,138,0,138,元大-土城學府,2023-05-26,9822
4109,加捷生醫,65,0,65,元大-土城學府,2023-05-26,9822
2888,新光金,70,19,51,元大-土城學府,2023-05-26,9822
2887,台新金,52,6,46,元大-土城學府,2023-05-26,9822
2409,友達,50,5,45,元大-土城學府,2023-05-26,9822
1608,華榮,54,14,40,元大-土城學府,2023-05-26,9822
1721,三晃,34,0,34,元大-土城學府,2023-05-26,9822
3363,上詮,35,7,28,元大-土城學府,2023-05-26,9822
3058,立德,27,0,27,元大-土城學府,2023-05-26,9822
2883,凱基金,27,2,25,元大-土城學府,2023-05-26,9822
2634,漢翔,39,17,22,元大-土城學府,2023-05-26,9822
2498,宏達電,26,4,22,元大-土城學府,2023-05-26,9822
00882,中信中國高股息,20,0,20,元大-土城學府,2023-05-26,9822
1529,樂事綠能,23,4,19,元大-土城學府,2023-05-26,9822
9905,大華,19,0,19,元大-土城學府,2023-05-26,9822
3078,僑威,22,4,18,元大-土城學府,2023-05-26,9822
00902,中信電池及儲能,17,0,17,元大-土城學府,2023-05-26,9822
1906,寶隆,17,0,17,元大-土城學府,2023-05-26,9822
2356,英業達,34,17,17,元大-土城學府,2023-05-26,9822
00715L,期街口布蘭特正2,15,0,15,元大-土城學府,2023-05-26,9822
4746,台耀,16,1,15,元大-土城學府,2023-05-26,9822
8121,越峰,15,0,15,元大-土城學府,2023-05-26,9822
2913,農林,14,0,14,元大-土城學府,2023-05-26,9822
2317,鴻海,15,2,13,元大-土城學府,2023-05-26,9822
2002,中鋼,13,0,13,元大-土城學府,2023-05-26,9822
00795B,中信美國公債20年,13,0,13,元大-土城學府,2023-05-26,9822
00687B,國泰20年美債,13,0,13,元大-土城學府,2023-05-26,9822
2457,飛宏,24,11,13,元大-土城學府,2023-05-26,9822
3308,聯德,13,0,13,元大-土城學府,2023-05-26,9822
2606,裕民,12,0,12,元大-土城學府,2023-05-26,9822
5258,虹堡,16,4,12,元大-土城學府,2023-05-26,9822
6223,旺矽,16,4,12,元大-土城學府,2023-05-26,9822
5009,榮剛,15,4,11,元大-土城學府,2023-05-26,9822
1101,台泥,11,0,11,元大-土城學府,2023-05-26,9822
1589,永冠-KY,12,1,11,元大-土城學府,2023-05-26,9822
6570,維田,11,0,11,元大-土城學府,2023-05-26,9822
00772B,中信高評級公司債,11,0,11,元大-土城學府,2023-05-26,9822
1904,正隆,10,0,10,元大-土城學府,2023-05-26,9822
1314,中石化,10,0,10,元大-土城學府,2023-05-26,9822
1584,精剛,10,0,10,元大-土城學府,2023-05-26,9822
2889,國票金,10,0,10,元大-土城學府,2023-05-26,9822
3032,偉訓,11,1,10,元大-土城學府,2023-05-26,9822
4130,健亞,10,0,10,元大-土城學府,2023-05-26,9822
5244,弘凱,10,0,10,元大-土城學府,2023-05-26,9822
6016,康和證,10,0,10,元大-土城學府,2023-05-26,9822
6282,康舒,13,3,10,元大-土城學府,2023-05-26,9822
6841,長佳智能,10,0,10,元大-土城學府,2023-05-26,9822
8011,台通,10,0,10,元大-土城學府,2023-05-26,9822
00882,中信中國高股息,216,0,216,元大-土城學府,2023-05-29,9822
00902,中信電池及儲能,100,0,100,元大-土城學府,2023-05-29,9822
8048,德勝,42,1,41,元大-土城學府,2023-05-29,9822
2484,希華,40,0,40,元大-土城學府,2023-05-29,9822
2618,長榮航,139,102,37,元大-土城學府,2023-05-29,9822
2425,承啟,64,29,35,元大-土城學府,2023-05-29,9822
0056,元大高股息,53,19,34,元大-土城學府,2023-05-29,9822
3540,曜越,31,1,30,元大-土城學府,2023-05-29,9822
1906,寶隆,28,0,28,元大-土城學府,2023-05-29,9822
00885,富邦越南,27,0,27,元大-土城學府,2023-05-29,9822
2371,大同,54,29,25,元大-土城學府,2023-05-29,9822
4543,萬在,23,0,23,元大-土城學府,2023-05-29,9822
00923,群益台ESG低碳50,21,0,21,元大-土城學府,2023-05-29,9822
1460,宏遠,24,5,19,元大-土城學府,2023-05-29,9822
2303,聯電,53,35,18,元大-土城學府,2023-05-29,9822
3037,欣興,58,41,17,元大-土城學府,2023-05-29,9822
00688L,國泰20年美債正2,17,0,17,元大-土城學府,2023-05-29,9822
2376,技嘉,22,6,16,元大-土城學府,2023-05-29,9822
2851,中再保,16,0,16,元大-土城學府,2023-05-29,9822
3017,奇鋐,20,4,16,元大-土城學府,2023-05-29,9822
6456,GIS-KY,16,1,15,元大-土城學府,2023-05-29,9822
00895,富邦未來車,24,10,14,元大-土城學府,2023-05-29,9822
00679B,元大美債20年,20,6,14,元大-土城學府,2023-05-29,9822
1101,台泥,16,2,14,元大-土城學府,2023-05-29,9822
2601,益航,12,0,12,元大-土城學府,2023-05-29,9822
00637L,元大滬深300正2,55,44,11,元大-土城學府,2023-05-29,9822
1810,和成,12,2,10,元大-土城學府,2023-05-29,9822
2399,映泰,10,0,10,元大-土城學府,2023-05-29,9822
2889,國票金,10,0,10,元大-土城學府,2023-05-29,9822
3027,盛達,10,0,10,元大-土城學府,2023-05-29,9822
5521,工信,10,0,10,元大-土城學府,2023-05-29,9822
3231,緯創,188,179,9,元大-土城學府,2023-05-29,9822
2382,廣達,10,1,9,元大-土城學府,2023-05-29,9822
1608,華榮,15,6,9,元大-土城學府,2023-05-29,9822
2204,中華,16,7,9,元大-土城學府,2023-05-29,9822
5328,華容,9,0,9,元大-土城學府,2023-05-29,9822
2453,凌群,9,1,8,元大-土城學府,2023-05-29,9822
3232,昱捷,8,0,8,元大-土城學府,2023-05-29,9822
3711,日月光投控,9,1,8,元大-土城學府,2023-05-29,9822
4564,元翎,15,7,8,元大-土城學府,2023-05-29,9822
5905,南仁湖,12,4,8,元大-土城學府,2023-05-29,9822
3105,穩懋,8,0,8,元大-土城學府,2023-05-29,9822
4746,台耀,11,4,7,元大-土城學府,2023-05-29,9822
5706,鳳凰,13,7,6,元大-土城學府,2023-05-29,9822
00673R,期元大S＆P原油反1,6,0,6,元大-土城學府,2023-05-29,9822
00642U,期元大S＆P石油,6,0,6,元大-土城學府,2023-05-29,9822
6719,力智,6,0,6,元大-土城學府,2023-05-29,9822
8024,佑華,6,0,6,元大-土城學府,2023-05-29,9822
2408,南亞科,6,0,6,元大-土城學府,2023-05-29,9822
00893,國泰智能電動車,16,10,6,元大-土城學府,2023-05-29,9822
00882,中信中國高股息,182,0,182,元大-土城學府,2023-05-30,9822
2353,宏��,160,3,157,元大-土城學府,2023-05-30,9822
2356,英業達,164,43,121,元大-土城學府,2023-05-30,9822
1905,華紙,103,1,102,元大-土城學府,2023-05-30,9822
6125,廣運,93,2,91,元大-土城學府,2023-05-30,9822
2425,承啟,62,14,48,元大-土城學府,2023-05-30,9822
2603,長榮,47,2,45,元大-土城學府,2023-05-30,9822
2382,廣達,66,22,44,元大-土城學府,2023-05-30,9822
00922,國泰台灣領袖50,40,0,40,元大-土城學府,2023-05-30,9822
2371,大同,55,15,40,元大-土城學府,2023-05-30,9822
00902,中信電池及儲能,48,15,33,元大-土城學府,2023-05-30,9822
4109,加捷生醫,31,0,31,元大-土城學府,2023-05-30,9822
00715L,期街口布蘭特正2,25,0,25,元大-土城學府,2023-05-30,9822
6016,康和證,23,0,23,元大-土城學府,2023-05-30,9822
6770,力積電,34,14,20,元大-土城學府,2023-05-30,9822
6790,永豐實,18,0,18,元大-土城學府,2023-05-30,9822
00919,群益台灣精選高息,20,4,16,元大-土城學府,2023-05-30,9822
1605,華新,19,3,16,元大-土城學府,2023-05-30,9822
6285,啟��,16,0,16,元大-土城學府,2023-05-30,9822
3037,欣興,18,3,15,元大-土城學府,2023-05-30,9822
3032,偉訓,16,2,14,元大-土城學府,2023-05-30,9822
00712,復華富時不動產,43,30,13,元大-土城學府,2023-05-30,9822
4543,萬在,13,0,13,元大-土城學府,2023-05-30,9822
6164,華興,13,0,13,元大-土城學府,2023-05-30,9822
6756,威鋒電子,13,0,13,元大-土城學府,2023-05-30,9822
00679B,元大美債20年,12,0,12,元大-土城學府,2023-05-30,9822
3231,緯創,134,122,12,元大-土城學府,2023-05-30,9822
2637,慧洋-KY,11,0,11,元大-土城學府,2023-05-30,9822
00665L,富邦�琤肭磪囓�2,11,0,11,元大-土城學府,2023-05-30,9822
2457,飛宏,16,5,11,元大-土城學府,2023-05-30,9822
2881,富邦金,10,0,10,元大-土城學府,2023-05-30,9822
1314,中石化,10,0,10,元大-土城學府,2023-05-30,9822
2399,映泰,11,1,10,元大-土城學府,2023-05-30,9822
5521,工信,10,0,10,元大-土城學府,2023-05-30,9822
8043,蜜望實,10,0,10,元大-土城學府,2023-05-30,9822
1568,倉佑,9,0,9,元大-土城學府,2023-05-30,9822
3703,欣陸,9,0,9,元大-土城學府,2023-05-30,9822
2630,亞航,21,13,8,元大-土城學府,2023-05-30,9822
3017,奇鋐,8,0,8,元大-土城學府,2023-05-30,9822
5706,鳳凰,11,3,8,元大-土城學府,2023-05-30,9822
6282,康舒,11,3,8,元大-土城學府,2023-05-30,9822
2388,威盛,22,15,7,元大-土城學府,2023-05-30,9822
2504,國產,7,0,7,元大-土城學府,2023-05-30,9822
8109,博大,7,0,7,元大-土城學府,2023-05-30,9822
2002,中鋼,11,5,6,元大-土城學府,2023-05-30,9822
5269,祥碩,6,0,6,元大-土城學府,2023-05-30,9822
00722B,群益投資級電信債,6,0,6,元大-土城學府,2023-05-30,9822
3052,夆典,6,0,6,元大-土城學府,2023-05-30,9822
3714,富采,7,1,6,元大-土城學府,2023-05-30,9822
4114,健喬,6,0,6,元大-土城學府,2023-05-30,9822
00882,中信中國高股息,96,0,96,元大-土城學府,2023-05-31,9822
6790,永豐實,94,0,94,元大-土城學府,2023-05-31,9822
4543,萬在,92,1,91,元大-土城學府,2023-05-31,9822
00715L,期街口布蘭特正2,64,1,63,元大-土城學府,2023-05-31,9822
1504,東元,52,0,52,元大-土城學府,2023-05-31,9822
00642U,期元大S＆P石油,35,0,35,元大-土城學府,2023-05-31,9822
3265,台星科,35,1,34,元大-土城學府,2023-05-31,9822
3037,欣興,43,17,26,元大-土城學府,2023-05-31,9822
6125,廣運,26,0,26,元大-土城學府,2023-05-31,9822
00637L,元大滬深300正2,38,13,25,元大-土城學府,2023-05-31,9822
2834,臺企銀,25,2,23,元大-土城學府,2023-05-31,9822
2317,鴻海,49,27,22,元大-土城學府,2023-05-31,9822
2457,飛宏,51,29,22,元大-土城學府,2023-05-31,9822
6112,邁達特,23,3,20,元大-土城學府,2023-05-31,9822
2331,精英,23,4,19,元大-土城學府,2023-05-31,9822
3706,神達,34,17,17,元大-土城學府,2023-05-31,9822
1584,精剛,17,0,17,元大-土城學府,2023-05-31,9822
3232,昱捷,17,0,17,元大-土城學府,2023-05-31,9822
6290,良維,17,0,17,元大-土城學府,2023-05-31,9822
2356,英業達,29,12,17,元大-土城學府,2023-05-31,9822
6235,華孚,34,18,16,元大-土城學府,2023-05-31,9822
6116,彩晶,20,5,15,元大-土城學府,2023-05-31,9822
2601,益航,14,0,14,元大-土城學府,2023-05-31,9822
00878,國泰永續高股息,18,5,13,元大-土城學府,2023-05-31,9822
2883,凱基金,13,0,13,元大-土城學府,2023-05-31,9822
3504,揚明光,13,0,13,元大-土城學府,2023-05-31,9822
2323,中環,16,4,12,元大-土城學府,2023-05-31,9822
6161,捷波,13,1,12,元大-土城學府,2023-05-31,9822
6456,GIS-KY,12,0,12,元大-土城學府,2023-05-31,9822
6613,朋億*,10,0,10,元大-土城學府,2023-05-31,9822
00680L,元大美債20正2,10,0,10,元大-土城學府,2023-05-31,9822
3032,偉訓,11,1,10,元大-土城學府,2023-05-31,9822
6167,久正,10,0,10,元大-土城學府,2023-05-31,9822
2615,萬海,10,1,9,元大-土城學府,2023-05-31,9822
2449,京元電子,12,3,9,元大-土城學府,2023-05-31,9822
2603,長榮,13,5,8,元大-土城學府,2023-05-31,9822
4961,天鈺,9,1,8,元大-土城學府,2023-05-31,9822
9944,新麗,8,0,8,元大-土城學府,2023-05-31,9822
1101,台泥,10,3,7,元大-土城學府,2023-05-31,9822
1524,耿鼎,9,2,7,元大-土城學府,2023-05-31,9822
2736,富野,9,2,7,元大-土城學府,2023-05-31,9822
3704,合勤控,14,7,7,元大-土城學府,2023-05-31,9822
5531,鄉林,7,0,7,元大-土城學府,2023-05-31,9822
2382,廣達,26,19,7,元大-土城學府,2023-05-31,9822
1527,鑽全,6,0,6,元大-土城學府,2023-05-31,9822
3363,上詮,8,2,6,元大-土城學府,2023-05-31,9822
3508,位速,6,0,6,元大-土城學府,2023-05-31,9822
4162,智擎,10,4,6,元大-土城學府,2023-05-31,9822
5386,青雲,8,2,6,元大-土城學府,2023-05-31,9822
8109,博大,6,0,6,元大-土城學府,2023-05-31,9822
4543,萬在,105,5,100,元大-土城學府,2023-06-01,9822
00882,中信中國高股息,71,0,71,元大-土城學府,2023-06-01,9822
2352,佳世達,64,5,59,元大-土城學府,2023-06-01,9822
2888,新光金,58,0,58,元大-土城學府,2023-06-01,9822
00715L,期街口布蘭特正2,46,0,46,元大-土城學府,2023-06-01,9822
3013,晟銘電,47,16,31,元大-土城學府,2023-06-01,9822
1525,江申,25,1,24,元大-土城學府,2023-06-01,9822
2515,中工,52,28,24,元大-土城學府,2023-06-01,9822
1313,聯成,27,5,22,元大-土城學府,2023-06-01,9822
00642U,期元大S＆P石油,21,0,21,元大-土城學府,2023-06-01,9822
6485,點序,20,0,20,元大-土城學府,2023-06-01,9822
3041,揚智,17,0,17,元大-土城學府,2023-06-01,9822
2615,萬海,16,0,16,元大-土城學府,2023-06-01,9822
2425,承啟,21,5,16,元大-土城學府,2023-06-01,9822
6235,華孚,38,23,15,元大-土城學府,2023-06-01,9822
1616,億泰,14,0,14,元大-土城學府,2023-06-01,9822
3706,神達,44,30,14,元大-土城學府,2023-06-01,9822
2323,中環,40,27,13,元大-土城學府,2023-06-01,9822
2371,大同,17,4,13,元大-土城學府,2023-06-01,9822
1513,中興電,18,7,11,元大-土城學府,2023-06-01,9822
2206,三陽工業,17,6,11,元大-土城學府,2023-06-01,9822
2489,瑞軒,34,23,11,元大-土城學府,2023-06-01,9822
5706,鳳凰,38,27,11,元大-土城學府,2023-06-01,9822
6806,森崴能源,10,0,10,元大-土城學府,2023-06-01,9822
00900,富邦特選高股息30,14,4,10,元大-土城學府,2023-06-01,9822
8033,雷虎,10,0,10,元大-土城學府,2023-06-01,9822
00881,國泰台灣5G+,9,0,9,元大-土城學府,2023-06-01,9822
2609,陽明,11,2,9,元大-土城學府,2023-06-01,9822
4577,達航科技,9,0,9,元大-土城學府,2023-06-01,9822
00923,群益台ESG低碳50,12,4,8,元大-土城學府,2023-06-01,9822
1605,華新,9,1,8,元大-土城學府,2023-06-01,9822
2388,威盛,16,8,8,元大-土城學府,2023-06-01,9822
2890,永豐金,8,0,8,元大-土城學府,2023-06-01,9822
3059,華晶科,14,6,8,元大-土城學府,2023-06-01,9822
4564,元翎,16,8,8,元大-土城學府,2023-06-01,9822
6182,合晶,8,0,8,元大-土城學府,2023-06-01,9822
1101,台泥,8,0,8,元大-土城學府,2023-06-01,9822
2603,長榮,10,3,7,元大-土城學府,2023-06-01,9822
2356,英業達,11,4,7,元大-土城學府,2023-06-01,9822
2382,廣達,10,3,7,元大-土城學府,2023-06-01,9822
00633L,富邦上証正2,7,0,7,元大-土城學府,2023-06-01,9822
00712,復華富時不動產,7,0,7,元大-土城學府,2023-06-01,9822
2630,亞航,59,52,7,元大-土城學府,2023-06-01,9822
3205,佰研,8,1,7,元大-土城學府,2023-06-01,9822
3704,合勤控,10,3,7,元大-土城學府,2023-06-01,9822
4919,新唐,8,1,7,元大-土城學府,2023-06-01,9822
2454,聯發科,6,0,6,元大-土城學府,2023-06-01,9822
3029,零壹,7,1,6,元大-土城學府,2023-06-01,9822
2449,京元電子,8,2,6,元大-土城學府,2023-06-01,9822
2883,凱基金,6,0,6,元大-土城學府,2023-06-01,9822
00919,群益台灣精選高息,414,0,414,元大-土城學府,2023-06-02,9822
2610,華航,208,29,179,元大-土城學府,2023-06-02,9822
2618,長榮航,253,114,139,元大-土城學府,2023-06-02,9822
1504,東元,156,33,123,元大-土城學府,2023-06-02,9822
4543,萬在,125,30,95,元大-土城學府,2023-06-02,9822
3363,上詮,66,15,51,元大-土城學府,2023-06-02,9822
2881,富邦金,50,5,45,元大-土城學府,2023-06-02,9822
2371,大同,64,22,42,元大-土城學府,2023-06-02,9822
2891,中信金,36,0,36,元大-土城學府,2023-06-02,9822
5521,工信,35,0,35,元大-土城學府,2023-06-02,9822
00882,中信中國高股息,34,0,34,元大-土城學府,2023-06-02,9822
00895,富邦未來車,34,3,31,元大-土城學府,2023-06-02,9822
00720B,元大投資級公司債,30,0,30,元大-土城學府,2023-06-02,9822
2421,建準,37,7,30,元大-土城學府,2023-06-02,9822
00751B,元大AAA至A公司債,30,1,29,元大-土城學府,2023-06-02,9822
2892,第一金,28,0,28,元大-土城學府,2023-06-02,9822
3231,緯創,176,153,23,元大-土城學府,2023-06-02,9822
2356,英業達,60,39,21,元大-土城學府,2023-06-02,9822
3710,連展投控,20,0,20,元大-土城學府,2023-06-02,9822
5512,力麒,21,3,18,元大-土城學府,2023-06-02,9822
6185,幃翔,22,4,18,元大-土城學府,2023-06-02,9822
3006,晶豪科,20,3,17,元大-土城學府,2023-06-02,9822
4916,事欣科,15,0,15,元大-土城學府,2023-06-02,9822
6579,研揚,19,4,15,元大-土城學府,2023-06-02,9822
1762,中化生,13,0,13,元大-土城學府,2023-06-02,9822
2368,金像電,26,14,12,元大-土城學府,2023-06-02,9822
8277,商丞,12,0,12,元大-土城學府,2023-06-02,9822
2614,東森,11,0,11,元大-土城學府,2023-06-02,9822
1218,泰山,13,2,11,元大-土城學府,2023-06-02,9822
3591,艾笛森,11,0,11,元大-土城學府,2023-06-02,9822
6547,高端疫苗,12,1,11,元大-土城學府,2023-06-02,9822
2887,台新金,10,0,10,元大-土城學府,2023-06-02,9822
3504,揚明光,10,0,10,元大-土城學府,2023-06-02,9822
6153,嘉聯益,12,2,10,元大-土城學府,2023-06-02,9822
3521,鴻翊,9,0,9,元大-土城學府,2023-06-02,9822
5243,乙盛-KY,12,3,9,元大-土城學府,2023-06-02,9822
6015,宏遠證,10,1,9,元大-土城學府,2023-06-02,9822
00637L,元大滬深300正2,10,2,8,元大-土城學府,2023-06-02,9822
00679B,元大美債20年,9,1,8,元大-土城學府,2023-06-02,9822
1612,宏泰,9,1,8,元大-土城學府,2023-06-02,9822
2442,新美齊,8,0,8,元大-土城學府,2023-06-02,9822
3501,維熹,8,0,8,元大-土城學府,2023-06-02,9822
6770,力積電,29,21,8,元大-土城學府,2023-06-02,9822
4763,材料-KY,15,8,7,元大-土城學府,2023-06-02,9822
2489,瑞軒,22,15,7,元大-土城學府,2023-06-02,9822
2206,三陽工業,53,46,7,元大-土城學府,2023-06-02,9822
1711,永光,7,0,7,元大-土城學府,2023-06-02,9822
2313,華通,7,0,7,元大-土城學府,2023-06-02,9822
2609,陽明,8,1,7,元大-土城學府,2023-06-02,9822
2702,華園,8,1,7,元大-土城學府,2023-06-02,9822
00679B,元大美債20年,248,3,245,元大-土城學府,2023-06-05,9822
6125,廣運,159,8,151,元大-土城學府,2023-06-05,9822
2329,華泰,135,8,127,元大-土城學府,2023-06-05,9822
2618,長榮航,113,13,100,元大-土城學府,2023-06-05,9822
2331,精英,85,0,85,元大-土城學府,2023-06-05,9822
1909,榮成,41,6,35,元大-土城學府,2023-06-05,9822
2344,華邦電,37,3,34,元大-土城學府,2023-06-05,9822
00673R,期元大S＆P原油反1,31,0,31,元大-土城學府,2023-06-05,9822
1314,中石化,33,2,31,元大-土城學府,2023-06-05,9822
1718,中纖,30,0,30,元大-土城學府,2023-06-05,9822
6770,力積電,26,1,25,元大-土城學府,2023-06-05,9822
6790,永豐實,22,0,22,元大-土城學府,2023-06-05,9822
6485,點序,21,0,21,元大-土城學府,2023-06-05,9822
6282,康舒,55,35,20,元大-土城學府,2023-06-05,9822
00919,群益台灣精選高息,20,0,20,元大-土城學府,2023-06-05,9822
1905,華紙,34,14,20,元大-土城學府,2023-06-05,9822
2884,玉山金,23,3,20,元大-土城學府,2023-06-05,9822
6220,岳豐,20,0,20,元大-土城學府,2023-06-05,9822
2609,陽明,21,1,20,元大-土城學府,2023-06-05,9822
4543,萬在,22,3,19,元大-土城學府,2023-06-05,9822
3013,晟銘電,30,12,18,元大-土城學府,2023-06-05,9822
2206,三陽工業,31,14,17,元大-土城學府,2023-06-05,9822
2601,益航,17,0,17,元大-土城學府,2023-06-05,9822
2353,宏��,22,6,16,元大-土城學府,2023-06-05,9822
1603,華電,15,0,15,元大-土城學府,2023-06-05,9822
1529,樂事綠能,15,1,14,元大-土城學府,2023-06-05,9822
6160,欣技,22,8,14,元大-土城學府,2023-06-05,9822
00713,元大台灣高息低波,14,0,14,元大-土城學府,2023-06-05,9822
1611,中電,14,1,13,元大-土城學府,2023-06-05,9822
1218,泰山,12,0,12,元大-土城學府,2023-06-05,9822
3363,上詮,30,19,11,元大-土城學府,2023-06-05,9822
3710,連展投控,10,0,10,元大-土城學府,2023-06-05,9822
4510,高鋒,10,0,10,元大-土城學府,2023-06-05,9822
5243,乙盛-KY,11,1,10,元大-土城學府,2023-06-05,9822
5465,富驊,10,0,10,元大-土城學府,2023-06-05,9822
1727,中華化,9,0,9,元大-土城學府,2023-06-05,9822
1513,中興電,10,2,8,元大-土城學府,2023-06-05,9822
00900,富邦特選高股息30,8,0,8,元大-土城學府,2023-06-05,9822
1802,台玻,15,7,8,元大-土城學府,2023-06-05,9822
2406,國碩,8,0,8,元大-土城學府,2023-06-05,9822
3454,晶睿,10,2,8,元大-土城學府,2023-06-05,9822
3005,神基,7,0,7,元大-土城學府,2023-06-05,9822
00881,國泰台灣5G+,7,0,7,元大-土城學府,2023-06-05,9822
00893,國泰智能電動車,7,0,7,元大-土城學府,2023-06-05,9822
1319,東陽,20,13,7,元大-土城學府,2023-06-05,9822
2332,友訊,8,1,7,元大-土城學府,2023-06-05,9822
2486,一詮,20,13,7,元大-土城學府,2023-06-05,9822
2606,裕民,7,0,7,元大-土城學府,2023-06-05,9822
2734,易飛網,9,2,7,元大-土城學府,2023-06-05,9822
2913,農林,14,7,7,元大-土城學府,2023-06-05,9822
1609,大亞,160,52,108,元大-土城學府,2023-06-06,9822
6790,永豐實,83,0,83,元大-土城學府,2023-06-06,9822
2317,鴻海,84,6,78,元大-土城學府,2023-06-06,9822
00632R,元大台灣50反1,77,0,77,元大-土城學府,2023-06-06,9822
2888,新光金,74,1,73,元大-土城學府,2023-06-06,9822
2353,宏��,62,6,56,元大-土城學府,2023-06-06,9822
1605,華新,70,14,56,元大-土城學府,2023-06-06,9822
4916,事欣科,66,12,54,元大-土城學府,2023-06-06,9822
00919,群益台灣精選高息,50,0,50,元大-土城學府,2023-06-06,9822
2498,宏達電,46,3,43,元大-土城學府,2023-06-06,9822
2618,長榮航,73,34,39,元大-土城學府,2023-06-06,9822
1218,泰山,39,1,38,元大-土城學府,2023-06-06,9822
0056,元大高股息,43,6,37,元大-土城學府,2023-06-06,9822
6116,彩晶,178,142,36,元大-土城學府,2023-06-06,9822
2834,臺企銀,36,0,36,元大-土城學府,2023-06-06,9822
2402,毅嘉,49,16,33,元大-土城學府,2023-06-06,9822
00720B,元大投資級公司債,24,1,23,元大-土城學府,2023-06-06,9822
2427,三商電,28,7,21,元大-土城學府,2023-06-06,9822
1310,台苯,20,0,20,元大-土城學府,2023-06-06,9822
5521,工信,20,0,20,元大-土城學府,2023-06-06,9822
9945,潤泰新,19,0,19,元大-土城學府,2023-06-06,9822
2328,廣宇,21,2,19,元大-土城學府,2023-06-06,9822
3706,神達,31,14,17,元大-土城學府,2023-06-06,9822
00687B,國泰20年美債,16,0,16,元大-土城學府,2023-06-06,9822
6282,康舒,39,24,15,元大-土城學府,2023-06-06,9822
3231,緯創,56,41,15,元大-土城學府,2023-06-06,9822
3380,明泰,17,4,13,元大-土城學府,2023-06-06,9822
00679B,元大美債20年,12,0,12,元大-土城學府,2023-06-06,9822
2515,中工,23,11,12,元大-土城學府,2023-06-06,9822
2331,精英,15,4,11,元大-土城學府,2023-06-06,9822
1528,恩德,11,0,11,元大-土城學府,2023-06-06,9822
1802,台玻,11,0,11,元大-土城學府,2023-06-06,9822
3704,合勤控,11,0,11,元大-土城學府,2023-06-06,9822
2913,農林,12,2,10,元大-土城學府,2023-06-06,9822
1313,聯成,10,0,10,元大-土城學府,2023-06-06,9822
2607,榮運,10,0,10,元大-土城學府,2023-06-06,9822
3052,夆典,10,0,10,元大-土城學府,2023-06-06,9822
3062,建漢,10,0,10,元大-土城學府,2023-06-06,9822
6248,沛波,10,0,10,元大-土城學府,2023-06-06,9822
00795B,中信美國公債20年,9,0,9,元大-土城學府,2023-06-06,9822
00712,復華富時不動產,9,0,9,元大-土城學府,2023-06-06,9822
2615,萬海,11,2,9,元大-土城學府,2023-06-06,9822
1810,和成,9,0,9,元大-土城學府,2023-06-06,9822
00927,群益半導體收益,9,0,9,元大-土城學府,2023-06-06,9822
1608,華榮,9,0,9,元大-土城學府,2023-06-06,9822
6235,華孚,37,28,9,元大-土城學府,2023-06-06,9822
1519,華城,22,14,8,元大-土城學府,2023-06-06,9822
3025,星通,15,7,8,元大-土城學府,2023-06-06,9822
5386,青雲,9,1,8,元大-土城學府,2023-06-06,9822
2442,新美齊,7,0,7,元大-土城學府,2023-06-06,9822
2637,慧洋-KY,202,0,202,元大-土城學府,2023-06-07,9822
2344,華邦電,112,5,107,元大-土城學府,2023-06-07,9822
2515,中工,96,13,83,元大-土城學府,2023-06-07,9822
3704,合勤控,93,20,73,元大-土城學府,2023-06-07,9822
1909,榮成,42,2,40,元大-土城學府,2023-06-07,9822
00882,中信中國高股息,36,0,36,元大-土城學府,2023-06-07,9822
1609,大亞,132,96,36,元大-土城學府,2023-06-07,9822
1514,亞力,37,1,36,元大-土城學府,2023-06-07,9822
5521,工信,35,0,35,元大-土城學府,2023-06-07,9822
2347,聯強,31,0,31,元大-土城學府,2023-06-07,9822
6125,廣運,42,14,28,元大-土城學府,2023-06-07,9822
4543,萬在,29,1,28,元大-土城學府,2023-06-07,9822
2706,第一店,29,3,26,元大-土城學府,2023-06-07,9822
2611,志信,25,0,25,元大-土城學府,2023-06-07,9822
2618,長榮航,47,22,25,元大-土城學府,2023-06-07,9822
2206,三陽工業,54,30,24,元大-土城學府,2023-06-07,9822
1416,廣豐,20,0,20,元大-土城學府,2023-06-07,9822
2425,承啟,20,0,20,元大-土城學府,2023-06-07,9822
00895,富邦未來車,20,1,19,元大-土城學府,2023-06-07,9822
00893,國泰智能電動車,34,15,19,元大-土城學府,2023-06-07,9822
3003,健和興,19,0,19,元大-土城學府,2023-06-07,9822
3711,日月光投控,24,5,19,元大-土城學府,2023-06-07,9822
1444,力麗,16,0,16,元大-土城學府,2023-06-07,9822
2705,六福,30,14,16,元大-土城學府,2023-06-07,9822
2402,毅嘉,28,14,14,元大-土城學府,2023-06-07,9822
1608,華榮,20,7,13,元大-土城學府,2023-06-07,9822
00919,群益台灣精選高息,14,1,13,元大-土城學府,2023-06-07,9822
00679B,元大美債20年,12,0,12,元大-土城學府,2023-06-07,9822
2615,萬海,16,4,12,元大-土城學府,2023-06-07,9822
6282,康舒,23,12,11,元大-土城學府,2023-06-07,9822
1618,合機,11,0,11,元大-土城學府,2023-06-07,9822
2701,萬企,18,7,11,元大-土城學府,2023-06-07,9822
2354,鴻準,10,0,10,元大-土城學府,2023-06-07,9822
3706,神達,10,0,10,元大-土城學府,2023-06-07,9822
6485,點序,10,0,10,元大-土城學府,2023-06-07,9822
00715L,期街口布蘭特正2,9,0,9,元大-土城學府,2023-06-07,9822
3260,威剛,11,2,9,元大-土城學府,2023-06-07,9822
5864,致和證,9,0,9,元大-土城學府,2023-06-07,9822
1762,中化生,8,0,8,元大-土城學府,2023-06-07,9822
1217,愛之味,10,2,8,元大-土城學府,2023-06-07,9822
1460,宏遠,8,0,8,元大-土城學府,2023-06-07,9822
2888,新光金,21,13,8,元大-土城學府,2023-06-07,9822
3290,東浦,8,0,8,元大-土城學府,2023-06-07,9822
8011,台通,8,0,8,元大-土城學府,2023-06-07,9822
00878,國泰永續高股息,14,6,8,元大-土城學府,2023-06-07,9822
2457,飛宏,12,5,7,元大-土城學府,2023-06-07,9822
2399,映泰,9,2,7,元大-土城學府,2023-06-07,9822
4161,聿新科,7,0,7,元大-土城學府,2023-06-07,9822
6175,立敦,10,3,7,元大-土城學府,2023-06-07,9822
2545,皇翔,9,2,7,元大-土城學府,2023-06-07,9822
1513,中興電,92,18,74,元大-土城學府,2023-06-08,9822
6270,倍微,74,0,74,元大-土城學府,2023-06-08,9822
3704,合勤控,81,10,71,元大-土城學府,2023-06-08,9822
2349,錸德,64,3,61,元大-土城學府,2023-06-08,9822
1618,合機,51,0,51,元大-土城學府,2023-06-08,9822
2618,長榮航,233,182,51,元大-土城學府,2023-06-08,9822
00751B,元大AAA至A公司債,51,1,50,元大-土城學府,2023-06-08,9822
2344,華邦電,46,2,44,元大-土城學府,2023-06-08,9822
00673R,期元大S＆P原油反1,44,0,44,元大-土城學府,2023-06-08,9822
2329,華泰,40,1,39,元大-土城學府,2023-06-08,9822
00919,群益台灣精選高息,36,0,36,元大-土城學府,2023-06-08,9822
00679B,元大美債20年,34,0,34,元大-土城學府,2023-06-08,9822
1217,愛之味,30,2,28,元大-土城學府,2023-06-08,9822
00720B,元大投資級公司債,28,1,27,元大-土城學府,2023-06-08,9822
2882,國泰金,25,1,24,元大-土城學府,2023-06-08,9822
3037,欣興,35,12,23,元大-土城學府,2023-06-08,9822
6188,廣明,23,0,23,元大-土城學府,2023-06-08,9822
4543,萬在,29,6,23,元大-土城學府,2023-06-08,9822
6203,海韻電,23,0,23,元大-土城學府,2023-06-08,9822
8171,天宇,23,0,23,元大-土城學府,2023-06-08,9822
6577,勁豐,22,0,22,元大-土城學府,2023-06-08,9822
2206,三陽工業,42,20,22,元大-土城學府,2023-06-08,9822
1612,宏泰,22,1,21,元大-土城學府,2023-06-08,9822
2641,正德,21,0,21,元大-土城學府,2023-06-08,9822
00669R,國泰美國道瓊反1,21,1,20,元大-土城學府,2023-06-08,9822
3078,僑威,20,3,17,元大-土城學府,2023-06-08,9822
2382,廣達,23,6,17,元大-土城學府,2023-06-08,9822
00687B,國泰20年美債,16,0,16,元大-土城學府,2023-06-08,9822
00878,國泰永續高股息,54,38,16,元大-土城學府,2023-06-08,9822
2388,威盛,22,7,15,元大-土城學府,2023-06-08,9822
6285,啟��,20,5,15,元大-土城學府,2023-06-08,9822
1432,大魯閣,30,18,12,元大-土城學府,2023-06-08,9822
4930,燦星網,12,0,12,元大-土城學府,2023-06-08,9822
6153,嘉聯益,12,0,12,元大-土城學府,2023-06-08,9822
1605,華新,23,12,11,元大-土城學府,2023-06-08,9822
3029,零壹,19,8,11,元大-土城學府,2023-06-08,9822
00904,新光臺灣半導體30,10,0,10,元大-土城學府,2023-06-08,9822
00923,群益台ESG低碳50,10,0,10,元大-土城學府,2023-06-08,9822
1444,力麗,16,6,10,元大-土城學府,2023-06-08,9822
3380,明泰,11,1,10,元大-土城學府,2023-06-08,9822
5864,致和證,10,0,10,元大-土城學府,2023-06-08,9822
2347,聯強,9,0,9,元大-土城學府,2023-06-08,9822
2498,宏達電,9,0,9,元大-土城學府,2023-06-08,9822
00882,中信中國高股息,11,2,9,元大-土城學府,2023-06-08,9822
1802,台玻,11,2,9,元大-土城學府,2023-06-08,9822
6547,高端疫苗,8,0,8,元大-土城學府,2023-06-08,9822
0056,元大高股息,23,15,8,元大-土城學府,2023-06-08,9822
1711,永光,8,0,8,元大-土城學府,2023-06-08,9822
2022,聚亨,8,0,8,元大-土城學府,2023-06-08,9822
2312,金寶,9,1,8,元大-土城學府,2023-06-08,9822
2888,新光金,522,5,517,元大-土城學府,2023-06-09,9822
2610,華航,175,7,168,元大-土城學府,2023-06-09,9822
2601,益航,80,0,80,元大-土城學府,2023-06-09,9822
2891,中信金,83,5,78,元大-土城學府,2023-06-09,9822
5905,南仁湖,62,0,62,元大-土城學府,2023-06-09,9822
00929,復華台灣科技優息,51,0,51,元大-土城學府,2023-06-09,9822
2409,友達,51,2,49,元大-土城學府,2023-06-09,9822
1609,大亞,107,60,47,元大-土城學府,2023-06-09,9822
3363,上詮,44,3,41,元大-土城學府,2023-06-09,9822
5701,劍湖山,40,0,40,元大-土城學府,2023-06-09,9822
6203,海韻電,39,0,39,元大-土城學府,2023-06-09,9822
8926,台汽電,47,12,35,元大-土城學府,2023-06-09,9822
6266,泰詠,33,2,31,元大-土城學府,2023-06-09,9822
00715L,期街口布蘭特正2,28,0,28,元大-土城學府,2023-06-09,9822
00919,群益台灣精選高息,26,0,26,元大-土城學府,2023-06-09,9822
5309,系統電,30,4,26,元大-土城學府,2023-06-09,9822
00632R,元大台灣50反1,45,20,25,元大-土城學府,2023-06-09,9822
2353,宏��,27,6,21,元大-土城學府,2023-06-09,9822
2705,六福,25,5,20,元大-土城學府,2023-06-09,9822
2428,興勤,19,0,19,元大-土城學府,2023-06-09,9822
1608,華榮,19,1,18,元大-土城學府,2023-06-09,9822
2323,中環,36,18,18,元大-土城學府,2023-06-09,9822
2706,第一店,20,2,18,元大-土城學府,2023-06-09,9822
00893,國泰智能電動車,21,5,16,元大-土城學府,2023-06-09,9822
6570,維田,17,1,16,元大-土城學府,2023-06-09,9822
8358,金居,17,2,15,元大-土城學府,2023-06-09,9822
3704,合勤控,12,0,12,元大-土城學府,2023-06-09,9822
1533,車王電,12,1,11,元大-土城學府,2023-06-09,9822
6456,GIS-KY,11,0,11,元大-土城學府,2023-06-09,9822
2634,漢翔,24,13,11,元大-土城學府,2023-06-09,9822
1504,東元,32,21,11,元大-土城學府,2023-06-09,9822
2482,連宇,19,9,10,元大-土城學府,2023-06-09,9822
2630,亞航,33,23,10,元大-土城學府,2023-06-09,9822
3511,矽瑪,10,0,10,元大-土城學府,2023-06-09,9822
6282,康舒,16,6,10,元大-土城學府,2023-06-09,9822
2887,台新金,10,0,10,元大-土城學府,2023-06-09,9822
1314,中石化,10,1,9,元大-土城學府,2023-06-09,9822
00650L,復華香港正2,9,0,9,元大-土城學府,2023-06-09,9822
6625,必應,18,9,9,元大-土城學府,2023-06-09,9822
8171,天宇,9,0,9,元大-土城學府,2023-06-09,9822
00712,復華富時不動產,9,0,9,元大-土城學府,2023-06-09,9822
1752,南光,12,4,8,元大-土城學府,2023-06-09,9822
2722,夏都,12,4,8,元大-土城學府,2023-06-09,9822
4543,萬在,10,2,8,元大-土城學府,2023-06-09,9822
2883,凱基金,11,4,7,元大-土城學府,2023-06-09,9822
4961,天鈺,7,0,7,元大-土城學府,2023-06-09,9822
8403,盛弘,7,0,7,元大-土城學府,2023-06-09,9822
2916,滿心,6,0,6,元大-土城學府,2023-06-09,9822
6194,育富,6,0,6,元大-土城學府,2023-06-09,9822
6125,廣運,24,18,6,元大-土城學府,2023-06-09,9822
5465,富驊,125,19,106,元大-土城學府,2023-06-12,9822
2421,建準,81,2,79,元大-土城學府,2023-06-12,9822
00715L,期街口布蘭特正2,75,0,75,元大-土城學府,2023-06-12,9822
00929,復華台灣科技優息,71,2,69,元大-土城學府,2023-06-12,9822
3078,僑威,110,44,66,元大-土城學府,2023-06-12,9822
2425,承啟,66,3,63,元大-土城學府,2023-06-12,9822
2888,新光金,76,22,54,元大-土城學府,2023-06-12,9822
00895,富邦未來車,54,1,53,元大-土城學府,2023-06-12,9822
2323,中環,52,5,47,元大-土城學府,2023-06-12,9822
8926,台汽電,74,27,47,元大-土城學府,2023-06-12,9822
4130,健亞,46,0,46,元大-土城學府,2023-06-12,9822
00878,國泰永續高股息,56,11,45,元大-土城學府,2023-06-12,9822
1522,堤維西,52,7,45,元大-土城學府,2023-06-12,9822
2610,華航,50,9,41,元大-土城學府,2023-06-12,9822
2618,長榮航,123,83,40,元大-土城學府,2023-06-12,9822
1584,精剛,38,0,38,元大-土城學府,2023-06-12,9822
1905,華紙,36,0,36,元大-土城學府,2023-06-12,9822
2641,正德,30,0,30,元大-土城學府,2023-06-12,9822
3231,緯創,99,71,28,元大-土城學府,2023-06-12,9822
2388,威盛,38,10,28,元大-土城學府,2023-06-12,9822
0056,元大高股息,72,46,26,元大-土城學府,2023-06-12,9822
1609,大亞,61,36,25,元大-土城學府,2023-06-12,9822
1513,中興電,29,8,21,元大-土城學府,2023-06-12,9822
00919,群益台灣精選高息,35,15,20,元大-土城學府,2023-06-12,9822
1218,泰山,21,2,19,元大-土城學府,2023-06-12,9822
2374,佳能,18,0,18,元大-土城學府,2023-06-12,9822
1762,中化生,17,0,17,元大-土城學府,2023-06-12,9822
3380,明泰,16,1,15,元大-土城學府,2023-06-12,9822
3704,合勤控,23,8,15,元大-土城學府,2023-06-12,9822
4543,萬在,16,1,15,元大-土城學府,2023-06-12,9822
1618,合機,14,0,14,元大-土城學府,2023-06-12,9822
2402,毅嘉,14,0,14,元大-土城學府,2023-06-12,9822
4979,華星光,29,15,14,元大-土城學府,2023-06-12,9822
5410,國眾,12,0,12,元大-土城學府,2023-06-12,9822
00893,國泰智能電動車,24,12,12,元大-土城學府,2023-06-12,9822
6015,宏遠證,12,0,12,元大-土城學府,2023-06-12,9822
2881,富邦金,11,0,11,元大-土城學府,2023-06-12,9822
5009,榮剛,12,1,11,元大-土城學府,2023-06-12,9822
8033,雷虎,11,0,11,元大-土城學府,2023-06-12,9822
00664R,國泰臺灣加權反1,10,0,10,元大-土城學府,2023-06-12,9822
1603,華電,10,0,10,元大-土城學府,2023-06-12,9822
2354,鴻準,10,0,10,元大-土城學府,2023-06-12,9822
6016,康和證,10,0,10,元大-土城學府,2023-06-12,9822
8085,福華,10,0,10,元大-土城學府,2023-06-12,9822
1608,華榮,22,13,9,元大-土城學府,2023-06-12,9822
3037,欣興,25,16,9,元大-土城學府,2023-06-12,9822
6547,高端疫苗,9,0,9,元大-土城學府,2023-06-12,9822
8403,盛弘,9,0,9,元大-土城學府,2023-06-12,9822
1101,台泥,9,0,9,元大-土城學府,2023-06-12,9822
00642U,期元大S＆P石油,9,1,8,元大-土城學府,2023-06-12,9822
00715L,期街口布蘭特正2,71,0,71,元大-土城學府,2023-06-13,9822
1319,東陽,70,0,70,元大-土城學府,2023-06-13,9822
9939,宏全,65,0,65,元大-土城學府,2023-06-13,9822
00891,中信關鍵半導體,59,0,59,元大-土城學府,2023-06-13,9822
00642U,期元大S＆P石油,55,0,55,元大-土城學府,2023-06-13,9822
2206,三陽工業,69,16,53,元大-土城學府,2023-06-13,9822
00720B,元大投資級公司債,46,0,46,元大-土城學府,2023-06-13,9822
6116,彩晶,50,9,41,元大-土城學府,2023-06-13,9822
4114,健喬,40,0,40,元大-土城學府,2023-06-13,9822
2888,新光金,46,7,39,元大-土城學府,2023-06-13,9822
00929,復華台灣科技優息,34,1,33,元大-土城學府,2023-06-13,9822
4533,協易機,33,1,32,元大-土城學府,2023-06-13,9822
00751B,元大AAA至A公司債,31,0,31,元大-土城學府,2023-06-13,9822
2851,中再保,31,0,31,元大-土城學府,2023-06-13,9822
00893,國泰智能電動車,52,22,30,元大-土城學府,2023-06-13,9822
00919,群益台灣精選高息,27,0,27,元大-土城學府,2023-06-13,9822
8926,台汽電,26,0,26,元大-土城學府,2023-06-13,9822
00712,復華富時不動產,26,0,26,元大-土城學府,2023-06-13,9822
2731,雄獅,26,1,25,元大-土城學府,2023-06-13,9822
5521,工信,25,0,25,元大-土城學府,2023-06-13,9822
4543,萬在,27,5,22,元大-土城學府,2023-06-13,9822
1907,永豐餘,21,0,21,元大-土城學府,2023-06-13,9822
3576,聯合再生,20,0,20,元大-土城學府,2023-06-13,9822
5244,弘凱,18,0,18,元大-土城學府,2023-06-13,9822
1218,泰山,15,1,14,元大-土城學府,2023-06-13,9822
6117,迎廣,14,0,14,元大-土城學府,2023-06-13,9822
1528,恩德,12,0,12,元大-土城學府,2023-06-13,9822
3032,偉訓,20,8,12,元大-土城學府,2023-06-13,9822
3434,哲固,13,1,12,元大-土城學府,2023-06-13,9822
1605,華新,13,2,11,元大-土城學府,2023-06-13,9822
6148,驊宏資,11,0,11,元大-土城學府,2023-06-13,9822
1519,華城,15,5,10,元大-土城學府,2023-06-13,9822
1714,和桐,10,0,10,元大-土城學府,2023-06-13,9822
2349,錸德,10,0,10,元大-土城學府,2023-06-13,9822
2614,東森,10,0,10,元大-土城學府,2023-06-13,9822
3518,柏騰,10,0,10,元大-土城學府,2023-06-13,9822
1514,亞力,9,0,9,元大-土城學府,2023-06-13,9822
4130,健亞,9,0,9,元大-土城學府,2023-06-13,9822
2031,新光鋼,8,0,8,元大-土城學府,2023-06-13,9822
3014,聯陽,10,2,8,元大-土城學府,2023-06-13,9822
00713,元大台灣高息低波,7,0,7,元大-土城學府,2023-06-13,9822
6770,力積電,7,0,7,元大-土城學府,2023-06-13,9822
3022,威強電,8,1,7,元大-土城學府,2023-06-13,9822
6517,保勝光學,18,11,7,元大-土城學府,2023-06-13,9822
2371,大同,12,5,7,元大-土城學府,2023-06-13,9822
2376,技嘉,14,8,6,元大-土城學府,2023-06-13,9822
2347,聯強,6,0,6,元大-土城學府,2023-06-13,9822
2374,佳能,6,0,6,元大-土城學府,2023-06-13,9822
2439,美律,6,0,6,元大-土城學府,2023-06-13,9822
2705,六福,12,6,6,元大-土城學府,2023-06-13,9822
2468,華經,108,16,92,元大-土城學府,2023-06-14,9822
2356,英業達,144,53,91,元大-土城學府,2023-06-14,9822
00919,群益台灣精選高息,66,0,66,元大-土城學府,2023-06-14,9822
6456,GIS-KY,51,0,51,元大-土城學府,2023-06-14,9822
1609,大亞,45,5,40,元大-土城學府,2023-06-14,9822
00878,國泰永續高股息,46,16,30,元大-土城學府,2023-06-14,9822
00687B,國泰20年美債,28,0,28,元大-土城學府,2023-06-14,9822
2388,威盛,29,3,26,元大-土城學府,2023-06-14,9822
2308,台達電,28,5,23,元大-土城學府,2023-06-14,9822
2409,友達,26,5,21,元大-土城學府,2023-06-14,9822
2442,新美齊,20,0,20,元大-土城學府,2023-06-14,9822
00882,中信中國高股息,19,0,19,元大-土城學府,2023-06-14,9822
1522,堤維西,56,37,19,元大-土城學府,2023-06-14,9822
4739,康普,19,0,19,元大-土城學府,2023-06-14,9822
3711,日月光投控,16,0,16,元大-土城學府,2023-06-14,9822
2892,第一金,16,0,16,元大-土城學府,2023-06-14,9822
3033,威健,23,7,16,元大-土城學府,2023-06-14,9822
1234,黑松,15,0,15,元大-土城學府,2023-06-14,9822
6015,宏遠證,15,0,15,元大-土城學府,2023-06-14,9822
4533,協易機,26,11,15,元大-土城學府,2023-06-14,9822
00902,中信電池及儲能,14,0,14,元大-土城學府,2023-06-14,9822
3706,神達,21,7,14,元大-土城學府,2023-06-14,9822
2405,輔信,13,0,13,元大-土城學府,2023-06-14,9822
3346,麗清,13,0,13,元大-土城學府,2023-06-14,9822
8926,台汽電,14,1,13,元大-土城學府,2023-06-14,9822
2743,山富,24,12,12,元大-土城學府,2023-06-14,9822
1711,永光,14,2,12,元大-土城學府,2023-06-14,9822
2324,仁寶,13,1,12,元大-土城學府,2023-06-14,9822
2515,中工,15,3,12,元大-土城學府,2023-06-14,9822
4543,萬在,12,0,12,元大-土城學府,2023-06-14,9822
2376,技嘉,15,4,11,元大-土城學府,2023-06-14,9822
6596,寬宏藝術,11,0,11,元大-土城學府,2023-06-14,9822
1104,環泥,11,0,11,元大-土城學府,2023-06-14,9822
6282,康舒,10,0,10,元大-土城學府,2023-06-14,9822
1528,恩德,10,0,10,元大-土城學府,2023-06-14,9822
2102,泰豐,10,0,10,元大-土城學府,2023-06-14,9822
2443,昶虹,10,0,10,元大-土城學府,2023-06-14,9822
3059,華晶科,10,0,10,元大-土城學府,2023-06-14,9822
5521,工信,10,0,10,元大-土城學府,2023-06-14,9822
6657,華安,10,0,10,元大-土城學府,2023-06-14,9822
0056,元大高股息,24,15,9,元大-土城學府,2023-06-14,9822
00929,復華台灣科技優息,9,0,9,元大-土城學府,2023-06-14,9822
00720B,元大投資級公司債,9,0,9,元大-土城學府,2023-06-14,9822
3617,碩天,13,4,9,元大-土城學府,2023-06-14,9822
6005,群益證,10,1,9,元大-土城學府,2023-06-14,9822
6235,華孚,19,10,9,元大-土城學府,2023-06-14,9822
6485,點序,10,1,9,元大-土城學府,2023-06-14,9822
2305,全友,8,0,8,元大-土城學府,2023-06-14,9822
6122,擎邦,51,43,8,元大-土城學府,2023-06-14,9822
6138,茂達,9,1,8,元大-土城學府,2023-06-14,9822
00712,復華富時不動產,133,0,133,元大-土城學府,2023-06-15,9822
2618,長榮航,363,256,107,元大-土城學府,2023-06-15,9822
2888,新光金,112,46,66,元大-土城學府,2023-06-15,9822
6282,康舒,67,8,59,元大-土城學府,2023-06-15,9822
00919,群益台灣精選高息,59,2,57,元大-土城學府,2023-06-15,9822
00679B,元大美債20年,37,1,36,元大-土城學府,2023-06-15,9822
6026,福邦證,35,0,35,元大-土城學府,2023-06-15,9822
00637L,元大滬深300正2,40,6,34,元大-土城學府,2023-06-15,9822
6753,龍德造船,34,3,31,元大-土城學府,2023-06-15,9822
4543,萬在,29,0,29,元大-土城學府,2023-06-15,9822
1319,東陽,27,2,25,元大-土城學府,2023-06-15,9822
5457,宣德,25,0,25,元大-土城學府,2023-06-15,9822
5521,工信,20,0,20,元大-土城學府,2023-06-15,9822
6173,信昌電,20,0,20,元大-土城學府,2023-06-15,9822
3682,亞太電,18,0,18,元大-土城學府,2023-06-15,9822
3205,佰研,16,0,16,元大-土城學府,2023-06-15,9822
2344,華邦電,15,0,15,元大-土城學府,2023-06-15,9822
00882,中信中國高股息,15,1,14,元大-土城學府,2023-06-15,9822
2454,聯發科,14,0,14,元大-土城學府,2023-06-15,9822
00715L,期街口布蘭特正2,16,3,13,元大-土城學府,2023-06-15,9822
3413,京鼎,13,0,13,元大-土城學府,2023-06-15,9822
4967,十銓,27,14,13,元大-土城學府,2023-06-15,9822
1529,樂事綠能,21,9,12,元大-土城學府,2023-06-15,9822
2421,建準,26,14,12,元大-土城學府,2023-06-15,9822
2027,大成鋼,16,4,12,元大-土城學府,2023-06-15,9822
2382,廣達,34,23,11,元大-土城學府,2023-06-15,9822
3545,敦泰,11,0,11,元大-土城學府,2023-06-15,9822
6443,元晶,11,0,11,元大-土城學府,2023-06-15,9822
1528,恩德,12,1,11,元大-土城學府,2023-06-15,9822
2401,凌陽,38,27,11,元大-土城學府,2023-06-15,9822
3163,波若威,20,9,11,元大-土城學府,2023-06-15,9822
6016,康和證,13,2,11,元大-土城學府,2023-06-15,9822
8028,昇陽半導體,11,1,10,元大-土城學府,2023-06-15,9822
3032,偉訓,40,30,10,元大-土城學府,2023-06-15,9822
3013,晟銘電,63,53,10,元大-土城學府,2023-06-15,9822
4157,太景*-KY,10,0,10,元大-土城學府,2023-06-15,9822
2892,第一金,10,0,10,元大-土城學府,2023-06-15,9822
3022,威強電,14,4,10,元大-土城學府,2023-06-15,9822
3231,緯創,150,140,10,元大-土城學府,2023-06-15,9822
1905,華紙,11,2,9,元大-土城學府,2023-06-15,9822
3356,奇偶,16,7,9,元大-土城學府,2023-06-15,9822
6182,合晶,9,0,9,元大-土城學府,2023-06-15,9822
00891,中信關鍵半導體,8,0,8,元大-土城學府,2023-06-15,9822
00878,國泰永續高股息,37,29,8,元大-土城學府,2023-06-15,9822
2374,佳能,8,0,8,元大-土城學府,2023-06-15,9822
3024,憶聲,8,0,8,元大-土城學府,2023-06-15,9822
3162,精確,9,1,8,元大-土城學府,2023-06-15,9822
8150,南茂,9,1,8,元大-土城學府,2023-06-15,9822
8076,伍豐,19,11,8,元大-土城學府,2023-06-15,9822
00708L,期元大S＆P黃金正2,7,0,7,元大-土城學府,2023-06-15,9822
2610,華航,606,283,323,元大-土城學府,2023-06-16,9822
00632R,元大台灣50反1,125,0,125,元大-土城學府,2023-06-16,9822
2618,長榮航,235,155,80,元大-土城學府,2023-06-16,9822
3078,僑威,96,26,70,元大-土城學府,2023-06-16,9822
00720B,元大投資級公司債,73,5,68,元大-土城學府,2023-06-16,9822
3481,群創,53,6,47,元大-土城學府,2023-06-16,9822
1802,台玻,59,24,35,元大-土城學府,2023-06-16,9822
3682,亞太電,36,2,34,元大-土城學府,2023-06-16,9822
2888,新光金,31,0,31,元大-土城學府,2023-06-16,9822
5258,虹堡,52,23,29,元大-土城學府,2023-06-16,9822
4543,萬在,29,0,29,元大-土城學府,2023-06-16,9822
2301,光寶科,31,4,27,元大-土城學府,2023-06-16,9822
6282,康舒,33,8,25,元大-土城學府,2023-06-16,9822
00919,群益台灣精選高息,38,13,25,元大-土城學府,2023-06-16,9822
00673R,期元大S＆P原油反1,25,0,25,元大-土城學府,2023-06-16,9822
2353,宏��,28,6,22,元大-土城學府,2023-06-16,9822
8358,金居,23,1,22,元大-土城學府,2023-06-16,9822
00706L,期元大S＆P日圓正2,21,0,21,元大-土城學府,2023-06-16,9822
6016,康和證,20,0,20,元大-土城學府,2023-06-16,9822
6190,萬泰科,21,3,18,元大-土城學府,2023-06-16,9822
3013,晟銘電,35,18,17,元大-土城學府,2023-06-16,9822
2382,廣達,30,13,17,元大-土城學府,2023-06-16,9822
00851,台新全球AI,16,0,16,元大-土城學府,2023-06-16,9822
1504,東元,42,27,15,元大-土城學府,2023-06-16,9822
00713,元大台灣高息低波,15,1,14,元大-土城學府,2023-06-16,9822
2615,萬海,13,0,13,元大-土城學府,2023-06-16,9822
2401,凌陽,17,4,13,元大-土城學府,2023-06-16,9822
6770,力積電,13,1,12,元大-土城學府,2023-06-16,9822
3036,文曄,12,0,12,元大-土城學府,2023-06-16,9822
4534,慶騰,12,0,12,元大-土城學府,2023-06-16,9822
8926,台汽電,13,1,12,元大-土城學府,2023-06-16,9822
2371,大同,59,47,12,元大-土城學府,2023-06-16,9822
2883,凱基金,12,1,11,元大-土城學府,2023-06-16,9822
3576,聯合再生,12,2,10,元大-土城學府,2023-06-16,9822
3052,夆典,10,0,10,元大-土城學府,2023-06-16,9822
3209,全科,10,0,10,元大-土城學府,2023-06-16,9822
6173,信昌電,10,0,10,元大-土城學府,2023-06-16,9822
2492,華新科,10,1,9,元大-土城學府,2023-06-16,9822
1608,華榮,18,9,9,元大-土城學府,2023-06-16,9822
6266,泰詠,9,0,9,元大-土城學府,2023-06-16,9822
8050,廣積,11,2,9,元大-土城學府,2023-06-16,9822
8028,昇陽半導體,9,1,8,元大-土城學府,2023-06-16,9822
6139,亞翔,8,0,8,元大-土城學府,2023-06-16,9822
00929,復華台灣科技優息,9,1,8,元大-土城學府,2023-06-16,9822
6719,力智,8,0,8,元大-土城學府,2023-06-16,9822
6799,來頡,8,0,8,元大-土城學府,2023-06-16,9822
6147,頎邦,7,0,7,元大-土城學府,2023-06-16,9822
00902,中信電池及儲能,10,3,7,元大-土城學府,2023-06-16,9822
00853B,統一美債10年Aa-,7,0,7,元大-土城學府,2023-06-16,9822
00679B,元大美債20年,7,0,7,元大-土城學府,2023-06-16,9822
2353,宏��,244,21,223,元大-土城學府,2023-06-19,9822
2312,金寶,122,15,107,元大-土城學府,2023-06-19,9822
2324,仁寶,103,9,94,元大-土城學府,2023-06-19,9822
00929,復華台灣科技優息,62,2,60,元大-土城學府,2023-06-19,9822
1718,中纖,50,0,50,元大-土城學府,2023-06-19,9822
00882,中信中國高股息,45,0,45,元大-土城學府,2023-06-19,9822
2618,長榮航,139,101,38,元大-土城學府,2023-06-19,9822
2388,威盛,38,0,38,元大-土城學府,2023-06-19,9822
1218,泰山,39,1,38,元大-土城學府,2023-06-19,9822
3231,緯創,109,73,36,元大-土城學府,2023-06-19,9822
5258,虹堡,51,21,30,元大-土城學府,2023-06-19,9822
00893,國泰智能電動車,31,3,28,元大-土城學府,2023-06-19,9822
2356,英業達,65,39,26,元大-土城學府,2023-06-19,9822
4543,萬在,24,0,24,元大-土城學府,2023-06-19,9822
6282,康舒,25,2,23,元大-土城學府,2023-06-19,9822
1513,中興電,51,29,22,元大-土城學府,2023-06-19,9822
2421,建準,25,4,21,元大-土城學府,2023-06-19,9822
00632R,元大台灣50反1,20,0,20,元大-土城學府,2023-06-19,9822
2208,台船,20,0,20,元大-土城學府,2023-06-19,9822
0056,元大高股息,32,13,19,元大-土城學府,2023-06-19,9822
6139,亞翔,17,0,17,元大-土城學府,2023-06-19,9822
6790,永豐實,17,0,17,元大-土城學府,2023-06-19,9822
3363,上詮,18,2,16,元大-土城學府,2023-06-19,9822
2609,陽明,19,3,16,元大-土城學府,2023-06-19,9822
2401,凌陽,17,2,15,元大-土城學府,2023-06-19,9822
3078,僑威,42,28,14,元大-土城學府,2023-06-19,9822
6148,驊宏資,38,24,14,元大-土城學府,2023-06-19,9822
00673R,期元大S＆P原油反1,13,0,13,元大-土城學府,2023-06-19,9822
6274,台燿,11,0,11,元大-土城學府,2023-06-19,9822
1609,大亞,28,17,11,元大-土城學府,2023-06-19,9822
2882,國泰金,11,0,11,元大-土城學府,2023-06-19,9822
1101,台泥,11,0,11,元大-土城學府,2023-06-19,9822
2102,泰豐,10,0,10,元大-土城學府,2023-06-19,9822
2406,國碩,10,0,10,元大-土城學府,2023-06-19,9822
5381,合正,10,0,10,元大-土城學府,2023-06-19,9822
6265,方土昶,10,1,9,元大-土城學府,2023-06-19,9822
8069,元太,10,1,9,元大-土城學府,2023-06-19,9822
2303,聯電,20,11,9,元大-土城學府,2023-06-19,9822
1611,中電,8,0,8,元大-土城學府,2023-06-19,9822
2009,第一銅,8,0,8,元大-土城學府,2023-06-19,9822
2701,萬企,8,0,8,元大-土城學府,2023-06-19,9822
6190,萬泰科,9,1,8,元大-土城學府,2023-06-19,9822
6269,台郡,8,0,8,元大-土城學府,2023-06-19,9822
3032,偉訓,11,4,7,元大-土城學府,2023-06-19,9822
3265,台星科,10,3,7,元大-土城學府,2023-06-19,9822
6770,力積電,7,0,7,元大-土城學府,2023-06-19,9822
2885,元大金,6,0,6,元大-土城學府,2023-06-19,9822
2834,臺企銀,6,0,6,元大-土城學府,2023-06-19,9822
6147,頎邦,11,5,6,元大-土城學府,2023-06-19,9822
1524,耿鼎,6,0,6,元大-土城學府,2023-06-19,9822
3481,群創,297,18,279,元大-土城學府,2023-06-20,9822
2634,漢翔,284,186,98,元大-土城學府,2023-06-20,9822
1513,中興電,101,33,68,元大-土城學府,2023-06-20,9822
2618,長榮航,97,43,54,元大-土城學府,2023-06-20,9822
2701,萬企,48,0,48,元大-土城學府,2023-06-20,9822
3363,上詮,32,0,32,元大-土城學府,2023-06-20,9822
2323,中環,48,18,30,元大-土城學府,2023-06-20,9822
2374,佳能,29,0,29,元大-土城學府,2023-06-20,9822
4549,桓達,27,1,26,元大-土城學府,2023-06-20,9822
2331,精英,38,13,25,元大-土城學府,2023-06-20,9822
3078,僑威,45,23,22,元大-土城學府,2023-06-20,9822
2454,聯發科,23,1,22,元大-土城學府,2023-06-20,9822
3056,富華新,26,5,21,元大-土城學府,2023-06-20,9822
3049,精金,22,2,20,元大-土城學府,2023-06-20,9822
3704,合勤控,21,1,20,元大-土城學府,2023-06-20,9822
6116,彩晶,21,1,20,元大-土城學府,2023-06-20,9822
00882,中信中國高股息,19,0,19,元大-土城學府,2023-06-20,9822
2504,國產,17,0,17,元大-土城學府,2023-06-20,9822
2888,新光金,22,5,17,元大-土城學府,2023-06-20,9822
3499,環天科,21,4,17,元大-土城學府,2023-06-20,9822
00632R,元大台灣50反1,15,0,15,元大-土城學府,2023-06-20,9822
1103,嘉泥,15,2,13,元大-土城學府,2023-06-20,9822
2328,廣宇,14,1,13,元大-土城學府,2023-06-20,9822
2637,慧洋-KY,13,0,13,元大-土城學府,2023-06-20,9822
3232,昱捷,13,0,13,元大-土城學府,2023-06-20,9822
2482,連宇,19,6,13,元大-土城學府,2023-06-20,9822
2609,陽明,20,7,13,元大-土城學府,2023-06-20,9822
2442,新美齊,12,0,12,元大-土城學府,2023-06-20,9822
5512,力麒,16,5,11,元大-土城學府,2023-06-20,9822
5425,台半,10,0,10,元大-土城學府,2023-06-20,9822
1474,弘裕,10,0,10,元大-土城學府,2023-06-20,9822
2401,凌陽,13,3,10,元大-土城學府,2023-06-20,9822
3128,昇銳,10,0,10,元大-土城學府,2023-06-20,9822
6485,點序,11,1,10,元大-土城學府,2023-06-20,9822
00891,中信關鍵半導體,10,0,10,元大-土城學府,2023-06-20,9822
2481,強茂,10,1,9,元大-土城學府,2023-06-20,9822
8033,雷虎,10,1,9,元大-土城學府,2023-06-20,9822
2885,元大金,12,3,9,元大-土城學府,2023-06-20,9822
5009,榮剛,10,2,8,元大-土城學府,2023-06-20,9822
2545,皇翔,8,0,8,元大-土城學府,2023-06-20,9822
3027,盛達,9,1,8,元大-土城學府,2023-06-20,9822
3706,神達,11,3,8,元大-土城學府,2023-06-20,9822
4979,華星光,28,20,8,元大-土城學府,2023-06-20,9822
6443,元晶,12,4,8,元大-土城學府,2023-06-20,9822
6180,橘子,8,0,8,元大-土城學府,2023-06-20,9822
2317,鴻海,13,5,8,元大-土城學府,2023-06-20,9822
2409,友達,24,17,7,元大-土城學府,2023-06-20,9822
2356,英業達,61,54,7,元大-土城學府,2023-06-20,9822
00923,群益台ESG低碳50,11,4,7,元大-土城學府,2023-06-20,9822
00892,富邦台灣半導體,7,0,7,元大-土城學府,2023-06-20,9822
6288,聯嘉,100,0,100,元大-土城學府,2023-06-21,9822
6790,永豐實,72,0,72,元大-土城學府,2023-06-21,9822
0056,元大高股息,83,14,69,元大-土城學府,2023-06-21,9822
2303,聯電,64,15,49,元大-土城學府,2023-06-21,9822
2609,陽明,56,10,46,元大-土城學府,2023-06-21,9822
2371,大同,79,36,43,元大-土城學府,2023-06-21,9822
2731,雄獅,40,0,40,元大-土城學府,2023-06-21,9822
2618,長榮航,148,108,40,元大-土城學府,2023-06-21,9822
2705,六福,128,91,37,元大-土城學府,2023-06-21,9822
4543,萬在,50,23,27,元大-土城學府,2023-06-21,9822
1609,大亞,28,2,26,元大-土城學府,2023-06-21,9822
1460,宏遠,25,0,25,元大-土城學府,2023-06-21,9822
6120,達運,26,1,25,元大-土城學府,2023-06-21,9822
6147,頎邦,22,0,22,元大-土城學府,2023-06-21,9822
8112,至上,21,0,21,元大-土城學府,2023-06-21,9822
2014,中鴻,21,1,20,元大-土城學府,2023-06-21,9822
2641,正德,20,0,20,元大-土城學府,2023-06-21,9822
5512,力麒,30,10,20,元大-土城學府,2023-06-21,9822
6233,旺玖,20,0,20,元大-土城學府,2023-06-21,9822
6550,北極星藥業-KY,20,0,20,元大-土城學府,2023-06-21,9822
2356,英業達,86,67,19,元大-土城學府,2023-06-21,9822
6274,台燿,17,0,17,元大-土城學府,2023-06-21,9822
00882,中信中國高股息,16,0,16,元大-土城學府,2023-06-21,9822
1727,中華化,33,17,16,元大-土城學府,2023-06-21,9822
2883,凱基金,24,8,16,元大-土城學府,2023-06-21,9822
2605,新興,15,0,15,元大-土城學府,2023-06-21,9822
6125,廣運,19,4,15,元大-土城學府,2023-06-21,9822
2352,佳世達,26,11,15,元大-土城學府,2023-06-21,9822
2634,漢翔,77,62,15,元大-土城學府,2023-06-21,9822
6672,騰輝電子-KY,15,1,14,元大-土城學府,2023-06-21,9822
00637L,元大滬深300正2,28,14,14,元大-土城學府,2023-06-21,9822
2002,中鋼,13,0,13,元大-土城學府,2023-06-21,9822
4123,晟德,13,0,13,元大-土城學府,2023-06-21,9822
00919,群益台灣精選高息,15,2,13,元大-土城學府,2023-06-21,9822
00673R,期元大S＆P原油反1,32,20,12,元大-土城學府,2023-06-21,9822
1313,聯成,11,0,11,元大-土城學府,2023-06-21,9822
2504,國產,11,0,11,元大-土城學府,2023-06-21,9822
2722,夏都,12,1,11,元大-土城學府,2023-06-21,9822
2748,雲品,32,22,10,元大-土城學府,2023-06-21,9822
00924,復華S＆P500成長,10,0,10,元大-土城學府,2023-06-21,9822
2038,海光,10,0,10,元大-土城學府,2023-06-21,9822
2102,泰豐,10,0,10,元大-土城學府,2023-06-21,9822
3479,安勤,10,0,10,元大-土城學府,2023-06-21,9822
6265,方土昶,10,0,10,元大-土城學府,2023-06-21,9822
9919,康那香,10,0,10,元大-土城學府,2023-06-21,9822
2603,長榮,11,2,9,元大-土城學府,2023-06-21,9822
1802,台玻,13,4,9,元大-土城學府,2023-06-21,9822
00632R,元大台灣50反1,9,0,9,元大-土城學府,2023-06-21,9822
4916,事欣科,70,61,9,元大-土城學府,2023-06-21,9822
6589,台康生技,10,1,9,元大-土城學府,2023-06-21,9822
2312,金寶,171,3,168,元大-土城學府,2023-06-26,9822
3481,群創,155,0,155,元大-土城學府,2023-06-26,9822
1907,永豐餘,118,38,80,元大-土城學府,2023-06-26,9822
1616,億泰,69,0,69,元大-土城學府,2023-06-26,9822
2014,中鴻,82,14,68,元大-土城學府,2023-06-26,9822
00715L,期街口布蘭特正2,50,0,50,元大-土城學府,2023-06-26,9822
6125,廣運,111,67,44,元大-土城學府,2023-06-26,9822
5465,富驊,40,0,40,元大-土城學府,2023-06-26,9822
3032,偉訓,37,2,35,元大-土城學府,2023-06-26,9822
4543,萬在,39,6,33,元大-土城學府,2023-06-26,9822
1319,東陽,32,1,31,元大-土城學府,2023-06-26,9822
2611,志信,30,0,30,元大-土城學府,2023-06-26,9822
00893,國泰智能電動車,31,5,26,元大-土城學府,2023-06-26,9822
3704,合勤控,25,0,25,元大-土城學府,2023-06-26,9822
00878,國泰永續高股息,33,8,25,元大-土城學府,2023-06-26,9822
3380,明泰,25,1,24,元大-土城學府,2023-06-26,9822
2634,漢翔,71,48,23,元大-土城學府,2023-06-26,9822
2495,普安,27,4,23,元大-土城學府,2023-06-26,9822
3038,全台,26,4,22,元大-土城學府,2023-06-26,9822
8926,台汽電,44,23,21,元大-土城學府,2023-06-26,9822
1528,恩德,41,21,20,元大-土城學府,2023-06-26,9822
6116,彩晶,35,15,20,元大-土城學府,2023-06-26,9822
00919,群益台灣精選高息,20,0,20,元大-土城學府,2023-06-26,9822
3518,柏騰,21,2,19,元大-土城學府,2023-06-26,9822
1514,亞力,21,2,19,元大-土城學府,2023-06-26,9822
3037,欣興,30,11,19,元大-土城學府,2023-06-26,9822
2706,第一店,18,2,16,元大-土城學府,2023-06-26,9822
1605,華新,20,5,15,元大-土城學府,2023-06-26,9822
3073,天方能源,15,0,15,元大-土城學府,2023-06-26,9822
2498,宏達電,20,6,14,元大-土城學府,2023-06-26,9822
00637L,元大滬深300正2,20,6,14,元大-土城學府,2023-06-26,9822
2303,聯電,43,31,12,元大-土城學府,2023-06-26,9822
3078,僑威,29,17,12,元大-土城學府,2023-06-26,9822
2748,雲品,13,1,12,元大-土城學府,2023-06-26,9822
3686,達能,12,0,12,元大-土城學府,2023-06-26,9822
6282,康舒,20,10,10,元大-土城學府,2023-06-26,9822
6139,亞翔,10,0,10,元大-土城學府,2023-06-26,9822
00902,中信電池及儲能,10,0,10,元大-土城學府,2023-06-26,9822
00904,新光臺灣半導體30,10,0,10,元大-土城學府,2023-06-26,9822
2427,三商電,69,59,10,元大-土城學府,2023-06-26,9822
5521,工信,30,20,10,元大-土城學府,2023-06-26,9822
2439,美律,9,0,9,元大-土城學府,2023-06-26,9822
2382,廣達,13,4,9,元大-土城學府,2023-06-26,9822
3017,奇鋐,12,3,9,元大-土城學府,2023-06-26,9822
2405,輔信,11,2,9,元大-土城學府,2023-06-26,9822
8234,新漢,9,0,9,元大-土城學府,2023-06-26,9822
8358,金居,12,3,9,元大-土城學府,2023-06-26,9822
1533,車王電,18,10,8,元大-土城學府,2023-06-26,9822
2401,凌陽,10,2,8,元大-土城學府,2023-06-26,9822
6274,台燿,10,2,8,元大-土城學府,2023-06-26,9822
2618,長榮航,307,54,253,元大-土城學府,2023-06-27,9822
1471,首利,120,12,108,元大-土城學府,2023-06-27,9822
3704,合勤控,79,0,79,元大-土城學府,2023-06-27,9822
3038,全台,86,21,65,元大-土城學府,2023-06-27,9822
3231,緯創,130,74,56,元大-土城學府,2023-06-27,9822
2515,中工,46,0,46,元大-土城學府,2023-06-27,9822
1513,中興電,73,32,41,元大-土城學府,2023-06-27,9822
2303,聯電,43,3,40,元大-土城學府,2023-06-27,9822
3481,群創,46,13,33,元大-土城學府,2023-06-27,9822
1905,華紙,30,2,28,元大-土城學府,2023-06-27,9822
2409,友達,27,1,26,元大-土城學府,2023-06-27,9822
1907,永豐餘,35,11,24,元大-土城學府,2023-06-27,9822
1527,鑽全,22,0,22,元大-土城學府,2023-06-27,9822
8088,品安,21,0,21,元大-土城學府,2023-06-27,9822
2880,華南金,20,0,20,元大-土城學府,2023-06-27,9822
2014,中鴻,30,10,20,元大-土城學府,2023-06-27,9822
2308,台達電,20,1,19,元大-土城學府,2023-06-27,9822
00632R,元大台灣50反1,23,4,19,元大-土城學府,2023-06-27,9822
2427,三商電,50,32,18,元大-土城學府,2023-06-27,9822
2317,鴻海,24,7,17,元大-土城學府,2023-06-27,9822
2356,英業達,64,48,16,元大-土城學府,2023-06-27,9822
2374,佳能,16,0,16,元大-土城學府,2023-06-27,9822
1301,台塑,15,0,15,元大-土城學府,2023-06-27,9822
1584,精剛,15,0,15,元大-土城學府,2023-06-27,9822
3032,偉訓,15,1,14,元大-土城學府,2023-06-27,9822
6176,瑞儀,14,0,14,元大-土城學府,2023-06-27,9822
00929,復華台灣科技優息,13,0,13,元大-土城學府,2023-06-27,9822
3058,立德,14,1,13,元大-土城學府,2023-06-27,9822
1605,華新,35,24,11,元大-土城學府,2023-06-27,9822
1802,台玻,16,5,11,元大-土城學府,2023-06-27,9822
00713,元大台灣高息低波,11,0,11,元大-土城學府,2023-06-27,9822
2610,華航,155,144,11,元大-土城學府,2023-06-27,9822
8210,勤誠,12,1,11,元大-土城學府,2023-06-27,9822
3652,精聯,11,0,11,元大-土城學府,2023-06-27,9822
6116,彩晶,14,3,11,元大-土城學府,2023-06-27,9822
2481,強茂,23,12,11,元大-土城學府,2023-06-27,9822
1460,宏遠,10,0,10,元大-土城學府,2023-06-27,9822
1904,正隆,13,3,10,元大-土城學府,2023-06-27,9822
3306,鼎天,12,2,10,元大-土城學府,2023-06-27,9822
3356,奇偶,64,54,10,元大-土城學府,2023-06-27,9822
8201,無敵,10,0,10,元大-土城學府,2023-06-27,9822
3141,晶宏,10,1,9,元大-土城學府,2023-06-27,9822
5347,世界,9,0,9,元大-土城學府,2023-06-27,9822
1504,東元,10,2,8,元大-土城學府,2023-06-27,9822
00637L,元大滬深300正2,19,11,8,元大-土城學府,2023-06-27,9822
1737,臺鹽,8,0,8,元大-土城學府,2023-06-27,9822
2889,國票金,8,0,8,元大-土城學府,2023-06-27,9822
3078,僑威,15,7,8,元大-土城學府,2023-06-27,9822
3260,威剛,11,3,8,元大-土城學府,2023-06-27,9822
2206,三陽工業,12,4,8,元大-土城學府,2023-06-27,9822
0056,元大高股息,205,20,185,元大-土城學府,2023-06-28,9822
2888,新光金,116,10,106,元大-土城學府,2023-06-28,9822
00715L,期街口布蘭特正2,78,0,78,元大-土城學府,2023-06-28,9822
2409,友達,64,11,53,元大-土城學府,2023-06-28,9822
1605,華新,80,29,51,元大-土城學府,2023-06-28,9822
6657,華安,50,0,50,元大-土城學府,2023-06-28,9822
3027,盛達,50,2,48,元大-土城學府,2023-06-28,9822
2705,六福,66,34,32,元大-土城學府,2023-06-28,9822
3037,欣興,36,5,31,元大-土城學府,2023-06-28,9822
5388,中磊,37,14,23,元大-土城學府,2023-06-28,9822
6188,廣明,39,21,18,元大-土城學府,2023-06-28,9822
2609,陽明,23,7,16,元大-土城學府,2023-06-28,9822
6244,茂迪,14,0,14,元大-土城學府,2023-06-28,9822
1513,中興電,37,24,13,元大-土城學府,2023-06-28,9822
8234,新漢,12,0,12,元大-土城學府,2023-06-28,9822
00919,群益台灣精選高息,12,0,12,元大-土城學府,2023-06-28,9822
3481,群創,19,8,11,元大-土城學府,2023-06-28,9822
2317,鴻海,17,7,10,元大-土城學府,2023-06-28,9822
1762,中化生,14,4,10,元大-土城學府,2023-06-28,9822
1416,廣豐,9,0,9,元大-土城學府,2023-06-28,9822
1810,和成,26,17,9,元大-土城學府,2023-06-28,9822
3062,建漢,9,0,9,元大-土城學府,2023-06-28,9822
3024,憶聲,8,0,8,元大-土城學府,2023-06-28,9822
4533,協易機,13,5,8,元大-土城學府,2023-06-28,9822
2405,輔信,10,3,7,元大-土城學府,2023-06-28,9822
1528,恩德,10,3,7,元大-土城學府,2023-06-28,9822
2324,仁寶,10,3,7,元大-土城學府,2023-06-28,9822
3013,晟銘電,7,0,7,元大-土城學府,2023-06-28,9822
4155,訊映,7,0,7,元大-土城學府,2023-06-28,9822
2303,聯電,14,8,6,元大-土城學府,2023-06-28,9822
1609,大亞,10,4,6,元大-土城學府,2023-06-28,9822
4123,晟德,10,4,6,元大-土城學府,2023-06-28,9822
4175,杏一,6,0,6,元大-土城學府,2023-06-28,9822
4543,萬在,11,5,6,元大-土城學府,2023-06-28,9822
1795,美時,13,8,5,元大-土城學府,2023-06-28,9822
00642U,期元大S＆P石油,5,0,5,元大-土城學府,2023-06-28,9822
1471,首利,6,1,5,元大-土城學府,2023-06-28,9822
2349,錸德,5,0,5,元大-土城學府,2023-06-28,9822
2601,益航,5,0,5,元大-土城學府,2023-06-28,9822
2706,第一店,5,0,5,元大-土城學府,2023-06-28,9822
2820,華票,5,0,5,元大-土城學府,2023-06-28,9822
2913,農林,5,0,5,元大-土城學府,2023-06-28,9822
2915,潤泰全,5,0,5,元大-土城學府,2023-06-28,9822
3059,華晶科,5,0,5,元大-土城學府,2023-06-28,9822
4167,松瑞藥,6,1,5,元大-土城學府,2023-06-28,9822
4906,正文,18,13,5,元大-土城學府,2023-06-28,9822
5009,榮剛,8,3,5,元大-土城學府,2023-06-28,9822
5425,台半,6,1,5,元大-土城學府,2023-06-28,9822
6163,華電網,5,0,5,元大-土城學府,2023-06-28,9822
2337,旺宏,6,2,4,元大-土城學府,2023-06-28,9822
2329,華泰,115,0,115,元大-土城學府,2023-06-29,9822
2618,長榮航,167,64,103,元大-土城學府,2023-06-29,9822
2344,華邦電,115,21,94,元大-土城學府,2023-06-29,9822
2303,聯電,70,3,67,元大-土城學府,2023-06-29,9822
2353,宏��,53,0,53,元大-土城學府,2023-06-29,9822
8942,森鉅,42,0,42,元大-土城學府,2023-06-29,9822
1605,華新,32,2,30,元大-土城學府,2023-06-29,9822
1528,恩德,47,17,30,元大-土城學府,2023-06-29,9822
3037,欣興,37,9,28,元大-土城學府,2023-06-29,9822
2323,中環,59,33,26,元大-土城學府,2023-06-29,9822
4142,國光生,25,0,25,元大-土城學府,2023-06-29,9822
2609,陽明,33,9,24,元大-土城學府,2023-06-29,9822
0056,元大高股息,34,10,24,元大-土城學府,2023-06-29,9822
5607,遠雄港,23,0,23,元大-土城學府,2023-06-29,9822
3105,穩懋,22,0,22,元大-土城學府,2023-06-29,9822
2915,潤泰全,22,0,22,元大-土城學府,2023-06-29,9822
5347,世界,20,0,20,元大-土城學府,2023-06-29,9822
2603,長榮,25,6,19,元大-土城學府,2023-06-29,9822
2885,元大金,17,0,17,元大-土城學府,2023-06-29,9822
4979,華星光,43,26,17,元大-土城學府,2023-06-29,9822
00919,群益台灣精選高息,17,1,16,元大-土城學府,2023-06-29,9822
4543,萬在,20,4,16,元大-土城學府,2023-06-29,9822
2356,英業達,21,5,16,元大-土城學府,2023-06-29,9822
2201,裕隆,16,1,15,元大-土城學府,2023-06-29,9822
6118,建達,15,0,15,元大-土城學府,2023-06-29,9822
00878,國泰永續高股息,18,4,14,元大-土城學府,2023-06-29,9822
4967,十銓,20,6,14,元大-土城學府,2023-06-29,9822
8277,商丞,14,0,14,元大-土城學府,2023-06-29,9822
3078,僑威,22,9,13,元大-土城學府,2023-06-29,9822
3005,神基,13,1,12,元大-土城學府,2023-06-29,9822
1321,大洋,12,0,12,元大-土城學府,2023-06-29,9822
4526,東台,12,0,12,元大-土城學府,2023-06-29,9822
2412,中華電,13,2,11,元大-土城學府,2023-06-29,9822
4130,健亞,11,0,11,元大-土城學府,2023-06-29,9822
2548,華固,10,0,10,元大-土城學府,2023-06-29,9822
00737,國泰AI+Robo,10,0,10,元大-土城學府,2023-06-29,9822
2495,普安,10,0,10,元大-土城學府,2023-06-29,9822
2812,台中銀,10,0,10,元大-土城學府,2023-06-29,9822
2883B,凱基金乙特,10,0,10,元大-土城學府,2023-06-29,9822
4533,協易機,10,0,10,元大-土城學府,2023-06-29,9822
9933,中鼎,10,0,10,元大-土城學府,2023-06-29,9822
1432,大魯閣,9,0,9,元大-土城學府,2023-06-29,9822
3260,威剛,24,16,8,元大-土城學府,2023-06-29,9822
4915,致伸,13,5,8,元大-土城學府,2023-06-29,9822
6180,橘子,8,0,8,元大-土城學府,2023-06-29,9822
4746,台耀,32,26,6,元大-土城學府,2023-06-29,9822
9945,潤泰新,6,0,6,元大-土城學府,2023-06-29,9822
3205,佰研,15,9,6,元大-土城學府,2023-06-29,9822
8358,金居,6,0,6,元大-土城學府,2023-06-29,9822
2882,國泰金,5,0,5,元大-土城學府,2023-06-29,9822
5607,遠雄港,165,0,165,元大-土城學府,2023-06-30,9822
8105,凌巨,118,0,118,元大-土城學府,2023-06-30,9822
2618,長榮航,104,51,53,元大-土城學府,2023-06-30,9822
3037,欣興,61,15,46,元大-土城學府,2023-06-30,9822
2303,聯電,46,4,42,元大-土城學府,2023-06-30,9822
1444,力麗,41,0,41,元大-土城學府,2023-06-30,9822
2353,宏��,38,3,35,元大-土城學府,2023-06-30,9822
2344,華邦電,32,4,28,元大-土城學府,2023-06-30,9822
1504,東元,27,1,26,元大-土城學府,2023-06-30,9822
1718,中纖,25,0,25,元大-土城學府,2023-06-30,9822
2482,連宇,24,0,24,元大-土城學府,2023-06-30,9822
5521,工信,20,0,20,元大-土城學府,2023-06-30,9822
4414,如興,20,1,19,元大-土城學府,2023-06-30,9822
00722B,群益投資級電信債,18,0,18,元大-土城學府,2023-06-30,9822
2409,友達,16,0,16,元大-土城學府,2023-06-30,9822
8358,金居,24,8,16,元大-土城學府,2023-06-30,9822
2603,長榮,47,31,16,元大-土城學府,2023-06-30,9822
3481,群創,16,2,14,元大-土城學府,2023-06-30,9822
4130,健亞,13,0,13,元大-土城學府,2023-06-30,9822
2371,大同,71,59,12,元大-土城學府,2023-06-30,9822
2382,廣達,18,6,12,元大-土城學府,2023-06-30,9822
00764B,群益25年美債,11,0,11,元大-土城學府,2023-06-30,9822
4533,協易機,14,3,11,元大-土城學府,2023-06-30,9822
6550,北極星藥業-KY,11,0,11,元大-土城學府,2023-06-30,9822
1609,大亞,35,25,10,元大-土城學府,2023-06-30,9822
1201,味全,10,0,10,元大-土城學府,2023-06-30,9822
1402,遠東新,10,0,10,元大-土城學府,2023-06-30,9822
3682,亞太電,10,0,10,元大-土城學府,2023-06-30,9822
2323,中環,20,11,9,元大-土城學府,2023-06-30,9822
3045,台灣大,9,0,9,元大-土城學府,2023-06-30,9822
3706,神達,11,2,9,元大-土城學府,2023-06-30,9822
2610,華航,36,27,9,元大-土城學府,2023-06-30,9822
3624,光頡,8,0,8,元大-土城學府,2023-06-30,9822
5258,虹堡,8,0,8,元大-土城學府,2023-06-30,9822
6285,啟��,8,0,8,元大-土城學府,2023-06-30,9822
8092,建暐,8,0,8,元大-土城學府,2023-06-30,9822
2812,台中銀,10,3,7,元大-土城學府,2023-06-30,9822
1303,南亞,7,0,7,元大-土城學府,2023-06-30,9822
00706L,期元大S＆P日圓正2,7,0,7,元大-土城學府,2023-06-30,9822
2736,富野,7,0,7,元大-土城學府,2023-06-30,9822
0050,元大台灣50,8,1,7,元大-土城學府,2023-06-30,9822
00882,中信中國高股息,6,0,6,元大-土城學府,2023-06-30,9822
00673R,期元大S＆P原油反1,6,0,6,元大-土城學府,2023-06-30,9822
1605,華新,16,10,6,元大-土城學府,2023-06-30,9822
3703,欣陸,6,0,6,元大-土城學府,2023-06-30,9822
3710,連展投控,6,0,6,元大-土城學府,2023-06-30,9822
1795,美時,12,6,6,元大-土城學府,2023-06-30,9822
00720B,元大投資級公司債,5,0,5,元大-土城學府,2023-06-30,9822
3189,景碩,5,0,5,元大-土城學府,2023-06-30,9822
3205,佰研,5,0,5,元大-土城學府,2023-06-30,9822
2615,萬海,61,3,58,元大-土城學府,2023-07-03,9822
00720B,元大投資級公司債,35,2,33,元大-土城學府,2023-07-03,9822
00751B,元大AAA至A公司債,32,0,32,元大-土城學府,2023-07-03,9822
3027,盛達,31,2,29,元大-土城學府,2023-07-03,9822
6125,廣運,29,0,29,元大-土城學府,2023-07-03,9822
1313,聯成,28,0,28,元大-土城學府,2023-07-03,9822
1718,中纖,25,0,25,元大-土城學府,2023-07-03,9822
3231,緯創,134,109,25,元大-土城學府,2023-07-03,9822
2603,長榮,43,18,25,元大-土城學府,2023-07-03,9822
1336,台翰,24,0,24,元大-土城學府,2023-07-03,9822
1609,大亞,35,13,22,元大-土城學府,2023-07-03,9822
2201,裕隆,24,2,22,元大-土城學府,2023-07-03,9822
2323,中環,34,12,22,元大-土城學府,2023-07-03,9822
1528,恩德,49,29,20,元大-土城學府,2023-07-03,9822
4157,太景*-KY,19,1,18,元大-土城學府,2023-07-03,9822
6191,精成科,20,2,18,元大-土城學府,2023-07-03,9822
2206,三陽工業,19,2,17,元大-土城學府,2023-07-03,9822
1504,東元,22,5,17,元大-土城學府,2023-07-03,9822
2485,兆赫,17,0,17,元大-土城學府,2023-07-03,9822
1301,台塑,15,0,15,元大-土城學府,2023-07-03,9822
2356,英業達,61,47,14,元大-土城學府,2023-07-03,9822
3481,群創,16,2,14,元大-土城學府,2023-07-03,9822
6592,和潤企業,19,5,14,元大-土城學府,2023-07-03,9822
2634,漢翔,33,20,13,元大-土城學府,2023-07-03,9822
6180,橘子,13,0,13,元大-土城學府,2023-07-03,9822
00646,元大S＆P500,13,0,13,元大-土城學府,2023-07-03,9822
00632R,元大台灣50反1,13,0,13,元大-土城學府,2023-07-03,9822
1616,億泰,13,0,13,元大-土城學府,2023-07-03,9822
3483,力致,21,9,12,元大-土城學府,2023-07-03,9822
3711,日月光投控,12,0,12,元大-土城學府,2023-07-03,9822
6589,台康生技,12,0,12,元大-土城學府,2023-07-03,9822
2331,精英,20,8,12,元大-土城學府,2023-07-03,9822
2885,元大金,12,1,11,元大-土城學府,2023-07-03,9822
2412,中華電,11,0,11,元大-土城學府,2023-07-03,9822
4175,杏一,11,0,11,元大-土城學府,2023-07-03,9822
1514,亞力,19,9,10,元大-土城學府,2023-07-03,9822
2017,官田鋼,10,0,10,元大-土城學府,2023-07-03,9822
2903,遠百,10,0,10,元大-土城學府,2023-07-03,9822
3003,健和興,10,0,10,元大-土城學府,2023-07-03,9822
3093,港建*,10,0,10,元大-土城學府,2023-07-03,9822
6275,元山,10,0,10,元大-土城學府,2023-07-03,9822
2337,旺宏,10,1,9,元大-土城學府,2023-07-03,9822
3062,建漢,9,0,9,元大-土城學府,2023-07-03,9822
4533,協易機,9,0,9,元大-土城學府,2023-07-03,9822
3044,健鼎,11,3,8,元大-土城學府,2023-07-03,9822
00891,中信關鍵半導體,8,1,7,元大-土城學府,2023-07-03,9822
3006,晶豪科,7,0,7,元大-土城學府,2023-07-03,9822
2009,第一銅,7,0,7,元大-土城學府,2023-07-03,9822
2911,麗嬰房,7,0,7,元大-土城學府,2023-07-03,9822
4958,臻鼎-KY,7,0,7,元大-土城學府,2023-07-03,9822
2609,陽明,186,56,130,元大-土城學府,2023-07-04,9822
2317,鴻海,125,5,120,元大-土城學府,2023-07-04,9822
2611,志信,110,0,110,元大-土城學府,2023-07-04,9822
6188,廣明,82,4,78,元大-土城學府,2023-07-04,9822
1513,中興電,75,27,48,元大-土城學府,2023-07-04,9822
2603,長榮,98,51,47,元大-土城學府,2023-07-04,9822
00673R,期元大S＆P原油反1,40,0,40,元大-土城學府,2023-07-04,9822
3712,永崴投控,38,1,37,元大-土城學府,2023-07-04,9822
6125,廣運,37,2,35,元大-土城學府,2023-07-04,9822
5388,中磊,33,1,32,元大-土城學府,2023-07-04,9822
2405,輔信,36,6,30,元大-土城學府,2023-07-04,9822
2353,宏��,31,4,27,元大-土城學府,2023-07-04,9822
2399,映泰,43,16,27,元大-土城學府,2023-07-04,9822
5521,工信,27,0,27,元大-土城學府,2023-07-04,9822
2371,大同,65,40,25,元大-土城學府,2023-07-04,9822
4414,如興,23,0,23,元大-土城學府,2023-07-04,9822
0056,元大高股息,65,43,22,元大-土城學府,2023-07-04,9822
020038,元大ESG配息N,21,0,21,元大-土城學府,2023-07-04,9822
5009,榮剛,24,5,19,元大-土城學府,2023-07-04,9822
3078,僑威,31,12,19,元大-土城學府,2023-07-04,9822
3189,景碩,20,2,18,元大-土城學府,2023-07-04,9822
2303,聯電,21,4,17,元大-土城學府,2023-07-04,9822
2331,精英,18,1,17,元大-土城學府,2023-07-04,9822
1734,杏輝,17,0,17,元大-土城學府,2023-07-04,9822
3058,立德,17,0,17,元大-土城學府,2023-07-04,9822
4533,協易機,17,0,17,元大-土城學府,2023-07-04,9822
1809,中釉,16,0,16,元大-土城學府,2023-07-04,9822
2332,友訊,17,1,16,元大-土城學府,2023-07-04,9822
2349,錸德,16,0,16,元大-土城學府,2023-07-04,9822
2449,京元電子,28,12,16,元大-土城學府,2023-07-04,9822
8092,建暐,22,6,16,元大-土城學府,2023-07-04,9822
2883,凱基金,27,12,15,元大-土城學府,2023-07-04,9822
2340,台亞,14,1,13,元大-土城學府,2023-07-04,9822
3032,偉訓,22,9,13,元大-土城學府,2023-07-04,9822
3209,全科,13,0,13,元大-土城學府,2023-07-04,9822
2748,雲品,17,5,12,元大-土城學府,2023-07-04,9822
5607,遠雄港,12,0,12,元大-土城學府,2023-07-04,9822
6147,頎邦,12,0,12,元大-土城學府,2023-07-04,9822
3093,港建*,11,0,11,元大-土城學府,2023-07-04,9822
3715,定穎投控,13,2,11,元大-土城學府,2023-07-04,9822
2324,仁寶,26,15,11,元大-土城學府,2023-07-04,9822
3017,奇鋐,13,3,10,元大-土城學府,2023-07-04,9822
4142,國光生,10,0,10,元大-土城學府,2023-07-04,9822
2882,國泰金,11,1,10,元大-土城學府,2023-07-04,9822
1444,力麗,10,0,10,元大-土城學府,2023-07-04,9822
2337,旺宏,12,2,10,元大-土城學府,2023-07-04,9822
2468,華經,10,0,10,元大-土城學府,2023-07-04,9822
3483,力致,15,5,10,元大-土城學府,2023-07-04,9822
4564,元翎,10,0,10,元大-土城學府,2023-07-04,9822
8028,昇陽半導體,9,0,9,元大-土城學府,2023-07-04,9822
2609,陽明,215,99,116,元大-土城學府,2023-07-05,9822
2303,聯電,99,0,99,元大-土城學府,2023-07-05,9822
4919,新唐,86,3,83,元大-土城學府,2023-07-05,9822
2301,光寶科,85,11,74,元大-土城學府,2023-07-05,9822
2356,英業達,104,31,73,元大-土城學府,2023-07-05,9822
3163,波若威,64,4,60,元大-土城學府,2023-07-05,9822
00929,復華台灣科技優息,40,2,38,元大-土城學府,2023-07-05,9822
4566,時碩工業,45,8,37,元大-土城學府,2023-07-05,9822
2425,承啟,36,0,36,元大-土城學府,2023-07-05,9822
3564,其陽,34,0,34,元大-土城學府,2023-07-05,9822
2401,凌陽,31,1,30,元大-土城學府,2023-07-05,9822
00673R,期元大S＆P原油反1,27,0,27,元大-土城學府,2023-07-05,9822
1608,華榮,26,0,26,元大-土城學府,2023-07-05,9822
3356,奇偶,46,20,26,元大-土城學府,2023-07-05,9822
6125,廣運,34,8,26,元大-土城學府,2023-07-05,9822
4414,如興,22,0,22,元大-土城學府,2023-07-05,9822
2408,南亞科,20,0,20,元大-土城學府,2023-07-05,9822
1905,華紙,36,16,20,元大-土城學府,2023-07-05,9822
3372,典範,20,1,19,元大-土城學府,2023-07-05,9822
2449,京元電子,21,3,18,元大-土城學府,2023-07-05,9822
1605,華新,32,15,17,元大-土城學府,2023-07-05,9822
3380,明泰,19,3,16,元大-土城學府,2023-07-05,9822
2382,廣達,34,19,15,元大-土城學府,2023-07-05,9822
2412,中華電,13,0,13,元大-土城學府,2023-07-05,9822
2201,裕隆,29,17,12,元大-土城學府,2023-07-05,9822
2929,淘帝-KY,16,4,12,元大-土城學府,2023-07-05,9822
3481,群創,13,2,11,元大-土城學府,2023-07-05,9822
00881,國泰台灣5G+,11,0,11,元大-土城學府,2023-07-05,9822
00927,群益半導體收益,11,0,11,元大-土城學府,2023-07-05,9822
2388,威盛,11,0,11,元大-土城學府,2023-07-05,9822
2399,映泰,14,3,11,元大-土城學府,2023-07-05,9822
3374,精材,20,10,10,元大-土城學府,2023-07-05,9822
1444,力麗,10,0,10,元大-土城學府,2023-07-05,9822
4510,高鋒,10,0,10,元大-土城學府,2023-07-05,9822
1101,台泥,11,2,9,元大-土城學府,2023-07-05,9822
2504,國產,9,0,9,元大-土城學府,2023-07-05,9822
2880,華南金,9,0,9,元大-土城學府,2023-07-05,9822
3363,上詮,19,10,9,元大-土城學府,2023-07-05,9822
3543,州巧,9,0,9,元大-土城學府,2023-07-05,9822
4533,協易機,12,3,9,元大-土城學府,2023-07-05,9822
5465,富驊,9,0,9,元大-土城學府,2023-07-05,9822
8038,長園科,9,0,9,元大-土城學府,2023-07-05,9822
2402,毅嘉,66,57,9,元大-土城學府,2023-07-05,9822
00882,中信中國高股息,8,0,8,元大-土城學府,2023-07-05,9822
2413,環科,8,0,8,元大-土城學府,2023-07-05,9822
2420,新巨,8,0,8,元大-土城學府,2023-07-05,9822
6203,海韻電,8,0,8,元大-土城學府,2023-07-05,9822
6770,力積電,8,0,8,元大-土城學府,2023-07-05,9822
8092,建暐,20,12,8,元大-土城學府,2023-07-05,9822
3037,欣興,17,9,8,元大-土城學府,2023-07-05,9822
4533,協易機,111,5,106,元大-土城學府,2023-07-06,9822
00929,復華台灣科技優息,82,2,80,元大-土城學府,2023-07-06,9822
2369,菱生,72,1,71,元大-土城學府,2023-07-06,9822
00673R,期元大S＆P原油反1,59,0,59,元大-土城學府,2023-07-06,9822
3037,欣興,74,17,57,元大-土城學府,2023-07-06,9822
2425,承啟,40,0,40,元大-土城學府,2023-07-06,9822
5521,工信,40,0,40,元大-土城學府,2023-07-06,9822
3013,晟銘電,85,46,39,元大-土城學府,2023-07-06,9822
2317,鴻海,38,0,38,元大-土城學府,2023-07-06,9822
1584,精剛,36,0,36,元大-土城學府,2023-07-06,9822
6188,廣明,41,5,36,元大-土城學府,2023-07-06,9822
1907,永豐餘,35,2,33,元大-土城學府,2023-07-06,9822
2409,友達,71,38,33,元大-土城學府,2023-07-06,9822
0056,元大高股息,40,7,33,元大-土城學府,2023-07-06,9822
2885,元大金,33,0,33,元大-土城學府,2023-07-06,9822
2883,凱基金,40,10,30,元大-土城學府,2023-07-06,9822
6125,廣運,30,2,28,元大-土城學府,2023-07-06,9822
1101,台泥,27,0,27,元大-土城學府,2023-07-06,9822
00772B,中信高評級公司債,26,0,26,元大-土城學府,2023-07-06,9822
6016,康和證,26,0,26,元大-土城學府,2023-07-06,9822
6282,康舒,67,41,26,元大-土城學府,2023-07-06,9822
4439,冠星-KY,25,0,25,元大-土城學府,2023-07-06,9822
2609,陽明,87,64,23,元大-土城學府,2023-07-06,9822
5388,中磊,27,4,23,元大-土城學府,2023-07-06,9822
2884,玉山金,22,0,22,元大-土城學府,2023-07-06,9822
5243,乙盛-KY,25,3,22,元大-土城學府,2023-07-06,9822
8093,保銳,22,0,22,元大-土城學府,2023-07-06,9822
3027,盛達,22,2,20,元大-土城學府,2023-07-06,9822
2812,台中銀,19,0,19,元大-土城學府,2023-07-06,9822
5426,振發,22,3,19,元大-土城學府,2023-07-06,9822
5876,上海商銀,19,0,19,元大-土城學府,2023-07-06,9822
4977,眾達-KY,18,0,18,元大-土城學府,2023-07-06,9822
00679B,元大美債20年,17,0,17,元大-土城學府,2023-07-06,9822
3687,歐買尬,22,5,17,元大-土城學府,2023-07-06,9822
2603,長榮,19,2,17,元大-土城學府,2023-07-06,9822
1471,首利,20,4,16,元大-土城學府,2023-07-06,9822
2014,中鴻,16,0,16,元大-土城學府,2023-07-06,9822
2401,凌陽,18,2,16,元大-土城學府,2023-07-06,9822
2486,一詮,15,0,15,元大-土城學府,2023-07-06,9822
3017,奇鋐,20,5,15,元大-土城學府,2023-07-06,9822
3078,僑威,19,5,14,元大-土城學府,2023-07-06,9822
5009,榮剛,14,1,13,元大-土城學府,2023-07-06,9822
4906,正文,26,13,13,元大-土城學府,2023-07-06,9822
1513,中興電,20,8,12,元大-土城學府,2023-07-06,9822
2323,中環,14,2,12,元大-土城學府,2023-07-06,9822
2634,漢翔,23,11,12,元大-土城學府,2023-07-06,9822
2891,中信金,16,4,12,元大-土城學府,2023-07-06,9822
6117,迎廣,13,1,12,元大-土城學府,2023-07-06,9822
6753,龍德造船,17,5,12,元大-土城學府,2023-07-06,9822
4967,十銓,11,0,11,元大-土城學府,2023-07-06,9822
4533,協易機,140,2,138,元大-土城學府,2023-07-07,9822
9105,泰金寶-DR,89,10,79,元大-土城學府,2023-07-07,9822
2303,聯電,77,5,72,元大-土城學府,2023-07-07,9822
2603,長榮,103,35,68,元大-土城學府,2023-07-07,9822
2409,友達,62,12,50,元大-土城學府,2023-07-07,9822
2609,陽明,72,29,43,元大-土城學府,2023-07-07,9822
00882,中信中國高股息,44,1,43,元大-土城學府,2023-07-07,9822
5521,工信,40,0,40,元大-土城學府,2023-07-07,9822
2882,國泰金,36,0,36,元大-土城學府,2023-07-07,9822
2353,宏��,44,10,34,元大-土城學府,2023-07-07,9822
2340,台亞,50,16,34,元大-土城學府,2023-07-07,9822
3231,緯創,135,104,31,元大-土城學府,2023-07-07,9822
2356,英業達,69,40,29,元大-土城學府,2023-07-07,9822
1905,華紙,29,2,27,元大-土城學府,2023-07-07,9822
00688L,國泰20年美債正2,26,0,26,元大-土城學府,2023-07-07,9822
3058,立德,28,3,25,元大-土城學府,2023-07-07,9822
00679B,元大美債20年,24,0,24,元大-土城學府,2023-07-07,9822
00673R,期元大S＆P原油反1,23,0,23,元大-土城學府,2023-07-07,9822
3060,銘異,21,0,21,元大-土城學府,2023-07-07,9822
00687B,國泰20年美債,20,0,20,元大-土城學府,2023-07-07,9822
3615,安可,20,0,20,元大-土城學府,2023-07-07,9822
6703,軒郁,20,1,19,元大-土城學府,2023-07-07,9822
4968,立積,18,0,18,元大-土城學府,2023-07-07,9822
00772B,中信高評級公司債,16,0,16,元大-土城學府,2023-07-07,9822
00929,復華台灣科技優息,16,0,16,元大-土城學府,2023-07-07,9822
2834,臺企銀,15,0,15,元大-土城學府,2023-07-07,9822
3025,星通,23,8,15,元大-土城學府,2023-07-07,9822
1710,東聯,15,1,14,元大-土城學府,2023-07-07,9822
6125,廣運,13,0,13,元大-土城學府,2023-07-07,9822
2002,中鋼,15,2,13,元大-土城學府,2023-07-07,9822
3564,其陽,13,1,12,元大-土城學府,2023-07-07,9822
2615,萬海,12,0,12,元大-土城學府,2023-07-07,9822
00712,復華富時不動產,13,2,11,元大-土城學府,2023-07-07,9822
00764B,群益25年美債,11,0,11,元大-土城學府,2023-07-07,9822
00632R,元大台灣50反1,21,10,11,元大-土城學府,2023-07-07,9822
00751B,元大AAA至A公司債,11,0,11,元大-土城學府,2023-07-07,9822
2337,旺宏,11,0,11,元大-土城學府,2023-07-07,9822
4526,東台,16,5,11,元大-土城學府,2023-07-07,9822
6672,騰輝電子-KY,11,0,11,元大-土城學府,2023-07-07,9822
00904,新光臺灣半導體30,10,0,10,元大-土城學府,2023-07-07,9822
1584,精剛,10,0,10,元大-土城學府,2023-07-07,9822
1809,中釉,68,58,10,元大-土城學府,2023-07-07,9822
3093,港建*,11,1,10,元大-土城學府,2023-07-07,9822
3289,宜特,13,3,10,元大-土城學府,2023-07-07,9822
6167,久正,10,0,10,元大-土城學府,2023-07-07,9822
8411,福貞-KY,10,0,10,元大-土城學府,2023-07-07,9822
1711,永光,11,2,9,元大-土城學府,2023-07-07,9822
3046,建��,8,0,8,元大-土城學府,2023-07-07,9822
00713,元大台灣高息低波,9,1,8,元大-土城學府,2023-07-07,9822
2347,聯強,7,0,7,元大-土城學府,2023-07-07,9822
2834,臺企銀,381,1,380,元大-土城學府,2023-07-10,9822
0056,元大高股息,247,20,227,元大-土城學府,2023-07-10,9822
4533,協易機,195,3,192,元大-土城學府,2023-07-10,9822
2303,聯電,105,8,97,元大-土城學府,2023-07-10,9822
2883,凱基金,71,3,68,元大-土城學府,2023-07-10,9822
3025,星通,113,45,68,元大-土城學府,2023-07-10,9822
2609,陽明,92,38,54,元大-土城學府,2023-07-10,9822
2449,京元電子,42,2,40,元大-土城學府,2023-07-10,9822
4532,瑞智,109,69,40,元大-土城學府,2023-07-10,9822
6190,萬泰科,30,1,29,元大-土城學府,2023-07-10,9822
6282,康舒,64,37,27,元大-土城學府,2023-07-10,9822
00679B,元大美債20年,26,0,26,元大-土城學府,2023-07-10,9822
00929,復華台灣科技優息,28,5,23,元大-土城學府,2023-07-10,9822
6016,康和證,23,0,23,元大-土城學府,2023-07-10,9822
8171,天宇,22,0,22,元大-土城學府,2023-07-10,9822
00673R,期元大S＆P原油反1,22,0,22,元大-土城學府,2023-07-10,9822
2482,連宇,20,0,20,元大-土城學府,2023-07-10,9822
3518,柏騰,20,0,20,元大-土城學府,2023-07-10,9822
2615,萬海,35,19,16,元大-土城學府,2023-07-10,9822
00882,中信中國高股息,16,0,16,元大-土城學府,2023-07-10,9822
2356,英業達,41,25,16,元大-土城學府,2023-07-10,9822
1336,台翰,15,0,15,元大-土城學府,2023-07-10,9822
1101,台泥,15,2,13,元大-土城學府,2023-07-10,9822
2489,瑞軒,13,0,13,元大-土城學府,2023-07-10,9822
8050,廣積,31,18,13,元大-土城學府,2023-07-10,9822
2382,廣達,20,8,12,元大-土城學府,2023-07-10,9822
2201,裕隆,21,10,11,元大-土城學府,2023-07-10,9822
8049,晶采,11,0,11,元大-土城學府,2023-07-10,9822
3078,僑威,16,5,11,元大-土城學府,2023-07-10,9822
9945,潤泰新,10,0,10,元大-土城學府,2023-07-10,9822
1906,寶隆,10,0,10,元大-土城學府,2023-07-10,9822
8163,達方,15,5,10,元大-土城學府,2023-07-10,9822
2329,華泰,13,4,9,元大-土城學府,2023-07-10,9822
4155,訊映,9,0,9,元大-土城學府,2023-07-10,9822
6122,擎邦,10,1,9,元大-土城學府,2023-07-10,9822
6411,晶焱,10,1,9,元大-土城學府,2023-07-10,9822
2610,華航,21,12,9,元大-土城學府,2023-07-10,9822
2317,鴻海,8,0,8,元大-土城學府,2023-07-10,9822
00891,中信關鍵半導體,8,0,8,元大-土城學府,2023-07-10,9822
00722B,群益投資級電信債,8,0,8,元大-土城學府,2023-07-10,9822
3060,銘異,10,2,8,元大-土城學府,2023-07-10,9822
2618,長榮航,13,5,8,元大-土城學府,2023-07-10,9822
2312,金寶,762,755,7,元大-土城學府,2023-07-10,9822
3346,麗清,11,4,7,元大-土城學府,2023-07-10,9822
2324,仁寶,26,19,7,元大-土城學府,2023-07-10,9822
00687B,國泰20年美債,6,0,6,元大-土城學府,2023-07-10,9822
00772B,中信高評級公司債,6,0,6,元大-土城學府,2023-07-10,9822
6266,泰詠,7,1,6,元大-土城學府,2023-07-10,9822
1907,永豐餘,7,1,6,元大-土城學府,2023-07-10,9822
2605,新興,6,0,6,元大-土城學府,2023-07-10,9822
00679B,元大美債20年,245,0,245,元大-土城學府,2023-07-11,9822
6190,萬泰科,64,4,60,元大-土城學府,2023-07-11,9822
6285,啟��,85,31,54,元大-土城學府,2023-07-11,9822
6288,聯嘉,34,2,32,元大-土城學府,2023-07-11,9822
2201,裕隆,27,0,27,元大-土城學府,2023-07-11,9822
6282,康舒,30,10,20,元大-土城學府,2023-07-11,9822
3715,定穎投控,18,0,18,元大-土城學府,2023-07-11,9822
6417,韋僑,23,5,18,元大-土城學府,2023-07-11,9822
2615,萬海,21,4,17,元大-土城學府,2023-07-11,9822
6129,普誠,16,0,16,元大-土城學府,2023-07-11,9822
2340,台亞,37,22,15,元大-土城學府,2023-07-11,9822
4526,東台,18,4,14,元大-土城學府,2023-07-11,9822
5243,乙盛-KY,13,0,13,元大-土城學府,2023-07-11,9822
3016,嘉晶,16,4,12,元大-土城學府,2023-07-11,9822
3546,宇峻,12,0,12,元大-土城學府,2023-07-11,9822
4147,中裕,12,0,12,元大-土城學府,2023-07-11,9822
6185,幃翔,12,0,12,元大-土城學府,2023-07-11,9822
2371,大同,20,8,12,元大-土城學府,2023-07-11,9822
00673R,期元大S＆P原油反1,11,0,11,元大-土城學府,2023-07-11,9822
00632R,元大台灣50反1,15,4,11,元大-土城學府,2023-07-11,9822
5465,富驊,15,5,10,元大-土城學府,2023-07-11,9822
1304,台聚,10,0,10,元大-土城學府,2023-07-11,9822
2399,映泰,10,0,10,元大-土城學府,2023-07-11,9822
2867,三商壽,10,0,10,元大-土城學府,2023-07-11,9822
3019,亞光,21,11,10,元大-土城學府,2023-07-11,9822
6485,點序,10,0,10,元大-土城學府,2023-07-11,9822
3558,神準,11,1,10,元大-土城學府,2023-07-11,9822
00929,復華台灣科技優息,9,0,9,元大-土城學府,2023-07-11,9822
2387,精元,9,0,9,元大-土城學府,2023-07-11,9822
2402,毅嘉,13,4,9,元大-土城學府,2023-07-11,9822
3430,奇鈦科,9,0,9,元大-土城學府,2023-07-11,9822
4934,太極,15,6,9,元大-土城學府,2023-07-11,9822
4967,十銓,9,0,9,元大-土城學府,2023-07-11,9822
3707,漢磊,21,12,9,元大-土城學府,2023-07-11,9822
1503,士電,10,2,8,元大-土城學府,2023-07-11,9822
1515,力山,19,11,8,元大-土城學府,2023-07-11,9822
1618,合機,11,3,8,元大-土城學府,2023-07-11,9822
2453,凌群,8,0,8,元大-土城學府,2023-07-11,9822
3289,宜特,13,5,8,元大-土城學府,2023-07-11,9822
3624,光頡,9,1,8,元大-土城學府,2023-07-11,9822
6120,達運,25,17,8,元大-土城學府,2023-07-11,9822
6142,友勁,9,1,8,元大-土城學府,2023-07-11,9822
8358,金居,8,0,8,元大-土城學府,2023-07-11,9822
1604,聲寶,15,8,7,元大-土城學府,2023-07-11,9822
2363,矽統,7,0,7,元大-土城學府,2023-07-11,9822
4105,東洋,7,0,7,元大-土城學府,2023-07-11,9822
5521,工信,7,0,7,元大-土城學府,2023-07-11,9822
1785,光洋科,7,1,6,元大-土城學府,2023-07-11,9822
2031,新光鋼,6,0,6,元大-土城學府,2023-07-11,9822
2545,皇翔,6,0,6,元大-土城學府,2023-07-11,9822
4533,協易機,104,2,102,元大-土城學府,2023-07-12,9822
2303,聯電,108,33,75,元大-土城學府,2023-07-12,9822
2371,大同,75,15,60,元大-土城學府,2023-07-12,9822
3706,神達,135,93,42,元大-土城學府,2023-07-12,9822
2344,華邦電,46,10,36,元大-土城學府,2023-07-12,9822
2609,陽明,70,37,33,元大-土城學府,2023-07-12,9822
2020,美亞,34,1,33,元大-土城學府,2023-07-12,9822
2481,強茂,47,19,28,元大-土城學府,2023-07-12,9822
3231,緯創,90,65,25,元大-土城學府,2023-07-12,9822
2409,友達,33,10,23,元大-土城學府,2023-07-12,9822
5521,工信,30,7,23,元大-土城學府,2023-07-12,9822
2444,兆勁,22,0,22,元大-土城學府,2023-07-12,9822
3202,樺晟,20,0,20,元大-土城學府,2023-07-12,9822
8028,昇陽半導體,22,2,20,元大-土城學府,2023-07-12,9822
1528,恩德,31,12,19,元大-土城學府,2023-07-12,9822
0056,元大高股息,72,53,19,元大-土城學府,2023-07-12,9822
3583,辛耘,25,7,18,元大-土城學府,2023-07-12,9822
3078,僑威,19,1,18,元大-土城學府,2023-07-12,9822
00673R,期元大S＆P原油反1,18,0,18,元大-土城學府,2023-07-12,9822
00929,復華台灣科技優息,16,0,16,元大-土城學府,2023-07-12,9822
00882,中信中國高股息,16,0,16,元大-土城學府,2023-07-12,9822
4173,久裕,17,1,16,元大-土城學府,2023-07-12,9822
1444,力麗,15,0,15,元大-土城學府,2023-07-12,9822
4977,眾達-KY,14,0,14,元大-土城學府,2023-07-12,9822
6190,萬泰科,14,0,14,元大-土城學府,2023-07-12,9822
1584,精剛,20,6,14,元大-土城學府,2023-07-12,9822
2353,宏��,53,39,14,元大-土城學府,2023-07-12,9822
3289,宜特,19,6,13,元大-土城學府,2023-07-12,9822
5009,榮剛,18,5,13,元大-土城學府,2023-07-12,9822
6180,橘子,13,0,13,元大-土城學府,2023-07-12,9822
6285,啟��,31,19,12,元大-土城學府,2023-07-12,9822
1308,亞聚,12,0,12,元大-土城學府,2023-07-12,9822
2610,華航,86,74,12,元大-土城學府,2023-07-12,9822
1460,宏遠,11,0,11,元大-土城學府,2023-07-12,9822
2312,金寶,758,747,11,元大-土城學府,2023-07-12,9822
2314,台揚,11,0,11,元大-土城學府,2023-07-12,9822
2323,中環,26,15,11,元大-土城學府,2023-07-12,9822
6116,彩晶,11,0,11,元大-土城學府,2023-07-12,9822
6223,旺矽,12,1,11,元大-土城學府,2023-07-12,9822
3265,台星科,10,0,10,元大-土城學府,2023-07-12,9822
00905,FT臺灣Smart,10,0,10,元大-土城學府,2023-07-12,9822
2605,新興,10,0,10,元大-土城學府,2023-07-12,9822
3093,港建*,10,0,10,元大-土城學府,2023-07-12,9822
5608,四維航,12,2,10,元大-土城學府,2023-07-12,9822
6509,聚和,12,2,10,元大-土城學府,2023-07-12,9822
2402,毅嘉,11,1,10,元大-土城學府,2023-07-12,9822
2412,中華電,9,0,9,元大-土城學府,2023-07-12,9822
2419,仲琦,11,2,9,元大-土城學府,2023-07-12,9822
2634,漢翔,11,2,9,元大-土城學府,2023-07-12,9822
4532,瑞智,47,38,9,元大-土城學府,2023-07-12,9822
2618,長榮航,394,48,346,元大-土城學府,2023-07-13,9822
2610,華航,146,37,109,元大-土城學府,2023-07-13,9822
1609,大亞,66,7,59,元大-土城學府,2023-07-13,9822
00632R,元大台灣50反1,74,22,52,元大-土城學府,2023-07-13,9822
3057,喬鼎,47,0,47,元大-土城學府,2023-07-13,9822
00720B,元大投資級公司債,51,5,46,元大-土城學府,2023-07-13,9822
5521,工信,35,0,35,元大-土城學府,2023-07-13,9822
2301,光寶科,93,58,35,元大-土城學府,2023-07-13,9822
2323,中環,39,6,33,元大-土城學府,2023-07-13,9822
2025,千興,30,0,30,元大-土城學府,2023-07-13,9822
6806,森崴能源,35,6,29,元大-土城學府,2023-07-13,9822
00751B,元大AAA至A公司債,30,2,28,元大-土城學府,2023-07-13,9822
020038,元大ESG配息N,28,0,28,元大-土城學府,2023-07-13,9822
2329,華泰,58,33,25,元大-土城學府,2023-07-13,9822
00930,永豐ESG低碳高息,23,0,23,元大-土城學府,2023-07-13,9822
4743,合一,23,0,23,元大-土城學府,2023-07-13,9822
2303,聯電,52,29,23,元大-土城學府,2023-07-13,9822
2317,鴻海,23,1,22,元大-土城學府,2023-07-13,9822
1219,福壽,21,0,21,元大-土城學府,2023-07-13,9822
4533,協易機,46,25,21,元大-土城學府,2023-07-13,9822
4526,東台,22,3,19,元大-土城學府,2023-07-13,9822
6180,橘子,17,0,17,元大-土城學府,2023-07-13,9822
6188,廣明,47,31,16,元大-土城學府,2023-07-13,9822
2308,台達電,20,4,16,元大-土城學府,2023-07-13,9822
1514,亞力,16,1,15,元大-土城學府,2023-07-13,9822
6118,建達,33,18,15,元大-土城學府,2023-07-13,9822
2891,中信金,16,2,14,元大-土城學府,2023-07-13,9822
2331,精英,19,5,14,元大-土城學府,2023-07-13,9822
4129,聯合,13,0,13,元大-土城學府,2023-07-13,9822
1503,士電,19,7,12,元大-土城學府,2023-07-13,9822
00679B,元大美債20年,12,0,12,元大-土城學府,2023-07-13,9822
2402,毅嘉,13,1,12,元大-土城學府,2023-07-13,9822
2455,全新,13,1,12,元大-土城學府,2023-07-13,9822
4173,久裕,12,0,12,元大-土城學府,2023-07-13,9822
8021,尖點,12,0,12,元大-土城學府,2023-07-13,9822
5009,榮剛,12,1,11,元大-土城學府,2023-07-13,9822
3231,緯創,102,91,11,元大-土城學府,2023-07-13,9822
4906,正文,12,1,11,元大-土城學府,2023-07-13,9822
1314,中石化,13,3,10,元大-土城學府,2023-07-13,9822
6282,康舒,25,15,10,元大-土城學府,2023-07-13,9822
1604,聲寶,10,0,10,元大-土城學府,2023-07-13,9822
00645,富邦日本,10,0,10,元大-土城學府,2023-07-13,9822
00648R,元大S＆P500反1,10,0,10,元大-土城學府,2023-07-13,9822
2498,宏達電,22,12,10,元大-土城學府,2023-07-13,9822
6005,群益證,10,0,10,元大-土城學府,2023-07-13,9822
6547,高端疫苗,11,1,10,元大-土城學府,2023-07-13,9822
8024,佑華,10,0,10,元大-土城學府,2023-07-13,9822
3576,聯合再生,9,0,9,元大-土城學府,2023-07-13,9822
3704,合勤控,37,28,9,元大-土城學府,2023-07-13,9822
5351,鈺創,9,0,9,元大-土城學府,2023-07-13,9822
2312,金寶,859,685,174,元大-土城學府,2023-07-14,9822
2618,長榮航,236,86,150,元大-土城學府,2023-07-14,9822
2457,飛宏,112,4,108,元大-土城學府,2023-07-14,9822
2329,華泰,133,31,102,元大-土城學府,2023-07-14,9822
2610,華航,165,66,99,元大-土城學府,2023-07-14,9822
2449,京元電子,106,25,81,元大-土城學府,2023-07-14,9822
00720B,元大投資級公司債,63,0,63,元大-土城學府,2023-07-14,9822
3032,偉訓,56,15,41,元大-土城學府,2023-07-14,9822
00929,復華台灣科技優息,40,2,38,元大-土城學府,2023-07-14,9822
00679B,元大美債20年,34,0,34,元大-土城學府,2023-07-14,9822
8201,無敵,38,4,34,元大-土城學府,2023-07-14,9822
6579,研揚,35,2,33,元大-土城學府,2023-07-14,9822
1609,大亞,36,6,30,元大-土城學府,2023-07-14,9822
3706,神達,28,4,24,元大-土城學府,2023-07-14,9822
00930,永豐ESG低碳高息,22,0,22,元大-土城學府,2023-07-14,9822
4153,鈺緯,20,0,20,元大-土城學府,2023-07-14,9822
2371,大同,46,28,18,元大-土城學府,2023-07-14,9822
4746,台耀,25,8,17,元大-土城學府,2023-07-14,9822
2498,宏達電,32,15,17,元大-土城學府,2023-07-14,9822
6285,啟��,25,9,16,元大-土城學府,2023-07-14,9822
2382,廣達,116,101,15,元大-土城學府,2023-07-14,9822
2634,漢翔,28,13,15,元大-土城學府,2023-07-14,9822
6116,彩晶,17,2,15,元大-土城學府,2023-07-14,9822
2002,中鋼,20,7,13,元大-土城學府,2023-07-14,9822
3363,上詮,35,23,12,元大-土城學府,2023-07-14,9822
00633L,富邦上証正2,12,0,12,元大-土城學府,2023-07-14,9822
00882,中信中國高股息,12,0,12,元大-土城學府,2023-07-14,9822
1604,聲寶,11,0,11,元大-土城學府,2023-07-14,9822
1618,合機,12,1,11,元大-土城學府,2023-07-14,9822
6226,光鼎,11,0,11,元大-土城學府,2023-07-14,9822
6589,台康生技,11,0,11,元大-土城學府,2023-07-14,9822
2543,皇昌,10,0,10,元大-土城學府,2023-07-14,9822
4532,瑞智,12,2,10,元大-土城學府,2023-07-14,9822
4967,十銓,10,0,10,元大-土城學府,2023-07-14,9822
6613,朋億*,10,0,10,元大-土城學府,2023-07-14,9822
00722B,群益投資級電信債,9,0,9,元大-土城學府,2023-07-14,9822
3025,星通,10,1,9,元大-土城學府,2023-07-14,9822
6120,達運,16,7,9,元大-土城學府,2023-07-14,9822
6223,旺矽,18,9,9,元大-土城學府,2023-07-14,9822
8034,榮群,9,0,9,元大-土城學府,2023-07-14,9822
2630,亞航,8,0,8,元大-土城學府,2023-07-14,9822
1218,泰山,8,0,8,元大-土城學府,2023-07-14,9822
00928,中信上櫃ESG30,8,0,8,元大-土城學府,2023-07-14,9822
1201,味全,8,0,8,元大-土城學府,2023-07-14,9822
8358,金居,21,13,8,元大-土城學府,2023-07-14,9822
6235,華孚,25,18,7,元大-土城學府,2023-07-14,9822
5483,中美晶,19,12,7,元大-土城學府,2023-07-14,9822
2206,三陽工業,7,1,6,元大-土城學府,2023-07-14,9822
2201,裕隆,10,4,6,元大-土城學府,2023-07-14,9822
2421,建準,31,25,6,元大-土城學府,2023-07-14,9822
8096,擎亞,905,692,213,元大-土城學府,2023-07-17,9822
2312,金寶,139,17,122,元大-土城學府,2023-07-17,9822
3481,群創,124,17,107,元大-土城學府,2023-07-17,9822
2855,統一證,92,0,92,元大-土城學府,2023-07-17,9822
00929,復華台灣科技優息,69,0,69,元大-土城學府,2023-07-17,9822
2352,佳世達,58,4,54,元大-土城學府,2023-07-17,9822
1718,中纖,50,0,50,元大-土城學府,2023-07-17,9822
2801,彰銀,50,0,50,元大-土城學府,2023-07-17,9822
2618,長榮航,68,19,49,元大-土城學府,2023-07-17,9822
2313,華通,79,31,48,元大-土城學府,2023-07-17,9822
2324,仁寶,101,53,48,元大-土城學府,2023-07-17,9822
00882,中信中國高股息,45,6,39,元大-土城學府,2023-07-17,9822
5521,工信,30,0,30,元大-土城學府,2023-07-17,9822
2610,華航,51,23,28,元大-土城學府,2023-07-17,9822
6579,研揚,27,2,25,元大-土城學府,2023-07-17,9822
6188,廣明,33,8,25,元大-土城學府,2023-07-17,9822
2382,廣達,75,51,24,元大-土城學府,2023-07-17,9822
3037,欣興,33,9,24,元大-土城學府,2023-07-17,9822
1513,中興電,85,62,23,元大-土城學府,2023-07-17,9822
2329,華泰,47,26,21,元大-土城學府,2023-07-17,9822
3016,嘉晶,20,0,20,元大-土城學府,2023-07-17,9822
3380,明泰,53,33,20,元大-土城學府,2023-07-17,9822
5328,華容,20,0,20,元大-土城學府,2023-07-17,9822
5483,中美晶,26,6,20,元大-土城學府,2023-07-17,9822
1604,聲寶,18,1,17,元大-土城學府,2023-07-17,9822
2356,英業達,48,31,17,元大-土城學府,2023-07-17,9822
1618,合機,22,7,15,元大-土城學府,2023-07-17,9822
9958,世紀鋼,16,1,15,元大-土城學府,2023-07-17,9822
3163,波若威,23,10,13,元大-土城學府,2023-07-17,9822
6223,旺矽,13,0,13,元大-土城學府,2023-07-17,9822
1519,華城,30,18,12,元大-土城學府,2023-07-17,9822
5607,遠雄港,15,3,12,元大-土城學府,2023-07-17,9822
2457,飛宏,24,12,12,元大-土城學府,2023-07-17,9822
1904,正隆,12,0,12,元大-土城學府,2023-07-17,9822
2374,佳能,12,0,12,元大-土城學府,2023-07-17,9822
2498,宏達電,22,10,12,元大-土城學府,2023-07-17,9822
00922,國泰台灣領袖50,12,1,11,元大-土城學府,2023-07-17,9822
1217,愛之味,13,2,11,元大-土城學府,2023-07-17,9822
2331,精英,15,4,11,元大-土城學府,2023-07-17,9822
2301,光寶科,68,57,11,元大-土城學府,2023-07-17,9822
2891,中信金,18,7,11,元大-土城學府,2023-07-17,9822
6703,軒郁,10,0,10,元大-土城學府,2023-07-17,9822
1402,遠東新,10,0,10,元大-土城學府,2023-07-17,9822
2375,凱美,10,0,10,元大-土城學府,2023-07-17,9822
2468,華經,10,0,10,元大-土城學府,2023-07-17,9822
4916,事欣科,11,1,10,元大-土城學府,2023-07-17,9822
2353,宏��,34,26,8,元大-土城學府,2023-07-17,9822
1784,訊聯,9,1,8,元大-土城學府,2023-07-17,9822
1909,榮成,8,0,8,元大-土城學府,2023-07-17,9822
2402,毅嘉,12,4,8,元大-土城學府,2023-07-17,9822
2312,金寶,861,628,233,元大-土城學府,2023-07-18,9822
00882,中信中國高股息,147,0,147,元大-土城學府,2023-07-18,9822
1514,亞力,123,9,114,元大-土城學府,2023-07-18,9822
4414,如興,100,0,100,元大-土城學府,2023-07-18,9822
2356,英業達,210,131,79,元大-土城學府,2023-07-18,9822
00929,復華台灣科技優息,72,1,71,元大-土城學府,2023-07-18,9822
9105,泰金寶-DR,82,12,70,元大-土城學府,2023-07-18,9822
2374,佳能,67,13,54,元大-土城學府,2023-07-18,9822
2324,仁寶,150,97,53,元大-土城學府,2023-07-18,9822
3038,全台,67,15,52,元大-土城學府,2023-07-18,9822
3706,神達,255,203,52,元大-土城學府,2023-07-18,9822
6282,康舒,173,125,48,元大-土城學府,2023-07-18,9822
00878,國泰永續高股息,144,97,47,元大-土城學府,2023-07-18,9822
2425,承啟,49,4,45,元大-土城學府,2023-07-18,9822
2883,凱基金,45,4,41,元大-土城學府,2023-07-18,9822
3338,泰碩,47,8,39,元大-土城學府,2023-07-18,9822
2609,陽明,79,42,37,元大-土城學府,2023-07-18,9822
3518,柏騰,83,50,33,元大-土城學府,2023-07-18,9822
2352,佳世達,86,54,32,元大-土城學府,2023-07-18,9822
2412,中華電,32,0,32,元大-土城學府,2023-07-18,9822
6188,廣明,67,36,31,元大-土城學府,2023-07-18,9822
5521,工信,30,0,30,元大-土城學府,2023-07-18,9822
00632R,元大台灣50反1,30,2,28,元大-土城學府,2023-07-18,9822
4129,聯合,27,0,27,元大-土城學府,2023-07-18,9822
2201,裕隆,26,0,26,元大-土城學府,2023-07-18,9822
2371,大同,38,12,26,元大-土城學府,2023-07-18,9822
1513,中興電,40,20,20,元大-土城學府,2023-07-18,9822
2618,長榮航,49,29,20,元大-土城學府,2023-07-18,9822
1608,華榮,21,1,20,元大-土城學府,2023-07-18,9822
2449,京元電子,28,8,20,元大-土城學府,2023-07-18,9822
3071,協禧,20,0,20,元大-土城學府,2023-07-18,9822
8409,商之器,20,0,20,元大-土城學府,2023-07-18,9822
6133,金橋,20,1,19,元大-土城學府,2023-07-18,9822
3583,辛耘,29,12,17,元大-土城學府,2023-07-18,9822
4532,瑞智,24,7,17,元大-土城學府,2023-07-18,9822
2323,中環,21,5,16,元大-土城學府,2023-07-18,9822
6276,安鈦克,17,1,16,元大-土城學府,2023-07-18,9822
3380,明泰,18,2,16,元大-土城學府,2023-07-18,9822
00720B,元大投資級公司債,15,0,15,元大-土城學府,2023-07-18,9822
6274,台燿,22,8,14,元大-土城學府,2023-07-18,9822
1609,大亞,45,31,14,元大-土城學府,2023-07-18,9822
2481,強茂,29,16,13,元大-土城學府,2023-07-18,9822
6223,旺矽,18,5,13,元大-土城學府,2023-07-18,9822
1618,合機,14,2,12,元大-土城學府,2023-07-18,9822
1471,首利,13,1,12,元大-土城學府,2023-07-18,9822
2362,藍天,14,2,12,元大-土城學府,2023-07-18,9822
2498,宏達電,36,24,12,元大-土城學府,2023-07-18,9822
4743,合一,12,0,12,元大-土城學府,2023-07-18,9822
5469,瀚宇博,12,0,12,元大-土城學府,2023-07-18,9822
1503,士電,19,7,12,元大-土城學府,2023-07-18,9822
4915,致伸,102,0,102,元大-土城學府,2023-07-19,9822
00669R,國泰美國道瓊反1,100,0,100,元大-土城學府,2023-07-19,9822
5469,瀚宇博,101,3,98,元大-土城學府,2023-07-19,9822
2618,長榮航,107,25,82,元大-土城學府,2023-07-19,9822
00882,中信中國高股息,68,0,68,元大-土城學府,2023-07-19,9822
2303,聯電,49,1,48,元大-土城學府,2023-07-19,9822
3706,神達,195,148,47,元大-土城學府,2023-07-19,9822
00895,富邦未來車,42,1,41,元大-土城學府,2023-07-19,9822
2409,友達,39,0,39,元大-土城學府,2023-07-19,9822
1514,亞力,41,4,37,元大-土城學府,2023-07-19,9822
1504,東元,40,4,36,元大-土城學府,2023-07-19,9822
1609,大亞,36,5,31,元大-土城學府,2023-07-19,9822
6288,聯嘉,31,1,30,元大-土城學府,2023-07-19,9822
2492,華新科,25,0,25,元大-土城學府,2023-07-19,9822
2888,新光金,25,1,24,元大-土城學府,2023-07-19,9822
00929,復華台灣科技優息,39,18,21,元大-土城學府,2023-07-19,9822
3016,嘉晶,21,0,21,元大-土城學府,2023-07-19,9822
6218,豪勉,22,1,21,元大-土城學府,2023-07-19,9822
2353,宏��,64,44,20,元大-土城學府,2023-07-19,9822
2867,三商壽,30,10,20,元大-土城學府,2023-07-19,9822
2313,華通,22,2,20,元大-土城學府,2023-07-19,9822
6016,康和證,20,0,20,元大-土城學府,2023-07-19,9822
3078,僑威,56,37,19,元大-土城學府,2023-07-19,9822
2481,強茂,25,6,19,元大-土城學府,2023-07-19,9822
6116,彩晶,20,1,19,元大-土城學府,2023-07-19,9822
2883,凱基金,17,0,17,元大-土城學府,2023-07-19,9822
6188,廣明,20,4,16,元大-土城學府,2023-07-19,9822
00722B,群益投資級電信債,15,0,15,元大-土城學府,2023-07-19,9822
1402,遠東新,15,0,15,元大-土城學府,2023-07-19,9822
4938,和碩,36,21,15,元大-土城學府,2023-07-19,9822
2201,裕隆,16,3,13,元大-土城學府,2023-07-19,9822
2634,漢翔,20,7,13,元大-土城學府,2023-07-19,9822
2324,仁寶,76,63,13,元大-土城學府,2023-07-19,9822
3037,欣興,57,44,13,元大-土城學府,2023-07-19,9822
8201,無敵,20,8,12,元大-土城學府,2023-07-19,9822
4566,時碩工業,17,5,12,元大-土城學府,2023-07-19,9822
6111,大宇資,12,0,12,元大-土城學府,2023-07-19,9822
1795,美時,12,1,11,元大-土城學府,2023-07-19,9822
6207,雷科,11,0,11,元大-土城學府,2023-07-19,9822
00648R,元大S＆P500反1,10,0,10,元大-土城學府,2023-07-19,9822
2349,錸德,10,0,10,元大-土城學府,2023-07-19,9822
2419,仲琦,63,53,10,元大-土城學府,2023-07-19,9822
2897,王道銀行,10,0,10,元大-土城學府,2023-07-19,9822
4931,新盛力,10,0,10,元大-土城學府,2023-07-19,9822
6124,業強,10,0,10,元大-土城學府,2023-07-19,9822
4123,晟德,25,15,10,元大-土城學府,2023-07-19,9822
2881,富邦金,17,8,9,元大-土城學府,2023-07-19,9822
6114,久威,13,4,9,元大-土城學府,2023-07-19,9822
2344,華邦電,9,0,9,元大-土城學府,2023-07-19,9822
3363,上詮,49,40,9,元大-土城學府,2023-07-19,9822
2303,聯電,90,5,85,元大-土城學府,2023-07-20,9822
2609,陽明,86,16,70,元大-土城學府,2023-07-20,9822
3265,台星科,46,4,42,元大-土城學府,2023-07-20,9822
020038,元大ESG配息N,39,0,39,元大-土城學府,2023-07-20,9822
00712,復華富時不動產,52,15,37,元大-土城學府,2023-07-20,9822
3289,宜特,45,11,34,元大-土城學府,2023-07-20,9822
1101,台泥,33,0,33,元大-土城學府,2023-07-20,9822
6120,達運,33,2,31,元大-土城學府,2023-07-20,9822
2409,友達,33,3,30,元大-土城學府,2023-07-20,9822
3037,欣興,40,14,26,元大-土城學府,2023-07-20,9822
00929,復華台灣科技優息,35,11,24,元大-土城學府,2023-07-20,9822
2481,強茂,31,7,24,元大-土城學府,2023-07-20,9822
1102,亞泥,21,0,21,元大-土城學府,2023-07-20,9822
00858,永豐美國500大,20,0,20,元大-土城學府,2023-07-20,9822
5521,工信,20,0,20,元大-土城學府,2023-07-20,9822
0056,元大高股息,43,26,17,元大-土城學府,2023-07-20,9822
00900,富邦特選高股息30,17,0,17,元大-土城學府,2023-07-20,9822
00882,中信中國高股息,16,0,16,元大-土城學府,2023-07-20,9822
1529,樂事綠能,21,6,15,元大-土城學府,2023-07-20,9822
1810,和成,17,3,14,元大-土城學府,2023-07-20,9822
1795,美時,15,3,12,元大-土城學府,2023-07-20,9822
4130,健亞,12,0,12,元大-土城學府,2023-07-20,9822
9951,皇田,12,0,12,元大-土城學府,2023-07-20,9822
2329,華泰,14,3,11,元大-土城學府,2023-07-20,9822
3048,益登,11,0,11,元大-土城學府,2023-07-20,9822
3205,佰研,13,2,11,元大-土城學府,2023-07-20,9822
6104,創惟,14,3,11,元大-土城學府,2023-07-20,9822
2206,三陽工業,20,9,11,元大-土城學府,2023-07-20,9822
00679B,元大美債20年,10,0,10,元大-土城學府,2023-07-20,9822
1815,富喬,10,0,10,元大-土城學府,2023-07-20,9822
2323,中環,10,0,10,元大-土城學府,2023-07-20,9822
6129,普誠,12,2,10,元大-土城學府,2023-07-20,9822
6207,雷科,10,0,10,元大-土城學府,2023-07-20,9822
6223,旺矽,13,3,10,元大-土城學府,2023-07-20,9822
2337,旺宏,16,7,9,元大-土城學府,2023-07-20,9822
2356,英業達,38,28,10,元大-土城學府,2023-07-20,9822
3232,昱捷,9,0,9,元大-土城學府,2023-07-20,9822
4938,和碩,12,4,8,元大-土城學府,2023-07-20,9822
00885,富邦越南,8,0,8,元大-土城學府,2023-07-20,9822
2312,金寶,715,707,8,元大-土城學府,2023-07-20,9822
4919,新唐,18,10,8,元大-土城學府,2023-07-20,9822
9958,世紀鋼,11,3,8,元大-土城學府,2023-07-20,9822
2376,技嘉,19,12,7,元大-土城學府,2023-07-20,9822
2419,仲琦,12,6,6,元大-土城學府,2023-07-20,9822
3035,智原,17,11,6,元大-土城學府,2023-07-20,9822
6235,華孚,15,9,6,元大-土城學府,2023-07-20,9822
00680L,元大美債20正2,10,4,6,元大-土城學府,2023-07-20,9822
2374,佳能,17,11,6,元大-土城學府,2023-07-20,9822
2436,偉詮電,8,2,6,元大-土城學府,2023-07-20,9822
2736,富野,8,2,6,元大-土城學府,2023-07-20,9822
3481,群創,106,12,94,元大-土城學府,2023-07-21,9822
2618,長榮航,77,2,75,元大-土城學府,2023-07-21,9822
1513,中興電,109,42,67,元大-土城學府,2023-07-21,9822
3191,雲嘉南,60,0,60,元大-土城學府,2023-07-21,9822
2634,漢翔,67,12,55,元大-土城學府,2023-07-21,9822
00669R,國泰美國道瓊反1,50,0,50,元大-土城學府,2023-07-21,9822
5701,劍湖山,40,0,40,元大-土城學府,2023-07-21,9822
2515,中工,38,0,38,元大-土城學府,2023-07-21,9822
1102,亞泥,33,0,33,元大-土城學府,2023-07-21,9822
4919,新唐,38,6,32,元大-土城學府,2023-07-21,9822
00929,復華台灣科技優息,40,9,31,元大-土城學府,2023-07-21,9822
00715L,期街口布蘭特正2,25,2,23,元大-土城學府,2023-07-21,9822
2405,輔信,44,21,23,元大-土城學府,2023-07-21,9822
1514,亞力,34,12,22,元大-土城學府,2023-07-21,9822
3209,全科,20,0,20,元大-土城學府,2023-07-21,9822
5288,豐祥-KY,20,0,20,元大-土城學府,2023-07-21,9822
5425,台半,20,0,20,元大-土城學府,2023-07-21,9822
1101,台泥,24,5,19,元大-土城學府,2023-07-21,9822
1605,華新,19,1,18,元大-土城學府,2023-07-21,9822
6609,瀧澤科,18,0,18,元大-土城學府,2023-07-21,9822
3706,神達,27,10,17,元大-土城學府,2023-07-21,9822
8409,商之器,22,5,17,元大-土城學府,2023-07-21,9822
5521,工信,16,0,16,元大-土城學府,2023-07-21,9822
2603,長榮,20,4,16,元大-土城學府,2023-07-21,9822
3018,隆銘綠能,15,0,15,元大-土城學府,2023-07-21,9822
6282,康舒,71,57,14,元大-土城學府,2023-07-21,9822
006208,富邦台50,14,0,14,元大-土城學府,2023-07-21,9822
2324,仁寶,50,37,13,元大-土城學府,2023-07-21,9822
8936,國統,13,0,13,元大-土城學府,2023-07-21,9822
3013,晟銘電,28,16,12,元大-土城學府,2023-07-21,9822
3037,欣興,22,12,10,元大-土城學府,2023-07-21,9822
2201,裕隆,13,3,10,元大-土城學府,2023-07-21,9822
2352,佳世達,10,0,10,元大-土城學府,2023-07-21,9822
2883,凱基金,16,6,10,元大-土城學府,2023-07-21,9822
0050,元大台灣50,15,5,10,元大-土城學府,2023-07-21,9822
00904,新光臺灣半導體30,10,0,10,元大-土城學府,2023-07-21,9822
00688L,國泰20年美債正2,10,0,10,元大-土城學府,2023-07-21,9822
00680L,元大美債20正2,10,0,10,元大-土城學府,2023-07-21,9822
00772B,中信高評級公司債,10,0,10,元大-土城學府,2023-07-21,9822
6133,金橋,10,0,10,元大-土城學府,2023-07-21,9822
6207,雷科,10,0,10,元大-土城學府,2023-07-21,9822
6548,長科*,10,0,10,元大-土城學府,2023-07-21,9822
6579,研揚,10,0,10,元大-土城學府,2023-07-21,9822
2301,光寶科,39,29,10,元大-土城學府,2023-07-21,9822
3583,辛耘,14,5,9,元大-土城學府,2023-07-21,9822
3374,精材,10,2,8,元大-土城學府,2023-07-21,9822
3504,揚明光,8,0,8,元大-土城學府,2023-07-21,9822
6411,晶焱,8,0,8,元大-土城學府,2023-07-21,9822
6443,元晶,7,0,7,元大-土城學府,2023-07-21,9822
3038,全台,11,4,7,元大-土城學府,2023-07-21,9822
3481,群創,227,114,113,元大-土城學府,2023-07-24,9822
2618,長榮航,130,28,102,元大-土城學府,2023-07-24,9822
1905,華紙,121,32,89,元大-土城學府,2023-07-24,9822
3338,泰碩,88,18,70,元大-土城學府,2023-07-24,9822
6770,力積電,49,1,48,元大-土城學府,2023-07-24,9822
00929,復華台灣科技優息,45,4,41,元大-土城學府,2023-07-24,9822
2457,飛宏,50,11,39,元大-土城學府,2023-07-24,9822
2887,台新金,37,0,37,元大-土城學府,2023-07-24,9822
2329,華泰,51,17,34,元大-土城學府,2023-07-24,9822
1102,亞泥,34,2,32,元大-土城學府,2023-07-24,9822
2491,吉祥全,30,0,30,元大-土城學府,2023-07-24,9822
2374,佳能,27,0,27,元大-土城學府,2023-07-24,9822
1504,東元,28,2,26,元大-土城學府,2023-07-24,9822
4746,台耀,27,2,25,元大-土城學府,2023-07-24,9822
8044,網家,24,0,24,元大-土城學府,2023-07-24,9822
2883,凱基金,23,1,22,元大-土城學府,2023-07-24,9822
1101,台泥,22,0,22,元大-土城學府,2023-07-24,9822
3035,智原,68,46,22,元大-土城學府,2023-07-24,9822
2022,聚亨,20,0,20,元大-土城學府,2023-07-24,9822
2382,廣達,103,85,18,元大-土城學府,2023-07-24,9822
2881,富邦金,22,4,18,元大-土城學府,2023-07-24,9822
3205,佰研,17,0,17,元大-土城學府,2023-07-24,9822
3051,力特,18,2,16,元大-土城學府,2023-07-24,9822
2201,裕隆,16,1,15,元大-土城學府,2023-07-24,9822
2405,輔信,18,3,15,元大-土城學府,2023-07-24,9822
3141,晶宏,15,0,15,元大-土城學府,2023-07-24,9822
4503,金雨,15,0,15,元大-土城學府,2023-07-24,9822
1514,亞力,57,42,15,元大-土城學府,2023-07-24,9822
00712,復華富時不動產,14,0,14,元大-土城學府,2023-07-24,9822
2323,中環,14,0,14,元大-土城學府,2023-07-24,9822
3689,湧德,18,4,14,元大-土城學府,2023-07-24,9822
5386,青雲,14,0,14,元大-土城學府,2023-07-24,9822
1618,合機,16,3,13,元大-土城學府,2023-07-24,9822
2344,華邦電,13,0,13,元大-土城學府,2023-07-24,9822
6753,龍德造船,13,0,13,元大-土城學府,2023-07-24,9822
1503,士電,14,1,13,元大-土城學府,2023-07-24,9822
2515,中工,17,5,12,元大-土城學府,2023-07-24,9822
2388,威盛,12,1,11,元大-土城學府,2023-07-24,9822
2547,日勝生,11,0,11,元大-土城學府,2023-07-24,9822
00882,中信中國高股息,11,0,11,元大-土城學府,2023-07-24,9822
1609,大亞,49,38,11,元大-土城學府,2023-07-24,9822
2609,陽明,20,9,11,元大-土城學府,2023-07-24,9822
4977,眾達-KY,12,1,11,元大-土城學府,2023-07-24,9822
6417,韋僑,13,2,11,元大-土城學府,2023-07-24,9822
8016,矽創,10,0,10,元大-土城學府,2023-07-24,9822
00637L,元大滬深300正2,16,6,10,元大-土城學府,2023-07-24,9822
3450,聯鈞,13,3,10,元大-土城學府,2023-07-24,9822
4154,樂威科-KY,10,0,10,元大-土城學府,2023-07-24,9822
6190,萬泰科,10,0,10,元大-土城學府,2023-07-24,9822
2421,建準,80,70,10,元大-土城學府,2023-07-24,9822
2705,六福,63,2,61,元大-土城學府,2023-07-25,9822
2014,中鴻,51,1,50,元大-土城學府,2023-07-25,9822
2888,新光金,50,0,50,元大-土城學府,2023-07-25,9822
2303,聯電,46,5,41,元大-土城學府,2023-07-25,9822
1314,中石化,51,10,41,元大-土城學府,2023-07-25,9822
2883,凱基金,41,0,41,元大-土城學府,2023-07-25,9822
3231,緯創,46,5,41,元大-土城學府,2023-07-25,9822
3363,上詮,40,0,40,元大-土城學府,2023-07-25,9822
3037,欣興,74,41,33,元大-土城學府,2023-07-25,9822
1612,宏泰,36,6,30,元大-土城學府,2023-07-25,9822
2382,廣達,172,143,29,元大-土城學府,2023-07-25,9822
5521,工信,36,10,26,元大-土城學府,2023-07-25,9822
6188,廣明,44,21,23,元大-土城學府,2023-07-25,9822
2610,華航,31,9,22,元大-土城學府,2023-07-25,9822
00687B,國泰20年美債,20,0,20,元大-土城學府,2023-07-25,9822
8088,品安,20,0,20,元大-土城學府,2023-07-25,9822
4714,永捷,19,0,19,元大-土城學府,2023-07-25,9822
8093,保銳,19,0,19,元大-土城學府,2023-07-25,9822
2405,輔信,47,29,18,元大-土城學府,2023-07-25,9822
2374,佳能,17,0,17,元大-土城學府,2023-07-25,9822
2913,農林,15,0,15,元大-土城學府,2023-07-25,9822
3081,聯亞,14,0,14,元大-土城學府,2023-07-25,9822
2356,英業達,42,28,14,元大-土城學府,2023-07-25,9822
3706,神達,23,10,13,元大-土城學府,2023-07-25,9822
5483,中美晶,16,3,13,元大-土城學府,2023-07-25,9822
00922,國泰台灣領袖50,12,0,12,元大-土城學府,2023-07-25,9822
2887,台新金,35,23,12,元大-土城學府,2023-07-25,9822
00715L,期街口布蘭特正2,11,0,11,元大-土城學府,2023-07-25,9822
00632R,元大台灣50反1,31,20,11,元大-土城學府,2023-07-25,9822
2317,鴻海,50,40,10,元大-土城學府,2023-07-25,9822
3702,大聯大,10,0,10,元大-土城學府,2023-07-25,9822
00669R,國泰美國道瓊反1,10,0,10,元大-土城學府,2023-07-25,9822
1301,台塑,10,0,10,元大-土城學府,2023-07-25,9822
1711,永光,10,0,10,元大-土城學府,2023-07-25,9822
2388,威盛,15,5,10,元大-土城學府,2023-07-25,9822
3055,蔚華科,13,3,10,元大-土城學府,2023-07-25,9822
9905,大華,10,0,10,元大-土城學府,2023-07-25,9822
2421,建準,28,18,10,元大-土城學府,2023-07-25,9822
3209,全科,9,0,9,元大-土城學府,2023-07-25,9822
8171,天宇,10,1,9,元大-土城學府,2023-07-25,9822
8210,勤誠,11,2,9,元大-土城學府,2023-07-25,9822
5608,四維航,9,1,8,元大-土城學府,2023-07-25,9822
00850,元大臺灣ESG永續,10,2,8,元大-土城學府,2023-07-25,9822
00722B,群益投資級電信債,8,0,8,元大-土城學府,2023-07-25,9822
00900,富邦特選高股息30,13,5,8,元大-土城學府,2023-07-25,9822
1540,喬福,10,2,8,元大-土城學府,2023-07-25,9822
2486,一詮,10,2,8,元大-土城學府,2023-07-25,9822
2495,普安,10,2,8,元大-土城學府,2023-07-25,9822
3013,晟銘電,48,40,8,元大-土城學府,2023-07-25,9822
4934,太極,8,0,8,元大-土城學府,2023-07-25,9822
1504,東元,115,42,73,元大-土城學府,2023-07-26,9822
2359,所羅門,103,41,62,元大-土城學府,2023-07-26,9822
00929,復華台灣科技優息,55,1,54,元大-土城學府,2023-07-26,9822
00687B,國泰20年美債,50,0,50,元大-土城學府,2023-07-26,9822
00888,永豐台灣ESG,38,0,38,元大-土城學府,2023-07-26,9822
4123,晟德,32,2,30,元大-土城學府,2023-07-26,9822
1616,億泰,30,0,30,元大-土城學府,2023-07-26,9822
2344,華邦電,24,0,24,元大-土城學府,2023-07-26,9822
2515,中工,24,0,24,元大-土城學府,2023-07-26,9822
6112,邁達特,47,25,22,元大-土城學府,2023-07-26,9822
6214,精誠,24,2,22,元大-土城學府,2023-07-26,9822
8289,泰藝,22,0,22,元大-土城學府,2023-07-26,9822
2338,光罩,22,1,21,元大-土城學府,2023-07-26,9822
2883,凱基金,23,3,20,元大-土城學府,2023-07-26,9822
2886,兆豐金,23,3,20,元大-土城學府,2023-07-26,9822
2449,京元電子,22,3,19,元大-土城學府,2023-07-26,9822
2890,永豐金,20,1,19,元大-土城學府,2023-07-26,9822
3013,晟銘電,42,24,18,元大-土城學府,2023-07-26,9822
00772B,中信高評級公司債,16,0,16,元大-土城學府,2023-07-26,9822
6124,業強,16,0,16,元大-土城學府,2023-07-26,9822
00720B,元大投資級公司債,15,0,15,元大-土城學府,2023-07-26,9822
8358,金居,44,30,14,元大-土城學府,2023-07-26,9822
6274,台燿,36,22,14,元大-土城學府,2023-07-26,9822
8016,矽創,13,0,13,元大-土城學府,2023-07-26,9822
00679B,元大美債20年,14,1,13,元大-土城學府,2023-07-26,9822
2303,聯電,36,23,13,元大-土城學府,2023-07-26,9822
3044,健鼎,15,3,12,元大-土城學府,2023-07-26,9822
6125,廣運,15,3,12,元大-土城學府,2023-07-26,9822
1513,中興電,26,14,12,元大-土城學府,2023-07-26,9822
2402,毅嘉,12,1,11,元大-土城學府,2023-07-26,9822
1514,亞力,12,1,11,元大-土城學府,2023-07-26,9822
1608,華榮,11,0,11,元大-土城學府,2023-07-26,9822
2354,鴻準,13,2,11,元大-土城學府,2023-07-26,9822
6275,元山,26,15,11,元大-土城學府,2023-07-26,9822
2337,旺宏,10,0,10,元大-土城學府,2023-07-26,9822
2498,宏達電,10,0,10,元大-土城學府,2023-07-26,9822
00850,元大臺灣ESG永續,10,0,10,元大-土城學府,2023-07-26,9822
00648R,元大S＆P500反1,10,0,10,元大-土城學府,2023-07-26,9822
2455,全新,11,1,10,元大-土城學府,2023-07-26,9822
3380,明泰,11,1,10,元大-土城學府,2023-07-26,9822
6751,智聯服務,10,1,9,元大-土城學府,2023-07-26,9822
1471,首利,10,1,9,元大-土城學府,2023-07-26,9822
4763,材料-KY,9,0,9,元大-土城學府,2023-07-26,9822
00930,永豐ESG低碳高息,9,0,9,元大-土城學府,2023-07-26,9822
00673R,期元大S＆P原油反1,9,0,9,元大-土城學府,2023-07-26,9822
00902,中信電池及儲能,11,2,9,元大-土城學府,2023-07-26,9822
00891,中信關鍵半導體,9,0,9,元大-土城學府,2023-07-26,9822
1907,永豐餘,14,5,9,元大-土城學府,2023-07-26,9822
2027,大成鋼,20,11,9,元大-土城學府,2023-07-26,9822
4168,醣聯,11,2,9,元大-土城學府,2023-07-26,9822
2888,新光金,338,188,150,元大-土城學府,2023-07-27,9822
3481,群創,222,98,124,元大-土城學府,2023-07-27,9822
2887,台新金,111,0,111,元大-土城學府,2023-07-27,9822
00632R,元大台灣50反1,103,0,103,元大-土城學府,2023-07-27,9822
2353,宏��,60,8,52,元大-土城學府,2023-07-27,9822
1314,中石化,50,0,50,元大-土城學府,2023-07-27,9822
00715L,期街口布蘭特正2,49,1,48,元大-土城學府,2023-07-27,9822
00687B,國泰20年美債,48,0,48,元大-土城學府,2023-07-27,9822
00902,中信電池及儲能,42,1,41,元大-土城學府,2023-07-27,9822
2014,中鴻,41,0,41,元大-土城學府,2023-07-27,9822
1618,合機,50,17,33,元大-土城學府,2023-07-27,9822
2891,中信金,33,0,33,元大-土城學府,2023-07-27,9822
5258,虹堡,31,0,31,元大-土城學府,2023-07-27,9822
2405,輔信,30,6,24,元大-土城學府,2023-07-27,9822
1903,士紙,23,1,22,元大-土城學府,2023-07-27,9822
2380,虹光,20,0,20,元大-土城學府,2023-07-27,9822
1710,東聯,23,4,19,元大-土城學府,2023-07-27,9822
2913,農林,32,13,19,元大-土城學府,2023-07-27,9822
2884,玉山金,19,0,19,元大-土城學府,2023-07-27,9822
3037,欣興,44,26,18,元大-土城學府,2023-07-27,9822
1301,台塑,18,0,18,元大-土城學府,2023-07-27,9822
2340,台亞,31,13,18,元大-土城學府,2023-07-27,9822
1528,恩德,13,0,13,元大-土城學府,2023-07-27,9822
6015,宏遠證,26,14,12,元大-土城學府,2023-07-27,9822
1471,首利,13,1,12,元大-土城學府,2023-07-27,9822
6703,軒郁,12,0,12,元大-土城學府,2023-07-27,9822
2324,仁寶,14,3,11,元大-土城學府,2023-07-27,9822
2489,瑞軒,11,0,11,元大-土城學府,2023-07-27,9822
3583,辛耘,12,1,11,元大-土城學府,2023-07-27,9822
4533,協易機,109,98,11,元大-土城學府,2023-07-27,9822
6120,達運,16,5,11,元大-土城學府,2023-07-27,9822
8926,台汽電,11,0,11,元大-土城學府,2023-07-27,9822
00895,富邦未來車,11,1,10,元大-土城學府,2023-07-27,9822
4566,時碩工業,10,0,10,元大-土城學府,2023-07-27,9822
2457,飛宏,11,2,9,元大-土城學府,2023-07-27,9822
2515,中工,9,0,9,元大-土城學府,2023-07-27,9822
3504,揚明光,9,0,9,元大-土城學府,2023-07-27,9822
5351,鈺創,18,9,9,元大-土城學府,2023-07-27,9822
6111,大宇資,15,6,9,元大-土城學府,2023-07-27,9822
2002,中鋼,10,2,8,元大-土城學府,2023-07-27,9822
4532,瑞智,8,0,8,元大-土城學府,2023-07-27,9822
6799,來頡,8,0,8,元大-土城學府,2023-07-27,9822
8478,東哥遊艇,12,4,8,元大-土城學府,2023-07-27,9822
2883,凱基金,25,18,7,元大-土城學府,2023-07-27,9822
2301,光寶科,18,11,7,元大-土城學府,2023-07-27,9822
2461,光群雷,7,0,7,元大-土城學府,2023-07-27,9822
2317,鴻海,8,1,7,元大-土城學府,2023-07-27,9822
00923,群益台ESG低碳50,6,0,6,元大-土城學府,2023-07-27,9822
00885,富邦越南,6,0,6,元大-土城學府,2023-07-27,9822
00893,國泰智能電動車,9,3,6,元大-土城學府,2023-07-27,9822
00687B,國泰20年美債,108,0,108,元大-土城學府,2023-07-28,9822
1909,榮成,100,0,100,元大-土城學府,2023-07-28,9822
2618,長榮航,78,3,75,元大-土城學府,2023-07-28,9822
00632R,元大台灣50反1,58,0,58,元大-土城學府,2023-07-28,9822
00722B,群益投資級電信債,57,0,57,元大-土城學府,2023-07-28,9822
3013,晟銘電,96,41,55,元大-土城學府,2023-07-28,9822
3289,宜特,64,18,46,元大-土城學府,2023-07-28,9822
6290,良維,45,1,44,元大-土城學府,2023-07-28,9822
00929,復華台灣科技優息,40,2,38,元大-土城學府,2023-07-28,9822
2913,農林,171,135,36,元大-土城學府,2023-07-28,9822
3706,神達,37,5,32,元大-土城學府,2023-07-28,9822
00679B,元大美債20年,31,0,31,元大-土城學府,2023-07-28,9822
1618,合機,38,8,30,元大-土城學府,2023-07-28,9822
6282,康舒,49,23,26,元大-土城學府,2023-07-28,9822
1514,亞力,25,1,24,元大-土城學府,2023-07-28,9822
2401,凌陽,26,2,24,元大-土城學府,2023-07-28,9822
00720B,元大投資級公司債,23,0,23,元大-土城學府,2023-07-28,9822
2610,華航,23,1,22,元大-土城學府,2023-07-28,9822
2316,楠梓電,20,0,20,元大-土城學府,2023-07-28,9822
2388,威盛,20,0,20,元大-土城學府,2023-07-28,9822
2845,遠東銀,20,1,19,元大-土城學府,2023-07-28,9822
3264,欣銓,24,5,19,元大-土城學府,2023-07-28,9822
00680L,元大美債20正2,18,0,18,元大-土城學府,2023-07-28,9822
3078,僑威,23,5,18,元大-土城學府,2023-07-28,9822
8076,伍豐,18,0,18,元大-土城學府,2023-07-28,9822
00772B,中信高評級公司債,17,0,17,元大-土城學府,2023-07-28,9822
2027,大成鋼,24,9,15,元大-土城學府,2023-07-28,9822
00712,復華富時不動產,17,2,15,元大-土城學府,2023-07-28,9822
00688L,國泰20年美債正2,13,0,13,元大-土城學府,2023-07-28,9822
4533,協易機,32,19,13,元大-土城學府,2023-07-28,9822
5706,鳳凰,15,3,12,元大-土城學府,2023-07-28,9822
8109,博大,12,0,12,元大-土城學府,2023-07-28,9822
2461,光群雷,11,0,11,元大-土城學府,2023-07-28,9822
1301,台塑,11,0,11,元大-土城學府,2023-07-28,9822
00673R,期元大S＆P原油反1,11,0,11,元大-土城學府,2023-07-28,9822
1711,永光,14,3,11,元大-土城學府,2023-07-28,9822
6657,華安,11,0,11,元大-土城學府,2023-07-28,9822
00706L,期元大S＆P日圓正2,10,0,10,元大-土城學府,2023-07-28,9822
1717,長興,10,0,10,元大-土城學府,2023-07-28,9822
5309,系統電,10,0,10,元大-土城學府,2023-07-28,9822
6026,福邦證,10,0,10,元大-土城學府,2023-07-28,9822
6116,彩晶,10,0,10,元大-土城學府,2023-07-28,9822
3481,群創,77,67,10,元大-土城學府,2023-07-28,9822
00751B,元大AAA至A公司債,9,0,9,元大-土城學府,2023-07-28,9822
3032,偉訓,13,4,9,元大-土城學府,2023-07-28,9822
1904,正隆,11,3,8,元大-土城學府,2023-07-28,9822
3209,全科,8,0,8,元大-土城學府,2023-07-28,9822
6117,迎廣,9,1,8,元大-土城學府,2023-07-28,9822
1802,台玻,23,15,8,元大-土城學府,2023-07-28,9822
2498,宏達電,7,0,7,元大-土城學府,2023-07-28,9822
00878,國泰永續高股息,518,263,255,元大-土城學府,2023-07-31,9822
00929,復華台灣科技優息,130,21,109,元大-土城學府,2023-07-31,9822
1909,榮成,100,0,100,元大-土城學府,2023-07-31,9822
3231,緯創,148,63,85,元大-土城學府,2023-07-31,9822
3481,群創,83,4,79,元大-土城學府,2023-07-31,9822
2405,輔信,73,11,62,元大-土城學府,2023-07-31,9822
2382,廣達,121,69,52,元大-土城學府,2023-07-31,9822
2329,華泰,183,136,47,元大-土城學府,2023-07-31,9822
2425,承啟,60,15,45,元大-土城學府,2023-07-31,9822
2888,新光金,81,36,45,元大-土城學府,2023-07-31,9822
2420,新巨,40,0,40,元大-土城學府,2023-07-31,9822
2618,長榮航,41,3,38,元大-土城學府,2023-07-31,9822
9105,泰金寶-DR,37,0,37,元大-土城學府,2023-07-31,9822
00892,富邦台灣半導體,32,0,32,元大-土城學府,2023-07-31,9822
2609,陽明,49,19,30,元大-土城學府,2023-07-31,9822
2301,光寶科,65,36,29,元大-土城學府,2023-07-31,9822
5284,jpp-KY,60,32,28,元大-土城學府,2023-07-31,9822
3266,昇陽,26,0,26,元大-土城學府,2023-07-31,9822
2409,友達,29,5,24,元大-土城學府,2023-07-31,9822
2855,統一證,31,7,24,元大-土城學府,2023-07-31,9822
00679B,元大美債20年,25,2,23,元大-土城學府,2023-07-31,9822
4979,華星光,28,6,22,元大-土城學府,2023-07-31,9822
1616,億泰,20,0,20,元大-土城學府,2023-07-31,9822
2610,華航,24,4,20,元大-土城學府,2023-07-31,9822
6531,愛普*,26,6,20,元大-土城學府,2023-07-31,9822
2356,英業達,43,23,20,元大-土城學府,2023-07-31,9822
00885,富邦越南,20,1,19,元大-土城學府,2023-07-31,9822
00919,群益台灣精選高息,22,6,16,元大-土城學府,2023-07-31,9822
2809,京城銀,16,0,16,元大-土城學府,2023-07-31,9822
1907,永豐餘,15,0,15,元大-土城學府,2023-07-31,9822
6799,來頡,15,0,15,元大-土城學府,2023-07-31,9822
00687B,國泰20年美債,14,0,14,元大-土城學府,2023-07-31,9822
6609,瀧澤科,14,0,14,元大-土城學府,2023-07-31,9822
2884,玉山金,17,4,13,元大-土城學府,2023-07-31,9822
0050,元大台灣50,19,5,14,元大-土城學府,2023-07-31,9822
6125,廣運,17,4,13,元大-土城學府,2023-07-31,9822
2104,國際中橡,13,0,13,元大-土城學府,2023-07-31,9822
2201,裕隆,16,3,13,元大-土城學府,2023-07-31,9822
2317,鴻海,16,4,12,元大-土城學府,2023-07-31,9822
00680L,元大美債20正2,22,10,12,元大-土城學府,2023-07-31,9822
2316,楠梓電,11,0,11,元大-土城學府,2023-07-31,9822
2542,興富發,11,0,11,元大-土城學府,2023-07-31,9822
00715L,期街口布蘭特正2,11,0,11,元大-土城學府,2023-07-31,9822
2323,中環,11,0,11,元大-土城學府,2023-07-31,9822
6117,迎廣,11,0,11,元大-土城學府,2023-07-31,9822
2457,飛宏,14,4,10,元大-土城學府,2023-07-31,9822
2603,長榮,22,12,10,元大-土城學府,2023-07-31,9822
00646,元大S＆P500,10,0,10,元大-土城學府,2023-07-31,9822
5515,建國,10,0,10,元大-土城學府,2023-07-31,9822
5521,工信,10,0,10,元大-土城學府,2023-07-31,9822
00929,復華台灣科技優息,110,5,105,元大-土城學府,2023-08-01,9822
3062,建漢,82,0,82,元大-土城學府,2023-08-01,9822
6282,康舒,107,29,78,元大-土城學府,2023-08-01,9822
00923,群益台ESG低碳50,58,0,58,元大-土城學府,2023-08-01,9822
00632R,元大台灣50反1,31,0,31,元大-土城學府,2023-08-01,9822
2855,統一證,36,5,31,元大-土城學府,2023-08-01,9822
3032,偉訓,33,4,29,元大-土城學府,2023-08-01,9822
2022,聚亨,26,0,26,元大-土城學府,2023-08-01,9822
5521,工信,25,0,25,元大-土城學府,2023-08-01,9822
6609,瀧澤科,25,0,25,元大-土城學府,2023-08-01,9822
2363,矽統,29,6,23,元大-土城學府,2023-08-01,9822
2356,英業達,31,9,22,元大-土城學府,2023-08-01,9822
6223,旺矽,21,0,21,元大-土城學府,2023-08-01,9822
2420,新巨,20,0,20,元大-土城學府,2023-08-01,9822
4510,高鋒,20,0,20,元大-土城學府,2023-08-01,9822
2425,承啟,22,3,19,元大-土城學府,2023-08-01,9822
00773B,中信優先金融債,19,3,16,元大-土城學府,2023-08-01,9822
2353,宏��,46,31,15,元大-土城學府,2023-08-01,9822
00772B,中信高評級公司債,15,0,15,元大-土城學府,2023-08-01,9822
1711,永光,18,3,15,元大-土城學府,2023-08-01,9822
3583,辛耘,18,3,15,元大-土城學府,2023-08-01,9822
1806,冠軍,15,2,13,元大-土城學府,2023-08-01,9822
2419,仲琦,16,3,13,元大-土城學府,2023-08-01,9822
8027,鈦昇,22,9,13,元大-土城學府,2023-08-01,9822
2634,漢翔,26,14,12,元大-土城學府,2023-08-01,9822
2891,中信金,12,0,12,元大-土城學府,2023-08-01,9822
2427,三商電,12,1,11,元大-土城學府,2023-08-01,9822
6756,威鋒電子,11,0,11,元大-土城學府,2023-08-01,9822
3530,晶相光,10,0,10,元大-土城學府,2023-08-01,9822
00680L,元大美債20正2,10,0,10,元大-土城學府,2023-08-01,9822
00720B,元大投資級公司債,10,0,10,元大-土城學府,2023-08-01,9822
1218,泰山,10,0,10,元大-土城學府,2023-08-01,9822
1308,亞聚,10,0,10,元大-土城學府,2023-08-01,9822
1616,億泰,10,0,10,元大-土城學府,2023-08-01,9822
1717,長興,10,0,10,元大-土城學府,2023-08-01,9822
2020,美亞,10,0,10,元大-土城學府,2023-08-01,9822
2809,京城銀,10,0,10,元大-土城學府,2023-08-01,9822
2301,光寶科,41,32,9,元大-土城學府,2023-08-01,9822
2368,金像電,12,3,9,元大-土城學府,2023-08-01,9822
3596,智易,9,0,9,元大-土城學府,2023-08-01,9822
00922,國泰台灣領袖50,8,0,8,元大-土城學府,2023-08-01,9822
2313,華通,9,1,8,元大-土城學府,2023-08-01,9822
8215,明基材,9,1,8,元大-土城學府,2023-08-01,9822
1905,華紙,20,13,7,元大-土城學府,2023-08-01,9822
2329,華泰,21,14,7,元大-土城學府,2023-08-01,9822
2409,友達,13,6,7,元大-土城學府,2023-08-01,9822
2637,慧洋-KY,8,1,7,元大-土城學府,2023-08-01,9822
3217,優群,9,2,7,元大-土城學府,2023-08-01,9822
6176,瑞儀,8,1,7,元大-土城學府,2023-08-01,9822
5388,中磊,15,8,7,元大-土城學府,2023-08-01,9822
00929,復華台灣科技優息,136,5,131,元大-土城學府,2023-08-02,9822
2353,宏��,198,68,130,元大-土城學府,2023-08-02,9822
2618,長榮航,106,3,103,元大-土城學府,2023-08-02,9822
2014,中鴻,109,10,99,元大-土城學府,2023-08-02,9822
00687B,國泰20年美債,90,0,90,元大-土城學府,2023-08-02,9822
2301,光寶科,97,15,82,元大-土城學府,2023-08-02,9822
3231,緯創,160,85,75,元大-土城學府,2023-08-02,9822
3163,波若威,81,18,63,元大-土城學府,2023-08-02,9822
00900,富邦特選高股息30,80,20,60,元大-土城學府,2023-08-02,9822
6282,康舒,58,16,42,元大-土城學府,2023-08-02,9822
8105,凌巨,40,0,40,元大-土城學府,2023-08-02,9822
2855,統一證,34,0,34,元大-土城學府,2023-08-02,9822
00712,復華富時不動產,33,1,32,元大-土城學府,2023-08-02,9822
00679B,元大美債20年,29,0,29,元大-土城學府,2023-08-02,9822
00907,永豐優息存股,24,0,24,元大-土城學府,2023-08-02,9822
2002,中鋼,23,0,23,元大-土城學府,2023-08-02,9822
2402,毅嘉,97,74,23,元大-土城學府,2023-08-02,9822
6609,瀧澤科,22,0,22,元大-土城學府,2023-08-02,9822
3209,全科,21,0,21,元大-土城學府,2023-08-02,9822
2344,華邦電,22,1,21,元大-土城學府,2023-08-02,9822
1514,亞力,20,0,20,元大-土城學府,2023-08-02,9822
1904,正隆,21,1,20,元大-土城學府,2023-08-02,9822
2420,新巨,20,0,20,元大-土城學府,2023-08-02,9822
6285,啟��,41,21,20,元大-土城學府,2023-08-02,9822
1616,億泰,18,0,18,元大-土城學府,2023-08-02,9822
9945,潤泰新,16,0,16,元大-土城學府,2023-08-02,9822
3035,智原,16,0,16,元大-土城學府,2023-08-02,9822
2312,金寶,28,12,16,元大-土城學府,2023-08-02,9822
00885,富邦越南,30,15,15,元大-土城學府,2023-08-02,9822
2308,台達電,28,14,14,元大-土城學府,2023-08-02,9822
00923,群益台ESG低碳50,14,0,14,元大-土城學府,2023-08-02,9822
6538,倉和,18,4,14,元大-土城學府,2023-08-02,9822
3576,聯合再生,14,0,14,元大-土城學府,2023-08-02,9822
00772B,中信高評級公司債,13,0,13,元大-土城學府,2023-08-02,9822
00720B,元大投資級公司債,13,0,13,元大-土城學府,2023-08-02,9822
00673R,期元大S＆P原油反1,15,2,13,元大-土城學府,2023-08-02,9822
1905,華紙,55,42,13,元大-土城學府,2023-08-02,9822
2884,玉山金,17,4,13,元大-土城學府,2023-08-02,9822
2382,廣達,79,68,11,元大-土城學府,2023-08-02,9822
00751B,元大AAA至A公司債,11,0,11,元大-土城學府,2023-08-02,9822
6274,台燿,14,3,11,元大-土城學府,2023-08-02,9822
1303,南亞,10,0,10,元大-土城學府,2023-08-02,9822
3583,辛耘,23,13,10,元大-土城學府,2023-08-02,9822
00688L,國泰20年美債正2,10,0,10,元大-土城學府,2023-08-02,9822
5465,富驊,10,0,10,元大-土城學府,2023-08-02,9822
3711,日月光投控,9,0,9,元大-土城學府,2023-08-02,9822
00715L,期街口布蘭特正2,9,0,9,元大-土城學府,2023-08-02,9822
00773B,中信優先金融債,9,0,9,元大-土城學府,2023-08-02,9822
2425,承啟,12,3,9,元大-土城學府,2023-08-02,9822
6005,群益證,9,0,9,元大-土城學府,2023-08-02,9822
00878,國泰永續高股息,193,64,129,元大-土城學府,2023-08-04,9822
00929,復華台灣科技優息,74,0,74,元大-土城學府,2023-08-04,9822
00687B,國泰20年美債,64,0,64,元大-土城學府,2023-08-04,9822
00679B,元大美債20年,64,1,63,元大-土城學府,2023-08-04,9822
00680L,元大美債20正2,60,5,55,元大-土城學府,2023-08-04,9822
00900,富邦特選高股息30,50,1,49,元大-土城學府,2023-08-04,9822
6219,富旺,40,0,40,元大-土城學府,2023-08-04,9822
2344,華邦電,46,9,37,元大-土城學府,2023-08-04,9822
1616,億泰,43,6,37,元大-土城學府,2023-08-04,9822
1605,華新,37,4,33,元大-土城學府,2023-08-04,9822
00772B,中信高評級公司債,32,0,32,元大-土城學府,2023-08-04,9822
00919,群益台灣精選高息,32,0,32,元大-土城學府,2023-08-04,9822
2913,農林,111,80,31,元大-土城學府,2023-08-04,9822
2356,英業達,80,49,31,元大-土城學府,2023-08-04,9822
1609,大亞,52,22,30,元大-土城學府,2023-08-04,9822
1717,長興,30,0,30,元大-土城學府,2023-08-04,9822
3013,晟銘電,30,0,30,元大-土城學府,2023-08-04,9822
1785,光洋科,32,3,29,元大-土城學府,2023-08-04,9822
00795B,中信美國公債20年,27,0,27,元大-土城學府,2023-08-04,9822
2609,陽明,29,2,27,元大-土城學府,2023-08-04,9822
00751B,元大AAA至A公司債,26,0,26,元大-土城學府,2023-08-04,9822
2498,宏達電,25,0,25,元大-土城學府,2023-08-04,9822
6538,倉和,27,2,25,元大-土城學府,2023-08-04,9822
00923,群益台ESG低碳50,24,0,24,元大-土城學府,2023-08-04,9822
00773B,中信優先金融債,23,0,23,元大-土城學府,2023-08-04,9822
4746,台耀,28,6,22,元大-土城學府,2023-08-04,9822
3231,緯創,159,139,20,元大-土城學府,2023-08-04,9822
2883B,凱基金乙特,20,0,20,元大-土城學府,2023-08-04,9822
2303,聯電,36,18,18,元大-土城學府,2023-08-04,9822
00722B,群益投資級電信債,54,36,18,元大-土城學府,2023-08-04,9822
2883,凱基金,17,1,16,元大-土城學府,2023-08-04,9822
4533,協易機,19,3,16,元大-土城學府,2023-08-04,9822
2891,中信金,30,14,16,元大-土城學府,2023-08-04,9822
5443,均豪,13,0,13,元大-土城學府,2023-08-04,9822
2888,新光金,19,7,12,元大-土城學府,2023-08-04,9822
00720B,元大投資級公司債,13,2,11,元大-土城學府,2023-08-04,9822
1319,東陽,11,0,11,元大-土城學府,2023-08-04,9822
00688L,國泰20年美債正2,11,0,11,元大-土城學府,2023-08-04,9822
2374,佳能,11,0,11,元大-土城學府,2023-08-04,9822
2885,元大金,11,0,11,元大-土城學府,2023-08-04,9822
5490,同亨,10,0,10,元大-土城學府,2023-08-04,9822
3707,漢磊,10,0,10,元大-土城學府,2023-08-04,9822
5388,中磊,12,2,10,元大-土城學府,2023-08-04,9822
2382,廣達,77,68,9,元大-土城學府,2023-08-04,9822
6148,驊宏資,10,1,9,元大-土城學府,2023-08-04,9822
5871,中租-KY,10,1,9,元大-土城學府,2023-08-04,9822
1504,東元,11,3,8,元大-土城學府,2023-08-04,9822
1608,華榮,14,6,8,元大-土城學府,2023-08-04,9822
3711,日月光投控,8,0,8,元大-土城學府,2023-08-04,9822
3706,神達,16,8,8,元大-土城學府,2023-08-04,9822
2913,農林,103,6,97,元大-土城學府,2023-08-07,9822
00929,復華台灣科技優息,72,17,55,元大-土城學府,2023-08-07,9822
2855,統一證,39,3,36,元大-土城學府,2023-08-07,9822
2891,中信金,53,18,35,元大-土城學府,2023-08-07,9822
00679B,元大美債20年,34,4,30,元大-土城學府,2023-08-07,9822
3163,波若威,35,8,27,元大-土城學府,2023-08-07,9822
6538,倉和,25,0,25,元大-土城學府,2023-08-07,9822
00900,富邦特選高股息30,22,0,22,元大-土城學府,2023-08-07,9822
2610,華航,32,11,21,元大-土城學府,2023-08-07,9822
3679,新至陞,19,0,19,元大-土城學府,2023-08-07,9822
3035,智原,21,3,18,元大-土城學府,2023-08-07,9822
8038,長園科,18,0,18,元大-土城學府,2023-08-07,9822
00680L,元大美債20正2,16,0,16,元大-土城學府,2023-08-07,9822
00931B,統一美債20年,15,0,15,元大-土城學府,2023-08-07,9822
00923,群益台ESG低碳50,14,0,14,元大-土城學府,2023-08-07,9822
2618,長榮航,56,43,13,元大-土城學府,2023-08-07,9822
3305,昇貿,12,0,12,元大-土城學府,2023-08-07,9822
8092,建暐,12,0,12,元大-土城學府,2023-08-07,9822
2352,佳世達,27,16,11,元大-土城學府,2023-08-07,9822
0056,元大高股息,49,38,11,元大-土城學府,2023-08-07,9822
2382,廣達,89,79,10,元大-土城學府,2023-08-07,9822
2303,聯電,11,1,10,元大-土城學府,2023-08-07,9822
1711,永光,12,2,10,元大-土城學府,2023-08-07,9822
2388,威盛,16,6,10,元大-土城學府,2023-08-07,9822
2461,光群雷,10,0,10,元大-土城學府,2023-08-07,9822
2883,凱基金,10,0,10,元大-土城學府,2023-08-07,9822
4746,台耀,14,4,10,元大-土城學府,2023-08-07,9822
5521,工信,10,0,10,元大-土城學府,2023-08-07,9822
6219,富旺,10,0,10,元大-土城學府,2023-08-07,9822
00720B,元大投資級公司債,10,1,9,元大-土城學府,2023-08-07,9822
2002,中鋼,12,3,9,元大-土城學府,2023-08-07,9822
1727,中華化,11,2,9,元大-土城學府,2023-08-07,9822
2316,楠梓電,12,3,9,元大-土城學府,2023-08-07,9822
2634,漢翔,14,5,9,元大-土城學府,2023-08-07,9822
3325,旭品,12,3,9,元大-土城學府,2023-08-07,9822
6148,驊宏資,10,1,9,元大-土城學府,2023-08-07,9822
8109,博大,10,1,9,元大-土城學府,2023-08-07,9822
3037,欣興,10,1,9,元大-土城學府,2023-08-07,9822
8390,金益鼎,10,1,9,元大-土城學府,2023-08-07,9822
1514,亞力,8,0,8,元大-土城學府,2023-08-07,9822
1795,美時,8,0,8,元大-土城學府,2023-08-07,9822
2867,三商壽,8,0,8,元大-土城學府,2023-08-07,9822
6117,迎廣,10,2,8,元大-土城學府,2023-08-07,9822
00751B,元大AAA至A公司債,7,0,7,元大-土城學府,2023-08-07,9822
2504,國產,8,1,7,元大-土城學府,2023-08-07,9822
6016,康和證,7,0,7,元大-土城學府,2023-08-07,9822
00673R,期元大S＆P原油反1,6,0,6,元大-土城學府,2023-08-07,9822
00706L,期元大S＆P日圓正2,6,0,6,元大-土城學府,2023-08-07,9822
00637L,元大滬深300正2,6,0,6,元大-土城學府,2023-08-07,9822
00928,中信上櫃ESG30,6,0,6,元大-土城學府,2023-08-07,9822
00929,復華台灣科技優息,218,0,218,元大-土城學府,2023-08-08,9822
2834,臺企銀,117,0,117,元大-土城學府,2023-08-08,9822
2356,英業達,151,79,72,元大-土城學府,2023-08-08,9822
2890,永豐金,68,1,67,元大-土城學府,2023-08-08,9822
2303,聯電,99,34,65,元大-土城學府,2023-08-08,9822
3163,波若威,70,9,61,元大-土城學府,2023-08-08,9822
3481,群創,64,9,55,元大-土城學府,2023-08-08,9822
3706,神達,85,45,40,元大-土城學府,2023-08-08,9822
6125,廣運,51,16,35,元大-土城學府,2023-08-08,9822
00900,富邦特選高股息30,33,1,32,元大-土城學府,2023-08-08,9822
00923,群益台ESG低碳50,31,0,31,元大-土城學府,2023-08-08,9822
0056,元大高股息,35,9,26,元大-土城學府,2023-08-08,9822
1319,東陽,28,3,25,元大-土城學府,2023-08-08,9822
2301,光寶科,55,32,23,元大-土城學府,2023-08-08,9822
00931B,統一美債20年,23,0,23,元大-土城學府,2023-08-08,9822
8109,博大,23,0,23,元大-土城學府,2023-08-08,9822
2891,中信金,22,0,22,元大-土城學府,2023-08-08,9822
6282,康舒,37,15,22,元大-土城學府,2023-08-08,9822
2542,興富發,19,0,19,元大-土城學府,2023-08-08,9822
2312,金寶,20,5,15,元大-土城學府,2023-08-08,9822
2354,鴻準,15,0,15,元大-土城學府,2023-08-08,9822
2388,威盛,26,11,15,元大-土城學府,2023-08-08,9822
3363,上詮,23,9,14,元大-土城學府,2023-08-08,9822
1905,華紙,18,4,14,元大-土城學府,2023-08-08,9822
00928,中信上櫃ESG30,14,0,14,元大-土城學府,2023-08-08,9822
6150,撼訊,14,0,14,元大-土城學府,2023-08-08,9822
3231,緯創,115,101,14,元大-土城學府,2023-08-08,9822
2038,海光,13,0,13,元大-土城學府,2023-08-08,9822
2352,佳世達,16,3,13,元大-土城學府,2023-08-08,9822
2883,凱基金,13,0,13,元大-土城學府,2023-08-08,9822
1504,東元,13,0,13,元大-土城學府,2023-08-08,9822
2337,旺宏,14,2,12,元大-土城學府,2023-08-08,9822
3325,旭品,19,7,12,元大-土城學府,2023-08-08,9822
00722B,群益投資級電信債,11,0,11,元大-土城學府,2023-08-08,9822
2801,彰銀,11,0,11,元大-土城學府,2023-08-08,9822
8038,長園科,11,0,11,元大-土城學府,2023-08-08,9822
1234,黑松,10,0,10,元大-土城學府,2023-08-08,9822
1336,台翰,10,0,10,元大-土城學府,2023-08-08,9822
2881,富邦金,12,2,10,元大-土城學府,2023-08-08,9822
2344,華邦電,9,0,9,元大-土城學府,2023-08-08,9822
5483,中美晶,9,0,9,元大-土城學府,2023-08-08,9822
2316,楠梓電,11,2,9,元大-土城學府,2023-08-08,9822
2929,淘帝-KY,10,1,9,元大-土城學府,2023-08-08,9822
3504,揚明光,9,0,9,元大-土城學府,2023-08-08,9822
1717,長興,8,0,8,元大-土城學府,2023-08-08,9822
2367,燿華,8,0,8,元大-土城學府,2023-08-08,9822
5452,佶優,17,9,8,元大-土城學府,2023-08-08,9822
6770,力積電,11,3,8,元大-土城學府,2023-08-08,9822
00720B,元大投資級公司債,8,0,8,元大-土城學府,2023-08-08,9822
2330,台積電,8,1,7,元大-土城學府,2023-08-08,9822
00929,復華台灣科技優息,180,1,179,元大-土城學府,2023-08-09,9822
00878,國泰永續高股息,79,18,61,元大-土城學府,2023-08-09,9822
6125,廣運,59,7,52,元大-土城學府,2023-08-09,9822
2023,燁輝,52,2,50,元大-土城學府,2023-08-09,9822
6418,詠昇,50,0,50,元大-土城學府,2023-08-09,9822
2303,聯電,46,0,46,元大-土城學府,2023-08-09,9822
3363,上詮,46,0,46,元大-土城學府,2023-08-09,9822
00900,富邦特選高股息30,43,0,43,元大-土城學府,2023-08-09,9822
2382,廣達,100,69,31,元大-土城學府,2023-08-09,9822
2634,漢翔,31,7,24,元大-土城學府,2023-08-09,9822
3260,威剛,25,3,22,元大-土城學府,2023-08-09,9822
1608,華榮,20,0,20,元大-土城學府,2023-08-09,9822
5864,致和證,20,0,20,元大-土城學府,2023-08-09,9822
1905,華紙,23,4,19,元大-土城學府,2023-08-09,9822
3231,緯創,115,98,17,元大-土城學府,2023-08-09,9822
00712,復華富時不動產,16,0,16,元大-土城學府,2023-08-09,9822
2002,中鋼,16,0,16,元大-土城學府,2023-08-09,9822
2415,錩新,15,1,14,元大-土城學府,2023-08-09,9822
3481,群創,15,2,13,元大-土城學府,2023-08-09,9822
0056,元大高股息,25,12,13,元大-土城學府,2023-08-09,9822
00923,群益台ESG低碳50,19,7,12,元大-土城學府,2023-08-09,9822
4760,勤凱,12,0,12,元大-土城學府,2023-08-09,9822
5469,瀚宇博,12,0,12,元大-土城學府,2023-08-09,9822
2313,華通,12,0,12,元大-土城學府,2023-08-09,9822
6282,康舒,18,6,12,元大-土城學府,2023-08-09,9822
2855,統一證,11,0,11,元大-土城學府,2023-08-09,9822
6203,海韻電,11,0,11,元大-土城學府,2023-08-09,9822
8201,無敵,11,0,11,元大-土城學府,2023-08-09,9822
00931B,統一美債20年,10,0,10,元大-土城學府,2023-08-09,9822
2312,金寶,20,10,10,元大-土城學府,2023-08-09,9822
3703,欣陸,10,0,10,元大-土城學府,2023-08-09,9822
8109,博大,10,0,10,元大-土城學府,2023-08-09,9822
00885,富邦越南,15,6,9,元大-土城學府,2023-08-09,9822
1605,華新,12,3,9,元大-土城學府,2023-08-09,9822
2605,新興,9,0,9,元大-土城學府,2023-08-09,9822
3078,僑威,13,5,8,元大-土城學府,2023-08-09,9822
5210,寶碩,8,0,8,元大-土城學府,2023-08-09,9822
2344,華邦電,7,0,7,元大-土城學府,2023-08-09,9822
3045,台灣大,7,0,7,元大-土城學府,2023-08-09,9822
2356,英業達,32,25,7,元大-土城學府,2023-08-09,9822
00632R,元大台灣50反1,11,4,7,元大-土城學府,2023-08-09,9822
1503,士電,7,0,7,元大-土城學府,2023-08-09,9822
5880,合庫金,7,0,7,元大-土城學府,2023-08-09,9822
6120,達運,7,0,7,元大-土城學府,2023-08-09,9822
2891,中信金,7,1,6,元大-土城學府,2023-08-09,9822
1217,愛之味,6,0,6,元大-土城學府,2023-08-09,9822
1603,華電,6,0,6,元大-土城學府,2023-08-09,9822
3055,蔚華科,9,3,6,元大-土城學府,2023-08-09,9822
3504,揚明光,7,1,6,元大-土城學府,2023-08-09,9822
6129,普誠,9,3,6,元大-土城學府,2023-08-09,9822
9105,泰金寶-DR,500,0,500,元大-土城學府,2023-08-10,9822
00929,復華台灣科技優息,170,6,164,元大-土城學府,2023-08-10,9822
2845,遠東銀,103,0,103,元大-土城學府,2023-08-10,9822
2382,廣達,117,47,70,元大-土城學府,2023-08-10,9822
8942,森鉅,61,0,61,元大-土城學府,2023-08-10,9822
00786B,元大10年IG銀行債,50,0,50,元大-土城學府,2023-08-10,9822
00919,群益台灣精選高息,45,0,45,元大-土城學府,2023-08-10,9822
00923,群益台ESG低碳50,41,1,40,元大-土城學府,2023-08-10,9822
6125,廣運,53,13,40,元大-土城學府,2023-08-10,9822
00722B,群益投資級電信債,34,0,34,元大-土城學府,2023-08-10,9822
2353,宏��,35,3,32,元大-土城學府,2023-08-10,9822
3032,偉訓,33,2,31,元大-土城學府,2023-08-10,9822
2515,中工,30,0,30,元大-土城學府,2023-08-10,9822
2890,永豐金,30,0,30,元大-土城學府,2023-08-10,9822
3037,欣興,27,1,26,元大-土城學府,2023-08-10,9822
2408,南亞科,25,0,25,元大-土城學府,2023-08-10,9822
2324,仁寶,25,2,23,元大-土城學府,2023-08-10,9822
2610,華航,84,62,22,元大-土城學府,2023-08-10,9822
1909,榮成,21,0,21,元大-土城學府,2023-08-10,9822
6282,康舒,46,25,21,元大-土城學府,2023-08-10,9822
1802,台玻,32,12,20,元大-土城學府,2023-08-10,9822
3231,緯創,121,103,18,元大-土城學府,2023-08-10,9822
2425,承啟,18,0,18,元大-土城學府,2023-08-10,9822
3360,尚立,18,0,18,元大-土城學府,2023-08-10,9822
2312,金寶,20,3,17,元大-土城學府,2023-08-10,9822
006208,富邦台50,18,1,17,元大-土城學府,2023-08-10,9822
2356,英業達,44,28,16,元大-土城學府,2023-08-10,9822
5452,佶優,18,3,15,元大-土城學府,2023-08-10,9822
6116,彩晶,15,1,14,元大-土城學府,2023-08-10,9822
2855,統一證,13,0,13,元大-土城學府,2023-08-10,9822
3576,聯合再生,12,0,12,元大-土城學府,2023-08-10,9822
2329,華泰,15,3,12,元大-土城學府,2023-08-10,9822
00680L,元大美債20正2,31,20,11,元大-土城學府,2023-08-10,9822
1609,大亞,16,5,11,元大-土城學府,2023-08-10,9822
2314,台揚,11,0,11,元大-土城學府,2023-08-10,9822
4958,臻鼎-KY,12,1,11,元大-土城學府,2023-08-10,9822
5213,亞昕,11,0,11,元大-土城學府,2023-08-10,9822
6120,達運,15,4,11,元大-土城學府,2023-08-10,9822
3583,辛耘,31,21,10,元大-土城學府,2023-08-10,9822
4938,和碩,10,0,10,元大-土城學府,2023-08-10,9822
1513,中興電,26,16,10,元大-土城學府,2023-08-10,9822
00665L,富邦�琤肭磪囓�2,10,0,10,元大-土城學府,2023-08-10,9822
00676R,富邦臺灣加權反1,10,0,10,元大-土城學府,2023-08-10,9822
00904,新光臺灣半導體30,10,0,10,元大-土城學府,2023-08-10,9822
2023,燁輝,10,0,10,元大-土城學府,2023-08-10,9822
2460,建通,10,0,10,元大-土城學府,2023-08-10,9822
2615,萬海,10,0,10,元大-土城學府,2023-08-10,9822
3526,凡甲,11,1,10,元大-土城學府,2023-08-10,9822
5521,工信,20,10,10,元大-土城學府,2023-08-10,9822
6220,岳豐,10,0,10,元大-土城學府,2023-08-10,9822
00664R,國泰臺灣加權反1,100,0,100,元大-土城學府,2023-08-11,9822
00929,復華台灣科技優息,50,0,50,元大-土城學府,2023-08-11,9822
3024,憶聲,50,0,50,元大-土城學府,2023-08-11,9822
00900,富邦特選高股息30,48,0,48,元大-土城學府,2023-08-11,9822
6672,騰輝電子-KY,42,1,41,元大-土城學府,2023-08-11,9822
2363,矽統,89,54,35,元大-土城學府,2023-08-11,9822
00687B,國泰20年美債,28,0,28,元大-土城學府,2023-08-11,9822
00680L,元大美債20正2,27,0,27,元大-土城學府,2023-08-11,9822
3231,緯創,95,68,27,元大-土城學府,2023-08-11,9822
00772B,中信高評級公司債,26,0,26,元大-土城學府,2023-08-11,9822
8942,森鉅,25,0,25,元大-土城學府,2023-08-11,9822
1402,遠東新,25,0,25,元大-土城學府,2023-08-11,9822
2883,凱基金,34,10,24,元大-土城學府,2023-08-11,9822
00751B,元大AAA至A公司債,23,0,23,元大-土城學府,2023-08-11,9822
2892,第一金,22,0,22,元大-土城學府,2023-08-11,9822
00923,群益台ESG低碳50,22,0,22,元大-土城學府,2023-08-11,9822
00931B,統一美債20年,23,2,21,元大-土城學府,2023-08-11,9822
2618,長榮航,134,113,21,元大-土城學府,2023-08-11,9822
2881,富邦金,21,1,20,元大-土城學府,2023-08-11,9822
3163,波若威,26,6,20,元大-土城學府,2023-08-11,9822
2356,英業達,61,41,20,元大-土城學府,2023-08-11,9822
6770,力積電,20,0,20,元大-土城學府,2023-08-11,9822
2915,潤泰全,19,0,19,元大-土城學府,2023-08-11,9822
2374,佳能,17,0,17,元大-土城學府,2023-08-11,9822
1514,亞力,17,2,15,元大-土城學府,2023-08-11,9822
2515,中工,15,0,15,元大-土城學府,2023-08-11,9822
3032,偉訓,16,1,15,元大-土城學府,2023-08-11,9822
6456,GIS-KY,15,0,15,元大-土城學府,2023-08-11,9822
2886,兆豐金,13,0,13,元大-土城學府,2023-08-11,9822
00673R,期元大S＆P原油反1,12,0,12,元大-土城學府,2023-08-11,9822
2913,農林,14,2,12,元大-土城學府,2023-08-11,9822
3360,尚立,12,0,12,元大-土城學府,2023-08-11,9822
2801,彰銀,11,0,11,元大-土城學府,2023-08-11,9822
1319,東陽,11,0,11,元大-土城學府,2023-08-11,9822
6274,台燿,10,0,10,元大-土城學府,2023-08-11,9822
2891,中信金,11,1,10,元大-土城學府,2023-08-11,9822
3045,台灣大,10,0,10,元大-土城學府,2023-08-11,9822
3526,凡甲,10,0,10,元大-土城學府,2023-08-11,9822
5469,瀚宇博,9,0,9,元大-土城學府,2023-08-11,9822
1609,大亞,13,4,9,元大-土城學府,2023-08-11,9822
2303,聯電,10,2,8,元大-土城學府,2023-08-11,9822
00706L,期元大S＆P日圓正2,8,0,8,元大-土城學府,2023-08-11,9822
6191,精成科,9,1,8,元大-土城學府,2023-08-11,9822
8155,博智,8,0,8,元大-土城學府,2023-08-11,9822
8050,廣積,22,15,7,元大-土城學府,2023-08-11,9822
00882,中信中國高股息,7,0,7,元大-土城學府,2023-08-11,9822
2317,鴻海,13,6,7,元大-土城學府,2023-08-11,9822
1710,東聯,7,0,7,元大-土城學府,2023-08-11,9822
2022,聚亨,7,0,7,元大-土城學府,2023-08-11,9822
2313,華通,7,0,7,元大-土城學府,2023-08-11,9822
00929,復華台灣科技優息,182,0,182,元大-土城學府,2023-08-14,9822
00878,國泰永續高股息,196,21,175,元大-土城學府,2023-08-14,9822
00882,中信中國高股息,83,2,81,元大-土城學府,2023-08-14,9822
2610,華航,64,4,60,元大-土城學府,2023-08-14,9822
00900,富邦特選高股息30,58,1,57,元大-土城學府,2023-08-14,9822
00637L,元大滬深300正2,53,1,52,元大-土城學府,2023-08-14,9822
2317,鴻海,51,7,44,元大-土城學府,2023-08-14,9822
2303,聯電,40,1,39,元大-土城學府,2023-08-14,9822
6285,啟��,41,10,31,元大-土城學府,2023-08-14,9822
2356,英業達,69,40,29,元大-土城學府,2023-08-14,9822
00772B,中信高評級公司債,27,0,27,元大-土城學府,2023-08-14,9822
00923,群益台ESG低碳50,25,0,25,元大-土城學府,2023-08-14,9822
2301,光寶科,43,18,25,元大-土城學府,2023-08-14,9822
2705,六福,25,0,25,元大-土城學府,2023-08-14,9822
00919,群益台灣精選高息,24,1,23,元大-土城學府,2023-08-14,9822
00679B,元大美債20年,22,0,22,元大-土城學府,2023-08-14,9822
00888,永豐台灣ESG,20,1,19,元大-土城學府,2023-08-14,9822
2374,佳能,18,0,18,元大-土城學府,2023-08-14,9822
0050,元大台灣50,25,7,18,元大-土城學府,2023-08-14,9822
3163,波若威,27,11,16,元大-土城學府,2023-08-14,9822
2344,華邦電,19,3,16,元大-土城學府,2023-08-14,9822
2409,友達,15,0,15,元大-土城學府,2023-08-14,9822
2892,第一金,22,7,15,元大-土城學府,2023-08-14,9822
00902,中信電池及儲能,15,0,15,元大-土城學府,2023-08-14,9822
2014,中鴻,15,1,14,元大-土城學府,2023-08-14,9822
6770,力積電,20,6,14,元大-土城學府,2023-08-14,9822
9945,潤泰新,15,1,14,元大-土城學府,2023-08-14,9822
020038,元大ESG配息N,13,0,13,元大-土城學府,2023-08-14,9822
4766,南寶,13,0,13,元大-土城學府,2023-08-14,9822
00665L,富邦�琤肭磪囓�2,12,0,12,元大-土城學府,2023-08-14,9822
2401,凌陽,12,0,12,元大-土城學府,2023-08-14,9822
6288,聯嘉,12,0,12,元大-土城學府,2023-08-14,9822
1717,長興,11,0,11,元大-土城學府,2023-08-14,9822
1734,杏輝,11,0,11,元大-土城學府,2023-08-14,9822
2337,旺宏,11,0,11,元大-土城學府,2023-08-14,9822
2855,統一證,12,1,11,元大-土城學府,2023-08-14,9822
4533,協易機,45,34,11,元大-土城學府,2023-08-14,9822
6125,廣運,22,11,11,元大-土城學府,2023-08-14,9822
6282,康舒,13,3,10,元大-土城學府,2023-08-14,9822
1608,華榮,10,0,10,元大-土城學府,2023-08-14,9822
2888,新光金,10,0,10,元大-土城學府,2023-08-14,9822
3029,零壹,10,0,10,元大-土城學府,2023-08-14,9822
3360,尚立,10,0,10,元大-土城學府,2023-08-14,9822
5519,隆大,10,0,10,元大-土城學府,2023-08-14,9822
1712,興農,10,0,10,元大-土城學府,2023-08-14,9822
006208,富邦台50,9,0,9,元大-土城學府,2023-08-14,9822
0056,元大高股息,36,27,9,元大-土城學府,2023-08-14,9822
2002,中鋼,9,0,9,元大-土城學府,2023-08-14,9822
4934,太極,9,0,9,元大-土城學府,2023-08-14,9822
6223,旺矽,11,2,9,元大-土城學府,2023-08-14,9822
2883,凱基金,237,0,237,元大-土城學府,2023-08-15,9822
00929,復華台灣科技優息,207,8,199,元大-土城學府,2023-08-15,9822
2324,仁寶,282,87,195,元大-土城學府,2023-08-15,9822
00923,群益台ESG低碳50,157,0,157,元大-土城學府,2023-08-15,9822
00900,富邦特選高股息30,159,4,155,元大-土城學府,2023-08-15,9822
2317,鴻海,64,1,63,元大-土城學府,2023-08-15,9822
00907,永豐優息存股,45,0,45,元大-土城學府,2023-08-15,9822
6284,佳邦,37,0,37,元大-土城學府,2023-08-15,9822
00687B,國泰20年美債,36,0,36,元大-土城學府,2023-08-15,9822
2356,英業達,78,49,29,元大-土城學府,2023-08-15,9822
3481,群創,29,5,24,元大-土城學府,2023-08-15,9822
00795B,中信美國公債20年,20,0,20,元大-土城學府,2023-08-15,9822
2022,聚亨,40,20,20,元大-土城學府,2023-08-15,9822
2887,台新金,18,0,18,元大-土城學府,2023-08-15,9822
4916,事欣科,18,0,18,元大-土城學府,2023-08-15,9822
1609,大亞,24,6,18,元大-土城學府,2023-08-15,9822
00902,中信電池及儲能,17,0,17,元大-土城學府,2023-08-15,9822
2834,臺企銀,16,0,16,元大-土城學府,2023-08-15,9822
6609,瀧澤科,15,0,15,元大-土城學府,2023-08-15,9822
00706L,期元大S＆P日圓正2,14,0,14,元大-土城學府,2023-08-15,9822
3679,新至陞,13,0,13,元大-土城學府,2023-08-15,9822
2027,大成鋼,12,0,12,元大-土城學府,2023-08-15,9822
2801,彰銀,13,2,11,元大-土城學府,2023-08-15,9822
3078,僑威,27,16,11,元大-土城學府,2023-08-15,9822
8044,網家,11,0,11,元大-土城學府,2023-08-15,9822
2892,第一金,11,0,11,元大-土城學府,2023-08-15,9822
2891,中信金,10,0,10,元大-土城學府,2023-08-15,9822
5483,中美晶,10,0,10,元大-土城學府,2023-08-15,9822
2885,元大金,10,0,10,元大-土城學府,2023-08-15,9822
00673R,期元大S＆P原油反1,10,0,10,元大-土城學府,2023-08-15,9822
00712,復華富時不動產,11,1,10,元大-土城學府,2023-08-15,9822
1201,味全,10,0,10,元大-土城學府,2023-08-15,9822
1217,愛之味,10,0,10,元大-土城學府,2023-08-15,9822
1727,中華化,10,0,10,元大-土城學府,2023-08-15,9822
2884,玉山金,9,0,9,元大-土城學府,2023-08-15,9822
00930,永豐ESG低碳高息,9,0,9,元大-土城學府,2023-08-15,9822
2316,楠梓電,11,2,9,元大-土城學府,2023-08-15,9822
2618,長榮航,62,53,9,元大-土城學府,2023-08-15,9822
00679B,元大美債20年,17,9,8,元大-土城學府,2023-08-15,9822
2002,中鋼,8,0,8,元大-土城學府,2023-08-15,9822
2888,新光金,9,1,8,元大-土城學府,2023-08-15,9822
6285,啟��,10,2,8,元大-土城學府,2023-08-15,9822
2206,三陽工業,8,1,7,元大-土城學府,2023-08-15,9822
6114,久威,15,8,7,元大-土城學府,2023-08-15,9822
6116,彩晶,7,0,7,元大-土城學府,2023-08-15,9822
2615,萬海,7,0,7,元大-土城學府,2023-08-15,9822
0050,元大台灣50,9,3,6,元大-土城學府,2023-08-15,9822
5871,中租-KY,7,1,6,元大-土城學府,2023-08-15,9822
00931B,統一美債20年,6,0,6,元大-土城學府,2023-08-15,9822
2103,台橡,6,0,6,元大-土城學府,2023-08-15,9822
00878,國泰永續高股息,567,39,528,元大-土城學府,2023-08-16,9822
2303,聯電,242,70,172,元大-土城學府,2023-08-16,9822
00923,群益台ESG低碳50,89,0,89,元大-土城學府,2023-08-16,9822
2363,矽統,107,34,73,元大-土城學府,2023-08-16,9822
00929,復華台灣科技優息,62,4,58,元大-土城學府,2023-08-16,9822
2867,三商壽,31,0,31,元大-土城學府,2023-08-16,9822
3037,欣興,38,8,30,元大-土城學府,2023-08-16,9822
2324,仁寶,62,33,29,元大-土城學府,2023-08-16,9822
2884,玉山金,38,13,25,元大-土城學府,2023-08-16,9822
6284,佳邦,25,0,25,元大-土城學府,2023-08-16,9822
00687B,國泰20年美債,22,0,22,元大-土城學府,2023-08-16,9822
00795B,中信美國公債20年,22,0,22,元大-土城學府,2023-08-16,9822
00753L,中信中國50正2,21,0,21,元大-土城學府,2023-08-16,9822
2610,華航,28,8,20,元大-土城學府,2023-08-16,9822
5287,數字,19,0,19,元大-土城學府,2023-08-16,9822
2317,鴻海,19,0,19,元大-土城學府,2023-08-16,9822
00772B,中信高評級公司債,18,0,18,元大-土城學府,2023-08-16,9822
00712,復華富時不動產,17,0,17,元大-土城學府,2023-08-16,9822
2615,萬海,22,5,17,元大-土城學府,2023-08-16,9822
2881,富邦金,16,0,16,元大-土城學府,2023-08-16,9822
00931B,統一美債20年,18,3,15,元大-土城學府,2023-08-16,9822
4933,友輝,15,0,15,元大-土城學府,2023-08-16,9822
0050,元大台灣50,22,8,14,元大-土城學府,2023-08-16,9822
1514,亞力,14,0,14,元大-土城學府,2023-08-16,9822
9945,潤泰新,12,0,12,元大-土城學府,2023-08-16,9822
00679B,元大美債20年,12,0,12,元大-土城學府,2023-08-16,9822
2323,中環,12,0,12,元大-土城學府,2023-08-16,9822
2332,友訊,14,2,12,元大-土城學府,2023-08-16,9822
2834,臺企銀,23,11,12,元大-土城學府,2023-08-16,9822
2891,中信金,31,19,12,元大-土城學府,2023-08-16,9822
4766,南寶,12,0,12,元大-土城學府,2023-08-16,9822
1101,台泥,13,1,12,元大-土城學府,2023-08-16,9822
2885,元大金,16,5,11,元大-土城學府,2023-08-16,9822
2002,中鋼,11,0,11,元大-土城學府,2023-08-16,9822
3679,新至陞,11,0,11,元大-土城學府,2023-08-16,9822
3481,群創,12,1,11,元大-土城學府,2023-08-16,9822
3163,波若威,13,2,11,元大-土城學府,2023-08-16,9822
2344,華邦電,10,0,10,元大-土城學府,2023-08-16,9822
1319,東陽,11,1,10,元大-土城學府,2023-08-16,9822
1402,遠東新,10,0,10,元大-土城學府,2023-08-16,9822
2022,聚亨,10,0,10,元大-土城學府,2023-08-16,9822
2618,長榮航,87,77,10,元大-土城學府,2023-08-16,9822
2892,第一金,10,1,9,元大-土城學府,2023-08-16,9822
2887,台新金,10,1,9,元大-土城學府,2023-08-16,9822
00680L,元大美債20正2,9,0,9,元大-土城學府,2023-08-16,9822
2731,雄獅,10,1,9,元大-土城學府,2023-08-16,9822
6770,力積電,12,3,9,元大-土城學府,2023-08-16,9822
00891,中信關鍵半導體,15,6,9,元大-土城學府,2023-08-16,9822
8358,金居,15,7,8,元大-土城學府,2023-08-16,9822
00720B,元大投資級公司債,8,0,8,元大-土城學府,2023-08-16,9822
00929,復華台灣科技優息,124,5,119,元大-土城學府,2023-08-17,9822
2329,華泰,117,11,106,元大-土城學府,2023-08-17,9822
00772B,中信高評級公司債,64,0,64,元大-土城學府,2023-08-17,9822
00878,國泰永續高股息,85,23,62,元大-土城學府,2023-08-17,9822
2303,聯電,123,64,59,元大-土城學府,2023-08-17,9822
2881,富邦金,60,2,58,元大-土城學府,2023-08-17,9822
2888,新光金,42,0,42,元大-土城學府,2023-08-17,9822
00687B,國泰20年美債,42,0,42,元大-土城學府,2023-08-17,9822
00923,群益台ESG低碳50,48,11,37,元大-土城學府,2023-08-17,9822
2409,友達,28,3,25,元大-土城學府,2023-08-17,9822
3231,緯創,94,70,24,元大-土城學府,2023-08-17,9822
2885,元大金,28,4,24,元大-土城學府,2023-08-17,9822
2002,中鋼,20,0,20,元大-土城學府,2023-08-17,9822
00712,復華富時不動產,32,12,20,元大-土城學府,2023-08-17,9822
2891,中信金,25,5,20,元大-土城學府,2023-08-17,9822
2324,仁寶,94,75,19,元大-土城學府,2023-08-17,9822
3056,富華新,16,0,16,元大-土城學府,2023-08-17,9822
2801,彰銀,15,0,15,元大-土城學府,2023-08-17,9822
1301,台塑,15,1,14,元大-土城學府,2023-08-17,9822
2887,台新金,16,2,14,元大-土城學府,2023-08-17,9822
6753,龍德造船,14,0,14,元大-土城學府,2023-08-17,9822
2609,陽明,21,8,13,元大-土城學府,2023-08-17,9822
00773B,中信優先金融債,13,0,13,元大-土城學府,2023-08-17,9822
2855,統一證,13,0,13,元大-土城學府,2023-08-17,9822
6125,廣運,35,22,13,元大-土城學府,2023-08-17,9822
00888,永豐台灣ESG,12,0,12,元大-土城學府,2023-08-17,9822
00753L,中信中國50正2,12,0,12,元大-土城學府,2023-08-17,9822
4154,樂威科-KY,11,0,11,元大-土城學府,2023-08-17,9822
6203,海韻電,22,11,11,元大-土城學府,2023-08-17,9822
00706L,期元大S＆P日圓正2,10,0,10,元大-土城學府,2023-08-17,9822
00673R,期元大S＆P原油反1,10,0,10,元大-土城學府,2023-08-17,9822
1471,首利,13,3,10,元大-土城學府,2023-08-17,9822
3689,湧德,26,16,10,元大-土城學府,2023-08-17,9822
6237,驊訊,10,0,10,元大-土城學府,2023-08-17,9822
1101,台泥,24,14,10,元大-土城學府,2023-08-17,9822
00795B,中信美國公債20年,9,0,9,元大-土城學府,2023-08-17,9822
6770,力積電,11,2,9,元大-土城學府,2023-08-17,9822
00902,中信電池及儲能,8,0,8,元大-土城學府,2023-08-17,9822
00679B,元大美債20年,8,0,8,元大-土城學府,2023-08-17,9822
2615,萬海,8,0,8,元大-土城學府,2023-08-17,9822
3043,科風,8,0,8,元大-土城學府,2023-08-17,9822
2880,華南金,8,0,8,元大-土城學府,2023-08-17,9822
00722B,群益投資級電信債,7,0,7,元大-土城學府,2023-08-17,9822
2834,臺企銀,7,0,7,元大-土城學府,2023-08-17,9822
2884,玉山金,13,6,7,元大-土城學府,2023-08-17,9822
5388,中磊,7,0,7,元大-土城學府,2023-08-17,9822
6122,擎邦,7,0,7,元大-土城學府,2023-08-17,9822
2388,威盛,13,7,6,元大-土城學府,2023-08-17,9822
2419,仲琦,13,7,6,元大-土城學府,2023-08-17,9822
2820,華票,6,0,6,元大-土城學府,2023-08-17,9822
00929,復華台灣科技優息,141,2,139,元大-土城學府,2023-08-18,9822
2301,光寶科,81,30,51,元大-土城學府,2023-08-18,9822
00878,國泰永續高股息,61,19,42,元大-土城學府,2023-08-18,9822
2363,矽統,100,59,41,元大-土城學府,2023-08-18,9822
00712,復華富時不動產,56,20,36,元大-土城學府,2023-08-18,9822
00913,兆豐台灣晶圓製造,30,0,30,元大-土城學府,2023-08-18,9822
4113,聯上,29,1,28,元大-土城學府,2023-08-18,9822
6203,海韻電,27,0,27,元大-土城學府,2023-08-18,9822
3056,富華新,41,16,25,元大-土城學府,2023-08-18,9822
2302,麗正,25,0,25,元大-土城學府,2023-08-18,9822
2324,仁寶,88,63,25,元大-土城學府,2023-08-18,9822
6284,佳邦,25,0,25,元大-土城學府,2023-08-18,9822
2402,毅嘉,53,30,23,元大-土城學府,2023-08-18,9822
4164,承業醫,21,0,21,元大-土城學府,2023-08-18,9822
00751B,元大AAA至A公司債,20,0,20,元大-土城學府,2023-08-18,9822
00885,富邦越南,21,2,19,元大-土城學府,2023-08-18,9822
3035,智原,29,10,19,元大-土城學府,2023-08-18,9822
00893,國泰智能電動車,17,0,17,元大-土城學府,2023-08-18,9822
2356,英業達,54,37,17,元大-土城學府,2023-08-18,9822
00772B,中信高評級公司債,16,0,16,元大-土城學府,2023-08-18,9822
2883,凱基金,17,2,15,元大-土城學府,2023-08-18,9822
3231,緯創,130,115,15,元大-土城學府,2023-08-18,9822
2323,中環,14,1,13,元大-土城學府,2023-08-18,9822
2891,中信金,13,1,12,元大-土城學府,2023-08-18,9822
00888,永豐台灣ESG,12,0,12,元大-土城學府,2023-08-18,9822
1611,中電,12,0,12,元大-土城學府,2023-08-18,9822
2425,承啟,14,2,12,元大-土城學府,2023-08-18,9822
00882,中信中國高股息,15,4,11,元大-土城學府,2023-08-18,9822
6125,廣運,16,5,11,元大-土城學府,2023-08-18,9822
2881,富邦金,12,1,11,元大-土城學府,2023-08-18,9822
00900,富邦特選高股息30,17,7,10,元大-土城學府,2023-08-18,9822
00892,富邦台灣半導體,10,0,10,元大-土城學府,2023-08-18,9822
00753L,中信中國50正2,10,0,10,元大-土城學府,2023-08-18,9822
1612,宏泰,10,0,10,元大-土城學府,2023-08-18,9822
2417,圓剛,10,0,10,元大-土城學府,2023-08-18,9822
2481,強茂,10,0,10,元大-土城學府,2023-08-18,9822
3711,日月光投控,10,0,10,元大-土城學府,2023-08-18,9822
5907,大洋-KY,10,0,10,元大-土城學府,2023-08-18,9822
5483,中美晶,10,0,10,元大-土城學府,2023-08-18,9822
2618,長榮航,48,39,9,元大-土城學府,2023-08-18,9822
00679B,元大美債20年,9,0,9,元大-土城學府,2023-08-18,9822
2312,金寶,9,0,9,元大-土城學府,2023-08-18,9822
2892,第一金,9,0,9,元大-土城學府,2023-08-18,9822
2637,慧洋-KY,16,7,9,元大-土城學府,2023-08-18,9822
3363,上詮,22,14,8,元大-土城學府,2023-08-18,9822
3685,元創精密,8,0,8,元大-土城學府,2023-08-18,9822
2353,宏��,9,2,7,元大-土城學府,2023-08-18,9822
00713,元大台灣高息低波,7,0,7,元大-土城學府,2023-08-18,9822
2419,仲琦,7,0,7,元大-土城學府,2023-08-18,9822
2634,漢翔,11,4,7,元大-土城學府,2023-08-18,9822
00929,復華台灣科技優息,271,0,271,元大-土城學府,2023-08-21,9822
2618,長榮航,123,16,107,元大-土城學府,2023-08-21,9822
00715L,期街口布蘭特正2,45,1,44,元大-土城學府,2023-08-21,9822
2329,華泰,75,33,42,元大-土城學府,2023-08-21,9822
3306,鼎天,38,5,33,元大-土城學府,2023-08-21,9822
00632R,元大台灣50反1,42,11,31,元大-土城學府,2023-08-21,9822
2892,第一金,29,0,29,元大-土城學府,2023-08-21,9822
6170,統振,30,2,28,元大-土城學府,2023-08-21,9822
2421,建準,41,18,23,元大-土城學府,2023-08-21,9822
00753L,中信中國50正2,21,0,21,元大-土城學府,2023-08-21,9822
2301,光寶科,50,31,19,元大-土城學府,2023-08-21,9822
00751B,元大AAA至A公司債,18,0,18,元大-土城學府,2023-08-21,9822
00687B,國泰20年美債,16,0,16,元大-土城學府,2023-08-21,9822
00882,中信中國高股息,23,7,16,元大-土城學府,2023-08-21,9822
2888,新光金,16,0,16,元大-土城學府,2023-08-21,9822
00679B,元大美債20年,17,2,15,元大-土城學府,2023-08-21,9822
2891,中信金,16,1,15,元大-土城學府,2023-08-21,9822
2353,宏��,27,12,15,元大-土城學府,2023-08-21,9822
6116,彩晶,16,2,14,元大-土城學府,2023-08-21,9822
2610,華航,16,2,14,元大-土城學府,2023-08-21,9822
2324,仁寶,25,12,13,元大-土城學府,2023-08-21,9822
6139,亞翔,13,0,13,元大-土城學府,2023-08-21,9822
2606,裕民,13,2,11,元大-土城學府,2023-08-21,9822
1303,南亞,11,0,11,元大-土城學府,2023-08-21,9822
8069,元太,11,0,11,元大-土城學府,2023-08-21,9822
00892,富邦台灣半導體,11,0,11,元大-土城學府,2023-08-21,9822
5864,致和證,11,0,11,元大-土城學府,2023-08-21,9822
00665L,富邦�琤肭磪囓�2,10,0,10,元大-土城學府,2023-08-21,9822
1314,中石化,10,0,10,元大-土城學府,2023-08-21,9822
6156,松上,11,1,10,元大-土城學府,2023-08-21,9822
6274,台燿,10,0,10,元大-土城學府,2023-08-21,9822
0050,元大台灣50,11,1,10,元大-土城學府,2023-08-21,9822
00772B,中信高評級公司債,9,0,9,元大-土城學府,2023-08-21,9822
2855,統一證,9,0,9,元大-土城學府,2023-08-21,9822
2330,台積電,10,1,9,元大-土城學府,2023-08-21,9822
2881,富邦金,10,2,8,元大-土城學府,2023-08-21,9822
4543,萬在,8,0,8,元大-土城學府,2023-08-21,9822
4906,正文,12,4,8,元大-土城學府,2023-08-21,9822
2886,兆豐金,8,1,7,元大-土城學府,2023-08-21,9822
2885,元大金,9,2,7,元大-土城學府,2023-08-21,9822
2359,所羅門,8,1,7,元大-土城學府,2023-08-21,9822
2374,佳能,10,3,7,元大-土城學府,2023-08-21,9822
2419,仲琦,15,8,7,元大-土城學府,2023-08-21,9822
3706,神達,14,7,7,元大-土城學府,2023-08-21,9822
6117,迎廣,8,1,7,元大-土城學府,2023-08-21,9822
1513,中興電,12,6,6,元大-土城學府,2023-08-21,9822
2402,毅嘉,7,1,6,元大-土城學府,2023-08-21,9822
2515,中工,6,0,6,元大-土城學府,2023-08-21,9822
2913,農林,6,0,6,元大-土城學府,2023-08-21,9822
00919,群益台灣精選高息,6,1,5,元大-土城學府,2023-08-21,9822
2618,長榮航,209,144,65,元大-土城學府,2023-08-22,9822
6117,迎廣,71,8,63,元大-土城學府,2023-08-22,9822
2881,富邦金,61,0,61,元大-土城學府,2023-08-22,9822
00929,復華台灣科技優息,50,0,50,元大-土城學府,2023-08-22,9822
2344,華邦電,54,5,49,元大-土城學府,2023-08-22,9822
2329,華泰,50,12,38,元大-土城學府,2023-08-22,9822
2705,六福,37,0,37,元大-土城學府,2023-08-22,9822
3583,辛耘,42,5,37,元大-土城學府,2023-08-22,9822
6284,佳邦,30,0,30,元大-土城學府,2023-08-22,9822
00772B,中信高評級公司債,30,3,27,元大-土城學府,2023-08-22,9822
3325,旭品,26,2,24,元大-土城學府,2023-08-22,9822
2890,永豐金,23,0,23,元大-土城學府,2023-08-22,9822
00679B,元大美債20年,22,0,22,元大-土城學府,2023-08-22,9822
00878,國泰永續高股息,29,7,22,元大-土城學府,2023-08-22,9822
2324,仁寶,43,22,21,元大-土城學府,2023-08-22,9822
2421,建準,40,21,19,元大-土城學府,2023-08-22,9822
2498,宏達電,17,1,16,元大-土城學府,2023-08-22,9822
1584,精剛,16,0,16,元大-土城學府,2023-08-22,9822
2891,中信金,18,2,16,元大-土城學府,2023-08-22,9822
2637,慧洋-KY,18,3,15,元大-土城學府,2023-08-22,9822
1513,中興電,15,1,14,元大-土城學府,2023-08-22,9822
3346,麗清,13,0,13,元大-土城學府,2023-08-22,9822
00882,中信中國高股息,12,0,12,元大-土城學府,2023-08-22,9822
6108,競國,14,2,12,元大-土城學府,2023-08-22,9822
6285,啟��,13,1,12,元大-土城學府,2023-08-22,9822
2449,京元電子,26,14,12,元大-土城學府,2023-08-22,9822
00751B,元大AAA至A公司債,11,0,11,元大-土城學府,2023-08-22,9822
6235,華孚,23,12,11,元大-土城學府,2023-08-22,9822
1101,台泥,11,0,11,元大-土城學府,2023-08-22,9822
2201,裕隆,11,0,11,元大-土城學府,2023-08-22,9822
5452,佶優,18,7,11,元大-土城學府,2023-08-22,9822
3056,富華新,23,13,10,元大-土城學府,2023-08-22,9822
00892,富邦台灣半導體,10,0,10,元大-土城學府,2023-08-22,9822
1612,宏泰,10,0,10,元大-土城學府,2023-08-22,9822
1727,中華化,10,0,10,元大-土城學府,2023-08-22,9822
2363,矽統,67,57,10,元大-土城學府,2023-08-22,9822
2634,漢翔,18,8,10,元大-土城學府,2023-08-22,9822
3308,聯德,11,1,10,元大-土城學府,2023-08-22,9822
00885,富邦越南,29,19,10,元大-土城學府,2023-08-22,9822
2417,圓剛,10,0,10,元大-土城學府,2023-08-22,9822
5608,四維航,13,4,9,元大-土城學府,2023-08-22,9822
2405,輔信,9,0,9,元大-土城學府,2023-08-22,9822
2472,立隆電,9,0,9,元大-土城學府,2023-08-22,9822
2317,鴻海,8,0,8,元大-土城學府,2023-08-22,9822
2883,凱基金,8,0,8,元大-土城學府,2023-08-22,9822
2323,中環,10,2,8,元大-土城學府,2023-08-22,9822
3051,力特,25,17,8,元大-土城學府,2023-08-22,9822
6579,研揚,14,6,8,元大-土城學府,2023-08-22,9822
2002,中鋼,7,0,7,元大-土城學府,2023-08-22,9822
2314,台揚,7,0,7,元大-土城學府,2023-08-22,9822
2301,光寶科,107,28,79,元大-土城學府,2023-08-23,9822
2618,長榮航,85,43,42,元大-土城學府,2023-08-23,9822
00773B,中信優先金融債,40,0,40,元大-土城學府,2023-08-23,9822
2359,所羅門,35,0,35,元大-土城學府,2023-08-23,9822
2543,皇昌,27,0,27,元大-土城學府,2023-08-23,9822
2329,華泰,37,12,25,元大-土城學府,2023-08-23,9822
3071,協禧,30,6,24,元大-土城學府,2023-08-23,9822
2610,華航,29,7,22,元大-土城學府,2023-08-23,9822
6282,康舒,32,12,20,元大-土城學府,2023-08-23,9822
00902,中信電池及儲能,18,0,18,元大-土城學府,2023-08-23,9822
2702,華園,18,0,18,元大-土城學府,2023-08-23,9822
4766,南寶,18,0,18,元大-土城學府,2023-08-23,9822
6284,佳邦,17,0,17,元大-土城學府,2023-08-23,9822
00929,復華台灣科技優息,78,62,16,元大-土城學府,2023-08-23,9822
5880,合庫金,16,0,16,元大-土城學府,2023-08-23,9822
3231,緯創,41,28,13,元大-土城學府,2023-08-23,9822
2883,凱基金,11,0,11,元大-土城學府,2023-08-23,9822
00712,復華富時不動產,16,5,11,元大-土城學府,2023-08-23,9822
2316,楠梓電,17,6,11,元大-土城學府,2023-08-23,9822
5236,凌陽創新,11,0,11,元大-土城學府,2023-08-23,9822
8034,榮群,18,7,11,元大-土城學府,2023-08-23,9822
3078,僑威,11,1,10,元大-土城學府,2023-08-23,9822
1301,台塑,10,0,10,元大-土城學府,2023-08-23,9822
1760,寶齡富錦,10,0,10,元大-土城學府,2023-08-23,9822
3041,揚智,10,0,10,元大-土城學府,2023-08-23,9822
3163,波若威,16,6,10,元大-土城學府,2023-08-23,9822
4123,晟德,12,2,10,元大-土城學府,2023-08-23,9822
2615,萬海,8,0,8,元大-土城學府,2023-08-23,9822
00892,富邦台灣半導體,15,7,8,元大-土城學府,2023-08-23,9822
1471,首利,14,6,8,元大-土城學府,2023-08-23,9822
2485,兆赫,12,4,8,元大-土城學府,2023-08-23,9822
2884,玉山金,10,2,8,元大-土城學府,2023-08-23,9822
2606,裕民,10,3,7,元大-土城學府,2023-08-23,9822
5371,中光電,8,1,7,元大-土城學府,2023-08-23,9822
00919,群益台灣精選高息,7,0,7,元大-土城學府,2023-08-23,9822
2415,錩新,7,0,7,元大-土城學府,2023-08-23,9822
2382,廣達,33,26,7,元大-土城學府,2023-08-23,9822
6257,矽格,7,1,6,元大-土城學府,2023-08-23,9822
3715,定穎投控,35,29,6,元大-土城學府,2023-08-23,9822
4746,台耀,6,0,6,元大-土城學府,2023-08-23,9822
5452,佶優,10,4,6,元大-土城學府,2023-08-23,9822
6117,迎廣,21,16,5,元大-土城學府,2023-08-23,9822
00795B,中信美國公債20年,5,0,5,元大-土城學府,2023-08-23,9822
2390,云辰,5,0,5,元大-土城學府,2023-08-23,9822
2402,毅嘉,9,4,5,元大-土城學府,2023-08-23,9822
2527,宏璟,5,0,5,元大-土城學府,2023-08-23,9822
2886,兆豐金,5,0,5,元大-土城學府,2023-08-23,9822
6216,居易,5,0,5,元大-土城學府,2023-08-23,9822
8076,伍豐,5,0,5,元大-土城學府,2023-08-23,9822
1101,台泥,4,0,4,元大-土城學府,2023-08-23,9822
00919,群益台灣精選高息,73,0,73,元大-土城學府,2023-08-24,9822
3231,緯創,142,95,47,元大-土城學府,2023-08-24,9822
2317,鴻海,59,12,47,元大-土城學府,2023-08-24,9822
1313,聯成,40,0,40,元大-土城學府,2023-08-24,9822
2615,萬海,41,2,39,元大-土城學府,2023-08-24,9822
2329,華泰,89,53,36,元大-土城學府,2023-08-24,9822
2421,建準,55,24,31,元大-土城學府,2023-08-24,9822
1402,遠東新,30,0,30,元大-土城學府,2023-08-24,9822
2363,矽統,127,100,27,元大-土城學府,2023-08-24,9822
2543,皇昌,24,0,24,元大-土城學府,2023-08-24,9822
2316,楠梓電,25,2,23,元大-土城學府,2023-08-24,9822
00895,富邦未來車,24,3,21,元大-土城學府,2023-08-24,9822
00893,國泰智能電動車,38,17,21,元大-土城學府,2023-08-24,9822
2367,燿華,24,3,21,元大-土城學府,2023-08-24,9822
6531,愛普*,22,2,20,元大-土城學府,2023-08-24,9822
1217,愛之味,20,0,20,元大-土城學府,2023-08-24,9822
1718,中纖,20,0,20,元大-土城學府,2023-08-24,9822
2449,京元電子,43,23,20,元大-土城學府,2023-08-24,9822
3311,閎暉,20,0,20,元大-土城學府,2023-08-24,9822
3706,神達,31,13,18,元大-土城學府,2023-08-24,9822
3715,定穎投控,47,29,18,元大-土城學府,2023-08-24,9822
2353,宏��,28,11,17,元大-土城學府,2023-08-24,9822
8467,波力-KY,20,4,16,元大-土城學府,2023-08-24,9822
00907,永豐優息存股,15,0,15,元大-土城學府,2023-08-24,9822
2314,台揚,20,5,15,元大-土城學府,2023-08-24,9822
3071,協禧,16,1,15,元大-土城學府,2023-08-24,9822
9919,康那香,19,4,15,元大-土城學府,2023-08-24,9822
2883,凱基金,14,0,14,元大-土城學府,2023-08-24,9822
00712,復華富時不動產,15,1,14,元大-土城學府,2023-08-24,9822
00931B,統一美債20年,13,0,13,元大-土城學府,2023-08-24,9822
6274,台燿,19,6,13,元大-土城學府,2023-08-24,9822
00888,永豐台灣ESG,12,0,12,元大-土城學府,2023-08-24,9822
3078,僑威,13,1,12,元大-土城學府,2023-08-24,9822
2913,農林,22,10,12,元大-土城學府,2023-08-24,9822
2356,英業達,81,70,11,元大-土城學府,2023-08-24,9822
00900,富邦特選高股息30,11,0,11,元大-土城學府,2023-08-24,9822
6167,久正,11,0,11,元大-土城學府,2023-08-24,9822
2495,普安,10,0,10,元大-土城學府,2023-08-24,9822
3021,鴻名,13,3,10,元大-土城學府,2023-08-24,9822
4157,太景*-KY,10,0,10,元大-土城學府,2023-08-24,9822
5864,致和證,10,0,10,元大-土城學府,2023-08-24,9822
6462,神盾,10,0,10,元大-土城學府,2023-08-24,9822
1737,臺鹽,10,0,10,元大-土城學府,2023-08-24,9822
00679B,元大美債20年,10,1,9,元大-土城學府,2023-08-24,9822
2609,陽明,13,4,9,元大-土城學府,2023-08-24,9822
2402,毅嘉,16,7,9,元大-土城學府,2023-08-24,9822
2498,宏達電,8,0,8,元大-土城學府,2023-08-24,9822
3596,智易,10,2,8,元大-土城學府,2023-08-24,9822
2399,映泰,10,3,7,元大-土城學府,2023-08-24,9822
00929,復華台灣科技優息,55,48,7,元大-土城學府,2023-08-24,9822
2485,兆赫,153,37,116,元大-土城學府,2023-08-25,9822
00878,國泰永續高股息,114,3,111,元大-土城學府,2023-08-25,9822
3231,緯創,140,34,106,元大-土城學府,2023-08-25,9822
2867,三商壽,98,0,98,元大-土城學府,2023-08-25,9822
00919,群益台灣精選高息,69,2,67,元大-土城學府,2023-08-25,9822
2353,宏��,103,44,59,元大-土城學府,2023-08-25,9822
2382,廣達,77,40,37,元大-土城學府,2023-08-25,9822
2634,漢翔,82,47,35,元大-土城學府,2023-08-25,9822
6170,統振,63,30,33,元大-土城學府,2023-08-25,9822
6284,佳邦,32,0,32,元大-土城學府,2023-08-25,9822
2303,聯電,31,0,31,元大-土城學府,2023-08-25,9822
3021,鴻名,30,4,26,元大-土城學府,2023-08-25,9822
00900,富邦特選高股息30,22,0,22,元大-土城學府,2023-08-25,9822
2356,英業達,49,27,22,元大-土城學府,2023-08-25,9822
2301,光寶科,32,12,20,元大-土城學府,2023-08-25,9822
3037,欣興,41,22,19,元大-土城學府,2023-08-25,9822
00929,復華台灣科技優息,27,10,17,元大-土城學府,2023-08-25,9822
2609,陽明,19,3,16,元大-土城學府,2023-08-25,9822
2884,玉山金,15,0,15,元大-土城學府,2023-08-25,9822
00923,群益台ESG低碳50,14,0,14,元大-土城學府,2023-08-25,9822
2363,矽統,161,147,14,元大-土城學府,2023-08-25,9822
2618,長榮航,56,43,13,元大-土城學府,2023-08-25,9822
1802,台玻,14,1,13,元大-土城學府,2023-08-25,9822
2330,台積電,13,1,12,元大-土城學府,2023-08-25,9822
2891,中信金,12,0,12,元大-土城學府,2023-08-25,9822
00893,國泰智能電動車,14,2,12,元大-土城學府,2023-08-25,9822
00772B,中信高評級公司債,11,0,11,元大-土城學府,2023-08-25,9822
00850,元大臺灣ESG永續,10,0,10,元大-土城學府,2023-08-25,9822
00907,永豐優息存股,9,0,9,元大-土城學府,2023-08-25,9822
2369,菱生,10,1,9,元大-土城學府,2023-08-25,9822
2892,第一金,9,0,9,元大-土城學府,2023-08-25,9822
00922,國泰台灣領袖50,8,0,8,元大-土城學府,2023-08-25,9822
2610,華航,17,9,8,元大-土城學府,2023-08-25,9822
2419,仲琦,12,5,7,元大-土城學府,2023-08-25,9822
5475,德宏,7,0,7,元大-土城學府,2023-08-25,9822
8033,雷虎,9,2,7,元大-土城學府,2023-08-25,9822
2002,中鋼,7,0,7,元大-土城學府,2023-08-25,9822
0050,元大台灣50,7,1,6,元大-土城學府,2023-08-25,9822
1210,大成,6,0,6,元大-土城學府,2023-08-25,9822
2025,千興,6,0,6,元大-土城學府,2023-08-25,9822
2495,普安,6,0,6,元大-土城學府,2023-08-25,9822
3444,利機,6,0,6,元大-土城學府,2023-08-25,9822
2323,中環,8,3,5,元大-土城學府,2023-08-25,9822
2880,華南金,5,0,5,元大-土城學府,2023-08-25,9822
00895,富邦未來車,5,0,5,元大-土城學府,2023-08-25,9822
00632R,元大台灣50反1,5,0,5,元大-土城學府,2023-08-25,9822
1513,中興電,5,0,5,元大-土城學府,2023-08-25,9822
2344,華邦電,11,6,5,元大-土城學府,2023-08-25,9822
2486,一詮,5,0,5,元大-土城學府,2023-08-25,9822
2543,皇昌,5,0,5,元大-土城學府,2023-08-25,9822
00919,群益台灣精選高息,135,1,134,元大-土城學府,2023-08-28,9822
00929,復華台灣科技優息,71,2,69,元大-土城學府,2023-08-28,9822
3206,志豐,58,0,58,元大-土城學府,2023-08-28,9822
2382,廣達,94,42,52,元大-土城學府,2023-08-28,9822
9105,泰金寶-DR,52,0,52,元大-土城學府,2023-08-28,9822
4906,正文,67,24,43,元大-土城學府,2023-08-28,9822
2380,虹光,28,2,26,元大-土城學府,2023-08-28,9822
3037,欣興,26,2,24,元大-土城學府,2023-08-28,9822
2332,友訊,28,6,22,元大-土城學府,2023-08-28,9822
00878,國泰永續高股息,33,11,22,元大-土城學府,2023-08-28,9822
1217,愛之味,22,0,22,元大-土城學府,2023-08-28,9822
3021,鴻名,21,0,21,元大-土城學府,2023-08-28,9822
3051,力特,34,15,19,元大-土城學府,2023-08-28,9822
1737,臺鹽,26,8,18,元大-土城學府,2023-08-28,9822
1471,首利,26,9,17,元大-土城學府,2023-08-28,9822
2610,華航,16,3,13,元大-土城學府,2023-08-28,9822
2485,兆赫,36,24,12,元大-土城學府,2023-08-28,9822
4123,晟德,12,0,12,元大-土城學府,2023-08-28,9822
3231,緯創,65,53,12,元大-土城學府,2023-08-28,9822
00900,富邦特選高股息30,11,0,11,元大-土城學府,2023-08-28,9822
2634,漢翔,77,66,11,元大-土城學府,2023-08-28,9822
00882,中信中國高股息,12,2,10,元大-土城學府,2023-08-28,9822
2301,光寶科,42,32,10,元大-土城學府,2023-08-28,9822
6108,競國,10,0,10,元大-土城學府,2023-08-28,9822
00680L,元大美債20正2,9,0,9,元大-土城學府,2023-08-28,9822
2388,威盛,14,5,9,元大-土城學府,2023-08-28,9822
6517,保勝光學,18,9,9,元大-土城學府,2023-08-28,9822
1906,寶隆,8,0,8,元大-土城學府,2023-08-28,9822
6138,茂達,8,0,8,元大-土城學府,2023-08-28,9822
3481,群創,16,8,8,元大-土城學府,2023-08-28,9822
2355,敬鵬,12,5,7,元大-土城學府,2023-08-28,9822
3056,富華新,10,3,7,元大-土城學府,2023-08-28,9822
2363,矽統,37,31,6,元大-土城學府,2023-08-28,9822
2913,農林,6,0,6,元大-土城學府,2023-08-28,9822
4543,萬在,7,1,6,元大-土城學府,2023-08-28,9822
6188,廣明,9,3,6,元大-土城學府,2023-08-28,9822
2353,宏��,31,25,6,元大-土城學府,2023-08-28,9822
00795B,中信美國公債20年,5,0,5,元大-土城學府,2023-08-28,9822
1101,台泥,10,5,5,元大-土城學府,2023-08-28,9822
1240,茂生農經,5,0,5,元大-土城學府,2023-08-28,9822
1321,大洋,5,0,5,元大-土城學府,2023-08-28,9822
1734,杏輝,5,0,5,元大-土城學府,2023-08-28,9822
4503,金雨,5,0,5,元大-土城學府,2023-08-28,9822
4707,磐亞,5,0,5,元大-土城學府,2023-08-28,9822
4760,勤凱,5,0,5,元大-土城學府,2023-08-28,9822
4960,誠美材,5,0,5,元大-土城學府,2023-08-28,9822
5351,鈺創,6,1,5,元大-土城學府,2023-08-28,9822
6125,廣運,10,5,5,元大-土城學府,2023-08-28,9822
6592,和潤企業,5,0,5,元大-土城學府,2023-08-28,9822
1618,合機,4,0,4,元大-土城學府,2023-08-28,9822
2303,聯電,114,56,58,元大-土城學府,2023-08-29,9822
00929,復華台灣科技優息,45,5,40,元大-土城學府,2023-08-29,9822
2363,矽統,165,139,26,元大-土城學府,2023-08-29,9822
6104,創惟,25,1,24,元大-土城學府,2023-08-29,9822
00882,中信中國高股息,22,0,22,元大-土城學府,2023-08-29,9822
00680L,元大美債20正2,20,0,20,元大-土城學府,2023-08-29,9822
6216,居易,20,0,20,元大-土城學府,2023-08-29,9822
6672,騰輝電子-KY,20,0,20,元大-土城學府,2023-08-29,9822
1449,佳和,19,0,19,元大-土城學府,2023-08-29,9822
6443,元晶,19,2,17,元大-土城學府,2023-08-29,9822
4915,致伸,17,1,16,元大-土城學府,2023-08-29,9822
4113,聯上,15,0,15,元大-土城學府,2023-08-29,9822
00878,國泰永續高股息,19,4,15,元大-土城學府,2023-08-29,9822
2485,兆赫,18,4,14,元大-土城學府,2023-08-29,9822
2002,中鋼,19,6,13,元大-土城學府,2023-08-29,9822
8050,廣積,17,6,11,元大-土城學府,2023-08-29,9822
1906,寶隆,11,0,11,元大-土城學府,2023-08-29,9822
2316,楠梓電,26,15,11,元大-土城學府,2023-08-29,9822
2883,凱基金,13,2,11,元大-土城學府,2023-08-29,9822
3078,僑威,11,0,11,元大-土城學府,2023-08-29,9822
2543,皇昌,10,0,10,元大-土城學府,2023-08-29,9822
3206,志豐,10,0,10,元大-土城學府,2023-08-29,9822
6244,茂迪,10,0,10,元大-土城學府,2023-08-29,9822
6284,佳邦,10,0,10,元大-土城學府,2023-08-29,9822
2317,鴻海,45,35,10,元大-土城學府,2023-08-29,9822
3231,緯創,42,33,9,元大-土城學府,2023-08-29,9822
6285,啟��,14,5,9,元大-土城學府,2023-08-29,9822
1584,精剛,13,5,8,元大-土城學府,2023-08-29,9822
4543,萬在,8,0,8,元大-土城學府,2023-08-29,9822
6170,統振,18,10,8,元大-土城學府,2023-08-29,9822
6829,千附精密,8,0,8,元大-土城學府,2023-08-29,9822
1517,利奇,7,0,7,元大-土城學府,2023-08-29,9822
2441,超豐,8,1,7,元大-土城學府,2023-08-29,9822
8222,寶一,12,5,7,元大-土城學府,2023-08-29,9822
00751B,元大AAA至A公司債,8,1,7,元大-土城學府,2023-08-29,9822
1737,臺鹽,11,5,6,元大-土城學府,2023-08-29,9822
2329,華泰,11,5,6,元大-土城學府,2023-08-29,9822
5351,鈺創,6,0,6,元大-土城學府,2023-08-29,9822
6188,廣明,7,1,6,元大-土城學府,2023-08-29,9822
2421,建準,7,2,5,元大-土城學府,2023-08-29,9822
5880,合庫金,5,0,5,元大-土城學府,2023-08-29,9822
1905,華紙,6,1,5,元大-土城學府,2023-08-29,9822
3623,富晶通,5,0,5,元大-土城學府,2023-08-29,9822
6220,岳豐,5,0,5,元大-土城學府,2023-08-29,9822
6257,矽格,5,0,5,元大-土城學府,2023-08-29,9822
8110,華東,5,0,5,元大-土城學府,2023-08-29,9822
2352,佳世達,5,1,4,元大-土城學府,2023-08-29,9822
00679B,元大美債20年,4,0,4,元大-土城學府,2023-08-29,9822
1409,新纖,4,0,4,元大-土城學府,2023-08-29,9822
2312,金寶,4,0,4,元大-土城學府,2023-08-29,9822
2618,長榮航,113,3,110,元大-土城學府,2023-08-30,9822
3715,定穎投控,124,45,79,元大-土城學府,2023-08-30,9822
00669R,國泰美國道瓊反1,52,0,52,元大-土城學府,2023-08-30,9822
8222,寶一,44,0,44,元大-土城學府,2023-08-30,9822
00679B,元大美債20年,41,0,41,元大-土城學府,2023-08-30,9822
3380,明泰,30,0,30,元大-土城學府,2023-08-30,9822
2409,友達,25,0,25,元大-土城學府,2023-08-30,9822
00919,群益台灣精選高息,21,2,19,元大-土城學府,2023-08-30,9822
3481,群創,21,4,17,元大-土城學府,2023-08-30,9822
2316,楠梓電,31,15,16,元大-土城學府,2023-08-30,9822
00929,復華台灣科技優息,123,108,15,元大-土城學府,2023-08-30,9822
2301,光寶科,34,19,15,元大-土城學府,2023-08-30,9822
3372,典範,15,0,15,元大-土城學府,2023-08-30,9822
2610,華航,14,0,14,元大-土城學府,2023-08-30,9822
5381,合正,18,4,14,元大-土城學府,2023-08-30,9822
1513,中興電,12,0,12,元大-土城學府,2023-08-30,9822
2002,中鋼,12,1,11,元大-土城學府,2023-08-30,9822
2486,一詮,15,4,11,元大-土城學府,2023-08-30,9822
5351,鈺創,11,0,11,元大-土城學府,2023-08-30,9822
2883,凱基金,11,0,11,元大-土城學府,2023-08-30,9822
1522,堤維西,10,0,10,元大-土城學府,2023-08-30,9822
3014,聯陽,10,0,10,元大-土城學府,2023-08-30,9822
6291,沛亨,10,0,10,元大-土城學府,2023-08-30,9822
8150,南茂,10,0,10,元大-土城學府,2023-08-30,9822
4113,聯上,9,0,9,元大-土城學府,2023-08-30,9822
2495,普安,11,3,8,元大-土城學府,2023-08-30,9822
00673R,期元大S＆P原油反1,7,0,7,元大-土城學府,2023-08-30,9822
2340,台亞,13,6,7,元大-土城學府,2023-08-30,9822
2408,南亞科,17,10,7,元大-土城學府,2023-08-30,9822
4933,友輝,8,1,7,元大-土城學府,2023-08-30,9822
5009,榮剛,7,0,7,元大-土城學府,2023-08-30,9822
00637L,元大滬深300正2,6,0,6,元大-土城學府,2023-08-30,9822
2344,華邦電,17,11,6,元大-土城學府,2023-08-30,9822
2705,六福,6,0,6,元大-土城學府,2023-08-30,9822
8390,金益鼎,6,0,6,元大-土城學府,2023-08-30,9822
2356,英業達,8,3,5,元大-土城學府,2023-08-30,9822
1434,福懋,5,0,5,元大-土城學府,2023-08-30,9822
2038,海光,5,0,5,元大-土城學府,2023-08-30,9822
2440,太空梭,5,0,5,元大-土城學府,2023-08-30,9822
2441,超豐,5,0,5,元大-土城學府,2023-08-30,9822
2882,國泰金,5,0,5,元大-土城學府,2023-08-30,9822
3078,僑威,12,7,5,元大-土城學府,2023-08-30,9822
3374,精材,5,0,5,元大-土城學府,2023-08-30,9822
3712,永崴投控,5,0,5,元大-土城學府,2023-08-30,9822
2881,富邦金,5,0,5,元大-土城學府,2023-08-30,9822
2376,技嘉,14,9,5,元大-土城學府,2023-08-30,9822
00751B,元大AAA至A公司債,5,1,4,元大-土城學府,2023-08-30,9822
2208,台船,4,0,4,元大-土城學府,2023-08-30,9822
2355,敬鵬,6,2,4,元大-土城學府,2023-08-30,9822
3045,台灣大,4,0,4,元大-土城學府,2023-08-30,9822
2303,聯電,146,32,114,元大-土城學府,2023-08-31,9822
00929,復華台灣科技優息,133,37,96,元大-土城學府,2023-08-31,9822
00632R,元大台灣50反1,66,0,66,元大-土城學府,2023-08-31,9822
5225,東科-KY,63,4,59,元大-土城學府,2023-08-31,9822
2891,中信金,45,2,43,元大-土城學府,2023-08-31,9822
6213,聯茂,39,3,36,元大-土城學府,2023-08-31,9822
6285,啟��,49,18,31,元大-土城學府,2023-08-31,9822
2610,華航,30,3,27,元大-土城學府,2023-08-31,9822
5381,合正,31,8,23,元大-土城學府,2023-08-31,9822
4542,科嶠,20,0,20,元大-土城學府,2023-08-31,9822
5426,振發,20,0,20,元大-土城學府,2023-08-31,9822
2412,中華電,18,0,18,元大-土城學府,2023-08-31,9822
1522,堤維西,31,14,17,元大-土城學府,2023-08-31,9822
1802,台玻,56,40,16,元大-土城學府,2023-08-31,9822
1612,宏泰,15,0,15,元大-土城學府,2023-08-31,9822
2511,太子,15,0,15,元大-土城學府,2023-08-31,9822
3360,尚立,15,0,15,元大-土城學府,2023-08-31,9822
5351,鈺創,15,0,15,元大-土城學府,2023-08-31,9822
2880,華南金,20,5,15,元大-土城學府,2023-08-31,9822
6547,高端疫苗,21,7,14,元大-土城學府,2023-08-31,9822
2367,燿華,15,2,13,元大-土城學府,2023-08-31,9822
2883,凱基金,13,0,13,元大-土城學府,2023-08-31,9822
9904,寶成,13,0,13,元大-土城學府,2023-08-31,9822
3011,今皓,13,1,12,元大-土城學府,2023-08-31,9822
2884,玉山金,12,0,12,元大-土城學府,2023-08-31,9822
2002,中鋼,11,0,11,元大-土城學府,2023-08-31,9822
3056,富華新,16,6,10,元大-土城學府,2023-08-31,9822
1101,台泥,10,0,10,元大-土城學府,2023-08-31,9822
9941,裕融,10,0,10,元大-土城學府,2023-08-31,9822
4167,松瑞藥,10,0,10,元大-土城學府,2023-08-31,9822
8049,晶采,10,0,10,元大-土城學府,2023-08-31,9822
8289,泰藝,10,0,10,元大-土城學府,2023-08-31,9822
3706,神達,13,3,10,元大-土城學府,2023-08-31,9822
00878,國泰永續高股息,13,4,9,元大-土城學府,2023-08-31,9822
1529,樂事綠能,10,1,9,元大-土城學府,2023-08-31,9822
2409,友達,20,11,9,元大-土城學府,2023-08-31,9822
00764B,群益25年美債,9,0,9,元大-土城學府,2023-08-31,9822
00919,群益台灣精選高息,15,6,9,元大-土城學府,2023-08-31,9822
2834,臺企銀,11,2,9,元大-土城學府,2023-08-31,9822
6291,沛亨,9,0,9,元大-土城學府,2023-08-31,9822
2892,第一金,8,0,8,元大-土城學府,2023-08-31,9822
3715,定穎投控,28,20,8,元大-土城學府,2023-08-31,9822
1217,愛之味,7,0,7,元大-土城學府,2023-08-31,9822
1517,利奇,8,1,7,元大-土城學府,2023-08-31,9822
2390,云辰,23,16,7,元大-土城學府,2023-08-31,9822
2890,永豐金,7,0,7,元大-土城學府,2023-08-31,9822
3025,星通,7,0,7,元大-土城學府,2023-08-31,9822
5009,榮剛,7,0,7,元大-土城學府,2023-08-31,9822
6168,宏齊,13,6,7,元大-土城學府,2023-08-31,9822
1301,台塑,6,0,6,元大-土城學府,2023-08-31,9822
00929,復華台灣科技優息,131,5,126,元大-土城學府,2023-09-01,9822
2816,旺旺保,105,2,103,元大-土城學府,2023-09-01,9822
4933,友輝,101,0,101,元大-土城學府,2023-09-01,9822
6122,擎邦,108,28,80,元大-土城學府,2023-09-01,9822
3231,緯創,88,27,61,元大-土城學府,2023-09-01,9822
00932,兆豐永續高息等權,43,0,43,元大-土城學府,2023-09-01,9822
2329,華泰,55,13,42,元大-土城學府,2023-09-01,9822
00919,群益台灣精選高息,42,0,42,元大-土城學府,2023-09-01,9822
8222,寶一,37,1,36,元大-土城學府,2023-09-01,9822
2382,廣達,75,48,27,元大-土城學府,2023-09-01,9822
2363,矽統,272,246,26,元大-土城學府,2023-09-01,9822
2301,光寶科,40,16,24,元大-土城學府,2023-09-01,9822
00673R,期元大S＆P原油反1,27,4,23,元大-土城學府,2023-09-01,9822
00921,兆豐龍頭等權重,22,0,22,元大-土城學府,2023-09-01,9822
2409,友達,20,0,20,元大-土城學府,2023-09-01,9822
1314,中石化,20,0,20,元大-土城學府,2023-09-01,9822
5864,致和證,20,0,20,元大-土城學府,2023-09-01,9822
4967,十銓,36,17,19,元大-土城學府,2023-09-01,9822
5351,鈺創,27,9,18,元大-土城學府,2023-09-01,9822
2516,新建,17,0,17,元大-土城學府,2023-09-01,9822
6175,立敦,16,0,16,元大-土城學府,2023-09-01,9822
6547,高端疫苗,30,14,16,元大-土城學府,2023-09-01,9822
3715,定穎投控,24,9,15,元大-土城學府,2023-09-01,9822
2369,菱生,19,5,14,元大-土城學府,2023-09-01,9822
2457,飛宏,16,2,14,元大-土城學府,2023-09-01,9822
1101,台泥,13,0,13,元大-土城學府,2023-09-01,9822
2367,燿華,16,3,13,元大-土城學府,2023-09-01,9822
2356,英業達,23,11,12,元大-土城學府,2023-09-01,9822
00878,國泰永續高股息,19,8,11,元大-土城學府,2023-09-01,9822
2312,金寶,19,8,11,元大-土城學府,2023-09-01,9822
2402,毅嘉,67,56,11,元大-土城學府,2023-09-01,9822
2538,基泰,12,1,11,元大-土城學府,2023-09-01,9822
3260,威剛,21,10,11,元大-土城學府,2023-09-01,9822
8277,商丞,11,0,11,元大-土城學府,2023-09-01,9822
2337,旺宏,16,6,10,元大-土城學府,2023-09-01,9822
1612,宏泰,10,0,10,元大-土城學府,2023-09-01,9822
1709,和益,10,0,10,元大-土城學府,2023-09-01,9822
3056,富華新,10,0,10,元大-土城學府,2023-09-01,9822
4934,太極,10,0,10,元大-土城學府,2023-09-01,9822
6485,點序,10,0,10,元大-土城學府,2023-09-01,9822
3035,智原,22,12,10,元大-土城學府,2023-09-01,9822
2884,玉山金,9,0,9,元大-土城學府,2023-09-01,9822
2340,台亞,24,15,9,元大-土城學府,2023-09-01,9822
00893,國泰智能電動車,10,1,9,元大-土城學府,2023-09-01,9822
6104,創惟,10,1,9,元大-土城學府,2023-09-01,9822
6282,康舒,11,2,9,元大-土城學府,2023-09-01,9822
5388,中磊,8,0,8,元大-土城學府,2023-09-01,9822
00930,永豐ESG低碳高息,8,0,8,元大-土城學府,2023-09-01,9822
6235,華孚,25,17,8,元大-土城學府,2023-09-01,9822
2059,川湖,7,0,7,元大-土城學府,2023-09-01,9822
00929,復華台灣科技優息,774,100,674,元大-土城學府,2023-09-04,9822
2816,旺旺保,192,0,192,元大-土城學府,2023-09-04,9822
2363,矽統,184,79,105,元大-土城學府,2023-09-04,9822
4542,科嶠,53,1,52,元大-土城學府,2023-09-04,9822
4909,新復興,27,2,25,元大-土城學府,2023-09-04,9822
00673R,期元大S＆P原油反1,28,5,23,元大-土城學府,2023-09-04,9822
00915,凱基優選高股息30,22,1,21,元大-土城學府,2023-09-04,9822
00772B,中信高評級公司債,20,0,20,元大-土城學府,2023-09-04,9822
00931B,統一美債20年,16,0,16,元大-土城學府,2023-09-04,9822
2543,皇昌,15,0,15,元大-土城學府,2023-09-04,9822
2329,華泰,49,35,14,元大-土城學府,2023-09-04,9822
1471,首利,14,1,13,元大-土城學府,2023-09-04,9822
6104,創惟,13,0,13,元大-土城學府,2023-09-04,9822
2409,友達,13,1,12,元大-土城學府,2023-09-04,9822
1802,台玻,56,45,11,元大-土城學府,2023-09-04,9822
2401,凌陽,11,0,11,元大-土城學府,2023-09-04,9822
2488,漢平,12,1,11,元大-土城學府,2023-09-04,9822
00679B,元大美債20年,10,0,10,元大-土城學府,2023-09-04,9822
00773B,中信優先金融債,10,0,10,元大-土城學府,2023-09-04,9822
1718,中纖,10,0,10,元大-土城學府,2023-09-04,9822
2236,百達-KY,10,0,10,元大-土城學府,2023-09-04,9822
4167,松瑞藥,10,0,10,元大-土城學府,2023-09-04,9822
5009,榮剛,14,4,10,元大-土城學府,2023-09-04,9822
0050,元大台灣50,12,2,10,元大-土城學府,2023-09-04,9822
1314,中石化,10,1,9,元大-土城學府,2023-09-04,9822
1528,恩德,9,0,9,元大-土城學府,2023-09-04,9822
2352,佳世達,9,1,8,元大-土城學府,2023-09-04,9822
2634,漢翔,17,9,8,元大-土城學府,2023-09-04,9822
3051,力特,30,22,8,元大-土城學府,2023-09-04,9822
5483,中美晶,8,0,8,元大-土城學府,2023-09-04,9822
6285,啟��,13,5,8,元大-土城學府,2023-09-04,9822
6418,詠昇,8,0,8,元大-土城學府,2023-09-04,9822
6829,千附精密,8,0,8,元大-土城學府,2023-09-04,9822
1101,台泥,8,1,7,元大-土城學府,2023-09-04,9822
00923,群益台ESG低碳50,7,0,7,元大-土城學府,2023-09-04,9822
2308,台達電,7,0,7,元大-土城學府,2023-09-04,9822
2331,精英,9,2,7,元大-土城學府,2023-09-04,9822
2472,立隆電,16,9,7,元大-土城學府,2023-09-04,9822
3622,洋華,10,3,7,元大-土城學府,2023-09-04,9822
2317,鴻海,11,5,6,元大-土城學府,2023-09-04,9822
2369,菱生,9,3,6,元大-土城學府,2023-09-04,9822
3481,群創,7,1,6,元大-土城學府,2023-09-04,9822
2340,台亞,7,2,5,元大-土城學府,2023-09-04,9822
8069,元太,8,3,5,元大-土城學府,2023-09-04,9822
00632R,元大台灣50反1,5,0,5,元大-土城學府,2023-09-04,9822
00751B,元大AAA至A公司債,5,0,5,元大-土城學府,2023-09-04,9822
1612,宏泰,5,0,5,元大-土城學府,2023-09-04,9822
2104,國際中橡,5,0,5,元大-土城學府,2023-09-04,9822
2374,佳能,6,1,5,元大-土城學府,2023-09-04,9822
2812,台中銀,5,0,5,元大-土城學府,2023-09-04,9822
00929,復華台灣科技優息,124,9,115,元大-土城學府,2023-09-05,9822
3567,逸昌,82,2,80,元大-土城學府,2023-09-05,9822
00915,凱基優選高股息30,42,0,42,元大-土城學府,2023-09-05,9822
3548,兆利,44,5,39,元大-土城學府,2023-09-05,9822
4542,科嶠,39,10,29,元大-土城學府,2023-09-05,9822
00665L,富邦�琤肭磪囓�2,20,0,20,元大-土城學府,2023-09-05,9822
2816,旺旺保,20,0,20,元大-土城學府,2023-09-05,9822
5864,致和證,20,0,20,元大-土城學府,2023-09-05,9822
2485,兆赫,22,3,19,元大-土城學府,2023-09-05,9822
2390,云辰,16,1,15,元大-土城學府,2023-09-05,9822
00751B,元大AAA至A公司債,14,0,14,元大-土城學府,2023-09-05,9822
3715,定穎投控,41,27,14,元大-土城學府,2023-09-05,9822
2886,兆豐金,13,0,13,元大-土城學府,2023-09-05,9822
00772B,中信高評級公司債,13,0,13,元大-土城學府,2023-09-05,9822
1626,艾美特-KY,17,4,13,元大-土城學府,2023-09-05,9822
2504,國產,13,0,13,元大-土城學府,2023-09-05,9822
6485,點序,14,1,13,元大-土城學府,2023-09-05,9822
3231,緯創,33,21,12,元大-土城學府,2023-09-05,9822
00687B,國泰20年美債,12,0,12,元大-土城學府,2023-09-05,9822
1314,中石化,20,8,12,元大-土城學府,2023-09-05,9822
3014,聯陽,12,0,12,元大-土城學府,2023-09-05,9822
3679,新至陞,12,0,12,元大-土城學府,2023-09-05,9822
2374,佳能,11,0,11,元大-土城學府,2023-09-05,9822
2913,農林,11,0,11,元大-土城學府,2023-09-05,9822
3481,群創,14,3,11,元大-土城學府,2023-09-05,9822
00673R,期元大S＆P原油反1,10,0,10,元大-土城學府,2023-09-05,9822
3046,建��,12,2,10,元大-土城學府,2023-09-05,9822
5469,瀚宇博,13,3,10,元大-土城學府,2023-09-05,9822
5483,中美晶,10,0,10,元大-土城學府,2023-09-05,9822
6167,久正,10,0,10,元大-土城學府,2023-09-05,9822
6191,精成科,11,2,9,元大-土城學府,2023-09-05,9822
00900,富邦特選高股息30,8,0,8,元大-土城學府,2023-09-05,9822
1906,寶隆,8,0,8,元大-土城學府,2023-09-05,9822
2402,毅嘉,35,27,8,元大-土城學府,2023-09-05,9822
2387,精元,12,5,7,元大-土城學府,2023-09-05,9822
2883,凱基金,7,0,7,元大-土城學府,2023-09-05,9822
4721,美琪瑪,7,0,7,元大-土城學府,2023-09-05,9822
00720B,元大投資級公司債,6,0,6,元大-土城學府,2023-09-05,9822
1471,首利,7,1,6,元大-土城學府,2023-09-05,9822
3003,健和興,6,0,6,元大-土城學府,2023-09-05,9822
3622,洋華,6,0,6,元大-土城學府,2023-09-05,9822
4760,勤凱,6,0,6,元大-土城學府,2023-09-05,9822
00919,群益台灣精選高息,28,22,6,元大-土城學府,2023-09-05,9822
2884,玉山金,5,0,5,元大-土城學府,2023-09-05,9822
2204,中華,17,12,5,元大-土城學府,2023-09-05,9822
2421,建準,7,2,5,元大-土城學府,2023-09-05,9822
3051,力特,23,18,5,元大-土城學府,2023-09-05,9822
4967,十銓,6,1,5,元大-土城學府,2023-09-05,9822
5009,榮剛,6,1,5,元大-土城學府,2023-09-05,9822
5452,佶優,6,1,5,元大-土城學府,2023-09-05,9822
00919,群益台灣精選高息,306,21,285,元大-土城學府,2023-09-06,9822
2615,萬海,174,0,174,元大-土城學府,2023-09-06,9822
2816,旺旺保,111,0,111,元大-土城學府,2023-09-06,9822
2409,友達,110,1,109,元大-土城學府,2023-09-06,9822
2356,英業達,122,16,106,元大-土城學府,2023-09-06,9822
3481,群創,86,3,83,元大-土城學府,2023-09-06,9822
2354,鴻準,67,0,67,元大-土城學府,2023-09-06,9822
3363,上詮,63,2,61,元大-土城學府,2023-09-06,9822
00641R,富邦日本反1,50,0,50,元大-土城學府,2023-09-06,9822
2436,偉詮電,50,20,30,元大-土城學府,2023-09-06,9822
2884,玉山金,42,12,30,元大-土城學府,2023-09-06,9822
00915,凱基優選高股息30,31,5,26,元大-土城學府,2023-09-06,9822
1101,台泥,26,1,25,元大-土城學府,2023-09-06,9822
5351,鈺創,26,1,25,元大-土城學府,2023-09-06,9822
2303,聯電,39,16,23,元大-土城學府,2023-09-06,9822
5284,jpp-KY,20,1,19,元大-土城學府,2023-09-06,9822
00679B,元大美債20年,17,0,17,元大-土城學府,2023-09-06,9822
1522,堤維西,20,3,17,元大-土城學府,2023-09-06,9822
2367,燿華,19,2,17,元大-土城學府,2023-09-06,9822
2618,長榮航,30,13,17,元大-土城學府,2023-09-06,9822
2201,裕隆,17,1,16,元大-土城學府,2023-09-06,9822
1504,東元,19,4,15,元大-土城學府,2023-09-06,9822
3693,營邦,36,21,15,元大-土城學府,2023-09-06,9822
8016,矽創,19,4,15,元大-土城學府,2023-09-06,9822
00673R,期元大S＆P原油反1,14,0,14,元大-土城學府,2023-09-06,9822
2891,中信金,14,0,14,元大-土城學府,2023-09-06,9822
00665L,富邦�琤肭磪囓�2,14,1,13,元大-土城學府,2023-09-06,9822
3548,兆利,22,9,13,元大-土城學府,2023-09-06,9822
6147,頎邦,13,1,12,元大-土城學府,2023-09-06,9822
00751B,元大AAA至A公司債,11,0,11,元大-土城學府,2023-09-06,9822
2312,金寶,11,0,11,元大-土城學府,2023-09-06,9822
3714,富采,14,3,11,元大-土城學府,2023-09-06,9822
00931B,統一美債20年,11,0,11,元大-土城學府,2023-09-06,9822
2010,春源,10,0,10,元大-土城學府,2023-09-06,9822
2883,凱基金,11,1,10,元大-土城學府,2023-09-06,9822
3380,明泰,10,0,10,元大-土城學府,2023-09-06,9822
5009,榮剛,15,5,10,元大-土城學府,2023-09-06,9822
5225,東科-KY,10,0,10,元大-土城學府,2023-09-06,9822
8927,北基,10,0,10,元大-土城學府,2023-09-06,9822
5209,新鼎,10,1,9,元大-土城學府,2023-09-06,9822
8358,金居,11,2,9,元大-土城學府,2023-09-06,9822
2886,兆豐金,8,0,8,元大-土城學府,2023-09-06,9822
00772B,中信高評級公司債,8,0,8,元大-土城學府,2023-09-06,9822
2610,華航,10,2,8,元大-土城學府,2023-09-06,9822
6203,海韻電,8,0,8,元大-土城學府,2023-09-06,9822
8155,博智,8,0,8,元大-土城學府,2023-09-06,9822
2401,凌陽,32,25,7,元大-土城學府,2023-09-06,9822
2834,臺企銀,7,0,7,元大-土城學府,2023-09-06,9822
3042,晶技,11,4,7,元大-土城學府,2023-09-06,9822
3545,敦泰,10,3,7,元大-土城學府,2023-09-06,9822
2618,長榮航,250,10,240,元大-土城學府,2023-09-07,9822
00706L,期元大S＆P日圓正2,104,0,104,元大-土城學府,2023-09-07,9822
4906,正文,130,36,94,元大-土城學府,2023-09-07,9822
00919,群益台灣精選高息,95,14,81,元大-土城學府,2023-09-07,9822
2816,旺旺保,61,5,56,元大-土城學府,2023-09-07,9822
00929,復華台灣科技優息,172,120,52,元大-土城學府,2023-09-07,9822
3090,日電貿,50,0,50,元大-土城學府,2023-09-07,9822
00915,凱基優選高股息30,46,0,46,元大-土城學府,2023-09-07,9822
2303,聯電,55,13,42,元大-土城學府,2023-09-07,9822
3481,群創,33,2,31,元大-土城學府,2023-09-07,9822
3213,茂訊,30,0,30,元大-土城學府,2023-09-07,9822
00902,中信電池及儲能,29,0,29,元大-土城學府,2023-09-07,9822
3567,逸昌,36,7,29,元大-土城學府,2023-09-07,9822
4533,協易機,43,17,26,元大-土城學府,2023-09-07,9822
5225,東科-KY,35,10,25,元大-土城學府,2023-09-07,9822
5457,宣德,35,10,25,元大-土城學府,2023-09-07,9822
3217,優群,30,6,24,元大-土城學府,2023-09-07,9822
3704,合勤控,45,23,22,元大-土城學府,2023-09-07,9822
8409,商之器,22,0,22,元大-土城學府,2023-09-07,9822
3363,上詮,44,23,21,元大-土城學府,2023-09-07,9822
2353,宏��,24,5,19,元大-土城學府,2023-09-07,9822
2884,玉山金,27,8,19,元大-土城學府,2023-09-07,9822
00878,國泰永續高股息,17,0,17,元大-土城學府,2023-09-07,9822
00753L,中信中國50正2,17,0,17,元大-土城學府,2023-09-07,9822
2753,八方雲集,17,0,17,元大-土城學府,2023-09-07,9822
00907,永豐優息存股,16,0,16,元大-土城學府,2023-09-07,9822
00673R,期元大S＆P原油反1,16,0,16,元大-土城學府,2023-09-07,9822
2883,凱基金,16,0,16,元大-土城學府,2023-09-07,9822
00715L,期街口布蘭特正2,15,1,14,元大-土城學府,2023-09-07,9822
2891,中信金,13,0,13,元大-土城學府,2023-09-07,9822
2436,偉詮電,17,4,13,元大-土城學府,2023-09-07,9822
00712,復華富時不動產,12,0,12,元大-土城學府,2023-09-07,9822
3042,晶技,14,3,11,元大-土城學府,2023-09-07,9822
2314,台揚,11,0,11,元大-土城學府,2023-09-07,9822
2458,義隆,11,0,11,元大-土城學府,2023-09-07,9822
4743,合一,11,0,11,元大-土城學府,2023-09-07,9822
6282,康舒,13,2,11,元大-土城學府,2023-09-07,9822
1513,中興電,10,0,10,元大-土城學府,2023-09-07,9822
00900,富邦特選高股息30,14,4,10,元大-土城學府,2023-09-07,9822
2022,聚亨,10,0,10,元大-土城學府,2023-09-07,9822
00637L,元大滬深300正2,13,3,10,元大-土城學府,2023-09-07,9822
4123,晟德,12,2,10,元大-土城學府,2023-09-07,9822
4904,遠傳,10,0,10,元大-土城學府,2023-09-07,9822
6109,亞元,10,0,10,元大-土城學府,2023-09-07,9822
6203,海韻電,10,0,10,元大-土城學府,2023-09-07,9822
8927,北基,10,0,10,元大-土城學府,2023-09-07,9822
2330,台積電,9,0,9,元大-土城學府,2023-09-07,9822
1463,強盛新,9,0,9,元大-土城學府,2023-09-07,9822
1522,堤維西,10,1,9,元大-土城學府,2023-09-07,9822
2355,敬鵬,12,3,9,元大-土城學府,2023-09-07,9822
00919,群益台灣精選高息,184,3,181,元大-土城學府,2023-09-08,9822
00929,復華台灣科技優息,84,11,73,元大-土城學府,2023-09-08,9822
3481,群創,58,0,58,元大-土城學府,2023-09-08,9822
6208,日揚,30,0,30,元大-土城學府,2023-09-08,9822
2329,華泰,39,11,28,元大-土城學府,2023-09-08,9822
2405,輔信,24,4,20,元大-土城學府,2023-09-08,9822
3483,力致,24,4,20,元大-土城學府,2023-09-08,9822
5381,合正,23,3,20,元大-土城學府,2023-09-08,9822
3715,定穎投控,95,75,20,元大-土城學府,2023-09-08,9822
2353,宏��,27,10,17,元大-土城學府,2023-09-08,9822
4934,太極,23,6,17,元大-土城學府,2023-09-08,9822
00918,大華優利高填息30,16,0,16,元大-土城學府,2023-09-08,9822
2634,漢翔,43,27,16,元大-土城學府,2023-09-08,9822
2753,八方雲集,17,1,16,元大-土城學府,2023-09-08,9822
2892,第一金,15,0,15,元大-土城學府,2023-09-08,9822
6116,彩晶,15,0,15,元大-土城學府,2023-09-08,9822
3231,緯創,24,11,13,元大-土城學府,2023-09-08,9822
2031,新光鋼,15,2,13,元大-土城學府,2023-09-08,9822
3013,晟銘電,14,1,13,元大-土城學府,2023-09-08,9822
3617,碩天,24,11,13,元大-土城學府,2023-09-08,9822
2303,聯電,12,0,12,元大-土城學府,2023-09-08,9822
00915,凱基優選高股息30,12,0,12,元大-土城學府,2023-09-08,9822
5452,佶優,11,0,11,元大-土城學府,2023-09-08,9822
6282,康舒,15,4,11,元大-土城學府,2023-09-08,9822
00753L,中信中國50正2,10,0,10,元大-土城學府,2023-09-08,9822
1463,強盛新,10,0,10,元大-土城學府,2023-09-08,9822
1618,合機,21,11,10,元大-土城學府,2023-09-08,9822
2002,中鋼,10,0,10,元大-土城學府,2023-09-08,9822
2359,所羅門,10,0,10,元大-土城學府,2023-09-08,9822
5351,鈺創,10,0,10,元大-土城學府,2023-09-08,9822
6216,居易,10,0,10,元大-土城學府,2023-09-08,9822
6485,點序,11,1,10,元大-土城學府,2023-09-08,9822
3706,神達,14,5,9,元大-土城學府,2023-09-08,9822
2313,華通,24,15,9,元大-土城學府,2023-09-08,9822
2402,毅嘉,44,35,9,元大-土城學府,2023-09-08,9822
3037,欣興,20,11,9,元大-土城學府,2023-09-08,9822
4533,協易機,9,0,9,元大-土城學府,2023-09-08,9822
2317,鴻海,8,0,8,元大-土城學府,2023-09-08,9822
2374,佳能,11,3,8,元大-土城學府,2023-09-08,9822
2409,友達,8,0,8,元大-土城學府,2023-09-08,9822
2601,益航,8,0,8,元大-土城學府,2023-09-08,9822
2382,廣達,25,18,7,元大-土城學府,2023-09-08,9822
3338,泰碩,8,1,7,元大-土城學府,2023-09-08,9822
2358,廷鑫,16,9,7,元大-土城學府,2023-09-08,9822
3014,聯陽,14,7,7,元大-土城學府,2023-09-08,9822
8112,至上,59,52,7,元大-土城學府,2023-09-08,9822
2376,技嘉,21,15,6,元大-土城學府,2023-09-08,9822
2201,裕隆,6,0,6,元大-土城學府,2023-09-08,9822
2301,光寶科,14,8,6,元大-土城學府,2023-09-08,9822
00923,群益台ESG低碳50,15,9,6,元大-土城學府,2023-09-08,9822
00919,群益台灣精選高息,130,1,129,元大-土城學府,2023-09-11,9822
2382,廣達,154,40,114,元大-土城學府,2023-09-11,9822
00878,國泰永續高股息,121,18,103,元大-土城學府,2023-09-11,9822
00929,復華台灣科技優息,106,12,94,元大-土城學府,2023-09-11,9822
3715,定穎投控,119,71,48,元大-土城學府,2023-09-11,9822
00715L,期街口布蘭特正2,40,1,39,元大-土城學府,2023-09-11,9822
3014,聯陽,32,1,31,元大-土城學府,2023-09-11,9822
1618,合機,29,4,25,元大-土城學府,2023-09-11,9822
2363,矽統,114,90,24,元大-土城學府,2023-09-11,9822
2352,佳世達,25,4,21,元大-土城學府,2023-09-11,9822
2883,凱基金,21,0,21,元大-土城學府,2023-09-11,9822
00915,凱基優選高股息30,20,0,20,元大-土城學府,2023-09-11,9822
2380,虹光,20,0,20,元大-土城學府,2023-09-11,9822
00713,元大台灣高息低波,26,7,19,元大-土城學府,2023-09-11,9822
2312,金寶,19,0,19,元大-土城學府,2023-09-11,9822
6122,擎邦,22,3,19,元大-土城學府,2023-09-11,9822
6284,佳邦,20,1,19,元大-土城學府,2023-09-11,9822
2543,皇昌,19,1,18,元大-土城學府,2023-09-11,9822
006208,富邦台50,19,2,17,元大-土城學府,2023-09-11,9822
2031,新光鋼,17,0,17,元大-土城學府,2023-09-11,9822
00673R,期元大S＆P原油反1,15,0,15,元大-土城學府,2023-09-11,9822
2753,八方雲集,14,0,14,元大-土城學府,2023-09-11,9822
3481,群創,23,9,14,元大-土城學府,2023-09-11,9822
6770,力積電,13,0,13,元大-土城學府,2023-09-11,9822
00900,富邦特選高股息30,14,1,13,元大-土城學府,2023-09-11,9822
2888,新光金,14,1,13,元大-土城學府,2023-09-11,9822
4542,科嶠,13,0,13,元大-土城學府,2023-09-11,9822
00932,兆豐永續高息等權,12,0,12,元大-土城學府,2023-09-11,9822
6531,愛普*,17,5,12,元大-土城學府,2023-09-11,9822
2376,技嘉,20,9,11,元大-土城學府,2023-09-11,9822
00679B,元大美債20年,11,0,11,元大-土城學府,2023-09-11,9822
00918,大華優利高填息30,11,0,11,元大-土城學府,2023-09-11,9822
00931B,統一美債20年,11,0,11,元大-土城學府,2023-09-11,9822
2105,正新,12,1,11,元大-土城學府,2023-09-11,9822
1513,中興電,13,2,11,元大-土城學府,2023-09-11,9822
2329,華泰,66,56,10,元大-土城學府,2023-09-11,9822
2359,所羅門,12,2,10,元大-土城學府,2023-09-11,9822
4543,萬在,10,0,10,元大-土城學府,2023-09-11,9822
5243,乙盛-KY,10,0,10,元大-土城學府,2023-09-11,9822
5521,工信,10,0,10,元大-土城學府,2023-09-11,9822
8201,無敵,10,0,10,元大-土城學府,2023-09-11,9822
8390,金益鼎,10,0,10,元大-土城學府,2023-09-11,9822
2458,義隆,17,8,9,元大-土城學府,2023-09-11,9822
2538,基泰,11,2,9,元大-土城學府,2023-09-11,9822
00632R,元大台灣50反1,21,13,8,元大-土城學府,2023-09-11,9822
2324,仁寶,9,1,8,元大-土城學府,2023-09-11,9822
2457,飛宏,11,3,8,元大-土城學府,2023-09-11,9822
2353,宏��,34,26,8,元大-土城學府,2023-09-11,9822
2331,精英,7,0,7,元大-土城學府,2023-09-11,9822
3078,僑威,10,3,7,元大-土城學府,2023-09-11,9822
1471,首利,107,3,104,元大-土城學府,2023-09-12,9822
00706L,期元大S＆P日圓正2,90,0,90,元大-土城學府,2023-09-12,9822
00929,復華台灣科技優息,80,20,60,元大-土城學府,2023-09-12,9822
00931B,統一美債20年,49,0,49,元大-土城學府,2023-09-12,9822
00919,群益台灣精選高息,39,3,36,元大-土城學府,2023-09-12,9822
1524,耿鼎,52,27,25,元大-土城學府,2023-09-12,9822
00673R,期元大S＆P原油反1,21,0,21,元大-土城學府,2023-09-12,9822
6449,鈺邦,20,0,20,元大-土城學府,2023-09-12,9822
2363,矽統,91,74,17,元大-土城學府,2023-09-12,9822
2504,國產,15,0,15,元大-土城學府,2023-09-12,9822
2031,新光鋼,14,0,14,元大-土城學府,2023-09-12,9822
2405,輔信,16,3,13,元大-土城學府,2023-09-12,9822
1319,東陽,55,42,13,元大-土城學府,2023-09-12,9822
2884,玉山金,22,10,12,元大-土城學府,2023-09-12,9822
2402,毅嘉,20,8,12,元大-土城學府,2023-09-12,9822
5225,東科-KY,12,0,12,元大-土城學府,2023-09-12,9822
2382,廣達,25,14,11,元大-土城學府,2023-09-12,9822
6282,康舒,39,28,11,元大-土城學府,2023-09-12,9822
3715,定穎投控,11,1,10,元大-土城學府,2023-09-12,9822
1314,中石化,10,0,10,元大-土城學府,2023-09-12,9822
2332,友訊,10,0,10,元大-土城學府,2023-09-12,9822
6139,亞翔,10,0,10,元大-土城學府,2023-09-12,9822
6788,華景電,10,0,10,元大-土城學府,2023-09-12,9822
8222,寶一,19,9,10,元大-土城學府,2023-09-12,9822
00713,元大台灣高息低波,10,0,10,元大-土城學府,2023-09-12,9822
6125,廣運,15,6,9,元大-土城學府,2023-09-12,9822
2753,八方雲集,9,0,9,元大-土城學府,2023-09-12,9822
2883,凱基金,10,1,9,元大-土城學府,2023-09-12,9822
6770,力積電,8,0,8,元大-土城學府,2023-09-12,9822
1584,精剛,9,2,7,元大-土城學府,2023-09-12,9822
1906,寶隆,7,0,7,元大-土城學府,2023-09-12,9822
2421,建準,9,2,7,元大-土城學府,2023-09-12,9822
4909,新復興,6,0,6,元大-土城學府,2023-09-12,9822
2357,華碩,7,1,6,元大-土城學府,2023-09-12,9822
6274,台燿,9,3,6,元大-土城學府,2023-09-12,9822
2436,偉詮電,9,3,6,元大-土城學府,2023-09-12,9822
00918,大華優利高填息30,6,0,6,元大-土城學府,2023-09-12,9822
2498,宏達電,6,0,6,元大-土城學府,2023-09-12,9822
3545,敦泰,8,2,6,元大-土城學府,2023-09-12,9822
5258,虹堡,6,0,6,元大-土城學府,2023-09-12,9822
8076,伍豐,6,0,6,元大-土城學府,2023-09-12,9822
2313,華通,27,21,6,元大-土城學府,2023-09-12,9822
2376,技嘉,17,11,6,元大-土城學府,2023-09-12,9822
1104,環泥,5,0,5,元大-土城學府,2023-09-12,9822
1463,強盛新,5,0,5,元大-土城學府,2023-09-12,9822
1514,亞力,5,0,5,元大-土城學府,2023-09-12,9822
1515,力山,9,4,5,元大-土城學府,2023-09-12,9822
1720,生達,5,0,5,元大-土城學府,2023-09-12,9822
2201,裕隆,5,0,5,元大-土城學府,2023-09-12,9822
3652,精聯,5,0,5,元大-土城學府,2023-09-12,9822
00929,復華台灣科技優息,477,45,432,元大-土城學府,2023-09-13,9822
00919,群益台灣精選高息,105,3,102,元大-土城學府,2023-09-13,9822
3317,尼克森,60,1,59,元大-土城學府,2023-09-13,9822
1471,首利,41,2,39,元大-土城學府,2023-09-13,9822
3704,合勤控,54,30,24,元大-土城學府,2023-09-13,9822
2352,佳世達,43,20,23,元大-土城學府,2023-09-13,9822
1616,億泰,22,0,22,元大-土城學府,2023-09-13,9822
2929,淘帝-KY,22,0,22,元大-土城學府,2023-09-13,9822
3090,日電貿,22,1,21,元大-土城學府,2023-09-13,9822
3213,茂訊,23,3,20,元大-土城學府,2023-09-13,9822
1809,中釉,20,2,18,元大-土城學府,2023-09-13,9822
6788,華景電,20,2,18,元大-土城學府,2023-09-13,9822
00713,元大台灣高息低波,14,0,14,元大-土城學府,2023-09-13,9822
3346,麗清,21,8,13,元大-土城學府,2023-09-13,9822
00673R,期元大S＆P原油反1,12,0,12,元大-土城學府,2023-09-13,9822
00931B,統一美債20年,11,0,11,元大-土城學府,2023-09-13,9822
2812,台中銀,11,0,11,元大-土城學府,2023-09-13,9822
00642U,期元大S＆P石油,10,0,10,元大-土城學府,2023-09-13,9822
00706L,期元大S＆P日圓正2,10,0,10,元大-土城學府,2023-09-13,9822
1463,強盛新,10,0,10,元大-土城學府,2023-09-13,9822
1584,精剛,10,0,10,元大-土城學府,2023-09-13,9822
2324,仁寶,11,1,10,元大-土城學府,2023-09-13,9822
2419,仲琦,10,0,10,元大-土城學府,2023-09-13,9822
2609,陽明,11,1,10,元大-土城學府,2023-09-13,9822
3047,訊舟,10,0,10,元大-土城學府,2023-09-13,9822
4123,晟德,10,0,10,元大-土城學府,2023-09-13,9822
4904,遠傳,10,0,10,元大-土城學府,2023-09-13,9822
8201,無敵,10,0,10,元大-土城學府,2023-09-13,9822
00902,中信電池及儲能,10,0,10,元大-土城學府,2023-09-13,9822
6282,康舒,12,3,9,元大-土城學府,2023-09-13,9822
2610,華航,12,3,9,元大-土城學府,2023-09-13,9822
3045,台灣大,9,0,9,元大-土城學府,2023-09-13,9822
9928,中視,9,0,9,元大-土城學府,2023-09-13,9822
2031,新光鋼,8,0,8,元大-土城學府,2023-09-13,9822
2634,漢翔,10,2,8,元大-土城學府,2023-09-13,9822
5353,台林,8,0,8,元大-土城學府,2023-09-13,9822
5452,佶優,8,0,8,元大-土城學府,2023-09-13,9822
00720B,元大投資級公司債,7,0,7,元大-土城學府,2023-09-13,9822
2412,中華電,7,0,7,元大-土城學府,2023-09-13,9822
8390,金益鼎,7,0,7,元大-土城學府,2023-09-13,9822
1319,東陽,33,27,6,元大-土城學府,2023-09-13,9822
2355,敬鵬,22,16,6,元大-土城學府,2023-09-13,9822
2538,基泰,14,8,6,元大-土城學府,2023-09-13,9822
5457,宣德,5,0,5,元大-土城學府,2023-09-13,9822
00916,國泰全球品牌50,5,0,5,元大-土城學府,2023-09-13,9822
2409,友達,12,7,5,元大-土城學府,2023-09-13,9822
3217,優群,5,0,5,元大-土城學府,2023-09-13,9822
8050,廣積,4,0,4,元大-土城學府,2023-09-13,9822
2002,中鋼,6,2,4,元大-土城學府,2023-09-13,9822
2329,華泰,23,19,4,元大-土城學府,2023-09-13,9822
00632R,元大台灣50反1,539,15,524,元大-土城學府,2023-09-14,9822
00919,群益台灣精選高息,464,26,438,元大-土城學府,2023-09-14,9822
00929,復華台灣科技優息,228,27,201,元大-土城學府,2023-09-14,9822
3003,健和興,31,5,26,元大-土城學府,2023-09-14,9822
2371,大同,26,2,24,元大-土城學府,2023-09-14,9822
3213,茂訊,24,0,24,元大-土城學府,2023-09-14,9822
1718,中纖,22,0,22,元大-土城學府,2023-09-14,9822
3704,合勤控,30,10,20,元大-土城學府,2023-09-14,9822
6605,帝寶,20,1,19,元大-土城學府,2023-09-14,9822
00882,中信中國高股息,18,0,18,元大-土城學府,2023-09-14,9822
2331,精英,18,0,18,元大-土城學府,2023-09-14,9822
2303,聯電,34,17,17,元大-土城學府,2023-09-14,9822
2402,毅嘉,16,2,14,元大-土城學府,2023-09-14,9822
2618,長榮航,17,3,14,元大-土城學府,2023-09-14,9822
00713,元大台灣高息低波,13,0,13,元大-土城學府,2023-09-14,9822
2915,潤泰全,11,0,11,元大-土城學府,2023-09-14,9822
3149,正達,11,0,11,元大-土城學府,2023-09-14,9822
3260,威剛,16,5,11,元大-土城學府,2023-09-14,9822
00673R,期元大S＆P原油反1,10,0,10,元大-土城學府,2023-09-14,9822
1504,東元,11,1,10,元大-土城學府,2023-09-14,9822
2337,旺宏,15,5,10,元大-土城學府,2023-09-14,9822
2472,立隆電,10,0,10,元大-土城學府,2023-09-14,9822
3694,海華,10,0,10,元大-土城學府,2023-09-14,9822
6449,鈺邦,10,0,10,元大-土城學府,2023-09-14,9822
2347,聯強,10,1,9,元大-土城學府,2023-09-14,9822
3715,定穎投控,39,30,9,元大-土城學府,2023-09-14,9822
2344,華邦電,10,1,9,元大-土城學府,2023-09-14,9822
2105,正新,9,1,8,元大-土城學府,2023-09-14,9822
9941,裕融,10,3,7,元大-土城學府,2023-09-14,9822
1524,耿鼎,58,51,7,元大-土城學府,2023-09-14,9822
1584,精剛,7,0,7,元大-土城學府,2023-09-14,9822
2025,千興,8,1,7,元大-土城學府,2023-09-14,9822
3078,僑威,12,6,6,元大-土城學府,2023-09-14,9822
00687B,國泰20年美債,6,0,6,元大-土城學府,2023-09-14,9822
2340,台亞,12,6,6,元大-土城學府,2023-09-14,9822
4939,亞電,6,0,6,元大-土城學府,2023-09-14,9822
6108,競國,6,0,6,元大-土城學府,2023-09-14,9822
6756,威鋒電子,6,0,6,元大-土城學府,2023-09-14,9822
00679B,元大美債20年,7,1,6,元大-土城學府,2023-09-14,9822
2323,中環,6,1,5,元大-土城學府,2023-09-14,9822
1522,堤維西,88,83,5,元大-土城學府,2023-09-14,9822
3005,神基,5,0,5,元大-土城學府,2023-09-14,9822
3682,亞太電,5,0,5,元大-土城學府,2023-09-14,9822
4760,勤凱,5,0,5,元大-土城學府,2023-09-14,9822
5371,中光電,5,0,5,元大-土城學府,2023-09-14,9822
4739,康普,5,0,5,元大-土城學府,2023-09-14,9822
5880,合庫金,8,3,5,元大-土城學府,2023-09-14,9822
2002,中鋼,4,0,4,元大-土城學府,2023-09-14,9822
2332,友訊,6,2,4,元大-土城學府,2023-09-14,9822
2409,友達,4,0,4,元大-土城學府,2023-09-14,9822
00929,復華台灣科技優息,523,18,505,元大-土城學府,2023-09-15,9822
00919,群益台灣精選高息,416,48,368,元大-土城學府,2023-09-15,9822
3363,上詮,78,21,57,元大-土城學府,2023-09-15,9822
2425,承啟,56,1,55,元大-土城學府,2023-09-15,9822
00878,國泰永續高股息,52,10,42,元大-土城學府,2023-09-15,9822
1568,倉佑,53,15,38,元大-土城學府,2023-09-15,9822
2329,華泰,41,5,36,元大-土城學府,2023-09-15,9822
2486,一詮,86,51,35,元大-土城學府,2023-09-15,9822
00915,凱基優選高股息30,32,0,32,元大-土城學府,2023-09-15,9822
6605,帝寶,30,0,30,元大-土城學府,2023-09-15,9822
2303,聯電,32,6,26,元大-土城學府,2023-09-15,9822
3481,群創,26,4,22,元大-土城學府,2023-09-15,9822
4906,正文,22,0,22,元大-土城學府,2023-09-15,9822
1471,首利,25,4,21,元大-土城學府,2023-09-15,9822
00931B,統一美債20年,15,0,15,元大-土城學府,2023-09-15,9822
6284,佳邦,15,0,15,元大-土城學府,2023-09-15,9822
4503,金雨,14,0,14,元大-土城學府,2023-09-15,9822
3149,正達,13,0,13,元大-土城學府,2023-09-15,9822
1319,東陽,16,4,12,元大-土城學府,2023-09-15,9822
00918,大華優利高填息30,16,4,12,元大-土城學府,2023-09-15,9822
00673R,期元大S＆P原油反1,19,7,12,元大-土城學府,2023-09-15,9822
3058,立德,12,0,12,元大-土城學府,2023-09-15,9822
1504,東元,12,0,12,元大-土城學府,2023-09-15,9822
2504,國產,11,0,11,元大-土城學府,2023-09-15,9822
3596,智易,12,1,11,元大-土城學府,2023-09-15,9822
00713,元大台灣高息低波,11,1,10,元大-土城學府,2023-09-15,9822
2025,千興,10,0,10,元大-土城學府,2023-09-15,9822
2881,富邦金,10,0,10,元大-土城學府,2023-09-15,9822
5521,工信,10,0,10,元大-土城學府,2023-09-15,9822
8011,台通,10,0,10,元大-土城學府,2023-09-15,9822
3231,緯創,25,16,9,元大-土城學府,2023-09-15,9822
00927,群益半導體收益,10,1,9,元大-土城學府,2023-09-15,9822
2402,毅嘉,13,4,9,元大-土城學府,2023-09-15,9822
2610,華航,9,0,9,元大-土城學府,2023-09-15,9822
5351,鈺創,10,1,9,元大-土城學府,2023-09-15,9822
00902,中信電池及儲能,9,1,8,元大-土城學府,2023-09-15,9822
3380,明泰,13,5,8,元大-土城學府,2023-09-15,9822
8069,元太,10,2,8,元大-土城學府,2023-09-15,9822
2891,中信金,16,9,7,元大-土城學府,2023-09-15,9822
2314,台揚,7,0,7,元大-土城學府,2023-09-15,9822
1313,聯成,7,0,7,元大-土城學府,2023-09-15,9822
2331,精英,9,2,7,元大-土城學府,2023-09-15,9822
5243,乙盛-KY,7,0,7,元大-土城學府,2023-09-15,9822
6120,達運,23,16,7,元大-土城學府,2023-09-15,9822
6449,鈺邦,7,0,7,元大-土城學府,2023-09-15,9822
1802,台玻,8,2,6,元大-土城學府,2023-09-15,9822
00877,復華中國5G,6,0,6,元大-土城學府,2023-09-15,9822
8048,德勝,7,1,6,元大-土城學府,2023-09-15,9822
2615,萬海,19,13,6,元大-土城學府,2023-09-15,9822
2611,志信,5,0,5,元大-土城學府,2023-09-15,9822
00919,群益台灣精選高息,599,19,580,元大-土城學府,2023-09-18,9822
00929,復華台灣科技優息,269,25,244,元大-土城學府,2023-09-18,9822
2363,矽統,213,34,179,元大-土城學府,2023-09-18,9822
2303,聯電,71,0,71,元大-土城學府,2023-09-18,9822
00931B,統一美債20年,55,0,55,元大-土城學府,2023-09-18,9822
00878,國泰永續高股息,51,3,48,元大-土城學府,2023-09-18,9822
3163,波若威,46,4,42,元大-土城學府,2023-09-18,9822
00918,大華優利高填息30,106,68,38,元大-土城學府,2023-09-18,9822
5521,工信,35,0,35,元大-土城學府,2023-09-18,9822
2313,華通,64,35,29,元大-土城學府,2023-09-18,9822
2816,旺旺保,29,0,29,元大-土城學府,2023-09-18,9822
6284,佳邦,30,1,29,元大-土城學府,2023-09-18,9822
2353,宏��,32,4,28,元大-土城學府,2023-09-18,9822
2382,廣達,40,16,24,元大-土城學府,2023-09-18,9822
2329,華泰,51,28,23,元大-土城學府,2023-09-18,9822
4128,中天,23,0,23,元大-土城學府,2023-09-18,9822
00679B,元大美債20年,21,0,21,元大-土城學府,2023-09-18,9822
00772B,中信高評級公司債,20,0,20,元大-土城學府,2023-09-18,9822
3231,緯創,34,14,20,元大-土城學府,2023-09-18,9822
1314,中石化,20,0,20,元大-土城學府,2023-09-18,9822
5439,高技,20,0,20,元大-土城學府,2023-09-18,9822
1568,倉佑,15,0,15,元大-土城學府,2023-09-18,9822
00713,元大台灣高息低波,17,2,15,元大-土城學府,2023-09-18,9822
00915,凱基優選高股息30,14,0,14,元大-土城學府,2023-09-18,9822
1809,中釉,14,0,14,元大-土城學府,2023-09-18,9822
2618,長榮航,13,0,13,元大-土城學府,2023-09-18,9822
6457,紘康,13,0,13,元大-土城學府,2023-09-18,9822
3037,欣興,15,3,12,元大-土城學府,2023-09-18,9822
2402,毅嘉,19,7,12,元大-土城學府,2023-09-18,9822
3014,聯陽,13,1,12,元大-土城學府,2023-09-18,9822
00857B,永豐20年美公債,11,0,11,元大-土城學府,2023-09-18,9822
2884,玉山金,31,20,11,元大-土城學府,2023-09-18,9822
00715L,期街口布蘭特正2,12,1,11,元大-土城學府,2023-09-18,9822
3704,合勤控,21,10,11,元大-土城學府,2023-09-18,9822
2027,大成鋼,13,3,10,元大-土城學府,2023-09-18,9822
4714,永捷,11,1,10,元大-土城學府,2023-09-18,9822
6228,全譜,10,0,10,元大-土城學府,2023-09-18,9822
00720B,元大投資級公司債,9,0,9,元大-土城學府,2023-09-18,9822
6191,精成科,11,2,9,元大-土城學府,2023-09-18,9822
2330,台積電,9,0,9,元大-土城學府,2023-09-18,9822
3693,營邦,27,19,8,元大-土城學府,2023-09-18,9822
8054,安國,11,3,8,元大-土城學府,2023-09-18,9822
00687B,國泰20年美債,7,0,7,元大-土城學府,2023-09-18,9822
00696B,富邦美債20年,7,0,7,元大-土城學府,2023-09-18,9822
2059,川湖,7,0,7,元大-土城學府,2023-09-18,9822
00722B,群益投資級電信債,7,0,7,元大-土城學府,2023-09-18,9822
8050,廣積,7,0,7,元大-土城學府,2023-09-18,9822
2376,技嘉,18,11,7,元大-土城學府,2023-09-18,9822
2352,佳世達,6,0,6,元大-土城學府,2023-09-18,9822
2301,光寶科,16,10,6,元大-土城學府,2023-09-18,9822
2618,長榮航,313,10,303,元大-土城學府,2023-09-19,9822
00929,復華台灣科技優息,200,74,126,元大-土城學府,2023-09-19,9822
00919,群益台灣精選高息,70,3,67,元大-土城學府,2023-09-19,9822
5475,德宏,40,2,38,元大-土城學府,2023-09-19,9822
2303,聯電,39,2,37,元大-土城學府,2023-09-19,9822
2617,台航,30,2,28,元大-土城學府,2023-09-19,9822
3163,波若威,35,8,27,元大-土城學府,2023-09-19,9822
2610,華航,29,2,27,元大-土城學府,2023-09-19,9822
00878,國泰永續高股息,34,8,26,元大-土城學府,2023-09-19,9822
2881,富邦金,20,0,20,元大-土城學府,2023-09-19,9822
3078,僑威,18,0,18,元大-土城學府,2023-09-19,9822
6223,旺矽,18,0,18,元大-土城學府,2023-09-19,9822
8390,金益鼎,17,0,17,元大-土城學府,2023-09-19,9822
00687B,國泰20年美債,16,0,16,元大-土城學府,2023-09-19,9822
3231,緯創,39,23,16,元大-土城學府,2023-09-19,9822
00679B,元大美債20年,15,0,15,元大-土城學府,2023-09-19,9822
8044,網家,15,0,15,元大-土城學府,2023-09-19,9822
8155,博智,15,0,15,元大-土城學府,2023-09-19,9822
4906,正文,14,0,14,元大-土城學府,2023-09-19,9822
5521,工信,14,0,14,元大-土城學府,2023-09-19,9822
0056,元大高股息,20,7,13,元大-土城學府,2023-09-19,9822
2353,宏��,43,30,13,元大-土城學府,2023-09-19,9822
4714,永捷,14,1,13,元大-土城學府,2023-09-19,9822
2330,台積電,12,0,12,元大-土城學府,2023-09-19,9822
00932,兆豐永續高息等權,12,0,12,元大-土城學府,2023-09-19,9822
00885,富邦越南,12,1,11,元大-土城學府,2023-09-19,9822
00712,復華富時不動產,11,0,11,元大-土城學府,2023-09-19,9822
2606,裕民,15,4,11,元大-土城學府,2023-09-19,9822
3324,雙鴻,16,5,11,元大-土城學府,2023-09-19,9822
1101,台泥,11,1,10,元大-土城學府,2023-09-19,9822
020022,元大電動車N,10,0,10,元大-土城學府,2023-09-19,9822
2359,所羅門,10,0,10,元大-土城學府,2023-09-19,9822
2515,中工,10,0,10,元大-土城學府,2023-09-19,9822
2538,基泰,10,0,10,元大-土城學府,2023-09-19,9822
00915,凱基優選高股息30,9,0,9,元大-土城學府,2023-09-19,9822
3013,晟銘電,9,0,9,元大-土城學府,2023-09-19,9822
6290,良維,9,0,9,元大-土城學府,2023-09-19,9822
6189,豐藝,9,0,9,元大-土城學府,2023-09-19,9822
1616,億泰,8,0,8,元大-土城學府,2023-09-19,9822
6274,台燿,12,4,8,元大-土城學府,2023-09-19,9822
2344,華邦電,38,31,7,元大-土城學府,2023-09-19,9822
4746,台耀,9,2,7,元大-土城學府,2023-09-19,9822
1319,東陽,15,9,6,元大-土城學府,2023-09-19,9822
00673R,期元大S＆P原油反1,6,0,6,元大-土城學府,2023-09-19,9822
1471,首利,6,0,6,元大-土城學府,2023-09-19,9822
1524,耿鼎,13,7,6,元大-土城學府,2023-09-19,9822
2882,國泰金,6,0,6,元大-土城學府,2023-09-19,9822
3287,廣寰科,6,0,6,元大-土城學府,2023-09-19,9822
6005,群益證,6,0,6,元大-土城學府,2023-09-19,9822
0050,元大台灣50,6,0,6,元大-土城學府,2023-09-19,9822
00929,復華台灣科技優息,261,140,121,元大-土城學府,2023-09-20,9822
2367,燿華,136,36,100,元大-土城學府,2023-09-20,9822
2301,光寶科,81,2,79,元大-土城學府,2023-09-20,9822
00919,群益台灣精選高息,71,0,71,元大-土城學府,2023-09-20,9822
2641,正德,80,16,64,元大-土城學府,2023-09-20,9822
3715,定穎投控,97,37,60,元大-土城學府,2023-09-20,9822
3037,欣興,47,2,45,元大-土城學府,2023-09-20,9822
6451,訊芯-KY,41,1,40,元大-土城學府,2023-09-20,9822
4908,前鼎,40,7,33,元大-土城學府,2023-09-20,9822
2354,鴻準,35,7,28,元大-土城學府,2023-09-20,9822
6284,佳邦,25,0,25,元大-土城學府,2023-09-20,9822
00902,中信電池及儲能,25,0,25,元大-土城學府,2023-09-20,9822
8088,品安,39,19,20,元大-土城學府,2023-09-20,9822
2201,裕隆,35,16,19,元大-土城學府,2023-09-20,9822
4906,正文,16,0,16,元大-土城學府,2023-09-20,9822
6901,鑽石投資,18,3,15,元大-土城學府,2023-09-20,9822
2356,英業達,23,9,14,元大-土城學府,2023-09-20,9822
2313,華通,35,21,14,元大-土城學府,2023-09-20,9822
00878,國泰永續高股息,95,81,14,元大-土城學府,2023-09-20,9822
3264,欣銓,13,0,13,元大-土城學府,2023-09-20,9822
00753L,中信中國50正2,13,0,13,元大-土城學府,2023-09-20,9822
1605,華新,22,9,13,元大-土城學府,2023-09-20,9822
2340,台亞,14,3,11,元大-土城學府,2023-09-20,9822
2371,大同,11,0,11,元大-土城學府,2023-09-20,9822
2382,廣達,44,33,11,元大-土城學府,2023-09-20,9822
2883,凱基金,10,0,10,元大-土城學府,2023-09-20,9822
00897,富邦基因免疫生技,10,0,10,元大-土城學府,2023-09-20,9822
00900,富邦特選高股息30,10,0,10,元大-土城學府,2023-09-20,9822
8050,廣積,14,4,10,元大-土城學府,2023-09-20,9822
2332,友訊,13,4,9,元大-土城學府,2023-09-20,9822
2317,鴻海,9,0,9,元大-土城學府,2023-09-20,9822
2303,聯電,13,5,8,元大-土城學府,2023-09-20,9822
00915,凱基優選高股息30,8,0,8,元大-土城學府,2023-09-20,9822
1514,亞力,12,4,8,元大-土城學府,2023-09-20,9822
2913,農林,8,0,8,元大-土城學府,2023-09-20,9822
3231,緯創,35,28,7,元大-土城學府,2023-09-20,9822
3481,群創,17,10,7,元大-土城學府,2023-09-20,9822
2498,宏達電,8,1,7,元大-土城學府,2023-09-20,9822
6770,力積電,8,1,7,元大-土城學府,2023-09-20,9822
3045,台灣大,7,0,7,元大-土城學府,2023-09-20,9822
2330,台積電,7,1,6,元大-土城學府,2023-09-20,9822
00679B,元大美債20年,6,0,6,元大-土城學府,2023-09-20,9822
2344,華邦電,6,0,6,元大-土城學府,2023-09-20,9822
00907,永豐優息存股,6,0,6,元大-土城學府,2023-09-20,9822
2208,台船,7,1,6,元大-土城學府,2023-09-20,9822
2324,仁寶,6,0,6,元大-土城學府,2023-09-20,9822
2409,友達,11,5,6,元大-土城學府,2023-09-20,9822
3363,上詮,12,6,6,元大-土城學府,2023-09-20,9822
6530,創威,6,0,6,元大-土城學府,2023-09-20,9822
3189,景碩,5,0,5,元大-土城學府,2023-09-20,9822
5521,工信,40,0,40,元大-土城學府,2023-09-21,9822
00919,群益台灣精選高息,40,1,39,元大-土城學府,2023-09-21,9822
2002,中鋼,34,1,33,元大-土城學府,2023-09-21,9822
2884,玉山金,31,0,31,元大-土城學府,2023-09-21,9822
2025,千興,31,0,31,元大-土城學府,2023-09-21,9822
2891,中信金,33,5,28,元大-土城學府,2023-09-21,9822
006208,富邦台50,25,0,25,元大-土城學府,2023-09-21,9822
4904,遠傳,25,0,25,元大-土城學府,2023-09-21,9822
2374,佳能,24,0,24,元大-土城學府,2023-09-21,9822
2353,宏��,65,42,23,元大-土城學府,2023-09-21,9822
2610,華航,24,2,22,元大-土城學府,2023-09-21,9822
3715,定穎投控,63,41,22,元大-土城學府,2023-09-21,9822
4906,正文,22,0,22,元大-土城學府,2023-09-21,9822
00932,兆豐永續高息等權,23,1,22,元大-土城學府,2023-09-21,9822
2498,宏達電,21,1,20,元大-土城學府,2023-09-21,9822
3078,僑威,20,1,19,元大-土城學府,2023-09-21,9822
00902,中信電池及儲能,19,0,19,元大-土城學府,2023-09-21,9822
00712,復華富時不動產,18,0,18,元大-土城學府,2023-09-21,9822
1451,年興,18,0,18,元大-土城學府,2023-09-21,9822
6672,騰輝電子-KY,20,2,18,元大-土城學府,2023-09-21,9822
00923,群益台ESG低碳50,22,5,17,元大-土城學府,2023-09-21,9822
3056,富華新,16,0,16,元大-土城學府,2023-09-21,9822
9103,美德醫療-DR,24,8,16,元大-土城學府,2023-09-21,9822
2303,聯電,42,27,15,元大-土城學府,2023-09-21,9822
3037,欣興,32,19,13,元大-土城學府,2023-09-21,9822
00922,國泰台灣領袖50,12,0,12,元大-土城學府,2023-09-21,9822
2329,華泰,15,4,11,元大-土城學府,2023-09-21,9822
4961,天鈺,11,0,11,元大-土城學府,2023-09-21,9822
2449,京元電子,46,35,11,元大-土城學府,2023-09-21,9822
00882,中信中國高股息,11,0,11,元大-土城學府,2023-09-21,9822
5880,合庫金,11,0,11,元大-土城學府,2023-09-21,9822
2330,台積電,11,1,10,元大-土城學府,2023-09-21,9822
00665L,富邦�琤肭磪囓�2,16,6,10,元大-土城學府,2023-09-21,9822
1316,上曜,10,0,10,元大-土城學府,2023-09-21,9822
3202,樺晟,10,0,10,元大-土城學府,2023-09-21,9822
6243,迅杰,10,0,10,元大-土城學府,2023-09-21,9822
2313,華通,51,42,9,元大-土城學府,2023-09-21,9822
2399,映泰,28,19,9,元大-土城學府,2023-09-21,9822
2888,新光金,13,4,9,元大-土城學府,2023-09-21,9822
8050,廣積,10,1,9,元大-土城學府,2023-09-21,9822
0050,元大台灣50,9,0,9,元大-土城學府,2023-09-21,9822
2201,裕隆,19,10,9,元大-土城學府,2023-09-21,9822
1101,台泥,10,1,9,元大-土城學府,2023-09-21,9822
2885,元大金,10,2,8,元大-土城學府,2023-09-21,9822
0056,元大高股息,15,7,8,元大-土城學府,2023-09-21,9822
00673R,期元大S＆P原油反1,8,0,8,元大-土城學府,2023-09-21,9822
4908,前鼎,14,6,8,元大-土城學府,2023-09-21,9822
00915,凱基優選高股息30,9,2,7,元大-土城學府,2023-09-21,9822
3617,碩天,7,0,7,元大-土城學府,2023-09-21,9822
9941,裕融,6,0,6,元大-土城學府,2023-09-21,9822
00679B,元大美債20年,75,0,75,元大-土城學府,2023-09-22,9822
00931B,統一美債20年,48,0,48,元大-土城學府,2023-09-22,9822
00919,群益台灣精選高息,45,0,45,元大-土城學府,2023-09-22,9822
00715L,期街口布蘭特正2,40,0,40,元大-土城學府,2023-09-22,9822
00712,復華富時不動產,38,1,37,元大-土城學府,2023-09-22,9822
2891,中信金,33,4,29,元大-土城學府,2023-09-22,9822
00772B,中信高評級公司債,25,0,25,元大-土城學府,2023-09-22,9822
2543,皇昌,41,18,23,元大-土城學府,2023-09-22,9822
2303,聯電,25,2,23,元大-土城學府,2023-09-22,9822
00688L,國泰20年美債正2,21,0,21,元大-土城學府,2023-09-22,9822
00722B,群益投資級電信債,21,0,21,元大-土城學府,2023-09-22,9822
1201,味全,20,0,20,元大-土城學府,2023-09-22,9822
3122,笙泉,21,1,20,元大-土城學府,2023-09-22,9822
00929,復華台灣科技優息,64,44,20,元大-土城學府,2023-09-22,9822
2449,京元電子,64,45,19,元大-土城學府,2023-09-22,9822
5521,工信,15,0,15,元大-土城學府,2023-09-22,9822
3037,欣興,39,26,13,元大-土城學府,2023-09-22,9822
4908,前鼎,32,19,13,元大-土城學府,2023-09-22,9822
00751B,元大AAA至A公司債,12,0,12,元大-土城學府,2023-09-22,9822
2330,台積電,12,1,11,元大-土城學府,2023-09-22,9822
3163,波若威,35,24,11,元大-土城學府,2023-09-22,9822
3707,漢磊,11,0,11,元大-土城學府,2023-09-22,9822
00923,群益台ESG低碳50,10,0,10,元大-土城學府,2023-09-22,9822
00665L,富邦�琤肭磪囓�2,13,3,10,元大-土城學府,2023-09-22,9822
00673R,期元大S＆P原油反1,10,0,10,元大-土城學府,2023-09-22,9822
2605,新興,14,4,10,元大-土城學府,2023-09-22,9822
2883,凱基金,14,4,10,元大-土城學府,2023-09-22,9822
2609,陽明,11,1,10,元大-土城學府,2023-09-22,9822
6405,悅城,9,0,9,元大-土城學府,2023-09-22,9822
2515,中工,10,2,8,元大-土城學府,2023-09-22,9822
1101,台泥,11,3,8,元大-土城學府,2023-09-22,9822
2014,中鴻,9,1,8,元大-土城學府,2023-09-22,9822
00720B,元大投資級公司債,17,9,8,元大-土城學府,2023-09-22,9822
2425,承啟,8,0,8,元大-土城學府,2023-09-22,9822
3338,泰碩,10,2,8,元大-土城學府,2023-09-22,9822
3450,聯鈞,21,13,8,元大-土城學府,2023-09-22,9822
6770,力積電,8,0,8,元大-土城學府,2023-09-22,9822
2002,中鋼,7,0,7,元大-土城學府,2023-09-22,9822
00932,兆豐永續高息等權,7,0,7,元大-土城學府,2023-09-22,9822
00713,元大台灣高息低波,7,0,7,元大-土城學府,2023-09-22,9822
00795B,中信美國公債20年,7,0,7,元大-土城學府,2023-09-22,9822
2887,台新金,7,0,7,元大-土城學府,2023-09-22,9822
2412,中華電,7,0,7,元大-土城學府,2023-09-22,9822
2834,臺企銀,7,0,7,元大-土城學府,2023-09-22,9822
00724B,群益投資級金融債,6,0,6,元大-土城學府,2023-09-22,9822
00680L,元大美債20正2,5,0,5,元大-土城學府,2023-09-22,9822
6282,康舒,21,16,5,元大-土城學府,2023-09-22,9822
00696B,富邦美債20年,5,0,5,元大-土城學府,2023-09-22,9822
00902,中信電池及儲能,10,5,5,元大-土城學府,2023-09-22,9822
00857B,永豐20年美公債,5,0,5,元大-土城學府,2023-09-22,9822
00929,復華台灣科技優息,481,73,408,元大-土城學府,2023-09-25,9822
3363,上詮,194,92,102,元大-土城學府,2023-09-25,9822
00632R,元大台灣50反1,61,0,61,元大-土城學府,2023-09-25,9822
3265,台星科,55,9,46,元大-土城學府,2023-09-25,9822
6139,亞翔,34,10,24,元大-土城學府,2023-09-25,9822
00680L,元大美債20正2,22,0,22,元大-土城學府,2023-09-25,9822
2888,新光金,21,0,21,元大-土城學府,2023-09-25,9822
9945,潤泰新,20,0,20,元大-土城學府,2023-09-25,9822
3325,旭品,23,3,20,元大-土城學府,2023-09-25,9822
3693,營邦,42,23,19,元大-土城學府,2023-09-25,9822
2316,楠梓電,49,33,16,元大-土城學府,2023-09-25,9822
2618,長榮航,42,27,15,元大-土城學府,2023-09-25,9822
2301,光寶科,16,2,14,元大-土城學府,2023-09-25,9822
3017,奇鋐,16,3,13,元大-土城學府,2023-09-25,9822
2449,京元電子,24,12,12,元大-土城學府,2023-09-25,9822
8938,明安,12,0,12,元大-土城學府,2023-09-25,9822
00712,復華富時不動產,11,0,11,元大-土城學府,2023-09-25,9822
1504,東元,13,2,11,元大-土城學府,2023-09-25,9822
2303,聯電,52,42,10,元大-土城學府,2023-09-25,9822
1314,中石化,10,0,10,元大-土城學府,2023-09-25,9822
2338,光罩,10,0,10,元大-土城學府,2023-09-25,9822
6180,橘子,10,0,10,元大-土城學府,2023-09-25,9822
1101,台泥,9,0,9,元大-土城學府,2023-09-25,9822
1584,精剛,15,7,8,元大-土城學府,2023-09-25,9822
2374,佳能,8,0,8,元大-土城學府,2023-09-25,9822
6147,頎邦,8,0,8,元大-土城學府,2023-09-25,9822
2355,敬鵬,19,12,7,元大-土城學府,2023-09-25,9822
6122,擎邦,8,1,7,元大-土城學府,2023-09-25,9822
6213,聯茂,9,2,7,元大-土城學府,2023-09-25,9822
3078,僑威,6,0,6,元大-土城學府,2023-09-25,9822
6877,鏵友益,6,0,6,元大-土城學府,2023-09-25,9822
00679B,元大美債20年,6,0,6,元大-土城學府,2023-09-25,9822
00673R,期元大S＆P原油反1,5,0,5,元大-土城學府,2023-09-25,9822
1609,大亞,5,0,5,元大-土城學府,2023-09-25,9822
2201,裕隆,18,13,5,元大-土城學府,2023-09-25,9822
3043,科風,5,0,5,元大-土城學府,2023-09-25,9822
4114,健喬,5,0,5,元大-土城學府,2023-09-25,9822
4157,太景*-KY,5,0,5,元大-土城學府,2023-09-25,9822
4760,勤凱,5,0,5,元大-土城學府,2023-09-25,9822
2317,鴻海,4,0,4,元大-土城學府,2023-09-25,9822
2324,仁寶,4,0,4,元大-土城學府,2023-09-25,9822
3163,波若威,18,14,4,元大-土城學府,2023-09-25,9822
3228,金麗科,4,0,4,元大-土城學府,2023-09-25,9822
5009,榮剛,7,3,4,元大-土城學府,2023-09-25,9822
6290,良維,5,1,4,元大-土城學府,2023-09-25,9822
6457,紘康,4,0,4,元大-土城學府,2023-09-25,9822
0056,元大高股息,5,1,4,元大-土城學府,2023-09-25,9822
8050,廣積,6,2,4,元大-土城學府,2023-09-25,9822
2382,廣達,47,44,3,元大-土城學府,2023-09-25,9822
2358,廷鑫,4,1,3,元大-土城學府,2023-09-25,9822
00929,復華台灣科技優息,93,7,86,元大-土城學府,2023-09-26,9822
1522,堤維西,116,57,59,元大-土城學府,2023-09-26,9822
00679B,元大美債20年,58,2,56,元大-土城學府,2023-09-26,9822
2206,三陽工業,56,2,54,元大-土城學府,2023-09-26,9822
2329,華泰,36,4,32,元大-土城學府,2023-09-26,9822
00772B,中信高評級公司債,32,0,32,元大-土城學府,2023-09-26,9822
4979,華星光,30,5,25,元大-土城學府,2023-09-26,9822
6451,訊芯-KY,29,4,25,元大-土城學府,2023-09-26,9822
2380,虹光,24,0,24,元大-土城學府,2023-09-26,9822
3308,聯德,23,3,20,元大-土城學府,2023-09-26,9822
5009,榮剛,21,2,19,元大-土城學府,2023-09-26,9822
2317,鴻海,19,1,18,元大-土城學府,2023-09-26,9822
00878,國泰永續高股息,25,8,17,元大-土城學府,2023-09-26,9822
6770,力積電,16,0,16,元大-土城學府,2023-09-26,9822
00900,富邦特選高股息30,22,6,16,元大-土城學府,2023-09-26,9822
6191,精成科,16,0,16,元大-土城學府,2023-09-26,9822
2388,威盛,23,8,15,元大-土城學府,2023-09-26,9822
1568,倉佑,15,0,15,元大-土城學府,2023-09-26,9822
1444,力麗,14,0,14,元大-土城學府,2023-09-26,9822
4564,元翎,12,0,12,元大-土城學府,2023-09-26,9822
00932,兆豐永續高息等權,10,0,10,元大-土城學府,2023-09-26,9822
00904,新光臺灣半導體30,10,0,10,元大-土城學府,2023-09-26,9822
00897,富邦基因免疫生技,10,0,10,元大-土城學府,2023-09-26,9822
00713,元大台灣高息低波,10,0,10,元大-土城學府,2023-09-26,9822
1218,泰山,10,0,10,元大-土城學府,2023-09-26,9822
2316,楠梓電,17,7,10,元大-土城學府,2023-09-26,9822
2891,中信金,10,0,10,元大-土城學府,2023-09-26,9822
3050,鈺德,10,0,10,元大-土城學府,2023-09-26,9822
3260,威剛,10,0,10,元大-土城學府,2023-09-26,9822
4157,太景*-KY,10,0,10,元大-土城學府,2023-09-26,9822
6220,岳豐,10,0,10,元大-土城學府,2023-09-26,9822
2303,聯電,21,12,9,元大-土城學府,2023-09-26,9822
3380,明泰,10,1,9,元大-土城學府,2023-09-26,9822
4743,合一,9,0,9,元大-土城學府,2023-09-26,9822
6139,亞翔,24,15,9,元大-土城學府,2023-09-26,9822
6485,點序,10,1,9,元大-土城學府,2023-09-26,9822
0056,元大高股息,9,0,9,元大-土城學府,2023-09-26,9822
2352,佳世達,8,0,8,元大-土城學府,2023-09-26,9822
00923,群益台ESG低碳50,8,0,8,元大-土城學府,2023-09-26,9822
00712,復華富時不動產,8,0,8,元大-土城學府,2023-09-26,9822
1616,億泰,8,0,8,元大-土城學府,2023-09-26,9822
2002,中鋼,8,0,8,元大-土城學府,2023-09-26,9822
2425,承啟,8,0,8,元大-土城學府,2023-09-26,9822
2476,鉅祥,10,2,8,元大-土城學府,2023-09-26,9822
3450,聯鈞,20,12,8,元大-土城學府,2023-09-26,9822
3548,兆利,10,2,8,元大-土城學府,2023-09-26,9822
3715,定穎投控,59,51,8,元大-土城學府,2023-09-26,9822
6122,擎邦,9,1,8,元大-土城學府,2023-09-26,9822
5425,台半,8,0,8,元大-土城學府,2023-09-26,9822
00922,國泰台灣領袖50,8,0,8,元大-土城學府,2023-09-26,9822
00632R,元大台灣50反1,52,0,52,元大-土城學府,2023-09-27,9822
4906,正文,50,0,50,元大-土城學府,2023-09-27,9822
6275,元山,30,0,30,元大-土城學府,2023-09-27,9822
6122,擎邦,27,2,25,元大-土城學府,2023-09-27,9822
00712,復華富時不動產,23,0,23,元大-土城學府,2023-09-27,9822
4908,前鼎,26,5,21,元大-土城學府,2023-09-27,9822
1201,味全,20,0,20,元大-土城學府,2023-09-27,9822
6451,訊芯-KY,26,6,20,元大-土城學府,2023-09-27,9822
2014,中鴻,20,1,19,元大-土城學府,2023-09-27,9822
1463,強盛新,18,0,18,元大-土城學府,2023-09-27,9822
00772B,中信高評級公司債,16,0,16,元大-土城學府,2023-09-27,9822
3317,尼克森,15,0,15,元大-土城學府,2023-09-27,9822
2002,中鋼,24,10,14,元大-土城學府,2023-09-27,9822
3231,緯創,24,10,14,元大-土城學府,2023-09-27,9822
00720B,元大投資級公司債,13,0,13,元大-土城學府,2023-09-27,9822
2355,敬鵬,20,7,13,元大-土城學府,2023-09-27,9822
5351,鈺創,14,2,12,元大-土城學府,2023-09-27,9822
2017,官田鋼,11,0,11,元大-土城學府,2023-09-27,9822
3322,建舜電,13,2,11,元大-土城學府,2023-09-27,9822
00673R,期元大S＆P原油反1,10,0,10,元大-土城學府,2023-09-27,9822
0050,元大台灣50,12,2,10,元大-土城學府,2023-09-27,9822
2303,聯電,10,0,10,元大-土城學府,2023-09-27,9822
1609,大亞,19,10,9,元大-土城學府,2023-09-27,9822
3715,定穎投控,64,55,9,元大-土城學府,2023-09-27,9822
6457,紘康,9,0,9,元大-土城學府,2023-09-27,9822
9904,寶成,8,0,8,元大-土城學府,2023-09-27,9822
00902,中信電池及儲能,8,1,7,元大-土城學府,2023-09-27,9822
1471,首利,7,0,7,元大-土城學府,2023-09-27,9822
2820,華票,7,0,7,元大-土城學府,2023-09-27,9822
6877,鏵友益,7,0,7,元大-土城學府,2023-09-27,9822
8155,博智,7,0,7,元大-土城學府,2023-09-27,9822
00932,兆豐永續高息等權,6,0,6,元大-土城學府,2023-09-27,9822
00922,國泰台灣領袖50,7,1,6,元大-土城學府,2023-09-27,9822
1218,泰山,6,0,6,元大-土城學府,2023-09-27,9822
00773B,中信優先金融債,6,0,6,元大-土城學府,2023-09-27,9822
00679B,元大美債20年,5,0,5,元大-土城學府,2023-09-27,9822
1909,榮成,5,0,5,元大-土城學府,2023-09-27,9822
2409,友達,5,0,5,元大-土城學府,2023-09-27,9822
2495,普安,5,0,5,元大-土城學府,2023-09-27,9822
3042,晶技,6,1,5,元大-土城學府,2023-09-27,9822
3051,力特,7,2,5,元大-土城學府,2023-09-27,9822
3652,精聯,5,0,5,元大-土城學府,2023-09-27,9822
5009,榮剛,7,2,5,元大-土城學府,2023-09-27,9822
5381,合正,5,0,5,元大-土城學府,2023-09-27,9822
5907,大洋-KY,5,0,5,元大-土城學府,2023-09-27,9822
6180,橘子,5,0,5,元大-土城學府,2023-09-27,9822
6223,旺矽,5,0,5,元大-土城學府,2023-09-27,9822
6442,光聖,13,8,5,元大-土城學府,2023-09-27,9822
6456,GIS-KY,6,1,5,元大-土城學府,2023-09-27,9822
2891,中信金,5,1,4,元大-土城學府,2023-09-27,9822
6117,迎廣,80,9,71,元大-土城學府,2023-09-28,9822
00929,復華台灣科技優息,178,113,65,元大-土城學府,2023-09-28,9822
00706L,期元大S＆P日圓正2,50,0,50,元大-土城學府,2023-09-28,9822
3037,欣興,41,3,38,元大-土城學府,2023-09-28,9822
2031,新光鋼,36,0,36,元大-土城學府,2023-09-28,9822
3548,兆利,35,0,35,元大-土城學府,2023-09-28,9822
00673R,期元大S＆P原油反1,34,0,34,元大-土城學府,2023-09-28,9822
3231,緯創,50,16,34,元大-土城學府,2023-09-28,9822
2344,華邦電,34,2,32,元大-土城學府,2023-09-28,9822
00679B,元大美債20年,30,0,30,元大-土城學府,2023-09-28,9822
5521,工信,30,0,30,元大-土城學府,2023-09-28,9822
00712,復華富時不動產,28,0,28,元大-土城學府,2023-09-28,9822
8403,盛弘,28,0,28,元大-土城學府,2023-09-28,9822
2201,裕隆,28,2,26,元大-土城學府,2023-09-28,9822
00715L,期街口布蘭特正2,34,8,26,元大-土城學府,2023-09-28,9822
2408,南亞科,25,1,24,元大-土城學府,2023-09-28,9822
6153,嘉聯益,23,0,23,元大-土城學府,2023-09-28,9822
6901,鑽石投資,22,0,22,元大-土城學府,2023-09-28,9822
1568,倉佑,21,0,21,元大-土城學府,2023-09-28,9822
00753L,中信中國50正2,20,0,20,元大-土城學府,2023-09-28,9822
00772B,中信高評級公司債,20,0,20,元大-土城學府,2023-09-28,9822
3035,智原,22,4,18,元大-土城學府,2023-09-28,9822
4906,正文,15,0,15,元大-土城學府,2023-09-28,9822
2017,官田鋼,15,2,13,元大-土城學府,2023-09-28,9822
2421,建準,17,5,12,元大-土城學府,2023-09-28,9822
2208,台船,12,0,12,元大-土城學府,2023-09-28,9822
3701,大眾控,11,0,11,元大-土城學府,2023-09-28,9822
00720B,元大投資級公司債,11,0,11,元大-土城學府,2023-09-28,9822
00665L,富邦�琤肭磪囓�2,11,0,11,元大-土城學府,2023-09-28,9822
2356,英業達,14,3,11,元大-土城學府,2023-09-28,9822
2884,玉山金,10,0,10,元大-土城學府,2023-09-28,9822
1718,中纖,10,0,10,元大-土城學府,2023-09-28,9822
2363,矽統,71,61,10,元大-土城學府,2023-09-28,9822
2495,普安,10,0,10,元大-土城學府,2023-09-28,9822
2812,台中銀,10,0,10,元大-土城學府,2023-09-28,9822
00687B,國泰20年美債,9,0,9,元大-土城學府,2023-09-28,9822
2610,華航,21,12,9,元大-土城學府,2023-09-28,9822
2449,京元電子,7,0,7,元大-土城學府,2023-09-28,9822
1326,台化,7,0,7,元大-土城學府,2023-09-28,9822
3032,偉訓,12,5,7,元大-土城學府,2023-09-28,9822
00773B,中信優先金融債,6,0,6,元大-土城學府,2023-09-28,9822
3081,聯亞,6,0,6,元大-土城學府,2023-09-28,9822
3264,欣銓,6,0,6,元大-土城學府,2023-09-28,9822
3576,聯合再生,6,0,6,元大-土城學府,2023-09-28,9822
3630,新鉅科,7,1,6,元大-土城學府,2023-09-28,9822
5871,中租-KY,6,0,6,元大-土城學府,2023-09-28,9822
6538,倉和,6,0,6,元大-土城學府,2023-09-28,9822
1216,統一,5,0,5,元大-土城學府,2023-09-28,9822
1101,台泥,14,9,5,元大-土城學府,2023-09-28,9822
2316,楠梓電,35,30,5,元大-土城學府,2023-09-28,9822
2363,矽統,257,66,191,元大-土城學府,2023-10-02,9822
3715,定穎投控,141,66,75,元大-土城學府,2023-10-02,9822
6117,迎廣,77,4,73,元大-土城學府,2023-10-02,9822
4542,科嶠,52,2,50,元大-土城學府,2023-10-02,9822
00878,國泰永續高股息,70,21,49,元大-土城學府,2023-10-02,9822
3481,群創,50,12,38,元大-土城學府,2023-10-02,9822
2313,華通,52,24,28,元大-土城學府,2023-10-02,9822
1101,台泥,25,0,25,元大-土城學府,2023-10-02,9822
1471,首利,34,9,25,元大-土城學府,2023-10-02,9822
3033,威健,21,0,21,元大-土城學府,2023-10-02,9822
2884,玉山金,22,3,19,元大-土城學府,2023-10-02,9822
00687B,國泰20年美債,18,0,18,元大-土城學府,2023-10-02,9822
2618,長榮航,18,1,17,元大-土城學府,2023-10-02,9822
4979,華星光,16,0,16,元大-土城學府,2023-10-02,9822
00722B,群益投資級電信債,15,0,15,元大-土城學府,2023-10-02,9822
3548,兆利,21,6,15,元大-土城學府,2023-10-02,9822
2329,華泰,42,28,14,元大-土城學府,2023-10-02,9822
2409,友達,14,0,14,元大-土城學府,2023-10-02,9822
2888,新光金,12,0,12,元大-土城學府,2023-10-02,9822
2885,元大金,12,0,12,元大-土城學府,2023-10-02,9822
6139,亞翔,14,3,11,元大-土城學府,2023-10-02,9822
00642U,期元大S＆P石油,10,0,10,元大-土城學府,2023-10-02,9822
2002,中鋼,11,1,10,元大-土城學府,2023-10-02,9822
2208,台船,10,0,10,元大-土城學府,2023-10-02,9822
2929,淘帝-KY,10,0,10,元大-土城學府,2023-10-02,9822
3231,緯創,109,99,10,元大-土城學府,2023-10-02,9822
00715L,期街口布蘭特正2,9,0,9,元大-土城學府,2023-10-02,9822
2492,華新科,10,1,9,元大-土城學府,2023-10-02,9822
2883,凱基金,10,2,8,元大-土城學府,2023-10-02,9822
00720B,元大投資級公司債,8,0,8,元大-土城學府,2023-10-02,9822
2368,金像電,26,18,8,元大-土城學府,2023-10-02,9822
6538,倉和,8,0,8,元大-土城學府,2023-10-02,9822
00712,復華富時不動產,7,0,7,元大-土城學府,2023-10-02,9822
1519,華城,53,46,7,元大-土城學府,2023-10-02,9822
8088,品安,17,10,7,元大-土城學府,2023-10-02,9822
2457,飛宏,7,0,7,元大-土城學府,2023-10-02,9822
2606,裕民,6,0,6,元大-土城學府,2023-10-02,9822
1319,東陽,8,2,6,元大-土城學府,2023-10-02,9822
00919,群益台灣精選高息,12,6,6,元大-土城學府,2023-10-02,9822
00902,中信電池及儲能,6,0,6,元大-土城學府,2023-10-02,9822
00751B,元大AAA至A公司債,6,0,6,元大-土城學府,2023-10-02,9822
2316,楠梓電,9,3,6,元大-土城學府,2023-10-02,9822
2610,華航,10,4,6,元大-土城學府,2023-10-02,9822
3122,笙泉,8,2,6,元大-土城學府,2023-10-02,9822
6128,上福,13,7,6,元大-土城學府,2023-10-02,9822
00773B,中信優先金融債,5,0,5,元大-土城學府,2023-10-02,9822
1603,華電,10,5,5,元大-土城學府,2023-10-02,9822
1609,大亞,15,10,5,元大-土城學府,2023-10-02,9822
2204,中華,5,0,5,元大-土城學府,2023-10-02,9822
2495,普安,5,0,5,元大-土城學府,2023-10-02,9822
00637L,元大滬深300正2,57,0,57,元大-土城學府,2023-10-03,9822
6117,迎廣,63,13,50,元大-土城學府,2023-10-03,9822
0056,元大高股息,65,16,49,元大-土城學府,2023-10-03,9822
3276,宇環,50,1,49,元大-土城學府,2023-10-03,9822
00712,復華富時不動產,47,0,47,元大-土城學府,2023-10-03,9822
00878,國泰永續高股息,64,17,47,元大-土城學府,2023-10-03,9822
2002,中鋼,45,1,44,元大-土城學府,2023-10-03,9822
00931B,統一美債20年,42,0,42,元大-土城學府,2023-10-03,9822
00929,復華台灣科技優息,63,22,41,元大-土城學府,2023-10-03,9822
2409,友達,88,47,41,元大-土城學府,2023-10-03,9822
00919,群益台灣精選高息,41,1,40,元大-土城學府,2023-10-03,9822
9945,潤泰新,31,0,31,元大-土城學府,2023-10-03,9822
3264,欣銓,31,0,31,元大-土城學府,2023-10-03,9822
00922,國泰台灣領袖50,29,0,29,元大-土城學府,2023-10-03,9822
6449,鈺邦,27,0,27,元大-土城學府,2023-10-03,9822
3444,利機,23,0,23,元大-土城學府,2023-10-03,9822
00673R,期元大S＆P原油反1,22,1,21,元大-土城學府,2023-10-03,9822
00753L,中信中國50正2,21,0,21,元大-土城學府,2023-10-03,9822
3363,上詮,25,4,21,元大-土城學府,2023-10-03,9822
2891,中信金,21,0,21,元大-土城學府,2023-10-03,9822
00898,國泰基因免疫革命,20,0,20,元大-土城學府,2023-10-03,9822
00720B,元大投資級公司債,19,0,19,元大-土城學府,2023-10-03,9822
2402,毅嘉,28,10,18,元大-土城學府,2023-10-03,9822
3481,群創,16,0,16,元大-土城學府,2023-10-03,9822
00679B,元大美債20年,15,0,15,元大-土城學府,2023-10-03,9822
6235,華孚,30,15,15,元大-土城學府,2023-10-03,9822
00751B,元大AAA至A公司債,14,0,14,元大-土城學府,2023-10-03,9822
00665L,富邦�琤肭磪囓�2,14,0,14,元大-土城學府,2023-10-03,9822
00907,永豐優息存股,14,0,14,元大-土城學府,2023-10-03,9822
2458,義隆,13,0,13,元大-土城學府,2023-10-03,9822
00900,富邦特選高股息30,11,0,11,元大-土城學府,2023-10-03,9822
00882,中信中國高股息,11,0,11,元大-土城學府,2023-10-03,9822
1504,東元,11,0,11,元大-土城學府,2023-10-03,9822
1463,強盛新,10,0,10,元大-土城學府,2023-10-03,9822
2347,聯強,10,0,10,元大-土城學府,2023-10-03,9822
4906,正文,10,0,10,元大-土城學府,2023-10-03,9822
6120,達運,14,4,10,元大-土城學府,2023-10-03,9822
6288,聯嘉,19,9,10,元大-土城學府,2023-10-03,9822
8011,台通,10,0,10,元大-土城學府,2023-10-03,9822
8215,明基材,10,0,10,元大-土城學府,2023-10-03,9822
9958,世紀鋼,10,0,10,元大-土城學府,2023-10-03,9822
2303,聯電,10,1,9,元大-土城學府,2023-10-03,9822
3231,緯創,39,30,9,元大-土城學府,2023-10-03,9822
2867,三商壽,9,0,9,元大-土城學府,2023-10-03,9822
3013,晟銘電,63,54,9,元大-土城學府,2023-10-03,9822
5465,富驊,11,2,9,元大-土城學府,2023-10-03,9822
1815,富喬,21,12,9,元大-土城學府,2023-10-03,9822
1402,遠東新,8,0,8,元大-土城學府,2023-10-03,9822
1609,大亞,24,16,8,元大-土城學府,2023-10-03,9822
2367,燿華,10,2,8,元大-土城學府,2023-10-03,9822
3276,宇環,193,2,191,元大-土城學府,2023-10-04,9822
00632R,元大台灣50反1,74,5,69,元大-土城學府,2023-10-04,9822
5225,東科-KY,66,1,65,元大-土城學府,2023-10-04,9822
00712,復華富時不動產,64,0,64,元大-土城學府,2023-10-04,9822
2303,聯電,55,0,55,元大-土城學府,2023-10-04,9822
3481,群創,45,0,45,元大-土城學府,2023-10-04,9822
00679B,元大美債20年,46,5,41,元大-土城學府,2023-10-04,9822
1402,遠東新,39,0,39,元大-土城學府,2023-10-04,9822
00773B,中信優先金融債,33,0,33,元大-土城學府,2023-10-04,9822
6799,來頡,33,0,33,元大-土城學府,2023-10-04,9822
6451,訊芯-KY,80,49,31,元大-土城學府,2023-10-04,9822
0056,元大高股息,41,10,31,元大-土城學府,2023-10-04,9822
2480,敦陽科,29,0,29,元大-土城學府,2023-10-04,9822
2891,中信金,46,18,28,元大-土城學府,2023-10-04,9822
00878,國泰永續高股息,35,7,28,元大-土城學府,2023-10-04,9822
00720B,元大投資級公司債,27,0,27,元大-土城學府,2023-10-04,9822
2887,台新金,28,3,25,元大-土城學府,2023-10-04,9822
2883,凱基金,26,2,24,元大-土城學府,2023-10-04,9822
00922,國泰台灣領袖50,23,0,23,元大-土城學府,2023-10-04,9822
00929,復華台灣科技優息,40,19,21,元大-土城學府,2023-10-04,9822
2329,華泰,24,3,21,元大-土城學府,2023-10-04,9822
3231,緯創,38,18,20,元大-土城學府,2023-10-04,9822
5009,榮剛,20,0,20,元大-土城學府,2023-10-04,9822
1218,泰山,20,0,20,元大-土城學府,2023-10-04,9822
2002,中鋼,21,2,19,元大-土城學府,2023-10-04,9822
00772B,中信高評級公司債,18,0,18,元大-土城學府,2023-10-04,9822
2330,台積電,18,1,17,元大-土城學府,2023-10-04,9822
2412,中華電,16,0,16,元大-土城學府,2023-10-04,9822
2449,京元電子,21,5,16,元大-土城學府,2023-10-04,9822
2402,毅嘉,19,4,15,元大-土城學府,2023-10-04,9822
3006,晶豪科,21,7,14,元大-土城學府,2023-10-04,9822
2884,玉山金,16,3,13,元大-土城學府,2023-10-04,9822
2353,宏��,18,5,13,元大-土城學府,2023-10-04,9822
2885,元大金,12,0,12,元大-土城學府,2023-10-04,9822
2880,華南金,12,0,12,元大-土城學府,2023-10-04,9822
1802,台玻,13,1,12,元大-土城學府,2023-10-04,9822
2206,三陽工業,13,1,12,元大-土城學府,2023-10-04,9822
2337,旺宏,12,2,10,元大-土城學府,2023-10-04,9822
00885,富邦越南,10,0,10,元大-土城學府,2023-10-04,9822
00665L,富邦�琤肭磪囓�2,10,0,10,元大-土城學府,2023-10-04,9822
00932,兆豐永續高息等權,10,0,10,元大-土城學府,2023-10-04,9822
1603,華電,10,0,10,元大-土城學府,2023-10-04,9822
1815,富喬,14,4,10,元大-土城學府,2023-10-04,9822
3548,兆利,10,0,10,元大-土城學府,2023-10-04,9822
2881,富邦金,9,0,9,元大-土城學府,2023-10-04,9822
1524,耿鼎,17,8,9,元大-土城學府,2023-10-04,9822
00751B,元大AAA至A公司債,8,0,8,元大-土城學府,2023-10-04,9822
2419,仲琦,8,0,8,元大-土城學府,2023-10-04,9822
6223,旺矽,10,2,8,元大-土城學府,2023-10-04,9822
6770,力積電,10,2,8,元大-土城學府,2023-10-04,9822
3276,宇環,231,2,229,元大-土城學府,2023-10-05,9822
3715,定穎投控,216,114,102,元大-土城學府,2023-10-05,9822
00712,復華富時不動產,70,10,60,元大-土城學府,2023-10-05,9822
2025,千興,38,0,38,元大-土城學府,2023-10-05,9822
00773B,中信優先金融債,34,0,34,元大-土城學府,2023-10-05,9822
3694,海華,22,1,21,元大-土城學府,2023-10-05,9822
1584,精剛,21,1,20,元大-土城學府,2023-10-05,9822
1718,中纖,20,0,20,元大-土城學府,2023-10-05,9822
2542,興富發,20,0,20,元大-土城學府,2023-10-05,9822
6288,聯嘉,27,9,18,元大-土城學府,2023-10-05,9822
1101,台泥,16,0,16,元大-土城學府,2023-10-05,9822
00715L,期街口布蘭特正2,17,1,16,元大-土城學府,2023-10-05,9822
2316,楠梓電,16,1,15,元大-土城學府,2023-10-05,9822
2882,國泰金,15,3,12,元大-土城學府,2023-10-05,9822
00673R,期元大S＆P原油反1,12,0,12,元大-土城學府,2023-10-05,9822
4533,協易機,12,0,12,元大-土城學府,2023-10-05,9822
00929,復華台灣科技優息,19,8,11,元大-土城學府,2023-10-05,9822
2515,中工,11,0,11,元大-土城學府,2023-10-05,9822
1463,強盛新,10,0,10,元大-土城學府,2023-10-05,9822
6485,點序,10,0,10,元大-土城學府,2023-10-05,9822
6861,睿生光電,10,0,10,元大-土城學府,2023-10-05,9822
00642U,期元大S＆P石油,10,1,9,元大-土城學府,2023-10-05,9822
1437,勤益控,8,0,8,元大-土城學府,2023-10-05,9822
2355,敬鵬,15,7,8,元大-土城學府,2023-10-05,9822
4906,正文,8,0,8,元大-土城學府,2023-10-05,9822
8112,至上,9,1,8,元大-土城學府,2023-10-05,9822
2388,威盛,9,2,7,元大-土城學府,2023-10-05,9822
2881,富邦金,7,0,7,元大-土城學府,2023-10-05,9822
2417,圓剛,23,16,7,元大-土城學府,2023-10-05,9822
3081,聯亞,9,2,7,元大-土城學府,2023-10-05,9822
00751B,元大AAA至A公司債,6,0,6,元大-土城學府,2023-10-05,9822
2609,陽明,7,1,6,元大-土城學府,2023-10-05,9822
3032,偉訓,16,10,6,元大-土城學府,2023-10-05,9822
3037,欣興,12,6,6,元大-土城學府,2023-10-05,9822
2382,廣達,21,15,6,元大-土城學府,2023-10-05,9822
00919,群益台灣精選高息,10,4,6,元大-土城學府,2023-10-05,9822
2412,中華電,5,0,5,元大-土城學府,2023-10-05,9822
00902,中信電池及儲能,5,0,5,元大-土城學府,2023-10-05,9822
00882,中信中國高股息,5,0,5,元大-土城學府,2023-10-05,9822
1906,寶隆,5,0,5,元大-土城學府,2023-10-05,9822
2031,新光鋼,5,0,5,元大-土城學府,2023-10-05,9822
2640,大車隊,5,0,5,元大-土城學府,2023-10-05,9822
3630,新鉅科,5,0,5,元大-土城學府,2023-10-05,9822
4979,華星光,5,0,5,元大-土城學府,2023-10-05,9822
5871,中租-KY,5,0,5,元大-土城學府,2023-10-05,9822
1301,台塑,4,0,4,元大-土城學府,2023-10-05,9822
2002,中鋼,5,1,4,元大-土城學府,2023-10-05,9822
1308,亞聚,4,0,4,元大-土城學府,2023-10-05,9822
3005,神基,18,14,4,元大-土城學府,2023-10-05,9822
5392,能率,4,0,4,元大-土城學府,2023-10-05,9822
9950,萬國通,111,0,111,元大-土城學府,2023-10-06,9822
00929,復華台灣科技優息,78,6,72,元大-土城學府,2023-10-06,9822
00878,國泰永續高股息,35,1,34,元大-土城學府,2023-10-06,9822
8467,波力-KY,32,1,31,元大-土城學府,2023-10-06,9822
00720B,元大投資級公司債,26,0,26,元大-土城學府,2023-10-06,9822
00922,國泰台灣領袖50,27,1,26,元大-土城學府,2023-10-06,9822
3481,群創,26,1,25,元大-土城學府,2023-10-06,9822
00679B,元大美債20年,44,19,25,元大-土城學府,2023-10-06,9822
1514,亞力,24,4,20,元大-土城學府,2023-10-06,9822
1618,合機,20,0,20,元大-土城學府,2023-10-06,9822
2618,長榮航,25,5,20,元大-土城學府,2023-10-06,9822
5225,東科-KY,21,1,20,元大-土城學府,2023-10-06,9822
2363,矽統,91,71,20,元大-土城學府,2023-10-06,9822
3231,緯創,35,18,17,元大-土城學府,2023-10-06,9822
2417,圓剛,27,10,17,元大-土城學府,2023-10-06,9822
2883,凱基金,14,0,14,元大-土城學府,2023-10-06,9822
00919,群益台灣精選高息,13,0,13,元大-土城學府,2023-10-06,9822
00712,復華富時不動產,15,2,13,元大-土城學府,2023-10-06,9822
3260,威剛,22,9,13,元大-土城學府,2023-10-06,9822
2374,佳能,12,0,12,元大-土城學府,2023-10-06,9822
6139,亞翔,23,11,12,元大-土城學府,2023-10-06,9822
2409,友達,11,0,11,元大-土城學府,2023-10-06,9822
2371,大同,12,1,11,元大-土城學府,2023-10-06,9822
1402,遠東新,10,0,10,元大-土城學府,2023-10-06,9822
2888,新光金,11,1,10,元大-土城學府,2023-10-06,9822
4161,聿新科,10,0,10,元大-土城學府,2023-10-06,9822
6274,台燿,15,5,10,元大-土城學府,2023-10-06,9822
8054,安國,10,0,10,元大-土城學府,2023-10-06,9822
5351,鈺創,10,0,10,元大-土城學府,2023-10-06,9822
00715L,期街口布蘭特正2,9,0,9,元大-土城學府,2023-10-06,9822
2316,楠梓電,9,0,9,元大-土城學府,2023-10-06,9822
2402,毅嘉,17,8,9,元大-土城學府,2023-10-06,9822
6288,聯嘉,18,9,9,元大-土城學府,2023-10-06,9822
8097,常珵,9,0,9,元大-土城學府,2023-10-06,9822
0056,元大高股息,10,1,9,元大-土城學府,2023-10-06,9822
2427,三商電,14,6,8,元大-土城學府,2023-10-06,9822
2486,一詮,18,10,8,元大-土城學府,2023-10-06,9822
3014,聯陽,8,0,8,元大-土城學府,2023-10-06,9822
4906,正文,8,0,8,元大-土城學府,2023-10-06,9822
6451,訊芯-KY,12,5,7,元大-土城學府,2023-10-06,9822
1616,億泰,7,0,7,元大-土城學府,2023-10-06,9822
5483,中美晶,7,0,7,元大-土城學府,2023-10-06,9822
1101,台泥,6,0,6,元大-土城學府,2023-10-06,9822
6191,精成科,8,2,6,元大-土城學府,2023-10-06,9822
00751B,元大AAA至A公司債,6,0,6,元大-土城學府,2023-10-06,9822
2105,正新,6,0,6,元大-土城學府,2023-10-06,9822
8046,南電,6,0,6,元大-土城學府,2023-10-06,9822
2610,華航,5,0,5,元大-土城學府,2023-10-06,9822
3105,穩懋,5,0,5,元大-土城學府,2023-10-06,9822
1316,上曜,5,0,5,元大-土城學府,2023-10-06,9822
00679B,元大美債20年,121,3,118,元大-土城學府,2023-10-11,9822
6189,豐藝,81,2,79,元大-土城學府,2023-10-11,9822
3231,緯創,143,66,77,元大-土城學府,2023-10-11,9822
00632R,元大台灣50反1,54,0,54,元大-土城學府,2023-10-11,9822
3715,定穎投控,127,80,47,元大-土城學府,2023-10-11,9822
5521,工信,35,2,33,元大-土城學府,2023-10-11,9822
2356,英業達,47,18,29,元大-土城學府,2023-10-11,9822
2329,華泰,38,13,25,元大-土城學府,2023-10-11,9822
00919,群益台灣精選高息,29,5,24,元大-土城學府,2023-10-11,9822
2382,廣達,59,36,23,元大-土城學府,2023-10-11,9822
6550,北極星藥業-KY,22,0,22,元大-土城學府,2023-10-11,9822
2353,宏��,30,9,21,元大-土城學府,2023-10-11,9822
2515,中工,21,0,21,元大-土城學府,2023-10-11,9822
6191,精成科,22,3,19,元大-土城學府,2023-10-11,9822
5465,富驊,25,7,18,元大-土城學府,2023-10-11,9822
2603,長榮,17,0,17,元大-土城學府,2023-10-11,9822
2609,陽明,17,0,17,元大-土城學府,2023-10-11,9822
0056,元大高股息,22,5,17,元大-土城學府,2023-10-11,9822
1339,昭輝,23,6,17,元大-土城學府,2023-10-11,9822
2441,超豐,16,0,16,元大-土城學府,2023-10-11,9822
2374,佳能,15,0,15,元大-土城學府,2023-10-11,9822
2355,敬鵬,14,0,14,元大-土城學府,2023-10-11,9822
3006,晶豪科,46,34,12,元大-土城學府,2023-10-11,9822
00720B,元大投資級公司債,14,3,11,元大-土城學府,2023-10-11,9822
2476,鉅祥,11,0,11,元大-土城學府,2023-10-11,9822
4961,天鈺,11,0,11,元大-土城學府,2023-10-11,9822
2618,長榮航,17,6,11,元大-土城學府,2023-10-11,9822
1314,中石化,10,0,10,元大-土城學府,2023-10-11,9822
2031,新光鋼,10,0,10,元大-土城學府,2023-10-11,9822
3694,海華,10,0,10,元大-土城學府,2023-10-11,9822
5522,遠雄,10,0,10,元大-土城學府,2023-10-11,9822
6235,華孚,12,2,10,元大-土城學府,2023-10-11,9822
6122,擎邦,11,1,10,元大-土城學府,2023-10-11,9822
1517,利奇,9,0,9,元大-土城學府,2023-10-11,9822
1710,東聯,10,1,9,元大-土城學府,2023-10-11,9822
2630,亞航,16,7,9,元大-土城學府,2023-10-11,9822
2816,旺旺保,9,0,9,元大-土城學府,2023-10-11,9822
2427,三商電,9,1,8,元大-土城學府,2023-10-11,9822
6111,大宇資,8,0,8,元大-土城學府,2023-10-11,9822
3693,營邦,13,6,7,元大-土城學府,2023-10-11,9822
2331,精英,7,0,7,元大-土城學府,2023-10-11,9822
3540,曜越,7,0,7,元大-土城學府,2023-10-11,9822
8240,華宏,7,0,7,元大-土城學府,2023-10-11,9822
00715L,期街口布蘭特正2,8,2,6,元大-土城學府,2023-10-11,9822
2399,映泰,17,11,6,元大-土城學府,2023-10-11,9822
6120,達運,8,2,6,元大-土城學府,2023-10-11,9822
6156,松上,11,5,6,元大-土城學府,2023-10-11,9822
8044,網家,6,0,6,元大-土城學府,2023-10-11,9822
2887,台新金,20,15,5,元大-土城學府,2023-10-11,9822
6547,高端疫苗,5,0,5,元大-土城學府,2023-10-11,9822
2329,華泰,91,6,85,元大-土城學府,2023-10-12,9822
00720B,元大投資級公司債,59,11,48,元大-土城學府,2023-10-12,9822
00632R,元大台灣50反1,26,0,26,元大-土城學府,2023-10-12,9822
2352,佳世達,23,0,23,元大-土城學府,2023-10-12,9822
00919,群益台灣精選高息,22,1,21,元大-土城學府,2023-10-12,9822
1584,精剛,27,6,21,元大-土城學府,2023-10-12,9822
6189,豐藝,21,0,21,元大-土城學府,2023-10-12,9822
3363,上詮,22,2,20,元大-土城學府,2023-10-12,9822
00751B,元大AAA至A公司債,18,0,18,元大-土城學府,2023-10-12,9822
00929,復華台灣科技優息,24,6,18,元大-土城學府,2023-10-12,9822
3682,亞太電,15,0,15,元大-土城學府,2023-10-12,9822
2881,富邦金,15,1,14,元大-土城學府,2023-10-12,9822
00772B,中信高評級公司債,14,0,14,元大-土城學府,2023-10-12,9822
1618,合機,22,8,14,元大-土城學府,2023-10-12,9822
2363,矽統,106,94,12,元大-土城學府,2023-10-12,9822
1611,中電,12,0,12,元大-土城學府,2023-10-12,9822
4906,正文,12,0,12,元大-土城學府,2023-10-12,9822
2382,廣達,31,20,11,元大-土城學府,2023-10-12,9822
1718,中纖,10,0,10,元大-土城學府,2023-10-12,9822
6005,群益證,9,0,9,元大-土城學府,2023-10-12,9822
6695,芯鼎,9,0,9,元大-土城學府,2023-10-12,9822
2409,友達,14,6,8,元大-土城學府,2023-10-12,9822
1324,地球,21,13,8,元大-土城學府,2023-10-12,9822
2105,正新,13,5,8,元大-土城學府,2023-10-12,9822
2374,佳能,8,0,8,元大-土城學府,2023-10-12,9822
2472,立隆電,8,0,8,元大-土城學府,2023-10-12,9822
1201,味全,8,0,8,元大-土城學府,2023-10-12,9822
2515,中工,9,1,8,元大-土城學府,2023-10-12,9822
2449,京元電子,13,5,8,元大-土城學府,2023-10-12,9822
3615,安可,7,0,7,元大-土城學府,2023-10-12,9822
8076,伍豐,10,3,7,元大-土城學府,2023-10-12,9822
4102,永日,6,0,6,元大-土城學府,2023-10-12,9822
8222,寶一,11,5,6,元大-土城學府,2023-10-12,9822
3481,群創,6,0,6,元大-土城學府,2023-10-12,9822
00905,FT臺灣Smart,5,0,5,元大-土城學府,2023-10-12,9822
00673R,期元大S＆P原油反1,5,0,5,元大-土城學府,2023-10-12,9822
1810,和成,7,2,5,元大-土城學府,2023-10-12,9822
3576,聯合再生,6,1,5,元大-土城學府,2023-10-12,9822
5519,隆大,5,0,5,元大-土城學府,2023-10-12,9822
6122,擎邦,10,5,5,元大-土城學府,2023-10-12,9822
8044,網家,5,0,5,元大-土城學府,2023-10-12,9822
00893,國泰智能電動車,5,0,5,元大-土城學府,2023-10-12,9822
2412,中華電,4,0,4,元大-土城學府,2023-10-12,9822
3264,欣銓,5,1,4,元大-土城學府,2023-10-12,9822
6863,永道-KY,4,0,4,元大-土城學府,2023-10-12,9822
00715L,期街口布蘭特正2,3,0,3,元大-土城學府,2023-10-12,9822
1815,富喬,3,0,3,元大-土城學府,2023-10-12,9822
3013,晟銘電,16,13,3,元大-土城學府,2023-10-12,9822
3308,聯德,5,2,3,元大-土城學府,2023-10-12,9822
3346,麗清,3,0,3,元大-土城學府,2023-10-12,9822
2382,廣達,133,33,100,元大-土城學府,2023-10-13,9822
2301,光寶科,69,13,56,元大-土城學府,2023-10-13,9822
2344,華邦電,54,5,49,元大-土城學府,2023-10-13,9822
3078,僑威,56,8,48,元大-土城學府,2023-10-13,9822
4908,前鼎,77,34,43,元大-土城學府,2023-10-13,9822
3363,上詮,71,36,35,元大-土城學府,2023-10-13,9822
0056,元大高股息,34,0,34,元大-土城學府,2023-10-13,9822
00772B,中信高評級公司債,30,0,30,元大-土城學府,2023-10-13,9822
1905,華紙,36,7,29,元大-土城學府,2023-10-13,9822
6284,佳邦,39,12,27,元大-土城學府,2023-10-13,9822
00720B,元大投資級公司債,26,0,26,元大-土城學府,2023-10-13,9822
2353,宏��,28,4,24,元大-土城學府,2023-10-13,9822
00679B,元大美債20年,21,0,21,元大-土城學府,2023-10-13,9822
1718,中纖,20,0,20,元大-土城學府,2023-10-13,9822
1909,榮成,20,0,20,元大-土城學府,2023-10-13,9822
1568,倉佑,23,5,18,元大-土城學府,2023-10-13,9822
2329,華泰,37,19,18,元大-土城學府,2023-10-13,9822
2601,益航,18,0,18,元大-土城學府,2023-10-13,9822
9950,萬國通,20,2,18,元大-土城學府,2023-10-13,9822
00878,國泰永續高股息,17,0,17,元大-土城學府,2023-10-13,9822
3025,星通,37,21,16,元大-土城學府,2023-10-13,9822
6138,茂達,15,0,15,元大-土城學府,2023-10-13,9822
6863,永道-KY,15,0,15,元大-土城學府,2023-10-13,9822
2498,宏達電,14,0,14,元大-土城學府,2023-10-13,9822
00929,復華台灣科技優息,17,4,13,元大-土城學府,2023-10-13,9822
3325,旭品,15,2,13,元大-土城學府,2023-10-13,9822
6191,精成科,17,6,11,元大-土城學府,2023-10-13,9822
2610,華航,11,0,11,元大-土城學府,2023-10-13,9822
00632R,元大台灣50反1,11,0,11,元大-土城學府,2023-10-13,9822
00931B,統一美債20年,10,0,10,元大-土城學府,2023-10-13,9822
3048,益登,10,0,10,元大-土城學府,2023-10-13,9822
6757,台灣虎航,10,0,10,元大-土城學府,2023-10-13,9822
3037,欣興,20,10,10,元大-土城學府,2023-10-13,9822
5701,劍湖山,10,0,10,元大-土城學府,2023-10-13,9822
00919,群益台灣精選高息,10,1,9,元大-土城學府,2023-10-13,9822
2402,毅嘉,10,1,9,元大-土城學府,2023-10-13,9822
2615,萬海,10,1,9,元大-土城學府,2023-10-13,9822
2913,農林,9,0,9,元大-土城學府,2023-10-13,9822
9928,中視,9,0,9,元大-土城學府,2023-10-13,9822
1101,台泥,19,11,8,元大-土城學府,2023-10-13,9822
00715L,期街口布蘭特正2,9,1,8,元大-土城學府,2023-10-13,9822
3231,緯創,40,32,8,元大-土城學府,2023-10-13,9822
2376,技嘉,15,8,7,元大-土城學府,2023-10-13,9822
2881,富邦金,7,0,7,元大-土城學府,2023-10-13,9822
3715,定穎投控,36,29,7,元大-土城學府,2023-10-13,9822
00637L,元大滬深300正2,7,0,7,元大-土城學府,2023-10-13,9822
2390,云辰,7,0,7,元大-土城學府,2023-10-13,9822
2417,圓剛,7,0,7,元大-土城學府,2023-10-13,9822
4906,正文,7,0,7,元大-土城學府,2023-10-13,9822
5465,富驊,9,2,7,元大-土城學府,2023-10-13,9822
00878,國泰永續高股息,257,0,257,元大-土城學府,2023-10-16,9822
00929,復華台灣科技優息,152,5,147,元大-土城學府,2023-10-16,9822
2344,華邦電,62,3,59,元大-土城學府,2023-10-16,9822
4908,前鼎,115,57,58,元大-土城學府,2023-10-16,9822
2610,華航,54,3,51,元大-土城學府,2023-10-16,9822
0056,元大高股息,50,0,50,元大-土城學府,2023-10-16,9822
2233,宇隆,31,0,31,元大-土城學府,2023-10-16,9822
2376,技嘉,33,3,30,元大-土城學府,2023-10-16,9822
00632R,元大台灣50反1,36,11,25,元大-土城學府,2023-10-16,9822
3526,凡甲,24,0,24,元大-土城學府,2023-10-16,9822
2618,長榮航,27,4,23,元大-土城學府,2023-10-16,9822
2204,中華,22,0,22,元大-土城學府,2023-10-16,9822
6257,矽格,22,0,22,元大-土城學府,2023-10-16,9822
00919,群益台灣精選高息,24,3,21,元大-土城學府,2023-10-16,9822
2022,聚亨,20,0,20,元大-土城學府,2023-10-16,9822
2201,裕隆,33,14,19,元大-土城學府,2023-10-16,9822
00720B,元大投資級公司債,17,0,17,元大-土城學府,2023-10-16,9822
2002,中鋼,16,0,16,元大-土城學府,2023-10-16,9822
3706,神達,20,4,16,元大-土城學府,2023-10-16,9822
2515,中工,43,28,15,元大-土城學府,2023-10-16,9822
3264,欣銓,15,0,15,元大-土城學府,2023-10-16,9822
00673R,期元大S＆P原油反1,12,0,12,元大-土城學府,2023-10-16,9822
3265,台星科,13,1,12,元大-土城學府,2023-10-16,9822
020022,元大電動車N,10,0,10,元大-土城學府,2023-10-16,9822
00786B,元大10年IG銀行債,10,0,10,元大-土城學府,2023-10-16,9822
2425,承啟,16,6,10,元大-土城學府,2023-10-16,9822
6757,台灣虎航,10,0,10,元大-土城學府,2023-10-16,9822
3715,定穎投控,37,28,9,元大-土城學府,2023-10-16,9822
6220,岳豐,9,0,9,元大-土城學府,2023-10-16,9822
6451,訊芯-KY,12,3,9,元大-土城學府,2023-10-16,9822
2010,春源,8,0,8,元大-土城學府,2023-10-16,9822
2206,三陽工業,7,0,7,元大-土城學府,2023-10-16,9822
00713,元大台灣高息低波,7,0,7,元大-土城學府,2023-10-16,9822
1815,富喬,9,2,7,元大-土城學府,2023-10-16,9822
2417,圓剛,8,1,7,元大-土城學府,2023-10-16,9822
2501,國建,7,0,7,元大-土城學府,2023-10-16,9822
2913,農林,11,4,7,元大-土城學府,2023-10-16,9822
1605,華新,6,0,6,元大-土城學府,2023-10-16,9822
2486,一詮,9,3,6,元大-土城學府,2023-10-16,9822
4960,誠美材,15,9,6,元大-土城學府,2023-10-16,9822
5531,鄉林,6,0,6,元大-土城學府,2023-10-16,9822
6672,騰輝電子-KY,6,0,6,元大-土城學府,2023-10-16,9822
2324,仁寶,6,1,5,元大-土城學府,2023-10-16,9822
2363,矽統,136,131,5,元大-土城學府,2023-10-16,9822
00751B,元大AAA至A公司債,5,0,5,元大-土城學府,2023-10-16,9822
1218,泰山,10,5,5,元大-土城學府,2023-10-16,9822
2208,台船,5,0,5,元大-土城學府,2023-10-16,9822
2369,菱生,7,2,5,元大-土城學府,2023-10-16,9822
2498,宏達電,5,0,5,元大-土城學府,2023-10-16,9822
6138,茂達,5,0,5,元大-土城學府,2023-10-16,9822
00929,復華台灣科技優息,90,6,84,元大-土城學府,2023-10-17,9822
0056,元大高股息,78,0,78,元大-土城學府,2023-10-17,9822
6530,創威,75,2,73,元大-土城學府,2023-10-17,9822
00772B,中信高評級公司債,42,0,42,元大-土城學府,2023-10-17,9822
3276,宇環,51,10,41,元大-土城學府,2023-10-17,9822
2363,矽統,203,171,32,元大-土城學府,2023-10-17,9822
5225,東科-KY,30,0,30,元大-土城學府,2023-10-17,9822
5701,劍湖山,30,0,30,元大-土城學府,2023-10-17,9822
00687B,國泰20年美債,25,0,25,元大-土城學府,2023-10-17,9822
00720B,元大投資級公司債,25,0,25,元大-土城學府,2023-10-17,9822
6104,創惟,27,2,25,元大-土城學府,2023-10-17,9822
3715,定穎投控,62,38,24,元大-土城學府,2023-10-17,9822
8048,德勝,25,5,20,元大-土城學府,2023-10-17,9822
2352,佳世達,19,0,19,元大-土城學府,2023-10-17,9822
2031,新光鋼,17,0,17,元大-土城學府,2023-10-17,9822
2883,凱基金,16,0,16,元大-土城學府,2023-10-17,9822
2317,鴻海,15,0,15,元大-土城學府,2023-10-17,9822
3324,雙鴻,23,8,15,元大-土城學府,2023-10-17,9822
3481,群創,16,2,14,元大-土城學府,2023-10-17,9822
00751B,元大AAA至A公司債,12,0,12,元大-土城學府,2023-10-17,9822
00919,群益台灣精選高息,15,3,12,元大-土城學府,2023-10-17,9822
3163,波若威,16,5,11,元大-土城學府,2023-10-17,9822
8176,智捷,14,3,11,元大-土城學府,2023-10-17,9822
00753L,中信中國50正2,10,0,10,元大-土城學府,2023-10-17,9822
00673R,期元大S＆P原油反1,10,0,10,元大-土城學府,2023-10-17,9822
2338,光罩,10,0,10,元大-土城學府,2023-10-17,9822
4157,太景*-KY,10,0,10,元大-土城學府,2023-10-17,9822
00642U,期元大S＆P石油,10,0,10,元大-土城學府,2023-10-17,9822
4908,前鼎,41,31,10,元大-土城學府,2023-10-17,9822
00679B,元大美債20年,9,0,9,元大-土城學府,2023-10-17,9822
2610,華航,14,5,9,元大-土城學府,2023-10-17,9822
1519,華城,11,2,9,元大-土城學府,2023-10-17,9822
2233,宇隆,12,3,9,元大-土城學府,2023-10-17,9822
6469,大樹,7,0,7,元大-土城學府,2023-10-17,9822
00680L,元大美債20正2,7,0,7,元大-土城學府,2023-10-17,9822
2887,台新金,7,0,7,元大-土城學府,2023-10-17,9822
2356,英業達,18,11,7,元大-土城學府,2023-10-17,9822
3094,聯傑,9,2,7,元大-土城學府,2023-10-17,9822
6282,康舒,7,0,7,元大-土城學府,2023-10-17,9822
3037,欣興,7,0,7,元大-土城學府,2023-10-17,9822
1319,東陽,8,1,7,元大-土城學府,2023-10-17,9822
3078,僑威,19,12,7,元大-土城學府,2023-10-17,9822
2618,長榮航,32,26,6,元大-土城學府,2023-10-17,9822
1609,大亞,6,0,6,元大-土城學府,2023-10-17,9822
00878,國泰永續高股息,12,6,6,元大-土城學府,2023-10-17,9822
4979,華星光,10,4,6,元大-土城學府,2023-10-17,9822
2891,中信金,5,0,5,元大-土城學府,2023-10-17,9822
2425,承啟,15,10,5,元大-土城學府,2023-10-17,9822
020038,元大ESG配息N,5,0,5,元大-土城學府,2023-10-17,9822
1612,宏泰,5,0,5,元大-土城學府,2023-10-17,9822
2609,陽明,173,1,172,元大-土城學府,2023-10-18,9822
0056,元大高股息,158,5,153,元大-土城學府,2023-10-18,9822
2002,中鋼,116,0,116,元大-土城學府,2023-10-18,9822
00929,復華台灣科技優息,149,74,75,元大-土城學府,2023-10-18,9822
00878,國泰永續高股息,87,17,70,元大-土城學府,2023-10-18,9822
00919,群益台灣精選高息,60,0,60,元大-土城學府,2023-10-18,9822
5701,劍湖山,55,0,55,元大-土城學府,2023-10-18,9822
00922,國泰台灣領袖50,45,0,45,元大-土城學府,2023-10-18,9822
2031,新光鋼,40,0,40,元大-土城學府,2023-10-18,9822
5225,東科-KY,40,3,37,元大-土城學府,2023-10-18,9822
2353,宏��,34,3,31,元大-土城學府,2023-10-18,9822
2449,京元電子,31,1,30,元大-土城學府,2023-10-18,9822
00679B,元大美債20年,29,0,29,元大-土城學府,2023-10-18,9822
2363,矽統,47,20,27,元大-土城學府,2023-10-18,9822
3078,僑威,25,0,25,元大-土城學府,2023-10-18,9822
020039,元大加權N,24,0,24,元大-土城學府,2023-10-18,9822
2010,春源,22,0,22,元大-土城學府,2023-10-18,9822
2388,威盛,128,107,21,元大-土城學府,2023-10-18,9822
00725B,國泰投資級公司債,20,0,20,元大-土城學府,2023-10-18,9822
3499,環天科,21,1,20,元大-土城學府,2023-10-18,9822
3704,合勤控,22,2,20,元大-土城學府,2023-10-18,9822
6202,盛群,20,0,20,元大-土城學府,2023-10-18,9822
6770,力積電,22,3,19,元大-土城學府,2023-10-18,9822
1101,台泥,19,1,18,元大-土城學府,2023-10-18,9822
2374,佳能,17,0,17,元大-土城學府,2023-10-18,9822
2610,華航,25,9,16,元大-土城學府,2023-10-18,9822
2313,華通,31,15,16,元大-土城學府,2023-10-18,9822
2913,農林,15,0,15,元大-土城學府,2023-10-18,9822
4908,前鼎,53,38,15,元大-土城學府,2023-10-18,9822
00772B,中信高評級公司債,13,0,13,元大-土城學府,2023-10-18,9822
1584,精剛,17,4,13,元大-土城學府,2023-10-18,9822
2352,佳世達,16,3,13,元大-土城學府,2023-10-18,9822
3701,大眾控,14,1,13,元大-土城學府,2023-10-18,9822
00632R,元大台灣50反1,12,0,12,元大-土城學府,2023-10-18,9822
00673R,期元大S＆P原油反1,11,0,11,元大-土城學府,2023-10-18,9822
2618,長榮航,20,9,11,元大-土城學府,2023-10-18,9822
2382,廣達,35,24,11,元大-土城學府,2023-10-18,9822
5258,虹堡,11,1,10,元大-土城學府,2023-10-18,9822
6592,和潤企業,10,0,10,元大-土城學府,2023-10-18,9822
8215,明基材,10,0,10,元大-土城學府,2023-10-18,9822
00687B,國泰20年美債,9,0,9,元大-土城學府,2023-10-18,9822
1102,亞泥,9,0,9,元大-土城學府,2023-10-18,9822
2399,映泰,10,1,9,元大-土城學府,2023-10-18,9822
2486,一詮,13,4,9,元大-土城學府,2023-10-18,9822
3013,晟銘電,9,0,9,元大-土城學府,2023-10-18,9822
5009,榮剛,10,1,9,元大-土城學府,2023-10-18,9822
6485,點序,10,1,9,元大-土城學府,2023-10-18,9822
3017,奇鋐,10,2,8,元大-土城學府,2023-10-18,9822
3324,雙鴻,19,11,8,元大-土城學府,2023-10-18,9822
00931B,統一美債20年,8,0,8,元大-土城學府,2023-10-18,9822
0056,元大高股息,130,6,124,元大-土城學府,2023-10-19,9822
6290,良維,86,0,86,元大-土城學府,2023-10-19,9822
00933B,國泰10Y+金融債,69,0,69,元大-土城學府,2023-10-19,9822
4552,力達-KY,51,1,50,元大-土城學府,2023-10-19,9822
6237,驊訊,66,22,44,元大-土城學府,2023-10-19,9822
00632R,元大台灣50反1,42,0,42,元大-土城學府,2023-10-19,9822
1101,台泥,38,2,36,元大-土城學府,2023-10-19,9822
00878,國泰永續高股息,69,33,36,元大-土城學府,2023-10-19,9822
00929,復華台灣科技優息,35,3,32,元大-土城學府,2023-10-19,9822
5521,工信,31,0,31,元大-土城學府,2023-10-19,9822
6451,訊芯-KY,35,5,30,元大-土城學府,2023-10-19,9822
00687B,國泰20年美債,29,0,29,元大-土城學府,2023-10-19,9822
2337,旺宏,32,3,29,元大-土城學府,2023-10-19,9822
6142,友勁,25,0,25,元大-土城學府,2023-10-19,9822
6770,力積電,24,0,24,元大-土城學府,2023-10-19,9822
00885,富邦越南,23,0,23,元大-土城學府,2023-10-19,9822
6443,元晶,21,0,21,元大-土城學府,2023-10-19,9822
00897,富邦基因免疫生技,20,0,20,元大-土城學府,2023-10-19,9822
2705,六福,20,0,20,元大-土城學府,2023-10-19,9822
3583,辛耘,20,0,20,元大-土城學府,2023-10-19,9822
00712,復華富時不動產,19,1,18,元大-土城學府,2023-10-19,9822
2301,光寶科,21,4,17,元大-土城學府,2023-10-19,9822
2353,宏��,33,16,17,元大-土城學府,2023-10-19,9822
2388,威盛,22,5,17,元大-土城學府,2023-10-19,9822
2867,三商壽,16,0,16,元大-土城學府,2023-10-19,9822
00720B,元大投資級公司債,16,0,16,元大-土城學府,2023-10-19,9822
2317,鴻海,16,1,15,元大-土城學府,2023-10-19,9822
00922,國泰台灣領袖50,26,11,15,元大-土城學府,2023-10-19,9822
4908,前鼎,36,22,14,元大-土城學府,2023-10-19,9822
6753,龍德造船,14,0,14,元大-土城學府,2023-10-19,9822
00679B,元大美債20年,13,0,13,元大-土城學府,2023-10-19,9822
00772B,中信高評級公司債,13,0,13,元大-土城學府,2023-10-19,9822
2002,中鋼,13,0,13,元大-土城學府,2023-10-19,9822
2888,新光金,13,0,13,元大-土城學府,2023-10-19,9822
2355,敬鵬,11,0,11,元大-土城學府,2023-10-19,9822
2486,一詮,13,2,11,元大-土城學府,2023-10-19,9822
6156,松上,12,1,11,元大-土城學府,2023-10-19,9822
020039,元大加權N,10,0,10,元大-土城學府,2023-10-19,9822
1465,偉全,10,0,10,元大-土城學府,2023-10-19,9822
2010,春源,10,0,10,元大-土城學府,2023-10-19,9822
2461,光群雷,10,0,10,元大-土城學府,2023-10-19,9822
2634,漢翔,11,1,10,元大-土城學府,2023-10-19,9822
2883,凱基金,10,0,10,元大-土城學府,2023-10-19,9822
2905,三商,10,0,10,元大-土城學府,2023-10-19,9822
4167,松瑞藥,11,1,10,元大-土城學府,2023-10-19,9822
00680L,元大美債20正2,9,0,9,元大-土城學府,2023-10-19,9822
00722B,群益投資級電信債,9,0,9,元大-土城學府,2023-10-19,9822
6530,創威,37,28,9,元大-土城學府,2023-10-19,9822
00673R,期元大S＆P原油反1,8,0,8,元大-土城學府,2023-10-19,9822
2885,元大金,8,0,8,元大-土城學府,2023-10-19,9822
00929,復華台灣科技優息,100,4,96,元大-土城學府,2023-10-20,9822
00897,富邦基因免疫生技,85,0,85,元大-土城學府,2023-10-20,9822
6290,良維,85,8,77,元大-土城學府,2023-10-20,9822
4552,力達-KY,76,0,76,元大-土城學府,2023-10-20,9822
00712,復華富時不動產,63,0,63,元大-土城學府,2023-10-20,9822
0056,元大高股息,76,17,59,元大-土城學府,2023-10-20,9822
1402,遠東新,46,0,46,元大-土城學府,2023-10-20,9822
6237,驊訊,43,10,33,元大-土城學府,2023-10-20,9822
00878,國泰永續高股息,65,34,31,元大-土城學府,2023-10-20,9822
00632R,元大台灣50反1,44,13,31,元大-土城學府,2023-10-20,9822
2885,元大金,27,0,27,元大-土城學府,2023-10-20,9822
2317,鴻海,19,0,19,元大-土城學府,2023-10-20,9822
00673R,期元大S＆P原油反1,18,0,18,元大-土城學府,2023-10-20,9822
00772B,中信高評級公司債,18,2,16,元大-土城學府,2023-10-20,9822
2816,旺旺保,19,3,16,元大-土城學府,2023-10-20,9822
5351,鈺創,18,2,16,元大-土城學府,2023-10-20,9822
00715L,期街口布蘭特正2,35,20,15,元大-土城學府,2023-10-20,9822
2427,三商電,16,1,15,元大-土城學府,2023-10-20,9822
3264,欣銓,20,5,15,元大-土城學府,2023-10-20,9822
2884,玉山金,15,0,15,元大-土城學府,2023-10-20,9822
2303,聯電,122,108,14,元大-土城學府,2023-10-20,9822
2498,宏達電,15,1,14,元大-土城學府,2023-10-20,9822
00687B,國泰20年美債,13,0,13,元大-土城學府,2023-10-20,9822
00679B,元大美債20年,13,0,13,元大-土城學府,2023-10-20,9822
2618,長榮航,16,3,13,元大-土城學府,2023-10-20,9822
2705,六福,13,0,13,元大-土城學府,2023-10-20,9822
00919,群益台灣精選高息,22,10,12,元大-土城學府,2023-10-20,9822
2867,三商壽,12,0,12,元大-土城學府,2023-10-20,9822
9950,萬國通,14,2,12,元大-土城學府,2023-10-20,9822
1101,台泥,11,0,11,元大-土城學府,2023-10-20,9822
2324,仁寶,12,1,11,元大-土城學府,2023-10-20,9822
00922,國泰台灣領袖50,11,0,11,元大-土城學府,2023-10-20,9822
2349,錸德,10,0,10,元大-土城學府,2023-10-20,9822
2610,華航,15,5,10,元大-土城學府,2023-10-20,9822
3682,亞太電,10,0,10,元大-土城學府,2023-10-20,9822
6142,友勁,10,0,10,元大-土城學府,2023-10-20,9822
3481,群創,12,3,9,元大-土城學府,2023-10-20,9822
00720B,元大投資級公司債,9,0,9,元大-土城學府,2023-10-20,9822
2890,永豐金,10,1,9,元大-土城學府,2023-10-20,9822
2891,中信金,17,8,9,元大-土城學府,2023-10-20,9822
6770,力積電,13,4,9,元大-土城學府,2023-10-20,9822
2344,華邦電,8,0,8,元大-土城學府,2023-10-20,9822
2305,全友,8,0,8,元大-土城學府,2023-10-20,9822
2374,佳能,8,0,8,元大-土城學府,2023-10-20,9822
3703,欣陸,8,0,8,元大-土城學府,2023-10-20,9822
2204,中華,11,3,8,元大-土城學府,2023-10-20,9822
6139,亞翔,15,8,7,元大-土城學府,2023-10-20,9822
2887,台新金,7,0,7,元大-土城學府,2023-10-20,9822
2886,兆豐金,7,0,7,元大-土城學府,2023-10-20,9822
3025,星通,61,54,7,元大-土城學府,2023-10-20,9822
0056,元大高股息,139,3,136,元大-土城學府,2023-10-23,9822
00929,復華台灣科技優息,88,2,86,元大-土城學府,2023-10-23,9822
00712,復華富時不動產,57,0,57,元大-土城學府,2023-10-23,9822
2317,鴻海,46,15,31,元大-土城學府,2023-10-23,9822
00878,國泰永續高股息,72,42,30,元大-土城學府,2023-10-23,9822
00922,國泰台灣領袖50,27,0,27,元大-土城學府,2023-10-23,9822
2002,中鋼,26,0,26,元大-土城學府,2023-10-23,9822
2462,良得電,28,2,26,元大-土城學府,2023-10-23,9822
1101,台泥,25,0,25,元大-土城學府,2023-10-23,9822
6290,良維,23,0,23,元大-土城學府,2023-10-23,9822
2891,中信金,22,1,21,元大-土城學府,2023-10-23,9822
3704,合勤控,31,10,21,元大-土城學府,2023-10-23,9822
2449,京元電子,87,67,20,元大-土城學府,2023-10-23,9822
1568,倉佑,27,7,20,元大-土城學府,2023-10-23,9822
2353,宏��,20,0,20,元大-土城學府,2023-10-23,9822
2634,漢翔,21,1,20,元大-土城學府,2023-10-23,9822
3374,精材,20,0,20,元大-土城學府,2023-10-23,9822
3376,新日興,21,2,19,元大-土城學府,2023-10-23,9822
6237,驊訊,32,13,19,元大-土城學府,2023-10-23,9822
00772B,中信高評級公司債,17,0,17,元大-土城學府,2023-10-23,9822
9950,萬國通,30,13,17,元大-土城學府,2023-10-23,9822
2363,矽統,30,16,14,元大-土城學府,2023-10-23,9822
6168,宏齊,23,10,13,元大-土城學府,2023-10-23,9822
00715L,期街口布蘭特正2,12,0,12,元大-土城學府,2023-10-23,9822
1609,大亞,14,2,12,元大-土城學府,2023-10-23,9822
2892,第一金,11,0,11,元大-土城學府,2023-10-23,9822
00900,富邦特選高股息30,11,0,11,元大-土城學府,2023-10-23,9822
2402,毅嘉,28,18,10,元大-土城學府,2023-10-23,9822
3548,兆利,20,10,10,元大-土城學府,2023-10-23,9822
3481,群創,9,0,9,元大-土城學府,2023-10-23,9822
6156,松上,10,1,9,元大-土城學府,2023-10-23,9822
3105,穩懋,8,0,8,元大-土城學府,2023-10-23,9822
3231,緯創,25,17,8,元大-土城學府,2023-10-23,9822
00933B,國泰10Y+金融債,8,0,8,元大-土城學府,2023-10-23,9822
1524,耿鼎,9,1,8,元大-土城學府,2023-10-23,9822
00679B,元大美債20年,7,0,7,元大-土城學府,2023-10-23,9822
1785,光洋科,13,6,7,元大-土城學府,2023-10-23,9822
2027,大成鋼,8,1,7,元大-土城學府,2023-10-23,9822
2354,鴻準,8,1,7,元大-土城學府,2023-10-23,9822
1319,東陽,8,2,6,元大-土城學府,2023-10-23,9822
00882,中信中國高股息,8,2,6,元大-土城學府,2023-10-23,9822
1723,中碳,6,0,6,元大-土城學府,2023-10-23,9822
3557,嘉威,6,0,6,元大-土城學府,2023-10-23,9822
6753,龍德造船,6,0,6,元大-土城學府,2023-10-23,9822
3037,欣興,6,0,6,元大-土城學府,2023-10-23,9822
00881,國泰台灣5G+,5,0,5,元大-土城學府,2023-10-23,9822
8069,元太,6,1,5,元大-土城學府,2023-10-23,9822
00665L,富邦�琤肭磪囓�2,5,0,5,元大-土城學府,2023-10-23,9822
2201,裕隆,11,6,5,元大-土城學府,2023-10-23,9822
2324,仁寶,5,0,5,元大-土城學府,2023-10-23,9822
00929,復華台灣科技優息,121,8,113,元大-土城學府,2023-10-24,9822
1101,台泥,72,1,71,元大-土城學府,2023-10-24,9822
2449,京元電子,73,20,53,元大-土城學府,2023-10-24,9822
6292,迅德,55,2,53,元大-土城學府,2023-10-24,9822
2888,新光金,52,0,52,元大-土城學府,2023-10-24,9822
00679B,元大美債20年,33,0,33,元大-土城學府,2023-10-24,9822
9950,萬國通,30,2,28,元大-土城學府,2023-10-24,9822
00878,國泰永續高股息,31,5,26,元大-土城學府,2023-10-24,9822
00897,富邦基因免疫生技,25,0,25,元大-土城學府,2023-10-24,9822
2369,菱生,54,30,24,元大-土城學府,2023-10-24,9822
00712,復華富時不動產,21,0,21,元大-土城學府,2023-10-24,9822
00751B,元大AAA至A公司債,20,0,20,元大-土城學府,2023-10-24,9822
1314,中石化,20,0,20,元大-土城學府,2023-10-24,9822
00715L,期街口布蘭特正2,19,0,19,元大-土城學府,2023-10-24,9822
2303,聯電,65,48,17,元大-土城學府,2023-10-24,9822
00931B,統一美債20年,17,0,17,元大-土城學府,2023-10-24,9822
1522,堤維西,17,1,16,元大-土城學府,2023-10-24,9822
3715,定穎投控,45,29,16,元大-土城學府,2023-10-24,9822
00888,永豐台灣ESG,15,0,15,元大-土城學府,2023-10-24,9822
2515,中工,35,20,15,元大-土城學府,2023-10-24,9822
3260,威剛,18,3,15,元大-土城學府,2023-10-24,9822
5880,合庫金,13,0,13,元大-土城學府,2023-10-24,9822
2417,圓剛,15,2,13,元大-土城學府,2023-10-24,9822
2618,長榮航,44,31,13,元大-土城學府,2023-10-24,9822
2363,矽統,18,5,13,元大-土城學府,2023-10-24,9822
6695,芯鼎,15,3,12,元大-土城學府,2023-10-24,9822
6290,良維,13,1,12,元大-土城學府,2023-10-24,9822
2376,技嘉,11,0,11,元大-土城學府,2023-10-24,9822
2884,玉山金,10,0,10,元大-土城學府,2023-10-24,9822
1447,力鵬,10,0,10,元大-土城學府,2023-10-24,9822
5347,世界,14,4,10,元大-土城學府,2023-10-24,9822
6531,愛普*,12,2,10,元大-土城學府,2023-10-24,9822
2002,中鋼,9,0,9,元大-土城學府,2023-10-24,9822
2891,中信金,8,0,8,元大-土城學府,2023-10-24,9822
00919,群益台灣精選高息,19,11,8,元大-土城學府,2023-10-24,9822
2887,台新金,7,0,7,元大-土城學府,2023-10-24,9822
2834,臺企銀,7,0,7,元大-土城學府,2023-10-24,9822
3051,力特,53,46,7,元大-土城學府,2023-10-24,9822
3548,兆利,9,2,7,元大-土城學府,2023-10-24,9822
2458,義隆,7,0,7,元大-土城學府,2023-10-24,9822
0056,元大高股息,11,5,6,元大-土城學府,2023-10-24,9822
2354,鴻準,6,0,6,元大-土城學府,2023-10-24,9822
3041,揚智,14,8,6,元大-土城學府,2023-10-24,9822
5388,中磊,6,0,6,元大-土城學府,2023-10-24,9822
2206,三陽工業,8,3,5,元大-土城學府,2023-10-24,9822
00673R,期元大S＆P原油反1,5,0,5,元大-土城學府,2023-10-24,9822
00632R,元大台灣50反1,30,25,5,元大-土城學府,2023-10-24,9822
00915,凱基優選高股息30,5,0,5,元大-土城學府,2023-10-24,9822
020039,元大加權N,6,1,5,元大-土城學府,2023-10-24,9822
2408,南亞科,6,1,5,元大-土城學府,2023-10-24,9822
6197,佳必琪,106,18,88,元大-土城學府,2023-10-25,9822
8110,華東,84,6,78,元大-土城學府,2023-10-25,9822
6292,迅德,62,0,62,元大-土城學府,2023-10-25,9822
00929,復華台灣科技優息,81,26,55,元大-土城學府,2023-10-25,9822
00712,復華富時不動產,47,1,46,元大-土城學府,2023-10-25,9822
2409,友達,26,2,24,元大-土城學府,2023-10-25,9822
00680L,元大美債20正2,20,0,20,元大-土城學府,2023-10-25,9822
00679B,元大美債20年,21,1,20,元大-土城學府,2023-10-25,9822
1727,中華化,21,1,20,元大-土城學府,2023-10-25,9822
2380,虹光,20,0,20,元大-土城學府,2023-10-25,9822
2356,英業達,28,9,19,元大-土城學府,2023-10-25,9822
00882,中信中國高股息,20,1,19,元大-土城學府,2023-10-25,9822
6129,普誠,20,2,18,元大-土城學府,2023-10-25,9822
4908,前鼎,26,11,15,元大-土城學府,2023-10-25,9822
3231,緯創,33,18,15,元大-土城學府,2023-10-25,9822
1532,勤美,15,0,15,元大-土城學府,2023-10-25,9822
6257,矽格,16,1,15,元大-土城學府,2023-10-25,9822
2458,義隆,18,4,14,元大-土城學府,2023-10-25,9822
3363,上詮,19,6,13,元大-土城學府,2023-10-25,9822
2337,旺宏,16,4,12,元大-土城學府,2023-10-25,9822
1524,耿鼎,71,59,12,元大-土城學府,2023-10-25,9822
5701,劍湖山,11,0,11,元大-土城學府,2023-10-25,9822
00931B,統一美債20年,10,0,10,元大-土城學府,2023-10-25,9822
1314,中石化,10,0,10,元大-土城學府,2023-10-25,9822
1718,中纖,10,0,10,元大-土城學府,2023-10-25,9822
2312,金寶,12,2,10,元大-土城學府,2023-10-25,9822
5521,工信,10,0,10,元大-土城學府,2023-10-25,9822
2317,鴻海,17,7,10,元大-土城學府,2023-10-25,9822
2743,山富,9,0,9,元大-土城學府,2023-10-25,9822
8088,品安,20,11,9,元大-土城學府,2023-10-25,9822
2344,華邦電,11,3,8,元大-土城學府,2023-10-25,9822
2913,農林,8,0,8,元大-土城學府,2023-10-25,9822
8048,德勝,8,0,8,元大-土城學府,2023-10-25,9822
0056,元大高股息,11,4,7,元大-土城學府,2023-10-25,9822
00921,兆豐龍頭等權重,7,0,7,元大-土城學府,2023-10-25,9822
1618,合機,13,6,7,元大-土城學府,2023-10-25,9822
1815,富喬,16,9,7,元大-土城學府,2023-10-25,9822
2349,錸德,7,0,7,元大-土城學府,2023-10-25,9822
3535,晶彩科,8,1,7,元大-土城學府,2023-10-25,9822
3221,台嘉碩,6,0,6,元大-土城學府,2023-10-25,9822
4714,永捷,6,0,6,元大-土城學府,2023-10-25,9822
8050,廣積,7,1,6,元大-土城學府,2023-10-25,9822
1101,台泥,6,0,6,元大-土城學府,2023-10-25,9822
1710,東聯,5,0,5,元大-土城學府,2023-10-25,9822
2453,凌群,6,1,5,元大-土城學府,2023-10-25,9822
2462,良得電,7,2,5,元大-土城學府,2023-10-25,9822
2485,兆赫,9,4,5,元大-土城學府,2023-10-25,9822
2498,宏達電,6,1,5,元大-土城學府,2023-10-25,9822
2633,台灣高鐵,5,0,5,元大-土城學府,2023-10-25,9822
2887,台新金,5,0,5,元大-土城學府,2023-10-25,9822
00712,復華富時不動產,100,0,100,元大-土城學府,2023-10-26,9822
00929,復華台灣科技優息,135,51,84,元大-土城學府,2023-10-26,9822
1524,耿鼎,120,37,83,元大-土城學府,2023-10-26,9822
00885,富邦越南,78,0,78,元大-土城學府,2023-10-26,9822
2317,鴻海,51,1,50,元大-土城學府,2023-10-26,9822
2303,聯電,70,26,44,元大-土城學府,2023-10-26,9822
00878,國泰永續高股息,72,30,42,元大-土城學府,2023-10-26,9822
6197,佳必琪,43,1,42,元大-土城學府,2023-10-26,9822
2427,三商電,42,5,37,元大-土城學府,2023-10-26,9822
00679B,元大美債20年,32,0,32,元大-土城學府,2023-10-26,9822
0056,元大高股息,33,1,32,元大-土城學府,2023-10-26,9822
2344,華邦電,36,5,31,元大-土城學府,2023-10-26,9822
2520,冠德,30,0,30,元大-土城學府,2023-10-26,9822
5701,劍湖山,30,0,30,元大-土城學府,2023-10-26,9822
00919,群益台灣精選高息,27,0,27,元大-土城學府,2023-10-26,9822
2515,中工,30,6,24,元大-土城學府,2023-10-26,9822
0050,元大台灣50,24,2,22,元大-土城學府,2023-10-26,9822
00687B,國泰20年美債,17,0,17,元大-土城學府,2023-10-26,9822
00922,國泰台灣領袖50,14,0,14,元大-土城學府,2023-10-26,9822
2363,矽統,13,1,12,元大-土城學府,2023-10-26,9822
4552,力達-KY,12,0,12,元大-土城學府,2023-10-26,9822
4714,永捷,14,2,12,元大-土城學府,2023-10-26,9822
9105,泰金寶-DR,11,0,11,元大-土城學府,2023-10-26,9822
5880,合庫金,10,0,10,元大-土城學府,2023-10-26,9822
1522,堤維西,11,1,10,元大-土城學府,2023-10-26,9822
2340,台亞,10,0,10,元大-土城學府,2023-10-26,9822
3545,敦泰,10,0,10,元大-土城學府,2023-10-26,9822
1568,倉佑,11,2,9,元大-土城學府,2023-10-26,9822
3481,群創,10,1,9,元大-土城學府,2023-10-26,9822
2465,麗臺,8,0,8,元大-土城學府,2023-10-26,9822
3025,星通,24,16,8,元大-土城學府,2023-10-26,9822
3715,定穎投控,27,19,8,元大-土城學府,2023-10-26,9822
5465,富驊,10,2,8,元大-土城學府,2023-10-26,9822
2884,玉山金,8,1,7,元大-土城學府,2023-10-26,9822
5871,中租-KY,8,0,8,元大-土城學府,2023-10-26,9822
006208,富邦台50,8,0,8,元大-土城學府,2023-10-26,9822
1721,三晃,202,195,7,元大-土城學府,2023-10-26,9822
2855,統一證,7,0,7,元大-土城學府,2023-10-26,9822
3294,英濟,8,1,7,元大-土城學府,2023-10-26,9822
3704,合勤控,7,0,7,元大-土城學府,2023-10-26,9822
6114,久威,9,2,7,元大-土城學府,2023-10-26,9822
2337,旺宏,8,2,6,元大-土城學府,2023-10-26,9822
2305,全友,6,0,6,元大-土城學府,2023-10-26,9822
2338,光罩,6,0,6,元大-土城學府,2023-10-26,9822
2374,佳能,6,0,6,元大-土城學府,2023-10-26,9822
4173,久裕,6,0,6,元大-土城學府,2023-10-26,9822
3037,欣興,6,0,6,元大-土城學府,2023-10-26,9822
00713,元大台灣高息低波,5,0,5,元大-土城學府,2023-10-26,9822
2328,廣宇,5,0,5,元大-土城學府,2023-10-26,9822
00680L,元大美債20正2,5,0,5,元大-土城學府,2023-10-26,9822
1524,耿鼎,168,16,152,元大-土城學府,2023-10-27,9822
00929,復華台灣科技優息,70,0,70,元大-土城學府,2023-10-27,9822
2888,新光金,52,0,52,元大-土城學府,2023-10-27,9822
2317,鴻海,41,1,40,元大-土城學府,2023-10-27,9822
2303,聯電,34,7,27,元大-土城學府,2023-10-27,9822
00919,群益台灣精選高息,24,2,22,元大-土城學府,2023-10-27,9822
00712,復華富時不動產,21,0,21,元大-土城學府,2023-10-27,9822
2201,裕隆,23,2,21,元大-土城學府,2023-10-27,9822
2390,云辰,19,1,18,元大-土城學府,2023-10-27,9822
1584,精剛,17,2,15,元大-土城學府,2023-10-27,9822
3311,閎暉,15,0,15,元大-土城學府,2023-10-27,9822
2337,旺宏,18,4,14,元大-土城學府,2023-10-27,9822
3704,合勤控,25,11,14,元大-土城學府,2023-10-27,9822
2388,威盛,19,6,13,元大-土城學府,2023-10-27,9822
2408,南亞科,13,0,13,元大-土城學府,2023-10-27,9822
00680L,元大美債20正2,10,0,10,元大-土城學府,2023-10-27,9822
00931B,統一美債20年,10,0,10,元大-土城學府,2023-10-27,9822
00688L,國泰20年美債正2,10,0,10,元大-土城學府,2023-10-27,9822
1907,永豐餘,12,2,10,元大-土城學府,2023-10-27,9822
2312,金寶,10,0,10,元大-土城學府,2023-10-27,9822
2637,慧洋-KY,10,0,10,元大-土城學府,2023-10-27,9822
6404,通訊-KY,10,0,10,元大-土城學府,2023-10-27,9822
2520,冠德,10,1,9,元大-土城學府,2023-10-27,9822
3041,揚智,11,2,9,元大-土城學府,2023-10-27,9822
2401,凌陽,31,22,9,元大-土城學府,2023-10-27,9822
3013,晟銘電,24,15,9,元大-土城學府,2023-10-27,9822
3583,辛耘,10,1,9,元大-土城學府,2023-10-27,9822
6243,迅杰,9,1,8,元大-土城學府,2023-10-27,9822
2867,三商壽,7,0,7,元大-土城學府,2023-10-27,9822
5009,榮剛,9,2,7,元大-土城學府,2023-10-27,9822
0056,元大高股息,12,6,6,元大-土城學府,2023-10-27,9822
2338,光罩,6,0,6,元大-土城學府,2023-10-27,9822
2497,怡利電,6,0,6,元大-土城學府,2023-10-27,9822
4161,聿新科,6,0,6,元大-土城學府,2023-10-27,9822
5258,虹堡,25,19,6,元大-土城學府,2023-10-27,9822
6146,耕興,6,0,6,元大-土城學府,2023-10-27,9822
6290,良維,8,2,6,元大-土城學府,2023-10-27,9822
00933B,國泰10Y+金融債,5,0,5,元大-土城學府,2023-10-27,9822
2331,精英,5,0,5,元大-土城學府,2023-10-27,9822
2425,承啟,5,0,5,元大-土城學府,2023-10-27,9822
2427,三商電,9,4,5,元大-土城學府,2023-10-27,9822
2486,一詮,5,0,5,元大-土城學府,2023-10-27,9822
2885,元大金,5,0,5,元大-土城學府,2023-10-27,9822
3290,東浦,6,1,5,元大-土城學府,2023-10-27,9822
4714,永捷,5,0,5,元大-土城學府,2023-10-27,9822
4968,立積,5,0,5,元大-土城學府,2023-10-27,9822
5351,鈺創,9,4,5,元大-土城學府,2023-10-27,9822
5465,富驊,7,2,5,元大-土城學府,2023-10-27,9822
2002,中鋼,4,0,4,元大-土城學府,2023-10-27,9822
00893,國泰智能電動車,5,1,4,元大-土城學府,2023-10-27,9822
2618,長榮航,103,0,103,元大-土城學府,2023-10-30,9822
8110,華東,102,1,101,元大-土城學府,2023-10-30,9822
00632R,元大台灣50反1,100,0,100,元大-土城學府,2023-10-30,9822
2317,鴻海,115,24,91,元大-土城學府,2023-10-30,9822
00712,復華富時不動產,35,1,34,元大-土城學府,2023-10-30,9822
00929,復華台灣科技優息,37,5,32,元大-土城學府,2023-10-30,9822
00878,國泰永續高股息,30,0,30,元大-土城學府,2023-10-30,9822
6244,茂迪,30,0,30,元大-土城學府,2023-10-30,9822
1524,耿鼎,33,5,28,元大-土城學府,2023-10-30,9822
2233,宇隆,25,0,25,元大-土城學府,2023-10-30,9822
2427,三商電,25,0,25,元大-土城學府,2023-10-30,9822
2743,山富,24,1,23,元大-土城學府,2023-10-30,9822
1217,愛之味,20,0,20,元大-土城學府,2023-10-30,9822
2367,燿華,18,0,18,元大-土城學府,2023-10-30,9822
2891,中信金,23,5,18,元大-土城學府,2023-10-30,9822
6712,長聖,18,0,18,元大-土城學府,2023-10-30,9822
2885,元大金,14,0,14,元大-土城學府,2023-10-30,9822
00933B,國泰10Y+金融債,14,0,14,元大-土城學府,2023-10-30,9822
6443,元晶,16,2,14,元大-土城學府,2023-10-30,9822
3276,宇環,16,3,13,元大-土城學府,2023-10-30,9822
6233,旺玖,13,0,13,元大-土城學府,2023-10-30,9822
2330,台積電,13,1,12,元大-土城學府,2023-10-30,9822
2356,英業達,15,4,11,元大-土城學府,2023-10-30,9822
00885,富邦越南,11,0,11,元大-土城學府,2023-10-30,9822
3324,雙鴻,27,16,11,元大-土城學府,2023-10-30,9822
1718,中纖,10,0,10,元大-土城學府,2023-10-30,9822
2305,全友,10,0,10,元大-土城學府,2023-10-30,9822
2328,廣宇,10,0,10,元大-土城學府,2023-10-30,9822
2462,良得電,10,0,10,元大-土城學府,2023-10-30,9822
6133,金橋,10,0,10,元大-土城學府,2023-10-30,9822
2390,云辰,22,13,9,元大-土城學府,2023-10-30,9822
1522,堤維西,10,2,8,元大-土城學府,2023-10-30,9822
2331,精英,10,2,8,元大-土城學府,2023-10-30,9822
2340,台亞,9,1,8,元大-土城學府,2023-10-30,9822
3231,緯創,30,23,7,元大-土城學府,2023-10-30,9822
00902,中信電池及儲能,7,0,7,元大-土城學府,2023-10-30,9822
3363,上詮,10,3,7,元大-土城學府,2023-10-30,9822
00680L,元大美債20正2,6,0,6,元大-土城學府,2023-10-30,9822
2485,兆赫,52,46,6,元大-土城學府,2023-10-30,9822
00679B,元大美債20年,6,0,6,元大-土城學府,2023-10-30,9822
1721,三晃,14,8,6,元大-土城學府,2023-10-30,9822
2405,輔信,7,1,6,元大-土城學府,2023-10-30,9822
6276,安鈦克,8,2,6,元大-土城學府,2023-10-30,9822
2890,永豐金,5,0,5,元大-土城學府,2023-10-30,9822
2887,台新金,10,5,5,元大-土城學府,2023-10-30,9822
6146,耕興,5,0,5,元大-土城學府,2023-10-30,9822
00795B,中信美國公債20年,5,0,5,元大-土城學府,2023-10-30,9822
2206,三陽工業,8,3,5,元大-土城學府,2023-10-30,9822
00687B,國泰20年美債,5,0,5,元大-土城學府,2023-10-30,9822
00897,富邦基因免疫生技,5,0,5,元大-土城學府,2023-10-30,9822
2449,京元電子,83,20,63,元大-土城學府,2023-10-31,9822
0056,元大高股息,62,1,61,元大-土城學府,2023-10-31,9822
5243,乙盛-KY,51,0,51,元大-土城學府,2023-10-31,9822
2515,中工,51,2,49,元大-土城學府,2023-10-31,9822
2618,長榮航,63,14,49,元大-土城學府,2023-10-31,9822
2427,三商電,59,24,35,元大-土城學府,2023-10-31,9822
2303,聯電,40,7,33,元大-土城學府,2023-10-31,9822
1217,愛之味,30,0,30,元大-土城學府,2023-10-31,9822
00878,國泰永續高股息,38,8,30,元大-土城學府,2023-10-31,9822
00864B,中信美國公債0-1,25,0,25,元大-土城學府,2023-10-31,9822
00919,群益台灣精選高息,29,5,24,元大-土城學府,2023-10-31,9822
1568,倉佑,28,5,23,元大-土城學府,2023-10-31,9822
1718,中纖,23,0,23,元大-土城學府,2023-10-31,9822
3122,笙泉,29,9,20,元大-土城學府,2023-10-31,9822
8054,安國,41,22,19,元大-土城學府,2023-10-31,9822
00664R,國泰臺灣加權反1,18,0,18,元大-土城學府,2023-10-31,9822
2002,中鋼,17,0,17,元大-土城學府,2023-10-31,9822
00712,復華富時不動產,16,1,15,元大-土城學府,2023-10-31,9822
00897,富邦基因免疫生技,15,0,15,元大-土城學府,2023-10-31,9822
2337,旺宏,18,4,14,元大-土城學府,2023-10-31,9822
5701,劍湖山,13,0,13,元大-土城學府,2023-10-31,9822
3268,海德威,12,0,12,元大-土城學府,2023-10-31,9822
4908,前鼎,20,8,12,元大-土城學府,2023-10-31,9822
2382,廣達,37,26,11,元大-土城學府,2023-10-31,9822
2312,金寶,11,0,11,元大-土城學府,2023-10-31,9822
00929,復華台灣科技優息,45,34,11,元大-土城學府,2023-10-31,9822
9941,裕融,10,0,10,元大-土城學府,2023-10-31,9822
00931B,統一美債20年,10,0,10,元大-土城學府,2023-10-31,9822
6290,良維,10,0,10,元大-土城學府,2023-10-31,9822
00687B,國泰20年美債,10,0,10,元大-土城學府,2023-10-31,9822
3051,力特,10,0,10,元大-土城學府,2023-10-31,9822
2201,裕隆,15,6,9,元大-土城學府,2023-10-31,9822
00922,國泰台灣領袖50,9,0,9,元大-土城學府,2023-10-31,9822
2329,華泰,10,1,9,元大-土城學府,2023-10-31,9822
2363,矽統,11,2,9,元大-土城學府,2023-10-31,9822
2892,第一金,10,1,9,元大-土城學府,2023-10-31,9822
3078,僑威,10,1,9,元大-土城學府,2023-10-31,9822
00902,中信電池及儲能,8,0,8,元大-土城學府,2023-10-31,9822
2353,宏��,10,2,8,元大-土城學府,2023-10-31,9822
2406,國碩,9,1,8,元大-土城學府,2023-10-31,9822
3062,建漢,10,2,8,元大-土城學府,2023-10-31,9822
3481,群創,7,0,7,元大-土城學府,2023-10-31,9822
2913,農林,7,0,7,元大-土城學府,2023-10-31,9822
2313,華通,8,2,6,元大-土城學府,2023-10-31,9822
3715,定穎投控,47,40,7,元大-土城學府,2023-10-31,9822
3023,信邦,6,0,6,元大-土城學府,2023-10-31,9822
1504,東元,7,1,6,元大-土城學府,2023-10-31,9822
8111,立��,6,0,6,元大-土城學府,2023-10-31,9822
8210,勤誠,9,3,6,元大-土城學府,2023-10-31,9822
8936,國統,7,1,6,元大-土城學府,2023-10-31,9822
00934,中信成長高股息,147,15,132,元大-土城學府,2023-11-01,9822
00929,復華台灣科技優息,116,0,116,元大-土城學府,2023-11-01,9822
3363,上詮,72,1,71,元大-土城學府,2023-11-01,9822
6191,精成科,101,48,53,元大-土城學府,2023-11-01,9822
6284,佳邦,43,3,40,元大-土城學府,2023-11-01,9822
00878,國泰永續高股息,45,12,33,元大-土城學府,2023-11-01,9822
00679B,元大美債20年,29,0,29,元大-土城學府,2023-11-01,9822
2409,友達,24,0,24,元大-土城學府,2023-11-01,9822
1217,愛之味,20,0,20,元大-土城學府,2023-11-01,9822
5521,工信,18,2,16,元大-土城學府,2023-11-01,9822
2329,華泰,21,7,14,元大-土城學府,2023-11-01,9822
2476,鉅祥,11,0,11,元大-土城學府,2023-11-01,9822
4167,松瑞藥,14,3,11,元大-土城學府,2023-11-01,9822
1463,強盛新,10,0,10,元大-土城學府,2023-11-01,9822
6290,良維,10,1,9,元大-土城學府,2023-11-01,9822
2317,鴻海,17,9,8,元大-土城學府,2023-11-01,9822
1524,耿鼎,14,6,8,元大-土城學府,2023-11-01,9822
2462,良得電,17,9,8,元大-土城學府,2023-11-01,9822
3078,僑威,11,3,8,元大-土城學府,2023-11-01,9822
4927,泰鼎-KY,8,0,8,元大-土城學府,2023-11-01,9822
6457,紘康,8,0,8,元大-土城學府,2023-11-01,9822
8068,全達,8,0,8,元大-土城學府,2023-11-01,9822
8110,華東,9,1,8,元大-土城學府,2023-11-01,9822
1718,中纖,7,0,7,元大-土城學府,2023-11-01,9822
2388,威盛,13,6,7,元大-土城學府,2023-11-01,9822
2816,旺旺保,7,0,7,元大-土城學府,2023-11-01,9822
3338,泰碩,9,2,7,元大-土城學府,2023-11-01,9822
3231,緯創,12,6,6,元大-土城學府,2023-11-01,9822
00664R,國泰臺灣加權反1,6,0,6,元大-土城學府,2023-11-01,9822
00688L,國泰20年美債正2,6,0,6,元大-土城學府,2023-11-01,9822
00715L,期街口布蘭特正2,6,0,6,元大-土城學府,2023-11-01,9822
4915,致伸,6,0,6,元大-土城學府,2023-11-01,9822
6129,普誠,5,0,5,元大-土城學府,2023-11-01,9822
00795B,中信美國公債20年,5,0,5,元大-土城學府,2023-11-01,9822
2401,凌陽,15,10,5,元大-土城學府,2023-11-01,9822
1101,台泥,5,0,5,元大-土城學府,2023-11-01,9822
00922,國泰台灣領袖50,5,0,5,元大-土城學府,2023-11-01,9822
00935,野村臺灣新科技50,5,0,5,元大-土城學府,2023-11-01,9822
00751B,元大AAA至A公司債,5,0,5,元大-土城學府,2023-11-01,9822
00712,復華富時不動產,5,0,5,元大-土城學府,2023-11-01,9822
2855,統一證,5,0,5,元大-土城學府,2023-11-01,9822
3702,大聯大,16,11,5,元大-土城學府,2023-11-01,9822
6122,擎邦,5,0,5,元大-土城學府,2023-11-01,9822
6418,詠昇,14,9,5,元大-土城學府,2023-11-01,9822
8044,網家,5,0,5,元大-土城學府,2023-11-01,9822
2308,台達電,4,0,4,元大-土城學府,2023-11-01,9822
00687B,國泰20年美債,4,0,4,元大-土城學府,2023-11-01,9822
00885,富邦越南,4,0,4,元大-土城學府,2023-11-01,9822
00932,兆豐永續高息等權,4,0,4,元大-土城學府,2023-11-01,9822
1568,倉佑,4,0,4,元大-土城學府,2023-11-01,9822
00632R,元大台灣50反1,383,62,321,元大-土城學府,2023-11-02,9822
2543,皇昌,143,4,139,元大-土城學府,2023-11-02,9822
2618,長榮航,117,29,88,元大-土城學府,2023-11-02,9822
6257,矽格,55,0,55,元大-土城學府,2023-11-02,9822
00934,中信成長高股息,35,0,35,元大-土城學府,2023-11-02,9822
2329,華泰,37,3,34,元大-土城學府,2023-11-02,9822
5521,工信,29,3,26,元大-土城學府,2023-11-02,9822
2331,精英,22,0,22,元大-土城學府,2023-11-02,9822
3163,波若威,22,2,20,元大-土城學府,2023-11-02,9822
00680L,元大美債20正2,24,5,19,元大-土城學府,2023-11-02,9822
00679B,元大美債20年,14,0,14,元大-土城學府,2023-11-02,9822
2399,映泰,16,5,11,元大-土城學府,2023-11-02,9822
00688L,國泰20年美債正2,30,20,10,元大-土城學府,2023-11-02,9822
1319,東陽,14,4,10,元大-土城學府,2023-11-02,9822
3041,揚智,8,0,8,元大-土城學府,2023-11-02,9822
00919,群益台灣精選高息,34,27,7,元大-土城學府,2023-11-02,9822
2401,凌陽,7,0,7,元大-土城學府,2023-11-02,9822
3078,僑威,11,4,7,元大-土城學府,2023-11-02,9822
2883,凱基金,6,0,6,元大-土城學府,2023-11-02,9822
1314,中石化,6,0,6,元大-土城學府,2023-11-02,9822
2010,春源,6,0,6,元大-土城學府,2023-11-02,9822
2358,廷鑫,20,14,6,元大-土城學府,2023-11-02,9822
00715L,期街口布蘭特正2,6,1,5,元大-土城學府,2023-11-02,9822
00637L,元大滬深300正2,5,0,5,元大-土城學府,2023-11-02,9822
2539,櫻花建,5,0,5,元大-土城學府,2023-11-02,9822
3217,優群,5,0,5,元大-土城學府,2023-11-02,9822
4915,致伸,5,0,5,元大-土城學府,2023-11-02,9822
4966,譜瑞-KY,5,0,5,元大-土城學府,2023-11-02,9822
6770,力積電,5,0,5,元大-土城學府,2023-11-02,9822
2882,國泰金,5,0,5,元大-土城學府,2023-11-02,9822
00687B,國泰20年美債,5,0,5,元大-土城學府,2023-11-02,9822
2376,技嘉,7,3,4,元大-土城學府,2023-11-02,9822
2337,旺宏,7,3,4,元大-土城學府,2023-11-02,9822
1584,精剛,4,1,3,元大-土城學府,2023-11-02,9822
3443,創意,4,1,3,元大-土城學府,2023-11-02,9822
3481,群創,22,19,3,元大-土城學府,2023-11-02,9822
3625,西勝,3,0,3,元大-土城學府,2023-11-02,9822
4188,安克,3,0,3,元大-土城學府,2023-11-02,9822
6138,茂達,4,1,3,元大-土城學府,2023-11-02,9822
6168,宏齊,4,1,3,元大-土城學府,2023-11-02,9822
6274,台燿,9,6,3,元大-土城學府,2023-11-02,9822
9958,世紀鋼,5,2,3,元大-土城學府,2023-11-02,9822
6488,環球晶,2,0,2,元大-土城學府,2023-11-02,9822
1301,台塑,2,0,2,元大-土城學府,2023-11-02,9822
1324,地球,12,10,2,元大-土城學府,2023-11-02,9822
1519,華城,14,12,2,元大-土城學府,2023-11-02,9822
1722,台肥,2,0,2,元大-土城學府,2023-11-02,9822
2314,台揚,2,0,2,元大-土城學府,2023-11-02,9822
2316,楠梓電,6,4,2,元大-土城學府,2023-11-02,9822
2367,燿華,10,8,2,元大-土城學府,2023-11-02,9822
2618,長榮航,298,121,177,元大-土城學府,2023-11-03,9822
2363,矽統,291,160,131,元大-土城學府,2023-11-03,9822
2543,皇昌,53,2,51,元大-土城學府,2023-11-03,9822
00878,國泰永續高股息,63,13,50,元大-土城學府,2023-11-03,9822
6284,佳邦,44,0,44,元大-土城學府,2023-11-03,9822
2317,鴻海,43,3,40,元大-土城學府,2023-11-03,9822
00679B,元大美債20年,41,1,40,元大-土城學府,2023-11-03,9822
1337,再生-KY,30,0,30,元大-土城學府,2023-11-03,9822
00929,復華台灣科技優息,35,6,29,元大-土城學府,2023-11-03,9822
1453,大將,26,0,26,元大-土城學府,2023-11-03,9822
2353,宏��,31,5,26,元大-土城學府,2023-11-03,9822
00919,群益台灣精選高息,29,5,24,元大-土城學府,2023-11-03,9822
00934,中信成長高股息,24,3,21,元大-土城學府,2023-11-03,9822
1471,首利,20,0,20,元大-土城學府,2023-11-03,9822
1609,大亞,21,1,20,元大-土城學府,2023-11-03,9822
2313,華通,30,12,18,元大-土城學府,2023-11-03,9822
2382,廣達,31,17,14,元大-土城學府,2023-11-03,9822
1314,中石化,20,6,14,元大-土城學府,2023-11-03,9822
2453,凌群,14,0,14,元大-土城學府,2023-11-03,9822
2329,華泰,35,23,12,元大-土城學府,2023-11-03,9822
00664R,國泰臺灣加權反1,11,0,11,元大-土城學府,2023-11-03,9822
6189,豐藝,11,0,11,元大-土城學府,2023-11-03,9822
3231,緯創,21,11,10,元大-土城學府,2023-11-03,9822
1447,力鵬,10,0,10,元大-土城學府,2023-11-03,9822
1463,強盛新,11,1,10,元大-土城學府,2023-11-03,9822
2332,友訊,10,0,10,元大-土城學府,2023-11-03,9822
3052,夆典,10,0,10,元大-土城學府,2023-11-03,9822
4960,誠美材,15,5,10,元大-土城學府,2023-11-03,9822
2816,旺旺保,28,19,9,元大-土城學府,2023-11-03,9822
6005,群益證,9,0,9,元大-土城學府,2023-11-03,9822
6127,九豪,9,0,9,元大-土城學府,2023-11-03,9822
1321,大洋,8,0,8,元大-土城學府,2023-11-03,9822
2314,台揚,10,2,8,元大-土城學府,2023-11-03,9822
2417,圓剛,8,0,8,元大-土城學府,2023-11-03,9822
1568,倉佑,7,0,7,元大-土城學府,2023-11-03,9822
2331,精英,7,0,7,元大-土城學府,2023-11-03,9822
6257,矽格,12,5,7,元大-土城學府,2023-11-03,9822
2010,春源,6,0,6,元大-土城學府,2023-11-03,9822
3260,威剛,10,4,6,元大-土城學府,2023-11-03,9822
3322,建舜電,8,3,5,元大-土城學府,2023-11-03,9822
00850,元大臺灣ESG永續,5,0,5,元大-土城學府,2023-11-03,9822
00665L,富邦�琤肭磪囓�2,5,0,5,元大-土城學府,2023-11-03,9822
00933B,國泰10Y+金融債,5,0,5,元大-土城學府,2023-11-03,9822
1101,台泥,5,0,5,元大-土城學府,2023-11-03,9822
1449,佳和,8,3,5,元大-土城學府,2023-11-03,9822
1618,合機,5,0,5,元大-土城學府,2023-11-03,9822
2743,山富,5,0,5,元大-土城學府,2023-11-03,9822
3051,力特,5,0,5,元大-土城學府,2023-11-03,9822
00902,中信電池及儲能,4,0,4,元大-土城學府,2023-11-03,9822
2323,中環,4,0,4,元大-土城學府,2023-11-03,9822
00632R,元大台灣50反1,422,18,404,元大-土城學府,2023-11-06,9822
2618,長榮航,311,75,236,元大-土城學府,2023-11-06,9822
2484,希華,36,1,35,元大-土城學府,2023-11-06,9822
6197,佳必琪,34,2,32,元大-土城學府,2023-11-06,9822
6284,佳邦,30,1,29,元大-土城學府,2023-11-06,9822
00931B,統一美債20年,28,0,28,元大-土城學府,2023-11-06,9822
2543,皇昌,29,1,28,元大-土城學府,2023-11-06,9822
2883,凱基金,32,6,26,元大-土城學府,2023-11-06,9822
3704,合勤控,24,4,20,元大-土城學府,2023-11-06,9822
00679B,元大美債20年,17,0,17,元大-土城學府,2023-11-06,9822
00687B,國泰20年美債,15,0,15,元大-土城學府,2023-11-06,9822
00878,國泰永續高股息,20,5,15,元大-土城學府,2023-11-06,9822
1524,耿鼎,31,17,14,元大-土城學府,2023-11-06,9822
00680L,元大美債20正2,13,0,13,元大-土城學府,2023-11-06,9822
4961,天鈺,13,0,13,元大-土城學府,2023-11-06,9822
2331,精英,11,0,11,元大-土城學府,2023-11-06,9822
1314,中石化,11,0,11,元大-土城學府,2023-11-06,9822
2388,威盛,45,34,11,元大-土城學府,2023-11-06,9822
3231,緯創,19,9,10,元大-土城學府,2023-11-06,9822
00888,永豐台灣ESG,10,0,10,元大-土城學府,2023-11-06,9822
2417,圓剛,10,0,10,元大-土城學府,2023-11-06,9822
2880,華南金,10,0,10,元大-土城學府,2023-11-06,9822
3052,夆典,10,0,10,元大-土城學府,2023-11-06,9822
8038,長園科,11,1,10,元大-土城學府,2023-11-06,9822
00934,中信成長高股息,10,1,9,元大-土城學府,2023-11-06,9822
5880,合庫金,8,0,8,元大-土城學府,2023-11-06,9822
2313,華通,23,15,8,元大-土城學府,2023-11-06,9822
00720B,元大投資級公司債,8,0,8,元大-土城學府,2023-11-06,9822
2498,宏達電,15,7,8,元大-土城學府,2023-11-06,9822
6139,亞翔,16,8,8,元大-土城學府,2023-11-06,9822
2486,一詮,8,1,7,元大-土城學府,2023-11-06,9822
3227,原相,7,0,7,元大-土城學府,2023-11-06,9822
6285,啟��,17,11,6,元大-土城學府,2023-11-06,9822
00642U,期元大S＆P石油,6,0,6,元大-土城學府,2023-11-06,9822
2634,漢翔,11,5,6,元大-土城學府,2023-11-06,9822
3567,逸昌,8,2,6,元大-土城學府,2023-11-06,9822
1227,佳格,5,0,5,元大-土城學府,2023-11-06,9822
2332,友訊,5,0,5,元大-土城學府,2023-11-06,9822
2409,友達,5,0,5,元大-土城學府,2023-11-06,9822
2419,仲琦,6,1,5,元大-土城學府,2023-11-06,9822
3013,晟銘電,8,3,5,元大-土城學府,2023-11-06,9822
3708,上緯投控,5,0,5,元大-土城學府,2023-11-06,9822
6125,廣運,5,0,5,元大-土城學府,2023-11-06,9822
6133,金橋,7,2,5,元大-土城學府,2023-11-06,9822
8068,全達,6,1,5,元大-土城學府,2023-11-06,9822
00795B,中信美國公債20年,4,0,4,元大-土城學府,2023-11-06,9822
00885,富邦越南,4,0,4,元大-土城學府,2023-11-06,9822
1568,倉佑,4,0,4,元大-土城學府,2023-11-06,9822
2014,中鴻,4,0,4,元大-土城學府,2023-11-06,9822
3105,穩懋,7,3,4,元大-土城學府,2023-11-06,9822
00680L,元大美債20正2,65,0,65,元大-土城學府,2023-11-07,9822
00902,中信電池及儲能,64,0,64,元大-土城學府,2023-11-07,9822
3105,穩懋,57,1,56,元大-土城學府,2023-11-07,9822
00929,復華台灣科技優息,53,10,43,元大-土城學府,2023-11-07,9822
6139,亞翔,39,3,36,元大-土城學府,2023-11-07,9822
00720B,元大投資級公司債,33,0,33,元大-土城學府,2023-11-07,9822
2303,聯電,53,22,31,元大-土城學府,2023-11-07,9822
1217,愛之味,30,0,30,元大-土城學府,2023-11-07,9822
2388,威盛,50,23,27,元大-土城學府,2023-11-07,9822
00878,國泰永續高股息,32,7,25,元大-土城學府,2023-11-07,9822
3548,兆利,30,9,21,元大-土城學府,2023-11-07,9822
2618,長榮航,34,14,20,元大-土城學府,2023-11-07,9822
00934,中信成長高股息,19,0,19,元大-土城學府,2023-11-07,9822
00688L,國泰20年美債正2,17,0,17,元大-土城學府,2023-11-07,9822
2884,玉山金,17,1,16,元大-土城學府,2023-11-07,9822
2543,皇昌,16,0,16,元大-土城學府,2023-11-07,9822
00933B,國泰10Y+金融債,15,0,15,元大-土城學府,2023-11-07,9822
2484,希華,15,0,15,元大-土城學府,2023-11-07,9822
5701,劍湖山,15,0,15,元大-土城學府,2023-11-07,9822
2408,南亞科,14,1,13,元大-土城學府,2023-11-07,9822
5351,鈺創,25,12,13,元大-土城學府,2023-11-07,9822
2317,鴻海,13,1,12,元大-土城學府,2023-11-07,9822
2610,華航,18,6,12,元大-土城學府,2023-11-07,9822
3605,宏致,12,0,12,元大-土城學府,2023-11-07,9822
2355,敬鵬,11,0,11,元大-土城學府,2023-11-07,9822
2498,宏達電,13,2,11,元大-土城學府,2023-11-07,9822
1101,台泥,10,0,10,元大-土城學府,2023-11-07,9822
00921,兆豐龍頭等權重,10,0,10,元大-土城學府,2023-11-07,9822
1584,精剛,15,5,10,元大-土城學府,2023-11-07,9822
3545,敦泰,14,4,10,元大-土城學府,2023-11-07,9822
3622,洋華,10,0,10,元大-土城學府,2023-11-07,9822
8111,立��,10,0,10,元大-土城學府,2023-11-07,9822
00679B,元大美債20年,9,0,9,元大-土城學府,2023-11-07,9822
00712,復華富時不動產,12,3,9,元大-土城學府,2023-11-07,9822
1409,新纖,9,0,9,元大-土城學府,2023-11-07,9822
4961,天鈺,9,0,9,元大-土城學府,2023-11-07,9822
2867,三商壽,10,1,9,元大-土城學府,2023-11-07,9822
1731,美吾華,9,1,8,元大-土城學府,2023-11-07,9822
2353,宏��,10,2,8,元大-土城學府,2023-11-07,9822
2453,凌群,24,16,8,元大-土城學府,2023-11-07,9822
3322,建舜電,9,2,7,元大-土城學府,2023-11-07,9822
3481,群創,8,1,7,元大-土城學府,2023-11-07,9822
2010,春源,6,0,6,元大-土城學府,2023-11-07,9822
2390,云辰,8,2,6,元大-土城學府,2023-11-07,9822
2409,友達,6,0,6,元大-土城學府,2023-11-07,9822
3607,谷崧,6,0,6,元大-土城學府,2023-11-07,9822
6719,力智,6,0,6,元大-土城學府,2023-11-07,9822
8054,安國,7,1,6,元大-土城學府,2023-11-07,9822
3037,欣興,5,0,5,元大-土城學府,2023-11-07,9822
2427,三商電,5,0,5,元大-土城學府,2023-11-07,9822
00632R,元大台灣50反1,555,0,555,元大-土城學府,2023-11-08,9822
2363,矽統,174,80,94,元大-土城學府,2023-11-08,9822
6122,擎邦,81,2,79,元大-土城學府,2023-11-08,9822
2618,長榮航,162,84,78,元大-土城學府,2023-11-08,9822
00936,台新永續高息中小,42,0,42,元大-土城學府,2023-11-08,9822
2501,國建,33,0,33,元大-土城學府,2023-11-08,9822
1217,愛之味,27,1,26,元大-土城學府,2023-11-08,9822
2705,六福,20,0,20,元大-土城學府,2023-11-08,9822
00679B,元大美債20年,19,1,18,元大-土城學府,2023-11-08,9822
5347,世界,15,0,15,元大-土城學府,2023-11-08,9822
00933B,國泰10Y+金融債,15,0,15,元大-土城學府,2023-11-08,9822
00715L,期街口布蘭特正2,13,0,13,元大-土城學府,2023-11-08,9822
6117,迎廣,71,59,12,元大-土城學府,2023-11-08,9822
2515,中工,11,0,11,元大-土城學府,2023-11-08,9822
2884,玉山金,11,0,11,元大-土城學府,2023-11-08,9822
00902,中信電池及儲能,10,0,10,元大-土城學府,2023-11-08,9822
6799,來頡,10,0,10,元大-土城學府,2023-11-08,9822
8093,保銳,10,0,10,元大-土城學府,2023-11-08,9822
8432,東生華,10,0,10,元大-土城學府,2023-11-08,9822
8150,南茂,10,1,9,元大-土城學府,2023-11-08,9822
1463,強盛新,10,1,9,元大-土城學府,2023-11-08,9822
2913,農林,9,0,9,元大-土城學府,2023-11-08,9822
6282,康舒,12,3,9,元大-土城學府,2023-11-08,9822
6523,達爾膚,9,0,9,元大-土城學府,2023-11-08,9822
4938,和碩,8,0,8,元大-土城學府,2023-11-08,9822
1815,富喬,19,11,8,元大-土城學府,2023-11-08,9822
2417,圓剛,9,1,8,元大-土城學府,2023-11-08,9822
4167,松瑞藥,10,2,8,元大-土城學府,2023-11-08,9822
1560,中砂,9,1,8,元大-土城學府,2023-11-08,9822
3043,科風,8,0,8,元大-土城學府,2023-11-08,9822
3324,雙鴻,15,8,7,元大-土城學府,2023-11-08,9822
00642U,期元大S＆P石油,8,1,7,元大-土城學府,2023-11-08,9822
1514,亞力,7,0,7,元大-土城學府,2023-11-08,9822
3322,建舜電,9,2,7,元大-土城學府,2023-11-08,9822
3545,敦泰,9,3,6,元大-土城學府,2023-11-08,9822
1605,華新,8,2,6,元大-土城學府,2023-11-08,9822
2010,春源,6,0,6,元大-土城學府,2023-11-08,9822
2607,榮運,8,2,6,元大-土城學府,2023-11-08,9822
3548,兆利,11,5,6,元大-土城學府,2023-11-08,9822
6189,豐藝,7,1,6,元大-土城學府,2023-11-08,9822
8110,華東,8,2,6,元大-土城學府,2023-11-08,9822
2303,聯電,48,43,5,元大-土城學府,2023-11-08,9822
6531,愛普*,6,1,5,元大-土城學府,2023-11-08,9822
3693,營邦,30,25,5,元大-土城學府,2023-11-08,9822
1460,宏遠,5,0,5,元大-土城學府,2023-11-08,9822
1616,億泰,5,0,5,元大-土城學府,2023-11-08,9822
2543,皇昌,5,0,5,元大-土城學府,2023-11-08,9822
3037,欣興,5,0,5,元大-土城學府,2023-11-08,9822
3041,揚智,7,2,5,元大-土城學府,2023-11-08,9822
3508,位速,5,0,5,元大-土城學府,2023-11-08,9822
00929,復華台灣科技優息,81,8,73,元大-土城學府,2023-11-09,9822
3122,笙泉,88,30,58,元大-土城學府,2023-11-09,9822
00936,台新永續高息中小,54,0,54,元大-土城學府,2023-11-09,9822
1721,三晃,53,5,48,元大-土城學府,2023-11-09,9822
00688L,國泰20年美債正2,40,0,40,元大-土城學府,2023-11-09,9822
00934,中信成長高股息,29,1,28,元大-土城學府,2023-11-09,9822
2206,三陽工業,30,2,28,元大-土城學府,2023-11-09,9822
00632R,元大台灣50反1,27,0,27,元大-土城學府,2023-11-09,9822
00878,國泰永續高股息,28,8,20,元大-土城學府,2023-11-09,9822
00664R,國泰臺灣加權反1,20,0,20,元大-土城學府,2023-11-09,9822
2388,威盛,22,4,18,元大-土城學府,2023-11-09,9822
00931B,統一美債20年,21,5,16,元大-土城學府,2023-11-09,9822
3617,碩天,17,2,15,元大-土城學府,2023-11-09,9822
2303,聯電,63,50,13,元大-土城學府,2023-11-09,9822
2610,華航,20,8,12,元大-土城學府,2023-11-09,9822
2374,佳能,12,0,12,元大-土城學府,2023-11-09,9822
5347,世界,12,0,12,元大-土城學府,2023-11-09,9822
3013,晟銘電,43,32,11,元大-土城學府,2023-11-09,9822
6185,幃翔,12,1,11,元大-土城學府,2023-11-09,9822
6821,聯寶,11,0,11,元大-土城學府,2023-11-09,9822
00919,群益台灣精選高息,14,4,10,元大-土城學府,2023-11-09,9822
00680L,元大美債20正2,10,0,10,元大-土城學府,2023-11-09,9822
2542,興富發,10,0,10,元大-土城學府,2023-11-09,9822
00669R,國泰美國道瓊反1,10,0,10,元大-土城學府,2023-11-09,9822
1718,中纖,10,0,10,元大-土城學府,2023-11-09,9822
3306,鼎天,10,0,10,元大-土城學府,2023-11-09,9822
5522,遠雄,10,0,10,元大-土城學府,2023-11-09,9822
5321,美而快,9,0,9,元大-土城學府,2023-11-09,9822
00715L,期街口布蘭特正2,13,5,8,元大-土城學府,2023-11-09,9822
3715,定穎投控,15,7,8,元大-土城學府,2023-11-09,9822
00933B,國泰10Y+金融債,7,0,7,元大-土城學府,2023-11-09,9822
2390,云辰,8,1,7,元大-土城學府,2023-11-09,9822
3041,揚智,12,5,7,元大-土城學府,2023-11-09,9822
3264,欣銓,7,0,7,元大-土城學府,2023-11-09,9822
5344,立衛,7,0,7,元大-土城學府,2023-11-09,9822
2344,華邦電,6,0,6,元大-土城學府,2023-11-09,9822
6104,創惟,6,0,6,元大-土城學府,2023-11-09,9822
00901,永豐智能車供應鏈,6,0,6,元大-土城學府,2023-11-09,9822
1519,華城,18,12,6,元大-土城學府,2023-11-09,9822
2705,六福,6,0,6,元大-土城學府,2023-11-09,9822
00902,中信電池及儲能,6,1,5,元大-土城學府,2023-11-09,9822
00679B,元大美債20年,8,3,5,元大-土城學府,2023-11-09,9822
1437,勤益控,5,0,5,元大-土城學府,2023-11-09,9822
2331,精英,16,11,5,元大-土城學府,2023-11-09,9822
2884,玉山金,6,1,5,元大-土城學府,2023-11-09,9822
3322,建舜電,5,0,5,元大-土城學府,2023-11-09,9822
3704,合勤控,25,20,5,元大-土城學府,2023-11-09,9822
6125,廣運,9,4,5,元大-土城學府,2023-11-09,9822
6461,益得,5,0,5,元大-土城學府,2023-11-09,9822
1464,得力,4,0,4,元大-土城學府,2023-11-09,9822
1314,中石化,100,0,100,元大-土城學府,2023-11-10,9822
2002,中鋼,88,0,88,元大-土城學府,2023-11-10,9822
1210,大成,71,0,71,元大-土城學府,2023-11-10,9822
2329,華泰,53,3,50,元大-土城學府,2023-11-10,9822
1217,愛之味,40,0,40,元大-土城學府,2023-11-10,9822
00680L,元大美債20正2,36,0,36,元大-土城學府,2023-11-10,9822
2303,聯電,35,1,34,元大-土城學府,2023-11-10,9822
6550,北極星藥業-KY,40,6,34,元大-土城學府,2023-11-10,9822
00878,國泰永續高股息,33,3,30,元大-土城學府,2023-11-10,9822
3231,緯創,67,40,27,元大-土城學府,2023-11-10,9822
2206,三陽工業,25,1,24,元大-土城學府,2023-11-10,9822
2427,三商電,23,0,23,元大-土城學府,2023-11-10,9822
2486,一詮,23,1,22,元大-土城學府,2023-11-10,9822
00936,台新永續高息中小,22,0,22,元大-土城學府,2023-11-10,9822
6284,佳邦,20,0,20,元大-土城學府,2023-11-10,9822
2353,宏��,30,10,20,元大-土城學府,2023-11-10,9822
4123,晟德,20,1,19,元大-土城學府,2023-11-10,9822
00929,復華台灣科技優息,19,1,18,元大-土城學府,2023-11-10,9822
1584,精剛,22,4,18,元大-土城學府,2023-11-10,9822
4908,前鼎,18,1,17,元大-土城學府,2023-11-10,9822
8111,立��,17,1,16,元大-土城學府,2023-11-10,9822
6821,聯寶,15,0,15,元大-土城學府,2023-11-10,9822
00679B,元大美債20年,14,0,14,元大-土城學府,2023-11-10,9822
2305,全友,15,1,14,元大-土城學府,2023-11-10,9822
2618,長榮航,23,9,14,元大-土城學府,2023-11-10,9822
3041,揚智,17,3,14,元大-土城學府,2023-11-10,9822
2363,矽統,64,51,13,元大-土城學府,2023-11-10,9822
00934,中信成長高股息,13,1,12,元大-土城學府,2023-11-10,9822
00907,永豐優息存股,12,0,12,元大-土城學府,2023-11-10,9822
3013,晟銘電,31,19,12,元大-土城學府,2023-11-10,9822
2408,南亞科,12,1,11,元大-土城學府,2023-11-10,9822
00720B,元大投資級公司債,10,0,10,元大-土城學府,2023-11-10,9822
00931B,統一美債20年,10,0,10,元大-土城學府,2023-11-10,9822
2338,光罩,10,0,10,元大-土城學府,2023-11-10,9822
3376,新日興,16,6,10,元大-土城學府,2023-11-10,9822
4906,正文,10,0,10,元大-土城學府,2023-11-10,9822
6122,擎邦,38,28,10,元大-土城學府,2023-11-10,9822
8034,榮群,13,3,10,元大-土城學府,2023-11-10,9822
2609,陽明,12,2,10,元大-土城學府,2023-11-10,9822
3363,上詮,12,3,9,元大-土城學府,2023-11-10,9822
3483,力致,10,1,9,元大-土城學府,2023-11-10,9822
00919,群益台灣精選高息,9,2,7,元大-土城學府,2023-11-10,9822
8048,德勝,7,0,7,元大-土城學府,2023-11-10,9822
00687B,國泰20年美債,7,0,7,元大-土城學府,2023-11-10,9822
1815,富喬,7,0,7,元大-土城學府,2023-11-10,9822
2369,菱生,7,0,7,元大-土城學府,2023-11-10,9822
00688L,國泰20年美債正2,6,0,6,元大-土城學府,2023-11-10,9822
1460,宏遠,6,0,6,元大-土城學府,2023-11-10,9822
1616,億泰,6,0,6,元大-土城學府,2023-11-10,9822
2610,華航,14,8,6,元大-土城學府,2023-11-10,9822
00900,富邦特選高股息30,102,2,100,元大-土城學府,2023-11-13,9822
3147,大綜,83,3,80,元大-土城學府,2023-11-13,9822
3276,宇環,80,3,77,元大-土城學府,2023-11-13,9822
00878,國泰永續高股息,80,8,72,元大-土城學府,2023-11-13,9822
00632R,元大台灣50反1,62,6,56,元大-土城學府,2023-11-13,9822
1463,強盛新,43,0,43,元大-土城學府,2023-11-13,9822
2363,矽統,49,10,39,元大-土城學府,2023-11-13,9822
00679B,元大美債20年,38,0,38,元大-土城學府,2023-11-13,9822
6122,擎邦,37,10,27,元大-土城學府,2023-11-13,9822
2543,皇昌,30,4,26,元大-土城學府,2023-11-13,9822
3390,旭軟,26,2,24,元大-土城學府,2023-11-13,9822
00931B,統一美債20年,25,0,25,元大-土城學府,2023-11-13,9822
2743,山富,23,1,22,元大-土城學府,2023-11-13,9822
00933B,國泰10Y+金融債,20,0,20,元大-土城學府,2023-11-13,9822
3078,僑威,21,1,20,元大-土城學府,2023-11-13,9822
3290,東浦,20,0,20,元大-土城學府,2023-11-13,9822
5701,劍湖山,20,0,20,元大-土城學府,2023-11-13,9822
6799,來頡,20,0,20,元大-土城學府,2023-11-13,9822
3607,谷崧,18,0,18,元大-土城學府,2023-11-13,9822
6290,良維,26,8,18,元大-土城學府,2023-11-13,9822
2002,中鋼,99,82,17,元大-土城學府,2023-11-13,9822
00687B,國泰20年美債,16,0,16,元大-土城學府,2023-11-13,9822
2317,鴻海,13,0,13,元大-土城學府,2023-11-13,9822
2382,廣達,41,28,13,元大-土城學府,2023-11-13,9822
2425,承啟,13,0,13,元大-土城學府,2023-11-13,9822
8176,智捷,13,0,13,元大-土城學府,2023-11-13,9822
2313,華通,84,72,12,元大-土城學府,2023-11-13,9822
1101,台泥,11,0,11,元大-土城學府,2023-11-13,9822
1217,愛之味,12,1,11,元大-土城學府,2023-11-13,9822
2323,中環,11,0,11,元大-土城學府,2023-11-13,9822
00680L,元大美債20正2,10,0,10,元大-土城學府,2023-11-13,9822
00688L,國泰20年美債正2,10,0,10,元大-土城學府,2023-11-13,9822
6118,建達,10,1,9,元大-土城學府,2023-11-13,9822
8111,立��,11,2,9,元大-土城學府,2023-11-13,9822
00929,復華台灣科技優息,15,7,8,元大-土城學府,2023-11-13,9822
1437,勤益控,8,0,8,元大-土城學府,2023-11-13,9822
3045,台灣大,10,2,8,元大-土城學府,2023-11-13,9822
6456,GIS-KY,9,1,8,元大-土城學府,2023-11-13,9822
3006,晶豪科,14,7,7,元大-土城學府,2023-11-13,9822
2402,毅嘉,34,27,7,元大-土城學府,2023-11-13,9822
1455,集盛,6,0,6,元大-土城學府,2023-11-13,9822
3232,昱捷,6,0,6,元大-土城學府,2023-11-13,9822
3615,安可,6,0,6,元大-土城學府,2023-11-13,9822
6547,高端疫苗,6,0,6,元大-土城學府,2023-11-13,9822
6901,鑽石投資,6,0,6,元大-土城學府,2023-11-13,9822
9933,中鼎,5,0,5,元大-土城學府,2023-11-13,9822
00903,富邦元宇宙,5,0,5,元大-土城學府,2023-11-13,9822
00902,中信電池及儲能,5,0,5,元大-土城學府,2023-11-13,9822
1584,精剛,7,2,5,元大-土城學府,2023-11-13,9822
1603,華電,5,0,5,元大-土城學府,2023-11-13,9822
00706L,期元大S＆P日圓正2,200,0,200,元大-土城學府,2023-11-14,9822
2303,聯電,64,0,64,元大-土城學府,2023-11-14,9822
3147,大綜,58,0,58,元大-土城學府,2023-11-14,9822
00878,國泰永續高股息,38,3,35,元大-土城學府,2023-11-14,9822
2329,華泰,39,5,34,元大-土城學府,2023-11-14,9822
6122,擎邦,92,58,34,元大-土城學府,2023-11-14,9822
00632R,元大台灣50反1,32,0,32,元大-土城學府,2023-11-14,9822
6282,康舒,31,0,31,元大-土城學府,2023-11-14,9822
1217,愛之味,30,0,30,元大-土城學府,2023-11-14,9822
6664,群翊,30,0,30,元大-土城學府,2023-11-14,9822
1504,東元,30,1,29,元大-土城學府,2023-11-14,9822
00900,富邦特選高股息30,24,1,23,元大-土城學府,2023-11-14,9822
1210,大成,20,0,20,元大-土城學府,2023-11-14,9822
6182,合晶,20,0,20,元大-土城學府,2023-11-14,9822
9945,潤泰新,18,1,17,元大-土城學府,2023-11-14,9822
2427,三商電,16,0,16,元大-土城學府,2023-11-14,9822
3128,昇銳,17,1,16,元大-土城學府,2023-11-14,9822
1463,強盛新,17,2,15,元大-土城學府,2023-11-14,9822
2356,英業達,20,5,15,元大-土城學府,2023-11-14,9822
00679B,元大美債20年,13,0,13,元大-土城學府,2023-11-14,9822
2601,益航,13,0,13,元大-土城學府,2023-11-14,9822
2883,凱基金,12,0,12,元大-土城學府,2023-11-14,9822
3231,緯創,38,27,11,元大-土城學府,2023-11-14,9822
3006,晶豪科,14,3,11,元大-土城學府,2023-11-14,9822
6578,達邦蛋白,11,0,11,元大-土城學府,2023-11-14,9822
00931B,統一美債20年,10,0,10,元大-土城學府,2023-11-14,9822
3041,揚智,10,0,10,元大-土城學府,2023-11-14,9822
2204,中華,9,0,9,元大-土城學府,2023-11-14,9822
1515,力山,16,7,9,元大-土城學府,2023-11-14,9822
2369,菱生,11,2,9,元大-土城學府,2023-11-14,9822
2705,六福,9,0,9,元大-土城學府,2023-11-14,9822
3450,聯鈞,11,2,9,元大-土城學府,2023-11-14,9822
8088,品安,15,6,9,元大-土城學府,2023-11-14,9822
2485,兆赫,9,1,8,元大-土城學府,2023-11-14,9822
8155,博智,8,0,8,元大-土城學府,2023-11-14,9822
2313,華通,34,26,8,元大-土城學府,2023-11-14,9822
6235,華孚,8,0,8,元大-土城學府,2023-11-14,9822
1609,大亞,8,1,7,元大-土城學府,2023-11-14,9822
2374,佳能,7,0,7,元大-土城學府,2023-11-14,9822
5483,中美晶,6,0,6,元大-土城學府,2023-11-14,9822
00850,元大臺灣ESG永續,6,0,6,元大-土城學府,2023-11-14,9822
3105,穩懋,7,1,6,元大-土城學府,2023-11-14,9822
3362,先進光,9,3,6,元大-土城學府,2023-11-14,9822
00772B,中信高評級公司債,6,1,5,元大-土城學府,2023-11-14,9822
00642U,期元大S＆P石油,5,0,5,元大-土城學府,2023-11-14,9822
1460,宏遠,5,0,5,元大-土城學府,2023-11-14,9822
1522,堤維西,10,5,5,元大-土城學府,2023-11-14,9822
2462,良得電,6,1,5,元大-土城學府,2023-11-14,9822
2605,新興,6,1,5,元大-土城學府,2023-11-14,9822
2915,潤泰全,6,1,5,元大-土城學府,2023-11-14,9822
00878,國泰永續高股息,68,6,62,元大-土城學府,2023-11-15,9822
2543,皇昌,102,51,51,元大-土城學府,2023-11-15,9822
4806,桂田文創,32,0,32,元大-土城學府,2023-11-15,9822
2884,玉山金,41,10,31,元大-土城學府,2023-11-15,9822
00632R,元大台灣50反1,27,4,23,元大-土城學府,2023-11-15,9822
3260,威剛,25,2,23,元大-土城學府,2023-11-15,9822
6672,騰輝電子-KY,21,0,21,元大-土城學府,2023-11-15,9822
00680L,元大美債20正2,20,0,20,元大-土城學府,2023-11-15,9822
00679B,元大美債20年,26,6,20,元大-土城學府,2023-11-15,9822
8358,金居,20,0,20,元大-土城學府,2023-11-15,9822
00901,永豐智能車供應鏈,21,2,19,元大-土城學府,2023-11-15,9822
2516,新建,18,0,18,元大-土城學府,2023-11-15,9822
2317,鴻海,20,3,17,元大-土城學府,2023-11-15,9822
4967,十銓,22,5,17,元大-土城學府,2023-11-15,9822
2845,遠東銀,15,0,15,元大-土城學府,2023-11-15,9822
3276,宇環,26,11,15,元大-土城學府,2023-11-15,9822
6664,群翊,19,4,15,元大-土城學府,2023-11-15,9822
2353,宏��,18,4,14,元大-土城學府,2023-11-15,9822
3704,合勤控,13,0,13,元大-土城學府,2023-11-15,9822
2376,技嘉,22,10,12,元大-土城學府,2023-11-15,9822
2356,英業達,25,13,12,元大-土城學府,2023-11-15,9822
00933B,國泰10Y+金融債,12,0,12,元大-土城學府,2023-11-15,9822
8054,安國,19,7,12,元大-土城學府,2023-11-15,9822
4908,前鼎,19,8,11,元大-土城學府,2023-11-15,9822
5347,世界,13,2,11,元大-土城學府,2023-11-15,9822
00669R,國泰美國道瓊反1,10,0,10,元大-土城學府,2023-11-15,9822
00688L,國泰20年美債正2,10,0,10,元大-土城學府,2023-11-15,9822
00932,兆豐永續高息等權,10,0,10,元大-土城學府,2023-11-15,9822
1721,三晃,10,0,10,元大-土城學府,2023-11-15,9822
2337,旺宏,14,4,10,元大-土城學府,2023-11-15,9822
2369,菱生,34,24,10,元大-土城學府,2023-11-15,9822
2419,仲琦,11,1,10,元大-土城學府,2023-11-15,9822
3047,訊舟,10,0,10,元大-土城學府,2023-11-15,9822
1522,堤維西,9,0,9,元大-土城學府,2023-11-15,9822
6122,擎邦,20,11,9,元大-土城學府,2023-11-15,9822
00895,富邦未來車,11,3,8,元大-土城學府,2023-11-15,9822
2498,宏達電,17,9,8,元大-土城學府,2023-11-15,9822
3041,揚智,24,16,8,元大-土城學府,2023-11-15,9822
00931B,統一美債20年,8,0,8,元大-土城學府,2023-11-15,9822
3264,欣銓,7,0,7,元大-土城學府,2023-11-15,9822
2387,精元,7,0,7,元大-土城學府,2023-11-15,9822
00900,富邦特選高股息30,6,0,6,元大-土城學府,2023-11-15,9822
00687B,國泰20年美債,6,0,6,元大-土城學府,2023-11-15,9822
1532,勤美,6,0,6,元大-土城學府,2023-11-15,9822
3483,力致,7,1,6,元大-土城學府,2023-11-15,9822
3689,湧德,6,0,6,元大-土城學府,2023-11-15,9822
5309,系統電,6,0,6,元大-土城學府,2023-11-15,9822
8112,至上,6,0,6,元大-土城學府,2023-11-15,9822
0056,元大高股息,17,11,6,元大-土城學府,2023-11-15,9822
5225,東科-KY,8,3,5,元大-土城學府,2023-11-15,9822
00632R,元大台灣50反1,502,1,501,元大-土城學府,2023-11-16,9822
00669R,國泰美國道瓊反1,100,0,100,元大-土城學府,2023-11-16,9822
2543,皇昌,92,10,82,元大-土城學府,2023-11-16,9822
00679B,元大美債20年,74,0,74,元大-土城學府,2023-11-16,9822
00878,國泰永續高股息,88,15,73,元大-土城學府,2023-11-16,9822
2745,五福,53,0,53,元大-土城學府,2023-11-16,9822
2634,漢翔,47,4,43,元大-土城學府,2023-11-16,9822
6274,台燿,41,1,40,元大-土城學府,2023-11-16,9822
8426,紅木-KY,38,0,38,元大-土城學府,2023-11-16,9822
2845,遠東銀,31,0,31,元大-土城學府,2023-11-16,9822
3078,僑威,21,0,21,元大-土城學府,2023-11-16,9822
00933B,國泰10Y+金融債,20,0,20,元大-土城學府,2023-11-16,9822
2303,聯電,32,12,20,元大-土城學府,2023-11-16,9822
8088,品安,21,2,19,元大-土城學府,2023-11-16,9822
00751B,元大AAA至A公司債,15,0,15,元大-土城學府,2023-11-16,9822
00929,復華台灣科技優息,30,15,15,元大-土城學府,2023-11-16,9822
1101,台泥,15,0,15,元大-土城學府,2023-11-16,9822
1504,東元,19,4,15,元大-土城學府,2023-11-16,9822
00687B,國泰20年美債,14,0,14,元大-土城學府,2023-11-16,9822
00688L,國泰20年美債正2,14,0,14,元大-土城學府,2023-11-16,9822
00642U,期元大S＆P石油,13,0,13,元大-土城學府,2023-11-16,9822
00919,群益台灣精選高息,18,5,13,元大-土城學府,2023-11-16,9822
5706,鳳凰,17,5,12,元大-土城學府,2023-11-16,9822
2610,華航,69,58,11,元大-土城學府,2023-11-16,9822
2002,中鋼,12,1,11,元大-土城學府,2023-11-16,9822
2353,宏��,21,10,11,元大-土城學府,2023-11-16,9822
4967,十銓,15,4,11,元大-土城學府,2023-11-16,9822
3017,奇鋐,20,10,10,元大-土城學府,2023-11-16,9822
00680L,元大美債20正2,10,0,10,元大-土城學府,2023-11-16,9822
1815,富喬,12,2,10,元大-土城學府,2023-11-16,9822
3362,先進光,10,0,10,元大-土城學府,2023-11-16,9822
5460,同協,12,2,10,元大-土城學府,2023-11-16,9822
6026,福邦證,10,0,10,元大-土城學府,2023-11-16,9822
1515,力山,54,45,9,元大-土城學府,2023-11-16,9822
6290,良維,9,0,9,元大-土城學府,2023-11-16,9822
2376,技嘉,21,13,8,元大-土城學府,2023-11-16,9822
00720B,元大投資級公司債,8,0,8,元大-土城學府,2023-11-16,9822
6695,芯鼎,8,0,8,元大-土城學府,2023-11-16,9822
8034,榮群,11,3,8,元大-土城學府,2023-11-16,9822
2363,矽統,42,34,8,元大-土城學府,2023-11-16,9822
0056,元大高股息,7,0,7,元大-土城學府,2023-11-16,9822
00934,中信成長高股息,23,16,7,元大-土城學府,2023-11-16,9822
2417,圓剛,53,46,7,元大-土城學府,2023-11-16,9822
3013,晟銘電,7,0,7,元大-土城學府,2023-11-16,9822
5351,鈺創,7,0,7,元大-土城學府,2023-11-16,9822
8176,智捷,7,0,7,元大-土城學府,2023-11-16,9822
00850,元大臺灣ESG永續,10,4,6,元大-土城學府,2023-11-16,9822
00795B,中信美國公債20年,6,0,6,元大-土城學府,2023-11-16,9822
2228,劍麟,6,0,6,元大-土城學府,2023-11-16,9822
4908,前鼎,6,0,6,元大-土城學府,2023-11-16,9822
2543,皇昌,211,73,138,元大-土城學府,2023-11-17,9822
2618,長榮航,148,35,113,元大-土城學府,2023-11-17,9822
00632R,元大台灣50反1,122,20,102,元大-土城學府,2023-11-17,9822
00929,復華台灣科技優息,54,0,54,元大-土城學府,2023-11-17,9822
00933B,國泰10Y+金融債,51,0,51,元大-土城學府,2023-11-17,9822
1522,堤維西,46,0,46,元大-土城學府,2023-11-17,9822
00715L,期街口布蘭特正2,46,3,43,元大-土城學府,2023-11-17,9822
2501,國建,41,0,41,元大-土城學府,2023-11-17,9822
00878,國泰永續高股息,44,7,37,元大-土城學府,2023-11-17,9822
1815,富喬,35,4,31,元大-土城學府,2023-11-17,9822
9904,寶成,30,0,30,元大-土城學府,2023-11-17,9822
2892,第一金,30,1,29,元大-土城學府,2023-11-17,9822
2313,華通,38,11,27,元大-土城學府,2023-11-17,9822
6163,華電網,26,0,26,元大-土城學府,2023-11-17,9822
00679B,元大美債20年,23,1,22,元大-土城學府,2023-11-17,9822
2603,長榮,21,1,20,元大-土城學府,2023-11-17,9822
00687B,國泰20年美債,18,0,18,元大-土城學府,2023-11-17,9822
2353,宏��,17,0,17,元大-土城學府,2023-11-17,9822
2516,新建,16,0,16,元大-土城學府,2023-11-17,9822
2851,中再保,20,4,16,元大-土城學府,2023-11-17,9822
3041,揚智,84,68,16,元大-土城學府,2023-11-17,9822
00642U,期元大S＆P石油,14,1,13,元大-土城學府,2023-11-17,9822
00637L,元大滬深300正2,13,0,13,元大-土城學府,2023-11-17,9822
3625,西勝,13,0,13,元大-土城學府,2023-11-17,9822
6274,台燿,19,7,12,元大-土城學府,2023-11-17,9822
4979,華星光,14,3,11,元大-土城學府,2023-11-17,9822
2382,廣達,11,0,11,元大-土城學府,2023-11-17,9822
1463,強盛新,11,0,11,元大-土城學府,2023-11-17,9822
2417,圓剛,15,4,11,元大-土城學府,2023-11-17,9822
4526,東台,12,1,11,元大-土城學府,2023-11-17,9822
5439,高技,13,2,11,元大-土城學府,2023-11-17,9822
6282,康舒,14,4,10,元大-土城學府,2023-11-17,9822
00712,復華富時不動產,15,5,10,元大-土城學府,2023-11-17,9822
00934,中信成長高股息,11,1,10,元大-土城學府,2023-11-17,9822
2610,華航,18,8,10,元大-土城學府,2023-11-17,9822
00892,富邦台灣半導體,10,0,10,元大-土城學府,2023-11-17,9822
1718,中纖,10,0,10,元大-土城學府,2023-11-17,9822
3056,富華新,10,0,10,元大-土城學府,2023-11-17,9822
3526,凡甲,10,0,10,元大-土城學府,2023-11-17,9822
3715,定穎投控,32,22,10,元大-土城學府,2023-11-17,9822
00931B,統一美債20年,10,2,8,元大-土城學府,2023-11-17,9822
3363,上詮,9,1,8,元大-土城學府,2023-11-17,9822
6456,GIS-KY,9,1,8,元大-土城學府,2023-11-17,9822
2457,飛宏,10,2,8,元大-土城學府,2023-11-17,9822
00665L,富邦�琤肭磪囓�2,7,0,7,元大-土城學府,2023-11-17,9822
2301,光寶科,18,11,7,元大-土城學府,2023-11-17,9822
2312,金寶,10,3,7,元大-土城學府,2023-11-17,9822
2344,華邦電,15,8,7,元大-土城學府,2023-11-17,9822
1809,中釉,7,1,6,元大-土城學府,2023-11-17,9822
2367,燿華,9,3,6,元大-土城學府,2023-11-17,9822
2543,皇昌,209,3,206,元大-土城學府,2023-11-20,9822
2355,敬鵬,150,30,120,元大-土城學府,2023-11-20,9822
00706L,期元大S＆P日圓正2,102,0,102,元大-土城學府,2023-11-20,9822
4906,正文,101,0,101,元大-土城學府,2023-11-20,9822
6125,廣運,50,12,38,元大-土城學府,2023-11-20,9822
2356,英業達,44,8,36,元大-土城學府,2023-11-20,9822
00933B,國泰10Y+金融債,31,0,31,元大-土城學府,2023-11-20,9822
2516,新建,34,4,30,元大-土城學府,2023-11-20,9822
00690,兆豐藍籌30,27,0,27,元大-土城學府,2023-11-20,9822
2610,華航,35,10,25,元大-土城學府,2023-11-20,9822
8050,廣積,27,3,24,元大-土城學府,2023-11-20,9822
00687B,國泰20年美債,22,0,22,元大-土城學府,2023-11-20,9822
6233,旺玖,25,4,21,元大-土城學府,2023-11-20,9822
2484,希華,21,1,20,元大-土城學府,2023-11-20,9822
2723,美食-KY,20,0,20,元大-土城學府,2023-11-20,9822
2734,易飛網,20,0,20,元大-土城學府,2023-11-20,9822
00878,國泰永續高股息,20,0,20,元大-土城學府,2023-11-20,9822
2449,京元電子,19,0,19,元大-土城學府,2023-11-20,9822
2329,華泰,19,1,18,元大-土城學府,2023-11-20,9822
9904,寶成,18,0,18,元大-土城學府,2023-11-20,9822
8034,榮群,26,9,17,元大-土城學府,2023-11-20,9822
2891,中信金,17,0,17,元大-土城學府,2023-11-20,9822
2421,建準,14,0,14,元大-土城學府,2023-11-20,9822
2498,宏達電,16,2,14,元大-土城學府,2023-11-20,9822
3481,群創,12,0,12,元大-土城學府,2023-11-20,9822
2002,中鋼,12,0,12,元大-土城學府,2023-11-20,9822
00935,野村臺灣新科技50,12,0,12,元大-土城學府,2023-11-20,9822
1402,遠東新,12,0,12,元大-土城學府,2023-11-20,9822
00751B,元大AAA至A公司債,11,0,11,元大-土城學府,2023-11-20,9822
00696B,富邦美債20年,11,0,11,元大-土城學府,2023-11-20,9822
2317,鴻海,13,2,11,元大-土城學府,2023-11-20,9822
9945,潤泰新,10,0,10,元大-土城學府,2023-11-20,9822
2301,光寶科,13,3,10,元大-土城學府,2023-11-20,9822
2312,金寶,19,9,10,元大-土城學府,2023-11-20,9822
4968,立積,10,0,10,元大-土城學府,2023-11-20,9822
5701,劍湖山,10,0,10,元大-土城學府,2023-11-20,9822
6104,創惟,14,4,10,元大-土城學府,2023-11-20,9822
00931B,統一美債20年,10,0,10,元大-土城學府,2023-11-20,9822
2615,萬海,12,3,9,元大-土城學府,2023-11-20,9822
1609,大亞,10,1,9,元大-土城學府,2023-11-20,9822
2313,華通,25,16,9,元大-土城學府,2023-11-20,9822
2618,長榮航,45,36,9,元大-土城學府,2023-11-20,9822
5009,榮剛,10,1,9,元大-土城學府,2023-11-20,9822
8996,高力,52,44,8,元大-土城學府,2023-11-20,9822
5483,中美晶,9,1,8,元大-土城學府,2023-11-20,9822
1217,愛之味,10,2,8,元大-土城學府,2023-11-20,9822
2405,輔信,23,15,8,元大-土城學府,2023-11-20,9822
3567,逸昌,9,1,8,元大-土城學府,2023-11-20,9822
00857B,永豐20年美公債,7,0,7,元大-土城學府,2023-11-20,9822
2382,廣達,13,7,6,元大-土城學府,2023-11-20,9822
2516,新建,418,6,412,元大-土城學府,2023-11-21,9822
2355,敬鵬,88,15,73,元大-土城學府,2023-11-21,9822
6237,驊訊,79,13,66,元大-土城學府,2023-11-21,9822
00929,復華台灣科技優息,89,48,41,元大-土城學府,2023-11-21,9822
2313,華通,111,80,31,元大-土城學府,2023-11-21,9822
2303,聯電,34,4,30,元大-土城學府,2023-11-21,9822
2449,京元電子,26,6,20,元大-土城學府,2023-11-21,9822
6191,精成科,21,1,20,元大-土城學府,2023-11-21,9822
3380,明泰,20,1,19,元大-土城學府,2023-11-21,9822
2390,云辰,18,0,18,元大-土城學府,2023-11-21,9822
8046,南電,21,4,17,元大-土城學府,2023-11-21,9822
4933,友輝,18,1,17,元大-土城學府,2023-11-21,9822
5351,鈺創,40,23,17,元大-土城學府,2023-11-21,9822
2374,佳能,14,0,14,元大-土城學府,2023-11-21,9822
2484,希華,14,0,14,元大-土城學府,2023-11-21,9822
00891,中信關鍵半導體,16,3,13,元大-土城學府,2023-11-21,9822
2409,友達,20,7,13,元大-土城學府,2023-11-21,9822
3512,皇龍,15,3,12,元大-土城學府,2023-11-21,9822
8050,廣積,19,7,12,元大-土城學府,2023-11-21,9822
6235,華孚,21,10,11,元大-土城學府,2023-11-21,9822
1513,中興電,11,0,11,元大-土城學府,2023-11-21,9822
00934,中信成長高股息,10,0,10,元大-土城學府,2023-11-21,9822
00751B,元大AAA至A公司債,10,0,10,元大-土城學府,2023-11-21,9822
1471,首利,10,0,10,元大-土城學府,2023-11-21,9822
3234,光環,10,0,10,元大-土城學府,2023-11-21,9822
3710,連展投控,10,0,10,元大-土城學府,2023-11-21,9822
4503,金雨,10,0,10,元大-土城學府,2023-11-21,9822
6129,普誠,10,0,10,元大-土城學府,2023-11-21,9822
3715,定穎投控,29,20,9,元大-土城學府,2023-11-21,9822
3322,建舜電,9,0,9,元大-土城學府,2023-11-21,9822
3149,正達,9,0,9,元大-土城學府,2023-11-21,9822
3264,欣銓,14,5,9,元大-土城學府,2023-11-21,9822
00679B,元大美債20年,8,0,8,元大-土城學府,2023-11-21,9822
3044,健鼎,8,0,8,元大-土城學府,2023-11-21,9822
1517,利奇,10,2,8,元大-土城學府,2023-11-21,9822
3013,晟銘電,8,0,8,元大-土城學府,2023-11-21,9822
5225,東科-KY,8,0,8,元大-土城學府,2023-11-21,9822
6158,禾昌,8,0,8,元大-土城學府,2023-11-21,9822
00882,中信中國高股息,7,0,7,元大-土城學府,2023-11-21,9822
3325,旭品,24,17,7,元大-土城學府,2023-11-21,9822
6456,GIS-KY,7,0,7,元大-土城學府,2023-11-21,9822
00895,富邦未來車,6,0,6,元大-土城學府,2023-11-21,9822
00885,富邦越南,6,0,6,元大-土城學府,2023-11-21,9822
00931B,統一美債20年,6,0,6,元大-土城學府,2023-11-21,9822
1524,耿鼎,12,6,6,元大-土城學府,2023-11-21,9822
2371,大同,6,0,6,元大-土城學府,2023-11-21,9822
2851,中再保,10,4,6,元大-土城學府,2023-11-21,9822
3163,波若威,12,6,6,元大-土城學府,2023-11-21,9822
4714,永捷,6,0,6,元大-土城學府,2023-11-21,9822
2465,麗臺,7,1,6,元大-土城學府,2023-11-21,9822
2516,新建,191,35,156,元大-土城學府,2023-11-22,9822
2014,中鴻,103,0,103,元大-土城學府,2023-11-22,9822
6757,台灣虎航,90,0,90,元大-土城學府,2023-11-22,9822
00929,復華台灣科技優息,83,4,79,元大-土城學府,2023-11-22,9822
2353,宏��,75,0,75,元大-土城學府,2023-11-22,9822
3147,大綜,70,5,65,元大-土城學府,2023-11-22,9822
1447,力鵬,40,0,40,元大-土城學府,2023-11-22,9822
3231,緯創,54,21,33,元大-土城學府,2023-11-22,9822
2610,華航,37,5,32,元大-土城學府,2023-11-22,9822
00687B,國泰20年美債,32,0,32,元大-土城學府,2023-11-22,9822
2892,第一金,30,2,28,元大-土城學府,2023-11-22,9822
00934,中信成長高股息,26,0,26,元大-土城學府,2023-11-22,9822
3545,敦泰,33,10,23,元大-土城學府,2023-11-22,9822
6129,普誠,28,5,23,元大-土城學府,2023-11-22,9822
9904,寶成,23,1,22,元大-土城學府,2023-11-22,9822
2356,英業達,33,12,21,元大-土城學府,2023-11-22,9822
2301,光寶科,20,0,20,元大-土城學府,2023-11-22,9822
2883,凱基金,33,14,19,元大-土城學府,2023-11-22,9822
00679B,元大美債20年,18,0,18,元大-土城學府,2023-11-22,9822
2329,華泰,18,1,17,元大-土城學府,2023-11-22,9822
00919,群益台灣精選高息,33,16,17,元大-土城學府,2023-11-22,9822
00936,台新永續高息中小,17,0,17,元大-土城學府,2023-11-22,9822
2201,裕隆,19,3,16,元大-土城學府,2023-11-22,9822
1463,強盛新,17,2,15,元大-土城學府,2023-11-22,9822
2888,新光金,14,0,14,元大-土城學府,2023-11-22,9822
6139,亞翔,44,30,14,元大-土城學府,2023-11-22,9822
6191,精成科,14,0,14,元大-土城學府,2023-11-22,9822
2382,廣達,19,5,14,元大-土城學府,2023-11-22,9822
5521,工信,21,8,13,元大-土城學府,2023-11-22,9822
00688L,國泰20年美債正2,12,0,12,元大-土城學府,2023-11-22,9822
8046,南電,15,3,12,元大-土城學府,2023-11-22,9822
3583,辛耘,13,1,12,元大-土城學府,2023-11-22,9822
4744,皇將,11,0,11,元大-土城學府,2023-11-22,9822
4979,華星光,12,1,11,元大-土城學府,2023-11-22,9822
00680L,元大美債20正2,10,0,10,元大-土城學府,2023-11-22,9822
3217,優群,11,1,10,元大-土城學府,2023-11-22,9822
3512,皇龍,10,0,10,元大-土城學府,2023-11-22,9822
6235,華孚,10,0,10,元大-土城學府,2023-11-22,9822
2405,輔信,30,21,9,元大-土城學府,2023-11-22,9822
5533,皇鼎,41,32,9,元大-土城學府,2023-11-22,9822
5706,鳳凰,10,1,9,元大-土城學府,2023-11-22,9822
2376,技嘉,11,3,8,元大-土城學府,2023-11-22,9822
2482,連宇,7,0,7,元大-土城學府,2023-11-22,9822
2601,益航,7,0,7,元大-土城學府,2023-11-22,9822
2801,彰銀,7,0,7,元大-土城學府,2023-11-22,9822
3047,訊舟,14,7,7,元大-土城學府,2023-11-22,9822
3252,海灣,8,1,7,元大-土城學府,2023-11-22,9822
6104,創惟,15,8,7,元大-土城學府,2023-11-22,9822
6125,廣運,7,0,7,元大-土城學府,2023-11-22,9822
6770,力積電,13,6,7,元大-土城學府,2023-11-22,9822
3402,漢科,70,0,70,元大-土城學府,2023-11-23,9822
6411,晶焱,56,0,56,元大-土城學府,2023-11-23,9822
3041,揚智,130,76,54,元大-土城學府,2023-11-23,9822
2363,矽統,72,20,52,元大-土城學府,2023-11-23,9822
5292,華懋,40,0,40,元大-土城學府,2023-11-23,9822
6139,亞翔,55,16,39,元大-土城學府,2023-11-23,9822
00878,國泰永續高股息,42,4,38,元大-土城學府,2023-11-23,9822
2382,廣達,38,11,27,元大-土城學府,2023-11-23,9822
5465,富驊,34,7,27,元大-土城學府,2023-11-23,9822
3363,上詮,44,19,25,元大-土城學府,2023-11-23,9822
3231,緯創,46,22,24,元大-土城學府,2023-11-23,9822
6146,耕興,21,0,21,元大-土城學府,2023-11-23,9822
3169,亞信,32,12,20,元大-土城學府,2023-11-23,9822
2883,凱基金,30,11,19,元大-土城學府,2023-11-23,9822
8086,宏捷科,19,0,19,元大-土城學府,2023-11-23,9822
3006,晶豪科,37,20,17,元大-土城學府,2023-11-23,9822
00900,富邦特選高股息30,16,0,16,元大-土城學府,2023-11-23,9822
2516,新建,20,6,14,元大-土城學府,2023-11-23,9822
00936,台新永續高息中小,13,0,13,元大-土城學府,2023-11-23,9822
2367,燿華,13,0,13,元大-土城學府,2023-11-23,9822
6243,迅杰,14,1,13,元大-土城學府,2023-11-23,9822
0056,元大高股息,11,0,11,元大-土城學府,2023-11-23,9822
4967,十銓,19,8,11,元大-土城學府,2023-11-23,9822
2498,宏達電,13,2,11,元大-土城學府,2023-11-23,9822
3094,聯傑,17,6,11,元大-土城學府,2023-11-23,9822
5236,凌陽創新,11,0,11,元大-土城學府,2023-11-23,9822
2368,金像電,12,2,10,元大-土城學府,2023-11-23,9822
3027,盛達,10,0,10,元大-土城學府,2023-11-23,9822
3078,僑威,29,19,10,元大-土城學府,2023-11-23,9822
8183,精星,10,0,10,元大-土城學府,2023-11-23,9822
8358,金居,33,23,10,元大-土城學府,2023-11-23,9822
6223,旺矽,13,3,10,元大-土城學府,2023-11-23,9822
3122,笙泉,16,7,9,元大-土城學府,2023-11-23,9822
00929,復華台灣科技優息,34,26,8,元大-土城學府,2023-11-23,9822
4960,誠美材,13,5,8,元大-土城學府,2023-11-23,9822
5521,工信,36,28,8,元大-土城學府,2023-11-23,9822
6237,驊訊,25,17,8,元大-土城學府,2023-11-23,9822
8046,南電,9,1,8,元大-土城學府,2023-11-23,9822
2462,良得電,7,0,7,元大-土城學府,2023-11-23,9822
3051,力特,7,0,7,元大-土城學府,2023-11-23,9822
3706,神達,7,0,7,元大-土城學府,2023-11-23,9822
4906,正文,9,2,7,元大-土城學府,2023-11-23,9822
6104,創惟,9,2,7,元大-土城學府,2023-11-23,9822
8040,九暘,7,0,7,元大-土城學府,2023-11-23,9822
8996,高力,8,2,6,元大-土城學府,2023-11-23,9822
2002,中鋼,9,3,6,元大-土城學府,2023-11-23,9822
4979,華星光,7,1,6,元大-土城學府,2023-11-23,9822
00934,中信成長高股息,6,0,6,元大-土城學府,2023-11-23,9822
1524,耿鼎,11,5,6,元大-土城學府,2023-11-23,9822
2736,富野,6,0,6,元大-土城學府,2023-11-23,9822
2618,長榮航,127,28,99,元大-土城學府,2023-11-24,9822
00680L,元大美債20正2,95,0,95,元大-土城學府,2023-11-24,9822
00632R,元大台灣50反1,32,0,32,元大-土城學府,2023-11-24,9822
8442,威宏-KY,28,0,28,元大-土城學府,2023-11-24,9822
00878,國泰永續高股息,28,1,27,元大-土城學府,2023-11-24,9822
6146,耕興,27,0,27,元大-土城學府,2023-11-24,9822
8054,安國,33,7,26,元大-土城學府,2023-11-24,9822
00688L,國泰20年美債正2,25,0,25,元大-土城學府,2023-11-24,9822
3701,大眾控,25,0,25,元大-土城學府,2023-11-24,9822
5351,鈺創,72,47,25,元大-土城學府,2023-11-24,9822
2610,華航,36,14,22,元大-土城學府,2023-11-24,9822
00696B,富邦美債20年,21,0,21,元大-土城學府,2023-11-24,9822
1815,富喬,23,3,20,元大-土城學府,2023-11-24,9822
2316,楠梓電,20,0,20,元大-土城學府,2023-11-24,9822
00679B,元大美債20年,21,1,20,元大-土城學府,2023-11-24,9822
00931B,統一美債20年,17,0,17,元大-土城學府,2023-11-24,9822
00934,中信成長高股息,18,1,17,元大-土城學府,2023-11-24,9822
00929,復華台灣科技優息,39,22,17,元大-土城學府,2023-11-24,9822
3264,欣銓,15,0,15,元大-土城學府,2023-11-24,9822
00687B,國泰20年美債,14,0,14,元大-土城學府,2023-11-24,9822
2634,漢翔,31,18,13,元大-土城學府,2023-11-24,9822
3234,光環,12,0,12,元大-土城學府,2023-11-24,9822
4906,正文,12,0,12,元大-土城學府,2023-11-24,9822
6282,康舒,26,14,12,元大-土城學府,2023-11-24,9822
0056,元大高股息,14,3,11,元大-土城學府,2023-11-24,9822
4908,前鼎,13,2,11,元大-土城學府,2023-11-24,9822
1471,首利,23,12,11,元大-土城學府,2023-11-24,9822
1608,華榮,11,0,11,元大-土城學府,2023-11-24,9822
2527,宏璟,11,0,11,元大-土城學府,2023-11-24,9822
3041,揚智,15,4,11,元大-土城學府,2023-11-24,9822
1609,大亞,15,5,10,元大-土城學府,2023-11-24,9822
2722,夏都,10,0,10,元大-土城學府,2023-11-24,9822
3094,聯傑,24,14,10,元大-土城學府,2023-11-24,9822
9904,寶成,10,0,10,元大-土城學府,2023-11-24,9822
00713,元大台灣高息低波,10,0,10,元大-土城學府,2023-11-24,9822
2344,華邦電,12,3,9,元大-土城學府,2023-11-24,9822
1760,寶齡富錦,9,0,9,元大-土城學府,2023-11-24,9822
2888,新光金,14,5,9,元大-土城學府,2023-11-24,9822
2891,中信金,8,0,8,元大-土城學府,2023-11-24,9822
3227,原相,10,3,7,元大-土城學府,2023-11-24,9822
5706,鳳凰,8,1,7,元大-土城學府,2023-11-24,9822
6237,驊訊,14,7,7,元大-土城學府,2023-11-24,9822
2353,宏��,53,47,6,元大-土城學府,2023-11-24,9822
00850,元大臺灣ESG永續,6,0,6,元大-土城學府,2023-11-24,9822
6235,華孚,16,10,6,元大-土城學府,2023-11-24,9822
00905,FT臺灣Smart,6,0,6,元大-土城學府,2023-11-24,9822
00933B,國泰10Y+金融債,6,0,6,元大-土城學府,2023-11-24,9822
2739,寒舍,6,0,6,元大-土城學府,2023-11-24,9822
5328,華容,6,0,6,元大-土城學府,2023-11-24,9822
6223,旺矽,6,0,6,元大-土城學府,2023-11-24,9822
00706L,期元大S＆P日圓正2,102,0,102,元大-土城學府,2023-11-27,9822
2303,聯電,100,15,85,元大-土城學府,2023-11-27,9822
00934,中信成長高股息,71,0,71,元大-土城學府,2023-11-27,9822
00919,群益台灣精選高息,62,2,60,元大-土城學府,2023-11-27,9822
2618,長榮航,112,62,50,元大-土城學府,2023-11-27,9822
2527,宏璟,48,0,48,元大-土城學府,2023-11-27,9822
00929,復華台灣科技優息,58,12,46,元大-土城學府,2023-11-27,9822
8916,光隆,44,0,44,元大-土城學府,2023-11-27,9822
2883,凱基金,36,3,33,元大-土城學府,2023-11-27,9822
8442,威宏-KY,35,2,33,元大-土城學府,2023-11-27,9822
2363,矽統,53,21,32,元大-土城學府,2023-11-27,9822
00878,國泰永續高股息,32,0,32,元大-土城學府,2023-11-27,9822
9904,寶成,28,0,28,元大-土城學府,2023-11-27,9822
2457,飛宏,31,4,27,元大-土城學府,2023-11-27,9822
0056,元大高股息,25,1,24,元大-土城學府,2023-11-27,9822
4714,永捷,23,0,23,元大-土城學府,2023-11-27,9822
5009,榮剛,21,0,21,元大-土城學府,2023-11-27,9822
00632R,元大台灣50反1,32,11,21,元大-土城學府,2023-11-27,9822
5475,德宏,20,0,20,元大-土城學府,2023-11-27,9822
6116,彩晶,20,0,20,元大-土城學府,2023-11-27,9822
2610,華航,19,1,18,元大-土城學府,2023-11-27,9822
3372,典範,17,0,17,元大-土城學府,2023-11-27,9822
3231,緯創,31,14,17,元大-土城學府,2023-11-27,9822
5347,世界,39,23,16,元大-土城學府,2023-11-27,9822
2887,台新金,22,6,16,元大-土城學府,2023-11-27,9822
00679B,元大美債20年,27,12,15,元大-土城學府,2023-11-27,9822
8086,宏捷科,20,5,15,元大-土城學府,2023-11-27,9822
3017,奇鋐,20,6,14,元大-土城學府,2023-11-27,9822
00902,中信電池及儲能,14,0,14,元大-土城學府,2023-11-27,9822
3682,亞太電,14,0,14,元大-土城學府,2023-11-27,9822
6282,康舒,72,59,13,元大-土城學府,2023-11-27,9822
2498,宏達電,12,0,12,元大-土城學府,2023-11-27,9822
1584,精剛,15,4,11,元大-土城學府,2023-11-27,9822
3094,聯傑,11,0,11,元大-土城學府,2023-11-27,9822
6578,達邦蛋白,12,1,11,元大-土城學府,2023-11-27,9822
2356,英業達,15,5,10,元大-土城學府,2023-11-27,9822
2344,華邦電,10,0,10,元大-土城學府,2023-11-27,9822
6901,鑽石投資,12,2,10,元大-土城學府,2023-11-27,9822
1618,合機,10,0,10,元大-土城學府,2023-11-27,9822
4707,磐亞,10,0,10,元大-土城學府,2023-11-27,9822
6706,惠特,11,1,10,元大-土城學府,2023-11-27,9822
4968,立積,12,2,10,元大-土城學府,2023-11-27,9822
1513,中興電,36,27,9,元大-土城學府,2023-11-27,9822
2884,玉山金,10,1,9,元大-土城學府,2023-11-27,9822
00891,中信關鍵半導體,9,0,9,元大-土城學府,2023-11-27,9822
1517,利奇,9,0,9,元大-土城學府,2023-11-27,9822
00915,凱基優選高股息30,8,0,8,元大-土城學府,2023-11-27,9822
2516,新建,8,0,8,元大-土城學府,2023-11-27,9822
3234,光環,7,0,7,元大-土城學府,2023-11-27,9822
3558,神準,7,0,7,元大-土城學府,2023-11-27,9822
4906,正文,61,0,61,元大-土城學府,2023-11-28,9822
2527,宏璟,44,0,44,元大-土城學府,2023-11-28,9822
4968,立積,42,2,40,元大-土城學府,2023-11-28,9822
5292,華懋,38,0,38,元大-土城學府,2023-11-28,9822
2303,聯電,61,23,38,元大-土城學府,2023-11-28,9822
2353,宏��,52,21,31,元大-土城學府,2023-11-28,9822
00632R,元大台灣50反1,42,15,27,元大-土城學府,2023-11-28,9822
1514,亞力,49,22,27,元大-土城學府,2023-11-28,9822
3576,聯合再生,20,0,20,元大-土城學府,2023-11-28,9822
2472,立隆電,18,0,18,元大-土城學府,2023-11-28,9822
3231,緯創,25,7,18,元大-土城學府,2023-11-28,9822
9103,美德醫療-DR,21,4,17,元大-土城學府,2023-11-28,9822
00902,中信電池及儲能,14,0,14,元大-土城學府,2023-11-28,9822
00637L,元大滬深300正2,13,0,13,元大-土城學府,2023-11-28,9822
2606,裕民,33,20,13,元大-土城學府,2023-11-28,9822
4114,健喬,25,13,12,元大-土城學府,2023-11-28,9822
4121,優盛,12,0,12,元大-土城學府,2023-11-28,9822
00919,群益台灣精選高息,12,0,12,元大-土城學府,2023-11-28,9822
6129,普誠,22,11,11,元大-土城學府,2023-11-28,9822
00679B,元大美債20年,12,1,11,元大-土城學府,2023-11-28,9822
3047,訊舟,11,0,11,元大-土城學府,2023-11-28,9822
00646,元大S＆P500,10,0,10,元大-土城學府,2023-11-28,9822
1217,愛之味,10,0,10,元大-土城學府,2023-11-28,9822
2612,中航,22,12,10,元大-土城學府,2023-11-28,9822
3701,大眾控,10,0,10,元大-土城學府,2023-11-28,9822
4707,磐亞,10,0,10,元大-土城學府,2023-11-28,9822
5871,中租-KY,10,0,10,元大-土城學府,2023-11-28,9822
00751B,元大AAA至A公司債,10,1,9,元大-土城學府,2023-11-28,9822
2399,映泰,14,5,9,元大-土城學府,2023-11-28,9822
3051,力特,12,3,9,元大-土城學府,2023-11-28,9822
8442,威宏-KY,9,0,9,元大-土城學府,2023-11-28,9822
1447,力鵬,10,2,8,元大-土城學府,2023-11-28,9822
2388,威盛,26,19,7,元大-土城學府,2023-11-28,9822
2605,新興,9,2,7,元大-土城學府,2023-11-28,9822
3013,晟銘電,8,1,7,元大-土城學府,2023-11-28,9822
6278,台表科,7,0,7,元大-土城學府,2023-11-28,9822
00882,中信中國高股息,6,0,6,元大-土城學府,2023-11-28,9822
1325,恆大,6,0,6,元大-土城學府,2023-11-28,9822
1762,中化生,6,0,6,元大-土城學府,2023-11-28,9822
6443,元晶,6,0,6,元大-土城學府,2023-11-28,9822
2610,華航,9,4,5,元大-土城學府,2023-11-28,9822
00712,復華富時不動產,5,0,5,元大-土城學府,2023-11-28,9822
1314,中石化,5,0,5,元大-土城學府,2023-11-28,9822
1701,中化,13,8,5,元大-土城學府,2023-11-28,9822
1714,和桐,5,0,5,元大-土城學府,2023-11-28,9822
2308,台達電,5,0,5,元大-土城學府,2023-11-28,9822
2457,飛宏,5,0,5,元大-土城學府,2023-11-28,9822
2892,第一金,5,0,5,元大-土城學府,2023-11-28,9822
3673,TPK-KY,5,0,5,元大-土城學府,2023-11-28,9822
4961,天鈺,5,0,5,元大-土城學府,2023-11-28,9822
2369,菱生,98,25,73,元大-土城學府,2023-11-29,9822
1517,利奇,70,0,70,元大-土城學府,2023-11-29,9822
2618,長榮航,60,5,55,元大-土城學府,2023-11-29,9822
00688L,國泰20年美債正2,42,0,42,元大-土城學府,2023-11-29,9822
3265,台星科,41,1,40,元大-土城學府,2023-11-29,9822
2363,矽統,63,27,36,元大-土城學府,2023-11-29,9822
8442,威宏-KY,34,0,34,元大-土城學府,2023-11-29,9822
4906,正文,30,0,30,元大-土城學府,2023-11-29,9822
1616,億泰,30,5,25,元大-土城學府,2023-11-29,9822
00933B,國泰10Y+金融債,21,0,21,元大-土城學府,2023-11-29,9822
6284,佳邦,23,2,21,元大-土城學府,2023-11-29,9822
00919,群益台灣精選高息,26,5,21,元大-土城學府,2023-11-29,9822
00665L,富邦�琤肭磪囓�2,18,0,18,元大-土城學府,2023-11-29,9822
2313,華通,117,100,17,元大-土城學府,2023-11-29,9822
8054,安國,49,33,16,元大-土城學府,2023-11-29,9822
2409,友達,13,0,13,元大-土城學府,2023-11-29,9822
6282,康舒,25,12,13,元大-土城學府,2023-11-29,9822
00878,國泰永續高股息,34,22,12,元大-土城學府,2023-11-29,9822
6163,華電網,12,0,12,元大-土城學府,2023-11-29,9822
00679B,元大美債20年,14,2,12,元大-土城學府,2023-11-29,9822
2867,三商壽,11,0,11,元大-土城學府,2023-11-29,9822
00885,富邦越南,11,0,11,元大-土城學府,2023-11-29,9822
2449,京元電子,12,1,11,元大-土城學府,2023-11-29,9822
2610,華航,13,3,10,元大-土城學府,2023-11-29,9822
2382,廣達,24,14,10,元大-土城學府,2023-11-29,9822
3231,緯創,22,12,10,元大-土城學府,2023-11-29,9822
00850,元大臺灣ESG永續,10,0,10,元大-土城學府,2023-11-29,9822
00904,新光臺灣半導體30,10,0,10,元大-土城學府,2023-11-29,9822
1217,愛之味,10,0,10,元大-土城學府,2023-11-29,9822
1718,中纖,10,0,10,元大-土城學府,2023-11-29,9822
3105,穩懋,11,1,10,元大-土城學府,2023-11-29,9822
3576,聯合再生,10,0,10,元大-土城學府,2023-11-29,9822
5381,合正,13,3,10,元大-土城學府,2023-11-29,9822
8050,廣積,11,1,10,元大-土城學府,2023-11-29,9822
3041,揚智,14,4,10,元大-土城學府,2023-11-29,9822
8996,高力,13,4,9,元大-土城學府,2023-11-29,9822
1453,大將,9,0,9,元大-土城學府,2023-11-29,9822
3025,星通,12,3,9,元大-土城學府,2023-11-29,9822
1513,中興電,10,2,8,元大-土城學府,2023-11-29,9822
00751B,元大AAA至A公司債,8,0,8,元大-土城學府,2023-11-29,9822
2471,資通,8,0,8,元大-土城學府,2023-11-29,9822
2634,漢翔,11,3,8,元大-土城學府,2023-11-29,9822
00637L,元大滬深300正2,7,0,7,元大-土城學府,2023-11-29,9822
2401,凌陽,16,9,7,元大-土城學府,2023-11-29,9822
3372,典範,7,0,7,元大-土城學府,2023-11-29,9822
5236,凌陽創新,8,1,7,元大-土城學府,2023-11-29,9822
6462,神盾,7,0,7,元大-土城學府,2023-11-29,9822
1605,華新,10,4,6,元大-土城學府,2023-11-29,9822
2436,偉詮電,6,0,6,元大-土城學府,2023-11-29,9822
2891,中信金,6,0,6,元大-土城學府,2023-11-29,9822
2883,凱基金,115,8,107,元大-土城學府,2023-11-30,9822
3402,漢科,101,3,98,元大-土城學府,2023-11-30,9822
2303,聯電,83,7,76,元大-土城學府,2023-11-30,9822
1517,利奇,71,0,71,元大-土城學府,2023-11-30,9822
2363,矽統,65,35,30,元大-土城學府,2023-11-30,9822
3322,建舜電,30,0,30,元大-土城學府,2023-11-30,9822
5351,鈺創,31,1,30,元大-土城學府,2023-11-30,9822
2605,新興,50,21,29,元大-土城學府,2023-11-30,9822
00919,群益台灣精選高息,31,4,27,元大-土城學府,2023-11-30,9822
1609,大亞,30,5,25,元大-土城學府,2023-11-30,9822
00680L,元大美債20正2,20,0,20,元大-土城學府,2023-11-30,9822
9950,萬國通,20,0,20,元大-土城學府,2023-11-30,9822
3317,尼克森,46,26,20,元大-土城學府,2023-11-30,9822
1616,億泰,26,7,19,元大-土城學府,2023-11-30,9822
00931B,統一美債20年,17,0,17,元大-土城學府,2023-11-30,9822
1463,強盛新,17,0,17,元大-土城學府,2023-11-30,9822
3231,緯創,22,6,16,元大-土城學府,2023-11-30,9822
2353,宏��,69,53,16,元大-土城學府,2023-11-30,9822
2637,慧洋-KY,16,1,15,元大-土城學府,2023-11-30,9822
2332,友訊,16,2,14,元大-土城學府,2023-11-30,9822
00892,富邦台灣半導體,15,2,13,元大-土城學府,2023-11-30,9822
4533,協易機,14,1,13,元大-土城學府,2023-11-30,9822
2344,華邦電,22,10,12,元大-土城學府,2023-11-30,9822
00679B,元大美債20年,12,1,11,元大-土城學府,2023-11-30,9822
00688L,國泰20年美債正2,10,0,10,元大-土城學府,2023-11-30,9822
5864,致和證,10,0,10,元大-土城學府,2023-11-30,9822
00882,中信中國高股息,9,0,9,元大-土城學府,2023-11-30,9822
5347,世界,9,0,9,元大-土城學府,2023-11-30,9822
2492,華新科,15,7,8,元大-土城學府,2023-11-30,9822
00728,第一金工業30,8,0,8,元大-土城學府,2023-11-30,9822
2455,全新,13,5,8,元大-土城學府,2023-11-30,9822
2618,長榮航,36,28,8,元大-土城學府,2023-11-30,9822
00665L,富邦�琤肭磪囓�2,10,3,7,元大-土城學府,2023-11-30,9822
2421,建準,8,1,7,元大-土城學府,2023-11-30,9822
2606,裕民,13,6,7,元大-土城學府,2023-11-30,9822
6558,興能高,7,0,7,元大-土城學府,2023-11-30,9822
8996,高力,8,1,7,元大-土城學府,2023-11-30,9822
00891,中信關鍵半導體,9,3,6,元大-土城學府,2023-11-30,9822
00715L,期街口布蘭特正2,15,9,6,元大-土城學府,2023-11-30,9822
2359,所羅門,8,2,6,元大-土城學府,2023-11-30,9822
3540,曜越,6,0,6,元大-土城學府,2023-11-30,9822
6117,迎廣,13,7,6,元大-土城學府,2023-11-30,9822
6257,矽格,13,7,6,元大-土城學府,2023-11-30,9822
2317,鴻海,5,0,5,元大-土城學府,2023-11-30,9822
2002,中鋼,8,3,5,元大-土城學府,2023-11-30,9822
2345,智邦,5,0,5,元大-土城學府,2023-11-30,9822
1810,和成,5,0,5,元大-土城學府,2023-11-30,9822
2884,玉山金,6,1,5,元大-土城學府,2023-11-30,9822
00713,元大台灣高息低波,5,0,5,元大-土城學府,2023-11-30,9822
2355,敬鵬,7,2,5,元大-土城學府,2023-11-30,9822
00929,復華台灣科技優息,113,1,112,元大-土城學府,2023-12-01,9822
00878,國泰永續高股息,111,2,109,元大-土城學府,2023-12-01,9822
2618,長榮航,95,1,94,元大-土城學府,2023-12-01,9822
2353,宏��,65,4,61,元大-土城學府,2023-12-01,9822
6117,迎廣,97,37,60,元大-土城學府,2023-12-01,9822
2883,凱基金,61,16,45,元大-土城學府,2023-12-01,9822
1463,強盛新,42,0,42,元大-土城學府,2023-12-01,9822
00680L,元大美債20正2,56,15,41,元大-土城學府,2023-12-01,9822
5351,鈺創,43,3,40,元大-土城學府,2023-12-01,9822
1582,信錦,66,29,37,元大-土城學府,2023-12-01,9822
3704,合勤控,54,18,36,元大-土城學府,2023-12-01,9822
00919,群益台灣精選高息,74,40,34,元大-土城學府,2023-12-01,9822
6806,森崴能源,33,1,32,元大-土城學府,2023-12-01,9822
2382,廣達,40,12,28,元大-土城學府,2023-12-01,9822
3518,柏騰,24,0,24,元大-土城學府,2023-12-01,9822
6143,振曜,24,0,24,元大-土城學府,2023-12-01,9822
3545,敦泰,28,7,21,元大-土城學府,2023-12-01,9822
3363,上詮,35,15,20,元大-土城學府,2023-12-01,9822
5608,四維航,25,7,18,元大-土城學府,2023-12-01,9822
3706,神達,23,6,17,元大-土城學府,2023-12-01,9822
2891,中信金,17,1,16,元大-土城學府,2023-12-01,9822
4420,光明,15,0,15,元大-土城學府,2023-12-01,9822
6672,騰輝電子-KY,15,0,15,元大-土城學府,2023-12-01,9822
4550,長佳,14,0,14,元大-土城學府,2023-12-01,9822
6456,GIS-KY,14,0,14,元大-土城學府,2023-12-01,9822
1101,台泥,16,2,14,元大-土城學府,2023-12-01,9822
00885,富邦越南,13,0,13,元大-土城學府,2023-12-01,9822
2338,光罩,13,0,13,元大-土城學府,2023-12-01,9822
2887,台新金,12,0,12,元大-土城學府,2023-12-01,9822
6108,競國,12,0,12,元大-土城學府,2023-12-01,9822
3231,緯創,37,25,12,元大-土城學府,2023-12-01,9822
2376,技嘉,13,2,11,元大-土城學府,2023-12-01,9822
2641,正德,21,10,11,元大-土城學府,2023-12-01,9822
6194,育富,12,1,11,元大-土城學府,2023-12-01,9822
6288,聯嘉,11,0,11,元大-土城學府,2023-12-01,9822
9941,裕融,11,0,11,元大-土城學府,2023-12-01,9822
9945,潤泰新,11,0,11,元大-土城學府,2023-12-01,9822
2390,云辰,10,0,10,元大-土城學府,2023-12-01,9822
4157,太景*-KY,12,2,10,元大-土城學府,2023-12-01,9822
5469,瀚宇博,10,0,10,元大-土城學府,2023-12-01,9822
3481,群創,11,1,10,元大-土城學府,2023-12-01,9822
00935,野村臺灣新科技50,9,0,9,元大-土城學府,2023-12-01,9822
00930,永豐ESG低碳高息,9,0,9,元大-土城學府,2023-12-01,9822
2009,第一銅,11,2,9,元大-土城學府,2023-12-01,9822
6271,同欣電,11,2,9,元大-土城學府,2023-12-01,9822
2886,兆豐金,8,0,8,元大-土城學府,2023-12-01,9822
2413,環科,8,0,8,元大-土城學府,2023-12-01,9822
2845,遠東銀,8,0,8,元大-土城學府,2023-12-01,9822
4167,松瑞藥,29,21,8,元大-土城學府,2023-12-01,9822
1514,亞力,12,4,8,元大-土城學府,2023-12-01,9822
3390,旭軟,215,8,207,元大-土城學府,2023-12-04,9822
6117,迎廣,126,34,92,元大-土城學府,2023-12-04,9822
00715L,期街口布蘭特正2,55,0,55,元大-土城學府,2023-12-04,9822
00669R,國泰美國道瓊反1,50,0,50,元大-土城學府,2023-12-04,9822
1781,合世,50,1,49,元大-土城學府,2023-12-04,9822
2367,燿華,69,24,45,元大-土城學府,2023-12-04,9822
2607,榮運,40,0,40,元大-土城學府,2023-12-04,9822
00919,群益台灣精選高息,52,17,35,元大-土城學府,2023-12-04,9822
1605,華新,43,11,32,元大-土城學府,2023-12-04,9822
00751B,元大AAA至A公司債,30,0,30,元大-土城學府,2023-12-04,9822
00687B,國泰20年美債,30,0,30,元大-土城學府,2023-12-04,9822
4167,松瑞藥,41,11,30,元大-土城學府,2023-12-04,9822
2376,技嘉,31,2,29,元大-土城學府,2023-12-04,9822
00632R,元大台灣50反1,30,2,28,元大-土城學府,2023-12-04,9822
2353,宏��,53,25,28,元大-土城學府,2023-12-04,9822
4133,亞諾法,32,5,27,元大-土城學府,2023-12-04,9822
3481,群創,122,96,26,元大-土城學府,2023-12-04,9822
2605,新興,55,36,19,元大-土城學府,2023-12-04,9822
2637,慧洋-KY,27,8,19,元大-土城學府,2023-12-04,9822
3317,尼克森,15,0,15,元大-土城學府,2023-12-04,9822
2314,台揚,14,0,14,元大-土城學府,2023-12-04,9822
2363,矽統,30,16,14,元大-土城學府,2023-12-04,9822
3706,神達,22,8,14,元大-土城學府,2023-12-04,9822
1762,中化生,15,2,13,元大-土城學府,2023-12-04,9822
3078,僑威,24,11,13,元大-土城學府,2023-12-04,9822
3054,立萬利,12,0,12,元大-土城學府,2023-12-04,9822
3715,定穎投控,18,7,11,元大-土城學府,2023-12-04,9822
2419,仲琦,11,0,11,元大-土城學府,2023-12-04,9822
3363,上詮,19,8,11,元大-土城學府,2023-12-04,9822
6122,擎邦,14,3,11,元大-土城學府,2023-12-04,9822
00665L,富邦�琤肭磪囓�2,10,0,10,元大-土城學府,2023-12-04,9822
2618,長榮航,27,17,10,元大-土城學府,2023-12-04,9822
4157,太景*-KY,12,2,10,元大-土城學府,2023-12-04,9822
4744,皇將,10,0,10,元大-土城學府,2023-12-04,9822
2481,強茂,11,2,9,元大-土城學府,2023-12-04,9822
4909,新復興,18,9,9,元大-土城學府,2023-12-04,9822
00642U,期元大S＆P石油,8,0,8,元大-土城學府,2023-12-04,9822
00712,復華富時不動產,8,0,8,元大-土城學府,2023-12-04,9822
00931B,統一美債20年,10,2,8,元大-土城學府,2023-12-04,9822
1517,利奇,8,0,8,元大-土城學府,2023-12-04,9822
00934,中信成長高股息,12,5,7,元大-土城學府,2023-12-04,9822
00918,大華優利高填息30,7,0,7,元大-土城學府,2023-12-04,9822
00915,凱基優選高股息30,7,0,7,元大-土城學府,2023-12-04,9822
2352,佳世達,7,0,7,元大-土城學府,2023-12-04,9822
2641,正德,18,11,7,元大-土城學府,2023-12-04,9822
3032,偉訓,7,0,7,元大-土城學府,2023-12-04,9822
3324,雙鴻,13,6,7,元大-土城學府,2023-12-04,9822
3684,榮昌,7,0,7,元大-土城學府,2023-12-04,9822
3710,連展投控,7,0,7,元大-土城學府,2023-12-04,9822
8096,擎亞,9,2,7,元大-土城學府,2023-12-04,9822
00937B,群益ESG投等債20,133,9,124,元大-土城學府,2023-12-05,9822
2641,正德,172,66,106,元大-土城學府,2023-12-05,9822
00919,群益台灣精選高息,93,1,92,元大-土城學府,2023-12-05,9822
00712,復華富時不動產,86,13,73,元大-土城學府,2023-12-05,9822
6194,育富,68,3,65,元大-土城學府,2023-12-05,9822
3481,群創,60,23,37,元大-土城學府,2023-12-05,9822
2353,宏��,36,2,34,元大-土城學府,2023-12-05,9822
2363,矽統,43,12,31,元大-土城學府,2023-12-05,9822
2543,皇昌,31,0,31,元大-土城學府,2023-12-05,9822
4714,永捷,31,0,31,元大-土城學府,2023-12-05,9822
3022,威強電,30,0,30,元大-土城學府,2023-12-05,9822
2887,台新金,29,0,29,元大-土城學府,2023-12-05,9822
2303,聯電,51,22,29,元大-土城學府,2023-12-05,9822
2329,華泰,80,51,29,元大-土城學府,2023-12-05,9822
00751B,元大AAA至A公司債,27,0,27,元大-土城學府,2023-12-05,9822
2637,慧洋-KY,43,19,24,元大-土城學府,2023-12-05,9822
2891,中信金,24,0,24,元大-土城學府,2023-12-05,9822
3265,台星科,23,0,23,元大-土城學府,2023-12-05,9822
00878,國泰永續高股息,28,5,23,元大-土城學府,2023-12-05,9822
00679B,元大美債20年,29,6,23,元大-土城學府,2023-12-05,9822
5608,四維航,37,15,22,元大-土城學府,2023-12-05,9822
9103,美德醫療-DR,25,4,21,元大-土城學府,2023-12-05,9822
00687B,國泰20年美債,21,0,21,元大-土城學府,2023-12-05,9822
00931B,統一美債20年,20,0,20,元大-土城學府,2023-12-05,9822
4167,松瑞藥,67,47,20,元大-土城學府,2023-12-05,9822
00929,復華台灣科技優息,33,14,19,元大-土城學府,2023-12-05,9822
1504,東元,28,10,18,元大-土城學府,2023-12-05,9822
6457,紘康,18,0,18,元大-土城學府,2023-12-05,9822
8096,擎亞,28,10,18,元大-土城學府,2023-12-05,9822
00918,大華優利高填息30,17,1,16,元大-土城學府,2023-12-05,9822
2618,長榮航,19,3,16,元大-土城學府,2023-12-05,9822
2883,凱基金,16,0,16,元大-土城學府,2023-12-05,9822
5864,致和證,18,2,16,元大-土城學府,2023-12-05,9822
00882,中信中國高股息,15,0,15,元大-土城學府,2023-12-05,9822
00888,永豐台灣ESG,18,4,14,元大-土城學府,2023-12-05,9822
00934,中信成長高股息,13,0,13,元大-土城學府,2023-12-05,9822
8086,宏捷科,28,16,12,元大-土城學府,2023-12-05,9822
2606,裕民,104,92,12,元大-土城學府,2023-12-05,9822
5347,世界,11,0,11,元大-土城學府,2023-12-05,9822
1471,首利,11,0,11,元大-土城學府,2023-12-05,9822
3380,明泰,13,2,11,元大-土城學府,2023-12-05,9822
2374,佳能,10,0,10,元大-土城學府,2023-12-05,9822
1711,永光,20,10,10,元大-土城學府,2023-12-05,9822
3545,敦泰,10,0,10,元大-土城學府,2023-12-05,9822
5381,合正,11,1,10,元大-土城學府,2023-12-05,9822
6116,彩晶,10,0,10,元大-土城學府,2023-12-05,9822
8163,達方,10,0,10,元大-土城學府,2023-12-05,9822
2882,國泰金,9,0,9,元大-土城學府,2023-12-05,9822
00715L,期街口布蘭特正2,19,10,9,元大-土城學府,2023-12-05,9822
00688L,國泰20年美債正2,9,0,9,元大-土城學府,2023-12-05,9822
2641,正德,192,36,156,元大-土城學府,2023-12-06,9822
3390,旭軟,120,0,120,元大-土城學府,2023-12-06,9822
9105,泰金寶-DR,100,0,100,元大-土城學府,2023-12-06,9822
00937B,群益ESG投等債20,96,11,85,元大-土城學府,2023-12-06,9822
1612,宏泰,80,0,80,元大-土城學府,2023-12-06,9822
2367,燿華,70,8,62,元大-土城學府,2023-12-06,9822
00919,群益台灣精選高息,56,7,49,元大-土城學府,2023-12-06,9822
5608,四維航,52,11,41,元大-土城學府,2023-12-06,9822
00679B,元大美債20年,35,1,34,元大-土城學府,2023-12-06,9822
00680L,元大美債20正2,39,5,34,元大-土城學府,2023-12-06,9822
2607,榮運,34,3,31,元大-土城學府,2023-12-06,9822
00687B,國泰20年美債,33,5,28,元大-土城學府,2023-12-06,9822
2324,仁寶,40,13,27,元大-土城學府,2023-12-06,9822
00931B,統一美債20年,27,0,27,元大-土城學府,2023-12-06,9822
00688L,國泰20年美債正2,27,0,27,元大-土城學府,2023-12-06,9822
2609,陽明,30,3,27,元大-土城學府,2023-12-06,9822
2303,聯電,24,1,23,元大-土城學府,2023-12-06,9822
6120,達運,25,2,23,元大-土城學府,2023-12-06,9822
3078,僑威,22,0,22,元大-土城學府,2023-12-06,9822
1605,華新,24,4,20,元大-土城學府,2023-12-06,9822
6799,來頡,20,0,20,元大-土城學府,2023-12-06,9822
2332,友訊,20,1,19,元大-土城學府,2023-12-06,9822
6274,台燿,21,2,19,元大-土城學府,2023-12-06,9822
2409,友達,18,0,18,元大-土城學府,2023-12-06,9822
2313,華通,20,3,17,元大-土城學府,2023-12-06,9822
00632R,元大台灣50反1,22,5,17,元大-土城學府,2023-12-06,9822
2412,中華電,17,2,15,元大-土城學府,2023-12-06,9822
2419,仲琦,32,17,15,元大-土城學府,2023-12-06,9822
1504,東元,41,27,14,元大-土城學府,2023-12-06,9822
2329,華泰,40,26,14,元大-土城學府,2023-12-06,9822
8071,能率網通,14,0,14,元大-土城學府,2023-12-06,9822
2472,立隆電,12,0,12,元大-土城學府,2023-12-06,9822
00637L,元大滬深300正2,11,0,11,元大-土城學府,2023-12-06,9822
00933B,國泰10Y+金融債,11,0,11,元大-土城學府,2023-12-06,9822
1514,亞力,78,68,10,元大-土城學府,2023-12-06,9822
2881,富邦金,10,0,10,元大-土城學府,2023-12-06,9822
4105,東洋,10,0,10,元大-土城學府,2023-12-06,9822
3264,欣銓,13,3,10,元大-土城學府,2023-12-06,9822
3587,閎康,10,0,10,元大-土城學府,2023-12-06,9822
4414,如興,10,0,10,元大-土城學府,2023-12-06,9822
1781,合世,10,1,9,元大-土城學府,2023-12-06,9822
3481,群創,13,5,8,元大-土城學府,2023-12-06,9822
00918,大華優利高填息30,8,0,8,元大-土城學府,2023-12-06,9822
2354,鴻準,8,0,8,元大-土城學府,2023-12-06,9822
6104,創惟,9,1,8,元大-土城學府,2023-12-06,9822
6117,迎廣,87,79,8,元大-土城學府,2023-12-06,9822
9917,中保科,7,0,7,元大-土城學府,2023-12-06,9822
1522,堤維西,11,4,7,元大-土城學府,2023-12-06,9822
2610,華航,14,7,7,元大-土城學府,2023-12-06,9822
3306,鼎天,13,6,7,元大-土城學府,2023-12-06,9822
9105,泰金寶-DR,122,0,122,元大-土城學府,2023-12-07,9822
00919,群益台灣精選高息,128,6,122,元大-土城學府,2023-12-07,9822
00937B,群益ESG投等債20,95,5,90,元大-土城學府,2023-12-07,9822
00680L,元大美債20正2,85,0,85,元大-土城學府,2023-12-07,9822
2611,志信,76,1,75,元大-土城學府,2023-12-07,9822
2303,聯電,74,5,69,元大-土城學府,2023-12-07,9822
00712,復華富時不動產,69,0,69,元大-土城學府,2023-12-07,9822
3390,旭軟,65,17,48,元大-土城學府,2023-12-07,9822
4939,亞電,37,0,37,元大-土城學府,2023-12-07,9822
2355,敬鵬,49,13,36,元大-土城學府,2023-12-07,9822
2419,仲琦,28,2,26,元大-土城學府,2023-12-07,9822
00679B,元大美債20年,47,22,25,元大-土城學府,2023-12-07,9822
3260,威剛,28,3,25,元大-土城學府,2023-12-07,9822
00720B,元大投資級公司債,25,1,24,元大-土城學府,2023-12-07,9822
2425,承啟,28,6,22,元大-土城學府,2023-12-07,9822
00929,復華台灣科技優息,22,1,21,元大-土城學府,2023-12-07,9822
2338,光罩,21,1,20,元大-土城學府,2023-12-07,9822
00933B,國泰10Y+金融債,19,0,19,元大-土城學府,2023-12-07,9822
1721,三晃,20,1,19,元大-土城學府,2023-12-07,9822
8054,安國,33,14,19,元大-土城學府,2023-12-07,9822
3045,台灣大,18,0,18,元大-土城學府,2023-12-07,9822
00715L,期街口布蘭特正2,23,5,18,元大-土城學府,2023-12-07,9822
00918,大華優利高填息30,16,0,16,元大-土城學府,2023-12-07,9822
00665L,富邦�琤肭磪囓�2,18,3,15,元大-土城學府,2023-12-07,9822
2609,陽明,14,0,14,元大-土城學府,2023-12-07,9822
2702,華園,14,0,14,元大-土城學府,2023-12-07,9822
1319,東陽,16,2,14,元大-土城學府,2023-12-07,9822
00915,凱基優選高股息30,13,0,13,元大-土城學府,2023-12-07,9822
2358,廷鑫,12,0,12,元大-土城學府,2023-12-07,9822
2363,矽統,22,10,12,元大-土城學府,2023-12-07,9822
6275,元山,12,0,12,元大-土城學府,2023-12-07,9822
00687B,國泰20年美債,13,1,12,元大-土城學府,2023-12-07,9822
6143,振曜,16,5,11,元大-土城學府,2023-12-07,9822
00882,中信中國高股息,12,1,11,元大-土城學府,2023-12-07,9822
1611,中電,18,7,11,元大-土城學府,2023-12-07,9822
2634,漢翔,12,1,11,元大-土城學府,2023-12-07,9822
3704,合勤控,13,2,11,元大-土城學府,2023-12-07,9822
1513,中興電,43,32,11,元大-土城學府,2023-12-07,9822
1605,華新,14,4,10,元大-土城學府,2023-12-07,9822
4967,十銓,10,0,10,元大-土城學府,2023-12-07,9822
00725B,國泰投資級公司債,10,0,10,元大-土城學府,2023-12-07,9822
1463,強盛新,10,0,10,元大-土城學府,2023-12-07,9822
3317,尼克森,10,0,10,元大-土城學府,2023-12-07,9822
5864,致和證,10,0,10,元大-土城學府,2023-12-07,9822
6499,益安,10,0,10,元大-土城學府,2023-12-07,9822
2892,第一金,10,0,10,元大-土城學府,2023-12-07,9822
2605,新興,19,10,9,元大-土城學府,2023-12-07,9822
2367,燿華,12,3,9,元大-土城學府,2023-12-07,9822
3265,台星科,12,3,9,元大-土城學府,2023-12-07,9822
4919,新唐,10,1,9,元大-土城學府,2023-12-07,9822
00662,富邦NASDAQ,162,0,162,元大-土城學府,2023-12-08,9822
00919,群益台灣精選高息,70,17,53,元大-土城學府,2023-12-08,9822
2641,正德,67,20,47,元大-土城學府,2023-12-08,9822
2618,長榮航,128,91,37,元大-土城學府,2023-12-08,9822
2449,京元電子,38,2,36,元大-土城學府,2023-12-08,9822
00712,復華富時不動產,41,5,36,元大-土城學府,2023-12-08,9822
2605,新興,61,30,31,元大-土城學府,2023-12-08,9822
00937B,群益ESG投等債20,38,9,29,元大-土城學府,2023-12-08,9822
8996,高力,33,6,27,元大-土城學府,2023-12-08,9822
00933B,國泰10Y+金融債,34,10,24,元大-土城學府,2023-12-08,9822
00679B,元大美債20年,26,5,21,元大-土城學府,2023-12-08,9822
8088,品安,28,7,21,元大-土城學府,2023-12-08,9822
3022,威強電,20,0,20,元大-土城學府,2023-12-08,9822
9945,潤泰新,20,0,20,元大-土城學府,2023-12-08,9822
00907,永豐優息存股,20,1,19,元大-土城學府,2023-12-08,9822
2388,威盛,26,8,18,元大-土城學府,2023-12-08,9822
5608,四維航,22,4,18,元大-土城學府,2023-12-08,9822
3231,緯創,34,17,17,元大-土城學府,2023-12-08,9822
00882,中信中國高股息,17,0,17,元大-土城學府,2023-12-08,9822
00720B,元大投資級公司債,17,1,16,元大-土城學府,2023-12-08,9822
2317,鴻海,19,3,16,元大-土城學府,2023-12-08,9822
00935,野村臺灣新科技50,16,0,16,元大-土城學府,2023-12-08,9822
2409,友達,16,1,15,元大-土城學府,2023-12-08,9822
00895,富邦未來車,18,5,13,元大-土城學府,2023-12-08,9822
00893,國泰智能電動車,12,0,12,元大-土城學府,2023-12-08,9822
00715L,期街口布蘭特正2,12,1,11,元大-土城學府,2023-12-08,9822
3324,雙鴻,11,0,11,元大-土城學府,2023-12-08,9822
8034,榮群,15,5,10,元大-土城學府,2023-12-08,9822
1217,愛之味,10,0,10,元大-土城學府,2023-12-08,9822
2316,楠梓電,14,4,10,元大-土城學府,2023-12-08,9822
2812,台中銀,10,0,10,元大-土城學府,2023-12-08,9822
3380,明泰,11,1,10,元大-土城學府,2023-12-08,9822
3545,敦泰,13,3,10,元大-土城學府,2023-12-08,9822
4161,聿新科,10,0,10,元大-土城學府,2023-12-08,9822
2376,技嘉,18,8,10,元大-土城學府,2023-12-08,9822
2329,華泰,35,26,9,元大-土城學府,2023-12-08,9822
2365,昆盈,9,0,9,元大-土城學府,2023-12-08,9822
2515,中工,10,1,9,元大-土城學府,2023-12-08,9822
00905,FT臺灣Smart,8,0,8,元大-土城學府,2023-12-08,9822
2314,台揚,8,0,8,元大-土城學府,2023-12-08,9822
2399,映泰,8,0,8,元大-土城學府,2023-12-08,9822
00934,中信成長高股息,8,0,8,元大-土城學府,2023-12-08,9822
1514,亞力,66,58,8,元大-土城學府,2023-12-08,9822
3521,鴻翊,7,0,7,元大-土城學府,2023-12-08,9822
5328,華容,7,0,7,元大-土城學府,2023-12-08,9822
00918,大華優利高填息30,6,0,6,元大-土城學府,2023-12-08,9822
1616,億泰,10,4,6,元大-土城學府,2023-12-08,9822
2359,所羅門,7,1,6,元大-土城學府,2023-12-08,9822
2367,燿華,9,3,6,元大-土城學府,2023-12-08,9822
2834,臺企銀,6,0,6,元大-土城學府,2023-12-08,9822
00919,群益台灣精選高息,71,2,69,元大-土城學府,2023-12-11,9822
00706L,期元大S＆P日圓正2,55,0,55,元大-土城學府,2023-12-11,9822
00665L,富邦�琤肭磪囓�2,52,0,52,元大-土城學府,2023-12-11,9822
6284,佳邦,51,2,49,元大-土城學府,2023-12-11,9822
00679B,元大美債20年,43,11,32,元大-土城學府,2023-12-11,9822
1210,大成,31,0,31,元大-土城學府,2023-12-11,9822
2388,威盛,60,33,27,元大-土城學府,2023-12-11,9822
00882,中信中國高股息,24,0,24,元大-土城學府,2023-12-11,9822
4906,正文,23,0,23,元大-土城學府,2023-12-11,9822
1217,愛之味,22,0,22,元大-土城學府,2023-12-11,9822
00937B,群益ESG投等債20,22,1,21,元大-土城學府,2023-12-11,9822
2472,立隆電,21,0,21,元大-土城學府,2023-12-11,9822
00688L,國泰20年美債正2,18,0,18,元大-土城學府,2023-12-11,9822
3078,僑威,22,4,18,元大-土城學府,2023-12-11,9822
8996,高力,23,7,16,元大-土城學府,2023-12-11,9822
1522,堤維西,15,1,14,元大-土城學府,2023-12-11,9822
2891,中信金,31,17,14,元大-土城學府,2023-12-11,9822
00712,復華富時不動產,15,2,13,元大-土城學府,2023-12-11,9822
2405,輔信,13,0,13,元大-土城學府,2023-12-11,9822
2317,鴻海,14,1,13,元大-土城學府,2023-12-11,9822
1524,耿鼎,38,26,12,元大-土城學府,2023-12-11,9822
1514,亞力,44,33,11,元大-土城學府,2023-12-11,9822
1591,駿吉-KY,14,3,11,元大-土城學府,2023-12-11,9822
2365,昆盈,122,111,11,元大-土城學府,2023-12-11,9822
2867,三商壽,11,0,11,元大-土城學府,2023-12-11,9822
5864,致和證,11,0,11,元大-土城學府,2023-12-11,9822
9958,世紀鋼,11,0,11,元大-土城學府,2023-12-11,9822
1471,首利,20,10,10,元大-土城學府,2023-12-11,9822
2412,中華電,10,0,10,元大-土城學府,2023-12-11,9822
2543,皇昌,12,2,10,元大-土城學府,2023-12-11,9822
2618,長榮航,17,7,10,元大-土城學府,2023-12-11,9822
3372,典範,10,0,10,元大-土城學府,2023-12-11,9822
3437,榮創,10,0,10,元大-土城學府,2023-12-11,9822
6485,點序,10,0,10,元大-土城學府,2023-12-11,9822
1513,中興電,11,2,9,元大-土城學府,2023-12-11,9822
1616,億泰,8,0,8,元大-土城學府,2023-12-11,9822
2002,中鋼,10,2,8,元大-土城學府,2023-12-11,9822
3022,威強電,8,0,8,元大-土城學府,2023-12-11,9822
4543,萬在,16,8,8,元大-土城學府,2023-12-11,9822
6547,高端疫苗,8,0,8,元大-土城學府,2023-12-11,9822
3037,欣興,20,13,7,元大-土城學府,2023-12-11,9822
9927,泰銘,7,0,7,元大-土城學府,2023-12-11,9822
00687B,國泰20年美債,7,0,7,元大-土城學府,2023-12-11,9822
1314,中石化,7,0,7,元大-土城學府,2023-12-11,9822
2360,致茂,7,0,7,元大-土城學府,2023-12-11,9822
2367,燿華,9,2,7,元大-土城學府,2023-12-11,9822
2516,新建,9,2,7,元大-土城學府,2023-12-11,9822
3264,欣銓,10,3,7,元大-土城學府,2023-12-11,9822
3450,聯鈞,18,11,7,元大-土城學府,2023-12-11,9822
00632R,元大台灣50反1,7,0,7,元大-土城學府,2023-12-11,9822
00934,中信成長高股息,476,0,476,元大-土城學府,2023-12-12,9822
00919,群益台灣精選高息,201,12,189,元大-土城學府,2023-12-12,9822
5521,工信,122,55,67,元大-土城學府,2023-12-12,9822
00935,野村臺灣新科技50,50,0,50,元大-土城學府,2023-12-12,9822
4908,前鼎,42,4,38,元大-土城學府,2023-12-12,9822
00687B,國泰20年美債,34,0,34,元大-土城學府,2023-12-12,9822
3363,上詮,32,0,32,元大-土城學府,2023-12-12,9822
8112,至上,53,24,29,元大-土城學府,2023-12-12,9822
00679B,元大美債20年,24,0,24,元大-土城學府,2023-12-12,9822
00931B,統一美債20年,23,0,23,元大-土城學府,2023-12-12,9822
5258,虹堡,22,0,22,元大-土城學府,2023-12-12,9822
6799,來頡,32,10,22,元大-土城學府,2023-12-12,9822
00929,復華台灣科技優息,43,22,21,元大-土城學府,2023-12-12,9822
1447,力鵬,23,2,21,元大-土城學府,2023-12-12,9822
2889,國票金,21,0,21,元大-土城學府,2023-12-12,9822
1210,大成,20,0,20,元大-土城學府,2023-12-12,9822
3147,大綜,22,2,20,元大-土城學府,2023-12-12,9822
8426,紅木-KY,20,0,20,元大-土城學府,2023-12-12,9822
1591,駿吉-KY,49,33,16,元大-土城學府,2023-12-12,9822
1608,華榮,34,19,15,元大-土城學府,2023-12-12,9822
3231,緯創,17,3,14,元大-土城學府,2023-12-12,9822
1618,合機,90,76,14,元大-土城學府,2023-12-12,9822
3163,波若威,15,1,14,元大-土城學府,2023-12-12,9822
00937B,群益ESG投等債20,18,5,13,元大-土城學府,2023-12-12,9822
9945,潤泰新,14,2,12,元大-土城學府,2023-12-12,9822
1217,愛之味,12,0,12,元大-土城學府,2023-12-12,9822
8096,擎亞,18,6,12,元大-土城學府,2023-12-12,9822
2002,中鋼,12,0,12,元大-土城學府,2023-12-12,9822
00712,復華富時不動產,14,2,12,元大-土城學府,2023-12-12,9822
00720B,元大投資級公司債,12,1,11,元大-土城學府,2023-12-12,9822
2399,映泰,11,0,11,元大-土城學府,2023-12-12,9822
3041,揚智,18,7,11,元大-土城學府,2023-12-12,9822
00680L,元大美債20正2,10,0,10,元大-土城學府,2023-12-12,9822
00715L,期街口布蘭特正2,10,0,10,元大-土城學府,2023-12-12,9822
1503,士電,13,3,10,元大-土城學府,2023-12-12,9822
2618,長榮航,25,15,10,元大-土城學府,2023-12-12,9822
2913,農林,10,0,10,元大-土城學府,2023-12-12,9822
3689,湧德,10,0,10,元大-土城學府,2023-12-12,9822
00918,大華優利高填息30,17,8,9,元大-土城學府,2023-12-12,9822
1524,耿鼎,18,9,9,元大-土城學府,2023-12-12,9822
4967,十銓,13,4,9,元大-土城學府,2023-12-12,9822
4968,立積,10,1,9,元大-土城學府,2023-12-12,9822
6290,良維,21,12,9,元大-土城學府,2023-12-12,9822
00922,國泰台灣領袖50,8,0,8,元大-土城學府,2023-12-12,9822
00665L,富邦�琤肭磪囓�2,20,12,8,元大-土城學府,2023-12-12,9822
1513,中興電,17,9,8,元大-土城學府,2023-12-12,9822
1514,亞力,63,55,8,元大-土城學府,2023-12-12,9822
2329,華泰,11,3,8,元大-土城學府,2023-12-12,9822
2705,六福,8,0,8,元大-土城學府,2023-12-12,9822
2911,麗嬰房,8,0,8,元大-土城學府,2023-12-12,9822
00919,群益台灣精選高息,253,19,234,元大-土城學府,2023-12-13,9822
2888,新光金,110,0,110,元大-土城學府,2023-12-13,9822
4906,正文,102,4,98,元大-土城學府,2023-12-13,9822
00669R,國泰美國道瓊反1,50,0,50,元大-土城學府,2023-12-13,9822
5701,劍湖山,50,0,50,元大-土城學府,2023-12-13,9822
00929,復華台灣科技優息,62,19,43,元大-土城學府,2023-12-13,9822
00934,中信成長高股息,42,0,42,元大-土城學府,2023-12-13,9822
6122,擎邦,43,3,40,元大-土城學府,2023-12-13,9822
2889,國票金,40,0,40,元大-土城學府,2023-12-13,9822
6754,匯僑設計,38,0,38,元大-土城學府,2023-12-13,9822
2609,陽明,35,1,34,元大-土城學府,2023-12-13,9822
00918,大華優利高填息30,35,2,33,元大-土城學府,2023-12-13,9822
6282,康舒,38,6,32,元大-土城學府,2023-12-13,9822
2365,昆盈,52,22,30,元大-土城學府,2023-12-13,9822
3022,威強電,30,0,30,元大-土城學府,2023-12-13,9822
3390,旭軟,26,0,26,元大-土城學府,2023-12-13,9822
00642U,期元大S＆P石油,25,0,25,元大-土城學府,2023-12-13,9822
6104,創惟,25,1,24,元大-土城學府,2023-12-13,9822
00687B,國泰20年美債,24,0,24,元大-土城學府,2023-12-13,9822
1615,大山,23,0,23,元大-土城學府,2023-12-13,9822
00907,永豐優息存股,22,0,22,元大-土城學府,2023-12-13,9822
00715L,期街口布蘭特正2,21,0,21,元大-土城學府,2023-12-13,9822
2610,華航,25,4,21,元大-土城學府,2023-12-13,9822
1101,台泥,25,5,20,元大-土城學府,2023-12-13,9822
2605,新興,29,10,19,元大-土城學府,2023-12-13,9822
00933B,國泰10Y+金融債,18,0,18,元大-土城學府,2023-12-13,9822
2867,三商壽,17,0,17,元大-土城學府,2023-12-13,9822
2382,廣達,23,7,16,元大-土城學府,2023-12-13,9822
1608,華榮,16,0,16,元大-土城學府,2023-12-13,9822
3587,閎康,15,0,15,元大-土城學府,2023-12-13,9822
6770,力積電,21,6,15,元大-土城學府,2023-12-13,9822
1603,華電,20,6,14,元大-土城學府,2023-12-13,9822
8069,元太,17,3,14,元大-土城學府,2023-12-13,9822
00902,中信電池及儲能,15,1,14,元大-土城學府,2023-12-13,9822
00882,中信中國高股息,12,0,12,元大-土城學府,2023-12-13,9822
00632R,元大台灣50反1,12,0,12,元大-土城學府,2023-12-13,9822
2634,漢翔,18,7,11,元大-土城學府,2023-12-13,9822
6235,華孚,14,3,11,元大-土城學府,2023-12-13,9822
2515,中工,43,32,11,元大-土城學府,2023-12-13,9822
2882,國泰金,10,0,10,元大-土城學府,2023-12-13,9822
00680L,元大美債20正2,10,0,10,元大-土城學府,2023-12-13,9822
2313,華通,28,18,10,元大-土城學府,2023-12-13,9822
2002,中鋼,10,1,9,元大-土城學府,2023-12-13,9822
00922,國泰台灣領袖50,8,0,8,元大-土城學府,2023-12-13,9822
3266,昇陽,8,0,8,元大-土城學府,2023-12-13,9822
3287,廣寰科,60,52,8,元大-土城學府,2023-12-13,9822
4976,佳凌,12,4,8,元大-土城學府,2023-12-13,9822
2374,佳能,8,0,8,元大-土城學府,2023-12-13,9822
00936,台新永續高息中小,8,1,7,元大-土城學府,2023-12-13,9822
00937B,群益ESG投等債20,7,0,7,元大-土城學府,2023-12-13,9822
3390,旭軟,263,45,218,元大-土城學府,2023-12-14,9822
00918,大華優利高填息30,91,7,84,元大-土城學府,2023-12-14,9822
00919,群益台灣精選高息,123,59,64,元大-土城學府,2023-12-14,9822
00687B,國泰20年美債,52,0,52,元大-土城學府,2023-12-14,9822
5498,凱崴,42,0,42,元大-土城學府,2023-12-14,9822
00937B,群益ESG投等債20,42,0,42,元大-土城學府,2023-12-14,9822
1609,大亞,41,1,40,元大-土城學府,2023-12-14,9822
2472,立隆電,50,10,40,元大-土城學府,2023-12-14,9822
00882,中信中國高股息,44,5,39,元大-土城學府,2023-12-14,9822
00680L,元大美債20正2,76,39,37,元大-土城學府,2023-12-14,9822
2367,燿華,74,42,32,元大-土城學府,2023-12-14,9822
1447,力鵬,30,0,30,元大-土城學府,2023-12-14,9822
00892,富邦台灣半導體,27,0,27,元大-土城學府,2023-12-14,9822
00679B,元大美債20年,43,19,24,元大-土城學府,2023-12-14,9822
00933B,國泰10Y+金融債,23,1,22,元大-土城學府,2023-12-14,9822
6799,來頡,22,0,22,元大-土城學府,2023-12-14,9822
1210,大成,20,1,19,元大-土城學府,2023-12-14,9822
00891,中信關鍵半導體,18,0,18,元大-土城學府,2023-12-14,9822
2388,威盛,22,4,18,元大-土城學府,2023-12-14,9822
00665L,富邦�琤肭磪囓�2,20,3,17,元大-土城學府,2023-12-14,9822
3013,晟銘電,17,1,16,元大-土城學府,2023-12-14,9822
00934,中信成長高股息,15,0,15,元大-土城學府,2023-12-14,9822
5880,合庫金,30,15,15,元大-土城學府,2023-12-14,9822
8201,無敵,15,0,15,元大-土城學府,2023-12-14,9822
3041,揚智,34,20,14,元大-土城學府,2023-12-14,9822
3051,力特,24,10,14,元大-土城學府,2023-12-14,9822
00929,復華台灣科技優息,77,65,12,元大-土城學府,2023-12-14,9822
3481,群創,12,0,12,元大-土城學府,2023-12-14,9822
5011,久陽,12,0,12,元大-土城學府,2023-12-14,9822
9105,泰金寶-DR,12,0,12,元大-土城學府,2023-12-14,9822
2409,友達,13,2,11,元大-土城學府,2023-12-14,9822
5388,中磊,18,7,11,元大-土城學府,2023-12-14,9822
00857B,永豐20年美公債,10,0,10,元大-土城學府,2023-12-14,9822
00931B,統一美債20年,10,0,10,元大-土城學府,2023-12-14,9822
1615,大山,10,0,10,元大-土城學府,2023-12-14,9822
1711,永光,11,1,10,元大-土城學府,2023-12-14,9822
1727,中華化,10,0,10,元大-土城學府,2023-12-14,9822
2063,世鎧,10,0,10,元大-土城學府,2023-12-14,9822
2390,云辰,10,0,10,元大-土城學府,2023-12-14,9822
3038,全台,10,0,10,元大-土城學府,2023-12-14,9822
3373,熱映,10,0,10,元大-土城學府,2023-12-14,9822
2387,精元,21,12,9,元大-土城學府,2023-12-14,9822
2610,華航,13,4,9,元大-土城學府,2023-12-14,9822
2888,新光金,12,3,9,元大-土城學府,2023-12-14,9822
3712,永崴投控,9,0,9,元大-土城學府,2023-12-14,9822
4961,天鈺,11,2,9,元大-土城學府,2023-12-14,9822
2520,冠德,11,3,8,元大-土城學府,2023-12-14,9822
2605,新興,18,10,8,元大-土城學府,2023-12-14,9822
2609,陽明,8,0,8,元大-土城學府,2023-12-14,9822
5521,工信,73,65,8,元大-土城學府,2023-12-14,9822
9105,泰金寶-DR,502,0,502,元大-土城學府,2023-12-15,9822
00680L,元大美債20正2,111,27,84,元大-土城學府,2023-12-15,9822
2377,微星,81,1,80,元大-土城學府,2023-12-15,9822
2611,志信,70,0,70,元大-土城學府,2023-12-15,9822
2356,英業達,214,145,69,元大-土城學府,2023-12-15,9822
00919,群益台灣精選高息,302,234,68,元大-土城學府,2023-12-15,9822
00712,復華富時不動產,156,90,66,元大-土城學府,2023-12-15,9822
2601,益航,62,0,62,元大-土城學府,2023-12-15,9822
2363,矽統,171,116,55,元大-土城學府,2023-12-15,9822
00687B,國泰20年美債,49,2,47,元大-土城學府,2023-12-15,9822
6509,聚和,42,4,38,元大-土城學府,2023-12-15,9822
00637L,元大滬深300正2,32,1,31,元大-土城學府,2023-12-15,9822
2301,光寶科,38,8,30,元大-土城學府,2023-12-15,9822
2884,玉山金,30,2,28,元大-土城學府,2023-12-15,9822
00933B,國泰10Y+金融債,28,0,28,元大-土城學府,2023-12-15,9822
8426,紅木-KY,29,1,28,元大-土城學府,2023-12-15,9822
00918,大華優利高填息30,50,23,27,元大-土城學府,2023-12-15,9822
4906,正文,27,0,27,元大-土城學府,2023-12-15,9822
00934,中信成長高股息,33,7,26,元大-土城學府,2023-12-15,9822
2412,中華電,24,0,24,元大-土城學府,2023-12-15,9822
3231,緯創,29,5,24,元大-土城學府,2023-12-15,9822
5011,久陽,25,1,24,元大-土城學府,2023-12-15,9822
00937B,群益ESG投等債20,30,7,23,元大-土城學府,2023-12-15,9822
00725B,國泰投資級公司債,20,0,20,元大-土城學府,2023-12-15,9822
6275,元山,20,0,20,元大-土城學府,2023-12-15,9822
2388,威盛,48,29,19,元大-土城學府,2023-12-15,9822
2374,佳能,18,0,18,元大-土城學府,2023-12-15,9822
1721,三晃,20,2,18,元大-土城學府,2023-12-15,9822
2449,京元電子,33,16,17,元大-土城學府,2023-12-15,9822
00921,兆豐龍頭等權重,17,0,17,元大-土城學府,2023-12-15,9822
2316,楠梓電,16,0,16,元大-土城學府,2023-12-15,9822
5439,高技,17,1,16,元大-土城學府,2023-12-15,9822
00751B,元大AAA至A公司債,35,20,15,元大-土城學府,2023-12-15,9822
00679B,元大美債20年,34,19,15,元大-土城學府,2023-12-15,9822
1608,華榮,15,0,15,元大-土城學府,2023-12-15,9822
5210,寶碩,15,0,15,元大-土城學府,2023-12-15,9822
3515,華擎,17,3,14,元大-土城學府,2023-12-15,9822
00669R,國泰美國道瓊反1,12,0,12,元大-土城學府,2023-12-15,9822
2605,新興,22,10,12,元大-土城學府,2023-12-15,9822
2615,萬海,13,1,12,元大-土城學府,2023-12-15,9822
8299,群聯,12,0,12,元大-土城學府,2023-12-15,9822
3715,定穎投控,29,18,11,元大-土城學府,2023-12-15,9822
2211,長榮鋼,11,0,11,元大-土城學府,2023-12-15,9822
3033,威健,11,0,11,元大-土城學府,2023-12-15,9822
3213,茂訊,14,3,11,元大-土城學府,2023-12-15,9822
3236,千如,11,0,11,元大-土城學府,2023-12-15,9822
3437,榮創,11,0,11,元大-土城學府,2023-12-15,9822
2476,鉅祥,10,0,10,元大-土城學府,2023-12-15,9822
6026,福邦證,10,0,10,元大-土城學府,2023-12-15,9822
6153,嘉聯益,11,1,10,元大-土城學府,2023-12-15,9822
9105,泰金寶-DR,398,14,384,元大-土城學府,2023-12-18,9822
00919,群益台灣精選高息,131,25,106,元大-土城學府,2023-12-18,9822
00665L,富邦�琤肭磪囓�2,100,0,100,元大-土城學府,2023-12-18,9822
00929,復華台灣科技優息,108,39,69,元大-土城學府,2023-12-18,9822
1455,集盛,65,1,64,元大-土城學府,2023-12-18,9822
3047,訊舟,60,10,50,元大-土城學府,2023-12-18,9822
2002,中鋼,50,9,41,元大-土城學府,2023-12-18,9822
2883,凱基金,48,7,41,元大-土城學府,2023-12-18,9822
2618,長榮航,87,53,34,元大-土城學府,2023-12-18,9822
2356,英業達,91,58,33,元大-土城學府,2023-12-18,9822
00931B,統一美債20年,33,4,29,元大-土城學府,2023-12-18,9822
2449,京元電子,29,2,27,元大-土城學府,2023-12-18,9822
2615,萬海,59,34,25,元大-土城學府,2023-12-18,9822
2641,正德,27,4,23,元大-土城學府,2023-12-18,9822
6284,佳邦,22,1,21,元大-土城學府,2023-12-18,9822
00753L,中信中國50正2,20,0,20,元大-土城學府,2023-12-18,9822
3276,宇環,20,0,20,元大-土城學府,2023-12-18,9822
2610,華航,22,3,19,元大-土城學府,2023-12-18,9822
00712,復華富時不動產,36,18,18,元大-土城學府,2023-12-18,9822
00918,大華優利高填息30,17,0,17,元大-土城學府,2023-12-18,9822
2023,燁輝,33,17,16,元大-土城學府,2023-12-18,9822
3704,合勤控,31,15,16,元大-土城學府,2023-12-18,9822
4906,正文,18,2,16,元大-土城學府,2023-12-18,9822
6139,亞翔,25,9,16,元大-土城學府,2023-12-18,9822
2887,台新金,15,0,15,元大-土城學府,2023-12-18,9822
00921,兆豐龍頭等權重,15,0,15,元大-土城學府,2023-12-18,9822
2605,新興,28,13,15,元大-土城學府,2023-12-18,9822
1326,台化,14,0,14,元大-土城學府,2023-12-18,9822
2014,中鴻,48,34,14,元大-土城學府,2023-12-18,9822
6191,精成科,13,0,13,元大-土城學府,2023-12-18,9822
2009,第一銅,13,1,12,元大-土城學府,2023-12-18,9822
2030,彰源,29,17,12,元大-土城學府,2023-12-18,9822
2033,佳大,12,0,12,元大-土城學府,2023-12-18,9822
6179,亞通,12,0,12,元大-土城學府,2023-12-18,9822
6754,匯僑設計,12,0,12,元大-土城學府,2023-12-18,9822
1319,東陽,31,19,12,元大-土城學府,2023-12-18,9822
3264,欣銓,16,4,12,元大-土城學府,2023-12-18,9822
00687B,國泰20年美債,11,0,11,元大-土城學府,2023-12-18,9822
5425,台半,12,1,11,元大-土城學府,2023-12-18,9822
8442,威宏-KY,16,5,11,元大-土城學府,2023-12-18,9822
9919,康那香,11,0,11,元大-土城學府,2023-12-18,9822
9933,中鼎,11,0,11,元大-土城學府,2023-12-18,9822
2303,聯電,31,20,11,元大-土城學府,2023-12-18,9822
00637L,元大滬深300正2,20,10,10,元大-土城學府,2023-12-18,9822
00936,台新永續高息中小,10,0,10,元大-土城學府,2023-12-18,9822
1217,愛之味,10,0,10,元大-土城學府,2023-12-18,9822
2241,艾姆勒,10,0,10,元大-土城學府,2023-12-18,9822
6005,群益證,10,0,10,元大-土城學府,2023-12-18,9822
6670,復盛應用,10,0,10,元大-土城學府,2023-12-18,9822
9950,萬國通,10,0,10,元大-土城學府,2023-12-18,9822
2611,志信,140,0,140,元大-土城學府,2023-12-19,9822
2609,陽明,350,234,116,元大-土城學府,2023-12-19,9822
4906,正文,110,1,109,元大-土城學府,2023-12-19,9822
00937B,群益ESG投等債20,76,3,73,元大-土城學府,2023-12-19,9822
00929,復華台灣科技優息,111,44,67,元大-土城學府,2023-12-19,9822
2887,台新金,47,0,47,元大-土城學府,2023-12-19,9822
9904,寶成,41,2,39,元大-土城學府,2023-12-19,9822
2356,英業達,62,30,32,元大-土城學府,2023-12-19,9822
1210,大成,32,0,32,元大-土城學府,2023-12-19,9822
00919,群益台灣精選高息,78,47,31,元大-土城學府,2023-12-19,9822
1312,國喬,30,0,30,元大-土城學府,2023-12-19,9822
1514,亞力,31,6,25,元大-土城學府,2023-12-19,9822
2449,京元電子,27,5,22,元大-土城學府,2023-12-19,9822
1609,大亞,21,0,21,元大-土城學府,2023-12-19,9822
8112,至上,29,10,19,元大-土城學府,2023-12-19,9822
00918,大華優利高填息30,19,0,19,元大-土城學府,2023-12-19,9822
00712,復華富時不動產,56,38,18,元大-土城學府,2023-12-19,9822
6129,普誠,18,0,18,元大-土城學府,2023-12-19,9822
9945,潤泰新,18,0,18,元大-土城學府,2023-12-19,9822
2002,中鋼,17,0,17,元大-土城學府,2023-12-19,9822
00933B,國泰10Y+金融債,17,0,17,元大-土城學府,2023-12-19,9822
2344,華邦電,20,3,17,元大-土城學府,2023-12-19,9822
6284,佳邦,18,1,17,元大-土城學府,2023-12-19,9822
00878,國泰永續高股息,23,7,16,元大-土城學府,2023-12-19,9822
2812,台中銀,22,6,16,元大-土城學府,2023-12-19,9822
6139,亞翔,20,6,14,元大-土城學府,2023-12-19,9822
6179,亞通,14,0,14,元大-土城學府,2023-12-19,9822
2884,玉山金,20,7,13,元大-土城學府,2023-12-19,9822
00665L,富邦�琤肭磪囓�2,13,0,13,元大-土城學府,2023-12-19,9822
2498,宏達電,13,1,12,元大-土城學府,2023-12-19,9822
3504,揚明光,12,0,12,元大-土城學府,2023-12-19,9822
8011,台通,43,31,12,元大-土城學府,2023-12-19,9822
2352,佳世達,11,0,11,元大-土城學府,2023-12-19,9822
3324,雙鴻,16,5,11,元大-土城學府,2023-12-19,9822
5351,鈺創,11,0,11,元大-土城學府,2023-12-19,9822
6278,台表科,11,0,11,元大-土城學府,2023-12-19,9822
6456,GIS-KY,10,0,10,元大-土城學府,2023-12-19,9822
6770,力積電,10,0,10,元大-土城學府,2023-12-19,9822
6806,森崴能源,10,0,10,元大-土城學府,2023-12-19,9822
00637L,元大滬深300正2,12,3,9,元大-土城學府,2023-12-19,9822
3325,旭品,10,1,9,元大-土城學府,2023-12-19,9822
6668,中揚光,8,0,8,元大-土城學府,2023-12-19,9822
2615,萬海,53,45,8,元大-土城學府,2023-12-19,9822
1326,台化,8,0,8,元大-土城學府,2023-12-19,9822
1815,富喬,8,0,8,元大-土城學府,2023-12-19,9822
3704,合勤控,21,13,8,元大-土城學府,2023-12-19,9822
5258,虹堡,11,3,8,元大-土城學府,2023-12-19,9822
3264,欣銓,10,3,7,元大-土城學府,2023-12-19,9822
4714,永捷,8,1,7,元大-土城學府,2023-12-19,9822
6799,來頡,7,0,7,元大-土城學府,2023-12-19,9822
00632R,元大台灣50反1,663,0,663,元大-土城學府,2023-12-20,9822
00919,群益台灣精選高息,71,21,50,元大-土城學府,2023-12-20,9822
00934,中信成長高股息,32,0,32,元大-土城學府,2023-12-20,9822
2388,威盛,36,4,32,元大-土城學府,2023-12-20,9822
00688L,國泰20年美債正2,25,0,25,元大-土城學府,2023-12-20,9822
00929,復華台灣科技優息,27,3,24,元大-土城學府,2023-12-20,9822
6770,力積電,23,0,23,元大-土城學府,2023-12-20,9822
2303,聯電,35,13,22,元大-土城學府,2023-12-20,9822
1210,大成,18,0,18,元大-土城學府,2023-12-20,9822
9904,寶成,31,13,18,元大-土城學府,2023-12-20,9822
2882,國泰金,17,0,17,元大-土城學府,2023-12-20,9822
2891,中信金,15,0,15,元大-土城學府,2023-12-20,9822
2353,宏��,87,74,13,元大-土城學府,2023-12-20,9822
2485,兆赫,13,0,13,元大-土城學府,2023-12-20,9822
1618,合機,12,0,12,元大-土城學府,2023-12-20,9822
3041,揚智,12,0,12,元大-土城學府,2023-12-20,9822
6658,聯策,12,0,12,元大-土城學府,2023-12-20,9822
00680L,元大美債20正2,69,58,11,元大-土城學府,2023-12-20,9822
2887,台新金,11,0,11,元大-土城學府,2023-12-20,9822
4133,亞諾法,11,0,11,元大-土城學府,2023-12-20,9822
2419,仲琦,16,6,10,元大-土城學府,2023-12-20,9822
6191,精成科,10,0,10,元大-土城學府,2023-12-20,9822
8076,伍豐,10,0,10,元大-土城學府,2023-12-20,9822
9945,潤泰新,9,0,9,元大-土城學府,2023-12-20,9822
1524,耿鼎,13,4,9,元大-土城學府,2023-12-20,9822
1781,合世,10,1,9,元大-土城學府,2023-12-20,9822
1905,華紙,11,2,9,元大-土城學府,2023-12-20,9822
00646,元大S＆P500,8,0,8,元大-土城學府,2023-12-20,9822
6235,華孚,8,0,8,元大-土城學府,2023-12-20,9822
2014,中鴻,29,22,7,元大-土城學府,2023-12-20,9822
2812,台中銀,7,0,7,元大-土城學府,2023-12-20,9822
2913,農林,12,5,7,元大-土城學府,2023-12-20,9822
6284,佳邦,15,8,7,元大-土城學府,2023-12-20,9822
3706,神達,21,14,7,元大-土城學府,2023-12-20,9822
1471,首利,6,0,6,元大-土城學府,2023-12-20,9822
1907,永豐餘,8,2,6,元大-土城學府,2023-12-20,9822
2601,益航,6,0,6,元大-土城學府,2023-12-20,9822
8046,南電,6,0,6,元大-土城學府,2023-12-20,9822
2603,長榮,18,12,6,元大-土城學府,2023-12-20,9822
3532,台勝科,8,3,5,元大-土城學府,2023-12-20,9822
00923,群益台ESG低碳50,5,0,5,元大-土城學府,2023-12-20,9822
00885,富邦越南,5,0,5,元大-土城學府,2023-12-20,9822
020040,元大上櫃ESG龍頭N,5,0,5,元大-土城學府,2023-12-20,9822
1612,宏泰,5,0,5,元大-土城學府,2023-12-20,9822
2365,昆盈,9,4,5,元大-土城學府,2023-12-20,9822
3264,欣銓,7,2,5,元大-土城學府,2023-12-20,9822
3545,敦泰,6,1,5,元大-土城學府,2023-12-20,9822
3701,大眾控,5,0,5,元大-土城學府,2023-12-20,9822
4714,永捷,5,0,5,元大-土城學府,2023-12-20,9822
6276,安鈦克,5,0,5,元大-土城學府,2023-12-20,9822
2611,志信,141,1,140,元大-土城學府,2023-12-21,9822
00919,群益台灣精選高息,111,18,93,元大-土城學府,2023-12-21,9822
00720B,元大投資級公司債,88,0,88,元大-土城學府,2023-12-21,9822
4968,立積,41,5,36,元大-土城學府,2023-12-21,9822
00937B,群益ESG投等債20,36,2,34,元大-土城學府,2023-12-21,9822
2312,金寶,32,0,32,元大-土城學府,2023-12-21,9822
6443,元晶,32,0,32,元大-土城學府,2023-12-21,9822
2888,新光金,30,0,30,元大-土城學府,2023-12-21,9822
2324,仁寶,60,34,26,元大-土城學府,2023-12-21,9822
00679B,元大美債20年,25,0,25,元大-土城學府,2023-12-21,9822
2356,英業達,202,182,20,元大-土城學府,2023-12-21,9822
2399,映泰,18,1,17,元大-土城學府,2023-12-21,9822
3704,合勤控,17,0,17,元大-土城學府,2023-12-21,9822
2485,兆赫,16,0,16,元大-土城學府,2023-12-21,9822
1504,東元,20,5,15,元大-土城學府,2023-12-21,9822
2527,宏璟,28,13,15,元大-土城學府,2023-12-21,9822
00933B,國泰10Y+金融債,14,0,14,元大-土城學府,2023-12-21,9822
2303,聯電,54,40,14,元大-土城學府,2023-12-21,9822
2887,台新金,15,1,14,元大-土城學府,2023-12-21,9822
2363,矽統,19,7,12,元大-土城學府,2023-12-21,9822
2007,燁興,11,0,11,元大-土城學府,2023-12-21,9822
2885,元大金,13,2,11,元大-土城學府,2023-12-21,9822
9958,世紀鋼,12,1,11,元大-土城學府,2023-12-21,9822
00671R,富邦NASDAQ反1,10,0,10,元大-土城學府,2023-12-21,9822
2516,新建,10,0,10,元大-土城學府,2023-12-21,9822
2882,國泰金,10,0,10,元大-土城學府,2023-12-21,9822
4123,晟德,11,1,10,元大-土城學府,2023-12-21,9822
6117,迎廣,10,0,10,元大-土城學府,2023-12-21,9822
8426,紅木-KY,12,2,10,元大-土城學府,2023-12-21,9822
00712,復華富時不動產,19,10,9,元大-土城學府,2023-12-21,9822
2301,光寶科,30,21,9,元大-土城學府,2023-12-21,9822
00688L,國泰20年美債正2,9,0,9,元大-土城學府,2023-12-21,9822
00882,中信中國高股息,9,0,9,元大-土城學府,2023-12-21,9822
2331,精英,36,27,9,元大-土城學府,2023-12-21,9822
2801,彰銀,11,2,9,元大-土城學府,2023-12-21,9822
9919,康那香,30,21,9,元大-土城學府,2023-12-21,9822
3041,揚智,8,0,8,元大-土城學府,2023-12-21,9822
6754,匯僑設計,8,0,8,元大-土城學府,2023-12-21,9822
2886,兆豐金,7,0,7,元大-土城學府,2023-12-21,9822
1905,華紙,11,4,7,元大-土城學府,2023-12-21,9822
3264,欣銓,7,0,7,元大-土城學府,2023-12-21,9822
2201,裕隆,8,1,7,元大-土城學府,2023-12-21,9822
00878,國泰永續高股息,44,38,6,元大-土城學府,2023-12-21,9822
3035,智原,11,5,6,元大-土城學府,2023-12-21,9822
2382,廣達,33,26,7,元大-土城學府,2023-12-21,9822
1524,耿鼎,13,7,6,元大-土城學府,2023-12-21,9822
1781,合世,6,0,6,元大-土城學府,2023-12-21,9822
1815,富喬,10,4,6,元大-土城學府,2023-12-21,9822
2323,中環,32,26,6,元大-土城學府,2023-12-21,9822
2344,華邦電,18,12,6,元大-土城學府,2023-12-21,9822
00632R,元大台灣50反1,512,0,512,元大-土城學府,2023-12-22,9822
1210,大成,85,0,85,元大-土城學府,2023-12-22,9822
9105,泰金寶-DR,79,14,65,元大-土城學府,2023-12-22,9822
00679B,元大美債20年,62,4,58,元大-土城學府,2023-12-22,9822
3483,力致,56,2,54,元大-土城學府,2023-12-22,9822
2356,英業達,122,72,50,元大-土城學府,2023-12-22,9822
1455,集盛,50,0,50,元大-土城學府,2023-12-22,9822
2881,富邦金,50,0,50,元大-土城學府,2023-12-22,9822
00929,復華台灣科技優息,62,18,44,元大-土城學府,2023-12-22,9822
6122,擎邦,32,0,32,元大-土城學府,2023-12-22,9822
00720B,元大投資級公司債,62,35,27,元大-土城學府,2023-12-22,9822
00919,群益台灣精選高息,34,10,24,元大-土城學府,2023-12-22,9822
2449,京元電子,23,0,23,元大-土城學府,2023-12-22,9822
2388,威盛,34,13,21,元大-土城學府,2023-12-22,9822
6284,佳邦,21,0,21,元大-土城學府,2023-12-22,9822
00665L,富邦�琤肭磪囓�2,57,37,20,元大-土城學府,2023-12-22,9822
2443,昶虹,20,0,20,元大-土城學府,2023-12-22,9822
3013,晟銘電,30,12,18,元大-土城學府,2023-12-22,9822
5009,榮剛,27,11,16,元大-土城學府,2023-12-22,9822
1313,聯成,16,0,16,元大-土城學府,2023-12-22,9822
1319,東陽,17,1,16,元大-土城學府,2023-12-22,9822
00931B,統一美債20年,15,0,15,元大-土城學府,2023-12-22,9822
2303,聯電,16,2,14,元大-土城學府,2023-12-22,9822
2883,凱基金,14,0,14,元大-土城學府,2023-12-22,9822
3576,聯合再生,14,0,14,元大-土城學府,2023-12-22,9822
00680L,元大美債20正2,13,0,13,元大-土城學府,2023-12-22,9822
2913,農林,14,1,13,元大-土城學府,2023-12-22,9822
6126,信音,13,0,13,元大-土城學府,2023-12-22,9822
6282,康舒,13,1,12,元大-土城學府,2023-12-22,9822
6754,匯僑設計,11,0,11,元大-土城學府,2023-12-22,9822
1522,堤維西,10,0,10,元大-土城學府,2023-12-22,9822
3290,東浦,10,0,10,元大-土城學府,2023-12-22,9822
3607,谷崧,10,1,9,元大-土城學府,2023-12-22,9822
3706,神達,13,4,9,元大-土城學府,2023-12-22,9822
3231,緯創,9,1,8,元大-土城學府,2023-12-22,9822
2201,裕隆,8,0,8,元大-土城學府,2023-12-22,9822
2312,金寶,9,1,8,元大-土城學府,2023-12-22,9822
2387,精元,8,0,8,元大-土城學府,2023-12-22,9822
5608,四維航,8,0,8,元大-土城學府,2023-12-22,9822
8426,紅木-KY,8,0,8,元大-土城學府,2023-12-22,9822
8069,元太,20,12,8,元大-土城學府,2023-12-22,9822
1101,台泥,7,0,7,元大-土城學府,2023-12-22,9822
3071,協禧,8,1,7,元大-土城學府,2023-12-22,9822
00933B,國泰10Y+金融債,6,0,6,元大-土城學府,2023-12-22,9822
00751B,元大AAA至A公司債,6,0,6,元大-土城學府,2023-12-22,9822
1514,亞力,10,4,6,元大-土城學府,2023-12-22,9822
2014,中鴻,9,3,6,元大-土城學府,2023-12-22,9822
2605,新興,8,2,6,元大-土城學府,2023-12-22,9822
3346,麗清,24,18,6,元大-土城學府,2023-12-22,9822
6443,元晶,9,3,6,元大-土城學府,2023-12-22,9822
9105,泰金寶-DR,216,0,216,元大-土城學府,2023-12-25,9822
4906,正文,108,0,108,元大-土城學府,2023-12-25,9822
00680L,元大美債20正2,110,10,100,元大-土城學府,2023-12-25,9822
00919,群益台灣精選高息,100,19,81,元大-土城學府,2023-12-25,9822
2609,陽明,244,170,74,元大-土城學府,2023-12-25,9822
1455,集盛,50,0,50,元大-土城學府,2023-12-25,9822
2615,萬海,71,22,49,元大-土城學府,2023-12-25,9822
2344,華邦電,40,3,37,元大-土城學府,2023-12-25,9822
2358,廷鑫,33,0,33,元大-土城學府,2023-12-25,9822
2515,中工,28,1,27,元大-土城學府,2023-12-25,9822
2421,建準,22,1,21,元大-土城學府,2023-12-25,9822
6152,百一,18,0,18,元大-土城學府,2023-12-25,9822
00937B,群益ESG投等債20,24,7,17,元大-土城學府,2023-12-25,9822
00929,復華台灣科技優息,25,9,16,元大-土城學府,2023-12-25,9822
2888,新光金,17,1,16,元大-土城學府,2023-12-25,9822
00772B,中信高評級公司債,15,0,15,元大-土城學府,2023-12-25,9822
2369,菱生,16,2,14,元大-土城學府,2023-12-25,9822
00687B,國泰20年美債,15,2,13,元大-土城學府,2023-12-25,9822
4533,協易機,13,0,13,元大-土城學府,2023-12-25,9822
2618,長榮航,27,14,13,元大-土城學府,2023-12-25,9822
1514,亞力,19,7,12,元大-土城學府,2023-12-25,9822
2405,輔信,16,4,12,元大-土城學府,2023-12-25,9822
2331,精英,14,3,11,元大-土城學府,2023-12-25,9822
3041,揚智,12,1,11,元大-土城學府,2023-12-25,9822
5351,鈺創,11,0,11,元大-土城學府,2023-12-25,9822
00688L,國泰20年美債正2,10,0,10,元大-土城學府,2023-12-25,9822
2516,新建,11,1,10,元大-土城學府,2023-12-25,9822
6288,聯嘉,10,0,10,元大-土城學府,2023-12-25,9822
00933B,國泰10Y+金融債,19,10,9,元大-土城學府,2023-12-25,9822
2812,台中銀,9,0,9,元大-土城學府,2023-12-25,9822
1102,亞泥,8,0,8,元大-土城學府,2023-12-25,9822
2605,新興,33,25,8,元大-土城學府,2023-12-25,9822
3047,訊舟,8,0,8,元大-土城學府,2023-12-25,9822
3051,力特,13,5,8,元大-土城學府,2023-12-25,9822
6139,亞翔,29,21,8,元大-土城學府,2023-12-25,9822
2316,楠梓電,15,8,7,元大-土城學府,2023-12-25,9822
2355,敬鵬,7,0,7,元大-土城學府,2023-12-25,9822
6117,迎廣,43,36,7,元大-土城學府,2023-12-25,9822
6125,廣運,7,0,7,元大-土城學府,2023-12-25,9822
00712,復華富時不動產,6,0,6,元大-土城學府,2023-12-25,9822
3006,晶豪科,8,2,6,元大-土城學府,2023-12-25,9822
00885,富邦越南,6,0,6,元大-土城學府,2023-12-25,9822
2387,精元,6,0,6,元大-土城學府,2023-12-25,9822
2610,華航,82,76,6,元大-土城學府,2023-12-25,9822
2636,台驊控股,8,2,6,元大-土城學府,2023-12-25,9822
3483,力致,6,0,6,元大-土城學府,2023-12-25,9822
8050,廣積,6,0,6,元大-土城學府,2023-12-25,9822
8085,福華,6,0,6,元大-土城學府,2023-12-25,9822
4979,華星光,5,0,5,元大-土城學府,2023-12-25,9822
00706L,期元大S＆P日圓正2,5,0,5,元大-土城學府,2023-12-25,9822
9105,泰金寶-DR,109,0,109,元大-土城學府,2023-12-26,9822
00669R,國泰美國道瓊反1,100,10,90,元大-土城學府,2023-12-26,9822
2369,菱生,51,13,38,元大-土城學府,2023-12-26,9822
2610,華航,43,7,36,元大-土城學府,2023-12-26,9822
3481,群創,117,84,33,元大-土城學府,2023-12-26,9822
6116,彩晶,30,0,30,元大-土城學府,2023-12-26,9822
00937B,群益ESG投等債20,27,0,27,元大-土城學府,2023-12-26,9822
8096,擎亞,37,16,21,元大-土城學府,2023-12-26,9822
2206,三陽工業,20,0,20,元大-土城學府,2023-12-26,9822
2515,中工,20,0,20,元大-土城學府,2023-12-26,9822
00919,群益台灣精選高息,16,2,14,元大-土城學府,2023-12-26,9822
00632R,元大台灣50反1,23,10,13,元大-土城學府,2023-12-26,9822
5701,劍湖山,13,0,13,元大-土城學府,2023-12-26,9822
1326,台化,16,3,13,元大-土城學府,2023-12-26,9822
00929,復華台灣科技優息,17,5,12,元大-土城學府,2023-12-26,9822
2382,廣達,13,1,12,元大-土城學府,2023-12-26,9822
1504,東元,15,3,12,元大-土城學府,2023-12-26,9822
4979,華星光,12,0,12,元大-土城學府,2023-12-26,9822
2009,第一銅,11,0,11,元大-土城學府,2023-12-26,9822
2618,長榮航,22,12,10,元大-土城學府,2023-12-26,9822
00675L,富邦臺灣加權正2,10,0,10,元大-土城學府,2023-12-26,9822
2605,新興,10,0,10,元大-土城學府,2023-12-26,9822
2636,台驊控股,10,0,10,元大-土城學府,2023-12-26,9822
4939,亞電,12,2,10,元大-土城學府,2023-12-26,9822
6139,亞翔,11,1,10,元大-土城學府,2023-12-26,9822
3231,緯創,14,5,9,元大-土城學府,2023-12-26,9822
2882,國泰金,8,0,8,元大-土城學府,2023-12-26,9822
2065,世豐,7,0,7,元大-土城學府,2023-12-26,9822
1410,南染,7,0,7,元大-土城學府,2023-12-26,9822
2402,毅嘉,17,10,7,元大-土城學府,2023-12-26,9822
2498,宏達電,10,3,7,元大-土城學府,2023-12-26,9822
2204,中華,6,0,6,元大-土城學府,2023-12-26,9822
3540,曜越,6,0,6,元大-土城學府,2023-12-26,9822
3376,新日興,11,5,6,元大-土城學府,2023-12-26,9822
2324,仁寶,69,63,6,元大-土城學府,2023-12-26,9822
00646,元大S＆P500,5,0,5,元大-土城學府,2023-12-26,9822
2365,昆盈,6,1,5,元大-土城學府,2023-12-26,9822
3645,達邁,6,1,5,元大-土城學府,2023-12-26,9822
5425,台半,5,0,5,元大-土城學府,2023-12-26,9822
6233,旺玖,9,4,5,元大-土城學府,2023-12-26,9822
6271,同欣電,10,5,5,元大-土城學府,2023-12-26,9822
8050,廣積,5,0,5,元大-土城學府,2023-12-26,9822
2371,大同,6,2,4,元大-土城學府,2023-12-26,9822
2014,中鴻,4,0,4,元大-土城學府,2023-12-26,9822
2352,佳世達,7,3,4,元大-土城學府,2023-12-26,9822
3078,僑威,5,1,4,元大-土城學府,2023-12-26,9822
3479,安勤,5,1,4,元大-土城學府,2023-12-26,9822
6462,神盾,4,0,4,元大-土城學府,2023-12-26,9822
8421,旭源,4,0,4,元大-土城學府,2023-12-26,9822
00720B,元大投資級公司債,4,0,4,元大-土城學府,2023-12-26,9822
00934,中信成長高股息,458,28,430,元大-土城學府,2023-12-27,9822
2353,宏��,126,59,67,元大-土城學府,2023-12-27,9822
00937B,群益ESG投等債20,77,15,62,元大-土城學府,2023-12-27,9822
2890,永豐金,51,2,49,元大-土城學府,2023-12-27,9822
2889,國票金,46,2,44,元大-土城學府,2023-12-27,9822
2324,仁寶,111,71,40,元大-土城學府,2023-12-27,9822
4712,福格創新,33,0,33,元大-土城學府,2023-12-27,9822
9945,潤泰新,31,0,31,元大-土城學府,2023-12-27,9822
2010,春源,103,73,30,元大-土城學府,2023-12-27,9822
00679B,元大美債20年,28,0,28,元大-土城學府,2023-12-27,9822
3437,榮創,26,0,26,元大-土城學府,2023-12-27,9822
3481,群創,89,67,22,元大-土城學府,2023-12-27,9822
2618,長榮航,38,17,21,元大-土城學府,2023-12-27,9822
3231,緯創,36,16,20,元大-土城學府,2023-12-27,9822
6129,普誠,31,12,19,元大-土城學府,2023-12-27,9822
2610,華航,20,3,17,元大-土城學府,2023-12-27,9822
00882,中信中國高股息,16,0,16,元大-土城學府,2023-12-27,9822
3443,創意,16,0,16,元大-土城學府,2023-12-27,9822
2007,燁興,15,0,15,元大-土城學府,2023-12-27,9822
3056,富華新,15,0,15,元大-土城學府,2023-12-27,9822
6284,佳邦,15,0,15,元大-土城學府,2023-12-27,9822
00919,群益台灣精選高息,27,12,15,元大-土城學府,2023-12-27,9822
00646,元大S＆P500,14,0,14,元大-土城學府,2023-12-27,9822
00892,富邦台灣半導體,13,0,13,元大-土城學府,2023-12-27,9822
6282,康舒,16,4,12,元大-土城學府,2023-12-27,9822
6164,華興,11,0,11,元大-土城學府,2023-12-27,9822
6179,亞通,11,0,11,元大-土城學府,2023-12-27,9822
2362,藍天,11,1,10,元大-土城學府,2023-12-27,9822
5272,笙科,11,1,10,元大-土城學府,2023-12-27,9822
6133,金橋,10,0,10,元大-土城學府,2023-12-27,9822
6756,威鋒電子,10,0,10,元大-土城學府,2023-12-27,9822
1605,華新,17,7,10,元大-土城學府,2023-12-27,9822
2605,新興,11,2,9,元大-土城學府,2023-12-27,9822
8936,國統,8,0,8,元大-土城學府,2023-12-27,9822
2455,全新,8,0,8,元大-土城學府,2023-12-27,9822
3587,閎康,8,0,8,元大-土城學府,2023-12-27,9822
4908,前鼎,8,0,8,元大-土城學府,2023-12-27,9822
6672,騰輝電子-KY,8,0,8,元大-土城學府,2023-12-27,9822
00905,FT臺灣Smart,7,0,7,元大-土城學府,2023-12-27,9822
2002,中鋼,8,1,7,元大-土城學府,2023-12-27,9822
2101,南港,7,0,7,元大-土城學府,2023-12-27,9822
8039,台虹,8,1,7,元大-土城學府,2023-12-27,9822
2337,旺宏,13,6,7,元大-土城學府,2023-12-27,9822
2392,正崴,11,5,6,元大-土城學府,2023-12-27,9822
2542,興富發,6,0,6,元大-土城學府,2023-12-27,9822
2331,精英,6,0,6,元大-土城學府,2023-12-27,9822
5302,太欣,6,0,6,元大-土城學府,2023-12-27,9822
2317,鴻海,7,2,5,元大-土城學府,2023-12-27,9822
00687B,國泰20年美債,5,0,5,元大-土城學府,2023-12-27,9822
2462,良得電,5,0,5,元大-土城學府,2023-12-27,9822
00919,群益台灣精選高息,97,6,91,元大-土城學府,2023-12-28,9822
2609,陽明,87,7,80,元大-土城學府,2023-12-28,9822
2303,聯電,89,32,57,元大-土城學府,2023-12-28,9822
1455,集盛,60,10,50,元大-土城學府,2023-12-28,9822
00937B,群益ESG投等債20,49,2,47,元大-土城學府,2023-12-28,9822
00891,中信關鍵半導體,41,0,41,元大-土城學府,2023-12-28,9822
6164,華興,34,0,34,元大-土城學府,2023-12-28,9822
2421,建準,33,3,30,元大-土城學府,2023-12-28,9822
3024,憶聲,35,11,24,元大-土城學府,2023-12-28,9822
3231,緯創,47,24,23,元大-土城學府,2023-12-28,9822
2472,立隆電,20,0,20,元大-土城學府,2023-12-28,9822
1514,亞力,119,100,19,元大-土城學府,2023-12-28,9822
00882,中信中國高股息,20,1,19,元大-土城學府,2023-12-28,9822
2603,長榮,21,3,18,元大-土城學府,2023-12-28,9822
2324,仁寶,47,29,18,元大-土城學府,2023-12-28,9822
00934,中信成長高股息,18,0,18,元大-土城學府,2023-12-28,9822
2606,裕民,20,2,18,元大-土城學府,2023-12-28,9822
2363,矽統,20,3,17,元大-土城學府,2023-12-28,9822
00646,元大S＆P500,17,0,17,元大-土城學府,2023-12-28,9822
3035,智原,18,1,17,元大-土城學府,2023-12-28,9822
4906,正文,18,2,16,元大-土城學府,2023-12-28,9822
00892,富邦台灣半導體,15,0,15,元大-土城學府,2023-12-28,9822
2313,華通,15,1,14,元大-土城學府,2023-12-28,9822
2356,英業達,137,123,14,元大-土城學府,2023-12-28,9822
6266,泰詠,15,3,12,元大-土城學府,2023-12-28,9822
2314,台揚,11,0,11,元大-土城學府,2023-12-28,9822
1608,華榮,10,0,10,元大-土城學府,2023-12-28,9822
6538,倉和,10,0,10,元大-土城學府,2023-12-28,9822
2882,國泰金,12,2,10,元大-土城學府,2023-12-28,9822
2374,佳能,9,0,9,元大-土城學府,2023-12-28,9822
2365,昆盈,22,13,9,元大-土城學府,2023-12-28,9822
3587,閎康,8,0,8,元大-土城學府,2023-12-28,9822
5355,佳總,12,5,7,元大-土城學府,2023-12-28,9822
00918,大華優利高填息30,7,0,7,元大-土城學府,2023-12-28,9822
3481,群創,16,9,7,元大-土城學府,2023-12-28,9822
6203,海韻電,10,3,7,元大-土城學府,2023-12-28,9822
00900,富邦特選高股息30,7,0,7,元大-土城學府,2023-12-28,9822
0056,元大高股息,9,3,6,元大-土城學府,2023-12-28,9822
3380,明泰,9,3,6,元大-土城學府,2023-12-28,9822
3518,柏騰,6,0,6,元大-土城學府,2023-12-28,9822
3545,敦泰,13,7,6,元大-土城學府,2023-12-28,9822
4908,前鼎,6,0,6,元大-土城學府,2023-12-28,9822
2317,鴻海,7,1,6,元大-土城學府,2023-12-28,9822
6456,GIS-KY,8,2,6,元大-土城學府,2023-12-28,9822
8069,元太,6,1,5,元大-土城學府,2023-12-28,9822
2542,興富發,5,0,5,元大-土城學府,2023-12-28,9822
00936,台新永續高息中小,5,0,5,元大-土城學府,2023-12-28,9822
00895,富邦未來車,5,0,5,元大-土城學府,2023-12-28,9822
1760,寶齡富錦,5,0,5,元大-土城學府,2023-12-28,9822
2408,南亞科,6,1,5,元大-土城學府,2023-12-28,9822
00937B,群益ESG投等債20,94,20,74,元大-土城學府,2023-12-29,9822
00929,復華台灣科技優息,66,7,59,元大-土城學府,2023-12-29,9822
2331,精英,54,8,46,元大-土城學府,2023-12-29,9822
1514,亞力,68,33,35,元大-土城學府,2023-12-29,9822
2323,中環,32,0,32,元大-土城學府,2023-12-29,9822
1616,億泰,31,0,31,元大-土城學府,2023-12-29,9822
6538,倉和,23,0,23,元大-土城學府,2023-12-29,9822
2344,華邦電,71,50,21,元大-土城學府,2023-12-29,9822
00919,群益台灣精選高息,29,10,19,元大-土城學府,2023-12-29,9822
0050,元大台灣50,19,1,18,元大-土城學府,2023-12-29,9822
00719B,元大美債1-3,18,0,18,元大-土城學府,2023-12-29,9822
2515,中工,47,30,17,元大-土城學府,2023-12-29,9822
3006,晶豪科,26,10,16,元大-土城學府,2023-12-29,9822
6117,迎廣,21,7,14,元大-土城學府,2023-12-29,9822
1605,華新,13,0,13,元大-土城學府,2023-12-29,9822
2337,旺宏,17,5,12,元大-土城學府,2023-12-29,9822
8110,華東,12,0,12,元大-土城學府,2023-12-29,9822
2888,新光金,11,0,11,元大-土城學府,2023-12-29,9822
3325,旭品,11,0,11,元大-土城學府,2023-12-29,9822
6509,聚和,11,0,11,元大-土城學府,2023-12-29,9822
2834,臺企銀,10,0,10,元大-土城學府,2023-12-29,9822
8150,南茂,10,0,10,元大-土城學府,2023-12-29,9822
6782,視陽,10,0,10,元大-土城學府,2023-12-29,9822
1319,東陽,10,0,10,元大-土城學府,2023-12-29,9822
00642U,期元大S＆P石油,10,0,10,元大-土城學府,2023-12-29,9822
00706L,期元大S＆P日圓正2,10,0,10,元大-土城學府,2023-12-29,9822
2340,台亞,10,0,10,元大-土城學府,2023-12-29,9822
2495,普安,10,0,10,元大-土城學府,2023-12-29,9822
3206,志豐,10,0,10,元大-土城學府,2023-12-29,9822
3576,聯合再生,10,0,10,元大-土城學府,2023-12-29,9822
6667,信紘科,13,3,10,元大-土城學府,2023-12-29,9822
00688L,國泰20年美債正2,9,0,9,元大-土城學府,2023-12-29,9822
00885,富邦越南,10,1,9,元大-土城學府,2023-12-29,9822
8426,紅木-KY,11,2,9,元大-土城學府,2023-12-29,9822
00878,國泰永續高股息,33,25,8,元大-土城學府,2023-12-29,9822
5344,立衛,8,0,8,元大-土城學府,2023-12-29,9822
00933B,國泰10Y+金融債,7,0,7,元大-土城學府,2023-12-29,9822
3078,僑威,9,2,7,元大-土城學府,2023-12-29,9822
3706,神達,26,19,7,元大-土城學府,2023-12-29,9822
2329,華泰,6,0,6,元大-土城學府,2023-12-29,9822
2436,偉詮電,7,1,6,元大-土城學府,2023-12-29,9822
3260,威剛,10,4,6,元大-土城學府,2023-12-29,9822
3390,旭軟,14,8,6,元大-土城學府,2023-12-29,9822
6282,康舒,7,1,6,元大-土城學府,2023-12-29,9822
6456,GIS-KY,7,1,6,元大-土城學府,2023-12-29,9822
2301,光寶科,6,0,6,元大-土城學府,2023-12-29,9822
2353,宏��,76,71,5,元大-土城學府,2023-12-29,9822
00687B,國泰20年美債,6,1,5,元大-土城學府,2023-12-29,9822
1519,華城,26,21,5,元大-土城學府,2023-12-29,9822
00891,中信關鍵半導體,5,0,5,元大-土城學府,2023-12-29,9822
2609,陽明,214,96,118,元大-土城學府,2024-01-02,9822
00937B,群益ESG投等債20,101,11,90,元大-土城學府,2024-01-02,9822
3231,緯創,102,35,67,元大-土城學府,2024-01-02,9822
2324,仁寶,47,16,31,元大-土城學府,2024-01-02,9822
1217,愛之味,30,0,30,元大-土城學府,2024-01-02,9822
00712,復華富時不動產,34,6,28,元大-土城學府,2024-01-02,9822
2356,英業達,89,62,27,元大-土城學府,2024-01-02,9822
00719B,元大美債1-3,25,0,25,元大-土城學府,2024-01-02,9822
00795B,中信美國公債20年,24,0,24,元大-土城學府,2024-01-02,9822
3380,明泰,23,0,23,元大-土城學府,2024-01-02,9822
00933B,國泰10Y+金融債,22,0,22,元大-土城學府,2024-01-02,9822
2303,聯電,49,27,22,元大-土城學府,2024-01-02,9822
2382,廣達,29,9,20,元大-土城學府,2024-01-02,9822
4402,郡都開發,22,2,20,元大-土城學府,2024-01-02,9822
00772B,中信高評級公司債,33,15,18,元大-土城學府,2024-01-02,9822
00633L,富邦上証正2,17,0,17,元大-土城學府,2024-01-02,9822
6139,亞翔,31,14,17,元大-土城學府,2024-01-02,9822
00929,復華台灣科技優息,63,48,15,元大-土城學府,2024-01-02,9822
2615,萬海,62,48,14,元大-土城學府,2024-01-02,9822
8046,南電,15,1,14,元大-土城學府,2024-01-02,9822
00687B,國泰20年美債,13,0,13,元大-土城學府,2024-01-02,9822
00935,野村臺灣新科技50,33,20,13,元大-土城學府,2024-01-02,9822
00878,國泰永續高股息,22,9,13,元大-土城學府,2024-01-02,9822
00637L,元大滬深300正2,17,5,12,元大-土城學府,2024-01-02,9822
4712,福格創新,12,0,12,元大-土城學府,2024-01-02,9822
00679B,元大美債20年,11,0,11,元大-土城學府,2024-01-02,9822
6457,紘康,12,1,11,元大-土城學府,2024-01-02,9822
2328,廣宇,11,1,10,元大-土城學府,2024-01-02,9822
2607,榮運,10,0,10,元大-土城學府,2024-01-02,9822
2867,三商壽,10,0,10,元大-土城學府,2024-01-02,9822
3576,聯合再生,10,0,10,元大-土城學府,2024-01-02,9822
5243,乙盛-KY,10,0,10,元大-土城學府,2024-01-02,9822
5425,台半,11,1,10,元大-土城學府,2024-01-02,9822
8112,至上,15,5,10,元大-土城學府,2024-01-02,9822
0050,元大台灣50,15,5,10,元大-土城學府,2024-01-02,9822
2301,光寶科,11,2,9,元大-土城學府,2024-01-02,9822
5521,工信,17,8,9,元大-土城學府,2024-01-02,9822
6113,亞矽,21,12,9,元大-土城學府,2024-01-02,9822
2027,大成鋼,9,1,8,元大-土城學府,2024-01-02,9822
2352,佳世達,10,2,8,元大-土城學府,2024-01-02,9822
2363,矽統,9,1,8,元大-土城學府,2024-01-02,9822
3704,合勤控,8,0,8,元大-土城學府,2024-01-02,9822
8096,擎亞,8,0,8,元大-土城學府,2024-01-02,9822
8103,瀚荃,8,0,8,元大-土城學府,2024-01-02,9822
0056,元大高股息,18,11,7,元大-土城學府,2024-01-02,9822
2515,中工,26,19,7,元大-土城學府,2024-01-02,9822
2812,台中銀,7,0,7,元大-土城學府,2024-01-02,9822
3532,台勝科,7,0,7,元大-土城學府,2024-01-02,9822
5483,中美晶,7,0,7,元大-土城學府,2024-01-02,9822
6547,高端疫苗,8,1,7,元大-土城學府,2024-01-02,9822
9105,泰金寶-DR,1987,40,1947,元大-土城學府,2024-01-03,9822
00929,復華台灣科技優息,131,8,123,元大-土城學府,2024-01-03,9822
00919,群益台灣精選高息,106,3,103,元大-土城學府,2024-01-03,9822
2618,長榮航,116,26,90,元大-土城學府,2024-01-03,9822
00715L,期街口布蘭特正2,62,0,62,元大-土城學府,2024-01-03,9822
00881,國泰台灣5G+,56,0,56,元大-土城學府,2024-01-03,9822
00720B,元大投資級公司債,55,0,55,元大-土城學府,2024-01-03,9822
6126,信音,50,0,50,元大-土城學府,2024-01-03,9822
00937B,群益ESG投等債20,53,3,50,元大-土城學府,2024-01-03,9822
00935,野村臺灣新科技50,43,0,43,元大-土城學府,2024-01-03,9822
1455,集盛,41,0,41,元大-土城學府,2024-01-03,9822
2303,聯電,53,14,39,元大-土城學府,2024-01-03,9822
2443,昶虹,43,10,33,元大-土城學府,2024-01-03,9822
5701,劍湖山,30,0,30,元大-土城學府,2024-01-03,9822
2356,英業達,51,23,28,元大-土城學府,2024-01-03,9822
3576,聯合再生,28,1,27,元大-土城學府,2024-01-03,9822
2317,鴻海,29,2,27,元大-土城學府,2024-01-03,9822
2637,慧洋-KY,26,2,24,元大-土城學府,2024-01-03,9822
00882,中信中國高股息,33,10,23,元大-土城學府,2024-01-03,9822
2801,彰銀,20,0,20,元大-土城學府,2024-01-03,9822
6456,GIS-KY,20,0,20,元大-土城學府,2024-01-03,9822
6288,聯嘉,30,11,19,元大-土城學府,2024-01-03,9822
00679B,元大美債20年,21,4,17,元大-土城學府,2024-01-03,9822
2330,台積電,20,3,17,元大-土城學府,2024-01-03,9822
3037,欣興,17,0,17,元大-土城學府,2024-01-03,9822
00933B,國泰10Y+金融債,17,0,17,元大-土城學府,2024-01-03,9822
2610,華航,17,2,15,元大-土城學府,2024-01-03,9822
00770,國泰北美科技,14,0,14,元大-土城學府,2024-01-03,9822
8046,南電,16,2,14,元大-土城學府,2024-01-03,9822
3231,緯創,28,15,13,元大-土城學府,2024-01-03,9822
6770,力積電,19,6,13,元大-土城學府,2024-01-03,9822
6664,群翊,14,1,13,元大-土城學府,2024-01-03,9822
9934,成霖,16,3,13,元大-土城學府,2024-01-03,9822
3711,日月光投控,12,0,12,元大-土城學府,2024-01-03,9822
2362,藍天,39,27,12,元大-土城學府,2024-01-03,9822
1326,台化,11,0,11,元大-土城學府,2024-01-03,9822
2481,強茂,11,0,11,元大-土城學府,2024-01-03,9822
2601,益航,11,0,11,元大-土城學府,2024-01-03,9822
3041,揚智,11,0,11,元大-土城學府,2024-01-03,9822
5426,振發,12,1,11,元大-土城學府,2024-01-03,9822
6756,威鋒電子,11,0,11,元大-土城學府,2024-01-03,9822
00632R,元大台灣50反1,10,0,10,元大-土城學府,2024-01-03,9822
2027,大成鋼,10,0,10,元大-土城學府,2024-01-03,9822
6171,大城地產,10,0,10,元大-土城學府,2024-01-03,9822
2352,佳世達,11,2,9,元大-土城學府,2024-01-03,9822
2855,統一證,9,0,9,元大-土城學府,2024-01-03,9822
2913,農林,8,0,8,元大-土城學府,2024-01-03,9822
2892,第一金,8,0,8,元大-土城學府,2024-01-03,9822
0050,元大台灣50,10,2,8,元大-土城學府,2024-01-03,9822
4906,正文,9,1,8,元大-土城學府,2024-01-03,9822
00929,復華台灣科技優息,80,0,80,元大-土城學府,2024-01-04,9822
00720B,元大投資級公司債,64,0,64,元大-土城學府,2024-01-04,9822
00937B,群益ESG投等債20,58,0,58,元大-土城學府,2024-01-04,9822
3037,欣興,53,0,53,元大-土城學府,2024-01-04,9822
2867,三商壽,35,0,35,元大-土城學府,2024-01-04,9822
2618,長榮航,87,53,34,元大-土城學府,2024-01-04,9822
00712,復華富時不動產,31,0,31,元大-土城學府,2024-01-04,9822
00919,群益台灣精選高息,28,0,28,元大-土城學府,2024-01-04,9822
00934,中信成長高股息,28,0,28,元大-土城學府,2024-01-04,9822
0056,元大高股息,32,7,25,元大-土城學府,2024-01-04,9822
5521,工信,28,5,23,元大-土城學府,2024-01-04,9822
2888,新光金,20,0,20,元大-土城學府,2024-01-04,9822
2610,華航,22,4,18,元大-土城學府,2024-01-04,9822
00881,國泰台灣5G+,17,0,17,元大-土城學府,2024-01-04,9822
2303,聯電,42,25,17,元大-土城學府,2024-01-04,9822
3390,旭軟,22,6,16,元大-土城學府,2024-01-04,9822
1909,榮成,15,0,15,元大-土城學府,2024-01-04,9822
6770,力積電,15,0,15,元大-土城學府,2024-01-04,9822
8358,金居,15,0,15,元大-土城學府,2024-01-04,9822
5351,鈺創,14,0,14,元大-土城學府,2024-01-04,9822
00933B,國泰10Y+金融債,20,7,13,元大-土城學府,2024-01-04,9822
3022,威強電,14,1,13,元大-土城學府,2024-01-04,9822
00927,群益半導體收益,12,0,12,元大-土城學府,2024-01-04,9822
2331,精英,12,0,12,元大-土城學府,2024-01-04,9822
2425,承啟,12,0,12,元大-土城學府,2024-01-04,9822
00902,中信電池及儲能,12,0,12,元大-土城學府,2024-01-04,9822
2890,永豐金,10,0,10,元大-土城學府,2024-01-04,9822
1471,首利,10,0,10,元大-土城學府,2024-01-04,9822
2515,中工,18,8,10,元大-土城學府,2024-01-04,9822
2915,潤泰全,10,0,10,元大-土城學府,2024-01-04,9822
4402,郡都開發,11,1,10,元大-土城學府,2024-01-04,9822
4906,正文,10,0,10,元大-土城學府,2024-01-04,9822
6733,博晟生醫,10,0,10,元大-土城學府,2024-01-04,9822
2363,矽統,9,0,9,元大-土城學府,2024-01-04,9822
2362,藍天,19,10,9,元大-土城學府,2024-01-04,9822
4908,前鼎,10,1,9,元大-土城學府,2024-01-04,9822
6457,紘康,9,0,9,元大-土城學府,2024-01-04,9822
6509,聚和,9,0,9,元大-土城學府,2024-01-04,9822
00878,國泰永續高股息,9,0,9,元大-土城學府,2024-01-04,9822
00751B,元大AAA至A公司債,8,0,8,元大-土城學府,2024-01-04,9822
2449,京元電子,14,6,8,元大-土城學府,2024-01-04,9822
1524,耿鼎,8,0,8,元大-土城學府,2024-01-04,9822
3051,力特,8,0,8,元大-土城學府,2024-01-04,9822
3059,華晶科,8,0,8,元大-土城學府,2024-01-04,9822
1319,東陽,13,6,7,元大-土城學府,2024-01-04,9822
5225,東科-KY,7,0,7,元大-土城學府,2024-01-04,9822
5386,青雲,7,0,7,元大-土城學府,2024-01-04,9822
2014,中鴻,16,9,7,元大-土城學府,2024-01-04,9822
00882,中信中國高股息,9,3,6,元大-土城學府,2024-01-04,9822
00893,國泰智能電動車,6,0,6,元大-土城學府,2024-01-04,9822
2610,華航,97,12,85,元大-土城學府,2024-01-05,9822
00720B,元大投資級公司債,75,0,75,元大-土城學府,2024-01-05,9822
00929,復華台灣科技優息,59,1,58,元大-土城學府,2024-01-05,9822
3372,典範,46,0,46,元大-土城學府,2024-01-05,9822
2206,三陽工業,50,5,45,元大-土城學府,2024-01-05,9822
3037,欣興,43,0,43,元大-土城學府,2024-01-05,9822
00919,群益台灣精選高息,41,1,40,元大-土城學府,2024-01-05,9822
2618,長榮航,57,20,37,元大-土城學府,2024-01-05,9822
00687B,國泰20年美債,30,0,30,元大-土城學府,2024-01-05,9822
4402,郡都開發,31,2,29,元大-土城學府,2024-01-05,9822
00937B,群益ESG投等債20,25,0,25,元大-土城學府,2024-01-05,9822
3231,緯創,28,3,25,元大-土城學府,2024-01-05,9822
2609,陽明,292,267,25,元大-土城學府,2024-01-05,9822
2356,英業達,54,30,24,元大-土城學府,2024-01-05,9822
2607,榮運,33,12,21,元大-土城學府,2024-01-05,9822
2596,綠意,20,0,20,元大-土城學府,2024-01-05,9822
00931B,統一美債20年,22,4,18,元大-土城學府,2024-01-05,9822
00679B,元大美債20年,19,1,18,元大-土城學府,2024-01-05,9822
8096,擎亞,51,34,17,元大-土城學府,2024-01-05,9822
2611,志信,24,8,16,元大-土城學府,2024-01-05,9822
00680L,元大美債20正2,21,5,16,元大-土城學府,2024-01-05,9822
1717,長興,15,0,15,元大-土城學府,2024-01-05,9822
2606,裕民,21,7,14,元大-土城學府,2024-01-05,9822
3380,明泰,19,5,14,元大-土城學府,2024-01-05,9822
6538,倉和,14,0,14,元大-土城學府,2024-01-05,9822
6235,華孚,14,1,13,元大-土城學府,2024-01-05,9822
2882,國泰金,12,0,12,元大-土城學府,2024-01-05,9822
3390,旭軟,18,6,12,元大-土城學府,2024-01-05,9822
00933B,國泰10Y+金融債,11,0,11,元大-土城學府,2024-01-05,9822
2303,聯電,48,37,11,元大-土城學府,2024-01-05,9822
2201,裕隆,12,1,11,元大-土城學府,2024-01-05,9822
00904,新光臺灣半導體30,11,0,11,元大-土城學府,2024-01-05,9822
3324,雙鴻,12,1,11,元大-土城學府,2024-01-05,9822
00662,富邦NASDAQ,10,0,10,元大-土城學府,2024-01-05,9822
2027,大成鋼,10,0,10,元大-土城學府,2024-01-05,9822
3047,訊舟,10,0,10,元大-土城學府,2024-01-05,9822
4906,正文,10,0,10,元大-土城學府,2024-01-05,9822
6282,康舒,13,3,10,元大-土城學府,2024-01-05,9822
6733,博晟生醫,10,0,10,元大-土城學府,2024-01-05,9822
8046,南電,11,2,9,元大-土城學府,2024-01-05,9822
2330,台積電,12,3,9,元大-土城學府,2024-01-05,9822
1519,華城,9,1,8,元大-土城學府,2024-01-05,9822
2425,承啟,8,0,8,元大-土城學府,2024-01-05,9822
6163,華電網,10,2,8,元大-土城學府,2024-01-05,9822
9919,康那香,8,0,8,元大-土城學府,2024-01-05,9822
2353,宏��,56,49,7,元大-土城學府,2024-01-05,9822
00713,元大台灣高息低波,7,0,7,元大-土城學府,2024-01-05,9822
00646,元大S＆P500,7,0,7,元大-土城學府,2024-01-05,9822
1504,東元,7,0,7,元大-土城學府,2024-01-05,9822
1608,華榮,7,0,7,元大-土城學府,2024-01-05,9822
00632R,元大台灣50反1,458,3,455,元大-土城學府,2024-01-08,9822
00665L,富邦�琤肭磪囓�2,67,0,67,元大-土城學府,2024-01-08,9822
00929,復華台灣科技優息,67,0,67,元大-土城學府,2024-01-08,9822
2611,志信,55,0,55,元大-土城學府,2024-01-08,9822
00687B,國泰20年美債,55,1,54,元大-土城學府,2024-01-08,9822
00720B,元大投資級公司債,40,0,40,元大-土城學府,2024-01-08,9822
6163,華電網,40,1,39,元大-土城學府,2024-01-08,9822
0056,元大高股息,48,13,35,元大-土城學府,2024-01-08,9822
00937B,群益ESG投等債20,35,1,34,元大-土城學府,2024-01-08,9822
00919,群益台灣精選高息,44,10,34,元大-土城學府,2024-01-08,9822
2845,遠東銀,30,2,28,元大-土城學府,2024-01-08,9822
3017,奇鋐,30,2,28,元大-土城學府,2024-01-08,9822
00772B,中信高評級公司債,22,0,22,元大-土城學府,2024-01-08,9822
5225,東科-KY,25,3,22,元大-土城學府,2024-01-08,9822
6770,力積電,30,9,21,元大-土城學府,2024-01-08,9822
4157,太景*-KY,20,0,20,元大-土城學府,2024-01-08,9822
8096,擎亞,28,9,19,元大-土城學府,2024-01-08,9822
8930,青鋼,19,0,19,元大-土城學府,2024-01-08,9822
2303,聯電,21,2,19,元大-土城學府,2024-01-08,9822
00680L,元大美債20正2,28,10,18,元大-土城學府,2024-01-08,9822
00934,中信成長高股息,19,1,18,元大-土城學府,2024-01-08,9822
4979,華星光,19,1,18,元大-土城學府,2024-01-08,9822
2344,華邦電,27,11,16,元大-土城學府,2024-01-08,9822
4402,郡都開發,22,7,15,元大-土城學府,2024-01-08,9822
00770,國泰北美科技,13,0,13,元大-土城學府,2024-01-08,9822
00688L,國泰20年美債正2,13,0,13,元大-土城學府,2024-01-08,9822
2601,益航,13,0,13,元大-土城學府,2024-01-08,9822
6116,彩晶,16,3,13,元大-土城學府,2024-01-08,9822
2615,萬海,56,44,12,元大-土城學府,2024-01-08,9822
00891,中信關鍵半導體,13,1,12,元大-土城學府,2024-01-08,9822
2371,大同,13,1,12,元大-土城學府,2024-01-08,9822
6126,信音,11,0,11,元大-土城學府,2024-01-08,9822
2317,鴻海,12,1,11,元大-土城學府,2024-01-08,9822
1471,首利,10,0,10,元大-土城學府,2024-01-08,9822
3052,夆典,10,0,10,元大-土城學府,2024-01-08,9822
2609,陽明,129,119,10,元大-土城學府,2024-01-08,9822
6139,亞翔,23,14,9,元大-土城學府,2024-01-08,9822
6695,芯鼎,10,1,9,元大-土城學府,2024-01-08,9822
00881,國泰台灣5G+,8,0,8,元大-土城學府,2024-01-08,9822
00904,新光臺灣半導體30,8,0,8,元大-土城學府,2024-01-08,9822
2618,長榮航,27,19,8,元大-土城學府,2024-01-08,9822
3025,星通,8,1,7,元大-土城學府,2024-01-08,9822
00646,元大S＆P500,7,0,7,元大-土城學府,2024-01-08,9822
00751B,元大AAA至A公司債,7,0,7,元大-土城學府,2024-01-08,9822
00637L,元大滬深300正2,7,0,7,元大-土城學府,2024-01-08,9822
5258,虹堡,7,0,7,元大-土城學府,2024-01-08,9822
9934,成霖,10,3,7,元大-土城學府,2024-01-08,9822
00712,復華富時不動產,6,0,6,元大-土城學府,2024-01-08,9822
1815,富喬,11,5,6,元大-土城學府,2024-01-08,9822
2408,南亞科,6,0,6,元大-土城學府,2024-01-08,9822
3481,群創,243,20,223,元大-土城學府,2024-01-09,9822
00919,群益台灣精選高息,126,1,125,元大-土城學府,2024-01-09,9822
00680L,元大美債20正2,110,5,105,元大-土城學府,2024-01-09,9822
2359,所羅門,72,0,72,元大-土城學府,2024-01-09,9822
1455,集盛,65,0,65,元大-土城學府,2024-01-09,9822
00937B,群益ESG投等債20,60,0,60,元大-土城學府,2024-01-09,9822
00673R,期元大S＆P原油反1,50,0,50,元大-土城學府,2024-01-09,9822
2323,中環,47,0,47,元大-土城學府,2024-01-09,9822
2615,萬海,58,18,40,元大-土城學府,2024-01-09,9822
00706L,期元大S＆P日圓正2,40,0,40,元大-土城學府,2024-01-09,9822
00688L,國泰20年美債正2,50,10,40,元大-土城學府,2024-01-09,9822
00929,復華台灣科技優息,52,13,39,元大-土城學府,2024-01-09,9822
2363,矽統,56,24,32,元大-土城學府,2024-01-09,9822
2609,陽明,182,150,32,元大-土城學府,2024-01-09,9822
2002,中鋼,31,0,31,元大-土城學府,2024-01-09,9822
4714,永捷,30,0,30,元大-土城學府,2024-01-09,9822
2353,宏��,209,183,26,元大-土城學府,2024-01-09,9822
1721,三晃,29,4,25,元大-土城學府,2024-01-09,9822
2303,聯電,24,0,24,元大-土城學府,2024-01-09,9822
2356,英業達,69,45,24,元大-土城學府,2024-01-09,9822
2610,華航,27,4,23,元大-土城學府,2024-01-09,9822
1605,華新,20,0,20,元大-土城學府,2024-01-09,9822
5608,四維航,20,0,20,元大-土城學府,2024-01-09,9822
8930,青鋼,21,4,17,元大-土城學府,2024-01-09,9822
3231,緯創,57,43,14,元大-土城學府,2024-01-09,9822
2308,台達電,14,0,14,元大-土城學府,2024-01-09,9822
2329,華泰,27,14,13,元大-土城學府,2024-01-09,9822
00878,國泰永續高股息,15,2,13,元大-土城學府,2024-01-09,9822
2605,新興,12,0,12,元大-土城學府,2024-01-09,9822
00679B,元大美債20年,15,3,12,元大-土城學府,2024-01-09,9822
2344,華邦電,12,0,12,元大-土城學府,2024-01-09,9822
3047,訊舟,12,0,12,元大-土城學府,2024-01-09,9822
1717,長興,10,0,10,元大-土城學府,2024-01-09,9822
2027,大成鋼,10,0,10,元大-土城學府,2024-01-09,9822
3078,僑威,15,5,10,元大-土城學府,2024-01-09,9822
3576,聯合再生,10,0,10,元大-土城學府,2024-01-09,9822
6133,金橋,10,0,10,元大-土城學府,2024-01-09,9822
00931B,統一美債20年,10,1,9,元大-土城學府,2024-01-09,9822
00891,中信關鍵半導體,9,0,9,元大-土城學府,2024-01-09,9822
00905,FT臺灣Smart,9,0,9,元大-土城學府,2024-01-09,9822
2881,富邦金,10,1,9,元大-土城學府,2024-01-09,9822
3213,茂訊,9,0,9,元大-土城學府,2024-01-09,9822
3264,欣銓,9,0,9,元大-土城學府,2024-01-09,9822
6538,倉和,11,2,9,元大-土城學府,2024-01-09,9822
1301,台塑,8,0,8,元大-土城學府,2024-01-09,9822
3022,威強電,8,0,8,元大-土城學府,2024-01-09,9822
2603,長榮,41,33,8,元大-土城學府,2024-01-09,9822
3056,富華新,7,0,7,元大-土城學府,2024-01-09,9822
6547,高端疫苗,11,4,7,元大-土城學府,2024-01-09,9822
6672,騰輝電子-KY,7,0,7,元大-土城學府,2024-01-09,9822
00929,復華台灣科技優息,87,14,73,元大-土城學府,2024-01-10,9822
1455,集盛,67,2,65,元大-土城學府,2024-01-10,9822
3481,群創,74,12,62,元大-土城學府,2024-01-10,9822
2356,英業達,78,17,61,元大-土城學府,2024-01-10,9822
00919,群益台灣精選高息,51,4,47,元大-土城學府,2024-01-10,9822
2618,長榮航,49,6,43,元大-土城學府,2024-01-10,9822
2609,陽明,187,148,39,元大-土城學府,2024-01-10,9822
00632R,元大台灣50反1,105,72,33,元大-土城學府,2024-01-10,9822
00680L,元大美債20正2,31,0,31,元大-土城學府,2024-01-10,9822
2610,華航,22,1,21,元大-土城學府,2024-01-10,9822
2801,彰銀,21,0,21,元大-土城學府,2024-01-10,9822
2359,所羅門,20,0,20,元大-土城學府,2024-01-10,9822
2722,夏都,20,0,20,元大-土城學府,2024-01-10,9822
0056,元大高股息,22,3,19,元大-土城學府,2024-01-10,9822
3041,揚智,21,3,18,元大-土城學府,2024-01-10,9822
00713,元大台灣高息低波,17,0,17,元大-土城學府,2024-01-10,9822
2615,萬海,19,3,16,元大-土城學府,2024-01-10,9822
00918,大華優利高填息30,16,0,16,元大-土城學府,2024-01-10,9822
6139,亞翔,49,33,16,元大-土城學府,2024-01-10,9822
1605,華新,15,0,15,元大-土城學府,2024-01-10,9822
00937B,群益ESG投等債20,16,1,15,元大-土城學府,2024-01-10,9822
4402,郡都開發,15,1,14,元大-土城學府,2024-01-10,9822
6456,GIS-KY,14,0,14,元大-土城學府,2024-01-10,9822
2885,元大金,13,0,13,元大-土城學府,2024-01-10,9822
00900,富邦特選高股息30,15,2,13,元大-土城學府,2024-01-10,9822
6770,力積電,18,5,13,元大-土城學府,2024-01-10,9822
2301,光寶科,16,4,12,元大-土城學府,2024-01-10,9822
00935,野村臺灣新科技50,11,0,11,元大-土城學府,2024-01-10,9822
2313,華通,14,4,10,元大-土城學府,2024-01-10,9822
00676R,富邦臺灣加權反1,10,0,10,元大-土城學府,2024-01-10,9822
00881,國泰台灣5G+,9,0,9,元大-土城學府,2024-01-10,9822
00715L,期街口布蘭特正2,10,1,9,元大-土城學府,2024-01-10,9822
00933B,國泰10Y+金融債,10,1,9,元大-土城學府,2024-01-10,9822
2371,大同,31,22,9,元大-土城學府,2024-01-10,9822
2317,鴻海,10,1,9,元大-土城學府,2024-01-10,9822
00934,中信成長高股息,8,0,8,元大-土城學府,2024-01-10,9822
2009,第一銅,8,0,8,元大-土城學府,2024-01-10,9822
1319,東陽,8,0,8,元大-土城學府,2024-01-10,9822
1710,東聯,8,0,8,元大-土城學府,2024-01-10,9822
2331,精英,11,3,8,元大-土城學府,2024-01-10,9822
2401,凌陽,8,0,8,元大-土城學府,2024-01-10,9822
2812,台中銀,10,2,8,元大-土城學府,2024-01-10,9822
4714,永捷,8,0,8,元大-土城學府,2024-01-10,9822
00904,新光臺灣半導體30,7,0,7,元大-土城學府,2024-01-10,9822
2316,楠梓電,7,0,7,元大-土城學府,2024-01-10,9822
2891,中信金,7,0,7,元大-土城學府,2024-01-10,9822
3324,雙鴻,7,0,7,元大-土城學府,2024-01-10,9822
0050,元大台灣50,7,0,7,元大-土城學府,2024-01-10,9822
2303,聯電,19,12,7,元大-土城學府,2024-01-10,9822
00878,國泰永續高股息,12,6,6,元大-土城學府,2024-01-10,9822
00929,復華台灣科技優息,521,0,521,元大-土城學府,2024-01-11,9822
00632R,元大台灣50反1,102,7,95,元大-土城學府,2024-01-11,9822
2303,聯電,59,6,53,元大-土城學府,2024-01-11,9822
4908,前鼎,54,14,40,元大-土城學府,2024-01-11,9822
4402,郡都開發,38,0,38,元大-土城學府,2024-01-11,9822
00665L,富邦�琤肭磪囓�2,50,16,34,元大-土城學府,2024-01-11,9822
00919,群益台灣精選高息,36,3,33,元大-土城學府,2024-01-11,9822
00881,國泰台灣5G+,30,0,30,元大-土城學府,2024-01-11,9822
2353,宏��,99,75,24,元大-土城學府,2024-01-11,9822
2883,凱基金,23,0,23,元大-土城學府,2024-01-11,9822
00936,台新永續高息中小,21,0,21,元大-土城學府,2024-01-11,9822
00907,永豐優息存股,20,0,20,元大-土城學府,2024-01-11,9822
00680L,元大美債20正2,19,0,19,元大-土城學府,2024-01-11,9822
2324,仁寶,28,10,18,元大-土城學府,2024-01-11,9822
00882,中信中國高股息,15,0,15,元大-土城學府,2024-01-11,9822
2029,盛餘,15,0,15,元大-土城學府,2024-01-11,9822
2515,中工,13,0,13,元大-土城學府,2024-01-11,9822
6239,力成,15,2,13,元大-土城學府,2024-01-11,9822
1325,恆大,12,0,12,元大-土城學府,2024-01-11,9822
6695,芯鼎,29,17,12,元大-土城學府,2024-01-11,9822
2002,中鋼,12,1,11,元大-土城學府,2024-01-11,9822
00687B,國泰20年美債,13,2,11,元大-土城學府,2024-01-11,9822
00934,中信成長高股息,11,0,11,元大-土城學府,2024-01-11,9822
9945,潤泰新,10,0,10,元大-土城學府,2024-01-11,9822
00935,野村臺灣新科技50,10,0,10,元大-土城學府,2024-01-11,9822
00706L,期元大S＆P日圓正2,10,0,10,元大-土城學府,2024-01-11,9822
00675L,富邦臺灣加權正2,10,0,10,元大-土城學府,2024-01-11,9822
2323,中環,10,0,10,元大-土城學府,2024-01-11,9822
3162,精確,10,0,10,元大-土城學府,2024-01-11,9822
3202,樺晟,10,0,10,元大-土城學府,2024-01-11,9822
4714,永捷,10,0,10,元大-土城學府,2024-01-11,9822
4931,新盛力,10,0,10,元大-土城學府,2024-01-11,9822
2605,新興,9,0,9,元大-土城學府,2024-01-11,9822
00679B,元大美債20年,10,1,9,元大-土城學府,2024-01-11,9822
6125,廣運,10,1,9,元大-土城學府,2024-01-11,9822
6140,訊達,8,0,8,元大-土城學府,2024-01-11,9822
8358,金居,7,0,7,元大-土城學府,2024-01-11,9822
2618,長榮航,14,7,7,元大-土城學府,2024-01-11,9822
2317,鴻海,6,0,6,元大-土城學府,2024-01-11,9822
2606,裕民,6,0,6,元大-土城學府,2024-01-11,9822
1301,台塑,12,6,6,元大-土城學府,2024-01-11,9822
1514,亞力,15,9,6,元大-土城學府,2024-01-11,9822
00712,復華富時不動產,6,0,6,元大-土城學府,2024-01-11,9822
1303,南亞,6,0,6,元大-土城學府,2024-01-11,9822
3548,兆利,11,5,6,元大-土城學府,2024-01-11,9822
4904,遠傳,8,2,6,元大-土城學府,2024-01-11,9822
8227,巨有科技,38,32,6,元大-土城學府,2024-01-11,9822
00937B,群益ESG投等債20,5,0,5,元大-土城學府,2024-01-11,9822
00904,新光臺灣半導體30,5,0,5,元大-土城學府,2024-01-11,9822
2367,燿華,5,0,5,元大-土城學府,2024-01-11,9822
9105,泰金寶-DR,170,0,170,元大-土城學府,2024-01-12,9822
00929,復華台灣科技優息,70,7,63,元大-土城學府,2024-01-12,9822
4402,郡都開發,45,0,45,元大-土城學府,2024-01-12,9822
2353,宏��,57,22,35,元大-土城學府,2024-01-12,9822
2443,昶虹,22,0,22,元大-土城學府,2024-01-12,9822
6129,普誠,20,0,20,元大-土城學府,2024-01-12,9822
1101,台泥,23,3,20,元大-土城學府,2024-01-12,9822
3543,州巧,20,0,20,元大-土城學府,2024-01-12,9822
0056,元大高股息,19,0,19,元大-土城學府,2024-01-12,9822
2208,台船,18,2,16,元大-土城學府,2024-01-12,9822
2887,台新金,16,0,16,元大-土城學府,2024-01-12,9822
2888,新光金,32,16,16,元大-土城學府,2024-01-12,9822
00688L,國泰20年美債正2,15,0,15,元大-土城學府,2024-01-12,9822
2324,仁寶,15,2,13,元大-土城學府,2024-01-12,9822
00919,群益台灣精選高息,54,41,13,元大-土城學府,2024-01-12,9822
2301,光寶科,15,3,12,元大-土城學府,2024-01-12,9822
5210,寶碩,11,0,11,元大-土城學府,2024-01-12,9822
00679B,元大美債20年,12,2,10,元大-土城學府,2024-01-12,9822
00904,新光臺灣半導體30,10,0,10,元大-土城學府,2024-01-12,9822
1455,集盛,10,0,10,元大-土城學府,2024-01-12,9822
4906,正文,10,0,10,元大-土城學府,2024-01-12,9822
8034,榮群,22,12,10,元大-土城學府,2024-01-12,9822
3325,旭品,9,0,9,元大-土城學府,2024-01-12,9822
00713,元大台灣高息低波,9,1,8,元大-土城學府,2024-01-12,9822
2332,友訊,10,2,8,元大-土城學府,2024-01-12,9822
2344,華邦電,14,6,8,元大-土城學府,2024-01-12,9822
00927,群益半導體收益,8,0,8,元大-土城學府,2024-01-12,9822
00878,國泰永續高股息,9,2,7,元大-土城學府,2024-01-12,9822
2002,中鋼,10,3,7,元大-土城學府,2024-01-12,9822
3037,欣興,7,0,7,元大-土城學府,2024-01-12,9822
1524,耿鼎,7,0,7,元大-土城學府,2024-01-12,9822
2401,凌陽,8,1,7,元大-土城學府,2024-01-12,9822
2498,宏達電,11,4,7,元大-土城學府,2024-01-12,9822
8227,巨有科技,37,30,7,元大-土城學府,2024-01-12,9822
00937B,群益ESG投等債20,6,0,6,元大-土城學府,2024-01-12,9822
9945,潤泰新,6,0,6,元大-土城學府,2024-01-12,9822
2465,麗臺,6,0,6,元大-土城學府,2024-01-12,9822
2637,慧洋-KY,11,5,6,元大-土城學府,2024-01-12,9822
3518,柏騰,6,0,6,元大-土城學府,2024-01-12,9822
6770,力積電,8,2,6,元大-土城學府,2024-01-12,9822
2356,英業達,49,43,6,元大-土城學府,2024-01-12,9822
00687B,國泰20年美債,5,0,5,元大-土城學府,2024-01-12,9822
2006,東和鋼鐵,5,0,5,元大-土城學府,2024-01-12,9822
2014,中鴻,5,0,5,元大-土城學府,2024-01-12,9822
2440,太空梭,5,0,5,元大-土城學府,2024-01-12,9822
2515,中工,5,0,5,元大-土城學府,2024-01-12,9822
3588,通嘉,5,0,5,元大-土城學府,2024-01-12,9822
5269,祥碩,5,0,5,元大-土城學府,2024-01-12,9822
5381,合正,5,0,5,元大-土城學府,2024-01-12,9822
6117,迎廣,6,1,5,元大-土城學府,2024-01-12,9822
00632R,元大台灣50反1,529,0,529,元大-土城學府,2024-01-15,9822
3044,健鼎,158,1,157,元大-土城學府,2024-01-15,9822
00929,復華台灣科技優息,87,2,85,元大-土城學府,2024-01-15,9822
00665L,富邦�琤肭磪囓�2,43,0,43,元大-土城學府,2024-01-15,9822
0056,元大高股息,37,6,31,元大-土城學府,2024-01-15,9822
2883,凱基金,26,1,25,元大-土城學府,2024-01-15,9822
8047,星雲,25,0,25,元大-土城學府,2024-01-15,9822
2101,南港,23,0,23,元大-土城學府,2024-01-15,9822
00770,國泰北美科技,21,0,21,元大-土城學府,2024-01-15,9822
00687B,國泰20年美債,19,0,19,元大-土城學府,2024-01-15,9822
2356,英業達,47,29,18,元大-土城學府,2024-01-15,9822
2867,三商壽,18,0,18,元大-土城學府,2024-01-15,9822
2609,陽明,45,27,18,元大-土城學府,2024-01-15,9822
00888,永豐台灣ESG,20,5,15,元大-土城學府,2024-01-15,9822
1217,愛之味,15,0,15,元大-土城學府,2024-01-15,9822
2801,彰銀,15,0,15,元大-土城學府,2024-01-15,9822
1101,台泥,13,0,13,元大-土城學府,2024-01-15,9822
3041,揚智,16,3,13,元大-土城學府,2024-01-15,9822
2634,漢翔,42,30,12,元大-土城學府,2024-01-15,9822
5258,虹堡,14,2,12,元大-土城學府,2024-01-15,9822
5426,振發,42,30,12,元大-土城學府,2024-01-15,9822
4939,亞電,11,0,11,元大-土城學府,2024-01-15,9822
00927,群益半導體收益,10,0,10,元大-土城學府,2024-01-15,9822
2002,中鋼,14,4,10,元大-土城學府,2024-01-15,9822
2705,六福,10,0,10,元大-土城學府,2024-01-15,9822
2887,台新金,10,0,10,元大-土城學府,2024-01-15,9822
00902,中信電池及儲能,9,0,9,元大-土城學府,2024-01-15,9822
1326,台化,10,1,9,元大-土城學府,2024-01-15,9822
1463,強盛新,9,0,9,元大-土城學府,2024-01-15,9822
1605,華新,13,4,9,元大-土城學府,2024-01-15,9822
2353,宏��,36,28,8,元大-土城學府,2024-01-15,9822
3017,奇鋐,15,7,8,元大-土城學府,2024-01-15,9822
1718,中纖,10,3,7,元大-土城學府,2024-01-15,9822
8222,寶一,18,12,6,元大-土城學府,2024-01-15,9822
00679B,元大美債20年,6,0,6,元大-土城學府,2024-01-15,9822
2462,良得電,6,0,6,元大-土城學府,2024-01-15,9822
2486,一詮,45,39,6,元大-土城學府,2024-01-15,9822
3191,雲嘉南,6,0,6,元大-土城學府,2024-01-15,9822
4906,正文,9,3,6,元大-土城學府,2024-01-15,9822
9958,世紀鋼,10,4,6,元大-土城學府,2024-01-15,9822
2317,鴻海,5,0,5,元大-土城學府,2024-01-15,9822
00937B,群益ESG投等債20,19,14,5,元大-土城學府,2024-01-15,9822
1471,首利,5,0,5,元大-土城學府,2024-01-15,9822
2371,大同,23,18,5,元大-土城學府,2024-01-15,9822
2465,麗臺,5,0,5,元大-土城學府,2024-01-15,9822
2630,亞航,6,1,5,元大-土城學府,2024-01-15,9822
2739,寒舍,5,0,5,元大-土城學府,2024-01-15,9822
3293,鈊象,5,0,5,元大-土城學府,2024-01-15,9822
3376,新日興,6,1,5,元大-土城學府,2024-01-15,9822
5244,弘凱,5,0,5,元大-土城學府,2024-01-15,9822
00929,復華台灣科技優息,148,31,117,元大-土城學府,2024-01-16,9822
00665L,富邦�琤肭磪囓�2,122,40,82,元大-土城學府,2024-01-16,9822
0056,元大高股息,91,11,80,元大-土城學府,2024-01-16,9822
6164,華興,69,0,69,元大-土城學府,2024-01-16,9822
00919,群益台灣精選高息,68,5,63,元大-土城學府,2024-01-16,9822
3481,群創,107,60,47,元大-土城學府,2024-01-16,9822
2486,一詮,84,38,46,元大-土城學府,2024-01-16,9822
1455,集盛,51,7,44,元大-土城學府,2024-01-16,9822
2887,台新金,36,0,36,元大-土城學府,2024-01-16,9822
2002,中鋼,38,3,35,元大-土城學府,2024-01-16,9822
1301,台塑,36,3,33,元大-土城學府,2024-01-16,9822
00881,國泰台灣5G+,32,0,32,元大-土城學府,2024-01-16,9822
8096,擎亞,60,28,32,元大-土城學府,2024-01-16,9822
2353,宏��,42,14,28,元大-土城學府,2024-01-16,9822
2344,華邦電,35,10,25,元大-土城學府,2024-01-16,9822
2884,玉山金,25,1,24,元大-土城學府,2024-01-16,9822
2801,彰銀,26,2,24,元大-土城學府,2024-01-16,9822
5258,虹堡,23,3,20,元大-土城學府,2024-01-16,9822
4908,前鼎,22,3,19,元大-土城學府,2024-01-16,9822
6756,威鋒電子,18,0,18,元大-土城學府,2024-01-16,9822
2885,元大金,17,1,16,元大-土城學府,2024-01-16,9822
2101,南港,19,3,16,元大-土城學府,2024-01-16,9822
6140,訊達,20,4,16,元大-土城學府,2024-01-16,9822
1101,台泥,15,0,15,元大-土城學府,2024-01-16,9822
00878,國泰永續高股息,30,16,14,元大-土城學府,2024-01-16,9822
3576,聯合再生,15,1,14,元大-土城學府,2024-01-16,9822
4714,永捷,15,1,14,元大-土城學府,2024-01-16,9822
0050,元大台灣50,13,0,13,元大-土城學府,2024-01-16,9822
00687B,國泰20年美債,13,0,13,元大-土城學府,2024-01-16,9822
1524,耿鼎,13,0,13,元大-土城學府,2024-01-16,9822
2371,大同,13,0,13,元大-土城學府,2024-01-16,9822
5880,合庫金,12,0,12,元大-土城學府,2024-01-16,9822
00931B,統一美債20年,12,0,12,元大-土城學府,2024-01-16,9822
1609,大亞,12,0,12,元大-土城學府,2024-01-16,9822
2889,國票金,12,0,12,元大-土城學府,2024-01-16,9822
00927,群益半導體收益,11,0,11,元大-土城學府,2024-01-16,9822
1325,恆大,11,0,11,元大-土城學府,2024-01-16,9822
2892,第一金,11,0,11,元大-土城學府,2024-01-16,9822
5210,寶碩,12,1,11,元大-土城學府,2024-01-16,9822
6770,力積電,12,1,11,元大-土城學府,2024-01-16,9822
00904,新光臺灣半導體30,20,10,10,元大-土城學府,2024-01-16,9822
00720B,元大投資級公司債,10,0,10,元大-土城學府,2024-01-16,9822
1718,中纖,10,0,10,元大-土城學府,2024-01-16,9822
2606,裕民,11,1,10,元大-土城學府,2024-01-16,9822
2883,凱基金,15,5,10,元大-土城學府,2024-01-16,9822
2882,國泰金,9,0,9,元大-土城學府,2024-01-16,9822
2241,艾姆勒,9,0,9,元大-土城學府,2024-01-16,9822
3694,海華,27,18,9,元大-土城學府,2024-01-16,9822
00713,元大台灣高息低波,8,0,8,元大-土城學府,2024-01-16,9822
2303,聯電,61,53,8,元大-土城學府,2024-01-16,9822
2303,聯電,194,19,175,元大-土城學府,2024-01-17,9822
00929,復華台灣科技優息,156,1,155,元大-土城學府,2024-01-17,9822
3596,智易,128,0,128,元大-土城學府,2024-01-17,9822
0056,元大高股息,118,5,113,元大-土城學府,2024-01-17,9822
2883,凱基金,85,0,85,元大-土城學府,2024-01-17,9822
00919,群益台灣精選高息,116,38,78,元大-土城學府,2024-01-17,9822
5443,均豪,72,1,71,元大-土城學府,2024-01-17,9822
6126,信音,58,0,58,元大-土城學府,2024-01-17,9822
5488,松普,55,6,49,元大-土城學府,2024-01-17,9822
6164,華興,51,2,49,元大-土城學府,2024-01-17,9822
2344,華邦電,49,7,42,元大-土城學府,2024-01-17,9822
00878,國泰永續高股息,41,3,38,元大-土城學府,2024-01-17,9822
00882,中信中國高股息,57,21,36,元大-土城學府,2024-01-17,9822
00937B,群益ESG投等債20,36,0,36,元大-土城學府,2024-01-17,9822
3321,同泰,37,1,36,元大-土城學府,2024-01-17,9822
3231,緯創,71,37,34,元大-土城學府,2024-01-17,9822
2356,英業達,66,32,34,元大-土城學府,2024-01-17,9822
00904,新光臺灣半導體30,31,0,31,元大-土城學府,2024-01-17,9822
9945,潤泰新,30,0,30,元大-土城學府,2024-01-17,9822
0050,元大台灣50,28,0,28,元大-土城學府,2024-01-17,9822
00772B,中信高評級公司債,28,0,28,元大-土城學府,2024-01-17,9822
2610,華航,31,7,24,元大-土城學府,2024-01-17,9822
5258,虹堡,26,2,24,元大-土城學府,2024-01-17,9822
00927,群益半導體收益,23,0,23,元大-土城學府,2024-01-17,9822
2887,台新金,24,2,22,元大-土城學府,2024-01-17,9822
00679B,元大美債20年,22,0,22,元大-土城學府,2024-01-17,9822
00881,國泰台灣5G+,21,0,21,元大-土城學府,2024-01-17,9822
6770,力積電,28,7,21,元大-土城學府,2024-01-17,9822
2801,彰銀,25,5,20,元大-土城學府,2024-01-17,9822
00669R,國泰美國道瓊反1,20,0,20,元大-土城學府,2024-01-17,9822
2371,大同,22,2,20,元大-土城學府,2024-01-17,9822
5243,乙盛-KY,20,0,20,元大-土城學府,2024-01-17,9822
6290,良維,20,1,19,元大-土城學府,2024-01-17,9822
1609,大亞,21,3,18,元大-土城學府,2024-01-17,9822
00888,永豐台灣ESG,17,0,17,元大-土城學府,2024-01-17,9822
00687B,國泰20年美債,17,0,17,元大-土城學府,2024-01-17,9822
2882,國泰金,16,0,16,元大-土城學府,2024-01-17,9822
5880,合庫金,15,0,15,元大-土城學府,2024-01-17,9822
4956,光鋐,22,7,15,元大-土城學府,2024-01-17,9822
6139,亞翔,21,6,15,元大-土城學府,2024-01-17,9822
2002,中鋼,15,0,15,元大-土城學府,2024-01-17,9822
2405,輔信,30,16,14,元大-土城學府,2024-01-17,9822
2885,元大金,21,7,14,元大-土城學府,2024-01-17,9822
2812,台中銀,13,0,13,元大-土城學府,2024-01-17,9822
2884,玉山金,13,1,12,元大-土城學府,2024-01-17,9822
1504,東元,13,1,12,元大-土城學府,2024-01-17,9822
2609,陽明,56,44,12,元大-土城學府,2024-01-17,9822
2888,新光金,14,2,12,元大-土城學府,2024-01-17,9822
1101,台泥,15,3,12,元大-土城學府,2024-01-17,9822
2103,台橡,11,0,11,元大-土城學府,2024-01-17,9822
00632R,元大台灣50反1,172,1,171,元大-土城學府,2024-01-18,9822
00929,復華台灣科技優息,185,27,158,元大-土城學府,2024-01-18,9822
00637L,元大滬深300正2,104,5,99,元大-土城學府,2024-01-18,9822
2609,陽明,113,33,80,元大-土城學府,2024-01-18,9822
00878,國泰永續高股息,67,7,60,元大-土城學府,2024-01-18,9822
2888,新光金,54,0,54,元大-土城學府,2024-01-18,9822
2303,聯電,77,24,53,元大-土城學府,2024-01-18,9822
3149,正達,51,0,51,元大-土城學府,2024-01-18,9822
0056,元大高股息,45,8,37,元大-土城學府,2024-01-18,9822
00919,群益台灣精選高息,41,7,34,元大-土城學府,2024-01-18,9822
2363,矽統,35,2,33,元大-土城學府,2024-01-18,9822
4402,郡都開發,31,0,31,元大-土城學府,2024-01-18,9822
00882,中信中國高股息,25,0,25,元大-土城學府,2024-01-18,9822
00679B,元大美債20年,25,2,23,元大-土城學府,2024-01-18,9822
2353,宏��,33,12,21,元大-土城學府,2024-01-18,9822
00772B,中信高評級公司債,20,0,20,元大-土城學府,2024-01-18,9822
4906,正文,21,1,20,元大-土城學府,2024-01-18,9822
4960,誠美材,39,19,20,元大-土城學府,2024-01-18,9822
2884,玉山金,19,1,18,元大-土城學府,2024-01-18,9822
2356,英業達,61,45,16,元大-土城學府,2024-01-18,9822
6116,彩晶,35,20,15,元大-土城學府,2024-01-18,9822
2324,仁寶,19,5,14,元大-土城學府,2024-01-18,9822
2371,大同,20,6,14,元大-土城學府,2024-01-18,9822
00927,群益半導體收益,13,0,13,元大-土城學府,2024-01-18,9822
00687B,國泰20年美債,13,0,13,元大-土城學府,2024-01-18,9822
2618,長榮航,29,16,13,元大-土城學府,2024-01-18,9822
3715,定穎投控,12,0,12,元大-土城學府,2024-01-18,9822
6278,台表科,12,0,12,元大-土城學府,2024-01-18,9822
6547,高端疫苗,12,0,12,元大-土城學府,2024-01-18,9822
00935,野村臺灣新科技50,11,0,11,元大-土城學府,2024-01-18,9822
2527,宏璟,11,0,11,元大-土城學府,2024-01-18,9822
2867,三商壽,11,0,11,元大-土城學府,2024-01-18,9822
3576,聯合再生,10,0,10,元大-土城學府,2024-01-18,9822
1326,台化,9,0,9,元大-土城學府,2024-01-18,9822
2329,華泰,20,11,9,元大-土城學府,2024-01-18,9822
00713,元大台灣高息低波,11,3,8,元大-土城學府,2024-01-18,9822
00904,新光臺灣半導體30,8,0,8,元大-土城學府,2024-01-18,9822
1608,華榮,8,0,8,元大-土城學府,2024-01-18,9822
2301,光寶科,11,3,8,元大-土城學府,2024-01-18,9822
2885,元大金,8,0,8,元大-土城學府,2024-01-18,9822
4909,新復興,8,0,8,元大-土城學府,2024-01-18,9822
6124,業強,8,0,8,元大-土城學府,2024-01-18,9822
3037,欣興,10,3,7,元大-土城學府,2024-01-18,9822
2401,凌陽,8,1,7,元大-土城學府,2024-01-18,9822
6185,幃翔,7,0,7,元大-土城學府,2024-01-18,9822
2886,兆豐金,6,0,6,元大-土城學府,2024-01-18,9822
2887,台新金,6,0,6,元大-土城學府,2024-01-18,9822
00937B,群益ESG投等債20,11,5,6,元大-土城學府,2024-01-18,9822
4979,華星光,12,6,6,元大-土城學府,2024-01-18,9822
1102,亞泥,6,0,6,元大-土城學府,2024-01-18,9822
00632R,元大台灣50反1,250,10,240,元大-土城學府,2024-01-19,9822
00706L,期元大S＆P日圓正2,100,0,100,元大-土城學府,2024-01-19,9822
00679B,元大美債20年,85,0,85,元大-土城學府,2024-01-19,9822
00687B,國泰20年美債,73,1,72,元大-土城學府,2024-01-19,9822
2888,新光金,64,0,64,元大-土城學府,2024-01-19,9822
3481,群創,150,90,60,元大-土城學府,2024-01-19,9822
6531,愛普*,49,0,49,元大-土城學府,2024-01-19,9822
00751B,元大AAA至A公司債,45,0,45,元大-土城學府,2024-01-19,9822
00882,中信中國高股息,45,0,45,元大-土城學府,2024-01-19,9822
2603,長榮,40,0,40,元大-土城學府,2024-01-19,9822
00923,群益台ESG低碳50,37,0,37,元大-土城學府,2024-01-19,9822
00902,中信電池及儲能,34,0,34,元大-土城學府,2024-01-19,9822
00720B,元大投資級公司債,33,0,33,元大-土城學府,2024-01-19,9822
1718,中纖,30,0,30,元大-土城學府,2024-01-19,9822
6164,華興,30,0,30,元大-土城學府,2024-01-19,9822
00929,復華台灣科技優息,62,34,28,元大-土城學府,2024-01-19,9822
4303,信立,26,0,26,元大-土城學府,2024-01-19,9822
3490,單井,37,13,24,元大-土城學府,2024-01-19,9822
2609,陽明,37,15,22,元大-土城學府,2024-01-19,9822
1447,力鵬,20,0,20,元大-土城學府,2024-01-19,9822
2349,錸德,19,0,19,元大-土城學府,2024-01-19,9822
2002,中鋼,20,1,19,元大-土城學府,2024-01-19,9822
0056,元大高股息,34,15,19,元大-土城學府,2024-01-19,9822
6125,廣運,21,3,18,元大-土城學府,2024-01-19,9822
6770,力積電,16,0,16,元大-土城學府,2024-01-19,9822
2329,華泰,49,34,15,元大-土城學府,2024-01-19,9822
00937B,群益ESG投等債20,22,7,15,元大-土城學府,2024-01-19,9822
2610,華航,16,1,15,元大-土城學府,2024-01-19,9822
2867,三商壽,15,0,15,元大-土城學府,2024-01-19,9822
2465,麗臺,13,0,13,元大-土城學府,2024-01-19,9822
5488,松普,18,5,13,元大-土城學府,2024-01-19,9822
3587,閎康,15,3,12,元大-土城學府,2024-01-19,9822
00891,中信關鍵半導體,13,1,12,元大-土城學府,2024-01-19,9822
2243,宏旭-KY,12,0,12,元大-土城學府,2024-01-19,9822
6285,啟��,14,2,12,元大-土城學府,2024-01-19,9822
00712,復華富時不動產,11,0,11,元大-土城學府,2024-01-19,9822
1584,精剛,12,1,11,元大-土城學府,2024-01-19,9822
2498,宏達電,11,0,11,元大-土城學府,2024-01-19,9822
2618,長榮航,16,5,11,元大-土城學府,2024-01-19,9822
4746,台耀,23,14,9,元大-土城學府,2024-01-19,9822
5347,世界,11,2,9,元大-土城學府,2024-01-19,9822
2486,一詮,63,55,8,元大-土城學府,2024-01-19,9822
3483,力致,8,0,8,元大-土城學府,2024-01-19,9822
00688L,國泰20年美債正2,8,0,8,元大-土城學府,2024-01-19,9822
8011,台通,8,0,8,元大-土城學府,2024-01-19,9822
00633L,富邦上証正2,10,3,7,元大-土城學府,2024-01-19,9822
2344,華邦電,20,13,7,元大-土城學府,2024-01-19,9822
3025,星通,14,7,7,元大-土城學府,2024-01-19,9822
8034,榮群,27,20,7,元大-土城學府,2024-01-19,9822
2883,凱基金,7,0,7,元大-土城學府,2024-01-19,9822
9105,泰金寶-DR,110,5,105,元大-土城學府,2024-01-22,9822
2369,菱生,81,5,76,元大-土城學府,2024-01-22,9822
00665L,富邦�琤肭磪囓�2,65,0,65,元大-土城學府,2024-01-22,9822
00882,中信中國高股息,40,0,40,元大-土城學府,2024-01-22,9822
00929,復華台灣科技優息,55,21,34,元大-土城學府,2024-01-22,9822
00688L,國泰20年美債正2,33,0,33,元大-土城學府,2024-01-22,9822
2316,楠梓電,25,3,22,元大-土城學府,2024-01-22,9822
4402,郡都開發,21,0,21,元大-土城學府,2024-01-22,9822
9945,潤泰新,19,0,19,元大-土城學府,2024-01-22,9822
2603,長榮,41,23,18,元大-土城學府,2024-01-22,9822
00937B,群益ESG投等債20,17,0,17,元大-土城學府,2024-01-22,9822
00907,永豐優息存股,16,0,16,元大-土城學府,2024-01-22,9822
2103,台橡,16,0,16,元大-土城學府,2024-01-22,9822
6117,迎廣,23,7,16,元大-土城學府,2024-01-22,9822
2329,華泰,49,35,14,元大-土城學府,2024-01-22,9822
6164,華興,14,0,14,元大-土城學府,2024-01-22,9822
00687B,國泰20年美債,13,0,13,元大-土城學府,2024-01-22,9822
00911,兆豐洲際半導體,13,0,13,元大-土城學府,2024-01-22,9822
2211,長榮鋼,13,0,13,元大-土城學府,2024-01-22,9822
2344,華邦電,23,10,13,元大-土城學府,2024-01-22,9822
00902,中信電池及儲能,24,11,13,元大-土城學府,2024-01-22,9822
2002,中鋼,12,0,12,元大-土城學府,2024-01-22,9822
00680L,元大美債20正2,11,0,11,元大-土城學府,2024-01-22,9822
1301,台塑,12,1,11,元大-土城學府,2024-01-22,9822
6120,達運,12,1,11,元大-土城學府,2024-01-22,9822
2317,鴻海,14,4,10,元大-土城學府,2024-01-22,9822
1785,光洋科,10,0,10,元大-土城學府,2024-01-22,9822
2258,鴻華先進-創,10,0,10,元大-土城學府,2024-01-22,9822
5202,力新,10,0,10,元大-土城學府,2024-01-22,9822
6223,旺矽,13,3,10,元大-土城學府,2024-01-22,9822
8069,元太,10,1,9,元大-土城學府,2024-01-22,9822
5871,中租-KY,9,0,9,元大-土城學府,2024-01-22,9822
2313,華通,15,6,9,元大-土城學府,2024-01-22,9822
2314,台揚,9,0,9,元大-土城學府,2024-01-22,9822
5347,世界,9,0,9,元大-土城學府,2024-01-22,9822
2301,光寶科,29,20,9,元大-土城學府,2024-01-22,9822
2312,金寶,13,5,8,元大-土城學府,2024-01-22,9822
3520,華盈,37,29,8,元大-土城學府,2024-01-22,9822
5469,瀚宇博,10,2,8,元大-土城學府,2024-01-22,9822
6139,亞翔,8,0,8,元大-土城學府,2024-01-22,9822
1101,台泥,8,1,7,元大-土城學府,2024-01-22,9822
6530,創威,9,2,7,元大-土城學府,2024-01-22,9822
2308,台達電,7,1,6,元大-土城學府,2024-01-22,9822
00850,元大臺灣ESG永續,7,1,6,元大-土城學府,2024-01-22,9822
00642U,期元大S＆P石油,6,0,6,元大-土城學府,2024-01-22,9822
3147,大綜,11,5,6,元大-土城學府,2024-01-22,9822
2887,台新金,5,0,5,元大-土城學府,2024-01-22,9822
2365,昆盈,6,1,5,元大-土城學府,2024-01-22,9822
2515,中工,5,0,5,元大-土城學府,2024-01-22,9822
2890,永豐金,5,0,5,元大-土城學府,2024-01-22,9822
2329,華泰,58,12,46,元大-土城學府,2024-01-23,9822
00688L,國泰20年美債正2,39,1,38,元大-土城學府,2024-01-23,9822
00919,群益台灣精選高息,36,1,35,元大-土城學府,2024-01-23,9822
4402,郡都開發,32,1,31,元大-土城學府,2024-01-23,9822
2891,中信金,27,1,26,元大-土城學府,2024-01-23,9822
00680L,元大美債20正2,24,2,22,元大-土城學府,2024-01-23,9822
6698,旭暉應材,21,0,21,元大-土城學府,2024-01-23,9822
00937B,群益ESG投等債20,21,0,21,元大-土城學府,2024-01-23,9822
00929,復華台灣科技優息,38,18,20,元大-土城學府,2024-01-23,9822
00632R,元大台灣50反1,18,0,18,元大-土城學府,2024-01-23,9822
2344,華邦電,32,14,18,元大-土城學府,2024-01-23,9822
2618,長榮航,18,2,16,元大-土城學府,2024-01-23,9822
00679B,元大美債20年,16,1,15,元大-土城學府,2024-01-23,9822
2603,長榮,23,9,14,元大-土城學府,2024-01-23,9822
00645,富邦日本,14,0,14,元大-土城學府,2024-01-23,9822
2363,矽統,63,49,14,元大-土城學府,2024-01-23,9822
2605,新興,13,0,13,元大-土城學府,2024-01-23,9822
4953,緯軟,14,1,13,元大-土城學府,2024-01-23,9822
6223,旺矽,12,0,12,元大-土城學府,2024-01-23,9822
2324,仁寶,14,2,12,元大-土城學府,2024-01-23,9822
3548,兆利,13,2,11,元大-土城學府,2024-01-23,9822
2356,英業達,114,103,11,元大-土城學府,2024-01-23,9822
00687B,國泰20年美債,11,0,11,元大-土城學府,2024-01-23,9822
5351,鈺創,24,13,11,元大-土城學府,2024-01-23,9822
6218,豪勉,11,0,11,元大-土城學府,2024-01-23,9822
8096,擎亞,33,22,11,元大-土城學府,2024-01-23,9822
00795B,中信美國公債20年,10,0,10,元大-土城學府,2024-01-23,9822
1447,力鵬,10,0,10,元大-土城學府,2024-01-23,9822
3058,立德,10,0,10,元大-土城學府,2024-01-23,9822
3325,旭品,10,0,10,元大-土城學府,2024-01-23,9822
00713,元大台灣高息低波,10,0,10,元大-土城學府,2024-01-23,9822
8011,台通,9,0,9,元大-土城學府,2024-01-23,9822
00885,富邦越南,8,0,8,元大-土城學府,2024-01-23,9822
00931B,統一美債20年,8,0,8,元大-土城學府,2024-01-23,9822
1785,光洋科,12,4,8,元大-土城學府,2024-01-23,9822
2486,一詮,13,5,8,元大-土城學府,2024-01-23,9822
1524,耿鼎,10,2,8,元大-土城學府,2024-01-23,9822
2609,陽明,26,19,7,元大-土城學府,2024-01-23,9822
00637L,元大滬深300正2,12,5,7,元大-土城學府,2024-01-23,9822
00882,中信中國高股息,7,0,7,元大-土城學府,2024-01-23,9822
1514,亞力,79,74,5,元大-土城學府,2024-01-23,9822
3260,威剛,7,2,5,元大-土城學府,2024-01-23,9822
1815,富喬,5,0,5,元大-土城學府,2024-01-23,9822
2316,楠梓電,7,2,5,元大-土城學府,2024-01-23,9822
3712,永崴投控,5,0,5,元大-土城學府,2024-01-23,9822
4960,誠美材,10,5,5,元大-土城學府,2024-01-23,9822
6108,競國,5,0,5,元大-土城學府,2024-01-23,9822
3017,奇鋐,7,3,4,元大-土城學府,2024-01-23,9822
2362,藍天,6,2,4,元大-土城學府,2024-01-23,9822
2449,京元電子,4,0,4,元大-土城學府,2024-01-23,9822
3481,群創,110,23,87,元大-土城學府,2024-01-24,9822
2484,希華,85,0,85,元大-土城學府,2024-01-24,9822
00919,群益台灣精選高息,93,9,84,元大-土城學府,2024-01-24,9822
2365,昆盈,42,3,39,元大-土城學府,2024-01-24,9822
00679B,元大美債20年,34,0,34,元大-土城學府,2024-01-24,9822
00637L,元大滬深300正2,37,4,33,元大-土城學府,2024-01-24,9822
00929,復華台灣科技優息,83,53,30,元大-土城學府,2024-01-24,9822
1528,恩德,25,0,25,元大-土城學府,2024-01-24,9822
3372,典範,21,0,21,元大-土城學府,2024-01-24,9822
2324,仁寶,19,0,19,元大-土城學府,2024-01-24,9822
2374,佳能,19,2,17,元大-土城學府,2024-01-24,9822
00687B,國泰20年美債,17,1,16,元大-土城學府,2024-01-24,9822
00688L,國泰20年美債正2,15,0,15,元大-土城學府,2024-01-24,9822
00937B,群益ESG投等債20,57,43,14,元大-土城學府,2024-01-24,9822
3673,TPK-KY,15,4,11,元大-土城學府,2024-01-24,9822
3706,神達,13,2,11,元大-土城學府,2024-01-24,9822
3231,緯創,31,21,10,元大-土城學府,2024-01-24,9822
2353,宏��,41,31,10,元大-土城學府,2024-01-24,9822
4743,合一,11,1,10,元大-土城學府,2024-01-24,9822
2258,鴻華先進-創,10,0,10,元大-土城學府,2024-01-24,9822
2495,普安,10,0,10,元大-土城學府,2024-01-24,9822
2867,三商壽,10,0,10,元大-土城學府,2024-01-24,9822
5211,蒙恬,10,0,10,元大-土城學府,2024-01-24,9822
5469,瀚宇博,13,3,10,元大-土城學府,2024-01-24,9822
5426,振發,14,4,10,元大-土城學府,2024-01-24,9822
00915,凱基優選高股息30,10,1,9,元大-土城學府,2024-01-24,9822
3615,安可,26,17,9,元大-土城學府,2024-01-24,9822
9105,泰金寶-DR,10,1,9,元大-土城學府,2024-01-24,9822
3504,揚明光,32,24,8,元大-土城學府,2024-01-24,9822
00665L,富邦�琤肭磪囓�2,38,30,8,元大-土城學府,2024-01-24,9822
2002,中鋼,8,0,8,元大-土城學府,2024-01-24,9822
6446,藥華藥,8,0,8,元大-土城學府,2024-01-24,9822
2408,南亞科,10,2,8,元大-土城學府,2024-01-24,9822
2615,萬海,18,11,7,元大-土城學府,2024-01-24,9822
2421,建準,10,3,7,元大-土城學府,2024-01-24,9822
00922,國泰台灣領袖50,7,0,7,元大-土城學府,2024-01-24,9822
1514,亞力,33,26,7,元大-土城學府,2024-01-24,9822
2409,友達,7,0,7,元大-土城學府,2024-01-24,9822
6753,龍德造船,7,0,7,元大-土城學府,2024-01-24,9822
00935,野村臺灣新科技50,6,0,6,元大-土城學府,2024-01-24,9822
2103,台橡,6,0,6,元大-土城學府,2024-01-24,9822
00720B,元大投資級公司債,6,0,6,元大-土城學府,2024-01-24,9822
3287,廣寰科,10,4,6,元大-土城學府,2024-01-24,9822
4979,華星光,7,1,6,元大-土城學府,2024-01-24,9822
8932,智通*,6,0,6,元大-土城學府,2024-01-24,9822
00751B,元大AAA至A公司債,5,0,5,元大-土城學府,2024-01-24,9822
00712,復華富時不動產,5,0,5,元大-土城學府,2024-01-24,9822
00936,台新永續高息中小,5,0,5,元大-土城學府,2024-01-24,9822
1460,宏遠,5,0,5,元大-土城學府,2024-01-24,9822
2014,中鴻,7,2,5,元大-土城學府,2024-01-24,9822
9105,泰金寶-DR,212,6,206,元大-土城學府,2024-01-25,9822
00706L,期元大S＆P日圓正2,150,0,150,元大-土城學府,2024-01-25,9822
00919,群益台灣精選高息,129,57,72,元大-土城學府,2024-01-25,9822
00673R,期元大S＆P原油反1,51,0,51,元大-土城學府,2024-01-25,9822
00687B,國泰20年美債,45,0,45,元大-土城學府,2024-01-25,9822
3231,緯創,80,36,44,元大-土城學府,2024-01-25,9822
00929,復華台灣科技優息,61,22,39,元大-土城學府,2024-01-25,9822
8105,凌巨,31,0,31,元大-土城學府,2024-01-25,9822
00632R,元大台灣50反1,30,0,30,元大-土城學府,2024-01-25,9822
3413,京鼎,21,1,20,元大-土城學府,2024-01-25,9822
6167,久正,20,0,20,元大-土城學府,2024-01-25,9822
8050,廣積,21,2,19,元大-土城學府,2024-01-25,9822
00937B,群益ESG投等債20,20,5,15,元大-土城學府,2024-01-25,9822
00751B,元大AAA至A公司債,15,0,15,元大-土城學府,2024-01-25,9822
2363,矽統,16,1,15,元大-土城學府,2024-01-25,9822
5351,鈺創,15,0,15,元大-土城學府,2024-01-25,9822
2002,中鋼,14,0,14,元大-土城學府,2024-01-25,9822
2603,長榮,12,0,12,元大-土城學府,2024-01-25,9822
2609,陽明,15,2,13,元大-土城學府,2024-01-25,9822
6547,高端疫苗,12,0,12,元大-土城學府,2024-01-25,9822
2365,昆盈,29,17,12,元大-土城學府,2024-01-25,9822
3520,華盈,17,5,12,元大-土城學府,2024-01-25,9822
2007,燁興,10,0,10,元大-土城學府,2024-01-25,9822
2314,台揚,10,0,10,元大-土城學府,2024-01-25,9822
2332,友訊,10,0,10,元大-土城學府,2024-01-25,9822
2615,萬海,13,3,10,元大-土城學府,2024-01-25,9822
3114,好德,10,0,10,元大-土城學府,2024-01-25,9822
3483,力致,10,0,10,元大-土城學府,2024-01-25,9822
6698,旭暉應材,10,0,10,元大-土城學府,2024-01-25,9822
8933,愛地雅,10,0,10,元大-土城學府,2024-01-25,9822
1514,亞力,14,5,9,元大-土城學府,2024-01-25,9822
4909,新復興,20,11,9,元大-土城學府,2024-01-25,9822
8059,凱碩,21,12,9,元大-土城學府,2024-01-25,9822
2618,長榮航,12,3,9,元大-土城學府,2024-01-25,9822
00639,富邦深100,8,0,8,元大-土城學府,2024-01-25,9822
00637L,元大滬深300正2,21,13,8,元大-土城學府,2024-01-25,9822
5474,聰泰,8,0,8,元大-土城學府,2024-01-25,9822
00902,中信電池及儲能,7,0,7,元大-土城學府,2024-01-25,9822
00688L,國泰20年美債正2,7,0,7,元大-土城學府,2024-01-25,9822
3325,旭品,10,3,7,元大-土城學府,2024-01-25,9822
5426,振發,35,28,7,元大-土城學府,2024-01-25,9822
6405,悅城,8,1,7,元大-土城學府,2024-01-25,9822
00720B,元大投資級公司債,7,1,6,元大-土城學府,2024-01-25,9822
2405,輔信,6,0,6,元大-土城學府,2024-01-25,9822
2867,三商壽,6,0,6,元大-土城學府,2024-01-25,9822
3587,閎康,8,2,6,元大-土城學府,2024-01-25,9822
4188,安克,6,0,6,元大-土城學府,2024-01-25,9822
8054,安國,9,3,6,元大-土城學府,2024-01-25,9822
2421,建準,20,15,5,元大-土城學府,2024-01-25,9822
2376,技嘉,13,8,5,元大-土城學府,2024-01-25,9822
00933B,國泰10Y+金融債,1064,0,1064,元大-土城學府,2024-01-26,9822
9105,泰金寶-DR,232,71,161,元大-土城學府,2024-01-26,9822
3615,安可,148,2,146,元大-土城學府,2024-01-26,9822
2303,聯電,128,10,118,元大-土城學府,2024-01-26,9822
00919,群益台灣精選高息,112,12,100,元大-土城學府,2024-01-26,9822
3481,群創,122,29,93,元大-土城學府,2024-01-26,9822
3360,尚立,94,4,90,元大-土城學府,2024-01-26,9822
2618,長榮航,69,0,69,元大-土城學府,2024-01-26,9822
00929,復華台灣科技優息,63,7,56,元大-土城學府,2024-01-26,9822
00706L,期元大S＆P日圓正2,50,0,50,元大-土城學府,2024-01-26,9822
00665L,富邦�琤肭磪囓�2,57,10,47,元大-土城學府,2024-01-26,9822
6164,華興,46,0,46,元大-土城學府,2024-01-26,9822
1337,再生-KY,34,0,34,元大-土城學府,2024-01-26,9822
2324,仁寶,41,10,31,元大-土城學府,2024-01-26,9822
00637L,元大滬深300正2,32,3,29,元大-土城學府,2024-01-26,9822
1718,中纖,20,0,20,元大-土城學府,2024-01-26,9822
5880,合庫金,20,0,20,元大-土城學府,2024-01-26,9822
8050,廣積,20,0,20,元大-土城學府,2024-01-26,9822
00687B,國泰20年美債,18,0,18,元大-土城學府,2024-01-26,9822
1316,上曜,16,0,16,元大-土城學府,2024-01-26,9822
2637,慧洋-KY,16,0,16,元大-土城學府,2024-01-26,9822
3035,智原,18,2,16,元大-土城學府,2024-01-26,9822
3492,長盛,15,0,15,元大-土城學府,2024-01-26,9822
2421,建準,23,9,14,元大-土城學府,2024-01-26,9822
00632R,元大台灣50反1,13,0,13,元大-土城學府,2024-01-26,9822
8034,榮群,12,0,12,元大-土城學府,2024-01-26,9822
2356,英業達,81,69,12,元大-土城學府,2024-01-26,9822
00915,凱基優選高股息30,11,0,11,元大-土城學府,2024-01-26,9822
6270,倍微,30,19,11,元大-土城學府,2024-01-26,9822
3548,兆利,12,2,10,元大-土城學府,2024-01-26,9822
00772B,中信高評級公司債,10,0,10,元大-土城學府,2024-01-26,9822
00753L,中信中國50正2,10,0,10,元大-土城學府,2024-01-26,9822
00673R,期元大S＆P原油反1,12,2,10,元大-土城學府,2024-01-26,9822
5351,鈺創,10,0,10,元大-土城學府,2024-01-26,9822
6133,金橋,10,0,10,元大-土城學府,2024-01-26,9822
2417,圓剛,26,17,9,元大-土城學府,2024-01-26,9822
6282,康舒,11,3,8,元大-土城學府,2024-01-26,9822
00927,群益半導體收益,8,0,8,元大-土城學府,2024-01-26,9822
2314,台揚,8,0,8,元大-土城學府,2024-01-26,9822
3694,海華,23,15,8,元大-土城學府,2024-01-26,9822
0056,元大高股息,8,0,8,元大-土城學府,2024-01-26,9822
00918,大華優利高填息30,8,0,8,元大-土城學府,2024-01-26,9822
5426,振發,83,76,7,元大-土城學府,2024-01-26,9822
00937B,群益ESG投等債20,9,2,7,元大-土城學府,2024-01-26,9822
2344,華邦電,26,19,7,元大-土城學府,2024-01-26,9822
6113,亞矽,11,4,7,元大-土城學府,2024-01-26,9822
2301,光寶科,8,2,6,元大-土城學府,2024-01-26,9822
2465,麗臺,6,0,6,元大-土城學府,2024-01-26,9822
3312,弘憶股,11,5,6,元大-土城學府,2024-01-26,9822
3518,柏騰,6,0,6,元大-土城學府,2024-01-26,9822
00632R,元大台灣50反1,538,0,538,元大-土城學府,2024-01-29,9822
00937B,群益ESG投等債20,92,0,92,元大-土城學府,2024-01-29,9822
9105,泰金寶-DR,100,8,92,元大-土城學府,2024-01-29,9822
00929,復華台灣科技優息,56,1,55,元大-土城學府,2024-01-29,9822
00706L,期元大S＆P日圓正2,50,0,50,元大-土城學府,2024-01-29,9822
00665L,富邦�琤肭磪囓�2,53,7,46,元大-土城學府,2024-01-29,9822
00933B,國泰10Y+金融債,36,0,36,元大-土城學府,2024-01-29,9822
00687B,國泰20年美債,33,2,31,元大-土城學府,2024-01-29,9822
00679B,元大美債20年,30,0,30,元大-土城學府,2024-01-29,9822
00680L,元大美債20正2,23,0,23,元大-土城學府,2024-01-29,9822
00882,中信中國高股息,15,1,14,元大-土城學府,2024-01-29,9822
2351,順德,12,0,12,元大-土城學府,2024-01-29,9822
00934,中信成長高股息,13,2,11,元大-土城學府,2024-01-29,9822
0056,元大高股息,19,8,11,元大-土城學府,2024-01-29,9822
00673R,期元大S＆P原油反1,11,0,11,元大-土城學府,2024-01-29,9822
00633L,富邦上証正2,11,0,11,元大-土城學府,2024-01-29,9822
8071,能率網通,23,12,11,元大-土城學府,2024-01-29,9822
1718,中纖,10,0,10,元大-土城學府,2024-01-29,9822
4968,立積,12,2,10,元大-土城學府,2024-01-29,9822
2303,聯電,23,13,10,元大-土城學府,2024-01-29,9822
1326,台化,9,0,9,元大-土城學府,2024-01-29,9822
2356,英業達,56,47,9,元大-土城學府,2024-01-29,9822
2888,新光金,9,0,9,元大-土城學府,2024-01-29,9822
00720B,元大投資級公司債,10,1,9,元大-土城學府,2024-01-29,9822
00751B,元大AAA至A公司債,9,0,9,元大-土城學府,2024-01-29,9822
2867,三商壽,8,0,8,元大-土城學府,2024-01-29,9822
2337,旺宏,11,4,7,元大-土城學府,2024-01-29,9822
2440,太空梭,7,0,7,元大-土城學府,2024-01-29,9822
2633,台灣高鐵,7,0,7,元大-土城學府,2024-01-29,9822
8091,翔名,7,0,7,元大-土城學府,2024-01-29,9822
00931B,統一美債20年,6,0,6,元大-土城學府,2024-01-29,9822
2363,矽統,9,4,5,元大-土城學府,2024-01-29,9822
00923,群益台ESG低碳50,6,1,5,元大-土城學府,2024-01-29,9822
00637L,元大滬深300正2,18,13,5,元大-土城學府,2024-01-29,9822
2014,中鴻,5,0,5,元大-土城學府,2024-01-29,9822
2409,友達,5,0,5,元大-土城學府,2024-01-29,9822
2439,美律,5,0,5,元大-土城學府,2024-01-29,9822
3024,憶聲,5,0,5,元大-土城學府,2024-01-29,9822
3029,零壹,6,1,5,元大-土城學府,2024-01-29,9822
6177,達麗,5,0,5,元大-土城學府,2024-01-29,9822
00891,中信關鍵半導體,4,0,4,元大-土城學府,2024-01-29,9822
00646,元大S＆P500,4,0,4,元大-土城學府,2024-01-29,9822
00688L,國泰20年美債正2,4,0,4,元大-土城學府,2024-01-29,9822
2520,冠德,4,0,4,元大-土城學府,2024-01-29,9822
3041,揚智,6,2,4,元大-土城學府,2024-01-29,9822
3490,單井,4,0,4,元大-土城學府,2024-01-29,9822
3623,富晶通,5,1,4,元大-土城學府,2024-01-29,9822
6117,迎廣,5,1,4,元大-土城學府,2024-01-29,9822
6126,信音,4,0,4,元大-土城學府,2024-01-29,9822
8936,國統,8,4,4,元大-土城學府,2024-01-29,9822
00665L,富邦�琤肭磪囓�2,81,0,81,元大-土城學府,2024-01-30,9822
00687B,國泰20年美債,60,0,60,元大-土城學府,2024-01-30,9822
6125,廣運,54,7,47,元大-土城學府,2024-01-30,9822
00753L,中信中國50正2,32,0,32,元大-土城學府,2024-01-30,9822
2002,中鋼,32,1,31,元大-土城學府,2024-01-30,9822
2886,兆豐金,24,0,24,元大-土城學府,2024-01-30,9822
2421,建準,44,20,24,元大-土城學府,2024-01-30,9822
3024,憶聲,20,0,20,元大-土城學府,2024-01-30,9822
4303,信立,20,0,20,元大-土城學府,2024-01-30,9822
00715L,期街口布蘭特正2,19,0,19,元大-土城學府,2024-01-30,9822
00900,富邦特選高股息30,19,2,17,元大-土城學府,2024-01-30,9822
6789,采鈺,23,6,17,元大-土城學府,2024-01-30,9822
00882,中信中國高股息,16,0,16,元大-土城學府,2024-01-30,9822
3297,杭特,18,2,16,元大-土城學府,2024-01-30,9822
00680L,元大美債20正2,15,0,15,元大-土城學府,2024-01-30,9822
00933B,國泰10Y+金融債,15,0,15,元大-土城學府,2024-01-30,9822
2101,南港,15,0,15,元大-土城學府,2024-01-30,9822
00637L,元大滬深300正2,24,10,14,元大-土城學府,2024-01-30,9822
2867,三商壽,23,10,13,元大-土城學府,2024-01-30,9822
2356,英業達,62,49,13,元大-土城學府,2024-01-30,9822
00929,復華台灣科技優息,22,9,13,元大-土城學府,2024-01-30,9822
2324,仁寶,15,3,12,元大-土城學府,2024-01-30,9822
6531,愛普*,12,2,10,元大-土城學府,2024-01-30,9822
00795B,中信美國公債20年,10,0,10,元大-土城學府,2024-01-30,9822
2515,中工,10,0,10,元大-土城學府,2024-01-30,9822
3481,群創,85,76,9,元大-土城學府,2024-01-30,9822
00878,國泰永續高股息,9,0,9,元大-土城學府,2024-01-30,9822
2736,富野,8,0,8,元大-土城學府,2024-01-30,9822
3623,富晶通,11,3,8,元大-土城學府,2024-01-30,9822
6282,康舒,20,12,8,元大-土城學府,2024-01-30,9822
4909,新復興,15,8,7,元大-土城學府,2024-01-30,9822
00892,富邦台灣半導體,6,0,6,元大-土城學府,2024-01-30,9822
00646,元大S＆P500,7,1,6,元大-土城學府,2024-01-30,9822
2453,凌群,7,1,6,元大-土城學府,2024-01-30,9822
3338,泰碩,20,14,6,元大-土城學府,2024-01-30,9822
6547,高端疫苗,6,0,6,元大-土城學府,2024-01-30,9822
8227,巨有科技,35,29,6,元大-土城學府,2024-01-30,9822
8996,高力,6,0,6,元大-土城學府,2024-01-30,9822
00688L,國泰20年美債正2,5,0,5,元大-土城學府,2024-01-30,9822
00934,中信成長高股息,6,1,5,元大-土城學府,2024-01-30,9822
1309,台達化,5,0,5,元大-土城學府,2024-01-30,9822
2337,旺宏,7,2,5,元大-土城學府,2024-01-30,9822
2374,佳能,5,0,5,元大-土城學府,2024-01-30,9822
2406,國碩,7,2,5,元大-土城學府,2024-01-30,9822
3437,榮創,6,1,5,元大-土城學府,2024-01-30,9822
3702,大聯大,7,2,5,元大-土城學府,2024-01-30,9822
4167,松瑞藥,5,0,5,元大-土城學府,2024-01-30,9822
8064,東捷,9,4,5,元大-土城學府,2024-01-30,9822
8072,陞泰,5,0,5,元大-土城學府,2024-01-30,9822
1513,中興電,8,3,5,元大-土城學府,2024-01-30,9822
00919,群益台灣精選高息,111,10,101,元大-土城學府,2024-01-31,9822
8936,國統,75,8,67,元大-土城學府,2024-01-31,9822
3481,群創,123,78,45,元大-土城學府,2024-01-31,9822
3231,緯創,49,9,40,元大-土城學府,2024-01-31,9822
00929,復華台灣科技優息,44,7,37,元大-土城學府,2024-01-31,9822
4908,前鼎,47,12,35,元大-土城學府,2024-01-31,9822
00687B,國泰20年美債,34,0,34,元大-土城學府,2024-01-31,9822
2356,英業達,49,23,26,元大-土城學府,2024-01-31,9822
1528,恩德,25,0,25,元大-土城學府,2024-01-31,9822
2365,昆盈,40,18,22,元大-土城學府,2024-01-31,9822
8096,擎亞,24,2,22,元大-土城學府,2024-01-31,9822
2330,台積電,25,4,21,元大-土城學府,2024-01-31,9822
00688L,國泰20年美債正2,21,0,21,元大-土城學府,2024-01-31,9822
00934,中信成長高股息,21,0,21,元大-土城學府,2024-01-31,9822
2884,玉山金,21,0,21,元大-土城學府,2024-01-31,9822
2303,聯電,49,30,19,元大-土城學府,2024-01-31,9822
2886,兆豐金,20,4,16,元大-土城學府,2024-01-31,9822
2618,長榮航,18,2,16,元大-土城學府,2024-01-31,9822
4960,誠美材,17,2,15,元大-土城學府,2024-01-31,9822
00933B,國泰10Y+金融債,15,0,15,元大-土城學府,2024-01-31,9822
2609,陽明,24,9,15,元大-土城學府,2024-01-31,9822
2353,宏��,23,9,14,元大-土城學府,2024-01-31,9822
6695,芯鼎,26,12,14,元大-土城學府,2024-01-31,9822
1101,台泥,13,0,13,元大-土城學府,2024-01-31,9822
2363,矽統,12,0,12,元大-土城學府,2024-01-31,9822
3114,好德,11,0,11,元大-土城學府,2024-01-31,9822
6770,力積電,11,0,11,元大-土城學府,2024-01-31,9822
00713,元大台灣高息低波,10,0,10,元大-土城學府,2024-01-31,9822
00669R,國泰美國道瓊反1,10,0,10,元大-土城學府,2024-01-31,9822
1711,永光,10,0,10,元大-土城學府,2024-01-31,9822
2408,南亞科,10,0,10,元大-土城學府,2024-01-31,9822
2427,三商電,10,0,10,元大-土城學府,2024-01-31,9822
00882,中信中國高股息,9,0,9,元大-土城學府,2024-01-31,9822
3704,合勤控,9,0,9,元大-土城學府,2024-01-31,9822
00680L,元大美債20正2,10,2,8,元大-土城學府,2024-01-31,9822
3041,揚智,12,4,8,元大-土城學府,2024-01-31,9822
2891,中信金,8,0,8,元大-土城學府,2024-01-31,9822
6789,采鈺,8,0,8,元大-土城學府,2024-01-31,9822
6116,彩晶,10,3,7,元大-土城學府,2024-01-31,9822
00665L,富邦�琤肭磪囓�2,15,8,7,元大-土城學府,2024-01-31,9822
2867,三商壽,20,13,7,元大-土城學府,2024-01-31,9822
4133,亞諾法,10,3,7,元大-土城學府,2024-01-31,9822
00679B,元大美債20年,6,0,6,元大-土城學府,2024-01-31,9822
00642U,期元大S＆P石油,6,0,6,元大-土城學府,2024-01-31,9822
00720B,元大投資級公司債,8,2,6,元大-土城學府,2024-01-31,9822
2465,麗臺,7,1,6,元大-土城學府,2024-01-31,9822
3707,漢磊,6,0,6,元大-土城學府,2024-01-31,9822
4402,郡都開發,6,0,6,元大-土城學府,2024-01-31,9822
6869,雲豹能源,6,0,6,元大-土城學府,2024-01-31,9822
2106,建大,5,0,5,元大-土城學府,2024-01-31,9822
00655L,國泰中國A50正2,910,0,910,元大-土城學府,2024-02-01,9822
00937B,群益ESG投等債20,129,4,125,元大-土城學府,2024-02-01,9822
2867,三商壽,66,0,66,元大-土城學府,2024-02-01,9822
00927,群益半導體收益,53,0,53,元大-土城學府,2024-02-01,9822
8936,國統,111,71,40,元大-土城學府,2024-02-01,9822
00712,復華富時不動產,33,0,33,元大-土城學府,2024-02-01,9822
6667,信紘科,32,1,31,元大-土城學府,2024-02-01,9822
2812,台中銀,43,16,27,元大-土城學府,2024-02-01,9822
00878,國泰永續高股息,30,3,27,元大-土城學府,2024-02-01,9822
2356,英業達,52,26,26,元大-土城學府,2024-02-01,9822
00687B,國泰20年美債,26,0,26,元大-土城學府,2024-02-01,9822
2883,凱基金,26,2,24,元大-土城學府,2024-02-01,9822
3437,榮創,24,0,24,元大-土城學府,2024-02-01,9822
3481,群創,29,9,20,元大-土城學府,2024-02-01,9822
6442,光聖,23,3,20,元大-土城學府,2024-02-01,9822
00929,復華台灣科技優息,27,8,19,元大-土城學府,2024-02-01,9822
00882,中信中國高股息,18,1,17,元大-土城學府,2024-02-01,9822
3492,長盛,15,0,15,元大-土城學府,2024-02-01,9822
8096,擎亞,16,1,15,元大-土城學府,2024-02-01,9822
2409,友達,15,1,14,元大-土城學府,2024-02-01,9822
00923,群益台ESG低碳50,18,5,13,元大-土城學府,2024-02-01,9822
6245,立端,15,2,13,元大-土城學府,2024-02-01,9822
8011,台通,13,0,13,元大-土城學府,2024-02-01,9822
3520,華盈,25,14,11,元大-土城學府,2024-02-01,9822
2362,藍天,10,0,10,元大-土城學府,2024-02-01,9822
2886,兆豐金,10,0,10,元大-土城學府,2024-02-01,9822
3202,樺晟,10,0,10,元大-土城學府,2024-02-01,9822
8930,青鋼,10,0,10,元大-土城學府,2024-02-01,9822
2303,聯電,85,76,9,元大-土城學府,2024-02-01,9822
2382,廣達,13,4,9,元大-土城學府,2024-02-01,9822
3035,智原,15,7,8,元大-土城學府,2024-02-01,9822
3704,合勤控,8,0,8,元大-土城學府,2024-02-01,9822
00713,元大台灣高息低波,10,2,8,元大-土城學府,2024-02-01,9822
00900,富邦特選高股息30,132,124,8,元大-土城學府,2024-02-01,9822
9105,泰金寶-DR,8,0,8,元大-土城學府,2024-02-01,9822
00633L,富邦上証正2,7,0,7,元大-土城學府,2024-02-01,9822
6456,GIS-KY,7,0,7,元大-土城學府,2024-02-01,9822
2258,鴻華先進-創,6,0,6,元大-土城學府,2024-02-01,9822
6113,亞矽,18,12,6,元大-土城學府,2024-02-01,9822
8040,九暘,10,4,6,元大-土城學府,2024-02-01,9822
8059,凱碩,6,0,6,元大-土城學府,2024-02-01,9822
8105,凌巨,10,4,6,元大-土城學府,2024-02-01,9822
3711,日月光投控,6,0,6,元大-土城學府,2024-02-01,9822
00919,群益台灣精選高息,6,1,5,元大-土城學府,2024-02-01,9822
5426,振發,8,3,5,元大-土城學府,2024-02-01,9822
6770,力積電,6,1,5,元大-土城學府,2024-02-01,9822
1524,耿鼎,8,3,5,元大-土城學府,2024-02-01,9822
2641,正德,5,0,5,元大-土城學府,2024-02-01,9822
2301,光寶科,5,0,5,元大-土城學府,2024-02-01,9822
6243,迅杰,36,32,4,元大-土城學府,2024-02-01,9822
00688L,國泰20年美債正2,119,10,109,元大-土城學府,2024-02-02,9822
2329,華泰,65,14,51,元大-土城學府,2024-02-02,9822
00878,國泰永續高股息,50,13,37,元大-土城學府,2024-02-02,9822
00933B,國泰10Y+金融債,35,0,35,元大-土城學府,2024-02-02,9822
00665L,富邦�琤肭磪囓�2,40,7,33,元大-土城學府,2024-02-02,9822
6126,信音,33,0,33,元大-土城學府,2024-02-02,9822
2812,台中銀,42,10,32,元大-土城學府,2024-02-02,9822
2303,聯電,34,3,31,元大-土城學府,2024-02-02,9822
6667,信紘科,31,1,30,元大-土城學府,2024-02-02,9822
00935,野村臺灣新科技50,32,3,29,元大-土城學府,2024-02-02,9822
6113,亞矽,50,22,28,元大-土城學府,2024-02-02,9822
2356,英業達,79,52,27,元大-土城學府,2024-02-02,9822
2603,長榮,36,9,27,元大-土城學府,2024-02-02,9822
00679B,元大美債20年,29,3,26,元大-土城學府,2024-02-02,9822
00637L,元大滬深300正2,25,0,25,元大-土城學府,2024-02-02,9822
5608,四維航,25,2,23,元大-土城學府,2024-02-02,9822
2609,陽明,35,12,23,元大-土城學府,2024-02-02,9822
00715L,期街口布蘭特正2,22,0,22,元大-土城學府,2024-02-02,9822
2498,宏達電,23,1,22,元大-土城學府,2024-02-02,9822
00929,復華台灣科技優息,51,30,21,元大-土城學府,2024-02-02,9822
2891,中信金,21,0,21,元大-土城學府,2024-02-02,9822
3483,力致,25,4,21,元大-土城學府,2024-02-02,9822
2515,中工,20,0,20,元大-土城學府,2024-02-02,9822
3071,協禧,20,0,20,元大-土城學府,2024-02-02,9822
2363,矽統,18,2,16,元大-土城學府,2024-02-02,9822
2408,南亞科,15,0,15,元大-土城學府,2024-02-02,9822
2313,華通,16,1,15,元大-土城學府,2024-02-02,9822
5009,榮剛,15,0,15,元大-土城學府,2024-02-02,9822
2324,仁寶,16,2,14,元大-土城學府,2024-02-02,9822
2419,仲琦,11,0,11,元大-土城學府,2024-02-02,9822
3230,錦明,11,0,11,元大-土城學府,2024-02-02,9822
6179,亞通,12,1,11,元大-土城學府,2024-02-02,9822
00772B,中信高評級公司債,11,0,11,元大-土城學府,2024-02-02,9822
00712,復華富時不動產,11,0,11,元大-土城學府,2024-02-02,9822
2353,宏��,17,7,10,元大-土城學府,2024-02-02,9822
2328,廣宇,10,0,10,元大-土城學府,2024-02-02,9822
2405,輔信,10,0,10,元大-土城學府,2024-02-02,9822
00773B,中信優先金融債,10,0,10,元大-土城學府,2024-02-02,9822
6550,北極星藥業-KY,10,0,10,元大-土城學府,2024-02-02,9822
3036,文曄,23,13,10,元大-土城學府,2024-02-02,9822
8176,智捷,10,0,10,元大-土城學府,2024-02-02,9822
4741,泓瀚,8,0,8,元大-土城學府,2024-02-02,9822
5521,工信,9,1,8,元大-土城學府,2024-02-02,9822
6456,GIS-KY,8,0,8,元大-土城學府,2024-02-02,9822
3694,海華,8,1,7,元大-土城學府,2024-02-02,9822
1503,士電,8,1,7,元大-土城學府,2024-02-02,9822
3363,上詮,14,8,6,元大-土城學府,2024-02-02,9822
00892,富邦台灣半導體,6,0,6,元大-土城學府,2024-02-02,9822
00919,群益台灣精選高息,22,16,6,元大-土城學府,2024-02-02,9822
2401,凌陽,5,0,5,元大-土城學府,2024-02-02,9822
00929,復華台灣科技優息,116,24,92,元大-土城學府,2024-02-05,9822
00687B,國泰20年美債,64,0,64,元大-土城學府,2024-02-05,9822
00772B,中信高評級公司債,62,0,62,元大-土城學府,2024-02-05,9822
00753L,中信中國50正2,43,0,43,元大-土城學府,2024-02-05,9822
00715L,期街口布蘭特正2,35,1,34,元大-土城學府,2024-02-05,9822
2609,陽明,41,10,31,元大-土城學府,2024-02-05,9822
00688L,國泰20年美債正2,31,0,31,元大-土城學府,2024-02-05,9822
9105,泰金寶-DR,29,0,29,元大-土城學府,2024-02-05,9822
00679B,元大美債20年,28,0,28,元大-土城學府,2024-02-05,9822
00878,國泰永續高股息,39,13,26,元大-土城學府,2024-02-05,9822
00680L,元大美債20正2,26,1,25,元大-土城學府,2024-02-05,9822
00933B,國泰10Y+金融債,27,5,22,元大-土城學府,2024-02-05,9822
2344,華邦電,25,4,21,元大-土城學府,2024-02-05,9822
00919,群益台灣精選高息,29,9,20,元大-土城學府,2024-02-05,9822
4908,前鼎,20,0,20,元大-土城學府,2024-02-05,9822
2363,矽統,28,9,19,元大-土城學府,2024-02-05,9822
2618,長榮航,29,10,19,元大-土城學府,2024-02-05,9822
2303,聯電,21,2,19,元大-土城學府,2024-02-05,9822
1528,恩德,30,13,17,元大-土城學府,2024-02-05,9822
8011,台通,23,6,17,元大-土城學府,2024-02-05,9822
5351,鈺創,16,0,16,元大-土城學府,2024-02-05,9822
2884,玉山金,35,20,15,元大-土城學府,2024-02-05,9822
2429,銘旺科,12,0,12,元大-土城學府,2024-02-05,9822
1718,中纖,11,0,11,元大-土城學府,2024-02-05,9822
3530,晶相光,13,3,10,元大-土城學府,2024-02-05,9822
00675L,富邦臺灣加權正2,10,0,10,元大-土城學府,2024-02-05,9822
00712,復華富時不動產,10,0,10,元大-土城學府,2024-02-05,9822
00894,中信小資高價30,10,0,10,元大-土城學府,2024-02-05,9822
2402,毅嘉,10,0,10,元大-土城學府,2024-02-05,9822
2515,中工,10,0,10,元大-土城學府,2024-02-05,9822
3338,泰碩,10,0,10,元大-土城學府,2024-02-05,9822
6125,廣運,10,0,10,元大-土城學府,2024-02-05,9822
6223,旺矽,10,0,10,元大-土城學府,2024-02-05,9822
3325,旭品,10,1,9,元大-土城學府,2024-02-05,9822
2388,威盛,16,8,8,元大-土城學府,2024-02-05,9822
6451,訊芯-KY,9,1,8,元大-土城學府,2024-02-05,9822
00882,中信中國高股息,7,0,7,元大-土城學府,2024-02-05,9822
2887,台新金,8,1,7,元大-土城學府,2024-02-05,9822
2886,兆豐金,10,3,7,元大-土城學府,2024-02-05,9822
4108,懷特,7,0,7,元大-土城學府,2024-02-05,9822
8091,翔名,7,0,7,元大-土城學府,2024-02-05,9822
00795B,中信美國公債20年,17,10,7,元大-土城學府,2024-02-05,9822
3376,新日興,19,13,6,元大-土城學府,2024-02-05,9822
5608,四維航,6,0,6,元大-土城學府,2024-02-05,9822
00751B,元大AAA至A公司債,6,0,6,元大-土城學府,2024-02-05,9822
00857B,永豐20年美公債,6,0,6,元大-土城學府,2024-02-05,9822
2385,群光,6,0,6,元大-土城學府,2024-02-05,9822
3339,泰谷,6,0,6,元大-土城學府,2024-02-05,9822
3625,西勝,6,0,6,元大-土城學府,2024-02-05,9822
5269,祥碩,6,0,6,元大-土城學府,2024-02-05,9822
00632R,元大台灣50反1,694,100,594,元大-土城學府,2024-02-15,9822
9105,泰金寶-DR,300,1,299,元大-土城學府,2024-02-15,9822
00712,復華富時不動產,110,11,99,元大-土城學府,2024-02-15,9822
00937B,群益ESG投等債20,69,0,69,元大-土城學府,2024-02-15,9822
00665L,富邦�琤肭磪囓�2,80,15,65,元大-土城學府,2024-02-15,9822
00772B,中信高評級公司債,54,0,54,元大-土城學府,2024-02-15,9822
00687B,國泰20年美債,54,0,54,元大-土城學府,2024-02-15,9822
2883,凱基金,71,18,53,元大-土城學府,2024-02-15,9822
00680L,元大美債20正2,48,2,46,元大-土城學府,2024-02-15,9822
2618,長榮航,43,9,34,元大-土城學府,2024-02-15,9822
00688L,國泰20年美債正2,33,0,33,元大-土城學府,2024-02-15,9822
00720B,元大投資級公司債,30,0,30,元大-土城學府,2024-02-15,9822
00679B,元大美債20年,51,21,30,元大-土城學府,2024-02-15,9822
4906,正文,39,10,29,元大-土城學府,2024-02-15,9822
1522,堤維西,30,2,28,元大-土城學府,2024-02-15,9822
4714,永捷,43,17,26,元大-土城學府,2024-02-15,9822
5347,世界,26,0,26,元大-土城學府,2024-02-15,9822
00931B,統一美債20年,25,0,25,元大-土城學府,2024-02-15,9822
00751B,元大AAA至A公司債,22,0,22,元大-土城學府,2024-02-15,9822
2603,長榮,28,10,18,元大-土城學府,2024-02-15,9822
00919,群益台灣精選高息,47,28,19,元大-土城學府,2024-02-15,9822
00637L,元大滬深300正2,45,28,17,元大-土城學府,2024-02-15,9822
2301,光寶科,18,3,15,元大-土城學府,2024-02-15,9822
4956,光鋐,16,1,15,元大-土城學府,2024-02-15,9822
2332,友訊,14,0,14,元大-土城學府,2024-02-15,9822
3288,點晶,14,0,14,元大-土城學府,2024-02-15,9822
2408,南亞科,14,0,14,元大-土城學府,2024-02-15,9822
2344,華邦電,33,20,13,元大-土城學府,2024-02-15,9822
00933B,國泰10Y+金融債,13,0,13,元大-土城學府,2024-02-15,9822
00795B,中信美國公債20年,22,10,12,元大-土城學府,2024-02-15,9822
00882,中信中國高股息,13,1,12,元大-土城學府,2024-02-15,9822
8442,威宏-KY,12,0,12,元大-土城學府,2024-02-15,9822
2609,陽明,39,28,11,元大-土城學府,2024-02-15,9822
00773B,中信優先金融債,11,0,11,元大-土城學府,2024-02-15,9822
2897,王道銀行,15,4,11,元大-土城學府,2024-02-15,9822
6165,浪凡,11,0,11,元大-土城學府,2024-02-15,9822
2886,兆豐金,11,1,10,元大-土城學府,2024-02-15,9822
6269,台郡,10,0,10,元大-土城學府,2024-02-15,9822
2610,華航,14,4,10,元大-土城學府,2024-02-15,9822
2328,廣宇,10,0,10,元大-土城學府,2024-02-15,9822
2419,仲琦,10,0,10,元大-土城學府,2024-02-15,9822
3325,旭品,10,0,10,元大-土城學府,2024-02-15,9822
3380,明泰,10,0,10,元大-土城學府,2024-02-15,9822
6179,亞通,10,0,10,元大-土城學府,2024-02-15,9822
2421,建準,30,21,9,元大-土城學府,2024-02-15,9822
00891,中信關鍵半導體,14,6,8,元大-土城學府,2024-02-15,9822
1432,大魯閣,8,0,8,元大-土城學府,2024-02-15,9822
00900,富邦特選高股息30,10,3,7,元大-土城學府,2024-02-15,9822
2317,鴻海,7,0,7,元大-土城學府,2024-02-15,9822
2884,玉山金,8,1,7,元大-土城學府,2024-02-15,9822
00937B,群益ESG投等債20,200,0,200,元大-土城學府,2024-02-16,9822
00687B,國泰20年美債,62,0,62,元大-土城學府,2024-02-16,9822
2101,南港,56,0,56,元大-土城學府,2024-02-16,9822
00680L,元大美債20正2,51,0,51,元大-土城學府,2024-02-16,9822
2365,昆盈,97,47,50,元大-土城學府,2024-02-16,9822
00679B,元大美債20年,49,1,48,元大-土城學府,2024-02-16,9822
3321,同泰,50,3,47,元大-土城學府,2024-02-16,9822
2382,廣達,65,20,45,元大-土城學府,2024-02-16,9822
00795B,中信美國公債20年,37,0,37,元大-土城學府,2024-02-16,9822
1307,三芳,36,0,36,元大-土城學府,2024-02-16,9822
4908,前鼎,45,13,32,元大-土城學府,2024-02-16,9822
00931B,統一美債20年,31,0,31,元大-土城學府,2024-02-16,9822
00857B,永豐20年美公債,27,0,27,元大-土城學府,2024-02-16,9822
00878,國泰永續高股息,40,14,26,元大-土城學府,2024-02-16,9822
2352,佳世達,29,3,26,元大-土城學府,2024-02-16,9822
1612,宏泰,20,0,20,元大-土城學府,2024-02-16,9822
00933B,國泰10Y+金融債,19,0,19,元大-土城學府,2024-02-16,9822
00720B,元大投資級公司債,18,0,18,元大-土城學府,2024-02-16,9822
00919,群益台灣精選高息,33,16,17,元大-土城學府,2024-02-16,9822
5880,合庫金,17,0,17,元大-土城學府,2024-02-16,9822
3035,智原,21,4,17,元大-土城學府,2024-02-16,9822
2302,麗正,16,0,16,元大-土城學府,2024-02-16,9822
3481,群創,24,9,15,元大-土城學府,2024-02-16,9822
3003,健和興,16,1,15,元大-土城學府,2024-02-16,9822
00632R,元大台灣50反1,16,2,14,元大-土城學府,2024-02-16,9822
3056,富華新,13,0,13,元大-土城學府,2024-02-16,9822
2303,聯電,13,0,13,元大-土城學府,2024-02-16,9822
00772B,中信高評級公司債,13,0,13,元大-土城學府,2024-02-16,9822
1815,富喬,20,7,13,元大-土城學府,2024-02-16,9822
8096,擎亞,21,8,13,元大-土城學府,2024-02-16,9822
3583,辛耘,12,0,12,元大-土城學府,2024-02-16,9822
3027,盛達,11,0,11,元大-土城學府,2024-02-16,9822
00907,永豐優息存股,10,0,10,元大-土城學府,2024-02-16,9822
5701,劍湖山,10,0,10,元大-土城學府,2024-02-16,9822
6139,亞翔,12,2,10,元大-土城學府,2024-02-16,9822
8059,凱碩,18,8,10,元大-土城學府,2024-02-16,9822
6531,愛普*,11,2,9,元大-土城學府,2024-02-16,9822
2317,鴻海,8,0,8,元大-土城學府,2024-02-16,9822
00891,中信關鍵半導體,13,5,8,元大-土城學府,2024-02-16,9822
1316,上曜,11,3,8,元大-土城學府,2024-02-16,9822
1536,和大,8,0,8,元大-土城學府,2024-02-16,9822
5289,宜鼎,8,0,8,元大-土城學府,2024-02-16,9822
5351,鈺創,10,2,8,元大-土城學府,2024-02-16,9822
2002,中鋼,10,2,8,元大-土城學府,2024-02-16,9822
2492,華新科,9,2,7,元大-土城學府,2024-02-16,9822
2884,玉山金,7,0,7,元大-土城學府,2024-02-16,9822
8034,榮群,17,10,7,元大-土城學府,2024-02-16,9822
2371,大同,7,1,6,元大-土城學府,2024-02-16,9822
00641R,富邦日本反1,6,0,6,元大-土城學府,2024-02-16,9822
00913,兆豐台灣晶圓製造,6,0,6,元大-土城學府,2024-02-16,9822
3481,群創,242,64,178,元大-土城學府,2024-02-19,9822
2506,太設,90,4,86,元大-土城學府,2024-02-19,9822
8936,國統,93,13,80,元大-土城學府,2024-02-19,9822
00687B,國泰20年美債,67,6,61,元大-土城學府,2024-02-19,9822
2408,南亞科,62,4,58,元大-土城學府,2024-02-19,9822
2427,三商電,55,1,54,元大-土城學府,2024-02-19,9822
00673R,期元大S＆P原油反1,53,0,53,元大-土城學府,2024-02-19,9822
00929,復華台灣科技優息,68,20,48,元大-土城學府,2024-02-19,9822
00933B,國泰10Y+金融債,48,0,48,元大-土城學府,2024-02-19,9822
00919,群益台灣精選高息,40,6,34,元大-土城學府,2024-02-19,9822
00878,國泰永續高股息,62,31,31,元大-土城學府,2024-02-19,9822
2353,宏��,84,55,29,元大-土城學府,2024-02-19,9822
00937B,群益ESG投等債20,50,21,29,元大-土城學府,2024-02-19,9822
3231,緯創,42,14,28,元大-土城學府,2024-02-19,9822
8039,台虹,28,0,28,元大-土城學府,2024-02-19,9822
2356,英業達,70,43,27,元大-土城學府,2024-02-19,9822
1503,士電,33,8,25,元大-土城學府,2024-02-19,9822
1432,大魯閣,25,0,25,元大-土城學府,2024-02-19,9822
00679B,元大美債20年,25,0,25,元大-土城學府,2024-02-19,9822
5701,劍湖山,23,0,23,元大-土城學府,2024-02-19,9822
4939,亞電,22,0,22,元大-土城學府,2024-02-19,9822
00632R,元大台灣50反1,20,0,20,元大-土城學府,2024-02-19,9822
00650L,復華香港正2,19,0,19,元大-土城學府,2024-02-19,9822
00751B,元大AAA至A公司債,18,0,18,元大-土城學府,2024-02-19,9822
1307,三芳,18,0,18,元大-土城學府,2024-02-19,9822
00680L,元大美債20正2,21,4,17,元大-土城學府,2024-02-19,9822
2344,華邦電,47,31,16,元大-土城學府,2024-02-19,9822
6275,元山,16,0,16,元大-土城學府,2024-02-19,9822
2038,海光,15,0,15,元大-土城學府,2024-02-19,9822
1810,和成,14,0,14,元大-土城學府,2024-02-19,9822
2476,鉅祥,14,0,14,元大-土城學府,2024-02-19,9822
3380,明泰,15,1,14,元大-土城學府,2024-02-19,9822
6113,亞矽,19,5,14,元大-土城學府,2024-02-19,9822
2618,長榮航,17,3,14,元大-土城學府,2024-02-19,9822
2369,菱生,45,32,13,元大-土城學府,2024-02-19,9822
00720B,元大投資級公司債,13,0,13,元大-土城學府,2024-02-19,9822
3548,兆利,16,3,13,元大-土城學府,2024-02-19,9822
00795B,中信美國公債20年,12,0,12,元大-土城學府,2024-02-19,9822
6104,創惟,12,0,12,元大-土城學府,2024-02-19,9822
1314,中石化,25,13,12,元大-土城學府,2024-02-19,9822
2515,中工,15,3,12,元大-土城學府,2024-02-19,9822
2472,立隆電,11,0,11,元大-土城學府,2024-02-19,9822
2367,燿華,10,0,10,元大-土城學府,2024-02-19,9822
3673,TPK-KY,12,2,10,元大-土城學府,2024-02-19,9822
2025,千興,10,0,10,元大-土城學府,2024-02-19,9822
2601,益航,10,0,10,元大-土城學府,2024-02-19,9822
3284,太普高,10,0,10,元大-土城學府,2024-02-19,9822
6167,久正,10,0,10,元大-土城學府,2024-02-19,9822
1504,東元,13,3,10,元大-土城學府,2024-02-19,9822
6770,力積電,10,1,9,元大-土城學府,2024-02-19,9822
00632R,元大台灣50反1,110,3,107,元大-土城學府,2024-02-20,9822
00665L,富邦�琤肭磪囓�2,101,0,101,元大-土城學府,2024-02-20,9822
00687B,國泰20年美債,93,0,93,元大-土城學府,2024-02-20,9822
2101,南港,71,0,71,元大-土城學府,2024-02-20,9822
2404,漢唐,68,0,68,元大-土城學府,2024-02-20,9822
00680L,元大美債20正2,59,0,59,元大-土城學府,2024-02-20,9822
6120,達運,56,0,56,元大-土城學府,2024-02-20,9822
2329,華泰,83,28,55,元大-土城學府,2024-02-20,9822
1504,東元,52,3,49,元大-土城學府,2024-02-20,9822
3231,緯創,64,17,47,元大-土城學府,2024-02-20,9822
1432,大魯閣,42,0,42,元大-土城學府,2024-02-20,9822
2884,玉山金,42,0,42,元大-土城學府,2024-02-20,9822
4714,永捷,44,21,23,元大-土城學府,2024-02-20,9822
1517,利奇,22,0,22,元大-土城學府,2024-02-20,9822
00933B,國泰10Y+金融債,22,0,22,元大-土城學府,2024-02-20,9822
00937B,群益ESG投等債20,22,0,22,元大-土城學府,2024-02-20,9822
3481,群創,27,6,21,元大-土城學府,2024-02-20,9822
2887,台新金,20,0,20,元大-土城學府,2024-02-20,9822
8112,至上,22,2,20,元大-土城學府,2024-02-20,9822
8110,華東,25,5,20,元大-土城學府,2024-02-20,9822
5202,力新,19,0,19,元大-土城學府,2024-02-20,9822
1307,三芳,18,0,18,元大-土城學府,2024-02-20,9822
2498,宏達電,18,0,18,元大-土城學府,2024-02-20,9822
8047,星雲,17,0,17,元大-土城學府,2024-02-20,9822
3548,兆利,16,0,16,元大-土城學府,2024-02-20,9822
00878,國泰永續高股息,19,3,16,元大-土城學府,2024-02-20,9822
00673R,期元大S＆P原油反1,15,0,15,元大-土城學府,2024-02-20,9822
00679B,元大美債20年,14,0,14,元大-土城學府,2024-02-20,9822
00891,中信關鍵半導體,13,0,13,元大-土城學府,2024-02-20,9822
1609,大亞,14,1,13,元大-土城學府,2024-02-20,9822
2332,友訊,15,2,13,元大-土城學府,2024-02-20,9822
8011,台通,13,0,13,元大-土城學府,2024-02-20,9822
00929,復華台灣科技優息,33,21,12,元大-土城學府,2024-02-20,9822
3363,上詮,25,13,12,元大-土城學府,2024-02-20,9822
5426,振發,17,5,12,元大-土城學府,2024-02-20,9822
0056,元大高股息,26,15,11,元大-土城學府,2024-02-20,9822
5521,工信,11,0,11,元大-土城學府,2024-02-20,9822
2472,立隆電,10,0,10,元大-土城學府,2024-02-20,9822
6005,群益證,10,0,10,元大-土城學府,2024-02-20,9822
6126,信音,12,3,9,元大-土城學府,2024-02-20,9822
6667,信紘科,10,1,9,元大-土城學府,2024-02-20,9822
2376,技嘉,20,11,9,元大-土城學府,2024-02-20,9822
1503,士電,32,24,8,元大-土城學府,2024-02-20,9822
4961,天鈺,12,4,8,元大-土城學府,2024-02-20,9822
2382,廣達,22,14,8,元大-土城學府,2024-02-20,9822
00637L,元大滬深300正2,9,1,8,元大-土城學府,2024-02-20,9822
00720B,元大投資級公司債,10,2,8,元大-土城學府,2024-02-20,9822
3047,訊舟,11,3,8,元大-土城學府,2024-02-20,9822
3339,泰谷,8,0,8,元大-土城學府,2024-02-20,9822
4960,誠美材,8,0,8,元大-土城學府,2024-02-20,9822
00680L,元大美債20正2,424,0,424,元大-土城學府,2024-02-21,9822
6164,華興,276,16,260,元大-土城學府,2024-02-21,9822
4906,正文,101,5,96,元大-土城學府,2024-02-21,9822
8064,東捷,105,14,91,元大-土城學府,2024-02-21,9822
00919,群益台灣精選高息,117,28,89,元大-土城學府,2024-02-21,9822
2303,聯電,79,3,76,元大-土城學府,2024-02-21,9822
00929,復華台灣科技優息,83,14,69,元大-土城學府,2024-02-21,9822
00878,國泰永續高股息,71,5,66,元大-土城學府,2024-02-21,9822
3481,群創,62,3,59,元大-土城學府,2024-02-21,9822
8936,國統,54,5,49,元大-土城學府,2024-02-21,9822
2489,瑞軒,87,42,45,元大-土城學府,2024-02-21,9822
00712,復華富時不動產,41,1,40,元大-土城學府,2024-02-21,9822
00786B,元大10年IG銀行債,39,0,39,元大-土城學府,2024-02-21,9822
00937B,群益ESG投等債20,34,0,34,元大-土城學府,2024-02-21,9822
00891,中信關鍵半導體,33,2,31,元大-土城學府,2024-02-21,9822
3035,智原,35,6,29,元大-土城學府,2024-02-21,9822
00753L,中信中國50正2,29,0,29,元大-土城學府,2024-02-21,9822
8930,青鋼,26,2,24,元大-土城學府,2024-02-21,9822
4108,懷特,22,0,22,元大-土城學府,2024-02-21,9822
00679B,元大美債20年,21,0,21,元大-土城學府,2024-02-21,9822
1447,力鵬,20,0,20,元大-土城學府,2024-02-21,9822
2722,夏都,20,0,20,元大-土城學府,2024-02-21,9822
1316,上曜,38,19,19,元大-土城學府,2024-02-21,9822
00688L,國泰20年美債正2,18,0,18,元大-土城學府,2024-02-21,9822
00931B,統一美債20年,17,0,17,元大-土城學府,2024-02-21,9822
5443,均豪,34,17,17,元大-土城學府,2024-02-21,9822
8442,威宏-KY,16,0,16,元大-土城學府,2024-02-21,9822
2609,陽明,42,27,15,元大-土城學府,2024-02-21,9822
2332,友訊,14,0,14,元大-土城學府,2024-02-21,9822
3265,台星科,18,4,14,元大-土城學府,2024-02-21,9822
2324,仁寶,15,2,13,元大-土城學府,2024-02-21,9822
9904,寶成,13,0,13,元大-土城學府,2024-02-21,9822
1717,長興,12,1,11,元大-土城學府,2024-02-21,9822
8110,華東,13,2,11,元大-土城學府,2024-02-21,9822
2312,金寶,12,2,10,元大-土城學府,2024-02-21,9822
00675L,富邦臺灣加權正2,10,0,10,元大-土城學府,2024-02-21,9822
3372,典範,12,2,10,元大-土城學府,2024-02-21,9822
8024,佑華,10,0,10,元大-土城學府,2024-02-21,9822
8054,安國,10,0,10,元大-土城學府,2024-02-21,9822
2356,英業達,45,36,9,元大-土城學府,2024-02-21,9822
00933B,國泰10Y+金融債,20,11,9,元大-土城學府,2024-02-21,9822
2301,光寶科,9,1,8,元大-土城學府,2024-02-21,9822
5521,工信,13,5,8,元大-土城學府,2024-02-21,9822
2390,云辰,8,0,8,元大-土城學府,2024-02-21,9822
2431,聯昌,11,3,8,元大-土城學府,2024-02-21,9822
3313,斐成,8,0,8,元大-土城學府,2024-02-21,9822
3704,合勤控,8,0,8,元大-土城學府,2024-02-21,9822
3712,永崴投控,8,0,8,元大-土城學府,2024-02-21,9822
4714,永捷,9,1,8,元大-土城學府,2024-02-21,9822
2352,佳世達,7,0,7,元大-土城學府,2024-02-21,9822
00680L,元大美債20正2,181,0,181,元大-土城學府,2024-02-22,9822
2356,英業達,190,50,140,元大-土城學府,2024-02-22,9822
1455,集盛,241,136,105,元大-土城學府,2024-02-22,9822
3593,力銘,100,0,100,元大-土城學府,2024-02-22,9822
00665L,富邦�琤肭磪囓�2,103,4,99,元大-土城學府,2024-02-22,9822
2489,瑞軒,105,30,75,元大-土城學府,2024-02-22,9822
2303,聯電,90,18,72,元大-土城學府,2024-02-22,9822
00937B,群益ESG投等債20,77,8,69,元大-土城學府,2024-02-22,9822
3231,緯創,93,26,67,元大-土城學府,2024-02-22,9822
6270,倍微,61,2,59,元大-土城學府,2024-02-22,9822
00706L,期元大S＆P日圓正2,50,0,50,元大-土城學府,2024-02-22,9822
1524,耿鼎,47,6,41,元大-土城學府,2024-02-22,9822
2371,大同,50,12,38,元大-土城學府,2024-02-22,9822
3363,上詮,40,7,33,元大-土城學府,2024-02-22,9822
00933B,國泰10Y+金融債,32,2,30,元大-土城學府,2024-02-22,9822
2025,千興,30,0,30,元大-土城學府,2024-02-22,9822
3548,兆利,38,8,30,元大-土城學府,2024-02-22,9822
5426,振發,30,1,29,元大-土城學府,2024-02-22,9822
00687B,國泰20年美債,27,0,27,元大-土城學府,2024-02-22,9822
8936,國統,34,7,27,元大-土城學府,2024-02-22,9822
6164,華興,28,2,26,元大-土城學府,2024-02-22,9822
2618,長榮航,25,2,23,元大-土城學府,2024-02-22,9822
2610,華航,28,6,22,元大-土城學府,2024-02-22,9822
00922,國泰台灣領袖50,20,0,20,元大-土城學府,2024-02-22,9822
2705,六福,20,0,20,元大-土城學府,2024-02-22,9822
3044,健鼎,26,6,20,元大-土城學府,2024-02-22,9822
6117,迎廣,23,3,20,元大-土城學府,2024-02-22,9822
00679B,元大美債20年,34,14,20,元大-土城學府,2024-02-22,9822
00673R,期元大S＆P原油反1,18,0,18,元大-土城學府,2024-02-22,9822
00892,富邦台灣半導體,18,0,18,元大-土城學府,2024-02-22,9822
8358,金居,18,0,18,元大-土城學府,2024-02-22,9822
3031,佰鴻,16,0,16,元大-土城學府,2024-02-22,9822
3390,旭軟,16,0,16,元大-土城學府,2024-02-22,9822
3437,榮創,17,1,16,元大-土城學府,2024-02-22,9822
1608,華榮,15,0,15,元大-土城學府,2024-02-22,9822
2897,王道銀行,15,0,15,元大-土城學府,2024-02-22,9822
6168,宏齊,20,5,15,元大-土城學府,2024-02-22,9822
00891,中信關鍵半導體,17,3,14,元大-土城學府,2024-02-22,9822
1514,亞力,42,29,13,元大-土城學府,2024-02-22,9822
2324,仁寶,20,7,13,元大-土城學府,2024-02-22,9822
2329,華泰,46,33,13,元大-土城學府,2024-02-22,9822
3221,台嘉碩,17,5,12,元大-土城學府,2024-02-22,9822
1307,三芳,11,0,11,元大-土城學府,2024-02-22,9822
1503,士電,36,25,11,元大-土城學府,2024-02-22,9822
3149,正達,11,0,11,元大-土城學府,2024-02-22,9822
4909,新復興,43,32,11,元大-土城學府,2024-02-22,9822
2365,昆盈,12,1,11,元大-土城學府,2024-02-22,9822
00772B,中信高評級公司債,10,0,10,元大-土城學府,2024-02-22,9822
00650L,復華香港正2,10,0,10,元大-土城學府,2024-02-22,9822
1718,中纖,10,0,10,元大-土城學府,2024-02-22,9822
00933B,國泰10Y+金融債,46,0,46,元大-土城學府,2024-02-23,9822
00907,永豐優息存股,41,0,41,元大-土城學府,2024-02-23,9822
1455,集盛,73,35,38,元大-土城學府,2024-02-23,9822
00679B,元大美債20年,43,6,37,元大-土城學府,2024-02-23,9822
00632R,元大台灣50反1,46,10,36,元大-土城學府,2024-02-23,9822
3231,緯創,71,36,35,元大-土城學府,2024-02-23,9822
00706L,期元大S＆P日圓正2,30,0,30,元大-土城學府,2024-02-23,9822
2353,宏��,56,26,30,元大-土城學府,2024-02-23,9822
1717,長興,38,10,28,元大-土城學府,2024-02-23,9822
2363,矽統,28,5,23,元大-土城學府,2024-02-23,9822
00687B,國泰20年美債,22,0,22,元大-土城學府,2024-02-23,9822
3265,台星科,28,7,21,元大-土城學府,2024-02-23,9822
1102,亞泥,20,0,20,元大-土城學府,2024-02-23,9822
3211,順達,20,0,20,元大-土城學府,2024-02-23,9822
3437,榮創,22,2,20,元大-土城學府,2024-02-23,9822
1611,中電,19,0,19,元大-土城學府,2024-02-23,9822
2417,圓剛,20,2,18,元大-土城學府,2024-02-23,9822
2884,玉山金,20,4,16,元大-土城學府,2024-02-23,9822
3576,聯合再生,15,0,15,元大-土城學府,2024-02-23,9822
3041,揚智,23,8,15,元大-土城學府,2024-02-23,9822
5701,劍湖山,15,0,15,元大-土城學府,2024-02-23,9822
2371,大同,29,15,14,元大-土城學府,2024-02-23,9822
1316,上曜,43,29,14,元大-土城學府,2024-02-23,9822
00637L,元大滬深300正2,13,0,13,元大-土城學府,2024-02-23,9822
3034,聯詠,12,0,12,元大-土城學府,2024-02-23,9822
1503,士電,23,11,12,元大-土城學府,2024-02-23,9822
3325,旭品,12,0,12,元大-土城學府,2024-02-23,9822
3380,明泰,12,0,12,元大-土城學府,2024-02-23,9822
00720B,元大投資級公司債,11,0,11,元大-土城學府,2024-02-23,9822
3481,群創,15,5,10,元大-土城學府,2024-02-23,9822
3715,定穎投控,24,14,10,元大-土城學府,2024-02-23,9822
00937B,群益ESG投等債20,16,6,10,元大-土城學府,2024-02-23,9822
2406,國碩,10,0,10,元大-土城學府,2024-02-23,9822
4108,懷特,10,0,10,元大-土城學府,2024-02-23,9822
2014,中鴻,10,0,10,元大-土城學府,2024-02-23,9822
6179,亞通,10,0,10,元大-土城學府,2024-02-23,9822
8059,凱碩,10,1,9,元大-土城學府,2024-02-23,9822
00918,大華優利高填息30,12,3,9,元大-土城學府,2024-02-23,9822
3705,永信,9,0,9,元大-土城學府,2024-02-23,9822
6282,康舒,9,0,9,元大-土城學府,2024-02-23,9822
00922,國泰台灣領袖50,9,0,9,元大-土城學府,2024-02-23,9822
2376,技嘉,18,10,8,元大-土城學府,2024-02-23,9822
2355,敬鵬,20,12,8,元大-土城學府,2024-02-23,9822
6770,力積電,8,0,8,元大-土城學府,2024-02-23,9822
2498,宏達電,10,2,8,元大-土城學府,2024-02-23,9822
1524,耿鼎,8,0,8,元大-土城學府,2024-02-23,9822
2892,第一金,8,0,8,元大-土城學府,2024-02-23,9822
2313,華通,35,28,7,元大-土城學府,2024-02-23,9822
1815,富喬,11,4,7,元大-土城學府,2024-02-23,9822
4909,新復興,13,6,7,元大-土城學府,2024-02-23,9822
6684,安格,128,5,123,元大-土城學府,2024-02-26,9822
00878,國泰永續高股息,115,6,109,元大-土城學府,2024-02-26,9822
00919,群益台灣精選高息,88,19,69,元大-土城學府,2024-02-26,9822
4526,東台,85,16,69,元大-土城學府,2024-02-26,9822
00665L,富邦�琤肭磪囓�2,61,0,61,元大-土城學府,2024-02-26,9822
00937B,群益ESG投等債20,62,3,59,元大-土城學府,2024-02-26,9822
00753L,中信中國50正2,50,0,50,元大-土城學府,2024-02-26,9822
00637L,元大滬深300正2,44,1,43,元大-土城學府,2024-02-26,9822
00933B,國泰10Y+金融債,42,10,32,元大-土城學府,2024-02-26,9822
4109,加捷生醫,31,0,31,元大-土城學府,2024-02-26,9822
0050,元大台灣50,33,3,30,元大-土城學府,2024-02-26,9822
2329,華泰,32,9,23,元大-土城學府,2024-02-26,9822
3163,波若威,38,16,22,元大-土城學府,2024-02-26,9822
1514,亞力,71,50,21,元大-土城學府,2024-02-26,9822
2368,金像電,20,0,20,元大-土城學府,2024-02-26,9822
2883,凱基金,20,0,20,元大-土城學府,2024-02-26,9822
3363,上詮,22,2,20,元大-土城學府,2024-02-26,9822
4967,十銓,20,0,20,元大-土城學府,2024-02-26,9822
2376,技嘉,28,10,18,元大-土城學府,2024-02-26,9822
6168,宏齊,35,17,18,元大-土城學府,2024-02-26,9822
6226,光鼎,17,0,17,元大-土城學府,2024-02-26,9822
00772B,中信高評級公司債,20,4,16,元大-土城學府,2024-02-26,9822
2495,普安,23,7,16,元大-土城學府,2024-02-26,9822
2303,聯電,21,6,15,元大-土城學府,2024-02-26,9822
3548,兆利,16,1,15,元大-土城學府,2024-02-26,9822
3360,尚立,17,2,15,元大-土城學府,2024-02-26,9822
00679B,元大美債20年,48,34,14,元大-土城學府,2024-02-26,9822
00690,兆豐藍籌30,16,2,14,元大-土城學府,2024-02-26,9822
4903,聯光通,14,0,14,元大-土城學府,2024-02-26,9822
6282,康舒,16,2,14,元大-土城學府,2024-02-26,9822
1710,東聯,14,1,13,元大-土城學府,2024-02-26,9822
1609,大亞,21,9,12,元大-土城學府,2024-02-26,9822
4123,晟德,12,0,12,元大-土城學府,2024-02-26,9822
4960,誠美材,13,2,11,元大-土城學府,2024-02-26,9822
2884,玉山金,16,5,11,元大-土城學府,2024-02-26,9822
2449,京元電子,29,19,10,元大-土城學府,2024-02-26,9822
9103,美德醫療-DR,13,3,10,元大-土城學府,2024-02-26,9822
1785,光洋科,13,4,9,元大-土城學府,2024-02-26,9822
2409,友達,12,3,9,元大-土城學府,2024-02-26,9822
3041,揚智,12,3,9,元大-土城學府,2024-02-26,9822
2405,輔信,66,57,9,元大-土城學府,2024-02-26,9822
2002,中鋼,9,0,9,元大-土城學府,2024-02-26,9822
2330,台積電,12,4,8,元大-土城學府,2024-02-26,9822
00687B,國泰20年美債,8,0,8,元大-土城學府,2024-02-26,9822
00712,復華富時不動產,8,0,8,元大-土城學府,2024-02-26,9822
2603,長榮,8,0,8,元大-土城學府,2024-02-26,9822
3025,星通,11,3,8,元大-土城學府,2024-02-26,9822
00770,國泰北美科技,7,0,7,元大-土城學府,2024-02-26,9822
2313,華通,19,12,7,元大-土城學府,2024-02-26,9822
1316,上曜,21,15,6,元大-土城學府,2024-02-26,9822
2618,長榮航,434,6,428,元大-土城學府,2024-02-27,9822
00878,國泰永續高股息,235,40,195,元大-土城學府,2024-02-27,9822
00937B,群益ESG投等債20,125,5,120,元大-土城學府,2024-02-27,9822
00680L,元大美債20正2,76,0,76,元大-土城學府,2024-02-27,9822
1718,中纖,100,30,70,元大-土城學府,2024-02-27,9822
1524,耿鼎,89,25,64,元大-土城學府,2024-02-27,9822
00919,群益台灣精選高息,94,34,60,元大-土城學府,2024-02-27,9822
3163,波若威,65,10,55,元大-土城學府,2024-02-27,9822
2324,仁寶,74,21,53,元大-土城學府,2024-02-27,9822
00665L,富邦�琤肭磪囓�2,50,1,49,元大-土城學府,2024-02-27,9822
8096,擎亞,57,11,46,元大-土城學府,2024-02-27,9822
6284,佳邦,46,1,45,元大-土城學府,2024-02-27,9822
3037,欣興,82,39,43,元大-土城學府,2024-02-27,9822
1513,中興電,70,30,40,元大-土城學府,2024-02-27,9822
00679B,元大美債20年,36,2,34,元大-土城學府,2024-02-27,9822
00795B,中信美國公債20年,32,0,32,元大-土城學府,2024-02-27,9822
1316,上曜,41,12,29,元大-土城學府,2024-02-27,9822
2301,光寶科,33,7,26,元大-土城學府,2024-02-27,9822
2363,矽統,51,25,26,元大-土城學府,2024-02-27,9822
1504,東元,37,11,26,元大-土城學府,2024-02-27,9822
3481,群創,37,13,24,元大-土城學府,2024-02-27,9822
4931,新盛力,24,0,24,元大-土城學府,2024-02-27,9822
2369,菱生,29,7,22,元大-土城學府,2024-02-27,9822
2498,宏達電,29,8,21,元大-土城學府,2024-02-27,9822
2887,台新金,21,0,21,元大-土城學府,2024-02-27,9822
6799,來頡,25,6,19,元大-土城學府,2024-02-27,9822
00933B,國泰10Y+金融債,19,0,19,元大-土城學府,2024-02-27,9822
2344,華邦電,21,2,19,元大-土城學府,2024-02-27,9822
1727,中華化,20,2,18,元大-土城學府,2024-02-27,9822
1815,富喬,25,8,17,元大-土城學府,2024-02-27,9822
2303,聯電,17,2,15,元大-土城學府,2024-02-27,9822
5009,榮剛,15,0,15,元大-土城學府,2024-02-27,9822
6113,亞矽,17,3,14,元大-土城學府,2024-02-27,9822
6233,旺玖,18,4,14,元大-土城學府,2024-02-27,9822
6697,東捷資訊,14,0,14,元大-土城學府,2024-02-27,9822
4909,新復興,20,7,13,元大-土城學府,2024-02-27,9822
6207,雷科,14,1,13,元大-土城學府,2024-02-27,9822
8121,越峰,13,0,13,元大-土城學府,2024-02-27,9822
2329,華泰,82,69,13,元大-土城學府,2024-02-27,9822
2409,友達,13,1,12,元大-土城學府,2024-02-27,9822
2812,台中銀,14,2,12,元大-土城學府,2024-02-27,9822
00892,富邦台灣半導體,11,0,11,元大-土城學府,2024-02-27,9822
3227,原相,11,0,11,元大-土城學府,2024-02-27,9822
3363,上詮,41,30,11,元大-土城學府,2024-02-27,9822
6282,康舒,11,1,10,元大-土城學府,2024-02-27,9822
6789,采鈺,10,0,10,元大-土城學府,2024-02-27,9822
6237,驊訊,16,6,10,元大-土城學府,2024-02-27,9822
3715,定穎投控,14,5,9,元大-土城學府,2024-02-27,9822
00720B,元大投資級公司債,13,4,9,元大-土城學府,2024-02-27,9822
00712,復華富時不動產,9,0,9,元大-土城學府,2024-02-27,9822
00937B,群益ESG投等債20,111,6,105,元大-土城學府,2024-02-29,9822
6207,雷科,102,4,98,元大-土城學府,2024-02-29,9822
8110,華東,70,2,68,元大-土城學府,2024-02-29,9822
3548,兆利,61,2,59,元大-土城學府,2024-02-29,9822
00900,富邦特選高股息30,61,12,49,元大-土城學府,2024-02-29,9822
5452,佶優,52,16,36,元大-土城學府,2024-02-29,9822
6116,彩晶,36,1,35,元大-土城學府,2024-02-29,9822
00919,群益台灣精選高息,48,15,33,元大-土城學府,2024-02-29,9822
00933B,國泰10Y+金融債,29,5,24,元大-土城學府,2024-02-29,9822
3390,旭軟,27,5,22,元大-土城學府,2024-02-29,9822
2884,玉山金,25,4,21,元大-土城學府,2024-02-29,9822
4164,承業醫,20,0,20,元大-土城學府,2024-02-29,9822
6443,元晶,26,6,20,元大-土城學府,2024-02-29,9822
3231,緯創,42,22,20,元大-土城學府,2024-02-29,9822
00687B,國泰20年美債,20,1,19,元大-土城學府,2024-02-29,9822
1815,富喬,38,20,18,元大-土城學府,2024-02-29,9822
2634,漢翔,20,2,18,元大-土城學府,2024-02-29,9822
2353,宏��,18,0,18,元大-土城學府,2024-02-29,9822
00751B,元大AAA至A公司債,16,0,16,元大-土城學府,2024-02-29,9822
00632R,元大台灣50反1,16,0,16,元大-土城學府,2024-02-29,9822
1522,堤維西,45,29,16,元大-土城學府,2024-02-29,9822
6284,佳邦,16,0,16,元大-土城學府,2024-02-29,9822
00673R,期元大S＆P原油反1,15,0,15,元大-土城學府,2024-02-29,9822
1727,中華化,32,17,15,元大-土城學府,2024-02-29,9822
3058,立德,14,0,14,元大-土城學府,2024-02-29,9822
2820,華票,12,0,12,元大-土城學府,2024-02-29,9822
00680L,元大美債20正2,39,27,12,元大-土城學府,2024-02-29,9822
6288,聯嘉,23,12,11,元大-土城學府,2024-02-29,9822
3027,盛達,11,0,11,元大-土城學府,2024-02-29,9822
4755,三福化,11,0,11,元大-土城學府,2024-02-29,9822
00929,復華台灣科技優息,62,51,11,元大-土城學府,2024-02-29,9822
1432,大魯閣,10,0,10,元大-土城學府,2024-02-29,9822
4526,東台,10,0,10,元大-土城學府,2024-02-29,9822
00679B,元大美債20年,20,10,10,元大-土城學府,2024-02-29,9822
2431,聯昌,9,0,9,元大-土城學府,2024-02-29,9822
00715L,期街口布蘭特正2,10,1,9,元大-土城學府,2024-02-29,9822
1717,長興,10,1,9,元大-土城學府,2024-02-29,9822
3313,斐成,10,1,9,元大-土城學府,2024-02-29,9822
1513,中興電,46,37,9,元大-土城學府,2024-02-29,9822
1314,中石化,10,2,8,元大-土城學府,2024-02-29,9822
3044,健鼎,8,0,8,元大-土城學府,2024-02-29,9822
3684,榮昌,8,0,8,元大-土城學府,2024-02-29,9822
5498,凱崴,9,1,8,元大-土城學府,2024-02-29,9822
6124,業強,8,0,8,元大-土城學府,2024-02-29,9822
6216,居易,8,0,8,元大-土城學府,2024-02-29,9822
2329,華泰,22,15,7,元大-土城學府,2024-02-29,9822
5347,世界,7,0,7,元大-土城學府,2024-02-29,9822
1101,台泥,10,3,7,元大-土城學府,2024-02-29,9822
2611,志信,8,1,7,元大-土城學府,2024-02-29,9822
2330,台積電,7,0,7,元大-土城學府,2024-02-29,9822
00919,群益台灣精選高息,941,12,929,元大-土城學府,2024-03-01,9822
2845,遠東銀,205,6,199,元大-土城學府,2024-03-01,9822
00937B,群益ESG投等債20,119,7,112,元大-土城學府,2024-03-01,9822
00935,野村臺灣新科技50,100,0,100,元大-土城學府,2024-03-01,9822
9105,泰金寶-DR,115,15,100,元大-土城學府,2024-03-01,9822
00680L,元大美債20正2,84,0,84,元大-土城學府,2024-03-01,9822
1524,耿鼎,69,6,63,元大-土城學府,2024-03-01,9822
1513,中興電,76,19,57,元大-土城學府,2024-03-01,9822
6233,旺玖,52,3,49,元大-土城學府,2024-03-01,9822
00929,復華台灣科技優息,53,20,33,元大-土城學府,2024-03-01,9822
00687B,國泰20年美債,42,10,32,元大-土城學府,2024-03-01,9822
00751B,元大AAA至A公司債,31,0,31,元大-土城學府,2024-03-01,9822
1316,上曜,62,33,29,元大-土城學府,2024-03-01,9822
1609,大亞,58,29,29,元大-土城學府,2024-03-01,9822
3481,群創,27,1,26,元大-土城學府,2024-03-01,9822
00895,富邦未來車,25,0,25,元大-土城學府,2024-03-01,9822
2002,中鋼,32,8,24,元大-土城學府,2024-03-01,9822
6532,瑞耘,23,2,21,元大-土城學府,2024-03-01,9822
2801,彰銀,20,0,20,元大-土城學府,2024-03-01,9822
6829,千附精密,22,3,19,元大-土城學府,2024-03-01,9822
00918,大華優利高填息30,37,20,17,元大-土城學府,2024-03-01,9822
6179,亞通,19,2,17,元大-土城學府,2024-03-01,9822
2369,菱生,18,2,16,元大-土城學府,2024-03-01,9822
3360,尚立,32,17,15,元大-土城學府,2024-03-01,9822
3605,宏致,15,1,14,元大-土城學府,2024-03-01,9822
00679B,元大美債20年,32,18,14,元大-土城學府,2024-03-01,9822
9945,潤泰新,14,1,13,元大-土城學府,2024-03-01,9822
0050,元大台灣50,15,3,12,元大-土城學府,2024-03-01,9822
1455,集盛,70,58,12,元大-土城學府,2024-03-01,9822
8110,華東,12,0,12,元大-土城學府,2024-03-01,9822
2374,佳能,12,0,12,元大-土城學府,2024-03-01,9822
00933B,國泰10Y+金融債,12,1,11,元大-土城學府,2024-03-01,9822
2409,友達,11,0,11,元大-土城學府,2024-03-01,9822
3105,穩懋,13,3,10,元大-土城學府,2024-03-01,9822
2367,燿華,62,52,10,元大-土城學府,2024-03-01,9822
00893,國泰智能電動車,14,4,10,元大-土城學府,2024-03-01,9822
00892,富邦台灣半導體,10,0,10,元大-土城學府,2024-03-01,9822
2491,吉祥全,10,0,10,元大-土城學府,2024-03-01,9822
2705,六福,10,0,10,元大-土城學府,2024-03-01,9822
3032,偉訓,11,1,10,元大-土城學府,2024-03-01,9822
3227,原相,10,0,10,元大-土城學府,2024-03-01,9822
6138,茂達,11,1,10,元大-土城學府,2024-03-01,9822
1589,永冠-KY,10,1,9,元大-土城學府,2024-03-01,9822
2891,中信金,9,0,9,元大-土城學府,2024-03-01,9822
3490,單井,10,1,9,元大-土城學府,2024-03-01,9822
8121,越峰,9,0,9,元大-土城學府,2024-03-01,9822
00881,國泰台灣5G+,9,0,9,元大-土城學府,2024-03-01,9822
2329,華泰,34,25,9,元大-土城學府,2024-03-01,9822
00878,國泰永續高股息,41,33,8,元大-土城學府,2024-03-01,9822
6505,台塑化,8,0,8,元大-土城學府,2024-03-01,9822
00929,復華台灣科技優息,477,29,448,元大-土城學府,2024-03-04,9822
1455,集盛,78,0,78,元大-土城學府,2024-03-04,9822
00665L,富邦�琤肭磪囓�2,50,0,50,元大-土城學府,2024-03-04,9822
00918,大華優利高填息30,56,8,48,元大-土城學府,2024-03-04,9822
6770,力積電,43,5,38,元大-土城學府,2024-03-04,9822
00712,復華富時不動產,34,0,34,元大-土城學府,2024-03-04,9822
00878,國泰永續高股息,47,14,33,元大-土城學府,2024-03-04,9822
00632R,元大台灣50反1,31,0,31,元大-土城學府,2024-03-04,9822
3380,明泰,35,4,31,元大-土城學府,2024-03-04,9822
9945,潤泰新,29,0,29,元大-土城學府,2024-03-04,9822
00919,群益台灣精選高息,57,28,29,元大-土城學府,2024-03-04,9822
1522,堤維西,28,1,27,元大-土城學府,2024-03-04,9822
2002,中鋼,29,2,27,元大-土城學府,2024-03-04,9822
00687B,國泰20年美債,28,1,27,元大-土城學府,2024-03-04,9822
00933B,國泰10Y+金融債,25,0,25,元大-土城學府,2024-03-04,9822
0056,元大高股息,71,47,24,元大-土城學府,2024-03-04,9822
1217,愛之味,23,0,23,元大-土城學府,2024-03-04,9822
00937B,群益ESG投等債20,70,50,20,元大-土城學府,2024-03-04,9822
6163,華電網,22,2,20,元大-土城學府,2024-03-04,9822
1316,上曜,43,24,19,元大-土城學府,2024-03-04,9822
2317,鴻海,87,68,19,元大-土城學府,2024-03-04,9822
5457,宣德,17,0,17,元大-土城學府,2024-03-04,9822
6799,來頡,18,1,17,元大-土城學府,2024-03-04,9822
00637L,元大滬深300正2,17,0,17,元大-土城學府,2024-03-04,9822
3645,達邁,15,0,15,元大-土城學府,2024-03-04,9822
00673R,期元大S＆P原油反1,14,0,14,元大-土城學府,2024-03-04,9822
1409,新纖,13,0,13,元大-土城學府,2024-03-04,9822
2543,皇昌,13,1,12,元大-土城學府,2024-03-04,9822
2637,慧洋-KY,12,0,12,元大-土城學府,2024-03-04,9822
6127,九豪,17,5,12,元大-土城學府,2024-03-04,9822
4968,立積,28,16,12,元大-土城學府,2024-03-04,9822
1432,大魯閣,11,0,11,元大-土城學府,2024-03-04,9822
6233,旺玖,16,5,11,元大-土城學府,2024-03-04,9822
6462,神盾,14,3,11,元大-土城學府,2024-03-04,9822
00892,富邦台灣半導體,10,0,10,元大-土城學府,2024-03-04,9822
00715L,期街口布蘭特正2,14,4,10,元大-土城學府,2024-03-04,9822
2312,金寶,13,3,10,元大-土城學府,2024-03-04,9822
2419,仲琦,10,0,10,元大-土城學府,2024-03-04,9822
2888,新光金,10,0,10,元大-土城學府,2024-03-04,9822
3501,維熹,10,0,10,元大-土城學府,2024-03-04,9822
6547,高端疫苗,10,0,10,元大-土城學府,2024-03-04,9822
1503,士電,13,3,10,元大-土城學府,2024-03-04,9822
00679B,元大美債20年,16,7,9,元大-土城學府,2024-03-04,9822
00751B,元大AAA至A公司債,9,0,9,元大-土城學府,2024-03-04,9822
5309,系統電,10,1,9,元大-土城學府,2024-03-04,9822
6223,旺矽,10,1,9,元大-土城學府,2024-03-04,9822
3005,神基,13,4,9,元大-土城學府,2024-03-04,9822
2329,華泰,23,15,8,元大-土城學府,2024-03-04,9822
2415,錩新,10,2,8,元大-土城學府,2024-03-04,9822
3481,群創,12,5,7,元大-土城學府,2024-03-04,9822
9105,泰金寶-DR,496,0,496,元大-土城學府,2024-03-05,9822
00680L,元大美債20正2,177,0,177,元大-土城學府,2024-03-05,9822
00937B,群益ESG投等債20,171,12,159,元大-土城學府,2024-03-05,9822
00882,中信中國高股息,96,5,91,元大-土城學府,2024-03-05,9822
00902,中信電池及儲能,85,15,70,元大-土城學府,2024-03-05,9822
00665L,富邦�琤肭磪囓�2,52,0,52,元大-土城學府,2024-03-05,9822
00892,富邦台灣半導體,50,0,50,元大-土城學府,2024-03-05,9822
4402,郡都開發,50,1,49,元大-土城學府,2024-03-05,9822
1517,利奇,45,0,45,元大-土城學府,2024-03-05,9822
00919,群益台灣精選高息,188,145,43,元大-土城學府,2024-03-05,9822
00712,復華富時不動產,55,20,35,元大-土城學府,2024-03-05,9822
1605,華新,36,1,35,元大-土城學府,2024-03-05,9822
2324,仁寶,33,6,27,元大-土城學府,2024-03-05,9822
2316,楠梓電,40,14,26,元大-土城學府,2024-03-05,9822
00918,大華優利高填息30,31,5,26,元大-土城學府,2024-03-05,9822
3047,訊舟,26,2,24,元大-土城學府,2024-03-05,9822
00632R,元大台灣50反1,22,0,22,元大-土城學府,2024-03-05,9822
2485,兆赫,37,16,21,元大-土城學府,2024-03-05,9822
2002,中鋼,36,16,20,元大-土城學府,2024-03-05,9822
2417,圓剛,21,2,19,元大-土城學府,2024-03-05,9822
3481,群創,24,5,19,元大-土城學府,2024-03-05,9822
6753,龍德造船,18,0,18,元大-土城學府,2024-03-05,9822
8054,安國,19,2,17,元大-土城學府,2024-03-05,9822
2409,友達,18,1,17,元大-土城學府,2024-03-05,9822
4968,立積,19,2,17,元大-土城學府,2024-03-05,9822
5009,榮剛,19,2,17,元大-土城學府,2024-03-05,9822
8150,南茂,17,1,16,元大-土城學府,2024-03-05,9822
00687B,國泰20年美債,15,0,15,元大-土城學府,2024-03-05,9822
1522,堤維西,22,7,15,元大-土城學府,2024-03-05,9822
8936,國統,16,1,15,元大-土城學府,2024-03-05,9822
2365,昆盈,14,0,14,元大-土城學府,2024-03-05,9822
2329,華泰,25,12,13,元大-土城學府,2024-03-05,9822
2337,旺宏,18,5,13,元大-土城學府,2024-03-05,9822
00878,國泰永續高股息,18,6,12,元大-土城學府,2024-03-05,9822
1584,精剛,18,6,12,元大-土城學府,2024-03-05,9822
8076,伍豐,12,0,12,元大-土城學府,2024-03-05,9822
2374,佳能,12,0,12,元大-土城學府,2024-03-05,9822
2355,敬鵬,12,1,11,元大-土城學府,2024-03-05,9822
00770,國泰北美科技,11,0,11,元大-土城學府,2024-03-05,9822
1802,台玻,11,0,11,元大-土城學府,2024-03-05,9822
2609,陽明,18,7,11,元大-土城學府,2024-03-05,9822
1909,榮成,10,0,10,元大-土城學府,2024-03-05,9822
2303,聯電,24,14,10,元大-土城學府,2024-03-05,9822
2884,玉山金,10,0,10,元大-土城學府,2024-03-05,9822
8176,智捷,10,0,10,元大-土城學府,2024-03-05,9822
1101,台泥,10,1,9,元大-土城學府,2024-03-05,9822
1815,富喬,23,14,9,元大-土城學府,2024-03-05,9822
2371,大同,21,13,8,元大-土城學府,2024-03-05,9822
0061,元大寶滬深,9,1,8,元大-土城學府,2024-03-05,9822
6207,雷科,8,0,8,元大-土城學府,2024-03-05,9822
00918,大華優利高填息30,203,5,198,元大-土城學府,2024-03-06,9822
4939,亞電,114,0,114,元大-土城學府,2024-03-06,9822
2845,遠東銀,199,115,84,元大-土城學府,2024-03-06,9822
2618,長榮航,79,1,78,元大-土城學府,2024-03-06,9822
00929,復華台灣科技優息,102,35,67,元大-土城學府,2024-03-06,9822
00919,群益台灣精選高息,190,124,66,元大-土城學府,2024-03-06,9822
2421,建準,68,10,58,元大-土城學府,2024-03-06,9822
00937B,群益ESG投等債20,50,3,47,元大-土城學府,2024-03-06,9822
00915,凱基優選高股息30,46,0,46,元大-土城學府,2024-03-06,9822
00632R,元大台灣50反1,39,0,39,元大-土城學府,2024-03-06,9822
00878,國泰永續高股息,47,13,34,元大-土城學府,2024-03-06,9822
00687B,國泰20年美債,36,4,32,元大-土城學府,2024-03-06,9822
6197,佳必琪,38,8,30,元大-土城學府,2024-03-06,9822
2031,新光鋼,29,0,29,元大-土城學府,2024-03-06,9822
2368,金像電,26,0,26,元大-土城學府,2024-03-06,9822
5388,中磊,27,1,26,元大-土城學府,2024-03-06,9822
8926,台汽電,24,0,24,元大-土城學府,2024-03-06,9822
4906,正文,28,6,22,元大-土城學府,2024-03-06,9822
8069,元太,21,0,21,元大-土城學府,2024-03-06,9822
1201,味全,20,0,20,元大-土城學府,2024-03-06,9822
2498,宏達電,19,1,18,元大-土城學府,2024-03-06,9822
4402,郡都開發,18,0,18,元大-土城學府,2024-03-06,9822
6756,威鋒電子,16,0,16,元大-土城學府,2024-03-06,9822
4526,東台,17,1,16,元大-土城學府,2024-03-06,9822
5608,四維航,16,0,16,元大-土城學府,2024-03-06,9822
6284,佳邦,16,0,16,元大-土城學府,2024-03-06,9822
9941,裕融,15,0,15,元大-土城學府,2024-03-06,9822
6163,華電網,29,14,15,元大-土城學府,2024-03-06,9822
2353,宏��,14,0,14,元大-土城學府,2024-03-06,9822
2609,陽明,16,2,14,元大-土城學府,2024-03-06,9822
3450,聯鈞,19,5,14,元大-土城學府,2024-03-06,9822
6770,力積電,15,1,14,元大-土城學府,2024-03-06,9822
00773B,中信優先金融債,13,0,13,元大-土城學府,2024-03-06,9822
2369,菱生,21,8,13,元大-土城學府,2024-03-06,9822
2882,國泰金,13,0,13,元大-土城學府,2024-03-06,9822
8011,台通,49,36,13,元大-土城學府,2024-03-06,9822
6282,康舒,14,2,12,元大-土城學府,2024-03-06,9822
00933B,國泰10Y+金融債,11,0,11,元大-土城學府,2024-03-06,9822
2329,華泰,25,14,11,元大-土城學府,2024-03-06,9822
8110,華東,17,6,11,元大-土城學府,2024-03-06,9822
2316,楠梓電,39,28,11,元大-土城學府,2024-03-06,9822
00679B,元大美債20年,20,10,10,元大-土城學府,2024-03-06,9822
2489,瑞軒,10,0,10,元大-土城學府,2024-03-06,9822
8034,榮群,10,0,10,元大-土城學府,2024-03-06,9822
1101,台泥,10,0,10,元大-土城學府,2024-03-06,9822
00882,中信中國高股息,11,2,9,元大-土城學府,2024-03-06,9822
1710,東聯,11,2,9,元大-土城學府,2024-03-06,9822
2356,英業達,43,34,9,元大-土城學府,2024-03-06,9822
2897,王道銀行,10,1,9,元大-土城學府,2024-03-06,9822
4908,前鼎,12,3,9,元大-土城學府,2024-03-06,9822
00919,群益台灣精選高息,802,197,605,元大-土城學府,2024-03-07,9822
00937B,群益ESG投等債20,134,12,122,元大-土城學府,2024-03-07,9822
2367,燿華,195,80,115,元大-土城學府,2024-03-07,9822
1455,集盛,80,0,80,元大-土城學府,2024-03-07,9822
2852,第一保,80,0,80,元大-土城學府,2024-03-07,9822
1314,中石化,69,0,69,元大-土城學府,2024-03-07,9822
00918,大華優利高填息30,60,9,51,元大-土城學府,2024-03-07,9822
00921,兆豐龍頭等權重,43,0,43,元大-土城學府,2024-03-07,9822
1815,富喬,77,34,43,元大-土城學府,2024-03-07,9822
2025,千興,41,0,41,元大-土城學府,2024-03-07,9822
4906,正文,51,11,40,元大-土城學府,2024-03-07,9822
2421,建準,43,6,37,元大-土城學府,2024-03-07,9822
1785,光洋科,44,7,37,元大-土城學府,2024-03-07,9822
1513,中興電,48,14,34,元大-土城學府,2024-03-07,9822
5701,劍湖山,33,0,33,元大-土城學府,2024-03-07,9822
00929,復華台灣科技優息,145,113,32,元大-土城學府,2024-03-07,9822
1316,上曜,73,41,32,元大-土城學府,2024-03-07,9822
2365,昆盈,32,0,32,元大-土城學府,2024-03-07,9822
00753L,中信中國50正2,30,0,30,元大-土城學府,2024-03-07,9822
00632R,元大台灣50反1,39,10,29,元大-土城學府,2024-03-07,9822
00646,元大S＆P500,25,0,25,元大-土城學府,2024-03-07,9822
8028,昇陽半導體,26,1,25,元大-土城學府,2024-03-07,9822
5521,工信,31,7,24,元大-土城學府,2024-03-07,9822
00931B,統一美債20年,33,10,23,元大-土城學府,2024-03-07,9822
3481,群創,26,3,23,元大-土城學府,2024-03-07,9822
2371,大同,33,10,23,元大-土城學府,2024-03-07,9822
3518,柏騰,23,0,23,元大-土城學府,2024-03-07,9822
2002,中鋼,23,0,23,元大-土城學府,2024-03-07,9822
3051,力特,24,2,22,元大-土城學府,2024-03-07,9822
3402,漢科,23,1,22,元大-土城學府,2024-03-07,9822
8112,至上,28,7,21,元大-土城學府,2024-03-07,9822
6285,啟��,23,3,20,元大-土城學府,2024-03-07,9822
2753,八方雲集,20,0,20,元大-土城學府,2024-03-07,9822
1409,新纖,19,0,19,元大-土城學府,2024-03-07,9822
2316,楠梓電,23,4,19,元大-土城學府,2024-03-07,9822
6284,佳邦,20,2,18,元大-土城學府,2024-03-07,9822
6667,信紘科,20,2,18,元大-土城學府,2024-03-07,9822
2356,英業達,54,37,17,元大-土城學府,2024-03-07,9822
8150,南茂,21,5,16,元大-土城學府,2024-03-07,9822
2486,一詮,58,42,16,元大-土城學府,2024-03-07,9822
00673R,期元大S＆P原油反1,16,0,16,元大-土城學府,2024-03-07,9822
00882,中信中國高股息,17,2,15,元大-土城學府,2024-03-07,9822
2031,新光鋼,15,0,15,元大-土城學府,2024-03-07,9822
2409,友達,16,1,15,元大-土城學府,2024-03-07,9822
3625,西勝,15,0,15,元大-土城學府,2024-03-07,9822
2314,台揚,14,0,14,元大-土城學府,2024-03-07,9822
3540,曜越,17,3,14,元大-土城學府,2024-03-07,9822
3583,辛耘,15,2,13,元大-土城學府,2024-03-07,9822
8110,華東,17,4,13,元大-土城學府,2024-03-07,9822
2313,華通,53,40,13,元大-土城學府,2024-03-07,9822
2618,長榮航,426,75,351,元大-土城學府,2024-03-08,9822
2852,第一保,287,0,287,元大-土城學府,2024-03-08,9822
00937B,群益ESG投等債20,147,9,138,元大-土城學府,2024-03-08,9822
6116,彩晶,103,0,103,元大-土城學府,2024-03-08,9822
00706L,期元大S＆P日圓正2,100,0,100,元大-土城學府,2024-03-08,9822
1455,集盛,250,160,90,元大-土城學府,2024-03-08,9822
00687B,國泰20年美債,84,4,80,元大-土城學府,2024-03-08,9822
00918,大華優利高填息30,99,29,70,元大-土城學府,2024-03-08,9822
2888,新光金,67,5,62,元大-土城學府,2024-03-08,9822
2365,昆盈,50,7,43,元大-土城學府,2024-03-08,9822
6016,康和證,41,0,41,元大-土城學府,2024-03-08,9822
6005,群益證,36,0,36,元大-土城學府,2024-03-08,9822
00915,凱基優選高股息30,46,10,36,元大-土城學府,2024-03-08,9822
6197,佳必琪,37,1,36,元大-土城學府,2024-03-08,9822
2417,圓剛,48,17,31,元大-土城學府,2024-03-08,9822
3338,泰碩,82,53,29,元大-土城學府,2024-03-08,9822
00891,中信關鍵半導體,33,5,28,元大-土城學府,2024-03-08,9822
2002,中鋼,32,5,27,元大-土城學府,2024-03-08,9822
1560,中砂,29,2,27,元大-土城學府,2024-03-08,9822
1582,信錦,30,4,26,元大-土城學府,2024-03-08,9822
5439,高技,26,1,25,元大-土城學府,2024-03-08,9822
2031,新光鋼,24,0,24,元大-土城學府,2024-03-08,9822
2258,鴻華先進-創,23,0,23,元大-土城學府,2024-03-08,9822
6182,合晶,24,1,23,元大-土城學府,2024-03-08,9822
00679B,元大美債20年,35,14,21,元大-土城學府,2024-03-08,9822
3481,群創,32,12,20,元大-土城學府,2024-03-08,9822
00753L,中信中國50正2,20,0,20,元大-土城學府,2024-03-08,9822
2353,宏��,41,21,20,元大-土城學府,2024-03-08,9822
00923,群益台ESG低碳50,21,2,19,元大-土城學府,2024-03-08,9822
5009,榮剛,25,6,19,元大-土城學府,2024-03-08,9822
6146,耕興,20,2,18,元大-土城學府,2024-03-08,9822
2367,燿華,61,45,16,元大-土城學府,2024-03-08,9822
1524,耿鼎,24,8,16,元大-土城學府,2024-03-08,9822
2465,麗臺,26,10,16,元大-土城學府,2024-03-08,9822
2609,陽明,29,14,15,元大-土城學府,2024-03-08,9822
00673R,期元大S＆P原油反1,15,0,15,元大-土城學府,2024-03-08,9822
2109,華豐,16,1,15,元大-土城學府,2024-03-08,9822
3685,元創精密,15,0,15,元大-土城學府,2024-03-08,9822
6179,亞通,15,0,15,元大-土城學府,2024-03-08,9822
3645,達邁,16,3,13,元大-土城學府,2024-03-08,9822
8086,宏捷科,14,1,13,元大-土城學府,2024-03-08,9822
8112,至上,22,9,13,元大-土城學府,2024-03-08,9822
6285,啟��,13,0,13,元大-土城學府,2024-03-08,9822
9941,裕融,19,7,12,元大-土城學府,2024-03-08,9822
6530,創威,16,4,12,元大-土城學府,2024-03-08,9822
8105,凌巨,17,5,12,元大-土城學府,2024-03-08,9822
4906,正文,11,0,11,元大-土城學府,2024-03-08,9822
2812,台中銀,11,0,11,元大-土城學府,2024-03-08,9822
00922,國泰台灣領袖50,12,1,11,元大-土城學府,2024-03-08,9822
3051,力特,13,2,11,元大-土城學府,2024-03-08,9822
00919,群益台灣精選高息,959,73,886,元大-土城學府,2024-03-11,9822
2367,燿華,177,56,121,元大-土城學府,2024-03-11,9822
2610,華航,69,12,57,元大-土城學府,2024-03-11,9822
00918,大華優利高填息30,55,0,55,元大-土城學府,2024-03-11,9822
6125,廣運,61,11,50,元大-土城學府,2024-03-11,9822
00937B,群益ESG投等債20,48,0,48,元大-土城學府,2024-03-11,9822
2916,滿心,40,0,40,元大-土城學府,2024-03-11,9822
1101,台泥,30,0,30,元大-土城學府,2024-03-11,9822
00632R,元大台灣50反1,30,0,30,元大-土城學府,2024-03-11,9822
00687B,國泰20年美債,34,5,29,元大-土城學府,2024-03-11,9822
00915,凱基優選高股息30,29,2,27,元大-土城學府,2024-03-11,9822
1455,集盛,165,140,25,元大-土城學府,2024-03-11,9822
5426,振發,20,0,20,元大-土城學府,2024-03-11,9822
2368,金像電,20,4,16,元大-土城學府,2024-03-11,9822
2801,彰銀,17,2,15,元大-土城學府,2024-03-11,9822
2303,聯電,51,36,15,元大-土城學府,2024-03-11,9822
2342,茂矽,14,0,14,元大-土城學府,2024-03-11,9822
8059,凱碩,13,0,13,元大-土城學府,2024-03-11,9822
2371,大同,16,4,12,元大-土城學府,2024-03-11,9822
5880,合庫金,12,0,12,元大-土城學府,2024-03-11,9822
2301,光寶科,13,2,11,元大-土城學府,2024-03-11,9822
00885,富邦越南,21,10,11,元大-土城學府,2024-03-11,9822
3325,旭品,11,0,11,元大-土城學府,2024-03-11,9822
1301,台塑,11,0,11,元大-土城學府,2024-03-11,9822
5483,中美晶,10,0,10,元大-土城學府,2024-03-11,9822
6182,合晶,10,0,10,元大-土城學府,2024-03-11,9822
1444,力麗,10,0,10,元大-土城學府,2024-03-11,9822
1727,中華化,10,0,10,元大-土城學府,2024-03-11,9822
2031,新光鋼,10,0,10,元大-土城學府,2024-03-11,9822
2314,台揚,11,1,10,元大-土城學府,2024-03-11,9822
2607,榮運,10,0,10,元大-土城學府,2024-03-11,9822
3016,嘉晶,11,1,10,元大-土城學府,2024-03-11,9822
8112,至上,11,1,10,元大-土城學府,2024-03-11,9822
3037,欣興,10,1,9,元大-土城學府,2024-03-11,9822
5439,高技,9,0,9,元大-土城學府,2024-03-11,9822
2883,凱基金,63,55,8,元大-土城學府,2024-03-11,9822
00933B,國泰10Y+金融債,13,5,8,元大-土城學府,2024-03-11,9822
1560,中砂,8,0,8,元大-土城學府,2024-03-11,9822
2374,佳能,8,0,8,元大-土城學府,2024-03-11,9822
6799,來頡,8,0,8,元大-土城學府,2024-03-11,9822
3078,僑威,10,3,7,元大-土城學府,2024-03-11,9822
3294,英濟,7,0,7,元大-土城學府,2024-03-11,9822
3673,TPK-KY,7,0,7,元大-土城學府,2024-03-11,9822
2206,三陽工業,8,1,7,元大-土城學府,2024-03-11,9822
00673R,期元大S＆P原油反1,6,0,6,元大-土城學府,2024-03-11,9822
8932,智通*,6,0,6,元大-土城學府,2024-03-11,9822
8933,愛地雅,6,0,6,元大-土城學府,2024-03-11,9822
3062,建漢,5,0,5,元大-土城學府,2024-03-11,9822
5519,隆大,6,1,5,元大-土城學府,2024-03-11,9822
00922,國泰台灣領袖50,5,0,5,元大-土城學府,2024-03-11,9822
2888,新光金,335,3,332,元大-土城學府,2024-03-12,9822
00919,群益台灣精選高息,269,56,213,元大-土城學府,2024-03-12,9822
1815,富喬,136,6,130,元大-土城學府,2024-03-12,9822
00680L,元大美債20正2,117,13,104,元大-土城學府,2024-03-12,9822
00706L,期元大S＆P日圓正2,100,0,100,元大-土城學府,2024-03-12,9822
00687B,國泰20年美債,92,17,75,元大-土城學府,2024-03-12,9822
6125,廣運,53,11,42,元大-土城學府,2024-03-12,9822
00937B,群益ESG投等債20,50,11,39,元大-土城學府,2024-03-12,9822
4909,新復興,43,4,39,元大-土城學府,2024-03-12,9822
00637L,元大滬深300正2,30,0,30,元大-土城學府,2024-03-12,9822
3360,尚立,25,0,25,元大-土城學府,2024-03-12,9822
3363,上詮,25,0,25,元大-土城學府,2024-03-12,9822
4906,正文,24,0,24,元大-土城學府,2024-03-12,9822
3236,千如,22,0,22,元大-土城學府,2024-03-12,9822
2355,敬鵬,21,0,21,元大-土城學府,2024-03-12,9822
2916,滿心,20,0,20,元大-土城學府,2024-03-12,9822
3707,漢磊,60,43,17,元大-土城學府,2024-03-12,9822
00918,大華優利高填息30,24,8,16,元大-土城學府,2024-03-12,9822
00921,兆豐龍頭等權重,17,2,15,元大-土城學府,2024-03-12,9822
4714,永捷,32,17,15,元大-土城學府,2024-03-12,9822
00931B,統一美債20年,24,10,14,元大-土城學府,2024-03-12,9822
2641,正德,14,0,14,元大-土城學府,2024-03-12,9822
2417,圓剛,15,1,14,元大-土城學府,2024-03-12,9822
00679B,元大美債20年,14,0,14,元大-土城學府,2024-03-12,9822
2486,一詮,21,8,13,元大-土城學府,2024-03-12,9822
2637,慧洋-KY,14,1,13,元大-土城學府,2024-03-12,9822
2634,漢翔,13,1,12,元大-土城學府,2024-03-12,9822
00915,凱基優選高股息30,12,0,12,元大-土城學府,2024-03-12,9822
2371,大同,28,17,11,元大-土城學府,2024-03-12,9822
3607,谷崧,11,0,11,元大-土城學府,2024-03-12,9822
00646,元大S＆P500,17,7,10,元大-土城學府,2024-03-12,9822
2383,台光電,10,0,10,元大-土城學府,2024-03-12,9822
2002,中鋼,11,1,10,元大-土城學府,2024-03-12,9822
2883B,凱基金乙特,10,0,10,元大-土城學府,2024-03-12,9822
4927,泰鼎-KY,10,0,10,元大-土城學府,2024-03-12,9822
6658,聯策,10,0,10,元大-土城學府,2024-03-12,9822
8933,愛地雅,10,0,10,元大-土城學府,2024-03-12,9822
9950,萬國通,10,0,10,元大-土城學府,2024-03-12,9822
1514,亞力,21,12,9,元大-土城學府,2024-03-12,9822
1605,華新,10,1,9,元大-土城學府,2024-03-12,9822
2258,鴻華先進-創,9,0,9,元大-土城學府,2024-03-12,9822
3037,欣興,13,4,9,元大-土城學府,2024-03-12,9822
3051,力特,10,1,9,元大-土城學府,2024-03-12,9822
6152,百一,10,1,9,元大-土城學府,2024-03-12,9822
6806,森崴能源,9,0,9,元大-土城學府,2024-03-12,9822
9105,泰金寶-DR,9,0,9,元大-土城學府,2024-03-12,9822
3338,泰碩,23,15,8,元大-土城學府,2024-03-12,9822
6140,訊達,8,0,8,元大-土城學府,2024-03-12,9822
8926,台汽電,15,7,8,元大-土城學府,2024-03-12,9822
2368,金像電,7,0,7,元大-土城學府,2024-03-12,9822
00929,復華台灣科技優息,475,91,384,元大-土城學府,2024-03-13,9822
2883,凱基金,305,22,283,元大-土城學府,2024-03-13,9822
6158,禾昌,77,1,76,元大-土城學府,2024-03-13,9822
00687B,國泰20年美債,76,2,74,元大-土城學府,2024-03-13,9822
00933B,國泰10Y+金融債,70,1,69,元大-土城學府,2024-03-13,9822
2618,長榮航,88,24,64,元大-土城學府,2024-03-13,9822
2607,榮運,62,0,62,元大-土城學府,2024-03-13,9822
6015,宏遠證,56,0,56,元大-土城學府,2024-03-13,9822
6125,廣運,57,6,51,元大-土城學府,2024-03-13,9822
2354,鴻準,86,36,50,元大-土城學府,2024-03-13,9822
2515,中工,50,0,50,元大-土城學府,2024-03-13,9822
1517,利奇,45,0,45,元大-土城學府,2024-03-13,9822
3715,定穎投控,45,2,43,元大-土城學府,2024-03-13,9822
00918,大華優利高填息30,59,17,42,元大-土城學府,2024-03-13,9822
4909,新復興,65,23,42,元大-土城學府,2024-03-13,9822
3231,緯創,68,26,42,元大-土城學府,2024-03-13,9822
00650L,復華香港正2,44,6,38,元大-土城學府,2024-03-13,9822
00915,凱基優選高股息30,43,5,38,元大-土城學府,2024-03-13,9822
2852,第一保,38,0,38,元大-土城學府,2024-03-13,9822
2884,玉山金,50,12,38,元大-土城學府,2024-03-13,9822
2368,金像電,38,1,37,元大-土城學府,2024-03-13,9822
00680L,元大美債20正2,66,35,31,元大-土城學府,2024-03-13,9822
1326,台化,30,0,30,元大-土城學府,2024-03-13,9822
2916,滿心,26,0,26,元大-土城學府,2024-03-13,9822
3363,上詮,26,2,24,元大-土城學府,2024-03-13,9822
00937B,群益ESG投等債20,26,2,24,元大-土城學府,2024-03-13,9822
2031,新光鋼,23,0,23,元大-土城學府,2024-03-13,9822
6233,旺玖,24,2,22,元大-土城學府,2024-03-13,9822
1513,中興電,84,63,21,元大-土城學府,2024-03-13,9822
00646,元大S＆P500,21,0,21,元大-土城學府,2024-03-13,9822
6284,佳邦,20,0,20,元大-土城學府,2024-03-13,9822
00720B,元大投資級公司債,29,10,19,元大-土城學府,2024-03-13,9822
6282,康舒,18,2,16,元大-土城學府,2024-03-13,9822
00881,國泰台灣5G+,19,3,16,元大-土城學府,2024-03-13,9822
2302,麗正,16,0,16,元大-土城學府,2024-03-13,9822
5498,凱崴,22,6,16,元大-土城學府,2024-03-13,9822
2323,中環,15,0,15,元大-土城學府,2024-03-13,9822
1589,永冠-KY,18,3,15,元大-土城學府,2024-03-13,9822
6770,力積電,17,3,14,元大-土城學府,2024-03-13,9822
2355,敬鵬,14,0,14,元大-土城學府,2024-03-13,9822
2365,昆盈,27,13,14,元大-土城學府,2024-03-13,9822
2383,台光電,14,1,13,元大-土城學府,2024-03-13,9822
00712,復華富時不動產,15,2,13,元大-土城學府,2024-03-13,9822
00751B,元大AAA至A公司債,13,0,13,元大-土城學府,2024-03-13,9822
1614,三洋電,13,0,13,元大-土城學府,2024-03-13,9822
2610,華航,14,1,13,元大-土城學府,2024-03-13,9822
9941,裕融,14,2,12,元大-土城學府,2024-03-13,9822
1514,亞力,51,38,13,元大-土城學府,2024-03-13,9822
2408,南亞科,12,0,12,元大-土城學府,2024-03-13,9822
3521,鴻翊,12,0,12,元大-土城學府,2024-03-13,9822
00919,群益台灣精選高息,501,395,106,元大-土城學府,2024-03-14,9822
00687B,國泰20年美債,102,0,102,元大-土城學府,2024-03-14,9822
00918,大華優利高填息30,152,74,78,元大-土城學府,2024-03-14,9822
2303,聯電,80,22,58,元大-土城學府,2024-03-14,9822
5483,中美晶,52,1,51,元大-土城學府,2024-03-14,9822
2356,英業達,92,47,45,元大-土城學府,2024-03-14,9822
2836,高雄銀,45,5,40,元大-土城學府,2024-03-14,9822
00896,中信綠能及電動車,35,0,35,元大-土城學府,2024-03-14,9822
5880,合庫金,38,3,35,元大-土城學府,2024-03-14,9822
2365,昆盈,32,3,29,元大-土城學府,2024-03-14,9822
00637L,元大滬深300正2,30,3,27,元大-土城學府,2024-03-14,9822
6158,禾昌,26,0,26,元大-土城學府,2024-03-14,9822
2609,陽明,38,13,25,元大-土城學府,2024-03-14,9822
2888,新光金,48,23,25,元大-土城學府,2024-03-14,9822
00751B,元大AAA至A公司債,30,6,24,元大-土城學府,2024-03-14,9822
4714,永捷,33,9,24,元大-土城學府,2024-03-14,9822
3017,奇鋐,25,1,24,元大-土城學府,2024-03-14,9822
00915,凱基優選高股息30,36,13,23,元大-土城學府,2024-03-14,9822
2374,佳能,22,0,22,元大-土城學府,2024-03-14,9822
3169,亞信,22,0,22,元大-土城學府,2024-03-14,9822
6217,中探針,24,2,22,元大-土城學府,2024-03-14,9822
00680L,元大美債20正2,42,20,22,元大-土城學府,2024-03-14,9822
2603,長榮,30,9,21,元大-土城學府,2024-03-14,9822
8926,台汽電,26,5,21,元大-土城學府,2024-03-14,9822
3231,緯創,67,46,21,元大-土城學府,2024-03-14,9822
2354,鴻準,29,8,21,元大-土城學府,2024-03-14,9822
5272,笙科,20,0,20,元大-土城學府,2024-03-14,9822
6285,啟��,63,43,20,元大-土城學府,2024-03-14,9822
3325,旭品,21,2,19,元大-土城學府,2024-03-14,9822
00891,中信關鍵半導體,17,0,17,元大-土城學府,2024-03-14,9822
3706,神達,19,4,15,元大-土城學府,2024-03-14,9822
2408,南亞科,17,2,15,元大-土城學府,2024-03-14,9822
2301,光寶科,26,11,15,元大-土城學府,2024-03-14,9822
00673R,期元大S＆P原油反1,14,0,14,元大-土城學府,2024-03-14,9822
00933B,國泰10Y+金融債,14,0,14,元大-土城學府,2024-03-14,9822
1503,士電,52,39,13,元大-土城學府,2024-03-14,9822
2031,新光鋼,13,0,13,元大-土城學府,2024-03-14,9822
6284,佳邦,14,1,13,元大-土城學府,2024-03-14,9822
1808,潤隆,15,3,12,元大-土城學府,2024-03-14,9822
3005,神基,22,11,11,元大-土城學府,2024-03-14,9822
00935,野村臺灣新科技50,13,3,10,元大-土城學府,2024-03-14,9822
3702,大聯大,30,20,10,元大-土城學府,2024-03-14,9822
1584,精剛,10,0,10,元大-土城學府,2024-03-14,9822
00688L,國泰20年美債正2,10,0,10,元大-土城學府,2024-03-14,9822
2014,中鴻,17,7,10,元大-土城學府,2024-03-14,9822
2032,新鋼,10,0,10,元大-土城學府,2024-03-14,9822
2369,菱生,10,0,10,元大-土城學府,2024-03-14,9822
2442,新美齊,10,0,10,元大-土城學府,2024-03-14,9822
3712,永崴投控,12,2,10,元大-土城學府,2024-03-14,9822
6116,彩晶,10,0,10,元大-土城學府,2024-03-14,9822
00941,中信上游半導體,132,5,127,元大-土城學府,2024-03-15,9822
1455,集盛,145,35,110,元大-土城學府,2024-03-15,9822
00918,大華優利高填息30,105,1,104,元大-土城學府,2024-03-15,9822
00919,群益台灣精選高息,321,219,102,元大-土城學府,2024-03-15,9822
00687B,國泰20年美債,82,0,82,元大-土城學府,2024-03-15,9822
00937B,群益ESG投等債20,52,0,52,元大-土城學府,2024-03-15,9822
00712,復華富時不動產,45,1,44,元大-土城學府,2024-03-15,9822
2365,昆盈,40,0,40,元大-土城學府,2024-03-15,9822
2834,臺企銀,38,7,31,元大-土城學府,2024-03-15,9822
00665L,富邦�琤肭磪囓�2,30,0,30,元大-土城學府,2024-03-15,9822
6196,帆宣,30,0,30,元大-土城學府,2024-03-15,9822
2888,新光金,38,10,28,元大-土城學府,2024-03-15,9822
2603,長榮,48,21,27,元大-土城學府,2024-03-15,9822
6158,禾昌,27,0,27,元大-土城學府,2024-03-15,9822
00713,元大台灣高息低波,39,14,25,元大-土城學府,2024-03-15,9822
2323,中環,57,35,22,元大-土城學府,2024-03-15,9822
00679B,元大美債20年,49,28,21,元大-土城學府,2024-03-15,9822
2324,仁寶,26,5,21,元大-土城學府,2024-03-15,9822
2611,志信,27,7,20,元大-土城學府,2024-03-15,9822
00931B,統一美債20年,20,0,20,元大-土城學府,2024-03-15,9822
8936,國統,20,0,20,元大-土城學府,2024-03-15,9822
2354,鴻準,52,33,19,元大-土城學府,2024-03-15,9822
2002,中鋼,19,0,19,元大-土城學府,2024-03-15,9822
3706,神達,22,3,19,元大-土城學府,2024-03-15,9822
2373,震旦行,20,2,18,元大-土城學府,2024-03-15,9822
8091,翔名,18,0,18,元大-土城學府,2024-03-15,9822
3438,類比科,22,5,17,元大-土城學府,2024-03-15,9822
2301,光寶科,18,2,16,元大-土城學府,2024-03-15,9822
2377,微星,16,1,15,元大-土城學府,2024-03-15,9822
8105,凌巨,14,0,14,元大-土城學府,2024-03-15,9822
1711,永光,13,0,13,元大-土城學府,2024-03-15,9822
2891,中信金,20,7,13,元大-土城學府,2024-03-15,9822
2330,台積電,16,4,12,元大-土城學府,2024-03-15,9822
00915,凱基優選高股息30,15,3,12,元大-土城學府,2024-03-15,9822
00680L,元大美債20正2,57,45,12,元大-土城學府,2024-03-15,9822
1503,士電,36,24,12,元大-土城學府,2024-03-15,9822
00642U,期元大S＆P石油,12,0,12,元大-土城學府,2024-03-15,9822
2892,第一金,12,0,12,元大-土城學府,2024-03-15,9822
2615,萬海,13,2,11,元大-土城學府,2024-03-15,9822
00933B,國泰10Y+金融債,11,0,11,元大-土城學府,2024-03-15,9822
3207,耀勝,12,1,11,元大-土城學府,2024-03-15,9822
5880,合庫金,11,0,11,元大-土城學府,2024-03-15,9822
6275,元山,35,24,11,元大-土城學府,2024-03-15,9822
6457,紘康,11,0,11,元大-土城學府,2024-03-15,9822
1513,中興電,26,16,10,元大-土城學府,2024-03-15,9822
3189,景碩,11,1,10,元大-土城學府,2024-03-15,9822
00639,富邦深100,10,0,10,元大-土城學府,2024-03-15,9822
1445,大宇,10,0,10,元大-土城學府,2024-03-15,9822
4157,太景*-KY,10,0,10,元大-土城學府,2024-03-15,9822
5351,鈺創,10,0,10,元大-土城學府,2024-03-15,9822
9105,泰金寶-DR,264,0,264,元大-土城學府,2024-03-18,9822
00919,群益台灣精選高息,296,40,256,元大-土城學府,2024-03-18,9822
2014,中鴻,103,0,103,元大-土城學府,2024-03-18,9822
1455,集盛,103,13,90,元大-土城學府,2024-03-18,9822
00687B,國泰20年美債,52,2,50,元大-土城學府,2024-03-18,9822
00680L,元大美債20正2,41,0,41,元大-土城學府,2024-03-18,9822
00688L,國泰20年美債正2,37,0,37,元大-土城學府,2024-03-18,9822
00720B,元大投資級公司債,31,0,31,元大-土城學府,2024-03-18,9822
6144,得利影,27,0,27,元大-土城學府,2024-03-18,9822
2374,佳能,23,0,23,元大-土城學府,2024-03-18,9822
2609,陽明,36,14,22,元大-土城學府,2024-03-18,9822
5880,合庫金,23,1,22,元大-土城學府,2024-03-18,9822
00725B,國泰投資級公司債,22,0,22,元大-土城學府,2024-03-18,9822
6016,康和證,22,0,22,元大-土城學府,2024-03-18,9822
00679B,元大美債20年,23,2,21,元大-土城學府,2024-03-18,9822
00885,富邦越南,21,0,21,元大-土城學府,2024-03-18,9822
00941,中信上游半導體,180,160,20,元大-土城學府,2024-03-18,9822
2472,立隆電,20,1,19,元大-土城學府,2024-03-18,9822
2301,光寶科,19,1,18,元大-土城學府,2024-03-18,9822
3294,英濟,27,10,17,元大-土城學府,2024-03-18,9822
0056,元大高股息,37,21,16,元大-土城學府,2024-03-18,9822
00673R,期元大S＆P原油反1,16,0,16,元大-土城學府,2024-03-18,9822
00891,中信關鍵半導體,15,0,15,元大-土城學府,2024-03-18,9822
2834,臺企銀,16,2,14,元大-土城學府,2024-03-18,9822
2408,南亞科,14,0,14,元大-土城學府,2024-03-18,9822
8936,國統,30,16,14,元大-土城學府,2024-03-18,9822
00751B,元大AAA至A公司債,13,0,13,元大-土城學府,2024-03-18,9822
2603,長榮,16,3,13,元大-土城學府,2024-03-18,9822
2354,鴻準,18,5,13,元大-土城學府,2024-03-18,9822
00937B,群益ESG投等債20,13,1,12,元大-土城學府,2024-03-18,9822
00933B,國泰10Y+金融債,12,0,12,元大-土城學府,2024-03-18,9822
2382,廣達,27,15,12,元大-土城學府,2024-03-18,9822
1303,南亞,12,0,12,元大-土城學府,2024-03-18,9822
2885,元大金,12,0,12,元大-土城學府,2024-03-18,9822
4906,正文,15,3,12,元大-土城學府,2024-03-18,9822
6275,元山,22,12,10,元大-土城學府,2024-03-18,9822
9958,世紀鋼,10,0,10,元大-土城學府,2024-03-18,9822
1307,三芳,10,0,10,元大-土城學府,2024-03-18,9822
3032,偉訓,11,1,10,元大-土城學府,2024-03-18,9822
2610,華航,18,8,10,元大-土城學府,2024-03-18,9822
2377,微星,10,1,9,元大-土城學府,2024-03-18,9822
6695,芯鼎,9,0,9,元大-土城學府,2024-03-18,9822
2801,彰銀,8,0,8,元大-土城學府,2024-03-18,9822
00795B,中信美國公債20年,7,0,7,元大-土城學府,2024-03-18,9822
3308,聯德,7,0,7,元大-土城學府,2024-03-18,9822
6245,立端,7,0,7,元大-土城學府,2024-03-18,9822
2327,國巨,6,0,6,元大-土城學府,2024-03-18,9822
00646,元大S＆P500,6,0,6,元大-土城學府,2024-03-18,9822
3041,揚智,6,0,6,元大-土城學府,2024-03-18,9822
4532,瑞智,10,4,6,元大-土城學府,2024-03-18,9822
1455,集盛,125,45,80,元大-土城學府,2024-03-19,9822
00687B,國泰20年美債,78,2,76,元大-土城學府,2024-03-19,9822
00680L,元大美債20正2,52,0,52,元大-土城學府,2024-03-19,9822
2316,楠梓電,61,11,50,元大-土城學府,2024-03-19,9822
2371,大同,50,4,46,元大-土城學府,2024-03-19,9822
00679B,元大美債20年,36,0,36,元大-土城學府,2024-03-19,9822
8936,國統,51,20,31,元大-土城學府,2024-03-19,9822
5880,合庫金,32,2,30,元大-土城學府,2024-03-19,9822
2408,南亞科,29,0,29,元大-土城學府,2024-03-19,9822
00941,中信上游半導體,29,1,28,元大-土城學府,2024-03-19,9822
1503,士電,62,36,26,元大-土城學府,2024-03-19,9822
00937B,群益ESG投等債20,27,2,25,元大-土城學府,2024-03-19,9822
2472,立隆電,30,5,25,元大-土城學府,2024-03-19,9822
00918,大華優利高填息30,35,11,24,元大-土城學府,2024-03-19,9822
2515,中工,30,9,21,元大-土城學府,2024-03-19,9822
1718,中纖,20,0,20,元大-土城學府,2024-03-19,9822
2495,普安,20,0,20,元大-土城學府,2024-03-19,9822
00673R,期元大S＆P原油反1,18,0,18,元大-土城學府,2024-03-19,9822
00688L,國泰20年美債正2,24,6,18,元大-土城學府,2024-03-19,9822
00706L,期元大S＆P日圓正2,18,0,18,元大-土城學府,2024-03-19,9822
00712,復華富時不動產,17,0,17,元大-土城學府,2024-03-19,9822
00933B,國泰10Y+金融債,15,0,15,元大-土城學府,2024-03-19,9822
1101,台泥,14,0,14,元大-土城學府,2024-03-19,9822
2002,中鋼,18,5,13,元大-土城學府,2024-03-19,9822
2812,台中銀,13,1,12,元大-土城學府,2024-03-19,9822
2353,宏��,23,11,12,元大-土城學府,2024-03-19,9822
1513,中興電,76,64,12,元大-土城學府,2024-03-19,9822
2374,佳能,12,0,12,元大-土城學府,2024-03-19,9822
00885,富邦越南,11,0,11,元大-土城學府,2024-03-19,9822
00857B,永豐20年美公債,11,0,11,元大-土城學府,2024-03-19,9822
00665L,富邦�琤肭磪囓�2,11,0,11,元大-土城學府,2024-03-19,9822
00795B,中信美國公債20年,10,0,10,元大-土城學府,2024-03-19,9822
2313,華通,22,12,10,元大-土城學府,2024-03-19,9822
2489,瑞軒,10,0,10,元大-土城學府,2024-03-19,9822
6538,倉和,12,2,10,元大-土城學府,2024-03-19,9822
3017,奇鋐,19,9,10,元大-土城學府,2024-03-19,9822
3591,艾笛森,9,0,9,元大-土城學府,2024-03-19,9822
8213,志超,10,1,9,元大-土城學府,2024-03-19,9822
00931B,統一美債20年,8,0,8,元大-土城學府,2024-03-19,9822
2329,華泰,21,13,8,元大-土城學府,2024-03-19,9822
3518,柏騰,8,0,8,元大-土城學府,2024-03-19,9822
3712,永崴投控,8,0,8,元大-土城學府,2024-03-19,9822
00751B,元大AAA至A公司債,7,0,7,元大-土城學府,2024-03-19,9822
2834,臺企銀,11,4,7,元大-土城學府,2024-03-19,9822
2206,三陽工業,7,0,7,元大-土城學府,2024-03-19,9822
2539,櫻花建,7,0,7,元大-土城學府,2024-03-19,9822
2889,國票金,7,0,7,元大-土城學府,2024-03-19,9822
8112,至上,11,4,7,元大-土城學府,2024-03-19,9822
2887,台新金,6,0,6,元大-土城學府,2024-03-19,9822
2421,建準,8,2,6,元大-土城學府,2024-03-19,9822
00939,統一台灣高息動能,1605,397,1208,元大-土城學府,2024-03-20,9822
00919,群益台灣精選高息,567,465,102,元大-土城學府,2024-03-20,9822
2356,英業達,107,12,95,元大-土城學府,2024-03-20,9822
00937B,群益ESG投等債20,53,1,52,元大-土城學府,2024-03-20,9822
2031,新光鋼,46,0,46,元大-土城學府,2024-03-20,9822
6770,力積電,45,1,44,元大-土城學府,2024-03-20,9822
2344,華邦電,33,0,33,元大-土城學府,2024-03-20,9822
00650L,復華香港正2,30,0,30,元大-土城學府,2024-03-20,9822
2354,鴻準,62,33,29,元大-土城學府,2024-03-20,9822
2609,陽明,41,16,25,元大-土城學府,2024-03-20,9822
00688L,國泰20年美債正2,24,0,24,元大-土城學府,2024-03-20,9822
2916,滿心,24,0,24,元大-土城學府,2024-03-20,9822
1535,中宇,23,0,23,元大-土城學府,2024-03-20,9822
1101,台泥,23,1,22,元大-土城學府,2024-03-20,9822
00933B,國泰10Y+金融債,22,0,22,元大-土城學府,2024-03-20,9822
4938,和碩,38,17,21,元大-土城學府,2024-03-20,9822
8936,國統,29,8,21,元大-土城學府,2024-03-20,9822
2313,華通,23,3,20,元大-土城學府,2024-03-20,9822
9907,統一實,20,0,20,元大-土城學府,2024-03-20,9822
2382,廣達,28,8,20,元大-土城學府,2024-03-20,9822
00725B,國泰投資級公司債,20,0,20,元大-土城學府,2024-03-20,9822
2376,技嘉,24,6,18,元大-土城學府,2024-03-20,9822
1503,士電,33,15,18,元大-土城學府,2024-03-20,9822
2885,元大金,18,1,17,元大-土城學府,2024-03-20,9822
6158,禾昌,15,0,15,元大-土城學府,2024-03-20,9822
00680L,元大美債20正2,14,0,14,元大-土城學府,2024-03-20,9822
3322,建舜電,15,1,14,元大-土城學府,2024-03-20,9822
2618,長榮航,15,2,13,元大-土城學府,2024-03-20,9822
8112,至上,21,8,13,元大-土城學府,2024-03-20,9822
4129,聯合,12,0,12,元大-土城學府,2024-03-20,9822
2489,瑞軒,12,0,12,元大-土城學府,2024-03-20,9822
00921,兆豐龍頭等權重,18,6,12,元大-土城學府,2024-03-20,9822
8086,宏捷科,12,1,11,元大-土城學府,2024-03-20,9822
2002,中鋼,11,0,11,元大-土城學府,2024-03-20,9822
3583,辛耘,10,0,10,元大-土城學府,2024-03-20,9822
00795B,中信美國公債20年,10,0,10,元大-土城學府,2024-03-20,9822
00715L,期街口布蘭特正2,10,0,10,元大-土城學府,2024-03-20,9822
00673R,期元大S＆P原油反1,10,0,10,元大-土城學府,2024-03-20,9822
1218,泰山,10,0,10,元大-土城學府,2024-03-20,9822
1529,樂事綠能,10,0,10,元大-土城學府,2024-03-20,9822
2645,長榮航太,10,0,10,元大-土城學府,2024-03-20,9822
3363,上詮,10,0,10,元大-土城學府,2024-03-20,9822
5701,劍湖山,10,0,10,元大-土城學府,2024-03-20,9822
6217,中探針,10,0,10,元大-土城學府,2024-03-20,9822
6234,高僑,10,0,10,元大-土城學府,2024-03-20,9822
00687B,國泰20年美債,9,0,9,元大-土城學府,2024-03-20,9822
00713,元大台灣高息低波,11,2,9,元大-土城學府,2024-03-20,9822
1301,台塑,10,1,9,元大-土城學府,2024-03-20,9822
00857B,永豐20年美公債,9,0,9,元大-土城學府,2024-03-20,9822
6005,群益證,8,0,8,元大-土城學府,2024-03-20,9822
00706L,期元大S＆P日圓正2,302,0,302,元大-土城學府,2024-03-21,9822
1455,集盛,139,40,99,元大-土城學府,2024-03-21,9822
00680L,元大美債20正2,76,0,76,元大-土城學府,2024-03-21,9822
00937B,群益ESG投等債20,61,0,61,元大-土城學府,2024-03-21,9822
00687B,國泰20年美債,58,0,58,元大-土城學府,2024-03-21,9822
3481,群創,69,13,56,元大-土城學府,2024-03-21,9822
2888,新光金,51,16,35,元大-土城學府,2024-03-21,9822
8936,國統,46,11,35,元大-土城學府,2024-03-21,9822
2301,光寶科,34,4,30,元大-土城學府,2024-03-21,9822
2609,陽明,41,15,26,元大-土城學府,2024-03-21,9822
1314,中石化,23,0,23,元大-土城學府,2024-03-21,9822
2834,臺企銀,22,0,22,元大-土城學府,2024-03-21,9822
1503,士電,47,26,21,元大-土城學府,2024-03-21,9822
2405,輔信,28,7,21,元大-土城學府,2024-03-21,9822
2376,技嘉,27,8,19,元大-土城學府,2024-03-21,9822
00857B,永豐20年美公債,19,1,18,元大-土城學府,2024-03-21,9822
00688L,國泰20年美債正2,17,0,17,元大-土城學府,2024-03-21,9822
3005,神基,37,21,16,元大-土城學府,2024-03-21,9822
6191,精成科,32,16,16,元大-土城學府,2024-03-21,9822
2374,佳能,20,5,15,元大-土城學府,2024-03-21,9822
9907,統一實,15,0,15,元大-土城學府,2024-03-21,9822
00679B,元大美債20年,13,0,13,元大-土城學府,2024-03-21,9822
6176,瑞儀,15,2,13,元大-土城學府,2024-03-21,9822
5452,佶優,23,10,13,元大-土城學府,2024-03-21,9822
00930,永豐ESG低碳高息,12,0,12,元大-土城學府,2024-03-21,9822
00941,中信上游半導體,41,29,12,元大-土城學府,2024-03-21,9822
3017,奇鋐,22,10,12,元大-土城學府,2024-03-21,9822
2371,大同,21,10,11,元大-土城學府,2024-03-21,9822
4533,協易機,15,4,11,元大-土城學府,2024-03-21,9822
00918,大華優利高填息30,28,17,11,元大-土城學府,2024-03-21,9822
00673R,期元大S＆P原油反1,10,0,10,元大-土城學府,2024-03-21,9822
00921,兆豐龍頭等權重,10,0,10,元大-土城學府,2024-03-21,9822
2314,台揚,10,0,10,元大-土城學府,2024-03-21,9822
3360,尚立,10,0,10,元大-土城學府,2024-03-21,9822
6443,元晶,18,8,10,元大-土城學府,2024-03-21,9822
8383,千附,10,0,10,元大-土城學府,2024-03-21,9822
2323,中環,21,12,9,元大-土城學府,2024-03-21,9822
5443,均豪,11,2,9,元大-土城學府,2024-03-21,9822
5469,瀚宇博,18,9,9,元大-土城學府,2024-03-21,9822
8050,廣積,11,2,9,元大-土城學府,2024-03-21,9822
1504,東元,31,22,9,元大-土城學府,2024-03-21,9822
3033,威健,11,3,8,元大-土城學府,2024-03-21,9822
3035,智原,7,0,7,元大-土城學府,2024-03-21,9822
3227,原相,11,4,7,元大-土城學府,2024-03-21,9822
3706,神達,166,159,7,元大-土城學府,2024-03-21,9822
4938,和碩,19,12,7,元大-土城學府,2024-03-21,9822
2337,旺宏,15,9,6,元大-土城學府,2024-03-21,9822
2399,映泰,6,0,6,元大-土城學府,2024-03-21,9822
6116,彩晶,6,0,6,元大-土城學府,2024-03-21,9822
6414,樺漢,6,0,6,元大-土城學府,2024-03-21,9822
00632R,元大台灣50反1,215,30,185,元大-土城學府,2024-03-22,9822
3481,群創,234,49,185,元大-土城學府,2024-03-22,9822
00937B,群益ESG投等債20,68,0,68,元大-土城學府,2024-03-22,9822
2449,京元電子,81,14,67,元大-土城學府,2024-03-22,9822
00941,中信上游半導體,99,34,65,元大-土城學府,2024-03-22,9822
00688L,國泰20年美債正2,58,0,58,元大-土城學府,2024-03-22,9822
6443,元晶,86,35,51,元大-土城學府,2024-03-22,9822
2353,宏��,100,50,50,元大-土城學府,2024-03-22,9822
1522,堤維西,42,3,39,元大-土城學府,2024-03-22,9822
2317,鴻海,97,60,37,元大-土城學府,2024-03-22,9822
3706,神達,89,53,36,元大-土城學府,2024-03-22,9822
00665L,富邦�琤肭磪囓�2,34,0,34,元大-土城學府,2024-03-22,9822
00878,國泰永續高股息,41,11,30,元大-土城學府,2024-03-22,9822
00930,永豐ESG低碳高息,30,0,30,元大-土城學府,2024-03-22,9822
00679B,元大美債20年,35,5,30,元大-土城學府,2024-03-22,9822
2916,滿心,31,1,30,元大-土城學府,2024-03-22,9822
3689,湧德,30,0,30,元大-土城學府,2024-03-22,9822
8936,國統,44,14,30,元大-土城學府,2024-03-22,9822
2834,臺企銀,29,0,29,元大-土城學府,2024-03-22,9822
2883,凱基金,28,1,27,元大-土城學府,2024-03-22,9822
2374,佳能,26,0,26,元大-土城學府,2024-03-22,9822
912000,晨訊科-DR,25,0,25,元大-土城學府,2024-03-22,9822
2354,鴻準,54,33,21,元大-土城學府,2024-03-22,9822
5483,中美晶,21,1,20,元大-土城學府,2024-03-22,9822
2371,大同,32,12,20,元大-土城學府,2024-03-22,9822
1503,士電,41,22,19,元大-土城學府,2024-03-22,9822
8112,至上,30,14,16,元大-土城學府,2024-03-22,9822
00687B,國泰20年美債,15,0,15,元大-土城學府,2024-03-22,9822
2324,仁寶,42,27,15,元大-土城學府,2024-03-22,9822
3029,零壹,15,0,15,元大-土城學府,2024-03-22,9822
6158,禾昌,15,0,15,元大-土城學府,2024-03-22,9822
1616,億泰,16,2,14,元大-土城學府,2024-03-22,9822
2609,陽明,13,0,13,元大-土城學府,2024-03-22,9822
2888,新光金,13,0,13,元大-土城學府,2024-03-22,9822
8150,南茂,13,0,13,元大-土城學府,2024-03-22,9822
1316,上曜,16,4,12,元大-土城學府,2024-03-22,9822
4938,和碩,15,3,12,元大-土城學府,2024-03-22,9822
2603,長榮,64,52,12,元大-土城學府,2024-03-22,9822
2303,聯電,15,4,11,元大-土城學府,2024-03-22,9822
3083,網龍,13,2,11,元大-土城學府,2024-03-22,9822
3005,神基,22,11,11,元大-土城學府,2024-03-22,9822
3548,兆利,13,3,10,元大-土城學府,2024-03-22,9822
00673R,期元大S＆P原油反1,10,0,10,元大-土城學府,2024-03-22,9822
1313,聯成,10,0,10,元大-土城學府,2024-03-22,9822
00680L,元大美債20正2,58,48,10,元大-土城學府,2024-03-22,9822
2408,南亞科,24,15,9,元大-土城學府,2024-03-22,9822
9941,裕融,9,0,9,元大-土城學府,2024-03-22,9822
6163,華電網,9,0,9,元大-土城學府,2024-03-22,9822
1101,台泥,11,3,8,元大-土城學府,2024-03-22,9822
6188,廣明,16,8,8,元大-土城學府,2024-03-22,9822
00937B,群益ESG投等債20,202,3,199,元大-土城學府,2024-03-25,9822
2356,英業達,242,57,185,元大-土城學府,2024-03-25,9822
1455,集盛,220,120,100,元大-土城學府,2024-03-25,9822
00941,中信上游半導體,246,189,57,元大-土城學府,2024-03-25,9822
2358,廷鑫,50,0,50,元大-土城學府,2024-03-25,9822
8112,至上,53,4,49,元大-土城學府,2024-03-25,9822
2867,三商壽,46,0,46,元大-土城學府,2024-03-25,9822
00919,群益台灣精選高息,107,61,46,元大-土城學府,2024-03-25,9822
00679B,元大美債20年,43,10,33,元大-土城學府,2024-03-25,9822
2359,所羅門,34,2,32,元大-土城學府,2024-03-25,9822
6188,廣明,52,21,31,元大-土城學府,2024-03-25,9822
00646,元大S＆P500,25,0,25,元大-土城學府,2024-03-25,9822
3059,華晶科,38,15,23,元大-土城學府,2024-03-25,9822
2353,宏��,84,61,23,元大-土城學府,2024-03-25,9822
2009,第一銅,29,7,22,元大-土城學府,2024-03-25,9822
5483,中美晶,21,0,21,元大-土城學府,2024-03-25,9822
5347,世界,27,6,21,元大-土城學府,2024-03-25,9822
2303,聯電,26,5,21,元大-土城學府,2024-03-25,9822
00632R,元大台灣50反1,20,0,20,元大-土城學府,2024-03-25,9822
1714,和桐,20,0,20,元大-土城學府,2024-03-25,9822
2515,中工,23,3,20,元大-土城學府,2024-03-25,9822
3265,台星科,20,0,20,元大-土城學府,2024-03-25,9822
3231,緯創,41,22,19,元大-土城學府,2024-03-25,9822
2816,旺旺保,17,0,17,元大-土城學府,2024-03-25,9822
2301,光寶科,15,1,14,元大-土城學府,2024-03-25,9822
2888,新光金,14,0,14,元大-土城學府,2024-03-25,9822
00725B,國泰投資級公司債,13,0,13,元大-土城學府,2024-03-25,9822
2314,台揚,13,0,13,元大-土城學府,2024-03-25,9822
2376,技嘉,26,13,13,元大-土城學府,2024-03-25,9822
00885,富邦越南,12,0,12,元大-土城學府,2024-03-25,9822
1504,東元,14,2,12,元大-土城學府,2024-03-25,9822
5603,陸海,12,0,12,元大-土城學府,2024-03-25,9822
6146,耕興,12,0,12,元大-土城學府,2024-03-25,9822
6451,訊芯-KY,12,0,12,元大-土城學府,2024-03-25,9822
3035,智原,16,5,11,元大-土城學府,2024-03-25,9822
00687B,國泰20年美債,10,0,10,元大-土城學府,2024-03-25,9822
2449,京元電子,19,9,10,元大-土城學府,2024-03-25,9822
00673R,期元大S＆P原油反1,10,0,10,元大-土城學府,2024-03-25,9822
00751B,元大AAA至A公司債,10,0,10,元大-土城學府,2024-03-25,9822
1589,永冠-KY,10,0,10,元大-土城學府,2024-03-25,9822
6735,美達科技,10,0,10,元大-土城學府,2024-03-25,9822
8936,國統,15,5,10,元大-土城學府,2024-03-25,9822
2374,佳能,10,0,10,元大-土城學府,2024-03-25,9822
3548,兆利,13,3,10,元大-土城學府,2024-03-25,9822
00915,凱基優選高股息30,9,0,9,元大-土城學府,2024-03-25,9822
00715L,期街口布蘭特正2,10,1,9,元大-土城學府,2024-03-25,9822
2889,國票金,10,1,9,元大-土城學府,2024-03-25,9822
3704,合勤控,9,0,9,元大-土城學府,2024-03-25,9822
5701,劍湖山,9,0,9,元大-土城學府,2024-03-25,9822
6191,精成科,8,0,8,元大-土城學府,2024-03-25,9822
2883,凱基金,403,19,384,元大-土城學府,2024-03-26,9822
00937B,群益ESG投等債20,233,9,224,元大-土城學府,2024-03-26,9822
2356,英業達,251,66,185,元大-土城學府,2024-03-26,9822
00939,統一台灣高息動能,129,8,121,元大-土城學府,2024-03-26,9822
2359,所羅門,117,22,95,元大-土城學府,2024-03-26,9822
00941,中信上游半導體,117,28,89,元大-土城學府,2024-03-26,9822
3231,緯創,100,34,66,元大-土城學府,2024-03-26,9822
1455,集盛,230,180,50,元大-土城學府,2024-03-26,9822
2374,佳能,41,0,41,元大-土城學府,2024-03-26,9822
8936,國統,59,23,36,元大-土城學府,2024-03-26,9822
1504,東元,54,21,33,元大-土城學府,2024-03-26,9822
00933B,國泰10Y+金融債,33,0,33,元大-土城學府,2024-03-26,9822
00679B,元大美債20年,38,6,32,元大-土城學府,2024-03-26,9822
00665L,富邦�琤肭磪囓�2,30,0,30,元大-土城學府,2024-03-26,9822
5452,佶優,29,2,27,元大-土城學府,2024-03-26,9822
2609,陽明,31,6,25,元大-土城學府,2024-03-26,9822
2344,華邦電,41,19,22,元大-土城學府,2024-03-26,9822
3037,欣興,29,7,22,元大-土城學府,2024-03-26,9822
00720B,元大投資級公司債,25,3,22,元大-土城學府,2024-03-26,9822
00632R,元大台灣50反1,20,0,20,元大-土城學府,2024-03-26,9822
1815,富喬,32,13,19,元大-土城學府,2024-03-26,9822
5009,榮剛,19,0,19,元大-土城學府,2024-03-26,9822
2303,聯電,38,19,19,元大-土城學府,2024-03-26,9822
2618,長榮航,27,11,16,元大-土城學府,2024-03-26,9822
2049,上銀,19,3,16,元大-土城學府,2024-03-26,9822
2324,仁寶,30,14,16,元大-土城學府,2024-03-26,9822
3017,奇鋐,24,8,16,元大-土城學府,2024-03-26,9822
2727,王品,15,0,15,元大-土城學府,2024-03-26,9822
1701,中化,15,0,15,元大-土城學府,2024-03-26,9822
1609,大亞,141,126,15,元大-土城學府,2024-03-26,9822
1514,亞力,38,24,14,元大-土城學府,2024-03-26,9822
2399,映泰,14,0,14,元大-土城學府,2024-03-26,9822
6125,廣運,55,42,13,元大-土城學府,2024-03-26,9822
6770,力積電,12,0,12,元大-土城學府,2024-03-26,9822
00878,國泰永續高股息,43,31,12,元大-土城學府,2024-03-26,9822
2301,光寶科,12,2,10,元大-土城學府,2024-03-26,9822
00664R,國泰臺灣加權反1,10,0,10,元大-土城學府,2024-03-26,9822
2880,華南金,10,0,10,元大-土城學府,2024-03-26,9822
3325,旭品,10,0,10,元大-土城學府,2024-03-26,9822
5864,致和證,10,0,10,元大-土城學府,2024-03-26,9822
6547,高端疫苗,10,0,10,元大-土城學府,2024-03-26,9822
2367,燿華,24,14,10,元大-土城學府,2024-03-26,9822
3044,健鼎,10,1,9,元大-土城學府,2024-03-26,9822
2441,超豐,9,0,9,元大-土城學府,2024-03-26,9822
2610,華航,10,1,9,元大-土城學府,2024-03-26,9822
4953,緯軟,9,0,9,元大-土城學府,2024-03-26,9822
5608,四維航,9,0,9,元大-土城學府,2024-03-26,9822
6456,GIS-KY,9,0,9,元大-土城學府,2024-03-26,9822
6753,龍德造船,10,1,9,元大-土城學府,2024-03-26,9822
2887,台新金,11,2,9,元大-土城學府,2024-03-26,9822
00937B,群益ESG投等債20,475,10,465,元大-土城學府,2024-03-27,9822
00679B,元大美債20年,192,9,183,元大-土城學府,2024-03-27,9822
2317,鴻海,89,35,54,元大-土城學府,2024-03-27,9822
8222,寶一,55,6,49,元大-土城學府,2024-03-27,9822
5515,建國,51,2,49,元大-土城學府,2024-03-27,9822
1522,堤維西,45,8,37,元大-土城學府,2024-03-27,9822
6158,禾昌,35,0,35,元大-土城學府,2024-03-27,9822
1307,三芳,34,0,34,元大-土城學府,2024-03-27,9822
00918,大華優利高填息30,32,0,32,元大-土城學府,2024-03-27,9822
1513,中興電,58,34,24,元大-土城學府,2024-03-27,9822
3322,建舜電,20,0,20,元大-土城學府,2024-03-27,9822
5701,劍湖山,20,0,20,元大-土城學府,2024-03-27,9822
2308,台達電,19,0,19,元大-土城學府,2024-03-27,9822
2303,聯電,25,6,19,元大-土城學府,2024-03-27,9822
2353,宏��,27,9,18,元大-土城學府,2024-03-27,9822
0056,元大高股息,24,6,18,元大-土城學府,2024-03-27,9822
6129,普誠,18,1,17,元大-土城學府,2024-03-27,9822
3231,緯創,31,15,16,元大-土城學府,2024-03-27,9822
00941,中信上游半導體,124,109,15,元大-土城學府,2024-03-27,9822
2301,光寶科,16,1,15,元大-土城學府,2024-03-27,9822
2388,威盛,15,0,15,元大-土城學府,2024-03-27,9822
2344,華邦電,30,16,14,元大-土城學府,2024-03-27,9822
6457,紘康,13,1,12,元大-土城學府,2024-03-27,9822
1905,華紙,13,2,11,元大-土城學府,2024-03-27,9822
3622,洋華,12,1,11,元大-土城學府,2024-03-27,9822
2409,友達,12,1,11,元大-土城學府,2024-03-27,9822
6770,力積電,17,7,10,元大-土城學府,2024-03-27,9822
1785,光洋科,15,5,10,元大-土城學府,2024-03-27,9822
00673R,期元大S＆P原油反1,10,0,10,元大-土城學府,2024-03-27,9822
00665L,富邦�琤肭磪囓�2,40,30,10,元大-土城學府,2024-03-27,9822
2359,所羅門,32,22,10,元大-土城學府,2024-03-27,9822
3058,立德,12,2,10,元大-土城學府,2024-03-27,9822
8926,台汽電,11,2,9,元大-土城學府,2024-03-27,9822
2323,中環,10,1,9,元大-土城學府,2024-03-27,9822
3202,樺晟,9,0,9,元大-土城學府,2024-03-27,9822
3481,群創,11,2,9,元大-土城學府,2024-03-27,9822
8936,國統,23,14,9,元大-土城學府,2024-03-27,9822
2002,中鋼,9,1,8,元大-土城學府,2024-03-27,9822
1815,富喬,9,1,8,元大-土城學府,2024-03-27,9822
8070,長華*,8,0,8,元大-土城學府,2024-03-27,9822
5880,合庫金,11,3,8,元大-土城學府,2024-03-27,9822
2417,圓剛,7,0,7,元大-土城學府,2024-03-27,9822
6144,得利影,7,0,7,元大-土城學府,2024-03-27,9822
6150,撼訊,7,0,7,元大-土城學府,2024-03-27,9822
6188,廣明,7,0,7,元大-土城學府,2024-03-27,9822
2609,陽明,10,3,7,元大-土城學府,2024-03-27,9822
00850,元大臺灣ESG永續,7,1,6,元大-土城學府,2024-03-27,9822
2345,智邦,8,2,6,元大-土城學府,2024-03-27,9822
5439,高技,6,0,6,元大-土城學府,2024-03-27,9822
6456,GIS-KY,15,9,6,元大-土城學府,2024-03-27,9822
9105,泰金寶-DR,450,10,440,元大-土城學府,2024-03-28,9822
2883,凱基金,186,54,132,元大-土城學府,2024-03-28,9822
6016,康和證,100,0,100,元大-土城學府,2024-03-28,9822
00919,群益台灣精選高息,158,69,89,元大-土城學府,2024-03-28,9822
3058,立德,54,0,54,元大-土城學府,2024-03-28,9822
2867,三商壽,50,0,50,元大-土城學府,2024-03-28,9822
1609,大亞,69,28,41,元大-土城學府,2024-03-28,9822
00927,群益半導體收益,39,0,39,元大-土城學府,2024-03-28,9822
2356,英業達,88,52,36,元大-土城學府,2024-03-28,9822
2354,鴻準,125,90,35,元大-土城學府,2024-03-28,9822
2618,長榮航,47,13,34,元大-土城學府,2024-03-28,9822
3706,神達,45,12,33,元大-土城學府,2024-03-28,9822
2344,華邦電,42,12,30,元大-土城學府,2024-03-28,9822
00772B,中信高評級公司債,30,2,28,元大-土城學府,2024-03-28,9822
2329,華泰,32,4,28,元大-土城學府,2024-03-28,9822
2359,所羅門,31,3,28,元大-土城學府,2024-03-28,9822
00680L,元大美債20正2,26,0,26,元大-土城學府,2024-03-28,9822
1608,華榮,46,22,24,元大-土城學府,2024-03-28,9822
2367,燿華,36,15,21,元大-土城學府,2024-03-28,9822
00939,統一台灣高息動能,24,4,20,元大-土城學府,2024-03-28,9822
1307,三芳,19,1,18,元大-土城學府,2024-03-28,9822
00941,中信上游半導體,117,100,17,元大-土城學府,2024-03-28,9822
6144,得利影,16,0,16,元大-土城學府,2024-03-28,9822
3005,神基,23,10,13,元大-土城學府,2024-03-28,9822
2609,陽明,13,1,12,元大-土城學府,2024-03-28,9822
2515,中工,18,6,12,元大-土城學府,2024-03-28,9822
2374,佳能,12,0,12,元大-土城學府,2024-03-28,9822
2888,新光金,12,0,12,元大-土城學府,2024-03-28,9822
6179,亞通,13,1,12,元大-土城學府,2024-03-28,9822
1513,中興電,21,10,11,元大-土城學府,2024-03-28,9822
8936,國統,27,16,11,元大-土城學府,2024-03-28,9822
3504,揚明光,11,0,11,元大-土城學府,2024-03-28,9822
6146,耕興,11,0,11,元大-土城學府,2024-03-28,9822
00687B,國泰20年美債,10,0,10,元大-土城學府,2024-03-28,9822
1316,上曜,18,8,10,元大-土城學府,2024-03-28,9822
2530,華建,10,0,10,元大-土城學府,2024-03-28,9822
8068,全達,10,0,10,元大-土城學府,2024-03-28,9822
9802,鈺齊-KY,10,0,10,元大-土城學府,2024-03-28,9822
2324,仁寶,13,4,9,元大-土城學府,2024-03-28,9822
00646,元大S＆P500,9,0,9,元大-土城學府,2024-03-28,9822
6477,安集,12,3,9,元大-土城學府,2024-03-28,9822
2328,廣宇,19,10,9,元大-土城學府,2024-03-28,9822
00915,凱基優選高股息30,12,4,8,元大-土城學府,2024-03-28,9822
4906,正文,14,7,7,元大-土城學府,2024-03-28,9822
3264,欣銓,8,1,7,元大-土城學府,2024-03-28,9822
00922,國泰台灣領袖50,7,0,7,元大-土城學府,2024-03-28,9822
2408,南亞科,7,0,7,元大-土城學府,2024-03-28,9822
2855,統一證,8,1,7,元大-土城學府,2024-03-28,9822
6158,禾昌,7,0,7,元大-土城學府,2024-03-28,9822
6129,普誠,7,0,7,元大-土城學府,2024-03-28,9822
00937B,群益ESG投等債20,132,12,120,元大-土城學府,2024-03-29,9822
1702,南僑,48,0,48,元大-土城學府,2024-03-29,9822
3703,欣陸,49,4,45,元大-土城學府,2024-03-29,9822
2301,光寶科,50,14,36,元大-土城學府,2024-03-29,9822
1517,利奇,34,0,34,元大-土城學府,2024-03-29,9822
00919,群益台灣精選高息,78,54,24,元大-土城學府,2024-03-29,9822
00929,復華台灣科技優息,34,14,20,元大-土城學府,2024-03-29,9822
2605,新興,20,0,20,元大-土城學府,2024-03-29,9822
1307,三芳,16,0,16,元大-土城學府,2024-03-29,9822
00933B,國泰10Y+金融債,27,12,15,元大-土城學府,2024-03-29,9822
00706L,期元大S＆P日圓正2,15,0,15,元大-土城學府,2024-03-29,9822
2458,義隆,15,0,15,元大-土城學府,2024-03-29,9822
0056,元大高股息,23,10,13,元大-土城學府,2024-03-29,9822
2317,鴻海,80,67,13,元大-土城學府,2024-03-29,9822
3017,奇鋐,20,7,13,元大-土城學府,2024-03-29,9822
00939,統一台灣高息動能,17,4,13,元大-土城學府,2024-03-29,9822
3710,連展投控,13,0,13,元大-土城學府,2024-03-29,9822
00941,中信上游半導體,125,113,12,元大-土城學府,2024-03-29,9822
1609,大亞,25,13,12,元大-土城學府,2024-03-29,9822
00673R,期元大S＆P原油反1,11,0,11,元大-土城學府,2024-03-29,9822
2359,所羅門,11,0,11,元大-土城學府,2024-03-29,9822
6158,禾昌,11,0,11,元大-土城學府,2024-03-29,9822
00637L,元大滬深300正2,11,0,11,元大-土城學府,2024-03-29,9822
00857B,永豐20年美公債,11,0,11,元大-土城學府,2024-03-29,9822
3628,盈正,10,0,10,元大-土城學府,2024-03-29,9822
3714,富采,10,0,10,元大-土城學府,2024-03-29,9822
2374,佳能,9,0,9,元大-土城學府,2024-03-29,9822
3576,聯合再生,10,1,9,元大-土城學府,2024-03-29,9822
4540,全球傳動,10,1,9,元大-土城學府,2024-03-29,9822
3481,群創,13,4,9,元大-土城學府,2024-03-29,9822
2354,鴻準,62,54,8,元大-土城學府,2024-03-29,9822
2609,陽明,8,0,8,元大-土城學府,2024-03-29,9822
2867,三商壽,8,0,8,元大-土城學府,2024-03-29,9822
4303,信立,14,6,8,元大-土城學府,2024-03-29,9822
2603,長榮,17,10,7,元大-土城學府,2024-03-29,9822
2328,廣宇,17,10,7,元大-土城學府,2024-03-29,9822
1584,精剛,14,7,7,元大-土城學府,2024-03-29,9822
2855,統一證,26,19,7,元大-土城學府,2024-03-29,9822
2324,仁寶,19,12,7,元大-土城學府,2024-03-29,9822
1608,華榮,13,7,6,元大-土城學府,2024-03-29,9822
2201,裕隆,6,0,6,元大-土城學府,2024-03-29,9822
2498,宏達電,6,0,6,元大-土城學府,2024-03-29,9822
3032,偉訓,9,3,6,元大-土城學府,2024-03-29,9822
3058,立德,6,0,6,元大-土城學府,2024-03-29,9822
5284,jpp-KY,6,0,6,元大-土城學府,2024-03-29,9822
2327,國巨,6,0,6,元大-土城學府,2024-03-29,9822
00680L,元大美債20正2,6,0,6,元大-土城學府,2024-03-29,9822
2884,玉山金,10,4,6,元大-土城學府,2024-03-29,9822
3706,神達,13,8,5,元大-土城學府,2024-03-29,9822
1529,樂事綠能,5,0,5,元大-土城學府,2024-03-29,9822
00940,元大台灣價值高息,1277,585,692,元大-土城學府,2024-04-01,9822
00753L,中信中國50正2,100,0,100,元大-土城學府,2024-04-01,9822
2867,三商壽,100,0,100,元大-土城學府,2024-04-01,9822
1815,富喬,113,18,95,元大-土城學府,2024-04-01,9822
00919,群益台灣精選高息,108,19,89,元大-土城學府,2024-04-01,9822
6284,佳邦,75,1,74,元大-土城學府,2024-04-01,9822
2356,英業達,89,20,69,元大-土城學府,2024-04-01,9822
3706,神達,69,3,66,元大-土城學府,2024-04-01,9822
3231,緯創,61,14,47,元大-土城學府,2024-04-01,9822
00937B,群益ESG投等債20,63,19,44,元大-土城學府,2024-04-01,9822
00650L,復華香港正2,40,0,40,元大-土城學府,2024-04-01,9822
911608,明輝-DR,30,0,30,元大-土城學府,2024-04-01,9822
2317,鴻海,67,37,30,元大-土城學府,2024-04-01,9822
1785,光洋科,30,2,28,元大-土城學府,2024-04-01,9822
1517,利奇,27,0,27,元大-土城學府,2024-04-01,9822
2365,昆盈,31,4,27,元大-土城學府,2024-04-01,9822
2891,中信金,26,0,26,元大-土城學府,2024-04-01,9822
912000,晨訊科-DR,31,5,26,元大-土城學府,2024-04-01,9822
00939,統一台灣高息動能,30,5,25,元大-土城學府,2024-04-01,9822
2382,廣達,36,17,19,元大-土城學府,2024-04-01,9822
8936,國統,30,12,18,元大-土城學府,2024-04-01,9822
2603,長榮,22,4,18,元大-土城學府,2024-04-01,9822
2881,富邦金,17,0,17,元大-土城學府,2024-04-01,9822
3512,皇龍,15,0,15,元大-土城學府,2024-04-01,9822
3711,日月光投控,22,7,15,元大-土城學府,2024-04-01,9822
5347,世界,15,1,14,元大-土城學府,2024-04-01,9822
1513,中興電,29,16,13,元大-土城學府,2024-04-01,9822
00915,凱基優選高股息30,13,0,13,元大-土城學府,2024-04-01,9822
3666,光耀,16,3,13,元大-土城學府,2024-04-01,9822
6179,亞通,14,1,13,元大-土城學府,2024-04-01,9822
2801,彰銀,12,0,12,元大-土城學府,2024-04-01,9822
1307,三芳,12,0,12,元大-土城學府,2024-04-01,9822
2371,大同,27,15,12,元大-土城學府,2024-04-01,9822
6213,聯茂,15,3,12,元大-土城學府,2024-04-01,9822
2362,藍天,13,1,12,元大-土城學府,2024-04-01,9822
00646,元大S＆P500,12,1,11,元大-土城學府,2024-04-01,9822
1524,耿鼎,17,6,11,元大-土城學府,2024-04-01,9822
3360,尚立,11,0,11,元大-土城學府,2024-04-01,9822
4303,信立,28,17,11,元大-土城學府,2024-04-01,9822
00632R,元大台灣50反1,10,0,10,元大-土城學府,2024-04-01,9822
00673R,期元大S＆P原油反1,10,0,10,元大-土城學府,2024-04-01,9822
2359,所羅門,11,1,10,元大-土城學府,2024-04-01,9822
8096,擎亞,18,8,10,元大-土城學府,2024-04-01,9822
00715L,期街口布蘭特正2,14,5,9,元大-土城學府,2024-04-01,9822
2353,宏��,14,5,9,元大-土城學府,2024-04-01,9822
5864,致和證,10,1,9,元大-土城學府,2024-04-01,9822
2328,廣宇,13,4,9,元大-土城學府,2024-04-01,9822
00679B,元大美債20年,11,3,8,元大-土城學府,2024-04-01,9822
6219,富旺,8,0,8,元大-土城學府,2024-04-01,9822
00706L,期元大S＆P日圓正2,7,0,7,元大-土城學府,2024-04-01,9822
00937B,群益ESG投等債20,339,27,312,元大-土城學府,2024-04-02,9822
00929,復華台灣科技優息,180,45,135,元大-土城學府,2024-04-02,9822
00679B,元大美債20年,123,1,122,元大-土城學府,2024-04-02,9822
2867,三商壽,100,1,99,元大-土城學府,2024-04-02,9822
911868,同方友友-DR,60,0,60,元大-土城學府,2024-04-02,9822
00632R,元大台灣50反1,45,3,42,元大-土城學府,2024-04-02,9822
2888,新光金,38,0,38,元大-土城學府,2024-04-02,9822
00857B,永豐20年美公債,36,0,36,元大-土城學府,2024-04-02,9822
00687B,國泰20年美債,36,0,36,元大-土城學府,2024-04-02,9822
00941,中信上游半導體,35,0,35,元大-土城學府,2024-04-02,9822
2356,英業達,37,5,32,元大-土城學府,2024-04-02,9822
2472,立隆電,32,0,32,元大-土城學府,2024-04-02,9822
2354,鴻準,63,31,32,元大-土城學府,2024-04-02,9822
5371,中光電,49,20,29,元大-土城學府,2024-04-02,9822
3122,笙泉,27,0,27,元大-土城學府,2024-04-02,9822
2344,華邦電,29,3,26,元大-土城學府,2024-04-02,9822
2891,中信金,25,1,24,元大-土城學府,2024-04-02,9822
2367,燿華,36,13,23,元大-土城學府,2024-04-02,9822
4909,新復興,46,23,23,元大-土城學府,2024-04-02,9822
00680L,元大美債20正2,22,0,22,元大-土城學府,2024-04-02,9822
6144,得利影,21,0,21,元大-土城學府,2024-04-02,9822
00751B,元大AAA至A公司債,20,0,20,元大-土城學府,2024-04-02,9822
2301,光寶科,26,7,19,元大-土城學府,2024-04-02,9822
2530,華建,20,1,19,元大-土城學府,2024-04-02,9822
1517,利奇,17,0,17,元大-土城學府,2024-04-02,9822
00673R,期元大S＆P原油反1,16,0,16,元大-土城學府,2024-04-02,9822
6284,佳邦,16,0,16,元大-土城學府,2024-04-02,9822
1609,大亞,19,5,14,元大-土城學府,2024-04-02,9822
00939,統一台灣高息動能,19,7,12,元大-土城學府,2024-04-02,9822
00772B,中信高評級公司債,12,0,12,元大-土城學府,2024-04-02,9822
2365,昆盈,21,9,12,元大-土城學府,2024-04-02,9822
00933B,國泰10Y+金融債,11,0,11,元大-土城學府,2024-04-02,9822
6191,精成科,11,0,11,元大-土城學府,2024-04-02,9822
00720B,元大投資級公司債,28,18,10,元大-土城學府,2024-04-02,9822
2485,兆赫,10,0,10,元大-土城學府,2024-04-02,9822
00885,富邦越南,10,0,10,元大-土城學府,2024-04-02,9822
00773B,中信優先金融債,10,0,10,元大-土城學府,2024-04-02,9822
1316,上曜,11,1,10,元大-土城學府,2024-04-02,9822
1709,和益,10,0,10,元大-土城學府,2024-04-02,9822
2610,華航,10,0,10,元大-土城學府,2024-04-02,9822
9958,世紀鋼,10,0,10,元大-土城學府,2024-04-02,9822
2408,南亞科,11,1,10,元大-土城學府,2024-04-02,9822
2316,楠梓電,9,0,9,元大-土城學府,2024-04-02,9822
6215,和椿,10,1,9,元大-土城學府,2024-04-02,9822
2371,大同,19,10,9,元大-土城學府,2024-04-02,9822
00646,元大S＆P500,8,0,8,元大-土城學府,2024-04-02,9822
2401,凌陽,8,0,8,元大-土城學府,2024-04-02,9822
2603,長榮,23,16,7,元大-土城學府,2024-04-02,9822
00724B,群益投資級金融債,7,0,7,元大-土城學府,2024-04-02,9822
00935,野村臺灣新科技50,15,8,7,元大-土城學府,2024-04-02,9822
2323,中環,130,1,129,元大-土城學府,2024-04-03,9822
00940,元大台灣價值高息,706,630,76,元大-土城學府,2024-04-03,9822
00937B,群益ESG投等債20,43,0,43,元大-土城學府,2024-04-03,9822
00687B,國泰20年美債,45,3,42,元大-土城學府,2024-04-03,9822
3010,華立,39,1,38,元大-土城學府,2024-04-03,9822
00941,中信上游半導體,38,3,35,元大-土城學府,2024-04-03,9822
2317,鴻海,47,12,35,元大-土城學府,2024-04-03,9822
00919,群益台灣精選高息,108,77,31,元大-土城學府,2024-04-03,9822
1513,中興電,34,4,30,元大-土城學府,2024-04-03,9822
00929,復華台灣科技優息,84,55,29,元大-土城學府,2024-04-03,9822
00673R,期元大S＆P原油反1,23,0,23,元大-土城學府,2024-04-03,9822
00679B,元大美債20年,28,5,23,元大-土城學府,2024-04-03,9822
00688L,國泰20年美債正2,21,0,21,元大-土城學府,2024-04-03,9822
4956,光鋐,21,0,21,元大-土城學府,2024-04-03,9822
5521,工信,20,0,20,元大-土城學府,2024-04-03,9822
00680L,元大美債20正2,20,0,20,元大-土城學府,2024-04-03,9822
00907,永豐優息存股,19,0,19,元大-土城學府,2024-04-03,9822
2301,光寶科,26,8,18,元大-土城學府,2024-04-03,9822
2359,所羅門,20,3,17,元大-土城學府,2024-04-03,9822
2371,大同,18,3,15,元大-土城學府,2024-04-03,9822
3703,欣陸,21,6,15,元大-土城學府,2024-04-03,9822
6213,聯茂,29,14,15,元大-土城學府,2024-04-03,9822
6144,得利影,15,1,14,元大-土城學府,2024-04-03,9822
3481,群創,15,2,13,元大-土城學府,2024-04-03,9822
00712,復華富時不動產,23,10,13,元大-土城學府,2024-04-03,9822
2515,中工,49,37,12,元大-土城學府,2024-04-03,9822
2303,聯電,15,4,11,元大-土城學府,2024-04-03,9822
2801,彰銀,11,0,11,元大-土城學府,2024-04-03,9822
00720B,元大投資級公司債,11,0,11,元大-土城學府,2024-04-03,9822
3363,上詮,12,1,11,元大-土城學府,2024-04-03,9822
00927,群益半導體收益,10,0,10,元大-土城學府,2024-04-03,9822
1587,吉茂,10,0,10,元大-土城學府,2024-04-03,9822
1709,和益,10,0,10,元大-土城學府,2024-04-03,9822
2610,華航,10,0,10,元大-土城學府,2024-04-03,9822
3056,富華新,10,0,10,元大-土城學府,2024-04-03,9822
6789,采鈺,10,0,10,元大-土城學府,2024-04-03,9822
1101,台泥,22,13,9,元大-土城學府,2024-04-03,9822
00857B,永豐20年美公債,9,0,9,元大-土城學府,2024-04-03,9822
3078,僑威,9,0,9,元大-土城學府,2024-04-03,9822
6158,禾昌,10,1,9,元大-土城學府,2024-04-03,9822
8046,南電,10,1,9,元大-土城學府,2024-04-03,9822
00878,國泰永續高股息,9,1,8,元大-土城學府,2024-04-03,9822
2382,廣達,18,10,8,元大-土城學府,2024-04-03,9822
2409,友達,9,1,8,元大-土城學府,2024-04-03,9822
2023,燁輝,8,0,8,元大-土城學府,2024-04-03,9822
3234,光環,8,0,8,元大-土城學府,2024-04-03,9822
3706,神達,12,4,8,元大-土城學府,2024-04-03,9822
8088,品安,17,9,8,元大-土城學府,2024-04-03,9822
8171,天宇,8,0,8,元大-土城學府,2024-04-03,9822
00933B,國泰10Y+金融債,7,0,7,元大-土城學府,2024-04-03,9822
00940,元大台灣價值高息,275,48,227,元大-土城學府,2024-04-08,9822
00929,復華台灣科技優息,185,33,152,元大-土城學府,2024-04-08,9822
2356,英業達,137,1,136,元大-土城學府,2024-04-08,9822
00676R,富邦臺灣加權反1,100,0,100,元大-土城學府,2024-04-08,9822
00687B,國泰20年美債,110,28,82,元大-土城學府,2024-04-08,9822
00679B,元大美債20年,86,23,63,元大-土城學府,2024-04-08,9822
2371,大同,45,2,43,元大-土城學府,2024-04-08,9822
6462,神盾,42,1,41,元大-土城學府,2024-04-08,9822
00919,群益台灣精選高息,39,3,36,元大-土城學府,2024-04-08,9822
6770,力積電,34,3,31,元大-土城學府,2024-04-08,9822
2845,遠東銀,30,0,30,元大-土城學府,2024-04-08,9822
00937B,群益ESG投等債20,62,34,28,元大-土城學府,2024-04-08,9822
3056,富華新,27,0,27,元大-土城學府,2024-04-08,9822
2888,新光金,26,0,26,元大-土城學府,2024-04-08,9822
00673R,期元大S＆P原油反1,25,0,25,元大-土城學府,2024-04-08,9822
3058,立德,25,0,25,元大-土城學府,2024-04-08,9822
2353,宏��,27,5,22,元大-土城學府,2024-04-08,9822
6189,豐藝,25,5,20,元大-土城學府,2024-04-08,9822
9105,泰金寶-DR,20,0,20,元大-土城學府,2024-04-08,9822
6197,佳必琪,18,0,18,元大-土城學府,2024-04-08,9822
00773B,中信優先金融債,15,0,15,元大-土城學府,2024-04-08,9822
3706,神達,16,1,15,元大-土城學府,2024-04-08,9822
00715L,期街口布蘭特正2,16,2,14,元大-土城學府,2024-04-08,9822
2405,輔信,25,11,14,元大-土城學府,2024-04-08,9822
3059,華晶科,22,8,14,元大-土城學府,2024-04-08,9822
1517,利奇,13,0,13,元大-土城學府,2024-04-08,9822
2317,鴻海,57,46,11,元大-土城學府,2024-04-08,9822
0056,元大高股息,14,2,12,元大-土城學府,2024-04-08,9822
00680L,元大美債20正2,11,0,11,元大-土城學府,2024-04-08,9822
00795B,中信美國公債20年,11,0,11,元大-土城學府,2024-04-08,9822
00772B,中信高評級公司債,11,0,11,元大-土城學府,2024-04-08,9822
00751B,元大AAA至A公司債,11,0,11,元大-土城學府,2024-04-08,9822
2374,佳能,38,27,11,元大-土城學府,2024-04-08,9822
3025,星通,25,14,11,元大-土城學府,2024-04-08,9822
2368,金像電,11,1,10,元大-土城學府,2024-04-08,9822
1709,和益,10,0,10,元大-土城學府,2024-04-08,9822
6144,得利影,10,0,10,元大-土城學府,2024-04-08,9822
6274,台燿,14,4,10,元大-土城學府,2024-04-08,9822
6284,佳邦,10,0,10,元大-土城學府,2024-04-08,9822
00720B,元大投資級公司債,9,0,9,元大-土城學府,2024-04-08,9822
2887,台新金,10,1,9,元大-土城學府,2024-04-08,9822
2530,華建,9,0,9,元大-土城學府,2024-04-08,9822
00688L,國泰20年美債正2,8,0,8,元大-土城學府,2024-04-08,9822
2486,一詮,42,34,8,元大-土城學府,2024-04-08,9822
5701,劍湖山,8,0,8,元大-土城學府,2024-04-08,9822
2303,聯電,12,4,8,元大-土城學府,2024-04-08,9822
3702,大聯大,8,1,7,元大-土城學府,2024-04-08,9822
3684,榮昌,7,0,7,元大-土城學府,2024-04-08,9822
911622,泰聚亨-DR,7,0,7,元大-土城學府,2024-04-08,9822
3293,鈊象,6,0,6,元大-土城學府,2024-04-08,9822
00632R,元大台灣50反1,409,61,348,元大-土城學府,2024-04-09,9822
00929,復華台灣科技優息,183,7,176,元大-土城學府,2024-04-09,9822
1463,強盛新,85,0,85,元大-土城學府,2024-04-09,9822
2881,富邦金,80,2,78,元大-土城學府,2024-04-09,9822
2356,英業達,107,53,54,元大-土城學府,2024-04-09,9822
00940,元大台灣價值高息,101,55,46,元大-土城學府,2024-04-09,9822
3231,緯創,70,24,46,元大-土城學府,2024-04-09,9822
6284,佳邦,35,0,35,元大-土城學府,2024-04-09,9822
1815,富喬,34,2,32,元大-土城學府,2024-04-09,9822
6188,廣明,34,4,30,元大-土城學府,2024-04-09,9822
00637L,元大滬深300正2,29,0,29,元大-土城學府,2024-04-09,9822
6197,佳必琪,27,1,26,元大-土城學府,2024-04-09,9822
2371,大同,35,10,25,元大-土城學府,2024-04-09,9822
3481,群創,32,8,24,元大-土城學府,2024-04-09,9822
00679B,元大美債20年,29,6,23,元大-土城學府,2024-04-09,9822
00918,大華優利高填息30,22,0,22,元大-土城學府,2024-04-09,9822
2344,華邦電,22,0,22,元大-土城學府,2024-04-09,9822
2501,國建,25,3,22,元大-土城學府,2024-04-09,9822
2337,旺宏,24,2,22,元大-土城學府,2024-04-09,9822
00878,國泰永續高股息,27,6,21,元大-土城學府,2024-04-09,9822
00921,兆豐龍頭等權重,20,0,20,元大-土城學府,2024-04-09,9822
2402,毅嘉,33,14,19,元大-土城學府,2024-04-09,9822
3703,欣陸,20,3,17,元大-土城學府,2024-04-09,9822
1587,吉茂,20,5,15,元大-土城學府,2024-04-09,9822
1616,億泰,20,5,15,元大-土城學府,2024-04-09,9822
1605,華新,32,17,15,元大-土城學府,2024-04-09,9822
2362,藍天,15,2,13,元大-土城學府,2024-04-09,9822
3167,大量,13,0,13,元大-土城學府,2024-04-09,9822
4526,東台,13,0,13,元大-土城學府,2024-04-09,9822
9933,中鼎,14,1,13,元大-土城學府,2024-04-09,9822
00931B,統一美債20年,12,0,12,元大-土城學府,2024-04-09,9822
00937B,群益ESG投等債20,44,32,12,元大-土城學府,2024-04-09,9822
5371,中光電,15,3,12,元大-土城學府,2024-04-09,9822
00939,統一台灣高息動能,19,8,11,元大-土城學府,2024-04-09,9822
00673R,期元大S＆P原油反1,11,0,11,元大-土城學府,2024-04-09,9822
2354,鴻準,33,22,11,元大-土城學府,2024-04-09,9822
2903,遠百,11,0,11,元大-土城學府,2024-04-09,9822
1906,寶隆,10,0,10,元大-土城學府,2024-04-09,9822
2834,臺企銀,10,0,10,元大-土城學府,2024-04-09,9822
3380,明泰,10,0,10,元大-土城學府,2024-04-09,9822
4168,醣聯,10,0,10,元大-土城學府,2024-04-09,9822
8105,凌巨,10,0,10,元大-土城學府,2024-04-09,9822
2303,聯電,12,3,9,元大-土城學府,2024-04-09,9822
2630,亞航,16,7,9,元大-土城學府,2024-04-09,9822
6505,台塑化,10,1,9,元大-土城學府,2024-04-09,9822
4543,萬在,16,8,8,元大-土城學府,2024-04-09,9822
1524,耿鼎,11,3,8,元大-土城學府,2024-04-09,9822
8054,安國,18,10,8,元大-土城學府,2024-04-09,9822
2421,建準,9,2,7,元大-土城學府,2024-04-09,9822
6165,浪凡,8,1,7,元大-土城學府,2024-04-09,9822
6016,康和證,156,3,153,元大-土城學府,2024-04-10,9822
2515,中工,76,12,64,元大-土城學府,2024-04-10,9822
1301,台塑,51,1,50,元大-土城學府,2024-04-10,9822
00941,中信上游半導體,50,0,50,元大-土城學府,2024-04-10,9822
2317,鴻海,54,28,26,元大-土城學府,2024-04-10,9822
00937B,群益ESG投等債20,47,22,25,元大-土城學府,2024-04-10,9822
6770,力積電,26,1,25,元大-土城學府,2024-04-10,9822
2634,漢翔,44,21,23,元大-土城學府,2024-04-10,9822
6257,矽格,21,2,19,元大-土城學府,2024-04-10,9822
6290,良維,22,3,19,元大-土城學府,2024-04-10,9822
2033,佳大,17,0,17,元大-土城學府,2024-04-10,9822
2331,精英,16,0,16,元大-土城學府,2024-04-10,9822
6443,元晶,38,22,16,元大-土城學府,2024-04-10,9822
1815,富喬,16,1,15,元大-土城學府,2024-04-10,9822
3202,樺晟,15,0,15,元大-土城學府,2024-04-10,9822
2374,佳能,13,0,13,元大-土城學府,2024-04-10,9822
1513,中興電,58,45,13,元大-土城學府,2024-04-10,9822
2363,矽統,116,103,13,元大-土城學府,2024-04-10,9822
00673R,期元大S＆P原油反1,13,1,12,元大-土城學府,2024-04-10,9822
2025,千興,21,9,12,元大-土城學府,2024-04-10,9822
2002,中鋼,20,8,12,元大-土城學府,2024-04-10,9822
3005,神基,12,0,12,元大-土城學府,2024-04-10,9822
1785,光洋科,11,0,11,元大-土城學府,2024-04-10,9822
6227,茂綸,11,0,11,元大-土城學府,2024-04-10,9822
00933B,國泰10Y+金融債,11,0,11,元大-土城學府,2024-04-10,9822
2882,國泰金,11,0,11,元大-土城學府,2024-04-10,9822
2885,元大金,11,0,11,元大-土城學府,2024-04-10,9822
00919,群益台灣精選高息,15,4,11,元大-土城學府,2024-04-10,9822
2891,中信金,15,5,10,元大-土城學府,2024-04-10,9822
00931B,統一美債20年,10,0,10,元大-土城學府,2024-04-10,9822
00706L,期元大S＆P日圓正2,10,0,10,元大-土城學府,2024-04-10,9822
1517,利奇,10,0,10,元大-土城學府,2024-04-10,9822
2027,大成鋼,10,0,10,元大-土城學府,2024-04-10,9822
2029,盛餘,10,0,10,元大-土城學府,2024-04-10,9822
2449,京元電子,13,3,10,元大-土城學府,2024-04-10,9822
3231,緯創,22,13,9,元大-土城學府,2024-04-10,9822
2527,宏璟,9,0,9,元大-土城學府,2024-04-10,9822
6197,佳必琪,10,1,9,元大-土城學府,2024-04-10,9822
9955,佳龍,11,2,9,元大-土城學府,2024-04-10,9822
2376,技嘉,16,7,9,元大-土城學府,2024-04-10,9822
2609,陽明,8,0,8,元大-土城學府,2024-04-10,9822
2354,鴻準,24,16,8,元大-土城學府,2024-04-10,9822
1515,力山,12,4,8,元大-土城學府,2024-04-10,9822
2371,大同,14,6,8,元大-土城學府,2024-04-10,9822
3206,志豐,8,0,8,元大-土城學府,2024-04-10,9822
8033,雷虎,9,1,8,元大-土城學府,2024-04-10,9822
2308,台達電,8,0,8,元大-土城學府,2024-04-10,9822
3058,立德,7,0,7,元大-土城學府,2024-04-10,9822
8034,榮群,7,0,7,元大-土城學府,2024-04-10,9822
9105,泰金寶-DR,7,0,7,元大-土城學府,2024-04-10,9822
00679B,元大美債20年,153,1,152,元大-土城學府,2024-04-11,9822
1455,集盛,136,10,126,元大-土城學府,2024-04-11,9822
00937B,群益ESG投等債20,121,2,119,元大-土城學府,2024-04-11,9822
00687B,國泰20年美債,112,0,112,元大-土城學府,2024-04-11,9822
3576,聯合再生,64,0,64,元大-土城學府,2024-04-11,9822
00712,復華富時不動產,69,6,63,元大-土城學府,2024-04-11,9822
2317,鴻海,97,35,62,元大-土城學府,2024-04-11,9822
00680L,元大美債20正2,122,62,60,元大-土城學府,2024-04-11,9822
00929,復華台灣科技優息,78,20,58,元大-土城學府,2024-04-11,9822
00878,國泰永續高股息,59,4,55,元大-土城學府,2024-04-11,9822
00719B,元大美債1-3,50,0,50,元大-土城學府,2024-04-11,9822
2615,萬海,48,0,48,元大-土城學府,2024-04-11,9822
6016,康和證,61,16,45,元大-土城學府,2024-04-11,9822
2356,英業達,76,34,42,元大-土城學府,2024-04-11,9822
3010,華立,35,0,35,元大-土城學府,2024-04-11,9822
3481,群創,99,67,32,元大-土城學府,2024-04-11,9822
6197,佳必琪,29,0,29,元大-土城學府,2024-04-11,9822
1514,亞力,134,106,28,元大-土城學府,2024-04-11,9822
1504,東元,34,8,26,元大-土城學府,2024-04-11,9822
3013,晟銘電,50,24,26,元大-土城學府,2024-04-11,9822
6116,彩晶,25,0,25,元大-土城學府,2024-04-11,9822
3312,弘憶股,44,20,24,元大-土城學府,2024-04-11,9822
00915,凱基優選高股息30,23,2,21,元大-土城學府,2024-04-11,9822
2801,彰銀,21,0,21,元大-土城學府,2024-04-11,9822
2409,友達,20,0,20,元大-土城學府,2024-04-11,9822
4956,光鋐,20,0,20,元大-土城學府,2024-04-11,9822
6026,福邦證,20,0,20,元大-土城學府,2024-04-11,9822
8121,越峰,20,0,20,元大-土城學府,2024-04-11,9822
3231,緯創,35,15,20,元大-土城學府,2024-04-11,9822
2329,華泰,49,30,19,元大-土城學府,2024-04-11,9822
2303,聯電,40,22,18,元大-土城學府,2024-04-11,9822
2344,華邦電,28,10,18,元大-土城學府,2024-04-11,9822
00940,元大台灣價值高息,64,47,17,元大-土城學府,2024-04-11,9822
00941,中信上游半導體,17,1,16,元大-土城學府,2024-04-11,9822
00931B,統一美債20年,16,0,16,元大-土城學府,2024-04-11,9822
00632R,元大台灣50反1,17,1,16,元大-土城學府,2024-04-11,9822
2886,兆豐金,15,0,15,元大-土城學府,2024-04-11,9822
2337,旺宏,15,0,15,元大-土城學府,2024-04-11,9822
3444,利機,15,0,15,元大-土城學府,2024-04-11,9822
2882,國泰金,16,1,15,元大-土城學府,2024-04-11,9822
2607,榮運,14,0,14,元大-土城學府,2024-04-11,9822
00795B,中信美國公債20年,14,0,14,元大-土城學府,2024-04-11,9822
2605,新興,13,0,13,元大-土城學府,2024-04-11,9822
9958,世紀鋼,13,0,13,元大-土城學府,2024-04-11,9822
2313,華通,14,2,12,元大-土城學府,2024-04-11,9822
3058,立德,12,0,12,元大-土城學府,2024-04-11,9822
5386,青雲,16,4,12,元大-土城學府,2024-04-11,9822
6117,迎廣,34,22,12,元大-土城學府,2024-04-11,9822
3260,威剛,13,2,11,元大-土城學府,2024-04-11,9822
1815,富喬,12,1,11,元大-土城學府,2024-04-11,9822
00929,復華台灣科技優息,435,7,428,元大-土城學府,2024-04-12,9822
00687B,國泰20年美債,58,0,58,元大-土城學府,2024-04-12,9822
3402,漢科,50,0,50,元大-土城學府,2024-04-12,9822
00937B,群益ESG投等債20,46,8,38,元大-土城學府,2024-04-12,9822
1455,集盛,35,0,35,元大-土城學府,2024-04-12,9822
00679B,元大美債20年,38,5,33,元大-土城學府,2024-04-12,9822
2344,華邦電,45,12,33,元大-土城學府,2024-04-12,9822
4402,郡都開發,30,0,30,元大-土城學府,2024-04-12,9822
3027,盛達,30,1,29,元大-土城學府,2024-04-12,9822
2329,華泰,30,2,28,元大-土城學府,2024-04-12,9822
2353,宏��,74,49,25,元大-土城學府,2024-04-12,9822
00933B,國泰10Y+金融債,25,1,24,元大-土城學府,2024-04-12,9822
2382,廣達,30,7,23,元大-土城學府,2024-04-12,9822
00720B,元大投資級公司債,27,5,22,元大-土城學府,2024-04-12,9822
3481,群創,23,1,22,元大-土城學府,2024-04-12,9822
00915,凱基優選高股息30,25,4,21,元大-土城學府,2024-04-12,9822
6016,康和證,20,0,20,元大-土城學府,2024-04-12,9822
3703,欣陸,20,1,19,元大-土城學府,2024-04-12,9822
6257,矽格,25,7,18,元大-土城學府,2024-04-12,9822
4533,協易機,27,11,16,元大-土城學府,2024-04-12,9822
1582,信錦,17,1,16,元大-土城學府,2024-04-12,9822
8111,立��,15,0,15,元大-土城學府,2024-04-12,9822
00922,國泰台灣領袖50,16,2,14,元大-土城學府,2024-04-12,9822
2337,旺宏,15,2,13,元大-土城學府,2024-04-12,9822
2363,矽統,186,174,12,元大-土城學府,2024-04-12,9822
2308,台達電,12,0,12,元大-土城學府,2024-04-12,9822
2618,長榮航,14,2,12,元大-土城學府,2024-04-12,9822
3715,定穎投控,18,6,12,元大-土城學府,2024-04-12,9822
2611,志信,13,2,11,元大-土城學府,2024-04-12,9822
2883,凱基金,11,0,11,元大-土城學府,2024-04-12,9822
00751B,元大AAA至A公司債,10,0,10,元大-土城學府,2024-04-12,9822
6806,森崴能源,14,4,10,元大-土城學府,2024-04-12,9822
00719B,元大美債1-3,10,0,10,元大-土城學府,2024-04-12,9822
00688L,國泰20年美債正2,10,0,10,元大-土城學府,2024-04-12,9822
3583,辛耘,11,1,10,元大-土城學府,2024-04-12,9822
6141,柏承,10,0,10,元大-土城學府,2024-04-12,9822
6227,茂綸,21,11,10,元大-土城學府,2024-04-12,9822
00941,中信上游半導體,12,2,10,元大-土城學府,2024-04-12,9822
2609,陽明,14,6,8,元大-土城學府,2024-04-12,9822
4906,正文,8,0,8,元大-土城學府,2024-04-12,9822
2002,中鋼,12,4,8,元大-土城學府,2024-04-12,9822
5521,工信,8,0,8,元大-土城學府,2024-04-12,9822
5531,鄉林,9,1,8,元大-土城學府,2024-04-12,9822
6191,精成科,8,0,8,元大-土城學府,2024-04-12,9822
1605,華新,26,19,7,元大-土城學府,2024-04-12,9822
2449,京元電子,13,6,7,元大-土城學府,2024-04-12,9822
1905,華紙,7,0,7,元大-土城學府,2024-04-12,9822
2736,富野,8,1,7,元大-土城學府,2024-04-12,9822
5227,立凱-KY,7,0,7,元大-土城學府,2024-04-12,9822
2330,台積電,8,1,7,元大-土城學府,2024-04-12,9822
00929,復華台灣科技優息,288,29,259,元大-土城學府,2024-04-15,9822
00679B,元大美債20年,175,5,170,元大-土城學府,2024-04-15,9822
00933B,國泰10Y+金融債,91,6,85,元大-土城學府,2024-04-15,9822
00937B,群益ESG投等債20,78,0,78,元大-土城學府,2024-04-15,9822
3402,漢科,73,5,68,元大-土城學府,2024-04-15,9822
00878,國泰永續高股息,58,0,58,元大-土城學府,2024-04-15,9822
5009,榮剛,53,2,51,元大-土城學府,2024-04-15,9822
5309,系統電,51,0,51,元大-土城學府,2024-04-15,9822
0056,元大高股息,52,4,48,元大-土城學府,2024-04-15,9822
2867,三商壽,76,32,44,元大-土城學府,2024-04-15,9822
1609,大亞,100,59,41,元大-土城學府,2024-04-15,9822
00719B,元大美債1-3,40,0,40,元大-土城學府,2024-04-15,9822
1513,中興電,127,93,34,元大-土城學府,2024-04-15,9822
2353,宏��,34,6,28,元大-土城學府,2024-04-15,9822
2371,大同,142,114,28,元大-土城學府,2024-04-15,9822
1612,宏泰,38,12,26,元大-土城學府,2024-04-15,9822
00939,統一台灣高息動能,25,0,25,元大-土城學府,2024-04-15,9822
5347,世界,34,9,25,元大-土城學府,2024-04-15,9822
1504,東元,73,50,23,元大-土城學府,2024-04-15,9822
2515,中工,28,6,22,元大-土城學府,2024-04-15,9822
00927,群益半導體收益,23,1,22,元大-土城學府,2024-04-15,9822
3037,欣興,32,12,20,元大-土城學府,2024-04-15,9822
3058,立德,20,0,20,元大-土城學府,2024-04-15,9822
00891,中信關鍵半導體,19,0,19,元大-土城學府,2024-04-15,9822
1608,華榮,43,24,19,元大-土城學府,2024-04-15,9822
00712,復華富時不動產,19,1,18,元大-土城學府,2024-04-15,9822
8121,越峰,19,1,18,元大-土城學府,2024-04-15,9822
3294,英濟,19,2,17,元大-土城學府,2024-04-15,9822
00923,群益台ESG低碳50,16,0,16,元大-土城學府,2024-04-15,9822
6770,力積電,19,3,16,元大-土城學府,2024-04-15,9822
9945,潤泰新,16,0,16,元大-土城學府,2024-04-15,9822
00941,中信上游半導體,48,33,15,元大-土城學府,2024-04-15,9822
2382,廣達,27,13,14,元大-土城學府,2024-04-15,9822
2009,第一銅,26,12,14,元大-土城學府,2024-04-15,9822
3615,安可,45,32,13,元大-土城學府,2024-04-15,9822
00918,大華優利高填息30,15,2,13,元大-土城學府,2024-04-15,9822
2345,智邦,12,0,12,元大-土城學府,2024-04-15,9822
3062,建漢,12,0,12,元大-土城學府,2024-04-15,9822
3083,網龍,12,0,12,元大-土城學府,2024-04-15,9822
6547,高端疫苗,13,1,12,元大-土城學府,2024-04-15,9822
2409,友達,14,3,11,元大-土城學府,2024-04-15,9822
2303,聯電,26,15,11,元大-土城學府,2024-04-15,9822
8936,國統,13,3,10,元大-土城學府,2024-04-15,9822
2891,中信金,15,5,10,元大-土城學府,2024-04-15,9822
00650L,復華香港正2,10,0,10,元大-土城學府,2024-04-15,9822
1582,信錦,10,0,10,元大-土城學府,2024-04-15,9822
1589,永冠-KY,10,0,10,元大-土城學府,2024-04-15,9822
3622,洋華,33,23,10,元大-土城學府,2024-04-15,9822
2812,台中銀,10,0,10,元大-土城學府,2024-04-15,9822
1503,士電,19,10,9,元大-土城學府,2024-04-15,9822
00940,元大台灣價值高息,786,172,614,元大-土城學府,2024-04-16,9822
00929,復華台灣科技優息,316,18,298,元大-土城學府,2024-04-16,9822
00919,群益台灣精選高息,224,40,184,元大-土城學府,2024-04-16,9822
00937B,群益ESG投等債20,188,5,183,元大-土城學府,2024-04-16,9822
1609,大亞,398,278,120,元大-土城學府,2024-04-16,9822
0056,元大高股息,166,65,101,元大-土城學府,2024-04-16,9822
912000,晨訊科-DR,78,0,78,元大-土城學府,2024-04-16,9822
00918,大華優利高填息30,108,30,78,元大-土城學府,2024-04-16,9822
00878,國泰永續高股息,115,58,57,元大-土城學府,2024-04-16,9822
2888,新光金,72,17,55,元大-土城學府,2024-04-16,9822
2845,遠東銀,52,0,52,元大-土城學府,2024-04-16,9822
2457,飛宏,51,2,49,元大-土城學府,2024-04-16,9822
2834,臺企銀,51,3,48,元大-土城學府,2024-04-16,9822
00712,復華富時不動產,43,0,43,元大-土城學府,2024-04-16,9822
2618,長榮航,46,11,35,元大-土城學府,2024-04-16,9822
2303,聯電,41,7,34,元大-土城學府,2024-04-16,9822
00927,群益半導體收益,29,0,29,元大-土城學府,2024-04-16,9822
3231,緯創,42,12,30,元大-土城學府,2024-04-16,9822
6770,力積電,36,7,29,元大-土城學府,2024-04-16,9822
3576,聯合再生,30,1,29,元大-土城學府,2024-04-16,9822
6158,禾昌,29,0,29,元大-土城學府,2024-04-16,9822
2515,中工,28,0,28,元大-土城學府,2024-04-16,9822
00708L,期元大S＆P黃金正2,27,0,27,元大-土城學府,2024-04-16,9822
00885,富邦越南,26,0,26,元大-土城學府,2024-04-16,9822
2101,南港,25,0,25,元大-土城學府,2024-04-16,9822
2603,長榮,66,41,25,元大-土城學府,2024-04-16,9822
00733,富邦臺灣中小,25,0,25,元大-土城學府,2024-04-16,9822
5521,工信,31,7,24,元大-土城學府,2024-04-16,9822
5907,大洋-KY,24,0,24,元大-土城學府,2024-04-16,9822
00720B,元大投資級公司債,23,0,23,元大-土城學府,2024-04-16,9822
4402,郡都開發,22,0,22,元大-土城學府,2024-04-16,9822
00939,統一台灣高息動能,83,62,21,元大-土城學府,2024-04-16,9822
1326,台化,20,0,20,元大-土城學府,2024-04-16,9822
00633L,富邦上証正2,20,0,20,元大-土城學府,2024-04-16,9822
3058,立德,33,14,19,元大-土城學府,2024-04-16,9822
2408,南亞科,20,1,19,元大-土城學府,2024-04-16,9822
1513,中興電,43,24,19,元大-土城學府,2024-04-16,9822
2344,華邦電,39,21,18,元大-土城學府,2024-04-16,9822
00907,永豐優息存股,16,0,16,元大-土城學府,2024-04-16,9822
3260,威剛,19,3,16,元大-土城學府,2024-04-16,9822
2881,富邦金,16,0,16,元大-土城學府,2024-04-16,9822
3481,群創,25,9,16,元大-土城學府,2024-04-16,9822
00900,富邦特選高股息30,20,4,16,元大-土城學府,2024-04-16,9822
2884,玉山金,20,5,15,元大-土城學府,2024-04-16,9822
00646,元大S＆P500,15,0,15,元大-土城學府,2024-04-16,9822
2885,元大金,18,3,15,元大-土城學府,2024-04-16,9822
3202,樺晟,15,0,15,元大-土城學府,2024-04-16,9822
1584,精剛,21,7,14,元大-土城學府,2024-04-16,9822
5351,鈺創,16,2,14,元大-土城學府,2024-04-16,9822
2609,陽明,14,0,14,元大-土城學府,2024-04-16,9822
00929,復華台灣科技優息,156,2,154,元大-土城學府,2024-04-17,9822
00937B,群益ESG投等債20,120,20,100,元大-土城學府,2024-04-17,9822
00712,復華富時不動產,64,0,64,元大-土城學府,2024-04-17,9822
0056,元大高股息,66,4,62,元大-土城學府,2024-04-17,9822
1101,台泥,54,1,53,元大-土城學府,2024-04-17,9822
00720B,元大投資級公司債,48,0,48,元大-土城學府,2024-04-17,9822
00878,國泰永續高股息,41,7,34,元大-土城學府,2024-04-17,9822
00919,群益台灣精選高息,39,5,34,元大-土城學府,2024-04-17,9822
2353,宏��,50,16,34,元大-土城學府,2024-04-17,9822
00646,元大S＆P500,32,0,32,元大-土城學府,2024-04-17,9822
2371,大同,94,66,28,元大-土城學府,2024-04-17,9822
2367,燿華,52,26,26,元大-土城學府,2024-04-17,9822
00679B,元大美債20年,26,0,26,元大-土城學府,2024-04-17,9822
2303,聯電,22,1,21,元大-土城學府,2024-04-17,9822
2354,鴻準,22,1,21,元大-土城學府,2024-04-17,9822
2897,王道銀行,21,0,21,元大-土城學府,2024-04-17,9822
2419,仲琦,20,0,20,元大-土城學府,2024-04-17,9822
00680L,元大美債20正2,20,0,20,元大-土城學府,2024-04-17,9822
3231,緯創,49,30,19,元大-土城學府,2024-04-17,9822
00857B,永豐20年美公債,18,0,18,元大-土城學府,2024-04-17,9822
00632R,元大台灣50反1,43,25,18,元大-土城學府,2024-04-17,9822
3294,英濟,20,2,18,元大-土城學府,2024-04-17,9822
8936,國統,27,11,16,元大-土城學府,2024-04-17,9822
2408,南亞科,16,1,15,元大-土城學府,2024-04-17,9822
00927,群益半導體收益,15,1,14,元大-土城學府,2024-04-17,9822
4533,協易機,14,1,13,元大-土城學府,2024-04-17,9822
00724B,群益投資級金融債,13,0,13,元大-土城學府,2024-04-17,9822
1560,中砂,15,2,13,元大-土城學府,2024-04-17,9822
5009,榮剛,39,26,13,元大-土城學府,2024-04-17,9822
6116,彩晶,13,0,13,元大-土城學府,2024-04-17,9822
2892,第一金,12,0,12,元大-土城學府,2024-04-17,9822
8033,雷虎,15,3,12,元大-土城學府,2024-04-17,9822
9955,佳龍,15,3,12,元大-土城學府,2024-04-17,9822
2401,凌陽,14,3,11,元大-土城學府,2024-04-17,9822
2495,普安,11,0,11,元大-土城學府,2024-04-17,9822
3380,明泰,11,0,11,元大-土城學府,2024-04-17,9822
2382,廣達,15,5,10,元大-土城學府,2024-04-17,9822
00671R,富邦NASDAQ反1,10,0,10,元大-土城學府,2024-04-17,9822
1810,和成,52,42,10,元大-土城學府,2024-04-17,9822
2547,日勝生,10,0,10,元大-土城學府,2024-04-17,9822
2610,華航,13,3,10,元大-土城學府,2024-04-17,9822
00772B,中信高評級公司債,10,0,10,元大-土城學府,2024-04-17,9822
6770,力積電,20,11,9,元大-土城學府,2024-04-17,9822
1616,億泰,11,2,9,元大-土城學府,2024-04-17,9822
2002,中鋼,10,1,9,元大-土城學府,2024-04-17,9822
4402,郡都開發,10,1,9,元大-土城學府,2024-04-17,9822
5469,瀚宇博,9,0,9,元大-土城學府,2024-04-17,9822
3044,健鼎,8,0,8,元大-土城學府,2024-04-17,9822
1617,榮星,15,7,8,元大-土城學府,2024-04-17,9822
2801,彰銀,10,2,8,元大-土城學府,2024-04-17,9822
2883,凱基金,312,0,312,元大-土城學府,2024-04-18,9822
0056,元大高股息,67,1,66,元大-土城學府,2024-04-18,9822
2371,大同,160,109,51,元大-土城學府,2024-04-18,9822
6770,力積電,70,20,50,元大-土城學府,2024-04-18,9822
00937B,群益ESG投等債20,54,5,49,元大-土城學府,2024-04-18,9822
2515,中工,112,64,48,元大-土城學府,2024-04-18,9822
1504,東元,78,30,48,元大-土城學府,2024-04-18,9822
1608,華榮,74,32,42,元大-土城學府,2024-04-18,9822
1618,合機,42,0,42,元大-土城學府,2024-04-18,9822
00929,復華台灣科技優息,83,43,40,元大-土城學府,2024-04-18,9822
4588,玖鼎電力,43,4,39,元大-土城學府,2024-04-18,9822
1605,華新,75,36,39,元大-土城學府,2024-04-18,9822
2374,佳能,102,67,35,元大-土城學府,2024-04-18,9822
00933B,國泰10Y+金融債,34,0,34,元大-土城學府,2024-04-18,9822
5512,力麒,36,3,33,元大-土城學府,2024-04-18,9822
2303,聯電,40,8,32,元大-土城學府,2024-04-18,9822
00646,元大S＆P500,32,0,32,元大-土城學府,2024-04-18,9822
00940,元大台灣價值高息,70,38,32,元大-土城學府,2024-04-18,9822
2367,燿華,49,19,30,元大-土城學府,2024-04-18,9822
00680L,元大美債20正2,29,0,29,元大-土城學府,2024-04-18,9822
2365,昆盈,36,7,29,元大-土城學府,2024-04-18,9822
2538,基泰,53,27,26,元大-土城學府,2024-04-18,9822
8110,華東,25,0,25,元大-土城學府,2024-04-18,9822
8926,台汽電,29,6,23,元大-土城學府,2024-04-18,9822
00941,中信上游半導體,26,6,20,元大-土城學府,2024-04-18,9822
2020,美亞,20,0,20,元大-土城學府,2024-04-18,9822
00942B,台新美A公司債20+,20,0,20,元大-土城學府,2024-04-18,9822
2886,兆豐金,19,0,19,元大-土城學府,2024-04-18,9822
2317,鴻海,36,19,17,元大-土城學府,2024-04-18,9822
2356,英業達,47,31,16,元大-土城學府,2024-04-18,9822
1513,中興電,87,72,15,元大-土城學府,2024-04-18,9822
4961,天鈺,15,0,15,元大-土城學府,2024-04-18,9822
2897,王道銀行,14,0,14,元大-土城學府,2024-04-18,9822
3707,漢磊,18,4,14,元大-土城學府,2024-04-18,9822
00685L,群益臺灣加權正2,13,0,13,元大-土城學府,2024-04-18,9822
00923,群益台ESG低碳50,13,0,13,元大-土城學府,2024-04-18,9822
2537,聯上發,14,2,12,元大-土城學府,2024-04-18,9822
2609,陽明,20,8,12,元大-土城學府,2024-04-18,9822
2329,華泰,36,25,11,元大-土城學府,2024-04-18,9822
3312,弘憶股,38,27,11,元大-土城學府,2024-04-18,9822
2313,華通,12,2,10,元大-土城學府,2024-04-18,9822
2009,第一銅,29,19,10,元大-土城學府,2024-04-18,9822
00688L,國泰20年美債正2,10,0,10,元大-土城學府,2024-04-18,9822
00675L,富邦臺灣加權正2,10,0,10,元大-土城學府,2024-04-18,9822
1709,和益,10,0,10,元大-土城學府,2024-04-18,9822
2547,日勝生,10,0,10,元大-土城學府,2024-04-18,9822
6257,矽格,10,0,10,元大-土城學府,2024-04-18,9822
9939,宏全,10,0,10,元大-土城學府,2024-04-18,9822
2520,冠德,13,4,9,元大-土城學府,2024-04-18,9822
2353,宏��,17,8,9,元大-土城學府,2024-04-18,9822
00929,復華台灣科技優息,432,14,418,元大-土城學府,2024-04-19,9822
00940,元大台灣價值高息,414,196,218,元大-土城學府,2024-04-19,9822
00919,群益台灣精選高息,164,7,157,元大-土城學府,2024-04-19,9822
0056,元大高股息,82,5,77,元大-土城學府,2024-04-19,9822
5512,力麒,102,25,77,元大-土城學府,2024-04-19,9822
2515,中工,157,100,57,元大-土城學府,2024-04-19,9822
2101,南港,74,18,56,元大-土城學府,2024-04-19,9822
2303,聯電,70,14,56,元大-土城學府,2024-04-19,9822
1612,宏泰,81,32,49,元大-土城學府,2024-04-19,9822
4967,十銓,41,4,37,元大-土城學府,2024-04-19,9822
00941,中信上游半導體,42,5,37,元大-土城學府,2024-04-19,9822
5347,世界,46,11,35,元大-土城學府,2024-04-19,9822
00918,大華優利高填息30,45,11,34,元大-土城學府,2024-04-19,9822
1609,大亞,301,268,33,元大-土城學府,2024-04-19,9822
00935,野村臺灣新科技50,33,0,33,元大-土城學府,2024-04-19,9822
2330,台積電,43,10,33,元大-土城學府,2024-04-19,9822
006208,富邦台50,32,1,31,元大-土城學府,2024-04-19,9822
00646,元大S＆P500,30,1,29,元大-土城學府,2024-04-19,9822
2317,鴻海,56,27,29,元大-土城學府,2024-04-19,9822
2534,宏盛,30,2,28,元大-土城學府,2024-04-19,9822
8936,國統,82,55,27,元大-土城學府,2024-04-19,9822
3481,群創,39,14,25,元大-土城學府,2024-04-19,9822
1608,華榮,104,80,24,元大-土城學府,2024-04-19,9822
2467,志聖,21,1,20,元大-土城學府,2024-04-19,9822
2618,長榮航,56,36,20,元大-土城學府,2024-04-19,9822
2855,統一證,21,1,20,元大-土城學府,2024-04-19,9822
2409,友達,20,1,19,元大-土城學府,2024-04-19,9822
8926,台汽電,19,0,19,元大-土城學府,2024-04-19,9822
2886,兆豐金,22,4,18,元大-土城學府,2024-04-19,9822
6443,元晶,22,5,17,元大-土城學府,2024-04-19,9822
2890,永豐金,15,0,15,元大-土城學府,2024-04-19,9822
2388,威盛,18,3,15,元大-土城學府,2024-04-19,9822
4127,天良,15,0,15,元大-土城學府,2024-04-19,9822
2885,元大金,14,0,14,元大-土城學府,2024-04-19,9822
1815,富喬,20,6,14,元大-土城學府,2024-04-19,9822
5009,榮剛,51,37,14,元大-土城學府,2024-04-19,9822
1709,和益,20,7,13,元大-土城學府,2024-04-19,9822
2382,廣達,15,2,13,元大-土城學府,2024-04-19,9822
9955,佳龍,24,11,13,元大-土城學府,2024-04-19,9822
2887,台新金,11,0,11,元大-土城學府,2024-04-19,9822
00712,復華富時不動產,12,1,11,元大-土城學府,2024-04-19,9822
1603,華電,33,22,11,元大-土城學府,2024-04-19,9822
2511,太子,20,9,11,元大-土城學府,2024-04-19,9822
4956,光鋐,49,38,11,元大-土城學府,2024-04-19,9822
8097,常珵,10,0,10,元大-土城學府,2024-04-19,9822
00673R,期元大S＆P原油反1,10,0,10,元大-土城學府,2024-04-19,9822
2637,慧洋-KY,13,3,10,元大-土城學府,2024-04-19,9822
3045,台灣大,10,0,10,元大-土城學府,2024-04-19,9822
3138,耀登,10,0,10,元大-土城學府,2024-04-19,9822
6264,富裔,10,0,10,元大-土城學府,2024-04-19,9822
2515,中工,313,131,182,元大-土城學府,2024-04-22,9822
5512,力麒,200,46,154,元大-土城學府,2024-04-22,9822
00940,元大台灣價值高息,233,86,147,元大-土城學府,2024-04-22,9822
00929,復華台灣科技優息,145,2,143,元大-土城學府,2024-04-22,9822
00919,群益台灣精選高息,158,32,126,元大-土城學府,2024-04-22,9822
00632R,元大台灣50反1,91,0,91,元大-土城學府,2024-04-22,9822
1618,合機,113,32,81,元大-土城學府,2024-04-22,9822
00939,統一台灣高息動能,81,0,81,元大-土城學府,2024-04-22,9822
00937B,群益ESG投等債20,64,10,54,元大-土城學府,2024-04-22,9822
3015,全漢,42,0,42,元大-土城學府,2024-04-22,9822
00679B,元大美債20年,43,2,41,元大-土城學府,2024-04-22,9822
2374,佳能,48,10,38,元大-土城學府,2024-04-22,9822
3231,緯創,50,17,33,元大-土城學府,2024-04-22,9822
2609,陽明,57,27,30,元大-土城學府,2024-04-22,9822
2329,華泰,147,119,28,元大-土城學府,2024-04-22,9822
5533,皇鼎,43,20,23,元大-土城學府,2024-04-22,9822
00687B,國泰20年美債,23,0,23,元大-土城學府,2024-04-22,9822
1711,永光,22,0,22,元大-土城學府,2024-04-22,9822
2611,志信,23,2,21,元大-土城學府,2024-04-22,9822
1815,富喬,20,1,19,元大-土城學府,2024-04-22,9822
1513,中興電,47,28,19,元大-土城學府,2024-04-22,9822
1718,中纖,20,1,19,元大-土城學府,2024-04-22,9822
3297,杭特,19,0,19,元大-土城學府,2024-04-22,9822
4167,松瑞藥,18,0,18,元大-土城學府,2024-04-22,9822
2867,三商壽,31,13,18,元大-土城學府,2024-04-22,9822
2367,燿華,22,6,16,元大-土城學府,2024-04-22,9822
3078,僑威,20,7,13,元大-土城學府,2024-04-22,9822
3518,柏騰,13,0,13,元大-土城學府,2024-04-22,9822
5521,工信,33,20,13,元大-土城學府,2024-04-22,9822
2371,大同,168,155,13,元大-土城學府,2024-04-22,9822
1584,精剛,15,3,12,元大-土城學府,2024-04-22,9822
2365,昆盈,13,1,12,元大-土城學府,2024-04-22,9822
2408,南亞科,12,0,12,元大-土城學府,2024-04-22,9822
2850,新產,12,0,12,元大-土城學府,2024-04-22,9822
00918,大華優利高填息30,23,12,11,元大-土城學府,2024-04-22,9822
6120,達運,13,2,11,元大-土城學府,2024-04-22,9822
00673R,期元大S＆P原油反1,10,0,10,元大-土城學府,2024-04-22,9822
1810,和成,12,2,10,元大-土城學府,2024-04-22,9822
4967,十銓,11,1,10,元大-土城學府,2024-04-22,9822
1609,大亞,225,215,10,元大-土城學府,2024-04-22,9822
2313,華通,15,6,9,元大-土城學府,2024-04-22,9822
2497,怡利電,9,0,9,元大-土城學府,2024-04-22,9822
3003,健和興,10,1,9,元大-土城學府,2024-04-22,9822
2501,國建,30,21,9,元大-土城學府,2024-04-22,9822
4168,醣聯,8,0,8,元大-土城學府,2024-04-22,9822
1439,雋揚,8,0,8,元大-土城學府,2024-04-22,9822
4909,新復興,8,0,8,元大-土城學府,2024-04-22,9822
4306,炎洲,13,5,8,元大-土城學府,2024-04-22,9822
2009,第一銅,42,35,7,元大-土城學府,2024-04-22,9822
1570,力肯,7,0,7,元大-土城學府,2024-04-22,9822
00929,復華台灣科技優息,262,8,254,元大-土城學府,2024-04-23,9822
00632R,元大台灣50反1,202,26,176,元大-土城學府,2024-04-23,9822
2329,華泰,117,1,116,元大-土城學府,2024-04-23,9822
1101,台泥,113,6,107,元大-土城學府,2024-04-23,9822
00939,統一台灣高息動能,85,2,83,元大-土城學府,2024-04-23,9822
5009,榮剛,76,2,74,元大-土城學府,2024-04-23,9822
00940,元大台灣價值高息,111,58,53,元大-土城學府,2024-04-23,9822
2101,南港,71,34,37,元大-土城學府,2024-04-23,9822
2301,光寶科,50,16,34,元大-土城學府,2024-04-23,9822
1442,名軒,28,0,28,元大-土城學府,2024-04-23,9822
2317,鴻海,43,15,28,元大-土城學府,2024-04-23,9822
1457,宜進,23,0,23,元大-土城學府,2024-04-23,9822
00922,國泰台灣領袖50,21,0,21,元大-土城學府,2024-04-23,9822
2520,冠德,39,18,21,元大-土城學府,2024-04-23,9822
00937B,群益ESG投等債20,25,7,18,元大-土城學府,2024-04-23,9822
1314,中石化,20,2,18,元大-土城學府,2024-04-23,9822
00637L,元大滬深300正2,21,4,17,元大-土城學府,2024-04-23,9822
8044,網家,14,0,14,元大-土城學府,2024-04-23,9822
1440,南紡,13,0,13,元大-土城學府,2024-04-23,9822
3015,全漢,16,3,13,元大-土城學府,2024-04-23,9822
2511,太子,12,0,12,元大-土城學府,2024-04-23,9822
1316,上曜,15,4,11,元大-土城學府,2024-04-23,9822
00919,群益台灣精選高息,21,10,11,元大-土城學府,2024-04-23,9822
2889,國票金,10,0,10,元大-土城學府,2024-04-23,9822
1711,永光,10,0,10,元大-土城學府,2024-04-23,9822
1718,中纖,10,0,10,元大-土城學府,2024-04-23,9822
2492,華新科,10,0,10,元大-土城學府,2024-04-23,9822
3380,明泰,10,0,10,元大-土城學府,2024-04-23,9822
2354,鴻準,23,13,10,元大-土城學府,2024-04-23,9822
2408,南亞科,10,1,9,元大-土城學府,2024-04-23,9822
00885,富邦越南,9,0,9,元大-土城學府,2024-04-23,9822
2402,毅嘉,10,1,9,元大-土城學府,2024-04-23,9822
6770,力積電,9,0,9,元大-土城學府,2024-04-23,9822
2303,聯電,11,3,8,元大-土城學府,2024-04-23,9822
3715,定穎投控,14,6,8,元大-土城學府,2024-04-23,9822
6005,群益證,13,5,8,元大-土城學府,2024-04-23,9822
2603,長榮,62,55,7,元大-土城學府,2024-04-23,9822
5512,力麒,7,0,7,元大-土城學府,2024-04-23,9822
00697B,元大美債7-10,6,0,6,元大-土城學府,2024-04-23,9822
00679B,元大美債20年,6,0,6,元大-土城學府,2024-04-23,9822
1504,東元,25,19,6,元大-土城學府,2024-04-23,9822
2344,華邦電,6,0,6,元大-土城學府,2024-04-23,9822
2610,華航,9,3,6,元大-土城學府,2024-04-23,9822
3058,立德,6,0,6,元大-土城學府,2024-04-23,9822
6290,良維,8,2,6,元大-土城學府,2024-04-23,9822
2884,玉山金,11,5,6,元大-土城學府,2024-04-23,9822
00715L,期街口布蘭特正2,5,0,5,元大-土城學府,2024-04-23,9822
2106,建大,5,0,5,元大-土城學府,2024-04-23,9822
2388,威盛,5,0,5,元大-土城學府,2024-04-23,9822
3019,亞光,5,0,5,元大-土城學府,2024-04-23,9822
2515,中工,146,43,103,元大-土城學府,2024-04-24,9822
00878,國泰永續高股息,70,2,68,元大-土城學府,2024-04-24,9822
2501,國建,89,24,65,元大-土城學府,2024-04-24,9822
3703,欣陸,51,5,46,元大-土城學府,2024-04-24,9822
00937B,群益ESG投等債20,42,0,42,元大-土城學府,2024-04-24,9822
3481,群創,38,6,32,元大-土城學府,2024-04-24,9822
0050,元大台灣50,33,3,30,元大-土城學府,2024-04-24,9822
1440,南紡,30,1,29,元大-土城學府,2024-04-24,9822
2520,冠德,27,0,27,元大-土城學府,2024-04-24,9822
00940,元大台灣價值高息,56,30,26,元大-土城學府,2024-04-24,9822
2009,第一銅,30,6,24,元大-土城學府,2024-04-24,9822
2374,佳能,33,11,22,元大-土城學府,2024-04-24,9822
2409,友達,21,1,20,元大-土城學府,2024-04-24,9822
8011,台通,26,7,19,元大-土城學府,2024-04-24,9822
00929,復華台灣科技優息,45,26,19,元大-土城學府,2024-04-24,9822
3024,憶聲,21,3,18,元大-土城學府,2024-04-24,9822
2317,鴻海,70,52,18,元大-土城學府,2024-04-24,9822
3035,智原,60,43,17,元大-土城學府,2024-04-24,9822
00934,中信成長高股息,17,0,17,元大-土城學府,2024-04-24,9822
00923,群益台ESG低碳50,16,0,16,元大-土城學府,2024-04-24,9822
00685L,群益臺灣加權正2,16,0,16,元大-土城學府,2024-04-24,9822
00935,野村臺灣新科技50,16,0,16,元大-土城學府,2024-04-24,9822
1336,台翰,16,0,16,元大-土城學府,2024-04-24,9822
2504,國產,19,3,16,元大-土城學府,2024-04-24,9822
3294,英濟,15,0,15,元大-土城學府,2024-04-24,9822
3576,聯合再生,28,13,15,元大-土城學府,2024-04-24,9822
00687B,國泰20年美債,14,0,14,元大-土城學府,2024-04-24,9822
6116,彩晶,12,0,12,元大-土城學府,2024-04-24,9822
1101,台泥,31,21,10,元大-土城學府,2024-04-24,9822
00641R,富邦日本反1,10,0,10,元大-土城學府,2024-04-24,9822
00830,國泰費城半導體,10,0,10,元大-土城學府,2024-04-24,9822
1402,遠東新,11,1,10,元大-土城學府,2024-04-24,9822
1808,潤隆,10,0,10,元大-土城學府,2024-04-24,9822
2809,京城銀,10,0,10,元大-土城學府,2024-04-24,9822
2890,永豐金,11,1,10,元大-土城學府,2024-04-24,9822
3380,明泰,10,0,10,元大-土城學府,2024-04-24,9822
6026,福邦證,10,0,10,元大-土城學府,2024-04-24,9822
6242,立康,10,0,10,元大-土城學府,2024-04-24,9822
6712,長聖,10,0,10,元大-土城學府,2024-04-24,9822
2354,鴻準,23,13,10,元大-土城學府,2024-04-24,9822
6158,禾昌,10,0,10,元大-土城學府,2024-04-24,9822
00915,凱基優選高股息30,12,3,9,元大-土城學府,2024-04-24,9822
1618,合機,22,13,9,元大-土城學府,2024-04-24,9822
2634,漢翔,18,9,9,元大-土城學府,2024-04-24,9822
2880,華南金,9,0,9,元大-土城學府,2024-04-24,9822
3363,上詮,15,6,9,元大-土城學府,2024-04-24,9822
2542,興富發,8,0,8,元大-土城學府,2024-04-24,9822
1314,中石化,10,2,8,元大-土城學府,2024-04-24,9822
1455,集盛,59,51,8,元大-土城學府,2024-04-24,9822
6190,萬泰科,9,1,8,元大-土城學府,2024-04-24,9822
00929,復華台灣科技優息,135,10,125,元大-土城學府,2024-04-25,9822
1440,南紡,79,4,75,元大-土城學府,2024-04-25,9822
00937B,群益ESG投等債20,58,0,58,元大-土城學府,2024-04-25,9822
2618,長榮航,96,53,43,元大-土城學府,2024-04-25,9822
5009,榮剛,39,0,39,元大-土城學府,2024-04-25,9822
00687B,國泰20年美債,36,0,36,元大-土城學府,2024-04-25,9822
6244,茂迪,36,0,36,元大-土城學府,2024-04-25,9822
00940,元大台灣價值高息,42,15,27,元大-土城學府,2024-04-25,9822
00878,國泰永續高股息,24,1,23,元大-土城學府,2024-04-25,9822
00680L,元大美債20正2,20,0,20,元大-土城學府,2024-04-25,9822
3686,達能,19,0,19,元大-土城學府,2024-04-25,9822
00665L,富邦�琤肭磪囓�2,20,2,18,元大-土城學府,2024-04-25,9822
00679B,元大美債20年,17,0,17,元大-土城學府,2024-04-25,9822
3231,緯創,18,2,16,元大-土城學府,2024-04-25,9822
2472,立隆電,16,0,16,元大-土城學府,2024-04-25,9822
8926,台汽電,16,0,16,元大-土城學府,2024-04-25,9822
4114,健喬,15,0,15,元大-土城學府,2024-04-25,9822
6139,亞翔,32,19,13,元大-土城學府,2024-04-25,9822
00931B,統一美債20年,12,0,12,元大-土城學府,2024-04-25,9822
1316,上曜,17,6,11,元大-土城學府,2024-04-25,9822
2409,友達,14,3,11,元大-土城學府,2024-04-25,9822
2801,彰銀,11,0,11,元大-土城學府,2024-04-25,9822
2330,台積電,11,0,11,元大-土城學府,2024-04-25,9822
2356,英業達,16,6,10,元大-土城學府,2024-04-25,9822
00893,國泰智能電動車,10,0,10,元大-土城學府,2024-04-25,9822
2316,楠梓電,18,8,10,元大-土城學府,2024-04-25,9822
2520,冠德,25,15,10,元大-土城學府,2024-04-25,9822
2890,永豐金,10,0,10,元大-土城學府,2024-04-25,9822
3013,晟銘電,23,13,10,元大-土城學府,2024-04-25,9822
6531,愛普*,10,0,10,元大-土城學府,2024-04-25,9822
00919,群益台灣精選高息,20,11,9,元大-土城學府,2024-04-25,9822
3033,威健,9,0,9,元大-土城學府,2024-04-25,9822
3715,定穎投控,12,4,8,元大-土城學府,2024-04-25,9822
00772B,中信高評級公司債,8,0,8,元大-土城學府,2024-04-25,9822
2208,台船,8,0,8,元大-土城學府,2024-04-25,9822
3714,富采,10,2,8,元大-土城學府,2024-04-25,9822
6215,和椿,10,2,8,元大-土城學府,2024-04-25,9822
3037,欣興,32,24,8,元大-土城學府,2024-04-25,9822
00646,元大S＆P500,7,0,7,元大-土城學府,2024-04-25,9822
2630,亞航,10,3,7,元大-土城學府,2024-04-25,9822
2748,雲品,8,1,7,元大-土城學府,2024-04-25,9822
3293,鈊象,6,0,6,元大-土城學府,2024-04-25,9822
00753L,中信中國50正2,6,0,6,元大-土城學府,2024-04-25,9822
00939,統一台灣高息動能,6,0,6,元大-土城學府,2024-04-25,9822
2353,宏��,6,0,6,元大-土城學府,2024-04-25,9822
2367,燿華,17,11,6,元大-土城學府,2024-04-25,9822
2408,南亞科,6,0,6,元大-土城學府,2024-04-25,9822
3056,富華新,19,13,6,元大-土城學府,2024-04-25,9822
3430,奇鈦科,6,0,6,元大-土城學府,2024-04-25,9822
4714,永捷,6,0,6,元大-土城學府,2024-04-25,9822
00632R,元大台灣50反1,110,0,110,元大-土城學府,2024-04-26,9822
9105,泰金寶-DR,205,100,105,元大-土城學府,2024-04-26,9822
2317,鴻海,82,37,45,元大-土城學府,2024-04-26,9822
00680L,元大美債20正2,41,4,37,元大-土城學府,2024-04-26,9822
3481,群創,45,12,33,元大-土城學府,2024-04-26,9822
8121,越峰,30,0,30,元大-土城學府,2024-04-26,9822
00919,群益台灣精選高息,40,12,28,元大-土城學府,2024-04-26,9822
4123,晟德,25,0,25,元大-土城學府,2024-04-26,9822
00878,國泰永續高股息,24,1,23,元大-土城學府,2024-04-26,9822
00679B,元大美債20年,21,0,21,元大-土城學府,2024-04-26,9822
00940,元大台灣價值高息,45,24,21,元大-土城學府,2024-04-26,9822
2887,台新金,20,0,20,元大-土城學府,2024-04-26,9822
3548,兆利,21,1,20,元大-土城學府,2024-04-26,9822
3714,富采,25,6,19,元大-土城學府,2024-04-26,9822
5521,工信,21,2,19,元大-土城學府,2024-04-26,9822
6538,倉和,20,1,19,元大-土城學府,2024-04-26,9822
00937B,群益ESG投等債20,27,10,17,元大-土城學府,2024-04-26,9822
00929,復華台灣科技優息,17,2,15,元大-土城學府,2024-04-26,9822
1336,台翰,15,0,15,元大-土城學府,2024-04-26,9822
6140,訊達,14,0,14,元大-土城學府,2024-04-26,9822
1618,合機,29,16,13,元大-土城學府,2024-04-26,9822
2371,大同,40,28,12,元大-土城學府,2024-04-26,9822
2363,矽統,14,2,12,元大-土城學府,2024-04-26,9822
00688L,國泰20年美債正2,22,10,12,元大-土城學府,2024-04-26,9822
6411,晶焱,12,0,12,元大-土城學府,2024-04-26,9822
5347,世界,16,5,11,元大-土城學府,2024-04-26,9822
4157,太景*-KY,13,2,11,元大-土城學府,2024-04-26,9822
3231,緯創,13,3,10,元大-土城學府,2024-04-26,9822
1413,宏洲,10,0,10,元大-土城學府,2024-04-26,9822
1584,精剛,11,1,10,元大-土城學府,2024-04-26,9822
3013,晟銘電,19,9,10,元大-土城學府,2024-04-26,9822
8044,網家,10,0,10,元大-土城學府,2024-04-26,9822
3617,碩天,9,0,9,元大-土城學府,2024-04-26,9822
5512,力麒,30,21,9,元大-土城學府,2024-04-26,9822
912000,晨訊科-DR,9,0,9,元大-土城學府,2024-04-26,9822
3030,德律,19,11,8,元大-土城學府,2024-04-26,9822
00650L,復華香港正2,8,0,8,元大-土城學府,2024-04-26,9822
2883,凱基金,10,2,8,元大-土城學府,2024-04-26,9822
3033,威健,8,0,8,元大-土城學府,2024-04-26,9822
3051,力特,9,1,8,元大-土城學府,2024-04-26,9822
3706,神達,18,10,8,元大-土城學府,2024-04-26,9822
3712,永崴投控,8,0,8,元大-土城學府,2024-04-26,9822
5531,鄉林,12,4,8,元大-土城學府,2024-04-26,9822
00713,元大台灣高息低波,9,2,7,元大-土城學府,2024-04-26,9822
3147,大綜,7,0,7,元大-土城學府,2024-04-26,9822
00934,中信成長高股息,7,0,7,元大-土城學府,2024-04-26,9822
2104,國際中橡,7,0,7,元大-土城學府,2024-04-26,9822
2312,金寶,10,3,7,元大-土城學府,2024-04-26,9822
3056,富華新,26,19,7,元大-土城學府,2024-04-26,9822
5515,建國,7,0,7,元大-土城學府,2024-04-26,9822
1442,名軒,180,3,177,元大-土城學府,2024-04-29,9822
2618,長榮航,179,92,87,元大-土城學府,2024-04-29,9822
2363,矽統,100,19,81,元大-土城學府,2024-04-29,9822
2611,志信,50,0,50,元大-土城學府,2024-04-29,9822
6217,中探針,41,3,38,元大-土城學府,2024-04-29,9822
1101,台泥,35,0,35,元大-土城學府,2024-04-29,9822
3058,立德,30,0,30,元大-土城學府,2024-04-29,9822
2543,皇昌,26,0,26,元大-土城學府,2024-04-29,9822
2888,新光金,72,46,26,元大-土城學府,2024-04-29,9822
2371,大同,47,23,24,元大-土城學府,2024-04-29,9822
3047,訊舟,22,0,22,元大-土城學府,2024-04-29,9822
1609,大亞,29,8,21,元大-土城學府,2024-04-29,9822
1416,廣豐,20,0,20,元大-土城學府,2024-04-29,9822
1718,中纖,20,0,20,元大-土城學府,2024-04-29,9822
1905,華紙,30,10,20,元大-土城學府,2024-04-29,9822
1314,中石化,87,68,19,元大-土城學府,2024-04-29,9822
8011,台通,22,5,17,元大-土城學府,2024-04-29,9822
3481,群創,20,3,17,元大-土城學府,2024-04-29,9822
2607,榮運,18,2,16,元大-土城學府,2024-04-29,9822
2421,建準,15,0,15,元大-土城學府,2024-04-29,9822
2610,華航,37,22,15,元大-土城學府,2024-04-29,9822
1522,堤維西,18,4,14,元大-土城學府,2024-04-29,9822
00939,統一台灣高息動能,15,1,14,元大-土城學府,2024-04-29,9822
4532,瑞智,15,2,13,元大-土城學府,2024-04-29,9822
6411,晶焱,14,1,13,元大-土城學府,2024-04-29,9822
2359,所羅門,18,6,12,元大-土城學府,2024-04-29,9822
00632R,元大台灣50反1,12,0,12,元大-土城學府,2024-04-29,9822
8054,安國,13,1,12,元大-土城學府,2024-04-29,9822
3234,光環,13,2,11,元大-土城學府,2024-04-29,9822
9105,泰金寶-DR,10,0,10,元大-土城學府,2024-04-29,9822
00665L,富邦�琤肭磪囓�2,39,30,9,元大-土城學府,2024-04-29,9822
2486,一詮,19,10,9,元大-土城學府,2024-04-29,9822
8440,綠電,9,0,9,元大-土城學府,2024-04-29,9822
6770,力積電,18,9,9,元大-土城學府,2024-04-29,9822
8121,越峰,10,2,8,元大-土城學府,2024-04-29,9822
1524,耿鼎,7,0,7,元大-土城學府,2024-04-29,9822
2241,艾姆勒,7,0,7,元大-土城學府,2024-04-29,9822
2492,華新科,8,1,7,元大-土城學府,2024-04-29,9822
2641,正德,7,0,7,元大-土城學府,2024-04-29,9822
6248,沛波,7,0,7,元大-土城學府,2024-04-29,9822
2354,鴻準,20,13,7,元大-土城學府,2024-04-29,9822
2615,萬海,9,2,7,元大-土城學府,2024-04-29,9822
00915,凱基優選高股息30,7,0,7,元大-土城學府,2024-04-29,9822
1220,台榮,6,0,6,元大-土城學府,2024-04-29,9822
1808,潤隆,7,1,6,元大-土城學府,2024-04-29,9822
3025,星通,6,0,6,元大-土城學府,2024-04-29,9822
4960,誠美材,17,11,6,元大-土城學府,2024-04-29,9822
6431,光麗-KY,6,0,6,元大-土城學府,2024-04-29,9822
3231,緯創,11,6,5,元大-土城學府,2024-04-29,9822
00712,復華富時不動產,5,0,5,元大-土城學府,2024-04-29,9822
9105,泰金寶-DR,153,0,153,元大-土城學府,2024-04-30,9822
1455,集盛,177,25,152,元大-土城學府,2024-04-30,9822
5512,力麒,117,30,87,元大-土城學府,2024-04-30,9822
00937B,群益ESG投等債20,63,0,63,元大-土城學府,2024-04-30,9822
2515,中工,79,20,59,元大-土城學府,2024-04-30,9822
2801,彰銀,55,1,54,元大-土城學府,2024-04-30,9822
2855,統一證,51,0,51,元大-土城學府,2024-04-30,9822
6284,佳邦,51,2,49,元大-土城學府,2024-04-30,9822
2101,南港,115,74,41,元大-土城學府,2024-04-30,9822
2501,國建,55,24,31,元大-土城學府,2024-04-30,9822
00940,元大台灣價值高息,43,12,31,元大-土城學府,2024-04-30,9822
00919,群益台灣精選高息,32,3,29,元大-土城學府,2024-04-30,9822
2705,六福,31,2,29,元大-土城學府,2024-04-30,9822
9945,潤泰新,32,5,27,元大-土城學府,2024-04-30,9822
2888,新光金,34,9,25,元大-土城學府,2024-04-30,9822
5347,世界,27,3,24,元大-土城學府,2024-04-30,9822
2603,長榮,57,34,23,元大-土城學府,2024-04-30,9822
00929,復華台灣科技優息,26,3,23,元大-土城學府,2024-04-30,9822
1609,大亞,36,15,21,元大-土城學府,2024-04-30,9822
2367,燿華,24,4,20,元大-土城學府,2024-04-30,9822
6770,力積電,25,6,19,元大-土城學府,2024-04-30,9822
1101,台泥,19,0,19,元大-土城學府,2024-04-30,9822
2365,昆盈,24,6,18,元大-土城學府,2024-04-30,9822
1314,中石化,46,31,15,元大-土城學府,2024-04-30,9822
2630,亞航,14,0,14,元大-土城學府,2024-04-30,9822
3095,及成,13,0,13,元大-土城學府,2024-04-30,9822
3625,西勝,12,0,12,元大-土城學府,2024-04-30,9822
4167,松瑞藥,25,13,12,元大-土城學府,2024-04-30,9822
2812,台中銀,13,1,12,元大-土城學府,2024-04-30,9822
2617,台航,12,0,12,元大-土城學府,2024-04-30,9822
3711,日月光投控,15,3,12,元大-土城學府,2024-04-30,9822
00878,國泰永續高股息,13,2,11,元大-土城學府,2024-04-30,9822
00941,中信上游半導體,14,3,11,元大-土城學府,2024-04-30,9822
2880,華南金,37,26,11,元大-土城學府,2024-04-30,9822
4157,太景*-KY,11,0,11,元大-土城學府,2024-04-30,9822
2406,國碩,10,0,10,元大-土城學府,2024-04-30,9822
3231,緯創,12,2,10,元大-土城學府,2024-04-30,9822
0056,元大高股息,17,7,10,元大-土城學府,2024-04-30,9822
3163,波若威,12,3,9,元大-土城學府,2024-04-30,9822
1618,合機,14,5,9,元大-土城學府,2024-04-30,9822
2388,威盛,10,2,8,元大-土城學府,2024-04-30,9822
3037,欣興,8,1,7,元大-土城學府,2024-04-30,9822
00933B,國泰10Y+金融債,12,5,7,元大-土城學府,2024-04-30,9822
2610,華航,16,9,7,元大-土城學府,2024-04-30,9822
2913,農林,7,0,7,元大-土城學府,2024-04-30,9822
6016,康和證,10,3,7,元大-土城學府,2024-04-30,9822
8271,宇瞻,20,13,7,元大-土城學府,2024-04-30,9822
2327,國巨,7,0,7,元大-土城學府,2024-04-30,9822
1504,東元,8,2,6,元大-土城學府,2024-04-30,9822
00918,大華優利高填息30,8,2,6,元大-土城學府,2024-04-30,9822
9105,泰金寶-DR,250,0,250,元大-土城學府,2024-05-02,9822
00878,國泰永續高股息,152,4,148,元大-土城學府,2024-05-02,9822
00632R,元大台灣50反1,70,0,70,元大-土城學府,2024-05-02,9822
2317,鴻海,63,9,54,元大-土城學府,2024-05-02,9822
00929,復華台灣科技優息,57,3,54,元大-土城學府,2024-05-02,9822
2705,六福,50,0,50,元大-土城學府,2024-05-02,9822
2855,統一證,50,2,48,元大-土城學府,2024-05-02,9822
2609,陽明,64,25,39,元大-土城學府,2024-05-02,9822
6284,佳邦,36,2,34,元大-土城學府,2024-05-02,9822
5388,中磊,32,0,32,元大-土城學府,2024-05-02,9822
00919,群益台灣精選高息,33,2,31,元大-土城學府,2024-05-02,9822
00937B,群益ESG投等債20,30,0,30,元大-土城學府,2024-05-02,9822
3715,定穎投控,58,29,29,元大-土城學府,2024-05-02,9822
2101,南港,44,15,29,元大-土城學府,2024-05-02,9822
00680L,元大美債20正2,22,0,22,元大-土城學府,2024-05-02,9822
2515,中工,41,20,21,元大-土城學府,2024-05-02,9822
2363,矽統,37,16,21,元大-土城學府,2024-05-02,9822
00671R,富邦NASDAQ反1,20,0,20,元大-土城學府,2024-05-02,9822
2356,英業達,47,27,20,元大-土城學府,2024-05-02,9822
2401,凌陽,20,2,18,元大-土城學府,2024-05-02,9822
00679B,元大美債20年,18,0,18,元大-土城學府,2024-05-02,9822
00932,兆豐永續高息等權,16,0,16,元大-土城學府,2024-05-02,9822
1314,中石化,53,37,16,元大-土城學府,2024-05-02,9822
3481,群創,24,8,16,元大-土城學府,2024-05-02,9822
8064,東捷,19,4,15,元大-土城學府,2024-05-02,9822
2603,長榮,62,47,15,元大-土城學府,2024-05-02,9822
1616,億泰,15,0,15,元大-土城學府,2024-05-02,9822
1809,中釉,15,0,15,元大-土城學府,2024-05-02,9822
2537,聯上發,28,15,13,元大-土城學府,2024-05-02,9822
5371,中光電,16,3,13,元大-土城學府,2024-05-02,9822
2330,台積電,17,4,13,元大-土城學府,2024-05-02,9822
00940,元大台灣價值高息,47,35,12,元大-土城學府,2024-05-02,9822
00715L,期街口布蘭特正2,12,0,12,元大-土城學府,2024-05-02,9822
00918,大華優利高填息30,14,2,12,元大-土城學府,2024-05-02,9822
3706,神達,14,3,11,元大-土城學府,2024-05-02,9822
1718,中纖,10,0,10,元大-土城學府,2024-05-02,9822
2615,萬海,16,6,10,元大-土城學府,2024-05-02,9822
4533,協易機,28,18,10,元大-土城學府,2024-05-02,9822
6163,華電網,10,0,10,元大-土城學府,2024-05-02,9822
1442,名軒,11,1,10,元大-土城學府,2024-05-02,9822
00921,兆豐龍頭等權重,10,1,9,元大-土城學府,2024-05-02,9822
2611,志信,14,5,9,元大-土城學府,2024-05-02,9822
2885,元大金,10,1,9,元大-土城學府,2024-05-02,9822
6177,達麗,14,5,9,元大-土城學府,2024-05-02,9822
2031,新光鋼,8,0,8,元大-土城學府,2024-05-02,9822
2367,燿華,15,7,8,元大-土城學府,2024-05-02,9822
2303,聯電,12,5,7,元大-土城學府,2024-05-02,9822
5508,永信建,23,16,7,元大-土城學府,2024-05-02,9822
1909,榮成,10,3,7,元大-土城學府,2024-05-02,9822
2241,艾姆勒,10,3,7,元大-土城學府,2024-05-02,9822
9105,泰金寶-DR,300,0,300,元大-土城學府,2024-05-03,9822
2855,統一證,100,10,90,元大-土城學府,2024-05-03,9822
00940,元大台灣價值高息,64,2,62,元大-土城學府,2024-05-03,9822
2641,正德,55,0,55,元大-土城學府,2024-05-03,9822
00937B,群益ESG投等債20,45,0,45,元大-土城學府,2024-05-03,9822
2610,華航,105,62,43,元大-土城學府,2024-05-03,9822
1455,集盛,41,1,40,元大-土城學府,2024-05-03,9822
6284,佳邦,41,4,37,元大-土城學府,2024-05-03,9822
1609,大亞,69,34,35,元大-土城學府,2024-05-03,9822
1316,上曜,89,55,34,元大-土城學府,2024-05-03,9822
00919,群益台灣精選高息,37,4,33,元大-土城學府,2024-05-03,9822
5388,中磊,31,0,31,元大-土城學府,2024-05-03,9822
00932,兆豐永續高息等權,27,0,27,元大-土城學府,2024-05-03,9822
2504,國產,29,2,27,元大-土城學府,2024-05-03,9822
5512,力麒,27,1,26,元大-土城學府,2024-05-03,9822
00929,復華台灣科技優息,33,8,25,元大-土城學府,2024-05-03,9822
00878,國泰永續高股息,31,8,23,元大-土城學府,2024-05-03,9822
1514,亞力,46,25,21,元大-土城學府,2024-05-03,9822
6538,倉和,27,6,21,元大-土城學府,2024-05-03,9822
00688L,國泰20年美債正2,20,0,20,元大-土城學府,2024-05-03,9822
2515,中工,34,16,18,元大-土城學府,2024-05-03,9822
00680L,元大美債20正2,18,0,18,元大-土城學府,2024-05-03,9822
2609,陽明,35,17,18,元大-土城學府,2024-05-03,9822
00679B,元大美債20年,16,0,16,元大-土城學府,2024-05-03,9822
2501,國建,175,159,16,元大-土城學府,2024-05-03,9822
3583,辛耘,15,0,15,元大-土城學府,2024-05-03,9822
2537,聯上發,37,23,14,元大-土城學府,2024-05-03,9822
2739,寒舍,14,0,14,元大-土城學府,2024-05-03,9822
2206,三陽工業,16,3,13,元大-土城學府,2024-05-03,9822
00931B,統一美債20年,13,0,13,元大-土城學府,2024-05-03,9822
3706,神達,21,8,13,元大-土城學府,2024-05-03,9822
5521,工信,21,8,13,元大-土城學府,2024-05-03,9822
8064,東捷,14,1,13,元大-土城學府,2024-05-03,9822
00939,統一台灣高息動能,12,0,12,元大-土城學府,2024-05-03,9822
1442,名軒,15,3,12,元大-土城學府,2024-05-03,9822
1708,東鹼,12,0,12,元大-土城學府,2024-05-03,9822
2888,新光金,23,11,12,元大-土城學府,2024-05-03,9822
3037,欣興,13,2,11,元大-土城學府,2024-05-03,9822
2009,第一銅,11,0,11,元大-土城學府,2024-05-03,9822
2316,楠梓電,11,0,11,元大-土城學府,2024-05-03,9822
00882,中信中國高股息,11,1,10,元大-土城學府,2024-05-03,9822
00687B,國泰20年美債,10,0,10,元大-土城學府,2024-05-03,9822
00632R,元大台灣50反1,10,0,10,元大-土城學府,2024-05-03,9822
00671R,富邦NASDAQ反1,10,0,10,元大-土城學府,2024-05-03,9822
2402,毅嘉,10,0,10,元大-土城學府,2024-05-03,9822
3013,晟銘電,10,0,10,元大-土城學府,2024-05-03,9822
8011,台通,10,0,10,元大-土城學府,2024-05-03,9822
8926,台汽電,10,0,10,元大-土城學府,2024-05-03,9822
3231,緯創,11,1,10,元大-土城學府,2024-05-03,9822
00706L,期元大S＆P日圓正2,9,0,9,元大-土城學府,2024-05-03,9822
9105,泰金寶-DR,195,0,195,元大-土城學府,2024-05-06,9822
6143,振曜,94,4,90,元大-土城學府,2024-05-06,9822
9927,泰銘,81,0,81,元大-土城學府,2024-05-06,9822
2618,長榮航,117,52,65,元大-土城學府,2024-05-06,9822
2501,國建,205,158,47,元大-土城學府,2024-05-06,9822
00929,復華台灣科技優息,66,20,46,元大-土城學府,2024-05-06,9822
9933,中鼎,40,1,39,元大-土城學府,2024-05-06,9822
3679,新至陞,37,0,37,元大-土城學府,2024-05-06,9822
2363,矽統,38,7,31,元大-土城學府,2024-05-06,9822
2855,統一證,30,0,30,元大-土城學府,2024-05-06,9822
6257,矽格,30,0,30,元大-土城學府,2024-05-06,9822
2867,三商壽,30,1,29,元大-土城學府,2024-05-06,9822
6278,台表科,25,0,25,元大-土城學府,2024-05-06,9822
2368,金像電,25,0,25,元大-土城學府,2024-05-06,9822
2371,大同,36,13,23,元大-土城學府,2024-05-06,9822
00679B,元大美債20年,21,1,20,元大-土城學府,2024-05-06,9822
2449,京元電子,33,13,20,元大-土城學府,2024-05-06,9822
5512,力麒,19,1,18,元大-土城學府,2024-05-06,9822
6770,力積電,19,1,18,元大-土城學府,2024-05-06,9822
5498,凱崴,16,0,16,元大-土城學府,2024-05-06,9822
2515,中工,33,18,15,元大-土城學府,2024-05-06,9822
5511,德昌,16,2,14,元大-土城學府,2024-05-06,9822
3402,漢科,13,0,13,元大-土城學府,2024-05-06,9822
1708,東鹼,13,0,13,元大-土城學府,2024-05-06,9822
00878,國泰永續高股息,27,14,13,元大-土城學府,2024-05-06,9822
3576,聯合再生,12,0,12,元大-土城學府,2024-05-06,9822
3703,欣陸,19,7,12,元大-土城學府,2024-05-06,9822
6235,華孚,12,0,12,元大-土城學府,2024-05-06,9822
2352,佳世達,11,0,11,元大-土城學府,2024-05-06,9822
00665L,富邦�琤肭磪囓�2,11,0,11,元大-土城學府,2024-05-06,9822
1314,中石化,29,18,11,元大-土城學府,2024-05-06,9822
2344,華邦電,11,0,11,元大-土城學府,2024-05-06,9822
3189,景碩,11,0,11,元大-土城學府,2024-05-06,9822
00680L,元大美債20正2,10,0,10,元大-土城學府,2024-05-06,9822
00632R,元大台灣50反1,10,0,10,元大-土城學府,2024-05-06,9822
4303,信立,13,3,10,元大-土城學府,2024-05-06,9822
6282,康舒,9,0,9,元大-土城學府,2024-05-06,9822
00687B,國泰20年美債,13,4,9,元大-土城學府,2024-05-06,9822
4402,郡都開發,10,1,9,元大-土城學府,2024-05-06,9822
2101,南港,23,15,8,元大-土城學府,2024-05-06,9822
2543,皇昌,56,48,8,元大-土城學府,2024-05-06,9822
2025,千興,10,2,8,元大-土城學府,2024-05-06,9822
2027,大成鋼,10,2,8,元大-土城學府,2024-05-06,9822
2374,佳能,14,6,8,元大-土城學府,2024-05-06,9822
3021,鴻名,8,0,8,元大-土城學府,2024-05-06,9822
3264,欣銓,8,0,8,元大-土城學府,2024-05-06,9822
6215,和椿,7,0,7,元大-土城學府,2024-05-06,9822
1609,大亞,9,2,7,元大-土城學府,2024-05-06,9822
2731,雄獅,7,0,7,元大-土城學府,2024-05-06,9822
9945,潤泰新,18,11,7,元大-土城學府,2024-05-06,9822
2101,南港,112,37,75,元大-土城學府,2024-05-07,9822
2610,華航,71,0,71,元大-土城學府,2024-05-07,9822
9927,泰銘,67,1,66,元大-土城學府,2024-05-07,9822
00878,國泰永續高股息,64,2,62,元大-土城學府,2024-05-07,9822
6257,矽格,60,1,59,元大-土城學府,2024-05-07,9822
2618,長榮航,79,40,39,元大-土城學府,2024-05-07,9822
00940,元大台灣價值高息,45,7,38,元大-土城學府,2024-05-07,9822
2515,中工,58,23,35,元大-土城學府,2024-05-07,9822
1702,南僑,34,0,34,元大-土城學府,2024-05-07,9822
1440,南紡,30,0,30,元大-土城學府,2024-05-07,9822
6265,方土昶,28,2,26,元大-土城學府,2024-05-07,9822
3481,群創,29,4,25,元大-土城學府,2024-05-07,9822
2353,宏��,24,1,23,元大-土城學府,2024-05-07,9822
3033,威健,50,27,23,元大-土城學府,2024-05-07,9822
00882,中信中國高股息,24,2,22,元大-土城學府,2024-05-07,9822
3047,訊舟,22,0,22,元大-土城學府,2024-05-07,9822
2834,臺企銀,25,5,20,元大-土城學府,2024-05-07,9822
00937B,群益ESG投等債20,31,11,20,元大-土城學府,2024-05-07,9822
1608,華榮,26,7,19,元大-土城學府,2024-05-07,9822
8996,高力,18,0,18,元大-土城學府,2024-05-07,9822
6278,台表科,20,2,18,元大-土城學府,2024-05-07,9822
2855,統一證,18,0,18,元大-土城學府,2024-05-07,9822
3090,日電貿,21,5,16,元大-土城學府,2024-05-07,9822
00919,群益台灣精選高息,30,15,15,元大-土城學府,2024-05-07,9822
6125,廣運,33,18,15,元大-土城學府,2024-05-07,9822
8048,德勝,21,7,14,元大-土城學府,2024-05-07,9822
5392,能率,13,0,13,元大-土城學府,2024-05-07,9822
00929,復華台灣科技優息,40,28,12,元大-土城學府,2024-05-07,9822
2543,皇昌,22,10,12,元大-土城學府,2024-05-07,9822
2504,國產,12,0,12,元大-土城學府,2024-05-07,9822
2363,矽統,11,0,11,元大-土城學府,2024-05-07,9822
2014,中鴻,10,0,10,元大-土城學府,2024-05-07,9822
2421,建準,10,0,10,元大-土城學府,2024-05-07,9822
3707,漢磊,10,0,10,元大-土城學府,2024-05-07,9822
5864,致和證,10,0,10,元大-土城學府,2024-05-07,9822
2501,國建,218,208,10,元大-土城學府,2024-05-07,9822
2486,一詮,50,40,10,元大-土城學府,2024-05-07,9822
5498,凱崴,9,0,9,元大-土城學府,2024-05-07,9822
1316,上曜,11,2,9,元大-土城學府,2024-05-07,9822
2535,達欣工,8,0,8,元大-土城學府,2024-05-07,9822
4503,金雨,10,2,8,元大-土城學府,2024-05-07,9822
2382,廣達,11,4,7,元大-土城學府,2024-05-07,9822
5512,力麒,16,9,7,元大-土城學府,2024-05-07,9822
2031,新光鋼,7,0,7,元大-土城學府,2024-05-07,9822
3013,晟銘電,28,21,7,元大-土城學府,2024-05-07,9822
3264,欣銓,7,0,7,元大-土城學府,2024-05-07,9822
6117,迎廣,21,14,7,元大-土城學府,2024-05-07,9822
6227,茂綸,8,1,7,元大-土城學府,2024-05-07,9822
00933B,國泰10Y+金融債,7,0,7,元大-土城學府,2024-05-07,9822
3686,達能,7,1,6,元大-土城學府,2024-05-07,9822
00929,復華台灣科技優息,234,16,218,元大-土城學府,2024-05-08,9822
00679B,元大美債20年,113,22,91,元大-土城學府,2024-05-08,9822
2101,南港,89,26,63,元大-土城學府,2024-05-08,9822
1702,南僑,57,0,57,元大-土城學府,2024-05-08,9822
00665L,富邦�琤肭磪囓�2,103,50,53,元大-土城學府,2024-05-08,9822
00937B,群益ESG投等債20,44,0,44,元大-土城學府,2024-05-08,9822
4707,磐亞,44,0,44,元大-土城學府,2024-05-08,9822
2374,佳能,51,8,43,元大-土城學府,2024-05-08,9822
2376,技嘉,47,7,40,元大-土城學府,2024-05-08,9822
1440,南紡,39,3,36,元大-土城學府,2024-05-08,9822
2855,統一證,29,3,26,元大-土城學府,2024-05-08,9822
2603,長榮,90,65,25,元大-土城學府,2024-05-08,9822
2329,華泰,25,1,24,元大-土城學府,2024-05-08,9822
1618,合機,49,27,22,元大-土城學府,2024-05-08,9822
00941,中信上游半導體,21,1,20,元大-土城學府,2024-05-08,9822
00918,大華優利高填息30,22,3,19,元大-土城學府,2024-05-08,9822
3624,光頡,20,1,19,元大-土城學府,2024-05-08,9822
00932,兆豐永續高息等權,18,0,18,元大-土城學府,2024-05-08,9822
3706,神達,21,3,18,元大-土城學府,2024-05-08,9822
3715,定穎投控,18,1,17,元大-土城學府,2024-05-08,9822
1314,中石化,22,6,16,元大-土城學府,2024-05-08,9822
2618,長榮航,44,29,15,元大-土城學府,2024-05-08,9822
3617,碩天,15,0,15,元大-土城學府,2024-05-08,9822
8210,勤誠,16,1,15,元大-土城學府,2024-05-08,9822
1609,大亞,62,48,14,元大-土城學府,2024-05-08,9822
00940,元大台灣價值高息,63,51,12,元大-土城學府,2024-05-08,9822
2504,國產,12,0,12,元大-土城學府,2024-05-08,9822
2891,中信金,17,6,11,元大-土城學府,2024-05-08,9822
2545,皇翔,11,0,11,元大-土城學府,2024-05-08,9822
1612,宏泰,17,6,11,元大-土城學府,2024-05-08,9822
2313,華通,11,0,11,元大-土城學府,2024-05-08,9822
6005,群益證,17,6,11,元大-土城學府,2024-05-08,9822
3036,文曄,11,0,11,元大-土城學府,2024-05-08,9822
5871,中租-KY,12,1,11,元大-土城學府,2024-05-08,9822
2317,鴻海,19,8,11,元大-土城學府,2024-05-08,9822
8011,台通,11,1,10,元大-土城學府,2024-05-08,9822
00664R,國泰臺灣加權反1,10,0,10,元大-土城學府,2024-05-08,9822
1416,廣豐,10,0,10,元大-土城學府,2024-05-08,9822
2511,太子,10,0,10,元大-土城學府,2024-05-08,9822
2637,慧洋-KY,13,4,9,元大-土城學府,2024-05-08,9822
3147,大綜,9,0,9,元大-土城學府,2024-05-08,9822
5515,建國,10,1,9,元大-土城學府,2024-05-08,9822
6015,宏遠證,9,0,9,元大-土城學府,2024-05-08,9822
6290,良維,10,1,9,元大-土城學府,2024-05-08,9822
00712,復華富時不動產,11,3,8,元大-土城學府,2024-05-08,9822
2027,大成鋼,8,0,8,元大-土城學府,2024-05-08,9822
5386,青雲,8,0,8,元大-土城學府,2024-05-08,9822
2501,國建,210,202,8,元大-土城學府,2024-05-08,9822
1808,潤隆,7,0,7,元大-土城學府,2024-05-08,9822
3024,憶聲,7,0,7,元大-土城學府,2024-05-08,9822
2101,南港,227,32,195,元大-土城學府,2024-05-09,9822
00946,群益科技高息成長,161,5,156,元大-土城學府,2024-05-09,9822
00632R,元大台灣50反1,214,100,114,元大-土城學府,2024-05-09,9822
1815,富喬,138,25,113,元大-土城學府,2024-05-09,9822
00679B,元大美債20年,80,1,79,元大-土城學府,2024-05-09,9822
00944,野村趨勢動能高息,74,0,74,元大-土城學府,2024-05-09,9822
3715,定穎投控,79,23,56,元大-土城學府,2024-05-09,9822
2449,京元電子,45,2,43,元大-土城學府,2024-05-09,9822
00940,元大台灣價值高息,42,4,38,元大-土城學府,2024-05-09,9822
2515,中工,38,1,37,元大-土城學府,2024-05-09,9822
2888,新光金,38,1,37,元大-土城學府,2024-05-09,9822
4714,永捷,36,0,36,元大-土城學府,2024-05-09,9822
00929,復華台灣科技優息,36,0,36,元大-土城學府,2024-05-09,9822
00687B,國泰20年美債,44,10,34,元大-土城學府,2024-05-09,9822
3363,上詮,36,2,34,元大-土城學府,2024-05-09,9822
00937B,群益ESG投等債20,29,0,29,元大-土城學府,2024-05-09,9822
00931B,統一美債20年,29,0,29,元大-土城學府,2024-05-09,9822
00932,兆豐永續高息等權,27,0,27,元大-土城學府,2024-05-09,9822
2324,仁寶,40,13,27,元大-土城學府,2024-05-09,9822
00878,國泰永續高股息,59,33,26,元大-土城學府,2024-05-09,9822
1618,合機,38,13,25,元大-土城學府,2024-05-09,9822
6438,迅得,25,0,25,元大-土城學府,2024-05-09,9822
3060,銘異,23,0,23,元大-土城學府,2024-05-09,9822
1609,大亞,68,47,21,元大-土城學府,2024-05-09,9822
2885,元大金,26,5,21,元大-土城學府,2024-05-09,9822
2371,大同,40,19,21,元大-土城學府,2024-05-09,9822
8112,至上,26,5,21,元大-土城學府,2024-05-09,9822
1611,中電,19,0,19,元大-土城學府,2024-05-09,9822
4967,十銓,28,11,17,元大-土城學府,2024-05-09,9822
2464,盟立,26,10,16,元大-土城學府,2024-05-09,9822
2834,臺企銀,16,0,16,元大-土城學府,2024-05-09,9822
6257,矽格,16,0,16,元大-土城學府,2024-05-09,9822
3552,同致,15,0,15,元大-土城學府,2024-05-09,9822
00915,凱基優選高股息30,14,0,14,元大-土城學府,2024-05-09,9822
5351,鈺創,20,6,14,元大-土城學府,2024-05-09,9822
2601,益航,18,4,14,元大-土城學府,2024-05-09,9822
4533,協易機,14,0,14,元大-土城學府,2024-05-09,9822
3231,緯創,15,1,14,元大-土城學府,2024-05-09,9822
2880,華南金,15,2,13,元大-土城學府,2024-05-09,9822
2884,玉山金,12,0,12,元大-土城學府,2024-05-09,9822
2363,矽統,33,21,12,元大-土城學府,2024-05-09,9822
2374,佳能,15,3,12,元大-土城學府,2024-05-09,9822
4949,有成精密,13,1,12,元大-土城學府,2024-05-09,9822
2327,國巨,11,1,10,元大-土城學府,2024-05-09,9822
00935,野村臺灣新科技50,10,0,10,元大-土城學府,2024-05-09,9822
1101,台泥,10,0,10,元大-土城學府,2024-05-09,9822
1455,集盛,10,0,10,元大-土城學府,2024-05-09,9822
3617,碩天,10,0,10,元大-土城學府,2024-05-09,9822
2344,華邦電,11,2,9,元大-土城學府,2024-05-09,9822
6284,佳邦,10,1,9,元大-土城學府,2024-05-09,9822
00946,群益科技高息成長,72,0,72,元大-土城學府,2024-05-10,9822
6177,達麗,70,0,70,元大-土城學府,2024-05-10,9822
00932,兆豐永續高息等權,56,0,56,元大-土城學府,2024-05-10,9822
6757,台灣虎航,54,0,54,元大-土城學府,2024-05-10,9822
1702,南僑,53,0,53,元大-土城學府,2024-05-10,9822
1721,三晃,52,0,52,元大-土城學府,2024-05-10,9822
2101,南港,125,74,51,元大-土城學府,2024-05-10,9822
00940,元大台灣價值高息,81,33,48,元大-土城學府,2024-05-10,9822
6605,帝寶,44,0,44,元大-土城學府,2024-05-10,9822
8112,至上,55,15,40,元大-土城學府,2024-05-10,9822
3711,日月光投控,50,11,39,元大-土城學府,2024-05-10,9822
5871,中租-KY,34,0,34,元大-土城學府,2024-05-10,9822
2618,長榮航,129,95,34,元大-土城學府,2024-05-10,9822
2313,華通,42,16,26,元大-土城學府,2024-05-10,9822
00939,統一台灣高息動能,21,1,20,元大-土城學府,2024-05-10,9822
6152,百一,20,0,20,元大-土城學府,2024-05-10,9822
1314,中石化,39,21,18,元大-土城學府,2024-05-10,9822
6770,力積電,18,0,18,元大-土城學府,2024-05-10,9822
6116,彩晶,16,0,16,元大-土城學府,2024-05-10,9822
6284,佳邦,16,0,16,元大-土城學府,2024-05-10,9822
6462,神盾,16,0,16,元大-土城學府,2024-05-10,9822
00919,群益台灣精選高息,18,3,15,元大-土城學府,2024-05-10,9822
6863,永道-KY,15,0,15,元大-土城學府,2024-05-10,9822
2352,佳世達,14,0,14,元大-土城學府,2024-05-10,9822
3715,定穎投控,14,0,14,元大-土城學府,2024-05-10,9822
2402,毅嘉,14,0,14,元大-土城學府,2024-05-10,9822
4167,松瑞藥,25,11,14,元大-土城學府,2024-05-10,9822
00915,凱基優選高股息30,14,1,13,元大-土城學府,2024-05-10,9822
3013,晟銘電,51,40,11,元大-土城學府,2024-05-10,9822
1524,耿鼎,14,3,11,元大-土城學府,2024-05-10,9822
2349,錸德,11,0,11,元大-土城學府,2024-05-10,9822
2359,所羅門,42,31,11,元大-土城學府,2024-05-10,9822
00665L,富邦�琤肭磪囓�2,10,0,10,元大-土城學府,2024-05-10,9822
00918,大華優利高填息30,12,2,10,元大-土城學府,2024-05-10,9822
2303,聯電,22,12,10,元大-土城學府,2024-05-10,9822
00937B,群益ESG投等債20,10,0,10,元大-土城學府,2024-05-10,9822
4707,磐亞,10,1,9,元大-土城學府,2024-05-10,9822
6278,台表科,10,1,9,元大-土城學府,2024-05-10,9822
3036,文曄,9,0,9,元大-土城學府,2024-05-10,9822
1609,大亞,27,19,8,元大-土城學府,2024-05-10,9822
3293,鈊象,12,4,8,元大-土城學府,2024-05-10,9822
2537,聯上發,14,6,8,元大-土城學府,2024-05-10,9822
8150,南茂,9,1,8,元大-土城學府,2024-05-10,9822
1815,富喬,10,2,8,元大-土城學府,2024-05-10,9822
2449,京元電子,9,2,7,元大-土城學府,2024-05-10,9822
1608,華榮,8,1,7,元大-土城學府,2024-05-10,9822
2421,建準,9,2,7,元大-土城學府,2024-05-10,9822
4967,十銓,13,6,7,元大-土城學府,2024-05-10,9822
8086,宏捷科,9,2,7,元大-土城學府,2024-05-10,9822
00931B,統一美債20年,6,0,6,元大-土城學府,2024-05-10,9822
00929,復華台灣科技優息,326,65,261,元大-土城學府,2024-05-13,9822
2867,三商壽,160,0,160,元大-土城學府,2024-05-13,9822
2101,南港,113,15,98,元大-土城學府,2024-05-13,9822
1721,三晃,86,2,84,元大-土城學府,2024-05-13,9822
2618,長榮航,153,80,73,元大-土城學府,2024-05-13,9822
2603,長榮,102,45,57,元大-土城學府,2024-05-13,9822
00878,國泰永續高股息,68,13,55,元大-土城學府,2024-05-13,9822
6757,台灣虎航,50,0,50,元大-土城學府,2024-05-13,9822
3231,緯創,62,18,44,元大-土城學府,2024-05-13,9822
2344,華邦電,41,1,40,元大-土城學府,2024-05-13,9822
00891,中信關鍵半導體,32,0,32,元大-土城學府,2024-05-13,9822
2356,英業達,78,50,28,元大-土城學府,2024-05-13,9822
2515,中工,39,11,28,元大-土城學府,2024-05-13,9822
00937B,群益ESG投等債20,27,0,27,元大-土城學府,2024-05-13,9822
2882,國泰金,36,9,27,元大-土城學府,2024-05-13,9822
2317,鴻海,34,10,24,元大-土城學府,2024-05-13,9822
2409,友達,26,3,23,元大-土城學府,2024-05-13,9822
2855,統一證,23,0,23,元大-土城學府,2024-05-13,9822
3260,威剛,23,5,18,元大-土城學府,2024-05-13,9822
00946,群益科技高息成長,16,0,16,元大-土城學府,2024-05-13,9822
1609,大亞,25,9,16,元大-土城學府,2024-05-13,9822
00919,群益台灣精選高息,33,17,16,元大-土城學府,2024-05-13,9822
00923,群益台ESG低碳50,26,10,16,元大-土城學府,2024-05-13,9822
1440,南紡,20,5,15,元大-土城學府,2024-05-13,9822
2352,佳世達,15,0,15,元大-土城學府,2024-05-13,9822
3617,碩天,15,0,15,元大-土城學府,2024-05-13,9822
00915,凱基優選高股息30,16,2,14,元大-土城學府,2024-05-13,9822
2241,艾姆勒,48,35,13,元大-土城學府,2024-05-13,9822
2367,燿華,28,15,13,元大-土城學府,2024-05-13,9822
6139,亞翔,13,0,13,元大-土城學府,2024-05-13,9822
2449,京元電子,12,0,12,元大-土城學府,2024-05-13,9822
00944,野村趨勢動能高息,12,0,12,元大-土城學府,2024-05-13,9822
2363,矽統,30,18,12,元大-土城學府,2024-05-13,9822
2606,裕民,38,26,12,元大-土城學府,2024-05-13,9822
00632R,元大台灣50反1,216,205,11,元大-土城學府,2024-05-13,9822
00637L,元大滬深300正2,11,0,11,元大-土城學府,2024-05-13,9822
1536,和大,10,0,10,元大-土城學府,2024-05-13,9822
00930,永豐ESG低碳高息,10,0,10,元大-土城學府,2024-05-13,9822
2607,榮運,10,0,10,元大-土城學府,2024-05-13,9822
2617,台航,31,21,10,元大-土城學府,2024-05-13,9822
4114,健喬,10,0,10,元大-土城學府,2024-05-13,9822
6863,永道-KY,10,0,10,元大-土城學府,2024-05-13,9822
2605,新興,25,16,9,元大-土城學府,2024-05-13,9822
3313,斐成,9,0,9,元大-土城學府,2024-05-13,9822
6538,倉和,10,1,9,元大-土城學府,2024-05-13,9822
3013,晟銘電,20,12,8,元大-土城學府,2024-05-13,9822
4714,永捷,8,0,8,元大-土城學府,2024-05-13,9822
6547,高端疫苗,9,1,8,元大-土城學府,2024-05-13,9822
2615,萬海,66,59,7,元大-土城學府,2024-05-13,9822
3324,雙鴻,11,4,7,元大-土城學府,2024-05-13,9822
00680L,元大美債20正2,106,0,106,元大-土城學府,2024-05-14,9822
2615,萬海,332,255,77,元大-土城學府,2024-05-14,9822
00878,國泰永續高股息,91,19,72,元大-土城學府,2024-05-14,9822
2880,華南金,41,0,41,元大-土城學府,2024-05-14,9822
6757,台灣虎航,34,0,34,元大-土城學府,2024-05-14,9822
2472,立隆電,31,0,31,元大-土城學府,2024-05-14,9822
00637L,元大滬深300正2,30,0,30,元大-土城學府,2024-05-14,9822
8111,立��,30,0,30,元大-土城學府,2024-05-14,9822
4167,松瑞藥,25,0,25,元大-土城學府,2024-05-14,9822
00929,復華台灣科技優息,33,8,25,元大-土城學府,2024-05-14,9822
6265,方土昶,23,0,23,元大-土城學府,2024-05-14,9822
00919,群益台灣精選高息,52,29,23,元大-土城學府,2024-05-14,9822
00933B,國泰10Y+金融債,21,0,21,元大-土城學府,2024-05-14,9822
2371,大同,33,12,21,元大-土城學府,2024-05-14,9822
00937B,群益ESG投等債20,20,0,20,元大-土城學府,2024-05-14,9822
1416,廣豐,20,0,20,元大-土城學府,2024-05-14,9822
5288,豐祥-KY,20,0,20,元大-土城學府,2024-05-14,9822
6863,永道-KY,24,4,20,元大-土城學府,2024-05-14,9822
6538,倉和,20,1,19,元大-土城學府,2024-05-14,9822
2317,鴻海,37,18,19,元大-土城學府,2024-05-14,9822
00936,台新永續高息中小,18,0,18,元大-土城學府,2024-05-14,9822
1402,遠東新,16,0,16,元大-土城學府,2024-05-14,9822
2348,海悅,15,0,15,元大-土城學府,2024-05-14,9822
3363,上詮,21,6,15,元大-土城學府,2024-05-14,9822
00935,野村臺灣新科技50,15,0,15,元大-土城學府,2024-05-14,9822
00679B,元大美債20年,14,0,14,元大-土城學府,2024-05-14,9822
2515,中工,37,23,14,元大-土城學府,2024-05-14,9822
00665L,富邦�琤肭磪囓�2,13,0,13,元大-土城學府,2024-05-14,9822
2409,友達,11,0,11,元大-土城學府,2024-05-14,9822
6190,萬泰科,12,1,11,元大-土城學府,2024-05-14,9822
00664R,國泰臺灣加權反1,10,0,10,元大-土城學府,2024-05-14,9822
3402,漢科,10,0,10,元大-土城學府,2024-05-14,9822
4536,拓凱,10,0,10,元大-土城學府,2024-05-14,9822
4714,永捷,12,2,10,元大-土城學府,2024-05-14,9822
6244,茂迪,10,0,10,元大-土城學府,2024-05-14,9822
8213,志超,11,1,10,元大-土城學府,2024-05-14,9822
9904,寶成,11,1,10,元大-土城學府,2024-05-14,9822
6684,安格,16,7,9,元大-土城學府,2024-05-14,9822
5871,中租-KY,9,0,9,元大-土城學府,2024-05-14,9822
1409,新纖,10,1,9,元大-土城學府,2024-05-14,9822
2023,燁輝,10,1,9,元大-土城學府,2024-05-14,9822
2301,光寶科,11,2,9,元大-土城學府,2024-05-14,9822
5701,劍湖山,19,10,9,元大-土城學府,2024-05-14,9822
2891,中信金,8,0,8,元大-土城學府,2024-05-14,9822
2374,佳能,29,21,8,元大-土城學府,2024-05-14,9822
2537,聯上發,8,0,8,元大-土城學府,2024-05-14,9822
2405,輔信,11,4,7,元大-土城學府,2024-05-14,9822
5392,能率,9,2,7,元大-土城學府,2024-05-14,9822
5864,致和證,7,0,7,元大-土城學府,2024-05-14,9822
6689,伊雲谷,7,0,7,元大-土城學府,2024-05-14,9822
2641,正德,113,5,108,元大-土城學府,2024-05-15,9822
00929,復華台灣科技優息,131,30,101,元大-土城學府,2024-05-15,9822
2356,英業達,166,76,90,元大-土城學府,2024-05-15,9822
00940,元大台灣價值高息,181,99,82,元大-土城學府,2024-05-15,9822
2101,南港,68,13,55,元大-土城學府,2024-05-15,9822
2888,新光金,50,0,50,元大-土城學府,2024-05-15,9822
00679B,元大美債20年,43,0,43,元大-土城學府,2024-05-15,9822
00939,統一台灣高息動能,65,28,37,元大-土城學府,2024-05-15,9822
6863,永道-KY,38,2,36,元大-土城學府,2024-05-15,9822
2367,燿華,137,104,33,元大-土城學府,2024-05-15,9822
6753,龍德造船,35,4,31,元大-土城學府,2024-05-15,9822
00646,元大S＆P500,28,0,28,元大-土城學府,2024-05-15,9822
00937B,群益ESG投等債20,29,3,26,元大-土城學府,2024-05-15,9822
4167,松瑞藥,26,0,26,元大-土城學府,2024-05-15,9822
2515,中工,23,1,22,元大-土城學府,2024-05-15,9822
2206,三陽工業,27,6,21,元大-土城學府,2024-05-15,9822
3028,增你強,20,0,20,元大-土城學府,2024-05-15,9822
2743,山富,20,1,19,元大-土城學府,2024-05-15,9822
2324,仁寶,23,5,18,元大-土城學府,2024-05-15,9822
2618,長榮航,55,38,17,元大-土城學府,2024-05-15,9822
2352,佳世達,17,0,17,元大-土城學府,2024-05-15,9822
2630,亞航,21,4,17,元大-土城學府,2024-05-15,9822
00919,群益台灣精選高息,25,10,15,元大-土城學府,2024-05-15,9822
6531,愛普*,15,0,15,元大-土城學府,2024-05-15,9822
4960,誠美材,20,5,15,元大-土城學府,2024-05-15,9822
3706,神達,26,13,13,元大-土城學府,2024-05-15,9822
00941,中信上游半導體,13,0,13,元大-土城學府,2024-05-15,9822
00945B,凱基美國非投等債,13,0,13,元大-土城學府,2024-05-15,9822
3481,群創,15,2,13,元大-土城學府,2024-05-15,9822
00946,群益科技高息成長,23,10,13,元大-土城學府,2024-05-15,9822
1314,中石化,22,10,12,元大-土城學府,2024-05-15,9822
2371,大同,21,9,12,元大-土城學府,2024-05-15,9822
2915,潤泰全,16,4,12,元大-土城學府,2024-05-15,9822
4536,拓凱,11,0,11,元大-土城學府,2024-05-15,9822
00944,野村趨勢動能高息,10,0,10,元大-土城學府,2024-05-15,9822
1536,和大,10,0,10,元大-土城學府,2024-05-15,9822
2323,中環,13,3,10,元大-土城學府,2024-05-15,9822
2486,一詮,30,20,10,元大-土城學府,2024-05-15,9822
2867,三商壽,10,0,10,元大-土城學府,2024-05-15,9822
3047,訊舟,39,29,10,元大-土城學府,2024-05-15,9822
4414,如興,10,0,10,元大-土城學府,2024-05-15,9822
6869,雲豹能源,10,0,10,元大-土城學府,2024-05-15,9822
9962,有益,10,0,10,元大-土城學府,2024-05-15,9822
2884,玉山金,11,2,9,元大-土城學府,2024-05-15,9822
1455,集盛,27,18,9,元大-土城學府,2024-05-15,9822
2606,裕民,12,4,8,元大-土城學府,2024-05-15,9822
2406,國碩,11,3,8,元大-土城學府,2024-05-15,9822
2472,立隆電,8,0,8,元大-土城學府,2024-05-15,9822
3693,營邦,8,0,8,元大-土城學府,2024-05-15,9822
2301,光寶科,8,1,7,元大-土城學府,2024-05-15,9822
3231,緯創,112,14,98,元大-土城學府,2024-05-16,9822
00679B,元大美債20年,106,15,91,元大-土城學府,2024-05-16,9822
00878,國泰永續高股息,101,31,70,元大-土城學府,2024-05-16,9822
2317,鴻海,112,45,67,元大-土城學府,2024-05-16,9822
2356,英業達,68,26,42,元大-土城學府,2024-05-16,9822
3363,上詮,34,9,25,元大-土城學府,2024-05-16,9822
00646,元大S＆P500,24,0,24,元大-土城學府,2024-05-16,9822
8906,花王,22,0,22,元大-土城學府,2024-05-16,9822
5009,榮剛,23,3,20,元大-土城學府,2024-05-16,9822
2382,廣達,41,22,19,元大-土城學府,2024-05-16,9822
2915,潤泰全,22,3,19,元大-土城學府,2024-05-16,9822
6863,永道-KY,19,1,18,元大-土城學府,2024-05-16,9822
8096,擎亞,29,12,17,元大-土城學府,2024-05-16,9822
2882,國泰金,31,16,15,元大-土城學府,2024-05-16,9822
3303,岱稜,15,0,15,元大-土城學府,2024-05-16,9822
4743,合一,16,1,15,元大-土城學府,2024-05-16,9822
8064,東捷,15,0,15,元大-土城學府,2024-05-16,9822
3694,海華,13,0,13,元大-土城學府,2024-05-16,9822
00637L,元大滬深300正2,11,0,11,元大-土城學府,2024-05-16,9822
3268,海德威,11,0,11,元大-土城學府,2024-05-16,9822
3036,文曄,11,1,10,元大-土城學府,2024-05-16,9822
00650L,復華香港正2,10,0,10,元大-土城學府,2024-05-16,9822
00641R,富邦日本反1,10,0,10,元大-土城學府,2024-05-16,9822
1721,三晃,10,0,10,元大-土城學府,2024-05-16,9822
3049,精金,10,0,10,元大-土城學府,2024-05-16,9822
4943,康控-KY,10,0,10,元大-土城學府,2024-05-16,9822
5701,劍湖山,10,0,10,元大-土城學府,2024-05-16,9822
9105,泰金寶-DR,10,0,10,元大-土城學府,2024-05-16,9822
00933B,國泰10Y+金融債,17,7,10,元大-土城學府,2024-05-16,9822
3548,兆利,10,0,10,元大-土城學府,2024-05-16,9822
00706L,期元大S＆P日圓正2,9,0,9,元大-土城學府,2024-05-16,9822
6215,和椿,17,8,9,元大-土城學府,2024-05-16,9822
6284,佳邦,20,11,9,元大-土城學府,2024-05-16,9822
00937B,群益ESG投等債20,14,6,8,元大-土城學府,2024-05-16,9822
2348,海悅,8,0,8,元大-土城學府,2024-05-16,9822
6154,順發,8,0,8,元大-土城學府,2024-05-16,9822
00713,元大台灣高息低波,7,0,7,元大-土城學府,2024-05-16,9822
1618,合機,20,13,7,元大-土城學府,2024-05-16,9822
6531,愛普*,6,0,6,元大-土城學府,2024-05-16,9822
2062,橋椿,6,0,6,元大-土城學府,2024-05-16,9822
1608,華榮,45,39,6,元大-土城學府,2024-05-16,9822
1216,統一,6,0,6,元大-土城學府,2024-05-16,9822
2363,矽統,15,10,5,元大-土城學府,2024-05-16,9822
006208,富邦台50,6,1,5,元大-土城學府,2024-05-16,9822
00688L,國泰20年美債正2,5,0,5,元大-土城學府,2024-05-16,9822
1452,宏益,5,0,5,元大-土城學府,2024-05-16,9822
1532,勤美,5,0,5,元大-土城學府,2024-05-16,9822
2006,東和鋼鐵,5,0,5,元大-土城學府,2024-05-16,9822
2427,三商電,6,1,5,元大-土城學府,2024-05-16,9822
4739,康普,6,1,5,元大-土城學府,2024-05-16,9822
00940,元大台灣價值高息,383,46,337,元大-土城學府,2024-05-17,9822
1455,集盛,171,70,101,元大-土城學府,2024-05-17,9822
00878,國泰永續高股息,88,4,84,元大-土城學府,2024-05-17,9822
3450,聯鈞,82,12,70,元大-土城學府,2024-05-17,9822
3706,神達,69,8,61,元大-土城學府,2024-05-17,9822
00937B,群益ESG投等債20,60,3,57,元大-土城學府,2024-05-17,9822
00632R,元大台灣50反1,43,0,43,元大-土城學府,2024-05-17,9822
00679B,元大美債20年,41,2,39,元大-土城學府,2024-05-17,9822
2520,冠德,40,2,38,元大-土城學府,2024-05-17,9822
6770,力積電,44,7,37,元大-土城學府,2024-05-17,9822
00665L,富邦�琤肭磪囓�2,25,0,25,元大-土城學府,2024-05-17,9822
2374,佳能,75,50,25,元大-土城學府,2024-05-17,9822
2408,南亞科,26,1,25,元大-土城學府,2024-05-17,9822
00680L,元大美債20正2,24,0,24,元大-土城學府,2024-05-17,9822
5701,劍湖山,23,0,23,元大-土城學府,2024-05-17,9822
00932,兆豐永續高息等權,20,0,20,元大-土城學府,2024-05-17,9822
8213,志超,20,1,19,元大-土城學府,2024-05-17,9822
00919,群益台灣精選高息,28,10,18,元大-土城學府,2024-05-17,9822
2317,鴻海,53,35,18,元大-土城學府,2024-05-17,9822
6284,佳邦,19,2,17,元大-土城學府,2024-05-17,9822
2474,可成,16,0,16,元大-土城學府,2024-05-17,9822
1618,合機,44,30,14,元大-土城學府,2024-05-17,9822
3481,群創,14,0,14,元大-土城學府,2024-05-17,9822
00918,大華優利高填息30,13,0,13,元大-土城學府,2024-05-17,9822
00931B,統一美債20年,13,0,13,元大-土城學府,2024-05-17,9822
2349,錸德,14,1,13,元大-土城學府,2024-05-17,9822
4155,訊映,13,0,13,元大-土城學府,2024-05-17,9822
6753,龍德造船,14,1,13,元大-土城學府,2024-05-17,9822
00933B,國泰10Y+金融債,13,1,12,元大-土城學府,2024-05-17,9822
2915,潤泰全,12,0,12,元大-土城學府,2024-05-17,9822
3047,訊舟,35,23,12,元大-土城學府,2024-05-17,9822
3390,旭軟,12,0,12,元大-土城學府,2024-05-17,9822
6538,倉和,12,0,12,元大-土城學府,2024-05-17,9822
2609,陽明,22,11,11,元大-土城學府,2024-05-17,9822
1218,泰山,11,0,11,元大-土城學府,2024-05-17,9822
2409,友達,19,8,11,元大-土城學府,2024-05-17,9822
2603,長榮,113,103,10,元大-土城學府,2024-05-17,9822
2455,全新,10,0,10,元大-土城學府,2024-05-17,9822
2812,台中銀,10,0,10,元大-土城學府,2024-05-17,9822
3303,岱稜,10,0,10,元大-土城學府,2024-05-17,9822
6116,彩晶,10,0,10,元大-土城學府,2024-05-17,9822
9907,統一實,10,0,10,元大-土城學府,2024-05-17,9822
00690,兆豐藍籌30,9,0,9,元大-土城學府,2024-05-17,9822
1785,光洋科,9,0,9,元大-土城學府,2024-05-17,9822
2423,固緯,9,0,9,元大-土城學府,2024-05-17,9822
2605,新興,12,3,9,元大-土城學府,2024-05-17,9822
8906,花王,9,0,9,元大-土城學府,2024-05-17,9822
00687B,國泰20年美債,11,3,8,元大-土城學府,2024-05-17,9822
00700,富邦�琤肭磪�,8,0,8,元大-土城學府,2024-05-17,9822
2611,志信,11,3,8,元大-土城學府,2024-05-17,9822
00632R,元大台灣50反1,724,5,719,元大-土城學府,2024-05-20,9822
2618,長榮航,187,56,131,元大-土城學府,2024-05-20,9822
2610,華航,112,23,89,元大-土城學府,2024-05-20,9822
00937B,群益ESG投等債20,75,0,75,元大-土城學府,2024-05-20,9822
3450,聯鈞,83,9,74,元大-土城學府,2024-05-20,9822
00878,國泰永續高股息,83,10,73,元大-土城學府,2024-05-20,9822
9105,泰金寶-DR,74,2,72,元大-土城學府,2024-05-20,9822
2317,鴻海,85,25,60,元大-土城學府,2024-05-20,9822
1531,高林股,56,0,56,元大-土城學府,2024-05-20,9822
00940,元大台灣價值高息,123,70,53,元大-土城學府,2024-05-20,9822
00929,復華台灣科技優息,99,46,53,元大-土城學府,2024-05-20,9822
2356,英業達,65,13,52,元大-土城學府,2024-05-20,9822
00919,群益台灣精選高息,98,54,44,元大-土城學府,2024-05-20,9822
4714,永捷,45,1,44,元大-土城學府,2024-05-20,9822
2101,南港,42,1,41,元大-土城學府,2024-05-20,9822
2520,冠德,40,6,34,元大-土城學府,2024-05-20,9822
6188,廣明,41,8,33,元大-土城學府,2024-05-20,9822
00946,群益科技高息成長,32,0,32,元大-土城學府,2024-05-20,9822
2471,資通,28,0,28,元大-土城學府,2024-05-20,9822
8064,東捷,31,4,27,元大-土城學府,2024-05-20,9822
1455,集盛,25,0,25,元大-土城學府,2024-05-20,9822
6770,力積電,27,5,22,元大-土城學府,2024-05-20,9822
00679B,元大美債20年,67,47,20,元大-土城學府,2024-05-20,9822
6284,佳邦,20,0,20,元大-土城學府,2024-05-20,9822
6139,亞翔,21,3,18,元大-土城學府,2024-05-20,9822
2329,華泰,16,0,16,元大-土城學府,2024-05-20,9822
3231,緯創,30,15,15,元大-土城學府,2024-05-20,9822
00688L,國泰20年美債正2,15,0,15,元大-土城學府,2024-05-20,9822
5009,榮剛,17,3,14,元大-土城學府,2024-05-20,9822
00665L,富邦�琤肭磪囓�2,16,2,14,元大-土城學府,2024-05-20,9822
00680L,元大美債20正2,20,6,14,元大-土城學府,2024-05-20,9822
00918,大華優利高填息30,19,6,13,元大-土城學府,2024-05-20,9822
2601,益航,13,0,13,元大-土城學府,2024-05-20,9822
3483,力致,15,2,13,元大-土城學府,2024-05-20,9822
2915,潤泰全,14,1,13,元大-土城學府,2024-05-20,9822
6215,和椿,15,3,12,元大-土城學府,2024-05-20,9822
6005,群益證,11,0,11,元大-土城學府,2024-05-20,9822
3363,上詮,12,1,11,元大-土城學府,2024-05-20,9822
8071,能率網通,54,43,11,元大-土城學府,2024-05-20,9822
2367,燿華,103,93,10,元大-土城學府,2024-05-20,9822
00731,復華富時高息低波,10,0,10,元大-土城學府,2024-05-20,9822
00773B,中信優先金融債,10,0,10,元大-土城學府,2024-05-20,9822
00772B,中信高評級公司債,10,0,10,元大-土城學府,2024-05-20,9822
00753L,中信中國50正2,15,5,10,元大-土城學府,2024-05-20,9822
2489,瑞軒,18,8,10,元大-土城學府,2024-05-20,9822
2736,富野,10,0,10,元大-土城學府,2024-05-20,9822
2845,遠東銀,10,0,10,元大-土城學府,2024-05-20,9822
5701,劍湖山,10,0,10,元大-土城學府,2024-05-20,9822
6123,上奇,10,0,10,元大-土城學府,2024-05-20,9822
00713,元大台灣高息低波,13,4,9,元大-土城學府,2024-05-20,9822
4533,協易機,229,47,182,元大-土城學府,2024-05-21,9822
00939,統一台灣高息動能,100,10,90,元大-土城學府,2024-05-21,9822
00929,復華台灣科技優息,131,42,89,元大-土城學府,2024-05-21,9822
00937B,群益ESG投等債20,80,0,80,元大-土城學府,2024-05-21,9822
00878,國泰永續高股息,76,5,71,元大-土城學府,2024-05-21,9822
2610,華航,90,27,63,元大-土城學府,2024-05-21,9822
00679B,元大美債20年,54,0,54,元大-土城學府,2024-05-21,9822
3013,晟銘電,64,28,36,元大-土城學府,2024-05-21,9822
2363,矽統,46,11,35,元大-土城學府,2024-05-21,9822
00680L,元大美債20正2,26,0,26,元大-土城學府,2024-05-21,9822
00944,野村趨勢動能高息,24,0,24,元大-土城學府,2024-05-21,9822
00700,富邦�琤肭磪�,20,0,20,元大-土城學府,2024-05-21,9822
1618,合機,51,31,20,元大-土城學府,2024-05-21,9822
2611,志信,20,0,20,元大-土城學府,2024-05-21,9822
2520,冠德,21,2,19,元大-土城學府,2024-05-21,9822
2489,瑞軒,19,3,16,元大-土城學府,2024-05-21,9822
2834,臺企銀,33,17,16,元大-土城學府,2024-05-21,9822
2884,玉山金,19,4,15,元大-土城學府,2024-05-21,9822
1409,新纖,15,0,15,元大-土城學府,2024-05-21,9822
5475,德宏,15,0,15,元大-土城學府,2024-05-21,9822
00919,群益台灣精選高息,18,4,14,元大-土城學府,2024-05-21,9822
1514,亞力,22,8,14,元大-土城學府,2024-05-21,9822
5371,中光電,16,3,13,元大-土城學府,2024-05-21,9822
3033,威健,22,10,12,元大-土城學府,2024-05-21,9822
00712,復華富時不動產,11,0,11,元大-土城學府,2024-05-21,9822
2601,益航,11,0,11,元大-土城學府,2024-05-21,9822
4714,永捷,11,0,11,元大-土城學府,2024-05-21,9822
3450,聯鈞,13,3,10,元大-土城學府,2024-05-21,9822
00688L,國泰20年美債正2,10,0,10,元大-土城學府,2024-05-21,9822
1217,愛之味,10,0,10,元大-土城學府,2024-05-21,9822
2362,藍天,10,0,10,元大-土城學府,2024-05-21,9822
3684,榮昌,10,0,10,元大-土城學府,2024-05-21,9822
4967,十銓,22,12,10,元大-土城學府,2024-05-21,9822
6116,彩晶,10,0,10,元大-土城學府,2024-05-21,9822
9945,潤泰新,25,15,10,元大-土城學府,2024-05-21,9822
1605,華新,37,27,10,元大-土城學府,2024-05-21,9822
2890,永豐金,9,0,9,元大-土城學府,2024-05-21,9822
1504,東元,14,5,9,元大-土城學府,2024-05-21,9822
3702,大聯大,14,5,9,元大-土城學府,2024-05-21,9822
6005,群益證,9,1,8,元大-土城學府,2024-05-21,9822
1609,大亞,12,4,8,元大-土城學府,2024-05-21,9822
2314,台揚,8,0,8,元大-土城學府,2024-05-21,9822
2504,國產,10,2,8,元大-土城學府,2024-05-21,9822
8033,雷虎,8,0,8,元大-土城學府,2024-05-21,9822
6531,愛普*,7,0,7,元大-土城學府,2024-05-21,9822
3035,智原,7,0,7,元大-土城學府,2024-05-21,9822
00665L,富邦�琤肭磪囓�2,7,0,7,元大-土城學府,2024-05-21,9822
3056,富華新,7,0,7,元大-土城學府,2024-05-21,9822
00915,凱基優選高股息30,6,0,6,元大-土城學府,2024-05-21,9822
1301,台塑,6,0,6,元大-土城學府,2024-05-21,9822
00632R,元大台灣50反1,1985,5,1980,元大-土城學府,2024-05-22,9822
6117,迎廣,69,10,59,元大-土城學府,2024-05-22,9822
2610,華航,53,6,47,元大-土城學府,2024-05-22,9822
00679B,元大美債20年,37,0,37,元大-土城學府,2024-05-22,9822
3047,訊舟,44,8,36,元大-土城學府,2024-05-22,9822
3060,銘異,39,4,35,元大-土城學府,2024-05-22,9822
2618,長榮航,48,16,32,元大-土城學府,2024-05-22,9822
2317,鴻海,50,19,31,元大-土城學府,2024-05-22,9822
2834,臺企銀,30,1,29,元大-土城學府,2024-05-22,9822
9945,潤泰新,40,12,28,元大-土城學府,2024-05-22,9822
3013,晟銘電,73,47,26,元大-土城學府,2024-05-22,9822
2367,燿華,93,67,26,元大-土城學府,2024-05-22,9822
4533,協易機,56,31,25,元大-土城學府,2024-05-22,9822
2369,菱生,25,1,24,元大-土城學府,2024-05-22,9822
8277,商丞,22,0,22,元大-土城學府,2024-05-22,9822
00937B,群益ESG投等債20,21,0,21,元大-土城學府,2024-05-22,9822
2495,普安,35,15,20,元大-土城學府,2024-05-22,9822
4755,三福化,20,0,20,元大-土城學府,2024-05-22,9822
2543,皇昌,19,0,19,元大-土城學府,2024-05-22,9822
3481,群創,77,58,19,元大-土城學府,2024-05-22,9822
5512,力麒,18,0,18,元大-土城學府,2024-05-22,9822
3535,晶彩科,24,7,17,元大-土城學府,2024-05-22,9822
2890,永豐金,17,1,16,元大-土城學府,2024-05-22,9822
3033,威健,20,4,16,元大-土城學府,2024-05-22,9822
2376,技嘉,18,3,15,元大-土城學府,2024-05-22,9822
2867,三商壽,27,12,15,元大-土城學府,2024-05-22,9822
8076,伍豐,15,0,15,元大-土城學府,2024-05-22,9822
2359,所羅門,72,58,14,元大-土城學府,2024-05-22,9822
2002,中鋼,14,1,13,元大-土城學府,2024-05-22,9822
4114,健喬,13,0,13,元大-土城學府,2024-05-22,9822
6207,雷科,23,10,13,元大-土城學府,2024-05-22,9822
2489,瑞軒,13,1,12,元大-土城學府,2024-05-22,9822
4973,廣穎,12,0,12,元大-土城學府,2024-05-22,9822
3706,神達,34,23,11,元大-土城學府,2024-05-22,9822
4952,凌通,12,1,11,元大-土城學府,2024-05-22,9822
00905,FT臺灣Smart,10,0,10,元大-土城學府,2024-05-22,9822
00650L,復華香港正2,10,0,10,元大-土城學府,2024-05-22,9822
1416,廣豐,10,0,10,元大-土城學府,2024-05-22,9822
1905,華紙,11,1,10,元大-土城學府,2024-05-22,9822
2520,冠德,10,0,10,元大-土城學府,2024-05-22,9822
2634,漢翔,11,1,10,元大-土城學府,2024-05-22,9822
3455,由田,10,0,10,元大-土城學府,2024-05-22,9822
8110,華東,10,0,10,元大-土城學府,2024-05-22,9822
9955,佳龍,13,3,10,元大-土城學府,2024-05-22,9822
5371,中光電,21,12,9,元大-土城學府,2024-05-22,9822
3234,光環,10,1,9,元大-土城學府,2024-05-22,9822
2014,中鴻,9,0,9,元大-土城學府,2024-05-22,9822
3450,聯鈞,16,7,9,元大-土城學府,2024-05-22,9822
4543,萬在,14,5,9,元大-土城學府,2024-05-22,9822
4939,亞電,10,1,9,元大-土城學府,2024-05-22,9822
00679B,元大美債20年,265,11,254,元大-土城學府,2024-05-23,9822
00937B,群益ESG投等債20,62,1,61,元大-土城學府,2024-05-23,9822
2356,英業達,83,29,54,元大-土城學府,2024-05-23,9822
3005,神基,55,2,53,元大-土城學府,2024-05-23,9822
2834,臺企銀,55,3,52,元大-土城學府,2024-05-23,9822
2353,宏��,119,76,43,元大-土城學府,2024-05-23,9822
00905,FT臺灣Smart,43,2,41,元大-土城學府,2024-05-23,9822
3402,漢科,40,0,40,元大-土城學府,2024-05-23,9822
00712,復華富時不動產,37,2,35,元大-土城學府,2024-05-23,9822
00665L,富邦�琤肭磪囓�2,35,0,35,元大-土城學府,2024-05-23,9822
8076,伍豐,35,0,35,元大-土城學府,2024-05-23,9822
2101,南港,73,43,30,元大-土城學府,2024-05-23,9822
2618,長榮航,43,13,30,元大-土城學府,2024-05-23,9822
2009,第一銅,40,12,28,元大-土城學府,2024-05-23,9822
2324,仁寶,30,5,25,元大-土城學府,2024-05-23,9822
2915,潤泰全,23,0,23,元大-土城學府,2024-05-23,9822
4402,郡都開發,22,0,22,元大-土城學府,2024-05-23,9822
00650L,復華香港正2,21,0,21,元大-土城學府,2024-05-23,9822
00944,野村趨勢動能高息,20,0,20,元大-土城學府,2024-05-23,9822
1217,愛之味,20,0,20,元大-土城學府,2024-05-23,9822
1440,南紡,20,0,20,元大-土城學府,2024-05-23,9822
5426,振發,21,1,20,元大-土城學府,2024-05-23,9822
2610,華航,39,19,20,元大-土城學府,2024-05-23,9822
2363,矽統,24,5,19,元大-土城學府,2024-05-23,9822
6139,亞翔,19,0,19,元大-土城學府,2024-05-23,9822
2344,華邦電,21,2,19,元大-土城學府,2024-05-23,9822
9945,潤泰新,41,22,19,元大-土城學府,2024-05-23,9822
2002,中鋼,18,0,18,元大-土城學府,2024-05-23,9822
1314,中石化,28,10,18,元大-土城學府,2024-05-23,9822
2258,鴻華先進-創,18,0,18,元大-土城學府,2024-05-23,9822
6188,廣明,33,16,17,元大-土城學府,2024-05-23,9822
2545,皇翔,18,2,16,元大-土城學府,2024-05-23,9822
2359,所羅門,94,78,16,元大-土城學府,2024-05-23,9822
6147,頎邦,15,0,15,元大-土城學府,2024-05-23,9822
4714,永捷,15,0,15,元大-土城學府,2024-05-23,9822
2607,榮運,14,0,14,元大-土城學府,2024-05-23,9822
3715,定穎投控,13,0,13,元大-土城學府,2024-05-23,9822
2489,瑞軒,14,1,13,元大-土城學府,2024-05-23,9822
1605,華新,28,16,12,元大-土城學府,2024-05-23,9822
2886,兆豐金,12,0,12,元大-土城學府,2024-05-23,9822
1618,合機,12,0,12,元大-土城學府,2024-05-23,9822
1752,南光,12,0,12,元大-土城學府,2024-05-23,9822
2401,凌陽,14,2,12,元大-土城學府,2024-05-23,9822
3535,晶彩科,12,0,12,元大-土城學府,2024-05-23,9822
3548,兆利,11,0,11,元大-土城學府,2024-05-23,9822
00918,大華優利高填息30,12,1,11,元大-土城學府,2024-05-23,9822
3033,威健,11,0,11,元大-土城學府,2024-05-23,9822
1447,力鵬,10,0,10,元大-土城學府,2024-05-23,9822
2884,玉山金,15,5,10,元大-土城學府,2024-05-23,9822
2913,農林,10,0,10,元大-土城學府,2024-05-23,9822
00937B,群益ESG投等債20,226,0,226,元大-土城學府,2024-05-24,9822
00712,復華富時不動產,77,1,76,元大-土城學府,2024-05-24,9822
00715L,期街口布蘭特正2,67,0,67,元大-土城學府,2024-05-24,9822
00679B,元大美債20年,58,0,58,元大-土城學府,2024-05-24,9822
1810,和成,56,2,54,元大-土城學府,2024-05-24,9822
00632R,元大台灣50反1,32,0,32,元大-土城學府,2024-05-24,9822
00665L,富邦�琤肭磪囓�2,30,0,30,元大-土城學府,2024-05-24,9822
00650L,復華香港正2,30,0,30,元大-土城學府,2024-05-24,9822
6117,迎廣,43,16,27,元大-土城學府,2024-05-24,9822
2002,中鋼,23,0,23,元大-土城學府,2024-05-24,9822
6147,頎邦,20,0,20,元大-土城學府,2024-05-24,9822
2106,建大,21,1,20,元大-土城學府,2024-05-24,9822
3402,漢科,20,0,20,元大-土城學府,2024-05-24,9822
4960,誠美材,28,8,20,元大-土城學府,2024-05-24,9822
00878,國泰永續高股息,17,0,17,元大-土城學府,2024-05-24,9822
00646,元大S＆P500,16,0,16,元大-土城學府,2024-05-24,9822
6697,東捷資訊,16,0,16,元大-土城學府,2024-05-24,9822
6770,力積電,18,2,16,元大-土城學府,2024-05-24,9822
5426,振發,20,5,15,元大-土城學府,2024-05-24,9822
2330,台積電,15,1,14,元大-土城學府,2024-05-24,9822
1314,中石化,28,14,14,元大-土城學府,2024-05-24,9822
2408,南亞科,16,2,14,元大-土城學府,2024-05-24,9822
3060,銘異,49,35,14,元大-土城學府,2024-05-24,9822
3062,建漢,17,3,14,元大-土城學府,2024-05-24,9822
8064,東捷,24,10,14,元大-土城學府,2024-05-24,9822
1609,大亞,17,4,13,元大-土城學府,2024-05-24,9822
3691,碩禾,12,0,12,元大-土城學府,2024-05-24,9822
4533,協易機,13,1,12,元大-土城學府,2024-05-24,9822
6234,高僑,13,1,12,元大-土城學府,2024-05-24,9822
1516,川飛,12,1,11,元大-土城學府,2024-05-24,9822
3535,晶彩科,20,9,11,元大-土城學府,2024-05-24,9822
2367,燿華,24,14,10,元大-土城學府,2024-05-24,9822
2884,玉山金,10,0,10,元大-土城學府,2024-05-24,9822
3338,泰碩,48,38,10,元大-土城學府,2024-05-24,9822
00933B,國泰10Y+金融債,10,0,10,元大-土城學府,2024-05-24,9822
2474,可成,10,0,10,元大-土城學府,2024-05-24,9822
3576,聯合再生,10,0,10,元大-土城學府,2024-05-24,9822
4529,淳紳,10,0,10,元大-土城學府,2024-05-24,9822
4952,凌通,13,3,10,元大-土城學府,2024-05-24,9822
2885,元大金,10,0,10,元大-土城學府,2024-05-24,9822
2354,鴻準,15,5,10,元大-土城學府,2024-05-24,9822
00935,野村臺灣新科技50,10,1,9,元大-土城學府,2024-05-24,9822
00946,群益科技高息成長,9,0,9,元大-土城學府,2024-05-24,9822
2891,中信金,11,2,9,元大-土城學府,2024-05-24,9822
2464,盟立,28,20,8,元大-土城學府,2024-05-24,9822
3466,德晉,11,3,8,元大-土城學府,2024-05-24,9822
4956,光鋐,8,0,8,元大-土城學府,2024-05-24,9822
2365,昆盈,66,58,8,元大-土城學府,2024-05-24,9822
4967,十銓,10,3,7,元大-土城學府,2024-05-24,9822
8110,華東,7,0,7,元大-土城學府,2024-05-24,9822
00937B,群益ESG投等債20,461,1,460,元大-土城學府,2024-05-27,9822
00923,群益台ESG低碳50,61,3,58,元大-土城學府,2024-05-27,9822
5608,四維航,57,1,56,元大-土城學府,2024-05-27,9822
00931B,統一美債20年,45,0,45,元大-土城學府,2024-05-27,9822
2002,中鋼,41,0,41,元大-土城學府,2024-05-27,9822
9105,泰金寶-DR,66,25,41,元大-土城學府,2024-05-27,9822
00712,復華富時不動產,34,0,34,元大-土城學府,2024-05-27,9822
2353,宏��,138,104,34,元大-土城學府,2024-05-27,9822
1905,華紙,30,0,30,元大-土城學府,2024-05-27,9822
6235,華孚,26,0,26,元大-土城學府,2024-05-27,9822
2867,三商壽,50,25,25,元大-土城學府,2024-05-27,9822
5498,凱崴,44,20,24,元大-土城學府,2024-05-27,9822
1513,中興電,29,8,21,元大-土城學府,2024-05-27,9822
00650L,復華香港正2,21,0,21,元大-土城學府,2024-05-27,9822
00637L,元大滬深300正2,21,0,21,元大-土城學府,2024-05-27,9822
2453,凌群,23,3,20,元大-土城學府,2024-05-27,9822
5474,聰泰,20,0,20,元大-土城學府,2024-05-27,9822
3312,弘憶股,37,18,19,元大-土城學府,2024-05-27,9822
3450,聯鈞,20,2,18,元大-土城學府,2024-05-27,9822
9958,世紀鋼,26,9,17,元大-土城學府,2024-05-27,9822
6616,特昇-KY,20,3,17,元大-土城學府,2024-05-27,9822
0056,元大高股息,22,6,16,元大-土城學府,2024-05-27,9822
00946,群益科技高息成長,16,0,16,元大-土城學府,2024-05-27,9822
6147,頎邦,20,4,16,元大-土城學府,2024-05-27,9822
00679B,元大美債20年,100,85,15,元大-土城學府,2024-05-27,9822
00680L,元大美債20正2,15,0,15,元大-土城學府,2024-05-27,9822
2888,新光金,15,1,14,元大-土城學府,2024-05-27,9822
2891,中信金,15,2,13,元大-土城學府,2024-05-27,9822
9945,潤泰新,20,8,12,元大-土城學府,2024-05-27,9822
2886,兆豐金,13,0,13,元大-土城學府,2024-05-27,9822
1409,新纖,12,0,12,元大-土城學府,2024-05-27,9822
2881,富邦金,13,1,12,元大-土城學府,2024-05-27,9822
00933B,國泰10Y+金融債,17,6,11,元大-土城學府,2024-05-27,9822
2352,佳世達,15,4,11,元大-土城學府,2024-05-27,9822
3380,明泰,11,0,11,元大-土城學府,2024-05-27,9822
6284,佳邦,11,0,11,元大-土城學府,2024-05-27,9822
4961,天鈺,10,0,10,元大-土城學府,2024-05-27,9822
00633L,富邦上証正2,10,0,10,元大-土城學府,2024-05-27,9822
2258,鴻華先進-創,10,0,10,元大-土城學府,2024-05-27,9822
4123,晟德,10,0,10,元大-土城學府,2024-05-27,9822
5512,力麒,10,0,10,元大-土城學府,2024-05-27,9822
6220,岳豐,10,0,10,元大-土城學府,2024-05-27,9822
3583,辛耘,10,1,9,元大-土城學府,2024-05-27,9822
4533,協易機,23,14,9,元大-土城學府,2024-05-27,9822
6125,廣運,64,55,9,元大-土城學府,2024-05-27,9822
2363,矽統,119,110,9,元大-土城學府,2024-05-27,9822
2834,臺企銀,8,0,8,元大-土城學府,2024-05-27,9822
3202,樺晟,8,0,8,元大-土城學府,2024-05-27,9822
2887,台新金,7,0,7,元大-土城學府,2024-05-27,9822
8091,翔名,7,0,7,元大-土城學府,2024-05-27,9822
00937B,群益ESG投等債20,112,3,109,元大-土城學府,2024-05-28,9822
00939,統一台灣高息動能,101,6,95,元大-土城學府,2024-05-28,9822
4543,萬在,75,6,69,元大-土城學府,2024-05-28,9822
00679B,元大美債20年,55,2,53,元大-土城學府,2024-05-28,9822
2371,大同,54,3,51,元大-土城學府,2024-05-28,9822
2353,宏��,102,54,48,元大-土城學府,2024-05-28,9822
2421,建準,48,1,47,元大-土城學府,2024-05-28,9822
00918,大華優利高填息30,47,1,46,元大-土城學府,2024-05-28,9822
3518,柏騰,47,1,46,元大-土城學府,2024-05-28,9822
6116,彩晶,41,0,41,元大-土城學府,2024-05-28,9822
2363,矽統,67,27,40,元大-土城學府,2024-05-28,9822
2354,鴻準,151,115,36,元大-土城學府,2024-05-28,9822
2845,遠東銀,32,0,32,元大-土城學府,2024-05-28,9822
5907,大洋-KY,34,2,32,元大-土城學府,2024-05-28,9822
5512,力麒,26,2,24,元大-土城學府,2024-05-28,9822
6275,元山,26,3,23,元大-土城學府,2024-05-28,9822
00931B,統一美債20年,21,0,21,元大-土城學府,2024-05-28,9822
1312,國喬,20,0,20,元大-土城學府,2024-05-28,9822
2368,金像電,19,0,19,元大-土城學府,2024-05-28,9822
4960,誠美材,22,3,19,元大-土城學府,2024-05-28,9822
3689,湧德,28,11,17,元大-土城學府,2024-05-28,9822
6257,矽格,24,7,17,元大-土城學府,2024-05-28,9822
2609,陽明,26,10,16,元大-土城學府,2024-05-28,9822
3548,兆利,19,3,16,元大-土城學府,2024-05-28,9822
2258,鴻華先進-創,16,0,16,元大-土城學府,2024-05-28,9822
6215,和椿,31,15,16,元大-土城學府,2024-05-28,9822
00940,元大台灣價值高息,58,42,16,元大-土城學府,2024-05-28,9822
2301,光寶科,32,17,15,元大-土城學府,2024-05-28,9822
2801,彰銀,15,0,15,元大-土城學府,2024-05-28,9822
2317,鴻海,32,17,15,元大-土城學府,2024-05-28,9822
6168,宏齊,21,7,14,元大-土城學府,2024-05-28,9822
00712,復華富時不動產,13,0,13,元大-土城學府,2024-05-28,9822
1514,亞力,15,2,13,元大-土城學府,2024-05-28,9822
2464,盟立,29,16,13,元大-土城學府,2024-05-28,9822
2481,強茂,14,2,12,元大-土城學府,2024-05-28,9822
5371,中光電,14,2,12,元大-土城學府,2024-05-28,9822
00878,國泰永續高股息,19,8,11,元大-土城學府,2024-05-28,9822
9105,泰金寶-DR,32,20,12,元大-土城學府,2024-05-28,9822
2376,技嘉,13,2,11,元大-土城學府,2024-05-28,9822
00946,群益科技高息成長,12,1,11,元大-土城學府,2024-05-28,9822
2313,華通,11,0,11,元大-土城學府,2024-05-28,9822
2328,廣宇,11,0,11,元大-土城學府,2024-05-28,9822
2369,菱生,15,4,11,元大-土城學府,2024-05-28,9822
2634,漢翔,13,3,10,元大-土城學府,2024-05-28,9822
1905,華紙,16,6,10,元大-土城學府,2024-05-28,9822
6282,康舒,12,2,10,元大-土城學府,2024-05-28,9822
2891,中信金,9,0,9,元大-土城學府,2024-05-28,9822
6188,廣明,22,13,9,元大-土城學府,2024-05-28,9822
3483,力致,10,1,9,元大-土城學府,2024-05-28,9822
8076,伍豐,9,0,9,元大-土城學府,2024-05-28,9822
00937B,群益ESG投等債20,350,44,306,元大-土城學府,2024-05-29,9822
6016,康和證,102,0,102,元大-土城學府,2024-05-29,9822
00679B,元大美債20年,84,1,83,元大-土城學府,2024-05-29,9822
00940,元大台灣價值高息,91,19,72,元大-土城學府,2024-05-29,9822
1455,集盛,70,0,70,元大-土城學府,2024-05-29,9822
2489,瑞軒,107,53,54,元大-土城學府,2024-05-29,9822
2845,遠東銀,50,0,50,元大-土城學府,2024-05-29,9822
2317,鴻海,58,9,49,元大-土城學府,2024-05-29,9822
2618,長榮航,66,20,46,元大-土城學府,2024-05-29,9822
00712,復華富時不動產,44,0,44,元大-土城學府,2024-05-29,9822
00946,群益科技高息成長,49,6,43,元大-土城學府,2024-05-29,9822
2025,千興,42,0,42,元大-土城學府,2024-05-29,9822
3231,緯創,43,6,37,元大-土城學府,2024-05-29,9822
4543,萬在,41,4,37,元大-土城學府,2024-05-29,9822
2353,宏��,82,47,35,元大-土城學府,2024-05-29,9822
00929,復華台灣科技優息,73,38,35,元大-土城學府,2024-05-29,9822
2349,錸德,42,8,34,元大-土城學府,2024-05-29,9822
6021,美好證,30,0,30,元大-土城學府,2024-05-29,9822
1513,中興電,36,7,29,元大-土城學府,2024-05-29,9822
00720B,元大投資級公司債,29,0,29,元大-土城學府,2024-05-29,9822
3202,樺晟,31,2,29,元大-土城學府,2024-05-29,9822
3518,柏騰,28,0,28,元大-土城學府,2024-05-29,9822
2401,凌陽,58,31,27,元大-土城學府,2024-05-29,9822
2002,中鋼,25,0,25,元大-土城學府,2024-05-29,9822
3047,訊舟,34,9,25,元大-土城學府,2024-05-29,9822
00687B,國泰20年美債,23,0,23,元大-土城學府,2024-05-29,9822
2884,玉山金,23,0,23,元大-土城學府,2024-05-29,9822
1303,南亞,26,3,23,元大-土城學府,2024-05-29,9822
6284,佳邦,23,0,23,元大-土城學府,2024-05-29,9822
00931B,統一美債20年,22,0,22,元大-土城學府,2024-05-29,9822
4960,誠美材,22,0,22,元大-土城學府,2024-05-29,9822
2885,元大金,22,0,22,元大-土城學府,2024-05-29,9822
1101,台泥,24,3,21,元大-土城學府,2024-05-29,9822
2867,三商壽,26,5,21,元大-土城學府,2024-05-29,9822
5876,上海商銀,21,0,21,元大-土城學府,2024-05-29,9822
3706,神達,30,10,20,元大-土城學府,2024-05-29,9822
4968,立積,20,0,20,元大-土城學府,2024-05-29,9822
2891,中信金,20,1,19,元大-土城學府,2024-05-29,9822
2834,臺企銀,19,0,19,元大-土城學府,2024-05-29,9822
00878,國泰永續高股息,39,20,19,元大-土城學府,2024-05-29,9822
5469,瀚宇博,20,1,19,元大-土城學府,2024-05-29,9822
4906,正文,23,5,18,元大-土城學府,2024-05-29,9822
6147,頎邦,18,0,18,元大-土城學府,2024-05-29,9822
2615,萬海,75,57,18,元大-土城學府,2024-05-29,9822
1216,統一,18,0,18,元大-土城學府,2024-05-29,9822
00933B,國泰10Y+金融債,16,0,16,元大-土城學府,2024-05-29,9822
00772B,中信高評級公司債,15,0,15,元大-土城學府,2024-05-29,9822
2547,日勝生,15,0,15,元大-土城學府,2024-05-29,9822
00725B,國泰投資級公司債,14,0,14,元大-土城學府,2024-05-29,9822
3673,TPK-KY,15,1,14,元大-土城學府,2024-05-29,9822
00632R,元大台灣50反1,264,0,264,元大-土城學府,2024-05-30,9822
00937B,群益ESG投等債20,154,2,152,元大-土城學府,2024-05-30,9822
2489,瑞軒,100,27,73,元大-土城學府,2024-05-30,9822
00929,復華台灣科技優息,93,28,65,元大-土城學府,2024-05-30,9822
00878,國泰永續高股息,72,14,58,元大-土城學府,2024-05-30,9822
00680L,元大美債20正2,105,50,55,元大-土城學府,2024-05-30,9822
2611,志信,57,2,55,元大-土城學府,2024-05-30,9822
9945,潤泰新,51,4,47,元大-土城學府,2024-05-30,9822
00940,元大台灣價值高息,81,35,46,元大-土城學府,2024-05-30,9822
5608,四維航,56,14,42,元大-土城學府,2024-05-30,9822
2408,南亞科,41,0,41,元大-土城學府,2024-05-30,9822
00679B,元大美債20年,120,80,40,元大-土城學府,2024-05-30,9822
2884,玉山金,35,1,34,元大-土城學府,2024-05-30,9822
00946,群益科技高息成長,36,2,34,元大-土城學府,2024-05-30,9822
3481,群創,35,4,31,元大-土城學府,2024-05-30,9822
2353,宏��,50,20,30,元大-土城學府,2024-05-30,9822
6284,佳邦,25,0,25,元大-土城學府,2024-05-30,9822
4960,誠美材,28,5,23,元大-土城學府,2024-05-30,9822
00646,元大S＆P500,26,5,21,元大-土城學府,2024-05-30,9822
00923,群益台ESG低碳50,22,1,21,元大-土城學府,2024-05-30,9822
6021,美好證,20,0,20,元大-土城學府,2024-05-30,9822
2887,台新金,20,0,20,元大-土城學府,2024-05-30,9822
00852L,國泰美國道瓊正2,20,0,20,元大-土城學府,2024-05-30,9822
00650L,復華香港正2,20,0,20,元大-土城學府,2024-05-30,9822
00637L,元大滬深300正2,20,0,20,元大-土城學府,2024-05-30,9822
1907,永豐餘,20,0,20,元大-土城學府,2024-05-30,9822
1303,南亞,20,1,19,元大-土城學府,2024-05-30,9822
2330,台積電,18,0,18,元大-土城學府,2024-05-30,9822
1815,富喬,87,70,17,元大-土城學府,2024-05-30,9822
2610,華航,24,7,17,元大-土城學府,2024-05-30,9822
2405,輔信,27,10,17,元大-土城學府,2024-05-30,9822
2354,鴻準,67,50,17,元大-土城學府,2024-05-30,9822
2312,金寶,16,0,16,元大-土城學府,2024-05-30,9822
6147,頎邦,18,2,16,元大-土城學府,2024-05-30,9822
2101,南港,41,25,16,元大-土城學府,2024-05-30,9822
00687B,國泰20年美債,17,2,15,元大-土城學府,2024-05-30,9822
00720B,元大投資級公司債,14,0,14,元大-土城學府,2024-05-30,9822
2002,中鋼,14,0,14,元大-土城學府,2024-05-30,9822
2603,長榮,18,4,14,元大-土城學府,2024-05-30,9822
2317,鴻海,29,15,14,元大-土城學府,2024-05-30,9822
2885,元大金,13,0,13,元大-土城學府,2024-05-30,9822
6160,欣技,18,5,13,元大-土城學府,2024-05-30,9822
2363,矽統,50,38,12,元大-土城學府,2024-05-30,9822
006208,富邦台50,12,0,12,元大-土城學府,2024-05-30,9822
00931B,統一美債20年,11,0,11,元大-土城學府,2024-05-30,9822
1409,新纖,12,1,11,元大-土城學府,2024-05-30,9822
6414,樺漢,11,0,11,元大-土城學府,2024-05-30,9822
8438,昶昕,14,3,11,元大-土城學府,2024-05-30,9822
2834,臺企銀,11,0,11,元大-土城學府,2024-05-30,9822
6275,元山,11,1,10,元大-土城學府,2024-05-30,9822
00937B,群益ESG投等債20,149,26,123,元大-土城學府,2024-05-31,9822
00919,群益台灣精選高息,137,26,111,元大-土城學府,2024-05-31,9822
00929,復華台灣科技優息,115,6,109,元大-土城學府,2024-05-31,9822
2609,陽明,241,135,106,元大-土城學府,2024-05-31,9822
00632R,元大台灣50反1,185,100,85,元大-土城學府,2024-05-31,9822
00946,群益科技高息成長,60,0,60,元大-土城學府,2024-05-31,9822
00637L,元大滬深300正2,56,0,56,元大-土城學府,2024-05-31,9822
1802,台玻,56,1,55,元大-土城學府,2024-05-31,9822
2317,鴻海,80,33,47,元大-土城學府,2024-05-31,9822
6209,今國光,47,1,46,元大-土城學府,2024-05-31,9822
2489,瑞軒,47,9,38,元大-土城學府,2024-05-31,9822
00891,中信關鍵半導體,42,5,37,元大-土城學府,2024-05-31,9822
2303,聯電,45,10,35,元大-土城學府,2024-05-31,9822
6770,力積電,31,1,30,元大-土城學府,2024-05-31,9822
2002,中鋼,30,0,30,元大-土城學府,2024-05-31,9822
3312,弘憶股,76,47,29,元大-土城學府,2024-05-31,9822
00878,國泰永續高股息,40,12,28,元大-土城學府,2024-05-31,9822
3231,緯創,34,6,28,元大-土城學府,2024-05-31,9822
2356,英業達,28,1,27,元大-土城學府,2024-05-31,9822
1815,富喬,34,7,27,元大-土城學府,2024-05-31,9822
3035,智原,32,10,22,元大-土城學府,2024-05-31,9822
5371,中光電,25,4,21,元大-土城學府,2024-05-31,9822
1718,中纖,20,0,20,元大-土城學府,2024-05-31,9822
4967,十銓,21,1,20,元大-土城學府,2024-05-31,9822
5392,能率,20,1,19,元大-土城學府,2024-05-31,9822
00679B,元大美債20年,17,0,17,元大-土城學府,2024-05-31,9822
2812,台中銀,27,11,16,元大-土城學府,2024-05-31,9822
8358,金居,16,1,15,元大-土城學府,2024-05-31,9822
2344,華邦電,16,1,15,元大-土城學府,2024-05-31,9822
00939,統一台灣高息動能,16,2,14,元大-土城學府,2024-05-31,9822
2353,宏��,19,5,14,元大-土城學府,2024-05-31,9822
3455,由田,14,0,14,元大-土城學府,2024-05-31,9822
2368,金像電,14,0,14,元大-土城學府,2024-05-31,9822
2258,鴻華先進-創,14,0,14,元大-土城學府,2024-05-31,9822
3515,華擎,13,0,13,元大-土城學府,2024-05-31,9822
00715L,期街口布蘭特正2,13,0,13,元大-土城學府,2024-05-31,9822
2312,金寶,15,2,13,元大-土城學府,2024-05-31,9822
2308,台達電,13,1,12,元大-土城學府,2024-05-31,9822
00918,大華優利高填息30,12,0,12,元大-土城學府,2024-05-31,9822
1319,東陽,12,0,12,元大-土城學府,2024-05-31,9822
6863,永道-KY,11,0,11,元大-土城學府,2024-05-31,9822
1471,首利,12,1,11,元大-土城學府,2024-05-31,9822
2614,東森,12,1,11,元大-土城學府,2024-05-31,9822
1102,亞泥,10,0,10,元大-土城學府,2024-05-31,9822
00934,中信成長高股息,10,0,10,元大-土城學府,2024-05-31,9822
3037,欣興,10,0,10,元大-土城學府,2024-05-31,9822
6005,群益證,10,0,10,元大-土城學府,2024-05-31,9822
00852L,國泰美國道瓊正2,10,0,10,元大-土城學府,2024-05-31,9822
1905,華紙,10,0,10,元大-土城學府,2024-05-31,9822
2476,鉅祥,10,0,10,元大-土城學府,2024-05-31,9822
1314,中石化,266,2,264,元大-土城學府,2024-06-03,9822
2317,鴻海,224,103,121,元大-土城學府,2024-06-03,9822
6188,廣明,120,25,95,元大-土城學府,2024-06-03,9822
00937B,群益ESG投等債20,99,4,95,元大-土城學府,2024-06-03,9822
00919,群益台灣精選高息,74,9,65,元大-土城學府,2024-06-03,9822
00637L,元大滬深300正2,61,4,57,元大-土城學府,2024-06-03,9822
2641,正德,63,6,57,元大-土城學府,2024-06-03,9822
2353,宏��,85,30,55,元大-土城學府,2024-06-03,9822
00946,群益科技高息成長,53,0,53,元大-土城學府,2024-06-03,9822
2501,國建,78,27,51,元大-土城學府,2024-06-03,9822
2354,鴻準,46,11,35,元大-土城學府,2024-06-03,9822
3706,神達,42,9,33,元大-土城學府,2024-06-03,9822
00918,大華優利高填息30,35,3,32,元大-土城學府,2024-06-03,9822
2867,三商壽,25,0,25,元大-土城學府,2024-06-03,9822
6284,佳邦,25,0,25,元大-土城學府,2024-06-03,9822
4533,協易機,50,26,24,元大-土城學府,2024-06-03,9822
2618,長榮航,31,9,22,元大-土城學府,2024-06-03,9822
3402,漢科,22,1,21,元大-土城學府,2024-06-03,9822
2605,新興,22,1,21,元大-土城學府,2024-06-03,9822
00878,國泰永續高股息,27,6,21,元大-土城學府,2024-06-03,9822
1455,集盛,32,12,20,元大-土城學府,2024-06-03,9822
1409,新纖,23,3,20,元大-土城學府,2024-06-03,9822
00679B,元大美債20年,31,12,19,元大-土城學府,2024-06-03,9822
00929,復華台灣科技優息,19,0,19,元大-土城學府,2024-06-03,9822
2324,仁寶,16,0,16,元大-土城學府,2024-06-03,9822
2401,凌陽,16,0,16,元大-土城學府,2024-06-03,9822
00852L,國泰美國道瓊正2,15,0,15,元大-土城學府,2024-06-03,9822
2101,南港,41,27,14,元大-土城學府,2024-06-03,9822
00905,FT臺灣Smart,14,0,14,元大-土城學府,2024-06-03,9822
2615,萬海,123,110,13,元大-土城學府,2024-06-03,9822
2601,益航,13,0,13,元大-土城學府,2024-06-03,9822
2337,旺宏,14,2,12,元大-土城學府,2024-06-03,9822
00715L,期街口布蘭特正2,12,0,12,元大-土城學府,2024-06-03,9822
00939,統一台灣高息動能,11,0,11,元大-土城學府,2024-06-03,9822
2301,光寶科,16,5,11,元大-土城學府,2024-06-03,9822
6139,亞翔,21,10,11,元大-土城學府,2024-06-03,9822
2382,廣達,13,3,10,元大-土城學府,2024-06-03,9822
1440,南紡,10,0,10,元大-土城學府,2024-06-03,9822
2258,鴻華先進-創,10,0,10,元大-土城學府,2024-06-03,9822
3105,穩懋,10,1,9,元大-土城學府,2024-06-03,9822
00688L,國泰20年美債正2,9,0,9,元大-土城學府,2024-06-03,9822
6269,台郡,8,0,8,元大-土城學府,2024-06-03,9822
1303,南亞,9,1,8,元大-土城學府,2024-06-03,9822
2547,日勝生,21,13,8,元大-土城學府,2024-06-03,9822
6191,精成科,8,0,8,元大-土城學府,2024-06-03,9822
2610,華航,15,8,7,元大-土城學府,2024-06-03,9822
00687B,國泰20年美債,7,0,7,元大-土城學府,2024-06-03,9822
2637,慧洋-KY,7,0,7,元大-土城學府,2024-06-03,9822
3047,訊舟,11,4,7,元大-土城學府,2024-06-03,9822
8070,長華*,7,0,7,元大-土城學府,2024-06-03,9822
00936,台新永續高息中小,357,25,332,元大-土城學府,2024-06-04,9822
1314,中石化,232,10,222,元大-土城學府,2024-06-04,9822
2312,金寶,158,10,148,元大-土城學府,2024-06-04,9822
2344,華邦電,121,14,107,元大-土城學府,2024-06-04,9822
4906,正文,104,24,80,元大-土城學府,2024-06-04,9822
00878,國泰永續高股息,81,9,72,元大-土城學府,2024-06-04,9822
00918,大華優利高填息30,68,0,68,元大-土城學府,2024-06-04,9822
00946,群益科技高息成長,65,5,60,元大-土城學府,2024-06-04,9822
00919,群益台灣精選高息,84,25,59,元大-土城學府,2024-06-04,9822
00929,復華台灣科技優息,61,8,53,元大-土城學府,2024-06-04,9822
2641,正德,54,5,49,元大-土城學府,2024-06-04,9822
5519,隆大,69,20,49,元大-土城學府,2024-06-04,9822
2353,宏��,51,10,41,元大-土城學府,2024-06-04,9822
6757,台灣虎航,41,0,41,元大-土城學府,2024-06-04,9822
2836,高雄銀,40,0,40,元大-土城學府,2024-06-04,9822
2303,聯電,47,8,39,元大-土城學府,2024-06-04,9822
3706,神達,47,9,38,元大-土城學府,2024-06-04,9822
9945,潤泰新,45,11,34,元大-土城學府,2024-06-04,9822
2324,仁寶,38,4,34,元大-土城學府,2024-06-04,9822
1802,台玻,44,15,29,元大-土城學府,2024-06-04,9822
3231,緯創,31,3,28,元大-土城學府,2024-06-04,9822
4968,立積,28,0,28,元大-土城學府,2024-06-04,9822
6125,廣運,55,29,26,元大-土城學府,2024-06-04,9822
2367,燿華,51,25,26,元大-土城學府,2024-06-04,9822
00891,中信關鍵半導體,25,0,25,元大-土城學府,2024-06-04,9822
2356,英業達,29,5,24,元大-土城學府,2024-06-04,9822
2888,新光金,37,14,23,元大-土城學府,2024-06-04,9822
00733,富邦臺灣中小,26,3,23,元大-土城學府,2024-06-04,9822
3402,漢科,21,0,21,元大-土城學府,2024-06-04,9822
6139,亞翔,35,15,20,元大-土城學府,2024-06-04,9822
2464,盟立,35,17,18,元大-土城學府,2024-06-04,9822
2885,元大金,17,0,17,元大-土城學府,2024-06-04,9822
00882,中信中國高股息,17,0,17,元大-土城學府,2024-06-04,9822
2313,華通,17,0,17,元大-土城學府,2024-06-04,9822
6185,幃翔,20,3,17,元大-土城學府,2024-06-04,9822
5392,能率,16,0,16,元大-土城學府,2024-06-04,9822
3260,威剛,19,3,16,元大-土城學府,2024-06-04,9822
6770,力積電,19,4,15,元大-土城學府,2024-06-04,9822
2801,彰銀,15,0,15,元大-土城學府,2024-06-04,9822
3266,昇陽,15,0,15,元大-土城學府,2024-06-04,9822
5474,聰泰,15,0,15,元大-土城學府,2024-06-04,9822
2449,京元電子,17,3,14,元大-土城學府,2024-06-04,9822
3033,威健,15,1,14,元大-土城學府,2024-06-04,9822
1313,聯成,13,0,13,元大-土城學府,2024-06-04,9822
2405,輔信,13,0,13,元大-土城學府,2024-06-04,9822
1303,南亞,12,0,12,元大-土城學府,2024-06-04,9822
2465,麗臺,26,14,12,元大-土城學府,2024-06-04,9822
5426,振發,17,5,12,元大-土城學府,2024-06-04,9822
0050,元大台灣50,12,0,12,元大-土城學府,2024-06-04,9822
2880,華南金,11,0,11,元大-土城學府,2024-06-04,9822
00929,復華台灣科技優息,197,27,170,元大-土城學府,2024-06-05,9822
00878,國泰永續高股息,112,13,99,元大-土城學府,2024-06-05,9822
00936,台新永續高息中小,78,2,76,元大-土城學府,2024-06-05,9822
3402,漢科,81,10,71,元大-土城學府,2024-06-05,9822
00751B,元大AAA至A公司債,92,30,62,元大-土城學府,2024-06-05,9822
2520,冠德,40,1,39,元大-土城學府,2024-06-05,9822
2002,中鋼,30,0,30,元大-土城學府,2024-06-05,9822
2101,南港,27,0,27,元大-土城學府,2024-06-05,9822
00918,大華優利高填息30,36,10,26,元大-土城學府,2024-06-05,9822
2317,鴻海,57,32,25,元大-土城學府,2024-06-05,9822
5426,振發,24,0,24,元大-土城學府,2024-06-05,9822
2353,宏��,46,24,22,元大-土城學府,2024-06-05,9822
00650L,復華香港正2,20,0,20,元大-土城學府,2024-06-05,9822
2464,盟立,33,15,18,元大-土城學府,2024-06-05,9822
9105,泰金寶-DR,20,2,18,元大-土城學府,2024-06-05,9822
6770,力積電,16,0,16,元大-土城學府,2024-06-05,9822
3706,神達,21,5,16,元大-土城學府,2024-06-05,9822
3013,晟銘電,23,8,15,元大-土城學府,2024-06-05,9822
6215,和椿,22,7,15,元大-土城學府,2024-06-05,9822
3055,蔚華科,14,0,14,元大-土城學府,2024-06-05,9822
3231,緯創,19,6,13,元大-土城學府,2024-06-05,9822
2886,兆豐金,13,1,12,元大-土城學府,2024-06-05,9822
3048,益登,32,20,12,元大-土城學府,2024-06-05,9822
00632R,元大台灣50反1,20,8,12,元大-土城學府,2024-06-05,9822
2020,美亞,12,0,12,元大-土城學府,2024-06-05,9822
2331,精英,26,14,12,元大-土城學府,2024-06-05,9822
6284,佳邦,12,0,12,元大-土城學府,2024-06-05,9822
8076,伍豐,12,0,12,元大-土城學府,2024-06-05,9822
00940,元大台灣價值高息,66,55,11,元大-土城學府,2024-06-05,9822
3372,典範,18,7,11,元大-土城學府,2024-06-05,9822
4562,穎漢,16,5,11,元大-土城學府,2024-06-05,9822
4967,十銓,33,22,11,元大-土城學府,2024-06-05,9822
00921,兆豐龍頭等權重,10,0,10,元大-土城學府,2024-06-05,9822
00637L,元大滬深300正2,10,0,10,元大-土城學府,2024-06-05,9822
00905,FT臺灣Smart,10,0,10,元大-土城學府,2024-06-05,9822
1440,南紡,10,0,10,元大-土城學府,2024-06-05,9822
2314,台揚,10,0,10,元大-土城學府,2024-06-05,9822
3312,弘憶股,10,0,10,元大-土城學府,2024-06-05,9822
5474,聰泰,10,0,10,元大-土城學府,2024-06-05,9822
5498,凱崴,10,0,10,元大-土城學府,2024-06-05,9822
3088,艾訊,9,0,9,元大-土城學府,2024-06-05,9822
8438,昶昕,11,2,9,元大-土城學府,2024-06-05,9822
00900,富邦特選高股息30,10,2,8,元大-土城學府,2024-06-05,9822
1905,華紙,9,1,8,元大-土城學府,2024-06-05,9822
3432,台端,10,2,8,元大-土城學府,2024-06-05,9822
4188,安克,8,0,8,元大-土城學府,2024-06-05,9822
9934,成霖,12,4,8,元大-土城學府,2024-06-05,9822
6282,康舒,8,0,8,元大-土城學府,2024-06-05,9822
6531,愛普*,8,0,8,元大-土城學府,2024-06-05,9822
2618,長榮航,14,6,8,元大-土城學府,2024-06-05,9822
4967,十銓,88,4,84,元大-土城學府,2024-06-06,9822
00632R,元大台灣50反1,81,0,81,元大-土城學府,2024-06-06,9822
00946,群益科技高息成長,56,0,56,元大-土城學府,2024-06-06,9822
2611,志信,60,6,54,元大-土城學府,2024-06-06,9822
00929,復華台灣科技優息,54,2,52,元大-土城學府,2024-06-06,9822
2317,鴻海,98,47,51,元大-土城學府,2024-06-06,9822
2548,華固,51,3,48,元大-土城學府,2024-06-06,9822
2520,冠德,54,7,47,元大-土城學府,2024-06-06,9822
00936,台新永續高息中小,33,0,33,元大-土城學府,2024-06-06,9822
00923,群益台ESG低碳50,43,10,33,元大-土城學府,2024-06-06,9822
00915,凱基優選高股息30,34,3,31,元大-土城學府,2024-06-06,9822
00679B,元大美債20年,42,12,30,元大-土城學府,2024-06-06,9822
00937B,群益ESG投等債20,52,23,29,元大-土城學府,2024-06-06,9822
1815,富喬,38,10,28,元大-土城學府,2024-06-06,9822
3013,晟銘電,54,27,27,元大-土城學府,2024-06-06,9822
00918,大華優利高填息30,31,4,27,元大-土城學府,2024-06-06,9822
8926,台汽電,26,0,26,元大-土城學府,2024-06-06,9822
00919,群益台灣精選高息,55,30,25,元大-土城學府,2024-06-06,9822
2883B,凱基金乙特,25,0,25,元大-土城學府,2024-06-06,9822
1522,堤維西,37,13,24,元大-土城學府,2024-06-06,9822
6197,佳必琪,28,6,22,元大-土城學府,2024-06-06,9822
6116,彩晶,21,0,21,元大-土城學府,2024-06-06,9822
8071,能率網通,21,0,21,元大-土城學府,2024-06-06,9822
2609,陽明,348,328,20,元大-土城學府,2024-06-06,9822
00637L,元大滬深300正2,20,0,20,元大-土城學府,2024-06-06,9822
2020,美亞,20,0,20,元大-土城學府,2024-06-06,9822
2913,農林,18,0,18,元大-土城學府,2024-06-06,9822
2353,宏��,32,15,17,元大-土城學府,2024-06-06,9822
2316,楠梓電,18,1,17,元大-土城學府,2024-06-06,9822
2101,南港,90,74,16,元大-土城學府,2024-06-06,9822
2855,統一證,16,1,15,元大-土城學府,2024-06-06,9822
2489,瑞軒,20,5,15,元大-土城學府,2024-06-06,9822
5302,太欣,22,7,15,元大-土城學府,2024-06-06,9822
3231,緯創,28,13,15,元大-土城學府,2024-06-06,9822
1301,台塑,17,3,14,元大-土城學府,2024-06-06,9822
5347,世界,38,24,14,元大-土城學府,2024-06-06,9822
5009,榮剛,14,0,14,元大-土城學府,2024-06-06,9822
1781,合世,14,0,14,元大-土城學府,2024-06-06,9822
6191,精成科,24,10,14,元大-土城學府,2024-06-06,9822
6153,嘉聯益,12,0,12,元大-土城學府,2024-06-06,9822
5392,能率,35,23,12,元大-土城學府,2024-06-06,9822
00725B,國泰投資級公司債,11,0,11,元大-土城學府,2024-06-06,9822
2104,國際中橡,11,0,11,元大-土城學府,2024-06-06,9822
2337,旺宏,12,1,11,元大-土城學府,2024-06-06,9822
00902,中信電池及儲能,10,0,10,元大-土城學府,2024-06-06,9822
00882,中信中國高股息,10,0,10,元大-土城學府,2024-06-06,9822
1455,集盛,103,93,10,元大-土城學府,2024-06-06,9822
2464,盟立,12,2,10,元大-土城學府,2024-06-06,9822
2476,鉅祥,10,0,10,元大-土城學府,2024-06-06,9822
8011,台通,10,0,10,元大-土城學府,2024-06-06,9822
00929,復華台灣科技優息,98,0,98,元大-土城學府,2024-06-07,9822
2610,華航,158,73,85,元大-土城學府,2024-06-07,9822
00637L,元大滬深300正2,55,0,55,元大-土城學府,2024-06-07,9822
00665L,富邦�琤肭磪囓�2,50,0,50,元大-土城學府,2024-06-07,9822
3231,緯創,68,20,48,元大-土城學府,2024-06-07,9822
00679B,元大美債20年,41,0,41,元大-土城學府,2024-06-07,9822
1503,士電,45,5,40,元大-土城學府,2024-06-07,9822
2312,金寶,39,2,37,元大-土城學府,2024-06-07,9822
8291,尚茂,35,0,35,元大-土城學府,2024-06-07,9822
2002,中鋼,32,0,32,元大-土城學府,2024-06-07,9822
2367,燿華,68,38,30,元大-土城學府,2024-06-07,9822
1609,大亞,53,25,28,元大-土城學府,2024-06-07,9822
00680L,元大美債20正2,26,0,26,元大-土城學府,2024-06-07,9822
00936,台新永續高息中小,26,0,26,元大-土城學府,2024-06-07,9822
3260,威剛,28,4,24,元大-土城學府,2024-06-07,9822
2382,廣達,20,0,20,元大-土城學府,2024-06-07,9822
2329,華泰,25,6,19,元大-土城學府,2024-06-07,9822
1612,宏泰,19,1,18,元大-土城學府,2024-06-07,9822
2353,宏��,27,10,17,元大-土城學府,2024-06-07,9822
2489,瑞軒,28,12,16,元大-土城學府,2024-06-07,9822
2105,正新,15,0,15,元大-土城學府,2024-06-07,9822
5302,太欣,14,0,14,元大-土城學府,2024-06-07,9822
6005,群益證,16,3,13,元大-土城學府,2024-06-07,9822
9105,泰金寶-DR,13,0,13,元大-土城學府,2024-06-07,9822
3013,晟銘電,53,41,12,元大-土城學府,2024-06-07,9822
2603,長榮,22,10,12,元大-土城學府,2024-06-07,9822
2376,技嘉,11,0,11,元大-土城學府,2024-06-07,9822
00918,大華優利高填息30,12,1,11,元大-土城學府,2024-06-07,9822
1587,吉茂,11,0,11,元大-土城學府,2024-06-07,9822
2455,全新,11,0,11,元大-土城學府,2024-06-07,9822
2354,鴻準,15,4,11,元大-土城學府,2024-06-07,9822
00720B,元大投資級公司債,10,0,10,元大-土城學府,2024-06-07,9822
00715L,期街口布蘭特正2,10,0,10,元大-土城學府,2024-06-07,9822
1102,亞泥,10,0,10,元大-土城學府,2024-06-07,9822
1785,光洋科,10,0,10,元大-土城學府,2024-06-07,9822
3046,建��,10,0,10,元大-土城學府,2024-06-07,9822
6197,佳必琪,11,1,10,元大-土城學府,2024-06-07,9822
2324,仁寶,9,0,9,元大-土城學府,2024-06-07,9822
3037,欣興,19,10,9,元大-土城學府,2024-06-07,9822
00725B,國泰投資級公司債,9,0,9,元大-土城學府,2024-06-07,9822
3122,笙泉,20,11,9,元大-土城學府,2024-06-07,9822
3257,虹冠電,9,0,9,元大-土城學府,2024-06-07,9822
4510,高鋒,9,0,9,元大-土城學府,2024-06-07,9822
2368,金像電,8,0,8,元大-土城學府,2024-06-07,9822
3324,雙鴻,17,9,8,元大-土城學府,2024-06-07,9822
2464,盟立,10,2,8,元大-土城學府,2024-06-07,9822
2417,圓剛,10,2,8,元大-土城學府,2024-06-07,9822
3048,益登,10,2,8,元大-土城學府,2024-06-07,9822
8089,康全電訊,11,3,8,元大-土城學府,2024-06-07,9822
0050,元大台灣50,8,0,8,元大-土城學府,2024-06-07,9822
2609,陽明,327,201,126,元大-土城學府,2024-06-11,9822
00918,大華優利高填息30,83,0,83,元大-土城學府,2024-06-11,9822
4967,十銓,95,16,79,元大-土城學府,2024-06-11,9822
2881,富邦金,60,2,58,元大-土城學府,2024-06-11,9822
1455,集盛,67,12,55,元大-土城學府,2024-06-11,9822
00919,群益台灣精選高息,68,21,47,元大-土城學府,2024-06-11,9822
8926,台汽電,44,0,44,元大-土城學府,2024-06-11,9822
00946,群益科技高息成長,43,0,43,元大-土城學府,2024-06-11,9822
1815,富喬,66,25,41,元大-土城學府,2024-06-11,9822
2603,長榮,86,46,40,元大-土城學府,2024-06-11,9822
00688L,國泰20年美債正2,40,0,40,元大-土城學府,2024-06-11,9822
2374,佳能,42,2,40,元大-土城學府,2024-06-11,9822
00929,復華台灣科技優息,47,10,37,元大-土城學府,2024-06-11,9822
00680L,元大美債20正2,42,5,37,元大-土城學府,2024-06-11,9822
00679B,元大美債20年,104,69,35,元大-土城學府,2024-06-11,9822
00937B,群益ESG投等債20,56,24,32,元大-土城學府,2024-06-11,9822
00882,中信中國高股息,36,7,29,元大-土城學府,2024-06-11,9822
00720B,元大投資級公司債,28,0,28,元大-土城學府,2024-06-11,9822
2615,萬海,81,56,25,元大-土城學府,2024-06-11,9822
00687B,國泰20年美債,22,0,22,元大-土城學府,2024-06-11,9822
5426,振發,21,0,21,元大-土城學府,2024-06-11,9822
2002,中鋼,26,6,20,元大-土城學府,2024-06-11,9822
6216,居易,20,0,20,元大-土城學府,2024-06-11,9822
6442,光聖,25,5,20,元大-土城學府,2024-06-11,9822
2501,國建,26,8,18,元大-土城學府,2024-06-11,9822
6116,彩晶,18,0,18,元大-土城學府,2024-06-11,9822
2882,國泰金,21,4,17,元大-土城學府,2024-06-11,9822
2641,正德,18,3,15,元大-土城學府,2024-06-11,9822
2258,鴻華先進-創,15,0,15,元大-土城學府,2024-06-11,9822
6215,和椿,17,2,15,元大-土城學府,2024-06-11,9822
1618,合機,79,65,14,元大-土城學府,2024-06-11,9822
2421,建準,14,0,14,元大-土城學府,2024-06-11,9822
2464,盟立,21,7,14,元大-土城學府,2024-06-11,9822
2867,三商壽,26,12,14,元大-土城學府,2024-06-11,9822
00936,台新永續高息中小,13,0,13,元大-土城學府,2024-06-11,9822
3481,群創,15,2,13,元大-土城學府,2024-06-11,9822
2520,冠德,18,6,12,元大-土城學府,2024-06-11,9822
9945,潤泰新,41,29,12,元大-土城學府,2024-06-11,9822
5439,高技,11,0,11,元大-土城學府,2024-06-11,9822
6531,愛普*,11,0,11,元大-土城學府,2024-06-11,9822
1301,台塑,11,0,11,元大-土城學府,2024-06-11,9822
00712,復華富時不動產,11,0,11,元大-土城學府,2024-06-11,9822
1434,福懋,11,0,11,元大-土城學府,2024-06-11,9822
3033,威健,12,1,11,元大-土城學府,2024-06-11,9822
3176,基亞,11,0,11,元大-土城學府,2024-06-11,9822
2359,所羅門,11,1,10,元大-土城學府,2024-06-11,9822
00772B,中信高評級公司債,10,0,10,元大-土城學府,2024-06-11,9822
00931B,統一美債20年,10,0,10,元大-土城學府,2024-06-11,9822
2101,南港,13,3,10,元大-土城學府,2024-06-11,9822
2402,毅嘉,10,0,10,元大-土城學府,2024-06-11,9822
8110,華東,102,0,102,元大-土城學府,2024-06-12,9822
1455,集盛,100,20,80,元大-土城學府,2024-06-12,9822
00929,復華台灣科技優息,78,10,68,元大-土城學府,2024-06-12,9822
6216,居易,77,15,62,元大-土城學府,2024-06-12,9822
1101,台泥,64,4,60,元大-土城學府,2024-06-12,9822
2641,正德,47,2,45,元大-土城學府,2024-06-12,9822
00918,大華優利高填息30,45,0,45,元大-土城學府,2024-06-12,9822
2356,英業達,80,37,43,元大-土城學府,2024-06-12,9822
2883,凱基金,40,2,38,元大-土城學府,2024-06-12,9822
00919,群益台灣精選高息,35,1,34,元大-土城學府,2024-06-12,9822
3013,晟銘電,47,15,32,元大-土城學府,2024-06-12,9822
00679B,元大美債20年,36,5,31,元大-土城學府,2024-06-12,9822
2354,鴻準,35,6,29,元大-土城學府,2024-06-12,9822
2610,華航,41,13,28,元大-土城學府,2024-06-12,9822
00948B,中信優息投資級債,28,0,28,元大-土城學府,2024-06-12,9822
1618,合機,66,42,24,元大-土城學府,2024-06-12,9822
2002,中鋼,24,0,24,元大-土城學府,2024-06-12,9822
2486,一詮,41,18,23,元大-土城學府,2024-06-12,9822
2882,國泰金,22,0,22,元大-土城學府,2024-06-12,9822
3540,曜越,20,0,20,元大-土城學府,2024-06-12,9822
2374,佳能,22,3,19,元大-土城學府,2024-06-12,9822
6770,力積電,19,0,19,元大-土城學府,2024-06-12,9822
00712,復華富時不動產,19,0,19,元大-土城學府,2024-06-12,9822
9105,泰金寶-DR,28,10,18,元大-土城學府,2024-06-12,9822
2545,皇翔,18,1,17,元大-土城學府,2024-06-12,9822
1503,士電,25,9,16,元大-土城學府,2024-06-12,9822
2303,聯電,15,0,15,元大-土城學府,2024-06-12,9822
2312,金寶,16,1,15,元大-土城學府,2024-06-12,9822
2867,三商壽,35,20,15,元大-土城學府,2024-06-12,9822
00946,群益科技高息成長,23,9,14,元大-土城學府,2024-06-12,9822
9945,潤泰新,16,3,13,元大-土城學府,2024-06-12,9822
2409,友達,14,1,13,元大-土城學府,2024-06-12,9822
2515,中工,15,2,13,元大-土城學府,2024-06-12,9822
8926,台汽電,13,0,13,元大-土城學府,2024-06-12,9822
00947,台新臺灣IC設計,12,0,12,元大-土城學府,2024-06-12,9822
3481,群創,21,9,12,元大-土城學府,2024-06-12,9822
00939,統一台灣高息動能,14,2,12,元大-土城學府,2024-06-12,9822
1711,永光,11,0,11,元大-土城學府,2024-06-12,9822
2352,佳世達,11,0,11,元大-土城學府,2024-06-12,9822
6144,得利影,11,0,11,元大-土城學府,2024-06-12,9822
2891,中信金,11,1,10,元大-土城學府,2024-06-12,9822
00927,群益半導體收益,10,0,10,元大-土城學府,2024-06-12,9822
1514,亞力,14,4,10,元大-土城學府,2024-06-12,9822
2258,鴻華先進-創,10,0,10,元大-土城學府,2024-06-12,9822
8011,台通,10,0,10,元大-土城學府,2024-06-12,9822
3363,上詮,33,23,10,元大-土城學府,2024-06-12,9822
2331,精英,13,4,9,元大-土城學府,2024-06-12,9822
00830,國泰費城半導體,12,3,9,元大-土城學府,2024-06-12,9822
1307,三芳,9,0,9,元大-土城學府,2024-06-12,9822
1714,和桐,10,1,9,元大-土城學府,2024-06-12,9822
00679B,元大美債20年,278,51,227,元大-土城學府,2024-06-13,9822
00632R,元大台灣50反1,216,0,216,元大-土城學府,2024-06-13,9822
2609,陽明,187,107,80,元大-土城學府,2024-06-13,9822
00929,復華台灣科技優息,120,41,79,元大-土城學府,2024-06-13,9822
00937B,群益ESG投等債20,58,0,58,元大-土城學府,2024-06-13,9822
1514,亞力,82,43,39,元大-土城學府,2024-06-13,9822
00687B,國泰20年美債,39,0,39,元大-土城學府,2024-06-13,9822
6284,佳邦,40,2,38,元大-土城學府,2024-06-13,9822
2412,中華電,38,1,37,元大-土城學府,2024-06-13,9822
6788,華景電,29,0,29,元大-土城學府,2024-06-13,9822
2002,中鋼,31,4,27,元大-土城學府,2024-06-13,9822
8210,勤誠,27,1,26,元大-土城學府,2024-06-13,9822
2618,長榮航,29,3,26,元大-土城學府,2024-06-13,9822
8028,昇陽半導體,35,11,24,元大-土城學府,2024-06-13,9822
5439,高技,27,5,22,元大-土城學府,2024-06-13,9822
2359,所羅門,42,22,20,元大-土城學府,2024-06-13,9822
2258,鴻華先進-創,20,0,20,元大-土城學府,2024-06-13,9822
2317,鴻海,59,41,18,元大-土城學府,2024-06-13,9822
2458,義隆,18,0,18,元大-土城學府,2024-06-13,9822
1609,大亞,26,9,17,元大-土城學府,2024-06-13,9822
2009,第一銅,15,0,15,元大-土城學府,2024-06-13,9822
6290,良維,15,0,15,元大-土城學府,2024-06-13,9822
2367,燿華,48,34,14,元大-土城學府,2024-06-13,9822
1517,利奇,14,0,14,元大-土城學府,2024-06-13,9822
1815,富喬,31,17,14,元大-土城學府,2024-06-13,9822
6215,和椿,17,4,13,元大-土城學府,2024-06-13,9822
8383,千附,13,0,13,元大-土城學府,2024-06-13,9822
1618,合機,15,2,13,元大-土城學府,2024-06-13,9822
6139,亞翔,15,3,12,元大-土城學府,2024-06-13,9822
3189,景碩,11,0,11,元大-土城學府,2024-06-13,9822
3715,定穎投控,11,0,11,元大-土城學府,2024-06-13,9822
2368,金像電,11,0,11,元大-土城學府,2024-06-13,9822
2201,裕隆,11,1,10,元大-土城學府,2024-06-13,9822
00753L,中信中國50正2,10,0,10,元大-土城學府,2024-06-13,9822
00902,中信電池及儲能,10,0,10,元大-土城學府,2024-06-13,9822
3564,其陽,12,2,10,元大-土城學府,2024-06-13,9822
6153,嘉聯益,10,0,10,元大-土城學府,2024-06-13,9822
2641,正德,10,0,10,元大-土城學府,2024-06-13,9822
1307,三芳,9,0,9,元大-土城學府,2024-06-13,9822
1907,永豐餘,9,0,9,元大-土城學府,2024-06-13,9822
4127,天良,10,1,9,元大-土城學府,2024-06-13,9822
00918,大華優利高填息30,14,6,8,元大-土城學府,2024-06-13,9822
00720B,元大投資級公司債,9,1,8,元大-土城學府,2024-06-13,9822
00948B,中信優息投資級債,10,2,8,元大-土城學府,2024-06-13,9822
2365,昆盈,19,11,8,元大-土城學府,2024-06-13,9822
4904,遠傳,8,0,8,元大-土城學府,2024-06-13,9822
00830,國泰費城半導體,8,0,8,元大-土城學府,2024-06-13,9822
1434,福懋,7,0,7,元大-土城學府,2024-06-13,9822
00725B,國泰投資級公司債,7,0,7,元大-土城學府,2024-06-13,9822
00947,台新臺灣IC設計,7,0,7,元大-土城學府,2024-06-13,9822
2371,大同,139,59,80,元大-土城學府,2024-06-14,9822
2359,所羅門,62,17,45,元大-土城學府,2024-06-14,9822
1608,華榮,58,13,45,元大-土城學府,2024-06-14,9822
9934,成霖,42,0,42,元大-土城學府,2024-06-14,9822
00919,群益台灣精選高息,43,4,39,元大-土城學府,2024-06-14,9822
6161,捷波,44,5,39,元大-土城學府,2024-06-14,9822
00679B,元大美債20年,44,8,36,元大-土城學府,2024-06-14,9822
8383,千附,32,0,32,元大-土城學府,2024-06-14,9822
2618,長榮航,39,7,32,元大-土城學府,2024-06-14,9822
9945,潤泰新,34,6,28,元大-土城學府,2024-06-14,9822
5701,劍湖山,24,0,24,元大-土城學府,2024-06-14,9822
2887,台新金,23,0,23,元大-土城學府,2024-06-14,9822
3231,緯創,43,22,21,元大-土城學府,2024-06-14,9822
00936,台新永續高息中小,29,8,21,元大-土城學府,2024-06-14,9822
00948B,中信優息投資級債,21,0,21,元大-土城學府,2024-06-14,9822
3105,穩懋,22,2,20,元大-土城學府,2024-06-14,9822
1785,光洋科,27,7,20,元大-土城學府,2024-06-14,9822
2353,宏��,31,11,20,元大-土城學府,2024-06-14,9822
3202,樺晟,21,1,20,元大-土城學府,2024-06-14,9822
3048,益登,53,34,19,元大-土城學府,2024-06-14,9822
1609,大亞,55,38,17,元大-土城學府,2024-06-14,9822
2867,三商壽,20,3,17,元大-土城學府,2024-06-14,9822
00946,群益科技高息成長,16,0,16,元大-土城學府,2024-06-14,9822
3715,定穎投控,16,0,16,元大-土城學府,2024-06-14,9822
2363,矽統,22,7,15,元大-土城學府,2024-06-14,9822
00680L,元大美債20正2,40,25,15,元大-土城學府,2024-06-14,9822
6216,居易,21,7,14,元大-土城學府,2024-06-14,9822
2392,正崴,34,21,13,元大-土城學府,2024-06-14,9822
1815,富喬,41,28,13,元大-土城學府,2024-06-14,9822
3037,欣興,17,5,12,元大-土城學府,2024-06-14,9822
6788,華景電,14,2,12,元大-土城學府,2024-06-14,9822
2605,新興,15,3,12,元大-土城學府,2024-06-14,9822
1314,中石化,16,5,11,元大-土城學府,2024-06-14,9822
1616,億泰,25,14,11,元大-土城學府,2024-06-14,9822
4908,前鼎,12,1,11,元大-土城學府,2024-06-14,9822
6144,得利影,11,0,11,元大-土城學府,2024-06-14,9822
6271,同欣電,11,0,11,元大-土城學府,2024-06-14,9822
5347,世界,16,5,11,元大-土城學府,2024-06-14,9822
6147,頎邦,11,1,10,元大-土城學府,2024-06-14,9822
2344,華邦電,16,6,10,元大-土城學府,2024-06-14,9822
00650L,復華香港正2,10,0,10,元大-土城學府,2024-06-14,9822
2427,三商電,13,3,10,元大-土城學府,2024-06-14,9822
2514,龍邦,10,0,10,元大-土城學府,2024-06-14,9822
2617,台航,10,0,10,元大-土城學府,2024-06-14,9822
3027,盛達,10,0,10,元大-土城學府,2024-06-14,9822
3094,聯傑,10,0,10,元大-土城學府,2024-06-14,9822
6570,維田,10,0,10,元大-土城學府,2024-06-14,9822
5871,中租-KY,11,1,10,元大-土城學府,2024-06-14,9822
3710,連展投控,10,1,9,元大-土城學府,2024-06-14,9822
6270,倍微,13,4,9,元大-土城學府,2024-06-14,9822
00919,群益台灣精選高息,131,10,121,元大-土城學府,2024-06-17,9822
1608,華榮,141,53,88,元大-土城學府,2024-06-17,9822
1455,集盛,60,0,60,元大-土城學府,2024-06-17,9822
2515,中工,55,0,55,元大-土城學府,2024-06-17,9822
5302,太欣,55,1,54,元大-土城學府,2024-06-17,9822
2371,大同,103,66,37,元大-土城學府,2024-06-17,9822
2610,華航,41,5,36,元大-土城學府,2024-06-17,9822
00918,大華優利高填息30,55,24,31,元大-土城學府,2024-06-17,9822
3048,益登,40,11,29,元大-土城學府,2024-06-17,9822
00679B,元大美債20年,35,8,27,元大-土城學府,2024-06-17,9822
00713,元大台灣高息低波,25,0,25,元大-土城學府,2024-06-17,9822
2031,新光鋼,35,10,25,元大-土城學府,2024-06-17,9822
2615,萬海,82,58,24,元大-土城學府,2024-06-17,9822
2887,台新金,21,0,21,元大-土城學府,2024-06-17,9822
1503,士電,41,21,20,元大-土城學府,2024-06-17,9822
2838,聯邦銀,20,0,20,元大-土城學府,2024-06-17,9822
00687B,國泰20年美債,20,0,20,元大-土城學府,2024-06-17,9822
1584,精剛,18,0,18,元大-土城學府,2024-06-17,9822
00712,復華富時不動產,17,0,17,元大-土城學府,2024-06-17,9822
3481,群創,46,29,17,元大-土城學府,2024-06-17,9822
2705,六福,17,0,17,元大-土城學府,2024-06-17,9822
6538,倉和,17,0,17,元大-土城學府,2024-06-17,9822
00882,中信中國高股息,16,0,16,元大-土城學府,2024-06-17,9822
9105,泰金寶-DR,59,43,16,元大-土城學府,2024-06-17,9822
2641,正德,15,0,15,元大-土城學府,2024-06-17,9822
2609,陽明,86,71,15,元大-土城學府,2024-06-17,9822
2618,長榮航,19,4,15,元大-土城學府,2024-06-17,9822
8383,千附,15,0,15,元大-土城學府,2024-06-17,9822
006208,富邦台50,15,1,14,元大-土城學府,2024-06-17,9822
6139,亞翔,24,11,13,元大-土城學府,2024-06-17,9822
1611,中電,15,2,13,元大-土城學府,2024-06-17,9822
3231,緯創,22,9,13,元大-土城學府,2024-06-17,9822
00936,台新永續高息中小,23,11,12,元大-土城學府,2024-06-17,9822
4113,聯上,13,1,12,元大-土城學府,2024-06-17,9822
00933B,國泰10Y+金融債,13,1,12,元大-土城學府,2024-06-17,9822
00751B,元大AAA至A公司債,11,0,11,元大-土城學府,2024-06-17,9822
00878,國泰永續高股息,10,0,10,元大-土城學府,2024-06-17,9822
2534,宏盛,10,0,10,元大-土城學府,2024-06-17,9822
6788,華景電,10,0,10,元大-土城學府,2024-06-17,9822
00948B,中信優息投資級債,9,0,9,元大-土城學府,2024-06-17,9822
2316,楠梓電,20,11,9,元大-土城學府,2024-06-17,9822
2467,志聖,9,0,9,元大-土城學府,2024-06-17,9822
2545,皇翔,9,0,9,元大-土城學府,2024-06-17,9822
1605,華新,12,3,9,元大-土城學府,2024-06-17,9822
2537,聯上發,9,1,8,元大-土城學府,2024-06-17,9822
3022,威強電,8,0,8,元大-土城學府,2024-06-17,9822
00646,元大S＆P500,8,0,8,元大-土城學府,2024-06-17,9822
2330,台積電,8,0,8,元大-土城學府,2024-06-17,9822
2354,鴻準,15,8,7,元大-土城學府,2024-06-17,9822
4726,永昕,17,10,7,元大-土城學府,2024-06-17,9822
00919,群益台灣精選高息,221,32,189,元大-土城學府,2024-06-18,9822
00929,復華台灣科技優息,103,14,89,元大-土城學府,2024-06-18,9822
00937B,群益ESG投等債20,86,5,81,元大-土城學府,2024-06-18,9822
9105,泰金寶-DR,65,18,47,元大-土城學府,2024-06-18,9822
00946,群益科技高息成長,47,0,47,元大-土城學府,2024-06-18,9822
2353,宏��,63,20,43,元大-土城學府,2024-06-18,9822
3013,晟銘電,37,7,30,元大-土城學府,2024-06-18,9822
2392,正崴,64,36,28,元大-土城學府,2024-06-18,9822
1504,東元,31,5,26,元大-土城學府,2024-06-18,9822
2359,所羅門,78,54,24,元大-土城學府,2024-06-18,9822
1608,華榮,24,0,24,元大-土城學府,2024-06-18,9822
6531,愛普*,23,0,23,元大-土城學府,2024-06-18,9822
00720B,元大投資級公司債,23,0,23,元大-土城學府,2024-06-18,9822
2363,矽統,30,8,22,元大-土城學府,2024-06-18,9822
4562,穎漢,48,27,21,元大-土城學府,2024-06-18,9822
00632R,元大台灣50反1,20,0,20,元大-土城學府,2024-06-18,9822
2402,毅嘉,20,0,20,元大-土城學府,2024-06-18,9822
00918,大華優利高填息30,47,27,20,元大-土城學府,2024-06-18,9822
1522,堤維西,31,12,19,元大-土城學府,2024-06-18,9822
3535,晶彩科,27,8,19,元大-土城學府,2024-06-18,9822
4566,時碩工業,27,8,19,元大-土城學府,2024-06-18,9822
00687B,國泰20年美債,18,0,18,元大-土城學府,2024-06-18,9822
00942B,台新美A公司債20+,17,0,17,元大-土城學府,2024-06-18,9822
2515,中工,17,0,17,元大-土城學府,2024-06-18,9822
1463,強盛新,16,0,16,元大-土城學府,2024-06-18,9822
2025,千興,16,0,16,元大-土城學府,2024-06-18,9822
00713,元大台灣高息低波,16,0,16,元大-土城學府,2024-06-18,9822
00933B,國泰10Y+金融債,15,0,15,元大-土城學府,2024-06-18,9822
1802,台玻,35,21,14,元大-土城學府,2024-06-18,9822
6538,倉和,13,0,13,元大-土城學府,2024-06-18,9822
6770,力積電,21,9,12,元大-土城學府,2024-06-18,9822
00753L,中信中國50正2,12,0,12,元大-土城學府,2024-06-18,9822
006208,富邦台50,12,1,11,元大-土城學府,2024-06-18,9822
5490,同亨,21,10,11,元大-土城學府,2024-06-18,9822
6270,倍微,13,2,11,元大-土城學府,2024-06-18,9822
00679B,元大美債20年,14,4,10,元大-土城學府,2024-06-18,9822
1909,榮成,10,0,10,元大-土城學府,2024-06-18,9822
2601,益航,10,0,10,元大-土城學府,2024-06-18,9822
2851,中再保,10,0,10,元大-土城學府,2024-06-18,9822
6788,華景電,12,2,10,元大-土城學府,2024-06-18,9822
00850,元大臺灣ESG永續,10,0,10,元大-土城學府,2024-06-18,9822
2368,金像電,14,5,9,元大-土城學府,2024-06-18,9822
2615,萬海,38,29,9,元大-土城學府,2024-06-18,9822
3033,威健,9,0,9,元大-土城學府,2024-06-18,9822
3481,群創,24,15,9,元大-土城學府,2024-06-18,9822
4188,安克,9,0,9,元大-土城學府,2024-06-18,9822
4510,高鋒,9,0,9,元大-土城學府,2024-06-18,9822
4952,凌通,13,4,9,元大-土城學府,2024-06-18,9822
5701,劍湖山,9,0,9,元大-土城學府,2024-06-18,9822
2887,台新金,9,0,9,元大-土城學府,2024-06-18,9822
00632R,元大台灣50反1,129,5,124,元大-土城學府,2024-06-19,9822
00679B,元大美債20年,79,6,73,元大-土城學府,2024-06-19,9822
2618,長榮航,152,82,70,元大-土城學府,2024-06-19,9822
2317,鴻海,120,76,44,元大-土城學府,2024-06-19,9822
00688L,國泰20年美債正2,43,0,43,元大-土城學府,2024-06-19,9822
00946,群益科技高息成長,43,0,43,元大-土城學府,2024-06-19,9822
2359,所羅門,88,49,39,元大-土城學府,2024-06-19,9822
6139,亞翔,38,0,38,元大-土城學府,2024-06-19,9822
00919,群益台灣精選高息,132,97,35,元大-土城學府,2024-06-19,9822
00687B,國泰20年美債,38,5,33,元大-土城學府,2024-06-19,9822
00902,中信電池及儲能,30,0,30,元大-土城學府,2024-06-19,9822
2641,正德,30,0,30,元大-土城學府,2024-06-19,9822
2610,華航,121,92,29,元大-土城學府,2024-06-19,9822
1616,億泰,30,2,28,元大-土城學府,2024-06-19,9822
2428,興勤,28,0,28,元大-土城學府,2024-06-19,9822
3312,弘憶股,28,1,27,元大-土城學府,2024-06-19,9822
1618,合機,42,16,26,元大-土城學府,2024-06-19,9822
3013,晟銘電,48,23,25,元大-土城學府,2024-06-19,9822
2371,大同,60,36,24,元大-土城學府,2024-06-19,9822
00936,台新永續高息中小,24,1,23,元大-土城學府,2024-06-19,9822
5701,劍湖山,23,0,23,元大-土城學府,2024-06-19,9822
3062,建漢,36,15,21,元大-土城學府,2024-06-19,9822
2368,金像電,24,3,21,元大-土城學府,2024-06-19,9822
6163,華電網,21,0,21,元大-土城學府,2024-06-19,9822
00713,元大台灣高息低波,25,6,19,元大-土城學府,2024-06-19,9822
6213,聯茂,19,0,19,元大-土城學府,2024-06-19,9822
1455,集盛,17,0,17,元大-土城學府,2024-06-19,9822
6116,彩晶,14,2,12,元大-土城學府,2024-06-19,9822
1316,上曜,12,0,12,元大-土城學府,2024-06-19,9822
1303,南亞,12,0,12,元大-土城學府,2024-06-19,9822
1514,亞力,23,11,12,元大-土城學府,2024-06-19,9822
1815,富喬,33,22,11,元大-土城學府,2024-06-19,9822
1711,永光,11,0,11,元大-土城學府,2024-06-19,9822
2520,冠德,11,0,11,元大-土城學府,2024-06-19,9822
3363,上詮,41,30,11,元大-土城學府,2024-06-19,9822
4967,十銓,28,17,11,元大-土城學府,2024-06-19,9822
9105,泰金寶-DR,15,4,11,元大-土城學府,2024-06-19,9822
3450,聯鈞,41,31,10,元大-土城學府,2024-06-19,9822
8383,千附,10,0,10,元大-土城學府,2024-06-19,9822
1325,恆大,16,6,10,元大-土城學府,2024-06-19,9822
2402,毅嘉,10,0,10,元大-土城學府,2024-06-19,9822
00882,中信中國高股息,15,6,9,元大-土城學府,2024-06-19,9822
1587,吉茂,10,1,9,元大-土城學府,2024-06-19,9822
00700,富邦�琤肭磪�,8,0,8,元大-土城學府,2024-06-19,9822
2414,精技,8,0,8,元大-土城學府,2024-06-19,9822
4188,安克,8,0,8,元大-土城學府,2024-06-19,9822
8071,能率網通,8,0,8,元大-土城學府,2024-06-19,9822
8110,華東,10,2,8,元大-土城學府,2024-06-19,9822
3702,大聯大,10,2,8,元大-土城學府,2024-06-19,9822
00712,復華富時不動產,8,0,8,元大-土城學府,2024-06-19,9822
00940,元大台灣價值高息,924,159,765,元大-土城學府,2024-06-20,9822
00946,群益科技高息成長,148,0,148,元大-土城學府,2024-06-20,9822
00687B,國泰20年美債,87,4,83,元大-土城學府,2024-06-20,9822
00936,台新永續高息中小,79,0,79,元大-土城學府,2024-06-20,9822
00929,復華台灣科技優息,167,107,60,元大-土城學府,2024-06-20,9822
2618,長榮航,70,17,53,元大-土城學府,2024-06-20,9822
00937B,群益ESG投等債20,49,0,49,元大-土城學府,2024-06-20,9822
006208,富邦台50,47,0,47,元大-土城學府,2024-06-20,9822
2855,統一證,45,0,45,元大-土城學府,2024-06-20,9822
2317,鴻海,103,60,43,元大-土城學府,2024-06-20,9822
00637L,元大滬深300正2,40,0,40,元大-土城學府,2024-06-20,9822
1721,三晃,40,0,40,元大-土城學府,2024-06-20,9822
2353,宏��,43,6,37,元大-土城學府,2024-06-20,9822
00675L,富邦臺灣加權正2,37,0,37,元大-土城學府,2024-06-20,9822
00919,群益台灣精選高息,229,192,37,元大-土城學府,2024-06-20,9822
3231,緯創,61,25,36,元大-土城學府,2024-06-20,9822
00680L,元大美債20正2,30,0,30,元大-土城學府,2024-06-20,9822
00679B,元大美債20年,33,4,29,元大-土城學府,2024-06-20,9822
3047,訊舟,35,9,26,元大-土城學府,2024-06-20,9822
2312,金寶,30,5,25,元大-土城學府,2024-06-20,9822
2258,鴻華先進-創,24,0,24,元大-土城學府,2024-06-20,9822
2368,金像電,26,2,24,元大-土城學府,2024-06-20,9822
2330,台積電,23,0,23,元大-土城學府,2024-06-20,9822
00905,FT臺灣Smart,25,4,21,元大-土城學府,2024-06-20,9822
2101,南港,21,0,21,元大-土城學府,2024-06-20,9822
2476,鉅祥,21,0,21,元大-土城學府,2024-06-20,9822
00921,兆豐龍頭等權重,20,0,20,元大-土城學府,2024-06-20,9822
9105,泰金寶-DR,25,5,20,元大-土城學府,2024-06-20,9822
00948B,中信優息投資級債,19,0,19,元大-土城學府,2024-06-20,9822
2025,千興,20,1,19,元大-土城學府,2024-06-20,9822
1301,台塑,18,1,17,元大-土城學府,2024-06-20,9822
2610,華航,28,12,16,元大-土城學府,2024-06-20,9822
6505,台塑化,15,0,15,元大-土城學府,2024-06-20,9822
00632R,元大台灣50反1,15,0,15,元大-土城學府,2024-06-20,9822
1802,台玻,17,2,15,元大-土城學府,2024-06-20,9822
00878,國泰永續高股息,47,33,14,元大-土城學府,2024-06-20,9822
6425,易發,14,0,14,元大-土城學府,2024-06-20,9822
2498,宏達電,20,7,13,元大-土城學府,2024-06-20,9822
1514,亞力,35,22,13,元大-土城學府,2024-06-20,9822
00772B,中信高評級公司債,12,0,12,元大-土城學府,2024-06-20,9822
1612,宏泰,12,0,12,元大-土城學府,2024-06-20,9822
1618,合機,37,25,12,元大-土城學府,2024-06-20,9822
6164,華興,12,0,12,元大-土城學府,2024-06-20,9822
00933B,國泰10Y+金融債,11,0,11,元大-土城學府,2024-06-20,9822
4915,致伸,11,0,11,元大-土城學府,2024-06-20,9822
9945,潤泰新,11,0,11,元大-土城學府,2024-06-20,9822
1503,士電,30,19,11,元大-土城學府,2024-06-20,9822
00650L,復華香港正2,10,0,10,元大-土城學府,2024-06-20,9822
1309,台達化,12,2,10,元大-土城學府,2024-06-20,9822
2332,友訊,10,0,10,元大-土城學府,2024-06-20,9822
00940,元大台灣價值高息,615,115,500,元大-土城學府,2024-06-21,9822
00919,群益台灣精選高息,339,130,209,元大-土城學府,2024-06-21,9822
1802,台玻,150,0,150,元大-土城學府,2024-06-21,9822
6173,信昌電,141,0,141,元大-土城學府,2024-06-21,9822
2317,鴻海,128,28,100,元大-土城學府,2024-06-21,9822
1101,台泥,103,6,97,元大-土城學府,2024-06-21,9822
00946,群益科技高息成長,78,0,78,元大-土城學府,2024-06-21,9822
6026,福邦證,70,0,70,元大-土城學府,2024-06-21,9822
00937B,群益ESG投等債20,88,20,68,元大-土城學府,2024-06-21,9822
3312,弘憶股,72,11,61,元大-土城學府,2024-06-21,9822
00665L,富邦�琤肭磪囓�2,33,0,33,元大-土城學府,2024-06-21,9822
2031,新光鋼,35,2,33,元大-土城學府,2024-06-21,9822
3580,友威科,31,0,31,元大-土城學府,2024-06-21,9822
00637L,元大滬深300正2,40,10,30,元大-土城學府,2024-06-21,9822
2101,南港,33,3,30,元大-土城學府,2024-06-21,9822
00936,台新永續高息中小,29,0,29,元大-土城學府,2024-06-21,9822
1522,堤維西,27,0,27,元大-土城學府,2024-06-21,9822
2520,冠德,29,2,27,元大-土城學府,2024-06-21,9822
9105,泰金寶-DR,37,12,25,元大-土城學府,2024-06-21,9822
6177,達麗,25,1,24,元大-土城學府,2024-06-21,9822
2025,千興,20,0,20,元大-土城學府,2024-06-21,9822
1301,台塑,20,2,18,元大-土城學府,2024-06-21,9822
6770,力積電,21,4,17,元大-土城學府,2024-06-21,9822
3450,聯鈞,34,18,16,元大-土城學府,2024-06-21,9822
2515,中工,16,0,16,元大-土城學府,2024-06-21,9822
6176,瑞儀,16,0,16,元大-土城學府,2024-06-21,9822
1455,集盛,15,0,15,元大-土城學府,2024-06-21,9822
00907,永豐優息存股,14,0,14,元大-土城學府,2024-06-21,9822
00687B,國泰20年美債,19,6,13,元大-土城學府,2024-06-21,9822
00902,中信電池及儲能,12,0,12,元大-土城學府,2024-06-21,9822
00948B,中信優息投資級債,12,0,12,元大-土城學府,2024-06-21,9822
6216,居易,14,2,12,元大-土城學府,2024-06-21,9822
1309,台達化,15,3,12,元大-土城學府,2024-06-21,9822
1326,台化,12,0,12,元大-土城學府,2024-06-21,9822
6425,易發,12,0,12,元大-土城學府,2024-06-21,9822
2382,廣達,22,10,12,元大-土城學府,2024-06-21,9822
2492,華新科,14,3,11,元大-土城學府,2024-06-21,9822
00632R,元大台灣50反1,30,20,10,元大-土城學府,2024-06-21,9822
3483,力致,14,4,10,元大-土城學府,2024-06-21,9822
00669R,國泰美國道瓊反1,10,0,10,元大-土城學府,2024-06-21,9822
00688L,國泰20年美債正2,10,0,10,元大-土城學府,2024-06-21,9822
00680L,元大美債20正2,15,5,10,元大-土城學府,2024-06-21,9822
1219,福壽,10,0,10,元大-土城學府,2024-06-21,9822
1529,樂事綠能,13,3,10,元大-土城學府,2024-06-21,9822
2258,鴻華先進-創,10,0,10,元大-土城學府,2024-06-21,9822
2611,志信,10,0,10,元大-土城學府,2024-06-21,9822
8059,凱碩,10,0,10,元大-土城學府,2024-06-21,9822
3033,威健,11,1,10,元大-土城學府,2024-06-21,9822
2603,長榮,26,17,9,元大-土城學府,2024-06-21,9822
00947,台新臺灣IC設計,9,0,9,元大-土城學府,2024-06-21,9822
3481,群創,274,127,147,元大-土城學府,2024-06-24,9822
00919,群益台灣精選高息,192,60,132,元大-土城學府,2024-06-24,9822
1785,光洋科,149,23,126,元大-土城學府,2024-06-24,9822
00929,復華台灣科技優息,153,48,105,元大-土城學府,2024-06-24,9822
00937B,群益ESG投等債20,84,4,80,元大-土城學府,2024-06-24,9822
1802,台玻,66,0,66,元大-土城學府,2024-06-24,9822
6026,福邦證,60,0,60,元大-土城學府,2024-06-24,9822
2888,新光金,62,5,57,元大-土城學府,2024-06-24,9822
00940,元大台灣價值高息,203,157,46,元大-土城學府,2024-06-24,9822
2610,華航,60,14,46,元大-土城學府,2024-06-24,9822
8358,金居,45,0,45,元大-土城學府,2024-06-24,9822
00936,台新永續高息中小,47,2,45,元大-土城學府,2024-06-24,9822
3062,建漢,101,57,44,元大-土城學府,2024-06-24,9822
00907,永豐優息存股,50,15,35,元大-土城學府,2024-06-24,9822
3231,緯創,38,4,34,元大-土城學府,2024-06-24,9822
2317,鴻海,57,25,32,元大-土城學府,2024-06-24,9822
00676R,富邦臺灣加權反1,31,0,31,元大-土城學府,2024-06-24,9822
4977,眾達-KY,32,2,30,元大-土城學府,2024-06-24,9822
1449,佳和,31,2,29,元大-土城學府,2024-06-24,9822
2330,台積電,30,2,28,元大-土城學府,2024-06-24,9822
3047,訊舟,46,21,25,元大-土城學府,2024-06-24,9822
2353,宏��,29,5,24,元大-土城學府,2024-06-24,9822
00632R,元大台灣50反1,35,13,22,元大-土城學府,2024-06-24,9822
1522,堤維西,23,1,22,元大-土城學府,2024-06-24,9822
1504,東元,22,0,22,元大-土城學府,2024-06-24,9822
00918,大華優利高填息30,47,27,20,元大-土城學府,2024-06-24,9822
6290,良維,28,8,20,元大-土城學府,2024-06-24,9822
1463,強盛新,20,0,20,元大-土城學府,2024-06-24,9822
2034,允強,20,0,20,元大-土城學府,2024-06-24,9822
2369,菱生,22,3,19,元大-土城學府,2024-06-24,9822
3580,友威科,20,1,19,元大-土城學府,2024-06-24,9822
6213,聯茂,19,0,19,元大-土城學府,2024-06-24,9822
00946,群益科技高息成長,18,0,18,元大-土城學府,2024-06-24,9822
2409,友達,24,6,18,元大-土城學府,2024-06-24,9822
2615,萬海,56,39,17,元大-土城學府,2024-06-24,9822
3105,穩懋,18,2,16,元大-土城學府,2024-06-24,9822
2101,南港,15,0,15,元大-土城學府,2024-06-24,9822
2340,台亞,17,2,15,元大-土城學府,2024-06-24,9822
2607,榮運,15,0,15,元大-土城學府,2024-06-24,9822
2382,廣達,26,11,15,元大-土城學府,2024-06-24,9822
00923,群益台ESG低碳50,23,9,14,元大-土城學府,2024-06-24,9822
2025,千興,14,0,14,元大-土城學府,2024-06-24,9822
2312,金寶,16,2,14,元大-土城學府,2024-06-24,9822
3033,威健,14,0,14,元大-土城學府,2024-06-24,9822
2634,漢翔,15,2,13,元大-土城學府,2024-06-24,9822
2611,志信,12,0,12,元大-土城學府,2024-06-24,9822
1319,東陽,12,0,12,元大-土城學府,2024-06-24,9822
5328,華容,14,3,11,元大-土城學府,2024-06-24,9822
00712,復華富時不動產,11,0,11,元大-土城學府,2024-06-24,9822
3013,晟銘電,46,35,11,元大-土城學府,2024-06-24,9822
3481,群創,181,38,143,元大-土城學府,2024-06-25,9822
00753L,中信中國50正2,116,0,116,元大-土城學府,2024-06-25,9822
00919,群益台灣精選高息,94,29,65,元大-土城學府,2024-06-25,9822
3535,晶彩科,59,3,56,元大-土城學府,2024-06-25,9822
1514,亞力,70,17,53,元大-土城學府,2024-06-25,9822
00637L,元大滬深300正2,40,0,40,元大-土城學府,2024-06-25,9822
00632R,元大台灣50反1,212,178,34,元大-土城學府,2024-06-25,9822
4532,瑞智,42,9,33,元大-土城學府,2024-06-25,9822
2317,鴻海,58,26,32,元大-土城學府,2024-06-25,9822
2409,友達,36,4,32,元大-土城學府,2024-06-25,9822
2472,立隆電,31,0,31,元大-土城學府,2024-06-25,9822
3231,緯創,39,10,29,元大-土城學府,2024-06-25,9822
00940,元大台灣價值高息,168,140,28,元大-土城學府,2024-06-25,9822
2208,台船,27,0,27,元大-土城學府,2024-06-25,9822
00936,台新永續高息中小,26,0,26,元大-土城學府,2024-06-25,9822
00929,復華台灣科技優息,91,66,25,元大-土城學府,2024-06-25,9822
1815,富喬,33,10,23,元大-土城學府,2024-06-25,9822
3037,欣興,32,11,21,元大-土城學府,2024-06-25,9822
2610,華航,28,8,20,元大-土城學府,2024-06-25,9822
2303,聯電,33,14,19,元大-土城學府,2024-06-25,9822
2312,金寶,21,3,18,元大-土城學府,2024-06-25,9822
8044,網家,19,1,18,元大-土城學府,2024-06-25,9822
00733,富邦臺灣中小,18,0,18,元大-土城學府,2024-06-25,9822
5213,亞昕,17,0,17,元大-土城學府,2024-06-25,9822
6244,茂迪,18,1,17,元大-土城學府,2024-06-25,9822
1301,台塑,16,1,15,元大-土城學府,2024-06-25,9822
3580,友威科,19,4,15,元大-土城學府,2024-06-25,9822
00687B,國泰20年美債,20,5,15,元大-土城學府,2024-06-25,9822
3714,富采,15,0,15,元大-土城學府,2024-06-25,9822
1463,強盛新,15,2,13,元大-土城學府,2024-06-25,9822
1326,台化,12,0,12,元大-土城學府,2024-06-25,9822
1802,台玻,13,1,12,元大-土城學府,2024-06-25,9822
4956,光鋐,12,0,12,元大-土城學府,2024-06-25,9822
5009,榮剛,13,2,11,元大-土城學府,2024-06-25,9822
00713,元大台灣高息低波,11,0,11,元大-土城學府,2024-06-25,9822
3548,兆利,11,0,11,元大-土城學府,2024-06-25,9822
2002,中鋼,10,0,10,元大-土城學府,2024-06-25,9822
2882,國泰金,10,0,10,元大-土城學府,2024-06-25,9822
00720B,元大投資級公司債,10,0,10,元大-土城學府,2024-06-25,9822
00947,台新臺灣IC設計,10,0,10,元大-土城學府,2024-06-25,9822
1227,佳格,10,0,10,元大-土城學府,2024-06-25,9822
6163,華電網,10,0,10,元大-土城學府,2024-06-25,9822
911868,同方友友-DR,10,0,10,元大-土城學府,2024-06-25,9822
2881,富邦金,10,0,10,元大-土城學府,2024-06-25,9822
2641,正德,9,0,9,元大-土城學府,2024-06-25,9822
5328,華容,9,0,9,元大-土城學府,2024-06-25,9822
2382,廣達,18,10,8,元大-土城學府,2024-06-25,9822
00915,凱基優選高股息30,8,0,8,元大-土城學府,2024-06-25,9822
6834,天二科技,12,4,8,元大-土城學府,2024-06-25,9822
2367,燿華,19,11,8,元大-土城學府,2024-06-25,9822
2609,陽明,209,49,160,元大-土城學府,2024-06-26,9822
00680L,元大美債20正2,115,0,115,元大-土城學府,2024-06-26,9822
00881,國泰台灣5G+,105,0,105,元大-土城學府,2024-06-26,9822
0056,元大高股息,80,1,79,元大-土城學府,2024-06-26,9822
00940,元大台灣價值高息,89,24,65,元大-土城學府,2024-06-26,9822
00937B,群益ESG投等債20,57,0,57,元大-土城學府,2024-06-26,9822
8358,金居,61,4,57,元大-土城學府,2024-06-26,9822
00923,群益台ESG低碳50,55,0,55,元大-土城學府,2024-06-26,9822
3622,洋華,47,0,47,元大-土城學府,2024-06-26,9822
2885,元大金,52,11,41,元大-土城學府,2024-06-26,9822
00679B,元大美債20年,47,10,37,元大-土城學府,2024-06-26,9822
2353,宏��,38,7,31,元大-土城學府,2024-06-26,9822
2409,友達,34,4,30,元大-土城學府,2024-06-26,9822
1802,台玻,30,1,29,元大-土城學府,2024-06-26,9822
1815,富喬,30,2,28,元大-土城學府,2024-06-26,9822
1618,合機,23,0,23,元大-土城學府,2024-06-26,9822
3630,新鉅科,22,0,22,元大-土城學府,2024-06-26,9822
6788,華景電,21,0,21,元大-土城學府,2024-06-26,9822
2838,聯邦銀,20,0,20,元大-土城學府,2024-06-26,9822
2888,新光金,20,0,20,元大-土城學府,2024-06-26,9822
5009,榮剛,21,2,19,元大-土城學府,2024-06-26,9822
2884,玉山金,20,1,19,元大-土城學府,2024-06-26,9822
2002,中鋼,18,0,18,元大-土城學府,2024-06-26,9822
00919,群益台灣精選高息,35,17,18,元大-土城學府,2024-06-26,9822
1220,台榮,17,0,17,元大-土城學府,2024-06-26,9822
00878,國泰永續高股息,19,2,17,元大-土城學府,2024-06-26,9822
1785,光洋科,42,26,16,元大-土城學府,2024-06-26,9822
4532,瑞智,22,6,16,元大-土城學府,2024-06-26,9822
00929,復華台灣科技優息,29,13,16,元大-土城學府,2024-06-26,9822
6271,同欣電,15,0,15,元大-土城學府,2024-06-26,9822
3231,緯創,17,3,14,元大-土城學府,2024-06-26,9822
00946,群益科技高息成長,13,0,13,元大-土城學府,2024-06-26,9822
1609,大亞,38,25,13,元大-土城學府,2024-06-26,9822
2515,中工,13,0,13,元大-土城學府,2024-06-26,9822
00907,永豐優息存股,12,0,12,元大-土城學府,2024-06-26,9822
2603,長榮,16,4,12,元大-土城學府,2024-06-26,9822
2344,華邦電,11,0,11,元大-土城學府,2024-06-26,9822
4760,勤凱,11,0,11,元大-土城學府,2024-06-26,9822
3548,兆利,12,1,11,元大-土城學府,2024-06-26,9822
3624,光頡,12,1,11,元大-土城學府,2024-06-26,9822
5351,鈺創,11,0,11,元大-土城學府,2024-06-26,9822
9105,泰金寶-DR,32,21,11,元大-土城學府,2024-06-26,9822
2374,佳能,12,1,11,元大-土城學府,2024-06-26,9822
00753L,中信中國50正2,10,0,10,元大-土城學府,2024-06-26,9822
2101,南港,13,3,10,元大-土城學府,2024-06-26,9822
2371,大同,16,6,10,元大-土城學府,2024-06-26,9822
3686,達能,10,0,10,元大-土城學府,2024-06-26,9822
1301,台塑,10,0,10,元大-土城學府,2024-06-26,9822
9945,潤泰新,9,0,9,元大-土城學府,2024-06-26,9822
3163,波若威,24,15,9,元大-土城學府,2024-06-26,9822
00680L,元大美債20正2,129,0,129,元大-土城學府,2024-06-27,9822
00679B,元大美債20年,110,2,108,元大-土城學府,2024-06-27,9822
2641,正德,80,0,80,元大-土城學府,2024-06-27,9822
2885,元大金,71,0,71,元大-土城學府,2024-06-27,9822
00937B,群益ESG投等債20,68,7,61,元大-土城學府,2024-06-27,9822
00687B,國泰20年美債,60,0,60,元大-土城學府,2024-06-27,9822
1514,亞力,76,16,60,元大-土城學府,2024-06-27,9822
00929,復華台灣科技優息,54,4,50,元大-土城學府,2024-06-27,9822
00882,中信中國高股息,55,5,50,元大-土城學府,2024-06-27,9822
00753L,中信中國50正2,47,0,47,元大-土城學府,2024-06-27,9822
2317,鴻海,74,28,46,元大-土城學府,2024-06-27,9822
00751B,元大AAA至A公司債,41,0,41,元大-土城學府,2024-06-27,9822
3047,訊舟,92,57,35,元大-土城學府,2024-06-27,9822
6116,彩晶,31,0,31,元大-土城學府,2024-06-27,9822
911622,泰聚亨-DR,30,0,30,元大-土城學府,2024-06-27,9822
00688L,國泰20年美債正2,29,0,29,元大-土城學府,2024-06-27,9822
3013,晟銘電,40,14,26,元大-土城學府,2024-06-27,9822
6257,矽格,26,0,26,元大-土城學府,2024-06-27,9822
00919,群益台灣精選高息,54,28,26,元大-土城學府,2024-06-27,9822
00946,群益科技高息成長,25,0,25,元大-土城學府,2024-06-27,9822
6753,龍德造船,31,6,25,元大-土城學府,2024-06-27,9822
3481,群創,31,7,24,元大-土城學府,2024-06-27,9822
8076,伍豐,31,8,23,元大-土城學府,2024-06-27,9822
6538,倉和,22,0,22,元大-土城學府,2024-06-27,9822
00936,台新永續高息中小,21,0,21,元大-土城學府,2024-06-27,9822
2883,凱基金,35,14,21,元大-土城學府,2024-06-27,9822
00948B,中信優息投資級債,21,0,21,元大-土城學府,2024-06-27,9822
2402,毅嘉,21,0,21,元大-土城學府,2024-06-27,9822
00942B,台新美A公司債20+,20,0,20,元大-土城學府,2024-06-27,9822
8358,金居,52,33,19,元大-土城學府,2024-06-27,9822
8096,擎亞,18,0,18,元大-土城學府,2024-06-27,9822
00939,統一台灣高息動能,18,0,18,元大-土城學府,2024-06-27,9822
3691,碩禾,25,7,18,元大-土城學府,2024-06-27,9822
00713,元大台灣高息低波,18,0,18,元大-土城學府,2024-06-27,9822
2337,旺宏,18,1,17,元大-土城學府,2024-06-27,9822
00941,中信上游半導體,20,3,17,元大-土城學府,2024-06-27,9822
2897,王道銀行,17,0,17,元大-土城學府,2024-06-27,9822
1609,大亞,37,21,16,元大-土城學府,2024-06-27,9822
2498,宏達電,16,0,16,元大-土城學府,2024-06-27,9822
2515,中工,19,3,16,元大-土城學府,2024-06-27,9822
1809,中釉,22,7,15,元大-土城學府,2024-06-27,9822
2327,國巨,15,0,15,元大-土城學府,2024-06-27,9822
6244,茂迪,27,12,15,元大-土城學府,2024-06-27,9822
00918,大華優利高填息30,14,0,14,元大-土城學府,2024-06-27,9822
00931B,統一美債20年,14,0,14,元大-土城學府,2024-06-27,9822
9934,成霖,14,0,14,元大-土城學府,2024-06-27,9822
2611,志信,13,0,13,元大-土城學府,2024-06-27,9822
4167,松瑞藥,18,6,12,元大-土城學府,2024-06-27,9822
1319,東陽,12,0,12,元大-土城學府,2024-06-27,9822
2382,廣達,18,6,12,元大-土城學府,2024-06-27,9822
00929,復華台灣科技優息,151,3,148,元大-土城學府,2024-06-28,9822
2002,中鋼,102,1,101,元大-土城學府,2024-06-28,9822
4906,正文,57,8,49,元大-土城學府,2024-06-28,9822
2610,華航,57,10,47,元大-土城學府,2024-06-28,9822
00679B,元大美債20年,64,30,34,元大-土城學府,2024-06-28,9822
2406,國碩,73,42,31,元大-土城學府,2024-06-28,9822
3312,弘憶股,80,52,28,元大-土城學府,2024-06-28,9822
00936,台新永續高息中小,27,0,27,元大-土城學府,2024-06-28,9822
3050,鈺德,29,3,26,元大-土城學府,2024-06-28,9822
6284,佳邦,25,0,25,元大-土城學府,2024-06-28,9822
00687B,國泰20年美債,21,0,21,元大-土城學府,2024-06-28,9822
00939,統一台灣高息動能,21,0,21,元大-土城學府,2024-06-28,9822
2331,精英,22,1,21,元大-土城學府,2024-06-28,9822
2618,長榮航,50,30,20,元大-土城學府,2024-06-28,9822
2328,廣宇,24,4,20,元大-土城學府,2024-06-28,9822
2913,農林,20,0,20,元大-土城學府,2024-06-28,9822
6226,光鼎,20,0,20,元大-土城學府,2024-06-28,9822
2303,聯電,26,7,19,元大-土城學府,2024-06-28,9822
1303,南亞,24,5,19,元大-土城學府,2024-06-28,9822
00919,群益台灣精選高息,21,2,19,元大-土城學府,2024-06-28,9822
4977,眾達-KY,18,0,18,元大-土城學府,2024-06-28,9822
6753,龍德造船,27,10,17,元大-土城學府,2024-06-28,9822
6443,元晶,25,8,17,元大-土城學府,2024-06-28,9822
5871,中租-KY,17,1,16,元大-土城學府,2024-06-28,9822
00937B,群益ESG投等債20,78,63,15,元大-土城學府,2024-06-28,9822
3576,聯合再生,46,31,15,元大-土城學府,2024-06-28,9822
3691,碩禾,18,3,15,元大-土城學府,2024-06-28,9822
8104,錸寶,15,1,14,元大-土城學府,2024-06-28,9822
9105,泰金寶-DR,20,6,14,元大-土城學府,2024-06-28,9822
2883,凱基金,15,1,14,元大-土城學府,2024-06-28,9822
2722,夏都,13,0,13,元大-土城學府,2024-06-28,9822
8440,綠電,13,0,13,元大-土城學府,2024-06-28,9822
1101,台泥,15,2,13,元大-土城學府,2024-06-28,9822
8927,北基,12,0,12,元大-土城學府,2024-06-28,9822
00680L,元大美債20正2,13,2,11,元大-土城學府,2024-06-28,9822
00712,復華富時不動產,11,0,11,元大-土城學府,2024-06-28,9822
4533,協易機,12,1,11,元大-土城學府,2024-06-28,9822
00915,凱基優選高股息30,10,0,10,元大-土城學府,2024-06-28,9822
2201,裕隆,10,0,10,元大-土城學府,2024-06-28,9822
00772B,中信高評級公司債,10,0,10,元大-土城學府,2024-06-28,9822
1455,集盛,10,0,10,元大-土城學府,2024-06-28,9822
1618,合機,11,1,10,元大-土城學府,2024-06-28,9822
2337,旺宏,23,14,9,元大-土城學府,2024-06-28,9822
2427,三商電,15,6,9,元大-土城學府,2024-06-28,9822
4919,新唐,13,4,9,元大-土城學府,2024-06-28,9822
8071,能率網通,9,0,9,元大-土城學府,2024-06-28,9822
2449,京元電子,13,4,9,元大-土城學府,2024-06-28,9822
9958,世紀鋼,37,28,9,元大-土城學府,2024-06-28,9822
00751B,元大AAA至A公司債,8,0,8,元大-土城學府,2024-06-28,9822
2101,南港,18,10,8,元大-土城學府,2024-06-28,9822
00679B,元大美債20年,233,3,230,元大-土城學府,2024-07-01,9822
2014,中鴻,203,0,203,元大-土城學府,2024-07-01,9822
00937B,群益ESG投等債20,198,2,196,元大-土城學府,2024-07-01,9822
00687B,國泰20年美債,102,4,98,元大-土城學府,2024-07-01,9822
2313,華通,78,0,78,元大-土城學府,2024-07-01,9822
00929,復華台灣科技優息,81,9,72,元大-土城學府,2024-07-01,9822
0056,元大高股息,75,4,71,元大-土城學府,2024-07-01,9822
6753,龍德造船,91,27,64,元大-土城學府,2024-07-01,9822
00671R,富邦NASDAQ反1,50,0,50,元大-土城學府,2024-07-01,9822
2883,凱基金,77,28,49,元大-土城學府,2024-07-01,9822
2374,佳能,99,51,48,元大-土城學府,2024-07-01,9822
8234,新漢,46,2,44,元大-土城學府,2024-07-01,9822
3013,晟銘電,50,10,40,元大-土城學府,2024-07-01,9822
00948B,中信優息投資級債,35,0,35,元大-土城學府,2024-07-01,9822
3481,群創,45,10,35,元大-土城學府,2024-07-01,9822
00680L,元大美債20正2,26,0,26,元大-土城學府,2024-07-01,9822
00688L,國泰20年美債正2,26,0,26,元大-土城學府,2024-07-01,9822
00946,群益科技高息成長,23,0,23,元大-土城學府,2024-07-01,9822
00632R,元大台灣50反1,22,0,22,元大-土城學府,2024-07-01,9822
00882,中信中國高股息,22,0,22,元大-土城學府,2024-07-01,9822
2101,南港,21,0,21,元大-土城學府,2024-07-01,9822
8071,能率網通,21,0,21,元大-土城學府,2024-07-01,9822
8096,擎亞,23,3,20,元大-土城學府,2024-07-01,9822
4906,正文,20,1,19,元大-土城學府,2024-07-01,9822
2337,旺宏,20,2,18,元大-土城學府,2024-07-01,9822
2888,新光金,27,9,18,元大-土城學府,2024-07-01,9822
8027,鈦昇,19,2,17,元大-土城學府,2024-07-01,9822
2317,鴻海,25,9,16,元大-土城學府,2024-07-01,9822
00772B,中信高評級公司債,16,0,16,元大-土城學府,2024-07-01,9822
2002,中鋼,17,1,16,元大-土城學府,2024-07-01,9822
5230,雷笛克光學,19,3,16,元大-土城學府,2024-07-01,9822
3622,洋華,18,2,16,元大-土城學府,2024-07-01,9822
00720B,元大投資級公司債,15,0,15,元大-土城學府,2024-07-01,9822
3703,欣陸,15,0,15,元大-土城學府,2024-07-01,9822
2352,佳世達,17,3,14,元大-土城學府,2024-07-01,9822
00942B,台新美A公司債20+,13,0,13,元大-土城學府,2024-07-01,9822
2031,新光鋼,15,2,13,元大-土城學府,2024-07-01,9822
8104,錸寶,16,3,13,元大-土城學府,2024-07-01,9822
6895,宏碩系統,12,0,12,元大-土城學府,2024-07-01,9822
1303,南亞,13,2,11,元大-土城學府,2024-07-01,9822
2365,昆盈,90,79,11,元大-土城學府,2024-07-01,9822
3202,樺晟,16,5,11,元大-土城學府,2024-07-01,9822
00933B,國泰10Y+金融債,10,0,10,元大-土城學府,2024-07-01,9822
5351,鈺創,11,1,10,元大-土城學府,2024-07-01,9822
00665L,富邦�琤肭磪囓�2,10,0,10,元大-土城學府,2024-07-01,9822
1234,黑松,10,0,10,元大-土城學府,2024-07-01,9822
2402,毅嘉,12,2,10,元大-土城學府,2024-07-01,9822
2414,精技,12,2,10,元大-土城學府,2024-07-01,9822
2753,八方雲集,10,0,10,元大-土城學府,2024-07-01,9822
3005,神基,12,2,10,元大-土城學府,2024-07-01,9822
00929,復華台灣科技優息,266,70,196,元大-土城學府,2024-07-02,9822
5347,世界,142,9,133,元大-土城學府,2024-07-02,9822
2303,聯電,151,24,127,元大-土城學府,2024-07-02,9822
00687B,國泰20年美債,93,0,93,元大-土城學府,2024-07-02,9822
00937B,群益ESG投等債20,66,7,59,元大-土城學府,2024-07-02,9822
8089,康全電訊,59,1,58,元大-土城學府,2024-07-02,9822
00936,台新永續高息中小,62,5,57,元大-土城學府,2024-07-02,9822
5243,乙盛-KY,59,5,54,元大-土城學府,2024-07-02,9822
1806,冠軍,50,0,50,元大-土城學府,2024-07-02,9822
00679B,元大美債20年,45,0,45,元大-土城學府,2024-07-02,9822
00940,元大台灣價值高息,108,70,38,元大-土城學府,2024-07-02,9822
0056,元大高股息,40,5,35,元大-土城學府,2024-07-02,9822
00948B,中信優息投資級債,34,0,34,元大-土城學府,2024-07-02,9822
6538,倉和,35,2,33,元大-土城學府,2024-07-02,9822
00934,中信成長高股息,79,47,32,元大-土城學府,2024-07-02,9822
00680L,元大美債20正2,30,0,30,元大-土城學府,2024-07-02,9822
1309,台達化,29,0,29,元大-土城學府,2024-07-02,9822
2317,鴻海,132,103,29,元大-土城學府,2024-07-02,9822
9105,泰金寶-DR,63,35,28,元大-土城學府,2024-07-02,9822
00688L,國泰20年美債正2,27,0,27,元大-土城學府,2024-07-02,9822
2365,昆盈,53,27,26,元大-土城學府,2024-07-02,9822
00946,群益科技高息成長,28,2,26,元大-土城學府,2024-07-02,9822
2349,錸德,79,53,26,元大-土城學府,2024-07-02,9822
00927,群益半導體收益,24,0,24,元大-土城學府,2024-07-02,9822
6152,百一,25,1,24,元大-土城學府,2024-07-02,9822
8926,台汽電,24,0,24,元大-土城學府,2024-07-02,9822
3535,晶彩科,63,40,23,元大-土城學府,2024-07-02,9822
2605,新興,29,6,23,元大-土城學府,2024-07-02,9822
3481,群創,35,13,22,元大-土城學府,2024-07-02,9822
6757,台灣虎航,22,0,22,元大-土城學府,2024-07-02,9822
4714,永捷,33,14,19,元大-土城學府,2024-07-02,9822
2449,京元電子,22,4,18,元大-土城學府,2024-07-02,9822
8044,網家,18,0,18,元大-土城學府,2024-07-02,9822
00673R,期元大S＆P原油反1,17,0,17,元大-土城學府,2024-07-02,9822
3402,漢科,21,4,17,元大-土城學府,2024-07-02,9822
6285,啟��,18,1,17,元大-土城學府,2024-07-02,9822
8112,至上,17,1,16,元大-土城學府,2024-07-02,9822
00751B,元大AAA至A公司債,15,0,15,元大-土城學府,2024-07-02,9822
2883,凱基金,15,1,14,元大-土城學府,2024-07-02,9822
0050,元大台灣50,13,0,13,元大-土城學府,2024-07-02,9822
2392,正崴,23,10,13,元大-土城學府,2024-07-02,9822
8096,擎亞,16,3,13,元大-土城學府,2024-07-02,9822
2455,全新,12,0,12,元大-土城學府,2024-07-02,9822
1587,吉茂,13,1,12,元大-土城學府,2024-07-02,9822
2834,臺企銀,11,0,11,元大-土城學府,2024-07-02,9822
2388,威盛,11,0,11,元大-土城學府,2024-07-02,9822
2489,瑞軒,18,7,11,元大-土城學府,2024-07-02,9822
3260,威剛,11,0,11,元大-土城學府,2024-07-02,9822
6139,亞翔,23,12,11,元大-土城學府,2024-07-02,9822
2353,宏��,13,3,10,元大-土城學府,2024-07-02,9822
2888,新光金,811,45,766,元大-土城學府,2024-07-03,9822
2317,鴻海,155,31,124,元大-土城學府,2024-07-03,9822
2405,輔信,122,29,93,元大-土城學府,2024-07-03,9822
9105,泰金寶-DR,86,22,64,元大-土城學府,2024-07-03,9822
3312,弘憶股,59,6,53,元大-土城學府,2024-07-03,9822
00936,台新永續高息中小,51,0,51,元大-土城學府,2024-07-03,9822
8039,台虹,51,1,50,元大-土城學府,2024-07-03,9822
2402,毅嘉,72,26,46,元大-土城學府,2024-07-03,9822
9103,美德醫療-DR,56,11,45,元大-土城學府,2024-07-03,9822
00935,野村臺灣新科技50,44,0,44,元大-土城學府,2024-07-03,9822
2641,正德,160,122,38,元大-土城學府,2024-07-03,9822
00934,中信成長高股息,30,0,30,元大-土城學府,2024-07-03,9822
00940,元大台灣價值高息,95,66,29,元大-土城學府,2024-07-03,9822
6213,聯茂,31,5,26,元大-土城學府,2024-07-03,9822
3189,景碩,27,1,26,元大-土城學府,2024-07-03,9822
00946,群益科技高息成長,25,0,25,元大-土城學府,2024-07-03,9822
00882,中信中國高股息,23,0,23,元大-土城學府,2024-07-03,9822
6788,華景電,22,0,22,元大-土城學府,2024-07-03,9822
6226,光鼎,20,0,20,元大-土城學府,2024-07-03,9822
4906,正文,25,7,18,元大-土城學府,2024-07-03,9822
3047,訊舟,77,60,17,元大-土城學府,2024-07-03,9822
2406,國碩,23,6,17,元大-土城學府,2024-07-03,9822
00664R,國泰臺灣加權反1,17,0,17,元大-土城學府,2024-07-03,9822
2312,金寶,21,5,16,元大-土城學府,2024-07-03,9822
2615,萬海,68,52,16,元大-土城學府,2024-07-03,9822
00927,群益半導體收益,15,0,15,元大-土城學府,2024-07-03,9822
00919,群益台灣精選高息,17,2,15,元大-土城學府,2024-07-03,9822
00680L,元大美債20正2,14,0,14,元大-土城學府,2024-07-03,9822
3027,盛達,18,4,14,元大-土城學府,2024-07-03,9822
6757,台灣虎航,15,1,14,元大-土城學府,2024-07-03,9822
3005,神基,16,3,13,元大-土城學府,2024-07-03,9822
00687B,國泰20年美債,13,0,13,元大-土城學府,2024-07-03,9822
2489,瑞軒,19,6,13,元大-土城學府,2024-07-03,9822
6274,台燿,15,3,12,元大-土城學府,2024-07-03,9822
4167,松瑞藥,11,0,11,元大-土城學府,2024-07-03,9822
5388,中磊,10,0,10,元大-土城學府,2024-07-03,9822
00830,國泰費城半導體,10,0,10,元大-土城學府,2024-07-03,9822
00674R,期元大S＆P黃金反1,10,0,10,元大-土城學府,2024-07-03,9822
1312,國喬,10,0,10,元大-土城學府,2024-07-03,9822
2412,中華電,10,0,10,元大-土城學府,2024-07-03,9822
2838,聯邦銀,10,0,10,元大-土城學府,2024-07-03,9822
8011,台通,10,0,10,元大-土城學府,2024-07-03,9822
8064,東捷,20,10,10,元大-土城學府,2024-07-03,9822
00679B,元大美債20年,18,9,9,元大-土城學府,2024-07-03,9822
00937B,群益ESG投等債20,16,7,9,元大-土城學府,2024-07-03,9822
00948B,中信優息投資級債,16,7,9,元大-土城學府,2024-07-03,9822
1725,元禎,10,1,9,元大-土城學府,2024-07-03,9822
8440,綠電,9,0,9,元大-土城學府,2024-07-03,9822
8096,擎亞,11,3,8,元大-土城學府,2024-07-03,9822
5443,均豪,20,12,8,元大-土城學府,2024-07-03,9822
1409,新纖,268,37,231,元大-土城學府,2024-07-04,9822
00936,台新永續高息中小,104,0,104,元大-土城學府,2024-07-04,9822
6125,廣運,106,7,99,元大-土城學府,2024-07-04,9822
00632R,元大台灣50反1,111,13,98,元大-土城學府,2024-07-04,9822
00929,復華台灣科技優息,112,14,98,元大-土城學府,2024-07-04,9822
3189,景碩,83,1,82,元大-土城學府,2024-07-04,9822
00946,群益科技高息成長,81,2,79,元大-土城學府,2024-07-04,9822
2618,長榮航,109,35,74,元大-土城學府,2024-07-04,9822
3013,晟銘電,99,27,72,元大-土城學府,2024-07-04,9822
2412,中華電,71,7,64,元大-土城學府,2024-07-04,9822
3622,洋華,67,4,63,元大-土城學府,2024-07-04,9822
00881,國泰台灣5G+,53,1,52,元大-土城學府,2024-07-04,9822
2472,立隆電,50,0,50,元大-土城學府,2024-07-04,9822
2609,陽明,55,20,35,元大-土城學府,2024-07-04,9822
8064,東捷,57,23,34,元大-土城學府,2024-07-04,9822
00937B,群益ESG投等債20,76,47,29,元大-土城學府,2024-07-04,9822
3576,聯合再生,55,27,28,元大-土城學府,2024-07-04,9822
00940,元大台灣價值高息,107,82,25,元大-土城學府,2024-07-04,9822
2610,華航,28,4,24,元大-土城學府,2024-07-04,9822
3580,友威科,26,2,24,元大-土城學府,2024-07-04,9822
00680L,元大美債20正2,23,0,23,元大-土城學府,2024-07-04,9822
00927,群益半導體收益,22,0,22,元大-土城學府,2024-07-04,9822
1611,中電,20,0,20,元大-土城學府,2024-07-04,9822
4939,亞電,20,0,20,元大-土城學府,2024-07-04,9822
3037,欣興,23,4,19,元大-土城學府,2024-07-04,9822
3047,訊舟,91,72,19,元大-土城學府,2024-07-04,9822
6142,友勁,19,0,19,元大-土城學府,2024-07-04,9822
00646,元大S＆P500,16,0,16,元大-土城學府,2024-07-04,9822
3363,上詮,17,1,16,元大-土城學府,2024-07-04,9822
5426,振發,16,0,16,元大-土城學府,2024-07-04,9822
6284,佳邦,16,0,16,元大-土城學府,2024-07-04,9822
00719B,元大美債1-3,15,0,15,元大-土城學府,2024-07-04,9822
1314,中石化,48,33,15,元大-土城學府,2024-07-04,9822
2323,中環,18,3,15,元大-土城學府,2024-07-04,9822
6197,佳必琪,16,1,15,元大-土城學府,2024-07-04,9822
6226,光鼎,15,0,15,元大-土城學府,2024-07-04,9822
2359,所羅門,43,28,15,元大-土城學府,2024-07-04,9822
2495,普安,35,21,14,元大-土城學府,2024-07-04,9822
5371,中光電,14,0,14,元大-土城學府,2024-07-04,9822
00830,國泰費城半導體,14,0,14,元大-土城學府,2024-07-04,9822
2353,宏��,20,7,13,元大-土城學府,2024-07-04,9822
9105,泰金寶-DR,31,18,13,元大-土城學府,2024-07-04,9822
2603,長榮,12,0,12,元大-土城學府,2024-07-04,9822
3059,華晶科,13,1,12,元大-土城學府,2024-07-04,9822
2344,華邦電,14,3,11,元大-土城學府,2024-07-04,9822
1536,和大,11,0,11,元大-土城學府,2024-07-04,9822
00763U,期街口道瓊銅,10,0,10,元大-土城學府,2024-07-04,9822
6127,九豪,14,4,10,元大-土城學府,2024-07-04,9822
6264,富裔,10,0,10,元大-土城學府,2024-07-04,9822
4109,加捷生醫,20,11,9,元大-土城學府,2024-07-04,9822
00939,統一台灣高息動能,411,137,274,元大-土城學府,2024-07-05,9822
00679B,元大美債20年,235,2,233,元大-土城學府,2024-07-05,9822
3535,晶彩科,89,10,79,元大-土城學府,2024-07-05,9822
6257,矽格,60,5,55,元大-土城學府,2024-07-05,9822
2618,長榮航,52,6,46,元大-土城學府,2024-07-05,9822
00881,國泰台灣5G+,48,5,43,元大-土城學府,2024-07-05,9822
2356,英業達,105,67,38,元大-土城學府,2024-07-05,9822
00929,復華台灣科技優息,51,14,37,元大-土城學府,2024-07-05,9822
3312,弘憶股,44,7,37,元大-土城學府,2024-07-05,9822
2615,萬海,40,6,34,元大-土城學府,2024-07-05,9822
3576,聯合再生,56,22,34,元大-土城學府,2024-07-05,9822
8163,達方,35,1,34,元大-土城學府,2024-07-05,9822
00934,中信成長高股息,32,0,32,元大-土城學府,2024-07-05,9822
00937B,群益ESG投等債20,27,0,27,元大-土城學府,2024-07-05,9822
3481,群創,54,28,26,元大-土城學府,2024-07-05,9822
9907,統一實,26,0,26,元大-土城學府,2024-07-05,9822
2610,華航,41,17,24,元大-土城學府,2024-07-05,9822
00687B,國泰20年美債,20,0,20,元大-土城學府,2024-07-05,9822
2855,統一證,20,0,20,元大-土城學府,2024-07-05,9822
8039,台虹,21,1,20,元大-土城學府,2024-07-05,9822
2367,燿華,49,32,17,元大-土城學府,2024-07-05,9822
1618,合機,18,2,16,元大-土城學府,2024-07-05,9822
2365,昆盈,41,25,16,元大-土城學府,2024-07-05,9822
6139,亞翔,19,3,16,元大-土城學府,2024-07-05,9822
2317,鴻海,24,9,15,元大-土城學府,2024-07-05,9822
2349,錸德,19,4,15,元大-土城學府,2024-07-05,9822
2867,三商壽,16,1,15,元大-土城學府,2024-07-05,9822
1609,大亞,26,11,15,元大-土城學府,2024-07-05,9822
1504,東元,21,6,15,元大-土城學府,2024-07-05,9822
8104,錸寶,29,15,14,元大-土城學府,2024-07-05,9822
6120,達運,18,4,14,元大-土城學府,2024-07-05,9822
2883,凱基金,21,7,14,元大-土城學府,2024-07-05,9822
3402,漢科,13,0,13,元大-土城學府,2024-07-05,9822
5864,致和證,13,0,13,元大-土城學府,2024-07-05,9822
8926,台汽電,15,2,13,元大-土城學府,2024-07-05,9822
00882,中信中國高股息,12,0,12,元大-土城學府,2024-07-05,9822
6209,今國光,15,4,11,元大-土城學府,2024-07-05,9822
6244,茂迪,17,6,11,元大-土城學府,2024-07-05,9822
2301,光寶科,14,3,11,元大-土城學府,2024-07-05,9822
3005,神基,12,2,10,元大-土城學府,2024-07-05,9822
1802,台玻,17,7,10,元大-土城學府,2024-07-05,9822
2801,彰銀,10,0,10,元大-土城學府,2024-07-05,9822
3540,曜越,10,0,10,元大-土城學府,2024-07-05,9822
4503,金雨,11,1,10,元大-土城學府,2024-07-05,9822
5202,力新,14,4,10,元大-土城學府,2024-07-05,9822
6152,百一,15,5,10,元大-土城學府,2024-07-05,9822
2427,三商電,14,4,10,元大-土城學府,2024-07-05,9822
3374,精材,14,5,9,元大-土城學府,2024-07-05,9822
2303,聯電,26,17,9,元大-土城學府,2024-07-05,9822
1569,濱川,10,1,9,元大-土城學府,2024-07-05,9822
2365,昆盈,426,124,302,元大-土城學府,2024-07-08,9822
0056,元大高股息,166,20,146,元大-土城學府,2024-07-08,9822
00934,中信成長高股息,137,3,134,元大-土城學府,2024-07-08,9822
00882,中信中國高股息,107,0,107,元大-土城學府,2024-07-08,9822
3535,晶彩科,101,12,89,元大-土城學府,2024-07-08,9822
00929,復華台灣科技優息,93,18,75,元大-土城學府,2024-07-08,9822
2641,正德,73,0,73,元大-土城學府,2024-07-08,9822
3402,漢科,60,0,60,元大-土城學府,2024-07-08,9822
5272,笙科,61,1,60,元大-土城學府,2024-07-08,9822
3576,聯合再生,51,1,50,元大-土城學府,2024-07-08,9822
3013,晟銘電,46,0,46,元大-土城學府,2024-07-08,9822
00719B,元大美債1-3,45,0,45,元大-土城學府,2024-07-08,9822
2374,佳能,73,31,42,元大-土城學府,2024-07-08,9822
1785,光洋科,101,60,41,元大-土城學府,2024-07-08,9822
4908,前鼎,39,1,38,元大-土城學府,2024-07-08,9822
1504,東元,34,2,32,元大-土城學府,2024-07-08,9822
6156,松上,32,0,32,元大-土城學府,2024-07-08,9822
2489,瑞軒,43,13,30,元大-土城學府,2024-07-08,9822
3045,台灣大,30,0,30,元大-土城學府,2024-07-08,9822
8926,台汽電,30,1,29,元大-土城學府,2024-07-08,9822
3481,群創,105,76,29,元大-土城學府,2024-07-08,9822
5452,佶優,72,46,26,元大-土城學府,2024-07-08,9822
2609,陽明,87,62,25,元大-土城學府,2024-07-08,9822
8064,東捷,38,12,26,元大-土城學府,2024-07-08,9822
2618,長榮航,31,9,22,元大-土城學府,2024-07-08,9822
2356,英業達,27,5,22,元大-土城學府,2024-07-08,9822
6757,台灣虎航,23,1,22,元大-土城學府,2024-07-08,9822
1718,中纖,21,0,21,元大-土城學府,2024-07-08,9822
3580,友威科,22,1,21,元大-土城學府,2024-07-08,9822
1455,集盛,115,95,20,元大-土城學府,2024-07-08,9822
4526,東台,22,2,20,元大-土城學府,2024-07-08,9822
2344,華邦電,22,4,18,元大-土城學府,2024-07-08,9822
8110,華東,18,0,18,元大-土城學府,2024-07-08,9822
8027,鈦昇,19,2,17,元大-土城學府,2024-07-08,9822
1597,直得,17,0,17,元大-土城學府,2024-07-08,9822
00937B,群益ESG投等債20,19,3,16,元大-土城學府,2024-07-08,9822
00927,群益半導體收益,15,0,15,元大-土城學府,2024-07-08,9822
1618,合機,21,6,15,元大-土城學府,2024-07-08,9822
2402,毅嘉,15,0,15,元大-土城學府,2024-07-08,9822
2477,美隆電,15,0,15,元大-土城學府,2024-07-08,9822
6217,中探針,29,15,14,元大-土城學府,2024-07-08,9822
6443,元晶,29,15,14,元大-土城學府,2024-07-08,9822
2427,三商電,19,6,13,元大-土城學府,2024-07-08,9822
2464,盟立,61,48,13,元大-土城學府,2024-07-08,9822
3622,洋華,13,0,13,元大-土城學府,2024-07-08,9822
8121,越峰,13,0,13,元大-土城學府,2024-07-08,9822
8085,福華,16,4,12,元大-土城學府,2024-07-08,9822
1536,和大,20,8,12,元大-土城學府,2024-07-08,9822
2453,凌群,15,3,12,元大-土城學府,2024-07-08,9822
6188,廣明,15,3,12,元大-土城學府,2024-07-08,9822
00939,統一台灣高息動能,481,47,434,元大-土城學府,2024-07-09,9822
00881,國泰台灣5G+,235,1,234,元大-土城學府,2024-07-09,9822
0056,元大高股息,179,15,164,元大-土城學府,2024-07-09,9822
2312,金寶,180,47,133,元大-土城學府,2024-07-09,9822
00937B,群益ESG投等債20,109,5,104,元大-土城學府,2024-07-09,9822
2367,燿華,130,67,63,元大-土城學府,2024-07-09,9822
5328,華容,67,6,61,元大-土城學府,2024-07-09,9822
2353,宏��,60,7,53,元大-土城學府,2024-07-09,9822
00688L,國泰20年美債正2,45,0,45,元大-土城學府,2024-07-09,9822
1785,光洋科,71,27,44,元大-土城學府,2024-07-09,9822
2609,陽明,58,16,42,元大-土城學府,2024-07-09,9822
6788,華景電,41,0,41,元大-土城學府,2024-07-09,9822
00945B,凱基美國非投等債,40,0,40,元大-土城學府,2024-07-09,9822
3622,洋華,46,9,37,元大-土城學府,2024-07-09,9822
2834,臺企銀,36,0,36,元大-土城學府,2024-07-09,9822
3047,訊舟,69,34,35,元大-土城學府,2024-07-09,9822
2405,輔信,59,25,34,元大-土城學府,2024-07-09,9822
2615,萬海,44,10,34,元大-土城學府,2024-07-09,9822
4533,協易機,45,14,31,元大-土城學府,2024-07-09,9822
8105,凌巨,43,15,28,元大-土城學府,2024-07-09,9822
3062,建漢,26,1,25,元大-土城學府,2024-07-09,9822
2002,中鋼,25,0,25,元大-土城學府,2024-07-09,9822
2449,京元電子,47,25,22,元大-土城學府,2024-07-09,9822
00905,FT臺灣Smart,22,0,22,元大-土城學府,2024-07-09,9822
2618,長榮航,35,15,20,元大-土城學府,2024-07-09,9822
00725B,國泰投資級公司債,20,0,20,元大-土城學府,2024-07-09,9822
1504,東元,23,3,20,元大-土城學府,2024-07-09,9822
2337,旺宏,24,4,20,元大-土城學府,2024-07-09,9822
3402,漢科,20,0,20,元大-土城學府,2024-07-09,9822
9105,泰金寶-DR,108,88,20,元大-土城學府,2024-07-09,9822
2349,錸德,54,35,19,元大-土城學府,2024-07-09,9822
2392,正崴,56,39,17,元大-土城學府,2024-07-09,9822
2363,矽統,23,7,16,元大-土城學府,2024-07-09,9822
2637,慧洋-KY,16,0,16,元大-土城學府,2024-07-09,9822
3481,群創,41,26,15,元大-土城學府,2024-07-09,9822
8096,擎亞,19,4,15,元大-土城學府,2024-07-09,9822
00719B,元大美債1-3,15,0,15,元大-土城學府,2024-07-09,9822
2453,凌群,19,4,15,元大-土城學府,2024-07-09,9822
3050,鈺德,19,4,15,元大-土城學府,2024-07-09,9822
5243,乙盛-KY,19,4,15,元大-土城學府,2024-07-09,9822
3037,欣興,20,5,15,元大-土城學府,2024-07-09,9822
6218,豪勉,15,1,14,元大-土城學府,2024-07-09,9822
8176,智捷,14,0,14,元大-土城學府,2024-07-09,9822
2301,光寶科,13,1,12,元大-土城學府,2024-07-09,9822
00927,群益半導體收益,19,7,12,元大-土城學府,2024-07-09,9822
1314,中石化,13,1,12,元大-土城學府,2024-07-09,9822
1528,恩德,28,16,12,元大-土城學府,2024-07-09,9822
4306,炎洲,12,0,12,元大-土城學府,2024-07-09,9822
4904,遠傳,13,1,12,元大-土城學府,2024-07-09,9822
4908,前鼎,12,0,12,元大-土城學府,2024-07-09,9822
2888,新光金,429,189,240,元大-土城學府,2024-07-10,9822
00679B,元大美債20年,187,8,179,元大-土城學府,2024-07-10,9822
2867,三商壽,173,16,157,元大-土城學府,2024-07-10,9822
00881,國泰台灣5G+,81,0,81,元大-土城學府,2024-07-10,9822
2464,盟立,241,166,75,元大-土城學府,2024-07-10,9822
2367,燿華,80,13,67,元大-土城學府,2024-07-10,9822
00945B,凱基美國非投等債,43,0,43,元大-土城學府,2024-07-10,9822
1618,合機,54,15,39,元大-土城學府,2024-07-10,9822
6757,台灣虎航,36,0,36,元大-土城學府,2024-07-10,9822
2324,仁寶,36,3,33,元大-土城學府,2024-07-10,9822
3041,揚智,33,0,33,元大-土城學府,2024-07-10,9822
2405,輔信,47,18,29,元大-土城學府,2024-07-10,9822
2609,陽明,30,4,26,元大-土城學府,2024-07-10,9822
6117,迎廣,29,5,24,元大-土城學府,2024-07-10,9822
6116,彩晶,23,0,23,元大-土城學府,2024-07-10,9822
2312,金寶,63,40,23,元大-土城學府,2024-07-10,9822
00934,中信成長高股息,26,4,22,元大-土城學府,2024-07-10,9822
2615,萬海,34,12,22,元大-土城學府,2024-07-10,9822
5880,合庫金,30,11,19,元大-土城學府,2024-07-10,9822
2002,中鋼,28,10,18,元大-土城學府,2024-07-10,9822
2317,鴻海,47,30,17,元大-土城學府,2024-07-10,9822
6213,聯茂,21,4,17,元大-土城學府,2024-07-10,9822
8105,凌巨,24,7,17,元大-土城學府,2024-07-10,9822
6139,亞翔,17,1,16,元大-土城學府,2024-07-10,9822
00937B,群益ESG投等債20,17,1,16,元大-土城學府,2024-07-10,9822
1455,集盛,22,6,16,元大-土城學府,2024-07-10,9822
00795B,中信美國公債20年,15,0,15,元大-土城學府,2024-07-10,9822
1532,勤美,15,0,15,元大-土城學府,2024-07-10,9822
2392,正崴,51,37,14,元大-土城學府,2024-07-10,9822
4960,誠美材,14,1,13,元大-土城學府,2024-07-10,9822
5324,士開,13,0,13,元大-土城學府,2024-07-10,9822
1101,台泥,13,0,13,元大-土城學府,2024-07-10,9822
0056,元大高股息,13,1,12,元大-土城學府,2024-07-10,9822
8071,能率網通,25,13,12,元大-土城學府,2024-07-10,9822
2376,技嘉,14,2,12,元大-土城學府,2024-07-10,9822
00918,大華優利高填息30,12,1,11,元大-土城學府,2024-07-10,9822
3313,斐成,12,1,11,元大-土城學府,2024-07-10,9822
00753L,中信中國50正2,11,0,11,元大-土城學府,2024-07-10,9822
5328,華容,15,4,11,元大-土城學府,2024-07-10,9822
6120,達運,11,0,11,元大-土城學府,2024-07-10,9822
2618,長榮航,43,33,10,元大-土城學府,2024-07-10,9822
3374,精材,10,0,10,元大-土城學府,2024-07-10,9822
00719B,元大美債1-3,10,0,10,元大-土城學府,2024-07-10,9822
2390,云辰,10,0,10,元大-土城學府,2024-07-10,9822
2904,匯僑,10,0,10,元大-土城學府,2024-07-10,9822
5876,上海商銀,10,0,10,元大-土城學府,2024-07-10,9822
6209,今國光,10,0,10,元大-土城學府,2024-07-10,9822
6916,華凌,10,0,10,元大-土城學府,2024-07-10,9822
00713,元大台灣高息低波,10,0,10,元大-土城學府,2024-07-10,9822
1616,億泰,20,11,9,元大-土城學府,2024-07-10,9822
0056,元大高股息,386,9,377,元大-土城學府,2024-07-11,9822
2834,臺企銀,372,3,369,元大-土城學府,2024-07-11,9822
1101,台泥,114,1,113,元大-土城學府,2024-07-11,9822
2867,三商壽,124,20,104,元大-土城學府,2024-07-11,9822
2464,盟立,176,105,71,元大-土城學府,2024-07-11,9822
00934,中信成長高股息,67,5,62,元大-土城學府,2024-07-11,9822
00937B,群益ESG投等債20,68,11,57,元大-土城學府,2024-07-11,9822
1618,合機,59,10,49,元大-土城學府,2024-07-11,9822
2317,鴻海,75,30,45,元大-土城學府,2024-07-11,9822
00935,野村臺灣新科技50,43,0,43,元大-土城學府,2024-07-11,9822
2610,華航,41,2,39,元大-土城學府,2024-07-11,9822
6175,立敦,36,1,35,元大-土城學府,2024-07-11,9822
2609,陽明,35,1,34,元大-土城學府,2024-07-11,9822
2615,萬海,50,17,33,元大-土城學府,2024-07-11,9822
6117,迎廣,33,1,32,元大-土城學府,2024-07-11,9822
6757,台灣虎航,30,1,29,元大-土城學府,2024-07-11,9822
00688L,國泰20年美債正2,37,12,25,元大-土城學府,2024-07-11,9822
00719B,元大美債1-3,25,0,25,元大-土城學府,2024-07-11,9822
00725B,國泰投資級公司債,25,1,24,元大-土城學府,2024-07-11,9822
3231,緯創,28,5,23,元大-土城學府,2024-07-11,9822
1609,大亞,22,0,22,元大-土城學府,2024-07-11,9822
3312,弘憶股,41,19,22,元大-土城學府,2024-07-11,9822
2618,長榮航,24,2,22,元大-土城學府,2024-07-11,9822
2408,南亞科,25,3,22,元大-土城學府,2024-07-11,9822
6156,松上,22,3,19,元大-土城學府,2024-07-11,9822
00675L,富邦臺灣加權正2,19,1,18,元大-土城學府,2024-07-11,9822
8234,新漢,17,0,17,元大-土城學府,2024-07-11,9822
2354,鴻準,27,11,16,元大-土城學府,2024-07-11,9822
4562,穎漢,18,2,16,元大-土城學府,2024-07-11,9822
1503,士電,18,2,16,元大-土城學府,2024-07-11,9822
3363,上詮,24,8,16,元大-土城學府,2024-07-11,9822
1504,東元,19,4,15,元大-土城學府,2024-07-11,9822
8064,東捷,28,13,15,元大-土城學府,2024-07-11,9822
00632R,元大台灣50反1,234,220,14,元大-土城學府,2024-07-11,9822
2362,藍天,21,7,14,元大-土城學府,2024-07-11,9822
3706,神達,38,24,14,元大-土城學府,2024-07-11,9822
00713,元大台灣高息低波,14,0,14,元大-土城學府,2024-07-11,9822
3708,上緯投控,14,1,13,元大-土城學府,2024-07-11,9822
1326,台化,13,0,13,元大-土城學府,2024-07-11,9822
00679B,元大美債20年,36,24,12,元大-土城學府,2024-07-11,9822
2331,精英,13,1,12,元大-土城學府,2024-07-11,9822
3202,樺晟,12,0,12,元大-土城學府,2024-07-11,9822
8163,達方,12,0,12,元大-土城學府,2024-07-11,9822
2365,昆盈,72,61,11,元大-土城學府,2024-07-11,9822
2049,上銀,11,0,11,元大-土城學府,2024-07-11,9822
00881,國泰台灣5G+,12,1,11,元大-土城學府,2024-07-11,9822
1785,光洋科,36,25,11,元大-土城學府,2024-07-11,9822
2323,中環,12,1,11,元大-土城學府,2024-07-11,9822
2374,佳能,13,2,11,元大-土城學府,2024-07-11,9822
3060,銘異,17,6,11,元大-土城學府,2024-07-11,9822
00934,中信成長高股息,1139,5,1134,元大-土城學府,2024-07-12,9822
00679B,元大美債20年,302,28,274,元大-土城學府,2024-07-12,9822
2834,臺企銀,269,12,257,元大-土城學府,2024-07-12,9822
9945,潤泰新,220,13,207,元大-土城學府,2024-07-12,9822
00706L,期元大S＆P日圓正2,202,0,202,元大-土城學府,2024-07-12,9822
00929,復華台灣科技優息,273,136,137,元大-土城學府,2024-07-12,9822
00882,中信中國高股息,82,1,81,元大-土城學府,2024-07-12,9822
3535,晶彩科,87,11,76,元大-土城學府,2024-07-12,9822
2867,三商壽,111,37,74,元大-土城學府,2024-07-12,9822
2312,金寶,127,65,62,元大-土城學府,2024-07-12,9822
2303,聯電,68,11,57,元大-土城學府,2024-07-12,9822
2610,華航,75,20,55,元大-土城學府,2024-07-12,9822
8234,新漢,55,0,55,元大-土城學府,2024-07-12,9822
3312,弘憶股,44,1,43,元大-土城學府,2024-07-12,9822
3703,欣陸,40,0,40,元大-土城學府,2024-07-12,9822
00935,野村臺灣新科技50,31,0,31,元大-土城學府,2024-07-12,9822
3016,嘉晶,30,0,30,元大-土城學府,2024-07-12,9822
00725B,國泰投資級公司債,27,0,27,元大-土城學府,2024-07-12,9822
00881,國泰台灣5G+,27,1,26,元大-土城學府,2024-07-12,9822
3047,訊舟,35,11,24,元大-土城學府,2024-07-12,9822
1529,樂事綠能,32,9,23,元大-土城學府,2024-07-12,9822
2206,三陽工業,22,0,22,元大-土城學府,2024-07-12,9822
2317,鴻海,107,85,22,元大-土城學府,2024-07-12,9822
00927,群益半導體收益,51,30,21,元大-土城學府,2024-07-12,9822
1718,中纖,20,0,20,元大-土城學府,2024-07-12,9822
00753L,中信中國50正2,20,0,20,元大-土城學府,2024-07-12,9822
3402,漢科,20,0,20,元大-土城學府,2024-07-12,9822
00632R,元大台灣50反1,34,15,19,元大-土城學府,2024-07-12,9822
3363,上詮,25,7,18,元大-土城學府,2024-07-12,9822
0056,元大高股息,23,4,19,元大-土城學府,2024-07-12,9822
9105,泰金寶-DR,31,13,18,元大-土城學府,2024-07-12,9822
006208,富邦台50,20,2,18,元大-土城學府,2024-07-12,9822
1785,光洋科,20,3,17,元大-土城學府,2024-07-12,9822
2330,台積電,24,8,16,元大-土城學府,2024-07-12,9822
3518,柏騰,16,0,16,元大-土城學府,2024-07-12,9822
3019,亞光,48,32,16,元大-土城學府,2024-07-12,9822
2324,仁寶,15,0,15,元大-土城學府,2024-07-12,9822
6179,亞通,18,3,15,元大-土城學府,2024-07-12,9822
1603,華電,14,1,13,元大-土城學府,2024-07-12,9822
1609,大亞,39,26,13,元大-土城學府,2024-07-12,9822
1536,和大,17,6,11,元大-土城學府,2024-07-12,9822
00939,統一台灣高息動能,13,2,11,元大-土城學府,2024-07-12,9822
2603,長榮,17,6,11,元大-土城學府,2024-07-12,9822
6126,信音,15,4,11,元大-土城學府,2024-07-12,9822
2313,華通,12,1,11,元大-土城學府,2024-07-12,9822
2314,台揚,10,0,10,元大-土城學府,2024-07-12,9822
00928,中信上櫃ESG30,10,0,10,元大-土城學府,2024-07-12,9822
5202,力新,12,2,10,元大-土城學府,2024-07-12,9822
6244,茂迪,10,0,10,元大-土城學府,2024-07-12,9822
8110,華東,10,0,10,元大-土城學府,2024-07-12,9822
2834,臺企銀,276,5,271,元大-土城學府,2024-07-15,9822
00632R,元大台灣50反1,219,0,219,元大-土城學府,2024-07-15,9822
00934,中信成長高股息,167,12,155,元大-土城學府,2024-07-15,9822
00929,復華台灣科技優息,159,21,138,元大-土城學府,2024-07-15,9822
3710,連展投控,135,2,133,元大-土城學府,2024-07-15,9822
2356,英業達,162,53,109,元大-土城學府,2024-07-15,9822
4909,新復興,104,6,98,元大-土城學府,2024-07-15,9822
2618,長榮航,78,19,59,元大-土城學府,2024-07-15,9822
00687B,國泰20年美債,49,7,42,元大-土城學府,2024-07-15,9822
2610,華航,51,9,42,元大-土城學府,2024-07-15,9822
2312,金寶,151,113,38,元大-土城學府,2024-07-15,9822
2888,新光金,47,11,36,元大-土城學府,2024-07-15,9822
8234,新漢,35,0,35,元大-土城學府,2024-07-15,9822
9105,泰金寶-DR,36,2,34,元大-土城學府,2024-07-15,9822
3535,晶彩科,199,166,33,元大-土城學府,2024-07-15,9822
2891,中信金,35,4,31,元大-土城學府,2024-07-15,9822
2885,元大金,30,0,30,元大-土城學府,2024-07-15,9822
00927,群益半導體收益,29,0,29,元大-土城學府,2024-07-15,9822
0056,元大高股息,40,13,27,元大-土城學府,2024-07-15,9822
2489,瑞軒,139,112,27,元大-土城學府,2024-07-15,9822
3450,聯鈞,37,10,27,元大-土城學府,2024-07-15,9822
9958,世紀鋼,32,6,26,元大-土城學府,2024-07-15,9822
2409,友達,35,10,25,元大-土城學府,2024-07-15,9822
00933B,國泰10Y+金融債,24,0,24,元大-土城學府,2024-07-15,9822
1453,大將,24,0,24,元大-土城學府,2024-07-15,9822
1101,台泥,25,2,23,元大-土城學府,2024-07-15,9822
00918,大華優利高填息30,27,5,22,元大-土城學府,2024-07-15,9822
2838,聯邦銀,21,0,21,元大-土城學府,2024-07-15,9822
2365,昆盈,71,51,20,元大-土城學府,2024-07-15,9822
2419,仲琦,20,0,20,元大-土城學府,2024-07-15,9822
2543,皇昌,28,8,20,元大-土城學府,2024-07-15,9822
8044,網家,20,0,20,元大-土城學府,2024-07-15,9822
00936,台新永續高息中小,20,1,19,元大-土城學府,2024-07-15,9822
00688L,國泰20年美債正2,19,0,19,元大-土城學府,2024-07-15,9822
2867,三商壽,34,15,19,元大-土城學府,2024-07-15,9822
2883,凱基金,18,0,18,元大-土城學府,2024-07-15,9822
1785,光洋科,27,9,18,元大-土城學府,2024-07-15,9822
2401,凌陽,25,7,18,元大-土城學府,2024-07-15,9822
00878,國泰永續高股息,18,1,17,元大-土城學府,2024-07-15,9822
1725,元禎,15,0,15,元大-土城學府,2024-07-15,9822
1218,泰山,14,0,14,元大-土城學府,2024-07-15,9822
1608,華榮,45,31,14,元大-土城學府,2024-07-15,9822
6116,彩晶,14,0,14,元大-土城學府,2024-07-15,9822
6156,松上,15,1,14,元大-土城學府,2024-07-15,9822
00713,元大台灣高息低波,17,3,14,元大-土城學府,2024-07-15,9822
6224,聚鼎,13,0,13,元大-土城學府,2024-07-15,9822
3019,亞光,27,14,13,元大-土城學府,2024-07-15,9822
00882,中信中國高股息,12,0,12,元大-土城學府,2024-07-15,9822
00725B,國泰投資級公司債,12,0,12,元大-土城學府,2024-07-15,9822
6757,台灣虎航,12,0,12,元大-土城學府,2024-07-15,9822
00937B,群益ESG投等債20,144,3,141,元大-土城學府,2024-07-16,9822
2834,臺企銀,127,7,120,元大-土城學府,2024-07-16,9822
00929,復華台灣科技優息,109,8,101,元大-土城學府,2024-07-16,9822
00934,中信成長高股息,100,0,100,元大-土城學府,2024-07-16,9822
00919,群益台灣精選高息,87,5,82,元大-土城學府,2024-07-16,9822
0056,元大高股息,97,23,74,元大-土城學府,2024-07-16,9822
00927,群益半導體收益,64,0,64,元大-土城學府,2024-07-16,9822
2489,瑞軒,119,56,63,元大-土城學府,2024-07-16,9822
1609,大亞,76,19,57,元大-土城學府,2024-07-16,9822
1618,合機,48,4,44,元大-土城學府,2024-07-16,9822
2101,南港,44,1,43,元大-土城學府,2024-07-16,9822
3312,弘憶股,81,38,43,元大-土城學府,2024-07-16,9822
2312,金寶,59,23,36,元大-土城學府,2024-07-16,9822
8358,金居,35,0,35,元大-土城學府,2024-07-16,9822
4109,加捷生醫,65,33,32,元大-土城學府,2024-07-16,9822
00905,FT臺灣Smart,29,0,29,元大-土城學府,2024-07-16,9822
2615,萬海,29,1,28,元大-土城學府,2024-07-16,9822
2812,台中銀,30,2,28,元大-土城學府,2024-07-16,9822
4526,東台,27,0,27,元大-土城學府,2024-07-16,9822
2891,中信金,30,4,26,元大-土城學府,2024-07-16,9822
8011,台通,38,12,26,元大-土城學府,2024-07-16,9822
2618,長榮航,27,1,26,元大-土城學府,2024-07-16,9822
00878,國泰永續高股息,27,1,26,元大-土城學府,2024-07-16,9822
2317,鴻海,46,21,25,元大-土城學府,2024-07-16,9822
1504,東元,24,1,23,元大-土城學府,2024-07-16,9822
2477,美隆電,25,3,22,元大-土城學府,2024-07-16,9822
00946,群益科技高息成長,21,0,21,元大-土城學府,2024-07-16,9822
9904,寶成,21,0,21,元大-土城學府,2024-07-16,9822
3380,明泰,30,10,20,元大-土城學府,2024-07-16,9822
2301,光寶科,26,7,19,元大-土城學府,2024-07-16,9822
9105,泰金寶-DR,24,5,19,元大-土城學府,2024-07-16,9822
4909,新復興,28,9,19,元大-土城學府,2024-07-16,9822
00688L,國泰20年美債正2,18,0,18,元大-土城學府,2024-07-16,9822
2356,英業達,20,3,17,元大-土城學府,2024-07-16,9822
1503,士電,38,22,16,元大-土城學府,2024-07-16,9822
00942B,台新美A公司債20+,15,0,15,元大-土城學府,2024-07-16,9822
4167,松瑞藥,15,0,15,元大-土城學府,2024-07-16,9822
8064,東捷,17,2,15,元大-土城學府,2024-07-16,9822
00882,中信中國高股息,14,0,14,元大-土城學府,2024-07-16,9822
3105,穩懋,17,3,14,元大-土城學府,2024-07-16,9822
5880,合庫金,15,1,14,元大-土城學府,2024-07-16,9822
00933B,國泰10Y+金融債,13,0,13,元大-土城學府,2024-07-16,9822
2888,新光金,26,14,12,元大-土城學府,2024-07-16,9822
2328,廣宇,12,0,12,元大-土城學府,2024-07-16,9822
2363,矽統,20,8,12,元大-土城學府,2024-07-16,9822
6120,達運,17,5,12,元大-土城學府,2024-07-16,9822
2609,陽明,21,10,11,元大-土城學府,2024-07-16,9822
00881,國泰台灣5G+,11,0,11,元大-土城學府,2024-07-16,9822
6026,福邦證,11,0,11,元大-土城學府,2024-07-16,9822
8089,康全電訊,11,0,11,元大-土城學府,2024-07-16,9822
2881,富邦金,164,0,164,元大-土城學府,2024-07-17,9822
00937B,群益ESG投等債20,129,5,124,元大-土城學府,2024-07-17,9822
00929,復華台灣科技優息,144,49,95,元大-土城學府,2024-07-17,9822
00946,群益科技高息成長,96,2,94,元大-土城學府,2024-07-17,9822
00939,統一台灣高息動能,92,21,71,元大-土城學府,2024-07-17,9822
00919,群益台灣精選高息,63,2,61,元大-土城學府,2024-07-17,9822
0056,元大高股息,50,7,43,元大-土城學府,2024-07-17,9822
2845,遠東銀,41,0,41,元大-土城學府,2024-07-17,9822
2436,偉詮電,35,0,35,元大-土城學府,2024-07-17,9822
2615,萬海,39,7,32,元大-土城學府,2024-07-17,9822
8089,康全電訊,57,25,32,元大-土城學府,2024-07-17,9822
00763U,期街口道瓊銅,30,0,30,元大-土城學府,2024-07-17,9822
00949,復華日本龍頭,31,1,30,元大-土城學府,2024-07-17,9822
6117,迎廣,45,17,28,元大-土城學府,2024-07-17,9822
3231,緯創,28,2,26,元大-土城學府,2024-07-17,9822
2867,三商壽,30,5,25,元大-土城學府,2024-07-17,9822
2303,聯電,29,4,25,元大-土城學府,2024-07-17,9822
6770,力積電,30,6,24,元大-土城學府,2024-07-17,9822
2301,光寶科,23,1,22,元大-土城學府,2024-07-17,9822
00878,國泰永續高股息,22,0,22,元大-土城學府,2024-07-17,9822
00915,凱基優選高股息30,21,0,21,元大-土城學府,2024-07-17,9822
2408,南亞科,23,2,21,元大-土城學府,2024-07-17,9822
00931B,統一美債20年,20,0,20,元大-土城學府,2024-07-17,9822
2890,永豐金,20,0,20,元大-土城學府,2024-07-17,9822
2371,大同,21,1,20,元大-土城學府,2024-07-17,9822
6284,佳邦,22,3,19,元大-土城學府,2024-07-17,9822
3163,波若威,28,10,18,元大-土城學府,2024-07-17,9822
2485,兆赫,20,2,18,元大-土城學府,2024-07-17,9822
2453,凌群,24,7,17,元大-土城學府,2024-07-17,9822
2812,台中銀,17,0,17,元大-土城學府,2024-07-17,9822
3673,TPK-KY,24,7,17,元大-土城學府,2024-07-17,9822
2356,英業達,39,22,17,元大-土城學府,2024-07-17,9822
2449,京元電子,27,11,16,元大-土城學府,2024-07-17,9822
2477,美隆電,19,3,16,元大-土城學府,2024-07-17,9822
4526,東台,16,0,16,元大-土城學府,2024-07-17,9822
6155,鈞寶,17,1,16,元大-土城學府,2024-07-17,9822
2402,毅嘉,80,64,16,元大-土城學府,2024-07-17,9822
9105,泰金寶-DR,15,0,15,元大-土城學府,2024-07-17,9822
2537,聯上發,37,23,14,元大-土城學府,2024-07-17,9822
5876,上海商銀,14,0,14,元大-土城學府,2024-07-17,9822
1409,新纖,96,83,13,元大-土城學府,2024-07-17,9822
6806,森崴能源,15,2,13,元大-土城學府,2024-07-17,9822
1513,中興電,21,8,13,元大-土城學府,2024-07-17,9822
2834,臺企銀,12,0,12,元大-土城學府,2024-07-17,9822
6692,進能服,13,1,12,元大-土城學府,2024-07-17,9822
2542,興富發,18,7,11,元大-土城學府,2024-07-17,9822
00905,FT臺灣Smart,12,1,11,元大-土城學府,2024-07-17,9822
2501,國建,14,3,11,元大-土城學府,2024-07-17,9822
8358,金居,12,1,11,元大-土城學府,2024-07-17,9822
2891,中信金,14,3,11,元大-土城學府,2024-07-17,9822
00688L,國泰20年美債正2,222,0,222,元大-土城學府,2024-07-18,9822
00929,復華台灣科技優息,131,27,104,元大-土城學府,2024-07-18,9822
00919,群益台灣精選高息,118,17,101,元大-土城學府,2024-07-18,9822
00937B,群益ESG投等債20,65,1,64,元大-土城學府,2024-07-18,9822
00878,國泰永續高股息,83,20,63,元大-土城學府,2024-07-18,9822
2610,華航,80,19,61,元大-土城學府,2024-07-18,9822
2317,鴻海,94,35,59,元大-土城學府,2024-07-18,9822
9105,泰金寶-DR,63,17,46,元大-土城學府,2024-07-18,9822
00881,國泰台灣5G+,39,0,39,元大-土城學府,2024-07-18,9822
3163,波若威,52,13,39,元大-土城學府,2024-07-18,9822
1618,合機,40,4,36,元大-土城學府,2024-07-18,9822
2356,英業達,68,33,35,元大-土城學府,2024-07-18,9822
00927,群益半導體收益,35,0,35,元大-土城學府,2024-07-18,9822
2812,台中銀,36,2,34,元大-土城學府,2024-07-18,9822
1609,大亞,74,42,32,元大-土城學府,2024-07-18,9822
1102,亞泥,32,0,32,元大-土城學府,2024-07-18,9822
0056,元大高股息,56,27,29,元大-土城學府,2024-07-18,9822
2303,聯電,39,12,27,元大-土城學府,2024-07-18,9822
9955,佳龍,28,4,24,元大-土城學府,2024-07-18,9822
1301,台塑,30,7,23,元大-土城學府,2024-07-18,9822
2891,中信金,24,1,23,元大-土城學府,2024-07-18,9822
3037,欣興,41,19,22,元大-土城學府,2024-07-18,9822
2313,華通,24,3,21,元大-土城學府,2024-07-18,9822
00669R,國泰美國道瓊反1,20,0,20,元大-土城學府,2024-07-18,9822
2472,立隆電,20,0,20,元大-土城學府,2024-07-18,9822
3703,欣陸,60,40,20,元大-土城學府,2024-07-18,9822
4906,正文,34,15,19,元大-土城學府,2024-07-18,9822
1513,中興電,43,25,18,元大-土城學府,2024-07-18,9822
2002,中鋼,41,24,17,元大-土城學府,2024-07-18,9822
2881,富邦金,21,5,16,元大-土城學府,2024-07-18,9822
3673,TPK-KY,16,0,16,元大-土城學府,2024-07-18,9822
00687B,國泰20年美債,19,3,16,元大-土城學府,2024-07-18,9822
00680L,元大美債20正2,16,0,16,元大-土城學府,2024-07-18,9822
1316,上曜,19,3,16,元大-土城學府,2024-07-18,9822
6257,矽格,16,0,16,元大-土城學府,2024-07-18,9822
1303,南亞,16,0,16,元大-土城學府,2024-07-18,9822
8358,金居,17,2,15,元大-土城學府,2024-07-18,9822
00706L,期元大S＆P日圓正2,17,4,13,元大-土城學府,2024-07-18,9822
2258,鴻華先進-創,13,0,13,元大-土城學府,2024-07-18,9822
2365,昆盈,141,128,13,元大-土城學府,2024-07-18,9822
2449,京元電子,16,4,12,元大-土城學府,2024-07-18,9822
00712,復華富時不動產,16,4,12,元大-土城學府,2024-07-18,9822
2402,毅嘉,34,22,12,元大-土城學府,2024-07-18,9822
1815,富喬,15,3,12,元大-土城學府,2024-07-18,9822
00936,台新永續高息中小,19,7,12,元大-土城學府,2024-07-18,9822
6770,力積電,31,20,11,元大-土城學府,2024-07-18,9822
1536,和大,15,4,11,元大-土城學府,2024-07-18,9822
2888,新光金,27,16,11,元大-土城學府,2024-07-18,9822
00753L,中信中國50正2,40,30,10,元大-土城學府,2024-07-18,9822
00949,復華日本龍頭,10,0,10,元大-土城學府,2024-07-18,9822
00632R,元大台灣50反1,269,25,244,元大-土城學府,2024-07-19,9822
2419,仲琦,238,27,211,元大-土城學府,2024-07-19,9822
00937B,群益ESG投等債20,145,3,142,元大-土城學府,2024-07-19,9822
00919,群益台灣精選高息,152,11,141,元大-土城學府,2024-07-19,9822
00940,元大台灣價值高息,227,88,139,元大-土城學府,2024-07-19,9822
00929,復華台灣科技優息,179,47,132,元大-土城學府,2024-07-19,9822
1455,集盛,146,30,116,元大-土城學府,2024-07-19,9822
2834,臺企銀,102,6,96,元大-土城學府,2024-07-19,9822
2349,錸德,75,0,75,元大-土城學府,2024-07-19,9822
00878,國泰永續高股息,69,4,65,元大-土城學府,2024-07-19,9822
2472,立隆電,58,0,58,元大-土城學府,2024-07-19,9822
8936,國統,69,11,58,元大-土城學府,2024-07-19,9822
2891,中信金,68,10,58,元大-土城學府,2024-07-19,9822
0056,元大高股息,73,19,54,元大-土城學府,2024-07-19,9822
3380,明泰,55,4,51,元大-土城學府,2024-07-19,9822
2303,聯電,56,8,48,元大-土城學府,2024-07-19,9822
2480,敦陽科,48,0,48,元大-土城學府,2024-07-19,9822
2356,英業達,43,1,42,元大-土城學府,2024-07-19,9822
8089,康全電訊,42,1,41,元大-土城學府,2024-07-19,9822
3576,聯合再生,42,1,41,元大-土城學府,2024-07-19,9822
6116,彩晶,39,0,39,元大-土城學府,2024-07-19,9822
3037,欣興,41,9,32,元大-土城學府,2024-07-19,9822
2610,華航,53,21,32,元大-土城學府,2024-07-19,9822
2520,冠德,50,20,30,元大-土城學府,2024-07-19,9822
8076,伍豐,42,12,30,元大-土城學府,2024-07-19,9822
00680L,元大美債20正2,33,3,30,元大-土城學府,2024-07-19,9822
00927,群益半導體收益,28,0,28,元大-土城學府,2024-07-19,9822
2327,國巨,27,0,27,元大-土城學府,2024-07-19,9822
2883,凱基金,53,27,26,元大-土城學府,2024-07-19,9822
00665L,富邦�琤肭磪囓�2,24,0,24,元大-土城學府,2024-07-19,9822
2367,燿華,24,1,23,元大-土城學府,2024-07-19,9822
2609,陽明,29,7,22,元大-土城學府,2024-07-19,9822
3231,緯創,23,2,21,元大-土城學府,2024-07-19,9822
2312,金寶,30,9,21,元大-土城學府,2024-07-19,9822
6863,永道-KY,21,0,21,元大-土城學府,2024-07-19,9822
4916,事欣科,23,3,20,元大-土城學府,2024-07-19,9822
3013,晟銘電,31,11,20,元大-土城學府,2024-07-19,9822
8011,台通,24,4,20,元大-土城學府,2024-07-19,9822
00946,群益科技高息成長,17,0,17,元大-土城學府,2024-07-19,9822
3617,碩天,16,0,16,元大-土城學府,2024-07-19,9822
5213,亞昕,16,0,16,元大-土城學府,2024-07-19,9822
00918,大華優利高填息30,23,9,14,元大-土城學府,2024-07-19,9822
00939,統一台灣高息動能,19,5,14,元大-土城學府,2024-07-19,9822
00936,台新永續高息中小,27,13,14,元大-土城學府,2024-07-19,9822
8046,南電,13,0,13,元大-土城學府,2024-07-19,9822
2618,長榮航,18,5,13,元大-土城學府,2024-07-19,9822
00891,中信關鍵半導體,12,0,12,元大-土城學府,2024-07-19,9822
4726,永昕,16,4,12,元大-土城學府,2024-07-19,9822
00725B,國泰投資級公司債,12,0,12,元大-土城學府,2024-07-19,9822
00931B,統一美債20年,12,0,12,元大-土城學府,2024-07-19,9822
00940,元大台灣價值高息,444,64,380,元大-土城學府,2024-07-22,9822
00919,群益台灣精選高息,253,67,186,元大-土城學府,2024-07-22,9822
00946,群益科技高息成長,156,7,149,元大-土城學府,2024-07-22,9822
1718,中纖,100,0,100,元大-土城學府,2024-07-22,9822
3481,群創,77,12,65,元大-土城學府,2024-07-22,9822
00929,復華台灣科技優息,335,271,64,元大-土城學府,2024-07-22,9822
1609,大亞,95,34,61,元大-土城學府,2024-07-22,9822
2610,華航,105,53,52,元大-土城學府,2024-07-22,9822
5512,力麒,73,23,50,元大-土城學府,2024-07-22,9822
1802,台玻,50,3,47,元大-土城學府,2024-07-22,9822
00927,群益半導體收益,46,0,46,元大-土城學府,2024-07-22,9822
00881,國泰台灣5G+,45,0,45,元大-土城學府,2024-07-22,9822
8046,南電,44,0,44,元大-土城學府,2024-07-22,9822
1503,士電,42,2,40,元大-土城學府,2024-07-22,9822
1709,和益,35,0,35,元大-土城學府,2024-07-22,9822
00918,大華優利高填息30,45,14,31,元大-土城學府,2024-07-22,9822
2382,廣達,33,3,30,元大-土城學府,2024-07-22,9822
8473,山林水,46,16,30,元大-土城學府,2024-07-22,9822
4566,時碩工業,31,2,29,元大-土城學府,2024-07-22,9822
00936,台新永續高息中小,30,1,29,元大-土城學府,2024-07-22,9822
2303,聯電,37,11,26,元大-土城學府,2024-07-22,9822
3580,友威科,31,5,26,元大-土城學府,2024-07-22,9822
2317,鴻海,84,60,24,元大-土城學府,2024-07-22,9822
3189,景碩,27,6,21,元大-土城學府,2024-07-22,9822
2314,台揚,20,0,20,元大-土城學府,2024-07-22,9822
6570,維田,20,0,20,元大-土城學府,2024-07-22,9822
2489,瑞軒,41,22,19,元大-土城學府,2024-07-22,9822
00923,群益台ESG低碳50,23,6,17,元大-土城學府,2024-07-22,9822
2609,陽明,38,21,17,元大-土城學府,2024-07-22,9822
2888,新光金,26,10,16,元大-土城學府,2024-07-22,9822
00725B,國泰投資級公司債,15,0,15,元大-土城學府,2024-07-22,9822
00882,中信中國高股息,19,6,13,元大-土城學府,2024-07-22,9822
8104,錸寶,16,3,13,元大-土城學府,2024-07-22,9822
2356,英業達,22,10,12,元大-土城學府,2024-07-22,9822
5443,均豪,26,14,12,元大-土城學府,2024-07-22,9822
6245,立端,12,0,12,元大-土城學府,2024-07-22,9822
0056,元大高股息,176,164,12,元大-土城學府,2024-07-22,9822
5236,凌陽創新,14,3,11,元大-土城學府,2024-07-22,9822
3105,穩懋,16,6,10,元大-土城學府,2024-07-22,9822
1447,力鵬,10,0,10,元大-土城學府,2024-07-22,9822
1463,強盛新,10,0,10,元大-土城學府,2024-07-22,9822
1522,堤維西,10,0,10,元大-土城學府,2024-07-22,9822
2478,大毅,10,0,10,元大-土城學府,2024-07-22,9822
2867,三商壽,11,1,10,元大-土城學府,2024-07-22,9822
2419,仲琦,14,5,9,元大-土城學府,2024-07-22,9822
8201,無敵,9,0,9,元大-土城學府,2024-07-22,9822
0050,元大台灣50,13,4,9,元大-土城學府,2024-07-22,9822
2344,華邦電,10,2,8,元大-土城學府,2024-07-22,9822
6770,力積電,41,33,8,元大-土城學府,2024-07-22,9822
2354,鴻準,11,3,8,元大-土城學府,2024-07-22,9822
2897,王道銀行,1290,0,1290,元大-土城學府,2024-07-23,9822
00919,群益台灣精選高息,127,1,126,元大-土城學府,2024-07-23,9822
00937B,群益ESG投等債20,94,0,94,元大-土城學府,2024-07-23,9822
00929,復華台灣科技優息,109,16,93,元大-土城學府,2024-07-23,9822
2317,鴻海,123,33,90,元大-土城學府,2024-07-23,9822
4909,新復興,95,11,84,元大-土城學府,2024-07-23,9822
00878,國泰永續高股息,59,11,48,元大-土城學府,2024-07-23,9822
00946,群益科技高息成長,46,0,46,元大-土城學府,2024-07-23,9822
2409,友達,45,0,45,元大-土城學府,2024-07-23,9822
2489,瑞軒,44,6,38,元大-土城學府,2024-07-23,9822
2374,佳能,44,11,33,元大-土城學府,2024-07-23,9822
1609,大亞,77,46,31,元大-土城學府,2024-07-23,9822
00751B,元大AAA至A公司債,31,0,31,元大-土城學府,2024-07-23,9822
3481,群創,71,41,30,元大-土城學府,2024-07-23,9822
0056,元大高股息,41,14,27,元大-土城學府,2024-07-23,9822
00680L,元大美債20正2,25,0,25,元大-土城學府,2024-07-23,9822
00939,統一台灣高息動能,24,1,23,元大-土城學府,2024-07-23,9822
00637L,元大滬深300正2,21,0,21,元大-土城學府,2024-07-23,9822
00882,中信中國高股息,20,0,20,元大-土城學府,2024-07-23,9822
00719B,元大美債1-3,20,0,20,元大-土城學府,2024-07-23,9822
1102,亞泥,18,0,18,元大-土城學府,2024-07-23,9822
2349,錸德,23,5,18,元大-土城學府,2024-07-23,9822
2365,昆盈,39,21,18,元大-土城學府,2024-07-23,9822
6477,安集,30,13,17,元大-土城學府,2024-07-23,9822
9105,泰金寶-DR,23,8,15,元大-土城學府,2024-07-23,9822
5512,力麒,22,7,15,元大-土城學府,2024-07-23,9822
2888,新光金,15,1,14,元大-土城學府,2024-07-23,9822
00933B,國泰10Y+金融債,14,0,14,元大-土城學府,2024-07-23,9822
1785,光洋科,16,2,14,元大-土城學府,2024-07-23,9822
4804,大略-KY,13,0,13,元大-土城學府,2024-07-23,9822
00632R,元大台灣50反1,41,29,12,元大-土城學府,2024-07-23,9822
1301,台塑,13,1,12,元大-土城學府,2024-07-23,9822
2337,旺宏,13,1,12,元大-土城學府,2024-07-23,9822
2408,南亞科,13,1,12,元大-土城學府,2024-07-23,9822
1304,台聚,11,0,11,元大-土城學府,2024-07-23,9822
2528,皇普,11,0,11,元大-土城學府,2024-07-23,9822
3163,波若威,18,7,11,元大-土城學府,2024-07-23,9822
6841,長佳智能,21,10,11,元大-土城學府,2024-07-23,9822
3576,聯合再生,11,0,11,元大-土城學府,2024-07-23,9822
1815,富喬,10,0,10,元大-土城學府,2024-07-23,9822
2527,宏璟,10,0,10,元大-土城學府,2024-07-23,9822
2867,三商壽,10,0,10,元大-土城學府,2024-07-23,9822
6505,台塑化,15,5,10,元大-土城學府,2024-07-23,9822
4526,東台,10,1,9,元大-土城學府,2024-07-23,9822
3686,達能,9,0,9,元大-土城學府,2024-07-23,9822
8028,昇陽半導體,10,1,9,元大-土城學府,2024-07-23,9822
3522,御嵿,9,0,9,元大-土城學府,2024-07-23,9822
3047,訊舟,8,0,8,元大-土城學府,2024-07-23,9822
00904,新光臺灣半導體30,8,0,8,元大-土城學府,2024-07-23,9822
00934,中信成長高股息,12,4,8,元大-土城學府,2024-07-23,9822
00937B,群益ESG投等債20,156,6,150,元大-土城學府,2024-07-26,9822
00919,群益台灣精選高息,142,13,129,元大-土城學府,2024-07-26,9822
00929,復華台灣科技優息,165,40,125,元大-土城學府,2024-07-26,9822
00878,國泰永續高股息,116,0,116,元大-土城學府,2024-07-26,9822
0056,元大高股息,126,26,100,元大-土城學府,2024-07-26,9822
2881,富邦金,80,0,80,元大-土城學府,2024-07-26,9822
00946,群益科技高息成長,63,3,60,元大-土城學府,2024-07-26,9822
3711,日月光投控,57,1,56,元大-土城學府,2024-07-26,9822
2834,臺企銀,54,1,53,元大-土城學府,2024-07-26,9822
00680L,元大美債20正2,45,2,43,元大-土城學府,2024-07-26,9822
2337,旺宏,42,0,42,元大-土城學府,2024-07-26,9822
2489,瑞軒,43,1,42,元大-土城學府,2024-07-26,9822
2317,鴻海,45,8,37,元大-土城學府,2024-07-26,9822
2885,元大金,31,0,31,元大-土城學府,2024-07-26,9822
00637L,元大滬深300正2,26,2,24,元大-土城學府,2024-07-26,9822
2330,台積電,25,2,23,元大-土城學府,2024-07-26,9822
3189,景碩,28,6,22,元大-土城學府,2024-07-26,9822
2409,友達,22,1,21,元大-土城學府,2024-07-26,9822
2476,鉅祥,21,0,21,元大-土城學府,2024-07-26,9822
00902,中信電池及儲能,21,0,21,元大-土城學府,2024-07-26,9822
2408,南亞科,27,6,21,元大-土城學府,2024-07-26,9822
3163,波若威,23,3,20,元大-土城學府,2024-07-26,9822
1904,正隆,20,0,20,元大-土城學府,2024-07-26,9822
2303,聯電,35,15,20,元大-土城學府,2024-07-26,9822
5512,力麒,20,1,19,元大-土城學府,2024-07-26,9822
6142,友勁,19,0,19,元大-土城學府,2024-07-26,9822
2349,錸德,35,17,18,元大-土城學府,2024-07-26,9822
2618,長榮航,38,20,18,元大-土城學府,2024-07-26,9822
2845,遠東銀,18,0,18,元大-土城學府,2024-07-26,9822
6215,和椿,21,3,18,元大-土城學府,2024-07-26,9822
2891,中信金,20,3,17,元大-土城學府,2024-07-26,9822
00882,中信中國高股息,17,0,17,元大-土城學府,2024-07-26,9822
1503,士電,57,41,16,元大-土城學府,2024-07-26,9822
00934,中信成長高股息,16,0,16,元大-土城學府,2024-07-26,9822
00945B,凱基美國非投等債,15,0,15,元大-土城學府,2024-07-26,9822
2382,廣達,17,3,14,元大-土城學府,2024-07-26,9822
00935,野村臺灣新科技50,14,0,14,元大-土城學府,2024-07-26,9822
00713,元大台灣高息低波,14,2,12,元大-土城學府,2024-07-26,9822
00772B,中信高評級公司債,15,3,12,元大-土城學府,2024-07-26,9822
6443,元晶,12,0,12,元大-土城學府,2024-07-26,9822
8046,南電,12,0,12,元大-土城學府,2024-07-26,9822
2356,英業達,32,20,12,元大-土城學府,2024-07-26,9822
1301,台塑,11,0,11,元大-土城學府,2024-07-26,9822
1313,聯成,11,0,11,元大-土城學府,2024-07-26,9822
00881,國泰台灣5G+,10,0,10,元大-土城學府,2024-07-26,9822
2838,聯邦銀,10,0,10,元大-土城學府,2024-07-26,9822
00706L,期元大S＆P日圓正2,10,0,10,元大-土城學府,2024-07-26,9822
00933B,國泰10Y+金融債,10,0,10,元大-土城學府,2024-07-26,9822
1201,味全,10,0,10,元大-土城學府,2024-07-26,9822
0050,元大台灣50,12,2,10,元大-土城學府,2024-07-26,9822
2888,新光金,753,6,747,元大-土城學府,2024-07-29,9822
00937B,群益ESG投等債20,271,22,249,元大-土城學府,2024-07-29,9822
00940,元大台灣價值高息,173,23,150,元大-土城學府,2024-07-29,9822
00878,國泰永續高股息,93,0,93,元大-土城學府,2024-07-29,9822
00946,群益科技高息成長,93,0,93,元大-土城學府,2024-07-29,9822
0056,元大高股息,61,4,57,元大-土城學府,2024-07-29,9822
00919,群益台灣精選高息,51,1,50,元大-土城學府,2024-07-29,9822
00929,復華台灣科技優息,155,109,46,元大-土城學府,2024-07-29,9822
6570,維田,40,0,40,元大-土城學府,2024-07-29,9822
4906,正文,37,0,37,元大-土城學府,2024-07-29,9822
00632R,元大台灣50反1,35,0,35,元大-土城學府,2024-07-29,9822
00688L,國泰20年美債正2,36,1,35,元大-土城學府,2024-07-29,9822
00918,大華優利高填息30,35,0,35,元大-土城學府,2024-07-29,9822
2313,華通,31,2,29,元大-土城學府,2024-07-29,9822
2367,燿華,29,0,29,元大-土城學府,2024-07-29,9822
00680L,元大美債20正2,25,0,25,元大-土城學府,2024-07-29,9822
6116,彩晶,21,0,21,元大-土城學府,2024-07-29,9822
00669R,國泰美國道瓊反1,20,0,20,元大-土城學府,2024-07-29,9822
2356,英業達,27,8,19,元大-土城學府,2024-07-29,9822
6438,迅得,19,0,19,元大-土城學府,2024-07-29,9822
5213,亞昕,18,0,18,元大-土城學府,2024-07-29,9822
2884,玉山金,21,4,17,元大-土城學府,2024-07-29,9822
8096,擎亞,25,8,17,元大-土城學府,2024-07-29,9822
3363,上詮,17,0,17,元大-土城學府,2024-07-29,9822
0050,元大台灣50,17,1,16,元大-土城學府,2024-07-29,9822
6869,雲豹能源,17,1,16,元大-土城學府,2024-07-29,9822
00936,台新永續高息中小,15,0,15,元大-土城學府,2024-07-29,9822
3013,晟銘電,21,6,15,元大-土城學府,2024-07-29,9822
3105,穩懋,15,1,14,元大-土城學府,2024-07-29,9822
3312,弘憶股,58,44,14,元大-土城學府,2024-07-29,9822
1609,大亞,48,34,14,元大-土城學府,2024-07-29,9822
00934,中信成長高股息,24,11,13,元大-土城學府,2024-07-29,9822
00891,中信關鍵半導體,13,0,13,元大-土城學府,2024-07-29,9822
9105,泰金寶-DR,13,0,13,元大-土城學府,2024-07-29,9822
2354,鴻準,23,10,13,元大-土城學府,2024-07-29,9822
2603,長榮,12,0,12,元大-土城學府,2024-07-29,9822
2363,矽統,36,24,12,元大-土城學府,2024-07-29,9822
5009,榮剛,11,0,11,元大-土城學府,2024-07-29,9822
6016,康和證,11,0,11,元大-土城學府,2024-07-29,9822
3455,由田,10,0,10,元大-土城學府,2024-07-29,9822
00902,中信電池及儲能,10,0,10,元大-土城學府,2024-07-29,9822
1309,台達化,10,0,10,元大-土城學府,2024-07-29,9822
1504,東元,15,5,10,元大-土城學府,2024-07-29,9822
2332,友訊,10,0,10,元大-土城學府,2024-07-29,9822
3036A,文曄甲特,10,0,10,元大-土城學府,2024-07-29,9822
6456,GIS-KY,10,0,10,元大-土城學府,2024-07-29,9822
8088,品安,10,0,10,元大-土城學府,2024-07-29,9822
2891,中信金,9,0,9,元大-土城學府,2024-07-29,9822
1608,華榮,9,0,9,元大-土城學府,2024-07-29,9822
1463,強盛新,8,0,8,元大-土城學府,2024-07-29,9822
00632R,元大台灣50反1,463,48,415,元大-土城學府,2024-07-30,9822
00940,元大台灣價值高息,283,83,200,元大-土城學府,2024-07-30,9822
2890,永豐金,101,6,95,元大-土城學府,2024-07-30,9822
2323,中環,94,0,94,元大-土城學府,2024-07-30,9822
00929,復華台灣科技優息,114,26,88,元大-土城學府,2024-07-30,9822
00878,國泰永續高股息,93,37,56,元大-土城學府,2024-07-30,9822
00637L,元大滬深300正2,46,0,46,元大-土城學府,2024-07-30,9822
2349,錸德,104,59,45,元大-土城學府,2024-07-30,9822
2344,華邦電,48,4,44,元大-土城學府,2024-07-30,9822
2891,中信金,41,0,41,元大-土城學府,2024-07-30,9822
00680L,元大美債20正2,40,0,40,元大-土城學府,2024-07-30,9822
1409,新纖,43,3,40,元大-土城學府,2024-07-30,9822
3711,日月光投控,36,0,36,元大-土城學府,2024-07-30,9822
00946,群益科技高息成長,34,0,34,元大-土城學府,2024-07-30,9822
2382,廣達,36,5,31,元大-土城學府,2024-07-30,9822
00936,台新永續高息中小,31,0,31,元大-土城學府,2024-07-30,9822
1522,堤維西,26,0,26,元大-土城學府,2024-07-30,9822
00918,大華優利高填息30,27,4,23,元大-土城學府,2024-07-30,9822
1101,台泥,23,0,23,元大-土城學府,2024-07-30,9822
6005,群益證,22,0,22,元大-土城學府,2024-07-30,9822
00933B,國泰10Y+金融債,23,2,21,元大-土城學府,2024-07-30,9822
00676R,富邦臺灣加權反1,55,35,20,元大-土城學府,2024-07-30,9822
1201,味全,20,0,20,元大-土城學府,2024-07-30,9822
0056,元大高股息,76,56,20,元大-土城學府,2024-07-30,9822
1453,大將,19,0,19,元大-土城學府,2024-07-30,9822
1513,中興電,22,4,18,元大-土城學府,2024-07-30,9822
00715L,期街口布蘭特正2,18,0,18,元大-土城學府,2024-07-30,9822
2801,彰銀,20,2,18,元大-土城學府,2024-07-30,9822
8046,南電,18,0,18,元大-土城學府,2024-07-30,9822
00919,群益台灣精選高息,19,1,18,元大-土城學府,2024-07-30,9822
00945B,凱基美國非投等債,16,0,16,元大-土城學府,2024-07-30,9822
3189,景碩,20,6,14,元大-土城學府,2024-07-30,9822
2449,京元電子,15,2,13,元大-土城學府,2024-07-30,9822
1815,富喬,13,0,13,元大-土城學府,2024-07-30,9822
3013,晟銘電,14,1,13,元大-土城學府,2024-07-30,9822
2408,南亞科,12,0,12,元大-土城學府,2024-07-30,9822
2388,威盛,13,1,12,元大-土城學府,2024-07-30,9822
2489,瑞軒,17,5,12,元大-土城學府,2024-07-30,9822
3163,波若威,34,22,12,元大-土城學府,2024-07-30,9822
2348,海悅,12,0,12,元大-土城學府,2024-07-30,9822
3481,群創,18,6,12,元大-土城學府,2024-07-30,9822
2618,長榮航,14,3,11,元大-土城學府,2024-07-30,9822
2881,富邦金,11,0,11,元大-土城學府,2024-07-30,9822
00948B,中信優息投資級債,11,0,11,元大-土城學府,2024-07-30,9822
2356,英業達,67,56,11,元大-土城學府,2024-07-30,9822
2442,新美齊,20,9,11,元大-土城學府,2024-07-30,9822
2364,倫飛,15,5,10,元大-土城學府,2024-07-30,9822
8110,華東,10,0,10,元大-土城學府,2024-07-30,9822
8028,昇陽半導體,23,14,9,元大-土城學府,2024-07-30,9822
5512,力麒,9,0,9,元大-土城學府,2024-07-30,9822
00632R,元大台灣50反1,196,0,196,元大-土城學府,2024-07-31,9822
3481,群創,69,5,64,元大-土城學府,2024-07-31,9822
00676R,富邦臺灣加權反1,60,0,60,元大-土城學府,2024-07-31,9822
00946,群益科技高息成長,50,0,50,元大-土城學府,2024-07-31,9822
2399,映泰,50,0,50,元大-土城學府,2024-07-31,9822
3024,憶聲,53,5,48,元大-土城學府,2024-07-31,9822
0056,元大高股息,47,3,44,元大-土城學府,2024-07-31,9822
2324,仁寶,43,0,43,元大-土城學府,2024-07-31,9822
2362,藍天,45,9,36,元大-土城學府,2024-07-31,9822
00878,國泰永續高股息,38,2,36,元大-土城學府,2024-07-31,9822
00679B,元大美債20年,31,0,31,元大-土城學府,2024-07-31,9822
4909,新復興,32,5,27,元大-土城學府,2024-07-31,9822
00637L,元大滬深300正2,22,0,22,元大-土城學府,2024-07-31,9822
8440,綠電,32,10,22,元大-土城學府,2024-07-31,9822
2489,瑞軒,36,15,21,元大-土城學府,2024-07-31,9822
00688L,國泰20年美債正2,25,5,20,元大-土城學府,2024-07-31,9822
6116,彩晶,20,0,20,元大-土城學府,2024-07-31,9822
2515,中工,19,0,19,元大-土城學府,2024-07-31,9822
00940,元大台灣價值高息,34,16,18,元大-土城學府,2024-07-31,9822
00929,復華台灣科技優息,49,33,16,元大-土城學府,2024-07-31,9822
3037,欣興,39,23,16,元大-土城學府,2024-07-31,9822
00715L,期街口布蘭特正2,16,0,16,元大-土城學府,2024-07-31,9822
00680L,元大美債20正2,15,0,15,元大-土城學府,2024-07-31,9822
1110,東泥,15,0,15,元大-土城學府,2024-07-31,9822
8105,凌巨,18,5,13,元大-土城學府,2024-07-31,9822
2449,京元電子,12,0,12,元大-土城學府,2024-07-31,9822
3047,訊舟,81,69,12,元大-土城學府,2024-07-31,9822
2524,京城,47,36,11,元大-土城學府,2024-07-31,9822
1532,勤美,10,0,10,元大-土城學府,2024-07-31,9822
3013,晟銘電,15,5,10,元大-土城學府,2024-07-31,9822
00664R,國泰臺灣加權反1,9,0,9,元大-土城學府,2024-07-31,9822
3062,建漢,10,1,9,元大-土城學府,2024-07-31,9822
4533,協易機,9,0,9,元大-土城學府,2024-07-31,9822
3376,新日興,14,6,8,元大-土城學府,2024-07-31,9822
00945B,凱基美國非投等債,8,0,8,元大-土城學府,2024-07-31,9822
2204,中華,7,0,7,元大-土城學府,2024-07-31,9822
1449,佳和,9,2,7,元大-土城學府,2024-07-31,9822
3710,連展投控,7,0,7,元大-土城學府,2024-07-31,9822
00939,統一台灣高息動能,21,15,6,元大-土城學府,2024-07-31,9822
2530,華建,6,0,6,元大-土城學府,2024-07-31,9822
1101,台泥,6,0,6,元大-土城學府,2024-07-31,9822
2301,光寶科,8,2,6,元大-土城學府,2024-07-31,9822
2374,佳能,6,0,6,元大-土城學府,2024-07-31,9822
2409,友達,6,0,6,元大-土城學府,2024-07-31,9822
3042,晶技,7,1,6,元大-土城學府,2024-07-31,9822
00919,群益台灣精選高息,33,28,5,元大-土城學府,2024-07-31,9822
9945,潤泰新,8,3,5,元大-土城學府,2024-07-31,9822
00895,富邦未來車,5,0,5,元大-土城學府,2024-07-31,9822
00937B,群益ESG投等債20,5,0,5,元大-土城學府,2024-07-31,9822
00948B,中信優息投資級債,5,0,5,元大-土城學府,2024-07-31,9822
3518,柏騰,98,0,98,元大-土城學府,2024-08-01,9822
00929,復華台灣科技優息,110,16,94,元大-土城學府,2024-08-01,9822
00933B,國泰10Y+金融債,93,0,93,元大-土城學府,2024-08-01,9822
00878,國泰永續高股息,67,6,61,元大-土城學府,2024-08-01,9822
2409,友達,61,5,56,元大-土城學府,2024-08-01,9822
3024,憶聲,52,2,50,元大-土城學府,2024-08-01,9822
3663,鑫科,72,29,43,元大-土城學府,2024-08-01,9822
2317,鴻海,49,11,38,元大-土城學府,2024-08-01,9822
00679B,元大美債20年,36,0,36,元大-土城學府,2024-08-01,9822
2610,華航,32,1,31,元大-土城學府,2024-08-01,9822
3035,智原,33,3,30,元大-土城學府,2024-08-01,9822
2353,宏��,44,16,28,元大-土城學府,2024-08-01,9822
2349,錸德,56,28,28,元大-土城學府,2024-08-01,9822
2891,中信金,33,6,27,元大-土城學府,2024-08-01,9822
00712,復華富時不動產,25,0,25,元大-土城學府,2024-08-01,9822
1303,南亞,28,3,25,元大-土城學府,2024-08-01,9822
00919,群益台灣精選高息,28,3,25,元大-土城學府,2024-08-01,9822
3060,銘異,23,0,23,元大-土城學府,2024-08-01,9822
6443,元晶,23,1,22,元大-土城學府,2024-08-01,9822
2344,華邦電,24,5,19,元大-土城學府,2024-08-01,9822
8089,康全電訊,20,1,19,元大-土城學府,2024-08-01,9822
00942B,台新美A公司債20+,17,0,17,元大-土城學府,2024-08-01,9822
2888,新光金,17,0,17,元大-土城學府,2024-08-01,9822
00676R,富邦臺灣加權反1,15,0,15,元大-土城學府,2024-08-01,9822
4707,磐亞,15,0,15,元大-土城學府,2024-08-01,9822
2337,旺宏,82,68,14,元大-土城學府,2024-08-01,9822
00687B,國泰20年美債,19,5,14,元大-土城學府,2024-08-01,9822
00881,國泰台灣5G+,14,1,13,元大-土城學府,2024-08-01,9822
2867,三商壽,20,7,13,元大-土城學府,2024-08-01,9822
3673,TPK-KY,13,0,13,元大-土城學府,2024-08-01,9822
5443,均豪,23,10,13,元大-土城學府,2024-08-01,9822
3535,晶彩科,78,66,12,元大-土城學府,2024-08-01,9822
3686,達能,10,0,10,元大-土城學府,2024-08-01,9822
1532,勤美,10,0,10,元大-土城學府,2024-08-01,9822
2236,百達-KY,10,0,10,元大-土城學府,2024-08-01,9822
8147,正淩,10,0,10,元大-土城學府,2024-08-01,9822
00946,群益科技高息成長,9,0,9,元大-土城學府,2024-08-01,9822
00945B,凱基美國非投等債,12,3,9,元大-土城學府,2024-08-01,9822
1514,亞力,15,6,9,元大-土城學府,2024-08-01,9822
00934,中信成長高股息,8,0,8,元大-土城學府,2024-08-01,9822
2258,鴻華先進-創,8,0,8,元大-土城學府,2024-08-01,9822
4961,天鈺,12,4,8,元大-土城學府,2024-08-01,9822
6116,彩晶,8,0,8,元大-土城學府,2024-08-01,9822
2489,瑞軒,28,21,7,元大-土城學府,2024-08-01,9822
2313,華通,12,5,7,元大-土城學府,2024-08-01,9822
6212,理銘,7,0,7,元大-土城學府,2024-08-01,9822
3019,亞光,8,1,7,元大-土城學府,2024-08-01,9822
2530,華建,7,0,7,元大-土城學府,2024-08-01,9822
2382,廣達,17,11,6,元大-土城學府,2024-08-01,9822
2892,第一金,6,0,6,元大-土城學府,2024-08-01,9822
00632R,元大台灣50反1,446,60,386,元大-土城學府,2024-08-02,9822
00940,元大台灣價值高息,288,6,282,元大-土城學府,2024-08-02,9822
00878,國泰永續高股息,247,4,243,元大-土城學府,2024-08-02,9822
2317,鴻海,208,34,174,元大-土城學府,2024-08-02,9822
00929,復華台灣科技優息,167,50,117,元大-土城學府,2024-08-02,9822
00919,群益台灣精選高息,142,28,114,元大-土城學府,2024-08-02,9822
00934,中信成長高股息,80,7,73,元大-土城學府,2024-08-02,9822
2610,華航,81,9,72,元大-土城學府,2024-08-02,9822
00676R,富邦臺灣加權反1,68,0,68,元大-土城學府,2024-08-02,9822
00687B,國泰20年美債,65,0,65,元大-土城學府,2024-08-02,9822
0056,元大高股息,67,14,53,元大-土城學府,2024-08-02,9822
2365,昆盈,128,76,52,元大-土城學府,2024-08-02,9822
2362,藍天,57,6,51,元大-土城學府,2024-08-02,9822
6706,惠特,50,0,50,元大-土城學府,2024-08-02,9822
00679B,元大美債20年,52,5,47,元大-土城學府,2024-08-02,9822
00680L,元大美債20正2,48,1,47,元大-土城學府,2024-08-02,9822
5512,力麒,46,0,46,元大-土城學府,2024-08-02,9822
00688L,國泰20年美債正2,44,0,44,元大-土城學府,2024-08-02,9822
00918,大華優利高填息30,42,0,42,元大-土城學府,2024-08-02,9822
00900,富邦特選高股息30,41,0,41,元大-土城學府,2024-08-02,9822
3024,憶聲,45,6,39,元大-土城學府,2024-08-02,9822
00946,群益科技高息成長,38,1,37,元大-土城學府,2024-08-02,9822
00932,兆豐永續高息等權,37,0,37,元大-土城學府,2024-08-02,9822
2330,台積電,37,3,34,元大-土城學府,2024-08-02,9822
1101,台泥,38,4,34,元大-土城學府,2024-08-02,9822
00951,台新日本半導體,32,0,32,元大-土城學府,2024-08-02,9822
00881,國泰台灣5G+,43,12,31,元大-土城學府,2024-08-02,9822
9945,潤泰新,41,10,31,元大-土城學府,2024-08-02,9822
2885,元大金,30,0,30,元大-土城學府,2024-08-02,9822
00927,群益半導體收益,28,0,28,元大-土城學府,2024-08-02,9822
6215,和椿,27,1,26,元大-土城學府,2024-08-02,9822
3231,緯創,32,8,24,元大-土城學府,2024-08-02,9822
2891,中信金,29,6,23,元大-土城學府,2024-08-02,9822
00935,野村臺灣新科技50,29,6,23,元大-土城學府,2024-08-02,9822
1455,集盛,28,5,23,元大-土城學府,2024-08-02,9822
2344,華邦電,61,39,22,元大-土城學府,2024-08-02,9822
2498,宏達電,22,0,22,元大-土城學府,2024-08-02,9822
2349,錸德,36,15,21,元大-土城學府,2024-08-02,9822
2301,光寶科,30,10,20,元大-土城學府,2024-08-02,9822
5880,合庫金,21,1,20,元大-土城學府,2024-08-02,9822
3363,上詮,31,11,20,元大-土城學府,2024-08-02,9822
00933B,國泰10Y+金融債,18,0,18,元大-土城學府,2024-08-02,9822
5351,鈺創,18,0,18,元大-土城學府,2024-08-02,9822
00939,統一台灣高息動能,19,1,18,元大-土城學府,2024-08-02,9822
8096,擎亞,28,11,17,元大-土城學府,2024-08-02,9822
0050,元大台灣50,17,0,17,元大-土城學府,2024-08-02,9822
00936,台新永續高息中小,27,10,17,元大-土城學府,2024-08-02,9822
2382,廣達,18,2,16,元大-土城學府,2024-08-02,9822
3037,欣興,34,18,16,元大-土城學府,2024-08-02,9822
00905,FT臺灣Smart,16,0,16,元大-土城學府,2024-08-02,9822
00940,元大台灣價值高息,724,59,665,元大-土城學府,2024-08-05,9822
00929,復華台灣科技優息,703,116,587,元大-土城學府,2024-08-05,9822
6770,力積電,124,6,118,元大-土城學府,2024-08-05,9822
00919,群益台灣精選高息,199,92,107,元大-土城學府,2024-08-05,9822
6116,彩晶,105,0,105,元大-土城學府,2024-08-05,9822
2317,鴻海,117,25,92,元大-土城學府,2024-08-05,9822
00878,國泰永續高股息,313,225,88,元大-土城學府,2024-08-05,9822
00891,中信關鍵半導體,83,0,83,元大-土城學府,2024-08-05,9822
2409,友達,91,21,70,元大-土城學府,2024-08-05,9822
00936,台新永續高息中小,73,4,69,元大-土城學府,2024-08-05,9822
3481,群創,98,36,62,元大-土城學府,2024-08-05,9822
00918,大華優利高填息30,92,32,60,元大-土城學府,2024-08-05,9822
2002,中鋼,58,4,54,元大-土城學府,2024-08-05,9822
2885,元大金,55,2,53,元大-土城學府,2024-08-05,9822
00937B,群益ESG投等債20,73,22,51,元大-土城學府,2024-08-05,9822
0056,元大高股息,109,60,49,元大-土城學府,2024-08-05,9822
1301,台塑,55,7,48,元大-土城學府,2024-08-05,9822
2382,廣達,54,10,44,元大-土城學府,2024-08-05,9822
00932,兆豐永續高息等權,44,0,44,元大-土城學府,2024-08-05,9822
1313,聯成,41,0,41,元大-土城學府,2024-08-05,9822
00927,群益半導體收益,39,0,39,元大-土城學府,2024-08-05,9822
2330,台積電,53,17,36,元大-土城學府,2024-08-05,9822
2891,中信金,34,1,33,元大-土城學府,2024-08-05,9822
00933B,國泰10Y+金融債,68,36,32,元大-土城學府,2024-08-05,9822
1303,南亞,36,4,32,元大-土城學府,2024-08-05,9822
6443,元晶,30,0,30,元大-土城學府,2024-08-05,9822
6806,森崴能源,30,0,30,元大-土城學府,2024-08-05,9822
2324,仁寶,28,1,27,元大-土城學府,2024-08-05,9822
5009,榮剛,29,3,26,元大-土城學府,2024-08-05,9822
5474,聰泰,26,0,26,元大-土城學府,2024-08-05,9822
2610,華航,60,35,25,元大-土城學府,2024-08-05,9822
4562,穎漢,42,17,25,元大-土城學府,2024-08-05,9822
2801,彰銀,23,0,23,元大-土城學府,2024-08-05,9822
2515,中工,33,11,22,元大-土城學府,2024-08-05,9822
2308,台達電,30,9,21,元大-土城學府,2024-08-05,9822
2834,臺企銀,29,8,21,元大-土城學府,2024-08-05,9822
00631L,元大台灣50正2,23,2,21,元大-土城學府,2024-08-05,9822
006208,富邦台50,25,5,20,元大-土城學府,2024-08-05,9822
1312,國喬,20,0,20,元大-土城學府,2024-08-05,9822
00915,凱基優選高股息30,20,0,20,元大-土城學府,2024-08-05,9822
0050,元大台灣50,22,2,20,元大-土城學府,2024-08-05,9822
00646,元大S＆P500,19,0,19,元大-土城學府,2024-08-05,9822
2812,台中銀,18,0,18,元大-土城學府,2024-08-05,9822
00715L,期街口布蘭特正2,18,0,18,元大-土城學府,2024-08-05,9822
00902,中信電池及儲能,19,1,18,元大-土城學府,2024-08-05,9822
00923,群益台ESG低碳50,18,0,18,元大-土城學府,2024-08-05,9822
2892,第一金,17,0,17,元大-土城學府,2024-08-05,9822
1528,恩德,18,1,17,元大-土城學府,2024-08-05,9822
00881,國泰台灣5G+,17,0,17,元大-土城學府,2024-08-05,9822
2301,光寶科,30,15,15,元大-土城學府,2024-08-05,9822
2888,新光金,603,4,599,元大-土城學府,2024-08-06,9822
00688L,國泰20年美債正2,251,48,203,元大-土城學府,2024-08-06,9822
00940,元大台灣價值高息,262,111,151,元大-土城學府,2024-08-06,9822
00878,國泰永續高股息,134,18,116,元大-土城學府,2024-08-06,9822
00676R,富邦臺灣加權反1,150,60,90,元大-土城學府,2024-08-06,9822
00919,群益台灣精選高息,70,3,67,元大-土城學府,2024-08-06,9822
00946,群益科技高息成長,56,0,56,元大-土城學府,2024-08-06,9822
00932,兆豐永續高息等權,49,1,48,元大-土城學府,2024-08-06,9822
0050,元大台灣50,53,11,42,元大-土城學府,2024-08-06,9822
2337,旺宏,54,16,38,元大-土城學府,2024-08-06,9822
2356,英業達,78,43,35,元大-土城學府,2024-08-06,9822
8096,擎亞,53,19,34,元大-土城學府,2024-08-06,9822
00637L,元大滬深300正2,40,10,30,元大-土城學府,2024-08-06,9822
2515,中工,34,4,30,元大-土城學府,2024-08-06,9822
4909,新復興,31,2,29,元大-土城學府,2024-08-06,9822
3402,漢科,27,0,27,元大-土城學府,2024-08-06,9822
2365,昆盈,101,75,26,元大-土城學府,2024-08-06,9822
2609,陽明,60,34,26,元大-土城學府,2024-08-06,9822
00641R,富邦日本反1,30,5,25,元大-土城學府,2024-08-06,9822
00795B,中信美國公債20年,30,6,24,元大-土城學府,2024-08-06,9822
9105,泰金寶-DR,48,24,24,元大-土城學府,2024-08-06,9822
00923,群益台ESG低碳50,22,1,21,元大-土城學府,2024-08-06,9822
00671R,富邦NASDAQ反1,20,0,20,元大-土城學府,2024-08-06,9822
1504,東元,23,3,20,元大-土城學府,2024-08-06,9822
2891,中信金,30,11,19,元大-土城學府,2024-08-06,9822
8271,宇瞻,19,0,19,元大-土城學府,2024-08-06,9822
2481,強茂,18,0,18,元大-土城學府,2024-08-06,9822
3607,谷崧,18,0,18,元大-土城學府,2024-08-06,9822
2615,萬海,45,28,17,元大-土城學府,2024-08-06,9822
2002,中鋼,36,20,16,元大-土城學府,2024-08-06,9822
006208,富邦台50,24,8,16,元大-土城學府,2024-08-06,9822
00881,國泰台灣5G+,20,5,15,元大-土城學府,2024-08-06,9822
2886,兆豐金,16,1,15,元大-土城學府,2024-08-06,9822
2353,宏��,18,5,13,元大-土城學府,2024-08-06,9822
2834,臺企銀,14,1,13,元大-土城學府,2024-08-06,9822
2545,皇翔,12,0,12,元大-土城學府,2024-08-06,9822
00642U,期元大S＆P石油,12,0,12,元大-土城學府,2024-08-06,9822
00715L,期街口布蘭特正2,12,0,12,元大-土城學府,2024-08-06,9822
3374,精材,15,3,12,元大-土城學府,2024-08-06,9822
8076,伍豐,12,0,12,元大-土城學府,2024-08-06,9822
3189,景碩,19,8,11,元大-土城學府,2024-08-06,9822
2392,正崴,13,3,10,元大-土城學府,2024-08-06,9822
2441,超豐,10,0,10,元大-土城學府,2024-08-06,9822
00882,中信中國高股息,10,0,10,元大-土城學府,2024-08-06,9822
00915,凱基優選高股息30,12,2,10,元大-土城學府,2024-08-06,9822
1313,聯成,10,0,10,元大-土城學府,2024-08-06,9822
1522,堤維西,10,0,10,元大-土城學府,2024-08-06,9822
3052,夆典,10,0,10,元大-土城學府,2024-08-06,9822
6188,廣明,13,4,9,元大-土城學府,2024-08-06,9822
2408,南亞科,12,3,9,元大-土城學府,2024-08-06,9822
00632R,元大台灣50反1,805,33,772,元大-土城學府,2024-08-07,9822
00946,群益科技高息成長,129,10,119,元大-土城學府,2024-08-07,9822
00688L,國泰20年美債正2,103,5,98,元大-土城學府,2024-08-07,9822
00937B,群益ESG投等債20,123,26,97,元大-土城學府,2024-08-07,9822
00878,國泰永續高股息,121,55,66,元大-土城學府,2024-08-07,9822
00940,元大台灣價值高息,119,63,56,元大-土城學府,2024-08-07,9822
00641R,富邦日本反1,55,0,55,元大-土城學府,2024-08-07,9822
2888,新光金,52,5,47,元大-土城學府,2024-08-07,9822
00929,復華台灣科技優息,288,241,47,元大-土城學府,2024-08-07,9822
00637L,元大滬深300正2,42,0,42,元大-土城學府,2024-08-07,9822
0056,元大高股息,49,13,36,元大-土城學府,2024-08-07,9822
2883,凱基金,41,11,30,元大-土城學府,2024-08-07,9822
3019,亞光,56,26,30,元大-土城學府,2024-08-07,9822
2834,臺企銀,50,21,29,元大-土城學府,2024-08-07,9822
00795B,中信美國公債20年,30,3,27,元大-土城學府,2024-08-07,9822
00900,富邦特選高股息30,26,0,26,元大-土城學府,2024-08-07,9822
00936,台新永續高息中小,25,2,23,元大-土城學府,2024-08-07,9822
6213,聯茂,25,3,22,元大-土城學府,2024-08-07,9822
8054,安國,102,81,21,元大-土城學府,2024-08-07,9822
00680L,元大美債20正2,58,38,20,元大-土城學府,2024-08-07,9822
6197,佳必琪,20,0,20,元大-土城學府,2024-08-07,9822
9105,泰金寶-DR,23,4,19,元大-土城學府,2024-08-07,9822
2317,鴻海,64,48,16,元大-土城學府,2024-08-07,9822
2892,第一金,17,1,16,元大-土城學府,2024-08-07,9822
00934,中信成長高股息,24,8,16,元大-土城學府,2024-08-07,9822
4540,全球傳動,28,12,16,元大-土城學府,2024-08-07,9822
00881,國泰台灣5G+,21,8,13,元大-土城學府,2024-08-07,9822
8076,伍豐,12,0,12,元大-土城學府,2024-08-07,9822
1313,聯成,11,0,11,元大-土城學府,2024-08-07,9822
8028,昇陽半導體,11,0,11,元大-土城學府,2024-08-07,9822
00676R,富邦臺灣加權反1,11,0,11,元大-土城學府,2024-08-07,9822
00642U,期元大S＆P石油,10,0,10,元大-土城學府,2024-08-07,9822
2338,光罩,10,0,10,元大-土城學府,2024-08-07,9822
3363,上詮,10,0,10,元大-土城學府,2024-08-07,9822
3707,漢磊,10,0,10,元大-土城學府,2024-08-07,9822
2501,國建,10,0,10,元大-土城學府,2024-08-07,9822
00919,群益台灣精選高息,39,29,10,元大-土城學府,2024-08-07,9822
2412,中華電,11,1,10,元大-土城學府,2024-08-07,9822
00687B,國泰20年美債,23,14,9,元大-土城學府,2024-08-07,9822
00857B,永豐20年美公債,12,3,9,元大-土城學府,2024-08-07,9822
00927,群益半導體收益,10,1,9,元大-土城學府,2024-08-07,9822
3481,群創,22,14,8,元大-土城學府,2024-08-07,9822
3037,欣興,15,7,8,元大-土城學府,2024-08-07,9822
00764B,群益25年美債,8,0,8,元大-土城學府,2024-08-07,9822
3025,星通,8,0,8,元大-土城學府,2024-08-07,9822
9945,潤泰新,8,0,8,元大-土城學府,2024-08-07,9822
6538,倉和,7,0,7,元大-土城學府,2024-08-07,9822
2887,台新金,7,0,7,元大-土城學府,2024-08-07,9822
1540,喬福,41,34,7,元大-土城學府,2024-08-07,9822
4906,正文,9,2,7,元大-土城學府,2024-08-07,9822
00929,復華台灣科技優息,290,1,289,元大-土城學府,2024-08-08,9822
00937B,群益ESG投等債20,163,20,143,元大-土城學府,2024-08-08,9822
2486,一詮,91,2,89,元大-土城學府,2024-08-08,9822
00878,國泰永續高股息,90,5,85,元大-土城學府,2024-08-08,9822
00688L,國泰20年美債正2,81,9,72,元大-土城學府,2024-08-08,9822
00902,中信電池及儲能,61,0,61,元大-土城學府,2024-08-08,9822
2834,臺企銀,52,0,52,元大-土城學府,2024-08-08,9822
2886,兆豐金,47,0,47,元大-土城學府,2024-08-08,9822
2317,鴻海,92,48,44,元大-土城學府,2024-08-08,9822
3711,日月光投控,46,3,43,元大-土城學府,2024-08-08,9822
00680L,元大美債20正2,78,40,38,元大-土城學府,2024-08-08,9822
2609,陽明,43,6,37,元大-土城學府,2024-08-08,9822
6197,佳必琪,33,0,33,元大-土城學府,2024-08-08,9822
00671R,富邦NASDAQ反1,30,0,30,元大-土城學府,2024-08-08,9822
3019,亞光,39,12,27,元大-土城學府,2024-08-08,9822
00900,富邦特選高股息30,27,0,27,元大-土城學府,2024-08-08,9822
3033,威健,30,3,27,元大-土城學府,2024-08-08,9822
0056,元大高股息,31,4,27,元大-土城學府,2024-08-08,9822
2312,金寶,22,0,22,元大-土城學府,2024-08-08,9822
2324,仁寶,22,0,22,元大-土城學府,2024-08-08,9822
1540,喬福,35,14,21,元大-土城學府,2024-08-08,9822
00881,國泰台灣5G+,21,1,20,元大-土城學府,2024-08-08,9822
2615,萬海,52,32,20,元大-土城學府,2024-08-08,9822
1522,堤維西,21,1,20,元大-土城學府,2024-08-08,9822
3015,全漢,20,0,20,元大-土城學府,2024-08-08,9822
2892,第一金,19,2,17,元大-土城學府,2024-08-08,9822
00905,FT臺灣Smart,16,0,16,元大-土城學府,2024-08-08,9822
00933B,國泰10Y+金融債,14,0,14,元大-土城學府,2024-08-08,9822
4526,東台,15,1,14,元大-土城學府,2024-08-08,9822
9906,欣巴巴,15,1,14,元大-土城學府,2024-08-08,9822
2891,中信金,18,5,13,元大-土城學府,2024-08-08,9822
2258,鴻華先進-創,13,0,13,元大-土城學府,2024-08-08,9822
6213,聯茂,14,1,13,元大-土城學府,2024-08-08,9822
4510,高鋒,99,87,12,元大-土城學府,2024-08-08,9822
2330,台積電,16,4,12,元大-土城學府,2024-08-08,9822
3048,益登,13,2,11,元大-土城學府,2024-08-08,9822
3535,晶彩科,82,71,11,元大-土城學府,2024-08-08,9822
2344,華邦電,10,0,10,元大-土城學府,2024-08-08,9822
00931B,統一美債20年,10,0,10,元大-土城學府,2024-08-08,9822
4540,全球傳動,10,0,10,元大-土城學府,2024-08-08,9822
5481,新華,11,1,10,元大-土城學府,2024-08-08,9822
3260,威剛,14,5,9,元大-土城學府,2024-08-08,9822
2417,圓剛,11,2,9,元大-土城學府,2024-08-08,9822
3189,景碩,12,3,9,元大-土城學府,2024-08-08,9822
00927,群益半導體收益,8,0,8,元大-土城學府,2024-08-08,9822
6274,台燿,8,0,8,元大-土城學府,2024-08-08,9822
00679B,元大美債20年,34,27,7,元大-土城學府,2024-08-08,9822
2618,長榮航,7,0,7,元大-土城學府,2024-08-08,9822
3312,弘憶股,8,1,7,元大-土城學府,2024-08-08,9822
00720B,元大投資級公司債,7,1,6,元大-土城學府,2024-08-08,9822
00632R,元大台灣50反1,1041,21,1020,元大-土城學府,2024-08-09,9822
00679B,元大美債20年,331,31,300,元大-土城學府,2024-08-09,9822
00937B,群益ESG投等債20,236,20,216,元大-土城學府,2024-08-09,9822
3019,亞光,98,29,69,元大-土城學府,2024-08-09,9822
00948B,中信優息投資級債,83,30,53,元大-土城學府,2024-08-09,9822
6158,禾昌,50,0,50,元大-土城學府,2024-08-09,9822
00688L,國泰20年美債正2,45,0,45,元大-土城學府,2024-08-09,9822
00919,群益台灣精選高息,40,2,38,元大-土城學府,2024-08-09,9822
00878,國泰永續高股息,41,6,35,元大-土城學府,2024-08-09,9822
4909,新復興,54,22,32,元大-土城學府,2024-08-09,9822
00751B,元大AAA至A公司債,32,0,32,元大-土城學府,2024-08-09,9822
00753L,中信中國50正2,30,0,30,元大-土城學府,2024-08-09,9822
00881,國泰台灣5G+,29,0,29,元大-土城學府,2024-08-09,9822
00680L,元大美債20正2,40,12,28,元大-土城學府,2024-08-09,9822
00795B,中信美國公債20年,27,1,26,元大-土城學府,2024-08-09,9822
2477,美隆電,20,0,20,元大-土城學府,2024-08-09,9822
00936,台新永續高息中小,20,1,19,元大-土城學府,2024-08-09,9822
2609,陽明,48,30,18,元大-土城學府,2024-08-09,9822
3167,大量,16,1,15,元大-土城學府,2024-08-09,9822
6901,鑽石投資,15,0,15,元大-土城學府,2024-08-09,9822
00947,台新臺灣IC設計,14,0,14,元大-土城學府,2024-08-09,9822
6257,矽格,15,1,14,元大-土城學府,2024-08-09,9822
2615,萬海,31,17,14,元大-土城學府,2024-08-09,9822
1314,中石化,13,0,13,元大-土城學府,2024-08-09,9822
3189,景碩,20,7,13,元大-土城學府,2024-08-09,9822
3010,華立,13,1,12,元大-土城學府,2024-08-09,9822
2353,宏��,46,35,11,元大-土城學府,2024-08-09,9822
00931B,統一美債20年,11,0,11,元大-土城學府,2024-08-09,9822
4526,東台,12,1,11,元大-土城學府,2024-08-09,9822
4961,天鈺,14,3,11,元大-土城學府,2024-08-09,9822
3715,定穎投控,31,20,11,元大-土城學府,2024-08-09,9822
00882,中信中國高股息,10,0,10,元大-土城學府,2024-08-09,9822
00664R,國泰臺灣加權反1,10,0,10,元大-土城學府,2024-08-09,9822
00772B,中信高評級公司債,10,0,10,元大-土城學府,2024-08-09,9822
2486,一詮,95,85,10,元大-土城學府,2024-08-09,9822
2524,京城,10,0,10,元大-土城學府,2024-08-09,9822
4114,健喬,10,0,10,元大-土城學府,2024-08-09,9822
2204,中華,10,0,10,元大-土城學府,2024-08-09,9822
1536,和大,16,7,9,元大-土城學府,2024-08-09,9822
2349,錸德,11,2,9,元大-土城學府,2024-08-09,9822
5905,南仁湖,11,2,9,元大-土城學府,2024-08-09,9822
3044,健鼎,9,0,9,元大-土城學府,2024-08-09,9822
2399,映泰,10,2,8,元大-土城學府,2024-08-09,9822
6275,元山,8,0,8,元大-土城學府,2024-08-09,9822
2542,興富發,8,1,7,元大-土城學府,2024-08-09,9822
00724B,群益投資級金融債,7,0,7,元大-土城學府,2024-08-09,9822
00715L,期街口布蘭特正2,7,0,7,元大-土城學府,2024-08-09,9822
2887,台新金,7,0,7,元大-土城學府,2024-08-09,9822
4167,松瑞藥,7,0,7,元大-土城學府,2024-08-09,9822
2365,昆盈,79,73,6,元大-土城學府,2024-08-09,9822
00940,元大台灣價值高息,1549,1032,517,元大-土城學府,2024-08-12,9822
00632R,元大台灣50反1,499,103,396,元大-土城學府,2024-08-12,9822
00929,復華台灣科技優息,94,12,82,元大-土城學府,2024-08-12,9822
00680L,元大美債20正2,63,0,63,元大-土城學府,2024-08-12,9822
00679B,元大美債20年,65,8,57,元大-土城學府,2024-08-12,9822
00937B,群益ESG投等債20,54,0,54,元大-土城學府,2024-08-12,9822
2610,華航,124,81,43,元大-土城學府,2024-08-12,9822
00948B,中信優息投資級債,40,0,40,元大-土城學府,2024-08-12,9822
6215,和椿,43,4,39,元大-土城學府,2024-08-12,9822
4909,新復興,39,6,33,元大-土城學府,2024-08-12,9822
1455,集盛,38,10,28,元大-土城學府,2024-08-12,9822
2359,所羅門,37,11,26,元大-土城學府,2024-08-12,9822
00878,國泰永續高股息,70,50,20,元大-土城學府,2024-08-12,9822
2313,華通,24,5,19,元大-土城學府,2024-08-12,9822
2885,元大金,18,0,18,元大-土城學府,2024-08-12,9822
3663,鑫科,61,43,18,元大-土城學府,2024-08-12,9822
4562,穎漢,49,32,17,元大-土城學府,2024-08-12,9822
4973,廣穎,16,0,16,元大-土城學府,2024-08-12,9822
2891,中信金,15,1,14,元大-土城學府,2024-08-12,9822
2481,強茂,13,0,13,元大-土城學府,2024-08-12,9822
8105,凌巨,14,1,13,元大-土城學府,2024-08-12,9822
00688L,國泰20年美債正2,12,0,12,元大-土城學府,2024-08-12,9822
1785,光洋科,26,15,11,元大-土城學府,2024-08-12,9822
2312,金寶,35,24,11,元大-土城學府,2024-08-12,9822
3548,兆利,11,0,11,元大-土城學府,2024-08-12,9822
3686,達能,11,0,11,元大-土城學府,2024-08-12,9822
00951,台新日本半導體,10,0,10,元大-土城學府,2024-08-12,9822
1463,強盛新,10,0,10,元大-土城學府,2024-08-12,9822
1721,三晃,10,0,10,元大-土城學府,2024-08-12,9822
2314,台揚,10,0,10,元大-土城學府,2024-08-12,9822
2409,友達,10,0,10,元大-土城學府,2024-08-12,9822
4555,氣立,10,0,10,元大-土城學府,2024-08-12,9822
3535,晶彩科,9,0,9,元大-土城學府,2024-08-12,9822
00900,富邦特選高股息30,11,2,9,元大-土城學府,2024-08-12,9822
00931B,統一美債20年,9,0,9,元大-土城學府,2024-08-12,9822
1597,直得,13,4,9,元大-土城學府,2024-08-12,9822
1608,華榮,14,5,9,元大-土城學府,2024-08-12,9822
8374,羅昇,25,16,9,元大-土城學府,2024-08-12,9822
1314,中石化,8,0,8,元大-土城學府,2024-08-12,9822
00919,群益台灣精選高息,16,9,7,元大-土城學府,2024-08-12,9822
4540,全球傳動,11,4,7,元大-土城學府,2024-08-12,9822
6596,寬宏藝術,7,0,7,元大-土城學府,2024-08-12,9822
00936,台新永續高息中小,8,1,7,元大-土城學府,2024-08-12,9822
4513,福裕,9,3,6,元大-土城學府,2024-08-12,9822
00946,群益科技高息成長,6,0,6,元大-土城學府,2024-08-12,9822
00935,野村臺灣新科技50,6,0,6,元大-土城學府,2024-08-12,9822
00934,中信成長高股息,6,0,6,元大-土城學府,2024-08-12,9822
1795,美時,6,0,6,元大-土城學府,2024-08-12,9822
2349,錸德,11,5,6,元大-土城學府,2024-08-12,9822
3024,憶聲,6,0,6,元大-土城學府,2024-08-12,9822
00632R,元大台灣50反1,250,0,250,元大-土城學府,2024-08-13,9822
00679B,元大美債20年,88,0,88,元大-土城學府,2024-08-13,9822
2486,一詮,69,7,62,元大-土城學府,2024-08-13,9822
2609,陽明,46,7,39,元大-土城學府,2024-08-13,9822
3715,定穎投控,42,6,36,元大-土城學府,2024-08-13,9822
2801,彰銀,33,0,33,元大-土城學府,2024-08-13,9822
2610,華航,87,57,30,元大-土城學府,2024-08-13,9822
4909,新復興,42,12,30,元大-土城學府,2024-08-13,9822
2880,華南金,26,0,26,元大-土城學府,2024-08-13,9822
0056,元大高股息,24,3,21,元大-土城學府,2024-08-13,9822
2891,中信金,22,1,21,元大-土城學府,2024-08-13,9822
1609,大亞,41,21,20,元大-土城學府,2024-08-13,9822
6207,雷科,20,0,20,元大-土城學府,2024-08-13,9822
3324,雙鴻,21,3,18,元大-土城學府,2024-08-13,9822
2886,兆豐金,18,0,18,元大-土城學府,2024-08-13,9822
2615,萬海,37,22,15,元大-土城學府,2024-08-13,9822
2477,美隆電,15,1,14,元大-土城學府,2024-08-13,9822
00687B,國泰20年美債,14,0,14,元大-土城學府,2024-08-13,9822
3227,原相,14,1,13,元大-土城學府,2024-08-13,9822
1513,中興電,17,4,13,元大-土城學府,2024-08-13,9822
00936,台新永續高息中小,13,0,13,元大-土城學府,2024-08-13,9822
2515,中工,13,0,13,元大-土城學府,2024-08-13,9822
00881,國泰台灣5G+,22,10,12,元大-土城學府,2024-08-13,9822
1314,中石化,12,0,12,元大-土城學府,2024-08-13,9822
3663,鑫科,65,53,12,元大-土城學府,2024-08-13,9822
4714,永捷,13,2,11,元大-土城學府,2024-08-13,9822
00919,群益台灣精選高息,12,1,11,元大-土城學府,2024-08-13,9822
2603,長榮,11,0,11,元大-土城學府,2024-08-13,9822
00795B,中信美國公債20年,10,0,10,元大-土城學府,2024-08-13,9822
00948B,中信優息投資級債,10,0,10,元大-土城學府,2024-08-13,9822
1463,強盛新,10,0,10,元大-土城學府,2024-08-13,9822
6175,立敦,10,0,10,元大-土城學府,2024-08-13,9822
8926,台汽電,10,0,10,元大-土城學府,2024-08-13,9822
00878,國泰永續高股息,28,18,10,元大-土城學府,2024-08-13,9822
9945,潤泰新,11,2,9,元大-土城學府,2024-08-13,9822
00937B,群益ESG投等債20,9,0,9,元大-土城學府,2024-08-13,9822
2382,廣達,10,3,7,元大-土城學府,2024-08-13,9822
2355,敬鵬,7,0,7,元大-土城學府,2024-08-13,9822
2618,長榮航,46,39,7,元大-土城學府,2024-08-13,9822
6285,啟��,9,2,7,元大-土城學府,2024-08-13,9822
00697B,元大美債7-10,7,0,7,元大-土城學府,2024-08-13,9822
6743,安普新,7,0,7,元大-土城學府,2024-08-13,9822
2312,金寶,7,1,6,元大-土城學府,2024-08-13,9822
6821,聯寶,6,0,6,元大-土城學府,2024-08-13,9822
3231,緯創,13,7,6,元大-土城學府,2024-08-13,9822
1301,台塑,7,2,5,元大-土城學府,2024-08-13,9822
3691,碩禾,5,0,5,元大-土城學府,2024-08-13,9822
2885,元大金,6,1,5,元大-土城學府,2024-08-13,9822
3013,晟銘電,17,12,5,元大-土城學府,2024-08-13,9822
00680L,元大美債20正2,15,10,5,元大-土城學府,2024-08-13,9822
00939,統一台灣高息動能,1719,1497,222,元大-土城學府,2024-08-14,9822
00688L,國泰20年美債正2,150,60,90,元大-土城學府,2024-08-14,9822
00929,復華台灣科技優息,102,38,64,元大-土城學府,2024-08-14,9822
1101,台泥,68,10,58,元大-土城學府,2024-08-14,9822
1608,華榮,51,3,48,元大-土城學府,2024-08-14,9822
00937B,群益ESG投等債20,47,14,33,元大-土城學府,2024-08-14,9822
2356,英業達,49,17,32,元大-土城學府,2024-08-14,9822
00881,國泰台灣5G+,29,2,27,元大-土城學府,2024-08-14,9822
00900,富邦特選高股息30,23,0,23,元大-土城學府,2024-08-14,9822
4909,新復興,43,21,22,元大-土城學府,2024-08-14,9822
5426,振發,22,0,22,元大-土城學府,2024-08-14,9822
3044,健鼎,21,0,21,元大-土城學府,2024-08-14,9822
2615,萬海,31,11,20,元大-土城學府,2024-08-14,9822
2609,陽明,34,15,19,元大-土城學府,2024-08-14,9822
3227,原相,18,0,18,元大-土城學府,2024-08-14,9822
2402,毅嘉,22,5,17,元大-土城學府,2024-08-14,9822
1609,大亞,18,2,16,元大-土城學府,2024-08-14,9822
8076,伍豐,20,4,16,元大-土城學府,2024-08-14,9822
00936,台新永續高息中小,24,9,15,元大-土城學府,2024-08-14,9822
4533,協易機,16,2,14,元大-土城學府,2024-08-14,9822
2603,長榮,13,1,12,元大-土城學府,2024-08-14,9822
4561,健椿,22,10,12,元大-土城學府,2024-08-14,9822
2618,長榮航,14,2,12,元大-土城學府,2024-08-14,9822
00641R,富邦日本反1,10,0,10,元大-土城學府,2024-08-14,9822
00753L,中信中國50正2,10,0,10,元大-土城學府,2024-08-14,9822
3303,岱稜,14,4,10,元大-土城學府,2024-08-14,9822
5512,力麒,10,0,10,元大-土城學府,2024-08-14,9822
6108,競國,10,0,10,元大-土城學府,2024-08-14,9822
6142,友勁,10,0,10,元大-土城學府,2024-08-14,9822
6418,詠昇,10,0,10,元大-土城學府,2024-08-14,9822
9955,佳龍,10,0,10,元大-土城學府,2024-08-14,9822
2002,中鋼,15,6,9,元大-土城學府,2024-08-14,9822
1514,亞力,15,6,9,元大-土城學府,2024-08-14,9822
00720B,元大投資級公司債,10,1,9,元大-土城學府,2024-08-14,9822
00927,群益半導體收益,12,3,9,元大-土城學府,2024-08-14,9822
2312,金寶,10,1,9,元大-土城學府,2024-08-14,9822
3202,樺晟,9,0,9,元大-土城學府,2024-08-14,9822
8071,能率網通,20,11,9,元大-土城學府,2024-08-14,9822
4906,正文,8,0,8,元大-土城學府,2024-08-14,9822
3607,谷崧,9,1,8,元大-土城學府,2024-08-14,9822
4562,穎漢,41,34,7,元大-土城學府,2024-08-14,9822
6274,台燿,7,0,7,元大-土城學府,2024-08-14,9822
3548,兆利,7,0,7,元大-土城學府,2024-08-14,9822
5443,均豪,16,9,7,元大-土城學府,2024-08-14,9822
6269,台郡,6,0,6,元大-土城學府,2024-08-14,9822
00932,兆豐永續高息等權,8,2,6,元大-土城學府,2024-08-14,9822
00948B,中信優息投資級債,6,0,6,元大-土城學府,2024-08-14,9822
1309,台達化,6,0,6,元大-土城學府,2024-08-14,9822
1536,和大,13,7,6,元大-土城學府,2024-08-14,9822
2367,燿華,7,1,6,元大-土城學府,2024-08-14,9822
9105,泰金寶-DR,505,27,478,元大-土城學府,2024-08-15,9822
00934,中信成長高股息,1292,873,419,元大-土城學府,2024-08-15,9822
00679B,元大美債20年,181,4,177,元大-土城學府,2024-08-15,9822
00632R,元大台灣50反1,148,2,146,元大-土城學府,2024-08-15,9822
00900,富邦特選高股息30,123,1,122,元大-土城學府,2024-08-15,9822
9945,潤泰新,100,4,96,元大-土城學府,2024-08-15,9822
3645,達邁,96,23,73,元大-土城學府,2024-08-15,9822
00687B,國泰20年美債,69,0,69,元大-土城學府,2024-08-15,9822
00878,國泰永續高股息,80,16,64,元大-土城學府,2024-08-15,9822
00929,復華台灣科技優息,90,58,32,元大-土城學府,2024-08-15,9822
2002,中鋼,32,0,32,元大-土城學府,2024-08-15,9822
2317,鴻海,54,29,25,元大-土城學府,2024-08-15,9822
00948B,中信優息投資級債,23,0,23,元大-土城學府,2024-08-15,9822
1609,大亞,25,3,22,元大-土城學府,2024-08-15,9822
4906,正文,22,0,22,元大-土城學府,2024-08-15,9822
5371,中光電,22,1,21,元大-土城學府,2024-08-15,9822
2801,彰銀,32,11,21,元大-土城學府,2024-08-15,9822
6152,百一,19,0,19,元大-土城學府,2024-08-15,9822
2886,兆豐金,19,0,19,元大-土城學府,2024-08-15,9822
1503,士電,17,0,17,元大-土城學府,2024-08-15,9822
2885,元大金,18,1,17,元大-土城學府,2024-08-15,9822
2327,國巨,15,0,15,元大-土城學府,2024-08-15,9822
1514,亞力,16,2,14,元大-土城學府,2024-08-15,9822
00937B,群益ESG投等債20,43,29,14,元大-土城學府,2024-08-15,9822
2892,第一金,13,0,13,元大-土城學府,2024-08-15,9822
1301,台塑,13,0,13,元大-土城學府,2024-08-15,9822
8096,擎亞,55,43,12,元大-土城學府,2024-08-15,9822
2867,三商壽,11,0,11,元大-土城學府,2024-08-15,9822
3189,景碩,13,2,11,元大-土城學府,2024-08-15,9822
3363,上詮,13,2,11,元大-土城學府,2024-08-15,9822
3581,博磊,11,0,11,元大-土城學府,2024-08-15,9822
00751B,元大AAA至A公司債,10,0,10,元大-土城學府,2024-08-15,9822
00932,兆豐永續高息等權,10,0,10,元大-土城學府,2024-08-15,9822
4561,健椿,27,18,9,元大-土城學府,2024-08-15,9822
3535,晶彩科,9,1,8,元大-土城學府,2024-08-15,9822
2337,旺宏,8,0,8,元大-土城學府,2024-08-15,9822
00936,台新永續高息中小,11,4,7,元大-土城學府,2024-08-15,9822
3663,鑫科,67,60,7,元大-土城學府,2024-08-15,9822
4526,東台,7,0,7,元大-土城學府,2024-08-15,9822
8374,羅昇,32,25,7,元大-土城學府,2024-08-15,9822
00881,國泰台灣5G+,18,12,6,元大-土城學府,2024-08-15,9822
00697B,元大美債7-10,6,0,6,元大-土城學府,2024-08-15,9822
2409,友達,7,1,6,元大-土城學府,2024-08-15,9822
6461,益得,6,0,6,元大-土城學府,2024-08-15,9822
8011,台通,10,4,6,元大-土城學府,2024-08-15,9822
8071,能率網通,9,3,6,元大-土城學府,2024-08-15,9822
4533,協易機,6,0,6,元大-土城學府,2024-08-15,9822
00712,復華富時不動產,5,0,5,元大-土城學府,2024-08-15,9822
2597,潤弘,5,0,5,元大-土城學府,2024-08-15,9822
5483,中美晶,6,1,5,元大-土城學府,2024-08-15,9822
00934,中信成長高股息,189,7,182,元大-土城學府,2024-08-16,9822
00929,復華台灣科技優息,190,38,152,元大-土城學府,2024-08-16,9822
00687B,國泰20年美債,134,16,118,元大-土城學府,2024-08-16,9822
00688L,國泰20年美債正2,120,45,75,元大-土城學府,2024-08-16,9822
3645,達邁,73,2,71,元大-土城學府,2024-08-16,9822
00680L,元大美債20正2,56,15,41,元大-土城學府,2024-08-16,9822
00795B,中信美國公債20年,40,0,40,元大-土城學府,2024-08-16,9822
3607,谷崧,39,0,39,元大-土城學府,2024-08-16,9822
00679B,元大美債20年,90,51,39,元大-土城學府,2024-08-16,9822
8096,擎亞,48,21,27,元大-土城學府,2024-08-16,9822
9955,佳龍,20,0,20,元大-土城學府,2024-08-16,9822
2101,南港,20,1,19,元大-土城學府,2024-08-16,9822
2888,新光金,18,0,18,元大-土城學府,2024-08-16,9822
00933B,國泰10Y+金融債,17,0,17,元大-土城學府,2024-08-16,9822
1618,合機,20,3,17,元大-土城學府,2024-08-16,9822
00857B,永豐20年美公債,15,0,15,元大-土城學府,2024-08-16,9822
00900,富邦特選高股息30,15,0,15,元大-土城學府,2024-08-16,9822
3227,原相,15,1,14,元大-土城學府,2024-08-16,9822
1785,光洋科,16,2,14,元大-土城學府,2024-08-16,9822
2801,彰銀,13,0,13,元大-土城學府,2024-08-16,9822
3587,閎康,13,0,13,元大-土城學府,2024-08-16,9822
00931B,統一美債20年,12,0,12,元大-土城學府,2024-08-16,9822
6187,萬潤,46,34,12,元大-土城學府,2024-08-16,9822
4961,天鈺,11,0,11,元大-土城學府,2024-08-16,9822
00731,復華富時高息低波,11,0,11,元大-土城學府,2024-08-16,9822
2323,中環,20,9,11,元大-土城學府,2024-08-16,9822
4562,穎漢,23,12,11,元大-土城學府,2024-08-16,9822
1314,中石化,21,10,11,元大-土城學府,2024-08-16,9822
00646,元大S＆P500,10,0,10,元大-土城學府,2024-08-16,9822
2417,圓剛,10,0,10,元大-土城學府,2024-08-16,9822
3663,鑫科,30,20,10,元大-土城學府,2024-08-16,9822
5519,隆大,10,0,10,元大-土城學府,2024-08-16,9822
00945B,凱基美國非投等債,9,0,9,元大-土城學府,2024-08-16,9822
3189,景碩,10,1,9,元大-土城學府,2024-08-16,9822
2515,中工,8,0,8,元大-土城學府,2024-08-16,9822
3580,友威科,12,4,8,元大-土城學府,2024-08-16,9822
2615,萬海,8,1,7,元大-土城學府,2024-08-16,9822
00881,國泰台灣5G+,7,0,7,元大-土城學府,2024-08-16,9822
3042,晶技,8,1,7,元大-土城學府,2024-08-16,9822
00918,大華優利高填息30,7,0,7,元大-土城學府,2024-08-16,9822
2354,鴻準,6,0,6,元大-土城學府,2024-08-16,9822
6667,信紘科,6,0,6,元大-土城學府,2024-08-16,9822
3289,宜特,11,5,6,元大-土城學府,2024-08-16,9822
00696B,富邦美債20年,5,0,5,元大-土城學府,2024-08-16,9822
00706L,期元大S＆P日圓正2,5,0,5,元大-土城學府,2024-08-16,9822
00697B,元大美債7-10,5,0,5,元大-土城學府,2024-08-16,9822
1409,新纖,5,0,5,元大-土城學府,2024-08-16,9822
1463,強盛新,5,0,5,元大-土城學府,2024-08-16,9822
1514,亞力,6,1,5,元大-土城學府,2024-08-16,9822
2465,麗臺,5,0,5,元大-土城學府,2024-08-16,9822
8374,羅昇,126,5,121,元大-土城學府,2024-08-19,9822
3645,達邁,75,0,75,元大-土城學府,2024-08-19,9822
00937B,群益ESG投等債20,172,104,68,元大-土城學府,2024-08-19,9822
3047,訊舟,131,68,63,元大-土城學府,2024-08-19,9822
2405,輔信,50,6,44,元大-土城學府,2024-08-19,9822
00646,元大S＆P500,29,1,28,元大-土城學府,2024-08-19,9822
2801,彰銀,27,0,27,元大-土城學府,2024-08-19,9822
2354,鴻準,34,12,22,元大-土城學府,2024-08-19,9822
00632R,元大台灣50反1,47,25,22,元大-土城學府,2024-08-19,9822
00941,中信上游半導體,21,0,21,元大-土城學府,2024-08-19,9822
1463,強盛新,19,0,19,元大-土城學府,2024-08-19,9822
8054,安國,20,1,19,元大-土城學府,2024-08-19,9822
2313,華通,20,2,18,元大-土城學府,2024-08-19,9822
00715L,期街口布蘭特正2,17,0,17,元大-土城學府,2024-08-19,9822
2371,大同,17,0,17,元大-土城學府,2024-08-19,9822
2359,所羅門,45,29,16,元大-土城學府,2024-08-19,9822
4526,東台,22,7,15,元大-土城學府,2024-08-19,9822
8028,昇陽半導體,34,20,14,元大-土城學府,2024-08-19,9822
00857B,永豐20年美公債,13,0,13,元大-土城學府,2024-08-19,9822
00919,群益台灣精選高息,22,10,12,元大-土城學府,2024-08-19,9822
3062,建漢,17,5,12,元大-土城學府,2024-08-19,9822
6139,亞翔,13,1,12,元大-土城學府,2024-08-19,9822
2887,台新金,12,0,12,元大-土城學府,2024-08-19,9822
3231,緯創,14,3,11,元大-土城學府,2024-08-19,9822
00706L,期元大S＆P日圓正2,11,0,11,元大-土城學府,2024-08-19,9822
2888,新光金,27,16,11,元大-土城學府,2024-08-19,9822
9945,潤泰新,10,0,10,元大-土城學府,2024-08-19,9822
00902,中信電池及儲能,10,0,10,元大-土城學府,2024-08-19,9822
00719B,元大美債1-3,10,0,10,元大-土城學府,2024-08-19,9822
00948B,中信優息投資級債,10,0,10,元大-土城學府,2024-08-19,9822
2323,中環,10,0,10,元大-土城學府,2024-08-19,9822
2601,益航,10,0,10,元大-土城學府,2024-08-19,9822
2892,第一金,10,0,10,元大-土城學府,2024-08-19,9822
4561,健椿,10,0,10,元大-土城學府,2024-08-19,9822
5202,力新,10,0,10,元大-土城學府,2024-08-19,9822
3060,銘異,11,1,10,元大-土城學府,2024-08-19,9822
00936,台新永續高息中小,10,0,10,元大-土城學府,2024-08-19,9822
2886,兆豐金,9,0,9,元大-土城學府,2024-08-19,9822
5371,中光電,14,5,9,元大-土城學府,2024-08-19,9822
00931B,統一美債20年,9,0,9,元大-土城學府,2024-08-19,9822
2365,昆盈,33,24,9,元大-土城學府,2024-08-19,9822
3580,友威科,13,4,9,元大-土城學府,2024-08-19,9822
4967,十銓,9,0,9,元大-土城學府,2024-08-19,9822
6770,力積電,11,2,9,元大-土城學府,2024-08-19,9822
3013,晟銘電,13,4,9,元大-土城學府,2024-08-19,9822
3227,原相,8,0,8,元大-土城學府,2024-08-19,9822
2002,中鋼,12,4,8,元大-土城學府,2024-08-19,9822
00712,復華富時不動產,7,0,7,元大-土城學府,2024-08-19,9822
2344,華邦電,9,2,7,元大-土城學府,2024-08-19,9822
2609,陽明,21,14,7,元大-土城學府,2024-08-19,9822
00632R,元大台灣50反1,181,0,181,元大-土城學府,2024-08-20,9822
00937B,群益ESG投等債20,109,7,102,元大-土城學府,2024-08-20,9822
00687B,國泰20年美債,57,3,54,元大-土城學府,2024-08-20,9822
6770,力積電,113,65,48,元大-土城學府,2024-08-20,9822
00878,國泰永續高股息,44,1,43,元大-土城學府,2024-08-20,9822
8028,昇陽半導體,46,8,38,元大-土城學府,2024-08-20,9822
00713,元大台灣高息低波,36,2,34,元大-土城學府,2024-08-20,9822
00945B,凱基美國非投等債,32,0,32,元大-土城學府,2024-08-20,9822
2356,英業達,47,16,31,元大-土城學府,2024-08-20,9822
8358,金居,30,1,29,元大-土城學府,2024-08-20,9822
6443,元晶,24,0,24,元大-土城學府,2024-08-20,9822
00715L,期街口布蘭特正2,21,0,21,元大-土城學府,2024-08-20,9822
2201,裕隆,21,0,21,元大-土城學府,2024-08-20,9822
3062,建漢,22,1,21,元大-土城學府,2024-08-20,9822
00929,復華台灣科技優息,49,29,20,元大-土城學府,2024-08-20,9822
1536,和大,20,0,20,元大-土城學府,2024-08-20,9822
3645,達邁,22,2,20,元大-土城學府,2024-08-20,9822
2317,鴻海,28,11,17,元大-土城學府,2024-08-20,9822
2542,興富發,18,1,17,元大-土城學府,2024-08-20,9822
00931B,統一美債20年,17,0,17,元大-土城學府,2024-08-20,9822
00934,中信成長高股息,17,0,17,元大-土城學府,2024-08-20,9822
3580,友威科,23,6,17,元大-土城學府,2024-08-20,9822
8110,華東,20,3,17,元大-土城學府,2024-08-20,9822
00685L,群益臺灣加權正2,15,0,15,元大-土城學府,2024-08-20,9822
2545,皇翔,16,1,15,元大-土城學府,2024-08-20,9822
2515,中工,14,0,14,元大-土城學府,2024-08-20,9822
0056,元大高股息,12,0,12,元大-土城學府,2024-08-20,9822
5371,中光電,13,1,12,元大-土城學府,2024-08-20,9822
5474,聰泰,12,0,12,元大-土城學府,2024-08-20,9822
2881,富邦金,12,1,11,元大-土城學府,2024-08-20,9822
1303,南亞,15,5,10,元大-土城學府,2024-08-20,9822
00657,國泰日經225,10,0,10,元大-土城學府,2024-08-20,9822
3231,緯創,23,13,10,元大-土城學府,2024-08-20,9822
3260,威剛,10,0,10,元大-土城學府,2024-08-20,9822
3013,晟銘電,21,11,10,元大-土城學府,2024-08-20,9822
2641,正德,9,0,9,元大-土城學府,2024-08-20,9822
00706L,期元大S＆P日圓正2,14,5,9,元大-土城學府,2024-08-20,9822
00935,野村臺灣新科技50,9,0,9,元大-土城學府,2024-08-20,9822
00946,群益科技高息成長,23,14,9,元大-土城學府,2024-08-20,9822
2101,南港,12,3,9,元大-土城學府,2024-08-20,9822
3035,智原,9,0,9,元大-土城學府,2024-08-20,9822
3312,弘憶股,32,23,9,元大-土城學府,2024-08-20,9822
8147,正淩,10,1,9,元大-土城學府,2024-08-20,9822
1528,恩德,8,0,8,元大-土城學府,2024-08-20,9822
2014,中鴻,8,0,8,元大-土城學府,2024-08-20,9822
2365,昆盈,101,93,8,元大-土城學府,2024-08-20,9822
2611,志信,8,0,8,元大-土城學府,2024-08-20,9822
3607,谷崧,8,0,8,元大-土城學府,2024-08-20,9822
2615,萬海,8,0,8,元大-土城學府,2024-08-20,9822
2374,佳能,16,8,8,元大-土城學府,2024-08-20,9822
00632R,元大台灣50反1,258,2,256,元大-土城學府,2024-08-21,9822
2891,中信金,111,0,111,元大-土城學府,2024-08-21,9822
2888,新光金,305,212,93,元大-土城學府,2024-08-21,9822
4105,東洋,89,0,89,元大-土城學府,2024-08-21,9822
00934,中信成長高股息,52,1,51,元大-土城學府,2024-08-21,9822
00907,永豐優息存股,51,0,51,元大-土城學府,2024-08-21,9822
00676R,富邦臺灣加權反1,47,0,47,元大-土城學府,2024-08-21,9822
00688L,國泰20年美債正2,51,10,41,元大-土城學府,2024-08-21,9822
2301,光寶科,40,0,40,元大-土城學府,2024-08-21,9822
8105,凌巨,41,2,39,元大-土城學府,2024-08-21,9822
8101,華冠,30,0,30,元大-土城學府,2024-08-21,9822
00940,元大台灣價值高息,46,18,28,元大-土城學府,2024-08-21,9822
00687B,國泰20年美債,38,11,27,元大-土城學府,2024-08-21,9822
00929,復華台灣科技優息,50,23,27,元大-土城學府,2024-08-21,9822
5905,南仁湖,42,16,26,元大-土城學府,2024-08-21,9822
4906,正文,28,3,25,元大-土城學府,2024-08-21,9822
00878,國泰永續高股息,24,2,22,元大-土城學府,2024-08-21,9822
2356,英業達,37,17,20,元大-土城學府,2024-08-21,9822
3645,達邁,27,7,20,元大-土城學府,2024-08-21,9822
3715,定穎投控,20,0,20,元大-土城學府,2024-08-21,9822
00919,群益台灣精選高息,32,13,19,元大-土城學府,2024-08-21,9822
8054,安國,20,1,19,元大-土城學府,2024-08-21,9822
2365,昆盈,25,7,18,元大-土城學府,2024-08-21,9822
00751B,元大AAA至A公司債,18,2,16,元大-土城學府,2024-08-21,9822
00953B,群益優選非投等債,16,0,16,元大-土城學府,2024-08-21,9822
3535,晶彩科,36,20,16,元大-土城學府,2024-08-21,9822
00753L,中信中國50正2,15,0,15,元大-土城學府,2024-08-21,9822
00700,富邦�琤肭磪�,15,0,15,元大-土城學府,2024-08-21,9822
00918,大華優利高填息30,16,1,15,元大-土城學府,2024-08-21,9822
3548,兆利,16,1,15,元大-土城學府,2024-08-21,9822
8064,東捷,19,4,15,元大-土城學府,2024-08-21,9822
3580,友威科,25,11,14,元大-土城學府,2024-08-21,9822
0056,元大高股息,15,1,14,元大-土城學府,2024-08-21,9822
00680L,元大美債20正2,23,10,13,元大-土城學府,2024-08-21,9822
1503,士電,15,2,13,元大-土城學府,2024-08-21,9822
3712,永崴投控,14,1,13,元大-土城學府,2024-08-21,9822
9945,潤泰新,16,4,12,元大-土城學府,2024-08-21,9822
2317,鴻海,15,3,12,元大-土城學府,2024-08-21,9822
1808,潤隆,12,0,12,元大-土城學府,2024-08-21,9822
2312,金寶,15,3,12,元大-土城學府,2024-08-21,9822
00715L,期街口布蘭特正2,11,0,11,元大-土城學府,2024-08-21,9822
3050,鈺德,11,0,11,元大-土城學府,2024-08-21,9822
00902,中信電池及儲能,20,10,10,元大-土城學府,2024-08-21,9822
00650L,復華香港正2,10,0,10,元大-土城學府,2024-08-21,9822
2867,三商壽,20,10,10,元大-土城學府,2024-08-21,9822
6609,瀧澤科,12,2,10,元大-土城學府,2024-08-21,9822
9938,百和,10,0,10,元大-土城學府,2024-08-21,9822
3037,欣興,12,3,9,元大-土城學府,2024-08-21,9822
00706L,期元大S＆P日圓正2,9,0,9,元大-土城學府,2024-08-21,9822
2331,精英,9,0,9,元大-土城學府,2024-08-21,9822
00632R,元大台灣50反1,500,20,480,元大-土城學府,2024-08-22,9822
2897,王道銀行,351,10,341,元大-土城學府,2024-08-22,9822
2890,永豐金,120,0,120,元大-土城學府,2024-08-22,9822
0056,元大高股息,125,5,120,元大-土城學府,2024-08-22,9822
00929,復華台灣科技優息,111,24,87,元大-土城學府,2024-08-22,9822
3047,訊舟,80,8,72,元大-土城學府,2024-08-22,9822
1449,佳和,70,1,69,元大-土城學府,2024-08-22,9822
00687B,國泰20年美債,60,6,54,元大-土城學府,2024-08-22,9822
2891,中信金,56,3,53,元大-土城學府,2024-08-22,9822
00953B,群益優選非投等債,48,0,48,元大-土城學府,2024-08-22,9822
2349,錸德,165,119,46,元大-土城學府,2024-08-22,9822
00937B,群益ESG投等債20,51,9,42,元大-土城學府,2024-08-22,9822
4105,東洋,30,0,30,元大-土城學府,2024-08-22,9822
3013,晟銘電,31,7,24,元大-土城學府,2024-08-22,9822
2365,昆盈,34,13,21,元大-土城學府,2024-08-22,9822
00715L,期街口布蘭特正2,21,0,21,元大-土城學府,2024-08-22,9822
00945B,凱基美國非投等債,20,0,20,元大-土城學府,2024-08-22,9822
8234,新漢,26,6,20,元大-土城學府,2024-08-22,9822
3227,原相,45,26,19,元大-土城學府,2024-08-22,9822
2610,華航,16,0,16,元大-土城學府,2024-08-22,9822
8374,羅昇,23,7,16,元大-土城學府,2024-08-22,9822
00946,群益科技高息成長,15,0,15,元大-土城學府,2024-08-22,9822
5371,中光電,26,11,15,元大-土城學府,2024-08-22,9822
2515,中工,14,0,14,元大-土城學府,2024-08-22,9822
6139,亞翔,25,12,13,元大-土城學府,2024-08-22,9822
3019,亞光,47,34,13,元大-土城學府,2024-08-22,9822
8096,擎亞,54,42,12,元大-土城學府,2024-08-22,9822
00713,元大台灣高息低波,12,0,12,元大-土城學府,2024-08-22,9822
2885,元大金,11,0,11,元大-土城學府,2024-08-22,9822
2374,佳能,12,1,11,元大-土城學府,2024-08-22,9822
2883,凱基金,11,0,11,元大-土城學府,2024-08-22,9822
6207,雷科,11,0,11,元大-土城學府,2024-08-22,9822
1609,大亞,11,1,10,元大-土城學府,2024-08-22,9822
2851,中再保,11,1,10,元大-土城學府,2024-08-22,9822
3455,由田,10,0,10,元大-土城學府,2024-08-22,9822
6117,迎廣,12,3,9,元大-土城學府,2024-08-22,9822
2312,金寶,9,1,8,元大-土城學府,2024-08-22,9822
2353,宏��,9,1,8,元大-土城學府,2024-08-22,9822
2062,橋椿,12,4,8,元大-土城學府,2024-08-22,9822
00688L,國泰20年美債正2,12,5,7,元大-土城學府,2024-08-22,9822
00680L,元大美債20正2,12,5,7,元大-土城學府,2024-08-22,9822
00939,統一台灣高息動能,7,0,7,元大-土城學府,2024-08-22,9822
00923,群益台ESG低碳50,8,1,7,元大-土城學府,2024-08-22,9822
1308,亞聚,9,2,7,元大-土城學府,2024-08-22,9822
1808,潤隆,8,1,7,元大-土城學府,2024-08-22,9822
9945,潤泰新,6,0,6,元大-土城學府,2024-08-22,9822
00934,中信成長高股息,6,0,6,元大-土城學府,2024-08-22,9822
2392,正崴,7,1,6,元大-土城學府,2024-08-22,9822
3163,波若威,14,8,6,元大-土城學府,2024-08-22,9822
4979,華星光,6,0,6,元大-土城學府,2024-08-22,9822
2897,王道銀行,501,0,501,元大-土城學府,2024-08-23,9822
00939,統一台灣高息動能,182,5,177,元大-土城學府,2024-08-23,9822
2887,台新金,245,71,174,元大-土城學府,2024-08-23,9822
00632R,元大台灣50反1,183,77,106,元大-土城學府,2024-08-23,9822
8039,台虹,99,7,92,元大-土城學府,2024-08-23,9822
00706L,期元大S＆P日圓正2,79,0,79,元大-土城學府,2024-08-23,9822
00929,復華台灣科技優息,81,6,75,元大-土城學府,2024-08-23,9822
2891,中信金,63,3,60,元大-土城學府,2024-08-23,9822
2374,佳能,67,13,54,元大-土城學府,2024-08-23,9822
1409,新纖,61,10,51,元大-土城學府,2024-08-23,9822
8358,金居,51,0,51,元大-土城學府,2024-08-23,9822
4555,氣立,47,0,47,元大-土城學府,2024-08-23,9822
00680L,元大美債20正2,37,2,35,元大-土城學府,2024-08-23,9822
1314,中石化,41,10,31,元大-土城學府,2024-08-23,9822
00688L,國泰20年美債正2,29,0,29,元大-土城學府,2024-08-23,9822
1455,集盛,30,5,25,元大-土城學府,2024-08-23,9822
1727,中華化,40,16,24,元大-土城學府,2024-08-23,9822
2317,鴻海,25,3,22,元大-土城學府,2024-08-23,9822
3005,神基,21,0,21,元大-土城學府,2024-08-23,9822
00664R,國泰臺灣加權反1,20,0,20,元大-土城學府,2024-08-23,9822
6443,元晶,20,0,20,元大-土城學府,2024-08-23,9822
2609,陽明,42,22,20,元大-土城學府,2024-08-23,9822
3607,谷崧,19,0,19,元大-土城學府,2024-08-23,9822
00919,群益台灣精選高息,35,16,19,元大-土城學府,2024-08-23,9822
00679B,元大美債20年,18,0,18,元大-土城學府,2024-08-23,9822
6156,松上,18,0,18,元大-土城學府,2024-08-23,9822
00918,大華優利高填息30,17,2,15,元大-土城學府,2024-08-23,9822
1721,三晃,20,6,14,元大-土城學府,2024-08-23,9822
2615,萬海,18,5,13,元大-土城學府,2024-08-23,9822
4906,正文,13,2,11,元大-土城學府,2024-08-23,9822
2402,毅嘉,31,20,11,元大-土城學府,2024-08-23,9822
00687B,國泰20年美債,15,5,10,元大-土城學府,2024-08-23,9822
00945B,凱基美國非投等債,10,0,10,元大-土城學府,2024-08-23,9822
2834,臺企銀,10,0,10,元大-土城學府,2024-08-23,9822
9105,泰金寶-DR,10,0,10,元大-土城學府,2024-08-23,9822
6213,聯茂,9,0,9,元大-土城學府,2024-08-23,9822
8054,安國,10,1,9,元大-土城學府,2024-08-23,9822
00923,群益台ESG低碳50,8,0,8,元大-土城學府,2024-08-23,9822
6449,鈺邦,8,0,8,元大-土城學府,2024-08-23,9822
8121,越峰,14,6,8,元大-土城學府,2024-08-23,9822
00936,台新永續高息中小,7,0,7,元大-土城學府,2024-08-23,9822
4513,福裕,11,4,7,元大-土城學府,2024-08-23,9822
00940,元大台灣價值高息,28,21,7,元大-土城學府,2024-08-23,9822
2885,元大金,7,0,7,元大-土城學府,2024-08-23,9822
1301,台塑,8,2,6,元大-土城學府,2024-08-23,9822
2367,燿華,11,5,6,元大-土城學府,2024-08-23,9822
3535,晶彩科,9,3,6,元大-土城學府,2024-08-23,9822
2421,建準,6,0,6,元大-土城學府,2024-08-23,9822
00933B,國泰10Y+金融債,6,0,6,元大-土城學府,2024-08-23,9822
00857B,永豐20年美公債,6,0,6,元大-土城學府,2024-08-23,9822
00939,統一台灣高息動能,666,22,644,元大-土城學府,2024-08-26,9822
2888,新光金,542,308,234,元大-土城學府,2024-08-26,9822
00632R,元大台灣50反1,252,44,208,元大-土城學府,2024-08-26,9822
8039,台虹,130,8,122,元大-土城學府,2024-08-26,9822
2891,中信金,120,22,98,元大-土城學府,2024-08-26,9822
3047,訊舟,78,13,65,元大-土城學府,2024-08-26,9822
00936,台新永續高息中小,44,5,39,元大-土城學府,2024-08-26,9822
00687B,國泰20年美債,42,7,35,元大-土城學府,2024-08-26,9822
3686,達能,40,6,34,元大-土城學府,2024-08-26,9822
2409,友達,34,4,30,元大-土城學府,2024-08-26,9822
3518,柏騰,29,0,29,元大-土城學府,2024-08-26,9822
5443,均豪,83,59,24,元大-土城學府,2024-08-26,9822
1711,永光,27,5,22,元大-土城學府,2024-08-26,9822
3615,安可,26,6,20,元大-土城學府,2024-08-26,9822
00669R,國泰美國道瓊反1,20,0,20,元大-土城學府,2024-08-26,9822
5905,南仁湖,20,0,20,元大-土城學府,2024-08-26,9822
2402,毅嘉,83,63,20,元大-土城學府,2024-08-26,9822
1609,大亞,19,0,19,元大-土城學府,2024-08-26,9822
2481,強茂,20,1,19,元大-土城學府,2024-08-26,9822
3363,上詮,26,7,19,元大-土城學府,2024-08-26,9822
3013,晟銘電,25,8,17,元大-土城學府,2024-08-26,9822
2405,輔信,18,2,16,元大-土城學府,2024-08-26,9822
8028,昇陽半導體,58,42,16,元大-土城學府,2024-08-26,9822
1336,台翰,15,0,15,元大-土城學府,2024-08-26,9822
1514,亞力,18,4,14,元大-土城學府,2024-08-26,9822
6274,台燿,12,0,12,元大-土城學府,2024-08-26,9822
00679B,元大美債20年,24,13,11,元大-土城學府,2024-08-26,9822
2464,盟立,11,0,11,元大-土城學府,2024-08-26,9822
4526,東台,30,19,11,元大-土城學府,2024-08-26,9822
00919,群益台灣精選高息,15,5,10,元大-土城學府,2024-08-26,9822
3105,穩懋,10,0,10,元大-土城學府,2024-08-26,9822
1314,中石化,19,9,10,元大-土城學府,2024-08-26,9822
1717,長興,12,2,10,元大-土城學府,2024-08-26,9822
2506,太設,10,0,10,元大-土城學府,2024-08-26,9822
2836,高雄銀,10,0,10,元大-土城學府,2024-08-26,9822
3049,精金,10,0,10,元大-土城學府,2024-08-26,9822
4716,大立,10,0,10,元大-土城學府,2024-08-26,9822
8906,花王,10,0,10,元大-土城學府,2024-08-26,9822
6139,亞翔,19,11,8,元大-土城學府,2024-08-26,9822
6570,維田,10,2,8,元大-土城學府,2024-08-26,9822
6223,旺矽,9,2,7,元大-土城學府,2024-08-26,9822
00881,國泰台灣5G+,7,0,7,元大-土城學府,2024-08-26,9822
3048,益登,7,0,7,元大-土城學府,2024-08-26,9822
3652,精聯,7,0,7,元大-土城學府,2024-08-26,9822
8927,北基,7,0,7,元大-土城學府,2024-08-26,9822
6207,雷科,8,1,7,元大-土城學府,2024-08-26,9822
8043,蜜望實,8,2,6,元大-土城學府,2024-08-26,9822
4564,元翎,6,0,6,元大-土城學府,2024-08-26,9822
4714,永捷,6,0,6,元大-土城學府,2024-08-26,9822
5263,智崴,8,2,6,元大-土城學府,2024-08-26,9822
2888,新光金,183,37,146,元大-土城學府,2024-08-27,9822
8039,台虹,139,21,118,元大-土城學府,2024-08-27,9822
00632R,元大台灣50反1,303,200,103,元大-土城學府,2024-08-27,9822
2891,中信金,66,1,65,元大-土城學府,2024-08-27,9822
2609,陽明,70,14,56,元大-土城學府,2024-08-27,9822
00937B,群益ESG投等債20,55,1,54,元大-土城學府,2024-08-27,9822
1313,聯成,46,0,46,元大-土城學府,2024-08-27,9822
00882,中信中國高股息,50,12,38,元大-土城學府,2024-08-27,9822
00929,復華台灣科技優息,46,10,36,元大-土城學府,2024-08-27,9822
2867,三商壽,33,0,33,元大-土城學府,2024-08-27,9822
00953B,群益優選非投等債,32,0,32,元大-土城學府,2024-08-27,9822
2303,聯電,50,18,32,元大-土城學府,2024-08-27,9822
2615,萬海,33,3,30,元大-土城學府,2024-08-27,9822
00637L,元大滬深300正2,30,0,30,元大-土城學府,2024-08-27,9822
3715,定穎投控,32,2,30,元大-土城學府,2024-08-27,9822
00687B,國泰20年美債,33,5,28,元大-土城學府,2024-08-27,9822
5469,瀚宇博,27,2,25,元大-土城學府,2024-08-27,9822
4967,十銓,34,11,23,元大-土城學府,2024-08-27,9822
00878,國泰永續高股息,18,0,18,元大-土城學府,2024-08-27,9822
00706L,期元大S＆P日圓正2,17,0,17,元大-土城學府,2024-08-27,9822
2882,國泰金,16,0,16,元大-土城學府,2024-08-27,9822
3033,威健,52,36,16,元大-土城學府,2024-08-27,9822
6213,聯茂,18,3,15,元大-土城學府,2024-08-27,9822
2481,強茂,16,2,14,元大-土城學府,2024-08-27,9822
00751B,元大AAA至A公司債,13,0,13,元大-土城學府,2024-08-27,9822
2354,鴻準,12,0,12,元大-土城學府,2024-08-27,9822
2845,遠東銀,12,0,12,元大-土城學府,2024-08-27,9822
1101,台泥,11,0,11,元大-土城學府,2024-08-27,9822
00712,復華富時不動產,11,0,11,元大-土城學府,2024-08-27,9822
1776,展宇,12,1,11,元大-土城學府,2024-08-27,9822
8096,擎亞,25,14,11,元大-土城學府,2024-08-27,9822
00664R,國泰臺灣加權反1,10,0,10,元大-土城學府,2024-08-27,9822
4561,健椿,13,3,10,元大-土城學府,2024-08-27,9822
6117,迎廣,11,1,10,元大-土城學府,2024-08-27,9822
8291,尚茂,10,0,10,元大-土城學府,2024-08-27,9822
00918,大華優利高填息30,11,2,9,元大-土城學府,2024-08-27,9822
00946,群益科技高息成長,10,1,9,元大-土城學府,2024-08-27,9822
3032,偉訓,10,1,9,元大-土城學府,2024-08-27,9822
3605,宏致,13,4,9,元大-土城學府,2024-08-27,9822
00948B,中信優息投資級債,8,0,8,元大-土城學府,2024-08-27,9822
1319,東陽,8,0,8,元大-土城學府,2024-08-27,9822
2331,精英,8,0,8,元大-土城學府,2024-08-27,9822
2851,中再保,8,0,8,元大-土城學府,2024-08-27,9822
3550,聯穎,8,0,8,元大-土城學府,2024-08-27,9822
2603,長榮,9,1,8,元大-土城學府,2024-08-27,9822
2880,華南金,8,0,8,元大-土城學府,2024-08-27,9822
0056,元大高股息,13,6,7,元大-土城學府,2024-08-27,9822
2356,英業達,8,1,7,元大-土城學府,2024-08-27,9822
5386,青雲,9,2,7,元大-土城學府,2024-08-27,9822
8054,安國,6,0,6,元大-土城學府,2024-08-27,9822
9945,潤泰新,200,20,180,元大-土城學府,2024-08-28,9822
00680L,元大美債20正2,69,0,69,元大-土城學府,2024-08-28,9822
3481,群創,101,38,63,元大-土城學府,2024-08-28,9822
8039,台虹,63,16,47,元大-土城學府,2024-08-28,9822
00687B,國泰20年美債,37,2,35,元大-土城學府,2024-08-28,9822
5443,均豪,53,18,35,元大-土城學府,2024-08-28,9822
2417,圓剛,31,0,31,元大-土城學府,2024-08-28,9822
2891,中信金,29,5,24,元大-土城學府,2024-08-28,9822
00953B,群益優選非投等債,24,0,24,元大-土城學府,2024-08-28,9822
00959B,大華投等美債15Y+,22,0,22,元大-土城學府,2024-08-28,9822
3715,定穎投控,49,29,20,元大-土城學府,2024-08-28,9822
2392,正崴,23,4,19,元大-土城學府,2024-08-28,9822
6603,富強鑫,17,1,16,元大-土城學府,2024-08-28,9822
6449,鈺邦,15,0,15,元大-土城學府,2024-08-28,9822
00937B,群益ESG投等債20,25,10,15,元大-土城學府,2024-08-28,9822
2867,三商壽,13,0,13,元大-土城學府,2024-08-28,9822
8064,東捷,28,15,13,元大-土城學府,2024-08-28,9822
2344,華邦電,12,0,12,元大-土城學府,2024-08-28,9822
4906,正文,12,0,12,元大-土城學府,2024-08-28,9822
5309,系統電,14,2,12,元大-土城學府,2024-08-28,9822
6143,振曜,18,6,12,元大-土城學府,2024-08-28,9822
00881,國泰台灣5G+,12,1,11,元大-土城學府,2024-08-28,9822
6806,森崴能源,11,0,11,元大-土城學府,2024-08-28,9822
1449,佳和,11,0,11,元大-土城學府,2024-08-28,9822
2002,中鋼,11,0,11,元大-土城學府,2024-08-28,9822
4561,健椿,15,4,11,元大-土城學府,2024-08-28,9822
3019,亞光,17,6,11,元大-土城學府,2024-08-28,9822
3037,欣興,13,3,10,元大-土城學府,2024-08-28,9822
00688L,國泰20年美債正2,10,0,10,元大-土城學府,2024-08-28,9822
1312,國喬,10,0,10,元大-土城學府,2024-08-28,9822
1455,集盛,10,0,10,元大-土城學府,2024-08-28,9822
2845,遠東銀,10,0,10,元大-土城學府,2024-08-28,9822
6133,金橋,10,0,10,元大-土城學府,2024-08-28,9822
6596,寬宏藝術,10,0,10,元大-土城學府,2024-08-28,9822
8027,鈦昇,13,3,10,元大-土城學府,2024-08-28,9822
6223,旺矽,23,14,9,元大-土城學府,2024-08-28,9822
2337,旺宏,10,1,9,元大-土城學府,2024-08-28,9822
2354,鴻準,12,3,9,元大-土城學府,2024-08-28,9822
8096,擎亞,12,3,9,元大-土城學府,2024-08-28,9822
00929,復華台灣科技優息,14,6,8,元大-土城學府,2024-08-28,9822
00679B,元大美債20年,13,5,8,元大-土城學府,2024-08-28,9822
2464,盟立,15,7,8,元大-土城學府,2024-08-28,9822
2609,陽明,14,6,8,元大-土城學府,2024-08-28,9822
2313,華通,20,13,7,元大-土城學府,2024-08-28,9822
2362,藍天,14,7,7,元大-土城學府,2024-08-28,9822
9105,泰金寶-DR,9,2,7,元大-土城學府,2024-08-28,9822
2365,昆盈,18,11,7,元大-土城學府,2024-08-28,9822
00772B,中信高評級公司債,7,1,6,元大-土城學府,2024-08-28,9822
3686,達能,6,0,6,元大-土城學府,2024-08-28,9822
2349,錸德,13,7,6,元大-土城學府,2024-08-28,9822
0056,元大高股息,59,2,57,元大-土城學府,2024-08-29,9822
00937B,群益ESG投等債20,52,6,46,元大-土城學府,2024-08-29,9822
2402,毅嘉,51,10,41,元大-土城學府,2024-08-29,9822
2891,中信金,40,1,39,元大-土城學府,2024-08-29,9822
00632R,元大台灣50反1,59,21,38,元大-土城學府,2024-08-29,9822
3607,谷崧,35,0,35,元大-土城學府,2024-08-29,9822
00679B,元大美債20年,35,3,32,元大-土城學府,2024-08-29,9822
8039,台虹,73,43,30,元大-土城學府,2024-08-29,9822
1540,喬福,111,82,29,元大-土城學府,2024-08-29,9822
00688L,國泰20年美債正2,38,10,28,元大-土城學府,2024-08-29,9822
00882,中信中國高股息,30,4,26,元大-土城學府,2024-08-29,9822
00919,群益台灣精選高息,27,1,26,元大-土城學府,2024-08-29,9822
2477,美隆電,23,0,23,元大-土城學府,2024-08-29,9822
2609,陽明,22,0,22,元大-土城學府,2024-08-29,9822
3450,聯鈞,56,35,21,元大-土城學府,2024-08-29,9822
00753L,中信中國50正2,20,0,20,元大-土城學府,2024-08-29,9822
4729,熒茂,20,0,20,元大-土城學府,2024-08-29,9822
3231,緯創,21,2,19,元大-土城學府,2024-08-29,9822
00687B,國泰20年美債,29,11,18,元大-土城學府,2024-08-29,9822
5443,均豪,51,34,17,元大-土城學府,2024-08-29,9822
3455,由田,20,3,17,元大-土城學府,2024-08-29,9822
2382,廣達,19,4,15,元大-土城學府,2024-08-29,9822
00918,大華優利高填息30,15,0,15,元大-土城學府,2024-08-29,9822
1455,集盛,15,0,15,元大-土城學府,2024-08-29,9822
1313,聯成,14,0,14,元大-土城學府,2024-08-29,9822
3437,榮創,15,1,14,元大-土城學府,2024-08-29,9822
00751B,元大AAA至A公司債,13,0,13,元大-土城學府,2024-08-29,9822
2337,旺宏,15,2,13,元大-土城學府,2024-08-29,9822
2426,鼎元,40,27,13,元大-土城學府,2024-08-29,9822
8027,鈦昇,16,3,13,元大-土城學府,2024-08-29,9822
00881,國泰台灣5G+,14,2,12,元大-土城學府,2024-08-29,9822
3013,晟銘電,19,7,12,元大-土城學府,2024-08-29,9822
3167,大量,12,0,12,元大-土城學府,2024-08-29,9822
00878,國泰永續高股息,12,1,11,元大-土城學府,2024-08-29,9822
2845,遠東銀,11,0,11,元大-土城學府,2024-08-29,9822
2524,京城,15,4,11,元大-土城學府,2024-08-29,9822
00664R,國泰臺灣加權反1,10,0,10,元大-土城學府,2024-08-29,9822
3031,佰鴻,10,0,10,元大-土城學府,2024-08-29,9822
3710,連展投控,10,0,10,元大-土城學府,2024-08-29,9822
4908,前鼎,10,0,10,元大-土城學府,2024-08-29,9822
8147,正淩,10,0,10,元大-土城學府,2024-08-29,9822
2489,瑞軒,16,7,9,元大-土城學府,2024-08-29,9822
006208,富邦台50,10,1,9,元大-土城學府,2024-08-29,9822
3715,定穎投控,11,2,9,元大-土城學府,2024-08-29,9822
6425,易發,9,0,9,元大-土城學府,2024-08-29,9822
6698,旭暉應材,10,1,9,元大-土城學府,2024-08-29,9822
8374,羅昇,11,2,9,元大-土城學府,2024-08-29,9822
8927,北基,13,4,9,元大-土城學府,2024-08-29,9822
00948B,中信優息投資級債,8,0,8,元大-土城學府,2024-08-29,9822
5484,慧友,8,0,8,元大-土城學府,2024-08-29,9822
2897,王道銀行,499,356,143,元大-土城學府,2024-08-30,9822
00679B,元大美債20年,146,23,123,元大-土城學府,2024-08-30,9822
00632R,元大台灣50反1,51,0,51,元大-土城學府,2024-08-30,9822
3645,達邁,38,5,33,元大-土城學府,2024-08-30,9822
2891,中信金,30,1,29,元大-土城學府,2024-08-30,9822
8096,擎亞,27,2,25,元大-土城學府,2024-08-30,9822
2340,台亞,21,0,21,元大-土城學府,2024-08-30,9822
6143,振曜,23,2,21,元大-土城學府,2024-08-30,9822
00937B,群益ESG投等債20,23,3,20,元大-土城學府,2024-08-30,9822
1449,佳和,20,0,20,元大-土城學府,2024-08-30,9822
3481,群創,59,42,17,元大-土城學府,2024-08-30,9822
2367,燿華,40,26,14,元大-土城學府,2024-08-30,9822
00940,元大台灣價值高息,16,2,14,元大-土城學府,2024-08-30,9822
1597,直得,29,15,14,元大-土城學府,2024-08-30,9822
4956,光鋐,15,1,14,元大-土城學府,2024-08-30,9822
00680L,元大美債20正2,16,3,13,元大-土城學府,2024-08-30,9822
2537,聯上發,18,5,13,元大-土城學府,2024-08-30,9822
4958,臻鼎-KY,14,2,12,元大-土城學府,2024-08-30,9822
00688L,國泰20年美債正2,17,5,12,元大-土城學府,2024-08-30,9822
00959B,大華投等美債15Y+,14,2,12,元大-土城學府,2024-08-30,9822
2392,正崴,21,9,12,元大-土城學府,2024-08-30,9822
5386,青雲,15,4,11,元大-土城學府,2024-08-30,9822
4526,東台,52,41,11,元大-土城學府,2024-08-30,9822
2515,中工,12,1,11,元大-土城學府,2024-08-30,9822
8105,凌巨,15,4,11,元大-土城學府,2024-08-30,9822
2610,華航,13,2,11,元大-土城學府,2024-08-30,9822
00772B,中信高評級公司債,11,1,10,元大-土城學府,2024-08-30,9822
3580,友威科,12,2,10,元大-土城學府,2024-08-30,9822
3163,波若威,14,4,10,元大-土城學府,2024-08-30,9822
00933B,國泰10Y+金融債,9,0,9,元大-土城學府,2024-08-30,9822
3013,晟銘電,33,24,9,元大-土城學府,2024-08-30,9822
3535,晶彩科,11,2,9,元大-土城學府,2024-08-30,9822
2409,友達,13,4,9,元大-土城學府,2024-08-30,9822
4716,大立,9,0,9,元大-土城學府,2024-08-30,9822
1540,喬福,18,10,8,元大-土城學府,2024-08-30,9822
00637L,元大滬深300正2,8,0,8,元大-土城學府,2024-08-30,9822
3189,景碩,24,16,8,元大-土城學府,2024-08-30,9822
3522,御嵿,8,0,8,元大-土城學府,2024-08-30,9822
5905,南仁湖,9,1,8,元大-土城學府,2024-08-30,9822
6698,旭暉應材,16,8,8,元大-土城學府,2024-08-30,9822
8091,翔名,10,2,8,元大-土城學府,2024-08-30,9822
00892,富邦台灣半導體,7,0,7,元大-土城學府,2024-08-30,9822
00948B,中信優息投資級債,7,0,7,元大-土城學府,2024-08-30,9822
00953B,群益優選非投等債,7,0,7,元大-土城學府,2024-08-30,9822
2349,錸德,9,2,7,元大-土城學府,2024-08-30,9822
3615,安可,25,18,7,元大-土城學府,2024-08-30,9822
3042,晶技,7,0,7,元大-土城學府,2024-08-30,9822
2887,台新金,7,0,7,元大-土城學府,2024-08-30,9822
1514,亞力,6,0,6,元大-土城學府,2024-08-30,9822
00706L,期元大S＆P日圓正2,6,0,6,元大-土城學府,2024-08-30,9822
00679B,元大美債20年,156,5,151,元大-土城學府,2024-09-02,9822
2609,陽明,124,1,123,元大-土城學府,2024-09-02,9822
9105,泰金寶-DR,101,0,101,元大-土城學府,2024-09-02,9822
00959B,大華投等美債15Y+,73,5,68,元大-土城學府,2024-09-02,9822
8089,康全電訊,64,5,59,元大-土城學府,2024-09-02,9822
00680L,元大美債20正2,56,0,56,元大-土城學府,2024-09-02,9822
00937B,群益ESG投等債20,50,0,50,元大-土城學府,2024-09-02,9822
00918,大華優利高填息30,55,8,47,元大-土城學府,2024-09-02,9822
2402,毅嘉,68,33,35,元大-土城學府,2024-09-02,9822
2316,楠梓電,32,0,32,元大-土城學府,2024-09-02,9822
00687B,國泰20年美債,31,0,31,元大-土城學府,2024-09-02,9822
2382,廣達,31,1,30,元大-土城學府,2024-09-02,9822
4909,新復興,80,53,27,元大-土城學府,2024-09-02,9822
2615,萬海,26,1,25,元大-土城學府,2024-09-02,9822
8096,擎亞,29,4,25,元大-土城學府,2024-09-02,9822
3013,晟銘電,27,3,24,元大-土城學府,2024-09-02,9822
2337,旺宏,26,3,23,元大-土城學府,2024-09-02,9822
6156,松上,22,0,22,元大-土城學府,2024-09-02,9822
2515,中工,27,7,20,元大-土城學府,2024-09-02,9822
1809,中釉,23,3,20,元大-土城學府,2024-09-02,9822
00919,群益台灣精選高息,20,0,20,元大-土城學府,2024-09-02,9822
2317,鴻海,44,25,19,元大-土城學府,2024-09-02,9822
4306,炎洲,25,7,18,元大-土城學府,2024-09-02,9822
00905,FT臺灣Smart,15,0,15,元大-土城學府,2024-09-02,9822
3481,群創,16,2,14,元大-土城學府,2024-09-02,9822
2867,三商壽,14,0,14,元大-土城學府,2024-09-02,9822
00929,復華台灣科技優息,26,13,13,元大-土城學府,2024-09-02,9822
00881,國泰台灣5G+,13,0,13,元大-土城學府,2024-09-02,9822
00706L,期元大S＆P日圓正2,13,0,13,元大-土城學府,2024-09-02,9822
00915,凱基優選高股息30,13,0,13,元大-土城學府,2024-09-02,9822
3450,聯鈞,81,69,12,元大-土城學府,2024-09-02,9822
00948B,中信優息投資級債,11,0,11,元大-土城學府,2024-09-02,9822
4714,永捷,21,10,11,元大-土城學府,2024-09-02,9822
8105,凌巨,20,9,11,元大-土城學府,2024-09-02,9822
2313,華通,19,8,11,元大-土城學府,2024-09-02,9822
6531,愛普*,17,7,10,元大-土城學府,2024-09-02,9822
00795B,中信美國公債20年,10,0,10,元大-土城學府,2024-09-02,9822
1314,中石化,15,5,10,元大-土城學府,2024-09-02,9822
1455,集盛,10,0,10,元大-土城學府,2024-09-02,9822
1815,富喬,14,4,10,元大-土城學府,2024-09-02,9822
2371,大同,11,1,10,元大-土城學府,2024-09-02,9822
3402,漢科,10,0,10,元大-土城學府,2024-09-02,9822
3518,柏騰,10,0,10,元大-土城學府,2024-09-02,9822
4561,健椿,23,13,10,元大-土城學府,2024-09-02,9822
5515,建國,10,0,10,元大-土城學府,2024-09-02,9822
00934,中信成長高股息,11,1,10,元大-土城學府,2024-09-02,9822
2303,聯電,14,5,9,元大-土城學府,2024-09-02,9822
1101,台泥,10,1,9,元大-土城學府,2024-09-02,9822
4526,東台,27,18,9,元大-土城學府,2024-09-02,9822
8043,蜜望實,22,13,9,元大-土城學府,2024-09-02,9822
00919,群益台灣精選高息,129,7,122,元大-土城學府,2024-09-03,9822
00632R,元大台灣50反1,47,0,47,元大-土城學府,2024-09-03,9822
00940,元大台灣價值高息,70,24,46,元大-土城學府,2024-09-03,9822
00918,大華優利高填息30,47,3,44,元大-土城學府,2024-09-03,9822
00687B,國泰20年美債,43,2,41,元大-土城學府,2024-09-03,9822
1817,凱撒衛,40,0,40,元大-土城學府,2024-09-03,9822
00937B,群益ESG投等債20,33,0,33,元大-土城學府,2024-09-03,9822
1101,台泥,32,1,31,元大-土城學府,2024-09-03,9822
2331,精英,28,0,28,元大-土城學府,2024-09-03,9822
2337,旺宏,27,0,27,元大-土城學府,2024-09-03,9822
3047,訊舟,33,7,26,元大-土城學府,2024-09-03,9822
6546,正基,25,0,25,元大-土城學府,2024-09-03,9822
2349,錸德,24,0,24,元大-土城學府,2024-09-03,9822
2867,三商壽,24,0,24,元大-土城學府,2024-09-03,9822
2449,京元電子,24,0,24,元大-土城學府,2024-09-03,9822
00951,台新日本半導體,22,0,22,元大-土城學府,2024-09-03,9822
00878,國泰永續高股息,24,3,21,元大-土城學府,2024-09-03,9822
2515,中工,21,0,21,元大-土城學府,2024-09-03,9822
00929,復華台灣科技優息,50,31,19,元大-土城學府,2024-09-03,9822
6213,聯茂,45,28,17,元大-土城學府,2024-09-03,9822
3231,緯創,35,18,17,元大-土城學府,2024-09-03,9822
3518,柏騰,16,0,16,元大-土城學府,2024-09-03,9822
2885,元大金,16,1,15,元大-土城學府,2024-09-03,9822
00933B,國泰10Y+金融債,15,0,15,元大-土城學府,2024-09-03,9822
1314,中石化,14,0,14,元大-土城學府,2024-09-03,9822
2610,華航,14,0,14,元大-土城學府,2024-09-03,9822
2884,玉山金,12,0,12,元大-土城學府,2024-09-03,9822
00915,凱基優選高股息30,12,0,12,元大-土城學府,2024-09-03,9822
00650L,復華香港正2,12,0,12,元大-土城學府,2024-09-03,9822
1313,聯成,12,0,12,元大-土城學府,2024-09-03,9822
2241,艾姆勒,13,1,12,元大-土城學府,2024-09-03,9822
5309,系統電,12,0,12,元大-土城學府,2024-09-03,9822
00680L,元大美債20正2,11,0,11,元大-土城學府,2024-09-03,9822
2031,新光鋼,11,0,11,元大-土城學府,2024-09-03,9822
4909,新復興,12,2,10,元大-土城學府,2024-09-03,9822
00713,元大台灣高息低波,13,3,10,元大-土城學府,2024-09-03,9822
2891,中信金,13,3,10,元大-土城學府,2024-09-03,9822
00923,群益台ESG低碳50,9,0,9,元大-土城學府,2024-09-03,9822
2316,楠梓電,12,3,9,元大-土城學府,2024-09-03,9822
2609,陽明,12,3,9,元大-土城學府,2024-09-03,9822
6116,彩晶,13,4,9,元大-土城學府,2024-09-03,9822
6215,和椿,14,5,9,元大-土城學府,2024-09-03,9822
3037,欣興,9,1,8,元大-土城學府,2024-09-03,9822
2002,中鋼,18,10,8,元大-土城學府,2024-09-03,9822
00881,國泰台灣5G+,8,0,8,元大-土城學府,2024-09-03,9822
1326,台化,8,0,8,元大-土城學府,2024-09-03,9822
3432,台端,8,0,8,元大-土城學府,2024-09-03,9822
8210,勤誠,8,0,8,元大-土城學府,2024-09-03,9822
5443,均豪,23,16,7,元大-土城學府,2024-09-03,9822
00892,富邦台灣半導體,7,0,7,元大-土城學府,2024-09-03,9822
2897,王道銀行,685,0,685,元大-土城學府,2024-09-04,9822
00940,元大台灣價值高息,310,90,220,元大-土城學府,2024-09-04,9822
00929,復華台灣科技優息,211,40,171,元大-土城學府,2024-09-04,9822
00919,群益台灣精選高息,182,13,169,元大-土城學府,2024-09-04,9822
00948B,中信優息投資級債,162,0,162,元大-土城學府,2024-09-04,9822
00878,國泰永續高股息,236,82,154,元大-土城學府,2024-09-04,9822
00918,大華優利高填息30,146,22,124,元大-土城學府,2024-09-04,9822
3481,群創,131,18,113,元大-土城學府,2024-09-04,9822
2002,中鋼,92,1,91,元大-土城學府,2024-09-04,9822
1817,凱撒衛,69,0,69,元大-土城學府,2024-09-04,9822
2891,中信金,61,0,61,元大-土城學府,2024-09-04,9822
1802,台玻,61,0,61,元大-土城學府,2024-09-04,9822
0056,元大高股息,61,4,57,元大-土城學府,2024-09-04,9822
4576,大銀微系統,62,7,55,元大-土城學府,2024-09-04,9822
00951,台新日本半導體,51,0,51,元大-土城學府,2024-09-04,9822
00915,凱基優選高股息30,35,0,35,元大-土城學府,2024-09-04,9822
2890,永豐金,35,0,35,元大-土城學府,2024-09-04,9822
2330,台積電,38,6,32,元大-土城學府,2024-09-04,9822
0050,元大台灣50,33,2,31,元大-土城學府,2024-09-04,9822
00715L,期街口布蘭特正2,31,0,31,元大-土城學府,2024-09-04,9822
00954,中信日本半導體,26,0,26,元大-土城學府,2024-09-04,9822
2356,英業達,36,13,23,元大-土城學府,2024-09-04,9822
2610,華航,22,0,22,元大-土城學府,2024-09-04,9822
2337,旺宏,25,4,21,元大-土城學府,2024-09-04,9822
2331,精英,21,0,21,元大-土城學府,2024-09-04,9822
00923,群益台ESG低碳50,20,0,20,元大-土城學府,2024-09-04,9822
8096,擎亞,30,11,19,元大-土城學府,2024-09-04,9822
2886,兆豐金,18,0,18,元大-土城學府,2024-09-04,9822
3535,晶彩科,31,13,18,元大-土城學府,2024-09-04,9822
3037,欣興,22,5,17,元大-土城學府,2024-09-04,9822
6456,GIS-KY,17,0,17,元大-土城學府,2024-09-04,9822
2365,昆盈,30,14,16,元大-土城學府,2024-09-04,9822
2885,元大金,16,0,16,元大-土城學府,2024-09-04,9822
2344,華邦電,16,0,16,元大-土城學府,2024-09-04,9822
2368,金像電,19,3,16,元大-土城學府,2024-09-04,9822
3231,緯創,22,7,15,元大-土城學府,2024-09-04,9822
2317,鴻海,51,37,14,元大-土城學府,2024-09-04,9822
00713,元大台灣高息低波,18,4,14,元大-土城學府,2024-09-04,9822
2303,聯電,22,8,14,元大-土城學府,2024-09-04,9822
00772B,中信高評級公司債,14,0,14,元大-土城學府,2024-09-04,9822
1314,中石化,15,1,14,元大-土城學府,2024-09-04,9822
00905,FT臺灣Smart,13,0,13,元大-土城學府,2024-09-04,9822
00932,兆豐永續高息等權,13,0,13,元大-土城學府,2024-09-04,9822
00944,野村趨勢動能高息,13,0,13,元大-土城學府,2024-09-04,9822
3149,正達,15,2,13,元大-土城學府,2024-09-04,9822
00881,國泰台灣5G+,17,5,12,元大-土城學府,2024-09-04,9822
1313,聯成,12,0,12,元大-土城學府,2024-09-04,9822
6757,台灣虎航,12,0,12,元大-土城學府,2024-09-04,9822
6770,力積電,12,0,12,元大-土城學府,2024-09-04,9822
8071,能率網通,12,0,12,元大-土城學府,2024-09-04,9822
00934,中信成長高股息,409,44,365,元大-土城學府,2024-09-05,9822
2887,台新金,302,0,302,元大-土城學府,2024-09-05,9822
00952,凱基台灣AI50,153,0,153,元大-土城學府,2024-09-05,9822
00929,復華台灣科技優息,109,11,98,元大-土城學府,2024-09-05,9822
00919,群益台灣精選高息,99,7,92,元大-土城學府,2024-09-05,9822
0056,元大高股息,67,4,63,元大-土城學府,2024-09-05,9822
00712,復華富時不動產,50,1,49,元大-土城學府,2024-09-05,9822
00940,元大台灣價值高息,42,0,42,元大-土城學府,2024-09-05,9822
4576,大銀微系統,39,7,32,元大-土城學府,2024-09-05,9822
2002,中鋼,34,4,30,元大-土城學府,2024-09-05,9822
00878,國泰永續高股息,30,3,27,元大-土城學府,2024-09-05,9822
2382,廣達,27,3,24,元大-土城學府,2024-09-05,9822
6217,中探針,30,10,20,元大-土城學府,2024-09-05,9822
2317,鴻海,32,13,19,元大-土城學府,2024-09-05,9822
2308,台達電,20,1,19,元大-土城學府,2024-09-05,9822
00918,大華優利高填息30,36,19,17,元大-土城學府,2024-09-05,9822
2408,南亞科,18,1,17,元大-土城學府,2024-09-05,9822
00715L,期街口布蘭特正2,47,30,17,元大-土城學府,2024-09-05,9822
4510,高鋒,70,55,15,元大-土城學府,2024-09-05,9822
2344,華邦電,14,0,14,元大-土城學府,2024-09-05,9822
00687B,國泰20年美債,35,21,14,元大-土城學府,2024-09-05,9822
1540,喬福,102,88,14,元大-土城學府,2024-09-05,9822
3019,亞光,24,11,13,元大-土城學府,2024-09-05,9822
4906,正文,23,11,12,元大-土城學府,2024-09-05,9822
8096,擎亞,15,3,12,元大-土城學府,2024-09-05,9822
2313,華通,12,1,11,元大-土城學府,2024-09-05,9822
2882,國泰金,11,0,11,元大-土城學府,2024-09-05,9822
3231,緯創,32,22,10,元大-土城學府,2024-09-05,9822
2603,長榮,11,1,10,元大-土城學府,2024-09-05,9822
3013,晟銘電,21,11,10,元大-土城學府,2024-09-05,9822
00671R,富邦NASDAQ反1,10,0,10,元大-土城學府,2024-09-05,9822
1504,東元,11,1,10,元大-土城學府,2024-09-05,9822
1721,三晃,12,2,10,元大-土城學府,2024-09-05,9822
2722,夏都,10,0,10,元大-土城學府,2024-09-05,9822
3189,景碩,14,4,10,元大-土城學府,2024-09-05,9822
3354,律勝,10,0,10,元大-土城學府,2024-09-05,9822
8088,品安,10,0,10,元大-土城學府,2024-09-05,9822
5225,東科-KY,9,0,9,元大-土城學府,2024-09-05,9822
2495,普安,11,2,9,元大-土城學府,2024-09-05,9822
4549,桓達,12,3,9,元大-土城學府,2024-09-05,9822
8011,台通,11,2,9,元大-土城學府,2024-09-05,9822
00713,元大台灣高息低波,8,0,8,元大-土城學府,2024-09-05,9822
2368,金像電,8,0,8,元大-土城學府,2024-09-05,9822
2486,一詮,12,4,8,元大-土城學府,2024-09-05,9822
3306,鼎天,8,0,8,元大-土城學府,2024-09-05,9822
3312,弘憶股,8,0,8,元大-土城學府,2024-09-05,9822
2891,中信金,12,5,7,元大-土城學府,2024-09-05,9822
00882,中信中國高股息,21,14,7,元大-土城學府,2024-09-05,9822
6187,萬潤,29,22,7,元大-土城學府,2024-09-05,9822
2331,精英,7,0,7,元大-土城學府,2024-09-05,9822
00953B,群益優選非投等債,54,0,54,元大-土城學府,2024-09-06,9822
00919,群益台灣精選高息,47,3,44,元大-土城學府,2024-09-06,9822
00915,凱基優選高股息30,39,0,39,元大-土城學府,2024-09-06,9822
2882,國泰金,40,8,32,元大-土城學府,2024-09-06,9822
00918,大華優利高填息30,38,7,31,元大-土城學府,2024-09-06,9822
00687B,國泰20年美債,53,26,27,元大-土城學府,2024-09-06,9822
00713,元大台灣高息低波,27,0,27,元大-土城學府,2024-09-06,9822
8027,鈦昇,20,0,20,元大-土城學府,2024-09-06,9822
00715L,期街口布蘭特正2,21,1,20,元大-土城學府,2024-09-06,9822
00680L,元大美債20正2,24,5,19,元大-土城學府,2024-09-06,9822
3518,柏騰,18,0,18,元大-土城學府,2024-09-06,9822
4561,健椿,26,8,18,元大-土城學府,2024-09-06,9822
1815,富喬,20,4,16,元大-土城學府,2024-09-06,9822
2618,長榮航,15,0,15,元大-土城學府,2024-09-06,9822
2383,台光電,18,4,14,元大-土城學府,2024-09-06,9822
6213,聯茂,26,12,14,元大-土城學府,2024-09-06,9822
6139,亞翔,17,3,14,元大-土城學府,2024-09-06,9822
8374,羅昇,31,17,14,元大-土城學府,2024-09-06,9822
6405,悅城,27,14,13,元大-土城學府,2024-09-06,9822
2883,凱基金,21,9,12,元大-土城學府,2024-09-06,9822
2317,鴻海,25,13,12,元大-土城學府,2024-09-06,9822
2489,瑞軒,16,5,11,元大-土城學府,2024-09-06,9822
2344,華邦電,12,2,10,元大-土城學府,2024-09-06,9822
00650L,復華香港正2,10,0,10,元大-土城學府,2024-09-06,9822
1702,南僑,10,0,10,元大-土城學府,2024-09-06,9822
2417,圓剛,10,0,10,元大-土城學府,2024-09-06,9822
4967,十銓,10,0,10,元大-土城學府,2024-09-06,9822
00936,台新永續高息中小,10,1,9,元大-土城學府,2024-09-06,9822
2891,中信金,10,3,7,元大-土城學府,2024-09-06,9822
2002,中鋼,7,0,7,元大-土城學府,2024-09-06,9822
3058,立德,19,12,7,元大-土城學府,2024-09-06,9822
5905,南仁湖,15,8,7,元大-土城學府,2024-09-06,9822
3481,群創,12,5,7,元大-土城學府,2024-09-06,9822
1301,台塑,7,1,6,元大-土城學府,2024-09-06,9822
4906,正文,7,1,6,元大-土城學府,2024-09-06,9822
8064,東捷,7,1,6,元大-土城學府,2024-09-06,9822
6147,頎邦,6,0,6,元大-土城學府,2024-09-06,9822
2337,旺宏,6,1,5,元大-土城學府,2024-09-06,9822
1524,耿鼎,10,5,5,元大-土城學府,2024-09-06,9822
00922,國泰台灣領袖50,5,0,5,元大-土城學府,2024-09-06,9822
00945B,凱基美國非投等債,5,0,5,元大-土城學府,2024-09-06,9822
00951,台新日本半導體,5,0,5,元大-土城學府,2024-09-06,9822
1314,中石化,5,0,5,元大-土城學府,2024-09-06,9822
1616,億泰,5,0,5,元大-土城學府,2024-09-06,9822
2426,鼎元,5,0,5,元大-土城學府,2024-09-06,9822
2867,三商壽,5,0,5,元大-土城學府,2024-09-06,9822
3712,永崴投控,10,5,5,元大-土城學府,2024-09-06,9822
4927,泰鼎-KY,5,0,5,元大-土城學府,2024-09-06,9822
5515,建國,5,0,5,元大-土城學府,2024-09-06,9822
6026,福邦證,5,0,5,元大-土城學府,2024-09-06,9822
00919,群益台灣精選高息,120,5,115,元大-土城學府,2024-09-09,9822
2883,凱基金,108,1,107,元大-土城學府,2024-09-09,9822
2323,中環,100,0,100,元大-土城學府,2024-09-09,9822
00940,元大台灣價值高息,94,18,76,元大-土城學府,2024-09-09,9822
00918,大華優利高填息30,59,6,53,元大-土城學府,2024-09-09,9822
2801,彰銀,51,0,51,元大-土城學府,2024-09-09,9822
00878,國泰永續高股息,53,4,49,元大-土城學府,2024-09-09,9822
2317,鴻海,54,8,46,元大-土城學府,2024-09-09,9822
2885,元大金,43,1,42,元大-土城學府,2024-09-09,9822
00915,凱基優選高股息30,43,5,38,元大-土城學府,2024-09-09,9822
1301,台塑,37,1,36,元大-土城學府,2024-09-09,9822
00687B,國泰20年美債,33,0,33,元大-土城學府,2024-09-09,9822
2891,中信金,33,0,33,元大-土城學府,2024-09-09,9822
3715,定穎投控,53,25,28,元大-土城學府,2024-09-09,9822
2615,萬海,24,0,24,元大-土城學府,2024-09-09,9822
3231,緯創,36,13,23,元大-土城學府,2024-09-09,9822
2609,陽明,25,2,23,元大-土城學府,2024-09-09,9822
00715L,期街口布蘭特正2,18,1,17,元大-土城學府,2024-09-09,9822
2464,盟立,37,21,16,元大-土城學府,2024-09-09,9822
2881,富邦金,15,0,15,元大-土城學府,2024-09-09,9822
0056,元大高股息,19,4,15,元大-土城學府,2024-09-09,9822
2356,英業達,34,21,13,元大-土城學府,2024-09-09,9822
0050,元大台灣50,13,1,12,元大-土城學府,2024-09-09,9822
00930,永豐ESG低碳高息,12,0,12,元大-土城學府,2024-09-09,9822
00713,元大台灣高息低波,12,0,12,元大-土城學府,2024-09-09,9822
2603,長榮,11,0,11,元大-土城學府,2024-09-09,9822
00948B,中信優息投資級債,15,4,11,元大-土城學府,2024-09-09,9822
6449,鈺邦,18,7,11,元大-土城學府,2024-09-09,9822
00881,國泰台灣5G+,11,0,11,元大-土城學府,2024-09-09,9822
5880,合庫金,10,0,10,元大-土城學府,2024-09-09,9822
00952,凱基台灣AI50,10,0,10,元大-土城學府,2024-09-09,9822
1806,冠軍,10,0,10,元大-土城學府,2024-09-09,9822
6770,力積電,12,2,10,元大-土城學府,2024-09-09,9822
8932,智通*,10,0,10,元大-土城學府,2024-09-09,9822
2330,台積電,11,1,10,元大-土城學府,2024-09-09,9822
9945,潤泰新,9,0,9,元大-土城學府,2024-09-09,9822
00953B,群益優選非投等債,9,0,9,元大-土城學府,2024-09-09,9822
00900,富邦特選高股息30,8,0,8,元大-土城學府,2024-09-09,9822
2382,廣達,17,9,8,元大-土城學府,2024-09-09,9822
2489,瑞軒,12,5,7,元大-土城學府,2024-09-09,9822
3522,御嵿,6,0,6,元大-土城學府,2024-09-09,9822
4956,光鋐,19,13,6,元大-土城學府,2024-09-09,9822
6127,九豪,8,2,6,元大-土城學府,2024-09-09,9822
6570,維田,6,0,6,元大-土城學府,2024-09-09,9822
2882,國泰金,6,0,6,元大-土城學府,2024-09-09,9822
00679B,元大美債20年,29,23,6,元大-土城學府,2024-09-09,9822
2618,長榮航,6,0,6,元大-土城學府,2024-09-09,9822
2401,凌陽,5,0,5,元大-土城學府,2024-09-09,9822
3673,TPK-KY,9,4,5,元大-土城學府,2024-09-09,9822
00951,台新日本半導體,5,0,5,元大-土城學府,2024-09-09,9822
00959B,大華投等美債15Y+,120,0,120,元大-土城學府,2024-09-10,9822
2323,中環,100,0,100,元大-土城學府,2024-09-10,9822
00929,復華台灣科技優息,123,56,67,元大-土城學府,2024-09-10,9822
00918,大華優利高填息30,70,16,54,元大-土城學府,2024-09-10,9822
4974,亞泰,51,1,50,元大-土城學府,2024-09-10,9822
00878,國泰永續高股息,49,0,49,元大-土城學府,2024-09-10,9822
4956,光鋐,57,8,49,元大-土城學府,2024-09-10,9822
00919,群益台灣精選高息,124,80,44,元大-土城學府,2024-09-10,9822
00940,元大台灣價值高息,55,15,40,元大-土城學府,2024-09-10,9822
6187,萬潤,56,21,35,元大-土城學府,2024-09-10,9822
2331,精英,35,0,35,元大-土城學府,2024-09-10,9822
3481,群創,41,9,32,元大-土城學府,2024-09-10,9822
2303,聯電,30,0,30,元大-土城學府,2024-09-10,9822
8039,台虹,36,6,30,元大-土城學府,2024-09-10,9822
2382,廣達,44,15,29,元大-土城學府,2024-09-10,9822
1817,凱撒衛,27,0,27,元大-土城學府,2024-09-10,9822
5460,同協,27,1,26,元大-土城學府,2024-09-10,9822
0056,元大高股息,24,0,24,元大-土城學府,2024-09-10,9822
00713,元大台灣高息低波,24,0,24,元大-土城學府,2024-09-10,9822
2885,元大金,23,2,21,元大-土城學府,2024-09-10,9822
2402,毅嘉,36,16,20,元大-土城學府,2024-09-10,9822
00650L,復華香港正2,20,0,20,元大-土城學府,2024-09-10,9822
3217,優群,20,0,20,元大-土城學府,2024-09-10,9822
3003,健和興,21,1,20,元大-土城學府,2024-09-10,9822
2344,華邦電,24,8,16,元大-土城學府,2024-09-10,9822
2337,旺宏,18,2,16,元大-土城學府,2024-09-10,9822
3312,弘憶股,20,4,16,元大-土城學府,2024-09-10,9822
1301,台塑,17,2,15,元大-土城學府,2024-09-10,9822
00635U,期元大S＆P黃金,15,0,15,元大-土城學府,2024-09-10,9822
3518,柏騰,15,0,15,元大-土城學府,2024-09-10,9822
00715L,期街口布蘭特正2,14,0,14,元大-土城學府,2024-09-10,9822
2317,鴻海,49,35,14,元大-土城學府,2024-09-10,9822
00934,中信成長高股息,23,10,13,元大-土城學府,2024-09-10,9822
3231,緯創,34,21,13,元大-土城學府,2024-09-10,9822
2365,昆盈,21,9,12,元大-土城學府,2024-09-10,9822
00942B,台新美A公司債20+,12,0,12,元大-土城學府,2024-09-10,9822
3005,神基,11,0,11,元大-土城學府,2024-09-10,9822
00915,凱基優選高股息30,13,2,11,元大-土城學府,2024-09-10,9822
00948B,中信優息投資級債,11,0,11,元大-土城學府,2024-09-10,9822
1618,合機,12,1,11,元大-土城學府,2024-09-10,9822
4510,高鋒,28,17,11,元大-土城學府,2024-09-10,9822
4979,華星光,23,12,11,元大-土城學府,2024-09-10,9822
00679B,元大美債20年,27,16,11,元大-土城學府,2024-09-10,9822
00931B,統一美債20年,10,0,10,元大-土城學府,2024-09-10,9822
00956,中信日經高股息,10,0,10,元大-土城學府,2024-09-10,9822
2313,華通,15,5,10,元大-土城學府,2024-09-10,9822
2408,南亞科,9,0,9,元大-土城學府,2024-09-10,9822
3149,正達,9,0,9,元大-土城學府,2024-09-10,9822
2609,陽明,22,14,8,元大-土城學府,2024-09-10,9822
00930,永豐ESG低碳高息,9,1,8,元大-土城學府,2024-09-10,9822
00688L,國泰20年美債正2,117,14,103,元大-土城學府,2024-09-11,9822
00929,復華台灣科技優息,76,6,70,元大-土城學府,2024-09-11,9822
4977,眾達-KY,50,2,48,元大-土城學府,2024-09-11,9822
4974,亞泰,53,6,47,元大-土城學府,2024-09-11,9822
00687B,國泰20年美債,63,18,45,元大-土城學府,2024-09-11,9822
1101,台泥,43,0,43,元大-土城學府,2024-09-11,9822
0056,元大高股息,33,1,32,元大-土城學府,2024-09-11,9822
00878,國泰永續高股息,33,2,31,元大-土城學府,2024-09-11,9822
00919,群益台灣精選高息,32,5,27,元大-土城學府,2024-09-11,9822
3005,神基,26,3,23,元大-土城學府,2024-09-11,9822
1522,堤維西,28,6,22,元大-土城學府,2024-09-11,9822
00942B,台新美A公司債20+,20,0,20,元大-土城學府,2024-09-11,9822
2353,宏��,24,5,19,元大-土城學府,2024-09-11,9822
2349,錸德,33,16,17,元大-土城學府,2024-09-11,9822
00934,中信成長高股息,17,1,16,元大-土城學府,2024-09-11,9822
00957B,兆豐US優選投等債,15,0,15,元大-土城學府,2024-09-11,9822
1464,得力,15,0,15,元大-土城學府,2024-09-11,9822
6757,台灣虎航,15,0,15,元大-土城學府,2024-09-11,9822
00936,台新永續高息中小,14,0,14,元大-土城學府,2024-09-11,9822
00933B,國泰10Y+金融債,12,0,12,元大-土城學府,2024-09-11,9822
2883,凱基金,13,1,12,元大-土城學府,2024-09-11,9822
3518,柏騰,11,0,11,元大-土城學府,2024-09-11,9822
6108,競國,12,1,11,元大-土城學府,2024-09-11,9822
00931B,統一美債20年,10,0,10,元大-土城學府,2024-09-11,9822
00956,中信日經高股息,10,0,10,元大-土城學府,2024-09-11,9822
2354,鴻準,11,1,10,元大-土城學府,2024-09-11,9822
2402,毅嘉,13,3,10,元大-土城學府,2024-09-11,9822
2515,中工,11,1,10,元大-土城學府,2024-09-11,9822
3363,上詮,12,2,10,元大-土城學府,2024-09-11,9822
00715L,期街口布蘭特正2,11,2,9,元大-土城學府,2024-09-11,9822
00959B,大華投等美債15Y+,11,2,9,元大-土城學府,2024-09-11,9822
2897,王道銀行,9,0,9,元大-土城學府,2024-09-11,9822
00940,元大台灣價值高息,38,31,7,元大-土城學府,2024-09-11,9822
00939,統一台灣高息動能,7,0,7,元大-土城學府,2024-09-11,9822
1536,和大,7,0,7,元大-土城學府,2024-09-11,9822
8074,鉅橡,7,0,7,元大-土城學府,2024-09-11,9822
8096,擎亞,13,6,7,元大-土城學府,2024-09-11,9822
00720B,元大投資級公司債,10,3,7,元大-土城學府,2024-09-11,9822
00751B,元大AAA至A公司債,7,0,7,元大-土城學府,2024-09-11,9822
2313,華通,21,15,6,元大-土城學府,2024-09-11,9822
1540,喬福,24,18,6,元大-土城學府,2024-09-11,9822
00918,大華優利高填息30,8,2,6,元大-土城學府,2024-09-11,9822
00945B,凱基美國非投等債,6,0,6,元大-土城學府,2024-09-11,9822
3047,訊舟,14,8,6,元大-土城學府,2024-09-11,9822
6133,金橋,7,1,6,元大-土城學府,2024-09-11,9822
3013,晟銘電,11,6,5,元大-土城學府,2024-09-11,9822
00671R,富邦NASDAQ反1,5,0,5,元大-土城學府,2024-09-11,9822
00650L,復華香港正2,5,0,5,元大-土城學府,2024-09-11,9822
00915,凱基優選高股息30,5,0,5,元大-土城學府,2024-09-11,9822
00907,永豐優息存股,5,0,5,元大-土城學府,2024-09-11,9822
00632R,元大台灣50反1,1089,620,469,元大-土城學府,2024-09-12,9822
00712,復華富時不動產,151,0,151,元大-土城學府,2024-09-12,9822
00918,大華優利高填息30,67,7,60,元大-土城學府,2024-09-12,9822
00687B,國泰20年美債,71,13,58,元大-土城學府,2024-09-12,9822
4977,眾達-KY,59,8,51,元大-土城學府,2024-09-12,9822
2888,新光金,171,126,45,元大-土城學府,2024-09-12,9822
3715,定穎投控,46,3,43,元大-土城學府,2024-09-12,9822
00935,野村臺灣新科技50,33,0,33,元大-土城學府,2024-09-12,9822
2543,皇昌,22,0,22,元大-土城學府,2024-09-12,9822
1101,台泥,21,1,20,元大-土城學府,2024-09-12,9822
2891,中信金,24,7,17,元大-土城學府,2024-09-12,9822
00931B,統一美債20年,14,0,14,元大-土城學府,2024-09-12,9822
00631L,元大台灣50正2,13,0,13,元大-土城學府,2024-09-12,9822
00878,國泰永續高股息,12,0,12,元大-土城學府,2024-09-12,9822
00680L,元大美債20正2,40,28,12,元大-土城學府,2024-09-12,9822
00959B,大華投等美債15Y+,12,0,12,元大-土城學府,2024-09-12,9822
00713,元大台灣高息低波,11,0,11,元大-土城學府,2024-09-12,9822
00795B,中信美國公債20年,10,0,10,元大-土城學府,2024-09-12,9822
2316,楠梓電,11,1,10,元大-土城學府,2024-09-12,9822
2882,國泰金,10,0,10,元大-土城學府,2024-09-12,9822
6531,愛普*,13,3,10,元大-土城學府,2024-09-12,9822
8147,正淩,10,0,10,元大-土城學府,2024-09-12,9822
3587,閎康,9,0,9,元大-土城學府,2024-09-12,9822
2489,瑞軒,11,2,9,元大-土城學府,2024-09-12,9822
2497,怡利電,19,10,9,元大-土城學府,2024-09-12,9822
3189,景碩,13,4,9,元大-土城學府,2024-09-12,9822
4562,穎漢,9,1,8,元大-土城學府,2024-09-12,9822
2313,華通,14,7,7,元大-土城學府,2024-09-12,9822
00937B,群益ESG投等債20,6,0,6,元大-土城學府,2024-09-12,9822
2399,映泰,11,5,6,元大-土城學府,2024-09-12,9822
3356,奇偶,6,0,6,元大-土城學府,2024-09-12,9822
6152,百一,6,0,6,元大-土城學府,2024-09-12,9822
2881,富邦金,12,6,6,元大-土城學府,2024-09-12,9822
3017,奇鋐,9,4,5,元大-土城學府,2024-09-12,9822
2467,志聖,5,0,5,元大-土城學府,2024-09-12,9822
2609,陽明,14,9,5,元大-土城學府,2024-09-12,9822
00915,凱基優選高股息30,8,3,5,元大-土城學府,2024-09-12,9822
00957B,兆豐US優選投等債,5,0,5,元大-土城學府,2024-09-12,9822
1785,光洋科,5,0,5,元大-土城學府,2024-09-12,9822
2405,輔信,5,0,5,元大-土城學府,2024-09-12,9822
3094,聯傑,5,0,5,元大-土城學府,2024-09-12,9822
3712,永崴投控,7,2,5,元大-土城學府,2024-09-12,9822
4533,協易機,5,0,5,元大-土城學府,2024-09-12,9822
6443,元晶,7,2,5,元大-土城學府,2024-09-12,9822
00919,群益台灣精選高息,17,12,5,元大-土城學府,2024-09-12,9822
6187,萬潤,55,51,4,元大-土城學府,2024-09-12,9822
4763,材料-KY,5,1,4,元大-土城學府,2024-09-12,9822
00882,中信中國高股息,5,1,4,元大-土城學府,2024-09-12,9822
1808,潤隆,4,0,4,元大-土城學府,2024-09-12,9822
2349,錸德,25,21,4,元大-土城學府,2024-09-12,9822
00632R,元大台灣50反1,102,1,101,元大-土城學府,2024-09-13,9822
2883,凱基金,85,1,84,元大-土城學府,2024-09-13,9822
00929,復華台灣科技優息,44,1,43,元大-土城學府,2024-09-13,9822
4979,華星光,51,20,31,元大-土城學府,2024-09-13,9822
00934,中信成長高股息,1007,977,30,元大-土城學府,2024-09-13,9822
3360,尚立,32,2,30,元大-土城學府,2024-09-13,9822
00878,國泰永續高股息,21,0,21,元大-土城學府,2024-09-13,9822
2344,華邦電,21,0,21,元大-土城學府,2024-09-13,9822
3706,神達,27,9,18,元大-土城學府,2024-09-13,9822
6152,百一,17,0,17,元大-土城學府,2024-09-13,9822
00918,大華優利高填息30,26,10,16,元大-土城學府,2024-09-13,9822
2888,新光金,21,5,16,元大-土城學府,2024-09-13,9822
6213,聯茂,15,0,15,元大-土城學府,2024-09-13,9822
3013,晟銘電,19,5,14,元大-土城學府,2024-09-13,9822
3363,上詮,15,1,14,元大-土城學府,2024-09-13,9822
2891,中信金,13,0,13,元大-土城學府,2024-09-13,9822
00940,元大台灣價值高息,18,5,13,元大-土城學府,2024-09-13,9822
00687B,國泰20年美債,15,3,12,元大-土城學府,2024-09-13,9822
5905,南仁湖,22,10,12,元大-土城學府,2024-09-13,9822
00919,群益台灣精選高息,13,1,12,元大-土城學府,2024-09-13,9822
00665L,富邦�琤肭磪囓�2,10,0,10,元大-土城學府,2024-09-13,9822
2371,大同,47,38,9,元大-土城學府,2024-09-13,9822
2402,毅嘉,23,14,9,元大-土城學府,2024-09-13,9822
6770,力積電,36,27,9,元大-土城學府,2024-09-13,9822
00713,元大台灣高息低波,8,0,8,元大-土城學府,2024-09-13,9822
3289,宜特,11,3,8,元大-土城學府,2024-09-13,9822
00945B,凱基美國非投等債,7,0,7,元大-土城學府,2024-09-13,9822
4510,高鋒,27,20,7,元大-土城學府,2024-09-13,9822
8011,台通,10,3,7,元大-土城學府,2024-09-13,9822
2301,光寶科,8,1,7,元大-土城學府,2024-09-13,9822
0056,元大高股息,7,0,7,元大-土城學府,2024-09-13,9822
00679B,元大美債20年,17,11,6,元大-土城學府,2024-09-13,9822
00951,台新日本半導體,6,0,6,元大-土城學府,2024-09-13,9822
2362,藍天,7,1,6,元大-土城學府,2024-09-13,9822
1301,台塑,14,8,6,元大-土城學府,2024-09-13,9822
00882,中信中國高股息,5,0,5,元大-土城學府,2024-09-13,9822
1326,台化,5,0,5,元大-土城學府,2024-09-13,9822
3379,彬台,5,0,5,元大-土城學府,2024-09-13,9822
3663,鑫科,27,22,5,元大-土城學府,2024-09-13,9822
6104,創惟,7,2,5,元大-土城學府,2024-09-13,9822
6129,普誠,5,0,5,元大-土城學府,2024-09-13,9822
8096,擎亞,5,0,5,元大-土城學府,2024-09-13,9822
00948B,中信優息投資級債,4,0,4,元大-土城學府,2024-09-13,9822
2331,精英,4,0,4,元大-土城學府,2024-09-13,9822
3312,弘憶股,4,0,4,元大-土城學府,2024-09-13,9822
6405,悅城,14,10,4,元大-土城學府,2024-09-13,9822
6547,高端疫苗,4,0,4,元大-土城學府,2024-09-13,9822
8442,威宏-KY,4,0,4,元大-土城學府,2024-09-13,9822
4977,眾達-KY,6,2,4,元大-土城學府,2024-09-13,9822
00915,凱基優選高股息30,4,0,4,元大-土城學府,2024-09-13,9822
00687B,國泰20年美債,102,31,71,元大-土城學府,2024-09-16,9822
00919,群益台灣精選高息,67,7,60,元大-土城學府,2024-09-16,9822
00680L,元大美債20正2,72,18,54,元大-土城學府,2024-09-16,9822
2618,長榮航,52,5,47,元大-土城學府,2024-09-16,9822
8096,擎亞,38,1,37,元大-土城學府,2024-09-16,9822
00713,元大台灣高息低波,33,0,33,元大-土城學府,2024-09-16,9822
00918,大華優利高填息30,31,0,31,元大-土城學府,2024-09-16,9822
2070,精湛,36,5,31,元大-土城學府,2024-09-16,9822
4977,眾達-KY,35,6,29,元大-土城學府,2024-09-16,9822
1540,喬福,37,13,24,元大-土城學府,2024-09-16,9822
9105,泰金寶-DR,23,0,23,元大-土城學府,2024-09-16,9822
6128,上福,21,0,21,元大-土城學府,2024-09-16,9822
00715L,期街口布蘭特正2,19,0,19,元大-土城學府,2024-09-16,9822
00679B,元大美債20年,19,1,18,元大-土城學府,2024-09-16,9822
8383,千附,23,5,18,元大-土城學府,2024-09-16,9822
00937B,群益ESG投等債20,15,0,15,元大-土城學府,2024-09-16,9822
2497,怡利電,18,5,13,元大-土城學府,2024-09-16,9822
00632R,元大台灣50反1,13,2,11,元大-土城學府,2024-09-16,9822
2344,華邦電,13,2,11,元大-土城學府,2024-09-16,9822
00664R,國泰臺灣加權反1,10,0,10,元大-土城學府,2024-09-16,9822
00706L,期元大S＆P日圓正2,10,0,10,元大-土城學府,2024-09-16,9822
00857B,永豐20年美公債,10,0,10,元大-土城學府,2024-09-16,9822
00933B,國泰10Y+金融債,10,0,10,元大-土城學府,2024-09-16,9822
2609,陽明,10,0,10,元大-土城學府,2024-09-16,9822
6443,元晶,14,4,10,元大-土城學府,2024-09-16,9822
1785,光洋科,46,37,9,元大-土城學府,2024-09-16,9822
2402,毅嘉,11,2,9,元大-土城學府,2024-09-16,9822
2428,興勤,10,1,9,元大-土城學府,2024-09-16,9822
2062,橋椿,14,6,8,元大-土城學府,2024-09-16,9822
1326,台化,9,1,8,元大-土城學府,2024-09-16,9822
6530,創威,23,15,8,元大-土城學府,2024-09-16,9822
6531,愛普*,15,7,8,元大-土城學府,2024-09-16,9822
00929,復華台灣科技優息,13,5,8,元大-土城學府,2024-09-16,9822
3037,欣興,7,0,7,元大-土城學府,2024-09-16,9822
00959B,大華投等美債15Y+,7,0,7,元大-土城學府,2024-09-16,9822
3231,緯創,16,9,7,元大-土城學府,2024-09-16,9822
3303,岱稜,17,10,7,元大-土城學府,2024-09-16,9822
4563,百德,13,6,7,元大-土城學府,2024-09-16,9822
6505,台塑化,7,0,7,元大-土城學府,2024-09-16,9822
1303,南亞,9,3,6,元大-土城學府,2024-09-16,9822
3149,正達,8,2,6,元大-土城學府,2024-09-16,9822
1229,聯華,6,0,6,元大-土城學府,2024-09-16,9822
1309,台達化,7,1,6,元大-土城學府,2024-09-16,9822
2201,裕隆,6,0,6,元大-土城學府,2024-09-16,9822
3289,宜特,10,4,6,元大-土城學府,2024-09-16,9822
3290,東浦,6,0,6,元大-土城學府,2024-09-16,9822
8011,台通,7,1,6,元大-土城學府,2024-09-16,9822
00795B,中信美國公債20年,6,0,6,元大-土城學府,2024-09-16,9822
00881,國泰台灣5G+,5,0,5,元大-土城學府,2024-09-16,9822
00936,台新永續高息中小,11,6,5,元大-土城學府,2024-09-16,9822
00929,復華台灣科技優息,177,30,147,元大-土城學府,2024-09-18,9822
2891,中信金,176,48,128,元大-土城學府,2024-09-18,9822
00919,群益台灣精選高息,117,9,108,元大-土城學府,2024-09-18,9822
2888,新光金,141,42,99,元大-土城學府,2024-09-18,9822
00934,中信成長高股息,99,0,99,元大-土城學府,2024-09-18,9822
00953B,群益優選非投等債,93,10,83,元大-土城學府,2024-09-18,9822
2887,台新金,62,0,62,元大-土城學府,2024-09-18,9822
6517,保勝光學,60,0,60,元大-土城學府,2024-09-18,9822
3607,谷崧,51,0,51,元大-土城學府,2024-09-18,9822
2317,鴻海,65,26,39,元大-土城學府,2024-09-18,9822
00679B,元大美債20年,44,6,38,元大-土城學府,2024-09-18,9822
00713,元大台灣高息低波,33,0,33,元大-土城學府,2024-09-18,9822
00688L,國泰20年美債正2,39,10,29,元大-土城學府,2024-09-18,9822
8070,長華*,30,1,29,元大-土城學府,2024-09-18,9822
2477,美隆電,33,5,28,元大-土城學府,2024-09-18,9822
2233,宇隆,26,0,26,元大-土城學府,2024-09-18,9822
0056,元大高股息,26,0,26,元大-土城學府,2024-09-18,9822
3715,定穎投控,25,1,24,元大-土城學府,2024-09-18,9822
00706L,期元大S＆P日圓正2,20,0,20,元大-土城學府,2024-09-18,9822
2243,宏旭-KY,20,2,18,元大-土城學府,2024-09-18,9822
2313,華通,18,1,17,元大-土城學府,2024-09-18,9822
00751B,元大AAA至A公司債,16,0,16,元大-土城學府,2024-09-18,9822
3147,大綜,15,0,15,元大-土城學府,2024-09-18,9822
00945B,凱基美國非投等債,15,0,15,元大-土城學府,2024-09-18,9822
6218,豪勉,15,0,15,元大-土城學府,2024-09-18,9822
6456,GIS-KY,20,5,15,元大-土城學府,2024-09-18,9822
1785,光洋科,49,34,15,元大-土城學府,2024-09-18,9822
00637L,元大滬深300正2,13,0,13,元大-土城學府,2024-09-18,9822
9105,泰金寶-DR,19,6,13,元大-土城學府,2024-09-18,9822
00905,FT臺灣Smart,12,0,12,元大-土城學府,2024-09-18,9822
3481,群創,20,8,12,元大-土城學府,2024-09-18,9822
00720B,元大投資級公司債,11,0,11,元大-土城學府,2024-09-18,9822
00918,大華優利高填息30,13,2,11,元大-土城學府,2024-09-18,9822
00931B,統一美債20年,20,10,10,元大-土城學府,2024-09-18,9822
00669R,國泰美國道瓊反1,10,0,10,元大-土城學府,2024-09-18,9822
00958B,永豐ESG銀行債15,10,0,10,元大-土城學府,2024-09-18,9822
00959B,大華投等美債15Y+,10,0,10,元大-土城學府,2024-09-18,9822
2338,光罩,10,0,10,元大-土城學府,2024-09-18,9822
2537,聯上發,12,2,10,元大-土城學府,2024-09-18,9822
4401,東隆興,10,0,10,元大-土城學府,2024-09-18,9822
2449,京元電子,10,0,10,元大-土城學府,2024-09-18,9822
1314,中石化,10,1,9,元大-土城學府,2024-09-18,9822
2303,聯電,8,0,8,元大-土城學府,2024-09-18,9822
00687B,國泰20年美債,15,7,8,元大-土城學府,2024-09-18,9822
00915,凱基優選高股息30,8,0,8,元大-土城學府,2024-09-18,9822
1522,堤維西,8,0,8,元大-土城學府,2024-09-18,9822
3044,健鼎,9,1,8,元大-土城學府,2024-09-18,9822
00921,兆豐龍頭等權重,7,0,7,元大-土城學府,2024-09-18,9822
1711,永光,15,8,7,元大-土城學府,2024-09-18,9822
3047,訊舟,7,0,7,元大-土城學府,2024-09-18,9822
00929,復華台灣科技優息,253,16,237,元大-土城學府,2024-09-19,9822
00937B,群益ESG投等債20,123,15,108,元大-土城學府,2024-09-19,9822
3049,精金,121,32,89,元大-土城學府,2024-09-19,9822
00919,群益台灣精選高息,84,0,84,元大-土城學府,2024-09-19,9822
00680L,元大美債20正2,104,29,75,元大-土城學府,2024-09-19,9822
3689,湧德,68,3,65,元大-土城學府,2024-09-19,9822
00958B,永豐ESG銀行債15,50,0,50,元大-土城學府,2024-09-19,9822
2399,映泰,92,47,45,元大-土城學府,2024-09-19,9822
2888,新光金,51,9,42,元大-土城學府,2024-09-19,9822
00931B,統一美債20年,37,0,37,元大-土城學府,2024-09-19,9822
00687B,國泰20年美債,78,45,33,元大-土城學府,2024-09-19,9822
6257,矽格,32,1,31,元大-土城學府,2024-09-19,9822
00632R,元大台灣50反1,179,152,27,元大-土城學府,2024-09-19,9822
00720B,元大投資級公司債,29,2,27,元大-土城學府,2024-09-19,9822
2313,華通,20,1,19,元大-土城學府,2024-09-19,9822
00688L,國泰20年美債正2,18,0,18,元大-土城學府,2024-09-19,9822
8070,長華*,25,7,18,元大-土城學府,2024-09-19,9822
00946,群益科技高息成長,15,0,15,元大-土城學府,2024-09-19,9822
2539,櫻花建,15,0,15,元大-土城學府,2024-09-19,9822
4977,眾達-KY,26,11,15,元大-土城學府,2024-09-19,9822
1229,聯華,14,0,14,元大-土城學府,2024-09-19,9822
00706L,期元大S＆P日圓正2,15,2,13,元大-土城學府,2024-09-19,9822
00915,凱基優選高股息30,15,2,13,元大-土城學府,2024-09-19,9822
00779B,凱基美債25+,12,0,12,元大-土城學府,2024-09-19,9822
1101,台泥,14,2,12,元大-土城學府,2024-09-19,9822
00751B,元大AAA至A公司債,11,0,11,元大-土城學府,2024-09-19,9822
6288,聯嘉,18,7,11,元大-土城學府,2024-09-19,9822
00696B,富邦美債20年,10,0,10,元大-土城學府,2024-09-19,9822
00945B,凱基美國非投等債,10,0,10,元大-土城學府,2024-09-19,9822
2349,錸德,16,6,10,元大-土城學府,2024-09-19,9822
2477,美隆電,12,2,10,元大-土城學府,2024-09-19,9822
8074,鉅橡,13,3,10,元大-土城學府,2024-09-19,9822
8096,擎亞,20,10,10,元大-土城學府,2024-09-19,9822
00633L,富邦上証正2,9,0,9,元大-土城學府,2024-09-19,9822
00922,國泰台灣領袖50,10,1,9,元大-土城學府,2024-09-19,9822
1442,名軒,14,5,9,元大-土城學府,2024-09-19,9822
2344,華邦電,12,3,9,元大-土城學府,2024-09-19,9822
3044,健鼎,9,0,9,元大-土城學府,2024-09-19,9822
3056,富華新,10,1,9,元大-土城學府,2024-09-19,9822
6128,上福,9,0,9,元大-土城學府,2024-09-19,9822
6152,百一,9,0,9,元大-土城學府,2024-09-19,9822
6530,創威,10,1,9,元大-土城學府,2024-09-19,9822
00930,永豐ESG低碳高息,11,3,8,元大-土城學府,2024-09-19,9822
00918,大華優利高填息30,12,4,8,元大-土城學府,2024-09-19,9822
00764B,群益25年美債,8,0,8,元大-土城學府,2024-09-19,9822
00933B,國泰10Y+金融債,7,0,7,元大-土城學府,2024-09-19,9822
1316,上曜,7,0,7,元大-土城學府,2024-09-19,9822
4755,三福化,7,0,7,元大-土城學府,2024-09-19,9822
8421,旭源,6,0,6,元大-土城學府,2024-09-19,9822
3413,京鼎,8,2,6,元大-土城學府,2024-09-19,9822
00919,群益台灣精選高息,228,3,225,元大-土城學府,2024-09-20,9822
1524,耿鼎,106,0,106,元大-土城學府,2024-09-20,9822
00679B,元大美債20年,132,62,70,元大-土城學府,2024-09-20,9822
2888,新光金,51,7,44,元大-土城學府,2024-09-20,9822
2233,宇隆,38,0,38,元大-土城學府,2024-09-20,9822
00713,元大台灣高息低波,42,5,37,元大-土城學府,2024-09-20,9822
00937B,群益ESG投等債20,60,27,33,元大-土城學府,2024-09-20,9822
00680L,元大美債20正2,78,45,33,元大-土城學府,2024-09-20,9822
4513,福裕,33,3,30,元大-土城學府,2024-09-20,9822
1785,光洋科,33,5,28,元大-土城學府,2024-09-20,9822
5905,南仁湖,25,1,24,元大-土城學府,2024-09-20,9822
8096,擎亞,20,0,20,元大-土城學府,2024-09-20,9822
2344,華邦電,23,4,19,元大-土城學府,2024-09-20,9822
3005,神基,17,0,17,元大-土城學府,2024-09-20,9822
6517,保勝光學,17,0,17,元大-土城學府,2024-09-20,9822
2464,盟立,59,45,14,元大-土城學府,2024-09-20,9822
00960,野村全球航運龍頭,13,0,13,元大-土城學府,2024-09-20,9822
2303,聯電,24,12,12,元大-土城學府,2024-09-20,9822
3673,TPK-KY,12,0,12,元大-土城學府,2024-09-20,9822
4919,新唐,11,0,11,元大-土城學府,2024-09-20,9822
3081,聯亞,10,0,10,元大-土城學府,2024-09-20,9822
00946,群益科技高息成長,10,0,10,元大-土城學府,2024-09-20,9822
1536,和大,10,0,10,元大-土城學府,2024-09-20,9822
2329,華泰,11,1,10,元大-土城學府,2024-09-20,9822
2867,三商壽,10,0,10,元大-土城學府,2024-09-20,9822
2889,國票金,10,0,10,元大-土城學府,2024-09-20,9822
6143,振曜,12,2,10,元大-土城學府,2024-09-20,9822
6462,神盾,10,0,10,元大-土城學府,2024-09-20,9822
8111,立��,10,0,10,元大-土城學府,2024-09-20,9822
1316,上曜,13,3,10,元大-土城學府,2024-09-20,9822
1817,凱撒衛,9,0,9,元大-土城學府,2024-09-20,9822
2477,美隆電,12,3,9,元大-土城學府,2024-09-20,9822
8044,網家,10,1,9,元大-土城學府,2024-09-20,9822
2062,橋椿,14,5,9,元大-土城學府,2024-09-20,9822
00795B,中信美國公債20年,10,2,8,元大-土城學府,2024-09-20,9822
6789,采鈺,8,0,8,元大-土城學府,2024-09-20,9822
2883,凱基金,12,4,8,元大-土城學府,2024-09-20,9822
5483,中美晶,8,0,8,元大-土城學府,2024-09-20,9822
3062,建漢,29,22,7,元大-土城學府,2024-09-20,9822
3303,岱稜,8,1,7,元大-土城學府,2024-09-20,9822
3312,弘憶股,7,0,7,元大-土城學府,2024-09-20,9822
3390,旭軟,41,34,7,元大-土城學府,2024-09-20,9822
6706,惠特,8,1,7,元大-土城學府,2024-09-20,9822
8089,康全電訊,7,0,7,元大-土城學府,2024-09-20,9822
4526,東台,21,15,6,元大-土城學府,2024-09-20,9822
2313,華通,9,3,6,元大-土城學府,2024-09-20,9822
00706L,期元大S＆P日圓正2,6,0,6,元大-土城學府,2024-09-20,9822
2545,皇翔,6,0,6,元大-土城學府,2024-09-20,9822
3149,正達,13,7,6,元大-土城學府,2024-09-20,9822
00930,永豐ESG低碳高息,7,1,6,元大-土城學府,2024-09-20,9822
9945,潤泰新,143,28,115,元大-土城學府,2024-09-23,9822
00957B,兆豐US優選投等債,110,0,110,元大-土城學府,2024-09-23,9822
00919,群益台灣精選高息,109,2,107,元大-土城學府,2024-09-23,9822
00937B,群益ESG投等債20,125,43,82,元大-土城學府,2024-09-23,9822
2399,映泰,96,30,66,元大-土城學府,2024-09-23,9822
2891,中信金,181,116,65,元大-土城學府,2024-09-23,9822
00679B,元大美債20年,61,0,61,元大-土城學府,2024-09-23,9822
00680L,元大美債20正2,60,0,60,元大-土城學府,2024-09-23,9822
00688L,國泰20年美債正2,56,0,56,元大-土城學府,2024-09-23,9822
2070,精湛,47,6,41,元大-土城學府,2024-09-23,9822
1313,聯成,35,0,35,元大-土城學府,2024-09-23,9822
1711,永光,44,11,33,元大-土城學府,2024-09-23,9822
2324,仁寶,32,0,32,元大-土城學府,2024-09-23,9822
6546,正基,53,21,32,元大-土城學府,2024-09-23,9822
1776,展宇,32,3,29,元大-土城學府,2024-09-23,9822
00706L,期元大S＆P日圓正2,27,0,27,元大-土城學府,2024-09-23,9822
6606,建德工業,27,0,27,元大-土城學府,2024-09-23,9822
6517,保勝光學,21,0,21,元大-土城學府,2024-09-23,9822
00664R,國泰臺灣加權反1,20,0,20,元大-土城學府,2024-09-23,9822
4707,磐亞,24,6,18,元大-土城學府,2024-09-23,9822
00687B,國泰20年美債,37,21,16,元大-土城學府,2024-09-23,9822
00887,永豐中國科技50大,15,0,15,元大-土城學府,2024-09-23,9822
5230,雷笛克光學,15,0,15,元大-土城學府,2024-09-23,9822
00632R,元大台灣50反1,14,0,14,元大-土城學府,2024-09-23,9822
00948B,中信優息投資級債,20,6,14,元大-土城學府,2024-09-23,9822
6223,旺矽,15,2,13,元大-土城學府,2024-09-23,9822
4977,眾達-KY,17,4,13,元大-土城學府,2024-09-23,9822
2488,漢平,12,0,12,元大-土城學府,2024-09-23,9822
6269,台郡,12,0,12,元大-土城學府,2024-09-23,9822
2495,普安,17,5,12,元大-土城學府,2024-09-23,9822
3037,欣興,15,3,12,元大-土城學府,2024-09-23,9822
2062,橋椿,20,9,11,元大-土城學府,2024-09-23,9822
3363,上詮,12,1,11,元大-土城學府,2024-09-23,9822
6552,易華電,15,4,11,元大-土城學府,2024-09-23,9822
8374,羅昇,11,0,11,元大-土城學府,2024-09-23,9822
3450,聯鈞,31,20,11,元大-土城學府,2024-09-23,9822
1727,中華化,22,12,10,元大-土城學府,2024-09-23,9822
6706,惠特,12,2,10,元大-土城學府,2024-09-23,9822
2464,盟立,27,18,9,元大-土城學府,2024-09-23,9822
2545,皇翔,12,3,9,元大-土城學府,2024-09-23,9822
5905,南仁湖,9,0,9,元大-土城學府,2024-09-23,9822
6405,悅城,13,4,9,元大-土城學府,2024-09-23,9822
00751B,元大AAA至A公司債,9,0,9,元大-土城學府,2024-09-23,9822
00918,大華優利高填息30,11,3,8,元大-土城學府,2024-09-23,9822
00921,兆豐龍頭等權重,8,0,8,元大-土城學府,2024-09-23,9822
1721,三晃,27,19,8,元大-土城學府,2024-09-23,9822
8421,旭源,8,0,8,元大-土城學府,2024-09-23,9822
00891,中信關鍵半導體,8,0,8,元大-土城學府,2024-09-23,9822
00922,國泰台灣領袖50,13,6,7,元大-土城學府,2024-09-23,9822
6757,台灣虎航,7,0,7,元大-土城學府,2024-09-23,9822
2891,中信金,163,18,145,元大-土城學府,2024-09-24,9822
00929,復華台灣科技優息,53,4,49,元大-土城學府,2024-09-24,9822
00687B,國泰20年美債,46,2,44,元大-土城學府,2024-09-24,9822
00680L,元大美債20正2,61,18,43,元大-土城學府,2024-09-24,9822
00919,群益台灣精選高息,39,7,32,元大-土城學府,2024-09-24,9822
00948B,中信優息投資級債,30,0,30,元大-土城學府,2024-09-24,9822
6517,保勝光學,34,4,30,元大-土城學府,2024-09-24,9822
8089,康全電訊,35,6,29,元大-土城學府,2024-09-24,9822
1524,耿鼎,31,5,26,元大-土城學府,2024-09-24,9822
00715L,期街口布蘭特正2,25,2,23,元大-土城學府,2024-09-24,9822
3019,亞光,34,13,21,元大-土城學府,2024-09-24,9822
00960,野村全球航運龍頭,20,0,20,元大-土城學府,2024-09-24,9822
6139,亞翔,19,1,18,元大-土城學府,2024-09-24,9822
00679B,元大美債20年,15,0,15,元大-土城學府,2024-09-24,9822
3005,神基,16,1,15,元大-土城學府,2024-09-24,9822
6274,台燿,14,0,14,元大-土城學府,2024-09-24,9822
00937B,群益ESG投等債20,24,10,14,元大-土城學府,2024-09-24,9822
3037,欣興,14,0,14,元大-土城學府,2024-09-24,9822
3715,定穎投控,90,77,13,元大-土城學府,2024-09-24,9822
4977,眾達-KY,16,3,13,元大-土城學府,2024-09-24,9822
1817,凱撒衛,12,0,12,元大-土城學府,2024-09-24,9822
1609,大亞,11,0,11,元大-土城學府,2024-09-24,9822
2344,華邦電,11,0,11,元大-土城學府,2024-09-24,9822
00946,群益科技高息成長,10,0,10,元大-土城學府,2024-09-24,9822
00936,台新永續高息中小,10,0,10,元大-土城學府,2024-09-24,9822
00712,復華富時不動產,10,0,10,元大-土城學府,2024-09-24,9822
2481,強茂,10,0,10,元大-土城學府,2024-09-24,9822
3712,永崴投控,10,0,10,元大-土城學府,2024-09-24,9822
4513,福裕,44,34,10,元大-土城學府,2024-09-24,9822
4906,正文,10,0,10,元大-土城學府,2024-09-24,9822
8080,印鉐,10,0,10,元大-土城學府,2024-09-24,9822
3149,正達,29,20,9,元大-土城學府,2024-09-24,9822
2356,英業達,17,8,9,元大-土城學府,2024-09-24,9822
2070,精湛,18,10,8,元大-土城學府,2024-09-24,9822
3516,亞帝歐,8,0,8,元大-土城學府,2024-09-24,9822
4716,大立,11,3,8,元大-土城學府,2024-09-24,9822
2313,華通,20,12,8,元大-土城學府,2024-09-24,9822
0056,元大高股息,10,2,8,元大-土城學府,2024-09-24,9822
2316,楠梓電,7,0,7,元大-土城學府,2024-09-24,9822
6257,矽格,9,2,7,元大-土城學府,2024-09-24,9822
6609,瀧澤科,8,1,7,元大-土城學府,2024-09-24,9822
00751B,元大AAA至A公司債,7,0,7,元大-土城學府,2024-09-24,9822
4563,百德,10,3,7,元大-土城學府,2024-09-24,9822
2882,國泰金,10,4,6,元大-土城學府,2024-09-24,9822
8096,擎亞,12,6,6,元大-土城學府,2024-09-24,9822
1307,三芳,7,1,6,元大-土城學府,2024-09-24,9822
2408,南亞科,6,0,6,元大-土城學府,2024-09-24,9822
4916,事欣科,6,0,6,元大-土城學府,2024-09-24,9822
3081,聯亞,15,10,5,元大-土城學府,2024-09-24,9822
00795B,中信美國公債20年,5,0,5,元大-土城學府,2024-09-24,9822
00632R,元大台灣50反1,149,30,119,元大-土城學府,2024-09-25,9822
00679B,元大美債20年,75,17,58,元大-土城學府,2024-09-25,9822
00881,國泰台灣5G+,52,3,49,元大-土城學府,2024-09-25,9822
00937B,群益ESG投等債20,50,1,49,元大-土城學府,2024-09-25,9822
6546,正基,53,5,48,元大-土城學府,2024-09-25,9822
2324,仁寶,51,3,48,元大-土城學府,2024-09-25,9822
00948B,中信優息投資級債,47,1,46,元大-土城學府,2024-09-25,9822
00708L,期元大S＆P黃金正2,44,0,44,元大-土城學府,2024-09-25,9822
00687B,國泰20年美債,43,3,40,元大-土城學府,2024-09-25,9822
00725B,國泰投資級公司債,23,0,23,元大-土城學府,2024-09-25,9822
3550,聯穎,74,51,23,元大-土城學府,2024-09-25,9822
00902,中信電池及儲能,20,0,20,元大-土城學府,2024-09-25,9822
1460,宏遠,20,0,20,元大-土城學府,2024-09-25,9822
2605,新興,33,13,20,元大-土城學府,2024-09-25,9822
3047,訊舟,50,30,20,元大-土城學府,2024-09-25,9822
00795B,中信美國公債20年,19,0,19,元大-土城學府,2024-09-25,9822
2312,金寶,20,1,19,元大-土城學府,2024-09-25,9822
00919,群益台灣精選高息,25,6,19,元大-土城學府,2024-09-25,9822
5258,虹堡,17,0,17,元大-土城學府,2024-09-25,9822
3149,正達,18,3,15,元大-土城學府,2024-09-25,9822
2062,橋椿,15,1,14,元大-土城學府,2024-09-25,9822
4903,聯光通,20,6,14,元大-土城學府,2024-09-25,9822
0056,元大高股息,15,2,13,元大-土城學府,2024-09-25,9822
4977,眾達-KY,14,1,13,元大-土城學府,2024-09-25,9822
3037,欣興,14,2,12,元大-土城學府,2024-09-25,9822
00680L,元大美債20正2,12,0,12,元大-土城學府,2024-09-25,9822
2401,凌陽,13,1,12,元大-土城學府,2024-09-25,9822
2436,偉詮電,42,30,12,元大-土城學府,2024-09-25,9822
2883,凱基金,12,0,12,元大-土城學府,2024-09-25,9822
5386,青雲,13,1,12,元大-土城學府,2024-09-25,9822
2365,昆盈,17,6,11,元大-土城學府,2024-09-25,9822
00946,群益科技高息成長,11,0,11,元大-土城學府,2024-09-25,9822
2636,台驊控股,11,0,11,元大-土城學府,2024-09-25,9822
9927,泰銘,11,0,11,元大-土城學府,2024-09-25,9822
1219,福壽,10,0,10,元大-土城學府,2024-09-25,9822
2539,櫻花建,10,0,10,元大-土城學府,2024-09-25,9822
8147,正淩,12,2,10,元大-土城學府,2024-09-25,9822
6443,元晶,10,0,10,元大-土城學府,2024-09-25,9822
2228,劍麟,10,1,9,元大-土城學府,2024-09-25,9822
3163,波若威,10,1,9,元大-土城學府,2024-09-25,9822
8070,長華*,11,3,8,元大-土城學府,2024-09-25,9822
3481,群創,12,4,8,元大-土城學府,2024-09-25,9822
1727,中華化,9,1,8,元大-土城學府,2024-09-25,9822
6770,力積電,14,6,8,元大-土城學府,2024-09-25,9822
00751B,元大AAA至A公司債,7,0,7,元大-土城學府,2024-09-25,9822
00712,復華富時不動產,7,0,7,元大-土城學府,2024-09-25,9822
5347,世界,7,1,6,元大-土城學府,2024-09-25,9822
3715,定穎投控,25,19,6,元大-土城學府,2024-09-25,9822
00960,野村全球航運龍頭,19,13,6,元大-土城學府,2024-09-25,9822
3033,威健,6,0,6,元大-土城學府,2024-09-25,9822
1522,堤維西,130,0,130,元大-土城學府,2024-09-26,9822
00948B,中信優息投資級債,126,5,121,元大-土城學府,2024-09-26,9822
2605,新興,125,23,102,元大-土城學府,2024-09-26,9822
00937B,群益ESG投等債20,110,10,100,元大-土城學府,2024-09-26,9822
00934,中信成長高股息,115,15,100,元大-土城學府,2024-09-26,9822
00632R,元大台灣50反1,105,10,95,元大-土城學府,2024-09-26,9822
2888,新光金,113,27,86,元大-土城學府,2024-09-26,9822
00929,復華台灣科技優息,115,42,73,元大-土城學府,2024-09-26,9822
00679B,元大美債20年,68,8,60,元大-土城學府,2024-09-26,9822
3019,亞光,73,15,58,元大-土城學府,2024-09-26,9822
00680L,元大美債20正2,56,0,56,元大-土城學府,2024-09-26,9822
2356,英業達,65,10,55,元大-土城學府,2024-09-26,9822
2324,仁寶,44,10,34,元大-土城學府,2024-09-26,9822
1524,耿鼎,34,1,33,元大-土城學府,2024-09-26,9822
3550,聯穎,39,6,33,元大-土城學府,2024-09-26,9822
00918,大華優利高填息30,32,0,32,元大-土城學府,2024-09-26,9822
00960,野村全球航運龍頭,32,1,31,元大-土城學府,2024-09-26,9822
6517,保勝光學,21,0,21,元大-土城學府,2024-09-26,9822
00720B,元大投資級公司債,21,0,21,元大-土城學府,2024-09-26,9822
00713,元大台灣高息低波,21,0,21,元大-土城學府,2024-09-26,9822
6274,台燿,20,0,20,元大-土城學府,2024-09-26,9822
3607,谷崧,19,0,19,元大-土城學府,2024-09-26,9822
3673,TPK-KY,29,11,18,元大-土城學府,2024-09-26,9822
4532,瑞智,18,0,18,元大-土城學府,2024-09-26,9822
00751B,元大AAA至A公司債,17,0,17,元大-土城學府,2024-09-26,9822
2367,燿華,19,3,16,元大-土城學府,2024-09-26,9822
3715,定穎投控,42,26,16,元大-土城學府,2024-09-26,9822
2365,昆盈,20,4,16,元大-土城學府,2024-09-26,9822
2317,鴻海,56,41,15,元大-土城學府,2024-09-26,9822
00946,群益科技高息成長,16,2,14,元大-土城學府,2024-09-26,9822
2383,台光電,12,0,12,元大-土城學府,2024-09-26,9822
6570,維田,12,0,12,元大-土城學府,2024-09-26,9822
8374,羅昇,14,2,12,元大-土城學府,2024-09-26,9822
00772B,中信高評級公司債,11,0,11,元大-土城學府,2024-09-26,9822
00706L,期元大S＆P日圓正2,11,0,11,元大-土城學府,2024-09-26,9822
00927,群益半導體收益,11,0,11,元大-土城學府,2024-09-26,9822
00688L,國泰20年美債正2,15,5,10,元大-土城學府,2024-09-26,9822
1540,喬福,40,30,10,元大-土城學府,2024-09-26,9822
3289,宜特,10,0,10,元大-土城學府,2024-09-26,9822
3455,由田,10,0,10,元大-土城學府,2024-09-26,9822
4563,百德,11,2,9,元大-土城學府,2024-09-26,9822
00945B,凱基美國非投等債,9,0,9,元大-土城學府,2024-09-26,9822
2070,精湛,13,4,9,元大-土城學府,2024-09-26,9822
4903,聯光通,11,2,9,元大-土城學府,2024-09-26,9822
6873,泓德能源,8,0,8,元大-土城學府,2024-09-26,9822
6923,中台,8,0,8,元大-土城學府,2024-09-26,9822
3293,鈊象,9,2,7,元大-土城學府,2024-09-26,9822
3605,宏致,13,6,7,元大-土城學府,2024-09-26,9822
1785,光洋科,32,25,7,元大-土城學府,2024-09-26,9822
1301,台塑,10,3,7,元大-土城學府,2024-09-26,9822
00934,中信成長高股息,502,29,473,元大-土城學府,2024-09-27,9822
00687B,國泰20年美債,106,12,94,元大-土城學府,2024-09-27,9822
00937B,群益ESG投等債20,114,26,88,元大-土城學府,2024-09-27,9822
00919,群益台灣精選高息,59,5,54,元大-土城學府,2024-09-27,9822
2891,中信金,53,7,46,元大-土城學府,2024-09-27,9822
2886,兆豐金,35,3,32,元大-土城學府,2024-09-27,9822
4979,華星光,52,20,32,元大-土城學府,2024-09-27,9822
00960,野村全球航運龍頭,33,5,28,元大-土城學府,2024-09-27,9822
00933B,國泰10Y+金融債,25,0,25,元大-土城學府,2024-09-27,9822
3363,上詮,26,4,22,元大-土城學府,2024-09-27,9822
00679B,元大美債20年,41,21,20,元大-土城學府,2024-09-27,9822
00715L,期街口布蘭特正2,20,0,20,元大-土城學府,2024-09-27,9822
00953B,群益優選非投等債,19,0,19,元大-土城學府,2024-09-27,9822
00882,中信中國高股息,100,81,19,元大-土城學府,2024-09-27,9822
00632R,元大台灣50反1,25,6,19,元大-土城學府,2024-09-27,9822
3550,聯穎,45,26,19,元大-土城學府,2024-09-27,9822
2883,凱基金,29,11,18,元大-土城學府,2024-09-27,9822
1815,富喬,18,1,17,元大-土城學府,2024-09-27,9822
8249,菱光,17,1,16,元大-土城學府,2024-09-27,9822
2313,華通,25,10,15,元大-土城學府,2024-09-27,9822
2495,普安,15,0,15,元大-土城學府,2024-09-27,9822
4906,正文,14,0,14,元大-土城學府,2024-09-27,9822
3605,宏致,13,0,13,元大-土城學府,2024-09-27,9822
3289,宜特,12,0,12,元大-土城學府,2024-09-27,9822
6243,迅杰,12,0,12,元大-土城學府,2024-09-27,9822
2371,大同,17,6,11,元大-土城學府,2024-09-27,9822
6138,茂達,11,0,11,元大-土城學府,2024-09-27,9822
2539,櫻花建,10,0,10,元大-土城學府,2024-09-27,9822
00725B,國泰投資級公司債,10,0,10,元大-土城學府,2024-09-27,9822
2409,友達,13,3,10,元大-土城學府,2024-09-27,9822
3323,加百裕,10,0,10,元大-土城學府,2024-09-27,9822
1432,大魯閣,10,1,9,元大-土城學府,2024-09-27,9822
2606,裕民,25,16,9,元大-土城學府,2024-09-27,9822
00646,元大S＆P500,8,0,8,元大-土城學府,2024-09-27,9822
1736,喬山,9,1,8,元大-土城學府,2024-09-27,9822
3013,晟銘電,17,9,8,元大-土城學府,2024-09-27,9822
1540,喬福,23,16,7,元大-土城學府,2024-09-27,9822
3019,亞光,15,9,6,元大-土城學府,2024-09-27,9822
00712,復華富時不動產,8,2,6,元大-土城學府,2024-09-27,9822
1336,台翰,6,0,6,元大-土城學府,2024-09-27,9822
2611,志信,6,0,6,元大-土城學府,2024-09-27,9822
8150,南茂,6,0,6,元大-土城學府,2024-09-27,9822
2363,矽統,15,10,5,元大-土城學府,2024-09-27,9822
1326,台化,7,2,5,元大-土城學府,2024-09-27,9822
00899,FT潔淨能源,5,0,5,元大-土城學府,2024-09-27,9822
00696B,富邦美債20年,5,0,5,元大-土城學府,2024-09-27,9822
00772B,中信高評級公司債,5,0,5,元大-土城學府,2024-09-27,9822
00931B,統一美債20年,5,0,5,元大-土城學府,2024-09-27,9822
1103,嘉泥,5,0,5,元大-土城學府,2024-09-27,9822
2233,宇隆,5,0,5,元大-土城學府,2024-09-27,9822
2888,新光金,301,6,295,元大-土城學府,2024-09-30,9822
00937B,群益ESG投等債20,195,4,191,元大-土城學府,2024-09-30,9822
00919,群益台灣精選高息,145,8,137,元大-土城學府,2024-09-30,9822
00940,元大台灣價值高息,144,13,131,元大-土城學府,2024-09-30,9822
2881,富邦金,87,1,86,元大-土城學府,2024-09-30,9822
2609,陽明,106,38,68,元大-土城學府,2024-09-30,9822
00953B,群益優選非投等債,63,0,63,元大-土城學府,2024-09-30,9822
2867,三商壽,45,0,45,元大-土城學府,2024-09-30,9822
00939,統一台灣高息動能,50,6,44,元大-土城學府,2024-09-30,9822
00878,國泰永續高股息,47,5,42,元大-土城學府,2024-09-30,9822
2356,英業達,47,6,41,元大-土城學府,2024-09-30,9822
00753L,中信中國50正2,46,7,39,元大-土城學府,2024-09-30,9822
2615,萬海,50,16,34,元大-土城學府,2024-09-30,9822
00706L,期元大S＆P日圓正2,33,6,27,元大-土城學府,2024-09-30,9822
00687B,國泰20年美債,56,30,26,元大-土城學府,2024-09-30,9822
8473,山林水,20,0,20,元大-土城學府,2024-09-30,9822
2308,台達電,20,0,20,元大-土城學府,2024-09-30,9822
00945B,凱基美國非投等債,23,4,19,元大-土城學府,2024-09-30,9822
5014,建錩,29,10,19,元大-土城學府,2024-09-30,9822
0056,元大高股息,33,15,18,元大-土城學府,2024-09-30,9822
4906,正文,16,0,16,元大-土城學府,2024-09-30,9822
2330,台積電,18,2,16,元大-土城學府,2024-09-30,9822
00669R,國泰美國道瓊反1,15,0,15,元大-土城學府,2024-09-30,9822
3363,上詮,20,5,15,元大-土城學府,2024-09-30,9822
2891,中信金,15,1,14,元大-土城學府,2024-09-30,9822
2344,華邦電,17,3,14,元大-土城學府,2024-09-30,9822
2605,新興,21,8,13,元大-土城學府,2024-09-30,9822
1785,光洋科,12,0,12,元大-土城學府,2024-09-30,9822
3231,緯創,12,0,12,元大-土城學府,2024-09-30,9822
2337,旺宏,14,2,12,元大-土城學府,2024-09-30,9822
3607,谷崧,12,0,12,元大-土城學府,2024-09-30,9822
2317,鴻海,21,10,11,元大-土城學府,2024-09-30,9822
00915,凱基優選高股息30,10,0,10,元大-土城學府,2024-09-30,9822
00905,FT臺灣Smart,10,0,10,元大-土城學府,2024-09-30,9822
2607,榮運,10,0,10,元大-土城學府,2024-09-30,9822
3049,精金,12,2,10,元大-土城學府,2024-09-30,9822
4934,太極,10,0,10,元大-土城學府,2024-09-30,9822
3149,正達,10,0,10,元大-土城學府,2024-09-30,9822
2382,廣達,18,9,9,元大-土城學府,2024-09-30,9822
00891,中信關鍵半導體,9,0,9,元大-土城學府,2024-09-30,9822
00725B,國泰投資級公司債,9,0,9,元大-土城學府,2024-09-30,9822
00948B,中信優息投資級債,9,0,9,元大-土城學府,2024-09-30,9822
6770,力積電,9,0,9,元大-土城學府,2024-09-30,9822
2449,京元電子,11,3,8,元大-土城學府,2024-09-30,9822
3715,定穎投控,26,18,8,元大-土城學府,2024-09-30,9822
4909,新復興,17,9,8,元大-土城學府,2024-09-30,9822
00680L,元大美債20正2,8,0,8,元大-土城學府,2024-09-30,9822
1909,榮成,9,1,8,元大-土城學府,2024-09-30,9822
3625,西勝,8,0,8,元大-土城學府,2024-09-30,9822
2353,宏��,10,3,7,元大-土城學府,2024-09-30,9822
00939,統一台灣高息動能,366,1,365,元大-土城學府,2024-10-01,9822
00676R,富邦臺灣加權反1,100,0,100,元大-土城學府,2024-10-01,9822
00929,復華台灣科技優息,84,0,84,元大-土城學府,2024-10-01,9822
00687B,國泰20年美債,62,9,53,元大-土城學府,2024-10-01,9822
00919,群益台灣精選高息,46,1,45,元大-土城學府,2024-10-01,9822
00665L,富邦�琤肭磪囓�2,30,0,30,元大-土城學府,2024-10-01,9822
6546,正基,56,26,30,元大-土城學府,2024-10-01,9822
0056,元大高股息,35,10,25,元大-土城學府,2024-10-01,9822
9105,泰金寶-DR,22,0,22,元大-土城學府,2024-10-01,9822
006208,富邦台50,23,1,22,元大-土城學府,2024-10-01,9822
1313,聯成,20,0,20,元大-土城學府,2024-10-01,9822
00713,元大台灣高息低波,20,0,20,元大-土城學府,2024-10-01,9822
2317,鴻海,41,23,18,元大-土城學府,2024-10-01,9822
00940,元大台灣價值高息,18,0,18,元大-土城學府,2024-10-01,9822
6219,富旺,16,0,16,元大-土城學府,2024-10-01,9822
2316,楠梓電,16,2,14,元大-土城學府,2024-10-01,9822
3013,晟銘電,13,0,13,元大-土城學府,2024-10-01,9822
00878,國泰永續高股息,13,0,13,元大-土城學府,2024-10-01,9822
6248,沛波,12,0,12,元大-土城學府,2024-10-01,9822
00680L,元大美債20正2,11,0,11,元大-土城學府,2024-10-01,9822
6838,台新藥,11,0,11,元大-土城學府,2024-10-01,9822
00930,永豐ESG低碳高息,11,0,11,元大-土城學府,2024-10-01,9822
2344,華邦電,11,0,11,元大-土城學府,2024-10-01,9822
00671R,富邦NASDAQ反1,10,0,10,元大-土城學府,2024-10-01,9822
00948B,中信優息投資級債,10,0,10,元大-土城學府,2024-10-01,9822
6116,彩晶,10,0,10,元大-土城學府,2024-10-01,9822
6462,神盾,10,0,10,元大-土城學府,2024-10-01,9822
3081,聯亞,17,7,10,元大-土城學府,2024-10-01,9822
6609,瀧澤科,15,6,9,元大-土城學府,2024-10-01,9822
1616,億泰,9,0,9,元大-土城學府,2024-10-01,9822
00958B,永豐ESG銀行債15,8,0,8,元大-土城學府,2024-10-01,9822
00706L,期元大S＆P日圓正2,8,0,8,元大-土城學府,2024-10-01,9822
00753L,中信中國50正2,15,7,8,元大-土城學府,2024-10-01,9822
00946,群益科技高息成長,7,0,7,元大-土城學府,2024-10-01,9822
3481,群創,7,0,7,元大-土城學府,2024-10-01,9822
5269,祥碩,7,0,7,元大-土城學府,2024-10-01,9822
00907,永豐優息存股,6,0,6,元大-土城學府,2024-10-01,9822
00772B,中信高評級公司債,6,0,6,元大-土城學府,2024-10-01,9822
4906,正文,6,0,6,元大-土城學府,2024-10-01,9822
4923,力士,6,0,6,元大-土城學府,2024-10-01,9822
8429,金麗-KY,25,19,6,元大-土城學府,2024-10-01,9822
8927,北基,6,0,6,元大-土城學府,2024-10-01,9822
911622,泰聚亨-DR,6,0,6,元大-土城學府,2024-10-01,9822
6129,普誠,5,0,5,元大-土城學府,2024-10-01,9822
1308,亞聚,5,0,5,元大-土城學府,2024-10-01,9822
2208,台船,5,0,5,元大-土城學府,2024-10-01,9822
2243,宏旭-KY,7,2,5,元大-土城學府,2024-10-01,9822
2442,新美齊,7,2,5,元大-土城學府,2024-10-01,9822
3588,通嘉,5,0,5,元大-土城學府,2024-10-01,9822
3686,達能,5,0,5,元大-土城學府,2024-10-01,9822
00919,群益台灣精選高息,203,30,173,元大-土城學府,2024-10-04,9822
00929,復華台灣科技優息,125,6,119,元大-土城學府,2024-10-04,9822
00946,群益科技高息成長,115,0,115,元大-土城學府,2024-10-04,9822
00940,元大台灣價值高息,137,49,88,元大-土城學府,2024-10-04,9822
2929,淘帝-KY,80,1,79,元大-土城學府,2024-10-04,9822
00650L,復華香港正2,100,42,58,元大-土城學府,2024-10-04,9822
6530,創威,55,5,50,元大-土城學府,2024-10-04,9822
2609,陽明,69,24,45,元大-土城學府,2024-10-04,9822
2618,長榮航,46,4,42,元大-土城學府,2024-10-04,9822
6219,富旺,39,0,39,元大-土城學府,2024-10-04,9822
00882,中信中國高股息,441,403,38,元大-土城學府,2024-10-04,9822
2353,宏��,34,0,34,元大-土城學府,2024-10-04,9822
00937B,群益ESG投等債20,34,0,34,元大-土城學府,2024-10-04,9822
00688L,國泰20年美債正2,32,0,32,元大-土城學府,2024-10-04,9822
2356,英業達,33,1,32,元大-土城學府,2024-10-04,9822
0056,元大高股息,38,6,32,元大-土城學府,2024-10-04,9822
00878,國泰永續高股息,35,7,28,元大-土城學府,2024-10-04,9822
00712,復華富時不動產,28,0,28,元大-土城學府,2024-10-04,9822
00679B,元大美債20年,35,7,28,元大-土城學府,2024-10-04,9822
2615,萬海,44,20,24,元大-土城學府,2024-10-04,9822
2303,聯電,24,0,24,元大-土城學府,2024-10-04,9822
00948B,中信優息投資級債,23,0,23,元大-土城學府,2024-10-04,9822
2606,裕民,33,11,22,元大-土城學府,2024-10-04,9822
00632R,元大台灣50反1,22,0,22,元大-土城學府,2024-10-04,9822
3380,明泰,21,0,21,元大-土城學府,2024-10-04,9822
00700,富邦�琤肭磪�,20,0,20,元大-土城學府,2024-10-04,9822
00941,中信上游半導體,20,0,20,元大-土城學府,2024-10-04,9822
00960,野村全球航運龍頭,22,3,19,元大-土城學府,2024-10-04,9822
00931B,統一美債20年,20,1,19,元大-土城學府,2024-10-04,9822
00922,國泰台灣領袖50,19,0,19,元大-土城學府,2024-10-04,9822
2477,美隆電,20,1,19,元大-土城學府,2024-10-04,9822
2316,楠梓電,29,11,18,元大-土城學府,2024-10-04,9822
2449,京元電子,17,0,17,元大-土城學府,2024-10-04,9822
2610,華航,31,16,15,元大-土城學府,2024-10-04,9822
00918,大華優利高填息30,17,3,14,元大-土城學府,2024-10-04,9822
00637L,元大滬深300正2,75,62,13,元大-土城學府,2024-10-04,9822
5014,建錩,21,8,13,元大-土城學府,2024-10-04,9822
2603,長榮,14,2,12,元大-土城學府,2024-10-04,9822
3363,上詮,22,10,12,元大-土城學府,2024-10-04,9822
00687B,國泰20年美債,31,19,12,元大-土城學府,2024-10-04,9822
00915,凱基優選高股息30,12,0,12,元大-土城學府,2024-10-04,9822
2442,新美齊,11,0,11,元大-土城學府,2024-10-04,9822
2308,台達電,13,2,11,元大-土城學府,2024-10-04,9822
3231,緯創,17,6,11,元大-土城學府,2024-10-04,9822
00706L,期元大S＆P日圓正2,10,0,10,元大-土城學府,2024-10-04,9822
00635U,期元大S＆P黃金,10,0,10,元大-土城學府,2024-10-04,9822
00939,統一台灣高息動能,10,0,10,元大-土城學府,2024-10-04,9822
3030,德律,11,1,10,元大-土城學府,2024-10-04,9822
6218,豪勉,10,0,10,元大-土城學府,2024-10-04,9822
2884,玉山金,9,0,9,元大-土城學府,2024-10-04,9822
00632R,元大台灣50反1,541,14,527,元大-土城學府,2024-10-07,9822
2888,新光金,202,92,110,元大-土城學府,2024-10-07,9822
00940,元大台灣價值高息,112,23,89,元大-土城學府,2024-10-07,9822
00637L,元大滬深300正2,107,38,69,元大-土城學府,2024-10-07,9822
00919,群益台灣精選高息,66,3,63,元大-土城學府,2024-10-07,9822
00680L,元大美債20正2,81,22,59,元大-土城學府,2024-10-07,9822
6530,創威,54,0,54,元大-土城學府,2024-10-07,9822
8111,立��,73,19,54,元大-土城學府,2024-10-07,9822
00937B,群益ESG投等債20,63,16,47,元大-土城學府,2024-10-07,9822
0056,元大高股息,35,3,32,元大-土城學府,2024-10-07,9822
00708L,期元大S＆P黃金正2,30,0,30,元大-土城學府,2024-10-07,9822
00952,凱基台灣AI50,30,0,30,元大-土城學府,2024-10-07,9822
3025,星通,71,43,28,元大-土城學府,2024-10-07,9822
2609,陽明,37,11,26,元大-土城學府,2024-10-07,9822
00706L,期元大S＆P日圓正2,25,0,25,元大-土城學府,2024-10-07,9822
2303,聯電,23,2,21,元大-土城學府,2024-10-07,9822
00638R,元大滬深300反1,20,0,20,元大-土城學府,2024-10-07,9822
00935,野村臺灣新科技50,20,0,20,元大-土城學府,2024-10-07,9822
2425,承啟,25,5,20,元大-土城學府,2024-10-07,9822
2356,英業達,31,12,19,元大-土城學府,2024-10-07,9822
2426,鼎元,20,1,19,元大-土城學府,2024-10-07,9822
2610,華航,20,2,18,元大-土城學府,2024-10-07,9822
00687B,國泰20年美債,23,5,18,元大-土城學府,2024-10-07,9822
00878,國泰永續高股息,21,3,18,元大-土城學府,2024-10-07,9822
1314,中石化,19,3,16,元大-土城學府,2024-10-07,9822
00958B,永豐ESG銀行債15,16,0,16,元大-土城學府,2024-10-07,9822
2313,華通,29,14,15,元大-土城學府,2024-10-07,9822
2515,中工,18,3,15,元大-土城學府,2024-10-07,9822
00643,群益深証中小,13,0,13,元大-土城學府,2024-10-07,9822
3363,上詮,18,5,13,元大-土城學府,2024-10-07,9822
2317,鴻海,53,41,12,元大-土城學府,2024-10-07,9822
2344,華邦電,11,0,11,元大-土城學府,2024-10-07,9822
00857B,永豐20年美公債,11,0,11,元大-土城學府,2024-10-07,9822
4532,瑞智,11,0,11,元大-土城學府,2024-10-07,9822
00948B,中信優息投資級債,10,0,10,元大-土城學府,2024-10-07,9822
5347,世界,9,0,9,元大-土城學府,2024-10-07,9822
1805,寶徠,9,0,9,元大-土城學府,2024-10-07,9822
00887,永豐中國科技50大,56,48,8,元大-土城學府,2024-10-07,9822
2230,泰茂,8,0,8,元大-土城學府,2024-10-07,9822
3042,晶技,8,0,8,元大-土城學府,2024-10-07,9822
00646,元大S＆P500,8,0,8,元大-土城學府,2024-10-07,9822
3591,艾笛森,7,0,7,元大-土城學府,2024-10-07,9822
4523,永彰,10,3,7,元大-土城學府,2024-10-07,9822
4903,聯光通,12,5,7,元大-土城學府,2024-10-07,9822
1737,臺鹽,6,0,6,元大-土城學府,2024-10-07,9822
2489,瑞軒,6,0,6,元大-土城學府,2024-10-07,9822
3023,信邦,6,0,6,元大-土城學府,2024-10-07,9822
3430,奇鈦科,6,0,6,元大-土城學府,2024-10-07,9822
6274,台燿,8,2,6,元大-土城學府,2024-10-07,9822
00712,復華富時不動產,6,0,6,元大-土城學府,2024-10-07,9822
00934,中信成長高股息,163,5,158,元大-土城學府,2024-10-08,9822
00887,永豐中國科技50大,157,50,107,元大-土城學府,2024-10-08,9822
5014,建錩,101,22,79,元大-土城學府,2024-10-08,9822
00919,群益台灣精選高息,85,13,72,元大-土城學府,2024-10-08,9822
00929,復華台灣科技優息,101,37,64,元大-土城學府,2024-10-08,9822
00753L,中信中國50正2,71,20,51,元大-土城學府,2024-10-08,9822
00687B,國泰20年美債,49,1,48,元大-土城學府,2024-10-08,9822
8011,台通,47,1,46,元大-土城學府,2024-10-08,9822
0056,元大高股息,46,1,45,元大-土城學府,2024-10-08,9822
00637L,元大滬深300正2,236,192,44,元大-土城學府,2024-10-08,9822
4906,正文,33,0,33,元大-土城學府,2024-10-08,9822
00937B,群益ESG投等債20,32,3,29,元大-土城學府,2024-10-08,9822
00878,國泰永續高股息,31,2,29,元大-土城學府,2024-10-08,9822
3363,上詮,44,15,29,元大-土城學府,2024-10-08,9822
00638R,元大滬深300反1,32,4,28,元大-土城學府,2024-10-08,9822
00708L,期元大S＆P黃金正2,24,0,24,元大-土城學府,2024-10-08,9822
2883,凱基金,24,0,24,元大-土城學府,2024-10-08,9822
6530,創威,139,115,24,元大-土城學府,2024-10-08,9822
2399,映泰,78,55,23,元大-土城學府,2024-10-08,9822
3037,欣興,23,1,22,元大-土城學府,2024-10-08,9822
00680L,元大美債20正2,40,20,20,元大-土城學府,2024-10-08,9822
9935,慶豐富,20,0,20,元大-土城學府,2024-10-08,9822
2362,藍天,56,38,18,元大-土城學府,2024-10-08,9822
00915,凱基優選高股息30,18,0,18,元大-土城學府,2024-10-08,9822
2498,宏達電,18,2,16,元大-土城學府,2024-10-08,9822
3481,群創,21,5,16,元大-土城學府,2024-10-08,9822
2313,華通,14,0,14,元大-土城學府,2024-10-08,9822
00946,群益科技高息成長,16,2,14,元大-土城學府,2024-10-08,9822
8096,擎亞,14,0,14,元大-土城學府,2024-10-08,9822
4977,眾達-KY,20,7,13,元大-土城學府,2024-10-08,9822
2845,遠東銀,11,0,11,元大-土城學府,2024-10-08,9822
00918,大華優利高填息30,11,0,11,元大-土城學府,2024-10-08,9822
2303,聯電,14,3,11,元大-土城學府,2024-10-08,9822
2609,陽明,12,1,11,元大-土城學府,2024-10-08,9822
6505,台塑化,10,0,10,元大-土城學府,2024-10-08,9822
00952,凱基台灣AI50,10,0,10,元大-土城學府,2024-10-08,9822
3710,連展投控,10,0,10,元大-土城學府,2024-10-08,9822
006208,富邦台50,11,1,10,元大-土城學府,2024-10-08,9822
00665L,富邦�琤肭磪囓�2,10,1,9,元大-土城學府,2024-10-08,9822
00922,國泰台灣領袖50,9,0,9,元大-土城學府,2024-10-08,9822
2425,承啟,16,7,9,元大-土城學府,2024-10-08,9822
3550,聯穎,11,2,9,元大-土城學府,2024-10-08,9822
6456,GIS-KY,9,0,9,元大-土城學府,2024-10-08,9822
3062,建漢,8,0,8,元大-土城學府,2024-10-08,9822
6405,悅城,12,4,8,元大-土城學府,2024-10-08,9822
8112,至上,8,0,8,元大-土城學府,2024-10-08,9822
00933B,國泰10Y+金融債,8,0,8,元大-土城學府,2024-10-08,9822
2408,南亞科,8,0,8,元大-土城學府,2024-10-08,9822
00720B,元大投資級公司債,7,0,7,元大-土城學府,2024-10-08,9822
2108,南帝,7,0,7,元大-土城學府,2024-10-08,9822
3481,群創,67,2,65,元大-土城學府,2024-10-09,9822
2891,中信金,62,3,59,元大-土城學府,2024-10-09,9822
00650L,復華香港正2,55,0,55,元大-土城學府,2024-10-09,9822
00665L,富邦�琤肭磪囓�2,55,8,47,元大-土城學府,2024-10-09,9822
00687B,國泰20年美債,47,1,46,元大-土城學府,2024-10-09,9822
00919,群益台灣精選高息,60,17,43,元大-土城學府,2024-10-09,9822
4720,德淵,43,1,42,元大-土城學府,2024-10-09,9822
00637L,元大滬深300正2,184,146,38,元大-土城學府,2024-10-09,9822
00753L,中信中國50正2,32,3,29,元大-土城學府,2024-10-09,9822
2303,聯電,30,1,29,元大-土城學府,2024-10-09,9822
6219,富旺,28,0,28,元大-土城學府,2024-10-09,9822
00680L,元大美債20正2,25,1,24,元大-土城學府,2024-10-09,9822
2363,矽統,69,47,22,元大-土城學府,2024-10-09,9822
1455,集盛,20,0,20,元大-土城學府,2024-10-09,9822
00712,復華富時不動產,19,0,19,元大-土城學府,2024-10-09,9822
3715,定穎投控,22,3,19,元大-土城學府,2024-10-09,9822
3363,上詮,35,16,19,元大-土城學府,2024-10-09,9822
2477,美隆電,20,3,17,元大-土城學府,2024-10-09,9822
3576,聯合再生,18,2,16,元大-土城學府,2024-10-09,9822
00907,永豐優息存股,15,0,15,元大-土城學府,2024-10-09,9822
1605,華新,15,0,15,元大-土城學府,2024-10-09,9822
5009,榮剛,15,0,15,元大-土城學府,2024-10-09,9822
00937B,群益ESG投等債20,15,0,15,元大-土城學府,2024-10-09,9822
00679B,元大美債20年,22,8,14,元大-土城學府,2024-10-09,9822
2609,陽明,20,6,14,元大-土城學府,2024-10-09,9822
1802,台玻,14,0,14,元大-土城學府,2024-10-09,9822
4977,眾達-KY,18,4,14,元大-土城學府,2024-10-09,9822
6442,光聖,25,11,14,元大-土城學府,2024-10-09,9822
1314,中石化,21,8,13,元大-土城學府,2024-10-09,9822
2399,映泰,69,56,13,元大-土城學府,2024-10-09,9822
3450,聯鈞,73,61,12,元大-土城學府,2024-10-09,9822
2402,毅嘉,32,21,11,元大-土城學府,2024-10-09,9822
2455,全新,11,0,11,元大-土城學府,2024-10-09,9822
6108,競國,11,0,11,元大-土城學府,2024-10-09,9822
1101,台泥,17,6,11,元大-土城學府,2024-10-09,9822
00932,兆豐永續高息等權,10,0,10,元大-土城學府,2024-10-09,9822
2489,瑞軒,12,2,10,元大-土城學府,2024-10-09,9822
2313,華通,9,0,9,元大-土城學府,2024-10-09,9822
2349,錸德,10,1,9,元大-土城學府,2024-10-09,9822
6223,旺矽,15,6,9,元大-土城學府,2024-10-09,9822
2615,萬海,15,7,8,元大-土城學府,2024-10-09,9822
2362,藍天,9,1,8,元大-土城學府,2024-10-09,9822
3437,榮創,8,0,8,元大-土城學府,2024-10-09,9822
3518,柏騰,8,0,8,元大-土城學府,2024-10-09,9822
6609,瀧澤科,10,2,8,元大-土城學府,2024-10-09,9822
6830,汎銓,13,5,8,元大-土城學府,2024-10-09,9822
2888,新光金,13,5,8,元大-土城學府,2024-10-09,9822
00751B,元大AAA至A公司債,7,0,7,元大-土城學府,2024-10-09,9822
1711,永光,10,3,7,元大-土城學府,2024-10-09,9822
2014,中鴻,7,0,7,元大-土城學府,2024-10-09,9822
00929,復華台灣科技優息,250,43,207,元大-土城學府,2024-10-11,9822
00637L,元大滬深300正2,118,28,90,元大-土城學府,2024-10-11,9822
00882,中信中國高股息,53,5,48,元大-土城學府,2024-10-11,9822
00680L,元大美債20正2,38,0,38,元大-土城學府,2024-10-11,9822
00688L,國泰20年美債正2,30,0,30,元大-土城學府,2024-10-11,9822
0056,元大高股息,31,3,28,元大-土城學府,2024-10-11,9822
00646,元大S＆P500,27,0,27,元大-土城學府,2024-10-11,9822
3149,正達,43,18,25,元大-土城學府,2024-10-11,9822
2834,臺企銀,25,0,25,元大-土城學府,2024-10-11,9822
6530,創威,90,67,23,元大-土城學府,2024-10-11,9822
2605,新興,22,0,22,元大-土城學府,2024-10-11,9822
4903,聯光通,163,142,21,元大-土城學府,2024-10-11,9822
00713,元大台灣高息低波,21,0,21,元大-土城學府,2024-10-11,9822
00881,國泰台灣5G+,20,0,20,元大-土城學府,2024-10-11,9822
00952,凱基台灣AI50,20,0,20,元大-土城學府,2024-10-11,9822
00915,凱基優選高股息30,21,2,19,元大-土城學府,2024-10-11,9822
00725B,國泰投資級公司債,19,0,19,元大-土城學府,2024-10-11,9822
2349,錸德,22,3,19,元大-土城學府,2024-10-11,9822
00633L,富邦上証正2,16,0,16,元大-土城學府,2024-10-11,9822
3062,建漢,15,1,14,元大-土城學府,2024-10-11,9822
8011,台通,14,1,13,元大-土城學府,2024-10-11,9822
6219,富旺,12,0,12,元大-土城學府,2024-10-11,9822
3526,凡甲,11,0,11,元大-土城學府,2024-10-11,9822
00753L,中信中國50正2,21,10,11,元大-土城學府,2024-10-11,9822
00922,國泰台灣領袖50,16,5,11,元大-土城學府,2024-10-11,9822
3363,上詮,18,8,10,元大-土城學府,2024-10-11,9822
3707,漢磊,10,0,10,元大-土城學府,2024-10-11,9822
1102,亞泥,10,0,10,元大-土城學府,2024-10-11,9822
2601,益航,10,0,10,元大-土城學府,2024-10-11,9822
4979,華星光,12,2,10,元大-土城學府,2024-10-11,9822
6278,台表科,10,0,10,元大-土城學府,2024-10-11,9822
6546,正基,20,10,10,元大-土城學府,2024-10-11,9822
4909,新復興,16,6,10,元大-土城學府,2024-10-11,9822
2615,萬海,12,3,9,元大-土城學府,2024-10-11,9822
00643,群益深証中小,9,0,9,元大-土城學府,2024-10-11,9822
00934,中信成長高股息,9,0,9,元大-土城學府,2024-10-11,9822
00946,群益科技高息成長,14,5,9,元大-土城學府,2024-10-11,9822
2399,映泰,35,26,9,元大-土城學府,2024-10-11,9822
3013,晟銘電,39,30,9,元大-土城學府,2024-10-11,9822
6174,安��,8,0,8,元大-土城學府,2024-10-11,9822
00918,大華優利高填息30,7,0,7,元大-土城學府,2024-10-11,9822
2354,鴻準,8,1,7,元大-土城學府,2024-10-11,9822
3033,威健,8,1,7,元大-土城學府,2024-10-11,9822
1307,三芳,10,3,7,元大-土城學府,2024-10-11,9822
2344,華邦電,9,2,7,元大-土城學府,2024-10-11,9822
6706,惠特,7,0,7,元大-土城學府,2024-10-11,9822
2388,威盛,11,5,6,元大-土城學府,2024-10-11,9822
3550,聯穎,11,5,6,元大-土城學府,2024-10-11,9822
6770,力積電,6,0,6,元大-土城學府,2024-10-11,9822
00751B,元大AAA至A公司債,6,0,6,元大-土城學府,2024-10-11,9822
9105,泰金寶-DR,233,18,215,元大-土城學府,2024-10-14,9822
00882,中信中國高股息,228,24,204,元大-土城學府,2024-10-14,9822
00937B,群益ESG投等債20,150,11,139,元大-土城學府,2024-10-14,9822
00671R,富邦NASDAQ反1,100,0,100,元大-土城學府,2024-10-14,9822
00887,永豐中國科技50大,65,0,65,元大-土城學府,2024-10-14,9822
0056,元大高股息,65,9,56,元大-土城學府,2024-10-14,9822
00687B,國泰20年美債,57,7,50,元大-土城學府,2024-10-14,9822
00719B,元大美債1-3,43,0,43,元大-土城學府,2024-10-14,9822
00919,群益台灣精選高息,37,8,29,元大-土城學府,2024-10-14,9822
2615,萬海,28,2,26,元大-土城學府,2024-10-14,9822
4991,環宇-KY,31,5,26,元大-土城學府,2024-10-14,9822
00725B,國泰投資級公司債,25,0,25,元大-土城學府,2024-10-14,9822
6142,友勁,24,1,23,元大-土城學府,2024-10-14,9822
2845,遠東銀,23,0,23,元大-土城學府,2024-10-14,9822
00952,凱基台灣AI50,20,0,20,元大-土城學府,2024-10-14,9822
2399,映泰,58,39,19,元大-土城學府,2024-10-14,9822
3481,群創,21,2,19,元大-土城學府,2024-10-14,9822
2312,金寶,59,41,18,元大-土城學府,2024-10-14,9822
00948B,中信優息投資級債,19,3,16,元大-土城學府,2024-10-14,9822
00957B,兆豐US優選投等債,16,0,16,元大-土城學府,2024-10-14,9822
00720B,元大投資級公司債,14,0,14,元大-土城學府,2024-10-14,9822
00891,中信關鍵半導體,14,0,14,元大-土城學府,2024-10-14,9822
00922,國泰台灣領袖50,18,5,13,元大-土城學府,2024-10-14,9822
00632R,元大台灣50反1,12,0,12,元大-土城學府,2024-10-14,9822
2883,凱基金,12,0,12,元大-土城學府,2024-10-14,9822
3450,聯鈞,27,15,12,元大-土城學府,2024-10-14,9822
00905,FT臺灣Smart,11,0,11,元大-土城學府,2024-10-14,9822
1314,中石化,13,2,11,元大-土城學府,2024-10-14,9822
3231,緯創,15,4,11,元大-土城學府,2024-10-14,9822
5443,均豪,14,3,11,元大-土城學府,2024-10-14,9822
9933,中鼎,10,0,10,元大-土城學府,2024-10-14,9822
00751B,元大AAA至A公司債,10,0,10,元大-土城學府,2024-10-14,9822
1108,幸福,10,0,10,元大-土城學府,2024-10-14,9822
1326,台化,11,1,10,元大-土城學府,2024-10-14,9822
1597,直得,10,0,10,元大-土城學府,2024-10-14,9822
1718,中纖,10,0,10,元大-土城學府,2024-10-14,9822
2316,楠梓電,20,10,10,元大-土城學府,2024-10-14,9822
2543,皇昌,18,8,10,元大-土城學府,2024-10-14,9822
3484,崧騰,10,0,10,元大-土城學府,2024-10-14,9822
2330,台積電,18,8,10,元大-土城學府,2024-10-14,9822
2486,一詮,11,2,9,元大-土城學府,2024-10-14,9822
00664R,國泰臺灣加權反1,9,0,9,元大-土城學府,2024-10-14,9822
00933B,國泰10Y+金融債,17,8,9,元大-土城學府,2024-10-14,9822
1455,集盛,10,1,9,元大-土城學府,2024-10-14,9822
2365,昆盈,14,5,9,元大-土城學府,2024-10-14,9822
3548,兆利,22,13,9,元大-土城學府,2024-10-14,9822
3715,定穎投控,18,10,8,元大-土城學府,2024-10-14,9822
00753L,中信中國50正2,29,22,7,元大-土城學府,2024-10-14,9822
3703,欣陸,7,0,7,元大-土城學府,2024-10-14,9822
2344,華邦電,8,1,7,元大-土城學府,2024-10-14,9822
00632R,元大台灣50反1,574,10,564,元大-土城學府,2024-10-15,9822
00934,中信成長高股息,503,6,497,元大-土城學府,2024-10-15,9822
00637L,元大滬深300正2,80,10,70,元大-土城學府,2024-10-15,9822
00688L,國泰20年美債正2,38,0,38,元大-土城學府,2024-10-15,9822
00679B,元大美債20年,36,5,31,元大-土城學府,2024-10-15,9822
3149,正達,67,40,27,元大-土城學府,2024-10-15,9822
0056,元大高股息,48,22,26,元大-土城學府,2024-10-15,9822
1618,合機,25,0,25,元大-土城學府,2024-10-15,9822
00887,永豐中國科技50大,30,7,23,元大-土城學府,2024-10-15,9822
2603,長榮,22,0,22,元大-土城學府,2024-10-15,9822
2363,矽統,49,31,18,元大-土城學府,2024-10-15,9822
6546,正基,18,0,18,元大-土城學府,2024-10-15,9822
2368,金像電,18,0,18,元大-土城學府,2024-10-15,9822
2399,映泰,40,24,16,元大-土城學府,2024-10-15,9822
1905,華紙,16,0,16,元大-土城學府,2024-10-15,9822
3013,晟銘電,26,11,15,元大-土城學府,2024-10-15,9822
00961,FT臺灣永續高息,15,0,15,元大-土城學府,2024-10-15,9822
00720B,元大投資級公司債,15,0,15,元大-土城學府,2024-10-15,9822
4903,聯光通,32,17,15,元大-土城學府,2024-10-15,9822
00687B,國泰20年美債,20,6,14,元大-土城學府,2024-10-15,9822
4979,華星光,25,11,14,元大-土城學府,2024-10-15,9822
00922,國泰台灣領袖50,14,1,13,元大-土城學府,2024-10-15,9822
4720,德淵,13,0,13,元大-土城學府,2024-10-15,9822
4956,光鋐,27,14,13,元大-土城學府,2024-10-15,9822
00927,群益半導體收益,15,3,12,元大-土城學府,2024-10-15,9822
2349,錸德,13,1,12,元大-土城學府,2024-10-15,9822
1514,亞力,14,3,11,元大-土城學府,2024-10-15,9822
2038,海光,12,1,11,元大-土城學府,2024-10-15,9822
2362,藍天,11,0,11,元大-土城學府,2024-10-15,9822
3450,聯鈞,20,10,10,元大-土城學府,2024-10-15,9822
3231,緯創,31,21,10,元大-土城學府,2024-10-15,9822
00665L,富邦�琤肭磪囓�2,10,0,10,元大-土城學府,2024-10-15,9822
1326,台化,10,0,10,元大-土城學府,2024-10-15,9822
3294,英濟,10,0,10,元大-土城學府,2024-10-15,9822
3518,柏騰,10,0,10,元大-土城學府,2024-10-15,9822
2881,富邦金,12,2,10,元大-土城學府,2024-10-15,9822
5443,均豪,15,6,9,元大-土城學府,2024-10-15,9822
00912,中信臺灣智慧50,9,0,9,元大-土城學府,2024-10-15,9822
2520,冠德,9,0,9,元大-土城學府,2024-10-15,9822
2905,三商,9,0,9,元大-土城學府,2024-10-15,9822
3715,定穎投控,19,10,9,元大-土城學府,2024-10-15,9822
6269,台郡,9,0,9,元大-土城學府,2024-10-15,9822
00919,群益台灣精選高息,29,21,8,元大-土城學府,2024-10-15,9822
2371,大同,8,0,8,元大-土城學府,2024-10-15,9822
2002,中鋼,8,0,8,元大-土城學府,2024-10-15,9822
00706L,期元大S＆P日圓正2,7,0,7,元大-土城學府,2024-10-15,9822
2489,瑞軒,8,1,7,元大-土城學府,2024-10-15,9822
00753L,中信中國50正2,7,0,7,元大-土城學府,2024-10-15,9822
3363,上詮,7,0,7,元大-土城學府,2024-10-15,9822
8089,康全電訊,6,0,6,元大-土城學府,2024-10-15,9822
00922,國泰台灣領袖50,124,4,120,元大-土城學府,2024-10-16,9822
2881,富邦金,101,0,101,元大-土城學府,2024-10-16,9822
0056,元大高股息,104,19,85,元大-土城學府,2024-10-16,9822
00712,復華富時不動產,55,0,55,元大-土城學府,2024-10-16,9822
1313,聯成,45,0,45,元大-土城學府,2024-10-16,9822
00919,群益台灣精選高息,43,0,43,元大-土城學府,2024-10-16,9822
00952,凱基台灣AI50,30,0,30,元大-土城學府,2024-10-16,9822
2888,新光金,34,6,28,元大-土城學府,2024-10-16,9822
1101,台泥,26,0,26,元大-土城學府,2024-10-16,9822
00680L,元大美債20正2,19,0,19,元大-土城學府,2024-10-16,9822
00753L,中信中國50正2,27,10,17,元大-土城學府,2024-10-16,9822
6426,統新,15,0,15,元大-土城學府,2024-10-16,9822
3576,聯合再生,16,2,14,元大-土城學府,2024-10-16,9822
2601,益航,14,0,14,元大-土城學府,2024-10-16,9822
00878,國泰永續高股息,16,2,14,元大-土城學府,2024-10-16,9822
2344,華邦電,14,1,13,元大-土城學府,2024-10-16,9822
3037,欣興,16,3,13,元大-土城學府,2024-10-16,9822
2363,矽統,21,8,13,元大-土城學府,2024-10-16,9822
00960,野村全球航運龍頭,12,0,12,元大-土城學府,2024-10-16,9822
0061,元大寶滬深,12,0,12,元大-土城學府,2024-10-16,9822
2206,三陽工業,12,0,12,元大-土城學府,2024-10-16,9822
2303,聯電,13,1,12,元大-土城學府,2024-10-16,9822
00637L,元大滬深300正2,30,19,11,元大-土城學府,2024-10-16,9822
3149,正達,42,31,11,元大-土城學府,2024-10-16,9822
00739,元大MSCI A股,10,0,10,元大-土城學府,2024-10-16,9822
00957B,兆豐US優選投等債,10,0,10,元大-土城學府,2024-10-16,9822
2539,櫻花建,10,0,10,元大-土城學府,2024-10-16,9822
3339,泰谷,10,0,10,元大-土城學府,2024-10-16,9822
3455,由田,10,0,10,元大-土城學府,2024-10-16,9822
3498,陽程,18,8,10,元大-土城學府,2024-10-16,9822
8429,金麗-KY,10,0,10,元大-土城學府,2024-10-16,9822
00679B,元大美債20年,17,7,10,元大-土城學府,2024-10-16,9822
2330,台積電,14,5,9,元大-土城學府,2024-10-16,9822
2883,凱基金,15,6,9,元大-土城學府,2024-10-16,9822
6517,保勝光學,10,1,9,元大-土城學府,2024-10-16,9822
9105,泰金寶-DR,22,13,9,元大-土城學府,2024-10-16,9822
00887,永豐中國科技50大,52,44,8,元大-土城學府,2024-10-16,9822
2069,運錩,8,0,8,元大-土城學府,2024-10-16,9822
6770,力積電,13,6,7,元大-土城學府,2024-10-16,9822
1513,中興電,8,1,7,元大-土城學府,2024-10-16,9822
2408,南亞科,7,0,7,元大-土城學府,2024-10-16,9822
3710,連展投控,15,8,7,元大-土城學府,2024-10-16,9822
6442,光聖,8,1,7,元大-土城學府,2024-10-16,9822
3017,奇鋐,10,3,7,元大-土城學府,2024-10-16,9822
2489,瑞軒,29,23,6,元大-土城學府,2024-10-16,9822
00665L,富邦�琤肭磪囓�2,10,4,6,元大-土城學府,2024-10-16,9822
2308,台達電,7,1,6,元大-土城學府,2024-10-16,9822
2258,鴻華先進-創,6,0,6,元大-土城學府,2024-10-16,9822
3071,協禧,6,0,6,元大-土城學府,2024-10-16,9822
5484,慧友,9,3,6,元大-土城學府,2024-10-16,9822
0056,元大高股息,71,9,62,元大-土城學府,2024-10-17,9822
00887,永豐中國科技50大,60,0,60,元大-土城學府,2024-10-17,9822
00637L,元大滬深300正2,57,11,46,元大-土城學府,2024-10-17,9822
4906,正文,34,0,34,元大-土城學府,2024-10-17,9822
00922,國泰台灣領袖50,34,1,33,元大-土城學府,2024-10-17,9822
2303,聯電,30,4,26,元大-土城學府,2024-10-17,9822
00951,台新日本半導體,24,0,24,元大-土城學府,2024-10-17,9822
00878,國泰永續高股息,25,1,24,元大-土城學府,2024-10-17,9822
6530,創威,39,15,24,元大-土城學府,2024-10-17,9822
00937B,群益ESG投等債20,25,6,19,元大-土城學府,2024-10-17,9822
00679B,元大美債20年,17,3,14,元大-土城學府,2024-10-17,9822
00712,復華富時不動產,14,1,13,元大-土城學府,2024-10-17,9822
1326,台化,12,0,12,元大-土城學府,2024-10-17,9822
2359,所羅門,17,5,12,元大-土城學府,2024-10-17,9822
2412,中華電,12,0,12,元大-土城學府,2024-10-17,9822
4533,協易機,16,4,12,元大-土城學府,2024-10-17,9822
8011,台通,12,0,12,元大-土城學府,2024-10-17,9822
3545,敦泰,11,0,11,元大-土城學府,2024-10-17,9822
3105,穩懋,11,0,11,元大-土城學府,2024-10-17,9822
2330,台積電,12,1,11,元大-土城學府,2024-10-17,9822
3450,聯鈞,106,96,10,元大-土城學府,2024-10-17,9822
6274,台燿,11,1,10,元大-土城學府,2024-10-17,9822
00751B,元大AAA至A公司債,10,0,10,元大-土城學府,2024-10-17,9822
3550,聯穎,11,1,10,元大-土城學府,2024-10-17,9822
4977,眾達-KY,11,2,9,元大-土城學府,2024-10-17,9822
1528,恩德,32,23,9,元大-土城學府,2024-10-17,9822
2431,聯昌,9,0,9,元大-土城學府,2024-10-17,9822
2449,京元電子,15,6,9,元大-土城學府,2024-10-17,9822
6241,易通展,10,1,9,元大-土城學府,2024-10-17,9822
4979,華星光,11,3,8,元大-土城學府,2024-10-17,9822
6442,光聖,10,2,8,元大-土城學府,2024-10-17,9822
2421,建準,22,14,8,元大-土城學府,2024-10-17,9822
2820,華票,8,0,8,元大-土城學府,2024-10-17,9822
5452,佶優,32,24,8,元大-土城學府,2024-10-17,9822
00687B,國泰20年美債,8,1,7,元大-土城學府,2024-10-17,9822
3056,富華新,7,0,7,元大-土城學府,2024-10-17,9822
6706,惠特,14,7,7,元大-土城學府,2024-10-17,9822
9945,潤泰新,11,4,7,元大-土城學府,2024-10-17,9822
00941,中信上游半導體,6,0,6,元大-土城學府,2024-10-17,9822
2002,中鋼,7,1,6,元大-土城學府,2024-10-17,9822
3062,建漢,31,25,6,元大-土城學府,2024-10-17,9822
3706,神達,7,1,6,元大-土城學府,2024-10-17,9822
5484,慧友,6,0,6,元大-土城學府,2024-10-17,9822
00881,國泰台灣5G+,7,1,6,元大-土城學府,2024-10-17,9822
2399,映泰,46,41,5,元大-土城學府,2024-10-17,9822
00882,中信中國高股息,7,2,5,元大-土城學府,2024-10-17,9822
00700,富邦�琤肭磪�,5,0,5,元大-土城學府,2024-10-17,9822
00650L,復華香港正2,5,0,5,元大-土城學府,2024-10-17,9822
00935,野村臺灣新科技50,5,0,5,元大-土城學府,2024-10-17,9822
1305,華夏,5,0,5,元大-土城學府,2024-10-17,9822
00632R,元大台灣50反1,821,476,345,元大-土城學府,2024-10-18,9822
00929,復華台灣科技優息,126,20,106,元大-土城學府,2024-10-18,9822
00945B,凱基美國非投等債,99,5,94,元大-土城學府,2024-10-18,9822
00679B,元大美債20年,70,5,65,元大-土城學府,2024-10-18,9822
00937B,群益ESG投等債20,64,0,64,元大-土城學府,2024-10-18,9822
6117,迎廣,63,2,61,元大-土城學府,2024-10-18,9822
00919,群益台灣精選高息,51,5,46,元大-土城學府,2024-10-18,9822
00948B,中信優息投資級債,35,0,35,元大-土城學府,2024-10-18,9822
2303,聯電,39,6,33,元大-土城學府,2024-10-18,9822
00946,群益科技高息成長,34,3,31,元大-土城學府,2024-10-18,9822
00687B,國泰20年美債,39,9,30,元大-土城學府,2024-10-18,9822
6241,易通展,30,0,30,元大-土城學府,2024-10-18,9822
00887,永豐中國科技50大,35,7,28,元大-土城學府,2024-10-18,9822
4562,穎漢,78,53,25,元大-土城學府,2024-10-18,9822
00941,中信上游半導體,25,0,25,元大-土城學府,2024-10-18,9822
00713,元大台灣高息低波,23,0,23,元大-土城學府,2024-10-18,9822
6156,松上,24,1,23,元大-土城學府,2024-10-18,9822
00951,台新日本半導體,23,0,23,元大-土城學府,2024-10-18,9822
3338,泰碩,22,0,22,元大-土城學府,2024-10-18,9822
2464,盟立,26,5,21,元大-土城學府,2024-10-18,9822
5347,世界,21,3,18,元大-土城學府,2024-10-18,9822
00935,野村臺灣新科技50,27,10,17,元大-土城學府,2024-10-18,9822
0056,元大高股息,27,10,17,元大-土城學府,2024-10-18,9822
00720B,元大投資級公司債,25,9,16,元大-土城學府,2024-10-18,9822
6763,綠界科技*,51,36,15,元大-土城學府,2024-10-18,9822
6806,森崴能源,15,0,15,元大-土城學府,2024-10-18,9822
00715L,期街口布蘭特正2,13,0,13,元大-土城學府,2024-10-18,9822
3037,欣興,13,1,12,元大-土城學府,2024-10-18,9822
3715,定穎投控,12,0,12,元大-土城學府,2024-10-18,9822
00892,富邦台灣半導體,12,0,12,元大-土城學府,2024-10-18,9822
00932,兆豐永續高息等權,12,0,12,元大-土城學府,2024-10-18,9822
6239,力成,12,0,12,元大-土城學府,2024-10-18,9822
2609,陽明,17,6,11,元大-土城學府,2024-10-18,9822
00891,中信關鍵半導體,27,16,11,元大-土城學府,2024-10-18,9822
3025,星通,25,14,11,元大-土城學府,2024-10-18,9822
6462,神盾,12,1,11,元大-土城學府,2024-10-18,9822
2888,新光金,27,16,11,元大-土城學府,2024-10-18,9822
00907,永豐優息存股,10,0,10,元大-土城學府,2024-10-18,9822
2421,建準,26,16,10,元大-土城學府,2024-10-18,9822
3105,穩懋,10,0,10,元大-土城學府,2024-10-18,9822
2845,遠東銀,10,0,10,元大-土城學府,2024-10-18,9822
3551,世禾,14,5,9,元大-土城學府,2024-10-18,9822
5392,能率,9,0,9,元大-土城學府,2024-10-18,9822
00751B,元大AAA至A公司債,16,7,9,元大-土城學府,2024-10-18,9822
1540,喬福,59,51,8,元大-土城學府,2024-10-18,9822
2645,長榮航太,8,0,8,元大-土城學府,2024-10-18,9822
5309,系統電,8,0,8,元大-土城學府,2024-10-18,9822
2313,華通,9,1,8,元大-土城學府,2024-10-18,9822
00795B,中信美國公債20年,7,0,7,元大-土城學府,2024-10-18,9822
2439,美律,7,0,7,元大-土城學府,2024-10-18,9822
00905,FT臺灣Smart,308,0,308,元大-土城學府,2024-10-21,9822
00937B,群益ESG投等債20,159,4,155,元大-土城學府,2024-10-21,9822
00945B,凱基美國非投等債,148,0,148,元大-土城學府,2024-10-21,9822
00687B,國泰20年美債,74,3,71,元大-土城學府,2024-10-21,9822
00948B,中信優息投資級債,72,16,56,元大-土城學府,2024-10-21,9822
2883,凱基金,54,0,54,元大-土城學府,2024-10-21,9822
00679B,元大美債20年,54,4,50,元大-土城學府,2024-10-21,9822
3710,連展投控,51,2,49,元大-土城學府,2024-10-21,9822
2891,中信金,48,3,45,元大-土城學府,2024-10-21,9822
00878,國泰永續高股息,48,6,42,元大-土城學府,2024-10-21,9822
2888,新光金,41,1,40,元大-土城學府,2024-10-21,9822
00933B,國泰10Y+金融債,36,0,36,元大-土城學府,2024-10-21,9822
00637L,元大滬深300正2,46,11,35,元大-土城學府,2024-10-21,9822
00725B,國泰投資級公司債,33,0,33,元大-土城學府,2024-10-21,9822
2421,建準,39,11,28,元大-土城學府,2024-10-21,9822
0056,元大高股息,28,0,28,元大-土城學府,2024-10-21,9822
00680L,元大美債20正2,26,0,26,元大-土城學府,2024-10-21,9822
4561,健椿,31,6,25,元大-土城學府,2024-10-21,9822
2354,鴻準,25,1,24,元大-土城學府,2024-10-21,9822
3013,晟銘電,28,6,22,元大-土城學府,2024-10-21,9822
2303,聯電,27,5,22,元大-土城學府,2024-10-21,9822
00882,中信中國高股息,30,10,20,元大-土城學府,2024-10-21,9822
00957B,兆豐US優選投等債,19,0,19,元大-土城學府,2024-10-21,9822
3048,益登,19,0,19,元大-土城學府,2024-10-21,9822
00753L,中信中國50正2,18,0,18,元大-土城學府,2024-10-21,9822
00751B,元大AAA至A公司債,18,2,16,元大-土城學府,2024-10-21,9822
2885,元大金,18,3,15,元大-土城學府,2024-10-21,9822
9958,世紀鋼,34,20,14,元大-土城學府,2024-10-21,9822
00720B,元大投資級公司債,14,0,14,元大-土城學府,2024-10-21,9822
2363,矽統,29,17,12,元大-土城學府,2024-10-21,9822
6104,創惟,23,12,11,元大-土城學府,2024-10-21,9822
2881,富邦金,11,0,11,元大-土城學府,2024-10-21,9822
1326,台化,10,0,10,元大-土城學府,2024-10-21,9822
3149,正達,23,13,10,元大-土城學府,2024-10-21,9822
2399,映泰,36,27,9,元大-土城學府,2024-10-21,9822
8064,東捷,14,6,8,元大-土城學府,2024-10-21,9822
00712,復華富時不動產,9,1,8,元大-土城學府,2024-10-21,9822
00915,凱基優選高股息30,8,0,8,元大-土城學府,2024-10-21,9822
2882,國泰金,8,1,7,元大-土城學府,2024-10-21,9822
1303,南亞,9,2,7,元大-土城學府,2024-10-21,9822
00715L,期街口布蘭特正2,17,10,7,元大-土城學府,2024-10-21,9822
3021,鴻名,8,1,7,元大-土城學府,2024-10-21,9822
3017,奇鋐,9,2,7,元大-土城學府,2024-10-21,9822
2317,鴻海,32,25,7,元大-土城學府,2024-10-21,9822
00922,國泰台灣領袖50,6,0,6,元大-土城學府,2024-10-21,9822
2439,美律,6,0,6,元大-土城學府,2024-10-21,9822
4956,光鋐,7,1,6,元大-土城學府,2024-10-21,9822
6426,統新,6,0,6,元大-土城學府,2024-10-21,9822
5234,達興材料,6,0,6,元大-土城學府,2024-10-21,9822
9945,潤泰新,8,2,6,元大-土城學府,2024-10-21,9822
9105,泰金寶-DR,253,2,251,元大-土城學府,2024-10-22,9822
00937B,群益ESG投等債20,208,6,202,元大-土城學府,2024-10-22,9822
00687B,國泰20年美債,149,21,128,元大-土城學府,2024-10-22,9822
00922,國泰台灣領袖50,118,0,118,元大-土城學府,2024-10-22,9822
00637L,元大滬深300正2,89,0,89,元大-土城學府,2024-10-22,9822
00953B,群益優選非投等債,80,0,80,元大-土城學府,2024-10-22,9822
00959B,大華投等美債15Y+,76,0,76,元大-土城學府,2024-10-22,9822
00679B,元大美債20年,81,5,76,元大-土城學府,2024-10-22,9822
00680L,元大美債20正2,59,0,59,元大-土城學府,2024-10-22,9822
00929,復華台灣科技優息,57,0,57,元大-土城學府,2024-10-22,9822
00948B,中信優息投資級債,36,2,34,元大-土城學府,2024-10-22,9822
2421,建準,33,2,31,元大-土城學府,2024-10-22,9822
00891,中信關鍵半導體,30,0,30,元大-土城學府,2024-10-22,9822
00712,復華富時不動產,29,0,29,元大-土城學府,2024-10-22,9822
6609,瀧澤科,31,3,28,元大-土城學府,2024-10-22,9822
00941,中信上游半導體,22,0,22,元大-土城學府,2024-10-22,9822
1815,富喬,25,3,22,元大-土城學府,2024-10-22,9822
8429,金麗-KY,22,0,22,元大-土城學府,2024-10-22,9822
00933B,國泰10Y+金融債,21,0,21,元大-土城學府,2024-10-22,9822
00688L,國泰20年美債正2,20,0,20,元大-土城學府,2024-10-22,9822
4934,太極,20,0,20,元大-土城學府,2024-10-22,9822
6603,富強鑫,20,0,20,元大-土城學府,2024-10-22,9822
00751B,元大AAA至A公司債,18,0,18,元大-土城學府,2024-10-22,9822
00905,FT臺灣Smart,17,0,17,元大-土城學府,2024-10-22,9822
4561,健椿,17,0,17,元大-土城學府,2024-10-22,9822
2312,金寶,18,2,16,元大-土城學府,2024-10-22,9822
6117,迎廣,20,4,16,元大-土城學府,2024-10-22,9822
00887,永豐中國科技50大,16,1,15,元大-土城學府,2024-10-22,9822
2303,聯電,15,1,14,元大-土城學府,2024-10-22,9822
006208,富邦台50,14,0,14,元大-土城學府,2024-10-22,9822
2356,英業達,21,8,13,元大-土城學府,2024-10-22,9822
2330,台積電,18,5,13,元大-土城學府,2024-10-22,9822
00951,台新日本半導體,13,0,13,元大-土城學府,2024-10-22,9822
2363,矽統,45,34,11,元大-土城學府,2024-10-22,9822
8374,羅昇,10,0,10,元大-土城學府,2024-10-22,9822
0056,元大高股息,15,5,10,元大-土城學府,2024-10-22,9822
00719B,元大美債1-3,10,0,10,元大-土城學府,2024-10-22,9822
3290,東浦,17,7,10,元大-土城學府,2024-10-22,9822
3576,聯合再生,10,0,10,元大-土城學府,2024-10-22,9822
5484,慧友,10,0,10,元大-土城學府,2024-10-22,9822
6425,易發,10,0,10,元大-土城學府,2024-10-22,9822
2543,皇昌,11,2,9,元大-土城學府,2024-10-22,9822
00772B,中信高評級公司債,9,0,9,元大-土城學府,2024-10-22,9822
00957B,兆豐US優選投等債,9,0,9,元大-土城學府,2024-10-22,9822
1905,華紙,9,0,9,元大-土城學府,2024-10-22,9822
3049,精金,14,5,9,元大-土城學府,2024-10-22,9822
4908,前鼎,10,1,9,元大-土城學府,2024-10-22,9822
00725B,國泰投資級公司債,8,0,8,元大-土城學府,2024-10-22,9822
00927,群益半導體收益,8,0,8,元大-土城學府,2024-10-22,9822
2329,華泰,12,4,8,元大-土城學府,2024-10-22,9822
00922,國泰台灣領袖50,547,0,547,元大-土城學府,2024-10-23,9822
00953B,群益優選非投等債,100,0,100,元大-土城學府,2024-10-23,9822
3481,群創,112,21,91,元大-土城學府,2024-10-23,9822
2618,長榮航,82,0,82,元大-土城學府,2024-10-23,9822
00664R,國泰臺灣加權反1,70,0,70,元大-土城學府,2024-10-23,9822
00679B,元大美債20年,56,12,44,元大-土城學府,2024-10-23,9822
2317,鴻海,51,7,44,元大-土城學府,2024-10-23,9822
00687B,國泰20年美債,41,2,39,元大-土城學府,2024-10-23,9822
00929,復華台灣科技優息,39,0,39,元大-土城學府,2024-10-23,9822
00940,元大台灣價值高息,50,11,39,元大-土城學府,2024-10-23,9822
00637L,元大滬深300正2,42,5,37,元大-土城學府,2024-10-23,9822
00959B,大華投等美債15Y+,36,0,36,元大-土城學府,2024-10-23,9822
0056,元大高股息,34,0,34,元大-土城學府,2024-10-23,9822
2885,元大金,33,0,33,元大-土城學府,2024-10-23,9822
00712,復華富時不動產,32,0,32,元大-土城學府,2024-10-23,9822
6117,迎廣,33,4,29,元大-土城學府,2024-10-23,9822
00919,群益台灣精選高息,27,0,27,元大-土城學府,2024-10-23,9822
00882,中信中國高股息,30,5,25,元大-土城學府,2024-10-23,9822
6770,力積電,22,0,22,元大-土城學府,2024-10-23,9822
8096,擎亞,29,7,22,元大-土城學府,2024-10-23,9822
2886,兆豐金,20,0,20,元大-土城學府,2024-10-23,9822
2884,玉山金,18,0,18,元大-土城學府,2024-10-23,9822
2303,聯電,21,4,17,元大-土城學府,2024-10-23,9822
1517,利奇,15,0,15,元大-土城學府,2024-10-23,9822
2399,映泰,60,47,13,元大-土城學府,2024-10-23,9822
2412,中華電,12,0,12,元大-土城學府,2024-10-23,9822
00948B,中信優息投資級債,12,0,12,元大-土城學府,2024-10-23,9822
4164,承業醫,12,0,12,元大-土城學府,2024-10-23,9822
6104,創惟,108,98,10,元大-土城學府,2024-10-23,9822
00857B,永豐20年美公債,10,0,10,元大-土城學府,2024-10-23,9822
2204,中華,10,0,10,元大-土城學府,2024-10-23,9822
2482,連宇,11,1,10,元大-土城學府,2024-10-23,9822
006208,富邦台50,10,0,10,元大-土城學府,2024-10-23,9822
3450,聯鈞,32,23,9,元大-土城學府,2024-10-23,9822
2313,華通,11,2,9,元大-土城學府,2024-10-23,9822
8213,志超,9,0,9,元大-土城學府,2024-10-23,9822
00878,國泰永續高股息,34,26,8,元大-土城學府,2024-10-23,9822
8277,商丞,8,0,8,元大-土城學府,2024-10-23,9822
3037,欣興,35,27,8,元大-土城學府,2024-10-23,9822
9939,宏全,7,0,7,元大-土城學府,2024-10-23,9822
00939,統一台灣高息動能,6,0,6,元大-土城學府,2024-10-23,9822
3163,波若威,6,0,6,元大-土城學府,2024-10-23,9822
5460,同協,6,0,6,元大-土城學府,2024-10-23,9822
5907,大洋-KY,6,0,6,元大-土城學府,2024-10-23,9822
6405,悅城,21,15,6,元大-土城學府,2024-10-23,9822
2344,華邦電,10,4,6,元大-土城學府,2024-10-23,9822
2324,仁寶,6,0,6,元大-土城學府,2024-10-23,9822
8249,菱光,15,10,5,元大-土城學府,2024-10-23,9822
2369,菱生,17,12,5,元大-土城學府,2024-10-23,9822
6129,普誠,5,0,5,元大-土城學府,2024-10-23,9822
00959B,大華投等美債15Y+,60,0,60,元大-土城學府,2024-10-24,9822
6104,創惟,79,22,57,元大-土城學府,2024-10-24,9822
00922,國泰台灣領袖50,55,0,55,元大-土城學府,2024-10-24,9822
00929,復華台灣科技優息,59,5,54,元大-土城學府,2024-10-24,9822
00637L,元大滬深300正2,43,0,43,元大-土城學府,2024-10-24,9822
2891,中信金,41,0,41,元大-土城學府,2024-10-24,9822
0056,元大高股息,43,3,40,元大-土城學府,2024-10-24,9822
00878,國泰永續高股息,44,5,39,元大-土城學府,2024-10-24,9822
2405,輔信,52,20,32,元大-土城學府,2024-10-24,9822
00882,中信中國高股息,30,0,30,元大-土城學府,2024-10-24,9822
1101,台泥,26,0,26,元大-土城學府,2024-10-24,9822
6117,迎廣,31,5,26,元大-土城學府,2024-10-24,9822
00632R,元大台灣50反1,595,570,25,元大-土城學府,2024-10-24,9822
3209,全科,24,2,22,元大-土城學府,2024-10-24,9822
00712,復華富時不動產,23,2,21,元大-土城學府,2024-10-24,9822
3105,穩懋,21,0,21,元大-土城學府,2024-10-24,9822
5443,均豪,22,2,20,元大-土城學府,2024-10-24,9822
00918,大華優利高填息30,20,1,19,元大-土城學府,2024-10-24,9822
8103,瀚荃,19,0,19,元大-土城學府,2024-10-24,9822
2801,彰銀,18,0,18,元大-土城學府,2024-10-24,9822
6706,惠特,21,3,18,元大-土城學府,2024-10-24,9822
00919,群益台灣精選高息,20,2,18,元大-土城學府,2024-10-24,9822
8064,東捷,29,12,17,元大-土城學府,2024-10-24,9822
1721,三晃,118,101,17,元大-土城學府,2024-10-24,9822
2481,強茂,17,0,17,元大-土城學府,2024-10-24,9822
2482,連宇,22,6,16,元大-土城學府,2024-10-24,9822
1517,利奇,15,0,15,元大-土城學府,2024-10-24,9822
2489,瑞軒,26,12,14,元大-土城學府,2024-10-24,9822
1229,聯華,13,0,13,元大-土城學府,2024-10-24,9822
2388,威盛,20,7,13,元大-土城學府,2024-10-24,9822
00715L,期街口布蘭特正2,15,2,13,元大-土城學府,2024-10-24,9822
6763,綠界科技*,27,14,13,元大-土城學府,2024-10-24,9822
2027,大成鋼,12,0,12,元大-土城學府,2024-10-24,9822
3706,神達,16,4,12,元大-土城學府,2024-10-24,9822
00887,永豐中國科技50大,18,7,11,元大-土城學府,2024-10-24,9822
3455,由田,11,0,11,元大-土城學府,2024-10-24,9822
3689,湧德,13,2,11,元大-土城學府,2024-10-24,9822
6156,松上,11,0,11,元大-土城學府,2024-10-24,9822
2609,陽明,18,7,11,元大-土城學府,2024-10-24,9822
00753L,中信中國50正2,10,0,10,元大-土城學府,2024-10-24,9822
00932,兆豐永續高息等權,10,0,10,元大-土城學府,2024-10-24,9822
8404,百和興業-KY,10,0,10,元大-土城學府,2024-10-24,9822
00664R,國泰臺灣加權反1,10,0,10,元大-土城學府,2024-10-24,9822
00948B,中信優息投資級債,10,0,10,元大-土城學府,2024-10-24,9822
2390,云辰,10,0,10,元大-土城學府,2024-10-24,9822
2929,淘帝-KY,11,1,10,元大-土城學府,2024-10-24,9822
4903,聯光通,12,2,10,元大-土城學府,2024-10-24,9822
5234,達興材料,10,0,10,元大-土城學府,2024-10-24,9822
5355,佳總,10,0,10,元大-土城學府,2024-10-24,9822
5905,南仁湖,11,1,10,元大-土城學府,2024-10-24,9822
2646,星宇航空,238,171,67,元大-土城學府,2024-10-25,9822
00952,凱基台灣AI50,50,0,50,元大-土城學府,2024-10-25,9822
6104,創惟,119,69,50,元大-土城學府,2024-10-25,9822
00919,群益台灣精選高息,48,1,47,元大-土城學府,2024-10-25,9822
2303,聯電,50,6,44,元大-土城學府,2024-10-25,9822
00937B,群益ESG投等債20,41,9,32,元大-土城學府,2024-10-25,9822
3550,聯穎,32,0,32,元大-土城學府,2024-10-25,9822
00680L,元大美債20正2,28,0,28,元大-土城學府,2024-10-25,9822
00959B,大華投等美債15Y+,23,0,23,元大-土城學府,2024-10-25,9822
2374,佳能,34,12,22,元大-土城學府,2024-10-25,9822
8011,台通,22,0,22,元大-土城學府,2024-10-25,9822
00946,群益科技高息成長,20,0,20,元大-土城學府,2024-10-25,9822
00664R,國泰臺灣加權反1,20,0,20,元大-土城學府,2024-10-25,9822
6133,金橋,20,1,19,元大-土城學府,2024-10-25,9822
2344,華邦電,19,1,18,元大-土城學府,2024-10-25,9822
2609,陽明,24,6,18,元大-土城學府,2024-10-25,9822
4908,前鼎,18,0,18,元大-土城學府,2024-10-25,9822
5202,力新,23,5,18,元大-土城學府,2024-10-25,9822
6142,友勁,20,2,18,元大-土城學府,2024-10-25,9822
00687B,國泰20年美債,21,4,17,元大-土城學府,2024-10-25,9822
00932,兆豐永續高息等權,15,0,15,元大-土城學府,2024-10-25,9822
00921,兆豐龍頭等權重,14,0,14,元大-土城學府,2024-10-25,9822
00900,富邦特選高股息30,14,0,14,元大-土城學府,2024-10-25,9822
2337,旺宏,15,2,13,元大-土城學府,2024-10-25,9822
2351,順德,19,7,12,元大-土城學府,2024-10-25,9822
2429,銘旺科,11,0,11,元大-土城學府,2024-10-25,9822
2455,全新,11,0,11,元大-土城學府,2024-10-25,9822
6202,盛群,11,0,11,元大-土城學府,2024-10-25,9822
6213,聯茂,14,3,11,元大-土城學府,2024-10-25,9822
9105,泰金寶-DR,20,9,11,元大-土城學府,2024-10-25,9822
00927,群益半導體收益,10,0,10,元大-土城學府,2024-10-25,9822
00882,中信中國高股息,10,0,10,元大-土城學府,2024-10-25,9822
00700,富邦�琤肭磪�,10,0,10,元大-土城學府,2024-10-25,9822
006205,富邦上証,10,0,10,元大-土城學府,2024-10-25,9822
00643,群益深証中小,10,0,10,元大-土城學府,2024-10-25,9822
2468,華經,10,0,10,元大-土城學府,2024-10-25,9822
2489,瑞軒,21,11,10,元大-土城學府,2024-10-25,9822
00679B,元大美債20年,13,4,9,元大-土城學府,2024-10-25,9822
2495,普安,68,59,9,元大-土城學府,2024-10-25,9822
3149,正達,14,5,9,元大-土城學府,2024-10-25,9822
00905,FT臺灣Smart,9,0,9,元大-土城學府,2024-10-25,9822
3029,零壹,9,1,8,元大-土城學府,2024-10-25,9822
00632R,元大台灣50反1,93,85,8,元大-土城學府,2024-10-25,9822
2417,圓剛,8,0,8,元大-土城學府,2024-10-25,9822
6770,力積電,14,6,8,元大-土城學府,2024-10-25,9822
8358,金居,11,3,8,元大-土城學府,2024-10-25,9822
4174,浩鼎,7,0,7,元大-土城學府,2024-10-25,9822
6129,普誠,7,0,7,元大-土城學府,2024-10-25,9822
6288,聯嘉,8,1,7,元大-土城學府,2024-10-25,9822
2615,萬海,9,3,6,元大-土城學府,2024-10-25,9822
2477,美隆電,178,22,156,元大-土城學府,2024-10-28,9822
00937B,群益ESG投等債20,81,0,81,元大-土城學府,2024-10-28,9822
2302,麗正,73,7,66,元大-土城學府,2024-10-28,9822
00952,凱基台灣AI50,51,0,51,元大-土城學府,2024-10-28,9822
2903,遠百,42,0,42,元大-土城學府,2024-10-28,9822
00919,群益台灣精選高息,50,11,39,元大-土城學府,2024-10-28,9822
0056,元大高股息,48,10,38,元大-土城學府,2024-10-28,9822
00923,群益台ESG低碳50,36,0,36,元大-土城學府,2024-10-28,9822
00637L,元大滬深300正2,43,8,35,元大-土城學府,2024-10-28,9822
2303,聯電,31,6,25,元大-土城學府,2024-10-28,9822
00687B,國泰20年美債,30,6,24,元大-土城學府,2024-10-28,9822
00948B,中信優息投資級債,24,0,24,元大-土城學府,2024-10-28,9822
1101,台泥,22,0,22,元大-土城學府,2024-10-28,9822
2481,強茂,20,0,20,元大-土城學府,2024-10-28,9822
2884,玉山金,17,0,17,元大-土城學府,2024-10-28,9822
00712,復華富時不動產,17,0,17,元大-土城學府,2024-10-28,9822
6117,迎廣,20,3,17,元大-土城學府,2024-10-28,9822
00679B,元大美債20年,26,10,16,元大-土城學府,2024-10-28,9822
1517,利奇,16,0,16,元大-土城學府,2024-10-28,9822
2891,中信金,16,0,16,元大-土城學府,2024-10-28,9822
6788,華景電,17,1,16,元大-土城學府,2024-10-28,9822
3552,同致,18,2,16,元大-土城學府,2024-10-28,9822
6530,創威,15,0,15,元大-土城學府,2024-10-28,9822
2317,鴻海,164,150,14,元大-土城學府,2024-10-28,9822
2354,鴻準,57,43,14,元大-土城學府,2024-10-28,9822
2356,英業達,17,3,14,元大-土城學府,2024-10-28,9822
6158,禾昌,25,11,14,元大-土城學府,2024-10-28,9822
00751B,元大AAA至A公司債,14,0,14,元大-土城學府,2024-10-28,9822
4561,健椿,13,0,13,元大-土城學府,2024-10-28,9822
2405,輔信,12,0,12,元大-土城學府,2024-10-28,9822
00680L,元大美債20正2,12,0,12,元大-土城學府,2024-10-28,9822
00715L,期街口布蘭特正2,11,0,11,元大-土城學府,2024-10-28,9822
8096,擎亞,20,9,11,元大-土城學府,2024-10-28,9822
6142,友勁,12,2,10,元大-土城學府,2024-10-28,9822
00959B,大華投等美債15Y+,10,0,10,元大-土城學府,2024-10-28,9822
3048,益登,10,0,10,元大-土城學府,2024-10-28,9822
6288,聯嘉,37,27,10,元大-土城學府,2024-10-28,9822
00720B,元大投資級公司債,9,0,9,元大-土城學府,2024-10-28,9822
00725B,國泰投資級公司債,9,0,9,元大-土城學府,2024-10-28,9822
00688L,國泰20年美債正2,8,0,8,元大-土城學府,2024-10-28,9822
1808,潤隆,8,0,8,元大-土城學府,2024-10-28,9822
2312,金寶,9,1,8,元大-土城學府,2024-10-28,9822
2603,長榮,9,1,8,元大-土城學府,2024-10-28,9822
1514,亞力,9,2,7,元大-土城學府,2024-10-28,9822
00905,FT臺灣Smart,7,0,7,元大-土城學府,2024-10-28,9822
1584,精剛,7,0,7,元大-土城學府,2024-10-28,9822
2897,王道銀行,7,0,7,元大-土城學府,2024-10-28,9822
4903,聯光通,11,4,7,元大-土城學府,2024-10-28,9822
8027,鈦昇,7,0,7,元大-土城學府,2024-10-28,9822
2646,星宇航空,80,74,6,元大-土城學府,2024-10-28,9822
00680L,元大美債20正2,500,0,500,元大-土城學府,2024-10-29,9822
9105,泰金寶-DR,202,9,193,元大-土城學府,2024-10-29,9822
00919,群益台灣精選高息,180,11,169,元大-土城學府,2024-10-29,9822
00632R,元大台灣50反1,200,38,162,元大-土城學府,2024-10-29,9822
00937B,群益ESG投等債20,122,5,117,元大-土城學府,2024-10-29,9822
00946,群益科技高息成長,116,0,116,元大-土城學府,2024-10-29,9822
2317,鴻海,222,118,104,元大-土城學府,2024-10-29,9822
00878,國泰永續高股息,96,0,96,元大-土城學府,2024-10-29,9822
00929,復華台灣科技優息,125,50,75,元大-土城學府,2024-10-29,9822
00940,元大台灣價值高息,77,5,72,元大-土城學府,2024-10-29,9822
0056,元大高股息,66,5,61,元大-土城學府,2024-10-29,9822
3037,欣興,70,30,40,元大-土城學府,2024-10-29,9822
00706L,期元大S＆P日圓正2,33,0,33,元大-土城學府,2024-10-29,9822
00712,復華富時不動產,32,0,32,元大-土城學府,2024-10-29,9822
1711,永光,32,4,28,元大-土城學府,2024-10-29,9822
2646,星宇航空,35,9,26,元大-土城學府,2024-10-29,9822
5452,佶優,31,6,25,元大-土城學府,2024-10-29,9822
2390,云辰,24,0,24,元大-土城學府,2024-10-29,9822
00959B,大華投等美債15Y+,22,0,22,元大-土城學府,2024-10-29,9822
00637L,元大滬深300正2,27,7,20,元大-土城學府,2024-10-29,9822
2608,嘉里大榮,20,0,20,元大-土城學府,2024-10-29,9822
6456,GIS-KY,18,0,18,元大-土城學府,2024-10-29,9822
8033,雷虎,18,0,18,元大-土城學府,2024-10-29,9822
00715L,期街口布蘭特正2,17,0,17,元大-土城學府,2024-10-29,9822
2891,中信金,18,1,17,元大-土城學府,2024-10-29,9822
006208,富邦台50,16,0,16,元大-土城學府,2024-10-29,9822
00922,國泰台灣領袖50,136,120,16,元大-土城學府,2024-10-29,9822
00642U,期元大S＆P石油,16,0,16,元大-土城學府,2024-10-29,9822
0050,元大台灣50,16,0,16,元大-土城學府,2024-10-29,9822
6770,力積電,28,13,15,元大-土城學府,2024-10-29,9822
3013,晟銘電,18,3,15,元大-土城學府,2024-10-29,9822
3532,台勝科,15,0,15,元大-土城學府,2024-10-29,9822
2413,環科,17,2,15,元大-土城學府,2024-10-29,9822
00881,國泰台灣5G+,14,0,14,元大-土城學府,2024-10-29,9822
00934,中信成長高股息,14,0,14,元大-土城學府,2024-10-29,9822
1616,億泰,14,0,14,元大-土城學府,2024-10-29,9822
1605,華新,14,0,14,元大-土城學府,2024-10-29,9822
2609,陽明,15,2,13,元大-土城學府,2024-10-29,9822
2601,益航,13,0,13,元大-土城學府,2024-10-29,9822
00918,大華優利高填息30,13,0,13,元大-土城學府,2024-10-29,9822
00905,FT臺灣Smart,12,0,12,元大-土城學府,2024-10-29,9822
2344,華邦電,12,0,12,元大-土城學府,2024-10-29,9822
00665L,富邦�琤肭磪囓�2,12,0,12,元大-土城學府,2024-10-29,9822
00902,中信電池及儲能,12,0,12,元大-土城學府,2024-10-29,9822
3516,亞帝歐,12,0,12,元大-土城學府,2024-10-29,9822
2618,長榮航,26,14,12,元大-土城學府,2024-10-29,9822
2883,凱基金,13,2,11,元大-土城學府,2024-10-29,9822
00958B,永豐ESG銀行債15,11,0,11,元大-土城學府,2024-10-29,9822
2610,華航,20,9,11,元大-土城學府,2024-10-29,9822
00927,群益半導體收益,10,0,10,元大-土城學府,2024-10-29,9822
00919,群益台灣精選高息,130,26,104,元大-土城學府,2024-10-30,9822
00632R,元大台灣50反1,111,35,76,元大-土城學府,2024-10-30,9822
00708L,期元大S＆P黃金正2,60,0,60,元大-土城學府,2024-10-30,9822
00930,永豐ESG低碳高息,58,0,58,元大-土城學府,2024-10-30,9822
6156,松上,56,0,56,元大-土城學府,2024-10-30,9822
2303,聯電,60,10,50,元大-土城學府,2024-10-30,9822
4919,新唐,54,19,35,元大-土城學府,2024-10-30,9822
00929,復華台灣科技優息,37,4,33,元大-土城學府,2024-10-30,9822
00940,元大台灣價值高息,33,1,32,元大-土城學府,2024-10-30,9822
00637L,元大滬深300正2,32,0,32,元大-土城學府,2024-10-30,9822
00712,復華富時不動產,26,0,26,元大-土城學府,2024-10-30,9822
3518,柏騰,25,1,24,元大-土城學府,2024-10-30,9822
00948B,中信優息投資級債,23,0,23,元大-土城學府,2024-10-30,9822
00878,國泰永續高股息,23,1,22,元大-土城學府,2024-10-30,9822
00946,群益科技高息成長,21,0,21,元大-土城學府,2024-10-30,9822
3481,群創,25,4,21,元大-土城學府,2024-10-30,9822
00958B,永豐ESG銀行債15,21,0,21,元大-土城學府,2024-10-30,9822
00959B,大華投等美債15Y+,20,0,20,元大-土城學府,2024-10-30,9822
00679B,元大美債20年,21,1,20,元大-土城學府,2024-10-30,9822
0056,元大高股息,21,3,18,元大-土城學府,2024-10-30,9822
3709,鑫聯大投控,17,0,17,元大-土城學府,2024-10-30,9822
2337,旺宏,18,3,15,元大-土城學府,2024-10-30,9822
6530,創威,16,2,14,元大-土城學府,2024-10-30,9822
00882,中信中國高股息,12,0,12,元大-土城學府,2024-10-30,9822
5871,中租-KY,11,0,11,元大-土城學府,2024-10-30,9822
6126,信音,11,0,11,元大-土城學府,2024-10-30,9822
1612,宏泰,10,0,10,元大-土城學府,2024-10-30,9822
2329,華泰,13,3,10,元大-土城學府,2024-10-30,9822
3402,漢科,10,0,10,元大-土城學府,2024-10-30,9822
4977,眾達-KY,11,1,10,元大-土城學府,2024-10-30,9822
8096,擎亞,12,2,10,元大-土城學府,2024-10-30,9822
8367,建新國際,10,0,10,元大-土城學府,2024-10-30,9822
2425,承啟,20,10,10,元大-土城學府,2024-10-30,9822
00887,永豐中國科技50大,9,0,9,元大-土城學府,2024-10-30,9822
2382,廣達,10,1,9,元大-土城學府,2024-10-30,9822
3550,聯穎,9,0,9,元大-土城學府,2024-10-30,9822
00934,中信成長高股息,10,2,8,元大-土城學府,2024-10-30,9822
2891,中信金,10,2,8,元大-土城學府,2024-10-30,9822
2762,世界健身-KY,8,0,8,元大-土城學府,2024-10-30,9822
3231,緯創,9,1,8,元大-土城學府,2024-10-30,9822
1528,恩德,76,68,8,元大-土城學府,2024-10-30,9822
6191,精成科,8,0,8,元大-土城學府,2024-10-30,9822
00905,FT臺灣Smart,7,0,7,元大-土城學府,2024-10-30,9822
6257,矽格,7,0,7,元大-土城學府,2024-10-30,9822
8028,昇陽半導體,7,0,7,元大-土城學府,2024-10-30,9822
00915,凱基優選高股息30,6,0,6,元大-土城學府,2024-10-30,9822
3047,訊舟,33,27,6,元大-土城學府,2024-10-30,9822
3686,達能,7,1,6,元大-土城學府,2024-10-30,9822
6109,亞元,6,0,6,元大-土城學府,2024-10-30,9822
6176,瑞儀,6,0,6,元大-土城學府,2024-10-30,9822
2303,聯電,117,6,111,元大-土城學府,2024-11-01,9822
00929,復華台灣科技優息,92,19,73,元大-土城學府,2024-11-01,9822
00878,國泰永續高股息,64,0,64,元大-土城學府,2024-11-01,9822
2891,中信金,53,2,51,元大-土城學府,2024-11-01,9822
00919,群益台灣精選高息,73,26,47,元大-土城學府,2024-11-01,9822
2317,鴻海,150,107,43,元大-土城學府,2024-11-01,9822
2354,鴻準,156,116,40,元大-土城學府,2024-11-01,9822
0056,元大高股息,40,5,35,元大-土城學府,2024-11-01,9822
00706L,期元大S＆P日圓正2,30,0,30,元大-土城學府,2024-11-01,9822
1517,利奇,32,2,30,元大-土城學府,2024-11-01,9822
00948B,中信優息投資級債,28,0,28,元大-土城學府,2024-11-01,9822
00946,群益科技高息成長,31,5,26,元大-土城學府,2024-11-01,9822
00930,永豐ESG低碳高息,21,0,21,元大-土城學府,2024-11-01,9822
3013,晟銘電,22,5,17,元大-土城學府,2024-11-01,9822
2884,玉山金,17,0,17,元大-土城學府,2024-11-01,9822
2409,友達,16,0,16,元大-土城學府,2024-11-01,9822
00937B,群益ESG投等債20,25,9,16,元大-土城學府,2024-11-01,9822
1326,台化,15,0,15,元大-土城學府,2024-11-01,9822
00940,元大台灣價值高息,23,9,14,元大-土城學府,2024-11-01,9822
5871,中租-KY,14,0,14,元大-土城學府,2024-11-01,9822
00708L,期元大S＆P黃金正2,13,0,13,元大-土城學府,2024-11-01,9822
00959B,大華投等美債15Y+,13,0,13,元大-土城學府,2024-11-01,9822
2618,長榮航,20,8,12,元大-土城學府,2024-11-01,9822
00915,凱基優選高股息30,12,0,12,元大-土城學府,2024-11-01,9822
00679B,元大美債20年,12,1,11,元大-土城學府,2024-11-01,9822
2344,華邦電,12,1,11,元大-土城學府,2024-11-01,9822
006208,富邦台50,10,0,10,元大-土城學府,2024-11-01,9822
2062,橋椿,10,0,10,元大-土城學府,2024-11-01,9822
2431,聯昌,22,12,10,元大-土城學府,2024-11-01,9822
3450,聯鈞,24,14,10,元大-土城學府,2024-11-01,9822
3035,智原,25,15,10,元大-土城學府,2024-11-01,9822
6133,金橋,33,24,9,元大-土城學府,2024-11-01,9822
00712,復華富時不動產,8,0,8,元大-土城學府,2024-11-01,9822
2883,凱基金,8,0,8,元大-土城學府,2024-11-01,9822
00891,中信關鍵半導體,11,3,8,元大-土城學府,2024-11-01,9822
00945B,凱基美國非投等債,8,0,8,元大-土城學府,2024-11-01,9822
00958B,永豐ESG銀行債15,8,0,8,元大-土城學府,2024-11-01,9822
9945,潤泰新,9,1,8,元大-土城學府,2024-11-01,9822
3011,今皓,7,0,7,元大-土城學府,2024-11-01,9822
5014,建錩,7,0,7,元大-土城學府,2024-11-01,9822
0050,元大台灣50,7,1,6,元大-土城學府,2024-11-01,9822
00905,FT臺灣Smart,6,0,6,元大-土城學府,2024-11-01,9822
00687B,國泰20年美債,9,3,6,元大-土城學府,2024-11-01,9822
2301,光寶科,26,20,6,元大-土城學府,2024-11-01,9822
8103,瀚荃,6,0,6,元大-土城學府,2024-11-01,9822
2337,旺宏,10,5,5,元大-土城學府,2024-11-01,9822
00939,統一台灣高息動能,5,0,5,元大-土城學府,2024-11-01,9822
2890,永豐金,5,0,5,元大-土城學府,2024-11-01,9822
3711,日月光投控,6,1,5,元大-土城學府,2024-11-01,9822
2351,順德,5,0,5,元大-土城學府,2024-11-01,9822
9105,泰金寶-DR,300,1,299,元大-土城學府,2024-11-04,9822
00940,元大台灣價值高息,117,11,106,元大-土城學府,2024-11-04,9822
00679B,元大美債20年,89,1,88,元大-土城學府,2024-11-04,9822
8111,立��,99,13,86,元大-土城學府,2024-11-04,9822
00882,中信中國高股息,71,0,71,元大-土城學府,2024-11-04,9822
00929,復華台灣科技優息,81,12,69,元大-土城學府,2024-11-04,9822
00878,國泰永續高股息,57,6,51,元大-土城學府,2024-11-04,9822
00937B,群益ESG投等債20,66,18,48,元大-土城學府,2024-11-04,9822
00712,復華富時不動產,48,0,48,元大-土城學府,2024-11-04,9822
2303,聯電,60,14,46,元大-土城學府,2024-11-04,9822
00948B,中信優息投資級債,36,0,36,元大-土城學府,2024-11-04,9822
1717,長興,30,0,30,元大-土城學府,2024-11-04,9822
3202,樺晟,25,0,25,元大-土城學府,2024-11-04,9822
00932,兆豐永續高息等權,23,0,23,元大-土城學府,2024-11-04,9822
00687B,國泰20年美債,28,5,23,元大-土城學府,2024-11-04,9822
2609,陽明,67,44,23,元大-土城學府,2024-11-04,9822
00959B,大華投等美債15Y+,22,0,22,元大-土城學府,2024-11-04,9822
2615,萬海,38,16,22,元大-土城學府,2024-11-04,9822
00637L,元大滬深300正2,26,5,21,元大-土城學府,2024-11-04,9822
2329,華泰,28,7,21,元大-土城學府,2024-11-04,9822
3481,群創,16,0,16,元大-土城學府,2024-11-04,9822
2618,長榮航,20,4,16,元大-土城學府,2024-11-04,9822
3709,鑫聯大投控,20,5,15,元大-土城學府,2024-11-04,9822
2337,旺宏,21,7,14,元大-土城學府,2024-11-04,9822
6456,GIS-KY,14,0,14,元大-土城學府,2024-11-04,9822
00751B,元大AAA至A公司債,12,0,12,元大-土城學府,2024-11-04,9822
6158,禾昌,13,1,12,元大-土城學府,2024-11-04,9822
1584,精剛,12,1,11,元大-土城學府,2024-11-04,9822
1616,億泰,11,0,11,元大-土城學府,2024-11-04,9822
6821,聯寶,12,1,11,元大-土城學府,2024-11-04,9822
2542,興富發,10,0,10,元大-土城學府,2024-11-04,9822
00706L,期元大S＆P日圓正2,10,0,10,元大-土城學府,2024-11-04,9822
00650L,復華香港正2,10,0,10,元大-土城學府,2024-11-04,9822
00931B,統一美債20年,10,0,10,元大-土城學府,2024-11-04,9822
00939,統一台灣高息動能,10,0,10,元大-土城學府,2024-11-04,9822
1815,富喬,11,1,10,元大-土城學府,2024-11-04,9822
2634,漢翔,10,0,10,元大-土城學府,2024-11-04,9822
4729,熒茂,10,0,10,元大-土城學府,2024-11-04,9822
5355,佳總,10,0,10,元大-土城學府,2024-11-04,9822
8367,建新國際,10,0,10,元大-土城學府,2024-11-04,9822
3450,聯鈞,36,26,10,元大-土城學府,2024-11-04,9822
2646,星宇航空,21,12,9,元大-土城學府,2024-11-04,9822
1517,利奇,8,0,8,元大-土城學府,2024-11-04,9822
2607,榮運,8,0,8,元大-土城學府,2024-11-04,9822
3042,晶技,8,0,8,元大-土城學府,2024-11-04,9822
3017,奇鋐,17,9,8,元大-土城學府,2024-11-04,9822
2539,櫻花建,7,0,7,元大-土城學府,2024-11-04,9822
4174,浩鼎,7,0,7,元大-土城學府,2024-11-04,9822
00927,群益半導體收益,7,0,7,元大-土城學府,2024-11-04,9822
0056,元大高股息,25,18,7,元大-土城學府,2024-11-04,9822
00932,兆豐永續高息等權,114,4,110,元大-土城學府,2024-11-05,9822
00878,國泰永續高股息,66,3,63,元大-土城學府,2024-11-05,9822
2303,聯電,48,10,38,元大-土城學府,2024-11-05,9822
00946,群益科技高息成長,36,0,36,元大-土城學府,2024-11-05,9822
3049,精金,39,5,34,元大-土城學府,2024-11-05,9822
8028,昇陽半導體,34,6,28,元大-土城學府,2024-11-05,9822
2618,長榮航,40,13,27,元大-土城學府,2024-11-05,9822
4174,浩鼎,26,0,26,元大-土城學府,2024-11-05,9822
00919,群益台灣精選高息,31,5,26,元大-土城學府,2024-11-05,9822
3013,晟銘電,46,28,18,元大-土城學府,2024-11-05,9822
3450,聯鈞,100,83,17,元大-土城學府,2024-11-05,9822
2353,宏��,18,2,16,元大-土城學府,2024-11-05,9822
00725B,國泰投資級公司債,15,0,15,元大-土城學府,2024-11-05,9822
2610,華航,31,16,15,元大-土城學府,2024-11-05,9822
2317,鴻海,22,8,14,元大-土城學府,2024-11-05,9822
00753L,中信中國50正2,20,8,12,元大-土城學府,2024-11-05,9822
6449,鈺邦,13,1,12,元大-土城學府,2024-11-05,9822
2542,興富發,10,0,10,元大-土城學府,2024-11-05,9822
2390,云辰,10,0,10,元大-土城學府,2024-11-05,9822
2354,鴻準,147,139,8,元大-土城學府,2024-11-05,9822
00915,凱基優選高股息30,8,0,8,元大-土城學府,2024-11-05,9822
1528,恩德,12,4,8,元大-土城學府,2024-11-05,9822
6830,汎銓,14,6,8,元大-土城學府,2024-11-05,9822
3711,日月光投控,8,1,7,元大-土城學府,2024-11-05,9822
00891,中信關鍵半導體,8,1,7,元大-土城學府,2024-11-05,9822
00692,富邦公司治理,7,0,7,元大-土城學府,2024-11-05,9822
6491,晶碩,7,0,7,元大-土城學府,2024-11-05,9822
2328,廣宇,7,1,6,元大-土城學府,2024-11-05,9822
9933,中鼎,6,0,6,元大-土城學府,2024-11-05,9822
4167,松瑞藥,6,0,6,元大-土城學府,2024-11-05,9822
6213,聯茂,6,0,6,元大-土城學府,2024-11-05,9822
6530,創威,21,15,6,元大-土城學府,2024-11-05,9822
00673R,期元大S＆P原油反1,5,0,5,元大-土城學府,2024-11-05,9822
00650L,復華香港正2,5,0,5,元大-土城學府,2024-11-05,9822
1301,台塑,12,7,5,元大-土城學府,2024-11-05,9822
1326,台化,5,0,5,元大-土城學府,2024-11-05,9822
1605,華新,10,5,5,元大-土城學府,2024-11-05,9822
8096,擎亞,7,2,5,元大-土城學府,2024-11-05,9822
3023,信邦,4,0,4,元大-土城學府,2024-11-05,9822
9103,美德醫療-DR,4,0,4,元大-土城學府,2024-11-05,9822
2834,臺企銀,5,1,4,元大-土城學府,2024-11-05,9822
00715L,期街口布蘭特正2,10,6,4,元大-土城學府,2024-11-05,9822
00930,永豐ESG低碳高息,4,0,4,元大-土城學府,2024-11-05,9822
00948B,中信優息投資級債,4,0,4,元大-土城學府,2024-11-05,9822
1584,精剛,4,0,4,元大-土城學府,2024-11-05,9822
1815,富喬,6,2,4,元大-土城學府,2024-11-05,9822
2371,大同,9,5,4,元大-土城學府,2024-11-05,9822
3035,智原,4,0,4,元大-土城學府,2024-11-05,9822
8390,金益鼎,7,3,4,元大-土城學府,2024-11-05,9822
2312,金寶,5,1,4,元大-土城學府,2024-11-05,9822
00632R,元大台灣50反1,615,173,442,元大-土城學府,2024-11-06,9822
2419,仲琦,109,1,108,元大-土城學府,2024-11-06,9822
00882,中信中國高股息,83,0,83,元大-土城學府,2024-11-06,9822
00679B,元大美債20年,98,19,79,元大-土城學府,2024-11-06,9822
6757,台灣虎航,80,3,77,元大-土城學府,2024-11-06,9822
00878,國泰永續高股息,72,7,65,元大-土城學府,2024-11-06,9822
00687B,國泰20年美債,61,3,58,元大-土城學府,2024-11-06,9822
00795B,中信美國公債20年,38,0,38,元大-土城學府,2024-11-06,9822
00637L,元大滬深300正2,52,14,38,元大-土城學府,2024-11-06,9822
0056,元大高股息,38,6,32,元大-土城學府,2024-11-06,9822
2618,長榮航,32,4,28,元大-土城學府,2024-11-06,9822
00937B,群益ESG投等債20,28,1,27,元大-土城學府,2024-11-06,9822
00712,復華富時不動產,26,0,26,元大-土城學府,2024-11-06,9822
00680L,元大美債20正2,31,5,26,元大-土城學府,2024-11-06,9822
00650L,復華香港正2,25,0,25,元大-土城學府,2024-11-06,9822
00919,群益台灣精選高息,36,12,24,元大-土城學府,2024-11-06,9822
00720B,元大投資級公司債,21,0,21,元大-土城學府,2024-11-06,9822
00948B,中信優息投資級債,21,0,21,元大-土城學府,2024-11-06,9822
00959B,大華投等美債15Y+,21,0,21,元大-土城學府,2024-11-06,9822
6530,創威,23,2,21,元大-土城學府,2024-11-06,9822
00946,群益科技高息成長,20,0,20,元大-土城學府,2024-11-06,9822
1313,聯成,20,0,20,元大-土城學府,2024-11-06,9822
2646,星宇航空,21,1,20,元大-土城學府,2024-11-06,9822
3317,尼克森,20,0,20,元大-土城學府,2024-11-06,9822
2303,聯電,39,19,20,元大-土城學府,2024-11-06,9822
00931B,統一美債20年,20,0,20,元大-土城學府,2024-11-06,9822
00753L,中信中國50正2,19,0,19,元大-土城學府,2024-11-06,9822
00688L,國泰20年美債正2,17,0,17,元大-土城學府,2024-11-06,9822
3062,建漢,22,5,17,元大-土城學府,2024-11-06,9822
3450,聯鈞,57,42,15,元大-土城學府,2024-11-06,9822
5347,世界,24,12,12,元大-土城學府,2024-11-06,9822
3481,群創,16,5,11,元大-土城學府,2024-11-06,9822
3260,威剛,14,3,11,元大-土城學府,2024-11-06,9822
4919,新唐,23,12,11,元大-土城學府,2024-11-06,9822
00958B,永豐ESG銀行債15,15,4,11,元大-土城學府,2024-11-06,9822
2069,運錩,11,0,11,元大-土城學府,2024-11-06,9822
2520,冠德,11,0,11,元大-土城學府,2024-11-06,9822
8027,鈦昇,12,1,11,元大-土城學府,2024-11-06,9822
2603,長榮,11,0,11,元大-土城學府,2024-11-06,9822
8032,光菱,18,8,10,元大-土城學府,2024-11-06,9822
2101,南港,10,0,10,元大-土城學府,2024-11-06,9822
2367,燿華,10,0,10,元大-土城學府,2024-11-06,9822
2855,統一證,10,0,10,元大-土城學府,2024-11-06,9822
3209,全科,10,0,10,元大-土城學府,2024-11-06,9822
4174,浩鼎,10,0,10,元大-土城學府,2024-11-06,9822
6182,合晶,10,0,10,元大-土城學府,2024-11-06,9822
6706,惠特,10,0,10,元大-土城學府,2024-11-06,9822
00915,凱基優選高股息30,10,0,10,元大-土城學府,2024-11-06,9822
00633L,富邦上証正2,9,0,9,元大-土城學府,2024-11-06,9822
1528,恩德,18,9,9,元大-土城學府,2024-11-06,9822
9105,泰金寶-DR,949,298,651,元大-土城學府,2024-11-07,9822
2634,漢翔,253,0,253,元大-土城學府,2024-11-07,9822
00679B,元大美債20年,222,12,210,元大-土城學府,2024-11-07,9822
9945,潤泰新,101,1,100,元大-土城學府,2024-11-07,9822
2356,英業達,147,51,96,元大-土城學府,2024-11-07,9822
3202,樺晟,51,0,51,元大-土城學府,2024-11-07,9822
8044,網家,34,0,34,元大-土城學府,2024-11-07,9822
5386,青雲,34,2,32,元大-土城學府,2024-11-07,9822
6757,台灣虎航,31,0,31,元大-土城學府,2024-11-07,9822
2603,長榮,33,4,29,元大-土城學府,2024-11-07,9822
8429,金麗-KY,23,0,23,元大-土城學府,2024-11-07,9822
5243,乙盛-KY,38,16,22,元大-土城學府,2024-11-07,9822
4916,事欣科,21,1,20,元大-土城學府,2024-11-07,9822
2609,陽明,37,17,20,元大-土城學府,2024-11-07,9822
1597,直得,21,2,19,元大-土城學府,2024-11-07,9822
00688L,國泰20年美債正2,17,0,17,元大-土城學府,2024-11-07,9822
2646,星宇航空,16,0,16,元大-土城學府,2024-11-07,9822
00680L,元大美債20正2,21,6,15,元大-土城學府,2024-11-07,9822
00713,元大台灣高息低波,16,0,16,元大-土城學府,2024-11-07,9822
2890,永豐金,20,5,15,元大-土城學府,2024-11-07,9822
00945B,凱基美國非投等債,20,5,15,元大-土城學府,2024-11-07,9822
00948B,中信優息投資級債,20,5,15,元大-土城學府,2024-11-07,9822
00878,國泰永續高股息,37,22,15,元大-土城學府,2024-11-07,9822
00712,復華富時不動產,14,2,12,元大-土城學府,2024-11-07,9822
2069,運錩,12,0,12,元大-土城學府,2024-11-07,9822
2331,精英,12,0,12,元大-土城學府,2024-11-07,9822
00673R,期元大S＆P原油反1,11,0,11,元大-土城學府,2024-11-07,9822
1815,富喬,27,16,11,元大-土城學府,2024-11-07,9822
2231,為升,11,0,11,元大-土城學府,2024-11-07,9822
2543,皇昌,12,1,11,元大-土城學府,2024-11-07,9822
2363,矽統,13,2,11,元大-土城學府,2024-11-07,9822
1560,中砂,14,3,11,元大-土城學府,2024-11-07,9822
00929,復華台灣科技優息,27,17,10,元大-土城學府,2024-11-07,9822
00664R,國泰臺灣加權反1,10,0,10,元大-土城學府,2024-11-07,9822
3490,單井,10,0,10,元大-土城學府,2024-11-07,9822
8088,品安,10,0,10,元大-土城學府,2024-11-07,9822
2892,第一金,17,7,10,元大-土城學府,2024-11-07,9822
3324,雙鴻,12,3,9,元大-土城學府,2024-11-07,9822
6788,華景電,10,1,9,元大-土城學府,2024-11-07,9822
6282,康舒,11,3,8,元大-土城學府,2024-11-07,9822
2014,中鴻,15,7,8,元大-土城學府,2024-11-07,9822
2027,大成鋼,11,3,8,元大-土城學府,2024-11-07,9822
2344,華邦電,19,11,8,元大-土城學府,2024-11-07,9822
6830,汎銓,17,9,8,元大-土城學府,2024-11-07,9822
8415,大國鋼,8,0,8,元大-土城學府,2024-11-07,9822
00924,復華S＆P500成長,7,0,7,元大-土城學府,2024-11-07,9822
5907,大洋-KY,7,0,7,元大-土城學府,2024-11-07,9822
00923,群益台ESG低碳50,6,0,6,元大-土城學府,2024-11-07,9822
5871,中租-KY,7,1,6,元大-土城學府,2024-11-07,9822
6443,元晶,6,0,6,元大-土城學府,2024-11-07,9822
00632R,元大台灣50反1,320,0,320,元大-土城學府,2024-11-08,9822
2354,鴻準,336,185,151,元大-土城學府,2024-11-08,9822
00933B,國泰10Y+金融債,128,13,115,元大-土城學府,2024-11-08,9822
2890,永豐金,100,12,88,元大-土城學府,2024-11-08,9822
2356,英業達,101,29,72,元大-土城學府,2024-11-08,9822
00637L,元大滬深300正2,90,31,59,元大-土城學府,2024-11-08,9822
00945B,凱基美國非投等債,59,0,59,元大-土城學府,2024-11-08,9822
4967,十銓,62,6,56,元大-土城學府,2024-11-08,9822
4979,華星光,71,21,50,元大-土城學府,2024-11-08,9822
3062,建漢,82,42,40,元大-土城學府,2024-11-08,9822
8096,擎亞,62,23,39,元大-土城學府,2024-11-08,9822
00929,復華台灣科技優息,41,5,36,元大-土城學府,2024-11-08,9822
3013,晟銘電,33,2,31,元大-土城學府,2024-11-08,9822
00712,復華富時不動產,30,1,29,元大-土城學府,2024-11-08,9822
00679B,元大美債20年,27,0,27,元大-土城學府,2024-11-08,9822
8044,網家,34,8,26,元大-土城學府,2024-11-08,9822
2332,友訊,27,4,23,元大-土城學府,2024-11-08,9822
2368,金像電,22,0,22,元大-土城學府,2024-11-08,9822
1447,力鵬,22,0,22,元大-土城學府,2024-11-08,9822
00688L,國泰20年美債正2,30,11,19,元大-土城學府,2024-11-08,9822
2731,雄獅,22,3,19,元大-土城學府,2024-11-08,9822
6456,GIS-KY,24,6,18,元大-土城學府,2024-11-08,9822
2303,聯電,38,20,18,元大-土城學府,2024-11-08,9822
2353,宏��,21,4,17,元大-土城學府,2024-11-08,9822
2328,廣宇,27,11,16,元大-土城學府,2024-11-08,9822
2388,威盛,19,4,15,元大-土城學府,2024-11-08,9822
00900,富邦特選高股息30,15,0,15,元大-土城學府,2024-11-08,9822
00932,兆豐永續高息等權,15,0,15,元大-土城學府,2024-11-08,9822
2489,瑞軒,23,8,15,元大-土城學府,2024-11-08,9822
3481,群創,24,12,12,元大-土城學府,2024-11-08,9822
6505,台塑化,31,19,12,元大-土城學府,2024-11-08,9822
0050,元大台灣50,15,3,12,元大-土城學府,2024-11-08,9822
00919,群益台灣精選高息,12,0,12,元大-土城學府,2024-11-08,9822
2208,台船,11,0,11,元大-土城學府,2024-11-08,9822
00930,永豐ESG低碳高息,10,0,10,元大-土城學府,2024-11-08,9822
1414,東和,10,0,10,元大-土城學府,2024-11-08,9822
1815,富喬,10,0,10,元大-土城學府,2024-11-08,9822
2457,飛宏,10,0,10,元大-土城學府,2024-11-08,9822
2607,榮運,10,0,10,元大-土城學府,2024-11-08,9822
3209,全科,10,0,10,元大-土城學府,2024-11-08,9822
3432,台端,10,0,10,元大-土城學府,2024-11-08,9822
4956,光鋐,18,8,10,元大-土城學府,2024-11-08,9822
6757,台灣虎航,10,0,10,元大-土城學府,2024-11-08,9822
9905,大華,10,0,10,元大-土城學府,2024-11-08,9822
1528,恩德,16,7,9,元大-土城學府,2024-11-08,9822
00665L,富邦�琤肭磪囓�2,10,1,9,元大-土城學府,2024-11-08,9822
2606,裕民,10,1,9,元大-土城學府,2024-11-08,9822
6706,惠特,24,15,9,元大-土城學府,2024-11-08,9822
8111,立��,13,4,9,元大-土城學府,2024-11-08,9822
9933,中鼎,9,0,9,元大-土城學府,2024-11-08,9822
00878,國泰永續高股息,102,0,102,元大-土城學府,2024-11-11,9822
2609,陽明,112,51,61,元大-土城學府,2024-11-11,9822
3317,尼克森,50,1,49,元大-土城學府,2024-11-11,9822
8096,擎亞,35,2,33,元大-土城學府,2024-11-11,9822
8044,網家,31,0,31,元大-土城學府,2024-11-11,9822
3167,大量,30,0,30,元大-土城學府,2024-11-11,9822
5345,天揚,30,0,30,元大-土城學府,2024-11-11,9822
0056,元大高股息,33,3,30,元大-土城學府,2024-11-11,9822
6257,矽格,28,0,28,元大-土城學府,2024-11-11,9822
5452,佶優,26,0,26,元大-土城學府,2024-11-11,9822
1524,耿鼎,28,8,20,元大-土城學府,2024-11-11,9822
00680L,元大美債20正2,21,1,20,元大-土城學府,2024-11-11,9822
00919,群益台灣精選高息,20,1,19,元大-土城學府,2024-11-11,9822
6877,鏵友益,20,1,19,元大-土城學府,2024-11-11,9822
2354,鴻準,74,55,19,元大-土城學府,2024-11-11,9822
00932,兆豐永續高息等權,18,0,18,元大-土城學府,2024-11-11,9822
1605,華新,22,6,16,元大-土城學府,2024-11-11,9822
00637L,元大滬深300正2,17,2,15,元大-土城學府,2024-11-11,9822
1101,台泥,20,5,15,元大-土城學府,2024-11-11,9822
1229,聯華,15,0,15,元大-土城學府,2024-11-11,9822
5315,光聯,15,0,15,元大-土城學府,2024-11-11,9822
1301,台塑,18,3,15,元大-土城學府,2024-11-11,9822
2337,旺宏,16,2,14,元大-土城學府,2024-11-11,9822
8039,台虹,14,0,14,元大-土城學府,2024-11-11,9822
4958,臻鼎-KY,21,8,13,元大-土城學府,2024-11-11,9822
8936,國統,14,1,13,元大-土城學府,2024-11-11,9822
2388,威盛,15,2,13,元大-土城學府,2024-11-11,9822
006208,富邦台50,12,0,12,元大-土城學府,2024-11-11,9822
00753L,中信中國50正2,12,0,12,元大-土城學府,2024-11-11,9822
4114,健喬,12,0,12,元大-土城學府,2024-11-11,9822
8358,金居,13,1,12,元大-土城學府,2024-11-11,9822
3231,緯創,17,5,12,元大-土城學府,2024-11-11,9822
1326,台化,11,0,11,元大-土城學府,2024-11-11,9822
2801,彰銀,11,0,11,元大-土城學府,2024-11-11,9822
3380,明泰,11,0,11,元大-土城學府,2024-11-11,9822
3030,德律,13,2,11,元大-土城學府,2024-11-11,9822
00930,永豐ESG低碳高息,11,0,11,元大-土城學府,2024-11-11,9822
1444,力麗,11,1,10,元大-土城學府,2024-11-11,9822
1449,佳和,16,6,10,元大-土城學府,2024-11-11,9822
4576,大銀微系統,19,9,10,元大-土城學府,2024-11-11,9822
4919,新唐,21,11,10,元大-土城學府,2024-11-11,9822
5519,隆大,10,0,10,元大-土城學府,2024-11-11,9822
6213,聯茂,11,1,10,元大-土城學府,2024-11-11,9822
3037,欣興,12,3,9,元大-土城學府,2024-11-11,9822
00961,FT臺灣永續高息,9,0,9,元大-土城學府,2024-11-11,9822
2409,友達,9,0,9,元大-土城學府,2024-11-11,9822
4956,光鋐,19,10,9,元大-土城學府,2024-11-11,9822
1580,新麥,8,0,8,元大-土城學府,2024-11-11,9822
5474,聰泰,8,0,8,元大-土城學府,2024-11-11,9822
6706,惠特,16,8,8,元大-土城學府,2024-11-11,9822
00878,國泰永續高股息,183,0,183,元大-土城學府,2024-11-12,9822
0056,元大高股息,82,0,82,元大-土城學府,2024-11-12,9822
2609,陽明,172,103,69,元大-土城學府,2024-11-12,9822
00919,群益台灣精選高息,66,5,61,元大-土城學府,2024-11-12,9822
00929,復華台灣科技優息,75,15,60,元大-土城學府,2024-11-12,9822
3706,神達,207,160,47,元大-土城學府,2024-11-12,9822
6757,台灣虎航,43,0,43,元大-土城學府,2024-11-12,9822
3231,緯創,50,13,37,元大-土城學府,2024-11-12,9822
006208,富邦台50,33,0,33,元大-土城學府,2024-11-12,9822
3481,群創,33,5,28,元大-土城學府,2024-11-12,9822
2328,廣宇,40,13,27,元大-土城學府,2024-11-12,9822
2392,正崴,26,1,25,元大-土城學府,2024-11-12,9822
2344,華邦電,23,0,23,元大-土城學府,2024-11-12,9822
2731,雄獅,26,3,23,元大-土城學府,2024-11-12,9822
5871,中租-KY,24,2,22,元大-土城學府,2024-11-12,9822
00915,凱基優選高股息30,21,0,21,元大-土城學府,2024-11-12,9822
00891,中信關鍵半導體,20,0,20,元大-土城學府,2024-11-12,9822
00753L,中信中國50正2,20,0,20,元大-土城學府,2024-11-12,9822
2601,益航,20,0,20,元大-土城學府,2024-11-12,9822
4977,眾達-KY,23,5,18,元大-土城學府,2024-11-12,9822
6116,彩晶,17,0,17,元大-土城學府,2024-11-12,9822
3550,聯穎,16,0,16,元大-土城學府,2024-11-12,9822
00715L,期街口布蘭特正2,15,0,15,元大-土城學府,2024-11-12,9822
2388,威盛,17,2,15,元大-土城學府,2024-11-12,9822
2419,仲琦,15,0,15,元大-土城學府,2024-11-12,9822
00932,兆豐永續高息等權,14,0,14,元大-土城學府,2024-11-12,9822
2431,聯昌,20,6,14,元大-土城學府,2024-11-12,9822
6257,矽格,13,0,13,元大-土城學府,2024-11-12,9822
1314,中石化,16,4,12,元大-土城學府,2024-11-12,9822
00918,大華優利高填息30,14,2,12,元大-土城學府,2024-11-12,9822
2303,聯電,31,19,12,元大-土城學府,2024-11-12,9822
2882,國泰金,16,4,12,元大-土城學府,2024-11-12,9822
1605,華新,21,9,12,元大-土城學府,2024-11-12,9822
2455,全新,23,11,12,元大-土城學府,2024-11-12,9822
2881,富邦金,14,2,12,元大-土城學府,2024-11-12,9822
8028,昇陽半導體,15,3,12,元大-土城學府,2024-11-12,9822
2330,台積電,12,0,12,元大-土城學府,2024-11-12,9822
00905,FT臺灣Smart,12,1,11,元大-土城學府,2024-11-12,9822
1301,台塑,11,0,11,元大-土城學府,2024-11-12,9822
3317,尼克森,11,0,11,元大-土城學府,2024-11-12,9822
1326,台化,11,0,11,元大-土城學府,2024-11-12,9822
1584,精剛,11,0,11,元大-土城學府,2024-11-12,9822
8240,華宏,14,3,11,元大-土城學府,2024-11-12,9822
2356,英業達,171,160,11,元大-土城學府,2024-11-12,9822
00665L,富邦�琤肭磪囓�2,11,0,11,元大-土城學府,2024-11-12,9822
00646,元大S＆P500,11,0,11,元大-土城學府,2024-11-12,9822
2912,統一超,10,0,10,元大-土城學府,2024-11-12,9822
5483,中美晶,10,0,10,元大-土城學府,2024-11-12,9822
6213,聯茂,11,1,10,元大-土城學府,2024-11-12,9822
00946,群益科技高息成長,9,0,9,元大-土城學府,2024-11-12,9822
00878,國泰永續高股息,162,28,134,元大-土城學府,2024-11-13,9822
9945,潤泰新,102,0,102,元大-土城學府,2024-11-13,9822
3706,神達,163,62,101,元大-土城學府,2024-11-13,9822
00632R,元大台灣50反1,201,102,99,元大-土城學府,2024-11-13,9822
2618,長榮航,101,27,74,元大-土城學府,2024-11-13,9822
3481,群創,57,1,56,元大-土城學府,2024-11-13,9822
3202,樺晟,50,0,50,元大-土城學府,2024-11-13,9822
2317,鴻海,84,42,42,元大-土城學府,2024-11-13,9822
2609,陽明,72,40,32,元大-土城學府,2024-11-13,9822
4114,健喬,30,0,30,元大-土城學府,2024-11-13,9822
6288,聯嘉,34,4,30,元大-土城學府,2024-11-13,9822
00637L,元大滬深300正2,27,0,27,元大-土城學府,2024-11-13,9822
0056,元大高股息,31,8,23,元大-土城學府,2024-11-13,9822
3019,亞光,20,0,20,元大-土城學府,2024-11-13,9822
9905,大華,20,0,20,元大-土城學府,2024-11-13,9822
00919,群益台灣精選高息,22,2,20,元大-土城學府,2024-11-13,9822
3576,聯合再生,20,2,18,元大-土城學府,2024-11-13,9822
00915,凱基優選高股息30,17,0,17,元大-土城學府,2024-11-13,9822
2834,臺企銀,16,0,16,元大-土城學府,2024-11-13,9822
00665L,富邦�琤肭磪囓�2,21,6,15,元大-土城學府,2024-11-13,9822
6116,彩晶,15,0,15,元大-土城學府,2024-11-13,9822
2891,中信金,14,0,14,元大-土城學府,2024-11-13,9822
2324,仁寶,82,68,14,元大-土城學府,2024-11-13,9822
6477,安集,15,2,13,元大-土城學府,2024-11-13,9822
006208,富邦台50,13,0,13,元大-土城學府,2024-11-13,9822
00929,復華台灣科技優息,18,6,12,元大-土城學府,2024-11-13,9822
3455,由田,12,0,12,元大-土城學府,2024-11-13,9822
8096,擎亞,14,2,12,元大-土城學府,2024-11-13,9822
2731,雄獅,11,0,11,元大-土城學府,2024-11-13,9822
5880,合庫金,11,0,11,元大-土城學府,2024-11-13,9822
8150,南茂,12,1,11,元大-土城學府,2024-11-13,9822
2330,台積電,11,0,11,元大-土城學府,2024-11-13,9822
00680L,元大美債20正2,20,10,10,元大-土城學府,2024-11-13,9822
00882,中信中國高股息,10,0,10,元大-土城學府,2024-11-13,9822
00931B,統一美債20年,10,0,10,元大-土城學府,2024-11-13,9822
1314,中石化,15,5,10,元大-土城學府,2024-11-13,9822
2393,億光,10,0,10,元大-土城學府,2024-11-13,9822
4977,眾達-KY,21,11,10,元大-土城學府,2024-11-13,9822
00922,國泰台灣領袖50,12,3,9,元大-土城學府,2024-11-13,9822
2489,瑞軒,10,1,9,元大-土城學府,2024-11-13,9822
3047,訊舟,15,7,8,元大-土城學府,2024-11-13,9822
5871,中租-KY,14,6,8,元大-土城學府,2024-11-13,9822
00881,國泰台灣5G+,8,0,8,元大-土城學府,2024-11-13,9822
00937B,群益ESG投等債20,14,6,8,元大-土城學府,2024-11-13,9822
2801,彰銀,8,0,8,元大-土城學府,2024-11-13,9822
5351,鈺創,9,1,8,元大-土城學府,2024-11-13,9822
2881,富邦金,7,0,7,元大-土城學府,2024-11-13,9822
3189,景碩,11,4,7,元大-土城學府,2024-11-13,9822
2882,國泰金,7,0,7,元大-土城學府,2024-11-13,9822
2353,宏��,7,0,7,元大-土城學府,2024-11-13,9822
00878,國泰永續高股息,213,1,212,元大-土城學府,2024-11-14,9822
2610,華航,164,19,145,元大-土城學府,2024-11-14,9822
2354,鴻準,169,52,117,元大-土城學府,2024-11-14,9822
2303,聯電,107,0,107,元大-土城學府,2024-11-14,9822
2312,金寶,114,11,103,元大-土城學府,2024-11-14,9822
0056,元大高股息,62,2,60,元大-土城學府,2024-11-14,9822
00929,復華台灣科技優息,67,23,44,元大-土城學府,2024-11-14,9822
8089,康全電訊,51,10,41,元大-土城學府,2024-11-14,9822
2337,旺宏,46,8,38,元大-土城學府,2024-11-14,9822
3518,柏騰,35,1,34,元大-土城學府,2024-11-14,9822
3013,晟銘電,47,16,31,元大-土城學府,2024-11-14,9822
1301,台塑,30,1,29,元大-土城學府,2024-11-14,9822
00687B,國泰20年美債,28,0,28,元大-土城學府,2024-11-14,9822
00919,群益台灣精選高息,26,0,26,元大-土城學府,2024-11-14,9822
00679B,元大美債20年,34,10,24,元大-土城學府,2024-11-14,9822
00943,兆豐電子高息等權,23,0,23,元大-土城學府,2024-11-14,9822
1717,長興,22,0,22,元大-土城學府,2024-11-14,9822
2489,瑞軒,24,3,21,元大-土城學府,2024-11-14,9822
2356,英業達,44,23,21,元大-土城學府,2024-11-14,9822
3580,友威科,21,1,20,元大-土城學府,2024-11-14,9822
9905,大華,20,0,20,元大-土城學府,2024-11-14,9822
4931,新盛力,56,38,18,元大-土城學府,2024-11-14,9822
2382,廣達,25,7,18,元大-土城學府,2024-11-14,9822
2344,華邦電,17,0,17,元大-土城學府,2024-11-14,9822
2408,南亞科,15,0,15,元大-土城學府,2024-11-14,9822
00959B,大華投等美債15Y+,15,0,15,元大-土城學府,2024-11-14,9822
3037,欣興,21,6,15,元大-土城學府,2024-11-14,9822
3231,緯創,18,3,15,元大-土城學府,2024-11-14,9822
3015,全漢,21,7,14,元大-土城學府,2024-11-14,9822
00932,兆豐永續高息等權,14,0,14,元大-土城學府,2024-11-14,9822
3481,群創,13,0,13,元大-土城學府,2024-11-14,9822
00931B,統一美債20年,13,0,13,元大-土城學府,2024-11-14,9822
1447,力鵬,15,2,13,元大-土城學府,2024-11-14,9822
00915,凱基優選高股息30,12,0,12,元大-土城學府,2024-11-14,9822
00713,元大台灣高息低波,12,0,12,元大-土城學府,2024-11-14,9822
2603,長榮,16,4,12,元大-土城學府,2024-11-14,9822
006208,富邦台50,12,0,12,元大-土城學府,2024-11-14,9822
00922,國泰台灣領袖50,11,0,11,元大-土城學府,2024-11-14,9822
00930,永豐ESG低碳高息,11,0,11,元大-土城學府,2024-11-14,9822
2374,佳能,14,3,11,元大-土城學府,2024-11-14,9822
2498,宏達電,11,0,11,元大-土城學府,2024-11-14,9822
2884,玉山金,10,0,10,元大-土城學府,2024-11-14,9822
2455,全新,10,0,10,元大-土城學府,2024-11-14,9822
1611,中電,10,0,10,元大-土城學府,2024-11-14,9822
2419,仲琦,10,0,10,元大-土城學府,2024-11-14,9822
2883,凱基金,12,2,10,元大-土城學府,2024-11-14,9822
3447,展達,9,0,9,元大-土城學府,2024-11-14,9822
5460,同協,9,0,9,元大-土城學府,2024-11-14,9822
5880,合庫金,9,0,9,元大-土城學府,2024-11-14,9822
1303,南亞,10,2,8,元大-土城學府,2024-11-14,9822
00878,國泰永續高股息,189,1,188,元大-土城學府,2024-11-15,9822
2317,鴻海,166,63,103,元大-土城學府,2024-11-15,9822
3580,友威科,75,7,68,元大-土城學府,2024-11-15,9822
3706,神達,190,135,55,元大-土城學府,2024-11-15,9822
00637L,元大滬深300正2,60,6,54,元大-土城學府,2024-11-15,9822
2641,正德,52,0,52,元大-土城學府,2024-11-15,9822
2610,華航,58,16,42,元大-土城學府,2024-11-15,9822
8089,康全電訊,46,4,42,元大-土城學府,2024-11-15,9822
00933B,國泰10Y+金融債,40,5,35,元大-土城學府,2024-11-15,9822
00959B,大華投等美債15Y+,30,0,30,元大-土城學府,2024-11-15,9822
2049,上銀,22,0,22,元大-土城學府,2024-11-15,9822
2002,中鋼,22,1,21,元大-土城學府,2024-11-15,9822
2393,億光,20,1,19,元大-土城學府,2024-11-15,9822
6530,創威,17,0,17,元大-土城學府,2024-11-15,9822
00679B,元大美債20年,24,7,17,元大-土城學府,2024-11-15,9822
2382,廣達,37,21,16,元大-土城學府,2024-11-15,9822
00929,復華台灣科技優息,18,3,15,元大-土城學府,2024-11-15,9822
00946,群益科技高息成長,13,0,13,元大-土城學府,2024-11-15,9822
1717,長興,13,0,13,元大-土城學府,2024-11-15,9822
00950B,凱基A級公司債,12,0,12,元大-土城學府,2024-11-15,9822
2801,彰銀,11,0,11,元大-土城學府,2024-11-15,9822
2882,國泰金,11,0,11,元大-土城學府,2024-11-15,9822
00891,中信關鍵半導體,11,1,10,元大-土城學府,2024-11-15,9822
00673R,期元大S＆P原油反1,10,0,10,元大-土城學府,2024-11-15,9822
00943,兆豐電子高息等權,10,0,10,元大-土城學府,2024-11-15,9822
8047,星雲,10,0,10,元大-土城學府,2024-11-15,9822
8104,錸寶,11,1,10,元大-土城學府,2024-11-15,9822
3035,智原,10,0,10,元大-土城學府,2024-11-15,9822
006208,富邦台50,10,0,10,元大-土城學府,2024-11-15,9822
1528,恩德,9,0,9,元大-土城學府,2024-11-15,9822
5460,同協,9,0,9,元大-土城學府,2024-11-15,9822
3607,谷崧,8,0,8,元大-土城學府,2024-11-15,9822
1536,和大,7,0,7,元大-土城學府,2024-11-15,9822
2301,光寶科,8,1,7,元大-土城學府,2024-11-15,9822
6405,悅城,16,9,7,元大-土城學府,2024-11-15,9822
8070,長華*,7,0,7,元大-土城學府,2024-11-15,9822
00937B,群益ESG投等債20,7,0,7,元大-土城學府,2024-11-15,9822
0056,元大高股息,10,3,7,元大-土城學府,2024-11-15,9822
00934,中信成長高股息,7,0,7,元大-土城學府,2024-11-15,9822
1618,合機,21,15,6,元大-土城學府,2024-11-15,9822
3202,樺晟,7,1,6,元大-土城學府,2024-11-15,9822
6217,中探針,8,2,6,元大-土城學府,2024-11-15,9822
4979,華星光,8,3,5,元大-土城學府,2024-11-15,9822
1229,聯華,5,0,5,元大-土城學府,2024-11-15,9822
00915,凱基優選高股息30,9,4,5,元大-土城學府,2024-11-15,9822
00830,國泰費城半導體,5,0,5,元大-土城學府,2024-11-15,9822
00887,永豐中國科技50大,6,1,5,元大-土城學府,2024-11-15,9822
00690,兆豐藍籌30,5,0,5,元大-土城學府,2024-11-15,9822
00951,台新日本半導體,5,0,5,元大-土城學府,2024-11-15,9822
1611,中電,5,0,5,元大-土城學府,2024-11-15,9822
2888,新光金,350,69,281,元大-土城學府,2024-11-18,9822
00878,國泰永續高股息,250,8,242,元大-土城學府,2024-11-18,9822
00929,復華台灣科技優息,109,10,99,元大-土城學府,2024-11-18,9822
3706,神達,129,51,78,元大-土城學府,2024-11-18,9822
2881,富邦金,74,0,74,元大-土城學府,2024-11-18,9822
00948B,中信優息投資級債,49,0,49,元大-土城學府,2024-11-18,9822
00706L,期元大S＆P日圓正2,40,0,40,元大-土城學府,2024-11-18,9822
00708L,期元大S＆P黃金正2,36,0,36,元大-土城學府,2024-11-18,9822
8996,高力,40,4,36,元大-土城學府,2024-11-18,9822
2610,華航,38,3,35,元大-土城學府,2024-11-18,9822
0056,元大高股息,36,1,35,元大-土城學府,2024-11-18,9822
2317,鴻海,185,161,24,元大-土城學府,2024-11-18,9822
2354,鴻準,99,77,22,元大-土城學府,2024-11-18,9822
00930,永豐ESG低碳高息,21,0,21,元大-土城學府,2024-11-18,9822
00959B,大華投等美債15Y+,21,0,21,元大-土城學府,2024-11-18,9822
00679B,元大美債20年,30,10,20,元大-土城學府,2024-11-18,9822
00715L,期街口布蘭特正2,20,0,20,元大-土城學府,2024-11-18,9822
1717,長興,20,0,20,元大-土城學府,2024-11-18,9822
00934,中信成長高股息,15,0,15,元大-土城學府,2024-11-18,9822
00937B,群益ESG投等債20,15,0,15,元大-土城學府,2024-11-18,9822
2615,萬海,16,1,15,元大-土城學府,2024-11-18,9822
1442,名軒,18,4,14,元大-土城學府,2024-11-18,9822
00690,兆豐藍籌30,13,0,13,元大-土城學府,2024-11-18,9822
00891,中信關鍵半導體,12,0,12,元大-土城學府,2024-11-18,9822
006208,富邦台50,14,2,12,元大-土城學府,2024-11-18,9822
2882,國泰金,12,0,12,元大-土城學府,2024-11-18,9822
2617,台航,11,0,11,元大-土城學府,2024-11-18,9822
2834,臺企銀,12,1,11,元大-土城學府,2024-11-18,9822
3455,由田,11,0,11,元大-土城學府,2024-11-18,9822
3551,世禾,12,1,11,元大-土城學府,2024-11-18,9822
2884,玉山金,10,0,10,元大-土城學府,2024-11-18,9822
00950B,凱基A級公司債,10,0,10,元大-土城學府,2024-11-18,9822
3338,泰碩,15,5,10,元大-土城學府,2024-11-18,9822
4157,太景*-KY,10,0,10,元大-土城學府,2024-11-18,9822
6196,帆宣,10,0,10,元大-土城學府,2024-11-18,9822
8027,鈦昇,10,0,10,元大-土城學府,2024-11-18,9822
8374,羅昇,10,0,10,元大-土城學府,2024-11-18,9822
00753L,中信中國50正2,9,0,9,元大-土城學府,2024-11-18,9822
2312,金寶,122,113,9,元大-土城學府,2024-11-18,9822
00943,兆豐電子高息等權,8,0,8,元大-土城學府,2024-11-18,9822
4114,健喬,8,0,8,元大-土城學府,2024-11-18,9822
00919,群益台灣精選高息,12,4,8,元大-土城學府,2024-11-18,9822
2409,友達,6,0,6,元大-土城學府,2024-11-18,9822
00713,元大台灣高息低波,6,0,6,元大-土城學府,2024-11-18,9822
2883,凱基金,6,0,6,元大-土城學府,2024-11-18,9822
6005,群益證,6,0,6,元大-土城學府,2024-11-18,9822
6456,GIS-KY,7,1,6,元大-土城學府,2024-11-18,9822
8096,擎亞,11,5,6,元大-土城學府,2024-11-18,9822
2301,光寶科,6,0,6,元大-土城學府,2024-11-18,9822
00631L,元大台灣50正2,5,0,5,元大-土城學府,2024-11-18,9822
00637L,元大滬深300正2,97,1,96,元大-土城學府,2024-11-19,9822
00878,國泰永續高股息,58,10,48,元大-土城學府,2024-11-19,9822
9105,泰金寶-DR,66,26,40,元大-土城學府,2024-11-19,9822
00960,野村全球航運龍頭,23,0,23,元大-土城學府,2024-11-19,9822
2349,錸德,40,18,22,元大-土城學府,2024-11-19,9822
6182,合晶,22,0,22,元大-土城學府,2024-11-19,9822
3047,訊舟,24,2,22,元大-土城學府,2024-11-19,9822
2884,玉山金,19,0,19,元大-土城學府,2024-11-19,9822
5203,訊連,19,0,19,元大-土城學府,2024-11-19,9822
00930,永豐ESG低碳高息,18,0,18,元大-土城學府,2024-11-19,9822
00959B,大華投等美債15Y+,18,0,18,元大-土城學府,2024-11-19,9822
00922,國泰台灣領袖50,30,13,17,元大-土城學府,2024-11-19,9822
2344,華邦電,18,1,17,元大-土城學府,2024-11-19,9822
8096,擎亞,17,0,17,元大-土城學府,2024-11-19,9822
00950B,凱基A級公司債,16,0,16,元大-土城學府,2024-11-19,9822
00887,永豐中國科技50大,14,0,14,元大-土城學府,2024-11-19,9822
2615,萬海,20,8,12,元大-土城學府,2024-11-19,9822
2303,聯電,13,2,11,元大-土城學府,2024-11-19,9822
6505,台塑化,16,5,11,元大-土城學府,2024-11-19,9822
2317,鴻海,133,122,11,元大-土城學府,2024-11-19,9822
00943,兆豐電子高息等權,10,0,10,元大-土城學府,2024-11-19,9822
2399,映泰,11,1,10,元大-土城學府,2024-11-19,9822
4977,眾達-KY,12,2,10,元大-土城學府,2024-11-19,9822
6133,金橋,11,1,10,元大-土城學府,2024-11-19,9822
8104,錸寶,42,32,10,元大-土城學府,2024-11-19,9822
3017,奇鋐,17,7,10,元大-土城學府,2024-11-19,9822
2392,正崴,18,8,10,元大-土城學府,2024-11-19,9822
2388,威盛,10,1,9,元大-土城學府,2024-11-19,9822
6763,綠界科技*,18,9,9,元大-土城學府,2024-11-19,9822
00685L,群益臺灣加權正2,7,0,7,元大-土城學府,2024-11-19,9822
00708L,期元大S＆P黃金正2,12,5,7,元大-土城學府,2024-11-19,9822
00673R,期元大S＆P原油反1,7,0,7,元大-土城學府,2024-11-19,9822
1301,台塑,32,25,7,元大-土城學府,2024-11-19,9822
3552,同致,7,0,7,元大-土城學府,2024-11-19,9822
5309,系統電,9,2,7,元大-土城學府,2024-11-19,9822
2312,金寶,43,37,6,元大-土城學府,2024-11-19,9822
6443,元晶,6,0,6,元大-土城學府,2024-11-19,9822
00934,中信成長高股息,6,0,6,元大-土城學府,2024-11-19,9822
5347,世界,6,1,5,元大-土城學府,2024-11-19,9822
00641R,富邦日本反1,5,0,5,元大-土城學府,2024-11-19,9822
00932,兆豐永續高息等權,5,0,5,元大-土城學府,2024-11-19,9822
3024,憶聲,6,1,5,元大-土城學府,2024-11-19,9822
3499,環天科,5,0,5,元大-土城學府,2024-11-19,9822
4558,寶緯,6,1,5,元大-土城學府,2024-11-19,9822
6757,台灣虎航,5,0,5,元大-土城學府,2024-11-19,9822
00946,群益科技高息成長,6,1,5,元大-土城學府,2024-11-19,9822
3481,群創,19,15,4,元大-土城學府,2024-11-19,9822
00712,復華富時不動產,4,0,4,元大-土城學府,2024-11-19,9822
00715L,期街口布蘭特正2,5,1,4,元大-土城學府,2024-11-19,9822
2027,大成鋼,4,0,4,元大-土城學府,2024-11-19,9822
2354,鴻準,436,205,231,元大-土城學府,2024-11-20,9822
3323,加百裕,51,4,47,元大-土城學府,2024-11-20,9822
3706,神達,139,93,46,元大-土城學府,2024-11-20,9822
2303,聯電,56,17,39,元大-土城學府,2024-11-20,9822
00679B,元大美債20年,36,0,36,元大-土城學府,2024-11-20,9822
6757,台灣虎航,35,0,35,元大-土城學府,2024-11-20,9822
00680L,元大美債20正2,32,0,32,元大-土城學府,2024-11-20,9822
00919,群益台灣精選高息,69,37,32,元大-土城學府,2024-11-20,9822
2882,國泰金,30,0,30,元大-土城學府,2024-11-20,9822
00878,國泰永續高股息,43,15,28,元大-土城學府,2024-11-20,9822
00923,群益台ESG低碳50,26,0,26,元大-土城學府,2024-11-20,9822
3447,展達,37,12,25,元大-土城學府,2024-11-20,9822
2356,英業達,48,27,21,元大-土城學府,2024-11-20,9822
1102,亞泥,20,0,20,元大-土城學府,2024-11-20,9822
0056,元大高股息,20,0,20,元大-土城學府,2024-11-20,9822
5315,光聯,17,0,17,元大-土城學府,2024-11-20,9822
1301,台塑,16,1,15,元大-土城學府,2024-11-20,9822
3167,大量,14,0,14,元大-土城學府,2024-11-20,9822
2408,南亞科,12,0,12,元大-土城學府,2024-11-20,9822
6530,創威,13,1,12,元大-土城學府,2024-11-20,9822
3711,日月光投控,12,1,11,元大-土城學府,2024-11-20,9822
5347,世界,12,1,11,元大-土城學府,2024-11-20,9822
00948B,中信優息投資級債,10,0,10,元大-土城學府,2024-11-20,9822
2634,漢翔,10,0,10,元大-土城學府,2024-11-20,9822
6176,瑞儀,10,0,10,元大-土城學府,2024-11-20,9822
2542,興富發,9,0,9,元大-土城學府,2024-11-20,9822
00930,永豐ESG低碳高息,9,0,9,元大-土城學府,2024-11-20,9822
2489,瑞軒,11,2,9,元大-土城學府,2024-11-20,9822
5203,訊連,10,1,9,元大-土城學府,2024-11-20,9822
2881,富邦金,8,0,8,元大-土城學府,2024-11-20,9822
006208,富邦台50,9,2,7,元大-土城學府,2024-11-20,9822
2425,承啟,7,0,7,元大-土城學府,2024-11-20,9822
6456,GIS-KY,7,0,7,元大-土城學府,2024-11-20,9822
00631L,元大台灣50正2,6,0,6,元大-土城學府,2024-11-20,9822
3481,群創,6,0,6,元大-土城學府,2024-11-20,9822
2392,正崴,9,3,6,元大-土城學府,2024-11-20,9822
00891,中信關鍵半導體,6,0,6,元大-土城學府,2024-11-20,9822
00935,野村臺灣新科技50,6,0,6,元大-土城學府,2024-11-20,9822
1569,濱川,13,7,6,元大-土城學府,2024-11-20,9822
2495,普安,12,6,6,元大-土城學府,2024-11-20,9822
3231,緯創,6,0,6,元大-土城學府,2024-11-20,9822
00937B,群益ESG投等債20,5,0,5,元大-土城學府,2024-11-20,9822
3013,晟銘電,20,15,5,元大-土城學府,2024-11-20,9822
6863,永道-KY,5,0,5,元大-土城學府,2024-11-20,9822
3189,景碩,4,0,4,元大-土城學府,2024-11-20,9822
3044,健鼎,4,0,4,元大-土城學府,2024-11-20,9822
1449,佳和,7,3,4,元大-土城學府,2024-11-20,9822
00905,FT臺灣Smart,4,0,4,元大-土城學府,2024-11-20,9822
1714,和桐,4,0,4,元大-土城學府,2024-11-20,9822
2211,長榮鋼,4,0,4,元大-土城學府,2024-11-20,9822
2609,陽明,183,72,111,元大-土城學府,2024-11-21,9822
00878,國泰永續高股息,90,13,77,元大-土城學府,2024-11-21,9822
2349,錸德,54,13,41,元大-土城學府,2024-11-21,9822
00637L,元大滬深300正2,40,0,40,元大-土城學府,2024-11-21,9822
2890,永豐金,37,0,37,元大-土城學府,2024-11-21,9822
00919,群益台灣精選高息,32,0,32,元大-土城學府,2024-11-21,9822
3450,聯鈞,53,25,28,元大-土城學府,2024-11-21,9822
3706,神達,155,128,27,元大-土城學府,2024-11-21,9822
3013,晟銘電,38,13,25,元大-土城學府,2024-11-21,9822
0056,元大高股息,27,2,25,元大-土城學府,2024-11-21,9822
2881,富邦金,23,0,23,元大-土城學府,2024-11-21,9822
2303,聯電,42,19,23,元大-土城學府,2024-11-21,9822
5426,振發,23,2,21,元大-土城學府,2024-11-21,9822
00680L,元大美債20正2,20,0,20,元大-土城學府,2024-11-21,9822
00943,兆豐電子高息等權,20,0,20,元大-土城學府,2024-11-21,9822
1342,八貫,20,0,20,元大-土城學府,2024-11-21,9822
3003,健和興,17,0,17,元大-土城學府,2024-11-21,9822
3032,偉訓,18,1,17,元大-土城學府,2024-11-21,9822
6757,台灣虎航,16,0,16,元大-土城學府,2024-11-21,9822
2354,鴻準,319,303,16,元大-土城學府,2024-11-21,9822
2332,友訊,15,1,14,元大-土城學府,2024-11-21,9822
2317,鴻海,40,27,13,元大-土城學府,2024-11-21,9822
00687B,國泰20年美債,19,6,13,元大-土城學府,2024-11-21,9822
00948B,中信優息投資級債,12,0,12,元大-土城學府,2024-11-21,9822
9105,泰金寶-DR,39,27,12,元大-土城學府,2024-11-21,9822
8996,高力,12,1,11,元大-土城學府,2024-11-21,9822
00929,復華台灣科技優息,24,13,11,元大-土城學府,2024-11-21,9822
2891,中信金,12,2,10,元大-土城學府,2024-11-21,9822
1102,亞泥,10,0,10,元大-土城學府,2024-11-21,9822
1471,首利,9,0,9,元大-土城學府,2024-11-21,9822
2409,友達,9,0,9,元大-土城學府,2024-11-21,9822
2449,京元電子,10,1,9,元大-土城學府,2024-11-21,9822
1301,台塑,9,1,8,元大-土城學府,2024-11-21,9822
00909,國泰數位支付服務,8,0,8,元大-土城學府,2024-11-21,9822
2474,可成,10,2,8,元大-土城學府,2024-11-21,9822
00937B,群益ESG投等債20,10,2,8,元大-土城學府,2024-11-21,9822
3711,日月光投控,17,9,8,元大-土城學府,2024-11-21,9822
4558,寶緯,8,0,8,元大-土城學府,2024-11-21,9822
006208,富邦台50,8,0,8,元大-土城學府,2024-11-21,9822
0050,元大台灣50,7,0,7,元大-土城學府,2024-11-21,9822
2002,中鋼,7,0,7,元大-土城學府,2024-11-21,9822
2374,佳能,6,0,6,元大-土城學府,2024-11-21,9822
2382,廣達,5,0,5,元大-土城學府,2024-11-21,9822
00930,永豐ESG低碳高息,5,0,5,元大-土城學府,2024-11-21,9822
00850,元大臺灣ESG永續,5,0,5,元大-土城學府,2024-11-21,9822
00675L,富邦臺灣加權正2,5,0,5,元大-土城學府,2024-11-21,9822
2912,統一超,5,0,5,元大-土城學府,2024-11-21,9822
00715L,期街口布蘭特正2,5,0,5,元大-土城學府,2024-11-21,9822
1540,喬福,5,0,5,元大-土城學府,2024-11-21,9822
2413,環科,7,2,5,元大-土城學府,2024-11-21,9822
2609,陽明,213,75,138,元大-土城學府,2024-11-22,9822
00637L,元大滬深300正2,61,0,61,元大-土城學府,2024-11-22,9822
4931,新盛力,35,5,30,元大-土城學府,2024-11-22,9822
5315,光聯,31,2,29,元大-土城學府,2024-11-22,9822
00680L,元大美債20正2,22,0,22,元大-土城學府,2024-11-22,9822
00959B,大華投等美債15Y+,22,0,22,元大-土城學府,2024-11-22,9822
3706,神達,126,106,20,元大-土城學府,2024-11-22,9822
2615,萬海,20,2,18,元大-土城學府,2024-11-22,9822
00930,永豐ESG低碳高息,18,0,18,元大-土城學府,2024-11-22,9822
00878,國泰永續高股息,41,23,18,元大-土城學府,2024-11-22,9822
2356,英業達,60,44,16,元大-土城學府,2024-11-22,9822
2515,中工,15,0,15,元大-土城學府,2024-11-22,9822
3550,聯穎,18,3,15,元大-土城學府,2024-11-22,9822
6770,力積電,15,1,14,元大-土城學府,2024-11-22,9822
3056,富華新,14,0,14,元大-土城學府,2024-11-22,9822
6156,松上,14,0,14,元大-土城學府,2024-11-22,9822
1802,台玻,19,6,13,元大-土城學府,2024-11-22,9822
2354,鴻準,223,211,12,元大-土城學府,2024-11-22,9822
2324,仁寶,18,6,12,元大-土城學府,2024-11-22,9822
4977,眾達-KY,14,2,12,元大-土城學府,2024-11-22,9822
2891,中信金,12,1,11,元大-土城學府,2024-11-22,9822
2382,廣達,12,1,11,元大-土城學府,2024-11-22,9822
3211,順達,12,1,11,元大-土城學府,2024-11-22,9822
2603,長榮,11,1,10,元大-土城學府,2024-11-22,9822
00753L,中信中國50正2,10,0,10,元大-土城學府,2024-11-22,9822
00948B,中信優息投資級債,10,0,10,元大-土城學府,2024-11-22,9822
1528,恩德,11,1,10,元大-土城學府,2024-11-22,9822
2405,輔信,12,2,10,元大-土城學府,2024-11-22,9822
9921,巨大,10,0,10,元大-土城學府,2024-11-22,9822
2449,京元電子,13,3,10,元大-土城學府,2024-11-22,9822
9105,泰金寶-DR,154,145,9,元大-土城學府,2024-11-22,9822
2883,凱基金,8,0,8,元大-土城學府,2024-11-22,9822
00937B,群益ESG投等債20,8,0,8,元大-土城學府,2024-11-22,9822
2408,南亞科,8,0,8,元大-土城學府,2024-11-22,9822
3702,大聯大,8,0,8,元大-土城學府,2024-11-22,9822
3081,聯亞,9,2,7,元大-土城學府,2024-11-22,9822
00632R,元大台灣50反1,7,0,7,元大-土城學府,2024-11-22,9822
2353,宏��,7,0,7,元大-土城學府,2024-11-22,9822
2413,環科,9,2,7,元大-土城學府,2024-11-22,9822
4513,福裕,11,4,7,元大-土城學府,2024-11-22,9822
8171,天宇,6,0,6,元大-土城學府,2024-11-22,9822
00915,凱基優選高股息30,6,0,6,元大-土城學府,2024-11-22,9822
2539,櫻花建,12,6,6,元大-土城學府,2024-11-22,9822
6153,嘉聯益,6,0,6,元大-土城學府,2024-11-22,9822
3037,欣興,7,1,6,元大-土城學府,2024-11-22,9822
6530,創威,5,0,5,元大-土城學府,2024-11-22,9822
00933B,國泰10Y+金融債,5,0,5,元大-土城學府,2024-11-22,9822
00932,兆豐永續高息等權,5,0,5,元大-土城學府,2024-11-22,9822
00673R,期元大S＆P原油反1,5,0,5,元大-土城學府,2024-11-22,9822
2204,中華,19,14,5,元大-土城學府,2024-11-22,9822
3712,永崴投控,145,25,120,元大-土城學府,2024-11-25,9822
1101,台泥,103,1,102,元大-土城學府,2024-11-25,9822
00671R,富邦NASDAQ反1,95,0,95,元大-土城學府,2024-11-25,9822
9105,泰金寶-DR,162,99,63,元大-土城學府,2024-11-25,9822
2618,長榮航,73,21,52,元大-土城學府,2024-11-25,9822
6269,台郡,28,0,28,元大-土城學府,2024-11-25,9822
4931,新盛力,30,4,26,元大-土城學府,2024-11-25,9822
2371,大同,53,30,23,元大-土城學府,2024-11-25,9822
912000,晨訊科-DR,20,0,20,元大-土城學府,2024-11-25,9822
1809,中釉,17,0,17,元大-土城學府,2024-11-25,9822
2356,英業達,33,16,17,元大-土城學府,2024-11-25,9822
8201,無敵,16,0,16,元大-土城學府,2024-11-25,9822
2609,陽明,74,59,15,元大-土城學府,2024-11-25,9822
3715,定穎投控,15,1,14,元大-土城學府,2024-11-25,9822
6127,九豪,15,1,14,元大-土城學府,2024-11-25,9822
3481,群創,16,3,13,元大-土城學府,2024-11-25,9822
2431,聯昌,14,2,12,元大-土城學府,2024-11-25,9822
1815,富喬,36,24,12,元大-土城學府,2024-11-25,9822
2344,華邦電,14,3,11,元大-土城學府,2024-11-25,9822
3013,晟銘電,24,13,11,元大-土城學府,2024-11-25,9822
3338,泰碩,11,0,11,元大-土城學府,2024-11-25,9822
00688L,國泰20年美債正2,10,0,10,元大-土城學府,2024-11-25,9822
00687B,國泰20年美債,10,0,10,元大-土城學府,2024-11-25,9822
2891,中信金,22,12,10,元大-土城學府,2024-11-25,9822
6163,華電網,10,0,10,元大-土城學府,2024-11-25,9822
3211,順達,11,2,9,元大-土城學府,2024-11-25,9822
00901,永豐智能車供應鏈,9,0,9,元大-土城學府,2024-11-25,9822
2312,金寶,109,101,8,元大-土城學府,2024-11-25,9822
00887,永豐中國科技50大,9,1,8,元大-土城學府,2024-11-25,9822
5243,乙盛-KY,14,6,8,元大-土城學府,2024-11-25,9822
00631L,元大台灣50正2,9,1,8,元大-土城學府,2024-11-25,9822
2615,萬海,8,1,7,元大-土城學府,2024-11-25,9822
2834,臺企銀,7,0,7,元大-土城學府,2024-11-25,9822
5236,凌陽創新,6,0,6,元大-土城學府,2024-11-25,9822
8299,群聯,9,3,6,元大-土城學府,2024-11-25,9822
00940,元大台灣價值高息,12,6,6,元大-土城學府,2024-11-25,9822
00922,國泰台灣領袖50,5,0,5,元大-土城學府,2024-11-25,9822
1714,和桐,5,0,5,元大-土城學府,2024-11-25,9822
1776,展宇,5,0,5,元大-土城學府,2024-11-25,9822
1802,台玻,8,3,5,元大-土城學府,2024-11-25,9822
2520,冠德,5,0,5,元大-土城學府,2024-11-25,9822
3062,建漢,8,3,5,元大-土城學府,2024-11-25,9822
5314,世紀,5,0,5,元大-土城學府,2024-11-25,9822
5876,上海商銀,5,0,5,元大-土城學府,2024-11-25,9822
6770,力積電,136,132,4,元大-土城學府,2024-11-25,9822
00679B,元大美債20年,10,6,4,元大-土城學府,2024-11-25,9822
00953B,群益優選非投等債,4,0,4,元大-土城學府,2024-11-25,9822
1591,駿吉-KY,6,2,4,元大-土城學府,2024-11-25,9822
2539,櫻花建,4,0,4,元大-土城學府,2024-11-25,9822
5483,中美晶,4,0,4,元大-土城學府,2024-11-25,9822
2317,鴻海,108,12,96,元大-土城學府,2024-11-26,9822
3712,永崴投控,88,7,81,元大-土城學府,2024-11-26,9822
8374,羅昇,129,62,67,元大-土城學府,2024-11-26,9822
2367,燿華,62,4,58,元大-土城學府,2024-11-26,9822
00930,永豐ESG低碳高息,46,0,46,元大-土城學府,2024-11-26,9822
2547,日勝生,138,103,35,元大-土城學府,2024-11-26,9822
3231,緯創,39,6,33,元大-土城學府,2024-11-26,9822
00878,國泰永續高股息,33,0,33,元大-土城學府,2024-11-26,9822
00923,群益台ESG低碳50,33,0,33,元大-土城學府,2024-11-26,9822
4931,新盛力,32,5,27,元大-土城學府,2024-11-26,9822
2312,金寶,63,38,25,元大-土城學府,2024-11-26,9822
6558,興能高,36,11,25,元大-土城學府,2024-11-26,9822
00929,復華台灣科技優息,26,2,24,元大-土城學府,2024-11-26,9822
00943,兆豐電子高息等權,22,0,22,元大-土城學府,2024-11-26,9822
1102,亞泥,20,0,20,元大-土城學府,2024-11-26,9822
912000,晨訊科-DR,20,0,20,元大-土城學府,2024-11-26,9822
4979,華星光,28,9,19,元大-土城學府,2024-11-26,9822
2615,萬海,18,0,18,元大-土城學府,2024-11-26,9822
3017,奇鋐,23,7,16,元大-土城學府,2024-11-26,9822
3167,大量,17,1,16,元大-土城學府,2024-11-26,9822
2419,仲琦,26,10,16,元大-土城學府,2024-11-26,9822
3149,正達,18,2,16,元大-土城學府,2024-11-26,9822
006208,富邦台50,16,0,16,元大-土城學府,2024-11-26,9822
00932,兆豐永續高息等權,15,0,15,元大-土城學府,2024-11-26,9822
8171,天宇,19,4,15,元大-土城學府,2024-11-26,9822
4956,光鋐,18,4,14,元大-土城學府,2024-11-26,9822
1466,聚隆,13,0,13,元大-土城學府,2024-11-26,9822
2324,仁寶,21,8,13,元大-土城學府,2024-11-26,9822
2344,華邦電,16,3,13,元大-土城學府,2024-11-26,9822
00919,群益台灣精選高息,16,4,12,元大-土城學府,2024-11-26,9822
1614,三洋電,12,0,12,元大-土城學府,2024-11-26,9822
2371,大同,17,6,11,元大-土城學府,2024-11-26,9822
3380,明泰,13,2,11,元大-土城學府,2024-11-26,9822
9914,美利達,11,0,11,元大-土城學府,2024-11-26,9822
1301,台塑,35,25,10,元大-土城學府,2024-11-26,9822
3481,群創,10,0,10,元大-土城學府,2024-11-26,9822
2609,陽明,43,33,10,元大-土城學府,2024-11-26,9822
00882,中信中國高股息,10,0,10,元大-土城學府,2024-11-26,9822
4739,康普,10,0,10,元大-土城學府,2024-11-26,9822
5465,富驊,17,7,10,元大-土城學府,2024-11-26,9822
2883,凱基金,9,0,9,元大-土城學府,2024-11-26,9822
5309,系統電,40,31,9,元大-土城學府,2024-11-26,9822
6443,元晶,10,1,9,元大-土城學府,2024-11-26,9822
00937B,群益ESG投等債20,10,2,8,元大-土城學府,2024-11-26,9822
2070,精湛,8,0,8,元大-土城學府,2024-11-26,9822
00881,國泰台灣5G+,7,0,7,元大-土城學府,2024-11-26,9822
2330,台積電,8,1,7,元大-土城學府,2024-11-26,9822
00715L,期街口布蘭特正2,7,0,7,元大-土城學府,2024-11-26,9822
8104,錸寶,18,12,6,元大-土城學府,2024-11-26,9822
3597,映興,7,1,6,元大-土城學府,2024-11-26,9822
00878,國泰永續高股息,117,3,114,元大-土城學府,2024-11-27,9822
00919,群益台灣精選高息,119,7,112,元大-土城學府,2024-11-27,9822
3712,永崴投控,100,1,99,元大-土城學府,2024-11-27,9822
0056,元大高股息,104,10,94,元大-土城學府,2024-11-27,9822
00940,元大台灣價值高息,125,56,69,元大-土城學府,2024-11-27,9822
2426,鼎元,62,2,60,元大-土城學府,2024-11-27,9822
2354,鴻準,57,8,49,元大-土城學府,2024-11-27,9822
1536,和大,54,8,46,元大-土城學府,2024-11-27,9822
8374,羅昇,138,93,45,元大-土城學府,2024-11-27,9822
2929,淘帝-KY,40,0,40,元大-土城學府,2024-11-27,9822
2317,鴻海,51,12,39,元大-土城學府,2024-11-27,9822
2356,英業達,40,5,35,元大-土城學府,2024-11-27,9822
3211,順達,32,1,31,元大-土城學府,2024-11-27,9822
1102,亞泥,30,0,30,元大-土城學府,2024-11-27,9822
3231,緯創,68,39,29,元大-土城學府,2024-11-27,9822
4931,新盛力,30,2,28,元大-土城學府,2024-11-27,9822
4167,松瑞藥,28,0,28,元大-土城學府,2024-11-27,9822
00930,永豐ESG低碳高息,30,3,27,元大-土城學府,2024-11-27,9822
2883,凱基金,28,1,27,元大-土城學府,2024-11-27,9822
2605,新興,27,0,27,元大-土城學府,2024-11-27,9822
00929,復華台灣科技優息,29,3,26,元大-土城學府,2024-11-27,9822
3037,欣興,29,6,23,元大-土城學府,2024-11-27,9822
00923,群益台ESG低碳50,22,0,22,元大-土城學府,2024-11-27,9822
00943,兆豐電子高息等權,22,0,22,元大-土城學府,2024-11-27,9822
2607,榮運,20,0,20,元大-土城學府,2024-11-27,9822
2344,華邦電,42,24,18,元大-土城學府,2024-11-27,9822
2002,中鋼,19,1,18,元大-土城學府,2024-11-27,9822
4526,東台,34,18,16,元大-土城學府,2024-11-27,9822
00708L,期元大S＆P黃金正2,15,0,15,元大-土城學府,2024-11-27,9822
2399,映泰,15,1,14,元大-土城學府,2024-11-27,9822
3189,景碩,15,1,14,元大-土城學府,2024-11-27,9822
3013,晟銘電,14,1,13,元大-土城學府,2024-11-27,9822
8104,錸寶,23,10,13,元大-土城學府,2024-11-27,9822
1815,富喬,30,18,12,元大-土城學府,2024-11-27,9822
2392,正崴,30,18,12,元大-土城學府,2024-11-27,9822
1714,和桐,11,0,11,元大-土城學府,2024-11-27,9822
2330,台積電,11,0,11,元大-土城學府,2024-11-27,9822
1447,力鵬,10,0,10,元大-土城學府,2024-11-27,9822
3325,旭品,10,0,10,元大-土城學府,2024-11-27,9822
8027,鈦昇,9,0,9,元大-土城學府,2024-11-27,9822
2419,仲琦,10,1,9,元大-土城學府,2024-11-27,9822
00881,國泰台灣5G+,8,0,8,元大-土城學府,2024-11-27,9822
00637L,元大滬深300正2,8,0,8,元大-土城學府,2024-11-27,9822
3450,聯鈞,35,27,8,元大-土城學府,2024-11-27,9822
0050,元大台灣50,9,2,7,元大-土城學府,2024-11-27,9822
2881,富邦金,7,0,7,元大-土城學府,2024-11-27,9822
6257,矽格,7,0,7,元大-土城學府,2024-11-27,9822
3230,錦明,20,13,7,元大-土城學府,2024-11-27,9822
4562,穎漢,24,17,7,元大-土城學府,2024-11-27,9822
8163,達方,20,13,7,元大-土城學府,2024-11-27,9822
00878,國泰永續高股息,179,9,170,元大-土城學府,2024-11-28,9822
00919,群益台灣精選高息,155,14,141,元大-土城學府,2024-11-28,9822
3706,神達,357,235,122,元大-土城學府,2024-11-28,9822
2312,金寶,173,88,85,元大-土城學府,2024-11-28,9822
00940,元大台灣價值高息,87,16,71,元大-土城學府,2024-11-28,9822
2392,正崴,83,15,68,元大-土城學府,2024-11-28,9822
6770,力積電,149,90,59,元大-土城學府,2024-11-28,9822
00929,復華台灣科技優息,63,19,44,元大-土城學府,2024-11-28,9822
2332,友訊,50,11,39,元大-土城學府,2024-11-28,9822
0056,元大高股息,45,11,34,元大-土城學府,2024-11-28,9822
4931,新盛力,30,1,29,元大-土城學府,2024-11-28,9822
1102,亞泥,23,0,23,元大-土城學府,2024-11-28,9822
4510,高鋒,68,47,21,元大-土城學府,2024-11-28,9822
4991,環宇-KY,30,10,20,元大-土城學府,2024-11-28,9822
00918,大華優利高填息30,19,0,19,元大-土城學府,2024-11-28,9822
3043,科風,17,0,17,元大-土城學府,2024-11-28,9822
2419,仲琦,21,4,17,元大-土城學府,2024-11-28,9822
00930,永豐ESG低碳高息,16,0,16,元大-土城學府,2024-11-28,9822
00932,兆豐永續高息等權,14,0,14,元大-土城學府,2024-11-28,9822
1714,和桐,13,0,13,元大-土城學府,2024-11-28,9822
0050,元大台灣50,12,1,11,元大-土城學府,2024-11-28,9822
2881,富邦金,11,0,11,元大-土城學府,2024-11-28,9822
8163,達方,16,5,11,元大-土城學府,2024-11-28,9822
3211,順達,13,2,11,元大-土城學府,2024-11-28,9822
00739,元大MSCI A股,10,0,10,元大-土城學府,2024-11-28,9822
00950B,凱基A級公司債,10,0,10,元大-土城學府,2024-11-28,9822
6182,合晶,10,0,10,元大-土城學府,2024-11-28,9822
00946,群益科技高息成長,10,0,10,元大-土城學府,2024-11-28,9822
2609,陽明,38,28,10,元大-土城學府,2024-11-28,9822
2344,華邦電,11,2,9,元大-土城學府,2024-11-28,9822
3189,景碩,10,1,9,元大-土城學府,2024-11-28,9822
3591,艾笛森,10,1,9,元大-土城學府,2024-11-28,9822
1815,富喬,82,73,9,元大-土城學府,2024-11-28,9822
00795B,中信美國公債20年,8,0,8,元大-土城學府,2024-11-28,9822
00706L,期元大S＆P日圓正2,8,0,8,元大-土城學府,2024-11-28,9822
2329,華泰,8,0,8,元大-土城學府,2024-11-28,9822
00713,元大台灣高息低波,8,0,8,元大-土城學府,2024-11-28,9822
00934,中信成長高股息,9,2,7,元大-土城學府,2024-11-28,9822
00830,國泰費城半導體,7,0,7,元大-土城學府,2024-11-28,9822
2233,宇隆,7,0,7,元大-土城學府,2024-11-28,9822
2330,台積電,8,1,7,元大-土城學府,2024-11-28,9822
2615,萬海,9,2,7,元大-土城學府,2024-11-28,9822
2383,台光電,8,3,5,元大-土城學府,2024-11-28,9822
1447,力鵬,5,0,5,元大-土城學府,2024-11-28,9822
6016,康和證,5,0,5,元大-土城學府,2024-11-28,9822
6133,金橋,5,0,5,元大-土城學府,2024-11-28,9822
8171,天宇,10,5,5,元大-土城學府,2024-11-28,9822
9921,巨大,5,0,5,元大-土城學府,2024-11-28,9822
00915,凱基優選高股息30,4,0,4,元大-土城學府,2024-11-28,9822
3037,欣興,4,0,4,元大-土城學府,2024-11-28,9822
3706,神達,357,320,37,元大-土城學府,2024-11-29,9822
8358,金居,36,0,36,元大-土城學府,2024-11-29,9822
5353,台林,31,2,29,元大-土城學府,2024-11-29,9822
4931,新盛力,29,2,27,元大-土城學府,2024-11-29,9822
2317,鴻海,59,33,26,元大-土城學府,2024-11-29,9822
00959B,大華投等美債15Y+,24,0,24,元大-土城學府,2024-11-29,9822
00934,中信成長高股息,25,1,24,元大-土城學府,2024-11-29,9822
0056,元大高股息,25,2,23,元大-土城學府,2024-11-29,9822
2615,萬海,24,4,20,元大-土城學府,2024-11-29,9822
00700,富邦�琤肭磪�,20,0,20,元大-土城學府,2024-11-29,9822
00636,國泰中國A50,20,0,20,元大-土城學府,2024-11-29,9822
00878,國泰永續高股息,36,17,19,元大-土城學府,2024-11-29,9822
00902,中信電池及儲能,19,0,19,元大-土城學府,2024-11-29,9822
2312,金寶,38,19,19,元大-土城學府,2024-11-29,9822
2887,台新金,17,0,17,元大-土城學府,2024-11-29,9822
00919,群益台灣精選高息,27,11,16,元大-土城學府,2024-11-29,9822
6788,華景電,17,1,16,元大-土城學府,2024-11-29,9822
2881,富邦金,13,0,13,元大-土城學府,2024-11-29,9822
3167,大量,13,0,13,元大-土城學府,2024-11-29,9822
1301,台塑,16,3,13,元大-土城學府,2024-11-29,9822
6530,創威,12,0,12,元大-土城學府,2024-11-29,9822
3037,欣興,12,1,11,元大-土城學府,2024-11-29,9822
00637L,元大滬深300正2,16,6,10,元大-土城學府,2024-11-29,9822
00891,中信關鍵半導體,10,0,10,元大-土城學府,2024-11-29,9822
1609,大亞,10,0,10,元大-土城學府,2024-11-29,9822
3030,德律,11,1,10,元大-土城學府,2024-11-29,9822
2646,星宇航空,11,2,9,元大-土城學府,2024-11-29,9822
1605,華新,8,0,8,元大-土城學府,2024-11-29,9822
00905,FT臺灣Smart,8,0,8,元大-土城學府,2024-11-29,9822
2002,中鋼,8,0,8,元大-土城學府,2024-11-29,9822
2809,京城銀,8,0,8,元大-土城學府,2024-11-29,9822
5309,系統電,10,2,8,元大-土城學府,2024-11-29,9822
6505,台塑化,14,7,7,元大-土城學府,2024-11-29,9822
006208,富邦台50,7,0,7,元大-土城學府,2024-11-29,9822
2891,中信金,7,0,7,元大-土城學府,2024-11-29,9822
00688L,國泰20年美債正2,10,3,7,元大-土城學府,2024-11-29,9822
00943,兆豐電子高息等權,7,0,7,元大-土城學府,2024-11-29,9822
2431,聯昌,7,0,7,元大-土城學府,2024-11-29,9822
6116,彩晶,7,0,7,元大-土城學府,2024-11-29,9822
8104,錸寶,10,3,7,元大-土城學府,2024-11-29,9822
2303,聯電,15,8,7,元大-土城學府,2024-11-29,9822
2883,凱基金,12,6,6,元大-土城學府,2024-11-29,9822
00946,群益科技高息成長,6,0,6,元大-土城學府,2024-11-29,9822
0050,元大台灣50,6,0,6,元大-土城學府,2024-11-29,9822
00795B,中信美國公債20年,5,0,5,元大-土城學府,2024-11-29,9822
00708L,期元大S＆P黃金正2,5,0,5,元大-土城學府,2024-11-29,9822
00715L,期街口布蘭特正2,5,0,5,元大-土城學府,2024-11-29,9822
00953B,群益優選非投等債,5,0,5,元大-土城學府,2024-11-29,9822
2337,旺宏,8,3,5,元大-土城學府,2024-11-29,9822
2375,凱美,5,0,5,元大-土城學府,2024-11-29,9822
9105,泰金寶-DR,937,10,927,元大-土城學府,2024-12-02,9822
2312,金寶,75,45,30,元大-土城學府,2024-12-02,9822
2354,鴻準,39,12,27,元大-土城學府,2024-12-02,9822
00929,復華台灣科技優息,36,9,27,元大-土城學府,2024-12-02,9822
6472,保瑞,22,1,21,元大-土城學府,2024-12-02,9822
3211,順達,35,15,20,元大-土城學府,2024-12-02,9822
3013,晟銘電,22,2,20,元大-土城學府,2024-12-02,9822
00959B,大華投等美債15Y+,20,0,20,元大-土城學府,2024-12-02,9822
4123,晟德,20,0,20,元大-土城學府,2024-12-02,9822
2489,瑞軒,19,0,19,元大-土城學府,2024-12-02,9822
5309,系統電,72,53,19,元大-土城學府,2024-12-02,9822
1536,和大,38,22,16,元大-土城學府,2024-12-02,9822
3025,星通,21,5,16,元大-土城學府,2024-12-02,9822
2392,正崴,20,6,14,元大-土城學府,2024-12-02,9822
6274,台燿,26,12,14,元大-土城學府,2024-12-02,9822
4931,新盛力,16,3,13,元大-土城學府,2024-12-02,9822
00918,大華優利高填息30,13,0,13,元大-土城學府,2024-12-02,9822
6781,AES-KY,15,2,13,元大-土城學府,2024-12-02,9822
8171,天宇,15,2,13,元大-土城學府,2024-12-02,9822
8374,羅昇,26,14,12,元大-土城學府,2024-12-02,9822
2317,鴻海,16,4,12,元大-土城學府,2024-12-02,9822
2328,廣宇,11,0,11,元大-土城學府,2024-12-02,9822
00953B,群益優選非投等債,10,0,10,元大-土城學府,2024-12-02,9822
3564,其陽,10,0,10,元大-土城學府,2024-12-02,9822
6962,ITH-KY,10,0,10,元大-土城學府,2024-12-02,9822
912000,晨訊科-DR,10,0,10,元大-土城學府,2024-12-02,9822
0056,元大高股息,16,6,10,元大-土城學府,2024-12-02,9822
00935,野村臺灣新科技50,10,1,9,元大-土城學府,2024-12-02,9822
3450,聯鈞,28,19,9,元大-土城學府,2024-12-02,9822
00713,元大台灣高息低波,10,1,9,元大-土城學府,2024-12-02,9822
00632R,元大台灣50反1,19,10,9,元大-土城學府,2024-12-02,9822
1231,聯華食,9,0,9,元大-土城學府,2024-12-02,9822
1815,富喬,27,18,9,元大-土城學府,2024-12-02,9822
3323,加百裕,71,62,9,元大-土城學府,2024-12-02,9822
00878,國泰永續高股息,25,16,9,元大-土城學府,2024-12-02,9822
8034,榮群,8,0,8,元大-土城學府,2024-12-02,9822
3037,欣興,7,0,7,元大-土城學府,2024-12-02,9822
1714,和桐,7,0,7,元大-土城學府,2024-12-02,9822
2408,南亞科,10,3,7,元大-土城學府,2024-12-02,9822
6191,精成科,6,0,6,元大-土城學府,2024-12-02,9822
8028,昇陽半導體,7,1,6,元大-土城學府,2024-12-02,9822
8431,匯鑽科,6,0,6,元大-土城學府,2024-12-02,9822
3706,神達,340,335,5,元大-土城學府,2024-12-02,9822
1522,堤維西,5,0,5,元大-土城學府,2024-12-02,9822
2607,榮運,5,0,5,元大-土城學府,2024-12-02,9822
3324,雙鴻,6,1,5,元大-土城學府,2024-12-02,9822
00631L,元大台灣50正2,6,1,5,元大-土城學府,2024-12-02,9822
00646,元大S＆P500,6,2,4,元大-土城學府,2024-12-02,9822
00712,復華富時不動產,4,0,4,元大-土城學府,2024-12-02,9822
3709,鑫聯大投控,4,0,4,元大-土城學府,2024-12-02,9822
2897,王道銀行,200,0,200,元大-土城學府,2024-12-03,9822
00632R,元大台灣50反1,162,8,154,元大-土城學府,2024-12-03,9822
00923,群益台ESG低碳50,104,5,99,元大-土城學府,2024-12-03,9822
00918,大華優利高填息30,73,2,71,元大-土城學府,2024-12-03,9822
1524,耿鼎,70,5,65,元大-土城學府,2024-12-03,9822
00919,群益台灣精選高息,65,15,50,元大-土城學府,2024-12-03,9822
00891,中信關鍵半導體,37,1,36,元大-土城學府,2024-12-03,9822
00688L,國泰20年美債正2,20,0,20,元大-土城學府,2024-12-03,9822
2354,鴻準,24,5,19,元大-土城學府,2024-12-03,9822
2317,鴻海,44,26,18,元大-土城學府,2024-12-03,9822
3005,神基,17,0,17,元大-土城學府,2024-12-03,9822
00915,凱基優選高股息30,17,1,16,元大-土城學府,2024-12-03,9822
2455,全新,26,11,15,元大-土城學府,2024-12-03,9822
2324,仁寶,20,5,15,元大-土城學府,2024-12-03,9822
2303,聯電,18,3,15,元大-土城學府,2024-12-03,9822
00687B,國泰20年美債,17,3,14,元大-土城學府,2024-12-03,9822
3090,日電貿,18,4,14,元大-土城學府,2024-12-03,9822
6288,聯嘉,14,0,14,元大-土城學府,2024-12-03,9822
6715,嘉基,14,0,14,元大-土城學府,2024-12-03,9822
6505,台塑化,13,0,13,元大-土城學府,2024-12-03,9822
6770,力積電,11,0,11,元大-土城學府,2024-12-03,9822
00712,復華富時不動產,21,10,11,元大-土城學府,2024-12-03,9822
2834,臺企銀,11,0,11,元大-土城學府,2024-12-03,9822
2375,凱美,14,4,10,元大-土城學府,2024-12-03,9822
4927,泰鼎-KY,10,0,10,元大-土城學府,2024-12-03,9822
6443,元晶,10,0,10,元大-土城學府,2024-12-03,9822
912000,晨訊科-DR,10,0,10,元大-土城學府,2024-12-03,9822
2002,中鋼,8,0,8,元大-土城學府,2024-12-03,9822
2887,台新金,10,2,8,元大-土城學府,2024-12-03,9822
00713,元大台灣高息低波,9,1,8,元大-土城學府,2024-12-03,9822
00685L,群益臺灣加權正2,7,0,7,元大-土城學府,2024-12-03,9822
00631L,元大台灣50正2,7,0,7,元大-土城學府,2024-12-03,9822
2312,金寶,17,10,7,元大-土城學府,2024-12-03,9822
2337,旺宏,11,4,7,元大-土城學府,2024-12-03,9822
5371,中光電,18,13,5,元大-土城學府,2024-12-03,9822
6472,保瑞,6,1,5,元大-土城學府,2024-12-03,9822
1609,大亞,10,5,5,元大-土城學府,2024-12-03,9822
2344,華邦電,5,0,5,元大-土城學府,2024-12-03,9822
2353,宏��,6,1,5,元大-土城學府,2024-12-03,9822
2382,廣達,6,1,5,元大-土城學府,2024-12-03,9822
3045,台灣大,5,0,5,元大-土城學府,2024-12-03,9822
4114,健喬,5,0,5,元大-土城學府,2024-12-03,9822
6418,詠昇,5,0,5,元大-土城學府,2024-12-03,9822
2539,櫻花建,4,0,4,元大-土城學府,2024-12-03,9822
4714,永捷,15,11,4,元大-土城學府,2024-12-03,9822
6781,AES-KY,6,2,4,元大-土城學府,2024-12-03,9822
00757,統一FANG+,4,0,4,元大-土城學府,2024-12-03,9822
1402,遠東新,5,1,4,元大-土城學府,2024-12-03,9822
2023,燁輝,4,0,4,元大-土城學府,2024-12-03,9822
6197,佳必琪,5,1,4,元大-土城學府,2024-12-03,9822
3706,神達,269,114,155,元大-土城學府,2024-12-04,9822
00946,群益科技高息成長,100,0,100,元大-土城學府,2024-12-04,9822
5880,合庫金,99,0,99,元大-土城學府,2024-12-04,9822
2887,台新金,95,0,95,元大-土城學府,2024-12-04,9822
4931,新盛力,96,28,68,元大-土城學府,2024-12-04,9822
00918,大華優利高填息30,54,0,54,元大-土城學府,2024-12-04,9822
1301,台塑,35,3,32,元大-土城學府,2024-12-04,9822
2303,聯電,35,4,31,元大-土城學府,2024-12-04,9822
00959B,大華投等美債15Y+,30,0,30,元大-土城學府,2024-12-04,9822
2312,金寶,34,4,30,元大-土城學府,2024-12-04,9822
2344,華邦電,29,2,27,元大-土城學府,2024-12-04,9822
9105,泰金寶-DR,71,48,23,元大-土城學府,2024-12-04,9822
2610,華航,41,20,21,元大-土城學府,2024-12-04,9822
1102,亞泥,20,0,20,元大-土城學府,2024-12-04,9822
2929,淘帝-KY,20,0,20,元大-土城學府,2024-12-04,9822
4979,華星光,61,42,19,元大-土城學府,2024-12-04,9822
3605,宏致,19,1,18,元大-土城學府,2024-12-04,9822
3043,科風,19,4,15,元大-土城學府,2024-12-04,9822
00926,凱基全球菁英55,11,0,11,元大-土城學府,2024-12-04,9822
2231,為升,11,0,11,元大-土城學府,2024-12-04,9822
5324,士開,11,0,11,元大-土城學府,2024-12-04,9822
6451,訊芯-KY,11,0,11,元大-土城學府,2024-12-04,9822
4714,永捷,10,0,10,元大-土城學府,2024-12-04,9822
00953B,群益優選非投等債,10,0,10,元大-土城學府,2024-12-04,9822
2852,第一保,10,0,10,元大-土城學府,2024-12-04,9822
00712,復華富時不動產,9,0,9,元大-土城學府,2024-12-04,9822
1312,國喬,10,1,9,元大-土城學府,2024-12-04,9822
1447,力鵬,9,0,9,元大-土城學府,2024-12-04,9822
4977,眾達-KY,14,5,9,元大-土城學府,2024-12-04,9822
8096,擎亞,26,18,8,元大-土城學府,2024-12-04,9822
2408,南亞科,14,7,7,元大-土城學府,2024-12-04,9822
00646,元大S＆P500,7,0,7,元大-土城學府,2024-12-04,9822
4123,晟德,6,0,6,元大-土城學府,2024-12-04,9822
00724B,群益投資級金融債,6,0,6,元大-土城學府,2024-12-04,9822
00948B,中信優息投資級債,6,0,6,元大-土城學府,2024-12-04,9822
3035,智原,10,4,6,元大-土城學府,2024-12-04,9822
00680L,元大美債20正2,6,1,5,元大-土城學府,2024-12-04,9822
0056,元大高股息,11,5,6,元大-土城學府,2024-12-04,9822
00915,凱基優選高股息30,5,0,5,元大-土城學府,2024-12-04,9822
1569,濱川,5,0,5,元大-土城學府,2024-12-04,9822
1605,華新,7,2,5,元大-土城學府,2024-12-04,9822
3312,弘憶股,5,0,5,元大-土城學府,2024-12-04,9822
6899,創為精密,5,0,5,元大-土城學府,2024-12-04,9822
5347,世界,7,2,5,元大-土城學府,2024-12-04,9822
6720,久昌,4,0,4,元大-土城學府,2024-12-04,9822
3376,新日興,11,6,5,元大-土城學府,2024-12-04,9822
2543,皇昌,4,0,4,元大-土城學府,2024-12-04,9822
6488,環球晶,4,0,4,元大-土城學府,2024-12-04,9822
00673R,期元大S＆P原油反1,4,0,4,元大-土城學府,2024-12-04,9822
00751B,元大AAA至A公司債,4,0,4,元大-土城學府,2024-12-04,9822
1815,富喬,202,48,154,元大-土城學府,2024-12-05,9822
00923,群益台ESG低碳50,132,0,132,元大-土城學府,2024-12-05,9822
00664R,國泰臺灣加權反1,100,0,100,元大-土城學府,2024-12-05,9822
2929,淘帝-KY,82,0,82,元大-土城學府,2024-12-05,9822
4931,新盛力,99,17,82,元大-土城學府,2024-12-05,9822
4977,眾達-KY,78,34,44,元大-土城學府,2024-12-05,9822
5315,光聯,39,0,39,元大-土城學府,2024-12-05,9822
00918,大華優利高填息30,35,0,35,元大-土城學府,2024-12-05,9822
3705,永信,35,0,35,元大-土城學府,2024-12-05,9822
00919,群益台灣精選高息,56,24,32,元大-土城學府,2024-12-05,9822
00878,國泰永續高股息,30,2,28,元大-土城學府,2024-12-05,9822
3015,全漢,31,3,28,元大-土城學府,2024-12-05,9822
1301,台塑,30,6,24,元大-土城學府,2024-12-05,9822
2317,鴻海,29,5,24,元大-土城學府,2024-12-05,9822
3323,加百裕,42,24,18,元大-土城學府,2024-12-05,9822
00715L,期街口布蘭特正2,16,0,16,元大-土城學府,2024-12-05,9822
3090,日電貿,40,24,16,元大-土城學府,2024-12-05,9822
3211,順達,35,20,15,元大-土城學府,2024-12-05,9822
2812,台中銀,15,0,15,元大-土城學府,2024-12-05,9822
4714,永捷,15,0,15,元大-土城學府,2024-12-05,9822
2371,大同,20,7,13,元大-土城學府,2024-12-05,9822
00915,凱基優選高股息30,13,0,13,元大-土城學府,2024-12-05,9822
6558,興能高,24,12,12,元大-土城學府,2024-12-05,9822
6715,嘉基,13,1,12,元大-土城學府,2024-12-05,9822
8042,金山電,19,7,12,元大-土城學府,2024-12-05,9822
1447,力鵬,12,1,11,元大-土城學府,2024-12-05,9822
2344,華邦電,11,0,11,元大-土城學府,2024-12-05,9822
2399,映泰,11,0,11,元大-土城學府,2024-12-05,9822
5324,士開,11,0,11,元大-土城學府,2024-12-05,9822
9105,泰金寶-DR,30,19,11,元大-土城學府,2024-12-05,9822
2303,聯電,20,9,11,元大-土城學府,2024-12-05,9822
0056,元大高股息,11,0,11,元大-土城學府,2024-12-05,9822
6770,力積電,10,0,10,元大-土城學府,2024-12-05,9822
00887,永豐中國科技50大,10,0,10,元大-土城學府,2024-12-05,9822
00959B,大華投等美債15Y+,10,0,10,元大-土城學府,2024-12-05,9822
3548,兆利,11,2,9,元大-土城學府,2024-12-05,9822
2312,金寶,29,20,9,元大-土城學府,2024-12-05,9822
6213,聯茂,26,17,9,元大-土城學府,2024-12-05,9822
00712,復華富時不動產,8,0,8,元大-土城學府,2024-12-05,9822
3013,晟銘電,19,11,8,元大-土城學府,2024-12-05,9822
6919,康霈*,8,0,8,元大-土城學府,2024-12-05,9822
00930,永豐ESG低碳高息,11,3,8,元大-土城學府,2024-12-05,9822
1605,華新,12,4,8,元大-土城學府,2024-12-05,9822
3265,台星科,8,0,8,元大-土城學府,2024-12-05,9822
4971,IET-KY,15,7,8,元大-土城學府,2024-12-05,9822
6426,統新,8,0,8,元大-土城學府,2024-12-05,9822
6962,ITH-KY,9,1,8,元大-土城學府,2024-12-05,9822
2355,敬鵬,7,0,7,元大-土城學府,2024-12-05,9822
00713,元大台灣高息低波,7,1,6,元大-土城學府,2024-12-05,9822
1303,南亞,12,6,6,元大-土城學府,2024-12-05,9822
00918,大華優利高填息30,69,1,68,元大-土城學府,2024-12-06,9822
3706,神達,116,75,41,元大-土城學府,2024-12-06,9822
4931,新盛力,46,8,38,元大-土城學府,2024-12-06,9822
2891,中信金,31,0,31,元大-土城學府,2024-12-06,9822
6558,興能高,35,6,29,元大-土城學府,2024-12-06,9822
3323,加百裕,29,7,22,元大-土城學府,2024-12-06,9822
8171,天宇,22,1,21,元大-土城學府,2024-12-06,9822
2929,淘帝-KY,25,4,21,元大-土城學府,2024-12-06,9822
3211,順達,29,9,20,元大-土城學府,2024-12-06,9822
1702,南僑,19,0,19,元大-土城學府,2024-12-06,9822
00930,永豐ESG低碳高息,30,14,16,元大-土城學府,2024-12-06,9822
4977,眾達-KY,28,13,15,元大-土城學府,2024-12-06,9822
2354,鴻準,248,234,14,元大-土城學府,2024-12-06,9822
00959B,大華投等美債15Y+,13,0,13,元大-土城學府,2024-12-06,9822
2374,佳能,16,3,13,元大-土城學府,2024-12-06,9822
00915,凱基優選高股息30,12,0,12,元大-土城學府,2024-12-06,9822
1815,富喬,45,34,11,元大-土城學府,2024-12-06,9822
2312,金寶,28,17,11,元大-土城學府,2024-12-06,9822
00919,群益台灣精選高息,24,13,11,元大-土城學府,2024-12-06,9822
2317,鴻海,44,33,11,元大-土城學府,2024-12-06,9822
6530,創威,11,1,10,元大-土城學府,2024-12-06,9822
00712,復華富時不動產,10,0,10,元大-土城學府,2024-12-06,9822
3380,明泰,12,2,10,元大-土城學府,2024-12-06,9822
4714,永捷,15,5,10,元大-土城學府,2024-12-06,9822
6271,同欣電,10,0,10,元大-土城學府,2024-12-06,9822
00946,群益科技高息成長,9,0,9,元大-土城學府,2024-12-06,9822
2002,中鋼,9,0,9,元大-土城學府,2024-12-06,9822
2388,威盛,13,4,9,元大-土城學府,2024-12-06,9822
2615,萬海,10,1,9,元大-土城學府,2024-12-06,9822
00933B,國泰10Y+金融債,8,0,8,元大-土城學府,2024-12-06,9822
00665L,富邦�琤肭磪囓�2,8,0,8,元大-土城學府,2024-12-06,9822
5230,雷笛克光學,8,0,8,元大-土城學府,2024-12-06,9822
6757,台灣虎航,8,0,8,元大-土城學府,2024-12-06,9822
5371,中光電,8,1,7,元大-土城學府,2024-12-06,9822
8011,台通,7,0,7,元大-土城學府,2024-12-06,9822
2204,中華,8,2,6,元大-土城學府,2024-12-06,9822
00953B,群益優選非投等債,6,0,6,元大-土城學府,2024-12-06,9822
2355,敬鵬,6,0,6,元大-土城學府,2024-12-06,9822
3056,富華新,8,2,6,元大-土城學府,2024-12-06,9822
2610,華航,6,1,5,元大-土城學府,2024-12-06,9822
1528,恩德,5,0,5,元大-土城學府,2024-12-06,9822
00830,國泰費城半導體,5,0,5,元大-土城學府,2024-12-06,9822
00715L,期街口布蘭特正2,5,0,5,元大-土城學府,2024-12-06,9822
00937B,群益ESG投等債20,5,0,5,元大-土城學府,2024-12-06,9822
3032,偉訓,6,1,5,元大-土城學府,2024-12-06,9822
5484,慧友,5,0,5,元大-土城學府,2024-12-06,9822
6821,聯寶,5,0,5,元大-土城學府,2024-12-06,9822
6923,中台,5,0,5,元大-土城學府,2024-12-06,9822
9934,成霖,5,0,5,元大-土城學府,2024-12-06,9822
2889,國票金,5,0,5,元大-土城學府,2024-12-06,9822
2354,鴻準,234,84,150,元大-土城學府,2024-12-09,9822
4977,眾達-KY,142,26,116,元大-土城學府,2024-12-09,9822
00921,兆豐龍頭等權重,100,0,100,元大-土城學府,2024-12-09,9822
2382,廣達,73,3,70,元大-土城學府,2024-12-09,9822
00918,大華優利高填息30,37,1,36,元大-土城學府,2024-12-09,9822
2891,中信金,34,0,34,元大-土城學府,2024-12-09,9822
2317,鴻海,33,3,30,元大-土城學府,2024-12-09,9822
2801,彰銀,30,4,26,元大-土城學府,2024-12-09,9822
00637L,元大滬深300正2,30,6,24,元大-土城學府,2024-12-09,9822
0056,元大高股息,28,5,23,元大-土城學府,2024-12-09,9822
3013,晟銘電,25,2,23,元大-土城學府,2024-12-09,9822
4979,華星光,61,38,23,元大-土城學府,2024-12-09,9822
4931,新盛力,42,20,22,元大-土城學府,2024-12-09,9822
2392,正崴,28,7,21,元大-土城學府,2024-12-09,9822
2449,京元電子,22,1,21,元大-土城學府,2024-12-09,9822
3032,偉訓,22,1,21,元大-土城學府,2024-12-09,9822
2312,金寶,24,6,18,元大-土城學府,2024-12-09,9822
1449,佳和,21,5,16,元大-土城學府,2024-12-09,9822
00915,凱基優選高股息30,16,1,15,元大-土城學府,2024-12-09,9822
3211,順達,26,12,14,元大-土城學府,2024-12-09,9822
2615,萬海,55,41,14,元大-土城學府,2024-12-09,9822
3450,聯鈞,27,15,12,元大-土城學府,2024-12-09,9822
3037,欣興,12,2,10,元大-土城學府,2024-12-09,9822
6558,興能高,25,15,10,元大-土城學府,2024-12-09,9822
00933B,國泰10Y+金融債,15,5,10,元大-土城學府,2024-12-09,9822
00953B,群益優選非投等債,10,0,10,元大-土城學府,2024-12-09,9822
1717,長興,10,0,10,元大-土城學府,2024-12-09,9822
2349,錸德,11,1,10,元大-土城學府,2024-12-09,9822
2387,精元,10,0,10,元大-土城學府,2024-12-09,9822
4906,正文,10,0,10,元大-土城學府,2024-12-09,9822
4916,事欣科,10,0,10,元大-土城學府,2024-12-09,9822
6271,同欣電,10,0,10,元大-土城學府,2024-12-09,9822
6505,台塑化,9,0,9,元大-土城學府,2024-12-09,9822
00900,富邦特選高股息30,9,0,9,元大-土城學府,2024-12-09,9822
2393,億光,10,1,9,元大-土城學府,2024-12-09,9822
1609,大亞,10,1,9,元大-土城學府,2024-12-09,9822
8150,南茂,8,0,8,元大-土城學府,2024-12-09,9822
3363,上詮,8,0,8,元大-土城學府,2024-12-09,9822
00878,國泰永續高股息,19,11,8,元大-土城學府,2024-12-09,9822
2883,凱基金,13,6,7,元大-土城學府,2024-12-09,9822
3043,科風,10,3,7,元大-土城學府,2024-12-09,9822
2405,輔信,8,1,7,元大-土城學府,2024-12-09,9822
2495,普安,9,2,7,元大-土城學府,2024-12-09,9822
3548,兆利,8,1,7,元大-土城學府,2024-12-09,9822
3607,谷崧,8,1,7,元大-土城學府,2024-12-09,9822
6752,叡揚,7,0,7,元大-土城學府,2024-12-09,9822
9105,泰金寶-DR,7,0,7,元大-土城學府,2024-12-09,9822
2542,興富發,7,0,7,元大-土城學府,2024-12-09,9822
3597,映興,6,0,6,元大-土城學府,2024-12-09,9822
2002,中鋼,6,0,6,元大-土城學府,2024-12-09,9822
3706,神達,281,113,168,元大-土城學府,2024-12-10,9822
00751B,元大AAA至A公司債,162,0,162,元大-土城學府,2024-12-10,9822
00915,凱基優選高股息30,48,0,48,元大-土城學府,2024-12-10,9822
00918,大華優利高填息30,41,0,41,元大-土城學府,2024-12-10,9822
2609,陽明,102,64,38,元大-土城學府,2024-12-10,9822
6863,永道-KY,37,1,36,元大-土城學府,2024-12-10,9822
2317,鴻海,41,6,35,元大-土城學府,2024-12-10,9822
2903,遠百,32,0,32,元大-土城學府,2024-12-10,9822
2002,中鋼,30,1,29,元大-土城學府,2024-12-10,9822
00919,群益台灣精選高息,31,6,25,元大-土城學府,2024-12-10,9822
6877,鏵友益,24,2,22,元大-土城學府,2024-12-10,9822
6683,雍智科技,20,0,20,元大-土城學府,2024-12-10,9822
0056,元大高股息,29,9,20,元大-土城學府,2024-12-10,9822
00878,國泰永續高股息,25,6,19,元大-土城學府,2024-12-10,9822
4977,眾達-KY,39,22,17,元大-土城學府,2024-12-10,9822
6530,創威,15,0,15,元大-土城學府,2024-12-10,9822
1584,精剛,15,0,15,元大-土城學府,2024-12-10,9822
2882,國泰金,15,0,15,元大-土城學府,2024-12-10,9822
2363,矽統,57,43,14,元大-土城學府,2024-12-10,9822
6164,華興,14,0,14,元大-土城學府,2024-12-10,9822
2618,長榮航,18,5,13,元大-土城學府,2024-12-10,9822
8096,擎亞,11,0,11,元大-土城學府,2024-12-10,9822
00953B,群益優選非投等債,11,0,11,元大-土城學府,2024-12-10,9822
1802,台玻,12,1,11,元大-土城學府,2024-12-10,9822
5315,光聯,11,0,11,元大-土城學府,2024-12-10,9822
8044,網家,12,1,11,元大-土城學府,2024-12-10,9822
2542,興富發,10,0,10,元大-土城學府,2024-12-10,9822
1201,味全,10,0,10,元大-土城學府,2024-12-10,9822
1203,味王,10,0,10,元大-土城學府,2024-12-10,9822
2417,圓剛,10,1,9,元大-土城學府,2024-12-10,9822
2615,萬海,11,2,9,元大-土城學府,2024-12-10,9822
00687B,國泰20年美債,8,0,8,元大-土城學府,2024-12-10,9822
3037,欣興,10,2,8,元大-土城學府,2024-12-10,9822
3043,科風,8,0,8,元大-土城學府,2024-12-10,9822
4971,IET-KY,10,2,8,元大-土城學府,2024-12-10,9822
2449,京元電子,7,0,7,元大-土城學府,2024-12-10,9822
00909,國泰數位支付服務,8,1,7,元大-土城學府,2024-12-10,9822
2382,廣達,7,0,7,元大-土城學府,2024-12-10,9822
6558,興能高,27,20,7,元大-土城學府,2024-12-10,9822
5309,系統電,7,0,7,元大-土城學府,2024-12-10,9822
4909,新復興,11,5,6,元大-土城學府,2024-12-10,9822
1609,大亞,9,3,6,元大-土城學府,2024-12-10,9822
2405,輔信,6,0,6,元大-土城學府,2024-12-10,9822
00933B,國泰10Y+金融債,5,0,5,元大-土城學府,2024-12-10,9822
00941,中信上游半導體,5,0,5,元大-土城學府,2024-12-10,9822
00830,國泰費城半導體,5,0,5,元大-土城學府,2024-12-10,9822
00633L,富邦上証正2,5,0,5,元大-土城學府,2024-12-10,9822
00964,中信亞太高股息,5,0,5,元大-土城學府,2024-12-10,9822
1569,濱川,5,0,5,元大-土城學府,2024-12-10,9822
1708,東鹼,5,0,5,元大-土城學府,2024-12-10,9822
00940,元大台灣價值高息,116,10,106,元大-土城學府,2024-12-11,9822
00712,復華富時不動產,105,0,105,元大-土城學府,2024-12-11,9822
2609,陽明,119,17,102,元大-土城學府,2024-12-11,9822
6244,茂迪,100,0,100,元大-土城學府,2024-12-11,9822
00918,大華優利高填息30,66,0,66,元大-土城學府,2024-12-11,9822
5328,華容,67,3,64,元大-土城學府,2024-12-11,9822
00919,群益台灣精選高息,67,4,63,元大-土城學府,2024-12-11,9822
1301,台塑,59,4,55,元大-土城學府,2024-12-11,9822
2317,鴻海,57,13,44,元大-土城學府,2024-12-11,9822
5439,高技,44,0,44,元大-土城學府,2024-12-11,9822
2382,廣達,45,2,43,元大-土城學府,2024-12-11,9822
00968B,元大優息投等債,40,0,40,元大-土城學府,2024-12-11,9822
00915,凱基優選高股息30,35,0,35,元大-土城學府,2024-12-11,9822
00959B,大華投等美債15Y+,30,0,30,元大-土城學府,2024-12-11,9822
2401,凌陽,26,0,26,元大-土城學府,2024-12-11,9822
00688L,國泰20年美債正2,25,0,25,元大-土城學府,2024-12-11,9822
2233,宇隆,23,0,23,元大-土城學府,2024-12-11,9822
2887,台新金,20,0,20,元大-土城學府,2024-12-11,9822
4729,熒茂,20,0,20,元大-土城學府,2024-12-11,9822
6470,宇智,23,3,20,元大-土城學府,2024-12-11,9822
3231,緯創,21,2,19,元大-土城學府,2024-12-11,9822
0056,元大高股息,28,13,15,元大-土城學府,2024-12-11,9822
2613,中櫃,15,0,15,元大-土城學府,2024-12-11,9822
2303,聯電,19,5,14,元大-土城學府,2024-12-11,9822
6770,力積電,170,157,13,元大-土城學府,2024-12-11,9822
00878,國泰永續高股息,17,4,13,元大-土城學府,2024-12-11,9822
00967B,元大優息美債,12,0,12,元大-土城學府,2024-12-11,9822
3455,由田,12,0,12,元大-土城學府,2024-12-11,9822
00929,復華台灣科技優息,31,19,12,元大-土城學府,2024-12-11,9822
00926,凱基全球菁英55,11,0,11,元大-土城學府,2024-12-11,9822
2002,中鋼,12,1,11,元大-土城學府,2024-12-11,9822
2258,鴻華先進-創,11,0,11,元大-土城學府,2024-12-11,9822
2344,華邦電,23,12,11,元大-土城學府,2024-12-11,9822
2801,彰銀,10,0,10,元大-土城學府,2024-12-11,9822
2201,裕隆,10,0,10,元大-土城學府,2024-12-11,9822
2882,國泰金,12,2,10,元大-土城學府,2024-12-11,9822
00969B,元大零息超長美債,10,0,10,元大-土城學府,2024-12-11,9822
1536,和大,12,2,10,元大-土城學府,2024-12-11,9822
1714,和桐,10,0,10,元大-土城學府,2024-12-11,9822
1717,長興,10,0,10,元大-土城學府,2024-12-11,9822
3607,谷崧,21,11,10,元大-土城學府,2024-12-11,9822
2313,華通,30,20,10,元大-土城學府,2024-12-11,9822
00713,元大台灣高息低波,9,0,9,元大-土城學府,2024-12-11,9822
2204,中華,9,0,9,元大-土城學府,2024-12-11,9822
2353,宏��,11,2,9,元大-土城學府,2024-12-11,9822
2465,麗臺,10,1,9,元大-土城學府,2024-12-11,9822
6863,永道-KY,13,4,9,元大-土城學府,2024-12-11,9822
8096,擎亞,14,5,9,元大-土城學府,2024-12-11,9822
8054,安國,11,2,9,元大-土城學府,2024-12-11,9822
2337,旺宏,9,1,8,元大-土城學府,2024-12-11,9822
6770,力積電,281,137,144,元大-土城學府,2024-12-12,9822
00919,群益台灣精選高息,119,4,115,元大-土城學府,2024-12-12,9822
00918,大華優利高填息30,91,0,91,元大-土城學府,2024-12-12,9822
3041,揚智,93,38,55,元大-土城學府,2024-12-12,9822
3550,聯穎,60,5,55,元大-土城學府,2024-12-12,9822
2609,陽明,56,22,34,元大-土城學府,2024-12-12,9822
2615,萬海,39,6,33,元大-土城學府,2024-12-12,9822
6142,友勁,26,0,26,元大-土城學府,2024-12-12,9822
4107,邦特,25,0,25,元大-土城學府,2024-12-12,9822
5328,華容,28,4,24,元大-土城學府,2024-12-12,9822
00687B,國泰20年美債,24,0,24,元大-土城學府,2024-12-12,9822
2233,宇隆,20,0,20,元大-土城學府,2024-12-12,9822
2328,廣宇,28,8,20,元大-土城學府,2024-12-12,9822
4977,眾達-KY,48,28,20,元大-土城學府,2024-12-12,9822
2382,廣達,21,2,19,元大-土城學府,2024-12-12,9822
0056,元大高股息,24,6,18,元大-土城學府,2024-12-12,9822
3515,華擎,19,1,18,元大-土城學府,2024-12-12,9822
3706,神達,239,221,18,元大-土城學府,2024-12-12,9822
4979,華星光,49,32,17,元大-土城學府,2024-12-12,9822
2515,中工,15,0,15,元大-土城學府,2024-12-12,9822
3029,零壹,92,78,14,元大-土城學府,2024-12-12,9822
2303,聯電,46,33,13,元大-土城學府,2024-12-12,9822
00968B,元大優息投等債,13,0,13,元大-土城學府,2024-12-12,9822
1455,集盛,13,0,13,元大-土城學府,2024-12-12,9822
6158,禾昌,13,0,13,元大-土城學府,2024-12-12,9822
6863,永道-KY,15,2,13,元大-土城學府,2024-12-12,9822
2392,正崴,13,1,12,元大-土城學府,2024-12-12,9822
2349,錸德,14,2,12,元大-土城學府,2024-12-12,9822
6788,華景電,15,3,12,元大-土城學府,2024-12-12,9822
3019,亞光,31,20,11,元大-土城學府,2024-12-12,9822
00680L,元大美債20正2,11,0,11,元大-土城學府,2024-12-12,9822
00632R,元大台灣50反1,10,0,10,元大-土城學府,2024-12-12,9822
1449,佳和,14,4,10,元大-土城學府,2024-12-12,9822
00850,元大臺灣ESG永續,10,0,10,元大-土城學府,2024-12-12,9822
00967B,元大優息美債,10,0,10,元大-土城學府,2024-12-12,9822
00969B,元大零息超長美債,10,0,10,元大-土城學府,2024-12-12,9822
1536,和大,10,0,10,元大-土城學府,2024-12-12,9822
2734,易飛網,10,0,10,元大-土城學府,2024-12-12,9822
5230,雷笛克光學,10,0,10,元大-土城學府,2024-12-12,9822
2002,中鋼,10,0,10,元大-土城學府,2024-12-12,9822
1714,和桐,10,1,9,元大-土城學府,2024-12-12,9822
2426,鼎元,10,1,9,元大-土城學府,2024-12-12,9822
1301,台塑,9,1,8,元大-土城學府,2024-12-12,9822
2317,鴻海,37,28,9,元大-土城學府,2024-12-12,9822
00751B,元大AAA至A公司債,8,0,8,元大-土城學府,2024-12-12,9822
00713,元大台灣高息低波,8,0,8,元大-土城學府,2024-12-12,9822
00937B,群益ESG投等債20,8,0,8,元大-土城學府,2024-12-12,9822
2312,金寶,10,2,8,元大-土城學府,2024-12-12,9822
2344,華邦電,18,10,8,元大-土城學府,2024-12-12,9822
4931,新盛力,41,33,8,元大-土城學府,2024-12-12,9822
1785,光洋科,158,21,137,元大-土城學府,2024-12-13,9822
0056,元大高股息,64,0,64,元大-土城學府,2024-12-13,9822
00948B,中信優息投資級債,54,0,54,元大-土城學府,2024-12-13,9822
00918,大華優利高填息30,50,0,50,元大-土城學府,2024-12-13,9822
00679B,元大美債20年,50,2,48,元大-土城學府,2024-12-13,9822
00909,國泰數位支付服務,34,0,34,元大-土城學府,2024-12-13,9822
00878,國泰永續高股息,32,1,31,元大-土城學府,2024-12-13,9822
2371,大同,36,5,31,元大-土城學府,2024-12-13,9822
2356,英業達,31,0,31,元大-土城學府,2024-12-13,9822
2618,長榮航,35,4,31,元大-土城學府,2024-12-13,9822
00637L,元大滬深300正2,30,0,30,元大-土城學府,2024-12-13,9822
00919,群益台灣精選高息,36,9,27,元大-土城學府,2024-12-13,9822
2354,鴻準,34,10,24,元大-土城學府,2024-12-13,9822
5392,能率,23,2,21,元大-土城學府,2024-12-13,9822
2317,鴻海,31,11,20,元大-土城學府,2024-12-13,9822
1220,台榮,20,0,20,元大-土城學府,2024-12-13,9822
00915,凱基優選高股息30,20,0,20,元大-土城學府,2024-12-13,9822
00688L,國泰20年美債正2,20,0,20,元大-土城學府,2024-12-13,9822
5452,佶優,20,0,20,元大-土城學府,2024-12-13,9822
2887,台新金,19,0,19,元大-土城學府,2024-12-13,9822
00893,國泰智能電動車,18,0,18,元大-土城學府,2024-12-13,9822
8111,立��,21,4,17,元大-土城學府,2024-12-13,9822
00687B,國泰20年美債,17,1,16,元大-土城學府,2024-12-13,9822
5328,華容,20,4,16,元大-土城學府,2024-12-13,9822
9945,潤泰新,15,0,15,元大-土城學府,2024-12-13,9822
3037,欣興,16,2,14,元大-土城學府,2024-12-13,9822
3081,聯亞,17,3,14,元大-土城學府,2024-12-13,9822
4107,邦特,14,0,14,元大-土城學府,2024-12-13,9822
00680L,元大美債20正2,34,20,14,元大-土城學府,2024-12-13,9822
2324,仁寶,17,4,13,元大-土城學府,2024-12-13,9822
2233,宇隆,13,0,13,元大-土城學府,2024-12-13,9822
1717,長興,12,0,12,元大-土城學府,2024-12-13,9822
4906,正文,12,0,12,元大-土城學府,2024-12-13,9822
1714,和桐,11,0,11,元大-土城學府,2024-12-13,9822
6116,彩晶,13,2,11,元大-土城學府,2024-12-13,9822
00900,富邦特選高股息30,10,0,10,元大-土城學府,2024-12-13,9822
00857B,永豐20年美公債,10,0,10,元大-土城學府,2024-12-13,9822
1229,聯華,10,0,10,元大-土城學府,2024-12-13,9822
1447,力鵬,10,0,10,元大-土城學府,2024-12-13,9822
2905,三商,10,0,10,元大-土城學府,2024-12-13,9822
9934,成霖,10,0,10,元大-土城學府,2024-12-13,9822
2897,王道銀行,9,0,9,元大-土城學府,2024-12-13,9822
2329,華泰,10,1,9,元大-土城學府,2024-12-13,9822
3013,晟銘電,20,11,9,元大-土城學府,2024-12-13,9822
5484,慧友,9,0,9,元大-土城學府,2024-12-13,9822
2883,凱基金,8,0,8,元大-土城學府,2024-12-13,9822
2610,華航,11,4,7,元大-土城學府,2024-12-13,9822
00969B,元大零息超長美債,7,0,7,元大-土城學府,2024-12-13,9822
00713,元大台灣高息低波,8,2,6,元大-土城學府,2024-12-13,9822
2353,宏��,12,6,6,元大-土城學府,2024-12-13,9822
00918,大華優利高填息30,140,3,137,元大-土城學府,2024-12-16,9822
00937B,群益ESG投等債20,112,0,112,元大-土城學府,2024-12-16,9822
00919,群益台灣精選高息,114,38,76,元大-土城學府,2024-12-16,9822
00922,國泰台灣領袖50,75,0,75,元大-土城學府,2024-12-16,9822
00950B,凱基A級公司債,70,0,70,元大-土城學府,2024-12-16,9822
2609,陽明,78,25,53,元大-土城學府,2024-12-16,9822
5315,光聯,67,14,53,元大-土城學府,2024-12-16,9822
6244,茂迪,50,0,50,元大-土城學府,2024-12-16,9822
1802,台玻,46,2,44,元大-土城學府,2024-12-16,9822
2382,廣達,48,7,41,元大-土城學府,2024-12-16,9822
0056,元大高股息,63,27,36,元大-土城學府,2024-12-16,9822
00933B,國泰10Y+金融債,32,0,32,元大-土城學府,2024-12-16,9822
00945B,凱基美國非投等債,34,2,32,元大-土城學府,2024-12-16,9822
1513,中興電,29,1,28,元大-土城學府,2024-12-16,9822
2354,鴻準,31,3,28,元大-土城學府,2024-12-16,9822
00915,凱基優選高股息30,27,0,27,元大-土城學府,2024-12-16,9822
2615,萬海,29,3,26,元大-土城學府,2024-12-16,9822
2317,鴻海,48,25,23,元大-土城學府,2024-12-16,9822
3231,緯創,26,4,22,元大-土城學府,2024-12-16,9822
00687B,國泰20年美債,22,0,22,元大-土城學府,2024-12-16,9822
00959B,大華投等美債15Y+,22,0,22,元大-土城學府,2024-12-16,9822
3550,聯穎,21,0,21,元大-土城學府,2024-12-16,9822
00751B,元大AAA至A公司債,20,0,20,元大-土城學府,2024-12-16,9822
00953B,群益優選非投等債,20,0,20,元大-土城學府,2024-12-16,9822
3564,其陽,20,0,20,元大-土城學府,2024-12-16,9822
00679B,元大美債20年,18,0,18,元大-土城學府,2024-12-16,9822
6191,精成科,17,0,17,元大-土城學府,2024-12-16,9822
5483,中美晶,17,0,17,元大-土城學府,2024-12-16,9822
3211,順達,25,9,16,元大-土城學府,2024-12-16,9822
2328,廣宇,15,1,14,元大-土城學府,2024-12-16,9822
8096,擎亞,16,3,13,元大-土城學府,2024-12-16,9822
2367,燿華,16,3,13,元大-土城學府,2024-12-16,9822
00940,元大台灣價值高息,36,24,12,元大-土城學府,2024-12-16,9822
4931,新盛力,38,26,12,元大-土城學府,2024-12-16,9822
6733,博晟生醫,12,0,12,元大-土城學府,2024-12-16,9822
9105,泰金寶-DR,19,8,11,元大-土城學府,2024-12-16,9822
00680L,元大美債20正2,21,10,11,元大-土城學府,2024-12-16,9822
00878,國泰永續高股息,11,1,10,元大-土城學府,2024-12-16,9822
00795B,中信美國公債20年,10,0,10,元大-土城學府,2024-12-16,9822
00926,凱基全球菁英55,10,0,10,元大-土城學府,2024-12-16,9822
00772B,中信高評級公司債,10,0,10,元大-土城學府,2024-12-16,9822
00728,第一金工業30,10,0,10,元大-土城學府,2024-12-16,9822
00960,野村全球航運龍頭,10,0,10,元大-土城學府,2024-12-16,9822
2355,敬鵬,13,3,10,元大-土城學府,2024-12-16,9822
2461,光群雷,10,0,10,元大-土城學府,2024-12-16,9822
3090,日電貿,11,2,9,元大-土城學府,2024-12-16,9822
3013,晟銘電,24,16,8,元大-土城學府,2024-12-16,9822
00713,元大台灣高息低波,7,0,7,元大-土城學府,2024-12-16,9822
6530,創威,8,1,7,元大-土城學府,2024-12-16,9822
5243,乙盛-KY,7,0,7,元大-土城學府,2024-12-16,9822
1785,光洋科,205,0,205,元大-土城學府,2024-12-17,9822
00937B,群益ESG投等債20,141,6,135,元大-土城學府,2024-12-17,9822
6546,正基,120,0,120,元大-土城學府,2024-12-17,9822
00915,凱基優選高股息30,67,0,67,元大-土城學府,2024-12-17,9822
00918,大華優利高填息30,97,30,67,元大-土城學府,2024-12-17,9822
00713,元大台灣高息低波,59,3,56,元大-土城學府,2024-12-17,9822
8249,菱光,39,7,32,元大-土城學府,2024-12-17,9822
1605,華新,30,0,30,元大-土城學府,2024-12-17,9822
2609,陽明,54,25,29,元大-土城學府,2024-12-17,9822
0056,元大高股息,32,5,27,元大-土城學府,2024-12-17,9822
2303,聯電,51,27,24,元大-土城學府,2024-12-17,9822
2883,凱基金,32,12,20,元大-土城學府,2024-12-17,9822
00679B,元大美債20年,20,0,20,元大-土城學府,2024-12-17,9822
00950B,凱基A級公司債,19,0,19,元大-土城學府,2024-12-17,9822
00959B,大華投等美債15Y+,19,0,19,元大-土城學府,2024-12-17,9822
00882,中信中國高股息,22,4,18,元大-土城學府,2024-12-17,9822
9945,潤泰新,17,0,17,元大-土城學府,2024-12-17,9822
3481,群創,15,0,15,元大-土城學府,2024-12-17,9822
00967B,元大優息美債,15,0,15,元大-土城學府,2024-12-17,9822
2317,鴻海,25,10,15,元大-土城學府,2024-12-17,9822
00688L,國泰20年美債正2,12,0,12,元大-土城學府,2024-12-17,9822
2834,臺企銀,12,1,11,元大-土城學府,2024-12-17,9822
4927,泰鼎-KY,11,0,11,元大-土城學府,2024-12-17,9822
5009,榮剛,11,0,11,元大-土城學府,2024-12-17,9822
00687B,國泰20年美債,10,0,10,元大-土城學府,2024-12-17,9822
00887,永豐中國科技50大,10,0,10,元大-土城學府,2024-12-17,9822
1303,南亞,14,4,10,元大-土城學府,2024-12-17,9822
1314,中石化,10,0,10,元大-土城學府,2024-12-17,9822
1514,亞力,10,0,10,元大-土城學府,2024-12-17,9822
1717,長興,10,0,10,元大-土城學府,2024-12-17,9822
2233,宇隆,10,0,10,元大-土城學府,2024-12-17,9822
2344,華邦電,14,4,10,元大-土城學府,2024-12-17,9822
4107,邦特,10,0,10,元大-土城學府,2024-12-17,9822
2382,廣達,10,1,9,元大-土城學府,2024-12-17,9822
5483,中美晶,14,5,9,元大-土城學府,2024-12-17,9822
3231,緯創,13,4,9,元大-土城學府,2024-12-17,9822
3035,智原,33,24,9,元大-土城學府,2024-12-17,9822
2542,興富發,8,0,8,元大-土城學府,2024-12-17,9822
2368,金像電,15,7,8,元大-土城學府,2024-12-17,9822
2354,鴻準,18,10,8,元大-土城學府,2024-12-17,9822
1326,台化,7,0,7,元大-土城學府,2024-12-17,9822
2449,京元電子,11,5,6,元大-土城學府,2024-12-17,9822
2881,富邦金,6,0,6,元大-土城學府,2024-12-17,9822
2885,元大金,6,0,6,元大-土城學府,2024-12-17,9822
00751B,元大AAA至A公司債,6,0,6,元大-土城學府,2024-12-17,9822
2002,中鋼,7,1,6,元大-土城學府,2024-12-17,9822
3576,聯合再生,6,0,6,元大-土城學府,2024-12-17,9822
4931,新盛力,23,17,6,元大-土城學府,2024-12-17,9822
2886,兆豐金,6,0,6,元大-土城學府,2024-12-17,9822
00933B,國泰10Y+金融債,5,0,5,元大-土城學府,2024-12-17,9822
00918,大華優利高填息30,140,0,140,元大-土城學府,2024-12-18,9822
2884,玉山金,70,1,69,元大-土城學府,2024-12-18,9822
00712,復華富時不動產,46,0,46,元大-土城學府,2024-12-18,9822
2883,凱基金,35,0,35,元大-土城學府,2024-12-18,9822
2609,陽明,149,117,32,元大-土城學府,2024-12-18,9822
1522,堤維西,30,4,26,元大-土城學府,2024-12-18,9822
2332,友訊,24,0,24,元大-土城學府,2024-12-18,9822
00713,元大台灣高息低波,24,1,23,元大-土城學府,2024-12-18,9822
6164,華興,20,0,20,元大-土城學府,2024-12-18,9822
912000,晨訊科-DR,20,0,20,元大-土城學府,2024-12-18,9822
2233,宇隆,20,1,19,元大-土城學府,2024-12-18,9822
8033,雷虎,21,2,19,元大-土城學府,2024-12-18,9822
00937B,群益ESG投等債20,18,0,18,元大-土城學府,2024-12-18,9822
2344,華邦電,27,9,18,元大-土城學府,2024-12-18,9822
0056,元大高股息,21,4,17,元大-土城學府,2024-12-18,9822
5371,中光電,23,7,16,元大-土城學府,2024-12-18,9822
00933B,國泰10Y+金融債,13,0,13,元大-土城學府,2024-12-18,9822
4303,信立,14,2,12,元大-土城學府,2024-12-18,9822
4540,全球傳動,65,55,10,元大-土城學府,2024-12-18,9822
00632R,元大台灣50反1,10,0,10,元大-土城學府,2024-12-18,9822
00968B,元大優息投等債,10,0,10,元大-土城學府,2024-12-18,9822
1303,南亞,13,3,10,元大-土城學府,2024-12-18,9822
2464,盟立,10,0,10,元大-土城學府,2024-12-18,9822
4157,太景*-KY,10,0,10,元大-土城學府,2024-12-18,9822
8070,長華*,10,0,10,元大-土城學府,2024-12-18,9822
2637,慧洋-KY,9,0,9,元大-土城學府,2024-12-18,9822
00637L,元大滬深300正2,12,3,9,元大-土城學府,2024-12-18,9822
6451,訊芯-KY,7,0,7,元大-土城學府,2024-12-18,9822
00909,國泰數位支付服務,7,0,7,元大-土城學府,2024-12-18,9822
4107,邦特,7,0,7,元大-土城學府,2024-12-18,9822
4533,協易機,9,2,7,元大-土城學府,2024-12-18,9822
5309,系統電,10,3,7,元大-土城學府,2024-12-18,9822
5460,同協,7,0,7,元大-土城學府,2024-12-18,9822
8086,宏捷科,7,0,7,元大-土城學府,2024-12-18,9822
1314,中石化,6,0,6,元大-土城學府,2024-12-18,9822
3037,欣興,7,1,6,元大-土城學府,2024-12-18,9822
2520,冠德,7,1,6,元大-土城學府,2024-12-18,9822
00948B,中信優息投資級債,6,0,6,元大-土城學府,2024-12-18,9822
00959B,大華投等美債15Y+,6,0,6,元大-土城學府,2024-12-18,9822
5009,榮剛,6,0,6,元大-土城學府,2024-12-18,9822
2317,鴻海,7,1,6,元大-土城學府,2024-12-18,9822
2382,廣達,6,0,6,元大-土城學府,2024-12-18,9822
2049,上銀,15,10,5,元大-土城學府,2024-12-18,9822
2375,凱美,5,0,5,元大-土城學府,2024-12-18,9822
006208,富邦台50,5,0,5,元大-土城學府,2024-12-18,9822
00905,FT臺灣Smart,5,0,5,元大-土城學府,2024-12-18,9822
006205,富邦上証,5,0,5,元大-土城學府,2024-12-18,9822
1616,億泰,5,0,5,元大-土城學府,2024-12-18,9822
2449,京元電子,8,3,5,元大-土城學府,2024-12-18,9822
3049,精金,5,0,5,元大-土城學府,2024-12-18,9822
2374,佳能,240,57,183,元大-土城學府,2024-12-19,9822
00918,大華優利高填息30,135,2,133,元大-土城學府,2024-12-19,9822
00671R,富邦NASDAQ反1,100,0,100,元大-土城學府,2024-12-19,9822
00712,復華富時不動產,66,0,66,元大-土城學府,2024-12-19,9822
00687B,國泰20年美債,60,0,60,元大-土城學府,2024-12-19,9822
4979,華星光,109,54,55,元大-土城學府,2024-12-19,9822
3481,群創,53,4,49,元大-土城學府,2024-12-19,9822
2897,王道銀行,53,5,48,元大-土城學府,2024-12-19,9822
2812,台中銀,46,0,46,元大-土城學府,2024-12-19,9822
00679B,元大美債20年,47,2,45,元大-土城學府,2024-12-19,9822
0056,元大高股息,47,2,45,元大-土城學府,2024-12-19,9822
00878,國泰永續高股息,58,21,37,元大-土城學府,2024-12-19,9822
00959B,大華投等美債15Y+,32,0,32,元大-土城學府,2024-12-19,9822
2883,凱基金,30,0,30,元大-土城學府,2024-12-19,9822
00937B,群益ESG投等債20,28,1,27,元大-土城學府,2024-12-19,9822
6770,力積電,83,56,27,元大-土城學府,2024-12-19,9822
2886,兆豐金,23,1,22,元大-土城學府,2024-12-19,9822
2609,陽明,41,19,22,元大-土城學府,2024-12-19,9822
2903,遠百,21,0,21,元大-土城學府,2024-12-19,9822
2002,中鋼,36,16,20,元大-土城學府,2024-12-19,9822
3323,加百裕,42,22,20,元大-土城學府,2024-12-19,9822
2417,圓剛,25,8,17,元大-土城學府,2024-12-19,9822
2303,聯電,31,15,16,元大-土城學府,2024-12-19,9822
00933B,國泰10Y+金融債,16,0,16,元大-土城學府,2024-12-19,9822
4107,邦特,15,0,15,元大-土城學府,2024-12-19,9822
00968B,元大優息投等債,14,0,14,元大-土城學府,2024-12-19,9822
2881,富邦金,13,0,13,元大-土城學府,2024-12-19,9822
2317,鴻海,30,17,13,元大-土城學府,2024-12-19,9822
2882,國泰金,12,0,12,元大-土城學府,2024-12-19,9822
5484,慧友,13,1,12,元大-土城學府,2024-12-19,9822
2409,友達,12,0,12,元大-土城學府,2024-12-19,9822
2890,永豐金,11,0,11,元大-土城學府,2024-12-19,9822
3037,欣興,13,2,11,元大-土城學府,2024-12-19,9822
9945,潤泰新,10,0,10,元大-土城學府,2024-12-19,9822
00967B,元大優息美債,10,0,10,元大-土城學府,2024-12-19,9822
1314,中石化,10,0,10,元大-土城學府,2024-12-19,9822
2030,彰源,10,0,10,元大-土城學府,2024-12-19,9822
2399,映泰,10,0,10,元大-土城學府,2024-12-19,9822
4157,太景*-KY,10,0,10,元大-土城學府,2024-12-19,9822
5009,榮剛,10,0,10,元大-土城學府,2024-12-19,9822
4958,臻鼎-KY,13,3,10,元大-土城學府,2024-12-19,9822
9105,泰金寶-DR,37,28,9,元大-土城學府,2024-12-19,9822
00830,國泰費城半導體,9,0,9,元大-土城學府,2024-12-19,9822
9958,世紀鋼,9,0,9,元大-土城學府,2024-12-19,9822
00948B,中信優息投資級債,14,5,9,元大-土城學府,2024-12-19,9822
3706,神達,52,43,9,元大-土城學府,2024-12-19,9822
4931,新盛力,220,211,9,元大-土城學府,2024-12-19,9822
5880,合庫金,9,0,9,元大-土城學府,2024-12-19,9822
6788,華景電,10,1,9,元大-土城學府,2024-12-19,9822
1815,富喬,25,16,9,元大-土城學府,2024-12-19,9822
