Ticker,Name,buy,sell,diff,Branch,Date,Branch_Code
2002,中鋼,256,24,232,元大-蘆洲,2023-01-03,9857
5009,榮剛,89,31,58,元大-蘆洲,2023-01-03,9857
3231,緯創,58,3,55,元大-蘆洲,2023-01-03,9857
1752,南光,51,7,44,元大-蘆洲,2023-01-03,9857
9904,寶成,43,6,37,元大-蘆洲,2023-01-03,9857
3479,安勤,76,39,37,元大-蘆洲,2023-01-03,9857
00665L,富邦�琤肭磪囓�2,65,34,31,元大-蘆洲,2023-01-03,9857
4129,聯合,30,0,30,元大-蘆洲,2023-01-03,9857
1434,福懋,30,5,25,元大-蘆洲,2023-01-03,9857
8105,凌巨,25,0,25,元大-蘆洲,2023-01-03,9857
00878,國泰永續高股息,62,38,24,元大-蘆洲,2023-01-03,9857
2890,永豐金,28,5,23,元大-蘆洲,2023-01-03,9857
1605,華新,114,91,23,元大-蘆洲,2023-01-03,9857
2388,威盛,62,40,22,元大-蘆洲,2023-01-03,9857
8227,巨有科技,19,0,19,元大-蘆洲,2023-01-03,9857
00673R,期元大S＆P原油反1,18,0,18,元大-蘆洲,2023-01-03,9857
2610,華航,24,7,17,元大-蘆洲,2023-01-03,9857
4167,松瑞藥,27,10,17,元大-蘆洲,2023-01-03,9857
2867,三商壽,17,0,17,元大-蘆洲,2023-01-03,9857
00885,富邦越南,21,4,17,元大-蘆洲,2023-01-03,9857
8933,愛地雅,30,14,16,元大-蘆洲,2023-01-03,9857
1810,和成,41,25,16,元大-蘆洲,2023-01-03,9857
00683L,期元大美元指正2,16,1,15,元大-蘆洲,2023-01-03,9857
2609,陽明,41,26,15,元大-蘆洲,2023-01-03,9857
00679B,元大美債20年,13,0,13,元大-蘆洲,2023-01-03,9857
3481,群創,15,2,13,元大-蘆洲,2023-01-03,9857
00713,元大台灣高息低波,13,0,13,元大-蘆洲,2023-01-03,9857
2313,華通,13,1,12,元大-蘆洲,2023-01-03,9857
2615,萬海,26,15,11,元大-蘆洲,2023-01-03,9857
6282,康舒,13,2,11,元大-蘆洲,2023-01-03,9857
00712,復華富時不動產,10,0,10,元大-蘆洲,2023-01-03,9857
3576,聯合再生,11,1,10,元大-蘆洲,2023-01-03,9857
00907,永豐優息存股,10,0,10,元大-蘆洲,2023-01-03,9857
2101,南港,10,0,10,元大-蘆洲,2023-01-03,9857
2601,益航,10,0,10,元大-蘆洲,2023-01-03,9857
1409,新纖,9,0,9,元大-蘆洲,2023-01-03,9857
2885,元大金,16,7,9,元大-蘆洲,2023-01-03,9857
4114,健喬,59,50,9,元大-蘆洲,2023-01-03,9857
4106,雃博,11,2,9,元大-蘆洲,2023-01-03,9857
00900,富邦特選高股息30,13,4,9,元大-蘆洲,2023-01-03,9857
1514,亞力,33,25,8,元大-蘆洲,2023-01-03,9857
2884,玉山金,11,3,8,元大-蘆洲,2023-01-03,9857
00902,中信電池及儲能,8,0,8,元大-蘆洲,2023-01-03,9857
2368,金像電,16,8,8,元大-蘆洲,2023-01-03,9857
2886,兆豐金,18,11,7,元大-蘆洲,2023-01-03,9857
5347,世界,7,0,7,元大-蘆洲,2023-01-03,9857
2641,正德,7,0,7,元大-蘆洲,2023-01-03,9857
2455,全新,7,0,7,元大-蘆洲,2023-01-03,9857
1314,中石化,9,2,7,元大-蘆洲,2023-01-03,9857
1789,神隆,7,0,7,元大-蘆洲,2023-01-03,9857
2482,連宇,64,5,59,元大-蘆洲,2023-01-04,9857
00902,中信電池及儲能,49,0,49,元大-蘆洲,2023-01-04,9857
2884,玉山金,41,0,41,元大-蘆洲,2023-01-04,9857
2023,燁輝,40,0,40,元大-蘆洲,2023-01-04,9857
2886,兆豐金,38,0,38,元大-蘆洲,2023-01-04,9857
2641,正德,35,0,35,元大-蘆洲,2023-01-04,9857
5608,四維航,36,3,33,元大-蘆洲,2023-01-04,9857
2405,輔信,30,0,30,元大-蘆洲,2023-01-04,9857
00665L,富邦�琤肭磪囓�2,108,79,29,元大-蘆洲,2023-01-04,9857
2885,元大金,30,3,27,元大-蘆洲,2023-01-04,9857
2457,飛宏,28,4,24,元大-蘆洲,2023-01-04,9857
9103,美德醫療-DR,25,1,24,元大-蘆洲,2023-01-04,9857
3037,欣興,26,2,24,元大-蘆洲,2023-01-04,9857
2609,陽明,43,20,23,元大-蘆洲,2023-01-04,9857
3708,上緯投控,31,8,23,元大-蘆洲,2023-01-04,9857
2888,新光金,26,4,22,元大-蘆洲,2023-01-04,9857
00642U,期元大S＆P石油,22,0,22,元大-蘆洲,2023-01-04,9857
1513,中興電,82,61,21,元大-蘆洲,2023-01-04,9857
6167,久正,20,0,20,元大-蘆洲,2023-01-04,9857
2542,興富發,20,0,20,元大-蘆洲,2023-01-04,9857
4129,聯合,20,2,18,元大-蘆洲,2023-01-04,9857
2014,中鴻,17,0,17,元大-蘆洲,2023-01-04,9857
5009,榮剛,40,23,17,元大-蘆洲,2023-01-04,9857
2615,萬海,42,28,14,元大-蘆洲,2023-01-04,9857
1701,中化,35,23,12,元大-蘆洲,2023-01-04,9857
2204,中華,11,0,11,元大-蘆洲,2023-01-04,9857
4979,華星光,16,5,11,元大-蘆洲,2023-01-04,9857
1304,台聚,11,0,11,元大-蘆洲,2023-01-04,9857
8028,昇陽半導體,11,0,11,元大-蘆洲,2023-01-04,9857
2603,長榮,50,40,10,元大-蘆洲,2023-01-04,9857
2498,宏達電,66,55,11,元大-蘆洲,2023-01-04,9857
2882,國泰金,14,4,10,元大-蘆洲,2023-01-04,9857
6443,元晶,21,11,10,元大-蘆洲,2023-01-04,9857
4157,太景*-KY,10,0,10,元大-蘆洲,2023-01-04,9857
2344,華邦電,22,12,10,元大-蘆洲,2023-01-04,9857
6245,立端,12,2,10,元大-蘆洲,2023-01-04,9857
1612,宏泰,10,0,10,元大-蘆洲,2023-01-04,9857
9962,有益,10,0,10,元大-蘆洲,2023-01-04,9857
2330,台積電,12,2,10,元大-蘆洲,2023-01-04,9857
3042,晶技,9,0,9,元大-蘆洲,2023-01-04,9857
4171,瑞基,25,17,8,元大-蘆洲,2023-01-04,9857
3013,晟銘電,8,0,8,元大-蘆洲,2023-01-04,9857
3162,精確,11,3,8,元大-蘆洲,2023-01-04,9857
00635U,期元大S＆P黃金,8,0,8,元大-蘆洲,2023-01-04,9857
00706L,期元大S＆P日圓正2,8,0,8,元大-蘆洲,2023-01-04,9857
3713,新晶投控,8,1,7,元大-蘆洲,2023-01-04,9857
4743,合一,7,0,7,元大-蘆洲,2023-01-04,9857
1795,美時,33,26,7,元大-蘆洲,2023-01-04,9857
8150,南茂,6,0,6,元大-蘆洲,2023-01-04,9857
0056,元大高股息,6,0,6,元大-蘆洲,2023-01-04,9857
00715L,期街口布蘭特正2,119,0,119,元大-蘆洲,2023-01-05,9857
4102,永日,50,1,49,元大-蘆洲,2023-01-05,9857
1529,樂事綠能,79,36,43,元大-蘆洲,2023-01-05,9857
00642U,期元大S＆P石油,32,0,32,元大-蘆洲,2023-01-05,9857
6111,大宇資,43,12,31,元大-蘆洲,2023-01-05,9857
5009,榮剛,30,1,29,元大-蘆洲,2023-01-05,9857
2409,友達,60,35,25,元大-蘆洲,2023-01-05,9857
3260,威剛,30,6,24,元大-蘆洲,2023-01-05,9857
2486,一詮,25,1,24,元大-蘆洲,2023-01-05,9857
2317,鴻海,26,4,22,元大-蘆洲,2023-01-05,9857
2609,陽明,38,16,22,元大-蘆洲,2023-01-05,9857
1718,中纖,32,10,22,元大-蘆洲,2023-01-05,9857
1605,華新,65,44,21,元大-蘆洲,2023-01-05,9857
2388,威盛,62,43,19,元大-蘆洲,2023-01-05,9857
2615,萬海,48,28,20,元大-蘆洲,2023-01-05,9857
2882,國泰金,31,13,18,元大-蘆洲,2023-01-05,9857
00770,國泰北美科技,17,0,17,元大-蘆洲,2023-01-05,9857
2458,義隆,16,0,16,元大-蘆洲,2023-01-05,9857
1513,中興電,53,38,15,元大-蘆洲,2023-01-05,9857
6116,彩晶,30,15,15,元大-蘆洲,2023-01-05,9857
2368,金像電,29,14,15,元大-蘆洲,2023-01-05,9857
3035,智原,22,7,15,元大-蘆洲,2023-01-05,9857
2002,中鋼,16,1,15,元大-蘆洲,2023-01-05,9857
00850,元大臺灣ESG永續,14,0,14,元大-蘆洲,2023-01-05,9857
2887,台新金,14,0,14,元大-蘆洲,2023-01-05,9857
2867,三商壽,16,3,13,元大-蘆洲,2023-01-05,9857
2498,宏達電,66,53,13,元大-蘆洲,2023-01-05,9857
2723,美食-KY,14,1,13,元大-蘆洲,2023-01-05,9857
1810,和成,14,1,13,元大-蘆洲,2023-01-05,9857
1609,大亞,17,4,13,元大-蘆洲,2023-01-05,9857
3037,欣興,26,14,12,元大-蘆洲,2023-01-05,9857
2313,華通,14,2,12,元大-蘆洲,2023-01-05,9857
1504,東元,23,11,12,元大-蘆洲,2023-01-05,9857
00679B,元大美債20年,11,0,11,元大-蘆洲,2023-01-05,9857
8069,元太,47,36,11,元大-蘆洲,2023-01-05,9857
2618,長榮航,40,29,11,元大-蘆洲,2023-01-05,9857
6443,元晶,32,21,11,元大-蘆洲,2023-01-05,9857
6708,天擎,11,0,11,元大-蘆洲,2023-01-05,9857
4129,聯合,12,1,11,元大-蘆洲,2023-01-05,9857
1789,神隆,10,0,10,元大-蘆洲,2023-01-05,9857
0061,元大寶滬深,10,0,10,元大-蘆洲,2023-01-05,9857
1305,華夏,11,1,10,元大-蘆洲,2023-01-05,9857
00919,群益台灣精選高息,9,0,9,元大-蘆洲,2023-01-05,9857
1301,台塑,10,1,9,元大-蘆洲,2023-01-05,9857
4919,新唐,13,4,9,元大-蘆洲,2023-01-05,9857
0056,元大高股息,16,8,8,元大-蘆洲,2023-01-05,9857
2357,華碩,8,0,8,元大-蘆洲,2023-01-05,9857
6104,創惟,44,36,8,元大-蘆洲,2023-01-05,9857
01003T,兆豐新光R1,7,0,7,元大-蘆洲,2023-01-05,9857
1342,八貫,8,1,7,元大-蘆洲,2023-01-05,9857
00673R,期元大S＆P原油反1,103,0,103,元大-蘆洲,2023-01-06,9857
00720B,元大投資級公司債,102,7,95,元大-蘆洲,2023-01-06,9857
00632R,元大台灣50反1,70,7,63,元大-蘆洲,2023-01-06,9857
2329,華泰,61,5,56,元大-蘆洲,2023-01-06,9857
2880,華南金,50,0,50,元大-蘆洲,2023-01-06,9857
4129,聯合,39,0,39,元大-蘆洲,2023-01-06,9857
2609,陽明,58,19,39,元大-蘆洲,2023-01-06,9857
2317,鴻海,45,6,39,元大-蘆洲,2023-01-06,9857
1513,中興電,48,20,28,元大-蘆洲,2023-01-06,9857
1519,華城,36,14,22,元大-蘆洲,2023-01-06,9857
00715L,期街口布蘭特正2,23,1,22,元大-蘆洲,2023-01-06,9857
5512,力麒,20,0,20,元大-蘆洲,2023-01-06,9857
4157,太景*-KY,20,0,20,元大-蘆洲,2023-01-06,9857
2061,風青,20,0,20,元大-蘆洲,2023-01-06,9857
1529,樂事綠能,36,16,20,元大-蘆洲,2023-01-06,9857
1101,台泥,21,3,18,元大-蘆洲,2023-01-06,9857
6235,華孚,18,1,17,元大-蘆洲,2023-01-06,9857
8105,凌巨,28,12,16,元大-蘆洲,2023-01-06,9857
5475,德宏,15,0,15,元大-蘆洲,2023-01-06,9857
6456,GIS-KY,15,0,15,元大-蘆洲,2023-01-06,9857
1810,和成,17,2,15,元大-蘆洲,2023-01-06,9857
2457,飛宏,15,0,15,元大-蘆洲,2023-01-06,9857
00670L,富邦NASDAQ正2,15,0,15,元大-蘆洲,2023-01-06,9857
2458,義隆,20,6,14,元大-蘆洲,2023-01-06,9857
6118,建達,28,15,13,元大-蘆洲,2023-01-06,9857
3017,奇鋐,12,0,12,元大-蘆洲,2023-01-06,9857
6245,立端,16,4,12,元大-蘆洲,2023-01-06,9857
3293,鈊象,16,4,12,元大-蘆洲,2023-01-06,9857
2618,長榮航,15,4,11,元大-蘆洲,2023-01-06,9857
2338,光罩,19,8,11,元大-蘆洲,2023-01-06,9857
2497,怡利電,10,0,10,元大-蘆洲,2023-01-06,9857
1314,中石化,14,4,10,元大-蘆洲,2023-01-06,9857
00683L,期元大美元指正2,10,0,10,元大-蘆洲,2023-01-06,9857
1569,濱川,10,0,10,元大-蘆洲,2023-01-06,9857
5534,長虹,10,0,10,元大-蘆洲,2023-01-06,9857
00852L,國泰美國道瓊正2,10,0,10,元大-蘆洲,2023-01-06,9857
9919,康那香,10,0,10,元大-蘆洲,2023-01-06,9857
3704,合勤控,53,45,8,元大-蘆洲,2023-01-06,9857
4958,臻鼎-KY,8,0,8,元大-蘆洲,2023-01-06,9857
4961,天鈺,42,34,8,元大-蘆洲,2023-01-06,9857
2884,玉山金,7,0,7,元大-蘆洲,2023-01-06,9857
5608,四維航,8,1,7,元大-蘆洲,2023-01-06,9857
8028,昇陽半導體,12,5,7,元大-蘆洲,2023-01-06,9857
1342,八貫,21,14,7,元大-蘆洲,2023-01-06,9857
6414,樺漢,7,0,7,元大-蘆洲,2023-01-06,9857
3362,先進光,7,0,7,元大-蘆洲,2023-01-06,9857
2308,台達電,6,0,6,元大-蘆洲,2023-01-06,9857
2495,普安,6,0,6,元大-蘆洲,2023-01-06,9857
2812,台中銀,7,1,6,元大-蘆洲,2023-01-06,9857
4943,康控-KY,9,3,6,元大-蘆洲,2023-01-06,9857
00632R,元大台灣50反1,330,0,330,元大-蘆洲,2023-01-09,9857
3576,聯合再生,250,12,238,元大-蘆洲,2023-01-09,9857
2312,金寶,100,1,99,元大-蘆洲,2023-01-09,9857
2885,元大金,100,38,62,元大-蘆洲,2023-01-09,9857
2014,中鴻,100,39,61,元大-蘆洲,2023-01-09,9857
2317,鴻海,59,8,51,元大-蘆洲,2023-01-09,9857
2515,中工,51,0,51,元大-蘆洲,2023-01-09,9857
00631L,元大台灣50正2,43,1,42,元大-蘆洲,2023-01-09,9857
2359,所羅門,37,2,35,元大-蘆洲,2023-01-09,9857
2332,友訊,30,0,30,元大-蘆洲,2023-01-09,9857
00715L,期街口布蘭特正2,23,0,23,元大-蘆洲,2023-01-09,9857
2603,長榮,37,16,21,元大-蘆洲,2023-01-09,9857
3227,原相,24,4,20,元大-蘆洲,2023-01-09,9857
4934,太極,20,0,20,元大-蘆洲,2023-01-09,9857
2457,飛宏,20,0,20,元大-蘆洲,2023-01-09,9857
00772B,中信高評級公司債,21,1,20,元大-蘆洲,2023-01-09,9857
2368,金像電,26,7,19,元大-蘆洲,2023-01-09,9857
00900,富邦特選高股息30,29,10,19,元大-蘆洲,2023-01-09,9857
1605,華新,95,77,18,元大-蘆洲,2023-01-09,9857
2201,裕隆,49,32,17,元大-蘆洲,2023-01-09,9857
2609,陽明,33,16,17,元大-蘆洲,2023-01-09,9857
4129,聯合,18,1,17,元大-蘆洲,2023-01-09,9857
00665L,富邦�琤肭磪囓�2,18,1,17,元大-蘆洲,2023-01-09,9857
2419,仲琦,19,3,16,元大-蘆洲,2023-01-09,9857
8069,元太,43,27,16,元大-蘆洲,2023-01-09,9857
6187,萬潤,15,0,15,元大-蘆洲,2023-01-09,9857
5608,四維航,18,3,15,元大-蘆洲,2023-01-09,9857
00683L,期元大美元指正2,15,0,15,元大-蘆洲,2023-01-09,9857
8028,昇陽半導體,14,0,14,元大-蘆洲,2023-01-09,9857
2313,華通,16,2,14,元大-蘆洲,2023-01-09,9857
00893,國泰智能電動車,19,5,14,元大-蘆洲,2023-01-09,9857
8081,致新,14,1,13,元大-蘆洲,2023-01-09,9857
3034,聯詠,22,10,12,元大-蘆洲,2023-01-09,9857
3380,明泰,12,0,12,元大-蘆洲,2023-01-09,9857
1304,台聚,17,5,12,元大-蘆洲,2023-01-09,9857
8289,泰藝,12,0,12,元大-蘆洲,2023-01-09,9857
2867,三商壽,12,0,12,元大-蘆洲,2023-01-09,9857
8083,瑞穎,12,0,12,元大-蘆洲,2023-01-09,9857
3059,華晶科,12,1,11,元大-蘆洲,2023-01-09,9857
2354,鴻準,15,4,11,元大-蘆洲,2023-01-09,9857
00664R,國泰臺灣加權反1,11,0,11,元大-蘆洲,2023-01-09,9857
4763,材料-KY,16,6,10,元大-蘆洲,2023-01-09,9857
2007,燁興,10,0,10,元大-蘆洲,2023-01-09,9857
5534,長虹,10,0,10,元大-蘆洲,2023-01-09,9857
1104,環泥,10,0,10,元大-蘆洲,2023-01-09,9857
5340,建榮,10,0,10,元大-蘆洲,2023-01-09,9857
2061,風青,10,0,10,元大-蘆洲,2023-01-09,9857
5403,中菲,10,0,10,元大-蘆洲,2023-01-09,9857
6550,北極星藥業-KY,13,4,9,元大-蘆洲,2023-01-09,9857
2597,潤弘,10,1,9,元大-蘆洲,2023-01-09,9857
00878,國泰永續高股息,111,17,94,元大-蘆洲,2023-01-10,9857
6116,彩晶,136,55,81,元大-蘆洲,2023-01-10,9857
00637L,元大滬深300正2,60,0,60,元大-蘆洲,2023-01-10,9857
00720B,元大投資級公司債,62,6,56,元大-蘆洲,2023-01-10,9857
2609,陽明,52,13,39,元大-蘆洲,2023-01-10,9857
1701,中化,37,6,31,元大-蘆洲,2023-01-10,9857
3520,華盈,30,0,30,元大-蘆洲,2023-01-10,9857
00676R,富邦臺灣加權反1,30,0,30,元大-蘆洲,2023-01-10,9857
2615,萬海,42,13,29,元大-蘆洲,2023-01-10,9857
00885,富邦越南,34,6,28,元大-蘆洲,2023-01-10,9857
2641,正德,32,4,28,元大-蘆洲,2023-01-10,9857
1444,力麗,40,16,24,元大-蘆洲,2023-01-10,9857
3356,奇偶,20,0,20,元大-蘆洲,2023-01-10,9857
00852L,國泰美國道瓊正2,18,0,18,元大-蘆洲,2023-01-10,9857
3685,元創精密,18,0,18,元大-蘆洲,2023-01-10,9857
6443,元晶,54,38,16,元大-蘆洲,2023-01-10,9857
2618,長榮航,17,2,15,元大-蘆洲,2023-01-10,9857
3312,弘憶股,15,0,15,元大-蘆洲,2023-01-10,9857
5014,建錩,27,12,15,元大-蘆洲,2023-01-10,9857
2359,所羅門,16,2,14,元大-蘆洲,2023-01-10,9857
3454,晶睿,31,17,14,元大-蘆洲,2023-01-10,9857
6153,嘉聯益,15,2,13,元大-蘆洲,2023-01-10,9857
1417,嘉裕,19,6,13,元大-蘆洲,2023-01-10,9857
1605,華新,70,57,13,元大-蘆洲,2023-01-10,9857
2882,國泰金,17,6,11,元大-蘆洲,2023-01-10,9857
3027,盛達,37,26,11,元大-蘆洲,2023-01-10,9857
6129,普誠,13,2,11,元大-蘆洲,2023-01-10,9857
00715L,期街口布蘭特正2,11,0,11,元大-蘆洲,2023-01-10,9857
6446,藥華藥,10,0,10,元大-蘆洲,2023-01-10,9857
3128,昇銳,26,16,10,元大-蘆洲,2023-01-10,9857
4161,聿新科,10,0,10,元大-蘆洲,2023-01-10,9857
4743,合一,16,6,10,元大-蘆洲,2023-01-10,9857
2537,聯上發,10,0,10,元大-蘆洲,2023-01-10,9857
2332,友訊,10,0,10,元大-蘆洲,2023-01-10,9857
2482,連宇,23,13,10,元大-蘆洲,2023-01-10,9857
9105,泰金寶-DR,10,0,10,元大-蘆洲,2023-01-10,9857
2601,益航,10,0,10,元大-蘆洲,2023-01-10,9857
1708,東鹼,17,8,9,元大-蘆洲,2023-01-10,9857
4129,聯合,24,15,9,元大-蘆洲,2023-01-10,9857
1513,中興電,40,32,8,元大-蘆洲,2023-01-10,9857
2338,光罩,11,3,8,元大-蘆洲,2023-01-10,9857
3093,港建*,8,0,8,元大-蘆洲,2023-01-10,9857
3390,旭軟,14,6,8,元大-蘆洲,2023-01-10,9857
2102,泰豐,8,0,8,元大-蘆洲,2023-01-10,9857
4934,太極,8,0,8,元大-蘆洲,2023-01-10,9857
2312,金寶,8,0,8,元大-蘆洲,2023-01-10,9857
2610,華航,12,4,8,元大-蘆洲,2023-01-10,9857
5258,虹堡,12,4,8,元大-蘆洲,2023-01-10,9857
3545,敦泰,12,4,8,元大-蘆洲,2023-01-10,9857
2317,鴻海,11,3,8,元大-蘆洲,2023-01-10,9857
3576,聯合再生,105,2,103,元大-蘆洲,2023-01-11,9857
4129,聯合,67,0,67,元大-蘆洲,2023-01-11,9857
5876,上海商銀,50,0,50,元大-蘆洲,2023-01-11,9857
00632R,元大台灣50反1,46,0,46,元大-蘆洲,2023-01-11,9857
2313,華通,44,6,38,元大-蘆洲,2023-01-11,9857
2610,華航,76,40,36,元大-蘆洲,2023-01-11,9857
2002,中鋼,39,6,33,元大-蘆洲,2023-01-11,9857
4904,遠傳,33,4,29,元大-蘆洲,2023-01-11,9857
1810,和成,23,0,23,元大-蘆洲,2023-01-11,9857
2359,所羅門,23,2,21,元大-蘆洲,2023-01-11,9857
2332,友訊,21,0,21,元大-蘆洲,2023-01-11,9857
9907,統一實,20,0,20,元大-蘆洲,2023-01-11,9857
2607,榮運,20,1,19,元大-蘆洲,2023-01-11,9857
3037,欣興,33,15,18,元大-蘆洲,2023-01-11,9857
2884,玉山金,17,1,16,元大-蘆洲,2023-01-11,9857
3163,波若威,20,4,16,元大-蘆洲,2023-01-11,9857
3045,台灣大,16,1,15,元大-蘆洲,2023-01-11,9857
1584,精剛,27,12,15,元大-蘆洲,2023-01-11,9857
4956,光鋐,15,0,15,元大-蘆洲,2023-01-11,9857
4919,新唐,25,10,15,元大-蘆洲,2023-01-11,9857
6111,大宇資,22,7,15,元大-蘆洲,2023-01-11,9857
6276,安鈦克,15,1,14,元大-蘆洲,2023-01-11,9857
6139,亞翔,13,1,12,元大-蘆洲,2023-01-11,9857
1605,華新,27,16,11,元大-蘆洲,2023-01-11,9857
1701,中化,34,23,11,元大-蘆洲,2023-01-11,9857
2903,遠百,11,0,11,元大-蘆洲,2023-01-11,9857
2851,中再保,12,1,11,元大-蘆洲,2023-01-11,9857
00680L,元大美債20正2,11,0,11,元大-蘆洲,2023-01-11,9857
3704,合勤控,25,15,10,元大-蘆洲,2023-01-11,9857
1560,中砂,28,18,10,元大-蘆洲,2023-01-11,9857
1533,車王電,10,0,10,元大-蘆洲,2023-01-11,9857
4142,國光生,10,0,10,元大-蘆洲,2023-01-11,9857
2543,皇昌,10,0,10,元大-蘆洲,2023-01-11,9857
3669,圓展,10,0,10,元大-蘆洲,2023-01-11,9857
4157,太景*-KY,10,0,10,元大-蘆洲,2023-01-11,9857
6282,康舒,10,0,10,元大-蘆洲,2023-01-11,9857
2603,長榮,45,35,10,元大-蘆洲,2023-01-11,9857
2409,友達,22,12,10,元大-蘆洲,2023-01-11,9857
5351,鈺創,18,9,9,元大-蘆洲,2023-01-11,9857
5347,世界,11,2,9,元大-蘆洲,2023-01-11,9857
8033,雷虎,11,2,9,元大-蘆洲,2023-01-11,9857
3479,安勤,19,10,9,元大-蘆洲,2023-01-11,9857
2615,萬海,27,18,9,元大-蘆洲,2023-01-11,9857
4943,康控-KY,11,2,9,元大-蘆洲,2023-01-11,9857
2892,第一金,11,2,9,元大-蘆洲,2023-01-11,9857
8069,元太,14,6,8,元大-蘆洲,2023-01-11,9857
1708,東鹼,8,0,8,元大-蘆洲,2023-01-11,9857
2455,全新,9,1,8,元大-蘆洲,2023-01-11,9857
3702,大聯大,9,1,8,元大-蘆洲,2023-01-11,9857
3380,明泰,10,2,8,元大-蘆洲,2023-01-11,9857
3231,緯創,196,18,178,元大-蘆洲,2023-01-12,9857
3037,欣興,75,9,66,元大-蘆洲,2023-01-12,9857
2312,金寶,54,0,54,元大-蘆洲,2023-01-12,9857
00637L,元大滬深300正2,54,1,53,元大-蘆洲,2023-01-12,9857
2014,中鴻,63,28,35,元大-蘆洲,2023-01-12,9857
6205,詮欣,34,1,33,元大-蘆洲,2023-01-12,9857
3094,聯傑,29,0,29,元大-蘆洲,2023-01-12,9857
00882,中信中國高股息,27,0,27,元大-蘆洲,2023-01-12,9857
00665L,富邦�琤肭磪囓�2,83,56,27,元大-蘆洲,2023-01-12,9857
2748,雲品,30,3,27,元大-蘆洲,2023-01-12,9857
2891,中信金,25,0,25,元大-蘆洲,2023-01-12,9857
3521,鴻翊,25,0,25,元大-蘆洲,2023-01-12,9857
1314,中石化,32,7,25,元大-蘆洲,2023-01-12,9857
2892,第一金,24,0,24,元大-蘆洲,2023-01-12,9857
3163,波若威,25,3,22,元大-蘆洲,2023-01-12,9857
00753L,中信中國50正2,32,11,21,元大-蘆洲,2023-01-12,9857
2607,榮運,22,1,21,元大-蘆洲,2023-01-12,9857
4904,遠傳,19,0,19,元大-蘆洲,2023-01-12,9857
2465,麗臺,20,1,19,元大-蘆洲,2023-01-12,9857
5347,世界,26,8,18,元大-蘆洲,2023-01-12,9857
9919,康那香,17,0,17,元大-蘆洲,2023-01-12,9857
1605,華新,94,77,17,元大-蘆洲,2023-01-12,9857
4128,中天,16,0,16,元大-蘆洲,2023-01-12,9857
6770,力積電,27,11,16,元大-蘆洲,2023-01-12,9857
2618,長榮航,29,14,15,元大-蘆洲,2023-01-12,9857
1810,和成,21,6,15,元大-蘆洲,2023-01-12,9857
2609,陽明,28,14,14,元大-蘆洲,2023-01-12,9857
4743,合一,35,22,13,元大-蘆洲,2023-01-12,9857
2388,威盛,35,22,13,元大-蘆洲,2023-01-12,9857
5371,中光電,16,3,13,元大-蘆洲,2023-01-12,9857
8150,南茂,13,0,13,元大-蘆洲,2023-01-12,9857
2615,萬海,28,16,12,元大-蘆洲,2023-01-12,9857
00673R,期元大S＆P原油反1,12,0,12,元大-蘆洲,2023-01-12,9857
1513,中興電,18,7,11,元大-蘆洲,2023-01-12,9857
8076,伍豐,15,4,11,元大-蘆洲,2023-01-12,9857
00916,國泰全球品牌50,16,5,11,元大-蘆洲,2023-01-12,9857
2610,華航,23,13,10,元大-蘆洲,2023-01-12,9857
2880,華南金,10,0,10,元大-蘆洲,2023-01-12,9857
1519,華城,16,6,10,元大-蘆洲,2023-01-12,9857
1342,八貫,10,0,10,元大-蘆洲,2023-01-12,9857
2317,鴻海,14,4,10,元大-蘆洲,2023-01-12,9857
3006,晶豪科,26,16,10,元大-蘆洲,2023-01-12,9857
3042,晶技,11,1,10,元大-蘆洲,2023-01-12,9857
6550,北極星藥業-KY,10,0,10,元大-蘆洲,2023-01-12,9857
5321,美而快,28,18,10,元大-蘆洲,2023-01-12,9857
2028,威致,12,2,10,元大-蘆洲,2023-01-12,9857
1340,勝悅-KY,10,0,10,元大-蘆洲,2023-01-12,9857
1219,福壽,10,0,10,元大-蘆洲,2023-01-12,9857
6509,聚和,10,0,10,元大-蘆洲,2023-01-12,9857
6609,瀧澤科,14,4,10,元大-蘆洲,2023-01-12,9857
3693,營邦,63,3,60,元大-蘆洲,2023-01-13,9857
2312,金寶,56,0,56,元大-蘆洲,2023-01-13,9857
2313,華通,44,2,42,元大-蘆洲,2023-01-13,9857
2610,華航,55,17,38,元大-蘆洲,2023-01-13,9857
00753L,中信中國50正2,35,0,35,元大-蘆洲,2023-01-13,9857
2915,潤泰全,30,0,30,元大-蘆洲,2023-01-13,9857
2498,宏達電,67,38,29,元大-蘆洲,2023-01-13,9857
2748,雲品,30,2,28,元大-蘆洲,2023-01-13,9857
00878,國泰永續高股息,47,20,27,元大-蘆洲,2023-01-13,9857
6153,嘉聯益,25,0,25,元大-蘆洲,2023-01-13,9857
00679B,元大美債20年,36,13,23,元大-蘆洲,2023-01-13,9857
00900,富邦特選高股息30,24,1,23,元大-蘆洲,2023-01-13,9857
00882,中信中國高股息,25,2,23,元大-蘆洲,2023-01-13,9857
2867,三商壽,21,0,21,元大-蘆洲,2023-01-13,9857
00772B,中信高評級公司債,22,1,21,元大-蘆洲,2023-01-13,9857
6182,合晶,21,0,21,元大-蘆洲,2023-01-13,9857
8027,鈦昇,24,5,19,元大-蘆洲,2023-01-13,9857
6118,建達,30,11,19,元大-蘆洲,2023-01-13,9857
2892,第一金,21,3,18,元大-蘆洲,2023-01-13,9857
2614,東森,22,5,17,元大-蘆洲,2023-01-13,9857
2388,威盛,25,10,15,元大-蘆洲,2023-01-13,9857
00673R,期元大S＆P原油反1,15,0,15,元大-蘆洲,2023-01-13,9857
2891,中信金,16,2,14,元大-蘆洲,2023-01-13,9857
2331,精英,14,0,14,元大-蘆洲,2023-01-13,9857
3035,智原,25,12,13,元大-蘆洲,2023-01-13,9857
9105,泰金寶-DR,13,0,13,元大-蘆洲,2023-01-13,9857
3189,景碩,17,6,11,元大-蘆洲,2023-01-13,9857
00720B,元大投資級公司債,12,1,11,元大-蘆洲,2023-01-13,9857
6282,康舒,13,2,11,元大-蘆洲,2023-01-13,9857
4763,材料-KY,27,17,10,元大-蘆洲,2023-01-13,9857
01003T,兆豐新光R1,10,0,10,元大-蘆洲,2023-01-13,9857
4128,中天,10,0,10,元大-蘆洲,2023-01-13,9857
1313,聯成,10,0,10,元大-蘆洲,2023-01-13,9857
2104,國際中橡,10,0,10,元大-蘆洲,2023-01-13,9857
6284,佳邦,10,0,10,元大-蘆洲,2023-01-13,9857
2332,友訊,10,0,10,元大-蘆洲,2023-01-13,9857
6509,聚和,10,0,10,元大-蘆洲,2023-01-13,9857
5478,智冠,9,0,9,元大-蘆洲,2023-01-13,9857
1529,樂事綠能,12,3,9,元大-蘆洲,2023-01-13,9857
3042,晶技,10,1,9,元大-蘆洲,2023-01-13,9857
00770,國泰北美科技,18,9,9,元大-蘆洲,2023-01-13,9857
1785,光洋科,10,1,9,元大-蘆洲,2023-01-13,9857
3708,上緯投控,9,0,9,元大-蘆洲,2023-01-13,9857
2883,凱基金,9,1,8,元大-蘆洲,2023-01-13,9857
2885,元大金,15,6,9,元大-蘆洲,2023-01-13,9857
2352,佳世達,8,0,8,元大-蘆洲,2023-01-13,9857
1611,中電,8,0,8,元大-蘆洲,2023-01-13,9857
2357,華碩,8,0,8,元大-蘆洲,2023-01-13,9857
2465,麗臺,45,37,8,元大-蘆洲,2023-01-13,9857
00725B,國泰投資級公司債,8,0,8,元大-蘆洲,2023-01-13,9857
4707,磐亞,100,0,100,元大-蘆洲,2023-01-16,9857
00632R,元大台灣50反1,124,31,93,元大-蘆洲,2023-01-16,9857
2867,三商壽,55,0,55,元大-蘆洲,2023-01-16,9857
2609,陽明,75,27,48,元大-蘆洲,2023-01-16,9857
00679B,元大美債20年,49,9,40,元大-蘆洲,2023-01-16,9857
1584,精剛,44,7,37,元大-蘆洲,2023-01-16,9857
2610,華航,41,7,34,元大-蘆洲,2023-01-16,9857
2317,鴻海,33,0,33,元大-蘆洲,2023-01-16,9857
00720B,元大投資級公司債,40,13,27,元大-蘆洲,2023-01-16,9857
00772B,中信高評級公司債,23,1,22,元大-蘆洲,2023-01-16,9857
5512,力麒,20,2,18,元大-蘆洲,2023-01-16,9857
6770,力積電,43,27,16,元大-蘆洲,2023-01-16,9857
2515,中工,26,10,16,元大-蘆洲,2023-01-16,9857
2465,麗臺,26,13,13,元大-蘆洲,2023-01-16,9857
00882,中信中國高股息,41,29,12,元大-蘆洲,2023-01-16,9857
00725B,國泰投資級公司債,12,0,12,元大-蘆洲,2023-01-16,9857
2204,中華,12,0,12,元大-蘆洲,2023-01-16,9857
2889,國票金,14,2,12,元大-蘆洲,2023-01-16,9857
020023,元大櫃買半導體N,10,0,10,元大-蘆洲,2023-01-16,9857
2061,風青,10,0,10,元大-蘆洲,2023-01-16,9857
8933,愛地雅,10,0,10,元大-蘆洲,2023-01-16,9857
2368,金像電,19,9,10,元大-蘆洲,2023-01-16,9857
2312,金寶,10,0,10,元大-蘆洲,2023-01-16,9857
00770,國泰北美科技,21,12,9,元大-蘆洲,2023-01-16,9857
2498,宏達電,9,0,9,元大-蘆洲,2023-01-16,9857
4904,遠傳,10,1,9,元大-蘆洲,2023-01-16,9857
2027,大成鋼,10,1,9,元大-蘆洲,2023-01-16,9857
4162,智擎,22,13,9,元大-蘆洲,2023-01-16,9857
5009,榮剛,14,6,8,元大-蘆洲,2023-01-16,9857
6782,視陽,11,4,7,元大-蘆洲,2023-01-16,9857
6188,廣明,8,1,7,元大-蘆洲,2023-01-16,9857
1909,榮成,17,10,7,元大-蘆洲,2023-01-16,9857
00751B,元大AAA至A公司債,7,0,7,元大-蘆洲,2023-01-16,9857
5483,中美晶,7,0,7,元大-蘆洲,2023-01-16,9857
00671R,富邦NASDAQ反1,10,3,7,元大-蘆洲,2023-01-16,9857
2801,彰銀,12,5,7,元大-蘆洲,2023-01-16,9857
6499,益安,6,0,6,元大-蘆洲,2023-01-16,9857
2851,中再保,6,0,6,元大-蘆洲,2023-01-16,9857
3669,圓展,6,0,6,元大-蘆洲,2023-01-16,9857
1701,中化,17,11,6,元大-蘆洲,2023-01-16,9857
9919,康那香,6,0,6,元大-蘆洲,2023-01-16,9857
1309,台達化,6,0,6,元大-蘆洲,2023-01-16,9857
3221,台嘉碩,6,0,6,元大-蘆洲,2023-01-16,9857
6176,瑞儀,6,0,6,元大-蘆洲,2023-01-16,9857
3022,威強電,6,0,6,元大-蘆洲,2023-01-16,9857
00881,國泰台灣5G+,7,1,6,元大-蘆洲,2023-01-16,9857
2539,櫻花建,5,0,5,元大-蘆洲,2023-01-16,9857
5608,四維航,10,5,5,元大-蘆洲,2023-01-16,9857
5425,台半,10,5,5,元大-蘆洲,2023-01-16,9857
8421,旭源,5,0,5,元大-蘆洲,2023-01-16,9857
2890,永豐金,200,16,184,元大-蘆洲,2023-01-17,9857
00632R,元大台灣50反1,165,10,155,元大-蘆洲,2023-01-17,9857
00902,中信電池及儲能,130,8,122,元大-蘆洲,2023-01-17,9857
2882,國泰金,107,17,90,元大-蘆洲,2023-01-17,9857
2002,中鋼,107,25,82,元大-蘆洲,2023-01-17,9857
2748,雲品,110,32,78,元大-蘆洲,2023-01-17,9857
4904,遠傳,68,0,68,元大-蘆洲,2023-01-17,9857
6770,力積電,72,12,60,元大-蘆洲,2023-01-17,9857
5258,虹堡,55,7,48,元大-蘆洲,2023-01-17,9857
00882,中信中國高股息,51,8,43,元大-蘆洲,2023-01-17,9857
00637L,元大滬深300正2,42,0,42,元大-蘆洲,2023-01-17,9857
00679B,元大美債20年,34,0,34,元大-蘆洲,2023-01-17,9857
2313,華通,42,8,34,元大-蘆洲,2023-01-17,9857
00655L,國泰中國A50正2,32,0,32,元大-蘆洲,2023-01-17,9857
2618,長榮航,38,7,31,元大-蘆洲,2023-01-17,9857
020023,元大櫃買半導體N,26,0,26,元大-蘆洲,2023-01-17,9857
2884,玉山金,25,0,25,元大-蘆洲,2023-01-17,9857
3037,欣興,27,3,24,元大-蘆洲,2023-01-17,9857
0050,元大台灣50,28,4,24,元大-蘆洲,2023-01-17,9857
1313,聯成,22,0,22,元大-蘆洲,2023-01-17,9857
1417,嘉裕,21,0,21,元大-蘆洲,2023-01-17,9857
1219,福壽,25,5,20,元大-蘆洲,2023-01-17,9857
3481,群創,30,12,18,元大-蘆洲,2023-01-17,9857
2636,台驊控股,16,0,16,元大-蘆洲,2023-01-17,9857
2317,鴻海,19,4,15,元大-蘆洲,2023-01-17,9857
3272,東碩,15,0,15,元大-蘆洲,2023-01-17,9857
4167,松瑞藥,15,0,15,元大-蘆洲,2023-01-17,9857
2022,聚亨,13,0,13,元大-蘆洲,2023-01-17,9857
2812,台中銀,13,1,12,元大-蘆洲,2023-01-17,9857
2338,光罩,18,6,12,元大-蘆洲,2023-01-17,9857
2367,燿華,20,8,12,元大-蘆洲,2023-01-17,9857
00675L,富邦臺灣加權正2,12,0,12,元大-蘆洲,2023-01-17,9857
1752,南光,13,1,12,元大-蘆洲,2023-01-17,9857
2603,長榮,16,4,12,元大-蘆洲,2023-01-17,9857
00720B,元大投資級公司債,11,0,11,元大-蘆洲,2023-01-17,9857
3714,富采,10,0,10,元大-蘆洲,2023-01-17,9857
2515,中工,10,0,10,元大-蘆洲,2023-01-17,9857
2061,風青,10,0,10,元大-蘆洲,2023-01-17,9857
1584,精剛,15,6,9,元大-蘆洲,2023-01-17,9857
00676R,富邦臺灣加權反1,9,0,9,元大-蘆洲,2023-01-17,9857
1736,喬山,8,0,8,元大-蘆洲,2023-01-17,9857
2340,台亞,20,12,8,元大-蘆洲,2023-01-17,9857
2419,仲琦,8,0,8,元大-蘆洲,2023-01-17,9857
8069,元太,23,15,8,元大-蘆洲,2023-01-17,9857
2607,榮運,11,3,8,元大-蘆洲,2023-01-17,9857
3013,晟銘電,18,11,7,元大-蘆洲,2023-01-17,9857
4114,健喬,11,4,7,元大-蘆洲,2023-01-17,9857
1608,華榮,11,4,7,元大-蘆洲,2023-01-17,9857
8358,金居,18,12,6,元大-蘆洲,2023-01-17,9857
00713,元大台灣高息低波,6,0,6,元大-蘆洲,2023-01-17,9857
00632R,元大台灣50反1,567,380,187,元大-蘆洲,2023-01-30,9857
00878,國泰永續高股息,251,128,123,元大-蘆洲,2023-01-30,9857
3624,光頡,116,13,103,元大-蘆洲,2023-01-30,9857
2317,鴻海,89,2,87,元大-蘆洲,2023-01-30,9857
2891,中信金,111,28,83,元大-蘆洲,2023-01-30,9857
2897,王道銀行,97,32,65,元大-蘆洲,2023-01-30,9857
2609,陽明,82,25,57,元大-蘆洲,2023-01-30,9857
2915,潤泰全,50,1,49,元大-蘆洲,2023-01-30,9857
2867,三商壽,49,0,49,元大-蘆洲,2023-01-30,9857
2359,所羅門,47,0,47,元大-蘆洲,2023-01-30,9857
00665L,富邦�琤肭磪囓�2,89,45,44,元大-蘆洲,2023-01-30,9857
9945,潤泰新,59,17,42,元大-蘆洲,2023-01-30,9857
4904,遠傳,65,30,35,元大-蘆洲,2023-01-30,9857
5243,乙盛-KY,32,3,29,元大-蘆洲,2023-01-30,9857
8069,元太,54,26,28,元大-蘆洲,2023-01-30,9857
2358,廷鑫,26,0,26,元大-蘆洲,2023-01-30,9857
00673R,期元大S＆P原油反1,25,0,25,元大-蘆洲,2023-01-30,9857
4768,晶呈科技,24,2,22,元大-蘆洲,2023-01-30,9857
00720B,元大投資級公司債,20,0,20,元大-蘆洲,2023-01-30,9857
00655L,國泰中國A50正2,20,0,20,元大-蘆洲,2023-01-30,9857
8038,長園科,26,6,20,元大-蘆洲,2023-01-30,9857
9105,泰金寶-DR,20,0,20,元大-蘆洲,2023-01-30,9857
3715,定穎投控,20,0,20,元大-蘆洲,2023-01-30,9857
6245,立端,27,9,18,元大-蘆洲,2023-01-30,9857
2352,佳世達,23,5,18,元大-蘆洲,2023-01-30,9857
00772B,中信高評級公司債,17,0,17,元大-蘆洲,2023-01-30,9857
2834,臺企銀,40,23,17,元大-蘆洲,2023-01-30,9857
6142,友勁,15,0,15,元大-蘆洲,2023-01-30,9857
2402,毅嘉,20,5,15,元大-蘆洲,2023-01-30,9857
5498,凱崴,14,0,14,元大-蘆洲,2023-01-30,9857
2368,金像電,23,10,13,元大-蘆洲,2023-01-30,9857
00751B,元大AAA至A公司債,13,0,13,元大-蘆洲,2023-01-30,9857
1301,台塑,15,3,12,元大-蘆洲,2023-01-30,9857
2027,大成鋼,15,3,12,元大-蘆洲,2023-01-30,9857
2353,宏��,14,3,11,元大-蘆洲,2023-01-30,9857
6224,聚鼎,10,0,10,元大-蘆洲,2023-01-30,9857
00780B,國泰A級金融債,10,0,10,元大-蘆洲,2023-01-30,9857
00676R,富邦臺灣加權反1,12,2,10,元大-蘆洲,2023-01-30,9857
6206,飛捷,10,0,10,元大-蘆洲,2023-01-30,9857
3591,艾笛森,10,0,10,元大-蘆洲,2023-01-30,9857
6167,久正,10,0,10,元大-蘆洲,2023-01-30,9857
00674R,期元大S＆P黃金反1,10,0,10,元大-蘆洲,2023-01-30,9857
6174,安��,10,0,10,元大-蘆洲,2023-01-30,9857
00786B,元大10年IG銀行債,10,0,10,元大-蘆洲,2023-01-30,9857
2208,台船,11,2,9,元大-蘆洲,2023-01-30,9857
2038,海光,12,3,9,元大-蘆洲,2023-01-30,9857
3265,台星科,20,11,9,元大-蘆洲,2023-01-30,9857
6719,力智,13,4,9,元大-蘆洲,2023-01-30,9857
2308,台達電,12,4,8,元大-蘆洲,2023-01-30,9857
2457,飛宏,11,3,8,元大-蘆洲,2023-01-30,9857
00905,FT臺灣Smart,332,1,331,元大-蘆洲,2023-01-31,9857
2892,第一金,176,0,176,元大-蘆洲,2023-01-31,9857
00632R,元大台灣50反1,138,24,114,元大-蘆洲,2023-01-31,9857
00679B,元大美債20年,105,0,105,元大-蘆洲,2023-01-31,9857
00673R,期元大S＆P原油反1,100,0,100,元大-蘆洲,2023-01-31,9857
2885,元大金,142,64,78,元大-蘆洲,2023-01-31,9857
2613,中櫃,54,0,54,元大-蘆洲,2023-01-31,9857
9105,泰金寶-DR,82,30,52,元大-蘆洲,2023-01-31,9857
00637L,元大滬深300正2,60,10,50,元大-蘆洲,2023-01-31,9857
2542,興富發,50,0,50,元大-蘆洲,2023-01-31,9857
4904,遠傳,45,2,43,元大-蘆洲,2023-01-31,9857
2897,王道銀行,42,0,42,元大-蘆洲,2023-01-31,9857
00671R,富邦NASDAQ反1,43,3,40,元大-蘆洲,2023-01-31,9857
2359,所羅門,41,5,36,元大-蘆洲,2023-01-31,9857
6120,達運,35,1,34,元大-蘆洲,2023-01-31,9857
2883,凱基金,46,12,34,元大-蘆洲,2023-01-31,9857
4114,健喬,50,17,33,元大-蘆洲,2023-01-31,9857
1711,永光,33,1,32,元大-蘆洲,2023-01-31,9857
00664R,國泰臺灣加權反1,32,0,32,元大-蘆洲,2023-01-31,9857
0056,元大高股息,56,25,31,元大-蘆洲,2023-01-31,9857
00720B,元大投資級公司債,27,0,27,元大-蘆洲,2023-01-31,9857
1514,亞力,37,10,27,元大-蘆洲,2023-01-31,9857
2002,中鋼,39,13,26,元大-蘆洲,2023-01-31,9857
00885,富邦越南,31,5,26,元大-蘆洲,2023-01-31,9857
2344,華邦電,30,6,24,元大-蘆洲,2023-01-31,9857
6153,嘉聯益,23,1,22,元大-蘆洲,2023-01-31,9857
00665L,富邦�琤肭磪囓�2,22,0,22,元大-蘆洲,2023-01-31,9857
2027,大成鋼,27,5,22,元大-蘆洲,2023-01-31,9857
2323,中環,23,2,21,元大-蘆洲,2023-01-31,9857
2230,泰茂,22,1,21,元大-蘆洲,2023-01-31,9857
6235,華孚,23,3,20,元大-蘆洲,2023-01-31,9857
4157,太景*-KY,20,0,20,元大-蘆洲,2023-01-31,9857
2603,長榮,26,6,20,元大-蘆洲,2023-01-31,9857
006208,富邦台50,21,1,20,元大-蘆洲,2023-01-31,9857
2330,台積電,40,21,19,元大-蘆洲,2023-01-31,9857
00900,富邦特選高股息30,32,14,18,元大-蘆洲,2023-01-31,9857
2305,全友,18,0,18,元大-蘆洲,2023-01-31,9857
6477,安集,22,4,18,元大-蘆洲,2023-01-31,9857
1504,東元,18,0,18,元大-蘆洲,2023-01-31,9857
2884,玉山金,22,5,17,元大-蘆洲,2023-01-31,9857
6111,大宇資,18,2,16,元大-蘆洲,2023-01-31,9857
2615,萬海,33,18,15,元大-蘆洲,2023-01-31,9857
8289,泰藝,15,0,15,元大-蘆洲,2023-01-31,9857
1701,中化,27,13,14,元大-蘆洲,2023-01-31,9857
4934,太極,54,40,14,元大-蘆洲,2023-01-31,9857
2886,兆豐金,13,0,13,元大-蘆洲,2023-01-31,9857
3708,上緯投控,22,9,13,元大-蘆洲,2023-01-31,9857
00715L,期街口布蘭特正2,13,0,13,元大-蘆洲,2023-01-31,9857
1336,台翰,13,1,12,元大-蘆洲,2023-01-31,9857
00642U,期元大S＆P石油,12,0,12,元大-蘆洲,2023-01-31,9857
9105,泰金寶-DR,110,0,110,元大-蘆洲,2023-02-01,9857
6202,盛群,116,7,109,元大-蘆洲,2023-02-01,9857
00905,FT臺灣Smart,77,0,77,元大-蘆洲,2023-02-01,9857
00878,國泰永續高股息,78,12,66,元大-蘆洲,2023-02-01,9857
9904,寶成,55,0,55,元大-蘆洲,2023-02-01,9857
3576,聯合再生,54,0,54,元大-蘆洲,2023-02-01,9857
2317,鴻海,64,11,53,元大-蘆洲,2023-02-01,9857
4167,松瑞藥,52,3,49,元大-蘆洲,2023-02-01,9857
2409,友達,74,30,44,元大-蘆洲,2023-02-01,9857
2897,王道銀行,43,0,43,元大-蘆洲,2023-02-01,9857
0056,元大高股息,75,35,40,元大-蘆洲,2023-02-01,9857
3047,訊舟,40,2,38,元大-蘆洲,2023-02-01,9857
2359,所羅門,40,2,38,元大-蘆洲,2023-02-01,9857
2368,金像電,46,10,36,元大-蘆洲,2023-02-01,9857
4142,國光生,41,5,36,元大-蘆洲,2023-02-01,9857
6477,安集,41,6,35,元大-蘆洲,2023-02-01,9857
2891,中信金,56,25,31,元大-蘆洲,2023-02-01,9857
1342,八貫,31,3,28,元大-蘆洲,2023-02-01,9857
6005,群益證,26,0,26,元大-蘆洲,2023-02-01,9857
1609,大亞,84,58,26,元大-蘆洲,2023-02-01,9857
2340,台亞,36,11,25,元大-蘆洲,2023-02-01,9857
2030,彰源,35,10,25,元大-蘆洲,2023-02-01,9857
1701,中化,24,1,23,元大-蘆洲,2023-02-01,9857
5009,榮剛,54,32,22,元大-蘆洲,2023-02-01,9857
00882,中信中國高股息,20,0,20,元大-蘆洲,2023-02-01,9857
5243,乙盛-KY,20,0,20,元大-蘆洲,2023-02-01,9857
2006,東和鋼鐵,19,0,19,元大-蘆洲,2023-02-01,9857
6180,橘子,29,10,19,元大-蘆洲,2023-02-01,9857
2883,凱基金,20,3,17,元大-蘆洲,2023-02-01,9857
1443,立益物流,20,4,16,元大-蘆洲,2023-02-01,9857
6142,友勁,15,0,15,元大-蘆洲,2023-02-01,9857
6550,北極星藥業-KY,18,3,15,元大-蘆洲,2023-02-01,9857
3454,晶睿,20,6,14,元大-蘆洲,2023-02-01,9857
2929,淘帝-KY,85,71,14,元大-蘆洲,2023-02-01,9857
6603,富強鑫,13,0,13,元大-蘆洲,2023-02-01,9857
5392,能率,13,0,13,元大-蘆洲,2023-02-01,9857
2367,燿華,29,17,12,元大-蘆洲,2023-02-01,9857
2892,第一金,12,0,12,元大-蘆洲,2023-02-01,9857
4763,材料-KY,41,30,11,元大-蘆洲,2023-02-01,9857
3521,鴻翊,11,0,11,元大-蘆洲,2023-02-01,9857
00715L,期街口布蘭特正2,14,3,11,元大-蘆洲,2023-02-01,9857
2486,一詮,12,1,11,元大-蘆洲,2023-02-01,9857
1907,永豐餘,22,11,11,元大-蘆洲,2023-02-01,9857
1734,杏輝,12,1,11,元大-蘆洲,2023-02-01,9857
3027,盛達,21,10,11,元大-蘆洲,2023-02-01,9857
2455,全新,19,9,10,元大-蘆洲,2023-02-01,9857
2485,兆赫,10,0,10,元大-蘆洲,2023-02-01,9857
2498,宏達電,15,5,10,元大-蘆洲,2023-02-01,9857
00773B,中信優先金融債,10,0,10,元大-蘆洲,2023-02-01,9857
3325,旭品,10,0,10,元大-蘆洲,2023-02-01,9857
2002,中鋼,504,4,500,元大-蘆洲,2023-02-02,9857
00632R,元大台灣50反1,293,33,260,元大-蘆洲,2023-02-02,9857
2409,友達,182,7,175,元大-蘆洲,2023-02-02,9857
00878,國泰永續高股息,111,21,90,元大-蘆洲,2023-02-02,9857
2880,華南金,87,5,82,元大-蘆洲,2023-02-02,9857
2317,鴻海,77,14,63,元大-蘆洲,2023-02-02,9857
00720B,元大投資級公司債,55,1,54,元大-蘆洲,2023-02-02,9857
00633L,富邦上証正2,53,0,53,元大-蘆洲,2023-02-02,9857
6443,元晶,106,56,50,元大-蘆洲,2023-02-02,9857
2511,太子,50,0,50,元大-蘆洲,2023-02-02,9857
6237,驊訊,46,1,45,元大-蘆洲,2023-02-02,9857
2201,裕隆,84,42,42,元大-蘆洲,2023-02-02,9857
3494,誠研,40,0,40,元大-蘆洲,2023-02-02,9857
2313,華通,57,17,40,元大-蘆洲,2023-02-02,9857
9105,泰金寶-DR,41,2,39,元大-蘆洲,2023-02-02,9857
00900,富邦特選高股息30,93,55,38,元大-蘆洲,2023-02-02,9857
1789,神隆,45,10,35,元大-蘆洲,2023-02-02,9857
0056,元大高股息,62,35,27,元大-蘆洲,2023-02-02,9857
5351,鈺創,77,50,27,元大-蘆洲,2023-02-02,9857
00679B,元大美債20年,24,0,24,元大-蘆洲,2023-02-02,9857
9904,寶成,24,0,24,元大-蘆洲,2023-02-02,9857
5392,能率,26,3,23,元大-蘆洲,2023-02-02,9857
2492,華新科,30,8,22,元大-蘆洲,2023-02-02,9857
00882,中信中國高股息,21,0,21,元大-蘆洲,2023-02-02,9857
1609,大亞,109,89,20,元大-蘆洲,2023-02-02,9857
5347,世界,20,0,20,元大-蘆洲,2023-02-02,9857
3207,耀勝,55,37,18,元大-蘆洲,2023-02-02,9857
5009,榮剛,23,6,17,元大-蘆洲,2023-02-02,9857
00715L,期街口布蘭特正2,17,0,17,元大-蘆洲,2023-02-02,9857
00671R,富邦NASDAQ反1,17,0,17,元大-蘆洲,2023-02-02,9857
3704,合勤控,44,28,16,元大-蘆洲,2023-02-02,9857
2231,為升,18,2,16,元大-蘆洲,2023-02-02,9857
5258,虹堡,21,6,15,元大-蘆洲,2023-02-02,9857
3027,盛達,23,9,14,元大-蘆洲,2023-02-02,9857
4904,遠傳,15,1,14,元大-蘆洲,2023-02-02,9857
2497,怡利電,21,7,14,元大-蘆洲,2023-02-02,9857
3041,揚智,15,2,13,元大-蘆洲,2023-02-02,9857
1810,和成,15,2,13,元大-蘆洲,2023-02-02,9857
2468,華經,50,37,13,元大-蘆洲,2023-02-02,9857
2417,圓剛,13,0,13,元大-蘆洲,2023-02-02,9857
8171,天宇,20,7,13,元大-蘆洲,2023-02-02,9857
1513,中興電,34,21,13,元大-蘆洲,2023-02-02,9857
6732,昇佳電子,14,1,13,元大-蘆洲,2023-02-02,9857
2881,富邦金,24,12,12,元大-蘆洲,2023-02-02,9857
5014,建錩,12,0,12,元大-蘆洲,2023-02-02,9857
1701,中化,26,14,12,元大-蘆洲,2023-02-02,9857
00885,富邦越南,12,0,12,元大-蘆洲,2023-02-02,9857
8358,金居,15,4,11,元大-蘆洲,2023-02-02,9857
5608,四維航,11,0,11,元大-蘆洲,2023-02-02,9857
1312,國喬,11,0,11,元大-蘆洲,2023-02-02,9857
00637L,元大滬深300正2,379,45,334,元大-蘆洲,2023-02-03,9857
00632R,元大台灣50反1,276,30,246,元大-蘆洲,2023-02-03,9857
00671R,富邦NASDAQ反1,211,0,211,元大-蘆洲,2023-02-03,9857
3481,群創,178,24,154,元大-蘆洲,2023-02-03,9857
00878,國泰永續高股息,264,113,151,元大-蘆洲,2023-02-03,9857
00882,中信中國高股息,117,5,112,元大-蘆洲,2023-02-03,9857
2892,第一金,115,4,111,元大-蘆洲,2023-02-03,9857
00885,富邦越南,110,0,110,元大-蘆洲,2023-02-03,9857
5351,鈺創,126,41,85,元大-蘆洲,2023-02-03,9857
2748,雲品,82,4,78,元大-蘆洲,2023-02-03,9857
2891,中信金,140,70,70,元大-蘆洲,2023-02-03,9857
00720B,元大投資級公司債,58,0,58,元大-蘆洲,2023-02-03,9857
2897,王道銀行,60,3,57,元大-蘆洲,2023-02-03,9857
00900,富邦特選高股息30,83,27,56,元大-蘆洲,2023-02-03,9857
2409,友達,126,72,54,元大-蘆洲,2023-02-03,9857
2027,大成鋼,50,1,49,元大-蘆洲,2023-02-03,9857
2352,佳世達,61,13,48,元大-蘆洲,2023-02-03,9857
3037,欣興,83,35,48,元大-蘆洲,2023-02-03,9857
00902,中信電池及儲能,42,0,42,元大-蘆洲,2023-02-03,9857
2607,榮運,47,5,42,元大-蘆洲,2023-02-03,9857
1701,中化,36,0,36,元大-蘆洲,2023-02-03,9857
1789,神隆,46,12,34,元大-蘆洲,2023-02-03,9857
3419,譁裕,32,0,32,元大-蘆洲,2023-02-03,9857
2368,金像電,47,16,31,元大-蘆洲,2023-02-03,9857
3454,晶睿,33,3,30,元大-蘆洲,2023-02-03,9857
3508,位速,32,3,29,元大-蘆洲,2023-02-03,9857
6104,創惟,63,35,28,元大-蘆洲,2023-02-03,9857
2834,臺企銀,34,6,28,元大-蘆洲,2023-02-03,9857
1314,中石化,32,4,28,元大-蘆洲,2023-02-03,9857
2236,百達-KY,27,0,27,元大-蘆洲,2023-02-03,9857
00905,FT臺灣Smart,27,0,27,元大-蘆洲,2023-02-03,9857
2884,玉山金,29,3,26,元大-蘆洲,2023-02-03,9857
1409,新纖,26,0,26,元大-蘆洲,2023-02-03,9857
1584,精剛,70,44,26,元大-蘆洲,2023-02-03,9857
2014,中鴻,35,9,26,元大-蘆洲,2023-02-03,9857
6153,嘉聯益,27,1,26,元大-蘆洲,2023-02-03,9857
2417,圓剛,25,0,25,元大-蘆洲,2023-02-03,9857
8038,長園科,25,1,24,元大-蘆洲,2023-02-03,9857
4904,遠傳,30,6,24,元大-蘆洲,2023-02-03,9857
4961,天鈺,28,5,23,元大-蘆洲,2023-02-03,9857
8105,凌巨,23,0,23,元大-蘆洲,2023-02-03,9857
6770,力積電,31,8,23,元大-蘆洲,2023-02-03,9857
2201,裕隆,53,31,22,元大-蘆洲,2023-02-03,9857
2887,台新金,25,3,22,元大-蘆洲,2023-02-03,9857
2482,連宇,63,42,21,元大-蘆洲,2023-02-03,9857
00633L,富邦上証正2,21,0,21,元大-蘆洲,2023-02-03,9857
3581,博磊,20,0,20,元大-蘆洲,2023-02-03,9857
00642U,期元大S＆P石油,21,1,20,元大-蘆洲,2023-02-03,9857
2007,燁興,32,12,20,元大-蘆洲,2023-02-03,9857
00664R,國泰臺灣加權反1,20,0,20,元大-蘆洲,2023-02-03,9857
00632R,元大台灣50反1,391,45,346,元大-蘆洲,2023-02-06,9857
00878,國泰永續高股息,371,48,323,元大-蘆洲,2023-02-06,9857
2614,東森,195,15,180,元大-蘆洲,2023-02-06,9857
2880,華南金,103,2,101,元大-蘆洲,2023-02-06,9857
00902,中信電池及儲能,100,0,100,元大-蘆洲,2023-02-06,9857
2328,廣宇,104,15,89,元大-蘆洲,2023-02-06,9857
0056,元大高股息,73,7,66,元大-蘆洲,2023-02-06,9857
00882,中信中國高股息,60,6,54,元大-蘆洲,2023-02-06,9857
2603,長榮,74,21,53,元大-蘆洲,2023-02-06,9857
00642U,期元大S＆P石油,47,0,47,元大-蘆洲,2023-02-06,9857
2834,臺企銀,34,0,34,元大-蘆洲,2023-02-06,9857
00715L,期街口布蘭特正2,34,0,34,元大-蘆洲,2023-02-06,9857
1760,寶齡富錦,57,25,32,元大-蘆洲,2023-02-06,9857
00655L,國泰中國A50正2,31,0,31,元大-蘆洲,2023-02-06,9857
2615,萬海,55,28,27,元大-蘆洲,2023-02-06,9857
6546,正基,28,2,26,元大-蘆洲,2023-02-06,9857
5706,鳳凰,27,2,25,元大-蘆洲,2023-02-06,9857
1605,華新,48,23,25,元大-蘆洲,2023-02-06,9857
4904,遠傳,25,0,25,元大-蘆洲,2023-02-06,9857
2409,友達,27,3,24,元大-蘆洲,2023-02-06,9857
2884,玉山金,27,4,23,元大-蘆洲,2023-02-06,9857
6443,元晶,25,3,22,元大-蘆洲,2023-02-06,9857
00637L,元大滬深300正2,65,44,21,元大-蘆洲,2023-02-06,9857
2891,中信金,51,30,21,元大-蘆洲,2023-02-06,9857
3596,智易,20,0,20,元大-蘆洲,2023-02-06,9857
3297,杭特,20,0,20,元大-蘆洲,2023-02-06,9857
3037,欣興,47,27,20,元大-蘆洲,2023-02-06,9857
8105,凌巨,20,1,19,元大-蘆洲,2023-02-06,9857
00679B,元大美債20年,22,4,18,元大-蘆洲,2023-02-06,9857
00905,FT臺灣Smart,18,0,18,元大-蘆洲,2023-02-06,9857
00720B,元大投資級公司債,23,6,17,元大-蘆洲,2023-02-06,9857
2498,宏達電,86,69,17,元大-蘆洲,2023-02-06,9857
2208,台船,21,4,17,元大-蘆洲,2023-02-06,9857
6005,群益證,16,0,16,元大-蘆洲,2023-02-06,9857
2002,中鋼,20,5,15,元大-蘆洲,2023-02-06,9857
3521,鴻翊,15,0,15,元大-蘆洲,2023-02-06,9857
00664R,國泰臺灣加權反1,15,0,15,元大-蘆洲,2023-02-06,9857
9103,美德醫療-DR,17,3,14,元大-蘆洲,2023-02-06,9857
1342,八貫,15,1,14,元大-蘆洲,2023-02-06,9857
2801,彰銀,13,0,13,元大-蘆洲,2023-02-06,9857
0050,元大台灣50,13,0,13,元大-蘆洲,2023-02-06,9857
2748,雲品,29,17,12,元大-蘆洲,2023-02-06,9857
00919,群益台灣精選高息,12,0,12,元大-蘆洲,2023-02-06,9857
2201,裕隆,24,12,12,元大-蘆洲,2023-02-06,9857
2458,義隆,13,1,12,元大-蘆洲,2023-02-06,9857
2340,台亞,11,0,11,元大-蘆洲,2023-02-06,9857
8050,廣積,13,2,11,元大-蘆洲,2023-02-06,9857
1215,卜蜂,11,0,11,元大-蘆洲,2023-02-06,9857
1217,愛之味,11,0,11,元大-蘆洲,2023-02-06,9857
2530,華建,10,0,10,元大-蘆洲,2023-02-06,9857
2880,華南金,107,3,104,元大-蘆洲,2023-02-07,9857
3624,光頡,106,5,101,元大-蘆洲,2023-02-07,9857
2883,凱基金,100,2,98,元大-蘆洲,2023-02-07,9857
00878,國泰永續高股息,112,34,78,元大-蘆洲,2023-02-07,9857
6282,康舒,166,91,75,元大-蘆洲,2023-02-07,9857
2498,宏達電,105,40,65,元大-蘆洲,2023-02-07,9857
2610,華航,67,4,63,元大-蘆洲,2023-02-07,9857
2344,華邦電,97,44,53,元大-蘆洲,2023-02-07,9857
00900,富邦特選高股息30,42,0,42,元大-蘆洲,2023-02-07,9857
00795B,中信美國公債20年,40,0,40,元大-蘆洲,2023-02-07,9857
9105,泰金寶-DR,36,0,36,元大-蘆洲,2023-02-07,9857
4904,遠傳,33,0,33,元大-蘆洲,2023-02-07,9857
5351,鈺創,29,1,28,元大-蘆洲,2023-02-07,9857
2618,長榮航,43,17,26,元大-蘆洲,2023-02-07,9857
2409,友達,45,20,25,元大-蘆洲,2023-02-07,9857
6160,欣技,24,0,24,元大-蘆洲,2023-02-07,9857
2812,台中銀,23,0,23,元大-蘆洲,2023-02-07,9857
00679B,元大美債20年,22,0,22,元大-蘆洲,2023-02-07,9857
2834,臺企銀,40,18,22,元大-蘆洲,2023-02-07,9857
2891,中信金,21,0,21,元大-蘆洲,2023-02-07,9857
00632R,元大台灣50反1,47,27,20,元大-蘆洲,2023-02-07,9857
2332,友訊,20,1,19,元大-蘆洲,2023-02-07,9857
2884,玉山金,19,1,18,元大-蘆洲,2023-02-07,9857
2317,鴻海,36,17,19,元大-蘆洲,2023-02-07,9857
1513,中興電,20,3,17,元大-蘆洲,2023-02-07,9857
4763,材料-KY,42,26,16,元大-蘆洲,2023-02-07,9857
6770,力積電,17,1,16,元大-蘆洲,2023-02-07,9857
6118,建達,22,7,15,元大-蘆洲,2023-02-07,9857
00642U,期元大S＆P石油,15,0,15,元大-蘆洲,2023-02-07,9857
5299,杰力,15,0,15,元大-蘆洲,2023-02-07,9857
3521,鴻翊,20,5,15,元大-蘆洲,2023-02-07,9857
2201,裕隆,30,15,15,元大-蘆洲,2023-02-07,9857
6443,元晶,17,2,15,元大-蘆洲,2023-02-07,9857
2208,台船,34,20,14,元大-蘆洲,2023-02-07,9857
4907,富宇,14,0,14,元大-蘆洲,2023-02-07,9857
6278,台表科,17,3,14,元大-蘆洲,2023-02-07,9857
8940,新天地,13,0,13,元大-蘆洲,2023-02-07,9857
1337,再生-KY,13,0,13,元大-蘆洲,2023-02-07,9857
1519,華城,16,3,13,元大-蘆洲,2023-02-07,9857
2888,新光金,14,1,13,元大-蘆洲,2023-02-07,9857
00712,復華富時不動產,14,3,11,元大-蘆洲,2023-02-07,9857
00772B,中信高評級公司債,11,0,11,元大-蘆洲,2023-02-07,9857
1909,榮成,11,0,11,元大-蘆洲,2023-02-07,9857
1417,嘉裕,119,108,11,元大-蘆洲,2023-02-07,9857
1795,美時,77,67,10,元大-蘆洲,2023-02-07,9857
2412,中華電,12,1,11,元大-蘆洲,2023-02-07,9857
2027,大成鋼,14,3,11,元大-蘆洲,2023-02-07,9857
2890,永豐金,11,0,11,元大-蘆洲,2023-02-07,9857
5014,建錩,10,0,10,元大-蘆洲,2023-02-07,9857
2601,益航,10,0,10,元大-蘆洲,2023-02-07,9857
2886,兆豐金,198,0,198,元大-蘆洲,2023-02-08,9857
00878,國泰永續高股息,195,43,152,元大-蘆洲,2023-02-08,9857
1605,華新,152,27,125,元大-蘆洲,2023-02-08,9857
5880,合庫金,89,3,86,元大-蘆洲,2023-02-08,9857
3162,精確,92,19,73,元大-蘆洲,2023-02-08,9857
2883,凱基金,80,17,63,元大-蘆洲,2023-02-08,9857
2376,技嘉,64,2,62,元大-蘆洲,2023-02-08,9857
00720B,元大投資級公司債,60,3,57,元大-蘆洲,2023-02-08,9857
6142,友勁,50,0,50,元大-蘆洲,2023-02-08,9857
9919,康那香,44,0,44,元大-蘆洲,2023-02-08,9857
6116,彩晶,65,22,43,元大-蘆洲,2023-02-08,9857
4721,美琪瑪,44,3,41,元大-蘆洲,2023-02-08,9857
00679B,元大美債20年,44,3,41,元大-蘆洲,2023-02-08,9857
00885,富邦越南,39,0,39,元大-蘆洲,2023-02-08,9857
00905,FT臺灣Smart,36,0,36,元大-蘆洲,2023-02-08,9857
4979,華星光,98,63,35,元大-蘆洲,2023-02-08,9857
3521,鴻翊,35,0,35,元大-蘆洲,2023-02-08,9857
2834,臺企銀,34,0,34,元大-蘆洲,2023-02-08,9857
2888,新光金,50,17,33,元大-蘆洲,2023-02-08,9857
4167,松瑞藥,31,0,31,元大-蘆洲,2023-02-08,9857
6589,台康生技,47,17,30,元大-蘆洲,2023-02-08,9857
4114,健喬,93,63,30,元大-蘆洲,2023-02-08,9857
00850,元大臺灣ESG永續,30,3,27,元大-蘆洲,2023-02-08,9857
00637L,元大滬深300正2,26,1,25,元大-蘆洲,2023-02-08,9857
6244,茂迪,37,13,24,元大-蘆洲,2023-02-08,9857
020023,元大櫃買半導體N,21,0,21,元大-蘆洲,2023-02-08,9857
3037,欣興,44,24,20,元大-蘆洲,2023-02-08,9857
2368,金像電,25,5,20,元大-蘆洲,2023-02-08,9857
00795B,中信美國公債20年,20,0,20,元大-蘆洲,2023-02-08,9857
2610,華航,45,26,19,元大-蘆洲,2023-02-08,9857
2201,裕隆,50,31,19,元大-蘆洲,2023-02-08,9857
9902,台火,19,0,19,元大-蘆洲,2023-02-08,9857
3479,安勤,54,35,19,元大-蘆洲,2023-02-08,9857
3714,富采,20,2,18,元大-蘆洲,2023-02-08,9857
3710,連展投控,21,3,18,元大-蘆洲,2023-02-08,9857
2402,毅嘉,17,0,17,元大-蘆洲,2023-02-08,9857
6109,亞元,18,1,17,元大-蘆洲,2023-02-08,9857
4961,天鈺,32,15,17,元大-蘆洲,2023-02-08,9857
2412,中華電,14,0,14,元大-蘆洲,2023-02-08,9857
2882,國泰金,14,1,13,元大-蘆洲,2023-02-08,9857
3406,玉晶光,15,2,13,元大-蘆洲,2023-02-08,9857
8033,雷虎,16,4,12,元大-蘆洲,2023-02-08,9857
5014,建錩,13,1,12,元大-蘆洲,2023-02-08,9857
6735,美達科技,12,0,12,元大-蘆洲,2023-02-08,9857
3022,威強電,26,14,12,元大-蘆洲,2023-02-08,9857
3149,正達,11,0,11,元大-蘆洲,2023-02-08,9857
00772B,中信高評級公司債,10,0,10,元大-蘆洲,2023-02-08,9857
1215,卜蜂,10,0,10,元大-蘆洲,2023-02-08,9857
2208,台船,20,10,10,元大-蘆洲,2023-02-08,9857
3025,星通,10,0,10,元大-蘆洲,2023-02-08,9857
4960,誠美材,213,3,210,元大-蘆洲,2023-02-09,9857
3481,群創,237,38,199,元大-蘆洲,2023-02-09,9857
2002,中鋼,202,6,196,元大-蘆洲,2023-02-09,9857
00878,國泰永續高股息,137,29,108,元大-蘆洲,2023-02-09,9857
4128,中天,96,4,92,元大-蘆洲,2023-02-09,9857
00650L,復華香港正2,70,0,70,元大-蘆洲,2023-02-09,9857
00632R,元大台灣50反1,55,2,53,元大-蘆洲,2023-02-09,9857
00902,中信電池及儲能,50,0,50,元大-蘆洲,2023-02-09,9857
2891,中信金,59,10,49,元大-蘆洲,2023-02-09,9857
2880,華南金,47,0,47,元大-蘆洲,2023-02-09,9857
2344,華邦電,98,53,45,元大-蘆洲,2023-02-09,9857
2603,長榮,47,3,44,元大-蘆洲,2023-02-09,9857
00673R,期元大S＆P原油反1,44,0,44,元大-蘆洲,2023-02-09,9857
6719,力智,44,3,41,元大-蘆洲,2023-02-09,9857
5014,建錩,43,3,40,元大-蘆洲,2023-02-09,9857
9105,泰金寶-DR,40,0,40,元大-蘆洲,2023-02-09,9857
1336,台翰,41,3,38,元大-蘆洲,2023-02-09,9857
3520,華盈,42,7,35,元大-蘆洲,2023-02-09,9857
3624,光頡,40,6,34,元大-蘆洲,2023-02-09,9857
00720B,元大投資級公司債,33,0,33,元大-蘆洲,2023-02-09,9857
8349,�矬�,33,0,33,元大-蘆洲,2023-02-09,9857
2748,雲品,40,9,31,元大-蘆洲,2023-02-09,9857
00679B,元大美債20年,31,1,30,元大-蘆洲,2023-02-09,9857
4919,新唐,35,6,29,元大-蘆洲,2023-02-09,9857
00772B,中信高評級公司債,25,0,25,元大-蘆洲,2023-02-09,9857
2867,三商壽,25,0,25,元大-蘆洲,2023-02-09,9857
2201,裕隆,30,5,25,元大-蘆洲,2023-02-09,9857
6244,茂迪,28,4,24,元大-蘆洲,2023-02-09,9857
1584,精剛,61,38,23,元大-蘆洲,2023-02-09,9857
8033,雷虎,40,17,23,元大-蘆洲,2023-02-09,9857
2465,麗臺,22,1,21,元大-蘆洲,2023-02-09,9857
2601,益航,21,0,21,元大-蘆洲,2023-02-09,9857
4164,承業醫,26,6,20,元大-蘆洲,2023-02-09,9857
6116,彩晶,43,23,20,元大-蘆洲,2023-02-09,9857
9103,美德醫療-DR,20,0,20,元大-蘆洲,2023-02-09,9857
020023,元大櫃買半導體N,20,0,20,元大-蘆洲,2023-02-09,9857
8105,凌巨,25,5,20,元大-蘆洲,2023-02-09,9857
2453,凌群,20,1,19,元大-蘆洲,2023-02-09,9857
3141,晶宏,26,7,19,元大-蘆洲,2023-02-09,9857
2884,玉山金,19,0,19,元大-蘆洲,2023-02-09,9857
6441,廣錠,31,14,17,元大-蘆洲,2023-02-09,9857
2897,王道銀行,17,0,17,元大-蘆洲,2023-02-09,9857
00885,富邦越南,17,0,17,元大-蘆洲,2023-02-09,9857
1605,華新,50,34,16,元大-蘆洲,2023-02-09,9857
00751B,元大AAA至A公司債,16,0,16,元大-蘆洲,2023-02-09,9857
4162,智擎,22,6,16,元大-蘆洲,2023-02-09,9857
3149,正達,16,0,16,元大-蘆洲,2023-02-09,9857
1609,大亞,41,25,16,元大-蘆洲,2023-02-09,9857
2610,華航,22,6,16,元大-蘆洲,2023-02-09,9857
6185,幃翔,15,0,15,元大-蘆洲,2023-02-09,9857
00878,國泰永續高股息,288,49,239,元大-蘆洲,2023-02-10,9857
0056,元大高股息,157,28,129,元大-蘆洲,2023-02-10,9857
00637L,元大滬深300正2,86,1,85,元大-蘆洲,2023-02-10,9857
4979,華星光,150,67,83,元大-蘆洲,2023-02-10,9857
00712,復華富時不動產,71,3,68,元大-蘆洲,2023-02-10,9857
2867,三商壽,66,0,66,元大-蘆洲,2023-02-10,9857
3162,精確,56,1,55,元大-蘆洲,2023-02-10,9857
6743,安普新,42,0,42,元大-蘆洲,2023-02-10,9857
3027,盛達,62,21,41,元大-蘆洲,2023-02-10,9857
00795B,中信美國公債20年,41,0,41,元大-蘆洲,2023-02-10,9857
3042,晶技,41,0,41,元大-蘆洲,2023-02-10,9857
00676R,富邦臺灣加權反1,40,0,40,元大-蘆洲,2023-02-10,9857
1342,八貫,78,39,39,元大-蘆洲,2023-02-10,9857
3356,奇偶,39,1,38,元大-蘆洲,2023-02-10,9857
2887,台新金,39,1,38,元大-蘆洲,2023-02-10,9857
4746,台耀,41,5,36,元大-蘆洲,2023-02-10,9857
1584,精剛,87,53,34,元大-蘆洲,2023-02-10,9857
2609,陽明,63,30,33,元大-蘆洲,2023-02-10,9857
1605,華新,58,25,33,元大-蘆洲,2023-02-10,9857
00885,富邦越南,32,0,32,元大-蘆洲,2023-02-10,9857
1789,神隆,31,2,29,元大-蘆洲,2023-02-10,9857
6589,台康生技,38,10,28,元大-蘆洲,2023-02-10,9857
3479,安勤,30,2,28,元大-蘆洲,2023-02-10,9857
2618,長榮航,49,21,28,元大-蘆洲,2023-02-10,9857
00720B,元大投資級公司債,28,0,28,元大-蘆洲,2023-02-10,9857
6443,元晶,33,7,26,元大-蘆洲,2023-02-10,9857
6274,台燿,27,2,25,元大-蘆洲,2023-02-10,9857
1524,耿鼎,27,2,25,元大-蘆洲,2023-02-10,9857
5608,四維航,32,7,25,元大-蘆洲,2023-02-10,9857
6266,泰詠,37,12,25,元大-蘆洲,2023-02-10,9857
2027,大成鋼,27,3,24,元大-蘆洲,2023-02-10,9857
2413,環科,27,3,24,元大-蘆洲,2023-02-10,9857
2610,華航,28,6,22,元大-蘆洲,2023-02-10,9857
2369,菱生,32,10,22,元大-蘆洲,2023-02-10,9857
6558,興能高,24,2,22,元大-蘆洲,2023-02-10,9857
6547,高端疫苗,23,1,22,元大-蘆洲,2023-02-10,9857
2101,南港,21,0,21,元大-蘆洲,2023-02-10,9857
2534,宏盛,21,0,21,元大-蘆洲,2023-02-10,9857
2444,兆勁,20,0,20,元大-蘆洲,2023-02-10,9857
9919,康那香,20,0,20,元大-蘆洲,2023-02-10,9857
00902,中信電池及儲能,20,0,20,元大-蘆洲,2023-02-10,9857
3624,光頡,32,13,19,元大-蘆洲,2023-02-10,9857
2453,凌群,35,16,19,元大-蘆洲,2023-02-10,9857
4915,致伸,21,3,18,元大-蘆洲,2023-02-10,9857
2305,全友,18,0,18,元大-蘆洲,2023-02-10,9857
2915,潤泰全,17,0,17,元大-蘆洲,2023-02-10,9857
2368,金像電,20,3,17,元大-蘆洲,2023-02-10,9857
2883,凱基金,20,4,16,元大-蘆洲,2023-02-10,9857
00751B,元大AAA至A公司債,16,0,16,元大-蘆洲,2023-02-10,9857
5475,德宏,16,0,16,元大-蘆洲,2023-02-10,9857
00878,國泰永續高股息,206,17,189,元大-蘆洲,2023-02-13,9857
6153,嘉聯益,100,0,100,元大-蘆洲,2023-02-13,9857
4167,松瑞藥,90,0,90,元大-蘆洲,2023-02-13,9857
00885,富邦越南,82,0,82,元大-蘆洲,2023-02-13,9857
00632R,元大台灣50反1,89,15,74,元大-蘆洲,2023-02-13,9857
00679B,元大美債20年,66,0,66,元大-蘆洲,2023-02-13,9857
2409,友達,94,32,62,元大-蘆洲,2023-02-13,9857
00720B,元大投資級公司債,51,0,51,元大-蘆洲,2023-02-13,9857
00772B,中信高評級公司債,47,0,47,元大-蘆洲,2023-02-13,9857
1447,力鵬,48,2,46,元大-蘆洲,2023-02-13,9857
4743,合一,45,4,41,元大-蘆洲,2023-02-13,9857
3481,群創,94,56,38,元大-蘆洲,2023-02-13,9857
2888,新光金,34,0,34,元大-蘆洲,2023-02-13,9857
00671R,富邦NASDAQ反1,40,7,33,元大-蘆洲,2023-02-13,9857
6245,立端,32,4,28,元大-蘆洲,2023-02-13,9857
6770,力積電,30,3,27,元大-蘆洲,2023-02-13,9857
6129,普誠,27,1,26,元大-蘆洲,2023-02-13,9857
2634,漢翔,37,12,25,元大-蘆洲,2023-02-13,9857
1789,神隆,24,0,24,元大-蘆洲,2023-02-13,9857
1336,台翰,35,12,23,元大-蘆洲,2023-02-13,9857
00673R,期元大S＆P原油反1,23,0,23,元大-蘆洲,2023-02-13,9857
00795B,中信美國公債20年,22,0,22,元大-蘆洲,2023-02-13,9857
2359,所羅門,22,1,21,元大-蘆洲,2023-02-13,9857
1701,中化,60,40,20,元大-蘆洲,2023-02-13,9857
2601,益航,20,0,20,元大-蘆洲,2023-02-13,9857
1810,和成,25,5,20,元大-蘆洲,2023-02-13,9857
3013,晟銘電,44,26,18,元大-蘆洲,2023-02-13,9857
2368,金像電,19,3,16,元大-蘆洲,2023-02-13,9857
00900,富邦特選高股息30,18,2,16,元大-蘆洲,2023-02-13,9857
6235,華孚,66,50,16,元大-蘆洲,2023-02-13,9857
2303,聯電,39,23,16,元大-蘆洲,2023-02-13,9857
00751B,元大AAA至A公司債,15,0,15,元大-蘆洲,2023-02-13,9857
2610,華航,19,5,14,元大-蘆洲,2023-02-13,9857
2201,裕隆,23,9,14,元大-蘆洲,2023-02-13,9857
2344,華邦電,31,17,14,元大-蘆洲,2023-02-13,9857
2884,玉山金,34,21,13,元大-蘆洲,2023-02-13,9857
2530,華建,13,0,13,元大-蘆洲,2023-02-13,9857
00850,元大臺灣ESG永續,13,0,13,元大-蘆洲,2023-02-13,9857
1524,耿鼎,13,1,12,元大-蘆洲,2023-02-13,9857
3014,聯陽,12,0,12,元大-蘆洲,2023-02-13,9857
6118,建達,15,3,12,元大-蘆洲,2023-02-13,9857
6550,北極星藥業-KY,11,0,11,元大-蘆洲,2023-02-13,9857
4919,新唐,13,2,11,元大-蘆洲,2023-02-13,9857
6593,台灣銘板,11,0,11,元大-蘆洲,2023-02-13,9857
5258,虹堡,12,1,11,元大-蘆洲,2023-02-13,9857
4979,華星光,30,20,10,元大-蘆洲,2023-02-13,9857
2340,台亞,10,0,10,元大-蘆洲,2023-02-13,9857
2890,永豐金,10,0,10,元大-蘆洲,2023-02-13,9857
3521,鴻翊,10,0,10,元大-蘆洲,2023-02-13,9857
6266,泰詠,68,58,10,元大-蘆洲,2023-02-13,9857
2453,凌群,290,195,95,元大-蘆洲,2023-02-14,9857
00632R,元大台灣50反1,195,102,93,元大-蘆洲,2023-02-14,9857
00637L,元大滬深300正2,169,90,79,元大-蘆洲,2023-02-14,9857
4979,華星光,113,35,78,元大-蘆洲,2023-02-14,9857
2332,友訊,77,12,65,元大-蘆洲,2023-02-14,9857
00878,國泰永續高股息,154,95,59,元大-蘆洲,2023-02-14,9857
1605,華新,198,142,56,元大-蘆洲,2023-02-14,9857
2405,輔信,50,0,50,元大-蘆洲,2023-02-14,9857
6116,彩晶,62,15,47,元大-蘆洲,2023-02-14,9857
00673R,期元大S＆P原油反1,33,0,33,元大-蘆洲,2023-02-14,9857
3022,威強電,31,1,30,元大-蘆洲,2023-02-14,9857
2484,希華,30,0,30,元大-蘆洲,2023-02-14,9857
2884,玉山金,32,8,24,元大-蘆洲,2023-02-14,9857
2748,雲品,49,26,23,元大-蘆洲,2023-02-14,9857
00679B,元大美債20年,28,5,23,元大-蘆洲,2023-02-14,9857
1432,大魯閣,25,3,22,元大-蘆洲,2023-02-14,9857
4743,合一,41,20,21,元大-蘆洲,2023-02-14,9857
3714,富采,23,3,20,元大-蘆洲,2023-02-14,9857
00720B,元大投資級公司債,20,0,20,元大-蘆洲,2023-02-14,9857
2471,資通,27,7,20,元大-蘆洲,2023-02-14,9857
6104,創惟,24,4,20,元大-蘆洲,2023-02-14,9857
00719B,元大美債1-3,20,0,20,元大-蘆洲,2023-02-14,9857
00665L,富邦�琤肭磪囓�2,20,0,20,元大-蘆洲,2023-02-14,9857
00671R,富邦NASDAQ反1,20,0,20,元大-蘆洲,2023-02-14,9857
6153,嘉聯益,18,0,18,元大-蘆洲,2023-02-14,9857
3594,磐儀,18,1,17,元大-蘆洲,2023-02-14,9857
5009,榮剛,21,4,17,元大-蘆洲,2023-02-14,9857
2208,台船,26,10,16,元大-蘆洲,2023-02-14,9857
00882,中信中國高股息,20,4,16,元大-蘆洲,2023-02-14,9857
6016,康和證,41,25,16,元大-蘆洲,2023-02-14,9857
2401,凌陽,16,0,16,元大-蘆洲,2023-02-14,9857
00713,元大台灣高息低波,15,0,15,元大-蘆洲,2023-02-14,9857
2359,所羅門,15,0,15,元大-蘆洲,2023-02-14,9857
2607,榮運,20,5,15,元大-蘆洲,2023-02-14,9857
1701,中化,19,4,15,元大-蘆洲,2023-02-14,9857
2009,第一銅,24,10,14,元大-蘆洲,2023-02-14,9857
6188,廣明,14,0,14,元大-蘆洲,2023-02-14,9857
6541,泰福-KY,15,2,13,元大-蘆洲,2023-02-14,9857
2201,裕隆,23,10,13,元大-蘆洲,2023-02-14,9857
6142,友勁,16,3,13,元大-蘆洲,2023-02-14,9857
4746,台耀,33,20,13,元大-蘆洲,2023-02-14,9857
2885,元大金,12,0,12,元大-蘆洲,2023-02-14,9857
2344,華邦電,25,13,12,元大-蘆洲,2023-02-14,9857
3706,神達,17,5,12,元大-蘆洲,2023-02-14,9857
00772B,中信高評級公司債,12,0,12,元大-蘆洲,2023-02-14,9857
5608,四維航,11,0,11,元大-蘆洲,2023-02-14,9857
00780B,國泰A級金融債,11,0,11,元大-蘆洲,2023-02-14,9857
1409,新纖,11,0,11,元大-蘆洲,2023-02-14,9857
3013,晟銘電,40,29,11,元大-蘆洲,2023-02-14,9857
3707,漢磊,11,0,11,元大-蘆洲,2023-02-14,9857
00878,國泰永續高股息,375,11,364,元大-蘆洲,2023-02-15,9857
00902,中信電池及儲能,283,40,243,元大-蘆洲,2023-02-15,9857
00632R,元大台灣50反1,230,12,218,元大-蘆洲,2023-02-15,9857
00637L,元大滬深300正2,234,68,166,元大-蘆洲,2023-02-15,9857
3027,盛達,124,7,117,元大-蘆洲,2023-02-15,9857
2337,旺宏,111,0,111,元大-蘆洲,2023-02-15,9857
2883,凱基金,104,6,98,元大-蘆洲,2023-02-15,9857
1609,大亞,153,67,86,元大-蘆洲,2023-02-15,9857
2812,台中銀,69,0,69,元大-蘆洲,2023-02-15,9857
2607,榮運,50,0,50,元大-蘆洲,2023-02-15,9857
6101,寬魚國際,49,4,45,元大-蘆洲,2023-02-15,9857
00905,FT臺灣Smart,44,0,44,元大-蘆洲,2023-02-15,9857
00671R,富邦NASDAQ反1,41,0,41,元大-蘆洲,2023-02-15,9857
1789,神隆,57,20,37,元大-蘆洲,2023-02-15,9857
6235,華孚,100,65,35,元大-蘆洲,2023-02-15,9857
3710,連展投控,35,1,34,元大-蘆洲,2023-02-15,9857
6116,彩晶,48,14,34,元大-蘆洲,2023-02-15,9857
00882,中信中國高股息,33,1,32,元大-蘆洲,2023-02-15,9857
2905,三商,30,0,30,元大-蘆洲,2023-02-15,9857
6443,元晶,40,13,27,元大-蘆洲,2023-02-15,9857
0056,元大高股息,35,9,26,元大-蘆洲,2023-02-15,9857
2344,華邦電,34,9,25,元大-蘆洲,2023-02-15,9857
2359,所羅門,25,0,25,元大-蘆洲,2023-02-15,9857
00753L,中信中國50正2,25,0,25,元大-蘆洲,2023-02-15,9857
2610,華航,38,14,24,元大-蘆洲,2023-02-15,9857
5608,四維航,31,7,24,元大-蘆洲,2023-02-15,9857
0050,元大台灣50,24,4,20,元大-蘆洲,2023-02-15,9857
3591,艾笛森,20,0,20,元大-蘆洲,2023-02-15,9857
00900,富邦特選高股息30,21,3,18,元大-蘆洲,2023-02-15,9857
1301,台塑,20,3,17,元大-蘆洲,2023-02-15,9857
2609,陽明,29,12,17,元大-蘆洲,2023-02-15,9857
2027,大成鋼,28,13,15,元大-蘆洲,2023-02-15,9857
00772B,中信高評級公司債,18,4,14,元大-蘆洲,2023-02-15,9857
4919,新唐,39,25,14,元大-蘆洲,2023-02-15,9857
1218,泰山,14,0,14,元大-蘆洲,2023-02-15,9857
6741,91APP*-KY,16,2,14,元大-蘆洲,2023-02-15,9857
00885,富邦越南,16,3,13,元大-蘆洲,2023-02-15,9857
6278,台表科,14,1,13,元大-蘆洲,2023-02-15,9857
2601,益航,13,0,13,元大-蘆洲,2023-02-15,9857
00903,富邦元宇宙,13,0,13,元大-蘆洲,2023-02-15,9857
00891,中信關鍵半導體,15,2,13,元大-蘆洲,2023-02-15,9857
1342,八貫,31,19,12,元大-蘆洲,2023-02-15,9857
2236,百達-KY,13,1,12,元大-蘆洲,2023-02-15,9857
4967,十銓,10,0,10,元大-蘆洲,2023-02-15,9857
4167,松瑞藥,10,0,10,元大-蘆洲,2023-02-15,9857
2612,中航,10,0,10,元大-蘆洲,2023-02-15,9857
2367,燿華,15,5,10,元大-蘆洲,2023-02-15,9857
4121,優盛,10,0,10,元大-蘆洲,2023-02-15,9857
00648R,元大S＆P500反1,10,0,10,元大-蘆洲,2023-02-15,9857
8088,品安,10,0,10,元大-蘆洲,2023-02-15,9857
00632R,元大台灣50反1,1689,136,1553,元大-蘆洲,2023-02-16,9857
00878,國泰永續高股息,354,47,307,元大-蘆洲,2023-02-16,9857
2882,國泰金,306,6,300,元大-蘆洲,2023-02-16,9857
00719B,元大美債1-3,168,0,168,元大-蘆洲,2023-02-16,9857
2337,旺宏,131,0,131,元大-蘆洲,2023-02-16,9857
00680L,元大美債20正2,154,30,124,元大-蘆洲,2023-02-16,9857
2812,台中銀,101,0,101,元大-蘆洲,2023-02-16,9857
2897,王道銀行,90,0,90,元大-蘆洲,2023-02-16,9857
00665L,富邦�琤肭磪囓�2,87,0,87,元大-蘆洲,2023-02-16,9857
00679B,元大美債20年,82,0,82,元大-蘆洲,2023-02-16,9857
2332,友訊,78,6,72,元大-蘆洲,2023-02-16,9857
5905,南仁湖,83,16,67,元大-蘆洲,2023-02-16,9857
2328,廣宇,59,2,57,元大-蘆洲,2023-02-16,9857
6118,建達,53,1,52,元大-蘆洲,2023-02-16,9857
5880,合庫金,46,0,46,元大-蘆洲,2023-02-16,9857
6142,友勁,45,0,45,元大-蘆洲,2023-02-16,9857
020023,元大櫃買半導體N,40,0,40,元大-蘆洲,2023-02-16,9857
00633L,富邦上証正2,38,0,38,元大-蘆洲,2023-02-16,9857
3022,威強電,51,16,35,元大-蘆洲,2023-02-16,9857
9105,泰金寶-DR,31,0,31,元大-蘆洲,2023-02-16,9857
1907,永豐餘,30,0,30,元大-蘆洲,2023-02-16,9857
00673R,期元大S＆P原油反1,30,0,30,元大-蘆洲,2023-02-16,9857
4960,誠美材,52,23,29,元大-蘆洲,2023-02-16,9857
9907,統一實,26,0,26,元大-蘆洲,2023-02-16,9857
8171,天宇,30,5,25,元大-蘆洲,2023-02-16,9857
8083,瑞穎,25,1,24,元大-蘆洲,2023-02-16,9857
00772B,中信高評級公司債,23,0,23,元大-蘆洲,2023-02-16,9857
4755,三福化,22,0,22,元大-蘆洲,2023-02-16,9857
2104,國際中橡,22,0,22,元大-蘆洲,2023-02-16,9857
00751B,元大AAA至A公司債,21,0,21,元大-蘆洲,2023-02-16,9857
2465,麗臺,38,17,21,元大-蘆洲,2023-02-16,9857
6016,康和證,50,30,20,元大-蘆洲,2023-02-16,9857
00795B,中信美國公債20年,19,0,19,元大-蘆洲,2023-02-16,9857
8349,�矬�,19,0,19,元大-蘆洲,2023-02-16,9857
00885,富邦越南,30,12,18,元大-蘆洲,2023-02-16,9857
6266,泰詠,33,16,17,元大-蘆洲,2023-02-16,9857
3260,威剛,16,0,16,元大-蘆洲,2023-02-16,9857
1218,泰山,16,0,16,元大-蘆洲,2023-02-16,9857
6235,華孚,52,37,15,元大-蘆洲,2023-02-16,9857
00720B,元大投資級公司債,14,0,14,元大-蘆洲,2023-02-16,9857
8105,凌巨,27,13,14,元大-蘆洲,2023-02-16,9857
2376,技嘉,14,0,14,元大-蘆洲,2023-02-16,9857
00891,中信關鍵半導體,15,2,13,元大-蘆洲,2023-02-16,9857
6712,長聖,13,0,13,元大-蘆洲,2023-02-16,9857
3094,聯傑,26,13,13,元大-蘆洲,2023-02-16,9857
5014,建錩,12,0,12,元大-蘆洲,2023-02-16,9857
2449,京元電子,12,0,12,元大-蘆洲,2023-02-16,9857
6625,必應,12,0,12,元大-蘆洲,2023-02-16,9857
00900,富邦特選高股息30,13,2,11,元大-蘆洲,2023-02-16,9857
3055,蔚華科,11,0,11,元大-蘆洲,2023-02-16,9857
6116,彩晶,410,27,383,元大-蘆洲,2023-02-17,9857
2014,中鴻,416,68,348,元大-蘆洲,2023-02-17,9857
00680L,元大美債20正2,298,0,298,元大-蘆洲,2023-02-17,9857
00637L,元大滬深300正2,805,527,278,元大-蘆洲,2023-02-17,9857
00902,中信電池及儲能,229,0,229,元大-蘆洲,2023-02-17,9857
2303,聯電,154,17,137,元大-蘆洲,2023-02-17,9857
3058,立德,134,1,133,元大-蘆洲,2023-02-17,9857
00878,國泰永續高股息,158,44,114,元大-蘆洲,2023-02-17,9857
2618,長榮航,146,49,97,元大-蘆洲,2023-02-17,9857
00772B,中信高評級公司債,75,0,75,元大-蘆洲,2023-02-17,9857
4979,華星光,91,20,71,元大-蘆洲,2023-02-17,9857
6125,廣運,52,1,51,元大-蘆洲,2023-02-17,9857
2610,華航,204,153,51,元大-蘆洲,2023-02-17,9857
8261,富鼎,51,3,48,元大-蘆洲,2023-02-17,9857
2201,裕隆,51,11,40,元大-蘆洲,2023-02-17,9857
00679B,元大美債20年,67,27,40,元大-蘆洲,2023-02-17,9857
6443,元晶,54,19,35,元大-蘆洲,2023-02-17,9857
2455,全新,58,24,34,元大-蘆洲,2023-02-17,9857
2492,華新科,40,9,31,元大-蘆洲,2023-02-17,9857
00719B,元大美債1-3,30,0,30,元大-蘆洲,2023-02-17,9857
2468,華經,28,1,27,元大-蘆洲,2023-02-17,9857
2027,大成鋼,29,2,27,元大-蘆洲,2023-02-17,9857
2368,金像電,31,7,24,元大-蘆洲,2023-02-17,9857
2615,萬海,39,17,22,元大-蘆洲,2023-02-17,9857
3013,晟銘電,47,26,21,元大-蘆洲,2023-02-17,9857
1701,中化,20,0,20,元大-蘆洲,2023-02-17,9857
00893,國泰智能電動車,36,17,19,元大-蘆洲,2023-02-17,9857
00773B,中信優先金融債,28,10,18,元大-蘆洲,2023-02-17,9857
1789,神隆,18,0,18,元大-蘆洲,2023-02-17,9857
6191,精成科,18,0,18,元大-蘆洲,2023-02-17,9857
1234,黑松,18,0,18,元大-蘆洲,2023-02-17,9857
8358,金居,23,5,18,元大-蘆洲,2023-02-17,9857
2888,新光金,20,3,17,元大-蘆洲,2023-02-17,9857
2614,東森,17,1,16,元大-蘆洲,2023-02-17,9857
00795B,中信美國公債20年,16,0,16,元大-蘆洲,2023-02-17,9857
1218,泰山,15,0,15,元大-蘆洲,2023-02-17,9857
00753L,中信中國50正2,15,0,15,元大-蘆洲,2023-02-17,9857
6188,廣明,15,0,15,元大-蘆洲,2023-02-17,9857
00751B,元大AAA至A公司債,26,11,15,元大-蘆洲,2023-02-17,9857
2471,資通,93,78,15,元大-蘆洲,2023-02-17,9857
4167,松瑞藥,15,0,15,元大-蘆洲,2023-02-17,9857
1515,力山,14,0,14,元大-蘆洲,2023-02-17,9857
00903,富邦元宇宙,13,0,13,元大-蘆洲,2023-02-17,9857
5703,亞都,13,0,13,元大-蘆洲,2023-02-17,9857
3006,晶豪科,17,4,13,元大-蘆洲,2023-02-17,9857
5425,台半,36,23,13,元大-蘆洲,2023-02-17,9857
3576,聯合再生,16,4,12,元大-蘆洲,2023-02-17,9857
6547,高端疫苗,48,37,11,元大-蘆洲,2023-02-17,9857
00720B,元大投資級公司債,11,0,11,元大-蘆洲,2023-02-17,9857
3105,穩懋,16,5,11,元大-蘆洲,2023-02-17,9857
00902,中信電池及儲能,480,26,454,元大-蘆洲,2023-02-20,9857
00632R,元大台灣50反1,316,128,188,元大-蘆洲,2023-02-20,9857
1504,東元,139,2,137,元大-蘆洲,2023-02-20,9857
3701,大眾控,130,0,130,元大-蘆洲,2023-02-20,9857
3049,精金,104,0,104,元大-蘆洲,2023-02-20,9857
6188,廣明,76,0,76,元大-蘆洲,2023-02-20,9857
6142,友勁,75,1,74,元大-蘆洲,2023-02-20,9857
2880,華南金,75,4,71,元大-蘆洲,2023-02-20,9857
00878,國泰永續高股息,103,35,68,元大-蘆洲,2023-02-20,9857
00715L,期街口布蘭特正2,65,0,65,元大-蘆洲,2023-02-20,9857
6202,盛群,62,2,60,元大-蘆洲,2023-02-20,9857
6118,建達,58,7,51,元大-蘆洲,2023-02-20,9857
9105,泰金寶-DR,50,0,50,元大-蘆洲,2023-02-20,9857
3576,聯合再生,52,3,49,元大-蘆洲,2023-02-20,9857
2455,全新,51,8,43,元大-蘆洲,2023-02-20,9857
1609,大亞,87,46,41,元大-蘆洲,2023-02-20,9857
2609,陽明,40,2,38,元大-蘆洲,2023-02-20,9857
6206,飛捷,37,0,37,元大-蘆洲,2023-02-20,9857
6719,力智,39,2,37,元大-蘆洲,2023-02-20,9857
9904,寶成,43,7,36,元大-蘆洲,2023-02-20,9857
2801,彰銀,42,9,33,元大-蘆洲,2023-02-20,9857
1218,泰山,33,0,33,元大-蘆洲,2023-02-20,9857
4168,醣聯,30,0,30,元大-蘆洲,2023-02-20,9857
2324,仁寶,32,3,29,元大-蘆洲,2023-02-20,9857
6266,泰詠,34,6,28,元大-蘆洲,2023-02-20,9857
3037,欣興,50,24,26,元大-蘆洲,2023-02-20,9857
1591,駿吉-KY,25,0,25,元大-蘆洲,2023-02-20,9857
4128,中天,33,9,24,元大-蘆洲,2023-02-20,9857
6226,光鼎,20,0,20,元大-蘆洲,2023-02-20,9857
1514,亞力,23,3,20,元大-蘆洲,2023-02-20,9857
2397,友通,21,2,19,元大-蘆洲,2023-02-20,9857
00664R,國泰臺灣加權反1,18,0,18,元大-蘆洲,2023-02-20,9857
6625,必應,20,2,18,元大-蘆洲,2023-02-20,9857
5703,亞都,18,0,18,元大-蘆洲,2023-02-20,9857
2611,志信,20,2,18,元大-蘆洲,2023-02-20,9857
6492,生華科,18,0,18,元大-蘆洲,2023-02-20,9857
00900,富邦特選高股息30,21,4,17,元大-蘆洲,2023-02-20,9857
2201,裕隆,28,12,16,元大-蘆洲,2023-02-20,9857
2363,矽統,16,0,16,元大-蘆洲,2023-02-20,9857
1326,台化,15,0,15,元大-蘆洲,2023-02-20,9857
8358,金居,21,6,15,元大-蘆洲,2023-02-20,9857
00891,中信關鍵半導體,17,2,15,元大-蘆洲,2023-02-20,9857
2731,雄獅,19,4,15,元大-蘆洲,2023-02-20,9857
00679B,元大美債20年,17,3,14,元大-蘆洲,2023-02-20,9857
3045,台灣大,14,0,14,元大-蘆洲,2023-02-20,9857
2882,國泰金,24,10,14,元大-蘆洲,2023-02-20,9857
1701,中化,20,6,14,元大-蘆洲,2023-02-20,9857
2617,台航,14,0,14,元大-蘆洲,2023-02-20,9857
00772B,中信高評級公司債,14,0,14,元大-蘆洲,2023-02-20,9857
1417,嘉裕,17,3,14,元大-蘆洲,2023-02-20,9857
6282,康舒,253,88,165,元大-蘆洲,2023-02-21,9857
2884,玉山金,197,87,110,元大-蘆洲,2023-02-21,9857
2618,長榮航,119,23,96,元大-蘆洲,2023-02-21,9857
2867,三商壽,93,1,92,元大-蘆洲,2023-02-21,9857
2498,宏達電,125,56,69,元大-蘆洲,2023-02-21,9857
5701,劍湖山,60,3,57,元大-蘆洲,2023-02-21,9857
3494,誠研,43,0,43,元大-蘆洲,2023-02-21,9857
4768,晶呈科技,40,0,40,元大-蘆洲,2023-02-21,9857
6770,力積電,43,9,34,元大-蘆洲,2023-02-21,9857
2468,華經,32,2,30,元大-蘆洲,2023-02-21,9857
3356,奇偶,31,1,30,元大-蘆洲,2023-02-21,9857
1618,合機,30,0,30,元大-蘆洲,2023-02-21,9857
1512,瑞利,28,0,28,元大-蘆洲,2023-02-21,9857
00885,富邦越南,38,10,28,元大-蘆洲,2023-02-21,9857
2887,台新金,27,0,27,元大-蘆洲,2023-02-21,9857
2885,元大金,25,0,25,元大-蘆洲,2023-02-21,9857
2834,臺企銀,27,3,24,元大-蘆洲,2023-02-21,9857
2208,台船,114,93,21,元大-蘆洲,2023-02-21,9857
2891,中信金,45,24,21,元大-蘆洲,2023-02-21,9857
5009,榮剛,26,6,20,元大-蘆洲,2023-02-21,9857
3338,泰碩,20,0,20,元大-蘆洲,2023-02-21,9857
2801,彰銀,30,12,18,元大-蘆洲,2023-02-21,9857
2439,美律,18,0,18,元大-蘆洲,2023-02-21,9857
1591,駿吉-KY,18,0,18,元大-蘆洲,2023-02-21,9857
1529,樂事綠能,19,1,18,元大-蘆洲,2023-02-21,9857
2634,漢翔,44,27,17,元大-蘆洲,2023-02-21,9857
1504,東元,19,2,17,元大-蘆洲,2023-02-21,9857
6806,森崴能源,19,3,16,元大-蘆洲,2023-02-21,9857
2890,永豐金,16,0,16,元大-蘆洲,2023-02-21,9857
6804,明係,16,0,16,元大-蘆洲,2023-02-21,9857
5258,虹堡,19,3,16,元大-蘆洲,2023-02-21,9857
5210,寶碩,15,0,15,元大-蘆洲,2023-02-21,9857
8091,翔名,16,1,15,元大-蘆洲,2023-02-21,9857
4121,優盛,22,7,15,元大-蘆洲,2023-02-21,9857
00713,元大台灣高息低波,14,0,14,元大-蘆洲,2023-02-21,9857
1314,中石化,21,7,14,元大-蘆洲,2023-02-21,9857
3594,磐儀,88,74,14,元大-蘆洲,2023-02-21,9857
5608,四維航,14,0,14,元大-蘆洲,2023-02-21,9857
2367,燿華,13,0,13,元大-蘆洲,2023-02-21,9857
5353,台林,15,2,13,元大-蘆洲,2023-02-21,9857
3535,晶彩科,13,0,13,元大-蘆洲,2023-02-21,9857
00751B,元大AAA至A公司債,12,0,12,元大-蘆洲,2023-02-21,9857
00720B,元大投資級公司債,12,0,12,元大-蘆洲,2023-02-21,9857
1506,正道,12,0,12,元大-蘆洲,2023-02-21,9857
2617,台航,13,1,12,元大-蘆洲,2023-02-21,9857
9934,成霖,12,0,12,元大-蘆洲,2023-02-21,9857
2101,南港,12,0,12,元大-蘆洲,2023-02-21,9857
4960,誠美材,16,4,12,元大-蘆洲,2023-02-21,9857
8936,國統,36,24,12,元大-蘆洲,2023-02-21,9857
8927,北基,11,0,11,元大-蘆洲,2023-02-21,9857
00902,中信電池及儲能,154,0,154,元大-蘆洲,2023-02-22,9857
00878,國泰永續高股息,185,38,147,元大-蘆洲,2023-02-22,9857
2609,陽明,201,75,126,元大-蘆洲,2023-02-22,9857
00680L,元大美債20正2,115,0,115,元大-蘆洲,2023-02-22,9857
2812,台中銀,223,113,110,元大-蘆洲,2023-02-22,9857
00637L,元大滬深300正2,314,217,97,元大-蘆洲,2023-02-22,9857
1605,華新,116,19,97,元大-蘆洲,2023-02-22,9857
6770,力積電,61,7,54,元大-蘆洲,2023-02-22,9857
00712,復華富時不動產,53,3,50,元大-蘆洲,2023-02-22,9857
2601,益航,46,0,46,元大-蘆洲,2023-02-22,9857
00919,群益台灣精選高息,41,0,41,元大-蘆洲,2023-02-22,9857
6142,友勁,41,0,41,元大-蘆洲,2023-02-22,9857
6202,盛群,41,3,38,元大-蘆洲,2023-02-22,9857
4979,華星光,65,28,37,元大-蘆洲,2023-02-22,9857
2303,聯電,38,5,33,元大-蘆洲,2023-02-22,9857
1513,中興電,72,42,30,元大-蘆洲,2023-02-22,9857
00772B,中信高評級公司債,30,0,30,元大-蘆洲,2023-02-22,9857
0056,元大高股息,35,6,29,元大-蘆洲,2023-02-22,9857
2344,華邦電,34,7,27,元大-蘆洲,2023-02-22,9857
8088,品安,27,0,27,元大-蘆洲,2023-02-22,9857
00753L,中信中國50正2,27,0,27,元大-蘆洲,2023-02-22,9857
8150,南茂,26,0,26,元大-蘆洲,2023-02-22,9857
1103,嘉泥,26,1,25,元大-蘆洲,2023-02-22,9857
2014,中鴻,32,8,24,元大-蘆洲,2023-02-22,9857
4564,元翎,24,0,24,元大-蘆洲,2023-02-22,9857
2324,仁寶,25,2,23,元大-蘆洲,2023-02-22,9857
00720B,元大投資級公司債,22,0,22,元大-蘆洲,2023-02-22,9857
3035,智原,63,41,22,元大-蘆洲,2023-02-22,9857
2201,裕隆,41,19,22,元大-蘆洲,2023-02-22,9857
0050,元大台灣50,22,1,21,元大-蘆洲,2023-02-22,9857
8038,長園科,23,2,21,元大-蘆洲,2023-02-22,9857
4167,松瑞藥,20,0,20,元大-蘆洲,2023-02-22,9857
4129,聯合,32,12,20,元大-蘆洲,2023-02-22,9857
4743,合一,24,4,20,元大-蘆洲,2023-02-22,9857
1609,大亞,38,19,19,元大-蘆洲,2023-02-22,9857
2705,六福,56,38,18,元大-蘆洲,2023-02-22,9857
3338,泰碩,18,0,18,元大-蘆洲,2023-02-22,9857
3037,欣興,38,20,18,元大-蘆洲,2023-02-22,9857
2498,宏達電,44,27,17,元大-蘆洲,2023-02-22,9857
3710,連展投控,18,1,17,元大-蘆洲,2023-02-22,9857
2702,華園,20,5,15,元大-蘆洲,2023-02-22,9857
00893,國泰智能電動車,15,0,15,元大-蘆洲,2023-02-22,9857
2419,仲琦,16,1,15,元大-蘆洲,2023-02-22,9857
2614,東森,20,5,15,元大-蘆洲,2023-02-22,9857
9934,成霖,15,0,15,元大-蘆洲,2023-02-22,9857
6288,聯嘉,21,6,15,元大-蘆洲,2023-02-22,9857
8478,東哥遊艇,74,59,15,元大-蘆洲,2023-02-22,9857
1519,華城,91,77,14,元大-蘆洲,2023-02-22,9857
2323,中環,15,1,14,元大-蘆洲,2023-02-22,9857
2605,新興,14,0,14,元大-蘆洲,2023-02-22,9857
00632R,元大台灣50反1,970,28,942,元大-蘆洲,2023-02-23,9857
00885,富邦越南,298,2,296,元大-蘆洲,2023-02-23,9857
6015,宏遠證,130,0,130,元大-蘆洲,2023-02-23,9857
3481,群創,154,27,127,元大-蘆洲,2023-02-23,9857
00637L,元大滬深300正2,338,230,108,元大-蘆洲,2023-02-23,9857
6191,精成科,104,0,104,元大-蘆洲,2023-02-23,9857
2337,旺宏,102,0,102,元大-蘆洲,2023-02-23,9857
2812,台中銀,134,41,93,元大-蘆洲,2023-02-23,9857
6005,群益證,60,0,60,元大-蘆洲,2023-02-23,9857
6202,盛群,50,1,49,元大-蘆洲,2023-02-23,9857
4526,東台,52,5,47,元大-蘆洲,2023-02-23,9857
00712,復華富時不動產,51,5,46,元大-蘆洲,2023-02-23,9857
6016,康和證,61,15,46,元大-蘆洲,2023-02-23,9857
00642U,期元大S＆P石油,44,0,44,元大-蘆洲,2023-02-23,9857
6125,廣運,43,0,43,元大-蘆洲,2023-02-23,9857
9934,成霖,42,0,42,元大-蘆洲,2023-02-23,9857
8028,昇陽半導體,41,0,41,元大-蘆洲,2023-02-23,9857
00720B,元大投資級公司債,40,2,38,元大-蘆洲,2023-02-23,9857
3030,德律,34,0,34,元大-蘆洲,2023-02-23,9857
5512,力麒,76,42,34,元大-蘆洲,2023-02-23,9857
00772B,中信高評級公司債,32,0,32,元大-蘆洲,2023-02-23,9857
2313,華通,32,0,32,元大-蘆洲,2023-02-23,9857
2409,友達,34,3,31,元大-蘆洲,2023-02-23,9857
3037,欣興,61,30,31,元大-蘆洲,2023-02-23,9857
2610,華航,33,2,31,元大-蘆洲,2023-02-23,9857
6142,友勁,28,0,28,元大-蘆洲,2023-02-23,9857
00893,國泰智能電動車,30,2,28,元大-蘆洲,2023-02-23,9857
00715L,期街口布蘭特正2,27,0,27,元大-蘆洲,2023-02-23,9857
8131,福懋科,26,0,26,元大-蘆洲,2023-02-23,9857
00891,中信關鍵半導體,29,4,25,元大-蘆洲,2023-02-23,9857
6182,合晶,25,1,24,元大-蘆洲,2023-02-23,9857
2601,益航,26,2,24,元大-蘆洲,2023-02-23,9857
2344,華邦電,46,23,23,元大-蘆洲,2023-02-23,9857
00902,中信電池及儲能,22,0,22,元大-蘆洲,2023-02-23,9857
6456,GIS-KY,24,3,21,元大-蘆洲,2023-02-23,9857
2402,毅嘉,21,0,21,元大-蘆洲,2023-02-23,9857
4770,上品,22,1,21,元大-蘆洲,2023-02-23,9857
8358,金居,25,5,20,元大-蘆洲,2023-02-23,9857
6116,彩晶,33,13,20,元大-蘆洲,2023-02-23,9857
00888,永豐台灣ESG,20,0,20,元大-蘆洲,2023-02-23,9857
8234,新漢,36,16,20,元大-蘆洲,2023-02-23,9857
00751B,元大AAA至A公司債,19,0,19,元大-蘆洲,2023-02-23,9857
2882,國泰金,21,2,19,元大-蘆洲,2023-02-23,9857
1522,堤維西,20,1,19,元大-蘆洲,2023-02-23,9857
3665,貿聯-KY,20,1,19,元大-蘆洲,2023-02-23,9857
6443,元晶,28,9,19,元大-蘆洲,2023-02-23,9857
2329,華泰,20,2,18,元大-蘆洲,2023-02-23,9857
1504,東元,40,23,17,元大-蘆洲,2023-02-23,9857
5704,老爺知,26,10,16,元大-蘆洲,2023-02-23,9857
8105,凌巨,19,3,16,元大-蘆洲,2023-02-23,9857
2605,新興,385,41,344,元大-蘆洲,2023-02-24,9857
6443,元晶,252,10,242,元大-蘆洲,2023-02-24,9857
2882,國泰金,203,6,197,元大-蘆洲,2023-02-24,9857
00637L,元大滬深300正2,175,0,175,元大-蘆洲,2023-02-24,9857
00885,富邦越南,121,6,115,元大-蘆洲,2023-02-24,9857
00878,國泰永續高股息,148,75,73,元大-蘆洲,2023-02-24,9857
5512,力麒,143,80,63,元大-蘆洲,2023-02-24,9857
3037,欣興,125,68,57,元大-蘆洲,2023-02-24,9857
2014,中鴻,61,9,52,元大-蘆洲,2023-02-24,9857
2482,連宇,71,21,50,元大-蘆洲,2023-02-24,9857
2359,所羅門,50,0,50,元大-蘆洲,2023-02-24,9857
1701,中化,48,1,47,元大-蘆洲,2023-02-24,9857
5457,宣德,48,2,46,元大-蘆洲,2023-02-24,9857
2618,長榮航,48,3,45,元大-蘆洲,2023-02-24,9857
2399,映泰,71,33,38,元大-蘆洲,2023-02-24,9857
00882,中信中國高股息,46,10,36,元大-蘆洲,2023-02-24,9857
2611,志信,47,13,34,元大-蘆洲,2023-02-24,9857
2498,宏達電,68,35,33,元大-蘆洲,2023-02-24,9857
6109,亞元,31,0,31,元大-蘆洲,2023-02-24,9857
6026,福邦證,30,0,30,元大-蘆洲,2023-02-24,9857
2748,雲品,33,4,29,元大-蘆洲,2023-02-24,9857
2886,兆豐金,29,0,29,元大-蘆洲,2023-02-24,9857
2303,聯電,52,23,29,元大-蘆洲,2023-02-24,9857
00753L,中信中國50正2,26,0,26,元大-蘆洲,2023-02-24,9857
2317,鴻海,34,9,25,元大-蘆洲,2023-02-24,9857
2834,臺企銀,33,9,24,元大-蘆洲,2023-02-24,9857
2208,台船,58,34,24,元大-蘆洲,2023-02-24,9857
1584,精剛,36,12,24,元大-蘆洲,2023-02-24,9857
3520,華盈,26,2,24,元大-蘆洲,2023-02-24,9857
00715L,期街口布蘭特正2,25,2,23,元大-蘆洲,2023-02-24,9857
2867,三商壽,21,0,21,元大-蘆洲,2023-02-24,9857
1514,亞力,25,5,20,元大-蘆洲,2023-02-24,9857
4503,金雨,20,0,20,元大-蘆洲,2023-02-24,9857
2409,友達,54,34,20,元大-蘆洲,2023-02-24,9857
00772B,中信高評級公司債,20,0,20,元大-蘆洲,2023-02-24,9857
6116,彩晶,45,26,19,元大-蘆洲,2023-02-24,9857
5222,全訊,21,2,19,元大-蘆洲,2023-02-24,9857
1513,中興電,46,27,19,元大-蘆洲,2023-02-24,9857
2002,中鋼,22,4,18,元大-蘆洲,2023-02-24,9857
4167,松瑞藥,20,2,18,元大-蘆洲,2023-02-24,9857
8150,南茂,19,1,18,元大-蘆洲,2023-02-24,9857
3673,TPK-KY,22,5,17,元大-蘆洲,2023-02-24,9857
1907,永豐餘,18,1,17,元大-蘆洲,2023-02-24,9857
3163,波若威,19,2,17,元大-蘆洲,2023-02-24,9857
3045,台灣大,16,0,16,元大-蘆洲,2023-02-24,9857
8033,雷虎,20,4,16,元大-蘆洲,2023-02-24,9857
3661,世芯-KY,18,3,15,元大-蘆洲,2023-02-24,9857
4968,立積,22,7,15,元大-蘆洲,2023-02-24,9857
6719,力智,18,3,15,元大-蘆洲,2023-02-24,9857
2883,凱基金,27,12,15,元大-蘆洲,2023-02-24,9857
1605,華新,334,19,315,元大-蘆洲,2023-03-01,9857
00878,國泰永續高股息,275,6,269,元大-蘆洲,2023-03-01,9857
00885,富邦越南,197,0,197,元大-蘆洲,2023-03-01,9857
0056,元大高股息,113,11,102,元大-蘆洲,2023-03-01,9857
00665L,富邦�琤肭磪囓�2,98,0,98,元大-蘆洲,2023-03-01,9857
2002,中鋼,94,1,93,元大-蘆洲,2023-03-01,9857
6116,彩晶,111,40,71,元大-蘆洲,2023-03-01,9857
2618,長榮航,172,104,68,元大-蘆洲,2023-03-01,9857
3481,群創,71,5,66,元大-蘆洲,2023-03-01,9857
1314,中石化,63,1,62,元大-蘆洲,2023-03-01,9857
2885,元大金,164,104,60,元大-蘆洲,2023-03-01,9857
2104,國際中橡,55,0,55,元大-蘆洲,2023-03-01,9857
2892,第一金,57,3,54,元大-蘆洲,2023-03-01,9857
4763,材料-KY,66,13,53,元大-蘆洲,2023-03-01,9857
2337,旺宏,56,5,51,元大-蘆洲,2023-03-01,9857
2601,益航,371,322,49,元大-蘆洲,2023-03-01,9857
2880,華南金,49,1,48,元大-蘆洲,2023-03-01,9857
5880,合庫金,44,0,44,元大-蘆洲,2023-03-01,9857
3714,富采,45,3,42,元大-蘆洲,2023-03-01,9857
2323,中環,40,1,39,元大-蘆洲,2023-03-01,9857
2014,中鴻,76,38,38,元大-蘆洲,2023-03-01,9857
1217,愛之味,36,3,33,元大-蘆洲,2023-03-01,9857
2017,官田鋼,32,0,32,元大-蘆洲,2023-03-01,9857
2462,良得電,30,0,30,元大-蘆洲,2023-03-01,9857
6266,泰詠,39,11,28,元大-蘆洲,2023-03-01,9857
2888,新光金,29,1,28,元大-蘆洲,2023-03-01,9857
00712,復華富時不動產,28,0,28,元大-蘆洲,2023-03-01,9857
2352,佳世達,32,5,27,元大-蘆洲,2023-03-01,9857
2881,富邦金,29,4,25,元大-蘆洲,2023-03-01,9857
2610,華航,39,15,24,元大-蘆洲,2023-03-01,9857
1709,和益,36,13,23,元大-蘆洲,2023-03-01,9857
00713,元大台灣高息低波,23,0,23,元大-蘆洲,2023-03-01,9857
2344,華邦電,32,11,21,元大-蘆洲,2023-03-01,9857
1218,泰山,21,0,21,元大-蘆洲,2023-03-01,9857
3006,晶豪科,26,6,20,元大-蘆洲,2023-03-01,9857
3013,晟銘電,24,7,17,元大-蘆洲,2023-03-01,9857
2614,東森,17,0,17,元大-蘆洲,2023-03-01,9857
2611,志信,24,7,17,元大-蘆洲,2023-03-01,9857
3037,欣興,43,27,16,元大-蘆洲,2023-03-01,9857
2867,三商壽,16,0,16,元大-蘆洲,2023-03-01,9857
3056,富華新,16,0,16,元大-蘆洲,2023-03-01,9857
3380,明泰,21,5,16,元大-蘆洲,2023-03-01,9857
3264,欣銓,16,0,16,元大-蘆洲,2023-03-01,9857
4919,新唐,25,9,16,元大-蘆洲,2023-03-01,9857
2882,國泰金,21,5,16,元大-蘆洲,2023-03-01,9857
6733,博晟生醫,15,0,15,元大-蘆洲,2023-03-01,9857
2471,資通,16,1,15,元大-蘆洲,2023-03-01,9857
2409,友達,22,7,15,元大-蘆洲,2023-03-01,9857
2317,鴻海,18,3,15,元大-蘆洲,2023-03-01,9857
1319,東陽,17,3,14,元大-蘆洲,2023-03-01,9857
00680L,元大美債20正2,307,1,306,元大-蘆洲,2023-03-02,9857
2892,第一金,208,3,205,元大-蘆洲,2023-03-02,9857
00878,國泰永續高股息,217,14,203,元大-蘆洲,2023-03-02,9857
2880,華南金,140,5,135,元大-蘆洲,2023-03-02,9857
2882,國泰金,87,4,83,元大-蘆洲,2023-03-02,9857
00712,復華富時不動產,92,18,74,元大-蘆洲,2023-03-02,9857
00632R,元大台灣50反1,118,44,74,元大-蘆洲,2023-03-02,9857
5258,虹堡,93,26,67,元大-蘆洲,2023-03-02,9857
00671R,富邦NASDAQ反1,60,0,60,元大-蘆洲,2023-03-02,9857
2886,兆豐金,58,3,55,元大-蘆洲,2023-03-02,9857
2498,宏達電,59,12,47,元大-蘆洲,2023-03-02,9857
2201,裕隆,72,31,41,元大-蘆洲,2023-03-02,9857
4526,東台,41,0,41,元大-蘆洲,2023-03-02,9857
2706,第一店,40,0,40,元大-蘆洲,2023-03-02,9857
9945,潤泰新,42,4,38,元大-蘆洲,2023-03-02,9857
2482,連宇,80,44,36,元大-蘆洲,2023-03-02,9857
2812,台中銀,33,0,33,元大-蘆洲,2023-03-02,9857
1605,華新,227,195,32,元大-蘆洲,2023-03-02,9857
2368,金像電,36,4,32,元大-蘆洲,2023-03-02,9857
3030,德律,31,0,31,元大-蘆洲,2023-03-02,9857
3013,晟銘電,30,0,30,元大-蘆洲,2023-03-02,9857
9933,中鼎,31,1,30,元大-蘆洲,2023-03-02,9857
2332,友訊,31,2,29,元大-蘆洲,2023-03-02,9857
3006,晶豪科,33,6,27,元大-蘆洲,2023-03-02,9857
2801,彰銀,27,0,27,元大-蘆洲,2023-03-02,9857
2605,新興,61,35,26,元大-蘆洲,2023-03-02,9857
2834,臺企銀,36,12,24,元大-蘆洲,2023-03-02,9857
6116,彩晶,31,10,21,元大-蘆洲,2023-03-02,9857
2610,華航,34,13,21,元大-蘆洲,2023-03-02,9857
00893,國泰智能電動車,21,0,21,元大-蘆洲,2023-03-02,9857
6160,欣技,20,0,20,元大-蘆洲,2023-03-02,9857
2504,國產,20,0,20,元大-蘆洲,2023-03-02,9857
9919,康那香,20,0,20,元大-蘆洲,2023-03-02,9857
1714,和桐,20,0,20,元大-蘆洲,2023-03-02,9857
00830,國泰費城半導體,19,0,19,元大-蘆洲,2023-03-02,9857
00902,中信電池及儲能,30,11,19,元大-蘆洲,2023-03-02,9857
4931,新盛力,18,0,18,元大-蘆洲,2023-03-02,9857
00679B,元大美債20年,17,1,16,元大-蘆洲,2023-03-02,9857
2439,美律,19,3,16,元大-蘆洲,2023-03-02,9857
1101,台泥,20,5,15,元大-蘆洲,2023-03-02,9857
2606,裕民,43,28,15,元大-蘆洲,2023-03-02,9857
2312,金寶,15,0,15,元大-蘆洲,2023-03-02,9857
2388,威盛,63,48,15,元大-蘆洲,2023-03-02,9857
2634,漢翔,18,4,14,元大-蘆洲,2023-03-02,9857
00772B,中信高評級公司債,14,0,14,元大-蘆洲,2023-03-02,9857
1503,士電,26,13,13,元大-蘆洲,2023-03-02,9857
2702,華園,14,1,13,元大-蘆洲,2023-03-02,9857
2359,所羅門,24,11,13,元大-蘆洲,2023-03-02,9857
1514,亞力,15,2,13,元大-蘆洲,2023-03-02,9857
3714,富采,12,0,12,元大-蘆洲,2023-03-02,9857
6116,彩晶,325,70,255,元大-蘆洲,2023-03-03,9857
2605,新興,307,72,235,元大-蘆洲,2023-03-03,9857
2014,中鴻,156,5,151,元大-蘆洲,2023-03-03,9857
4979,華星光,126,3,123,元大-蘆洲,2023-03-03,9857
1605,華新,160,47,113,元大-蘆洲,2023-03-03,9857
5880,合庫金,88,0,88,元大-蘆洲,2023-03-03,9857
00632R,元大台灣50反1,157,80,77,元大-蘆洲,2023-03-03,9857
3711,日月光投控,80,4,76,元大-蘆洲,2023-03-03,9857
2834,臺企銀,74,6,68,元大-蘆洲,2023-03-03,9857
2886,兆豐金,65,0,65,元大-蘆洲,2023-03-03,9857
3035,智原,112,54,58,元大-蘆洲,2023-03-03,9857
00712,復華富時不動產,57,0,57,元大-蘆洲,2023-03-03,9857
6235,華孚,127,73,54,元大-蘆洲,2023-03-03,9857
00878,國泰永續高股息,76,22,54,元大-蘆洲,2023-03-03,9857
5351,鈺創,49,9,40,元大-蘆洲,2023-03-03,9857
8033,雷虎,56,17,39,元大-蘆洲,2023-03-03,9857
8171,天宇,40,3,37,元大-蘆洲,2023-03-03,9857
6770,力積電,46,13,33,元大-蘆洲,2023-03-03,9857
2884,玉山金,34,2,32,元大-蘆洲,2023-03-03,9857
00673R,期元大S＆P原油反1,30,0,30,元大-蘆洲,2023-03-03,9857
2201,裕隆,31,2,29,元大-蘆洲,2023-03-03,9857
2867,三商壽,29,0,29,元大-蘆洲,2023-03-03,9857
6142,友勁,33,5,28,元大-蘆洲,2023-03-03,9857
2801,彰銀,29,6,23,元大-蘆洲,2023-03-03,9857
2388,威盛,104,82,22,元大-蘆洲,2023-03-03,9857
5512,力麒,22,0,22,元大-蘆洲,2023-03-03,9857
4960,誠美材,22,0,22,元大-蘆洲,2023-03-03,9857
1810,和成,35,13,22,元大-蘆洲,2023-03-03,9857
4747,強生,33,12,21,元大-蘆洲,2023-03-03,9857
9933,中鼎,20,0,20,元大-蘆洲,2023-03-03,9857
2891,中信金,21,2,19,元大-蘆洲,2023-03-03,9857
3380,明泰,19,0,19,元大-蘆洲,2023-03-03,9857
3056,富華新,19,1,18,元大-蘆洲,2023-03-03,9857
00679B,元大美債20年,22,6,16,元大-蘆洲,2023-03-03,9857
3207,耀勝,34,18,16,元大-蘆洲,2023-03-03,9857
2208,台船,27,11,16,元大-蘆洲,2023-03-03,9857
3049,精金,17,1,16,元大-蘆洲,2023-03-03,9857
8112,至上,19,3,16,元大-蘆洲,2023-03-03,9857
2606,裕民,36,21,15,元大-蘆洲,2023-03-03,9857
2312,金寶,15,0,15,元大-蘆洲,2023-03-03,9857
6244,茂迪,15,0,15,元大-蘆洲,2023-03-03,9857
00751B,元大AAA至A公司債,16,1,15,元大-蘆洲,2023-03-03,9857
2419,仲琦,36,21,15,元大-蘆洲,2023-03-03,9857
00885,富邦越南,15,0,15,元大-蘆洲,2023-03-03,9857
6288,聯嘉,20,6,14,元大-蘆洲,2023-03-03,9857
4533,協易機,17,3,14,元大-蘆洲,2023-03-03,9857
2498,宏達電,31,17,14,元大-蘆洲,2023-03-03,9857
8176,智捷,26,13,13,元大-蘆洲,2023-03-03,9857
1609,大亞,15,2,13,元大-蘆洲,2023-03-03,9857
6488,環球晶,14,2,12,元大-蘆洲,2023-03-03,9857
00632R,元大台灣50反1,465,63,402,元大-蘆洲,2023-03-06,9857
6244,茂迪,180,17,163,元大-蘆洲,2023-03-06,9857
00637L,元大滬深300正2,155,6,149,元大-蘆洲,2023-03-06,9857
3576,聯合再生,200,65,135,元大-蘆洲,2023-03-06,9857
00885,富邦越南,102,0,102,元大-蘆洲,2023-03-06,9857
00719B,元大美債1-3,100,0,100,元大-蘆洲,2023-03-06,9857
00673R,期元大S＆P原油反1,99,0,99,元大-蘆洲,2023-03-06,9857
8105,凌巨,85,4,81,元大-蘆洲,2023-03-06,9857
5608,四維航,84,20,64,元大-蘆洲,2023-03-06,9857
2344,華邦電,173,117,56,元大-蘆洲,2023-03-06,9857
2641,正德,103,47,56,元大-蘆洲,2023-03-06,9857
2883,凱基金,57,3,54,元大-蘆洲,2023-03-06,9857
2888,新光金,53,0,53,元大-蘆洲,2023-03-06,9857
5905,南仁湖,50,0,50,元大-蘆洲,2023-03-06,9857
2610,華航,49,12,37,元大-蘆洲,2023-03-06,9857
00665L,富邦�琤肭磪囓�2,35,0,35,元大-蘆洲,2023-03-06,9857
2425,承啟,35,0,35,元大-蘆洲,2023-03-06,9857
6492,生華科,31,0,31,元大-蘆洲,2023-03-06,9857
2302,麗正,30,0,30,元大-蘆洲,2023-03-06,9857
6841,長佳智能,33,3,30,元大-蘆洲,2023-03-06,9857
00893,國泰智能電動車,49,19,30,元大-蘆洲,2023-03-06,9857
3630,新鉅科,32,3,29,元大-蘆洲,2023-03-06,9857
3706,神達,33,5,28,元大-蘆洲,2023-03-06,9857
2867,三商壽,27,0,27,元大-蘆洲,2023-03-06,9857
2427,三商電,25,0,25,元大-蘆洲,2023-03-06,9857
3714,富采,35,11,24,元大-蘆洲,2023-03-06,9857
2891,中信金,28,4,24,元大-蘆洲,2023-03-06,9857
2736,富野,23,0,23,元大-蘆洲,2023-03-06,9857
4977,眾達-KY,34,11,23,元大-蘆洲,2023-03-06,9857
5258,虹堡,121,98,23,元大-蘆洲,2023-03-06,9857
8049,晶采,21,0,21,元大-蘆洲,2023-03-06,9857
3062,建漢,20,0,20,元大-蘆洲,2023-03-06,9857
1539,巨庭,34,14,20,元大-蘆洲,2023-03-06,9857
6167,久正,20,0,20,元大-蘆洲,2023-03-06,9857
2834,臺企銀,22,3,19,元大-蘆洲,2023-03-06,9857
8176,智捷,19,0,19,元大-蘆洲,2023-03-06,9857
2313,華通,19,1,18,元大-蘆洲,2023-03-06,9857
00720B,元大投資級公司債,18,0,18,元大-蘆洲,2023-03-06,9857
3356,奇偶,45,28,17,元大-蘆洲,2023-03-06,9857
3479,安勤,28,11,17,元大-蘆洲,2023-03-06,9857
2613,中櫃,16,0,16,元大-蘆洲,2023-03-06,9857
2439,美律,22,6,16,元大-蘆洲,2023-03-06,9857
2027,大成鋼,33,18,15,元大-蘆洲,2023-03-06,9857
1301,台塑,17,2,15,元大-蘆洲,2023-03-06,9857
2929,淘帝-KY,15,0,15,元大-蘆洲,2023-03-06,9857
1503,士電,16,1,15,元大-蘆洲,2023-03-06,9857
2642,宅配通,15,0,15,元大-蘆洲,2023-03-06,9857
2882,國泰金,23,8,15,元大-蘆洲,2023-03-06,9857
3114,好德,14,0,14,元大-蘆洲,2023-03-06,9857
6733,博晟生醫,14,0,14,元大-蘆洲,2023-03-06,9857
6116,彩晶,244,31,213,元大-蘆洲,2023-03-07,9857
00885,富邦越南,193,2,191,元大-蘆洲,2023-03-07,9857
3652,精聯,165,5,160,元大-蘆洲,2023-03-07,9857
00632R,元大台灣50反1,205,51,154,元大-蘆洲,2023-03-07,9857
2883,凱基金,156,50,106,元大-蘆洲,2023-03-07,9857
8936,國統,90,1,89,元大-蘆洲,2023-03-07,9857
00673R,期元大S＆P原油反1,87,0,87,元大-蘆洲,2023-03-07,9857
2610,華航,96,12,84,元大-蘆洲,2023-03-07,9857
00878,國泰永續高股息,114,37,77,元大-蘆洲,2023-03-07,9857
3481,群創,329,253,76,元大-蘆洲,2023-03-07,9857
3037,欣興,89,16,73,元大-蘆洲,2023-03-07,9857
2409,友達,80,9,71,元大-蘆洲,2023-03-07,9857
2371,大同,66,2,64,元大-蘆洲,2023-03-07,9857
6244,茂迪,59,5,54,元大-蘆洲,2023-03-07,9857
1440,南紡,51,1,50,元大-蘆洲,2023-03-07,9857
6770,力積電,104,56,48,元大-蘆洲,2023-03-07,9857
8096,擎亞,43,2,41,元大-蘆洲,2023-03-07,9857
2359,所羅門,121,80,41,元大-蘆洲,2023-03-07,9857
5469,瀚宇博,38,0,38,元大-蘆洲,2023-03-07,9857
3027,盛達,50,13,37,元大-蘆洲,2023-03-07,9857
1710,東聯,41,6,35,元大-蘆洲,2023-03-07,9857
6443,元晶,68,36,32,元大-蘆洲,2023-03-07,9857
1810,和成,34,2,32,元大-蘆洲,2023-03-07,9857
8049,晶采,30,0,30,元大-蘆洲,2023-03-07,9857
00650L,復華香港正2,30,0,30,元大-蘆洲,2023-03-07,9857
1736,喬山,30,0,30,元大-蘆洲,2023-03-07,9857
2486,一詮,66,37,29,元大-蘆洲,2023-03-07,9857
5234,達興材料,30,1,29,元大-蘆洲,2023-03-07,9857
00713,元大台灣高息低波,31,5,26,元大-蘆洲,2023-03-07,9857
4915,致伸,35,10,25,元大-蘆洲,2023-03-07,9857
00680L,元大美債20正2,25,0,25,元大-蘆洲,2023-03-07,9857
2344,華邦電,57,33,24,元大-蘆洲,2023-03-07,9857
6109,亞元,26,2,24,元大-蘆洲,2023-03-07,9857
4919,新唐,33,9,24,元大-蘆洲,2023-03-07,9857
3169,亞信,23,1,22,元大-蘆洲,2023-03-07,9857
8033,雷虎,26,5,21,元大-蘆洲,2023-03-07,9857
3051,力特,21,0,21,元大-蘆洲,2023-03-07,9857
4979,華星光,38,18,20,元大-蘆洲,2023-03-07,9857
2891,中信金,34,14,20,元大-蘆洲,2023-03-07,9857
1434,福懋,20,0,20,元大-蘆洲,2023-03-07,9857
3062,建漢,17,0,17,元大-蘆洲,2023-03-07,9857
6283,淳安,17,0,17,元大-蘆洲,2023-03-07,9857
6697,東捷資訊,17,0,17,元大-蘆洲,2023-03-07,9857
2354,鴻準,17,1,16,元大-蘆洲,2023-03-07,9857
1314,中石化,16,0,16,元大-蘆洲,2023-03-07,9857
00852L,國泰美國道瓊正2,17,1,16,元大-蘆洲,2023-03-07,9857
6235,華孚,131,116,15,元大-蘆洲,2023-03-07,9857
3019,亞光,29,14,15,元大-蘆洲,2023-03-07,9857
2929,淘帝-KY,20,5,15,元大-蘆洲,2023-03-07,9857
3703,欣陸,16,1,15,元大-蘆洲,2023-03-07,9857
2883,凱基金,492,2,490,元大-蘆洲,2023-03-08,9857
00637L,元大滬深300正2,557,80,477,元大-蘆洲,2023-03-08,9857
2884,玉山金,431,8,423,元大-蘆洲,2023-03-08,9857
00885,富邦越南,184,0,184,元大-蘆洲,2023-03-08,9857
00923,群益台ESG低碳50,125,0,125,元大-蘆洲,2023-03-08,9857
00632R,元大台灣50反1,257,146,111,元大-蘆洲,2023-03-08,9857
1529,樂事綠能,105,2,103,元大-蘆洲,2023-03-08,9857
5880,合庫金,103,0,103,元大-蘆洲,2023-03-08,9857
00902,中信電池及儲能,97,0,97,元大-蘆洲,2023-03-08,9857
3013,晟銘電,66,7,59,元大-蘆洲,2023-03-08,9857
8936,國統,62,3,59,元大-蘆洲,2023-03-08,9857
2504,國產,51,0,51,元大-蘆洲,2023-03-08,9857
5608,四維航,74,24,50,元大-蘆洲,2023-03-08,9857
2337,旺宏,53,4,49,元大-蘆洲,2023-03-08,9857
1504,東元,54,10,44,元大-蘆洲,2023-03-08,9857
00665L,富邦�琤肭磪囓�2,74,35,39,元大-蘆洲,2023-03-08,9857
2388,威盛,105,68,37,元大-蘆洲,2023-03-08,9857
1102,亞泥,35,0,35,元大-蘆洲,2023-03-08,9857
3289,宜特,48,13,35,元大-蘆洲,2023-03-08,9857
2498,宏達電,54,21,33,元大-蘆洲,2023-03-08,9857
1701,中化,45,12,33,元大-蘆洲,2023-03-08,9857
2201,裕隆,35,4,31,元大-蘆洲,2023-03-08,9857
2515,中工,30,0,30,元大-蘆洲,2023-03-08,9857
912000,晨訊科-DR,30,0,30,元大-蘆洲,2023-03-08,9857
2609,陽明,101,71,30,元大-蘆洲,2023-03-08,9857
3019,亞光,40,11,29,元大-蘆洲,2023-03-08,9857
3092,鴻碩,30,1,29,元大-蘆洲,2023-03-08,9857
1417,嘉裕,27,0,27,元大-蘆洲,2023-03-08,9857
4142,國光生,26,0,26,元大-蘆洲,2023-03-08,9857
2344,華邦電,60,35,25,元大-蘆洲,2023-03-08,9857
8049,晶采,25,1,24,元大-蘆洲,2023-03-08,9857
9105,泰金寶-DR,30,6,24,元大-蘆洲,2023-03-08,9857
2891,中信金,35,12,23,元大-蘆洲,2023-03-08,9857
1584,精剛,50,27,23,元大-蘆洲,2023-03-08,9857
00706L,期元大S＆P日圓正2,23,0,23,元大-蘆洲,2023-03-08,9857
3454,晶睿,29,8,21,元大-蘆洲,2023-03-08,9857
6282,康舒,84,64,20,元大-蘆洲,2023-03-08,9857
6235,華孚,153,133,20,元大-蘆洲,2023-03-08,9857
2317,鴻海,22,2,20,元大-蘆洲,2023-03-08,9857
6160,欣技,20,0,20,元大-蘆洲,2023-03-08,9857
00712,復華富時不動產,19,0,19,元大-蘆洲,2023-03-08,9857
3163,波若威,26,7,19,元大-蘆洲,2023-03-08,9857
2753,八方雲集,18,0,18,元大-蘆洲,2023-03-08,9857
5351,鈺創,31,13,18,元大-蘆洲,2023-03-08,9857
8112,至上,18,0,18,元大-蘆洲,2023-03-08,9857
1503,士電,33,16,17,元大-蘆洲,2023-03-08,9857
00753L,中信中國50正2,17,0,17,元大-蘆洲,2023-03-08,9857
3046,建��,27,10,17,元大-蘆洲,2023-03-08,9857
5425,台半,34,18,16,元大-蘆洲,2023-03-08,9857
2419,仲琦,19,3,16,元大-蘆洲,2023-03-08,9857
00632R,元大台灣50反1,1530,0,1530,元大-蘆洲,2023-03-09,9857
2002,中鋼,349,48,301,元大-蘆洲,2023-03-09,9857
00878,國泰永續高股息,334,48,286,元大-蘆洲,2023-03-09,9857
3481,群創,201,66,135,元大-蘆洲,2023-03-09,9857
5880,合庫金,134,3,131,元大-蘆洲,2023-03-09,9857
1504,東元,109,38,71,元大-蘆洲,2023-03-09,9857
2371,大同,67,2,65,元大-蘆洲,2023-03-09,9857
00885,富邦越南,106,43,63,元大-蘆洲,2023-03-09,9857
3711,日月光投控,60,1,59,元大-蘆洲,2023-03-09,9857
2812,台中銀,57,3,54,元大-蘆洲,2023-03-09,9857
3305,昇貿,51,0,51,元大-蘆洲,2023-03-09,9857
00637L,元大滬深300正2,122,77,45,元大-蘆洲,2023-03-09,9857
8936,國統,64,19,45,元大-蘆洲,2023-03-09,9857
8222,寶一,114,71,43,元大-蘆洲,2023-03-09,9857
2359,所羅門,176,134,42,元大-蘆洲,2023-03-09,9857
2605,新興,42,0,42,元大-蘆洲,2023-03-09,9857
2890,永豐金,40,0,40,元大-蘆洲,2023-03-09,9857
2891,中信金,38,0,38,元大-蘆洲,2023-03-09,9857
00923,群益台ESG低碳50,37,0,37,元大-蘆洲,2023-03-09,9857
2867,三商壽,47,10,37,元大-蘆洲,2023-03-09,9857
3062,建漢,63,29,34,元大-蘆洲,2023-03-09,9857
3290,東浦,47,14,33,元大-蘆洲,2023-03-09,9857
2317,鴻海,38,5,33,元大-蘆洲,2023-03-09,9857
2331,精英,36,5,31,元大-蘆洲,2023-03-09,9857
2425,承啟,30,0,30,元大-蘆洲,2023-03-09,9857
1514,亞力,46,17,29,元大-蘆洲,2023-03-09,9857
6109,亞元,28,0,28,元大-蘆洲,2023-03-09,9857
2419,仲琦,60,33,27,元大-蘆洲,2023-03-09,9857
4763,材料-KY,39,13,26,元大-蘆洲,2023-03-09,9857
1513,中興電,65,39,26,元大-蘆洲,2023-03-09,9857
6116,彩晶,35,10,25,元大-蘆洲,2023-03-09,9857
6235,華孚,86,62,24,元大-蘆洲,2023-03-09,9857
00712,復華富時不動產,24,0,24,元大-蘆洲,2023-03-09,9857
6290,良維,25,2,23,元大-蘆洲,2023-03-09,9857
00655L,國泰中國A50正2,22,0,22,元大-蘆洲,2023-03-09,9857
2498,宏達電,97,75,22,元大-蘆洲,2023-03-09,9857
1101,台泥,38,16,22,元大-蘆洲,2023-03-09,9857
2409,友達,63,42,21,元大-蘆洲,2023-03-09,9857
00715L,期街口布蘭特正2,23,2,21,元大-蘆洲,2023-03-09,9857
5230,雷笛克光學,29,8,21,元大-蘆洲,2023-03-09,9857
6118,建達,37,16,21,元大-蘆洲,2023-03-09,9857
8171,天宇,25,4,21,元大-蘆洲,2023-03-09,9857
6142,友勁,20,0,20,元大-蘆洲,2023-03-09,9857
5706,鳳凰,20,1,19,元大-蘆洲,2023-03-09,9857
5465,富驊,20,1,19,元大-蘆洲,2023-03-09,9857
5512,力麒,19,0,19,元大-蘆洲,2023-03-09,9857
2354,鴻準,20,1,19,元大-蘆洲,2023-03-09,9857
8183,精星,23,4,19,元大-蘆洲,2023-03-09,9857
2880,華南金,18,0,18,元大-蘆洲,2023-03-09,9857
4702,中美實,48,30,18,元大-蘆洲,2023-03-09,9857
00878,國泰永續高股息,333,24,309,元大-蘆洲,2023-03-10,9857
00637L,元大滬深300正2,380,220,160,元大-蘆洲,2023-03-10,9857
2883,凱基金,162,11,151,元大-蘆洲,2023-03-10,9857
00664R,國泰臺灣加權反1,150,0,150,元大-蘆洲,2023-03-10,9857
2618,長榮航,148,11,137,元大-蘆洲,2023-03-10,9857
6116,彩晶,153,30,123,元大-蘆洲,2023-03-10,9857
4167,松瑞藥,104,0,104,元大-蘆洲,2023-03-10,9857
2891,中信金,145,42,103,元大-蘆洲,2023-03-10,9857
00715L,期街口布蘭特正2,121,20,101,元大-蘆洲,2023-03-10,9857
00885,富邦越南,100,0,100,元大-蘆洲,2023-03-10,9857
00676R,富邦臺灣加權反1,120,25,95,元大-蘆洲,2023-03-10,9857
2884,玉山金,116,26,90,元大-蘆洲,2023-03-10,9857
00712,復華富時不動產,101,18,83,元大-蘆洲,2023-03-10,9857
00902,中信電池及儲能,79,0,79,元大-蘆洲,2023-03-10,9857
00882,中信中國高股息,75,3,72,元大-蘆洲,2023-03-10,9857
2610,華航,114,50,64,元大-蘆洲,2023-03-10,9857
00719B,元大美債1-3,60,0,60,元大-蘆洲,2023-03-10,9857
8069,元太,61,4,57,元大-蘆洲,2023-03-10,9857
2880,華南金,52,0,52,元大-蘆洲,2023-03-10,9857
2888,新光金,60,12,48,元大-蘆洲,2023-03-10,9857
9934,成霖,48,0,48,元大-蘆洲,2023-03-10,9857
2368,金像電,49,1,48,元大-蘆洲,2023-03-10,9857
00665L,富邦�琤肭磪囓�2,43,0,43,元大-蘆洲,2023-03-10,9857
1609,大亞,47,6,41,元大-蘆洲,2023-03-10,9857
2867,三商壽,44,4,40,元大-蘆洲,2023-03-10,9857
2344,華邦電,67,27,40,元大-蘆洲,2023-03-10,9857
2892,第一金,39,0,39,元大-蘆洲,2023-03-10,9857
3652,精聯,38,0,38,元大-蘆洲,2023-03-10,9857
00753L,中信中國50正2,38,0,38,元大-蘆洲,2023-03-10,9857
8936,國統,38,1,37,元大-蘆洲,2023-03-10,9857
00713,元大台灣高息低波,42,6,36,元大-蘆洲,2023-03-10,9857
00642U,期元大S＆P石油,35,0,35,元大-蘆洲,2023-03-10,9857
8064,東捷,35,0,35,元大-蘆洲,2023-03-10,9857
3035,智原,42,8,34,元大-蘆洲,2023-03-10,9857
6142,友勁,33,0,33,元大-蘆洲,2023-03-10,9857
2897,王道銀行,33,0,33,元大-蘆洲,2023-03-10,9857
2812,台中銀,55,22,33,元大-蘆洲,2023-03-10,9857
1513,中興電,54,22,32,元大-蘆洲,2023-03-10,9857
2313,華通,36,5,31,元大-蘆洲,2023-03-10,9857
4566,時碩工業,32,1,31,元大-蘆洲,2023-03-10,9857
1314,中石化,36,6,30,元大-蘆洲,2023-03-10,9857
2882,國泰金,33,4,29,元大-蘆洲,2023-03-10,9857
2371,大同,30,1,29,元大-蘆洲,2023-03-10,9857
2022,聚亨,31,2,29,元大-蘆洲,2023-03-10,9857
2317,鴻海,34,5,29,元大-蘆洲,2023-03-10,9857
2481,強茂,35,7,28,元大-蘆洲,2023-03-10,9857
6456,GIS-KY,28,0,28,元大-蘆洲,2023-03-10,9857
00923,群益台ESG低碳50,27,0,27,元大-蘆洲,2023-03-10,9857
5521,工信,27,0,27,元大-蘆洲,2023-03-10,9857
4142,國光生,68,41,27,元大-蘆洲,2023-03-10,9857
00632R,元大台灣50反1,1732,293,1439,元大-蘆洲,2023-03-13,9857
00878,國泰永續高股息,410,54,356,元大-蘆洲,2023-03-13,9857
00676R,富邦臺灣加權反1,250,0,250,元大-蘆洲,2023-03-13,9857
00679B,元大美債20年,200,0,200,元大-蘆洲,2023-03-13,9857
1529,樂事綠能,102,1,101,元大-蘆洲,2023-03-13,9857
2634,漢翔,84,11,73,元大-蘆洲,2023-03-13,9857
00712,復華富時不動產,67,0,67,元大-蘆洲,2023-03-13,9857
1504,東元,109,43,66,元大-蘆洲,2023-03-13,9857
00671R,富邦NASDAQ反1,84,20,64,元大-蘆洲,2023-03-13,9857
00665L,富邦�琤肭磪囓�2,60,0,60,元大-蘆洲,2023-03-13,9857
2609,陽明,190,137,53,元大-蘆洲,2023-03-13,9857
1101,台泥,66,20,46,元大-蘆洲,2023-03-13,9857
1760,寶齡富錦,55,11,44,元大-蘆洲,2023-03-13,9857
6770,力積電,52,9,43,元大-蘆洲,2023-03-13,9857
4164,承業醫,40,0,40,元大-蘆洲,2023-03-13,9857
00902,中信電池及儲能,39,0,39,元大-蘆洲,2023-03-13,9857
00713,元大台灣高息低波,46,7,39,元大-蘆洲,2023-03-13,9857
2344,華邦電,50,13,37,元大-蘆洲,2023-03-13,9857
3046,建��,106,69,37,元大-蘆洲,2023-03-13,9857
00680L,元大美債20正2,50,16,34,元大-蘆洲,2023-03-13,9857
2884,玉山金,49,15,34,元大-蘆洲,2023-03-13,9857
2402,毅嘉,57,24,33,元大-蘆洲,2023-03-13,9857
2413,環科,90,57,33,元大-蘆洲,2023-03-13,9857
2457,飛宏,82,51,31,元大-蘆洲,2023-03-13,9857
5465,富驊,30,0,30,元大-蘆洲,2023-03-13,9857
00719B,元大美債1-3,30,0,30,元大-蘆洲,2023-03-13,9857
3290,東浦,30,0,30,元大-蘆洲,2023-03-13,9857
5351,鈺創,28,0,28,元大-蘆洲,2023-03-13,9857
2023,燁輝,28,1,27,元大-蘆洲,2023-03-13,9857
2867,三商壽,45,20,25,元大-蘆洲,2023-03-13,9857
1316,上曜,70,45,25,元大-蘆洲,2023-03-13,9857
6191,精成科,25,0,25,元大-蘆洲,2023-03-13,9857
2482,連宇,90,66,24,元大-蘆洲,2023-03-13,9857
2388,威盛,120,98,22,元大-蘆洲,2023-03-13,9857
0056,元大高股息,48,26,22,元大-蘆洲,2023-03-13,9857
2601,益航,33,11,22,元大-蘆洲,2023-03-13,9857
3093,港建*,43,22,21,元大-蘆洲,2023-03-13,9857
2352,佳世達,53,33,20,元大-蘆洲,2023-03-13,9857
2453,凌群,52,32,20,元大-蘆洲,2023-03-13,9857
2444,兆勁,20,0,20,元大-蘆洲,2023-03-13,9857
2891,中信金,45,26,19,元大-蘆洲,2023-03-13,9857
6274,台燿,22,4,18,元大-蘆洲,2023-03-13,9857
3033,威健,18,0,18,元大-蘆洲,2023-03-13,9857
4114,健喬,20,2,18,元大-蘆洲,2023-03-13,9857
2882,國泰金,19,3,16,元大-蘆洲,2023-03-13,9857
00720B,元大投資級公司債,16,0,16,元大-蘆洲,2023-03-13,9857
6547,高端疫苗,20,4,16,元大-蘆洲,2023-03-13,9857
6266,泰詠,16,0,16,元大-蘆洲,2023-03-13,9857
2610,華航,51,35,16,元大-蘆洲,2023-03-13,9857
2317,鴻海,32,17,15,元大-蘆洲,2023-03-13,9857
00878,國泰永續高股息,468,194,274,元大-蘆洲,2023-03-14,9857
3576,聯合再生,276,7,269,元大-蘆洲,2023-03-14,9857
1101,台泥,248,32,216,元大-蘆洲,2023-03-14,9857
2615,萬海,211,34,177,元大-蘆洲,2023-03-14,9857
5880,合庫金,255,103,152,元大-蘆洲,2023-03-14,9857
2883,凱基金,145,2,143,元大-蘆洲,2023-03-14,9857
2618,長榮航,190,50,140,元大-蘆洲,2023-03-14,9857
2891,中信金,192,56,136,元大-蘆洲,2023-03-14,9857
2610,華航,144,33,111,元大-蘆洲,2023-03-14,9857
00637L,元大滬深300正2,215,107,108,元大-蘆洲,2023-03-14,9857
6116,彩晶,113,24,89,元大-蘆洲,2023-03-14,9857
2515,中工,91,8,83,元大-蘆洲,2023-03-14,9857
2888,新光金,97,20,77,元大-蘆洲,2023-03-14,9857
2812,台中銀,69,0,69,元大-蘆洲,2023-03-14,9857
2302,麗正,65,0,65,元大-蘆洲,2023-03-14,9857
2885,元大金,184,121,63,元大-蘆洲,2023-03-14,9857
00665L,富邦�琤肭磪囓�2,61,0,61,元大-蘆洲,2023-03-14,9857
4532,瑞智,60,0,60,元大-蘆洲,2023-03-14,9857
00642U,期元大S＆P石油,57,0,57,元大-蘆洲,2023-03-14,9857
2108,南帝,66,11,55,元大-蘆洲,2023-03-14,9857
3481,群創,129,75,54,元大-蘆洲,2023-03-14,9857
3162,精確,64,10,54,元大-蘆洲,2023-03-14,9857
00712,復華富時不動產,55,2,53,元大-蘆洲,2023-03-14,9857
2882,國泰金,53,0,53,元大-蘆洲,2023-03-14,9857
2331,精英,55,8,47,元大-蘆洲,2023-03-14,9857
2409,友達,63,17,46,元大-蘆洲,2023-03-14,9857
00713,元大台灣高息低波,52,7,45,元大-蘆洲,2023-03-14,9857
1451,年興,43,0,43,元大-蘆洲,2023-03-14,9857
8936,國統,44,3,41,元大-蘆洲,2023-03-14,9857
2607,榮運,43,4,39,元大-蘆洲,2023-03-14,9857
2890,永豐金,42,3,39,元大-蘆洲,2023-03-14,9857
2303,聯電,64,25,39,元大-蘆洲,2023-03-14,9857
9934,成霖,38,0,38,元大-蘆洲,2023-03-14,9857
00882,中信中國高股息,76,40,36,元大-蘆洲,2023-03-14,9857
2344,華邦電,43,7,36,元大-蘆洲,2023-03-14,9857
4763,材料-KY,69,35,34,元大-蘆洲,2023-03-14,9857
2884,玉山金,41,9,32,元大-蘆洲,2023-03-14,9857
2359,所羅門,43,11,32,元大-蘆洲,2023-03-14,9857
6290,良維,32,1,31,元大-蘆洲,2023-03-14,9857
6770,力積電,40,9,31,元大-蘆洲,2023-03-14,9857
1504,東元,40,10,30,元大-蘆洲,2023-03-14,9857
00715L,期街口布蘭特正2,30,0,30,元大-蘆洲,2023-03-14,9857
2601,益航,32,3,29,元大-蘆洲,2023-03-14,9857
2892,第一金,33,5,28,元大-蘆洲,2023-03-14,9857
2886,兆豐金,32,4,28,元大-蘆洲,2023-03-14,9857
6274,台燿,33,6,27,元大-蘆洲,2023-03-14,9857
4167,松瑞藥,27,0,27,元大-蘆洲,2023-03-14,9857
2867,三商壽,28,1,27,元大-蘆洲,2023-03-14,9857
00902,中信電池及儲能,86,60,26,元大-蘆洲,2023-03-14,9857
2031,新光鋼,24,0,24,元大-蘆洲,2023-03-14,9857
00632R,元大台灣50反1,676,11,665,元大-蘆洲,2023-03-15,9857
6116,彩晶,466,22,444,元大-蘆洲,2023-03-15,9857
00679B,元大美債20年,279,2,277,元大-蘆洲,2023-03-15,9857
00878,國泰永續高股息,216,19,197,元大-蘆洲,2023-03-15,9857
00772B,中信高評級公司債,196,0,196,元大-蘆洲,2023-03-15,9857
5880,合庫金,182,22,160,元大-蘆洲,2023-03-15,9857
1504,東元,147,22,125,元大-蘆洲,2023-03-15,9857
00650L,復華香港正2,81,0,81,元大-蘆洲,2023-03-15,9857
2891,中信金,83,20,63,元大-蘆洲,2023-03-15,9857
9933,中鼎,62,0,62,元大-蘆洲,2023-03-15,9857
2603,長榮,168,111,57,元大-蘆洲,2023-03-15,9857
2888,新光金,65,12,53,元大-蘆洲,2023-03-15,9857
00712,復華富時不動產,75,22,53,元大-蘆洲,2023-03-15,9857
00715L,期街口布蘭特正2,52,0,52,元大-蘆洲,2023-03-15,9857
2897,王道銀行,51,0,51,元大-蘆洲,2023-03-15,9857
00642U,期元大S＆P石油,43,0,43,元大-蘆洲,2023-03-15,9857
3481,群創,172,130,42,元大-蘆洲,2023-03-15,9857
2201,裕隆,73,35,38,元大-蘆洲,2023-03-15,9857
9945,潤泰新,32,0,32,元大-蘆洲,2023-03-15,9857
2413,環科,76,44,32,元大-蘆洲,2023-03-15,9857
3535,晶彩科,31,0,31,元大-蘆洲,2023-03-15,9857
2882,國泰金,33,2,31,元大-蘆洲,2023-03-15,9857
00713,元大台灣高息低波,32,1,31,元大-蘆洲,2023-03-15,9857
2017,官田鋼,50,20,30,元大-蘆洲,2023-03-15,9857
2801,彰銀,25,0,25,元大-蘆洲,2023-03-15,9857
00665L,富邦�琤肭磪囓�2,67,42,25,元大-蘆洲,2023-03-15,9857
1503,士電,29,4,25,元大-蘆洲,2023-03-15,9857
00773B,中信優先金融債,25,0,25,元大-蘆洲,2023-03-15,9857
2352,佳世達,29,5,24,元大-蘆洲,2023-03-15,9857
2614,東森,39,15,24,元大-蘆洲,2023-03-15,9857
2108,南帝,29,6,23,元大-蘆洲,2023-03-15,9857
3652,精聯,22,0,22,元大-蘆洲,2023-03-15,9857
2883,凱基金,58,36,22,元大-蘆洲,2023-03-15,9857
3576,聯合再生,28,8,20,元大-蘆洲,2023-03-15,9857
00882,中信中國高股息,26,6,20,元大-蘆洲,2023-03-15,9857
1906,寶隆,20,0,20,元大-蘆洲,2023-03-15,9857
2425,承啟,20,0,20,元大-蘆洲,2023-03-15,9857
00733,富邦臺灣中小,20,0,20,元大-蘆洲,2023-03-15,9857
2884,玉山金,19,0,19,元大-蘆洲,2023-03-15,9857
2890,永豐金,21,2,19,元大-蘆洲,2023-03-15,9857
2457,飛宏,91,73,18,元大-蘆洲,2023-03-15,9857
6125,廣運,27,9,18,元大-蘆洲,2023-03-15,9857
00688L,國泰20年美債正2,17,0,17,元大-蘆洲,2023-03-15,9857
2881,富邦金,21,5,16,元大-蘆洲,2023-03-15,9857
2880,華南金,18,2,16,元大-蘆洲,2023-03-15,9857
1736,喬山,19,3,16,元大-蘆洲,2023-03-15,9857
3380,明泰,18,2,16,元大-蘆洲,2023-03-15,9857
00720B,元大投資級公司債,15,0,15,元大-蘆洲,2023-03-15,9857
2486,一詮,37,22,15,元大-蘆洲,2023-03-15,9857
5608,四維航,23,8,15,元大-蘆洲,2023-03-15,9857
00878,國泰永續高股息,306,19,287,元大-蘆洲,2023-03-16,9857
3576,聯合再生,317,32,285,元大-蘆洲,2023-03-16,9857
2891,中信金,228,63,165,元大-蘆洲,2023-03-16,9857
2834,臺企銀,304,156,148,元大-蘆洲,2023-03-16,9857
00772B,中信高評級公司債,146,0,146,元大-蘆洲,2023-03-16,9857
2882,國泰金,92,1,91,元大-蘆洲,2023-03-16,9857
00642U,期元大S＆P石油,101,13,88,元大-蘆洲,2023-03-16,9857
00715L,期街口布蘭特正2,89,2,87,元大-蘆洲,2023-03-16,9857
00676R,富邦臺灣加權反1,100,15,85,元大-蘆洲,2023-03-16,9857
3346,麗清,84,0,84,元大-蘆洲,2023-03-16,9857
2884,玉山金,130,56,74,元大-蘆洲,2023-03-16,9857
3711,日月光投控,70,0,70,元大-蘆洲,2023-03-16,9857
00902,中信電池及儲能,64,0,64,元大-蘆洲,2023-03-16,9857
2603,長榮,112,48,64,元大-蘆洲,2023-03-16,9857
2888,新光金,139,88,51,元大-蘆洲,2023-03-16,9857
2330,台積電,52,3,49,元大-蘆洲,2023-03-16,9857
00713,元大台灣高息低波,51,3,48,元大-蘆洲,2023-03-16,9857
2867,三商壽,55,8,47,元大-蘆洲,2023-03-16,9857
1605,華新,73,29,44,元大-蘆洲,2023-03-16,9857
8105,凌巨,42,0,42,元大-蘆洲,2023-03-16,9857
1609,大亞,88,48,40,元大-蘆洲,2023-03-16,9857
0056,元大高股息,66,27,39,元大-蘆洲,2023-03-16,9857
2618,長榮航,62,23,39,元大-蘆洲,2023-03-16,9857
2609,陽明,87,52,35,元大-蘆洲,2023-03-16,9857
2313,華通,39,5,34,元大-蘆洲,2023-03-16,9857
2615,萬海,55,21,34,元大-蘆洲,2023-03-16,9857
3481,群創,256,224,32,元大-蘆洲,2023-03-16,9857
2312,金寶,31,0,31,元大-蘆洲,2023-03-16,9857
4167,松瑞藥,30,0,30,元大-蘆洲,2023-03-16,9857
2344,華邦電,31,2,29,元大-蘆洲,2023-03-16,9857
9934,成霖,30,1,29,元大-蘆洲,2023-03-16,9857
5009,榮剛,38,11,27,元大-蘆洲,2023-03-16,9857
3290,東浦,29,2,27,元大-蘆洲,2023-03-16,9857
6116,彩晶,51,25,26,元大-蘆洲,2023-03-16,9857
1584,精剛,32,7,25,元大-蘆洲,2023-03-16,9857
2359,所羅門,31,6,25,元大-蘆洲,2023-03-16,9857
2317,鴻海,43,18,25,元大-蘆洲,2023-03-16,9857
3038,全台,25,0,25,元大-蘆洲,2023-03-16,9857
1522,堤維西,24,0,24,元大-蘆洲,2023-03-16,9857
4915,致伸,23,0,23,元大-蘆洲,2023-03-16,9857
6129,普誠,25,2,23,元大-蘆洲,2023-03-16,9857
2302,麗正,62,40,22,元大-蘆洲,2023-03-16,9857
1314,中石化,30,9,21,元大-蘆洲,2023-03-16,9857
9919,康那香,20,0,20,元大-蘆洲,2023-03-16,9857
3178,公準,21,1,20,元大-蘆洲,2023-03-16,9857
1101,台泥,22,2,20,元大-蘆洲,2023-03-16,9857
5519,隆大,19,0,19,元大-蘆洲,2023-03-16,9857
1795,美時,28,9,19,元大-蘆洲,2023-03-16,9857
00712,復華富時不動產,52,35,17,元大-蘆洲,2023-03-16,9857
4919,新唐,21,4,17,元大-蘆洲,2023-03-16,9857
00632R,元大台灣50反1,1258,56,1202,元大-蘆洲,2023-03-17,9857
00715L,期街口布蘭特正2,254,0,254,元大-蘆洲,2023-03-17,9857
2618,長榮航,152,4,148,元大-蘆洲,2023-03-17,9857
00720B,元大投資級公司債,84,0,84,元大-蘆洲,2023-03-17,9857
00712,復華富時不動產,78,0,78,元大-蘆洲,2023-03-17,9857
2888,新光金,64,7,57,元大-蘆洲,2023-03-17,9857
00902,中信電池及儲能,55,0,55,元大-蘆洲,2023-03-17,9857
2610,華航,57,6,51,元大-蘆洲,2023-03-17,9857
00772B,中信高評級公司債,42,0,42,元大-蘆洲,2023-03-17,9857
9945,潤泰新,59,18,41,元大-蘆洲,2023-03-17,9857
2409,友達,80,42,38,元大-蘆洲,2023-03-17,9857
1524,耿鼎,83,46,37,元大-蘆洲,2023-03-17,9857
9934,成霖,33,0,33,元大-蘆洲,2023-03-17,9857
3217,優群,33,1,32,元大-蘆洲,2023-03-17,9857
2891,中信金,53,24,29,元大-蘆洲,2023-03-17,9857
00878,國泰永續高股息,62,35,27,元大-蘆洲,2023-03-17,9857
2881,富邦金,27,0,27,元大-蘆洲,2023-03-17,9857
3062,建漢,26,1,25,元大-蘆洲,2023-03-17,9857
2867,三商壽,24,0,24,元大-蘆洲,2023-03-17,9857
2108,南帝,26,3,23,元大-蘆洲,2023-03-17,9857
00665L,富邦�琤肭磪囓�2,63,40,23,元大-蘆洲,2023-03-17,9857
00713,元大台灣高息低波,36,14,22,元大-蘆洲,2023-03-17,9857
5483,中美晶,46,24,22,元大-蘆洲,2023-03-17,9857
2884,玉山金,22,1,21,元大-蘆洲,2023-03-17,9857
3162,精確,23,3,20,元大-蘆洲,2023-03-17,9857
2344,華邦電,20,0,20,元大-蘆洲,2023-03-17,9857
2462,良得電,20,0,20,元大-蘆洲,2023-03-17,9857
9921,巨大,20,1,19,元大-蘆洲,2023-03-17,9857
9904,寶成,18,1,17,元大-蘆洲,2023-03-17,9857
1582,信錦,17,0,17,元大-蘆洲,2023-03-17,9857
2605,新興,24,7,17,元大-蘆洲,2023-03-17,9857
1308,亞聚,16,0,16,元大-蘆洲,2023-03-17,9857
5299,杰力,16,0,16,元大-蘆洲,2023-03-17,9857
00900,富邦特選高股息30,16,0,16,元大-蘆洲,2023-03-17,9857
2883,凱基金,21,5,16,元大-蘆洲,2023-03-17,9857
1464,得力,15,0,15,元大-蘆洲,2023-03-17,9857
2534,宏盛,15,0,15,元大-蘆洲,2023-03-17,9857
2606,裕民,16,2,14,元大-蘆洲,2023-03-17,9857
2359,所羅門,14,1,13,元大-蘆洲,2023-03-17,9857
5272,笙科,13,0,13,元大-蘆洲,2023-03-17,9857
3207,耀勝,16,3,13,元大-蘆洲,2023-03-17,9857
2243,宏旭-KY,13,0,13,元大-蘆洲,2023-03-17,9857
1319,東陽,16,4,12,元大-蘆洲,2023-03-17,9857
2609,陽明,34,22,12,元大-蘆洲,2023-03-17,9857
2031,新光鋼,16,4,12,元大-蘆洲,2023-03-17,9857
4763,材料-KY,93,81,12,元大-蘆洲,2023-03-17,9857
2885,元大金,32,21,11,元大-蘆洲,2023-03-17,9857
1342,八貫,11,0,11,元大-蘆洲,2023-03-17,9857
00680L,元大美債20正2,11,0,11,元大-蘆洲,2023-03-17,9857
2399,映泰,12,2,10,元大-蘆洲,2023-03-17,9857
00885,富邦越南,223,0,223,元大-蘆洲,2023-03-20,9857
5880,合庫金,203,20,183,元大-蘆洲,2023-03-20,9857
2002,中鋼,165,1,164,元大-蘆洲,2023-03-20,9857
00637L,元大滬深300正2,171,62,109,元大-蘆洲,2023-03-20,9857
2607,榮運,102,0,102,元大-蘆洲,2023-03-20,9857
00632R,元大台灣50反1,331,231,100,元大-蘆洲,2023-03-20,9857
00878,國泰永續高股息,157,65,92,元大-蘆洲,2023-03-20,9857
2884,玉山金,90,0,90,元大-蘆洲,2023-03-20,9857
3481,群創,198,120,78,元大-蘆洲,2023-03-20,9857
00642U,期元大S＆P石油,79,4,75,元大-蘆洲,2023-03-20,9857
1605,華新,96,26,70,元大-蘆洲,2023-03-20,9857
5512,力麒,78,14,64,元大-蘆洲,2023-03-20,9857
1609,大亞,71,13,58,元大-蘆洲,2023-03-20,9857
00676R,富邦臺灣加權反1,50,0,50,元大-蘆洲,2023-03-20,9857
2641,正德,45,0,45,元大-蘆洲,2023-03-20,9857
00882,中信中國高股息,41,0,41,元大-蘆洲,2023-03-20,9857
2834,臺企銀,54,14,40,元大-蘆洲,2023-03-20,9857
5315,光聯,41,1,40,元大-蘆洲,2023-03-20,9857
2845,遠東銀,40,0,40,元大-蘆洲,2023-03-20,9857
2882,國泰金,60,21,39,元大-蘆洲,2023-03-20,9857
2420,新巨,36,0,36,元大-蘆洲,2023-03-20,9857
2482,連宇,54,20,34,元大-蘆洲,2023-03-20,9857
2881,富邦金,36,4,32,元大-蘆洲,2023-03-20,9857
6843,進典,28,0,28,元大-蘆洲,2023-03-20,9857
3046,建��,79,54,25,元大-蘆洲,2023-03-20,9857
6244,茂迪,137,112,25,元大-蘆洲,2023-03-20,9857
9945,潤泰新,35,11,24,元大-蘆洲,2023-03-20,9857
00713,元大台灣高息低波,28,5,23,元大-蘆洲,2023-03-20,9857
1304,台聚,38,16,22,元大-蘆洲,2023-03-20,9857
2027,大成鋼,26,4,22,元大-蘆洲,2023-03-20,9857
00772B,中信高評級公司債,24,3,21,元大-蘆洲,2023-03-20,9857
2601,益航,20,0,20,元大-蘆洲,2023-03-20,9857
6219,富旺,22,2,20,元大-蘆洲,2023-03-20,9857
2317,鴻海,31,12,19,元大-蘆洲,2023-03-20,9857
2603,長榮,44,24,20,元大-蘆洲,2023-03-20,9857
4526,東台,19,0,19,元大-蘆洲,2023-03-20,9857
3545,敦泰,26,7,19,元大-蘆洲,2023-03-20,9857
00902,中信電池及儲能,19,0,19,元大-蘆洲,2023-03-20,9857
3707,漢磊,28,10,18,元大-蘆洲,2023-03-20,9857
6146,耕興,18,0,18,元大-蘆洲,2023-03-20,9857
3051,力特,18,1,17,元大-蘆洲,2023-03-20,9857
2609,陽明,31,14,17,元大-蘆洲,2023-03-20,9857
2888,新光金,28,12,16,元大-蘆洲,2023-03-20,9857
00753L,中信中國50正2,16,0,16,元大-蘆洲,2023-03-20,9857
2880,華南金,15,0,15,元大-蘆洲,2023-03-20,9857
2329,華泰,15,0,15,元大-蘆洲,2023-03-20,9857
1312,國喬,15,0,15,元大-蘆洲,2023-03-20,9857
1503,士電,15,0,15,元大-蘆洲,2023-03-20,9857
00715L,期街口布蘭特正2,35,20,15,元大-蘆洲,2023-03-20,9857
2534,宏盛,14,0,14,元大-蘆洲,2023-03-20,9857
00632R,元大台灣50反1,564,50,514,元大-蘆洲,2023-03-21,9857
2303,聯電,270,15,255,元大-蘆洲,2023-03-21,9857
00885,富邦越南,128,1,127,元大-蘆洲,2023-03-21,9857
2388,威盛,128,49,79,元大-蘆洲,2023-03-21,9857
00900,富邦特選高股息30,74,0,74,元大-蘆洲,2023-03-21,9857
2891,中信金,68,2,66,元大-蘆洲,2023-03-21,9857
00897,富邦基因免疫生技,50,0,50,元大-蘆洲,2023-03-21,9857
5425,台半,69,21,48,元大-蘆洲,2023-03-21,9857
00882,中信中國高股息,48,0,48,元大-蘆洲,2023-03-21,9857
00772B,中信高評級公司債,51,5,46,元大-蘆洲,2023-03-21,9857
3481,群創,227,181,46,元大-蘆洲,2023-03-21,9857
2609,陽明,48,7,41,元大-蘆洲,2023-03-21,9857
3264,欣銓,42,2,40,元大-蘆洲,2023-03-21,9857
2881,富邦金,40,1,39,元大-蘆洲,2023-03-21,9857
6167,久正,35,0,35,元大-蘆洲,2023-03-21,9857
00878,國泰永續高股息,50,18,32,元大-蘆洲,2023-03-21,9857
3011,今皓,32,1,31,元大-蘆洲,2023-03-21,9857
9904,寶成,31,0,31,元大-蘆洲,2023-03-21,9857
2883,凱基金,36,7,29,元大-蘆洲,2023-03-21,9857
2402,毅嘉,48,20,28,元大-蘆洲,2023-03-21,9857
2603,長榮,34,6,28,元大-蘆洲,2023-03-21,9857
3094,聯傑,35,8,27,元大-蘆洲,2023-03-21,9857
2014,中鴻,31,5,26,元大-蘆洲,2023-03-21,9857
00712,復華富時不動產,28,2,26,元大-蘆洲,2023-03-21,9857
2615,萬海,27,2,25,元大-蘆洲,2023-03-21,9857
2409,友達,39,14,25,元大-蘆洲,2023-03-21,9857
2888,新光金,62,38,24,元大-蘆洲,2023-03-21,9857
2420,新巨,26,2,24,元大-蘆洲,2023-03-21,9857
6122,擎邦,36,13,23,元大-蘆洲,2023-03-21,9857
2882,國泰金,25,3,22,元大-蘆洲,2023-03-21,9857
6116,彩晶,27,6,21,元大-蘆洲,2023-03-21,9857
2010,春源,20,0,20,元大-蘆洲,2023-03-21,9857
2462,良得電,20,3,17,元大-蘆洲,2023-03-21,9857
1314,中石化,16,1,15,元大-蘆洲,2023-03-21,9857
2481,強茂,22,7,15,元大-蘆洲,2023-03-21,9857
00665L,富邦�琤肭磪囓�2,15,0,15,元大-蘆洲,2023-03-21,9857
3162,精確,42,28,14,元大-蘆洲,2023-03-21,9857
2880,華南金,19,5,14,元大-蘆洲,2023-03-21,9857
6863,永道-KY,15,1,14,元大-蘆洲,2023-03-21,9857
3047,訊舟,14,0,14,元大-蘆洲,2023-03-21,9857
6235,華孚,73,60,13,元大-蘆洲,2023-03-21,9857
3092,鴻碩,15,2,13,元大-蘆洲,2023-03-21,9857
8467,波力-KY,12,0,12,元大-蘆洲,2023-03-21,9857
6231,系微,19,7,12,元大-蘆洲,2023-03-21,9857
4536,拓凱,12,0,12,元大-蘆洲,2023-03-21,9857
6125,廣運,13,1,12,元大-蘆洲,2023-03-21,9857
2498,宏達電,15,4,11,元大-蘆洲,2023-03-21,9857
4906,正文,11,0,11,元大-蘆洲,2023-03-21,9857
2362,藍天,10,0,10,元大-蘆洲,2023-03-21,9857
6274,台燿,14,4,10,元大-蘆洲,2023-03-21,9857
00632R,元大台灣50反1,2004,125,1879,元大-蘆洲,2023-03-22,9857
2890,永豐金,205,41,164,元大-蘆洲,2023-03-22,9857
00885,富邦越南,118,0,118,元大-蘆洲,2023-03-22,9857
3481,群創,164,56,108,元大-蘆洲,2023-03-22,9857
3576,聯合再生,105,4,101,元大-蘆洲,2023-03-22,9857
00679B,元大美債20年,58,1,57,元大-蘆洲,2023-03-22,9857
2457,飛宏,62,21,41,元大-蘆洲,2023-03-22,9857
00900,富邦特選高股息30,41,0,41,元大-蘆洲,2023-03-22,9857
00772B,中信高評級公司債,37,0,37,元大-蘆洲,2023-03-22,9857
2867,三商壽,51,14,37,元大-蘆洲,2023-03-22,9857
3114,好德,35,0,35,元大-蘆洲,2023-03-22,9857
00680L,元大美債20正2,33,0,33,元大-蘆洲,2023-03-22,9857
2618,長榮航,40,7,33,元大-蘆洲,2023-03-22,9857
2885,元大金,32,3,29,元大-蘆洲,2023-03-22,9857
6244,茂迪,43,14,29,元大-蘆洲,2023-03-22,9857
3042,晶技,25,3,22,元大-蘆洲,2023-03-22,9857
6235,華孚,57,35,22,元大-蘆洲,2023-03-22,9857
5272,笙科,21,0,21,元大-蘆洲,2023-03-22,9857
5258,虹堡,32,12,20,元大-蘆洲,2023-03-22,9857
2891,中信金,30,10,20,元大-蘆洲,2023-03-22,9857
2413,環科,26,7,19,元大-蘆洲,2023-03-22,9857
1609,大亞,23,4,19,元大-蘆洲,2023-03-22,9857
6492,生華科,19,0,19,元大-蘆洲,2023-03-22,9857
4526,東台,18,0,18,元大-蘆洲,2023-03-22,9857
2484,希華,18,0,18,元大-蘆洲,2023-03-22,9857
2495,普安,20,3,17,元大-蘆洲,2023-03-22,9857
3013,晟銘電,25,8,17,元大-蘆洲,2023-03-22,9857
2883,凱基金,32,16,16,元大-蘆洲,2023-03-22,9857
00720B,元大投資級公司債,16,0,16,元大-蘆洲,2023-03-22,9857
2317,鴻海,21,6,15,元大-蘆洲,2023-03-22,9857
3624,光頡,23,8,15,元大-蘆洲,2023-03-22,9857
4157,太景*-KY,15,0,15,元大-蘆洲,2023-03-22,9857
8478,東哥遊艇,30,15,15,元大-蘆洲,2023-03-22,9857
2845,遠東銀,14,0,14,元大-蘆洲,2023-03-22,9857
1802,台玻,14,0,14,元大-蘆洲,2023-03-22,9857
8088,品安,14,0,14,元大-蘆洲,2023-03-22,9857
2482,連宇,79,66,13,元大-蘆洲,2023-03-22,9857
1316,上曜,35,22,13,元大-蘆洲,2023-03-22,9857
00688L,國泰20年美債正2,13,0,13,元大-蘆洲,2023-03-22,9857
2430,燦坤,13,0,13,元大-蘆洲,2023-03-22,9857
3715,定穎投控,57,44,13,元大-蘆洲,2023-03-22,9857
2756,聯發國際,13,0,13,元大-蘆洲,2023-03-22,9857
3162,精確,42,30,12,元大-蘆洲,2023-03-22,9857
2449,京元電子,24,12,12,元大-蘆洲,2023-03-22,9857
2880,華南金,12,0,12,元大-蘆洲,2023-03-22,9857
4930,燦星網,11,0,11,元大-蘆洲,2023-03-22,9857
1584,精剛,19,8,11,元大-蘆洲,2023-03-22,9857
00888,永豐台灣ESG,11,0,11,元大-蘆洲,2023-03-22,9857
8932,智通*,11,0,11,元大-蘆洲,2023-03-22,9857
6142,友勁,10,0,10,元大-蘆洲,2023-03-22,9857
00632R,元大台灣50反1,992,24,968,元大-蘆洲,2023-03-23,9857
2014,中鴻,211,1,210,元大-蘆洲,2023-03-23,9857
00885,富邦越南,190,0,190,元大-蘆洲,2023-03-23,9857
2890,永豐金,102,0,102,元大-蘆洲,2023-03-23,9857
3481,群創,269,175,94,元大-蘆洲,2023-03-23,9857
2303,聯電,123,30,93,元大-蘆洲,2023-03-23,9857
3322,建舜電,76,20,56,元大-蘆洲,2023-03-23,9857
5608,四維航,46,0,46,元大-蘆洲,2023-03-23,9857
3114,好德,43,0,43,元大-蘆洲,2023-03-23,9857
00712,復華富時不動產,57,21,36,元大-蘆洲,2023-03-23,9857
2368,金像電,51,15,36,元大-蘆洲,2023-03-23,9857
00665L,富邦�琤肭磪囓�2,35,0,35,元大-蘆洲,2023-03-23,9857
3653,健策,49,16,33,元大-蘆洲,2023-03-23,9857
8289,泰藝,30,0,30,元大-蘆洲,2023-03-23,9857
1524,耿鼎,73,44,29,元大-蘆洲,2023-03-23,9857
1529,樂事綠能,40,11,29,元大-蘆洲,2023-03-23,9857
6244,茂迪,76,48,28,元大-蘆洲,2023-03-23,9857
2444,兆勁,28,2,26,元大-蘆洲,2023-03-23,9857
2606,裕民,25,0,25,元大-蘆洲,2023-03-23,9857
6288,聯嘉,30,5,25,元大-蘆洲,2023-03-23,9857
00680L,元大美債20正2,25,0,25,元大-蘆洲,2023-03-23,9857
1513,中興電,34,12,22,元大-蘆洲,2023-03-23,9857
3356,奇偶,25,3,22,元大-蘆洲,2023-03-23,9857
2601,益航,24,3,21,元大-蘆洲,2023-03-23,9857
5272,笙科,21,0,21,元大-蘆洲,2023-03-23,9857
00900,富邦特選高股息30,47,27,20,元大-蘆洲,2023-03-23,9857
8358,金居,21,2,19,元大-蘆洲,2023-03-23,9857
00713,元大台灣高息低波,20,1,19,元大-蘆洲,2023-03-23,9857
2610,華航,19,0,19,元大-蘆洲,2023-03-23,9857
4763,材料-KY,42,24,18,元大-蘆洲,2023-03-23,9857
3682,亞太電,18,0,18,元大-蘆洲,2023-03-23,9857
4526,東台,18,0,18,元大-蘆洲,2023-03-23,9857
2495,普安,18,0,18,元大-蘆洲,2023-03-23,9857
6148,驊宏資,40,23,17,元大-蘆洲,2023-03-23,9857
2201,裕隆,28,12,16,元大-蘆洲,2023-03-23,9857
6005,群益證,16,0,16,元大-蘆洲,2023-03-23,9857
4157,太景*-KY,15,0,15,元大-蘆洲,2023-03-23,9857
2515,中工,15,0,15,元大-蘆洲,2023-03-23,9857
2317,鴻海,17,3,14,元大-蘆洲,2023-03-23,9857
2637,慧洋-KY,16,2,14,元大-蘆洲,2023-03-23,9857
2641,正德,14,0,14,元大-蘆洲,2023-03-23,9857
00715L,期街口布蘭特正2,24,11,13,元大-蘆洲,2023-03-23,9857
00893,國泰智能電動車,16,3,13,元大-蘆洲,2023-03-23,9857
6605,帝寶,13,0,13,元大-蘆洲,2023-03-23,9857
1319,東陽,24,11,13,元大-蘆洲,2023-03-23,9857
2881,富邦金,15,2,13,元大-蘆洲,2023-03-23,9857
2834,臺企銀,13,0,13,元大-蘆洲,2023-03-23,9857
5351,鈺創,41,28,13,元大-蘆洲,2023-03-23,9857
00714,群益道瓊美國地產,12,0,12,元大-蘆洲,2023-03-23,9857
3545,敦泰,29,17,12,元大-蘆洲,2023-03-23,9857
2303,聯電,132,25,107,元大-蘆洲,2023-03-24,9857
2887,台新金,101,1,100,元大-蘆洲,2023-03-24,9857
00632R,元大台灣50反1,223,129,94,元大-蘆洲,2023-03-24,9857
1605,華新,155,68,87,元大-蘆洲,2023-03-24,9857
1609,大亞,182,104,78,元大-蘆洲,2023-03-24,9857
2618,長榮航,74,11,63,元大-蘆洲,2023-03-24,9857
3715,定穎投控,94,38,56,元大-蘆洲,2023-03-24,9857
6125,廣運,54,0,54,元大-蘆洲,2023-03-24,9857
5475,德宏,54,1,53,元大-蘆洲,2023-03-24,9857
00773B,中信優先金融債,52,0,52,元大-蘆洲,2023-03-24,9857
6129,普誠,54,5,49,元大-蘆洲,2023-03-24,9857
4763,材料-KY,77,32,45,元大-蘆洲,2023-03-24,9857
00664R,國泰臺灣加權反1,45,0,45,元大-蘆洲,2023-03-24,9857
00772B,中信高評級公司債,38,0,38,元大-蘆洲,2023-03-24,9857
3432,台端,56,18,38,元大-蘆洲,2023-03-24,9857
3322,建舜電,89,52,37,元大-蘆洲,2023-03-24,9857
1513,中興電,52,17,35,元大-蘆洲,2023-03-24,9857
3031,佰鴻,35,1,34,元大-蘆洲,2023-03-24,9857
2014,中鴻,49,15,34,元大-蘆洲,2023-03-24,9857
8105,凌巨,32,0,32,元大-蘆洲,2023-03-24,9857
2329,華泰,33,1,32,元大-蘆洲,2023-03-24,9857
2495,普安,33,2,31,元大-蘆洲,2023-03-24,9857
00900,富邦特選高股息30,37,6,31,元大-蘆洲,2023-03-24,9857
00674R,期元大S＆P黃金反1,30,0,30,元大-蘆洲,2023-03-24,9857
3682,亞太電,29,0,29,元大-蘆洲,2023-03-24,9857
6148,驊宏資,36,7,29,元大-蘆洲,2023-03-24,9857
5351,鈺創,43,14,29,元大-蘆洲,2023-03-24,9857
2883,凱基金,37,9,28,元大-蘆洲,2023-03-24,9857
00888,永豐台灣ESG,30,2,28,元大-蘆洲,2023-03-24,9857
1810,和成,27,2,25,元大-蘆洲,2023-03-24,9857
3231,緯創,73,49,24,元大-蘆洲,2023-03-24,9857
2352,佳世達,24,0,24,元大-蘆洲,2023-03-24,9857
2603,長榮,30,6,24,元大-蘆洲,2023-03-24,9857
4919,新唐,30,7,23,元大-蘆洲,2023-03-24,9857
2388,威盛,97,75,22,元大-蘆洲,2023-03-24,9857
00713,元大台灣高息低波,27,6,21,元大-蘆洲,2023-03-24,9857
4107,邦特,21,0,21,元大-蘆洲,2023-03-24,9857
00697B,元大美債7-10,20,0,20,元大-蘆洲,2023-03-24,9857
6122,擎邦,35,16,19,元大-蘆洲,2023-03-24,9857
2880,華南金,26,10,16,元大-蘆洲,2023-03-24,9857
6160,欣技,39,23,16,元大-蘆洲,2023-03-24,9857
6134,萬旭,30,15,15,元大-蘆洲,2023-03-24,9857
3520,華盈,23,8,15,元大-蘆洲,2023-03-24,9857
8163,達方,15,0,15,元大-蘆洲,2023-03-24,9857
3189,景碩,41,26,15,元大-蘆洲,2023-03-24,9857
6416,瑞祺電通,15,1,14,元大-蘆洲,2023-03-24,9857
2471,資通,21,7,14,元大-蘆洲,2023-03-24,9857
4960,誠美材,19,6,13,元大-蘆洲,2023-03-24,9857
3025,星通,16,3,13,元大-蘆洲,2023-03-24,9857
00720B,元大投資級公司債,13,0,13,元大-蘆洲,2023-03-24,9857
00922,國泰台灣領袖50,219,0,219,元大-蘆洲,2023-03-27,9857
1605,華新,218,51,167,元大-蘆洲,2023-03-27,9857
00882,中信中國高股息,156,10,146,元大-蘆洲,2023-03-27,9857
00679B,元大美債20年,97,13,84,元大-蘆洲,2023-03-27,9857
00637L,元大滬深300正2,192,109,83,元大-蘆洲,2023-03-27,9857
6244,茂迪,215,142,73,元大-蘆洲,2023-03-27,9857
3481,群創,81,9,72,元大-蘆洲,2023-03-27,9857
2476,鉅祥,70,0,70,元大-蘆洲,2023-03-27,9857
6799,來頡,73,3,70,元大-蘆洲,2023-03-27,9857
6770,力積電,71,2,69,元大-蘆洲,2023-03-27,9857
2201,裕隆,72,3,69,元大-蘆洲,2023-03-27,9857
3006,晶豪科,68,6,62,元大-蘆洲,2023-03-27,9857
4906,正文,60,3,57,元大-蘆洲,2023-03-27,9857
2883B,凱基金乙特,55,0,55,元大-蘆洲,2023-03-27,9857
1504,東元,162,108,54,元大-蘆洲,2023-03-27,9857
6288,聯嘉,93,48,45,元大-蘆洲,2023-03-27,9857
2610,華航,51,7,44,元大-蘆洲,2023-03-27,9857
2340,台亞,49,6,43,元大-蘆洲,2023-03-27,9857
6841,長佳智能,38,0,38,元大-蘆洲,2023-03-27,9857
3714,富采,51,18,33,元大-蘆洲,2023-03-27,9857
2891,中信金,40,7,33,元大-蘆洲,2023-03-27,9857
00772B,中信高評級公司債,32,0,32,元大-蘆洲,2023-03-27,9857
2303,聯電,40,8,32,元大-蘆洲,2023-03-27,9857
2421,建準,33,3,30,元大-蘆洲,2023-03-27,9857
2002,中鋼,29,1,28,元大-蘆洲,2023-03-27,9857
6275,元山,27,0,27,元大-蘆洲,2023-03-27,9857
00632R,元大台灣50反1,30,3,27,元大-蘆洲,2023-03-27,9857
3260,威剛,29,6,23,元大-蘆洲,2023-03-27,9857
8088,品安,25,2,23,元大-蘆洲,2023-03-27,9857
2481,強茂,23,0,23,元大-蘆洲,2023-03-27,9857
6443,元晶,71,49,22,元大-蘆洲,2023-03-27,9857
3689,湧德,22,0,22,元大-蘆洲,2023-03-27,9857
2323,中環,22,1,21,元大-蘆洲,2023-03-27,9857
4919,新唐,32,11,21,元大-蘆洲,2023-03-27,9857
2609,陽明,33,12,21,元大-蘆洲,2023-03-27,9857
6167,久正,20,0,20,元大-蘆洲,2023-03-27,9857
00708L,期元大S＆P黃金正2,20,0,20,元大-蘆洲,2023-03-27,9857
6550,北極星藥業-KY,25,5,20,元大-蘆洲,2023-03-27,9857
3032,偉訓,20,1,19,元大-蘆洲,2023-03-27,9857
6182,合晶,26,8,18,元大-蘆洲,2023-03-27,9857
6485,點序,33,16,17,元大-蘆洲,2023-03-27,9857
6129,普誠,17,0,17,元大-蘆洲,2023-03-27,9857
6276,安鈦克,18,1,17,元大-蘆洲,2023-03-27,9857
4904,遠傳,16,0,16,元大-蘆洲,2023-03-27,9857
2332,友訊,21,6,15,元大-蘆洲,2023-03-27,9857
1473,台南,15,0,15,元大-蘆洲,2023-03-27,9857
2413,環科,22,7,15,元大-蘆洲,2023-03-27,9857
2027,大成鋼,19,4,15,元大-蘆洲,2023-03-27,9857
2404,漢唐,13,0,13,元大-蘆洲,2023-03-27,9857
3576,聯合再生,13,0,13,元大-蘆洲,2023-03-27,9857
1605,華新,241,37,204,元大-蘆洲,2023-03-28,9857
00679B,元大美債20年,126,0,126,元大-蘆洲,2023-03-28,9857
6226,光鼎,110,2,108,元大-蘆洲,2023-03-28,9857
00878,國泰永續高股息,100,21,79,元大-蘆洲,2023-03-28,9857
00882,中信中國高股息,81,5,76,元大-蘆洲,2023-03-28,9857
6770,力積電,77,5,72,元大-蘆洲,2023-03-28,9857
00922,國泰台灣領袖50,66,0,66,元大-蘆洲,2023-03-28,9857
2515,中工,61,0,61,元大-蘆洲,2023-03-28,9857
8105,凌巨,61,0,61,元大-蘆洲,2023-03-28,9857
2481,強茂,81,24,57,元大-蘆洲,2023-03-28,9857
2402,毅嘉,63,9,54,元大-蘆洲,2023-03-28,9857
2344,華邦電,54,2,52,元大-蘆洲,2023-03-28,9857
5439,高技,52,2,50,元大-蘆洲,2023-03-28,9857
2891,中信金,59,12,47,元大-蘆洲,2023-03-28,9857
2425,承啟,40,0,40,元大-蘆洲,2023-03-28,9857
00665L,富邦�琤肭磪囓�2,42,6,36,元大-蘆洲,2023-03-28,9857
3035,智原,67,32,35,元大-蘆洲,2023-03-28,9857
3033,威健,34,0,34,元大-蘆洲,2023-03-28,9857
00680L,元大美債20正2,33,0,33,元大-蘆洲,2023-03-28,9857
5425,台半,55,23,32,元大-蘆洲,2023-03-28,9857
5285,界霖,31,0,31,元大-蘆洲,2023-03-28,9857
6167,久正,30,0,30,元大-蘆洲,2023-03-28,9857
5351,鈺創,33,3,30,元大-蘆洲,2023-03-28,9857
2731,雄獅,56,26,30,元大-蘆洲,2023-03-28,9857
3037,欣興,57,32,25,元大-蘆洲,2023-03-28,9857
00720B,元大投資級公司債,26,0,26,元大-蘆洲,2023-03-28,9857
00632R,元大台灣50反1,26,2,24,元大-蘆洲,2023-03-28,9857
3046,建��,27,3,24,元大-蘆洲,2023-03-28,9857
2476,鉅祥,36,13,23,元大-蘆洲,2023-03-28,9857
2409,友達,29,6,23,元大-蘆洲,2023-03-28,9857
2618,長榮航,45,22,23,元大-蘆洲,2023-03-28,9857
00772B,中信高評級公司債,23,0,23,元大-蘆洲,2023-03-28,9857
2303,聯電,31,8,23,元大-蘆洲,2023-03-28,9857
3715,定穎投控,87,64,23,元大-蘆洲,2023-03-28,9857
00688L,國泰20年美債正2,22,0,22,元大-蘆洲,2023-03-28,9857
6116,彩晶,22,0,22,元大-蘆洲,2023-03-28,9857
3481,群創,29,7,22,元大-蘆洲,2023-03-28,9857
1217,愛之味,21,0,21,元大-蘆洲,2023-03-28,9857
3088,艾訊,21,0,21,元大-蘆洲,2023-03-28,9857
00900,富邦特選高股息30,23,3,20,元大-蘆洲,2023-03-28,9857
6177,達麗,20,0,20,元大-蘆洲,2023-03-28,9857
2610,華航,38,19,19,元大-蘆洲,2023-03-28,9857
1342,八貫,30,11,19,元大-蘆洲,2023-03-28,9857
1802,台玻,20,1,19,元大-蘆洲,2023-03-28,9857
2002,中鋼,26,8,18,元大-蘆洲,2023-03-28,9857
00671R,富邦NASDAQ反1,20,3,17,元大-蘆洲,2023-03-28,9857
6733,博晟生醫,17,0,17,元大-蘆洲,2023-03-28,9857
3362,先進光,71,55,16,元大-蘆洲,2023-03-28,9857
2453,凌群,24,9,15,元大-蘆洲,2023-03-28,9857
2605,新興,17,2,15,元大-蘆洲,2023-03-28,9857
2014,中鴻,281,0,281,元大-蘆洲,2023-03-29,9857
1605,華新,148,23,125,元大-蘆洲,2023-03-29,9857
2002,中鋼,91,9,82,元大-蘆洲,2023-03-29,9857
00679B,元大美債20年,81,2,79,元大-蘆洲,2023-03-29,9857
4979,華星光,110,58,52,元大-蘆洲,2023-03-29,9857
1618,合機,56,5,51,元大-蘆洲,2023-03-29,9857
2884,玉山金,64,15,49,元大-蘆洲,2023-03-29,9857
00673R,期元大S＆P原油反1,45,0,45,元大-蘆洲,2023-03-29,9857
00680L,元大美債20正2,41,0,41,元大-蘆洲,2023-03-29,9857
2303,聯電,45,13,32,元大-蘆洲,2023-03-29,9857
2883,凱基金,55,26,29,元大-蘆洲,2023-03-29,9857
3260,威剛,40,12,28,元大-蘆洲,2023-03-29,9857
00922,國泰台灣領袖50,24,0,24,元大-蘆洲,2023-03-29,9857
9945,潤泰新,26,2,24,元大-蘆洲,2023-03-29,9857
00882,中信中國高股息,23,0,23,元大-蘆洲,2023-03-29,9857
1609,大亞,62,39,23,元大-蘆洲,2023-03-29,9857
6235,華孚,61,39,22,元大-蘆洲,2023-03-29,9857
2801,彰銀,20,0,20,元大-蘆洲,2023-03-29,9857
6257,矽格,20,0,20,元大-蘆洲,2023-03-29,9857
2367,燿華,30,10,20,元大-蘆洲,2023-03-29,9857
3264,欣銓,20,0,20,元大-蘆洲,2023-03-29,9857
3272,東碩,21,1,20,元大-蘆洲,2023-03-29,9857
2340,台亞,22,3,19,元大-蘆洲,2023-03-29,9857
2365,昆盈,19,0,19,元大-蘆洲,2023-03-29,9857
3051,力特,25,6,19,元大-蘆洲,2023-03-29,9857
2603,長榮,21,3,18,元大-蘆洲,2023-03-29,9857
8249,菱光,17,0,17,元大-蘆洲,2023-03-29,9857
2888,新光金,43,26,17,元大-蘆洲,2023-03-29,9857
00772B,中信高評級公司債,17,0,17,元大-蘆洲,2023-03-29,9857
2388,威盛,67,50,17,元大-蘆洲,2023-03-29,9857
3017,奇鋐,37,21,16,元大-蘆洲,2023-03-29,9857
1762,中化生,23,7,16,元大-蘆洲,2023-03-29,9857
1591,駿吉-KY,15,0,15,元大-蘆洲,2023-03-29,9857
6275,元山,15,0,15,元大-蘆洲,2023-03-29,9857
6205,詮欣,14,0,14,元大-蘆洲,2023-03-29,9857
6770,力積電,26,12,14,元大-蘆洲,2023-03-29,9857
3707,漢磊,22,9,13,元大-蘆洲,2023-03-29,9857
2641,正德,13,0,13,元大-蘆洲,2023-03-29,9857
8064,東捷,12,0,12,元大-蘆洲,2023-03-29,9857
3714,富采,15,3,12,元大-蘆洲,2023-03-29,9857
2332,友訊,14,2,12,元大-蘆洲,2023-03-29,9857
3037,欣興,49,38,11,元大-蘆洲,2023-03-29,9857
3545,敦泰,11,0,11,元大-蘆洲,2023-03-29,9857
3047,訊舟,11,0,11,元大-蘆洲,2023-03-29,9857
2498,宏達電,23,12,11,元大-蘆洲,2023-03-29,9857
2883B,凱基金乙特,10,0,10,元大-蘆洲,2023-03-29,9857
020029,元大ESG高股息N,10,0,10,元大-蘆洲,2023-03-29,9857
3025,星通,16,6,10,元大-蘆洲,2023-03-29,9857
6163,華電網,10,0,10,元大-蘆洲,2023-03-29,9857
8105,凌巨,10,0,10,元大-蘆洲,2023-03-29,9857
6134,萬旭,140,45,95,元大-蘆洲,2023-03-30,9857
8050,廣積,74,6,68,元大-蘆洲,2023-03-30,9857
2885,元大金,69,2,67,元大-蘆洲,2023-03-30,9857
6179,亞通,56,0,56,元大-蘆洲,2023-03-30,9857
2887,台新金,52,0,52,元大-蘆洲,2023-03-30,9857
3042,晶技,53,1,52,元大-蘆洲,2023-03-30,9857
4906,正文,52,3,49,元大-蘆洲,2023-03-30,9857
6443,元晶,43,6,37,元大-蘆洲,2023-03-30,9857
00882,中信中國高股息,44,7,37,元大-蘆洲,2023-03-30,9857
2753,八方雲集,38,7,31,元大-蘆洲,2023-03-30,9857
2515,中工,31,0,31,元大-蘆洲,2023-03-30,9857
5469,瀚宇博,36,10,26,元大-蘆洲,2023-03-30,9857
3105,穩懋,28,3,25,元大-蘆洲,2023-03-30,9857
00679B,元大美債20年,24,0,24,元大-蘆洲,2023-03-30,9857
2881,富邦金,35,11,24,元大-蘆洲,2023-03-30,9857
6133,金橋,30,6,24,元大-蘆洲,2023-03-30,9857
2368,金像電,26,3,23,元大-蘆洲,2023-03-30,9857
8255,朋程,31,8,23,元大-蘆洲,2023-03-30,9857
2332,友訊,21,0,21,元大-蘆洲,2023-03-30,9857
00665L,富邦�琤肭磪囓�2,43,22,21,元大-蘆洲,2023-03-30,9857
2889,國票金,22,1,21,元大-蘆洲,2023-03-30,9857
2331,精英,22,2,20,元大-蘆洲,2023-03-30,9857
2883,凱基金,21,1,20,元大-蘆洲,2023-03-30,9857
3036,文曄,20,1,19,元大-蘆洲,2023-03-30,9857
6282,康舒,21,2,19,元大-蘆洲,2023-03-30,9857
2543,皇昌,16,0,16,元大-蘆洲,2023-03-30,9857
5222,全訊,18,3,15,元大-蘆洲,2023-03-30,9857
2426,鼎元,14,0,14,元大-蘆洲,2023-03-30,9857
6205,詮欣,14,0,14,元大-蘆洲,2023-03-30,9857
8147,正淩,24,12,12,元大-蘆洲,2023-03-30,9857
2610,華航,15,3,12,元大-蘆洲,2023-03-30,9857
2413,環科,23,11,12,元大-蘆洲,2023-03-30,9857
2359,所羅門,39,27,12,元大-蘆洲,2023-03-30,9857
9962,有益,11,0,11,元大-蘆洲,2023-03-30,9857
2534,宏盛,22,11,11,元大-蘆洲,2023-03-30,9857
00713,元大台灣高息低波,13,2,11,元大-蘆洲,2023-03-30,9857
00888,永豐台灣ESG,10,0,10,元大-蘆洲,2023-03-30,9857
6285,啟��,49,39,10,元大-蘆洲,2023-03-30,9857
00715L,期街口布蘭特正2,10,0,10,元大-蘆洲,2023-03-30,9857
6276,安鈦克,10,0,10,元大-蘆洲,2023-03-30,9857
1314,中石化,11,1,10,元大-蘆洲,2023-03-30,9857
3704,合勤控,10,0,10,元大-蘆洲,2023-03-30,9857
2609,陽明,31,21,10,元大-蘆洲,2023-03-30,9857
6125,廣運,10,0,10,元大-蘆洲,2023-03-30,9857
2801,彰銀,10,1,9,元大-蘆洲,2023-03-30,9857
2376,技嘉,18,9,9,元大-蘆洲,2023-03-30,9857
3444,利機,9,0,9,元大-蘆洲,2023-03-30,9857
6244,茂迪,63,54,9,元大-蘆洲,2023-03-30,9857
3706,神達,10,1,9,元大-蘆洲,2023-03-30,9857
2538,基泰,8,0,8,元大-蘆洲,2023-03-30,9857
00632R,元大台灣50反1,178,54,124,元大-蘆洲,2023-03-31,9857
4746,台耀,87,8,79,元大-蘆洲,2023-03-31,9857
5309,系統電,121,53,68,元大-蘆洲,2023-03-31,9857
00673R,期元大S＆P原油反1,55,0,55,元大-蘆洲,2023-03-31,9857
5465,富驊,59,8,51,元大-蘆洲,2023-03-31,9857
2302,麗正,64,21,43,元大-蘆洲,2023-03-31,9857
2427,三商電,38,0,38,元大-蘆洲,2023-03-31,9857
6276,安鈦克,38,0,38,元大-蘆洲,2023-03-31,9857
4979,華星光,46,14,32,元大-蘆洲,2023-03-31,9857
2359,所羅門,31,6,25,元大-蘆洲,2023-03-31,9857
3046,建��,38,14,24,元大-蘆洲,2023-03-31,9857
3711,日月光投控,24,0,24,元大-蘆洲,2023-03-31,9857
5608,四維航,27,4,23,元大-蘆洲,2023-03-31,9857
2402,毅嘉,23,1,22,元大-蘆洲,2023-03-31,9857
2482,連宇,38,16,22,元大-蘆洲,2023-03-31,9857
6547,高端疫苗,21,0,21,元大-蘆洲,2023-03-31,9857
2867,三商壽,28,7,21,元大-蘆洲,2023-03-31,9857
8277,商丞,20,1,19,元大-蘆洲,2023-03-31,9857
4763,材料-KY,25,6,19,元大-蘆洲,2023-03-31,9857
1714,和桐,32,14,18,元大-蘆洲,2023-03-31,9857
3491,昇達科,38,21,17,元大-蘆洲,2023-03-31,9857
3038,全台,23,6,17,元大-蘆洲,2023-03-31,9857
1519,華城,20,4,16,元大-蘆洲,2023-03-31,9857
1314,中石化,21,5,16,元大-蘆洲,2023-03-31,9857
1609,大亞,29,13,16,元大-蘆洲,2023-03-31,9857
00664R,國泰臺灣加權反1,15,0,15,元大-蘆洲,2023-03-31,9857
3272,東碩,17,2,15,元大-蘆洲,2023-03-31,9857
3693,營邦,17,2,15,元大-蘆洲,2023-03-31,9857
6603,富強鑫,15,0,15,元大-蘆洲,2023-03-31,9857
1513,中興電,26,12,14,元大-蘆洲,2023-03-31,9857
00772B,中信高評級公司債,14,0,14,元大-蘆洲,2023-03-31,9857
5381,合正,14,0,14,元大-蘆洲,2023-03-31,9857
8936,國統,15,1,14,元大-蘆洲,2023-03-31,9857
3346,麗清,15,1,14,元大-蘆洲,2023-03-31,9857
6205,詮欣,13,0,13,元大-蘆洲,2023-03-31,9857
1810,和成,15,2,13,元大-蘆洲,2023-03-31,9857
2457,飛宏,46,33,13,元大-蘆洲,2023-03-31,9857
1504,東元,31,18,13,元大-蘆洲,2023-03-31,9857
8107,大億金茂,12,0,12,元大-蘆洲,2023-03-31,9857
00650L,復華香港正2,12,0,12,元大-蘆洲,2023-03-31,9857
8222,寶一,13,1,12,元大-蘆洲,2023-03-31,9857
2337,旺宏,35,23,12,元大-蘆洲,2023-03-31,9857
2356,英業達,16,4,12,元大-蘆洲,2023-03-31,9857
2609,陽明,44,33,11,元大-蘆洲,2023-03-31,9857
2453,凌群,21,10,11,元大-蘆洲,2023-03-31,9857
4526,東台,11,0,11,元大-蘆洲,2023-03-31,9857
6282,康舒,16,5,11,元大-蘆洲,2023-03-31,9857
1605,華新,81,70,11,元大-蘆洲,2023-03-31,9857
3545,敦泰,11,0,11,元大-蘆洲,2023-03-31,9857
6550,北極星藥業-KY,11,0,11,元大-蘆洲,2023-03-31,9857
00673R,期元大S＆P原油反1,486,0,486,元大-蘆洲,2023-04-06,9857
3576,聯合再生,208,3,205,元大-蘆洲,2023-04-06,9857
00902,中信電池及儲能,171,15,156,元大-蘆洲,2023-04-06,9857
2344,華邦電,140,16,124,元大-蘆洲,2023-04-06,9857
1308,亞聚,84,6,78,元大-蘆洲,2023-04-06,9857
00882,中信中國高股息,66,0,66,元大-蘆洲,2023-04-06,9857
2834,臺企銀,66,2,64,元大-蘆洲,2023-04-06,9857
1528,恩德,60,0,60,元大-蘆洲,2023-04-06,9857
00637L,元大滬深300正2,60,0,60,元大-蘆洲,2023-04-06,9857
5309,系統電,83,30,53,元大-蘆洲,2023-04-06,9857
00674R,期元大S＆P黃金反1,50,0,50,元大-蘆洲,2023-04-06,9857
2515,中工,55,8,47,元大-蘆洲,2023-04-06,9857
00893,國泰智能電動車,44,0,44,元大-蘆洲,2023-04-06,9857
00679B,元大美債20年,60,18,42,元大-蘆洲,2023-04-06,9857
1605,華新,111,72,39,元大-蘆洲,2023-04-06,9857
2436,偉詮電,215,176,39,元大-蘆洲,2023-04-06,9857
2609,陽明,53,15,38,元大-蘆洲,2023-04-06,9857
3714,富采,39,1,38,元大-蘆洲,2023-04-06,9857
2368,金像電,49,11,38,元大-蘆洲,2023-04-06,9857
00638R,元大滬深300反1,32,0,32,元大-蘆洲,2023-04-06,9857
00905,FT臺灣Smart,30,0,30,元大-蘆洲,2023-04-06,9857
6548,長科*,40,12,28,元大-蘆洲,2023-04-06,9857
8069,元太,40,13,27,元大-蘆洲,2023-04-06,9857
3046,建��,29,3,26,元大-蘆洲,2023-04-06,9857
3056,富華新,45,20,25,元大-蘆洲,2023-04-06,9857
4746,台耀,51,26,25,元大-蘆洲,2023-04-06,9857
2867,三商壽,24,0,24,元大-蘆洲,2023-04-06,9857
4979,華星光,36,13,23,元大-蘆洲,2023-04-06,9857
6770,力積電,22,0,22,元大-蘆洲,2023-04-06,9857
6244,茂迪,54,33,21,元大-蘆洲,2023-04-06,9857
3545,敦泰,23,2,21,元大-蘆洲,2023-04-06,9857
8213,志超,22,1,21,元大-蘆洲,2023-04-06,9857
4951,精拓科,20,1,19,元大-蘆洲,2023-04-06,9857
2881,富邦金,22,4,18,元大-蘆洲,2023-04-06,9857
00712,復華富時不動產,18,0,18,元大-蘆洲,2023-04-06,9857
4967,十銓,46,28,18,元大-蘆洲,2023-04-06,9857
2317,鴻海,22,4,18,元大-蘆洲,2023-04-06,9857
5483,中美晶,18,1,17,元大-蘆洲,2023-04-06,9857
2618,長榮航,19,2,17,元大-蘆洲,2023-04-06,9857
3088,艾訊,17,0,17,元大-蘆洲,2023-04-06,9857
3499,環天科,17,1,16,元大-蘆洲,2023-04-06,9857
2603,長榮,15,0,15,元大-蘆洲,2023-04-06,9857
8936,國統,16,1,15,元大-蘆洲,2023-04-06,9857
2883B,凱基金乙特,15,0,15,元大-蘆洲,2023-04-06,9857
2027,大成鋼,14,0,14,元大-蘆洲,2023-04-06,9857
2017,官田鋼,19,5,14,元大-蘆洲,2023-04-06,9857
3265,台星科,14,0,14,元大-蘆洲,2023-04-06,9857
3441,聯一光,14,0,14,元大-蘆洲,2023-04-06,9857
6576,逸達,15,1,14,元大-蘆洲,2023-04-06,9857
6443,元晶,25,12,13,元大-蘆洲,2023-04-06,9857
1584,精剛,73,3,70,元大-蘆洲,2023-04-07,9857
2495,普安,80,17,63,元大-蘆洲,2023-04-07,9857
00712,復華富時不動產,64,3,61,元大-蘆洲,2023-04-07,9857
2302,麗正,60,0,60,元大-蘆洲,2023-04-07,9857
4968,立積,97,40,57,元大-蘆洲,2023-04-07,9857
2867,三商壽,55,0,55,元大-蘆洲,2023-04-07,9857
6185,幃翔,50,2,48,元大-蘆洲,2023-04-07,9857
3576,聯合再生,50,4,46,元大-蘆洲,2023-04-07,9857
2402,毅嘉,51,7,44,元大-蘆洲,2023-04-07,9857
00679B,元大美債20年,71,29,42,元大-蘆洲,2023-04-07,9857
3231,緯創,70,30,40,元大-蘆洲,2023-04-07,9857
00665L,富邦�琤肭磪囓�2,35,2,33,元大-蘆洲,2023-04-07,9857
4906,正文,35,2,33,元大-蘆洲,2023-04-07,9857
2231,為升,29,0,29,元大-蘆洲,2023-04-07,9857
3035,智原,54,25,29,元大-蘆洲,2023-04-07,9857
2208,台船,26,1,25,元大-蘆洲,2023-04-07,9857
3037,欣興,30,6,24,元大-蘆洲,2023-04-07,9857
2605,新興,24,1,23,元大-蘆洲,2023-04-07,9857
3711,日月光投控,22,0,22,元大-蘆洲,2023-04-07,9857
6753,龍德造船,22,1,21,元大-蘆洲,2023-04-07,9857
4763,材料-KY,21,0,21,元大-蘆洲,2023-04-07,9857
8069,元太,31,10,21,元大-蘆洲,2023-04-07,9857
1906,寶隆,20,0,20,元大-蘆洲,2023-04-07,9857
5465,富驊,19,0,19,元大-蘆洲,2023-04-07,9857
6244,茂迪,41,22,19,元大-蘆洲,2023-04-07,9857
1101,台泥,18,0,18,元大-蘆洲,2023-04-07,9857
5880,合庫金,20,2,18,元大-蘆洲,2023-04-07,9857
2834,臺企銀,26,9,17,元大-蘆洲,2023-04-07,9857
1529,樂事綠能,22,5,17,元大-蘆洲,2023-04-07,9857
6129,普誠,20,5,15,元大-蘆洲,2023-04-07,9857
2482,連宇,31,16,15,元大-蘆洲,2023-04-07,9857
8271,宇瞻,18,3,15,元大-蘆洲,2023-04-07,9857
3046,建��,25,10,15,元大-蘆洲,2023-04-07,9857
00713,元大台灣高息低波,15,1,14,元大-蘆洲,2023-04-07,9857
00830,國泰費城半導體,14,0,14,元大-蘆洲,2023-04-07,9857
4903,聯光通,14,0,14,元大-蘆洲,2023-04-07,9857
4526,東台,14,0,14,元大-蘆洲,2023-04-07,9857
8213,志超,14,1,13,元大-蘆洲,2023-04-07,9857
2409,友達,15,2,13,元大-蘆洲,2023-04-07,9857
6235,華孚,101,88,13,元大-蘆洲,2023-04-07,9857
2891,中信金,24,11,13,元大-蘆洲,2023-04-07,9857
5009,榮剛,13,1,12,元大-蘆洲,2023-04-07,9857
6770,力積電,12,0,12,元大-蘆洲,2023-04-07,9857
2884,玉山金,13,1,12,元大-蘆洲,2023-04-07,9857
8383,千附,14,3,11,元大-蘆洲,2023-04-07,9857
3027,盛達,14,4,10,元大-蘆洲,2023-04-07,9857
6278,台表科,10,0,10,元大-蘆洲,2023-04-07,9857
6265,方土昶,10,0,10,元大-蘆洲,2023-04-07,9857
1218,泰山,11,1,10,元大-蘆洲,2023-04-07,9857
9945,潤泰新,13,3,10,元大-蘆洲,2023-04-07,9857
3520,華盈,116,9,107,元大-蘆洲,2023-04-10,9857
3576,聯合再生,102,0,102,元大-蘆洲,2023-04-10,9857
00637L,元大滬深300正2,52,0,52,元大-蘆洲,2023-04-10,9857
2881,富邦金,42,1,41,元大-蘆洲,2023-04-10,9857
6806,森崴能源,45,5,40,元大-蘆洲,2023-04-10,9857
2408,南亞科,41,2,39,元大-蘆洲,2023-04-10,9857
3058,立德,37,0,37,元大-蘆洲,2023-04-10,9857
3037,欣興,43,7,36,元大-蘆洲,2023-04-10,9857
00679B,元大美債20年,32,4,28,元大-蘆洲,2023-04-10,9857
6547,高端疫苗,27,0,27,元大-蘆洲,2023-04-10,9857
00753L,中信中國50正2,27,0,27,元大-蘆洲,2023-04-10,9857
00673R,期元大S＆P原油反1,27,0,27,元大-蘆洲,2023-04-10,9857
1605,華新,62,36,26,元大-蘆洲,2023-04-10,9857
00712,復華富時不動產,36,10,26,元大-蘆洲,2023-04-10,9857
3025,星通,34,10,24,元大-蘆洲,2023-04-10,9857
6288,聯嘉,34,10,24,元大-蘆洲,2023-04-10,9857
00632R,元大台灣50反1,24,0,24,元大-蘆洲,2023-04-10,9857
5452,佶優,23,0,23,元大-蘆洲,2023-04-10,9857
3479,安勤,28,5,23,元大-蘆洲,2023-04-10,9857
2421,建準,27,5,22,元大-蘆洲,2023-04-10,9857
5905,南仁湖,22,0,22,元大-蘆洲,2023-04-10,9857
00720B,元大投資級公司債,21,0,21,元大-蘆洲,2023-04-10,9857
3162,精確,21,0,21,元大-蘆洲,2023-04-10,9857
00830,國泰費城半導體,22,1,21,元大-蘆洲,2023-04-10,9857
0056,元大高股息,43,22,21,元大-蘆洲,2023-04-10,9857
00772B,中信高評級公司債,19,0,19,元大-蘆洲,2023-04-10,9857
6155,鈞寶,22,5,17,元大-蘆洲,2023-04-10,9857
2605,新興,19,3,16,元大-蘆洲,2023-04-10,9857
3264,欣銓,16,0,16,元大-蘆洲,2023-04-10,9857
3432,台端,18,3,15,元大-蘆洲,2023-04-10,9857
1319,東陽,15,1,14,元大-蘆洲,2023-04-10,9857
3714,富采,14,0,14,元大-蘆洲,2023-04-10,9857
2230,泰茂,13,0,13,元大-蘆洲,2023-04-10,9857
5309,系統電,22,9,13,元大-蘆洲,2023-04-10,9857
8358,金居,15,2,13,元大-蘆洲,2023-04-10,9857
2884,玉山金,17,4,13,元大-蘆洲,2023-04-10,9857
3017,奇鋐,16,3,13,元大-蘆洲,2023-04-10,9857
3034,聯詠,16,4,12,元大-蘆洲,2023-04-10,9857
6163,華電網,17,5,12,元大-蘆洲,2023-04-10,9857
1717,長興,12,0,12,元大-蘆洲,2023-04-10,9857
6005,群益證,12,0,12,元大-蘆洲,2023-04-10,9857
3312,弘憶股,11,0,11,元大-蘆洲,2023-04-10,9857
4968,立積,31,21,10,元大-蘆洲,2023-04-10,9857
6156,松上,10,0,10,元大-蘆洲,2023-04-10,9857
6142,友勁,10,0,10,元大-蘆洲,2023-04-10,9857
4746,台耀,48,38,10,元大-蘆洲,2023-04-10,9857
3682,亞太電,20,10,10,元大-蘆洲,2023-04-10,9857
6129,普誠,10,0,10,元大-蘆洲,2023-04-10,9857
6195,詩肯,10,0,10,元大-蘆洲,2023-04-10,9857
9962,有益,12,2,10,元大-蘆洲,2023-04-10,9857
2515,中工,212,45,167,元大-蘆洲,2023-04-11,9857
2324,仁寶,138,0,138,元大-蘆洲,2023-04-11,9857
5328,華容,104,14,90,元大-蘆洲,2023-04-11,9857
6770,力積電,80,11,69,元大-蘆洲,2023-04-11,9857
6209,今國光,106,44,62,元大-蘆洲,2023-04-11,9857
5531,鄉林,60,1,59,元大-蘆洲,2023-04-11,9857
00632R,元大台灣50反1,71,18,53,元大-蘆洲,2023-04-11,9857
3576,聯合再生,53,0,53,元大-蘆洲,2023-04-11,9857
2883,凱基金,81,33,48,元大-蘆洲,2023-04-11,9857
3545,敦泰,73,27,46,元大-蘆洲,2023-04-11,9857
00712,復華富時不動產,51,8,43,元大-蘆洲,2023-04-11,9857
6245,立端,43,3,40,元大-蘆洲,2023-04-11,9857
00900,富邦特選高股息30,44,10,34,元大-蘆洲,2023-04-11,9857
2618,長榮航,42,9,33,元大-蘆洲,2023-04-11,9857
3706,神達,46,14,32,元大-蘆洲,2023-04-11,9857
2303,聯電,43,11,32,元大-蘆洲,2023-04-11,9857
00679B,元大美債20年,31,0,31,元大-蘆洲,2023-04-11,9857
2331,精英,41,10,31,元大-蘆洲,2023-04-11,9857
8050,廣積,36,6,30,元大-蘆洲,2023-04-11,9857
6129,普誠,34,4,30,元大-蘆洲,2023-04-11,9857
4763,材料-KY,31,2,29,元大-蘆洲,2023-04-11,9857
1504,東元,74,47,27,元大-蘆洲,2023-04-11,9857
3046,建��,45,18,27,元大-蘆洲,2023-04-11,9857
3088,艾訊,27,1,26,元大-蘆洲,2023-04-11,9857
6244,茂迪,27,2,25,元大-蘆洲,2023-04-11,9857
2634,漢翔,32,8,24,元大-蘆洲,2023-04-11,9857
1514,亞力,59,35,24,元大-蘆洲,2023-04-11,9857
6116,彩晶,37,14,23,元大-蘆洲,2023-04-11,9857
00878,國泰永續高股息,44,21,23,元大-蘆洲,2023-04-11,9857
2457,飛宏,66,44,22,元大-蘆洲,2023-04-11,9857
1802,台玻,22,0,22,元大-蘆洲,2023-04-11,9857
2891,中信金,40,20,20,元大-蘆洲,2023-04-11,9857
1218,泰山,21,1,20,元大-蘆洲,2023-04-11,9857
6163,華電網,20,0,20,元大-蘆洲,2023-04-11,9857
2444,兆勁,20,0,20,元大-蘆洲,2023-04-11,9857
6649,台生材,20,0,20,元大-蘆洲,2023-04-11,9857
3499,環天科,19,0,19,元大-蘆洲,2023-04-11,9857
2881,富邦金,20,1,19,元大-蘆洲,2023-04-11,9857
3231,緯創,94,76,18,元大-蘆洲,2023-04-11,9857
00772B,中信高評級公司債,18,0,18,元大-蘆洲,2023-04-11,9857
2609,陽明,24,6,18,元大-蘆洲,2023-04-11,9857
6282,康舒,24,6,18,元大-蘆洲,2023-04-11,9857
00680L,元大美債20正2,17,0,17,元大-蘆洲,2023-04-11,9857
00673R,期元大S＆P原油反1,17,0,17,元大-蘆洲,2023-04-11,9857
3013,晟銘電,18,2,16,元大-蘆洲,2023-04-11,9857
2809,京城銀,16,0,16,元大-蘆洲,2023-04-11,9857
2834,臺企銀,95,79,16,元大-蘆洲,2023-04-11,9857
2332,友訊,20,5,15,元大-蘆洲,2023-04-11,9857
6570,維田,15,0,15,元大-蘆洲,2023-04-11,9857
6156,松上,15,1,14,元大-蘆洲,2023-04-11,9857
1609,大亞,294,118,176,元大-蘆洲,2023-04-12,9857
4968,立積,96,23,73,元大-蘆洲,2023-04-12,9857
00679B,元大美債20年,65,2,63,元大-蘆洲,2023-04-12,9857
00712,復華富時不動產,62,0,62,元大-蘆洲,2023-04-12,9857
00900,富邦特選高股息30,85,25,60,元大-蘆洲,2023-04-12,9857
2889,國票金,57,10,47,元大-蘆洲,2023-04-12,9857
5439,高技,42,0,42,元大-蘆洲,2023-04-12,9857
3056,富華新,53,12,41,元大-蘆洲,2023-04-12,9857
8936,國統,48,7,41,元大-蘆洲,2023-04-12,9857
6167,久正,38,0,38,元大-蘆洲,2023-04-12,9857
2886,兆豐金,35,0,35,元大-蘆洲,2023-04-12,9857
00673R,期元大S＆P原油反1,33,0,33,元大-蘆洲,2023-04-12,9857
0056,元大高股息,76,44,32,元大-蘆洲,2023-04-12,9857
2367,燿華,68,37,31,元大-蘆洲,2023-04-12,9857
6279,胡連,31,3,28,元大-蘆洲,2023-04-12,9857
2460,建通,48,21,27,元大-蘆洲,2023-04-12,9857
2834,臺企銀,34,7,27,元大-蘆洲,2023-04-12,9857
2368,金像電,38,12,26,元大-蘆洲,2023-04-12,9857
3231,緯創,76,51,25,元大-蘆洲,2023-04-12,9857
3013,晟銘電,39,15,24,元大-蘆洲,2023-04-12,9857
8038,長園科,27,3,24,元大-蘆洲,2023-04-12,9857
2406,國碩,22,0,22,元大-蘆洲,2023-04-12,9857
3714,富采,21,0,21,元大-蘆洲,2023-04-12,9857
2427,三商電,25,4,21,元大-蘆洲,2023-04-12,9857
4130,健亞,21,0,21,元大-蘆洲,2023-04-12,9857
2344,華邦電,54,33,21,元大-蘆洲,2023-04-12,9857
00902,中信電池及儲能,25,5,20,元大-蘆洲,2023-04-12,9857
00632R,元大台灣50反1,25,5,20,元大-蘆洲,2023-04-12,9857
2405,輔信,20,0,20,元大-蘆洲,2023-04-12,9857
6515,穎崴,20,0,20,元大-蘆洲,2023-04-12,9857
1906,寶隆,20,0,20,元大-蘆洲,2023-04-12,9857
2516,新建,20,0,20,元大-蘆洲,2023-04-12,9857
4541,晟田,20,0,20,元大-蘆洲,2023-04-12,9857
6005,群益證,19,0,19,元大-蘆洲,2023-04-12,9857
1513,中興電,121,103,18,元大-蘆洲,2023-04-12,9857
2481,強茂,19,1,18,元大-蘆洲,2023-04-12,9857
6248,沛波,20,2,18,元大-蘆洲,2023-04-12,9857
1612,宏泰,17,0,17,元大-蘆洲,2023-04-12,9857
3094,聯傑,22,6,16,元大-蘆洲,2023-04-12,9857
2609,陽明,91,75,16,元大-蘆洲,2023-04-12,9857
00671R,富邦NASDAQ反1,16,0,16,元大-蘆洲,2023-04-12,9857
6015,宏遠證,15,0,15,元大-蘆洲,2023-04-12,9857
1514,亞力,66,52,14,元大-蘆洲,2023-04-12,9857
4155,訊映,19,5,14,元大-蘆洲,2023-04-12,9857
6245,立端,27,13,14,元大-蘆洲,2023-04-12,9857
2542,興富發,16,2,14,元大-蘆洲,2023-04-12,9857
6148,驊宏資,18,4,14,元大-蘆洲,2023-04-12,9857
2382,廣達,15,1,14,元大-蘆洲,2023-04-12,9857
2476,鉅祥,17,4,13,元大-蘆洲,2023-04-12,9857
6223,旺矽,26,13,13,元大-蘆洲,2023-04-12,9857
00878,國泰永續高股息,308,61,247,元大-蘆洲,2023-04-13,9857
3576,聯合再生,266,61,205,元大-蘆洲,2023-04-13,9857
1514,亞力,234,73,161,元大-蘆洲,2023-04-13,9857
3694,海華,114,3,111,元大-蘆洲,2023-04-13,9857
00900,富邦特選高股息30,103,7,96,元大-蘆洲,2023-04-13,9857
00712,復華富時不動產,75,0,75,元大-蘆洲,2023-04-13,9857
2329,華泰,74,4,70,元大-蘆洲,2023-04-13,9857
3711,日月光投控,65,1,64,元大-蘆洲,2023-04-13,9857
1314,中石化,93,35,58,元大-蘆洲,2023-04-13,9857
2885,元大金,50,0,50,元大-蘆洲,2023-04-13,9857
4916,事欣科,54,5,49,元大-蘆洲,2023-04-13,9857
2206,三陽工業,82,35,47,元大-蘆洲,2023-04-13,9857
00673R,期元大S＆P原油反1,47,0,47,元大-蘆洲,2023-04-13,9857
6443,元晶,53,9,44,元大-蘆洲,2023-04-13,9857
00922,國泰台灣領袖50,43,0,43,元大-蘆洲,2023-04-13,9857
1503,士電,93,50,43,元大-蘆洲,2023-04-13,9857
3231,緯創,87,46,41,元大-蘆洲,2023-04-13,9857
1609,大亞,120,80,40,元大-蘆洲,2023-04-13,9857
00671R,富邦NASDAQ反1,41,3,38,元大-蘆洲,2023-04-13,9857
2023,燁輝,40,2,38,元大-蘆洲,2023-04-13,9857
8936,國統,54,16,38,元大-蘆洲,2023-04-13,9857
00680L,元大美債20正2,36,0,36,元大-蘆洲,2023-04-13,9857
1504,東元,84,49,35,元大-蘆洲,2023-04-13,9857
2897,王道銀行,34,0,34,元大-蘆洲,2023-04-13,9857
5009,榮剛,77,45,32,元大-蘆洲,2023-04-13,9857
4906,正文,31,0,31,元大-蘆洲,2023-04-13,9857
5425,台半,32,1,31,元大-蘆洲,2023-04-13,9857
5531,鄉林,40,10,30,元大-蘆洲,2023-04-13,9857
3013,晟銘電,29,2,27,元大-蘆洲,2023-04-13,9857
1101,台泥,31,5,26,元大-蘆洲,2023-04-13,9857
3006,晶豪科,66,40,26,元大-蘆洲,2023-04-13,9857
1809,中釉,25,0,25,元大-蘆洲,2023-04-13,9857
0050,元大台灣50,26,1,25,元大-蘆洲,2023-04-13,9857
2382,廣達,24,0,24,元大-蘆洲,2023-04-13,9857
3056,富華新,25,1,24,元大-蘆洲,2023-04-13,9857
8927,北基,23,0,23,元大-蘆洲,2023-04-13,9857
2330,台積電,22,0,22,元大-蘆洲,2023-04-13,9857
2031,新光鋼,21,0,21,元大-蘆洲,2023-04-13,9857
1718,中纖,21,0,21,元大-蘆洲,2023-04-13,9857
00902,中信電池及儲能,22,1,21,元大-蘆洲,2023-04-13,9857
00891,中信關鍵半導體,21,0,21,元大-蘆洲,2023-04-13,9857
2349,錸德,20,0,20,元大-蘆洲,2023-04-13,9857
2367,燿華,31,11,20,元大-蘆洲,2023-04-13,9857
1513,中興電,109,90,19,元大-蘆洲,2023-04-13,9857
3673,TPK-KY,21,2,19,元大-蘆洲,2023-04-13,9857
6209,今國光,49,31,18,元大-蘆洲,2023-04-13,9857
2371,大同,19,1,18,元大-蘆洲,2023-04-13,9857
00679B,元大美債20年,17,0,17,元大-蘆洲,2023-04-13,9857
2834,臺企銀,28,12,16,元大-蘆洲,2023-04-13,9857
2404,漢唐,15,0,15,元大-蘆洲,2023-04-13,9857
2867,三商壽,224,52,172,元大-蘆洲,2023-04-14,9857
00679B,元大美債20年,122,3,119,元大-蘆洲,2023-04-14,9857
2471,資通,103,4,99,元大-蘆洲,2023-04-14,9857
2208,台船,251,168,83,元大-蘆洲,2023-04-14,9857
00772B,中信高評級公司債,82,0,82,元大-蘆洲,2023-04-14,9857
2634,漢翔,223,171,52,元大-蘆洲,2023-04-14,9857
2380,虹光,50,0,50,元大-蘆洲,2023-04-14,9857
00712,復華富時不動產,50,0,50,元大-蘆洲,2023-04-14,9857
00900,富邦特選高股息30,50,4,46,元大-蘆洲,2023-04-14,9857
8171,天宇,44,0,44,元大-蘆洲,2023-04-14,9857
2402,毅嘉,59,21,38,元大-蘆洲,2023-04-14,9857
2002,中鋼,39,3,36,元大-蘆洲,2023-04-14,9857
2017,官田鋼,48,14,34,元大-蘆洲,2023-04-14,9857
2886,兆豐金,31,0,31,元大-蘆洲,2023-04-14,9857
2851,中再保,31,0,31,元大-蘆洲,2023-04-14,9857
6456,GIS-KY,34,3,31,元大-蘆洲,2023-04-14,9857
4916,事欣科,37,7,30,元大-蘆洲,2023-04-14,9857
00664R,國泰臺灣加權反1,30,0,30,元大-蘆洲,2023-04-14,9857
6197,佳必琪,32,5,27,元大-蘆洲,2023-04-14,9857
2332,友訊,28,1,27,元大-蘆洲,2023-04-14,9857
2329,華泰,27,1,26,元大-蘆洲,2023-04-14,9857
1905,華紙,29,3,26,元大-蘆洲,2023-04-14,9857
2344,華邦電,62,37,25,元大-蘆洲,2023-04-14,9857
2355,敬鵬,24,0,24,元大-蘆洲,2023-04-14,9857
2617,台航,25,1,24,元大-蘆洲,2023-04-14,9857
2061,風青,23,0,23,元大-蘆洲,2023-04-14,9857
00680L,元大美債20正2,23,0,23,元大-蘆洲,2023-04-14,9857
6209,今國光,30,7,23,元大-蘆洲,2023-04-14,9857
1504,東元,110,87,23,元大-蘆洲,2023-04-14,9857
2457,飛宏,85,63,22,元大-蘆洲,2023-04-14,9857
2501,國建,20,0,20,元大-蘆洲,2023-04-14,9857
4906,正文,22,2,20,元大-蘆洲,2023-04-14,9857
4930,燦星網,20,0,20,元大-蘆洲,2023-04-14,9857
00687B,國泰20年美債,20,0,20,元大-蘆洲,2023-04-14,9857
6804,明係,20,0,20,元大-蘆洲,2023-04-14,9857
5475,德宏,20,1,19,元大-蘆洲,2023-04-14,9857
2889,國票金,20,1,19,元大-蘆洲,2023-04-14,9857
6167,久正,30,11,19,元大-蘆洲,2023-04-14,9857
6603,富強鑫,19,0,19,元大-蘆洲,2023-04-14,9857
6285,啟��,25,7,18,元大-蘆洲,2023-04-14,9857
5309,系統電,19,1,18,元大-蘆洲,2023-04-14,9857
3162,精確,17,0,17,元大-蘆洲,2023-04-14,9857
2303,聯電,22,5,17,元大-蘆洲,2023-04-14,9857
1609,大亞,95,78,17,元大-蘆洲,2023-04-14,9857
8222,寶一,63,46,17,元大-蘆洲,2023-04-14,9857
2014,中鴻,24,7,17,元大-蘆洲,2023-04-14,9857
6245,立端,22,5,17,元大-蘆洲,2023-04-14,9857
1584,精剛,80,64,16,元大-蘆洲,2023-04-14,9857
1101,台泥,21,5,16,元大-蘆洲,2023-04-14,9857
1314,中石化,16,0,16,元大-蘆洲,2023-04-14,9857
6116,彩晶,395,12,383,元大-蘆洲,2023-04-17,9857
2634,漢翔,515,314,201,元大-蘆洲,2023-04-17,9857
00632R,元大台灣50反1,224,80,144,元大-蘆洲,2023-04-17,9857
2359,所羅門,144,37,107,元大-蘆洲,2023-04-17,9857
1605,華新,187,89,98,元大-蘆洲,2023-04-17,9857
2457,飛宏,178,90,88,元大-蘆洲,2023-04-17,9857
00712,復華富時不動產,128,42,86,元大-蘆洲,2023-04-17,9857
3046,建��,117,42,75,元大-蘆洲,2023-04-17,9857
2002,中鋼,69,2,67,元大-蘆洲,2023-04-17,9857
6190,萬泰科,79,15,64,元大-蘆洲,2023-04-17,9857
00679B,元大美債20年,66,5,61,元大-蘆洲,2023-04-17,9857
2610,華航,58,6,52,元大-蘆洲,2023-04-17,9857
00648R,元大S＆P500反1,50,0,50,元大-蘆洲,2023-04-17,9857
2109,華豐,50,0,50,元大-蘆洲,2023-04-17,9857
3712,永崴投控,60,11,49,元大-蘆洲,2023-04-17,9857
2312,金寶,68,22,46,元大-蘆洲,2023-04-17,9857
00900,富邦特選高股息30,48,3,45,元大-蘆洲,2023-04-17,9857
4916,事欣科,69,25,44,元大-蘆洲,2023-04-17,9857
1609,大亞,47,8,39,元大-蘆洲,2023-04-17,9857
00885,富邦越南,37,0,37,元大-蘆洲,2023-04-17,9857
1806,冠軍,45,10,35,元大-蘆洲,2023-04-17,9857
3481,群創,115,80,35,元大-蘆洲,2023-04-17,9857
6547,高端疫苗,54,20,34,元大-蘆洲,2023-04-17,9857
2515,中工,77,44,33,元大-蘆洲,2023-04-17,9857
4977,眾達-KY,32,0,32,元大-蘆洲,2023-04-17,9857
3705,永信,30,0,30,元大-蘆洲,2023-04-17,9857
1784,訊聯,30,0,30,元大-蘆洲,2023-04-17,9857
2885,元大金,29,0,29,元大-蘆洲,2023-04-17,9857
2884,玉山金,32,4,28,元大-蘆洲,2023-04-17,9857
6016,康和證,28,0,28,元大-蘆洲,2023-04-17,9857
7402,邑錡,27,0,27,元大-蘆洲,2023-04-17,9857
00720B,元大投資級公司債,25,0,25,元大-蘆洲,2023-04-17,9857
5512,力麒,35,10,25,元大-蘆洲,2023-04-17,9857
9907,統一實,32,9,23,元大-蘆洲,2023-04-17,9857
3491,昇達科,29,7,22,元大-蘆洲,2023-04-17,9857
00680L,元大美債20正2,21,0,21,元大-蘆洲,2023-04-17,9857
5211,蒙恬,23,2,21,元大-蘆洲,2023-04-17,9857
2317,鴻海,26,6,20,元大-蘆洲,2023-04-17,9857
8049,晶采,20,0,20,元大-蘆洲,2023-04-17,9857
5515,建國,20,0,20,元大-蘆洲,2023-04-17,9857
2206,三陽工業,94,75,19,元大-蘆洲,2023-04-17,9857
1809,中釉,27,8,19,元大-蘆洲,2023-04-17,9857
00772B,中信高評級公司債,20,1,19,元大-蘆洲,2023-04-17,9857
2890,永豐金,19,1,18,元大-蘆洲,2023-04-17,9857
8050,廣積,22,4,18,元大-蘆洲,2023-04-17,9857
6235,華孚,159,141,18,元大-蘆洲,2023-04-17,9857
5371,中光電,32,15,17,元大-蘆洲,2023-04-17,9857
1314,中石化,17,0,17,元大-蘆洲,2023-04-17,9857
2851,中再保,17,0,17,元大-蘆洲,2023-04-17,9857
6163,華電網,33,16,17,元大-蘆洲,2023-04-17,9857
00679B,元大美債20年,174,8,166,元大-蘆洲,2023-04-18,9857
2457,飛宏,261,99,162,元大-蘆洲,2023-04-18,9857
2313,華通,150,15,135,元大-蘆洲,2023-04-18,9857
00680L,元大美債20正2,113,0,113,元大-蘆洲,2023-04-18,9857
2208,台船,192,82,110,元大-蘆洲,2023-04-18,9857
2344,華邦電,109,5,104,元大-蘆洲,2023-04-18,9857
3710,連展投控,85,0,85,元大-蘆洲,2023-04-18,9857
2867,三商壽,150,70,80,元大-蘆洲,2023-04-18,9857
1584,精剛,129,63,66,元大-蘆洲,2023-04-18,9857
1444,力麗,103,41,62,元大-蘆洲,2023-04-18,9857
8033,雷虎,148,87,61,元大-蘆洲,2023-04-18,9857
00720B,元大投資級公司債,58,0,58,元大-蘆洲,2023-04-18,9857
3652,精聯,57,0,57,元大-蘆洲,2023-04-18,9857
2515,中工,143,86,57,元大-蘆洲,2023-04-18,9857
00772B,中信高評級公司債,63,10,53,元大-蘆洲,2023-04-18,9857
2329,華泰,67,14,53,元大-蘆洲,2023-04-18,9857
3481,群創,72,20,52,元大-蘆洲,2023-04-18,9857
00878,國泰永續高股息,80,29,51,元大-蘆洲,2023-04-18,9857
1618,合機,52,4,48,元大-蘆洲,2023-04-18,9857
2359,所羅門,91,45,46,元大-蘆洲,2023-04-18,9857
00912,中信臺灣智慧50,43,0,43,元大-蘆洲,2023-04-18,9857
6770,力積電,56,16,40,元大-蘆洲,2023-04-18,9857
00632R,元大台灣50反1,57,19,38,元大-蘆洲,2023-04-18,9857
00751B,元大AAA至A公司債,38,0,38,元大-蘆洲,2023-04-18,9857
00712,復華富時不動產,50,13,37,元大-蘆洲,2023-04-18,9857
1785,光洋科,32,1,31,元大-蘆洲,2023-04-18,9857
3706,神達,30,0,30,元大-蘆洲,2023-04-18,9857
2498,宏達電,55,25,30,元大-蘆洲,2023-04-18,9857
2340,台亞,30,0,30,元大-蘆洲,2023-04-18,9857
1529,樂事綠能,91,63,28,元大-蘆洲,2023-04-18,9857
2880,華南金,28,0,28,元大-蘆洲,2023-04-18,9857
2618,長榮航,36,10,26,元大-蘆洲,2023-04-18,9857
1810,和成,34,8,26,元大-蘆洲,2023-04-18,9857
6152,百一,41,15,26,元大-蘆洲,2023-04-18,9857
4977,眾達-KY,37,11,26,元大-蘆洲,2023-04-18,9857
2002,中鋼,26,1,25,元大-蘆洲,2023-04-18,9857
2882,國泰金,31,6,25,元大-蘆洲,2023-04-18,9857
00922,國泰台灣領袖50,24,0,24,元大-蘆洲,2023-04-18,9857
2891,中信金,25,1,24,元大-蘆洲,2023-04-18,9857
2890,永豐金,23,0,23,元大-蘆洲,2023-04-18,9857
5009,榮剛,29,8,21,元大-蘆洲,2023-04-18,9857
6160,欣技,73,52,21,元大-蘆洲,2023-04-18,9857
9103,美德醫療-DR,24,3,21,元大-蘆洲,2023-04-18,9857
6443,元晶,65,44,21,元大-蘆洲,2023-04-18,9857
1609,大亞,34,14,20,元大-蘆洲,2023-04-18,9857
5608,四維航,20,0,20,元大-蘆洲,2023-04-18,9857
2109,華豐,20,0,20,元大-蘆洲,2023-04-18,9857
00706L,期元大S＆P日圓正2,22,2,20,元大-蘆洲,2023-04-18,9857
1409,新纖,20,0,20,元大-蘆洲,2023-04-18,9857
5309,系統電,30,10,20,元大-蘆洲,2023-04-18,9857
3481,群創,589,144,445,元大-蘆洲,2023-04-19,9857
2313,華通,190,1,189,元大-蘆洲,2023-04-19,9857
6770,力積電,110,9,101,元大-蘆洲,2023-04-19,9857
00712,復華富時不動產,73,0,73,元大-蘆洲,2023-04-19,9857
1810,和成,119,61,58,元大-蘆洲,2023-04-19,9857
3673,TPK-KY,84,26,58,元大-蘆洲,2023-04-19,9857
2610,華航,83,34,49,元大-蘆洲,2023-04-19,9857
00720B,元大投資級公司債,41,0,41,元大-蘆洲,2023-04-19,9857
2457,飛宏,122,85,37,元大-蘆洲,2023-04-19,9857
0056,元大高股息,41,4,37,元大-蘆洲,2023-04-19,9857
1314,中石化,36,3,33,元大-蘆洲,2023-04-19,9857
00679B,元大美債20年,32,0,32,元大-蘆洲,2023-04-19,9857
2328,廣宇,49,20,29,元大-蘆洲,2023-04-19,9857
3576,聯合再生,394,366,28,元大-蘆洲,2023-04-19,9857
8403,盛弘,29,1,28,元大-蘆洲,2023-04-19,9857
2883,凱基金,36,9,27,元大-蘆洲,2023-04-19,9857
2303,聯電,33,6,27,元大-蘆洲,2023-04-19,9857
00772B,中信高評級公司債,26,0,26,元大-蘆洲,2023-04-19,9857
2002,中鋼,30,5,25,元大-蘆洲,2023-04-19,9857
9935,慶豐富,25,0,25,元大-蘆洲,2023-04-19,9857
2208,台船,92,67,25,元大-蘆洲,2023-04-19,9857
3005,神基,42,18,24,元大-蘆洲,2023-04-19,9857
00881,國泰台灣5G+,25,1,24,元大-蘆洲,2023-04-19,9857
00713,元大台灣高息低波,27,3,24,元大-蘆洲,2023-04-19,9857
3591,艾笛森,23,0,23,元大-蘆洲,2023-04-19,9857
4510,高鋒,23,0,23,元大-蘆洲,2023-04-19,9857
6477,安集,67,44,23,元大-蘆洲,2023-04-19,9857
2409,友達,48,26,22,元大-蘆洲,2023-04-19,9857
00885,富邦越南,22,0,22,元大-蘆洲,2023-04-19,9857
8068,全達,22,0,22,元大-蘆洲,2023-04-19,9857
2014,中鴻,23,2,21,元大-蘆洲,2023-04-19,9857
2344,華邦電,29,8,21,元大-蘆洲,2023-04-19,9857
2460,建通,33,13,20,元大-蘆洲,2023-04-19,9857
5439,高技,22,2,20,元大-蘆洲,2023-04-19,9857
8210,勤誠,24,4,20,元大-蘆洲,2023-04-19,9857
00680L,元大美債20正2,19,0,19,元大-蘆洲,2023-04-19,9857
2609,陽明,45,27,18,元大-蘆洲,2023-04-19,9857
00922,國泰台灣領袖50,18,0,18,元大-蘆洲,2023-04-19,9857
3037,欣興,27,9,18,元大-蘆洲,2023-04-19,9857
2645,長榮航太,17,0,17,元大-蘆洲,2023-04-19,9857
1720,生達,19,3,16,元大-蘆洲,2023-04-19,9857
1802,台玻,19,3,16,元大-蘆洲,2023-04-19,9857
6470,宇智,36,20,16,元大-蘆洲,2023-04-19,9857
2834,臺企銀,25,9,16,元大-蘆洲,2023-04-19,9857
2884,玉山金,22,6,16,元大-蘆洲,2023-04-19,9857
3006,晶豪科,18,2,16,元大-蘆洲,2023-04-19,9857
00912,中信臺灣智慧50,15,0,15,元大-蘆洲,2023-04-19,9857
2495,普安,51,36,15,元大-蘆洲,2023-04-19,9857
4961,天鈺,52,38,14,元大-蘆洲,2023-04-19,9857
4164,承業醫,18,4,14,元大-蘆洲,2023-04-19,9857
2002,中鋼,407,4,403,元大-蘆洲,2023-04-20,9857
2014,中鴻,212,50,162,元大-蘆洲,2023-04-20,9857
2888,新光金,111,0,111,元大-蘆洲,2023-04-20,9857
2010,春源,100,0,100,元大-蘆洲,2023-04-20,9857
6218,豪勉,173,79,94,元大-蘆洲,2023-04-20,9857
3078,僑威,111,30,81,元大-蘆洲,2023-04-20,9857
00888,永豐台灣ESG,82,1,81,元大-蘆洲,2023-04-20,9857
00878,國泰永續高股息,101,30,71,元大-蘆洲,2023-04-20,9857
4906,正文,70,1,69,元大-蘆洲,2023-04-20,9857
0056,元大高股息,69,0,69,元大-蘆洲,2023-04-20,9857
00885,富邦越南,65,0,65,元大-蘆洲,2023-04-20,9857
6770,力積電,74,13,61,元大-蘆洲,2023-04-20,9857
6142,友勁,61,1,60,元大-蘆洲,2023-04-20,9857
3576,聯合再生,69,14,55,元大-蘆洲,2023-04-20,9857
6470,宇智,65,10,55,元大-蘆洲,2023-04-20,9857
3466,德晉,61,7,54,元大-蘆洲,2023-04-20,9857
6244,茂迪,94,42,52,元大-蘆洲,2023-04-20,9857
2515,中工,117,67,50,元大-蘆洲,2023-04-20,9857
2748,雲品,54,6,48,元大-蘆洲,2023-04-20,9857
2634,漢翔,73,33,40,元大-蘆洲,2023-04-20,9857
1321,大洋,40,0,40,元大-蘆洲,2023-04-20,9857
1471,首利,71,33,38,元大-蘆洲,2023-04-20,9857
8028,昇陽半導體,40,3,37,元大-蘆洲,2023-04-20,9857
00665L,富邦�琤肭磪囓�2,39,2,37,元大-蘆洲,2023-04-20,9857
6443,元晶,53,18,35,元大-蘆洲,2023-04-20,9857
3522,御嵿,34,0,34,元大-蘆洲,2023-04-20,9857
3058,立德,51,17,34,元大-蘆洲,2023-04-20,9857
2359,所羅門,53,19,34,元大-蘆洲,2023-04-20,9857
2303,聯電,34,2,32,元大-蘆洲,2023-04-20,9857
2867,三商壽,32,0,32,元大-蘆洲,2023-04-20,9857
2618,長榮航,34,4,30,元大-蘆洲,2023-04-20,9857
2481,強茂,32,2,30,元大-蘆洲,2023-04-20,9857
4968,立積,48,18,30,元大-蘆洲,2023-04-20,9857
2610,華航,43,14,29,元大-蘆洲,2023-04-20,9857
4541,晟田,31,3,28,元大-蘆洲,2023-04-20,9857
1618,合機,32,5,27,元大-蘆洲,2023-04-20,9857
00720B,元大投資級公司債,26,0,26,元大-蘆洲,2023-04-20,9857
8111,立��,89,63,26,元大-蘆洲,2023-04-20,9857
3481,群創,65,40,25,元大-蘆洲,2023-04-20,9857
00648R,元大S＆P500反1,25,0,25,元大-蘆洲,2023-04-20,9857
5608,四維航,28,3,25,元大-蘆洲,2023-04-20,9857
00713,元大台灣高息低波,34,9,25,元大-蘆洲,2023-04-20,9857
00902,中信電池及儲能,24,0,24,元大-蘆洲,2023-04-20,9857
8222,寶一,68,44,24,元大-蘆洲,2023-04-20,9857
2313,華通,54,30,24,元大-蘆洲,2023-04-20,9857
4130,健亞,24,0,24,元大-蘆洲,2023-04-20,9857
2324,仁寶,32,9,23,元大-蘆洲,2023-04-20,9857
2884,玉山金,24,2,22,元大-蘆洲,2023-04-20,9857
2367,燿華,22,0,22,元大-蘆洲,2023-04-20,9857
5880,合庫金,22,0,22,元大-蘆洲,2023-04-20,9857
00878,國泰永續高股息,311,45,266,元大-蘆洲,2023-04-21,9857
3576,聯合再生,268,72,196,元大-蘆洲,2023-04-21,9857
00715L,期街口布蘭特正2,114,1,113,元大-蘆洲,2023-04-21,9857
0056,元大高股息,79,7,72,元大-蘆洲,2023-04-21,9857
2313,華通,64,0,64,元大-蘆洲,2023-04-21,9857
3037,欣興,84,27,57,元大-蘆洲,2023-04-21,9857
2887,台新金,56,3,53,元大-蘆洲,2023-04-21,9857
00720B,元大投資級公司債,52,1,51,元大-蘆洲,2023-04-21,9857
00900,富邦特選高股息30,57,9,48,元大-蘆洲,2023-04-21,9857
00902,中信電池及儲能,46,0,46,元大-蘆洲,2023-04-21,9857
1907,永豐餘,93,49,44,元大-蘆洲,2023-04-21,9857
6163,華電網,50,6,44,元大-蘆洲,2023-04-21,9857
00888,永豐台灣ESG,43,0,43,元大-蘆洲,2023-04-21,9857
2888,新光金,42,0,42,元大-蘆洲,2023-04-21,9857
5439,高技,43,1,42,元大-蘆洲,2023-04-21,9857
2883,凱基金,54,14,40,元大-蘆洲,2023-04-21,9857
00669R,國泰美國道瓊反1,40,0,40,元大-蘆洲,2023-04-21,9857
6770,力積電,77,38,39,元大-蘆洲,2023-04-21,9857
2303,聯電,45,7,38,元大-蘆洲,2023-04-21,9857
6443,元晶,40,5,35,元大-蘆洲,2023-04-21,9857
8105,凌巨,35,1,34,元大-蘆洲,2023-04-21,9857
8111,立��,89,55,34,元大-蘆洲,2023-04-21,9857
6244,茂迪,51,18,33,元大-蘆洲,2023-04-21,9857
1524,耿鼎,34,1,33,元大-蘆洲,2023-04-21,9857
8936,國統,30,0,30,元大-蘆洲,2023-04-21,9857
3624,光頡,32,2,30,元大-蘆洲,2023-04-21,9857
6156,松上,30,0,30,元大-蘆洲,2023-04-21,9857
6190,萬泰科,33,3,30,元大-蘆洲,2023-04-21,9857
6142,友勁,30,3,27,元大-蘆洲,2023-04-21,9857
6112,邁達特,34,10,24,元大-蘆洲,2023-04-21,9857
2367,燿華,24,0,24,元大-蘆洲,2023-04-21,9857
00637L,元大滬深300正2,24,0,24,元大-蘆洲,2023-04-21,9857
2208,台船,59,35,24,元大-蘆洲,2023-04-21,9857
1760,寶齡富錦,35,11,24,元大-蘆洲,2023-04-21,9857
2882,國泰金,27,3,24,元大-蘆洲,2023-04-21,9857
3466,德晉,28,5,23,元大-蘆洲,2023-04-21,9857
00912,中信臺灣智慧50,22,0,22,元大-蘆洲,2023-04-21,9857
2867,三商壽,22,0,22,元大-蘆洲,2023-04-21,9857
4129,聯合,37,15,22,元大-蘆洲,2023-04-21,9857
1909,榮成,83,62,21,元大-蘆洲,2023-04-21,9857
6122,擎邦,21,0,21,元大-蘆洲,2023-04-21,9857
00671R,富邦NASDAQ反1,20,0,20,元大-蘆洲,2023-04-21,9857
5410,國眾,20,0,20,元大-蘆洲,2023-04-21,9857
8210,勤誠,22,2,20,元大-蘆洲,2023-04-21,9857
5381,合正,20,0,20,元大-蘆洲,2023-04-21,9857
2886,兆豐金,21,2,19,元大-蘆洲,2023-04-21,9857
00885,富邦越南,19,0,19,元大-蘆洲,2023-04-21,9857
3362,先進光,21,2,19,元大-蘆洲,2023-04-21,9857
4956,光鋐,19,0,19,元大-蘆洲,2023-04-21,9857
2615,萬海,73,55,18,元大-蘆洲,2023-04-21,9857
00671R,富邦NASDAQ反1,440,0,440,元大-蘆洲,2023-04-24,9857
6116,彩晶,400,13,387,元大-蘆洲,2023-04-24,9857
00902,中信電池及儲能,90,0,90,元大-蘆洲,2023-04-24,9857
1503,士電,103,20,83,元大-蘆洲,2023-04-24,9857
2515,中工,75,16,59,元大-蘆洲,2023-04-24,9857
6770,力積電,61,8,53,元大-蘆洲,2023-04-24,9857
00885,富邦越南,51,0,51,元大-蘆洲,2023-04-24,9857
00637L,元大滬深300正2,54,3,51,元大-蘆洲,2023-04-24,9857
2890,永豐金,50,6,44,元大-蘆洲,2023-04-24,9857
2313,華通,60,19,41,元大-蘆洲,2023-04-24,9857
1785,光洋科,40,1,39,元大-蘆洲,2023-04-24,9857
6182,合晶,34,0,34,元大-蘆洲,2023-04-24,9857
00632R,元大台灣50反1,70,37,33,元大-蘆洲,2023-04-24,9857
00679B,元大美債20年,31,0,31,元大-蘆洲,2023-04-24,9857
0056,元大高股息,34,6,28,元大-蘆洲,2023-04-24,9857
2630,亞航,30,2,28,元大-蘆洲,2023-04-24,9857
4979,華星光,38,12,26,元大-蘆洲,2023-04-24,9857
2609,陽明,37,12,25,元大-蘆洲,2023-04-24,9857
2913,農林,51,26,25,元大-蘆洲,2023-04-24,9857
00665L,富邦�琤肭磪囓�2,27,2,25,元大-蘆洲,2023-04-24,9857
6142,友勁,24,0,24,元大-蘆洲,2023-04-24,9857
2303,聯電,33,12,21,元大-蘆洲,2023-04-24,9857
2380,虹光,20,0,20,元大-蘆洲,2023-04-24,9857
00688L,國泰20年美債正2,20,0,20,元大-蘆洲,2023-04-24,9857
9919,康那香,20,0,20,元大-蘆洲,2023-04-24,9857
1714,和桐,20,0,20,元大-蘆洲,2023-04-24,9857
3520,華盈,20,0,20,元大-蘆洲,2023-04-24,9857
00853B,統一美債10年Aa-,18,0,18,元大-蘆洲,2023-04-24,9857
00900,富邦特選高股息30,18,0,18,元大-蘆洲,2023-04-24,9857
3673,TPK-KY,18,0,18,元大-蘆洲,2023-04-24,9857
00712,復華富時不動產,27,9,18,元大-蘆洲,2023-04-24,9857
2455,全新,19,3,16,元大-蘆洲,2023-04-24,9857
3548,兆利,18,2,16,元大-蘆洲,2023-04-24,9857
2027,大成鋼,14,0,14,元大-蘆洲,2023-04-24,9857
8926,台汽電,17,3,14,元大-蘆洲,2023-04-24,9857
3501,維熹,15,1,14,元大-蘆洲,2023-04-24,9857
00687B,國泰20年美債,14,0,14,元大-蘆洲,2023-04-24,9857
1611,中電,24,10,14,元大-蘆洲,2023-04-24,9857
00772B,中信高評級公司債,14,0,14,元大-蘆洲,2023-04-24,9857
6156,松上,14,0,14,元大-蘆洲,2023-04-24,9857
2324,仁寶,18,5,13,元大-蘆洲,2023-04-24,9857
6152,百一,13,0,13,元大-蘆洲,2023-04-24,9857
3504,揚明光,13,1,12,元大-蘆洲,2023-04-24,9857
6122,擎邦,16,4,12,元大-蘆洲,2023-04-24,9857
1215,卜蜂,13,1,12,元大-蘆洲,2023-04-24,9857
1702,南僑,12,0,12,元大-蘆洲,2023-04-24,9857
3191,雲嘉南,12,0,12,元大-蘆洲,2023-04-24,9857
1810,和成,18,6,12,元大-蘆洲,2023-04-24,9857
3035,智原,25,13,12,元大-蘆洲,2023-04-24,9857
4960,誠美材,16,5,11,元大-蘆洲,2023-04-24,9857
00878,國泰永續高股息,247,21,226,元大-蘆洲,2023-04-25,9857
3576,聯合再生,181,4,177,元大-蘆洲,2023-04-25,9857
0056,元大高股息,124,21,103,元大-蘆洲,2023-04-25,9857
2913,農林,131,40,91,元大-蘆洲,2023-04-25,9857
1101,台泥,101,20,81,元大-蘆洲,2023-04-25,9857
1721,三晃,117,37,80,元大-蘆洲,2023-04-25,9857
1609,大亞,105,29,76,元大-蘆洲,2023-04-25,9857
2609,陽明,102,29,73,元大-蘆洲,2023-04-25,9857
00637L,元大滬深300正2,87,16,71,元大-蘆洲,2023-04-25,9857
3231,緯創,116,46,70,元大-蘆洲,2023-04-25,9857
2489,瑞軒,65,0,65,元大-蘆洲,2023-04-25,9857
2352,佳世達,55,0,55,元大-蘆洲,2023-04-25,9857
00753L,中信中國50正2,51,0,51,元大-蘆洲,2023-04-25,9857
2344,華邦電,70,23,47,元大-蘆洲,2023-04-25,9857
2634,漢翔,200,153,47,元大-蘆洲,2023-04-25,9857
2890,永豐金,54,9,45,元大-蘆洲,2023-04-25,9857
4743,合一,52,11,41,元大-蘆洲,2023-04-25,9857
2002,中鋼,41,1,40,元大-蘆洲,2023-04-25,9857
8171,天宇,39,0,39,元大-蘆洲,2023-04-25,9857
0050,元大台灣50,36,0,36,元大-蘆洲,2023-04-25,9857
3191,雲嘉南,35,0,35,元大-蘆洲,2023-04-25,9857
8426,紅木-KY,35,0,35,元大-蘆洲,2023-04-25,9857
4960,誠美材,37,3,34,元大-蘆洲,2023-04-25,9857
2607,榮運,33,0,33,元大-蘆洲,2023-04-25,9857
6190,萬泰科,36,3,33,元大-蘆洲,2023-04-25,9857
5469,瀚宇博,32,2,30,元大-蘆洲,2023-04-25,9857
3704,合勤控,30,2,28,元大-蘆洲,2023-04-25,9857
2243,宏旭-KY,28,0,28,元大-蘆洲,2023-04-25,9857
00881,國泰台灣5G+,27,0,27,元大-蘆洲,2023-04-25,9857
2883,凱基金,46,21,25,元大-蘆洲,2023-04-25,9857
00648R,元大S＆P500反1,25,0,25,元大-蘆洲,2023-04-25,9857
2031,新光鋼,25,0,25,元大-蘆洲,2023-04-25,9857
00891,中信關鍵半導體,39,14,25,元大-蘆洲,2023-04-25,9857
1810,和成,27,3,24,元大-蘆洲,2023-04-25,9857
6182,合晶,23,0,23,元大-蘆洲,2023-04-25,9857
2330,台積電,34,11,23,元大-蘆洲,2023-04-25,9857
2105,正新,23,1,22,元大-蘆洲,2023-04-25,9857
2402,毅嘉,43,22,21,元大-蘆洲,2023-04-25,9857
2542,興富發,21,0,21,元大-蘆洲,2023-04-25,9857
3006,晶豪科,29,8,21,元大-蘆洲,2023-04-25,9857
1909,榮成,24,3,21,元大-蘆洲,2023-04-25,9857
6456,GIS-KY,21,0,21,元大-蘆洲,2023-04-25,9857
2457,飛宏,72,52,20,元大-蘆洲,2023-04-25,9857
4967,十銓,22,2,20,元大-蘆洲,2023-04-25,9857
2367,燿華,22,2,20,元大-蘆洲,2023-04-25,9857
2302,麗正,22,2,20,元大-蘆洲,2023-04-25,9857
6156,松上,20,0,20,元大-蘆洲,2023-04-25,9857
2603,長榮,26,6,20,元大-蘆洲,2023-04-25,9857
6509,聚和,22,3,19,元大-蘆洲,2023-04-25,9857
2206,三陽工業,49,30,19,元大-蘆洲,2023-04-25,9857
00885,富邦越南,312,3,309,元大-蘆洲,2023-04-26,9857
00712,復華富時不動產,63,0,63,元大-蘆洲,2023-04-26,9857
2337,旺宏,69,8,61,元大-蘆洲,2023-04-26,9857
1605,華新,68,11,57,元大-蘆洲,2023-04-26,9857
1471,首利,61,7,54,元大-蘆洲,2023-04-26,9857
8093,保銳,60,6,54,元大-蘆洲,2023-04-26,9857
2890,永豐金,50,1,49,元大-蘆洲,2023-04-26,9857
6770,力積電,54,11,43,元大-蘆洲,2023-04-26,9857
2610,華航,54,13,41,元大-蘆洲,2023-04-26,9857
6182,合晶,41,1,40,元大-蘆洲,2023-04-26,9857
2515,中工,71,31,40,元大-蘆洲,2023-04-26,9857
00671R,富邦NASDAQ反1,40,0,40,元大-蘆洲,2023-04-26,9857
2609,陽明,78,40,38,元大-蘆洲,2023-04-26,9857
2887,台新金,40,5,35,元大-蘆洲,2023-04-26,9857
2603,長榮,36,3,33,元大-蘆洲,2023-04-26,9857
4919,新唐,39,8,31,元大-蘆洲,2023-04-26,9857
3035,智原,49,19,30,元大-蘆洲,2023-04-26,9857
2353,宏��,35,5,30,元大-蘆洲,2023-04-26,9857
1101,台泥,47,18,29,元大-蘆洲,2023-04-26,9857
2344,華邦電,37,10,27,元大-蘆洲,2023-04-26,9857
2382,廣達,30,3,27,元大-蘆洲,2023-04-26,9857
2002,中鋼,28,2,26,元大-蘆洲,2023-04-26,9857
0056,元大高股息,32,8,24,元大-蘆洲,2023-04-26,9857
5425,台半,22,1,21,元大-蘆洲,2023-04-26,9857
2484,希華,21,0,21,元大-蘆洲,2023-04-26,9857
2243,宏旭-KY,20,0,20,元大-蘆洲,2023-04-26,9857
2883B,凱基金乙特,20,0,20,元大-蘆洲,2023-04-26,9857
00676R,富邦臺灣加權反1,20,0,20,元大-蘆洲,2023-04-26,9857
00891,中信關鍵半導體,25,6,19,元大-蘆洲,2023-04-26,9857
2368,金像電,26,7,19,元大-蘆洲,2023-04-26,9857
1905,華紙,93,74,19,元大-蘆洲,2023-04-26,9857
1904,正隆,35,16,19,元大-蘆洲,2023-04-26,9857
00881,國泰台灣5G+,19,1,18,元大-蘆洲,2023-04-26,9857
2208,台船,40,22,18,元大-蘆洲,2023-04-26,9857
00715L,期街口布蘭特正2,18,0,18,元大-蘆洲,2023-04-26,9857
5351,鈺創,18,0,18,元大-蘆洲,2023-04-26,9857
3264,欣銓,17,0,17,元大-蘆洲,2023-04-26,9857
2867,三商壽,26,9,17,元大-蘆洲,2023-04-26,9857
5608,四維航,17,0,17,元大-蘆洲,2023-04-26,9857
2324,仁寶,17,0,17,元大-蘆洲,2023-04-26,9857
2727,王品,30,13,17,元大-蘆洲,2023-04-26,9857
2330,台積電,23,6,17,元大-蘆洲,2023-04-26,9857
4743,合一,19,3,16,元大-蘆洲,2023-04-26,9857
6179,亞通,16,0,16,元大-蘆洲,2023-04-26,9857
00680L,元大美債20正2,17,1,16,元大-蘆洲,2023-04-26,9857
2615,萬海,16,1,15,元大-蘆洲,2023-04-26,9857
2882,國泰金,18,3,15,元大-蘆洲,2023-04-26,9857
00713,元大台灣高息低波,16,2,14,元大-蘆洲,2023-04-26,9857
2383,台光電,16,2,14,元大-蘆洲,2023-04-26,9857
1709,和益,24,10,14,元大-蘆洲,2023-04-26,9857
1721,三晃,163,80,83,元大-蘆洲,2023-04-27,9857
00648R,元大S＆P500反1,100,25,75,元大-蘆洲,2023-04-27,9857
1310,台苯,180,108,72,元大-蘆洲,2023-04-27,9857
2303,聯電,93,25,68,元大-蘆洲,2023-04-27,9857
00712,復華富時不動產,67,0,67,元大-蘆洲,2023-04-27,9857
00715L,期街口布蘭特正2,92,25,67,元大-蘆洲,2023-04-27,9857
2515,中工,82,21,61,元大-蘆洲,2023-04-27,9857
1711,永光,146,86,60,元大-蘆洲,2023-04-27,9857
1471,首利,146,102,44,元大-蘆洲,2023-04-27,9857
2331,精英,110,67,43,元大-蘆洲,2023-04-27,9857
4979,華星光,49,7,42,元大-蘆洲,2023-04-27,9857
3191,雲嘉南,39,0,39,元大-蘆洲,2023-04-27,9857
3037,欣興,52,14,38,元大-蘆洲,2023-04-27,9857
2884,玉山金,42,5,37,元大-蘆洲,2023-04-27,9857
2002,中鋼,44,11,33,元大-蘆洲,2023-04-27,9857
00679B,元大美債20年,47,17,30,元大-蘆洲,2023-04-27,9857
2888,新光金,30,4,26,元大-蘆洲,2023-04-27,9857
4967,十銓,26,2,24,元大-蘆洲,2023-04-27,9857
2482,連宇,43,20,23,元大-蘆洲,2023-04-27,9857
3231,緯創,98,76,22,元大-蘆洲,2023-04-27,9857
2359,所羅門,20,0,20,元大-蘆洲,2023-04-27,9857
2601,益航,22,3,19,元大-蘆洲,2023-04-27,9857
2913,農林,132,113,19,元大-蘆洲,2023-04-27,9857
1314,中石化,19,0,19,元大-蘆洲,2023-04-27,9857
00688L,國泰20年美債正2,18,0,18,元大-蘆洲,2023-04-27,9857
6244,茂迪,27,11,16,元大-蘆洲,2023-04-27,9857
2329,華泰,16,1,15,元大-蘆洲,2023-04-27,9857
2881,富邦金,15,0,15,元大-蘆洲,2023-04-27,9857
6443,元晶,18,4,14,元大-蘆洲,2023-04-27,9857
2330,台積電,18,4,14,元大-蘆洲,2023-04-27,9857
2867,三商壽,25,11,14,元大-蘆洲,2023-04-27,9857
4123,晟德,15,1,14,元大-蘆洲,2023-04-27,9857
2425,承啟,15,1,14,元大-蘆洲,2023-04-27,9857
3071,協禧,23,9,14,元大-蘆洲,2023-04-27,9857
6129,普誠,15,1,14,元大-蘆洲,2023-04-27,9857
3032,偉訓,14,1,13,元大-蘆洲,2023-04-27,9857
6116,彩晶,13,0,13,元大-蘆洲,2023-04-27,9857
3673,TPK-KY,13,1,12,元大-蘆洲,2023-04-27,9857
00751B,元大AAA至A公司債,12,0,12,元大-蘆洲,2023-04-27,9857
6282,康舒,24,12,12,元大-蘆洲,2023-04-27,9857
0050,元大台灣50,11,0,11,元大-蘆洲,2023-04-27,9857
2603,長榮,27,16,11,元大-蘆洲,2023-04-27,9857
00680L,元大美債20正2,11,0,11,元大-蘆洲,2023-04-27,9857
00708L,期元大S＆P黃金正2,11,0,11,元大-蘆洲,2023-04-27,9857
1710,東聯,32,21,11,元大-蘆洲,2023-04-27,9857
2883B,凱基金乙特,10,0,10,元大-蘆洲,2023-04-27,9857
006208,富邦台50,10,0,10,元大-蘆洲,2023-04-27,9857
3703,欣陸,10,0,10,元大-蘆洲,2023-04-27,9857
4904,遠傳,10,0,10,元大-蘆洲,2023-04-27,9857
1432,大魯閣,10,0,10,元大-蘆洲,2023-04-27,9857
2880,華南金,160,9,151,元大-蘆洲,2023-04-28,9857
3481,群創,160,16,144,元大-蘆洲,2023-04-28,9857
6140,訊達,128,0,128,元大-蘆洲,2023-04-28,9857
2409,友達,141,21,120,元大-蘆洲,2023-04-28,9857
00891,中信關鍵半導體,102,0,102,元大-蘆洲,2023-04-28,9857
1503,士電,111,11,100,元大-蘆洲,2023-04-28,9857
2402,毅嘉,176,84,92,元大-蘆洲,2023-04-28,9857
1101,台泥,70,5,65,元大-蘆洲,2023-04-28,9857
6288,聯嘉,108,59,49,元大-蘆洲,2023-04-28,9857
2344,華邦電,101,54,47,元大-蘆洲,2023-04-28,9857
00688L,國泰20年美債正2,40,0,40,元大-蘆洲,2023-04-28,9857
2208,台船,74,38,36,元大-蘆洲,2023-04-28,9857
2890,永豐金,35,0,35,元大-蘆洲,2023-04-28,9857
6116,彩晶,33,0,33,元大-蘆洲,2023-04-28,9857
2883,凱基金,34,5,29,元大-蘆洲,2023-04-28,9857
2461,光群雷,28,1,27,元大-蘆洲,2023-04-28,9857
6770,力積電,30,4,26,元大-蘆洲,2023-04-28,9857
3325,旭品,25,0,25,元大-蘆洲,2023-04-28,9857
2405,輔信,25,0,25,元大-蘆洲,2023-04-28,9857
4979,華星光,71,47,24,元大-蘆洲,2023-04-28,9857
3706,神達,23,1,22,元大-蘆洲,2023-04-28,9857
2109,華豐,21,0,21,元大-蘆洲,2023-04-28,9857
2425,承啟,31,10,21,元大-蘆洲,2023-04-28,9857
6235,華孚,24,3,21,元大-蘆洲,2023-04-28,9857
3521,鴻翊,18,0,18,元大-蘆洲,2023-04-28,9857
2382,廣達,20,2,18,元大-蘆洲,2023-04-28,9857
2495,普安,28,11,17,元大-蘆洲,2023-04-28,9857
2408,南亞科,24,7,17,元大-蘆洲,2023-04-28,9857
00772B,中信高評級公司債,16,0,16,元大-蘆洲,2023-04-28,9857
3260,威剛,21,5,16,元大-蘆洲,2023-04-28,9857
3265,台星科,17,1,16,元大-蘆洲,2023-04-28,9857
6443,元晶,19,3,16,元大-蘆洲,2023-04-28,9857
2609,陽明,70,55,15,元大-蘆洲,2023-04-28,9857
2630,亞航,20,6,14,元大-蘆洲,2023-04-28,9857
3189,景碩,25,11,14,元大-蘆洲,2023-04-28,9857
2002,中鋼,15,1,14,元大-蘆洲,2023-04-28,9857
5469,瀚宇博,13,0,13,元大-蘆洲,2023-04-28,9857
6266,泰詠,15,2,13,元大-蘆洲,2023-04-28,9857
00715L,期街口布蘭特正2,13,1,12,元大-蘆洲,2023-04-28,9857
1342,八貫,13,1,12,元大-蘆洲,2023-04-28,9857
1721,三晃,18,6,12,元大-蘆洲,2023-04-28,9857
2913,農林,49,38,11,元大-蘆洲,2023-04-28,9857
3071,協禧,16,5,11,元大-蘆洲,2023-04-28,9857
3035,智原,18,7,11,元大-蘆洲,2023-04-28,9857
6156,松上,10,0,10,元大-蘆洲,2023-04-28,9857
3290,東浦,10,0,10,元大-蘆洲,2023-04-28,9857
3324,雙鴻,17,7,10,元大-蘆洲,2023-04-28,9857
4102,永日,10,0,10,元大-蘆洲,2023-04-28,9857
2030,彰源,10,0,10,元大-蘆洲,2023-04-28,9857
2313,華通,18,8,10,元大-蘆洲,2023-04-28,9857
8403,盛弘,132,15,117,元大-蘆洲,2023-05-02,9857
2603,長榮,121,22,99,元大-蘆洲,2023-05-02,9857
2880,華南金,92,2,90,元大-蘆洲,2023-05-02,9857
8171,天宇,73,0,73,元大-蘆洲,2023-05-02,9857
4906,正文,70,0,70,元大-蘆洲,2023-05-02,9857
2402,毅嘉,80,15,65,元大-蘆洲,2023-05-02,9857
00688L,國泰20年美債正2,54,0,54,元大-蘆洲,2023-05-02,9857
2913,農林,134,83,51,元大-蘆洲,2023-05-02,9857
00679B,元大美債20年,51,1,50,元大-蘆洲,2023-05-02,9857
2530,華建,47,1,46,元大-蘆洲,2023-05-02,9857
1314,中石化,52,7,45,元大-蘆洲,2023-05-02,9857
2208,台船,49,6,43,元大-蘆洲,2023-05-02,9857
3037,欣興,73,32,41,元大-蘆洲,2023-05-02,9857
8210,勤誠,40,0,40,元大-蘆洲,2023-05-02,9857
6288,聯嘉,38,4,34,元大-蘆洲,2023-05-02,9857
2888,新光金,40,7,33,元大-蘆洲,2023-05-02,9857
4979,華星光,43,10,33,元大-蘆洲,2023-05-02,9857
2409,友達,48,16,32,元大-蘆洲,2023-05-02,9857
2897,王道銀行,36,4,32,元大-蘆洲,2023-05-02,9857
1528,恩德,52,23,29,元大-蘆洲,2023-05-02,9857
00633L,富邦上証正2,26,0,26,元大-蘆洲,2023-05-02,9857
00720B,元大投資級公司債,26,0,26,元大-蘆洲,2023-05-02,9857
6234,高僑,42,17,25,元大-蘆洲,2023-05-02,9857
1584,精剛,22,0,22,元大-蘆洲,2023-05-02,9857
00772B,中信高評級公司債,22,0,22,元大-蘆洲,2023-05-02,9857
3033,威健,52,30,22,元大-蘆洲,2023-05-02,9857
3025,星通,25,4,21,元大-蘆洲,2023-05-02,9857
2495,普安,56,35,21,元大-蘆洲,2023-05-02,9857
4566,時碩工業,24,3,21,元大-蘆洲,2023-05-02,9857
1471,首利,21,0,21,元大-蘆洲,2023-05-02,9857
00715L,期街口布蘭特正2,20,0,20,元大-蘆洲,2023-05-02,9857
4919,新唐,22,2,20,元大-蘆洲,2023-05-02,9857
3576,聯合再生,20,0,20,元大-蘆洲,2023-05-02,9857
00680L,元大美債20正2,19,0,19,元大-蘆洲,2023-05-02,9857
3704,合勤控,18,0,18,元大-蘆洲,2023-05-02,9857
00706L,期元大S＆P日圓正2,17,0,17,元大-蘆洲,2023-05-02,9857
2884,玉山金,16,0,16,元大-蘆洲,2023-05-02,9857
00725B,國泰投資級公司債,16,0,16,元大-蘆洲,2023-05-02,9857
2881,富邦金,16,0,16,元大-蘆洲,2023-05-02,9857
2739,寒舍,16,0,16,元大-蘆洲,2023-05-02,9857
1711,永光,25,9,16,元大-蘆洲,2023-05-02,9857
2354,鴻準,24,9,15,元大-蘆洲,2023-05-02,9857
4541,晟田,29,14,15,元大-蘆洲,2023-05-02,9857
5009,榮剛,18,3,15,元大-蘆洲,2023-05-02,9857
2498,宏達電,19,4,15,元大-蘆洲,2023-05-02,9857
00632R,元大台灣50反1,79,64,15,元大-蘆洲,2023-05-02,9857
1605,華新,28,13,15,元大-蘆洲,2023-05-02,9857
4510,高鋒,30,16,14,元大-蘆洲,2023-05-02,9857
4121,優盛,43,29,14,元大-蘆洲,2023-05-02,9857
2031,新光鋼,14,0,14,元大-蘆洲,2023-05-02,9857
00712,復華富時不動產,122,6,116,元大-蘆洲,2023-05-03,9857
2603,長榮,116,10,106,元大-蘆洲,2023-05-03,9857
5347,世界,99,3,96,元大-蘆洲,2023-05-03,9857
00878,國泰永續高股息,101,10,91,元大-蘆洲,2023-05-03,9857
00882,中信中國高股息,91,0,91,元大-蘆洲,2023-05-03,9857
00632R,元大台灣50反1,119,35,84,元大-蘆洲,2023-05-03,9857
1720,生達,75,2,73,元大-蘆洲,2023-05-03,9857
00715L,期街口布蘭特正2,89,16,73,元大-蘆洲,2023-05-03,9857
2208,台船,74,2,72,元大-蘆洲,2023-05-03,9857
1905,華紙,173,102,71,元大-蘆洲,2023-05-03,9857
1218,泰山,66,7,59,元大-蘆洲,2023-05-03,9857
2609,陽明,68,12,56,元大-蘆洲,2023-05-03,9857
1762,中化生,50,0,50,元大-蘆洲,2023-05-03,9857
00648R,元大S＆P500反1,50,0,50,元大-蘆洲,2023-05-03,9857
3231,緯創,65,17,48,元大-蘆洲,2023-05-03,9857
0056,元大高股息,51,6,45,元大-蘆洲,2023-05-03,9857
3078,僑威,52,8,44,元大-蘆洲,2023-05-03,9857
5465,富驊,43,1,42,元大-蘆洲,2023-05-03,9857
3711,日月光投控,41,0,41,元大-蘆洲,2023-05-03,9857
6179,亞通,43,3,40,元大-蘆洲,2023-05-03,9857
4968,立積,49,12,37,元大-蘆洲,2023-05-03,9857
1101,台泥,60,23,37,元大-蘆洲,2023-05-03,9857
3029,零壹,41,5,36,元大-蘆洲,2023-05-03,9857
00642U,期元大S＆P石油,39,3,36,元大-蘆洲,2023-05-03,9857
2359,所羅門,36,0,36,元大-蘆洲,2023-05-03,9857
8403,盛弘,44,10,34,元大-蘆洲,2023-05-03,9857
2482,連宇,43,12,31,元大-蘆洲,2023-05-03,9857
4979,華星光,48,17,31,元大-蘆洲,2023-05-03,9857
1514,亞力,33,4,29,元大-蘆洲,2023-05-03,9857
2615,萬海,39,13,26,元大-蘆洲,2023-05-03,9857
3481,群創,121,96,25,元大-蘆洲,2023-05-03,9857
8105,凌巨,23,0,23,元大-蘆洲,2023-05-03,9857
2002,中鋼,24,1,23,元大-蘆洲,2023-05-03,9857
6806,森崴能源,29,7,22,元大-蘆洲,2023-05-03,9857
2344,華邦電,24,3,21,元大-蘆洲,2023-05-03,9857
2881,富邦金,20,0,20,元大-蘆洲,2023-05-03,9857
00772B,中信高評級公司債,20,0,20,元大-蘆洲,2023-05-03,9857
00669R,國泰美國道瓊反1,20,0,20,元大-蘆洲,2023-05-03,9857
4906,正文,20,0,20,元大-蘆洲,2023-05-03,9857
8478,東哥遊艇,28,8,20,元大-蘆洲,2023-05-03,9857
1519,華城,40,21,19,元大-蘆洲,2023-05-03,9857
00902,中信電池及儲能,18,0,18,元大-蘆洲,2023-05-03,9857
2913,農林,53,35,18,元大-蘆洲,2023-05-03,9857
2417,圓剛,21,4,17,元大-蘆洲,2023-05-03,9857
00665L,富邦�琤肭磪囓�2,26,9,17,元大-蘆洲,2023-05-03,9857
3006,晶豪科,28,12,16,元大-蘆洲,2023-05-03,9857
00633L,富邦上証正2,15,0,15,元大-蘆洲,2023-05-03,9857
1711,永光,50,35,15,元大-蘆洲,2023-05-03,9857
3032,偉訓,14,0,14,元大-蘆洲,2023-05-03,9857
2867,三商壽,14,0,14,元大-蘆洲,2023-05-03,9857
00715L,期街口布蘭特正2,324,13,311,元大-蘆洲,2023-05-04,9857
6234,高僑,197,19,178,元大-蘆洲,2023-05-04,9857
00642U,期元大S＆P石油,83,1,82,元大-蘆洲,2023-05-04,9857
00712,復華富時不動產,66,0,66,元大-蘆洲,2023-05-04,9857
3703,欣陸,61,1,60,元大-蘆洲,2023-05-04,9857
4746,台耀,140,89,51,元大-蘆洲,2023-05-04,9857
00679B,元大美債20年,57,7,50,元大-蘆洲,2023-05-04,9857
1905,華紙,79,30,49,元大-蘆洲,2023-05-04,9857
4744,皇將,68,24,44,元大-蘆洲,2023-05-04,9857
2344,華邦電,45,4,41,元大-蘆洲,2023-05-04,9857
2610,華航,45,8,37,元大-蘆洲,2023-05-04,9857
2208,台船,80,46,34,元大-蘆洲,2023-05-04,9857
4906,正文,32,0,32,元大-蘆洲,2023-05-04,9857
3231,緯創,69,37,32,元大-蘆洲,2023-05-04,9857
1762,中化生,40,10,30,元大-蘆洲,2023-05-04,9857
3521,鴻翊,28,0,28,元大-蘆洲,2023-05-04,9857
2206,三陽工業,89,63,26,元大-蘆洲,2023-05-04,9857
2851,中再保,25,0,25,元大-蘆洲,2023-05-04,9857
1904,正隆,44,19,25,元大-蘆洲,2023-05-04,9857
2002,中鋼,24,0,24,元大-蘆洲,2023-05-04,9857
3025,星通,36,13,23,元大-蘆洲,2023-05-04,9857
2538,基泰,28,5,23,元大-蘆洲,2023-05-04,9857
8105,凌巨,21,0,21,元大-蘆洲,2023-05-04,9857
1503,士電,27,7,20,元大-蘆洲,2023-05-04,9857
2425,承啟,20,0,20,元大-蘆洲,2023-05-04,9857
00688L,國泰20年美債正2,20,0,20,元大-蘆洲,2023-05-04,9857
2340,台亞,20,0,20,元大-蘆洲,2023-05-04,9857
1731,美吾華,20,0,20,元大-蘆洲,2023-05-04,9857
2331,精英,31,11,20,元大-蘆洲,2023-05-04,9857
3006,晶豪科,25,6,19,元大-蘆洲,2023-05-04,9857
4188,安克,19,0,19,元大-蘆洲,2023-05-04,9857
8222,寶一,39,20,19,元大-蘆洲,2023-05-04,9857
4111,濟生,20,2,18,元大-蘆洲,2023-05-04,9857
9103,美德醫療-DR,20,2,18,元大-蘆洲,2023-05-04,9857
3191,雲嘉南,18,0,18,元大-蘆洲,2023-05-04,9857
2230,泰茂,23,6,17,元大-蘆洲,2023-05-04,9857
8068,全達,21,4,17,元大-蘆洲,2023-05-04,9857
2367,燿華,16,0,16,元大-蘆洲,2023-05-04,9857
6443,元晶,35,20,15,元大-蘆洲,2023-05-04,9857
2609,陽明,61,46,15,元大-蘆洲,2023-05-04,9857
1514,亞力,33,18,15,元大-蘆洲,2023-05-04,9857
2482,連宇,29,15,14,元大-蘆洲,2023-05-04,9857
2429,銘旺科,14,0,14,元大-蘆洲,2023-05-04,9857
3207,耀勝,18,4,14,元大-蘆洲,2023-05-04,9857
00751B,元大AAA至A公司債,13,0,13,元大-蘆洲,2023-05-04,9857
2867,三商壽,23,10,13,元大-蘆洲,2023-05-04,9857
4123,晟德,14,1,13,元大-蘆洲,2023-05-04,9857
2105,正新,14,2,12,元大-蘆洲,2023-05-04,9857
2324,仁寶,14,2,12,元大-蘆洲,2023-05-04,9857
2314,台揚,14,2,12,元大-蘆洲,2023-05-04,9857
00648R,元大S＆P500反1,115,0,115,元大-蘆洲,2023-05-05,9857
3576,聯合再生,115,13,102,元大-蘆洲,2023-05-05,9857
00878,國泰永續高股息,92,0,92,元大-蘆洲,2023-05-05,9857
2609,陽明,80,4,76,元大-蘆洲,2023-05-05,9857
6244,茂迪,129,56,73,元大-蘆洲,2023-05-05,9857
00715L,期街口布蘭特正2,62,0,62,元大-蘆洲,2023-05-05,9857
00712,復華富時不動產,89,28,61,元大-蘆洲,2023-05-05,9857
2354,鴻準,47,0,47,元大-蘆洲,2023-05-05,9857
2353,宏��,64,23,41,元大-蘆洲,2023-05-05,9857
6443,元晶,48,8,40,元大-蘆洲,2023-05-05,9857
00642U,期元大S＆P石油,39,0,39,元大-蘆洲,2023-05-05,9857
00772B,中信高評級公司債,35,0,35,元大-蘆洲,2023-05-05,9857
1609,大亞,177,142,35,元大-蘆洲,2023-05-05,9857
2880,華南金,34,0,34,元大-蘆洲,2023-05-05,9857
4173,久裕,33,1,32,元大-蘆洲,2023-05-05,9857
1503,士電,46,14,32,元大-蘆洲,2023-05-05,9857
00720B,元大投資級公司債,33,2,31,元大-蘆洲,2023-05-05,9857
6180,橘子,32,1,31,元大-蘆洲,2023-05-05,9857
2303,聯電,33,4,29,元大-蘆洲,2023-05-05,9857
2453,凌群,59,30,29,元大-蘆洲,2023-05-05,9857
2061,風青,26,0,26,元大-蘆洲,2023-05-05,9857
00679B,元大美債20年,31,5,26,元大-蘆洲,2023-05-05,9857
1810,和成,25,0,25,元大-蘆洲,2023-05-05,9857
4114,健喬,65,42,23,元大-蘆洲,2023-05-05,9857
1104,環泥,22,0,22,元大-蘆洲,2023-05-05,9857
3356,奇偶,24,2,22,元大-蘆洲,2023-05-05,9857
2344,華邦電,38,17,21,元大-蘆洲,2023-05-05,9857
6167,久正,35,15,20,元大-蘆洲,2023-05-05,9857
6185,幃翔,20,0,20,元大-蘆洲,2023-05-05,9857
2419,仲琦,20,0,20,元大-蘆洲,2023-05-05,9857
6438,迅得,29,10,19,元大-蘆洲,2023-05-05,9857
6770,力積電,60,41,19,元大-蘆洲,2023-05-05,9857
2515,中工,52,33,19,元大-蘆洲,2023-05-05,9857
3033,威健,19,0,19,元大-蘆洲,2023-05-05,9857
5880,合庫金,25,6,19,元大-蘆洲,2023-05-05,9857
1760,寶齡富錦,22,3,19,元大-蘆洲,2023-05-05,9857
00687B,國泰20年美債,19,0,19,元大-蘆洲,2023-05-05,9857
00885,富邦越南,19,2,17,元大-蘆洲,2023-05-05,9857
3071,協禧,52,35,17,元大-蘆洲,2023-05-05,9857
2402,毅嘉,17,2,15,元大-蘆洲,2023-05-05,9857
3062,建漢,15,0,15,元大-蘆洲,2023-05-05,9857
4123,晟德,17,2,15,元大-蘆洲,2023-05-05,9857
1504,東元,50,35,15,元大-蘆洲,2023-05-05,9857
00888,永豐台灣ESG,14,0,14,元大-蘆洲,2023-05-05,9857
6271,同欣電,15,1,14,元大-蘆洲,2023-05-05,9857
6550,北極星藥業-KY,24,10,14,元大-蘆洲,2023-05-05,9857
00751B,元大AAA至A公司債,14,0,14,元大-蘆洲,2023-05-05,9857
4916,事欣科,36,23,13,元大-蘆洲,2023-05-05,9857
00830,國泰費城半導體,12,0,12,元大-蘆洲,2023-05-05,9857
2352,佳世達,12,1,11,元大-蘆洲,2023-05-05,9857
2801,彰銀,201,0,201,元大-蘆洲,2023-05-08,9857
00715L,期街口布蘭特正2,154,16,138,元大-蘆洲,2023-05-08,9857
1605,華新,169,42,127,元大-蘆洲,2023-05-08,9857
00690,兆豐藍籌30,100,0,100,元大-蘆洲,2023-05-08,9857
2609,陽明,106,9,97,元大-蘆洲,2023-05-08,9857
3481,群創,96,16,80,元大-蘆洲,2023-05-08,9857
2887,台新金,76,8,68,元大-蘆洲,2023-05-08,9857
2851,中再保,66,13,53,元大-蘆洲,2023-05-08,9857
6190,萬泰科,51,0,51,元大-蘆洲,2023-05-08,9857
6116,彩晶,55,5,50,元大-蘆洲,2023-05-08,9857
3576,聯合再生,101,52,49,元大-蘆洲,2023-05-08,9857
1319,東陽,48,2,46,元大-蘆洲,2023-05-08,9857
4161,聿新科,40,0,40,元大-蘆洲,2023-05-08,9857
2881,富邦金,38,1,37,元大-蘆洲,2023-05-08,9857
1783,和康生,58,22,36,元大-蘆洲,2023-05-08,9857
9933,中鼎,55,21,34,元大-蘆洲,2023-05-08,9857
1810,和成,34,1,33,元大-蘆洲,2023-05-08,9857
00712,復華富時不動產,34,3,31,元大-蘆洲,2023-05-08,9857
6234,高僑,41,11,30,元大-蘆洲,2023-05-08,9857
1326,台化,29,0,29,元大-蘆洲,2023-05-08,9857
1785,光洋科,31,3,28,元大-蘆洲,2023-05-08,9857
1314,中石化,28,0,28,元大-蘆洲,2023-05-08,9857
00751B,元大AAA至A公司債,28,0,28,元大-蘆洲,2023-05-08,9857
2344,華邦電,28,2,26,元大-蘆洲,2023-05-08,9857
00720B,元大投資級公司債,27,1,26,元大-蘆洲,2023-05-08,9857
4173,久裕,27,2,25,元大-蘆洲,2023-05-08,9857
8222,寶一,46,21,25,元大-蘆洲,2023-05-08,9857
3038,全台,27,3,24,元大-蘆洲,2023-05-08,9857
3191,雲嘉南,24,1,23,元大-蘆洲,2023-05-08,9857
1529,樂事綠能,55,33,22,元大-蘆洲,2023-05-08,9857
4111,濟生,32,10,22,元大-蘆洲,2023-05-08,9857
2014,中鴻,21,0,21,元大-蘆洲,2023-05-08,9857
2630,亞航,33,15,18,元大-蘆洲,2023-05-08,9857
1434,福懋,18,0,18,元大-蘆洲,2023-05-08,9857
5608,四維航,18,0,18,元大-蘆洲,2023-05-08,9857
3715,定穎投控,65,48,17,元大-蘆洲,2023-05-08,9857
00772B,中信高評級公司債,17,0,17,元大-蘆洲,2023-05-08,9857
2359,所羅門,21,4,17,元大-蘆洲,2023-05-08,9857
5328,華容,17,0,17,元大-蘆洲,2023-05-08,9857
3149,正達,17,1,16,元大-蘆洲,2023-05-08,9857
6163,華電網,23,7,16,元大-蘆洲,2023-05-08,9857
3013,晟銘電,32,17,15,元大-蘆洲,2023-05-08,9857
2458,義隆,21,6,15,元大-蘆洲,2023-05-08,9857
8936,國統,22,7,15,元大-蘆洲,2023-05-08,9857
2601,益航,15,0,15,元大-蘆洲,2023-05-08,9857
2732,六角,17,2,15,元大-蘆洲,2023-05-08,9857
2492,華新科,24,9,15,元大-蘆洲,2023-05-08,9857
1795,美時,26,11,15,元大-蘆洲,2023-05-08,9857
2413,環科,14,0,14,元大-蘆洲,2023-05-08,9857
4167,松瑞藥,12,0,12,元大-蘆洲,2023-05-08,9857
3576,聯合再生,323,5,318,元大-蘆洲,2023-05-09,9857
1905,華紙,275,150,125,元大-蘆洲,2023-05-09,9857
2883,凱基金,119,6,113,元大-蘆洲,2023-05-09,9857
3491,昇達科,54,1,53,元大-蘆洲,2023-05-09,9857
6443,元晶,70,17,53,元大-蘆洲,2023-05-09,9857
00679B,元大美債20年,53,3,50,元大-蘆洲,2023-05-09,9857
3191,雲嘉南,50,1,49,元大-蘆洲,2023-05-09,9857
2609,陽明,59,13,46,元大-蘆洲,2023-05-09,9857
00687B,國泰20年美債,44,0,44,元大-蘆洲,2023-05-09,9857
1907,永豐餘,69,26,43,元大-蘆洲,2023-05-09,9857
6244,茂迪,59,17,42,元大-蘆洲,2023-05-09,9857
1513,中興電,74,33,41,元大-蘆洲,2023-05-09,9857
00772B,中信高評級公司債,39,0,39,元大-蘆洲,2023-05-09,9857
1503,士電,60,23,37,元大-蘆洲,2023-05-09,9857
2359,所羅門,37,1,36,元大-蘆洲,2023-05-09,9857
3715,定穎投控,56,20,36,元大-蘆洲,2023-05-09,9857
00720B,元大投資級公司債,33,0,33,元大-蘆洲,2023-05-09,9857
2402,毅嘉,86,53,33,元大-蘆洲,2023-05-09,9857
00680L,元大美債20正2,29,0,29,元大-蘆洲,2023-05-09,9857
2482,連宇,49,21,28,元大-蘆洲,2023-05-09,9857
00885,富邦越南,31,4,27,元大-蘆洲,2023-05-09,9857
5498,凱崴,27,0,27,元大-蘆洲,2023-05-09,9857
00751B,元大AAA至A公司債,27,0,27,元大-蘆洲,2023-05-09,9857
2601,益航,26,0,26,元大-蘆洲,2023-05-09,9857
6418,詠昇,25,0,25,元大-蘆洲,2023-05-09,9857
1101,台泥,32,8,24,元大-蘆洲,2023-05-09,9857
4129,聯合,23,0,23,元大-蘆洲,2023-05-09,9857
1504,東元,124,103,21,元大-蘆洲,2023-05-09,9857
3037,欣興,50,29,21,元大-蘆洲,2023-05-09,9857
6477,安集,21,1,20,元大-蘆洲,2023-05-09,9857
5452,佶優,30,10,20,元大-蘆洲,2023-05-09,9857
5512,力麒,20,0,20,元大-蘆洲,2023-05-09,9857
00673R,期元大S＆P原油反1,20,0,20,元大-蘆洲,2023-05-09,9857
6156,松上,20,0,20,元大-蘆洲,2023-05-09,9857
6190,萬泰科,20,0,20,元大-蘆洲,2023-05-09,9857
7402,邑錡,20,0,20,元大-蘆洲,2023-05-09,9857
3499,環天科,20,0,20,元大-蘆洲,2023-05-09,9857
8105,凌巨,20,0,20,元大-蘆洲,2023-05-09,9857
1218,泰山,25,5,20,元大-蘆洲,2023-05-09,9857
2340,台亞,20,1,19,元大-蘆洲,2023-05-09,9857
8358,金居,19,0,19,元大-蘆洲,2023-05-09,9857
2344,華邦電,24,5,19,元大-蘆洲,2023-05-09,9857
6116,彩晶,24,6,18,元大-蘆洲,2023-05-09,9857
2368,金像電,19,1,18,元大-蘆洲,2023-05-09,9857
4979,華星光,22,4,18,元大-蘆洲,2023-05-09,9857
00725B,國泰投資級公司債,17,0,17,元大-蘆洲,2023-05-09,9857
1605,華新,82,65,17,元大-蘆洲,2023-05-09,9857
2881,富邦金,30,13,17,元大-蘆洲,2023-05-09,9857
00713,元大台灣高息低波,16,0,16,元大-蘆洲,2023-05-09,9857
8936,國統,32,16,16,元大-蘆洲,2023-05-09,9857
00637L,元大滬深300正2,223,6,217,元大-蘆洲,2023-05-10,9857
4744,皇將,127,13,114,元大-蘆洲,2023-05-10,9857
00878,國泰永續高股息,99,6,93,元大-蘆洲,2023-05-10,9857
00687B,國泰20年美債,71,0,71,元大-蘆洲,2023-05-10,9857
3694,海華,60,0,60,元大-蘆洲,2023-05-10,9857
2882,國泰金,54,0,54,元大-蘆洲,2023-05-10,9857
00772B,中信高評級公司債,51,0,51,元大-蘆洲,2023-05-10,9857
3013,晟銘電,34,0,34,元大-蘆洲,2023-05-10,9857
2405,輔信,30,0,30,元大-蘆洲,2023-05-10,9857
00679B,元大美債20年,30,1,29,元大-蘆洲,2023-05-10,9857
1337,再生-KY,31,3,28,元大-蘆洲,2023-05-10,9857
6116,彩晶,32,5,27,元大-蘆洲,2023-05-10,9857
00673R,期元大S＆P原油反1,27,0,27,元大-蘆洲,2023-05-10,9857
6245,立端,27,0,27,元大-蘆洲,2023-05-10,9857
3209,全科,26,1,25,元大-蘆洲,2023-05-10,9857
6142,友勁,23,0,23,元大-蘆洲,2023-05-10,9857
00680L,元大美債20正2,22,0,22,元大-蘆洲,2023-05-10,9857
1451,年興,25,3,22,元大-蘆洲,2023-05-10,9857
1810,和成,45,24,21,元大-蘆洲,2023-05-10,9857
6129,普誠,21,0,21,元大-蘆洲,2023-05-10,9857
00713,元大台灣高息低波,27,6,21,元大-蘆洲,2023-05-10,9857
6235,華孚,37,17,20,元大-蘆洲,2023-05-10,9857
1102,亞泥,23,3,20,元大-蘆洲,2023-05-10,9857
8936,國統,20,0,20,元大-蘆洲,2023-05-10,9857
1714,和桐,20,0,20,元大-蘆洲,2023-05-10,9857
00751B,元大AAA至A公司債,20,0,20,元大-蘆洲,2023-05-10,9857
3191,雲嘉南,20,2,18,元大-蘆洲,2023-05-10,9857
4979,華星光,25,7,18,元大-蘆洲,2023-05-10,9857
1314,中石化,17,0,17,元大-蘆洲,2023-05-10,9857
1513,中興電,37,20,17,元大-蘆洲,2023-05-10,9857
9933,中鼎,16,0,16,元大-蘆洲,2023-05-10,9857
00688L,國泰20年美債正2,16,0,16,元大-蘆洲,2023-05-10,9857
6112,邁達特,43,28,15,元大-蘆洲,2023-05-10,9857
4121,優盛,18,3,15,元大-蘆洲,2023-05-10,9857
8358,金居,14,0,14,元大-蘆洲,2023-05-10,9857
1326,台化,14,0,14,元大-蘆洲,2023-05-10,9857
1605,華新,21,8,13,元大-蘆洲,2023-05-10,9857
1471,首利,13,0,13,元大-蘆洲,2023-05-10,9857
5880,合庫金,12,0,12,元大-蘆洲,2023-05-10,9857
2471,資通,14,2,12,元大-蘆洲,2023-05-10,9857
2504,國產,15,3,12,元大-蘆洲,2023-05-10,9857
3048,益登,11,0,11,元大-蘆洲,2023-05-10,9857
6156,松上,11,0,11,元大-蘆洲,2023-05-10,9857
4190,佐登-KY,11,0,11,元大-蘆洲,2023-05-10,9857
0056,元大高股息,11,0,11,元大-蘆洲,2023-05-10,9857
2027,大成鋼,18,8,10,元大-蘆洲,2023-05-10,9857
6612,奈米醫材,11,1,10,元大-蘆洲,2023-05-10,9857
1321,大洋,10,0,10,元大-蘆洲,2023-05-10,9857
5243,乙盛-KY,11,1,10,元大-蘆洲,2023-05-10,9857
4968,立積,22,12,10,元大-蘆洲,2023-05-10,9857
3576,聯合再生,233,30,203,元大-蘆洲,2023-05-11,9857
1609,大亞,152,59,93,元大-蘆洲,2023-05-11,9857
2515,中工,83,12,71,元大-蘆洲,2023-05-11,9857
00878,國泰永續高股息,99,28,71,元大-蘆洲,2023-05-11,9857
1314,中石化,114,46,68,元大-蘆洲,2023-05-11,9857
2359,所羅門,76,18,58,元大-蘆洲,2023-05-11,9857
00715L,期街口布蘭特正2,56,2,54,元大-蘆洲,2023-05-11,9857
3481,群創,187,137,50,元大-蘆洲,2023-05-11,9857
2482,連宇,51,1,50,元大-蘆洲,2023-05-11,9857
6104,創惟,43,2,41,元大-蘆洲,2023-05-11,9857
2409,友達,51,12,39,元大-蘆洲,2023-05-11,9857
6182,合晶,39,0,39,元大-蘆洲,2023-05-11,9857
1905,華紙,72,36,36,元大-蘆洲,2023-05-11,9857
5512,力麒,30,0,30,元大-蘆洲,2023-05-11,9857
1612,宏泰,30,0,30,元大-蘆洲,2023-05-11,9857
6570,維田,40,10,30,元大-蘆洲,2023-05-11,9857
4903,聯光通,29,0,29,元大-蘆洲,2023-05-11,9857
6285,啟��,31,2,29,元大-蘆洲,2023-05-11,9857
2610,華航,30,1,29,元大-蘆洲,2023-05-11,9857
9907,統一實,27,0,27,元大-蘆洲,2023-05-11,9857
1409,新纖,26,0,26,元大-蘆洲,2023-05-11,9857
3260,威剛,31,6,25,元大-蘆洲,2023-05-11,9857
3037,欣興,55,30,25,元大-蘆洲,2023-05-11,9857
00772B,中信高評級公司債,24,0,24,元大-蘆洲,2023-05-11,9857
00720B,元大投資級公司債,24,0,24,元大-蘆洲,2023-05-11,9857
5498,凱崴,25,2,23,元大-蘆洲,2023-05-11,9857
0056,元大高股息,57,35,22,元大-蘆洲,2023-05-11,9857
1504,東元,41,19,22,元大-蘆洲,2023-05-11,9857
4763,材料-KY,22,1,21,元大-蘆洲,2023-05-11,9857
3522,御嵿,21,0,21,元大-蘆洲,2023-05-11,9857
2609,陽明,32,12,20,元大-蘆洲,2023-05-11,9857
5310,天剛,20,0,20,元大-蘆洲,2023-05-11,9857
1321,大洋,20,0,20,元大-蘆洲,2023-05-11,9857
4114,健喬,26,6,20,元大-蘆洲,2023-05-11,9857
6234,高僑,33,13,20,元大-蘆洲,2023-05-11,9857
1605,華新,29,9,20,元大-蘆洲,2023-05-11,9857
2611,志信,18,0,18,元大-蘆洲,2023-05-11,9857
4503,金雨,77,59,18,元大-蘆洲,2023-05-11,9857
8261,富鼎,20,3,17,元大-蘆洲,2023-05-11,9857
1519,華城,43,27,16,元大-蘆洲,2023-05-11,9857
6160,欣技,18,2,16,元大-蘆洲,2023-05-11,9857
2634,漢翔,45,30,15,元大-蘆洲,2023-05-11,9857
4967,十銓,15,0,15,元大-蘆洲,2023-05-11,9857
00888,永豐台灣ESG,15,0,15,元大-蘆洲,2023-05-11,9857
2388,威盛,28,13,15,元大-蘆洲,2023-05-11,9857
2888,新光金,28,13,15,元大-蘆洲,2023-05-11,9857
2618,長榮航,47,32,15,元大-蘆洲,2023-05-11,9857
3162,精確,14,0,14,元大-蘆洲,2023-05-11,9857
2834,臺企銀,14,0,14,元大-蘆洲,2023-05-11,9857
6276,安鈦克,39,25,14,元大-蘆洲,2023-05-11,9857
3576,聯合再生,216,1,215,元大-蘆洲,2023-05-12,9857
00669R,國泰美國道瓊反1,150,0,150,元大-蘆洲,2023-05-12,9857
00882,中信中國高股息,108,0,108,元大-蘆洲,2023-05-12,9857
1440,南紡,50,0,50,元大-蘆洲,2023-05-12,9857
00648R,元大S＆P500反1,50,0,50,元大-蘆洲,2023-05-12,9857
2883,凱基金,72,23,49,元大-蘆洲,2023-05-12,9857
3481,群創,61,14,47,元大-蘆洲,2023-05-12,9857
2888,新光金,64,20,44,元大-蘆洲,2023-05-12,9857
00637L,元大滬深300正2,50,6,44,元大-蘆洲,2023-05-12,9857
1314,中石化,62,20,42,元大-蘆洲,2023-05-12,9857
2317,鴻海,52,11,41,元大-蘆洲,2023-05-12,9857
1101,台泥,35,1,34,元大-蘆洲,2023-05-12,9857
2634,漢翔,49,15,34,元大-蘆洲,2023-05-12,9857
2885,元大金,33,0,33,元大-蘆洲,2023-05-12,9857
4979,華星光,53,21,32,元大-蘆洲,2023-05-12,9857
1810,和成,31,0,31,元大-蘆洲,2023-05-12,9857
00715L,期街口布蘭特正2,38,7,31,元大-蘆洲,2023-05-12,9857
6570,維田,37,7,30,元大-蘆洲,2023-05-12,9857
2340,台亞,31,2,29,元大-蘆洲,2023-05-12,9857
5531,鄉林,32,4,28,元大-蘆洲,2023-05-12,9857
1722,台肥,26,0,26,元大-蘆洲,2023-05-12,9857
2356,英業達,24,0,24,元大-蘆洲,2023-05-12,9857
2890,永豐金,24,0,24,元大-蘆洲,2023-05-12,9857
4114,健喬,36,14,22,元大-蘆洲,2023-05-12,9857
2812,台中銀,21,0,21,元大-蘆洲,2023-05-12,9857
2359,所羅門,22,2,20,元大-蘆洲,2023-05-12,9857
2101,南港,20,0,20,元大-蘆洲,2023-05-12,9857
2603,長榮,19,0,19,元大-蘆洲,2023-05-12,9857
1701,中化,20,1,19,元大-蘆洲,2023-05-12,9857
1108,幸福,19,0,19,元大-蘆洲,2023-05-12,9857
2409,友達,25,6,19,元大-蘆洲,2023-05-12,9857
2882,國泰金,23,5,18,元大-蘆洲,2023-05-12,9857
2887,台新金,21,4,17,元大-蘆洲,2023-05-12,9857
00642U,期元大S＆P石油,18,1,17,元大-蘆洲,2023-05-12,9857
4938,和碩,19,3,16,元大-蘆洲,2023-05-12,9857
00687B,國泰20年美債,26,10,16,元大-蘆洲,2023-05-12,9857
1721,三晃,13,0,13,元大-蘆洲,2023-05-12,9857
00680L,元大美債20正2,12,0,12,元大-蘆洲,2023-05-12,9857
8038,長園科,19,7,12,元大-蘆洲,2023-05-12,9857
1529,樂事綠能,35,23,12,元大-蘆洲,2023-05-12,9857
00712,復華富時不動產,12,0,12,元大-蘆洲,2023-05-12,9857
00888,永豐台灣ESG,11,0,11,元大-蘆洲,2023-05-12,9857
1569,濱川,11,0,11,元大-蘆洲,2023-05-12,9857
3081,聯亞,11,0,11,元大-蘆洲,2023-05-12,9857
8215,明基材,13,2,11,元大-蘆洲,2023-05-12,9857
00878,國泰永續高股息,81,71,10,元大-蘆洲,2023-05-12,9857
6285,啟��,20,10,10,元大-蘆洲,2023-05-12,9857
2312,金寶,10,0,10,元大-蘆洲,2023-05-12,9857
3646,艾恩特,10,0,10,元大-蘆洲,2023-05-12,9857
6160,欣技,13,3,10,元大-蘆洲,2023-05-12,9857
2303,聯電,229,7,222,元大-蘆洲,2023-05-15,9857
00687B,國泰20年美債,63,0,63,元大-蘆洲,2023-05-15,9857
2317,鴻海,61,7,54,元大-蘆洲,2023-05-15,9857
6285,啟��,46,2,44,元大-蘆洲,2023-05-15,9857
1314,中石化,51,14,37,元大-蘆洲,2023-05-15,9857
6218,豪勉,56,21,35,元大-蘆洲,2023-05-15,9857
6122,擎邦,111,77,34,元大-蘆洲,2023-05-15,9857
00679B,元大美債20年,46,13,33,元大-蘆洲,2023-05-15,9857
00715L,期街口布蘭特正2,33,0,33,元大-蘆洲,2023-05-15,9857
4167,松瑞藥,32,0,32,元大-蘆洲,2023-05-15,9857
2888,新光金,40,10,30,元大-蘆洲,2023-05-15,9857
2887,台新金,28,1,27,元大-蘆洲,2023-05-15,9857
3704,合勤控,26,0,26,元大-蘆洲,2023-05-15,9857
2031,新光鋼,30,5,25,元大-蘆洲,2023-05-15,9857
00648R,元大S＆P500反1,25,0,25,元大-蘆洲,2023-05-15,9857
00637L,元大滬深300正2,49,25,24,元大-蘆洲,2023-05-15,9857
00751B,元大AAA至A公司債,24,0,24,元大-蘆洲,2023-05-15,9857
6116,彩晶,23,0,23,元大-蘆洲,2023-05-15,9857
3046,建��,60,38,22,元大-蘆洲,2023-05-15,9857
00882,中信中國高股息,26,5,21,元大-蘆洲,2023-05-15,9857
00878,國泰永續高股息,104,83,21,元大-蘆洲,2023-05-15,9857
2641,正德,21,0,21,元大-蘆洲,2023-05-15,9857
2542,興富發,23,3,20,元大-蘆洲,2023-05-15,9857
2340,台亞,20,0,20,元大-蘆洲,2023-05-15,9857
00673R,期元大S＆P原油反1,20,1,19,元大-蘆洲,2023-05-15,9857
1609,大亞,43,24,19,元大-蘆洲,2023-05-15,9857
00642U,期元大S＆P石油,18,0,18,元大-蘆洲,2023-05-15,9857
1783,和康生,20,2,18,元大-蘆洲,2023-05-15,9857
4763,材料-KY,19,1,18,元大-蘆洲,2023-05-15,9857
2618,長榮航,34,17,17,元大-蘆洲,2023-05-15,9857
5706,鳳凰,26,9,17,元大-蘆洲,2023-05-15,9857
3105,穩懋,16,0,16,元大-蘆洲,2023-05-15,9857
00900,富邦特選高股息30,18,2,16,元大-蘆洲,2023-05-15,9857
4906,正文,15,0,15,元大-蘆洲,2023-05-15,9857
6443,元晶,20,6,14,元大-蘆洲,2023-05-15,9857
3034,聯詠,18,4,14,元大-蘆洲,2023-05-15,9857
2515,中工,13,0,13,元大-蘆洲,2023-05-15,9857
2402,毅嘉,29,17,12,元大-蘆洲,2023-05-15,9857
3231,緯創,49,37,12,元大-蘆洲,2023-05-15,9857
1709,和益,14,2,12,元大-蘆洲,2023-05-15,9857
6234,高僑,17,5,12,元大-蘆洲,2023-05-15,9857
6806,森崴能源,14,3,11,元大-蘆洲,2023-05-15,9857
4171,瑞基,11,0,11,元大-蘆洲,2023-05-15,9857
8097,常珵,14,3,11,元大-蘆洲,2023-05-15,9857
2388,威盛,16,5,11,元大-蘆洲,2023-05-15,9857
1707,葡萄王,11,0,11,元大-蘆洲,2023-05-15,9857
0056,元大高股息,29,18,11,元大-蘆洲,2023-05-15,9857
00720B,元大投資級公司債,11,0,11,元大-蘆洲,2023-05-15,9857
2610,華航,15,5,10,元大-蘆洲,2023-05-15,9857
9904,寶成,15,5,10,元大-蘆洲,2023-05-15,9857
2014,中鴻,103,0,103,元大-蘆洲,2023-05-16,9857
00687B,國泰20年美債,71,0,71,元大-蘆洲,2023-05-16,9857
2888,新光金,86,23,63,元大-蘆洲,2023-05-16,9857
00720B,元大投資級公司債,62,0,62,元大-蘆洲,2023-05-16,9857
4123,晟德,50,0,50,元大-蘆洲,2023-05-16,9857
00772B,中信高評級公司債,58,10,48,元大-蘆洲,2023-05-16,9857
00665L,富邦�琤肭磪囓�2,61,13,48,元大-蘆洲,2023-05-16,9857
1504,東元,83,47,36,元大-蘆洲,2023-05-16,9857
6547,高端疫苗,32,0,32,元大-蘆洲,2023-05-16,9857
00632R,元大台灣50反1,61,30,31,元大-蘆洲,2023-05-16,9857
00751B,元大AAA至A公司債,30,0,30,元大-蘆洲,2023-05-16,9857
6719,力智,35,6,29,元大-蘆洲,2023-05-16,9857
00679B,元大美債20年,40,11,29,元大-蘆洲,2023-05-16,9857
2349,錸德,31,3,28,元大-蘆洲,2023-05-16,9857
2633,台灣高鐵,38,11,27,元大-蘆洲,2023-05-16,9857
2603,長榮,27,2,25,元大-蘆洲,2023-05-16,9857
6282,康舒,25,0,25,元大-蘆洲,2023-05-16,9857
2427,三商電,42,18,24,元大-蘆洲,2023-05-16,9857
2337,旺宏,21,1,20,元大-蘆洲,2023-05-16,9857
2929,淘帝-KY,20,0,20,元大-蘆洲,2023-05-16,9857
1783,和康生,32,12,20,元大-蘆洲,2023-05-16,9857
6770,力積電,21,2,19,元大-蘆洲,2023-05-16,9857
4919,新唐,22,3,19,元大-蘆洲,2023-05-16,9857
3209,全科,20,1,19,元大-蘆洲,2023-05-16,9857
2313,華通,22,3,19,元大-蘆洲,2023-05-16,9857
2368,金像電,20,6,14,元大-蘆洲,2023-05-16,9857
2538,基泰,22,8,14,元大-蘆洲,2023-05-16,9857
3712,永崴投控,14,1,13,元大-蘆洲,2023-05-16,9857
2727,王品,16,5,11,元大-蘆洲,2023-05-16,9857
1319,東陽,12,1,11,元大-蘆洲,2023-05-16,9857
8916,光隆,11,0,11,元大-蘆洲,2023-05-16,9857
6535,順藥,11,0,11,元大-蘆洲,2023-05-16,9857
00642U,期元大S＆P石油,11,0,11,元大-蘆洲,2023-05-16,9857
4763,材料-KY,15,5,10,元大-蘆洲,2023-05-16,9857
2883B,凱基金乙特,10,0,10,元大-蘆洲,2023-05-16,9857
3587,閎康,10,0,10,元大-蘆洲,2023-05-16,9857
1725,元禎,10,0,10,元大-蘆洲,2023-05-16,9857
1789,神隆,10,0,10,元大-蘆洲,2023-05-16,9857
2421,建準,15,5,10,元大-蘆洲,2023-05-16,9857
8942,森鉅,10,0,10,元大-蘆洲,2023-05-16,9857
5498,凱崴,10,0,10,元大-蘆洲,2023-05-16,9857
2317,鴻海,12,2,10,元大-蘆洲,2023-05-16,9857
2208,台船,9,0,9,元大-蘆洲,2023-05-16,9857
1721,三晃,20,11,9,元大-蘆洲,2023-05-16,9857
3163,波若威,10,1,9,元大-蘆洲,2023-05-16,9857
2453,凌群,10,1,9,元大-蘆洲,2023-05-16,9857
3481,群創,24,15,9,元大-蘆洲,2023-05-16,9857
2890,永豐金,10,2,8,元大-蘆洲,2023-05-16,9857
6165,浪凡,8,0,8,元大-蘆洲,2023-05-16,9857
4968,立積,15,7,8,元大-蘆洲,2023-05-16,9857
00632R,元大台灣50反1,363,0,363,元大-蘆洲,2023-05-17,9857
00687B,國泰20年美債,125,0,125,元大-蘆洲,2023-05-17,9857
2014,中鴻,109,0,109,元大-蘆洲,2023-05-17,9857
6282,康舒,108,10,98,元大-蘆洲,2023-05-17,9857
2618,長榮航,81,8,73,元大-蘆洲,2023-05-17,9857
2031,新光鋼,71,0,71,元大-蘆洲,2023-05-17,9857
6285,啟��,70,0,70,元大-蘆洲,2023-05-17,9857
00772B,中信高評級公司債,60,0,60,元大-蘆洲,2023-05-17,9857
00751B,元大AAA至A公司債,54,0,54,元大-蘆洲,2023-05-17,9857
2888,新光金,72,18,54,元大-蘆洲,2023-05-17,9857
2603,長榮,44,1,43,元大-蘆洲,2023-05-17,9857
3479,安勤,50,8,42,元大-蘆洲,2023-05-17,9857
1905,華紙,77,39,38,元大-蘆洲,2023-05-17,9857
00712,復華富時不動產,39,1,38,元大-蘆洲,2023-05-17,9857
00637L,元大滬深300正2,37,0,37,元大-蘆洲,2023-05-17,9857
3207,耀勝,60,26,34,元大-蘆洲,2023-05-17,9857
6733,博晟生醫,32,1,31,元大-蘆洲,2023-05-17,9857
2313,華通,37,7,30,元大-蘆洲,2023-05-17,9857
2913,農林,33,3,30,元大-蘆洲,2023-05-17,9857
00852L,國泰美國道瓊正2,30,0,30,元大-蘆洲,2023-05-17,9857
00683L,期元大美元指正2,29,1,28,元大-蘆洲,2023-05-17,9857
2609,陽明,49,23,26,元大-蘆洲,2023-05-17,9857
2402,毅嘉,91,69,22,元大-蘆洲,2023-05-17,9857
2887,台新金,27,7,20,元大-蘆洲,2023-05-17,9857
00706L,期元大S＆P日圓正2,20,0,20,元大-蘆洲,2023-05-17,9857
3022,威強電,58,38,20,元大-蘆洲,2023-05-17,9857
6874,倍力,51,31,20,元大-蘆洲,2023-05-17,9857
3260,威剛,24,5,19,元大-蘆洲,2023-05-17,9857
00720B,元大投資級公司債,24,6,18,元大-蘆洲,2023-05-17,9857
3033,威健,18,0,18,元大-蘆洲,2023-05-17,9857
2303,聯電,25,8,17,元大-蘆洲,2023-05-17,9857
00882,中信中國高股息,21,4,17,元大-蘆洲,2023-05-17,9857
4566,時碩工業,18,1,17,元大-蘆洲,2023-05-17,9857
1104,環泥,19,2,17,元大-蘆洲,2023-05-17,9857
00773B,中信優先金融債,17,0,17,元大-蘆洲,2023-05-17,9857
6125,廣運,17,0,17,元大-蘆洲,2023-05-17,9857
00857B,永豐20年美公債,17,0,17,元大-蘆洲,2023-05-17,9857
2881,富邦金,23,6,17,元大-蘆洲,2023-05-17,9857
2743,山富,29,13,16,元大-蘆洲,2023-05-17,9857
00633L,富邦上証正2,16,0,16,元大-蘆洲,2023-05-17,9857
00679B,元大美債20年,34,18,16,元大-蘆洲,2023-05-17,9857
9945,潤泰新,15,0,15,元大-蘆洲,2023-05-17,9857
00688L,國泰20年美債正2,15,0,15,元大-蘆洲,2023-05-17,9857
6589,台康生技,25,11,14,元大-蘆洲,2023-05-17,9857
4173,久裕,20,7,13,元大-蘆洲,2023-05-17,9857
2748,雲品,12,0,12,元大-蘆洲,2023-05-17,9857
00795B,中信美國公債20年,12,0,12,元大-蘆洲,2023-05-17,9857
2495,普安,24,12,12,元大-蘆洲,2023-05-17,9857
1326,台化,15,3,12,元大-蘆洲,2023-05-17,9857
3704,合勤控,18,6,12,元大-蘆洲,2023-05-17,9857
2002,中鋼,302,13,289,元大-蘆洲,2023-05-18,9857
00687B,國泰20年美債,135,0,135,元大-蘆洲,2023-05-18,9857
6282,康舒,150,22,128,元大-蘆洲,2023-05-18,9857
2888,新光金,163,65,98,元大-蘆洲,2023-05-18,9857
00902,中信電池及儲能,51,1,50,元大-蘆洲,2023-05-18,9857
00650L,復華香港正2,50,10,40,元大-蘆洲,2023-05-18,9857
5381,合正,40,0,40,元大-蘆洲,2023-05-18,9857
00720B,元大投資級公司債,34,0,34,元大-蘆洲,2023-05-18,9857
00772B,中信高評級公司債,39,7,32,元大-蘆洲,2023-05-18,9857
2736,富野,41,11,30,元大-蘆洲,2023-05-18,9857
4167,松瑞藥,30,0,30,元大-蘆洲,2023-05-18,9857
8222,寶一,95,65,30,元大-蘆洲,2023-05-18,9857
00637L,元大滬深300正2,37,12,25,元大-蘆洲,2023-05-18,9857
2887,台新金,33,9,24,元大-蘆洲,2023-05-18,9857
1101,台泥,24,0,24,元大-蘆洲,2023-05-18,9857
2913,農林,23,1,22,元大-蘆洲,2023-05-18,9857
5324,士開,22,0,22,元大-蘆洲,2023-05-18,9857
5483,中美晶,25,3,22,元大-蘆洲,2023-05-18,9857
00751B,元大AAA至A公司債,35,13,22,元大-蘆洲,2023-05-18,9857
00673R,期元大S＆P原油反1,22,1,21,元大-蘆洲,2023-05-18,9857
1314,中石化,22,2,20,元大-蘆洲,2023-05-18,9857
2402,毅嘉,30,12,18,元大-蘆洲,2023-05-18,9857
6112,邁達特,111,95,16,元大-蘆洲,2023-05-18,9857
1810,和成,17,1,16,元大-蘆洲,2023-05-18,9857
00882,中信中國高股息,21,5,16,元大-蘆洲,2023-05-18,9857
2105,正新,19,4,15,元大-蘆洲,2023-05-18,9857
00664R,國泰臺灣加權反1,15,0,15,元大-蘆洲,2023-05-18,9857
3362,先進光,45,30,15,元大-蘆洲,2023-05-18,9857
8926,台汽電,14,0,14,元大-蘆洲,2023-05-18,9857
00688L,國泰20年美債正2,14,0,14,元大-蘆洲,2023-05-18,9857
2734,易飛網,23,9,14,元大-蘆洲,2023-05-18,9857
3078,僑威,68,54,14,元大-蘆洲,2023-05-18,9857
8076,伍豐,20,6,14,元大-蘆洲,2023-05-18,9857
2495,普安,64,51,13,元大-蘆洲,2023-05-18,9857
2356,英業達,53,40,13,元大-蘆洲,2023-05-18,9857
2409,友達,14,1,13,元大-蘆洲,2023-05-18,9857
8426,紅木-KY,14,1,13,元大-蘆洲,2023-05-18,9857
4128,中天,12,0,12,元大-蘆洲,2023-05-18,9857
8069,元太,30,18,12,元大-蘆洲,2023-05-18,9857
00706L,期元大S＆P日圓正2,12,0,12,元大-蘆洲,2023-05-18,9857
00857B,永豐20年美公債,12,0,12,元大-蘆洲,2023-05-18,9857
4906,正文,12,0,12,元大-蘆洲,2023-05-18,9857
2388,威盛,27,15,12,元大-蘆洲,2023-05-18,9857
2352,佳世達,19,7,12,元大-蘆洲,2023-05-18,9857
2634,漢翔,100,89,11,元大-蘆洲,2023-05-18,9857
00795B,中信美國公債20年,11,0,11,元大-蘆洲,2023-05-18,9857
2476,鉅祥,11,0,11,元大-蘆洲,2023-05-18,9857
5234,達興材料,13,2,11,元大-蘆洲,2023-05-18,9857
1609,大亞,85,74,11,元大-蘆洲,2023-05-18,9857
2404,漢唐,10,0,10,元大-蘆洲,2023-05-18,9857
2303,聯電,310,12,298,元大-蘆洲,2023-05-19,9857
00687B,國泰20年美債,230,0,230,元大-蘆洲,2023-05-19,9857
00632R,元大台灣50反1,188,25,163,元大-蘆洲,2023-05-19,9857
5512,力麒,87,1,86,元大-蘆洲,2023-05-19,9857
00637L,元大滬深300正2,110,35,75,元大-蘆洲,2023-05-19,9857
00772B,中信高評級公司債,62,0,62,元大-蘆洲,2023-05-19,9857
2204,中華,63,3,60,元大-蘆洲,2023-05-19,9857
00902,中信電池及儲能,51,0,51,元大-蘆洲,2023-05-19,9857
6202,盛群,51,0,51,元大-蘆洲,2023-05-19,9857
8478,東哥遊艇,55,7,48,元大-蘆洲,2023-05-19,9857
1605,華新,61,15,46,元大-蘆洲,2023-05-19,9857
6804,明係,46,4,42,元大-蘆洲,2023-05-19,9857
00882,中信中國高股息,46,5,41,元大-蘆洲,2023-05-19,9857
3029,零壹,53,14,39,元大-蘆洲,2023-05-19,9857
1609,大亞,70,31,39,元大-蘆洲,2023-05-19,9857
00751B,元大AAA至A公司債,38,0,38,元大-蘆洲,2023-05-19,9857
5009,榮剛,40,7,33,元大-蘆洲,2023-05-19,9857
2897,王道銀行,32,2,30,元大-蘆洲,2023-05-19,9857
2323,中環,82,54,28,元大-蘆洲,2023-05-19,9857
00720B,元大投資級公司債,43,21,22,元大-蘆洲,2023-05-19,9857
2913,農林,45,26,19,元大-蘆洲,2023-05-19,9857
00753L,中信中國50正2,23,5,18,元大-蘆洲,2023-05-19,9857
4919,新唐,27,9,18,元大-蘆洲,2023-05-19,9857
00795B,中信美國公債20年,18,1,17,元大-蘆洲,2023-05-19,9857
2020,美亞,17,0,17,元大-蘆洲,2023-05-19,9857
2887,台新金,32,16,16,元大-蘆洲,2023-05-19,9857
4960,誠美材,16,0,16,元大-蘆洲,2023-05-19,9857
00665L,富邦�琤肭磪囓�2,30,14,16,元大-蘆洲,2023-05-19,9857
6248,沛波,15,0,15,元大-蘆洲,2023-05-19,9857
5353,台林,21,6,15,元大-蘆洲,2023-05-19,9857
1720,生達,15,0,15,元大-蘆洲,2023-05-19,9857
1608,華榮,28,13,15,元大-蘆洲,2023-05-19,9857
2603,長榮,15,0,15,元大-蘆洲,2023-05-19,9857
8048,德勝,14,0,14,元大-蘆洲,2023-05-19,9857
2881,富邦金,23,9,14,元大-蘆洲,2023-05-19,9857
4128,中天,13,0,13,元大-蘆洲,2023-05-19,9857
5498,凱崴,15,2,13,元大-蘆洲,2023-05-19,9857
3004,豐達科,15,2,13,元大-蘆洲,2023-05-19,9857
1529,樂事綠能,32,19,13,元大-蘆洲,2023-05-19,9857
00773B,中信優先金融債,13,0,13,元大-蘆洲,2023-05-19,9857
6235,華孚,54,41,13,元大-蘆洲,2023-05-19,9857
2317,鴻海,19,6,13,元大-蘆洲,2023-05-19,9857
4906,正文,15,3,12,元大-蘆洲,2023-05-19,9857
4743,合一,21,9,12,元大-蘆洲,2023-05-19,9857
2331,精英,12,0,12,元大-蘆洲,2023-05-19,9857
2365,昆盈,13,1,12,元大-蘆洲,2023-05-19,9857
1513,中興電,52,41,11,元大-蘆洲,2023-05-19,9857
1905,華紙,28,17,11,元大-蘆洲,2023-05-19,9857
2006,東和鋼鐵,11,0,11,元大-蘆洲,2023-05-19,9857
2486,一詮,12,1,11,元大-蘆洲,2023-05-19,9857
00687B,國泰20年美債,222,0,222,元大-蘆洲,2023-05-22,9857
00637L,元大滬深300正2,350,161,189,元大-蘆洲,2023-05-22,9857
2888,新光金,122,9,113,元大-蘆洲,2023-05-22,9857
2618,長榮航,284,178,106,元大-蘆洲,2023-05-22,9857
2303,聯電,80,7,73,元大-蘆洲,2023-05-22,9857
00882,中信中國高股息,68,0,68,元大-蘆洲,2023-05-22,9857
3037,欣興,79,19,60,元大-蘆洲,2023-05-22,9857
00795B,中信美國公債20年,57,0,57,元大-蘆洲,2023-05-22,9857
1605,華新,54,11,43,元大-蘆洲,2023-05-22,9857
4173,久裕,269,229,40,元大-蘆洲,2023-05-22,9857
3363,上詮,49,11,38,元大-蘆洲,2023-05-22,9857
00632R,元大台灣50反1,76,40,36,元大-蘆洲,2023-05-22,9857
8112,至上,36,1,35,元大-蘆洲,2023-05-22,9857
5009,榮剛,35,2,33,元大-蘆洲,2023-05-22,9857
1717,長興,32,0,32,元大-蘆洲,2023-05-22,9857
00680L,元大美債20正2,36,5,31,元大-蘆洲,2023-05-22,9857
2427,三商電,83,55,28,元大-蘆洲,2023-05-22,9857
00751B,元大AAA至A公司債,24,0,24,元大-蘆洲,2023-05-22,9857
00688L,國泰20年美債正2,24,0,24,元大-蘆洲,2023-05-22,9857
2722,夏都,24,0,24,元大-蘆洲,2023-05-22,9857
6770,力積電,29,5,24,元大-蘆洲,2023-05-22,9857
6698,旭暉應材,23,0,23,元大-蘆洲,2023-05-22,9857
2903,遠百,22,0,22,元大-蘆洲,2023-05-22,9857
2344,華邦電,43,21,22,元大-蘆洲,2023-05-22,9857
2511,太子,20,0,20,元大-蘆洲,2023-05-22,9857
2425,承啟,20,0,20,元大-蘆洲,2023-05-22,9857
9105,泰金寶-DR,20,0,20,元大-蘆洲,2023-05-22,9857
1340,勝悅-KY,20,1,19,元大-蘆洲,2023-05-22,9857
00720B,元大投資級公司債,19,0,19,元大-蘆洲,2023-05-22,9857
2031,新光鋼,20,2,18,元大-蘆洲,2023-05-22,9857
2412,中華電,18,0,18,元大-蘆洲,2023-05-22,9857
00772B,中信高評級公司債,17,0,17,元大-蘆洲,2023-05-22,9857
00713,元大台灣高息低波,23,6,17,元大-蘆洲,2023-05-22,9857
2313,華通,18,2,16,元大-蘆洲,2023-05-22,9857
6248,沛波,17,1,16,元大-蘆洲,2023-05-22,9857
2204,中華,17,1,16,元大-蘆洲,2023-05-22,9857
1815,富喬,15,1,14,元大-蘆洲,2023-05-22,9857
2206,三陽工業,67,53,14,元大-蘆洲,2023-05-22,9857
2352,佳世達,23,9,14,元大-蘆洲,2023-05-22,9857
1101,台泥,18,5,13,元大-蘆洲,2023-05-22,9857
00706L,期元大S＆P日圓正2,12,0,12,元大-蘆洲,2023-05-22,9857
1301,台塑,12,0,12,元大-蘆洲,2023-05-22,9857
2356,英業達,11,0,11,元大-蘆洲,2023-05-22,9857
00673R,期元大S＆P原油反1,13,2,11,元大-蘆洲,2023-05-22,9857
3081,聯亞,12,1,11,元大-蘆洲,2023-05-22,9857
8926,台汽電,12,1,11,元大-蘆洲,2023-05-22,9857
2461,光群雷,11,0,11,元大-蘆洲,2023-05-22,9857
00773B,中信優先金融債,11,0,11,元大-蘆洲,2023-05-22,9857
8046,南電,13,3,10,元大-蘆洲,2023-05-22,9857
00907,永豐優息存股,10,0,10,元大-蘆洲,2023-05-22,9857
3576,聯合再生,126,2,124,元大-蘆洲,2023-05-23,9857
2537,聯上發,110,0,110,元大-蘆洲,2023-05-23,9857
2888,新光金,92,0,92,元大-蘆洲,2023-05-23,9857
3232,昱捷,118,26,92,元大-蘆洲,2023-05-23,9857
00882,中信中國高股息,79,0,79,元大-蘆洲,2023-05-23,9857
00632R,元大台灣50反1,96,30,66,元大-蘆洲,2023-05-23,9857
00687B,國泰20年美債,61,0,61,元大-蘆洲,2023-05-23,9857
2303,聯電,61,7,54,元大-蘆洲,2023-05-23,9857
2314,台揚,56,3,53,元大-蘆洲,2023-05-23,9857
00688L,國泰20年美債正2,52,0,52,元大-蘆洲,2023-05-23,9857
00637L,元大滬深300正2,48,0,48,元大-蘆洲,2023-05-23,9857
2603,長榮,50,3,47,元大-蘆洲,2023-05-23,9857
2618,長榮航,199,155,44,元大-蘆洲,2023-05-23,9857
2634,漢翔,59,24,35,元大-蘆洲,2023-05-23,9857
1319,東陽,43,11,32,元大-蘆洲,2023-05-23,9857
00751B,元大AAA至A公司債,30,1,29,元大-蘆洲,2023-05-23,9857
6689,伊雲谷,32,5,27,元大-蘆洲,2023-05-23,9857
5483,中美晶,28,1,27,元大-蘆洲,2023-05-23,9857
2913,農林,52,25,27,元大-蘆洲,2023-05-23,9857
00795B,中信美國公債20年,27,0,27,元大-蘆洲,2023-05-23,9857
6874,倍力,24,0,24,元大-蘆洲,2023-05-23,9857
3704,合勤控,25,2,23,元大-蘆洲,2023-05-23,9857
2313,華通,35,12,23,元大-蘆洲,2023-05-23,9857
00772B,中信高評級公司債,22,0,22,元大-蘆洲,2023-05-23,9857
3479,安勤,22,1,21,元大-蘆洲,2023-05-23,9857
3481,群創,286,265,21,元大-蘆洲,2023-05-23,9857
1337,再生-KY,20,0,20,元大-蘆洲,2023-05-23,9857
4967,十銓,23,4,19,元大-蘆洲,2023-05-23,9857
8261,富鼎,18,0,18,元大-蘆洲,2023-05-23,9857
2208,台船,26,9,17,元大-蘆洲,2023-05-23,9857
0056,元大高股息,36,19,17,元大-蘆洲,2023-05-23,9857
00680L,元大美債20正2,33,17,16,元大-蘆洲,2023-05-23,9857
6804,明係,16,0,16,元大-蘆洲,2023-05-23,9857
6104,創惟,15,0,15,元大-蘆洲,2023-05-23,9857
3339,泰谷,15,0,15,元大-蘆洲,2023-05-23,9857
8358,金居,16,1,15,元大-蘆洲,2023-05-23,9857
6806,森崴能源,23,8,15,元大-蘆洲,2023-05-23,9857
2897,王道銀行,30,15,15,元大-蘆洲,2023-05-23,9857
1514,亞力,35,21,14,元大-蘆洲,2023-05-23,9857
2371,大同,23,10,13,元大-蘆洲,2023-05-23,9857
1734,杏輝,13,0,13,元大-蘆洲,2023-05-23,9857
00706L,期元大S＆P日圓正2,13,0,13,元大-蘆洲,2023-05-23,9857
2739,寒舍,16,3,13,元大-蘆洲,2023-05-23,9857
1609,大亞,43,30,13,元大-蘆洲,2023-05-23,9857
2317,鴻海,16,4,12,元大-蘆洲,2023-05-23,9857
3454,晶睿,13,1,12,元大-蘆洲,2023-05-23,9857
4911,德英,12,0,12,元大-蘆洲,2023-05-23,9857
9103,美德醫療-DR,12,0,12,元大-蘆洲,2023-05-23,9857
00679B,元大美債20年,27,15,12,元大-蘆洲,2023-05-23,9857
00725B,國泰投資級公司債,11,0,11,元大-蘆洲,2023-05-23,9857
00878,國泰永續高股息,209,14,195,元大-蘆洲,2023-05-24,9857
00882,中信中國高股息,170,1,169,元大-蘆洲,2023-05-24,9857
3041,揚智,120,2,118,元大-蘆洲,2023-05-24,9857
2605,新興,101,1,100,元大-蘆洲,2023-05-24,9857
00637L,元大滬深300正2,112,13,99,元大-蘆洲,2023-05-24,9857
00679B,元大美債20年,100,22,78,元大-蘆洲,2023-05-24,9857
00632R,元大台灣50反1,82,12,70,元大-蘆洲,2023-05-24,9857
2867,三商壽,63,2,61,元大-蘆洲,2023-05-24,9857
00900,富邦特選高股息30,51,5,46,元大-蘆洲,2023-05-24,9857
2888,新光金,66,26,40,元大-蘆洲,2023-05-24,9857
2337,旺宏,51,11,40,元大-蘆洲,2023-05-24,9857
00665L,富邦�琤肭磪囓�2,60,22,38,元大-蘆洲,2023-05-24,9857
2880,華南金,39,2,37,元大-蘆洲,2023-05-24,9857
00680L,元大美債20正2,36,0,36,元大-蘆洲,2023-05-24,9857
3289,宜特,37,2,35,元大-蘆洲,2023-05-24,9857
00687B,國泰20年美債,34,0,34,元大-蘆洲,2023-05-24,9857
4121,優盛,31,0,31,元大-蘆洲,2023-05-24,9857
2897,王道銀行,30,0,30,元大-蘆洲,2023-05-24,9857
1444,力麗,30,0,30,元大-蘆洲,2023-05-24,9857
2913,農林,40,10,30,元大-蘆洲,2023-05-24,9857
1459,聯發,29,0,29,元大-蘆洲,2023-05-24,9857
1529,樂事綠能,41,13,28,元大-蘆洲,2023-05-24,9857
3207,耀勝,30,4,26,元大-蘆洲,2023-05-24,9857
3704,合勤控,32,7,25,元大-蘆洲,2023-05-24,9857
2537,聯上發,54,29,25,元大-蘆洲,2023-05-24,9857
5222,全訊,35,11,24,元大-蘆洲,2023-05-24,9857
9919,康那香,25,1,24,元大-蘆洲,2023-05-24,9857
2419,仲琦,21,0,21,元大-蘆洲,2023-05-24,9857
00795B,中信美國公債20年,21,0,21,元大-蘆洲,2023-05-24,9857
2409,友達,33,13,20,元大-蘆洲,2023-05-24,9857
2399,映泰,47,27,20,元大-蘆洲,2023-05-24,9857
3202,樺晟,20,0,20,元大-蘆洲,2023-05-24,9857
2108,南帝,20,0,20,元大-蘆洲,2023-05-24,9857
6104,創惟,19,0,19,元大-蘆洲,2023-05-24,9857
6248,沛波,20,1,19,元大-蘆洲,2023-05-24,9857
6282,康舒,58,39,19,元大-蘆洲,2023-05-24,9857
3702,大聯大,20,2,18,元大-蘆洲,2023-05-24,9857
5531,鄉林,26,8,18,元大-蘆洲,2023-05-24,9857
2722,夏都,40,23,17,元大-蘆洲,2023-05-24,9857
2705,六福,29,13,16,元大-蘆洲,2023-05-24,9857
00712,復華富時不動產,21,5,16,元大-蘆洲,2023-05-24,9857
2890,永豐金,17,1,16,元大-蘆洲,2023-05-24,9857
3701,大眾控,24,8,16,元大-蘆洲,2023-05-24,9857
1616,億泰,15,0,15,元大-蘆洲,2023-05-24,9857
1103,嘉泥,15,0,15,元大-蘆洲,2023-05-24,9857
3037,欣興,50,35,15,元大-蘆洲,2023-05-24,9857
1460,宏遠,15,1,14,元大-蘆洲,2023-05-24,9857
2739,寒舍,19,6,13,元大-蘆洲,2023-05-24,9857
6290,良維,13,0,13,元大-蘆洲,2023-05-24,9857
3035,智原,16,3,13,元大-蘆洲,2023-05-24,9857
00688L,國泰20年美債正2,360,0,360,元大-蘆洲,2023-05-25,9857
00687B,國泰20年美債,339,0,339,元大-蘆洲,2023-05-25,9857
00637L,元大滬深300正2,390,103,287,元大-蘆洲,2023-05-25,9857
00680L,元大美債20正2,217,7,210,元大-蘆洲,2023-05-25,9857
00882,中信中國高股息,200,8,192,元大-蘆洲,2023-05-25,9857
00712,復華富時不動產,107,0,107,元大-蘆洲,2023-05-25,9857
2402,毅嘉,111,18,93,元大-蘆洲,2023-05-25,9857
2883,凱基金,78,2,76,元大-蘆洲,2023-05-25,9857
2382,廣達,82,21,61,元大-蘆洲,2023-05-25,9857
00650L,復華香港正2,60,0,60,元大-蘆洲,2023-05-25,9857
6202,盛群,52,0,52,元大-蘆洲,2023-05-25,9857
6245,立端,55,4,51,元大-蘆洲,2023-05-25,9857
8093,保銳,45,0,45,元大-蘆洲,2023-05-25,9857
2887,台新金,48,8,40,元大-蘆洲,2023-05-25,9857
2892,第一金,38,1,37,元大-蘆洲,2023-05-25,9857
2359,所羅門,40,4,36,元大-蘆洲,2023-05-25,9857
2457,飛宏,66,31,35,元大-蘆洲,2023-05-25,9857
2890,永豐金,37,2,35,元大-蘆洲,2023-05-25,9857
3189,景碩,56,22,34,元大-蘆洲,2023-05-25,9857
3027,盛達,33,1,32,元大-蘆洲,2023-05-25,9857
1605,華新,30,1,29,元大-蘆洲,2023-05-25,9857
3017,奇鋐,64,35,29,元大-蘆洲,2023-05-25,9857
00923,群益台ESG低碳50,30,3,27,元大-蘆洲,2023-05-25,9857
2022,聚亨,27,0,27,元大-蘆洲,2023-05-25,9857
2880,華南金,24,0,24,元大-蘆洲,2023-05-25,9857
2881,富邦金,26,2,24,元大-蘆洲,2023-05-25,9857
1504,東元,47,24,23,元大-蘆洲,2023-05-25,9857
2349,錸德,25,3,22,元大-蘆洲,2023-05-25,9857
5258,虹堡,22,1,21,元大-蘆洲,2023-05-25,9857
2303,聯電,27,6,21,元大-蘆洲,2023-05-25,9857
2630,亞航,72,51,21,元大-蘆洲,2023-05-25,9857
2885,元大金,22,1,21,元大-蘆洲,2023-05-25,9857
6282,康舒,40,20,20,元大-蘆洲,2023-05-25,9857
9958,世紀鋼,20,0,20,元大-蘆洲,2023-05-25,9857
3048,益登,20,0,20,元大-蘆洲,2023-05-25,9857
2317,鴻海,23,3,20,元大-蘆洲,2023-05-25,9857
00907,永豐優息存股,20,0,20,元大-蘆洲,2023-05-25,9857
2498,宏達電,25,6,19,元大-蘆洲,2023-05-25,9857
4960,誠美材,19,0,19,元大-蘆洲,2023-05-25,9857
2882,國泰金,18,0,18,元大-蘆洲,2023-05-25,9857
2548,華固,20,2,18,元大-蘆洲,2023-05-25,9857
3207,耀勝,19,2,17,元大-蘆洲,2023-05-25,9857
1310,台苯,19,2,17,元大-蘆洲,2023-05-25,9857
1514,亞力,23,7,16,元大-蘆洲,2023-05-25,9857
00753L,中信中國50正2,18,2,16,元大-蘆洲,2023-05-25,9857
1101,台泥,32,16,16,元大-蘆洲,2023-05-25,9857
00751B,元大AAA至A公司債,21,5,16,元大-蘆洲,2023-05-25,9857
00720B,元大投資級公司債,18,3,15,元大-蘆洲,2023-05-25,9857
00795B,中信美國公債20年,15,0,15,元大-蘆洲,2023-05-25,9857
1432,大魯閣,15,0,15,元大-蘆洲,2023-05-25,9857
00637L,元大滬深300正2,166,0,166,元大-蘆洲,2023-05-26,9857
00712,復華富時不動產,128,20,108,元大-蘆洲,2023-05-26,9857
6285,啟��,109,15,94,元大-蘆洲,2023-05-26,9857
8028,昇陽半導體,99,11,88,元大-蘆洲,2023-05-26,9857
4915,致伸,209,125,84,元大-蘆洲,2023-05-26,9857
2323,中環,202,138,64,元大-蘆洲,2023-05-26,9857
2618,長榮航,369,311,58,元大-蘆洲,2023-05-26,9857
2637,慧洋-KY,64,7,57,元大-蘆洲,2023-05-26,9857
2324,仁寶,90,41,49,元大-蘆洲,2023-05-26,9857
00632R,元大台灣50反1,373,327,46,元大-蘆洲,2023-05-26,9857
2888,新光金,52,7,45,元大-蘆洲,2023-05-26,9857
00882,中信中國高股息,42,0,42,元大-蘆洲,2023-05-26,9857
00715L,期街口布蘭特正2,44,3,41,元大-蘆洲,2023-05-26,9857
6443,元晶,42,5,37,元大-蘆洲,2023-05-26,9857
2359,所羅門,40,3,37,元大-蘆洲,2023-05-26,9857
2883,凱基金,53,18,35,元大-蘆洲,2023-05-26,9857
2002,中鋼,45,10,35,元大-蘆洲,2023-05-26,9857
2890,永豐金,52,18,34,元大-蘆洲,2023-05-26,9857
2409,友達,43,11,32,元大-蘆洲,2023-05-26,9857
3231,緯創,277,244,33,元大-蘆洲,2023-05-26,9857
00680L,元大美債20正2,32,2,30,元大-蘆洲,2023-05-26,9857
1905,華紙,44,16,28,元大-蘆洲,2023-05-26,9857
2007,燁興,27,1,26,元大-蘆洲,2023-05-26,9857
3289,宜特,35,9,26,元大-蘆洲,2023-05-26,9857
00683L,期元大美元指正2,25,0,25,元大-蘆洲,2023-05-26,9857
3078,僑威,27,2,25,元大-蘆洲,2023-05-26,9857
1605,華新,42,19,23,元大-蘆洲,2023-05-26,9857
2208,台船,24,2,22,元大-蘆洲,2023-05-26,9857
1218,泰山,21,0,21,元大-蘆洲,2023-05-26,9857
3710,連展投控,21,0,21,元大-蘆洲,2023-05-26,9857
00664R,國泰臺灣加權反1,21,0,21,元大-蘆洲,2023-05-26,9857
2376,技嘉,40,19,21,元大-蘆洲,2023-05-26,9857
3207,耀勝,25,5,20,元大-蘆洲,2023-05-26,9857
2705,六福,20,0,20,元大-蘆洲,2023-05-26,9857
2340,台亞,50,30,20,元大-蘆洲,2023-05-26,9857
00902,中信電池及儲能,19,0,19,元大-蘆洲,2023-05-26,9857
2367,燿華,20,1,19,元大-蘆洲,2023-05-26,9857
00633L,富邦上証正2,18,0,18,元大-蘆洲,2023-05-26,9857
6531,愛普*,25,7,18,元大-蘆洲,2023-05-26,9857
5301,寶得利,55,38,17,元大-蘆洲,2023-05-26,9857
3694,海華,18,1,17,元大-蘆洲,2023-05-26,9857
2515,中工,23,7,16,元大-蘆洲,2023-05-26,9857
2059,川湖,16,0,16,元大-蘆洲,2023-05-26,9857
2495,普安,16,0,16,元大-蘆洲,2023-05-26,9857
4306,炎洲,16,0,16,元大-蘆洲,2023-05-26,9857
2328,廣宇,16,0,16,元大-蘆洲,2023-05-26,9857
2427,三商電,15,0,15,元大-蘆洲,2023-05-26,9857
2332,友訊,16,1,15,元大-蘆洲,2023-05-26,9857
2331,精英,20,5,15,元大-蘆洲,2023-05-26,9857
6194,育富,15,0,15,元大-蘆洲,2023-05-26,9857
2002,中鋼,323,0,323,元大-蘆洲,2023-05-29,9857
00882,中信中國高股息,110,8,102,元大-蘆洲,2023-05-29,9857
00637L,元大滬深300正2,101,20,81,元大-蘆洲,2023-05-29,9857
2883,凱基金,83,6,77,元大-蘆洲,2023-05-29,9857
2482,連宇,64,3,61,元大-蘆洲,2023-05-29,9857
6443,元晶,77,20,57,元大-蘆洲,2023-05-29,9857
00679B,元大美債20年,78,23,55,元大-蘆洲,2023-05-29,9857
2409,友達,76,22,54,元大-蘆洲,2023-05-29,9857
3625,西勝,50,0,50,元大-蘆洲,2023-05-29,9857
6202,盛群,50,0,50,元大-蘆洲,2023-05-29,9857
3078,僑威,94,47,47,元大-蘆洲,2023-05-29,9857
3037,欣興,81,41,40,元大-蘆洲,2023-05-29,9857
00712,復華富時不動產,42,9,33,元大-蘆洲,2023-05-29,9857
5328,華容,57,26,31,元大-蘆洲,2023-05-29,9857
2887,台新金,31,1,30,元大-蘆洲,2023-05-29,9857
00673R,期元大S＆P原油反1,30,0,30,元大-蘆洲,2023-05-29,9857
2353,宏��,43,14,29,元大-蘆洲,2023-05-29,9857
00751B,元大AAA至A公司債,26,0,26,元大-蘆洲,2023-05-29,9857
2340,台亞,25,0,25,元大-蘆洲,2023-05-29,9857
00683L,期元大美元指正2,25,0,25,元大-蘆洲,2023-05-29,9857
6190,萬泰科,28,4,24,元大-蘆洲,2023-05-29,9857
2399,映泰,30,6,24,元大-蘆洲,2023-05-29,9857
2888,新光金,31,8,23,元大-蘆洲,2023-05-29,9857
00687B,國泰20年美債,23,0,23,元大-蘆洲,2023-05-29,9857
3711,日月光投控,31,11,20,元大-蘆洲,2023-05-29,9857
9944,新麗,21,1,20,元大-蘆洲,2023-05-29,9857
1609,大亞,25,6,19,元大-蘆洲,2023-05-29,9857
2634,漢翔,27,10,17,元大-蘆洲,2023-05-29,9857
2915,潤泰全,17,0,17,元大-蘆洲,2023-05-29,9857
1326,台化,15,0,15,元大-蘆洲,2023-05-29,9857
2851,中再保,15,0,15,元大-蘆洲,2023-05-29,9857
2897,王道銀行,15,0,15,元大-蘆洲,2023-05-29,9857
3265,台星科,31,16,15,元大-蘆洲,2023-05-29,9857
00795B,中信美國公債20年,14,0,14,元大-蘆洲,2023-05-29,9857
6217,中探針,14,0,14,元大-蘆洲,2023-05-29,9857
2636,台驊控股,13,0,13,元大-蘆洲,2023-05-29,9857
2630,亞航,28,15,13,元大-蘆洲,2023-05-29,9857
8150,南茂,74,62,12,元大-蘆洲,2023-05-29,9857
6603,富強鑫,15,3,12,元大-蘆洲,2023-05-29,9857
3189,景碩,28,17,11,元大-蘆洲,2023-05-29,9857
1101,台泥,24,12,12,元大-蘆洲,2023-05-29,9857
00713,元大台灣高息低波,29,18,11,元大-蘆洲,2023-05-29,9857
4934,太極,11,0,11,元大-蘆洲,2023-05-29,9857
2376,技嘉,20,9,11,元大-蘆洲,2023-05-29,9857
2356,英業達,16,5,11,元大-蘆洲,2023-05-29,9857
2421,建準,48,38,10,元大-蘆洲,2023-05-29,9857
1218,泰山,19,9,10,元大-蘆洲,2023-05-29,9857
4904,遠傳,12,2,10,元大-蘆洲,2023-05-29,9857
4108,懷特,10,0,10,元大-蘆洲,2023-05-29,9857
3325,旭品,11,1,10,元大-蘆洲,2023-05-29,9857
2206,三陽工業,179,15,164,元大-蘆洲,2023-05-30,9857
00882,中信中國高股息,129,0,129,元大-蘆洲,2023-05-30,9857
2882,國泰金,125,0,125,元大-蘆洲,2023-05-30,9857
8011,台通,88,13,75,元大-蘆洲,2023-05-30,9857
2883,凱基金,74,4,70,元大-蘆洲,2023-05-30,9857
5386,青雲,60,5,55,元大-蘆洲,2023-05-30,9857
5328,華容,61,10,51,元大-蘆洲,2023-05-30,9857
2884,玉山金,63,17,46,元大-蘆洲,2023-05-30,9857
2002,中鋼,53,7,46,元大-蘆洲,2023-05-30,9857
2382,廣達,63,20,43,元大-蘆洲,2023-05-30,9857
00712,復華富時不動產,41,0,41,元大-蘆洲,2023-05-30,9857
00637L,元大滬深300正2,78,40,38,元大-蘆洲,2023-05-30,9857
2356,英業達,87,57,30,元大-蘆洲,2023-05-30,9857
3576,聯合再生,30,0,30,元大-蘆洲,2023-05-30,9857
5498,凱崴,30,3,27,元大-蘆洲,2023-05-30,9857
4543,萬在,27,0,27,元大-蘆洲,2023-05-30,9857
2481,強茂,27,1,26,元大-蘆洲,2023-05-30,9857
3363,上詮,92,66,26,元大-蘆洲,2023-05-30,9857
1504,東元,34,9,25,元大-蘆洲,2023-05-30,9857
00648R,元大S＆P500反1,25,0,25,元大-蘆洲,2023-05-30,9857
4564,元翎,45,21,24,元大-蘆洲,2023-05-30,9857
6244,茂迪,23,0,23,元大-蘆洲,2023-05-30,9857
6799,來頡,24,1,23,元大-蘆洲,2023-05-30,9857
00751B,元大AAA至A公司債,22,0,22,元大-蘆洲,2023-05-30,9857
00725B,國泰投資級公司債,21,0,21,元大-蘆洲,2023-05-30,9857
2609,陽明,23,2,21,元大-蘆洲,2023-05-30,9857
2537,聯上發,20,0,20,元大-蘆洲,2023-05-30,9857
4977,眾達-KY,25,5,20,元大-蘆洲,2023-05-30,9857
6203,海韻電,25,5,20,元大-蘆洲,2023-05-30,9857
4744,皇將,23,4,19,元大-蘆洲,2023-05-30,9857
3231,緯創,191,172,19,元大-蘆洲,2023-05-30,9857
2890,永豐金,19,2,17,元大-蘆洲,2023-05-30,9857
00715L,期街口布蘭特正2,17,0,17,元大-蘆洲,2023-05-30,9857
6182,合晶,17,0,17,元大-蘆洲,2023-05-30,9857
2727,王品,22,6,16,元大-蘆洲,2023-05-30,9857
2331,精英,24,8,16,元大-蘆洲,2023-05-30,9857
00706L,期元大S＆P日圓正2,16,0,16,元大-蘆洲,2023-05-30,9857
2809,京城銀,16,0,16,元大-蘆洲,2023-05-30,9857
6188,廣明,24,8,16,元大-蘆洲,2023-05-30,9857
1524,耿鼎,36,21,15,元大-蘆洲,2023-05-30,9857
00680L,元大美債20正2,15,0,15,元大-蘆洲,2023-05-30,9857
1108,幸福,15,0,15,元大-蘆洲,2023-05-30,9857
1905,華紙,21,6,15,元大-蘆洲,2023-05-30,9857
3481,群創,33,19,14,元大-蘆洲,2023-05-30,9857
4766,南寶,15,1,14,元大-蘆洲,2023-05-30,9857
3037,欣興,30,16,14,元大-蘆洲,2023-05-30,9857
2637,慧洋-KY,14,1,13,元大-蘆洲,2023-05-30,9857
00753L,中信中國50正2,13,0,13,元大-蘆洲,2023-05-30,9857
6276,安鈦克,13,0,13,元大-蘆洲,2023-05-30,9857
3163,波若威,14,1,13,元大-蘆洲,2023-05-30,9857
00882,中信中國高股息,127,0,127,元大-蘆洲,2023-05-31,9857
00715L,期街口布蘭特正2,103,0,103,元大-蘆洲,2023-05-31,9857
00687B,國泰20年美債,71,1,70,元大-蘆洲,2023-05-31,9857
00878,國泰永續高股息,78,12,66,元大-蘆洲,2023-05-31,9857
2382,廣達,92,31,61,元大-蘆洲,2023-05-31,9857
00688L,國泰20年美債正2,55,0,55,元大-蘆洲,2023-05-31,9857
1513,中興電,80,29,51,元大-蘆洲,2023-05-31,9857
00642U,期元大S＆P石油,49,0,49,元大-蘆洲,2023-05-31,9857
2371,大同,93,54,39,元大-蘆洲,2023-05-31,9857
3006,晶豪科,68,29,39,元大-蘆洲,2023-05-31,9857
2002,中鋼,37,1,36,元大-蘆洲,2023-05-31,9857
6233,旺玖,42,6,36,元大-蘆洲,2023-05-31,9857
4564,元翎,73,38,35,元大-蘆洲,2023-05-31,9857
2887,台新金,36,2,34,元大-蘆洲,2023-05-31,9857
2356,英業達,107,77,30,元大-蘆洲,2023-05-31,9857
6282,康舒,77,47,30,元大-蘆洲,2023-05-31,9857
3037,欣興,39,10,29,元大-蘆洲,2023-05-31,9857
2609,陽明,31,2,29,元大-蘆洲,2023-05-31,9857
2801,彰銀,30,2,28,元大-蘆洲,2023-05-31,9857
00650L,復華香港正2,52,24,28,元大-蘆洲,2023-05-31,9857
3042,晶技,33,5,28,元大-蘆洲,2023-05-31,9857
3011,今皓,27,0,27,元大-蘆洲,2023-05-31,9857
2317,鴻海,38,12,26,元大-蘆洲,2023-05-31,9857
2368,金像電,62,37,25,元大-蘆洲,2023-05-31,9857
2352,佳世達,41,16,25,元大-蘆洲,2023-05-31,9857
3025,星通,40,16,24,元大-蘆洲,2023-05-31,9857
00772B,中信高評級公司債,23,0,23,元大-蘆洲,2023-05-31,9857
4967,十銓,64,41,23,元大-蘆洲,2023-05-31,9857
6570,維田,23,0,23,元大-蘆洲,2023-05-31,9857
1101,台泥,28,6,22,元大-蘆洲,2023-05-31,9857
2736,富野,39,17,22,元大-蘆洲,2023-05-31,9857
2017,官田鋼,24,4,20,元大-蘆洲,2023-05-31,9857
5328,華容,28,8,20,元大-蘆洲,2023-05-31,9857
2880,華南金,22,2,20,元大-蘆洲,2023-05-31,9857
2337,旺宏,27,7,20,元大-蘆洲,2023-05-31,9857
00795B,中信美國公債20年,22,2,20,元大-蘆洲,2023-05-31,9857
3033,威健,29,10,19,元大-蘆洲,2023-05-31,9857
4908,前鼎,18,0,18,元大-蘆洲,2023-05-31,9857
4968,立積,33,16,17,元大-蘆洲,2023-05-31,9857
3363,上詮,20,3,17,元大-蘆洲,2023-05-31,9857
00725B,國泰投資級公司債,17,1,16,元大-蘆洲,2023-05-31,9857
00637L,元大滬深300正2,52,36,16,元大-蘆洲,2023-05-31,9857
2504,國產,16,0,16,元大-蘆洲,2023-05-31,9857
2201,裕隆,30,15,15,元大-蘆洲,2023-05-31,9857
8936,國統,18,3,15,元大-蘆洲,2023-05-31,9857
2330,台積電,24,10,14,元大-蘆洲,2023-05-31,9857
8076,伍豐,15,1,14,元大-蘆洲,2023-05-31,9857
5353,台林,13,0,13,元大-蘆洲,2023-05-31,9857
8040,九暘,17,4,13,元大-蘆洲,2023-05-31,9857
1218,泰山,14,1,13,元大-蘆洲,2023-05-31,9857
2331,精英,171,10,161,元大-蘆洲,2023-06-01,9857
00715L,期街口布蘭特正2,138,2,136,元大-蘆洲,2023-06-01,9857
2201,裕隆,147,50,97,元大-蘆洲,2023-06-01,9857
2323,中環,142,56,86,元大-蘆洲,2023-06-01,9857
2371,大同,88,15,73,元大-蘆洲,2023-06-01,9857
2515,中工,235,167,68,元大-蘆洲,2023-06-01,9857
3706,神達,115,50,65,元大-蘆洲,2023-06-01,9857
00878,國泰永續高股息,212,149,63,元大-蘆洲,2023-06-01,9857
2888,新光金,67,10,57,元大-蘆洲,2023-06-01,9857
00688L,國泰20年美債正2,65,15,50,元大-蘆洲,2023-06-01,9857
1605,華新,56,8,48,元大-蘆洲,2023-06-01,9857
00642U,期元大S＆P石油,44,0,44,元大-蘆洲,2023-06-01,9857
2705,六福,42,0,42,元大-蘆洲,2023-06-01,9857
2356,英業達,50,11,39,元大-蘆洲,2023-06-01,9857
0056,元大高股息,98,61,37,元大-蘆洲,2023-06-01,9857
2601,益航,35,0,35,元大-蘆洲,2023-06-01,9857
3013,晟銘電,70,36,34,元大-蘆洲,2023-06-01,9857
2340,台亞,35,1,34,元大-蘆洲,2023-06-01,9857
1101,台泥,31,0,31,元大-蘆洲,2023-06-01,9857
1589,永冠-KY,32,1,31,元大-蘆洲,2023-06-01,9857
4906,正文,30,0,30,元大-蘆洲,2023-06-01,9857
2913,農林,184,154,30,元大-蘆洲,2023-06-01,9857
2329,華泰,29,0,29,元大-蘆洲,2023-06-01,9857
3704,合勤控,32,4,28,元大-蘆洲,2023-06-01,9857
5498,凱崴,34,7,27,元大-蘆洲,2023-06-01,9857
6122,擎邦,36,10,26,元大-蘆洲,2023-06-01,9857
2615,萬海,30,4,26,元大-蘆洲,2023-06-01,9857
2344,華邦電,29,4,25,元大-蘆洲,2023-06-01,9857
1608,華榮,26,3,23,元大-蘆洲,2023-06-01,9857
2890,永豐金,23,0,23,元大-蘆洲,2023-06-01,9857
3189,景碩,24,1,23,元大-蘆洲,2023-06-01,9857
00751B,元大AAA至A公司債,23,0,23,元大-蘆洲,2023-06-01,9857
2883,凱基金,25,2,23,元大-蘆洲,2023-06-01,9857
6112,邁達特,25,4,21,元大-蘆洲,2023-06-01,9857
00665L,富邦�琤肭磪囓�2,31,10,21,元大-蘆洲,2023-06-01,9857
2489,瑞軒,45,24,21,元大-蘆洲,2023-06-01,9857
5706,鳳凰,66,46,20,元大-蘆洲,2023-06-01,9857
6125,廣運,25,5,20,元大-蘆洲,2023-06-01,9857
3260,威剛,34,15,19,元大-蘆洲,2023-06-01,9857
3059,華晶科,31,12,19,元大-蘆洲,2023-06-01,9857
2408,南亞科,25,6,19,元大-蘆洲,2023-06-01,9857
6229,研通,20,2,18,元大-蘆洲,2023-06-01,9857
2892,第一金,20,2,18,元大-蘆洲,2023-06-01,9857
8048,德勝,19,2,17,元大-蘆洲,2023-06-01,9857
2332,友訊,18,2,16,元大-蘆洲,2023-06-01,9857
5258,虹堡,22,6,16,元大-蘆洲,2023-06-01,9857
6517,保勝光學,15,0,15,元大-蘆洲,2023-06-01,9857
2630,亞航,58,43,15,元大-蘆洲,2023-06-01,9857
2897,王道銀行,15,0,15,元大-蘆洲,2023-06-01,9857
6188,廣明,75,60,15,元大-蘆洲,2023-06-01,9857
2409,友達,606,11,595,元大-蘆洲,2023-06-02,9857
2489,瑞軒,613,94,519,元大-蘆洲,2023-06-02,9857
1905,華紙,277,144,133,元大-蘆洲,2023-06-02,9857
2371,大同,133,40,93,元大-蘆洲,2023-06-02,9857
2610,華航,222,139,83,元大-蘆洲,2023-06-02,9857
2880,華南金,76,0,76,元大-蘆洲,2023-06-02,9857
00706L,期元大S＆P日圓正2,74,0,74,元大-蘆洲,2023-06-02,9857
2340,台亞,60,0,60,元大-蘆洲,2023-06-02,9857
3576,聯合再生,51,1,50,元大-蘆洲,2023-06-02,9857
6770,力積電,57,11,46,元大-蘆洲,2023-06-02,9857
6205,詮欣,44,0,44,元大-蘆洲,2023-06-02,9857
3673,TPK-KY,50,7,43,元大-蘆洲,2023-06-02,9857
2382,廣達,104,62,42,元大-蘆洲,2023-06-02,9857
2609,陽明,49,9,40,元大-蘆洲,2023-06-02,9857
2888,新光金,43,3,40,元大-蘆洲,2023-06-02,9857
00679B,元大美債20年,38,0,38,元大-蘆洲,2023-06-02,9857
4906,正文,31,0,31,元大-蘆洲,2023-06-02,9857
2236,百達-KY,32,2,30,元大-蘆洲,2023-06-02,9857
3305,昇貿,33,7,26,元大-蘆洲,2023-06-02,9857
1608,華榮,81,55,26,元大-蘆洲,2023-06-02,9857
00919,群益台灣精選高息,25,1,24,元大-蘆洲,2023-06-02,9857
8210,勤誠,25,1,24,元大-蘆洲,2023-06-02,9857
4543,萬在,33,10,23,元大-蘆洲,2023-06-02,9857
4979,華星光,172,150,22,元大-蘆洲,2023-06-02,9857
2402,毅嘉,31,9,22,元大-蘆洲,2023-06-02,9857
2637,慧洋-KY,21,0,21,元大-蘆洲,2023-06-02,9857
00902,中信電池及儲能,21,0,21,元大-蘆洲,2023-06-02,9857
3694,海華,21,0,21,元大-蘆洲,2023-06-02,9857
3207,耀勝,25,4,21,元大-蘆洲,2023-06-02,9857
8403,盛弘,20,0,20,元大-蘆洲,2023-06-02,9857
8905,裕國,20,0,20,元大-蘆洲,2023-06-02,9857
2542,興富發,20,0,20,元大-蘆洲,2023-06-02,9857
2603,長榮,50,31,19,元大-蘆洲,2023-06-02,9857
1904,正隆,30,13,17,元大-蘆洲,2023-06-02,9857
3062,建漢,17,0,17,元大-蘆洲,2023-06-02,9857
2329,華泰,22,5,17,元大-蘆洲,2023-06-02,9857
1612,宏泰,17,0,17,元大-蘆洲,2023-06-02,9857
2498,宏達電,29,13,16,元大-蘆洲,2023-06-02,9857
3025,星通,22,6,16,元大-蘆洲,2023-06-02,9857
2887,台新金,37,21,16,元大-蘆洲,2023-06-02,9857
3363,上詮,55,40,15,元大-蘆洲,2023-06-02,9857
8059,凱碩,16,1,15,元大-蘆洲,2023-06-02,9857
4130,健亞,15,0,15,元大-蘆洲,2023-06-02,9857
00926,凱基全球菁英55,14,0,14,元大-蘆洲,2023-06-02,9857
2889,國票金,14,0,14,元大-蘆洲,2023-06-02,9857
912000,晨訊科-DR,14,0,14,元大-蘆洲,2023-06-02,9857
3003,健和興,16,2,14,元大-蘆洲,2023-06-02,9857
1504,東元,86,73,13,元大-蘆洲,2023-06-02,9857
6185,幃翔,14,1,13,元大-蘆洲,2023-06-02,9857
3017,奇鋐,39,26,13,元大-蘆洲,2023-06-02,9857
2834,臺企銀,300,14,286,元大-蘆洲,2023-06-05,9857
1605,華新,208,95,113,元大-蘆洲,2023-06-05,9857
00687B,國泰20年美債,92,0,92,元大-蘆洲,2023-06-05,9857
912000,晨訊科-DR,90,0,90,元大-蘆洲,2023-06-05,9857
00679B,元大美債20年,94,11,83,元大-蘆洲,2023-06-05,9857
00712,復華富時不動產,103,27,76,元大-蘆洲,2023-06-05,9857
00882,中信中國高股息,76,5,71,元大-蘆洲,2023-06-05,9857
1806,冠軍,61,2,59,元大-蘆洲,2023-06-05,9857
1519,華城,92,40,52,元大-蘆洲,2023-06-05,9857
2603,長榮,86,39,47,元大-蘆洲,2023-06-05,9857
1802,台玻,50,5,45,元大-蘆洲,2023-06-05,9857
2887,台新金,43,1,42,元大-蘆洲,2023-06-05,9857
1611,中電,44,2,42,元大-蘆洲,2023-06-05,9857
00878,國泰永續高股息,71,30,41,元大-蘆洲,2023-06-05,9857
3583,辛耘,42,4,38,元大-蘆洲,2023-06-05,9857
2610,華航,94,57,37,元大-蘆洲,2023-06-05,9857
6456,GIS-KY,42,5,37,元大-蘆洲,2023-06-05,9857
2634,漢翔,53,18,35,元大-蘆洲,2023-06-05,9857
2419,仲琦,35,1,34,元大-蘆洲,2023-06-05,9857
8059,凱碩,37,5,32,元大-蘆洲,2023-06-05,9857
1612,宏泰,41,11,30,元大-蘆洲,2023-06-05,9857
6282,康舒,82,52,30,元大-蘆洲,2023-06-05,9857
4908,前鼎,31,1,30,元大-蘆洲,2023-06-05,9857
6005,群益證,30,1,29,元大-蘆洲,2023-06-05,9857
2353,宏��,88,60,28,元大-蘆洲,2023-06-05,9857
1616,億泰,32,4,28,元大-蘆洲,2023-06-05,9857
2014,中鴻,49,23,26,元大-蘆洲,2023-06-05,9857
1529,樂事綠能,141,115,26,元大-蘆洲,2023-06-05,9857
8222,寶一,45,19,26,元大-蘆洲,2023-06-05,9857
1528,恩德,26,1,25,元大-蘆洲,2023-06-05,9857
00688L,國泰20年美債正2,29,4,25,元大-蘆洲,2023-06-05,9857
2017,官田鋼,35,13,22,元大-蘆洲,2023-06-05,9857
4111,濟生,22,0,22,元大-蘆洲,2023-06-05,9857
2312,金寶,32,10,22,元大-蘆洲,2023-06-05,9857
00720B,元大投資級公司債,41,20,21,元大-蘆洲,2023-06-05,9857
2913,農林,27,6,21,元大-蘆洲,2023-06-05,9857
6244,茂迪,21,1,20,元大-蘆洲,2023-06-05,9857
0056,元大高股息,42,23,19,元大-蘆洲,2023-06-05,9857
8358,金居,22,4,18,元大-蘆洲,2023-06-05,9857
2609,陽明,25,7,18,元大-蘆洲,2023-06-05,9857
3083,網龍,17,0,17,元大-蘆洲,2023-06-05,9857
2371,大同,35,19,16,元大-蘆洲,2023-06-05,9857
2337,旺宏,20,4,16,元大-蘆洲,2023-06-05,9857
00713,元大台灣高息低波,29,14,15,元大-蘆洲,2023-06-05,9857
8088,品安,20,5,15,元大-蘆洲,2023-06-05,9857
00673R,期元大S＆P原油反1,15,0,15,元大-蘆洲,2023-06-05,9857
9943,好樂迪,21,6,15,元大-蘆洲,2023-06-05,9857
6214,精誠,19,4,15,元大-蘆洲,2023-06-05,9857
8046,南電,20,6,14,元大-蘆洲,2023-06-05,9857
4744,皇將,14,0,14,元大-蘆洲,2023-06-05,9857
2409,友達,405,68,337,元大-蘆洲,2023-06-06,9857
2887,台新金,293,25,268,元大-蘆洲,2023-06-06,9857
2610,華航,285,45,240,元大-蘆洲,2023-06-06,9857
2888,新光金,193,55,138,元大-蘆洲,2023-06-06,9857
6282,康舒,187,68,119,元大-蘆洲,2023-06-06,9857
2834,臺企銀,102,10,92,元大-蘆洲,2023-06-06,9857
2402,毅嘉,142,72,70,元大-蘆洲,2023-06-06,9857
2014,中鴻,79,9,70,元大-蘆洲,2023-06-06,9857
00679B,元大美債20年,59,1,58,元大-蘆洲,2023-06-06,9857
1905,華紙,130,82,48,元大-蘆洲,2023-06-06,9857
1609,大亞,287,240,47,元大-蘆洲,2023-06-06,9857
2881,富邦金,47,1,46,元大-蘆洲,2023-06-06,9857
4906,正文,65,20,45,元大-蘆洲,2023-06-06,9857
00927,群益半導體收益,42,0,42,元大-蘆洲,2023-06-06,9857
6269,台郡,42,1,41,元大-蘆洲,2023-06-06,9857
00919,群益台灣精選高息,40,0,40,元大-蘆洲,2023-06-06,9857
6290,良維,45,6,39,元大-蘆洲,2023-06-06,9857
00687B,國泰20年美債,34,0,34,元大-蘆洲,2023-06-06,9857
2337,旺宏,38,4,34,元大-蘆洲,2023-06-06,9857
6285,啟��,45,15,30,元大-蘆洲,2023-06-06,9857
00712,復華富時不動產,31,3,28,元大-蘆洲,2023-06-06,9857
1810,和成,36,9,27,元大-蘆洲,2023-06-06,9857
2461,光群雷,35,8,27,元大-蘆洲,2023-06-06,9857
8059,凱碩,27,0,27,元大-蘆洲,2023-06-06,9857
3046,建��,29,3,26,元大-蘆洲,2023-06-06,9857
6112,邁達特,57,31,26,元大-蘆洲,2023-06-06,9857
2482,連宇,25,0,25,元大-蘆洲,2023-06-06,9857
2492,華新科,28,3,25,元大-蘆洲,2023-06-06,9857
6005,群益證,25,0,25,元大-蘆洲,2023-06-06,9857
2359,所羅門,25,1,24,元大-蘆洲,2023-06-06,9857
3406,玉晶光,32,8,24,元大-蘆洲,2023-06-06,9857
3231,緯創,93,69,24,元大-蘆洲,2023-06-06,9857
2399,映泰,50,26,24,元大-蘆洲,2023-06-06,9857
6443,元晶,23,0,23,元大-蘆洲,2023-06-06,9857
8088,品安,25,2,23,元大-蘆洲,2023-06-06,9857
2457,飛宏,65,42,23,元大-蘆洲,2023-06-06,9857
00751B,元大AAA至A公司債,24,1,23,元大-蘆洲,2023-06-06,9857
2706,第一店,33,11,22,元大-蘆洲,2023-06-06,9857
6026,福邦證,22,1,21,元大-蘆洲,2023-06-06,9857
3673,TPK-KY,34,13,21,元大-蘆洲,2023-06-06,9857
4931,新盛力,27,6,21,元大-蘆洲,2023-06-06,9857
2371,大同,28,8,20,元大-蘆洲,2023-06-06,9857
5439,高技,21,1,20,元大-蘆洲,2023-06-06,9857
1326,台化,20,0,20,元大-蘆洲,2023-06-06,9857
00632R,元大台灣50反1,19,0,19,元大-蘆洲,2023-06-06,9857
2303,聯電,82,65,17,元大-蘆洲,2023-06-06,9857
3260,威剛,21,4,17,元大-蘆洲,2023-06-06,9857
3047,訊舟,21,4,17,元大-蘆洲,2023-06-06,9857
6125,廣運,56,39,17,元大-蘆洲,2023-06-06,9857
6129,普誠,16,0,16,元大-蘆洲,2023-06-06,9857
2489,瑞軒,249,10,239,元大-蘆洲,2023-06-07,9857
2618,長榮航,294,103,191,元大-蘆洲,2023-06-07,9857
2634,漢翔,139,13,126,元大-蘆洲,2023-06-07,9857
2888,新光金,245,120,125,元大-蘆洲,2023-06-07,9857
00637L,元大滬深300正2,108,1,107,元大-蘆洲,2023-06-07,9857
1605,華新,104,13,91,元大-蘆洲,2023-06-07,9857
3078,僑威,119,43,76,元大-蘆洲,2023-06-07,9857
2887,台新金,83,16,67,元大-蘆洲,2023-06-07,9857
2881,富邦金,65,4,61,元大-蘆洲,2023-06-07,9857
3663,鑫科,60,0,60,元大-蘆洲,2023-06-07,9857
2501,國建,55,0,55,元大-蘆洲,2023-06-07,9857
00680L,元大美債20正2,65,10,55,元大-蘆洲,2023-06-07,9857
3027,盛達,87,33,54,元大-蘆洲,2023-06-07,9857
6244,茂迪,58,5,53,元大-蘆洲,2023-06-07,9857
3049,精金,52,2,50,元大-蘆洲,2023-06-07,9857
00882,中信中國高股息,48,1,47,元大-蘆洲,2023-06-07,9857
2359,所羅門,45,0,45,元大-蘆洲,2023-06-07,9857
3189,景碩,48,5,43,元大-蘆洲,2023-06-07,9857
6282,康舒,75,32,43,元大-蘆洲,2023-06-07,9857
6116,彩晶,46,4,42,元大-蘆洲,2023-06-07,9857
00919,群益台灣精選高息,43,1,42,元大-蘆洲,2023-06-07,9857
6125,廣運,57,24,33,元大-蘆洲,2023-06-07,9857
4960,誠美材,41,10,31,元大-蘆洲,2023-06-07,9857
3058,立德,55,25,30,元大-蘆洲,2023-06-07,9857
2457,飛宏,72,44,28,元大-蘆洲,2023-06-07,9857
00852L,國泰美國道瓊正2,28,0,28,元大-蘆洲,2023-06-07,9857
3202,樺晟,30,3,27,元大-蘆洲,2023-06-07,9857
1903,士紙,27,2,25,元大-蘆洲,2023-06-07,9857
2706,第一店,48,23,25,元大-蘆洲,2023-06-07,9857
4979,華星光,128,104,24,元大-蘆洲,2023-06-07,9857
1608,華榮,80,56,24,元大-蘆洲,2023-06-07,9857
3062,建漢,24,1,23,元大-蘆洲,2023-06-07,9857
00712,復華富時不動產,25,4,21,元大-蘆洲,2023-06-07,9857
2337,旺宏,21,0,21,元大-蘆洲,2023-06-07,9857
6191,精成科,26,5,21,元大-蘆洲,2023-06-07,9857
2528,皇普,21,0,21,元大-蘆洲,2023-06-07,9857
2371,大同,36,16,20,元大-蘆洲,2023-06-07,9857
2344,華邦電,21,1,20,元大-蘆洲,2023-06-07,9857
1604,聲寶,20,0,20,元大-蘆洲,2023-06-07,9857
4533,協易機,50,30,20,元大-蘆洲,2023-06-07,9857
6026,福邦證,20,0,20,元大-蘆洲,2023-06-07,9857
8426,紅木-KY,24,5,19,元大-蘆洲,2023-06-07,9857
00679B,元大美債20年,24,5,19,元大-蘆洲,2023-06-07,9857
3624,光頡,21,3,18,元大-蘆洲,2023-06-07,9857
2889,國票金,18,0,18,元大-蘆洲,2023-06-07,9857
00753L,中信中國50正2,17,0,17,元大-蘆洲,2023-06-07,9857
2388,威盛,37,20,17,元大-蘆洲,2023-06-07,9857
1218,泰山,20,3,17,元大-蘆洲,2023-06-07,9857
00673R,期元大S＆P原油反1,22,6,16,元大-蘆洲,2023-06-07,9857
3094,聯傑,17,1,16,元大-蘆洲,2023-06-07,9857
2888,新光金,381,19,362,元大-蘆洲,2023-06-08,9857
2344,華邦電,160,30,130,元大-蘆洲,2023-06-08,9857
00687B,國泰20年美債,115,0,115,元大-蘆洲,2023-06-08,9857
1605,華新,128,17,111,元大-蘆洲,2023-06-08,9857
00919,群益台灣精選高息,94,0,94,元大-蘆洲,2023-06-08,9857
00679B,元大美債20年,96,10,86,元大-蘆洲,2023-06-08,9857
3694,海華,70,0,70,元大-蘆洲,2023-06-08,9857
2880,華南金,75,5,70,元大-蘆洲,2023-06-08,9857
1609,大亞,301,231,70,元大-蘆洲,2023-06-08,9857
00751B,元大AAA至A公司債,68,10,58,元大-蘆洲,2023-06-08,9857
3576,聯合再生,57,1,56,元大-蘆洲,2023-06-08,9857
00878,國泰永續高股息,99,46,53,元大-蘆洲,2023-06-08,9857
6276,安鈦克,56,4,52,元大-蘆洲,2023-06-08,9857
00650L,復華香港正2,50,0,50,元大-蘆洲,2023-06-08,9857
00712,復華富時不動產,71,22,49,元大-蘆洲,2023-06-08,9857
00720B,元大投資級公司債,45,0,45,元大-蘆洲,2023-06-08,9857
00637L,元大滬深300正2,53,10,43,元大-蘆洲,2023-06-08,9857
6190,萬泰科,51,10,41,元大-蘆洲,2023-06-08,9857
3481,群創,195,154,41,元大-蘆洲,2023-06-08,9857
2368,金像電,95,59,36,元大-蘆洲,2023-06-08,9857
3630,新鉅科,35,0,35,元大-蘆洲,2023-06-08,9857
2501,國建,34,0,34,元大-蘆洲,2023-06-08,9857
3105,穩懋,39,6,33,元大-蘆洲,2023-06-08,9857
2349,錸德,31,0,31,元大-蘆洲,2023-06-08,9857
8059,凱碩,49,18,31,元大-蘆洲,2023-06-08,9857
4167,松瑞藥,30,0,30,元大-蘆洲,2023-06-08,9857
2881,富邦金,29,0,29,元大-蘆洲,2023-06-08,9857
4906,正文,32,3,29,元大-蘆洲,2023-06-08,9857
3163,波若威,27,0,27,元大-蘆洲,2023-06-08,9857
8105,凌巨,28,1,27,元大-蘆洲,2023-06-08,9857
6776,展�眥篕�,40,13,27,元大-蘆洲,2023-06-08,9857
2323,中環,36,9,27,元大-蘆洲,2023-06-08,9857
3011,今皓,28,3,25,元大-蘆洲,2023-06-08,9857
4960,誠美材,35,11,24,元大-蘆洲,2023-06-08,9857
3706,神達,23,1,22,元大-蘆洲,2023-06-08,9857
1720,生達,37,15,22,元大-蘆洲,2023-06-08,9857
00927,群益半導體收益,21,0,21,元大-蘆洲,2023-06-08,9857
00665L,富邦�琤肭磪囓�2,25,4,21,元大-蘆洲,2023-06-08,9857
00688L,國泰20年美債正2,21,0,21,元大-蘆洲,2023-06-08,9857
1504,東元,47,26,21,元大-蘆洲,2023-06-08,9857
6269,台郡,21,0,21,元大-蘆洲,2023-06-08,9857
5328,華容,21,0,21,元大-蘆洲,2023-06-08,9857
2409,友達,31,11,20,元大-蘆洲,2023-06-08,9857
6274,台燿,23,3,20,元大-蘆洲,2023-06-08,9857
3231,緯創,68,49,19,元大-蘆洲,2023-06-08,9857
3712,永崴投控,23,4,19,元大-蘆洲,2023-06-08,9857
00795B,中信美國公債20年,19,0,19,元大-蘆洲,2023-06-08,9857
6016,康和證,19,1,18,元大-蘆洲,2023-06-08,9857
3673,TPK-KY,22,5,17,元大-蘆洲,2023-06-08,9857
2457,飛宏,63,46,17,元大-蘆洲,2023-06-08,9857
2888,新光金,599,113,486,元大-蘆洲,2023-06-09,9857
00929,復華台灣科技優息,280,0,280,元大-蘆洲,2023-06-09,9857
2883,凱基金,132,8,124,元大-蘆洲,2023-06-09,9857
1513,中興電,118,22,96,元大-蘆洲,2023-06-09,9857
2834,臺企銀,101,21,80,元大-蘆洲,2023-06-09,9857
2812,台中銀,80,7,73,元大-蘆洲,2023-06-09,9857
1504,東元,84,12,72,元大-蘆洲,2023-06-09,9857
4960,誠美材,60,1,59,元大-蘆洲,2023-06-09,9857
2887,台新金,108,52,56,元大-蘆洲,2023-06-09,9857
6274,台燿,53,11,42,元大-蘆洲,2023-06-09,9857
2482,連宇,106,65,41,元大-蘆洲,2023-06-09,9857
6026,福邦證,42,1,41,元大-蘆洲,2023-06-09,9857
8462,柏文,40,0,40,元大-蘆洲,2023-06-09,9857
00715L,期街口布蘭特正2,37,0,37,元大-蘆洲,2023-06-09,9857
00900,富邦特選高股息30,50,16,34,元大-蘆洲,2023-06-09,9857
5483,中美晶,34,0,34,元大-蘆洲,2023-06-09,9857
2743,山富,43,10,33,元大-蘆洲,2023-06-09,9857
00712,復華富時不動產,66,37,29,元大-蘆洲,2023-06-09,9857
6116,彩晶,48,21,27,元大-蘆洲,2023-06-09,9857
8038,長園科,31,5,26,元大-蘆洲,2023-06-09,9857
3680,家登,29,3,26,元大-蘆洲,2023-06-09,9857
2359,所羅門,44,18,26,元大-蘆洲,2023-06-09,9857
1802,台玻,25,0,25,元大-蘆洲,2023-06-09,9857
00679B,元大美債20年,39,15,24,元大-蘆洲,2023-06-09,9857
6517,保勝光學,26,3,23,元大-蘆洲,2023-06-09,9857
3037,欣興,98,75,23,元大-蘆洲,2023-06-09,9857
2501,國建,20,0,20,元大-蘆洲,2023-06-09,9857
2882,國泰金,30,10,20,元大-蘆洲,2023-06-09,9857
3105,穩懋,23,4,19,元大-蘆洲,2023-06-09,9857
00642U,期元大S＆P石油,18,0,18,元大-蘆洲,2023-06-09,9857
3025,星通,34,17,17,元大-蘆洲,2023-06-09,9857
6198,瑞築,17,0,17,元大-蘆洲,2023-06-09,9857
1612,宏泰,29,12,17,元大-蘆洲,2023-06-09,9857
1533,車王電,26,10,16,元大-蘆洲,2023-06-09,9857
6282,康舒,40,24,16,元大-蘆洲,2023-06-09,9857
00919,群益台灣精選高息,23,8,15,元大-蘆洲,2023-06-09,9857
2492,華新科,15,0,15,元大-蘆洲,2023-06-09,9857
6129,普誠,15,1,14,元大-蘆洲,2023-06-09,9857
5009,榮剛,17,3,14,元大-蘆洲,2023-06-09,9857
3033,威健,16,2,14,元大-蘆洲,2023-06-09,9857
2421,建準,24,11,13,元大-蘆洲,2023-06-09,9857
1720,生達,13,0,13,元大-蘆洲,2023-06-09,9857
2706,第一店,36,23,13,元大-蘆洲,2023-06-09,9857
2497,怡利電,22,9,13,元大-蘆洲,2023-06-09,9857
6532,瑞耘,17,4,13,元大-蘆洲,2023-06-09,9857
6016,康和證,23,10,13,元大-蘆洲,2023-06-09,9857
3715,定穎投控,20,7,13,元大-蘆洲,2023-06-09,9857
8033,雷虎,13,1,12,元大-蘆洲,2023-06-09,9857
2388,威盛,67,55,12,元大-蘆洲,2023-06-09,9857
2340,台亞,15,3,12,元大-蘆洲,2023-06-09,9857
3576,聯合再生,318,3,315,元大-蘆洲,2023-06-12,9857
00929,復華台灣科技優息,188,8,180,元大-蘆洲,2023-06-12,9857
00919,群益台灣精選高息,190,11,179,元大-蘆洲,2023-06-12,9857
2888,新光金,335,197,138,元大-蘆洲,2023-06-12,9857
00712,復華富時不動產,113,1,112,元大-蘆洲,2023-06-12,9857
2382,廣達,125,38,87,元大-蘆洲,2023-06-12,9857
3027,盛達,102,19,83,元大-蘆洲,2023-06-12,9857
8059,凱碩,83,0,83,元大-蘆洲,2023-06-12,9857
2359,所羅門,75,0,75,元大-蘆洲,2023-06-12,9857
3231,緯創,131,62,69,元大-蘆洲,2023-06-12,9857
00715L,期街口布蘭特正2,84,15,69,元大-蘆洲,2023-06-12,9857
00878,國泰永續高股息,164,97,67,元大-蘆洲,2023-06-12,9857
0056,元大高股息,104,38,66,元大-蘆洲,2023-06-12,9857
9944,新麗,73,11,62,元大-蘆洲,2023-06-12,9857
2340,台亞,56,0,56,元大-蘆洲,2023-06-12,9857
1504,東元,68,12,56,元大-蘆洲,2023-06-12,9857
1612,宏泰,55,3,52,元大-蘆洲,2023-06-12,9857
2887,台新金,55,5,50,元大-蘆洲,2023-06-12,9857
2801,彰銀,50,1,49,元大-蘆洲,2023-06-12,9857
2312,金寶,67,20,47,元大-蘆洲,2023-06-12,9857
4938,和碩,52,6,46,元大-蘆洲,2023-06-12,9857
1605,華新,51,5,46,元大-蘆洲,2023-06-12,9857
1609,大亞,129,87,42,元大-蘆洲,2023-06-12,9857
3062,建漢,45,5,40,元大-蘆洲,2023-06-12,9857
3058,立德,41,4,37,元大-蘆洲,2023-06-12,9857
3037,欣興,64,27,37,元大-蘆洲,2023-06-12,9857
6288,聯嘉,74,38,36,元大-蘆洲,2023-06-12,9857
2409,友達,64,29,35,元大-蘆洲,2023-06-12,9857
2634,漢翔,47,13,34,元大-蘆洲,2023-06-12,9857
6116,彩晶,69,37,32,元大-蘆洲,2023-06-12,9857
2337,旺宏,42,10,32,元大-蘆洲,2023-06-12,9857
00642U,期元大S＆P石油,34,2,32,元大-蘆洲,2023-06-12,9857
4533,協易機,32,1,31,元大-蘆洲,2023-06-12,9857
2495,普安,35,4,31,元大-蘆洲,2023-06-12,9857
3078,僑威,99,68,31,元大-蘆洲,2023-06-12,9857
2356,英業達,105,75,30,元大-蘆洲,2023-06-12,9857
2388,威盛,79,49,30,元大-蘆洲,2023-06-12,9857
6126,信音,30,2,28,元大-蘆洲,2023-06-12,9857
2610,華航,57,29,28,元大-蘆洲,2023-06-12,9857
5425,台半,46,19,27,元大-蘆洲,2023-06-12,9857
6596,寬宏藝術,33,7,26,元大-蘆洲,2023-06-12,9857
2399,映泰,37,11,26,元大-蘆洲,2023-06-12,9857
1616,億泰,24,0,24,元大-蘆洲,2023-06-12,9857
00679B,元大美債20年,24,0,24,元大-蘆洲,2023-06-12,9857
3707,漢磊,27,4,23,元大-蘆洲,2023-06-12,9857
1802,台玻,30,7,23,元大-蘆洲,2023-06-12,9857
6269,台郡,22,0,22,元大-蘆洲,2023-06-12,9857
6282,康舒,42,20,22,元大-蘆洲,2023-06-12,9857
2377,微星,31,10,21,元大-蘆洲,2023-06-12,9857
6198,瑞築,21,0,21,元大-蘆洲,2023-06-12,9857
00688L,國泰20年美債正2,277,0,277,元大-蘆洲,2023-06-13,9857
2888,新光金,818,581,237,元大-蘆洲,2023-06-13,9857
00715L,期街口布蘭特正2,189,0,189,元大-蘆洲,2023-06-13,9857
00919,群益台灣精選高息,191,3,188,元大-蘆洲,2023-06-13,9857
00642U,期元大S＆P石油,117,0,117,元大-蘆洲,2023-06-13,9857
3576,聯合再生,109,10,99,元大-蘆洲,2023-06-13,9857
2002,中鋼,104,21,83,元大-蘆洲,2023-06-13,9857
00637L,元大滬深300正2,122,59,63,元大-蘆洲,2023-06-13,9857
2887,台新金,63,1,62,元大-蘆洲,2023-06-13,9857
2317,鴻海,139,79,60,元大-蘆洲,2023-06-13,9857
6235,華孚,93,42,51,元大-蘆洲,2023-06-13,9857
8926,台汽電,45,8,37,元大-蘆洲,2023-06-13,9857
8440,綠電,33,1,32,元大-蘆洲,2023-06-13,9857
5425,台半,43,11,32,元大-蘆洲,2023-06-13,9857
00929,復華台灣科技優息,41,11,30,元大-蘆洲,2023-06-13,9857
2883,凱基金,63,34,29,元大-蘆洲,2023-06-13,9857
2457,飛宏,71,42,29,元大-蘆洲,2023-06-13,9857
3481,群創,47,20,27,元大-蘆洲,2023-06-13,9857
1104,環泥,33,6,27,元大-蘆洲,2023-06-13,9857
00648R,元大S＆P500反1,25,0,25,元大-蘆洲,2023-06-13,9857
8114,振樺電,33,9,24,元大-蘆洲,2023-06-13,9857
6143,振曜,25,1,24,元大-蘆洲,2023-06-13,9857
8112,至上,23,0,23,元大-蘆洲,2023-06-13,9857
6753,龍德造船,27,5,22,元大-蘆洲,2023-06-13,9857
2312,金寶,36,14,22,元大-蘆洲,2023-06-13,9857
1605,華新,33,11,22,元大-蘆洲,2023-06-13,9857
00882,中信中國高股息,21,0,21,元大-蘆洲,2023-06-13,9857
5201,凱衛,21,0,21,元大-蘆洲,2023-06-13,9857
1609,大亞,83,64,19,元大-蘆洲,2023-06-13,9857
2382,廣達,77,59,18,元大-蘆洲,2023-06-13,9857
00679B,元大美債20年,24,6,18,元大-蘆洲,2023-06-13,9857
00632R,元大台灣50反1,101,84,17,元大-蘆洲,2023-06-13,9857
3058,立德,22,5,17,元大-蘆洲,2023-06-13,9857
2208,台船,18,1,17,元大-蘆洲,2023-06-13,9857
3356,奇偶,42,25,17,元大-蘆洲,2023-06-13,9857
00892,富邦台灣半導體,21,4,17,元大-蘆洲,2023-06-13,9857
1584,精剛,20,4,16,元大-蘆洲,2023-06-13,9857
2492,華新科,16,0,16,元大-蘆洲,2023-06-13,9857
5871,中租-KY,17,1,16,元大-蘆洲,2023-06-13,9857
6112,邁達特,18,2,16,元大-蘆洲,2023-06-13,9857
2324,仁寶,29,13,16,元大-蘆洲,2023-06-13,9857
9943,好樂迪,27,11,16,元大-蘆洲,2023-06-13,9857
6016,康和證,16,1,15,元大-蘆洲,2023-06-13,9857
3033,威健,17,3,14,元大-蘆洲,2023-06-13,9857
00921,兆豐龍頭等權重,14,0,14,元大-蘆洲,2023-06-13,9857
2027,大成鋼,20,7,13,元大-蘆洲,2023-06-13,9857
00795B,中信美國公債20年,13,0,13,元大-蘆洲,2023-06-13,9857
5905,南仁湖,15,2,13,元大-蘆洲,2023-06-13,9857
5498,凱崴,16,3,13,元大-蘆洲,2023-06-13,9857
6126,信音,24,11,13,元大-蘆洲,2023-06-13,9857
2356,英業達,326,190,136,元大-蘆洲,2023-06-14,9857
2002,中鋼,103,13,90,元大-蘆洲,2023-06-14,9857
00919,群益台灣精選高息,94,8,86,元大-蘆洲,2023-06-14,9857
00687B,國泰20年美債,75,0,75,元大-蘆洲,2023-06-14,9857
00712,復華富時不動產,99,35,64,元大-蘆洲,2023-06-14,9857
2317,鴻海,74,15,59,元大-蘆洲,2023-06-14,9857
8440,綠電,57,0,57,元大-蘆洲,2023-06-14,9857
6235,華孚,90,36,54,元大-蘆洲,2023-06-14,9857
1310,台苯,50,0,50,元大-蘆洲,2023-06-14,9857
4919,新唐,43,0,43,元大-蘆洲,2023-06-14,9857
6109,亞元,40,0,40,元大-蘆洲,2023-06-14,9857
3576,聯合再生,49,9,40,元大-蘆洲,2023-06-14,9857
00751B,元大AAA至A公司債,40,0,40,元大-蘆洲,2023-06-14,9857
3308,聯德,47,8,39,元大-蘆洲,2023-06-14,9857
00929,復華台灣科技優息,40,2,38,元大-蘆洲,2023-06-14,9857
4979,華星光,74,37,37,元大-蘆洲,2023-06-14,9857
9945,潤泰新,33,0,33,元大-蘆洲,2023-06-14,9857
2617,台航,31,0,31,元大-蘆洲,2023-06-14,9857
1504,東元,48,17,31,元大-蘆洲,2023-06-14,9857
8201,無敵,29,0,29,元大-蘆洲,2023-06-14,9857
2887,台新金,32,3,29,元大-蘆洲,2023-06-14,9857
1802,台玻,28,0,28,元大-蘆洲,2023-06-14,9857
1609,大亞,103,78,25,元大-蘆洲,2023-06-14,9857
5465,富驊,54,29,25,元大-蘆洲,2023-06-14,9857
1409,新纖,26,1,25,元大-蘆洲,2023-06-14,9857
2369,菱生,25,1,24,元大-蘆洲,2023-06-14,9857
00713,元大台灣高息低波,37,13,24,元大-蘆洲,2023-06-14,9857
3046,建��,32,9,23,元大-蘆洲,2023-06-14,9857
2609,陽明,76,54,22,元大-蘆洲,2023-06-14,9857
6129,普誠,32,11,21,元大-蘆洲,2023-06-14,9857
2406,國碩,20,0,20,元大-蘆洲,2023-06-14,9857
4960,誠美材,30,10,20,元大-蘆洲,2023-06-14,9857
8028,昇陽半導體,23,3,20,元大-蘆洲,2023-06-14,9857
2743,山富,37,18,19,元大-蘆洲,2023-06-14,9857
5531,鄉林,20,1,19,元大-蘆洲,2023-06-14,9857
8215,明基材,19,1,18,元大-蘆洲,2023-06-14,9857
6788,華景電,20,2,18,元大-蘆洲,2023-06-14,9857
8358,金居,20,2,18,元大-蘆洲,2023-06-14,9857
2353,宏��,35,17,18,元大-蘆洲,2023-06-14,9857
1524,耿鼎,28,10,18,元大-蘆洲,2023-06-14,9857
3035,智原,32,15,17,元大-蘆洲,2023-06-14,9857
3481,群創,93,76,17,元大-蘆洲,2023-06-14,9857
00892,富邦台灣半導體,17,0,17,元大-蘆洲,2023-06-14,9857
3030,德律,16,0,16,元大-蘆洲,2023-06-14,9857
1806,冠軍,87,71,16,元大-蘆洲,2023-06-14,9857
2208,台船,18,3,15,元大-蘆洲,2023-06-14,9857
1815,富喬,20,5,15,元大-蘆洲,2023-06-14,9857
00637L,元大滬深300正2,60,45,15,元大-蘆洲,2023-06-14,9857
5864,致和證,15,0,15,元大-蘆洲,2023-06-14,9857
6233,旺玖,15,0,15,元大-蘆洲,2023-06-14,9857
2489,瑞軒,238,9,229,元大-蘆洲,2023-06-15,9857
2883,凱基金,190,1,189,元大-蘆洲,2023-06-15,9857
6282,康舒,228,42,186,元大-蘆洲,2023-06-15,9857
2618,長榮航,957,775,182,元大-蘆洲,2023-06-15,9857
00715L,期街口布蘭特正2,115,0,115,元大-蘆洲,2023-06-15,9857
6016,康和證,109,6,103,元大-蘆洲,2023-06-15,9857
5258,虹堡,111,16,95,元大-蘆洲,2023-06-15,9857
00712,復華富時不動產,112,32,80,元大-蘆洲,2023-06-15,9857
2834,臺企銀,72,1,71,元大-蘆洲,2023-06-15,9857
6664,群翊,52,2,50,元大-蘆洲,2023-06-15,9857
00915,凱基優選高股息30,50,1,49,元大-蘆洲,2023-06-15,9857
00751B,元大AAA至A公司債,48,0,48,元大-蘆洲,2023-06-15,9857
2409,友達,70,23,47,元大-蘆洲,2023-06-15,9857
1802,台玻,60,17,43,元大-蘆洲,2023-06-15,9857
00671R,富邦NASDAQ反1,42,0,42,元大-蘆洲,2023-06-15,9857
3483,力致,50,9,41,元大-蘆洲,2023-06-15,9857
00632R,元大台灣50反1,74,34,40,元大-蘆洲,2023-06-15,9857
8076,伍豐,81,43,38,元大-蘆洲,2023-06-15,9857
5483,中美晶,40,3,37,元大-蘆洲,2023-06-15,9857
2352,佳世達,42,6,36,元大-蘆洲,2023-06-15,9857
3380,明泰,35,0,35,元大-蘆洲,2023-06-15,9857
2324,仁寶,44,10,34,元大-蘆洲,2023-06-15,9857
3006,晶豪科,34,1,33,元大-蘆洲,2023-06-15,9857
3356,奇偶,48,18,30,元大-蘆洲,2023-06-15,9857
3022,威強電,29,1,28,元大-蘆洲,2023-06-15,9857
5371,中光電,26,0,26,元大-蘆洲,2023-06-15,9857
2457,飛宏,45,19,26,元大-蘆洲,2023-06-15,9857
2405,輔信,49,23,26,元大-蘆洲,2023-06-15,9857
4906,正文,31,5,26,元大-蘆洲,2023-06-15,9857
1514,亞力,47,23,24,元大-蘆洲,2023-06-15,9857
3058,立德,32,8,24,元大-蘆洲,2023-06-15,9857
8034,榮群,23,0,23,元大-蘆洲,2023-06-15,9857
2401,凌陽,92,69,23,元大-蘆洲,2023-06-15,9857
00706L,期元大S＆P日圓正2,22,0,22,元大-蘆洲,2023-06-15,9857
2331,精英,27,5,22,元大-蘆洲,2023-06-15,9857
00762,元大全球AI,22,0,22,元大-蘆洲,2023-06-15,9857
3652,精聯,27,6,21,元大-蘆洲,2023-06-15,9857
2417,圓剛,20,0,20,元大-蘆洲,2023-06-15,9857
4930,燦星網,20,0,20,元大-蘆洲,2023-06-15,9857
4958,臻鼎-KY,21,1,20,元大-蘆洲,2023-06-15,9857
3707,漢磊,27,7,20,元大-蘆洲,2023-06-15,9857
00679B,元大美債20年,25,5,20,元大-蘆洲,2023-06-15,9857
2317,鴻海,35,15,20,元大-蘆洲,2023-06-15,9857
2609,陽明,84,64,20,元大-蘆洲,2023-06-15,9857
2867,三商壽,20,1,19,元大-蘆洲,2023-06-15,9857
2332,友訊,25,6,19,元大-蘆洲,2023-06-15,9857
00897,富邦基因免疫生技,20,1,19,元大-蘆洲,2023-06-15,9857
00922,國泰台灣領袖50,17,0,17,元大-蘆洲,2023-06-15,9857
5469,瀚宇博,17,0,17,元大-蘆洲,2023-06-15,9857
2482,連宇,51,34,17,元大-蘆洲,2023-06-15,9857
00632R,元大台灣50反1,2021,9,2012,元大-蘆洲,2023-06-16,9857
2610,華航,769,404,365,元大-蘆洲,2023-06-16,9857
2312,金寶,422,112,310,元大-蘆洲,2023-06-16,9857
6160,欣技,210,0,210,元大-蘆洲,2023-06-16,9857
2834,臺企銀,221,54,167,元大-蘆洲,2023-06-16,9857
1514,亞力,187,55,132,元大-蘆洲,2023-06-16,9857
2489,瑞軒,125,9,116,元大-蘆洲,2023-06-16,9857
2371,大同,269,172,97,元大-蘆洲,2023-06-16,9857
00919,群益台灣精選高息,111,31,80,元大-蘆洲,2023-06-16,9857
2031,新光鋼,71,0,71,元大-蘆洲,2023-06-16,9857
3706,神達,188,122,66,元大-蘆洲,2023-06-16,9857
2880,華南金,59,0,59,元大-蘆洲,2023-06-16,9857
00878,國泰永續高股息,111,56,55,元大-蘆洲,2023-06-16,9857
1907,永豐餘,60,6,54,元大-蘆洲,2023-06-16,9857
4979,華星光,87,35,52,元大-蘆洲,2023-06-16,9857
2201,裕隆,72,23,49,元大-蘆洲,2023-06-16,9857
1609,大亞,205,156,49,元大-蘆洲,2023-06-16,9857
2439,美律,51,3,48,元大-蘆洲,2023-06-16,9857
2405,輔信,135,88,47,元大-蘆洲,2023-06-16,9857
2317,鴻海,58,12,46,元大-蘆洲,2023-06-16,9857
5426,振發,50,5,45,元大-蘆洲,2023-06-16,9857
00679B,元大美債20年,49,6,43,元大-蘆洲,2023-06-16,9857
00929,復華台灣科技優息,51,10,41,元大-蘆洲,2023-06-16,9857
00882,中信中國高股息,60,21,39,元大-蘆洲,2023-06-16,9857
2511,太子,40,1,39,元大-蘆洲,2023-06-16,9857
3013,晟銘電,52,14,38,元大-蘆洲,2023-06-16,9857
2401,凌陽,67,31,36,元大-蘆洲,2023-06-16,9857
3264,欣銓,35,2,33,元大-蘆洲,2023-06-16,9857
00713,元大台灣高息低波,43,11,32,元大-蘆洲,2023-06-16,9857
4744,皇將,30,0,30,元大-蘆洲,2023-06-16,9857
1313,聯成,30,0,30,元大-蘆洲,2023-06-16,9857
5014,建錩,30,0,30,元大-蘆洲,2023-06-16,9857
8201,無敵,44,15,29,元大-蘆洲,2023-06-16,9857
6189,豐藝,27,0,27,元大-蘆洲,2023-06-16,9857
3693,營邦,42,16,26,元大-蘆洲,2023-06-16,9857
6168,宏齊,24,0,24,元大-蘆洲,2023-06-16,9857
2303,聯電,57,33,24,元大-蘆洲,2023-06-16,9857
9945,潤泰新,23,0,23,元大-蘆洲,2023-06-16,9857
1905,華紙,92,70,22,元大-蘆洲,2023-06-16,9857
8926,台汽電,24,4,20,元大-蘆洲,2023-06-16,9857
00671R,富邦NASDAQ反1,20,0,20,元大-蘆洲,2023-06-16,9857
1307,三芳,19,0,19,元大-蘆洲,2023-06-16,9857
2002,中鋼,23,5,18,元大-蘆洲,2023-06-16,9857
8150,南茂,20,2,18,元大-蘆洲,2023-06-16,9857
2883,凱基金,69,51,18,元大-蘆洲,2023-06-16,9857
5533,皇鼎,18,0,18,元大-蘆洲,2023-06-16,9857
2882,國泰金,28,10,18,元大-蘆洲,2023-06-16,9857
1314,中石化,20,2,18,元大-蘆洲,2023-06-16,9857
3625,西勝,18,0,18,元大-蘆洲,2023-06-16,9857
2204,中華,18,0,18,元大-蘆洲,2023-06-16,9857
3481,群創,1231,616,615,元大-蘆洲,2023-06-19,9857
6116,彩晶,420,209,211,元大-蘆洲,2023-06-19,9857
4967,十銓,181,25,156,元大-蘆洲,2023-06-19,9857
1609,大亞,161,49,112,元大-蘆洲,2023-06-19,9857
2324,仁寶,127,34,93,元大-蘆洲,2023-06-19,9857
2031,新光鋼,81,0,81,元大-蘆洲,2023-06-19,9857
6148,驊宏資,98,39,59,元大-蘆洲,2023-06-19,9857
00712,復華富時不動產,55,0,55,元大-蘆洲,2023-06-19,9857
2382,廣達,75,21,54,元大-蘆洲,2023-06-19,9857
2609,陽明,66,14,52,元大-蘆洲,2023-06-19,9857
6182,合晶,54,2,52,元大-蘆洲,2023-06-19,9857
00632R,元大台灣50反1,52,0,52,元大-蘆洲,2023-06-19,9857
00650L,復華香港正2,51,0,51,元大-蘆洲,2023-06-19,9857
2516,新建,50,0,50,元大-蘆洲,2023-06-19,9857
2618,長榮航,163,123,40,元大-蘆洲,2023-06-19,9857
2887,台新金,45,6,39,元大-蘆洲,2023-06-19,9857
00878,國泰永續高股息,147,108,39,元大-蘆洲,2023-06-19,9857
1611,中電,38,0,38,元大-蘆洲,2023-06-19,9857
2356,英業達,124,87,37,元大-蘆洲,2023-06-19,9857
00882,中信中國高股息,37,1,36,元大-蘆洲,2023-06-19,9857
1708,東鹼,36,0,36,元大-蘆洲,2023-06-19,9857
3231,緯創,99,63,36,元大-蘆洲,2023-06-19,9857
6128,上福,35,0,35,元大-蘆洲,2023-06-19,9857
00687B,國泰20年美債,32,0,32,元大-蘆洲,2023-06-19,9857
5864,致和證,32,0,32,元大-蘆洲,2023-06-19,9857
00657,國泰日經225,30,0,30,元大-蘆洲,2023-06-19,9857
1909,榮成,29,0,29,元大-蘆洲,2023-06-19,9857
6120,達運,42,13,29,元大-蘆洲,2023-06-19,9857
2323,中環,50,23,27,元大-蘆洲,2023-06-19,9857
00679B,元大美債20年,33,5,28,元大-蘆洲,2023-06-19,9857
2353,宏��,30,4,26,元大-蘆洲,2023-06-19,9857
2371,大同,45,19,26,元大-蘆洲,2023-06-19,9857
4973,廣穎,34,8,26,元大-蘆洲,2023-06-19,9857
6160,欣技,30,4,26,元大-蘆洲,2023-06-19,9857
6190,萬泰科,26,0,26,元大-蘆洲,2023-06-19,9857
00919,群益台灣精選高息,38,13,25,元大-蘆洲,2023-06-19,9857
1608,華榮,24,0,24,元大-蘆洲,2023-06-19,9857
2409,友達,1397,1374,23,元大-蘆洲,2023-06-19,9857
00795B,中信美國公債20年,23,0,23,元大-蘆洲,2023-06-19,9857
2801,彰銀,25,2,23,元大-蘆洲,2023-06-19,9857
2883,凱基金,31,9,22,元大-蘆洲,2023-06-19,9857
00720B,元大投資級公司債,23,1,22,元大-蘆洲,2023-06-19,9857
4121,優盛,21,0,21,元大-蘆洲,2023-06-19,9857
2890,永豐金,21,0,21,元大-蘆洲,2023-06-19,9857
2392,正崴,20,0,20,元大-蘆洲,2023-06-19,9857
2897,王道銀行,20,0,20,元大-蘆洲,2023-06-19,9857
00673R,期元大S＆P原油反1,20,0,20,元大-蘆洲,2023-06-19,9857
3680,家登,20,0,20,元大-蘆洲,2023-06-19,9857
3706,神達,38,18,20,元大-蘆洲,2023-06-19,9857
4938,和碩,42,23,19,元大-蘆洲,2023-06-19,9857
2883,凱基金,117,14,103,元大-蘆洲,2023-06-20,9857
2748,雲品,130,36,94,元大-蘆洲,2023-06-20,9857
6443,元晶,100,14,86,元大-蘆洲,2023-06-20,9857
2489,瑞軒,117,35,82,元大-蘆洲,2023-06-20,9857
2801,彰銀,65,0,65,元大-蘆洲,2023-06-20,9857
4541,晟田,66,1,65,元大-蘆洲,2023-06-20,9857
3481,群創,186,129,57,元大-蘆洲,2023-06-20,9857
1528,恩德,104,48,56,元大-蘆洲,2023-06-20,9857
2337,旺宏,59,4,55,元大-蘆洲,2023-06-20,9857
6275,元山,53,0,53,元大-蘆洲,2023-06-20,9857
00712,復華富時不動產,56,7,49,元大-蘆洲,2023-06-20,9857
00650L,復華香港正2,50,1,49,元大-蘆洲,2023-06-20,9857
1802,台玻,141,93,48,元大-蘆洲,2023-06-20,9857
2454,聯發科,51,4,47,元大-蘆洲,2023-06-20,9857
8222,寶一,75,34,41,元大-蘆洲,2023-06-20,9857
1611,中電,42,2,40,元大-蘆洲,2023-06-20,9857
6109,亞元,40,0,40,元大-蘆洲,2023-06-20,9857
6026,福邦證,40,1,39,元大-蘆洲,2023-06-20,9857
4934,太極,49,11,38,元大-蘆洲,2023-06-20,9857
2504,國產,40,3,37,元大-蘆洲,2023-06-20,9857
3078,僑威,73,37,36,元大-蘆洲,2023-06-20,9857
2382,廣達,67,35,32,元大-蘆洲,2023-06-20,9857
00878,國泰永續高股息,296,267,29,元大-蘆洲,2023-06-20,9857
2618,長榮航,157,128,29,元大-蘆洲,2023-06-20,9857
3706,神達,35,7,28,元大-蘆洲,2023-06-20,9857
1810,和成,50,23,27,元大-蘆洲,2023-06-20,9857
2014,中鴻,29,2,27,元大-蘆洲,2023-06-20,9857
00882,中信中國高股息,25,1,24,元大-蘆洲,2023-06-20,9857
1522,堤維西,35,12,23,元大-蘆洲,2023-06-20,9857
2634,漢翔,205,183,22,元大-蘆洲,2023-06-20,9857
2201,裕隆,24,2,22,元大-蘆洲,2023-06-20,9857
1560,中砂,32,10,22,元大-蘆洲,2023-06-20,9857
5009,榮剛,30,9,21,元大-蘆洲,2023-06-20,9857
2913,農林,21,0,21,元大-蘆洲,2023-06-20,9857
00687B,國泰20年美債,21,0,21,元大-蘆洲,2023-06-20,9857
4938,和碩,21,2,19,元大-蘆洲,2023-06-20,9857
8358,金居,42,23,19,元大-蘆洲,2023-06-20,9857
00679B,元大美債20年,23,5,18,元大-蘆洲,2023-06-20,9857
2482,連宇,52,34,18,元大-蘆洲,2023-06-20,9857
6188,廣明,19,1,18,元大-蘆洲,2023-06-20,9857
4951,精拓科,18,1,17,元大-蘆洲,2023-06-20,9857
1314,中石化,17,0,17,元大-蘆洲,2023-06-20,9857
3576,聯合再生,23,6,17,元大-蘆洲,2023-06-20,9857
6279,胡連,20,4,16,元大-蘆洲,2023-06-20,9857
2059,川湖,17,1,16,元大-蘆洲,2023-06-20,9857
2401,凌陽,21,6,15,元大-蘆洲,2023-06-20,9857
3038,全台,26,11,15,元大-蘆洲,2023-06-20,9857
5324,士開,40,25,15,元大-蘆洲,2023-06-20,9857
3231,緯創,79,64,15,元大-蘆洲,2023-06-20,9857
2104,國際中橡,22,8,14,元大-蘆洲,2023-06-20,9857
2409,友達,1012,350,662,元大-蘆洲,2023-06-21,9857
2489,瑞軒,336,24,312,元大-蘆洲,2023-06-21,9857
00687B,國泰20年美債,113,8,105,元大-蘆洲,2023-06-21,9857
4543,萬在,117,14,103,元大-蘆洲,2023-06-21,9857
2705,六福,204,140,64,元大-蘆洲,2023-06-21,9857
00919,群益台灣精選高息,63,0,63,元大-蘆洲,2023-06-21,9857
2356,英業達,159,102,57,元大-蘆洲,2023-06-21,9857
00673R,期元大S＆P原油反1,83,27,56,元大-蘆洲,2023-06-21,9857
2371,大同,116,60,56,元大-蘆洲,2023-06-21,9857
2312,金寶,65,12,53,元大-蘆洲,2023-06-21,9857
00650L,復華香港正2,51,0,51,元大-蘆洲,2023-06-21,9857
2031,新光鋼,50,0,50,元大-蘆洲,2023-06-21,9857
1217,愛之味,50,2,48,元大-蘆洲,2023-06-21,9857
1906,寶隆,50,7,43,元大-蘆洲,2023-06-21,9857
5483,中美晶,83,43,40,元大-蘆洲,2023-06-21,9857
2323,中環,156,118,38,元大-蘆洲,2023-06-21,9857
1609,大亞,62,27,35,元大-蘆洲,2023-06-21,9857
1802,台玻,38,5,33,元大-蘆洲,2023-06-21,9857
2801,彰銀,33,0,33,元大-蘆洲,2023-06-21,9857
1605,華新,48,16,32,元大-蘆洲,2023-06-21,9857
2634,漢翔,101,69,32,元大-蘆洲,2023-06-21,9857
00753L,中信中國50正2,29,0,29,元大-蘆洲,2023-06-21,9857
2337,旺宏,28,0,28,元大-蘆洲,2023-06-21,9857
4916,事欣科,69,43,26,元大-蘆洲,2023-06-21,9857
8440,綠電,25,0,25,元大-蘆洲,2023-06-21,9857
6276,安鈦克,25,0,25,元大-蘆洲,2023-06-21,9857
1513,中興電,38,13,25,元大-蘆洲,2023-06-21,9857
2349,錸德,22,0,22,元大-蘆洲,2023-06-21,9857
4967,十銓,53,32,21,元大-蘆洲,2023-06-21,9857
00882,中信中國高股息,21,0,21,元大-蘆洲,2023-06-21,9857
2609,陽明,58,37,21,元大-蘆洲,2023-06-21,9857
1524,耿鼎,21,1,20,元大-蘆洲,2023-06-21,9857
9945,潤泰新,25,5,20,元大-蘆洲,2023-06-21,9857
6443,元晶,25,5,20,元大-蘆洲,2023-06-21,9857
3518,柏騰,30,11,19,元大-蘆洲,2023-06-21,9857
1608,華榮,24,5,19,元大-蘆洲,2023-06-21,9857
1727,中華化,22,4,18,元大-蘆洲,2023-06-21,9857
2344,華邦電,29,11,18,元大-蘆洲,2023-06-21,9857
00927,群益半導體收益,17,0,17,元大-蘆洲,2023-06-21,9857
00720B,元大投資級公司債,17,0,17,元大-蘆洲,2023-06-21,9857
2867,三商壽,21,5,16,元大-蘆洲,2023-06-21,9857
2405,輔信,60,45,15,元大-蘆洲,2023-06-21,9857
2712,遠雄來,16,1,15,元大-蘆洲,2023-06-21,9857
2603,長榮,36,21,15,元大-蘆洲,2023-06-21,9857
6288,聯嘉,16,2,14,元大-蘆洲,2023-06-21,9857
8940,新天地,15,2,13,元大-蘆洲,2023-06-21,9857
1514,亞力,28,15,13,元大-蘆洲,2023-06-21,9857
00631L,元大台灣50正2,13,0,13,元大-蘆洲,2023-06-21,9857
2399,映泰,21,9,12,元大-蘆洲,2023-06-21,9857
3033,威健,12,0,12,元大-蘆洲,2023-06-21,9857
3481,群創,654,106,548,元大-蘆洲,2023-06-26,9857
2489,瑞軒,214,5,209,元大-蘆洲,2023-06-26,9857
3231,緯創,288,163,125,元大-蘆洲,2023-06-26,9857
2405,輔信,121,0,121,元大-蘆洲,2023-06-26,9857
6188,廣明,143,29,114,元大-蘆洲,2023-06-26,9857
2409,友達,163,56,107,元大-蘆洲,2023-06-26,9857
1605,華新,165,60,105,元大-蘆洲,2023-06-26,9857
6116,彩晶,112,28,84,元大-蘆洲,2023-06-26,9857
8105,凌巨,85,10,75,元大-蘆洲,2023-06-26,9857
2344,華邦電,90,15,75,元大-蘆洲,2023-06-26,9857
2382,廣達,94,33,61,元大-蘆洲,2023-06-26,9857
00715L,期街口布蘭特正2,61,0,61,元大-蘆洲,2023-06-26,9857
00637L,元大滬深300正2,48,0,48,元大-蘆洲,2023-06-26,9857
00632R,元大台灣50反1,93,46,47,元大-蘆洲,2023-06-26,9857
2356,英業達,124,78,46,元大-蘆洲,2023-06-26,9857
1504,東元,53,7,46,元大-蘆洲,2023-06-26,9857
6657,華安,51,6,45,元大-蘆洲,2023-06-26,9857
6282,康舒,66,25,41,元大-蘆洲,2023-06-26,9857
1904,正隆,72,35,37,元大-蘆洲,2023-06-26,9857
2303,聯電,101,64,37,元大-蘆洲,2023-06-26,9857
5426,振發,37,2,35,元大-蘆洲,2023-06-26,9857
6120,達運,46,11,35,元大-蘆洲,2023-06-26,9857
1455,集盛,30,0,30,元大-蘆洲,2023-06-26,9857
2609,陽明,63,34,29,元大-蘆洲,2023-06-26,9857
3518,柏騰,31,2,29,元大-蘆洲,2023-06-26,9857
00687B,國泰20年美債,30,3,27,元大-蘆洲,2023-06-26,9857
1810,和成,34,7,27,元大-蘆洲,2023-06-26,9857
2104,國際中橡,30,4,26,元大-蘆洲,2023-06-26,9857
6180,橘子,29,4,25,元大-蘆洲,2023-06-26,9857
2427,三商電,105,80,25,元大-蘆洲,2023-06-26,9857
2312,金寶,29,5,24,元大-蘆洲,2023-06-26,9857
3013,晟銘電,27,4,23,元大-蘆洲,2023-06-26,9857
2388,威盛,35,13,22,元大-蘆洲,2023-06-26,9857
2352,佳世達,28,7,21,元大-蘆洲,2023-06-26,9857
3694,海華,20,0,20,元大-蘆洲,2023-06-26,9857
1611,中電,20,0,20,元大-蘆洲,2023-06-26,9857
2603,長榮,26,7,19,元大-蘆洲,2023-06-26,9857
2748,雲品,22,2,20,元大-蘆洲,2023-06-26,9857
2324,仁寶,44,25,19,元大-蘆洲,2023-06-26,9857
3515,華擎,23,4,19,元大-蘆洲,2023-06-26,9857
2453,凌群,27,9,18,元大-蘆洲,2023-06-26,9857
1617,榮星,18,0,18,元大-蘆洲,2023-06-26,9857
3042,晶技,31,13,18,元大-蘆洲,2023-06-26,9857
00919,群益台灣精選高息,22,4,18,元大-蘆洲,2023-06-26,9857
3325,旭品,18,1,17,元大-蘆洲,2023-06-26,9857
3149,正達,20,3,17,元大-蘆洲,2023-06-26,9857
6770,力積電,25,8,17,元大-蘆洲,2023-06-26,9857
3032,偉訓,35,19,16,元大-蘆洲,2023-06-26,9857
2371,大同,89,73,16,元大-蘆洲,2023-06-26,9857
2515,中工,16,0,16,元大-蘆洲,2023-06-26,9857
00878,國泰永續高股息,486,145,341,元大-蘆洲,2023-06-27,9857
2618,長榮航,269,134,135,元大-蘆洲,2023-06-27,9857
2610,華航,339,233,106,元大-蘆洲,2023-06-27,9857
2303,聯電,116,24,92,元大-蘆洲,2023-06-27,9857
1471,首利,106,15,91,元大-蘆洲,2023-06-27,9857
2344,華邦電,81,3,78,元大-蘆洲,2023-06-27,9857
1605,華新,97,26,71,元大-蘆洲,2023-06-27,9857
2883,凱基金,69,0,69,元大-蘆洲,2023-06-27,9857
1905,華紙,123,58,65,元大-蘆洲,2023-06-27,9857
3231,緯創,114,53,61,元大-蘆洲,2023-06-27,9857
2888,新光金,60,3,57,元大-蘆洲,2023-06-27,9857
00665L,富邦�琤肭磪囓�2,60,4,56,元大-蘆洲,2023-06-27,9857
2489,瑞軒,52,0,52,元大-蘆洲,2023-06-27,9857
2323,中環,119,72,47,元大-蘆洲,2023-06-27,9857
1608,華榮,49,2,47,元大-蘆洲,2023-06-27,9857
9802,鈺齊-KY,46,0,46,元大-蘆洲,2023-06-27,9857
6290,良維,41,1,40,元大-蘆洲,2023-06-27,9857
2340,台亞,79,41,38,元大-蘆洲,2023-06-27,9857
2359,所羅門,44,7,37,元大-蘆洲,2023-06-27,9857
5225,東科-KY,37,4,33,元大-蘆洲,2023-06-27,9857
1513,中興電,90,57,33,元大-蘆洲,2023-06-27,9857
3324,雙鴻,39,8,31,元大-蘆洲,2023-06-27,9857
00720B,元大投資級公司債,32,2,30,元大-蘆洲,2023-06-27,9857
4123,晟德,35,5,30,元大-蘆洲,2023-06-27,9857
3037,欣興,120,91,29,元大-蘆洲,2023-06-27,9857
1314,中石化,39,10,29,元大-蘆洲,2023-06-27,9857
2427,三商電,115,86,29,元大-蘆洲,2023-06-27,9857
6016,康和證,30,2,28,元大-蘆洲,2023-06-27,9857
00929,復華台灣科技優息,27,2,25,元大-蘆洲,2023-06-27,9857
3694,海華,30,5,25,元大-蘆洲,2023-06-27,9857
2867,三商壽,40,15,25,元大-蘆洲,2023-06-27,9857
3325,旭品,34,9,25,元大-蘆洲,2023-06-27,9857
8440,綠電,25,0,25,元大-蘆洲,2023-06-27,9857
6274,台燿,24,0,24,元大-蘆洲,2023-06-27,9857
2014,中鴻,43,19,24,元大-蘆洲,2023-06-27,9857
2891,中信金,26,3,23,元大-蘆洲,2023-06-27,9857
2615,萬海,39,18,21,元大-蘆洲,2023-06-27,9857
3518,柏騰,22,1,21,元大-蘆洲,2023-06-27,9857
1301,台塑,22,1,21,元大-蘆洲,2023-06-27,9857
4726,永昕,20,0,20,元大-蘆洲,2023-06-27,9857
1529,樂事綠能,36,17,19,元大-蘆洲,2023-06-27,9857
2365,昆盈,20,1,19,元大-蘆洲,2023-06-27,9857
5608,四維航,19,0,19,元大-蘆洲,2023-06-27,9857
1504,東元,70,52,18,元大-蘆洲,2023-06-27,9857
00919,群益台灣精選高息,34,17,17,元大-蘆洲,2023-06-27,9857
2748,雲品,30,13,17,元大-蘆洲,2023-06-27,9857
2408,南亞科,18,1,17,元大-蘆洲,2023-06-27,9857
2027,大成鋼,19,2,17,元大-蘆洲,2023-06-27,9857
2314,台揚,18,1,17,元大-蘆洲,2023-06-27,9857
3042,晶技,17,1,16,元大-蘆洲,2023-06-27,9857
2489,瑞軒,230,10,220,元大-蘆洲,2023-06-28,9857
1605,華新,336,116,220,元大-蘆洲,2023-06-28,9857
00715L,期街口布蘭特正2,142,0,142,元大-蘆洲,2023-06-28,9857
4157,太景*-KY,109,22,87,元大-蘆洲,2023-06-28,9857
6116,彩晶,94,10,84,元大-蘆洲,2023-06-28,9857
4967,十銓,103,28,75,元大-蘆洲,2023-06-28,9857
3338,泰碩,60,0,60,元大-蘆洲,2023-06-28,9857
3481,群創,111,57,54,元大-蘆洲,2023-06-28,9857
00650L,復華香港正2,150,100,50,元大-蘆洲,2023-06-28,9857
6191,精成科,59,12,47,元大-蘆洲,2023-06-28,9857
6657,華安,47,0,47,元大-蘆洲,2023-06-28,9857
1101,台泥,47,1,46,元大-蘆洲,2023-06-28,9857
1504,東元,70,26,44,元大-蘆洲,2023-06-28,9857
00642U,期元大S＆P石油,42,0,42,元大-蘆洲,2023-06-28,9857
1444,力麗,82,43,39,元大-蘆洲,2023-06-28,9857
4108,懷特,36,0,36,元大-蘆洲,2023-06-28,9857
6589,台康生技,42,6,36,元大-蘆洲,2023-06-28,9857
4106,雃博,38,3,35,元大-蘆洲,2023-06-28,9857
6148,驊宏資,48,18,30,元大-蘆洲,2023-06-28,9857
1301,台塑,29,0,29,元大-蘆洲,2023-06-28,9857
3027,盛達,33,4,29,元大-蘆洲,2023-06-28,9857
2634,漢翔,50,22,28,元大-蘆洲,2023-06-28,9857
00919,群益台灣精選高息,27,0,27,元大-蘆洲,2023-06-28,9857
1513,中興電,43,17,26,元大-蘆洲,2023-06-28,9857
2332,友訊,35,9,26,元大-蘆洲,2023-06-28,9857
2449,京元電子,33,7,26,元大-蘆洲,2023-06-28,9857
2883,凱基金,31,5,26,元大-蘆洲,2023-06-28,9857
2303,聯電,28,3,25,元大-蘆洲,2023-06-28,9857
3037,欣興,47,23,24,元大-蘆洲,2023-06-28,9857
1752,南光,26,3,23,元大-蘆洲,2023-06-28,9857
6547,高端疫苗,22,0,22,元大-蘆洲,2023-06-28,9857
6160,欣技,20,0,20,元大-蘆洲,2023-06-28,9857
00891,中信關鍵半導體,20,0,20,元大-蘆洲,2023-06-28,9857
2882,國泰金,29,9,20,元大-蘆洲,2023-06-28,9857
4908,前鼎,26,7,19,元大-蘆洲,2023-06-28,9857
5009,榮剛,22,4,18,元大-蘆洲,2023-06-28,9857
3089,億杰,18,0,18,元大-蘆洲,2023-06-28,9857
2382,廣達,55,38,17,元大-蘆洲,2023-06-28,9857
5608,四維航,17,0,17,元大-蘆洲,2023-06-28,9857
2059,川湖,22,5,17,元大-蘆洲,2023-06-28,9857
00751B,元大AAA至A公司債,16,0,16,元大-蘆洲,2023-06-28,9857
4746,台耀,95,79,16,元大-蘆洲,2023-06-28,9857
4906,正文,65,50,15,元大-蘆洲,2023-06-28,9857
4168,醣聯,15,0,15,元大-蘆洲,2023-06-28,9857
6585,鼎基,15,0,15,元大-蘆洲,2023-06-28,9857
3042,晶技,14,0,14,元大-蘆洲,2023-06-28,9857
2324,仁寶,16,3,13,元大-蘆洲,2023-06-28,9857
1789,神隆,13,0,13,元大-蘆洲,2023-06-28,9857
2892,第一金,13,0,13,元大-蘆洲,2023-06-28,9857
2534,宏盛,12,0,12,元大-蘆洲,2023-06-28,9857
3591,艾笛森,147,2,145,元大-蘆洲,2023-06-29,9857
2317,鴻海,141,4,137,元大-蘆洲,2023-06-29,9857
1605,華新,120,15,105,元大-蘆洲,2023-06-29,9857
4157,太景*-KY,178,97,81,元大-蘆洲,2023-06-29,9857
2618,長榮航,156,88,68,元大-蘆洲,2023-06-29,9857
2303,聯電,67,3,64,元大-蘆洲,2023-06-29,9857
2887,台新金,57,0,57,元大-蘆洲,2023-06-29,9857
3207,耀勝,87,30,57,元大-蘆洲,2023-06-29,9857
8936,國統,53,12,41,元大-蘆洲,2023-06-29,9857
1701,中化,46,6,40,元大-蘆洲,2023-06-29,9857
1802,台玻,40,1,39,元大-蘆洲,2023-06-29,9857
2610,華航,105,70,35,元大-蘆洲,2023-06-29,9857
4414,如興,49,16,33,元大-蘆洲,2023-06-29,9857
1504,東元,37,8,29,元大-蘆洲,2023-06-29,9857
2489,瑞軒,34,6,28,元大-蘆洲,2023-06-29,9857
6125,廣運,27,1,26,元大-蘆洲,2023-06-29,9857
00720B,元大投資級公司債,26,0,26,元大-蘆洲,2023-06-29,9857
6657,華安,59,35,24,元大-蘆洲,2023-06-29,9857
00712,復華富時不動產,49,26,23,元大-蘆洲,2023-06-29,9857
5512,力麒,23,0,23,元大-蘆洲,2023-06-29,9857
2888,新光金,23,1,22,元大-蘆洲,2023-06-29,9857
8150,南茂,24,3,21,元大-蘆洲,2023-06-29,9857
1570,力肯,20,0,20,元大-蘆洲,2023-06-29,9857
2458,義隆,20,0,20,元大-蘆洲,2023-06-29,9857
00885,富邦越南,26,7,19,元大-蘆洲,2023-06-29,9857
1528,恩德,30,11,19,元大-蘆洲,2023-06-29,9857
4746,台耀,43,24,19,元大-蘆洲,2023-06-29,9857
3481,群創,31,14,17,元大-蘆洲,2023-06-29,9857
1301,台塑,17,0,17,元大-蘆洲,2023-06-29,9857
2634,漢翔,26,9,17,元大-蘆洲,2023-06-29,9857
1314,中石化,22,5,17,元大-蘆洲,2023-06-29,9857
00673R,期元大S＆P原油反1,17,0,17,元大-蘆洲,2023-06-29,9857
1326,台化,17,0,17,元大-蘆洲,2023-06-29,9857
5225,東科-KY,31,15,16,元大-蘆洲,2023-06-29,9857
4543,萬在,17,3,14,元大-蘆洲,2023-06-29,9857
4906,正文,54,40,14,元大-蘆洲,2023-06-29,9857
8083,瑞穎,14,0,14,元大-蘆洲,2023-06-29,9857
8210,勤誠,24,11,13,元大-蘆洲,2023-06-29,9857
2405,輔信,13,0,13,元大-蘆洲,2023-06-29,9857
00664R,國泰臺灣加權反1,13,0,13,元大-蘆洲,2023-06-29,9857
1589,永冠-KY,13,0,13,元大-蘆洲,2023-06-29,9857
3058,立德,15,3,12,元大-蘆洲,2023-06-29,9857
6005,群益證,12,0,12,元大-蘆洲,2023-06-29,9857
6546,正基,12,0,12,元大-蘆洲,2023-06-29,9857
2419,仲琦,165,154,11,元大-蘆洲,2023-06-29,9857
2368,金像電,20,9,11,元大-蘆洲,2023-06-29,9857
2882,國泰金,11,0,11,元大-蘆洲,2023-06-29,9857
1783,和康生,21,10,11,元大-蘆洲,2023-06-29,9857
2867,三商壽,11,0,11,元大-蘆洲,2023-06-29,9857
3450,聯鈞,11,0,11,元大-蘆洲,2023-06-29,9857
2344,華邦電,176,15,161,元大-蘆洲,2023-06-30,9857
2603,長榮,267,120,147,元大-蘆洲,2023-06-30,9857
8050,廣積,123,15,108,元大-蘆洲,2023-06-30,9857
6116,彩晶,132,30,102,元大-蘆洲,2023-06-30,9857
9958,世紀鋼,106,10,96,元大-蘆洲,2023-06-30,9857
2618,長榮航,130,51,79,元大-蘆洲,2023-06-30,9857
2489,瑞軒,77,4,73,元大-蘆洲,2023-06-30,9857
00687B,國泰20年美債,57,0,57,元大-蘆洲,2023-06-30,9857
1605,華新,87,33,54,元大-蘆洲,2023-06-30,9857
2436,偉詮電,50,1,49,元大-蘆洲,2023-06-30,9857
1584,精剛,50,8,42,元大-蘆洲,2023-06-30,9857
1802,台玻,43,5,38,元大-蘆洲,2023-06-30,9857
5880,合庫金,38,1,37,元大-蘆洲,2023-06-30,9857
00795B,中信美國公債20年,32,1,31,元大-蘆洲,2023-06-30,9857
00665L,富邦�琤肭磪囓�2,30,0,30,元大-蘆洲,2023-06-30,9857
2208,台船,32,3,29,元大-蘆洲,2023-06-30,9857
2610,華航,139,111,28,元大-蘆洲,2023-06-30,9857
6190,萬泰科,30,3,27,元大-蘆洲,2023-06-30,9857
1301,台塑,26,0,26,元大-蘆洲,2023-06-30,9857
2885,元大金,26,0,26,元大-蘆洲,2023-06-30,9857
2888,新光金,41,16,25,元大-蘆洲,2023-06-30,9857
2330,台積電,32,7,25,元大-蘆洲,2023-06-30,9857
6446,藥華藥,25,1,24,元大-蘆洲,2023-06-30,9857
1701,中化,24,0,24,元大-蘆洲,2023-06-30,9857
8105,凌巨,24,2,22,元大-蘆洲,2023-06-30,9857
2317,鴻海,41,19,22,元大-蘆洲,2023-06-30,9857
00679B,元大美債20年,21,0,21,元大-蘆洲,2023-06-30,9857
5512,力麒,20,0,20,元大-蘆洲,2023-06-30,9857
00713,元大台灣高息低波,20,0,20,元大-蘆洲,2023-06-30,9857
3711,日月光投控,21,1,20,元大-蘆洲,2023-06-30,9857
00900,富邦特選高股息30,19,1,18,元大-蘆洲,2023-06-30,9857
2303,聯電,50,32,18,元大-蘆洲,2023-06-30,9857
8358,金居,34,17,17,元大-蘆洲,2023-06-30,9857
00680L,元大美債20正2,17,0,17,元大-蘆洲,2023-06-30,9857
8034,榮群,23,6,17,元大-蘆洲,2023-06-30,9857
1444,力麗,21,5,16,元大-蘆洲,2023-06-30,9857
2027,大成鋼,16,0,16,元大-蘆洲,2023-06-30,9857
8111,立��,15,0,15,元大-蘆洲,2023-06-30,9857
6806,森崴能源,26,11,15,元大-蘆洲,2023-06-30,9857
2462,良得電,15,0,15,元大-蘆洲,2023-06-30,9857
2371,大同,72,57,15,元大-蘆洲,2023-06-30,9857
2880,華南金,13,0,13,元大-蘆洲,2023-06-30,9857
2882,國泰金,12,0,12,元大-蘆洲,2023-06-30,9857
8936,國統,51,39,12,元大-蘆洲,2023-06-30,9857
2511,太子,12,0,12,元大-蘆洲,2023-06-30,9857
2634,漢翔,23,11,12,元大-蘆洲,2023-06-30,9857
3591,艾笛森,24,12,12,元大-蘆洲,2023-06-30,9857
6285,啟��,19,7,12,元大-蘆洲,2023-06-30,9857
00927,群益半導體收益,11,0,11,元大-蘆洲,2023-06-30,9857
2312,金寶,14,3,11,元大-蘆洲,2023-06-30,9857
4906,正文,256,141,115,元大-蘆洲,2023-07-03,9857
2489,瑞軒,110,1,109,元大-蘆洲,2023-07-03,9857
2206,三陽工業,137,32,105,元大-蘆洲,2023-07-03,9857
3078,僑威,126,44,82,元大-蘆洲,2023-07-03,9857
020038,元大ESG配息N,80,0,80,元大-蘆洲,2023-07-03,9857
2603,長榮,145,69,76,元大-蘆洲,2023-07-03,9857
4967,十銓,77,19,58,元大-蘆洲,2023-07-03,9857
00712,復華富時不動產,60,5,55,元大-蘆洲,2023-07-03,9857
2303,聯電,61,7,54,元大-蘆洲,2023-07-03,9857
3231,緯創,208,155,53,元大-蘆洲,2023-07-03,9857
4566,時碩工業,52,2,50,元大-蘆洲,2023-07-03,9857
6187,萬潤,50,1,49,元大-蘆洲,2023-07-03,9857
4414,如興,43,2,41,元大-蘆洲,2023-07-03,9857
1560,中砂,37,0,37,元大-蘆洲,2023-07-03,9857
2356,英業達,143,107,36,元大-蘆洲,2023-07-03,9857
6276,安鈦克,38,3,35,元大-蘆洲,2023-07-03,9857
6657,華安,35,0,35,元大-蘆洲,2023-07-03,9857
3481,群創,68,33,35,元大-蘆洲,2023-07-03,9857
3711,日月光投控,38,4,34,元大-蘆洲,2023-07-03,9857
8936,國統,36,2,34,元大-蘆洲,2023-07-03,9857
3483,力致,44,12,32,元大-蘆洲,2023-07-03,9857
6188,廣明,64,34,30,元大-蘆洲,2023-07-03,9857
1314,中石化,29,0,29,元大-蘆洲,2023-07-03,9857
4104,佳醫,30,5,25,元大-蘆洲,2023-07-03,9857
2867,三商壽,25,0,25,元大-蘆洲,2023-07-03,9857
2371,大同,88,63,25,元大-蘆洲,2023-07-03,9857
2368,金像電,57,33,24,元大-蘆洲,2023-07-03,9857
8083,瑞穎,24,0,24,元大-蘆洲,2023-07-03,9857
3207,耀勝,32,9,23,元大-蘆洲,2023-07-03,9857
1217,愛之味,23,0,23,元大-蘆洲,2023-07-03,9857
00929,復華台灣科技優息,32,9,23,元大-蘆洲,2023-07-03,9857
2438,翔耀,22,0,22,元大-蘆洲,2023-07-03,9857
2401,凌陽,29,7,22,元大-蘆洲,2023-07-03,9857
1308,亞聚,24,4,20,元大-蘆洲,2023-07-03,9857
6142,友勁,20,0,20,元大-蘆洲,2023-07-03,9857
3191,雲嘉南,20,0,20,元大-蘆洲,2023-07-03,9857
2881,富邦金,20,0,20,元大-蘆洲,2023-07-03,9857
2412,中華電,22,3,19,元大-蘆洲,2023-07-03,9857
2338,光罩,35,16,19,元大-蘆洲,2023-07-03,9857
2481,強茂,18,0,18,元大-蘆洲,2023-07-03,9857
2887,台新金,23,7,16,元大-蘆洲,2023-07-03,9857
1795,美時,30,15,15,元大-蘆洲,2023-07-03,9857
2913,農林,25,10,15,元大-蘆洲,2023-07-03,9857
1809,中釉,15,0,15,元大-蘆洲,2023-07-03,9857
1802,台玻,14,0,14,元大-蘆洲,2023-07-03,9857
3163,波若威,16,2,14,元大-蘆洲,2023-07-03,9857
2409,友達,39,25,14,元大-蘆洲,2023-07-03,9857
4938,和碩,16,3,13,元大-蘆洲,2023-07-03,9857
2540,愛山林,13,0,13,元大-蘆洲,2023-07-03,9857
6275,元山,15,2,13,元大-蘆洲,2023-07-03,9857
2402,毅嘉,580,107,473,元大-蘆洲,2023-07-04,9857
2888,新光金,376,25,351,元大-蘆洲,2023-07-04,9857
2014,中鴻,254,0,254,元大-蘆洲,2023-07-04,9857
2356,英業達,448,259,189,元大-蘆洲,2023-07-04,9857
2883,凱基金,124,20,104,元大-蘆洲,2023-07-04,9857
2317,鴻海,106,17,89,元大-蘆洲,2023-07-04,9857
1605,華新,81,25,56,元大-蘆洲,2023-07-04,9857
2603,長榮,264,211,53,元大-蘆洲,2023-07-04,9857
5608,四維航,60,8,52,元大-蘆洲,2023-07-04,9857
2208,台船,52,4,48,元大-蘆洲,2023-07-04,9857
3013,晟銘電,65,19,46,元大-蘆洲,2023-07-04,9857
2637,慧洋-KY,38,0,38,元大-蘆洲,2023-07-04,9857
1905,華紙,89,56,33,元大-蘆洲,2023-07-04,9857
2027,大成鋼,32,1,31,元大-蘆洲,2023-07-04,9857
00929,復華台灣科技優息,49,18,31,元大-蘆洲,2023-07-04,9857
2385,群光,30,3,27,元大-蘆洲,2023-07-04,9857
4906,正文,66,40,26,元大-蘆洲,2023-07-04,9857
00673R,期元大S＆P原油反1,25,0,25,元大-蘆洲,2023-07-04,9857
2887,台新金,24,1,23,元大-蘆洲,2023-07-04,9857
2615,萬海,101,78,23,元大-蘆洲,2023-07-04,9857
00632R,元大台灣50反1,110,88,22,元大-蘆洲,2023-07-04,9857
3189,景碩,22,1,21,元大-蘆洲,2023-07-04,9857
00671R,富邦NASDAQ反1,20,0,20,元大-蘆洲,2023-07-04,9857
2344,華邦電,28,9,19,元大-蘆洲,2023-07-04,9857
1504,東元,28,9,19,元大-蘆洲,2023-07-04,9857
2436,偉詮電,20,1,19,元大-蘆洲,2023-07-04,9857
2537,聯上發,20,2,18,元大-蘆洲,2023-07-04,9857
2399,映泰,58,40,18,元大-蘆洲,2023-07-04,9857
2301,光寶科,40,22,18,元大-蘆洲,2023-07-04,9857
4938,和碩,20,3,17,元大-蘆洲,2023-07-04,9857
2606,裕民,19,3,16,元大-蘆洲,2023-07-04,9857
2419,仲琦,104,89,15,元大-蘆洲,2023-07-04,9857
8028,昇陽半導體,17,2,15,元大-蘆洲,2023-07-04,9857
3141,晶宏,15,0,15,元大-蘆洲,2023-07-04,9857
2412,中華電,15,0,15,元大-蘆洲,2023-07-04,9857
2882,國泰金,16,1,15,元大-蘆洲,2023-07-04,9857
2486,一詮,33,18,15,元大-蘆洲,2023-07-04,9857
2897,王道銀行,15,0,15,元大-蘆洲,2023-07-04,9857
9919,康那香,15,1,14,元大-蘆洲,2023-07-04,9857
2332,友訊,35,21,14,元大-蘆洲,2023-07-04,9857
6112,邁達特,52,38,14,元大-蘆洲,2023-07-04,9857
5706,鳳凰,15,2,13,元大-蘆洲,2023-07-04,9857
6147,頎邦,13,0,13,元大-蘆洲,2023-07-04,9857
1513,中興電,46,33,13,元大-蘆洲,2023-07-04,9857
3025,星通,74,61,13,元大-蘆洲,2023-07-04,9857
3131,弘塑,14,1,13,元大-蘆洲,2023-07-04,9857
5328,華容,13,0,13,元大-蘆洲,2023-07-04,9857
4904,遠傳,13,0,13,元大-蘆洲,2023-07-04,9857
2337,旺宏,34,21,13,元大-蘆洲,2023-07-04,9857
4979,華星光,41,28,13,元大-蘆洲,2023-07-04,9857
2609,陽明,446,203,243,元大-蘆洲,2023-07-05,9857
2104,國際中橡,102,0,102,元大-蘆洲,2023-07-05,9857
4960,誠美材,125,25,100,元大-蘆洲,2023-07-05,9857
00929,復華台灣科技優息,100,0,100,元大-蘆洲,2023-07-05,9857
2880,華南金,80,0,80,元大-蘆洲,2023-07-05,9857
2356,英業達,171,95,76,元大-蘆洲,2023-07-05,9857
4414,如興,60,0,60,元大-蘆洲,2023-07-05,9857
020038,元大ESG配息N,60,0,60,元大-蘆洲,2023-07-05,9857
2419,仲琦,98,45,53,元大-蘆洲,2023-07-05,9857
3682,亞太電,51,0,51,元大-蘆洲,2023-07-05,9857
2312,金寶,82,31,51,元大-蘆洲,2023-07-05,9857
2838,聯邦銀,50,0,50,元大-蘆洲,2023-07-05,9857
8105,凌巨,53,3,50,元大-蘆洲,2023-07-05,9857
3372,典範,84,34,50,元大-蘆洲,2023-07-05,9857
2317,鴻海,72,24,48,元大-蘆洲,2023-07-05,9857
2303,聯電,52,7,45,元大-蘆洲,2023-07-05,9857
5356,協益,50,6,44,元大-蘆洲,2023-07-05,9857
3231,緯創,245,203,42,元大-蘆洲,2023-07-05,9857
1584,精剛,56,16,40,元大-蘆洲,2023-07-05,9857
00712,復華富時不動產,44,5,39,元大-蘆洲,2023-07-05,9857
4157,太景*-KY,51,13,38,元大-蘆洲,2023-07-05,9857
2888,新光金,50,12,38,元大-蘆洲,2023-07-05,9857
1314,中石化,41,4,37,元大-蘆洲,2023-07-05,9857
0056,元大高股息,82,46,36,元大-蘆洲,2023-07-05,9857
6190,萬泰科,36,2,34,元大-蘆洲,2023-07-05,9857
4763,材料-KY,45,11,34,元大-蘆洲,2023-07-05,9857
3706,神達,66,32,34,元大-蘆洲,2023-07-05,9857
2324,仁寶,43,13,30,元大-蘆洲,2023-07-05,9857
00673R,期元大S＆P原油反1,30,0,30,元大-蘆洲,2023-07-05,9857
2618,長榮航,236,209,27,元大-蘆洲,2023-07-05,9857
2399,映泰,39,12,27,元大-蘆洲,2023-07-05,9857
6153,嘉聯益,28,2,26,元大-蘆洲,2023-07-05,9857
1734,杏輝,25,0,25,元大-蘆洲,2023-07-05,9857
1101,台泥,25,0,25,元大-蘆洲,2023-07-05,9857
5243,乙盛-KY,33,11,22,元大-蘆洲,2023-07-05,9857
1301,台塑,21,0,21,元大-蘆洲,2023-07-05,9857
1785,光洋科,20,0,20,元大-蘆洲,2023-07-05,9857
1608,華榮,37,17,20,元大-蘆洲,2023-07-05,9857
1905,華紙,31,12,19,元大-蘆洲,2023-07-05,9857
2359,所羅門,21,2,19,元大-蘆洲,2023-07-05,9857
1513,中興電,32,14,18,元大-蘆洲,2023-07-05,9857
3363,上詮,28,10,18,元大-蘆洲,2023-07-05,9857
1795,美時,33,15,18,元大-蘆洲,2023-07-05,9857
3114,好德,18,0,18,元大-蘆洲,2023-07-05,9857
2454,聯發科,17,0,17,元大-蘆洲,2023-07-05,9857
3356,奇偶,27,10,17,元大-蘆洲,2023-07-05,9857
00888,永豐台灣ESG,17,0,17,元大-蘆洲,2023-07-05,9857
5465,富驊,18,2,16,元大-蘆洲,2023-07-05,9857
2867,三商壽,15,0,15,元大-蘆洲,2023-07-05,9857
3260,威剛,33,18,15,元大-蘆洲,2023-07-05,9857
00929,復華台灣科技優息,242,0,242,元大-蘆洲,2023-07-06,9857
2409,友達,164,31,133,元大-蘆洲,2023-07-06,9857
2609,陽明,197,74,123,元大-蘆洲,2023-07-06,9857
00706L,期元大S＆P日圓正2,110,0,110,元大-蘆洲,2023-07-06,9857
2883,凱基金,112,2,110,元大-蘆洲,2023-07-06,9857
2363,矽統,100,0,100,元大-蘆洲,2023-07-06,9857
00882,中信中國高股息,85,0,85,元大-蘆洲,2023-07-06,9857
0056,元大高股息,108,30,78,元大-蘆洲,2023-07-06,9857
00687B,國泰20年美債,76,3,73,元大-蘆洲,2023-07-06,9857
2323,中環,77,6,71,元大-蘆洲,2023-07-06,9857
00919,群益台灣精選高息,65,0,65,元大-蘆洲,2023-07-06,9857
2887,台新金,82,18,64,元大-蘆洲,2023-07-06,9857
3049,精金,63,0,63,元大-蘆洲,2023-07-06,9857
2885,元大金,59,0,59,元大-蘆洲,2023-07-06,9857
8215,明基材,83,25,58,元大-蘆洲,2023-07-06,9857
1504,東元,65,9,56,元大-蘆洲,2023-07-06,9857
1609,大亞,65,10,55,元大-蘆洲,2023-07-06,9857
2891,中信金,60,6,54,元大-蘆洲,2023-07-06,9857
2382,廣達,125,73,52,元大-蘆洲,2023-07-06,9857
00878,國泰永續高股息,87,36,51,元大-蘆洲,2023-07-06,9857
00648R,元大S＆P500反1,50,0,50,元大-蘆洲,2023-07-06,9857
3037,欣興,58,10,48,元大-蘆洲,2023-07-06,9857
2880,華南金,45,0,45,元大-蘆洲,2023-07-06,9857
2356,英業達,159,115,44,元大-蘆洲,2023-07-06,9857
4414,如興,45,2,43,元大-蘆洲,2023-07-06,9857
2002,中鋼,49,7,42,元大-蘆洲,2023-07-06,9857
00720B,元大投資級公司債,45,3,42,元大-蘆洲,2023-07-06,9857
2317,鴻海,76,34,42,元大-蘆洲,2023-07-06,9857
6282,康舒,99,61,38,元大-蘆洲,2023-07-06,9857
2890,永豐金,41,5,36,元大-蘆洲,2023-07-06,9857
2303,聯電,40,6,34,元大-蘆洲,2023-07-06,9857
2329,華泰,55,21,34,元大-蘆洲,2023-07-06,9857
3379,彬台,33,0,33,元大-蘆洲,2023-07-06,9857
00712,復華富時不動產,34,2,32,元大-蘆洲,2023-07-06,9857
2402,毅嘉,44,13,31,元大-蘆洲,2023-07-06,9857
1605,華新,46,15,31,元大-蘆洲,2023-07-06,9857
4167,松瑞藥,31,0,31,元大-蘆洲,2023-07-06,9857
2330,台積電,39,10,29,元大-蘆洲,2023-07-06,9857
4915,致伸,29,1,28,元大-蘆洲,2023-07-06,9857
6770,力積電,29,1,28,元大-蘆洲,2023-07-06,9857
6417,韋僑,31,3,28,元大-蘆洲,2023-07-06,9857
2882,國泰金,28,0,28,元大-蘆洲,2023-07-06,9857
00665L,富邦�琤肭磪囓�2,69,43,26,元大-蘆洲,2023-07-06,9857
2436,偉詮電,31,5,26,元大-蘆洲,2023-07-06,9857
2371,大同,35,9,26,元大-蘆洲,2023-07-06,9857
4566,時碩工業,49,23,26,元大-蘆洲,2023-07-06,9857
1101,台泥,39,13,26,元大-蘆洲,2023-07-06,9857
00673R,期元大S＆P原油反1,25,0,25,元大-蘆洲,2023-07-06,9857
1303,南亞,24,0,24,元大-蘆洲,2023-07-06,9857
00751B,元大AAA至A公司債,24,1,23,元大-蘆洲,2023-07-06,9857
4532,瑞智,672,172,500,元大-蘆洲,2023-07-07,9857
2303,聯電,201,9,192,元大-蘆洲,2023-07-07,9857
00637L,元大滬深300正2,133,5,128,元大-蘆洲,2023-07-07,9857
00720B,元大投資級公司債,127,0,127,元大-蘆洲,2023-07-07,9857
00929,復華台灣科技優息,123,0,123,元大-蘆洲,2023-07-07,9857
3576,聯合再生,202,100,102,元大-蘆洲,2023-07-07,9857
2344,華邦電,88,7,81,元大-蘆洲,2023-07-07,9857
3060,銘異,80,13,67,元大-蘆洲,2023-07-07,9857
6116,彩晶,79,13,66,元大-蘆洲,2023-07-07,9857
3704,合勤控,89,24,65,元大-蘆洲,2023-07-07,9857
00679B,元大美債20年,64,0,64,元大-蘆洲,2023-07-07,9857
1514,亞力,61,3,58,元大-蘆洲,2023-07-07,9857
00687B,國泰20年美債,57,0,57,元大-蘆洲,2023-07-07,9857
1802,台玻,53,0,53,元大-蘆洲,2023-07-07,9857
2887,台新金,56,5,51,元大-蘆洲,2023-07-07,9857
2845,遠東銀,50,0,50,元大-蘆洲,2023-07-07,9857
1513,中興電,67,22,45,元大-蘆洲,2023-07-07,9857
3231,緯創,250,206,44,元大-蘆洲,2023-07-07,9857
00882,中信中國高股息,50,6,44,元大-蘆洲,2023-07-07,9857
1616,億泰,43,0,43,元大-蘆洲,2023-07-07,9857
00665L,富邦�琤肭磪囓�2,50,8,42,元大-蘆洲,2023-07-07,9857
3694,海華,50,10,40,元大-蘆洲,2023-07-07,9857
2382,廣達,70,34,36,元大-蘆洲,2023-07-07,9857
00878,國泰永續高股息,171,138,33,元大-蘆洲,2023-07-07,9857
2885,元大金,43,12,31,元大-蘆洲,2023-07-07,9857
00919,群益台灣精選高息,31,0,31,元大-蘆洲,2023-07-07,9857
1314,中石化,33,3,30,元大-蘆洲,2023-07-07,9857
2206,三陽工業,31,5,26,元大-蘆洲,2023-07-07,9857
2609,陽明,68,42,26,元大-蘆洲,2023-07-07,9857
2888,新光金,29,4,25,元大-蘆洲,2023-07-07,9857
2881,富邦金,38,13,25,元大-蘆洲,2023-07-07,9857
1806,冠軍,25,0,25,元大-蘆洲,2023-07-07,9857
5388,中磊,52,28,24,元大-蘆洲,2023-07-07,9857
3033,威健,67,43,24,元大-蘆洲,2023-07-07,9857
3363,上詮,47,23,24,元大-蘆洲,2023-07-07,9857
2427,三商電,41,18,23,元大-蘆洲,2023-07-07,9857
3714,富采,23,0,23,元大-蘆洲,2023-07-07,9857
3042,晶技,23,0,23,元大-蘆洲,2023-07-07,9857
3006,晶豪科,28,5,23,元大-蘆洲,2023-07-07,9857
4726,永昕,25,3,22,元大-蘆洲,2023-07-07,9857
2889,國票金,21,0,21,元大-蘆洲,2023-07-07,9857
020038,元大ESG配息N,20,0,20,元大-蘆洲,2023-07-07,9857
6108,競國,20,0,20,元大-蘆洲,2023-07-07,9857
1608,華榮,20,0,20,元大-蘆洲,2023-07-07,9857
2504,國產,20,0,20,元大-蘆洲,2023-07-07,9857
2468,華經,26,6,20,元大-蘆洲,2023-07-07,9857
00712,復華富時不動產,27,8,19,元大-蘆洲,2023-07-07,9857
2449,京元電子,21,2,19,元大-蘆洲,2023-07-07,9857
8201,無敵,19,0,19,元大-蘆洲,2023-07-07,9857
3037,欣興,21,2,19,元大-蘆洲,2023-07-07,9857
3576,聯合再生,315,0,315,元大-蘆洲,2023-07-10,9857
8050,廣積,107,5,102,元大-蘆洲,2023-07-10,9857
2359,所羅門,122,21,101,元大-蘆洲,2023-07-10,9857
00919,群益台灣精選高息,92,0,92,元大-蘆洲,2023-07-10,9857
3363,上詮,112,24,88,元大-蘆洲,2023-07-10,9857
00679B,元大美債20年,86,3,83,元大-蘆洲,2023-07-10,9857
2883,凱基金,123,48,75,元大-蘆洲,2023-07-10,9857
00673R,期元大S＆P原油反1,70,1,69,元大-蘆洲,2023-07-10,9857
5439,高技,102,38,64,元大-蘆洲,2023-07-10,9857
2609,陽明,132,76,56,元大-蘆洲,2023-07-10,9857
6770,力積電,48,1,47,元大-蘆洲,2023-07-10,9857
6016,康和證,92,50,42,元大-蘆洲,2023-07-10,9857
00929,復華台灣科技優息,39,0,39,元大-蘆洲,2023-07-10,9857
8255,朋程,48,12,36,元大-蘆洲,2023-07-10,9857
5864,致和證,36,0,36,元大-蘆洲,2023-07-10,9857
00720B,元大投資級公司債,49,13,36,元大-蘆洲,2023-07-10,9857
00753L,中信中國50正2,34,0,34,元大-蘆洲,2023-07-10,9857
3305,昇貿,55,22,33,元大-蘆洲,2023-07-10,9857
2618,長榮航,55,23,32,元大-蘆洲,2023-07-10,9857
2312,金寶,45,13,32,元大-蘆洲,2023-07-10,9857
00891,中信關鍵半導體,41,10,31,元大-蘆洲,2023-07-10,9857
1504,東元,74,44,30,元大-蘆洲,2023-07-10,9857
1626,艾美特-KY,31,1,30,元大-蘆洲,2023-07-10,9857
3712,永崴投控,30,0,30,元大-蘆洲,2023-07-10,9857
3715,定穎投控,40,10,30,元大-蘆洲,2023-07-10,9857
1101,台泥,33,4,29,元大-蘆洲,2023-07-10,9857
2436,偉詮電,42,14,28,元大-蘆洲,2023-07-10,9857
4927,泰鼎-KY,28,0,28,元大-蘆洲,2023-07-10,9857
4906,正文,31,4,27,元大-蘆洲,2023-07-10,9857
00687B,國泰20年美債,26,0,26,元大-蘆洲,2023-07-10,9857
00772B,中信高評級公司債,24,0,24,元大-蘆洲,2023-07-10,9857
2419,仲琦,69,46,23,元大-蘆洲,2023-07-10,9857
1905,華紙,23,1,22,元大-蘆洲,2023-07-10,9857
2201,裕隆,21,1,20,元大-蘆洲,2023-07-10,9857
3059,華晶科,20,0,20,元大-蘆洲,2023-07-10,9857
1618,合機,25,5,20,元大-蘆洲,2023-07-10,9857
6190,萬泰科,55,36,19,元大-蘆洲,2023-07-10,9857
6577,勁豐,19,0,19,元大-蘆洲,2023-07-10,9857
4953,緯軟,18,0,18,元大-蘆洲,2023-07-10,9857
3078,僑威,52,34,18,元大-蘆洲,2023-07-10,9857
2356,英業達,51,34,17,元大-蘆洲,2023-07-10,9857
00751B,元大AAA至A公司債,20,3,17,元大-蘆洲,2023-07-10,9857
2405,輔信,17,0,17,元大-蘆洲,2023-07-10,9857
4552,力達-KY,17,0,17,元大-蘆洲,2023-07-10,9857
00712,復華富時不動產,17,0,17,元大-蘆洲,2023-07-10,9857
00662,富邦NASDAQ,17,0,17,元大-蘆洲,2023-07-10,9857
00882,中信中國高股息,22,6,16,元大-蘆洲,2023-07-10,9857
5381,合正,17,1,16,元大-蘆洲,2023-07-10,9857
4726,永昕,16,0,16,元大-蘆洲,2023-07-10,9857
00927,群益半導體收益,16,0,16,元大-蘆洲,2023-07-10,9857
2301,光寶科,210,24,186,元大-蘆洲,2023-07-11,9857
3576,聯合再生,209,30,179,元大-蘆洲,2023-07-11,9857
2618,長榮航,206,78,128,元大-蘆洲,2023-07-11,9857
4532,瑞智,117,9,108,元大-蘆洲,2023-07-11,9857
2340,台亞,201,102,99,元大-蘆洲,2023-07-11,9857
00673R,期元大S＆P原油反1,96,0,96,元大-蘆洲,2023-07-11,9857
2356,英業達,211,128,83,元大-蘆洲,2023-07-11,9857
6116,彩晶,95,13,82,元大-蘆洲,2023-07-11,9857
6426,統新,52,2,50,元大-蘆洲,2023-07-11,9857
6026,福邦證,48,0,48,元大-蘆洲,2023-07-11,9857
3025,星通,103,60,43,元大-蘆洲,2023-07-11,9857
5009,榮剛,39,4,35,元大-蘆洲,2023-07-11,9857
2457,飛宏,137,103,34,元大-蘆洲,2023-07-11,9857
2609,陽明,78,48,30,元大-蘆洲,2023-07-11,9857
3356,奇偶,38,9,29,元大-蘆洲,2023-07-11,9857
2208,台船,31,2,29,元大-蘆洲,2023-07-11,9857
4934,太極,44,16,28,元大-蘆洲,2023-07-11,9857
6142,友勁,28,0,28,元大-蘆洲,2023-07-11,9857
9929,秋雨,28,0,28,元大-蘆洲,2023-07-11,9857
3038,全台,32,6,26,元大-蘆洲,2023-07-11,9857
00665L,富邦�琤肭磪囓�2,66,40,26,元大-蘆洲,2023-07-11,9857
1540,喬福,26,1,25,元大-蘆洲,2023-07-11,9857
8155,博智,32,7,25,元大-蘆洲,2023-07-11,9857
4510,高鋒,37,14,23,元大-蘆洲,2023-07-11,9857
00632R,元大台灣50反1,32,10,22,元大-蘆洲,2023-07-11,9857
2883,凱基金,32,10,22,元大-蘆洲,2023-07-11,9857
00929,復華台灣科技優息,21,0,21,元大-蘆洲,2023-07-11,9857
1314,中石化,21,0,21,元大-蘆洲,2023-07-11,9857
2444,兆勁,21,0,21,元大-蘆洲,2023-07-11,9857
2402,毅嘉,28,7,21,元大-蘆洲,2023-07-11,9857
2498,宏達電,48,28,20,元大-蘆洲,2023-07-11,9857
2329,華泰,66,47,19,元大-蘆洲,2023-07-11,9857
2801,彰銀,20,1,19,元大-蘆洲,2023-07-11,9857
6182,合晶,27,9,18,元大-蘆洲,2023-07-11,9857
00679B,元大美債20年,18,1,17,元大-蘆洲,2023-07-11,9857
1608,華榮,25,8,17,元大-蘆洲,2023-07-11,9857
00882,中信中國高股息,19,3,16,元大-蘆洲,2023-07-11,9857
1504,東元,55,39,16,元大-蘆洲,2023-07-11,9857
1514,亞力,40,24,16,元大-蘆洲,2023-07-11,9857
6234,高僑,28,13,15,元大-蘆洲,2023-07-11,9857
00662,富邦NASDAQ,15,0,15,元大-蘆洲,2023-07-11,9857
2881,富邦金,17,3,14,元大-蘆洲,2023-07-11,9857
2421,建準,42,28,14,元大-蘆洲,2023-07-11,9857
2359,所羅門,21,7,14,元大-蘆洲,2023-07-11,9857
6148,驊宏資,16,3,13,元大-蘆洲,2023-07-11,9857
020038,元大ESG配息N,14,1,13,元大-蘆洲,2023-07-11,9857
1810,和成,13,0,13,元大-蘆洲,2023-07-11,9857
00720B,元大投資級公司債,13,0,13,元大-蘆洲,2023-07-11,9857
4526,東台,49,36,13,元大-蘆洲,2023-07-11,9857
4960,誠美材,21,8,13,元大-蘆洲,2023-07-11,9857
3231,緯創,506,294,212,元大-蘆洲,2023-07-12,9857
2356,英業達,420,289,131,元大-蘆洲,2023-07-12,9857
2481,強茂,139,56,83,元大-蘆洲,2023-07-12,9857
3706,神達,234,160,74,元大-蘆洲,2023-07-12,9857
1608,華榮,74,0,74,元大-蘆洲,2023-07-12,9857
3521,鴻翊,65,0,65,元大-蘆洲,2023-07-12,9857
2323,中環,81,17,64,元大-蘆洲,2023-07-12,9857
00673R,期元大S＆P原油反1,57,0,57,元大-蘆洲,2023-07-12,9857
3207,耀勝,70,15,55,元大-蘆洲,2023-07-12,9857
2609,陽明,147,94,53,元大-蘆洲,2023-07-12,9857
4906,正文,54,2,52,元大-蘆洲,2023-07-12,9857
6426,統新,47,1,46,元大-蘆洲,2023-07-12,9857
00929,復華台灣科技優息,70,27,43,元大-蘆洲,2023-07-12,9857
6142,友勁,40,2,38,元大-蘆洲,2023-07-12,9857
3652,精聯,39,2,37,元大-蘆洲,2023-07-12,9857
3305,昇貿,45,13,32,元大-蘆洲,2023-07-12,9857
2515,中工,31,0,31,元大-蘆洲,2023-07-12,9857
2897,王道銀行,30,0,30,元大-蘆洲,2023-07-12,9857
00679B,元大美債20年,32,4,28,元大-蘆洲,2023-07-12,9857
4306,炎洲,28,0,28,元大-蘆洲,2023-07-12,9857
2324,仁寶,35,9,26,元大-蘆洲,2023-07-12,9857
00720B,元大投資級公司債,26,0,26,元大-蘆洲,2023-07-12,9857
00905,FT臺灣Smart,24,0,24,元大-蘆洲,2023-07-12,9857
2457,飛宏,48,25,23,元大-蘆洲,2023-07-12,9857
6548,長科*,25,2,23,元大-蘆洲,2023-07-12,9857
8070,長華*,27,5,22,元大-蘆洲,2023-07-12,9857
020023,元大櫃買半導體N,22,0,22,元大-蘆洲,2023-07-12,9857
2883,凱基金,25,4,21,元大-蘆洲,2023-07-12,9857
1519,華城,31,10,21,元大-蘆洲,2023-07-12,9857
2101,南港,21,0,21,元大-蘆洲,2023-07-12,9857
9904,寶成,20,0,20,元大-蘆洲,2023-07-12,9857
1301,台塑,24,4,20,元大-蘆洲,2023-07-12,9857
3025,星通,75,55,20,元大-蘆洲,2023-07-12,9857
3313,斐成,20,0,20,元大-蘆洲,2023-07-12,9857
3312,弘憶股,20,0,20,元大-蘆洲,2023-07-12,9857
6285,啟��,48,29,19,元大-蘆洲,2023-07-12,9857
3062,建漢,22,4,18,元大-蘆洲,2023-07-12,9857
4934,太極,39,21,18,元大-蘆洲,2023-07-12,9857
3583,辛耘,44,26,18,元大-蘆洲,2023-07-12,9857
00712,復華富時不動產,18,1,17,元大-蘆洲,2023-07-12,9857
2382,廣達,84,67,17,元大-蘆洲,2023-07-12,9857
2615,萬海,23,7,16,元大-蘆洲,2023-07-12,9857
6282,康舒,37,22,15,元大-蘆洲,2023-07-12,9857
2002,中鋼,15,0,15,元大-蘆洲,2023-07-12,9857
4976,佳凌,15,0,15,元大-蘆洲,2023-07-12,9857
1604,聲寶,56,41,15,元大-蘆洲,2023-07-12,9857
2425,承啟,21,7,14,元大-蘆洲,2023-07-12,9857
1584,精剛,14,1,13,元大-蘆洲,2023-07-12,9857
1611,中電,13,0,13,元大-蘆洲,2023-07-12,9857
2347,聯強,13,1,12,元大-蘆洲,2023-07-12,9857
2618,長榮航,416,111,305,元大-蘆洲,2023-07-13,9857
00632R,元大台灣50反1,339,58,281,元大-蘆洲,2023-07-13,9857
2359,所羅門,389,180,209,元大-蘆洲,2023-07-13,9857
2610,華航,307,182,125,元大-蘆洲,2023-07-13,9857
2609,陽明,224,107,117,元大-蘆洲,2023-07-13,9857
2303,聯電,86,13,73,元大-蘆洲,2023-07-13,9857
2312,金寶,288,222,66,元大-蘆洲,2023-07-13,9857
00712,復華富時不動產,110,50,60,元大-蘆洲,2023-07-13,9857
8936,國統,77,19,58,元大-蘆洲,2023-07-13,9857
00882,中信中國高股息,59,4,55,元大-蘆洲,2023-07-13,9857
00891,中信關鍵半導體,60,7,53,元大-蘆洲,2023-07-13,9857
00930,永豐ESG低碳高息,50,0,50,元大-蘆洲,2023-07-13,9857
1447,力鵬,50,0,50,元大-蘆洲,2023-07-13,9857
6142,友勁,50,0,50,元大-蘆洲,2023-07-13,9857
2881,富邦金,51,2,49,元大-蘆洲,2023-07-13,9857
2329,華泰,139,92,47,元大-蘆洲,2023-07-13,9857
2324,仁寶,238,191,47,元大-蘆洲,2023-07-13,9857
00929,復華台灣科技優息,102,56,46,元大-蘆洲,2023-07-13,9857
1314,中石化,57,14,43,元大-蘆洲,2023-07-13,9857
2337,旺宏,39,2,37,元大-蘆洲,2023-07-13,9857
2634,漢翔,47,12,35,元大-蘆洲,2023-07-13,9857
00673R,期元大S＆P原油反1,34,0,34,元大-蘆洲,2023-07-13,9857
6282,康舒,70,38,32,元大-蘆洲,2023-07-13,9857
00664R,國泰臺灣加權反1,31,0,31,元大-蘆洲,2023-07-13,9857
4743,合一,36,6,30,元大-蘆洲,2023-07-13,9857
00720B,元大投資級公司債,31,2,29,元大-蘆洲,2023-07-13,9857
4533,協易機,59,30,29,元大-蘆洲,2023-07-13,9857
6443,元晶,33,5,28,元大-蘆洲,2023-07-13,9857
2340,台亞,40,16,24,元大-蘆洲,2023-07-13,9857
2352,佳世達,110,87,23,元大-蘆洲,2023-07-13,9857
1504,東元,55,33,22,元大-蘆洲,2023-07-13,9857
8210,勤誠,50,28,22,元大-蘆洲,2023-07-13,9857
2206,三陽工業,22,1,21,元大-蘆洲,2023-07-13,9857
6188,廣明,75,54,21,元大-蘆洲,2023-07-13,9857
2362,藍天,22,2,20,元大-蘆洲,2023-07-13,9857
1783,和康生,20,0,20,元大-蘆洲,2023-07-13,9857
6276,安鈦克,25,5,20,元大-蘆洲,2023-07-13,9857
1513,中興電,43,23,20,元大-蘆洲,2023-07-13,9857
020023,元大櫃買半導體N,19,0,19,元大-蘆洲,2023-07-13,9857
2601,益航,21,2,19,元大-蘆洲,2023-07-13,9857
00905,FT臺灣Smart,24,5,19,元大-蘆洲,2023-07-13,9857
3078,僑威,50,31,19,元大-蘆洲,2023-07-13,9857
3321,同泰,18,0,18,元大-蘆洲,2023-07-13,9857
00927,群益半導體收益,20,2,18,元大-蘆洲,2023-07-13,9857
2883,凱基金,23,5,18,元大-蘆洲,2023-07-13,9857
6120,達運,109,91,18,元大-蘆洲,2023-07-13,9857
3032,偉訓,31,14,17,元大-蘆洲,2023-07-13,9857
6126,信音,20,3,17,元大-蘆洲,2023-07-13,9857
2736,富野,17,0,17,元大-蘆洲,2023-07-13,9857
3071,協禧,26,10,16,元大-蘆洲,2023-07-13,9857
2303,聯電,392,20,372,元大-蘆洲,2023-07-14,9857
2618,長榮航,419,286,133,元大-蘆洲,2023-07-14,9857
1301,台塑,106,5,101,元大-蘆洲,2023-07-14,9857
3363,上詮,163,80,83,元大-蘆洲,2023-07-14,9857
00632R,元大台灣50反1,76,2,74,元大-蘆洲,2023-07-14,9857
2498,宏達電,83,13,70,元大-蘆洲,2023-07-14,9857
00882,中信中國高股息,78,10,68,元大-蘆洲,2023-07-14,9857
2371,大同,157,92,65,元大-蘆洲,2023-07-14,9857
00673R,期元大S＆P原油反1,89,25,64,元大-蘆洲,2023-07-14,9857
00929,復華台灣科技優息,69,7,62,元大-蘆洲,2023-07-14,9857
8150,南茂,58,2,56,元大-蘆洲,2023-07-14,9857
2603,長榮,101,51,50,元大-蘆洲,2023-07-14,9857
00712,復華富時不動產,103,53,50,元大-蘆洲,2023-07-14,9857
8105,凌巨,49,4,45,元大-蘆洲,2023-07-14,9857
2609,陽明,102,58,44,元大-蘆洲,2023-07-14,9857
3032,偉訓,57,15,42,元大-蘆洲,2023-07-14,9857
4533,協易機,65,23,42,元大-蘆洲,2023-07-14,9857
1609,大亞,112,70,42,元大-蘆洲,2023-07-14,9857
00662,富邦NASDAQ,41,0,41,元大-蘆洲,2023-07-14,9857
4906,正文,48,8,40,元大-蘆洲,2023-07-14,9857
6185,幃翔,39,0,39,元大-蘆洲,2023-07-14,9857
2883,凱基金,43,6,37,元大-蘆洲,2023-07-14,9857
020038,元大ESG配息N,35,0,35,元大-蘆洲,2023-07-14,9857
2017,官田鋼,34,0,34,元大-蘆洲,2023-07-14,9857
3163,波若威,89,55,34,元大-蘆洲,2023-07-14,9857
00720B,元大投資級公司債,34,1,33,元大-蘆洲,2023-07-14,9857
2801,彰銀,32,0,32,元大-蘆洲,2023-07-14,9857
2421,建準,66,34,32,元大-蘆洲,2023-07-14,9857
5483,中美晶,58,27,31,元大-蘆洲,2023-07-14,9857
3264,欣銓,30,2,28,元大-蘆洲,2023-07-14,9857
2344,華邦電,33,5,28,元大-蘆洲,2023-07-14,9857
2419,仲琦,66,38,28,元大-蘆洲,2023-07-14,9857
8110,華東,27,0,27,元大-蘆洲,2023-07-14,9857
4916,事欣科,25,0,25,元大-蘆洲,2023-07-14,9857
2324,仁寶,38,15,23,元大-蘆洲,2023-07-14,9857
1432,大魯閣,23,0,23,元大-蘆洲,2023-07-14,9857
6285,啟��,34,11,23,元大-蘆洲,2023-07-14,9857
3325,旭品,32,10,22,元大-蘆洲,2023-07-14,9857
2301,光寶科,110,88,22,元大-蘆洲,2023-07-14,9857
00631L,元大台灣50正2,23,2,21,元大-蘆洲,2023-07-14,9857
5443,均豪,21,0,21,元大-蘆洲,2023-07-14,9857
4726,永昕,21,0,21,元大-蘆洲,2023-07-14,9857
1504,東元,94,73,21,元大-蘆洲,2023-07-14,9857
2328,廣宇,68,48,20,元大-蘆洲,2023-07-14,9857
3693,營邦,26,7,19,元大-蘆洲,2023-07-14,9857
2449,京元電子,24,6,18,元大-蘆洲,2023-07-14,9857
6282,康舒,40,22,18,元大-蘆洲,2023-07-14,9857
00679B,元大美債20年,24,7,17,元大-蘆洲,2023-07-14,9857
8227,巨有科技,18,2,16,元大-蘆洲,2023-07-14,9857
2436,偉詮電,32,17,15,元大-蘆洲,2023-07-14,9857
00673R,期元大S＆P原油反1,224,0,224,元大-蘆洲,2023-07-17,9857
2888,新光金,291,84,207,元大-蘆洲,2023-07-17,9857
4938,和碩,259,55,204,元大-蘆洲,2023-07-17,9857
00929,復華台灣科技優息,176,1,175,元大-蘆洲,2023-07-17,9857
3481,群創,317,180,137,元大-蘆洲,2023-07-17,9857
2010,春源,100,5,95,元大-蘆洲,2023-07-17,9857
2382,廣達,182,106,76,元大-蘆洲,2023-07-17,9857
2890,永豐金,100,27,73,元大-蘆洲,2023-07-17,9857
2610,華航,152,87,65,元大-蘆洲,2023-07-17,9857
2328,廣宇,87,24,63,元大-蘆洲,2023-07-17,9857
2371,大同,163,114,49,元大-蘆洲,2023-07-17,9857
00753L,中信中國50正2,44,0,44,元大-蘆洲,2023-07-17,9857
2340,台亞,100,58,42,元大-蘆洲,2023-07-17,9857
2329,華泰,88,46,42,元大-蘆洲,2023-07-17,9857
6188,廣明,71,32,39,元大-蘆洲,2023-07-17,9857
3706,神達,42,4,38,元大-蘆洲,2023-07-17,9857
3037,欣興,74,37,37,元大-蘆洲,2023-07-17,9857
5009,榮剛,38,2,36,元大-蘆洲,2023-07-17,9857
2363,矽統,31,1,30,元大-蘆洲,2023-07-17,9857
3033,威健,41,11,30,元大-蘆洲,2023-07-17,9857
5258,虹堡,62,33,29,元大-蘆洲,2023-07-17,9857
00720B,元大投資級公司債,29,0,29,元大-蘆洲,2023-07-17,9857
1608,華榮,30,2,28,元大-蘆洲,2023-07-17,9857
2881,富邦金,48,21,27,元大-蘆洲,2023-07-17,9857
5607,遠雄港,27,0,27,元大-蘆洲,2023-07-17,9857
6191,精成科,33,7,26,元大-蘆洲,2023-07-17,9857
5483,中美晶,30,5,25,元大-蘆洲,2023-07-17,9857
2405,輔信,25,0,25,元大-蘆洲,2023-07-17,9857
00637L,元大滬深300正2,42,18,24,元大-蘆洲,2023-07-17,9857
2313,華通,82,58,24,元大-蘆洲,2023-07-17,9857
2801,彰銀,26,2,24,元大-蘆洲,2023-07-17,9857
2338,光罩,30,6,24,元大-蘆洲,2023-07-17,9857
1301,台塑,24,0,24,元大-蘆洲,2023-07-17,9857
6235,華孚,37,14,23,元大-蘆洲,2023-07-17,9857
2515,中工,25,3,22,元大-蘆洲,2023-07-17,9857
3325,旭品,32,10,22,元大-蘆洲,2023-07-17,9857
00888,永豐台灣ESG,31,9,22,元大-蘆洲,2023-07-17,9857
2609,陽明,38,17,21,元大-蘆洲,2023-07-17,9857
2362,藍天,20,0,20,元大-蘆洲,2023-07-17,9857
00671R,富邦NASDAQ反1,20,0,20,元大-蘆洲,2023-07-17,9857
00664R,國泰臺灣加權反1,20,0,20,元大-蘆洲,2023-07-17,9857
4927,泰鼎-KY,20,0,20,元大-蘆洲,2023-07-17,9857
5301,寶得利,23,3,20,元大-蘆洲,2023-07-17,9857
2504,國產,20,0,20,元大-蘆洲,2023-07-17,9857
3005,神基,29,9,20,元大-蘆洲,2023-07-17,9857
4934,太極,31,12,19,元大-蘆洲,2023-07-17,9857
2388,威盛,90,71,19,元大-蘆洲,2023-07-17,9857
5439,高技,33,14,19,元大-蘆洲,2023-07-17,9857
00905,FT臺灣Smart,20,1,19,元大-蘆洲,2023-07-17,9857
1731,美吾華,19,0,19,元大-蘆洲,2023-07-17,9857
2324,仁寶,387,89,298,元大-蘆洲,2023-07-18,9857
00882,中信中國高股息,230,10,220,元大-蘆洲,2023-07-18,9857
2356,英業達,664,459,205,元大-蘆洲,2023-07-18,9857
2421,建準,250,64,186,元大-蘆洲,2023-07-18,9857
00929,復華台灣科技優息,235,73,162,元大-蘆洲,2023-07-18,9857
2312,金寶,342,199,143,元大-蘆洲,2023-07-18,9857
6282,康舒,302,177,125,元大-蘆洲,2023-07-18,9857
6188,廣明,148,39,109,元大-蘆洲,2023-07-18,9857
4414,如興,100,0,100,元大-蘆洲,2023-07-18,9857
1513,中興電,143,48,95,元大-蘆洲,2023-07-18,9857
2359,所羅門,115,36,79,元大-蘆洲,2023-07-18,9857
2883,凱基金,79,3,76,元大-蘆洲,2023-07-18,9857
00687B,國泰20年美債,87,15,72,元大-蘆洲,2023-07-18,9857
3481,群創,288,218,70,元大-蘆洲,2023-07-18,9857
2352,佳世達,232,164,68,元大-蘆洲,2023-07-18,9857
00679B,元大美債20年,62,1,61,元大-蘆洲,2023-07-18,9857
00720B,元大投資級公司債,64,6,58,元大-蘆洲,2023-07-18,9857
3363,上詮,67,17,50,元大-蘆洲,2023-07-18,9857
3711,日月光投控,47,2,45,元大-蘆洲,2023-07-18,9857
1514,亞力,125,80,45,元大-蘆洲,2023-07-18,9857
2481,強茂,118,74,44,元大-蘆洲,2023-07-18,9857
8033,雷虎,49,5,44,元大-蘆洲,2023-07-18,9857
6285,啟��,81,37,44,元大-蘆洲,2023-07-18,9857
4906,正文,62,19,43,元大-蘆洲,2023-07-18,9857
2353,宏��,160,117,43,元大-蘆洲,2023-07-18,9857
2881,富邦金,72,31,41,元大-蘆洲,2023-07-18,9857
1789,神隆,50,13,37,元大-蘆洲,2023-07-18,9857
0056,元大高股息,178,143,35,元大-蘆洲,2023-07-18,9857
2402,毅嘉,77,44,33,元大-蘆洲,2023-07-18,9857
3706,神達,263,232,31,元大-蘆洲,2023-07-18,9857
2329,華泰,158,127,31,元大-蘆洲,2023-07-18,9857
3033,威健,43,14,29,元大-蘆洲,2023-07-18,9857
2027,大成鋼,55,27,28,元大-蘆洲,2023-07-18,9857
5328,華容,27,0,27,元大-蘆洲,2023-07-18,9857
1313,聯成,39,12,27,元大-蘆洲,2023-07-18,9857
00715L,期街口布蘭特正2,26,0,26,元大-蘆洲,2023-07-18,9857
2449,京元電子,47,22,25,元大-蘆洲,2023-07-18,9857
00637L,元大滬深300正2,24,0,24,元大-蘆洲,2023-07-18,9857
8086,宏捷科,31,7,24,元大-蘆洲,2023-07-18,9857
2515,中工,34,10,24,元大-蘆洲,2023-07-18,9857
2887,台新金,41,17,24,元大-蘆洲,2023-07-18,9857
1314,中石化,24,0,24,元大-蘆洲,2023-07-18,9857
2520,冠德,23,0,23,元大-蘆洲,2023-07-18,9857
6517,保勝光學,23,0,23,元大-蘆洲,2023-07-18,9857
6142,友勁,25,2,23,元大-蘆洲,2023-07-18,9857
3305,昇貿,84,62,22,元大-蘆洲,2023-07-18,9857
00712,復華富時不動產,24,2,22,元大-蘆洲,2023-07-18,9857
4934,太極,35,14,21,元大-蘆洲,2023-07-18,9857
2337,旺宏,28,7,21,元大-蘆洲,2023-07-18,9857
6026,福邦證,20,0,20,元大-蘆洲,2023-07-18,9857
2888,新光金,323,96,227,元大-蘆洲,2023-07-19,9857
2883,凱基金,242,22,220,元大-蘆洲,2023-07-19,9857
00929,復華台灣科技優息,213,54,159,元大-蘆洲,2023-07-19,9857
4123,晟德,143,37,106,元大-蘆洲,2023-07-19,9857
6226,光鼎,100,0,100,元大-蘆洲,2023-07-19,9857
2881,富邦金,110,12,98,元大-蘆洲,2023-07-19,9857
2329,華泰,146,50,96,元大-蘆洲,2023-07-19,9857
2515,中工,88,2,86,元大-蘆洲,2023-07-19,9857
00632R,元大台灣50反1,85,16,69,元大-蘆洲,2023-07-19,9857
00637L,元大滬深300正2,272,204,68,元大-蘆洲,2023-07-19,9857
4566,時碩工業,93,26,67,元大-蘆洲,2023-07-19,9857
6235,華孚,118,55,63,元大-蘆洲,2023-07-19,9857
2317,鴻海,97,41,56,元大-蘆洲,2023-07-19,9857
2402,毅嘉,53,0,53,元大-蘆洲,2023-07-19,9857
6282,康舒,144,94,50,元大-蘆洲,2023-07-19,9857
3078,僑威,75,31,44,元大-蘆洲,2023-07-19,9857
2885,元大金,53,10,43,元大-蘆洲,2023-07-19,9857
2303,聯電,112,72,40,元大-蘆洲,2023-07-19,9857
3694,海華,40,1,39,元大-蘆洲,2023-07-19,9857
1611,中電,40,1,39,元大-蘆洲,2023-07-19,9857
2312,金寶,151,112,39,元大-蘆洲,2023-07-19,9857
6116,彩晶,95,57,38,元大-蘆洲,2023-07-19,9857
2352,佳世達,102,68,34,元大-蘆洲,2023-07-19,9857
5880,合庫金,32,1,31,元大-蘆洲,2023-07-19,9857
1513,中興電,31,1,30,元大-蘆洲,2023-07-19,9857
3035,智原,73,44,29,元大-蘆洲,2023-07-19,9857
00662,富邦NASDAQ,30,2,28,元大-蘆洲,2023-07-19,9857
2353,宏��,111,83,28,元大-蘆洲,2023-07-19,9857
6182,合晶,35,8,27,元大-蘆洲,2023-07-19,9857
2328,廣宇,45,19,26,元大-蘆洲,2023-07-19,9857
1314,中石化,24,0,24,元大-蘆洲,2023-07-19,9857
9105,泰金寶-DR,36,12,24,元大-蘆洲,2023-07-19,9857
1605,華新,29,6,23,元大-蘆洲,2023-07-19,9857
5269,祥碩,28,5,23,元大-蘆洲,2023-07-19,9857
2481,強茂,62,39,23,元大-蘆洲,2023-07-19,9857
2603,長榮,53,32,21,元大-蘆洲,2023-07-19,9857
6188,廣明,86,65,21,元大-蘆洲,2023-07-19,9857
1608,華榮,22,1,21,元大-蘆洲,2023-07-19,9857
1522,堤維西,21,0,21,元大-蘆洲,2023-07-19,9857
2801,彰銀,46,25,21,元大-蘆洲,2023-07-19,9857
5009,榮剛,31,10,21,元大-蘆洲,2023-07-19,9857
2340,台亞,41,21,20,元大-蘆洲,2023-07-19,9857
6505,台塑化,20,0,20,元大-蘆洲,2023-07-19,9857
0050,元大台灣50,20,0,20,元大-蘆洲,2023-07-19,9857
2313,華通,42,23,19,元大-蘆洲,2023-07-19,9857
1101,台泥,32,13,19,元大-蘆洲,2023-07-19,9857
4104,佳醫,20,1,19,元大-蘆洲,2023-07-19,9857
00671R,富邦NASDAQ反1,19,0,19,元大-蘆洲,2023-07-19,9857
2324,仁寶,390,371,19,元大-蘆洲,2023-07-19,9857
3338,泰碩,25,7,18,元大-蘆洲,2023-07-19,9857
3703,欣陸,140,0,140,元大-蘆洲,2023-07-20,9857
9958,世紀鋼,131,8,123,元大-蘆洲,2023-07-20,9857
00632R,元大台灣50反1,122,0,122,元大-蘆洲,2023-07-20,9857
1529,樂事綠能,124,7,117,元大-蘆洲,2023-07-20,9857
6282,康舒,211,106,105,元大-蘆洲,2023-07-20,9857
6770,力積電,101,18,83,元大-蘆洲,2023-07-20,9857
00673R,期元大S＆P原油反1,83,0,83,元大-蘆洲,2023-07-20,9857
3481,群創,83,8,75,元大-蘆洲,2023-07-20,9857
1528,恩德,69,1,68,元大-蘆洲,2023-07-20,9857
3037,欣興,74,15,59,元大-蘆洲,2023-07-20,9857
2206,三陽工業,125,70,55,元大-蘆洲,2023-07-20,9857
2312,金寶,76,24,52,元大-蘆洲,2023-07-20,9857
3032,偉訓,93,44,49,元大-蘆洲,2023-07-20,9857
2515,中工,37,0,37,元大-蘆洲,2023-07-20,9857
00929,復華台灣科技優息,37,2,35,元大-蘆洲,2023-07-20,9857
2634,漢翔,50,17,33,元大-蘆洲,2023-07-20,9857
3694,海華,31,1,30,元大-蘆洲,2023-07-20,9857
2748,雲品,50,20,30,元大-蘆洲,2023-07-20,9857
1102,亞泥,30,0,30,元大-蘆洲,2023-07-20,9857
4123,晟德,114,85,29,元大-蘆洲,2023-07-20,9857
00662,富邦NASDAQ,29,0,29,元大-蘆洲,2023-07-20,9857
00882,中信中國高股息,39,11,28,元大-蘆洲,2023-07-20,9857
2419,仲琦,83,56,27,元大-蘆洲,2023-07-20,9857
2329,華泰,58,32,26,元大-蘆洲,2023-07-20,9857
2465,麗臺,26,0,26,元大-蘆洲,2023-07-20,9857
4919,新唐,54,28,26,元大-蘆洲,2023-07-20,9857
1464,得力,25,0,25,元大-蘆洲,2023-07-20,9857
2609,陽明,81,57,24,元大-蘆洲,2023-07-20,9857
1786,科妍,30,6,24,元大-蘆洲,2023-07-20,9857
2883,凱基金,24,1,23,元大-蘆洲,2023-07-20,9857
2801,彰銀,23,0,23,元大-蘆洲,2023-07-20,9857
4746,台耀,30,7,23,元大-蘆洲,2023-07-20,9857
2481,強茂,33,10,23,元大-蘆洲,2023-07-20,9857
00679B,元大美債20年,25,4,21,元大-蘆洲,2023-07-20,9857
1101,台泥,21,0,21,元大-蘆洲,2023-07-20,9857
2443,昶虹,21,0,21,元大-蘆洲,2023-07-20,9857
2330,台積電,28,8,20,元大-蘆洲,2023-07-20,9857
8936,國統,26,6,20,元大-蘆洲,2023-07-20,9857
00905,FT臺灣Smart,20,0,20,元大-蘆洲,2023-07-20,9857
9933,中鼎,20,0,20,元大-蘆洲,2023-07-20,9857
6026,福邦證,20,0,20,元大-蘆洲,2023-07-20,9857
2337,旺宏,24,4,20,元大-蘆洲,2023-07-20,9857
00919,群益台灣精選高息,19,0,19,元大-蘆洲,2023-07-20,9857
2014,中鴻,37,19,18,元大-蘆洲,2023-07-20,9857
2371,大同,30,12,18,元大-蘆洲,2023-07-20,9857
8926,台汽電,18,0,18,元大-蘆洲,2023-07-20,9857
0056,元大高股息,55,37,18,元大-蘆洲,2023-07-20,9857
020038,元大ESG配息N,17,0,17,元大-蘆洲,2023-07-20,9857
2881,富邦金,23,7,16,元大-蘆洲,2023-07-20,9857
00885,富邦越南,16,0,16,元大-蘆洲,2023-07-20,9857
2405,輔信,176,18,158,元大-蘆洲,2023-07-21,9857
2303,聯電,184,82,102,元大-蘆洲,2023-07-21,9857
2344,華邦電,100,9,91,元大-蘆洲,2023-07-21,9857
00680L,元大美債20正2,87,0,87,元大-蘆洲,2023-07-21,9857
2206,三陽工業,99,12,87,元大-蘆洲,2023-07-21,9857
1513,中興電,168,94,74,元大-蘆洲,2023-07-21,9857
2312,金寶,93,21,72,元大-蘆洲,2023-07-21,9857
00929,復華台灣科技優息,70,5,65,元大-蘆洲,2023-07-21,9857
2489,瑞軒,62,0,62,元大-蘆洲,2023-07-21,9857
3682,亞太電,103,44,59,元大-蘆洲,2023-07-21,9857
3694,海華,71,16,55,元大-蘆洲,2023-07-21,9857
6443,元晶,54,1,53,元大-蘆洲,2023-07-21,9857
2027,大成鋼,78,26,52,元大-蘆洲,2023-07-21,9857
4526,東台,50,0,50,元大-蘆洲,2023-07-21,9857
1440,南紡,50,0,50,元大-蘆洲,2023-07-21,9857
2383,台光電,56,6,50,元大-蘆洲,2023-07-21,9857
2801,彰銀,50,5,45,元大-蘆洲,2023-07-21,9857
00673R,期元大S＆P原油反1,72,28,44,元大-蘆洲,2023-07-21,9857
2324,仁寶,80,37,43,元大-蘆洲,2023-07-21,9857
3044,健鼎,138,97,41,元大-蘆洲,2023-07-21,9857
2330,台積電,53,16,37,元大-蘆洲,2023-07-21,9857
5009,榮剛,36,2,34,元大-蘆洲,2023-07-21,9857
6679,鈺太,33,1,32,元大-蘆洲,2023-07-21,9857
1101,台泥,31,0,31,元大-蘆洲,2023-07-21,9857
3071,協禧,51,20,31,元大-蘆洲,2023-07-21,9857
2736,富野,34,3,31,元大-蘆洲,2023-07-21,9857
3037,欣興,54,23,31,元大-蘆洲,2023-07-21,9857
6188,廣明,69,40,29,元大-蘆洲,2023-07-21,9857
1584,精剛,36,7,29,元大-蘆洲,2023-07-21,9857
00670L,富邦NASDAQ正2,28,0,28,元大-蘆洲,2023-07-21,9857
00720B,元大投資級公司債,25,0,25,元大-蘆洲,2023-07-21,9857
00882,中信中國高股息,25,0,25,元大-蘆洲,2023-07-21,9857
2353,宏��,40,15,25,元大-蘆洲,2023-07-21,9857
1519,華城,25,1,24,元大-蘆洲,2023-07-21,9857
00712,復華富時不動產,60,37,23,元大-蘆洲,2023-07-21,9857
2352,佳世達,45,22,23,元大-蘆洲,2023-07-21,9857
1605,華新,50,28,22,元大-蘆洲,2023-07-21,9857
8222,寶一,34,13,21,元大-蘆洲,2023-07-21,9857
2363,矽統,20,0,20,元大-蘆洲,2023-07-21,9857
2867,三商壽,20,0,20,元大-蘆洲,2023-07-21,9857
6517,保勝光學,20,0,20,元大-蘆洲,2023-07-21,9857
00919,群益台灣精選高息,25,5,20,元大-蘆洲,2023-07-21,9857
6116,彩晶,102,82,20,元大-蘆洲,2023-07-21,9857
0050,元大台灣50,22,3,19,元大-蘆洲,2023-07-21,9857
2486,一詮,23,4,19,元大-蘆洲,2023-07-21,9857
2705,六福,21,2,19,元大-蘆洲,2023-07-21,9857
5469,瀚宇博,19,1,18,元大-蘆洲,2023-07-21,9857
6206,飛捷,18,0,18,元大-蘆洲,2023-07-21,9857
1760,寶齡富錦,17,0,17,元大-蘆洲,2023-07-21,9857
2409,友達,31,14,17,元大-蘆洲,2023-07-21,9857
1609,大亞,172,86,86,元大-蘆洲,2023-07-24,9857
3682,亞太電,75,18,57,元大-蘆洲,2023-07-24,9857
2890,永豐金,64,14,50,元大-蘆洲,2023-07-24,9857
3149,正達,50,0,50,元大-蘆洲,2023-07-24,9857
00662,富邦NASDAQ,50,0,50,元大-蘆洲,2023-07-24,9857
5608,四維航,50,1,49,元大-蘆洲,2023-07-24,9857
3037,欣興,114,67,47,元大-蘆洲,2023-07-24,9857
00929,復華台灣科技優息,50,4,46,元大-蘆洲,2023-07-24,9857
2419,仲琦,109,64,45,元大-蘆洲,2023-07-24,9857
1529,樂事綠能,46,6,40,元大-蘆洲,2023-07-24,9857
3312,弘憶股,40,0,40,元大-蘆洲,2023-07-24,9857
2801,彰銀,39,0,39,元大-蘆洲,2023-07-24,9857
2323,中環,43,4,39,元大-蘆洲,2023-07-24,9857
9958,世紀鋼,67,31,36,元大-蘆洲,2023-07-24,9857
1815,富喬,35,0,35,元大-蘆洲,2023-07-24,9857
2324,仁寶,59,24,35,元大-蘆洲,2023-07-24,9857
00673R,期元大S＆P原油反1,34,0,34,元大-蘆洲,2023-07-24,9857
2630,亞航,43,11,32,元大-蘆洲,2023-07-24,9857
1604,聲寶,30,0,30,元大-蘆洲,2023-07-24,9857
2337,旺宏,31,2,29,元大-蘆洲,2023-07-24,9857
3046,建��,33,4,29,元大-蘆洲,2023-07-24,9857
1504,東元,68,40,28,元大-蘆洲,2023-07-24,9857
2881,富邦金,29,2,27,元大-蘆洲,2023-07-24,9857
3032,偉訓,42,16,26,元大-蘆洲,2023-07-24,9857
3017,奇鋐,81,56,25,元大-蘆洲,2023-07-24,9857
4154,樂威科-KY,24,0,24,元大-蘆洲,2023-07-24,9857
00679B,元大美債20年,31,8,23,元大-蘆洲,2023-07-24,9857
00930,永豐ESG低碳高息,23,0,23,元大-蘆洲,2023-07-24,9857
8215,明基材,23,0,23,元大-蘆洲,2023-07-24,9857
2486,一詮,24,1,23,元大-蘆洲,2023-07-24,9857
2884,玉山金,28,6,22,元大-蘆洲,2023-07-24,9857
1101,台泥,29,7,22,元大-蘆洲,2023-07-24,9857
6168,宏齊,22,0,22,元大-蘆洲,2023-07-24,9857
2303,聯電,54,33,21,元大-蘆洲,2023-07-24,9857
1102,亞泥,22,1,21,元大-蘆洲,2023-07-24,9857
1514,亞力,34,13,21,元大-蘆洲,2023-07-24,9857
6111,大宇資,24,3,21,元大-蘆洲,2023-07-24,9857
2382,廣達,187,166,21,元大-蘆洲,2023-07-24,9857
4526,東台,20,0,20,元大-蘆洲,2023-07-24,9857
2031,新光鋼,30,10,20,元大-蘆洲,2023-07-24,9857
1608,華榮,20,0,20,元大-蘆洲,2023-07-24,9857
3013,晟銘電,177,157,20,元大-蘆洲,2023-07-24,9857
2312,金寶,34,15,19,元大-蘆洲,2023-07-24,9857
00720B,元大投資級公司債,22,3,19,元大-蘆洲,2023-07-24,9857
00637L,元大滬深300正2,128,110,18,元大-蘆洲,2023-07-24,9857
2880,華南金,18,0,18,元大-蘆洲,2023-07-24,9857
6679,鈺太,18,0,18,元大-蘆洲,2023-07-24,9857
3231,緯創,54,36,18,元大-蘆洲,2023-07-24,9857
6182,合晶,18,2,16,元大-蘆洲,2023-07-24,9857
2883,凱基金,16,0,16,元大-蘆洲,2023-07-24,9857
3576,聯合再生,100,1,99,元大-蘆洲,2023-07-25,9857
2382,廣達,302,217,85,元大-蘆洲,2023-07-25,9857
5009,榮剛,111,46,65,元大-蘆洲,2023-07-25,9857
00632R,元大台灣50反1,72,13,59,元大-蘆洲,2023-07-25,9857
6125,廣運,80,29,51,元大-蘆洲,2023-07-25,9857
2609,陽明,64,17,47,元大-蘆洲,2023-07-25,9857
00664R,國泰臺灣加權反1,40,0,40,元大-蘆洲,2023-07-25,9857
1815,富喬,55,15,40,元大-蘆洲,2023-07-25,9857
3583,辛耘,66,27,39,元大-蘆洲,2023-07-25,9857
1905,華紙,58,22,36,元大-蘆洲,2023-07-25,9857
00673R,期元大S＆P原油反1,65,29,36,元大-蘆洲,2023-07-25,9857
3029,零壹,37,1,36,元大-蘆洲,2023-07-25,9857
00679B,元大美債20年,47,12,35,元大-蘆洲,2023-07-25,9857
00715L,期街口布蘭特正2,46,11,35,元大-蘆洲,2023-07-25,9857
5474,聰泰,38,6,32,元大-蘆洲,2023-07-25,9857
8215,明基材,49,18,31,元大-蘆洲,2023-07-25,9857
1102,亞泥,33,2,31,元大-蘆洲,2023-07-25,9857
2031,新光鋼,31,0,31,元大-蘆洲,2023-07-25,9857
3702,大聯大,31,0,31,元大-蘆洲,2023-07-25,9857
3231,緯創,66,36,30,元大-蘆洲,2023-07-25,9857
1612,宏泰,49,20,29,元大-蘆洲,2023-07-25,9857
2542,興富發,28,0,28,元大-蘆洲,2023-07-25,9857
4726,永昕,33,6,27,元大-蘆洲,2023-07-25,9857
4123,晟德,37,10,27,元大-蘆洲,2023-07-25,9857
2338,光罩,27,1,26,元大-蘆洲,2023-07-25,9857
4906,正文,32,6,26,元大-蘆洲,2023-07-25,9857
3071,協禧,70,46,24,元大-蘆洲,2023-07-25,9857
00929,復華台灣科技優息,25,1,24,元大-蘆洲,2023-07-25,9857
5483,中美晶,31,7,24,元大-蘆洲,2023-07-25,9857
6282,康舒,39,16,23,元大-蘆洲,2023-07-25,9857
2387,精元,23,0,23,元大-蘆洲,2023-07-25,9857
6275,元山,27,5,22,元大-蘆洲,2023-07-25,9857
00795B,中信美國公債20年,21,0,21,元大-蘆洲,2023-07-25,9857
2201,裕隆,31,11,20,元大-蘆洲,2023-07-25,9857
1434,福懋,20,0,20,元大-蘆洲,2023-07-25,9857
02001L,富邦蘋果正二N,20,0,20,元大-蘆洲,2023-07-25,9857
2027,大成鋼,34,15,19,元大-蘆洲,2023-07-25,9857
2455,全新,22,3,19,元大-蘆洲,2023-07-25,9857
1752,南光,19,0,19,元大-蘆洲,2023-07-25,9857
2454,聯發科,19,0,19,元大-蘆洲,2023-07-25,9857
2206,三陽工業,34,16,18,元大-蘆洲,2023-07-25,9857
2495,普安,21,3,18,元大-蘆洲,2023-07-25,9857
1529,樂事綠能,23,5,18,元大-蘆洲,2023-07-25,9857
2449,京元電子,20,3,17,元大-蘆洲,2023-07-25,9857
2603,長榮,32,15,17,元大-蘆洲,2023-07-25,9857
5443,均豪,18,1,17,元大-蘆洲,2023-07-25,9857
4953,緯軟,27,10,17,元大-蘆洲,2023-07-25,9857
2301,光寶科,82,65,17,元大-蘆洲,2023-07-25,9857
6116,彩晶,29,13,16,元大-蘆洲,2023-07-25,9857
2748,雲品,16,1,15,元大-蘆洲,2023-07-25,9857
4533,協易機,650,146,504,元大-蘆洲,2023-07-26,9857
3576,聯合再生,503,0,503,元大-蘆洲,2023-07-26,9857
3481,群創,314,177,137,元大-蘆洲,2023-07-26,9857
1504,東元,419,298,121,元大-蘆洲,2023-07-26,9857
5475,德宏,117,0,117,元大-蘆洲,2023-07-26,9857
00929,復華台灣科技優息,101,32,69,元大-蘆洲,2023-07-26,9857
2329,華泰,312,250,62,元大-蘆洲,2023-07-26,9857
9958,世紀鋼,57,7,50,元大-蘆洲,2023-07-26,9857
00637L,元大滬深300正2,54,5,49,元大-蘆洲,2023-07-26,9857
2883,凱基金,66,24,42,元大-蘆洲,2023-07-26,9857
6274,台燿,62,21,41,元大-蘆洲,2023-07-26,9857
1609,大亞,53,14,39,元大-蘆洲,2023-07-26,9857
2303,聯電,44,6,38,元大-蘆洲,2023-07-26,9857
3088,艾訊,46,8,38,元大-蘆洲,2023-07-26,9857
2371,大同,66,31,35,元大-蘆洲,2023-07-26,9857
00712,復華富時不動產,45,11,34,元大-蘆洲,2023-07-26,9857
1471,首利,45,11,34,元大-蘆洲,2023-07-26,9857
8215,明基材,41,9,32,元大-蘆洲,2023-07-26,9857
00673R,期元大S＆P原油反1,31,0,31,元大-蘆洲,2023-07-26,9857
6275,元山,38,7,31,元大-蘆洲,2023-07-26,9857
1513,中興電,58,28,30,元大-蘆洲,2023-07-26,9857
1605,華新,85,55,30,元大-蘆洲,2023-07-26,9857
3694,海華,35,5,30,元大-蘆洲,2023-07-26,9857
00671R,富邦NASDAQ反1,30,0,30,元大-蘆洲,2023-07-26,9857
00680L,元大美債20正2,30,0,30,元大-蘆洲,2023-07-26,9857
00720B,元大投資級公司債,35,7,28,元大-蘆洲,2023-07-26,9857
00882,中信中國高股息,51,24,27,元大-蘆洲,2023-07-26,9857
6112,邁達特,80,53,27,元大-蘆洲,2023-07-26,9857
2337,旺宏,38,11,27,元大-蘆洲,2023-07-26,9857
2206,三陽工業,26,0,26,元大-蘆洲,2023-07-26,9857
2468,華經,40,14,26,元大-蘆洲,2023-07-26,9857
2421,建準,71,46,25,元大-蘆洲,2023-07-26,9857
2419,仲琦,74,50,24,元大-蘆洲,2023-07-26,9857
1104,環泥,24,0,24,元大-蘆洲,2023-07-26,9857
2344,華邦電,26,3,23,元大-蘆洲,2023-07-26,9857
6517,保勝光學,24,1,23,元大-蘆洲,2023-07-26,9857
4743,合一,24,1,23,元大-蘆洲,2023-07-26,9857
1618,合機,94,71,23,元大-蘆洲,2023-07-26,9857
2354,鴻準,38,16,22,元大-蘆洲,2023-07-26,9857
00679B,元大美債20年,26,5,21,元大-蘆洲,2023-07-26,9857
3540,曜越,26,6,20,元大-蘆洲,2023-07-26,9857
6155,鈞寶,20,0,20,元大-蘆洲,2023-07-26,9857
00927,群益半導體收益,18,0,18,元大-蘆洲,2023-07-26,9857
00930,永豐ESG低碳高息,18,0,18,元大-蘆洲,2023-07-26,9857
1815,富喬,29,11,18,元大-蘆洲,2023-07-26,9857
3265,台星科,18,1,17,元大-蘆洲,2023-07-26,9857
1529,樂事綠能,20,3,17,元大-蘆洲,2023-07-26,9857
4188,安克,17,0,17,元大-蘆洲,2023-07-26,9857
2328,廣宇,32,16,16,元大-蘆洲,2023-07-26,9857
6214,精誠,26,10,16,元大-蘆洲,2023-07-26,9857
00632R,元大台灣50反1,142,7,135,元大-蘆洲,2023-07-27,9857
6116,彩晶,176,82,94,元大-蘆洲,2023-07-27,9857
8110,華東,100,6,94,元大-蘆洲,2023-07-27,9857
3236,千如,107,29,78,元大-蘆洲,2023-07-27,9857
1605,華新,79,7,72,元大-蘆洲,2023-07-27,9857
2883,凱基金,85,14,71,元大-蘆洲,2023-07-27,9857
00664R,國泰臺灣加權反1,70,0,70,元大-蘆洲,2023-07-27,9857
2897,王道銀行,78,15,63,元大-蘆洲,2023-07-27,9857
3037,欣興,152,90,62,元大-蘆洲,2023-07-27,9857
00679B,元大美債20年,65,5,60,元大-蘆洲,2023-07-27,9857
4414,如興,60,1,59,元大-蘆洲,2023-07-27,9857
2002,中鋼,48,0,48,元大-蘆洲,2023-07-27,9857
2641,正德,48,2,46,元大-蘆洲,2023-07-27,9857
00929,復華台灣科技優息,47,1,46,元大-蘆洲,2023-07-27,9857
8390,金益鼎,47,2,45,元大-蘆洲,2023-07-27,9857
3231,緯創,73,32,41,元大-蘆洲,2023-07-27,9857
2324,仁寶,51,12,39,元大-蘆洲,2023-07-27,9857
1618,合機,62,25,37,元大-蘆洲,2023-07-27,9857
00673R,期元大S＆P原油反1,36,0,36,元大-蘆洲,2023-07-27,9857
00680L,元大美債20正2,36,0,36,元大-蘆洲,2023-07-27,9857
2382,廣達,136,100,36,元大-蘆洲,2023-07-27,9857
2453,凌群,48,13,35,元大-蘆洲,2023-07-27,9857
6188,廣明,125,91,34,元大-蘆洲,2023-07-27,9857
00687B,國泰20年美債,35,3,32,元大-蘆洲,2023-07-27,9857
2882,國泰金,68,38,30,元大-蘆洲,2023-07-27,9857
3576,聯合再生,53,23,30,元大-蘆洲,2023-07-27,9857
6282,康舒,134,107,27,元大-蘆洲,2023-07-27,9857
4979,華星光,56,31,25,元大-蘆洲,2023-07-27,9857
2206,三陽工業,26,2,24,元大-蘆洲,2023-07-27,9857
1608,華榮,40,16,24,元大-蘆洲,2023-07-27,9857
2359,所羅門,66,43,23,元大-蘆洲,2023-07-27,9857
3051,力特,24,1,23,元大-蘆洲,2023-07-27,9857
2340,台亞,40,18,22,元大-蘆洲,2023-07-27,9857
5410,國眾,25,3,22,元大-蘆洲,2023-07-27,9857
2881,富邦金,52,31,21,元大-蘆洲,2023-07-27,9857
2887,台新金,22,1,21,元大-蘆洲,2023-07-27,9857
2356,英業達,42,22,20,元大-蘆洲,2023-07-27,9857
00669R,國泰美國道瓊反1,20,0,20,元大-蘆洲,2023-07-27,9857
2634,漢翔,22,3,19,元大-蘆洲,2023-07-27,9857
2890,永豐金,33,14,19,元大-蘆洲,2023-07-27,9857
2603,長榮,33,14,19,元大-蘆洲,2023-07-27,9857
2471,資通,40,23,17,元大-蘆洲,2023-07-27,9857
3715,定穎投控,45,28,17,元大-蘆洲,2023-07-27,9857
6269,台郡,16,0,16,元大-蘆洲,2023-07-27,9857
2332,友訊,16,0,16,元大-蘆洲,2023-07-27,9857
8249,菱光,15,0,15,元大-蘆洲,2023-07-27,9857
1504,東元,28,14,14,元大-蘆洲,2023-07-27,9857
1314,中石化,15,1,14,元大-蘆洲,2023-07-27,9857
2303,聯電,48,34,14,元大-蘆洲,2023-07-27,9857
6290,良維,15,2,13,元大-蘆洲,2023-07-27,9857
2888,新光金,632,43,589,元大-蘆洲,2023-07-28,9857
3163,波若威,243,50,193,元大-蘆洲,2023-07-28,9857
2610,華航,261,69,192,元大-蘆洲,2023-07-28,9857
00679B,元大美債20年,204,15,189,元大-蘆洲,2023-07-28,9857
00687B,國泰20年美債,130,0,130,元大-蘆洲,2023-07-28,9857
1905,華紙,257,157,100,元大-蘆洲,2023-07-28,9857
3576,聯合再生,100,0,100,元大-蘆洲,2023-07-28,9857
00712,復華富時不動產,105,8,97,元大-蘆洲,2023-07-28,9857
1513,中興電,107,20,87,元大-蘆洲,2023-07-28,9857
2618,長榮航,126,52,74,元大-蘆洲,2023-07-28,9857
00720B,元大投資級公司債,81,12,69,元大-蘆洲,2023-07-28,9857
00673R,期元大S＆P原油反1,65,0,65,元大-蘆洲,2023-07-28,9857
2891,中信金,77,12,65,元大-蘆洲,2023-07-28,9857
2027,大成鋼,84,23,61,元大-蘆洲,2023-07-28,9857
00930,永豐ESG低碳高息,61,0,61,元大-蘆洲,2023-07-28,9857
00632R,元大台灣50反1,60,0,60,元大-蘆洲,2023-07-28,9857
2002,中鋼,64,7,57,元大-蘆洲,2023-07-28,9857
4967,十銓,58,12,46,元大-蘆洲,2023-07-28,9857
2355,敬鵬,45,0,45,元大-蘆洲,2023-07-28,9857
4533,協易機,50,6,44,元大-蘆洲,2023-07-28,9857
00665L,富邦�琤肭磪囓�2,48,4,44,元大-蘆洲,2023-07-28,9857
00751B,元大AAA至A公司債,43,0,43,元大-蘆洲,2023-07-28,9857
2606,裕民,91,48,43,元大-蘆洲,2023-07-28,9857
2323,中環,49,9,40,元大-蘆洲,2023-07-28,9857
3231,緯創,280,240,40,元大-蘆洲,2023-07-28,9857
1904,正隆,54,15,39,元大-蘆洲,2023-07-28,9857
4306,炎洲,40,2,38,元大-蘆洲,2023-07-28,9857
2369,菱生,84,47,37,元大-蘆洲,2023-07-28,9857
00680L,元大美債20正2,35,0,35,元大-蘆洲,2023-07-28,9857
2886,兆豐金,36,2,34,元大-蘆洲,2023-07-28,9857
2317,鴻海,36,2,34,元大-蘆洲,2023-07-28,9857
2881,富邦金,51,18,33,元大-蘆洲,2023-07-28,9857
00795B,中信美國公債20年,33,0,33,元大-蘆洲,2023-07-28,9857
3481,群創,239,206,33,元大-蘆洲,2023-07-28,9857
00772B,中信高評級公司債,31,1,30,元大-蘆洲,2023-07-28,9857
4961,天鈺,39,9,30,元大-蘆洲,2023-07-28,9857
3583,辛耘,42,12,30,元大-蘆洲,2023-07-28,9857
2915,潤泰全,30,0,30,元大-蘆洲,2023-07-28,9857
3706,神達,36,8,28,元大-蘆洲,2023-07-28,9857
6282,康舒,99,74,25,元大-蘆洲,2023-07-28,9857
6182,合晶,26,1,25,元大-蘆洲,2023-07-28,9857
2340,台亞,35,11,24,元大-蘆洲,2023-07-28,9857
1319,東陽,137,115,22,元大-蘆洲,2023-07-28,9857
6290,良維,35,14,21,元大-蘆洲,2023-07-28,9857
1216,統一,21,0,21,元大-蘆洲,2023-07-28,9857
1611,中電,20,0,20,元大-蘆洲,2023-07-28,9857
00664R,國泰臺灣加權反1,20,0,20,元大-蘆洲,2023-07-28,9857
6153,嘉聯益,20,0,20,元大-蘆洲,2023-07-28,9857
2302,麗正,20,0,20,元大-蘆洲,2023-07-28,9857
6223,旺矽,23,5,18,元大-蘆洲,2023-07-28,9857
2888,新光金,555,137,418,元大-蘆洲,2023-07-31,9857
3481,群創,476,89,387,元大-蘆洲,2023-07-31,9857
2883,凱基金,320,17,303,元大-蘆洲,2023-07-31,9857
00878,國泰永續高股息,500,227,273,元大-蘆洲,2023-07-31,9857
3231,緯創,331,169,162,元大-蘆洲,2023-07-31,9857
00929,復華台灣科技優息,239,85,154,元大-蘆洲,2023-07-31,9857
00679B,元大美債20年,113,0,113,元大-蘆洲,2023-07-31,9857
2382,廣達,204,102,102,元大-蘆洲,2023-07-31,9857
00719B,元大美債1-3,100,0,100,元大-蘆洲,2023-07-31,9857
2329,華泰,370,313,57,元大-蘆洲,2023-07-31,9857
2603,長榮,126,70,56,元大-蘆洲,2023-07-31,9857
3236,千如,176,122,54,元大-蘆洲,2023-07-31,9857
2419,仲琦,99,49,50,元大-蘆洲,2023-07-31,9857
00686R,群益臺灣加權反1,50,0,50,元大-蘆洲,2023-07-31,9857
2402,毅嘉,63,17,46,元大-蘆洲,2023-07-31,9857
2301,光寶科,263,218,45,元大-蘆洲,2023-07-31,9857
2359,所羅門,47,2,45,元大-蘆洲,2023-07-31,9857
2027,大成鋼,46,3,43,元大-蘆洲,2023-07-31,9857
2891,中信金,44,3,41,元大-蘆洲,2023-07-31,9857
2337,旺宏,44,7,37,元大-蘆洲,2023-07-31,9857
6176,瑞儀,48,12,36,元大-蘆洲,2023-07-31,9857
2324,仁寶,97,61,36,元大-蘆洲,2023-07-31,9857
2328,廣宇,51,18,33,元大-蘆洲,2023-07-31,9857
3363,上詮,32,1,31,元大-蘆洲,2023-07-31,9857
6182,合晶,34,3,31,元大-蘆洲,2023-07-31,9857
2501,國建,30,0,30,元大-蘆洲,2023-07-31,9857
5469,瀚宇博,32,2,30,元大-蘆洲,2023-07-31,9857
00687B,國泰20年美債,29,0,29,元大-蘆洲,2023-07-31,9857
4533,協易機,31,2,29,元大-蘆洲,2023-07-31,9857
2609,陽明,68,39,29,元大-蘆洲,2023-07-31,9857
5608,四維航,30,2,28,元大-蘆洲,2023-07-31,9857
3078,僑威,35,8,27,元大-蘆洲,2023-07-31,9857
5425,台半,34,7,27,元大-蘆洲,2023-07-31,9857
2362,藍天,25,0,25,元大-蘆洲,2023-07-31,9857
5880,合庫金,29,4,25,元大-蘆洲,2023-07-31,9857
6217,中探針,28,3,25,元大-蘆洲,2023-07-31,9857
1618,合機,29,4,25,元大-蘆洲,2023-07-31,9857
6517,保勝光學,24,0,24,元大-蘆洲,2023-07-31,9857
2618,長榮航,84,61,23,元大-蘆洲,2023-07-31,9857
00795B,中信美國公債20年,23,0,23,元大-蘆洲,2023-07-31,9857
2634,漢翔,46,23,23,元大-蘆洲,2023-07-31,9857
3234,光環,24,2,22,元大-蘆洲,2023-07-31,9857
2408,南亞科,25,3,22,元大-蘆洲,2023-07-31,9857
1611,中電,21,1,20,元大-蘆洲,2023-07-31,9857
5426,振發,20,0,20,元大-蘆洲,2023-07-31,9857
5009,榮剛,24,5,19,元大-蘆洲,2023-07-31,9857
020038,元大ESG配息N,18,0,18,元大-蘆洲,2023-07-31,9857
6126,信音,20,2,18,元大-蘆洲,2023-07-31,9857
3694,海華,50,32,18,元大-蘆洲,2023-07-31,9857
6441,廣錠,18,0,18,元大-蘆洲,2023-07-31,9857
1210,大成,187,2,185,元大-蘆洲,2023-08-01,9857
2301,光寶科,290,186,104,元大-蘆洲,2023-08-01,9857
2010,春源,80,0,80,元大-蘆洲,2023-08-01,9857
00673R,期元大S＆P原油反1,79,0,79,元大-蘆洲,2023-08-01,9857
2891,中信金,84,7,77,元大-蘆洲,2023-08-01,9857
1513,中興電,93,22,71,元大-蘆洲,2023-08-01,9857
3062,建漢,90,20,70,元大-蘆洲,2023-08-01,9857
00680L,元大美債20正2,64,0,64,元大-蘆洲,2023-08-01,9857
3163,波若威,158,94,64,元大-蘆洲,2023-08-01,9857
3078,僑威,68,9,59,元大-蘆洲,2023-08-01,9857
3380,明泰,65,9,56,元大-蘆洲,2023-08-01,9857
3032,偉訓,52,1,51,元大-蘆洲,2023-08-01,9857
00885,富邦越南,60,11,49,元大-蘆洲,2023-08-01,9857
00923,群益台ESG低碳50,46,0,46,元大-蘆洲,2023-08-01,9857
3052,夆典,46,0,46,元大-蘆洲,2023-08-01,9857
1815,富喬,55,11,44,元大-蘆洲,2023-08-01,9857
1605,華新,53,10,43,元大-蘆洲,2023-08-01,9857
2426,鼎元,38,2,36,元大-蘆洲,2023-08-01,9857
4979,華星光,84,48,36,元大-蘆洲,2023-08-01,9857
6282,康舒,98,63,35,元大-蘆洲,2023-08-01,9857
2801,彰銀,34,0,34,元大-蘆洲,2023-08-01,9857
2344,華邦電,61,28,33,元大-蘆洲,2023-08-01,9857
2468,華經,38,5,33,元大-蘆洲,2023-08-01,9857
0056,元大高股息,71,39,32,元大-蘆洲,2023-08-01,9857
5443,均豪,38,7,31,元大-蘆洲,2023-08-01,9857
3105,穩懋,33,2,31,元大-蘆洲,2023-08-01,9857
3682,亞太電,29,0,29,元大-蘆洲,2023-08-01,9857
3056,富華新,34,6,28,元大-蘆洲,2023-08-01,9857
2401,凌陽,50,23,27,元大-蘆洲,2023-08-01,9857
00929,復華台灣科技優息,79,52,27,元大-蘆洲,2023-08-01,9857
2913,農林,201,175,26,元大-蘆洲,2023-08-01,9857
3029,零壹,39,13,26,元大-蘆洲,2023-08-01,9857
5258,虹堡,28,4,24,元大-蘆洲,2023-08-01,9857
6176,瑞儀,24,1,23,元大-蘆洲,2023-08-01,9857
2329,華泰,49,26,23,元大-蘆洲,2023-08-01,9857
00925,新光標普電動車,23,0,23,元大-蘆洲,2023-08-01,9857
3694,海華,40,17,23,元大-蘆洲,2023-08-01,9857
6441,廣錠,23,1,22,元大-蘆洲,2023-08-01,9857
6218,豪勉,31,9,22,元大-蘆洲,2023-08-01,9857
1104,環泥,20,0,20,元大-蘆洲,2023-08-01,9857
3312,弘憶股,20,0,20,元大-蘆洲,2023-08-01,9857
00882,中信中國高股息,24,4,20,元大-蘆洲,2023-08-01,9857
00679B,元大美債20年,20,2,18,元大-蘆洲,2023-08-01,9857
2630,亞航,19,1,18,元大-蘆洲,2023-08-01,9857
1785,光洋科,19,3,16,元大-蘆洲,2023-08-01,9857
1905,華紙,48,33,15,元大-蘆洲,2023-08-01,9857
2388,威盛,54,39,15,元大-蘆洲,2023-08-01,9857
2020,美亞,15,1,14,元大-蘆洲,2023-08-01,9857
3031,佰鴻,14,0,14,元大-蘆洲,2023-08-01,9857
1618,合機,14,0,14,元大-蘆洲,2023-08-01,9857
00687B,國泰20年美債,273,0,273,元大-蘆洲,2023-08-02,9857
00878,國泰永續高股息,532,308,224,元大-蘆洲,2023-08-02,9857
00929,復華台灣科技優息,235,19,216,元大-蘆洲,2023-08-02,9857
00900,富邦特選高股息30,181,31,150,元大-蘆洲,2023-08-02,9857
00923,群益台ESG低碳50,136,1,135,元大-蘆洲,2023-08-02,9857
3481,群創,349,233,116,元大-蘆洲,2023-08-02,9857
2834,臺企銀,118,4,114,元大-蘆洲,2023-08-02,9857
3231,緯創,194,82,112,元大-蘆洲,2023-08-02,9857
2301,光寶科,137,28,109,元大-蘆洲,2023-08-02,9857
2014,中鴻,318,232,86,元大-蘆洲,2023-08-02,9857
00637L,元大滬深300正2,113,30,83,元大-蘆洲,2023-08-02,9857
2312,金寶,91,12,79,元大-蘆洲,2023-08-02,9857
2890,永豐金,77,1,76,元大-蘆洲,2023-08-02,9857
2344,華邦電,76,1,75,元大-蘆洲,2023-08-02,9857
1611,中電,73,2,71,元大-蘆洲,2023-08-02,9857
2323,中環,81,15,66,元大-蘆洲,2023-08-02,9857
3163,波若威,118,56,62,元大-蘆洲,2023-08-02,9857
2883,凱基金,63,1,62,元大-蘆洲,2023-08-02,9857
00679B,元大美債20年,70,12,58,元大-蘆洲,2023-08-02,9857
2002,中鋼,58,4,54,元大-蘆洲,2023-08-02,9857
2382,廣達,195,142,53,元大-蘆洲,2023-08-02,9857
1210,大成,69,17,52,元大-蘆洲,2023-08-02,9857
1815,富喬,54,6,48,元大-蘆洲,2023-08-02,9857
8358,金居,60,12,48,元大-蘆洲,2023-08-02,9857
3037,欣興,116,68,48,元大-蘆洲,2023-08-02,9857
6282,康舒,159,112,47,元大-蘆洲,2023-08-02,9857
2882,國泰金,63,18,45,元大-蘆洲,2023-08-02,9857
4979,華星光,51,9,42,元大-蘆洲,2023-08-02,9857
00673R,期元大S＆P原油反1,45,4,41,元大-蘆洲,2023-08-02,9857
6441,廣錠,45,5,40,元大-蘆洲,2023-08-02,9857
2888,新光金,62,26,36,元大-蘆洲,2023-08-02,9857
4746,台耀,110,75,35,元大-蘆洲,2023-08-02,9857
1305,華夏,42,7,35,元大-蘆洲,2023-08-02,9857
2897,王道銀行,33,0,33,元大-蘆洲,2023-08-02,9857
3078,僑威,44,12,32,元大-蘆洲,2023-08-02,9857
0056,元大高股息,146,115,31,元大-蘆洲,2023-08-02,9857
00680L,元大美債20正2,31,0,31,元大-蘆洲,2023-08-02,9857
2886,兆豐金,34,4,30,元大-蘆洲,2023-08-02,9857
3576,聯合再生,32,2,30,元大-蘆洲,2023-08-02,9857
4167,松瑞藥,30,0,30,元大-蘆洲,2023-08-02,9857
3324,雙鴻,35,5,30,元大-蘆洲,2023-08-02,9857
00722B,群益投資級電信債,29,0,29,元大-蘆洲,2023-08-02,9857
00885,富邦越南,35,7,28,元大-蘆洲,2023-08-02,9857
8021,尖點,28,0,28,元大-蘆洲,2023-08-02,9857
3583,辛耘,43,16,27,元大-蘆洲,2023-08-02,9857
00720B,元大投資級公司債,45,18,27,元大-蘆洲,2023-08-02,9857
3694,海華,37,10,27,元大-蘆洲,2023-08-02,9857
3558,神準,28,2,26,元大-蘆洲,2023-08-02,9857
2356,英業達,63,37,26,元大-蘆洲,2023-08-02,9857
2328,廣宇,27,1,26,元大-蘆洲,2023-08-02,9857
2409,友達,259,32,227,元大-蘆洲,2023-08-04,9857
2344,華邦電,311,85,226,元大-蘆洲,2023-08-04,9857
00679B,元大美債20年,204,28,176,元大-蘆洲,2023-08-04,9857
1605,華新,203,35,168,元大-蘆洲,2023-08-04,9857
00687B,國泰20年美債,175,17,158,元大-蘆洲,2023-08-04,9857
00688L,國泰20年美債正2,138,0,138,元大-蘆洲,2023-08-04,9857
00720B,元大投資級公司債,119,0,119,元大-蘆洲,2023-08-04,9857
00929,復華台灣科技優息,120,2,118,元大-蘆洲,2023-08-04,9857
2618,長榮航,126,16,110,元大-蘆洲,2023-08-04,9857
2104,國際中橡,104,0,104,元大-蘆洲,2023-08-04,9857
2891,中信金,117,13,104,元大-蘆洲,2023-08-04,9857
2883,凱基金,105,10,95,元大-蘆洲,2023-08-04,9857
3231,緯創,385,308,77,元大-蘆洲,2023-08-04,9857
00878,國泰永續高股息,321,249,72,元大-蘆洲,2023-08-04,9857
00795B,中信美國公債20年,78,6,72,元大-蘆洲,2023-08-04,9857
1608,華榮,95,38,57,元大-蘆洲,2023-08-04,9857
1609,大亞,91,36,55,元大-蘆洲,2023-08-04,9857
3703,欣陸,54,0,54,元大-蘆洲,2023-08-04,9857
00772B,中信高評級公司債,53,0,53,元大-蘆洲,2023-08-04,9857
00751B,元大AAA至A公司債,59,9,50,元大-蘆洲,2023-08-04,9857
00680L,元大美債20正2,82,34,48,元大-蘆洲,2023-08-04,9857
5880,合庫金,59,11,48,元大-蘆洲,2023-08-04,9857
6235,華孚,58,16,42,元大-蘆洲,2023-08-04,9857
2890,永豐金,86,45,41,元大-蘆洲,2023-08-04,9857
6153,嘉聯益,41,0,41,元大-蘆洲,2023-08-04,9857
8215,明基材,40,0,40,元大-蘆洲,2023-08-04,9857
2801,彰銀,42,2,40,元大-蘆洲,2023-08-04,9857
00900,富邦特選高股息30,69,30,39,元大-蘆洲,2023-08-04,9857
0056,元大高股息,183,147,36,元大-蘆洲,2023-08-04,9857
00725B,國泰投資級公司債,39,6,33,元大-蘆洲,2023-08-04,9857
2886,兆豐金,36,4,32,元大-蘆洲,2023-08-04,9857
4953,緯軟,38,6,32,元大-蘆洲,2023-08-04,9857
00773B,中信優先金融債,30,0,30,元大-蘆洲,2023-08-04,9857
2897,王道銀行,31,2,29,元大-蘆洲,2023-08-04,9857
2206,三陽工業,31,2,29,元大-蘆洲,2023-08-04,9857
00919,群益台灣精選高息,50,21,29,元大-蘆洲,2023-08-04,9857
00923,群益台ESG低碳50,28,0,28,元大-蘆洲,2023-08-04,9857
00882,中信中國高股息,38,11,27,元大-蘆洲,2023-08-04,9857
3037,欣興,38,11,27,元大-蘆洲,2023-08-04,9857
00885,富邦越南,37,12,25,元大-蘆洲,2023-08-04,9857
1785,光洋科,35,10,25,元大-蘆洲,2023-08-04,9857
6443,元晶,44,19,25,元大-蘆洲,2023-08-04,9857
2330,台積電,26,1,25,元大-蘆洲,2023-08-04,9857
2323,中環,37,13,24,元大-蘆洲,2023-08-04,9857
2888,新光金,58,34,24,元大-蘆洲,2023-08-04,9857
2356,英業達,126,103,23,元大-蘆洲,2023-08-04,9857
1504,東元,29,7,22,元大-蘆洲,2023-08-04,9857
2460,建通,22,0,22,元大-蘆洲,2023-08-04,9857
2353,宏��,52,32,20,元大-蘆洲,2023-08-04,9857
2885,元大金,21,1,20,元大-蘆洲,2023-08-04,9857
3576,聯合再生,482,65,417,元大-蘆洲,2023-08-07,9857
00931B,統一美債20年,276,1,275,元大-蘆洲,2023-08-07,9857
5371,中光電,165,14,151,元大-蘆洲,2023-08-07,9857
00929,復華台灣科技優息,134,13,121,元大-蘆洲,2023-08-07,9857
2913,農林,139,23,116,元大-蘆洲,2023-08-07,9857
00722B,群益投資級電信債,91,0,91,元大-蘆洲,2023-08-07,9857
5009,榮剛,182,96,86,元大-蘆洲,2023-08-07,9857
6188,廣明,78,23,55,元大-蘆洲,2023-08-07,9857
2383,台光電,90,36,54,元大-蘆洲,2023-08-07,9857
3044,健鼎,57,5,52,元大-蘆洲,2023-08-07,9857
00673R,期元大S＆P原油反1,51,0,51,元大-蘆洲,2023-08-07,9857
1210,大成,78,32,46,元大-蘆洲,2023-08-07,9857
00720B,元大投資級公司債,48,3,45,元大-蘆洲,2023-08-07,9857
2882,國泰金,43,0,43,元大-蘆洲,2023-08-07,9857
00882,中信中國高股息,43,1,42,元大-蘆洲,2023-08-07,9857
00637L,元大滬深300正2,48,6,42,元大-蘆洲,2023-08-07,9857
6108,競國,43,2,41,元大-蘆洲,2023-08-07,9857
00900,富邦特選高股息30,43,5,38,元大-蘆洲,2023-08-07,9857
1616,億泰,40,2,38,元大-蘆洲,2023-08-07,9857
2610,華航,75,38,37,元大-蘆洲,2023-08-07,9857
00753L,中信中國50正2,40,6,34,元大-蘆洲,2023-08-07,9857
6187,萬潤,37,3,34,元大-蘆洲,2023-08-07,9857
8358,金居,39,6,33,元大-蘆洲,2023-08-07,9857
8932,智通*,32,0,32,元大-蘆洲,2023-08-07,9857
2023,燁輝,32,1,31,元大-蘆洲,2023-08-07,9857
3715,定穎投控,34,4,30,元大-蘆洲,2023-08-07,9857
00878,國泰永續高股息,102,72,30,元大-蘆洲,2023-08-07,9857
00665L,富邦�琤肭磪囓�2,37,10,27,元大-蘆洲,2023-08-07,9857
3013,晟銘電,45,18,27,元大-蘆洲,2023-08-07,9857
00632R,元大台灣50反1,41,15,26,元大-蘆洲,2023-08-07,9857
1587,吉茂,26,1,25,元大-蘆洲,2023-08-07,9857
2609,陽明,46,22,24,元大-蘆洲,2023-08-07,9857
3017,奇鋐,51,27,24,元大-蘆洲,2023-08-07,9857
2382,廣達,167,143,24,元大-蘆洲,2023-08-07,9857
00687B,國泰20年美債,23,3,20,元大-蘆洲,2023-08-07,9857
00655L,國泰中國A50正2,20,0,20,元大-蘆洲,2023-08-07,9857
1905,華紙,58,38,20,元大-蘆洲,2023-08-07,9857
4167,松瑞藥,22,3,19,元大-蘆洲,2023-08-07,9857
2353,宏��,40,21,19,元大-蘆洲,2023-08-07,9857
2014,中鴻,67,49,18,元大-蘆洲,2023-08-07,9857
2880,華南金,18,1,17,元大-蘆洲,2023-08-07,9857
00679B,元大美債20年,25,9,16,元大-蘆洲,2023-08-07,9857
2330,台積電,16,0,16,元大-蘆洲,2023-08-07,9857
6285,啟��,26,10,16,元大-蘆洲,2023-08-07,9857
4543,萬在,16,0,16,元大-蘆洲,2023-08-07,9857
4953,緯軟,19,4,15,元大-蘆洲,2023-08-07,9857
2419,仲琦,19,4,15,元大-蘆洲,2023-08-07,9857
2022,聚亨,15,0,15,元大-蘆洲,2023-08-07,9857
00751B,元大AAA至A公司債,15,1,14,元大-蘆洲,2023-08-07,9857
2883,凱基金,15,1,14,元大-蘆洲,2023-08-07,9857
00929,復華台灣科技優息,169,2,167,元大-蘆洲,2023-08-08,9857
3576,聯合再生,155,0,155,元大-蘆洲,2023-08-08,9857
00900,富邦特選高股息30,147,5,142,元大-蘆洲,2023-08-08,9857
00878,國泰永續高股息,171,44,127,元大-蘆洲,2023-08-08,9857
2618,長榮航,183,57,126,元大-蘆洲,2023-08-08,9857
2890,永豐金,143,51,92,元大-蘆洲,2023-08-08,9857
2388,威盛,106,16,90,元大-蘆洲,2023-08-08,9857
5880,合庫金,114,25,89,元大-蘆洲,2023-08-08,9857
2801,彰銀,87,0,87,元大-蘆洲,2023-08-08,9857
2356,英業達,382,312,70,元大-蘆洲,2023-08-08,9857
00931B,統一美債20年,70,0,70,元大-蘆洲,2023-08-08,9857
2883,凱基金,55,2,53,元大-蘆洲,2023-08-08,9857
2014,中鴻,56,5,51,元大-蘆洲,2023-08-08,9857
1608,華榮,61,11,50,元大-蘆洲,2023-08-08,9857
3231,緯創,306,256,50,元大-蘆洲,2023-08-08,9857
2301,光寶科,88,45,43,元大-蘆洲,2023-08-08,9857
2359,所羅門,40,0,40,元大-蘆洲,2023-08-08,9857
00753L,中信中國50正2,38,0,38,元大-蘆洲,2023-08-08,9857
2303,聯電,52,15,37,元大-蘆洲,2023-08-08,9857
1587,吉茂,35,1,34,元大-蘆洲,2023-08-08,9857
2892,第一金,33,0,33,元大-蘆洲,2023-08-08,9857
3706,神達,71,39,32,元大-蘆洲,2023-08-08,9857
1533,車王電,32,1,31,元大-蘆洲,2023-08-08,9857
2344,華邦電,30,0,30,元大-蘆洲,2023-08-08,9857
00923,群益台ESG低碳50,29,0,29,元大-蘆洲,2023-08-08,9857
2913,農林,90,61,29,元大-蘆洲,2023-08-08,9857
3548,兆利,29,0,29,元大-蘆洲,2023-08-08,9857
3715,定穎投控,37,8,29,元大-蘆洲,2023-08-08,9857
3380,明泰,29,1,28,元大-蘆洲,2023-08-08,9857
00706L,期元大S＆P日圓正2,28,0,28,元大-蘆洲,2023-08-08,9857
00673R,期元大S＆P原油反1,58,30,28,元大-蘆洲,2023-08-08,9857
2609,陽明,36,9,27,元大-蘆洲,2023-08-08,9857
2312,金寶,54,28,26,元大-蘆洲,2023-08-08,9857
1503,士電,25,0,25,元大-蘆洲,2023-08-08,9857
2515,中工,26,1,25,元大-蘆洲,2023-08-08,9857
0056,元大高股息,80,56,24,元大-蘆洲,2023-08-08,9857
3714,富采,21,0,21,元大-蘆洲,2023-08-08,9857
00679B,元大美債20年,23,2,21,元大-蘆洲,2023-08-08,9857
1806,冠軍,20,0,20,元大-蘆洲,2023-08-08,9857
6016,康和證,26,6,20,元大-蘆洲,2023-08-08,9857
00680L,元大美債20正2,19,0,19,元大-蘆洲,2023-08-08,9857
6139,亞翔,29,10,19,元大-蘆洲,2023-08-08,9857
2211,長榮鋼,27,8,19,元大-蘆洲,2023-08-08,9857
5009,榮剛,36,18,18,元大-蘆洲,2023-08-08,9857
2887,台新金,18,1,17,元大-蘆洲,2023-08-08,9857
2329,華泰,50,33,17,元大-蘆洲,2023-08-08,9857
2401,凌陽,19,2,17,元大-蘆洲,2023-08-08,9857
6125,廣運,47,30,17,元大-蘆洲,2023-08-08,9857
1905,華紙,61,45,16,元大-蘆洲,2023-08-08,9857
1609,大亞,27,11,16,元大-蘆洲,2023-08-08,9857
3044,健鼎,189,54,135,元大-蘆洲,2023-08-09,9857
00929,復華台灣科技優息,126,0,126,元大-蘆洲,2023-08-09,9857
00878,國泰永續高股息,137,26,111,元大-蘆洲,2023-08-09,9857
3047,訊舟,116,10,106,元大-蘆洲,2023-08-09,9857
1609,大亞,103,19,84,元大-蘆洲,2023-08-09,9857
00900,富邦特選高股息30,81,0,81,元大-蘆洲,2023-08-09,9857
2303,聯電,93,24,69,元大-蘆洲,2023-08-09,9857
3231,緯創,216,150,66,元大-蘆洲,2023-08-09,9857
2206,三陽工業,74,8,66,元大-蘆洲,2023-08-09,9857
2801,彰銀,58,1,57,元大-蘆洲,2023-08-09,9857
2002,中鋼,57,8,49,元大-蘆洲,2023-08-09,9857
5009,榮剛,51,5,46,元大-蘆洲,2023-08-09,9857
2344,華邦電,57,11,46,元大-蘆洲,2023-08-09,9857
3312,弘憶股,45,0,45,元大-蘆洲,2023-08-09,9857
6120,達運,44,1,43,元大-蘆洲,2023-08-09,9857
2882,國泰金,43,3,40,元大-蘆洲,2023-08-09,9857
00885,富邦越南,43,5,38,元大-蘆洲,2023-08-09,9857
00680L,元大美債20正2,64,30,34,元大-蘆洲,2023-08-09,9857
1503,士電,39,6,33,元大-蘆洲,2023-08-09,9857
1605,華新,31,4,27,元大-蘆洲,2023-08-09,9857
2356,英業達,161,134,27,元大-蘆洲,2023-08-09,9857
9945,潤泰新,26,0,26,元大-蘆洲,2023-08-09,9857
8936,國統,26,0,26,元大-蘆洲,2023-08-09,9857
6204,艾華,27,1,26,元大-蘆洲,2023-08-09,9857
2359,所羅門,28,3,25,元大-蘆洲,2023-08-09,9857
5880,合庫金,26,2,24,元大-蘆洲,2023-08-09,9857
2834,臺企銀,37,13,24,元大-蘆洲,2023-08-09,9857
2430,燦坤,24,0,24,元大-蘆洲,2023-08-09,9857
2913,農林,38,14,24,元大-蘆洲,2023-08-09,9857
6182,合晶,26,2,24,元大-蘆洲,2023-08-09,9857
4960,誠美材,23,0,23,元大-蘆洲,2023-08-09,9857
6187,萬潤,26,4,22,元大-蘆洲,2023-08-09,9857
6016,康和證,21,0,21,元大-蘆洲,2023-08-09,9857
1587,吉茂,21,0,21,元大-蘆洲,2023-08-09,9857
6026,福邦證,20,0,20,元大-蘆洲,2023-08-09,9857
00931B,統一美債20年,30,10,20,元大-蘆洲,2023-08-09,9857
1310,台苯,20,0,20,元大-蘆洲,2023-08-09,9857
2405,輔信,32,13,19,元大-蘆洲,2023-08-09,9857
3694,海華,44,26,18,元大-蘆洲,2023-08-09,9857
00919,群益台灣精選高息,19,2,17,元大-蘆洲,2023-08-09,9857
3213,茂訊,21,3,18,元大-蘆洲,2023-08-09,9857
2890,永豐金,19,2,17,元大-蘆洲,2023-08-09,9857
1308,亞聚,17,0,17,元大-蘆洲,2023-08-09,9857
00923,群益台ESG低碳50,16,0,16,元大-蘆洲,2023-08-09,9857
3706,神達,28,13,15,元大-蘆洲,2023-08-09,9857
6116,彩晶,20,5,15,元大-蘆洲,2023-08-09,9857
3581,博磊,18,3,15,元大-蘆洲,2023-08-09,9857
3055,蔚華科,17,3,14,元大-蘆洲,2023-08-09,9857
2886,兆豐金,66,52,14,元大-蘆洲,2023-08-09,9857
00720B,元大投資級公司債,14,0,14,元大-蘆洲,2023-08-09,9857
00929,復華台灣科技優息,470,11,459,元大-蘆洲,2023-08-10,9857
00878,國泰永續高股息,432,150,282,元大-蘆洲,2023-08-10,9857
3703,欣陸,147,0,147,元大-蘆洲,2023-08-10,9857
2888,新光金,243,115,128,元大-蘆洲,2023-08-10,9857
2402,毅嘉,122,4,118,元大-蘆洲,2023-08-10,9857
00900,富邦特選高股息30,128,45,83,元大-蘆洲,2023-08-10,9857
2883,凱基金,85,5,80,元大-蘆洲,2023-08-10,9857
2363,矽統,174,95,79,元大-蘆洲,2023-08-10,9857
2382,廣達,129,58,71,元大-蘆洲,2023-08-10,9857
00673R,期元大S＆P原油反1,89,20,69,元大-蘆洲,2023-08-10,9857
8112,至上,123,55,68,元大-蘆洲,2023-08-10,9857
2610,華航,102,40,62,元大-蘆洲,2023-08-10,9857
2884,玉山金,61,1,60,元大-蘆洲,2023-08-10,9857
4906,正文,61,2,59,元大-蘆洲,2023-08-10,9857
2886,兆豐金,65,6,59,元大-蘆洲,2023-08-10,9857
2344,華邦電,63,5,58,元大-蘆洲,2023-08-10,9857
2312,金寶,58,1,57,元大-蘆洲,2023-08-10,9857
6116,彩晶,136,80,56,元大-蘆洲,2023-08-10,9857
00687B,國泰20年美債,55,0,55,元大-蘆洲,2023-08-10,9857
1605,華新,70,16,54,元大-蘆洲,2023-08-10,9857
2303,聯電,72,22,50,元大-蘆洲,2023-08-10,9857
00676R,富邦臺灣加權反1,50,0,50,元大-蘆洲,2023-08-10,9857
00923,群益台ESG低碳50,49,0,49,元大-蘆洲,2023-08-10,9857
0056,元大高股息,94,48,46,元大-蘆洲,2023-08-10,9857
1815,富喬,48,4,44,元大-蘆洲,2023-08-10,9857
8996,高力,51,7,44,元大-蘆洲,2023-08-10,9857
2323,中環,57,14,43,元大-蘆洲,2023-08-10,9857
2328,廣宇,42,1,41,元大-蘆洲,2023-08-10,9857
00671R,富邦NASDAQ反1,40,0,40,元大-蘆洲,2023-08-10,9857
00919,群益台灣精選高息,37,0,37,元大-蘆洲,2023-08-10,9857
1608,華榮,34,0,34,元大-蘆洲,2023-08-10,9857
1503,士電,34,1,33,元大-蘆洲,2023-08-10,9857
00637L,元大滬深300正2,65,33,32,元大-蘆洲,2023-08-10,9857
3037,欣興,38,7,31,元大-蘆洲,2023-08-10,9857
3217,優群,31,2,29,元大-蘆洲,2023-08-10,9857
3356,奇偶,33,4,29,元大-蘆洲,2023-08-10,9857
6125,廣運,34,6,28,元大-蘆洲,2023-08-10,9857
3231,緯創,252,226,26,元大-蘆洲,2023-08-10,9857
3047,訊舟,26,0,26,元大-蘆洲,2023-08-10,9857
2376,技嘉,39,13,26,元大-蘆洲,2023-08-10,9857
2359,所羅門,29,3,26,元大-蘆洲,2023-08-10,9857
3711,日月光投控,30,4,26,元大-蘆洲,2023-08-10,9857
2383,台光電,37,12,25,元大-蘆洲,2023-08-10,9857
0050,元大台灣50,26,2,24,元大-蘆洲,2023-08-10,9857
2324,仁寶,59,35,24,元大-蘆洲,2023-08-10,9857
3017,奇鋐,29,5,24,元大-蘆洲,2023-08-10,9857
1802,台玻,37,13,24,元大-蘆洲,2023-08-10,9857
2017,官田鋼,28,4,24,元大-蘆洲,2023-08-10,9857
3078,僑威,46,23,23,元大-蘆洲,2023-08-10,9857
4114,健喬,21,0,21,元大-蘆洲,2023-08-10,9857
6235,華孚,219,22,197,元大-蘆洲,2023-08-11,9857
00885,富邦越南,212,24,188,元大-蘆洲,2023-08-11,9857
2618,長榮航,248,82,166,元大-蘆洲,2023-08-11,9857
00673R,期元大S＆P原油反1,150,0,150,元大-蘆洲,2023-08-11,9857
00929,復華台灣科技優息,147,0,147,元大-蘆洲,2023-08-11,9857
3231,緯創,279,160,119,元大-蘆洲,2023-08-11,9857
2892,第一金,115,2,113,元大-蘆洲,2023-08-11,9857
2027,大成鋼,105,0,105,元大-蘆洲,2023-08-11,9857
2363,矽統,241,151,90,元大-蘆洲,2023-08-11,9857
2399,映泰,80,4,76,元大-蘆洲,2023-08-11,9857
00931B,統一美債20年,72,0,72,元大-蘆洲,2023-08-11,9857
3481,群創,140,74,66,元大-蘆洲,2023-08-11,9857
00637L,元大滬深300正2,221,160,61,元大-蘆洲,2023-08-11,9857
3052,夆典,52,0,52,元大-蘆洲,2023-08-11,9857
00679B,元大美債20年,54,4,50,元大-蘆洲,2023-08-11,9857
2609,陽明,46,2,44,元大-蘆洲,2023-08-11,9857
00795B,中信美國公債20年,36,0,36,元大-蘆洲,2023-08-11,9857
00923,群益台ESG低碳50,35,0,35,元大-蘆洲,2023-08-11,9857
00706L,期元大S＆P日圓正2,34,0,34,元大-蘆洲,2023-08-11,9857
1210,大成,37,4,33,元大-蘆洲,2023-08-11,9857
2367,燿華,33,0,33,元大-蘆洲,2023-08-11,9857
6116,彩晶,55,22,33,元大-蘆洲,2023-08-11,9857
3047,訊舟,30,0,30,元大-蘆洲,2023-08-11,9857
2317,鴻海,29,1,28,元大-蘆洲,2023-08-11,9857
2355,敬鵬,34,6,28,元大-蘆洲,2023-08-11,9857
2883,凱基金,26,0,26,元大-蘆洲,2023-08-11,9857
2345,智邦,26,1,25,元大-蘆洲,2023-08-11,9857
0056,元大高股息,62,37,25,元大-蘆洲,2023-08-11,9857
5608,四維航,34,10,24,元大-蘆洲,2023-08-11,9857
2002,中鋼,26,2,24,元大-蘆洲,2023-08-11,9857
00751B,元大AAA至A公司債,21,0,21,元大-蘆洲,2023-08-11,9857
8936,國統,21,0,21,元大-蘆洲,2023-08-11,9857
2344,華邦電,21,0,21,元大-蘆洲,2023-08-11,9857
8440,綠電,20,0,20,元大-蘆洲,2023-08-11,9857
6108,競國,20,0,20,元大-蘆洲,2023-08-11,9857
9940,信義,20,0,20,元大-蘆洲,2023-08-11,9857
8105,凌巨,20,0,20,元大-蘆洲,2023-08-11,9857
00687B,國泰20年美債,23,4,19,元大-蘆洲,2023-08-11,9857
9907,統一實,21,2,19,元大-蘆洲,2023-08-11,9857
00891,中信關鍵半導體,19,0,19,元大-蘆洲,2023-08-11,9857
6153,嘉聯益,23,4,19,元大-蘆洲,2023-08-11,9857
3257,虹冠電,18,0,18,元大-蘆洲,2023-08-11,9857
2356,英業達,169,151,18,元大-蘆洲,2023-08-11,9857
6806,森崴能源,21,4,17,元大-蘆洲,2023-08-11,9857
4906,正文,26,9,17,元大-蘆洲,2023-08-11,9857
2888,新光金,44,27,17,元大-蘆洲,2023-08-11,9857
2312,金寶,22,6,16,元大-蘆洲,2023-08-11,9857
2337,旺宏,16,0,16,元大-蘆洲,2023-08-11,9857
8086,宏捷科,16,0,16,元大-蘆洲,2023-08-11,9857
3051,力特,17,1,16,元大-蘆洲,2023-08-11,9857
00637L,元大滬深300正2,429,130,299,元大-蘆洲,2023-08-14,9857
00900,富邦特選高股息30,216,2,214,元大-蘆洲,2023-08-14,9857
00929,復華台灣科技優息,245,32,213,元大-蘆洲,2023-08-14,9857
2610,華航,260,107,153,元大-蘆洲,2023-08-14,9857
00878,國泰永續高股息,278,164,114,元大-蘆洲,2023-08-14,9857
2344,華邦電,109,13,96,元大-蘆洲,2023-08-14,9857
1605,華新,128,45,83,元大-蘆洲,2023-08-14,9857
3231,緯創,187,115,72,元大-蘆洲,2023-08-14,9857
00923,群益台ESG低碳50,72,0,72,元大-蘆洲,2023-08-14,9857
2883,凱基金,81,19,62,元大-蘆洲,2023-08-14,9857
2609,陽明,82,24,58,元大-蘆洲,2023-08-14,9857
1815,富喬,57,2,55,元大-蘆洲,2023-08-14,9857
00882,中信中國高股息,70,19,51,元大-蘆洲,2023-08-14,9857
2104,國際中橡,50,0,50,元大-蘆洲,2023-08-14,9857
1608,華榮,50,0,50,元大-蘆洲,2023-08-14,9857
3481,群創,49,1,48,元大-蘆洲,2023-08-14,9857
1513,中興電,50,9,41,元大-蘆洲,2023-08-14,9857
2897,王道銀行,42,2,40,元大-蘆洲,2023-08-14,9857
2312,金寶,69,32,37,元大-蘆洲,2023-08-14,9857
1604,聲寶,35,0,35,元大-蘆洲,2023-08-14,9857
6005,群益證,35,2,33,元大-蘆洲,2023-08-14,9857
8930,青鋼,36,5,31,元大-蘆洲,2023-08-14,9857
0050,元大台灣50,30,0,30,元大-蘆洲,2023-08-14,9857
2515,中工,30,0,30,元大-蘆洲,2023-08-14,9857
2027,大成鋼,39,10,29,元大-蘆洲,2023-08-14,9857
2834,臺企銀,31,3,28,元大-蘆洲,2023-08-14,9857
1795,美時,43,18,25,元大-蘆洲,2023-08-14,9857
2337,旺宏,24,0,24,元大-蘆洲,2023-08-14,9857
2891,中信金,48,25,23,元大-蘆洲,2023-08-14,9857
2603,長榮,49,26,23,元大-蘆洲,2023-08-14,9857
00927,群益半導體收益,22,0,22,元大-蘆洲,2023-08-14,9857
2330,台積電,24,2,22,元大-蘆洲,2023-08-14,9857
00919,群益台灣精選高息,24,3,21,元大-蘆洲,2023-08-14,9857
00706L,期元大S＆P日圓正2,20,0,20,元大-蘆洲,2023-08-14,9857
00655L,國泰中國A50正2,20,0,20,元大-蘆洲,2023-08-14,9857
0056,元大高股息,54,34,20,元大-蘆洲,2023-08-14,9857
3622,洋華,25,6,19,元大-蘆洲,2023-08-14,9857
2637,慧洋-KY,19,0,19,元大-蘆洲,2023-08-14,9857
6285,啟��,28,9,19,元大-蘆洲,2023-08-14,9857
00631L,元大台灣50正2,19,1,18,元大-蘆洲,2023-08-14,9857
1326,台化,19,1,18,元大-蘆洲,2023-08-14,9857
00902,中信電池及儲能,18,0,18,元大-蘆洲,2023-08-14,9857
00850,元大臺灣ESG永續,17,0,17,元大-蘆洲,2023-08-14,9857
00931B,統一美債20年,19,2,17,元大-蘆洲,2023-08-14,9857
3312,弘憶股,17,0,17,元大-蘆洲,2023-08-14,9857
3483,力致,33,17,16,元大-蘆洲,2023-08-14,9857
5608,四維航,18,2,16,元大-蘆洲,2023-08-14,9857
2402,毅嘉,22,6,16,元大-蘆洲,2023-08-14,9857
1101,台泥,16,0,16,元大-蘆洲,2023-08-14,9857
00679B,元大美債20年,15,0,15,元大-蘆洲,2023-08-14,9857
2409,友達,290,27,263,元大-蘆洲,2023-08-15,9857
00680L,元大美債20正2,256,0,256,元大-蘆洲,2023-08-15,9857
00900,富邦特選高股息30,150,26,124,元大-蘆洲,2023-08-15,9857
00929,復華台灣科技優息,144,23,121,元大-蘆洲,2023-08-15,9857
2888,新光金,114,3,111,元大-蘆洲,2023-08-15,9857
3231,緯創,303,199,104,元大-蘆洲,2023-08-15,9857
00923,群益台ESG低碳50,103,2,101,元大-蘆洲,2023-08-15,9857
2382,廣達,193,126,67,元大-蘆洲,2023-08-15,9857
4906,正文,62,0,62,元大-蘆洲,2023-08-15,9857
2880,華南金,69,10,59,元大-蘆洲,2023-08-15,9857
2883,凱基金,90,37,53,元大-蘆洲,2023-08-15,9857
00882,中信中國高股息,42,6,36,元大-蘆洲,2023-08-15,9857
00931B,統一美債20年,36,0,36,元大-蘆洲,2023-08-15,9857
00679B,元大美債20年,32,1,31,元大-蘆洲,2023-08-15,9857
00712,復華富時不動產,41,15,26,元大-蘆洲,2023-08-15,9857
2345,智邦,27,1,26,元大-蘆洲,2023-08-15,9857
3037,欣興,38,15,23,元大-蘆洲,2023-08-15,9857
00885,富邦越南,24,2,22,元大-蘆洲,2023-08-15,9857
2891,中信金,34,13,21,元大-蘆洲,2023-08-15,9857
2913,農林,33,12,21,元大-蘆洲,2023-08-15,9857
1301,台塑,21,0,21,元大-蘆洲,2023-08-15,9857
5388,中磊,21,0,21,元大-蘆洲,2023-08-15,9857
9945,潤泰新,21,0,21,元大-蘆洲,2023-08-15,9857
00902,中信電池及儲能,20,0,20,元大-蘆洲,2023-08-15,9857
2881,富邦金,21,1,20,元大-蘆洲,2023-08-15,9857
00706L,期元大S＆P日圓正2,21,1,20,元大-蘆洲,2023-08-15,9857
6016,康和證,25,5,20,元大-蘆洲,2023-08-15,9857
2353,宏��,42,23,19,元大-蘆洲,2023-08-15,9857
2884,玉山金,19,0,19,元大-蘆洲,2023-08-15,9857
5392,能率,20,1,19,元大-蘆洲,2023-08-15,9857
6770,力積電,27,9,18,元大-蘆洲,2023-08-15,9857
1304,台聚,18,0,18,元大-蘆洲,2023-08-15,9857
2002,中鋼,22,6,16,元大-蘆洲,2023-08-15,9857
2388,威盛,30,14,16,元大-蘆洲,2023-08-15,9857
00751B,元大AAA至A公司債,15,0,15,元大-蘆洲,2023-08-15,9857
2014,中鴻,15,1,14,元大-蘆洲,2023-08-15,9857
6213,聯茂,15,1,14,元大-蘆洲,2023-08-15,9857
2022,聚亨,27,13,14,元大-蘆洲,2023-08-15,9857
6125,廣運,33,20,13,元大-蘆洲,2023-08-15,9857
00720B,元大投資級公司債,13,0,13,元大-蘆洲,2023-08-15,9857
00772B,中信高評級公司債,13,0,13,元大-蘆洲,2023-08-15,9857
6625,必應,15,3,12,元大-蘆洲,2023-08-15,9857
1326,台化,12,0,12,元大-蘆洲,2023-08-15,9857
8046,南電,14,2,12,元大-蘆洲,2023-08-15,9857
5340,建榮,15,4,11,元大-蘆洲,2023-08-15,9857
00637L,元大滬深300正2,228,217,11,元大-蘆洲,2023-08-15,9857
2867,三商壽,11,0,11,元大-蘆洲,2023-08-15,9857
2834,臺企銀,26,15,11,元大-蘆洲,2023-08-15,9857
2356,英業達,123,113,10,元大-蘆洲,2023-08-15,9857
3034,聯詠,10,0,10,元大-蘆洲,2023-08-15,9857
00929,復華台灣科技優息,373,0,373,元大-蘆洲,2023-08-16,9857
2303,聯電,134,3,131,元大-蘆洲,2023-08-16,9857
2880,華南金,112,0,112,元大-蘆洲,2023-08-16,9857
00923,群益台ESG低碳50,99,0,99,元大-蘆洲,2023-08-16,9857
00900,富邦特選高股息30,109,26,83,元大-蘆洲,2023-08-16,9857
8050,廣積,129,50,79,元大-蘆洲,2023-08-16,9857
2610,華航,175,105,70,元大-蘆洲,2023-08-16,9857
6235,華孚,87,28,59,元大-蘆洲,2023-08-16,9857
1802,台玻,60,2,58,元大-蘆洲,2023-08-16,9857
00772B,中信高評級公司債,51,0,51,元大-蘆洲,2023-08-16,9857
1616,億泰,50,0,50,元大-蘆洲,2023-08-16,9857
2104,國際中橡,50,0,50,元大-蘆洲,2023-08-16,9857
6799,來頡,50,0,50,元大-蘆洲,2023-08-16,9857
00706L,期元大S＆P日圓正2,50,0,50,元大-蘆洲,2023-08-16,9857
3481,群創,71,24,47,元大-蘆洲,2023-08-16,9857
6274,台燿,60,14,46,元大-蘆洲,2023-08-16,9857
00712,復華富時不動產,67,21,46,元大-蘆洲,2023-08-16,9857
2324,仁寶,334,289,45,元大-蘆洲,2023-08-16,9857
00665L,富邦�琤肭磪囓�2,43,0,43,元大-蘆洲,2023-08-16,9857
2609,陽明,59,16,43,元大-蘆洲,2023-08-16,9857
2887,台新金,44,6,38,元大-蘆洲,2023-08-16,9857
0050,元大台灣50,34,0,34,元大-蘆洲,2023-08-16,9857
1301,台塑,34,1,33,元大-蘆洲,2023-08-16,9857
9919,康那香,32,0,32,元大-蘆洲,2023-08-16,9857
2891,中信金,50,19,31,元大-蘆洲,2023-08-16,9857
1101,台泥,39,10,29,元大-蘆洲,2023-08-16,9857
2834,臺企銀,31,4,27,元大-蘆洲,2023-08-16,9857
00927,群益半導體收益,25,0,25,元大-蘆洲,2023-08-16,9857
2323,中環,25,3,22,元大-蘆洲,2023-08-16,9857
00795B,中信美國公債20年,22,0,22,元大-蘆洲,2023-08-16,9857
2883,凱基金,45,23,22,元大-蘆洲,2023-08-16,9857
2354,鴻準,22,1,21,元大-蘆洲,2023-08-16,9857
1795,美時,54,33,21,元大-蘆洲,2023-08-16,9857
00850,元大臺灣ESG永續,20,0,20,元大-蘆洲,2023-08-16,9857
5876,上海商銀,20,0,20,元大-蘆洲,2023-08-16,9857
2345,智邦,22,2,20,元大-蘆洲,2023-08-16,9857
5483,中美晶,26,7,19,元大-蘆洲,2023-08-16,9857
6753,龍德造船,20,1,19,元大-蘆洲,2023-08-16,9857
2344,華邦電,25,6,19,元大-蘆洲,2023-08-16,9857
3037,欣興,34,15,19,元大-蘆洲,2023-08-16,9857
00751B,元大AAA至A公司債,19,2,17,元大-蘆洲,2023-08-16,9857
2002,中鋼,23,6,17,元大-蘆洲,2023-08-16,9857
2886,兆豐金,21,4,17,元大-蘆洲,2023-08-16,9857
2892,第一金,34,18,16,元大-蘆洲,2023-08-16,9857
2885,元大金,17,1,16,元大-蘆洲,2023-08-16,9857
2352,佳世達,35,20,15,元大-蘆洲,2023-08-16,9857
2317,鴻海,35,21,14,元大-蘆洲,2023-08-16,9857
6126,信音,27,13,14,元大-蘆洲,2023-08-16,9857
6231,系微,14,0,14,元大-蘆洲,2023-08-16,9857
2881,富邦金,30,16,14,元大-蘆洲,2023-08-16,9857
00929,復華台灣科技優息,167,22,145,元大-蘆洲,2023-08-17,9857
3231,緯創,329,204,125,元大-蘆洲,2023-08-17,9857
2382,廣達,401,285,116,元大-蘆洲,2023-08-17,9857
2329,華泰,229,122,107,元大-蘆洲,2023-08-17,9857
2409,友達,92,34,58,元大-蘆洲,2023-08-17,9857
00931B,統一美債20年,57,5,52,元大-蘆洲,2023-08-17,9857
00712,復華富時不動產,51,0,51,元大-蘆洲,2023-08-17,9857
2845,遠東銀,50,0,50,元大-蘆洲,2023-08-17,9857
00720B,元大投資級公司債,49,0,49,元大-蘆洲,2023-08-17,9857
2002,中鋼,55,6,49,元大-蘆洲,2023-08-17,9857
2359,所羅門,50,2,48,元大-蘆洲,2023-08-17,9857
2890,永豐金,47,0,47,元大-蘆洲,2023-08-17,9857
6116,彩晶,47,0,47,元大-蘆洲,2023-08-17,9857
2323,中環,64,18,46,元大-蘆洲,2023-08-17,9857
3689,湧德,73,27,46,元大-蘆洲,2023-08-17,9857
6203,海韻電,44,0,44,元大-蘆洲,2023-08-17,9857
00687B,國泰20年美債,45,6,39,元大-蘆洲,2023-08-17,9857
00878,國泰永續高股息,51,14,37,元大-蘆洲,2023-08-17,9857
2324,仁寶,226,190,36,元大-蘆洲,2023-08-17,9857
00882,中信中國高股息,72,36,36,元大-蘆洲,2023-08-17,9857
00772B,中信高評級公司債,35,0,35,元大-蘆洲,2023-08-17,9857
3056,富華新,39,6,33,元大-蘆洲,2023-08-17,9857
9945,潤泰新,33,1,32,元大-蘆洲,2023-08-17,9857
2885,元大金,32,1,31,元大-蘆洲,2023-08-17,9857
2338,光罩,30,0,30,元大-蘆洲,2023-08-17,9857
2888,新光金,36,7,29,元大-蘆洲,2023-08-17,9857
3105,穩懋,31,4,27,元大-蘆洲,2023-08-17,9857
2880,華南金,24,0,24,元大-蘆洲,2023-08-17,9857
2383,台光電,51,28,23,元大-蘆洲,2023-08-17,9857
2427,三商電,23,0,23,元大-蘆洲,2023-08-17,9857
00795B,中信美國公債20年,24,1,23,元大-蘆洲,2023-08-17,9857
00680L,元大美債20正2,22,0,22,元大-蘆洲,2023-08-17,9857
2303,聯電,101,79,22,元大-蘆洲,2023-08-17,9857
1471,首利,29,7,22,元大-蘆洲,2023-08-17,9857
00900,富邦特選高股息30,24,4,20,元大-蘆洲,2023-08-17,9857
00857B,永豐20年美公債,20,0,20,元大-蘆洲,2023-08-17,9857
3052,夆典,20,0,20,元大-蘆洲,2023-08-17,9857
00715L,期街口布蘭特正2,18,0,18,元大-蘆洲,2023-08-17,9857
020038,元大ESG配息N,20,2,18,元大-蘆洲,2023-08-17,9857
00751B,元大AAA至A公司債,19,3,16,元大-蘆洲,2023-08-17,9857
9904,寶成,16,0,16,元大-蘆洲,2023-08-17,9857
6176,瑞儀,18,2,16,元大-蘆洲,2023-08-17,9857
1301,台塑,18,2,16,元大-蘆洲,2023-08-17,9857
2331,精英,15,0,15,元大-蘆洲,2023-08-17,9857
00688L,國泰20年美債正2,15,0,15,元大-蘆洲,2023-08-17,9857
2915,潤泰全,15,0,15,元大-蘆洲,2023-08-17,9857
00923,群益台ESG低碳50,14,0,14,元大-蘆洲,2023-08-17,9857
2388,威盛,37,23,14,元大-蘆洲,2023-08-17,9857
3021,鴻名,15,1,14,元大-蘆洲,2023-08-17,9857
6005,群益證,13,0,13,元大-蘆洲,2023-08-17,9857
2002,中鋼,516,10,506,元大-蘆洲,2023-08-18,9857
00929,復華台灣科技優息,384,17,367,元大-蘆洲,2023-08-18,9857
00931B,統一美債20年,306,5,301,元大-蘆洲,2023-08-18,9857
00885,富邦越南,236,28,208,元大-蘆洲,2023-08-18,9857
00878,國泰永續高股息,273,66,207,元大-蘆洲,2023-08-18,9857
3231,緯創,388,198,190,元大-蘆洲,2023-08-18,9857
2363,矽統,563,462,101,元大-蘆洲,2023-08-18,9857
00712,復華富時不動產,97,3,94,元大-蘆洲,2023-08-18,9857
2324,仁寶,216,131,85,元大-蘆洲,2023-08-18,9857
2618,長榮航,108,37,71,元大-蘆洲,2023-08-18,9857
6139,亞翔,101,34,67,元大-蘆洲,2023-08-18,9857
0056,元大高股息,115,49,66,元大-蘆洲,2023-08-18,9857
2495,普安,66,3,63,元大-蘆洲,2023-08-18,9857
6116,彩晶,63,2,61,元大-蘆洲,2023-08-18,9857
6235,華孚,100,42,58,元大-蘆洲,2023-08-18,9857
2308,台達電,57,0,57,元大-蘆洲,2023-08-18,9857
2610,華航,102,52,50,元大-蘆洲,2023-08-18,9857
2883,凱基金,51,3,48,元大-蘆洲,2023-08-18,9857
3078,僑威,64,18,46,元大-蘆洲,2023-08-18,9857
00673R,期元大S＆P原油反1,75,30,45,元大-蘆洲,2023-08-18,9857
1905,華紙,40,2,38,元大-蘆洲,2023-08-18,9857
00632R,元大台灣50反1,41,3,38,元大-蘆洲,2023-08-18,9857
2409,友達,238,201,37,元大-蘆洲,2023-08-18,9857
00679B,元大美債20年,38,6,32,元大-蘆洲,2023-08-18,9857
2344,華邦電,29,0,29,元大-蘆洲,2023-08-18,9857
1519,華城,53,25,28,元大-蘆洲,2023-08-18,9857
2312,金寶,55,27,28,元大-蘆洲,2023-08-18,9857
1101,台泥,29,2,27,元大-蘆洲,2023-08-18,9857
6625,必應,26,0,26,元大-蘆洲,2023-08-18,9857
0050,元大台灣50,30,4,26,元大-蘆洲,2023-08-18,9857
6190,萬泰科,22,0,22,元大-蘆洲,2023-08-18,9857
00923,群益台ESG低碳50,21,0,21,元大-蘆洲,2023-08-18,9857
00720B,元大投資級公司債,22,1,21,元大-蘆洲,2023-08-18,9857
6285,啟��,44,23,21,元大-蘆洲,2023-08-18,9857
5009,榮剛,22,1,21,元大-蘆洲,2023-08-18,9857
3706,神達,117,96,21,元大-蘆洲,2023-08-18,9857
3035,智原,88,67,21,元大-蘆洲,2023-08-18,9857
00900,富邦特選高股息30,29,9,20,元大-蘆洲,2023-08-18,9857
6015,宏遠證,20,0,20,元大-蘆洲,2023-08-18,9857
6026,福邦證,18,0,18,元大-蘆洲,2023-08-18,9857
1409,新纖,25,7,18,元大-蘆洲,2023-08-18,9857
3038,全台,16,0,16,元大-蘆洲,2023-08-18,9857
6770,力積電,29,14,15,元大-蘆洲,2023-08-18,9857
2204,中華,15,0,15,元大-蘆洲,2023-08-18,9857
3056,富華新,45,30,15,元大-蘆洲,2023-08-18,9857
2834,臺企銀,14,0,14,元大-蘆洲,2023-08-18,9857
020028,元大特選電動車N,14,0,14,元大-蘆洲,2023-08-18,9857
8996,高力,14,1,13,元大-蘆洲,2023-08-18,9857
2913,農林,23,10,13,元大-蘆洲,2023-08-18,9857
2014,中鴻,24,12,12,元大-蘆洲,2023-08-18,9857
00885,富邦越南,241,13,228,元大-蘆洲,2023-08-21,9857
6116,彩晶,121,1,120,元大-蘆洲,2023-08-21,9857
2324,仁寶,170,70,100,元大-蘆洲,2023-08-21,9857
2382,廣達,157,98,59,元大-蘆洲,2023-08-21,9857
00929,復華台灣科技優息,50,5,45,元大-蘆洲,2023-08-21,9857
2605,新興,45,3,42,元大-蘆洲,2023-08-21,9857
00637L,元大滬深300正2,256,220,36,元大-蘆洲,2023-08-21,9857
00715L,期街口布蘭特正2,36,3,33,元大-蘆洲,2023-08-21,9857
6026,福邦證,30,0,30,元大-蘆洲,2023-08-21,9857
2402,毅嘉,48,18,30,元大-蘆洲,2023-08-21,9857
2031,新光鋼,32,3,29,元大-蘆洲,2023-08-21,9857
2344,華邦電,32,4,28,元大-蘆洲,2023-08-21,9857
2618,長榮航,56,29,27,元大-蘆洲,2023-08-21,9857
2886,兆豐金,29,1,28,元大-蘆洲,2023-08-21,9857
00688L,國泰20年美債正2,25,0,25,元大-蘆洲,2023-08-21,9857
00772B,中信高評級公司債,23,0,23,元大-蘆洲,2023-08-21,9857
2356,英業達,181,159,22,元大-蘆洲,2023-08-21,9857
00665L,富邦�琤肭磪囓�2,50,30,20,元大-蘆洲,2023-08-21,9857
1905,華紙,22,2,20,元大-蘆洲,2023-08-21,9857
6160,欣技,23,3,20,元大-蘆洲,2023-08-21,9857
2442,新美齊,20,0,20,元大-蘆洲,2023-08-21,9857
00923,群益台ESG低碳50,20,0,20,元大-蘆洲,2023-08-21,9857
00712,復華富時不動產,29,10,19,元大-蘆洲,2023-08-21,9857
2359,所羅門,35,16,19,元大-蘆洲,2023-08-21,9857
2354,鴻準,19,1,18,元大-蘆洲,2023-08-21,9857
1504,東元,28,10,18,元大-蘆洲,2023-08-21,9857
2353,宏��,23,5,18,元大-蘆洲,2023-08-21,9857
2409,友達,18,0,18,元大-蘆洲,2023-08-21,9857
8027,鈦昇,17,0,17,元大-蘆洲,2023-08-21,9857
3042,晶技,19,2,17,元大-蘆洲,2023-08-21,9857
8358,金居,22,6,16,元大-蘆洲,2023-08-21,9857
8942,森鉅,15,0,15,元大-蘆洲,2023-08-21,9857
3518,柏騰,15,0,15,元大-蘆洲,2023-08-21,9857
3325,旭品,24,9,15,元大-蘆洲,2023-08-21,9857
00679B,元大美債20年,22,7,15,元大-蘆洲,2023-08-21,9857
00907,永豐優息存股,14,0,14,元大-蘆洲,2023-08-21,9857
00891,中信關鍵半導體,18,5,13,元大-蘆洲,2023-08-21,9857
2610,華航,46,33,13,元大-蘆洲,2023-08-21,9857
00913,兆豐台灣晶圓製造,13,0,13,元大-蘆洲,2023-08-21,9857
2369,菱生,13,1,12,元大-蘆洲,2023-08-21,9857
00882,中信中國高股息,53,41,12,元大-蘆洲,2023-08-21,9857
2330,台積電,12,0,12,元大-蘆洲,2023-08-21,9857
00751B,元大AAA至A公司債,17,6,11,元大-蘆洲,2023-08-21,9857
1444,力麗,11,0,11,元大-蘆洲,2023-08-21,9857
00650L,復華香港正2,11,0,11,元大-蘆洲,2023-08-21,9857
6719,力智,11,0,11,元大-蘆洲,2023-08-21,9857
1513,中興電,17,7,10,元大-蘆洲,2023-08-21,9857
00900,富邦特選高股息30,18,8,10,元大-蘆洲,2023-08-21,9857
2363,矽統,525,514,11,元大-蘆洲,2023-08-21,9857
1471,首利,23,13,10,元大-蘆洲,2023-08-21,9857
00637L,元大滬深300正2,440,220,220,元大-蘆洲,2023-08-22,9857
3703,欣陸,200,0,200,元大-蘆洲,2023-08-22,9857
6285,啟��,163,62,101,元大-蘆洲,2023-08-22,9857
8112,至上,101,0,101,元大-蘆洲,2023-08-22,9857
00929,復華台灣科技優息,85,15,70,元大-蘆洲,2023-08-22,9857
6116,彩晶,67,0,67,元大-蘆洲,2023-08-22,9857
1301,台塑,65,1,64,元大-蘆洲,2023-08-22,9857
2363,矽統,646,587,59,元大-蘆洲,2023-08-22,9857
3231,緯創,253,194,59,元大-蘆洲,2023-08-22,9857
2329,華泰,106,47,59,元大-蘆洲,2023-08-22,9857
2402,毅嘉,71,15,56,元大-蘆洲,2023-08-22,9857
2888,新光金,53,1,52,元大-蘆洲,2023-08-22,9857
3706,神達,66,21,45,元大-蘆洲,2023-08-22,9857
5469,瀚宇博,46,5,41,元大-蘆洲,2023-08-22,9857
00679B,元大美債20年,41,2,39,元大-蘆洲,2023-08-22,9857
4906,正文,55,19,36,元大-蘆洲,2023-08-22,9857
2208,台船,32,0,32,元大-蘆洲,2023-08-22,9857
2883,凱基金,31,0,31,元大-蘆洲,2023-08-22,9857
2504,國產,30,0,30,元大-蘆洲,2023-08-22,9857
2332,友訊,90,63,27,元大-蘆洲,2023-08-22,9857
2359,所羅門,48,21,27,元大-蘆洲,2023-08-22,9857
3694,海華,37,10,27,元大-蘆洲,2023-08-22,9857
1909,榮成,26,0,26,元大-蘆洲,2023-08-22,9857
2401,凌陽,36,12,24,元大-蘆洲,2023-08-22,9857
00687B,國泰20年美債,25,2,23,元大-蘆洲,2023-08-22,9857
3380,明泰,43,20,23,元大-蘆洲,2023-08-22,9857
2637,慧洋-KY,32,9,23,元大-蘆洲,2023-08-22,9857
2613,中櫃,23,0,23,元大-蘆洲,2023-08-22,9857
00650L,復華香港正2,24,1,23,元大-蘆洲,2023-08-22,9857
2031,新光鋼,22,0,22,元大-蘆洲,2023-08-22,9857
4533,協易機,21,0,21,元大-蘆洲,2023-08-22,9857
2356,英業達,157,137,20,元大-蘆洲,2023-08-22,9857
3032,偉訓,24,4,20,元大-蘆洲,2023-08-22,9857
00655L,國泰中國A50正2,20,0,20,元大-蘆洲,2023-08-22,9857
5483,中美晶,20,1,19,元大-蘆洲,2023-08-22,9857
2206,三陽工業,20,1,19,元大-蘆洲,2023-08-22,9857
00907,永豐優息存股,18,0,18,元大-蘆洲,2023-08-22,9857
1609,大亞,23,5,18,元大-蘆洲,2023-08-22,9857
2344,華邦電,19,2,17,元大-蘆洲,2023-08-22,9857
00900,富邦特選高股息30,18,1,17,元大-蘆洲,2023-08-22,9857
6257,矽格,17,1,16,元大-蘆洲,2023-08-22,9857
2881,富邦金,15,0,15,元大-蘆洲,2023-08-22,9857
2421,建準,54,39,15,元大-蘆洲,2023-08-22,9857
6282,康舒,28,13,15,元大-蘆洲,2023-08-22,9857
2419,仲琦,42,27,15,元大-蘆洲,2023-08-22,9857
00927,群益半導體收益,15,0,15,元大-蘆洲,2023-08-22,9857
3308,聯德,21,7,14,元大-蘆洲,2023-08-22,9857
2891,中信金,34,21,13,元大-蘆洲,2023-08-22,9857
00751B,元大AAA至A公司債,16,3,13,元大-蘆洲,2023-08-22,9857
00882,中信中國高股息,18,5,13,元大-蘆洲,2023-08-22,9857
6139,亞翔,128,16,112,元大-蘆洲,2023-08-23,9857
3306,鼎天,102,2,100,元大-蘆洲,2023-08-23,9857
2409,友達,92,6,86,元大-蘆洲,2023-08-23,9857
2618,長榮航,100,39,61,元大-蘆洲,2023-08-23,9857
00929,復華台灣科技優息,122,63,59,元大-蘆洲,2023-08-23,9857
2382,廣達,157,101,56,元大-蘆洲,2023-08-23,9857
2913,農林,52,0,52,元大-蘆洲,2023-08-23,9857
2329,華泰,109,62,47,元大-蘆洲,2023-08-23,9857
2881,富邦金,45,2,43,元大-蘆洲,2023-08-23,9857
6282,康舒,72,33,39,元大-蘆洲,2023-08-23,9857
2883,凱基金,37,0,37,元大-蘆洲,2023-08-23,9857
1301,台塑,36,0,36,元大-蘆洲,2023-08-23,9857
3163,波若威,58,23,35,元大-蘆洲,2023-08-23,9857
00712,復華富時不動產,34,1,33,元大-蘆洲,2023-08-23,9857
3078,僑威,33,4,29,元大-蘆洲,2023-08-23,9857
2301,光寶科,37,11,26,元大-蘆洲,2023-08-23,9857
2344,華邦電,26,2,24,元大-蘆洲,2023-08-23,9857
1528,恩德,20,0,20,元大-蘆洲,2023-08-23,9857
3711,日月光投控,20,1,19,元大-蘆洲,2023-08-23,9857
2610,華航,39,21,18,元大-蘆洲,2023-08-23,9857
3308,聯德,40,22,18,元大-蘆洲,2023-08-23,9857
00751B,元大AAA至A公司債,20,3,17,元大-蘆洲,2023-08-23,9857
1527,鑽全,17,0,17,元大-蘆洲,2023-08-23,9857
2002,中鋼,18,1,17,元大-蘆洲,2023-08-23,9857
1519,華城,54,38,16,元大-蘆洲,2023-08-23,9857
4979,華星光,33,17,16,元大-蘆洲,2023-08-23,9857
2630,亞航,18,2,16,元大-蘆洲,2023-08-23,9857
2637,慧洋-KY,16,1,15,元大-蘆洲,2023-08-23,9857
2421,建準,35,20,15,元大-蘆洲,2023-08-23,9857
2338,光罩,22,7,15,元大-蘆洲,2023-08-23,9857
6170,統振,27,14,13,元大-蘆洲,2023-08-23,9857
2323,中環,27,14,13,元大-蘆洲,2023-08-23,9857
00719B,元大美債1-3,13,0,13,元大-蘆洲,2023-08-23,9857
5371,中光電,20,7,13,元大-蘆洲,2023-08-23,9857
00902,中信電池及儲能,13,0,13,元大-蘆洲,2023-08-23,9857
5871,中租-KY,13,0,13,元大-蘆洲,2023-08-23,9857
2801,彰銀,12,0,12,元大-蘆洲,2023-08-23,9857
3312,弘憶股,12,0,12,元大-蘆洲,2023-08-23,9857
1709,和益,12,0,12,元大-蘆洲,2023-08-23,9857
2324,仁寶,35,23,12,元大-蘆洲,2023-08-23,9857
2206,三陽工業,12,1,11,元大-蘆洲,2023-08-23,9857
1417,嘉裕,11,0,11,元大-蘆洲,2023-08-23,9857
2883B,凱基金乙特,10,0,10,元大-蘆洲,2023-08-23,9857
00697B,元大美債7-10,10,0,10,元大-蘆洲,2023-08-23,9857
2915,潤泰全,10,0,10,元大-蘆洲,2023-08-23,9857
00665L,富邦�琤肭磪囓�2,14,4,10,元大-蘆洲,2023-08-23,9857
00755B,群益投資級公用債,10,0,10,元大-蘆洲,2023-08-23,9857
6770,力積電,16,7,9,元大-蘆洲,2023-08-23,9857
2355,敬鵬,13,4,9,元大-蘆洲,2023-08-23,9857
3207,耀勝,13,4,9,元大-蘆洲,2023-08-23,9857
00929,復華台灣科技優息,647,59,588,元大-蘆洲,2023-08-24,9857
2363,矽統,850,675,175,元大-蘆洲,2023-08-24,9857
00919,群益台灣精選高息,146,7,139,元大-蘆洲,2023-08-24,9857
3308,聯德,126,34,92,元大-蘆洲,2023-08-24,9857
3231,緯創,466,391,75,元大-蘆洲,2023-08-24,9857
2376,技嘉,137,65,72,元大-蘆洲,2023-08-24,9857
2324,仁寶,119,49,70,元大-蘆洲,2023-08-24,9857
6167,久正,64,16,48,元大-蘆洲,2023-08-24,9857
2356,英業達,205,161,44,元大-蘆洲,2023-08-24,9857
2419,仲琦,125,93,32,元大-蘆洲,2023-08-24,9857
2332,友訊,73,42,31,元大-蘆洲,2023-08-24,9857
3312,弘憶股,33,3,30,元大-蘆洲,2023-08-24,9857
2002,中鋼,30,1,29,元大-蘆洲,2023-08-24,9857
2338,光罩,30,2,28,元大-蘆洲,2023-08-24,9857
3567,逸昌,39,12,27,元大-蘆洲,2023-08-24,9857
4960,誠美材,29,2,27,元大-蘆洲,2023-08-24,9857
3062,建漢,36,10,26,元大-蘆洲,2023-08-24,9857
2355,敬鵬,29,5,24,元大-蘆洲,2023-08-24,9857
2538,基泰,56,32,24,元大-蘆洲,2023-08-24,9857
2801,彰銀,24,1,23,元大-蘆洲,2023-08-24,9857
6188,廣明,25,2,23,元大-蘆洲,2023-08-24,9857
9945,潤泰新,23,0,23,元大-蘆洲,2023-08-24,9857
2312,金寶,28,6,22,元大-蘆洲,2023-08-24,9857
4763,材料-KY,36,14,22,元大-蘆洲,2023-08-24,9857
2880,華南金,21,1,20,元大-蘆洲,2023-08-24,9857
1210,大成,20,0,20,元大-蘆洲,2023-08-24,9857
2617,台航,22,2,20,元大-蘆洲,2023-08-24,9857
8404,百和興業-KY,20,0,20,元大-蘆洲,2023-08-24,9857
6015,宏遠證,20,0,20,元大-蘆洲,2023-08-24,9857
3038,全台,20,0,20,元大-蘆洲,2023-08-24,9857
8107,大億金茂,20,0,20,元大-蘆洲,2023-08-24,9857
2883,凱基金,25,6,19,元大-蘆洲,2023-08-24,9857
2405,輔信,21,2,19,元大-蘆洲,2023-08-24,9857
2605,新興,49,30,19,元大-蘆洲,2023-08-24,9857
1760,寶齡富錦,18,0,18,元大-蘆洲,2023-08-24,9857
3694,海華,18,1,17,元大-蘆洲,2023-08-24,9857
3363,上詮,18,1,17,元大-蘆洲,2023-08-24,9857
00751B,元大AAA至A公司債,17,1,16,元大-蘆洲,2023-08-24,9857
2371,大同,19,4,15,元大-蘆洲,2023-08-24,9857
3036,文曄,15,0,15,元大-蘆洲,2023-08-24,9857
00923,群益台ESG低碳50,20,5,15,元大-蘆洲,2023-08-24,9857
00712,復華富時不動產,19,5,14,元大-蘆洲,2023-08-24,9857
2516,新建,20,6,14,元大-蘆洲,2023-08-24,9857
6125,廣運,33,20,13,元大-蘆洲,2023-08-24,9857
2436,偉詮電,21,8,13,元大-蘆洲,2023-08-24,9857
5388,中磊,20,7,13,元大-蘆洲,2023-08-24,9857
5009,榮剛,13,1,12,元大-蘆洲,2023-08-24,9857
6153,嘉聯益,12,0,12,元大-蘆洲,2023-08-24,9857
1605,華新,23,11,12,元大-蘆洲,2023-08-24,9857
4506,崇友,11,0,11,元大-蘆洲,2023-08-24,9857
00878,國泰永續高股息,480,75,405,元大-蘆洲,2023-08-25,9857
3231,緯創,477,120,357,元大-蘆洲,2023-08-25,9857
00637L,元大滬深300正2,305,105,200,元大-蘆洲,2023-08-25,9857
6235,華孚,180,37,143,元大-蘆洲,2023-08-25,9857
00929,復華台灣科技優息,160,27,133,元大-蘆洲,2023-08-25,9857
3037,欣興,90,14,76,元大-蘆洲,2023-08-25,9857
00900,富邦特選高股息30,141,71,70,元大-蘆洲,2023-08-25,9857
2382,廣達,145,79,66,元大-蘆洲,2023-08-25,9857
00919,群益台灣精選高息,69,6,63,元大-蘆洲,2023-08-25,9857
2485,兆赫,141,87,54,元大-蘆洲,2023-08-25,9857
6168,宏齊,63,9,54,元大-蘆洲,2023-08-25,9857
1471,首利,48,2,46,元大-蘆洲,2023-08-25,9857
8011,台通,37,0,37,元大-蘆洲,2023-08-25,9857
4979,華星光,38,6,32,元大-蘆洲,2023-08-25,9857
2609,陽明,35,6,29,元大-蘆洲,2023-08-25,9857
2736,富野,29,1,28,元大-蘆洲,2023-08-25,9857
2610,華航,142,115,27,元大-蘆洲,2023-08-25,9857
1815,富喬,26,0,26,元大-蘆洲,2023-08-25,9857
2705,六福,29,3,26,元大-蘆洲,2023-08-25,9857
0056,元大高股息,49,24,25,元大-蘆洲,2023-08-25,9857
00923,群益台ESG低碳50,24,1,23,元大-蘆洲,2023-08-25,9857
3138,耀登,23,0,23,元大-蘆洲,2023-08-25,9857
2303,聯電,34,11,23,元大-蘆洲,2023-08-25,9857
2880,華南金,21,0,21,元大-蘆洲,2023-08-25,9857
2641,正德,21,0,21,元大-蘆洲,2023-08-25,9857
3706,神達,28,7,21,元大-蘆洲,2023-08-25,9857
00713,元大台灣高息低波,20,0,20,元大-蘆洲,2023-08-25,9857
2486,一詮,23,3,20,元大-蘆洲,2023-08-25,9857
1503,士電,28,8,20,元大-蘆洲,2023-08-25,9857
2330,台積電,38,18,20,元大-蘆洲,2023-08-25,9857
6116,彩晶,23,4,19,元大-蘆洲,2023-08-25,9857
2888,新光金,19,3,16,元大-蘆洲,2023-08-25,9857
3051,力特,16,0,16,元大-蘆洲,2023-08-25,9857
2617,台航,16,0,16,元大-蘆洲,2023-08-25,9857
4155,訊映,15,0,15,元大-蘆洲,2023-08-25,9857
2913,農林,15,0,15,元大-蘆洲,2023-08-25,9857
2883,凱基金,20,5,15,元大-蘆洲,2023-08-25,9857
2317,鴻海,17,2,15,元大-蘆洲,2023-08-25,9857
00712,復華富時不動產,21,7,14,元大-蘆洲,2023-08-25,9857
1301,台塑,13,0,13,元大-蘆洲,2023-08-25,9857
1736,喬山,14,1,13,元大-蘆洲,2023-08-25,9857
0050,元大台灣50,13,0,13,元大-蘆洲,2023-08-25,9857
00753L,中信中國50正2,12,0,12,元大-蘆洲,2023-08-25,9857
2353,宏��,23,11,12,元大-蘆洲,2023-08-25,9857
00720B,元大投資級公司債,17,5,12,元大-蘆洲,2023-08-25,9857
2356,英業達,57,46,11,元大-蘆洲,2023-08-25,9857
2301,光寶科,31,20,11,元大-蘆洲,2023-08-25,9857
6418,詠昇,19,8,11,元大-蘆洲,2023-08-25,9857
5871,中租-KY,11,0,11,元大-蘆洲,2023-08-25,9857
00907,永豐優息存股,11,0,11,元大-蘆洲,2023-08-25,9857
2002,中鋼,212,5,207,元大-蘆洲,2023-08-28,9857
2014,中鴻,155,9,146,元大-蘆洲,2023-08-28,9857
00929,復華台灣科技優息,137,40,97,元大-蘆洲,2023-08-28,9857
2312,金寶,102,7,95,元大-蘆洲,2023-08-28,9857
2610,華航,94,1,93,元大-蘆洲,2023-08-28,9857
00878,國泰永續高股息,94,7,87,元大-蘆洲,2023-08-28,9857
6285,啟��,80,5,75,元大-蘆洲,2023-08-28,9857
00900,富邦特選高股息30,84,11,73,元大-蘆洲,2023-08-28,9857
2886,兆豐金,86,15,71,元大-蘆洲,2023-08-28,9857
3051,力特,122,61,61,元大-蘆洲,2023-08-28,9857
4906,正文,126,66,60,元大-蘆洲,2023-08-28,9857
00931B,統一美債20年,103,44,59,元大-蘆洲,2023-08-28,9857
3481,群創,75,17,58,元大-蘆洲,2023-08-28,9857
2388,威盛,96,39,57,元大-蘆洲,2023-08-28,9857
1314,中石化,53,0,53,元大-蘆洲,2023-08-28,9857
00919,群益台灣精選高息,56,6,50,元大-蘆洲,2023-08-28,9857
5534,長虹,47,0,47,元大-蘆洲,2023-08-28,9857
1514,亞力,42,1,41,元大-蘆洲,2023-08-28,9857
6139,亞翔,53,13,40,元大-蘆洲,2023-08-28,9857
1815,富喬,34,0,34,元大-蘆洲,2023-08-28,9857
1737,臺鹽,43,13,30,元大-蘆洲,2023-08-28,9857
2324,仁寶,39,15,24,元大-蘆洲,2023-08-28,9857
2634,漢翔,216,193,23,元大-蘆洲,2023-08-28,9857
2834,臺企銀,22,0,22,元大-蘆洲,2023-08-28,9857
2402,毅嘉,50,28,22,元大-蘆洲,2023-08-28,9857
3035,智原,37,15,22,元大-蘆洲,2023-08-28,9857
1609,大亞,24,4,20,元大-蘆洲,2023-08-28,9857
3308,聯德,66,47,19,元大-蘆洲,2023-08-28,9857
1605,華新,18,1,17,元大-蘆洲,2023-08-28,9857
2208,台船,18,2,16,元大-蘆洲,2023-08-28,9857
2449,京元電子,44,29,15,元大-蘆洲,2023-08-28,9857
1587,吉茂,15,0,15,元大-蘆洲,2023-08-28,9857
2206,三陽工業,15,0,15,元大-蘆洲,2023-08-28,9857
3032,偉訓,14,0,14,元大-蘆洲,2023-08-28,9857
2344,華邦電,16,2,14,元大-蘆洲,2023-08-28,9857
2359,所羅門,21,8,13,元大-蘆洲,2023-08-28,9857
4763,材料-KY,18,5,13,元大-蘆洲,2023-08-28,9857
4960,誠美材,13,0,13,元大-蘆洲,2023-08-28,9857
2485,兆赫,20,7,13,元大-蘆洲,2023-08-28,9857
2340,台亞,36,24,12,元大-蘆洲,2023-08-28,9857
3042,晶技,12,0,12,元大-蘆洲,2023-08-28,9857
6125,廣運,28,16,12,元大-蘆洲,2023-08-28,9857
9950,萬國通,12,0,12,元大-蘆洲,2023-08-28,9857
3312,弘憶股,12,0,12,元大-蘆洲,2023-08-28,9857
3715,定穎投控,22,10,12,元大-蘆洲,2023-08-28,9857
0056,元大高股息,18,6,12,元大-蘆洲,2023-08-28,9857
2419,仲琦,18,7,11,元大-蘆洲,2023-08-28,9857
8927,北基,12,1,11,元大-蘆洲,2023-08-28,9857
3006,晶豪科,11,0,11,元大-蘆洲,2023-08-28,9857
2352,佳世達,13,3,10,元大-蘆洲,2023-08-28,9857
2880,華南金,316,0,316,元大-蘆洲,2023-08-29,9857
2303,聯電,246,28,218,元大-蘆洲,2023-08-29,9857
2363,矽統,733,538,195,元大-蘆洲,2023-08-29,9857
2329,華泰,169,54,115,元大-蘆洲,2023-08-29,9857
00680L,元大美債20正2,84,0,84,元大-蘆洲,2023-08-29,9857
00929,復華台灣科技優息,88,25,63,元大-蘆洲,2023-08-29,9857
6829,千附精密,56,7,49,元大-蘆洲,2023-08-29,9857
3231,緯創,154,109,45,元大-蘆洲,2023-08-29,9857
00878,國泰永續高股息,67,22,45,元大-蘆洲,2023-08-29,9857
00712,復華富時不動產,65,22,43,元大-蘆洲,2023-08-29,9857
3481,群創,66,30,36,元大-蘆洲,2023-08-29,9857
2002,中鋼,37,3,34,元大-蘆洲,2023-08-29,9857
6244,茂迪,31,0,31,元大-蘆洲,2023-08-29,9857
6015,宏遠證,30,0,30,元大-蘆洲,2023-08-29,9857
00637L,元大滬深300正2,138,108,30,元大-蘆洲,2023-08-29,9857
2516,新建,30,0,30,元大-蘆洲,2023-08-29,9857
3706,神達,32,5,27,元大-蘆洲,2023-08-29,9857
1905,華紙,32,5,27,元大-蘆洲,2023-08-29,9857
1471,首利,102,76,26,元大-蘆洲,2023-08-29,9857
00687B,國泰20年美債,26,1,25,元大-蘆洲,2023-08-29,9857
6167,久正,69,46,23,元大-蘆洲,2023-08-29,9857
8222,寶一,31,9,22,元大-蘆洲,2023-08-29,9857
2883,凱基金,21,0,21,元大-蘆洲,2023-08-29,9857
3312,弘憶股,20,0,20,元大-蘆洲,2023-08-29,9857
1815,富喬,20,1,19,元大-蘆洲,2023-08-29,9857
6282,康舒,20,2,18,元大-蘆洲,2023-08-29,9857
2317,鴻海,32,14,18,元大-蘆洲,2023-08-29,9857
6104,創惟,24,9,15,元大-蘆洲,2023-08-29,9857
9904,寶成,15,0,15,元大-蘆洲,2023-08-29,9857
1108,幸福,15,0,15,元大-蘆洲,2023-08-29,9857
2897,王道銀行,14,0,14,元大-蘆洲,2023-08-29,9857
8033,雷虎,15,1,14,元大-蘆洲,2023-08-29,9857
00665L,富邦�琤肭磪囓�2,30,18,12,元大-蘆洲,2023-08-29,9857
00651R,復華香港反1,12,0,12,元大-蘆洲,2023-08-29,9857
6234,高僑,12,0,12,元大-蘆洲,2023-08-29,9857
3032,偉訓,13,1,12,元大-蘆洲,2023-08-29,9857
5009,榮剛,19,7,12,元大-蘆洲,2023-08-29,9857
6026,福邦證,12,0,12,元大-蘆洲,2023-08-29,9857
00865B,國泰US短期公債,11,0,11,元大-蘆洲,2023-08-29,9857
8358,金居,28,17,11,元大-蘆洲,2023-08-29,9857
2801,彰銀,10,0,10,元大-蘆洲,2023-08-29,9857
2323,中環,24,14,10,元大-蘆洲,2023-08-29,9857
3149,正達,10,0,10,元大-蘆洲,2023-08-29,9857
4712,福格創新,10,0,10,元大-蘆洲,2023-08-29,9857
1701,中化,10,0,10,元大-蘆洲,2023-08-29,9857
1218,泰山,10,0,10,元大-蘆洲,2023-08-29,9857
2332,友訊,19,10,9,元大-蘆洲,2023-08-29,9857
6116,彩晶,10,1,9,元大-蘆洲,2023-08-29,9857
2352,佳世達,13,4,9,元大-蘆洲,2023-08-29,9857
8110,華東,9,0,9,元大-蘆洲,2023-08-29,9857
3715,定穎投控,567,131,436,元大-蘆洲,2023-08-30,9857
2618,長榮航,150,54,96,元大-蘆洲,2023-08-30,9857
3481,群創,102,20,82,元大-蘆洲,2023-08-30,9857
1471,首利,93,38,55,元大-蘆洲,2023-08-30,9857
8358,金居,109,56,53,元大-蘆洲,2023-08-30,9857
2610,華航,62,10,52,元大-蘆洲,2023-08-30,9857
1319,東陽,100,48,52,元大-蘆洲,2023-08-30,9857
5009,榮剛,48,0,48,元大-蘆洲,2023-08-30,9857
2367,燿華,51,9,42,元大-蘆洲,2023-08-30,9857
4763,材料-KY,59,17,42,元大-蘆洲,2023-08-30,9857
00929,復華台灣科技優息,85,49,36,元大-蘆洲,2023-08-30,9857
2485,兆赫,97,62,35,元大-蘆洲,2023-08-30,9857
00637L,元大滬深300正2,38,4,34,元大-蘆洲,2023-08-30,9857
6799,來頡,33,1,32,元大-蘆洲,2023-08-30,9857
00673R,期元大S＆P原油反1,31,0,31,元大-蘆洲,2023-08-30,9857
00632R,元大台灣50反1,39,10,29,元大-蘆洲,2023-08-30,9857
4572,駐龍,27,0,27,元大-蘆洲,2023-08-30,9857
6235,華孚,69,47,22,元大-蘆洲,2023-08-30,9857
3094,聯傑,30,8,22,元大-蘆洲,2023-08-30,9857
1802,台玻,98,78,20,元大-蘆洲,2023-08-30,9857
2324,仁寶,55,36,19,元大-蘆洲,2023-08-30,9857
6116,彩晶,37,18,19,元大-蘆洲,2023-08-30,9857
2301,光寶科,36,18,18,元大-蘆洲,2023-08-30,9857
2399,映泰,18,0,18,元大-蘆洲,2023-08-30,9857
3051,力特,48,32,16,元大-蘆洲,2023-08-30,9857
1503,士電,16,0,16,元大-蘆洲,2023-08-30,9857
2634,漢翔,23,7,16,元大-蘆洲,2023-08-30,9857
6605,帝寶,16,0,16,元大-蘆洲,2023-08-30,9857
8112,至上,16,3,13,元大-蘆洲,2023-08-30,9857
00882,中信中國高股息,25,12,13,元大-蘆洲,2023-08-30,9857
3264,欣銓,14,1,13,元大-蘆洲,2023-08-30,9857
2436,偉詮電,130,118,12,元大-蘆洲,2023-08-30,9857
910861,神州-DR,12,0,12,元大-蘆洲,2023-08-30,9857
5608,四維航,11,0,11,元大-蘆洲,2023-08-30,9857
6104,創惟,14,3,11,元大-蘆洲,2023-08-30,9857
1210,大成,11,0,11,元大-蘆洲,2023-08-30,9857
2316,楠梓電,12,2,10,元大-蘆洲,2023-08-30,9857
2412,中華電,10,0,10,元大-蘆洲,2023-08-30,9857
3354,律勝,10,0,10,元大-蘆洲,2023-08-30,9857
2516,新建,10,0,10,元大-蘆洲,2023-08-30,9857
2486,一詮,10,0,10,元大-蘆洲,2023-08-30,9857
4564,元翎,10,0,10,元大-蘆洲,2023-08-30,9857
1783,和康生,10,0,10,元大-蘆洲,2023-08-30,9857
2888,新光金,18,8,10,元大-蘆洲,2023-08-30,9857
00931B,統一美債20年,10,0,10,元大-蘆洲,2023-08-30,9857
1101,台泥,10,0,10,元大-蘆洲,2023-08-30,9857
2892,第一金,13,3,10,元大-蘆洲,2023-08-30,9857
6443,元晶,10,1,9,元大-蘆洲,2023-08-30,9857
2355,敬鵬,63,54,9,元大-蘆洲,2023-08-30,9857
00923,群益台ESG低碳50,12,3,9,元大-蘆洲,2023-08-30,9857
1319,東陽,215,32,183,元大-蘆洲,2023-08-31,9857
1314,中石化,150,4,146,元大-蘆洲,2023-08-31,9857
00929,復華台灣科技優息,157,18,139,元大-蘆洲,2023-08-31,9857
2303,聯電,116,6,110,元大-蘆洲,2023-08-31,9857
911868,同方友友-DR,100,0,100,元大-蘆洲,2023-08-31,9857
3481,群創,110,21,89,元大-蘆洲,2023-08-31,9857
2880,華南金,84,4,80,元大-蘆洲,2023-08-31,9857
00878,國泰永續高股息,104,44,60,元大-蘆洲,2023-08-31,9857
2363,矽統,408,356,52,元大-蘆洲,2023-08-31,9857
2436,偉詮電,93,52,41,元大-蘆洲,2023-08-31,9857
2337,旺宏,76,43,33,元大-蘆洲,2023-08-31,9857
2890,永豐金,31,0,31,元大-蘆洲,2023-08-31,9857
1815,富喬,30,0,30,元大-蘆洲,2023-08-31,9857
6491,晶碩,44,17,27,元大-蘆洲,2023-08-31,9857
8033,雷虎,50,25,25,元大-蘆洲,2023-08-31,9857
4130,健亞,25,0,25,元大-蘆洲,2023-08-31,9857
00919,群益台灣精選高息,44,20,24,元大-蘆洲,2023-08-31,9857
00882,中信中國高股息,24,0,24,元大-蘆洲,2023-08-31,9857
2834,臺企銀,23,0,23,元大-蘆洲,2023-08-31,9857
2330,台積電,22,0,22,元大-蘆洲,2023-08-31,9857
4572,駐龍,21,0,21,元大-蘆洲,2023-08-31,9857
2359,所羅門,27,6,21,元大-蘆洲,2023-08-31,9857
1760,寶齡富錦,21,1,20,元大-蘆洲,2023-08-31,9857
3682,亞太電,20,0,20,元大-蘆洲,2023-08-31,9857
5009,榮剛,23,4,19,元大-蘆洲,2023-08-31,9857
3372,典範,19,0,19,元大-蘆洲,2023-08-31,9857
4967,十銓,48,29,19,元大-蘆洲,2023-08-31,9857
6770,力積電,21,2,19,元大-蘆洲,2023-08-31,9857
1471,首利,66,48,18,元大-蘆洲,2023-08-31,9857
9945,潤泰新,26,9,17,元大-蘆洲,2023-08-31,9857
2364,倫飛,27,10,17,元大-蘆洲,2023-08-31,9857
2886,兆豐金,15,0,15,元大-蘆洲,2023-08-31,9857
2891,中信金,15,0,15,元大-蘆洲,2023-08-31,9857
2888,新光金,24,9,15,元大-蘆洲,2023-08-31,9857
2409,友達,36,21,15,元大-蘆洲,2023-08-31,9857
3081,聯亞,15,0,15,元大-蘆洲,2023-08-31,9857
1101,台泥,17,3,14,元大-蘆洲,2023-08-31,9857
00715L,期街口布蘭特正2,24,10,14,元大-蘆洲,2023-08-31,9857
8086,宏捷科,25,11,14,元大-蘆洲,2023-08-31,9857
2885,元大金,14,0,14,元大-蘆洲,2023-08-31,9857
4919,新唐,13,0,13,元大-蘆洲,2023-08-31,9857
2486,一詮,13,0,13,元大-蘆洲,2023-08-31,9857
00632R,元大台灣50反1,13,0,13,元大-蘆洲,2023-08-31,9857
2367,燿華,55,42,13,元大-蘆洲,2023-08-31,9857
1216,統一,13,1,12,元大-蘆洲,2023-08-31,9857
2002,中鋼,13,2,11,元大-蘆洲,2023-08-31,9857
6111,大宇資,12,1,11,元大-蘆洲,2023-08-31,9857
2801,彰銀,11,0,11,元大-蘆洲,2023-08-31,9857
3257,虹冠電,11,0,11,元大-蘆洲,2023-08-31,9857
1301,台塑,10,0,10,元大-蘆洲,2023-08-31,9857
00929,復華台灣科技優息,403,18,385,元大-蘆洲,2023-09-01,9857
00919,群益台灣精選高息,201,23,178,元大-蘆洲,2023-09-01,9857
3231,緯創,304,137,167,元大-蘆洲,2023-09-01,9857
00932,兆豐永續高息等權,124,0,124,元大-蘆洲,2023-09-01,9857
2303,聯電,118,22,96,元大-蘆洲,2023-09-01,9857
1314,中石化,104,9,95,元大-蘆洲,2023-09-01,9857
00673R,期元大S＆P原油反1,101,15,86,元大-蘆洲,2023-09-01,9857
00878,國泰永續高股息,93,27,66,元大-蘆洲,2023-09-01,9857
4909,新復興,91,29,62,元大-蘆洲,2023-09-01,9857
2356,英業達,84,34,50,元大-蘆洲,2023-09-01,9857
2402,毅嘉,199,153,46,元大-蘆洲,2023-09-01,9857
2329,華泰,136,92,44,元大-蘆洲,2023-09-01,9857
1471,首利,51,8,43,元大-蘆洲,2023-09-01,9857
00923,群益台ESG低碳50,56,15,41,元大-蘆洲,2023-09-01,9857
2323,中環,43,2,41,元大-蘆洲,2023-09-01,9857
2337,旺宏,70,30,40,元大-蘆洲,2023-09-01,9857
2359,所羅門,44,5,39,元大-蘆洲,2023-09-01,9857
3163,波若威,130,91,39,元大-蘆洲,2023-09-01,9857
2355,敬鵬,53,15,38,元大-蘆洲,2023-09-01,9857
3078,僑威,46,12,34,元大-蘆洲,2023-09-01,9857
6282,康舒,60,28,32,元大-蘆洲,2023-09-01,9857
1522,堤維西,40,11,29,元大-蘆洲,2023-09-01,9857
2324,仁寶,41,13,28,元大-蘆洲,2023-09-01,9857
3037,欣興,32,7,25,元大-蘆洲,2023-09-01,9857
2382,廣達,87,64,23,元大-蘆洲,2023-09-01,9857
2376,技嘉,63,40,23,元大-蘆洲,2023-09-01,9857
2890,永豐金,25,2,23,元大-蘆洲,2023-09-01,9857
2377,微星,20,0,20,元大-蘆洲,2023-09-01,9857
1313,聯成,20,0,20,元大-蘆洲,2023-09-01,9857
1802,台玻,142,122,20,元大-蘆洲,2023-09-01,9857
3481,群創,38,18,20,元大-蘆洲,2023-09-01,9857
2301,光寶科,33,14,19,元大-蘆洲,2023-09-01,9857
00713,元大台灣高息低波,23,4,19,元大-蘆洲,2023-09-01,9857
3707,漢磊,20,1,19,元大-蘆洲,2023-09-01,9857
3035,智原,101,82,19,元大-蘆洲,2023-09-01,9857
3042,晶技,20,2,18,元大-蘆洲,2023-09-01,9857
0056,元大高股息,26,8,18,元大-蘆洲,2023-09-01,9857
2419,仲琦,18,1,17,元大-蘆洲,2023-09-01,9857
3622,洋華,21,5,16,元大-蘆洲,2023-09-01,9857
1101,台泥,18,3,15,元大-蘆洲,2023-09-01,9857
2485,兆赫,116,101,15,元大-蘆洲,2023-09-01,9857
6235,華孚,30,15,15,元大-蘆洲,2023-09-01,9857
4746,台耀,15,0,15,元大-蘆洲,2023-09-01,9857
2330,台積電,14,0,14,元大-蘆洲,2023-09-01,9857
1904,正隆,15,1,14,元大-蘆洲,2023-09-01,9857
00712,復華富時不動產,13,0,13,元大-蘆洲,2023-09-01,9857
6285,啟��,19,6,13,元大-蘆洲,2023-09-01,9857
2412,中華電,13,0,13,元大-蘆洲,2023-09-01,9857
2401,凌陽,23,10,13,元大-蘆洲,2023-09-01,9857
8215,明基材,23,10,13,元大-蘆洲,2023-09-01,9857
1314,中石化,407,5,402,元大-蘆洲,2023-09-04,9857
00919,群益台灣精選高息,364,22,342,元大-蘆洲,2023-09-04,9857
2363,矽統,388,179,209,元大-蘆洲,2023-09-04,9857
2371,大同,109,42,67,元大-蘆洲,2023-09-04,9857
2323,中環,92,37,55,元大-蘆洲,2023-09-04,9857
00751B,元大AAA至A公司債,45,0,45,元大-蘆洲,2023-09-04,9857
00712,復華富時不動產,42,2,40,元大-蘆洲,2023-09-04,9857
3481,群創,39,2,37,元大-蘆洲,2023-09-04,9857
1609,大亞,63,26,37,元大-蘆洲,2023-09-04,9857
3081,聯亞,37,2,35,元大-蘆洲,2023-09-04,9857
6244,茂迪,33,0,33,元大-蘆洲,2023-09-04,9857
2377,微星,32,1,31,元大-蘆洲,2023-09-04,9857
1522,堤維西,33,4,29,元大-蘆洲,2023-09-04,9857
1312,國喬,30,1,29,元大-蘆洲,2023-09-04,9857
00915,凱基優選高股息30,27,0,27,元大-蘆洲,2023-09-04,9857
2308,台達電,27,1,26,元大-蘆洲,2023-09-04,9857
00720B,元大投資級公司債,26,0,26,元大-蘆洲,2023-09-04,9857
2634,漢翔,31,7,24,元大-蘆洲,2023-09-04,9857
2492,華新科,43,20,23,元大-蘆洲,2023-09-04,9857
2352,佳世達,31,8,23,元大-蘆洲,2023-09-04,9857
00687B,國泰20年美債,22,0,22,元大-蘆洲,2023-09-04,9857
3049,精金,20,0,20,元大-蘆洲,2023-09-04,9857
0056,元大高股息,25,5,20,元大-蘆洲,2023-09-04,9857
00679B,元大美債20年,20,1,19,元大-蘆洲,2023-09-04,9857
00932,兆豐永續高息等權,19,0,19,元大-蘆洲,2023-09-04,9857
2409,友達,33,14,19,元大-蘆洲,2023-09-04,9857
00673R,期元大S＆P原油反1,18,0,18,元大-蘆洲,2023-09-04,9857
2369,菱生,28,10,18,元大-蘆洲,2023-09-04,9857
2515,中工,20,2,18,元大-蘆洲,2023-09-04,9857
4908,前鼎,22,4,18,元大-蘆洲,2023-09-04,9857
00772B,中信高評級公司債,17,0,17,元大-蘆洲,2023-09-04,9857
2312,金寶,29,13,16,元大-蘆洲,2023-09-04,9857
3149,正達,16,0,16,元大-蘆洲,2023-09-04,9857
2376,技嘉,26,11,15,元大-蘆洲,2023-09-04,9857
00680L,元大美債20正2,15,0,15,元大-蘆洲,2023-09-04,9857
2880,華南金,15,0,15,元大-蘆洲,2023-09-04,9857
4952,凌通,15,0,15,元大-蘆洲,2023-09-04,9857
6112,邁達特,24,10,14,元大-蘆洲,2023-09-04,9857
6719,力智,19,5,14,元大-蘆洲,2023-09-04,9857
3094,聯傑,20,6,14,元大-蘆洲,2023-09-04,9857
00688L,國泰20年美債正2,14,0,14,元大-蘆洲,2023-09-04,9857
5285,界霖,15,1,14,元大-蘆洲,2023-09-04,9857
2009,第一銅,22,8,14,元大-蘆洲,2023-09-04,9857
6213,聯茂,20,7,13,元大-蘆洲,2023-09-04,9857
2488,漢平,16,3,13,元大-蘆洲,2023-09-04,9857
5381,合正,27,15,12,元大-蘆洲,2023-09-04,9857
1802,台玻,177,165,12,元大-蘆洲,2023-09-04,9857
1210,大成,13,1,12,元大-蘆洲,2023-09-04,9857
1101,台泥,14,2,12,元大-蘆洲,2023-09-04,9857
8033,雷虎,12,1,11,元大-蘆洲,2023-09-04,9857
00929,復華台灣科技優息,573,58,515,元大-蘆洲,2023-09-05,9857
2027,大成鋼,216,3,213,元大-蘆洲,2023-09-05,9857
00919,群益台灣精選高息,164,21,143,元大-蘆洲,2023-09-05,9857
2610,華航,90,37,53,元大-蘆洲,2023-09-05,9857
3231,緯創,97,49,48,元大-蘆洲,2023-09-05,9857
00665L,富邦�琤肭磪囓�2,47,0,47,元大-蘆洲,2023-09-05,9857
3051,力特,128,82,46,元大-蘆洲,2023-09-05,9857
3014,聯陽,50,7,43,元大-蘆洲,2023-09-05,9857
2402,毅嘉,77,36,41,元大-蘆洲,2023-09-05,9857
2913,農林,45,5,40,元大-蘆洲,2023-09-05,9857
6243,迅杰,45,7,38,元大-蘆洲,2023-09-05,9857
00679B,元大美債20年,35,0,35,元大-蘆洲,2023-09-05,9857
00687B,國泰20年美債,34,0,34,元大-蘆洲,2023-09-05,9857
2618,長榮航,50,18,32,元大-蘆洲,2023-09-05,9857
4743,合一,41,13,28,元大-蘆洲,2023-09-05,9857
1101,台泥,35,8,27,元大-蘆洲,2023-09-05,9857
2634,漢翔,44,17,27,元大-蘆洲,2023-09-05,9857
3034,聯詠,32,5,27,元大-蘆洲,2023-09-05,9857
2603,長榮,34,8,26,元大-蘆洲,2023-09-05,9857
1616,億泰,24,0,24,元大-蘆洲,2023-09-05,9857
2476,鉅祥,25,2,23,元大-蘆洲,2023-09-05,9857
4906,正文,28,5,23,元大-蘆洲,2023-09-05,9857
6173,信昌電,25,4,21,元大-蘆洲,2023-09-05,9857
5258,虹堡,25,4,21,元大-蘆洲,2023-09-05,9857
4960,誠美材,20,0,20,元大-蘆洲,2023-09-05,9857
2705,六福,20,0,20,元大-蘆洲,2023-09-05,9857
2888,新光金,24,7,17,元大-蘆洲,2023-09-05,9857
3013,晟銘電,17,0,17,元大-蘆洲,2023-09-05,9857
6418,詠昇,19,3,16,元大-蘆洲,2023-09-05,9857
2504,國產,16,0,16,元大-蘆洲,2023-09-05,9857
00932,兆豐永續高息等權,19,3,16,元大-蘆洲,2023-09-05,9857
6282,康舒,24,8,16,元大-蘆洲,2023-09-05,9857
2485,兆赫,39,25,14,元大-蘆洲,2023-09-05,9857
2885,元大金,14,0,14,元大-蘆洲,2023-09-05,9857
2884,玉山金,16,3,13,元大-蘆洲,2023-09-05,9857
2421,建準,17,4,13,元大-蘆洲,2023-09-05,9857
00882,中信中國高股息,12,0,12,元大-蘆洲,2023-09-05,9857
2376,技嘉,31,19,12,元大-蘆洲,2023-09-05,9857
8150,南茂,13,1,12,元大-蘆洲,2023-09-05,9857
5439,高技,12,0,12,元大-蘆洲,2023-09-05,9857
2201,裕隆,16,4,12,元大-蘆洲,2023-09-05,9857
5425,台半,19,7,12,元大-蘆洲,2023-09-05,9857
3325,旭品,14,3,11,元大-蘆洲,2023-09-05,9857
5215,科嘉-KY,18,7,11,元大-蘆洲,2023-09-05,9857
4967,十銓,12,1,11,元大-蘆洲,2023-09-05,9857
2462,良得電,14,3,11,元大-蘆洲,2023-09-05,9857
00753L,中信中國50正2,11,0,11,元大-蘆洲,2023-09-05,9857
3715,定穎投控,58,47,11,元大-蘆洲,2023-09-05,9857
2330,台積電,11,0,11,元大-蘆洲,2023-09-05,9857
6136,富爾特,10,0,10,元大-蘆洲,2023-09-05,9857
00919,群益台灣精選高息,683,25,658,元大-蘆洲,2023-09-06,9857
00929,復華台灣科技優息,659,119,540,元大-蘆洲,2023-09-06,9857
2409,友達,502,56,446,元大-蘆洲,2023-09-06,9857
3481,群創,414,171,243,元大-蘆洲,2023-09-06,9857
00680L,元大美債20正2,110,0,110,元大-蘆洲,2023-09-06,9857
2401,凌陽,103,10,93,元大-蘆洲,2023-09-06,9857
00673R,期元大S＆P原油反1,92,0,92,元大-蘆洲,2023-09-06,9857
2356,英業達,93,26,67,元大-蘆洲,2023-09-06,9857
2610,華航,74,12,62,元大-蘆洲,2023-09-06,9857
00676R,富邦臺灣加權反1,50,0,50,元大-蘆洲,2023-09-06,9857
6116,彩晶,64,19,45,元大-蘆洲,2023-09-06,9857
2618,長榮航,74,32,42,元大-蘆洲,2023-09-06,9857
1102,亞泥,41,3,38,元大-蘆洲,2023-09-06,9857
5388,中磊,83,45,38,元大-蘆洲,2023-09-06,9857
2504,國產,36,0,36,元大-蘆洲,2023-09-06,9857
2332,友訊,60,25,35,元大-蘆洲,2023-09-06,9857
3034,聯詠,41,10,31,元大-蘆洲,2023-09-06,9857
8050,廣積,43,15,28,元大-蘆洲,2023-09-06,9857
3703,欣陸,30,5,25,元大-蘆洲,2023-09-06,9857
00715L,期街口布蘭特正2,25,0,25,元大-蘆洲,2023-09-06,9857
4945,陞達科技,27,3,24,元大-蘆洲,2023-09-06,9857
2002,中鋼,25,1,24,元大-蘆洲,2023-09-06,9857
6282,康舒,30,7,23,元大-蘆洲,2023-09-06,9857
2388,威盛,40,19,21,元大-蘆洲,2023-09-06,9857
5457,宣德,23,3,20,元大-蘆洲,2023-09-06,9857
6015,宏遠證,20,0,20,元大-蘆洲,2023-09-06,9857
6274,台燿,90,70,20,元大-蘆洲,2023-09-06,9857
00679B,元大美債20年,19,0,19,元大-蘆洲,2023-09-06,9857
2331,精英,23,4,19,元大-蘆洲,2023-09-06,9857
8358,金居,25,7,18,元大-蘆洲,2023-09-06,9857
2929,淘帝-KY,18,0,18,元大-蘆洲,2023-09-06,9857
2457,飛宏,34,16,18,元大-蘆洲,2023-09-06,9857
2330,台積電,22,5,17,元大-蘆洲,2023-09-06,9857
3694,海華,18,2,16,元大-蘆洲,2023-09-06,9857
2337,旺宏,28,12,16,元大-蘆洲,2023-09-06,9857
2880,華南金,26,10,16,元大-蘆洲,2023-09-06,9857
2316,楠梓電,23,8,15,元大-蘆洲,2023-09-06,9857
00632R,元大台灣50反1,15,0,15,元大-蘆洲,2023-09-06,9857
3058,立德,15,0,15,元大-蘆洲,2023-09-06,9857
8183,精星,18,3,15,元大-蘆洲,2023-09-06,9857
1101,台泥,36,21,15,元大-蘆洲,2023-09-06,9857
2344,華邦電,17,3,14,元大-蘆洲,2023-09-06,9857
6419,京晨科,14,0,14,元大-蘆洲,2023-09-06,9857
00751B,元大AAA至A公司債,14,0,14,元大-蘆洲,2023-09-06,9857
3163,波若威,33,19,14,元大-蘆洲,2023-09-06,9857
2204,中華,16,3,13,元大-蘆洲,2023-09-06,9857
2436,偉詮電,34,21,13,元大-蘆洲,2023-09-06,9857
2317,鴻海,16,3,13,元大-蘆洲,2023-09-06,9857
2421,建準,35,22,13,元大-蘆洲,2023-09-06,9857
2369,菱生,22,9,13,元大-蘆洲,2023-09-06,9857
2409,友達,273,13,260,元大-蘆洲,2023-09-07,9857
00929,復華台灣科技優息,502,274,228,元大-蘆洲,2023-09-07,9857
00919,群益台灣精選高息,244,55,189,元大-蘆洲,2023-09-07,9857
2363,矽統,287,123,164,元大-蘆洲,2023-09-07,9857
3231,緯創,111,39,72,元大-蘆洲,2023-09-07,9857
3481,群創,84,16,68,元大-蘆洲,2023-09-07,9857
00932,兆豐永續高息等權,63,1,62,元大-蘆洲,2023-09-07,9857
2897,王道銀行,62,0,62,元大-蘆洲,2023-09-07,9857
6485,點序,66,4,62,元大-蘆洲,2023-09-07,9857
4909,新復興,122,62,60,元大-蘆洲,2023-09-07,9857
2317,鴻海,59,0,59,元大-蘆洲,2023-09-07,9857
3704,合勤控,257,198,59,元大-蘆洲,2023-09-07,9857
1605,華新,49,1,48,元大-蘆洲,2023-09-07,9857
2610,華航,58,12,46,元大-蘆洲,2023-09-07,9857
6156,松上,45,0,45,元大-蘆洲,2023-09-07,9857
1733,五鼎,44,0,44,元大-蘆洲,2023-09-07,9857
2405,輔信,42,0,42,元大-蘆洲,2023-09-07,9857
2402,毅嘉,58,18,40,元大-蘆洲,2023-09-07,9857
00878,國泰永續高股息,93,53,40,元大-蘆洲,2023-09-07,9857
4967,十銓,107,67,40,元大-蘆洲,2023-09-07,9857
00902,中信電池及儲能,32,0,32,元大-蘆洲,2023-09-07,9857
6190,萬泰科,31,0,31,元大-蘆洲,2023-09-07,9857
2618,長榮航,37,9,28,元大-蘆洲,2023-09-07,9857
2313,華通,101,73,28,元大-蘆洲,2023-09-07,9857
00713,元大台灣高息低波,27,0,27,元大-蘆洲,2023-09-07,9857
2614,東森,76,50,26,元大-蘆洲,2023-09-07,9857
2884,玉山金,32,6,26,元大-蘆洲,2023-09-07,9857
00637L,元大滬深300正2,26,0,26,元大-蘆洲,2023-09-07,9857
2401,凌陽,33,7,26,元大-蘆洲,2023-09-07,9857
8222,寶一,32,6,26,元大-蘆洲,2023-09-07,9857
2105,正新,25,0,25,元大-蘆洲,2023-09-07,9857
00923,群益台ESG低碳50,24,0,24,元大-蘆洲,2023-09-07,9857
4533,協易機,55,31,24,元大-蘆洲,2023-09-07,9857
3583,辛耘,24,1,23,元大-蘆洲,2023-09-07,9857
8112,至上,72,50,22,元大-蘆洲,2023-09-07,9857
00915,凱基優選高股息30,21,0,21,元大-蘆洲,2023-09-07,9857
4114,健喬,20,0,20,元大-蘆洲,2023-09-07,9857
2515,中工,20,1,19,元大-蘆洲,2023-09-07,9857
4906,正文,26,8,18,元大-蘆洲,2023-09-07,9857
00673R,期元大S＆P原油反1,18,0,18,元大-蘆洲,2023-09-07,9857
5258,虹堡,26,8,18,元大-蘆洲,2023-09-07,9857
2330,台積電,18,0,18,元大-蘆洲,2023-09-07,9857
5483,中美晶,28,11,17,元大-蘆洲,2023-09-07,9857
2881,富邦金,16,0,16,元大-蘆洲,2023-09-07,9857
3338,泰碩,34,18,16,元大-蘆洲,2023-09-07,9857
4147,中裕,24,8,16,元大-蘆洲,2023-09-07,9857
00679B,元大美債20年,16,1,15,元大-蘆洲,2023-09-07,9857
8936,國統,17,2,15,元大-蘆洲,2023-09-07,9857
2413,環科,16,1,15,元大-蘆洲,2023-09-07,9857
6139,亞翔,28,13,15,元大-蘆洲,2023-09-07,9857
2630,亞航,206,28,178,元大-蘆洲,2023-09-08,9857
00919,群益台灣精選高息,165,1,164,元大-蘆洲,2023-09-08,9857
00637L,元大滬深300正2,245,102,143,元大-蘆洲,2023-09-08,9857
00902,中信電池及儲能,110,0,110,元大-蘆洲,2023-09-08,9857
2308,台達電,62,0,62,元大-蘆洲,2023-09-08,9857
2880,華南金,61,0,61,元大-蘆洲,2023-09-08,9857
00878,國泰永續高股息,89,31,58,元大-蘆洲,2023-09-08,9857
2317,鴻海,58,1,57,元大-蘆洲,2023-09-08,9857
3306,鼎天,59,2,57,元大-蘆洲,2023-09-08,9857
00900,富邦特選高股息30,57,0,57,元大-蘆洲,2023-09-08,9857
3481,群創,83,33,50,元大-蘆洲,2023-09-08,9857
2897,王道銀行,50,0,50,元大-蘆洲,2023-09-08,9857
2905,三商,50,0,50,元大-蘆洲,2023-09-08,9857
2618,長榮航,82,37,45,元大-蘆洲,2023-09-08,9857
00929,復華台灣科技優息,284,242,42,元大-蘆洲,2023-09-08,9857
2421,建準,68,26,42,元大-蘆洲,2023-09-08,9857
2382,廣達,78,40,38,元大-蘆洲,2023-09-08,9857
00673R,期元大S＆P原油反1,35,0,35,元大-蘆洲,2023-09-08,9857
2402,毅嘉,59,26,33,元大-蘆洲,2023-09-08,9857
2409,友達,55,23,32,元大-蘆洲,2023-09-08,9857
00931B,統一美債20年,30,0,30,元大-蘆洲,2023-09-08,9857
2393,億光,30,1,29,元大-蘆洲,2023-09-08,9857
00882,中信中國高股息,33,5,28,元大-蘆洲,2023-09-08,9857
00918,大華優利高填息30,28,0,28,元大-蘆洲,2023-09-08,9857
0056,元大高股息,37,10,27,元大-蘆洲,2023-09-08,9857
9928,中視,27,0,27,元大-蘆洲,2023-09-08,9857
1802,台玻,41,15,26,元大-蘆洲,2023-09-08,9857
8034,榮群,48,24,24,元大-蘆洲,2023-09-08,9857
3715,定穎投控,235,212,23,元大-蘆洲,2023-09-08,9857
2330,台積電,25,3,22,元大-蘆洲,2023-09-08,9857
2312,金寶,23,1,22,元大-蘆洲,2023-09-08,9857
00915,凱基優選高股息30,21,0,21,元大-蘆洲,2023-09-08,9857
5009,榮剛,24,3,21,元大-蘆洲,2023-09-08,9857
2887,台新金,24,4,20,元大-蘆洲,2023-09-08,9857
2314,台揚,20,0,20,元大-蘆洲,2023-09-08,9857
2413,環科,20,0,20,元大-蘆洲,2023-09-08,9857
1305,華夏,25,5,20,元大-蘆洲,2023-09-08,9857
00881,國泰台灣5G+,20,1,19,元大-蘆洲,2023-09-08,9857
2002,中鋼,18,0,18,元大-蘆洲,2023-09-08,9857
2834,臺企銀,17,0,17,元大-蘆洲,2023-09-08,9857
6274,台燿,41,25,16,元大-蘆洲,2023-09-08,9857
2356,英業達,68,52,16,元大-蘆洲,2023-09-08,9857
8033,雷虎,23,7,16,元大-蘆洲,2023-09-08,9857
00665L,富邦�琤肭磪囓�2,19,4,15,元大-蘆洲,2023-09-08,9857
1304,台聚,15,0,15,元大-蘆洲,2023-09-08,9857
2365,昆盈,15,0,15,元大-蘆洲,2023-09-08,9857
8069,元太,16,1,15,元大-蘆洲,2023-09-08,9857
1513,中興電,14,1,13,元大-蘆洲,2023-09-08,9857
6282,康舒,14,1,13,元大-蘆洲,2023-09-08,9857
4906,正文,20,7,13,元大-蘆洲,2023-09-08,9857
00919,群益台灣精選高息,375,3,372,元大-蘆洲,2023-09-11,9857
00929,復華台灣科技優息,308,25,283,元大-蘆洲,2023-09-11,9857
00878,國泰永續高股息,335,75,260,元大-蘆洲,2023-09-11,9857
3545,敦泰,130,14,116,元大-蘆洲,2023-09-11,9857
2363,矽統,588,477,111,元大-蘆洲,2023-09-11,9857
2312,金寶,126,17,109,元大-蘆洲,2023-09-11,9857
2634,漢翔,165,58,107,元大-蘆洲,2023-09-11,9857
00931B,統一美債20年,104,0,104,元大-蘆洲,2023-09-11,9857
2609,陽明,104,21,83,元大-蘆洲,2023-09-11,9857
3078,僑威,103,25,78,元大-蘆洲,2023-09-11,9857
2486,一詮,75,4,71,元大-蘆洲,2023-09-11,9857
4533,協易機,69,7,62,元大-蘆洲,2023-09-11,9857
1618,合機,75,14,61,元大-蘆洲,2023-09-11,9857
1616,億泰,60,1,59,元大-蘆洲,2023-09-11,9857
00932,兆豐永續高息等權,54,0,54,元大-蘆洲,2023-09-11,9857
6116,彩晶,84,31,53,元大-蘆洲,2023-09-11,9857
1605,華新,53,4,49,元大-蘆洲,2023-09-11,9857
1522,堤維西,52,6,46,元大-蘆洲,2023-09-11,9857
00918,大華優利高填息30,44,0,44,元大-蘆洲,2023-09-11,9857
00915,凱基優選高股息30,47,3,44,元大-蘆洲,2023-09-11,9857
2610,華航,48,8,40,元大-蘆洲,2023-09-11,9857
2421,建準,58,21,37,元大-蘆洲,2023-09-11,9857
8033,雷虎,72,35,37,元大-蘆洲,2023-09-11,9857
00900,富邦特選高股息30,36,3,33,元大-蘆洲,2023-09-11,9857
2359,所羅門,103,70,33,元大-蘆洲,2023-09-11,9857
00712,復華富時不動產,31,0,31,元大-蘆洲,2023-09-11,9857
6185,幃翔,31,0,31,元大-蘆洲,2023-09-11,9857
3231,緯創,215,186,29,元大-蘆洲,2023-09-11,9857
1802,台玻,38,9,29,元大-蘆洲,2023-09-11,9857
00713,元大台灣高息低波,27,0,27,元大-蘆洲,2023-09-11,9857
4938,和碩,29,3,26,元大-蘆洲,2023-09-11,9857
2374,佳能,30,6,24,元大-蘆洲,2023-09-11,9857
8930,青鋼,24,0,24,元大-蘆洲,2023-09-11,9857
2352,佳世達,32,8,24,元大-蘆洲,2023-09-11,9857
2356,英業達,116,92,24,元大-蘆洲,2023-09-11,9857
3707,漢磊,22,0,22,元大-蘆洲,2023-09-11,9857
5388,中磊,47,25,22,元大-蘆洲,2023-09-11,9857
2376,技嘉,55,33,22,元大-蘆洲,2023-09-11,9857
2884,玉山金,28,7,21,元大-蘆洲,2023-09-11,9857
4543,萬在,22,1,21,元大-蘆洲,2023-09-11,9857
00687B,國泰20年美債,19,0,19,元大-蘆洲,2023-09-11,9857
2427,三商電,21,2,19,元大-蘆洲,2023-09-11,9857
3017,奇鋐,27,8,19,元大-蘆洲,2023-09-11,9857
6426,統新,20,1,19,元大-蘆洲,2023-09-11,9857
4909,新復興,20,1,19,元大-蘆洲,2023-09-11,9857
3583,辛耘,26,7,19,元大-蘆洲,2023-09-11,9857
2002,中鋼,20,1,19,元大-蘆洲,2023-09-11,9857
00922,國泰台灣領袖50,18,0,18,元大-蘆洲,2023-09-11,9857
00688L,國泰20年美債正2,18,0,18,元大-蘆洲,2023-09-11,9857
1733,五鼎,17,0,17,元大-蘆洲,2023-09-11,9857
00929,復華台灣科技優息,272,86,186,元大-蘆洲,2023-09-12,9857
2890,永豐金,200,15,185,元大-蘆洲,2023-09-12,9857
00919,群益台灣精選高息,140,8,132,元大-蘆洲,2023-09-12,9857
2618,長榮航,120,9,111,元大-蘆洲,2023-09-12,9857
00673R,期元大S＆P原油反1,81,0,81,元大-蘆洲,2023-09-12,9857
00878,國泰永續高股息,86,20,66,元大-蘆洲,2023-09-12,9857
3711,日月光投控,61,2,59,元大-蘆洲,2023-09-12,9857
2208,台船,56,8,48,元大-蘆洲,2023-09-12,9857
5381,合正,83,41,42,元大-蘆洲,2023-09-12,9857
2421,建準,51,10,41,元大-蘆洲,2023-09-12,9857
3231,緯創,144,105,39,元大-蘆洲,2023-09-12,9857
4909,新復興,36,0,36,元大-蘆洲,2023-09-12,9857
1519,華城,33,3,30,元大-蘆洲,2023-09-12,9857
2402,毅嘉,33,3,30,元大-蘆洲,2023-09-12,9857
2002,中鋼,29,0,29,元大-蘆洲,2023-09-12,9857
8222,寶一,35,6,29,元大-蘆洲,2023-09-12,9857
2376,技嘉,62,37,25,元大-蘆洲,2023-09-12,9857
6285,啟��,24,3,21,元大-蘆洲,2023-09-12,9857
00730,富邦臺灣優質高息,20,0,20,元大-蘆洲,2023-09-12,9857
2834,臺企銀,32,12,20,元大-蘆洲,2023-09-12,9857
2413,環科,21,1,20,元大-蘆洲,2023-09-12,9857
3094,聯傑,22,3,19,元大-蘆洲,2023-09-12,9857
2888,新光金,27,10,17,元大-蘆洲,2023-09-12,9857
00679B,元大美債20年,16,0,16,元大-蘆洲,2023-09-12,9857
00896,中信綠能及電動車,20,4,16,元大-蘆洲,2023-09-12,9857
9928,中視,17,1,16,元大-蘆洲,2023-09-12,9857
2356,英業達,69,54,15,元大-蘆洲,2023-09-12,9857
5880,合庫金,16,1,15,元大-蘆洲,2023-09-12,9857
00720B,元大投資級公司債,15,0,15,元大-蘆洲,2023-09-12,9857
00665L,富邦�琤肭磪囓�2,31,16,15,元大-蘆洲,2023-09-12,9857
2637,慧洋-KY,16,1,15,元大-蘆洲,2023-09-12,9857
3623,富晶通,15,0,15,元大-蘆洲,2023-09-12,9857
8358,金居,20,5,15,元大-蘆洲,2023-09-12,9857
2330,台積電,26,11,15,元大-蘆洲,2023-09-12,9857
2367,燿華,14,0,14,元大-蘆洲,2023-09-12,9857
00923,群益台ESG低碳50,14,0,14,元大-蘆洲,2023-09-12,9857
2880,華南金,19,5,14,元大-蘆洲,2023-09-12,9857
1795,美時,22,9,13,元大-蘆洲,2023-09-12,9857
2382,廣達,48,35,13,元大-蘆洲,2023-09-12,9857
3051,力特,14,1,13,元大-蘆洲,2023-09-12,9857
3715,定穎投控,23,10,13,元大-蘆洲,2023-09-12,9857
3163,波若威,21,10,11,元大-蘆洲,2023-09-12,9857
5439,高技,12,1,11,元大-蘆洲,2023-09-12,9857
2486,一詮,12,1,11,元大-蘆洲,2023-09-12,9857
9950,萬國通,10,0,10,元大-蘆洲,2023-09-12,9857
3027,盛達,10,0,10,元大-蘆洲,2023-09-12,9857
6120,達運,20,10,10,元大-蘆洲,2023-09-12,9857
2838,聯邦銀,10,0,10,元大-蘆洲,2023-09-12,9857
1616,億泰,10,0,10,元大-蘆洲,2023-09-12,9857
6426,統新,10,0,10,元大-蘆洲,2023-09-12,9857
1314,中石化,746,0,746,元大-蘆洲,2023-09-13,9857
00929,復華台灣科技優息,637,139,498,元大-蘆洲,2023-09-13,9857
00878,國泰永續高股息,253,8,245,元大-蘆洲,2023-09-13,9857
00919,群益台灣精選高息,170,27,143,元大-蘆洲,2023-09-13,9857
2615,萬海,102,0,102,元大-蘆洲,2023-09-13,9857
2890,永豐金,50,0,50,元大-蘆洲,2023-09-13,9857
2313,華通,96,57,39,元大-蘆洲,2023-09-13,9857
2312,金寶,41,2,39,元大-蘆洲,2023-09-13,9857
00637L,元大滬深300正2,34,0,34,元大-蘆洲,2023-09-13,9857
5388,中磊,31,1,30,元大-蘆洲,2023-09-13,9857
2618,長榮航,36,6,30,元大-蘆洲,2023-09-13,9857
00902,中信電池及儲能,28,0,28,元大-蘆洲,2023-09-13,9857
2374,佳能,34,7,27,元大-蘆洲,2023-09-13,9857
1471,首利,62,35,27,元大-蘆洲,2023-09-13,9857
2308,台達電,24,1,23,元大-蘆洲,2023-09-13,9857
5272,笙科,23,1,22,元大-蘆洲,2023-09-13,9857
00713,元大台灣高息低波,26,4,22,元大-蘆洲,2023-09-13,9857
6715,嘉基,23,2,21,元大-蘆洲,2023-09-13,9857
2481,強茂,21,0,21,元大-蘆洲,2023-09-13,9857
2236,百達-KY,21,1,20,元大-蘆洲,2023-09-13,9857
0056,元大高股息,30,10,20,元大-蘆洲,2023-09-13,9857
5009,榮剛,28,9,19,元大-蘆洲,2023-09-13,9857
1101,台泥,22,4,18,元大-蘆洲,2023-09-13,9857
3710,連展投控,18,0,18,元大-蘆洲,2023-09-13,9857
00712,復華富時不動產,18,0,18,元大-蘆洲,2023-09-13,9857
6288,聯嘉,23,6,17,元大-蘆洲,2023-09-13,9857
3704,合勤控,24,7,17,元大-蘆洲,2023-09-13,9857
2363,矽統,79,63,16,元大-蘆洲,2023-09-13,9857
6235,華孚,23,7,16,元大-蘆洲,2023-09-13,9857
3481,群創,16,0,16,元大-蘆洲,2023-09-13,9857
3231,緯創,70,56,14,元大-蘆洲,2023-09-13,9857
00751B,元大AAA至A公司債,14,0,14,元大-蘆洲,2023-09-13,9857
3163,波若威,53,40,13,元大-蘆洲,2023-09-13,9857
1717,長興,13,0,13,元大-蘆洲,2023-09-13,9857
3624,光頡,18,5,13,元大-蘆洲,2023-09-13,9857
2801,彰銀,13,0,13,元大-蘆洲,2023-09-13,9857
2388,威盛,27,15,12,元大-蘆洲,2023-09-13,9857
3030,德律,12,0,12,元大-蘆洲,2023-09-13,9857
2405,輔信,16,5,11,元大-蘆洲,2023-09-13,9857
00772B,中信高評級公司債,11,0,11,元大-蘆洲,2023-09-13,9857
2851,中再保,11,0,11,元大-蘆洲,2023-09-13,9857
2352,佳世達,20,10,10,元大-蘆洲,2023-09-13,9857
1108,幸福,10,0,10,元大-蘆洲,2023-09-13,9857
4909,新復興,10,0,10,元大-蘆洲,2023-09-13,9857
3037,欣興,18,8,10,元大-蘆洲,2023-09-13,9857
2330,台積電,12,2,10,元大-蘆洲,2023-09-13,9857
2317,鴻海,10,1,9,元大-蘆洲,2023-09-13,9857
2630,亞航,20,11,9,元大-蘆洲,2023-09-13,9857
8222,寶一,12,3,9,元大-蘆洲,2023-09-13,9857
00921,兆豐龍頭等權重,8,0,8,元大-蘆洲,2023-09-13,9857
00929,復華台灣科技優息,583,188,395,元大-蘆洲,2023-09-14,9857
00919,群益台灣精選高息,231,34,197,元大-蘆洲,2023-09-14,9857
6235,華孚,118,12,106,元大-蘆洲,2023-09-14,9857
3163,波若威,169,74,95,元大-蘆洲,2023-09-14,9857
00878,國泰永續高股息,244,156,88,元大-蘆洲,2023-09-14,9857
00715L,期街口布蘭特正2,46,0,46,元大-蘆洲,2023-09-14,9857
2371,大同,70,28,42,元大-蘆洲,2023-09-14,9857
00885,富邦越南,39,0,39,元大-蘆洲,2023-09-14,9857
4906,正文,52,19,33,元大-蘆洲,2023-09-14,9857
00632R,元大台灣50反1,37,5,32,元大-蘆洲,2023-09-14,9857
2313,華通,76,46,30,元大-蘆洲,2023-09-14,9857
5328,華容,28,1,27,元大-蘆洲,2023-09-14,9857
3481,群創,52,25,27,元大-蘆洲,2023-09-14,9857
2606,裕民,35,12,23,元大-蘆洲,2023-09-14,9857
2538,基泰,28,5,23,元大-蘆洲,2023-09-14,9857
2630,亞航,31,8,23,元大-蘆洲,2023-09-14,9857
4979,華星光,112,91,21,元大-蘆洲,2023-09-14,9857
2329,華泰,26,5,21,元大-蘆洲,2023-09-14,9857
2401,凌陽,28,8,20,元大-蘆洲,2023-09-14,9857
3060,銘異,21,1,20,元大-蘆洲,2023-09-14,9857
2610,華航,33,13,20,元大-蘆洲,2023-09-14,9857
1444,力麗,20,0,20,元大-蘆洲,2023-09-14,9857
1471,首利,56,37,19,元大-蘆洲,2023-09-14,9857
2485,兆赫,33,14,19,元大-蘆洲,2023-09-14,9857
4967,十銓,30,11,19,元大-蘆洲,2023-09-14,9857
2355,敬鵬,23,4,19,元大-蘆洲,2023-09-14,9857
3545,敦泰,21,2,19,元大-蘆洲,2023-09-14,9857
00882,中信中國高股息,23,5,18,元大-蘆洲,2023-09-14,9857
2897,王道銀行,18,0,18,元大-蘆洲,2023-09-14,9857
4533,協易機,18,0,18,元大-蘆洲,2023-09-14,9857
1524,耿鼎,50,33,17,元大-蘆洲,2023-09-14,9857
2332,友訊,18,2,16,元大-蘆洲,2023-09-14,9857
3005,神基,19,3,16,元大-蘆洲,2023-09-14,9857
8076,伍豐,15,0,15,元大-蘆洲,2023-09-14,9857
4137,麗豐-KY,15,0,15,元大-蘆洲,2023-09-14,9857
1217,愛之味,16,2,14,元大-蘆洲,2023-09-14,9857
2408,南亞科,21,7,14,元大-蘆洲,2023-09-14,9857
00751B,元大AAA至A公司債,13,0,13,元大-蘆洲,2023-09-14,9857
1314,中石化,19,6,13,元大-蘆洲,2023-09-14,9857
8048,德勝,30,17,13,元大-蘆洲,2023-09-14,9857
4916,事欣科,17,4,13,元大-蘆洲,2023-09-14,9857
6275,元山,38,25,13,元大-蘆洲,2023-09-14,9857
4915,致伸,19,7,12,元大-蘆洲,2023-09-14,9857
3205,佰研,12,0,12,元大-蘆洲,2023-09-14,9857
1504,東元,22,10,12,元大-蘆洲,2023-09-14,9857
6257,矽格,12,1,11,元大-蘆洲,2023-09-14,9857
00665L,富邦�琤肭磪囓�2,15,4,11,元大-蘆洲,2023-09-14,9857
2421,建準,65,54,11,元大-蘆洲,2023-09-14,9857
00720B,元大投資級公司債,11,0,11,元大-蘆洲,2023-09-14,9857
2885,元大金,26,16,10,元大-蘆洲,2023-09-14,9857
00929,復華台灣科技優息,558,172,386,元大-蘆洲,2023-09-15,9857
3481,群創,355,12,343,元大-蘆洲,2023-09-15,9857
00919,群益台灣精選高息,446,113,333,元大-蘆洲,2023-09-15,9857
00885,富邦越南,252,30,222,元大-蘆洲,2023-09-15,9857
2606,裕民,252,64,188,元大-蘆洲,2023-09-15,9857
2486,一詮,195,72,123,元大-蘆洲,2023-09-15,9857
00637L,元大滬深300正2,106,0,106,元大-蘆洲,2023-09-15,9857
00680L,元大美債20正2,102,5,97,元大-蘆洲,2023-09-15,9857
3419,譁裕,75,0,75,元大-蘆洲,2023-09-15,9857
3236,千如,161,87,74,元大-蘆洲,2023-09-15,9857
3058,立德,68,3,65,元大-蘆洲,2023-09-15,9857
4909,新復興,79,16,63,元大-蘆洲,2023-09-15,9857
1524,耿鼎,76,13,63,元大-蘆洲,2023-09-15,9857
2610,華航,64,2,62,元大-蘆洲,2023-09-15,9857
1802,台玻,65,5,60,元大-蘆洲,2023-09-15,9857
00687B,國泰20年美債,56,0,56,元大-蘆洲,2023-09-15,9857
6235,華孚,62,8,54,元大-蘆洲,2023-09-15,9857
2331,精英,49,0,49,元大-蘆洲,2023-09-15,9857
2377,微星,50,4,46,元大-蘆洲,2023-09-15,9857
2634,漢翔,54,12,42,元大-蘆洲,2023-09-15,9857
00772B,中信高評級公司債,40,0,40,元大-蘆洲,2023-09-15,9857
2025,千興,40,0,40,元大-蘆洲,2023-09-15,9857
3545,敦泰,37,5,32,元大-蘆洲,2023-09-15,9857
6120,達運,31,0,31,元大-蘆洲,2023-09-15,9857
9105,泰金寶-DR,33,3,30,元大-蘆洲,2023-09-15,9857
2328,廣宇,30,0,30,元大-蘆洲,2023-09-15,9857
2354,鴻準,35,8,27,元大-蘆洲,2023-09-15,9857
2884,玉山金,34,11,23,元大-蘆洲,2023-09-15,9857
00918,大華優利高填息30,33,10,23,元大-蘆洲,2023-09-15,9857
6443,元晶,25,3,22,元大-蘆洲,2023-09-15,9857
00915,凱基優選高股息30,25,5,20,元大-蘆洲,2023-09-15,9857
5381,合正,34,14,20,元大-蘆洲,2023-09-15,9857
2880,華南金,21,2,19,元大-蘆洲,2023-09-15,9857
2002,中鋼,30,11,19,元大-蘆洲,2023-09-15,9857
8034,榮群,21,3,18,元大-蘆洲,2023-09-15,9857
3540,曜越,18,0,18,元大-蘆洲,2023-09-15,9857
1217,愛之味,30,12,18,元大-蘆洲,2023-09-15,9857
4908,前鼎,42,24,18,元大-蘆洲,2023-09-15,9857
00679B,元大美債20年,17,0,17,元大-蘆洲,2023-09-15,9857
3363,上詮,51,34,17,元大-蘆洲,2023-09-15,9857
1409,新纖,17,0,17,元大-蘆洲,2023-09-15,9857
3715,定穎投控,68,51,17,元大-蘆洲,2023-09-15,9857
3231,緯創,81,65,16,元大-蘆洲,2023-09-15,9857
2633,台灣高鐵,16,0,16,元大-蘆洲,2023-09-15,9857
3044,健鼎,23,9,14,元大-蘆洲,2023-09-15,9857
2838,聯邦銀,14,0,14,元大-蘆洲,2023-09-15,9857
1326,台化,28,14,14,元大-蘆洲,2023-09-15,9857
2059,川湖,16,2,14,元大-蘆洲,2023-09-15,9857
3588,通嘉,17,3,14,元大-蘆洲,2023-09-15,9857
2485,兆赫,14,0,14,元大-蘆洲,2023-09-15,9857
00929,復華台灣科技優息,1086,250,836,元大-蘆洲,2023-09-18,9857
00885,富邦越南,333,0,333,元大-蘆洲,2023-09-18,9857
2363,矽統,463,189,274,元大-蘆洲,2023-09-18,9857
1522,堤維西,200,12,188,元大-蘆洲,2023-09-18,9857
2002,中鋼,183,3,180,元大-蘆洲,2023-09-18,9857
00878,國泰永續高股息,115,3,112,元大-蘆洲,2023-09-18,9857
00795B,中信美國公債20年,66,0,66,元大-蘆洲,2023-09-18,9857
3231,緯創,120,60,60,元大-蘆洲,2023-09-18,9857
00679B,元大美債20年,57,4,53,元大-蘆洲,2023-09-18,9857
00751B,元大AAA至A公司債,61,12,49,元大-蘆洲,2023-09-18,9857
3706,神達,50,2,48,元大-蘆洲,2023-09-18,9857
00687B,國泰20年美債,53,6,47,元大-蘆洲,2023-09-18,9857
2330,台積電,50,7,43,元大-蘆洲,2023-09-18,9857
4979,華星光,88,50,38,元大-蘆洲,2023-09-18,9857
00918,大華優利高填息30,37,0,37,元大-蘆洲,2023-09-18,9857
6451,訊芯-KY,41,11,30,元大-蘆洲,2023-09-18,9857
3324,雙鴻,30,1,29,元大-蘆洲,2023-09-18,9857
00915,凱基優選高股息30,29,0,29,元大-蘆洲,2023-09-18,9857
1802,台玻,33,4,29,元大-蘆洲,2023-09-18,9857
2485,兆赫,32,3,29,元大-蘆洲,2023-09-18,9857
0056,元大高股息,34,5,29,元大-蘆洲,2023-09-18,9857
8046,南電,31,2,29,元大-蘆洲,2023-09-18,9857
5483,中美晶,28,1,27,元大-蘆洲,2023-09-18,9857
3058,立德,42,16,26,元大-蘆洲,2023-09-18,9857
2352,佳世達,28,3,25,元大-蘆洲,2023-09-18,9857
2332,友訊,32,8,24,元大-蘆洲,2023-09-18,9857
2356,英業達,71,48,23,元大-蘆洲,2023-09-18,9857
3081,聯亞,23,1,22,元大-蘆洲,2023-09-18,9857
2852,第一保,21,0,21,元大-蘆洲,2023-09-18,9857
2915,潤泰全,20,0,20,元大-蘆洲,2023-09-18,9857
2382,廣達,41,22,19,元大-蘆洲,2023-09-18,9857
3287,廣寰科,20,1,19,元大-蘆洲,2023-09-18,9857
2601,益航,20,1,19,元大-蘆洲,2023-09-18,9857
00931B,統一美債20年,18,0,18,元大-蘆洲,2023-09-18,9857
2353,宏��,20,2,18,元大-蘆洲,2023-09-18,9857
9938,百和,17,0,17,元大-蘆洲,2023-09-18,9857
2421,建準,24,7,17,元大-蘆洲,2023-09-18,9857
1326,台化,36,20,16,元大-蘆洲,2023-09-18,9857
00713,元大台灣高息低波,19,3,16,元大-蘆洲,2023-09-18,9857
00720B,元大投資級公司債,20,5,15,元大-蘆洲,2023-09-18,9857
6282,康舒,19,4,15,元大-蘆洲,2023-09-18,9857
2340,台亞,20,5,15,元大-蘆洲,2023-09-18,9857
2516,新建,15,0,15,元大-蘆洲,2023-09-18,9857
8358,金居,16,1,15,元大-蘆洲,2023-09-18,9857
00772B,中信高評級公司債,24,10,14,元大-蘆洲,2023-09-18,9857
1301,台塑,15,1,14,元大-蘆洲,2023-09-18,9857
2887,台新金,15,1,14,元大-蘆洲,2023-09-18,9857
00900,富邦特選高股息30,14,0,14,元大-蘆洲,2023-09-18,9857
3260,威剛,14,1,13,元大-蘆洲,2023-09-18,9857
2436,偉詮電,15,2,13,元大-蘆洲,2023-09-18,9857
00929,復華台灣科技優息,534,80,454,元大-蘆洲,2023-09-19,9857
00885,富邦越南,252,0,252,元大-蘆洲,2023-09-19,9857
2610,華航,214,9,205,元大-蘆洲,2023-09-19,9857
3481,群創,125,17,108,元大-蘆洲,2023-09-19,9857
00921,兆豐龍頭等權重,110,5,105,元大-蘆洲,2023-09-19,9857
00902,中信電池及儲能,84,0,84,元大-蘆洲,2023-09-19,9857
2331,精英,101,20,81,元大-蘆洲,2023-09-19,9857
2402,毅嘉,168,98,70,元大-蘆洲,2023-09-19,9857
6901,鑽石投資,82,14,68,元大-蘆洲,2023-09-19,9857
00919,群益台灣精選高息,127,63,64,元大-蘆洲,2023-09-19,9857
00673R,期元大S＆P原油反1,58,0,58,元大-蘆洲,2023-09-19,9857
5243,乙盛-KY,57,0,57,元大-蘆洲,2023-09-19,9857
2002,中鋼,51,0,51,元大-蘆洲,2023-09-19,9857
2618,長榮航,51,5,46,元大-蘆洲,2023-09-19,9857
00665L,富邦�琤肭磪囓�2,43,0,43,元大-蘆洲,2023-09-19,9857
2486,一詮,45,3,42,元大-蘆洲,2023-09-19,9857
2312,金寶,49,15,34,元大-蘆洲,2023-09-19,9857
2303,聯電,33,1,32,元大-蘆洲,2023-09-19,9857
6185,幃翔,31,0,31,元大-蘆洲,2023-09-19,9857
2105,正新,62,32,30,元大-蘆洲,2023-09-19,9857
2355,敬鵬,45,15,30,元大-蘆洲,2023-09-19,9857
2324,仁寶,30,1,29,元大-蘆洲,2023-09-19,9857
6120,達運,40,12,28,元大-蘆洲,2023-09-19,9857
4979,華星光,136,109,27,元大-蘆洲,2023-09-19,9857
3231,緯創,229,202,27,元大-蘆洲,2023-09-19,9857
6282,康舒,35,10,25,元大-蘆洲,2023-09-19,9857
1802,台玻,51,27,24,元大-蘆洲,2023-09-19,9857
2330,台積電,24,2,22,元大-蘆洲,2023-09-19,9857
2323,中環,24,2,22,元大-蘆洲,2023-09-19,9857
2388,威盛,75,54,21,元大-蘆洲,2023-09-19,9857
2607,榮運,20,0,20,元大-蘆洲,2023-09-19,9857
3060,銘異,20,0,20,元大-蘆洲,2023-09-19,9857
1471,首利,25,7,18,元大-蘆洲,2023-09-19,9857
3706,神達,36,19,17,元大-蘆洲,2023-09-19,9857
00712,復華富時不動產,16,0,16,元大-蘆洲,2023-09-19,9857
1409,新纖,17,1,16,元大-蘆洲,2023-09-19,9857
8112,至上,42,27,15,元大-蘆洲,2023-09-19,9857
6274,台燿,51,36,15,元大-蘆洲,2023-09-19,9857
6235,華孚,20,5,15,元大-蘆洲,2023-09-19,9857
0056,元大高股息,19,5,14,元大-蘆洲,2023-09-19,9857
3081,聯亞,25,11,14,元大-蘆洲,2023-09-19,9857
9907,統一實,14,0,14,元大-蘆洲,2023-09-19,9857
2542,興富發,19,5,14,元大-蘆洲,2023-09-19,9857
3078,僑威,18,4,14,元大-蘆洲,2023-09-19,9857
3260,威剛,17,3,14,元大-蘆洲,2023-09-19,9857
3669,圓展,13,0,13,元大-蘆洲,2023-09-19,9857
4908,前鼎,25,13,12,元大-蘆洲,2023-09-19,9857
2301,光寶科,14,3,11,元大-蘆洲,2023-09-19,9857
3685,元創精密,19,8,11,元大-蘆洲,2023-09-19,9857
6213,聯茂,16,5,11,元大-蘆洲,2023-09-19,9857
00929,復華台灣科技優息,841,516,325,元大-蘆洲,2023-09-20,9857
2610,華航,319,24,295,元大-蘆洲,2023-09-20,9857
00679B,元大美債20年,270,0,270,元大-蘆洲,2023-09-20,9857
2303,聯電,216,8,208,元大-蘆洲,2023-09-20,9857
3576,聯合再生,204,0,204,元大-蘆洲,2023-09-20,9857
00919,群益台灣精選高息,256,94,162,元大-蘆洲,2023-09-20,9857
2409,友達,169,14,155,元大-蘆洲,2023-09-20,9857
6226,光鼎,100,0,100,元大-蘆洲,2023-09-20,9857
00921,兆豐龍頭等權重,69,0,69,元大-蘆洲,2023-09-20,9857
3706,神達,117,52,65,元大-蘆洲,2023-09-20,9857
2363,矽統,262,197,65,元大-蘆洲,2023-09-20,9857
3481,群創,68,5,63,元大-蘆洲,2023-09-20,9857
2313,華通,141,85,56,元大-蘆洲,2023-09-20,9857
2605,新興,277,226,51,元大-蘆洲,2023-09-20,9857
3236,千如,41,0,41,元大-蘆洲,2023-09-20,9857
2449,京元電子,130,93,37,元大-蘆洲,2023-09-20,9857
2606,裕民,161,127,34,元大-蘆洲,2023-09-20,9857
2613,中櫃,33,0,33,元大-蘆洲,2023-09-20,9857
6182,合晶,36,3,33,元大-蘆洲,2023-09-20,9857
2603,長榮,44,12,32,元大-蘆洲,2023-09-20,9857
2328,廣宇,30,0,30,元大-蘆洲,2023-09-20,9857
2618,長榮航,59,29,30,元大-蘆洲,2023-09-20,9857
5009,榮剛,33,4,29,元大-蘆洲,2023-09-20,9857
5243,乙盛-KY,28,0,28,元大-蘆洲,2023-09-20,9857
3709,鑫聯大投控,28,0,28,元大-蘆洲,2023-09-20,9857
2352,佳世達,33,6,27,元大-蘆洲,2023-09-20,9857
2316,楠梓電,36,9,27,元大-蘆洲,2023-09-20,9857
1608,華榮,26,0,26,元大-蘆洲,2023-09-20,9857
2486,一詮,26,0,26,元大-蘆洲,2023-09-20,9857
2887,台新金,26,1,25,元大-蘆洲,2023-09-20,9857
2323,中環,25,0,25,元大-蘆洲,2023-09-20,9857
2312,金寶,26,3,23,元大-蘆洲,2023-09-20,9857
4909,新復興,31,8,23,元大-蘆洲,2023-09-20,9857
00680L,元大美債20正2,25,3,22,元大-蘆洲,2023-09-20,9857
2367,燿華,142,121,21,元大-蘆洲,2023-09-20,9857
3037,欣興,36,15,21,元大-蘆洲,2023-09-20,9857
00772B,中信高評級公司債,20,0,20,元大-蘆洲,2023-09-20,9857
2201,裕隆,39,19,20,元大-蘆洲,2023-09-20,9857
2038,海光,20,0,20,元大-蘆洲,2023-09-20,9857
4979,華星光,57,37,20,元大-蘆洲,2023-09-20,9857
2884,玉山金,19,0,19,元大-蘆洲,2023-09-20,9857
3715,定穎投控,108,90,18,元大-蘆洲,2023-09-20,9857
00902,中信電池及儲能,21,3,18,元大-蘆洲,2023-09-20,9857
2913,農林,18,0,18,元大-蘆洲,2023-09-20,9857
6770,力積電,18,0,18,元大-蘆洲,2023-09-20,9857
2542,興富發,18,1,17,元大-蘆洲,2023-09-20,9857
2324,仁寶,18,2,16,元大-蘆洲,2023-09-20,9857
2330,台積電,17,1,16,元大-蘆洲,2023-09-20,9857
6278,台表科,16,0,16,元大-蘆洲,2023-09-20,9857
3163,波若威,24,8,16,元大-蘆洲,2023-09-20,9857
00679B,元大美債20年,128,2,126,元大-蘆洲,2023-09-21,9857
3703,欣陸,100,0,100,元大-蘆洲,2023-09-21,9857
00919,群益台灣精選高息,113,20,93,元大-蘆洲,2023-09-21,9857
4747,強生,86,0,86,元大-蘆洲,2023-09-21,9857
2409,友達,122,39,83,元大-蘆洲,2023-09-21,9857
0050,元大台灣50,82,1,81,元大-蘆洲,2023-09-21,9857
00878,國泰永續高股息,164,87,77,元大-蘆洲,2023-09-21,9857
00902,中信電池及儲能,75,0,75,元大-蘆洲,2023-09-21,9857
00929,復華台灣科技優息,464,393,71,元大-蘆洲,2023-09-21,9857
1809,中釉,68,2,66,元大-蘆洲,2023-09-21,9857
2002,中鋼,59,0,59,元大-蘆洲,2023-09-21,9857
2486,一詮,58,1,57,元大-蘆洲,2023-09-21,9857
00922,國泰台灣領袖50,56,0,56,元大-蘆洲,2023-09-21,9857
2330,台積電,57,4,53,元大-蘆洲,2023-09-21,9857
00923,群益台ESG低碳50,43,0,43,元大-蘆洲,2023-09-21,9857
1802,台玻,93,51,42,元大-蘆洲,2023-09-21,9857
00932,兆豐永續高息等權,42,1,41,元大-蘆洲,2023-09-21,9857
2317,鴻海,39,1,38,元大-蘆洲,2023-09-21,9857
00900,富邦特選高股息30,38,0,38,元大-蘆洲,2023-09-21,9857
3338,泰碩,52,15,37,元大-蘆洲,2023-09-21,9857
00921,兆豐龍頭等權重,36,0,36,元大-蘆洲,2023-09-21,9857
0056,元大高股息,46,12,34,元大-蘆洲,2023-09-21,9857
3706,神達,37,4,33,元大-蘆洲,2023-09-21,9857
6770,力積電,34,1,33,元大-蘆洲,2023-09-21,9857
00720B,元大投資級公司債,31,0,31,元大-蘆洲,2023-09-21,9857
2891,中信金,34,3,31,元大-蘆洲,2023-09-21,9857
1216,統一,32,1,31,元大-蘆洲,2023-09-21,9857
4909,新復興,50,20,30,元大-蘆洲,2023-09-21,9857
2882,國泰金,30,0,30,元大-蘆洲,2023-09-21,9857
2887,台新金,31,1,30,元大-蘆洲,2023-09-21,9857
6118,建達,32,3,29,元大-蘆洲,2023-09-21,9857
5009,榮剛,38,9,29,元大-蘆洲,2023-09-21,9857
5880,合庫金,28,0,28,元大-蘆洲,2023-09-21,9857
2362,藍天,28,0,28,元大-蘆洲,2023-09-21,9857
2883,凱基金,43,15,28,元大-蘆洲,2023-09-21,9857
1101,台泥,35,9,26,元大-蘆洲,2023-09-21,9857
00680L,元大美債20正2,26,1,25,元大-蘆洲,2023-09-21,9857
2881,富邦金,24,0,24,元大-蘆洲,2023-09-21,9857
2884,玉山金,26,2,24,元大-蘆洲,2023-09-21,9857
00712,復華富時不動產,25,2,23,元大-蘆洲,2023-09-21,9857
2892,第一金,21,0,21,元大-蘆洲,2023-09-21,9857
00688L,國泰20年美債正2,20,0,20,元大-蘆洲,2023-09-21,9857
2392,正崴,20,0,20,元大-蘆洲,2023-09-21,9857
9105,泰金寶-DR,20,0,20,元大-蘆洲,2023-09-21,9857
006208,富邦台50,19,0,19,元大-蘆洲,2023-09-21,9857
2201,裕隆,19,0,19,元大-蘆洲,2023-09-21,9857
00632R,元大台灣50反1,140,121,19,元大-蘆洲,2023-09-21,9857
2880,華南金,19,0,19,元大-蘆洲,2023-09-21,9857
00888,永豐台灣ESG,19,0,19,元大-蘆洲,2023-09-21,9857
2542,興富發,20,2,18,元大-蘆洲,2023-09-21,9857
00885,富邦越南,428,0,428,元大-蘆洲,2023-09-22,9857
00687B,國泰20年美債,358,5,353,元大-蘆洲,2023-09-22,9857
00929,復華台灣科技優息,254,24,230,元大-蘆洲,2023-09-22,9857
00679B,元大美債20年,222,35,187,元大-蘆洲,2023-09-22,9857
00688L,國泰20年美債正2,126,0,126,元大-蘆洲,2023-09-22,9857
00712,復華富時不動產,122,0,122,元大-蘆洲,2023-09-22,9857
1314,中石化,150,30,120,元大-蘆洲,2023-09-22,9857
1605,華新,116,3,113,元大-蘆洲,2023-09-22,9857
3338,泰碩,106,4,102,元大-蘆洲,2023-09-22,9857
00680L,元大美債20正2,99,0,99,元大-蘆洲,2023-09-22,9857
2382,廣達,109,24,85,元大-蘆洲,2023-09-22,9857
00919,群益台灣精選高息,64,1,63,元大-蘆洲,2023-09-22,9857
2303,聯電,89,28,61,元大-蘆洲,2023-09-22,9857
00751B,元大AAA至A公司債,59,0,59,元大-蘆洲,2023-09-22,9857
00931B,統一美債20年,56,1,55,元大-蘆洲,2023-09-22,9857
8467,波力-KY,51,1,50,元大-蘆洲,2023-09-22,9857
00673R,期元大S＆P原油反1,55,11,44,元大-蘆洲,2023-09-22,9857
2891,中信金,40,0,40,元大-蘆洲,2023-09-22,9857
2538,基泰,42,2,40,元大-蘆洲,2023-09-22,9857
1101,台泥,44,6,38,元大-蘆洲,2023-09-22,9857
00720B,元大投資級公司債,35,0,35,元大-蘆洲,2023-09-22,9857
00665L,富邦�琤肭磪囓�2,38,8,30,元大-蘆洲,2023-09-22,9857
00795B,中信美國公債20年,33,5,28,元大-蘆洲,2023-09-22,9857
2014,中鴻,30,2,28,元大-蘆洲,2023-09-22,9857
2017,官田鋼,31,4,27,元大-蘆洲,2023-09-22,9857
00753L,中信中國50正2,26,0,26,元大-蘆洲,2023-09-22,9857
3163,波若威,46,20,26,元大-蘆洲,2023-09-22,9857
2888,新光金,31,8,23,元大-蘆洲,2023-09-22,9857
2331,精英,21,0,21,元大-蘆洲,2023-09-22,9857
2887,台新金,21,0,21,元大-蘆洲,2023-09-22,9857
2317,鴻海,25,4,21,元大-蘆洲,2023-09-22,9857
2330,台積電,39,19,20,元大-蘆洲,2023-09-22,9857
3060,銘異,20,0,20,元大-蘆洲,2023-09-22,9857
2486,一詮,27,7,20,元大-蘆洲,2023-09-22,9857
2884,玉山金,22,3,19,元大-蘆洲,2023-09-22,9857
2027,大成鋼,20,1,19,元大-蘆洲,2023-09-22,9857
3706,神達,46,27,19,元大-蘆洲,2023-09-22,9857
2883,凱基金,19,0,19,元大-蘆洲,2023-09-22,9857
6285,啟��,65,48,17,元大-蘆洲,2023-09-22,9857
6116,彩晶,35,18,17,元大-蘆洲,2023-09-22,9857
020024,兆豐富櫃200N,16,0,16,元大-蘆洲,2023-09-22,9857
00772B,中信高評級公司債,15,0,15,元大-蘆洲,2023-09-22,9857
4564,元翎,15,0,15,元大-蘆洲,2023-09-22,9857
2367,燿華,22,8,14,元大-蘆洲,2023-09-22,9857
2402,毅嘉,20,6,14,元大-蘆洲,2023-09-22,9857
2881,富邦金,13,0,13,元大-蘆洲,2023-09-22,9857
2002,中鋼,19,6,13,元大-蘆洲,2023-09-22,9857
2313,華通,50,38,12,元大-蘆洲,2023-09-22,9857
00722B,群益投資級電信債,12,0,12,元大-蘆洲,2023-09-22,9857
1444,力麗,13,1,12,元大-蘆洲,2023-09-22,9857
00929,復華台灣科技優息,277,28,249,元大-蘆洲,2023-09-25,9857
00878,國泰永續高股息,80,17,63,元大-蘆洲,2023-09-25,9857
3363,上詮,149,88,61,元大-蘆洲,2023-09-25,9857
3236,千如,56,0,56,元大-蘆洲,2023-09-25,9857
2618,長榮航,68,16,52,元大-蘆洲,2023-09-25,9857
00919,群益台灣精選高息,68,17,51,元大-蘆洲,2023-09-25,9857
4979,華星光,80,31,49,元大-蘆洲,2023-09-25,9857
2363,矽統,158,112,46,元大-蘆洲,2023-09-25,9857
00679B,元大美債20年,46,4,42,元大-蘆洲,2023-09-25,9857
6139,亞翔,52,11,41,元大-蘆洲,2023-09-25,9857
3694,海華,36,0,36,元大-蘆洲,2023-09-25,9857
2542,興富發,36,3,33,元大-蘆洲,2023-09-25,9857
1802,台玻,32,1,31,元大-蘆洲,2023-09-25,9857
2888,新光金,26,0,26,元大-蘆洲,2023-09-25,9857
6191,精成科,28,2,26,元大-蘆洲,2023-09-25,9857
3037,欣興,37,12,25,元大-蘆洲,2023-09-25,9857
2610,華航,42,18,24,元大-蘆洲,2023-09-25,9857
2201,裕隆,40,16,24,元大-蘆洲,2023-09-25,9857
00715L,期街口布蘭特正2,23,0,23,元大-蘆洲,2023-09-25,9857
2344,華邦電,23,1,22,元大-蘆洲,2023-09-25,9857
3481,群創,22,0,22,元大-蘆洲,2023-09-25,9857
2637,慧洋-KY,26,5,21,元大-蘆洲,2023-09-25,9857
2884,玉山金,28,8,20,元大-蘆洲,2023-09-25,9857
1584,精剛,60,40,20,元大-蘆洲,2023-09-25,9857
1101,台泥,23,4,19,元大-蘆洲,2023-09-25,9857
2330,台積電,22,3,19,元大-蘆洲,2023-09-25,9857
2421,建準,37,19,18,元大-蘆洲,2023-09-25,9857
3322,建舜電,31,14,17,元大-蘆洲,2023-09-25,9857
00902,中信電池及儲能,16,0,16,元大-蘆洲,2023-09-25,9857
00720B,元大投資級公司債,15,0,15,元大-蘆洲,2023-09-25,9857
3325,旭品,15,0,15,元大-蘆洲,2023-09-25,9857
00931B,統一美債20年,15,0,15,元大-蘆洲,2023-09-25,9857
00751B,元大AAA至A公司債,15,1,14,元大-蘆洲,2023-09-25,9857
3450,聯鈞,47,34,13,元大-蘆洲,2023-09-25,9857
2882,國泰金,13,0,13,元大-蘆洲,2023-09-25,9857
2002,中鋼,12,0,12,元大-蘆洲,2023-09-25,9857
2349,錸德,13,1,12,元大-蘆洲,2023-09-25,9857
6418,詠昇,13,1,12,元大-蘆洲,2023-09-25,9857
8086,宏捷科,11,0,11,元大-蘆洲,2023-09-25,9857
2313,華通,31,20,11,元大-蘆洲,2023-09-25,9857
6220,岳豐,11,0,11,元大-蘆洲,2023-09-25,9857
2354,鴻準,13,2,11,元大-蘆洲,2023-09-25,9857
3706,神達,30,19,11,元大-蘆洲,2023-09-25,9857
4944,兆遠,10,0,10,元大-蘆洲,2023-09-25,9857
9105,泰金寶-DR,10,0,10,元大-蘆洲,2023-09-25,9857
00893,國泰智能電動車,12,2,10,元大-蘆洲,2023-09-25,9857
1608,華榮,10,0,10,元大-蘆洲,2023-09-25,9857
1714,和桐,10,0,10,元大-蘆洲,2023-09-25,9857
2489,瑞軒,10,0,10,元大-蘆洲,2023-09-25,9857
3338,泰碩,10,0,10,元大-蘆洲,2023-09-25,9857
2303,聯電,322,29,293,元大-蘆洲,2023-09-26,9857
00929,復華台灣科技優息,411,132,279,元大-蘆洲,2023-09-26,9857
00919,群益台灣精選高息,150,6,144,元大-蘆洲,2023-09-26,9857
00679B,元大美債20年,133,3,130,元大-蘆洲,2023-09-26,9857
6442,光聖,101,12,89,元大-蘆洲,2023-09-26,9857
00680L,元大美債20正2,96,9,87,元大-蘆洲,2023-09-26,9857
00637L,元大滬深300正2,65,0,65,元大-蘆洲,2023-09-26,9857
1101,台泥,62,2,60,元大-蘆洲,2023-09-26,9857
2344,華邦電,60,0,60,元大-蘆洲,2023-09-26,9857
2485,兆赫,65,6,59,元大-蘆洲,2023-09-26,9857
00665L,富邦�琤肭磪囓�2,59,1,58,元大-蘆洲,2023-09-26,9857
00712,復華富時不動產,52,0,52,元大-蘆洲,2023-09-26,9857
2317,鴻海,52,3,49,元大-蘆洲,2023-09-26,9857
6732,昇佳電子,49,2,47,元大-蘆洲,2023-09-26,9857
2618,長榮航,61,15,46,元大-蘆洲,2023-09-26,9857
00730,富邦臺灣優質高息,45,0,45,元大-蘆洲,2023-09-26,9857
3308,聯德,46,3,43,元大-蘆洲,2023-09-26,9857
00772B,中信高評級公司債,45,5,40,元大-蘆洲,2023-09-26,9857
2337,旺宏,41,2,39,元大-蘆洲,2023-09-26,9857
1409,新纖,37,2,35,元大-蘆洲,2023-09-26,9857
00720B,元大投資級公司債,41,6,35,元大-蘆洲,2023-09-26,9857
00687B,國泰20年美債,35,1,34,元大-蘆洲,2023-09-26,9857
2329,華泰,35,1,34,元大-蘆洲,2023-09-26,9857
2615,萬海,32,0,32,元大-蘆洲,2023-09-26,9857
3481,群創,39,7,32,元大-蘆洲,2023-09-26,9857
9945,潤泰新,32,3,29,元大-蘆洲,2023-09-26,9857
2881,富邦金,29,1,28,元大-蘆洲,2023-09-26,9857
6153,嘉聯益,38,10,28,元大-蘆洲,2023-09-26,9857
00931B,統一美債20年,27,0,27,元大-蘆洲,2023-09-26,9857
2542,興富發,30,3,27,元大-蘆洲,2023-09-26,9857
2353,宏��,25,0,25,元大-蘆洲,2023-09-26,9857
2515,中工,46,21,25,元大-蘆洲,2023-09-26,9857
3711,日月光投控,26,1,25,元大-蘆洲,2023-09-26,9857
9904,寶成,22,0,22,元大-蘆洲,2023-09-26,9857
2801,彰銀,22,0,22,元大-蘆洲,2023-09-26,9857
6116,彩晶,27,6,21,元大-蘆洲,2023-09-26,9857
3231,緯創,51,31,20,元大-蘆洲,2023-09-26,9857
2634,漢翔,43,23,20,元大-蘆洲,2023-09-26,9857
00916,國泰全球品牌50,20,0,20,元大-蘆洲,2023-09-26,9857
00751B,元大AAA至A公司債,21,1,20,元大-蘆洲,2023-09-26,9857
2331,精英,70,50,20,元大-蘆洲,2023-09-26,9857
2313,華通,43,23,20,元大-蘆洲,2023-09-26,9857
2352,佳世達,41,22,19,元大-蘆洲,2023-09-26,9857
2892,第一金,21,2,19,元大-蘆洲,2023-09-26,9857
2363,矽統,109,91,18,元大-蘆洲,2023-09-26,9857
3051,力特,69,51,18,元大-蘆洲,2023-09-26,9857
6108,競國,18,0,18,元大-蘆洲,2023-09-26,9857
2402,毅嘉,40,22,18,元大-蘆洲,2023-09-26,9857
5381,合正,30,12,18,元大-蘆洲,2023-09-26,9857
1524,耿鼎,62,44,18,元大-蘆洲,2023-09-26,9857
00929,復華台灣科技優息,242,25,217,元大-蘆洲,2023-09-27,9857
3036,文曄,159,53,106,元大-蘆洲,2023-09-27,9857
6153,嘉聯益,102,2,100,元大-蘆洲,2023-09-27,9857
3056,富華新,101,5,96,元大-蘆洲,2023-09-27,9857
2002,中鋼,129,38,91,元大-蘆洲,2023-09-27,9857
00919,群益台灣精選高息,75,0,75,元大-蘆洲,2023-09-27,9857
00712,復華富時不動產,67,0,67,元大-蘆洲,2023-09-27,9857
2014,中鴻,71,5,66,元大-蘆洲,2023-09-27,9857
2609,陽明,81,21,60,元大-蘆洲,2023-09-27,9857
00679B,元大美債20年,59,10,49,元大-蘆洲,2023-09-27,9857
1605,華新,46,4,42,元大-蘆洲,2023-09-27,9857
2723,美食-KY,39,1,38,元大-蘆洲,2023-09-27,9857
6271,同欣電,40,2,38,元大-蘆洲,2023-09-27,9857
00932,兆豐永續高息等權,37,0,37,元大-蘆洲,2023-09-27,9857
1102,亞泥,36,0,36,元大-蘆洲,2023-09-27,9857
00922,國泰台灣領袖50,35,0,35,元大-蘆洲,2023-09-27,9857
2542,興富發,33,0,33,元大-蘆洲,2023-09-27,9857
00720B,元大投資級公司債,31,0,31,元大-蘆洲,2023-09-27,9857
00637L,元大滬深300正2,34,4,30,元大-蘆洲,2023-09-27,9857
00878,國泰永續高股息,42,14,28,元大-蘆洲,2023-09-27,9857
1101,台泥,29,2,27,元大-蘆洲,2023-09-27,9857
0050,元大台灣50,26,0,26,元大-蘆洲,2023-09-27,9857
00680L,元大美債20正2,21,0,21,元大-蘆洲,2023-09-27,9857
5483,中美晶,21,0,21,元大-蘆洲,2023-09-27,9857
8420,明揚,68,48,20,元大-蘆洲,2023-09-27,9857
9904,寶成,18,3,15,元大-蘆洲,2023-09-27,9857
5880,合庫金,15,0,15,元大-蘆洲,2023-09-27,9857
2883,凱基金,15,1,14,元大-蘆洲,2023-09-27,9857
2369,菱生,14,0,14,元大-蘆洲,2023-09-27,9857
00753L,中信中國50正2,13,0,13,元大-蘆洲,2023-09-27,9857
3481,群創,28,15,13,元大-蘆洲,2023-09-27,9857
6257,矽格,13,1,12,元大-蘆洲,2023-09-27,9857
2330,台積電,13,1,12,元大-蘆洲,2023-09-27,9857
3707,漢磊,12,1,11,元大-蘆洲,2023-09-27,9857
3037,欣興,15,4,11,元大-蘆洲,2023-09-27,9857
2421,建準,36,25,11,元大-蘆洲,2023-09-27,9857
1802,台玻,15,4,11,元大-蘆洲,2023-09-27,9857
00900,富邦特選高股息30,10,0,10,元大-蘆洲,2023-09-27,9857
2206,三陽工業,16,6,10,元大-蘆洲,2023-09-27,9857
2516,新建,10,0,10,元大-蘆洲,2023-09-27,9857
1310,台苯,10,0,10,元大-蘆洲,2023-09-27,9857
00715L,期街口布蘭特正2,10,0,10,元大-蘆洲,2023-09-27,9857
6789,采鈺,10,0,10,元大-蘆洲,2023-09-27,9857
3711,日月光投控,11,1,10,元大-蘆洲,2023-09-27,9857
1471,首利,9,0,9,元大-蘆洲,2023-09-27,9857
3685,元創精密,9,0,9,元大-蘆洲,2023-09-27,9857
2880,華南金,9,0,9,元大-蘆洲,2023-09-27,9857
2301,光寶科,17,9,8,元大-蘆洲,2023-09-27,9857
3049,精金,8,0,8,元大-蘆洲,2023-09-27,9857
1409,新纖,11,3,8,元大-蘆洲,2023-09-27,9857
00929,復華台灣科技優息,256,22,234,元大-蘆洲,2023-09-28,9857
1314,中石化,150,0,150,元大-蘆洲,2023-09-28,9857
00931B,統一美債20年,95,3,92,元大-蘆洲,2023-09-28,9857
2610,華航,93,1,92,元大-蘆洲,2023-09-28,9857
1815,富喬,125,44,81,元大-蘆洲,2023-09-28,9857
00712,復華富時不動產,148,70,78,元大-蘆洲,2023-09-28,9857
2368,金像電,91,15,76,元大-蘆洲,2023-09-28,9857
00673R,期元大S＆P原油反1,73,0,73,元大-蘆洲,2023-09-28,9857
1409,新纖,80,10,70,元大-蘆洲,2023-09-28,9857
2618,長榮航,75,7,68,元大-蘆洲,2023-09-28,9857
3231,緯創,239,178,61,元大-蘆洲,2023-09-28,9857
00679B,元大美債20年,79,23,56,元大-蘆洲,2023-09-28,9857
2002,中鋼,67,13,54,元大-蘆洲,2023-09-28,9857
00676R,富邦臺灣加權反1,50,0,50,元大-蘆洲,2023-09-28,9857
00680L,元大美債20正2,54,7,47,元大-蘆洲,2023-09-28,9857
4555,氣立,45,0,45,元大-蘆洲,2023-09-28,9857
2409,友達,48,6,42,元大-蘆洲,2023-09-28,9857
2014,中鴻,50,8,42,元大-蘆洲,2023-09-28,9857
6116,彩晶,60,22,38,元大-蘆洲,2023-09-28,9857
00688L,國泰20年美債正2,35,0,35,元大-蘆洲,2023-09-28,9857
1101,台泥,39,4,35,元大-蘆洲,2023-09-28,9857
2353,宏��,43,9,34,元大-蘆洲,2023-09-28,9857
2344,華邦電,63,30,33,元大-蘆洲,2023-09-28,9857
00687B,國泰20年美債,44,12,32,元大-蘆洲,2023-09-28,9857
00665L,富邦�琤肭磪囓�2,33,2,31,元大-蘆洲,2023-09-28,9857
2834,臺企銀,34,3,31,元大-蘆洲,2023-09-28,9857
00720B,元大投資級公司債,32,1,31,元大-蘆洲,2023-09-28,9857
3037,欣興,36,6,30,元大-蘆洲,2023-09-28,9857
3006,晶豪科,32,4,28,元大-蘆洲,2023-09-28,9857
2356,英業達,66,38,28,元大-蘆洲,2023-09-28,9857
9904,寶成,30,4,26,元大-蘆洲,2023-09-28,9857
1605,華新,34,9,25,元大-蘆洲,2023-09-28,9857
3035,智原,52,29,23,元大-蘆洲,2023-09-28,9857
4979,華星光,47,24,23,元大-蘆洲,2023-09-28,9857
3322,建舜電,77,54,23,元大-蘆洲,2023-09-28,9857
00919,群益台灣精選高息,23,0,23,元大-蘆洲,2023-09-28,9857
3051,力特,50,31,19,元大-蘆洲,2023-09-28,9857
00751B,元大AAA至A公司債,19,1,18,元大-蘆洲,2023-09-28,9857
2883,凱基金,24,6,18,元大-蘆洲,2023-09-28,9857
2329,華泰,21,3,18,元大-蘆洲,2023-09-28,9857
1710,東聯,16,0,16,元大-蘆洲,2023-09-28,9857
00637L,元大滬深300正2,15,0,15,元大-蘆洲,2023-09-28,9857
6517,保勝光學,14,0,14,元大-蘆洲,2023-09-28,9857
2887,台新金,14,0,14,元大-蘆洲,2023-09-28,9857
6274,台燿,43,30,13,元大-蘆洲,2023-09-28,9857
8210,勤誠,19,6,13,元大-蘆洲,2023-09-28,9857
6276,安鈦克,14,1,13,元大-蘆洲,2023-09-28,9857
2363,矽統,88,75,13,元大-蘆洲,2023-09-28,9857
9945,潤泰新,14,2,12,元大-蘆洲,2023-09-28,9857
3308,聯德,14,2,12,元大-蘆洲,2023-09-28,9857
8358,金居,240,18,222,元大-蘆洲,2023-10-02,9857
2409,友達,136,10,126,元大-蘆洲,2023-10-02,9857
3363,上詮,131,9,122,元大-蘆洲,2023-10-02,9857
6188,廣明,120,9,111,元大-蘆洲,2023-10-02,9857
3037,欣興,117,17,100,元大-蘆洲,2023-10-02,9857
2618,長榮航,91,18,73,元大-蘆洲,2023-10-02,9857
00751B,元大AAA至A公司債,69,2,67,元大-蘆洲,2023-10-02,9857
00720B,元大投資級公司債,60,3,57,元大-蘆洲,2023-10-02,9857
3062,建漢,50,0,50,元大-蘆洲,2023-10-02,9857
2329,華泰,103,53,50,元大-蘆洲,2023-10-02,9857
2352,佳世達,41,1,40,元大-蘆洲,2023-10-02,9857
5324,士開,42,4,38,元大-蘆洲,2023-10-02,9857
4556,旭然,37,0,37,元大-蘆洲,2023-10-02,9857
00919,群益台灣精選高息,43,7,36,元大-蘆洲,2023-10-02,9857
2867,三商壽,33,0,33,元大-蘆洲,2023-10-02,9857
00680L,元大美債20正2,34,1,33,元大-蘆洲,2023-10-02,9857
2354,鴻準,36,5,31,元大-蘆洲,2023-10-02,9857
2344,華邦電,37,7,30,元大-蘆洲,2023-10-02,9857
5388,中磊,30,0,30,元大-蘆洲,2023-10-02,9857
2002,中鋼,50,21,29,元大-蘆洲,2023-10-02,9857
00632R,元大台灣50反1,28,0,28,元大-蘆洲,2023-10-02,9857
2888,新光金,26,0,26,元大-蘆洲,2023-10-02,9857
6116,彩晶,37,13,24,元大-蘆洲,2023-10-02,9857
00679B,元大美債20年,26,3,23,元大-蘆洲,2023-10-02,9857
6173,信昌電,23,0,23,元大-蘆洲,2023-10-02,9857
2542,興富發,23,0,23,元大-蘆洲,2023-10-02,9857
2323,中環,22,0,22,元大-蘆洲,2023-10-02,9857
2349,錸德,22,0,22,元大-蘆洲,2023-10-02,9857
2883,凱基金,24,2,22,元大-蘆洲,2023-10-02,9857
1618,合機,32,10,22,元大-蘆洲,2023-10-02,9857
2816,旺旺保,21,1,20,元大-蘆洲,2023-10-02,9857
2609,陽明,30,10,20,元大-蘆洲,2023-10-02,9857
2880,華南金,19,0,19,元大-蘆洲,2023-10-02,9857
6117,迎廣,35,16,19,元大-蘆洲,2023-10-02,9857
00888,永豐台灣ESG,17,1,16,元大-蘆洲,2023-10-02,9857
2027,大成鋼,18,2,16,元大-蘆洲,2023-10-02,9857
9945,潤泰新,20,5,15,元大-蘆洲,2023-10-02,9857
2371,大同,15,0,15,元大-蘆洲,2023-10-02,9857
8086,宏捷科,16,2,14,元大-蘆洲,2023-10-02,9857
8436,大江,14,0,14,元大-蘆洲,2023-10-02,9857
2017,官田鋼,13,0,13,元大-蘆洲,2023-10-02,9857
2355,敬鵬,64,52,12,元大-蘆洲,2023-10-02,9857
00712,復華富時不動產,14,2,12,元大-蘆洲,2023-10-02,9857
2516,新建,12,0,12,元大-蘆洲,2023-10-02,9857
00931B,統一美債20年,12,0,12,元大-蘆洲,2023-10-02,9857
5452,佶優,16,4,12,元大-蘆洲,2023-10-02,9857
8227,巨有科技,18,6,12,元大-蘆洲,2023-10-02,9857
2884,玉山金,13,1,12,元大-蘆洲,2023-10-02,9857
8926,台汽電,11,0,11,元大-蘆洲,2023-10-02,9857
2425,承啟,11,0,11,元大-蘆洲,2023-10-02,9857
3481,群創,283,39,244,元大-蘆洲,2023-10-03,9857
00929,復華台灣科技優息,183,27,156,元大-蘆洲,2023-10-03,9857
3231,緯創,271,145,126,元大-蘆洲,2023-10-03,9857
2409,友達,176,52,124,元大-蘆洲,2023-10-03,9857
0056,元大高股息,118,10,108,元大-蘆洲,2023-10-03,9857
00712,復華富時不動產,73,2,71,元大-蘆洲,2023-10-03,9857
00922,國泰台灣領袖50,68,0,68,元大-蘆洲,2023-10-03,9857
00882,中信中國高股息,63,0,63,元大-蘆洲,2023-10-03,9857
00637L,元大滬深300正2,158,100,58,元大-蘆洲,2023-10-03,9857
2618,長榮航,55,7,48,元大-蘆洲,2023-10-03,9857
2331,精英,44,0,44,元大-蘆洲,2023-10-03,9857
6854,錼創科技-KY創,41,0,41,元大-蘆洲,2023-10-03,9857
2002,中鋼,42,5,37,元大-蘆洲,2023-10-03,9857
00919,群益台灣精選高息,42,6,36,元大-蘆洲,2023-10-03,9857
2025,千興,32,0,32,元大-蘆洲,2023-10-03,9857
2413,環科,30,0,30,元大-蘆洲,2023-10-03,9857
00679B,元大美債20年,29,0,29,元大-蘆洲,2023-10-03,9857
00888,永豐台灣ESG,30,2,28,元大-蘆洲,2023-10-03,9857
00753L,中信中國50正2,27,0,27,元大-蘆洲,2023-10-03,9857
2313,華通,52,25,27,元大-蘆洲,2023-10-03,9857
00878,國泰永續高股息,36,10,26,元大-蘆洲,2023-10-03,9857
4944,兆遠,35,9,26,元大-蘆洲,2023-10-03,9857
00907,永豐優息存股,25,0,25,元大-蘆洲,2023-10-03,9857
00720B,元大投資級公司債,40,15,25,元大-蘆洲,2023-10-03,9857
2388,威盛,86,62,24,元大-蘆洲,2023-10-03,9857
00905,FT臺灣Smart,23,0,23,元大-蘆洲,2023-10-03,9857
9904,寶成,21,0,21,元大-蘆洲,2023-10-03,9857
2206,三陽工業,35,14,21,元大-蘆洲,2023-10-03,9857
6282,康舒,23,2,21,元大-蘆洲,2023-10-03,9857
1326,台化,20,0,20,元大-蘆洲,2023-10-03,9857
1514,亞力,48,27,21,元大-蘆洲,2023-10-03,9857
4909,新復興,20,0,20,元大-蘆洲,2023-10-03,9857
2885,元大金,22,2,20,元大-蘆洲,2023-10-03,9857
00897,富邦基因免疫生技,19,0,19,元大-蘆洲,2023-10-03,9857
8227,巨有科技,23,5,18,元大-蘆洲,2023-10-03,9857
2634,漢翔,17,0,17,元大-蘆洲,2023-10-03,9857
2402,毅嘉,49,32,17,元大-蘆洲,2023-10-03,9857
00924,復華S＆P500成長,17,0,17,元大-蘆洲,2023-10-03,9857
2329,華泰,47,30,17,元大-蘆洲,2023-10-03,9857
2891,中信金,17,0,17,元大-蘆洲,2023-10-03,9857
1605,華新,21,4,17,元大-蘆洲,2023-10-03,9857
00927,群益半導體收益,16,0,16,元大-蘆洲,2023-10-03,9857
2882,國泰金,18,2,16,元大-蘆洲,2023-10-03,9857
00680L,元大美債20正2,18,3,15,元大-蘆洲,2023-10-03,9857
3013,晟銘電,47,32,15,元大-蘆洲,2023-10-03,9857
00688L,國泰20年美債正2,15,0,15,元大-蘆洲,2023-10-03,9857
3265,台星科,18,3,15,元大-蘆洲,2023-10-03,9857
3032,偉訓,57,42,15,元大-蘆洲,2023-10-03,9857
2436,偉詮電,15,1,14,元大-蘆洲,2023-10-03,9857
00719B,元大美債1-3,13,0,13,元大-蘆洲,2023-10-03,9857
2303,聯電,246,2,244,元大-蘆洲,2023-10-04,9857
2609,陽明,285,73,212,元大-蘆洲,2023-10-04,9857
00679B,元大美債20年,221,45,176,元大-蘆洲,2023-10-04,9857
00929,復華台灣科技優息,189,24,165,元大-蘆洲,2023-10-04,9857
00688L,國泰20年美債正2,129,0,129,元大-蘆洲,2023-10-04,9857
00712,復華富時不動產,134,14,120,元大-蘆洲,2023-10-04,9857
6153,嘉聯益,101,2,99,元大-蘆洲,2023-10-04,9857
00878,國泰永續高股息,112,16,96,元大-蘆洲,2023-10-04,9857
2409,友達,125,38,87,元大-蘆洲,2023-10-04,9857
00720B,元大投資級公司債,97,15,82,元大-蘆洲,2023-10-04,9857
2353,宏��,84,5,79,元大-蘆洲,2023-10-04,9857
00922,國泰台灣領袖50,74,0,74,元大-蘆洲,2023-10-04,9857
00687B,國泰20年美債,93,24,69,元大-蘆洲,2023-10-04,9857
00772B,中信高評級公司債,70,5,65,元大-蘆洲,2023-10-04,9857
00680L,元大美債20正2,183,120,63,元大-蘆洲,2023-10-04,9857
2002,中鋼,73,12,61,元大-蘆洲,2023-10-04,9857
2382,廣達,128,68,60,元大-蘆洲,2023-10-04,9857
0056,元大高股息,62,8,54,元大-蘆洲,2023-10-04,9857
00919,群益台灣精選高息,75,23,52,元大-蘆洲,2023-10-04,9857
2892,第一金,50,1,49,元大-蘆洲,2023-10-04,9857
1802,台玻,54,7,47,元大-蘆洲,2023-10-04,9857
00719B,元大美債1-3,43,1,42,元大-蘆洲,2023-10-04,9857
5272,笙科,42,1,41,元大-蘆洲,2023-10-04,9857
2891,中信金,47,9,38,元大-蘆洲,2023-10-04,9857
2317,鴻海,53,19,34,元大-蘆洲,2023-10-04,9857
00673R,期元大S＆P原油反1,34,0,34,元大-蘆洲,2023-10-04,9857
00751B,元大AAA至A公司債,40,6,34,元大-蘆洲,2023-10-04,9857
8086,宏捷科,38,6,32,元大-蘆洲,2023-10-04,9857
2412,中華電,33,2,31,元大-蘆洲,2023-10-04,9857
2618,長榮航,54,23,31,元大-蘆洲,2023-10-04,9857
2888,新光金,36,5,31,元大-蘆洲,2023-10-04,9857
4909,新復興,30,0,30,元大-蘆洲,2023-10-04,9857
00637L,元大滬深300正2,170,140,30,元大-蘆洲,2023-10-04,9857
2885,元大金,29,1,28,元大-蘆洲,2023-10-04,9857
00931B,統一美債20年,38,11,27,元大-蘆洲,2023-10-04,9857
2330,台積電,29,3,26,元大-蘆洲,2023-10-04,9857
6274,台燿,32,8,24,元大-蘆洲,2023-10-04,9857
1718,中纖,24,0,24,元大-蘆洲,2023-10-04,9857
2887,台新金,25,1,24,元大-蘆洲,2023-10-04,9857
6770,力積電,24,1,23,元大-蘆洲,2023-10-04,9857
4556,旭然,23,0,23,元大-蘆洲,2023-10-04,9857
8227,巨有科技,40,18,22,元大-蘆洲,2023-10-04,9857
5880,合庫金,33,11,22,元大-蘆洲,2023-10-04,9857
6112,邁達特,27,6,21,元大-蘆洲,2023-10-04,9857
3231,緯創,115,95,20,元大-蘆洲,2023-10-04,9857
2881,富邦金,36,16,20,元大-蘆洲,2023-10-04,9857
3037,欣興,29,10,19,元大-蘆洲,2023-10-04,9857
2312,金寶,20,1,19,元大-蘆洲,2023-10-04,9857
1216,統一,22,3,19,元大-蘆洲,2023-10-04,9857
2344,華邦電,22,4,18,元大-蘆洲,2023-10-04,9857
8358,金居,378,29,349,元大-蘆洲,2023-10-05,9857
2002,中鋼,174,4,170,元大-蘆洲,2023-10-05,9857
00712,復華富時不動產,125,0,125,元大-蘆洲,2023-10-05,9857
00632R,元大台灣50反1,85,0,85,元大-蘆洲,2023-10-05,9857
00929,復華台灣科技優息,121,37,84,元大-蘆洲,2023-10-05,9857
2883,凱基金,100,38,62,元大-蘆洲,2023-10-05,9857
00772B,中信高評級公司債,51,0,51,元大-蘆洲,2023-10-05,9857
2486,一詮,242,195,47,元大-蘆洲,2023-10-05,9857
9945,潤泰新,45,1,44,元大-蘆洲,2023-10-05,9857
3231,緯創,88,45,43,元大-蘆洲,2023-10-05,9857
2892,第一金,37,1,36,元大-蘆洲,2023-10-05,9857
2377,微星,35,1,34,元大-蘆洲,2023-10-05,9857
00665L,富邦�琤肭磪囓�2,31,0,31,元大-蘆洲,2023-10-05,9857
4906,正文,31,0,31,元大-蘆洲,2023-10-05,9857
00720B,元大投資級公司債,30,0,30,元大-蘆洲,2023-10-05,9857
1815,富喬,153,126,27,元大-蘆洲,2023-10-05,9857
00882,中信中國高股息,26,0,26,元大-蘆洲,2023-10-05,9857
00719B,元大美債1-3,28,2,26,元大-蘆洲,2023-10-05,9857
5340,建榮,29,4,25,元大-蘆洲,2023-10-05,9857
2408,南亞科,31,9,22,元大-蘆洲,2023-10-05,9857
1314,中石化,20,0,20,元大-蘆洲,2023-10-05,9857
1108,幸福,20,0,20,元大-蘆洲,2023-10-05,9857
00637L,元大滬深300正2,20,0,20,元大-蘆洲,2023-10-05,9857
6116,彩晶,38,18,20,元大-蘆洲,2023-10-05,9857
1524,耿鼎,23,3,20,元大-蘆洲,2023-10-05,9857
5381,合正,32,13,19,元大-蘆洲,2023-10-05,9857
4979,華星光,32,14,18,元大-蘆洲,2023-10-05,9857
1101,台泥,19,1,18,元大-蘆洲,2023-10-05,9857
2882,國泰金,26,9,17,元大-蘆洲,2023-10-05,9857
00679B,元大美債20年,26,10,16,元大-蘆洲,2023-10-05,9857
2369,菱生,21,5,16,元大-蘆洲,2023-10-05,9857
2355,敬鵬,35,19,16,元大-蘆洲,2023-10-05,9857
3706,神達,23,7,16,元大-蘆洲,2023-10-05,9857
00687B,國泰20年美債,16,0,16,元大-蘆洲,2023-10-05,9857
2516,新建,15,0,15,元大-蘆洲,2023-10-05,9857
4967,十銓,23,8,15,元大-蘆洲,2023-10-05,9857
8210,勤誠,24,10,14,元大-蘆洲,2023-10-05,9857
5272,笙科,22,8,14,元大-蘆洲,2023-10-05,9857
6274,台燿,34,21,13,元大-蘆洲,2023-10-05,9857
8049,晶采,13,0,13,元大-蘆洲,2023-10-05,9857
6204,艾華,14,1,13,元大-蘆洲,2023-10-05,9857
3308,聯德,12,0,12,元大-蘆洲,2023-10-05,9857
6167,久正,11,0,11,元大-蘆洲,2023-10-05,9857
3545,敦泰,16,5,11,元大-蘆洲,2023-10-05,9857
2409,友達,22,11,11,元大-蘆洲,2023-10-05,9857
6197,佳必琪,11,0,11,元大-蘆洲,2023-10-05,9857
6288,聯嘉,45,34,11,元大-蘆洲,2023-10-05,9857
2634,漢翔,11,1,10,元大-蘆洲,2023-10-05,9857
2317,鴻海,17,7,10,元大-蘆洲,2023-10-05,9857
2897,王道銀行,10,0,10,元大-蘆洲,2023-10-05,9857
9105,泰金寶-DR,176,3,173,元大-蘆洲,2023-10-06,9857
00929,復華台灣科技優息,166,32,134,元大-蘆洲,2023-10-06,9857
00712,復華富時不動產,95,10,85,元大-蘆洲,2023-10-06,9857
3363,上詮,90,25,65,元大-蘆洲,2023-10-06,9857
00902,中信電池及儲能,64,0,64,元大-蘆洲,2023-10-06,9857
00632R,元大台灣50反1,59,0,59,元大-蘆洲,2023-10-06,9857
2329,華泰,82,29,53,元大-蘆洲,2023-10-06,9857
2363,矽統,119,69,50,元大-蘆洲,2023-10-06,9857
2618,長榮航,153,107,46,元大-蘆洲,2023-10-06,9857
1616,億泰,42,0,42,元大-蘆洲,2023-10-06,9857
2409,友達,47,6,41,元大-蘆洲,2023-10-06,9857
2312,金寶,44,10,34,元大-蘆洲,2023-10-06,9857
2340,台亞,32,0,32,元大-蘆洲,2023-10-06,9857
3037,欣興,38,6,32,元大-蘆洲,2023-10-06,9857
5347,世界,32,0,32,元大-蘆洲,2023-10-06,9857
2883,凱基金,32,2,30,元大-蘆洲,2023-10-06,9857
6191,精成科,32,5,27,元大-蘆洲,2023-10-06,9857
2486,一詮,176,149,27,元大-蘆洲,2023-10-06,9857
1605,華新,69,45,24,元大-蘆洲,2023-10-06,9857
00715L,期街口布蘭特正2,22,0,22,元大-蘆洲,2023-10-06,9857
00772B,中信高評級公司債,21,0,21,元大-蘆洲,2023-10-06,9857
5426,振發,33,12,21,元大-蘆洲,2023-10-06,9857
3481,群創,27,6,21,元大-蘆洲,2023-10-06,9857
2331,精英,20,0,20,元大-蘆洲,2023-10-06,9857
2413,環科,30,10,20,元大-蘆洲,2023-10-06,9857
00719B,元大美債1-3,20,0,20,元大-蘆洲,2023-10-06,9857
3530,晶相光,28,9,19,元大-蘆洲,2023-10-06,9857
3071,協禧,20,1,19,元大-蘆洲,2023-10-06,9857
6139,亞翔,36,17,19,元大-蘆洲,2023-10-06,9857
00720B,元大投資級公司債,32,14,18,元大-蘆洲,2023-10-06,9857
2888,新光金,17,0,17,元大-蘆洲,2023-10-06,9857
8930,青鋼,22,5,17,元大-蘆洲,2023-10-06,9857
2313,華通,31,15,16,元大-蘆洲,2023-10-06,9857
2610,華航,17,1,16,元大-蘆洲,2023-10-06,9857
00891,中信關鍵半導體,20,4,16,元大-蘆洲,2023-10-06,9857
2323,中環,19,3,16,元大-蘆洲,2023-10-06,9857
3325,旭品,43,27,16,元大-蘆洲,2023-10-06,9857
00679B,元大美債20年,20,5,15,元大-蘆洲,2023-10-06,9857
00888,永豐台灣ESG,15,0,15,元大-蘆洲,2023-10-06,9857
2603,長榮,17,2,15,元大-蘆洲,2023-10-06,9857
5469,瀚宇博,18,4,14,元大-蘆洲,2023-10-06,9857
2206,三陽工業,15,1,14,元大-蘆洲,2023-10-06,9857
2453,凌群,22,8,14,元大-蘆洲,2023-10-06,9857
1909,榮成,17,3,14,元大-蘆洲,2023-10-06,9857
3213,茂訊,13,0,13,元大-蘆洲,2023-10-06,9857
00919,群益台灣精選高息,20,8,12,元大-蘆洲,2023-10-06,9857
1515,力山,14,2,12,元大-蘆洲,2023-10-06,9857
1324,地球,17,5,12,元大-蘆洲,2023-10-06,9857
2368,金像電,17,5,12,元大-蘆洲,2023-10-06,9857
3715,定穎投控,126,114,12,元大-蘆洲,2023-10-06,9857
3231,緯創,392,134,258,元大-蘆洲,2023-10-11,9857
00632R,元大台灣50反1,240,0,240,元大-蘆洲,2023-10-11,9857
0056,元大高股息,177,46,131,元大-蘆洲,2023-10-11,9857
3694,海華,128,1,127,元大-蘆洲,2023-10-11,9857
2618,長榮航,129,12,117,元大-蘆洲,2023-10-11,9857
5469,瀚宇博,114,8,106,元大-蘆洲,2023-10-11,9857
9105,泰金寶-DR,103,16,87,元大-蘆洲,2023-10-11,9857
2356,英業達,111,35,76,元大-蘆洲,2023-10-11,9857
00919,群益台灣精選高息,92,19,73,元大-蘆洲,2023-10-11,9857
3013,晟銘電,118,46,72,元大-蘆洲,2023-10-11,9857
2867,三商壽,70,0,70,元大-蘆洲,2023-10-11,9857
1609,大亞,67,2,65,元大-蘆洲,2023-10-11,9857
4909,新復興,50,4,46,元大-蘆洲,2023-10-11,9857
2542,興富發,45,4,41,元大-蘆洲,2023-10-11,9857
2353,宏��,41,5,36,元大-蘆洲,2023-10-11,9857
6244,茂迪,33,0,33,元大-蘆洲,2023-10-11,9857
4944,兆遠,33,0,33,元大-蘆洲,2023-10-11,9857
2610,華航,52,20,32,元大-蘆洲,2023-10-11,9857
1802,台玻,51,20,31,元大-蘆洲,2023-10-11,9857
6116,彩晶,55,25,30,元大-蘆洲,2023-10-11,9857
6695,芯鼎,28,0,28,元大-蘆洲,2023-10-11,9857
5864,致和證,25,0,25,元大-蘆洲,2023-10-11,9857
2014,中鴻,23,0,23,元大-蘆洲,2023-10-11,9857
1471,首利,54,31,23,元大-蘆洲,2023-10-11,9857
1314,中石化,23,0,23,元大-蘆洲,2023-10-11,9857
2399,映泰,32,9,23,元大-蘆洲,2023-10-11,9857
2329,華泰,42,20,22,元大-蘆洲,2023-10-11,9857
2603,長榮,60,38,22,元大-蘆洲,2023-10-11,9857
2367,燿華,24,4,20,元大-蘆洲,2023-10-11,9857
4414,如興,20,0,20,元大-蘆洲,2023-10-11,9857
2405,輔信,30,10,20,元大-蘆洲,2023-10-11,9857
00720B,元大投資級公司債,19,0,19,元大-蘆洲,2023-10-11,9857
2312,金寶,24,6,18,元大-蘆洲,2023-10-11,9857
00900,富邦特選高股息30,25,7,18,元大-蘆洲,2023-10-11,9857
2498,宏達電,18,0,18,元大-蘆洲,2023-10-11,9857
2439,美律,22,4,18,元大-蘆洲,2023-10-11,9857
3088,艾訊,21,3,18,元大-蘆洲,2023-10-11,9857
2465,麗臺,22,4,18,元大-蘆洲,2023-10-11,9857
2201,裕隆,20,2,18,元大-蘆洲,2023-10-11,9857
6120,達運,20,3,17,元大-蘆洲,2023-10-11,9857
6901,鑽石投資,18,1,17,元大-蘆洲,2023-10-11,9857
2359,所羅門,16,0,16,元大-蘆洲,2023-10-11,9857
2421,建準,29,13,16,元大-蘆洲,2023-10-11,9857
2402,毅嘉,25,9,16,元大-蘆洲,2023-10-11,9857
3047,訊舟,15,0,15,元大-蘆洲,2023-10-11,9857
2636,台驊控股,15,0,15,元大-蘆洲,2023-10-11,9857
8034,榮群,15,0,15,元大-蘆洲,2023-10-11,9857
2365,昆盈,43,28,15,元大-蘆洲,2023-10-11,9857
00773B,中信優先金融債,15,0,15,元大-蘆洲,2023-10-11,9857
3037,欣興,22,8,14,元大-蘆洲,2023-10-11,9857
3481,群創,1150,60,1090,元大-蘆洲,2023-10-12,9857
00637L,元大滬深300正2,506,33,473,元大-蘆洲,2023-10-12,9857
00632R,元大台灣50反1,267,0,267,元大-蘆洲,2023-10-12,9857
00919,群益台灣精選高息,70,0,70,元大-蘆洲,2023-10-12,9857
2405,輔信,69,4,65,元大-蘆洲,2023-10-12,9857
2382,廣達,127,70,57,元大-蘆洲,2023-10-12,9857
1609,大亞,67,10,57,元大-蘆洲,2023-10-12,9857
3694,海華,62,13,49,元大-蘆洲,2023-10-12,9857
9105,泰金寶-DR,36,0,36,元大-蘆洲,2023-10-12,9857
00679B,元大美債20年,39,5,34,元大-蘆洲,2023-10-12,9857
00715L,期街口布蘭特正2,34,1,33,元大-蘆洲,2023-10-12,9857
8227,巨有科技,31,4,27,元大-蘆洲,2023-10-12,9857
00720B,元大投資級公司債,22,0,22,元大-蘆洲,2023-10-12,9857
4979,華星光,74,53,21,元大-蘆洲,2023-10-12,9857
3122,笙泉,41,20,21,元大-蘆洲,2023-10-12,9857
2409,友達,26,5,21,元大-蘆洲,2023-10-12,9857
1324,地球,33,13,20,元大-蘆洲,2023-10-12,9857
2634,漢翔,22,3,19,元大-蘆洲,2023-10-12,9857
2438,翔耀,18,0,18,元大-蘆洲,2023-10-12,9857
2486,一詮,175,157,18,元大-蘆洲,2023-10-12,9857
2601,益航,20,3,17,元大-蘆洲,2023-10-12,9857
4906,正文,16,1,15,元大-蘆洲,2023-10-12,9857
2867,三商壽,15,0,15,元大-蘆洲,2023-10-12,9857
2413,環科,15,0,15,元大-蘆洲,2023-10-12,9857
4967,十銓,24,9,15,元大-蘆洲,2023-10-12,9857
2605,新興,14,0,14,元大-蘆洲,2023-10-12,9857
2206,三陽工業,22,8,14,元大-蘆洲,2023-10-12,9857
1815,富喬,36,23,13,元大-蘆洲,2023-10-12,9857
2402,毅嘉,25,12,13,元大-蘆洲,2023-10-12,9857
6216,居易,21,8,13,元大-蘆洲,2023-10-12,9857
00929,復華台灣科技優息,36,24,12,元大-蘆洲,2023-10-12,9857
2313,華通,45,33,12,元大-蘆洲,2023-10-12,9857
6684,安格,11,0,11,元大-蘆洲,2023-10-12,9857
6438,迅得,11,0,11,元大-蘆洲,2023-10-12,9857
2637,慧洋-KY,11,0,11,元大-蘆洲,2023-10-12,9857
6443,元晶,16,5,11,元大-蘆洲,2023-10-12,9857
3308,聯德,11,0,11,元大-蘆洲,2023-10-12,9857
3010,華立,11,0,11,元大-蘆洲,2023-10-12,9857
6854,錼創科技-KY創,11,0,11,元大-蘆洲,2023-10-12,9857
9919,康那香,11,0,11,元大-蘆洲,2023-10-12,9857
1101,台泥,13,3,10,元大-蘆洲,2023-10-12,9857
1517,利奇,10,0,10,元大-蘆洲,2023-10-12,9857
00706L,期元大S＆P日圓正2,10,0,10,元大-蘆洲,2023-10-12,9857
9924,福興,10,0,10,元大-蘆洲,2023-10-12,9857
00712,復華富時不動產,12,2,10,元大-蘆洲,2023-10-12,9857
00888,永豐台灣ESG,10,0,10,元大-蘆洲,2023-10-12,9857
6160,欣技,20,10,10,元大-蘆洲,2023-10-12,9857
2385,群光,10,0,10,元大-蘆洲,2023-10-12,9857
2365,昆盈,10,1,9,元大-蘆洲,2023-10-12,9857
2104,國際中橡,9,0,9,元大-蘆洲,2023-10-12,9857
3231,緯創,257,81,176,元大-蘆洲,2023-10-13,9857
00878,國泰永續高股息,283,138,145,元大-蘆洲,2023-10-13,9857
2382,廣達,161,57,104,元大-蘆洲,2023-10-13,9857
00637L,元大滬深300正2,79,0,79,元大-蘆洲,2023-10-13,9857
00712,復華富時不動產,77,10,67,元大-蘆洲,2023-10-13,9857
3236,千如,65,0,65,元大-蘆洲,2023-10-13,9857
00919,群益台灣精選高息,63,0,63,元大-蘆洲,2023-10-13,9857
00929,復華台灣科技優息,69,8,61,元大-蘆洲,2023-10-13,9857
0056,元大高股息,76,16,60,元大-蘆洲,2023-10-13,9857
00680L,元大美債20正2,55,0,55,元大-蘆洲,2023-10-13,9857
3694,海華,53,0,53,元大-蘆洲,2023-10-13,9857
2409,友達,52,7,45,元大-蘆洲,2023-10-13,9857
3078,僑威,74,32,42,元大-蘆洲,2023-10-13,9857
4977,眾達-KY,42,2,40,元大-蘆洲,2023-10-13,9857
2301,光寶科,55,16,39,元大-蘆洲,2023-10-13,9857
2359,所羅門,46,8,38,元大-蘆洲,2023-10-13,9857
2641,正德,38,2,36,元大-蘆洲,2023-10-13,9857
2313,華通,50,15,35,元大-蘆洲,2023-10-13,9857
6712,長聖,36,2,34,元大-蘆洲,2023-10-13,9857
2324,仁寶,51,17,34,元大-蘆洲,2023-10-13,9857
1905,華紙,40,10,30,元大-蘆洲,2023-10-13,9857
3037,欣興,34,4,30,元大-蘆洲,2023-10-13,9857
3325,旭品,38,8,30,元大-蘆洲,2023-10-13,9857
9105,泰金寶-DR,25,0,25,元大-蘆洲,2023-10-13,9857
2881,富邦金,25,1,24,元大-蘆洲,2023-10-13,9857
6719,力智,30,6,24,元大-蘆洲,2023-10-13,9857
2329,華泰,45,22,23,元大-蘆洲,2023-10-13,9857
00922,國泰台灣領袖50,23,0,23,元大-蘆洲,2023-10-13,9857
8076,伍豐,25,2,23,元大-蘆洲,2023-10-13,9857
2353,宏��,23,0,23,元大-蘆洲,2023-10-13,9857
00772B,中信高評級公司債,22,0,22,元大-蘆洲,2023-10-13,9857
2610,華航,25,3,22,元大-蘆洲,2023-10-13,9857
2376,技嘉,70,48,22,元大-蘆洲,2023-10-13,9857
00751B,元大AAA至A公司債,21,0,21,元大-蘆洲,2023-10-13,9857
2308,台達電,22,1,21,元大-蘆洲,2023-10-13,9857
00720B,元大投資級公司債,23,2,21,元大-蘆洲,2023-10-13,9857
2618,長榮航,21,1,20,元大-蘆洲,2023-10-13,9857
3703,欣陸,20,0,20,元大-蘆洲,2023-10-13,9857
00688L,國泰20年美債正2,24,5,19,元大-蘆洲,2023-10-13,9857
00905,FT臺灣Smart,19,0,19,元大-蘆洲,2023-10-13,9857
3706,神達,47,29,18,元大-蘆洲,2023-10-13,9857
2014,中鴻,21,4,17,元大-蘆洲,2023-10-13,9857
2323,中環,18,2,16,元大-蘆洲,2023-10-13,9857
6160,欣技,15,0,15,元大-蘆洲,2023-10-13,9857
3264,欣銓,17,2,15,元大-蘆洲,2023-10-13,9857
2516,新建,18,4,14,元大-蘆洲,2023-10-13,9857
2427,三商電,17,3,14,元大-蘆洲,2023-10-13,9857
6112,邁達特,30,16,14,元大-蘆洲,2023-10-13,9857
2886,兆豐金,18,4,14,元大-蘆洲,2023-10-13,9857
00665L,富邦�琤肭磪囓�2,15,2,13,元大-蘆洲,2023-10-13,9857
00929,復華台灣科技優息,340,27,313,元大-蘆洲,2023-10-16,9857
0056,元大高股息,216,4,212,元大-蘆洲,2023-10-16,9857
1314,中石化,712,519,193,元大-蘆洲,2023-10-16,9857
2618,長榮航,155,19,136,元大-蘆洲,2023-10-16,9857
2344,華邦電,136,7,129,元大-蘆洲,2023-10-16,9857
00673R,期元大S＆P原油反1,143,20,123,元大-蘆洲,2023-10-16,9857
00712,復華富時不動產,95,0,95,元大-蘆洲,2023-10-16,9857
1605,華新,92,14,78,元大-蘆洲,2023-10-16,9857
4919,新唐,70,6,64,元大-蘆洲,2023-10-16,9857
3122,笙泉,64,1,63,元大-蘆洲,2023-10-16,9857
2515,中工,191,130,61,元大-蘆洲,2023-10-16,9857
3231,緯創,113,53,60,元大-蘆洲,2023-10-16,9857
00919,群益台灣精選高息,65,20,45,元大-蘆洲,2023-10-16,9857
00679B,元大美債20年,42,1,41,元大-蘆洲,2023-10-16,9857
3694,海華,45,5,40,元大-蘆洲,2023-10-16,9857
00719B,元大美債1-3,40,0,40,元大-蘆洲,2023-10-16,9857
2324,仁寶,60,23,37,元大-蘆洲,2023-10-16,9857
00637L,元大滬深300正2,35,0,35,元大-蘆洲,2023-10-16,9857
2610,華航,57,26,31,元大-蘆洲,2023-10-16,9857
6276,安鈦克,39,9,30,元大-蘆洲,2023-10-16,9857
2884,玉山金,30,3,27,元大-蘆洲,2023-10-16,9857
2002,中鋼,26,0,26,元大-蘆洲,2023-10-16,9857
5347,世界,25,0,25,元大-蘆洲,2023-10-16,9857
1524,耿鼎,36,11,25,元大-蘆洲,2023-10-16,9857
9904,寶成,25,0,25,元大-蘆洲,2023-10-16,9857
3715,定穎投控,64,40,24,元大-蘆洲,2023-10-16,9857
3037,欣興,38,14,24,元大-蘆洲,2023-10-16,9857
00922,國泰台灣領袖50,37,15,22,元大-蘆洲,2023-10-16,9857
2201,裕隆,60,38,22,元大-蘆洲,2023-10-16,9857
5215,科嘉-KY,31,11,20,元大-蘆洲,2023-10-16,9857
6244,茂迪,36,16,20,元大-蘆洲,2023-10-16,9857
6770,力積電,28,9,19,元大-蘆洲,2023-10-16,9857
4908,前鼎,85,66,19,元大-蘆洲,2023-10-16,9857
2359,所羅門,18,0,18,元大-蘆洲,2023-10-16,9857
2421,建準,25,7,18,元大-蘆洲,2023-10-16,9857
3363,上詮,42,25,17,元大-蘆洲,2023-10-16,9857
6158,禾昌,17,1,16,元大-蘆洲,2023-10-16,9857
2206,三陽工業,15,0,15,元大-蘆洲,2023-10-16,9857
6625,必應,23,8,15,元大-蘆洲,2023-10-16,9857
020039,元大加權N,15,0,15,元大-蘆洲,2023-10-16,9857
1723,中碳,15,0,15,元大-蘆洲,2023-10-16,9857
2897,王道銀行,15,0,15,元大-蘆洲,2023-10-16,9857
00720B,元大投資級公司債,15,0,15,元大-蘆洲,2023-10-16,9857
00751B,元大AAA至A公司債,15,0,15,元大-蘆洲,2023-10-16,9857
2486,一詮,79,66,13,元大-蘆洲,2023-10-16,9857
6531,愛普*,19,5,14,元大-蘆洲,2023-10-16,9857
2641,正德,13,0,13,元大-蘆洲,2023-10-16,9857
1618,合機,14,1,13,元大-蘆洲,2023-10-16,9857
2609,陽明,19,7,12,元大-蘆洲,2023-10-16,9857
2409,友達,22,10,12,元大-蘆洲,2023-10-16,9857
0056,元大高股息,239,55,184,元大-蘆洲,2023-10-17,9857
00929,復華台灣科技優息,173,6,167,元大-蘆洲,2023-10-17,9857
00687B,國泰20年美債,139,0,139,元大-蘆洲,2023-10-17,9857
00931B,統一美債20年,127,1,126,元大-蘆洲,2023-10-17,9857
00679B,元大美債20年,88,0,88,元大-蘆洲,2023-10-17,9857
2489,瑞軒,85,0,85,元大-蘆洲,2023-10-17,9857
3231,緯創,275,192,83,元大-蘆洲,2023-10-17,9857
3576,聯合再生,142,72,70,元大-蘆洲,2023-10-17,9857
2618,長榮航,129,59,70,元大-蘆洲,2023-10-17,9857
00637L,元大滬深300正2,62,0,62,元大-蘆洲,2023-10-17,9857
2331,精英,49,0,49,元大-蘆洲,2023-10-17,9857
1723,中碳,40,0,40,元大-蘆洲,2023-10-17,9857
00720B,元大投資級公司債,39,0,39,元大-蘆洲,2023-10-17,9857
2610,華航,43,12,31,元大-蘆洲,2023-10-17,9857
00900,富邦特選高股息30,30,0,30,元大-蘆洲,2023-10-17,9857
6695,芯鼎,30,2,28,元大-蘆洲,2023-10-17,9857
2352,佳世達,30,4,26,元大-蘆洲,2023-10-17,9857
3715,定穎投控,86,61,25,元大-蘆洲,2023-10-17,9857
00632R,元大台灣50反1,25,0,25,元大-蘆洲,2023-10-17,9857
2316,楠梓電,22,0,22,元大-蘆洲,2023-10-17,9857
1608,華榮,21,0,21,元大-蘆洲,2023-10-17,9857
8054,安國,29,8,21,元大-蘆洲,2023-10-17,9857
1609,大亞,29,8,21,元大-蘆洲,2023-10-17,9857
00719B,元大美債1-3,22,1,21,元大-蘆洲,2023-10-17,9857
2891,中信金,24,4,20,元大-蘆洲,2023-10-17,9857
6116,彩晶,20,0,20,元大-蘆洲,2023-10-17,9857
3694,海華,20,0,20,元大-蘆洲,2023-10-17,9857
2436,偉詮電,31,11,20,元大-蘆洲,2023-10-17,9857
2002,中鋼,34,15,19,元大-蘆洲,2023-10-17,9857
00715L,期街口布蘭特正2,19,0,19,元大-蘆洲,2023-10-17,9857
020039,元大加權N,18,0,18,元大-蘆洲,2023-10-17,9857
3276,宇環,22,5,17,元大-蘆洲,2023-10-17,9857
1471,首利,38,21,17,元大-蘆洲,2023-10-17,9857
00751B,元大AAA至A公司債,21,5,16,元大-蘆洲,2023-10-17,9857
4919,新唐,18,2,16,元大-蘆洲,2023-10-17,9857
6530,創威,36,20,16,元大-蘆洲,2023-10-17,9857
2465,麗臺,23,8,15,元大-蘆洲,2023-10-17,9857
00922,國泰台灣領袖50,15,0,15,元大-蘆洲,2023-10-17,9857
4908,前鼎,38,23,15,元大-蘆洲,2023-10-17,9857
1217,愛之味,15,0,15,元大-蘆洲,2023-10-17,9857
4933,友輝,16,1,15,元大-蘆洲,2023-10-17,9857
2367,燿華,18,4,14,元大-蘆洲,2023-10-17,9857
2881,富邦金,14,0,14,元大-蘆洲,2023-10-17,9857
1568,倉佑,14,0,14,元大-蘆洲,2023-10-17,9857
9904,寶成,14,0,14,元大-蘆洲,2023-10-17,9857
6104,創惟,14,0,14,元大-蘆洲,2023-10-17,9857
6122,擎邦,14,0,14,元大-蘆洲,2023-10-17,9857
6257,矽格,21,8,13,元大-蘆洲,2023-10-17,9857
2888,新光金,22,8,14,元大-蘆洲,2023-10-17,9857
1513,中興電,15,2,13,元大-蘆洲,2023-10-17,9857
0056,元大高股息,433,41,392,元大-蘆洲,2023-10-18,9857
00929,復華台灣科技優息,242,20,222,元大-蘆洲,2023-10-18,9857
00919,群益台灣精選高息,157,34,123,元大-蘆洲,2023-10-18,9857
00922,國泰台灣領袖50,119,10,109,元大-蘆洲,2023-10-18,9857
4908,前鼎,132,55,77,元大-蘆洲,2023-10-18,9857
2883,凱基金,68,1,67,元大-蘆洲,2023-10-18,9857
1101,台泥,66,1,65,元大-蘆洲,2023-10-18,9857
00687B,國泰20年美債,66,2,64,元大-蘆洲,2023-10-18,9857
2382,廣達,107,47,60,元大-蘆洲,2023-10-18,9857
2618,長榮航,80,29,51,元大-蘆洲,2023-10-18,9857
2436,偉詮電,74,25,49,元大-蘆洲,2023-10-18,9857
4919,新唐,66,20,46,元大-蘆洲,2023-10-18,9857
2609,陽明,49,7,42,元大-蘆洲,2023-10-18,9857
2002,中鋼,45,4,41,元大-蘆洲,2023-10-18,9857
3037,欣興,49,9,40,元大-蘆洲,2023-10-18,9857
00673R,期元大S＆P原油反1,40,0,40,元大-蘆洲,2023-10-18,9857
1471,首利,92,53,39,元大-蘆洲,2023-10-18,9857
2201,裕隆,60,21,39,元大-蘆洲,2023-10-18,9857
3481,群創,50,12,38,元大-蘆洲,2023-10-18,9857
2344,華邦電,40,3,37,元大-蘆洲,2023-10-18,9857
00679B,元大美債20年,37,1,36,元大-蘆洲,2023-10-18,9857
00751B,元大AAA至A公司債,35,0,35,元大-蘆洲,2023-10-18,9857
2409,友達,40,5,35,元大-蘆洲,2023-10-18,9857
3706,神達,42,9,33,元大-蘆洲,2023-10-18,9857
1605,華新,38,6,32,元大-蘆洲,2023-10-18,9857
00932,兆豐永續高息等權,32,0,32,元大-蘆洲,2023-10-18,9857
6770,力積電,32,1,31,元大-蘆洲,2023-10-18,9857
3260,威剛,61,32,29,元大-蘆洲,2023-10-18,9857
6237,驊訊,44,16,28,元大-蘆洲,2023-10-18,9857
2388,威盛,94,66,28,元大-蘆洲,2023-10-18,9857
00712,復華富時不動產,29,2,27,元大-蘆洲,2023-10-18,9857
2376,技嘉,43,16,27,元大-蘆洲,2023-10-18,9857
1304,台聚,27,1,26,元大-蘆洲,2023-10-18,9857
1815,富喬,88,63,25,元大-蘆洲,2023-10-18,9857
2313,華通,33,8,25,元大-蘆洲,2023-10-18,9857
2495,普安,22,1,21,元大-蘆洲,2023-10-18,9857
6625,必應,27,6,21,元大-蘆洲,2023-10-18,9857
2915,潤泰全,20,0,20,元大-蘆洲,2023-10-18,9857
3588,通嘉,47,27,20,元大-蘆洲,2023-10-18,9857
1608,華榮,21,1,20,元大-蘆洲,2023-10-18,9857
6233,旺玖,31,11,20,元大-蘆洲,2023-10-18,9857
00888,永豐台灣ESG,19,0,19,元大-蘆洲,2023-10-18,9857
5381,合正,19,0,19,元大-蘆洲,2023-10-18,9857
2610,華航,36,18,18,元大-蘆洲,2023-10-18,9857
2887,台新金,18,0,18,元大-蘆洲,2023-10-18,9857
2330,台積電,20,2,18,元大-蘆洲,2023-10-18,9857
2748,雲品,17,0,17,元大-蘆洲,2023-10-18,9857
00720B,元大投資級公司債,17,0,17,元大-蘆洲,2023-10-18,9857
00719B,元大美債1-3,16,0,16,元大-蘆洲,2023-10-18,9857
3078,僑威,23,7,16,元大-蘆洲,2023-10-18,9857
0056,元大高股息,319,6,313,元大-蘆洲,2023-10-19,9857
00931B,統一美債20年,228,0,228,元大-蘆洲,2023-10-19,9857
00929,復華台灣科技優息,234,7,227,元大-蘆洲,2023-10-19,9857
00719B,元大美債1-3,152,0,152,元大-蘆洲,2023-10-19,9857
5880,合庫金,136,0,136,元大-蘆洲,2023-10-19,9857
00720B,元大投資級公司債,134,20,114,元大-蘆洲,2023-10-19,9857
00679B,元大美債20年,95,1,94,元大-蘆洲,2023-10-19,9857
3025,星通,115,23,92,元大-蘆洲,2023-10-19,9857
00933B,國泰10Y+金融債,98,10,88,元大-蘆洲,2023-10-19,9857
00878,國泰永續高股息,123,35,88,元大-蘆洲,2023-10-19,9857
00637L,元大滬深300正2,122,41,81,元大-蘆洲,2023-10-19,9857
1101,台泥,82,4,78,元大-蘆洲,2023-10-19,9857
00751B,元大AAA至A公司債,76,0,76,元大-蘆洲,2023-10-19,9857
00902,中信電池及儲能,72,1,71,元大-蘆洲,2023-10-19,9857
2344,華邦電,61,8,53,元大-蘆洲,2023-10-19,9857
00687B,國泰20年美債,47,0,47,元大-蘆洲,2023-10-19,9857
5469,瀚宇博,45,0,45,元大-蘆洲,2023-10-19,9857
2317,鴻海,46,2,44,元大-蘆洲,2023-10-19,9857
00922,國泰台灣領袖50,42,0,42,元大-蘆洲,2023-10-19,9857
00712,復華富時不動產,43,5,38,元大-蘆洲,2023-10-19,9857
1815,富喬,63,26,37,元大-蘆洲,2023-10-19,9857
3715,定穎投控,203,167,36,元大-蘆洲,2023-10-19,9857
00680L,元大美債20正2,35,0,35,元大-蘆洲,2023-10-19,9857
00893,國泰智能電動車,34,1,33,元大-蘆洲,2023-10-19,9857
2610,華航,60,27,33,元大-蘆洲,2023-10-19,9857
9945,潤泰新,33,0,33,元大-蘆洲,2023-10-19,9857
2363,矽統,58,26,32,元大-蘆洲,2023-10-19,9857
00665L,富邦�琤肭磪囓�2,36,6,30,元大-蘆洲,2023-10-19,9857
2486,一詮,43,15,28,元大-蘆洲,2023-10-19,9857
2634,漢翔,28,0,28,元大-蘆洲,2023-10-19,9857
3006,晶豪科,33,7,26,元大-蘆洲,2023-10-19,9857
00715L,期街口布蘭特正2,25,0,25,元大-蘆洲,2023-10-19,9857
1605,華新,28,3,25,元大-蘆洲,2023-10-19,9857
00919,群益台灣精選高息,24,2,22,元大-蘆洲,2023-10-19,9857
3305,昇貿,22,0,22,元大-蘆洲,2023-10-19,9857
00932,兆豐永續高息等權,20,0,20,元大-蘆洲,2023-10-19,9857
2883,凱基金,33,14,19,元大-蘆洲,2023-10-19,9857
3481,群創,40,21,19,元大-蘆洲,2023-10-19,9857
8227,巨有科技,18,0,18,元大-蘆洲,2023-10-19,9857
00722B,群益投資級電信債,17,0,17,元大-蘆洲,2023-10-19,9857
2356,英業達,75,58,17,元大-蘆洲,2023-10-19,9857
2402,毅嘉,30,13,17,元大-蘆洲,2023-10-19,9857
6426,統新,16,0,16,元大-蘆洲,2023-10-19,9857
1471,首利,62,46,16,元大-蘆洲,2023-10-19,9857
2031,新光鋼,15,0,15,元大-蘆洲,2023-10-19,9857
1608,華榮,15,0,15,元大-蘆洲,2023-10-19,9857
9946,三發地產,15,0,15,元大-蘆洲,2023-10-19,9857
2409,友達,22,7,15,元大-蘆洲,2023-10-19,9857
9907,統一實,14,0,14,元大-蘆洲,2023-10-19,9857
00753L,中信中國50正2,34,20,14,元大-蘆洲,2023-10-19,9857
6274,台燿,217,20,197,元大-蘆洲,2023-10-20,9857
00712,復華富時不動產,156,8,148,元大-蘆洲,2023-10-20,9857
2618,長榮航,162,24,138,元大-蘆洲,2023-10-20,9857
00929,復華台灣科技優息,188,58,130,元大-蘆洲,2023-10-20,9857
2356,英業達,148,34,114,元大-蘆洲,2023-10-20,9857
00673R,期元大S＆P原油反1,124,20,104,元大-蘆洲,2023-10-20,9857
00878,國泰永續高股息,242,149,93,元大-蘆洲,2023-10-20,9857
2002,中鋼,94,8,86,元大-蘆洲,2023-10-20,9857
1568,倉佑,112,38,74,元大-蘆洲,2023-10-20,9857
6116,彩晶,83,12,71,元大-蘆洲,2023-10-20,9857
3231,緯創,152,85,67,元大-蘆洲,2023-10-20,9857
1609,大亞,55,9,46,元大-蘆洲,2023-10-20,9857
0056,元大高股息,115,71,44,元大-蘆洲,2023-10-20,9857
2486,一詮,79,35,44,元大-蘆洲,2023-10-20,9857
00720B,元大投資級公司債,42,0,42,元大-蘆洲,2023-10-20,9857
3122,笙泉,113,75,38,元大-蘆洲,2023-10-20,9857
2834,臺企銀,38,2,36,元大-蘆洲,2023-10-20,9857
00679B,元大美債20年,41,7,34,元大-蘆洲,2023-10-20,9857
00687B,國泰20年美債,31,0,31,元大-蘆洲,2023-10-20,9857
2887,台新金,31,1,30,元大-蘆洲,2023-10-20,9857
2885,元大金,34,5,29,元大-蘆洲,2023-10-20,9857
1605,華新,27,2,25,元大-蘆洲,2023-10-20,9857
6494,九齊,25,0,25,元大-蘆洲,2023-10-20,9857
00919,群益台灣精選高息,33,8,25,元大-蘆洲,2023-10-20,9857
00637L,元大滬深300正2,49,25,24,元大-蘆洲,2023-10-20,9857
2515,中工,54,30,24,元大-蘆洲,2023-10-20,9857
6770,力積電,26,3,23,元大-蘆洲,2023-10-20,9857
2610,華航,26,5,21,元大-蘆洲,2023-10-20,9857
00715L,期街口布蘭特正2,36,15,21,元大-蘆洲,2023-10-20,9857
2317,鴻海,24,4,20,元大-蘆洲,2023-10-20,9857
3704,合勤控,35,15,20,元大-蘆洲,2023-10-20,9857
3062,建漢,20,0,20,元大-蘆洲,2023-10-20,9857
3060,銘異,20,0,20,元大-蘆洲,2023-10-20,9857
2888,新光金,49,30,19,元大-蘆洲,2023-10-20,9857
8176,智捷,29,10,19,元大-蘆洲,2023-10-20,9857
4908,前鼎,36,18,18,元大-蘆洲,2023-10-20,9857
3694,海華,27,9,18,元大-蘆洲,2023-10-20,9857
00772B,中信高評級公司債,17,0,17,元大-蘆洲,2023-10-20,9857
1471,首利,38,21,17,元大-蘆洲,2023-10-20,9857
2363,矽統,41,25,16,元大-蘆洲,2023-10-20,9857
00680L,元大美債20正2,26,10,16,元大-蘆洲,2023-10-20,9857
1608,華榮,17,1,16,元大-蘆洲,2023-10-20,9857
8069,元太,17,2,15,元大-蘆洲,2023-10-20,9857
00882,中信中國高股息,25,10,15,元大-蘆洲,2023-10-20,9857
2388,威盛,50,36,14,元大-蘆洲,2023-10-20,9857
00922,國泰台灣領袖50,15,1,14,元大-蘆洲,2023-10-20,9857
6005,群益證,14,0,14,元大-蘆洲,2023-10-20,9857
2324,仁寶,18,4,14,元大-蘆洲,2023-10-20,9857
6530,創威,36,23,13,元大-蘆洲,2023-10-20,9857
3032,偉訓,14,1,13,元大-蘆洲,2023-10-20,9857
00712,復華富時不動產,156,8,148,元大-蘆洲,2023-10-23,9857
6274,台燿,131,10,121,元大-蘆洲,2023-10-23,9857
00919,群益台灣精選高息,121,2,119,元大-蘆洲,2023-10-23,9857
5880,合庫金,114,0,114,元大-蘆洲,2023-10-23,9857
00637L,元大滬深300正2,170,62,108,元大-蘆洲,2023-10-23,9857
00931B,統一美債20年,108,1,107,元大-蘆洲,2023-10-23,9857
2317,鴻海,163,70,93,元大-蘆洲,2023-10-23,9857
2609,陽明,88,0,88,元大-蘆洲,2023-10-23,9857
4401,東隆興,51,3,48,元大-蘆洲,2023-10-23,9857
00751B,元大AAA至A公司債,47,2,45,元大-蘆洲,2023-10-23,9857
2409,友達,53,12,41,元大-蘆洲,2023-10-23,9857
2399,映泰,51,16,35,元大-蘆洲,2023-10-23,9857
8069,元太,35,1,34,元大-蘆洲,2023-10-23,9857
6770,力積電,32,1,31,元大-蘆洲,2023-10-23,9857
2330,台積電,31,2,29,元大-蘆洲,2023-10-23,9857
00922,國泰台灣領袖50,30,0,30,元大-蘆洲,2023-10-23,9857
3041,揚智,193,164,29,元大-蘆洲,2023-10-23,9857
00720B,元大投資級公司債,38,11,27,元大-蘆洲,2023-10-23,9857
00882,中信中國高股息,26,0,26,元大-蘆洲,2023-10-23,9857
2596,綠意,24,0,24,元大-蘆洲,2023-10-23,9857
00878,國泰永續高股息,151,130,21,元大-蘆洲,2023-10-23,9857
2402,毅嘉,163,142,21,元大-蘆洲,2023-10-23,9857
2515,中工,70,49,21,元大-蘆洲,2023-10-23,9857
020039,元大加權N,18,0,18,元大-蘆洲,2023-10-23,9857
3481,群創,24,7,17,元大-蘆洲,2023-10-23,9857
00687B,國泰20年美債,23,5,18,元大-蘆洲,2023-10-23,9857
6276,安鈦克,21,5,16,元大-蘆洲,2023-10-23,9857
4714,永捷,15,0,15,元大-蘆洲,2023-10-23,9857
2887,台新金,15,0,15,元大-蘆洲,2023-10-23,9857
00772B,中信高評級公司債,14,0,14,元大-蘆洲,2023-10-23,9857
5871,中租-KY,14,0,14,元大-蘆洲,2023-10-23,9857
00665L,富邦�琤肭磪囓�2,14,0,14,元大-蘆洲,2023-10-23,9857
00933B,國泰10Y+金融債,14,0,14,元大-蘆洲,2023-10-23,9857
2886,兆豐金,14,0,14,元大-蘆洲,2023-10-23,9857
2002,中鋼,23,9,14,元大-蘆洲,2023-10-23,9857
2201,裕隆,26,13,13,元大-蘆洲,2023-10-23,9857
00907,永豐優息存股,13,0,13,元大-蘆洲,2023-10-23,9857
00900,富邦特選高股息30,13,1,12,元大-蘆洲,2023-10-23,9857
8916,光隆,12,0,12,元大-蘆洲,2023-10-23,9857
3025,星通,25,13,12,元大-蘆洲,2023-10-23,9857
3324,雙鴻,19,7,12,元大-蘆洲,2023-10-23,9857
3029,零壹,12,0,12,元大-蘆洲,2023-10-23,9857
1504,東元,27,16,11,元大-蘆洲,2023-10-23,9857
6282,康舒,11,0,11,元大-蘆洲,2023-10-23,9857
2605,新興,18,7,11,元大-蘆洲,2023-10-23,9857
2324,仁寶,12,1,11,元大-蘆洲,2023-10-23,9857
00892,富邦台灣半導體,11,0,11,元大-蘆洲,2023-10-23,9857
3260,威剛,19,8,11,元大-蘆洲,2023-10-23,9857
2885,元大金,13,2,11,元大-蘆洲,2023-10-23,9857
2357,華碩,11,1,10,元大-蘆洲,2023-10-23,9857
2405,輔信,201,21,180,元大-蘆洲,2023-10-24,9857
00712,復華富時不動產,161,0,161,元大-蘆洲,2023-10-24,9857
00929,復華台灣科技優息,170,24,146,元大-蘆洲,2023-10-24,9857
2317,鴻海,157,42,115,元大-蘆洲,2023-10-24,9857
6274,台燿,109,13,96,元大-蘆洲,2023-10-24,9857
0056,元大高股息,92,29,63,元大-蘆洲,2023-10-24,9857
00680L,元大美債20正2,60,3,57,元大-蘆洲,2023-10-24,9857
6168,宏齊,110,60,50,元大-蘆洲,2023-10-24,9857
00893,國泰智能電動車,50,1,49,元大-蘆洲,2023-10-24,9857
00772B,中信高評級公司債,44,0,44,元大-蘆洲,2023-10-24,9857
1324,地球,64,20,44,元大-蘆洲,2023-10-24,9857
00919,群益台灣精選高息,57,14,43,元大-蘆洲,2023-10-24,9857
2369,菱生,164,123,41,元大-蘆洲,2023-10-24,9857
4960,誠美材,59,19,40,元大-蘆洲,2023-10-24,9857
2356,英業達,70,36,34,元大-蘆洲,2023-10-24,9857
2303,聯電,102,69,33,元大-蘆洲,2023-10-24,9857
3260,威剛,48,18,30,元大-蘆洲,2023-10-24,9857
2002,中鋼,31,3,28,元大-蘆洲,2023-10-24,9857
2883,凱基金,29,3,26,元大-蘆洲,2023-10-24,9857
4979,華星光,63,37,26,元大-蘆洲,2023-10-24,9857
2882,國泰金,24,0,24,元大-蘆洲,2023-10-24,9857
00715L,期街口布蘭特正2,24,0,24,元大-蘆洲,2023-10-24,9857
00713,元大台灣高息低波,23,0,23,元大-蘆洲,2023-10-24,9857
6695,芯鼎,36,14,22,元大-蘆洲,2023-10-24,9857
2890,永豐金,22,1,21,元大-蘆洲,2023-10-24,9857
2892,第一金,22,1,21,元大-蘆洲,2023-10-24,9857
4743,合一,23,3,20,元大-蘆洲,2023-10-24,9857
6185,幃翔,20,0,20,元大-蘆洲,2023-10-24,9857
00687B,國泰20年美債,20,1,19,元大-蘆洲,2023-10-24,9857
2382,廣達,96,78,18,元大-蘆洲,2023-10-24,9857
00632R,元大台灣50反1,50,33,17,元大-蘆洲,2023-10-24,9857
00637L,元大滬深300正2,250,234,16,元大-蘆洲,2023-10-24,9857
2201,裕隆,23,7,16,元大-蘆洲,2023-10-24,9857
1314,中石化,46,30,16,元大-蘆洲,2023-10-24,9857
2332,友訊,20,5,15,元大-蘆洲,2023-10-24,9857
1101,台泥,15,1,14,元大-蘆洲,2023-10-24,9857
1471,首利,14,0,14,元大-蘆洲,2023-10-24,9857
1301,台塑,14,0,14,元大-蘆洲,2023-10-24,9857
2834,臺企銀,13,0,13,元大-蘆洲,2023-10-24,9857
3481,群創,47,34,13,元大-蘆洲,2023-10-24,9857
3122,笙泉,77,64,13,元大-蘆洲,2023-10-24,9857
2425,承啟,13,0,13,元大-蘆洲,2023-10-24,9857
3051,力特,57,44,13,元大-蘆洲,2023-10-24,9857
00665L,富邦�琤肭磪囓�2,15,3,12,元大-蘆洲,2023-10-24,9857
3029,零壹,12,0,12,元大-蘆洲,2023-10-24,9857
1303,南亞,12,0,12,元大-蘆洲,2023-10-24,9857
6176,瑞儀,13,2,11,元大-蘆洲,2023-10-24,9857
3035,智原,34,23,11,元大-蘆洲,2023-10-24,9857
4526,東台,11,0,11,元大-蘆洲,2023-10-24,9857
2607,榮運,12,1,11,元大-蘆洲,2023-10-24,9857
00929,復華台灣科技優息,106,14,92,元大-蘆洲,2023-10-25,9857
3122,笙泉,97,26,71,元大-蘆洲,2023-10-25,9857
1524,耿鼎,262,195,67,元大-蘆洲,2023-10-25,9857
6116,彩晶,109,43,66,元大-蘆洲,2023-10-25,9857
2317,鴻海,79,14,65,元大-蘆洲,2023-10-25,9857
00712,復華富時不動產,60,5,55,元大-蘆洲,2023-10-25,9857
2892,第一金,52,0,52,元大-蘆洲,2023-10-25,9857
00919,群益台灣精選高息,47,5,42,元大-蘆洲,2023-10-25,9857
2376,技嘉,50,11,39,元大-蘆洲,2023-10-25,9857
00687B,國泰20年美債,39,2,37,元大-蘆洲,2023-10-25,9857
00922,國泰台灣領袖50,35,3,32,元大-蘆洲,2023-10-25,9857
4979,華星光,46,14,32,元大-蘆洲,2023-10-25,9857
2886,兆豐金,35,4,31,元大-蘆洲,2023-10-25,9857
00715L,期街口布蘭特正2,30,0,30,元大-蘆洲,2023-10-25,9857
8358,金居,31,2,29,元大-蘆洲,2023-10-25,9857
3025,星通,60,33,27,元大-蘆洲,2023-10-25,9857
2485,兆赫,33,7,26,元大-蘆洲,2023-10-25,9857
2344,華邦電,27,4,23,元大-蘆洲,2023-10-25,9857
00933B,國泰10Y+金融債,22,0,22,元大-蘆洲,2023-10-25,9857
6138,茂達,26,4,22,元大-蘆洲,2023-10-25,9857
3037,欣興,39,18,21,元大-蘆洲,2023-10-25,9857
2637,慧洋-KY,20,0,20,元大-蘆洲,2023-10-25,9857
6226,光鼎,20,0,20,元大-蘆洲,2023-10-25,9857
1710,東聯,20,0,20,元大-蘆洲,2023-10-25,9857
4960,誠美材,41,22,19,元大-蘆洲,2023-10-25,9857
2301,光寶科,26,8,18,元大-蘆洲,2023-10-25,9857
1101,台泥,19,4,15,元大-蘆洲,2023-10-25,9857
4123,晟德,14,0,14,元大-蘆洲,2023-10-25,9857
2630,亞航,16,2,14,元大-蘆洲,2023-10-25,9857
2888,新光金,14,0,14,元大-蘆洲,2023-10-25,9857
00720B,元大投資級公司債,16,2,14,元大-蘆洲,2023-10-25,9857
2610,華航,16,3,13,元大-蘆洲,2023-10-25,9857
9105,泰金寶-DR,80,67,13,元大-蘆洲,2023-10-25,9857
8040,九暘,21,8,13,元大-蘆洲,2023-10-25,9857
2337,旺宏,42,30,12,元大-蘆洲,2023-10-25,9857
2618,長榮航,26,14,12,元大-蘆洲,2023-10-25,9857
2515,中工,37,25,12,元大-蘆洲,2023-10-25,9857
00772B,中信高評級公司債,12,0,12,元大-蘆洲,2023-10-25,9857
6114,久威,14,2,12,元大-蘆洲,2023-10-25,9857
5302,太欣,11,0,11,元大-蘆洲,2023-10-25,9857
2462,良得電,12,1,11,元大-蘆洲,2023-10-25,9857
5381,合正,29,19,10,元大-蘆洲,2023-10-25,9857
3202,樺晟,10,0,10,元大-蘆洲,2023-10-25,9857
00632R,元大台灣50反1,16,6,10,元大-蘆洲,2023-10-25,9857
6125,廣運,13,3,10,元大-蘆洲,2023-10-25,9857
3481,群創,43,34,9,元大-蘆洲,2023-10-25,9857
2449,京元電子,12,3,9,元大-蘆洲,2023-10-25,9857
6197,佳必琪,38,29,9,元大-蘆洲,2023-10-25,9857
3022,威強電,9,0,9,元大-蘆洲,2023-10-25,9857
4968,立積,9,0,9,元大-蘆洲,2023-10-25,9857
00929,復華台灣科技優息,425,115,310,元大-蘆洲,2023-10-26,9857
00885,富邦越南,293,0,293,元大-蘆洲,2023-10-26,9857
0056,元大高股息,191,12,179,元大-蘆洲,2023-10-26,9857
00712,復華富時不動產,149,12,137,元大-蘆洲,2023-10-26,9857
2344,華邦電,123,0,123,元大-蘆洲,2023-10-26,9857
00931B,統一美債20年,123,0,123,元大-蘆洲,2023-10-26,9857
2303,聯電,143,38,105,元大-蘆洲,2023-10-26,9857
00919,群益台灣精選高息,109,13,96,元大-蘆洲,2023-10-26,9857
00922,國泰台灣領袖50,71,0,71,元大-蘆洲,2023-10-26,9857
00878,國泰永續高股息,99,33,66,元大-蘆洲,2023-10-26,9857
9105,泰金寶-DR,64,5,59,元大-蘆洲,2023-10-26,9857
00676R,富邦臺灣加權反1,50,0,50,元大-蘆洲,2023-10-26,9857
3037,欣興,64,18,46,元大-蘆洲,2023-10-26,9857
1605,華新,45,3,42,元大-蘆洲,2023-10-26,9857
3363,上詮,56,17,39,元大-蘆洲,2023-10-26,9857
2515,中工,43,5,38,元大-蘆洲,2023-10-26,9857
0050,元大台灣50,39,1,38,元大-蘆洲,2023-10-26,9857
2884,玉山金,34,0,34,元大-蘆洲,2023-10-26,9857
2883,凱基金,53,20,33,元大-蘆洲,2023-10-26,9857
6116,彩晶,39,7,32,元大-蘆洲,2023-10-26,9857
2465,麗臺,33,3,30,元大-蘆洲,2023-10-26,9857
2002,中鋼,36,7,29,元大-蘆洲,2023-10-26,9857
2313,華通,29,1,28,元大-蘆洲,2023-10-26,9857
1609,大亞,32,4,28,元大-蘆洲,2023-10-26,9857
6243,迅杰,52,24,28,元大-蘆洲,2023-10-26,9857
8358,金居,44,16,28,元大-蘆洲,2023-10-26,9857
3450,聯鈞,36,8,28,元大-蘆洲,2023-10-26,9857
6150,撼訊,40,13,27,元大-蘆洲,2023-10-26,9857
4960,誠美材,27,0,27,元大-蘆洲,2023-10-26,9857
2887,台新金,26,0,26,元大-蘆洲,2023-10-26,9857
6143,振曜,31,10,21,元大-蘆洲,2023-10-26,9857
2486,一詮,73,53,20,元大-蘆洲,2023-10-26,9857
2390,云辰,20,0,20,元大-蘆洲,2023-10-26,9857
00894,中信小資高價30,20,0,20,元大-蘆洲,2023-10-26,9857
6187,萬潤,20,0,20,元大-蘆洲,2023-10-26,9857
2337,旺宏,30,12,18,元大-蘆洲,2023-10-26,9857
00713,元大台灣高息低波,18,0,18,元大-蘆洲,2023-10-26,9857
8110,華東,35,18,17,元大-蘆洲,2023-10-26,9857
2892,第一金,17,0,17,元大-蘆洲,2023-10-26,9857
9945,潤泰新,17,0,17,元大-蘆洲,2023-10-26,9857
2201,裕隆,17,0,17,元大-蘆洲,2023-10-26,9857
3058,立德,19,2,17,元大-蘆洲,2023-10-26,9857
6213,聯茂,17,0,17,元大-蘆洲,2023-10-26,9857
2880,華南金,17,0,17,元大-蘆洲,2023-10-26,9857
6117,迎廣,62,46,16,元大-蘆洲,2023-10-26,9857
00631L,元大台灣50正2,16,0,16,元大-蘆洲,2023-10-26,9857
00891,中信關鍵半導體,16,0,16,元大-蘆洲,2023-10-26,9857
00892,富邦台灣半導體,15,0,15,元大-蘆洲,2023-10-26,9857
3714,富采,15,0,15,元大-蘆洲,2023-10-26,9857
6185,幃翔,15,0,15,元大-蘆洲,2023-10-26,9857
00885,富邦越南,318,0,318,元大-蘆洲,2023-10-27,9857
1815,富喬,146,32,114,元大-蘆洲,2023-10-27,9857
00712,復華富時不動產,102,1,101,元大-蘆洲,2023-10-27,9857
00929,復華台灣科技優息,163,87,76,元大-蘆洲,2023-10-27,9857
3122,笙泉,177,106,71,元大-蘆洲,2023-10-27,9857
2486,一詮,83,21,62,元大-蘆洲,2023-10-27,9857
2405,輔信,53,2,51,元大-蘆洲,2023-10-27,9857
00676R,富邦臺灣加權反1,50,0,50,元大-蘆洲,2023-10-27,9857
00919,群益台灣精選高息,44,1,43,元大-蘆洲,2023-10-27,9857
6116,彩晶,40,0,40,元大-蘆洲,2023-10-27,9857
00931B,統一美債20年,38,0,38,元大-蘆洲,2023-10-27,9857
2329,華泰,47,14,33,元大-蘆洲,2023-10-27,9857
0056,元大高股息,36,5,31,元大-蘆洲,2023-10-27,9857
2344,華邦電,30,0,30,元大-蘆洲,2023-10-27,9857
8105,凌巨,30,0,30,元大-蘆洲,2023-10-27,9857
3276,宇環,48,20,28,元大-蘆洲,2023-10-27,9857
6770,力積電,24,1,23,元大-蘆洲,2023-10-27,9857
2382,廣達,41,18,23,元大-蘆洲,2023-10-27,9857
6290,良維,29,6,23,元大-蘆洲,2023-10-27,9857
4133,亞諾法,25,2,23,元大-蘆洲,2023-10-27,9857
2317,鴻海,19,0,19,元大-蘆洲,2023-10-27,9857
6237,驊訊,40,21,19,元大-蘆洲,2023-10-27,9857
3037,欣興,32,14,18,元大-蘆洲,2023-10-27,9857
2388,威盛,47,29,18,元大-蘆洲,2023-10-27,9857
2201,裕隆,20,3,17,元大-蘆洲,2023-10-27,9857
1721,三晃,30,13,17,元大-蘆洲,2023-10-27,9857
2303,聯電,44,27,17,元大-蘆洲,2023-10-27,9857
3324,雙鴻,19,3,16,元大-蘆洲,2023-10-27,9857
00680L,元大美債20正2,20,4,16,元大-蘆洲,2023-10-27,9857
6472,保瑞,22,6,16,元大-蘆洲,2023-10-27,9857
8215,明基材,24,9,15,元大-蘆洲,2023-10-27,9857
2498,宏達電,17,2,15,元大-蘆洲,2023-10-27,9857
5460,同協,15,0,15,元大-蘆洲,2023-10-27,9857
5351,鈺創,15,0,15,元大-蘆洲,2023-10-27,9857
2887,台新金,13,0,13,元大-蘆洲,2023-10-27,9857
3257,虹冠電,14,1,13,元大-蘆洲,2023-10-27,9857
00697B,元大美債7-10,13,0,13,元大-蘆洲,2023-10-27,9857
2485,兆赫,17,4,13,元大-蘆洲,2023-10-27,9857
2641,正德,13,0,13,元大-蘆洲,2023-10-27,9857
2637,慧洋-KY,13,0,13,元大-蘆洲,2023-10-27,9857
3014,聯陽,15,3,12,元大-蘆洲,2023-10-27,9857
6789,采鈺,12,0,12,元大-蘆洲,2023-10-27,9857
6216,居易,22,10,12,元大-蘆洲,2023-10-27,9857
00888,永豐台灣ESG,12,0,12,元大-蘆洲,2023-10-27,9857
3006,晶豪科,15,3,12,元大-蘆洲,2023-10-27,9857
00878,國泰永續高股息,48,36,12,元大-蘆洲,2023-10-27,9857
2743,山富,11,0,11,元大-蘆洲,2023-10-27,9857
3044,健鼎,13,2,11,元大-蘆洲,2023-10-27,9857
6530,創威,14,3,11,元大-蘆洲,2023-10-27,9857
2206,三陽工業,11,1,10,元大-蘆洲,2023-10-27,9857
2317,鴻海,213,40,173,元大-蘆洲,2023-10-30,9857
9105,泰金寶-DR,141,12,129,元大-蘆洲,2023-10-30,9857
00712,復華富時不動產,137,8,129,元大-蘆洲,2023-10-30,9857
2390,云辰,84,7,77,元大-蘆洲,2023-10-30,9857
00676R,富邦臺灣加權反1,50,0,50,元大-蘆洲,2023-10-30,9857
00878,國泰永續高股息,61,15,46,元大-蘆洲,2023-10-30,9857
3231,緯創,105,62,43,元大-蘆洲,2023-10-30,9857
00929,復華台灣科技優息,78,35,43,元大-蘆洲,2023-10-30,9857
2885,元大金,43,1,42,元大-蘆洲,2023-10-30,9857
910861,神州-DR,41,0,41,元大-蘆洲,2023-10-30,9857
1314,中石化,46,8,38,元大-蘆洲,2023-10-30,9857
2883,凱基金,35,0,35,元大-蘆洲,2023-10-30,9857
2888,新光金,36,1,35,元大-蘆洲,2023-10-30,9857
5347,世界,34,0,34,元大-蘆洲,2023-10-30,9857
2887,台新金,34,3,31,元大-蘆洲,2023-10-30,9857
2485,兆赫,307,276,31,元大-蘆洲,2023-10-30,9857
6026,福邦證,30,0,30,元大-蘆洲,2023-10-30,9857
6117,迎廣,58,29,29,元大-蘆洲,2023-10-30,9857
8110,華東,30,6,24,元大-蘆洲,2023-10-30,9857
00679B,元大美債20年,24,0,24,元大-蘆洲,2023-10-30,9857
00637L,元大滬深300正2,143,120,23,元大-蘆洲,2023-10-30,9857
2465,麗臺,42,19,23,元大-蘆洲,2023-10-30,9857
2489,瑞軒,20,0,20,元大-蘆洲,2023-10-30,9857
8215,明基材,30,12,18,元大-蘆洲,2023-10-30,9857
00933B,國泰10Y+金融債,18,0,18,元大-蘆洲,2023-10-30,9857
2641,正德,20,2,18,元大-蘆洲,2023-10-30,9857
00687B,國泰20年美債,17,1,16,元大-蘆洲,2023-10-30,9857
6176,瑞儀,17,1,16,元大-蘆洲,2023-10-30,9857
2356,英業達,91,75,16,元大-蘆洲,2023-10-30,9857
6443,元晶,42,26,16,元大-蘆洲,2023-10-30,9857
00931B,統一美債20年,16,0,16,元大-蘆洲,2023-10-30,9857
1471,首利,23,8,15,元大-蘆洲,2023-10-30,9857
5516,雙喜,15,0,15,元大-蘆洲,2023-10-30,9857
2610,華航,17,3,14,元大-蘆洲,2023-10-30,9857
3715,定穎投控,130,116,14,元大-蘆洲,2023-10-30,9857
00751B,元大AAA至A公司債,13,1,12,元大-蘆洲,2023-10-30,9857
2609,陽明,20,8,12,元大-蘆洲,2023-10-30,9857
2369,菱生,14,2,12,元大-蘆洲,2023-10-30,9857
3707,漢磊,12,0,12,元大-蘆洲,2023-10-30,9857
00720B,元大投資級公司債,17,5,12,元大-蘆洲,2023-10-30,9857
2303,聯電,24,12,12,元大-蘆洲,2023-10-30,9857
5521,工信,12,1,11,元大-蘆洲,2023-10-30,9857
2834,臺企銀,11,0,11,元大-蘆洲,2023-10-30,9857
2354,鴻準,13,2,11,元大-蘆洲,2023-10-30,9857
3058,立德,11,0,11,元大-蘆洲,2023-10-30,9857
5272,笙科,16,5,11,元大-蘆洲,2023-10-30,9857
4114,健喬,15,4,11,元大-蘆洲,2023-10-30,9857
1321,大洋,10,0,10,元大-蘆洲,2023-10-30,9857
8038,長園科,10,0,10,元大-蘆洲,2023-10-30,9857
3202,樺晟,10,0,10,元大-蘆洲,2023-10-30,9857
5439,高技,208,8,200,元大-蘆洲,2023-10-31,9857
6116,彩晶,203,5,198,元大-蘆洲,2023-10-31,9857
00719B,元大美債1-3,156,0,156,元大-蘆洲,2023-10-31,9857
00878,國泰永續高股息,191,42,149,元大-蘆洲,2023-10-31,9857
0056,元大高股息,114,13,101,元大-蘆洲,2023-10-31,9857
00919,群益台灣精選高息,84,5,79,元大-蘆洲,2023-10-31,9857
4960,誠美材,77,0,77,元大-蘆洲,2023-10-31,9857
00929,復華台灣科技優息,78,4,74,元大-蘆洲,2023-10-31,9857
1524,耿鼎,127,53,74,元大-蘆洲,2023-10-31,9857
2486,一詮,108,68,40,元大-蘆洲,2023-10-31,9857
6235,華孚,47,10,37,元大-蘆洲,2023-10-31,9857
00637L,元大滬深300正2,37,0,37,元大-蘆洲,2023-10-31,9857
2337,旺宏,32,3,29,元大-蘆洲,2023-10-31,9857
00631L,元大台灣50正2,28,0,28,元大-蘆洲,2023-10-31,9857
2406,國碩,34,6,28,元大-蘆洲,2023-10-31,9857
9105,泰金寶-DR,37,10,27,元大-蘆洲,2023-10-31,9857
00922,國泰台灣領袖50,27,1,26,元大-蘆洲,2023-10-31,9857
3094,聯傑,49,23,26,元大-蘆洲,2023-10-31,9857
6712,長聖,26,0,26,元大-蘆洲,2023-10-31,9857
2312,金寶,26,1,25,元大-蘆洲,2023-10-31,9857
5388,中磊,24,0,24,元大-蘆洲,2023-10-31,9857
2303,聯電,29,6,23,元大-蘆洲,2023-10-31,9857
2816,旺旺保,23,0,23,元大-蘆洲,2023-10-31,9857
3122,笙泉,185,163,22,元大-蘆洲,2023-10-31,9857
2344,華邦電,35,14,21,元大-蘆洲,2023-10-31,9857
2104,國際中橡,20,0,20,元大-蘆洲,2023-10-31,9857
6216,居易,40,20,20,元大-蘆洲,2023-10-31,9857
8358,金居,20,1,19,元大-蘆洲,2023-10-31,9857
3268,海德威,53,34,19,元大-蘆洲,2023-10-31,9857
2884,玉山金,18,0,18,元大-蘆洲,2023-10-31,9857
2390,云辰,23,5,18,元大-蘆洲,2023-10-31,9857
2641,正德,18,0,18,元大-蘆洲,2023-10-31,9857
00679B,元大美債20年,18,0,18,元大-蘆洲,2023-10-31,9857
2417,圓剛,26,8,18,元大-蘆洲,2023-10-31,9857
4168,醣聯,17,0,17,元大-蘆洲,2023-10-31,9857
3576,聯合再生,59,42,17,元大-蘆洲,2023-10-31,9857
5483,中美晶,22,5,17,元大-蘆洲,2023-10-31,9857
4188,安克,17,0,17,元大-蘆洲,2023-10-31,9857
00932,兆豐永續高息等權,16,0,16,元大-蘆洲,2023-10-31,9857
8215,明基材,26,10,16,元大-蘆洲,2023-10-31,9857
2367,燿華,30,14,16,元大-蘆洲,2023-10-31,9857
1815,富喬,60,45,15,元大-蘆洲,2023-10-31,9857
2317,鴻海,47,32,15,元大-蘆洲,2023-10-31,9857
6282,康舒,19,4,15,元大-蘆洲,2023-10-31,9857
00885,富邦越南,15,0,15,元大-蘆洲,2023-10-31,9857
4108,懷特,22,7,15,元大-蘆洲,2023-10-31,9857
3305,昇貿,23,8,15,元大-蘆洲,2023-10-31,9857
00915,凱基優選高股息30,15,0,15,元大-蘆洲,2023-10-31,9857
2025,千興,15,0,15,元大-蘆洲,2023-10-31,9857
5530,龍巖,15,0,15,元大-蘆洲,2023-10-31,9857
00931B,統一美債20年,179,0,179,元大-蘆洲,2023-11-01,9857
00934,中信成長高股息,156,0,156,元大-蘆洲,2023-11-01,9857
00878,國泰永續高股息,185,34,151,元大-蘆洲,2023-11-01,9857
00929,復華台灣科技優息,165,27,138,元大-蘆洲,2023-11-01,9857
00679B,元大美債20年,102,0,102,元大-蘆洲,2023-11-01,9857
6285,啟��,85,1,84,元大-蘆洲,2023-11-01,9857
00935,野村臺灣新科技50,60,0,60,元大-蘆洲,2023-11-01,9857
0056,元大高股息,71,15,56,元大-蘆洲,2023-11-01,9857
00751B,元大AAA至A公司債,50,0,50,元大-蘆洲,2023-11-01,9857
00676R,富邦臺灣加權反1,50,0,50,元大-蘆洲,2023-11-01,9857
00885,富邦越南,50,0,50,元大-蘆洲,2023-11-01,9857
2308,台達電,39,2,37,元大-蘆洲,2023-11-01,9857
1605,華新,33,3,30,元大-蘆洲,2023-11-01,9857
6712,長聖,33,5,28,元大-蘆洲,2023-11-01,9857
00712,復華富時不動產,42,15,27,元大-蘆洲,2023-11-01,9857
2363,矽統,33,6,27,元大-蘆洲,2023-11-01,9857
2610,華航,63,37,26,元大-蘆洲,2023-11-01,9857
1731,美吾華,25,0,25,元大-蘆洲,2023-11-01,9857
2886,兆豐金,24,0,24,元大-蘆洲,2023-11-01,9857
3059,華晶科,24,0,24,元大-蘆洲,2023-11-01,9857
3481,群創,36,13,23,元大-蘆洲,2023-11-01,9857
8110,華東,33,10,23,元大-蘆洲,2023-11-01,9857
4915,致伸,50,27,23,元大-蘆洲,2023-11-01,9857
2317,鴻海,31,9,22,元大-蘆洲,2023-11-01,9857
2409,友達,32,12,20,元大-蘆洲,2023-11-01,9857
3380,明泰,37,17,20,元大-蘆洲,2023-11-01,9857
2303,聯電,35,16,19,元大-蘆洲,2023-11-01,9857
2382,廣達,44,26,18,元大-蘆洲,2023-11-01,9857
2615,萬海,39,22,17,元大-蘆洲,2023-11-01,9857
6257,矽格,17,0,17,元大-蘆洲,2023-11-01,9857
5469,瀚宇博,27,11,16,元大-蘆洲,2023-11-01,9857
3305,昇貿,16,0,16,元大-蘆洲,2023-11-01,9857
00715L,期街口布蘭特正2,15,0,15,元大-蘆洲,2023-11-01,9857
00719B,元大美債1-3,15,0,15,元大-蘆洲,2023-11-01,9857
3694,海華,16,1,15,元大-蘆洲,2023-11-01,9857
3024,憶聲,15,0,15,元大-蘆洲,2023-11-01,9857
3704,合勤控,30,16,14,元大-蘆洲,2023-11-01,9857
1514,亞力,13,0,13,元大-蘆洲,2023-11-01,9857
3624,光頡,12,0,12,元大-蘆洲,2023-11-01,9857
1609,大亞,14,3,11,元大-蘆洲,2023-11-01,9857
3035,智原,38,26,12,元大-蘆洲,2023-11-01,9857
00713,元大台灣高息低波,12,1,11,元大-蘆洲,2023-11-01,9857
5426,振發,11,0,11,元大-蘆洲,2023-11-01,9857
00632R,元大台灣50反1,35,24,11,元大-蘆洲,2023-11-01,9857
6147,頎邦,11,0,11,元大-蘆洲,2023-11-01,9857
8426,紅木-KY,11,0,11,元大-蘆洲,2023-11-01,9857
2406,國碩,16,5,11,元大-蘆洲,2023-11-01,9857
9105,泰金寶-DR,11,0,11,元大-蘆洲,2023-11-01,9857
2353,宏��,12,2,10,元大-蘆洲,2023-11-01,9857
2002,中鋼,12,2,10,元大-蘆洲,2023-11-01,9857
2014,中鴻,200,1,199,元大-蘆洲,2023-11-02,9857
00632R,元大台灣50反1,177,0,177,元大-蘆洲,2023-11-02,9857
2313,華通,168,28,140,元大-蘆洲,2023-11-02,9857
3231,緯創,198,92,106,元大-蘆洲,2023-11-02,9857
6116,彩晶,108,11,97,元大-蘆洲,2023-11-02,9857
00878,國泰永續高股息,118,46,72,元大-蘆洲,2023-11-02,9857
2417,圓剛,92,25,67,元大-蘆洲,2023-11-02,9857
6451,訊芯-KY,57,1,56,元大-蘆洲,2023-11-02,9857
00934,中信成長高股息,43,1,42,元大-蘆洲,2023-11-02,9857
00706L,期元大S＆P日圓正2,39,0,39,元大-蘆洲,2023-11-02,9857
6235,華孚,54,21,33,元大-蘆洲,2023-11-02,9857
2421,建準,49,18,31,元大-蘆洲,2023-11-02,9857
00935,野村臺灣新科技50,48,19,29,元大-蘆洲,2023-11-02,9857
00712,復華富時不動產,54,27,27,元大-蘆洲,2023-11-02,9857
00637L,元大滬深300正2,124,100,24,元大-蘆洲,2023-11-02,9857
2371,大同,24,1,23,元大-蘆洲,2023-11-02,9857
2331,精英,21,0,21,元大-蘆洲,2023-11-02,9857
00931B,統一美債20年,23,2,21,元大-蘆洲,2023-11-02,9857
2405,輔信,22,2,20,元大-蘆洲,2023-11-02,9857
00921,兆豐龍頭等權重,20,0,20,元大-蘆洲,2023-11-02,9857
8215,明基材,28,9,19,元大-蘆洲,2023-11-02,9857
00900,富邦特選高股息30,18,1,17,元大-蘆洲,2023-11-02,9857
00933B,國泰10Y+金融債,16,0,16,元大-蘆洲,2023-11-02,9857
1101,台泥,23,8,15,元大-蘆洲,2023-11-02,9857
2356,英業達,55,41,14,元大-蘆洲,2023-11-02,9857
3450,聯鈞,22,8,14,元大-蘆洲,2023-11-02,9857
3481,群創,45,31,14,元大-蘆洲,2023-11-02,9857
2883,凱基金,15,2,13,元大-蘆洲,2023-11-02,9857
6279,胡連,16,3,13,元大-蘆洲,2023-11-02,9857
8110,華東,17,4,13,元大-蘆洲,2023-11-02,9857
2329,華泰,21,8,13,元大-蘆洲,2023-11-02,9857
3715,定穎投控,160,148,12,元大-蘆洲,2023-11-02,9857
2736,富野,12,0,12,元大-蘆洲,2023-11-02,9857
2465,麗臺,15,3,12,元大-蘆洲,2023-11-02,9857
3545,敦泰,15,4,11,元大-蘆洲,2023-11-02,9857
4108,懷特,13,2,11,元大-蘆洲,2023-11-02,9857
2903,遠百,10,0,10,元大-蘆洲,2023-11-02,9857
3041,揚智,10,0,10,元大-蘆洲,2023-11-02,9857
6216,居易,10,0,10,元大-蘆洲,2023-11-02,9857
3518,柏騰,10,0,10,元大-蘆洲,2023-11-02,9857
2891,中信金,9,1,8,元大-蘆洲,2023-11-02,9857
6443,元晶,8,0,8,元大-蘆洲,2023-11-02,9857
2485,兆赫,8,0,8,元大-蘆洲,2023-11-02,9857
9105,泰金寶-DR,27,19,8,元大-蘆洲,2023-11-02,9857
00664R,國泰臺灣加權反1,8,0,8,元大-蘆洲,2023-11-02,9857
5371,中光電,8,0,8,元大-蘆洲,2023-11-02,9857
2451,創見,8,0,8,元大-蘆洲,2023-11-02,9857
4167,松瑞藥,60,52,8,元大-蘆洲,2023-11-02,9857
8028,昇陽半導體,8,1,7,元大-蘆洲,2023-11-02,9857
00720B,元大投資級公司債,22,15,7,元大-蘆洲,2023-11-02,9857
9105,泰金寶-DR,260,0,260,元大-蘆洲,2023-11-03,9857
2363,矽統,478,320,158,元大-蘆洲,2023-11-03,9857
00632R,元大台灣50反1,136,0,136,元大-蘆洲,2023-11-03,9857
2634,漢翔,106,5,101,元大-蘆洲,2023-11-03,9857
00688L,國泰20年美債正2,100,0,100,元大-蘆洲,2023-11-03,9857
00720B,元大投資級公司債,81,4,77,元大-蘆洲,2023-11-03,9857
00934,中信成長高股息,72,2,70,元大-蘆洲,2023-11-03,9857
00878,國泰永續高股息,89,21,68,元大-蘆洲,2023-11-03,9857
2382,廣達,85,24,61,元大-蘆洲,2023-11-03,9857
2344,華邦電,57,7,50,元大-蘆洲,2023-11-03,9857
2498,宏達電,61,12,49,元大-蘆洲,2023-11-03,9857
2421,建準,50,3,47,元大-蘆洲,2023-11-03,9857
2317,鴻海,45,8,37,元大-蘆洲,2023-11-03,9857
00679B,元大美債20年,96,59,37,元大-蘆洲,2023-11-03,9857
8150,南茂,53,23,30,元大-蘆洲,2023-11-03,9857
4532,瑞智,30,0,30,元大-蘆洲,2023-11-03,9857
00795B,中信美國公債20年,27,0,27,元大-蘆洲,2023-11-03,9857
00687B,國泰20年美債,43,17,26,元大-蘆洲,2023-11-03,9857
2417,圓剛,29,3,26,元大-蘆洲,2023-11-03,9857
00712,復華富時不動產,67,42,25,元大-蘆洲,2023-11-03,9857
2465,麗臺,34,12,22,元大-蘆洲,2023-11-03,9857
2542,興富發,23,1,22,元大-蘆洲,2023-11-03,9857
3231,緯創,200,179,21,元大-蘆洲,2023-11-03,9857
2025,千興,21,0,21,元大-蘆洲,2023-11-03,9857
1815,富喬,175,156,19,元大-蘆洲,2023-11-03,9857
00772B,中信高評級公司債,17,1,16,元大-蘆洲,2023-11-03,9857
1802,台玻,37,21,16,元大-蘆洲,2023-11-03,9857
3122,笙泉,33,17,16,元大-蘆洲,2023-11-03,9857
2390,云辰,25,11,14,元大-蘆洲,2023-11-03,9857
4951,精拓科,14,0,14,元大-蘆洲,2023-11-03,9857
6290,良維,14,1,13,元大-蘆洲,2023-11-03,9857
2482,連宇,13,0,13,元大-蘆洲,2023-11-03,9857
4908,前鼎,25,12,13,元大-蘆洲,2023-11-03,9857
4555,氣立,13,0,13,元大-蘆洲,2023-11-03,9857
2353,宏��,14,1,13,元大-蘆洲,2023-11-03,9857
6770,力積電,77,66,11,元大-蘆洲,2023-11-03,9857
5475,德宏,11,0,11,元大-蘆洲,2023-11-03,9857
8049,晶采,11,0,11,元大-蘆洲,2023-11-03,9857
6695,芯鼎,10,0,10,元大-蘆洲,2023-11-03,9857
2405,輔信,10,0,10,元大-蘆洲,2023-11-03,9857
3596,智易,10,0,10,元大-蘆洲,2023-11-03,9857
8112,至上,11,2,9,元大-蘆洲,2023-11-03,9857
00719B,元大美債1-3,9,0,9,元大-蘆洲,2023-11-03,9857
8086,宏捷科,36,27,9,元大-蘆洲,2023-11-03,9857
3376,新日興,15,6,9,元大-蘆洲,2023-11-03,9857
8110,華東,20,12,8,元大-蘆洲,2023-11-03,9857
2367,燿華,11,3,8,元大-蘆洲,2023-11-03,9857
00669R,國泰美國道瓊反1,8,0,8,元大-蘆洲,2023-11-03,9857
4906,正文,13,5,8,元大-蘆洲,2023-11-03,9857
3406,玉晶光,7,0,7,元大-蘆洲,2023-11-03,9857
6770,力積電,424,66,358,元大-蘆洲,2023-11-06,9857
4157,太景*-KY,184,4,180,元大-蘆洲,2023-11-06,9857
3122,笙泉,103,12,91,元大-蘆洲,2023-11-06,9857
3036,文曄,115,28,87,元大-蘆洲,2023-11-06,9857
00878,國泰永續高股息,87,25,62,元大-蘆洲,2023-11-06,9857
00687B,國泰20年美債,51,0,51,元大-蘆洲,2023-11-06,9857
00712,復華富時不動產,58,10,48,元大-蘆洲,2023-11-06,9857
2313,華通,85,38,47,元大-蘆洲,2023-11-06,9857
2618,長榮航,88,42,46,元大-蘆洲,2023-11-06,9857
2388,威盛,176,130,46,元大-蘆洲,2023-11-06,9857
1504,東元,44,0,44,元大-蘆洲,2023-11-06,9857
2486,一詮,110,68,42,元大-蘆洲,2023-11-06,9857
1605,華新,96,58,38,元大-蘆洲,2023-11-06,9857
3363,上詮,41,4,37,元大-蘆洲,2023-11-06,9857
2465,麗臺,36,1,35,元大-蘆洲,2023-11-06,9857
00664R,國泰臺灣加權反1,35,0,35,元大-蘆洲,2023-11-06,9857
1721,三晃,114,80,34,元大-蘆洲,2023-11-06,9857
4164,承業醫,36,3,33,元大-蘆洲,2023-11-06,9857
00715L,期街口布蘭特正2,33,0,33,元大-蘆洲,2023-11-06,9857
2379,瑞昱,29,0,29,元大-蘆洲,2023-11-06,9857
2409,友達,51,22,29,元大-蘆洲,2023-11-06,9857
1785,光洋科,32,5,27,元大-蘆洲,2023-11-06,9857
2883,凱基金,23,1,22,元大-蘆洲,2023-11-06,9857
1710,東聯,22,0,22,元大-蘆洲,2023-11-06,9857
00720B,元大投資級公司債,21,0,21,元大-蘆洲,2023-11-06,9857
2376,技嘉,39,18,21,元大-蘆洲,2023-11-06,9857
00935,野村臺灣新科技50,19,0,19,元大-蘆洲,2023-11-06,9857
5351,鈺創,22,4,18,元大-蘆洲,2023-11-06,9857
2882,國泰金,17,0,17,元大-蘆洲,2023-11-06,9857
8150,南茂,33,17,16,元大-蘆洲,2023-11-06,9857
8176,智捷,16,0,16,元大-蘆洲,2023-11-06,9857
2332,友訊,31,15,16,元大-蘆洲,2023-11-06,9857
2329,華泰,41,25,16,元大-蘆洲,2023-11-06,9857
00751B,元大AAA至A公司債,32,17,15,元大-蘆洲,2023-11-06,9857
1802,台玻,43,28,15,元大-蘆洲,2023-11-06,9857
3264,欣銓,22,7,15,元大-蘆洲,2023-11-06,9857
3706,神達,17,3,14,元大-蘆洲,2023-11-06,9857
00679B,元大美債20年,20,7,13,元大-蘆洲,2023-11-06,9857
1603,華電,12,0,12,元大-蘆洲,2023-11-06,9857
5289,宜鼎,12,0,12,元大-蘆洲,2023-11-06,9857
2885,元大金,13,1,12,元大-蘆洲,2023-11-06,9857
6139,亞翔,31,20,11,元大-蘆洲,2023-11-06,9857
8433,弘帆,11,0,11,元大-蘆洲,2023-11-06,9857
6176,瑞儀,11,0,11,元大-蘆洲,2023-11-06,9857
8112,至上,13,2,11,元大-蘆洲,2023-11-06,9857
8110,華東,30,19,11,元大-蘆洲,2023-11-06,9857
1611,中電,10,0,10,元大-蘆洲,2023-11-06,9857
5484,慧友,10,0,10,元大-蘆洲,2023-11-06,9857
00933B,國泰10Y+金融債,10,0,10,元大-蘆洲,2023-11-06,9857
2736,富野,12,2,10,元大-蘆洲,2023-11-06,9857
3444,利機,100,0,100,元大-蘆洲,2023-11-07,9857
2401,凌陽,155,56,99,元大-蘆洲,2023-11-07,9857
00878,國泰永續高股息,85,26,59,元大-蘆洲,2023-11-07,9857
00676R,富邦臺灣加權反1,50,0,50,元大-蘆洲,2023-11-07,9857
2486,一詮,62,12,50,元大-蘆洲,2023-11-07,9857
2363,矽統,186,141,45,元大-蘆洲,2023-11-07,9857
6182,合晶,37,0,37,元大-蘆洲,2023-11-07,9857
00712,復華富時不動產,37,0,37,元大-蘆洲,2023-11-07,9857
2610,華航,34,4,30,元大-蘆洲,2023-11-07,9857
8110,華東,32,2,30,元大-蘆洲,2023-11-07,9857
2402,毅嘉,24,0,24,元大-蘆洲,2023-11-07,9857
5347,世界,31,8,23,元大-蘆洲,2023-11-07,9857
2408,南亞科,24,2,22,元大-蘆洲,2023-11-07,9857
6133,金橋,22,0,22,元大-蘆洲,2023-11-07,9857
00931B,統一美債20年,25,4,21,元大-蘆洲,2023-11-07,9857
2618,長榮航,52,31,21,元大-蘆洲,2023-11-07,9857
2010,春源,20,0,20,元大-蘆洲,2023-11-07,9857
2405,輔信,21,1,20,元大-蘆洲,2023-11-07,9857
5469,瀚宇博,20,0,20,元大-蘆洲,2023-11-07,9857
6185,幃翔,20,1,19,元大-蘆洲,2023-11-07,9857
00882,中信中國高股息,19,0,19,元大-蘆洲,2023-11-07,9857
1504,東元,22,3,19,元大-蘆洲,2023-11-07,9857
5351,鈺創,31,13,18,元大-蘆洲,2023-11-07,9857
2880,華南金,18,0,18,元大-蘆洲,2023-11-07,9857
00637L,元大滬深300正2,18,0,18,元大-蘆洲,2023-11-07,9857
8150,南茂,20,3,17,元大-蘆洲,2023-11-07,9857
2002,中鋼,20,3,17,元大-蘆洲,2023-11-07,9857
1789,神隆,29,12,17,元大-蘆洲,2023-11-07,9857
3037,欣興,21,5,16,元大-蘆洲,2023-11-07,9857
2743,山富,25,10,15,元大-蘆洲,2023-11-07,9857
00665L,富邦�琤肭磪囓�2,15,0,15,元大-蘆洲,2023-11-07,9857
6285,啟��,64,50,14,元大-蘆洲,2023-11-07,9857
00753L,中信中國50正2,15,1,14,元大-蘆洲,2023-11-07,9857
00751B,元大AAA至A公司債,13,0,13,元大-蘆洲,2023-11-07,9857
1314,中石化,13,0,13,元大-蘆洲,2023-11-07,9857
1582,信錦,16,4,12,元大-蘆洲,2023-11-07,9857
2883,凱基金,21,9,12,元大-蘆洲,2023-11-07,9857
2492,華新科,23,11,12,元大-蘆洲,2023-11-07,9857
5483,中美晶,20,9,11,元大-蘆洲,2023-11-07,9857
2355,敬鵬,12,1,11,元大-蘆洲,2023-11-07,9857
00933B,國泰10Y+金融債,11,0,11,元大-蘆洲,2023-11-07,9857
5880,合庫金,12,1,11,元大-蘆洲,2023-11-07,9857
1519,華城,43,33,10,元大-蘆洲,2023-11-07,9857
3276,宇環,10,0,10,元大-蘆洲,2023-11-07,9857
00633L,富邦上証正2,10,0,10,元大-蘆洲,2023-11-07,9857
5531,鄉林,10,0,10,元大-蘆洲,2023-11-07,9857
3265,台星科,10,0,10,元大-蘆洲,2023-11-07,9857
6156,松上,11,1,10,元大-蘆洲,2023-11-07,9857
2359,所羅門,16,6,10,元大-蘆洲,2023-11-07,9857
00713,元大台灣高息低波,18,9,9,元大-蘆洲,2023-11-07,9857
00936,台新永續高息中小,330,0,330,元大-蘆洲,2023-11-08,9857
9105,泰金寶-DR,260,0,260,元大-蘆洲,2023-11-08,9857
00632R,元大台灣50反1,213,0,213,元大-蘆洲,2023-11-08,9857
00878,國泰永續高股息,249,64,185,元大-蘆洲,2023-11-08,9857
2303,聯電,132,17,115,元大-蘆洲,2023-11-08,9857
3227,原相,107,11,96,元大-蘆洲,2023-11-08,9857
8210,勤誠,96,21,75,元大-蘆洲,2023-11-08,9857
4938,和碩,80,14,66,元大-蘆洲,2023-11-08,9857
1815,富喬,94,36,58,元大-蘆洲,2023-11-08,9857
00715L,期街口布蘭特正2,63,13,50,元大-蘆洲,2023-11-08,9857
6274,台燿,61,11,50,元大-蘆洲,2023-11-08,9857
00676R,富邦臺灣加權反1,50,0,50,元大-蘆洲,2023-11-08,9857
3041,揚智,53,8,45,元大-蘆洲,2023-11-08,9857
2618,長榮航,100,55,45,元大-蘆洲,2023-11-08,9857
00919,群益台灣精選高息,87,47,40,元大-蘆洲,2023-11-08,9857
2363,矽統,247,208,39,元大-蘆洲,2023-11-08,9857
2368,金像電,44,6,38,元大-蘆洲,2023-11-08,9857
2409,友達,48,13,35,元大-蘆洲,2023-11-08,9857
00712,復華富時不動產,42,9,33,元大-蘆洲,2023-11-08,9857
00935,野村臺灣新科技50,77,45,32,元大-蘆洲,2023-11-08,9857
2392,正崴,30,4,26,元大-蘆洲,2023-11-08,9857
00922,國泰台灣領袖50,38,13,25,元大-蘆洲,2023-11-08,9857
6285,啟��,26,1,25,元大-蘆洲,2023-11-08,9857
2476,鉅祥,24,0,24,元大-蘆洲,2023-11-08,9857
4908,前鼎,34,10,24,元大-蘆洲,2023-11-08,9857
2337,旺宏,29,6,23,元大-蘆洲,2023-11-08,9857
2401,凌陽,43,20,23,元大-蘆洲,2023-11-08,9857
3257,虹冠電,24,1,23,元大-蘆洲,2023-11-08,9857
6443,元晶,23,0,23,元大-蘆洲,2023-11-08,9857
3325,旭品,24,1,23,元大-蘆洲,2023-11-08,9857
00772B,中信高評級公司債,28,6,22,元大-蘆洲,2023-11-08,9857
00680L,元大美債20正2,155,134,21,元大-蘆洲,2023-11-08,9857
2867,三商壽,20,0,20,元大-蘆洲,2023-11-08,9857
1710,東聯,20,0,20,元大-蘆洲,2023-11-08,9857
2388,威盛,101,82,19,元大-蘆洲,2023-11-08,9857
00885,富邦越南,19,1,18,元大-蘆洲,2023-11-08,9857
6770,力積電,41,24,17,元大-蘆洲,2023-11-08,9857
4967,十銓,55,38,17,元大-蘆洲,2023-11-08,9857
4167,松瑞藥,50,34,16,元大-蘆洲,2023-11-08,9857
4743,合一,30,15,15,元大-蘆洲,2023-11-08,9857
6117,迎廣,75,61,14,元大-蘆洲,2023-11-08,9857
2542,興富發,19,5,14,元大-蘆洲,2023-11-08,9857
3706,神達,18,4,14,元大-蘆洲,2023-11-08,9857
2025,千興,25,12,13,元大-蘆洲,2023-11-08,9857
2883,凱基金,24,11,13,元大-蘆洲,2023-11-08,9857
6005,群益證,12,0,12,元大-蘆洲,2023-11-08,9857
1314,中石化,15,3,12,元大-蘆洲,2023-11-08,9857
00850,元大臺灣ESG永續,16,4,12,元大-蘆洲,2023-11-08,9857
3363,上詮,14,2,12,元大-蘆洲,2023-11-08,9857
00679B,元大美債20年,17,6,11,元大-蘆洲,2023-11-08,9857
2002,中鋼,367,1,366,元大-蘆洲,2023-11-09,9857
00936,台新永續高息中小,208,9,199,元大-蘆洲,2023-11-09,9857
3122,笙泉,141,24,117,元大-蘆洲,2023-11-09,9857
1582,信錦,107,5,102,元大-蘆洲,2023-11-09,9857
00878,國泰永續高股息,242,162,80,元大-蘆洲,2023-11-09,9857
1522,堤維西,81,5,76,元大-蘆洲,2023-11-09,9857
2344,華邦電,54,0,54,元大-蘆洲,2023-11-09,9857
00676R,富邦臺灣加權反1,51,0,51,元大-蘆洲,2023-11-09,9857
2352,佳世達,68,18,50,元大-蘆洲,2023-11-09,9857
2486,一詮,89,41,48,元大-蘆洲,2023-11-09,9857
6442,光聖,37,2,35,元大-蘆洲,2023-11-09,9857
00679B,元大美債20年,34,1,33,元大-蘆洲,2023-11-09,9857
4532,瑞智,31,1,30,元大-蘆洲,2023-11-09,9857
3037,欣興,27,2,25,元大-蘆洲,2023-11-09,9857
2610,華航,37,13,24,元大-蘆洲,2023-11-09,9857
8064,東捷,23,0,23,元大-蘆洲,2023-11-09,9857
2421,建準,30,7,23,元大-蘆洲,2023-11-09,9857
2412,中華電,23,0,23,元大-蘆洲,2023-11-09,9857
00929,復華台灣科技優息,88,65,23,元大-蘆洲,2023-11-09,9857
1324,地球,69,47,22,元大-蘆洲,2023-11-09,9857
1721,三晃,23,1,22,元大-蘆洲,2023-11-09,9857
6569,醫揚,22,0,22,元大-蘆洲,2023-11-09,9857
2331,精英,53,32,21,元大-蘆洲,2023-11-09,9857
1314,中石化,69,49,20,元大-蘆洲,2023-11-09,9857
00671R,富邦NASDAQ反1,20,0,20,元大-蘆洲,2023-11-09,9857
911868,同方友友-DR,20,0,20,元大-蘆洲,2023-11-09,9857
3704,合勤控,22,2,20,元大-蘆洲,2023-11-09,9857
3260,威剛,21,2,19,元大-蘆洲,2023-11-09,9857
3380,明泰,20,2,18,元大-蘆洲,2023-11-09,9857
00715L,期街口布蘭特正2,19,1,18,元大-蘆洲,2023-11-09,9857
2329,華泰,103,85,18,元大-蘆洲,2023-11-09,9857
6901,鑽石投資,31,14,17,元大-蘆洲,2023-11-09,9857
6116,彩晶,38,22,16,元大-蘆洲,2023-11-09,9857
2409,友達,25,9,16,元大-蘆洲,2023-11-09,9857
6285,啟��,36,21,15,元大-蘆洲,2023-11-09,9857
6182,合晶,15,0,15,元大-蘆洲,2023-11-09,9857
00753L,中信中國50正2,15,0,15,元大-蘆洲,2023-11-09,9857
2313,華通,19,5,14,元大-蘆洲,2023-11-09,9857
1319,東陽,17,3,14,元大-蘆洲,2023-11-09,9857
1519,華城,17,4,13,元大-蘆洲,2023-11-09,9857
3036,文曄,33,20,13,元大-蘆洲,2023-11-09,9857
4108,懷特,13,0,13,元大-蘆洲,2023-11-09,9857
8011,台通,16,4,12,元大-蘆洲,2023-11-09,9857
6284,佳邦,20,8,12,元大-蘆洲,2023-11-09,9857
1504,東元,13,1,12,元大-蘆洲,2023-11-09,9857
2338,光罩,12,0,12,元大-蘆洲,2023-11-09,9857
3094,聯傑,15,3,12,元大-蘆洲,2023-11-09,9857
2462,良得電,19,7,12,元大-蘆洲,2023-11-09,9857
3221,台嘉碩,11,0,11,元大-蘆洲,2023-11-09,9857
1795,美時,16,6,10,元大-蘆洲,2023-11-09,9857
3122,笙泉,193,2,191,元大-蘆洲,2023-11-10,9857
2610,華航,110,1,109,元大-蘆洲,2023-11-10,9857
00676R,富邦臺灣加權反1,100,0,100,元大-蘆洲,2023-11-10,9857
00878,國泰永續高股息,95,13,82,元大-蘆洲,2023-11-10,9857
00919,群益台灣精選高息,58,2,56,元大-蘆洲,2023-11-10,9857
00936,台新永續高息中小,149,100,49,元大-蘆洲,2023-11-10,9857
8034,榮群,59,14,45,元大-蘆洲,2023-11-10,9857
2027,大成鋼,45,0,45,元大-蘆洲,2023-11-10,9857
2486,一詮,43,0,43,元大-蘆洲,2023-11-10,9857
00679B,元大美債20年,44,2,42,元大-蘆洲,2023-11-10,9857
5880,合庫金,42,0,42,元大-蘆洲,2023-11-10,9857
1815,富喬,102,61,41,元大-蘆洲,2023-11-10,9857
2401,凌陽,39,1,38,元大-蘆洲,2023-11-10,9857
3013,晟銘電,44,8,36,元大-蘆洲,2023-11-10,9857
00900,富邦特選高股息30,38,3,35,元大-蘆洲,2023-11-10,9857
6901,鑽石投資,67,33,34,元大-蘆洲,2023-11-10,9857
2208,台船,32,1,31,元大-蘆洲,2023-11-10,9857
00637L,元大滬深300正2,229,200,29,元大-蘆洲,2023-11-10,9857
1314,中石化,29,0,29,元大-蘆洲,2023-11-10,9857
6530,創威,40,14,26,元大-蘆洲,2023-11-10,9857
6712,長聖,25,2,23,元大-蘆洲,2023-11-10,9857
2388,威盛,50,27,23,元大-蘆洲,2023-11-10,9857
2337,旺宏,22,1,21,元大-蘆洲,2023-11-10,9857
2883B,凱基金乙特,20,0,20,元大-蘆洲,2023-11-10,9857
00671R,富邦NASDAQ反1,20,0,20,元大-蘆洲,2023-11-10,9857
4128,中天,60,40,20,元大-蘆洲,2023-11-10,9857
4743,合一,61,41,20,元大-蘆洲,2023-11-10,9857
3481,群創,43,23,20,元大-蘆洲,2023-11-10,9857
00720B,元大投資級公司債,19,0,19,元大-蘆洲,2023-11-10,9857
3231,緯創,222,203,19,元大-蘆洲,2023-11-10,9857
2883,凱基金,20,2,18,元大-蘆洲,2023-11-10,9857
2331,精英,19,2,17,元大-蘆洲,2023-11-10,9857
5386,青雲,18,1,17,元大-蘆洲,2023-11-10,9857
5871,中租-KY,16,0,16,元大-蘆洲,2023-11-10,9857
1442,名軒,15,0,15,元大-蘆洲,2023-11-10,9857
00633L,富邦上証正2,20,5,15,元大-蘆洲,2023-11-10,9857
2634,漢翔,18,3,15,元大-蘆洲,2023-11-10,9857
3645,達邁,13,0,13,元大-蘆洲,2023-11-10,9857
2329,華泰,52,40,12,元大-蘆洲,2023-11-10,9857
6244,茂迪,12,0,12,元大-蘆洲,2023-11-10,9857
2542,興富發,16,4,12,元大-蘆洲,2023-11-10,9857
2353,宏��,18,6,12,元大-蘆洲,2023-11-10,9857
2201,裕隆,22,11,11,元大-蘆洲,2023-11-10,9857
1795,美時,25,15,10,元大-蘆洲,2023-11-10,9857
4552,力達-KY,10,0,10,元大-蘆洲,2023-11-10,9857
2302,麗正,11,1,10,元大-蘆洲,2023-11-10,9857
1584,精剛,32,22,10,元大-蘆洲,2023-11-10,9857
2464,盟立,10,0,10,元大-蘆洲,2023-11-10,9857
3558,神準,10,0,10,元大-蘆洲,2023-11-10,9857
9904,寶成,10,0,10,元大-蘆洲,2023-11-10,9857
00929,復華台灣科技優息,314,46,268,元大-蘆洲,2023-11-13,9857
00679B,元大美債20年,188,0,188,元大-蘆洲,2023-11-13,9857
00878,國泰永續高股息,126,17,109,元大-蘆洲,2023-11-13,9857
3703,欣陸,100,0,100,元大-蘆洲,2023-11-13,9857
2382,廣達,102,46,56,元大-蘆洲,2023-11-13,9857
3122,笙泉,220,165,55,元大-蘆洲,2023-11-13,9857
00936,台新永續高息中小,41,0,41,元大-蘆洲,2023-11-13,9857
00632R,元大台灣50反1,37,0,37,元大-蘆洲,2023-11-13,9857
00934,中信成長高股息,35,0,35,元大-蘆洲,2023-11-13,9857
00922,國泰台灣領袖50,37,3,34,元大-蘆洲,2023-11-13,9857
00882,中信中國高股息,33,0,33,元大-蘆洲,2023-11-13,9857
1314,中石化,32,0,32,元大-蘆洲,2023-11-13,9857
00664R,國泰臺灣加權反1,31,0,31,元大-蘆洲,2023-11-13,9857
2607,榮運,29,3,26,元大-蘆洲,2023-11-13,9857
00637L,元大滬深300正2,25,0,25,元大-蘆洲,2023-11-13,9857
2465,麗臺,24,1,23,元大-蘆洲,2023-11-13,9857
5521,工信,41,18,23,元大-蘆洲,2023-11-13,9857
2376,技嘉,31,9,22,元大-蘆洲,2023-11-13,9857
8249,菱光,26,4,22,元大-蘆洲,2023-11-13,9857
00680L,元大美債20正2,24,2,22,元大-蘆洲,2023-11-13,9857
5465,富驊,22,1,21,元大-蘆洲,2023-11-13,9857
2610,華航,28,7,21,元大-蘆洲,2023-11-13,9857
2405,輔信,21,1,20,元大-蘆洲,2023-11-13,9857
6643,M31,20,1,19,元大-蘆洲,2023-11-13,9857
6901,鑽石投資,24,8,16,元大-蘆洲,2023-11-13,9857
1815,富喬,66,50,16,元大-蘆洲,2023-11-13,9857
3036,文曄,30,14,16,元大-蘆洲,2023-11-13,9857
4763,材料-KY,20,4,16,元大-蘆洲,2023-11-13,9857
1609,大亞,16,0,16,元大-蘆洲,2023-11-13,9857
6770,力積電,30,16,14,元大-蘆洲,2023-11-13,9857
00687B,國泰20年美債,14,0,14,元大-蘆洲,2023-11-13,9857
5426,振發,13,0,13,元大-蘆洲,2023-11-13,9857
3545,敦泰,23,11,12,元大-蘆洲,2023-11-13,9857
2486,一詮,23,11,12,元大-蘆洲,2023-11-13,9857
9943,好樂迪,12,0,12,元大-蘆洲,2023-11-13,9857
8916,光隆,12,0,12,元大-蘆洲,2023-11-13,9857
2618,長榮航,44,33,11,元大-蘆洲,2023-11-13,9857
2884,玉山金,12,1,11,元大-蘆洲,2023-11-13,9857
6129,普誠,11,0,11,元大-蘆洲,2023-11-13,9857
5608,四維航,11,0,11,元大-蘆洲,2023-11-13,9857
2816,旺旺保,11,0,11,元大-蘆洲,2023-11-13,9857
6139,亞翔,17,6,11,元大-蘆洲,2023-11-13,9857
3092,鴻碩,11,0,11,元大-蘆洲,2023-11-13,9857
2002,中鋼,11,1,10,元大-蘆洲,2023-11-13,9857
4142,國光生,10,0,10,元大-蘆洲,2023-11-13,9857
00633L,富邦上証正2,20,10,10,元大-蘆洲,2023-11-13,9857
6224,聚鼎,10,0,10,元大-蘆洲,2023-11-13,9857
8076,伍豐,12,2,10,元大-蘆洲,2023-11-13,9857
8068,全達,10,0,10,元大-蘆洲,2023-11-13,9857
4564,元翎,10,0,10,元大-蘆洲,2023-11-13,9857
2313,華通,255,20,235,元大-蘆洲,2023-11-14,9857
00637L,元大滬深300正2,130,5,125,元大-蘆洲,2023-11-14,9857
6138,茂達,133,9,124,元大-蘆洲,2023-11-14,9857
8110,華東,60,0,60,元大-蘆洲,2023-11-14,9857
9945,潤泰新,61,5,56,元大-蘆洲,2023-11-14,9857
2609,陽明,80,32,48,元大-蘆洲,2023-11-14,9857
1815,富喬,57,14,43,元大-蘆洲,2023-11-14,9857
6235,華孚,62,23,39,元大-蘆洲,2023-11-14,9857
00715L,期街口布蘭特正2,54,17,37,元大-蘆洲,2023-11-14,9857
00632R,元大台灣50反1,35,0,35,元大-蘆洲,2023-11-14,9857
6244,茂迪,30,2,28,元大-蘆洲,2023-11-14,9857
3711,日月光投控,29,2,27,元大-蘆洲,2023-11-14,9857
1101,台泥,32,6,26,元大-蘆洲,2023-11-14,9857
4107,邦特,25,0,25,元大-蘆洲,2023-11-14,9857
3438,類比科,26,2,24,元大-蘆洲,2023-11-14,9857
2359,所羅門,27,3,24,元大-蘆洲,2023-11-14,9857
2363,矽統,187,164,23,元大-蘆洲,2023-11-14,9857
2402,毅嘉,69,46,23,元大-蘆洲,2023-11-14,9857
2743,山富,22,2,20,元大-蘆洲,2023-11-14,9857
1102,亞泥,20,0,20,元大-蘆洲,2023-11-14,9857
1504,東元,26,6,20,元大-蘆洲,2023-11-14,9857
4743,合一,29,11,18,元大-蘆洲,2023-11-14,9857
3231,緯創,84,66,18,元大-蘆洲,2023-11-14,9857
2417,圓剛,39,22,17,元大-蘆洲,2023-11-14,9857
00687B,國泰20年美債,17,1,16,元大-蘆洲,2023-11-14,9857
2357,華碩,28,13,15,元大-蘆洲,2023-11-14,9857
1449,佳和,15,0,15,元大-蘆洲,2023-11-14,9857
2618,長榮航,29,15,14,元大-蘆洲,2023-11-14,9857
00720B,元大投資級公司債,14,0,14,元大-蘆洲,2023-11-14,9857
2374,佳能,13,0,13,元大-蘆洲,2023-11-14,9857
4915,致伸,22,10,12,元大-蘆洲,2023-11-14,9857
2486,一詮,22,10,12,元大-蘆洲,2023-11-14,9857
6901,鑽石投資,14,3,11,元大-蘆洲,2023-11-14,9857
2881,富邦金,18,7,11,元大-蘆洲,2023-11-14,9857
4950,牧東,11,0,11,元大-蘆洲,2023-11-14,9857
2465,麗臺,15,4,11,元大-蘆洲,2023-11-14,9857
6182,合晶,11,0,11,元大-蘆洲,2023-11-14,9857
2883,凱基金,11,0,11,元大-蘆洲,2023-11-14,9857
3035,智原,25,14,11,元大-蘆洲,2023-11-14,9857
2637,慧洋-KY,10,0,10,元大-蘆洲,2023-11-14,9857
3704,合勤控,15,5,10,元大-蘆洲,2023-11-14,9857
1524,耿鼎,14,4,10,元大-蘆洲,2023-11-14,9857
8227,巨有科技,10,0,10,元大-蘆洲,2023-11-14,9857
2401,凌陽,11,1,10,元大-蘆洲,2023-11-14,9857
6160,欣技,10,0,10,元大-蘆洲,2023-11-14,9857
9105,泰金寶-DR,10,0,10,元大-蘆洲,2023-11-14,9857
8121,越峰,10,0,10,元大-蘆洲,2023-11-14,9857
00923,群益台ESG低碳50,10,0,10,元大-蘆洲,2023-11-14,9857
3128,昇銳,11,1,10,元大-蘆洲,2023-11-14,9857
3321,同泰,10,0,10,元大-蘆洲,2023-11-14,9857
00929,復華台灣科技優息,285,87,198,元大-蘆洲,2023-11-15,9857
00680L,元大美債20正2,249,69,180,元大-蘆洲,2023-11-15,9857
00935,野村臺灣新科技50,101,0,101,元大-蘆洲,2023-11-15,9857
00878,國泰永續高股息,185,107,78,元大-蘆洲,2023-11-15,9857
6235,華孚,96,29,67,元大-蘆洲,2023-11-15,9857
3324,雙鴻,71,10,61,元大-蘆洲,2023-11-15,9857
3062,建漢,51,0,51,元大-蘆洲,2023-11-15,9857
1513,中興電,46,7,39,元大-蘆洲,2023-11-15,9857
2323,中環,74,40,34,元大-蘆洲,2023-11-15,9857
00632R,元大台灣50反1,134,101,33,元大-蘆洲,2023-11-15,9857
00664R,國泰臺灣加權反1,31,0,31,元大-蘆洲,2023-11-15,9857
6116,彩晶,73,49,24,元大-蘆洲,2023-11-15,9857
3374,精材,27,5,22,元大-蘆洲,2023-11-15,9857
2820,華票,20,0,20,元大-蘆洲,2023-11-15,9857
4532,瑞智,20,0,20,元大-蘆洲,2023-11-15,9857
2883B,凱基金乙特,20,0,20,元大-蘆洲,2023-11-15,9857
1471,首利,20,1,19,元大-蘆洲,2023-11-15,9857
4770,上品,20,1,19,元大-蘆洲,2023-11-15,9857
3706,神達,21,3,18,元大-蘆洲,2023-11-15,9857
3017,奇鋐,20,2,18,元大-蘆洲,2023-11-15,9857
5439,高技,19,3,16,元大-蘆洲,2023-11-15,9857
2355,敬鵬,28,12,16,元大-蘆洲,2023-11-15,9857
00719B,元大美債1-3,15,0,15,元大-蘆洲,2023-11-15,9857
8163,達方,17,3,14,元大-蘆洲,2023-11-15,9857
8011,台通,13,0,13,元大-蘆洲,2023-11-15,9857
3231,緯創,91,78,13,元大-蘆洲,2023-11-15,9857
2337,旺宏,47,35,12,元大-蘆洲,2023-11-15,9857
3596,智易,14,2,12,元大-蘆洲,2023-11-15,9857
3704,合勤控,16,5,11,元大-蘆洲,2023-11-15,9857
6139,亞翔,23,12,11,元大-蘆洲,2023-11-15,9857
1313,聯成,11,0,11,元大-蘆洲,2023-11-15,9857
3689,湧德,18,7,11,元大-蘆洲,2023-11-15,9857
8261,富鼎,15,4,11,元大-蘆洲,2023-11-15,9857
5351,鈺創,26,16,10,元大-蘆洲,2023-11-15,9857
2353,宏��,16,6,10,元大-蘆洲,2023-11-15,9857
6472,保瑞,12,2,10,元大-蘆洲,2023-11-15,9857
5225,東科-KY,10,0,10,元大-蘆洲,2023-11-15,9857
1409,新纖,10,0,10,元大-蘆洲,2023-11-15,9857
1710,東聯,10,0,10,元大-蘆洲,2023-11-15,9857
00933B,國泰10Y+金融債,13,3,10,元大-蘆洲,2023-11-15,9857
2889,國票金,10,1,9,元大-蘆洲,2023-11-15,9857
1304,台聚,10,1,9,元大-蘆洲,2023-11-15,9857
4714,永捷,10,1,9,元大-蘆洲,2023-11-15,9857
4908,前鼎,27,18,9,元大-蘆洲,2023-11-15,9857
3576,聯合再生,12,3,9,元大-蘆洲,2023-11-15,9857
3693,營邦,22,13,9,元大-蘆洲,2023-11-15,9857
3450,聯鈞,27,19,8,元大-蘆洲,2023-11-15,9857
6243,迅杰,15,7,8,元大-蘆洲,2023-11-15,9857
6806,森崴能源,8,0,8,元大-蘆洲,2023-11-15,9857
2371,大同,12,4,8,元大-蘆洲,2023-11-15,9857
00878,國泰永續高股息,249,14,235,元大-蘆洲,2023-11-16,9857
00885,富邦越南,205,0,205,元大-蘆洲,2023-11-16,9857
00632R,元大台灣50反1,182,0,182,元大-蘆洲,2023-11-16,9857
2002,中鋼,168,28,140,元大-蘆洲,2023-11-16,9857
00688L,國泰20年美債正2,105,0,105,元大-蘆洲,2023-11-16,9857
00676R,富邦臺灣加權反1,100,0,100,元大-蘆洲,2023-11-16,9857
2025,千興,80,0,80,元大-蘆洲,2023-11-16,9857
2329,華泰,314,239,75,元大-蘆洲,2023-11-16,9857
00679B,元大美債20年,70,4,66,元大-蘆洲,2023-11-16,9857
00692,富邦公司治理,56,0,56,元大-蘆洲,2023-11-16,9857
00637L,元大滬深300正2,45,0,45,元大-蘆洲,2023-11-16,9857
1582,信錦,61,18,43,元大-蘆洲,2023-11-16,9857
2607,榮運,44,4,40,元大-蘆洲,2023-11-16,9857
3013,晟銘電,45,5,40,元大-蘆洲,2023-11-16,9857
2610,華航,238,203,35,元大-蘆洲,2023-11-16,9857
5706,鳳凰,41,6,35,元大-蘆洲,2023-11-16,9857
0056,元大高股息,52,18,34,元大-蘆洲,2023-11-16,9857
6753,龍德造船,30,0,30,元大-蘆洲,2023-11-16,9857
00751B,元大AAA至A公司債,30,0,30,元大-蘆洲,2023-11-16,9857
00680L,元大美債20正2,33,4,29,元大-蘆洲,2023-11-16,9857
4908,前鼎,31,3,28,元大-蘆洲,2023-11-16,9857
00687B,國泰20年美債,25,0,25,元大-蘆洲,2023-11-16,9857
3041,揚智,39,16,23,元大-蘆洲,2023-11-16,9857
00719B,元大美債1-3,21,0,21,元大-蘆洲,2023-11-16,9857
00715L,期街口布蘭特正2,20,0,20,元大-蘆洲,2023-11-16,9857
6235,華孚,162,142,20,元大-蘆洲,2023-11-16,9857
2486,一詮,24,4,20,元大-蘆洲,2023-11-16,9857
00633L,富邦上証正2,40,20,20,元大-蘆洲,2023-11-16,9857
6147,頎邦,20,0,20,元大-蘆洲,2023-11-16,9857
2364,倫飛,24,5,19,元大-蘆洲,2023-11-16,9857
2417,圓剛,189,171,18,元大-蘆洲,2023-11-16,9857
1605,華新,48,30,18,元大-蘆洲,2023-11-16,9857
1515,力山,119,101,18,元大-蘆洲,2023-11-16,9857
6456,GIS-KY,26,8,18,元大-蘆洲,2023-11-16,9857
4919,新唐,20,3,17,元大-蘆洲,2023-11-16,9857
1101,台泥,18,1,17,元大-蘆洲,2023-11-16,9857
2369,菱生,21,4,17,元大-蘆洲,2023-11-16,9857
4128,中天,17,0,17,元大-蘆洲,2023-11-16,9857
5483,中美晶,17,1,16,元大-蘆洲,2023-11-16,9857
3006,晶豪科,27,12,15,元大-蘆洲,2023-11-16,9857
9925,新保,15,0,15,元大-蘆洲,2023-11-16,9857
6274,台燿,16,2,14,元大-蘆洲,2023-11-16,9857
6290,良維,14,0,14,元大-蘆洲,2023-11-16,9857
4960,誠美材,19,5,14,元大-蘆洲,2023-11-16,9857
2882,國泰金,13,0,13,元大-蘆洲,2023-11-16,9857
1504,東元,18,5,13,元大-蘆洲,2023-11-16,9857
5381,合正,14,1,13,元大-蘆洲,2023-11-16,9857
8110,華東,32,19,13,元大-蘆洲,2023-11-16,9857
2301,光寶科,12,0,12,元大-蘆洲,2023-11-16,9857
2362,藍天,12,0,12,元大-蘆洲,2023-11-16,9857
2401,凌陽,265,103,162,元大-蘆洲,2023-11-17,9857
2618,長榮航,240,97,143,元大-蘆洲,2023-11-17,9857
00680L,元大美債20正2,209,79,130,元大-蘆洲,2023-11-17,9857
00637L,元大滬深300正2,85,1,84,元大-蘆洲,2023-11-17,9857
00632R,元大台灣50反1,81,21,60,元大-蘆洲,2023-11-17,9857
1504,東元,64,9,55,元大-蘆洲,2023-11-17,9857
00929,復華台灣科技優息,90,40,50,元大-蘆洲,2023-11-17,9857
2607,榮運,55,6,49,元大-蘆洲,2023-11-17,9857
3548,兆利,59,11,48,元大-蘆洲,2023-11-17,9857
9907,統一實,41,0,41,元大-蘆洲,2023-11-17,9857
6190,萬泰科,35,0,35,元大-蘆洲,2023-11-17,9857
00720B,元大投資級公司債,35,0,35,元大-蘆洲,2023-11-17,9857
00715L,期街口布蘭特正2,35,1,34,元大-蘆洲,2023-11-17,9857
2543,皇昌,55,21,34,元大-蘆洲,2023-11-17,9857
3094,聯傑,41,8,33,元大-蘆洲,2023-11-17,9857
6274,台燿,34,1,33,元大-蘆洲,2023-11-17,9857
3041,揚智,174,142,32,元大-蘆洲,2023-11-17,9857
2331,精英,31,0,31,元大-蘆洲,2023-11-17,9857
0056,元大高股息,43,13,30,元大-蘆洲,2023-11-17,9857
6285,啟��,31,2,29,元大-蘆洲,2023-11-17,9857
4129,聯合,30,2,28,元大-蘆洲,2023-11-17,9857
00664R,國泰臺灣加權反1,25,0,25,元大-蘆洲,2023-11-17,9857
6138,茂達,34,13,21,元大-蘆洲,2023-11-17,9857
006208,富邦台50,23,3,20,元大-蘆洲,2023-11-17,9857
2313,華通,59,39,20,元大-蘆洲,2023-11-17,9857
1307,三芳,20,1,19,元大-蘆洲,2023-11-17,9857
2344,華邦電,33,14,19,元大-蘆洲,2023-11-17,9857
8034,榮群,35,17,18,元大-蘆洲,2023-11-17,9857
2457,飛宏,26,8,18,元大-蘆洲,2023-11-17,9857
6235,華孚,29,13,16,元大-蘆洲,2023-11-17,9857
2883,凱基金,31,15,16,元大-蘆洲,2023-11-17,9857
3122,笙泉,20,5,15,元大-蘆洲,2023-11-17,9857
00679B,元大美債20年,20,5,15,元大-蘆洲,2023-11-17,9857
6127,九豪,22,8,14,元大-蘆洲,2023-11-17,9857
4714,永捷,16,2,14,元大-蘆洲,2023-11-17,9857
2356,英業達,33,20,13,元大-蘆洲,2023-11-17,9857
1524,耿鼎,21,8,13,元大-蘆洲,2023-11-17,9857
1314,中石化,30,17,13,元大-蘆洲,2023-11-17,9857
2201,裕隆,21,9,12,元大-蘆洲,2023-11-17,9857
2236,百達-KY,11,0,11,元大-蘆洲,2023-11-17,9857
4743,合一,15,4,11,元大-蘆洲,2023-11-17,9857
00665L,富邦�琤肭磪囓�2,10,0,10,元大-蘆洲,2023-11-17,9857
00753L,中信中國50正2,10,0,10,元大-蘆洲,2023-11-17,9857
3491,昇達科,10,0,10,元大-蘆洲,2023-11-17,9857
3059,華晶科,11,1,10,元大-蘆洲,2023-11-17,9857
6153,嘉聯益,30,20,10,元大-蘆洲,2023-11-17,9857
2603,長榮,12,2,10,元大-蘆洲,2023-11-17,9857
00936,台新永續高息中小,10,1,9,元大-蘆洲,2023-11-17,9857
2885,元大金,14,5,9,元大-蘆洲,2023-11-17,9857
2367,燿華,24,15,9,元大-蘆洲,2023-11-17,9857
00885,富邦越南,216,3,213,元大-蘆洲,2023-11-20,9857
00878,國泰永續高股息,224,30,194,元大-蘆洲,2023-11-20,9857
00929,復華台灣科技優息,223,107,116,元大-蘆洲,2023-11-20,9857
2834,臺企銀,107,1,106,元大-蘆洲,2023-11-20,9857
0056,元大高股息,112,11,101,元大-蘆洲,2023-11-20,9857
00751B,元大AAA至A公司債,89,0,89,元大-蘆洲,2023-11-20,9857
3715,定穎投控,204,121,83,元大-蘆洲,2023-11-20,9857
3294,英濟,52,0,52,元大-蘆洲,2023-11-20,9857
3548,兆利,71,19,52,元大-蘆洲,2023-11-20,9857
3037,欣興,112,62,50,元大-蘆洲,2023-11-20,9857
1409,新纖,50,0,50,元大-蘆洲,2023-11-20,9857
8150,南茂,52,8,44,元大-蘆洲,2023-11-20,9857
2515,中工,50,6,44,元大-蘆洲,2023-11-20,9857
3260,威剛,59,22,37,元大-蘆洲,2023-11-20,9857
2610,華航,67,32,35,元大-蘆洲,2023-11-20,9857
2354,鴻準,31,0,31,元大-蘆洲,2023-11-20,9857
6243,迅杰,65,35,30,元大-蘆洲,2023-11-20,9857
1591,駿吉-KY,30,0,30,元大-蘆洲,2023-11-20,9857
00679B,元大美債20年,33,6,27,元大-蘆洲,2023-11-20,9857
3481,群創,76,50,26,元大-蘆洲,2023-11-20,9857
2314,台揚,32,8,24,元大-蘆洲,2023-11-20,9857
3645,達邁,29,5,24,元大-蘆洲,2023-11-20,9857
00919,群益台灣精選高息,81,58,23,元大-蘆洲,2023-11-20,9857
2356,英業達,76,54,22,元大-蘆洲,2023-11-20,9857
2417,圓剛,24,2,22,元大-蘆洲,2023-11-20,9857
1455,集盛,20,0,20,元大-蘆洲,2023-11-20,9857
00680L,元大美債20正2,20,0,20,元大-蘆洲,2023-11-20,9857
2537,聯上發,20,0,20,元大-蘆洲,2023-11-20,9857
6153,嘉聯益,44,24,20,元大-蘆洲,2023-11-20,9857
8227,巨有科技,23,3,20,元大-蘆洲,2023-11-20,9857
2883B,凱基金乙特,20,0,20,元大-蘆洲,2023-11-20,9857
2743,山富,25,6,19,元大-蘆洲,2023-11-20,9857
00882,中信中國高股息,20,1,19,元大-蘆洲,2023-11-20,9857
2364,倫飛,17,0,17,元大-蘆洲,2023-11-20,9857
1598,岱宇,20,3,17,元大-蘆洲,2023-11-20,9857
6156,松上,17,0,17,元大-蘆洲,2023-11-20,9857
6177,達麗,16,0,16,元大-蘆洲,2023-11-20,9857
2258,鴻華先進-創,15,0,15,元大-蘆洲,2023-11-20,9857
2241,艾姆勒,15,0,15,元大-蘆洲,2023-11-20,9857
5706,鳳凰,48,33,15,元大-蘆洲,2023-11-20,9857
5371,中光電,16,1,15,元大-蘆洲,2023-11-20,9857
2313,華通,86,71,15,元大-蘆洲,2023-11-20,9857
2408,南亞科,26,12,14,元大-蘆洲,2023-11-20,9857
2363,矽統,124,110,14,元大-蘆洲,2023-11-20,9857
6732,昇佳電子,17,4,13,元大-蘆洲,2023-11-20,9857
00687B,國泰20年美債,15,2,13,元大-蘆洲,2023-11-20,9857
1605,華新,35,22,13,元大-蘆洲,2023-11-20,9857
00753L,中信中國50正2,13,0,13,元大-蘆洲,2023-11-20,9857
3088,艾訊,13,0,13,元大-蘆洲,2023-11-20,9857
2492,華新科,13,0,13,元大-蘆洲,2023-11-20,9857
00706L,期元大S＆P日圓正2,302,0,302,元大-蘆洲,2023-11-21,9857
3041,揚智,329,138,191,元大-蘆洲,2023-11-21,9857
2618,長榮航,196,28,168,元大-蘆洲,2023-11-21,9857
2883B,凱基金乙特,89,0,89,元大-蘆洲,2023-11-21,9857
00751B,元大AAA至A公司債,84,1,83,元大-蘆洲,2023-11-21,9857
00632R,元大台灣50反1,82,10,72,元大-蘆洲,2023-11-21,9857
6282,康舒,83,14,69,元大-蘆洲,2023-11-21,9857
00712,復華富時不動產,63,3,60,元大-蘆洲,2023-11-21,9857
2316,楠梓電,71,14,57,元大-蘆洲,2023-11-21,9857
00673R,期元大S＆P原油反1,53,0,53,元大-蘆洲,2023-11-21,9857
00664R,國泰臺灣加權反1,50,2,48,元大-蘆洲,2023-11-21,9857
5351,鈺創,89,42,47,元大-蘆洲,2023-11-21,9857
00919,群益台灣精選高息,69,26,43,元大-蘆洲,2023-11-21,9857
2308,台達電,43,0,43,元大-蘆洲,2023-11-21,9857
00679B,元大美債20年,42,1,41,元大-蘆洲,2023-11-21,9857
00885,富邦越南,53,12,41,元大-蘆洲,2023-11-21,9857
2367,燿華,169,131,38,元大-蘆洲,2023-11-21,9857
2371,大同,35,1,34,元大-蘆洲,2023-11-21,9857
3059,華晶科,87,53,34,元大-蘆洲,2023-11-21,9857
2431,聯昌,31,0,31,元大-蘆洲,2023-11-21,9857
5443,均豪,30,2,28,元大-蘆洲,2023-11-21,9857
5706,鳳凰,33,6,27,元大-蘆洲,2023-11-21,9857
3036,文曄,30,4,26,元大-蘆洲,2023-11-21,9857
2377,微星,31,6,25,元大-蘆洲,2023-11-21,9857
1815,富喬,80,55,25,元大-蘆洲,2023-11-21,9857
1582,信錦,24,2,22,元大-蘆洲,2023-11-21,9857
2352,佳世達,24,3,21,元大-蘆洲,2023-11-21,9857
2401,凌陽,35,14,21,元大-蘆洲,2023-11-21,9857
2329,華泰,49,28,21,元大-蘆洲,2023-11-21,9857
2515,中工,21,0,21,元大-蘆洲,2023-11-21,9857
2534,宏盛,20,0,20,元大-蘆洲,2023-11-21,9857
2867,三商壽,27,7,20,元大-蘆洲,2023-11-21,9857
00773B,中信優先金融債,20,0,20,元大-蘆洲,2023-11-21,9857
2484,希華,19,0,19,元大-蘆洲,2023-11-21,9857
2351,順德,19,0,19,元大-蘆洲,2023-11-21,9857
9103,美德醫療-DR,19,0,19,元大-蘆洲,2023-11-21,9857
1504,東元,25,6,19,元大-蘆洲,2023-11-21,9857
00795B,中信美國公債20年,18,0,18,元大-蘆洲,2023-11-21,9857
3356,奇偶,18,0,18,元大-蘆洲,2023-11-21,9857
3149,正達,19,2,17,元大-蘆洲,2023-11-21,9857
3062,建漢,32,15,17,元大-蘆洲,2023-11-21,9857
00687B,國泰20年美債,18,1,17,元大-蘆洲,2023-11-21,9857
1524,耿鼎,42,25,17,元大-蘆洲,2023-11-21,9857
2498,宏達電,28,12,16,元大-蘆洲,2023-11-21,9857
3078,僑威,21,6,15,元大-蘆洲,2023-11-21,9857
3483,力致,32,16,16,元大-蘆洲,2023-11-21,9857
2107,厚生,15,0,15,元大-蘆洲,2023-11-21,9857
6411,晶焱,15,0,15,元大-蘆洲,2023-11-21,9857
6806,森崴能源,15,0,15,元大-蘆洲,2023-11-21,9857
2486,一詮,37,23,14,元大-蘆洲,2023-11-21,9857
2883B,凱基金乙特,200,10,190,元大-蘆洲,2023-11-22,9857
3231,緯創,206,98,108,元大-蘆洲,2023-11-22,9857
3548,兆利,107,6,101,元大-蘆洲,2023-11-22,9857
4938,和碩,102,5,97,元大-蘆洲,2023-11-22,9857
2867,三商壽,83,0,83,元大-蘆洲,2023-11-22,9857
00919,群益台灣精選高息,77,16,61,元大-蘆洲,2023-11-22,9857
6770,力積電,73,17,56,元大-蘆洲,2023-11-22,9857
3325,旭品,113,62,51,元大-蘆洲,2023-11-22,9857
00905,FT臺灣Smart,47,0,47,元大-蘆洲,2023-11-22,9857
2382,廣達,53,8,45,元大-蘆洲,2023-11-22,9857
2002,中鋼,62,17,45,元大-蘆洲,2023-11-22,9857
2356,英業達,91,47,44,元大-蘆洲,2023-11-22,9857
4129,聯合,44,1,43,元大-蘆洲,2023-11-22,9857
1504,東元,44,4,40,元大-蘆洲,2023-11-22,9857
2353,宏��,41,1,40,元大-蘆洲,2023-11-22,9857
3013,晟銘電,47,8,39,元大-蘆洲,2023-11-22,9857
00637L,元大滬深300正2,139,100,39,元大-蘆洲,2023-11-22,9857
00687B,國泰20年美債,39,2,37,元大-蘆洲,2023-11-22,9857
00720B,元大投資級公司債,36,1,35,元大-蘆洲,2023-11-22,9857
00929,復華台灣科技優息,61,27,34,元大-蘆洲,2023-11-22,9857
00632R,元大台灣50反1,30,2,28,元大-蘆洲,2023-11-22,9857
2376,技嘉,41,14,27,元大-蘆洲,2023-11-22,9857
3060,銘異,56,30,26,元大-蘆洲,2023-11-22,9857
5014,建錩,25,0,25,元大-蘆洲,2023-11-22,9857
2888,新光金,25,1,24,元大-蘆洲,2023-11-22,9857
2883,凱基金,62,38,24,元大-蘆洲,2023-11-22,9857
2402,毅嘉,30,8,22,元大-蘆洲,2023-11-22,9857
2201,裕隆,24,2,22,元大-蘆洲,2023-11-22,9857
00680L,元大美債20正2,22,0,22,元大-蘆洲,2023-11-22,9857
6125,廣運,28,7,21,元大-蘆洲,2023-11-22,9857
3019,亞光,26,5,21,元大-蘆洲,2023-11-22,9857
2014,中鴻,26,5,21,元大-蘆洲,2023-11-22,9857
6189,豐藝,20,0,20,元大-蘆洲,2023-11-22,9857
2739,寒舍,26,6,20,元大-蘆洲,2023-11-22,9857
2421,建準,21,1,20,元大-蘆洲,2023-11-22,9857
2605,新興,22,2,20,元大-蘆洲,2023-11-22,9857
5347,世界,45,25,20,元大-蘆洲,2023-11-22,9857
00673R,期元大S＆P原油反1,20,0,20,元大-蘆洲,2023-11-22,9857
4979,華星光,22,3,19,元大-蘆洲,2023-11-22,9857
6120,達運,18,0,18,元大-蘆洲,2023-11-22,9857
2258,鴻華先進-創,19,1,18,元大-蘆洲,2023-11-22,9857
2882,國泰金,19,1,18,元大-蘆洲,2023-11-22,9857
4533,協易機,17,0,17,元大-蘆洲,2023-11-22,9857
5533,皇鼎,29,12,17,元大-蘆洲,2023-11-22,9857
2388,威盛,121,104,17,元大-蘆洲,2023-11-22,9857
2547,日勝生,16,0,16,元大-蘆洲,2023-11-22,9857
00878,國泰永續高股息,73,57,16,元大-蘆洲,2023-11-22,9857
2801,彰銀,16,0,16,元大-蘆洲,2023-11-22,9857
2615,萬海,15,0,15,元大-蘆洲,2023-11-22,9857
4908,前鼎,64,49,15,元大-蘆洲,2023-11-22,9857
3362,先進光,122,15,107,元大-蘆洲,2023-11-23,9857
3122,笙泉,245,148,97,元大-蘆洲,2023-11-23,9857
3059,華晶科,117,29,88,元大-蘆洲,2023-11-23,9857
3231,緯創,123,45,78,元大-蘆洲,2023-11-23,9857
00919,群益台灣精選高息,98,22,76,元大-蘆洲,2023-11-23,9857
6139,亞翔,63,6,57,元大-蘆洲,2023-11-23,9857
00637L,元大滬深300正2,249,200,49,元大-蘆洲,2023-11-23,9857
6485,點序,60,14,46,元大-蘆洲,2023-11-23,9857
2363,矽統,188,145,43,元大-蘆洲,2023-11-23,9857
2344,華邦電,52,12,40,元大-蘆洲,2023-11-23,9857
1815,富喬,96,57,39,元大-蘆洲,2023-11-23,9857
6237,驊訊,80,42,38,元大-蘆洲,2023-11-23,9857
6282,康舒,258,224,34,元大-蘆洲,2023-11-23,9857
8110,華東,32,1,31,元大-蘆洲,2023-11-23,9857
2014,中鴻,45,14,31,元大-蘆洲,2023-11-23,9857
3264,欣銓,31,0,31,元大-蘆洲,2023-11-23,9857
5483,中美晶,30,0,30,元大-蘆洲,2023-11-23,9857
2465,麗臺,36,7,29,元大-蘆洲,2023-11-23,9857
3078,僑威,142,115,27,元大-蘆洲,2023-11-23,9857
5521,工信,54,28,26,元大-蘆洲,2023-11-23,9857
3714,富采,25,1,24,元大-蘆洲,2023-11-23,9857
9904,寶成,37,13,24,元大-蘆洲,2023-11-23,9857
3715,定穎投控,84,60,24,元大-蘆洲,2023-11-23,9857
1714,和桐,23,0,23,元大-蘆洲,2023-11-23,9857
3006,晶豪科,83,62,21,元大-蘆洲,2023-11-23,9857
00680L,元大美債20正2,46,25,21,元大-蘆洲,2023-11-23,9857
2607,榮運,20,0,20,元大-蘆洲,2023-11-23,9857
2022,聚亨,20,0,20,元大-蘆洲,2023-11-23,9857
1449,佳和,20,0,20,元大-蘆洲,2023-11-23,9857
6275,元山,22,3,19,元大-蘆洲,2023-11-23,9857
2367,燿華,28,9,19,元大-蘆洲,2023-11-23,9857
5210,寶碩,26,7,19,元大-蘆洲,2023-11-23,9857
2313,華通,89,70,19,元大-蘆洲,2023-11-23,9857
2332,友訊,18,0,18,元大-蘆洲,2023-11-23,9857
6684,安格,27,10,17,元大-蘆洲,2023-11-23,9857
1301,台塑,17,0,17,元大-蘆洲,2023-11-23,9857
4908,前鼎,37,20,17,元大-蘆洲,2023-11-23,9857
6164,華興,22,5,17,元大-蘆洲,2023-11-23,9857
6708,天擎,17,0,17,元大-蘆洲,2023-11-23,9857
3035,智原,34,17,17,元大-蘆洲,2023-11-23,9857
3706,神達,28,11,17,元大-蘆洲,2023-11-23,9857
3060,銘異,19,3,16,元大-蘆洲,2023-11-23,9857
2476,鉅祥,24,8,16,元大-蘆洲,2023-11-23,9857
6530,創威,42,27,15,元大-蘆洲,2023-11-23,9857
3402,漢科,18,3,15,元大-蘆洲,2023-11-23,9857
6156,松上,15,0,15,元大-蘆洲,2023-11-23,9857
6112,邁達特,26,11,15,元大-蘆洲,2023-11-23,9857
2354,鴻準,15,1,14,元大-蘆洲,2023-11-23,9857
1104,環泥,14,0,14,元大-蘆洲,2023-11-23,9857
6411,晶焱,26,12,14,元大-蘆洲,2023-11-23,9857
2618,長榮航,385,7,378,元大-蘆洲,2023-11-24,9857
3047,訊舟,165,1,164,元大-蘆洲,2023-11-24,9857
2888,新光金,200,59,141,元大-蘆洲,2023-11-24,9857
00885,富邦越南,135,1,134,元大-蘆洲,2023-11-24,9857
5439,高技,121,0,121,元大-蘆洲,2023-11-24,9857
2883B,凱基金乙特,100,0,100,元大-蘆洲,2023-11-24,9857
2492,華新科,145,66,79,元大-蘆洲,2023-11-24,9857
5351,鈺創,183,107,76,元大-蘆洲,2023-11-24,9857
00878,國泰永續高股息,76,4,72,元大-蘆洲,2023-11-24,9857
00934,中信成長高股息,88,21,67,元大-蘆洲,2023-11-24,9857
3706,神達,67,3,64,元大-蘆洲,2023-11-24,9857
3037,欣興,90,35,55,元大-蘆洲,2023-11-24,9857
00882,中信中國高股息,52,0,52,元大-蘆洲,2023-11-24,9857
2363,矽統,96,49,47,元大-蘆洲,2023-11-24,9857
6129,普誠,48,2,46,元大-蘆洲,2023-11-24,9857
6789,采鈺,59,13,46,元大-蘆洲,2023-11-24,9857
2331,精英,54,11,43,元大-蘆洲,2023-11-24,9857
00919,群益台灣精選高息,54,13,41,元大-蘆洲,2023-11-24,9857
6285,啟��,42,2,40,元大-蘆洲,2023-11-24,9857
5452,佶優,40,0,40,元大-蘆洲,2023-11-24,9857
3060,銘異,35,1,34,元大-蘆洲,2023-11-24,9857
00929,復華台灣科技優息,72,39,33,元大-蘆洲,2023-11-24,9857
2610,華航,46,13,33,元大-蘆洲,2023-11-24,9857
3231,緯創,57,25,32,元大-蘆洲,2023-11-24,9857
1815,富喬,78,47,31,元大-蘆洲,2023-11-24,9857
00905,FT臺灣Smart,30,0,30,元大-蘆洲,2023-11-24,9857
2883,凱基金,75,46,29,元大-蘆洲,2023-11-24,9857
00679B,元大美債20年,27,0,27,元大-蘆洲,2023-11-24,9857
5347,世界,48,24,24,元大-蘆洲,2023-11-24,9857
4726,永昕,24,0,24,元大-蘆洲,2023-11-24,9857
3006,晶豪科,39,16,23,元大-蘆洲,2023-11-24,9857
2356,英業達,70,48,22,元大-蘆洲,2023-11-24,9857
00680L,元大美債20正2,38,17,21,元大-蘆洲,2023-11-24,9857
1708,東鹼,21,0,21,元大-蘆洲,2023-11-24,9857
5706,鳳凰,21,0,21,元大-蘆洲,2023-11-24,9857
2371,大同,27,7,20,元大-蘆洲,2023-11-24,9857
8121,越峰,22,2,20,元大-蘆洲,2023-11-24,9857
4934,太極,20,0,20,元大-蘆洲,2023-11-24,9857
00632R,元大台灣50反1,20,0,20,元大-蘆洲,2023-11-24,9857
2401,凌陽,42,22,20,元大-蘆洲,2023-11-24,9857
00712,復華富時不動產,24,5,19,元大-蘆洲,2023-11-24,9857
00751B,元大AAA至A公司債,18,0,18,元大-蘆洲,2023-11-24,9857
00931B,統一美債20年,18,0,18,元大-蘆洲,2023-11-24,9857
2705,六福,18,0,18,元大-蘆洲,2023-11-24,9857
6578,達邦蛋白,18,0,18,元大-蘆洲,2023-11-24,9857
00687B,國泰20年美債,17,0,17,元大-蘆洲,2023-11-24,9857
6237,驊訊,27,10,17,元大-蘆洲,2023-11-24,9857
6117,迎廣,48,31,17,元大-蘆洲,2023-11-24,9857
00772B,中信高評級公司債,15,0,15,元大-蘆洲,2023-11-24,9857
3701,大眾控,15,0,15,元大-蘆洲,2023-11-24,9857
1795,美時,201,24,177,元大-蘆洲,2023-11-27,9857
00919,群益台灣精選高息,150,23,127,元大-蘆洲,2023-11-27,9857
00637L,元大滬深300正2,116,3,113,元大-蘆洲,2023-11-27,9857
00929,復華台灣科技優息,141,33,108,元大-蘆洲,2023-11-27,9857
1514,亞力,215,110,105,元大-蘆洲,2023-11-27,9857
2883,凱基金,122,25,97,元大-蘆洲,2023-11-27,9857
3231,緯創,162,76,86,元大-蘆洲,2023-11-27,9857
0056,元大高股息,99,24,75,元大-蘆洲,2023-11-27,9857
2303,聯電,84,18,66,元大-蘆洲,2023-11-27,9857
1785,光洋科,70,6,64,元大-蘆洲,2023-11-27,9857
2515,中工,54,0,54,元大-蘆洲,2023-11-27,9857
5351,鈺創,82,34,48,元大-蘆洲,2023-11-27,9857
3530,晶相光,46,1,45,元大-蘆洲,2023-11-27,9857
2356,英業達,89,54,35,元大-蘆洲,2023-11-27,9857
00772B,中信高評級公司債,32,0,32,元大-蘆洲,2023-11-27,9857
2610,華航,43,12,31,元大-蘆洲,2023-11-27,9857
5443,均豪,30,0,30,元大-蘆洲,2023-11-27,9857
1471,首利,29,0,29,元大-蘆洲,2023-11-27,9857
2363,矽統,73,45,28,元大-蘆洲,2023-11-27,9857
1582,信錦,27,0,27,元大-蘆洲,2023-11-27,9857
00724B,群益投資級金融債,25,0,25,元大-蘆洲,2023-11-27,9857
00715L,期街口布蘭特正2,26,2,24,元大-蘆洲,2023-11-27,9857
2355,敬鵬,28,4,24,元大-蘆洲,2023-11-27,9857
5347,世界,90,67,23,元大-蘆洲,2023-11-27,9857
00923,群益台ESG低碳50,27,4,23,元大-蘆洲,2023-11-27,9857
5439,高技,22,0,22,元大-蘆洲,2023-11-27,9857
00712,復華富時不動產,21,0,21,元大-蘆洲,2023-11-27,9857
3402,漢科,21,0,21,元大-蘆洲,2023-11-27,9857
2883B,凱基金乙特,20,0,20,元大-蘆洲,2023-11-27,9857
00934,中信成長高股息,18,0,18,元大-蘆洲,2023-11-27,9857
00687B,國泰20年美債,17,1,16,元大-蘆洲,2023-11-27,9857
2634,漢翔,25,9,16,元大-蘆洲,2023-11-27,9857
4129,聯合,20,4,16,元大-蘆洲,2023-11-27,9857
00878,國泰永續高股息,72,56,16,元大-蘆洲,2023-11-27,9857
3260,威剛,15,0,15,元大-蘆洲,2023-11-27,9857
2457,飛宏,64,49,15,元大-蘆洲,2023-11-27,9857
2359,所羅門,15,0,15,元大-蘆洲,2023-11-27,9857
3706,神達,26,11,15,元大-蘆洲,2023-11-27,9857
1342,八貫,15,0,15,元大-蘆洲,2023-11-27,9857
3707,漢磊,20,5,15,元大-蘆洲,2023-11-27,9857
2330,台積電,18,3,15,元大-蘆洲,2023-11-27,9857
4102,永日,14,0,14,元大-蘆洲,2023-11-27,9857
6754,匯僑設計,14,0,14,元大-蘆洲,2023-11-27,9857
3094,聯傑,14,0,14,元大-蘆洲,2023-11-27,9857
3705,永信,24,10,14,元大-蘆洲,2023-11-27,9857
2388,威盛,41,27,14,元大-蘆洲,2023-11-27,9857
3511,矽瑪,13,0,13,元大-蘆洲,2023-11-27,9857
6197,佳必琪,13,0,13,元大-蘆洲,2023-11-27,9857
8403,盛弘,13,0,13,元大-蘆洲,2023-11-27,9857
6799,來頡,18,5,13,元大-蘆洲,2023-11-27,9857
2367,燿華,720,27,693,元大-蘆洲,2023-11-28,9857
00919,群益台灣精選高息,409,3,406,元大-蘆洲,2023-11-28,9857
3481,群創,388,24,364,元大-蘆洲,2023-11-28,9857
2303,聯電,130,41,89,元大-蘆洲,2023-11-28,9857
4114,健喬,113,47,66,元大-蘆洲,2023-11-28,9857
2352,佳世達,62,3,59,元大-蘆洲,2023-11-28,9857
3231,緯創,100,49,51,元大-蘆洲,2023-11-28,9857
8110,華東,40,0,40,元大-蘆洲,2023-11-28,9857
2867,三商壽,37,0,37,元大-蘆洲,2023-11-28,9857
3060,銘異,36,2,34,元大-蘆洲,2023-11-28,9857
1762,中化生,51,20,31,元大-蘆洲,2023-11-28,9857
2883B,凱基金乙特,30,0,30,元大-蘆洲,2023-11-28,9857
00632R,元大台灣50反1,31,4,27,元大-蘆洲,2023-11-28,9857
2353,宏��,48,22,26,元大-蘆洲,2023-11-28,9857
6282,康舒,37,15,22,元大-蘆洲,2023-11-28,9857
2331,精英,21,0,21,元大-蘆洲,2023-11-28,9857
4770,上品,20,0,20,元大-蘆洲,2023-11-28,9857
3178,公準,21,1,20,元大-蘆洲,2023-11-28,9857
1727,中華化,20,1,19,元大-蘆洲,2023-11-28,9857
5347,世界,21,4,17,元大-蘆洲,2023-11-28,9857
00712,復華富時不動產,17,0,17,元大-蘆洲,2023-11-28,9857
1802,台玻,17,0,17,元大-蘆洲,2023-11-28,9857
6117,迎廣,17,0,17,元大-蘆洲,2023-11-28,9857
4938,和碩,25,9,16,元大-蘆洲,2023-11-28,9857
020028,元大特選電動車N,16,0,16,元大-蘆洲,2023-11-28,9857
4188,安克,14,0,14,元大-蘆洲,2023-11-28,9857
8936,國統,18,4,14,元大-蘆洲,2023-11-28,9857
6245,立端,17,4,13,元大-蘆洲,2023-11-28,9857
2405,輔信,16,3,13,元大-蘆洲,2023-11-28,9857
2059,川湖,13,0,13,元大-蘆洲,2023-11-28,9857
2801,彰銀,16,3,13,元大-蘆洲,2023-11-28,9857
2399,映泰,13,2,11,元大-蘆洲,2023-11-28,9857
1732,毛寶,16,5,11,元大-蘆洲,2023-11-28,9857
3374,精材,10,0,10,元大-蘆洲,2023-11-28,9857
1760,寶齡富錦,22,12,10,元大-蘆洲,2023-11-28,9857
8929,富堡,10,0,10,元大-蘆洲,2023-11-28,9857
3024,憶聲,15,5,10,元大-蘆洲,2023-11-28,9857
00720B,元大投資級公司債,10,0,10,元大-蘆洲,2023-11-28,9857
2515,中工,10,0,10,元大-蘆洲,2023-11-28,9857
00665L,富邦�琤肭磪囓�2,10,0,10,元大-蘆洲,2023-11-28,9857
00753L,中信中國50正2,10,0,10,元大-蘆洲,2023-11-28,9857
00679B,元大美債20年,13,3,10,元大-蘆洲,2023-11-28,9857
3673,TPK-KY,9,0,9,元大-蘆洲,2023-11-28,9857
6411,晶焱,10,1,9,元大-蘆洲,2023-11-28,9857
2375,凱美,10,1,9,元大-蘆洲,2023-11-28,9857
5439,高技,10,1,9,元大-蘆洲,2023-11-28,9857
4157,太景*-KY,17,8,9,元大-蘆洲,2023-11-28,9857
3402,漢科,12,4,8,元大-蘆洲,2023-11-28,9857
3209,全科,8,0,8,元大-蘆洲,2023-11-28,9857
6806,森崴能源,8,0,8,元大-蘆洲,2023-11-28,9857
2353,宏��,291,64,227,元大-蘆洲,2023-11-29,9857
2610,華航,143,15,128,元大-蘆洲,2023-11-29,9857
8112,至上,126,27,99,元大-蘆洲,2023-11-29,9857
00679B,元大美債20年,105,8,97,元大-蘆洲,2023-11-29,9857
00637L,元大滬深300正2,97,0,97,元大-蘆洲,2023-11-29,9857
00919,群益台灣精選高息,141,49,92,元大-蘆洲,2023-11-29,9857
00665L,富邦�琤肭磪囓�2,90,0,90,元大-蘆洲,2023-11-29,9857
3231,緯創,134,64,70,元大-蘆洲,2023-11-29,9857
00882,中信中國高股息,61,0,61,元大-蘆洲,2023-11-29,9857
2405,輔信,76,16,60,元大-蘆洲,2023-11-29,9857
2492,華新科,113,60,53,元大-蘆洲,2023-11-29,9857
00706L,期元大S＆P日圓正2,52,0,52,元大-蘆洲,2023-11-29,9857
5608,四維航,60,12,48,元大-蘆洲,2023-11-29,9857
4121,優盛,60,13,47,元大-蘆洲,2023-11-29,9857
3481,群創,58,14,44,元大-蘆洲,2023-11-29,9857
2618,長榮航,106,63,43,元大-蘆洲,2023-11-29,9857
00680L,元大美債20正2,50,12,38,元大-蘆洲,2023-11-29,9857
00650L,復華香港正2,36,0,36,元大-蘆洲,2023-11-29,9857
00712,復華富時不動產,33,1,32,元大-蘆洲,2023-11-29,9857
00632R,元大台灣50反1,36,5,31,元大-蘆洲,2023-11-29,9857
2369,菱生,116,86,30,元大-蘆洲,2023-11-29,9857
1314,中石化,30,0,30,元大-蘆洲,2023-11-29,9857
5347,世界,31,2,29,元大-蘆洲,2023-11-29,9857
3701,大眾控,34,5,29,元大-蘆洲,2023-11-29,9857
2605,新興,27,0,27,元大-蘆洲,2023-11-29,9857
6177,達麗,27,0,27,元大-蘆洲,2023-11-29,9857
2303,聯電,28,3,25,元大-蘆洲,2023-11-29,9857
1101,台泥,44,19,25,元大-蘆洲,2023-11-29,9857
2472,立隆電,45,20,25,元大-蘆洲,2023-11-29,9857
00664R,國泰臺灣加權反1,25,0,25,元大-蘆洲,2023-11-29,9857
9945,潤泰新,22,0,22,元大-蘆洲,2023-11-29,9857
00865B,國泰US短期公債,21,0,21,元大-蘆洲,2023-11-29,9857
6285,啟��,23,2,21,元大-蘆洲,2023-11-29,9857
2609,陽明,27,6,21,元大-蘆洲,2023-11-29,9857
3402,漢科,21,1,20,元大-蘆洲,2023-11-29,9857
8054,安國,83,63,20,元大-蘆洲,2023-11-29,9857
2812,台中銀,20,2,18,元大-蘆洲,2023-11-29,9857
9955,佳龍,21,4,17,元大-蘆洲,2023-11-29,9857
6811,宏�硌穈T,17,0,17,元大-蘆洲,2023-11-29,9857
00633L,富邦上証正2,17,0,17,元大-蘆洲,2023-11-29,9857
4945,陞達科技,24,7,17,元大-蘆洲,2023-11-29,9857
2890,永豐金,18,1,17,元大-蘆洲,2023-11-29,9857
2887,台新金,27,10,17,元大-蘆洲,2023-11-29,9857
2891,中信金,18,2,16,元大-蘆洲,2023-11-29,9857
2382,廣達,34,18,16,元大-蘆洲,2023-11-29,9857
5534,長虹,21,5,16,元大-蘆洲,2023-11-29,9857
5515,建國,21,5,16,元大-蘆洲,2023-11-29,9857
3122,笙泉,30,14,16,元大-蘆洲,2023-11-29,9857
1731,美吾華,15,0,15,元大-蘆洲,2023-11-29,9857
4561,健椿,15,0,15,元大-蘆洲,2023-11-29,9857
3231,緯創,201,31,170,元大-蘆洲,2023-11-30,9857
00680L,元大美債20正2,107,16,91,元大-蘆洲,2023-11-30,9857
00929,復華台灣科技優息,146,67,79,元大-蘆洲,2023-11-30,9857
1514,亞力,170,106,64,元大-蘆洲,2023-11-30,9857
2605,新興,124,62,62,元大-蘆洲,2023-11-30,9857
00934,中信成長高股息,63,4,59,元大-蘆洲,2023-11-30,9857
5439,高技,107,51,56,元大-蘆洲,2023-11-30,9857
2329,華泰,359,311,48,元大-蘆洲,2023-11-30,9857
5465,富驊,55,11,44,元大-蘆洲,2023-11-30,9857
00679B,元大美債20年,59,17,42,元大-蘆洲,2023-11-30,9857
8358,金居,44,4,40,元大-蘆洲,2023-11-30,9857
2353,宏��,105,71,34,元大-蘆洲,2023-11-30,9857
2330,台積電,37,5,32,元大-蘆洲,2023-11-30,9857
00632R,元大台灣50反1,31,0,31,元大-蘆洲,2023-11-30,9857
00882,中信中國高股息,27,0,27,元大-蘆洲,2023-11-30,9857
2337,旺宏,31,5,26,元大-蘆洲,2023-11-30,9857
2375,凱美,29,5,24,元大-蘆洲,2023-11-30,9857
2457,飛宏,28,5,23,元大-蘆洲,2023-11-30,9857
9105,泰金寶-DR,23,0,23,元大-蘆洲,2023-11-30,9857
2313,華通,95,72,23,元大-蘆洲,2023-11-30,9857
4121,優盛,22,0,22,元大-蘆洲,2023-11-30,9857
6741,91APP*-KY,20,0,20,元大-蘆洲,2023-11-30,9857
2369,菱生,20,1,19,元大-蘆洲,2023-11-30,9857
4908,前鼎,22,3,19,元大-蘆洲,2023-11-30,9857
2481,強茂,54,35,19,元大-蘆洲,2023-11-30,9857
1616,億泰,25,7,18,元大-蘆洲,2023-11-30,9857
2365,昆盈,17,0,17,元大-蘆洲,2023-11-30,9857
2465,麗臺,26,9,17,元大-蘆洲,2023-11-30,9857
3522,御嵿,16,0,16,元大-蘆洲,2023-11-30,9857
6558,興能高,22,6,16,元大-蘆洲,2023-11-30,9857
2421,建準,21,5,16,元大-蘆洲,2023-11-30,9857
2388,威盛,58,44,14,元大-蘆洲,2023-11-30,9857
2002,中鋼,25,11,14,元大-蘆洲,2023-11-30,9857
4919,新唐,22,8,14,元大-蘆洲,2023-11-30,9857
0056,元大高股息,14,0,14,元大-蘆洲,2023-11-30,9857
6547,高端疫苗,18,5,13,元大-蘆洲,2023-11-30,9857
3374,精材,14,1,13,元大-蘆洲,2023-11-30,9857
2206,三陽工業,12,0,12,元大-蘆洲,2023-11-30,9857
1752,南光,12,0,12,元大-蘆洲,2023-11-30,9857
00915,凱基優選高股息30,11,0,11,元大-蘆洲,2023-11-30,9857
8068,全達,13,2,11,元大-蘆洲,2023-11-30,9857
1909,榮成,12,1,11,元大-蘆洲,2023-11-30,9857
8150,南茂,12,1,11,元大-蘆洲,2023-11-30,9857
2201,裕隆,14,3,11,元大-蘆洲,2023-11-30,9857
00919,群益台灣精選高息,45,34,11,元大-蘆洲,2023-11-30,9857
2889,國票金,11,1,10,元大-蘆洲,2023-11-30,9857
1301,台塑,10,0,10,元大-蘆洲,2023-11-30,9857
2358,廷鑫,10,0,10,元大-蘆洲,2023-11-30,9857
3024,憶聲,10,0,10,元大-蘆洲,2023-11-30,9857
1536,和大,10,0,10,元大-蘆洲,2023-11-30,9857
2002,中鋼,530,8,522,元大-蘆洲,2023-12-01,9857
00919,群益台灣精選高息,382,35,347,元大-蘆洲,2023-12-01,9857
00680L,元大美債20正2,340,22,318,元大-蘆洲,2023-12-01,9857
00878,國泰永續高股息,250,27,223,元大-蘆洲,2023-12-01,9857
3041,揚智,239,97,142,元大-蘆洲,2023-12-01,9857
9103,美德醫療-DR,105,6,99,元大-蘆洲,2023-12-01,9857
2353,宏��,112,34,78,元大-蘆洲,2023-12-01,9857
00679B,元大美債20年,88,10,78,元大-蘆洲,2023-12-01,9857
2329,華泰,321,245,76,元大-蘆洲,2023-12-01,9857
3231,緯創,275,204,71,元大-蘆洲,2023-12-01,9857
00687B,國泰20年美債,69,3,66,元大-蘆洲,2023-12-01,9857
5465,富驊,64,4,60,元大-蘆洲,2023-12-01,9857
1605,華新,68,12,56,元大-蘆洲,2023-12-01,9857
00929,復華台灣科技優息,141,89,52,元大-蘆洲,2023-12-01,9857
2887,台新金,53,1,52,元大-蘆洲,2023-12-01,9857
4121,優盛,53,3,50,元大-蘆洲,2023-12-01,9857
1304,台聚,50,0,50,元大-蘆洲,2023-12-01,9857
00637L,元大滬深300正2,44,0,44,元大-蘆洲,2023-12-01,9857
2301,光寶科,42,7,35,元大-蘆洲,2023-12-01,9857
2888,新光金,34,0,34,元大-蘆洲,2023-12-01,9857
2356,英業達,77,43,34,元大-蘆洲,2023-12-01,9857
2314,台揚,33,0,33,元大-蘆洲,2023-12-01,9857
2408,南亞科,50,17,33,元大-蘆洲,2023-12-01,9857
3050,鈺德,46,13,33,元大-蘆洲,2023-12-01,9857
2317,鴻海,32,1,31,元大-蘆洲,2023-12-01,9857
2377,微星,35,5,30,元大-蘆洲,2023-12-01,9857
1785,光洋科,32,4,28,元大-蘆洲,2023-12-01,9857
1101,台泥,38,10,28,元大-蘆洲,2023-12-01,9857
1905,華紙,25,3,22,元大-蘆洲,2023-12-01,9857
2886,兆豐金,22,0,22,元大-蘆洲,2023-12-01,9857
2882,國泰金,22,0,22,元大-蘆洲,2023-12-01,9857
1720,生達,23,1,22,元大-蘆洲,2023-12-01,9857
4114,健喬,47,26,21,元大-蘆洲,2023-12-01,9857
6194,育富,25,4,21,元大-蘆洲,2023-12-01,9857
00715L,期街口布蘭特正2,28,8,20,元大-蘆洲,2023-12-01,9857
2365,昆盈,20,0,20,元大-蘆洲,2023-12-01,9857
00664R,國泰臺灣加權反1,20,0,20,元大-蘆洲,2023-12-01,9857
2489,瑞軒,20,0,20,元大-蘆洲,2023-12-01,9857
2883,凱基金,35,16,19,元大-蘆洲,2023-12-01,9857
2352,佳世達,27,8,19,元大-蘆洲,2023-12-01,9857
6770,力積電,22,4,18,元大-蘆洲,2023-12-01,9857
1904,正隆,20,2,18,元大-蘆洲,2023-12-01,9857
00882,中信中國高股息,17,0,17,元大-蘆洲,2023-12-01,9857
2425,承啟,17,0,17,元大-蘆洲,2023-12-01,9857
2038,海光,17,0,17,元大-蘆洲,2023-12-01,9857
2376,技嘉,26,9,17,元大-蘆洲,2023-12-01,9857
5347,世界,19,3,16,元大-蘆洲,2023-12-01,9857
2881,富邦金,19,3,16,元大-蘆洲,2023-12-01,9857
2402,毅嘉,47,31,16,元大-蘆洲,2023-12-01,9857
5328,華容,83,68,15,元大-蘆洲,2023-12-01,9857
00919,群益台灣精選高息,497,20,477,元大-蘆洲,2023-12-04,9857
00680L,元大美債20正2,271,70,201,元大-蘆洲,2023-12-04,9857
5469,瀚宇博,255,55,200,元大-蘆洲,2023-12-04,9857
00687B,國泰20年美債,153,2,151,元大-蘆洲,2023-12-04,9857
2883,凱基金,122,25,97,元大-蘆洲,2023-12-04,9857
9103,美德醫療-DR,87,4,83,元大-蘆洲,2023-12-04,9857
2353,宏��,96,28,68,元大-蘆洲,2023-12-04,9857
4167,松瑞藥,92,25,67,元大-蘆洲,2023-12-04,9857
9919,康那香,235,169,66,元大-蘆洲,2023-12-04,9857
1504,東元,66,3,63,元大-蘆洲,2023-12-04,9857
2851,中再保,60,0,60,元大-蘆洲,2023-12-04,9857
00715L,期街口布蘭特正2,59,0,59,元大-蘆洲,2023-12-04,9857
1605,華新,151,92,59,元大-蘆洲,2023-12-04,9857
1785,光洋科,75,18,57,元大-蘆洲,2023-12-04,9857
00665L,富邦�琤肭磪囓�2,51,0,51,元大-蘆洲,2023-12-04,9857
00751B,元大AAA至A公司債,61,11,50,元大-蘆洲,2023-12-04,9857
00664R,國泰臺灣加權反1,50,0,50,元大-蘆洲,2023-12-04,9857
1795,美時,71,24,47,元大-蘆洲,2023-12-04,9857
6129,普誠,47,0,47,元大-蘆洲,2023-12-04,9857
4909,新復興,90,43,47,元大-蘆洲,2023-12-04,9857
00918,大華優利高填息30,41,0,41,元大-蘆洲,2023-12-04,9857
2462,良得電,51,11,40,元大-蘆洲,2023-12-04,9857
00929,復華台灣科技優息,109,72,37,元大-蘆洲,2023-12-04,9857
3715,定穎投控,71,35,36,元大-蘆洲,2023-12-04,9857
2615,萬海,90,55,35,元大-蘆洲,2023-12-04,9857
2609,陽明,138,104,34,元大-蘆洲,2023-12-04,9857
00915,凱基優選高股息30,37,3,34,元大-蘆洲,2023-12-04,9857
2314,台揚,34,0,34,元大-蘆洲,2023-12-04,9857
3707,漢磊,33,0,33,元大-蘆洲,2023-12-04,9857
2607,榮運,44,12,32,元大-蘆洲,2023-12-04,9857
00632R,元大台灣50反1,36,5,31,元大-蘆洲,2023-12-04,9857
1708,東鹼,40,9,31,元大-蘆洲,2023-12-04,9857
1528,恩德,31,0,31,元大-蘆洲,2023-12-04,9857
8085,福華,31,2,29,元大-蘆洲,2023-12-04,9857
2887,台新金,31,2,29,元大-蘆洲,2023-12-04,9857
1701,中化,39,11,28,元大-蘆洲,2023-12-04,9857
6235,華孚,38,12,26,元大-蘆洲,2023-12-04,9857
6116,彩晶,72,46,26,元大-蘆洲,2023-12-04,9857
00720B,元大投資級公司債,28,3,25,元大-蘆洲,2023-12-04,9857
5351,鈺創,30,5,25,元大-蘆洲,2023-12-04,9857
2355,敬鵬,115,91,24,元大-蘆洲,2023-12-04,9857
2465,麗臺,32,8,24,元大-蘆洲,2023-12-04,9857
00933B,國泰10Y+金融債,30,6,24,元大-蘆洲,2023-12-04,9857
2402,毅嘉,28,5,23,元大-蘆洲,2023-12-04,9857
2369,菱生,26,4,22,元大-蘆洲,2023-12-04,9857
1905,華紙,27,5,22,元大-蘆洲,2023-12-04,9857
6443,元晶,22,2,20,元大-蘆洲,2023-12-04,9857
2356,英業達,27,7,20,元大-蘆洲,2023-12-04,9857
3576,聯合再生,26,6,20,元大-蘆洲,2023-12-04,9857
2376,技嘉,32,13,19,元大-蘆洲,2023-12-04,9857
00937B,群益ESG投等債20,385,55,330,元大-蘆洲,2023-12-05,9857
9103,美德醫療-DR,208,2,206,元大-蘆洲,2023-12-05,9857
00919,群益台灣精選高息,225,22,203,元大-蘆洲,2023-12-05,9857
1605,華新,151,14,137,元大-蘆洲,2023-12-05,9857
3489,森寶,137,0,137,元大-蘆洲,2023-12-05,9857
2601,益航,188,99,89,元大-蘆洲,2023-12-05,9857
3450,聯鈞,91,2,89,元大-蘆洲,2023-12-05,9857
00772B,中信高評級公司債,87,0,87,元大-蘆洲,2023-12-05,9857
00687B,國泰20年美債,91,4,87,元大-蘆洲,2023-12-05,9857
4938,和碩,75,0,75,元大-蘆洲,2023-12-05,9857
00882,中信中國高股息,76,3,73,元大-蘆洲,2023-12-05,9857
00637L,元大滬深300正2,263,200,63,元大-蘆洲,2023-12-05,9857
00918,大華優利高填息30,62,0,62,元大-蘆洲,2023-12-05,9857
1785,光洋科,60,0,60,元大-蘆洲,2023-12-05,9857
2344,華邦電,54,2,52,元大-蘆洲,2023-12-05,9857
9904,寶成,50,2,48,元大-蘆洲,2023-12-05,9857
00934,中信成長高股息,43,0,43,元大-蘆洲,2023-12-05,9857
6116,彩晶,43,0,43,元大-蘆洲,2023-12-05,9857
2883,凱基金,45,5,40,元大-蘆洲,2023-12-05,9857
2609,陽明,82,45,37,元大-蘆洲,2023-12-05,9857
5347,世界,41,4,37,元大-蘆洲,2023-12-05,9857
2606,裕民,238,204,34,元大-蘆洲,2023-12-05,9857
2882,國泰金,38,4,34,元大-蘆洲,2023-12-05,9857
5328,華容,35,2,33,元大-蘆洲,2023-12-05,9857
2887,台新金,31,1,30,元大-蘆洲,2023-12-05,9857
3260,威剛,32,2,30,元大-蘆洲,2023-12-05,9857
3481,群創,223,195,28,元大-蘆洲,2023-12-05,9857
00633L,富邦上証正2,26,0,26,元大-蘆洲,2023-12-05,9857
2486,一詮,35,10,25,元大-蘆洲,2023-12-05,9857
3532,台勝科,24,0,24,元大-蘆洲,2023-12-05,9857
9925,新保,23,0,23,元大-蘆洲,2023-12-05,9857
3390,旭軟,38,15,23,元大-蘆洲,2023-12-05,9857
2337,旺宏,24,1,23,元大-蘆洲,2023-12-05,9857
0056,元大高股息,29,6,23,元大-蘆洲,2023-12-05,9857
6233,旺玖,48,27,21,元大-蘆洲,2023-12-05,9857
2363,矽統,66,45,21,元大-蘆洲,2023-12-05,9857
00888,永豐台灣ESG,21,0,21,元大-蘆洲,2023-12-05,9857
4526,東台,20,0,20,元大-蘆洲,2023-12-05,9857
2399,映泰,22,2,20,元大-蘆洲,2023-12-05,9857
2603,長榮,27,7,20,元大-蘆洲,2023-12-05,9857
2303,聯電,41,21,20,元大-蘆洲,2023-12-05,9857
4931,新盛力,19,0,19,元大-蘆洲,2023-12-05,9857
2612,中航,70,51,19,元大-蘆洲,2023-12-05,9857
00650L,復華香港正2,20,2,18,元大-蘆洲,2023-12-05,9857
4414,如興,18,0,18,元大-蘆洲,2023-12-05,9857
6016,康和證,20,2,18,元大-蘆洲,2023-12-05,9857
2355,敬鵬,56,38,18,元大-蘆洲,2023-12-05,9857
1524,耿鼎,24,7,17,元大-蘆洲,2023-12-05,9857
2516,新建,22,6,16,元大-蘆洲,2023-12-05,9857
1325,恆大,16,0,16,元大-蘆洲,2023-12-05,9857
2353,宏��,315,35,280,元大-蘆洲,2023-12-06,9857
00937B,群益ESG投等債20,266,8,258,元大-蘆洲,2023-12-06,9857
00919,群益台灣精選高息,218,43,175,元大-蘆洲,2023-12-06,9857
00933B,國泰10Y+金融債,138,0,138,元大-蘆洲,2023-12-06,9857
6148,驊宏資,144,7,137,元大-蘆洲,2023-12-06,9857
3450,聯鈞,140,18,122,元大-蘆洲,2023-12-06,9857
00664R,國泰臺灣加權反1,100,0,100,元大-蘆洲,2023-12-06,9857
00751B,元大AAA至A公司債,73,8,65,元大-蘆洲,2023-12-06,9857
3481,群創,79,17,62,元大-蘆洲,2023-12-06,9857
00772B,中信高評級公司債,72,10,62,元大-蘆洲,2023-12-06,9857
1528,恩德,64,4,60,元大-蘆洲,2023-12-06,9857
00929,復華台灣科技優息,88,30,58,元大-蘆洲,2023-12-06,9857
00632R,元大台灣50反1,50,0,50,元大-蘆洲,2023-12-06,9857
1504,東元,73,28,45,元大-蘆洲,2023-12-06,9857
00637L,元大滬深300正2,264,221,43,元大-蘆洲,2023-12-06,9857
2419,仲琦,82,39,43,元大-蘆洲,2023-12-06,9857
1785,光洋科,42,2,40,元大-蘆洲,2023-12-06,9857
1319,東陽,69,29,40,元大-蘆洲,2023-12-06,9857
00720B,元大投資級公司債,39,0,39,元大-蘆洲,2023-12-06,9857
6156,松上,35,0,35,元大-蘆洲,2023-12-06,9857
3489,森寶,35,0,35,元大-蘆洲,2023-12-06,9857
2363,矽統,50,18,32,元大-蘆洲,2023-12-06,9857
2511,太子,30,0,30,元大-蘆洲,2023-12-06,9857
2313,華通,67,38,29,元大-蘆洲,2023-12-06,9857
2303,聯電,28,1,27,元大-蘆洲,2023-12-06,9857
00687B,國泰20年美債,29,3,26,元大-蘆洲,2023-12-06,9857
2601,益航,55,30,25,元大-蘆洲,2023-12-06,9857
3050,鈺德,30,5,25,元大-蘆洲,2023-12-06,9857
2371,大同,34,10,24,元大-蘆洲,2023-12-06,9857
3540,曜越,36,12,24,元大-蘆洲,2023-12-06,9857
2105,正新,25,2,23,元大-蘆洲,2023-12-06,9857
2888,新光金,23,0,23,元大-蘆洲,2023-12-06,9857
2542,興富發,22,0,22,元大-蘆洲,2023-12-06,9857
5381,合正,23,1,22,元大-蘆洲,2023-12-06,9857
1513,中興電,60,39,21,元大-蘆洲,2023-12-06,9857
3037,欣興,21,1,20,元大-蘆洲,2023-12-06,9857
1568,倉佑,27,7,20,元大-蘆洲,2023-12-06,9857
00679B,元大美債20年,55,35,20,元大-蘆洲,2023-12-06,9857
00907,永豐優息存股,25,6,19,元大-蘆洲,2023-12-06,9857
1605,華新,39,20,19,元大-蘆洲,2023-12-06,9857
6213,聯茂,22,3,19,元大-蘆洲,2023-12-06,9857
2355,敬鵬,182,163,19,元大-蘆洲,2023-12-06,9857
00931B,統一美債20年,54,35,19,元大-蘆洲,2023-12-06,9857
1506,正道,19,0,19,元大-蘆洲,2023-12-06,9857
00795B,中信美國公債20年,18,0,18,元大-蘆洲,2023-12-06,9857
1795,美時,26,8,18,元大-蘆洲,2023-12-06,9857
00936,台新永續高息中小,18,1,17,元大-蘆洲,2023-12-06,9857
2618,長榮航,31,15,16,元大-蘆洲,2023-12-06,9857
2606,裕民,69,54,15,元大-蘆洲,2023-12-06,9857
2359,所羅門,29,14,15,元大-蘆洲,2023-12-06,9857
00919,群益台灣精選高息,295,19,276,元大-蘆洲,2023-12-07,9857
2353,宏��,230,4,226,元大-蘆洲,2023-12-07,9857
00937B,群益ESG投等債20,287,172,115,元大-蘆洲,2023-12-07,9857
2344,華邦電,111,3,108,元大-蘆洲,2023-12-07,9857
3059,華晶科,107,2,105,元大-蘆洲,2023-12-07,9857
00680L,元大美債20正2,390,297,93,元大-蘆洲,2023-12-07,9857
6148,驊宏資,82,2,80,元大-蘆洲,2023-12-07,9857
00712,復華富時不動產,78,0,78,元大-蘆洲,2023-12-07,9857
2890,永豐金,108,32,76,元大-蘆洲,2023-12-07,9857
9103,美德醫療-DR,102,30,72,元大-蘆洲,2023-12-07,9857
00637L,元大滬深300正2,88,25,63,元大-蘆洲,2023-12-07,9857
00933B,國泰10Y+金融債,62,0,62,元大-蘆洲,2023-12-07,9857
00632R,元大台灣50反1,60,0,60,元大-蘆洲,2023-12-07,9857
3051,力特,80,21,59,元大-蘆洲,2023-12-07,9857
1605,華新,84,27,57,元大-蘆洲,2023-12-07,9857
2363,矽統,94,42,52,元大-蘆洲,2023-12-07,9857
1522,堤維西,84,34,50,元大-蘆洲,2023-12-07,9857
2888,新光金,49,0,49,元大-蘆洲,2023-12-07,9857
2405,輔信,48,9,39,元大-蘆洲,2023-12-07,9857
2303,聯電,43,6,37,元大-蘆洲,2023-12-07,9857
00882,中信中國高股息,43,8,35,元大-蘆洲,2023-12-07,9857
2883,凱基金,52,18,34,元大-蘆洲,2023-12-07,9857
2465,麗臺,36,2,34,元大-蘆洲,2023-12-07,9857
2883B,凱基金乙特,33,0,33,元大-蘆洲,2023-12-07,9857
2399,映泰,132,100,32,元大-蘆洲,2023-12-07,9857
2349,錸德,30,0,30,元大-蘆洲,2023-12-07,9857
00669R,國泰美國道瓊反1,30,0,30,元大-蘆洲,2023-12-07,9857
8110,華東,30,0,30,元大-蘆洲,2023-12-07,9857
00720B,元大投資級公司債,29,1,28,元大-蘆洲,2023-12-07,9857
00772B,中信高評級公司債,36,8,28,元大-蘆洲,2023-12-07,9857
1618,合機,58,30,28,元大-蘆洲,2023-12-07,9857
3013,晟銘電,57,30,27,元大-蘆洲,2023-12-07,9857
1616,億泰,32,7,25,元大-蘆洲,2023-12-07,9857
2388,威盛,67,42,25,元大-蘆洲,2023-12-07,9857
4167,松瑞藥,40,15,25,元大-蘆洲,2023-12-07,9857
2542,興富發,25,0,25,元大-蘆洲,2023-12-07,9857
1802,台玻,24,0,24,元大-蘆洲,2023-12-07,9857
00795B,中信美國公債20年,24,0,24,元大-蘆洲,2023-12-07,9857
6235,華孚,28,5,23,元大-蘆洲,2023-12-07,9857
2641,正德,46,23,23,元大-蘆洲,2023-12-07,9857
1504,東元,52,31,21,元大-蘆洲,2023-12-07,9857
2611,志信,22,1,21,元大-蘆洲,2023-12-07,9857
2002,中鋼,24,4,20,元大-蘆洲,2023-12-07,9857
00931B,統一美債20年,23,3,20,元大-蘆洲,2023-12-07,9857
00934,中信成長高股息,22,3,19,元大-蘆洲,2023-12-07,9857
00935,野村臺灣新科技50,19,0,19,元大-蘆洲,2023-12-07,9857
3260,威剛,28,10,18,元大-蘆洲,2023-12-07,9857
2371,大同,28,10,18,元大-蘆洲,2023-12-07,9857
5706,鳳凰,18,0,18,元大-蘆洲,2023-12-07,9857
00633L,富邦上証正2,18,0,18,元大-蘆洲,2023-12-07,9857
2618,長榮航,905,235,670,元大-蘆洲,2023-12-08,9857
00687B,國泰20年美債,482,4,478,元大-蘆洲,2023-12-08,9857
00929,復華台灣科技優息,318,61,257,元大-蘆洲,2023-12-08,9857
00919,群益台灣精選高息,208,22,186,元大-蘆洲,2023-12-08,9857
00937B,群益ESG投等債20,176,5,171,元大-蘆洲,2023-12-08,9857
2888,新光金,173,32,141,元大-蘆洲,2023-12-08,9857
00680L,元大美債20正2,214,83,131,元大-蘆洲,2023-12-08,9857
2605,新興,252,142,110,元大-蘆洲,2023-12-08,9857
1514,亞力,208,134,74,元大-蘆洲,2023-12-08,9857
2376,技嘉,162,96,66,元大-蘆洲,2023-12-08,9857
00679B,元大美債20年,67,7,60,元大-蘆洲,2023-12-08,9857
00882,中信中國高股息,62,2,60,元大-蘆洲,2023-12-08,9857
2358,廷鑫,61,1,60,元大-蘆洲,2023-12-08,9857
1529,樂事綠能,64,6,58,元大-蘆洲,2023-12-08,9857
00632R,元大台灣50反1,57,0,57,元大-蘆洲,2023-12-08,9857
3078,僑威,75,30,45,元大-蘆洲,2023-12-08,9857
1785,光洋科,41,0,41,元大-蘆洲,2023-12-08,9857
5608,四維航,43,4,39,元大-蘆洲,2023-12-08,9857
2380,虹光,35,0,35,元大-蘆洲,2023-12-08,9857
2303,聯電,41,7,34,元大-蘆洲,2023-12-08,9857
2002,中鋼,50,17,33,元大-蘆洲,2023-12-08,9857
6148,驊宏資,34,2,32,元大-蘆洲,2023-12-08,9857
2409,友達,33,2,31,元大-蘆洲,2023-12-08,9857
2355,敬鵬,72,42,30,元大-蘆洲,2023-12-08,9857
00706L,期元大S＆P日圓正2,31,2,29,元大-蘆洲,2023-12-08,9857
3013,晟銘電,55,26,29,元大-蘆洲,2023-12-08,9857
1528,恩德,28,1,27,元大-蘆洲,2023-12-08,9857
00751B,元大AAA至A公司債,28,2,26,元大-蘆洲,2023-12-08,9857
1815,富喬,32,7,25,元大-蘆洲,2023-12-08,9857
2314,台揚,29,4,25,元大-蘆洲,2023-12-08,9857
3041,揚智,178,154,24,元大-蘆洲,2023-12-08,9857
2882,國泰金,22,0,22,元大-蘆洲,2023-12-08,9857
00712,復華富時不動產,22,0,22,元大-蘆洲,2023-12-08,9857
3390,旭軟,26,4,22,元大-蘆洲,2023-12-08,9857
6116,彩晶,21,0,21,元大-蘆洲,2023-12-08,9857
1432,大魯閣,20,0,20,元大-蘆洲,2023-12-08,9857
2025,千興,20,0,20,元大-蘆洲,2023-12-08,9857
6271,同欣電,22,2,20,元大-蘆洲,2023-12-08,9857
4967,十銓,43,23,20,元大-蘆洲,2023-12-08,9857
00715L,期街口布蘭特正2,23,4,19,元大-蘆洲,2023-12-08,9857
1409,新纖,18,0,18,元大-蘆洲,2023-12-08,9857
00637L,元大滬深300正2,28,10,18,元大-蘆洲,2023-12-08,9857
6716,應廣,17,0,17,元大-蘆洲,2023-12-08,9857
8996,高力,22,7,15,元大-蘆洲,2023-12-08,9857
6235,華孚,23,8,15,元大-蘆洲,2023-12-08,9857
00753L,中信中國50正2,17,2,15,元大-蘆洲,2023-12-08,9857
00688L,國泰20年美債正2,17,2,15,元大-蘆洲,2023-12-08,9857
9103,美德醫療-DR,15,0,15,元大-蘆洲,2023-12-08,9857
2610,華航,39,25,14,元大-蘆洲,2023-12-08,9857
2359,所羅門,24,10,14,元大-蘆洲,2023-12-08,9857
00687B,國泰20年美債,227,0,227,元大-蘆洲,2023-12-11,9857
00919,群益台灣精選高息,249,42,207,元大-蘆洲,2023-12-11,9857
00882,中信中國高股息,203,3,200,元大-蘆洲,2023-12-11,9857
00680L,元大美債20正2,118,1,117,元大-蘆洲,2023-12-11,9857
00637L,元大滬深300正2,92,11,81,元大-蘆洲,2023-12-11,9857
4967,十銓,121,46,75,元大-蘆洲,2023-12-11,9857
00929,復華台灣科技優息,117,44,73,元大-蘆洲,2023-12-11,9857
2888,新光金,158,89,69,元大-蘆洲,2023-12-11,9857
6116,彩晶,67,0,67,元大-蘆洲,2023-12-11,9857
1785,光洋科,72,7,65,元大-蘆洲,2023-12-11,9857
6290,良維,57,4,53,元大-蘆洲,2023-12-11,9857
00937B,群益ESG投等債20,68,18,50,元大-蘆洲,2023-12-11,9857
00715L,期街口布蘭特正2,47,3,44,元大-蘆洲,2023-12-11,9857
2002,中鋼,77,33,44,元大-蘆洲,2023-12-11,9857
00934,中信成長高股息,44,2,42,元大-蘆洲,2023-12-11,9857
6285,啟��,70,29,41,元大-蘆洲,2023-12-11,9857
2388,威盛,104,64,40,元大-蘆洲,2023-12-11,9857
3312,弘憶股,40,0,40,元大-蘆洲,2023-12-11,9857
6695,芯鼎,44,7,37,元大-蘆洲,2023-12-11,9857
1524,耿鼎,133,99,34,元大-蘆洲,2023-12-11,9857
00753L,中信中國50正2,35,2,33,元大-蘆洲,2023-12-11,9857
00918,大華優利高填息30,45,13,32,元大-蘆洲,2023-12-11,9857
6148,驊宏資,33,1,32,元大-蘆洲,2023-12-11,9857
00679B,元大美債20年,39,9,30,元大-蘆洲,2023-12-11,9857
5351,鈺創,46,17,29,元大-蘆洲,2023-12-11,9857
9105,泰金寶-DR,26,0,26,元大-蘆洲,2023-12-11,9857
2610,華航,42,17,25,元大-蘆洲,2023-12-11,9857
2605,新興,90,67,23,元大-蘆洲,2023-12-11,9857
8050,廣積,23,0,23,元大-蘆洲,2023-12-11,9857
1504,東元,25,3,22,元大-蘆洲,2023-12-11,9857
1514,亞力,192,170,22,元大-蘆洲,2023-12-11,9857
4306,炎洲,23,3,20,元大-蘆洲,2023-12-11,9857
2301,光寶科,25,5,20,元大-蘆洲,2023-12-11,9857
1802,台玻,18,0,18,元大-蘆洲,2023-12-11,9857
00642U,期元大S＆P石油,18,0,18,元大-蘆洲,2023-12-11,9857
6547,高端疫苗,19,2,17,元大-蘆洲,2023-12-11,9857
00915,凱基優選高股息30,17,0,17,元大-蘆洲,2023-12-11,9857
00931B,統一美債20年,18,1,17,元大-蘆洲,2023-12-11,9857
00665L,富邦�琤肭磪囓�2,17,0,17,元大-蘆洲,2023-12-11,9857
2634,漢翔,16,0,16,元大-蘆洲,2023-12-11,9857
3013,晟銘電,29,13,16,元大-蘆洲,2023-12-11,9857
2380,虹光,16,0,16,元大-蘆洲,2023-12-11,9857
3706,神達,19,4,15,元大-蘆洲,2023-12-11,9857
2457,飛宏,28,13,15,元大-蘆洲,2023-12-11,9857
3231,緯創,56,41,15,元大-蘆洲,2023-12-11,9857
1314,中石化,14,0,14,元大-蘆洲,2023-12-11,9857
2609,陽明,33,19,14,元大-蘆洲,2023-12-11,9857
2401,凌陽,13,0,13,元大-蘆洲,2023-12-11,9857
5465,富驊,13,0,13,元大-蘆洲,2023-12-11,9857
2349,錸德,13,0,13,元大-蘆洲,2023-12-11,9857
00680L,元大美債20正2,443,22,421,元大-蘆洲,2023-12-12,9857
00919,群益台灣精選高息,385,25,360,元大-蘆洲,2023-12-12,9857
2353,宏��,164,47,117,元大-蘆洲,2023-12-12,9857
2344,華邦電,128,16,112,元大-蘆洲,2023-12-12,9857
4967,十銓,140,35,105,元大-蘆洲,2023-12-12,9857
00687B,國泰20年美債,86,10,76,元大-蘆洲,2023-12-12,9857
2002,中鋼,79,5,74,元大-蘆洲,2023-12-12,9857
8096,擎亞,89,23,66,元大-蘆洲,2023-12-12,9857
2408,南亞科,60,11,49,元大-蘆洲,2023-12-12,9857
1618,合機,214,166,48,元大-蘆洲,2023-12-12,9857
3231,緯創,92,46,46,元大-蘆洲,2023-12-12,9857
6695,芯鼎,43,8,35,元大-蘆洲,2023-12-12,9857
00679B,元大美債20年,36,2,34,元大-蘆洲,2023-12-12,9857
00937B,群益ESG投等債20,33,0,33,元大-蘆洲,2023-12-12,9857
3037,欣興,45,13,32,元大-蘆洲,2023-12-12,9857
1612,宏泰,72,41,31,元大-蘆洲,2023-12-12,9857
8011,台通,87,61,26,元大-蘆洲,2023-12-12,9857
00665L,富邦�琤肭磪囓�2,26,0,26,元大-蘆洲,2023-12-12,9857
4979,華星光,38,16,22,元大-蘆洲,2023-12-12,9857
2618,長榮航,76,54,22,元大-蘆洲,2023-12-12,9857
2486,一詮,22,0,22,元大-蘆洲,2023-12-12,9857
1312,國喬,22,0,22,元大-蘆洲,2023-12-12,9857
2615,萬海,51,30,21,元大-蘆洲,2023-12-12,9857
1324,地球,22,1,21,元大-蘆洲,2023-12-12,9857
2882,國泰金,21,1,20,元大-蘆洲,2023-12-12,9857
8034,榮群,74,54,20,元大-蘆洲,2023-12-12,9857
3530,晶相光,20,0,20,元大-蘆洲,2023-12-12,9857
2506,太設,20,0,20,元大-蘆洲,2023-12-12,9857
00751B,元大AAA至A公司債,19,1,18,元大-蘆洲,2023-12-12,9857
2363,矽統,77,59,18,元大-蘆洲,2023-12-12,9857
3499,環天科,25,7,18,元大-蘆洲,2023-12-12,9857
3024,憶聲,18,0,18,元大-蘆洲,2023-12-12,9857
00918,大華優利高填息30,46,29,17,元大-蘆洲,2023-12-12,9857
2313,華通,50,33,17,元大-蘆洲,2023-12-12,9857
3041,揚智,30,14,16,元大-蘆洲,2023-12-12,9857
3163,波若威,21,6,15,元大-蘆洲,2023-12-12,9857
2328,廣宇,15,0,15,元大-蘆洲,2023-12-12,9857
00891,中信關鍵半導體,20,5,15,元大-蘆洲,2023-12-12,9857
3287,廣寰科,24,10,14,元大-蘆洲,2023-12-12,9857
6274,台燿,14,1,13,元大-蘆洲,2023-12-12,9857
6290,良維,37,25,12,元大-蘆洲,2023-12-12,9857
3450,聯鈞,13,1,12,元大-蘆洲,2023-12-12,9857
2609,陽明,39,27,12,元大-蘆洲,2023-12-12,9857
1785,光洋科,12,0,12,元大-蘆洲,2023-12-12,9857
00772B,中信高評級公司債,12,0,12,元大-蘆洲,2023-12-12,9857
2743,山富,12,0,12,元大-蘆洲,2023-12-12,9857
3266,昇陽,12,0,12,元大-蘆洲,2023-12-12,9857
3481,群創,101,89,12,元大-蘆洲,2023-12-12,9857
2301,光寶科,14,3,11,元大-蘆洲,2023-12-12,9857
8261,富鼎,12,1,11,元大-蘆洲,2023-12-12,9857
00637L,元大滬深300正2,880,8,872,元大-蘆洲,2023-12-13,9857
00919,群益台灣精選高息,360,18,342,元大-蘆洲,2023-12-13,9857
3706,神達,292,90,202,元大-蘆洲,2023-12-13,9857
2883,凱基金,92,5,87,元大-蘆洲,2023-12-13,9857
00937B,群益ESG投等債20,85,0,85,元大-蘆洲,2023-12-13,9857
00687B,國泰20年美債,91,10,81,元大-蘆洲,2023-12-13,9857
00918,大華優利高填息30,80,0,80,元大-蘆洲,2023-12-13,9857
9105,泰金寶-DR,206,129,77,元大-蘆洲,2023-12-13,9857
00933B,國泰10Y+金融債,74,0,74,元大-蘆洲,2023-12-13,9857
00715L,期街口布蘭特正2,77,10,67,元大-蘆洲,2023-12-13,9857
6116,彩晶,60,0,60,元大-蘆洲,2023-12-13,9857
00642U,期元大S＆P石油,58,0,58,元大-蘆洲,2023-12-13,9857
00929,復華台灣科技優息,191,140,51,元大-蘆洲,2023-12-13,9857
9103,美德醫療-DR,50,0,50,元大-蘆洲,2023-12-13,9857
1514,亞力,122,75,47,元大-蘆洲,2023-12-13,9857
00882,中信中國高股息,62,15,47,元大-蘆洲,2023-12-13,9857
2882,國泰金,47,1,46,元大-蘆洲,2023-12-13,9857
3037,欣興,55,9,46,元大-蘆洲,2023-12-13,9857
2002,中鋼,56,11,45,元大-蘆洲,2023-12-13,9857
2892,第一金,42,1,41,元大-蘆洲,2023-12-13,9857
2399,映泰,68,28,40,元大-蘆洲,2023-12-13,9857
2605,新興,52,14,38,元大-蘆洲,2023-12-13,9857
3294,英濟,34,0,34,元大-蘆洲,2023-12-13,9857
4906,正文,54,20,34,元大-蘆洲,2023-12-13,9857
8096,擎亞,51,18,33,元大-蘆洲,2023-12-13,9857
3231,緯創,132,99,33,元大-蘆洲,2023-12-13,9857
00934,中信成長高股息,31,0,31,元大-蘆洲,2023-12-13,9857
2888,新光金,27,0,27,元大-蘆洲,2023-12-13,9857
00720B,元大投資級公司債,30,4,26,元大-蘆洲,2023-12-13,9857
5483,中美晶,27,1,26,元大-蘆洲,2023-12-13,9857
00679B,元大美債20年,27,2,25,元大-蘆洲,2023-12-13,9857
2867,三商壽,24,0,24,元大-蘆洲,2023-12-13,9857
2105,正新,24,1,23,元大-蘆洲,2023-12-13,9857
3694,海華,37,14,23,元大-蘆洲,2023-12-13,9857
2890,永豐金,29,6,23,元大-蘆洲,2023-12-13,9857
4543,萬在,25,3,22,元大-蘆洲,2023-12-13,9857
2641,正德,24,3,21,元大-蘆洲,2023-12-13,9857
2402,毅嘉,23,2,21,元大-蘆洲,2023-12-13,9857
3548,兆利,21,1,20,元大-蘆洲,2023-12-13,9857
1540,喬福,20,0,20,元大-蘆洲,2023-12-13,9857
4113,聯上,20,0,20,元大-蘆洲,2023-12-13,9857
2104,國際中橡,20,0,20,元大-蘆洲,2023-12-13,9857
2201,裕隆,21,2,19,元大-蘆洲,2023-12-13,9857
2515,中工,60,41,19,元大-蘆洲,2023-12-13,9857
00680L,元大美債20正2,74,56,18,元大-蘆洲,2023-12-13,9857
2634,漢翔,46,30,16,元大-蘆洲,2023-12-13,9857
2365,昆盈,43,27,16,元大-蘆洲,2023-12-13,9857
00936,台新永續高息中小,35,20,15,元大-蘆洲,2023-12-13,9857
1717,長興,15,0,15,元大-蘆洲,2023-12-13,9857
1504,東元,18,3,15,元大-蘆洲,2023-12-13,9857
00933B,國泰10Y+金融債,224,14,210,元大-蘆洲,2023-12-14,9857
00885,富邦越南,210,50,160,元大-蘆洲,2023-12-14,9857
00929,復華台灣科技優息,233,74,159,元大-蘆洲,2023-12-14,9857
00688L,國泰20年美債正2,141,0,141,元大-蘆洲,2023-12-14,9857
2449,京元電子,166,37,129,元大-蘆洲,2023-12-14,9857
1529,樂事綠能,119,4,115,元大-蘆洲,2023-12-14,9857
00637L,元大滬深300正2,165,70,95,元大-蘆洲,2023-12-14,9857
9945,潤泰新,102,8,94,元大-蘆洲,2023-12-14,9857
00664R,國泰臺灣加權反1,90,0,90,元大-蘆洲,2023-12-14,9857
00687B,國泰20年美債,97,12,85,元大-蘆洲,2023-12-14,9857
00918,大華優利高填息30,172,101,71,元大-蘆洲,2023-12-14,9857
3211,順達,61,2,59,元大-蘆洲,2023-12-14,9857
3051,力特,125,70,55,元大-蘆洲,2023-12-14,9857
2365,昆盈,107,53,54,元大-蘆洲,2023-12-14,9857
3294,英濟,52,0,52,元大-蘆洲,2023-12-14,9857
00882,中信中國高股息,49,0,49,元大-蘆洲,2023-12-14,9857
3390,旭軟,71,22,49,元大-蘆洲,2023-12-14,9857
8096,擎亞,51,5,46,元大-蘆洲,2023-12-14,9857
2332,友訊,53,8,45,元大-蘆洲,2023-12-14,9857
5426,振發,76,31,45,元大-蘆洲,2023-12-14,9857
2425,承啟,50,10,40,元大-蘆洲,2023-12-14,9857
2354,鴻準,40,1,39,元大-蘆洲,2023-12-14,9857
3715,定穎投控,90,52,38,元大-蘆洲,2023-12-14,9857
4908,前鼎,44,7,37,元大-蘆洲,2023-12-14,9857
00680L,元大美債20正2,155,121,34,元大-蘆洲,2023-12-14,9857
3266,昇陽,32,0,32,元大-蘆洲,2023-12-14,9857
3380,明泰,33,1,32,元大-蘆洲,2023-12-14,9857
00936,台新永續高息中小,31,0,31,元大-蘆洲,2023-12-14,9857
2002,中鋼,33,4,29,元大-蘆洲,2023-12-14,9857
6127,九豪,52,24,28,元大-蘆洲,2023-12-14,9857
3149,正達,27,0,27,元大-蘆洲,2023-12-14,9857
00934,中信成長高股息,34,9,25,元大-蘆洲,2023-12-14,9857
8011,台通,33,9,24,元大-蘆洲,2023-12-14,9857
00720B,元大投資級公司債,27,3,24,元大-蘆洲,2023-12-14,9857
00937B,群益ESG投等債20,80,56,24,元大-蘆洲,2023-12-14,9857
2610,華航,27,6,21,元大-蘆洲,2023-12-14,9857
00795B,中信美國公債20年,21,0,21,元大-蘆洲,2023-12-14,9857
2301,光寶科,31,10,21,元大-蘆洲,2023-12-14,9857
5521,工信,91,71,20,元大-蘆洲,2023-12-14,9857
2913,農林,20,0,20,元大-蘆洲,2023-12-14,9857
2883B,凱基金乙特,20,0,20,元大-蘆洲,2023-12-14,9857
6244,茂迪,24,5,19,元大-蘆洲,2023-12-14,9857
1609,大亞,23,5,18,元大-蘆洲,2023-12-14,9857
2324,仁寶,63,46,17,元大-蘆洲,2023-12-14,9857
3005,神基,28,12,16,元大-蘆洲,2023-12-14,9857
5328,華容,19,3,16,元大-蘆洲,2023-12-14,9857
00633L,富邦上証正2,16,0,16,元大-蘆洲,2023-12-14,9857
6112,邁達特,16,1,15,元大-蘆洲,2023-12-14,9857
2369,菱生,16,1,15,元大-蘆洲,2023-12-14,9857
5355,佳總,15,0,15,元大-蘆洲,2023-12-14,9857
2356,英業達,932,427,505,元大-蘆洲,2023-12-15,9857
00688L,國泰20年美債正2,271,0,271,元大-蘆洲,2023-12-15,9857
00919,群益台灣精選高息,571,313,258,元大-蘆洲,2023-12-15,9857
00936,台新永續高息中小,166,0,166,元大-蘆洲,2023-12-15,9857
2363,矽統,510,357,153,元大-蘆洲,2023-12-15,9857
3532,台勝科,165,12,153,元大-蘆洲,2023-12-15,9857
2481,強茂,152,21,131,元大-蘆洲,2023-12-15,9857
00937B,群益ESG投等債20,160,40,120,元大-蘆洲,2023-12-15,9857
3211,順達,98,5,93,元大-蘆洲,2023-12-15,9857
2888,新光金,92,17,75,元大-蘆洲,2023-12-15,9857
00918,大華優利高填息30,93,22,71,元大-蘆洲,2023-12-15,9857
00720B,元大投資級公司債,78,9,69,元大-蘆洲,2023-12-15,9857
00632R,元大台灣50反1,63,0,63,元大-蘆洲,2023-12-15,9857
00934,中信成長高股息,66,15,51,元大-蘆洲,2023-12-15,9857
3231,緯創,77,26,51,元大-蘆洲,2023-12-15,9857
3041,揚智,79,32,47,元大-蘆洲,2023-12-15,9857
00878,國泰永續高股息,127,86,41,元大-蘆洲,2023-12-15,9857
00915,凱基優選高股息30,54,13,41,元大-蘆洲,2023-12-15,9857
00664R,國泰臺灣加權反1,40,0,40,元大-蘆洲,2023-12-15,9857
3481,群創,47,8,39,元大-蘆洲,2023-12-15,9857
00637L,元大滬深300正2,189,151,38,元大-蘆洲,2023-12-15,9857
1101,台泥,44,7,37,元大-蘆洲,2023-12-15,9857
2419,仲琦,37,3,34,元大-蘆洲,2023-12-15,9857
2641,正德,33,0,33,元大-蘆洲,2023-12-15,9857
5439,高技,32,0,32,元大-蘆洲,2023-12-15,9857
2388,威盛,114,83,31,元大-蘆洲,2023-12-15,9857
5880,合庫金,31,0,31,元大-蘆洲,2023-12-15,9857
5521,工信,40,8,32,元大-蘆洲,2023-12-15,9857
2401,凌陽,38,7,31,元大-蘆洲,2023-12-15,9857
00931B,統一美債20年,77,49,28,元大-蘆洲,2023-12-15,9857
4915,致伸,44,17,27,元大-蘆洲,2023-12-15,9857
2010,春源,30,4,26,元大-蘆洲,2023-12-15,9857
3712,永崴投控,50,25,25,元大-蘆洲,2023-12-15,9857
3265,台星科,32,9,23,元大-蘆洲,2023-12-15,9857
2913,農林,22,0,22,元大-蘆洲,2023-12-15,9857
2301,光寶科,23,2,21,元大-蘆洲,2023-12-15,9857
1720,生達,21,0,21,元大-蘆洲,2023-12-15,9857
8201,無敵,20,0,20,元大-蘆洲,2023-12-15,9857
2317,鴻海,20,1,19,元大-蘆洲,2023-12-15,9857
4157,太景*-KY,20,1,19,元大-蘆洲,2023-12-15,9857
2201,裕隆,18,0,18,元大-蘆洲,2023-12-15,9857
2402,毅嘉,19,2,17,元大-蘆洲,2023-12-15,9857
1805,寶徠,20,3,17,元大-蘆洲,2023-12-15,9857
2498,宏達電,25,8,17,元大-蘆洲,2023-12-15,9857
2329,華泰,50,33,17,元大-蘆洲,2023-12-15,9857
6176,瑞儀,16,0,16,元大-蘆洲,2023-12-15,9857
2472,立隆電,20,4,16,元大-蘆洲,2023-12-15,9857
2359,所羅門,20,4,16,元大-蘆洲,2023-12-15,9857
6235,華孚,24,9,15,元大-蘆洲,2023-12-15,9857
1582,信錦,28,13,15,元大-蘆洲,2023-12-15,9857
00680L,元大美債20正2,1139,147,992,元大-蘆洲,2023-12-18,9857
00688L,國泰20年美債正2,547,29,518,元大-蘆洲,2023-12-18,9857
2014,中鴻,664,352,312,元大-蘆洲,2023-12-18,9857
00919,群益台灣精選高息,327,129,198,元大-蘆洲,2023-12-18,9857
2618,長榮航,289,105,184,元大-蘆洲,2023-12-18,9857
00929,復華台灣科技優息,328,160,168,元大-蘆洲,2023-12-18,9857
00937B,群益ESG投等債20,203,60,143,元大-蘆洲,2023-12-18,9857
00931B,統一美債20年,125,17,108,元大-蘆洲,2023-12-18,9857
4167,松瑞藥,112,29,83,元大-蘆洲,2023-12-18,9857
3047,訊舟,79,3,76,元大-蘆洲,2023-12-18,9857
6282,康舒,79,4,75,元大-蘆洲,2023-12-18,9857
00712,復華富時不動產,122,53,69,元大-蘆洲,2023-12-18,9857
1907,永豐餘,68,0,68,元大-蘆洲,2023-12-18,9857
2605,新興,74,9,65,元大-蘆洲,2023-12-18,9857
2392,正崴,65,6,59,元大-蘆洲,2023-12-18,9857
2356,英業達,310,252,58,元大-蘆洲,2023-12-18,9857
00882,中信中國高股息,59,3,56,元大-蘆洲,2023-12-18,9857
00679B,元大美債20年,133,77,56,元大-蘆洲,2023-12-18,9857
00687B,國泰20年美債,59,10,49,元大-蘆洲,2023-12-18,9857
2610,華航,80,32,48,元大-蘆洲,2023-12-18,9857
1810,和成,45,0,45,元大-蘆洲,2023-12-18,9857
2377,微星,43,0,43,元大-蘆洲,2023-12-18,9857
2498,宏達電,72,33,39,元大-蘆洲,2023-12-18,9857
2022,聚亨,73,34,39,元大-蘆洲,2023-12-18,9857
2890,永豐金,38,1,37,元大-蘆洲,2023-12-18,9857
00933B,國泰10Y+金融債,48,11,37,元大-蘆洲,2023-12-18,9857
00751B,元大AAA至A公司債,57,21,36,元大-蘆洲,2023-12-18,9857
2515,中工,37,3,34,元大-蘆洲,2023-12-18,9857
3264,欣銓,36,3,33,元大-蘆洲,2023-12-18,9857
3372,典範,34,1,33,元大-蘆洲,2023-12-18,9857
6005,群益證,34,1,33,元大-蘆洲,2023-12-18,9857
2331,精英,32,0,32,元大-蘆洲,2023-12-18,9857
8112,至上,35,11,24,元大-蘆洲,2023-12-18,9857
5498,凱崴,24,0,24,元大-蘆洲,2023-12-18,9857
2303,聯電,60,36,24,元大-蘆洲,2023-12-18,9857
00915,凱基優選高股息30,23,0,23,元大-蘆洲,2023-12-18,9857
2355,敬鵬,24,1,23,元大-蘆洲,2023-12-18,9857
1721,三晃,22,0,22,元大-蘆洲,2023-12-18,9857
00632R,元大台灣50反1,22,0,22,元大-蘆洲,2023-12-18,9857
2027,大成鋼,41,19,22,元大-蘆洲,2023-12-18,9857
2363,矽統,118,97,21,元大-蘆洲,2023-12-18,9857
2465,麗臺,21,0,21,元大-蘆洲,2023-12-18,9857
3178,公準,21,0,21,元大-蘆洲,2023-12-18,9857
6230,尼得科超眾,21,1,20,元大-蘆洲,2023-12-18,9857
2883,凱基金,20,0,20,元大-蘆洲,2023-12-18,9857
3211,順達,25,6,19,元大-蘆洲,2023-12-18,9857
4129,聯合,21,2,19,元大-蘆洲,2023-12-18,9857
6140,訊達,18,0,18,元大-蘆洲,2023-12-18,9857
2359,所羅門,24,8,16,元大-蘆洲,2023-12-18,9857
00900,富邦特選高股息30,19,3,16,元大-蘆洲,2023-12-18,9857
00688L,國泰20年美債正2,328,0,328,元大-蘆洲,2023-12-19,9857
2609,陽明,609,380,229,元大-蘆洲,2023-12-19,9857
00885,富邦越南,118,0,118,元大-蘆洲,2023-12-19,9857
2618,長榮航,95,16,79,元大-蘆洲,2023-12-19,9857
00687B,國泰20年美債,79,15,64,元大-蘆洲,2023-12-19,9857
2615,萬海,110,47,63,元大-蘆洲,2023-12-19,9857
00934,中信成長高股息,73,12,61,元大-蘆洲,2023-12-19,9857
4171,瑞基,53,2,51,元大-蘆洲,2023-12-19,9857
2303,聯電,74,25,49,元大-蘆洲,2023-12-19,9857
00936,台新永續高息中小,47,0,47,元大-蘆洲,2023-12-19,9857
0056,元大高股息,58,19,39,元大-蘆洲,2023-12-19,9857
2356,英業達,301,263,38,元大-蘆洲,2023-12-19,9857
6116,彩晶,53,17,36,元大-蘆洲,2023-12-19,9857
3042,晶技,37,5,32,元大-蘆洲,2023-12-19,9857
6443,元晶,31,0,31,元大-蘆洲,2023-12-19,9857
00882,中信中國高股息,30,2,28,元大-蘆洲,2023-12-19,9857
00918,大華優利高填息30,40,13,27,元大-蘆洲,2023-12-19,9857
2377,微星,31,3,28,元大-蘆洲,2023-12-19,9857
2481,強茂,28,1,27,元大-蘆洲,2023-12-19,9857
2607,榮運,33,6,27,元大-蘆洲,2023-12-19,9857
1504,東元,41,15,26,元大-蘆洲,2023-12-19,9857
2007,燁興,26,1,25,元大-蘆洲,2023-12-19,9857
3294,英濟,30,5,25,元大-蘆洲,2023-12-19,9857
2888,新光金,28,3,25,元大-蘆洲,2023-12-19,9857
2344,華邦電,51,27,24,元大-蘆洲,2023-12-19,9857
4128,中天,23,0,23,元大-蘆洲,2023-12-19,9857
1608,華榮,24,1,23,元大-蘆洲,2023-12-19,9857
3707,漢磊,29,8,21,元大-蘆洲,2023-12-19,9857
00712,復華富時不動產,60,40,20,元大-蘆洲,2023-12-19,9857
2882,國泰金,20,0,20,元大-蘆洲,2023-12-19,9857
1709,和益,20,0,20,元大-蘆洲,2023-12-19,9857
4564,元翎,20,0,20,元大-蘆洲,2023-12-19,9857
2610,華航,32,12,20,元大-蘆洲,2023-12-19,9857
2887,台新金,30,11,19,元大-蘆洲,2023-12-19,9857
2313,華通,35,16,19,元大-蘆洲,2023-12-19,9857
00915,凱基優選高股息30,28,9,19,元大-蘆洲,2023-12-19,9857
5351,鈺創,25,7,18,元大-蘆洲,2023-12-19,9857
1314,中石化,52,34,18,元大-蘆洲,2023-12-19,9857
8924,大田,17,0,17,元大-蘆洲,2023-12-19,9857
2324,仁寶,60,43,17,元大-蘆洲,2023-12-19,9857
00888,永豐台灣ESG,16,0,16,元大-蘆洲,2023-12-19,9857
3105,穩懋,17,2,15,元大-蘆洲,2023-12-19,9857
3231,緯創,70,56,14,元大-蘆洲,2023-12-19,9857
00713,元大台灣高息低波,18,4,14,元大-蘆洲,2023-12-19,9857
00637L,元大滬深300正2,105,91,14,元大-蘆洲,2023-12-19,9857
5011,久陽,14,0,14,元大-蘆洲,2023-12-19,9857
00753L,中信中國50正2,13,0,13,元大-蘆洲,2023-12-19,9857
8201,無敵,15,2,13,元大-蘆洲,2023-12-19,9857
2349,錸德,13,0,13,元大-蘆洲,2023-12-19,9857
2032,新鋼,28,15,13,元大-蘆洲,2023-12-19,9857
00632R,元大台灣50反1,646,0,646,元大-蘆洲,2023-12-20,9857
2002,中鋼,445,7,438,元大-蘆洲,2023-12-20,9857
00919,群益台灣精選高息,208,49,159,元大-蘆洲,2023-12-20,9857
00934,中信成長高股息,110,0,110,元大-蘆洲,2023-12-20,9857
2618,長榮航,319,220,99,元大-蘆洲,2023-12-20,9857
00929,復華台灣科技優息,98,23,75,元大-蘆洲,2023-12-20,9857
00937B,群益ESG投等債20,101,31,70,元大-蘆洲,2023-12-20,9857
8096,擎亞,60,0,60,元大-蘆洲,2023-12-20,9857
2031,新光鋼,69,20,49,元大-蘆洲,2023-12-20,9857
00687B,國泰20年美債,60,12,48,元大-蘆洲,2023-12-20,9857
2312,金寶,129,88,41,元大-蘆洲,2023-12-20,9857
00680L,元大美債20正2,57,17,40,元大-蘆洲,2023-12-20,9857
2892,第一金,45,5,40,元大-蘆洲,2023-12-20,9857
9919,康那香,38,3,35,元大-蘆洲,2023-12-20,9857
00715L,期街口布蘭特正2,47,13,34,元大-蘆洲,2023-12-20,9857
2344,華邦電,31,0,31,元大-蘆洲,2023-12-20,9857
3605,宏致,30,0,30,元大-蘆洲,2023-12-20,9857
3481,群創,53,23,30,元大-蘆洲,2023-12-20,9857
3450,聯鈞,34,5,29,元大-蘆洲,2023-12-20,9857
6285,啟��,63,36,27,元大-蘆洲,2023-12-20,9857
5351,鈺創,28,1,27,元大-蘆洲,2023-12-20,9857
00882,中信中國高股息,26,0,26,元大-蘆洲,2023-12-20,9857
4113,聯上,25,0,25,元大-蘆洲,2023-12-20,9857
6219,富旺,25,0,25,元大-蘆洲,2023-12-20,9857
1504,東元,28,4,24,元大-蘆洲,2023-12-20,9857
1905,華紙,51,27,24,元大-蘆洲,2023-12-20,9857
2888,新光金,24,0,24,元大-蘆洲,2023-12-20,9857
2501,國建,26,3,23,元大-蘆洲,2023-12-20,9857
00751B,元大AAA至A公司債,23,0,23,元大-蘆洲,2023-12-20,9857
2371,大同,53,33,20,元大-蘆洲,2023-12-20,9857
2845,遠東銀,30,10,20,元大-蘆洲,2023-12-20,9857
8215,明基材,24,4,20,元大-蘆洲,2023-12-20,9857
2891,中信金,20,0,20,元大-蘆洲,2023-12-20,9857
8942,森鉅,19,0,19,元大-蘆洲,2023-12-20,9857
00935,野村臺灣新科技50,19,1,18,元大-蘆洲,2023-12-20,9857
00857B,永豐20年美公債,18,0,18,元大-蘆洲,2023-12-20,9857
00933B,國泰10Y+金融債,19,3,16,元大-蘆洲,2023-12-20,9857
5011,久陽,15,0,15,元大-蘆洲,2023-12-20,9857
3163,波若威,20,5,15,元大-蘆洲,2023-12-20,9857
8054,安國,30,15,15,元大-蘆洲,2023-12-20,9857
00752,中信中國50,15,0,15,元大-蘆洲,2023-12-20,9857
5371,中光電,15,0,15,元大-蘆洲,2023-12-20,9857
2387,精元,21,7,14,元大-蘆洲,2023-12-20,9857
6244,茂迪,25,11,14,元大-蘆洲,2023-12-20,9857
4904,遠傳,14,0,14,元大-蘆洲,2023-12-20,9857
2882,國泰金,13,0,13,元大-蘆洲,2023-12-20,9857
2481,強茂,13,0,13,元大-蘆洲,2023-12-20,9857
1781,合世,20,7,13,元大-蘆洲,2023-12-20,9857
2323,中環,33,21,12,元大-蘆洲,2023-12-20,9857
00936,台新永續高息中小,12,0,12,元大-蘆洲,2023-12-20,9857
00688L,國泰20年美債正2,389,2,387,元大-蘆洲,2023-12-21,9857
00919,群益台灣精選高息,347,39,308,元大-蘆洲,2023-12-21,9857
00929,復華台灣科技優息,284,146,138,元大-蘆洲,2023-12-21,9857
3532,台勝科,70,8,62,元大-蘆洲,2023-12-21,9857
2355,敬鵬,51,0,51,元大-蘆洲,2023-12-21,9857
2617,台航,52,3,49,元大-蘆洲,2023-12-21,9857
2610,華航,73,28,45,元大-蘆洲,2023-12-21,9857
2303,聯電,64,23,41,元大-蘆洲,2023-12-21,9857
2882,國泰金,39,0,39,元大-蘆洲,2023-12-21,9857
4114,健喬,43,5,38,元大-蘆洲,2023-12-21,9857
3704,合勤控,42,4,38,元大-蘆洲,2023-12-21,9857
3188,鑫龍騰,35,0,35,元大-蘆洲,2023-12-21,9857
00753L,中信中國50正2,34,0,34,元大-蘆洲,2023-12-21,9857
1504,東元,47,15,32,元大-蘆洲,2023-12-21,9857
00632R,元大台灣50反1,35,4,31,元大-蘆洲,2023-12-21,9857
1718,中纖,30,0,30,元大-蘆洲,2023-12-21,9857
2506,太設,35,5,30,元大-蘆洲,2023-12-21,9857
4915,致伸,28,1,27,元大-蘆洲,2023-12-21,9857
8088,品安,66,39,27,元大-蘆洲,2023-12-21,9857
4938,和碩,31,4,27,元大-蘆洲,2023-12-21,9857
2515,中工,375,349,26,元大-蘆洲,2023-12-21,9857
2801,彰銀,25,0,25,元大-蘆洲,2023-12-21,9857
2883,凱基金,23,0,23,元大-蘆洲,2023-12-21,9857
00936,台新永續高息中小,22,0,22,元大-蘆洲,2023-12-21,9857
2388,威盛,41,21,20,元大-蘆洲,2023-12-21,9857
1104,環泥,20,0,20,元大-蘆洲,2023-12-21,9857
6248,沛波,20,0,20,元大-蘆洲,2023-12-21,9857
6233,旺玖,27,8,19,元大-蘆洲,2023-12-21,9857
2330,台積電,19,0,19,元大-蘆洲,2023-12-21,9857
00888,永豐台灣ESG,19,0,19,元大-蘆洲,2023-12-21,9857
00878,國泰永續高股息,49,31,18,元大-蘆洲,2023-12-21,9857
2038,海光,29,12,17,元大-蘆洲,2023-12-21,9857
2888,新光金,19,3,16,元大-蘆洲,2023-12-21,9857
1325,恆大,111,95,16,元大-蘆洲,2023-12-21,9857
3218,大學光,17,1,16,元大-蘆洲,2023-12-21,9857
5469,瀚宇博,15,0,15,元大-蘆洲,2023-12-21,9857
2201,裕隆,21,6,15,元大-蘆洲,2023-12-21,9857
2032,新鋼,15,1,14,元大-蘆洲,2023-12-21,9857
6243,迅杰,23,9,14,元大-蘆洲,2023-12-21,9857
2885,元大金,14,0,14,元大-蘆洲,2023-12-21,9857
1732,毛寶,57,43,14,元大-蘆洲,2023-12-21,9857
2331,精英,155,142,13,元大-蘆洲,2023-12-21,9857
3622,洋華,13,0,13,元大-蘆洲,2023-12-21,9857
00772B,中信高評級公司債,13,0,13,元大-蘆洲,2023-12-21,9857
2739,寒舍,13,1,12,元大-蘆洲,2023-12-21,9857
1616,億泰,12,0,12,元大-蘆洲,2023-12-21,9857
2009,第一銅,13,1,12,元大-蘆洲,2023-12-21,9857
8110,華東,44,32,12,元大-蘆洲,2023-12-21,9857
2891,中信金,13,2,11,元大-蘆洲,2023-12-21,9857
6443,元晶,41,30,11,元大-蘆洲,2023-12-21,9857
00882,中信中國高股息,256,11,245,元大-蘆洲,2023-12-22,9857
00687B,國泰20年美債,145,13,132,元大-蘆洲,2023-12-22,9857
2606,裕民,118,12,106,元大-蘆洲,2023-12-22,9857
2609,陽明,703,627,76,元大-蘆洲,2023-12-22,9857
00929,復華台灣科技優息,86,24,62,元大-蘆洲,2023-12-22,9857
5355,佳總,50,0,50,元大-蘆洲,2023-12-22,9857
00919,群益台灣精選高息,91,41,50,元大-蘆洲,2023-12-22,9857
1528,恩德,40,0,40,元大-蘆洲,2023-12-22,9857
9105,泰金寶-DR,65,27,38,元大-蘆洲,2023-12-22,9857
5009,榮剛,55,17,38,元大-蘆洲,2023-12-22,9857
3051,力特,54,19,35,元大-蘆洲,2023-12-22,9857
3188,鑫龍騰,35,0,35,元大-蘆洲,2023-12-22,9857
1608,華榮,35,2,33,元大-蘆洲,2023-12-22,9857
6443,元晶,35,11,24,元大-蘆洲,2023-12-22,9857
3706,神達,39,19,20,元大-蘆洲,2023-12-22,9857
2425,承啟,18,0,18,元大-蘆洲,2023-12-22,9857
00936,台新永續高息中小,17,0,17,元大-蘆洲,2023-12-22,9857
3231,緯創,74,57,17,元大-蘆洲,2023-12-22,9857
5469,瀚宇博,16,0,16,元大-蘆洲,2023-12-22,9857
2387,精元,18,2,16,元大-蘆洲,2023-12-22,9857
6153,嘉聯益,16,0,16,元大-蘆洲,2023-12-22,9857
8112,至上,23,7,16,元大-蘆洲,2023-12-22,9857
2888,新光金,16,0,16,元大-蘆洲,2023-12-22,9857
3450,聯鈞,16,1,15,元大-蘆洲,2023-12-22,9857
6285,啟��,41,26,15,元大-蘆洲,2023-12-22,9857
00931B,統一美債20年,19,5,14,元大-蘆洲,2023-12-22,9857
8215,明基材,25,11,14,元大-蘆洲,2023-12-22,9857
2201,裕隆,17,4,13,元大-蘆洲,2023-12-22,9857
2323,中環,30,17,13,元大-蘆洲,2023-12-22,9857
2506,太設,36,23,13,元大-蘆洲,2023-12-22,9857
4906,正文,23,10,13,元大-蘆洲,2023-12-22,9857
3037,欣興,73,61,12,元大-蘆洲,2023-12-22,9857
3622,洋華,13,1,12,元大-蘆洲,2023-12-22,9857
1471,首利,12,0,12,元大-蘆洲,2023-12-22,9857
6182,合晶,13,1,12,元大-蘆洲,2023-12-22,9857
3006,晶豪科,47,35,12,元大-蘆洲,2023-12-22,9857
3372,典範,11,0,11,元大-蘆洲,2023-12-22,9857
00753L,中信中國50正2,10,0,10,元大-蘆洲,2023-12-22,9857
2883,凱基金,10,0,10,元大-蘆洲,2023-12-22,9857
1785,光洋科,12,2,10,元大-蘆洲,2023-12-22,9857
3363,上詮,11,1,10,元大-蘆洲,2023-12-22,9857
4113,聯上,10,0,10,元大-蘆洲,2023-12-22,9857
2852,第一保,10,0,10,元大-蘆洲,2023-12-22,9857
8926,台汽電,10,0,10,元大-蘆洲,2023-12-22,9857
00877,復華中國5G,10,0,10,元大-蘆洲,2023-12-22,9857
6129,普誠,40,30,10,元大-蘆洲,2023-12-22,9857
6538,倉和,10,0,10,元大-蘆洲,2023-12-22,9857
8096,擎亞,10,0,10,元大-蘆洲,2023-12-22,9857
6505,台塑化,9,0,9,元大-蘆洲,2023-12-22,9857
1815,富喬,10,1,9,元大-蘆洲,2023-12-22,9857
00919,群益台灣精選高息,205,19,186,元大-蘆洲,2023-12-25,9857
2609,陽明,718,533,185,元大-蘆洲,2023-12-25,9857
00676R,富邦臺灣加權反1,140,0,140,元大-蘆洲,2023-12-25,9857
3481,群創,320,216,104,元大-蘆洲,2023-12-25,9857
00937B,群益ESG投等債20,103,0,103,元大-蘆洲,2023-12-25,9857
00929,復華台灣科技優息,98,13,85,元大-蘆洲,2023-12-25,9857
00680L,元大美債20正2,98,24,74,元大-蘆洲,2023-12-25,9857
00720B,元大投資級公司債,70,5,65,元大-蘆洲,2023-12-25,9857
00687B,國泰20年美債,68,10,58,元大-蘆洲,2023-12-25,9857
2603,長榮,138,82,56,元大-蘆洲,2023-12-25,9857
3037,欣興,58,3,55,元大-蘆洲,2023-12-25,9857
1440,南紡,51,0,51,元大-蘆洲,2023-12-25,9857
00933B,國泰10Y+金融債,52,9,43,元大-蘆洲,2023-12-25,9857
2618,長榮航,72,29,43,元大-蘆洲,2023-12-25,9857
3013,晟銘電,73,32,41,元大-蘆洲,2023-12-25,9857
00688L,國泰20年美債正2,41,0,41,元大-蘆洲,2023-12-25,9857
00934,中信成長高股息,39,0,39,元大-蘆洲,2023-12-25,9857
2421,建準,56,19,37,元大-蘆洲,2023-12-25,9857
2002,中鋼,42,9,33,元大-蘆洲,2023-12-25,9857
8088,品安,58,25,33,元大-蘆洲,2023-12-25,9857
00679B,元大美債20年,37,4,33,元大-蘆洲,2023-12-25,9857
2331,精英,56,24,32,元大-蘆洲,2023-12-25,9857
00900,富邦特選高股息30,28,0,28,元大-蘆洲,2023-12-25,9857
2515,中工,159,132,27,元大-蘆洲,2023-12-25,9857
2362,藍天,31,5,26,元大-蘆洲,2023-12-25,9857
2498,宏達電,60,34,26,元大-蘆洲,2023-12-25,9857
00637L,元大滬深300正2,60,35,25,元大-蘆洲,2023-12-25,9857
2615,萬海,103,78,25,元大-蘆洲,2023-12-25,9857
2324,仁寶,112,88,24,元大-蘆洲,2023-12-25,9857
00936,台新永續高息中小,22,0,22,元大-蘆洲,2023-12-25,9857
3483,力致,21,0,21,元大-蘆洲,2023-12-25,9857
1314,中石化,21,0,21,元大-蘆洲,2023-12-25,9857
2371,大同,22,1,21,元大-蘆洲,2023-12-25,9857
1434,福懋,20,0,20,元大-蘆洲,2023-12-25,9857
1528,恩德,20,0,20,元大-蘆洲,2023-12-25,9857
00650L,復華香港正2,20,0,20,元大-蘆洲,2023-12-25,9857
2915,潤泰全,20,0,20,元大-蘆洲,2023-12-25,9857
00753L,中信中國50正2,21,1,20,元大-蘆洲,2023-12-25,9857
4128,中天,21,1,20,元大-蘆洲,2023-12-25,9857
6233,旺玖,24,6,18,元大-蘆洲,2023-12-25,9857
2883,凱基金,17,0,17,元大-蘆洲,2023-12-25,9857
4162,智擎,18,1,17,元大-蘆洲,2023-12-25,9857
6733,博晟生醫,19,2,17,元大-蘆洲,2023-12-25,9857
1409,新纖,16,0,16,元大-蘆洲,2023-12-25,9857
1337,再生-KY,15,0,15,元大-蘆洲,2023-12-25,9857
6111,大宇資,17,2,15,元大-蘆洲,2023-12-25,9857
6176,瑞儀,15,0,15,元大-蘆洲,2023-12-25,9857
00922,國泰台灣領袖50,14,0,14,元大-蘆洲,2023-12-25,9857
2023,燁輝,21,7,14,元大-蘆洲,2023-12-25,9857
3373,熱映,14,0,14,元大-蘆洲,2023-12-25,9857
00929,復華台灣科技優息,657,145,512,元大-蘆洲,2023-12-26,9857
6116,彩晶,486,54,432,元大-蘆洲,2023-12-26,9857
00882,中信中國高股息,94,0,94,元大-蘆洲,2023-12-26,9857
00664R,國泰臺灣加權反1,80,0,80,元大-蘆洲,2023-12-26,9857
00637L,元大滬深300正2,96,32,64,元大-蘆洲,2023-12-26,9857
6285,啟��,84,24,60,元大-蘆洲,2023-12-26,9857
00680L,元大美債20正2,93,40,53,元大-蘆洲,2023-12-26,9857
2596,綠意,47,0,47,元大-蘆洲,2023-12-26,9857
2547,日勝生,30,0,30,元大-蘆洲,2023-12-26,9857
00632R,元大台灣50反1,63,33,30,元大-蘆洲,2023-12-26,9857
2363,矽統,36,11,25,元大-蘆洲,2023-12-26,9857
6290,良維,25,1,24,元大-蘆洲,2023-12-26,9857
3122,笙泉,25,2,23,元大-蘆洲,2023-12-26,9857
2388,威盛,61,39,22,元大-蘆洲,2023-12-26,9857
2618,長榮航,46,24,22,元大-蘆洲,2023-12-26,9857
2607,榮運,21,0,21,元大-蘆洲,2023-12-26,9857
2402,毅嘉,46,26,20,元大-蘆洲,2023-12-26,9857
2007,燁興,20,0,20,元大-蘆洲,2023-12-26,9857
1528,恩德,20,0,20,元大-蘆洲,2023-12-26,9857
00795B,中信美國公債20年,20,0,20,元大-蘆洲,2023-12-26,9857
2610,華航,56,37,19,元大-蘆洲,2023-12-26,9857
00687B,國泰20年美債,19,0,19,元大-蘆洲,2023-12-26,9857
3376,新日興,19,1,18,元大-蘆洲,2023-12-26,9857
1608,華榮,18,0,18,元大-蘆洲,2023-12-26,9857
8112,至上,17,0,17,元大-蘆洲,2023-12-26,9857
2449,京元電子,20,4,16,元大-蘆洲,2023-12-26,9857
00720B,元大投資級公司債,18,3,15,元大-蘆洲,2023-12-26,9857
2501,國建,14,0,14,元大-蘆洲,2023-12-26,9857
2891,中信金,21,7,14,元大-蘆洲,2023-12-26,9857
1519,華城,24,11,13,元大-蘆洲,2023-12-26,9857
2014,中鴻,21,8,13,元大-蘆洲,2023-12-26,9857
6443,元晶,13,0,13,元大-蘆洲,2023-12-26,9857
2367,燿華,13,0,13,元大-蘆洲,2023-12-26,9857
2427,三商電,14,2,12,元大-蘆洲,2023-12-26,9857
6668,中揚光,12,0,12,元大-蘆洲,2023-12-26,9857
3037,欣興,23,11,12,元大-蘆洲,2023-12-26,9857
4906,正文,12,0,12,元大-蘆洲,2023-12-26,9857
6485,點序,18,7,11,元大-蘆洲,2023-12-26,9857
8085,福華,13,2,11,元大-蘆洲,2023-12-26,9857
3443,創意,12,2,10,元大-蘆洲,2023-12-26,9857
2369,菱生,13,3,10,元大-蘆洲,2023-12-26,9857
4129,聯合,10,0,10,元大-蘆洲,2023-12-26,9857
9105,泰金寶-DR,15,5,10,元大-蘆洲,2023-12-26,9857
4979,華星光,20,10,10,元大-蘆洲,2023-12-26,9857
1714,和桐,10,0,10,元大-蘆洲,2023-12-26,9857
8215,明基材,18,8,10,元大-蘆洲,2023-12-26,9857
4113,聯上,10,0,10,元大-蘆洲,2023-12-26,9857
5521,工信,11,1,10,元大-蘆洲,2023-12-26,9857
5398,慕康生醫,10,0,10,元大-蘆洲,2023-12-26,9857
3588,通嘉,53,44,9,元大-蘆洲,2023-12-26,9857
00929,復華台灣科技優息,696,61,635,元大-蘆洲,2023-12-27,9857
00919,群益台灣精選高息,297,47,250,元大-蘆洲,2023-12-27,9857
00937B,群益ESG投等債20,214,3,211,元大-蘆洲,2023-12-27,9857
00632R,元大台灣50反1,230,32,198,元大-蘆洲,2023-12-27,9857
00664R,國泰臺灣加權反1,160,0,160,元大-蘆洲,2023-12-27,9857
6116,彩晶,100,21,79,元大-蘆洲,2023-12-27,9857
2392,正崴,67,0,67,元大-蘆洲,2023-12-27,9857
2610,華航,77,16,61,元大-蘆洲,2023-12-27,9857
2515,中工,80,19,61,元大-蘆洲,2023-12-27,9857
3346,麗清,61,5,56,元大-蘆洲,2023-12-27,9857
00688L,國泰20年美債正2,62,7,55,元大-蘆洲,2023-12-27,9857
2888,新光金,67,16,51,元大-蘆洲,2023-12-27,9857
2501,國建,49,0,49,元大-蘆洲,2023-12-27,9857
2353,宏��,245,197,48,元大-蘆洲,2023-12-27,9857
2405,輔信,146,100,46,元大-蘆洲,2023-12-27,9857
2388,威盛,53,12,41,元大-蘆洲,2023-12-27,9857
8050,廣積,41,1,40,元大-蘆洲,2023-12-27,9857
00687B,國泰20年美債,69,29,40,元大-蘆洲,2023-12-27,9857
2324,仁寶,372,336,36,元大-蘆洲,2023-12-27,9857
6668,中揚光,37,1,36,元大-蘆洲,2023-12-27,9857
9904,寶成,30,2,28,元大-蘆洲,2023-12-27,9857
00715L,期街口布蘭特正2,52,25,27,元大-蘆洲,2023-12-27,9857
4979,華星光,29,3,26,元大-蘆洲,2023-12-27,9857
6139,亞翔,30,5,25,元大-蘆洲,2023-12-27,9857
8936,國統,30,7,23,元大-蘆洲,2023-12-27,9857
5347,世界,37,15,22,元大-蘆洲,2023-12-27,9857
1528,恩德,21,0,21,元大-蘆洲,2023-12-27,9857
2007,燁興,23,2,21,元大-蘆洲,2023-12-27,9857
00637L,元大滬深300正2,135,115,20,元大-蘆洲,2023-12-27,9857
00722B,群益投資級電信債,20,0,20,元大-蘆洲,2023-12-27,9857
1409,新纖,20,0,20,元大-蘆洲,2023-12-27,9857
00882,中信中國高股息,20,1,19,元大-蘆洲,2023-12-27,9857
00679B,元大美債20年,20,2,18,元大-蘆洲,2023-12-27,9857
00753L,中信中國50正2,20,2,18,元大-蘆洲,2023-12-27,9857
2365,昆盈,30,12,18,元大-蘆洲,2023-12-27,9857
3694,海華,33,16,17,元大-蘆洲,2023-12-27,9857
4906,正文,17,0,17,元大-蘆洲,2023-12-27,9857
00933B,國泰10Y+金融債,17,1,16,元大-蘆洲,2023-12-27,9857
2329,華泰,16,0,16,元大-蘆洲,2023-12-27,9857
3024,憶聲,16,1,15,元大-蘆洲,2023-12-27,9857
2812,台中銀,15,0,15,元大-蘆洲,2023-12-27,9857
2615,萬海,74,60,14,元大-蘆洲,2023-12-27,9857
6282,康舒,14,1,13,元大-蘆洲,2023-12-27,9857
6182,合晶,18,5,13,元大-蘆洲,2023-12-27,9857
6271,同欣電,12,0,12,元大-蘆洲,2023-12-27,9857
2603,長榮,28,16,12,元大-蘆洲,2023-12-27,9857
1434,福懋,12,0,12,元大-蘆洲,2023-12-27,9857
1524,耿鼎,12,0,12,元大-蘆洲,2023-12-27,9857
00915,凱基優選高股息30,11,0,11,元大-蘆洲,2023-12-27,9857
2883B,凱基金乙特,11,0,11,元大-蘆洲,2023-12-27,9857
00929,復華台灣科技優息,687,43,644,元大-蘆洲,2023-12-28,9857
00937B,群益ESG投等債20,209,4,205,元大-蘆洲,2023-12-28,9857
3706,神達,296,167,129,元大-蘆洲,2023-12-28,9857
00919,群益台灣精選高息,159,31,128,元大-蘆洲,2023-12-28,9857
2303,聯電,270,147,123,元大-蘆洲,2023-12-28,9857
2888,新光金,104,2,102,元大-蘆洲,2023-12-28,9857
2356,英業達,337,245,92,元大-蘆洲,2023-12-28,9857
00712,復華富時不動產,94,3,91,元大-蘆洲,2023-12-28,9857
1529,樂事綠能,92,8,84,元大-蘆洲,2023-12-28,9857
6285,啟��,97,14,83,元大-蘆洲,2023-12-28,9857
3006,晶豪科,81,13,68,元大-蘆洲,2023-12-28,9857
2436,偉詮電,100,34,66,元大-蘆洲,2023-12-28,9857
00934,中信成長高股息,58,1,57,元大-蘆洲,2023-12-28,9857
5522,遠雄,50,0,50,元大-蘆洲,2023-12-28,9857
1514,亞力,100,51,49,元大-蘆洲,2023-12-28,9857
2355,敬鵬,59,23,36,元大-蘆洲,2023-12-28,9857
00632R,元大台灣50反1,41,5,36,元大-蘆洲,2023-12-28,9857
1524,耿鼎,37,2,35,元大-蘆洲,2023-12-28,9857
00665L,富邦�琤肭磪囓�2,35,0,35,元大-蘆洲,2023-12-28,9857
1582,信錦,41,12,29,元大-蘆洲,2023-12-28,9857
00936,台新永續高息中小,28,0,28,元大-蘆洲,2023-12-28,9857
6129,普誠,41,13,28,元大-蘆洲,2023-12-28,9857
2603,長榮,52,24,28,元大-蘆洲,2023-12-28,9857
5355,佳總,31,3,28,元大-蘆洲,2023-12-28,9857
9105,泰金寶-DR,26,0,26,元大-蘆洲,2023-12-28,9857
3041,揚智,26,1,25,元大-蘆洲,2023-12-28,9857
6276,安鈦克,25,0,25,元大-蘆洲,2023-12-28,9857
00915,凱基優選高股息30,24,0,24,元大-蘆洲,2023-12-28,9857
3231,緯創,62,38,24,元大-蘆洲,2023-12-28,9857
3078,僑威,33,10,23,元大-蘆洲,2023-12-28,9857
3094,聯傑,25,2,23,元大-蘆洲,2023-12-28,9857
1616,億泰,27,4,23,元大-蘆洲,2023-12-28,9857
4979,華星光,27,7,20,元大-蘆洲,2023-12-28,9857
00664R,國泰臺灣加權反1,20,0,20,元大-蘆洲,2023-12-28,9857
2369,菱生,20,0,20,元大-蘆洲,2023-12-28,9857
2007,燁興,20,0,20,元大-蘆洲,2023-12-28,9857
1815,富喬,20,0,20,元大-蘆洲,2023-12-28,9857
6187,萬潤,26,6,20,元大-蘆洲,2023-12-28,9857
2324,仁寶,196,177,19,元大-蘆洲,2023-12-28,9857
2359,所羅門,30,11,19,元大-蘆洲,2023-12-28,9857
1618,合機,41,24,17,元大-蘆洲,2023-12-28,9857
00918,大華優利高填息30,18,0,18,元大-蘆洲,2023-12-28,9857
5011,久陽,15,0,15,元大-蘆洲,2023-12-28,9857
3545,敦泰,21,7,14,元大-蘆洲,2023-12-28,9857
4938,和碩,14,1,13,元大-蘆洲,2023-12-28,9857
2105,正新,15,2,13,元大-蘆洲,2023-12-28,9857
3673,TPK-KY,13,0,13,元大-蘆洲,2023-12-28,9857
1513,中興電,28,15,13,元大-蘆洲,2023-12-28,9857
2388,威盛,22,10,12,元大-蘆洲,2023-12-28,9857
2101,南港,22,10,12,元大-蘆洲,2023-12-28,9857
00929,復華台灣科技優息,513,69,444,元大-蘆洲,2023-12-29,9857
00937B,群益ESG投等債20,243,0,243,元大-蘆洲,2023-12-29,9857
6116,彩晶,224,34,190,元大-蘆洲,2023-12-29,9857
00637L,元大滬深300正2,329,174,155,元大-蘆洲,2023-12-29,9857
2610,華航,334,206,128,元大-蘆洲,2023-12-29,9857
6215,和椿,100,5,95,元大-蘆洲,2023-12-29,9857
2356,英業達,245,151,94,元大-蘆洲,2023-12-29,9857
00687B,國泰20年美債,70,2,68,元大-蘆洲,2023-12-29,9857
00688L,國泰20年美債正2,66,0,66,元大-蘆洲,2023-12-29,9857
00882,中信中國高股息,85,21,64,元大-蘆洲,2023-12-29,9857
00933B,國泰10Y+金融債,73,10,63,元大-蘆洲,2023-12-29,9857
2609,陽明,242,185,57,元大-蘆洲,2023-12-29,9857
1529,樂事綠能,48,2,46,元大-蘆洲,2023-12-29,9857
6196,帆宣,42,3,39,元大-蘆洲,2023-12-29,9857
2913,農林,37,0,37,元大-蘆洲,2023-12-29,9857
8011,台通,64,34,30,元大-蘆洲,2023-12-29,9857
6275,元山,30,0,30,元大-蘆洲,2023-12-29,9857
2002,中鋼,37,8,29,元大-蘆洲,2023-12-29,9857
2353,宏��,124,96,28,元大-蘆洲,2023-12-29,9857
2324,仁寶,184,156,28,元大-蘆洲,2023-12-29,9857
00900,富邦特選高股息30,29,1,28,元大-蘆洲,2023-12-29,9857
9945,潤泰新,74,48,26,元大-蘆洲,2023-12-29,9857
1519,華城,82,57,25,元大-蘆洲,2023-12-29,9857
00715L,期街口布蘭特正2,24,0,24,元大-蘆洲,2023-12-29,9857
6187,萬潤,27,3,24,元大-蘆洲,2023-12-29,9857
6125,廣運,53,30,23,元大-蘆洲,2023-12-29,9857
2206,三陽工業,22,0,22,元大-蘆洲,2023-12-29,9857
2615,萬海,41,20,21,元大-蘆洲,2023-12-29,9857
1528,恩德,20,0,20,元大-蘆洲,2023-12-29,9857
2359,所羅門,20,0,20,元大-蘆洲,2023-12-29,9857
1815,富喬,23,4,19,元大-蘆洲,2023-12-29,9857
00915,凱基優選高股息30,18,1,17,元大-蘆洲,2023-12-29,9857
4924,欣厚-KY,17,0,17,元大-蘆洲,2023-12-29,9857
2515,中工,44,27,17,元大-蘆洲,2023-12-29,9857
1785,光洋科,17,1,16,元大-蘆洲,2023-12-29,9857
6285,啟��,25,9,16,元大-蘆洲,2023-12-29,9857
00679B,元大美債20年,29,13,16,元大-蘆洲,2023-12-29,9857
2867,三商壽,15,0,15,元大-蘆洲,2023-12-29,9857
1605,華新,17,2,15,元大-蘆洲,2023-12-29,9857
3548,兆利,21,8,13,元大-蘆洲,2023-12-29,9857
2481,強茂,21,8,13,元大-蘆洲,2023-12-29,9857
6443,元晶,13,1,12,元大-蘆洲,2023-12-29,9857
8096,擎亞,38,26,12,元大-蘆洲,2023-12-29,9857
2363,矽統,26,15,11,元大-蘆洲,2023-12-29,9857
00934,中信成長高股息,16,5,11,元大-蘆洲,2023-12-29,9857
6179,亞通,14,3,11,元大-蘆洲,2023-12-29,9857
1616,億泰,22,11,11,元大-蘆洲,2023-12-29,9857
5469,瀚宇博,16,5,11,元大-蘆洲,2023-12-29,9857
1503,士電,33,22,11,元大-蘆洲,2023-12-29,9857
00712,復華富時不動產,40,30,10,元大-蘆洲,2023-12-29,9857
00637L,元大滬深300正2,787,55,732,元大-蘆洲,2024-01-02,9857
00937B,群益ESG投等債20,416,34,382,元大-蘆洲,2024-01-02,9857
2890,永豐金,388,15,373,元大-蘆洲,2024-01-02,9857
00929,復華台灣科技優息,439,102,337,元大-蘆洲,2024-01-02,9857
00712,復華富時不動產,302,75,227,元大-蘆洲,2024-01-02,9857
00878,國泰永續高股息,268,90,178,元大-蘆洲,2024-01-02,9857
00680L,元大美債20正2,173,2,171,元大-蘆洲,2024-01-02,9857
00919,群益台灣精選高息,169,74,95,元大-蘆洲,2024-01-02,9857
00687B,國泰20年美債,87,15,72,元大-蘆洲,2024-01-02,9857
3231,緯創,228,160,68,元大-蘆洲,2024-01-02,9857
2353,宏��,196,135,61,元大-蘆洲,2024-01-02,9857
00688L,國泰20年美債正2,54,0,54,元大-蘆洲,2024-01-02,9857
2607,榮運,54,6,48,元大-蘆洲,2024-01-02,9857
00934,中信成長高股息,46,3,43,元大-蘆洲,2024-01-02,9857
00679B,元大美債20年,41,1,40,元大-蘆洲,2024-01-02,9857
2344,華邦電,105,68,37,元大-蘆洲,2024-01-02,9857
00918,大華優利高填息30,52,19,33,元大-蘆洲,2024-01-02,9857
0056,元大高股息,59,29,30,元大-蘆洲,2024-01-02,9857
2303,聯電,86,56,30,元大-蘆洲,2024-01-02,9857
8046,南電,29,1,28,元大-蘆洲,2024-01-02,9857
2867,三商壽,28,0,28,元大-蘆洲,2024-01-02,9857
00632R,元大台灣50反1,25,0,25,元大-蘆洲,2024-01-02,9857
6182,合晶,25,1,24,元大-蘆洲,2024-01-02,9857
00720B,元大投資級公司債,24,0,24,元大-蘆洲,2024-01-02,9857
6112,邁達特,23,0,23,元大-蘆洲,2024-01-02,9857
6668,中揚光,23,1,22,元大-蘆洲,2024-01-02,9857
2352,佳世達,84,63,21,元大-蘆洲,2024-01-02,9857
6770,力積電,25,5,20,元大-蘆洲,2024-01-02,9857
2382,廣達,30,11,19,元大-蘆洲,2024-01-02,9857
00885,富邦越南,20,1,19,元大-蘆洲,2024-01-02,9857
1102,亞泥,18,0,18,元大-蘆洲,2024-01-02,9857
1513,中興電,24,6,18,元大-蘆洲,2024-01-02,9857
5351,鈺創,22,5,17,元大-蘆洲,2024-01-02,9857
3264,欣銓,17,0,17,元大-蘆洲,2024-01-02,9857
8110,華東,17,1,16,元大-蘆洲,2024-01-02,9857
3260,威剛,17,1,16,元大-蘆洲,2024-01-02,9857
00933B,國泰10Y+金融債,36,20,16,元大-蘆洲,2024-01-02,9857
1605,華新,26,11,15,元大-蘆洲,2024-01-02,9857
2615,萬海,102,87,15,元大-蘆洲,2024-01-02,9857
00795B,中信美國公債20年,14,0,14,元大-蘆洲,2024-01-02,9857
5009,榮剛,14,0,14,元大-蘆洲,2024-01-02,9857
3622,洋華,16,2,14,元大-蘆洲,2024-01-02,9857
2329,華泰,16,3,13,元大-蘆洲,2024-01-02,9857
2355,敬鵬,15,2,13,元大-蘆洲,2024-01-02,9857
6233,旺玖,17,4,13,元大-蘆洲,2024-01-02,9857
00882,中信中國高股息,20,7,13,元大-蘆洲,2024-01-02,9857
00751B,元大AAA至A公司債,13,2,11,元大-蘆洲,2024-01-02,9857
6290,良維,32,22,10,元大-蘆洲,2024-01-02,9857
2883,凱基金,10,0,10,元大-蘆洲,2024-01-02,9857
5011,久陽,10,0,10,元大-蘆洲,2024-01-02,9857
2618,長榮航,752,111,641,元大-蘆洲,2024-01-03,9857
00929,復華台灣科技優息,464,30,434,元大-蘆洲,2024-01-03,9857
00919,群益台灣精選高息,295,66,229,元大-蘆洲,2024-01-03,9857
2331,精英,209,52,157,元大-蘆洲,2024-01-03,9857
0056,元大高股息,164,19,145,元大-蘆洲,2024-01-03,9857
00637L,元大滬深300正2,193,89,104,元大-蘆洲,2024-01-03,9857
2610,華航,192,91,101,元大-蘆洲,2024-01-03,9857
2371,大同,106,10,96,元大-蘆洲,2024-01-03,9857
2303,聯電,150,56,94,元大-蘆洲,2024-01-03,9857
2353,宏��,168,88,80,元大-蘆洲,2024-01-03,9857
1605,華新,87,16,71,元大-蘆洲,2024-01-03,9857
6164,華興,67,5,62,元大-蘆洲,2024-01-03,9857
2890,永豐金,51,0,51,元大-蘆洲,2024-01-03,9857
2603,長榮,104,55,49,元大-蘆洲,2024-01-03,9857
2498,宏達電,78,31,47,元大-蘆洲,2024-01-03,9857
3481,群創,74,29,45,元大-蘆洲,2024-01-03,9857
8110,華東,45,2,43,元大-蘆洲,2024-01-03,9857
2356,英業達,153,112,41,元大-蘆洲,2024-01-03,9857
2101,南港,43,4,39,元大-蘆洲,2024-01-03,9857
3260,威剛,47,10,37,元大-蘆洲,2024-01-03,9857
00934,中信成長高股息,59,23,36,元大-蘆洲,2024-01-03,9857
00891,中信關鍵半導體,37,3,34,元大-蘆洲,2024-01-03,9857
00900,富邦特選高股息30,36,3,33,元大-蘆洲,2024-01-03,9857
2392,正崴,33,0,33,元大-蘆洲,2024-01-03,9857
00712,復華富時不動產,33,1,32,元大-蘆洲,2024-01-03,9857
2014,中鴻,33,1,32,元大-蘆洲,2024-01-03,9857
3703,欣陸,32,0,32,元大-蘆洲,2024-01-03,9857
00679B,元大美債20年,39,8,31,元大-蘆洲,2024-01-03,9857
00715L,期街口布蘭特正2,31,1,30,元大-蘆洲,2024-01-03,9857
1785,光洋科,30,0,30,元大-蘆洲,2024-01-03,9857
2511,太子,30,0,30,元大-蘆洲,2024-01-03,9857
2455,全新,30,2,28,元大-蘆洲,2024-01-03,9857
3231,緯創,72,44,28,元大-蘆洲,2024-01-03,9857
6668,中揚光,30,3,27,元大-蘆洲,2024-01-03,9857
0050,元大台灣50,29,2,27,元大-蘆洲,2024-01-03,9857
2481,強茂,32,6,26,元大-蘆洲,2024-01-03,9857
2324,仁寶,74,48,26,元大-蘆洲,2024-01-03,9857
3105,穩懋,24,0,24,元大-蘆洲,2024-01-03,9857
00687B,國泰20年美債,25,1,24,元大-蘆洲,2024-01-03,9857
2425,承啟,24,0,24,元大-蘆洲,2024-01-03,9857
6689,伊雲谷,25,1,24,元大-蘆洲,2024-01-03,9857
00713,元大台灣高息低波,29,5,24,元大-蘆洲,2024-01-03,9857
4938,和碩,23,0,23,元大-蘆洲,2024-01-03,9857
00680L,元大美債20正2,39,16,23,元大-蘆洲,2024-01-03,9857
2330,台積電,26,3,23,元大-蘆洲,2024-01-03,9857
00918,大華優利高填息30,22,0,22,元大-蘆洲,2024-01-03,9857
2889,國票金,24,2,22,元大-蘆洲,2024-01-03,9857
2408,南亞科,32,11,21,元大-蘆洲,2024-01-03,9857
6026,福邦證,20,0,20,元大-蘆洲,2024-01-03,9857
2454,聯發科,23,3,20,元大-蘆洲,2024-01-03,9857
00929,復華台灣科技優息,398,18,380,元大-蘆洲,2024-01-04,9857
9105,泰金寶-DR,390,13,377,元大-蘆洲,2024-01-04,9857
9919,康那香,390,160,230,元大-蘆洲,2024-01-04,9857
00637L,元大滬深300正2,254,40,214,元大-蘆洲,2024-01-04,9857
2618,長榮航,263,69,194,元大-蘆洲,2024-01-04,9857
00937B,群益ESG投等債20,179,3,176,元大-蘆洲,2024-01-04,9857
00927,群益半導體收益,147,0,147,元大-蘆洲,2024-01-04,9857
00712,復華富時不動產,104,8,96,元大-蘆洲,2024-01-04,9857
00882,中信中國高股息,84,5,79,元大-蘆洲,2024-01-04,9857
00720B,元大投資級公司債,67,0,67,元大-蘆洲,2024-01-04,9857
2353,宏��,158,95,63,元大-蘆洲,2024-01-04,9857
5608,四維航,61,9,52,元大-蘆洲,2024-01-04,9857
5425,台半,52,2,50,元大-蘆洲,2024-01-04,9857
2344,華邦電,83,35,48,元大-蘆洲,2024-01-04,9857
2331,精英,71,25,46,元大-蘆洲,2024-01-04,9857
2303,聯電,75,31,44,元大-蘆洲,2024-01-04,9857
00680L,元大美債20正2,37,0,37,元大-蘆洲,2024-01-04,9857
4973,廣穎,61,26,35,元大-蘆洲,2024-01-04,9857
00878,國泰永續高股息,47,14,33,元大-蘆洲,2024-01-04,9857
0056,元大高股息,61,29,32,元大-蘆洲,2024-01-04,9857
3339,泰谷,30,0,30,元大-蘆洲,2024-01-04,9857
2486,一詮,103,74,29,元大-蘆洲,2024-01-04,9857
00679B,元大美債20年,32,4,28,元大-蘆洲,2024-01-04,9857
9103,美德醫療-DR,38,12,26,元大-蘆洲,2024-01-04,9857
8046,南電,27,2,25,元大-蘆洲,2024-01-04,9857
5452,佶優,42,17,25,元大-蘆洲,2024-01-04,9857
00881,國泰台灣5G+,24,0,24,元大-蘆洲,2024-01-04,9857
2392,正崴,27,3,24,元大-蘆洲,2024-01-04,9857
2301,光寶科,27,3,24,元大-蘆洲,2024-01-04,9857
2883,凱基金,25,1,24,元大-蘆洲,2024-01-04,9857
1528,恩德,20,0,20,元大-蘆洲,2024-01-04,9857
6668,中揚光,20,0,20,元大-蘆洲,2024-01-04,9857
8930,青鋼,20,0,20,元大-蘆洲,2024-01-04,9857
2101,南港,21,2,19,元大-蘆洲,2024-01-04,9857
1217,愛之味,25,6,19,元大-蘆洲,2024-01-04,9857
2641,正德,66,48,18,元大-蘆洲,2024-01-04,9857
00933B,國泰10Y+金融債,17,0,17,元大-蘆洲,2024-01-04,9857
2402,毅嘉,18,1,17,元大-蘆洲,2024-01-04,9857
3232,昱捷,17,0,17,元大-蘆洲,2024-01-04,9857
2022,聚亨,17,0,17,元大-蘆洲,2024-01-04,9857
3037,欣興,26,9,17,元大-蘆洲,2024-01-04,9857
8086,宏捷科,32,16,16,元大-蘆洲,2024-01-04,9857
3481,群創,16,0,16,元大-蘆洲,2024-01-04,9857
2597,潤弘,16,0,16,元大-蘆洲,2024-01-04,9857
6120,達運,20,4,16,元大-蘆洲,2024-01-04,9857
2425,承啟,15,0,15,元大-蘆洲,2024-01-04,9857
3450,聯鈞,19,4,15,元大-蘆洲,2024-01-04,9857
3030,德律,15,0,15,元大-蘆洲,2024-01-04,9857
2387,精元,18,3,15,元大-蘆洲,2024-01-04,9857
2362,藍天,27,12,15,元大-蘆洲,2024-01-04,9857
00929,復華台灣科技優息,410,112,298,元大-蘆洲,2024-01-05,9857
2609,陽明,456,243,213,元大-蘆洲,2024-01-05,9857
2618,長榮航,618,411,207,元大-蘆洲,2024-01-05,9857
00937B,群益ESG投等債20,192,8,184,元大-蘆洲,2024-01-05,9857
8096,擎亞,184,60,124,元大-蘆洲,2024-01-05,9857
00687B,國泰20年美債,88,2,86,元大-蘆洲,2024-01-05,9857
00919,群益台灣精選高息,91,10,81,元大-蘆洲,2024-01-05,9857
0056,元大高股息,71,8,63,元大-蘆洲,2024-01-05,9857
8085,福華,58,2,56,元大-蘆洲,2024-01-05,9857
00927,群益半導體收益,54,0,54,元大-蘆洲,2024-01-05,9857
2344,華邦電,82,28,54,元大-蘆洲,2024-01-05,9857
6695,芯鼎,87,34,53,元大-蘆洲,2024-01-05,9857
2353,宏��,146,95,51,元大-蘆洲,2024-01-05,9857
6117,迎廣,57,14,43,元大-蘆洲,2024-01-05,9857
3013,晟銘電,40,0,40,元大-蘆洲,2024-01-05,9857
2605,新興,87,50,37,元大-蘆洲,2024-01-05,9857
2537,聯上發,50,14,36,元大-蘆洲,2024-01-05,9857
6163,華電網,43,9,34,元大-蘆洲,2024-01-05,9857
2885,元大金,36,3,33,元大-蘆洲,2024-01-05,9857
00720B,元大投資級公司債,32,0,32,元大-蘆洲,2024-01-05,9857
1325,恆大,31,3,28,元大-蘆洲,2024-01-05,9857
00712,復華富時不動產,26,0,26,元大-蘆洲,2024-01-05,9857
00934,中信成長高股息,27,2,25,元大-蘆洲,2024-01-05,9857
2369,菱生,24,0,24,元大-蘆洲,2024-01-05,9857
00679B,元大美債20年,36,13,23,元大-蘆洲,2024-01-05,9857
1721,三晃,23,2,21,元大-蘆洲,2024-01-05,9857
6141,柏承,21,0,21,元大-蘆洲,2024-01-05,9857
8112,至上,51,30,21,元大-蘆洲,2024-01-05,9857
00878,國泰永續高股息,26,6,20,元大-蘆洲,2024-01-05,9857
5355,佳總,20,0,20,元大-蘆洲,2024-01-05,9857
2486,一詮,45,25,20,元大-蘆洲,2024-01-05,9857
00772B,中信高評級公司債,21,2,19,元大-蘆洲,2024-01-05,9857
00680L,元大美債20正2,219,200,19,元大-蘆洲,2024-01-05,9857
2597,潤弘,19,0,19,元大-蘆洲,2024-01-05,9857
2109,華豐,18,0,18,元大-蘆洲,2024-01-05,9857
3380,明泰,25,7,18,元大-蘆洲,2024-01-05,9857
1504,東元,22,4,18,元大-蘆洲,2024-01-05,9857
00795B,中信美國公債20年,17,0,17,元大-蘆洲,2024-01-05,9857
2509,全坤建,15,0,15,元大-蘆洲,2024-01-05,9857
2641,正德,28,13,15,元大-蘆洲,2024-01-05,9857
1732,毛寶,107,93,14,元大-蘆洲,2024-01-05,9857
1815,富喬,25,11,14,元大-蘆洲,2024-01-05,9857
9921,巨大,13,0,13,元大-蘆洲,2024-01-05,9857
3406,玉晶光,12,0,12,元大-蘆洲,2024-01-05,9857
00933B,國泰10Y+金融債,17,5,12,元大-蘆洲,2024-01-05,9857
00931B,統一美債20年,12,0,12,元大-蘆洲,2024-01-05,9857
00918,大華優利高填息30,15,4,11,元大-蘆洲,2024-01-05,9857
2007,燁興,14,3,11,元大-蘆洲,2024-01-05,9857
4939,亞電,11,0,11,元大-蘆洲,2024-01-05,9857
2367,燿華,10,0,10,元大-蘆洲,2024-01-05,9857
6770,力積電,382,93,289,元大-蘆洲,2024-01-08,9857
00929,復華台灣科技優息,279,20,259,元大-蘆洲,2024-01-08,9857
00637L,元大滬深300正2,298,60,238,元大-蘆洲,2024-01-08,9857
3481,群創,518,292,226,元大-蘆洲,2024-01-08,9857
00919,群益台灣精選高息,117,3,114,元大-蘆洲,2024-01-08,9857
00687B,國泰20年美債,235,131,104,元大-蘆洲,2024-01-08,9857
00655L,國泰中國A50正2,75,0,75,元大-蘆洲,2024-01-08,9857
8085,福華,73,6,67,元大-蘆洲,2024-01-08,9857
2303,聯電,112,47,65,元大-蘆洲,2024-01-08,9857
2607,榮運,68,9,59,元大-蘆洲,2024-01-08,9857
3715,定穎投控,55,2,53,元大-蘆洲,2024-01-08,9857
2388,威盛,127,74,53,元大-蘆洲,2024-01-08,9857
2353,宏��,256,211,45,元大-蘆洲,2024-01-08,9857
2489,瑞軒,39,0,39,元大-蘆洲,2024-01-08,9857
00679B,元大美債20年,88,49,39,元大-蘆洲,2024-01-08,9857
0056,元大高股息,45,6,39,元大-蘆洲,2024-01-08,9857
2317,鴻海,40,4,36,元大-蘆洲,2024-01-08,9857
00923,群益台ESG低碳50,35,0,35,元大-蘆洲,2024-01-08,9857
6182,合晶,42,7,35,元大-蘆洲,2024-01-08,9857
00725B,國泰投資級公司債,33,6,27,元大-蘆洲,2024-01-08,9857
2324,仁寶,41,16,25,元大-蘆洲,2024-01-08,9857
00753L,中信中國50正2,23,0,23,元大-蘆洲,2024-01-08,9857
1785,光洋科,22,0,22,元大-蘆洲,2024-01-08,9857
4915,致伸,42,21,21,元大-蘆洲,2024-01-08,9857
2536,宏普,21,1,20,元大-蘆洲,2024-01-08,9857
2002,中鋼,30,10,20,元大-蘆洲,2024-01-08,9857
2458,義隆,22,2,20,元大-蘆洲,2024-01-08,9857
2486,一詮,53,33,20,元大-蘆洲,2024-01-08,9857
4128,中天,22,2,20,元大-蘆洲,2024-01-08,9857
2329,華泰,29,10,19,元大-蘆洲,2024-01-08,9857
00927,群益半導體收益,19,0,19,元大-蘆洲,2024-01-08,9857
8011,台通,19,1,18,元大-蘆洲,2024-01-08,9857
2615,萬海,37,19,18,元大-蘆洲,2024-01-08,9857
3032,偉訓,37,19,18,元大-蘆洲,2024-01-08,9857
2455,全新,17,0,17,元大-蘆洲,2024-01-08,9857
1605,華新,22,5,17,元大-蘆洲,2024-01-08,9857
00936,台新永續高息中小,17,1,16,元大-蘆洲,2024-01-08,9857
2302,麗正,15,0,15,元大-蘆洲,2024-01-08,9857
1504,東元,16,1,15,元大-蘆洲,2024-01-08,9857
1808,潤隆,15,0,15,元大-蘆洲,2024-01-08,9857
6129,普誠,15,0,15,元大-蘆洲,2024-01-08,9857
9945,潤泰新,22,7,15,元大-蘆洲,2024-01-08,9857
1815,富喬,23,8,15,元大-蘆洲,2024-01-08,9857
2610,華航,25,10,15,元大-蘆洲,2024-01-08,9857
1301,台塑,14,0,14,元大-蘆洲,2024-01-08,9857
00928,中信上櫃ESG30,14,0,14,元大-蘆洲,2024-01-08,9857
00665L,富邦�琤肭磪囓�2,15,2,13,元大-蘆洲,2024-01-08,9857
2634,漢翔,40,28,12,元大-蘆洲,2024-01-08,9857
2530,華建,12,0,12,元大-蘆洲,2024-01-08,9857
2443,昶虹,17,5,12,元大-蘆洲,2024-01-08,9857
00919,群益台灣精選高息,310,38,272,元大-蘆洲,2024-01-09,9857
2609,陽明,550,300,250,元大-蘆洲,2024-01-09,9857
2303,聯電,244,27,217,元大-蘆洲,2024-01-09,9857
6116,彩晶,143,2,141,元大-蘆洲,2024-01-09,9857
00892,富邦台灣半導體,120,0,120,元大-蘆洲,2024-01-09,9857
9904,寶成,116,7,109,元大-蘆洲,2024-01-09,9857
00891,中信關鍵半導體,127,20,107,元大-蘆洲,2024-01-09,9857
2455,全新,100,12,88,元大-蘆洲,2024-01-09,9857
3265,台星科,97,10,87,元大-蘆洲,2024-01-09,9857
00937B,群益ESG投等債20,80,0,80,元大-蘆洲,2024-01-09,9857
1609,大亞,70,1,69,元大-蘆洲,2024-01-09,9857
3013,晟銘電,102,42,60,元大-蘆洲,2024-01-09,9857
3050,鈺德,61,4,57,元大-蘆洲,2024-01-09,9857
00680L,元大美債20正2,74,18,56,元大-蘆洲,2024-01-09,9857
1605,華新,60,5,55,元大-蘆洲,2024-01-09,9857
2208,台船,58,4,54,元大-蘆洲,2024-01-09,9857
3035,智原,87,33,54,元大-蘆洲,2024-01-09,9857
3380,明泰,51,1,50,元大-蘆洲,2024-01-09,9857
2353,宏��,135,90,45,元大-蘆洲,2024-01-09,9857
0050,元大台灣50,48,5,43,元大-蘆洲,2024-01-09,9857
3037,欣興,56,13,43,元大-蘆洲,2024-01-09,9857
6120,達運,107,66,41,元大-蘆洲,2024-01-09,9857
00632R,元大台灣50反1,41,2,39,元大-蘆洲,2024-01-09,9857
3231,緯創,150,111,39,元大-蘆洲,2024-01-09,9857
2363,矽統,126,90,36,元大-蘆洲,2024-01-09,9857
0056,元大高股息,47,12,35,元大-蘆洲,2024-01-09,9857
6285,啟��,50,16,34,元大-蘆洲,2024-01-09,9857
2308,台達電,34,1,33,元大-蘆洲,2024-01-09,9857
2356,英業達,109,76,33,元大-蘆洲,2024-01-09,9857
1528,恩德,33,0,33,元大-蘆洲,2024-01-09,9857
00665L,富邦�琤肭磪囓�2,33,1,32,元大-蘆洲,2024-01-09,9857
2014,中鴻,39,8,31,元大-蘆洲,2024-01-09,9857
2337,旺宏,33,2,31,元大-蘆洲,2024-01-09,9857
4744,皇將,30,0,30,元大-蘆洲,2024-01-09,9857
2855,統一證,30,0,30,元大-蘆洲,2024-01-09,9857
1514,亞力,45,16,29,元大-蘆洲,2024-01-09,9857
2641,正德,38,11,27,元大-蘆洲,2024-01-09,9857
00918,大華優利高填息30,26,0,26,元大-蘆洲,2024-01-09,9857
2369,菱生,27,1,26,元大-蘆洲,2024-01-09,9857
00770,國泰北美科技,28,2,26,元大-蘆洲,2024-01-09,9857
00715L,期街口布蘭特正2,25,0,25,元大-蘆洲,2024-01-09,9857
2739,寒舍,27,3,24,元大-蘆洲,2024-01-09,9857
2324,仁寶,88,64,24,元大-蘆洲,2024-01-09,9857
3346,麗清,28,5,23,元大-蘆洲,2024-01-09,9857
1314,中石化,26,3,23,元大-蘆洲,2024-01-09,9857
2317,鴻海,23,1,22,元大-蘆洲,2024-01-09,9857
2888,新光金,22,0,22,元大-蘆洲,2024-01-09,9857
00930,永豐ESG低碳高息,22,0,22,元大-蘆洲,2024-01-09,9857
5608,四維航,24,3,21,元大-蘆洲,2024-01-09,9857
2344,華邦電,29,8,21,元大-蘆洲,2024-01-09,9857
2609,陽明,714,270,444,元大-蘆洲,2024-01-10,9857
00929,復華台灣科技優息,242,22,220,元大-蘆洲,2024-01-10,9857
00687B,國泰20年美債,113,0,113,元大-蘆洲,2024-01-10,9857
1605,華新,81,6,75,元大-蘆洲,2024-01-10,9857
2641,正德,79,4,75,元大-蘆洲,2024-01-10,9857
0056,元大高股息,88,22,66,元大-蘆洲,2024-01-10,9857
00933B,國泰10Y+金融債,62,1,61,元大-蘆洲,2024-01-10,9857
2208,台船,53,0,53,元大-蘆洲,2024-01-10,9857
2353,宏��,147,105,42,元大-蘆洲,2024-01-10,9857
00632R,元大台灣50反1,42,0,42,元大-蘆洲,2024-01-10,9857
3025,星通,49,8,41,元大-蘆洲,2024-01-10,9857
6139,亞翔,43,3,40,元大-蘆洲,2024-01-10,9857
2883B,凱基金乙特,40,0,40,元大-蘆洲,2024-01-10,9857
3231,緯創,112,73,39,元大-蘆洲,2024-01-10,9857
2618,長榮航,89,51,38,元大-蘆洲,2024-01-10,9857
00891,中信關鍵半導體,34,0,34,元大-蘆洲,2024-01-10,9857
2603,長榮,102,69,33,元大-蘆洲,2024-01-10,9857
1314,中石化,34,1,33,元大-蘆洲,2024-01-10,9857
2362,藍天,52,20,32,元大-蘆洲,2024-01-10,9857
2611,志信,40,10,30,元大-蘆洲,2024-01-10,9857
9904,寶成,32,2,30,元大-蘆洲,2024-01-10,9857
00751B,元大AAA至A公司債,31,2,29,元大-蘆洲,2024-01-10,9857
1515,力山,29,1,28,元大-蘆洲,2024-01-10,9857
2427,三商電,28,0,28,元大-蘆洲,2024-01-10,9857
00919,群益台灣精選高息,99,72,27,元大-蘆洲,2024-01-10,9857
2344,華邦電,34,7,27,元大-蘆洲,2024-01-10,9857
2301,光寶科,41,15,26,元大-蘆洲,2024-01-10,9857
6669,緯穎,28,3,25,元大-蘆洲,2024-01-10,9857
00892,富邦台灣半導體,25,0,25,元大-蘆洲,2024-01-10,9857
2501,國建,24,0,24,元大-蘆洲,2024-01-10,9857
6164,華興,52,28,24,元大-蘆洲,2024-01-10,9857
2885,元大金,35,11,24,元大-蘆洲,2024-01-10,9857
2610,華航,26,3,23,元大-蘆洲,2024-01-10,9857
00878,國泰永續高股息,38,15,23,元大-蘆洲,2024-01-10,9857
00770,國泰北美科技,22,0,22,元大-蘆洲,2024-01-10,9857
2506,太設,20,0,20,元大-蘆洲,2024-01-10,9857
2607,榮運,25,5,20,元大-蘆洲,2024-01-10,9857
2515,中工,33,14,19,元大-蘆洲,2024-01-10,9857
00720B,元大投資級公司債,25,6,19,元大-蘆洲,2024-01-10,9857
2409,友達,47,29,18,元大-蘆洲,2024-01-10,9857
00930,永豐ESG低碳高息,17,0,17,元大-蘆洲,2024-01-10,9857
00680L,元大美債20正2,17,0,17,元大-蘆洲,2024-01-10,9857
6770,力積電,21,5,16,元大-蘆洲,2024-01-10,9857
1324,地球,16,0,16,元大-蘆洲,2024-01-10,9857
2363,矽統,62,46,16,元大-蘆洲,2024-01-10,9857
5608,四維航,16,1,15,元大-蘆洲,2024-01-10,9857
1608,華榮,15,0,15,元大-蘆洲,2024-01-10,9857
6182,合晶,23,8,15,元大-蘆洲,2024-01-10,9857
2882,國泰金,15,0,15,元大-蘆洲,2024-01-10,9857
2637,慧洋-KY,22,8,14,元大-蘆洲,2024-01-10,9857
00929,復華台灣科技優息,293,21,272,元大-蘆洲,2024-01-11,9857
2618,長榮航,259,62,197,元大-蘆洲,2024-01-11,9857
3025,星通,159,61,98,元大-蘆洲,2024-01-11,9857
0056,元大高股息,76,1,75,元大-蘆洲,2024-01-11,9857
3481,群創,99,24,75,元大-蘆洲,2024-01-11,9857
00892,富邦台灣半導體,70,2,68,元大-蘆洲,2024-01-11,9857
00919,群益台灣精選高息,67,3,64,元大-蘆洲,2024-01-11,9857
00632R,元大台灣50反1,59,4,55,元大-蘆洲,2024-01-11,9857
2610,華航,60,9,51,元大-蘆洲,2024-01-11,9857
00891,中信關鍵半導體,52,7,45,元大-蘆洲,2024-01-11,9857
3706,神達,73,28,45,元大-蘆洲,2024-01-11,9857
00680L,元大美債20正2,44,0,44,元大-蘆洲,2024-01-11,9857
2641,正德,42,0,42,元大-蘆洲,2024-01-11,9857
2486,一詮,87,52,35,元大-蘆洲,2024-01-11,9857
2603,長榮,54,20,34,元大-蘆洲,2024-01-11,9857
2353,宏��,261,228,33,元大-蘆洲,2024-01-11,9857
00715L,期街口布蘭特正2,31,0,31,元大-蘆洲,2024-01-11,9857
1515,力山,34,4,30,元大-蘆洲,2024-01-11,9857
2408,南亞科,41,11,30,元大-蘆洲,2024-01-11,9857
2467,志聖,33,3,30,元大-蘆洲,2024-01-11,9857
2303,聯電,40,10,30,元大-蘆洲,2024-01-11,9857
00687B,國泰20年美債,28,1,27,元大-蘆洲,2024-01-11,9857
2605,新興,27,0,27,元大-蘆洲,2024-01-11,9857
2515,中工,27,1,26,元大-蘆洲,2024-01-11,9857
2884,玉山金,26,0,26,元大-蘆洲,2024-01-11,9857
6244,茂迪,22,0,22,元大-蘆洲,2024-01-11,9857
2301,光寶科,24,3,21,元大-蘆洲,2024-01-11,9857
3703,欣陸,21,0,21,元大-蘆洲,2024-01-11,9857
00882,中信中國高股息,21,0,21,元大-蘆洲,2024-01-11,9857
00850,元大臺灣ESG永續,20,0,20,元大-蘆洲,2024-01-11,9857
8110,華東,20,0,20,元大-蘆洲,2024-01-11,9857
1608,華榮,20,0,20,元大-蘆洲,2024-01-11,9857
4915,致伸,20,0,20,元大-蘆洲,2024-01-11,9857
2388,威盛,73,54,19,元大-蘆洲,2024-01-11,9857
3037,欣興,23,4,19,元大-蘆洲,2024-01-11,9857
9945,潤泰新,18,0,18,元大-蘆洲,2024-01-11,9857
6120,達運,176,159,17,元大-蘆洲,2024-01-11,9857
2312,金寶,17,0,17,元大-蘆洲,2024-01-11,9857
1815,富喬,27,10,17,元大-蘆洲,2024-01-11,9857
00933B,國泰10Y+金融債,20,3,17,元大-蘆洲,2024-01-11,9857
00930,永豐ESG低碳高息,16,0,16,元大-蘆洲,2024-01-11,9857
2449,京元電子,21,5,16,元大-蘆洲,2024-01-11,9857
00688L,國泰20年美債正2,16,0,16,元大-蘆洲,2024-01-11,9857
2495,普安,16,0,16,元大-蘆洲,2024-01-11,9857
1616,億泰,19,3,16,元大-蘆洲,2024-01-11,9857
2498,宏達電,23,8,15,元大-蘆洲,2024-01-11,9857
4529,淳紳,21,6,15,元大-蘆洲,2024-01-11,9857
4113,聯上,15,0,15,元大-蘆洲,2024-01-11,9857
6173,信昌電,15,0,15,元大-蘆洲,2024-01-11,9857
2356,英業達,99,84,15,元大-蘆洲,2024-01-11,9857
3622,洋華,616,31,585,元大-蘆洲,2024-01-12,9857
00929,復華台灣科技優息,284,35,249,元大-蘆洲,2024-01-12,9857
2486,一詮,292,97,195,元大-蘆洲,2024-01-12,9857
1513,中興電,122,10,112,元大-蘆洲,2024-01-12,9857
3481,群創,136,43,93,元大-蘆洲,2024-01-12,9857
3231,緯創,284,216,68,元大-蘆洲,2024-01-12,9857
5426,振發,103,37,66,元大-蘆洲,2024-01-12,9857
00919,群益台灣精選高息,80,24,56,元大-蘆洲,2024-01-12,9857
2890,永豐金,71,17,54,元大-蘆洲,2024-01-12,9857
00637L,元大滬深300正2,260,211,49,元大-蘆洲,2024-01-12,9857
2888,新光金,57,8,49,元大-蘆洲,2024-01-12,9857
00673R,期元大S＆P原油反1,48,0,48,元大-蘆洲,2024-01-12,9857
00725B,國泰投資級公司債,49,1,48,元大-蘆洲,2024-01-12,9857
2324,仁寶,55,8,47,元大-蘆洲,2024-01-12,9857
6120,達運,134,89,45,元大-蘆洲,2024-01-12,9857
8150,南茂,44,2,42,元大-蘆洲,2024-01-12,9857
2353,宏��,116,75,41,元大-蘆洲,2024-01-12,9857
2104,國際中橡,40,0,40,元大-蘆洲,2024-01-12,9857
8096,擎亞,96,56,40,元大-蘆洲,2024-01-12,9857
00687B,國泰20年美債,33,2,31,元大-蘆洲,2024-01-12,9857
0056,元大高股息,31,1,30,元大-蘆洲,2024-01-12,9857
3521,鴻翊,30,0,30,元大-蘆洲,2024-01-12,9857
2331,精英,28,0,28,元大-蘆洲,2024-01-12,9857
6129,普誠,26,0,26,元大-蘆洲,2024-01-12,9857
00712,復華富時不動產,25,0,25,元大-蘆洲,2024-01-12,9857
2634,漢翔,43,20,23,元大-蘆洲,2024-01-12,9857
1795,美時,26,4,22,元大-蘆洲,2024-01-12,9857
2887,台新金,22,0,22,元大-蘆洲,2024-01-12,9857
3715,定穎投控,80,59,21,元大-蘆洲,2024-01-12,9857
00770,國泰北美科技,21,0,21,元大-蘆洲,2024-01-12,9857
2358,廷鑫,20,0,20,元大-蘆洲,2024-01-12,9857
00927,群益半導體收益,28,8,20,元大-蘆洲,2024-01-12,9857
5483,中美晶,20,0,20,元大-蘆洲,2024-01-12,9857
6695,芯鼎,68,49,19,元大-蘆洲,2024-01-12,9857
00632R,元大台灣50反1,18,0,18,元大-蘆洲,2024-01-12,9857
00904,新光臺灣半導體30,17,0,17,元大-蘆洲,2024-01-12,9857
2882,國泰金,18,2,16,元大-蘆洲,2024-01-12,9857
00751B,元大AAA至A公司債,17,2,15,元大-蘆洲,2024-01-12,9857
2344,華邦電,19,4,15,元大-蘆洲,2024-01-12,9857
00720B,元大投資級公司債,15,0,15,元大-蘆洲,2024-01-12,9857
00918,大華優利高填息30,18,4,14,元大-蘆洲,2024-01-12,9857
5347,世界,15,1,14,元大-蘆洲,2024-01-12,9857
3706,神達,28,14,14,元大-蘆洲,2024-01-12,9857
00728,第一金工業30,13,0,13,元大-蘆洲,2024-01-12,9857
00891,中信關鍵半導體,13,0,13,元大-蘆洲,2024-01-12,9857
2880,華南金,13,0,13,元大-蘆洲,2024-01-12,9857
6443,元晶,12,0,12,元大-蘆洲,2024-01-12,9857
3588,通嘉,13,1,12,元大-蘆洲,2024-01-12,9857
4909,新復興,125,113,12,元大-蘆洲,2024-01-12,9857
2423,固緯,20,8,12,元大-蘆洲,2024-01-12,9857
2618,長榮航,750,17,733,元大-蘆洲,2024-01-15,9857
6116,彩晶,256,36,220,元大-蘆洲,2024-01-15,9857
00929,復華台灣科技優息,197,43,154,元大-蘆洲,2024-01-15,9857
00680L,元大美債20正2,119,0,119,元大-蘆洲,2024-01-15,9857
3231,緯創,243,125,118,元大-蘆洲,2024-01-15,9857
1529,樂事綠能,142,36,106,元大-蘆洲,2024-01-15,9857
8085,福華,104,7,97,元大-蘆洲,2024-01-15,9857
2610,華航,83,15,68,元大-蘆洲,2024-01-15,9857
2409,友達,81,21,60,元大-蘆洲,2024-01-15,9857
00927,群益半導體收益,57,0,57,元大-蘆洲,2024-01-15,9857
0056,元大高股息,74,21,53,元大-蘆洲,2024-01-15,9857
00673R,期元大S＆P原油反1,45,0,45,元大-蘆洲,2024-01-15,9857
00937B,群益ESG投等債20,44,0,44,元大-蘆洲,2024-01-15,9857
6148,驊宏資,41,0,41,元大-蘆洲,2024-01-15,9857
00882,中信中國高股息,40,0,40,元大-蘆洲,2024-01-15,9857
00933B,國泰10Y+金融債,46,7,39,元大-蘆洲,2024-01-15,9857
5426,振發,63,24,39,元大-蘆洲,2024-01-15,9857
3013,晟銘電,41,6,35,元大-蘆洲,2024-01-15,9857
5355,佳總,35,0,35,元大-蘆洲,2024-01-15,9857
2515,中工,32,0,32,元大-蘆洲,2024-01-15,9857
6770,力積電,33,2,31,元大-蘆洲,2024-01-15,9857
3576,聯合再生,31,1,30,元大-蘆洲,2024-01-15,9857
00679B,元大美債20年,35,5,30,元大-蘆洲,2024-01-15,9857
4113,聯上,30,0,30,元大-蘆洲,2024-01-15,9857
00676R,富邦臺灣加權反1,30,0,30,元大-蘆洲,2024-01-15,9857
6125,廣運,32,3,29,元大-蘆洲,2024-01-15,9857
1714,和桐,27,0,27,元大-蘆洲,2024-01-15,9857
00687B,國泰20年美債,27,1,26,元大-蘆洲,2024-01-15,9857
3390,旭軟,64,38,26,元大-蘆洲,2024-01-15,9857
2634,漢翔,69,43,26,元大-蘆洲,2024-01-15,9857
8034,榮群,51,26,25,元大-蘆洲,2024-01-15,9857
00878,國泰永續高股息,48,24,24,元大-蘆洲,2024-01-15,9857
4956,光鋐,31,7,24,元大-蘆洲,2024-01-15,9857
5210,寶碩,24,0,24,元大-蘆洲,2024-01-15,9857
2887,台新金,23,0,23,元大-蘆洲,2024-01-15,9857
1301,台塑,20,0,20,元大-蘆洲,2024-01-15,9857
2208,台船,38,18,20,元大-蘆洲,2024-01-15,9857
00753L,中信中國50正2,20,0,20,元大-蘆洲,2024-01-15,9857
2630,亞航,26,7,19,元大-蘆洲,2024-01-15,9857
2317,鴻海,21,4,17,元大-蘆洲,2024-01-15,9857
3030,德律,17,0,17,元大-蘆洲,2024-01-15,9857
00751B,元大AAA至A公司債,20,3,17,元大-蘆洲,2024-01-15,9857
2913,農林,14,0,14,元大-蘆洲,2024-01-15,9857
1795,美時,72,58,14,元大-蘆洲,2024-01-15,9857
2892,第一金,13,0,13,元大-蘆洲,2024-01-15,9857
1605,華新,17,4,13,元大-蘆洲,2024-01-15,9857
6207,雷科,21,8,13,元大-蘆洲,2024-01-15,9857
2739,寒舍,12,0,12,元大-蘆洲,2024-01-15,9857
4572,駐龍,12,0,12,元大-蘆洲,2024-01-15,9857
2520,冠德,12,0,12,元大-蘆洲,2024-01-15,9857
0056,元大高股息,284,9,275,元大-蘆洲,2024-01-16,9857
00929,復華台灣科技優息,290,26,264,元大-蘆洲,2024-01-16,9857
2618,長榮航,129,8,121,元大-蘆洲,2024-01-16,9857
2888,新光金,113,14,99,元大-蘆洲,2024-01-16,9857
3025,星通,205,114,91,元大-蘆洲,2024-01-16,9857
00720B,元大投資級公司債,91,2,89,元大-蘆洲,2024-01-16,9857
00927,群益半導體收益,85,0,85,元大-蘆洲,2024-01-16,9857
3715,定穎投控,84,3,81,元大-蘆洲,2024-01-16,9857
1314,中石化,87,11,76,元大-蘆洲,2024-01-16,9857
00878,國泰永續高股息,124,48,76,元大-蘆洲,2024-01-16,9857
2883,凱基金,72,4,68,元大-蘆洲,2024-01-16,9857
00919,群益台灣精選高息,74,6,68,元大-蘆洲,2024-01-16,9857
2887,台新金,67,0,67,元大-蘆洲,2024-01-16,9857
2884,玉山金,54,0,54,元大-蘆洲,2024-01-16,9857
00715L,期街口布蘭特正2,56,4,52,元大-蘆洲,2024-01-16,9857
00637L,元大滬深300正2,230,180,50,元大-蘆洲,2024-01-16,9857
2409,友達,98,50,48,元大-蘆洲,2024-01-16,9857
2892,第一金,42,0,42,元大-蘆洲,2024-01-16,9857
2610,華航,58,19,39,元大-蘆洲,2024-01-16,9857
2324,仁寶,43,4,39,元大-蘆洲,2024-01-16,9857
6695,芯鼎,116,78,38,元大-蘆洲,2024-01-16,9857
2882,國泰金,45,7,38,元大-蘆洲,2024-01-16,9857
2603,長榮,55,18,37,元大-蘆洲,2024-01-16,9857
00937B,群益ESG投等債20,40,4,36,元大-蘆洲,2024-01-16,9857
2344,華邦電,45,11,34,元大-蘆洲,2024-01-16,9857
00881,國泰台灣5G+,33,0,33,元大-蘆洲,2024-01-16,9857
2353,宏��,150,118,32,元大-蘆洲,2024-01-16,9857
00882,中信中國高股息,34,3,31,元大-蘆洲,2024-01-16,9857
2852,第一保,30,0,30,元大-蘆洲,2024-01-16,9857
1721,三晃,31,1,30,元大-蘆洲,2024-01-16,9857
1605,華新,31,2,29,元大-蘆洲,2024-01-16,9857
1609,大亞,42,13,29,元大-蘆洲,2024-01-16,9857
1301,台塑,31,2,29,元大-蘆洲,2024-01-16,9857
8034,榮群,52,24,28,元大-蘆洲,2024-01-16,9857
2329,華泰,87,59,28,元大-蘆洲,2024-01-16,9857
4979,華星光,28,1,27,元大-蘆洲,2024-01-16,9857
2885,元大金,31,5,26,元大-蘆洲,2024-01-16,9857
9945,潤泰新,29,3,26,元大-蘆洲,2024-01-16,9857
2609,陽明,156,131,25,元大-蘆洲,2024-01-16,9857
2890,永豐金,40,15,25,元大-蘆洲,2024-01-16,9857
8085,福華,27,2,25,元大-蘆洲,2024-01-16,9857
00907,永豐優息存股,23,0,23,元大-蘆洲,2024-01-16,9857
6140,訊達,45,22,23,元大-蘆洲,2024-01-16,9857
2312,金寶,95,72,23,元大-蘆洲,2024-01-16,9857
1802,台玻,22,0,22,元大-蘆洲,2024-01-16,9857
2352,佳世達,22,1,21,元大-蘆洲,2024-01-16,9857
2356,英業達,38,17,21,元大-蘆洲,2024-01-16,9857
2331,精英,33,12,21,元大-蘆洲,2024-01-16,9857
2607,榮運,24,4,20,元大-蘆洲,2024-01-16,9857
2611,志信,20,0,20,元大-蘆洲,2024-01-16,9857
00929,復華台灣科技優息,513,71,442,元大-蘆洲,2024-01-17,9857
00650L,復華香港正2,402,0,402,元大-蘆洲,2024-01-17,9857
00919,群益台灣精選高息,441,100,341,元大-蘆洲,2024-01-17,9857
0056,元大高股息,319,20,299,元大-蘆洲,2024-01-17,9857
2303,聯電,308,52,256,元大-蘆洲,2024-01-17,9857
00878,國泰永續高股息,368,117,251,元大-蘆洲,2024-01-17,9857
00882,中信中國高股息,222,3,219,元大-蘆洲,2024-01-17,9857
2880,華南金,224,15,209,元大-蘆洲,2024-01-17,9857
1611,中電,155,0,155,元大-蘆洲,2024-01-17,9857
6116,彩晶,144,2,142,元大-蘆洲,2024-01-17,9857
00687B,國泰20年美債,127,0,127,元大-蘆洲,2024-01-17,9857
2344,華邦電,129,19,110,元大-蘆洲,2024-01-17,9857
5443,均豪,105,0,105,元大-蘆洲,2024-01-17,9857
2887,台新金,106,2,104,元大-蘆洲,2024-01-17,9857
6120,達運,154,59,95,元大-蘆洲,2024-01-17,9857
1529,樂事綠能,101,12,89,元大-蘆洲,2024-01-17,9857
00881,國泰台灣5G+,75,0,75,元大-蘆洲,2024-01-17,9857
1605,華新,78,7,71,元大-蘆洲,2024-01-17,9857
2888,新光金,92,21,71,元大-蘆洲,2024-01-17,9857
1528,恩德,99,29,70,元大-蘆洲,2024-01-17,9857
00637L,元大滬深300正2,168,106,62,元大-蘆洲,2024-01-17,9857
2317,鴻海,70,9,61,元大-蘆洲,2024-01-17,9857
00680L,元大美債20正2,80,22,58,元大-蘆洲,2024-01-17,9857
6140,訊達,65,12,53,元大-蘆洲,2024-01-17,9857
2206,三陽工業,51,0,51,元大-蘆洲,2024-01-17,9857
2356,英業達,90,40,50,元大-蘆洲,2024-01-17,9857
3390,旭軟,61,13,48,元大-蘆洲,2024-01-17,9857
1314,中石化,55,10,45,元大-蘆洲,2024-01-17,9857
2312,金寶,45,0,45,元大-蘆洲,2024-01-17,9857
6129,普誠,52,7,45,元大-蘆洲,2024-01-17,9857
8150,南茂,52,11,41,元大-蘆洲,2024-01-17,9857
00753L,中信中國50正2,51,10,41,元大-蘆洲,2024-01-17,9857
0050,元大台灣50,43,2,41,元大-蘆洲,2024-01-17,9857
6243,迅杰,114,75,39,元大-蘆洲,2024-01-17,9857
2427,三商電,38,0,38,元大-蘆洲,2024-01-17,9857
00937B,群益ESG投等債20,39,2,37,元大-蘆洲,2024-01-17,9857
1513,中興電,45,8,37,元大-蘆洲,2024-01-17,9857
2882,國泰金,42,6,36,元大-蘆洲,2024-01-17,9857
3037,欣興,39,4,35,元大-蘆洲,2024-01-17,9857
1608,華榮,35,0,35,元大-蘆洲,2024-01-17,9857
2610,華航,49,15,34,元大-蘆洲,2024-01-17,9857
00927,群益半導體收益,34,1,33,元大-蘆洲,2024-01-17,9857
2002,中鋼,67,35,32,元大-蘆洲,2024-01-17,9857
00918,大華優利高填息30,36,5,31,元大-蘆洲,2024-01-17,9857
2883B,凱基金乙特,30,0,30,元大-蘆洲,2024-01-17,9857
9945,潤泰新,33,4,29,元大-蘆洲,2024-01-17,9857
2618,長榮航,74,45,29,元大-蘆洲,2024-01-17,9857
00679B,元大美債20年,37,13,24,元大-蘆洲,2024-01-17,9857
3702,大聯大,34,11,23,元大-蘆洲,2024-01-17,9857
3294,英濟,23,0,23,元大-蘆洲,2024-01-17,9857
00929,復華台灣科技優息,367,64,303,元大-蘆洲,2024-01-18,9857
00637L,元大滬深300正2,386,122,264,元大-蘆洲,2024-01-18,9857
00919,群益台灣精選高息,144,31,113,元大-蘆洲,2024-01-18,9857
00882,中信中國高股息,112,5,107,元大-蘆洲,2024-01-18,9857
4960,誠美材,98,5,93,元大-蘆洲,2024-01-18,9857
2303,聯電,124,56,68,元大-蘆洲,2024-01-18,9857
0056,元大高股息,90,23,67,元大-蘆洲,2024-01-18,9857
2883,凱基金,67,0,67,元大-蘆洲,2024-01-18,9857
2887,台新金,71,12,59,元大-蘆洲,2024-01-18,9857
6770,力積電,74,16,58,元大-蘆洲,2024-01-18,9857
6015,宏遠證,50,0,50,元大-蘆洲,2024-01-18,9857
2324,仁寶,98,55,43,元大-蘆洲,2024-01-18,9857
4979,華星光,60,20,40,元大-蘆洲,2024-01-18,9857
6182,合晶,39,0,39,元大-蘆洲,2024-01-18,9857
1815,富喬,43,8,35,元大-蘆洲,2024-01-18,9857
1504,東元,36,5,31,元大-蘆洲,2024-01-18,9857
8105,凌巨,30,0,30,元大-蘆洲,2024-01-18,9857
2363,矽統,40,11,29,元大-蘆洲,2024-01-18,9857
3025,星通,95,66,29,元大-蘆洲,2024-01-18,9857
2409,友達,144,116,28,元大-蘆洲,2024-01-18,9857
5880,合庫金,26,0,26,元大-蘆洲,2024-01-18,9857
2882,國泰金,32,6,26,元大-蘆洲,2024-01-18,9857
2382,廣達,42,18,24,元大-蘆洲,2024-01-18,9857
1101,台泥,24,1,23,元大-蘆洲,2024-01-18,9857
00937B,群益ESG投等債20,24,0,24,元大-蘆洲,2024-01-18,9857
00712,復華富時不動產,34,12,22,元大-蘆洲,2024-01-18,9857
2371,大同,23,1,22,元大-蘆洲,2024-01-18,9857
1616,億泰,20,0,20,元大-蘆洲,2024-01-18,9857
00878,國泰永續高股息,82,63,19,元大-蘆洲,2024-01-18,9857
00927,群益半導體收益,21,3,18,元大-蘆洲,2024-01-18,9857
6244,茂迪,19,1,18,元大-蘆洲,2024-01-18,9857
2486,一詮,46,28,18,元大-蘆洲,2024-01-18,9857
00687B,國泰20年美債,24,6,18,元大-蘆洲,2024-01-18,9857
1301,台塑,17,0,17,元大-蘆洲,2024-01-18,9857
2892,第一金,23,7,16,元大-蘆洲,2024-01-18,9857
1326,台化,17,1,16,元大-蘆洲,2024-01-18,9857
3231,緯創,77,62,15,元大-蘆洲,2024-01-18,9857
9945,潤泰新,16,1,15,元大-蘆洲,2024-01-18,9857
8112,至上,31,16,15,元大-蘆洲,2024-01-18,9857
1785,光洋科,20,5,15,元大-蘆洲,2024-01-18,9857
6233,旺玖,59,44,15,元大-蘆洲,2024-01-18,9857
2329,華泰,90,75,15,元大-蘆洲,2024-01-18,9857
1519,華城,36,22,14,元大-蘆洲,2024-01-18,9857
3033,威健,17,3,14,元大-蘆洲,2024-01-18,9857
2344,華邦電,43,30,13,元大-蘆洲,2024-01-18,9857
00934,中信成長高股息,15,2,13,元大-蘆洲,2024-01-18,9857
2884,玉山金,12,0,12,元大-蘆洲,2024-01-18,9857
00770,國泰北美科技,12,0,12,元大-蘆洲,2024-01-18,9857
2332,友訊,12,0,12,元大-蘆洲,2024-01-18,9857
1802,台玻,12,0,12,元大-蘆洲,2024-01-18,9857
00680L,元大美債20正2,277,8,269,元大-蘆洲,2024-01-19,9857
00882,中信中國高股息,167,0,167,元大-蘆洲,2024-01-19,9857
00937B,群益ESG投等債20,167,20,147,元大-蘆洲,2024-01-19,9857
2609,陽明,156,25,131,元大-蘆洲,2024-01-19,9857
00637L,元大滬深300正2,757,630,127,元大-蘆洲,2024-01-19,9857
00687B,國泰20年美債,122,5,117,元大-蘆洲,2024-01-19,9857
00673R,期元大S＆P原油反1,116,0,116,元大-蘆洲,2024-01-19,9857
00929,復華台灣科技優息,163,58,105,元大-蘆洲,2024-01-19,9857
00679B,元大美債20年,100,1,99,元大-蘆洲,2024-01-19,9857
2883,凱基金,90,10,80,元大-蘆洲,2024-01-19,9857
2610,華航,71,1,70,元大-蘆洲,2024-01-19,9857
4960,誠美材,63,2,61,元大-蘆洲,2024-01-19,9857
2867,三商壽,65,10,55,元大-蘆洲,2024-01-19,9857
00918,大華優利高填息30,53,0,53,元大-蘆洲,2024-01-19,9857
00919,群益台灣精選高息,64,11,53,元大-蘆洲,2024-01-19,9857
0056,元大高股息,59,7,52,元大-蘆洲,2024-01-19,9857
2409,友達,69,18,51,元大-蘆洲,2024-01-19,9857
00664R,國泰臺灣加權反1,50,0,50,元大-蘆洲,2024-01-19,9857
2887,台新金,52,2,50,元大-蘆洲,2024-01-19,9857
00751B,元大AAA至A公司債,46,0,46,元大-蘆洲,2024-01-19,9857
00688L,國泰20年美債正2,48,5,43,元大-蘆洲,2024-01-19,9857
5426,振發,184,147,37,元大-蘆洲,2024-01-19,9857
00934,中信成長高股息,36,0,36,元大-蘆洲,2024-01-19,9857
6116,彩晶,66,32,34,元大-蘆洲,2024-01-19,9857
2618,長榮航,53,20,33,元大-蘆洲,2024-01-19,9857
00878,國泰永續高股息,58,30,28,元大-蘆洲,2024-01-19,9857
6756,威鋒電子,37,10,27,元大-蘆洲,2024-01-19,9857
6244,茂迪,25,0,25,元大-蘆洲,2024-01-19,9857
3694,海華,38,13,25,元大-蘆洲,2024-01-19,9857
2377,微星,28,3,25,元大-蘆洲,2024-01-19,9857
2884,玉山金,24,0,24,元大-蘆洲,2024-01-19,9857
2014,中鴻,24,0,24,元大-蘆洲,2024-01-19,9857
8240,華宏,24,0,24,元大-蘆洲,2024-01-19,9857
3264,欣銓,36,13,23,元大-蘆洲,2024-01-19,9857
00904,新光臺灣半導體30,28,6,22,元大-蘆洲,2024-01-19,9857
6235,華孚,21,0,21,元大-蘆洲,2024-01-19,9857
6443,元晶,20,0,20,元大-蘆洲,2024-01-19,9857
2801,彰銀,20,0,20,元大-蘆洲,2024-01-19,9857
9103,美德醫療-DR,20,0,20,元大-蘆洲,2024-01-19,9857
1102,亞泥,20,0,20,元大-蘆洲,2024-01-19,9857
2515,中工,20,0,20,元大-蘆洲,2024-01-19,9857
4956,光鋐,46,27,19,元大-蘆洲,2024-01-19,9857
00720B,元大投資級公司債,18,0,18,元大-蘆洲,2024-01-19,9857
2344,華邦電,34,17,17,元大-蘆洲,2024-01-19,9857
2486,一詮,26,9,17,元大-蘆洲,2024-01-19,9857
3037,欣興,94,77,17,元大-蘆洲,2024-01-19,9857
2890,永豐金,30,14,16,元大-蘆洲,2024-01-19,9857
6156,松上,18,3,15,元大-蘆洲,2024-01-19,9857
2615,萬海,60,45,15,元大-蘆洲,2024-01-19,9857
00933B,國泰10Y+金融債,18,4,14,元大-蘆洲,2024-01-19,9857
00882,中信中國高股息,259,120,139,元大-蘆洲,2024-01-22,9857
1609,大亞,146,11,135,元大-蘆洲,2024-01-22,9857
2618,長榮航,185,58,127,元大-蘆洲,2024-01-22,9857
2353,宏��,174,71,103,元大-蘆洲,2024-01-22,9857
2014,中鴻,98,1,97,元大-蘆洲,2024-01-22,9857
00679B,元大美債20年,85,1,84,元大-蘆洲,2024-01-22,9857
00937B,群益ESG投等債20,65,0,65,元大-蘆洲,2024-01-22,9857
6120,達運,100,38,62,元大-蘆洲,2024-01-22,9857
2867,三商壽,51,0,51,元大-蘆洲,2024-01-22,9857
8096,擎亞,94,49,45,元大-蘆洲,2024-01-22,9857
00673R,期元大S＆P原油反1,50,6,44,元大-蘆洲,2024-01-22,9857
00715L,期街口布蘭特正2,40,0,40,元大-蘆洲,2024-01-22,9857
2007,燁興,40,0,40,元大-蘆洲,2024-01-22,9857
00919,群益台灣精選高息,60,25,35,元大-蘆洲,2024-01-22,9857
0056,元大高股息,61,26,35,元大-蘆洲,2024-01-22,9857
00929,復華台灣科技優息,97,64,33,元大-蘆洲,2024-01-22,9857
00664R,國泰臺灣加權反1,35,5,30,元大-蘆洲,2024-01-22,9857
6679,鈺太,31,1,30,元大-蘆洲,2024-01-22,9857
1785,光洋科,30,0,30,元大-蘆洲,2024-01-22,9857
2605,新興,30,1,29,元大-蘆洲,2024-01-22,9857
2317,鴻海,29,0,29,元大-蘆洲,2024-01-22,9857
2316,楠梓電,43,15,28,元大-蘆洲,2024-01-22,9857
00770,國泰北美科技,30,3,27,元大-蘆洲,2024-01-22,9857
1101,台泥,33,6,27,元大-蘆洲,2024-01-22,9857
6561,是方,25,0,25,元大-蘆洲,2024-01-22,9857
4915,致伸,24,0,24,元大-蘆洲,2024-01-22,9857
00687B,國泰20年美債,25,2,23,元大-蘆洲,2024-01-22,9857
6285,啟��,38,15,23,元大-蘆洲,2024-01-22,9857
00632R,元大台灣50反1,26,5,21,元大-蘆洲,2024-01-22,9857
00933B,國泰10Y+金融債,21,0,21,元大-蘆洲,2024-01-22,9857
3520,華盈,32,12,20,元大-蘆洲,2024-01-22,9857
0055,元大MSCI金融,20,0,20,元大-蘆洲,2024-01-22,9857
4188,安克,20,0,20,元大-蘆洲,2024-01-22,9857
2883,凱基金,18,0,18,元大-蘆洲,2024-01-22,9857
2882,國泰金,18,0,18,元大-蘆洲,2024-01-22,9857
6117,迎廣,23,5,18,元大-蘆洲,2024-01-22,9857
2887,台新金,32,14,18,元大-蘆洲,2024-01-22,9857
2408,南亞科,21,4,17,元大-蘆洲,2024-01-22,9857
1815,富喬,24,8,16,元大-蘆洲,2024-01-22,9857
2610,華航,34,18,16,元大-蘆洲,2024-01-22,9857
6116,彩晶,20,5,15,元大-蘆洲,2024-01-22,9857
1301,台塑,16,1,15,元大-蘆洲,2024-01-22,9857
2634,漢翔,17,2,15,元大-蘆洲,2024-01-22,9857
6139,亞翔,15,1,14,元大-蘆洲,2024-01-22,9857
6233,旺玖,42,28,14,元大-蘆洲,2024-01-22,9857
2906,高林,13,0,13,元大-蘆洲,2024-01-22,9857
2641,正德,15,2,13,元大-蘆洲,2024-01-22,9857
6190,萬泰科,14,1,13,元大-蘆洲,2024-01-22,9857
5488,松普,14,2,12,元大-蘆洲,2024-01-22,9857
5309,系統電,12,0,12,元大-蘆洲,2024-01-22,9857
3481,群創,1744,482,1262,元大-蘆洲,2024-01-23,9857
9105,泰金寶-DR,104,15,89,元大-蘆洲,2024-01-23,9857
2365,昆盈,70,2,68,元大-蘆洲,2024-01-23,9857
00673R,期元大S＆P原油反1,67,0,67,元大-蘆洲,2024-01-23,9857
00937B,群益ESG投等債20,61,1,60,元大-蘆洲,2024-01-23,9857
2002,中鋼,59,0,59,元大-蘆洲,2024-01-23,9857
6140,訊達,104,51,53,元大-蘆洲,2024-01-23,9857
00637L,元大滬深300正2,258,206,52,元大-蘆洲,2024-01-23,9857
3694,海華,53,6,47,元大-蘆洲,2024-01-23,9857
00664R,國泰臺灣加權反1,45,0,45,元大-蘆洲,2024-01-23,9857
2344,華邦電,67,23,44,元大-蘆洲,2024-01-23,9857
2408,南亞科,62,19,43,元大-蘆洲,2024-01-23,9857
1785,光洋科,61,20,41,元大-蘆洲,2024-01-23,9857
00882,中信中國高股息,96,56,40,元大-蘆洲,2024-01-23,9857
00632R,元大台灣50反1,40,0,40,元大-蘆洲,2024-01-23,9857
2609,陽明,50,18,32,元大-蘆洲,2024-01-23,9857
00929,復華台灣科技優息,90,59,31,元大-蘆洲,2024-01-23,9857
00679B,元大美債20年,33,4,29,元大-蘆洲,2024-01-23,9857
00687B,國泰20年美債,55,31,24,元大-蘆洲,2024-01-23,9857
2887,台新金,24,0,24,元大-蘆洲,2024-01-23,9857
6668,中揚光,26,3,23,元大-蘆洲,2024-01-23,9857
2027,大成鋼,22,0,22,元大-蘆洲,2024-01-23,9857
2884,玉山金,63,44,19,元大-蘆洲,2024-01-23,9857
2474,可成,20,1,19,元大-蘆洲,2024-01-23,9857
6218,豪勉,19,1,18,元大-蘆洲,2024-01-23,9857
2301,光寶科,18,4,14,元大-蘆洲,2024-01-23,9857
3576,聯合再生,15,1,14,元大-蘆洲,2024-01-23,9857
6117,迎廣,17,3,14,元大-蘆洲,2024-01-23,9857
3296,勝德,15,1,14,元大-蘆洲,2024-01-23,9857
2449,京元電子,19,5,14,元大-蘆洲,2024-01-23,9857
1609,大亞,56,42,14,元大-蘆洲,2024-01-23,9857
1795,美時,16,3,13,元大-蘆洲,2024-01-23,9857
00933B,國泰10Y+金融債,18,5,13,元大-蘆洲,2024-01-23,9857
1101,台泥,12,0,12,元大-蘆洲,2024-01-23,9857
2316,楠梓電,13,1,12,元大-蘆洲,2024-01-23,9857
2634,漢翔,13,2,11,元大-蘆洲,2024-01-23,9857
2867,三商壽,11,0,11,元大-蘆洲,2024-01-23,9857
3014,聯陽,12,1,11,元大-蘆洲,2024-01-23,9857
2014,中鴻,14,3,11,元大-蘆洲,2024-01-23,9857
6129,普誠,11,0,11,元大-蘆洲,2024-01-23,9857
2376,技嘉,19,9,10,元大-蘆洲,2024-01-23,9857
4908,前鼎,22,12,10,元大-蘆洲,2024-01-23,9857
2892,第一金,10,0,10,元大-蘆洲,2024-01-23,9857
00697B,元大美債7-10,10,0,10,元大-蘆洲,2024-01-23,9857
6561,是方,10,0,10,元大-蘆洲,2024-01-23,9857
1218,泰山,10,0,10,元大-蘆洲,2024-01-23,9857
5534,長虹,10,0,10,元大-蘆洲,2024-01-23,9857
6233,旺玖,21,11,10,元大-蘆洲,2024-01-23,9857
3042,晶技,10,0,10,元大-蘆洲,2024-01-23,9857
00909,國泰數位支付服務,10,0,10,元大-蘆洲,2024-01-23,9857
3481,群創,887,533,354,元大-蘆洲,2024-01-24,9857
00937B,群益ESG投等債20,230,0,230,元大-蘆洲,2024-01-24,9857
00632R,元大台灣50反1,148,0,148,元大-蘆洲,2024-01-24,9857
00882,中信中國高股息,163,21,142,元大-蘆洲,2024-01-24,9857
2369,菱生,295,189,106,元大-蘆洲,2024-01-24,9857
00637L,元大滬深300正2,237,149,88,元大-蘆洲,2024-01-24,9857
00919,群益台灣精選高息,99,12,87,元大-蘆洲,2024-01-24,9857
3622,洋華,78,6,72,元大-蘆洲,2024-01-24,9857
6116,彩晶,105,42,63,元大-蘆洲,2024-01-24,9857
2409,友達,65,5,60,元大-蘆洲,2024-01-24,9857
2344,華邦電,73,17,56,元大-蘆洲,2024-01-24,9857
00664R,國泰臺灣加權反1,55,0,55,元大-蘆洲,2024-01-24,9857
3037,欣興,80,26,54,元大-蘆洲,2024-01-24,9857
2313,華通,70,18,52,元大-蘆洲,2024-01-24,9857
2515,中工,52,0,52,元大-蘆洲,2024-01-24,9857
2324,仁寶,54,4,50,元大-蘆洲,2024-01-24,9857
00680L,元大美債20正2,47,0,47,元大-蘆洲,2024-01-24,9857
2887,台新金,41,2,39,元大-蘆洲,2024-01-24,9857
00687B,國泰20年美債,37,0,37,元大-蘆洲,2024-01-24,9857
1434,福懋,40,3,37,元大-蘆洲,2024-01-24,9857
00679B,元大美債20年,42,7,35,元大-蘆洲,2024-01-24,9857
00933B,國泰10Y+金融債,35,0,35,元大-蘆洲,2024-01-24,9857
6140,訊達,49,15,34,元大-蘆洲,2024-01-24,9857
2014,中鴻,45,12,33,元大-蘆洲,2024-01-24,9857
1314,中石化,33,5,28,元大-蘆洲,2024-01-24,9857
2408,南亞科,44,16,28,元大-蘆洲,2024-01-24,9857
00688L,國泰20年美債正2,28,2,26,元大-蘆洲,2024-01-24,9857
8028,昇陽半導體,28,3,25,元大-蘆洲,2024-01-24,9857
00931B,統一美債20年,25,0,25,元大-蘆洲,2024-01-24,9857
5301,寶得利,24,0,24,元大-蘆洲,2024-01-24,9857
2371,大同,32,9,23,元大-蘆洲,2024-01-24,9857
1785,光洋科,27,5,22,元大-蘆洲,2024-01-24,9857
6679,鈺太,20,0,20,元大-蘆洲,2024-01-24,9857
00915,凱基優選高股息30,20,0,20,元大-蘆洲,2024-01-24,9857
1304,台聚,20,0,20,元大-蘆洲,2024-01-24,9857
1582,信錦,20,0,20,元大-蘆洲,2024-01-24,9857
00795B,中信美國公債20年,18,0,18,元大-蘆洲,2024-01-24,9857
6770,力積電,21,3,18,元大-蘆洲,2024-01-24,9857
6233,旺玖,44,27,17,元大-蘆洲,2024-01-24,9857
8089,康全電訊,18,1,17,元大-蘆洲,2024-01-24,9857
3545,敦泰,26,10,16,元大-蘆洲,2024-01-24,9857
6505,台塑化,16,0,16,元大-蘆洲,2024-01-24,9857
6239,力成,18,3,15,元大-蘆洲,2024-01-24,9857
2007,燁興,15,0,15,元大-蘆洲,2024-01-24,9857
00665L,富邦�琤肭磪囓�2,20,6,14,元大-蘆洲,2024-01-24,9857
00900,富邦特選高股息30,30,16,14,元大-蘆洲,2024-01-24,9857
3325,旭品,13,0,13,元大-蘆洲,2024-01-24,9857
3712,永崴投控,35,22,13,元大-蘆洲,2024-01-24,9857
1514,亞力,27,14,13,元大-蘆洲,2024-01-24,9857
5871,中租-KY,13,0,13,元大-蘆洲,2024-01-24,9857
3548,兆利,301,49,252,元大-蘆洲,2024-01-25,9857
00680L,元大美債20正2,232,3,229,元大-蘆洲,2024-01-25,9857
2002,中鋼,174,3,171,元大-蘆洲,2024-01-25,9857
00687B,國泰20年美債,165,6,159,元大-蘆洲,2024-01-25,9857
00937B,群益ESG投等債20,169,22,147,元大-蘆洲,2024-01-25,9857
2408,南亞科,113,1,112,元大-蘆洲,2024-01-25,9857
3376,新日興,119,17,102,元大-蘆洲,2024-01-25,9857
00676R,富邦臺灣加權反1,100,0,100,元大-蘆洲,2024-01-25,9857
00679B,元大美債20年,87,6,81,元大-蘆洲,2024-01-25,9857
3380,明泰,80,0,80,元大-蘆洲,2024-01-25,9857
8096,擎亞,344,267,77,元大-蘆洲,2024-01-25,9857
8028,昇陽半導體,67,0,67,元大-蘆洲,2024-01-25,9857
3231,緯創,226,181,45,元大-蘆洲,2024-01-25,9857
1785,光洋科,41,1,40,元大-蘆洲,2024-01-25,9857
1582,信錦,40,0,40,元大-蘆洲,2024-01-25,9857
00632R,元大台灣50反1,44,5,39,元大-蘆洲,2024-01-25,9857
00688L,國泰20年美債正2,43,5,38,元大-蘆洲,2024-01-25,9857
2498,宏達電,44,7,37,元大-蘆洲,2024-01-25,9857
8105,凌巨,52,17,35,元大-蘆洲,2024-01-25,9857
6116,彩晶,40,6,34,元大-蘆洲,2024-01-25,9857
2409,友達,65,32,33,元大-蘆洲,2024-01-25,9857
1714,和桐,32,0,32,元大-蘆洲,2024-01-25,9857
00712,復華富時不動產,31,0,31,元大-蘆洲,2024-01-25,9857
5328,華容,30,0,30,元大-蘆洲,2024-01-25,9857
5490,同亨,30,0,30,元大-蘆洲,2024-01-25,9857
2615,萬海,26,0,26,元大-蘆洲,2024-01-25,9857
2467,志聖,22,0,22,元大-蘆洲,2024-01-25,9857
5483,中美晶,22,0,22,元大-蘆洲,2024-01-25,9857
4909,新復興,82,61,21,元大-蘆洲,2024-01-25,9857
00933B,國泰10Y+金融債,21,0,21,元大-蘆洲,2024-01-25,9857
3521,鴻翊,20,0,20,元大-蘆洲,2024-01-25,9857
00673R,期元大S＆P原油反1,20,0,20,元大-蘆洲,2024-01-25,9857
6111,大宇資,29,10,19,元大-蘆洲,2024-01-25,9857
6113,亞矽,49,31,18,元大-蘆洲,2024-01-25,9857
3706,神達,28,11,17,元大-蘆洲,2024-01-25,9857
3032,偉訓,18,1,17,元大-蘆洲,2024-01-25,9857
2363,矽統,37,20,17,元大-蘆洲,2024-01-25,9857
4129,聯合,22,5,17,元大-蘆洲,2024-01-25,9857
2421,建準,41,24,17,元大-蘆洲,2024-01-25,9857
2314,台揚,16,0,16,元大-蘆洲,2024-01-25,9857
00795B,中信美國公債20年,16,0,16,元大-蘆洲,2024-01-25,9857
1314,中石化,16,0,16,元大-蘆洲,2024-01-25,9857
6462,神盾,39,24,15,元大-蘆洲,2024-01-25,9857
3645,達邁,17,2,15,元大-蘆洲,2024-01-25,9857
6695,芯鼎,21,7,14,元大-蘆洲,2024-01-25,9857
4979,華星光,19,5,14,元大-蘆洲,2024-01-25,9857
1809,中釉,18,4,14,元大-蘆洲,2024-01-25,9857
2884,玉山金,14,1,13,元大-蘆洲,2024-01-25,9857
4999,鑫禾,13,0,13,元大-蘆洲,2024-01-25,9857
2369,菱生,28,15,13,元大-蘆洲,2024-01-25,9857
2303,聯電,616,142,474,元大-蘆洲,2024-01-26,9857
00929,復華台灣科技優息,197,33,164,元大-蘆洲,2024-01-26,9857
00937B,群益ESG投等債20,130,4,126,元大-蘆洲,2024-01-26,9857
6120,達運,241,124,117,元大-蘆洲,2024-01-26,9857
00680L,元大美債20正2,127,28,99,元大-蘆洲,2024-01-26,9857
00919,群益台灣精選高息,112,23,89,元大-蘆洲,2024-01-26,9857
2324,仁寶,102,44,58,元大-蘆洲,2024-01-26,9857
00637L,元大滬深300正2,96,48,48,元大-蘆洲,2024-01-26,9857
6239,力成,53,9,44,元大-蘆洲,2024-01-26,9857
3231,緯創,141,102,39,元大-蘆洲,2024-01-26,9857
2867,三商壽,36,0,36,元大-蘆洲,2024-01-26,9857
5521,工信,34,0,34,元大-蘆洲,2024-01-26,9857
00891,中信關鍵半導體,32,2,30,元大-蘆洲,2024-01-26,9857
8096,擎亞,101,71,30,元大-蘆洲,2024-01-26,9857
2897,王道銀行,30,0,30,元大-蘆洲,2024-01-26,9857
00651R,復華香港反1,30,0,30,元大-蘆洲,2024-01-26,9857
2329,華泰,73,43,30,元大-蘆洲,2024-01-26,9857
00673R,期元大S＆P原油反1,29,0,29,元大-蘆洲,2024-01-26,9857
00878,國泰永續高股息,44,17,27,元大-蘆洲,2024-01-26,9857
00665L,富邦�琤肭磪囓�2,27,0,27,元大-蘆洲,2024-01-26,9857
00687B,國泰20年美債,26,0,26,元大-蘆洲,2024-01-26,9857
3623,富晶通,49,24,25,元大-蘆洲,2024-01-26,9857
6235,華孚,26,4,22,元大-蘆洲,2024-01-26,9857
8033,雷虎,22,0,22,元大-蘆洲,2024-01-26,9857
00676R,富邦臺灣加權反1,30,10,20,元大-蘆洲,2024-01-26,9857
3264,欣銓,23,3,20,元大-蘆洲,2024-01-26,9857
00900,富邦特選高股息30,19,0,19,元大-蘆洲,2024-01-26,9857
2609,陽明,35,17,18,元大-蘆洲,2024-01-26,9857
00688L,國泰20年美債正2,25,7,18,元大-蘆洲,2024-01-26,9857
2363,矽統,28,10,18,元大-蘆洲,2024-01-26,9857
00933B,國泰10Y+金融債,19,2,17,元大-蘆洲,2024-01-26,9857
3312,弘憶股,17,1,16,元大-蘆洲,2024-01-26,9857
2301,光寶科,17,2,15,元大-蘆洲,2024-01-26,9857
00712,復華富時不動產,15,0,15,元大-蘆洲,2024-01-26,9857
00679B,元大美債20年,28,13,15,元大-蘆洲,2024-01-26,9857
00892,富邦台灣半導體,36,21,15,元大-蘆洲,2024-01-26,9857
2344,華邦電,44,30,14,元大-蘆洲,2024-01-26,9857
6285,啟��,20,6,14,元大-蘆洲,2024-01-26,9857
00752,中信中國50,14,0,14,元大-蘆洲,2024-01-26,9857
3032,偉訓,17,4,13,元大-蘆洲,2024-01-26,9857
2369,菱生,23,10,13,元大-蘆洲,2024-01-26,9857
3066,李洲,27,14,13,元大-蘆洲,2024-01-26,9857
3615,安可,24,11,13,元大-蘆洲,2024-01-26,9857
2603,長榮,23,10,13,元大-蘆洲,2024-01-26,9857
2421,建準,24,11,13,元大-蘆洲,2024-01-26,9857
2388,威盛,41,28,13,元大-蘆洲,2024-01-26,9857
3712,永崴投控,21,9,12,元大-蘆洲,2024-01-26,9857
1449,佳和,12,0,12,元大-蘆洲,2024-01-26,9857
6140,訊達,54,42,12,元大-蘆洲,2024-01-26,9857
2357,華碩,17,5,12,元大-蘆洲,2024-01-26,9857
00650L,復華香港正2,201,1,200,元大-蘆洲,2024-01-29,9857
00687B,國泰20年美債,160,1,159,元大-蘆洲,2024-01-29,9857
8086,宏捷科,150,0,150,元大-蘆洲,2024-01-29,9857
00680L,元大美債20正2,120,0,120,元大-蘆洲,2024-01-29,9857
00937B,群益ESG投等債20,159,41,118,元大-蘆洲,2024-01-29,9857
3481,群創,373,258,115,元大-蘆洲,2024-01-29,9857
00885,富邦越南,101,1,100,元大-蘆洲,2024-01-29,9857
2867,三商壽,72,0,72,元大-蘆洲,2024-01-29,9857
2303,聯電,121,55,66,元大-蘆洲,2024-01-29,9857
3360,尚立,247,182,65,元大-蘆洲,2024-01-29,9857
6120,達運,64,4,60,元大-蘆洲,2024-01-29,9857
00673R,期元大S＆P原油反1,59,0,59,元大-蘆洲,2024-01-29,9857
00933B,國泰10Y+金融債,49,0,49,元大-蘆洲,2024-01-29,9857
3380,明泰,50,1,49,元大-蘆洲,2024-01-29,9857
2618,長榮航,212,169,43,元大-蘆洲,2024-01-29,9857
8096,擎亞,168,126,42,元大-蘆洲,2024-01-29,9857
00664R,國泰臺灣加權反1,40,0,40,元大-蘆洲,2024-01-29,9857
1309,台達化,38,1,37,元大-蘆洲,2024-01-29,9857
2527,宏璟,35,0,35,元大-蘆洲,2024-01-29,9857
00923,群益台ESG低碳50,34,0,34,元大-蘆洲,2024-01-29,9857
2409,友達,38,6,32,元大-蘆洲,2024-01-29,9857
3066,李洲,45,15,30,元大-蘆洲,2024-01-29,9857
00679B,元大美債20年,39,10,29,元大-蘆洲,2024-01-29,9857
5426,振發,56,27,29,元大-蘆洲,2024-01-29,9857
6244,茂迪,50,24,26,元大-蘆洲,2024-01-29,9857
2331,精英,27,2,25,元大-蘆洲,2024-01-29,9857
4128,中天,24,0,24,元大-蘆洲,2024-01-29,9857
3059,華晶科,33,9,24,元大-蘆洲,2024-01-29,9857
4968,立積,36,13,23,元大-蘆洲,2024-01-29,9857
2484,希華,22,0,22,元大-蘆洲,2024-01-29,9857
00753L,中信中國50正2,21,0,21,元大-蘆洲,2024-01-29,9857
00882,中信中國高股息,36,15,21,元大-蘆洲,2024-01-29,9857
2363,矽統,25,5,20,元大-蘆洲,2024-01-29,9857
00719B,元大美債1-3,20,0,20,元大-蘆洲,2024-01-29,9857
5328,華容,22,2,20,元大-蘆洲,2024-01-29,9857
2515,中工,30,10,20,元大-蘆洲,2024-01-29,9857
2302,麗正,20,0,20,元大-蘆洲,2024-01-29,9857
2836,高雄銀,20,0,20,元大-蘆洲,2024-01-29,9857
00935,野村臺灣新科技50,19,0,19,元大-蘆洲,2024-01-29,9857
5475,德宏,19,0,19,元大-蘆洲,2024-01-29,9857
2392,正崴,19,0,19,元大-蘆洲,2024-01-29,9857
00927,群益半導體收益,20,2,18,元大-蘆洲,2024-01-29,9857
1438,三地開發,18,0,18,元大-蘆洲,2024-01-29,9857
6117,迎廣,19,1,18,元大-蘆洲,2024-01-29,9857
2615,萬海,20,3,17,元大-蘆洲,2024-01-29,9857
1785,光洋科,21,5,16,元大-蘆洲,2024-01-29,9857
5521,工信,16,0,16,元大-蘆洲,2024-01-29,9857
6140,訊達,51,35,16,元大-蘆洲,2024-01-29,9857
3622,洋華,40,25,15,元大-蘆洲,2024-01-29,9857
00706L,期元大S＆P日圓正2,15,0,15,元大-蘆洲,2024-01-29,9857
00637L,元大滬深300正2,354,134,220,元大-蘆洲,2024-01-30,9857
2618,長榮航,234,21,213,元大-蘆洲,2024-01-30,9857
4543,萬在,170,51,119,元大-蘆洲,2024-01-30,9857
2308,台達電,73,1,72,元大-蘆洲,2024-01-30,9857
3481,群創,124,54,70,元大-蘆洲,2024-01-30,9857
2409,友達,98,33,65,元大-蘆洲,2024-01-30,9857
00664R,國泰臺灣加權反1,60,0,60,元大-蘆洲,2024-01-30,9857
1438,三地開發,58,0,58,元大-蘆洲,2024-01-30,9857
00933B,國泰10Y+金融債,60,3,57,元大-蘆洲,2024-01-30,9857
00882,中信中國高股息,66,10,56,元大-蘆洲,2024-01-30,9857
00679B,元大美債20年,58,12,46,元大-蘆洲,2024-01-30,9857
00919,群益台灣精選高息,50,5,45,元大-蘆洲,2024-01-30,9857
2344,華邦電,45,2,43,元大-蘆洲,2024-01-30,9857
2888,新光金,48,5,43,元大-蘆洲,2024-01-30,9857
3376,新日興,46,4,42,元大-蘆洲,2024-01-30,9857
00633L,富邦上証正2,52,10,42,元大-蘆洲,2024-01-30,9857
00937B,群益ESG投等債20,79,39,40,元大-蘆洲,2024-01-30,9857
2885,元大金,40,1,39,元大-蘆洲,2024-01-30,9857
2337,旺宏,42,3,39,元大-蘆洲,2024-01-30,9857
2867,三商壽,45,12,33,元大-蘆洲,2024-01-30,9857
1815,富喬,31,0,31,元大-蘆洲,2024-01-30,9857
00687B,國泰20年美債,49,20,29,元大-蘆洲,2024-01-30,9857
00632R,元大台灣50反1,34,5,29,元大-蘆洲,2024-01-30,9857
3694,海華,39,12,27,元大-蘆洲,2024-01-30,9857
2515,中工,26,0,26,元大-蘆洲,2024-01-30,9857
00665L,富邦�琤肭磪囓�2,38,12,26,元大-蘆洲,2024-01-30,9857
2426,鼎元,25,0,25,元大-蘆洲,2024-01-30,9857
2104,國際中橡,30,5,25,元大-蘆洲,2024-01-30,9857
2002,中鋼,30,6,24,元大-蘆洲,2024-01-30,9857
2353,宏��,30,9,21,元大-蘆洲,2024-01-30,9857
2328,廣宇,20,0,20,元大-蘆洲,2024-01-30,9857
9105,泰金寶-DR,33,15,18,元大-蘆洲,2024-01-30,9857
6125,廣運,39,22,17,元大-蘆洲,2024-01-30,9857
4162,智擎,17,0,17,元大-蘆洲,2024-01-30,9857
3017,奇鋐,29,13,16,元大-蘆洲,2024-01-30,9857
2498,宏達電,24,8,16,元大-蘆洲,2024-01-30,9857
2421,建準,83,67,16,元大-蘆洲,2024-01-30,9857
3033,威健,71,55,16,元大-蘆洲,2024-01-30,9857
2314,台揚,16,0,16,元大-蘆洲,2024-01-30,9857
5871,中租-KY,17,1,16,元大-蘆洲,2024-01-30,9857
3312,弘憶股,15,0,15,元大-蘆洲,2024-01-30,9857
00715L,期街口布蘭特正2,15,0,15,元大-蘆洲,2024-01-30,9857
2392,正崴,15,0,15,元大-蘆洲,2024-01-30,9857
00751B,元大AAA至A公司債,15,0,15,元大-蘆洲,2024-01-30,9857
00639,富邦深100,14,0,14,元大-蘆洲,2024-01-30,9857
8064,東捷,82,68,14,元大-蘆洲,2024-01-30,9857
6757,台灣虎航,15,1,14,元大-蘆洲,2024-01-30,9857
5498,凱崴,17,3,14,元大-蘆洲,2024-01-30,9857
1504,東元,14,1,13,元大-蘆洲,2024-01-30,9857
2313,華通,37,24,13,元大-蘆洲,2024-01-30,9857
00680L,元大美債20正2,346,113,233,元大-蘆洲,2024-01-31,9857
00688L,國泰20年美債正2,192,4,188,元大-蘆洲,2024-01-31,9857
1609,大亞,174,10,164,元大-蘆洲,2024-01-31,9857
6116,彩晶,129,0,129,元大-蘆洲,2024-01-31,9857
2534,宏盛,99,0,99,元大-蘆洲,2024-01-31,9857
00929,復華台灣科技優息,116,24,92,元大-蘆洲,2024-01-31,9857
3231,緯創,124,41,83,元大-蘆洲,2024-01-31,9857
2303,聯電,146,71,75,元大-蘆洲,2024-01-31,9857
6265,方土昶,69,0,69,元大-蘆洲,2024-01-31,9857
00715L,期街口布蘭特正2,66,0,66,元大-蘆洲,2024-01-31,9857
00882,中信中國高股息,64,2,62,元大-蘆洲,2024-01-31,9857
00937B,群益ESG投等債20,119,64,55,元大-蘆洲,2024-01-31,9857
00673R,期元大S＆P原油反1,50,0,50,元大-蘆洲,2024-01-31,9857
2867,三商壽,52,10,42,元大-蘆洲,2024-01-31,9857
2356,英業達,96,58,38,元大-蘆洲,2024-01-31,9857
2002,中鋼,36,3,33,元大-蘆洲,2024-01-31,9857
4938,和碩,34,2,32,元大-蘆洲,2024-01-31,9857
2611,志信,32,0,32,元大-蘆洲,2024-01-31,9857
2104,國際中橡,30,0,30,元大-蘆洲,2024-01-31,9857
00753L,中信中國50正2,40,10,30,元大-蘆洲,2024-01-31,9857
6425,易發,27,0,27,元大-蘆洲,2024-01-31,9857
6113,亞矽,48,24,24,元大-蘆洲,2024-01-31,9857
2337,旺宏,27,3,24,元大-蘆洲,2024-01-31,9857
2379,瑞昱,30,7,23,元大-蘆洲,2024-01-31,9857
2365,昆盈,36,14,22,元大-蘆洲,2024-01-31,9857
2330,台積電,26,5,21,元大-蘆洲,2024-01-31,9857
00637L,元大滬深300正2,323,302,21,元大-蘆洲,2024-01-31,9857
2515,中工,21,0,21,元大-蘆洲,2024-01-31,9857
6237,驊訊,45,24,21,元大-蘆洲,2024-01-31,9857
0056,元大高股息,22,2,20,元大-蘆洲,2024-01-31,9857
8210,勤誠,50,30,20,元大-蘆洲,2024-01-31,9857
2353,宏��,22,2,20,元大-蘆洲,2024-01-31,9857
2607,榮運,20,0,20,元大-蘆洲,2024-01-31,9857
6140,訊達,102,83,19,元大-蘆洲,2024-01-31,9857
6695,芯鼎,68,49,19,元大-蘆洲,2024-01-31,9857
2812,台中銀,18,0,18,元大-蘆洲,2024-01-31,9857
00919,群益台灣精選高息,132,114,18,元大-蘆洲,2024-01-31,9857
3037,欣興,21,4,17,元大-蘆洲,2024-01-31,9857
2382,廣達,25,8,17,元大-蘆洲,2024-01-31,9857
8085,福華,22,6,16,元大-蘆洲,2024-01-31,9857
3545,敦泰,37,21,16,元大-蘆洲,2024-01-31,9857
3081,聯亞,16,0,16,元大-蘆洲,2024-01-31,9857
00687B,國泰20年美債,126,110,16,元大-蘆洲,2024-01-31,9857
00712,復華富時不動產,21,6,15,元大-蘆洲,2024-01-31,9857
6757,台灣虎航,15,0,15,元大-蘆洲,2024-01-31,9857
3294,英濟,16,1,15,元大-蘆洲,2024-01-31,9857
6182,合晶,15,0,15,元大-蘆洲,2024-01-31,9857
2344,華邦電,20,6,14,元大-蘆洲,2024-01-31,9857
3605,宏致,19,5,14,元大-蘆洲,2024-01-31,9857
2425,承啟,13,0,13,元大-蘆洲,2024-01-31,9857
2409,友達,453,104,349,元大-蘆洲,2024-02-01,9857
00712,復華富時不動產,345,31,314,元大-蘆洲,2024-02-01,9857
00929,復華台灣科技優息,247,14,233,元大-蘆洲,2024-02-01,9857
6116,彩晶,172,83,89,元大-蘆洲,2024-02-01,9857
2303,聯電,83,13,70,元大-蘆洲,2024-02-01,9857
3037,欣興,79,14,65,元大-蘆洲,2024-02-01,9857
5531,鄉林,60,0,60,元大-蘆洲,2024-02-01,9857
4906,正文,68,12,56,元大-蘆洲,2024-02-01,9857
8936,國統,158,105,53,元大-蘆洲,2024-02-01,9857
00676R,富邦臺灣加權反1,50,0,50,元大-蘆洲,2024-02-01,9857
00878,國泰永續高股息,78,29,49,元大-蘆洲,2024-02-01,9857
1732,毛寶,47,0,47,元大-蘆洲,2024-02-01,9857
00665L,富邦�琤肭磪囓�2,55,8,47,元大-蘆洲,2024-02-01,9857
00937B,群益ESG投等債20,69,25,44,元大-蘆洲,2024-02-01,9857
00688L,國泰20年美債正2,66,24,42,元大-蘆洲,2024-02-01,9857
00918,大華優利高填息30,50,9,41,元大-蘆洲,2024-02-01,9857
3481,群創,176,136,40,元大-蘆洲,2024-02-01,9857
00637L,元大滬深300正2,230,191,39,元大-蘆洲,2024-02-01,9857
00882,中信中國高股息,40,1,39,元大-蘆洲,2024-02-01,9857
00919,群益台灣精選高息,64,36,28,元大-蘆洲,2024-02-01,9857
2867,三商壽,29,2,27,元大-蘆洲,2024-02-01,9857
3289,宜特,32,5,27,元大-蘆洲,2024-02-01,9857
3706,神達,24,3,21,元大-蘆洲,2024-02-01,9857
1528,恩德,31,10,21,元大-蘆洲,2024-02-01,9857
6165,浪凡,25,5,20,元大-蘆洲,2024-02-01,9857
2897,王道銀行,20,0,20,元大-蘆洲,2024-02-01,9857
2312,金寶,20,0,20,元大-蘆洲,2024-02-01,9857
2511,太子,20,0,20,元大-蘆洲,2024-02-01,9857
2356,英業達,72,53,19,元大-蘆洲,2024-02-01,9857
3615,安可,21,2,19,元大-蘆洲,2024-02-01,9857
00930,永豐ESG低碳高息,17,0,17,元大-蘆洲,2024-02-01,9857
3712,永崴投控,25,8,17,元大-蘆洲,2024-02-01,9857
3535,晶彩科,21,4,17,元大-蘆洲,2024-02-01,9857
2903,遠百,16,0,16,元大-蘆洲,2024-02-01,9857
3360,尚立,17,1,16,元大-蘆洲,2024-02-01,9857
3434,哲固,14,0,14,元大-蘆洲,2024-02-01,9857
6112,邁達特,18,4,14,元大-蘆洲,2024-02-01,9857
1503,士電,31,17,14,元大-蘆洲,2024-02-01,9857
00933B,國泰10Y+金融債,18,5,13,元大-蘆洲,2024-02-01,9857
5272,笙科,39,26,13,元大-蘆洲,2024-02-01,9857
00935,野村臺灣新科技50,12,0,12,元大-蘆洲,2024-02-01,9857
6244,茂迪,15,3,12,元大-蘆洲,2024-02-01,9857
5009,榮剛,12,0,12,元大-蘆洲,2024-02-01,9857
8110,華東,11,0,11,元大-蘆洲,2024-02-01,9857
00881,國泰台灣5G+,11,0,11,元大-蘆洲,2024-02-01,9857
6176,瑞儀,12,1,11,元大-蘆洲,2024-02-01,9857
4960,誠美材,11,0,11,元大-蘆洲,2024-02-01,9857
6229,研通,38,27,11,元大-蘆洲,2024-02-01,9857
6243,迅杰,25,14,11,元大-蘆洲,2024-02-01,9857
2355,敬鵬,12,2,10,元大-蘆洲,2024-02-01,9857
2353,宏��,262,65,197,元大-蘆洲,2024-02-02,9857
00637L,元大滬深300正2,267,98,169,元大-蘆洲,2024-02-02,9857
3289,宜特,151,3,148,元大-蘆洲,2024-02-02,9857
8059,凱碩,123,6,117,元大-蘆洲,2024-02-02,9857
00929,復華台灣科技優息,93,19,74,元大-蘆洲,2024-02-02,9857
00688L,國泰20年美債正2,76,4,72,元大-蘆洲,2024-02-02,9857
3615,安可,82,23,59,元大-蘆洲,2024-02-02,9857
00919,群益台灣精選高息,93,35,58,元大-蘆洲,2024-02-02,9857
2891,中信金,58,0,58,元大-蘆洲,2024-02-02,9857
00937B,群益ESG投等債20,70,12,58,元大-蘆洲,2024-02-02,9857
00712,復華富時不動產,62,5,57,元大-蘆洲,2024-02-02,9857
2603,長榮,59,6,53,元大-蘆洲,2024-02-02,9857
2812,台中銀,62,11,51,元大-蘆洲,2024-02-02,9857
4543,萬在,125,76,49,元大-蘆洲,2024-02-02,9857
2344,華邦電,45,3,42,元大-蘆洲,2024-02-02,9857
2324,仁寶,42,1,41,元大-蘆洲,2024-02-02,9857
3481,群創,50,10,40,元大-蘆洲,2024-02-02,9857
00878,國泰永續高股息,109,73,36,元大-蘆洲,2024-02-02,9857
6116,彩晶,34,0,34,元大-蘆洲,2024-02-02,9857
5608,四維航,35,2,33,元大-蘆洲,2024-02-02,9857
2607,榮運,31,0,31,元大-蘆洲,2024-02-02,9857
2345,智邦,39,8,31,元大-蘆洲,2024-02-02,9857
8996,高力,42,12,30,元大-蘆洲,2024-02-02,9857
3694,海華,43,16,27,元大-蘆洲,2024-02-02,9857
1513,中興電,105,81,24,元大-蘆洲,2024-02-02,9857
1815,富喬,23,0,23,元大-蘆洲,2024-02-02,9857
2515,中工,22,0,22,元大-蘆洲,2024-02-02,9857
1529,樂事綠能,23,1,22,元大-蘆洲,2024-02-02,9857
00752,中信中國50,21,0,21,元大-蘆洲,2024-02-02,9857
8089,康全電訊,37,16,21,元大-蘆洲,2024-02-02,9857
2511,太子,20,0,20,元大-蘆洲,2024-02-02,9857
00720B,元大投資級公司債,20,0,20,元大-蘆洲,2024-02-02,9857
00679B,元大美債20年,54,35,19,元大-蘆洲,2024-02-02,9857
5351,鈺創,22,3,19,元大-蘆洲,2024-02-02,9857
2303,聯電,79,60,19,元大-蘆洲,2024-02-02,9857
2615,萬海,20,2,18,元大-蘆洲,2024-02-02,9857
6770,力積電,23,6,17,元大-蘆洲,2024-02-02,9857
2610,華航,19,3,16,元大-蘆洲,2024-02-02,9857
6695,芯鼎,88,73,15,元大-蘆洲,2024-02-02,9857
00931B,統一美債20年,25,10,15,元大-蘆洲,2024-02-02,9857
6244,茂迪,15,0,15,元大-蘆洲,2024-02-02,9857
6165,浪凡,14,0,14,元大-蘆洲,2024-02-02,9857
6282,康舒,19,6,13,元大-蘆洲,2024-02-02,9857
2313,華通,24,11,13,元大-蘆洲,2024-02-02,9857
2023,燁輝,13,0,13,元大-蘆洲,2024-02-02,9857
2314,台揚,12,0,12,元大-蘆洲,2024-02-02,9857
4908,前鼎,33,22,11,元大-蘆洲,2024-02-02,9857
2609,陽明,81,70,11,元大-蘆洲,2024-02-02,9857
2369,菱生,14,3,11,元大-蘆洲,2024-02-02,9857
1201,味全,11,0,11,元大-蘆洲,2024-02-02,9857
00687B,國泰20年美債,302,0,302,元大-蘆洲,2024-02-05,9857
00937B,群益ESG投等債20,151,5,146,元大-蘆洲,2024-02-05,9857
6757,台灣虎航,127,0,127,元大-蘆洲,2024-02-05,9857
00919,群益台灣精選高息,195,74,121,元大-蘆洲,2024-02-05,9857
1528,恩德,115,11,104,元大-蘆洲,2024-02-05,9857
4714,永捷,115,11,104,元大-蘆洲,2024-02-05,9857
00679B,元大美債20年,92,1,91,元大-蘆洲,2024-02-05,9857
00680L,元大美債20正2,103,15,88,元大-蘆洲,2024-02-05,9857
2891,中信金,104,17,87,元大-蘆洲,2024-02-05,9857
2467,志聖,94,10,84,元大-蘆洲,2024-02-05,9857
2387,精元,87,7,80,元大-蘆洲,2024-02-05,9857
00764B,群益25年美債,72,0,72,元大-蘆洲,2024-02-05,9857
3615,安可,90,19,71,元大-蘆洲,2024-02-05,9857
3041,揚智,119,51,68,元大-蘆洲,2024-02-05,9857
2303,聯電,81,18,63,元大-蘆洲,2024-02-05,9857
1513,中興電,77,18,59,元大-蘆洲,2024-02-05,9857
6285,啟��,63,5,58,元大-蘆洲,2024-02-05,9857
2890,永豐金,60,6,54,元大-蘆洲,2024-02-05,9857
00902,中信電池及儲能,53,0,53,元大-蘆洲,2024-02-05,9857
00933B,國泰10Y+金融債,102,50,52,元大-蘆洲,2024-02-05,9857
00712,復華富時不動產,56,5,51,元大-蘆洲,2024-02-05,9857
00715L,期街口布蘭特正2,55,6,49,元大-蘆洲,2024-02-05,9857
00882,中信中國高股息,56,8,48,元大-蘆洲,2024-02-05,9857
2329,華泰,75,30,45,元大-蘆洲,2024-02-05,9857
3530,晶相光,63,19,44,元大-蘆洲,2024-02-05,9857
6126,信音,40,0,40,元大-蘆洲,2024-02-05,9857
2356,英業達,74,34,40,元大-蘆洲,2024-02-05,9857
2609,陽明,46,7,39,元大-蘆洲,2024-02-05,9857
2421,建準,104,68,36,元大-蘆洲,2024-02-05,9857
3035,智原,37,3,34,元大-蘆洲,2024-02-05,9857
2388,威盛,51,22,29,元大-蘆洲,2024-02-05,9857
3545,敦泰,34,10,24,元大-蘆洲,2024-02-05,9857
6770,力積電,31,8,23,元大-蘆洲,2024-02-05,9857
2406,國碩,23,0,23,元大-蘆洲,2024-02-05,9857
00632R,元大台灣50反1,32,10,22,元大-蘆洲,2024-02-05,9857
3576,聯合再生,22,1,21,元大-蘆洲,2024-02-05,9857
3481,群創,55,34,21,元大-蘆洲,2024-02-05,9857
00795B,中信美國公債20年,20,0,20,元大-蘆洲,2024-02-05,9857
6276,安鈦克,20,0,20,元大-蘆洲,2024-02-05,9857
3032,偉訓,29,10,19,元大-蘆洲,2024-02-05,9857
2101,南港,20,1,19,元大-蘆洲,2024-02-05,9857
3289,宜特,22,3,19,元大-蘆洲,2024-02-05,9857
2344,華邦電,22,3,19,元大-蘆洲,2024-02-05,9857
00676R,富邦臺灣加權反1,25,9,16,元大-蘆洲,2024-02-05,9857
6547,高端疫苗,24,8,16,元大-蘆洲,2024-02-05,9857
00929,復華台灣科技優息,99,83,16,元大-蘆洲,2024-02-05,9857
6220,岳豐,15,0,15,元大-蘆洲,2024-02-05,9857
2618,長榮航,68,53,15,元大-蘆洲,2024-02-05,9857
4543,萬在,15,0,15,元大-蘆洲,2024-02-05,9857
2363,矽統,17,3,14,元大-蘆洲,2024-02-05,9857
00680L,元大美債20正2,526,1,525,元大-蘆洲,2024-02-15,9857
00751B,元大AAA至A公司債,389,4,385,元大-蘆洲,2024-02-15,9857
00688L,國泰20年美債正2,361,22,339,元大-蘆洲,2024-02-15,9857
00687B,國泰20年美債,327,25,302,元大-蘆洲,2024-02-15,9857
00679B,元大美債20年,224,4,220,元大-蘆洲,2024-02-15,9857
00937B,群益ESG投等債20,281,62,219,元大-蘆洲,2024-02-15,9857
00712,復華富時不動產,219,13,206,元大-蘆洲,2024-02-15,9857
00632R,元大台灣50反1,276,76,200,元大-蘆洲,2024-02-15,9857
00764B,群益25年美債,160,0,160,元大-蘆洲,2024-02-15,9857
00673R,期元大S＆P原油反1,144,0,144,元大-蘆洲,2024-02-15,9857
3481,群創,166,23,143,元大-蘆洲,2024-02-15,9857
00929,復華台灣科技優息,297,177,120,元大-蘆洲,2024-02-15,9857
2329,華泰,263,146,117,元大-蘆洲,2024-02-15,9857
00933B,國泰10Y+金融債,107,0,107,元大-蘆洲,2024-02-15,9857
2344,華邦電,82,19,63,元大-蘆洲,2024-02-15,9857
00907,永豐優息存股,62,0,62,元大-蘆洲,2024-02-15,9857
00878,國泰永續高股息,179,122,57,元大-蘆洲,2024-02-15,9857
00882,中信中國高股息,71,14,57,元大-蘆洲,2024-02-15,9857
00664R,國泰臺灣加權反1,74,23,51,元大-蘆洲,2024-02-15,9857
2359,所羅門,50,3,47,元大-蘆洲,2024-02-15,9857
00720B,元大投資級公司債,42,0,42,元大-蘆洲,2024-02-15,9857
2887,台新金,110,69,41,元大-蘆洲,2024-02-15,9857
00795B,中信美國公債20年,40,0,40,元大-蘆洲,2024-02-15,9857
2610,華航,53,15,38,元大-蘆洲,2024-02-15,9857
6196,帆宣,42,4,38,元大-蘆洲,2024-02-15,9857
3607,谷崧,35,0,35,元大-蘆洲,2024-02-15,9857
00931B,統一美債20年,35,0,35,元大-蘆洲,2024-02-15,9857
6689,伊雲谷,34,0,34,元大-蘆洲,2024-02-15,9857
2409,友達,56,23,33,元大-蘆洲,2024-02-15,9857
2515,中工,34,1,33,元大-蘆洲,2024-02-15,9857
3712,永崴投控,43,10,33,元大-蘆洲,2024-02-15,9857
4938,和碩,41,10,31,元大-蘆洲,2024-02-15,9857
1513,中興電,54,27,27,元大-蘆洲,2024-02-15,9857
3033,威健,36,10,26,元大-蘆洲,2024-02-15,9857
2365,昆盈,135,110,25,元大-蘆洲,2024-02-15,9857
6806,森崴能源,24,0,24,元大-蘆洲,2024-02-15,9857
2888,新光金,30,7,23,元大-蘆洲,2024-02-15,9857
00713,元大台灣高息低波,29,7,22,元大-蘆洲,2024-02-15,9857
00770,國泰北美科技,27,4,23,元大-蘆洲,2024-02-15,9857
6547,高端疫苗,26,4,22,元大-蘆洲,2024-02-15,9857
6757,台灣虎航,21,0,21,元大-蘆洲,2024-02-15,9857
3294,英濟,21,0,21,元大-蘆洲,2024-02-15,9857
9945,潤泰新,22,2,20,元大-蘆洲,2024-02-15,9857
2618,長榮航,113,94,19,元大-蘆洲,2024-02-15,9857
6219,富旺,19,0,19,元大-蘆洲,2024-02-15,9857
6113,亞矽,21,3,18,元大-蘆洲,2024-02-15,9857
5871,中租-KY,21,3,18,元大-蘆洲,2024-02-15,9857
2308,台達電,21,3,18,元大-蘆洲,2024-02-15,9857
3013,晟銘電,26,9,17,元大-蘆洲,2024-02-15,9857
4915,致伸,30,14,16,元大-蘆洲,2024-02-15,9857
00937B,群益ESG投等債20,820,20,800,元大-蘆洲,2024-02-16,9857
2312,金寶,532,2,530,元大-蘆洲,2024-02-16,9857
00679B,元大美債20年,281,0,281,元大-蘆洲,2024-02-16,9857
00687B,國泰20年美債,235,85,150,元大-蘆洲,2024-02-16,9857
6684,安格,136,32,104,元大-蘆洲,2024-02-16,9857
2618,長榮航,121,29,92,元大-蘆洲,2024-02-16,9857
00933B,國泰10Y+金融債,76,0,76,元大-蘆洲,2024-02-16,9857
00931B,統一美債20年,61,0,61,元大-蘆洲,2024-02-16,9857
00680L,元大美債20正2,61,0,61,元大-蘆洲,2024-02-16,9857
00673R,期元大S＆P原油反1,56,0,56,元大-蘆洲,2024-02-16,9857
2382,廣達,89,39,50,元大-蘆洲,2024-02-16,9857
3481,群創,77,32,45,元大-蘆洲,2024-02-16,9857
2884,玉山金,43,0,43,元大-蘆洲,2024-02-16,9857
6233,旺玖,49,6,43,元大-蘆洲,2024-02-16,9857
00725B,國泰投資級公司債,41,0,41,元大-蘆洲,2024-02-16,9857
5452,佶優,40,1,39,元大-蘆洲,2024-02-16,9857
6285,啟��,43,4,39,元大-蘆洲,2024-02-16,9857
2888,新光金,44,10,34,元大-蘆洲,2024-02-16,9857
2303,聯電,47,15,32,元大-蘆洲,2024-02-16,9857
4109,加捷生醫,32,0,32,元大-蘆洲,2024-02-16,9857
00720B,元大投資級公司債,31,0,31,元大-蘆洲,2024-02-16,9857
2426,鼎元,65,34,31,元大-蘆洲,2024-02-16,9857
1584,精剛,30,0,30,元大-蘆洲,2024-02-16,9857
00688L,國泰20年美債正2,30,0,30,元大-蘆洲,2024-02-16,9857
00764B,群益25年美債,29,0,29,元大-蘆洲,2024-02-16,9857
00632R,元大台灣50反1,30,1,29,元大-蘆洲,2024-02-16,9857
2421,建準,43,14,29,元大-蘆洲,2024-02-16,9857
2530,華建,29,0,29,元大-蘆洲,2024-02-16,9857
00712,復華富時不動產,33,4,29,元大-蘆洲,2024-02-16,9857
3036,文曄,34,6,28,元大-蘆洲,2024-02-16,9857
2887,台新金,36,8,28,元大-蘆洲,2024-02-16,9857
9904,寶成,25,0,25,元大-蘆洲,2024-02-16,9857
8097,常珵,25,0,25,元大-蘆洲,2024-02-16,9857
00795B,中信美國公債20年,24,0,24,元大-蘆洲,2024-02-16,9857
00706L,期元大S＆P日圓正2,23,0,23,元大-蘆洲,2024-02-16,9857
5306,桂盟,22,0,22,元大-蘆洲,2024-02-16,9857
5512,力麒,23,2,21,元大-蘆洲,2024-02-16,9857
6901,鑽石投資,21,0,21,元大-蘆洲,2024-02-16,9857
2356,英業達,295,274,21,元大-蘆洲,2024-02-16,9857
00853B,統一美債10年Aa-,20,0,20,元大-蘆洲,2024-02-16,9857
2897,王道銀行,20,0,20,元大-蘆洲,2024-02-16,9857
2543,皇昌,21,2,19,元大-蘆洲,2024-02-16,9857
2425,承啟,47,28,19,元大-蘆洲,2024-02-16,9857
3715,定穎投控,46,28,18,元大-蘆洲,2024-02-16,9857
3032,偉訓,18,0,18,元大-蘆洲,2024-02-16,9857
3322,建舜電,20,2,18,元大-蘆洲,2024-02-16,9857
2641,正德,20,2,18,元大-蘆洲,2024-02-16,9857
1101,台泥,24,7,17,元大-蘆洲,2024-02-16,9857
4746,台耀,17,1,16,元大-蘆洲,2024-02-16,9857
2515,中工,44,29,15,元大-蘆洲,2024-02-16,9857
2352,佳世達,265,2,263,元大-蘆洲,2024-02-19,9857
00878,國泰永續高股息,293,33,260,元大-蘆洲,2024-02-19,9857
6290,良維,202,17,185,元大-蘆洲,2024-02-19,9857
00933B,國泰10Y+金融債,161,0,161,元大-蘆洲,2024-02-19,9857
00937B,群益ESG投等債20,149,2,147,元大-蘆洲,2024-02-19,9857
2888,新光金,130,8,122,元大-蘆洲,2024-02-19,9857
00637L,元大滬深300正2,294,187,107,元大-蘆洲,2024-02-19,9857
4714,永捷,154,49,105,元大-蘆洲,2024-02-19,9857
00687B,國泰20年美債,197,95,102,元大-蘆洲,2024-02-19,9857
2515,中工,100,3,97,元大-蘆洲,2024-02-19,9857
2365,昆盈,168,78,90,元大-蘆洲,2024-02-19,9857
2329,華泰,212,122,90,元大-蘆洲,2024-02-19,9857
00679B,元大美債20年,84,1,83,元大-蘆洲,2024-02-19,9857
00918,大華優利高填息30,73,0,73,元大-蘆洲,2024-02-19,9857
2353,宏��,114,42,72,元大-蘆洲,2024-02-19,9857
8059,凱碩,70,1,69,元大-蘆洲,2024-02-19,9857
00919,群益台灣精選高息,121,65,56,元大-蘆洲,2024-02-19,9857
2887,台新金,59,3,56,元大-蘆洲,2024-02-19,9857
1806,冠軍,224,169,55,元大-蘆洲,2024-02-19,9857
8096,擎亞,115,65,50,元大-蘆洲,2024-02-19,9857
3437,榮創,93,43,50,元大-蘆洲,2024-02-19,9857
6284,佳邦,51,2,49,元大-蘆洲,2024-02-19,9857
00751B,元大AAA至A公司債,49,0,49,元大-蘆洲,2024-02-19,9857
00673R,期元大S＆P原油反1,48,0,48,元大-蘆洲,2024-02-19,9857
2388,威盛,55,12,43,元大-蘆洲,2024-02-19,9857
1447,力鵬,40,0,40,元大-蘆洲,2024-02-19,9857
5608,四維航,43,3,40,元大-蘆洲,2024-02-19,9857
6196,帆宣,41,2,39,元大-蘆洲,2024-02-19,9857
2313,華通,48,15,33,元大-蘆洲,2024-02-19,9857
2356,英業達,101,68,33,元大-蘆洲,2024-02-19,9857
00712,復華富時不動產,36,5,31,元大-蘆洲,2024-02-19,9857
1718,中纖,30,0,30,元大-蘆洲,2024-02-19,9857
6274,台燿,60,31,29,元大-蘆洲,2024-02-19,9857
1101,台泥,35,7,28,元大-蘆洲,2024-02-19,9857
00929,復華台灣科技優息,123,96,27,元大-蘆洲,2024-02-19,9857
8936,國統,49,22,27,元大-蘆洲,2024-02-19,9857
1815,富喬,106,81,25,元大-蘆洲,2024-02-19,9857
2014,中鴻,35,11,24,元大-蘆洲,2024-02-19,9857
2303,聯電,37,13,24,元大-蘆洲,2024-02-19,9857
3622,洋華,24,1,23,元大-蘆洲,2024-02-19,9857
5426,振發,93,71,22,元大-蘆洲,2024-02-19,9857
2465,麗臺,24,3,21,元大-蘆洲,2024-02-19,9857
2905,三商,20,0,20,元大-蘆洲,2024-02-19,9857
00641R,富邦日本反1,20,0,20,元大-蘆洲,2024-02-19,9857
00891,中信關鍵半導體,23,3,20,元大-蘆洲,2024-02-19,9857
00632R,元大台灣50反1,18,0,18,元大-蘆洲,2024-02-19,9857
2609,陽明,19,1,18,元大-蘆洲,2024-02-19,9857
1528,恩德,30,12,18,元大-蘆洲,2024-02-19,9857
6689,伊雲谷,18,0,18,元大-蘆洲,2024-02-19,9857
00931B,統一美債20年,18,0,18,元大-蘆洲,2024-02-19,9857
2332,友訊,158,24,134,元大-蘆洲,2024-02-20,9857
4961,天鈺,137,9,128,元大-蘆洲,2024-02-20,9857
4714,永捷,238,118,120,元大-蘆洲,2024-02-20,9857
3231,緯創,176,76,100,元大-蘆洲,2024-02-20,9857
00679B,元大美債20年,104,5,99,元大-蘆洲,2024-02-20,9857
2356,英業達,133,36,97,元大-蘆洲,2024-02-20,9857
00687B,國泰20年美債,94,0,94,元大-蘆洲,2024-02-20,9857
6126,信音,139,47,92,元大-蘆洲,2024-02-20,9857
3322,建舜電,82,0,82,元大-蘆洲,2024-02-20,9857
00937B,群益ESG投等債20,79,3,76,元大-蘆洲,2024-02-20,9857
00933B,國泰10Y+金融債,91,20,71,元大-蘆洲,2024-02-20,9857
2603,長榮,99,29,70,元大-蘆洲,2024-02-20,9857
00878,國泰永續高股息,87,27,60,元大-蘆洲,2024-02-20,9857
00665L,富邦�琤肭磪囓�2,58,1,57,元大-蘆洲,2024-02-20,9857
00632R,元大台灣50反1,67,11,56,元大-蘆洲,2024-02-20,9857
3041,揚智,290,235,55,元大-蘆洲,2024-02-20,9857
00680L,元大美債20正2,100,47,53,元大-蘆洲,2024-02-20,9857
00650L,復華香港正2,50,0,50,元大-蘆洲,2024-02-20,9857
6133,金橋,50,0,50,元大-蘆洲,2024-02-20,9857
1314,中石化,51,5,46,元大-蘆洲,2024-02-20,9857
00673R,期元大S＆P原油反1,42,0,42,元大-蘆洲,2024-02-20,9857
8096,擎亞,88,47,41,元大-蘆洲,2024-02-20,9857
3289,宜特,40,5,35,元大-蘆洲,2024-02-20,9857
1316,上曜,64,29,35,元大-蘆洲,2024-02-20,9857
2489,瑞軒,45,11,34,元大-蘆洲,2024-02-20,9857
3481,群創,63,30,33,元大-蘆洲,2024-02-20,9857
1785,光洋科,38,6,32,元大-蘆洲,2024-02-20,9857
3058,立德,32,0,32,元大-蘆洲,2024-02-20,9857
2405,輔信,88,59,29,元大-蘆洲,2024-02-20,9857
00764B,群益25年美債,27,0,27,元大-蘆洲,2024-02-20,9857
8064,東捷,37,10,27,元大-蘆洲,2024-02-20,9857
2379,瑞昱,34,7,27,元大-蘆洲,2024-02-20,9857
3312,弘憶股,38,13,25,元大-蘆洲,2024-02-20,9857
1809,中釉,36,11,25,元大-蘆洲,2024-02-20,9857
00712,復華富時不動產,26,2,24,元大-蘆洲,2024-02-20,9857
2002,中鋼,29,6,23,元大-蘆洲,2024-02-20,9857
2486,一詮,24,1,23,元大-蘆洲,2024-02-20,9857
00892,富邦台灣半導體,23,0,23,元大-蘆洲,2024-02-20,9857
00885,富邦越南,26,4,22,元大-蘆洲,2024-02-20,9857
6244,茂迪,22,0,22,元大-蘆洲,2024-02-20,9857
3498,陽程,28,6,22,元大-蘆洲,2024-02-20,9857
2731,雄獅,21,0,21,元大-蘆洲,2024-02-20,9857
6282,康舒,60,39,21,元大-蘆洲,2024-02-20,9857
5388,中磊,21,0,21,元大-蘆洲,2024-02-20,9857
00922,國泰台灣領袖50,21,1,20,元大-蘆洲,2024-02-20,9857
5508,永信建,20,0,20,元大-蘆洲,2024-02-20,9857
2426,鼎元,22,2,20,元大-蘆洲,2024-02-20,9857
3592,瑞鼎,20,1,19,元大-蘆洲,2024-02-20,9857
00931B,統一美債20年,19,0,19,元大-蘆洲,2024-02-20,9857
8473,山林水,20,1,19,元大-蘆洲,2024-02-20,9857
00878,國泰永續高股息,378,27,351,元大-蘆洲,2024-02-21,9857
2329,華泰,557,233,324,元大-蘆洲,2024-02-21,9857
00937B,群益ESG投等債20,203,9,194,元大-蘆洲,2024-02-21,9857
3376,新日興,157,10,147,元大-蘆洲,2024-02-21,9857
00933B,國泰10Y+金融債,149,18,131,元大-蘆洲,2024-02-21,9857
5381,合正,156,42,114,元大-蘆洲,2024-02-21,9857
1316,上曜,142,28,114,元大-蘆洲,2024-02-21,9857
2515,中工,102,4,98,元大-蘆洲,2024-02-21,9857
00712,復華富時不動產,92,7,85,元大-蘆洲,2024-02-21,9857
2303,聯電,89,13,76,元大-蘆洲,2024-02-21,9857
1447,力鵬,83,9,74,元大-蘆洲,2024-02-21,9857
3591,艾笛森,75,1,74,元大-蘆洲,2024-02-21,9857
00679B,元大美債20年,73,11,62,元大-蘆洲,2024-02-21,9857
8096,擎亞,71,18,53,元大-蘆洲,2024-02-21,9857
3481,群創,239,191,48,元大-蘆洲,2024-02-21,9857
2892,第一金,48,0,48,元大-蘆洲,2024-02-21,9857
3363,上詮,66,22,44,元大-蘆洲,2024-02-21,9857
1314,中石化,47,4,43,元大-蘆洲,2024-02-21,9857
6116,彩晶,103,60,43,元大-蘆洲,2024-02-21,9857
3231,緯創,113,72,41,元大-蘆洲,2024-02-21,9857
5355,佳總,40,0,40,元大-蘆洲,2024-02-21,9857
2609,陽明,82,44,38,元大-蘆洲,2024-02-21,9857
6282,康舒,52,15,37,元大-蘆洲,2024-02-21,9857
2867,三商壽,30,0,30,元大-蘆洲,2024-02-21,9857
5443,均豪,91,62,29,元大-蘆洲,2024-02-21,9857
00687B,國泰20年美債,31,3,28,元大-蘆洲,2024-02-21,9857
4906,正文,43,16,27,元大-蘆洲,2024-02-21,9857
5608,四維航,31,4,27,元大-蘆洲,2024-02-21,9857
5490,同亨,26,0,26,元大-蘆洲,2024-02-21,9857
2353,宏��,38,13,25,元大-蘆洲,2024-02-21,9857
5488,松普,38,14,24,元大-蘆洲,2024-02-21,9857
00770,國泰北美科技,27,3,24,元大-蘆洲,2024-02-21,9857
3047,訊舟,111,87,24,元大-蘆洲,2024-02-21,9857
2402,毅嘉,25,2,23,元大-蘆洲,2024-02-21,9857
1471,首利,23,0,23,元大-蘆洲,2024-02-21,9857
2355,敬鵬,24,1,23,元大-蘆洲,2024-02-21,9857
2420,新巨,22,0,22,元大-蘆洲,2024-02-21,9857
3035,智原,58,36,22,元大-蘆洲,2024-02-21,9857
00641R,富邦日本反1,21,0,21,元大-蘆洲,2024-02-21,9857
4945,陞達科技,31,10,21,元大-蘆洲,2024-02-21,9857
00891,中信關鍵半導體,26,5,21,元大-蘆洲,2024-02-21,9857
2882,國泰金,32,11,21,元大-蘆洲,2024-02-21,9857
00720B,元大投資級公司債,20,0,20,元大-蘆洲,2024-02-21,9857
1526,日馳,20,0,20,元大-蘆洲,2024-02-21,9857
1522,堤維西,22,2,20,元大-蘆洲,2024-02-21,9857
3017,奇鋐,23,4,19,元大-蘆洲,2024-02-21,9857
5521,工信,33,15,18,元大-蘆洲,2024-02-21,9857
2897,王道銀行,18,1,17,元大-蘆洲,2024-02-21,9857
5515,建國,19,2,17,元大-蘆洲,2024-02-21,9857
2392,正崴,17,1,16,元大-蘆洲,2024-02-21,9857
9105,泰金寶-DR,265,35,230,元大-蘆洲,2024-02-22,9857
00919,群益台灣精選高息,499,362,137,元大-蘆洲,2024-02-22,9857
8105,凌巨,135,26,109,元大-蘆洲,2024-02-22,9857
00933B,國泰10Y+金融債,122,20,102,元大-蘆洲,2024-02-22,9857
00878,國泰永續高股息,108,17,91,元大-蘆洲,2024-02-22,9857
6189,豐藝,108,17,91,元大-蘆洲,2024-02-22,9857
00764B,群益25年美債,80,0,80,元大-蘆洲,2024-02-22,9857
00687B,國泰20年美債,78,0,78,元大-蘆洲,2024-02-22,9857
3481,群創,102,28,74,元大-蘆洲,2024-02-22,9857
00937B,群益ESG投等債20,125,52,73,元大-蘆洲,2024-02-22,9857
1513,中興電,144,72,72,元大-蘆洲,2024-02-22,9857
00637L,元大滬深300正2,318,247,71,元大-蘆洲,2024-02-22,9857
3231,緯創,177,114,63,元大-蘆洲,2024-02-22,9857
00665L,富邦�琤肭磪囓�2,88,26,62,元大-蘆洲,2024-02-22,9857
00679B,元大美債20年,57,0,57,元大-蘆洲,2024-02-22,9857
3321,同泰,60,6,54,元大-蘆洲,2024-02-22,9857
00795B,中信美國公債20年,52,0,52,元大-蘆洲,2024-02-22,9857
3551,世禾,51,0,51,元大-蘆洲,2024-02-22,9857
2367,燿華,82,38,44,元大-蘆洲,2024-02-22,9857
2543,皇昌,70,27,43,元大-蘆洲,2024-02-22,9857
6126,信音,101,60,41,元大-蘆洲,2024-02-22,9857
6806,森崴能源,83,45,38,元大-蘆洲,2024-02-22,9857
00712,復華富時不動產,39,2,37,元大-蘆洲,2024-02-22,9857
6284,佳邦,36,1,35,元大-蘆洲,2024-02-22,9857
2353,宏��,56,21,35,元大-蘆洲,2024-02-22,9857
00830,國泰費城半導體,37,2,35,元大-蘆洲,2024-02-22,9857
1316,上曜,41,8,33,元大-蘆洲,2024-02-22,9857
6207,雷科,36,3,33,元大-蘆洲,2024-02-22,9857
5498,凱崴,58,25,33,元大-蘆洲,2024-02-22,9857
2371,大同,55,22,33,元大-蘆洲,2024-02-22,9857
2530,華建,30,0,30,元大-蘆洲,2024-02-22,9857
3013,晟銘電,156,129,27,元大-蘆洲,2024-02-22,9857
2460,建通,43,16,27,元大-蘆洲,2024-02-22,9857
6218,豪勉,26,0,26,元大-蘆洲,2024-02-22,9857
8936,國統,38,12,26,元大-蘆洲,2024-02-22,9857
00892,富邦台灣半導體,31,5,26,元大-蘆洲,2024-02-22,9857
1514,亞力,63,38,25,元大-蘆洲,2024-02-22,9857
3265,台星科,45,20,25,元大-蘆洲,2024-02-22,9857
1702,南僑,28,4,24,元大-蘆洲,2024-02-22,9857
2426,鼎元,27,4,23,元大-蘆洲,2024-02-22,9857
2369,菱生,58,36,22,元大-蘆洲,2024-02-22,9857
00931B,統一美債20年,22,0,22,元大-蘆洲,2024-02-22,9857
2745,五福,21,0,21,元大-蘆洲,2024-02-22,9857
00891,中信關鍵半導體,46,25,21,元大-蘆洲,2024-02-22,9857
6425,易發,31,11,20,元大-蘆洲,2024-02-22,9857
3479,安勤,21,1,20,元大-蘆洲,2024-02-22,9857
1721,三晃,24,5,19,元大-蘆洲,2024-02-22,9857
00692,富邦公司治理,20,1,19,元大-蘆洲,2024-02-22,9857
1785,光洋科,19,0,19,元大-蘆洲,2024-02-22,9857
2376,技嘉,50,32,18,元大-蘆洲,2024-02-22,9857
2618,長榮航,256,46,210,元大-蘆洲,2024-02-23,9857
00937B,群益ESG投等債20,173,5,168,元大-蘆洲,2024-02-23,9857
00650L,復華香港正2,162,0,162,元大-蘆洲,2024-02-23,9857
3481,群創,184,53,131,元大-蘆洲,2024-02-23,9857
6189,豐藝,138,26,112,元大-蘆洲,2024-02-23,9857
3363,上詮,103,23,80,元大-蘆洲,2024-02-23,9857
6167,久正,207,129,78,元大-蘆洲,2024-02-23,9857
00919,群益台灣精選高息,171,95,76,元大-蘆洲,2024-02-23,9857
1513,中興電,267,195,72,元大-蘆洲,2024-02-23,9857
6282,康舒,75,7,68,元大-蘆洲,2024-02-23,9857
00712,復華富時不動產,88,20,68,元大-蘆洲,2024-02-23,9857
00933B,國泰10Y+金融債,81,15,66,元大-蘆洲,2024-02-23,9857
00680L,元大美債20正2,65,1,64,元大-蘆洲,2024-02-23,9857
00679B,元大美債20年,68,5,63,元大-蘆洲,2024-02-23,9857
1785,光洋科,63,2,61,元大-蘆洲,2024-02-23,9857
2313,華通,254,194,60,元大-蘆洲,2024-02-23,9857
00687B,國泰20年美債,78,20,58,元大-蘆洲,2024-02-23,9857
3390,旭軟,67,10,57,元大-蘆洲,2024-02-23,9857
2486,一詮,52,4,48,元大-蘆洲,2024-02-23,9857
020023,元大櫃買半導體N,48,0,48,元大-蘆洲,2024-02-23,9857
2609,陽明,137,90,47,元大-蘆洲,2024-02-23,9857
8112,至上,51,9,42,元大-蘆洲,2024-02-23,9857
5452,佶優,51,14,37,元大-蘆洲,2024-02-23,9857
3005,神基,50,13,37,元大-蘆洲,2024-02-23,9857
3576,聯合再生,56,20,36,元大-蘆洲,2024-02-23,9857
8440,綠電,35,0,35,元大-蘆洲,2024-02-23,9857
2101,南港,38,3,35,元大-蘆洲,2024-02-23,9857
6218,豪勉,34,2,32,元大-蘆洲,2024-02-23,9857
9945,潤泰新,31,0,31,元大-蘆洲,2024-02-23,9857
1514,亞力,114,84,30,元大-蘆洲,2024-02-23,9857
3231,緯創,143,114,29,元大-蘆洲,2024-02-23,9857
1711,永光,30,1,29,元大-蘆洲,2024-02-23,9857
2014,中鴻,28,0,28,元大-蘆洲,2024-02-23,9857
8064,東捷,80,54,26,元大-蘆洲,2024-02-23,9857
4303,信立,32,6,26,元大-蘆洲,2024-02-23,9857
6284,佳邦,26,0,26,元大-蘆洲,2024-02-23,9857
2884,玉山金,26,0,26,元大-蘆洲,2024-02-23,9857
2374,佳能,25,0,25,元大-蘆洲,2024-02-23,9857
3715,定穎投控,65,40,25,元大-蘆洲,2024-02-23,9857
2356,英業達,152,128,24,元大-蘆洲,2024-02-23,9857
2002,中鋼,33,9,24,元大-蘆洲,2024-02-23,9857
3548,兆利,28,5,23,元大-蘆洲,2024-02-23,9857
3025,星通,52,29,23,元大-蘆洲,2024-02-23,9857
3645,達邁,22,0,22,元大-蘆洲,2024-02-23,9857
2363,矽統,26,5,21,元大-蘆洲,2024-02-23,9857
2610,華航,38,17,21,元大-蘆洲,2024-02-23,9857
2324,仁寶,37,18,19,元大-蘆洲,2024-02-23,9857
2882,國泰金,19,1,18,元大-蘆洲,2024-02-23,9857
00918,大華優利高填息30,34,15,19,元大-蘆洲,2024-02-23,9857
2408,南亞科,20,2,18,元大-蘆洲,2024-02-23,9857
00637L,元大滬深300正2,510,102,408,元大-蘆洲,2024-02-26,9857
00878,國泰永續高股息,403,56,347,元大-蘆洲,2024-02-26,9857
00885,富邦越南,119,0,119,元大-蘆洲,2024-02-26,9857
00937B,群益ESG投等債20,147,33,114,元大-蘆洲,2024-02-26,9857
4915,致伸,100,2,98,元大-蘆洲,2024-02-26,9857
2892,第一金,68,0,68,元大-蘆洲,2024-02-26,9857
1536,和大,71,7,64,元大-蘆洲,2024-02-26,9857
4720,德淵,56,0,56,元大-蘆洲,2024-02-26,9857
2409,友達,49,3,46,元大-蘆洲,2024-02-26,9857
2601,益航,45,0,45,元大-蘆洲,2024-02-26,9857
00891,中信關鍵半導體,43,2,41,元大-蘆洲,2024-02-26,9857
3231,緯創,93,52,41,元大-蘆洲,2024-02-26,9857
3564,其陽,40,1,39,元大-蘆洲,2024-02-26,9857
00933B,國泰10Y+金融債,71,33,38,元大-蘆洲,2024-02-26,9857
2884,玉山金,36,0,36,元大-蘆洲,2024-02-26,9857
2303,聯電,43,7,36,元大-蘆洲,2024-02-26,9857
2609,陽明,68,34,34,元大-蘆洲,2024-02-26,9857
6167,久正,41,10,31,元大-蘆洲,2024-02-26,9857
6274,台燿,51,20,31,元大-蘆洲,2024-02-26,9857
5483,中美晶,30,0,30,元大-蘆洲,2024-02-26,9857
00795B,中信美國公債20年,41,11,30,元大-蘆洲,2024-02-26,9857
2495,普安,190,160,30,元大-蘆洲,2024-02-26,9857
6226,光鼎,45,15,30,元大-蘆洲,2024-02-26,9857
4113,聯上,30,0,30,元大-蘆洲,2024-02-26,9857
3321,同泰,29,0,29,元大-蘆洲,2024-02-26,9857
2329,華泰,102,73,29,元大-蘆洲,2024-02-26,9857
9103,美德醫療-DR,33,5,28,元大-蘆洲,2024-02-26,9857
5263,智崴,28,0,28,元大-蘆洲,2024-02-26,9857
1504,東元,89,62,27,元大-蘆洲,2024-02-26,9857
2388,威盛,37,11,26,元大-蘆洲,2024-02-26,9857
2344,華邦電,29,3,26,元大-蘆洲,2024-02-26,9857
2886,兆豐金,28,3,25,元大-蘆洲,2024-02-26,9857
2369,菱生,57,34,23,元大-蘆洲,2024-02-26,9857
1503,士電,95,72,23,元大-蘆洲,2024-02-26,9857
3055,蔚華科,52,31,21,元大-蘆洲,2024-02-26,9857
00632R,元大台灣50反1,34,13,21,元大-蘆洲,2024-02-26,9857
5426,振發,34,13,21,元大-蘆洲,2024-02-26,9857
6530,創威,32,12,20,元大-蘆洲,2024-02-26,9857
2401,凌陽,24,4,20,元大-蘆洲,2024-02-26,9857
3037,欣興,90,72,18,元大-蘆洲,2024-02-26,9857
3033,威健,27,8,19,元大-蘆洲,2024-02-26,9857
00715L,期街口布蘭特正2,18,0,18,元大-蘆洲,2024-02-26,9857
6218,豪勉,30,12,18,元大-蘆洲,2024-02-26,9857
00720B,元大投資級公司債,17,1,16,元大-蘆洲,2024-02-26,9857
1710,東聯,17,1,16,元大-蘆洲,2024-02-26,9857
1717,長興,36,20,16,元大-蘆洲,2024-02-26,9857
2002,中鋼,19,3,16,元大-蘆洲,2024-02-26,9857
00931B,統一美債20年,25,10,15,元大-蘆洲,2024-02-26,9857
8033,雷虎,18,3,15,元大-蘆洲,2024-02-26,9857
4542,科嶠,15,0,15,元大-蘆洲,2024-02-26,9857
00878,國泰永續高股息,712,72,640,元大-蘆洲,2024-02-27,9857
00937B,群益ESG投等債20,249,10,239,元大-蘆洲,2024-02-27,9857
00795B,中信美國公債20年,175,0,175,元大-蘆洲,2024-02-27,9857
00929,復華台灣科技優息,412,242,170,元大-蘆洲,2024-02-27,9857
3607,谷崧,143,4,139,元大-蘆洲,2024-02-27,9857
00919,群益台灣精選高息,408,278,130,元大-蘆洲,2024-02-27,9857
00687B,國泰20年美債,133,5,128,元大-蘆洲,2024-02-27,9857
00632R,元大台灣50反1,132,20,112,元大-蘆洲,2024-02-27,9857
00885,富邦越南,100,0,100,元大-蘆洲,2024-02-27,9857
8096,擎亞,117,19,98,元大-蘆洲,2024-02-27,9857
1711,永光,118,33,85,元大-蘆洲,2024-02-27,9857
3037,欣興,192,111,81,元大-蘆洲,2024-02-27,9857
00679B,元大美債20年,98,18,80,元大-蘆洲,2024-02-27,9857
1609,大亞,104,28,76,元大-蘆洲,2024-02-27,9857
2618,長榮航,70,7,63,元大-蘆洲,2024-02-27,9857
3231,緯創,185,122,63,元大-蘆洲,2024-02-27,9857
2002,中鋼,69,9,60,元大-蘆洲,2024-02-27,9857
2313,華通,102,43,59,元大-蘆洲,2024-02-27,9857
6113,亞矽,58,5,53,元大-蘆洲,2024-02-27,9857
9105,泰金寶-DR,57,10,47,元大-蘆洲,2024-02-27,9857
00637L,元大滬深300正2,166,120,46,元大-蘆洲,2024-02-27,9857
3265,台星科,47,2,45,元大-蘆洲,2024-02-27,9857
5263,智崴,45,0,45,元大-蘆洲,2024-02-27,9857
2601,益航,55,10,45,元大-蘆洲,2024-02-27,9857
6226,光鼎,44,2,42,元大-蘆洲,2024-02-27,9857
5498,凱崴,48,7,41,元大-蘆洲,2024-02-27,9857
2495,普安,50,10,40,元大-蘆洲,2024-02-27,9857
00664R,國泰臺灣加權反1,40,0,40,元大-蘆洲,2024-02-27,9857
6494,九齊,40,0,40,元大-蘆洲,2024-02-27,9857
6285,啟��,70,33,37,元大-蘆洲,2024-02-27,9857
1528,恩德,35,0,35,元大-蘆洲,2024-02-27,9857
1802,台玻,33,0,33,元大-蘆洲,2024-02-27,9857
00896,中信綠能及電動車,32,0,32,元大-蘆洲,2024-02-27,9857
00912,中信臺灣智慧50,31,0,31,元大-蘆洲,2024-02-27,9857
00720B,元大投資級公司債,30,0,30,元大-蘆洲,2024-02-27,9857
4711,永純,30,0,30,元大-蘆洲,2024-02-27,9857
5328,華容,30,0,30,元大-蘆洲,2024-02-27,9857
8064,東捷,66,37,29,元大-蘆洲,2024-02-27,9857
4979,華星光,66,38,28,元大-蘆洲,2024-02-27,9857
2607,榮運,27,0,27,元大-蘆洲,2024-02-27,9857
00904,新光臺灣半導體30,31,4,27,元大-蘆洲,2024-02-27,9857
4306,炎洲,30,6,24,元大-蘆洲,2024-02-27,9857
9945,潤泰新,24,0,24,元大-蘆洲,2024-02-27,9857
2388,威盛,37,15,22,元大-蘆洲,2024-02-27,9857
5347,世界,23,1,22,元大-蘆洲,2024-02-27,9857
3707,漢磊,22,2,20,元大-蘆洲,2024-02-27,9857
00893,國泰智能電動車,37,17,20,元大-蘆洲,2024-02-27,9857
1101,台泥,22,3,19,元大-蘆洲,2024-02-27,9857
00891,中信關鍵半導體,70,51,19,元大-蘆洲,2024-02-27,9857
2329,華泰,92,73,19,元大-蘆洲,2024-02-27,9857
00937B,群益ESG投等債20,317,11,306,元大-蘆洲,2024-02-29,9857
00919,群益台灣精選高息,243,93,150,元大-蘆洲,2024-02-29,9857
2498,宏達電,163,47,116,元大-蘆洲,2024-02-29,9857
3481,群創,144,31,113,元大-蘆洲,2024-02-29,9857
00650L,復華香港正2,105,0,105,元大-蘆洲,2024-02-29,9857
2455,全新,106,5,101,元大-蘆洲,2024-02-29,9857
00632R,元大台灣50反1,82,0,82,元大-蘆洲,2024-02-29,9857
5452,佶優,87,29,58,元大-蘆洲,2024-02-29,9857
00795B,中信美國公債20年,56,0,56,元大-蘆洲,2024-02-29,9857
6126,信音,83,28,55,元大-蘆洲,2024-02-29,9857
9945,潤泰新,57,2,55,元大-蘆洲,2024-02-29,9857
00673R,期元大S＆P原油反1,54,0,54,元大-蘆洲,2024-02-29,9857
2601,益航,54,2,52,元大-蘆洲,2024-02-29,9857
00933B,國泰10Y+金融債,72,21,51,元大-蘆洲,2024-02-29,9857
00679B,元大美債20年,52,8,44,元大-蘆洲,2024-02-29,9857
2329,華泰,124,80,44,元大-蘆洲,2024-02-29,9857
00929,復華台灣科技優息,212,170,42,元大-蘆洲,2024-02-29,9857
00882,中信中國高股息,60,18,42,元大-蘆洲,2024-02-29,9857
1609,大亞,131,90,41,元大-蘆洲,2024-02-29,9857
00680L,元大美債20正2,43,3,40,元大-蘆洲,2024-02-29,9857
2206,三陽工業,38,0,38,元大-蘆洲,2024-02-29,9857
4513,福裕,38,0,38,元大-蘆洲,2024-02-29,9857
9105,泰金寶-DR,37,0,37,元大-蘆洲,2024-02-29,9857
3231,緯創,90,54,36,元大-蘆洲,2024-02-29,9857
3037,欣興,80,46,34,元大-蘆洲,2024-02-29,9857
1513,中興電,220,187,33,元大-蘆洲,2024-02-29,9857
2313,華通,70,38,32,元大-蘆洲,2024-02-29,9857
3372,典範,31,0,31,元大-蘆洲,2024-02-29,9857
00688L,國泰20年美債正2,30,0,30,元大-蘆洲,2024-02-29,9857
2324,仁寶,34,5,29,元大-蘆洲,2024-02-29,9857
1522,堤維西,120,91,29,元大-蘆洲,2024-02-29,9857
0056,元大高股息,41,14,27,元大-蘆洲,2024-02-29,9857
1717,長興,28,1,27,元大-蘆洲,2024-02-29,9857
1514,亞力,176,149,27,元大-蘆洲,2024-02-29,9857
2440,太空梭,26,0,26,元大-蘆洲,2024-02-29,9857
2002,中鋼,29,7,22,元大-蘆洲,2024-02-29,9857
2353,宏��,28,6,22,元大-蘆洲,2024-02-29,9857
6443,元晶,34,12,22,元大-蘆洲,2024-02-29,9857
2363,矽統,42,20,22,元大-蘆洲,2024-02-29,9857
2331,精英,22,2,20,元大-蘆洲,2024-02-29,9857
3047,訊舟,30,11,19,元大-蘆洲,2024-02-29,9857
6770,力積電,25,6,19,元大-蘆洲,2024-02-29,9857
2892,第一金,17,0,17,元大-蘆洲,2024-02-29,9857
2317,鴻海,18,1,17,元大-蘆洲,2024-02-29,9857
6116,彩晶,38,21,17,元大-蘆洲,2024-02-29,9857
5512,力麒,20,4,16,元大-蘆洲,2024-02-29,9857
4543,萬在,50,34,16,元大-蘆洲,2024-02-29,9857
5202,力新,15,0,15,元大-蘆洲,2024-02-29,9857
1506,正道,15,0,15,元大-蘆洲,2024-02-29,9857
6179,亞通,22,7,15,元大-蘆洲,2024-02-29,9857
00919,群益台灣精選高息,610,51,559,元大-蘆洲,2024-03-01,9857
00937B,群益ESG投等債20,223,15,208,元大-蘆洲,2024-03-01,9857
00918,大華優利高填息30,198,5,193,元大-蘆洲,2024-03-01,9857
2332,友訊,114,0,114,元大-蘆洲,2024-03-01,9857
2455,全新,105,5,100,元大-蘆洲,2024-03-01,9857
00929,復華台灣科技優息,205,106,99,元大-蘆洲,2024-03-01,9857
2609,陽明,103,6,97,元大-蘆洲,2024-03-01,9857
5452,佶優,98,5,93,元大-蘆洲,2024-03-01,9857
2401,凌陽,97,4,93,元大-蘆洲,2024-03-01,9857
2618,長榮航,104,16,88,元大-蘆洲,2024-03-01,9857
2329,華泰,136,53,83,元大-蘆洲,2024-03-01,9857
00687B,國泰20年美債,82,11,71,元大-蘆洲,2024-03-01,9857
9105,泰金寶-DR,70,1,69,元大-蘆洲,2024-03-01,9857
2313,華通,84,15,69,元大-蘆洲,2024-03-01,9857
6126,信音,71,17,54,元大-蘆洲,2024-03-01,9857
3322,建舜電,61,9,52,元大-蘆洲,2024-03-01,9857
00933B,國泰10Y+金融債,73,21,52,元大-蘆洲,2024-03-01,9857
00650L,復華香港正2,50,0,50,元大-蘆洲,2024-03-01,9857
4303,信立,54,8,46,元大-蘆洲,2024-03-01,9857
2303,聯電,88,45,43,元大-蘆洲,2024-03-01,9857
3037,欣興,45,5,40,元大-蘆洲,2024-03-01,9857
6266,泰詠,40,0,40,元大-蘆洲,2024-03-01,9857
1815,富喬,83,46,37,元大-蘆洲,2024-03-01,9857
6462,神盾,57,20,37,元大-蘆洲,2024-03-01,9857
1609,大亞,91,55,36,元大-蘆洲,2024-03-01,9857
6275,元山,49,14,35,元大-蘆洲,2024-03-01,9857
8105,凌巨,39,5,34,元大-蘆洲,2024-03-01,9857
6271,同欣電,45,11,34,元大-蘆洲,2024-03-01,9857
3042,晶技,34,1,33,元大-蘆洲,2024-03-01,9857
00830,國泰費城半導體,32,2,30,元大-蘆洲,2024-03-01,9857
2888,新光金,40,12,28,元大-蘆洲,2024-03-01,9857
4513,福裕,27,0,27,元大-蘆洲,2024-03-01,9857
1316,上曜,165,138,27,元大-蘆洲,2024-03-01,9857
00936,台新永續高息中小,32,6,26,元大-蘆洲,2024-03-01,9857
00720B,元大投資級公司債,28,3,25,元大-蘆洲,2024-03-01,9857
1503,士電,92,67,25,元大-蘆洲,2024-03-01,9857
8478,東哥遊艇,26,1,25,元大-蘆洲,2024-03-01,9857
3380,明泰,23,0,23,元大-蘆洲,2024-03-01,9857
2369,菱生,71,50,21,元大-蘆洲,2024-03-01,9857
2906,高林,20,0,20,元大-蘆洲,2024-03-01,9857
3047,訊舟,20,0,20,元大-蘆洲,2024-03-01,9857
4747,強生,20,0,20,元大-蘆洲,2024-03-01,9857
3035,智原,42,23,19,元大-蘆洲,2024-03-01,9857
5483,中美晶,23,4,19,元大-蘆洲,2024-03-01,9857
4909,新復興,91,73,18,元大-蘆洲,2024-03-01,9857
2002,中鋼,45,28,17,元大-蘆洲,2024-03-01,9857
3714,富采,17,0,17,元大-蘆洲,2024-03-01,9857
2312,金寶,23,6,17,元大-蘆洲,2024-03-01,9857
1727,中華化,20,3,17,元大-蘆洲,2024-03-01,9857
3191,雲嘉南,17,0,17,元大-蘆洲,2024-03-01,9857
00937B,群益ESG投等債20,404,3,401,元大-蘆洲,2024-03-04,9857
6116,彩晶,308,14,294,元大-蘆洲,2024-03-04,9857
00919,群益台灣精選高息,256,61,195,元大-蘆洲,2024-03-04,9857
6125,廣運,215,54,161,元大-蘆洲,2024-03-04,9857
00918,大華優利高填息30,150,14,136,元大-蘆洲,2024-03-04,9857
00632R,元大台灣50反1,202,91,111,元大-蘆洲,2024-03-04,9857
4714,永捷,110,10,100,元大-蘆洲,2024-03-04,9857
00751B,元大AAA至A公司債,120,22,98,元大-蘆洲,2024-03-04,9857
3376,新日興,117,23,94,元大-蘆洲,2024-03-04,9857
3360,尚立,88,3,85,元大-蘆洲,2024-03-04,9857
6188,廣明,83,2,81,元大-蘆洲,2024-03-04,9857
3231,緯創,168,99,69,元大-蘆洲,2024-03-04,9857
9105,泰金寶-DR,89,21,68,元大-蘆洲,2024-03-04,9857
4513,福裕,67,0,67,元大-蘆洲,2024-03-04,9857
2603,長榮,101,38,63,元大-蘆洲,2024-03-04,9857
1514,亞力,205,147,58,元大-蘆洲,2024-03-04,9857
00673R,期元大S＆P原油反1,56,0,56,元大-蘆洲,2024-03-04,9857
2489,瑞軒,58,13,45,元大-蘆洲,2024-03-04,9857
6244,茂迪,45,0,45,元大-蘆洲,2024-03-04,9857
2353,宏��,90,48,42,元大-蘆洲,2024-03-04,9857
00857B,永豐20年美公債,43,1,42,元大-蘆洲,2024-03-04,9857
3209,全科,42,1,41,元大-蘆洲,2024-03-04,9857
6218,豪勉,62,26,36,元大-蘆洲,2024-03-04,9857
00929,復華台灣科技優息,284,248,36,元大-蘆洲,2024-03-04,9857
00930,永豐ESG低碳高息,47,12,35,元大-蘆洲,2024-03-04,9857
3005,神基,48,16,32,元大-蘆洲,2024-03-04,9857
00637L,元大滬深300正2,96,65,31,元大-蘆洲,2024-03-04,9857
6147,頎邦,40,10,30,元大-蘆洲,2024-03-04,9857
3321,同泰,29,0,29,元大-蘆洲,2024-03-04,9857
9945,潤泰新,48,21,27,元大-蘆洲,2024-03-04,9857
3006,晶豪科,126,99,27,元大-蘆洲,2024-03-04,9857
2884,玉山金,28,3,25,元大-蘆洲,2024-03-04,9857
2014,中鴻,23,0,23,元大-蘆洲,2024-03-04,9857
1316,上曜,64,43,21,元大-蘆洲,2024-03-04,9857
2002,中鋼,44,23,21,元大-蘆洲,2024-03-04,9857
8068,全達,20,0,20,元大-蘆洲,2024-03-04,9857
1101,台泥,25,6,19,元大-蘆洲,2024-03-04,9857
2892,第一金,20,1,19,元大-蘆洲,2024-03-04,9857
2515,中工,22,3,19,元大-蘆洲,2024-03-04,9857
6127,九豪,97,78,19,元大-蘆洲,2024-03-04,9857
2409,友達,39,20,19,元大-蘆洲,2024-03-04,9857
3605,宏致,19,1,18,元大-蘆洲,2024-03-04,9857
6770,力積電,30,11,19,元大-蘆洲,2024-03-04,9857
1314,中石化,21,3,18,元大-蘆洲,2024-03-04,9857
3535,晶彩科,19,1,18,元大-蘆洲,2024-03-04,9857
4968,立積,28,11,17,元大-蘆洲,2024-03-04,9857
2867,三商壽,17,0,17,元大-蘆洲,2024-03-04,9857
6231,系微,18,2,16,元大-蘆洲,2024-03-04,9857
8936,國統,22,7,15,元大-蘆洲,2024-03-04,9857
00915,凱基優選高股息30,16,1,15,元大-蘆洲,2024-03-04,9857
00919,群益台灣精選高息,333,90,243,元大-蘆洲,2024-03-05,9857
00937B,群益ESG投等債20,169,7,162,元大-蘆洲,2024-03-05,9857
00632R,元大台灣50反1,149,13,136,元大-蘆洲,2024-03-05,9857
00650L,復華香港正2,105,0,105,元大-蘆洲,2024-03-05,9857
3376,新日興,154,53,101,元大-蘆洲,2024-03-05,9857
00712,復華富時不動產,121,27,94,元大-蘆洲,2024-03-05,9857
00882,中信中國高股息,109,17,92,元大-蘆洲,2024-03-05,9857
1316,上曜,128,46,82,元大-蘆洲,2024-03-05,9857
2303,聯電,82,13,69,元大-蘆洲,2024-03-05,9857
00687B,國泰20年美債,66,1,65,元大-蘆洲,2024-03-05,9857
00679B,元大美債20年,66,2,64,元大-蘆洲,2024-03-05,9857
1785,光洋科,63,3,60,元大-蘆洲,2024-03-05,9857
00918,大華優利高填息30,69,10,59,元大-蘆洲,2024-03-05,9857
5452,佶優,67,8,59,元大-蘆洲,2024-03-05,9857
2312,金寶,60,1,59,元大-蘆洲,2024-03-05,9857
4906,正文,155,96,59,元大-蘆洲,2024-03-05,9857
9103,美德醫療-DR,56,0,56,元大-蘆洲,2024-03-05,9857
00915,凱基優選高股息30,57,1,56,元大-蘆洲,2024-03-05,9857
3163,波若威,77,24,53,元大-蘆洲,2024-03-05,9857
2324,仁寶,70,18,52,元大-蘆洲,2024-03-05,9857
3481,群創,80,29,51,元大-蘆洲,2024-03-05,9857
2883,凱基金,61,15,46,元大-蘆洲,2024-03-05,9857
2329,華泰,77,32,45,元大-蘆洲,2024-03-05,9857
00891,中信關鍵半導體,47,3,44,元大-蘆洲,2024-03-05,9857
1513,中興電,167,124,43,元大-蘆洲,2024-03-05,9857
5488,松普,91,49,42,元大-蘆洲,2024-03-05,9857
00933B,國泰10Y+金融債,40,0,40,元大-蘆洲,2024-03-05,9857
2603,長榮,81,44,37,元大-蘆洲,2024-03-05,9857
2344,華邦電,41,5,36,元大-蘆洲,2024-03-05,9857
6806,森崴能源,94,59,35,元大-蘆洲,2024-03-05,9857
5521,工信,41,8,33,元大-蘆洲,2024-03-05,9857
2486,一詮,37,5,32,元大-蘆洲,2024-03-05,9857
1522,堤維西,34,4,30,元大-蘆洲,2024-03-05,9857
00664R,國泰臺灣加權反1,30,0,30,元大-蘆洲,2024-03-05,9857
2605,新興,36,6,30,元大-蘆洲,2024-03-05,9857
00892,富邦台灣半導體,30,0,30,元大-蘆洲,2024-03-05,9857
2867,三商壽,29,0,29,元大-蘆洲,2024-03-05,9857
6188,廣明,63,34,29,元大-蘆洲,2024-03-05,9857
00764B,群益25年美債,30,1,29,元大-蘆洲,2024-03-05,9857
00900,富邦特選高股息30,46,17,29,元大-蘆洲,2024-03-05,9857
00715L,期街口布蘭特正2,26,0,26,元大-蘆洲,2024-03-05,9857
8086,宏捷科,45,19,26,元大-蘆洲,2024-03-05,9857
2363,矽統,27,2,25,元大-蘆洲,2024-03-05,9857
6125,廣運,62,37,25,元大-蘆洲,2024-03-05,9857
00923,群益台ESG低碳50,30,6,24,元大-蘆洲,2024-03-05,9857
00929,復華台灣科技優息,148,125,23,元大-蘆洲,2024-03-05,9857
2014,中鴻,24,2,22,元大-蘆洲,2024-03-05,9857
2208,台船,23,1,22,元大-蘆洲,2024-03-05,9857
6126,信音,29,7,22,元大-蘆洲,2024-03-05,9857
2313,華通,52,31,21,元大-蘆洲,2024-03-05,9857
3481,群創,461,19,442,元大-蘆洲,2024-03-06,9857
00632R,元大台灣50反1,405,25,380,元大-蘆洲,2024-03-06,9857
2618,長榮航,317,6,311,元大-蘆洲,2024-03-06,9857
6116,彩晶,281,15,266,元大-蘆洲,2024-03-06,9857
00937B,群益ESG投等債20,209,25,184,元大-蘆洲,2024-03-06,9857
00918,大華優利高填息30,163,33,130,元大-蘆洲,2024-03-06,9857
5521,工信,135,28,107,元大-蘆洲,2024-03-06,9857
5488,松普,152,46,106,元大-蘆洲,2024-03-06,9857
00919,群益台灣精選高息,271,173,98,元大-蘆洲,2024-03-06,9857
5426,振發,110,35,75,元大-蘆洲,2024-03-06,9857
6282,康舒,77,8,69,元大-蘆洲,2024-03-06,9857
3372,典範,78,10,68,元大-蘆洲,2024-03-06,9857
2352,佳世達,69,10,59,元大-蘆洲,2024-03-06,9857
1513,中興電,167,114,53,元大-蘆洲,2024-03-06,9857
2014,中鴻,54,2,52,元大-蘆洲,2024-03-06,9857
6190,萬泰科,60,8,52,元大-蘆洲,2024-03-06,9857
6163,華電網,77,31,46,元大-蘆洲,2024-03-06,9857
2002,中鋼,62,17,45,元大-蘆洲,2024-03-06,9857
00665L,富邦�琤肭磪囓�2,93,53,40,元大-蘆洲,2024-03-06,9857
00830,國泰費城半導體,40,1,39,元大-蘆洲,2024-03-06,9857
1539,巨庭,39,0,39,元大-蘆洲,2024-03-06,9857
6179,亞通,42,7,35,元大-蘆洲,2024-03-06,9857
3689,湧德,58,25,33,元大-蘆洲,2024-03-06,9857
3231,緯創,91,59,32,元大-蘆洲,2024-03-06,9857
6770,力積電,33,2,31,元大-蘆洲,2024-03-06,9857
2344,華邦電,43,13,30,元大-蘆洲,2024-03-06,9857
00712,復華富時不動產,49,20,29,元大-蘆洲,2024-03-06,9857
5515,建國,47,18,29,元大-蘆洲,2024-03-06,9857
2812,台中銀,53,25,28,元大-蘆洲,2024-03-06,9857
00857B,永豐20年美公債,27,0,27,元大-蘆洲,2024-03-06,9857
6109,亞元,26,0,26,元大-蘆洲,2024-03-06,9857
4543,萬在,35,10,25,元大-蘆洲,2024-03-06,9857
1409,新纖,52,27,25,元大-蘆洲,2024-03-06,9857
2405,輔信,36,13,23,元大-蘆洲,2024-03-06,9857
2801,彰銀,25,2,23,元大-蘆洲,2024-03-06,9857
9945,潤泰新,23,0,23,元大-蘆洲,2024-03-06,9857
2324,仁寶,40,18,22,元大-蘆洲,2024-03-06,9857
6168,宏齊,22,0,22,元大-蘆洲,2024-03-06,9857
9907,統一實,26,4,22,元大-蘆洲,2024-03-06,9857
2888,新光金,34,12,22,元大-蘆洲,2024-03-06,9857
1806,冠軍,21,0,21,元大-蘆洲,2024-03-06,9857
2022,聚亨,20,0,20,元大-蘆洲,2024-03-06,9857
2908,特力,20,0,20,元大-蘆洲,2024-03-06,9857
6443,元晶,20,1,19,元大-蘆洲,2024-03-06,9857
5465,富驊,25,6,19,元大-蘆洲,2024-03-06,9857
1440,南紡,20,1,19,元大-蘆洲,2024-03-06,9857
2615,萬海,32,14,18,元大-蘆洲,2024-03-06,9857
8011,台通,78,60,18,元大-蘆洲,2024-03-06,9857
5388,中磊,30,12,18,元大-蘆洲,2024-03-06,9857
00720B,元大投資級公司債,18,1,17,元大-蘆洲,2024-03-06,9857
5521,工信,389,70,319,元大-蘆洲,2024-03-07,9857
3481,群創,270,39,231,元大-蘆洲,2024-03-07,9857
00632R,元大台灣50反1,218,0,218,元大-蘆洲,2024-03-07,9857
00918,大華優利高填息30,180,30,150,元大-蘆洲,2024-03-07,9857
00919,群益台灣精選高息,355,212,143,元大-蘆洲,2024-03-07,9857
00915,凱基優選高股息30,131,7,124,元大-蘆洲,2024-03-07,9857
2486,一詮,164,48,116,元大-蘆洲,2024-03-07,9857
00637L,元大滬深300正2,213,122,91,元大-蘆洲,2024-03-07,9857
2367,燿華,209,126,83,元大-蘆洲,2024-03-07,9857
4306,炎洲,89,20,69,元大-蘆洲,2024-03-07,9857
00687B,國泰20年美債,105,46,59,元大-蘆洲,2024-03-07,9857
1513,中興電,185,129,56,元大-蘆洲,2024-03-07,9857
3231,緯創,106,50,56,元大-蘆洲,2024-03-07,9857
6116,彩晶,61,13,48,元大-蘆洲,2024-03-07,9857
5009,榮剛,49,1,48,元大-蘆洲,2024-03-07,9857
3163,波若威,73,25,48,元大-蘆洲,2024-03-07,9857
1785,光洋科,148,103,45,元大-蘆洲,2024-03-07,9857
00720B,元大投資級公司債,53,9,44,元大-蘆洲,2024-03-07,9857
2610,華航,43,0,43,元大-蘆洲,2024-03-07,9857
00930,永豐ESG低碳高息,43,0,43,元大-蘆洲,2024-03-07,9857
5234,達興材料,55,14,41,元大-蘆洲,2024-03-07,9857
3689,湧德,65,25,40,元大-蘆洲,2024-03-07,9857
6275,元山,114,75,39,元大-蘆洲,2024-03-07,9857
2313,華通,72,35,37,元大-蘆洲,2024-03-07,9857
6591,動力-KY,43,6,37,元大-蘆洲,2024-03-07,9857
2409,友達,44,9,35,元大-蘆洲,2024-03-07,9857
2014,中鴻,37,2,35,元大-蘆洲,2024-03-07,9857
00712,復華富時不動產,37,4,33,元大-蘆洲,2024-03-07,9857
8163,達方,33,1,32,元大-蘆洲,2024-03-07,9857
4107,邦特,28,0,28,元大-蘆洲,2024-03-07,9857
2329,華泰,71,43,28,元大-蘆洲,2024-03-07,9857
2887,台新金,90,62,28,元大-蘆洲,2024-03-07,9857
2002,中鋼,32,5,27,元大-蘆洲,2024-03-07,9857
6462,神盾,63,36,27,元大-蘆洲,2024-03-07,9857
1314,中石化,29,3,26,元大-蘆洲,2024-03-07,9857
3325,旭品,61,35,26,元大-蘆洲,2024-03-07,9857
6282,康舒,75,50,25,元大-蘆洲,2024-03-07,9857
00753L,中信中國50正2,25,0,25,元大-蘆洲,2024-03-07,9857
2387,精元,31,6,25,元大-蘆洲,2024-03-07,9857
2457,飛宏,24,0,24,元大-蘆洲,2024-03-07,9857
6126,信音,32,8,24,元大-蘆洲,2024-03-07,9857
2601,益航,23,0,23,元大-蘆洲,2024-03-07,9857
5483,中美晶,29,7,22,元大-蘆洲,2024-03-07,9857
2324,仁寶,45,23,22,元大-蘆洲,2024-03-07,9857
6245,立端,22,1,21,元大-蘆洲,2024-03-07,9857
9945,潤泰新,40,20,20,元大-蘆洲,2024-03-07,9857
00937B,群益ESG投等債20,125,105,20,元大-蘆洲,2024-03-07,9857
3362,先進光,20,0,20,元大-蘆洲,2024-03-07,9857
5425,台半,23,3,20,元大-蘆洲,2024-03-07,9857
2441,超豐,20,0,20,元大-蘆洲,2024-03-07,9857
00919,群益台灣精選高息,872,529,343,元大-蘆洲,2024-03-08,9857
2002,中鋼,311,47,264,元大-蘆洲,2024-03-08,9857
00937B,群益ESG投等債20,271,73,198,元大-蘆洲,2024-03-08,9857
00632R,元大台灣50反1,318,130,188,元大-蘆洲,2024-03-08,9857
00687B,國泰20年美債,176,14,162,元大-蘆洲,2024-03-08,9857
1301,台塑,129,3,126,元大-蘆洲,2024-03-08,9857
00679B,元大美債20年,133,26,107,元大-蘆洲,2024-03-08,9857
4915,致伸,121,20,101,元大-蘆洲,2024-03-08,9857
1609,大亞,132,39,93,元大-蘆洲,2024-03-08,9857
2344,華邦電,109,37,72,元大-蘆洲,2024-03-08,9857
2317,鴻海,77,10,67,元大-蘆洲,2024-03-08,9857
00637L,元大滬深300正2,155,89,66,元大-蘆洲,2024-03-08,9857
00712,復華富時不動產,75,17,58,元大-蘆洲,2024-03-08,9857
1416,廣豐,43,1,42,元大-蘆洲,2024-03-08,9857
00915,凱基優選高股息30,78,39,39,元大-蘆洲,2024-03-08,9857
2449,京元電子,114,79,35,元大-蘆洲,2024-03-08,9857
6125,廣運,112,77,35,元大-蘆洲,2024-03-08,9857
6285,啟��,46,13,33,元大-蘆洲,2024-03-08,9857
1522,堤維西,40,7,33,元大-蘆洲,2024-03-08,9857
00931B,統一美債20年,40,8,32,元大-蘆洲,2024-03-08,9857
00676R,富邦臺灣加權反1,32,0,32,元大-蘆洲,2024-03-08,9857
00929,復華台灣科技優息,448,416,32,元大-蘆洲,2024-03-08,9857
8069,元太,34,3,31,元大-蘆洲,2024-03-08,9857
1616,億泰,31,0,31,元大-蘆洲,2024-03-08,9857
2608,嘉里大榮,31,0,31,元大-蘆洲,2024-03-08,9857
2887,台新金,34,4,30,元大-蘆洲,2024-03-08,9857
2409,友達,45,16,29,元大-蘆洲,2024-03-08,9857
2834,臺企銀,60,31,29,元大-蘆洲,2024-03-08,9857
6116,彩晶,40,14,26,元大-蘆洲,2024-03-08,9857
6227,茂綸,28,2,26,元大-蘆洲,2024-03-08,9857
6274,台燿,55,30,25,元大-蘆洲,2024-03-08,9857
00922,國泰台灣領袖50,61,37,24,元大-蘆洲,2024-03-08,9857
6693,廣閎科,24,0,24,元大-蘆洲,2024-03-08,9857
5498,凱崴,128,104,24,元大-蘆洲,2024-03-08,9857
9941,裕融,25,2,23,元大-蘆洲,2024-03-08,9857
3171,炎洲流通,28,5,23,元大-蘆洲,2024-03-08,9857
3689,湧德,34,11,23,元大-蘆洲,2024-03-08,9857
00665L,富邦�琤肭磪囓�2,23,0,23,元大-蘆洲,2024-03-08,9857
2331,精英,21,0,21,元大-蘆洲,2024-03-08,9857
2601,益航,30,10,20,元大-蘆洲,2024-03-08,9857
3540,曜越,67,47,20,元大-蘆洲,2024-03-08,9857
3032,偉訓,25,5,20,元大-蘆洲,2024-03-08,9857
1802,台玻,20,0,20,元大-蘆洲,2024-03-08,9857
8121,越峰,20,0,20,元大-蘆洲,2024-03-08,9857
3006,晶豪科,74,55,19,元大-蘆洲,2024-03-08,9857
9105,泰金寶-DR,80,61,19,元大-蘆洲,2024-03-08,9857
2486,一詮,29,11,18,元大-蘆洲,2024-03-08,9857
2328,廣宇,19,1,18,元大-蘆洲,2024-03-08,9857
00885,富邦越南,31,13,18,元大-蘆洲,2024-03-08,9857
1524,耿鼎,23,5,18,元大-蘆洲,2024-03-08,9857
00919,群益台灣精選高息,1085,222,863,元大-蘆洲,2024-03-11,9857
00937B,群益ESG投等債20,442,39,403,元大-蘆洲,2024-03-11,9857
00918,大華優利高填息30,155,2,153,元大-蘆洲,2024-03-11,9857
00687B,國泰20年美債,151,3,148,元大-蘆洲,2024-03-11,9857
00632R,元大台灣50反1,127,7,120,元大-蘆洲,2024-03-11,9857
3163,波若威,155,38,117,元大-蘆洲,2024-03-11,9857
2834,臺企銀,116,16,100,元大-蘆洲,2024-03-11,9857
2371,大同,97,13,84,元大-蘆洲,2024-03-11,9857
1316,上曜,169,94,75,元大-蘆洲,2024-03-11,9857
00931B,統一美債20年,75,0,75,元大-蘆洲,2024-03-11,9857
2303,聯電,161,90,71,元大-蘆洲,2024-03-11,9857
00764B,群益25年美債,63,0,63,元大-蘆洲,2024-03-11,9857
5483,中美晶,53,6,47,元大-蘆洲,2024-03-11,9857
3376,新日興,44,2,42,元大-蘆洲,2024-03-11,9857
1815,富喬,98,57,41,元大-蘆洲,2024-03-11,9857
2408,南亞科,49,9,40,元大-蘆洲,2024-03-11,9857
2367,燿華,122,83,39,元大-蘆洲,2024-03-11,9857
1907,永豐餘,35,0,35,元大-蘆洲,2024-03-11,9857
2014,中鴻,35,1,34,元大-蘆洲,2024-03-11,9857
9105,泰金寶-DR,33,0,33,元大-蘆洲,2024-03-11,9857
8085,福華,35,3,32,元大-蘆洲,2024-03-11,9857
3017,奇鋐,50,19,31,元大-蘆洲,2024-03-11,9857
2890,永豐金,31,0,31,元大-蘆洲,2024-03-11,9857
2537,聯上發,40,11,29,元大-蘆洲,2024-03-11,9857
2610,華航,31,5,26,元大-蘆洲,2024-03-11,9857
1785,光洋科,42,17,25,元大-蘆洲,2024-03-11,9857
2601,益航,25,0,25,元大-蘆洲,2024-03-11,9857
00891,中信關鍵半導體,26,2,24,元大-蘆洲,2024-03-11,9857
2618,長榮航,72,49,23,元大-蘆洲,2024-03-11,9857
1314,中石化,24,1,23,元大-蘆洲,2024-03-11,9857
1210,大成,23,0,23,元大-蘆洲,2024-03-11,9857
3481,群創,57,36,21,元大-蘆洲,2024-03-11,9857
3356,奇偶,20,0,20,元大-蘆洲,2024-03-11,9857
3624,光頡,20,0,20,元大-蘆洲,2024-03-11,9857
5439,高技,20,0,20,元大-蘆洲,2024-03-11,9857
00935,野村臺灣新科技50,20,0,20,元大-蘆洲,2024-03-11,9857
00715L,期街口布蘭特正2,19,0,19,元大-蘆洲,2024-03-11,9857
5469,瀚宇博,18,0,18,元大-蘆洲,2024-03-11,9857
3339,泰谷,19,2,17,元大-蘆洲,2024-03-11,9857
3380,明泰,18,1,17,元大-蘆洲,2024-03-11,9857
8926,台汽電,24,9,15,元大-蘆洲,2024-03-11,9857
3450,聯鈞,24,9,15,元大-蘆洲,2024-03-11,9857
00751B,元大AAA至A公司債,21,6,15,元大-蘆洲,2024-03-11,9857
5213,亞昕,18,4,14,元大-蘆洲,2024-03-11,9857
3060,銘異,14,0,14,元大-蘆洲,2024-03-11,9857
00915,凱基優選高股息30,22,8,14,元大-蘆洲,2024-03-11,9857
2388,威盛,31,18,13,元大-蘆洲,2024-03-11,9857
00650L,復華香港正2,13,0,13,元大-蘆洲,2024-03-11,9857
6189,豐藝,13,0,13,元大-蘆洲,2024-03-11,9857
2301,光寶科,22,9,13,元大-蘆洲,2024-03-11,9857
00937B,群益ESG投等債20,260,16,244,元大-蘆洲,2024-03-12,9857
00706L,期元大S＆P日圓正2,213,0,213,元大-蘆洲,2024-03-12,9857
00687B,國泰20年美債,118,1,117,元大-蘆洲,2024-03-12,9857
6125,廣運,118,24,94,元大-蘆洲,2024-03-12,9857
1815,富喬,207,140,67,元大-蘆洲,2024-03-12,9857
00915,凱基優選高股息30,67,4,63,元大-蘆洲,2024-03-12,9857
2328,廣宇,67,11,56,元大-蘆洲,2024-03-12,9857
6274,台燿,102,46,56,元大-蘆洲,2024-03-12,9857
2371,大同,60,8,52,元大-蘆洲,2024-03-12,9857
2367,燿華,171,119,52,元大-蘆洲,2024-03-12,9857
00919,群益台灣精選高息,200,152,48,元大-蘆洲,2024-03-12,9857
4714,永捷,101,57,44,元大-蘆洲,2024-03-12,9857
00665L,富邦�琤肭磪囓�2,91,47,44,元大-蘆洲,2024-03-12,9857
2206,三陽工業,45,4,41,元大-蘆洲,2024-03-12,9857
2530,華建,41,0,41,元大-蘆洲,2024-03-12,9857
2618,長榮航,222,182,40,元大-蘆洲,2024-03-12,9857
2344,華邦電,51,11,40,元大-蘆洲,2024-03-12,9857
2845,遠東銀,42,4,38,元大-蘆洲,2024-03-12,9857
8096,擎亞,108,73,35,元大-蘆洲,2024-03-12,9857
00753L,中信中國50正2,45,10,35,元大-蘆洲,2024-03-12,9857
3624,光頡,33,0,33,元大-蘆洲,2024-03-12,9857
2312,金寶,34,2,32,元大-蘆洲,2024-03-12,9857
1589,永冠-KY,32,1,31,元大-蘆洲,2024-03-12,9857
00918,大華優利高填息30,79,49,30,元大-蘆洲,2024-03-12,9857
1528,恩德,31,2,29,元大-蘆洲,2024-03-12,9857
2324,仁寶,36,8,28,元大-蘆洲,2024-03-12,9857
3545,敦泰,29,2,27,元大-蘆洲,2024-03-12,9857
1522,堤維西,43,16,27,元大-蘆洲,2024-03-12,9857
1514,亞力,48,21,27,元大-蘆洲,2024-03-12,9857
3325,旭品,63,36,27,元大-蘆洲,2024-03-12,9857
3016,嘉晶,47,23,24,元大-蘆洲,2024-03-12,9857
6770,力積電,31,7,24,元大-蘆洲,2024-03-12,9857
2331,精英,24,0,24,元大-蘆洲,2024-03-12,9857
2352,佳世達,29,6,23,元大-蘆洲,2024-03-12,9857
5258,虹堡,29,6,23,元大-蘆洲,2024-03-12,9857
00885,富邦越南,22,0,22,元大-蘆洲,2024-03-12,9857
2425,承啟,22,0,22,元大-蘆洲,2024-03-12,9857
6217,中探針,33,12,21,元大-蘆洲,2024-03-12,9857
9907,統一實,20,0,20,元大-蘆洲,2024-03-12,9857
00931B,統一美債20年,20,0,20,元大-蘆洲,2024-03-12,9857
2855,統一證,20,0,20,元大-蘆洲,2024-03-12,9857
00857B,永豐20年美公債,19,0,19,元大-蘆洲,2024-03-12,9857
6282,康舒,30,12,18,元大-蘆洲,2024-03-12,9857
3006,晶豪科,27,10,17,元大-蘆洲,2024-03-12,9857
1101,台泥,21,4,17,元大-蘆洲,2024-03-12,9857
2427,三商電,20,3,17,元大-蘆洲,2024-03-12,9857
00935,野村臺灣新科技50,18,1,17,元大-蘆洲,2024-03-12,9857
4906,正文,18,1,17,元大-蘆洲,2024-03-12,9857
2892,第一金,18,2,16,元大-蘆洲,2024-03-12,9857
2539,櫻花建,26,10,16,元大-蘆洲,2024-03-12,9857
00919,群益台灣精選高息,538,140,398,元大-蘆洲,2024-03-13,9857
00937B,群益ESG投等債20,340,21,319,元大-蘆洲,2024-03-13,9857
2344,華邦電,224,4,220,元大-蘆洲,2024-03-13,9857
1514,亞力,380,162,218,元大-蘆洲,2024-03-13,9857
3231,緯創,273,75,198,元大-蘆洲,2024-03-13,9857
00918,大華優利高填息30,211,60,151,元大-蘆洲,2024-03-13,9857
00687B,國泰20年美債,223,86,137,元大-蘆洲,2024-03-13,9857
00929,復華台灣科技優息,187,64,123,元大-蘆洲,2024-03-13,9857
00637L,元大滬深300正2,147,45,102,元大-蘆洲,2024-03-13,9857
3481,群創,101,22,79,元大-蘆洲,2024-03-13,9857
2408,南亞科,112,39,73,元大-蘆洲,2024-03-13,9857
00720B,元大投資級公司債,67,6,61,元大-蘆洲,2024-03-13,9857
1609,大亞,77,16,61,元大-蘆洲,2024-03-13,9857
1815,富喬,173,122,51,元大-蘆洲,2024-03-13,9857
00933B,國泰10Y+金融債,56,7,49,元大-蘆洲,2024-03-13,9857
3715,定穎投控,51,4,47,元大-蘆洲,2024-03-13,9857
2607,榮運,65,20,45,元大-蘆洲,2024-03-13,9857
2385,群光,52,10,42,元大-蘆洲,2024-03-13,9857
3041,揚智,42,4,38,元大-蘆洲,2024-03-13,9857
00931B,統一美債20年,37,1,36,元大-蘆洲,2024-03-13,9857
2834,臺企銀,75,39,36,元大-蘆洲,2024-03-13,9857
1612,宏泰,45,10,35,元大-蘆洲,2024-03-13,9857
1608,華榮,99,66,33,元大-蘆洲,2024-03-13,9857
5864,致和證,30,0,30,元大-蘆洲,2024-03-13,9857
5201,凱衛,31,1,30,元大-蘆洲,2024-03-13,9857
00878,國泰永續高股息,93,64,29,元大-蘆洲,2024-03-13,9857
6125,廣運,94,65,29,元大-蘆洲,2024-03-13,9857
2603,長榮,79,50,29,元大-蘆洲,2024-03-13,9857
6188,廣明,36,7,29,元大-蘆洲,2024-03-13,9857
2324,仁寶,34,7,27,元大-蘆洲,2024-03-13,9857
3372,典範,26,0,26,元大-蘆洲,2024-03-13,9857
00857B,永豐20年美公債,25,0,25,元大-蘆洲,2024-03-13,9857
3171,炎洲流通,47,22,25,元大-蘆洲,2024-03-13,9857
3322,建舜電,24,0,24,元大-蘆洲,2024-03-13,9857
3017,奇鋐,58,34,24,元大-蘆洲,2024-03-13,9857
2836,高雄銀,23,0,23,元大-蘆洲,2024-03-13,9857
00927,群益半導體收益,23,0,23,元大-蘆洲,2024-03-13,9857
00935,野村臺灣新科技50,25,2,23,元大-蘆洲,2024-03-13,9857
2484,希華,22,0,22,元大-蘆洲,2024-03-13,9857
00882,中信中國高股息,48,26,22,元大-蘆洲,2024-03-13,9857
2888,新光金,28,6,22,元大-蘆洲,2024-03-13,9857
1618,合機,37,16,21,元大-蘆洲,2024-03-13,9857
1721,三晃,21,0,21,元大-蘆洲,2024-03-13,9857
5355,佳總,20,0,20,元大-蘆洲,2024-03-13,9857
3450,聯鈞,24,4,20,元大-蘆洲,2024-03-13,9857
2329,華泰,30,10,20,元大-蘆洲,2024-03-13,9857
8926,台汽電,48,29,19,元大-蘆洲,2024-03-13,9857
2867,三商壽,20,1,19,元大-蘆洲,2024-03-13,9857
8085,福華,19,0,19,元大-蘆洲,2024-03-13,9857
2337,旺宏,20,1,19,元大-蘆洲,2024-03-13,9857
00919,群益台灣精選高息,877,404,473,元大-蘆洲,2024-03-14,9857
00918,大華優利高填息30,353,49,304,元大-蘆洲,2024-03-14,9857
00937B,群益ESG投等債20,371,99,272,元大-蘆洲,2024-03-14,9857
00929,復華台灣科技優息,380,137,243,元大-蘆洲,2024-03-14,9857
2883,凱基金,588,365,223,元大-蘆洲,2024-03-14,9857
2014,中鴻,207,4,203,元大-蘆洲,2024-03-14,9857
00687B,國泰20年美債,244,55,189,元大-蘆洲,2024-03-14,9857
2885,元大金,187,37,150,元大-蘆洲,2024-03-14,9857
2888,新光金,150,13,137,元大-蘆洲,2024-03-14,9857
2603,長榮,118,32,86,元大-蘆洲,2024-03-14,9857
1815,富喬,95,9,86,元大-蘆洲,2024-03-14,9857
3005,神基,117,32,85,元大-蘆洲,2024-03-14,9857
0056,元大高股息,96,20,76,元大-蘆洲,2024-03-14,9857
3231,緯創,120,45,75,元大-蘆洲,2024-03-14,9857
1513,中興電,194,121,73,元大-蘆洲,2024-03-14,9857
2537,聯上發,72,0,72,元大-蘆洲,2024-03-14,9857
2301,光寶科,73,1,72,元大-蘆洲,2024-03-14,9857
2618,長榮航,231,172,59,元大-蘆洲,2024-03-14,9857
6126,信音,56,1,55,元大-蘆洲,2024-03-14,9857
1314,中石化,52,0,52,元大-蘆洲,2024-03-14,9857
2601,益航,50,0,50,元大-蘆洲,2024-03-14,9857
2354,鴻準,99,51,48,元大-蘆洲,2024-03-14,9857
6188,廣明,42,1,41,元大-蘆洲,2024-03-14,9857
4581,光隆精密-KY,41,0,41,元大-蘆洲,2024-03-14,9857
00922,國泰台灣領袖50,42,1,41,元大-蘆洲,2024-03-14,9857
00934,中信成長高股息,47,7,40,元大-蘆洲,2024-03-14,9857
2547,日勝生,40,0,40,元大-蘆洲,2024-03-14,9857
6415,矽力*-KY,41,2,39,元大-蘆洲,2024-03-14,9857
2889,國票金,59,22,37,元大-蘆洲,2024-03-14,9857
00632R,元大台灣50反1,50,16,34,元大-蘆洲,2024-03-14,9857
5201,凱衛,33,0,33,元大-蘆洲,2024-03-14,9857
3706,神達,41,8,33,元大-蘆洲,2024-03-14,9857
4938,和碩,34,3,31,元大-蘆洲,2024-03-14,9857
2313,華通,36,5,31,元大-蘆洲,2024-03-14,9857
2530,華建,31,0,31,元大-蘆洲,2024-03-14,9857
3702,大聯大,33,3,30,元大-蘆洲,2024-03-14,9857
00680L,元大美債20正2,30,0,30,元大-蘆洲,2024-03-14,9857
00888,永豐台灣ESG,30,0,30,元大-蘆洲,2024-03-14,9857
3035,智原,46,16,30,元大-蘆洲,2024-03-14,9857
2401,凌陽,43,17,26,元大-蘆洲,2024-03-14,9857
2845,遠東銀,30,5,25,元大-蘆洲,2024-03-14,9857
2329,華泰,43,19,24,元大-蘆洲,2024-03-14,9857
2408,南亞科,28,5,23,元大-蘆洲,2024-03-14,9857
4714,永捷,31,8,23,元大-蘆洲,2024-03-14,9857
1806,冠軍,28,5,23,元大-蘆洲,2024-03-14,9857
00673R,期元大S＆P原油反1,21,0,21,元大-蘆洲,2024-03-14,9857
00915,凱基優選高股息30,70,49,21,元大-蘆洲,2024-03-14,9857
1316,上曜,75,54,21,元大-蘆洲,2024-03-14,9857
2615,萬海,24,4,20,元大-蘆洲,2024-03-14,9857
1471,首利,20,0,20,元大-蘆洲,2024-03-14,9857
00688L,國泰20年美債正2,495,0,495,元大-蘆洲,2024-03-15,9857
00919,群益台灣精選高息,656,230,426,元大-蘆洲,2024-03-15,9857
00941,中信上游半導體,561,163,398,元大-蘆洲,2024-03-15,9857
2603,長榮,278,77,201,元大-蘆洲,2024-03-15,9857
2834,臺企銀,307,161,146,元大-蘆洲,2024-03-15,9857
00687B,國泰20年美債,137,3,134,元大-蘆洲,2024-03-15,9857
00712,復華富時不動產,111,0,111,元大-蘆洲,2024-03-15,9857
2354,鴻準,186,102,84,元大-蘆洲,2024-03-15,9857
00915,凱基優選高股息30,82,0,82,元大-蘆洲,2024-03-15,9857
00679B,元大美債20年,79,3,76,元大-蘆洲,2024-03-15,9857
3481,群創,223,150,73,元大-蘆洲,2024-03-15,9857
2618,長榮航,97,28,69,元大-蘆洲,2024-03-15,9857
00673R,期元大S＆P原油反1,64,0,64,元大-蘆洲,2024-03-15,9857
2836,高雄銀,60,0,60,元大-蘆洲,2024-03-15,9857
2611,志信,102,44,58,元大-蘆洲,2024-03-15,9857
2353,宏��,71,15,56,元大-蘆洲,2024-03-15,9857
2303,聯電,94,44,50,元大-蘆洲,2024-03-15,9857
4714,永捷,150,101,49,元大-蘆洲,2024-03-15,9857
00680L,元大美債20正2,59,13,46,元大-蘆洲,2024-03-15,9857
2607,榮運,45,0,45,元大-蘆洲,2024-03-15,9857
2344,華邦電,45,1,44,元大-蘆洲,2024-03-15,9857
2609,陽明,112,69,43,元大-蘆洲,2024-03-15,9857
2104,國際中橡,40,0,40,元大-蘆洲,2024-03-15,9857
2002,中鋼,42,4,38,元大-蘆洲,2024-03-15,9857
2014,中鴻,38,0,38,元大-蘆洲,2024-03-15,9857
2363,矽統,41,6,35,元大-蘆洲,2024-03-15,9857
6116,彩晶,53,20,33,元大-蘆洲,2024-03-15,9857
2330,台積電,48,16,32,元大-蘆洲,2024-03-15,9857
2615,萬海,33,1,32,元大-蘆洲,2024-03-15,9857
3005,神基,39,8,31,元大-蘆洲,2024-03-15,9857
2887,台新金,42,11,31,元大-蘆洲,2024-03-15,9857
5347,世界,63,33,30,元大-蘆洲,2024-03-15,9857
4960,誠美材,30,0,30,元大-蘆洲,2024-03-15,9857
00720B,元大投資級公司債,30,1,29,元大-蘆洲,2024-03-15,9857
2301,光寶科,39,10,29,元大-蘆洲,2024-03-15,9857
2610,華航,43,15,28,元大-蘆洲,2024-03-15,9857
1809,中釉,29,1,28,元大-蘆洲,2024-03-15,9857
1316,上曜,62,34,28,元大-蘆洲,2024-03-15,9857
00665L,富邦�琤肭磪囓�2,26,0,26,元大-蘆洲,2024-03-15,9857
5483,中美晶,27,1,26,元大-蘆洲,2024-03-15,9857
6285,啟��,57,31,26,元大-蘆洲,2024-03-15,9857
2302,麗正,25,0,25,元大-蘆洲,2024-03-15,9857
00632R,元大台灣50反1,27,2,25,元大-蘆洲,2024-03-15,9857
5871,中租-KY,26,1,25,元大-蘆洲,2024-03-15,9857
8096,擎亞,26,4,22,元大-蘆洲,2024-03-15,9857
2489,瑞軒,23,2,21,元大-蘆洲,2024-03-15,9857
3628,盈正,21,0,21,元大-蘆洲,2024-03-15,9857
6122,擎邦,22,1,21,元大-蘆洲,2024-03-15,9857
00931B,統一美債20年,20,0,20,元大-蘆洲,2024-03-15,9857
2636,台驊控股,25,5,20,元大-蘆洲,2024-03-15,9857
00680L,元大美債20正2,424,0,424,元大-蘆洲,2024-03-18,9857
5347,世界,283,60,223,元大-蘆洲,2024-03-18,9857
2511,太子,201,0,201,元大-蘆洲,2024-03-18,9857
00937B,群益ESG投等債20,210,48,162,元大-蘆洲,2024-03-18,9857
00929,復華台灣科技優息,293,151,142,元大-蘆洲,2024-03-18,9857
00919,群益台灣精選高息,286,154,132,元大-蘆洲,2024-03-18,9857
2884,玉山金,136,24,112,元大-蘆洲,2024-03-18,9857
00941,中信上游半導體,105,6,99,元大-蘆洲,2024-03-18,9857
00687B,國泰20年美債,107,17,90,元大-蘆洲,2024-03-18,9857
2501,國建,84,3,81,元大-蘆洲,2024-03-18,9857
2618,長榮航,84,8,76,元大-蘆洲,2024-03-18,9857
1608,華榮,99,34,65,元大-蘆洲,2024-03-18,9857
6165,浪凡,50,0,50,元大-蘆洲,2024-03-18,9857
9945,潤泰新,49,6,43,元大-蘆洲,2024-03-18,9857
00751B,元大AAA至A公司債,42,0,42,元大-蘆洲,2024-03-18,9857
00679B,元大美債20年,72,30,42,元大-蘆洲,2024-03-18,9857
1215,卜蜂,40,0,40,元大-蘆洲,2024-03-18,9857
2352,佳世達,41,4,37,元大-蘆洲,2024-03-18,9857
2371,大同,38,2,36,元大-蘆洲,2024-03-18,9857
3294,英濟,105,71,34,元大-蘆洲,2024-03-18,9857
2888,新光金,40,7,33,元大-蘆洲,2024-03-18,9857
2834,臺企銀,142,111,31,元大-蘆洲,2024-03-18,9857
3481,群創,60,29,31,元大-蘆洲,2024-03-18,9857
00918,大華優利高填息30,70,40,30,元大-蘆洲,2024-03-18,9857
2603,長榮,68,38,30,元大-蘆洲,2024-03-18,9857
00652,富邦印度,30,1,29,元大-蘆洲,2024-03-18,9857
1789,神隆,30,2,28,元大-蘆洲,2024-03-18,9857
2303,聯電,104,77,27,元大-蘆洲,2024-03-18,9857
00933B,國泰10Y+金融債,52,25,27,元大-蘆洲,2024-03-18,9857
2408,南亞科,28,3,25,元大-蘆洲,2024-03-18,9857
2382,廣達,49,25,24,元大-蘆洲,2024-03-18,9857
00915,凱基優選高股息30,42,18,24,元大-蘆洲,2024-03-18,9857
00713,元大台灣高息低波,24,0,24,元大-蘆洲,2024-03-18,9857
3663,鑫科,34,13,21,元大-蘆洲,2024-03-18,9857
6182,合晶,22,1,21,元大-蘆洲,2024-03-18,9857
2530,華建,22,1,21,元大-蘆洲,2024-03-18,9857
2601,益航,21,0,21,元大-蘆洲,2024-03-18,9857
2608,嘉里大榮,20,0,20,元大-蘆洲,2024-03-18,9857
8011,台通,33,14,19,元大-蘆洲,2024-03-18,9857
00725B,國泰投資級公司債,19,0,19,元大-蘆洲,2024-03-18,9857
3705,永信,19,0,19,元大-蘆洲,2024-03-18,9857
00891,中信關鍵半導體,27,9,18,元大-蘆洲,2024-03-18,9857
2329,華泰,84,67,17,元大-蘆洲,2024-03-18,9857
2006,東和鋼鐵,18,1,17,元大-蘆洲,2024-03-18,9857
6244,茂迪,20,3,17,元大-蘆洲,2024-03-18,9857
2486,一詮,82,66,16,元大-蘆洲,2024-03-18,9857
2401,凌陽,16,0,16,元大-蘆洲,2024-03-18,9857
3013,晟銘電,18,2,16,元大-蘆洲,2024-03-18,9857
2349,錸德,20,4,16,元大-蘆洲,2024-03-18,9857
00931B,統一美債20年,27,12,15,元大-蘆洲,2024-03-18,9857
00680L,元大美債20正2,178,0,178,元大-蘆洲,2024-03-19,9857
00919,群益台灣精選高息,297,127,170,元大-蘆洲,2024-03-19,9857
00934,中信成長高股息,187,35,152,元大-蘆洲,2024-03-19,9857
2888,新光金,140,0,140,元大-蘆洲,2024-03-19,9857
00687B,國泰20年美債,156,28,128,元大-蘆洲,2024-03-19,9857
6274,台燿,143,54,89,元大-蘆洲,2024-03-19,9857
00679B,元大美債20年,87,0,87,元大-蘆洲,2024-03-19,9857
3050,鈺德,85,0,85,元大-蘆洲,2024-03-19,9857
2420,新巨,70,0,70,元大-蘆洲,2024-03-19,9857
5880,合庫金,67,0,67,元大-蘆洲,2024-03-19,9857
00941,中信上游半導體,64,2,62,元大-蘆洲,2024-03-19,9857
2362,藍天,83,21,62,元大-蘆洲,2024-03-19,9857
00933B,國泰10Y+金融債,61,0,61,元大-蘆洲,2024-03-19,9857
6462,神盾,66,10,56,元大-蘆洲,2024-03-19,9857
1815,富喬,54,0,54,元大-蘆洲,2024-03-19,9857
2356,英業達,89,44,45,元大-蘆洲,2024-03-19,9857
2104,國際中橡,45,0,45,元大-蘆洲,2024-03-19,9857
2376,技嘉,48,4,44,元大-蘆洲,2024-03-19,9857
1605,華新,54,14,40,元大-蘆洲,2024-03-19,9857
2515,中工,83,44,39,元大-蘆洲,2024-03-19,9857
00720B,元大投資級公司債,49,10,39,元大-蘆洲,2024-03-19,9857
2354,鴻準,73,37,36,元大-蘆洲,2024-03-19,9857
3051,力特,34,2,32,元大-蘆洲,2024-03-19,9857
00891,中信關鍵半導體,31,1,30,元大-蘆洲,2024-03-19,9857
00912,中信臺灣智慧50,30,0,30,元大-蘆洲,2024-03-19,9857
2323,中環,68,38,30,元大-蘆洲,2024-03-19,9857
2371,大同,35,6,29,元大-蘆洲,2024-03-19,9857
00918,大華優利高填息30,49,20,29,元大-蘆洲,2024-03-19,9857
2609,陽明,41,13,28,元大-蘆洲,2024-03-19,9857
00673R,期元大S＆P原油反1,28,0,28,元大-蘆洲,2024-03-19,9857
5483,中美晶,81,53,28,元大-蘆洲,2024-03-19,9857
3041,揚智,52,25,27,元大-蘆洲,2024-03-19,9857
00753L,中信中國50正2,29,4,25,元大-蘆洲,2024-03-19,9857
2353,宏��,27,2,25,元大-蘆洲,2024-03-19,9857
2618,長榮航,45,21,24,元大-蘆洲,2024-03-19,9857
3663,鑫科,24,0,24,元大-蘆洲,2024-03-19,9857
00927,群益半導體收益,25,1,24,元大-蘆洲,2024-03-19,9857
00878,國泰永續高股息,72,48,24,元大-蘆洲,2024-03-19,9857
3694,海華,34,12,22,元大-蘆洲,2024-03-19,9857
3380,明泰,23,2,21,元大-蘆洲,2024-03-19,9857
00881,國泰台灣5G+,22,1,21,元大-蘆洲,2024-03-19,9857
1313,聯成,21,0,21,元大-蘆洲,2024-03-19,9857
00857B,永豐20年美公債,21,0,21,元大-蘆洲,2024-03-19,9857
2885,元大金,22,1,21,元大-蘆洲,2024-03-19,9857
00688L,國泰20年美債正2,22,2,20,元大-蘆洲,2024-03-19,9857
3059,華晶科,19,0,19,元大-蘆洲,2024-03-19,9857
5443,均豪,68,50,18,元大-蘆洲,2024-03-19,9857
2388,威盛,38,20,18,元大-蘆洲,2024-03-19,9857
1101,台泥,40,23,17,元大-蘆洲,2024-03-19,9857
8467,波力-KY,22,5,17,元大-蘆洲,2024-03-19,9857
00939,統一台灣高息動能,1374,108,1266,元大-蘆洲,2024-03-20,9857
00919,群益台灣精選高息,854,388,466,元大-蘆洲,2024-03-20,9857
00937B,群益ESG投等債20,218,5,213,元大-蘆洲,2024-03-20,9857
2834,臺企銀,143,2,141,元大-蘆洲,2024-03-20,9857
2801,彰銀,125,1,124,元大-蘆洲,2024-03-20,9857
2355,敬鵬,102,4,98,元大-蘆洲,2024-03-20,9857
00927,群益半導體收益,65,2,63,元大-蘆洲,2024-03-20,9857
00632R,元大台灣50反1,61,3,58,元大-蘆洲,2024-03-20,9857
3481,群創,75,18,57,元大-蘆洲,2024-03-20,9857
00673R,期元大S＆P原油反1,50,0,50,元大-蘆洲,2024-03-20,9857
2883,凱基金,155,107,48,元大-蘆洲,2024-03-20,9857
9945,潤泰新,48,1,47,元大-蘆洲,2024-03-20,9857
2603,長榮,167,123,44,元大-蘆洲,2024-03-20,9857
2356,英業達,101,58,43,元大-蘆洲,2024-03-20,9857
2382,廣達,59,17,42,元大-蘆洲,2024-03-20,9857
5493,三聯,53,12,41,元大-蘆洲,2024-03-20,9857
2344,華邦電,49,9,40,元大-蘆洲,2024-03-20,9857
00687B,國泰20年美債,74,34,40,元大-蘆洲,2024-03-20,9857
6438,迅得,41,2,39,元大-蘆洲,2024-03-20,9857
2888,新光金,44,7,37,元大-蘆洲,2024-03-20,9857
2374,佳能,63,27,36,元大-蘆洲,2024-03-20,9857
2002,中鋼,46,11,35,元大-蘆洲,2024-03-20,9857
2610,華航,41,8,33,元大-蘆洲,2024-03-20,9857
00941,中信上游半導體,51,19,32,元大-蘆洲,2024-03-20,9857
2328,廣宇,33,2,31,元大-蘆洲,2024-03-20,9857
4979,華星光,40,10,30,元大-蘆洲,2024-03-20,9857
4129,聯合,33,3,30,元大-蘆洲,2024-03-20,9857
00878,國泰永續高股息,43,15,28,元大-蘆洲,2024-03-20,9857
0056,元大高股息,119,91,28,元大-蘆洲,2024-03-20,9857
8210,勤誠,33,5,28,元大-蘆洲,2024-03-20,9857
6285,啟��,77,50,27,元大-蘆洲,2024-03-20,9857
6274,台燿,32,7,25,元大-蘆洲,2024-03-20,9857
8374,羅昇,25,0,25,元大-蘆洲,2024-03-20,9857
00720B,元大投資級公司債,24,2,22,元大-蘆洲,2024-03-20,9857
2885,元大金,27,6,21,元大-蘆洲,2024-03-20,9857
4906,正文,23,2,21,元大-蘆洲,2024-03-20,9857
4961,天鈺,35,14,21,元大-蘆洲,2024-03-20,9857
6244,茂迪,20,0,20,元大-蘆洲,2024-03-20,9857
1806,冠軍,20,0,20,元大-蘆洲,2024-03-20,9857
1608,華榮,20,1,19,元大-蘆洲,2024-03-20,9857
2492,華新科,23,5,18,元大-蘆洲,2024-03-20,9857
3260,威剛,35,17,18,元大-蘆洲,2024-03-20,9857
1218,泰山,19,2,17,元大-蘆洲,2024-03-20,9857
2903,遠百,17,0,17,元大-蘆洲,2024-03-20,9857
1609,大亞,31,14,17,元大-蘆洲,2024-03-20,9857
1101,台泥,24,7,17,元大-蘆洲,2024-03-20,9857
6443,元晶,17,1,16,元大-蘆洲,2024-03-20,9857
2867,三商壽,16,0,16,元大-蘆洲,2024-03-20,9857
3294,英濟,17,1,16,元大-蘆洲,2024-03-20,9857
2464,盟立,17,1,16,元大-蘆洲,2024-03-20,9857
00939,統一台灣高息動能,753,16,737,元大-蘆洲,2024-03-21,9857
00795B,中信美國公債20年,369,0,369,元大-蘆洲,2024-03-21,9857
00929,復華台灣科技優息,263,37,226,元大-蘆洲,2024-03-21,9857
2618,長榮航,218,13,205,元大-蘆洲,2024-03-21,9857
1609,大亞,185,52,133,元大-蘆洲,2024-03-21,9857
00632R,元大台灣50反1,125,0,125,元大-蘆洲,2024-03-21,9857
00687B,國泰20年美債,109,2,107,元大-蘆洲,2024-03-21,9857
6116,彩晶,105,30,75,元大-蘆洲,2024-03-21,9857
9105,泰金寶-DR,64,0,64,元大-蘆洲,2024-03-21,9857
00679B,元大美債20年,67,6,61,元大-蘆洲,2024-03-21,9857
2883,凱基金,141,89,52,元大-蘆洲,2024-03-21,9857
1522,堤維西,54,10,44,元大-蘆洲,2024-03-21,9857
3005,神基,91,48,43,元大-蘆洲,2024-03-21,9857
00937B,群益ESG投等債20,89,47,42,元大-蘆洲,2024-03-21,9857
2524,京城,42,0,42,元大-蘆洲,2024-03-21,9857
00919,群益台灣精選高息,405,366,39,元大-蘆洲,2024-03-21,9857
00941,中信上游半導體,147,110,37,元大-蘆洲,2024-03-21,9857
2367,燿華,71,36,35,元大-蘆洲,2024-03-21,9857
3047,訊舟,31,0,31,元大-蘆洲,2024-03-21,9857
2801,彰銀,29,0,29,元大-蘆洲,2024-03-21,9857
2405,輔信,52,27,25,元大-蘆洲,2024-03-21,9857
2889,國票金,32,7,25,元大-蘆洲,2024-03-21,9857
3231,緯創,58,34,24,元大-蘆洲,2024-03-21,9857
00680L,元大美債20正2,35,11,24,元大-蘆洲,2024-03-21,9857
1503,士電,208,185,23,元大-蘆洲,2024-03-21,9857
00753L,中信中國50正2,25,4,21,元大-蘆洲,2024-03-21,9857
1806,冠軍,21,0,21,元大-蘆洲,2024-03-21,9857
1101,台泥,43,23,20,元大-蘆洲,2024-03-21,9857
3581,博磊,20,0,20,元大-蘆洲,2024-03-21,9857
9962,有益,20,0,20,元大-蘆洲,2024-03-21,9857
2301,光寶科,69,49,20,元大-蘆洲,2024-03-21,9857
4113,聯上,20,1,19,元大-蘆洲,2024-03-21,9857
2834,臺企銀,21,3,18,元大-蘆洲,2024-03-21,9857
2302,麗正,18,0,18,元大-蘆洲,2024-03-21,9857
1504,東元,75,59,16,元大-蘆洲,2024-03-21,9857
4938,和碩,37,20,17,元大-蘆洲,2024-03-21,9857
3576,聯合再生,20,4,16,元大-蘆洲,2024-03-21,9857
5452,佶優,20,4,16,元大-蘆洲,2024-03-21,9857
4906,正文,21,6,15,元大-蘆洲,2024-03-21,9857
6176,瑞儀,24,9,15,元大-蘆洲,2024-03-21,9857
00885,富邦越南,20,5,15,元大-蘆洲,2024-03-21,9857
00720B,元大投資級公司債,35,22,13,元大-蘆洲,2024-03-21,9857
6285,啟��,40,27,13,元大-蘆洲,2024-03-21,9857
2603,長榮,124,111,13,元大-蘆洲,2024-03-21,9857
8033,雷虎,56,43,13,元大-蘆洲,2024-03-21,9857
4953,緯軟,15,3,12,元大-蘆洲,2024-03-21,9857
5498,凱崴,16,4,12,元大-蘆洲,2024-03-21,9857
00891,中信關鍵半導體,18,6,12,元大-蘆洲,2024-03-21,9857
1802,台玻,15,3,12,元大-蘆洲,2024-03-21,9857
3363,上詮,14,2,12,元大-蘆洲,2024-03-21,9857
00937B,群益ESG投等債20,430,18,412,元大-蘆洲,2024-03-22,9857
00939,統一台灣高息動能,282,37,245,元大-蘆洲,2024-03-22,9857
00637L,元大滬深300正2,430,210,220,元大-蘆洲,2024-03-22,9857
2888,新光金,218,9,209,元大-蘆洲,2024-03-22,9857
00919,群益台灣精選高息,550,356,194,元大-蘆洲,2024-03-22,9857
00679B,元大美債20年,152,5,147,元大-蘆洲,2024-03-22,9857
3706,神達,294,196,98,元大-蘆洲,2024-03-22,9857
6443,元晶,130,34,96,元大-蘆洲,2024-03-22,9857
00632R,元大台灣50反1,97,2,95,元大-蘆洲,2024-03-22,9857
2883,凱基金,117,24,93,元大-蘆洲,2024-03-22,9857
2353,宏��,261,179,82,元大-蘆洲,2024-03-22,9857
2303,聯電,156,76,80,元大-蘆洲,2024-03-22,9857
6274,台燿,101,27,74,元大-蘆洲,2024-03-22,9857
1785,光洋科,114,41,73,元大-蘆洲,2024-03-22,9857
00795B,中信美國公債20年,61,0,61,元大-蘆洲,2024-03-22,9857
2482,連宇,61,2,59,元大-蘆洲,2024-03-22,9857
00753L,中信中國50正2,57,0,57,元大-蘆洲,2024-03-22,9857
2603,長榮,134,79,55,元大-蘆洲,2024-03-22,9857
5493,三聯,85,31,54,元大-蘆洲,2024-03-22,9857
00941,中信上游半導體,85,33,52,元大-蘆洲,2024-03-22,9857
00673R,期元大S＆P原油反1,50,0,50,元大-蘆洲,2024-03-22,9857
00720B,元大投資級公司債,48,6,42,元大-蘆洲,2024-03-22,9857
2633,台灣高鐵,41,1,40,元大-蘆洲,2024-03-22,9857
2406,國碩,86,47,39,元大-蘆洲,2024-03-22,9857
1605,華新,90,52,38,元大-蘆洲,2024-03-22,9857
00857B,永豐20年美公債,40,4,36,元大-蘆洲,2024-03-22,9857
4939,亞電,35,0,35,元大-蘆洲,2024-03-22,9857
1616,億泰,58,26,32,元大-蘆洲,2024-03-22,9857
8936,國統,38,11,27,元大-蘆洲,2024-03-22,9857
3380,明泰,27,1,26,元大-蘆洲,2024-03-22,9857
6712,長聖,27,2,25,元大-蘆洲,2024-03-22,9857
2371,大同,41,17,24,元大-蘆洲,2024-03-22,9857
2892,第一金,25,1,24,元大-蘆洲,2024-03-22,9857
1513,中興電,76,54,22,元大-蘆洲,2024-03-22,9857
1597,直得,21,0,21,元大-蘆洲,2024-03-22,9857
2489,瑞軒,21,0,21,元大-蘆洲,2024-03-22,9857
2352,佳世達,38,19,19,元大-蘆洲,2024-03-22,9857
2401,凌陽,23,4,19,元大-蘆洲,2024-03-22,9857
4714,永捷,35,17,18,元大-蘆洲,2024-03-22,9857
6147,頎邦,18,2,16,元大-蘆洲,2024-03-22,9857
2609,陽明,37,22,15,元大-蘆洲,2024-03-22,9857
3005,神基,34,19,15,元大-蘆洲,2024-03-22,9857
1514,亞力,44,29,15,元大-蘆洲,2024-03-22,9857
2328,廣宇,21,6,15,元大-蘆洲,2024-03-22,9857
5483,中美晶,31,17,14,元大-蘆洲,2024-03-22,9857
1808,潤隆,16,2,14,元大-蘆洲,2024-03-22,9857
3083,網龍,14,0,14,元大-蘆洲,2024-03-22,9857
3062,建漢,31,17,14,元大-蘆洲,2024-03-22,9857
2887,台新金,16,2,14,元大-蘆洲,2024-03-22,9857
1504,東元,57,43,14,元大-蘆洲,2024-03-22,9857
2356,英業達,392,178,214,元大-蘆洲,2024-03-25,9857
00937B,群益ESG投等債20,375,209,166,元大-蘆洲,2024-03-25,9857
3163,波若威,169,17,152,元大-蘆洲,2024-03-25,9857
2014,中鴻,151,0,151,元大-蘆洲,2024-03-25,9857
6188,廣明,180,47,133,元大-蘆洲,2024-03-25,9857
1504,東元,140,20,120,元大-蘆洲,2024-03-25,9857
00929,復華台灣科技優息,192,73,119,元大-蘆洲,2024-03-25,9857
00939,統一台灣高息動能,233,134,99,元大-蘆洲,2024-03-25,9857
1785,光洋科,109,34,75,元大-蘆洲,2024-03-25,9857
1609,大亞,377,308,69,元大-蘆洲,2024-03-25,9857
00919,群益台灣精選高息,294,225,69,元大-蘆洲,2024-03-25,9857
2324,仁寶,76,25,51,元大-蘆洲,2024-03-25,9857
6128,上福,50,0,50,元大-蘆洲,2024-03-25,9857
1101,台泥,48,1,47,元大-蘆洲,2024-03-25,9857
2618,長榮航,51,7,44,元大-蘆洲,2024-03-25,9857
3176,基亞,40,0,40,元大-蘆洲,2024-03-25,9857
2501,國建,41,2,39,元大-蘆洲,2024-03-25,9857
1513,中興電,136,98,38,元大-蘆洲,2024-03-25,9857
2888,新光金,42,4,38,元大-蘆洲,2024-03-25,9857
2630,亞航,38,0,38,元大-蘆洲,2024-03-25,9857
2401,凌陽,49,12,37,元大-蘆洲,2024-03-25,9857
6139,亞翔,97,62,35,元大-蘆洲,2024-03-25,9857
2353,宏��,67,34,33,元大-蘆洲,2024-03-25,9857
2352,佳世達,38,5,33,元大-蘆洲,2024-03-25,9857
3481,群創,46,16,30,元大-蘆洲,2024-03-25,9857
6196,帆宣,31,1,30,元大-蘆洲,2024-03-25,9857
00679B,元大美債20年,40,10,30,元大-蘆洲,2024-03-25,9857
4720,德淵,30,1,29,元大-蘆洲,2024-03-25,9857
2329,華泰,33,5,28,元大-蘆洲,2024-03-25,9857
3042,晶技,38,10,28,元大-蘆洲,2024-03-25,9857
2834,臺企銀,49,22,27,元大-蘆洲,2024-03-25,9857
2405,輔信,32,6,26,元大-蘆洲,2024-03-25,9857
3294,英濟,52,27,25,元大-蘆洲,2024-03-25,9857
4526,東台,51,26,25,元大-蘆洲,2024-03-25,9857
00915,凱基優選高股息30,38,14,24,元大-蘆洲,2024-03-25,9857
3058,立德,23,0,23,元大-蘆洲,2024-03-25,9857
5608,四維航,21,0,21,元大-蘆洲,2024-03-25,9857
2887,台新金,24,3,21,元大-蘆洲,2024-03-25,9857
00712,復華富時不動產,20,0,20,元大-蘆洲,2024-03-25,9857
0056,元大高股息,38,18,20,元大-蘆洲,2024-03-25,9857
9105,泰金寶-DR,19,0,19,元大-蘆洲,2024-03-25,9857
00688L,國泰20年美債正2,22,3,19,元大-蘆洲,2024-03-25,9857
3704,合勤控,28,10,18,元大-蘆洲,2024-03-25,9857
2383,台光電,20,3,17,元大-蘆洲,2024-03-25,9857
1314,中石化,20,4,16,元大-蘆洲,2024-03-25,9857
6005,群益證,26,10,16,元大-蘆洲,2024-03-25,9857
2881,富邦金,16,0,16,元大-蘆洲,2024-03-25,9857
2027,大成鋼,17,1,16,元大-蘆洲,2024-03-25,9857
3005,神基,26,11,15,元大-蘆洲,2024-03-25,9857
4939,亞電,57,42,15,元大-蘆洲,2024-03-25,9857
2371,大同,585,258,327,元大-蘆洲,2024-03-26,9857
00795B,中信美國公債20年,321,0,321,元大-蘆洲,2024-03-26,9857
00722B,群益投資級電信債,200,1,199,元大-蘆洲,2024-03-26,9857
3372,典範,197,1,196,元大-蘆洲,2024-03-26,9857
00939,統一台灣高息動能,328,140,188,元大-蘆洲,2024-03-26,9857
00687B,國泰20年美債,149,0,149,元大-蘆洲,2024-03-26,9857
00937B,群益ESG投等債20,169,45,124,元大-蘆洲,2024-03-26,9857
6197,佳必琪,131,8,123,元大-蘆洲,2024-03-26,9857
00941,中信上游半導體,163,46,117,元大-蘆洲,2024-03-26,9857
2603,長榮,127,21,106,元大-蘆洲,2024-03-26,9857
00887,永豐中國科技50大,94,0,94,元大-蘆洲,2024-03-26,9857
2344,華邦電,129,36,93,元大-蘆洲,2024-03-26,9857
4979,華星光,126,36,90,元大-蘆洲,2024-03-26,9857
3231,緯創,129,53,76,元大-蘆洲,2024-03-26,9857
6125,廣運,133,72,61,元大-蘆洲,2024-03-26,9857
2609,陽明,87,36,51,元大-蘆洲,2024-03-26,9857
4714,永捷,54,16,38,元大-蘆洲,2024-03-26,9857
2618,長榮航,67,31,36,元大-蘆洲,2024-03-26,9857
1605,華新,100,64,36,元大-蘆洲,2024-03-26,9857
2539,櫻花建,30,0,30,元大-蘆洲,2024-03-26,9857
2303,聯電,103,73,30,元大-蘆洲,2024-03-26,9857
1785,光洋科,48,19,29,元大-蘆洲,2024-03-26,9857
2889,國票金,29,0,29,元大-蘆洲,2024-03-26,9857
6530,創威,50,21,29,元大-蘆洲,2024-03-26,9857
2356,英業達,159,130,29,元大-蘆洲,2024-03-26,9857
2329,華泰,77,49,28,元大-蘆洲,2024-03-26,9857
00680L,元大美債20正2,25,0,25,元大-蘆洲,2024-03-26,9857
2211,長榮鋼,26,1,25,元大-蘆洲,2024-03-26,9857
6290,良維,32,7,25,元大-蘆洲,2024-03-26,9857
1529,樂事綠能,32,7,25,元大-蘆洲,2024-03-26,9857
5498,凱崴,45,20,25,元大-蘆洲,2024-03-26,9857
2317,鴻海,135,110,25,元大-蘆洲,2024-03-26,9857
2801,彰銀,25,1,24,元大-蘆洲,2024-03-26,9857
00915,凱基優選高股息30,47,24,23,元大-蘆洲,2024-03-26,9857
00900,富邦特選高股息30,27,5,22,元大-蘆洲,2024-03-26,9857
3694,海華,29,7,22,元大-蘆洲,2024-03-26,9857
00679B,元大美債20年,29,7,22,元大-蘆洲,2024-03-26,9857
6139,亞翔,80,59,21,元大-蘆洲,2024-03-26,9857
0056,元大高股息,57,35,22,元大-蘆洲,2024-03-26,9857
3406,玉晶光,26,5,21,元大-蘆洲,2024-03-26,9857
00933B,國泰10Y+金融債,31,11,20,元大-蘆洲,2024-03-26,9857
1718,中纖,20,0,20,元大-蘆洲,2024-03-26,9857
2610,華航,20,1,19,元大-蘆洲,2024-03-26,9857
1616,億泰,48,29,19,元大-蘆洲,2024-03-26,9857
00878,國泰永續高股息,66,47,19,元大-蘆洲,2024-03-26,9857
00891,中信關鍵半導體,44,25,19,元大-蘆洲,2024-03-26,9857
2417,圓剛,51,33,18,元大-蘆洲,2024-03-26,9857
3062,建漢,25,7,18,元大-蘆洲,2024-03-26,9857
00904,新光臺灣半導體30,21,3,18,元大-蘆洲,2024-03-26,9857
00720B,元大投資級公司債,28,10,18,元大-蘆洲,2024-03-26,9857
1609,大亞,339,98,241,元大-蘆洲,2024-03-27,9857
1608,華榮,340,110,230,元大-蘆洲,2024-03-27,9857
00937B,群益ESG投等債20,237,18,219,元大-蘆洲,2024-03-27,9857
00929,復華台灣科技優息,263,120,143,元大-蘆洲,2024-03-27,9857
00939,統一台灣高息動能,117,17,100,元大-蘆洲,2024-03-27,9857
00679B,元大美債20年,119,25,94,元大-蘆洲,2024-03-27,9857
2511,太子,84,0,84,元大-蘆洲,2024-03-27,9857
1605,華新,109,27,82,元大-蘆洲,2024-03-27,9857
00919,群益台灣精選高息,134,56,78,元大-蘆洲,2024-03-27,9857
2301,光寶科,77,8,69,元大-蘆洲,2024-03-27,9857
4714,永捷,74,5,69,元大-蘆洲,2024-03-27,9857
6274,台燿,121,57,64,元大-蘆洲,2024-03-27,9857
1513,中興電,146,96,50,元大-蘆洲,2024-03-27,9857
00941,中信上游半導體,45,2,43,元大-蘆洲,2024-03-27,9857
1584,精剛,48,5,43,元大-蘆洲,2024-03-27,9857
8215,明基材,40,0,40,元大-蘆洲,2024-03-27,9857
2365,昆盈,52,13,39,元大-蘆洲,2024-03-27,9857
1710,東聯,40,2,38,元大-蘆洲,2024-03-27,9857
4526,東台,155,120,35,元大-蘆洲,2024-03-27,9857
2344,華邦電,35,3,32,元大-蘆洲,2024-03-27,9857
4908,前鼎,31,0,31,元大-蘆洲,2024-03-27,9857
00632R,元大台灣50反1,30,0,30,元大-蘆洲,2024-03-27,9857
2376,技嘉,36,7,29,元大-蘆洲,2024-03-27,9857
6005,群益證,33,4,29,元大-蘆洲,2024-03-27,9857
6770,力積電,41,13,28,元大-蘆洲,2024-03-27,9857
2603,長榮,59,31,28,元大-蘆洲,2024-03-27,9857
5515,建國,40,13,27,元大-蘆洲,2024-03-27,9857
1603,華電,132,106,26,元大-蘆洲,2024-03-27,9857
1714,和桐,26,0,26,元大-蘆洲,2024-03-27,9857
3380,明泰,23,0,23,元大-蘆洲,2024-03-27,9857
2303,聯電,71,49,22,元大-蘆洲,2024-03-27,9857
5880,合庫金,21,0,21,元大-蘆洲,2024-03-27,9857
3581,博磊,20,0,20,元大-蘆洲,2024-03-27,9857
2367,燿華,89,70,19,元大-蘆洲,2024-03-27,9857
2363,矽統,30,11,19,元大-蘆洲,2024-03-27,9857
6120,達運,20,1,19,元大-蘆洲,2024-03-27,9857
4979,華星光,65,47,18,元大-蘆洲,2024-03-27,9857
2486,一詮,32,14,18,元大-蘆洲,2024-03-27,9857
1597,直得,23,5,18,元大-蘆洲,2024-03-27,9857
3013,晟銘電,36,18,18,元大-蘆洲,2024-03-27,9857
3706,神達,134,117,17,元大-蘆洲,2024-03-27,9857
5351,鈺創,37,20,17,元大-蘆洲,2024-03-27,9857
3305,昇貿,17,0,17,元大-蘆洲,2024-03-27,9857
1540,喬福,17,0,17,元大-蘆洲,2024-03-27,9857
2601,益航,18,1,17,元大-蘆洲,2024-03-27,9857
6191,精成科,22,6,16,元大-蘆洲,2024-03-27,9857
2913,農林,19,4,15,元大-蘆洲,2024-03-27,9857
6166,凌華,20,5,15,元大-蘆洲,2024-03-27,9857
6104,創惟,17,2,15,元大-蘆洲,2024-03-27,9857
1808,潤隆,26,11,15,元大-蘆洲,2024-03-27,9857
2314,台揚,656,26,630,元大-蘆洲,2024-03-28,9857
2836,高雄銀,400,0,400,元大-蘆洲,2024-03-28,9857
00937B,群益ESG投等債20,348,17,331,元大-蘆洲,2024-03-28,9857
2883,凱基金,266,39,227,元大-蘆洲,2024-03-28,9857
4958,臻鼎-KY,237,33,204,元大-蘆洲,2024-03-28,9857
3707,漢磊,149,12,137,元大-蘆洲,2024-03-28,9857
00637L,元大滬深300正2,485,373,112,元大-蘆洲,2024-03-28,9857
3706,神達,150,56,94,元大-蘆洲,2024-03-28,9857
00941,中信上游半導體,102,11,91,元大-蘆洲,2024-03-28,9857
00939,統一台灣高息動能,112,37,75,元大-蘆洲,2024-03-28,9857
2408,南亞科,79,8,71,元大-蘆洲,2024-03-28,9857
00919,群益台灣精選高息,213,156,57,元大-蘆洲,2024-03-28,9857
2880,華南金,58,11,47,元大-蘆洲,2024-03-28,9857
2603,長榮,98,58,40,元大-蘆洲,2024-03-28,9857
00882,中信中國高股息,35,0,35,元大-蘆洲,2024-03-28,9857
2303,聯電,109,75,34,元大-蘆洲,2024-03-28,9857
1608,華榮,127,95,32,元大-蘆洲,2024-03-28,9857
00632R,元大台灣50反1,31,0,31,元大-蘆洲,2024-03-28,9857
5880,合庫金,30,0,30,元大-蘆洲,2024-03-28,9857
8105,凌巨,30,0,30,元大-蘆洲,2024-03-28,9857
2601,益航,30,0,30,元大-蘆洲,2024-03-28,9857
2882,國泰金,30,0,30,元大-蘆洲,2024-03-28,9857
5381,合正,30,0,30,元大-蘆洲,2024-03-28,9857
8011,台通,30,3,27,元大-蘆洲,2024-03-28,9857
3260,威剛,34,8,26,元大-蘆洲,2024-03-28,9857
3005,神基,34,9,25,元大-蘆洲,2024-03-28,9857
2301,光寶科,47,22,25,元大-蘆洲,2024-03-28,9857
2515,中工,38,14,24,元大-蘆洲,2024-03-28,9857
00720B,元大投資級公司債,24,0,24,元大-蘆洲,2024-03-28,9857
3512,皇龍,25,1,24,元大-蘆洲,2024-03-28,9857
8936,國統,61,37,24,元大-蘆洲,2024-03-28,9857
9945,潤泰新,26,2,24,元大-蘆洲,2024-03-28,9857
2337,旺宏,25,2,23,元大-蘆洲,2024-03-28,9857
4915,致伸,29,6,23,元大-蘆洲,2024-03-28,9857
2049,上銀,35,13,22,元大-蘆洲,2024-03-28,9857
2038,海光,21,0,21,元大-蘆洲,2024-03-28,9857
6182,合晶,25,5,20,元大-蘆洲,2024-03-28,9857
2801,彰銀,20,0,20,元大-蘆洲,2024-03-28,9857
2464,盟立,45,25,20,元大-蘆洲,2024-03-28,9857
1584,精剛,27,7,20,元大-蘆洲,2024-03-28,9857
4303,信立,40,20,20,元大-蘆洲,2024-03-28,9857
1582,信錦,33,14,19,元大-蘆洲,2024-03-28,9857
6770,力積電,44,26,18,元大-蘆洲,2024-03-28,9857
2062,橋椿,18,0,18,元大-蘆洲,2024-03-28,9857
2884,玉山金,18,1,17,元大-蘆洲,2024-03-28,9857
5243,乙盛-KY,37,20,17,元大-蘆洲,2024-03-28,9857
1316,上曜,36,19,17,元大-蘆洲,2024-03-28,9857
5388,中磊,21,4,17,元大-蘆洲,2024-03-28,9857
6005,群益證,18,1,17,元大-蘆洲,2024-03-28,9857
6695,芯鼎,31,14,17,元大-蘆洲,2024-03-28,9857
00937B,群益ESG投等債20,328,33,295,元大-蘆洲,2024-03-29,9857
2314,台揚,194,4,190,元大-蘆洲,2024-03-29,9857
00637L,元大滬深300正2,204,75,129,元大-蘆洲,2024-03-29,9857
2324,仁寶,115,7,108,元大-蘆洲,2024-03-29,9857
2888,新光金,112,29,83,元大-蘆洲,2024-03-29,9857
3037,欣興,96,21,75,元大-蘆洲,2024-03-29,9857
2303,聯電,203,136,67,元大-蘆洲,2024-03-29,9857
00632R,元大台灣50反1,54,0,54,元大-蘆洲,2024-03-29,9857
2301,光寶科,82,32,50,元大-蘆洲,2024-03-29,9857
3062,建漢,119,73,46,元大-蘆洲,2024-03-29,9857
1513,中興電,71,27,44,元大-蘆洲,2024-03-29,9857
6126,信音,117,76,41,元大-蘆洲,2024-03-29,9857
2542,興富發,41,1,40,元大-蘆洲,2024-03-29,9857
00679B,元大美債20年,64,29,35,元大-蘆洲,2024-03-29,9857
3706,神達,67,35,32,元大-蘆洲,2024-03-29,9857
4526,東台,90,59,31,元大-蘆洲,2024-03-29,9857
1608,華榮,42,11,31,元大-蘆洲,2024-03-29,9857
6456,GIS-KY,30,0,30,元大-蘆洲,2024-03-29,9857
2371,大同,131,101,30,元大-蘆洲,2024-03-29,9857
2354,鴻準,69,40,29,元大-蘆洲,2024-03-29,9857
00687B,國泰20年美債,32,7,25,元大-蘆洲,2024-03-29,9857
3702,大聯大,32,7,25,元大-蘆洲,2024-03-29,9857
2636,台驊控股,25,1,24,元大-蘆洲,2024-03-29,9857
8033,雷虎,30,7,23,元大-蘆洲,2024-03-29,9857
1582,信錦,36,14,22,元大-蘆洲,2024-03-29,9857
1785,光洋科,118,97,21,元大-蘆洲,2024-03-29,9857
2317,鴻海,162,141,21,元大-蘆洲,2024-03-29,9857
2329,華泰,44,23,21,元大-蘆洲,2024-03-29,9857
2402,毅嘉,25,5,20,元大-蘆洲,2024-03-29,9857
5426,振發,26,6,20,元大-蘆洲,2024-03-29,9857
2328,廣宇,41,21,20,元大-蘆洲,2024-03-29,9857
2363,矽統,21,2,19,元大-蘆洲,2024-03-29,9857
3013,晟銘電,87,68,19,元大-蘆洲,2024-03-29,9857
2368,金像電,22,4,18,元大-蘆洲,2024-03-29,9857
4303,信立,28,11,17,元大-蘆洲,2024-03-29,9857
3305,昇貿,16,0,16,元大-蘆洲,2024-03-29,9857
2889,國票金,24,8,16,元大-蘆洲,2024-03-29,9857
6285,啟��,63,47,16,元大-蘆洲,2024-03-29,9857
8054,安國,54,39,15,元大-蘆洲,2024-03-29,9857
3163,波若威,17,2,15,元大-蘆洲,2024-03-29,9857
5386,青雲,21,6,15,元大-蘆洲,2024-03-29,9857
1710,東聯,15,0,15,元大-蘆洲,2024-03-29,9857
00720B,元大投資級公司債,15,0,15,元大-蘆洲,2024-03-29,9857
3704,合勤控,17,2,15,元大-蘆洲,2024-03-29,9857
6125,廣運,29,15,14,元大-蘆洲,2024-03-29,9857
1584,精剛,13,0,13,元大-蘆洲,2024-03-29,9857
5608,四維航,13,1,12,元大-蘆洲,2024-03-29,9857
2369,菱生,21,9,12,元大-蘆洲,2024-03-29,9857
1540,喬福,12,0,12,元大-蘆洲,2024-03-29,9857
3024,憶聲,12,0,12,元大-蘆洲,2024-03-29,9857
00940,元大台灣價值高息,3504,1174,2330,元大-蘆洲,2024-04-01,9857
1785,光洋科,234,0,234,元大-蘆洲,2024-04-01,9857
00929,復華台灣科技優息,143,18,125,元大-蘆洲,2024-04-01,9857
3707,漢磊,122,17,105,元大-蘆洲,2024-04-01,9857
00937B,群益ESG投等債20,120,16,104,元大-蘆洲,2024-04-01,9857
00919,群益台灣精選高息,141,48,93,元大-蘆洲,2024-04-01,9857
3231,緯創,130,55,75,元大-蘆洲,2024-04-01,9857
00939,統一台灣高息動能,110,41,69,元大-蘆洲,2024-04-01,9857
1582,信錦,66,8,58,元大-蘆洲,2024-04-01,9857
2834,臺企銀,94,39,55,元大-蘆洲,2024-04-01,9857
1815,富喬,101,46,55,元大-蘆洲,2024-04-01,9857
9105,泰金寶-DR,50,0,50,元大-蘆洲,2024-04-01,9857
00673R,期元大S＆P原油反1,50,5,45,元大-蘆洲,2024-04-01,9857
1513,中興電,116,73,43,元大-蘆洲,2024-04-01,9857
00679B,元大美債20年,62,21,41,元大-蘆洲,2024-04-01,9857
2382,廣達,91,51,40,元大-蘆洲,2024-04-01,9857
3013,晟銘電,104,64,40,元大-蘆洲,2024-04-01,9857
2356,英業達,125,86,39,元大-蘆洲,2024-04-01,9857
2603,長榮,72,33,39,元大-蘆洲,2024-04-01,9857
0056,元大高股息,70,33,37,元大-蘆洲,2024-04-01,9857
2402,毅嘉,50,18,32,元大-蘆洲,2024-04-01,9857
6743,安普新,31,0,31,元大-蘆洲,2024-04-01,9857
6139,亞翔,120,90,30,元大-蘆洲,2024-04-01,9857
6462,神盾,59,30,29,元大-蘆洲,2024-04-01,9857
2388,威盛,41,12,29,元大-蘆洲,2024-04-01,9857
2891,中信金,49,21,28,元大-蘆洲,2024-04-01,9857
8255,朋程,30,2,28,元大-蘆洲,2024-04-01,9857
00927,群益半導體收益,22,0,22,元大-蘆洲,2024-04-01,9857
2352,佳世達,26,4,22,元大-蘆洲,2024-04-01,9857
2328,廣宇,39,18,21,元大-蘆洲,2024-04-01,9857
1540,喬福,20,0,20,元大-蘆洲,2024-04-01,9857
2368,金像電,22,2,20,元大-蘆洲,2024-04-01,9857
3006,晶豪科,20,0,20,元大-蘆洲,2024-04-01,9857
1101,台泥,21,1,20,元大-蘆洲,2024-04-01,9857
00923,群益台ESG低碳50,19,0,19,元大-蘆洲,2024-04-01,9857
3058,立德,26,7,19,元大-蘆洲,2024-04-01,9857
1504,東元,34,16,18,元大-蘆洲,2024-04-01,9857
3037,欣興,23,5,18,元大-蘆洲,2024-04-01,9857
00878,國泰永續高股息,29,12,17,元大-蘆洲,2024-04-01,9857
00720B,元大投資級公司債,16,0,16,元大-蘆洲,2024-04-01,9857
2301,光寶科,20,4,16,元大-蘆洲,2024-04-01,9857
1409,新纖,15,0,15,元大-蘆洲,2024-04-01,9857
2313,華通,21,6,15,元大-蘆洲,2024-04-01,9857
3032,偉訓,32,18,14,元大-蘆洲,2024-04-01,9857
2501,國建,18,4,14,元大-蘆洲,2024-04-01,9857
3380,明泰,24,10,14,元大-蘆洲,2024-04-01,9857
2610,華航,13,0,13,元大-蘆洲,2024-04-01,9857
4938,和碩,15,2,13,元大-蘆洲,2024-04-01,9857
3042,晶技,17,4,13,元大-蘆洲,2024-04-01,9857
2867,三商壽,13,0,13,元大-蘆洲,2024-04-01,9857
00929,復華台灣科技優息,537,30,507,元大-蘆洲,2024-04-02,9857
00940,元大台灣價值高息,933,522,411,元大-蘆洲,2024-04-02,9857
00937B,群益ESG投等債20,286,0,286,元大-蘆洲,2024-04-02,9857
2467,志聖,177,3,174,元大-蘆洲,2024-04-02,9857
3376,新日興,132,3,129,元大-蘆洲,2024-04-02,9857
2888,新光金,270,143,127,元大-蘆洲,2024-04-02,9857
00679B,元大美債20年,119,1,118,元大-蘆洲,2024-04-02,9857
00632R,元大台灣50反1,127,20,107,元大-蘆洲,2024-04-02,9857
2883,凱基金,106,1,105,元大-蘆洲,2024-04-02,9857
3041,揚智,100,0,100,元大-蘆洲,2024-04-02,9857
00687B,國泰20年美債,164,66,98,元大-蘆洲,2024-04-02,9857
00680L,元大美債20正2,130,38,92,元大-蘆洲,2024-04-02,9857
2603,長榮,111,47,64,元大-蘆洲,2024-04-02,9857
2371,大同,125,69,56,元大-蘆洲,2024-04-02,9857
9105,泰金寶-DR,51,0,51,元大-蘆洲,2024-04-02,9857
2301,光寶科,69,21,48,元大-蘆洲,2024-04-02,9857
00637L,元大滬深300正2,162,120,42,元大-蘆洲,2024-04-02,9857
6026,福邦證,40,0,40,元大-蘆洲,2024-04-02,9857
00720B,元大投資級公司債,39,0,39,元大-蘆洲,2024-04-02,9857
00931B,統一美債20年,39,0,39,元大-蘆洲,2024-04-02,9857
00919,群益台灣精選高息,119,80,39,元大-蘆洲,2024-04-02,9857
00941,中信上游半導體,54,16,38,元大-蘆洲,2024-04-02,9857
6202,盛群,54,17,37,元大-蘆洲,2024-04-02,9857
00939,統一台灣高息動能,41,5,36,元大-蘆洲,2024-04-02,9857
1785,光洋科,81,46,35,元大-蘆洲,2024-04-02,9857
0056,元大高股息,56,22,34,元大-蘆洲,2024-04-02,9857
2344,華邦電,40,7,33,元大-蘆洲,2024-04-02,9857
00933B,國泰10Y+金融債,32,0,32,元大-蘆洲,2024-04-02,9857
00650L,復華香港正2,30,0,30,元大-蘆洲,2024-04-02,9857
2417,圓剛,42,14,28,元大-蘆洲,2024-04-02,9857
2303,聯電,108,82,26,元大-蘆洲,2024-04-02,9857
3017,奇鋐,41,16,25,元大-蘆洲,2024-04-02,9857
2356,英業達,45,21,24,元大-蘆洲,2024-04-02,9857
3062,建漢,29,5,24,元大-蘆洲,2024-04-02,9857
8255,朋程,24,0,24,元大-蘆洲,2024-04-02,9857
1605,華新,36,13,23,元大-蘆洲,2024-04-02,9857
3706,神達,45,22,23,元大-蘆洲,2024-04-02,9857
2365,昆盈,30,8,22,元大-蘆洲,2024-04-02,9857
2834,臺企銀,22,1,21,元大-蘆洲,2024-04-02,9857
00751B,元大AAA至A公司債,19,0,19,元大-蘆洲,2024-04-02,9857
00725B,國泰投資級公司債,19,0,19,元大-蘆洲,2024-04-02,9857
9946,三發地產,20,1,19,元大-蘆洲,2024-04-02,9857
2369,菱生,34,15,19,元大-蘆洲,2024-04-02,9857
8033,雷虎,30,11,19,元大-蘆洲,2024-04-02,9857
1305,華夏,17,0,17,元大-蘆洲,2024-04-02,9857
6120,達運,33,16,17,元大-蘆洲,2024-04-02,9857
6126,信音,34,17,17,元大-蘆洲,2024-04-02,9857
6282,康舒,16,0,16,元大-蘆洲,2024-04-02,9857
2328,廣宇,28,12,16,元大-蘆洲,2024-04-02,9857
5521,工信,19,3,16,元大-蘆洲,2024-04-02,9857
00929,復華台灣科技優息,735,10,725,元大-蘆洲,2024-04-03,9857
00940,元大台灣價值高息,627,89,538,元大-蘆洲,2024-04-03,9857
3481,群創,193,25,168,元大-蘆洲,2024-04-03,9857
00679B,元大美債20年,164,20,144,元大-蘆洲,2024-04-03,9857
00687B,國泰20年美債,145,2,143,元大-蘆洲,2024-04-03,9857
00937B,群益ESG投等債20,121,0,121,元大-蘆洲,2024-04-03,9857
00680L,元大美債20正2,114,0,114,元大-蘆洲,2024-04-03,9857
2603,長榮,92,16,76,元大-蘆洲,2024-04-03,9857
8064,東捷,121,50,71,元大-蘆洲,2024-04-03,9857
2301,光寶科,96,34,62,元大-蘆洲,2024-04-03,9857
00673R,期元大S＆P原油反1,55,0,55,元大-蘆洲,2024-04-03,9857
0056,元大高股息,59,7,52,元大-蘆洲,2024-04-03,9857
2303,聯電,67,16,51,元大-蘆洲,2024-04-03,9857
2344,華邦電,53,4,49,元大-蘆洲,2024-04-03,9857
2002,中鋼,59,15,44,元大-蘆洲,2024-04-03,9857
1609,大亞,72,29,43,元大-蘆洲,2024-04-03,9857
2892,第一金,42,1,41,元大-蘆洲,2024-04-03,9857
3037,欣興,40,0,40,元大-蘆洲,2024-04-03,9857
00927,群益半導體收益,37,0,37,元大-蘆洲,2024-04-03,9857
2887,台新金,39,2,37,元大-蘆洲,2024-04-03,9857
8215,明基材,35,0,35,元大-蘆洲,2024-04-03,9857
6026,福邦證,35,0,35,元大-蘆洲,2024-04-03,9857
00688L,國泰20年美債正2,30,0,30,元大-蘆洲,2024-04-03,9857
2009,第一銅,64,34,30,元大-蘆洲,2024-04-03,9857
00795B,中信美國公債20年,29,0,29,元大-蘆洲,2024-04-03,9857
00939,統一台灣高息動能,38,9,29,元大-蘆洲,2024-04-03,9857
2330,台積電,31,2,29,元大-蘆洲,2024-04-03,9857
2609,陽明,43,15,28,元大-蘆洲,2024-04-03,9857
5864,致和證,30,3,27,元大-蘆洲,2024-04-03,9857
00941,中信上游半導體,48,22,26,元大-蘆洲,2024-04-03,9857
3380,明泰,26,0,26,元大-蘆洲,2024-04-03,9857
00933B,國泰10Y+金融債,28,2,26,元大-蘆洲,2024-04-03,9857
6139,亞翔,58,33,25,元大-蘆洲,2024-04-03,9857
9945,潤泰新,25,0,25,元大-蘆洲,2024-04-03,9857
6189,豐藝,56,32,24,元大-蘆洲,2024-04-03,9857
6743,安普新,23,0,23,元大-蘆洲,2024-04-03,9857
2884,玉山金,28,5,23,元大-蘆洲,2024-04-03,9857
6770,力積電,24,2,22,元大-蘆洲,2024-04-03,9857
2885,元大金,23,1,22,元大-蘆洲,2024-04-03,9857
2317,鴻海,104,82,22,元大-蘆洲,2024-04-03,9857
2408,南亞科,27,6,21,元大-蘆洲,2024-04-03,9857
8996,高力,25,4,21,元大-蘆洲,2024-04-03,9857
2601,益航,21,0,21,元大-蘆洲,2024-04-03,9857
2382,廣達,56,36,20,元大-蘆洲,2024-04-03,9857
2486,一詮,273,253,20,元大-蘆洲,2024-04-03,9857
1802,台玻,32,12,20,元大-蘆洲,2024-04-03,9857
2409,友達,26,6,20,元大-蘆洲,2024-04-03,9857
2354,鴻準,72,53,19,元大-蘆洲,2024-04-03,9857
3545,敦泰,20,1,19,元大-蘆洲,2024-04-03,9857
1731,美吾華,18,0,18,元大-蘆洲,2024-04-03,9857
00764B,群益25年美債,857,0,857,元大-蘆洲,2024-04-08,9857
00720B,元大投資級公司債,481,0,481,元大-蘆洲,2024-04-08,9857
00929,復華台灣科技優息,446,20,426,元大-蘆洲,2024-04-08,9857
00687B,國泰20年美債,232,8,224,元大-蘆洲,2024-04-08,9857
00679B,元大美債20年,228,28,200,元大-蘆洲,2024-04-08,9857
2371,大同,219,32,187,元大-蘆洲,2024-04-08,9857
00680L,元大美債20正2,145,19,126,元大-蘆洲,2024-04-08,9857
00637L,元大滬深300正2,164,50,114,元大-蘆洲,2024-04-08,9857
00919,群益台灣精選高息,120,25,95,元大-蘆洲,2024-04-08,9857
3548,兆利,106,19,87,元大-蘆洲,2024-04-08,9857
6274,台燿,102,32,70,元大-蘆洲,2024-04-08,9857
2356,英業達,83,15,68,元大-蘆洲,2024-04-08,9857
00937B,群益ESG投等債20,246,185,61,元大-蘆洲,2024-04-08,9857
2324,仁寶,62,3,59,元大-蘆洲,2024-04-08,9857
1710,東聯,50,0,50,元大-蘆洲,2024-04-08,9857
2342,茂矽,50,0,50,元大-蘆洲,2024-04-08,9857
6120,達運,64,14,50,元大-蘆洲,2024-04-08,9857
9940,信義,50,0,50,元大-蘆洲,2024-04-08,9857
00933B,國泰10Y+金融債,60,13,47,元大-蘆洲,2024-04-08,9857
1618,合機,60,15,45,元大-蘆洲,2024-04-08,9857
00941,中信上游半導體,44,0,44,元大-蘆洲,2024-04-08,9857
0056,元大高股息,50,6,44,元大-蘆洲,2024-04-08,9857
1785,光洋科,120,79,41,元大-蘆洲,2024-04-08,9857
1609,大亞,90,51,39,元大-蘆洲,2024-04-08,9857
8096,擎亞,49,16,33,元大-蘆洲,2024-04-08,9857
00688L,國泰20年美債正2,32,0,32,元大-蘆洲,2024-04-08,9857
00751B,元大AAA至A公司債,31,0,31,元大-蘆洲,2024-04-08,9857
2511,太子,31,0,31,元大-蘆洲,2024-04-08,9857
2352,佳世達,46,16,30,元大-蘆洲,2024-04-08,9857
3062,建漢,31,1,30,元大-蘆洲,2024-04-08,9857
1582,信錦,32,2,30,元大-蘆洲,2024-04-08,9857
00927,群益半導體收益,28,1,27,元大-蘆洲,2024-04-08,9857
8255,朋程,27,0,27,元大-蘆洲,2024-04-08,9857
00632R,元大台灣50反1,151,125,26,元大-蘆洲,2024-04-08,9857
8033,雷虎,35,9,26,元大-蘆洲,2024-04-08,9857
2618,長榮航,92,67,25,元大-蘆洲,2024-04-08,9857
6189,豐藝,48,25,23,元大-蘆洲,2024-04-08,9857
2607,榮運,23,0,23,元大-蘆洲,2024-04-08,9857
3715,定穎投控,35,12,23,元大-蘆洲,2024-04-08,9857
6425,易發,27,5,22,元大-蘆洲,2024-04-08,9857
1529,樂事綠能,22,1,21,元大-蘆洲,2024-04-08,9857
00931B,統一美債20年,21,0,21,元大-蘆洲,2024-04-08,9857
2375,凱美,21,0,21,元大-蘆洲,2024-04-08,9857
00795B,中信美國公債20年,20,0,20,元大-蘆洲,2024-04-08,9857
1324,地球,20,0,20,元大-蘆洲,2024-04-08,9857
2514,龍邦,20,0,20,元大-蘆洲,2024-04-08,9857
6234,高僑,20,0,20,元大-蘆洲,2024-04-08,9857
00902,中信電池及儲能,20,0,20,元大-蘆洲,2024-04-08,9857
4714,永捷,24,5,19,元大-蘆洲,2024-04-08,9857
00885,富邦越南,18,0,18,元大-蘆洲,2024-04-08,9857
00929,復華台灣科技優息,234,2,232,元大-蘆洲,2024-04-09,9857
3231,緯創,401,171,230,元大-蘆洲,2024-04-09,9857
1608,華榮,282,91,191,元大-蘆洲,2024-04-09,9857
00937B,群益ESG投等債20,232,50,182,元大-蘆洲,2024-04-09,9857
1314,中石化,156,26,130,元大-蘆洲,2024-04-09,9857
00687B,國泰20年美債,124,4,120,元大-蘆洲,2024-04-09,9857
00650L,復華香港正2,100,0,100,元大-蘆洲,2024-04-09,9857
6116,彩晶,101,25,76,元大-蘆洲,2024-04-09,9857
00637L,元大滬深300正2,69,10,59,元大-蘆洲,2024-04-09,9857
1513,中興電,223,165,58,元大-蘆洲,2024-04-09,9857
6189,豐藝,114,63,51,元大-蘆洲,2024-04-09,9857
00679B,元大美債20年,80,33,47,元大-蘆洲,2024-04-09,9857
6274,台燿,93,45,48,元大-蘆洲,2024-04-09,9857
9940,信義,45,0,45,元大-蘆洲,2024-04-09,9857
00720B,元大投資級公司債,43,0,43,元大-蘆洲,2024-04-09,9857
2356,英業達,76,35,41,元大-蘆洲,2024-04-09,9857
6456,GIS-KY,51,10,41,元大-蘆洲,2024-04-09,9857
2609,陽明,77,38,39,元大-蘆洲,2024-04-09,9857
1522,堤維西,42,4,38,元大-蘆洲,2024-04-09,9857
2314,台揚,38,0,38,元大-蘆洲,2024-04-09,9857
2501,國建,80,43,37,元大-蘆洲,2024-04-09,9857
00941,中信上游半導體,39,2,37,元大-蘆洲,2024-04-09,9857
00939,統一台灣高息動能,34,0,34,元大-蘆洲,2024-04-09,9857
3052,夆典,32,0,32,元大-蘆洲,2024-04-09,9857
4303,信立,45,14,31,元大-蘆洲,2024-04-09,9857
2539,櫻花建,35,5,30,元大-蘆洲,2024-04-09,9857
2382,廣達,49,20,29,元大-蘆洲,2024-04-09,9857
2025,千興,37,8,29,元大-蘆洲,2024-04-09,9857
1785,光洋科,59,32,27,元大-蘆洲,2024-04-09,9857
3360,尚立,33,7,26,元大-蘆洲,2024-04-09,9857
6207,雷科,35,9,26,元大-蘆洲,2024-04-09,9857
4306,炎洲,33,9,24,元大-蘆洲,2024-04-09,9857
6578,達邦蛋白,31,9,22,元大-蘆洲,2024-04-09,9857
4973,廣穎,25,3,22,元大-蘆洲,2024-04-09,9857
2027,大成鋼,56,34,22,元大-蘆洲,2024-04-09,9857
2354,鴻準,41,19,22,元大-蘆洲,2024-04-09,9857
00764B,群益25年美債,21,0,21,元大-蘆洲,2024-04-09,9857
3376,新日興,21,1,20,元大-蘆洲,2024-04-09,9857
2601,益航,20,0,20,元大-蘆洲,2024-04-09,9857
00851,台新全球AI,20,0,20,元大-蘆洲,2024-04-09,9857
3060,銘異,22,2,20,元大-蘆洲,2024-04-09,9857
1540,喬福,20,0,20,元大-蘆洲,2024-04-09,9857
4714,永捷,30,11,19,元大-蘆洲,2024-04-09,9857
912000,晨訊科-DR,33,14,19,元大-蘆洲,2024-04-09,9857
00878,國泰永續高股息,51,32,19,元大-蘆洲,2024-04-09,9857
2329,華泰,49,31,18,元大-蘆洲,2024-04-09,9857
2464,盟立,67,49,18,元大-蘆洲,2024-04-09,9857
3706,神達,29,12,17,元大-蘆洲,2024-04-09,9857
5443,均豪,35,18,17,元大-蘆洲,2024-04-09,9857
6603,富強鑫,16,0,16,元大-蘆洲,2024-04-09,9857
2363,矽統,515,328,187,元大-蘆洲,2024-04-10,9857
2367,燿華,202,24,178,元大-蘆洲,2024-04-10,9857
2314,台揚,205,32,173,元大-蘆洲,2024-04-10,9857
1609,大亞,347,185,162,元大-蘆洲,2024-04-10,9857
00637L,元大滬深300正2,210,50,160,元大-蘆洲,2024-04-10,9857
2610,華航,124,4,120,元大-蘆洲,2024-04-10,9857
00937B,群益ESG投等債20,121,5,116,元大-蘆洲,2024-04-10,9857
3052,夆典,114,0,114,元大-蘆洲,2024-04-10,9857
6668,中揚光,98,12,86,元大-蘆洲,2024-04-10,9857
1514,亞力,331,253,78,元大-蘆洲,2024-04-10,9857
6770,力積電,103,25,78,元大-蘆洲,2024-04-10,9857
2316,楠梓電,74,3,71,元大-蘆洲,2024-04-10,9857
00680L,元大美債20正2,105,37,68,元大-蘆洲,2024-04-10,9857
2337,旺宏,66,2,64,元大-蘆洲,2024-04-10,9857
2329,華泰,220,158,62,元大-蘆洲,2024-04-10,9857
3576,聯合再生,66,6,60,元大-蘆洲,2024-04-10,9857
2371,大同,113,53,60,元大-蘆洲,2024-04-10,9857
00632R,元大台灣50反1,77,21,56,元大-蘆洲,2024-04-10,9857
00940,元大台灣價值高息,239,183,56,元大-蘆洲,2024-04-10,9857
00679B,元大美債20年,64,11,53,元大-蘆洲,2024-04-10,9857
2889,國票金,53,2,51,元大-蘆洲,2024-04-10,9857
00933B,國泰10Y+金融債,52,1,51,元大-蘆洲,2024-04-10,9857
00927,群益半導體收益,53,5,48,元大-蘆洲,2024-04-10,9857
2515,中工,121,73,48,元大-蘆洲,2024-04-10,9857
3694,海華,56,9,47,元大-蘆洲,2024-04-10,9857
1513,中興電,150,104,46,元大-蘆洲,2024-04-10,9857
6415,矽力*-KY,47,2,45,元大-蘆洲,2024-04-10,9857
6016,康和證,46,1,45,元大-蘆洲,2024-04-10,9857
2634,漢翔,79,35,44,元大-蘆洲,2024-04-10,9857
6188,廣明,46,5,41,元大-蘆洲,2024-04-10,9857
00929,復華台灣科技優息,158,116,42,元大-蘆洲,2024-04-10,9857
2206,三陽工業,41,0,41,元大-蘆洲,2024-04-10,9857
2464,盟立,101,62,39,元大-蘆洲,2024-04-10,9857
2486,一詮,48,13,35,元大-蘆洲,2024-04-10,9857
6213,聯茂,59,25,34,元大-蘆洲,2024-04-10,9857
2376,技嘉,56,23,33,元大-蘆洲,2024-04-10,9857
00881,國泰台灣5G+,37,4,33,元大-蘆洲,2024-04-10,9857
3481,群創,162,129,33,元大-蘆洲,2024-04-10,9857
2887,台新金,34,2,32,元大-蘆洲,2024-04-10,9857
1101,台泥,53,21,32,元大-蘆洲,2024-04-10,9857
2354,鴻準,40,9,31,元大-蘆洲,2024-04-10,9857
2408,南亞科,83,53,30,元大-蘆洲,2024-04-10,9857
2103,台橡,31,1,30,元大-蘆洲,2024-04-10,9857
4976,佳凌,30,0,30,元大-蘆洲,2024-04-10,9857
6274,台燿,37,7,30,元大-蘆洲,2024-04-10,9857
2374,佳能,49,19,30,元大-蘆洲,2024-04-10,9857
3706,神達,47,18,29,元大-蘆洲,2024-04-10,9857
2014,中鴻,79,50,29,元大-蘆洲,2024-04-10,9857
8478,東哥遊艇,28,0,28,元大-蘆洲,2024-04-10,9857
2884,玉山金,27,0,27,元大-蘆洲,2024-04-10,9857
00937B,群益ESG投等債20,706,48,658,元大-蘆洲,2024-04-11,9857
3481,群創,417,15,402,元大-蘆洲,2024-04-11,9857
00687B,國泰20年美債,400,9,391,元大-蘆洲,2024-04-11,9857
00632R,元大台灣50反1,474,166,308,元大-蘆洲,2024-04-11,9857
00712,復華富時不動產,311,9,302,元大-蘆洲,2024-04-11,9857
00929,復華台灣科技優息,218,21,197,元大-蘆洲,2024-04-11,9857
00679B,元大美債20年,219,26,193,元大-蘆洲,2024-04-11,9857
00940,元大台灣價值高息,255,94,161,元大-蘆洲,2024-04-11,9857
2303,聯電,172,36,136,元大-蘆洲,2024-04-11,9857
00680L,元大美債20正2,126,4,122,元大-蘆洲,2024-04-11,9857
00919,群益台灣精選高息,99,23,76,元大-蘆洲,2024-04-11,9857
00795B,中信美國公債20年,92,22,70,元大-蘆洲,2024-04-11,9857
3052,夆典,70,0,70,元大-蘆洲,2024-04-11,9857
3545,敦泰,67,0,67,元大-蘆洲,2024-04-11,9857
2308,台達電,90,23,67,元大-蘆洲,2024-04-11,9857
00922,國泰台灣領袖50,65,2,63,元大-蘆洲,2024-04-11,9857
00688L,國泰20年美債正2,63,0,63,元大-蘆洲,2024-04-11,9857
1605,華新,144,83,61,元大-蘆洲,2024-04-11,9857
00931B,統一美債20年,60,1,59,元大-蘆洲,2024-04-11,9857
6213,聯茂,62,4,58,元大-蘆洲,2024-04-11,9857
2501,國建,85,31,54,元大-蘆洲,2024-04-11,9857
6282,康舒,68,19,49,元大-蘆洲,2024-04-11,9857
2406,國碩,197,149,48,元大-蘆洲,2024-04-11,9857
00941,中信上游半導體,46,1,45,元大-蘆洲,2024-04-11,9857
1618,合機,56,13,43,元大-蘆洲,2024-04-11,9857
2409,友達,50,8,42,元大-蘆洲,2024-04-11,9857
3231,緯創,83,43,40,元大-蘆洲,2024-04-11,9857
4113,聯上,38,0,38,元大-蘆洲,2024-04-11,9857
3056,富華新,38,0,38,元大-蘆洲,2024-04-11,9857
2634,漢翔,53,17,36,元大-蘆洲,2024-04-11,9857
0056,元大高股息,38,4,34,元大-蘆洲,2024-04-11,9857
4976,佳凌,34,0,34,元大-蘆洲,2024-04-11,9857
3260,威剛,64,30,34,元大-蘆洲,2024-04-11,9857
00933B,國泰10Y+金融債,33,0,33,元大-蘆洲,2024-04-11,9857
00720B,元大投資級公司債,34,2,32,元大-蘆洲,2024-04-11,9857
00665L,富邦�琤肭磪囓�2,37,5,32,元大-蘆洲,2024-04-11,9857
4973,廣穎,38,6,32,元大-蘆洲,2024-04-11,9857
2014,中鴻,35,4,31,元大-蘆洲,2024-04-11,9857
6231,系微,31,0,31,元大-蘆洲,2024-04-11,9857
00751B,元大AAA至A公司債,30,0,30,元大-蘆洲,2024-04-11,9857
5425,台半,30,0,30,元大-蘆洲,2024-04-11,9857
2731,雄獅,34,4,30,元大-蘆洲,2024-04-11,9857
1785,光洋科,45,16,29,元大-蘆洲,2024-04-11,9857
3548,兆利,29,1,28,元大-蘆洲,2024-04-11,9857
2892,第一金,28,0,28,元大-蘆洲,2024-04-11,9857
00878,國泰永續高股息,34,7,27,元大-蘆洲,2024-04-11,9857
2332,友訊,65,39,26,元大-蘆洲,2024-04-11,9857
2354,鴻準,47,21,26,元大-蘆洲,2024-04-11,9857
3013,晟銘電,94,68,26,元大-蘆洲,2024-04-11,9857
2329,華泰,108,83,25,元大-蘆洲,2024-04-11,9857
2367,燿華,616,248,368,元大-蘆洲,2024-04-12,9857
2363,矽統,1053,789,264,元大-蘆洲,2024-04-12,9857
00929,復華台灣科技優息,263,31,232,元大-蘆洲,2024-04-12,9857
2353,宏��,356,134,222,元大-蘆洲,2024-04-12,9857
00937B,群益ESG投等債20,155,7,148,元大-蘆洲,2024-04-12,9857
3481,群創,209,115,94,元大-蘆洲,2024-04-12,9857
00687B,國泰20年美債,155,63,92,元大-蘆洲,2024-04-12,9857
00933B,國泰10Y+金融債,87,0,87,元大-蘆洲,2024-04-12,9857
00679B,元大美債20年,99,13,86,元大-蘆洲,2024-04-12,9857
2382,廣達,96,16,80,元大-蘆洲,2024-04-12,9857
00720B,元大投資級公司債,79,0,79,元大-蘆洲,2024-04-12,9857
3059,華晶科,84,11,73,元大-蘆洲,2024-04-12,9857
2009,第一銅,87,29,58,元大-蘆洲,2024-04-12,9857
00680L,元大美債20正2,58,1,57,元大-蘆洲,2024-04-12,9857
6016,康和證,45,0,45,元大-蘆洲,2024-04-12,9857
2401,凌陽,46,2,44,元大-蘆洲,2024-04-12,9857
2834,臺企銀,41,2,39,元大-蘆洲,2024-04-12,9857
3231,緯創,135,98,37,元大-蘆洲,2024-04-12,9857
2323,中環,40,3,37,元大-蘆洲,2024-04-12,9857
1314,中石化,39,3,36,元大-蘆洲,2024-04-12,9857
3354,律勝,37,3,34,元大-蘆洲,2024-04-12,9857
00712,復華富時不動產,39,5,34,元大-蘆洲,2024-04-12,9857
2618,長榮航,52,19,33,元大-蘆洲,2024-04-12,9857
00941,中信上游半導體,58,27,31,元大-蘆洲,2024-04-12,9857
2601,益航,36,5,31,元大-蘆洲,2024-04-12,9857
2409,友達,33,3,30,元大-蘆洲,2024-04-12,9857
3689,湧德,32,2,30,元大-蘆洲,2024-04-12,9857
4938,和碩,33,4,29,元大-蘆洲,2024-04-12,9857
3042,晶技,30,1,29,元大-蘆洲,2024-04-12,9857
00751B,元大AAA至A公司債,29,0,29,元大-蘆洲,2024-04-12,9857
2610,華航,83,56,27,元大-蘆洲,2024-04-12,9857
2615,萬海,35,9,26,元大-蘆洲,2024-04-12,9857
00878,國泰永續高股息,27,1,26,元大-蘆洲,2024-04-12,9857
00891,中信關鍵半導體,25,0,25,元大-蘆洲,2024-04-12,9857
1809,中釉,25,0,25,元大-蘆洲,2024-04-12,9857
1605,華新,115,91,24,元大-蘆洲,2024-04-12,9857
00918,大華優利高填息30,44,22,22,元大-蘆洲,2024-04-12,9857
2356,英業達,38,17,21,元大-蘆洲,2024-04-12,9857
8112,至上,36,15,21,元大-蘆洲,2024-04-12,9857
4402,郡都開發,20,0,20,元大-蘆洲,2024-04-12,9857
1815,富喬,39,19,20,元大-蘆洲,2024-04-12,9857
2609,陽明,28,10,18,元大-蘆洲,2024-04-12,9857
5426,振發,37,19,18,元大-蘆洲,2024-04-12,9857
2889,國票金,23,6,17,元大-蘆洲,2024-04-12,9857
3576,聯合再生,25,8,17,元大-蘆洲,2024-04-12,9857
2002,中鋼,23,6,17,元大-蘆洲,2024-04-12,9857
2855,統一證,17,0,17,元大-蘆洲,2024-04-12,9857
3663,鑫科,17,0,17,元大-蘆洲,2024-04-12,9857
2537,聯上發,34,17,17,元大-蘆洲,2024-04-12,9857
2888,新光金,35,18,17,元大-蘆洲,2024-04-12,9857
00937B,群益ESG投等債20,694,13,681,元大-蘆洲,2024-04-15,9857
00929,復華台灣科技優息,539,58,481,元大-蘆洲,2024-04-15,9857
2374,佳能,369,97,272,元大-蘆洲,2024-04-15,9857
00688L,國泰20年美債正2,260,20,240,元大-蘆洲,2024-04-15,9857
00940,元大台灣價值高息,405,174,231,元大-蘆洲,2024-04-15,9857
2303,聯電,265,50,215,元大-蘆洲,2024-04-15,9857
3312,弘憶股,317,105,212,元大-蘆洲,2024-04-15,9857
00878,國泰永續高股息,244,42,202,元大-蘆洲,2024-04-15,9857
1608,華榮,289,87,202,元大-蘆洲,2024-04-15,9857
0056,元大高股息,149,1,148,元大-蘆洲,2024-04-15,9857
1609,大亞,257,110,147,元大-蘆洲,2024-04-15,9857
00632R,元大台灣50反1,330,192,138,元大-蘆洲,2024-04-15,9857
1504,東元,231,132,99,元大-蘆洲,2024-04-15,9857
1513,中興電,367,276,91,元大-蘆洲,2024-04-15,9857
2344,華邦電,98,8,90,元大-蘆洲,2024-04-15,9857
2371,大同,444,355,89,元大-蘆洲,2024-04-15,9857
00933B,國泰10Y+金融債,83,0,83,元大-蘆洲,2024-04-15,9857
3481,群創,185,107,78,元大-蘆洲,2024-04-15,9857
3060,銘異,83,15,68,元大-蘆洲,2024-04-15,9857
1815,富喬,68,5,63,元大-蘆洲,2024-04-15,9857
00687B,國泰20年美債,66,7,59,元大-蘆洲,2024-04-15,9857
2618,長榮航,69,12,57,元大-蘆洲,2024-04-15,9857
2543,皇昌,67,10,57,元大-蘆洲,2024-04-15,9857
00939,統一台灣高息動能,75,19,56,元大-蘆洲,2024-04-15,9857
1314,中石化,118,63,55,元大-蘆洲,2024-04-15,9857
2316,楠梓電,54,1,53,元大-蘆洲,2024-04-15,9857
4533,協易機,210,159,51,元大-蘆洲,2024-04-15,9857
5521,工信,51,0,51,元大-蘆洲,2024-04-15,9857
1710,東聯,50,0,50,元大-蘆洲,2024-04-15,9857
2367,燿華,82,33,49,元大-蘆洲,2024-04-15,9857
5439,高技,49,1,48,元大-蘆洲,2024-04-15,9857
3712,永崴投控,52,6,46,元大-蘆洲,2024-04-15,9857
2867,三商壽,174,127,47,元大-蘆洲,2024-04-15,9857
1503,士電,70,23,47,元大-蘆洲,2024-04-15,9857
00927,群益半導體收益,47,1,46,元大-蘆洲,2024-04-15,9857
00934,中信成長高股息,42,0,42,元大-蘆洲,2024-04-15,9857
3706,神達,64,23,41,元大-蘆洲,2024-04-15,9857
4532,瑞智,156,119,37,元大-蘆洲,2024-04-15,9857
1605,華新,157,121,36,元大-蘆洲,2024-04-15,9857
3231,緯創,106,70,36,元大-蘆洲,2024-04-15,9857
2601,益航,35,0,35,元大-蘆洲,2024-04-15,9857
2365,昆盈,55,22,33,元大-蘆洲,2024-04-15,9857
00679B,元大美債20年,53,21,32,元大-蘆洲,2024-04-15,9857
8105,凌巨,31,0,31,元大-蘆洲,2024-04-15,9857
2025,千興,30,0,30,元大-蘆洲,2024-04-15,9857
00921,兆豐龍頭等權重,30,0,30,元大-蘆洲,2024-04-15,9857
2607,榮運,30,0,30,元大-蘆洲,2024-04-15,9857
2501,國建,67,38,29,元大-蘆洲,2024-04-15,9857
1612,宏泰,124,95,29,元大-蘆洲,2024-04-15,9857
3033,威健,31,3,28,元大-蘆洲,2024-04-15,9857
00940,元大台灣價值高息,1746,438,1308,元大-蘆洲,2024-04-16,9857
00937B,群益ESG投等債20,941,22,919,元大-蘆洲,2024-04-16,9857
2374,佳能,680,53,627,元大-蘆洲,2024-04-16,9857
00929,復華台灣科技優息,812,207,605,元大-蘆洲,2024-04-16,9857
2206,三陽工業,350,2,348,元大-蘆洲,2024-04-16,9857
0056,元大高股息,346,66,280,元大-蘆洲,2024-04-16,9857
1609,大亞,783,517,266,元大-蘆洲,2024-04-16,9857
00919,群益台灣精選高息,520,272,248,元大-蘆洲,2024-04-16,9857
00885,富邦越南,240,9,231,元大-蘆洲,2024-04-16,9857
00878,國泰永續高股息,298,91,207,元大-蘆洲,2024-04-16,9857
00939,統一台灣高息動能,212,14,198,元大-蘆洲,2024-04-16,9857
2303,聯電,226,51,175,元大-蘆洲,2024-04-16,9857
3372,典範,147,6,141,元大-蘆洲,2024-04-16,9857
3231,緯創,180,58,122,元大-蘆洲,2024-04-16,9857
2884,玉山金,125,6,119,元大-蘆洲,2024-04-16,9857
00687B,國泰20年美債,128,14,114,元大-蘆洲,2024-04-16,9857
1785,光洋科,136,28,108,元大-蘆洲,2024-04-16,9857
2630,亞航,251,150,101,元大-蘆洲,2024-04-16,9857
9105,泰金寶-DR,102,2,100,元大-蘆洲,2024-04-16,9857
2618,長榮航,139,43,96,元大-蘆洲,2024-04-16,9857
2601,益航,81,0,81,元大-蘆洲,2024-04-16,9857
2892,第一金,92,12,80,元大-蘆洲,2024-04-16,9857
2891,中信金,117,40,77,元大-蘆洲,2024-04-16,9857
2615,萬海,74,1,73,元大-蘆洲,2024-04-16,9857
2344,華邦電,86,13,73,元大-蘆洲,2024-04-16,9857
2609,陽明,96,25,71,元大-蘆洲,2024-04-16,9857
3013,晟銘電,77,8,69,元大-蘆洲,2024-04-16,9857
2887,台新金,83,21,62,元大-蘆洲,2024-04-16,9857
2408,南亞科,72,12,60,元大-蘆洲,2024-04-16,9857
00918,大華優利高填息30,57,2,55,元大-蘆洲,2024-04-16,9857
00933B,國泰10Y+金融債,55,0,55,元大-蘆洲,2024-04-16,9857
2025,千興,54,1,53,元大-蘆洲,2024-04-16,9857
2890,永豐金,53,1,52,元大-蘆洲,2024-04-16,9857
2880,華南金,52,0,52,元大-蘆洲,2024-04-16,9857
2834,臺企銀,68,19,49,元大-蘆洲,2024-04-16,9857
6116,彩晶,64,14,50,元大-蘆洲,2024-04-16,9857
3058,立德,47,0,47,元大-蘆洲,2024-04-16,9857
2402,毅嘉,53,7,46,元大-蘆洲,2024-04-16,9857
2888,新光金,50,5,45,元大-蘆洲,2024-04-16,9857
00679B,元大美債20年,70,26,44,元大-蘆洲,2024-04-16,9857
2317,鴻海,157,114,43,元大-蘆洲,2024-04-16,9857
2356,英業達,58,17,41,元大-蘆洲,2024-04-16,9857
1314,中石化,46,7,39,元大-蘆洲,2024-04-16,9857
2312,金寶,40,2,38,元大-蘆洲,2024-04-16,9857
6285,啟��,36,2,34,元大-蘆洲,2024-04-16,9857
2882,國泰金,63,31,32,元大-蘆洲,2024-04-16,9857
1815,富喬,32,1,31,元大-蘆洲,2024-04-16,9857
3260,威剛,38,7,31,元大-蘆洲,2024-04-16,9857
4973,廣穎,35,6,29,元大-蘆洲,2024-04-16,9857
1584,精剛,36,7,29,元大-蘆洲,2024-04-16,9857
00937B,群益ESG投等債20,611,6,605,元大-蘆洲,2024-04-17,9857
00632R,元大台灣50反1,731,380,351,元大-蘆洲,2024-04-17,9857
00929,復華台灣科技優息,291,10,281,元大-蘆洲,2024-04-17,9857
0056,元大高股息,258,10,248,元大-蘆洲,2024-04-17,9857
00712,復華富時不動產,189,1,188,元大-蘆洲,2024-04-17,9857
2618,長榮航,180,16,164,元大-蘆洲,2024-04-17,9857
6283,淳安,316,193,123,元大-蘆洲,2024-04-17,9857
00933B,國泰10Y+金融債,102,0,102,元大-蘆洲,2024-04-17,9857
5488,松普,100,0,100,元大-蘆洲,2024-04-17,9857
2303,聯電,114,16,98,元大-蘆洲,2024-04-17,9857
00940,元大台灣價值高息,306,218,88,元大-蘆洲,2024-04-17,9857
2867,三商壽,143,57,86,元大-蘆洲,2024-04-17,9857
3231,緯創,157,71,86,元大-蘆洲,2024-04-17,9857
00687B,國泰20年美債,103,20,83,元大-蘆洲,2024-04-17,9857
3481,群創,101,19,82,元大-蘆洲,2024-04-17,9857
2408,南亞科,82,5,77,元大-蘆洲,2024-04-17,9857
00919,群益台灣精選高息,99,26,73,元大-蘆洲,2024-04-17,9857
00650L,復華香港正2,66,0,66,元大-蘆洲,2024-04-17,9857
00720B,元大投資級公司債,59,0,59,元大-蘆洲,2024-04-17,9857
4960,誠美材,60,1,59,元大-蘆洲,2024-04-17,9857
00857B,永豐20年美公債,57,0,57,元大-蘆洲,2024-04-17,9857
00918,大華優利高填息30,61,8,53,元大-蘆洲,2024-04-17,9857
5314,世紀,59,7,52,元大-蘆洲,2024-04-17,9857
00679B,元大美債20年,146,95,51,元大-蘆洲,2024-04-17,9857
2889,國票金,49,0,49,元大-蘆洲,2024-04-17,9857
2101,南港,48,1,47,元大-蘆洲,2024-04-17,9857
2409,友達,66,20,46,元大-蘆洲,2024-04-17,9857
00939,統一台灣高息動能,47,3,44,元大-蘆洲,2024-04-17,9857
8097,常珵,42,0,42,元大-蘆洲,2024-04-17,9857
2880,華南金,42,2,40,元大-蘆洲,2024-04-17,9857
1605,華新,302,263,39,元大-蘆洲,2024-04-17,9857
00878,國泰永續高股息,79,43,36,元大-蘆洲,2024-04-17,9857
2615,萬海,35,0,35,元大-蘆洲,2024-04-17,9857
3622,洋華,41,6,35,元大-蘆洲,2024-04-17,9857
2605,新興,35,1,34,元大-蘆洲,2024-04-17,9857
5443,均豪,34,4,30,元大-蘆洲,2024-04-17,9857
5534,長虹,31,1,30,元大-蘆洲,2024-04-17,9857
6244,茂迪,40,11,29,元大-蘆洲,2024-04-17,9857
4157,太景*-KY,31,3,28,元大-蘆洲,2024-04-17,9857
3260,威剛,29,2,27,元大-蘆洲,2024-04-17,9857
2883,凱基金,35,9,26,元大-蘆洲,2024-04-17,9857
2884,玉山金,29,3,26,元大-蘆洲,2024-04-17,9857
00935,野村臺灣新科技50,26,0,26,元大-蘆洲,2024-04-17,9857
1810,和成,85,61,24,元大-蘆洲,2024-04-17,9857
2886,兆豐金,32,7,25,元大-蘆洲,2024-04-17,9857
5351,鈺創,26,1,25,元大-蘆洲,2024-04-17,9857
2354,鴻準,25,2,23,元大-蘆洲,2024-04-17,9857
2014,中鴻,24,1,23,元大-蘆洲,2024-04-17,9857
2630,亞航,58,35,23,元大-蘆洲,2024-04-17,9857
00725B,國泰投資級公司債,22,0,22,元大-蘆洲,2024-04-17,9857
00929,復華台灣科技優息,293,34,259,元大-蘆洲,2024-04-18,9857
00937B,群益ESG投等債20,251,10,241,元大-蘆洲,2024-04-18,9857
1609,大亞,655,505,150,元大-蘆洲,2024-04-18,9857
0056,元大高股息,161,31,130,元大-蘆洲,2024-04-18,9857
2371,大同,584,465,119,元大-蘆洲,2024-04-18,9857
1605,華新,386,285,101,元大-蘆洲,2024-04-18,9857
00632R,元大台灣50反1,99,2,97,元大-蘆洲,2024-04-18,9857
3481,群創,112,35,77,元大-蘆洲,2024-04-18,9857
2303,聯電,91,19,72,元大-蘆洲,2024-04-18,9857
2014,中鴻,90,35,55,元大-蘆洲,2024-04-18,9857
2022,聚亨,54,0,54,元大-蘆洲,2024-04-18,9857
5522,遠雄,51,0,51,元大-蘆洲,2024-04-18,9857
1710,東聯,50,1,49,元大-蘆洲,2024-04-18,9857
2889,國票金,49,1,48,元大-蘆洲,2024-04-18,9857
00940,元大台灣價值高息,118,70,48,元大-蘆洲,2024-04-18,9857
2409,友達,79,31,48,元大-蘆洲,2024-04-18,9857
2301,光寶科,62,14,48,元大-蘆洲,2024-04-18,9857
2344,華邦電,47,4,43,元大-蘆洲,2024-04-18,9857
00942B,台新美A公司債20+,52,10,42,元大-蘆洲,2024-04-18,9857
3694,海華,42,3,39,元大-蘆洲,2024-04-18,9857
3312,弘憶股,111,73,38,元大-蘆洲,2024-04-18,9857
5347,世界,43,6,37,元大-蘆洲,2024-04-18,9857
9105,泰金寶-DR,35,0,35,元大-蘆洲,2024-04-18,9857
2365,昆盈,34,0,34,元大-蘆洲,2024-04-18,9857
3707,漢磊,85,53,32,元大-蘆洲,2024-04-18,9857
00687B,國泰20年美債,52,20,32,元大-蘆洲,2024-04-18,9857
00733,富邦臺灣中小,33,2,31,元大-蘆洲,2024-04-18,9857
5388,中磊,31,1,30,元大-蘆洲,2024-04-18,9857
6770,力積電,39,9,30,元大-蘆洲,2024-04-18,9857
3209,全科,30,0,30,元大-蘆洲,2024-04-18,9857
1513,中興電,194,164,30,元大-蘆洲,2024-04-18,9857
2520,冠德,46,19,27,元大-蘆洲,2024-04-18,9857
2609,陽明,45,23,22,元大-蘆洲,2024-04-18,9857
00633L,富邦上証正2,22,0,22,元大-蘆洲,2024-04-18,9857
6125,廣運,39,17,22,元大-蘆洲,2024-04-18,9857
9945,潤泰新,56,34,22,元大-蘆洲,2024-04-18,9857
2313,華通,30,8,22,元大-蘆洲,2024-04-18,9857
9933,中鼎,21,0,21,元大-蘆洲,2024-04-18,9857
6515,穎崴,21,0,21,元大-蘆洲,2024-04-18,9857
00725B,國泰投資級公司債,21,0,21,元大-蘆洲,2024-04-18,9857
3056,富華新,25,4,21,元大-蘆洲,2024-04-18,9857
1603,華電,50,29,21,元大-蘆洲,2024-04-18,9857
00878,國泰永續高股息,30,10,20,元大-蘆洲,2024-04-18,9857
00751B,元大AAA至A公司債,20,0,20,元大-蘆洲,2024-04-18,9857
2605,新興,20,0,20,元大-蘆洲,2024-04-18,9857
3356,奇偶,22,2,20,元大-蘆洲,2024-04-18,9857
2104,國際中橡,20,0,20,元大-蘆洲,2024-04-18,9857
2504,國產,52,34,18,元大-蘆洲,2024-04-18,9857
2537,聯上發,38,20,18,元大-蘆洲,2024-04-18,9857
3266,昇陽,20,2,18,元大-蘆洲,2024-04-18,9857
00929,復華台灣科技優息,968,290,678,元大-蘆洲,2024-04-19,9857
2303,聯電,309,81,228,元大-蘆洲,2024-04-19,9857
1603,華電,293,85,208,元大-蘆洲,2024-04-19,9857
00878,國泰永續高股息,242,42,200,元大-蘆洲,2024-04-19,9857
0056,元大高股息,269,79,190,元大-蘆洲,2024-04-19,9857
2537,聯上發,174,18,156,元大-蘆洲,2024-04-19,9857
00697B,元大美債7-10,118,0,118,元大-蘆洲,2024-04-19,9857
1612,宏泰,281,165,116,元大-蘆洲,2024-04-19,9857
00937B,群益ESG投等債20,215,102,113,元大-蘆洲,2024-04-19,9857
2206,三陽工業,217,105,112,元大-蘆洲,2024-04-19,9857
2330,台積電,130,27,103,元大-蘆洲,2024-04-19,9857
3481,群創,285,188,97,元大-蘆洲,2024-04-19,9857
2515,中工,587,493,94,元大-蘆洲,2024-04-19,9857
00939,統一台灣高息動能,212,122,90,元大-蘆洲,2024-04-19,9857
00637L,元大滬深300正2,110,30,80,元大-蘆洲,2024-04-19,9857
2618,長榮航,187,113,74,元大-蘆洲,2024-04-19,9857
2317,鴻海,237,164,73,元大-蘆洲,2024-04-19,9857
2353,宏��,97,28,69,元大-蘆洲,2024-04-19,9857
5515,建國,87,20,67,元大-蘆洲,2024-04-19,9857
1609,大亞,1111,1049,62,元大-蘆洲,2024-04-19,9857
2401,凌陽,58,0,58,元大-蘆洲,2024-04-19,9857
2637,慧洋-KY,75,18,57,元大-蘆洲,2024-04-19,9857
2801,彰銀,51,0,51,元大-蘆洲,2024-04-19,9857
2641,正德,61,11,50,元大-蘆洲,2024-04-19,9857
8936,國統,138,88,50,元大-蘆洲,2024-04-19,9857
1301,台塑,50,0,50,元大-蘆洲,2024-04-19,9857
2506,太設,55,6,49,元大-蘆洲,2024-04-19,9857
00706L,期元大S＆P日圓正2,50,2,48,元大-蘆洲,2024-04-19,9857
1608,華榮,426,379,47,元大-蘆洲,2024-04-19,9857
2880,華南金,57,11,46,元大-蘆洲,2024-04-19,9857
0050,元大台灣50,53,7,46,元大-蘆洲,2024-04-19,9857
2344,華邦電,49,7,42,元大-蘆洲,2024-04-19,9857
2892,第一金,49,7,42,元大-蘆洲,2024-04-19,9857
3707,漢磊,44,3,41,元大-蘆洲,2024-04-19,9857
6770,力積電,71,31,40,元大-蘆洲,2024-04-19,9857
2367,燿華,97,58,39,元大-蘆洲,2024-04-19,9857
2409,友達,66,29,37,元大-蘆洲,2024-04-19,9857
2903,遠百,36,0,36,元大-蘆洲,2024-04-19,9857
2887,台新金,36,0,36,元大-蘆洲,2024-04-19,9857
2002,中鋼,46,11,35,元大-蘆洲,2024-04-19,9857
2897,王道銀行,35,0,35,元大-蘆洲,2024-04-19,9857
00941,中信上游半導體,55,21,34,元大-蘆洲,2024-04-19,9857
00918,大華優利高填息30,34,1,33,元大-蘆洲,2024-04-19,9857
3260,威剛,37,4,33,元大-蘆洲,2024-04-19,9857
2884,玉山金,40,8,32,元大-蘆洲,2024-04-19,9857
6116,彩晶,68,37,31,元大-蘆洲,2024-04-19,9857
6244,茂迪,33,2,31,元大-蘆洲,2024-04-19,9857
00923,群益台ESG低碳50,33,2,31,元大-蘆洲,2024-04-19,9857
6217,中探針,32,1,31,元大-蘆洲,2024-04-19,9857
2427,三商電,63,32,31,元大-蘆洲,2024-04-19,9857
00937B,群益ESG投等債20,572,46,526,元大-蘆洲,2024-04-22,9857
00929,復華台灣科技優息,827,304,523,元大-蘆洲,2024-04-22,9857
00632R,元大台灣50反1,442,148,294,元大-蘆洲,2024-04-22,9857
00940,元大台灣價值高息,413,153,260,元大-蘆洲,2024-04-22,9857
2609,陽明,258,82,176,元大-蘆洲,2024-04-22,9857
00939,統一台灣高息動能,172,3,169,元大-蘆洲,2024-04-22,9857
00919,群益台灣精選高息,236,68,168,元大-蘆洲,2024-04-22,9857
2371,大同,720,579,141,元大-蘆洲,2024-04-22,9857
6120,達運,128,11,117,元大-蘆洲,2024-04-22,9857
2303,聯電,142,37,105,元大-蘆洲,2024-04-22,9857
00687B,國泰20年美債,105,1,104,元大-蘆洲,2024-04-22,9857
00878,國泰永續高股息,112,9,103,元大-蘆洲,2024-04-22,9857
2409,友達,103,7,96,元大-蘆洲,2024-04-22,9857
0056,元大高股息,110,17,93,元大-蘆洲,2024-04-22,9857
2603,長榮,173,104,69,元大-蘆洲,2024-04-22,9857
1504,東元,77,21,56,元大-蘆洲,2024-04-22,9857
1617,榮星,89,32,57,元大-蘆洲,2024-04-22,9857
3703,欣陸,132,76,56,元大-蘆洲,2024-04-22,9857
2388,威盛,74,19,55,元大-蘆洲,2024-04-22,9857
1313,聯成,50,0,50,元大-蘆洲,2024-04-22,9857
3060,銘異,54,6,48,元大-蘆洲,2024-04-22,9857
1608,華榮,173,127,46,元大-蘆洲,2024-04-22,9857
3231,緯創,133,87,46,元大-蘆洲,2024-04-22,9857
6125,廣運,65,20,45,元大-蘆洲,2024-04-22,9857
6770,力積電,49,6,43,元大-蘆洲,2024-04-22,9857
3481,群創,129,87,42,元大-蘆洲,2024-04-22,9857
2543,皇昌,87,49,38,元大-蘆洲,2024-04-22,9857
00679B,元大美債20年,42,5,37,元大-蘆洲,2024-04-22,9857
6213,聯茂,56,20,36,元大-蘆洲,2024-04-22,9857
3013,晟銘電,57,23,34,元大-蘆洲,2024-04-22,9857
00857B,永豐20年美公債,34,1,33,元大-蘆洲,2024-04-22,9857
00664R,國泰臺灣加權反1,31,0,31,元大-蘆洲,2024-04-22,9857
2489,瑞軒,30,0,30,元大-蘆洲,2024-04-22,9857
00942B,台新美A公司債20+,30,0,30,元大-蘆洲,2024-04-22,9857
2330,台積電,42,12,30,元大-蘆洲,2024-04-22,9857
5515,建國,38,9,29,元大-蘆洲,2024-04-22,9857
3466,德晉,30,1,29,元大-蘆洲,2024-04-22,9857
2408,南亞科,31,2,29,元大-蘆洲,2024-04-22,9857
1802,台玻,30,4,26,元大-蘆洲,2024-04-22,9857
3622,洋華,69,43,26,元大-蘆洲,2024-04-22,9857
1618,合機,128,103,25,元大-蘆洲,2024-04-22,9857
5009,榮剛,37,13,24,元大-蘆洲,2024-04-22,9857
00715L,期街口布蘭特正2,26,2,24,元大-蘆洲,2024-04-22,9857
6116,彩晶,36,12,24,元大-蘆洲,2024-04-22,9857
3450,聯鈞,38,15,23,元大-蘆洲,2024-04-22,9857
2103,台橡,21,0,21,元大-蘆洲,2024-04-22,9857
00933B,國泰10Y+金融債,20,0,20,元大-蘆洲,2024-04-22,9857
4972,湯石照明,20,0,20,元大-蘆洲,2024-04-22,9857
1805,寶徠,21,1,20,元大-蘆洲,2024-04-22,9857
5512,力麒,252,232,20,元大-蘆洲,2024-04-22,9857
00632R,元大台灣50反1,306,79,227,元大-蘆洲,2024-04-23,9857
00929,復華台灣科技優息,186,31,155,元大-蘆洲,2024-04-23,9857
2801,彰銀,110,1,109,元大-蘆洲,2024-04-23,9857
2101,南港,128,33,95,元大-蘆洲,2024-04-23,9857
00937B,群益ESG投等債20,98,15,83,元大-蘆洲,2024-04-23,9857
1710,東聯,80,0,80,元大-蘆洲,2024-04-23,9857
00940,元大台灣價值高息,169,103,66,元大-蘆洲,2024-04-23,9857
3363,上詮,70,14,56,元大-蘆洲,2024-04-23,9857
3231,緯創,71,30,41,元大-蘆洲,2024-04-23,9857
2889,國票金,55,20,35,元大-蘆洲,2024-04-23,9857
2303,聯電,56,21,35,元大-蘆洲,2024-04-23,9857
1608,華榮,89,58,31,元大-蘆洲,2024-04-23,9857
6116,彩晶,67,36,31,元大-蘆洲,2024-04-23,9857
6213,聯茂,48,18,30,元大-蘆洲,2024-04-23,9857
1605,華新,51,21,30,元大-蘆洲,2024-04-23,9857
8105,凌巨,30,0,30,元大-蘆洲,2024-04-23,9857
3673,TPK-KY,29,0,29,元大-蘆洲,2024-04-23,9857
2409,友達,65,37,28,元大-蘆洲,2024-04-23,9857
1785,光洋科,30,2,28,元大-蘆洲,2024-04-23,9857
5009,榮剛,37,9,28,元大-蘆洲,2024-04-23,9857
1795,美時,31,3,28,元大-蘆洲,2024-04-23,9857
3535,晶彩科,37,12,25,元大-蘆洲,2024-04-23,9857
00941,中信上游半導體,24,0,24,元大-蘆洲,2024-04-23,9857
3715,定穎投控,35,12,23,元大-蘆洲,2024-04-23,9857
2603,長榮,48,25,23,元大-蘆洲,2024-04-23,9857
3706,神達,41,19,22,元大-蘆洲,2024-04-23,9857
4526,東台,26,4,22,元大-蘆洲,2024-04-23,9857
3703,欣陸,29,8,21,元大-蘆洲,2024-04-23,9857
6282,康舒,26,5,21,元大-蘆洲,2024-04-23,9857
00878,國泰永續高股息,34,14,20,元大-蘆洲,2024-04-23,9857
8215,明基材,19,0,19,元大-蘆洲,2024-04-23,9857
4167,松瑞藥,23,4,19,元大-蘆洲,2024-04-23,9857
4303,信立,22,3,19,元大-蘆洲,2024-04-23,9857
2884,玉山金,20,1,19,元大-蘆洲,2024-04-23,9857
5443,均豪,19,1,18,元大-蘆洲,2024-04-23,9857
5515,建國,21,3,18,元大-蘆洲,2024-04-23,9857
2515,中工,148,131,17,元大-蘆洲,2024-04-23,9857
1725,元禎,51,34,17,元大-蘆洲,2024-04-23,9857
1582,信錦,20,3,17,元大-蘆洲,2024-04-23,9857
00687B,國泰20年美債,20,5,15,元大-蘆洲,2024-04-23,9857
2317,鴻海,38,23,15,元大-蘆洲,2024-04-23,9857
5324,士開,20,6,14,元大-蘆洲,2024-04-23,9857
2464,盟立,24,10,14,元大-蘆洲,2024-04-23,9857
4979,華星光,15,1,14,元大-蘆洲,2024-04-23,9857
00733,富邦臺灣中小,13,0,13,元大-蘆洲,2024-04-23,9857
6005,群益證,25,12,13,元大-蘆洲,2024-04-23,9857
2881,富邦金,15,2,13,元大-蘆洲,2024-04-23,9857
2845,遠東銀,12,0,12,元大-蘆洲,2024-04-23,9857
1305,華夏,12,0,12,元大-蘆洲,2024-04-23,9857
00939,統一台灣高息動能,20,9,11,元大-蘆洲,2024-04-23,9857
2206,三陽工業,517,234,283,元大-蘆洲,2024-04-24,9857
6190,萬泰科,121,8,113,元大-蘆洲,2024-04-24,9857
3481,群創,109,18,91,元大-蘆洲,2024-04-24,9857
00919,群益台灣精選高息,128,40,88,元大-蘆洲,2024-04-24,9857
1618,合機,171,85,86,元大-蘆洲,2024-04-24,9857
3363,上詮,87,2,85,元大-蘆洲,2024-04-24,9857
2537,聯上發,101,19,82,元大-蘆洲,2024-04-24,9857
2009,第一銅,82,13,69,元大-蘆洲,2024-04-24,9857
3576,聯合再生,68,1,67,元大-蘆洲,2024-04-24,9857
6761,穩得,70,4,66,元大-蘆洲,2024-04-24,9857
4128,中天,61,0,61,元大-蘆洲,2024-04-24,9857
2409,友達,79,19,60,元大-蘆洲,2024-04-24,9857
8215,明基材,58,0,58,元大-蘆洲,2024-04-24,9857
2886,兆豐金,51,0,51,元大-蘆洲,2024-04-24,9857
6770,力積電,54,11,43,元大-蘆洲,2024-04-24,9857
00637L,元大滬深300正2,85,45,40,元大-蘆洲,2024-04-24,9857
1605,華新,97,58,39,元大-蘆洲,2024-04-24,9857
1608,華榮,85,52,33,元大-蘆洲,2024-04-24,9857
00665L,富邦�琤肭磪囓�2,70,39,31,元大-蘆洲,2024-04-24,9857
2705,六福,30,2,28,元大-蘆洲,2024-04-24,9857
00929,復華台灣科技優息,149,124,25,元大-蘆洲,2024-04-24,9857
1540,喬福,25,0,25,元大-蘆洲,2024-04-24,9857
00687B,國泰20年美債,24,0,24,元大-蘆洲,2024-04-24,9857
00941,中信上游半導體,28,4,24,元大-蘆洲,2024-04-24,9857
2313,華通,30,6,24,元大-蘆洲,2024-04-24,9857
3715,定穎投控,128,105,23,元大-蘆洲,2024-04-24,9857
2027,大成鋼,29,6,23,元大-蘆洲,2024-04-24,9857
2536,宏普,23,1,22,元大-蘆洲,2024-04-24,9857
1522,堤維西,28,7,21,元大-蘆洲,2024-04-24,9857
00878,國泰永續高股息,31,11,20,元大-蘆洲,2024-04-24,9857
00937B,群益ESG投等債20,59,39,20,元大-蘆洲,2024-04-24,9857
2504,國產,22,2,20,元大-蘆洲,2024-04-24,9857
5608,四維航,20,1,19,元大-蘆洲,2024-04-24,9857
8054,安國,63,45,18,元大-蘆洲,2024-04-24,9857
2542,興富發,18,0,18,元大-蘆洲,2024-04-24,9857
2867,三商壽,40,23,17,元大-蘆洲,2024-04-24,9857
2511,太子,30,13,17,元大-蘆洲,2024-04-24,9857
2208,台船,15,0,15,元大-蘆洲,2024-04-24,9857
1455,集盛,17,2,15,元大-蘆洲,2024-04-24,9857
00857B,永豐20年美公債,18,3,15,元大-蘆洲,2024-04-24,9857
2022,聚亨,18,3,15,元大-蘆洲,2024-04-24,9857
6515,穎崴,15,0,15,元大-蘆洲,2024-04-24,9857
1314,中石化,105,91,14,元大-蘆洲,2024-04-24,9857
6244,茂迪,17,3,14,元大-蘆洲,2024-04-24,9857
2363,矽統,49,36,13,元大-蘆洲,2024-04-24,9857
1104,環泥,13,0,13,元大-蘆洲,2024-04-24,9857
3703,欣陸,30,17,13,元大-蘆洲,2024-04-24,9857
4532,瑞智,26,14,12,元大-蘆洲,2024-04-24,9857
8011,台通,21,9,12,元大-蘆洲,2024-04-24,9857
3231,緯創,136,124,12,元大-蘆洲,2024-04-24,9857
00929,復華台灣科技優息,207,8,199,元大-蘆洲,2024-04-25,9857
0056,元大高股息,168,2,166,元大-蘆洲,2024-04-25,9857
2618,長榮航,522,371,151,元大-蘆洲,2024-04-25,9857
2610,華航,512,400,112,元大-蘆洲,2024-04-25,9857
2867,三商壽,118,16,102,元大-蘆洲,2024-04-25,9857
1605,華新,100,4,96,元大-蘆洲,2024-04-25,9857
2317,鴻海,128,36,92,元大-蘆洲,2024-04-25,9857
00937B,群益ESG投等債20,88,1,87,元大-蘆洲,2024-04-25,9857
3024,憶聲,74,3,71,元大-蘆洲,2024-04-25,9857
00687B,國泰20年美債,75,10,65,元大-蘆洲,2024-04-25,9857
2303,聯電,104,43,61,元大-蘆洲,2024-04-25,9857
00878,國泰永續高股息,60,6,54,元大-蘆洲,2024-04-25,9857
2515,中工,151,99,52,元大-蘆洲,2024-04-25,9857
00919,群益台灣精選高息,57,5,52,元大-蘆洲,2024-04-25,9857
2101,南港,91,42,49,元大-蘆洲,2024-04-25,9857
00679B,元大美債20年,48,1,47,元大-蘆洲,2024-04-25,9857
3703,欣陸,82,38,44,元大-蘆洲,2024-04-25,9857
2615,萬海,61,19,42,元大-蘆洲,2024-04-25,9857
2537,聯上發,62,22,40,元大-蘆洲,2024-04-25,9857
6116,彩晶,51,12,39,元大-蘆洲,2024-04-25,9857
8054,安國,65,26,39,元大-蘆洲,2024-04-25,9857
3163,波若威,41,9,32,元大-蘆洲,2024-04-25,9857
2883,凱基金,45,13,32,元大-蘆洲,2024-04-25,9857
3715,定穎投控,74,43,31,元大-蘆洲,2024-04-25,9857
6761,穩得,31,0,31,元大-蘆洲,2024-04-25,9857
00891,中信關鍵半導體,30,0,30,元大-蘆洲,2024-04-25,9857
00631L,元大台灣50正2,29,0,29,元大-蘆洲,2024-04-25,9857
00651R,復華香港反1,28,0,28,元大-蘆洲,2024-04-25,9857
5608,四維航,26,1,25,元大-蘆洲,2024-04-25,9857
2887,台新金,26,1,25,元大-蘆洲,2024-04-25,9857
6770,力積電,37,13,24,元大-蘆洲,2024-04-25,9857
2886,兆豐金,24,1,23,元大-蘆洲,2024-04-25,9857
00939,統一台灣高息動能,23,1,22,元大-蘆洲,2024-04-25,9857
4303,信立,37,15,22,元大-蘆洲,2024-04-25,9857
00940,元大台灣價值高息,160,138,22,元大-蘆洲,2024-04-25,9857
3231,緯創,65,44,21,元大-蘆洲,2024-04-25,9857
3356,奇偶,23,2,21,元大-蘆洲,2024-04-25,9857
00680L,元大美債20正2,21,0,21,元大-蘆洲,2024-04-25,9857
6266,泰詠,20,0,20,元大-蘆洲,2024-04-25,9857
00715L,期街口布蘭特正2,20,0,20,元大-蘆洲,2024-04-25,9857
5328,華容,20,0,20,元大-蘆洲,2024-04-25,9857
8215,明基材,21,1,20,元大-蘆洲,2024-04-25,9857
2027,大成鋼,21,2,19,元大-蘆洲,2024-04-25,9857
6235,華孚,20,1,19,元大-蘆洲,2024-04-25,9857
1722,台肥,17,0,17,元大-蘆洲,2024-04-25,9857
3081,聯亞,17,0,17,元大-蘆洲,2024-04-25,9857
1314,中石化,29,12,17,元大-蘆洲,2024-04-25,9857
6139,亞翔,18,2,16,元大-蘆洲,2024-04-25,9857
1540,喬福,16,0,16,元大-蘆洲,2024-04-25,9857
3706,神達,17,1,16,元大-蘆洲,2024-04-25,9857
00937B,群益ESG投等債20,259,0,259,元大-蘆洲,2024-04-26,9857
00632R,元大台灣50反1,175,10,165,元大-蘆洲,2024-04-26,9857
6274,台燿,124,11,113,元大-蘆洲,2024-04-26,9857
00929,復華台灣科技優息,120,24,96,元大-蘆洲,2024-04-26,9857
4532,瑞智,105,11,94,元大-蘆洲,2024-04-26,9857
00679B,元大美債20年,93,2,91,元大-蘆洲,2024-04-26,9857
00687B,國泰20年美債,79,0,79,元大-蘆洲,2024-04-26,9857
00939,統一台灣高息動能,54,4,50,元大-蘆洲,2024-04-26,9857
00676R,富邦臺灣加權反1,50,0,50,元大-蘆洲,2024-04-26,9857
6530,創威,59,13,46,元大-蘆洲,2024-04-26,9857
3266,昇陽,40,0,40,元大-蘆洲,2024-04-26,9857
8234,新漢,41,2,39,元大-蘆洲,2024-04-26,9857
2009,第一銅,53,15,38,元大-蘆洲,2024-04-26,9857
2359,所羅門,153,118,35,元大-蘆洲,2024-04-26,9857
2371,大同,153,120,33,元大-蘆洲,2024-04-26,9857
6190,萬泰科,38,5,33,元大-蘆洲,2024-04-26,9857
6223,旺矽,33,1,32,元大-蘆洲,2024-04-26,9857
00891,中信關鍵半導體,51,20,31,元大-蘆洲,2024-04-26,9857
6188,廣明,62,31,31,元大-蘆洲,2024-04-26,9857
00720B,元大投資級公司債,30,0,30,元大-蘆洲,2024-04-26,9857
00680L,元大美債20正2,30,0,30,元大-蘆洲,2024-04-26,9857
3024,憶聲,30,0,30,元大-蘆洲,2024-04-26,9857
6266,泰詠,30,1,29,元大-蘆洲,2024-04-26,9857
3231,緯創,48,19,29,元大-蘆洲,2024-04-26,9857
8096,擎亞,41,12,29,元大-蘆洲,2024-04-26,9857
6244,茂迪,29,0,29,元大-蘆洲,2024-04-26,9857
2206,三陽工業,118,92,26,元大-蘆洲,2024-04-26,9857
1101,台泥,27,1,26,元大-蘆洲,2024-04-26,9857
1314,中石化,57,33,24,元大-蘆洲,2024-04-26,9857
2505,國揚,39,17,22,元大-蘆洲,2024-04-26,9857
1618,合機,52,31,21,元大-蘆洲,2024-04-26,9857
3338,泰碩,43,23,20,元大-蘆洲,2024-04-26,9857
1519,華城,47,28,19,元大-蘆洲,2024-04-26,9857
00739,元大MSCI A股,19,0,19,元大-蘆洲,2024-04-26,9857
2423,固緯,19,0,19,元大-蘆洲,2024-04-26,9857
00633L,富邦上証正2,20,1,19,元大-蘆洲,2024-04-26,9857
1605,華新,33,15,18,元大-蘆洲,2024-04-26,9857
3715,定穎投控,52,34,18,元大-蘆洲,2024-04-26,9857
6177,達麗,20,2,18,元大-蘆洲,2024-04-26,9857
2102,泰豐,23,6,17,元大-蘆洲,2024-04-26,9857
3686,達能,21,5,16,元大-蘆洲,2024-04-26,9857
00942B,台新美A公司債20+,16,0,16,元大-蘆洲,2024-04-26,9857
00795B,中信美國公債20年,16,0,16,元大-蘆洲,2024-04-26,9857
3234,光環,29,14,15,元大-蘆洲,2024-04-26,9857
3712,永崴投控,31,16,15,元大-蘆洲,2024-04-26,9857
2511,太子,30,15,15,元大-蘆洲,2024-04-26,9857
3312,弘憶股,18,4,14,元大-蘆洲,2024-04-26,9857
006206,元大上證50,14,0,14,元大-蘆洲,2024-04-26,9857
3707,漢磊,23,9,14,元大-蘆洲,2024-04-26,9857
2547,日勝生,16,2,14,元大-蘆洲,2024-04-26,9857
2618,長榮航,767,399,368,元大-蘆洲,2024-04-29,9857
00632R,元大台灣50反1,236,5,231,元大-蘆洲,2024-04-29,9857
00919,群益台灣精選高息,260,94,166,元大-蘆洲,2024-04-29,9857
2515,中工,265,107,158,元大-蘆洲,2024-04-29,9857
00882,中信中國高股息,159,16,143,元大-蘆洲,2024-04-29,9857
2609,陽明,323,179,144,元大-蘆洲,2024-04-29,9857
3163,波若威,128,7,121,元大-蘆洲,2024-04-29,9857
00650L,復華香港正2,100,0,100,元大-蘆洲,2024-04-29,9857
2101,南港,120,39,81,元大-蘆洲,2024-04-29,9857
5457,宣德,65,0,65,元大-蘆洲,2024-04-29,9857
2511,太子,89,26,63,元大-蘆洲,2024-04-29,9857
2363,矽統,195,146,49,元大-蘆洲,2024-04-29,9857
2538,基泰,52,7,45,元大-蘆洲,2024-04-29,9857
3346,麗清,41,1,40,元大-蘆洲,2024-04-29,9857
2514,龍邦,40,0,40,元大-蘆洲,2024-04-29,9857
4306,炎洲,46,10,36,元大-蘆洲,2024-04-29,9857
00631L,元大台灣50正2,42,7,35,元大-蘆洲,2024-04-29,9857
2371,大同,74,43,31,元大-蘆洲,2024-04-29,9857
2241,艾姆勒,39,11,28,元大-蘆洲,2024-04-29,9857
2887,台新金,32,5,27,元大-蘆洲,2024-04-29,9857
6177,達麗,30,6,24,元大-蘆洲,2024-04-29,9857
2601,益航,53,29,24,元大-蘆洲,2024-04-29,9857
2883B,凱基金乙特,24,0,24,元大-蘆洲,2024-04-29,9857
2323,中環,143,120,23,元大-蘆洲,2024-04-29,9857
4912,聯德控股-KY,23,0,23,元大-蘆洲,2024-04-29,9857
3081,聯亞,23,1,22,元大-蘆洲,2024-04-29,9857
2520,冠德,66,44,22,元大-蘆洲,2024-04-29,9857
3234,光環,36,15,21,元大-蘆洲,2024-04-29,9857
1473,台南,21,0,21,元大-蘆洲,2024-04-29,9857
5439,高技,21,0,21,元大-蘆洲,2024-04-29,9857
8150,南茂,20,0,20,元大-蘆洲,2024-04-29,9857
00633L,富邦上証正2,20,0,20,元大-蘆洲,2024-04-29,9857
4716,大立,25,6,19,元大-蘆洲,2024-04-29,9857
2913,農林,42,23,19,元大-蘆洲,2024-04-29,9857
2867,三商壽,24,6,18,元大-蘆洲,2024-04-29,9857
1618,合機,22,5,17,元大-蘆洲,2024-04-29,9857
2316,楠梓電,19,2,17,元大-蘆洲,2024-04-29,9857
00941,中信上游半導體,18,2,16,元大-蘆洲,2024-04-29,9857
8033,雷虎,26,10,16,元大-蘆洲,2024-04-29,9857
6125,廣運,31,16,15,元大-蘆洲,2024-04-29,9857
00706L,期元大S＆P日圓正2,40,25,15,元大-蘆洲,2024-04-29,9857
2506,太設,18,3,15,元大-蘆洲,2024-04-29,9857
5392,能率,15,1,14,元大-蘆洲,2024-04-29,9857
6156,松上,14,0,14,元大-蘆洲,2024-04-29,9857
2615,萬海,96,83,13,元大-蘆洲,2024-04-29,9857
1220,台榮,15,2,13,元大-蘆洲,2024-04-29,9857
3481,群創,160,147,13,元大-蘆洲,2024-04-29,9857
4155,訊映,16,4,12,元大-蘆洲,2024-04-29,9857
5388,中磊,12,0,12,元大-蘆洲,2024-04-29,9857
8050,廣積,12,0,12,元大-蘆洲,2024-04-29,9857
00632R,元大台灣50反1,310,0,310,元大-蘆洲,2024-04-30,9857
00919,群益台灣精選高息,205,30,175,元大-蘆洲,2024-04-30,9857
1504,東元,170,41,129,元大-蘆洲,2024-04-30,9857
3376,新日興,158,33,125,元大-蘆洲,2024-04-30,9857
2515,中工,140,47,93,元大-蘆洲,2024-04-30,9857
5531,鄉林,97,14,83,元大-蘆洲,2024-04-30,9857
6190,萬泰科,177,100,77,元大-蘆洲,2024-04-30,9857
1314,中石化,136,73,63,元大-蘆洲,2024-04-30,9857
2481,強茂,64,1,63,元大-蘆洲,2024-04-30,9857
1313,聯成,60,0,60,元大-蘆洲,2024-04-30,9857
9904,寶成,61,5,56,元大-蘆洲,2024-04-30,9857
2501,國建,392,343,49,元大-蘆洲,2024-04-30,9857
6275,元山,50,2,48,元大-蘆洲,2024-04-30,9857
1101,台泥,48,0,48,元大-蘆洲,2024-04-30,9857
2009,第一銅,84,39,45,元大-蘆洲,2024-04-30,9857
2537,聯上發,65,34,31,元大-蘆洲,2024-04-30,9857
5425,台半,31,1,30,元大-蘆洲,2024-04-30,9857
3005,神基,31,2,29,元大-蘆洲,2024-04-30,9857
2010,春源,30,1,29,元大-蘆洲,2024-04-30,9857
2241,艾姆勒,34,6,28,元大-蘆洲,2024-04-30,9857
8110,華東,54,27,27,元大-蘆洲,2024-04-30,9857
6770,力積電,35,9,26,元大-蘆洲,2024-04-30,9857
6530,創威,32,7,25,元大-蘆洲,2024-04-30,9857
1616,億泰,26,2,24,元大-蘆洲,2024-04-30,9857
3363,上詮,111,88,23,元大-蘆洲,2024-04-30,9857
2314,台揚,23,0,23,元大-蘆洲,2024-04-30,9857
00891,中信關鍵半導體,27,5,22,元大-蘆洲,2024-04-30,9857
2388,威盛,28,6,22,元大-蘆洲,2024-04-30,9857
1316,上曜,173,152,21,元大-蘆洲,2024-04-30,9857
00679B,元大美債20年,23,2,21,元大-蘆洲,2024-04-30,9857
00753L,中信中國50正2,20,0,20,元大-蘆洲,2024-04-30,9857
2002,中鋼,26,7,19,元大-蘆洲,2024-04-30,9857
1522,堤維西,19,1,18,元大-蘆洲,2024-04-30,9857
00680L,元大美債20正2,23,5,18,元大-蘆洲,2024-04-30,9857
2356,英業達,20,3,17,元大-蘆洲,2024-04-30,9857
2705,六福,17,0,17,元大-蘆洲,2024-04-30,9857
1218,泰山,22,5,17,元大-蘆洲,2024-04-30,9857
2363,矽統,258,241,17,元大-蘆洲,2024-04-30,9857
2449,京元電子,22,6,16,元大-蘆洲,2024-04-30,9857
3312,弘憶股,33,17,16,元大-蘆洲,2024-04-30,9857
2427,三商電,20,4,16,元大-蘆洲,2024-04-30,9857
2317,鴻海,48,33,15,元大-蘆洲,2024-04-30,9857
1215,卜蜂,15,0,15,元大-蘆洲,2024-04-30,9857
2505,國揚,23,8,15,元大-蘆洲,2024-04-30,9857
6875,國邑*,15,0,15,元大-蘆洲,2024-04-30,9857
1605,華新,28,13,15,元大-蘆洲,2024-04-30,9857
1513,中興電,31,17,14,元大-蘆洲,2024-04-30,9857
6116,彩晶,19,5,14,元大-蘆洲,2024-04-30,9857
6189,豐藝,15,2,13,元大-蘆洲,2024-04-30,9857
2355,敬鵬,14,1,13,元大-蘆洲,2024-04-30,9857
00878,國泰永續高股息,404,159,245,元大-蘆洲,2024-05-02,9857
3481,群創,253,22,231,元大-蘆洲,2024-05-02,9857
00929,復華台灣科技優息,180,18,162,元大-蘆洲,2024-05-02,9857
2101,南港,173,24,149,元大-蘆洲,2024-05-02,9857
1532,勤美,146,8,138,元大-蘆洲,2024-05-02,9857
2511,太子,172,35,137,元大-蘆洲,2024-05-02,9857
2515,中工,209,77,132,元大-蘆洲,2024-05-02,9857
2501,國建,462,357,105,元大-蘆洲,2024-05-02,9857
00679B,元大美債20年,105,13,92,元大-蘆洲,2024-05-02,9857
00937B,群益ESG投等債20,120,43,77,元大-蘆洲,2024-05-02,9857
2867,三商壽,80,5,75,元大-蘆洲,2024-05-02,9857
8064,東捷,87,19,68,元大-蘆洲,2024-05-02,9857
00882,中信中國高股息,88,21,67,元大-蘆洲,2024-05-02,9857
00687B,國泰20年美債,68,4,64,元大-蘆洲,2024-05-02,9857
2409,友達,80,16,64,元大-蘆洲,2024-05-02,9857
3306,鼎天,60,5,55,元大-蘆洲,2024-05-02,9857
00725B,國泰投資級公司債,55,0,55,元大-蘆洲,2024-05-02,9857
1609,大亞,146,93,53,元大-蘆洲,2024-05-02,9857
2603,長榮,122,74,48,元大-蘆洲,2024-05-02,9857
2615,萬海,103,55,48,元大-蘆洲,2024-05-02,9857
2887,台新金,51,6,45,元大-蘆洲,2024-05-02,9857
2367,燿華,51,7,44,元大-蘆洲,2024-05-02,9857
3715,定穎投控,83,41,42,元大-蘆洲,2024-05-02,9857
2371,大同,105,66,39,元大-蘆洲,2024-05-02,9857
00715L,期街口布蘭特正2,50,11,39,元大-蘆洲,2024-05-02,9857
00940,元大台灣價值高息,92,56,36,元大-蘆洲,2024-05-02,9857
00751B,元大AAA至A公司債,35,0,35,元大-蘆洲,2024-05-02,9857
1618,合機,54,19,35,元大-蘆洲,2024-05-02,9857
2303,聯電,96,62,34,元大-蘆洲,2024-05-02,9857
2401,凌陽,54,23,31,元大-蘆洲,2024-05-02,9857
00772B,中信高評級公司債,30,0,30,元大-蘆洲,2024-05-02,9857
2903,遠百,30,1,29,元大-蘆洲,2024-05-02,9857
00637L,元大滬深300正2,143,115,28,元大-蘆洲,2024-05-02,9857
2330,台積電,26,0,26,元大-蘆洲,2024-05-02,9857
3163,波若威,30,5,25,元大-蘆洲,2024-05-02,9857
2486,一詮,39,14,25,元大-蘆洲,2024-05-02,9857
2609,陽明,116,91,25,元大-蘆洲,2024-05-02,9857
00919,群益台灣精選高息,95,70,25,元大-蘆洲,2024-05-02,9857
6243,迅杰,24,0,24,元大-蘆洲,2024-05-02,9857
00891,中信關鍵半導體,23,0,23,元大-蘆洲,2024-05-02,9857
2337,旺宏,36,14,22,元大-蘆洲,2024-05-02,9857
8215,明基材,22,0,22,元大-蘆洲,2024-05-02,9857
2301,光寶科,28,7,21,元大-蘆洲,2024-05-02,9857
3363,上詮,62,42,20,元大-蘆洲,2024-05-02,9857
00650L,復華香港正2,20,0,20,元大-蘆洲,2024-05-02,9857
5371,中光電,31,12,19,元大-蘆洲,2024-05-02,9857
1815,富喬,24,5,19,元大-蘆洲,2024-05-02,9857
3033,威健,47,30,17,元大-蘆洲,2024-05-02,9857
6177,達麗,46,29,17,元大-蘆洲,2024-05-02,9857
2497,怡利電,20,3,17,元大-蘆洲,2024-05-02,9857
6770,力積電,716,176,540,元大-蘆洲,2024-05-03,9857
1532,勤美,221,60,161,元大-蘆洲,2024-05-03,9857
1316,上曜,351,196,155,元大-蘆洲,2024-05-03,9857
2101,南港,168,57,111,元大-蘆洲,2024-05-03,9857
00650L,復華香港正2,125,24,101,元大-蘆洲,2024-05-03,9857
00795B,中信美國公債20年,97,3,94,元大-蘆洲,2024-05-03,9857
9945,潤泰新,153,64,89,元大-蘆洲,2024-05-03,9857
00937B,群益ESG投等債20,88,0,88,元大-蘆洲,2024-05-03,9857
00878,國泰永續高股息,96,13,83,元大-蘆洲,2024-05-03,9857
00687B,國泰20年美債,79,5,74,元大-蘆洲,2024-05-03,9857
2845,遠東銀,70,0,70,元大-蘆洲,2024-05-03,9857
2641,正德,62,5,57,元大-蘆洲,2024-05-03,9857
2511,太子,141,87,54,元大-蘆洲,2024-05-03,9857
2371,大同,104,54,50,元大-蘆洲,2024-05-03,9857
1514,亞力,63,15,48,元大-蘆洲,2024-05-03,9857
1540,喬福,47,2,45,元大-蘆洲,2024-05-03,9857
3231,緯創,88,46,42,元大-蘆洲,2024-05-03,9857
2537,聯上發,108,66,42,元大-蘆洲,2024-05-03,9857
5531,鄉林,187,147,40,元大-蘆洲,2024-05-03,9857
6120,達運,50,12,38,元大-蘆洲,2024-05-03,9857
2515,中工,111,73,38,元大-蘆洲,2024-05-03,9857
00933B,國泰10Y+金融債,37,0,37,元大-蘆洲,2024-05-03,9857
8112,至上,96,61,35,元大-蘆洲,2024-05-03,9857
2603,長榮,62,33,29,元大-蘆洲,2024-05-03,9857
1301,台塑,31,4,27,元大-蘆洲,2024-05-03,9857
1618,合機,52,26,26,元大-蘆洲,2024-05-03,9857
2331,精英,26,0,26,元大-蘆洲,2024-05-03,9857
1609,大亞,116,93,23,元大-蘆洲,2024-05-03,9857
2618,長榮航,277,254,23,元大-蘆洲,2024-05-03,9857
2313,華通,52,32,20,元大-蘆洲,2024-05-03,9857
1444,力麗,20,0,20,元大-蘆洲,2024-05-03,9857
2014,中鴻,23,5,18,元大-蘆洲,2024-05-03,9857
9940,信義,29,11,18,元大-蘆洲,2024-05-03,9857
5009,榮剛,63,46,17,元大-蘆洲,2024-05-03,9857
1817,凱撒衛,17,0,17,元大-蘆洲,2024-05-03,9857
8215,明基材,25,9,16,元大-蘆洲,2024-05-03,9857
3081,聯亞,16,1,15,元大-蘆洲,2024-05-03,9857
4513,福裕,15,0,15,元大-蘆洲,2024-05-03,9857
6442,光聖,84,69,15,元大-蘆洲,2024-05-03,9857
2206,三陽工業,19,4,15,元大-蘆洲,2024-05-03,9857
2834,臺企銀,17,2,15,元大-蘆洲,2024-05-03,9857
8096,擎亞,108,94,14,元大-蘆洲,2024-05-03,9857
3706,神達,17,3,14,元大-蘆洲,2024-05-03,9857
2356,英業達,16,2,14,元大-蘆洲,2024-05-03,9857
1611,中電,15,1,14,元大-蘆洲,2024-05-03,9857
2607,榮運,16,2,14,元大-蘆洲,2024-05-03,9857
4976,佳凌,14,0,14,元大-蘆洲,2024-05-03,9857
6712,長聖,15,1,14,元大-蘆洲,2024-05-03,9857
4714,永捷,80,67,13,元大-蘆洲,2024-05-03,9857
3025,星通,17,5,12,元大-蘆洲,2024-05-03,9857
00637L,元大滬深300正2,520,41,479,元大-蘆洲,2024-05-06,9857
00929,復華台灣科技優息,304,7,297,元大-蘆洲,2024-05-06,9857
00937B,群益ESG投等債20,219,53,166,元大-蘆洲,2024-05-06,9857
00632R,元大台灣50反1,362,201,161,元大-蘆洲,2024-05-06,9857
2618,長榮航,626,480,146,元大-蘆洲,2024-05-06,9857
2392,正崴,86,7,79,元大-蘆洲,2024-05-06,9857
00687B,國泰20年美債,75,11,64,元大-蘆洲,2024-05-06,9857
2316,楠梓電,74,16,58,元大-蘆洲,2024-05-06,9857
2417,圓剛,56,3,53,元大-蘆洲,2024-05-06,9857
1504,東元,79,27,52,元大-蘆洲,2024-05-06,9857
2515,中工,81,29,52,元大-蘆洲,2024-05-06,9857
5522,遠雄,74,23,51,元大-蘆洲,2024-05-06,9857
2449,京元電子,60,9,51,元大-蘆洲,2024-05-06,9857
00676R,富邦臺灣加權反1,50,0,50,元大-蘆洲,2024-05-06,9857
1102,亞泥,51,2,49,元大-蘆洲,2024-05-06,9857
00940,元大台灣價值高息,130,83,47,元大-蘆洲,2024-05-06,9857
3708,上緯投控,51,8,43,元大-蘆洲,2024-05-06,9857
2206,三陽工業,48,6,42,元大-蘆洲,2024-05-06,9857
9933,中鼎,65,24,41,元大-蘆洲,2024-05-06,9857
1314,中石化,57,21,36,元大-蘆洲,2024-05-06,9857
1414,東和,35,0,35,元大-蘆洲,2024-05-06,9857
2547,日勝生,36,3,33,元大-蘆洲,2024-05-06,9857
4303,信立,56,27,29,元大-蘆洲,2024-05-06,9857
6515,穎崴,32,3,29,元大-蘆洲,2024-05-06,9857
1101,台泥,50,23,27,元大-蘆洲,2024-05-06,9857
2363,矽統,64,37,27,元大-蘆洲,2024-05-06,9857
4967,十銓,41,15,26,元大-蘆洲,2024-05-06,9857
2002,中鋼,29,3,26,元大-蘆洲,2024-05-06,9857
00939,統一台灣高息動能,31,5,26,元大-蘆洲,2024-05-06,9857
6770,力積電,87,62,25,元大-蘆洲,2024-05-06,9857
6757,台灣虎航,25,0,25,元大-蘆洲,2024-05-06,9857
1442,名軒,27,3,24,元大-蘆洲,2024-05-06,9857
2409,友達,27,3,24,元大-蘆洲,2024-05-06,9857
6177,達麗,40,16,24,元大-蘆洲,2024-05-06,9857
00919,群益台灣精選高息,37,14,23,元大-蘆洲,2024-05-06,9857
00679B,元大美債20年,34,11,23,元大-蘆洲,2024-05-06,9857
6269,台郡,21,0,21,元大-蘆洲,2024-05-06,9857
3005,神基,27,6,21,元大-蘆洲,2024-05-06,9857
6120,達運,23,3,20,元大-蘆洲,2024-05-06,9857
1513,中興電,50,30,20,元大-蘆洲,2024-05-06,9857
00878,國泰永續高股息,60,42,18,元大-蘆洲,2024-05-06,9857
1618,合機,39,22,17,元大-蘆洲,2024-05-06,9857
5426,振發,18,1,17,元大-蘆洲,2024-05-06,9857
1434,福懋,20,3,17,元大-蘆洲,2024-05-06,9857
3025,星通,21,4,17,元大-蘆洲,2024-05-06,9857
2308,台達電,19,2,17,元大-蘆洲,2024-05-06,9857
00933B,國泰10Y+金融債,19,3,16,元大-蘆洲,2024-05-06,9857
1514,亞力,28,12,16,元大-蘆洲,2024-05-06,9857
2543,皇昌,66,51,15,元大-蘆洲,2024-05-06,9857
2371,大同,78,64,14,元大-蘆洲,2024-05-06,9857
00937B,群益ESG投等債20,351,28,323,元大-蘆洲,2024-05-07,9857
3481,群創,300,109,191,元大-蘆洲,2024-05-07,9857
00940,元大台灣價值高息,197,23,174,元大-蘆洲,2024-05-07,9857
00929,復華台灣科技優息,187,31,156,元大-蘆洲,2024-05-07,9857
2101,南港,113,11,102,元大-蘆洲,2024-05-07,9857
00878,國泰永續高股息,112,33,79,元大-蘆洲,2024-05-07,9857
2515,中工,114,42,72,元大-蘆洲,2024-05-07,9857
2002,中鋼,74,5,69,元大-蘆洲,2024-05-07,9857
2486,一詮,232,163,69,元大-蘆洲,2024-05-07,9857
1815,富喬,69,4,65,元大-蘆洲,2024-05-07,9857
00632R,元大台灣50反1,118,55,63,元大-蘆洲,2024-05-07,9857
1609,大亞,146,90,56,元大-蘆洲,2024-05-07,9857
3376,新日興,63,10,53,元大-蘆洲,2024-05-07,9857
5457,宣德,50,1,49,元大-蘆洲,2024-05-07,9857
2890,永豐金,52,5,47,元大-蘆洲,2024-05-07,9857
00720B,元大投資級公司債,54,7,47,元大-蘆洲,2024-05-07,9857
00753L,中信中國50正2,54,7,47,元大-蘆洲,2024-05-07,9857
3013,晟銘電,114,68,46,元大-蘆洲,2024-05-07,9857
2845,遠東銀,50,5,45,元大-蘆洲,2024-05-07,9857
8155,博智,40,1,39,元大-蘆洲,2024-05-07,9857
2606,裕民,55,17,38,元大-蘆洲,2024-05-07,9857
3466,德晉,77,40,37,元大-蘆洲,2024-05-07,9857
2883,凱基金,40,5,35,元大-蘆洲,2024-05-07,9857
5864,致和證,35,0,35,元大-蘆洲,2024-05-07,9857
00679B,元大美債20年,67,33,34,元大-蘆洲,2024-05-07,9857
5521,工信,35,1,34,元大-蘆洲,2024-05-07,9857
1618,合機,69,36,33,元大-蘆洲,2024-05-07,9857
1314,中石化,57,24,33,元大-蘆洲,2024-05-07,9857
2344,華邦電,60,28,32,元大-蘆洲,2024-05-07,9857
6290,良維,40,8,32,元大-蘆洲,2024-05-07,9857
00690,兆豐藍籌30,30,0,30,元大-蘆洲,2024-05-07,9857
00945B,凱基美國非投等債,27,0,27,元大-蘆洲,2024-05-07,9857
5871,中租-KY,26,0,26,元大-蘆洲,2024-05-07,9857
8070,長華*,25,0,25,元大-蘆洲,2024-05-07,9857
1304,台聚,28,3,25,元大-蘆洲,2024-05-07,9857
3372,典範,25,0,25,元大-蘆洲,2024-05-07,9857
8096,擎亞,151,127,24,元大-蘆洲,2024-05-07,9857
2603,長榮,119,96,23,元大-蘆洲,2024-05-07,9857
5531,鄉林,45,22,23,元大-蘆洲,2024-05-07,9857
8478,東哥遊艇,22,0,22,元大-蘆洲,2024-05-07,9857
2440,太空梭,24,2,22,元大-蘆洲,2024-05-07,9857
2601,益航,21,0,21,元大-蘆洲,2024-05-07,9857
8033,雷虎,36,17,19,元大-蘆洲,2024-05-07,9857
2356,英業達,27,8,19,元大-蘆洲,2024-05-07,9857
00919,群益台灣精選高息,34,15,19,元大-蘆洲,2024-05-07,9857
2501,國建,61,42,19,元大-蘆洲,2024-05-07,9857
2887,台新金,36,18,18,元大-蘆洲,2024-05-07,9857
1605,華新,34,16,18,元大-蘆洲,2024-05-07,9857
2610,華航,43,25,18,元大-蘆洲,2024-05-07,9857
6177,達麗,38,20,18,元大-蘆洲,2024-05-07,9857
2618,長榮航,488,135,353,元大-蘆洲,2024-05-08,9857
3481,群創,235,22,213,元大-蘆洲,2024-05-08,9857
00878,國泰永續高股息,423,222,201,元大-蘆洲,2024-05-08,9857
00940,元大台灣價值高息,227,72,155,元大-蘆洲,2024-05-08,9857
00929,復華台灣科技優息,202,73,129,元大-蘆洲,2024-05-08,9857
2317,鴻海,151,42,109,元大-蘆洲,2024-05-08,9857
5871,中租-KY,70,4,66,元大-蘆洲,2024-05-08,9857
3363,上詮,100,36,64,元大-蘆洲,2024-05-08,9857
5531,鄉林,61,1,60,元大-蘆洲,2024-05-08,9857
5512,力麒,71,12,59,元大-蘆洲,2024-05-08,9857
00679B,元大美債20年,89,34,55,元大-蘆洲,2024-05-08,9857
3712,永崴投控,53,1,52,元大-蘆洲,2024-05-08,9857
1612,宏泰,76,26,50,元大-蘆洲,2024-05-08,9857
6285,啟��,49,0,49,元大-蘆洲,2024-05-08,9857
00795B,中信美國公債20年,47,0,47,元大-蘆洲,2024-05-08,9857
2511,太子,41,1,40,元大-蘆洲,2024-05-08,9857
2880,華南金,44,4,40,元大-蘆洲,2024-05-08,9857
3033,威健,56,16,40,元大-蘆洲,2024-05-08,9857
00725B,國泰投資級公司債,40,1,39,元大-蘆洲,2024-05-08,9857
00688L,國泰20年美債正2,40,3,37,元大-蘆洲,2024-05-08,9857
2537,聯上發,36,1,35,元大-蘆洲,2024-05-08,9857
2867,三商壽,35,0,35,元大-蘆洲,2024-05-08,9857
2206,三陽工業,34,0,34,元大-蘆洲,2024-05-08,9857
00633L,富邦上証正2,33,0,33,元大-蘆洲,2024-05-08,9857
2377,微星,33,1,32,元大-蘆洲,2024-05-08,9857
6005,群益證,45,14,31,元大-蘆洲,2024-05-08,9857
5521,工信,34,3,31,元大-蘆洲,2024-05-08,9857
2464,盟立,38,8,30,元大-蘆洲,2024-05-08,9857
2641,正德,102,72,30,元大-蘆洲,2024-05-08,9857
6689,伊雲谷,30,0,30,元大-蘆洲,2024-05-08,9857
00687B,國泰20年美債,34,5,29,元大-蘆洲,2024-05-08,9857
00680L,元大美債20正2,113,85,28,元大-蘆洲,2024-05-08,9857
2501,國建,61,33,28,元大-蘆洲,2024-05-08,9857
8927,北基,27,0,27,元大-蘆洲,2024-05-08,9857
0056,元大高股息,31,4,27,元大-蘆洲,2024-05-08,9857
2609,陽明,123,98,25,元大-蘆洲,2024-05-08,9857
3036,文曄,25,1,24,元大-蘆洲,2024-05-08,9857
5515,建國,27,3,24,元大-蘆洲,2024-05-08,9857
4967,十銓,115,93,22,元大-蘆洲,2024-05-08,9857
5522,遠雄,29,7,22,元大-蘆洲,2024-05-08,9857
6120,達運,22,0,22,元大-蘆洲,2024-05-08,9857
2002,中鋼,34,12,22,元大-蘆洲,2024-05-08,9857
1785,光洋科,29,8,21,元大-蘆洲,2024-05-08,9857
4760,勤凱,21,1,20,元大-蘆洲,2024-05-08,9857
2374,佳能,176,157,19,元大-蘆洲,2024-05-08,9857
2402,毅嘉,23,4,19,元大-蘆洲,2024-05-08,9857
6139,亞翔,42,23,19,元大-蘆洲,2024-05-08,9857
5608,四維航,58,39,19,元大-蘆洲,2024-05-08,9857
2855,統一證,18,0,18,元大-蘆洲,2024-05-08,9857
3260,威剛,63,45,18,元大-蘆洲,2024-05-08,9857
00937B,群益ESG投等債20,523,50,473,元大-蘆洲,2024-05-09,9857
2206,三陽工業,299,1,298,元大-蘆洲,2024-05-09,9857
00878,國泰永續高股息,288,51,237,元大-蘆洲,2024-05-09,9857
00946,群益科技高息成長,170,0,170,元大-蘆洲,2024-05-09,9857
2367,燿華,398,235,163,元大-蘆洲,2024-05-09,9857
00929,復華台灣科技優息,167,5,162,元大-蘆洲,2024-05-09,9857
00944,野村趨勢動能高息,94,0,94,元大-蘆洲,2024-05-09,9857
00919,群益台灣精選高息,89,4,85,元大-蘆洲,2024-05-09,9857
00945B,凱基美國非投等債,77,0,77,元大-蘆洲,2024-05-09,9857
2611,志信,73,8,65,元大-蘆洲,2024-05-09,9857
3047,訊舟,75,12,63,元大-蘆洲,2024-05-09,9857
3231,緯創,89,29,60,元大-蘆洲,2024-05-09,9857
2371,大同,106,52,54,元大-蘆洲,2024-05-09,9857
00795B,中信美國公債20年,52,2,50,元大-蘆洲,2024-05-09,9857
2888,新光金,139,90,49,元大-蘆洲,2024-05-09,9857
2618,長榮航,222,175,47,元大-蘆洲,2024-05-09,9857
2354,鴻準,56,13,43,元大-蘆洲,2024-05-09,9857
4402,郡都開發,39,0,39,元大-蘆洲,2024-05-09,9857
3481,群創,43,6,37,元大-蘆洲,2024-05-09,9857
1540,喬福,37,0,37,元大-蘆洲,2024-05-09,9857
1101,台泥,36,2,34,元大-蘆洲,2024-05-09,9857
2031,新光鋼,31,0,31,元大-蘆洲,2024-05-09,9857
8928,鉅明,30,0,30,元大-蘆洲,2024-05-09,9857
3037,欣興,55,26,29,元大-蘆洲,2024-05-09,9857
8112,至上,39,9,30,元大-蘆洲,2024-05-09,9857
3615,安可,29,0,29,元大-蘆洲,2024-05-09,9857
5388,中磊,36,8,28,元大-蘆洲,2024-05-09,9857
8110,華東,36,8,28,元大-蘆洲,2024-05-09,9857
5469,瀚宇博,27,0,27,元大-蘆洲,2024-05-09,9857
8089,康全電訊,36,10,26,元大-蘆洲,2024-05-09,9857
2344,華邦電,26,1,25,元大-蘆洲,2024-05-09,9857
3036,文曄,38,13,25,元大-蘆洲,2024-05-09,9857
2610,華航,91,66,25,元大-蘆洲,2024-05-09,9857
3260,威剛,116,92,24,元大-蘆洲,2024-05-09,9857
5871,中租-KY,25,1,24,元大-蘆洲,2024-05-09,9857
2457,飛宏,25,1,24,元大-蘆洲,2024-05-09,9857
00679B,元大美債20年,24,1,23,元大-蘆洲,2024-05-09,9857
1444,力麗,23,0,23,元大-蘆洲,2024-05-09,9857
2409,友達,22,0,22,元大-蘆洲,2024-05-09,9857
2889,國票金,26,4,22,元大-蘆洲,2024-05-09,9857
2506,太設,23,1,22,元大-蘆洲,2024-05-09,9857
6139,亞翔,63,42,21,元大-蘆洲,2024-05-09,9857
2606,裕民,67,46,21,元大-蘆洲,2024-05-09,9857
2303,聯電,40,19,21,元大-蘆洲,2024-05-09,9857
1612,宏泰,26,6,20,元大-蘆洲,2024-05-09,9857
2027,大成鋼,21,1,20,元大-蘆洲,2024-05-09,9857
2101,南港,33,15,18,元大-蘆洲,2024-05-09,9857
2365,昆盈,28,11,17,元大-蘆洲,2024-05-09,9857
3024,憶聲,17,0,17,元大-蘆洲,2024-05-09,9857
1808,潤隆,17,1,16,元大-蘆洲,2024-05-09,9857
9904,寶成,259,1,258,元大-蘆洲,2024-05-10,9857
00885,富邦越南,216,0,216,元大-蘆洲,2024-05-10,9857
00929,復華台灣科技優息,361,145,216,元大-蘆洲,2024-05-10,9857
00680L,元大美債20正2,202,25,177,元大-蘆洲,2024-05-10,9857
00632R,元大台灣50反1,123,0,123,元大-蘆洲,2024-05-10,9857
00919,群益台灣精選高息,118,40,78,元大-蘆洲,2024-05-10,9857
00753L,中信中國50正2,75,1,74,元大-蘆洲,2024-05-10,9857
00650L,復華香港正2,69,0,69,元大-蘆洲,2024-05-10,9857
00946,群益科技高息成長,90,22,68,元大-蘆洲,2024-05-10,9857
2317,鴻海,147,88,59,元大-蘆洲,2024-05-10,9857
5457,宣德,51,0,51,元大-蘆洲,2024-05-10,9857
00676R,富邦臺灣加權反1,50,0,50,元大-蘆洲,2024-05-10,9857
2313,華通,82,34,48,元大-蘆洲,2024-05-10,9857
3013,晟銘電,125,81,44,元大-蘆洲,2024-05-10,9857
2605,新興,71,30,41,元大-蘆洲,2024-05-10,9857
8011,台通,37,0,37,元大-蘆洲,2024-05-10,9857
4960,誠美材,43,11,32,元大-蘆洲,2024-05-10,9857
00915,凱基優選高股息30,30,0,30,元大-蘆洲,2024-05-10,9857
3481,群創,82,52,30,元大-蘆洲,2024-05-10,9857
2101,南港,35,6,29,元大-蘆洲,2024-05-10,9857
2409,友達,32,3,29,元大-蘆洲,2024-05-10,9857
1815,富喬,54,27,27,元大-蘆洲,2024-05-10,9857
2008,高興昌,25,0,25,元大-蘆洲,2024-05-10,9857
2534,宏盛,22,0,22,元大-蘆洲,2024-05-10,9857
2545,皇翔,27,5,22,元大-蘆洲,2024-05-10,9857
6239,力成,22,2,20,元大-蘆洲,2024-05-10,9857
2457,飛宏,24,4,20,元大-蘆洲,2024-05-10,9857
7402,邑錡,20,0,20,元大-蘆洲,2024-05-10,9857
1785,光洋科,25,5,20,元大-蘆洲,2024-05-10,9857
9934,成霖,20,1,19,元大-蘆洲,2024-05-10,9857
2420,新巨,20,1,19,元大-蘆洲,2024-05-10,9857
3615,安可,19,0,19,元大-蘆洲,2024-05-10,9857
2388,威盛,38,19,19,元大-蘆洲,2024-05-10,9857
1440,南紡,19,1,18,元大-蘆洲,2024-05-10,9857
2537,聯上發,28,10,18,元大-蘆洲,2024-05-10,9857
5871,中租-KY,19,3,16,元大-蘆洲,2024-05-10,9857
2611,志信,23,7,16,元大-蘆洲,2024-05-10,9857
00933B,國泰10Y+金融債,22,6,16,元大-蘆洲,2024-05-10,9857
1605,華新,20,4,16,元大-蘆洲,2024-05-10,9857
3260,威剛,75,59,16,元大-蘆洲,2024-05-10,9857
00715L,期街口布蘭特正2,27,12,15,元大-蘆洲,2024-05-10,9857
3036,文曄,19,5,14,元大-蘆洲,2024-05-10,9857
8083,瑞穎,14,0,14,元大-蘆洲,2024-05-10,9857
3376,新日興,33,19,14,元大-蘆洲,2024-05-10,9857
2464,盟立,14,1,13,元大-蘆洲,2024-05-10,9857
3402,漢科,13,1,12,元大-蘆洲,2024-05-10,9857
2612,中航,37,25,12,元大-蘆洲,2024-05-10,9857
6026,福邦證,12,0,12,元大-蘆洲,2024-05-10,9857
00637L,元大滬深300正2,22,10,12,元大-蘆洲,2024-05-10,9857
2427,三商電,14,2,12,元大-蘆洲,2024-05-10,9857
00937B,群益ESG投等債20,312,0,312,元大-蘆洲,2024-05-13,9857
00929,復華台灣科技優息,356,120,236,元大-蘆洲,2024-05-13,9857
5608,四維航,239,82,157,元大-蘆洲,2024-05-13,9857
00919,群益台灣精選高息,167,14,153,元大-蘆洲,2024-05-13,9857
00632R,元大台灣50反1,325,211,114,元大-蘆洲,2024-05-13,9857
2618,長榮航,325,211,114,元大-蘆洲,2024-05-13,9857
00878,國泰永續高股息,103,23,80,元大-蘆洲,2024-05-13,9857
3481,群創,207,134,73,元大-蘆洲,2024-05-13,9857
2344,華邦電,66,0,66,元大-蘆洲,2024-05-13,9857
1522,堤維西,116,53,63,元大-蘆洲,2024-05-13,9857
3376,新日興,76,15,61,元大-蘆洲,2024-05-13,9857
2634,漢翔,71,10,61,元大-蘆洲,2024-05-13,9857
2615,萬海,335,276,59,元大-蘆洲,2024-05-13,9857
6139,亞翔,62,4,58,元大-蘆洲,2024-05-13,9857
2308,台達電,65,7,58,元大-蘆洲,2024-05-13,9857
00795B,中信美國公債20年,56,0,56,元大-蘆洲,2024-05-13,9857
2882,國泰金,67,12,55,元大-蘆洲,2024-05-13,9857
6757,台灣虎航,56,1,55,元大-蘆洲,2024-05-13,9857
2537,聯上發,74,20,54,元大-蘆洲,2024-05-13,9857
9904,寶成,56,5,51,元大-蘆洲,2024-05-13,9857
2888,新光金,59,9,50,元大-蘆洲,2024-05-13,9857
3231,緯創,74,26,48,元大-蘆洲,2024-05-13,9857
2641,正德,128,82,46,元大-蘆洲,2024-05-13,9857
4960,誠美材,53,8,45,元大-蘆洲,2024-05-13,9857
2606,裕民,297,253,44,元大-蘆洲,2024-05-13,9857
2636,台驊控股,69,29,40,元大-蘆洲,2024-05-13,9857
1314,中石化,74,35,39,元大-蘆洲,2024-05-13,9857
2881,富邦金,42,4,38,元大-蘆洲,2024-05-13,9857
1524,耿鼎,45,13,32,元大-蘆洲,2024-05-13,9857
00715L,期街口布蘭特正2,36,5,31,元大-蘆洲,2024-05-13,9857
2883,凱基金,53,23,30,元大-蘆洲,2024-05-13,9857
1312,國喬,34,6,28,元大-蘆洲,2024-05-13,9857
00679B,元大美債20年,39,12,27,元大-蘆洲,2024-05-13,9857
2884,玉山金,27,1,26,元大-蘆洲,2024-05-13,9857
5392,能率,48,23,25,元大-蘆洲,2024-05-13,9857
2206,三陽工業,58,34,24,元大-蘆洲,2024-05-13,9857
00946,群益科技高息成長,31,7,24,元大-蘆洲,2024-05-13,9857
2892,第一金,30,6,24,元大-蘆洲,2024-05-13,9857
4562,穎漢,66,42,24,元大-蘆洲,2024-05-13,9857
1513,中興電,59,36,23,元大-蘆洲,2024-05-13,9857
1815,富喬,70,48,22,元大-蘆洲,2024-05-13,9857
00687B,國泰20年美債,24,3,21,元大-蘆洲,2024-05-13,9857
3051,力特,21,0,21,元大-蘆洲,2024-05-13,9857
2520,冠德,43,23,20,元大-蘆洲,2024-05-13,9857
00637L,元大滬深300正2,21,2,19,元大-蘆洲,2024-05-13,9857
8011,台通,22,3,19,元大-蘆洲,2024-05-13,9857
8085,福華,19,0,19,元大-蘆洲,2024-05-13,9857
3044,健鼎,30,11,19,元大-蘆洲,2024-05-13,9857
1503,士電,32,14,18,元大-蘆洲,2024-05-13,9857
3711,日月光投控,18,0,18,元大-蘆洲,2024-05-13,9857
2609,陽明,931,525,406,元大-蘆洲,2024-05-14,9857
5009,榮剛,269,3,266,元大-蘆洲,2024-05-14,9857
00933B,國泰10Y+金融債,121,2,119,元大-蘆洲,2024-05-14,9857
00937B,群益ESG投等債20,108,1,107,元大-蘆洲,2024-05-14,9857
3047,訊舟,162,60,102,元大-蘆洲,2024-05-14,9857
6451,訊芯-KY,95,4,91,元大-蘆洲,2024-05-14,9857
2892,第一金,85,0,85,元大-蘆洲,2024-05-14,9857
2101,南港,67,3,64,元大-蘆洲,2024-05-14,9857
00753L,中信中國50正2,60,0,60,元大-蘆洲,2024-05-14,9857
2887,台新金,49,1,48,元大-蘆洲,2024-05-14,9857
1522,堤維西,152,115,37,元大-蘆洲,2024-05-14,9857
3231,緯創,45,10,35,元大-蘆洲,2024-05-14,9857
2834,臺企銀,35,5,30,元大-蘆洲,2024-05-14,9857
1582,信錦,29,0,29,元大-蘆洲,2024-05-14,9857
2606,裕民,52,24,28,元大-蘆洲,2024-05-14,9857
2374,佳能,362,334,28,元大-蘆洲,2024-05-14,9857
9945,潤泰新,63,36,27,元大-蘆洲,2024-05-14,9857
00878,國泰永續高股息,88,62,26,元大-蘆洲,2024-05-14,9857
5371,中光電,58,33,25,元大-蘆洲,2024-05-14,9857
1101,台泥,24,3,21,元大-蘆洲,2024-05-14,9857
2890,永豐金,22,1,21,元大-蘆洲,2024-05-14,9857
5871,中租-KY,22,1,21,元大-蘆洲,2024-05-14,9857
3051,力特,20,0,20,元大-蘆洲,2024-05-14,9857
2427,三商電,31,11,20,元大-蘆洲,2024-05-14,9857
2883,凱基金,30,10,20,元大-蘆洲,2024-05-14,9857
6168,宏齊,20,0,20,元大-蘆洲,2024-05-14,9857
1513,中興電,56,37,19,元大-蘆洲,2024-05-14,9857
2884,玉山金,19,0,19,元大-蘆洲,2024-05-14,9857
2031,新光鋼,20,2,18,元大-蘆洲,2024-05-14,9857
00929,復華台灣科技優息,42,24,18,元大-蘆洲,2024-05-14,9857
5475,德宏,17,0,17,元大-蘆洲,2024-05-14,9857
2610,華航,58,41,17,元大-蘆洲,2024-05-14,9857
8927,北基,16,0,16,元大-蘆洲,2024-05-14,9857
8070,長華*,18,2,16,元大-蘆洲,2024-05-14,9857
2615,萬海,678,662,16,元大-蘆洲,2024-05-14,9857
2630,亞航,22,7,15,元大-蘆洲,2024-05-14,9857
00637L,元大滬深300正2,19,4,15,元大-蘆洲,2024-05-14,9857
00946,群益科技高息成長,16,1,15,元大-蘆洲,2024-05-14,9857
2206,三陽工業,59,44,15,元大-蘆洲,2024-05-14,9857
2636,台驊控股,29,15,14,元大-蘆洲,2024-05-14,9857
2323,中環,17,3,14,元大-蘆洲,2024-05-14,9857
5351,鈺創,19,5,14,元大-蘆洲,2024-05-14,9857
2534,宏盛,12,0,12,元大-蘆洲,2024-05-14,9857
1529,樂事綠能,12,0,12,元大-蘆洲,2024-05-14,9857
6462,神盾,25,13,12,元大-蘆洲,2024-05-14,9857
2634,漢翔,23,12,11,元大-蘆洲,2024-05-14,9857
3016,嘉晶,11,0,11,元大-蘆洲,2024-05-14,9857
2612,中航,14,3,11,元大-蘆洲,2024-05-14,9857
2542,興富發,13,2,11,元大-蘆洲,2024-05-14,9857
1731,美吾華,11,0,11,元大-蘆洲,2024-05-14,9857
00632R,元大台灣50反1,530,93,437,元大-蘆洲,2024-05-15,9857
00878,國泰永續高股息,361,75,286,元大-蘆洲,2024-05-15,9857
00937B,群益ESG投等債20,193,19,174,元大-蘆洲,2024-05-15,9857
4533,協易機,194,56,138,元大-蘆洲,2024-05-15,9857
00919,群益台灣精選高息,128,36,92,元大-蘆洲,2024-05-15,9857
00929,復華台灣科技優息,192,105,87,元大-蘆洲,2024-05-15,9857
2356,英業達,208,136,72,元大-蘆洲,2024-05-15,9857
00857B,永豐20年美公債,83,11,72,元大-蘆洲,2024-05-15,9857
1310,台苯,70,3,67,元大-蘆洲,2024-05-15,9857
2323,中環,70,11,59,元大-蘆洲,2024-05-15,9857
2601,益航,61,4,57,元大-蘆洲,2024-05-15,9857
2542,興富發,59,3,56,元大-蘆洲,2024-05-15,9857
2371,大同,72,18,54,元大-蘆洲,2024-05-15,9857
00720B,元大投資級公司債,62,10,52,元大-蘆洲,2024-05-15,9857
1312,國喬,73,25,48,元大-蘆洲,2024-05-15,9857
2367,燿華,554,510,44,元大-蘆洲,2024-05-15,9857
2025,千興,41,0,41,元大-蘆洲,2024-05-15,9857
00940,元大台灣價值高息,204,164,40,元大-蘆洲,2024-05-15,9857
2481,強茂,40,0,40,元大-蘆洲,2024-05-15,9857
00679B,元大美債20年,43,4,39,元大-蘆洲,2024-05-15,9857
2547,日勝生,42,3,39,元大-蘆洲,2024-05-15,9857
6451,訊芯-KY,46,10,36,元大-蘆洲,2024-05-15,9857
1440,南紡,40,5,35,元大-蘆洲,2024-05-15,9857
8054,安國,73,40,33,元大-蘆洲,2024-05-15,9857
2405,輔信,84,54,30,元大-蘆洲,2024-05-15,9857
5515,建國,40,10,30,元大-蘆洲,2024-05-15,9857
2352,佳世達,30,2,28,元大-蘆洲,2024-05-15,9857
2002,中鋼,33,5,28,元大-蘆洲,2024-05-15,9857
8927,北基,27,0,27,元大-蘆洲,2024-05-15,9857
00945B,凱基美國非投等債,25,0,25,元大-蘆洲,2024-05-15,9857
3376,新日興,38,13,25,元大-蘆洲,2024-05-15,9857
2362,藍天,27,3,24,元大-蘆洲,2024-05-15,9857
6264,富裔,23,0,23,元大-蘆洲,2024-05-15,9857
3234,光環,25,2,23,元大-蘆洲,2024-05-15,9857
2603,長榮,66,43,23,元大-蘆洲,2024-05-15,9857
6125,廣運,46,24,22,元大-蘆洲,2024-05-15,9857
00933B,國泰10Y+金融債,24,3,21,元大-蘆洲,2024-05-15,9857
2363,矽統,98,77,21,元大-蘆洲,2024-05-15,9857
3706,神達,62,42,20,元大-蘆洲,2024-05-15,9857
4967,十銓,33,13,20,元大-蘆洲,2024-05-15,9857
3689,湧德,28,8,20,元大-蘆洲,2024-05-15,9857
2834,臺企銀,28,8,20,元大-蘆洲,2024-05-15,9857
4121,優盛,20,0,20,元大-蘆洲,2024-05-15,9857
00669R,國泰美國道瓊反1,20,0,20,元大-蘆洲,2024-05-15,9857
2401,凌陽,19,0,19,元大-蘆洲,2024-05-15,9857
5531,鄉林,24,5,19,元大-蘆洲,2024-05-15,9857
912000,晨訊科-DR,17,0,17,元大-蘆洲,2024-05-15,9857
00687B,國泰20年美債,28,11,17,元大-蘆洲,2024-05-15,9857
00946,群益科技高息成長,16,0,16,元大-蘆洲,2024-05-15,9857
2376,技嘉,30,14,16,元大-蘆洲,2024-05-15,9857
00878,國泰永續高股息,502,117,385,元大-蘆洲,2024-05-16,9857
2353,宏��,276,144,132,元大-蘆洲,2024-05-16,9857
2356,英業達,181,65,116,元大-蘆洲,2024-05-16,9857
4968,立積,114,20,94,元大-蘆洲,2024-05-16,9857
2101,南港,112,19,93,元大-蘆洲,2024-05-16,9857
00632R,元大台灣50反1,211,120,91,元大-蘆洲,2024-05-16,9857
00937B,群益ESG投等債20,236,148,88,元大-蘆洲,2024-05-16,9857
00637L,元大滬深300正2,110,22,88,元大-蘆洲,2024-05-16,9857
2382,廣達,108,29,79,元大-蘆洲,2024-05-16,9857
3231,緯創,137,62,75,元大-蘆洲,2024-05-16,9857
3481,群創,159,91,68,元大-蘆洲,2024-05-16,9857
6451,訊芯-KY,68,8,60,元大-蘆洲,2024-05-16,9857
2913,農林,53,0,53,元大-蘆洲,2024-05-16,9857
2524,京城,48,0,48,元大-蘆洲,2024-05-16,9857
00753L,中信中國50正2,45,4,41,元大-蘆洲,2024-05-16,9857
3266,昇陽,40,0,40,元大-蘆洲,2024-05-16,9857
1316,上曜,43,5,38,元大-蘆洲,2024-05-16,9857
3260,威剛,38,2,36,元大-蘆洲,2024-05-16,9857
2359,所羅門,165,132,33,元大-蘆洲,2024-05-16,9857
3047,訊舟,191,162,29,元大-蘆洲,2024-05-16,9857
2547,日勝生,39,10,29,元大-蘆洲,2024-05-16,9857
00724B,群益投資級金融債,29,0,29,元大-蘆洲,2024-05-16,9857
1612,宏泰,29,4,25,元大-蘆洲,2024-05-16,9857
2464,盟立,54,29,25,元大-蘆洲,2024-05-16,9857
2887,台新金,35,12,23,元大-蘆洲,2024-05-16,9857
3030,德律,33,11,22,元大-蘆洲,2024-05-16,9857
2882,國泰金,39,18,21,元大-蘆洲,2024-05-16,9857
2615,萬海,47,26,21,元大-蘆洲,2024-05-16,9857
2417,圓剛,22,1,21,元大-蘆洲,2024-05-16,9857
00795B,中信美國公債20年,32,11,21,元大-蘆洲,2024-05-16,9857
2365,昆盈,97,77,20,元大-蘆洲,2024-05-16,9857
00926,凱基全球菁英55,20,0,20,元大-蘆洲,2024-05-16,9857
020020,元大台股領航N,20,0,20,元大-蘆洲,2024-05-16,9857
2453,凌群,28,9,19,元大-蘆洲,2024-05-16,9857
2634,漢翔,23,5,18,元大-蘆洲,2024-05-16,9857
1532,勤美,27,9,18,元大-蘆洲,2024-05-16,9857
00946,群益科技高息成長,18,0,18,元大-蘆洲,2024-05-16,9857
2331,精英,45,27,18,元大-蘆洲,2024-05-16,9857
5515,建國,26,8,18,元大-蘆洲,2024-05-16,9857
6215,和椿,26,9,17,元大-蘆洲,2024-05-16,9857
2451,創見,19,2,17,元大-蘆洲,2024-05-16,9857
1608,華榮,47,31,16,元大-蘆洲,2024-05-16,9857
2392,正崴,17,1,16,元大-蘆洲,2024-05-16,9857
00679B,元大美債20年,55,39,16,元大-蘆洲,2024-05-16,9857
2301,光寶科,20,4,16,元大-蘆洲,2024-05-16,9857
2317,鴻海,178,163,15,元大-蘆洲,2024-05-16,9857
00631L,元大台灣50正2,18,3,15,元大-蘆洲,2024-05-16,9857
2527,宏璟,25,10,15,元大-蘆洲,2024-05-16,9857
4513,福裕,23,8,15,元大-蘆洲,2024-05-16,9857
00882,中信中國高股息,130,115,15,元大-蘆洲,2024-05-16,9857
00878,國泰永續高股息,335,17,318,元大-蘆洲,2024-05-17,9857
00929,復華台灣科技優息,277,37,240,元大-蘆洲,2024-05-17,9857
00937B,群益ESG投等債20,175,21,154,元大-蘆洲,2024-05-17,9857
2610,華航,350,244,106,元大-蘆洲,2024-05-17,9857
2367,燿華,277,177,100,元大-蘆洲,2024-05-17,9857
3481,群創,120,24,96,元大-蘆洲,2024-05-17,9857
1312,國喬,95,6,89,元大-蘆洲,2024-05-17,9857
2618,長榮航,224,138,86,元大-蘆洲,2024-05-17,9857
1455,集盛,80,0,80,元大-蘆洲,2024-05-17,9857
2609,陽明,177,99,78,元大-蘆洲,2024-05-17,9857
2605,新興,97,20,77,元大-蘆洲,2024-05-17,9857
2317,鴻海,127,51,76,元大-蘆洲,2024-05-17,9857
00687B,國泰20年美債,89,16,73,元大-蘆洲,2024-05-17,9857
1314,中石化,79,13,66,元大-蘆洲,2024-05-17,9857
2882,國泰金,68,8,60,元大-蘆洲,2024-05-17,9857
2501,國建,75,16,59,元大-蘆洲,2024-05-17,9857
3047,訊舟,131,74,57,元大-蘆洲,2024-05-17,9857
00919,群益台灣精選高息,64,9,55,元大-蘆洲,2024-05-17,9857
3059,華晶科,212,161,51,元大-蘆洲,2024-05-17,9857
00679B,元大美債20年,45,2,43,元大-蘆洲,2024-05-17,9857
1326,台化,41,0,41,元大-蘆洲,2024-05-17,9857
00795B,中信美國公債20年,40,0,40,元大-蘆洲,2024-05-17,9857
00753L,中信中國50正2,75,41,34,元大-蘆洲,2024-05-17,9857
2838,聯邦銀,32,0,32,元大-蘆洲,2024-05-17,9857
5388,中磊,31,0,31,元大-蘆洲,2024-05-17,9857
3231,緯創,44,13,31,元大-蘆洲,2024-05-17,9857
1310,台苯,30,0,30,元大-蘆洲,2024-05-17,9857
2002,中鋼,31,3,28,元大-蘆洲,2024-05-17,9857
3706,神達,41,13,28,元大-蘆洲,2024-05-17,9857
3060,銘異,57,31,26,元大-蘆洲,2024-05-17,9857
9103,美德醫療-DR,27,1,26,元大-蘆洲,2024-05-17,9857
1609,大亞,44,18,26,元大-蘆洲,2024-05-17,9857
6288,聯嘉,24,0,24,元大-蘆洲,2024-05-17,9857
00936,台新永續高息中小,23,0,23,元大-蘆洲,2024-05-17,9857
1303,南亞,26,3,23,元大-蘆洲,2024-05-17,9857
2020,美亞,23,0,23,元大-蘆洲,2024-05-17,9857
6133,金橋,23,0,23,元大-蘆洲,2024-05-17,9857
2888,新光金,40,17,23,元大-蘆洲,2024-05-17,9857
00637L,元大滬深300正2,23,2,21,元大-蘆洲,2024-05-17,9857
5469,瀚宇博,22,1,21,元大-蘆洲,2024-05-17,9857
5392,能率,109,88,21,元大-蘆洲,2024-05-17,9857
2417,圓剛,46,25,21,元大-蘆洲,2024-05-17,9857
1815,富喬,39,19,20,元大-蘆洲,2024-05-17,9857
2009,第一銅,22,2,20,元大-蘆洲,2024-05-17,9857
5483,中美晶,20,0,20,元大-蘆洲,2024-05-17,9857
2834,臺企銀,19,1,18,元大-蘆洲,2024-05-17,9857
00669R,國泰美國道瓊反1,18,0,18,元大-蘆洲,2024-05-17,9857
4956,光鋐,32,14,18,元大-蘆洲,2024-05-17,9857
2301,光寶科,20,2,18,元大-蘆洲,2024-05-17,9857
2365,昆盈,42,25,17,元大-蘆洲,2024-05-17,9857
00929,復華台灣科技優息,509,39,470,元大-蘆洲,2024-05-20,9857
2618,長榮航,621,448,173,元大-蘆洲,2024-05-20,9857
00937B,群益ESG投等債20,176,12,164,元大-蘆洲,2024-05-20,9857
00940,元大台灣價值高息,401,252,149,元大-蘆洲,2024-05-20,9857
3033,威健,133,42,91,元大-蘆洲,2024-05-20,9857
6188,廣明,126,42,84,元大-蘆洲,2024-05-20,9857
00637L,元大滬深300正2,102,28,74,元大-蘆洲,2024-05-20,9857
2363,矽統,237,167,70,元大-蘆洲,2024-05-20,9857
2867,三商壽,146,77,69,元大-蘆洲,2024-05-20,9857
3231,緯創,87,22,65,元大-蘆洲,2024-05-20,9857
4533,協易機,715,652,63,元大-蘆洲,2024-05-20,9857
00753L,中信中國50正2,65,5,60,元大-蘆洲,2024-05-20,9857
00679B,元大美債20年,63,3,60,元大-蘆洲,2024-05-20,9857
6166,凌華,54,0,54,元大-蘆洲,2024-05-20,9857
1447,力鵬,55,2,53,元大-蘆洲,2024-05-20,9857
1608,華榮,128,77,51,元大-蘆洲,2024-05-20,9857
2206,三陽工業,47,3,44,元大-蘆洲,2024-05-20,9857
00939,統一台灣高息動能,94,51,43,元大-蘆洲,2024-05-20,9857
00680L,元大美債20正2,46,5,41,元大-蘆洲,2024-05-20,9857
2888,新光金,112,73,39,元大-蘆洲,2024-05-20,9857
5009,榮剛,41,2,39,元大-蘆洲,2024-05-20,9857
00933B,國泰10Y+金融債,51,15,36,元大-蘆洲,2024-05-20,9857
00725B,國泰投資級公司債,35,0,35,元大-蘆洲,2024-05-20,9857
2101,南港,41,7,34,元大-蘆洲,2024-05-20,9857
2359,所羅門,168,136,32,元大-蘆洲,2024-05-20,9857
2880,華南金,32,0,32,元大-蘆洲,2024-05-20,9857
2352,佳世達,36,4,32,元大-蘆洲,2024-05-20,9857
2317,鴻海,130,98,32,元大-蘆洲,2024-05-20,9857
2607,榮運,31,0,31,元大-蘆洲,2024-05-20,9857
00885,富邦越南,30,0,30,元大-蘆洲,2024-05-20,9857
2613,中櫃,31,1,30,元大-蘆洲,2024-05-20,9857
00671R,富邦NASDAQ反1,30,0,30,元大-蘆洲,2024-05-20,9857
00946,群益科技高息成長,30,1,29,元大-蘆洲,2024-05-20,9857
00687B,國泰20年美債,45,17,28,元大-蘆洲,2024-05-20,9857
5324,士開,40,12,28,元大-蘆洲,2024-05-20,9857
9904,寶成,43,15,28,元大-蘆洲,2024-05-20,9857
8033,雷虎,28,1,27,元大-蘆洲,2024-05-20,9857
2406,國碩,48,21,27,元大-蘆洲,2024-05-20,9857
2367,燿華,229,203,26,元大-蘆洲,2024-05-20,9857
00650L,復華香港正2,27,1,26,元大-蘆洲,2024-05-20,9857
2449,京元電子,38,12,26,元大-蘆洲,2024-05-20,9857
3481,群創,43,18,25,元大-蘆洲,2024-05-20,9857
2897,王道銀行,27,3,24,元大-蘆洲,2024-05-20,9857
00632R,元大台灣50反1,128,104,24,元大-蘆洲,2024-05-20,9857
3024,憶聲,23,0,23,元大-蘆洲,2024-05-20,9857
2356,英業達,33,10,23,元大-蘆洲,2024-05-20,9857
6264,富裔,22,0,22,元大-蘆洲,2024-05-20,9857
4107,邦特,22,0,22,元大-蘆洲,2024-05-20,9857
1609,大亞,82,60,22,元大-蘆洲,2024-05-20,9857
2365,昆盈,24,3,21,元大-蘆洲,2024-05-20,9857
00878,國泰永續高股息,446,93,353,元大-蘆洲,2024-05-21,9857
00929,復華台灣科技優息,303,102,201,元大-蘆洲,2024-05-21,9857
00632R,元大台灣50反1,234,50,184,元大-蘆洲,2024-05-21,9857
00940,元大台灣價值高息,253,95,158,元大-蘆洲,2024-05-21,9857
00795B,中信美國公債20年,107,0,107,元大-蘆洲,2024-05-21,9857
3576,聯合再生,106,1,105,元大-蘆洲,2024-05-21,9857
00753L,中信中國50正2,121,18,103,元大-蘆洲,2024-05-21,9857
00706L,期元大S＆P日圓正2,100,0,100,元大-蘆洲,2024-05-21,9857
2892,第一金,96,5,91,元大-蘆洲,2024-05-21,9857
3481,群創,96,18,78,元大-蘆洲,2024-05-21,9857
5469,瀚宇博,81,6,75,元大-蘆洲,2024-05-21,9857
2354,鴻準,197,124,73,元大-蘆洲,2024-05-21,9857
00650L,復華香港正2,67,5,62,元大-蘆洲,2024-05-21,9857
00919,群益台灣精選高息,84,23,61,元大-蘆洲,2024-05-21,9857
2887,台新金,76,15,61,元大-蘆洲,2024-05-21,9857
00679B,元大美債20年,57,0,57,元大-蘆洲,2024-05-21,9857
3059,華晶科,76,22,54,元大-蘆洲,2024-05-21,9857
00918,大華優利高填息30,58,7,51,元大-蘆洲,2024-05-21,9857
3609,三一東林,50,0,50,元大-蘆洲,2024-05-21,9857
2609,陽明,67,17,50,元大-蘆洲,2024-05-21,9857
00725B,國泰投資級公司債,45,0,45,元大-蘆洲,2024-05-21,9857
5608,四維航,45,1,44,元大-蘆洲,2024-05-21,9857
2409,友達,45,6,39,元大-蘆洲,2024-05-21,9857
1309,台達化,35,0,35,元大-蘆洲,2024-05-21,9857
2884,玉山金,55,20,35,元大-蘆洲,2024-05-21,9857
00680L,元大美債20正2,41,7,34,元大-蘆洲,2024-05-21,9857
1314,中石化,75,42,33,元大-蘆洲,2024-05-21,9857
00687B,國泰20年美債,33,0,33,元大-蘆洲,2024-05-21,9857
3260,威剛,36,3,33,元大-蘆洲,2024-05-21,9857
3338,泰碩,134,102,32,元大-蘆洲,2024-05-21,9857
5388,中磊,30,0,30,元大-蘆洲,2024-05-21,9857
2009,第一銅,100,70,30,元大-蘆洲,2024-05-21,9857
2515,中工,30,1,29,元大-蘆洲,2024-05-21,9857
2834,臺企銀,30,2,28,元大-蘆洲,2024-05-21,9857
3564,其陽,33,6,27,元大-蘆洲,2024-05-21,9857
2007,燁興,52,25,27,元大-蘆洲,2024-05-21,9857
1301,台塑,27,1,26,元大-蘆洲,2024-05-21,9857
2607,榮運,25,0,25,元大-蘆洲,2024-05-21,9857
4533,協易機,192,167,25,元大-蘆洲,2024-05-21,9857
2352,佳世達,28,4,24,元大-蘆洲,2024-05-21,9857
00712,復華富時不動產,40,17,23,元大-蘆洲,2024-05-21,9857
2489,瑞軒,65,42,23,元大-蘆洲,2024-05-21,9857
2323,中環,24,1,23,元大-蘆洲,2024-05-21,9857
0056,元大高股息,32,10,22,元大-蘆洲,2024-05-21,9857
1522,堤維西,27,6,21,元大-蘆洲,2024-05-21,9857
2504,國產,33,13,20,元大-蘆洲,2024-05-21,9857
6290,良維,24,4,20,元大-蘆洲,2024-05-21,9857
2603,長榮,42,23,19,元大-蘆洲,2024-05-21,9857
2460,建通,23,4,19,元大-蘆洲,2024-05-21,9857
2332,友訊,20,2,18,元大-蘆洲,2024-05-21,9857
2009,第一銅,473,192,281,元大-蘆洲,2024-05-22,9857
2884,玉山金,228,10,218,元大-蘆洲,2024-05-22,9857
00937B,群益ESG投等債20,205,46,159,元大-蘆洲,2024-05-22,9857
2206,三陽工業,150,7,143,元大-蘆洲,2024-05-22,9857
00632R,元大台灣50反1,165,33,132,元大-蘆洲,2024-05-22,9857
2618,長榮航,262,137,125,元大-蘆洲,2024-05-22,9857
1605,華新,119,26,93,元大-蘆洲,2024-05-22,9857
2002,中鋼,108,17,91,元大-蘆洲,2024-05-22,9857
9945,潤泰新,110,29,81,元大-蘆洲,2024-05-22,9857
3059,華晶科,123,55,68,元大-蘆洲,2024-05-22,9857
2867,三商壽,62,12,50,元大-蘆洲,2024-05-22,9857
2367,燿華,254,205,49,元大-蘆洲,2024-05-22,9857
3033,威健,56,9,47,元大-蘆洲,2024-05-22,9857
1612,宏泰,69,22,47,元大-蘆洲,2024-05-22,9857
2489,瑞軒,97,52,45,元大-蘆洲,2024-05-22,9857
00650L,復華香港正2,50,5,45,元大-蘆洲,2024-05-22,9857
2504,國產,40,0,40,元大-蘆洲,2024-05-22,9857
00715L,期街口布蘭特正2,39,0,39,元大-蘆洲,2024-05-22,9857
2354,鴻準,65,29,36,元大-蘆洲,2024-05-22,9857
8110,華東,61,26,35,元大-蘆洲,2024-05-22,9857
2888,新光金,45,10,35,元大-蘆洲,2024-05-22,9857
6125,廣運,110,76,34,元大-蘆洲,2024-05-22,9857
5392,能率,108,79,29,元大-蘆洲,2024-05-22,9857
2890,永豐金,32,3,29,元大-蘆洲,2024-05-22,9857
4543,萬在,49,20,29,元大-蘆洲,2024-05-22,9857
3706,神達,107,79,28,元大-蘆洲,2024-05-22,9857
5225,東科-KY,32,5,27,元大-蘆洲,2024-05-22,9857
6134,萬旭,25,0,25,元大-蘆洲,2024-05-22,9857
2634,漢翔,35,12,23,元大-蘆洲,2024-05-22,9857
3338,泰碩,57,34,23,元大-蘆洲,2024-05-22,9857
2313,華通,33,10,23,元大-蘆洲,2024-05-22,9857
2027,大成鋼,30,7,23,元大-蘆洲,2024-05-22,9857
00712,復華富時不動產,24,2,22,元大-蘆洲,2024-05-22,9857
6215,和椿,46,24,22,元大-蘆洲,2024-05-22,9857
8926,台汽電,25,3,22,元大-蘆洲,2024-05-22,9857
2365,昆盈,107,86,21,元大-蘆洲,2024-05-22,9857
1303,南亞,23,3,20,元大-蘆洲,2024-05-22,9857
5309,系統電,20,0,20,元大-蘆洲,2024-05-22,9857
9924,福興,20,0,20,元大-蘆洲,2024-05-22,9857
5475,德宏,20,0,20,元大-蘆洲,2024-05-22,9857
3520,華盈,21,1,20,元大-蘆洲,2024-05-22,9857
3060,銘異,39,19,20,元大-蘆洲,2024-05-22,9857
2610,華航,112,94,18,元大-蘆洲,2024-05-22,9857
4526,東台,20,2,18,元大-蘆洲,2024-05-22,9857
6244,茂迪,35,17,18,元大-蘆洲,2024-05-22,9857
2328,廣宇,20,2,18,元大-蘆洲,2024-05-22,9857
2465,麗臺,60,42,18,元大-蘆洲,2024-05-22,9857
1455,集盛,33,17,16,元大-蘆洲,2024-05-22,9857
5009,榮剛,18,2,16,元大-蘆洲,2024-05-22,9857
5498,凱崴,27,11,16,元大-蘆洲,2024-05-22,9857
00937B,群益ESG投等債20,726,10,716,元大-蘆洲,2024-05-23,9857
2883,凱基金,135,16,119,元大-蘆洲,2024-05-23,9857
2356,英業達,122,16,106,元大-蘆洲,2024-05-23,9857
4533,協易機,203,99,104,元大-蘆洲,2024-05-23,9857
2363,矽統,133,30,103,元大-蘆洲,2024-05-23,9857
2324,仁寶,150,51,99,元大-蘆洲,2024-05-23,9857
6190,萬泰科,106,12,94,元大-蘆洲,2024-05-23,9857
2009,第一銅,278,200,78,元大-蘆洲,2024-05-23,9857
3481,群創,265,204,61,元大-蘆洲,2024-05-23,9857
6209,今國光,132,79,53,元大-蘆洲,2024-05-23,9857
00830,國泰費城半導體,51,2,49,元大-蘆洲,2024-05-23,9857
00929,復華台灣科技優息,209,162,47,元大-蘆洲,2024-05-23,9857
00715L,期街口布蘭特正2,46,0,46,元大-蘆洲,2024-05-23,9857
6147,頎邦,42,0,42,元大-蘆洲,2024-05-23,9857
9945,潤泰新,45,5,40,元大-蘆洲,2024-05-23,9857
2888,新光金,49,10,39,元大-蘆洲,2024-05-23,9857
2444,兆勁,41,4,37,元大-蘆洲,2024-05-23,9857
4127,天良,43,8,35,元大-蘆洲,2024-05-23,9857
2329,華泰,39,5,34,元大-蘆洲,2024-05-23,9857
00651R,復華香港反1,34,0,34,元大-蘆洲,2024-05-23,9857
2101,南港,42,10,32,元大-蘆洲,2024-05-23,9857
1522,堤維西,41,9,32,元大-蘆洲,2024-05-23,9857
00679B,元大美債20年,40,8,32,元大-蘆洲,2024-05-23,9857
1314,中石化,53,22,31,元大-蘆洲,2024-05-23,9857
6207,雷科,38,7,31,元大-蘆洲,2024-05-23,9857
2464,盟立,169,139,30,元大-蘆洲,2024-05-23,9857
5488,松普,33,3,30,元大-蘆洲,2024-05-23,9857
2002,中鋼,40,13,27,元大-蘆洲,2024-05-23,9857
8064,東捷,29,3,26,元大-蘆洲,2024-05-23,9857
00936,台新永續高息中小,25,0,25,元大-蘆洲,2024-05-23,9857
3260,威剛,26,2,24,元大-蘆洲,2024-05-23,9857
2371,大同,97,75,22,元大-蘆洲,2024-05-23,9857
3363,上詮,60,38,22,元大-蘆洲,2024-05-23,9857
5871,中租-KY,21,0,21,元大-蘆洲,2024-05-23,9857
3520,華盈,21,0,21,元大-蘆洲,2024-05-23,9857
3715,定穎投控,26,6,20,元大-蘆洲,2024-05-23,9857
2834,臺企銀,22,2,20,元大-蘆洲,2024-05-23,9857
1536,和大,79,59,20,元大-蘆洲,2024-05-23,9857
00712,復華富時不動產,55,36,19,元大-蘆洲,2024-05-23,9857
00632R,元大台灣50反1,130,111,19,元大-蘆洲,2024-05-23,9857
6116,彩晶,52,33,19,元大-蘆洲,2024-05-23,9857
3051,力特,19,0,19,元大-蘆洲,2024-05-23,9857
2641,正德,21,2,19,元大-蘆洲,2024-05-23,9857
8071,能率網通,50,31,19,元大-蘆洲,2024-05-23,9857
2405,輔信,22,4,18,元大-蘆洲,2024-05-23,9857
3010,華立,18,0,18,元大-蘆洲,2024-05-23,9857
3033,威健,21,3,18,元大-蘆洲,2024-05-23,9857
2014,中鴻,19,2,17,元大-蘆洲,2024-05-23,9857
5347,世界,18,1,17,元大-蘆洲,2024-05-23,9857
2867,三商壽,19,3,16,元大-蘆洲,2024-05-23,9857
00937B,群益ESG投等債20,560,1,559,元大-蘆洲,2024-05-24,9857
00712,復華富時不動產,331,7,324,元大-蘆洲,2024-05-24,9857
2618,長榮航,252,67,185,元大-蘆洲,2024-05-24,9857
2892,第一金,204,80,124,元大-蘆洲,2024-05-24,9857
2002,中鋼,103,5,98,元大-蘆洲,2024-05-24,9857
6451,訊芯-KY,101,4,97,元大-蘆洲,2024-05-24,9857
00929,復華台灣科技優息,123,45,78,元大-蘆洲,2024-05-24,9857
2365,昆盈,304,226,78,元大-蘆洲,2024-05-24,9857
3338,泰碩,163,94,69,元大-蘆洲,2024-05-24,9857
2324,仁寶,127,59,68,元大-蘆洲,2024-05-24,9857
00751B,元大AAA至A公司債,63,0,63,元大-蘆洲,2024-05-24,9857
00946,群益科技高息成長,64,1,63,元大-蘆洲,2024-05-24,9857
2303,聯電,112,50,62,元大-蘆洲,2024-05-24,9857
2601,益航,60,0,60,元大-蘆洲,2024-05-24,9857
4549,桓達,54,5,49,元大-蘆洲,2024-05-24,9857
6770,力積電,51,4,47,元大-蘆洲,2024-05-24,9857
00680L,元大美債20正2,55,10,45,元大-蘆洲,2024-05-24,9857
2867,三商壽,53,10,43,元大-蘆洲,2024-05-24,9857
2633,台灣高鐵,41,0,41,元大-蘆洲,2024-05-24,9857
6125,廣運,98,58,40,元大-蘆洲,2024-05-24,9857
6719,力智,41,3,38,元大-蘆洲,2024-05-24,9857
9945,潤泰新,61,25,36,元大-蘆洲,2024-05-24,9857
5347,世界,37,3,34,元大-蘆洲,2024-05-24,9857
1810,和成,120,88,32,元大-蘆洲,2024-05-24,9857
8358,金居,33,2,31,元大-蘆洲,2024-05-24,9857
2354,鴻準,76,45,31,元大-蘆洲,2024-05-24,9857
00637L,元大滬深300正2,41,10,31,元大-蘆洲,2024-05-24,9857
2405,輔信,48,18,30,元大-蘆洲,2024-05-24,9857
2371,大同,49,20,29,元大-蘆洲,2024-05-24,9857
2464,盟立,127,98,29,元大-蘆洲,2024-05-24,9857
4979,華星光,50,22,28,元大-蘆洲,2024-05-24,9857
1303,南亞,32,5,27,元大-蘆洲,2024-05-24,9857
2352,佳世達,27,0,27,元大-蘆洲,2024-05-24,9857
5498,凱崴,234,208,26,元大-蘆洲,2024-05-24,9857
2313,華通,31,5,26,元大-蘆洲,2024-05-24,9857
1313,聯成,30,6,24,元大-蘆洲,2024-05-24,9857
8213,志超,24,0,24,元大-蘆洲,2024-05-24,9857
2515,中工,41,19,22,元大-蘆洲,2024-05-24,9857
00665L,富邦�琤肭磪囓�2,26,4,22,元大-蘆洲,2024-05-24,9857
2337,旺宏,22,0,22,元大-蘆洲,2024-05-24,9857
4532,瑞智,34,12,22,元大-蘆洲,2024-05-24,9857
00753L,中信中國50正2,21,0,21,元大-蘆洲,2024-05-24,9857
6275,元山,29,8,21,元大-蘆洲,2024-05-24,9857
2014,中鴻,21,0,21,元大-蘆洲,2024-05-24,9857
2486,一詮,101,80,21,元大-蘆洲,2024-05-24,9857
1301,台塑,21,0,21,元大-蘆洲,2024-05-24,9857
6139,亞翔,27,7,20,元大-蘆洲,2024-05-24,9857
6147,頎邦,22,2,20,元大-蘆洲,2024-05-24,9857
1608,華榮,26,6,20,元大-蘆洲,2024-05-24,9857
2641,正德,21,1,20,元大-蘆洲,2024-05-24,9857
00937B,群益ESG投等債20,356,30,326,元大-蘆洲,2024-05-27,9857
00679B,元大美債20年,291,5,286,元大-蘆洲,2024-05-27,9857
2489,瑞軒,391,173,218,元大-蘆洲,2024-05-27,9857
2363,矽統,466,311,155,元大-蘆洲,2024-05-27,9857
00942B,台新美A公司債20+,150,20,130,元大-蘆洲,2024-05-27,9857
2641,正德,200,73,127,元大-蘆洲,2024-05-27,9857
3234,光環,113,3,110,元大-蘆洲,2024-05-27,9857
00932,兆豐永續高息等權,108,4,104,元大-蘆洲,2024-05-27,9857
1815,富喬,302,199,103,元大-蘆洲,2024-05-27,9857
1440,南紡,100,3,97,元大-蘆洲,2024-05-27,9857
3481,群創,311,221,90,元大-蘆洲,2024-05-27,9857
9105,泰金寶-DR,258,173,85,元大-蘆洲,2024-05-27,9857
3706,神達,126,45,81,元大-蘆洲,2024-05-27,9857
00929,復華台灣科技優息,182,102,80,元大-蘆洲,2024-05-27,9857
6213,聯茂,74,3,71,元大-蘆洲,2024-05-27,9857
2353,宏��,365,295,70,元大-蘆洲,2024-05-27,9857
2610,華航,75,20,55,元大-蘆洲,2024-05-27,9857
2002,中鋼,52,4,48,元大-蘆洲,2024-05-27,9857
00720B,元大投資級公司債,48,0,48,元大-蘆洲,2024-05-27,9857
6156,松上,47,0,47,元大-蘆洲,2024-05-27,9857
00933B,國泰10Y+金融債,49,9,40,元大-蘆洲,2024-05-27,9857
6125,廣運,114,75,39,元大-蘆洲,2024-05-27,9857
3047,訊舟,187,149,38,元大-蘆洲,2024-05-27,9857
2633,台灣高鐵,39,2,37,元大-蘆洲,2024-05-27,9857
3024,憶聲,43,6,37,元大-蘆洲,2024-05-27,9857
4549,桓達,37,1,36,元大-蘆洲,2024-05-27,9857
5531,鄉林,40,5,35,元大-蘆洲,2024-05-27,9857
4533,協易機,76,43,33,元大-蘆洲,2024-05-27,9857
3260,威剛,34,2,32,元大-蘆洲,2024-05-27,9857
4908,前鼎,46,15,31,元大-蘆洲,2024-05-27,9857
4402,郡都開發,31,0,31,元大-蘆洲,2024-05-27,9857
00751B,元大AAA至A公司債,31,1,30,元大-蘆洲,2024-05-27,9857
00740B,富邦全球投等債,30,0,30,元大-蘆洲,2024-05-27,9857
4545,銘鈺,51,21,30,元大-蘆洲,2024-05-27,9857
2352,佳世達,61,32,29,元大-蘆洲,2024-05-27,9857
00712,復華富時不動產,34,7,27,元大-蘆洲,2024-05-27,9857
5880,合庫金,28,0,28,元大-蘆洲,2024-05-27,9857
3033,威健,32,6,26,元大-蘆洲,2024-05-27,9857
3693,營邦,28,3,25,元大-蘆洲,2024-05-27,9857
3149,正達,29,5,24,元大-蘆洲,2024-05-27,9857
00926,凱基全球菁英55,24,0,24,元大-蘆洲,2024-05-27,9857
00713,元大台灣高息低波,22,0,22,元大-蘆洲,2024-05-27,9857
6265,方土昶,23,1,22,元大-蘆洲,2024-05-27,9857
2801,彰銀,23,1,22,元大-蘆洲,2024-05-27,9857
2344,華邦電,23,1,22,元大-蘆洲,2024-05-27,9857
2371,大同,50,30,20,元大-蘆洲,2024-05-27,9857
2367,燿華,58,39,19,元大-蘆洲,2024-05-27,9857
9904,寶成,22,3,19,元大-蘆洲,2024-05-27,9857
2603,長榮,85,67,18,元大-蘆洲,2024-05-27,9857
6443,元晶,18,0,18,元大-蘆洲,2024-05-27,9857
2618,長榮航,879,224,655,元大-蘆洲,2024-05-28,9857
00937B,群益ESG投等債20,334,45,289,元大-蘆洲,2024-05-28,9857
2354,鴻準,548,349,199,元大-蘆洲,2024-05-28,9857
6215,和椿,241,83,158,元大-蘆洲,2024-05-28,9857
2609,陽明,227,77,150,元大-蘆洲,2024-05-28,9857
00946,群益科技高息成長,146,5,141,元大-蘆洲,2024-05-28,9857
3030,德律,124,3,121,元大-蘆洲,2024-05-28,9857
4906,正文,150,38,112,元大-蘆洲,2024-05-28,9857
2641,正德,210,99,111,元大-蘆洲,2024-05-28,9857
00650L,復華香港正2,121,10,111,元大-蘆洲,2024-05-28,9857
00753L,中信中國50正2,82,2,80,元大-蘆洲,2024-05-28,9857
2303,聯電,123,54,69,元大-蘆洲,2024-05-28,9857
2892,第一金,66,0,66,元大-蘆洲,2024-05-28,9857
2353,宏��,165,100,65,元大-蘆洲,2024-05-28,9857
9105,泰金寶-DR,82,24,58,元大-蘆洲,2024-05-28,9857
2363,矽統,167,109,58,元大-蘆洲,2024-05-28,9857
2317,鴻海,107,51,56,元大-蘆洲,2024-05-28,9857
5388,中磊,52,1,51,元大-蘆洲,2024-05-28,9857
2369,菱生,69,26,43,元大-蘆洲,2024-05-28,9857
3706,神達,52,9,43,元大-蘆洲,2024-05-28,9857
00857B,永豐20年美公債,44,2,42,元大-蘆洲,2024-05-28,9857
2301,光寶科,83,45,38,元大-蘆洲,2024-05-28,9857
2324,仁寶,62,26,36,元大-蘆洲,2024-05-28,9857
2615,萬海,69,33,36,元大-蘆洲,2024-05-28,9857
2017,官田鋼,40,4,36,元大-蘆洲,2024-05-28,9857
2365,昆盈,41,5,36,元大-蘆洲,2024-05-28,9857
6190,萬泰科,50,16,34,元大-蘆洲,2024-05-28,9857
00724B,群益投資級金融債,31,0,31,元大-蘆洲,2024-05-28,9857
2603,長榮,55,24,31,元大-蘆洲,2024-05-28,9857
2851,中再保,30,0,30,元大-蘆洲,2024-05-28,9857
2332,友訊,31,2,29,元大-蘆洲,2024-05-28,9857
2409,友達,31,2,29,元大-蘆洲,2024-05-28,9857
2382,廣達,40,11,29,元大-蘆洲,2024-05-28,9857
3055,蔚華科,49,21,28,元大-蘆洲,2024-05-28,9857
00882,中信中國高股息,40,13,27,元大-蘆洲,2024-05-28,9857
5220,萬達光電,27,0,27,元大-蘆洲,2024-05-28,9857
9103,美德醫療-DR,27,0,27,元大-蘆洲,2024-05-28,9857
8096,擎亞,52,25,27,元大-蘆洲,2024-05-28,9857
1312,國喬,41,14,27,元大-蘆洲,2024-05-28,9857
00751B,元大AAA至A公司債,35,10,25,元大-蘆洲,2024-05-28,9857
00915,凱基優選高股息30,28,3,25,元大-蘆洲,2024-05-28,9857
00673R,期元大S＆P原油反1,25,0,25,元大-蘆洲,2024-05-28,9857
4716,大立,25,0,25,元大-蘆洲,2024-05-28,9857
2464,盟立,95,70,25,元大-蘆洲,2024-05-28,9857
00919,群益台灣精選高息,80,55,25,元大-蘆洲,2024-05-28,9857
2367,燿華,66,43,23,元大-蘆洲,2024-05-28,9857
00712,復華富時不動產,39,16,23,元大-蘆洲,2024-05-28,9857
4402,郡都開發,36,15,21,元大-蘆洲,2024-05-28,9857
00891,中信關鍵半導體,26,6,20,元大-蘆洲,2024-05-28,9857
4720,德淵,20,0,20,元大-蘆洲,2024-05-28,9857
00937B,群益ESG投等債20,756,0,756,元大-蘆洲,2024-05-29,9857
00632R,元大台灣50反1,547,0,547,元大-蘆洲,2024-05-29,9857
00679B,元大美債20年,242,14,228,元大-蘆洲,2024-05-29,9857
2609,陽明,261,46,215,元大-蘆洲,2024-05-29,9857
2363,矽統,189,42,147,元大-蘆洲,2024-05-29,9857
2888,新光金,171,34,137,元大-蘆洲,2024-05-29,9857
2884,玉山金,139,3,136,元大-蘆洲,2024-05-29,9857
2453,凌群,120,7,113,元大-蘆洲,2024-05-29,9857
4714,永捷,134,21,113,元大-蘆洲,2024-05-29,9857
2883,凱基金,116,7,109,元大-蘆洲,2024-05-29,9857
00929,復華台灣科技優息,156,48,108,元大-蘆洲,2024-05-29,9857
00940,元大台灣價值高息,174,82,92,元大-蘆洲,2024-05-29,9857
00687B,國泰20年美債,111,19,92,元大-蘆洲,2024-05-29,9857
2206,三陽工業,91,3,88,元大-蘆洲,2024-05-29,9857
2613,中櫃,164,79,85,元大-蘆洲,2024-05-29,9857
2801,彰銀,82,4,78,元大-蘆洲,2024-05-29,9857
2892,第一金,158,81,77,元大-蘆洲,2024-05-29,9857
00878,國泰永續高股息,83,8,75,元大-蘆洲,2024-05-29,9857
2489,瑞軒,251,177,74,元大-蘆洲,2024-05-29,9857
2317,鴻海,117,44,73,元大-蘆洲,2024-05-29,9857
3047,訊舟,407,339,68,元大-蘆洲,2024-05-29,9857
2886,兆豐金,66,1,65,元大-蘆洲,2024-05-29,9857
2349,錸德,72,8,64,元大-蘆洲,2024-05-29,9857
3227,原相,105,41,64,元大-蘆洲,2024-05-29,9857
2367,燿華,103,40,63,元大-蘆洲,2024-05-29,9857
2332,友訊,63,0,63,元大-蘆洲,2024-05-29,9857
2401,凌陽,145,83,62,元大-蘆洲,2024-05-29,9857
00712,復華富時不動產,67,8,59,元大-蘆洲,2024-05-29,9857
00725B,國泰投資級公司債,60,1,59,元大-蘆洲,2024-05-29,9857
00753L,中信中國50正2,67,10,57,元大-蘆洲,2024-05-29,9857
00946,群益科技高息成長,53,1,52,元大-蘆洲,2024-05-29,9857
2504,國產,71,23,48,元大-蘆洲,2024-05-29,9857
9904,寶成,43,1,42,元大-蘆洲,2024-05-29,9857
2834,臺企銀,41,0,41,元大-蘆洲,2024-05-29,9857
00936,台新永續高息中小,40,1,39,元大-蘆洲,2024-05-29,9857
4967,十銓,54,16,38,元大-蘆洲,2024-05-29,9857
00680L,元大美債20正2,40,2,38,元大-蘆洲,2024-05-29,9857
2885,元大金,49,12,37,元大-蘆洲,2024-05-29,9857
00918,大華優利高填息30,43,8,35,元大-蘆洲,2024-05-29,9857
2324,仁寶,47,12,35,元大-蘆洲,2024-05-29,9857
6213,聯茂,66,31,35,元大-蘆洲,2024-05-29,9857
5880,合庫金,33,0,33,元大-蘆洲,2024-05-29,9857
2610,華航,82,49,33,元大-蘆洲,2024-05-29,9857
2409,友達,38,5,33,元大-蘆洲,2024-05-29,9857
1101,台泥,49,16,33,元大-蘆洲,2024-05-29,9857
1312,國喬,33,1,32,元大-蘆洲,2024-05-29,9857
2615,萬海,59,28,31,元大-蘆洲,2024-05-29,9857
5515,建國,28,0,28,元大-蘆洲,2024-05-29,9857
00891,中信關鍵半導體,34,6,28,元大-蘆洲,2024-05-29,9857
2614,東森,28,1,27,元大-蘆洲,2024-05-29,9857
00632R,元大台灣50反1,551,50,501,元大-蘆洲,2024-05-30,9857
00929,復華台灣科技優息,365,80,285,元大-蘆洲,2024-05-30,9857
00637L,元大滬深300正2,248,0,248,元大-蘆洲,2024-05-30,9857
00937B,群益ESG投等債20,225,5,220,元大-蘆洲,2024-05-30,9857
9105,泰金寶-DR,188,12,176,元大-蘆洲,2024-05-30,9857
00885,富邦越南,155,6,149,元大-蘆洲,2024-05-30,9857
2002,中鋼,153,13,140,元大-蘆洲,2024-05-30,9857
2353,宏��,225,100,125,元大-蘆洲,2024-05-30,9857
8936,國統,136,32,104,元大-蘆洲,2024-05-30,9857
2328,廣宇,173,71,102,元大-蘆洲,2024-05-30,9857
00712,復華富時不動產,102,5,97,元大-蘆洲,2024-05-30,9857
00679B,元大美債20年,106,12,94,元大-蘆洲,2024-05-30,9857
00940,元大台灣價值高息,196,104,92,元大-蘆洲,2024-05-30,9857
1815,富喬,541,462,79,元大-蘆洲,2024-05-30,9857
00687B,國泰20年美債,84,11,73,元大-蘆洲,2024-05-30,9857
2363,矽統,218,150,68,元大-蘆洲,2024-05-30,9857
2206,三陽工業,70,6,64,元大-蘆洲,2024-05-30,9857
00915,凱基優選高股息30,62,0,62,元大-蘆洲,2024-05-30,9857
00946,群益科技高息成長,62,1,61,元大-蘆洲,2024-05-30,9857
6290,良維,76,15,61,元大-蘆洲,2024-05-30,9857
4545,銘鈺,60,0,60,元大-蘆洲,2024-05-30,9857
3035,智原,72,13,59,元大-蘆洲,2024-05-30,9857
1605,華新,58,1,57,元大-蘆洲,2024-05-30,9857
00878,國泰永續高股息,78,21,57,元大-蘆洲,2024-05-30,9857
00918,大華優利高填息30,57,1,56,元大-蘆洲,2024-05-30,9857
2489,瑞軒,221,166,55,元大-蘆洲,2024-05-30,9857
6188,廣明,66,15,51,元大-蘆洲,2024-05-30,9857
00680L,元大美債20正2,52,2,50,元大-蘆洲,2024-05-30,9857
00651R,復華香港反1,49,0,49,元大-蘆洲,2024-05-30,9857
5880,合庫金,49,0,49,元大-蘆洲,2024-05-30,9857
2356,英業達,53,9,44,元大-蘆洲,2024-05-30,9857
2330,台積電,46,4,42,元大-蘆洲,2024-05-30,9857
2834,臺企銀,46,5,41,元大-蘆洲,2024-05-30,9857
020031,統一IC設計臺灣N,40,0,40,元大-蘆洲,2024-05-30,9857
8105,凌巨,83,45,38,元大-蘆洲,2024-05-30,9857
2332,友訊,37,0,37,元大-蘆洲,2024-05-30,9857
3481,群創,191,155,36,元大-蘆洲,2024-05-30,9857
0056,元大高股息,49,13,36,元大-蘆洲,2024-05-30,9857
3013,晟銘電,48,12,36,元大-蘆洲,2024-05-30,9857
00907,永豐優息存股,36,0,36,元大-蘆洲,2024-05-30,9857
1303,南亞,39,4,35,元大-蘆洲,2024-05-30,9857
2886,兆豐金,34,0,34,元大-蘆洲,2024-05-30,9857
00665L,富邦�琤肭磪囓�2,35,1,34,元大-蘆洲,2024-05-30,9857
2344,華邦電,40,6,34,元大-蘆洲,2024-05-30,9857
00933B,國泰10Y+金融債,35,3,32,元大-蘆洲,2024-05-30,9857
2317,鴻海,121,90,31,元大-蘆洲,2024-05-30,9857
2497,怡利電,32,1,31,元大-蘆洲,2024-05-30,9857
6147,頎邦,31,0,31,元大-蘆洲,2024-05-30,9857
2312,金寶,38,7,31,元大-蘆洲,2024-05-30,9857
4533,協易機,715,685,30,元大-蘆洲,2024-05-30,9857
2609,陽明,985,718,267,元大-蘆洲,2024-05-31,9857
2613,中櫃,351,115,236,元大-蘆洲,2024-05-31,9857
00929,復華台灣科技優息,345,149,196,元大-蘆洲,2024-05-31,9857
00919,群益台灣精選高息,210,17,193,元大-蘆洲,2024-05-31,9857
00937B,群益ESG投等債20,218,65,153,元大-蘆洲,2024-05-31,9857
3376,新日興,167,24,143,元大-蘆洲,2024-05-31,9857
3481,群創,147,19,128,元大-蘆洲,2024-05-31,9857
2354,鴻準,415,290,125,元大-蘆洲,2024-05-31,9857
2002,中鋼,113,10,103,元大-蘆洲,2024-05-31,9857
2344,華邦電,106,4,102,元大-蘆洲,2024-05-31,9857
2317,鴻海,150,57,93,元大-蘆洲,2024-05-31,9857
00878,國泰永續高股息,115,23,92,元大-蘆洲,2024-05-31,9857
2367,燿華,174,103,71,元大-蘆洲,2024-05-31,9857
2353,宏��,81,13,68,元大-蘆洲,2024-05-31,9857
1815,富喬,258,194,64,元大-蘆洲,2024-05-31,9857
2610,華航,71,8,63,元大-蘆洲,2024-05-31,9857
3231,緯創,91,30,61,元大-蘆洲,2024-05-31,9857
2845,遠東銀,64,5,59,元大-蘆洲,2024-05-31,9857
00651R,復華香港反1,52,0,52,元大-蘆洲,2024-05-31,9857
00939,統一台灣高息動能,52,0,52,元大-蘆洲,2024-05-31,9857
5531,鄉林,51,0,51,元大-蘆洲,2024-05-31,9857
2409,友達,73,24,49,元大-蘆洲,2024-05-31,9857
4906,正文,69,21,48,元大-蘆洲,2024-05-31,9857
2886,兆豐金,47,1,46,元大-蘆洲,2024-05-31,9857
2489,瑞軒,100,57,43,元大-蘆洲,2024-05-31,9857
2303,聯電,60,20,40,元大-蘆洲,2024-05-31,9857
2603,長榮,111,72,39,元大-蘆洲,2024-05-31,9857
2486,一詮,71,33,38,元大-蘆洲,2024-05-31,9857
1517,利奇,38,0,38,元大-蘆洲,2024-05-31,9857
9105,泰金寶-DR,43,6,37,元大-蘆洲,2024-05-31,9857
2382,廣達,44,8,36,元大-蘆洲,2024-05-31,9857
5469,瀚宇博,44,13,31,元大-蘆洲,2024-05-31,9857
2889,國票金,31,0,31,元大-蘆洲,2024-05-31,9857
6278,台表科,36,5,31,元大-蘆洲,2024-05-31,9857
2338,光罩,33,3,30,元大-蘆洲,2024-05-31,9857
00946,群益科技高息成長,33,3,30,元大-蘆洲,2024-05-31,9857
3312,弘憶股,276,246,30,元大-蘆洲,2024-05-31,9857
2547,日勝生,30,1,29,元大-蘆洲,2024-05-31,9857
2352,佳世達,30,2,28,元大-蘆洲,2024-05-31,9857
00756B,群益投等新興公債,27,0,27,元大-蘆洲,2024-05-31,9857
6117,迎廣,51,25,26,元大-蘆洲,2024-05-31,9857
3037,欣興,28,2,26,元大-蘆洲,2024-05-31,9857
2331,精英,51,26,25,元大-蘆洲,2024-05-31,9857
8107,大億金茂,25,0,25,元大-蘆洲,2024-05-31,9857
3051,力特,24,0,24,元大-蘆洲,2024-05-31,9857
2330,台積電,26,3,23,元大-蘆洲,2024-05-31,9857
6770,力積電,74,50,24,元大-蘆洲,2024-05-31,9857
00715L,期街口布蘭特正2,24,1,23,元大-蘆洲,2024-05-31,9857
2892,第一金,22,0,22,元大-蘆洲,2024-05-31,9857
1587,吉茂,26,5,21,元大-蘆洲,2024-05-31,9857
00637L,元大滬深300正2,270,30,240,元大-蘆洲,2024-06-03,9857
00919,群益台灣精選高息,248,74,174,元大-蘆洲,2024-06-03,9857
00715L,期街口布蘭特正2,159,0,159,元大-蘆洲,2024-06-03,9857
2354,鴻準,234,85,149,元大-蘆洲,2024-06-03,9857
2353,宏��,172,28,144,元大-蘆洲,2024-06-03,9857
2618,長榮航,162,27,135,元大-蘆洲,2024-06-03,9857
2610,華航,160,29,131,元大-蘆洲,2024-06-03,9857
2328,廣宇,137,41,96,元大-蘆洲,2024-06-03,9857
2615,萬海,253,174,79,元大-蘆洲,2024-06-03,9857
3694,海華,79,3,76,元大-蘆洲,2024-06-03,9857
00918,大華優利高填息30,83,21,62,元大-蘆洲,2024-06-03,9857
2486,一詮,126,73,53,元大-蘆洲,2024-06-03,9857
00651R,復華香港反1,55,3,52,元大-蘆洲,2024-06-03,9857
2002,中鋼,69,19,50,元大-蘆洲,2024-06-03,9857
5426,振發,140,93,47,元大-蘆洲,2024-06-03,9857
4533,協易機,354,309,45,元大-蘆洲,2024-06-03,9857
3036,文曄,52,7,45,元大-蘆洲,2024-06-03,9857
4960,誠美材,51,9,42,元大-蘆洲,2024-06-03,9857
2421,建準,66,25,41,元大-蘆洲,2024-06-03,9857
6188,廣明,123,84,39,元大-蘆洲,2024-06-03,9857
2880,華南金,38,0,38,元大-蘆洲,2024-06-03,9857
8028,昇陽半導體,41,3,38,元大-蘆洲,2024-06-03,9857
3041,揚智,40,2,38,元大-蘆洲,2024-06-03,9857
2892,第一金,43,6,37,元大-蘆洲,2024-06-03,9857
2356,英業達,75,40,35,元大-蘆洲,2024-06-03,9857
9105,泰金寶-DR,45,10,35,元大-蘆洲,2024-06-03,9857
2401,凌陽,51,17,34,元大-蘆洲,2024-06-03,9857
1815,富喬,271,237,34,元大-蘆洲,2024-06-03,9857
5452,佶優,32,0,32,元大-蘆洲,2024-06-03,9857
3693,營邦,32,1,31,元大-蘆洲,2024-06-03,9857
00888,永豐台灣ESG,31,0,31,元大-蘆洲,2024-06-03,9857
2607,榮運,32,2,30,元大-蘆洲,2024-06-03,9857
1316,上曜,34,5,29,元大-蘆洲,2024-06-03,9857
2501,國建,58,29,29,元大-蘆洲,2024-06-03,9857
2324,仁寶,50,21,29,元大-蘆洲,2024-06-03,9857
2369,菱生,55,27,28,元大-蘆洲,2024-06-03,9857
6937,天虹,28,0,28,元大-蘆洲,2024-06-03,9857
2905,三商,28,0,28,元大-蘆洲,2024-06-03,9857
5512,力麒,26,0,26,元大-蘆洲,2024-06-03,9857
3712,永崴投控,26,2,24,元大-蘆洲,2024-06-03,9857
1608,華榮,25,2,23,元大-蘆洲,2024-06-03,9857
3490,單井,48,25,23,元大-蘆洲,2024-06-03,9857
2313,華通,23,1,22,元大-蘆洲,2024-06-03,9857
00929,復華台灣科技優息,116,94,22,元大-蘆洲,2024-06-03,9857
2883,凱基金,26,5,21,元大-蘆洲,2024-06-03,9857
3260,威剛,39,19,20,元大-蘆洲,2024-06-03,9857
3017,奇鋐,39,18,21,元大-蘆洲,2024-06-03,9857
3322,建舜電,20,0,20,元大-蘆洲,2024-06-03,9857
00921,兆豐龍頭等權重,24,5,19,元大-蘆洲,2024-06-03,9857
2498,宏達電,23,4,19,元大-蘆洲,2024-06-03,9857
2312,金寶,470,187,283,元大-蘆洲,2024-06-04,9857
2317,鴻海,242,37,205,元大-蘆洲,2024-06-04,9857
00929,復華台灣科技優息,210,14,196,元大-蘆洲,2024-06-04,9857
00918,大華優利高填息30,182,2,180,元大-蘆洲,2024-06-04,9857
6125,廣運,319,143,176,元大-蘆洲,2024-06-04,9857
2486,一詮,244,86,158,元大-蘆洲,2024-06-04,9857
6227,茂綸,167,49,118,元大-蘆洲,2024-06-04,9857
00632R,元大台灣50反1,152,41,111,元大-蘆洲,2024-06-04,9857
3481,群創,105,11,94,元大-蘆洲,2024-06-04,9857
00680L,元大美債20正2,101,15,86,元大-蘆洲,2024-06-04,9857
3376,新日興,101,17,84,元大-蘆洲,2024-06-04,9857
2344,華邦電,99,18,81,元大-蘆洲,2024-06-04,9857
9105,泰金寶-DR,79,0,79,元大-蘆洲,2024-06-04,9857
00919,群益台灣精選高息,222,145,77,元大-蘆洲,2024-06-04,9857
2801,彰銀,73,0,73,元大-蘆洲,2024-06-04,9857
00936,台新永續高息中小,85,14,71,元大-蘆洲,2024-06-04,9857
2354,鴻準,144,74,70,元大-蘆洲,2024-06-04,9857
2324,仁寶,119,50,69,元大-蘆洲,2024-06-04,9857
0056,元大高股息,73,7,66,元大-蘆洲,2024-06-04,9857
2421,建準,65,1,64,元大-蘆洲,2024-06-04,9857
1802,台玻,127,65,62,元大-蘆洲,2024-06-04,9857
5443,均豪,65,3,62,元大-蘆洲,2024-06-04,9857
3013,晟銘電,119,58,61,元大-蘆洲,2024-06-04,9857
2331,精英,461,402,59,元大-蘆洲,2024-06-04,9857
2618,長榮航,120,63,57,元大-蘆洲,2024-06-04,9857
2002,中鋼,60,4,56,元大-蘆洲,2024-06-04,9857
00891,中信關鍵半導體,69,13,56,元大-蘆洲,2024-06-04,9857
1316,上曜,60,4,56,元大-蘆洲,2024-06-04,9857
2524,京城,56,1,55,元大-蘆洲,2024-06-04,9857
2888,新光金,152,98,54,元大-蘆洲,2024-06-04,9857
2409,友達,82,32,50,元大-蘆洲,2024-06-04,9857
2537,聯上發,342,295,47,元大-蘆洲,2024-06-04,9857
2915,潤泰全,50,3,47,元大-蘆洲,2024-06-04,9857
2605,新興,72,29,43,元大-蘆洲,2024-06-04,9857
3047,訊舟,100,57,43,元大-蘆洲,2024-06-04,9857
00878,國泰永續高股息,80,40,40,元大-蘆洲,2024-06-04,9857
1605,華新,42,6,36,元大-蘆洲,2024-06-04,9857
3694,海華,37,1,36,元大-蘆洲,2024-06-04,9857
2367,燿華,195,159,36,元大-蘆洲,2024-06-04,9857
8234,新漢,69,34,35,元大-蘆洲,2024-06-04,9857
00712,復華富時不動產,54,22,32,元大-蘆洲,2024-06-04,9857
3230,錦明,34,3,31,元大-蘆洲,2024-06-04,9857
00713,元大台灣高息低波,31,0,31,元大-蘆洲,2024-06-04,9857
6215,和椿,37,7,30,元大-蘆洲,2024-06-04,9857
2489,瑞軒,40,12,28,元大-蘆洲,2024-06-04,9857
00939,統一台灣高息動能,28,0,28,元大-蘆洲,2024-06-04,9857
6156,松上,27,0,27,元大-蘆洲,2024-06-04,9857
1409,新纖,26,0,26,元大-蘆洲,2024-06-04,9857
2359,所羅門,27,1,26,元大-蘆洲,2024-06-04,9857
4726,永昕,32,7,25,元大-蘆洲,2024-06-04,9857
00929,復華台灣科技優息,310,47,263,元大-蘆洲,2024-06-05,9857
00632R,元大台灣50反1,713,451,262,元大-蘆洲,2024-06-05,9857
2303,聯電,279,66,213,元大-蘆洲,2024-06-05,9857
2331,精英,1001,838,163,元大-蘆洲,2024-06-05,9857
00878,國泰永續高股息,163,14,149,元大-蘆洲,2024-06-05,9857
00936,台新永續高息中小,149,16,133,元大-蘆洲,2024-06-05,9857
00918,大華優利高填息30,110,1,109,元大-蘆洲,2024-06-05,9857
2427,三商電,123,15,108,元大-蘆洲,2024-06-05,9857
2101,南港,136,39,97,元大-蘆洲,2024-06-05,9857
3481,群創,94,1,93,元大-蘆洲,2024-06-05,9857
2353,宏��,113,20,93,元大-蘆洲,2024-06-05,9857
6125,廣運,170,87,83,元大-蘆洲,2024-06-05,9857
2344,華邦電,90,10,80,元大-蘆洲,2024-06-05,9857
2105,正新,78,2,76,元大-蘆洲,2024-06-05,9857
9105,泰金寶-DR,77,1,76,元大-蘆洲,2024-06-05,9857
2891,中信金,124,49,75,元大-蘆洲,2024-06-05,9857
1802,台玻,118,43,75,元大-蘆洲,2024-06-05,9857
0056,元大高股息,72,3,69,元大-蘆洲,2024-06-05,9857
4938,和碩,77,9,68,元大-蘆洲,2024-06-05,9857
3706,神達,71,5,66,元大-蘆洲,2024-06-05,9857
00919,群益台灣精選高息,92,33,59,元大-蘆洲,2024-06-05,9857
3202,樺晟,71,13,58,元大-蘆洲,2024-06-05,9857
1316,上曜,66,10,56,元大-蘆洲,2024-06-05,9857
00885,富邦越南,82,35,47,元大-蘆洲,2024-06-05,9857
3372,典範,62,15,47,元大-蘆洲,2024-06-05,9857
6443,元晶,47,2,45,元大-蘆洲,2024-06-05,9857
2002,中鋼,52,9,43,元大-蘆洲,2024-06-05,9857
00687B,國泰20年美債,86,45,41,元大-蘆洲,2024-06-05,9857
00713,元大台灣高息低波,38,0,38,元大-蘆洲,2024-06-05,9857
2417,圓剛,76,39,37,元大-蘆洲,2024-06-05,9857
6190,萬泰科,41,5,36,元大-蘆洲,2024-06-05,9857
3231,緯創,58,22,36,元大-蘆洲,2024-06-05,9857
00753L,中信中國50正2,42,7,35,元大-蘆洲,2024-06-05,9857
2363,矽統,52,19,33,元大-蘆洲,2024-06-05,9857
2352,佳世達,32,0,32,元大-蘆洲,2024-06-05,9857
1446,宏和,47,15,32,元大-蘆洲,2024-06-05,9857
2834,臺企銀,32,0,32,元大-蘆洲,2024-06-05,9857
2313,華通,35,5,30,元大-蘆洲,2024-06-05,9857
8093,保銳,30,0,30,元大-蘆洲,2024-06-05,9857
00751B,元大AAA至A公司債,46,16,30,元大-蘆洲,2024-06-05,9857
2886,兆豐金,30,2,28,元大-蘆洲,2024-06-05,9857
2301,光寶科,30,2,28,元大-蘆洲,2024-06-05,9857
3522,御嵿,27,0,27,元大-蘆洲,2024-06-05,9857
3707,漢磊,29,3,26,元大-蘆洲,2024-06-05,9857
00715L,期街口布蘭特正2,34,8,26,元大-蘆洲,2024-06-05,9857
1301,台塑,27,2,25,元大-蘆洲,2024-06-05,9857
6789,采鈺,26,1,25,元大-蘆洲,2024-06-05,9857
4533,協易機,45,21,24,元大-蘆洲,2024-06-05,9857
3694,海華,33,9,24,元大-蘆洲,2024-06-05,9857
3048,益登,121,97,24,元大-蘆洲,2024-06-05,9857
00632R,元大台灣50反1,640,215,425,元大-蘆洲,2024-06-06,9857
00936,台新永續高息中小,365,0,365,元大-蘆洲,2024-06-06,9857
3576,聯合再生,255,0,255,元大-蘆洲,2024-06-06,9857
00665L,富邦�琤肭磪囓�2,203,29,174,元大-蘆洲,2024-06-06,9857
3481,群創,184,42,142,元大-蘆洲,2024-06-06,9857
4906,正文,192,50,142,元大-蘆洲,2024-06-06,9857
00753L,中信中國50正2,149,10,139,元大-蘆洲,2024-06-06,9857
00918,大華優利高填息30,126,0,126,元大-蘆洲,2024-06-06,9857
2888,新光金,129,19,110,元大-蘆洲,2024-06-06,9857
00679B,元大美債20年,128,21,107,元大-蘆洲,2024-06-06,9857
00687B,國泰20年美債,116,25,91,元大-蘆洲,2024-06-06,9857
00637L,元大滬深300正2,112,21,91,元大-蘆洲,2024-06-06,9857
2101,南港,142,60,82,元大-蘆洲,2024-06-06,9857
3202,樺晟,90,14,76,元大-蘆洲,2024-06-06,9857
4533,協易機,100,39,61,元大-蘆洲,2024-06-06,9857
00631L,元大台灣50正2,67,7,60,元大-蘆洲,2024-06-06,9857
00919,群益台灣精選高息,118,62,56,元大-蘆洲,2024-06-06,9857
2317,鴻海,177,122,55,元大-蘆洲,2024-06-06,9857
4714,永捷,78,25,53,元大-蘆洲,2024-06-06,9857
1815,富喬,204,155,49,元大-蘆洲,2024-06-06,9857
2486,一詮,83,36,47,元大-蘆洲,2024-06-06,9857
2886,兆豐金,45,0,45,元大-蘆洲,2024-06-06,9857
00680L,元大美債20正2,55,13,42,元大-蘆洲,2024-06-06,9857
2354,鴻準,168,128,40,元大-蘆洲,2024-06-06,9857
2467,志聖,44,6,38,元大-蘆洲,2024-06-06,9857
2409,友達,57,20,37,元大-蘆洲,2024-06-06,9857
2897,王道銀行,33,0,33,元大-蘆洲,2024-06-06,9857
020031,統一IC設計臺灣N,32,0,32,元大-蘆洲,2024-06-06,9857
00715L,期街口布蘭特正2,45,16,29,元大-蘆洲,2024-06-06,9857
9105,泰金寶-DR,101,72,29,元大-蘆洲,2024-06-06,9857
3260,威剛,33,5,28,元大-蘆洲,2024-06-06,9857
3051,力特,27,0,27,元大-蘆洲,2024-06-06,9857
0056,元大高股息,60,33,27,元大-蘆洲,2024-06-06,9857
3706,神達,152,128,24,元大-蘆洲,2024-06-06,9857
2241,艾姆勒,29,5,24,元大-蘆洲,2024-06-06,9857
2611,志信,32,8,24,元大-蘆洲,2024-06-06,9857
2332,友訊,25,1,24,元大-蘆洲,2024-06-06,9857
4167,松瑞藥,23,0,23,元大-蘆洲,2024-06-06,9857
00712,復華富時不動產,24,1,23,元大-蘆洲,2024-06-06,9857
2461,光群雷,22,0,22,元大-蘆洲,2024-06-06,9857
6197,佳必琪,85,64,21,元大-蘆洲,2024-06-06,9857
3047,訊舟,44,24,20,元大-蘆洲,2024-06-06,9857
1314,中石化,40,19,21,元大-蘆洲,2024-06-06,9857
2002,中鋼,28,8,20,元大-蘆洲,2024-06-06,9857
6244,茂迪,19,0,19,元大-蘆洲,2024-06-06,9857
5302,太欣,30,11,19,元大-蘆洲,2024-06-06,9857
6116,彩晶,29,10,19,元大-蘆洲,2024-06-06,9857
2915,潤泰全,28,10,18,元大-蘆洲,2024-06-06,9857
3005,神基,25,7,18,元大-蘆洲,2024-06-06,9857
2892,第一金,69,51,18,元大-蘆洲,2024-06-06,9857
00937B,群益ESG投等債20,280,52,228,元大-蘆洲,2024-06-07,9857
00929,復華台灣科技優息,169,12,157,元大-蘆洲,2024-06-07,9857
00936,台新永續高息中小,158,5,153,元大-蘆洲,2024-06-07,9857
00919,群益台灣精選高息,144,10,134,元大-蘆洲,2024-06-07,9857
00637L,元大滬深300正2,229,100,129,元大-蘆洲,2024-06-07,9857
2883,凱基金,189,75,114,元大-蘆洲,2024-06-07,9857
3231,緯創,124,14,110,元大-蘆洲,2024-06-07,9857
00753L,中信中國50正2,85,0,85,元大-蘆洲,2024-06-07,9857
1609,大亞,133,67,66,元大-蘆洲,2024-06-07,9857
00918,大華優利高填息30,66,6,60,元大-蘆洲,2024-06-07,9857
1714,和桐,52,0,52,元大-蘆洲,2024-06-07,9857
8213,志超,50,0,50,元大-蘆洲,2024-06-07,9857
0056,元大高股息,70,20,50,元大-蘆洲,2024-06-07,9857
2486,一詮,166,119,47,元大-蘆洲,2024-06-07,9857
2312,金寶,109,69,40,元大-蘆洲,2024-06-07,9857
00687B,國泰20年美債,79,41,38,元大-蘆洲,2024-06-07,9857
2489,瑞軒,48,11,37,元大-蘆洲,2024-06-07,9857
2615,萬海,304,267,37,元大-蘆洲,2024-06-07,9857
00882,中信中國高股息,46,10,36,元大-蘆洲,2024-06-07,9857
2002,中鋼,49,14,35,元大-蘆洲,2024-06-07,9857
6125,廣運,112,79,33,元大-蘆洲,2024-06-07,9857
2382,廣達,38,7,31,元大-蘆洲,2024-06-07,9857
2014,中鴻,31,0,31,元大-蘆洲,2024-06-07,9857
8070,長華*,39,8,31,元大-蘆洲,2024-06-07,9857
2402,毅嘉,30,0,30,元大-蘆洲,2024-06-07,9857
2482,連宇,38,8,30,元大-蘆洲,2024-06-07,9857
2101,南港,75,45,30,元大-蘆洲,2024-06-07,9857
2324,仁寶,40,11,29,元大-蘆洲,2024-06-07,9857
2317,鴻海,59,31,28,元大-蘆洲,2024-06-07,9857
5302,太欣,29,1,28,元大-蘆洲,2024-06-07,9857
00712,復華富時不動產,28,0,28,元大-蘆洲,2024-06-07,9857
4906,正文,48,21,27,元大-蘆洲,2024-06-07,9857
2421,建準,26,1,25,元大-蘆洲,2024-06-07,9857
2354,鴻準,39,15,24,元大-蘆洲,2024-06-07,9857
3437,榮創,24,0,24,元大-蘆洲,2024-06-07,9857
9105,泰金寶-DR,160,137,23,元大-蘆洲,2024-06-07,9857
9904,寶成,26,4,22,元大-蘆洲,2024-06-07,9857
2520,冠德,34,13,21,元大-蘆洲,2024-06-07,9857
4157,太景*-KY,21,0,21,元大-蘆洲,2024-06-07,9857
2353,宏��,82,62,20,元大-蘆洲,2024-06-07,9857
5521,工信,20,0,20,元大-蘆洲,2024-06-07,9857
8040,九暘,23,3,20,元大-蘆洲,2024-06-07,9857
3706,神達,59,40,19,元大-蘆洲,2024-06-07,9857
2344,華邦電,30,11,19,元大-蘆洲,2024-06-07,9857
1612,宏泰,37,19,18,元大-蘆洲,2024-06-07,9857
4533,協易機,61,43,18,元大-蘆洲,2024-06-07,9857
2501,國建,81,63,18,元大-蘆洲,2024-06-07,9857
1314,中石化,31,14,17,元大-蘆洲,2024-06-07,9857
00665L,富邦�琤肭磪囓�2,17,1,16,元大-蘆洲,2024-06-07,9857
5864,致和證,16,0,16,元大-蘆洲,2024-06-07,9857
00937B,群益ESG投等債20,565,51,514,元大-蘆洲,2024-06-11,9857
00940,元大台灣價值高息,520,147,373,元大-蘆洲,2024-06-11,9857
2609,陽明,1043,743,300,元大-蘆洲,2024-06-11,9857
00929,復華台灣科技優息,322,46,276,元大-蘆洲,2024-06-11,9857
00918,大華優利高填息30,239,17,222,元大-蘆洲,2024-06-11,9857
1514,亞力,299,99,200,元大-蘆洲,2024-06-11,9857
2888,新光金,220,56,164,元大-蘆洲,2024-06-11,9857
8213,志超,153,0,153,元大-蘆洲,2024-06-11,9857
00919,群益台灣精選高息,187,48,139,元大-蘆洲,2024-06-11,9857
3481,群創,158,28,130,元大-蘆洲,2024-06-11,9857
00687B,國泰20年美債,154,30,124,元大-蘆洲,2024-06-11,9857
0056,元大高股息,95,4,91,元大-蘆洲,2024-06-11,9857
2374,佳能,179,89,90,元大-蘆洲,2024-06-11,9857
9945,潤泰新,115,28,87,元大-蘆洲,2024-06-11,9857
00673R,期元大S＆P原油反1,85,0,85,元大-蘆洲,2024-06-11,9857
00936,台新永續高息中小,85,1,84,元大-蘆洲,2024-06-11,9857
00637L,元大滬深300正2,93,10,83,元大-蘆洲,2024-06-11,9857
1316,上曜,148,68,80,元大-蘆洲,2024-06-11,9857
3376,新日興,119,46,73,元大-蘆洲,2024-06-11,9857
4513,福裕,64,0,64,元大-蘆洲,2024-06-11,9857
00878,國泰永續高股息,68,6,62,元大-蘆洲,2024-06-11,9857
2603,長榮,131,73,58,元大-蘆洲,2024-06-11,9857
4167,松瑞藥,103,50,53,元大-蘆洲,2024-06-11,9857
1584,精剛,50,1,49,元大-蘆洲,2024-06-11,9857
3231,緯創,64,18,46,元大-蘆洲,2024-06-11,9857
2489,瑞軒,54,9,45,元大-蘆洲,2024-06-11,9857
2461,光群雷,45,0,45,元大-蘆洲,2024-06-11,9857
4960,誠美材,45,2,43,元大-蘆洲,2024-06-11,9857
1815,富喬,90,49,41,元大-蘆洲,2024-06-11,9857
2537,聯上發,154,115,39,元大-蘆洲,2024-06-11,9857
3033,威健,42,4,38,元大-蘆洲,2024-06-11,9857
3047,訊舟,225,187,38,元大-蘆洲,2024-06-11,9857
00712,復華富時不動產,50,12,38,元大-蘆洲,2024-06-11,9857
5608,四維航,45,8,37,元大-蘆洲,2024-06-11,9857
4113,聯上,35,0,35,元大-蘆洲,2024-06-11,9857
6414,樺漢,44,11,33,元大-蘆洲,2024-06-11,9857
6290,良維,51,19,32,元大-蘆洲,2024-06-11,9857
9946,三發地產,35,3,32,元大-蘆洲,2024-06-11,9857
4967,十銓,97,66,31,元大-蘆洲,2024-06-11,9857
1582,信錦,34,3,31,元大-蘆洲,2024-06-11,9857
2486,一詮,83,52,31,元大-蘆洲,2024-06-11,9857
00680L,元大美債20正2,53,23,30,元大-蘆洲,2024-06-11,9857
2498,宏達電,52,22,30,元大-蘆洲,2024-06-11,9857
5426,振發,32,2,30,元大-蘆洲,2024-06-11,9857
1301,台塑,30,0,30,元大-蘆洲,2024-06-11,9857
00933B,國泰10Y+金融債,30,0,30,元大-蘆洲,2024-06-11,9857
1540,喬福,26,0,26,元大-蘆洲,2024-06-11,9857
1732,毛寶,29,6,23,元大-蘆洲,2024-06-11,9857
2891,中信金,25,2,23,元大-蘆洲,2024-06-11,9857
9907,統一實,26,3,23,元大-蘆洲,2024-06-11,9857
00712,復華富時不動產,298,0,298,元大-蘆洲,2024-06-12,9857
2618,長榮航,317,89,228,元大-蘆洲,2024-06-12,9857
2888,新光金,265,85,180,元大-蘆洲,2024-06-12,9857
3481,群創,181,36,145,元大-蘆洲,2024-06-12,9857
2883,凱基金,164,33,131,元大-蘆洲,2024-06-12,9857
00918,大華優利高填息30,129,5,124,元大-蘆洲,2024-06-12,9857
00929,復華台灣科技優息,185,63,122,元大-蘆洲,2024-06-12,9857
00948B,中信優息投資級債,118,0,118,元大-蘆洲,2024-06-12,9857
9904,寶成,117,1,116,元大-蘆洲,2024-06-12,9857
5608,四維航,116,3,113,元大-蘆洲,2024-06-12,9857
1584,精剛,102,12,90,元大-蘆洲,2024-06-12,9857
00919,群益台灣精選高息,117,35,82,元大-蘆洲,2024-06-12,9857
00687B,國泰20年美債,85,12,73,元大-蘆洲,2024-06-12,9857
00882,中信中國高股息,87,14,73,元大-蘆洲,2024-06-12,9857
2427,三商電,81,13,68,元大-蘆洲,2024-06-12,9857
2002,中鋼,58,2,56,元大-蘆洲,2024-06-12,9857
2312,金寶,62,12,50,元大-蘆洲,2024-06-12,9857
3231,緯創,118,71,47,元大-蘆洲,2024-06-12,9857
2891,中信金,54,7,47,元大-蘆洲,2024-06-12,9857
1316,上曜,70,29,41,元大-蘆洲,2024-06-12,9857
1611,中電,40,0,40,元大-蘆洲,2024-06-12,9857
2615,萬海,190,150,40,元大-蘆洲,2024-06-12,9857
2354,鴻準,62,24,38,元大-蘆洲,2024-06-12,9857
9945,潤泰新,57,22,35,元大-蘆洲,2024-06-12,9857
1617,榮星,58,26,32,元大-蘆洲,2024-06-12,9857
00947,台新臺灣IC設計,31,0,31,元大-蘆洲,2024-06-12,9857
2313,華通,50,20,30,元大-蘆洲,2024-06-12,9857
2607,榮運,28,0,28,元大-蘆洲,2024-06-12,9857
6116,彩晶,26,0,26,元大-蘆洲,2024-06-12,9857
00631L,元大台灣50正2,27,3,24,元大-蘆洲,2024-06-12,9857
2609,陽明,585,561,24,元大-蘆洲,2024-06-12,9857
2534,宏盛,23,0,23,元大-蘆洲,2024-06-12,9857
2409,友達,41,19,22,元大-蘆洲,2024-06-12,9857
3051,力特,22,0,22,元大-蘆洲,2024-06-12,9857
1524,耿鼎,21,0,21,元大-蘆洲,2024-06-12,9857
2641,正德,30,9,21,元大-蘆洲,2024-06-12,9857
6152,百一,37,16,21,元大-蘆洲,2024-06-12,9857
1101,台泥,23,3,20,元大-蘆洲,2024-06-12,9857
1570,力肯,21,1,20,元大-蘆洲,2024-06-12,9857
1815,富喬,79,59,20,元大-蘆洲,2024-06-12,9857
2610,華航,35,16,19,元大-蘆洲,2024-06-12,9857
00637L,元大滬深300正2,30,11,19,元大-蘆洲,2024-06-12,9857
2882,國泰金,21,2,19,元大-蘆洲,2024-06-12,9857
2887,台新金,44,25,19,元大-蘆洲,2024-06-12,9857
2365,昆盈,21,2,19,元大-蘆洲,2024-06-12,9857
5515,建國,19,0,19,元大-蘆洲,2024-06-12,9857
3372,典範,19,1,18,元大-蘆洲,2024-06-12,9857
2201,裕隆,23,5,18,元大-蘆洲,2024-06-12,9857
2356,英業達,55,37,18,元大-蘆洲,2024-06-12,9857
6834,天二科技,47,30,17,元大-蘆洲,2024-06-12,9857
9105,泰金寶-DR,373,81,292,元大-蘆洲,2024-06-13,9857
2449,京元電子,319,33,286,元大-蘆洲,2024-06-13,9857
00948B,中信優息投資級債,270,0,270,元大-蘆洲,2024-06-13,9857
00915,凱基優選高股息30,212,5,207,元大-蘆洲,2024-06-13,9857
2344,華邦電,217,42,175,元大-蘆洲,2024-06-13,9857
4906,正文,150,1,149,元大-蘆洲,2024-06-13,9857
2206,三陽工業,147,1,146,元大-蘆洲,2024-06-13,9857
00680L,元大美債20正2,233,130,103,元大-蘆洲,2024-06-13,9857
2408,南亞科,106,18,88,元大-蘆洲,2024-06-13,9857
00946,群益科技高息成長,175,115,60,元大-蘆洲,2024-06-13,9857
00665L,富邦�琤肭磪囓�2,62,2,60,元大-蘆洲,2024-06-13,9857
00918,大華優利高填息30,82,24,58,元大-蘆洲,2024-06-13,9857
2353,宏��,70,14,56,元大-蘆洲,2024-06-13,9857
1312,國喬,49,2,47,元大-蘆洲,2024-06-13,9857
2498,宏達電,65,18,47,元大-蘆洲,2024-06-13,9857
8110,華東,46,2,44,元大-蘆洲,2024-06-13,9857
5531,鄉林,40,0,40,元大-蘆洲,2024-06-13,9857
1522,堤維西,58,19,39,元大-蘆洲,2024-06-13,9857
9904,寶成,40,1,39,元大-蘆洲,2024-06-13,9857
00936,台新永續高息中小,46,8,38,元大-蘆洲,2024-06-13,9857
2888,新光金,146,109,37,元大-蘆洲,2024-06-13,9857
2101,南港,52,15,37,元大-蘆洲,2024-06-13,9857
2501,國建,40,4,36,元大-蘆洲,2024-06-13,9857
2615,萬海,141,107,34,元大-蘆洲,2024-06-13,9857
00942B,台新美A公司債20+,32,0,32,元大-蘆洲,2024-06-13,9857
2489,瑞軒,38,7,31,元大-蘆洲,2024-06-13,9857
00947,台新臺灣IC設計,29,0,29,元大-蘆洲,2024-06-13,9857
00881,國泰台灣5G+,39,11,28,元大-蘆洲,2024-06-13,9857
2365,昆盈,157,130,27,元大-蘆洲,2024-06-13,9857
00919,群益台灣精選高息,68,42,26,元大-蘆洲,2024-06-13,9857
3432,台端,25,0,25,元大-蘆洲,2024-06-13,9857
2542,興富發,31,6,25,元大-蘆洲,2024-06-13,9857
00631L,元大台灣50正2,27,3,24,元大-蘆洲,2024-06-13,9857
3231,緯創,56,32,24,元大-蘆洲,2024-06-13,9857
4909,新復興,55,33,22,元大-蘆洲,2024-06-13,9857
2367,燿華,167,146,21,元大-蘆洲,2024-06-13,9857
2515,中工,25,4,21,元大-蘆洲,2024-06-13,9857
6216,居易,23,3,20,元大-蘆洲,2024-06-13,9857
6147,頎邦,20,0,20,元大-蘆洲,2024-06-13,9857
2505,國揚,20,0,20,元大-蘆洲,2024-06-13,9857
2368,金像電,28,9,19,元大-蘆洲,2024-06-13,9857
1609,大亞,52,33,19,元大-蘆洲,2024-06-13,9857
5426,振發,19,0,19,元大-蘆洲,2024-06-13,9857
4533,協易機,38,19,19,元大-蘆洲,2024-06-13,9857
2208,台船,18,0,18,元大-蘆洲,2024-06-13,9857
6188,廣明,35,17,18,元大-蘆洲,2024-06-13,9857
2324,仁寶,22,4,18,元大-蘆洲,2024-06-13,9857
3454,晶睿,17,0,17,元大-蘆洲,2024-06-13,9857
6182,合晶,21,4,17,元大-蘆洲,2024-06-13,9857
1301,台塑,16,0,16,元大-蘆洲,2024-06-13,9857
00929,復華台灣科技優息,395,74,321,元大-蘆洲,2024-06-14,9857
00919,群益台灣精選高息,204,33,171,元大-蘆洲,2024-06-14,9857
2002,中鋼,169,16,153,元大-蘆洲,2024-06-14,9857
00936,台新永續高息中小,132,15,117,元大-蘆洲,2024-06-14,9857
2371,大同,348,231,117,元大-蘆洲,2024-06-14,9857
1609,大亞,261,159,102,元大-蘆洲,2024-06-14,9857
2486,一詮,166,73,93,元大-蘆洲,2024-06-14,9857
3047,訊舟,98,11,87,元大-蘆洲,2024-06-14,9857
8086,宏捷科,72,0,72,元大-蘆洲,2024-06-14,9857
00939,統一台灣高息動能,64,2,62,元大-蘆洲,2024-06-14,9857
4561,健椿,64,4,60,元大-蘆洲,2024-06-14,9857
2206,三陽工業,60,2,58,元大-蘆洲,2024-06-14,9857
00946,群益科技高息成長,58,0,58,元大-蘆洲,2024-06-14,9857
00907,永豐優息存股,60,3,57,元大-蘆洲,2024-06-14,9857
00948B,中信優息投資級債,53,0,53,元大-蘆洲,2024-06-14,9857
2618,長榮航,89,37,52,元大-蘆洲,2024-06-14,9857
2367,燿華,72,30,42,元大-蘆洲,2024-06-14,9857
2352,佳世達,38,0,38,元大-蘆洲,2024-06-14,9857
00942B,台新美A公司債20+,38,0,38,元大-蘆洲,2024-06-14,9857
2613,中櫃,101,63,38,元大-蘆洲,2024-06-14,9857
2884,玉山金,48,11,37,元大-蘆洲,2024-06-14,9857
00918,大華優利高填息30,48,11,37,元大-蘆洲,2024-06-14,9857
4968,立積,73,37,36,元大-蘆洲,2024-06-14,9857
912000,晨訊科-DR,36,0,36,元大-蘆洲,2024-06-14,9857
6190,萬泰科,36,1,35,元大-蘆洲,2024-06-14,9857
5351,鈺創,50,16,34,元大-蘆洲,2024-06-14,9857
2609,陽明,361,330,31,元大-蘆洲,2024-06-14,9857
6152,百一,30,0,30,元大-蘆洲,2024-06-14,9857
6139,亞翔,40,11,29,元大-蘆洲,2024-06-14,9857
9904,寶成,29,0,29,元大-蘆洲,2024-06-14,9857
5534,長虹,26,0,26,元大-蘆洲,2024-06-14,9857
2338,光罩,27,2,25,元大-蘆洲,2024-06-14,9857
2537,聯上發,66,43,23,元大-蘆洲,2024-06-14,9857
00713,元大台灣高息低波,23,1,22,元大-蘆洲,2024-06-14,9857
5426,振發,23,1,22,元大-蘆洲,2024-06-14,9857
3450,聯鈞,33,11,22,元大-蘆洲,2024-06-14,9857
00915,凱基優選高股息30,24,2,22,元大-蘆洲,2024-06-14,9857
5347,世界,35,13,22,元大-蘆洲,2024-06-14,9857
1515,力山,21,0,21,元大-蘆洲,2024-06-14,9857
2406,國碩,23,2,21,元大-蘆洲,2024-06-14,9857
3062,建漢,46,25,21,元大-蘆洲,2024-06-14,9857
2363,矽統,68,48,20,元大-蘆洲,2024-06-14,9857
2337,旺宏,21,1,20,元大-蘆洲,2024-06-14,9857
4402,郡都開發,20,0,20,元大-蘆洲,2024-06-14,9857
2392,正崴,51,32,19,元大-蘆洲,2024-06-14,9857
3149,正達,22,3,19,元大-蘆洲,2024-06-14,9857
3048,益登,124,105,19,元大-蘆洲,2024-06-14,9857
4533,協易機,41,23,18,元大-蘆洲,2024-06-14,9857
3363,上詮,24,7,17,元大-蘆洲,2024-06-14,9857
2617,台航,16,0,16,元大-蘆洲,2024-06-14,9857
00929,復華台灣科技優息,589,52,537,元大-蘆洲,2024-06-17,9857
8105,凌巨,320,10,310,元大-蘆洲,2024-06-17,9857
00919,群益台灣精選高息,223,22,201,元大-蘆洲,2024-06-17,9857
2609,陽明,402,211,191,元大-蘆洲,2024-06-17,9857
00936,台新永續高息中小,250,62,188,元大-蘆洲,2024-06-17,9857
00680L,元大美債20正2,180,30,150,元大-蘆洲,2024-06-17,9857
2486,一詮,186,38,148,元大-蘆洲,2024-06-17,9857
00933B,國泰10Y+金融債,125,3,122,元大-蘆洲,2024-06-17,9857
00946,群益科技高息成長,115,3,112,元大-蘆洲,2024-06-17,9857
00665L,富邦�琤肭磪囓�2,107,4,103,元大-蘆洲,2024-06-17,9857
2615,萬海,295,211,84,元大-蘆洲,2024-06-17,9857
1503,士電,145,63,82,元大-蘆洲,2024-06-17,9857
2101,南港,95,14,81,元大-蘆洲,2024-06-17,9857
5905,南仁湖,74,2,72,元大-蘆洲,2024-06-17,9857
2888,新光金,88,17,71,元大-蘆洲,2024-06-17,9857
2409,友達,107,39,68,元大-蘆洲,2024-06-17,9857
3622,洋華,86,18,68,元大-蘆洲,2024-06-17,9857
00918,大華優利高填息30,78,18,60,元大-蘆洲,2024-06-17,9857
00687B,國泰20年美債,115,56,59,元大-蘆洲,2024-06-17,9857
00753L,中信中國50正2,57,0,57,元大-蘆洲,2024-06-17,9857
1504,東元,61,5,56,元大-蘆洲,2024-06-17,9857
2603,長榮,79,28,51,元大-蘆洲,2024-06-17,9857
3376,新日興,56,12,44,元大-蘆洲,2024-06-17,9857
1513,中興電,100,62,38,元大-蘆洲,2024-06-17,9857
1616,億泰,74,36,38,元大-蘆洲,2024-06-17,9857
2886,兆豐金,33,0,33,元大-蘆洲,2024-06-17,9857
00882,中信中國高股息,35,2,33,元大-蘆洲,2024-06-17,9857
1522,堤維西,35,2,33,元大-蘆洲,2024-06-17,9857
2349,錸德,36,5,31,元大-蘆洲,2024-06-17,9857
00713,元大台灣高息低波,31,0,31,元大-蘆洲,2024-06-17,9857
2426,鼎元,30,0,30,元大-蘆洲,2024-06-17,9857
1316,上曜,37,7,30,元大-蘆洲,2024-06-17,9857
4532,瑞智,44,14,30,元大-蘆洲,2024-06-17,9857
2355,敬鵬,32,2,30,元大-蘆洲,2024-06-17,9857
2905,三商,30,1,29,元大-蘆洲,2024-06-17,9857
2501,國建,33,5,28,元大-蘆洲,2024-06-17,9857
2393,億光,34,6,28,元大-蘆洲,2024-06-17,9857
5351,鈺創,31,3,28,元大-蘆洲,2024-06-17,9857
2356,英業達,34,7,27,元大-蘆洲,2024-06-17,9857
2867,三商壽,47,20,27,元大-蘆洲,2024-06-17,9857
2025,千興,42,15,27,元大-蘆洲,2024-06-17,9857
6016,康和證,26,0,26,元大-蘆洲,2024-06-17,9857
2353,宏��,37,11,26,元大-蘆洲,2024-06-17,9857
1618,合機,108,82,26,元大-蘆洲,2024-06-17,9857
00751B,元大AAA至A公司債,26,0,26,元大-蘆洲,2024-06-17,9857
2461,光群雷,25,0,25,元大-蘆洲,2024-06-17,9857
00675L,富邦臺灣加權正2,25,0,25,元大-蘆洲,2024-06-17,9857
911868,同方友友-DR,30,6,24,元大-蘆洲,2024-06-17,9857
3231,緯創,32,9,23,元大-蘆洲,2024-06-17,9857
9904,寶成,25,2,23,元大-蘆洲,2024-06-17,9857
00632R,元大台灣50反1,553,137,416,元大-蘆洲,2024-06-18,9857
00918,大華優利高填息30,225,58,167,元大-蘆洲,2024-06-18,9857
9105,泰金寶-DR,194,35,159,元大-蘆洲,2024-06-18,9857
9103,美德醫療-DR,155,19,136,元大-蘆洲,2024-06-18,9857
00929,復華台灣科技優息,341,208,133,元大-蘆洲,2024-06-18,9857
00687B,國泰20年美債,146,20,126,元大-蘆洲,2024-06-18,9857
00885,富邦越南,100,0,100,元大-蘆洲,2024-06-18,9857
2371,大同,172,88,84,元大-蘆洲,2024-06-18,9857
00937B,群益ESG投等債20,80,2,78,元大-蘆洲,2024-06-18,9857
00637L,元大滬深300正2,90,20,70,元大-蘆洲,2024-06-18,9857
1504,東元,89,26,63,元大-蘆洲,2024-06-18,9857
3037,欣興,87,25,62,元大-蘆洲,2024-06-18,9857
9904,寶成,65,10,55,元大-蘆洲,2024-06-18,9857
2022,聚亨,54,1,53,元大-蘆洲,2024-06-18,9857
00933B,國泰10Y+金融債,53,3,50,元大-蘆洲,2024-06-18,9857
00753L,中信中國50正2,50,0,50,元大-蘆洲,2024-06-18,9857
4562,穎漢,283,234,49,元大-蘆洲,2024-06-18,9857
8028,昇陽半導體,138,92,46,元大-蘆洲,2024-06-18,9857
2353,宏��,72,27,45,元大-蘆洲,2024-06-18,9857
8096,擎亞,271,229,42,元大-蘆洲,2024-06-18,9857
2486,一詮,57,18,39,元大-蘆洲,2024-06-18,9857
2482,連宇,38,0,38,元大-蘆洲,2024-06-18,9857
00915,凱基優選高股息30,38,1,37,元大-蘆洲,2024-06-18,9857
00919,群益台灣精選高息,95,59,36,元大-蘆洲,2024-06-18,9857
2312,金寶,54,19,35,元大-蘆洲,2024-06-18,9857
4906,正文,36,1,35,元大-蘆洲,2024-06-18,9857
2107,厚生,35,0,35,元大-蘆洲,2024-06-18,9857
2363,矽統,95,62,33,元大-蘆洲,2024-06-18,9857
4967,十銓,84,55,29,元大-蘆洲,2024-06-18,9857
2887,台新金,30,2,28,元大-蘆洲,2024-06-18,9857
2385,群光,30,2,28,元大-蘆洲,2024-06-18,9857
3376,新日興,35,8,27,元大-蘆洲,2024-06-18,9857
00939,統一台灣高息動能,29,2,27,元大-蘆洲,2024-06-18,9857
00948B,中信優息投資級債,29,2,27,元大-蘆洲,2024-06-18,9857
4526,東台,69,43,26,元大-蘆洲,2024-06-18,9857
00673R,期元大S＆P原油反1,25,0,25,元大-蘆洲,2024-06-18,9857
1802,台玻,74,49,25,元大-蘆洲,2024-06-18,9857
1303,南亞,27,5,22,元大-蘆洲,2024-06-18,9857
2317,鴻海,83,61,22,元大-蘆洲,2024-06-18,9857
5515,建國,21,0,21,元大-蘆洲,2024-06-18,9857
1445,大宇,21,0,21,元大-蘆洲,2024-06-18,9857
00713,元大台灣高息低波,32,12,20,元大-蘆洲,2024-06-18,9857
2426,鼎元,20,0,20,元大-蘆洲,2024-06-18,9857
2062,橋椿,20,0,20,元大-蘆洲,2024-06-18,9857
00907,永豐優息存股,20,0,20,元大-蘆洲,2024-06-18,9857
1301,台塑,20,1,19,元大-蘆洲,2024-06-18,9857
00688L,國泰20年美債正2,18,0,18,元大-蘆洲,2024-06-18,9857
00675L,富邦臺灣加權正2,20,2,18,元大-蘆洲,2024-06-18,9857
5607,遠雄港,18,0,18,元大-蘆洲,2024-06-18,9857
6213,聯茂,30,13,17,元大-蘆洲,2024-06-18,9857
00632R,元大台灣50反1,2004,110,1894,元大-蘆洲,2024-06-19,9857
00937B,群益ESG投等債20,295,65,230,元大-蘆洲,2024-06-19,9857
1514,亞力,207,60,147,元大-蘆洲,2024-06-19,9857
2618,長榮航,433,287,146,元大-蘆洲,2024-06-19,9857
2888,新光金,175,51,124,元大-蘆洲,2024-06-19,9857
2408,南亞科,141,26,115,元大-蘆洲,2024-06-19,9857
00687B,國泰20年美債,167,52,115,元大-蘆洲,2024-06-19,9857
00713,元大台灣高息低波,122,9,113,元大-蘆洲,2024-06-19,9857
3673,TPK-KY,130,22,108,元大-蘆洲,2024-06-19,9857
00933B,國泰10Y+金融債,112,5,107,元大-蘆洲,2024-06-19,9857
2371,大同,148,42,106,元大-蘆洲,2024-06-19,9857
2465,麗臺,91,0,91,元大-蘆洲,2024-06-19,9857
00946,群益科技高息成長,88,0,88,元大-蘆洲,2024-06-19,9857
5443,均豪,170,89,81,元大-蘆洲,2024-06-19,9857
3622,洋華,92,22,70,元大-蘆洲,2024-06-19,9857
2891,中信金,76,6,70,元大-蘆洲,2024-06-19,9857
2363,矽統,99,29,70,元大-蘆洲,2024-06-19,9857
2328,廣宇,70,4,66,元大-蘆洲,2024-06-19,9857
1815,富喬,152,94,58,元大-蘆洲,2024-06-19,9857
00673R,期元大S＆P原油反1,58,0,58,元大-蘆洲,2024-06-19,9857
2867,三商壽,56,9,47,元大-蘆洲,2024-06-19,9857
3062,建漢,299,252,47,元大-蘆洲,2024-06-19,9857
00939,統一台灣高息動能,167,124,43,元大-蘆洲,2024-06-19,9857
2511,太子,42,0,42,元大-蘆洲,2024-06-19,9857
00936,台新永續高息中小,92,50,42,元大-蘆洲,2024-06-19,9857
1440,南紡,40,1,39,元大-蘆洲,2024-06-19,9857
6218,豪勉,38,0,38,元大-蘆洲,2024-06-19,9857
2406,國碩,59,22,37,元大-蘆洲,2024-06-19,9857
2886,兆豐金,52,15,37,元大-蘆洲,2024-06-19,9857
2301,光寶科,47,11,36,元大-蘆洲,2024-06-19,9857
00680L,元大美債20正2,52,18,34,元大-蘆洲,2024-06-19,9857
3450,聯鈞,164,132,32,元大-蘆洲,2024-06-19,9857
5531,鄉林,35,5,30,元大-蘆洲,2024-06-19,9857
4927,泰鼎-KY,30,0,30,元大-蘆洲,2024-06-19,9857
4561,健椿,35,6,29,元大-蘆洲,2024-06-19,9857
00919,群益台灣精選高息,339,313,26,元大-蘆洲,2024-06-19,9857
5371,中光電,29,3,26,元大-蘆洲,2024-06-19,9857
4728,雙美,26,0,26,元大-蘆洲,2024-06-19,9857
1504,東元,48,23,25,元大-蘆洲,2024-06-19,9857
8064,東捷,80,54,26,元大-蘆洲,2024-06-19,9857
2353,宏��,43,18,25,元大-蘆洲,2024-06-19,9857
00679B,元大美債20年,32,7,25,元大-蘆洲,2024-06-19,9857
9904,寶成,24,0,24,元大-蘆洲,2024-06-19,9857
00948B,中信優息投資級債,23,0,23,元大-蘆洲,2024-06-19,9857
2362,藍天,23,0,23,元大-蘆洲,2024-06-19,9857
3374,精材,26,5,21,元大-蘆洲,2024-06-19,9857
6213,聯茂,22,1,21,元大-蘆洲,2024-06-19,9857
6834,天二科技,28,7,21,元大-蘆洲,2024-06-19,9857
3260,威剛,31,11,20,元大-蘆洲,2024-06-19,9857
6266,泰詠,20,0,20,元大-蘆洲,2024-06-19,9857
9105,泰金寶-DR,219,9,210,元大-蘆洲,2024-06-20,9857
00687B,國泰20年美債,184,8,176,元大-蘆洲,2024-06-20,9857
1611,中電,215,46,169,元大-蘆洲,2024-06-20,9857
00650L,復華香港正2,141,0,141,元大-蘆洲,2024-06-20,9857
4909,新復興,296,165,131,元大-蘆洲,2024-06-20,9857
4561,健椿,123,8,115,元大-蘆洲,2024-06-20,9857
2886,兆豐金,103,5,98,元大-蘆洲,2024-06-20,9857
00940,元大台灣價值高息,351,259,92,元大-蘆洲,2024-06-20,9857
2880,華南金,83,7,76,元大-蘆洲,2024-06-20,9857
00946,群益科技高息成長,129,65,64,元大-蘆洲,2024-06-20,9857
00948B,中信優息投資級債,61,0,61,元大-蘆洲,2024-06-20,9857
3047,訊舟,74,14,60,元大-蘆洲,2024-06-20,9857
00929,復華台灣科技優息,201,144,57,元大-蘆洲,2024-06-20,9857
2371,大同,97,40,57,元大-蘆洲,2024-06-20,9857
4958,臻鼎-KY,65,12,53,元大-蘆洲,2024-06-20,9857
1301,台塑,52,2,50,元大-蘆洲,2024-06-20,9857
00936,台新永續高息中小,119,74,45,元大-蘆洲,2024-06-20,9857
3037,欣興,49,11,38,元大-蘆洲,2024-06-20,9857
5905,南仁湖,40,3,37,元大-蘆洲,2024-06-20,9857
00891,中信關鍵半導體,40,4,36,元大-蘆洲,2024-06-20,9857
00933B,國泰10Y+金融債,36,2,34,元大-蘆洲,2024-06-20,9857
2353,宏��,47,14,33,元大-蘆洲,2024-06-20,9857
2515,中工,36,3,33,元大-蘆洲,2024-06-20,9857
6140,訊達,36,5,31,元大-蘆洲,2024-06-20,9857
00676R,富邦臺灣加權反1,50,20,30,元大-蘆洲,2024-06-20,9857
1514,亞力,116,88,28,元大-蘆洲,2024-06-20,9857
00680L,元大美債20正2,27,0,27,元大-蘆洲,2024-06-20,9857
00679B,元大美債20年,49,23,26,元大-蘆洲,2024-06-20,9857
3231,緯創,60,34,26,元大-蘆洲,2024-06-20,9857
4306,炎洲,28,6,22,元大-蘆洲,2024-06-20,9857
4966,譜瑞-KY,25,4,21,元大-蘆洲,2024-06-20,9857
2382,廣達,103,82,21,元大-蘆洲,2024-06-20,9857
2014,中鴻,22,1,21,元大-蘆洲,2024-06-20,9857
6116,彩晶,36,15,21,元大-蘆洲,2024-06-20,9857
1618,合機,41,21,20,元大-蘆洲,2024-06-20,9857
6266,泰詠,20,0,20,元大-蘆洲,2024-06-20,9857
2462,良得電,21,1,20,元大-蘆洲,2024-06-20,9857
5210,寶碩,20,0,20,元大-蘆洲,2024-06-20,9857
1605,華新,21,2,19,元大-蘆洲,2024-06-20,9857
2330,台積電,23,4,19,元大-蘆洲,2024-06-20,9857
00935,野村臺灣新科技50,19,0,19,元大-蘆洲,2024-06-20,9857
2887,台新金,24,5,19,元大-蘆洲,2024-06-20,9857
2385,群光,19,1,18,元大-蘆洲,2024-06-20,9857
2498,宏達電,39,21,18,元大-蘆洲,2024-06-20,9857
8096,擎亞,61,43,18,元大-蘆洲,2024-06-20,9857
00673R,期元大S＆P原油反1,18,0,18,元大-蘆洲,2024-06-20,9857
2427,三商電,21,3,18,元大-蘆洲,2024-06-20,9857
4915,致伸,23,6,17,元大-蘆洲,2024-06-20,9857
3324,雙鴻,20,3,17,元大-蘆洲,2024-06-20,9857
1308,亞聚,20,3,17,元大-蘆洲,2024-06-20,9857
00940,元大台灣價值高息,667,249,418,元大-蘆洲,2024-06-21,9857
9105,泰金寶-DR,264,11,253,元大-蘆洲,2024-06-21,9857
2609,陽明,427,250,177,元大-蘆洲,2024-06-21,9857
00929,復華台灣科技優息,306,151,155,元大-蘆洲,2024-06-21,9857
2317,鴻海,240,101,139,元大-蘆洲,2024-06-21,9857
00933B,國泰10Y+金融債,139,10,129,元大-蘆洲,2024-06-21,9857
00706L,期元大S＆P日圓正2,114,0,114,元大-蘆洲,2024-06-21,9857
1301,台塑,114,6,108,元大-蘆洲,2024-06-21,9857
00679B,元大美債20年,248,153,95,元大-蘆洲,2024-06-21,9857
00885,富邦越南,107,16,91,元大-蘆洲,2024-06-21,9857
00948B,中信優息投資級債,99,18,81,元大-蘆洲,2024-06-21,9857
00946,群益科技高息成長,89,17,72,元大-蘆洲,2024-06-21,9857
00637L,元大滬深300正2,82,10,72,元大-蘆洲,2024-06-21,9857
2301,光寶科,67,0,67,元大-蘆洲,2024-06-21,9857
3483,力致,199,135,64,元大-蘆洲,2024-06-21,9857
6116,彩晶,277,215,62,元大-蘆洲,2024-06-21,9857
3673,TPK-KY,63,9,54,元大-蘆洲,2024-06-21,9857
2354,鴻準,93,40,53,元大-蘆洲,2024-06-21,9857
2511,太子,53,0,53,元大-蘆洲,2024-06-21,9857
2515,中工,58,5,53,元大-蘆洲,2024-06-21,9857
2369,菱生,54,2,52,元大-蘆洲,2024-06-21,9857
4960,誠美材,62,11,51,元大-蘆洲,2024-06-21,9857
2615,萬海,246,195,51,元大-蘆洲,2024-06-21,9857
00687B,國泰20年美債,80,30,50,元大-蘆洲,2024-06-21,9857
00878,國泰永續高股息,78,28,50,元大-蘆洲,2024-06-21,9857
2601,益航,50,4,46,元大-蘆洲,2024-06-21,9857
00936,台新永續高息中小,43,5,38,元大-蘆洲,2024-06-21,9857
00934,中信成長高股息,37,0,37,元大-蘆洲,2024-06-21,9857
00713,元大台灣高息低波,43,6,37,元大-蘆洲,2024-06-21,9857
3686,達能,41,5,36,元大-蘆洲,2024-06-21,9857
2330,台積電,46,11,35,元大-蘆洲,2024-06-21,9857
8048,德勝,48,14,34,元大-蘆洲,2024-06-21,9857
3481,群創,888,855,33,元大-蘆洲,2024-06-21,9857
4956,光鋐,90,57,33,元大-蘆洲,2024-06-21,9857
9945,潤泰新,32,3,29,元大-蘆洲,2024-06-21,9857
2548,華固,40,11,29,元大-蘆洲,2024-06-21,9857
8011,台通,66,38,28,元大-蘆洲,2024-06-21,9857
6552,易華電,28,0,28,元大-蘆洲,2024-06-21,9857
2371,大同,47,20,27,元大-蘆洲,2024-06-21,9857
6207,雷科,35,9,26,元大-蘆洲,2024-06-21,9857
2603,長榮,47,21,26,元大-蘆洲,2024-06-21,9857
6282,康舒,33,8,25,元大-蘆洲,2024-06-21,9857
2349,錸德,31,6,25,元大-蘆洲,2024-06-21,9857
1802,台玻,28,3,25,元大-蘆洲,2024-06-21,9857
00675L,富邦臺灣加權正2,24,0,24,元大-蘆洲,2024-06-21,9857
2492,華新科,42,18,24,元大-蘆洲,2024-06-21,9857
3694,海華,38,14,24,元大-蘆洲,2024-06-21,9857
3338,泰碩,25,2,23,元大-蘆洲,2024-06-21,9857
1504,東元,26,3,23,元大-蘆洲,2024-06-21,9857
1309,台達化,40,18,22,元大-蘆洲,2024-06-21,9857
00929,復華台灣科技優息,517,38,479,元大-蘆洲,2024-06-24,9857
3481,群創,1560,1195,365,元大-蘆洲,2024-06-24,9857
00937B,群益ESG投等債20,352,20,332,元大-蘆洲,2024-06-24,9857
00940,元大台灣價值高息,465,227,238,元大-蘆洲,2024-06-24,9857
9105,泰金寶-DR,231,35,196,元大-蘆洲,2024-06-24,9857
1785,光洋科,313,159,154,元大-蘆洲,2024-06-24,9857
3062,建漢,468,336,132,元大-蘆洲,2024-06-24,9857
00919,群益台灣精選高息,460,341,119,元大-蘆洲,2024-06-24,9857
1503,士電,126,23,103,元大-蘆洲,2024-06-24,9857
00753L,中信中國50正2,101,0,101,元大-蘆洲,2024-06-24,9857
2409,友達,137,47,90,元大-蘆洲,2024-06-24,9857
2615,萬海,194,106,88,元大-蘆洲,2024-06-24,9857
00918,大華優利高填息30,87,7,80,元大-蘆洲,2024-06-24,9857
2317,鴻海,156,79,77,元大-蘆洲,2024-06-24,9857
00885,富邦越南,107,30,77,元大-蘆洲,2024-06-24,9857
00936,台新永續高息中小,76,2,74,元大-蘆洲,2024-06-24,9857
00947,台新臺灣IC設計,74,5,69,元大-蘆洲,2024-06-24,9857
1314,中石化,135,67,68,元大-蘆洲,2024-06-24,9857
2330,台積電,87,25,62,元大-蘆洲,2024-06-24,9857
5443,均豪,128,72,56,元大-蘆洲,2024-06-24,9857
1309,台達化,73,19,54,元大-蘆洲,2024-06-24,9857
2301,光寶科,52,3,49,元大-蘆洲,2024-06-24,9857
2353,宏��,59,15,44,元大-蘆洲,2024-06-24,9857
2349,錸德,63,20,43,元大-蘆洲,2024-06-24,9857
5452,佶優,42,0,42,元大-蘆洲,2024-06-24,9857
4906,正文,42,0,42,元大-蘆洲,2024-06-24,9857
3714,富采,42,0,42,元大-蘆洲,2024-06-24,9857
1802,台玻,60,20,40,元大-蘆洲,2024-06-24,9857
1301,台塑,40,0,40,元大-蘆洲,2024-06-24,9857
2382,廣達,69,30,39,元大-蘆洲,2024-06-24,9857
2324,仁寶,40,1,39,元大-蘆洲,2024-06-24,9857
9904,寶成,40,3,37,元大-蘆洲,2024-06-24,9857
3047,訊舟,155,119,36,元大-蘆洲,2024-06-24,9857
00881,國泰台灣5G+,40,5,35,元大-蘆洲,2024-06-24,9857
6770,力積電,40,7,33,元大-蘆洲,2024-06-24,9857
1312,國喬,30,0,30,元大-蘆洲,2024-06-24,9857
1310,台苯,30,0,30,元大-蘆洲,2024-06-24,9857
00878,國泰永續高股息,73,44,29,元大-蘆洲,2024-06-24,9857
2367,燿華,32,3,29,元大-蘆洲,2024-06-24,9857
3622,洋華,29,0,29,元大-蘆洲,2024-06-24,9857
2002,中鋼,32,3,29,元大-蘆洲,2024-06-24,9857
4979,華星光,42,14,28,元大-蘆洲,2024-06-24,9857
2537,聯上發,72,44,28,元大-蘆洲,2024-06-24,9857
3450,聯鈞,93,65,28,元大-蘆洲,2024-06-24,9857
3576,聯合再生,46,19,27,元大-蘆洲,2024-06-24,9857
00679B,元大美債20年,46,19,27,元大-蘆洲,2024-06-24,9857
3037,欣興,28,3,25,元大-蘆洲,2024-06-24,9857
2340,台亞,29,4,25,元大-蘆洲,2024-06-24,9857
8085,福華,40,16,24,元大-蘆洲,2024-06-24,9857
1504,東元,26,2,24,元大-蘆洲,2024-06-24,9857
00936,台新永續高息中小,241,9,232,元大-蘆洲,2024-06-25,9857
00885,富邦越南,231,2,229,元大-蘆洲,2024-06-25,9857
3481,群創,1033,816,217,元大-蘆洲,2024-06-25,9857
9105,泰金寶-DR,224,54,170,元大-蘆洲,2024-06-25,9857
00929,復華台灣科技優息,238,103,135,元大-蘆洲,2024-06-25,9857
1815,富喬,91,18,73,元大-蘆洲,2024-06-25,9857
6116,彩晶,89,16,73,元大-蘆洲,2024-06-25,9857
2883,凱基金,74,3,71,元大-蘆洲,2024-06-25,9857
00946,群益科技高息成長,63,3,60,元大-蘆洲,2024-06-25,9857
2354,鴻準,132,75,57,元大-蘆洲,2024-06-25,9857
1309,台達化,50,3,47,元大-蘆洲,2024-06-25,9857
2301,光寶科,50,4,46,元大-蘆洲,2024-06-25,9857
2601,益航,45,0,45,元大-蘆洲,2024-06-25,9857
1802,台玻,44,0,44,元大-蘆洲,2024-06-25,9857
3708,上緯投控,42,1,41,元大-蘆洲,2024-06-25,9857
2542,興富發,48,8,40,元大-蘆洲,2024-06-25,9857
2352,佳世達,72,32,40,元大-蘆洲,2024-06-25,9857
5481,新華,46,8,38,元大-蘆洲,2024-06-25,9857
8103,瀚荃,38,1,37,元大-蘆洲,2024-06-25,9857
3037,欣興,38,4,34,元大-蘆洲,2024-06-25,9857
1301,台塑,38,4,34,元大-蘆洲,2024-06-25,9857
1731,美吾華,34,0,34,元大-蘆洲,2024-06-25,9857
3231,緯創,54,20,34,元大-蘆洲,2024-06-25,9857
1503,士電,56,23,33,元大-蘆洲,2024-06-25,9857
3024,憶聲,32,0,32,元大-蘆洲,2024-06-25,9857
2464,盟立,48,18,30,元大-蘆洲,2024-06-25,9857
2324,仁寶,31,1,30,元大-蘆洲,2024-06-25,9857
6120,達運,29,0,29,元大-蘆洲,2024-06-25,9857
2002,中鋼,38,11,27,元大-蘆洲,2024-06-25,9857
2455,全新,28,1,27,元大-蘆洲,2024-06-25,9857
8176,智捷,26,0,26,元大-蘆洲,2024-06-25,9857
2377,微星,26,1,25,元大-蘆洲,2024-06-25,9857
2891,中信金,26,1,25,元大-蘆洲,2024-06-25,9857
3483,力致,42,18,24,元大-蘆洲,2024-06-25,9857
6147,頎邦,29,5,24,元大-蘆洲,2024-06-25,9857
2101,南港,24,2,22,元大-蘆洲,2024-06-25,9857
2382,廣達,43,23,20,元大-蘆洲,2024-06-25,9857
00942B,台新美A公司債20+,20,0,20,元大-蘆洲,2024-06-25,9857
2489,瑞軒,21,1,20,元大-蘆洲,2024-06-25,9857
1442,名軒,19,0,19,元大-蘆洲,2024-06-25,9857
3049,精金,18,0,18,元大-蘆洲,2024-06-25,9857
00934,中信成長高股息,20,2,18,元大-蘆洲,2024-06-25,9857
912000,晨訊科-DR,30,12,18,元大-蘆洲,2024-06-25,9857
2344,華邦電,30,13,17,元大-蘆洲,2024-06-25,9857
2537,聯上發,18,1,17,元大-蘆洲,2024-06-25,9857
1522,堤維西,22,5,17,元大-蘆洲,2024-06-25,9857
6443,元晶,17,0,17,元大-蘆洲,2024-06-25,9857
3715,定穎投控,30,14,16,元大-蘆洲,2024-06-25,9857
8011,台通,30,14,16,元大-蘆洲,2024-06-25,9857
5009,榮剛,16,0,16,元大-蘆洲,2024-06-25,9857
00936,台新永續高息中小,274,0,274,元大-蘆洲,2024-06-26,9857
2002,中鋼,244,4,240,元大-蘆洲,2024-06-26,9857
00632R,元大台灣50反1,291,57,234,元大-蘆洲,2024-06-26,9857
00637L,元大滬深300正2,220,0,220,元大-蘆洲,2024-06-26,9857
00929,復華台灣科技優息,191,49,142,元大-蘆洲,2024-06-26,9857
9105,泰金寶-DR,164,33,131,元大-蘆洲,2024-06-26,9857
2409,友達,155,27,128,元大-蘆洲,2024-06-26,9857
00706L,期元大S＆P日圓正2,100,0,100,元大-蘆洲,2024-06-26,9857
00679B,元大美債20年,108,11,97,元大-蘆洲,2024-06-26,9857
00891,中信關鍵半導體,87,1,86,元大-蘆洲,2024-06-26,9857
2317,鴻海,130,55,75,元大-蘆洲,2024-06-26,9857
00942B,台新美A公司債20+,71,0,71,元大-蘆洲,2024-06-26,9857
2884,玉山金,76,6,70,元大-蘆洲,2024-06-26,9857
3712,永崴投控,120,52,68,元大-蘆洲,2024-06-26,9857
00940,元大台灣價值高息,170,104,66,元大-蘆洲,2024-06-26,9857
00939,統一台灣高息動能,69,5,64,元大-蘆洲,2024-06-26,9857
00919,群益台灣精選高息,110,52,58,元大-蘆洲,2024-06-26,9857
2889,國票金,55,7,48,元大-蘆洲,2024-06-26,9857
2515,中工,55,12,43,元大-蘆洲,2024-06-26,9857
00651R,復華香港反1,41,0,41,元大-蘆洲,2024-06-26,9857
1785,光洋科,120,81,39,元大-蘆洲,2024-06-26,9857
00947,台新臺灣IC設計,37,0,37,元大-蘆洲,2024-06-26,9857
5443,均豪,121,84,37,元大-蘆洲,2024-06-26,9857
6443,元晶,50,14,36,元大-蘆洲,2024-06-26,9857
2349,錸德,38,3,35,元大-蘆洲,2024-06-26,9857
00941,中信上游半導體,62,28,34,元大-蘆洲,2024-06-26,9857
2615,萬海,119,85,34,元大-蘆洲,2024-06-26,9857
00687B,國泰20年美債,47,13,34,元大-蘆洲,2024-06-26,9857
3168,眾福科,33,0,33,元大-蘆洲,2024-06-26,9857
3324,雙鴻,34,3,31,元大-蘆洲,2024-06-26,9857
00933B,國泰10Y+金融債,31,0,31,元大-蘆洲,2024-06-26,9857
00948B,中信優息投資級債,30,0,30,元大-蘆洲,2024-06-26,9857
2886,兆豐金,33,3,30,元大-蘆洲,2024-06-26,9857
4967,十銓,36,7,29,元大-蘆洲,2024-06-26,9857
1802,台玻,28,0,28,元大-蘆洲,2024-06-26,9857
00713,元大台灣高息低波,29,1,28,元大-蘆洲,2024-06-26,9857
9919,康那香,29,1,28,元大-蘆洲,2024-06-26,9857
6505,台塑化,54,27,27,元大-蘆洲,2024-06-26,9857
3535,晶彩科,74,48,26,元大-蘆洲,2024-06-26,9857
6770,力積電,38,12,26,元大-蘆洲,2024-06-26,9857
9904,寶成,26,1,25,元大-蘆洲,2024-06-26,9857
8103,瀚荃,30,5,25,元大-蘆洲,2024-06-26,9857
5608,四維航,26,1,25,元大-蘆洲,2024-06-26,9857
8354,冠好,25,0,25,元大-蘆洲,2024-06-26,9857
3711,日月光投控,33,8,25,元大-蘆洲,2024-06-26,9857
2371,大同,29,4,25,元大-蘆洲,2024-06-26,9857
2888,新光金,60,35,25,元大-蘆洲,2024-06-26,9857
1815,富喬,47,24,23,元大-蘆洲,2024-06-26,9857
3715,定穎投控,29,6,23,元大-蘆洲,2024-06-26,9857
2401,凌陽,31,9,22,元大-蘆洲,2024-06-26,9857
00937B,群益ESG投等債20,418,47,371,元大-蘆洲,2024-06-27,9857
00929,復華台灣科技優息,304,10,294,元大-蘆洲,2024-06-27,9857
3481,群創,597,317,280,元大-蘆洲,2024-06-27,9857
00878,國泰永續高股息,260,14,246,元大-蘆洲,2024-06-27,9857
00936,台新永續高息中小,220,0,220,元大-蘆洲,2024-06-27,9857
00679B,元大美債20年,180,30,150,元大-蘆洲,2024-06-27,9857
00680L,元大美債20正2,158,22,136,元大-蘆洲,2024-06-27,9857
2885,元大金,136,2,134,元大-蘆洲,2024-06-27,9857
3576,聯合再生,209,77,132,元大-蘆洲,2024-06-27,9857
4909,新復興,127,33,94,元大-蘆洲,2024-06-27,9857
00948B,中信優息投資級債,89,2,87,元大-蘆洲,2024-06-27,9857
00933B,國泰10Y+金融債,74,0,74,元大-蘆洲,2024-06-27,9857
00687B,國泰20年美債,82,10,72,元大-蘆洲,2024-06-27,9857
00919,群益台灣精選高息,74,11,63,元大-蘆洲,2024-06-27,9857
6806,森崴能源,159,97,62,元大-蘆洲,2024-06-27,9857
3047,訊舟,258,208,50,元大-蘆洲,2024-06-27,9857
8070,長華*,52,2,50,元大-蘆洲,2024-06-27,9857
0056,元大高股息,47,4,43,元大-蘆洲,2024-06-27,9857
3714,富采,42,0,42,元大-蘆洲,2024-06-27,9857
2371,大同,51,10,41,元大-蘆洲,2024-06-27,9857
2409,友達,46,5,41,元大-蘆洲,2024-06-27,9857
2303,聯電,56,16,40,元大-蘆洲,2024-06-27,9857
9945,潤泰新,41,2,39,元大-蘆洲,2024-06-27,9857
00942B,台新美A公司債20+,40,2,38,元大-蘆洲,2024-06-27,9857
2344,華邦電,39,2,37,元大-蘆洲,2024-06-27,9857
2002,中鋼,44,8,36,元大-蘆洲,2024-06-27,9857
4938,和碩,35,0,35,元大-蘆洲,2024-06-27,9857
8076,伍豐,80,46,34,元大-蘆洲,2024-06-27,9857
8103,瀚荃,35,2,33,元大-蘆洲,2024-06-27,9857
8064,東捷,55,23,32,元大-蘆洲,2024-06-27,9857
2421,建準,30,0,30,元大-蘆洲,2024-06-27,9857
4167,松瑞藥,101,72,29,元大-蘆洲,2024-06-27,9857
2356,英業達,38,12,26,元大-蘆洲,2024-06-27,9857
5355,佳總,26,0,26,元大-蘆洲,2024-06-27,9857
1605,華新,30,5,25,元大-蘆洲,2024-06-27,9857
3062,建漢,81,56,25,元大-蘆洲,2024-06-27,9857
6257,矽格,26,1,25,元大-蘆洲,2024-06-27,9857
2324,仁寶,31,7,24,元大-蘆洲,2024-06-27,9857
8096,擎亞,31,8,23,元大-蘆洲,2024-06-27,9857
6116,彩晶,56,34,22,元大-蘆洲,2024-06-27,9857
00881,國泰台灣5G+,30,8,22,元大-蘆洲,2024-06-27,9857
4545,銘鈺,23,1,22,元大-蘆洲,2024-06-27,9857
5426,振發,27,5,22,元大-蘆洲,2024-06-27,9857
2887,台新金,22,1,21,元大-蘆洲,2024-06-27,9857
2883,凱基金,28,8,20,元大-蘆洲,2024-06-27,9857
1301,台塑,25,5,20,元大-蘆洲,2024-06-27,9857
5531,鄉林,20,0,20,元大-蘆洲,2024-06-27,9857
00713,元大台灣高息低波,20,0,20,元大-蘆洲,2024-06-27,9857
3483,力致,37,17,20,元大-蘆洲,2024-06-27,9857
1785,光洋科,76,57,19,元大-蘆洲,2024-06-27,9857
00929,復華台灣科技優息,1065,77,988,元大-蘆洲,2024-06-28,9857
1609,大亞,262,59,203,元大-蘆洲,2024-06-28,9857
00937B,群益ESG投等債20,173,44,129,元大-蘆洲,2024-06-28,9857
2618,長榮航,181,54,127,元大-蘆洲,2024-06-28,9857
00936,台新永續高息中小,110,0,110,元大-蘆洲,2024-06-28,9857
8064,東捷,167,61,106,元大-蘆洲,2024-06-28,9857
00679B,元大美債20年,117,14,103,元大-蘆洲,2024-06-28,9857
00680L,元大美債20正2,106,10,96,元大-蘆洲,2024-06-28,9857
00933B,國泰10Y+金融債,91,0,91,元大-蘆洲,2024-06-28,9857
3576,聯合再生,296,211,85,元大-蘆洲,2024-06-28,9857
9934,成霖,72,0,72,元大-蘆洲,2024-06-28,9857
00919,群益台灣精選高息,82,28,54,元大-蘆洲,2024-06-28,9857
9904,寶成,53,0,53,元大-蘆洲,2024-06-28,9857
00713,元大台灣高息低波,53,0,53,元大-蘆洲,2024-06-28,9857
2610,華航,148,98,50,元大-蘆洲,2024-06-28,9857
2301,光寶科,54,4,50,元大-蘆洲,2024-06-28,9857
2352,佳世達,54,7,47,元大-蘆洲,2024-06-28,9857
2501,國建,48,4,44,元大-蘆洲,2024-06-28,9857
2409,友達,60,17,43,元大-蘆洲,2024-06-28,9857
00687B,國泰20年美債,45,3,42,元大-蘆洲,2024-06-28,9857
2887,台新金,45,5,40,元大-蘆洲,2024-06-28,9857
6244,茂迪,72,32,40,元大-蘆洲,2024-06-28,9857
00882,中信中國高股息,39,0,39,元大-蘆洲,2024-06-28,9857
3312,弘憶股,132,95,37,元大-蘆洲,2024-06-28,9857
00712,復華富時不動產,39,3,36,元大-蘆洲,2024-06-28,9857
6213,聯茂,54,18,36,元大-蘆洲,2024-06-28,9857
2303,聯電,63,29,34,元大-蘆洲,2024-06-28,9857
00651R,復華香港反1,56,22,34,元大-蘆洲,2024-06-28,9857
00948B,中信優息投資級債,34,0,34,元大-蘆洲,2024-06-28,9857
00632R,元大台灣50反1,31,0,31,元大-蘆洲,2024-06-28,9857
00751B,元大AAA至A公司債,31,0,31,元大-蘆洲,2024-06-28,9857
2601,益航,30,0,30,元大-蘆洲,2024-06-28,9857
5475,德宏,29,0,29,元大-蘆洲,2024-06-28,9857
8027,鈦昇,57,28,29,元大-蘆洲,2024-06-28,9857
2883,凱基金,71,43,28,元大-蘆洲,2024-06-28,9857
4561,健椿,31,5,26,元大-蘆洲,2024-06-28,9857
0056,元大高股息,28,2,26,元大-蘆洲,2024-06-28,9857
8354,冠好,25,0,25,元大-蘆洲,2024-06-28,9857
2337,旺宏,24,0,24,元大-蘆洲,2024-06-28,9857
2369,菱生,27,3,24,元大-蘆洲,2024-06-28,9857
00756B,群益投等新興公債,23,0,23,元大-蘆洲,2024-06-28,9857
8076,伍豐,34,11,23,元大-蘆洲,2024-06-28,9857
3615,安可,23,3,20,元大-蘆洲,2024-06-28,9857
00673R,期元大S＆P原油反1,20,0,20,元大-蘆洲,2024-06-28,9857
6147,頎邦,20,0,20,元大-蘆洲,2024-06-28,9857
4167,松瑞藥,20,1,19,元大-蘆洲,2024-06-28,9857
2406,國碩,150,131,19,元大-蘆洲,2024-06-28,9857
6770,力積電,25,7,18,元大-蘆洲,2024-06-28,9857
00720B,元大投資級公司債,18,0,18,元大-蘆洲,2024-06-28,9857
8404,百和興業-KY,20,2,18,元大-蘆洲,2024-06-28,9857
00632R,元大台灣50反1,801,94,707,元大-蘆洲,2024-07-01,9857
00937B,群益ESG投等債20,488,91,397,元大-蘆洲,2024-07-01,9857
00929,復華台灣科技優息,325,27,298,元大-蘆洲,2024-07-01,9857
00680L,元大美債20正2,241,28,213,元大-蘆洲,2024-07-01,9857
2002,中鋼,237,32,205,元大-蘆洲,2024-07-01,9857
00948B,中信優息投資級債,204,0,204,元大-蘆洲,2024-07-01,9857
00679B,元大美債20年,196,35,161,元大-蘆洲,2024-07-01,9857
00936,台新永續高息中小,269,139,130,元大-蘆洲,2024-07-01,9857
00934,中信成長高股息,122,3,119,元大-蘆洲,2024-07-01,9857
6127,九豪,109,8,101,元大-蘆洲,2024-07-01,9857
2354,鴻準,118,28,90,元大-蘆洲,2024-07-01,9857
00687B,國泰20年美債,158,88,70,元大-蘆洲,2024-07-01,9857
2886,兆豐金,83,13,70,元大-蘆洲,2024-07-01,9857
2883,凱基金,59,6,53,元大-蘆洲,2024-07-01,9857
0056,元大高股息,87,37,50,元大-蘆洲,2024-07-01,9857
2206,三陽工業,63,15,48,元大-蘆洲,2024-07-01,9857
2365,昆盈,330,284,46,元大-蘆洲,2024-07-01,9857
1802,台玻,48,2,46,元大-蘆洲,2024-07-01,9857
00751B,元大AAA至A公司債,44,0,44,元大-蘆洲,2024-07-01,9857
8096,擎亞,58,15,43,元大-蘆洲,2024-07-01,9857
2331,精英,43,1,42,元大-蘆洲,2024-07-01,9857
00949,復華日本龍頭,41,0,41,元大-蘆洲,2024-07-01,9857
6753,龍德造船,76,40,36,元大-蘆洲,2024-07-01,9857
6698,旭暉應材,36,3,33,元大-蘆洲,2024-07-01,9857
2882,國泰金,33,1,32,元大-蘆洲,2024-07-01,9857
2887,台新金,32,1,31,元大-蘆洲,2024-07-01,9857
3049,精金,30,0,30,元大-蘆洲,2024-07-01,9857
3060,銘異,32,2,30,元大-蘆洲,2024-07-01,9857
6770,力積電,76,47,29,元大-蘆洲,2024-07-01,9857
2328,廣宇,28,0,28,元大-蘆洲,2024-07-01,9857
3024,憶聲,60,32,28,元大-蘆洲,2024-07-01,9857
00720B,元大投資級公司債,28,0,28,元大-蘆洲,2024-07-01,9857
00942B,台新美A公司債20+,40,13,27,元大-蘆洲,2024-07-01,9857
1301,台塑,27,0,27,元大-蘆洲,2024-07-01,9857
2409,友達,30,5,25,元大-蘆洲,2024-07-01,9857
912000,晨訊科-DR,25,0,25,元大-蘆洲,2024-07-01,9857
2317,鴻海,116,91,25,元大-蘆洲,2024-07-01,9857
3312,弘憶股,92,70,22,元大-蘆洲,2024-07-01,9857
2337,旺宏,23,1,22,元大-蘆洲,2024-07-01,9857
00881,國泰台灣5G+,22,0,22,元大-蘆洲,2024-07-01,9857
00673R,期元大S＆P原油反1,20,0,20,元大-蘆洲,2024-07-01,9857
00637L,元大滬深300正2,40,20,20,元大-蘆洲,2024-07-01,9857
00772B,中信高評級公司債,21,1,20,元大-蘆洲,2024-07-01,9857
4967,十銓,65,45,20,元大-蘆洲,2024-07-01,9857
2031,新光鋼,20,0,20,元大-蘆洲,2024-07-01,9857
3048,益登,46,27,19,元大-蘆洲,2024-07-01,9857
2363,矽統,23,4,19,元大-蘆洲,2024-07-01,9857
6182,合晶,28,11,17,元大-蘆洲,2024-07-01,9857
00931B,統一美債20年,17,0,17,元大-蘆洲,2024-07-01,9857
2359,所羅門,85,69,16,元大-蘆洲,2024-07-01,9857
00680L,元大美債20正2,848,0,848,元大-蘆洲,2024-07-02,9857
00934,中信成長高股息,531,2,529,元大-蘆洲,2024-07-02,9857
00929,復華台灣科技優息,640,115,525,元大-蘆洲,2024-07-02,9857
2618,長榮航,483,101,382,元大-蘆洲,2024-07-02,9857
2303,聯電,333,23,310,元大-蘆洲,2024-07-02,9857
2317,鴻海,322,57,265,元大-蘆洲,2024-07-02,9857
00942B,台新美A公司債20+,197,0,197,元大-蘆洲,2024-07-02,9857
00687B,國泰20年美債,125,10,115,元大-蘆洲,2024-07-02,9857
0056,元大高股息,123,13,110,元大-蘆洲,2024-07-02,9857
2354,鴻準,97,8,89,元大-蘆洲,2024-07-02,9857
00948B,中信優息投資級債,88,0,88,元大-蘆洲,2024-07-02,9857
3591,艾笛森,87,0,87,元大-蘆洲,2024-07-02,9857
00673R,期元大S＆P原油反1,80,0,80,元大-蘆洲,2024-07-02,9857
00679B,元大美債20年,69,0,69,元大-蘆洲,2024-07-02,9857
00919,群益台灣精選高息,74,16,58,元大-蘆洲,2024-07-02,9857
1815,富喬,62,5,57,元大-蘆洲,2024-07-02,9857
2324,仁寶,69,20,49,元大-蘆洲,2024-07-02,9857
6152,百一,53,6,47,元大-蘆洲,2024-07-02,9857
2609,陽明,79,38,41,元大-蘆洲,2024-07-02,9857
3520,華盈,47,6,41,元大-蘆洲,2024-07-02,9857
00937B,群益ESG投等債20,96,59,37,元大-蘆洲,2024-07-02,9857
8112,至上,38,1,37,元大-蘆洲,2024-07-02,9857
00946,群益科技高息成長,35,0,35,元大-蘆洲,2024-07-02,9857
00949,復華日本龍頭,34,0,34,元大-蘆洲,2024-07-02,9857
00751B,元大AAA至A公司債,34,0,34,元大-蘆洲,2024-07-02,9857
3702,大聯大,34,0,34,元大-蘆洲,2024-07-02,9857
00927,群益半導體收益,43,10,33,元大-蘆洲,2024-07-02,9857
6285,啟��,36,4,32,元大-蘆洲,2024-07-02,9857
1301,台塑,36,5,31,元大-蘆洲,2024-07-02,9857
00933B,國泰10Y+金融債,40,10,30,元大-蘆洲,2024-07-02,9857
2002,中鋼,53,23,30,元大-蘆洲,2024-07-02,9857
00632R,元大台灣50反1,42,12,30,元大-蘆洲,2024-07-02,9857
00712,復華富時不動產,35,6,29,元大-蘆洲,2024-07-02,9857
00795B,中信美國公債20年,29,0,29,元大-蘆洲,2024-07-02,9857
2352,佳世達,36,8,28,元大-蘆洲,2024-07-02,9857
2031,新光鋼,28,1,27,元大-蘆洲,2024-07-02,9857
8473,山林水,28,1,27,元大-蘆洲,2024-07-02,9857
3027,盛達,27,1,26,元大-蘆洲,2024-07-02,9857
2449,京元電子,40,14,26,元大-蘆洲,2024-07-02,9857
2301,光寶科,31,6,25,元大-蘆洲,2024-07-02,9857
5452,佶優,68,43,25,元大-蘆洲,2024-07-02,9857
8110,華東,25,0,25,元大-蘆洲,2024-07-02,9857
2464,盟立,44,20,24,元大-蘆洲,2024-07-02,9857
3714,富采,24,0,24,元大-蘆洲,2024-07-02,9857
1326,台化,26,3,23,元大-蘆洲,2024-07-02,9857
3038,全台,24,1,23,元大-蘆洲,2024-07-02,9857
2412,中華電,24,2,22,元大-蘆洲,2024-07-02,9857
2344,華邦電,27,5,22,元大-蘆洲,2024-07-02,9857
00688L,國泰20年美債正2,22,0,22,元大-蘆洲,2024-07-02,9857
1785,光洋科,53,32,21,元大-蘆洲,2024-07-02,9857
2880,華南金,305,9,296,元大-蘆洲,2024-07-03,9857
00937B,群益ESG投等債20,282,10,272,元大-蘆洲,2024-07-03,9857
00934,中信成長高股息,245,7,238,元大-蘆洲,2024-07-03,9857
8064,東捷,209,77,132,元大-蘆洲,2024-07-03,9857
00929,復華台灣科技優息,211,100,111,元大-蘆洲,2024-07-03,9857
00706L,期元大S＆P日圓正2,100,0,100,元大-蘆洲,2024-07-03,9857
0056,元大高股息,98,4,94,元大-蘆洲,2024-07-03,9857
6244,茂迪,172,86,86,元大-蘆洲,2024-07-03,9857
2427,三商電,101,17,84,元大-蘆洲,2024-07-03,9857
2402,毅嘉,181,105,76,元大-蘆洲,2024-07-03,9857
3576,聯合再生,361,294,67,元大-蘆洲,2024-07-03,9857
2303,聯電,91,27,64,元大-蘆洲,2024-07-03,9857
00946,群益科技高息成長,86,24,62,元大-蘆洲,2024-07-03,9857
3663,鑫科,127,66,61,元大-蘆洲,2024-07-03,9857
00650L,復華香港正2,60,0,60,元大-蘆洲,2024-07-03,9857
00632R,元大台灣50反1,55,0,55,元大-蘆洲,2024-07-03,9857
2368,金像電,77,23,54,元大-蘆洲,2024-07-03,9857
00936,台新永續高息中小,58,4,54,元大-蘆洲,2024-07-03,9857
3047,訊舟,388,339,49,元大-蘆洲,2024-07-03,9857
2489,瑞軒,73,25,48,元大-蘆洲,2024-07-03,9857
6443,元晶,232,187,45,元大-蘆洲,2024-07-03,9857
2317,鴻海,71,28,43,元大-蘆洲,2024-07-03,9857
00631L,元大台灣50正2,44,2,42,元大-蘆洲,2024-07-03,9857
2409,友達,56,16,40,元大-蘆洲,2024-07-03,9857
00679B,元大美債20年,42,3,39,元大-蘆洲,2024-07-03,9857
2834,臺企銀,53,18,35,元大-蘆洲,2024-07-03,9857
2609,陽明,186,154,32,元大-蘆洲,2024-07-03,9857
4566,時碩工業,36,4,32,元大-蘆洲,2024-07-03,9857
5498,凱崴,66,34,32,元大-蘆洲,2024-07-03,9857
4968,立積,42,12,30,元大-蘆洲,2024-07-03,9857
00673R,期元大S＆P原油反1,30,0,30,元大-蘆洲,2024-07-03,9857
5426,振發,53,26,27,元大-蘆洲,2024-07-03,9857
2354,鴻準,31,4,27,元大-蘆洲,2024-07-03,9857
6282,康舒,51,27,24,元大-蘆洲,2024-07-03,9857
2412,中華電,23,0,23,元大-蘆洲,2024-07-03,9857
5452,佶優,36,14,22,元大-蘆洲,2024-07-03,9857
6477,安集,42,21,21,元大-蘆洲,2024-07-03,9857
2913,農林,32,11,21,元大-蘆洲,2024-07-03,9857
2301,光寶科,34,14,20,元大-蘆洲,2024-07-03,9857
6139,亞翔,51,31,20,元大-蘆洲,2024-07-03,9857
1442,名軒,20,0,20,元大-蘆洲,2024-07-03,9857
6706,惠特,22,2,20,元大-蘆洲,2024-07-03,9857
2618,長榮航,79,60,19,元大-蘆洲,2024-07-03,9857
4906,正文,146,127,19,元大-蘆洲,2024-07-03,9857
5347,世界,36,18,18,元大-蘆洲,2024-07-03,9857
1795,美時,22,4,18,元大-蘆洲,2024-07-03,9857
8071,能率網通,22,4,18,元大-蘆洲,2024-07-03,9857
3060,銘異,33,15,18,元大-蘆洲,2024-07-03,9857
6126,信音,20,2,18,元大-蘆洲,2024-07-03,9857
5371,中光電,19,2,17,元大-蘆洲,2024-07-03,9857
00632R,元大台灣50反1,345,150,195,元大-蘆洲,2024-07-04,9857
2206,三陽工業,174,5,169,元大-蘆洲,2024-07-04,9857
00934,中信成長高股息,134,0,134,元大-蘆洲,2024-07-04,9857
2401,凌陽,109,4,105,元大-蘆洲,2024-07-04,9857
1815,富喬,115,20,95,元大-蘆洲,2024-07-04,9857
2408,南亞科,159,67,92,元大-蘆洲,2024-07-04,9857
9105,泰金寶-DR,143,53,90,元大-蘆洲,2024-07-04,9857
2880,華南金,100,11,89,元大-蘆洲,2024-07-04,9857
6278,台表科,96,12,84,元大-蘆洲,2024-07-04,9857
2883,凱基金,154,73,81,元大-蘆洲,2024-07-04,9857
2409,友達,112,42,70,元大-蘆洲,2024-07-04,9857
2412,中華電,67,0,67,元大-蘆洲,2024-07-04,9857
8070,長華*,51,0,51,元大-蘆洲,2024-07-04,9857
1304,台聚,50,0,50,元大-蘆洲,2024-07-04,9857
00937B,群益ESG投等債20,130,81,49,元大-蘆洲,2024-07-04,9857
3189,景碩,49,1,48,元大-蘆洲,2024-07-04,9857
1409,新纖,130,83,47,元大-蘆洲,2024-07-04,9857
3715,定穎投控,45,2,43,元大-蘆洲,2024-07-04,9857
00936,台新永續高息中小,51,8,43,元大-蘆洲,2024-07-04,9857
5608,四維航,45,4,41,元大-蘆洲,2024-07-04,9857
4746,台耀,40,0,40,元大-蘆洲,2024-07-04,9857
1217,愛之味,40,0,40,元大-蘆洲,2024-07-04,9857
2368,金像電,46,7,39,元大-蘆洲,2024-07-04,9857
3312,弘憶股,192,152,40,元大-蘆洲,2024-07-04,9857
00949,復華日本龍頭,37,0,37,元大-蘆洲,2024-07-04,9857
3231,緯創,49,13,36,元大-蘆洲,2024-07-04,9857
2359,所羅門,113,77,36,元大-蘆洲,2024-07-04,9857
3615,安可,102,68,34,元大-蘆洲,2024-07-04,9857
1560,中砂,39,7,32,元大-蘆洲,2024-07-04,9857
00673R,期元大S＆P原油反1,30,0,30,元大-蘆洲,2024-07-04,9857
5347,世界,38,8,30,元大-蘆洲,2024-07-04,9857
3673,TPK-KY,51,22,29,元大-蘆洲,2024-07-04,9857
2328,廣宇,30,1,29,元大-蘆洲,2024-07-04,9857
00753L,中信中國50正2,30,2,28,元大-蘆洲,2024-07-04,9857
2609,陽明,90,62,28,元大-蘆洲,2024-07-04,9857
3548,兆利,26,0,26,元大-蘆洲,2024-07-04,9857
9103,美德醫療-DR,27,1,26,元大-蘆洲,2024-07-04,9857
1802,台玻,26,1,25,元大-蘆洲,2024-07-04,9857
3521,鴻翊,25,0,25,元大-蘆洲,2024-07-04,9857
1536,和大,36,11,25,元大-蘆洲,2024-07-04,9857
5498,凱崴,24,0,24,元大-蘆洲,2024-07-04,9857
2405,輔信,102,79,23,元大-蘆洲,2024-07-04,9857
2353,宏��,29,6,23,元大-蘆洲,2024-07-04,9857
2406,國碩,34,13,21,元大-蘆洲,2024-07-04,9857
2347,聯強,27,6,21,元大-蘆洲,2024-07-04,9857
2603,長榮,31,11,20,元大-蘆洲,2024-07-04,9857
00679B,元大美債20年,22,2,20,元大-蘆洲,2024-07-04,9857
3441,聯一光,20,0,20,元大-蘆洲,2024-07-04,9857
00945B,凱基美國非投等債,20,0,20,元大-蘆洲,2024-07-04,9857
6130,上亞科技,20,0,20,元大-蘆洲,2024-07-04,9857
00934,中信成長高股息,893,0,893,元大-蘆洲,2024-07-05,9857
00637L,元大滬深300正2,529,146,383,元大-蘆洲,2024-07-05,9857
3481,群創,680,351,329,元大-蘆洲,2024-07-05,9857
2618,長榮航,350,80,270,元大-蘆洲,2024-07-05,9857
00878,國泰永續高股息,228,37,191,元大-蘆洲,2024-07-05,9857
2349,錸德,211,56,155,元大-蘆洲,2024-07-05,9857
00680L,元大美債20正2,154,30,124,元大-蘆洲,2024-07-05,9857
00679B,元大美債20年,115,0,115,元大-蘆洲,2024-07-05,9857
00919,群益台灣精選高息,115,17,98,元大-蘆洲,2024-07-05,9857
00905,FT臺灣Smart,93,0,93,元大-蘆洲,2024-07-05,9857
6706,惠特,105,13,92,元大-蘆洲,2024-07-05,9857
00929,復華台灣科技優息,147,57,90,元大-蘆洲,2024-07-05,9857
2610,華航,102,16,86,元大-蘆洲,2024-07-05,9857
2609,陽明,173,93,80,元大-蘆洲,2024-07-05,9857
2883,凱基金,94,22,72,元大-蘆洲,2024-07-05,9857
4967,十銓,117,46,71,元大-蘆洲,2024-07-05,9857
9105,泰金寶-DR,186,116,70,元大-蘆洲,2024-07-05,9857
1454,台富,63,0,63,元大-蘆洲,2024-07-05,9857
4561,健椿,87,30,57,元大-蘆洲,2024-07-05,9857
00945B,凱基美國非投等債,57,0,57,元大-蘆洲,2024-07-05,9857
2464,盟立,172,116,56,元大-蘆洲,2024-07-05,9857
2332,友訊,51,1,50,元大-蘆洲,2024-07-05,9857
1718,中纖,74,28,46,元大-蘆洲,2024-07-05,9857
2913,農林,47,6,41,元大-蘆洲,2024-07-05,9857
00631L,元大台灣50正2,43,3,40,元大-蘆洲,2024-07-05,9857
3450,聯鈞,88,50,38,元大-蘆洲,2024-07-05,9857
1409,新纖,52,14,38,元大-蘆洲,2024-07-05,9857
00949,復華日本龍頭,37,0,37,元大-蘆洲,2024-07-05,9857
1513,中興電,214,177,37,元大-蘆洲,2024-07-05,9857
00687B,國泰20年美債,40,4,36,元大-蘆洲,2024-07-05,9857
00673R,期元大S＆P原油反1,35,0,35,元大-蘆洲,2024-07-05,9857
2356,英業達,88,53,35,元大-蘆洲,2024-07-05,9857
6153,嘉聯益,36,3,33,元大-蘆洲,2024-07-05,9857
2352,佳世達,35,3,32,元大-蘆洲,2024-07-05,9857
5864,致和證,30,0,30,元大-蘆洲,2024-07-05,9857
2367,燿華,195,166,29,元大-蘆洲,2024-07-05,9857
2641,正德,30,1,29,元大-蘆洲,2024-07-05,9857
00882,中信中國高股息,30,1,29,元大-蘆洲,2024-07-05,9857
6770,力積電,33,4,29,元大-蘆洲,2024-07-05,9857
6278,台表科,36,7,29,元大-蘆洲,2024-07-05,9857
1717,長興,30,2,28,元大-蘆洲,2024-07-05,9857
6133,金橋,31,5,26,元大-蘆洲,2024-07-05,9857
2515,中工,29,4,25,元大-蘆洲,2024-07-05,9857
00753L,中信中國50正2,55,30,25,元大-蘆洲,2024-07-05,9857
3576,聯合再生,76,51,25,元大-蘆洲,2024-07-05,9857
3048,益登,95,72,23,元大-蘆洲,2024-07-05,9857
2606,裕民,23,0,23,元大-蘆洲,2024-07-05,9857
1455,集盛,30,7,23,元大-蘆洲,2024-07-05,9857
3706,神達,32,9,23,元大-蘆洲,2024-07-05,9857
2603,長榮,56,34,22,元大-蘆洲,2024-07-05,9857
00632R,元大台灣50反1,2281,182,2099,元大-蘆洲,2024-07-08,9857
00934,中信成長高股息,338,0,338,元大-蘆洲,2024-07-08,9857
00673R,期元大S＆P原油反1,190,0,190,元大-蘆洲,2024-07-08,9857
2515,中工,201,16,185,元大-蘆洲,2024-07-08,9857
8021,尖點,188,7,181,元大-蘆洲,2024-07-08,9857
3094,聯傑,170,21,149,元大-蘆洲,2024-07-08,9857
2401,凌陽,140,22,118,元大-蘆洲,2024-07-08,9857
1718,中纖,289,179,110,元大-蘆洲,2024-07-08,9857
8064,東捷,209,109,100,元大-蘆洲,2024-07-08,9857
00680L,元大美債20正2,127,31,96,元大-蘆洲,2024-07-08,9857
2449,京元電子,119,32,87,元大-蘆洲,2024-07-08,9857
2365,昆盈,314,227,87,元大-蘆洲,2024-07-08,9857
1802,台玻,85,1,84,元大-蘆洲,2024-07-08,9857
2363,矽統,184,102,82,元大-蘆洲,2024-07-08,9857
1314,中石化,133,53,80,元大-蘆洲,2024-07-08,9857
2618,長榮航,121,42,79,元大-蘆洲,2024-07-08,9857
1785,光洋科,661,583,78,元大-蘆洲,2024-07-08,9857
1815,富喬,114,41,73,元大-蘆洲,2024-07-08,9857
4561,健椿,89,18,71,元大-蘆洲,2024-07-08,9857
2603,長榮,117,53,64,元大-蘆洲,2024-07-08,9857
00919,群益台灣精選高息,141,78,63,元大-蘆洲,2024-07-08,9857
8028,昇陽半導體,97,40,57,元大-蘆洲,2024-07-08,9857
4533,協易機,56,1,55,元大-蘆洲,2024-07-08,9857
00881,國泰台灣5G+,61,6,55,元大-蘆洲,2024-07-08,9857
2371,大同,63,11,52,元大-蘆洲,2024-07-08,9857
2405,輔信,51,0,51,元大-蘆洲,2024-07-08,9857
00676R,富邦臺灣加權反1,50,0,50,元大-蘆洲,2024-07-08,9857
00651R,復華香港反1,50,0,50,元大-蘆洲,2024-07-08,9857
00795B,中信美國公債20年,50,0,50,元大-蘆洲,2024-07-08,9857
00949,復華日本龍頭,50,2,48,元大-蘆洲,2024-07-08,9857
3663,鑫科,92,45,47,元大-蘆洲,2024-07-08,9857
2301,光寶科,58,12,46,元大-蘆洲,2024-07-08,9857
00631L,元大台灣50正2,50,5,45,元大-蘆洲,2024-07-08,9857
2498,宏達電,49,5,44,元大-蘆洲,2024-07-08,9857
2427,三商電,55,14,41,元大-蘆洲,2024-07-08,9857
1522,堤維西,42,2,40,元大-蘆洲,2024-07-08,9857
2402,毅嘉,42,6,36,元大-蘆洲,2024-07-08,9857
2486,一詮,42,6,36,元大-蘆洲,2024-07-08,9857
1445,大宇,34,0,34,元大-蘆洲,2024-07-08,9857
00929,復華台灣科技優息,192,160,32,元大-蘆洲,2024-07-08,9857
9904,寶成,32,0,32,元大-蘆洲,2024-07-08,9857
5608,四維航,41,11,30,元大-蘆洲,2024-07-08,9857
1442,名軒,30,0,30,元大-蘆洲,2024-07-08,9857
9958,世紀鋼,38,9,29,元大-蘆洲,2024-07-08,9857
6188,廣明,51,22,29,元大-蘆洲,2024-07-08,9857
00945B,凱基美國非投等債,28,0,28,元大-蘆洲,2024-07-08,9857
2323,中環,53,25,28,元大-蘆洲,2024-07-08,9857
00927,群益半導體收益,33,5,28,元大-蘆洲,2024-07-08,9857
2464,盟立,139,112,27,元大-蘆洲,2024-07-08,9857
2417,圓剛,127,101,26,元大-蘆洲,2024-07-08,9857
2312,金寶,2931,241,2690,元大-蘆洲,2024-07-09,9857
00632R,元大台灣50反1,988,0,988,元大-蘆洲,2024-07-09,9857
3673,TPK-KY,429,137,292,元大-蘆洲,2024-07-09,9857
2886,兆豐金,271,7,264,元大-蘆洲,2024-07-09,9857
9105,泰金寶-DR,620,360,260,元大-蘆洲,2024-07-09,9857
00934,中信成長高股息,192,8,184,元大-蘆洲,2024-07-09,9857
2317,鴻海,282,122,160,元大-蘆洲,2024-07-09,9857
3047,訊舟,381,255,126,元大-蘆洲,2024-07-09,9857
2618,長榮航,135,15,120,元大-蘆洲,2024-07-09,9857
2349,錸德,175,72,103,元大-蘆洲,2024-07-09,9857
1785,光洋科,207,106,101,元大-蘆洲,2024-07-09,9857
912000,晨訊科-DR,77,0,77,元大-蘆洲,2024-07-09,9857
00679B,元大美債20年,102,26,76,元大-蘆洲,2024-07-09,9857
00878,國泰永續高股息,81,12,69,元大-蘆洲,2024-07-09,9857
2367,燿華,509,442,67,元大-蘆洲,2024-07-09,9857
3050,鈺德,92,25,67,元大-蘆洲,2024-07-09,9857
2405,輔信,159,92,67,元大-蘆洲,2024-07-09,9857
1815,富喬,73,9,64,元大-蘆洲,2024-07-09,9857
6116,彩晶,105,41,64,元大-蘆洲,2024-07-09,9857
00927,群益半導體收益,64,0,64,元大-蘆洲,2024-07-09,9857
2301,光寶科,64,3,61,元大-蘆洲,2024-07-09,9857
2609,陽明,113,56,57,元大-蘆洲,2024-07-09,9857
2303,聯電,132,78,54,元大-蘆洲,2024-07-09,9857
5515,建國,54,0,54,元大-蘆洲,2024-07-09,9857
2353,宏��,54,1,53,元大-蘆洲,2024-07-09,9857
00650L,復華香港正2,53,0,53,元大-蘆洲,2024-07-09,9857
2344,華邦電,56,3,53,元大-蘆洲,2024-07-09,9857
00881,國泰台灣5G+,51,5,46,元大-蘆洲,2024-07-09,9857
00937B,群益ESG投等債20,68,23,45,元大-蘆洲,2024-07-09,9857
4960,誠美材,80,35,45,元大-蘆洲,2024-07-09,9857
1409,新纖,71,27,44,元大-蘆洲,2024-07-09,9857
8176,智捷,42,0,42,元大-蘆洲,2024-07-09,9857
5880,合庫金,51,9,42,元大-蘆洲,2024-07-09,9857
2328,廣宇,48,7,41,元大-蘆洲,2024-07-09,9857
00857B,永豐20年美公債,40,0,40,元大-蘆洲,2024-07-09,9857
3062,建漢,105,66,39,元大-蘆洲,2024-07-09,9857
2515,中工,55,17,38,元大-蘆洲,2024-07-09,9857
5452,佶優,48,10,38,元大-蘆洲,2024-07-09,9857
5608,四維航,38,0,38,元大-蘆洲,2024-07-09,9857
2313,華通,72,34,38,元大-蘆洲,2024-07-09,9857
2834,臺企銀,78,40,38,元大-蘆洲,2024-07-09,9857
1504,東元,45,9,36,元大-蘆洲,2024-07-09,9857
6152,百一,63,27,36,元大-蘆洲,2024-07-09,9857
3324,雙鴻,57,22,35,元大-蘆洲,2024-07-09,9857
6120,達運,35,0,35,元大-蘆洲,2024-07-09,9857
5347,世界,44,13,31,元大-蘆洲,2024-07-09,9857
4746,台耀,41,12,29,元大-蘆洲,2024-07-09,9857
8096,擎亞,42,14,28,元大-蘆洲,2024-07-09,9857
8105,凌巨,284,257,27,元大-蘆洲,2024-07-09,9857
00651R,復華香港反1,26,0,26,元大-蘆洲,2024-07-09,9857
00665L,富邦�琤肭磪囓�2,631,11,620,元大-蘆洲,2024-07-10,9857
00650L,復華香港正2,500,0,500,元大-蘆洲,2024-07-10,9857
00934,中信成長高股息,241,61,180,元大-蘆洲,2024-07-10,9857
4906,正文,185,27,158,元大-蘆洲,2024-07-10,9857
2888,新光金,531,395,136,元大-蘆洲,2024-07-10,9857
6126,信音,161,31,130,元大-蘆洲,2024-07-10,9857
3094,聯傑,151,31,120,元大-蘆洲,2024-07-10,9857
3062,建漢,109,11,98,元大-蘆洲,2024-07-10,9857
6706,惠特,106,9,97,元大-蘆洲,2024-07-10,9857
6015,宏遠證,90,0,90,元大-蘆洲,2024-07-10,9857
2489,瑞軒,181,107,74,元大-蘆洲,2024-07-10,9857
00679B,元大美債20年,75,3,72,元大-蘆洲,2024-07-10,9857
00688L,國泰20年美債正2,112,42,70,元大-蘆洲,2024-07-10,9857
2367,燿華,139,72,67,元大-蘆洲,2024-07-10,9857
5309,系統電,203,141,62,元大-蘆洲,2024-07-10,9857
00937B,群益ESG投等債20,77,17,60,元大-蘆洲,2024-07-10,9857
2363,矽統,74,29,45,元大-蘆洲,2024-07-10,9857
2867,三商壽,84,39,45,元大-蘆洲,2024-07-10,9857
2392,正崴,144,100,44,元大-蘆洲,2024-07-10,9857
1569,濱川,64,22,42,元大-蘆洲,2024-07-10,9857
2354,鴻準,77,35,42,元大-蘆洲,2024-07-10,9857
9904,寶成,51,9,42,元大-蘆洲,2024-07-10,9857
6152,百一,46,5,41,元大-蘆洲,2024-07-10,9857
2809,京城銀,41,1,40,元大-蘆洲,2024-07-10,9857
2317,鴻海,62,23,39,元大-蘆洲,2024-07-10,9857
00927,群益半導體收益,37,0,37,元大-蘆洲,2024-07-10,9857
3576,聯合再生,41,5,36,元大-蘆洲,2024-07-10,9857
4977,眾達-KY,49,13,36,元大-蘆洲,2024-07-10,9857
2002,中鋼,102,71,31,元大-蘆洲,2024-07-10,9857
3037,欣興,40,10,30,元大-蘆洲,2024-07-10,9857
2323,中環,27,0,27,元大-蘆洲,2024-07-10,9857
1316,上曜,37,12,25,元大-蘆洲,2024-07-10,9857
2887,台新金,31,7,24,元大-蘆洲,2024-07-10,9857
2405,輔信,87,64,23,元大-蘆洲,2024-07-10,9857
1802,台玻,32,9,23,元大-蘆洲,2024-07-10,9857
2606,裕民,22,0,22,元大-蘆洲,2024-07-10,9857
6531,愛普*,29,7,22,元大-蘆洲,2024-07-10,9857
3591,艾笛森,21,0,21,元大-蘆洲,2024-07-10,9857
2617,台航,20,0,20,元大-蘆洲,2024-07-10,9857
00882,中信中國高股息,43,23,20,元大-蘆洲,2024-07-10,9857
3380,明泰,20,0,20,元大-蘆洲,2024-07-10,9857
3498,陽程,32,13,19,元大-蘆洲,2024-07-10,9857
1806,冠軍,18,0,18,元大-蘆洲,2024-07-10,9857
1528,恩德,18,0,18,元大-蘆洲,2024-07-10,9857
8033,雷虎,19,1,18,元大-蘆洲,2024-07-10,9857
00936,台新永續高息中小,34,16,18,元大-蘆洲,2024-07-10,9857
2880,華南金,19,3,16,元大-蘆洲,2024-07-10,9857
6218,豪勉,36,20,16,元大-蘆洲,2024-07-10,9857
5371,中光電,19,3,16,元大-蘆洲,2024-07-10,9857
0056,元大高股息,34,18,16,元大-蘆洲,2024-07-10,9857
00687B,國泰20年美債,419,11,408,元大-蘆洲,2024-07-11,9857
2888,新光金,555,178,377,元大-蘆洲,2024-07-11,9857
3037,欣興,331,87,244,元大-蘆洲,2024-07-11,9857
00929,復華台灣科技優息,305,83,222,元大-蘆洲,2024-07-11,9857
00665L,富邦�琤肭磪囓�2,207,6,201,元大-蘆洲,2024-07-11,9857
00937B,群益ESG投等債20,180,19,161,元大-蘆洲,2024-07-11,9857
4566,時碩工業,205,53,152,元大-蘆洲,2024-07-11,9857
00934,中信成長高股息,154,40,114,元大-蘆洲,2024-07-11,9857
00885,富邦越南,113,3,110,元大-蘆洲,2024-07-11,9857
2530,華建,90,1,89,元大-蘆洲,2024-07-11,9857
2354,鴻準,152,73,79,元大-蘆洲,2024-07-11,9857
5309,系統電,121,50,71,元大-蘆洲,2024-07-11,9857
3050,鈺德,107,39,68,元大-蘆洲,2024-07-11,9857
2515,中工,58,1,57,元大-蘆洲,2024-07-11,9857
00651R,復華香港反1,56,0,56,元大-蘆洲,2024-07-11,9857
00945B,凱基美國非投等債,55,0,55,元大-蘆洲,2024-07-11,9857
2002,中鋼,55,2,53,元大-蘆洲,2024-07-11,9857
2353,宏��,81,28,53,元大-蘆洲,2024-07-11,9857
1611,中電,50,0,50,元大-蘆洲,2024-07-11,9857
6757,台灣虎航,51,6,45,元大-蘆洲,2024-07-11,9857
2440,太空梭,46,1,45,元大-蘆洲,2024-07-11,9857
2405,輔信,55,10,45,元大-蘆洲,2024-07-11,9857
2618,長榮航,72,29,43,元大-蘆洲,2024-07-11,9857
2365,昆盈,228,187,41,元大-蘆洲,2024-07-11,9857
2344,華邦電,67,27,40,元大-蘆洲,2024-07-11,9857
1101,台泥,49,9,40,元大-蘆洲,2024-07-11,9857
00679B,元大美債20年,83,44,39,元大-蘆洲,2024-07-11,9857
4533,協易機,50,12,38,元大-蘆洲,2024-07-11,9857
5371,中光電,41,4,37,元大-蘆洲,2024-07-11,9857
2362,藍天,57,20,37,元大-蘆洲,2024-07-11,9857
2301,光寶科,58,21,37,元大-蘆洲,2024-07-11,9857
00882,中信中國高股息,42,6,36,元大-蘆洲,2024-07-11,9857
6278,台表科,38,4,34,元大-蘆洲,2024-07-11,9857
2542,興富發,47,14,33,元大-蘆洲,2024-07-11,9857
1514,亞力,95,62,33,元大-蘆洲,2024-07-11,9857
8028,昇陽半導體,82,52,30,元大-蘆洲,2024-07-11,9857
2610,華航,43,15,28,元大-蘆洲,2024-07-11,9857
1314,中石化,30,3,27,元大-蘆洲,2024-07-11,9857
2382,廣達,41,14,27,元大-蘆洲,2024-07-11,9857
1513,中興電,107,80,27,元大-蘆洲,2024-07-11,9857
3576,聯合再生,37,11,26,元大-蘆洲,2024-07-11,9857
1609,大亞,46,20,26,元大-蘆洲,2024-07-11,9857
00795B,中信美國公債20年,26,1,25,元大-蘆洲,2024-07-11,9857
4414,如興,25,0,25,元大-蘆洲,2024-07-11,9857
2891,中信金,26,1,25,元大-蘆洲,2024-07-11,9857
9103,美德醫療-DR,30,6,24,元大-蘆洲,2024-07-11,9857
00725B,國泰投資級公司債,22,0,22,元大-蘆洲,2024-07-11,9857
2316,楠梓電,27,5,22,元大-蘆洲,2024-07-11,9857
00901,永豐智能車供應鏈,22,0,22,元大-蘆洲,2024-07-11,9857
1795,美時,23,1,22,元大-蘆洲,2024-07-11,9857
00929,復華台灣科技優息,940,142,798,元大-蘆洲,2024-07-12,9857
2312,金寶,1060,369,691,元大-蘆洲,2024-07-12,9857
00919,群益台灣精選高息,578,157,421,元大-蘆洲,2024-07-12,9857
00934,中信成長高股息,412,10,402,元大-蘆洲,2024-07-12,9857
00937B,群益ESG投等債20,374,60,314,元大-蘆洲,2024-07-12,9857
2515,中工,321,18,303,元大-蘆洲,2024-07-12,9857
00632R,元大台灣50反1,347,50,297,元大-蘆洲,2024-07-12,9857
2317,鴻海,227,51,176,元大-蘆洲,2024-07-12,9857
00905,FT臺灣Smart,177,2,175,元大-蘆洲,2024-07-12,9857
00680L,元大美債20正2,232,61,171,元大-蘆洲,2024-07-12,9857
2303,聯電,212,47,165,元大-蘆洲,2024-07-12,9857
0056,元大高股息,157,15,142,元大-蘆洲,2024-07-12,9857
2883,凱基金,175,41,134,元大-蘆洲,2024-07-12,9857
00927,群益半導體收益,120,0,120,元大-蘆洲,2024-07-12,9857
2618,長榮航,129,27,102,元大-蘆洲,2024-07-12,9857
00878,國泰永續高股息,120,31,89,元大-蘆洲,2024-07-12,9857
1529,樂事綠能,120,31,89,元大-蘆洲,2024-07-12,9857
00891,中信關鍵半導體,81,11,70,元大-蘆洲,2024-07-12,9857
2367,燿華,151,90,61,元大-蘆洲,2024-07-12,9857
00679B,元大美債20年,78,19,59,元大-蘆洲,2024-07-12,9857
00651R,復華香港反1,57,0,57,元大-蘆洲,2024-07-12,9857
3047,訊舟,63,8,55,元大-蘆洲,2024-07-12,9857
00936,台新永續高息中小,60,5,55,元大-蘆洲,2024-07-12,9857
1316,上曜,138,84,54,元大-蘆洲,2024-07-12,9857
2891,中信金,63,10,53,元大-蘆洲,2024-07-12,9857
2406,國碩,72,21,51,元大-蘆洲,2024-07-12,9857
2330,台積電,61,14,47,元大-蘆洲,2024-07-12,9857
00725B,國泰投資級公司債,46,0,46,元大-蘆洲,2024-07-12,9857
2323,中環,64,19,45,元大-蘆洲,2024-07-12,9857
5905,南仁湖,45,4,41,元大-蘆洲,2024-07-12,9857
4958,臻鼎-KY,43,3,40,元大-蘆洲,2024-07-12,9857
2363,矽統,63,25,38,元大-蘆洲,2024-07-12,9857
1785,光洋科,59,23,36,元大-蘆洲,2024-07-12,9857
3019,亞光,89,53,36,元大-蘆洲,2024-07-12,9857
00650L,復華香港正2,50,15,35,元大-蘆洲,2024-07-12,9857
2353,宏��,39,9,30,元大-蘆洲,2024-07-12,9857
3231,緯創,34,4,30,元大-蘆洲,2024-07-12,9857
00935,野村臺灣新科技50,39,10,29,元大-蘆洲,2024-07-12,9857
1310,台苯,30,1,29,元大-蘆洲,2024-07-12,9857
2867,三商壽,109,80,29,元大-蘆洲,2024-07-12,9857
5328,華容,57,29,28,元大-蘆洲,2024-07-12,9857
00881,國泰台灣5G+,63,36,27,元大-蘆洲,2024-07-12,9857
3209,全科,32,5,27,元大-蘆洲,2024-07-12,9857
3033,威健,34,7,27,元大-蘆洲,2024-07-12,9857
006208,富邦台50,36,9,27,元大-蘆洲,2024-07-12,9857
6603,富強鑫,77,51,26,元大-蘆洲,2024-07-12,9857
3094,聯傑,27,1,26,元大-蘆洲,2024-07-12,9857
00946,群益科技高息成長,25,1,24,元大-蘆洲,2024-07-12,9857
3593,力銘,24,0,24,元大-蘆洲,2024-07-12,9857
5426,振發,65,41,24,元大-蘆洲,2024-07-12,9857
1609,大亞,496,121,375,元大-蘆洲,2024-07-15,9857
00929,復華台灣科技優息,397,66,331,元大-蘆洲,2024-07-15,9857
2888,新光金,408,109,299,元大-蘆洲,2024-07-15,9857
00680L,元大美債20正2,249,0,249,元大-蘆洲,2024-07-15,9857
2891,中信金,181,9,172,元大-蘆洲,2024-07-15,9857
00934,中信成長高股息,181,12,169,元大-蘆洲,2024-07-15,9857
2618,長榮航,142,22,120,元大-蘆洲,2024-07-15,9857
3706,神達,120,9,111,元大-蘆洲,2024-07-15,9857
1101,台泥,101,3,98,元大-蘆洲,2024-07-15,9857
00679B,元大美債20年,107,10,97,元大-蘆洲,2024-07-15,9857
00665L,富邦�琤肭磪囓�2,97,0,97,元大-蘆洲,2024-07-15,9857
2356,英業達,210,125,85,元大-蘆洲,2024-07-15,9857
00919,群益台灣精選高息,128,45,83,元大-蘆洲,2024-07-15,9857
00712,復華富時不動產,116,37,79,元大-蘆洲,2024-07-15,9857
2511,太子,70,0,70,元大-蘆洲,2024-07-15,9857
2303,聯電,88,18,70,元大-蘆洲,2024-07-15,9857
00937B,群益ESG投等債20,119,50,69,元大-蘆洲,2024-07-15,9857
00905,FT臺灣Smart,67,2,65,元大-蘆洲,2024-07-15,9857
00936,台新永續高息中小,65,0,65,元大-蘆洲,2024-07-15,9857
8105,凌巨,90,28,62,元大-蘆洲,2024-07-15,9857
9105,泰金寶-DR,119,57,62,元大-蘆洲,2024-07-15,9857
2365,昆盈,159,100,59,元大-蘆洲,2024-07-15,9857
00688L,國泰20年美債正2,55,0,55,元大-蘆洲,2024-07-15,9857
2243,宏旭-KY,67,17,50,元大-蘆洲,2024-07-15,9857
3059,華晶科,46,0,46,元大-蘆洲,2024-07-15,9857
8354,冠好,45,0,45,元大-蘆洲,2024-07-15,9857
2498,宏達電,52,7,45,元大-蘆洲,2024-07-15,9857
2610,華航,57,15,42,元大-蘆洲,2024-07-15,9857
00878,國泰永續高股息,90,47,43,元大-蘆洲,2024-07-15,9857
1608,華榮,123,82,41,元大-蘆洲,2024-07-15,9857
2883,凱基金,67,27,40,元大-蘆洲,2024-07-15,9857
1477,聚陽,37,1,36,元大-蘆洲,2024-07-15,9857
6116,彩晶,46,10,36,元大-蘆洲,2024-07-15,9857
8927,北基,37,1,36,元大-蘆洲,2024-07-15,9857
1612,宏泰,38,3,35,元大-蘆洲,2024-07-15,9857
4960,誠美材,40,5,35,元大-蘆洲,2024-07-15,9857
2867,三商壽,53,18,35,元大-蘆洲,2024-07-15,9857
2393,億光,45,11,34,元大-蘆洲,2024-07-15,9857
00945B,凱基美國非投等債,33,0,33,元大-蘆洲,2024-07-15,9857
2371,大同,47,15,32,元大-蘆洲,2024-07-15,9857
6770,力積電,35,4,31,元大-蘆洲,2024-07-15,9857
00933B,國泰10Y+金融債,40,9,31,元大-蘆洲,2024-07-15,9857
3050,鈺德,35,4,31,元大-蘆洲,2024-07-15,9857
0056,元大高股息,102,72,30,元大-蘆洲,2024-07-15,9857
2538,基泰,53,23,30,元大-蘆洲,2024-07-15,9857
9945,潤泰新,54,25,29,元大-蘆洲,2024-07-15,9857
2402,毅嘉,29,1,28,元大-蘆洲,2024-07-15,9857
3596,智易,31,3,28,元大-蘆洲,2024-07-15,9857
2353,宏��,40,12,28,元大-蘆洲,2024-07-15,9857
2603,長榮,32,5,27,元大-蘆洲,2024-07-15,9857
00929,復華台灣科技優息,294,48,246,元大-蘆洲,2024-07-16,9857
0056,元大高股息,201,22,179,元大-蘆洲,2024-07-16,9857
00679B,元大美債20年,193,39,154,元大-蘆洲,2024-07-16,9857
2365,昆盈,214,72,142,元大-蘆洲,2024-07-16,9857
00937B,群益ESG投等債20,212,77,135,元大-蘆洲,2024-07-16,9857
00665L,富邦�琤肭磪囓�2,129,0,129,元大-蘆洲,2024-07-16,9857
3290,東浦,132,3,129,元大-蘆洲,2024-07-16,9857
1316,上曜,205,77,128,元大-蘆洲,2024-07-16,9857
00934,中信成長高股息,121,0,121,元大-蘆洲,2024-07-16,9857
00902,中信電池及儲能,101,0,101,元大-蘆洲,2024-07-16,9857
2101,南港,131,31,100,元大-蘆洲,2024-07-16,9857
00725B,國泰投資級公司債,95,0,95,元大-蘆洲,2024-07-16,9857
00905,FT臺灣Smart,105,20,85,元大-蘆洲,2024-07-16,9857
00664R,國泰臺灣加權反1,80,0,80,元大-蘆洲,2024-07-16,9857
2891,中信金,99,19,80,元大-蘆洲,2024-07-16,9857
3231,緯創,231,154,77,元大-蘆洲,2024-07-16,9857
00919,群益台灣精選高息,114,41,73,元大-蘆洲,2024-07-16,9857
1815,富喬,82,25,57,元大-蘆洲,2024-07-16,9857
2515,中工,59,4,55,元大-蘆洲,2024-07-16,9857
6592,和潤企業,53,3,50,元大-蘆洲,2024-07-16,9857
2312,金寶,310,263,47,元大-蘆洲,2024-07-16,9857
2317,鴻海,78,34,44,元大-蘆洲,2024-07-16,9857
6462,神盾,77,34,43,元大-蘆洲,2024-07-16,9857
2002,中鋼,49,6,43,元大-蘆洲,2024-07-16,9857
2305,全友,52,11,41,元大-蘆洲,2024-07-16,9857
00939,統一台灣高息動能,39,0,39,元大-蘆洲,2024-07-16,9857
2440,太空梭,37,0,37,元大-蘆洲,2024-07-16,9857
2615,萬海,73,36,37,元大-蘆洲,2024-07-16,9857
00942B,台新美A公司債20+,72,37,35,元大-蘆洲,2024-07-16,9857
00651R,復華香港反1,33,0,33,元大-蘆洲,2024-07-16,9857
1540,喬福,70,38,32,元大-蘆洲,2024-07-16,9857
2867,三商壽,43,11,32,元大-蘆洲,2024-07-16,9857
8011,台通,133,102,31,元大-蘆洲,2024-07-16,9857
6026,福邦證,31,0,31,元大-蘆洲,2024-07-16,9857
6021,美好證,32,2,30,元大-蘆洲,2024-07-16,9857
2025,千興,30,0,30,元大-蘆洲,2024-07-16,9857
3044,健鼎,35,5,30,元大-蘆洲,2024-07-16,9857
3708,上緯投控,31,3,28,元大-蘆洲,2024-07-16,9857
1101,台泥,34,6,28,元大-蘆洲,2024-07-16,9857
8076,伍豐,27,0,27,元大-蘆洲,2024-07-16,9857
2356,英業達,44,18,26,元大-蘆洲,2024-07-16,9857
1513,中興電,53,28,25,元大-蘆洲,2024-07-16,9857
2609,陽明,35,10,25,元大-蘆洲,2024-07-16,9857
5498,凱崴,25,0,25,元大-蘆洲,2024-07-16,9857
00632R,元大台灣50反1,27,2,25,元大-蘆洲,2024-07-16,9857
4956,光鋐,38,13,25,元大-蘆洲,2024-07-16,9857
9105,泰金寶-DR,60,37,23,元大-蘆洲,2024-07-16,9857
4714,永捷,28,5,23,元大-蘆洲,2024-07-16,9857
5443,均豪,35,13,22,元大-蘆洲,2024-07-16,9857
1785,光洋科,31,10,21,元大-蘆洲,2024-07-16,9857
00929,復華台灣科技優息,490,47,443,元大-蘆洲,2024-07-17,9857
2882,國泰金,285,17,268,元大-蘆洲,2024-07-17,9857
00937B,群益ESG投等債20,281,25,256,元大-蘆洲,2024-07-17,9857
1718,中纖,189,0,189,元大-蘆洲,2024-07-17,9857
6451,訊芯-KY,139,9,130,元大-蘆洲,2024-07-17,9857
3231,緯創,179,52,127,元大-蘆洲,2024-07-17,9857
00919,群益台灣精選高息,171,53,118,元大-蘆洲,2024-07-17,9857
2537,聯上發,198,109,89,元大-蘆洲,2024-07-17,9857
3189,景碩,140,65,75,元大-蘆洲,2024-07-17,9857
1409,新纖,93,21,72,元大-蘆洲,2024-07-17,9857
0056,元大高股息,82,11,71,元大-蘆洲,2024-07-17,9857
00934,中信成長高股息,121,50,71,元大-蘆洲,2024-07-17,9857
00680L,元大美債20正2,114,49,65,元大-蘆洲,2024-07-17,9857
8011,台通,106,41,65,元大-蘆洲,2024-07-17,9857
00679B,元大美債20年,83,21,62,元大-蘆洲,2024-07-17,9857
6244,茂迪,67,5,62,元大-蘆洲,2024-07-17,9857
4906,正文,89,33,56,元大-蘆洲,2024-07-17,9857
6770,力積電,71,17,54,元大-蘆洲,2024-07-17,9857
2402,毅嘉,218,165,53,元大-蘆洲,2024-07-17,9857
00927,群益半導體收益,52,0,52,元大-蘆洲,2024-07-17,9857
00936,台新永續高息中小,52,0,52,元大-蘆洲,2024-07-17,9857
2462,良得電,51,0,51,元大-蘆洲,2024-07-17,9857
00650L,復華香港正2,50,0,50,元大-蘆洲,2024-07-17,9857
00918,大華優利高填息30,45,0,45,元大-蘆洲,2024-07-17,9857
00905,FT臺灣Smart,45,3,42,元大-蘆洲,2024-07-17,9857
2881,富邦金,46,4,42,元大-蘆洲,2024-07-17,9857
2330,台積電,50,9,41,元大-蘆洲,2024-07-17,9857
1609,大亞,781,742,39,元大-蘆洲,2024-07-17,9857
2867,三商壽,62,25,37,元大-蘆洲,2024-07-17,9857
00878,國泰永續高股息,55,20,35,元大-蘆洲,2024-07-17,9857
00795B,中信美國公債20年,37,3,34,元大-蘆洲,2024-07-17,9857
1529,樂事綠能,36,3,33,元大-蘆洲,2024-07-17,9857
2845,遠東銀,43,10,33,元大-蘆洲,2024-07-17,9857
5876,上海商銀,49,17,32,元大-蘆洲,2024-07-17,9857
2515,中工,70,39,31,元大-蘆洲,2024-07-17,9857
4414,如興,36,5,31,元大-蘆洲,2024-07-17,9857
2538,基泰,44,16,28,元大-蘆洲,2024-07-17,9857
2376,技嘉,47,19,28,元大-蘆洲,2024-07-17,9857
00881,國泰台灣5G+,41,13,28,元大-蘆洲,2024-07-17,9857
2338,光罩,28,0,28,元大-蘆洲,2024-07-17,9857
2002,中鋼,54,28,26,元大-蘆洲,2024-07-17,9857
2371,大同,50,24,26,元大-蘆洲,2024-07-17,9857
00864B,中信美國公債0-1,26,0,26,元大-蘆洲,2024-07-17,9857
6215,和椿,26,1,25,元大-蘆洲,2024-07-17,9857
3050,鈺德,38,14,24,元大-蘆洲,2024-07-17,9857
2328,廣宇,24,0,24,元大-蘆洲,2024-07-17,9857
4958,臻鼎-KY,77,53,24,元大-蘆洲,2024-07-17,9857
2353,宏��,44,21,23,元大-蘆洲,2024-07-17,9857
3022,威強電,25,3,22,元大-蘆洲,2024-07-17,9857
4113,聯上,31,9,22,元大-蘆洲,2024-07-17,9857
00712,復華富時不動產,672,24,648,元大-蘆洲,2024-07-18,9857
00929,復華台灣科技優息,607,166,441,元大-蘆洲,2024-07-18,9857
00669R,國泰美國道瓊反1,353,0,353,元大-蘆洲,2024-07-18,9857
00919,群益台灣精選高息,330,10,320,元大-蘆洲,2024-07-18,9857
00632R,元大台灣50反1,323,120,203,元大-蘆洲,2024-07-18,9857
00937B,群益ESG投等債20,242,68,174,元大-蘆洲,2024-07-18,9857
2365,昆盈,522,364,158,元大-蘆洲,2024-07-18,9857
2208,台船,151,0,151,元大-蘆洲,2024-07-18,9857
00679B,元大美債20年,200,61,139,元大-蘆洲,2024-07-18,9857
00878,國泰永續高股息,138,15,123,元大-蘆洲,2024-07-18,9857
0056,元大高股息,120,8,112,元大-蘆洲,2024-07-18,9857
00934,中信成長高股息,190,95,95,元大-蘆洲,2024-07-18,9857
3481,群創,388,293,95,元大-蘆洲,2024-07-18,9857
1709,和益,162,70,92,元大-蘆洲,2024-07-18,9857
2317,鴻海,168,79,89,元大-蘆洲,2024-07-18,9857
00927,群益半導體收益,89,2,87,元大-蘆洲,2024-07-18,9857
00946,群益科技高息成長,115,29,86,元大-蘆洲,2024-07-18,9857
2610,華航,94,12,82,元大-蘆洲,2024-07-18,9857
2303,聯電,125,44,81,元大-蘆洲,2024-07-18,9857
4113,聯上,60,2,58,元大-蘆洲,2024-07-18,9857
3231,緯創,86,33,53,元大-蘆洲,2024-07-18,9857
6770,力積電,73,22,51,元大-蘆洲,2024-07-18,9857
00651R,復華香港反1,52,1,51,元大-蘆洲,2024-07-18,9857
2489,瑞軒,111,60,51,元大-蘆洲,2024-07-18,9857
2371,大同,67,18,49,元大-蘆洲,2024-07-18,9857
3094,聯傑,47,2,45,元大-蘆洲,2024-07-18,9857
2330,台積電,62,17,45,元大-蘆洲,2024-07-18,9857
2356,英業達,88,44,44,元大-蘆洲,2024-07-18,9857
2382,廣達,59,15,44,元大-蘆洲,2024-07-18,9857
3163,波若威,133,89,44,元大-蘆洲,2024-07-18,9857
1718,中纖,89,48,41,元大-蘆洲,2024-07-18,9857
00688L,國泰20年美債正2,40,0,40,元大-蘆洲,2024-07-18,9857
00936,台新永續高息中小,55,15,40,元大-蘆洲,2024-07-18,9857
00885,富邦越南,69,30,39,元大-蘆洲,2024-07-18,9857
1785,光洋科,58,19,39,元大-蘆洲,2024-07-18,9857
2537,聯上發,84,45,39,元大-蘆洲,2024-07-18,9857
3013,晟銘電,121,83,38,元大-蘆洲,2024-07-18,9857
1611,中電,51,13,38,元大-蘆洲,2024-07-18,9857
2354,鴻準,41,4,37,元大-蘆洲,2024-07-18,9857
00918,大華優利高填息30,44,8,36,元大-蘆洲,2024-07-18,9857
3715,定穎投控,32,1,31,元大-蘆洲,2024-07-18,9857
3591,艾笛森,31,0,31,元大-蘆洲,2024-07-18,9857
5607,遠雄港,31,0,31,元大-蘆洲,2024-07-18,9857
8096,擎亞,46,15,31,元大-蘆洲,2024-07-18,9857
5531,鄉林,30,0,30,元大-蘆洲,2024-07-18,9857
2377,微星,52,22,30,元大-蘆洲,2024-07-18,9857
2362,藍天,90,62,28,元大-蘆洲,2024-07-18,9857
2542,興富發,35,8,27,元大-蘆洲,2024-07-18,9857
00891,中信關鍵半導體,37,11,26,元大-蘆洲,2024-07-18,9857
9904,寶成,88,63,25,元大-蘆洲,2024-07-18,9857
00929,復華台灣科技優息,525,19,506,元大-蘆洲,2024-07-19,9857
00680L,元大美債20正2,476,20,456,元大-蘆洲,2024-07-19,9857
00919,群益台灣精選高息,314,32,282,元大-蘆洲,2024-07-19,9857
00937B,群益ESG投等債20,312,67,245,元大-蘆洲,2024-07-19,9857
00878,國泰永續高股息,233,27,206,元大-蘆洲,2024-07-19,9857
0056,元大高股息,148,8,140,元大-蘆洲,2024-07-19,9857
1314,中石化,118,0,118,元大-蘆洲,2024-07-19,9857
6603,富強鑫,109,3,106,元大-蘆洲,2024-07-19,9857
5215,科嘉-KY,102,0,102,元大-蘆洲,2024-07-19,9857
2886,兆豐金,100,2,98,元大-蘆洲,2024-07-19,9857
00934,中信成長高股息,103,11,92,元大-蘆洲,2024-07-19,9857
2402,毅嘉,122,39,83,元大-蘆洲,2024-07-19,9857
3376,新日興,100,21,79,元大-蘆洲,2024-07-19,9857
3481,群創,304,229,75,元大-蘆洲,2024-07-19,9857
2330,台積電,116,41,75,元大-蘆洲,2024-07-19,9857
5607,遠雄港,76,5,71,元大-蘆洲,2024-07-19,9857
2618,長榮航,80,14,66,元大-蘆洲,2024-07-19,9857
5309,系統電,124,64,60,元大-蘆洲,2024-07-19,9857
1409,新纖,60,0,60,元大-蘆洲,2024-07-19,9857
3714,富采,58,0,58,元大-蘆洲,2024-07-19,9857
00947,台新臺灣IC設計,57,0,57,元大-蘆洲,2024-07-19,9857
6901,鑽石投資,57,0,57,元大-蘆洲,2024-07-19,9857
00725B,國泰投資級公司債,56,1,55,元大-蘆洲,2024-07-19,9857
00946,群益科技高息成長,64,10,54,元大-蘆洲,2024-07-19,9857
00936,台新永續高息中小,57,3,54,元大-蘆洲,2024-07-19,9857
1609,大亞,755,702,53,元大-蘆洲,2024-07-19,9857
1326,台化,52,0,52,元大-蘆洲,2024-07-19,9857
2356,英業達,73,22,51,元大-蘆洲,2024-07-19,9857
00650L,復華香港正2,50,0,50,元大-蘆洲,2024-07-19,9857
6615,慧智,50,0,50,元大-蘆洲,2024-07-19,9857
2511,太子,50,2,48,元大-蘆洲,2024-07-19,9857
1304,台聚,50,2,48,元大-蘆洲,2024-07-19,9857
8011,台通,72,25,47,元大-蘆洲,2024-07-19,9857
2344,華邦電,46,0,46,元大-蘆洲,2024-07-19,9857
2881,富邦金,45,1,44,元大-蘆洲,2024-07-19,9857
2515,中工,45,2,43,元大-蘆洲,2024-07-19,9857
2440,太空梭,50,7,43,元大-蘆洲,2024-07-19,9857
8112,至上,45,2,43,元大-蘆洲,2024-07-19,9857
8033,雷虎,42,0,42,元大-蘆洲,2024-07-19,9857
4303,信立,136,94,42,元大-蘆洲,2024-07-19,9857
2349,錸德,40,1,39,元大-蘆洲,2024-07-19,9857
9904,寶成,42,4,38,元大-蘆洲,2024-07-19,9857
2542,興富發,42,6,36,元大-蘆洲,2024-07-19,9857
00881,國泰台灣5G+,64,28,36,元大-蘆洲,2024-07-19,9857
1802,台玻,34,0,34,元大-蘆洲,2024-07-19,9857
2537,聯上發,108,74,34,元大-蘆洲,2024-07-19,9857
2406,國碩,44,10,34,元大-蘆洲,2024-07-19,9857
9945,潤泰新,54,21,33,元大-蘆洲,2024-07-19,9857
2845,遠東銀,36,4,32,元大-蘆洲,2024-07-19,9857
00918,大華優利高填息30,48,17,31,元大-蘆洲,2024-07-19,9857
00940,元大台灣價值高息,419,48,371,元大-蘆洲,2024-07-22,9857
00665L,富邦�琤肭磪囓�2,351,3,348,元大-蘆洲,2024-07-22,9857
2838,聯邦銀,301,0,301,元大-蘆洲,2024-07-22,9857
00929,復華台灣科技優息,660,398,262,元大-蘆洲,2024-07-22,9857
00878,國泰永續高股息,331,76,255,元大-蘆洲,2024-07-22,9857
00919,群益台灣精選高息,442,243,199,元大-蘆洲,2024-07-22,9857
0056,元大高股息,164,75,89,元大-蘆洲,2024-07-22,9857
2303,聯電,119,35,84,元大-蘆洲,2024-07-22,9857
00680L,元大美債20正2,98,21,77,元大-蘆洲,2024-07-22,9857
00946,群益科技高息成長,61,1,60,元大-蘆洲,2024-07-22,9857
2206,三陽工業,61,2,59,元大-蘆洲,2024-07-22,9857
00934,中信成長高股息,197,140,57,元大-蘆洲,2024-07-22,9857
2301,光寶科,74,17,57,元大-蘆洲,2024-07-22,9857
2317,鴻海,189,132,57,元大-蘆洲,2024-07-22,9857
2365,昆盈,306,254,52,元大-蘆洲,2024-07-22,9857
1611,中電,168,117,51,元大-蘆洲,2024-07-22,9857
2618,長榮航,69,18,51,元大-蘆洲,2024-07-22,9857
6129,普誠,52,2,50,元大-蘆洲,2024-07-22,9857
3715,定穎投控,71,24,47,元大-蘆洲,2024-07-22,9857
5439,高技,48,3,45,元大-蘆洲,2024-07-22,9857
3231,緯創,79,35,44,元大-蘆洲,2024-07-22,9857
00637L,元大滬深300正2,94,50,44,元大-蘆洲,2024-07-22,9857
3481,群創,329,286,43,元大-蘆洲,2024-07-22,9857
3576,聯合再生,44,3,41,元大-蘆洲,2024-07-22,9857
5309,系統電,43,5,38,元大-蘆洲,2024-07-22,9857
3492,長盛,41,4,37,元大-蘆洲,2024-07-22,9857
5880,合庫金,40,4,36,元大-蘆洲,2024-07-22,9857
1609,大亞,134,99,35,元大-蘆洲,2024-07-22,9857
3037,欣興,72,38,34,元大-蘆洲,2024-07-22,9857
00936,台新永續高息中小,51,17,34,元大-蘆洲,2024-07-22,9857
00891,中信關鍵半導體,34,0,34,元大-蘆洲,2024-07-22,9857
6147,頎邦,33,0,33,元大-蘆洲,2024-07-22,9857
00881,國泰台灣5G+,57,26,31,元大-蘆洲,2024-07-22,9857
006208,富邦台50,35,6,29,元大-蘆洲,2024-07-22,9857
5512,力麒,176,147,29,元大-蘆洲,2024-07-22,9857
1905,華紙,28,0,28,元大-蘆洲,2024-07-22,9857
2883,凱基金,60,34,26,元大-蘆洲,2024-07-22,9857
8150,南茂,29,3,26,元大-蘆洲,2024-07-22,9857
00935,野村臺灣新科技50,28,2,26,元大-蘆洲,2024-07-22,9857
8473,山林水,83,58,25,元大-蘆洲,2024-07-22,9857
2834,臺企銀,31,7,24,元大-蘆洲,2024-07-22,9857
2886,兆豐金,31,7,24,元大-蘆洲,2024-07-22,9857
2338,光罩,26,2,24,元大-蘆洲,2024-07-22,9857
00713,元大台灣高息低波,24,1,23,元大-蘆洲,2024-07-22,9857
0050,元大台灣50,28,6,22,元大-蘆洲,2024-07-22,9857
1409,新纖,35,13,22,元大-蘆洲,2024-07-22,9857
00688L,國泰20年美債正2,22,0,22,元大-蘆洲,2024-07-22,9857
2344,華邦電,30,8,22,元大-蘆洲,2024-07-22,9857
2498,宏達電,45,25,20,元大-蘆洲,2024-07-22,9857
2484,希華,24,5,19,元大-蘆洲,2024-07-22,9857
00929,復華台灣科技優息,410,207,203,元大-蘆洲,2024-07-23,9857
00937B,群益ESG投等債20,259,57,202,元大-蘆洲,2024-07-23,9857
2801,彰銀,200,1,199,元大-蘆洲,2024-07-23,9857
00885,富邦越南,200,9,191,元大-蘆洲,2024-07-23,9857
3481,群創,267,111,156,元大-蘆洲,2024-07-23,9857
00878,國泰永續高股息,157,39,118,元大-蘆洲,2024-07-23,9857
2489,瑞軒,147,29,118,元大-蘆洲,2024-07-23,9857
2888,新光金,131,18,113,元大-蘆洲,2024-07-23,9857
00919,群益台灣精選高息,189,96,93,元大-蘆洲,2024-07-23,9857
00632R,元大台灣50反1,152,78,74,元大-蘆洲,2024-07-23,9857
00940,元大台灣價值高息,83,10,73,元大-蘆洲,2024-07-23,9857
2609,陽明,118,52,66,元大-蘆洲,2024-07-23,9857
00753L,中信中國50正2,64,1,63,元大-蘆洲,2024-07-23,9857
8105,凌巨,69,8,61,元大-蘆洲,2024-07-23,9857
2349,錸德,62,2,60,元大-蘆洲,2024-07-23,9857
2409,友達,86,26,60,元大-蘆洲,2024-07-23,9857
0056,元大高股息,85,25,60,元大-蘆洲,2024-07-23,9857
00946,群益科技高息成長,62,5,57,元大-蘆洲,2024-07-23,9857
00933B,國泰10Y+金融債,57,8,49,元大-蘆洲,2024-07-23,9857
00688L,國泰20年美債正2,45,0,45,元大-蘆洲,2024-07-23,9857
00725B,國泰投資級公司債,43,0,43,元大-蘆洲,2024-07-23,9857
2408,南亞科,44,1,43,元大-蘆洲,2024-07-23,9857
5512,力麒,84,43,41,元大-蘆洲,2024-07-23,9857
4746,台耀,59,21,38,元大-蘆洲,2024-07-23,9857
3450,聯鈞,52,16,36,元大-蘆洲,2024-07-23,9857
00679B,元大美債20年,37,4,33,元大-蘆洲,2024-07-23,9857
1301,台塑,31,3,28,元大-蘆洲,2024-07-23,9857
2359,所羅門,85,59,26,元大-蘆洲,2024-07-23,9857
00637L,元大滬深300正2,62,36,26,元大-蘆洲,2024-07-23,9857
00934,中信成長高股息,88,63,25,元大-蘆洲,2024-07-23,9857
1609,大亞,49,24,25,元大-蘆洲,2024-07-23,9857
2312,金寶,103,79,24,元大-蘆洲,2024-07-23,9857
3231,緯創,38,14,24,元大-蘆洲,2024-07-23,9857
1314,中石化,27,4,23,元大-蘆洲,2024-07-23,9857
2511,太子,33,10,23,元大-蘆洲,2024-07-23,9857
5452,佶優,27,4,23,元大-蘆洲,2024-07-23,9857
3163,波若威,65,43,22,元大-蘆洲,2024-07-23,9857
3712,永崴投控,25,4,21,元大-蘆洲,2024-07-23,9857
2338,光罩,21,0,21,元大-蘆洲,2024-07-23,9857
6026,福邦證,20,0,20,元大-蘆洲,2024-07-23,9857
2301,光寶科,22,2,20,元大-蘆洲,2024-07-23,9857
2867,三商壽,59,40,19,元大-蘆洲,2024-07-23,9857
2515,中工,31,12,19,元大-蘆洲,2024-07-23,9857
00715L,期街口布蘭特正2,18,0,18,元大-蘆洲,2024-07-23,9857
3048,益登,53,35,18,元大-蘆洲,2024-07-23,9857
3266,昇陽,25,8,17,元大-蘆洲,2024-07-23,9857
4960,誠美材,16,0,16,元大-蘆洲,2024-07-23,9857
00942B,台新美A公司債20+,16,0,16,元大-蘆洲,2024-07-23,9857
6121,新普,15,0,15,元大-蘆洲,2024-07-23,9857
2449,京元電子,25,10,15,元大-蘆洲,2024-07-23,9857
00929,復華台灣科技優息,635,207,428,元大-蘆洲,2024-07-26,9857
00878,國泰永續高股息,292,2,290,元大-蘆洲,2024-07-26,9857
00937B,群益ESG投等債20,342,92,250,元大-蘆洲,2024-07-26,9857
00637L,元大滬深300正2,407,221,186,元大-蘆洲,2024-07-26,9857
0056,元大高股息,233,48,185,元大-蘆洲,2024-07-26,9857
00680L,元大美債20正2,185,2,183,元大-蘆洲,2024-07-26,9857
00919,群益台灣精選高息,291,115,176,元大-蘆洲,2024-07-26,9857
00946,群益科技高息成長,163,17,146,元大-蘆洲,2024-07-26,9857
2206,三陽工業,280,140,140,元大-蘆洲,2024-07-26,9857
3037,欣興,159,43,116,元大-蘆洲,2024-07-26,9857
2884,玉山金,121,9,112,元大-蘆洲,2024-07-26,9857
00934,中信成長高股息,187,81,106,元大-蘆洲,2024-07-26,9857
1529,樂事綠能,111,8,103,元大-蘆洲,2024-07-26,9857
00632R,元大台灣50反1,368,284,84,元大-蘆洲,2024-07-26,9857
2317,鴻海,121,37,84,元大-蘆洲,2024-07-26,9857
00891,中信關鍵半導體,91,10,81,元大-蘆洲,2024-07-26,9857
2330,台積電,102,25,77,元大-蘆洲,2024-07-26,9857
2349,錸德,107,36,71,元大-蘆洲,2024-07-26,9857
00940,元大台灣價值高息,457,388,69,元大-蘆洲,2024-07-26,9857
00882,中信中國高股息,86,20,66,元大-蘆洲,2024-07-26,9857
2409,友達,86,30,56,元大-蘆洲,2024-07-26,9857
2303,聯電,140,89,51,元大-蘆洲,2024-07-26,9857
00931B,統一美債20年,50,0,50,元大-蘆洲,2024-07-26,9857
2891,中信金,46,0,46,元大-蘆洲,2024-07-26,9857
00753L,中信中國50正2,55,10,45,元大-蘆洲,2024-07-26,9857
2301,光寶科,46,1,45,元大-蘆洲,2024-07-26,9857
00918,大華優利高填息30,62,19,43,元大-蘆洲,2024-07-26,9857
2845,遠東銀,43,0,43,元大-蘆洲,2024-07-26,9857
006208,富邦台50,46,4,42,元大-蘆洲,2024-07-26,9857
00941,中信上游半導體,46,4,42,元大-蘆洲,2024-07-26,9857
4927,泰鼎-KY,40,0,40,元大-蘆洲,2024-07-26,9857
1409,新纖,42,4,38,元大-蘆洲,2024-07-26,9857
3711,日月光投控,38,1,37,元大-蘆洲,2024-07-26,9857
9105,泰金寶-DR,50,14,36,元大-蘆洲,2024-07-26,9857
2002,中鋼,56,21,35,元大-蘆洲,2024-07-26,9857
0050,元大台灣50,45,10,35,元大-蘆洲,2024-07-26,9857
4960,誠美材,33,0,33,元大-蘆洲,2024-07-26,9857
2344,華邦電,32,0,32,元大-蘆洲,2024-07-26,9857
2851,中再保,32,0,32,元大-蘆洲,2024-07-26,9857
2382,廣達,39,7,32,元大-蘆洲,2024-07-26,9857
00927,群益半導體收益,42,11,31,元大-蘆洲,2024-07-26,9857
00881,國泰台灣5G+,41,11,30,元大-蘆洲,2024-07-26,9857
1609,大亞,82,52,30,元大-蘆洲,2024-07-26,9857
3231,緯創,68,38,30,元大-蘆洲,2024-07-26,9857
00905,FT臺灣Smart,31,2,29,元大-蘆洲,2024-07-26,9857
1314,中石化,29,0,29,元大-蘆洲,2024-07-26,9857
2356,英業達,57,28,29,元大-蘆洲,2024-07-26,9857
00936,台新永續高息中小,34,6,28,元大-蘆洲,2024-07-26,9857
00933B,國泰10Y+金融債,41,13,28,元大-蘆洲,2024-07-26,9857
2834,臺企銀,28,0,28,元大-蘆洲,2024-07-26,9857
00929,復華台灣科技優息,428,87,341,元大-蘆洲,2024-07-29,9857
5512,力麒,319,17,302,元大-蘆洲,2024-07-29,9857
0056,元大高股息,238,16,222,元大-蘆洲,2024-07-29,9857
00878,國泰永續高股息,198,56,142,元大-蘆洲,2024-07-29,9857
00680L,元大美債20正2,155,26,129,元大-蘆洲,2024-07-29,9857
2206,三陽工業,155,53,102,元大-蘆洲,2024-07-29,9857
00919,群益台灣精選高息,119,35,84,元大-蘆洲,2024-07-29,9857
00934,中信成長高股息,79,16,63,元大-蘆洲,2024-07-29,9857
00946,群益科技高息成長,77,15,62,元大-蘆洲,2024-07-29,9857
00940,元大台灣價值高息,219,161,58,元大-蘆洲,2024-07-29,9857
1314,中石化,65,15,50,元大-蘆洲,2024-07-29,9857
1522,堤維西,50,0,50,元大-蘆洲,2024-07-29,9857
00715L,期街口布蘭特正2,53,5,48,元大-蘆洲,2024-07-29,9857
2344,華邦電,47,2,45,元大-蘆洲,2024-07-29,9857
3047,訊舟,47,3,44,元大-蘆洲,2024-07-29,9857
2303,聯電,106,63,43,元大-蘆洲,2024-07-29,9857
00918,大華優利高填息30,52,11,41,元大-蘆洲,2024-07-29,9857
2356,英業達,63,23,40,元大-蘆洲,2024-07-29,9857
6126,信音,49,10,39,元大-蘆洲,2024-07-29,9857
2367,燿華,69,33,36,元大-蘆洲,2024-07-29,9857
2884,玉山金,68,36,32,元大-蘆洲,2024-07-29,9857
2399,映泰,38,8,30,元大-蘆洲,2024-07-29,9857
3094,聯傑,26,0,26,元大-蘆洲,2024-07-29,9857
2867,三商壽,28,2,26,元大-蘆洲,2024-07-29,9857
2301,光寶科,32,6,26,元大-蘆洲,2024-07-29,9857
00936,台新永續高息中小,25,0,25,元大-蘆洲,2024-07-29,9857
3518,柏騰,26,1,25,元大-蘆洲,2024-07-29,9857
3663,鑫科,64,40,24,元大-蘆洲,2024-07-29,9857
6937,天虹,24,0,24,元大-蘆洲,2024-07-29,9857
2353,宏��,30,7,23,元大-蘆洲,2024-07-29,9857
8940,新天地,23,0,23,元大-蘆洲,2024-07-29,9857
1709,和益,24,2,22,元大-蘆洲,2024-07-29,9857
2331,精英,21,1,20,元大-蘆洲,2024-07-29,9857
5439,高技,20,1,19,元大-蘆洲,2024-07-29,9857
3033,威健,21,2,19,元大-蘆洲,2024-07-29,9857
1513,中興電,63,44,19,元大-蘆洲,2024-07-29,9857
5443,均豪,114,95,19,元大-蘆洲,2024-07-29,9857
6026,福邦證,18,0,18,元大-蘆洲,2024-07-29,9857
2324,仁寶,29,11,18,元大-蘆洲,2024-07-29,9857
2891,中信金,21,4,17,元大-蘆洲,2024-07-29,9857
3231,緯創,32,15,17,元大-蘆洲,2024-07-29,9857
00632R,元大台灣50反1,171,154,17,元大-蘆洲,2024-07-29,9857
4402,郡都開發,24,7,17,元大-蘆洲,2024-07-29,9857
2536,宏普,17,1,16,元大-蘆洲,2024-07-29,9857
2426,鼎元,20,4,16,元大-蘆洲,2024-07-29,9857
5905,南仁湖,16,0,16,元大-蘆洲,2024-07-29,9857
8277,商丞,16,0,16,元大-蘆洲,2024-07-29,9857
3711,日月光投控,22,7,15,元大-蘆洲,2024-07-29,9857
2363,矽統,78,63,15,元大-蘆洲,2024-07-29,9857
1608,華榮,17,3,14,元大-蘆洲,2024-07-29,9857
00940,元大台灣價值高息,512,43,469,元大-蘆洲,2024-07-30,9857
3481,群創,271,120,151,元大-蘆洲,2024-07-30,9857
3037,欣興,154,18,136,元大-蘆洲,2024-07-30,9857
00946,群益科技高息成長,112,0,112,元大-蘆洲,2024-07-30,9857
00680L,元大美債20正2,140,31,109,元大-蘆洲,2024-07-30,9857
2884,玉山金,142,34,108,元大-蘆洲,2024-07-30,9857
2349,錸德,310,209,101,元大-蘆洲,2024-07-30,9857
00929,復華台灣科技優息,372,283,89,元大-蘆洲,2024-07-30,9857
00936,台新永續高息中小,75,7,68,元大-蘆洲,2024-07-30,9857
2303,聯電,108,43,65,元大-蘆洲,2024-07-30,9857
0056,元大高股息,104,48,56,元大-蘆洲,2024-07-30,9857
00637L,元大滬深300正2,77,21,56,元大-蘆洲,2024-07-30,9857
2344,華邦電,57,6,51,元大-蘆洲,2024-07-30,9857
4906,正文,85,34,51,元大-蘆洲,2024-07-30,9857
2382,廣達,60,9,51,元大-蘆洲,2024-07-30,9857
2409,友達,62,14,48,元大-蘆洲,2024-07-30,9857
2337,旺宏,97,50,47,元大-蘆洲,2024-07-30,9857
3024,憶聲,61,14,47,元大-蘆洲,2024-07-30,9857
1709,和益,45,0,45,元大-蘆洲,2024-07-30,9857
00679B,元大美債20年,48,4,44,元大-蘆洲,2024-07-30,9857
1802,台玻,41,0,41,元大-蘆洲,2024-07-30,9857
00753L,中信中國50正2,80,40,40,元大-蘆洲,2024-07-30,9857
3189,景碩,78,40,38,元大-蘆洲,2024-07-30,9857
5905,南仁湖,35,0,35,元大-蘆洲,2024-07-30,9857
00934,中信成長高股息,85,51,34,元大-蘆洲,2024-07-30,9857
2312,金寶,49,17,32,元大-蘆洲,2024-07-30,9857
00715L,期街口布蘭特正2,28,0,28,元大-蘆洲,2024-07-30,9857
3706,神達,28,1,27,元大-蘆洲,2024-07-30,9857
00882,中信中國高股息,36,10,26,元大-蘆洲,2024-07-30,9857
3231,緯創,43,17,26,元大-蘆洲,2024-07-30,9857
1608,華榮,33,8,25,元大-蘆洲,2024-07-30,9857
2317,鴻海,58,35,23,元大-蘆洲,2024-07-30,9857
00891,中信關鍵半導體,38,17,21,元大-蘆洲,2024-07-30,9857
1101,台泥,22,1,21,元大-蘆洲,2024-07-30,9857
1316,上曜,72,51,21,元大-蘆洲,2024-07-30,9857
3583,辛耘,24,4,20,元大-蘆洲,2024-07-30,9857
00712,復華富時不動產,29,10,19,元大-蘆洲,2024-07-30,9857
00947,台新臺灣IC設計,19,1,18,元大-蘆洲,2024-07-30,9857
2891,中信金,32,15,17,元大-蘆洲,2024-07-30,9857
00939,統一台灣高息動能,18,2,16,元大-蘆洲,2024-07-30,9857
00933B,國泰10Y+金融債,16,0,16,元大-蘆洲,2024-07-30,9857
2347,聯強,16,0,16,元大-蘆洲,2024-07-30,9857
6026,福邦證,16,0,16,元大-蘆洲,2024-07-30,9857
3211,順達,26,10,16,元大-蘆洲,2024-07-30,9857
2501,國建,17,2,15,元大-蘆洲,2024-07-30,9857
4402,郡都開發,17,2,15,元大-蘆洲,2024-07-30,9857
00951,台新日本半導體,16,1,15,元大-蘆洲,2024-07-30,9857
2376,技嘉,19,5,14,元大-蘆洲,2024-07-30,9857
00915,凱基優選高股息30,14,0,14,元大-蘆洲,2024-07-30,9857
1536,和大,16,2,14,元大-蘆洲,2024-07-30,9857
00929,復華台灣科技優息,357,114,243,元大-蘆洲,2024-07-31,9857
3047,訊舟,337,170,167,元大-蘆洲,2024-07-31,9857
2408,南亞科,128,0,128,元大-蘆洲,2024-07-31,9857
00919,群益台灣精選高息,117,6,111,元大-蘆洲,2024-07-31,9857
1709,和益,112,13,99,元大-蘆洲,2024-07-31,9857
00940,元大台灣價值高息,810,720,90,元大-蘆洲,2024-07-31,9857
5905,南仁湖,85,2,83,元大-蘆洲,2024-07-31,9857
00830,國泰費城半導體,73,0,73,元大-蘆洲,2024-07-31,9857
00632R,元大台灣50反1,72,12,60,元大-蘆洲,2024-07-31,9857
00878,國泰永續高股息,71,15,56,元大-蘆洲,2024-07-31,9857
00651R,復華香港反1,55,3,52,元大-蘆洲,2024-07-31,9857
00679B,元大美債20年,73,22,51,元大-蘆洲,2024-07-31,9857
2362,藍天,55,8,47,元大-蘆洲,2024-07-31,9857
9904,寶成,50,5,45,元大-蘆洲,2024-07-31,9857
00946,群益科技高息成長,43,1,42,元大-蘆洲,2024-07-31,9857
2359,所羅門,69,28,41,元大-蘆洲,2024-07-31,9857
1909,榮成,40,0,40,元大-蘆洲,2024-07-31,9857
4906,正文,42,4,38,元大-蘆洲,2024-07-31,9857
00934,中信成長高股息,77,45,32,元大-蘆洲,2024-07-31,9857
00715L,期街口布蘭特正2,30,0,30,元大-蘆洲,2024-07-31,9857
0056,元大高股息,34,6,28,元大-蘆洲,2024-07-31,9857
1434,福懋,28,0,28,元大-蘆洲,2024-07-31,9857
00937B,群益ESG投等債20,79,51,28,元大-蘆洲,2024-07-31,9857
00687B,國泰20年美債,33,5,28,元大-蘆洲,2024-07-31,9857
6126,信音,32,5,27,元大-蘆洲,2024-07-31,9857
00942B,台新美A公司債20+,26,0,26,元大-蘆洲,2024-07-31,9857
9945,潤泰新,33,7,26,元大-蘆洲,2024-07-31,9857
3037,欣興,53,27,26,元大-蘆洲,2024-07-31,9857
3580,友威科,54,29,25,元大-蘆洲,2024-07-31,9857
6937,天虹,25,0,25,元大-蘆洲,2024-07-31,9857
1409,新纖,25,0,25,元大-蘆洲,2024-07-31,9857
5452,佶優,23,0,23,元大-蘆洲,2024-07-31,9857
4526,東台,36,13,23,元大-蘆洲,2024-07-31,9857
2489,瑞軒,37,16,21,元大-蘆洲,2024-07-31,9857
3715,定穎投控,74,53,21,元大-蘆洲,2024-07-31,9857
4967,十銓,25,5,20,元大-蘆洲,2024-07-31,9857
8064,東捷,163,144,19,元大-蘆洲,2024-07-31,9857
00948B,中信優息投資級債,19,0,19,元大-蘆洲,2024-07-31,9857
3105,穩懋,18,0,18,元大-蘆洲,2024-07-31,9857
3686,達能,19,1,18,元大-蘆洲,2024-07-31,9857
5443,均豪,191,174,17,元大-蘆洲,2024-07-31,9857
2887,台新金,19,2,17,元大-蘆洲,2024-07-31,9857
3583,辛耘,22,6,16,元大-蘆洲,2024-07-31,9857
2477,美隆電,18,2,16,元大-蘆洲,2024-07-31,9857
2301,光寶科,19,3,16,元大-蘆洲,2024-07-31,9857
2542,興富發,19,4,15,元大-蘆洲,2024-07-31,9857
2204,中華,16,1,15,元大-蘆洲,2024-07-31,9857
2464,盟立,45,30,15,元大-蘆洲,2024-07-31,9857
9105,泰金寶-DR,23,8,15,元大-蘆洲,2024-07-31,9857
00922,國泰台灣領袖50,15,0,15,元大-蘆洲,2024-07-31,9857
00632R,元大台灣50反1,689,415,274,元大-蘆洲,2024-08-01,9857
2349,錸德,287,78,209,元大-蘆洲,2024-08-01,9857
2337,旺宏,408,240,168,元大-蘆洲,2024-08-01,9857
1314,中石化,176,13,163,元大-蘆洲,2024-08-01,9857
00878,國泰永續高股息,145,13,132,元大-蘆洲,2024-08-01,9857
2618,長榮航,113,16,97,元大-蘆洲,2024-08-01,9857
00937B,群益ESG投等債20,118,25,93,元大-蘆洲,2024-08-01,9857
00679B,元大美債20年,97,9,88,元大-蘆洲,2024-08-01,9857
00946,群益科技高息成長,98,14,84,元大-蘆洲,2024-08-01,9857
00687B,國泰20年美債,123,43,80,元大-蘆洲,2024-08-01,9857
00830,國泰費城半導體,94,15,79,元大-蘆洲,2024-08-01,9857
9904,寶成,100,31,69,元大-蘆洲,2024-08-01,9857
00637L,元大滬深300正2,60,0,60,元大-蘆洲,2024-08-01,9857
00706L,期元大S＆P日圓正2,88,28,60,元大-蘆洲,2024-08-01,9857
1216,統一,58,5,53,元大-蘆洲,2024-08-01,9857
00905,FT臺灣Smart,46,0,46,元大-蘆洲,2024-08-01,9857
3024,憶聲,61,17,44,元大-蘆洲,2024-08-01,9857
2409,友達,47,6,41,元大-蘆洲,2024-08-01,9857
00715L,期街口布蘭特正2,60,23,37,元大-蘆洲,2024-08-01,9857
2324,仁寶,41,6,35,元大-蘆洲,2024-08-01,9857
4402,郡都開發,34,0,34,元大-蘆洲,2024-08-01,9857
2542,興富發,58,24,34,元大-蘆洲,2024-08-01,9857
8028,昇陽半導體,49,18,31,元大-蘆洲,2024-08-01,9857
3260,威剛,35,4,31,元大-蘆洲,2024-08-01,9857
2329,華泰,31,3,28,元大-蘆洲,2024-08-01,9857
2363,矽統,98,70,28,元大-蘆洲,2024-08-01,9857
4967,十銓,50,24,26,元大-蘆洲,2024-08-01,9857
00651R,復華香港反1,25,0,25,元大-蘆洲,2024-08-01,9857
3047,訊舟,91,67,24,元大-蘆洲,2024-08-01,9857
2637,慧洋-KY,23,0,23,元大-蘆洲,2024-08-01,9857
2834,臺企銀,26,3,23,元大-蘆洲,2024-08-01,9857
00712,復華富時不動產,22,0,22,元大-蘆洲,2024-08-01,9857
2851,中再保,21,0,21,元大-蘆洲,2024-08-01,9857
5443,均豪,75,55,20,元大-蘆洲,2024-08-01,9857
0056,元大高股息,36,16,20,元大-蘆洲,2024-08-01,9857
6239,力成,24,5,19,元大-蘆洲,2024-08-01,9857
00673R,期元大S＆P原油反1,19,0,19,元大-蘆洲,2024-08-01,9857
2615,萬海,36,17,19,元大-蘆洲,2024-08-01,9857
4564,元翎,24,5,19,元大-蘆洲,2024-08-01,9857
1513,中興電,20,2,18,元大-蘆洲,2024-08-01,9857
00923,群益台ESG低碳50,21,4,17,元大-蘆洲,2024-08-01,9857
00948B,中信優息投資級債,24,8,16,元大-蘆洲,2024-08-01,9857
2405,輔信,23,7,16,元大-蘆洲,2024-08-01,9857
3346,麗清,16,0,16,元大-蘆洲,2024-08-01,9857
2356,英業達,36,20,16,元大-蘆洲,2024-08-01,9857
1905,華紙,15,0,15,元大-蘆洲,2024-08-01,9857
1305,華夏,16,2,14,元大-蘆洲,2024-08-01,9857
2884,玉山金,15,2,13,元大-蘆洲,2024-08-01,9857
00929,復華台灣科技優息,68,56,12,元大-蘆洲,2024-08-01,9857
3211,順達,13,1,12,元大-蘆洲,2024-08-01,9857
00940,元大台灣價值高息,707,135,572,元大-蘆洲,2024-08-02,9857
00680L,元大美債20正2,610,62,548,元大-蘆洲,2024-08-02,9857
00929,復華台灣科技優息,533,38,495,元大-蘆洲,2024-08-02,9857
00919,群益台灣精選高息,446,45,401,元大-蘆洲,2024-08-02,9857
00878,國泰永續高股息,502,108,394,元大-蘆洲,2024-08-02,9857
00679B,元大美債20年,333,31,302,元大-蘆洲,2024-08-02,9857
0056,元大高股息,225,1,224,元大-蘆洲,2024-08-02,9857
00885,富邦越南,219,2,217,元大-蘆洲,2024-08-02,9857
2317,鴻海,319,182,137,元大-蘆洲,2024-08-02,9857
2344,華邦電,144,27,117,元大-蘆洲,2024-08-02,9857
2330,台積電,130,16,114,元大-蘆洲,2024-08-02,9857
00946,群益科技高息成長,118,6,112,元大-蘆洲,2024-08-02,9857
00881,國泰台灣5G+,144,34,110,元大-蘆洲,2024-08-02,9857
3062,建漢,120,17,103,元大-蘆洲,2024-08-02,9857
2371,大同,108,6,102,元大-蘆洲,2024-08-02,9857
5512,力麒,108,7,101,元大-蘆洲,2024-08-02,9857
2206,三陽工業,140,42,98,元大-蘆洲,2024-08-02,9857
00937B,群益ESG投等債20,156,60,96,元大-蘆洲,2024-08-02,9857
00923,群益台ESG低碳50,88,0,88,元大-蘆洲,2024-08-02,9857
5905,南仁湖,77,0,77,元大-蘆洲,2024-08-02,9857
1314,中石化,82,9,73,元大-蘆洲,2024-08-02,9857
3037,欣興,195,124,71,元大-蘆洲,2024-08-02,9857
2337,旺宏,234,168,66,元大-蘆洲,2024-08-02,9857
00687B,國泰20年美債,94,36,58,元大-蘆洲,2024-08-02,9857
00927,群益半導體收益,60,2,58,元大-蘆洲,2024-08-02,9857
00936,台新永續高息中小,65,7,58,元大-蘆洲,2024-08-02,9857
00934,中信成長高股息,178,123,55,元大-蘆洲,2024-08-02,9857
00941,中信上游半導體,52,0,52,元大-蘆洲,2024-08-02,9857
2520,冠德,81,29,52,元大-蘆洲,2024-08-02,9857
4927,泰鼎-KY,47,0,47,元大-蘆洲,2024-08-02,9857
4906,正文,63,18,45,元大-蘆洲,2024-08-02,9857
9945,潤泰新,77,32,45,元大-蘆洲,2024-08-02,9857
1409,新纖,43,0,43,元大-蘆洲,2024-08-02,9857
00922,國泰台灣領袖50,39,0,39,元大-蘆洲,2024-08-02,9857
00932,兆豐永續高息等權,40,1,39,元大-蘆洲,2024-08-02,9857
00905,FT臺灣Smart,38,0,38,元大-蘆洲,2024-08-02,9857
00637L,元大滬深300正2,70,34,36,元大-蘆洲,2024-08-02,9857
0050,元大台灣50,37,2,35,元大-蘆洲,2024-08-02,9857
4714,永捷,43,8,35,元大-蘆洲,2024-08-02,9857
1210,大成,35,0,35,元大-蘆洲,2024-08-02,9857
00891,中信關鍵半導體,34,0,34,元大-蘆洲,2024-08-02,9857
00688L,國泰20年美債正2,85,52,33,元大-蘆洲,2024-08-02,9857
1316,上曜,106,73,33,元大-蘆洲,2024-08-02,9857
3363,上詮,39,6,33,元大-蘆洲,2024-08-02,9857
2421,建準,35,3,32,元大-蘆洲,2024-08-02,9857
4960,誠美材,31,0,31,元大-蘆洲,2024-08-02,9857
3231,緯創,51,21,30,元大-蘆洲,2024-08-02,9857
3711,日月光投控,33,3,30,元大-蘆洲,2024-08-02,9857
5531,鄉林,31,1,30,元大-蘆洲,2024-08-02,9857
1815,富喬,37,8,29,元大-蘆洲,2024-08-02,9857
00940,元大台灣價值高息,2041,522,1519,元大-蘆洲,2024-08-05,9857
00919,群益台灣精選高息,925,230,695,元大-蘆洲,2024-08-05,9857
00929,復華台灣科技優息,1324,755,569,元大-蘆洲,2024-08-05,9857
0056,元大高股息,395,68,327,元大-蘆洲,2024-08-05,9857
00688L,國泰20年美債正2,333,74,259,元大-蘆洲,2024-08-05,9857
00946,群益科技高息成長,249,4,245,元大-蘆洲,2024-08-05,9857
00936,台新永續高息中小,263,34,229,元大-蘆洲,2024-08-05,9857
2317,鴻海,313,96,217,元大-蘆洲,2024-08-05,9857
2206,三陽工業,202,8,194,元大-蘆洲,2024-08-05,9857
2838,聯邦銀,153,0,153,元大-蘆洲,2024-08-05,9857
2337,旺宏,383,234,149,元大-蘆洲,2024-08-05,9857
2834,臺企銀,152,8,144,元大-蘆洲,2024-08-05,9857
2409,友達,206,72,134,元大-蘆洲,2024-08-05,9857
00680L,元大美債20正2,486,354,132,元大-蘆洲,2024-08-05,9857
1314,中石化,130,2,128,元大-蘆洲,2024-08-05,9857
2303,聯電,254,137,117,元大-蘆洲,2024-08-05,9857
00676R,富邦臺灣加權反1,115,0,115,元大-蘆洲,2024-08-05,9857
2883,凱基金,208,101,107,元大-蘆洲,2024-08-05,9857
00715L,期街口布蘭特正2,105,5,100,元大-蘆洲,2024-08-05,9857
00686R,群益臺灣加權反1,100,0,100,元大-蘆洲,2024-08-05,9857
00795B,中信美國公債20年,99,0,99,元大-蘆洲,2024-08-05,9857
2330,台積電,186,93,93,元大-蘆洲,2024-08-05,9857
00933B,國泰10Y+金融債,136,45,91,元大-蘆洲,2024-08-05,9857
00918,大華優利高填息30,98,11,87,元大-蘆洲,2024-08-05,9857
00878,國泰永續高股息,793,707,86,元大-蘆洲,2024-08-05,9857
00905,FT臺灣Smart,93,20,73,元大-蘆洲,2024-08-05,9857
2002,中鋼,115,46,69,元大-蘆洲,2024-08-05,9857
00934,中信成長高股息,203,136,67,元大-蘆洲,2024-08-05,9857
00713,元大台灣高息低波,69,8,61,元大-蘆洲,2024-08-05,9857
00756B,群益投等新興公債,60,0,60,元大-蘆洲,2024-08-05,9857
2515,中工,63,4,59,元大-蘆洲,2024-08-05,9857
2501,國建,51,0,51,元大-蘆洲,2024-08-05,9857
4562,穎漢,142,94,48,元大-蘆洲,2024-08-05,9857
00900,富邦特選高股息30,77,29,48,元大-蘆洲,2024-08-05,9857
9105,泰金寶-DR,78,30,48,元大-蘆洲,2024-08-05,9857
3037,欣興,74,27,47,元大-蘆洲,2024-08-05,9857
0050,元大台灣50,55,10,45,元大-蘆洲,2024-08-05,9857
00907,永豐優息存股,64,20,44,元大-蘆洲,2024-08-05,9857
2344,華邦電,110,67,43,元大-蘆洲,2024-08-05,9857
6116,彩晶,66,24,42,元大-蘆洲,2024-08-05,9857
00679B,元大美債20年,313,272,41,元大-蘆洲,2024-08-05,9857
2867,三商壽,51,10,41,元大-蘆洲,2024-08-05,9857
00857B,永豐20年美公債,41,0,41,元大-蘆洲,2024-08-05,9857
00945B,凱基美國非投等債,40,0,40,元大-蘆洲,2024-08-05,9857
3006,晶豪科,40,1,39,元大-蘆洲,2024-08-05,9857
2851,中再保,41,2,39,元大-蘆洲,2024-08-05,9857
6770,力積電,51,12,39,元大-蘆洲,2024-08-05,9857
006208,富邦台50,58,20,38,元大-蘆洲,2024-08-05,9857
5512,力麒,43,7,36,元大-蘆洲,2024-08-05,9857
00881,國泰台灣5G+,83,47,36,元大-蘆洲,2024-08-05,9857
00940,元大台灣價值高息,1025,305,720,元大-蘆洲,2024-08-06,9857
2349,錸德,556,263,293,元大-蘆洲,2024-08-06,9857
00885,富邦越南,200,0,200,元大-蘆洲,2024-08-06,9857
00946,群益科技高息成長,177,5,172,元大-蘆洲,2024-08-06,9857
2515,中工,162,7,155,元大-蘆洲,2024-08-06,9857
00715L,期街口布蘭特正2,139,2,137,元大-蘆洲,2024-08-06,9857
3481,群創,255,141,114,元大-蘆洲,2024-08-06,9857
2409,友達,140,35,105,元大-蘆洲,2024-08-06,9857
00637L,元大滬深300正2,139,35,104,元大-蘆洲,2024-08-06,9857
2887,台新金,111,16,95,元大-蘆洲,2024-08-06,9857
00632R,元大台灣50反1,540,448,92,元大-蘆洲,2024-08-06,9857
4927,泰鼎-KY,92,0,92,元大-蘆洲,2024-08-06,9857
00878,國泰永續高股息,224,149,75,元大-蘆洲,2024-08-06,9857
0056,元大高股息,169,101,68,元大-蘆洲,2024-08-06,9857
3037,欣興,186,120,66,元大-蘆洲,2024-08-06,9857
2834,臺企銀,99,42,57,元大-蘆洲,2024-08-06,9857
00881,國泰台灣5G+,104,53,51,元大-蘆洲,2024-08-06,9857
00939,統一台灣高息動能,54,5,49,元大-蘆洲,2024-08-06,9857
00680L,元大美債20正2,372,324,48,元大-蘆洲,2024-08-06,9857
2317,鴻海,280,232,48,元大-蘆洲,2024-08-06,9857
6126,信音,64,16,48,元大-蘆洲,2024-08-06,9857
00631L,元大台灣50正2,76,33,43,元大-蘆洲,2024-08-06,9857
2365,昆盈,172,130,42,元大-蘆洲,2024-08-06,9857
1522,堤維西,43,3,40,元大-蘆洲,2024-08-06,9857
6443,元晶,49,9,40,元大-蘆洲,2024-08-06,9857
00933B,國泰10Y+金融債,42,3,39,元大-蘆洲,2024-08-06,9857
2542,興富發,62,26,36,元大-蘆洲,2024-08-06,9857
2489,瑞軒,71,37,34,元大-蘆洲,2024-08-06,9857
2609,陽明,206,173,33,元大-蘆洲,2024-08-06,9857
2888,新光金,87,54,33,元大-蘆洲,2024-08-06,9857
5388,中磊,35,4,31,元大-蘆洲,2024-08-06,9857
3356,奇偶,31,0,31,元大-蘆洲,2024-08-06,9857
3049,精金,30,0,30,元大-蘆洲,2024-08-06,9857
1611,中電,30,0,30,元大-蘆洲,2024-08-06,9857
5880,合庫金,30,1,29,元大-蘆洲,2024-08-06,9857
4526,東台,32,4,28,元大-蘆洲,2024-08-06,9857
3056,富華新,28,0,28,元大-蘆洲,2024-08-06,9857
2356,英業達,50,26,24,元大-蘆洲,2024-08-06,9857
0050,元大台灣50,60,36,24,元大-蘆洲,2024-08-06,9857
006208,富邦台50,40,18,22,元大-蘆洲,2024-08-06,9857
2367,燿華,40,19,21,元大-蘆洲,2024-08-06,9857
2520,冠德,35,14,21,元大-蘆洲,2024-08-06,9857
2882,國泰金,34,14,20,元大-蘆洲,2024-08-06,9857
3522,御嵿,20,0,20,元大-蘆洲,2024-08-06,9857
2601,益航,20,0,20,元大-蘆洲,2024-08-06,9857
4960,誠美材,60,40,20,元大-蘆洲,2024-08-06,9857
1815,富喬,39,20,19,元大-蘆洲,2024-08-06,9857
2301,光寶科,36,17,19,元大-蘆洲,2024-08-06,9857
1301,台塑,39,20,19,元大-蘆洲,2024-08-06,9857
6877,鏵友益,36,18,18,元大-蘆洲,2024-08-06,9857
00929,復華台灣科技優息,534,72,462,元大-蘆洲,2024-08-07,9857
00676R,富邦臺灣加權反1,314,0,314,元大-蘆洲,2024-08-07,9857
00940,元大台灣價值高息,463,175,288,元大-蘆洲,2024-08-07,9857
00878,國泰永續高股息,271,70,201,元大-蘆洲,2024-08-07,9857
1540,喬福,849,709,140,元大-蘆洲,2024-08-07,9857
3481,群創,182,51,131,元大-蘆洲,2024-08-07,9857
00664R,國泰臺灣加權反1,120,0,120,元大-蘆洲,2024-08-07,9857
3583,辛耘,127,19,108,元大-蘆洲,2024-08-07,9857
00679B,元大美債20年,173,82,91,元大-蘆洲,2024-08-07,9857
3489,森寶,79,0,79,元大-蘆洲,2024-08-07,9857
00687B,國泰20年美債,121,46,75,元大-蘆洲,2024-08-07,9857
2317,鴻海,170,107,63,元大-蘆洲,2024-08-07,9857
00936,台新永續高息中小,128,66,62,元大-蘆洲,2024-08-07,9857
00688L,國泰20年美債正2,68,7,61,元大-蘆洲,2024-08-07,9857
00942B,台新美A公司債20+,60,0,60,元大-蘆洲,2024-08-07,9857
00900,富邦特選高股息30,61,5,56,元大-蘆洲,2024-08-07,9857
2615,萬海,171,120,51,元大-蘆洲,2024-08-07,9857
00919,群益台灣精選高息,113,62,51,元大-蘆洲,2024-08-07,9857
00902,中信電池及儲能,50,0,50,元大-蘆洲,2024-08-07,9857
2542,興富發,68,18,50,元大-蘆洲,2024-08-07,9857
2887,台新金,69,19,50,元大-蘆洲,2024-08-07,9857
01010T,京城樂富R1,49,0,49,元大-蘆洲,2024-08-07,9857
2353,宏��,61,18,43,元大-蘆洲,2024-08-07,9857
2337,旺宏,51,8,43,元大-蘆洲,2024-08-07,9857
00946,群益科技高息成長,90,54,36,元大-蘆洲,2024-08-07,9857
3645,達邁,36,1,35,元大-蘆洲,2024-08-07,9857
1434,福懋,41,7,34,元大-蘆洲,2024-08-07,9857
2382,廣達,73,40,33,元大-蘆洲,2024-08-07,9857
6116,彩晶,36,5,31,元大-蘆洲,2024-08-07,9857
00939,統一台灣高息動能,31,0,31,元大-蘆洲,2024-08-07,9857
00922,國泰台灣領袖50,30,0,30,元大-蘆洲,2024-08-07,9857
9946,三發地產,30,0,30,元大-蘆洲,2024-08-07,9857
1802,台玻,30,1,29,元大-蘆洲,2024-08-07,9857
2610,華航,56,28,28,元大-蘆洲,2024-08-07,9857
2883,凱基金,53,26,27,元大-蘆洲,2024-08-07,9857
2834,臺企銀,53,27,26,元大-蘆洲,2024-08-07,9857
2312,金寶,41,15,26,元大-蘆洲,2024-08-07,9857
00632R,元大台灣50反1,222,197,25,元大-蘆洲,2024-08-07,9857
2357,華碩,27,2,25,元大-蘆洲,2024-08-07,9857
00881,國泰台灣5G+,34,10,24,元大-蘆洲,2024-08-07,9857
2408,南亞科,37,13,24,元大-蘆洲,2024-08-07,9857
00670L,富邦NASDAQ正2,22,0,22,元大-蘆洲,2024-08-07,9857
8105,凌巨,28,7,21,元大-蘆洲,2024-08-07,9857
6026,福邦證,20,0,20,元大-蘆洲,2024-08-07,9857
2886,兆豐金,35,15,20,元大-蘆洲,2024-08-07,9857
2392,正崴,19,0,19,元大-蘆洲,2024-08-07,9857
00948B,中信優息投資級債,20,1,19,元大-蘆洲,2024-08-07,9857
00751B,元大AAA至A公司債,25,7,18,元大-蘆洲,2024-08-07,9857
9911,櫻花,18,0,18,元大-蘆洲,2024-08-07,9857
3266,昇陽,18,0,18,元大-蘆洲,2024-08-07,9857
00929,復華台灣科技優息,537,58,479,元大-蘆洲,2024-08-08,9857
2349,錸德,342,86,256,元大-蘆洲,2024-08-08,9857
00632R,元大台灣50反1,324,83,241,元大-蘆洲,2024-08-08,9857
2886,兆豐金,168,1,167,元大-蘆洲,2024-08-08,9857
00940,元大台灣價值高息,263,100,163,元大-蘆洲,2024-08-08,9857
00878,國泰永續高股息,186,25,161,元大-蘆洲,2024-08-08,9857
00936,台新永續高息中小,138,18,120,元大-蘆洲,2024-08-08,9857
00937B,群益ESG投等債20,297,187,110,元大-蘆洲,2024-08-08,9857
2834,臺企銀,108,6,102,元大-蘆洲,2024-08-08,9857
00942B,台新美A公司債20+,84,0,84,元大-蘆洲,2024-08-08,9857
00919,群益台灣精選高息,103,21,82,元大-蘆洲,2024-08-08,9857
2609,陽明,90,19,71,元大-蘆洲,2024-08-08,9857
3047,訊舟,167,99,68,元大-蘆洲,2024-08-08,9857
3481,群創,87,26,61,元大-蘆洲,2024-08-08,9857
00946,群益科技高息成長,61,0,61,元大-蘆洲,2024-08-08,9857
2206,三陽工業,55,0,55,元大-蘆洲,2024-08-08,9857
00676R,富邦臺灣加權反1,50,0,50,元大-蘆洲,2024-08-08,9857
2312,金寶,110,61,49,元大-蘆洲,2024-08-08,9857
1714,和桐,49,0,49,元大-蘆洲,2024-08-08,9857
00881,國泰台灣5G+,53,6,47,元大-蘆洲,2024-08-08,9857
2610,華航,53,7,46,元大-蘆洲,2024-08-08,9857
2888,新光金,57,11,46,元大-蘆洲,2024-08-08,9857
00933B,國泰10Y+金融債,46,0,46,元大-蘆洲,2024-08-08,9857
2317,鴻海,141,97,44,元大-蘆洲,2024-08-08,9857
4510,高鋒,207,164,43,元大-蘆洲,2024-08-08,9857
00751B,元大AAA至A公司債,41,0,41,元大-蘆洲,2024-08-08,9857
0050,元大台灣50,52,12,40,元大-蘆洲,2024-08-08,9857
2365,昆盈,245,207,38,元大-蘆洲,2024-08-08,9857
1785,光洋科,37,4,33,元大-蘆洲,2024-08-08,9857
00948B,中信優息投資級債,33,0,33,元大-蘆洲,2024-08-08,9857
6244,茂迪,33,0,33,元大-蘆洲,2024-08-08,9857
2538,基泰,30,0,30,元大-蘆洲,2024-08-08,9857
8028,昇陽半導體,58,29,29,元大-蘆洲,2024-08-08,9857
1314,中石化,41,12,29,元大-蘆洲,2024-08-08,9857
2382,廣達,58,31,27,元大-蘆洲,2024-08-08,9857
2891,中信金,27,1,26,元大-蘆洲,2024-08-08,9857
6116,彩晶,27,1,26,元大-蘆洲,2024-08-08,9857
00932,兆豐永續高息等權,25,0,25,元大-蘆洲,2024-08-08,9857
1301,台塑,25,1,24,元大-蘆洲,2024-08-08,9857
6937,天虹,25,1,24,元大-蘆洲,2024-08-08,9857
2344,華邦電,27,4,23,元大-蘆洲,2024-08-08,9857
2356,英業達,44,21,23,元大-蘆洲,2024-08-08,9857
00923,群益台ESG低碳50,22,0,22,元大-蘆洲,2024-08-08,9857
2062,橋椿,20,0,20,元大-蘆洲,2024-08-08,9857
5356,協益,20,0,20,元大-蘆洲,2024-08-08,9857
4564,元翎,25,6,19,元大-蘆洲,2024-08-08,9857
3231,緯創,63,45,18,元大-蘆洲,2024-08-08,9857
00900,富邦特選高股息30,21,4,17,元大-蘆洲,2024-08-08,9857
3056,富華新,18,1,17,元大-蘆洲,2024-08-08,9857
00941,中信上游半導體,26,10,16,元大-蘆洲,2024-08-08,9857
00937B,群益ESG投等債20,516,0,516,元大-蘆洲,2024-08-09,9857
00632R,元大台灣50反1,463,163,300,元大-蘆洲,2024-08-09,9857
2349,錸德,479,182,297,元大-蘆洲,2024-08-09,9857
00679B,元大美債20年,224,12,212,元大-蘆洲,2024-08-09,9857
00676R,富邦臺灣加權反1,150,0,150,元大-蘆洲,2024-08-09,9857
2408,南亞科,123,6,117,元大-蘆洲,2024-08-09,9857
1218,泰山,89,0,89,元大-蘆洲,2024-08-09,9857
00687B,國泰20年美債,176,95,81,元大-蘆洲,2024-08-09,9857
00929,復華台灣科技優息,180,113,67,元大-蘆洲,2024-08-09,9857
00665L,富邦�琤肭磪囓�2,62,4,58,元大-蘆洲,2024-08-09,9857
00933B,國泰10Y+金融債,61,7,54,元大-蘆洲,2024-08-09,9857
2834,臺企銀,68,15,53,元大-蘆洲,2024-08-09,9857
2542,興富發,53,3,50,元大-蘆洲,2024-08-09,9857
00948B,中信優息投資級債,49,0,49,元大-蘆洲,2024-08-09,9857
6770,力積電,54,5,49,元大-蘆洲,2024-08-09,9857
00936,台新永續高息中小,81,33,48,元大-蘆洲,2024-08-09,9857
00688L,國泰20年美債正2,64,18,46,元大-蘆洲,2024-08-09,9857
5905,南仁湖,53,7,46,元大-蘆洲,2024-08-09,9857
00942B,台新美A公司債20+,46,8,38,元大-蘆洲,2024-08-09,9857
4909,新復興,127,93,34,元大-蘆洲,2024-08-09,9857
6152,百一,33,0,33,元大-蘆洲,2024-08-09,9857
00881,國泰台灣5G+,42,9,33,元大-蘆洲,2024-08-09,9857
2371,大同,41,9,32,元大-蘆洲,2024-08-09,9857
00795B,中信美國公債20年,32,0,32,元大-蘆洲,2024-08-09,9857
8354,冠好,30,0,30,元大-蘆洲,2024-08-09,9857
1522,堤維西,30,1,29,元大-蘆洲,2024-08-09,9857
00900,富邦特選高股息30,41,13,28,元大-蘆洲,2024-08-09,9857
2402,毅嘉,37,11,26,元大-蘆洲,2024-08-09,9857
4564,元翎,45,20,25,元大-蘆洲,2024-08-09,9857
6187,萬潤,34,9,25,元大-蘆洲,2024-08-09,9857
2353,宏��,43,19,24,元大-蘆洲,2024-08-09,9857
3047,訊舟,92,68,24,元大-蘆洲,2024-08-09,9857
3037,欣興,175,151,24,元大-蘆洲,2024-08-09,9857
2609,陽明,222,199,23,元大-蘆洲,2024-08-09,9857
00725B,國泰投資級公司債,28,5,23,元大-蘆洲,2024-08-09,9857
00949,復華日本龍頭,21,0,21,元大-蘆洲,2024-08-09,9857
00878,國泰永續高股息,154,133,21,元大-蘆洲,2024-08-09,9857
00830,國泰費城半導體,25,5,20,元大-蘆洲,2024-08-09,9857
00945B,凱基美國非投等債,23,3,20,元大-蘆洲,2024-08-09,9857
00858,永豐美國500大,20,0,20,元大-蘆洲,2024-08-09,9857
6603,富強鑫,52,34,18,元大-蘆洲,2024-08-09,9857
00926,凱基全球菁英55,20,2,18,元大-蘆洲,2024-08-09,9857
3583,辛耘,51,33,18,元大-蘆洲,2024-08-09,9857
3450,聯鈞,49,31,18,元大-蘆洲,2024-08-09,9857
00922,國泰台灣領袖50,20,3,17,元大-蘆洲,2024-08-09,9857
9906,欣巴巴,41,24,17,元大-蘆洲,2024-08-09,9857
3048,益登,39,22,17,元大-蘆洲,2024-08-09,9857
2537,聯上發,22,6,16,元大-蘆洲,2024-08-09,9857
2365,昆盈,311,295,16,元大-蘆洲,2024-08-09,9857
2636,台驊控股,15,0,15,元大-蘆洲,2024-08-09,9857
00632R,元大台灣50反1,349,11,338,元大-蘆洲,2024-08-12,9857
00688L,國泰20年美債正2,206,27,179,元大-蘆洲,2024-08-12,9857
2312,金寶,532,375,157,元大-蘆洲,2024-08-12,9857
00679B,元大美債20年,142,7,135,元大-蘆洲,2024-08-12,9857
00937B,群益ESG投等債20,143,29,114,元大-蘆洲,2024-08-12,9857
00878,國泰永續高股息,140,50,90,元大-蘆洲,2024-08-12,9857
6116,彩晶,102,22,80,元大-蘆洲,2024-08-12,9857
00900,富邦特選高股息30,83,4,79,元大-蘆洲,2024-08-12,9857
00687B,國泰20年美債,112,37,75,元大-蘆洲,2024-08-12,9857
00881,國泰台灣5G+,79,4,75,元大-蘆洲,2024-08-12,9857
00929,復華台灣科技優息,128,56,72,元大-蘆洲,2024-08-12,9857
00932,兆豐永續高息等權,74,7,67,元大-蘆洲,2024-08-12,9857
00902,中信電池及儲能,51,0,51,元大-蘆洲,2024-08-12,9857
00936,台新永續高息中小,90,41,49,元大-蘆洲,2024-08-12,9857
3481,群創,246,201,45,元大-蘆洲,2024-08-12,9857
2352,佳世達,48,4,44,元大-蘆洲,2024-08-12,9857
1218,泰山,40,0,40,元大-蘆洲,2024-08-12,9857
2881,富邦金,34,0,34,元大-蘆洲,2024-08-12,9857
1513,中興電,58,24,34,元大-蘆洲,2024-08-12,9857
2891,中信金,35,2,33,元大-蘆洲,2024-08-12,9857
00690,兆豐藍籌30,32,0,32,元大-蘆洲,2024-08-12,9857
00795B,中信美國公債20年,46,15,31,元大-蘆洲,2024-08-12,9857
2845,遠東銀,30,0,30,元大-蘆洲,2024-08-12,9857
0056,元大高股息,38,8,30,元大-蘆洲,2024-08-12,9857
4562,穎漢,175,148,27,元大-蘆洲,2024-08-12,9857
3518,柏騰,55,29,26,元大-蘆洲,2024-08-12,9857
2883,凱基金,77,51,26,元大-蘆洲,2024-08-12,9857
2402,毅嘉,32,8,24,元大-蘆洲,2024-08-12,9857
2880,華南金,24,0,24,元大-蘆洲,2024-08-12,9857
9906,欣巴巴,55,32,23,元大-蘆洲,2024-08-12,9857
2489,瑞軒,45,22,23,元大-蘆洲,2024-08-12,9857
5309,系統電,34,13,21,元大-蘆洲,2024-08-12,9857
00945B,凱基美國非投等債,24,3,21,元大-蘆洲,2024-08-12,9857
4306,炎洲,21,1,20,元大-蘆洲,2024-08-12,9857
00665L,富邦�琤肭磪囓�2,20,1,19,元大-蘆洲,2024-08-12,9857
6187,萬潤,29,10,19,元大-蘆洲,2024-08-12,9857
00676R,富邦臺灣加權反1,18,0,18,元大-蘆洲,2024-08-12,9857
6175,立敦,18,1,17,元大-蘆洲,2024-08-12,9857
2885,元大金,21,4,17,元大-蘆洲,2024-08-12,9857
4303,信立,21,5,16,元大-蘆洲,2024-08-12,9857
00725B,國泰投資級公司債,15,0,15,元大-蘆洲,2024-08-12,9857
3402,漢科,15,1,14,元大-蘆洲,2024-08-12,9857
6679,鈺太,14,0,14,元大-蘆洲,2024-08-12,9857
5905,南仁湖,14,0,14,元大-蘆洲,2024-08-12,9857
2317,鴻海,123,110,13,元大-蘆洲,2024-08-12,9857
1721,三晃,20,7,13,元大-蘆洲,2024-08-12,9857
3024,憶聲,17,4,13,元大-蘆洲,2024-08-12,9857
8076,伍豐,16,3,13,元大-蘆洲,2024-08-12,9857
2801,彰銀,13,0,13,元大-蘆洲,2024-08-12,9857
3535,晶彩科,21,8,13,元大-蘆洲,2024-08-12,9857
2880,華南金,1129,40,1089,元大-蘆洲,2024-08-13,9857
00676R,富邦臺灣加權反1,300,0,300,元大-蘆洲,2024-08-13,9857
00937B,群益ESG投等債20,232,2,230,元大-蘆洲,2024-08-13,9857
3481,群創,181,36,145,元大-蘆洲,2024-08-13,9857
2609,陽明,206,67,139,元大-蘆洲,2024-08-13,9857
00900,富邦特選高股息30,98,0,98,元大-蘆洲,2024-08-13,9857
2476,鉅祥,107,24,83,元大-蘆洲,2024-08-13,9857
2615,萬海,167,86,81,元大-蘆洲,2024-08-13,9857
00712,復華富時不動產,79,3,76,元大-蘆洲,2024-08-13,9857
00673R,期元大S＆P原油反1,62,0,62,元大-蘆洲,2024-08-13,9857
00688L,國泰20年美債正2,92,38,54,元大-蘆洲,2024-08-13,9857
00878,國泰永續高股息,107,60,47,元大-蘆洲,2024-08-13,9857
5880,合庫金,56,10,46,元大-蘆洲,2024-08-13,9857
00679B,元大美債20年,49,4,45,元大-蘆洲,2024-08-13,9857
1513,中興電,108,67,41,元大-蘆洲,2024-08-13,9857
3037,欣興,54,16,38,元大-蘆洲,2024-08-13,9857
1314,中石化,34,0,34,元大-蘆洲,2024-08-13,9857
2845,遠東銀,35,1,34,元大-蘆洲,2024-08-13,9857
00881,國泰台灣5G+,47,13,34,元大-蘆洲,2024-08-13,9857
2834,臺企銀,30,0,30,元大-蘆洲,2024-08-13,9857
2031,新光鋼,30,0,30,元大-蘆洲,2024-08-13,9857
2206,三陽工業,31,1,30,元大-蘆洲,2024-08-13,9857
00919,群益台灣精選高息,31,2,29,元大-蘆洲,2024-08-13,9857
00948B,中信優息投資級債,29,0,29,元大-蘆洲,2024-08-13,9857
2888,新光金,57,30,27,元大-蘆洲,2024-08-13,9857
3691,碩禾,26,0,26,元大-蘆洲,2024-08-13,9857
00687B,國泰20年美債,59,34,25,元大-蘆洲,2024-08-13,9857
2002,中鋼,27,2,25,元大-蘆洲,2024-08-13,9857
3047,訊舟,62,38,24,元大-蘆洲,2024-08-13,9857
00907,永豐優息存股,24,0,24,元大-蘆洲,2024-08-13,9857
2542,興富發,32,8,24,元大-蘆洲,2024-08-13,9857
4402,郡都開發,25,1,24,元大-蘆洲,2024-08-13,9857
5481,新華,31,7,24,元大-蘆洲,2024-08-13,9857
00713,元大台灣高息低波,22,0,22,元大-蘆洲,2024-08-13,9857
4960,誠美材,20,0,20,元大-蘆洲,2024-08-13,9857
00932,兆豐永續高息等權,20,0,20,元大-蘆洲,2024-08-13,9857
2382,廣達,40,20,20,元大-蘆洲,2024-08-13,9857
00632R,元大台灣50反1,94,75,19,元大-蘆洲,2024-08-13,9857
6505,台塑化,18,0,18,元大-蘆洲,2024-08-13,9857
8071,能率網通,42,24,18,元大-蘆洲,2024-08-13,9857
2520,冠德,101,83,18,元大-蘆洲,2024-08-13,9857
9914,美利達,20,4,16,元大-蘆洲,2024-08-13,9857
3663,鑫科,88,72,16,元大-蘆洲,2024-08-13,9857
2353,宏��,21,5,16,元大-蘆洲,2024-08-13,9857
1301,台塑,26,10,16,元大-蘆洲,2024-08-13,9857
00725B,國泰投資級公司債,15,0,15,元大-蘆洲,2024-08-13,9857
2439,美律,15,0,15,元大-蘆洲,2024-08-13,9857
2913,農林,15,0,15,元大-蘆洲,2024-08-13,9857
2419,仲琦,18,3,15,元大-蘆洲,2024-08-13,9857
3303,岱稜,26,11,15,元大-蘆洲,2024-08-13,9857
00632R,元大台灣50反1,780,8,772,元大-蘆洲,2024-08-14,9857
00881,國泰台灣5G+,139,16,123,元大-蘆洲,2024-08-14,9857
00687B,國泰20年美債,142,19,123,元大-蘆洲,2024-08-14,9857
1218,泰山,101,0,101,元大-蘆洲,2024-08-14,9857
4714,永捷,121,30,91,元大-蘆洲,2024-08-14,9857
2365,昆盈,370,279,91,元大-蘆洲,2024-08-14,9857
00679B,元大美債20年,92,5,87,元大-蘆洲,2024-08-14,9857
2352,佳世達,89,4,85,元大-蘆洲,2024-08-14,9857
00665L,富邦�琤肭磪囓�2,83,0,83,元大-蘆洲,2024-08-14,9857
8096,擎亞,201,118,83,元大-蘆洲,2024-08-14,9857
00934,中信成長高股息,81,0,81,元大-蘆洲,2024-08-14,9857
3489,森寶,82,2,80,元大-蘆洲,2024-08-14,9857
3481,群創,206,130,76,元大-蘆洲,2024-08-14,9857
00680L,元大美債20正2,90,25,65,元大-蘆洲,2024-08-14,9857
00937B,群益ESG投等債20,75,10,65,元大-蘆洲,2024-08-14,9857
00918,大華優利高填息30,64,0,64,元大-蘆洲,2024-08-14,9857
3231,緯創,94,41,53,元大-蘆洲,2024-08-14,9857
8028,昇陽半導體,69,21,48,元大-蘆洲,2024-08-14,9857
2882,國泰金,49,3,46,元大-蘆洲,2024-08-14,9857
00933B,國泰10Y+金融債,46,1,45,元大-蘆洲,2024-08-14,9857
3443,創意,50,6,44,元大-蘆洲,2024-08-14,9857
00929,復華台灣科技優息,109,66,43,元大-蘆洲,2024-08-14,9857
2888,新光金,99,56,43,元大-蘆洲,2024-08-14,9857
00795B,中信美國公債20年,46,5,41,元大-蘆洲,2024-08-14,9857
2356,英業達,60,25,35,元大-蘆洲,2024-08-14,9857
3689,湧德,32,0,32,元大-蘆洲,2024-08-14,9857
2845,遠東銀,28,0,28,元大-蘆洲,2024-08-14,9857
2601,益航,27,0,27,元大-蘆洲,2024-08-14,9857
2349,錸德,77,51,26,元大-蘆洲,2024-08-14,9857
00945B,凱基美國非投等債,31,5,26,元大-蘆洲,2024-08-14,9857
2489,瑞軒,47,22,25,元大-蘆洲,2024-08-14,9857
3230,錦明,26,1,25,元大-蘆洲,2024-08-14,9857
00948B,中信優息投資級債,24,0,24,元大-蘆洲,2024-08-14,9857
1101,台泥,47,23,24,元大-蘆洲,2024-08-14,9857
1536,和大,37,15,22,元大-蘆洲,2024-08-14,9857
3167,大量,35,13,22,元大-蘆洲,2024-08-14,9857
2801,彰銀,29,7,22,元大-蘆洲,2024-08-14,9857
8064,東捷,45,24,21,元大-蘆洲,2024-08-14,9857
00637L,元大滬深300正2,30,10,20,元大-蘆洲,2024-08-14,9857
1909,榮成,21,1,20,元大-蘆洲,2024-08-14,9857
2419,仲琦,24,4,20,元大-蘆洲,2024-08-14,9857
00878,國泰永續高股息,62,43,19,元大-蘆洲,2024-08-14,9857
4927,泰鼎-KY,20,1,19,元大-蘆洲,2024-08-14,9857
0050,元大台灣50,31,12,19,元大-蘆洲,2024-08-14,9857
6127,九豪,20,1,19,元大-蘆洲,2024-08-14,9857
3450,聯鈞,31,13,18,元大-蘆洲,2024-08-14,9857
2464,盟立,65,48,17,元大-蘆洲,2024-08-14,9857
1905,華紙,16,0,16,元大-蘆洲,2024-08-14,9857
2615,萬海,57,41,16,元大-蘆洲,2024-08-14,9857
5483,中美晶,16,0,16,元大-蘆洲,2024-08-14,9857
00687B,國泰20年美債,484,109,375,元大-蘆洲,2024-08-15,9857
00900,富邦特選高股息30,221,19,202,元大-蘆洲,2024-08-15,9857
00878,國泰永續高股息,235,40,195,元大-蘆洲,2024-08-15,9857
3376,新日興,212,22,190,元大-蘆洲,2024-08-15,9857
2615,萬海,241,92,149,元大-蘆洲,2024-08-15,9857
00929,復華台灣科技優息,231,94,137,元大-蘆洲,2024-08-15,9857
1785,光洋科,147,32,115,元大-蘆洲,2024-08-15,9857
3019,亞光,159,53,106,元大-蘆洲,2024-08-15,9857
00937B,群益ESG投等債20,125,20,105,元大-蘆洲,2024-08-15,9857
00948B,中信優息投資級債,100,0,100,元大-蘆洲,2024-08-15,9857
1314,中石化,105,10,95,元大-蘆洲,2024-08-15,9857
2542,興富發,112,35,77,元大-蘆洲,2024-08-15,9857
00679B,元大美債20年,110,33,77,元大-蘆洲,2024-08-15,9857
00881,國泰台灣5G+,89,25,64,元大-蘆洲,2024-08-15,9857
00795B,中信美國公債20年,59,1,58,元大-蘆洲,2024-08-15,9857
00632R,元大台灣50反1,59,5,54,元大-蘆洲,2024-08-15,9857
00676R,富邦臺灣加權反1,50,0,50,元大-蘆洲,2024-08-15,9857
6706,惠特,60,12,48,元大-蘆洲,2024-08-15,9857
3663,鑫科,114,72,42,元大-蘆洲,2024-08-15,9857
2801,彰銀,43,2,41,元大-蘆洲,2024-08-15,9857
2547,日勝生,40,0,40,元大-蘆洲,2024-08-15,9857
9105,泰金寶-DR,40,0,40,元大-蘆洲,2024-08-15,9857
2002,中鋼,45,7,38,元大-蘆洲,2024-08-15,9857
2886,兆豐金,38,0,38,元大-蘆洲,2024-08-15,9857
4564,元翎,37,0,37,元大-蘆洲,2024-08-15,9857
2317,鴻海,94,58,36,元大-蘆洲,2024-08-15,9857
2834,臺企銀,31,0,31,元大-蘆洲,2024-08-15,9857
2892,第一金,30,0,30,元大-蘆洲,2024-08-15,9857
5512,力麒,32,4,28,元大-蘆洲,2024-08-15,9857
9925,新保,28,1,27,元大-蘆洲,2024-08-15,9857
00731,復華富時高息低波,27,1,26,元大-蘆洲,2024-08-15,9857
3013,晟銘電,93,68,25,元大-蘆洲,2024-08-15,9857
2884,玉山金,27,5,22,元大-蘆洲,2024-08-15,9857
00932,兆豐永續高息等權,21,0,21,元大-蘆洲,2024-08-15,9857
4303,信立,21,0,21,元大-蘆洲,2024-08-15,9857
2489,瑞軒,105,84,21,元大-蘆洲,2024-08-15,9857
3266,昇陽,22,1,21,元大-蘆洲,2024-08-15,9857
6615,慧智,20,0,20,元大-蘆洲,2024-08-15,9857
4566,時碩工業,52,32,20,元大-蘆洲,2024-08-15,9857
2845,遠東銀,20,0,20,元大-蘆洲,2024-08-15,9857
5481,新華,27,7,20,元大-蘆洲,2024-08-15,9857
2355,敬鵬,20,2,18,元大-蘆洲,2024-08-15,9857
9935,慶豐富,22,4,18,元大-蘆洲,2024-08-15,9857
2883,凱基金,21,3,18,元大-蘆洲,2024-08-15,9857
1101,台泥,36,19,17,元大-蘆洲,2024-08-15,9857
00907,永豐優息存股,17,0,17,元大-蘆洲,2024-08-15,9857
5531,鄉林,20,3,17,元大-蘆洲,2024-08-15,9857
1301,台塑,22,5,17,元大-蘆洲,2024-08-15,9857
2352,佳世達,21,5,16,元大-蘆洲,2024-08-15,9857
1905,華紙,16,0,16,元大-蘆洲,2024-08-15,9857
00632R,元大台灣50反1,585,43,542,元大-蘆洲,2024-08-16,9857
00676R,富邦臺灣加權反1,270,0,270,元大-蘆洲,2024-08-16,9857
00687B,國泰20年美債,272,34,238,元大-蘆洲,2024-08-16,9857
00929,復華台灣科技優息,221,50,171,元大-蘆洲,2024-08-16,9857
00878,國泰永續高股息,172,52,120,元大-蘆洲,2024-08-16,9857
00937B,群益ESG投等債20,96,5,91,元大-蘆洲,2024-08-16,9857
4549,桓達,90,4,86,元大-蘆洲,2024-08-16,9857
00795B,中信美國公債20年,74,14,60,元大-蘆洲,2024-08-16,9857
00679B,元大美債20年,112,57,55,元大-蘆洲,2024-08-16,9857
00688L,國泰20年美債正2,74,22,52,元大-蘆洲,2024-08-16,9857
1611,中電,113,66,47,元大-蘆洲,2024-08-16,9857
00919,群益台灣精選高息,68,21,47,元大-蘆洲,2024-08-16,9857
00948B,中信優息投資級債,46,0,46,元大-蘆洲,2024-08-16,9857
4534,慶騰,46,1,45,元大-蘆洲,2024-08-16,9857
1513,中興電,86,42,44,元大-蘆洲,2024-08-16,9857
8096,擎亞,294,252,42,元大-蘆洲,2024-08-16,9857
2615,萬海,69,33,36,元大-蘆洲,2024-08-16,9857
2489,瑞軒,74,41,33,元大-蘆洲,2024-08-16,9857
1453,大將,31,0,31,元大-蘆洲,2024-08-16,9857
9935,慶豐富,32,3,29,元大-蘆洲,2024-08-16,9857
8147,正淩,30,1,29,元大-蘆洲,2024-08-16,9857
3005,神基,27,0,27,元大-蘆洲,2024-08-16,9857
00945B,凱基美國非投等債,27,0,27,元大-蘆洲,2024-08-16,9857
2891,中信金,32,6,26,元大-蘆洲,2024-08-16,9857
8076,伍豐,27,1,26,元大-蘆洲,2024-08-16,9857
2867,三商壽,28,5,23,元大-蘆洲,2024-08-16,9857
3231,緯創,39,17,22,元大-蘆洲,2024-08-16,9857
4526,東台,36,14,22,元大-蘆洲,2024-08-16,9857
3048,益登,33,12,21,元大-蘆洲,2024-08-16,9857
2845,遠東銀,21,0,21,元大-蘆洲,2024-08-16,9857
6877,鏵友益,26,6,20,元大-蘆洲,2024-08-16,9857
1515,力山,20,0,20,元大-蘆洲,2024-08-16,9857
3593,力銘,19,0,19,元大-蘆洲,2024-08-16,9857
00923,群益台ESG低碳50,25,6,19,元大-蘆洲,2024-08-16,9857
2002,中鋼,21,3,18,元大-蘆洲,2024-08-16,9857
2031,新光鋼,21,3,18,元大-蘆洲,2024-08-16,9857
2481,強茂,17,0,17,元大-蘆洲,2024-08-16,9857
00680L,元大美債20正2,52,36,16,元大-蘆洲,2024-08-16,9857
6180,橘子,16,0,16,元大-蘆洲,2024-08-16,9857
2618,長榮航,24,8,16,元大-蘆洲,2024-08-16,9857
2905,三商,15,0,15,元大-蘆洲,2024-08-16,9857
00719B,元大美債1-3,20,5,15,元大-蘆洲,2024-08-16,9857
2888,新光金,73,58,15,元大-蘆洲,2024-08-16,9857
00651R,復華香港反1,14,0,14,元大-蘆洲,2024-08-16,9857
2488,漢平,14,0,14,元大-蘆洲,2024-08-16,9857
5871,中租-KY,18,4,14,元大-蘆洲,2024-08-16,9857
2014,中鴻,13,0,13,元大-蘆洲,2024-08-16,9857
2406,國碩,12,0,12,元大-蘆洲,2024-08-16,9857
5608,四維航,12,0,12,元大-蘆洲,2024-08-16,9857
2603,長榮,32,20,12,元大-蘆洲,2024-08-16,9857
00687B,國泰20年美債,304,12,292,元大-蘆洲,2024-08-19,9857
00665L,富邦�琤肭磪囓�2,250,0,250,元大-蘆洲,2024-08-19,9857
00632R,元大台灣50反1,160,7,153,元大-蘆洲,2024-08-19,9857
00937B,群益ESG投等債20,119,2,117,元大-蘆洲,2024-08-19,9857
00676R,富邦臺灣加權反1,100,0,100,元大-蘆洲,2024-08-19,9857
00680L,元大美債20正2,99,10,89,元大-蘆洲,2024-08-19,9857
00945B,凱基美國非投等債,73,0,73,元大-蘆洲,2024-08-19,9857
2354,鴻準,77,17,60,元大-蘆洲,2024-08-19,9857
00878,國泰永續高股息,85,26,59,元大-蘆洲,2024-08-19,9857
8028,昇陽半導體,142,93,49,元大-蘆洲,2024-08-19,9857
2365,昆盈,171,124,47,元大-蘆洲,2024-08-19,9857
00907,永豐優息存股,43,0,43,元大-蘆洲,2024-08-19,9857
00688L,國泰20年美債正2,57,15,42,元大-蘆洲,2024-08-19,9857
00713,元大台灣高息低波,43,3,40,元大-蘆洲,2024-08-19,9857
3707,漢磊,62,21,41,元大-蘆洲,2024-08-19,9857
3025,星通,39,2,37,元大-蘆洲,2024-08-19,9857
4906,正文,62,27,35,元大-蘆洲,2024-08-19,9857
00651R,復華香港反1,35,0,35,元大-蘆洲,2024-08-19,9857
2002,中鋼,46,13,33,元大-蘆洲,2024-08-19,9857
8105,凌巨,57,24,33,元大-蘆洲,2024-08-19,9857
5488,松普,31,0,31,元大-蘆洲,2024-08-19,9857
00795B,中信美國公債20年,60,29,31,元大-蘆洲,2024-08-19,9857
3231,緯創,37,7,30,元大-蘆洲,2024-08-19,9857
00882,中信中國高股息,29,0,29,元大-蘆洲,2024-08-19,9857
00933B,國泰10Y+金融債,26,0,26,元大-蘆洲,2024-08-19,9857
2881,富邦金,28,2,26,元大-蘆洲,2024-08-19,9857
0056,元大高股息,62,39,23,元大-蘆洲,2024-08-19,9857
2312,金寶,35,12,23,元大-蘆洲,2024-08-19,9857
4566,時碩工業,36,13,23,元大-蘆洲,2024-08-19,9857
00948B,中信優息投資級債,21,0,21,元大-蘆洲,2024-08-19,9857
00936,台新永續高息中小,23,2,21,元大-蘆洲,2024-08-19,9857
00918,大華優利高填息30,21,1,20,元大-蘆洲,2024-08-19,9857
1536,和大,42,22,20,元大-蘆洲,2024-08-19,9857
5469,瀚宇博,20,0,20,元大-蘆洲,2024-08-19,9857
2845,遠東銀,20,1,19,元大-蘆洲,2024-08-19,9857
1609,大亞,23,5,18,元大-蘆洲,2024-08-19,9857
2537,聯上發,31,13,18,元大-蘆洲,2024-08-19,9857
9955,佳龍,29,11,18,元大-蘆洲,2024-08-19,9857
00942B,台新美A公司債20+,18,0,18,元大-蘆洲,2024-08-19,9857
2605,新興,16,0,16,元大-蘆洲,2024-08-19,9857
3673,TPK-KY,17,1,16,元大-蘆洲,2024-08-19,9857
00752,中信中國50,16,0,16,元大-蘆洲,2024-08-19,9857
9105,泰金寶-DR,21,6,15,元大-蘆洲,2024-08-19,9857
3037,欣興,25,10,15,元大-蘆洲,2024-08-19,9857
00900,富邦特選高股息30,20,6,14,元大-蘆洲,2024-08-19,9857
2464,盟立,97,84,13,元大-蘆洲,2024-08-19,9857
2405,輔信,44,31,13,元大-蘆洲,2024-08-19,9857
2886,兆豐金,13,1,12,元大-蘆洲,2024-08-19,9857
00857B,永豐20年美公債,12,0,12,元大-蘆洲,2024-08-19,9857
6122,擎邦,17,5,12,元大-蘆洲,2024-08-19,9857
00687B,國泰20年美債,259,1,258,元大-蘆洲,2024-08-20,9857
00680L,元大美債20正2,215,2,213,元大-蘆洲,2024-08-20,9857
2515,中工,169,31,138,元大-蘆洲,2024-08-20,9857
3707,漢磊,130,14,116,元大-蘆洲,2024-08-20,9857
00715L,期街口布蘭特正2,101,0,101,元大-蘆洲,2024-08-20,9857
2351,順德,93,14,79,元大-蘆洲,2024-08-20,9857
2542,興富發,92,24,68,元大-蘆洲,2024-08-20,9857
6244,茂迪,74,13,61,元大-蘆洲,2024-08-20,9857
2356,英業達,112,52,60,元大-蘆洲,2024-08-20,9857
2317,鴻海,106,48,58,元大-蘆洲,2024-08-20,9857
00679B,元大美債20年,65,8,57,元大-蘆洲,2024-08-20,9857
4979,華星光,69,17,52,元大-蘆洲,2024-08-20,9857
00929,復華台灣科技優息,110,58,52,元大-蘆洲,2024-08-20,9857
00676R,富邦臺灣加權反1,50,0,50,元大-蘆洲,2024-08-20,9857
3025,星通,49,0,49,元大-蘆洲,2024-08-20,9857
2406,國碩,47,3,44,元大-蘆洲,2024-08-20,9857
8049,晶采,41,0,41,元大-蘆洲,2024-08-20,9857
4564,元翎,41,0,41,元大-蘆洲,2024-08-20,9857
8028,昇陽半導體,131,91,40,元大-蘆洲,2024-08-20,9857
4303,信立,52,13,39,元大-蘆洲,2024-08-20,9857
2312,金寶,217,182,35,元大-蘆洲,2024-08-20,9857
2537,聯上發,39,5,34,元大-蘆洲,2024-08-20,9857
2867,三商壽,36,5,31,元大-蘆洲,2024-08-20,9857
2374,佳能,90,61,29,元大-蘆洲,2024-08-20,9857
00632R,元大台灣50反1,38,10,28,元大-蘆洲,2024-08-20,9857
2201,裕隆,28,0,28,元大-蘆洲,2024-08-20,9857
2417,圓剛,72,47,25,元大-蘆洲,2024-08-20,9857
00945B,凱基美國非投等債,25,0,25,元大-蘆洲,2024-08-20,9857
2520,冠德,54,30,24,元大-蘆洲,2024-08-20,9857
2330,台積電,27,4,23,元大-蘆洲,2024-08-20,9857
00918,大華優利高填息30,33,10,23,元大-蘆洲,2024-08-20,9857
3489,森寶,23,0,23,元大-蘆洲,2024-08-20,9857
6806,森崴能源,35,13,22,元大-蘆洲,2024-08-20,9857
5309,系統電,26,4,22,元大-蘆洲,2024-08-20,9857
4402,郡都開發,40,18,22,元大-蘆洲,2024-08-20,9857
8070,長華*,22,0,22,元大-蘆洲,2024-08-20,9857
00713,元大台灣高息低波,21,1,20,元大-蘆洲,2024-08-20,9857
2388,威盛,31,12,19,元大-蘆洲,2024-08-20,9857
1321,大洋,19,1,18,元大-蘆洲,2024-08-20,9857
2371,大同,26,8,18,元大-蘆洲,2024-08-20,9857
8150,南茂,27,9,18,元大-蘆洲,2024-08-20,9857
2419,仲琦,18,0,18,元大-蘆洲,2024-08-20,9857
00923,群益台ESG低碳50,18,0,18,元大-蘆洲,2024-08-20,9857
5512,力麒,17,0,17,元大-蘆洲,2024-08-20,9857
1442,名軒,18,2,16,元大-蘆洲,2024-08-20,9857
2328,廣宇,19,3,16,元大-蘆洲,2024-08-20,9857
6021,美好證,16,0,16,元大-蘆洲,2024-08-20,9857
1441,大東,15,0,15,元大-蘆洲,2024-08-20,9857
00905,FT臺灣Smart,16,1,15,元大-蘆洲,2024-08-20,9857
4960,誠美材,15,0,15,元大-蘆洲,2024-08-20,9857
00929,復華台灣科技優息,401,71,330,元大-蘆洲,2024-08-21,9857
2891,中信金,242,1,241,元大-蘆洲,2024-08-21,9857
00919,群益台灣精選高息,132,2,130,元大-蘆洲,2024-08-21,9857
00712,復華富時不動產,108,0,108,元大-蘆洲,2024-08-21,9857
2301,光寶科,101,4,97,元大-蘆洲,2024-08-21,9857
4906,正文,133,41,92,元大-蘆洲,2024-08-21,9857
1514,亞力,134,43,91,元大-蘆洲,2024-08-21,9857
00953B,群益優選非投等債,75,0,75,元大-蘆洲,2024-08-21,9857
2542,興富發,80,5,75,元大-蘆洲,2024-08-21,9857
2405,輔信,75,5,70,元大-蘆洲,2024-08-21,9857
3037,欣興,100,33,67,元大-蘆洲,2024-08-21,9857
2317,鴻海,86,20,66,元大-蘆洲,2024-08-21,9857
00713,元大台灣高息低波,72,12,60,元大-蘆洲,2024-08-21,9857
2312,金寶,212,155,57,元大-蘆洲,2024-08-21,9857
5876,上海商銀,50,0,50,元大-蘆洲,2024-08-21,9857
00676R,富邦臺灣加權反1,50,0,50,元大-蘆洲,2024-08-21,9857
9938,百和,50,0,50,元大-蘆洲,2024-08-21,9857
00687B,國泰20年美債,65,16,49,元大-蘆洲,2024-08-21,9857
1218,泰山,51,2,49,元大-蘆洲,2024-08-21,9857
3686,達能,51,2,49,元大-蘆洲,2024-08-21,9857
00637L,元大滬深300正2,90,50,40,元大-蘆洲,2024-08-21,9857
5905,南仁湖,95,55,40,元大-蘆洲,2024-08-21,9857
4555,氣立,78,40,38,元大-蘆洲,2024-08-21,9857
2323,中環,50,16,34,元大-蘆洲,2024-08-21,9857
2537,聯上發,34,3,31,元大-蘆洲,2024-08-21,9857
4960,誠美材,30,0,30,元大-蘆洲,2024-08-21,9857
00923,群益台ESG低碳50,29,0,29,元大-蘆洲,2024-08-21,9857
00915,凱基優選高股息30,29,0,29,元大-蘆洲,2024-08-21,9857
00715L,期街口布蘭特正2,29,0,29,元大-蘆洲,2024-08-21,9857
2344,華邦電,35,6,29,元大-蘆洲,2024-08-21,9857
00945B,凱基美國非投等債,28,0,28,元大-蘆洲,2024-08-21,9857
1711,永光,37,10,27,元大-蘆洲,2024-08-21,9857
2365,昆盈,64,37,27,元大-蘆洲,2024-08-21,9857
2615,萬海,57,31,26,元大-蘆洲,2024-08-21,9857
1409,新纖,32,6,26,元大-蘆洲,2024-08-21,9857
00878,國泰永續高股息,112,87,25,元大-蘆洲,2024-08-21,9857
0056,元大高股息,38,12,26,元大-蘆洲,2024-08-21,9857
00881,國泰台灣5G+,26,1,25,元大-蘆洲,2024-08-21,9857
6603,富強鑫,24,0,24,元大-蘆洲,2024-08-21,9857
00918,大華優利高填息30,24,0,24,元大-蘆洲,2024-08-21,9857
6117,迎廣,34,11,23,元大-蘆洲,2024-08-21,9857
3016,嘉晶,22,0,22,元大-蘆洲,2024-08-21,9857
3518,柏騰,42,21,21,元大-蘆洲,2024-08-21,9857
2617,台航,21,0,21,元大-蘆洲,2024-08-21,9857
2888A,新光金甲特,20,0,20,元大-蘆洲,2024-08-21,9857
1737,臺鹽,20,0,20,元大-蘆洲,2024-08-21,9857
2601,益航,20,0,20,元大-蘆洲,2024-08-21,9857
2356,英業達,64,46,18,元大-蘆洲,2024-08-21,9857
2486,一詮,23,5,18,元大-蘆洲,2024-08-21,9857
2609,陽明,88,71,17,元大-蘆洲,2024-08-21,9857
00680L,元大美債20正2,304,40,264,元大-蘆洲,2024-08-22,9857
8070,長華*,260,30,230,元大-蘆洲,2024-08-22,9857
00688L,國泰20年美債正2,195,0,195,元大-蘆洲,2024-08-22,9857
00665L,富邦�琤肭磪囓�2,100,2,98,元大-蘆洲,2024-08-22,9857
2363,矽統,109,25,84,元大-蘆洲,2024-08-22,9857
3019,亞光,115,34,81,元大-蘆洲,2024-08-22,9857
2890,永豐金,75,0,75,元大-蘆洲,2024-08-22,9857
2317,鴻海,111,40,71,元大-蘆洲,2024-08-22,9857
00715L,期街口布蘭特正2,70,0,70,元大-蘆洲,2024-08-22,9857
2891,中信金,74,8,66,元大-蘆洲,2024-08-22,9857
3047,訊舟,217,164,53,元大-蘆洲,2024-08-22,9857
00687B,國泰20年美債,60,9,51,元大-蘆洲,2024-08-22,9857
00919,群益台灣精選高息,51,0,51,元大-蘆洲,2024-08-22,9857
2542,興富發,56,6,50,元大-蘆洲,2024-08-22,9857
3489,森寶,50,0,50,元大-蘆洲,2024-08-22,9857
00676R,富邦臺灣加權反1,50,0,50,元大-蘆洲,2024-08-22,9857
00929,復華台灣科技優息,119,72,47,元大-蘆洲,2024-08-22,9857
1321,大洋,46,0,46,元大-蘆洲,2024-08-22,9857
2537,聯上發,50,5,45,元大-蘆洲,2024-08-22,9857
2349,錸德,1159,1115,44,元大-蘆洲,2024-08-22,9857
4707,磐亞,38,1,37,元大-蘆洲,2024-08-22,9857
9945,潤泰新,40,5,35,元大-蘆洲,2024-08-22,9857
1710,東聯,34,0,34,元大-蘆洲,2024-08-22,9857
00878,國泰永續高股息,46,13,33,元大-蘆洲,2024-08-22,9857
00936,台新永續高息中小,31,0,31,元大-蘆洲,2024-08-22,9857
3231,緯創,39,7,32,元大-蘆洲,2024-08-22,9857
2505,國揚,30,0,30,元大-蘆洲,2024-08-22,9857
1456,怡華,37,7,30,元大-蘆洲,2024-08-22,9857
4556,旭然,30,0,30,元大-蘆洲,2024-08-22,9857
00650L,復華香港正2,129,100,29,元大-蘆洲,2024-08-22,9857
6443,元晶,31,3,28,元大-蘆洲,2024-08-22,9857
5309,系統電,85,58,27,元大-蘆洲,2024-08-22,9857
3163,波若威,68,41,27,元大-蘆洲,2024-08-22,9857
2834,臺企銀,27,0,27,元大-蘆洲,2024-08-22,9857
8105,凌巨,32,5,27,元大-蘆洲,2024-08-22,9857
2027,大成鋼,31,5,26,元大-蘆洲,2024-08-22,9857
00795B,中信美國公債20年,25,0,25,元大-蘆洲,2024-08-22,9857
6156,松上,29,4,25,元大-蘆洲,2024-08-22,9857
00934,中信成長高股息,29,5,24,元大-蘆洲,2024-08-22,9857
2883,凱基金,33,12,21,元大-蘆洲,2024-08-22,9857
3006,晶豪科,21,0,21,元大-蘆洲,2024-08-22,9857
1522,堤維西,21,1,20,元大-蘆洲,2024-08-22,9857
2352,佳世達,20,0,20,元大-蘆洲,2024-08-22,9857
5498,凱崴,20,0,20,元大-蘆洲,2024-08-22,9857
4523,永彰,20,0,20,元大-蘆洲,2024-08-22,9857
2501,國建,21,1,20,元大-蘆洲,2024-08-22,9857
00713,元大台灣高息低波,22,3,19,元大-蘆洲,2024-08-22,9857
8021,尖點,25,7,18,元大-蘆洲,2024-08-22,9857
1785,光洋科,37,19,18,元大-蘆洲,2024-08-22,9857
8150,南茂,27,10,17,元大-蘆洲,2024-08-22,9857
00680L,元大美債20正2,291,38,253,元大-蘆洲,2024-08-23,9857
00632R,元大台灣50反1,544,317,227,元大-蘆洲,2024-08-23,9857
00676R,富邦臺灣加權反1,200,0,200,元大-蘆洲,2024-08-23,9857
00687B,國泰20年美債,142,7,135,元大-蘆洲,2024-08-23,9857
2349,錸德,662,545,117,元大-蘆洲,2024-08-23,9857
2515,中工,115,10,105,元大-蘆洲,2024-08-23,9857
2891,中信金,132,41,91,元大-蘆洲,2024-08-23,9857
1314,中石化,163,88,75,元大-蘆洲,2024-08-23,9857
00688L,國泰20年美債正2,74,2,72,元大-蘆洲,2024-08-23,9857
00878,國泰永續高股息,89,18,71,元大-蘆洲,2024-08-23,9857
00919,群益台灣精選高息,84,19,65,元大-蘆洲,2024-08-23,9857
1711,永光,172,116,56,元大-蘆洲,2024-08-23,9857
00650L,復華香港正2,50,0,50,元大-蘆洲,2024-08-23,9857
1708,東鹼,69,23,46,元大-蘆洲,2024-08-23,9857
00929,復華台灣科技優息,101,61,40,元大-蘆洲,2024-08-23,9857
00679B,元大美債20年,39,1,38,元大-蘆洲,2024-08-23,9857
8064,東捷,281,249,32,元大-蘆洲,2024-08-23,9857
2501,國建,32,1,31,元大-蘆洲,2024-08-23,9857
2317,鴻海,53,27,26,元大-蘆洲,2024-08-23,9857
00651R,復華香港反1,25,0,25,元大-蘆洲,2024-08-23,9857
00795B,中信美國公債20年,24,0,24,元大-蘆洲,2024-08-23,9857
00772B,中信高評級公司債,22,0,22,元大-蘆洲,2024-08-23,9857
2887,台新金,202,181,21,元大-蘆洲,2024-08-23,9857
2611,志信,20,0,20,元大-蘆洲,2024-08-23,9857
3189,景碩,49,29,20,元大-蘆洲,2024-08-23,9857
00864B,中信美國公債0-1,20,0,20,元大-蘆洲,2024-08-23,9857
4523,永彰,20,0,20,元大-蘆洲,2024-08-23,9857
2505,國揚,20,0,20,元大-蘆洲,2024-08-23,9857
6285,啟��,21,2,19,元大-蘆洲,2024-08-23,9857
2607,榮運,18,0,18,元大-蘆洲,2024-08-23,9857
00936,台新永續高息中小,18,0,18,元大-蘆洲,2024-08-23,9857
2885,元大金,17,0,17,元大-蘆洲,2024-08-23,9857
2867,三商壽,22,5,17,元大-蘆洲,2024-08-23,9857
6177,達麗,19,3,16,元大-蘆洲,2024-08-23,9857
2890,永豐金,17,1,16,元大-蘆洲,2024-08-23,9857
4513,福裕,69,54,15,元大-蘆洲,2024-08-23,9857
2362,藍天,20,6,14,元大-蘆洲,2024-08-23,9857
2429,銘旺科,14,0,14,元大-蘆洲,2024-08-23,9857
6156,松上,20,7,13,元大-蘆洲,2024-08-23,9857
5439,高技,13,0,13,元大-蘆洲,2024-08-23,9857
6218,豪勉,13,0,13,元大-蘆洲,2024-08-23,9857
8374,羅昇,59,46,13,元大-蘆洲,2024-08-23,9857
2489,瑞軒,31,19,12,元大-蘆洲,2024-08-23,9857
2330,台積電,25,13,12,元大-蘆洲,2024-08-23,9857
2464,盟立,34,22,12,元大-蘆洲,2024-08-23,9857
2014,中鴻,12,0,12,元大-蘆洲,2024-08-23,9857
2851,中再保,12,0,12,元大-蘆洲,2024-08-23,9857
2537,聯上發,44,33,11,元大-蘆洲,2024-08-23,9857
9105,泰金寶-DR,11,0,11,元大-蘆洲,2024-08-23,9857
2101,南港,11,0,11,元大-蘆洲,2024-08-23,9857
2409,友達,340,167,173,元大-蘆洲,2024-08-26,9857
2467,志聖,150,15,135,元大-蘆洲,2024-08-26,9857
00687B,國泰20年美債,97,2,95,元大-蘆洲,2024-08-26,9857
00632R,元大台灣50反1,90,5,85,元大-蘆洲,2024-08-26,9857
00680L,元大美債20正2,118,35,83,元大-蘆洲,2024-08-26,9857
8070,長華*,176,98,78,元大-蘆洲,2024-08-26,9857
3189,景碩,81,10,71,元大-蘆洲,2024-08-26,9857
2891,中信金,93,22,71,元大-蘆洲,2024-08-26,9857
00637L,元大滬深300正2,81,11,70,元大-蘆洲,2024-08-26,9857
8028,昇陽半導體,188,128,60,元大-蘆洲,2024-08-26,9857
00945B,凱基美國非投等債,68,10,58,元大-蘆洲,2024-08-26,9857
00688L,國泰20年美債正2,65,15,50,元大-蘆洲,2024-08-26,9857
2331,精英,47,2,45,元大-蘆洲,2024-08-26,9857
2867,三商壽,51,9,42,元大-蘆洲,2024-08-26,9857
00919,群益台灣精選高息,44,11,33,元大-蘆洲,2024-08-26,9857
2012,春雨,33,0,33,元大-蘆洲,2024-08-26,9857
1316,上曜,38,6,32,元大-蘆洲,2024-08-26,9857
1454,台富,47,15,32,元大-蘆洲,2024-08-26,9857
3047,訊舟,96,66,30,元大-蘆洲,2024-08-26,9857
2002,中鋼,41,12,29,元大-蘆洲,2024-08-26,9857
1611,中電,29,0,29,元大-蘆洲,2024-08-26,9857
3339,泰谷,28,0,28,元大-蘆洲,2024-08-26,9857
3711,日月光投控,36,10,26,元大-蘆洲,2024-08-26,9857
4564,元翎,32,7,25,元大-蘆洲,2024-08-26,9857
00679B,元大美債20年,30,5,25,元大-蘆洲,2024-08-26,9857
3673,TPK-KY,38,14,24,元大-蘆洲,2024-08-26,9857
2542,興富發,22,0,22,元大-蘆洲,2024-08-26,9857
6177,達麗,24,3,21,元大-蘆洲,2024-08-26,9857
00937B,群益ESG投等債20,27,6,21,元大-蘆洲,2024-08-26,9857
2615,萬海,103,84,19,元大-蘆洲,2024-08-26,9857
00918,大華優利高填息30,20,2,18,元大-蘆洲,2024-08-26,9857
00932,兆豐永續高息等權,17,0,17,元大-蘆洲,2024-08-26,9857
2101,南港,20,3,17,元大-蘆洲,2024-08-26,9857
2417,圓剛,43,27,16,元大-蘆洲,2024-08-26,9857
3390,旭軟,19,3,16,元大-蘆洲,2024-08-26,9857
6274,台燿,20,5,15,元大-蘆洲,2024-08-26,9857
00752,中信中國50,15,0,15,元大-蘆洲,2024-08-26,9857
1108,幸福,15,0,15,元大-蘆洲,2024-08-26,9857
8021,尖點,29,14,15,元大-蘆洲,2024-08-26,9857
3556,禾瑞亞,15,0,15,元大-蘆洲,2024-08-26,9857
5512,力麒,15,0,15,元大-蘆洲,2024-08-26,9857
2610,華航,24,10,14,元大-蘆洲,2024-08-26,9857
5263,智崴,13,0,13,元大-蘆洲,2024-08-26,9857
3013,晟銘電,18,5,13,元大-蘆洲,2024-08-26,9857
00953B,群益優選非投等債,13,0,13,元大-蘆洲,2024-08-26,9857
3033,威健,13,1,12,元大-蘆洲,2024-08-26,9857
1524,耿鼎,12,0,12,元大-蘆洲,2024-08-26,9857
2344,華邦電,29,17,12,元大-蘆洲,2024-08-26,9857
00881,國泰台灣5G+,12,0,12,元大-蘆洲,2024-08-26,9857
5452,佶優,32,21,11,元大-蘆洲,2024-08-26,9857
00680L,元大美債20正2,481,1,480,元大-蘆洲,2024-08-27,9857
3481,群創,579,427,152,元大-蘆洲,2024-08-27,9857
2891,中信金,147,2,145,元大-蘆洲,2024-08-27,9857
3707,漢磊,138,39,99,元大-蘆洲,2024-08-27,9857
2880,華南金,95,0,95,元大-蘆洲,2024-08-27,9857
00679B,元大美債20年,93,3,90,元大-蘆洲,2024-08-27,9857
00929,復華台灣科技優息,97,24,73,元大-蘆洲,2024-08-27,9857
00687B,國泰20年美債,72,0,72,元大-蘆洲,2024-08-27,9857
00945B,凱基美國非投等債,60,0,60,元大-蘆洲,2024-08-27,9857
8064,東捷,147,89,58,元大-蘆洲,2024-08-27,9857
2609,陽明,75,19,56,元大-蘆洲,2024-08-27,9857
2603,長榮,62,9,53,元大-蘆洲,2024-08-27,9857
2303,聯電,60,9,51,元大-蘆洲,2024-08-27,9857
4906,正文,67,19,48,元大-蘆洲,2024-08-27,9857
00878,國泰永續高股息,71,25,46,元大-蘆洲,2024-08-27,9857
3033,威健,47,6,41,元大-蘆洲,2024-08-27,9857
2882,國泰金,47,6,41,元大-蘆洲,2024-08-27,9857
2208,台船,41,1,40,元大-蘆洲,2024-08-27,9857
2409,友達,41,2,39,元大-蘆洲,2024-08-27,9857
4967,十銓,72,34,38,元大-蘆洲,2024-08-27,9857
2399,映泰,145,109,36,元大-蘆洲,2024-08-27,9857
2610,華航,35,0,35,元大-蘆洲,2024-08-27,9857
00688L,國泰20年美債正2,35,0,35,元大-蘆洲,2024-08-27,9857
1711,永光,107,72,35,元大-蘆洲,2024-08-27,9857
00919,群益台灣精選高息,37,4,33,元大-蘆洲,2024-08-27,9857
1708,東鹼,39,7,32,元大-蘆洲,2024-08-27,9857
2537,聯上發,32,2,30,元大-蘆洲,2024-08-27,9857
4960,誠美材,30,0,30,元大-蘆洲,2024-08-27,9857
2851,中再保,28,0,28,元大-蘆洲,2024-08-27,9857
3037,欣興,53,26,27,元大-蘆洲,2024-08-27,9857
1409,新纖,24,0,24,元大-蘆洲,2024-08-27,9857
00948B,中信優息投資級債,24,0,24,元大-蘆洲,2024-08-27,9857
2352,佳世達,26,3,23,元大-蘆洲,2024-08-27,9857
2406,國碩,22,0,22,元大-蘆洲,2024-08-27,9857
1905,華紙,21,0,21,元大-蘆洲,2024-08-27,9857
2883,凱基金,93,73,20,元大-蘆洲,2024-08-27,9857
6116,彩晶,20,0,20,元大-蘆洲,2024-08-27,9857
5234,達興材料,27,7,20,元大-蘆洲,2024-08-27,9857
00918,大華優利高填息30,19,0,19,元大-蘆洲,2024-08-27,9857
2542,興富發,19,0,19,元大-蘆洲,2024-08-27,9857
5328,華容,21,2,19,元大-蘆洲,2024-08-27,9857
2492,華新科,19,0,19,元大-蘆洲,2024-08-27,9857
3149,正達,56,39,17,元大-蘆洲,2024-08-27,9857
0056,元大高股息,26,9,17,元大-蘆洲,2024-08-27,9857
6706,惠特,23,6,17,元大-蘆洲,2024-08-27,9857
2705,六福,15,0,15,元大-蘆洲,2024-08-27,9857
2349,錸德,91,76,15,元大-蘆洲,2024-08-27,9857
2887,台新金,30,15,15,元大-蘆洲,2024-08-27,9857
2867,三商壽,14,0,14,元大-蘆洲,2024-08-27,9857
00931B,統一美債20年,13,0,13,元大-蘆洲,2024-08-27,9857
00680L,元大美債20正2,222,0,222,元大-蘆洲,2024-08-28,9857
2314,台揚,150,12,138,元大-蘆洲,2024-08-28,9857
00945B,凱基美國非投等債,120,0,120,元大-蘆洲,2024-08-28,9857
6788,華景電,101,0,101,元大-蘆洲,2024-08-28,9857
00715L,期街口布蘭特正2,95,10,85,元大-蘆洲,2024-08-28,9857
3059,華晶科,71,6,65,元大-蘆洲,2024-08-28,9857
3622,洋華,60,0,60,元大-蘆洲,2024-08-28,9857
2891,中信金,67,8,59,元大-蘆洲,2024-08-28,9857
00650L,復華香港正2,50,0,50,元大-蘆洲,2024-08-28,9857
6451,訊芯-KY,54,6,48,元大-蘆洲,2024-08-28,9857
2543,皇昌,122,76,46,元大-蘆洲,2024-08-28,9857
00637L,元大滬深300正2,85,42,43,元大-蘆洲,2024-08-28,9857
5443,均豪,170,134,36,元大-蘆洲,2024-08-28,9857
8374,羅昇,61,26,35,元大-蘆洲,2024-08-28,9857
3062,建漢,80,47,33,元大-蘆洲,2024-08-28,9857
8070,長華*,42,9,33,元大-蘆洲,2024-08-28,9857
1597,直得,51,19,32,元大-蘆洲,2024-08-28,9857
00939,統一台灣高息動能,32,0,32,元大-蘆洲,2024-08-28,9857
2615,萬海,75,45,30,元大-蘆洲,2024-08-28,9857
3031,佰鴻,30,0,30,元大-蘆洲,2024-08-28,9857
00688L,國泰20年美債正2,30,0,30,元大-蘆洲,2024-08-28,9857
8927,北基,30,2,28,元大-蘆洲,2024-08-28,9857
1314,中石化,28,0,28,元大-蘆洲,2024-08-28,9857
2349,錸德,58,31,27,元大-蘆洲,2024-08-28,9857
3481,群創,387,361,26,元大-蘆洲,2024-08-28,9857
6443,元晶,27,2,25,元大-蘆洲,2024-08-28,9857
4142,國光生,25,0,25,元大-蘆洲,2024-08-28,9857
2367,燿華,81,57,24,元大-蘆洲,2024-08-28,9857
3522,御嵿,26,2,24,元大-蘆洲,2024-08-28,9857
4564,元翎,33,10,23,元大-蘆洲,2024-08-28,9857
2243,宏旭-KY,24,1,23,元大-蘆洲,2024-08-28,9857
00679B,元大美債20年,31,9,22,元大-蘆洲,2024-08-28,9857
2609,陽明,24,2,22,元大-蘆洲,2024-08-28,9857
2317,鴻海,78,56,22,元大-蘆洲,2024-08-28,9857
3580,友威科,39,18,21,元大-蘆洲,2024-08-28,9857
00687B,國泰20年美債,37,16,21,元大-蘆洲,2024-08-28,9857
3498,陽程,28,8,20,元大-蘆洲,2024-08-28,9857
00739,元大MSCI A股,20,0,20,元大-蘆洲,2024-08-28,9857
00959B,大華投等美債15Y+,20,0,20,元大-蘆洲,2024-08-28,9857
2489,瑞軒,26,6,20,元大-蘆洲,2024-08-28,9857
8039,台虹,102,83,19,元大-蘆洲,2024-08-28,9857
00919,群益台灣精選高息,34,15,19,元大-蘆洲,2024-08-28,9857
6215,和椿,22,4,18,元大-蘆洲,2024-08-28,9857
3576,聯合再生,20,2,18,元大-蘆洲,2024-08-28,9857
5512,力麒,17,0,17,元大-蘆洲,2024-08-28,9857
6167,久正,20,4,16,元大-蘆洲,2024-08-28,9857
1802,台玻,16,0,16,元大-蘆洲,2024-08-28,9857
9912,偉聯,16,0,16,元大-蘆洲,2024-08-28,9857
3037,欣興,75,60,15,元大-蘆洲,2024-08-28,9857
1711,永光,76,61,15,元大-蘆洲,2024-08-28,9857
00882,中信中國高股息,495,0,495,元大-蘆洲,2024-08-29,9857
2314,台揚,292,14,278,元大-蘆洲,2024-08-29,9857
00632R,元大台灣50反1,290,20,270,元大-蘆洲,2024-08-29,9857
00945B,凱基美國非投等債,178,0,178,元大-蘆洲,2024-08-29,9857
00687B,國泰20年美債,153,10,143,元大-蘆洲,2024-08-29,9857
00680L,元大美債20正2,138,0,138,元大-蘆洲,2024-08-29,9857
3019,亞光,191,68,123,元大-蘆洲,2024-08-29,9857
3481,群創,157,40,117,元大-蘆洲,2024-08-29,9857
2891,中信金,87,1,86,元大-蘆洲,2024-08-29,9857
00900,富邦特選高股息30,83,0,83,元大-蘆洲,2024-08-29,9857
00942B,台新美A公司債20+,82,0,82,元大-蘆洲,2024-08-29,9857
3374,精材,93,14,79,元大-蘆洲,2024-08-29,9857
00937B,群益ESG投等債20,162,89,73,元大-蘆洲,2024-08-29,9857
2301,光寶科,75,9,66,元大-蘆洲,2024-08-29,9857
00915,凱基優選高股息30,56,0,56,元大-蘆洲,2024-08-29,9857
00679B,元大美債20年,77,23,54,元大-蘆洲,2024-08-29,9857
4906,正文,75,26,49,元大-蘆洲,2024-08-29,9857
3550,聯穎,258,210,48,元大-蘆洲,2024-08-29,9857
2303,聯電,68,31,37,元大-蘆洲,2024-08-29,9857
2330,台積電,41,4,37,元大-蘆洲,2024-08-29,9857
1540,喬福,168,131,37,元大-蘆洲,2024-08-29,9857
5443,均豪,296,259,37,元大-蘆洲,2024-08-29,9857
1714,和桐,36,0,36,元大-蘆洲,2024-08-29,9857
3231,緯創,64,30,34,元大-蘆洲,2024-08-29,9857
1718,中纖,30,0,30,元大-蘆洲,2024-08-29,9857
1531,高林股,28,0,28,元大-蘆洲,2024-08-29,9857
2425,承啟,189,162,27,元大-蘆洲,2024-08-29,9857
3715,定穎投控,38,14,24,元大-蘆洲,2024-08-29,9857
1609,大亞,35,11,24,元大-蘆洲,2024-08-29,9857
00715L,期街口布蘭特正2,25,1,24,元大-蘆洲,2024-08-29,9857
1727,中華化,70,47,23,元大-蘆洲,2024-08-29,9857
00881,國泰台灣5G+,24,1,23,元大-蘆洲,2024-08-29,9857
6531,愛普*,27,4,23,元大-蘆洲,2024-08-29,9857
3017,奇鋐,25,2,23,元大-蘆洲,2024-08-29,9857
4534,慶騰,22,0,22,元大-蘆洲,2024-08-29,9857
8096,擎亞,34,12,22,元大-蘆洲,2024-08-29,9857
2834,臺企銀,20,0,20,元大-蘆洲,2024-08-29,9857
00637L,元大滬深300正2,80,60,20,元大-蘆洲,2024-08-29,9857
2867,三商壽,50,30,20,元大-蘆洲,2024-08-29,9857
00933B,國泰10Y+金融債,19,0,19,元大-蘆洲,2024-08-29,9857
00905,FT臺灣Smart,18,0,18,元大-蘆洲,2024-08-29,9857
4743,合一,22,4,18,元大-蘆洲,2024-08-29,9857
0050,元大台灣50,22,5,17,元大-蘆洲,2024-08-29,9857
00919,群益台灣精選高息,36,18,18,元大-蘆洲,2024-08-29,9857
00665L,富邦�琤肭磪囓�2,20,3,17,元大-蘆洲,2024-08-29,9857
1717,長興,22,5,17,元大-蘆洲,2024-08-29,9857
3491,昇達科,21,4,17,元大-蘆洲,2024-08-29,9857
2371,大同,24,8,16,元大-蘆洲,2024-08-29,9857
00923,群益台ESG低碳50,15,0,15,元大-蘆洲,2024-08-29,9857
2515,中工,42,27,15,元大-蘆洲,2024-08-29,9857
00712,復華富時不動產,251,4,247,元大-蘆洲,2024-08-30,9857
00680L,元大美債20正2,159,5,154,元大-蘆洲,2024-08-30,9857
3037,欣興,135,39,96,元大-蘆洲,2024-08-30,9857
1711,永光,312,229,83,元大-蘆洲,2024-08-30,9857
00687B,國泰20年美債,80,0,80,元大-蘆洲,2024-08-30,9857
00632R,元大台灣50反1,75,0,75,元大-蘆洲,2024-08-30,9857
00959B,大華投等美債15Y+,65,0,65,元大-蘆洲,2024-08-30,9857
00929,復華台灣科技優息,76,15,61,元大-蘆洲,2024-08-30,9857
00651R,復華香港反1,58,0,58,元大-蘆洲,2024-08-30,9857
4927,泰鼎-KY,50,3,47,元大-蘆洲,2024-08-30,9857
00679B,元大美債20年,49,4,45,元大-蘆洲,2024-08-30,9857
4510,高鋒,76,35,41,元大-蘆洲,2024-08-30,9857
1815,富喬,54,13,41,元大-蘆洲,2024-08-30,9857
2313,華通,140,101,39,元大-蘆洲,2024-08-30,9857
4526,東台,990,951,39,元大-蘆洲,2024-08-30,9857
2409,友達,45,7,38,元大-蘆洲,2024-08-30,9857
1217,愛之味,40,2,38,元大-蘆洲,2024-08-30,9857
2891,中信金,37,0,37,元大-蘆洲,2024-08-30,9857
6215,和椿,107,71,36,元大-蘆洲,2024-08-30,9857
2425,承啟,75,40,35,元大-蘆洲,2024-08-30,9857
00688L,國泰20年美債正2,34,0,34,元大-蘆洲,2024-08-30,9857
2402,毅嘉,45,12,33,元大-蘆洲,2024-08-30,9857
8110,華東,32,0,32,元大-蘆洲,2024-08-30,9857
8111,立��,48,17,31,元大-蘆洲,2024-08-30,9857
3260,威剛,32,2,30,元大-蘆洲,2024-08-30,9857
3019,亞光,65,37,28,元大-蘆洲,2024-08-30,9857
1785,光洋科,106,78,28,元大-蘆洲,2024-08-30,9857
2364,倫飛,39,11,28,元大-蘆洲,2024-08-30,9857
3024,憶聲,31,5,26,元大-蘆洲,2024-08-30,9857
2340,台亞,31,5,26,元大-蘆洲,2024-08-30,9857
8028,昇陽半導體,52,28,24,元大-蘆洲,2024-08-30,9857
2880,華南金,22,1,21,元大-蘆洲,2024-08-30,9857
2027,大成鋼,24,3,21,元大-蘆洲,2024-08-30,9857
3013,晟銘電,27,6,21,元大-蘆洲,2024-08-30,9857
2886,兆豐金,22,1,21,元大-蘆洲,2024-08-30,9857
3707,漢磊,21,2,19,元大-蘆洲,2024-08-30,9857
00918,大華優利高填息30,19,0,19,元大-蘆洲,2024-08-30,9857
2618,長榮航,37,19,18,元大-蘆洲,2024-08-30,9857
2362,藍天,24,6,18,元大-蘆洲,2024-08-30,9857
3535,晶彩科,21,3,18,元大-蘆洲,2024-08-30,9857
2367,燿華,206,188,18,元大-蘆洲,2024-08-30,9857
2538,基泰,17,0,17,元大-蘆洲,2024-08-30,9857
1453,大將,20,3,17,元大-蘆洲,2024-08-30,9857
3481,群創,121,104,17,元大-蘆洲,2024-08-30,9857
3686,達能,19,3,16,元大-蘆洲,2024-08-30,9857
2355,敬鵬,16,1,15,元大-蘆洲,2024-08-30,9857
8064,東捷,135,121,14,元大-蘆洲,2024-08-30,9857
2426,鼎元,32,18,14,元大-蘆洲,2024-08-30,9857
3390,旭軟,25,11,14,元大-蘆洲,2024-08-30,9857
5386,青雲,45,32,13,元大-蘆洲,2024-08-30,9857
00680L,元大美債20正2,441,35,406,元大-蘆洲,2024-09-02,9857
00687B,國泰20年美債,293,4,289,元大-蘆洲,2024-09-02,9857
00637L,元大滬深300正2,124,0,124,元大-蘆洲,2024-09-02,9857
2352,佳世達,244,125,119,元大-蘆洲,2024-09-02,9857
00937B,群益ESG投等債20,130,21,109,元大-蘆洲,2024-09-02,9857
00715L,期街口布蘭特正2,90,0,90,元大-蘆洲,2024-09-02,9857
2615,萬海,114,39,75,元大-蘆洲,2024-09-02,9857
00688L,國泰20年美債正2,75,6,69,元大-蘆洲,2024-09-02,9857
2402,毅嘉,122,55,67,元大-蘆洲,2024-09-02,9857
2323,中環,98,32,66,元大-蘆洲,2024-09-02,9857
00936,台新永續高息中小,72,10,62,元大-蘆洲,2024-09-02,9857
4927,泰鼎-KY,62,1,61,元大-蘆洲,2024-09-02,9857
00929,復華台灣科技優息,86,26,60,元大-蘆洲,2024-09-02,9857
00665L,富邦�琤肭磪囓�2,58,0,58,元大-蘆洲,2024-09-02,9857
8011,台通,62,8,54,元大-蘆洲,2024-09-02,9857
2609,陽明,57,8,49,元大-蘆洲,2024-09-02,9857
3481,群創,89,43,46,元大-蘆洲,2024-09-02,9857
2420,新巨,82,37,45,元大-蘆洲,2024-09-02,9857
00650L,復華香港正2,40,0,40,元大-蘆洲,2024-09-02,9857
1326,台化,53,13,40,元大-蘆洲,2024-09-02,9857
6658,聯策,44,7,37,元大-蘆洲,2024-09-02,9857
6706,惠特,101,65,36,元大-蘆洲,2024-09-02,9857
2426,鼎元,44,9,35,元大-蘆洲,2024-09-02,9857
2603,長榮,44,9,35,元大-蘆洲,2024-09-02,9857
00915,凱基優選高股息30,35,1,34,元大-蘆洲,2024-09-02,9857
00945B,凱基美國非投等債,32,0,32,元大-蘆洲,2024-09-02,9857
9955,佳龍,32,0,32,元大-蘆洲,2024-09-02,9857
00679B,元大美債20年,31,0,31,元大-蘆洲,2024-09-02,9857
00948B,中信優息投資級債,31,0,31,元大-蘆洲,2024-09-02,9857
6431,光麗-KY,31,0,31,元大-蘆洲,2024-09-02,9857
1314,中石化,31,0,31,元大-蘆洲,2024-09-02,9857
8033,雷虎,30,0,30,元大-蘆洲,2024-09-02,9857
00919,群益台灣精選高息,45,16,29,元大-蘆洲,2024-09-02,9857
1539,巨庭,71,43,28,元大-蘆洲,2024-09-02,9857
00713,元大台灣高息低波,26,0,26,元大-蘆洲,2024-09-02,9857
1434,福懋,34,8,26,元大-蘆洲,2024-09-02,9857
4714,永捷,40,15,25,元大-蘆洲,2024-09-02,9857
1303,南亞,32,9,23,元大-蘆洲,2024-09-02,9857
4303,信立,23,0,23,元大-蘆洲,2024-09-02,9857
2313,華通,58,36,22,元大-蘆洲,2024-09-02,9857
2303,聯電,33,11,22,元大-蘆洲,2024-09-02,9857
2916,滿心,22,1,21,元大-蘆洲,2024-09-02,9857
8043,蜜望實,91,70,21,元大-蘆洲,2024-09-02,9857
4716,大立,20,0,20,元大-蘆洲,2024-09-02,9857
00933B,國泰10Y+金融債,19,1,18,元大-蘆洲,2024-09-02,9857
3006,晶豪科,20,2,18,元大-蘆洲,2024-09-02,9857
8105,凌巨,104,86,18,元大-蘆洲,2024-09-02,9857
3149,正達,32,14,18,元大-蘆洲,2024-09-02,9857
4564,元翎,25,8,17,元大-蘆洲,2024-09-02,9857
00918,大華優利高填息30,18,1,17,元大-蘆洲,2024-09-02,9857
00918,大華優利高填息30,718,0,718,元大-蘆洲,2024-09-03,9857
00919,群益台灣精選高息,348,4,344,元大-蘆洲,2024-09-03,9857
00940,元大台灣價值高息,323,53,270,元大-蘆洲,2024-09-03,9857
00680L,元大美債20正2,154,5,149,元大-蘆洲,2024-09-03,9857
00948B,中信優息投資級債,124,1,123,元大-蘆洲,2024-09-03,9857
00687B,國泰20年美債,121,0,121,元大-蘆洲,2024-09-03,9857
2421,建準,71,0,71,元大-蘆洲,2024-09-03,9857
00937B,群益ESG投等債20,106,38,68,元大-蘆洲,2024-09-03,9857
6213,聯茂,155,92,63,元大-蘆洲,2024-09-03,9857
3481,群創,74,16,58,元大-蘆洲,2024-09-03,9857
2883,凱基金,70,13,57,元大-蘆洲,2024-09-03,9857
00915,凱基優選高股息30,53,0,53,元大-蘆洲,2024-09-03,9857
2486,一詮,70,19,51,元大-蘆洲,2024-09-03,9857
3047,訊舟,110,60,50,元大-蘆洲,2024-09-03,9857
2537,聯上發,50,1,49,元大-蘆洲,2024-09-03,9857
4927,泰鼎-KY,46,1,45,元大-蘆洲,2024-09-03,9857
3042,晶技,43,0,43,元大-蘆洲,2024-09-03,9857
1101,台泥,53,11,42,元大-蘆洲,2024-09-03,9857
6244,茂迪,44,4,40,元大-蘆洲,2024-09-03,9857
2002,中鋼,42,5,37,元大-蘆洲,2024-09-03,9857
2891,中信金,41,5,36,元大-蘆洲,2024-09-03,9857
00665L,富邦�琤肭磪囓�2,35,0,35,元大-蘆洲,2024-09-03,9857
00679B,元大美債20年,34,4,30,元大-蘆洲,2024-09-03,9857
00637L,元大滬深300正2,40,10,30,元大-蘆洲,2024-09-03,9857
6706,惠特,45,15,30,元大-蘆洲,2024-09-03,9857
2882,國泰金,31,2,29,元大-蘆洲,2024-09-03,9857
00882,中信中國高股息,35,8,27,元大-蘆洲,2024-09-03,9857
6449,鈺邦,30,3,27,元大-蘆洲,2024-09-03,9857
1735,日勝化,29,2,27,元大-蘆洲,2024-09-03,9857
2356,英業達,33,7,26,元大-蘆洲,2024-09-03,9857
3380,明泰,30,5,25,元大-蘆洲,2024-09-03,9857
2312,金寶,45,21,24,元大-蘆洲,2024-09-03,9857
3491,昇達科,23,0,23,元大-蘆洲,2024-09-03,9857
6116,彩晶,23,0,23,元大-蘆洲,2024-09-03,9857
1434,福懋,22,0,22,元大-蘆洲,2024-09-03,9857
00878,國泰永續高股息,66,44,22,元大-蘆洲,2024-09-03,9857
4526,東台,35,13,22,元大-蘆洲,2024-09-03,9857
3105,穩懋,21,0,21,元大-蘆洲,2024-09-03,9857
2313,華通,73,52,21,元大-蘆洲,2024-09-03,9857
1714,和桐,24,3,21,元大-蘆洲,2024-09-03,9857
6120,達運,20,0,20,元大-蘆洲,2024-09-03,9857
8215,明基材,20,0,20,元大-蘆洲,2024-09-03,9857
2881,富邦金,19,1,18,元大-蘆洲,2024-09-03,9857
3163,波若威,21,4,17,元大-蘆洲,2024-09-03,9857
2609,陽明,19,2,17,元大-蘆洲,2024-09-03,9857
00933B,國泰10Y+金融債,21,4,17,元大-蘆洲,2024-09-03,9857
1314,中石化,18,1,17,元大-蘆洲,2024-09-03,9857
8096,擎亞,37,20,17,元大-蘆洲,2024-09-03,9857
2352,佳世達,17,1,16,元大-蘆洲,2024-09-03,9857
3231,緯創,56,40,16,元大-蘆洲,2024-09-03,9857
00679B,元大美債20年,812,43,769,元大-蘆洲,2024-09-04,9857
00940,元大台灣價值高息,872,296,576,元大-蘆洲,2024-09-04,9857
00929,復華台灣科技優息,784,259,525,元大-蘆洲,2024-09-04,9857
00919,群益台灣精選高息,534,28,506,元大-蘆洲,2024-09-04,9857
2888,新光金,435,66,369,元大-蘆洲,2024-09-04,9857
00918,大華優利高填息30,332,20,312,元大-蘆洲,2024-09-04,9857
00878,國泰永續高股息,325,25,300,元大-蘆洲,2024-09-04,9857
2838,聯邦銀,205,0,205,元大-蘆洲,2024-09-04,9857
1314,中石化,167,3,164,元大-蘆洲,2024-09-04,9857
00915,凱基優選高股息30,177,24,153,元大-蘆洲,2024-09-04,9857
0056,元大高股息,162,9,153,元大-蘆洲,2024-09-04,9857
2880,華南金,117,0,117,元大-蘆洲,2024-09-04,9857
3481,群創,180,68,112,元大-蘆洲,2024-09-04,9857
6153,嘉聯益,103,1,102,元大-蘆洲,2024-09-04,9857
2891,中信金,114,13,101,元大-蘆洲,2024-09-04,9857
00715L,期街口布蘭特正2,108,20,88,元大-蘆洲,2024-09-04,9857
2330,台積電,99,13,86,元大-蘆洲,2024-09-04,9857
00946,群益科技高息成長,138,52,86,元大-蘆洲,2024-09-04,9857
00881,國泰台灣5G+,88,5,83,元大-蘆洲,2024-09-04,9857
00948B,中信優息投資級債,158,89,69,元大-蘆洲,2024-09-04,9857
2344,華邦電,66,1,65,元大-蘆洲,2024-09-04,9857
00713,元大台灣高息低波,79,18,61,元大-蘆洲,2024-09-04,9857
2349,錸德,76,19,57,元大-蘆洲,2024-09-04,9857
2501,國建,55,1,54,元大-蘆洲,2024-09-04,9857
9105,泰金寶-DR,50,0,50,元大-蘆洲,2024-09-04,9857
00951,台新日本半導體,48,0,48,元大-蘆洲,2024-09-04,9857
2892,第一金,51,5,46,元大-蘆洲,2024-09-04,9857
2317,鴻海,203,157,46,元大-蘆洲,2024-09-04,9857
2303,聯電,59,14,45,元大-蘆洲,2024-09-04,9857
006208,富邦台50,52,8,44,元大-蘆洲,2024-09-04,9857
3231,緯創,83,39,44,元大-蘆洲,2024-09-04,9857
6937,天虹,49,6,43,元大-蘆洲,2024-09-04,9857
2601,益航,41,0,41,元大-蘆洲,2024-09-04,9857
2382,廣達,71,30,41,元大-蘆洲,2024-09-04,9857
2022,聚亨,40,0,40,元大-蘆洲,2024-09-04,9857
1301,台塑,46,7,39,元大-蘆洲,2024-09-04,9857
2834,臺企銀,39,0,39,元大-蘆洲,2024-09-04,9857
00712,復華富時不動產,36,0,36,元大-蘆洲,2024-09-04,9857
1785,光洋科,51,15,36,元大-蘆洲,2024-09-04,9857
9945,潤泰新,38,2,36,元大-蘆洲,2024-09-04,9857
1303,南亞,44,9,35,元大-蘆洲,2024-09-04,9857
2002,中鋼,37,3,34,元大-蘆洲,2024-09-04,9857
2515,中工,85,51,34,元大-蘆洲,2024-09-04,9857
2887,台新金,38,6,32,元大-蘆洲,2024-09-04,9857
5439,高技,33,2,31,元大-蘆洲,2024-09-04,9857
6770,力積電,32,2,30,元大-蘆洲,2024-09-04,9857
4306,炎洲,34,4,30,元大-蘆洲,2024-09-04,9857
2537,聯上發,33,3,30,元大-蘆洲,2024-09-04,9857
1608,華榮,30,0,30,元大-蘆洲,2024-09-04,9857
0050,元大台灣50,55,26,29,元大-蘆洲,2024-09-04,9857
00632R,元大台灣50反1,266,34,232,元大-蘆洲,2024-09-05,9857
00919,群益台灣精選高息,205,2,203,元大-蘆洲,2024-09-05,9857
00715L,期街口布蘭特正2,176,1,175,元大-蘆洲,2024-09-05,9857
00929,復華台灣科技優息,428,254,174,元大-蘆洲,2024-09-05,9857
00687B,國泰20年美債,192,19,173,元大-蘆洲,2024-09-05,9857
00712,復華富時不動產,110,0,110,元大-蘆洲,2024-09-05,9857
00952,凱基台灣AI50,104,0,104,元大-蘆洲,2024-09-05,9857
2838,聯邦銀,92,0,92,元大-蘆洲,2024-09-05,9857
00664R,國泰臺灣加權反1,82,0,82,元大-蘆洲,2024-09-05,9857
00878,國泰永續高股息,97,15,82,元大-蘆洲,2024-09-05,9857
00915,凱基優選高股息30,70,5,65,元大-蘆洲,2024-09-05,9857
2367,燿華,66,9,57,元大-蘆洲,2024-09-05,9857
2312,金寶,66,11,55,元大-蘆洲,2024-09-05,9857
2317,鴻海,135,82,53,元大-蘆洲,2024-09-05,9857
00918,大華優利高填息30,68,18,50,元大-蘆洲,2024-09-05,9857
2344,華邦電,47,0,47,元大-蘆洲,2024-09-05,9857
2308,台達電,48,2,46,元大-蘆洲,2024-09-05,9857
1539,巨庭,291,246,45,元大-蘆洲,2024-09-05,9857
2365,昆盈,117,73,44,元大-蘆洲,2024-09-05,9857
3037,欣興,55,12,43,元大-蘆洲,2024-09-05,9857
00642U,期元大S＆P石油,43,0,43,元大-蘆洲,2024-09-05,9857
00946,群益科技高息成長,100,57,43,元大-蘆洲,2024-09-05,9857
2515,中工,44,1,43,元大-蘆洲,2024-09-05,9857
2888,新光金,178,135,43,元大-蘆洲,2024-09-05,9857
2402,毅嘉,63,21,42,元大-蘆洲,2024-09-05,9857
2323,中環,41,1,40,元大-蘆洲,2024-09-05,9857
00951,台新日本半導體,34,0,34,元大-蘆洲,2024-09-05,9857
2834,臺企銀,34,1,33,元大-蘆洲,2024-09-05,9857
4303,信立,57,25,32,元大-蘆洲,2024-09-05,9857
1722,台肥,31,2,29,元大-蘆洲,2024-09-05,9857
3047,訊舟,64,35,29,元大-蘆洲,2024-09-05,9857
2337,旺宏,37,9,28,元大-蘆洲,2024-09-05,9857
1611,中電,26,1,25,元大-蘆洲,2024-09-05,9857
00713,元大台灣高息低波,27,3,24,元大-蘆洲,2024-09-05,9857
1609,大亞,25,2,23,元大-蘆洲,2024-09-05,9857
3548,兆利,31,8,23,元大-蘆洲,2024-09-05,9857
2328,廣宇,23,0,23,元大-蘆洲,2024-09-05,9857
4714,永捷,38,16,22,元大-蘆洲,2024-09-05,9857
8043,蜜望實,29,8,21,元大-蘆洲,2024-09-05,9857
2313,華通,33,12,21,元大-蘆洲,2024-09-05,9857
1806,冠軍,20,0,20,元大-蘆洲,2024-09-05,9857
2601,益航,20,0,20,元大-蘆洲,2024-09-05,9857
2002,中鋼,41,22,19,元大-蘆洲,2024-09-05,9857
5328,華容,19,0,19,元大-蘆洲,2024-09-05,9857
2408,南亞科,29,11,18,元大-蘆洲,2024-09-05,9857
2615,萬海,19,2,17,元大-蘆洲,2024-09-05,9857
00665L,富邦�琤肭磪囓�2,17,0,17,元大-蘆洲,2024-09-05,9857
0056,元大高股息,38,22,16,元大-蘆洲,2024-09-05,9857
3163,波若威,42,27,15,元大-蘆洲,2024-09-05,9857
6191,精成科,15,0,15,元大-蘆洲,2024-09-05,9857
00680L,元大美債20正2,3356,93,3263,元大-蘆洲,2024-09-06,9857
00687B,國泰20年美債,223,44,179,元大-蘆洲,2024-09-06,9857
00948B,中信優息投資級債,150,10,140,元大-蘆洲,2024-09-06,9857
00929,復華台灣科技優息,234,103,131,元大-蘆洲,2024-09-06,9857
1314,中石化,120,0,120,元大-蘆洲,2024-09-06,9857
00919,群益台灣精選高息,148,36,112,元大-蘆洲,2024-09-06,9857
2883,凱基金,111,13,98,元大-蘆洲,2024-09-06,9857
00937B,群益ESG投等債20,113,34,79,元大-蘆洲,2024-09-06,9857
00918,大華優利高填息30,66,0,66,元大-蘆洲,2024-09-06,9857
00632R,元大台灣50反1,221,160,61,元大-蘆洲,2024-09-06,9857
3481,群創,71,12,59,元大-蘆洲,2024-09-06,9857
1711,永光,315,257,58,元大-蘆洲,2024-09-06,9857
3037,欣興,72,18,54,元大-蘆洲,2024-09-06,9857
1440,南紡,50,0,50,元大-蘆洲,2024-09-06,9857
00688L,國泰20年美債正2,67,20,47,元大-蘆洲,2024-09-06,9857
2618,長榮航,53,12,41,元大-蘆洲,2024-09-06,9857
00725B,國泰投資級公司債,44,3,41,元大-蘆洲,2024-09-06,9857
8096,擎亞,42,1,41,元大-蘆洲,2024-09-06,9857
00878,國泰永續高股息,61,21,40,元大-蘆洲,2024-09-06,9857
00945B,凱基美國非投等債,37,1,36,元大-蘆洲,2024-09-06,9857
00715L,期街口布蘭特正2,34,0,34,元大-蘆洲,2024-09-06,9857
6213,聯茂,37,3,34,元大-蘆洲,2024-09-06,9857
00923,群益台ESG低碳50,33,0,33,元大-蘆洲,2024-09-06,9857
2301,光寶科,39,7,32,元大-蘆洲,2024-09-06,9857
2344,華邦電,30,0,30,元大-蘆洲,2024-09-06,9857
2409,友達,32,7,25,元大-蘆洲,2024-09-06,9857
2101,南港,25,0,25,元大-蘆洲,2024-09-06,9857
4440,宜新實業,25,0,25,元大-蘆洲,2024-09-06,9857
4535,至興,24,0,24,元大-蘆洲,2024-09-06,9857
1582,信錦,24,0,24,元大-蘆洲,2024-09-06,9857
00915,凱基優選高股息30,30,7,23,元大-蘆洲,2024-09-06,9857
2641,正德,23,0,23,元大-蘆洲,2024-09-06,9857
2497,怡利電,79,57,22,元大-蘆洲,2024-09-06,9857
1815,富喬,181,159,22,元大-蘆洲,2024-09-06,9857
00951,台新日本半導體,24,3,21,元大-蘆洲,2024-09-06,9857
2317,鴻海,32,11,21,元大-蘆洲,2024-09-06,9857
00676R,富邦臺灣加權反1,20,0,20,元大-蘆洲,2024-09-06,9857
3523,迎輝,20,0,20,元大-蘆洲,2024-09-06,9857
2405,輔信,22,5,17,元大-蘆洲,2024-09-06,9857
6425,易發,16,0,16,元大-蘆洲,2024-09-06,9857
00642U,期元大S＆P石油,16,0,16,元大-蘆洲,2024-09-06,9857
6405,悅城,58,43,15,元大-蘆洲,2024-09-06,9857
3483,力致,15,0,15,元大-蘆洲,2024-09-06,9857
3260,威剛,22,7,15,元大-蘆洲,2024-09-06,9857
2464,盟立,41,27,14,元大-蘆洲,2024-09-06,9857
5905,南仁湖,21,8,13,元大-蘆洲,2024-09-06,9857
8011,台通,14,1,13,元大-蘆洲,2024-09-06,9857
8927,北基,15,2,13,元大-蘆洲,2024-09-06,9857
00830,國泰費城半導體,13,0,13,元大-蘆洲,2024-09-06,9857
8071,能率網通,27,15,12,元大-蘆洲,2024-09-06,9857
00919,群益台灣精選高息,300,25,275,元大-蘆洲,2024-09-09,9857
0056,元大高股息,104,2,102,元大-蘆洲,2024-09-09,9857
00687B,國泰20年美債,117,16,101,元大-蘆洲,2024-09-09,9857
00878,國泰永續高股息,167,69,98,元大-蘆洲,2024-09-09,9857
2317,鴻海,103,17,86,元大-蘆洲,2024-09-09,9857
00940,元大台灣價值高息,152,72,80,元大-蘆洲,2024-09-09,9857
2881,富邦金,84,4,80,元大-蘆洲,2024-09-09,9857
00881,國泰台灣5G+,76,0,76,元大-蘆洲,2024-09-09,9857
00918,大華優利高填息30,72,2,70,元大-蘆洲,2024-09-09,9857
6706,惠特,81,17,64,元大-蘆洲,2024-09-09,9857
00637L,元大滬深300正2,141,90,51,元大-蘆洲,2024-09-09,9857
8249,菱光,123,75,48,元大-蘆洲,2024-09-09,9857
6757,台灣虎航,48,0,48,元大-蘆洲,2024-09-09,9857
2344,華邦電,54,6,48,元大-蘆洲,2024-09-09,9857
2399,映泰,56,12,44,元大-蘆洲,2024-09-09,9857
00946,群益科技高息成長,42,0,42,元大-蘆洲,2024-09-09,9857
2891,中信金,51,10,41,元大-蘆洲,2024-09-09,9857
1905,華紙,41,0,41,元大-蘆洲,2024-09-09,9857
3481,群創,53,12,41,元大-蘆洲,2024-09-09,9857
2382,廣達,46,7,39,元大-蘆洲,2024-09-09,9857
8076,伍豐,64,28,36,元大-蘆洲,2024-09-09,9857
2542,興富發,38,3,35,元大-蘆洲,2024-09-09,9857
2301,光寶科,30,0,30,元大-蘆洲,2024-09-09,9857
0050,元大台灣50,30,1,29,元大-蘆洲,2024-09-09,9857
00713,元大台灣高息低波,29,2,27,元大-蘆洲,2024-09-09,9857
4956,光鋐,355,328,27,元大-蘆洲,2024-09-09,9857
2002,中鋼,34,7,27,元大-蘆洲,2024-09-09,9857
9945,潤泰新,47,21,26,元大-蘆洲,2024-09-09,9857
00951,台新日本半導體,29,3,26,元大-蘆洲,2024-09-09,9857
3231,緯創,49,24,25,元大-蘆洲,2024-09-09,9857
6194,育富,57,33,24,元大-蘆洲,2024-09-09,9857
2330,台積電,24,1,23,元大-蘆洲,2024-09-09,9857
2618,長榮航,39,16,23,元大-蘆洲,2024-09-09,9857
2851,中再保,22,0,22,元大-蘆洲,2024-09-09,9857
3051,力特,22,0,22,元大-蘆洲,2024-09-09,9857
4306,炎洲,21,0,21,元大-蘆洲,2024-09-09,9857
6215,和椿,45,24,21,元大-蘆洲,2024-09-09,9857
00662,富邦NASDAQ,20,0,20,元大-蘆洲,2024-09-09,9857
006208,富邦台50,26,6,20,元大-蘆洲,2024-09-09,9857
00715L,期街口布蘭特正2,20,0,20,元大-蘆洲,2024-09-09,9857
4157,太景*-KY,20,0,20,元大-蘆洲,2024-09-09,9857
2303,聯電,29,10,19,元大-蘆洲,2024-09-09,9857
1815,富喬,65,46,19,元大-蘆洲,2024-09-09,9857
5388,中磊,20,2,18,元大-蘆洲,2024-09-09,9857
2615,萬海,74,57,17,元大-蘆洲,2024-09-09,9857
3037,欣興,114,97,17,元大-蘆洲,2024-09-09,9857
6274,台燿,42,25,17,元大-蘆洲,2024-09-09,9857
00915,凱基優選高股息30,44,27,17,元大-蘆洲,2024-09-09,9857
00934,中信成長高股息,16,0,16,元大-蘆洲,2024-09-09,9857
00882,中信中國高股息,26,10,16,元大-蘆洲,2024-09-09,9857
00680L,元大美債20正2,1076,28,1048,元大-蘆洲,2024-09-10,9857
00919,群益台灣精選高息,257,16,241,元大-蘆洲,2024-09-10,9857
00940,元大台灣價值高息,211,21,190,元大-蘆洲,2024-09-10,9857
00929,復華台灣科技優息,221,121,100,元大-蘆洲,2024-09-10,9857
6104,創惟,80,0,80,元大-蘆洲,2024-09-10,9857
00918,大華優利高填息30,62,1,61,元大-蘆洲,2024-09-10,9857
00878,國泰永續高股息,63,3,60,元大-蘆洲,2024-09-10,9857
6244,茂迪,58,0,58,元大-蘆洲,2024-09-10,9857
00687B,國泰20年美債,89,36,53,元大-蘆洲,2024-09-10,9857
2317,鴻海,84,30,54,元大-蘆洲,2024-09-10,9857
3673,TPK-KY,76,28,48,元大-蘆洲,2024-09-10,9857
2542,興富發,55,7,48,元大-蘆洲,2024-09-10,9857
0056,元大高股息,49,3,46,元大-蘆洲,2024-09-10,9857
00915,凱基優選高股息30,45,2,43,元大-蘆洲,2024-09-10,9857
00857B,永豐20年美公債,41,0,41,元大-蘆洲,2024-09-10,9857
1314,中石化,42,1,41,元大-蘆洲,2024-09-10,9857
2891,中信金,51,13,38,元大-蘆洲,2024-09-10,9857
00943,兆豐電子高息等權,36,0,36,元大-蘆洲,2024-09-10,9857
2382,廣達,74,41,33,元大-蘆洲,2024-09-10,9857
2609,陽明,49,17,32,元大-蘆洲,2024-09-10,9857
4714,永捷,86,55,31,元大-蘆洲,2024-09-10,9857
1584,精剛,47,17,30,元大-蘆洲,2024-09-10,9857
4909,新復興,104,74,30,元大-蘆洲,2024-09-10,9857
3047,訊舟,62,34,28,元大-蘆洲,2024-09-10,9857
6152,百一,55,27,28,元大-蘆洲,2024-09-10,9857
2409,友達,43,15,28,元大-蘆洲,2024-09-10,9857
2313,華通,45,18,27,元大-蘆洲,2024-09-10,9857
2344,華邦電,32,5,27,元大-蘆洲,2024-09-10,9857
6215,和椿,34,7,27,元大-蘆洲,2024-09-10,9857
6603,富強鑫,27,1,26,元大-蘆洲,2024-09-10,9857
00945B,凱基美國非投等債,26,0,26,元大-蘆洲,2024-09-10,9857
5213,亞昕,26,0,26,元大-蘆洲,2024-09-10,9857
1539,巨庭,52,27,25,元大-蘆洲,2024-09-10,9857
2002,中鋼,29,4,25,元大-蘆洲,2024-09-10,9857
6129,普誠,24,0,24,元大-蘆洲,2024-09-10,9857
4956,光鋐,146,122,24,元大-蘆洲,2024-09-10,9857
00715L,期街口布蘭特正2,23,0,23,元大-蘆洲,2024-09-10,9857
00934,中信成長高股息,25,3,22,元大-蘆洲,2024-09-10,9857
2489,瑞軒,60,39,21,元大-蘆洲,2024-09-10,9857
6213,聯茂,44,24,20,元大-蘆洲,2024-09-10,9857
9945,潤泰新,30,10,20,元大-蘆洲,2024-09-10,9857
6197,佳必琪,20,0,20,元大-蘆洲,2024-09-10,9857
2915,潤泰全,21,1,20,元大-蘆洲,2024-09-10,9857
2371,大同,25,6,19,元大-蘆洲,2024-09-10,9857
2539,櫻花建,22,3,19,元大-蘆洲,2024-09-10,9857
6763,綠界科技*,19,0,19,元大-蘆洲,2024-09-10,9857
00751B,元大AAA至A公司債,18,0,18,元大-蘆洲,2024-09-10,9857
1326,台化,22,4,18,元大-蘆洲,2024-09-10,9857
2408,南亞科,24,6,18,元大-蘆洲,2024-09-10,9857
2337,旺宏,26,9,17,元大-蘆洲,2024-09-10,9857
00688L,國泰20年美債正2,311,77,234,元大-蘆洲,2024-09-11,9857
00715L,期街口布蘭特正2,191,3,188,元大-蘆洲,2024-09-11,9857
00680L,元大美債20正2,503,351,152,元大-蘆洲,2024-09-11,9857
00632R,元大台灣50反1,120,11,109,元大-蘆洲,2024-09-11,9857
2883,凱基金,115,32,83,元大-蘆洲,2024-09-11,9857
00948B,中信優息投資級債,85,8,77,元大-蘆洲,2024-09-11,9857
00918,大華優利高填息30,63,5,58,元大-蘆洲,2024-09-11,9857
00919,群益台灣精選高息,68,12,56,元大-蘆洲,2024-09-11,9857
6152,百一,68,17,51,元大-蘆洲,2024-09-11,9857
2834,臺企銀,55,4,51,元大-蘆洲,2024-09-11,9857
1522,堤維西,55,5,50,元大-蘆洲,2024-09-11,9857
3489,森寶,50,0,50,元大-蘆洲,2024-09-11,9857
2353,宏��,44,0,44,元大-蘆洲,2024-09-11,9857
00933B,國泰10Y+金融債,45,3,42,元大-蘆洲,2024-09-11,9857
00878,國泰永續高股息,72,34,38,元大-蘆洲,2024-09-11,9857
6104,創惟,36,0,36,元大-蘆洲,2024-09-11,9857
6108,競國,45,9,36,元大-蘆洲,2024-09-11,9857
00915,凱基優選高股息30,44,13,31,元大-蘆洲,2024-09-11,9857
00882,中信中國高股息,35,4,31,元大-蘆洲,2024-09-11,9857
2542,興富發,27,1,26,元大-蘆洲,2024-09-11,9857
2537,聯上發,26,0,26,元大-蘆洲,2024-09-11,9857
0056,元大高股息,36,11,25,元大-蘆洲,2024-09-11,9857
2886,兆豐金,26,4,22,元大-蘆洲,2024-09-11,9857
2070,精湛,48,27,21,元大-蘆洲,2024-09-11,9857
3702,大聯大,19,0,19,元大-蘆洲,2024-09-11,9857
3707,漢磊,29,11,18,元大-蘆洲,2024-09-11,9857
00881,國泰台灣5G+,19,1,18,元大-蘆洲,2024-09-11,9857
3356,奇偶,18,0,18,元大-蘆洲,2024-09-11,9857
8076,伍豐,29,12,17,元大-蘆洲,2024-09-11,9857
00945B,凱基美國非投等債,23,6,17,元大-蘆洲,2024-09-11,9857
00952,凱基台灣AI50,16,0,16,元大-蘆洲,2024-09-11,9857
3715,定穎投控,26,10,16,元大-蘆洲,2024-09-11,9857
6177,達麗,17,1,16,元大-蘆洲,2024-09-11,9857
00642U,期元大S＆P石油,15,0,15,元大-蘆洲,2024-09-11,9857
00665L,富邦�琤肭磪囓�2,15,0,15,元大-蘆洲,2024-09-11,9857
00932,兆豐永續高息等權,15,0,15,元大-蘆洲,2024-09-11,9857
2399,映泰,74,60,14,元大-蘆洲,2024-09-11,9857
0050,元大台灣50,15,2,13,元大-蘆洲,2024-09-11,9857
5388,中磊,14,1,13,元大-蘆洲,2024-09-11,9857
00923,群益台ESG低碳50,13,0,13,元大-蘆洲,2024-09-11,9857
00930,永豐ESG低碳高息,13,0,13,元大-蘆洲,2024-09-11,9857
1314,中石化,20,7,13,元大-蘆洲,2024-09-11,9857
00935,野村臺灣新科技50,13,0,13,元大-蘆洲,2024-09-11,9857
4566,時碩工業,28,16,12,元大-蘆洲,2024-09-11,9857
2851,中再保,12,0,12,元大-蘆洲,2024-09-11,9857
1540,喬福,130,118,12,元大-蘆洲,2024-09-11,9857
2441,超豐,12,0,12,元大-蘆洲,2024-09-11,9857
3062,建漢,44,32,12,元大-蘆洲,2024-09-11,9857
6530,創威,85,73,12,元大-蘆洲,2024-09-11,9857
00957B,兆豐US優選投等債,12,0,12,元大-蘆洲,2024-09-11,9857
00632R,元大台灣50反1,622,20,602,元大-蘆洲,2024-09-12,9857
00680L,元大美債20正2,245,46,199,元大-蘆洲,2024-09-12,9857
2349,錸德,169,26,143,元大-蘆洲,2024-09-12,9857
00943,兆豐電子高息等權,126,0,126,元大-蘆洲,2024-09-12,9857
00650L,復華香港正2,100,0,100,元大-蘆洲,2024-09-12,9857
00900,富邦特選高股息30,101,1,100,元大-蘆洲,2024-09-12,9857
00712,復華富時不動產,100,2,98,元大-蘆洲,2024-09-12,9857
6104,創惟,112,16,96,元大-蘆洲,2024-09-12,9857
00905,FT臺灣Smart,95,5,90,元大-蘆洲,2024-09-12,9857
6152,百一,142,54,88,元大-蘆洲,2024-09-12,9857
00881,國泰台灣5G+,108,34,74,元大-蘆洲,2024-09-12,9857
3481,群創,83,24,59,元大-蘆洲,2024-09-12,9857
00688L,國泰20年美債正2,60,5,55,元大-蘆洲,2024-09-12,9857
6274,台燿,73,20,53,元大-蘆洲,2024-09-12,9857
2891,中信金,38,6,32,元大-蘆洲,2024-09-12,9857
3202,樺晟,30,0,30,元大-蘆洲,2024-09-12,9857
6257,矽格,30,1,29,元大-蘆洲,2024-09-12,9857
1711,永光,280,251,29,元大-蘆洲,2024-09-12,9857
0056,元大高股息,32,3,29,元大-蘆洲,2024-09-12,9857
00919,群益台灣精選高息,63,34,29,元大-蘆洲,2024-09-12,9857
00930,永豐ESG低碳高息,27,0,27,元大-蘆洲,2024-09-12,9857
3260,威剛,28,2,26,元大-蘆洲,2024-09-12,9857
00931B,統一美債20年,27,2,25,元大-蘆洲,2024-09-12,9857
8039,台虹,26,1,25,元大-蘆洲,2024-09-12,9857
2888,新光金,158,134,24,元大-蘆洲,2024-09-12,9857
1522,堤維西,22,1,21,元大-蘆洲,2024-09-12,9857
00725B,國泰投資級公司債,22,1,21,元大-蘆洲,2024-09-12,9857
00952,凱基台灣AI50,20,0,20,元大-蘆洲,2024-09-12,9857
00676R,富邦臺灣加權反1,20,0,20,元大-蘆洲,2024-09-12,9857
00713,元大台灣高息低波,28,9,19,元大-蘆洲,2024-09-12,9857
00915,凱基優選高股息30,54,37,17,元大-蘆洲,2024-09-12,9857
8064,東捷,18,1,17,元大-蘆洲,2024-09-12,9857
3264,欣銓,17,0,17,元大-蘆洲,2024-09-12,9857
1303,南亞,17,1,16,元大-蘆洲,2024-09-12,9857
3312,弘憶股,28,12,16,元大-蘆洲,2024-09-12,9857
3550,聯穎,16,0,16,元大-蘆洲,2024-09-12,9857
00948B,中信優息投資級債,16,0,16,元大-蘆洲,2024-09-12,9857
6284,佳邦,16,0,16,元大-蘆洲,2024-09-12,9857
2362,藍天,19,4,15,元大-蘆洲,2024-09-12,9857
00946,群益科技高息成長,15,0,15,元大-蘆洲,2024-09-12,9857
1504,東元,17,3,14,元大-蘆洲,2024-09-12,9857
2886,兆豐金,15,1,14,元大-蘆洲,2024-09-12,9857
1301,台塑,16,3,13,元大-蘆洲,2024-09-12,9857
4958,臻鼎-KY,23,10,13,元大-蘆洲,2024-09-12,9857
2344,華邦電,15,2,13,元大-蘆洲,2024-09-12,9857
2887,台新金,46,33,13,元大-蘆洲,2024-09-12,9857
00679B,元大美債20年,66,53,13,元大-蘆洲,2024-09-12,9857
2497,怡利電,75,63,12,元大-蘆洲,2024-09-12,9857
2467,志聖,23,11,12,元大-蘆洲,2024-09-12,9857
4935,茂林-KY,27,15,12,元大-蘆洲,2024-09-12,9857
00687B,國泰20年美債,174,14,160,元大-蘆洲,2024-09-13,9857
00632R,元大台灣50反1,146,5,141,元大-蘆洲,2024-09-13,9857
00937B,群益ESG投等債20,132,0,132,元大-蘆洲,2024-09-13,9857
00680L,元大美債20正2,151,40,111,元大-蘆洲,2024-09-13,9857
00948B,中信優息投資級債,125,20,105,元大-蘆洲,2024-09-13,9857
00679B,元大美債20年,84,1,83,元大-蘆洲,2024-09-13,9857
00919,群益台灣精選高息,88,5,83,元大-蘆洲,2024-09-13,9857
3583,辛耘,66,11,55,元大-蘆洲,2024-09-13,9857
9955,佳龍,78,31,47,元大-蘆洲,2024-09-13,9857
6706,惠特,83,40,43,元大-蘆洲,2024-09-13,9857
2399,映泰,80,37,43,元大-蘆洲,2024-09-13,9857
2303,聯電,44,7,37,元大-蘆洲,2024-09-13,9857
00929,復華台灣科技優息,79,43,36,元大-蘆洲,2024-09-13,9857
3149,正達,49,14,35,元大-蘆洲,2024-09-13,9857
00915,凱基優選高股息30,39,6,33,元大-蘆洲,2024-09-13,9857
00665L,富邦�琤肭磪囓�2,31,0,31,元大-蘆洲,2024-09-13,9857
3706,神達,40,9,31,元大-蘆洲,2024-09-13,9857
1307,三芳,34,4,30,元大-蘆洲,2024-09-13,9857
4971,IET-KY,29,0,29,元大-蘆洲,2024-09-13,9857
1773,勝一,27,1,26,元大-蘆洲,2024-09-13,9857
1540,喬福,250,227,23,元大-蘆洲,2024-09-13,9857
3663,鑫科,33,10,23,元大-蘆洲,2024-09-13,9857
00918,大華優利高填息30,28,8,20,元大-蘆洲,2024-09-13,9857
5512,力麒,20,0,20,元大-蘆洲,2024-09-13,9857
2916,滿心,18,0,18,元大-蘆洲,2024-09-13,9857
8070,長華*,46,28,18,元大-蘆洲,2024-09-13,9857
00713,元大台灣高息低波,17,0,17,元大-蘆洲,2024-09-13,9857
00891,中信關鍵半導體,16,0,16,元大-蘆洲,2024-09-13,9857
6114,久威,16,0,16,元大-蘆洲,2024-09-13,9857
6546,正基,30,15,15,元大-蘆洲,2024-09-13,9857
8064,東捷,53,38,15,元大-蘆洲,2024-09-13,9857
8011,台通,46,32,14,元大-蘆洲,2024-09-13,9857
3013,晟銘電,24,10,14,元大-蘆洲,2024-09-13,9857
4908,前鼎,16,2,14,元大-蘆洲,2024-09-13,9857
3376,新日興,18,4,14,元大-蘆洲,2024-09-13,9857
2891,中信金,30,17,13,元大-蘆洲,2024-09-13,9857
00637L,元大滬深300正2,23,10,13,元大-蘆洲,2024-09-13,9857
00945B,凱基美國非投等債,17,4,13,元大-蘆洲,2024-09-13,9857
2365,昆盈,28,16,12,元大-蘆洲,2024-09-13,9857
2851,中再保,12,0,12,元大-蘆洲,2024-09-13,9857
6197,佳必琪,14,2,12,元大-蘆洲,2024-09-13,9857
2845,遠東銀,18,6,12,元大-蘆洲,2024-09-13,9857
00878,國泰永續高股息,29,17,12,元大-蘆洲,2024-09-13,9857
3033,威健,13,2,11,元大-蘆洲,2024-09-13,9857
2317,鴻海,47,37,10,元大-蘆洲,2024-09-13,9857
6246,臺龍,18,8,10,元大-蘆洲,2024-09-13,9857
00673R,期元大S＆P原油反1,11,1,10,元大-蘆洲,2024-09-13,9857
2836,高雄銀,10,0,10,元大-蘆洲,2024-09-13,9857
2457,飛宏,12,2,10,元大-蘆洲,2024-09-13,9857
8234,新漢,10,0,10,元大-蘆洲,2024-09-13,9857
00687B,國泰20年美債,216,14,202,元大-蘆洲,2024-09-16,9857
00632R,元大台灣50反1,176,5,171,元大-蘆洲,2024-09-16,9857
00679B,元大美債20年,187,36,151,元大-蘆洲,2024-09-16,9857
00929,復華台灣科技優息,159,15,144,元大-蘆洲,2024-09-16,9857
00918,大華優利高填息30,120,5,115,元大-蘆洲,2024-09-16,9857
00713,元大台灣高息低波,103,1,102,元大-蘆洲,2024-09-16,9857
2349,錸德,221,120,101,元大-蘆洲,2024-09-16,9857
00885,富邦越南,100,0,100,元大-蘆洲,2024-09-16,9857
5905,南仁湖,100,4,96,元大-蘆洲,2024-09-16,9857
00937B,群益ESG投等債20,92,0,92,元大-蘆洲,2024-09-16,9857
00919,群益台灣精選高息,94,5,89,元大-蘆洲,2024-09-16,9857
2409,友達,284,218,66,元大-蘆洲,2024-09-16,9857
00915,凱基優選高股息30,77,15,62,元大-蘆洲,2024-09-16,9857
00943,兆豐電子高息等權,50,0,50,元大-蘆洲,2024-09-16,9857
2023,燁輝,50,0,50,元大-蘆洲,2024-09-16,9857
6152,百一,54,8,46,元大-蘆洲,2024-09-16,9857
00688L,國泰20年美債正2,55,10,45,元大-蘆洲,2024-09-16,9857
1773,勝一,42,3,39,元大-蘆洲,2024-09-16,9857
4909,新復興,107,69,38,元大-蘆洲,2024-09-16,9857
2426,鼎元,49,13,36,元大-蘆洲,2024-09-16,9857
8249,菱光,105,70,35,元大-蘆洲,2024-09-16,9857
5230,雷笛克光學,54,22,32,元大-蘆洲,2024-09-16,9857
00665L,富邦�琤肭磪囓�2,30,0,30,元大-蘆洲,2024-09-16,9857
00715L,期街口布蘭特正2,32,3,29,元大-蘆洲,2024-09-16,9857
00948B,中信優息投資級債,69,40,29,元大-蘆洲,2024-09-16,9857
4927,泰鼎-KY,26,0,26,元大-蘆洲,2024-09-16,9857
4562,穎漢,28,3,25,元大-蘆洲,2024-09-16,9857
1609,大亞,33,9,24,元大-蘆洲,2024-09-16,9857
2538,基泰,23,0,23,元大-蘆洲,2024-09-16,9857
4935,茂林-KY,25,4,21,元大-蘆洲,2024-09-16,9857
3019,亞光,33,12,21,元大-蘆洲,2024-09-16,9857
00878,國泰永續高股息,32,11,21,元大-蘆洲,2024-09-16,9857
00637L,元大滬深300正2,20,0,20,元大-蘆洲,2024-09-16,9857
00953B,群益優選非投等債,20,0,20,元大-蘆洲,2024-09-16,9857
5498,凱崴,20,0,20,元大-蘆洲,2024-09-16,9857
4123,晟德,20,0,20,元大-蘆洲,2024-09-16,9857
6015,宏遠證,20,1,19,元大-蘆洲,2024-09-16,9857
6405,悅城,27,9,18,元大-蘆洲,2024-09-16,9857
1909,榮成,21,4,17,元大-蘆洲,2024-09-16,9857
2905,三商,17,0,17,元大-蘆洲,2024-09-16,9857
00935,野村臺灣新科技50,17,0,17,元大-蘆洲,2024-09-16,9857
8028,昇陽半導體,40,24,16,元大-蘆洲,2024-09-16,9857
2014,中鴻,16,0,16,元大-蘆洲,2024-09-16,9857
00882,中信中國高股息,16,0,16,元大-蘆洲,2024-09-16,9857
4979,華星光,42,26,16,元大-蘆洲,2024-09-16,9857
1717,長興,16,0,16,元大-蘆洲,2024-09-16,9857
1301,台塑,33,17,16,元大-蘆洲,2024-09-16,9857
1530,亞崴,15,0,15,元大-蘆洲,2024-09-16,9857
6257,矽格,18,3,15,元大-蘆洲,2024-09-16,9857
8215,明基材,15,1,14,元大-蘆洲,2024-09-16,9857
00929,復華台灣科技優息,747,179,568,元大-蘆洲,2024-09-18,9857
2888,新光金,431,85,346,元大-蘆洲,2024-09-18,9857
00919,群益台灣精選高息,345,42,303,元大-蘆洲,2024-09-18,9857
00680L,元大美債20正2,256,45,211,元大-蘆洲,2024-09-18,9857
00688L,國泰20年美債正2,126,23,103,元大-蘆洲,2024-09-18,9857
2317,鴻海,135,34,101,元大-蘆洲,2024-09-18,9857
1711,永光,263,164,99,元大-蘆洲,2024-09-18,9857
3550,聯穎,159,66,93,元大-蘆洲,2024-09-18,9857
3481,群創,157,83,74,元大-蘆洲,2024-09-18,9857
00687B,國泰20年美債,100,27,73,元大-蘆洲,2024-09-18,9857
1905,華紙,60,0,60,元大-蘆洲,2024-09-18,9857
1773,勝一,62,4,58,元大-蘆洲,2024-09-18,9857
00918,大華優利高填息30,72,14,58,元大-蘆洲,2024-09-18,9857
00713,元大台灣高息低波,58,2,56,元大-蘆洲,2024-09-18,9857
2313,華通,86,33,53,元大-蘆洲,2024-09-18,9857
2344,華邦電,57,6,51,元大-蘆洲,2024-09-18,9857
6706,惠特,103,56,47,元大-蘆洲,2024-09-18,9857
00878,國泰永續高股息,52,11,41,元大-蘆洲,2024-09-18,9857
1304,台聚,42,5,37,元大-蘆洲,2024-09-18,9857
2887,台新金,49,12,37,元大-蘆洲,2024-09-18,9857
2338,光罩,35,1,34,元大-蘆洲,2024-09-18,9857
2882,國泰金,33,0,33,元大-蘆洲,2024-09-18,9857
00915,凱基優選高股息30,53,20,33,元大-蘆洲,2024-09-18,9857
0056,元大高股息,33,1,32,元大-蘆洲,2024-09-18,9857
4306,炎洲,28,0,28,元大-蘆洲,2024-09-18,9857
2303,聯電,34,8,26,元大-蘆洲,2024-09-18,9857
1540,喬福,57,31,26,元大-蘆洲,2024-09-18,9857
2889,國票金,26,0,26,元大-蘆洲,2024-09-18,9857
2408,南亞科,25,0,25,元大-蘆洲,2024-09-18,9857
00679B,元大美債20年,42,17,25,元大-蘆洲,2024-09-18,9857
4927,泰鼎-KY,25,1,24,元大-蘆洲,2024-09-18,9857
6126,信音,22,0,22,元大-蘆洲,2024-09-18,9857
8110,華東,23,1,22,元大-蘆洲,2024-09-18,9857
9105,泰金寶-DR,21,0,21,元大-蘆洲,2024-09-18,9857
1524,耿鼎,34,13,21,元大-蘆洲,2024-09-18,9857
8431,匯鑽科,23,2,21,元大-蘆洲,2024-09-18,9857
2023,燁輝,20,0,20,元大-蘆洲,2024-09-18,9857
00876,元大全球5G,20,0,20,元大-蘆洲,2024-09-18,9857
6770,力積電,21,1,20,元大-蘆洲,2024-09-18,9857
00934,中信成長高股息,19,0,19,元大-蘆洲,2024-09-18,9857
2330,台積電,23,4,19,元大-蘆洲,2024-09-18,9857
00882,中信中國高股息,21,2,19,元大-蘆洲,2024-09-18,9857
2374,佳能,131,113,18,元大-蘆洲,2024-09-18,9857
4906,正文,36,20,16,元大-蘆洲,2024-09-18,9857
6274,台燿,28,13,15,元大-蘆洲,2024-09-18,9857
00932,兆豐永續高息等權,15,0,15,元大-蘆洲,2024-09-18,9857
8028,昇陽半導體,19,4,15,元大-蘆洲,2024-09-18,9857
3189,景碩,34,19,15,元大-蘆洲,2024-09-18,9857
8104,錸寶,18,3,15,元大-蘆洲,2024-09-18,9857
6698,旭暉應材,31,17,14,元大-蘆洲,2024-09-18,9857
00632R,元大台灣50反1,486,151,335,元大-蘆洲,2024-09-19,9857
00680L,元大美債20正2,297,0,297,元大-蘆洲,2024-09-19,9857
00948B,中信優息投資級債,158,0,158,元大-蘆洲,2024-09-19,9857
00919,群益台灣精選高息,117,27,90,元大-蘆洲,2024-09-19,9857
6546,正基,101,13,88,元大-蘆洲,2024-09-19,9857
00929,復華台灣科技優息,146,59,87,元大-蘆洲,2024-09-19,9857
00937B,群益ESG投等債20,105,32,73,元大-蘆洲,2024-09-19,9857
2399,映泰,442,374,68,元大-蘆洲,2024-09-19,9857
00918,大華優利高填息30,72,5,67,元大-蘆洲,2024-09-19,9857
00688L,國泰20年美債正2,143,89,54,元大-蘆洲,2024-09-19,9857
9105,泰金寶-DR,56,3,53,元大-蘆洲,2024-09-19,9857
00706L,期元大S＆P日圓正2,51,0,51,元大-蘆洲,2024-09-19,9857
00945B,凱基美國非投等債,45,1,44,元大-蘆洲,2024-09-19,9857
2303,聯電,46,3,43,元大-蘆洲,2024-09-19,9857
00679B,元大美債20年,107,66,41,元大-蘆洲,2024-09-19,9857
00915,凱基優選高股息30,47,6,41,元大-蘆洲,2024-09-19,9857
00958B,永豐ESG銀行債15,43,6,37,元大-蘆洲,2024-09-19,9857
1717,長興,76,40,36,元大-蘆洲,2024-09-19,9857
2344,華邦電,48,14,34,元大-蘆洲,2024-09-19,9857
2442,新美齊,30,0,30,元大-蘆洲,2024-09-19,9857
00650L,復華香港正2,48,19,29,元大-蘆洲,2024-09-19,9857
2537,聯上發,24,0,24,元大-蘆洲,2024-09-19,9857
1416,廣豐,24,0,24,元大-蘆洲,2024-09-19,9857
3481,群創,81,59,22,元大-蘆洲,2024-09-19,9857
00751B,元大AAA至A公司債,21,0,21,元大-蘆洲,2024-09-19,9857
2514,龍邦,20,0,20,元大-蘆洲,2024-09-19,9857
6163,華電網,31,11,20,元大-蘆洲,2024-09-19,9857
6126,信音,19,0,19,元大-蘆洲,2024-09-19,9857
2891,中信金,43,25,18,元大-蘆洲,2024-09-19,9857
2501,國建,21,3,18,元大-蘆洲,2024-09-19,9857
2610,華航,26,8,18,元大-蘆洲,2024-09-19,9857
00931B,統一美債20年,22,6,16,元大-蘆洲,2024-09-19,9857
4513,福裕,35,19,16,元大-蘆洲,2024-09-19,9857
00877,復華中國5G,15,0,15,元大-蘆洲,2024-09-19,9857
00930,永豐ESG低碳高息,16,2,14,元大-蘆洲,2024-09-19,9857
5469,瀚宇博,14,0,14,元大-蘆洲,2024-09-19,9857
2317,鴻海,29,17,12,元大-蘆洲,2024-09-19,9857
3548,兆利,14,2,12,元大-蘆洲,2024-09-19,9857
4114,健喬,12,0,12,元大-蘆洲,2024-09-19,9857
4903,聯光通,41,29,12,元大-蘆洲,2024-09-19,9857
6125,廣運,35,24,11,元大-蘆洲,2024-09-19,9857
00905,FT臺灣Smart,11,0,11,元大-蘆洲,2024-09-19,9857
2536,宏普,11,0,11,元大-蘆洲,2024-09-19,9857
4526,東台,30,19,11,元大-蘆洲,2024-09-19,9857
3049,精金,620,609,11,元大-蘆洲,2024-09-19,9857
3711,日月光投控,18,8,10,元大-蘆洲,2024-09-19,9857
00779B,凱基美債25+,10,0,10,元大-蘆洲,2024-09-19,9857
3294,英濟,11,1,10,元大-蘆洲,2024-09-19,9857
00655L,國泰中國A50正2,10,0,10,元大-蘆洲,2024-09-19,9857
1806,冠軍,10,0,10,元大-蘆洲,2024-09-19,9857
00632R,元大台灣50反1,195,0,195,元大-蘆洲,2024-09-20,9857
00919,群益台灣精選高息,209,24,185,元大-蘆洲,2024-09-20,9857
00943,兆豐電子高息等權,127,0,127,元大-蘆洲,2024-09-20,9857
1808,潤隆,89,2,87,元大-蘆洲,2024-09-20,9857
00948B,中信優息投資級債,77,4,73,元大-蘆洲,2024-09-20,9857
4903,聯光通,102,36,66,元大-蘆洲,2024-09-20,9857
00688L,國泰20年美債正2,70,11,59,元大-蘆洲,2024-09-20,9857
00892,富邦台灣半導體,61,2,59,元大-蘆洲,2024-09-20,9857
4306,炎洲,59,3,56,元大-蘆洲,2024-09-20,9857
00958B,永豐ESG銀行債15,53,10,43,元大-蘆洲,2024-09-20,9857
00915,凱基優選高股息30,70,28,42,元大-蘆洲,2024-09-20,9857
2542,興富發,73,31,42,元大-蘆洲,2024-09-20,9857
3062,建漢,94,57,37,元大-蘆洲,2024-09-20,9857
2609,陽明,47,10,37,元大-蘆洲,2024-09-20,9857
00637L,元大滬深300正2,42,7,35,元大-蘆洲,2024-09-20,9857
2371,大同,37,3,34,元大-蘆洲,2024-09-20,9857
00679B,元大美債20年,58,28,30,元大-蘆洲,2024-09-20,9857
00712,復華富時不動產,41,12,29,元大-蘆洲,2024-09-20,9857
6177,達麗,32,4,28,元大-蘆洲,2024-09-20,9857
8070,長華*,109,81,28,元大-蘆洲,2024-09-20,9857
2344,華邦電,39,11,28,元大-蘆洲,2024-09-20,9857
00960,野村全球航運龍頭,26,0,26,元大-蘆洲,2024-09-20,9857
9945,潤泰新,66,40,26,元大-蘆洲,2024-09-20,9857
2615,萬海,32,7,25,元大-蘆洲,2024-09-20,9857
2101,南港,27,2,25,元大-蘆洲,2024-09-20,9857
2520,冠德,25,1,24,元大-蘆洲,2024-09-20,9857
6152,百一,24,0,24,元大-蘆洲,2024-09-20,9857
1316,上曜,22,0,22,元大-蘆洲,2024-09-20,9857
3673,TPK-KY,29,7,22,元大-蘆洲,2024-09-20,9857
00918,大華優利高填息30,42,21,21,元大-蘆洲,2024-09-20,9857
5388,中磊,21,0,21,元大-蘆洲,2024-09-20,9857
2399,映泰,735,715,20,元大-蘆洲,2024-09-20,9857
3694,海華,22,2,20,元大-蘆洲,2024-09-20,9857
5234,達興材料,41,22,19,元大-蘆洲,2024-09-20,9857
2545,皇翔,19,0,19,元大-蘆洲,2024-09-20,9857
9105,泰金寶-DR,18,0,18,元大-蘆洲,2024-09-20,9857
5009,榮剛,20,2,18,元大-蘆洲,2024-09-20,9857
2464,盟立,222,205,17,元大-蘆洲,2024-09-20,9857
00942B,台新美A公司債20+,16,0,16,元大-蘆洲,2024-09-20,9857
6609,瀧澤科,58,42,16,元大-蘆洲,2024-09-20,9857
3543,州巧,15,0,15,元大-蘆洲,2024-09-20,9857
00953B,群益優選非投等債,15,0,15,元大-蘆洲,2024-09-20,9857
4555,氣立,15,0,15,元大-蘆洲,2024-09-20,9857
3564,其陽,20,5,15,元大-蘆洲,2024-09-20,9857
00751B,元大AAA至A公司債,14,0,14,元大-蘆洲,2024-09-20,9857
4513,福裕,32,18,14,元大-蘆洲,2024-09-20,9857
1434,福懋,27,13,14,元大-蘆洲,2024-09-20,9857
3390,旭軟,22,8,14,元大-蘆洲,2024-09-20,9857
3622,洋華,26,13,13,元大-蘆洲,2024-09-20,9857
2023,燁輝,13,0,13,元大-蘆洲,2024-09-20,9857
00725B,國泰投資級公司債,256,0,256,元大-蘆洲,2024-09-23,9857
00919,群益台灣精選高息,255,11,244,元大-蘆洲,2024-09-23,9857
2399,映泰,334,234,100,元大-蘆洲,2024-09-23,9857
00687B,國泰20年美債,153,53,100,元大-蘆洲,2024-09-23,9857
00929,復華台灣科技優息,110,27,83,元大-蘆洲,2024-09-23,9857
1711,永光,264,184,80,元大-蘆洲,2024-09-23,9857
00937B,群益ESG投等債20,63,2,61,元大-蘆洲,2024-09-23,9857
00680L,元大美債20正2,63,5,58,元大-蘆洲,2024-09-23,9857
00632R,元大台灣50反1,75,18,57,元大-蘆洲,2024-09-23,9857
00688L,國泰20年美債正2,60,5,55,元大-蘆洲,2024-09-23,9857
6548,長科*,102,51,51,元大-蘆洲,2024-09-23,9857
00679B,元大美債20年,55,5,50,元大-蘆洲,2024-09-23,9857
6788,華景電,50,3,47,元大-蘆洲,2024-09-23,9857
00927,群益半導體收益,50,5,45,元大-蘆洲,2024-09-23,9857
4526,東台,134,89,45,元大-蘆洲,2024-09-23,9857
0056,元大高股息,41,4,37,元大-蘆洲,2024-09-23,9857
3481,群創,75,40,35,元大-蘆洲,2024-09-23,9857
1717,長興,86,57,29,元大-蘆洲,2024-09-23,9857
2464,盟立,58,29,29,元大-蘆洲,2024-09-23,9857
6177,達麗,33,4,29,元大-蘆洲,2024-09-23,9857
5243,乙盛-KY,26,1,25,元大-蘆洲,2024-09-23,9857
2062,橋椿,80,57,23,元大-蘆洲,2024-09-23,9857
3622,洋華,27,4,23,元大-蘆洲,2024-09-23,9857
8111,立��,26,3,23,元大-蘆洲,2024-09-23,9857
6285,啟��,23,1,22,元大-蘆洲,2024-09-23,9857
9945,潤泰新,23,1,22,元大-蘆洲,2024-09-23,9857
2402,毅嘉,21,0,21,元大-蘆洲,2024-09-23,9857
3231,緯創,29,9,20,元大-蘆洲,2024-09-23,9857
4974,亞泰,21,1,20,元大-蘆洲,2024-09-23,9857
3052,夆典,20,0,20,元大-蘆洲,2024-09-23,9857
4967,十銓,22,2,20,元大-蘆洲,2024-09-23,9857
1785,光洋科,39,19,20,元大-蘆洲,2024-09-23,9857
5426,振發,21,2,19,元大-蘆洲,2024-09-23,9857
00942B,台新美A公司債20+,18,0,18,元大-蘆洲,2024-09-23,9857
3149,正達,38,20,18,元大-蘆洲,2024-09-23,9857
5340,建榮,24,7,17,元大-蘆洲,2024-09-23,9857
4542,科嶠,75,58,17,元大-蘆洲,2024-09-23,9857
1808,潤隆,20,4,16,元大-蘆洲,2024-09-23,9857
00931B,統一美債20年,16,0,16,元大-蘆洲,2024-09-23,9857
2023,燁輝,16,0,16,元大-蘆洲,2024-09-23,9857
8088,品安,16,0,16,元大-蘆洲,2024-09-23,9857
4714,永捷,28,12,16,元大-蘆洲,2024-09-23,9857
00934,中信成長高股息,15,0,15,元大-蘆洲,2024-09-23,9857
00753L,中信中國50正2,15,0,15,元大-蘆洲,2024-09-23,9857
4931,新盛力,16,1,15,元大-蘆洲,2024-09-23,9857
2449,京元電子,19,5,14,元大-蘆洲,2024-09-23,9857
2070,精湛,45,31,14,元大-蘆洲,2024-09-23,9857
00948B,中信優息投資級債,17,3,14,元大-蘆洲,2024-09-23,9857
5905,南仁湖,16,2,14,元大-蘆洲,2024-09-23,9857
00960,野村全球航運龍頭,15,1,14,元大-蘆洲,2024-09-23,9857
00632R,元大台灣50反1,254,70,184,元大-蘆洲,2024-09-24,9857
6197,佳必琪,178,4,174,元大-蘆洲,2024-09-24,9857
6104,創惟,179,17,162,元大-蘆洲,2024-09-24,9857
00687B,國泰20年美債,130,14,116,元大-蘆洲,2024-09-24,9857
5905,南仁湖,105,10,95,元大-蘆洲,2024-09-24,9857
2888,新光金,100,24,76,元大-蘆洲,2024-09-24,9857
00919,群益台灣精選高息,82,9,73,元大-蘆洲,2024-09-24,9857
00651R,復華香港反1,60,0,60,元大-蘆洲,2024-09-24,9857
6152,百一,56,0,56,元大-蘆洲,2024-09-24,9857
2477,美隆電,60,4,56,元大-蘆洲,2024-09-24,9857
2349,錸德,117,65,52,元大-蘆洲,2024-09-24,9857
3715,定穎投控,267,217,50,元大-蘆洲,2024-09-24,9857
1717,長興,48,0,48,元大-蘆洲,2024-09-24,9857
3605,宏致,63,17,46,元大-蘆洲,2024-09-24,9857
2505,國揚,45,0,45,元大-蘆洲,2024-09-24,9857
00948B,中信優息投資級債,40,0,40,元大-蘆洲,2024-09-24,9857
3481,群創,51,14,37,元大-蘆洲,2024-09-24,9857
3013,晟銘電,123,86,37,元大-蘆洲,2024-09-24,9857
8096,擎亞,41,8,33,元大-蘆洲,2024-09-24,9857
0056,元大高股息,34,3,31,元大-蘆洲,2024-09-24,9857
00929,復華台灣科技優息,80,49,31,元大-蘆洲,2024-09-24,9857
00679B,元大美債20年,41,14,27,元大-蘆洲,2024-09-24,9857
00878,國泰永續高股息,36,9,27,元大-蘆洲,2024-09-24,9857
2891,中信金,51,27,24,元大-蘆洲,2024-09-24,9857
1503,士電,34,12,22,元大-蘆洲,2024-09-24,9857
6405,悅城,82,60,22,元大-蘆洲,2024-09-24,9857
2537,聯上發,22,0,22,元大-蘆洲,2024-09-24,9857
8086,宏捷科,24,2,22,元大-蘆洲,2024-09-24,9857
2515,中工,22,1,21,元大-蘆洲,2024-09-24,9857
00753L,中信中國50正2,20,0,20,元大-蘆洲,2024-09-24,9857
5388,中磊,20,1,19,元大-蘆洲,2024-09-24,9857
3580,友威科,39,22,17,元大-蘆洲,2024-09-24,9857
1584,精剛,98,81,17,元大-蘆洲,2024-09-24,9857
9945,潤泰新,21,5,16,元大-蘆洲,2024-09-24,9857
911868,同方友友-DR,16,0,16,元大-蘆洲,2024-09-24,9857
6126,信音,21,5,16,元大-蘆洲,2024-09-24,9857
5469,瀚宇博,18,2,16,元大-蘆洲,2024-09-24,9857
3060,銘異,15,0,15,元大-蘆洲,2024-09-24,9857
1815,富喬,17,2,15,元大-蘆洲,2024-09-24,9857
00960,野村全球航運龍頭,22,8,14,元大-蘆洲,2024-09-24,9857
4919,新唐,14,0,14,元大-蘆洲,2024-09-24,9857
3019,亞光,33,19,14,元大-蘆洲,2024-09-24,9857
6224,聚鼎,16,2,14,元大-蘆洲,2024-09-24,9857
1785,光洋科,28,14,14,元大-蘆洲,2024-09-24,9857
4974,亞泰,14,1,13,元大-蘆洲,2024-09-24,9857
3167,大量,102,89,13,元大-蘆洲,2024-09-24,9857
3037,欣興,20,7,13,元大-蘆洲,2024-09-24,9857
2002,中鋼,18,6,12,元大-蘆洲,2024-09-24,9857
2605,新興,20,8,12,元大-蘆洲,2024-09-24,9857
5276,達輝-KY,12,0,12,元大-蘆洲,2024-09-24,9857
00753L,中信中國50正2,164,0,164,元大-蘆洲,2024-09-25,9857
2439,美律,113,2,111,元大-蘆洲,2024-09-25,9857
00923,群益台ESG低碳50,106,2,104,元大-蘆洲,2024-09-25,9857
3550,聯穎,267,184,83,元大-蘆洲,2024-09-25,9857
3209,全科,83,5,78,元大-蘆洲,2024-09-25,9857
2883,凱基金,85,36,49,元大-蘆洲,2024-09-25,9857
00679B,元大美債20年,81,35,46,元大-蘆洲,2024-09-25,9857
00937B,群益ESG投等債20,63,20,43,元大-蘆洲,2024-09-25,9857
00948B,中信優息投資級債,41,0,41,元大-蘆洲,2024-09-25,9857
2889,國票金,41,1,40,元大-蘆洲,2024-09-25,9857
4526,東台,69,33,36,元大-蘆洲,2024-09-25,9857
1711,永光,49,14,35,元大-蘆洲,2024-09-25,9857
4974,亞泰,38,3,35,元大-蘆洲,2024-09-25,9857
00650L,復華香港正2,45,11,34,元大-蘆洲,2024-09-25,9857
9940,信義,35,2,33,元大-蘆洲,2024-09-25,9857
00687B,國泰20年美債,113,81,32,元大-蘆洲,2024-09-25,9857
1522,堤維西,36,4,32,元大-蘆洲,2024-09-25,9857
2888,新光金,64,35,29,元大-蘆洲,2024-09-25,9857
6288,聯嘉,29,1,28,元大-蘆洲,2024-09-25,9857
00945B,凱基美國非投等債,28,0,28,元大-蘆洲,2024-09-25,9857
1709,和益,32,5,27,元大-蘆洲,2024-09-25,9857
00931B,統一美債20年,28,2,26,元大-蘆洲,2024-09-25,9857
00665L,富邦�琤肭磪囓�2,40,16,24,元大-蘆洲,2024-09-25,9857
1524,耿鼎,26,4,22,元大-蘆洲,2024-09-25,9857
6462,神盾,23,1,22,元大-蘆洲,2024-09-25,9857
3037,欣興,34,12,22,元大-蘆洲,2024-09-25,9857
6197,佳必琪,22,1,21,元大-蘆洲,2024-09-25,9857
6156,松上,53,32,21,元大-蘆洲,2024-09-25,9857
2421,建準,21,0,21,元大-蘆洲,2024-09-25,9857
8111,立��,41,20,21,元大-蘆洲,2024-09-25,9857
2337,旺宏,24,3,21,元大-蘆洲,2024-09-25,9857
3705,永信,22,2,20,元大-蘆洲,2024-09-25,9857
2025,千興,20,1,19,元大-蘆洲,2024-09-25,9857
1584,精剛,81,62,19,元大-蘆洲,2024-09-25,9857
6830,汎銓,21,2,19,元大-蘆洲,2024-09-25,9857
3260,威剛,20,3,17,元大-蘆洲,2024-09-25,9857
3481,群創,31,15,16,元大-蘆洲,2024-09-25,9857
00712,復華富時不動產,16,0,16,元大-蘆洲,2024-09-25,9857
8011,台通,20,4,16,元大-蘆洲,2024-09-25,9857
8076,伍豐,46,30,16,元大-蘆洲,2024-09-25,9857
2401,凌陽,19,4,15,元大-蘆洲,2024-09-25,9857
6546,正基,27,12,15,元大-蘆洲,2024-09-25,9857
4157,太景*-KY,15,0,15,元大-蘆洲,2024-09-25,9857
00953B,群益優選非投等債,15,0,15,元大-蘆洲,2024-09-25,9857
2436,偉詮電,81,66,15,元大-蘆洲,2024-09-25,9857
2542,興富發,22,8,14,元大-蘆洲,2024-09-25,9857
3492,長盛,19,6,13,元大-蘆洲,2024-09-25,9857
3363,上詮,37,24,13,元大-蘆洲,2024-09-25,9857
00933B,國泰10Y+金融債,30,18,12,元大-蘆洲,2024-09-25,9857
8096,擎亞,23,11,12,元大-蘆洲,2024-09-25,9857
00712,復華富時不動產,257,11,246,元大-蘆洲,2024-09-26,9857
00937B,群益ESG投等債20,317,134,183,元大-蘆洲,2024-09-26,9857
00948B,中信優息投資級債,188,21,167,元大-蘆洲,2024-09-26,9857
00687B,國泰20年美債,235,108,127,元大-蘆洲,2024-09-26,9857
00680L,元大美債20正2,283,156,127,元大-蘆洲,2024-09-26,9857
00960,野村全球航運龍頭,436,309,127,元大-蘆洲,2024-09-26,9857
3481,群創,296,214,82,元大-蘆洲,2024-09-26,9857
3019,亞光,174,105,69,元大-蘆洲,2024-09-26,9857
2543,皇昌,90,21,69,元大-蘆洲,2024-09-26,9857
1808,潤隆,68,4,64,元大-蘆洲,2024-09-26,9857
00651R,復華香港反1,62,0,62,元大-蘆洲,2024-09-26,9857
2344,華邦電,74,24,50,元大-蘆洲,2024-09-26,9857
2439,美律,47,2,45,元大-蘆洲,2024-09-26,9857
00679B,元大美債20年,111,67,44,元大-蘆洲,2024-09-26,9857
1904,正隆,43,0,43,元大-蘆洲,2024-09-26,9857
1540,喬福,97,54,43,元大-蘆洲,2024-09-26,9857
3673,TPK-KY,51,9,42,元大-蘆洲,2024-09-26,9857
00931B,統一美債20年,47,10,37,元大-蘆洲,2024-09-26,9857
00923,群益台ESG低碳50,39,4,35,元大-蘆洲,2024-09-26,9857
00918,大華優利高填息30,37,7,30,元大-蘆洲,2024-09-26,9857
3033,威健,35,5,30,元大-蘆洲,2024-09-26,9857
4919,新唐,30,0,30,元大-蘆洲,2024-09-26,9857
2615,萬海,222,193,29,元大-蘆洲,2024-09-26,9857
2613,中櫃,98,70,28,元大-蘆洲,2024-09-26,9857
0056,元大高股息,34,7,27,元大-蘆洲,2024-09-26,9857
00713,元大台灣高息低波,37,12,25,元大-蘆洲,2024-09-26,9857
3605,宏致,45,20,25,元大-蘆洲,2024-09-26,9857
2495,普安,47,22,25,元大-蘆洲,2024-09-26,9857
00676R,富邦臺灣加權反1,25,0,25,元大-蘆洲,2024-09-26,9857
8105,凌巨,24,0,24,元大-蘆洲,2024-09-26,9857
00942B,台新美A公司債20+,24,0,24,元大-蘆洲,2024-09-26,9857
00958B,永豐ESG銀行債15,23,0,23,元大-蘆洲,2024-09-26,9857
00706L,期元大S＆P日圓正2,22,0,22,元大-蘆洲,2024-09-26,9857
2542,興富發,36,14,22,元大-蘆洲,2024-09-26,9857
3296,勝德,23,2,21,元大-蘆洲,2024-09-26,9857
2313,華通,25,5,20,元大-蘆洲,2024-09-26,9857
2482,連宇,20,0,20,元大-蘆洲,2024-09-26,9857
4157,太景*-KY,20,0,20,元大-蘆洲,2024-09-26,9857
4977,眾達-KY,22,3,19,元大-蘆洲,2024-09-26,9857
5871,中租-KY,20,1,19,元大-蘆洲,2024-09-26,9857
3588,通嘉,29,11,18,元大-蘆洲,2024-09-26,9857
3498,陽程,24,6,18,元大-蘆洲,2024-09-26,9857
3714,富采,18,0,18,元大-蘆洲,2024-09-26,9857
00632R,元大台灣50反1,29,11,18,元大-蘆洲,2024-09-26,9857
00688L,國泰20年美債正2,39,22,17,元大-蘆洲,2024-09-26,9857
6197,佳必琪,66,49,17,元大-蘆洲,2024-09-26,9857
2317,鴻海,59,43,16,元大-蘆洲,2024-09-26,9857
6830,汎銓,43,27,16,元大-蘆洲,2024-09-26,9857
4716,大立,79,63,16,元大-蘆洲,2024-09-26,9857
2408,南亞科,62,46,16,元大-蘆洲,2024-09-26,9857
00687B,國泰20年美債,401,46,355,元大-蘆洲,2024-09-27,9857
00712,復華富時不動產,225,1,224,元大-蘆洲,2024-09-27,9857
00680L,元大美債20正2,227,11,216,元大-蘆洲,2024-09-27,9857
00960,野村全球航運龍頭,210,81,129,元大-蘆洲,2024-09-27,9857
00945B,凱基美國非投等債,121,0,121,元大-蘆洲,2024-09-27,9857
00752,中信中國50,126,18,108,元大-蘆洲,2024-09-27,9857
00948B,中信優息投資級債,106,2,104,元大-蘆洲,2024-09-27,9857
00688L,國泰20年美債正2,98,1,97,元大-蘆洲,2024-09-27,9857
00679B,元大美債20年,99,38,61,元大-蘆洲,2024-09-27,9857
2891,中信金,70,19,51,元大-蘆洲,2024-09-27,9857
2888,新光金,52,4,48,元大-蘆洲,2024-09-27,9857
6147,頎邦,54,11,43,元大-蘆洲,2024-09-27,9857
1326,台化,55,12,43,元大-蘆洲,2024-09-27,9857
00651R,復華香港反1,40,0,40,元大-蘆洲,2024-09-27,9857
00947,台新臺灣IC設計,36,0,36,元大-蘆洲,2024-09-27,9857
3622,洋華,41,5,36,元大-蘆洲,2024-09-27,9857
6215,和椿,37,1,36,元大-蘆洲,2024-09-27,9857
2886,兆豐金,37,2,35,元大-蘆洲,2024-09-27,9857
1460,宏遠,35,0,35,元大-蘆洲,2024-09-27,9857
3149,正達,149,116,33,元大-蘆洲,2024-09-27,9857
00931B,統一美債20年,38,6,32,元大-蘆洲,2024-09-27,9857
2371,大同,81,50,31,元大-蘆洲,2024-09-27,9857
1799,易威,30,0,30,元大-蘆洲,2024-09-27,9857
2520,冠德,29,0,29,元大-蘆洲,2024-09-27,9857
1313,聯成,33,4,29,元大-蘆洲,2024-09-27,9857
2388,威盛,47,18,29,元大-蘆洲,2024-09-27,9857
4979,華星光,169,141,28,元大-蘆洲,2024-09-27,9857
2883,凱基金,44,16,28,元大-蘆洲,2024-09-27,9857
00706L,期元大S＆P日圓正2,27,0,27,元大-蘆洲,2024-09-27,9857
2017,官田鋼,31,4,27,元大-蘆洲,2024-09-27,9857
2884,玉山金,23,0,23,元大-蘆洲,2024-09-27,9857
8277,商丞,23,0,23,元大-蘆洲,2024-09-27,9857
00636,國泰中國A50,26,3,23,元大-蘆洲,2024-09-27,9857
00937B,群益ESG投等債20,105,83,22,元大-蘆洲,2024-09-27,9857
3041,揚智,31,9,22,元大-蘆洲,2024-09-27,9857
3013,晟銘電,65,43,22,元大-蘆洲,2024-09-27,9857
3605,宏致,49,28,21,元大-蘆洲,2024-09-27,9857
3019,亞光,61,41,20,元大-蘆洲,2024-09-27,9857
1540,喬福,73,53,20,元大-蘆洲,2024-09-27,9857
2415,錩新,27,7,20,元大-蘆洲,2024-09-27,9857
2834,臺企銀,20,1,19,元大-蘆洲,2024-09-27,9857
3339,泰谷,31,12,19,元大-蘆洲,2024-09-27,9857
8076,伍豐,34,15,19,元大-蘆洲,2024-09-27,9857
2402,毅嘉,17,0,17,元大-蘆洲,2024-09-27,9857
3550,聯穎,31,14,17,元大-蘆洲,2024-09-27,9857
2363,矽統,155,138,17,元大-蘆洲,2024-09-27,9857
00942B,台新美A公司債20+,16,0,16,元大-蘆洲,2024-09-27,9857
00751B,元大AAA至A公司債,18,2,16,元大-蘆洲,2024-09-27,9857
3363,上詮,35,20,15,元大-蘆洲,2024-09-27,9857
6285,啟��,17,2,15,元大-蘆洲,2024-09-27,9857
00687B,國泰20年美債,507,7,500,元大-蘆洲,2024-09-30,9857
00929,復華台灣科技優息,351,13,338,元大-蘆洲,2024-09-30,9857
00919,群益台灣精選高息,316,51,265,元大-蘆洲,2024-09-30,9857
2605,新興,474,237,237,元大-蘆洲,2024-09-30,9857
00679B,元大美債20年,237,10,227,元大-蘆洲,2024-09-30,9857
00940,元大台灣價值高息,196,17,179,元大-蘆洲,2024-09-30,9857
00881,國泰台灣5G+,69,2,67,元大-蘆洲,2024-09-30,9857
00945B,凱基美國非投等債,66,0,66,元大-蘆洲,2024-09-30,9857
2009,第一銅,67,9,58,元大-蘆洲,2024-09-30,9857
00948B,中信優息投資級債,63,9,54,元大-蘆洲,2024-09-30,9857
1522,堤維西,53,1,52,元大-蘆洲,2024-09-30,9857
3305,昇貿,53,4,49,元大-蘆洲,2024-09-30,9857
00952,凱基台灣AI50,50,3,47,元大-蘆洲,2024-09-30,9857
2330,台積電,48,6,42,元大-蘆洲,2024-09-30,9857
2609,陽明,180,141,39,元大-蘆洲,2024-09-30,9857
5439,高技,39,2,37,元大-蘆洲,2024-09-30,9857
3622,洋華,50,13,37,元大-蘆洲,2024-09-30,9857
2883,凱基金,48,11,37,元大-蘆洲,2024-09-30,9857
2007,燁興,45,11,34,元大-蘆洲,2024-09-30,9857
2489,瑞軒,38,6,32,元大-蘆洲,2024-09-30,9857
00918,大華優利高填息30,33,1,32,元大-蘆洲,2024-09-30,9857
2615,萬海,231,201,30,元大-蘆洲,2024-09-30,9857
2382,廣達,32,3,29,元大-蘆洲,2024-09-30,9857
2002,中鋼,91,63,28,元大-蘆洲,2024-09-30,9857
3037,欣興,50,23,27,元大-蘆洲,2024-09-30,9857
2313,華通,40,15,25,元大-蘆洲,2024-09-30,9857
2303,聯電,32,7,25,元大-蘆洲,2024-09-30,9857
00753L,中信中國50正2,95,70,25,元大-蘆洲,2024-09-30,9857
2537,聯上發,25,0,25,元大-蘆洲,2024-09-30,9857
00927,群益半導體收益,26,1,25,元大-蘆洲,2024-09-30,9857
8105,凌巨,24,0,24,元大-蘆洲,2024-09-30,9857
2312,金寶,198,175,23,元大-蘆洲,2024-09-30,9857
4714,永捷,25,2,23,元大-蘆洲,2024-09-30,9857
0050,元大台灣50,26,6,20,元大-蘆洲,2024-09-30,9857
4707,磐亞,20,0,20,元大-蘆洲,2024-09-30,9857
1524,耿鼎,23,3,20,元大-蘆洲,2024-09-30,9857
1815,富喬,21,2,19,元大-蘆洲,2024-09-30,9857
00688L,國泰20年美債正2,69,50,19,元大-蘆洲,2024-09-30,9857
1609,大亞,30,11,19,元大-蘆洲,2024-09-30,9857
2317,鴻海,51,32,19,元大-蘆洲,2024-09-30,9857
1582,信錦,22,5,17,元大-蘆洲,2024-09-30,9857
006208,富邦台50,22,5,17,元大-蘆洲,2024-09-30,9857
3711,日月光投控,28,11,17,元大-蘆洲,2024-09-30,9857
3694,海華,19,2,17,元大-蘆洲,2024-09-30,9857
2030,彰源,20,3,17,元大-蘆洲,2024-09-30,9857
3231,緯創,23,7,16,元大-蘆洲,2024-09-30,9857
00946,群益科技高息成長,18,2,16,元大-蘆洲,2024-09-30,9857
2023,燁輝,21,5,16,元大-蘆洲,2024-09-30,9857
3189,景碩,17,1,16,元大-蘆洲,2024-09-30,9857
2436,偉詮電,29,13,16,元大-蘆洲,2024-09-30,9857
00753L,中信中國50正2,263,16,247,元大-蘆洲,2024-10-01,9857
00929,復華台灣科技優息,238,49,189,元大-蘆洲,2024-10-01,9857
0056,元大高股息,103,7,96,元大-蘆洲,2024-10-01,9857
2605,新興,141,58,83,元大-蘆洲,2024-10-01,9857
00960,野村全球航運龍頭,73,2,71,元大-蘆洲,2024-10-01,9857
00919,群益台灣精選高息,99,39,60,元大-蘆洲,2024-10-01,9857
00937B,群益ESG投等債20,68,10,58,元大-蘆洲,2024-10-01,9857
2014,中鴻,170,114,56,元大-蘆洲,2024-10-01,9857
00687B,國泰20年美債,76,22,54,元大-蘆洲,2024-10-01,9857
0061,元大寶滬深,50,0,50,元大-蘆洲,2024-10-01,9857
3481,群創,68,25,43,元大-蘆洲,2024-10-01,9857
3576,聯合再生,63,20,43,元大-蘆洲,2024-10-01,9857
00637L,元大滬深300正2,108,66,42,元大-蘆洲,2024-10-01,9857
2489,瑞軒,42,2,40,元大-蘆洲,2024-10-01,9857
2344,華邦電,44,5,39,元大-蘆洲,2024-10-01,9857
1539,巨庭,37,0,37,元大-蘆洲,2024-10-01,9857
2317,鴻海,70,33,37,元大-蘆洲,2024-10-01,9857
00922,國泰台灣領袖50,31,0,31,元大-蘆洲,2024-10-01,9857
6548,長科*,29,0,29,元大-蘆洲,2024-10-01,9857
2891,中信金,35,6,29,元大-蘆洲,2024-10-01,9857
1337,再生-KY,47,20,27,元大-蘆洲,2024-10-01,9857
2888,新光金,37,10,27,元大-蘆洲,2024-10-01,9857
6244,茂迪,25,0,25,元大-蘆洲,2024-10-01,9857
2834,臺企銀,25,0,25,元大-蘆洲,2024-10-01,9857
00946,群益科技高息成長,32,8,24,元大-蘆洲,2024-10-01,9857
3013,晟銘電,36,12,24,元大-蘆洲,2024-10-01,9857
1301,台塑,34,10,24,元大-蘆洲,2024-10-01,9857
3715,定穎投控,42,20,22,元大-蘆洲,2024-10-01,9857
00650L,復華香港正2,37,16,21,元大-蘆洲,2024-10-01,9857
6770,力積電,22,1,21,元大-蘆洲,2024-10-01,9857
1460,宏遠,21,0,21,元大-蘆洲,2024-10-01,9857
00715L,期街口布蘭特正2,20,0,20,元大-蘆洲,2024-10-01,9857
2542,興富發,18,0,18,元大-蘆洲,2024-10-01,9857
00713,元大台灣高息低波,29,10,19,元大-蘆洲,2024-10-01,9857
2362,藍天,40,22,18,元大-蘆洲,2024-10-01,9857
2316,楠梓電,19,2,17,元大-蘆洲,2024-10-01,9857
1711,永光,22,5,17,元大-蘆洲,2024-10-01,9857
00878,國泰永續高股息,49,32,17,元大-蘆洲,2024-10-01,9857
2371,大同,19,3,16,元大-蘆洲,2024-10-01,9857
00680L,元大美債20正2,50,34,16,元大-蘆洲,2024-10-01,9857
00905,FT臺灣Smart,16,0,16,元大-蘆洲,2024-10-01,9857
8027,鈦昇,16,0,16,元大-蘆洲,2024-10-01,9857
1809,中釉,20,4,16,元大-蘆洲,2024-10-01,9857
5871,中租-KY,21,6,15,元大-蘆洲,2024-10-01,9857
1504,東元,20,5,15,元大-蘆洲,2024-10-01,9857
2913,農林,15,0,15,元大-蘆洲,2024-10-01,9857
2455,全新,86,71,15,元大-蘆洲,2024-10-01,9857
4157,太景*-KY,15,0,15,元大-蘆洲,2024-10-01,9857
2515,中工,14,0,14,元大-蘆洲,2024-10-01,9857
5483,中美晶,15,1,14,元大-蘆洲,2024-10-01,9857
00919,群益台灣精選高息,527,12,515,元大-蘆洲,2024-10-04,9857
00940,元大台灣價值高息,512,29,483,元大-蘆洲,2024-10-04,9857
00680L,元大美債20正2,271,40,231,元大-蘆洲,2024-10-04,9857
00712,復華富時不動產,199,1,198,元大-蘆洲,2024-10-04,9857
2609,陽明,234,84,150,元大-蘆洲,2024-10-04,9857
0056,元大高股息,144,4,140,元大-蘆洲,2024-10-04,9857
2618,長榮航,172,33,139,元大-蘆洲,2024-10-04,9857
2610,華航,111,7,104,元大-蘆洲,2024-10-04,9857
2603,長榮,119,37,82,元大-蘆洲,2024-10-04,9857
00878,國泰永續高股息,91,14,77,元大-蘆洲,2024-10-04,9857
2498,宏達電,249,173,76,元大-蘆洲,2024-10-04,9857
2206,三陽工業,73,0,73,元大-蘆洲,2024-10-04,9857
00918,大華優利高填息30,79,9,70,元大-蘆洲,2024-10-04,9857
00673R,期元大S＆P原油反1,70,0,70,元大-蘆洲,2024-10-04,9857
00713,元大台灣高息低波,68,1,67,元大-蘆洲,2024-10-04,9857
2887,台新金,62,3,59,元大-蘆洲,2024-10-04,9857
8927,北基,55,0,55,元大-蘆洲,2024-10-04,9857
2890,永豐金,53,1,52,元大-蘆洲,2024-10-04,9857
00948B,中信優息投資級債,52,0,52,元大-蘆洲,2024-10-04,9857
00706L,期元大S＆P日圓正2,52,0,52,元大-蘆洲,2024-10-04,9857
00688L,國泰20年美債正2,60,10,50,元大-蘆洲,2024-10-04,9857
2353,宏��,41,2,39,元大-蘆洲,2024-10-04,9857
2303,聯電,44,6,38,元大-蘆洲,2024-10-04,9857
3339,泰谷,37,0,37,元大-蘆洲,2024-10-04,9857
3062,建漢,48,11,37,元大-蘆洲,2024-10-04,9857
3376,新日興,37,3,34,元大-蘆洲,2024-10-04,9857
8249,菱光,41,7,34,元大-蘆洲,2024-10-04,9857
4903,聯光通,156,122,34,元大-蘆洲,2024-10-04,9857
2834,臺企銀,34,0,34,元大-蘆洲,2024-10-04,9857
00960,野村全球航運龍頭,40,7,33,元大-蘆洲,2024-10-04,9857
00922,國泰台灣領袖50,34,1,33,元大-蘆洲,2024-10-04,9857
0061,元大寶滬深,38,6,32,元大-蘆洲,2024-10-04,9857
00679B,元大美債20年,51,19,32,元大-蘆洲,2024-10-04,9857
2382,廣達,41,13,28,元大-蘆洲,2024-10-04,9857
00795B,中信美國公債20年,28,0,28,元大-蘆洲,2024-10-04,9857
00937B,群益ESG投等債20,41,15,26,元大-蘆洲,2024-10-04,9857
2489,瑞軒,32,7,25,元大-蘆洲,2024-10-04,9857
4915,致伸,30,5,25,元大-蘆洲,2024-10-04,9857
2028,威致,24,0,24,元大-蘆洲,2024-10-04,9857
2884,玉山金,35,13,22,元大-蘆洲,2024-10-04,9857
2515,中工,22,0,22,元大-蘆洲,2024-10-04,9857
5439,高技,22,0,22,元大-蘆洲,2024-10-04,9857
8070,長華*,35,13,22,元大-蘆洲,2024-10-04,9857
2313,華通,35,14,21,元大-蘆洲,2024-10-04,9857
2367,燿華,24,3,21,元大-蘆洲,2024-10-04,9857
1785,光洋科,38,18,20,元大-蘆洲,2024-10-04,9857
6689,伊雲谷,20,0,20,元大-蘆洲,2024-10-04,9857
3707,漢磊,20,1,19,元大-蘆洲,2024-10-04,9857
1340,勝悅-KY,20,1,19,元大-蘆洲,2024-10-04,9857
2402,毅嘉,27,8,19,元大-蘆洲,2024-10-04,9857
00637L,元大滬深300正2,701,64,637,元大-蘆洲,2024-10-07,9857
00919,群益台灣精選高息,227,4,223,元大-蘆洲,2024-10-07,9857
00632R,元大台灣50反1,201,20,181,元大-蘆洲,2024-10-07,9857
0061,元大寶滬深,161,3,158,元大-蘆洲,2024-10-07,9857
2618,長榮航,122,1,121,元大-蘆洲,2024-10-07,9857
00937B,群益ESG投等債20,115,6,109,元大-蘆洲,2024-10-07,9857
00753L,中信中國50正2,193,109,84,元大-蘆洲,2024-10-07,9857
00882,中信中國高股息,232,149,83,元大-蘆洲,2024-10-07,9857
00929,復華台灣科技優息,87,16,71,元大-蘆洲,2024-10-07,9857
2609,陽明,119,57,62,元大-蘆洲,2024-10-07,9857
2317,鴻海,144,86,58,元大-蘆洲,2024-10-07,9857
00636,國泰中國A50,54,2,52,元大-蘆洲,2024-10-07,9857
2887,台新金,52,4,48,元大-蘆洲,2024-10-07,9857
0056,元大高股息,90,46,44,元大-蘆洲,2024-10-07,9857
2615,萬海,93,52,41,元大-蘆洲,2024-10-07,9857
00639,富邦深100,45,3,42,元大-蘆洲,2024-10-07,9857
00706L,期元大S＆P日圓正2,41,0,41,元大-蘆洲,2024-10-07,9857
00887,永豐中國科技50大,125,85,40,元大-蘆洲,2024-10-07,9857
00915,凱基優選高股息30,43,4,39,元大-蘆洲,2024-10-07,9857
00946,群益科技高息成長,36,0,36,元大-蘆洲,2024-10-07,9857
5243,乙盛-KY,36,1,35,元大-蘆洲,2024-10-07,9857
8431,匯鑽科,34,0,34,元大-蘆洲,2024-10-07,9857
00688L,國泰20年美債正2,44,10,34,元大-蘆洲,2024-10-07,9857
2303,聯電,40,8,32,元大-蘆洲,2024-10-07,9857
00679B,元大美債20年,57,26,31,元大-蘆洲,2024-10-07,9857
8927,北基,30,0,30,元大-蘆洲,2024-10-07,9857
3062,建漢,36,8,28,元大-蘆洲,2024-10-07,9857
3189,景碩,44,16,28,元大-蘆洲,2024-10-07,9857
3714,富采,34,6,28,元大-蘆洲,2024-10-07,9857
6530,創威,101,74,27,元大-蘆洲,2024-10-07,9857
2436,偉詮電,34,8,26,元大-蘆洲,2024-10-07,9857
00943,兆豐電子高息等權,25,0,25,元大-蘆洲,2024-10-07,9857
00643,群益深証中小,23,0,23,元大-蘆洲,2024-10-07,9857
3481,群創,34,12,22,元大-蘆洲,2024-10-07,9857
8111,立��,187,165,22,元大-蘆洲,2024-10-07,9857
4967,十銓,24,2,22,元大-蘆洲,2024-10-07,9857
2031,新光鋼,21,0,21,元大-蘆洲,2024-10-07,9857
006205,富邦上証,20,0,20,元大-蘆洲,2024-10-07,9857
00725B,國泰投資級公司債,22,2,20,元大-蘆洲,2024-10-07,9857
4909,新復興,60,41,19,元大-蘆洲,2024-10-07,9857
3025,星通,186,167,19,元大-蘆洲,2024-10-07,9857
1907,永豐餘,20,1,19,元大-蘆洲,2024-10-07,9857
4903,聯光通,97,78,19,元大-蘆洲,2024-10-07,9857
8104,錸寶,24,5,19,元大-蘆洲,2024-10-07,9857
3312,弘憶股,24,6,18,元大-蘆洲,2024-10-07,9857
2014,中鴻,23,5,18,元大-蘆洲,2024-10-07,9857
4958,臻鼎-KY,19,2,17,元大-蘆洲,2024-10-07,9857
8404,百和興業-KY,89,72,17,元大-蘆洲,2024-10-07,9857
2354,鴻準,17,1,16,元大-蘆洲,2024-10-07,9857
00751B,元大AAA至A公司債,17,1,16,元大-蘆洲,2024-10-07,9857
00712,復華富時不動產,317,10,307,元大-蘆洲,2024-10-08,9857
00919,群益台灣精選高息,238,7,231,元大-蘆洲,2024-10-08,9857
00637L,元大滬深300正2,988,802,186,元大-蘆洲,2024-10-08,9857
00929,復華台灣科技優息,277,94,183,元大-蘆洲,2024-10-08,9857
00753L,中信中國50正2,336,191,145,元大-蘆洲,2024-10-08,9857
3049,精金,167,52,115,元大-蘆洲,2024-10-08,9857
0056,元大高股息,130,16,114,元大-蘆洲,2024-10-08,9857
0061,元大寶滬深,128,25,103,元大-蘆洲,2024-10-08,9857
2355,敬鵬,102,0,102,元大-蘆洲,2024-10-08,9857
00673R,期元大S＆P原油反1,96,0,96,元大-蘆洲,2024-10-08,9857
00940,元大台灣價值高息,152,60,92,元大-蘆洲,2024-10-08,9857
00665L,富邦�琤肭磪囓�2,99,11,88,元大-蘆洲,2024-10-08,9857
2880,華南金,82,0,82,元大-蘆洲,2024-10-08,9857
00937B,群益ESG投等債20,81,2,79,元大-蘆洲,2024-10-08,9857
00948B,中信優息投資級債,103,30,73,元大-蘆洲,2024-10-08,9857
3037,欣興,75,7,68,元大-蘆洲,2024-10-08,9857
00922,國泰台灣領袖50,74,7,67,元大-蘆洲,2024-10-08,9857
00680L,元大美債20正2,86,23,63,元大-蘆洲,2024-10-08,9857
2892,第一金,61,2,59,元大-蘆洲,2024-10-08,9857
2360,致茂,64,9,55,元大-蘆洲,2024-10-08,9857
00687B,國泰20年美債,165,110,55,元大-蘆洲,2024-10-08,9857
1314,中石化,78,28,50,元大-蘆洲,2024-10-08,9857
6449,鈺邦,52,3,49,元大-蘆洲,2024-10-08,9857
3149,正達,266,218,48,元大-蘆洲,2024-10-08,9857
3481,群創,55,9,46,元大-蘆洲,2024-10-08,9857
00918,大華優利高填息30,45,0,45,元大-蘆洲,2024-10-08,9857
2883,凱基金,85,43,42,元大-蘆洲,2024-10-08,9857
8927,北基,40,0,40,元大-蘆洲,2024-10-08,9857
2399,映泰,301,262,39,元大-蘆洲,2024-10-08,9857
00725B,國泰投資級公司債,38,0,38,元大-蘆洲,2024-10-08,9857
00877,復華中國5G,46,9,37,元大-蘆洲,2024-10-08,9857
2408,南亞科,37,2,35,元大-蘆洲,2024-10-08,9857
2303,聯電,46,13,33,元大-蘆洲,2024-10-08,9857
2363,矽統,129,96,33,元大-蘆洲,2024-10-08,9857
4960,誠美材,30,0,30,元大-蘆洲,2024-10-08,9857
00946,群益科技高息成長,32,2,30,元大-蘆洲,2024-10-08,9857
00905,FT臺灣Smart,34,5,29,元大-蘆洲,2024-10-08,9857
3189,景碩,28,0,28,元大-蘆洲,2024-10-08,9857
2328,廣宇,28,0,28,元大-蘆洲,2024-10-08,9857
2610,華航,29,2,27,元大-蘆洲,2024-10-08,9857
5876,上海商銀,27,0,27,元大-蘆洲,2024-10-08,9857
00933B,國泰10Y+金融債,25,0,25,元大-蘆洲,2024-10-08,9857
00881,國泰台灣5G+,26,3,23,元大-蘆洲,2024-10-08,9857
6133,金橋,23,1,22,元大-蘆洲,2024-10-08,9857
912000,晨訊科-DR,21,0,21,元大-蘆洲,2024-10-08,9857
00878,國泰永續高股息,62,42,20,元大-蘆洲,2024-10-08,9857
1524,耿鼎,21,1,20,元大-蘆洲,2024-10-08,9857
00655L,國泰中國A50正2,32,12,20,元大-蘆洲,2024-10-08,9857
3357,臺慶科,20,0,20,元大-蘆洲,2024-10-08,9857
00915,凱基優選高股息30,20,1,19,元大-蘆洲,2024-10-08,9857
00680L,元大美債20正2,351,31,320,元大-蘆洲,2024-10-09,9857
00753L,中信中國50正2,973,708,265,元大-蘆洲,2024-10-09,9857
00887,永豐中國科技50大,294,93,201,元大-蘆洲,2024-10-09,9857
3380,明泰,235,76,159,元大-蘆洲,2024-10-09,9857
00687B,國泰20年美債,147,5,142,元大-蘆洲,2024-10-09,9857
00637L,元大滬深300正2,362,233,129,元大-蘆洲,2024-10-09,9857
3037,欣興,155,38,117,元大-蘆洲,2024-10-09,9857
3049,精金,148,39,109,元大-蘆洲,2024-10-09,9857
00937B,群益ESG投等債20,100,7,93,元大-蘆洲,2024-10-09,9857
0056,元大高股息,90,15,75,元大-蘆洲,2024-10-09,9857
8927,北基,70,0,70,元大-蘆洲,2024-10-09,9857
00922,國泰台灣領袖50,68,3,65,元大-蘆洲,2024-10-09,9857
1314,中石化,188,123,65,元大-蘆洲,2024-10-09,9857
00656R,國泰中國A50反1,54,0,54,元大-蘆洲,2024-10-09,9857
2303,聯電,58,6,52,元大-蘆洲,2024-10-09,9857
00795B,中信美國公債20年,55,5,50,元大-蘆洲,2024-10-09,9857
2891,中信金,75,31,44,元大-蘆洲,2024-10-09,9857
2206,三陽工業,44,0,44,元大-蘆洲,2024-10-09,9857
2609,陽明,75,31,44,元大-蘆洲,2024-10-09,9857
2363,矽統,461,418,43,元大-蘆洲,2024-10-09,9857
00948B,中信優息投資級債,41,0,41,元大-蘆洲,2024-10-09,9857
00639,富邦深100,146,105,41,元大-蘆洲,2024-10-09,9857
6449,鈺邦,48,7,41,元大-蘆洲,2024-10-09,9857
3591,艾笛森,80,40,40,元大-蘆洲,2024-10-09,9857
2892,第一金,35,1,34,元大-蘆洲,2024-10-09,9857
2603,長榮,38,5,33,元大-蘆洲,2024-10-09,9857
8028,昇陽半導體,58,26,32,元大-蘆洲,2024-10-09,9857
4991,環宇-KY,31,1,30,元大-蘆洲,2024-10-09,9857
1569,濱川,36,7,29,元大-蘆洲,2024-10-09,9857
2344,華邦電,49,21,28,元大-蘆洲,2024-10-09,9857
3715,定穎投控,50,24,26,元大-蘆洲,2024-10-09,9857
2014,中鴻,40,14,26,元大-蘆洲,2024-10-09,9857
5531,鄉林,36,10,26,元大-蘆洲,2024-10-09,9857
00712,復華富時不動產,32,7,25,元大-蘆洲,2024-10-09,9857
2890,永豐金,25,1,24,元大-蘆洲,2024-10-09,9857
1718,中纖,23,0,23,元大-蘆洲,2024-10-09,9857
2542,興富發,21,0,21,元大-蘆洲,2024-10-09,9857
00715L,期街口布蘭特正2,22,1,21,元大-蘆洲,2024-10-09,9857
6284,佳邦,22,1,21,元大-蘆洲,2024-10-09,9857
2880,華南金,21,0,21,元大-蘆洲,2024-10-09,9857
3324,雙鴻,27,7,20,元大-蘆洲,2024-10-09,9857
3622,洋華,24,4,20,元大-蘆洲,2024-10-09,9857
2313,華通,55,36,19,元大-蘆洲,2024-10-09,9857
1611,中電,20,1,19,元大-蘆洲,2024-10-09,9857
2417,圓剛,18,0,18,元大-蘆洲,2024-10-09,9857
3265,台星科,22,4,18,元大-蘆洲,2024-10-09,9857
00915,凱基優選高股息30,23,5,18,元大-蘆洲,2024-10-09,9857
6770,力積電,17,0,17,元大-蘆洲,2024-10-09,9857
2376,技嘉,26,9,17,元大-蘆洲,2024-10-09,9857
1815,富喬,26,9,17,元大-蘆洲,2024-10-09,9857
3710,連展投控,184,12,172,元大-蘆洲,2024-10-11,9857
2834,臺企銀,171,6,165,元大-蘆洲,2024-10-11,9857
00687B,國泰20年美債,174,18,156,元大-蘆洲,2024-10-11,9857
00680L,元大美債20正2,103,0,103,元大-蘆洲,2024-10-11,9857
00679B,元大美債20年,105,5,100,元大-蘆洲,2024-10-11,9857
00753L,中信中國50正2,135,38,97,元大-蘆洲,2024-10-11,9857
00673R,期元大S＆P原油反1,75,2,73,元大-蘆洲,2024-10-11,9857
0056,元大高股息,101,30,71,元大-蘆洲,2024-10-11,9857
1314,中石化,107,40,67,元大-蘆洲,2024-10-11,9857
2812,台中銀,55,0,55,元大-蘆洲,2024-10-11,9857
2889,國票金,53,0,53,元大-蘆洲,2024-10-11,9857
00725B,國泰投資級公司債,53,0,53,元大-蘆洲,2024-10-11,9857
00688L,國泰20年美債正2,80,32,48,元大-蘆洲,2024-10-11,9857
4909,新復興,52,4,48,元大-蘆洲,2024-10-11,9857
3149,正達,230,183,47,元大-蘆洲,2024-10-11,9857
4991,環宇-KY,53,6,47,元大-蘆洲,2024-10-11,9857
4927,泰鼎-KY,43,1,42,元大-蘆洲,2024-10-11,9857
00637L,元大滬深300正2,108,67,41,元大-蘆洲,2024-10-11,9857
00934,中信成長高股息,50,10,40,元大-蘆洲,2024-10-11,9857
2449,京元電子,220,181,39,元大-蘆洲,2024-10-11,9857
1721,三晃,63,26,37,元大-蘆洲,2024-10-11,9857
2887,台新金,62,26,36,元大-蘆洲,2024-10-11,9857
00948B,中信優息投資級債,35,0,35,元大-蘆洲,2024-10-11,9857
3591,艾笛森,72,37,35,元大-蘆洲,2024-10-11,9857
00918,大華優利高填息30,35,0,35,元大-蘆洲,2024-10-11,9857
8111,立��,153,118,35,元大-蘆洲,2024-10-11,9857
00922,國泰台灣領袖50,35,1,34,元大-蘆洲,2024-10-11,9857
3481,群創,35,3,32,元大-蘆洲,2024-10-11,9857
00882,中信中國高股息,82,52,30,元大-蘆洲,2024-10-11,9857
00632R,元大台灣50反1,29,0,29,元大-蘆洲,2024-10-11,9857
00655L,國泰中國A50正2,29,0,29,元大-蘆洲,2024-10-11,9857
4903,聯光通,116,88,28,元大-蘆洲,2024-10-11,9857
2388,威盛,49,22,27,元大-蘆洲,2024-10-11,9857
00891,中信關鍵半導體,27,0,27,元大-蘆洲,2024-10-11,9857
00919,群益台灣精選高息,73,47,26,元大-蘆洲,2024-10-11,9857
00720B,元大投資級公司債,27,2,25,元大-蘆洲,2024-10-11,9857
2367,燿華,29,4,25,元大-蘆洲,2024-10-11,9857
2888,新光金,29,4,25,元大-蘆洲,2024-10-11,9857
6284,佳邦,25,1,24,元大-蘆洲,2024-10-11,9857
5439,高技,26,3,23,元大-蘆洲,2024-10-11,9857
3597,映興,30,7,23,元大-蘆洲,2024-10-11,9857
2363,矽統,139,117,22,元大-蘆洲,2024-10-11,9857
2002,中鋼,22,1,21,元大-蘆洲,2024-10-11,9857
3162,精確,57,37,20,元大-蘆洲,2024-10-11,9857
2303,聯電,37,17,20,元大-蘆洲,2024-10-11,9857
00931B,統一美債20年,20,1,19,元大-蘆洲,2024-10-11,9857
6530,創威,53,34,19,元大-蘆洲,2024-10-11,9857
8027,鈦昇,20,1,19,元大-蘆洲,2024-10-11,9857
3189,景碩,28,9,19,元大-蘆洲,2024-10-11,9857
00639,富邦深100,21,3,18,元大-蘆洲,2024-10-11,9857
00679B,元大美債20年,473,57,416,元大-蘆洲,2024-10-14,9857
00687B,國泰20年美債,177,4,173,元大-蘆洲,2024-10-14,9857
00887,永豐中國科技50大,128,13,115,元大-蘆洲,2024-10-14,9857
3710,連展投控,121,12,109,元大-蘆洲,2024-10-14,9857
0056,元大高股息,118,14,104,元大-蘆洲,2024-10-14,9857
00945B,凱基美國非投等債,102,10,92,元大-蘆洲,2024-10-14,9857
00680L,元大美債20正2,125,40,85,元大-蘆洲,2024-10-14,9857
00933B,國泰10Y+金融債,67,16,51,元大-蘆洲,2024-10-14,9857
4991,環宇-KY,56,5,51,元大-蘆洲,2024-10-14,9857
2206,三陽工業,51,1,50,元大-蘆洲,2024-10-14,9857
2312,金寶,597,549,48,元大-蘆洲,2024-10-14,9857
00922,國泰台灣領袖50,53,12,41,元大-蘆洲,2024-10-14,9857
00651R,復華香港反1,40,0,40,元大-蘆洲,2024-10-14,9857
00720B,元大投資級公司債,39,0,39,元大-蘆洲,2024-10-14,9857
00712,復華富時不動產,39,1,38,元大-蘆洲,2024-10-14,9857
00753L,中信中國50正2,59,21,38,元大-蘆洲,2024-10-14,9857
00937B,群益ESG投等債20,189,154,35,元大-蘆洲,2024-10-14,9857
00650L,復華香港正2,37,3,34,元大-蘆洲,2024-10-14,9857
2801,彰銀,31,1,30,元大-蘆洲,2024-10-14,9857
00681R,元大美債20反1,30,0,30,元大-蘆洲,2024-10-14,9857
3230,錦明,54,27,27,元大-蘆洲,2024-10-14,9857
6202,盛群,32,6,26,元大-蘆洲,2024-10-14,9857
00915,凱基優選高股息30,26,2,24,元大-蘆洲,2024-10-14,9857
2344,華邦電,26,2,24,元大-蘆洲,2024-10-14,9857
4303,信立,24,0,24,元大-蘆洲,2024-10-14,9857
00940,元大台灣價值高息,25,1,24,元大-蘆洲,2024-10-14,9857
0061,元大寶滬深,23,0,23,元大-蘆洲,2024-10-14,9857
4903,聯光通,81,58,23,元大-蘆洲,2024-10-14,9857
6224,聚鼎,41,19,22,元大-蘆洲,2024-10-14,9857
6156,松上,41,19,22,元大-蘆洲,2024-10-14,9857
00931B,統一美債20年,20,0,20,元大-蘆洲,2024-10-14,9857
1608,華榮,20,0,20,元大-蘆洲,2024-10-14,9857
00673R,期元大S＆P原油反1,20,0,20,元大-蘆洲,2024-10-14,9857
3481,群創,34,15,19,元大-蘆洲,2024-10-14,9857
00665L,富邦�琤肭磪囓�2,26,7,19,元大-蘆洲,2024-10-14,9857
2845,遠東銀,19,0,19,元大-蘆洲,2024-10-14,9857
00692,富邦公司治理,20,2,18,元大-蘆洲,2024-10-14,9857
2426,鼎元,53,36,17,元大-蘆洲,2024-10-14,9857
0050,元大台灣50,19,2,17,元大-蘆洲,2024-10-14,9857
2905,三商,16,0,16,元大-蘆洲,2024-10-14,9857
00912,中信臺灣智慧50,15,0,15,元大-蘆洲,2024-10-14,9857
9945,潤泰新,14,0,14,元大-蘆洲,2024-10-14,9857
2363,矽統,87,73,14,元大-蘆洲,2024-10-14,9857
2002,中鋼,18,4,14,元大-蘆洲,2024-10-14,9857
3376,新日興,29,16,13,元大-蘆洲,2024-10-14,9857
3715,定穎投控,46,33,13,元大-蘆洲,2024-10-14,9857
2101,南港,13,0,13,元大-蘆洲,2024-10-14,9857
1802,台玻,12,0,12,元大-蘆洲,2024-10-14,9857
006208,富邦台50,14,2,12,元大-蘆洲,2024-10-14,9857
4569,六方科-KY,13,1,12,元大-蘆洲,2024-10-14,9857
00679B,元大美債20年,795,11,784,元大-蘆洲,2024-10-15,9857
00632R,元大台灣50反1,455,1,454,元大-蘆洲,2024-10-15,9857
00680L,元大美債20正2,243,5,238,元大-蘆洲,2024-10-15,9857
4991,環宇-KY,140,9,131,元大-蘆洲,2024-10-15,9857
00687B,國泰20年美債,109,5,104,元大-蘆洲,2024-10-15,9857
00937B,群益ESG投等債20,91,22,69,元大-蘆洲,2024-10-15,9857
4979,華星光,133,68,65,元大-蘆洲,2024-10-15,9857
00715L,期街口布蘭特正2,65,0,65,元大-蘆洲,2024-10-15,9857
2887,台新金,91,33,58,元大-蘆洲,2024-10-15,9857
00650L,復華香港正2,49,0,49,元大-蘆洲,2024-10-15,9857
2344,華邦電,65,17,48,元大-蘆洲,2024-10-15,9857
3231,緯創,69,23,46,元大-蘆洲,2024-10-15,9857
2313,華通,54,18,36,元大-蘆洲,2024-10-15,9857
00664R,國泰臺灣加權反1,34,0,34,元大-蘆洲,2024-10-15,9857
6530,創威,66,40,26,元大-蘆洲,2024-10-15,9857
2243,宏旭-KY,26,0,26,元大-蘆洲,2024-10-15,9857
2303,聯電,35,10,25,元大-蘆洲,2024-10-15,9857
00943,兆豐電子高息等權,25,0,25,元大-蘆洲,2024-10-15,9857
3013,晟銘電,110,85,25,元大-蘆洲,2024-10-15,9857
6449,鈺邦,27,3,24,元大-蘆洲,2024-10-15,9857
2101,南港,22,0,22,元大-蘆洲,2024-10-15,9857
2520,冠德,26,5,21,元大-蘆洲,2024-10-15,9857
4927,泰鼎-KY,20,0,20,元大-蘆洲,2024-10-15,9857
5009,榮剛,21,1,20,元大-蘆洲,2024-10-15,9857
2809,京城銀,20,0,20,元大-蘆洲,2024-10-15,9857
2601,益航,19,0,19,元大-蘆洲,2024-10-15,9857
3605,宏致,30,11,19,元大-蘆洲,2024-10-15,9857
9945,潤泰新,31,12,19,元大-蘆洲,2024-10-15,9857
1815,富喬,19,1,18,元大-蘆洲,2024-10-15,9857
0056,元大高股息,80,62,18,元大-蘆洲,2024-10-15,9857
3189,景碩,23,6,17,元大-蘆洲,2024-10-15,9857
3673,TPK-KY,17,0,17,元大-蘆洲,2024-10-15,9857
00655L,國泰中國A50正2,17,0,17,元大-蘆洲,2024-10-15,9857
00922,國泰台灣領袖50,64,47,17,元大-蘆洲,2024-10-15,9857
2615,萬海,24,8,16,元大-蘆洲,2024-10-15,9857
2312,金寶,466,450,16,元大-蘆洲,2024-10-15,9857
4956,光鋐,129,113,16,元大-蘆洲,2024-10-15,9857
00753L,中信中國50正2,16,0,16,元大-蘆洲,2024-10-15,9857
2399,映泰,218,202,16,元大-蘆洲,2024-10-15,9857
8076,伍豐,15,0,15,元大-蘆洲,2024-10-15,9857
5439,高技,15,0,15,元大-蘆洲,2024-10-15,9857
2543,皇昌,30,16,14,元大-蘆洲,2024-10-15,9857
1522,堤維西,15,1,14,元大-蘆洲,2024-10-15,9857
2020,美亞,13,0,13,元大-蘆洲,2024-10-15,9857
3576,聯合再生,15,2,13,元大-蘆洲,2024-10-15,9857
00961,FT臺灣永續高息,13,0,13,元大-蘆洲,2024-10-15,9857
4906,正文,13,0,13,元大-蘆洲,2024-10-15,9857
8027,鈦昇,20,8,12,元大-蘆洲,2024-10-15,9857
1319,東陽,12,0,12,元大-蘆洲,2024-10-15,9857
3042,晶技,14,2,12,元大-蘆洲,2024-10-15,9857
0056,元大高股息,268,17,251,元大-蘆洲,2024-10-16,9857
3710,連展投控,199,29,170,元大-蘆洲,2024-10-16,9857
2303,聯電,135,9,126,元大-蘆洲,2024-10-16,9857
00948B,中信優息投資級債,136,40,96,元大-蘆洲,2024-10-16,9857
00922,國泰台灣領袖50,98,5,93,元大-蘆洲,2024-10-16,9857
00912,中信臺灣智慧50,78,0,78,元大-蘆洲,2024-10-16,9857
2002,中鋼,74,4,70,元大-蘆洲,2024-10-16,9857
00882,中信中國高股息,61,0,61,元大-蘆洲,2024-10-16,9857
9105,泰金寶-DR,339,289,50,元大-蘆洲,2024-10-16,9857
2880,華南金,46,0,46,元大-蘆洲,2024-10-16,9857
6182,合晶,42,1,41,元大-蘆洲,2024-10-16,9857
3230,錦明,44,7,37,元大-蘆洲,2024-10-16,9857
2887,台新金,51,16,35,元大-蘆洲,2024-10-16,9857
9945,潤泰新,36,7,29,元大-蘆洲,2024-10-16,9857
2376,技嘉,32,3,29,元大-蘆洲,2024-10-16,9857
3290,東浦,30,1,29,元大-蘆洲,2024-10-16,9857
6274,台燿,43,15,28,元大-蘆洲,2024-10-16,9857
2905,三商,28,0,28,元大-蘆洲,2024-10-16,9857
4440,宜新實業,28,1,27,元大-蘆洲,2024-10-16,9857
5876,上海商銀,26,0,26,元大-蘆洲,2024-10-16,9857
00753L,中信中國50正2,28,2,26,元大-蘆洲,2024-10-16,9857
2365,昆盈,102,76,26,元大-蘆洲,2024-10-16,9857
00887,永豐中國科技50大,87,62,25,元大-蘆洲,2024-10-16,9857
8021,尖點,32,7,25,元大-蘆洲,2024-10-16,9857
6770,力積電,102,80,22,元大-蘆洲,2024-10-16,9857
2344,華邦電,39,17,22,元大-蘆洲,2024-10-16,9857
00891,中信關鍵半導體,21,0,21,元大-蘆洲,2024-10-16,9857
1721,三晃,21,0,21,元大-蘆洲,2024-10-16,9857
3036,文曄,21,0,21,元大-蘆洲,2024-10-16,9857
3450,聯鈞,95,74,21,元大-蘆洲,2024-10-16,9857
4960,誠美材,20,0,20,元大-蘆洲,2024-10-16,9857
5230,雷笛克光學,28,8,20,元大-蘆洲,2024-10-16,9857
1314,中石化,20,1,19,元大-蘆洲,2024-10-16,9857
1605,華新,36,17,19,元大-蘆洲,2024-10-16,9857
8097,常珵,54,36,18,元大-蘆洲,2024-10-16,9857
2888,新光金,71,53,18,元大-蘆洲,2024-10-16,9857
2330,台積電,28,10,18,元大-蘆洲,2024-10-16,9857
4535,至興,17,0,17,元大-蘆洲,2024-10-16,9857
00907,永豐優息存股,20,3,17,元大-蘆洲,2024-10-16,9857
1609,大亞,17,1,16,元大-蘆洲,2024-10-16,9857
006208,富邦台50,18,2,16,元大-蘆洲,2024-10-16,9857
00830,國泰費城半導體,16,0,16,元大-蘆洲,2024-10-16,9857
6202,盛群,20,4,16,元大-蘆洲,2024-10-16,9857
2882,國泰金,18,2,16,元大-蘆洲,2024-10-16,9857
00881,國泰台灣5G+,31,16,15,元大-蘆洲,2024-10-16,9857
6215,和椿,42,27,15,元大-蘆洲,2024-10-16,9857
6164,華興,17,2,15,元大-蘆洲,2024-10-16,9857
8431,匯鑽科,15,0,15,元大-蘆洲,2024-10-16,9857
6167,久正,16,1,15,元大-蘆洲,2024-10-16,9857
00706L,期元大S＆P日圓正2,15,0,15,元大-蘆洲,2024-10-16,9857
0056,元大高股息,135,6,129,元大-蘆洲,2024-10-17,9857
00887,永豐中國科技50大,137,25,112,元大-蘆洲,2024-10-17,9857
2356,英業達,104,14,90,元大-蘆洲,2024-10-17,9857
00922,國泰台灣領袖50,85,9,76,元大-蘆洲,2024-10-17,9857
9105,泰金寶-DR,122,49,73,元大-蘆洲,2024-10-17,9857
2888,新光金,72,3,69,元大-蘆洲,2024-10-17,9857
3710,連展投控,97,35,62,元大-蘆洲,2024-10-17,9857
5452,佶優,177,115,62,元大-蘆洲,2024-10-17,9857
00637L,元大滬深300正2,61,1,60,元大-蘆洲,2024-10-17,9857
00919,群益台灣精選高息,72,12,60,元大-蘆洲,2024-10-17,9857
00680L,元大美債20正2,51,2,49,元大-蘆洲,2024-10-17,9857
2449,京元電子,88,40,48,元大-蘆洲,2024-10-17,9857
2303,聯電,53,7,46,元大-蘆洲,2024-10-17,9857
6788,華景電,46,0,46,元大-蘆洲,2024-10-17,9857
1301,台塑,44,3,41,元大-蘆洲,2024-10-17,9857
2344,華邦電,43,5,38,元大-蘆洲,2024-10-17,9857
2365,昆盈,80,43,37,元大-蘆洲,2024-10-17,9857
2891,中信金,41,5,36,元大-蘆洲,2024-10-17,9857
00706L,期元大S＆P日圓正2,35,0,35,元大-蘆洲,2024-10-17,9857
00753L,中信中國50正2,35,0,35,元大-蘆洲,2024-10-17,9857
6257,矽格,48,13,35,元大-蘆洲,2024-10-17,9857
00948B,中信優息投資級債,31,0,31,元大-蘆洲,2024-10-17,9857
6151,晉倫,48,17,31,元大-蘆洲,2024-10-17,9857
00665L,富邦�琤肭磪囓�2,61,31,30,元大-蘆洲,2024-10-17,9857
00669R,國泰美國道瓊反1,30,0,30,元大-蘆洲,2024-10-17,9857
6658,聯策,72,44,28,元大-蘆洲,2024-10-17,9857
00933B,國泰10Y+金融債,28,0,28,元大-蘆洲,2024-10-17,9857
2537,聯上發,31,4,27,元大-蘆洲,2024-10-17,9857
2405,輔信,31,5,26,元大-蘆洲,2024-10-17,9857
4977,眾達-KY,29,5,24,元大-蘆洲,2024-10-17,9857
8027,鈦昇,23,0,23,元大-蘆洲,2024-10-17,9857
00929,復華台灣科技優息,82,61,21,元大-蘆洲,2024-10-17,9857
00891,中信關鍵半導體,21,0,21,元大-蘆洲,2024-10-17,9857
6274,台燿,32,12,20,元大-蘆洲,2024-10-17,9857
6770,力積電,31,11,20,元大-蘆洲,2024-10-17,9857
3062,建漢,145,126,19,元大-蘆洲,2024-10-17,9857
2354,鴻準,21,2,19,元大-蘆洲,2024-10-17,9857
00650L,復華香港正2,20,1,19,元大-蘆洲,2024-10-17,9857
2543,皇昌,39,22,17,元大-蘆洲,2024-10-17,9857
6188,廣明,24,7,17,元大-蘆洲,2024-10-17,9857
2887,台新金,17,0,17,元大-蘆洲,2024-10-17,9857
3209,全科,114,97,17,元大-蘆洲,2024-10-17,9857
4576,大銀微系統,24,8,16,元大-蘆洲,2024-10-17,9857
3060,銘異,34,18,16,元大-蘆洲,2024-10-17,9857
00878,國泰永續高股息,29,14,15,元大-蘆洲,2024-10-17,9857
6505,台塑化,15,0,15,元大-蘆洲,2024-10-17,9857
8277,商丞,15,0,15,元大-蘆洲,2024-10-17,9857
2330,台積電,21,7,14,元大-蘆洲,2024-10-17,9857
6763,綠界科技*,37,23,14,元大-蘆洲,2024-10-17,9857
8111,立��,69,55,14,元大-蘆洲,2024-10-17,9857
00687B,國泰20年美債,489,4,485,元大-蘆洲,2024-10-18,9857
00632R,元大台灣50反1,525,181,344,元大-蘆洲,2024-10-18,9857
00937B,群益ESG投等債20,233,30,203,元大-蘆洲,2024-10-18,9857
00680L,元大美債20正2,235,34,201,元大-蘆洲,2024-10-18,9857
00679B,元大美債20年,165,13,152,元大-蘆洲,2024-10-18,9857
2303,聯電,126,18,108,元大-蘆洲,2024-10-18,9857
00664R,國泰臺灣加權反1,90,0,90,元大-蘆洲,2024-10-18,9857
0056,元大高股息,90,17,73,元大-蘆洲,2024-10-18,9857
00753L,中信中國50正2,61,2,59,元大-蘆洲,2024-10-18,9857
2609,陽明,110,51,59,元大-蘆洲,2024-10-18,9857
1528,恩德,123,66,57,元大-蘆洲,2024-10-18,9857
2449,京元電子,93,36,57,元大-蘆洲,2024-10-18,9857
2408,南亞科,54,4,50,元大-蘆洲,2024-10-18,9857
00950B,凱基A級公司債,50,0,50,元大-蘆洲,2024-10-18,9857
00688L,國泰20年美債正2,55,5,50,元大-蘆洲,2024-10-18,9857
00915,凱基優選高股息30,56,8,48,元大-蘆洲,2024-10-18,9857
3062,建漢,61,15,46,元大-蘆洲,2024-10-18,9857
00706L,期元大S＆P日圓正2,45,0,45,元大-蘆洲,2024-10-18,9857
2367,燿華,51,8,43,元大-蘆洲,2024-10-18,9857
5347,世界,56,13,43,元大-蘆洲,2024-10-18,9857
1802,台玻,43,2,41,元大-蘆洲,2024-10-18,9857
3710,連展投控,55,16,39,元大-蘆洲,2024-10-18,9857
2867,三商壽,57,20,37,元大-蘆洲,2024-10-18,9857
00948B,中信優息投資級債,36,0,36,元大-蘆洲,2024-10-18,9857
2376,技嘉,38,2,36,元大-蘆洲,2024-10-18,9857
00712,復華富時不動產,36,0,36,元大-蘆洲,2024-10-18,9857
00648R,元大S＆P500反1,35,0,35,元大-蘆洲,2024-10-18,9857
00671R,富邦NASDAQ反1,35,0,35,元大-蘆洲,2024-10-18,9857
00650L,復華香港正2,30,0,30,元大-蘆洲,2024-10-18,9857
2312,金寶,92,65,27,元大-蘆洲,2024-10-18,9857
3450,聯鈞,58,32,26,元大-蘆洲,2024-10-18,9857
00669R,國泰美國道瓊反1,25,0,25,元大-蘆洲,2024-10-18,9857
00942B,台新美A公司債20+,24,0,24,元大-蘆洲,2024-10-18,9857
4903,聯光通,36,14,22,元大-蘆洲,2024-10-18,9857
4562,穎漢,183,162,21,元大-蘆洲,2024-10-18,9857
2405,輔信,21,0,21,元大-蘆洲,2024-10-18,9857
2374,佳能,76,56,20,元大-蘆洲,2024-10-18,9857
4303,信立,21,1,20,元大-蘆洲,2024-10-18,9857
2014,中鴻,21,1,20,元大-蘆洲,2024-10-18,9857
8110,華東,20,0,20,元大-蘆洲,2024-10-18,9857
00795B,中信美國公債20年,19,0,19,元大-蘆洲,2024-10-18,9857
3011,今皓,88,69,19,元大-蘆洲,2024-10-18,9857
00725B,國泰投資級公司債,20,1,19,元大-蘆洲,2024-10-18,9857
1815,富喬,20,2,18,元大-蘆洲,2024-10-18,9857
6274,台燿,20,2,18,元大-蘆洲,2024-10-18,9857
2498,宏達電,30,12,18,元大-蘆洲,2024-10-18,9857
00933B,國泰10Y+金融債,18,0,18,元大-蘆洲,2024-10-18,9857
00931B,統一美債20年,19,1,18,元大-蘆洲,2024-10-18,9857
1314,中石化,20,3,17,元大-蘆洲,2024-10-18,9857
8064,東捷,39,22,17,元大-蘆洲,2024-10-18,9857
00937B,群益ESG投等債20,359,43,316,元大-蘆洲,2024-10-21,9857
00753L,中信中國50正2,246,30,216,元大-蘆洲,2024-10-21,9857
00887,永豐中國科技50大,196,20,176,元大-蘆洲,2024-10-21,9857
2883,凱基金,151,4,147,元大-蘆洲,2024-10-21,9857
00632R,元大台灣50反1,151,10,141,元大-蘆洲,2024-10-21,9857
1721,三晃,130,33,97,元大-蘆洲,2024-10-21,9857
1909,榮成,95,0,95,元大-蘆洲,2024-10-21,9857
00637L,元大滬深300正2,104,14,90,元大-蘆洲,2024-10-21,9857
00795B,中信美國公債20年,69,0,69,元大-蘆洲,2024-10-21,9857
00715L,期街口布蘭特正2,65,0,65,元大-蘆洲,2024-10-21,9857
00679B,元大美債20年,96,39,57,元大-蘆洲,2024-10-21,9857
00687B,國泰20年美債,103,52,51,元大-蘆洲,2024-10-21,9857
00948B,中信優息投資級債,54,7,47,元大-蘆洲,2024-10-21,9857
2886,兆豐金,46,0,46,元大-蘆洲,2024-10-21,9857
2402,毅嘉,51,9,42,元大-蘆洲,2024-10-21,9857
2303,聯電,60,18,42,元大-蘆洲,2024-10-21,9857
4526,東台,59,21,38,元大-蘆洲,2024-10-21,9857
00725B,國泰投資級公司債,45,10,35,元大-蘆洲,2024-10-21,9857
2618,長榮航,43,11,32,元大-蘆洲,2024-10-21,9857
00907,永豐優息存股,32,0,32,元大-蘆洲,2024-10-21,9857
2891,中信金,52,23,29,元大-蘆洲,2024-10-21,9857
8027,鈦昇,105,78,27,元大-蘆洲,2024-10-21,9857
00878,國泰永續高股息,33,7,26,元大-蘆洲,2024-10-21,9857
3013,晟銘電,111,85,26,元大-蘆洲,2024-10-21,9857
2882,國泰金,26,1,25,元大-蘆洲,2024-10-21,9857
6213,聯茂,27,3,24,元大-蘆洲,2024-10-21,9857
00942B,台新美A公司債20+,21,0,21,元大-蘆洲,2024-10-21,9857
4510,高鋒,60,39,21,元大-蘆洲,2024-10-21,9857
00697B,元大美債7-10,21,0,21,元大-蘆洲,2024-10-21,9857
00643,群益深証中小,20,0,20,元大-蘆洲,2024-10-21,9857
2023,燁輝,20,0,20,元大-蘆洲,2024-10-21,9857
3294,英濟,21,2,19,元大-蘆洲,2024-10-21,9857
2881,富邦金,19,1,18,元大-蘆洲,2024-10-21,9857
00751B,元大AAA至A公司債,18,0,18,元大-蘆洲,2024-10-21,9857
00933B,國泰10Y+金融債,18,0,18,元大-蘆洲,2024-10-21,9857
6425,易發,24,6,18,元大-蘆洲,2024-10-21,9857
2408,南亞科,24,7,17,元大-蘆洲,2024-10-21,9857
8431,匯鑽科,19,2,17,元大-蘆洲,2024-10-21,9857
8404,百和興業-KY,15,0,15,元大-蘆洲,2024-10-21,9857
4576,大銀微系統,101,86,15,元大-蘆洲,2024-10-21,9857
3094,聯傑,14,0,14,元大-蘆洲,2024-10-21,9857
2885,元大金,13,1,12,元大-蘆洲,2024-10-21,9857
2542,興富發,13,1,12,元大-蘆洲,2024-10-21,9857
6763,綠界科技*,45,34,11,元大-蘆洲,2024-10-21,9857
2421,建準,20,9,11,元大-蘆洲,2024-10-21,9857
6548,長科*,11,0,11,元大-蘆洲,2024-10-21,9857
00945B,凱基美國非投等債,11,0,11,元大-蘆洲,2024-10-21,9857
1569,濱川,16,5,11,元大-蘆洲,2024-10-21,9857
2369,菱生,11,0,11,元大-蘆洲,2024-10-21,9857
00642U,期元大S＆P石油,11,0,11,元大-蘆洲,2024-10-21,9857
00680L,元大美債20正2,701,75,626,元大-蘆洲,2024-10-22,9857
00937B,群益ESG投等債20,634,40,594,元大-蘆洲,2024-10-22,9857
00712,復華富時不動產,485,1,484,元大-蘆洲,2024-10-22,9857
00687B,國泰20年美債,455,102,353,元大-蘆洲,2024-10-22,9857
00948B,中信優息投資級債,304,2,302,元大-蘆洲,2024-10-22,9857
00679B,元大美債20年,283,3,280,元大-蘆洲,2024-10-22,9857
2618,長榮航,288,41,247,元大-蘆洲,2024-10-22,9857
00959B,大華投等美債15Y+,166,0,166,元大-蘆洲,2024-10-22,9857
00950B,凱基A級公司債,110,0,110,元大-蘆洲,2024-10-22,9857
00933B,國泰10Y+金融債,98,5,93,元大-蘆洲,2024-10-22,9857
00929,復華台灣科技優息,117,36,81,元大-蘆洲,2024-10-22,9857
2363,矽統,149,82,67,元大-蘆洲,2024-10-22,9857
3715,定穎投控,138,72,66,元大-蘆洲,2024-10-22,9857
2883,凱基金,62,9,53,元大-蘆洲,2024-10-22,9857
00919,群益台灣精選高息,57,5,52,元大-蘆洲,2024-10-22,9857
8155,博智,71,20,51,元大-蘆洲,2024-10-22,9857
00688L,國泰20年美債正2,107,60,47,元大-蘆洲,2024-10-22,9857
6609,瀧澤科,83,36,47,元大-蘆洲,2024-10-22,9857
9105,泰金寶-DR,68,23,45,元大-蘆洲,2024-10-22,9857
00725B,國泰投資級公司債,44,0,44,元大-蘆洲,2024-10-22,9857
00665L,富邦�琤肭磪囓�2,50,10,40,元大-蘆洲,2024-10-22,9857
2891,中信金,56,18,38,元大-蘆洲,2024-10-22,9857
1909,榮成,34,0,34,元大-蘆洲,2024-10-22,9857
3481,群創,83,51,32,元大-蘆洲,2024-10-22,9857
00942B,台新美A公司債20+,36,5,31,元大-蘆洲,2024-10-22,9857
00753L,中信中國50正2,153,125,28,元大-蘆洲,2024-10-22,9857
2344,華邦電,28,1,27,元大-蘆洲,2024-10-22,9857
8021,尖點,69,42,27,元大-蘆洲,2024-10-22,9857
2303,聯電,29,4,25,元大-蘆洲,2024-10-22,9857
2543,皇昌,44,19,25,元大-蘆洲,2024-10-22,9857
00945B,凱基美國非投等債,24,0,24,元大-蘆洲,2024-10-22,9857
3390,旭軟,22,1,21,元大-蘆洲,2024-10-22,9857
3031,佰鴻,21,0,21,元大-蘆洲,2024-10-22,9857
2489,瑞軒,29,9,20,元大-蘆洲,2024-10-22,9857
3675,德微,20,0,20,元大-蘆洲,2024-10-22,9857
8064,東捷,85,66,19,元大-蘆洲,2024-10-22,9857
00931B,統一美債20年,19,0,19,元大-蘆洲,2024-10-22,9857
5386,青雲,33,14,19,元大-蘆洲,2024-10-22,9857
3290,東浦,42,23,19,元大-蘆洲,2024-10-22,9857
1597,直得,53,34,19,元大-蘆洲,2024-10-22,9857
2609,陽明,79,61,18,元大-蘆洲,2024-10-22,9857
2634,漢翔,18,0,18,元大-蘆洲,2024-10-22,9857
0056,元大高股息,24,7,17,元大-蘆洲,2024-10-22,9857
00951,台新日本半導體,17,0,17,元大-蘆洲,2024-10-22,9857
2349,錸德,28,11,17,元大-蘆洲,2024-10-22,9857
00720B,元大投資級公司債,17,0,17,元大-蘆洲,2024-10-22,9857
1301,台塑,17,1,16,元大-蘆洲,2024-10-22,9857
3094,聯傑,16,0,16,元大-蘆洲,2024-10-22,9857
8110,華東,17,1,16,元大-蘆洲,2024-10-22,9857
1582,信錦,41,25,16,元大-蘆洲,2024-10-22,9857
00937B,群益ESG投等債20,389,15,374,元大-蘆洲,2024-10-23,9857
00680L,元大美債20正2,289,16,273,元大-蘆洲,2024-10-23,9857
00712,復華富時不動產,183,7,176,元大-蘆洲,2024-10-23,9857
6788,華景電,131,0,131,元大-蘆洲,2024-10-23,9857
00882,中信中國高股息,142,25,117,元大-蘆洲,2024-10-23,9857
00943,兆豐電子高息等權,116,5,111,元大-蘆洲,2024-10-23,9857
00687B,國泰20年美債,102,10,92,元大-蘆洲,2024-10-23,9857
2329,華泰,216,130,86,元大-蘆洲,2024-10-23,9857
00679B,元大美債20年,81,14,67,元大-蘆洲,2024-10-23,9857
2409,友達,76,19,57,元大-蘆洲,2024-10-23,9857
00878,國泰永續高股息,78,21,57,元大-蘆洲,2024-10-23,9857
00706L,期元大S＆P日圓正2,50,0,50,元大-蘆洲,2024-10-23,9857
00919,群益台灣精選高息,51,1,50,元大-蘆洲,2024-10-23,9857
2880,華南金,49,0,49,元大-蘆洲,2024-10-23,9857
00673R,期元大S＆P原油反1,46,0,46,元大-蘆洲,2024-10-23,9857
2303,聯電,53,7,46,元大-蘆洲,2024-10-23,9857
9945,潤泰新,45,0,45,元大-蘆洲,2024-10-23,9857
00907,永豐優息存股,45,0,45,元大-蘆洲,2024-10-23,9857
2889,國票金,42,0,42,元大-蘆洲,2024-10-23,9857
2002,中鋼,45,3,42,元大-蘆洲,2024-10-23,9857
2449,京元電子,49,8,41,元大-蘆洲,2024-10-23,9857
00650L,復華香港正2,40,0,40,元大-蘆洲,2024-10-23,9857
6120,達運,38,1,37,元大-蘆洲,2024-10-23,9857
5905,南仁湖,39,2,37,元大-蘆洲,2024-10-23,9857
00959B,大華投等美債15Y+,36,0,36,元大-蘆洲,2024-10-23,9857
6770,力積電,116,80,36,元大-蘆洲,2024-10-23,9857
6213,聯茂,58,24,34,元大-蘆洲,2024-10-23,9857
5425,台半,47,14,33,元大-蘆洲,2024-10-23,9857
2887,台新金,42,9,33,元大-蘆洲,2024-10-23,9857
3376,新日興,37,5,32,元大-蘆洲,2024-10-23,9857
1314,中石化,42,10,32,元大-蘆洲,2024-10-23,9857
2344,華邦電,38,6,32,元大-蘆洲,2024-10-23,9857
006208,富邦台50,32,0,32,元大-蘆洲,2024-10-23,9857
00900,富邦特選高股息30,29,0,29,元大-蘆洲,2024-10-23,9857
2886,兆豐金,37,9,28,元大-蘆洲,2024-10-23,9857
0056,元大高股息,51,25,26,元大-蘆洲,2024-10-23,9857
8027,鈦昇,33,8,25,元大-蘆洲,2024-10-23,9857
5876,上海商銀,25,0,25,元大-蘆洲,2024-10-23,9857
2317,鴻海,36,10,26,元大-蘆洲,2024-10-23,9857
00940,元大台灣價值高息,50,25,25,元大-蘆洲,2024-10-23,9857
00633L,富邦上証正2,25,0,25,元大-蘆洲,2024-10-23,9857
00941,中信上游半導體,24,0,24,元大-蘆洲,2024-10-23,9857
2542,興富發,24,1,23,元大-蘆洲,2024-10-23,9857
00905,FT臺灣Smart,24,1,23,元大-蘆洲,2024-10-23,9857
00881,國泰台灣5G+,22,0,22,元大-蘆洲,2024-10-23,9857
3013,晟銘電,49,27,22,元大-蘆洲,2024-10-23,9857
9105,泰金寶-DR,25,3,22,元大-蘆洲,2024-10-23,9857
00918,大華優利高填息30,23,1,22,元大-蘆洲,2024-10-23,9857
00933B,國泰10Y+金融債,21,0,21,元大-蘆洲,2024-10-23,9857
3037,欣興,159,138,21,元大-蘆洲,2024-10-23,9857
00929,復華台灣科技優息,256,25,231,元大-蘆洲,2024-10-24,9857
00937B,群益ESG投等債20,212,13,199,元大-蘆洲,2024-10-24,9857
0056,元大高股息,181,4,177,元大-蘆洲,2024-10-24,9857
00919,群益台灣精選高息,205,36,169,元大-蘆洲,2024-10-24,9857
1528,恩德,542,373,169,元大-蘆洲,2024-10-24,9857
00679B,元大美債20年,141,4,137,元大-蘆洲,2024-10-24,9857
00885,富邦越南,132,1,131,元大-蘆洲,2024-10-24,9857
2206,三陽工業,133,2,131,元大-蘆洲,2024-10-24,9857
3011,今皓,96,10,86,元大-蘆洲,2024-10-24,9857
2303,聯電,89,21,68,元大-蘆洲,2024-10-24,9857
2388,威盛,72,11,61,元大-蘆洲,2024-10-24,9857
1721,三晃,304,245,59,元大-蘆洲,2024-10-24,9857
2317,鴻海,118,61,57,元大-蘆洲,2024-10-24,9857
2880,華南金,56,2,54,元大-蘆洲,2024-10-24,9857
2354,鴻準,393,340,53,元大-蘆洲,2024-10-24,9857
00878,國泰永續高股息,56,6,50,元大-蘆洲,2024-10-24,9857
8429,金麗-KY,44,0,44,元大-蘆洲,2024-10-24,9857
00753L,中信中國50正2,46,3,43,元大-蘆洲,2024-10-24,9857
2489,瑞軒,238,197,41,元大-蘆洲,2024-10-24,9857
6548,長科*,40,1,39,元大-蘆洲,2024-10-24,9857
3380,明泰,59,23,36,元大-蘆洲,2024-10-24,9857
00687B,國泰20年美債,47,12,35,元大-蘆洲,2024-10-24,9857
1909,榮成,33,0,33,元大-蘆洲,2024-10-24,9857
1806,冠軍,32,0,32,元大-蘆洲,2024-10-24,9857
00725B,國泰投資級公司債,32,0,32,元大-蘆洲,2024-10-24,9857
00882,中信中國高股息,41,10,31,元大-蘆洲,2024-10-24,9857
1595,川寶,50,20,30,元大-蘆洲,2024-10-24,9857
2382,廣達,49,19,30,元大-蘆洲,2024-10-24,9857
8096,擎亞,34,5,29,元大-蘆洲,2024-10-24,9857
3645,達邁,28,0,28,元大-蘆洲,2024-10-24,9857
4991,環宇-KY,27,0,27,元大-蘆洲,2024-10-24,9857
00706L,期元大S＆P日圓正2,27,0,27,元大-蘆洲,2024-10-24,9857
00712,復華富時不動產,34,10,24,元大-蘆洲,2024-10-24,9857
1540,喬福,115,92,23,元大-蘆洲,2024-10-24,9857
00960,野村全球航運龍頭,34,11,23,元大-蘆洲,2024-10-24,9857
3231,緯創,33,10,23,元大-蘆洲,2024-10-24,9857
6451,訊芯-KY,23,1,22,元大-蘆洲,2024-10-24,9857
00907,永豐優息存股,30,8,22,元大-蘆洲,2024-10-24,9857
4123,晟德,27,5,22,元大-蘆洲,2024-10-24,9857
00918,大華優利高填息30,22,0,22,元大-蘆洲,2024-10-24,9857
2891,中信金,25,3,22,元大-蘆洲,2024-10-24,9857
2344,華邦電,46,25,21,元大-蘆洲,2024-10-24,9857
6658,聯策,36,15,21,元大-蘆洲,2024-10-24,9857
2399,映泰,151,131,20,元大-蘆洲,2024-10-24,9857
00648R,元大S＆P500反1,20,0,20,元大-蘆洲,2024-10-24,9857
00669R,國泰美國道瓊反1,20,0,20,元大-蘆洲,2024-10-24,9857
00671R,富邦NASDAQ反1,20,0,20,元大-蘆洲,2024-10-24,9857
6284,佳邦,20,0,20,元大-蘆洲,2024-10-24,9857
00938,凱基優選30,22,3,19,元大-蘆洲,2024-10-24,9857
4716,大立,61,42,19,元大-蘆洲,2024-10-24,9857
2646,星宇航空,667,270,397,元大-蘆洲,2024-10-25,9857
00937B,群益ESG投等債20,165,8,157,元大-蘆洲,2024-10-25,9857
00959B,大華投等美債15Y+,114,0,114,元大-蘆洲,2024-10-25,9857
2206,三陽工業,91,0,91,元大-蘆洲,2024-10-25,9857
00679B,元大美債20年,76,4,72,元大-蘆洲,2024-10-25,9857
9105,泰金寶-DR,65,0,65,元大-蘆洲,2024-10-25,9857
2495,普安,586,539,47,元大-蘆洲,2024-10-25,9857
8043,蜜望實,88,46,42,元大-蘆洲,2024-10-25,9857
1314,中石化,65,25,40,元大-蘆洲,2024-10-25,9857
2344,華邦電,43,4,39,元大-蘆洲,2024-10-25,9857
3037,欣興,60,28,32,元大-蘆洲,2024-10-25,9857
00725B,國泰投資級公司債,32,0,32,元大-蘆洲,2024-10-25,9857
6405,悅城,89,59,30,元大-蘆洲,2024-10-25,9857
2303,聯電,30,1,29,元大-蘆洲,2024-10-25,9857
6770,力積電,58,29,29,元大-蘆洲,2024-10-25,9857
6288,聯嘉,60,32,28,元大-蘆洲,2024-10-25,9857
3105,穩懋,28,1,27,元大-蘆洲,2024-10-25,9857
2367,燿華,30,3,27,元大-蘆洲,2024-10-25,9857
2637,慧洋-KY,27,3,24,元大-蘆洲,2024-10-25,9857
4303,信立,23,0,23,元大-蘆洲,2024-10-25,9857
3265,台星科,22,1,21,元大-蘆洲,2024-10-25,9857
3294,英濟,20,0,20,元大-蘆洲,2024-10-25,9857
8121,越峰,20,0,20,元大-蘆洲,2024-10-25,9857
2354,鴻準,204,185,19,元大-蘆洲,2024-10-25,9857
3694,海華,19,0,19,元大-蘆洲,2024-10-25,9857
2506,太設,19,0,19,元大-蘆洲,2024-10-25,9857
4729,熒茂,21,2,19,元大-蘆洲,2024-10-25,9857
6215,和椿,21,2,19,元大-蘆洲,2024-10-25,9857
00878,國泰永續高股息,25,7,18,元大-蘆洲,2024-10-25,9857
00960,野村全球航運龍頭,18,0,18,元大-蘆洲,2024-10-25,9857
2301,光寶科,20,3,17,元大-蘆洲,2024-10-25,9857
3715,定穎投控,31,14,17,元大-蘆洲,2024-10-25,9857
2489,瑞軒,18,1,17,元大-蘆洲,2024-10-25,9857
1513,中興電,26,10,16,元大-蘆洲,2024-10-25,9857
2363,矽統,39,23,16,元大-蘆洲,2024-10-25,9857
1524,耿鼎,22,7,15,元大-蘆洲,2024-10-25,9857
2891,中信金,17,2,15,元大-蘆洲,2024-10-25,9857
3360,尚立,16,2,14,元大-蘆洲,2024-10-25,9857
6246,臺龍,23,9,14,元大-蘆洲,2024-10-25,9857
00929,復華台灣科技優息,28,15,13,元大-蘆洲,2024-10-25,9857
8074,鉅橡,15,2,13,元大-蘆洲,2024-10-25,9857
3581,博磊,36,23,13,元大-蘆洲,2024-10-25,9857
2338,光罩,12,0,12,元大-蘆洲,2024-10-25,9857
8429,金麗-KY,12,0,12,元大-蘆洲,2024-10-25,9857
9935,慶豐富,12,0,12,元大-蘆洲,2024-10-25,9857
00712,復華富時不動產,12,0,12,元大-蘆洲,2024-10-25,9857
2356,英業達,43,31,12,元大-蘆洲,2024-10-25,9857
2329,華泰,45,34,11,元大-蘆洲,2024-10-25,9857
6235,華孚,43,32,11,元大-蘆洲,2024-10-25,9857
00919,群益台灣精選高息,18,7,11,元大-蘆洲,2024-10-25,9857
00882,中信中國高股息,595,1,594,元大-蘆洲,2024-10-28,9857
00680L,元大美債20正2,277,63,214,元大-蘆洲,2024-10-28,9857
00679B,元大美債20年,199,1,198,元大-蘆洲,2024-10-28,9857
00948B,中信優息投資級債,163,0,163,元大-蘆洲,2024-10-28,9857
00712,復華富時不動產,163,11,152,元大-蘆洲,2024-10-28,9857
00753L,中信中國50正2,125,5,120,元大-蘆洲,2024-10-28,9857
2354,鴻準,336,217,119,元大-蘆洲,2024-10-28,9857
2646,星宇航空,224,113,111,元大-蘆洲,2024-10-28,9857
00637L,元大滬深300正2,134,34,100,元大-蘆洲,2024-10-28,9857
00715L,期街口布蘭特正2,73,0,73,元大-蘆洲,2024-10-28,9857
3231,緯創,121,52,69,元大-蘆洲,2024-10-28,9857
00929,復華台灣科技優息,99,40,59,元大-蘆洲,2024-10-28,9857
2867,三商壽,56,5,51,元大-蘆洲,2024-10-28,9857
2312,金寶,78,28,50,元大-蘆洲,2024-10-28,9857
2349,錸德,116,68,48,元大-蘆洲,2024-10-28,9857
00919,群益台灣精選高息,67,21,46,元大-蘆洲,2024-10-28,9857
2303,聯電,54,8,46,元大-蘆洲,2024-10-28,9857
2883,凱基金,42,1,41,元大-蘆洲,2024-10-28,9857
2206,三陽工業,40,0,40,元大-蘆洲,2024-10-28,9857
00664R,國泰臺灣加權反1,39,0,39,元大-蘆洲,2024-10-28,9857
4545,銘鈺,40,3,37,元大-蘆洲,2024-10-28,9857
2399,映泰,236,200,36,元大-蘆洲,2024-10-28,9857
00933B,國泰10Y+金融債,43,10,33,元大-蘆洲,2024-10-28,9857
00943,兆豐電子高息等權,35,1,34,元大-蘆洲,2024-10-28,9857
3013,晟銘電,68,34,34,元大-蘆洲,2024-10-28,9857
0056,元大高股息,48,15,33,元大-蘆洲,2024-10-28,9857
00946,群益科技高息成長,35,2,33,元大-蘆洲,2024-10-28,9857
2477,美隆電,153,120,33,元大-蘆洲,2024-10-28,9857
00887,永豐中國科技50大,103,70,33,元大-蘆洲,2024-10-28,9857
2615,萬海,87,60,27,元大-蘆洲,2024-10-28,9857
4979,華星光,35,9,26,元大-蘆洲,2024-10-28,9857
4303,信立,26,0,26,元大-蘆洲,2024-10-28,9857
00930,永豐ESG低碳高息,25,0,25,元大-蘆洲,2024-10-28,9857
00671R,富邦NASDAQ反1,25,0,25,元大-蘆洲,2024-10-28,9857
00648R,元大S＆P500反1,25,0,25,元大-蘆洲,2024-10-28,9857
6143,振曜,25,1,24,元大-蘆洲,2024-10-28,9857
00905,FT臺灣Smart,23,0,23,元大-蘆洲,2024-10-28,9857
2449,京元電子,29,7,22,元大-蘆洲,2024-10-28,9857
00688L,國泰20年美債正2,22,0,22,元大-蘆洲,2024-10-28,9857
00932,兆豐永續高息等權,20,0,20,元大-蘆洲,2024-10-28,9857
00795B,中信美國公債20年,20,0,20,元大-蘆洲,2024-10-28,9857
00650L,復華香港正2,20,0,20,元大-蘆洲,2024-10-28,9857
1909,榮成,20,0,20,元大-蘆洲,2024-10-28,9857
00922,國泰台灣領袖50,21,1,20,元大-蘆洲,2024-10-28,9857
006208,富邦台50,20,2,18,元大-蘆洲,2024-10-28,9857
6142,友勁,25,6,19,元大-蘆洲,2024-10-28,9857
00878,國泰永續高股息,43,24,19,元大-蘆洲,2024-10-28,9857
00934,中信成長高股息,20,1,19,元大-蘆洲,2024-10-28,9857
3481,群創,62,44,18,元大-蘆洲,2024-10-28,9857
6197,佳必琪,19,1,18,元大-蘆洲,2024-10-28,9857
00919,群益台灣精選高息,485,8,477,元大-蘆洲,2024-10-29,9857
00929,復華台灣科技優息,317,22,295,元大-蘆洲,2024-10-29,9857
00882,中信中國高股息,184,10,174,元大-蘆洲,2024-10-29,9857
00878,國泰永續高股息,189,42,147,元大-蘆洲,2024-10-29,9857
0056,元大高股息,123,6,117,元大-蘆洲,2024-10-29,9857
1802,台玻,123,28,95,元大-蘆洲,2024-10-29,9857
00940,元大台灣價值高息,251,162,89,元大-蘆洲,2024-10-29,9857
2354,鴻準,131,44,87,元大-蘆洲,2024-10-29,9857
00715L,期街口布蘭特正2,83,0,83,元大-蘆洲,2024-10-29,9857
00915,凱基優選高股息30,84,1,83,元大-蘆洲,2024-10-29,9857
6133,金橋,227,145,82,元大-蘆洲,2024-10-29,9857
2206,三陽工業,80,0,80,元大-蘆洲,2024-10-29,9857
00881,國泰台灣5G+,85,7,78,元大-蘆洲,2024-10-29,9857
2303,聯電,143,65,78,元大-蘆洲,2024-10-29,9857
00946,群益科技高息成長,81,3,78,元大-蘆洲,2024-10-29,9857
1449,佳和,192,134,58,元大-蘆洲,2024-10-29,9857
00712,復華富時不動產,45,0,45,元大-蘆洲,2024-10-29,9857
6168,宏齊,45,2,43,元大-蘆洲,2024-10-29,9857
8027,鈦昇,49,10,39,元大-蘆洲,2024-10-29,9857
00922,國泰台灣領袖50,40,1,39,元大-蘆洲,2024-10-29,9857
00918,大華優利高填息30,39,0,39,元大-蘆洲,2024-10-29,9857
3704,合勤控,50,14,36,元大-蘆洲,2024-10-29,9857
5880,合庫金,54,20,34,元大-蘆洲,2024-10-29,9857
00679B,元大美債20年,45,13,32,元大-蘆洲,2024-10-29,9857
00713,元大台灣高息低波,33,2,31,元大-蘆洲,2024-10-29,9857
00637L,元大滬深300正2,156,126,30,元大-蘆洲,2024-10-29,9857
2388,威盛,77,48,29,元大-蘆洲,2024-10-29,9857
2344,華邦電,29,0,29,元大-蘆洲,2024-10-29,9857
2883,凱基金,108,81,27,元大-蘆洲,2024-10-29,9857
2887,台新金,31,5,26,元大-蘆洲,2024-10-29,9857
5481,新華,26,0,26,元大-蘆洲,2024-10-29,9857
00948B,中信優息投資級債,25,0,25,元大-蘆洲,2024-10-29,9857
3217,優群,30,5,25,元大-蘆洲,2024-10-29,9857
006208,富邦台50,34,9,25,元大-蘆洲,2024-10-29,9857
2890,永豐金,23,0,23,元大-蘆洲,2024-10-29,9857
2498,宏達電,48,25,23,元大-蘆洲,2024-10-29,9857
9907,統一實,23,0,23,元大-蘆洲,2024-10-29,9857
3189,景碩,85,62,23,元大-蘆洲,2024-10-29,9857
00937B,群益ESG投等債20,35,13,22,元大-蘆洲,2024-10-29,9857
2401,凌陽,22,0,22,元大-蘆洲,2024-10-29,9857
6274,台燿,31,9,22,元大-蘆洲,2024-10-29,9857
4529,淳紳,21,0,21,元大-蘆洲,2024-10-29,9857
2609,陽明,38,17,21,元大-蘆洲,2024-10-29,9857
5701,劍湖山,22,1,21,元大-蘆洲,2024-10-29,9857
00927,群益半導體收益,20,0,20,元大-蘆洲,2024-10-29,9857
00935,野村臺灣新科技50,20,0,20,元大-蘆洲,2024-10-29,9857
8358,金居,20,0,20,元大-蘆洲,2024-10-29,9857
6156,松上,95,75,20,元大-蘆洲,2024-10-29,9857
3481,群創,45,26,19,元大-蘆洲,2024-10-29,9857
2413,環科,71,52,19,元大-蘆洲,2024-10-29,9857
00929,復華台灣科技優息,417,13,404,元大-蘆洲,2024-10-30,9857
00712,復華富時不動產,394,7,387,元大-蘆洲,2024-10-30,9857
00919,群益台灣精選高息,121,5,116,元大-蘆洲,2024-10-30,9857
00753L,中信中國50正2,110,0,110,元大-蘆洲,2024-10-30,9857
00878,國泰永續高股息,100,18,82,元大-蘆洲,2024-10-30,9857
8021,尖點,85,5,80,元大-蘆洲,2024-10-30,9857
4919,新唐,208,130,78,元大-蘆洲,2024-10-30,9857
3481,群創,111,39,72,元大-蘆洲,2024-10-30,9857
3704,合勤控,83,13,70,元大-蘆洲,2024-10-30,9857
2337,旺宏,72,2,70,元大-蘆洲,2024-10-30,9857
6156,松上,71,7,64,元大-蘆洲,2024-10-30,9857
2303,聯電,66,5,61,元大-蘆洲,2024-10-30,9857
6197,佳必琪,65,6,59,元大-蘆洲,2024-10-30,9857
0056,元大高股息,70,15,55,元大-蘆洲,2024-10-30,9857
00937B,群益ESG投等債20,51,5,46,元大-蘆洲,2024-10-30,9857
00946,群益科技高息成長,43,0,43,元大-蘆洲,2024-10-30,9857
2349,錸德,37,1,36,元大-蘆洲,2024-10-30,9857
00915,凱基優選高股息30,36,0,36,元大-蘆洲,2024-10-30,9857
6191,精成科,56,22,34,元大-蘆洲,2024-10-30,9857
00959B,大華投等美債15Y+,33,0,33,元大-蘆洲,2024-10-30,9857
6770,力積電,41,8,33,元大-蘆洲,2024-10-30,9857
8110,華東,30,0,30,元大-蘆洲,2024-10-30,9857
8176,智捷,40,11,29,元大-蘆洲,2024-10-30,9857
3062,建漢,96,69,27,元大-蘆洲,2024-10-30,9857
2887,台新金,30,4,26,元大-蘆洲,2024-10-30,9857
2371,大同,31,6,25,元大-蘆洲,2024-10-30,9857
2313,華通,27,3,24,元大-蘆洲,2024-10-30,9857
2543,皇昌,92,69,23,元大-蘆洲,2024-10-30,9857
1608,華榮,23,0,23,元大-蘆洲,2024-10-30,9857
6120,達運,23,0,23,元大-蘆洲,2024-10-30,9857
3231,緯創,58,35,23,元大-蘆洲,2024-10-30,9857
4909,新復興,28,6,22,元大-蘆洲,2024-10-30,9857
1528,恩德,266,244,22,元大-蘆洲,2024-10-30,9857
4545,銘鈺,22,0,22,元大-蘆洲,2024-10-30,9857
6875,國邑*,22,0,22,元大-蘆洲,2024-10-30,9857
2891,中信金,27,7,20,元大-蘆洲,2024-10-30,9857
1582,信錦,20,0,20,元大-蘆洲,2024-10-30,9857
1609,大亞,21,1,20,元大-蘆洲,2024-10-30,9857
2328,廣宇,41,21,20,元大-蘆洲,2024-10-30,9857
1449,佳和,36,19,17,元大-蘆洲,2024-10-30,9857
6180,橘子,17,0,17,元大-蘆洲,2024-10-30,9857
00922,國泰台灣領袖50,16,0,16,元大-蘆洲,2024-10-30,9857
4979,華星光,19,4,15,元大-蘆洲,2024-10-30,9857
00882,中信中國高股息,14,0,14,元大-蘆洲,2024-10-30,9857
2617,台航,15,1,14,元大-蘆洲,2024-10-30,9857
2431,聯昌,18,4,14,元大-蘆洲,2024-10-30,9857
6271,同欣電,18,4,14,元大-蘆洲,2024-10-30,9857
2382,廣達,19,5,14,元大-蘆洲,2024-10-30,9857
00927,群益半導體收益,14,0,14,元大-蘆洲,2024-10-30,9857
006208,富邦台50,14,0,14,元大-蘆洲,2024-10-30,9857
2303,聯電,520,27,493,元大-蘆洲,2024-11-01,9857
00878,國泰永續高股息,208,27,181,元大-蘆洲,2024-11-01,9857
00712,復華富時不動產,169,6,163,元大-蘆洲,2024-11-01,9857
00929,復華台灣科技優息,166,41,125,元大-蘆洲,2024-11-01,9857
00919,群益台灣精選高息,227,105,122,元大-蘆洲,2024-11-01,9857
3704,合勤控,95,2,93,元大-蘆洲,2024-11-01,9857
00632R,元大台灣50反1,120,31,89,元大-蘆洲,2024-11-01,9857
0056,元大高股息,97,14,83,元大-蘆洲,2024-11-01,9857
2337,旺宏,84,22,62,元大-蘆洲,2024-11-01,9857
2317,鴻海,198,138,60,元大-蘆洲,2024-11-01,9857
2880,華南金,59,1,58,元大-蘆洲,2024-11-01,9857
00946,群益科技高息成長,63,6,57,元大-蘆洲,2024-11-01,9857
00687B,國泰20年美債,73,16,57,元大-蘆洲,2024-11-01,9857
3011,今皓,64,8,56,元大-蘆洲,2024-11-01,9857
00669R,國泰美國道瓊反1,55,0,55,元大-蘆洲,2024-11-01,9857
00671R,富邦NASDAQ反1,50,0,50,元大-蘆洲,2024-11-01,9857
00648R,元大S＆P500反1,50,0,50,元大-蘆洲,2024-11-01,9857
00915,凱基優選高股息30,50,1,49,元大-蘆洲,2024-11-01,9857
2891,中信金,57,10,47,元大-蘆洲,2024-11-01,9857
00665L,富邦�琤肭磪囓�2,50,3,47,元大-蘆洲,2024-11-01,9857
00651R,復華香港反1,40,0,40,元大-蘆洲,2024-11-01,9857
3481,群創,41,3,38,元大-蘆洲,2024-11-01,9857
00945B,凱基美國非投等債,38,0,38,元大-蘆洲,2024-11-01,9857
2886,兆豐金,35,0,35,元大-蘆洲,2024-11-01,9857
4529,淳紳,33,0,33,元大-蘆洲,2024-11-01,9857
00940,元大台灣價值高息,139,107,32,元大-蘆洲,2024-11-01,9857
2405,輔信,41,9,32,元大-蘆洲,2024-11-01,9857
6197,佳必琪,39,7,32,元大-蘆洲,2024-11-01,9857
00664R,國泰臺灣加權反1,30,0,30,元大-蘆洲,2024-11-01,9857
6182,合晶,30,1,29,元大-蘆洲,2024-11-01,9857
00713,元大台灣高息低波,29,0,29,元大-蘆洲,2024-11-01,9857
2887,台新金,27,1,26,元大-蘆洲,2024-11-01,9857
5426,振發,50,24,26,元大-蘆洲,2024-11-01,9857
6216,居易,61,38,23,元大-蘆洲,2024-11-01,9857
00933B,國泰10Y+金融債,23,1,22,元大-蘆洲,2024-11-01,9857
1605,華新,25,4,21,元大-蘆洲,2024-11-01,9857
3508,位速,25,4,21,元大-蘆洲,2024-11-01,9857
006208,富邦台50,21,1,20,元大-蘆洲,2024-11-01,9857
8027,鈦昇,20,0,20,元大-蘆洲,2024-11-01,9857
00930,永豐ESG低碳高息,19,0,19,元大-蘆洲,2024-11-01,9857
00922,國泰台灣領袖50,34,15,19,元大-蘆洲,2024-11-01,9857
2543,皇昌,66,47,19,元大-蘆洲,2024-11-01,9857
2330,台積電,23,5,18,元大-蘆洲,2024-11-01,9857
00936,台新永續高息中小,23,5,18,元大-蘆洲,2024-11-01,9857
8069,元太,22,6,16,元大-蘆洲,2024-11-01,9857
3105,穩懋,18,2,16,元大-蘆洲,2024-11-01,9857
3092,鴻碩,30,14,16,元大-蘆洲,2024-11-01,9857
00926,凱基全球菁英55,16,0,16,元大-蘆洲,2024-11-01,9857
2515,中工,17,1,16,元大-蘆洲,2024-11-01,9857
2353,宏��,17,1,16,元大-蘆洲,2024-11-01,9857
00919,群益台灣精選高息,174,25,149,元大-蘆洲,2024-11-04,9857
00712,復華富時不動產,108,0,108,元大-蘆洲,2024-11-04,9857
00878,國泰永續高股息,115,19,96,元大-蘆洲,2024-11-04,9857
00929,復華台灣科技優息,232,141,91,元大-蘆洲,2024-11-04,9857
2354,鴻準,374,286,88,元大-蘆洲,2024-11-04,9857
2329,華泰,94,11,83,元大-蘆洲,2024-11-04,9857
00680L,元大美債20正2,104,30,74,元大-蘆洲,2024-11-04,9857
00687B,國泰20年美債,130,59,71,元大-蘆洲,2024-11-04,9857
3019,亞光,83,14,69,元大-蘆洲,2024-11-04,9857
00632R,元大台灣50反1,70,2,68,元大-蘆洲,2024-11-04,9857
2609,陽明,106,40,66,元大-蘆洲,2024-11-04,9857
2303,聯電,101,36,65,元大-蘆洲,2024-11-04,9857
9105,泰金寶-DR,77,19,58,元大-蘆洲,2024-11-04,9857
2371,大同,70,18,52,元大-蘆洲,2024-11-04,9857
01010T,京城樂富R1,42,0,42,元大-蘆洲,2024-11-04,9857
3704,合勤控,40,1,39,元大-蘆洲,2024-11-04,9857
00679B,元大美債20年,78,42,36,元大-蘆洲,2024-11-04,9857
2615,萬海,469,434,35,元大-蘆洲,2024-11-04,9857
2409,友達,35,2,33,元大-蘆洲,2024-11-04,9857
00688L,國泰20年美債正2,30,0,30,元大-蘆洲,2024-11-04,9857
3490,單井,34,4,30,元大-蘆洲,2024-11-04,9857
2337,旺宏,30,1,29,元大-蘆洲,2024-11-04,9857
2880,華南金,31,2,29,元大-蘆洲,2024-11-04,9857
00713,元大台灣高息低波,29,0,29,元大-蘆洲,2024-11-04,9857
2706,第一店,35,7,28,元大-蘆洲,2024-11-04,9857
00933B,國泰10Y+金融債,26,2,24,元大-蘆洲,2024-11-04,9857
00946,群益科技高息成長,23,0,23,元大-蘆洲,2024-11-04,9857
3481,群創,49,27,22,元大-蘆洲,2024-11-04,9857
1806,冠軍,22,0,22,元大-蘆洲,2024-11-04,9857
6589,台康生技,23,2,21,元大-蘆洲,2024-11-04,9857
00892,富邦台灣半導體,28,7,21,元大-蘆洲,2024-11-04,9857
8354,冠好,20,0,20,元大-蘆洲,2024-11-04,9857
00926,凱基全球菁英55,20,0,20,元大-蘆洲,2024-11-04,9857
1308,亞聚,20,0,20,元大-蘆洲,2024-11-04,9857
00795B,中信美國公債20年,20,0,20,元大-蘆洲,2024-11-04,9857
6438,迅得,25,8,17,元大-蘆洲,2024-11-04,9857
2464,盟立,29,12,17,元大-蘆洲,2024-11-04,9857
4919,新唐,41,25,16,元大-蘆洲,2024-11-04,9857
00943,兆豐電子高息等權,16,0,16,元大-蘆洲,2024-11-04,9857
00939,統一台灣高息動能,16,0,16,元大-蘆洲,2024-11-04,9857
6266,泰詠,18,2,16,元大-蘆洲,2024-11-04,9857
4303,信立,16,1,15,元大-蘆洲,2024-11-04,9857
3016,嘉晶,15,1,14,元大-蘆洲,2024-11-04,9857
00655L,國泰中國A50正2,14,0,14,元大-蘆洲,2024-11-04,9857
00665L,富邦�琤肭磪囓�2,16,2,14,元大-蘆洲,2024-11-04,9857
8249,菱光,111,98,13,元大-蘆洲,2024-11-04,9857
6288,聯嘉,14,1,13,元大-蘆洲,2024-11-04,9857
8111,立��,87,74,13,元大-蘆洲,2024-11-04,9857
00751B,元大AAA至A公司債,12,0,12,元大-蘆洲,2024-11-04,9857
2465,麗臺,12,0,12,元大-蘆洲,2024-11-04,9857
2303,聯電,272,39,233,元大-蘆洲,2024-11-05,9857
00919,群益台灣精選高息,182,27,155,元大-蘆洲,2024-11-05,9857
2915,潤泰全,90,0,90,元大-蘆洲,2024-11-05,9857
00712,復華富時不動產,73,2,71,元大-蘆洲,2024-11-05,9857
00930,永豐ESG低碳高息,63,0,63,元大-蘆洲,2024-11-05,9857
3049,精金,102,58,44,元大-蘆洲,2024-11-05,9857
2371,大同,51,9,42,元大-蘆洲,2024-11-05,9857
6451,訊芯-KY,87,45,42,元大-蘆洲,2024-11-05,9857
00673R,期元大S＆P原油反1,40,0,40,元大-蘆洲,2024-11-05,9857
6530,創威,120,80,40,元大-蘆洲,2024-11-05,9857
4956,光鋐,47,11,36,元大-蘆洲,2024-11-05,9857
2615,萬海,246,211,35,元大-蘆洲,2024-11-05,9857
2316,楠梓電,36,4,32,元大-蘆洲,2024-11-05,9857
2880,華南金,30,1,29,元大-蘆洲,2024-11-05,9857
00960,野村全球航運龍頭,30,2,28,元大-蘆洲,2024-11-05,9857
00751B,元大AAA至A公司債,27,0,27,元大-蘆洲,2024-11-05,9857
00943,兆豐電子高息等權,23,0,23,元大-蘆洲,2024-11-05,9857
00679B,元大美債20年,26,3,23,元大-蘆洲,2024-11-05,9857
6438,迅得,24,2,22,元大-蘆洲,2024-11-05,9857
00948B,中信優息投資級債,22,0,22,元大-蘆洲,2024-11-05,9857
2328,廣宇,32,10,22,元大-蘆洲,2024-11-05,9857
00937B,群益ESG投等債20,33,12,21,元大-蘆洲,2024-11-05,9857
5439,高技,21,1,20,元大-蘆洲,2024-11-05,9857
00643,群益深証中小,20,0,20,元大-蘆洲,2024-11-05,9857
00946,群益科技高息成長,19,0,19,元大-蘆洲,2024-11-05,9857
2348,海悅,25,6,19,元大-蘆洲,2024-11-05,9857
00927,群益半導體收益,19,0,19,元大-蘆洲,2024-11-05,9857
00878,國泰永續高股息,58,39,19,元大-蘆洲,2024-11-05,9857
2399,映泰,62,45,17,元大-蘆洲,2024-11-05,9857
3455,由田,23,7,16,元大-蘆洲,2024-11-05,9857
3290,東浦,16,0,16,元大-蘆洲,2024-11-05,9857
2405,輔信,104,89,15,元大-蘆洲,2024-11-05,9857
2706,第一店,15,0,15,元大-蘆洲,2024-11-05,9857
00940,元大台灣價值高息,36,22,14,元大-蘆洲,2024-11-05,9857
00892,富邦台灣半導體,14,0,14,元大-蘆洲,2024-11-05,9857
1815,富喬,32,18,14,元大-蘆洲,2024-11-05,9857
6216,居易,16,2,14,元大-蘆洲,2024-11-05,9857
6274,台燿,14,1,13,元大-蘆洲,2024-11-05,9857
2329,華泰,14,1,13,元大-蘆洲,2024-11-05,9857
00915,凱基優選高股息30,15,2,13,元大-蘆洲,2024-11-05,9857
6005,群益證,12,0,12,元大-蘆洲,2024-11-05,9857
1531,高林股,12,0,12,元大-蘆洲,2024-11-05,9857
3711,日月光投控,15,3,12,元大-蘆洲,2024-11-05,9857
6412,群電,11,0,11,元大-蘆洲,2024-11-05,9857
8927,北基,11,0,11,元大-蘆洲,2024-11-05,9857
2301,光寶科,12,1,11,元大-蘆洲,2024-11-05,9857
6770,力積電,15,5,10,元大-蘆洲,2024-11-05,9857
4958,臻鼎-KY,10,0,10,元大-蘆洲,2024-11-05,9857
00936,台新永續高息中小,20,10,10,元大-蘆洲,2024-11-05,9857
3338,泰碩,10,0,10,元大-蘆洲,2024-11-05,9857
00671R,富邦NASDAQ反1,240,0,240,元大-蘆洲,2024-11-06,9857
00688L,國泰20年美債正2,197,5,192,元大-蘆洲,2024-11-06,9857
2354,鴻準,458,281,177,元大-蘆洲,2024-11-06,9857
00679B,元大美債20年,186,23,163,元大-蘆洲,2024-11-06,9857
00637L,元大滬深300正2,179,25,154,元大-蘆洲,2024-11-06,9857
00680L,元大美債20正2,230,79,151,元大-蘆洲,2024-11-06,9857
00632R,元大台灣50反1,141,25,116,元大-蘆洲,2024-11-06,9857
2002,中鋼,102,9,93,元大-蘆洲,2024-11-06,9857
2303,聯電,128,57,71,元大-蘆洲,2024-11-06,9857
00648R,元大S＆P500反1,70,0,70,元大-蘆洲,2024-11-06,9857
00919,群益台灣精選高息,86,17,69,元大-蘆洲,2024-11-06,9857
00669R,國泰美國道瓊反1,64,0,64,元大-蘆洲,2024-11-06,9857
00937B,群益ESG投等債20,95,39,56,元大-蘆洲,2024-11-06,9857
8249,菱光,182,130,52,元大-蘆洲,2024-11-06,9857
00665L,富邦�琤肭磪囓�2,57,6,51,元大-蘆洲,2024-11-06,9857
00795B,中信美國公債20年,52,2,50,元大-蘆洲,2024-11-06,9857
00751B,元大AAA至A公司債,50,2,48,元大-蘆洲,2024-11-06,9857
00946,群益科技高息成長,65,20,45,元大-蘆洲,2024-11-06,9857
00706L,期元大S＆P日圓正2,42,0,42,元大-蘆洲,2024-11-06,9857
00687B,國泰20年美債,162,122,40,元大-蘆洲,2024-11-06,9857
2376,技嘉,79,44,35,元大-蘆洲,2024-11-06,9857
8150,南茂,42,7,35,元大-蘆洲,2024-11-06,9857
2883,凱基金,36,1,35,元大-蘆洲,2024-11-06,9857
3583,辛耘,41,6,35,元大-蘆洲,2024-11-06,9857
00753L,中信中國50正2,33,0,33,元大-蘆洲,2024-11-06,9857
2615,萬海,72,40,32,元大-蘆洲,2024-11-06,9857
2337,旺宏,31,0,31,元大-蘆洲,2024-11-06,9857
00945B,凱基美國非投等債,30,0,30,元大-蘆洲,2024-11-06,9857
2344,華邦電,30,3,27,元大-蘆洲,2024-11-06,9857
9103,美德醫療-DR,25,0,25,元大-蘆洲,2024-11-06,9857
00948B,中信優息投資級債,71,47,24,元大-蘆洲,2024-11-06,9857
1522,堤維西,23,0,23,元大-蘆洲,2024-11-06,9857
3230,錦明,36,13,23,元大-蘆洲,2024-11-06,9857
8027,鈦昇,37,14,23,元大-蘆洲,2024-11-06,9857
4979,華星光,64,42,22,元大-蘆洲,2024-11-06,9857
2889,國票金,21,0,21,元大-蘆洲,2024-11-06,9857
00673R,期元大S＆P原油反1,20,0,20,元大-蘆洲,2024-11-06,9857
6274,台燿,16,0,16,元大-蘆洲,2024-11-06,9857
4562,穎漢,76,60,16,元大-蘆洲,2024-11-06,9857
6156,松上,23,7,16,元大-蘆洲,2024-11-06,9857
4527,方土霖,16,0,16,元大-蘆洲,2024-11-06,9857
1528,恩德,72,56,16,元大-蘆洲,2024-11-06,9857
00942B,台新美A公司債20+,23,8,15,元大-蘆洲,2024-11-06,9857
4956,光鋐,22,7,15,元大-蘆洲,2024-11-06,9857
00719B,元大美債1-3,15,0,15,元大-蘆洲,2024-11-06,9857
6246,臺龍,18,3,15,元大-蘆洲,2024-11-06,9857
2409,友達,20,5,15,元大-蘆洲,2024-11-06,9857
00877,復華中國5G,15,1,14,元大-蘆洲,2024-11-06,9857
1449,佳和,101,87,14,元大-蘆洲,2024-11-06,9857
6405,悅城,99,85,14,元大-蘆洲,2024-11-06,9857
00680L,元大美債20正2,393,72,321,元大-蘆洲,2024-11-07,9857
00706L,期元大S＆P日圓正2,134,0,134,元大-蘆洲,2024-11-07,9857
00632R,元大台灣50反1,154,22,132,元大-蘆洲,2024-11-07,9857
6706,惠特,138,15,123,元大-蘆洲,2024-11-07,9857
00878,國泰永續高股息,108,20,88,元大-蘆洲,2024-11-07,9857
00688L,國泰20年美債正2,85,0,85,元大-蘆洲,2024-11-07,9857
00679B,元大美債20年,101,28,73,元大-蘆洲,2024-11-07,9857
00671R,富邦NASDAQ反1,60,0,60,元大-蘆洲,2024-11-07,9857
2344,華邦電,91,38,53,元大-蘆洲,2024-11-07,9857
9105,泰金寶-DR,532,481,51,元大-蘆洲,2024-11-07,9857
3704,合勤控,45,2,43,元大-蘆洲,2024-11-07,9857
2851,中再保,42,0,42,元大-蘆洲,2024-11-07,9857
3049,精金,73,31,42,元大-蘆洲,2024-11-07,9857
2892,第一金,36,1,35,元大-蘆洲,2024-11-07,9857
2489,瑞軒,35,0,35,元大-蘆洲,2024-11-07,9857
00892,富邦台灣半導體,36,2,34,元大-蘆洲,2024-11-07,9857
6609,瀧澤科,46,14,32,元大-蘆洲,2024-11-07,9857
3583,辛耘,34,2,32,元大-蘆洲,2024-11-07,9857
00712,復華富時不動產,34,2,32,元大-蘆洲,2024-11-07,9857
3167,大量,74,47,27,元大-蘆洲,2024-11-07,9857
2332,友訊,57,30,27,元大-蘆洲,2024-11-07,9857
6288,聯嘉,96,69,27,元大-蘆洲,2024-11-07,9857
2303,聯電,230,204,26,元大-蘆洲,2024-11-07,9857
00893,國泰智能電動車,26,0,26,元大-蘆洲,2024-11-07,9857
2615,萬海,68,43,25,元大-蘆洲,2024-11-07,9857
00895,富邦未來車,26,1,25,元大-蘆洲,2024-11-07,9857
2457,飛宏,29,7,22,元大-蘆洲,2024-11-07,9857
6530,創威,48,27,21,元大-蘆洲,2024-11-07,9857
8027,鈦昇,32,13,19,元大-蘆洲,2024-11-07,9857
2014,中鴻,63,44,19,元大-蘆洲,2024-11-07,9857
4960,誠美材,18,0,18,元大-蘆洲,2024-11-07,9857
3522,御嵿,18,0,18,元大-蘆洲,2024-11-07,9857
3189,景碩,35,18,17,元大-蘆洲,2024-11-07,9857
3552,同致,35,19,16,元大-蘆洲,2024-11-07,9857
00922,國泰台灣領袖50,16,2,14,元大-蘆洲,2024-11-07,9857
8021,尖點,17,3,14,元大-蘆洲,2024-11-07,9857
2881,富邦金,21,7,14,元大-蘆洲,2024-11-07,9857
1815,富喬,94,81,13,元大-蘆洲,2024-11-07,9857
9958,世紀鋼,17,5,12,元大-蘆洲,2024-11-07,9857
00830,國泰費城半導體,15,3,12,元大-蘆洲,2024-11-07,9857
2891,中信金,27,15,12,元大-蘆洲,2024-11-07,9857
006208,富邦台50,12,1,11,元大-蘆洲,2024-11-07,9857
3501,維熹,11,0,11,元大-蘆洲,2024-11-07,9857
2882,國泰金,15,4,11,元大-蘆洲,2024-11-07,9857
3264,欣銓,11,0,11,元大-蘆洲,2024-11-07,9857
00762,元大全球AI,11,0,11,元大-蘆洲,2024-11-07,9857
3515,華擎,14,4,10,元大-蘆洲,2024-11-07,9857
2601,益航,10,0,10,元大-蘆洲,2024-11-07,9857
00948B,中信優息投資級債,20,10,10,元大-蘆洲,2024-11-07,9857
2478,大毅,10,0,10,元大-蘆洲,2024-11-07,9857
2002,中鋼,404,25,379,元大-蘆洲,2024-11-08,9857
00946,群益科技高息成長,203,15,188,元大-蘆洲,2024-11-08,9857
00725B,國泰投資級公司債,163,2,161,元大-蘆洲,2024-11-08,9857
4991,環宇-KY,191,46,145,元大-蘆洲,2024-11-08,9857
3062,建漢,320,217,103,元大-蘆洲,2024-11-08,9857
3011,今皓,101,0,101,元大-蘆洲,2024-11-08,9857
2356,英業達,159,64,95,元大-蘆洲,2024-11-08,9857
3037,欣興,174,79,95,元大-蘆洲,2024-11-08,9857
00632R,元大台灣50反1,162,68,94,元大-蘆洲,2024-11-08,9857
00932,兆豐永續高息等權,77,0,77,元大-蘆洲,2024-11-08,9857
2388,威盛,85,10,75,元大-蘆洲,2024-11-08,9857
4909,新復興,75,2,73,元大-蘆洲,2024-11-08,9857
2313,華通,99,28,71,元大-蘆洲,2024-11-08,9857
00673R,期元大S＆P原油反1,70,0,70,元大-蘆洲,2024-11-08,9857
2354,鴻準,445,382,63,元大-蘆洲,2024-11-08,9857
00665L,富邦�琤肭磪囓�2,58,4,54,元大-蘆洲,2024-11-08,9857
2206,三陽工業,52,0,52,元大-蘆洲,2024-11-08,9857
3339,泰谷,51,0,51,元大-蘆洲,2024-11-08,9857
2887,台新金,48,0,48,元大-蘆洲,2024-11-08,9857
00679B,元大美債20年,55,11,44,元大-蘆洲,2024-11-08,9857
00637L,元大滬深300正2,78,35,43,元大-蘆洲,2024-11-08,9857
2337,旺宏,52,9,43,元大-蘆洲,2024-11-08,9857
3290,東浦,46,6,40,元大-蘆洲,2024-11-08,9857
1802,台玻,115,75,40,元大-蘆洲,2024-11-08,9857
2353,宏��,40,1,39,元大-蘆洲,2024-11-08,9857
2409,友達,40,2,38,元大-蘆洲,2024-11-08,9857
3498,陽程,45,9,36,元大-蘆洲,2024-11-08,9857
5243,乙盛-KY,39,5,34,元大-蘆洲,2024-11-08,9857
2457,飛宏,38,5,33,元大-蘆洲,2024-11-08,9857
00953B,群益優選非投等債,33,1,32,元大-蘆洲,2024-11-08,9857
00878,國泰永續高股息,75,44,31,元大-蘆洲,2024-11-08,9857
3645,達邁,30,0,30,元大-蘆洲,2024-11-08,9857
2363,矽統,37,8,29,元大-蘆洲,2024-11-08,9857
2332,友訊,37,11,26,元大-蘆洲,2024-11-08,9857
2392,正崴,124,98,26,元大-蘆洲,2024-11-08,9857
1522,堤維西,31,5,26,元大-蘆洲,2024-11-08,9857
2014,中鴻,33,10,23,元大-蘆洲,2024-11-08,9857
6781,AES-KY,25,2,23,元大-蘆洲,2024-11-08,9857
3522,御嵿,22,0,22,元大-蘆洲,2024-11-08,9857
00945B,凱基美國非投等債,22,0,22,元大-蘆洲,2024-11-08,9857
2368,金像電,31,10,21,元大-蘆洲,2024-11-08,9857
2542,興富發,30,9,21,元大-蘆洲,2024-11-08,9857
2515,中工,21,1,20,元大-蘆洲,2024-11-08,9857
3162,精確,22,4,18,元大-蘆洲,2024-11-08,9857
2314,台揚,43,25,18,元大-蘆洲,2024-11-08,9857
5471,松翰,18,0,18,元大-蘆洲,2024-11-08,9857
3481,群創,33,15,18,元大-蘆洲,2024-11-08,9857
8076,伍豐,17,0,17,元大-蘆洲,2024-11-08,9857
4510,高鋒,27,10,17,元大-蘆洲,2024-11-08,9857
3036,文曄,22,6,16,元大-蘆洲,2024-11-08,9857
00953B,群益優選非投等債,980,0,980,元大-蘆洲,2024-11-11,9857
9105,泰金寶-DR,233,74,159,元大-蘆洲,2024-11-11,9857
00878,國泰永續高股息,154,16,138,元大-蘆洲,2024-11-11,9857
2337,旺宏,123,1,122,元大-蘆洲,2024-11-11,9857
00753L,中信中國50正2,111,31,80,元大-蘆洲,2024-11-11,9857
2887,台新金,73,1,72,元大-蘆洲,2024-11-11,9857
00919,群益台灣精選高息,74,9,65,元大-蘆洲,2024-11-11,9857
00680L,元大美債20正2,60,18,42,元大-蘆洲,2024-11-11,9857
2486,一詮,57,15,42,元大-蘆洲,2024-11-11,9857
3049,精金,51,10,41,元大-蘆洲,2024-11-11,9857
8027,鈦昇,41,0,41,元大-蘆洲,2024-11-11,9857
6727,亞泰金屬,35,0,35,元大-蘆洲,2024-11-11,9857
00687B,國泰20年美債,52,18,34,元大-蘆洲,2024-11-11,9857
2449,京元電子,62,29,33,元大-蘆洲,2024-11-11,9857
00932,兆豐永續高息等權,32,3,29,元大-蘆洲,2024-11-11,9857
00632R,元大台灣50反1,100,71,29,元大-蘆洲,2024-11-11,9857
6191,精成科,27,0,27,元大-蘆洲,2024-11-11,9857
3481,群創,38,11,27,元大-蘆洲,2024-11-11,9857
2609,陽明,72,46,26,元大-蘆洲,2024-11-11,9857
2409,友達,26,1,25,元大-蘆洲,2024-11-11,9857
4979,華星光,33,8,25,元大-蘆洲,2024-11-11,9857
0056,元大高股息,43,19,24,元大-蘆洲,2024-11-11,9857
3047,訊舟,29,5,24,元大-蘆洲,2024-11-11,9857
1815,富喬,33,9,24,元大-蘆洲,2024-11-11,9857
1449,佳和,50,27,23,元大-蘆洲,2024-11-11,9857
4919,新唐,23,0,23,元大-蘆洲,2024-11-11,9857
2353,宏��,28,5,23,元大-蘆洲,2024-11-11,9857
00926,凱基全球菁英55,22,0,22,元大-蘆洲,2024-11-11,9857
2880,華南金,23,1,22,元大-蘆洲,2024-11-11,9857
3189,景碩,21,1,20,元大-蘆洲,2024-11-11,9857
00909,國泰數位支付服務,28,8,20,元大-蘆洲,2024-11-11,9857
1563,巧新,20,0,20,元大-蘆洲,2024-11-11,9857
6026,福邦證,20,0,20,元大-蘆洲,2024-11-11,9857
2834,臺企銀,20,1,19,元大-蘆洲,2024-11-11,9857
3062,建漢,77,59,18,元大-蘆洲,2024-11-11,9857
00882,中信中國高股息,18,0,18,元大-蘆洲,2024-11-11,9857
1584,精剛,17,0,17,元大-蘆洲,2024-11-11,9857
3673,TPK-KY,17,0,17,元大-蘆洲,2024-11-11,9857
3231,緯創,45,28,17,元大-蘆洲,2024-11-11,9857
2354,鴻準,282,266,16,元大-蘆洲,2024-11-11,9857
2891,中信金,21,5,16,元大-蘆洲,2024-11-11,9857
2399,映泰,76,60,16,元大-蘆洲,2024-11-11,9857
3303,岱稜,119,103,16,元大-蘆洲,2024-11-11,9857
4916,事欣科,20,4,16,元大-蘆洲,2024-11-11,9857
8155,博智,16,0,16,元大-蘆洲,2024-11-11,9857
3714,富采,19,4,15,元大-蘆洲,2024-11-11,9857
2851,中再保,15,0,15,元大-蘆洲,2024-11-11,9857
2390,云辰,15,0,15,元大-蘆洲,2024-11-11,9857
00943,兆豐電子高息等權,15,0,15,元大-蘆洲,2024-11-11,9857
5880,合庫金,17,2,15,元大-蘆洲,2024-11-11,9857
00878,國泰永續高股息,494,15,479,元大-蘆洲,2024-11-12,9857
2206,三陽工業,302,0,302,元大-蘆洲,2024-11-12,9857
0056,元大高股息,216,1,215,元大-蘆洲,2024-11-12,9857
2892,第一金,199,0,199,元大-蘆洲,2024-11-12,9857
00953B,群益優選非投等債,188,0,188,元大-蘆洲,2024-11-12,9857
2354,鴻準,239,101,138,元大-蘆洲,2024-11-12,9857
2356,英業達,189,61,128,元大-蘆洲,2024-11-12,9857
00919,群益台灣精選高息,149,33,116,元大-蘆洲,2024-11-12,9857
2887,台新金,105,0,105,元大-蘆洲,2024-11-12,9857
2883,凱基金,107,5,102,元大-蘆洲,2024-11-12,9857
2888,新光金,110,10,100,元大-蘆洲,2024-11-12,9857
2317,鴻海,99,20,79,元大-蘆洲,2024-11-12,9857
00715L,期街口布蘭特正2,70,0,70,元大-蘆洲,2024-11-12,9857
00915,凱基優選高股息30,69,0,69,元大-蘆洲,2024-11-12,9857
00929,復華台灣科技優息,244,177,67,元大-蘆洲,2024-11-12,9857
3481,群創,66,1,65,元大-蘆洲,2024-11-12,9857
5871,中租-KY,71,7,64,元大-蘆洲,2024-11-12,9857
3037,欣興,64,15,49,元大-蘆洲,2024-11-12,9857
00753L,中信中國50正2,40,0,40,元大-蘆洲,2024-11-12,9857
5014,建錩,40,0,40,元大-蘆洲,2024-11-12,9857
2882,國泰金,47,9,38,元大-蘆洲,2024-11-12,9857
2834,臺企銀,37,0,37,元大-蘆洲,2024-11-12,9857
2382,廣達,46,10,36,元大-蘆洲,2024-11-12,9857
2409,友達,38,1,37,元大-蘆洲,2024-11-12,9857
00922,國泰台灣領袖50,38,2,36,元大-蘆洲,2024-11-12,9857
00713,元大台灣高息低波,35,3,32,元大-蘆洲,2024-11-12,9857
2489,瑞軒,30,0,30,元大-蘆洲,2024-11-12,9857
4303,信立,56,26,30,元大-蘆洲,2024-11-12,9857
2615,萬海,122,92,30,元大-蘆洲,2024-11-12,9857
00930,永豐ESG低碳高息,29,0,29,元大-蘆洲,2024-11-12,9857
5443,均豪,44,15,29,元大-蘆洲,2024-11-12,9857
2337,旺宏,30,2,28,元大-蘆洲,2024-11-12,9857
2330,台積電,31,4,27,元大-蘆洲,2024-11-12,9857
9904,寶成,31,4,27,元大-蘆洲,2024-11-12,9857
00946,群益科技高息成長,38,12,26,元大-蘆洲,2024-11-12,9857
6216,居易,27,1,26,元大-蘆洲,2024-11-12,9857
9105,泰金寶-DR,45,19,26,元大-蘆洲,2024-11-12,9857
1605,華新,34,9,25,元大-蘆洲,2024-11-12,9857
00932,兆豐永續高息等權,31,6,25,元大-蘆洲,2024-11-12,9857
5243,乙盛-KY,58,33,25,元大-蘆洲,2024-11-12,9857
2609,陽明,126,102,24,元大-蘆洲,2024-11-12,9857
2392,正崴,36,13,23,元大-蘆洲,2024-11-12,9857
6152,百一,23,1,22,元大-蘆洲,2024-11-12,9857
2312,金寶,31,9,22,元大-蘆洲,2024-11-12,9857
6288,聯嘉,29,8,21,元大-蘆洲,2024-11-12,9857
2014,中鴻,22,1,21,元大-蘆洲,2024-11-12,9857
4714,永捷,30,10,20,元大-蘆洲,2024-11-12,9857
00664R,國泰臺灣加權反1,20,0,20,元大-蘆洲,2024-11-12,9857
00712,復華富時不動產,36,16,20,元大-蘆洲,2024-11-12,9857
00934,中信成長高股息,19,0,19,元大-蘆洲,2024-11-12,9857
00953B,群益優選非投等債,671,0,671,元大-蘆洲,2024-11-13,9857
2206,三陽工業,272,2,270,元大-蘆洲,2024-11-13,9857
00878,國泰永續高股息,191,11,180,元大-蘆洲,2024-11-13,9857
00680L,元大美債20正2,158,20,138,元大-蘆洲,2024-11-13,9857
3234,光環,110,0,110,元大-蘆洲,2024-11-13,9857
2354,鴻準,311,201,110,元大-蘆洲,2024-11-13,9857
3481,群創,140,31,109,元大-蘆洲,2024-11-13,9857
00919,群益台灣精選高息,109,2,107,元大-蘆洲,2024-11-13,9857
2303,聯電,116,16,100,元大-蘆洲,2024-11-13,9857
00679B,元大美債20年,95,23,72,元大-蘆洲,2024-11-13,9857
2349,錸德,253,185,68,元大-蘆洲,2024-11-13,9857
0056,元大高股息,73,8,65,元大-蘆洲,2024-11-13,9857
2834,臺企銀,65,1,64,元大-蘆洲,2024-11-13,9857
3013,晟銘電,126,70,56,元大-蘆洲,2024-11-13,9857
2883,凱基金,62,8,54,元大-蘆洲,2024-11-13,9857
2337,旺宏,51,1,50,元大-蘆洲,2024-11-13,9857
00915,凱基優選高股息30,49,6,43,元大-蘆洲,2024-11-13,9857
2344,華邦電,46,6,40,元大-蘆洲,2024-11-13,9857
00942B,台新美A公司債20+,39,0,39,元大-蘆洲,2024-11-13,9857
00753L,中信中國50正2,41,3,38,元大-蘆洲,2024-11-13,9857
9945,潤泰新,40,4,36,元大-蘆洲,2024-11-13,9857
3583,辛耘,66,31,35,元大-蘆洲,2024-11-13,9857
2317,鴻海,56,21,35,元大-蘆洲,2024-11-13,9857
1449,佳和,41,7,34,元大-蘆洲,2024-11-13,9857
2881,富邦金,44,11,33,元大-蘆洲,2024-11-13,9857
2882,國泰金,41,8,33,元大-蘆洲,2024-11-13,9857
5309,系統電,83,52,31,元大-蘆洲,2024-11-13,9857
2392,正崴,108,78,30,元大-蘆洲,2024-11-13,9857
1582,信錦,30,0,30,元大-蘆洲,2024-11-13,9857
2457,飛宏,29,0,29,元大-蘆洲,2024-11-13,9857
3711,日月光投控,64,35,29,元大-蘆洲,2024-11-13,9857
3189,景碩,47,19,28,元大-蘆洲,2024-11-13,9857
00937B,群益ESG投等債20,49,22,27,元大-蘆洲,2024-11-13,9857
3511,矽瑪,53,26,27,元大-蘆洲,2024-11-13,9857
1802,台玻,27,0,27,元大-蘆洲,2024-11-13,9857
9105,泰金寶-DR,49,23,26,元大-蘆洲,2024-11-13,9857
00943,兆豐電子高息等權,145,120,25,元大-蘆洲,2024-11-13,9857
2105,正新,24,0,24,元大-蘆洲,2024-11-13,9857
2330,台積電,28,4,24,元大-蘆洲,2024-11-13,9857
00948B,中信優息投資級債,24,0,24,元大-蘆洲,2024-11-13,9857
8150,南茂,25,3,22,元大-蘆洲,2024-11-13,9857
2609,陽明,59,37,22,元大-蘆洲,2024-11-13,9857
3520,華盈,26,4,22,元大-蘆洲,2024-11-13,9857
00715L,期街口布蘭特正2,22,0,22,元大-蘆洲,2024-11-13,9857
00688L,國泰20年美債正2,21,0,21,元大-蘆洲,2024-11-13,9857
00908,富邦入息REITs+,20,0,20,元大-蘆洲,2024-11-13,9857
5315,光聯,21,1,20,元大-蘆洲,2024-11-13,9857
3051,力特,19,0,19,元大-蘆洲,2024-11-13,9857
2427,三商電,18,0,18,元大-蘆洲,2024-11-13,9857
4569,六方科-KY,20,2,18,元大-蘆洲,2024-11-13,9857
00878,國泰永續高股息,462,3,459,元大-蘆洲,2024-11-14,9857
2303,聯電,251,33,218,元大-蘆洲,2024-11-14,9857
00929,復華台灣科技優息,212,30,182,元大-蘆洲,2024-11-14,9857
00680L,元大美債20正2,205,50,155,元大-蘆洲,2024-11-14,9857
2892,第一金,139,4,135,元大-蘆洲,2024-11-14,9857
00687B,國泰20年美債,159,29,130,元大-蘆洲,2024-11-14,9857
00919,群益台灣精選高息,113,4,109,元大-蘆洲,2024-11-14,9857
0056,元大高股息,116,20,96,元大-蘆洲,2024-11-14,9857
00948B,中信優息投資級債,92,0,92,元大-蘆洲,2024-11-14,9857
00953B,群益優選非投等債,85,0,85,元大-蘆洲,2024-11-14,9857
00915,凱基優選高股息30,83,0,83,元大-蘆洲,2024-11-14,9857
00706L,期元大S＆P日圓正2,57,0,57,元大-蘆洲,2024-11-14,9857
3481,群創,58,2,56,元大-蘆洲,2024-11-14,9857
3231,緯創,71,20,51,元大-蘆洲,2024-11-14,9857
4931,新盛力,736,686,50,元大-蘆洲,2024-11-14,9857
00688L,國泰20年美債正2,41,0,41,元大-蘆洲,2024-11-14,9857
1301,台塑,51,11,40,元大-蘆洲,2024-11-14,9857
2317,鴻海,74,35,39,元大-蘆洲,2024-11-14,9857
1471,首利,40,1,39,元大-蘆洲,2024-11-14,9857
00946,群益科技高息成長,37,0,37,元大-蘆洲,2024-11-14,9857
2206,三陽工業,40,5,35,元大-蘆洲,2024-11-14,9857
2312,金寶,101,67,34,元大-蘆洲,2024-11-14,9857
00932,兆豐永續高息等權,34,0,34,元大-蘆洲,2024-11-14,9857
2634,漢翔,33,0,33,元大-蘆洲,2024-11-14,9857
2344,華邦電,35,3,32,元大-蘆洲,2024-11-14,9857
00940,元大台灣價值高息,48,16,32,元大-蘆洲,2024-11-14,9857
2365,昆盈,31,1,30,元大-蘆洲,2024-11-14,9857
2101,南港,41,11,30,元大-蘆洲,2024-11-14,9857
2884,玉山金,29,0,29,元大-蘆洲,2024-11-14,9857
00930,永豐ESG低碳高息,29,0,29,元大-蘆洲,2024-11-14,9857
00713,元大台灣高息低波,31,2,29,元大-蘆洲,2024-11-14,9857
4938,和碩,37,8,29,元大-蘆洲,2024-11-14,9857
8027,鈦昇,28,0,28,元大-蘆洲,2024-11-14,9857
2034,允強,30,2,28,元大-蘆洲,2024-11-14,9857
2382,廣達,52,26,26,元大-蘆洲,2024-11-14,9857
00918,大華優利高填息30,28,3,25,元大-蘆洲,2024-11-14,9857
3037,欣興,39,14,25,元大-蘆洲,2024-11-14,9857
2337,旺宏,25,3,22,元大-蘆洲,2024-11-14,9857
3290,東浦,22,0,22,元大-蘆洲,2024-11-14,9857
4562,穎漢,21,0,21,元大-蘆洲,2024-11-14,9857
2457,飛宏,21,0,21,元大-蘆洲,2024-11-14,9857
6509,聚和,20,0,20,元大-蘆洲,2024-11-14,9857
2014,中鴻,20,0,20,元大-蘆洲,2024-11-14,9857
1449,佳和,25,5,20,元大-蘆洲,2024-11-14,9857
00908,富邦入息REITs+,20,0,20,元大-蘆洲,2024-11-14,9857
4906,正文,20,0,20,元大-蘆洲,2024-11-14,9857
00922,國泰台灣領袖50,20,0,20,元大-蘆洲,2024-11-14,9857
2867,三商壽,20,0,20,元大-蘆洲,2024-11-14,9857
006208,富邦台50,23,4,19,元大-蘆洲,2024-11-14,9857
00927,群益半導體收益,18,0,18,元大-蘆洲,2024-11-14,9857
00953B,群益優選非投等債,506,0,506,元大-蘆洲,2024-11-15,9857
00878,國泰永續高股息,417,27,390,元大-蘆洲,2024-11-15,9857
3706,神達,862,753,109,元大-蘆洲,2024-11-15,9857
8927,北基,100,0,100,元大-蘆洲,2024-11-15,9857
00948B,中信優息投資級債,156,60,96,元大-蘆洲,2024-11-15,9857
2382,廣達,128,39,89,元大-蘆洲,2024-11-15,9857
00679B,元大美債20年,87,12,75,元大-蘆洲,2024-11-15,9857
00918,大華優利高填息30,86,14,72,元大-蘆洲,2024-11-15,9857
2368,金像電,66,2,64,元大-蘆洲,2024-11-15,9857
2880,華南金,63,1,62,元大-蘆洲,2024-11-15,9857
2317,鴻海,116,55,61,元大-蘆洲,2024-11-15,9857
2356,英業達,71,11,60,元大-蘆洲,2024-11-15,9857
3711,日月光投控,68,8,60,元大-蘆洲,2024-11-15,9857
2206,三陽工業,46,0,46,元大-蘆洲,2024-11-15,9857
00943,兆豐電子高息等權,40,0,40,元大-蘆洲,2024-11-15,9857
3591,艾笛森,37,0,37,元大-蘆洲,2024-11-15,9857
00945B,凱基美國非投等債,36,0,36,元大-蘆洲,2024-11-15,9857
5309,系統電,55,23,32,元大-蘆洲,2024-11-15,9857
00937B,群益ESG投等債20,50,23,27,元大-蘆洲,2024-11-15,9857
00932,兆豐永續高息等權,38,12,26,元大-蘆洲,2024-11-15,9857
00933B,國泰10Y+金融債,22,0,22,元大-蘆洲,2024-11-15,9857
3013,晟銘電,42,20,22,元大-蘆洲,2024-11-15,9857
3017,奇鋐,32,10,22,元大-蘆洲,2024-11-15,9857
2101,南港,20,0,20,元大-蘆洲,2024-11-15,9857
4157,太景*-KY,20,0,20,元大-蘆洲,2024-11-15,9857
5871,中租-KY,28,9,19,元大-蘆洲,2024-11-15,9857
1446,宏和,18,1,17,元大-蘆洲,2024-11-15,9857
0056,元大高股息,22,5,17,元大-蘆洲,2024-11-15,9857
3338,泰碩,32,16,16,元大-蘆洲,2024-11-15,9857
5450,南良,16,0,16,元大-蘆洲,2024-11-15,9857
1618,合機,68,52,16,元大-蘆洲,2024-11-15,9857
2303,聯電,43,27,16,元大-蘆洲,2024-11-15,9857
6770,力積電,16,1,15,元大-蘆洲,2024-11-15,9857
4906,正文,15,0,15,元大-蘆洲,2024-11-15,9857
6763,綠界科技*,19,4,15,元大-蘆洲,2024-11-15,9857
3202,樺晟,14,0,14,元大-蘆洲,2024-11-15,9857
3149,正達,31,17,14,元大-蘆洲,2024-11-15,9857
2324,仁寶,23,11,12,元大-蘆洲,2024-11-15,9857
3037,欣興,21,9,12,元大-蘆洲,2024-11-15,9857
4566,時碩工業,13,1,12,元大-蘆洲,2024-11-15,9857
8111,立��,16,4,12,元大-蘆洲,2024-11-15,9857
3312,弘憶股,22,10,12,元大-蘆洲,2024-11-15,9857
1524,耿鼎,29,17,12,元大-蘆洲,2024-11-15,9857
00960,野村全球航運龍頭,18,7,11,元大-蘆洲,2024-11-15,9857
2002,中鋼,18,7,11,元大-蘆洲,2024-11-15,9857
00712,復華富時不動產,11,0,11,元大-蘆洲,2024-11-15,9857
8227,巨有科技,12,1,11,元大-蘆洲,2024-11-15,9857
3264,欣銓,10,0,10,元大-蘆洲,2024-11-15,9857
00753L,中信中國50正2,12,2,10,元大-蘆洲,2024-11-15,9857
2409,友達,16,6,10,元大-蘆洲,2024-11-15,9857
00878,國泰永續高股息,587,83,504,元大-蘆洲,2024-11-18,9857
00948B,中信優息投資級債,415,2,413,元大-蘆洲,2024-11-18,9857
9105,泰金寶-DR,305,97,208,元大-蘆洲,2024-11-18,9857
2312,金寶,558,444,114,元大-蘆洲,2024-11-18,9857
8927,北基,101,0,101,元大-蘆洲,2024-11-18,9857
2812,台中銀,100,1,99,元大-蘆洲,2024-11-18,9857
00929,復華台灣科技優息,216,128,88,元大-蘆洲,2024-11-18,9857
2337,旺宏,88,1,87,元大-蘆洲,2024-11-18,9857
0056,元大高股息,83,14,69,元大-蘆洲,2024-11-18,9857
00953B,群益優選非投等債,67,0,67,元大-蘆洲,2024-11-18,9857
2354,鴻準,247,180,67,元大-蘆洲,2024-11-18,9857
00932,兆豐永續高息等權,62,0,62,元大-蘆洲,2024-11-18,9857
00680L,元大美債20正2,101,40,61,元大-蘆洲,2024-11-18,9857
00637L,元大滬深300正2,179,118,61,元大-蘆洲,2024-11-18,9857
2317,鴻海,72,18,54,元大-蘆洲,2024-11-18,9857
00650L,復華香港正2,50,0,50,元大-蘆洲,2024-11-18,9857
2371,大同,52,11,41,元大-蘆洲,2024-11-18,9857
00930,永豐ESG低碳高息,41,0,41,元大-蘆洲,2024-11-18,9857
00943,兆豐電子高息等權,180,140,40,元大-蘆洲,2024-11-18,9857
00919,群益台灣精選高息,53,13,40,元大-蘆洲,2024-11-18,9857
00937B,群益ESG投等債20,40,1,39,元大-蘆洲,2024-11-18,9857
9904,寶成,44,8,36,元大-蘆洲,2024-11-18,9857
00963,中信全球高股息,35,0,35,元大-蘆洲,2024-11-18,9857
1815,富喬,40,6,34,元大-蘆洲,2024-11-18,9857
2385,群光,32,0,32,元大-蘆洲,2024-11-18,9857
6285,啟��,32,2,30,元大-蘆洲,2024-11-18,9857
6763,綠界科技*,45,15,30,元大-蘆洲,2024-11-18,9857
2511,太子,30,0,30,元大-蘆洲,2024-11-18,9857
00713,元大台灣高息低波,30,2,28,元大-蘆洲,2024-11-18,9857
6133,金橋,33,5,28,元大-蘆洲,2024-11-18,9857
8044,網家,99,71,28,元大-蘆洲,2024-11-18,9857
1605,華新,31,4,27,元大-蘆洲,2024-11-18,9857
1785,光洋科,32,6,26,元大-蘆洲,2024-11-18,9857
2324,仁寶,33,7,26,元大-蘆洲,2024-11-18,9857
006208,富邦台50,24,0,24,元大-蘆洲,2024-11-18,9857
2356,英業達,65,41,24,元大-蘆洲,2024-11-18,9857
4956,光鋐,36,13,23,元大-蘆洲,2024-11-18,9857
1101,台泥,28,6,22,元大-蘆洲,2024-11-18,9857
3024,憶聲,21,0,21,元大-蘆洲,2024-11-18,9857
00887,永豐中國科技50大,53,32,21,元大-蘆洲,2024-11-18,9857
2329,華泰,21,2,19,元大-蘆洲,2024-11-18,9857
8284,三竹,18,0,18,元大-蘆洲,2024-11-18,9857
3704,合勤控,18,0,18,元大-蘆洲,2024-11-18,9857
6667,信紘科,18,0,18,元大-蘆洲,2024-11-18,9857
00915,凱基優選高股息30,17,0,17,元大-蘆洲,2024-11-18,9857
00922,國泰台灣領袖50,17,0,17,元大-蘆洲,2024-11-18,9857
4729,熒茂,29,12,17,元大-蘆洲,2024-11-18,9857
2405,輔信,17,0,17,元大-蘆洲,2024-11-18,9857
00891,中信關鍵半導體,16,0,16,元大-蘆洲,2024-11-18,9857
3047,訊舟,23,7,16,元大-蘆洲,2024-11-18,9857
00953B,群益優選非投等債,250,0,250,元大-蘆洲,2024-11-19,9857
2354,鴻準,466,284,182,元大-蘆洲,2024-11-19,9857
00930,永豐ESG低碳高息,164,0,164,元大-蘆洲,2024-11-19,9857
00637L,元大滬深300正2,127,10,117,元大-蘆洲,2024-11-19,9857
2349,錸德,293,191,102,元大-蘆洲,2024-11-19,9857
00665L,富邦�琤肭磪囓�2,92,0,92,元大-蘆洲,2024-11-19,9857
00878,國泰永續高股息,187,106,81,元大-蘆洲,2024-11-19,9857
00948B,中信優息投資級債,70,0,70,元大-蘆洲,2024-11-19,9857
0056,元大高股息,65,7,58,元大-蘆洲,2024-11-19,9857
2399,映泰,126,71,55,元大-蘆洲,2024-11-19,9857
9105,泰金寶-DR,284,231,53,元大-蘆洲,2024-11-19,9857
00650L,復華香港正2,50,0,50,元大-蘆洲,2024-11-19,9857
2382,廣達,58,15,43,元大-蘆洲,2024-11-19,9857
00673R,期元大S＆P原油反1,40,0,40,元大-蘆洲,2024-11-19,9857
2845,遠東銀,40,0,40,元大-蘆洲,2024-11-19,9857
3481,群創,80,42,38,元大-蘆洲,2024-11-19,9857
2317,鴻海,53,21,32,元大-蘆洲,2024-11-19,9857
2385,群光,30,0,30,元大-蘆洲,2024-11-19,9857
00918,大華優利高填息30,34,5,29,元大-蘆洲,2024-11-19,9857
00887,永豐中國科技50大,25,0,25,元大-蘆洲,2024-11-19,9857
2371,大同,42,20,22,元大-蘆洲,2024-11-19,9857
1301,台塑,31,10,21,元大-蘆洲,2024-11-19,9857
0050,元大台灣50,21,2,19,元大-蘆洲,2024-11-19,9857
2882,國泰金,28,10,18,元大-蘆洲,2024-11-19,9857
00713,元大台灣高息低波,24,8,16,元大-蘆洲,2024-11-19,9857
2353,宏��,18,2,16,元大-蘆洲,2024-11-19,9857
2890,永豐金,17,1,16,元大-蘆洲,2024-11-19,9857
00932,兆豐永續高息等權,21,6,15,元大-蘆洲,2024-11-19,9857
6122,擎邦,15,0,15,元大-蘆洲,2024-11-19,9857
3290,東浦,25,11,14,元大-蘆洲,2024-11-19,9857
3596,智易,14,0,14,元大-蘆洲,2024-11-19,9857
2344,華邦電,16,2,14,元大-蘆洲,2024-11-19,9857
2303,聯電,25,11,14,元大-蘆洲,2024-11-19,9857
6763,綠界科技*,23,10,13,元大-蘆洲,2024-11-19,9857
5309,系統電,50,37,13,元大-蘆洲,2024-11-19,9857
3062,建漢,26,13,13,元大-蘆洲,2024-11-19,9857
3705,永信,12,0,12,元大-蘆洲,2024-11-19,9857
006208,富邦台50,16,4,12,元大-蘆洲,2024-11-19,9857
2884,玉山金,17,6,11,元大-蘆洲,2024-11-19,9857
3689,湧德,11,0,11,元大-蘆洲,2024-11-19,9857
4157,太景*-KY,10,0,10,元大-蘆洲,2024-11-19,9857
1710,東聯,10,0,10,元大-蘆洲,2024-11-19,9857
1595,川寶,12,2,10,元大-蘆洲,2024-11-19,9857
4958,臻鼎-KY,10,0,10,元大-蘆洲,2024-11-19,9857
6185,幃翔,10,0,10,元大-蘆洲,2024-11-19,9857
3260,威剛,10,0,10,元大-蘆洲,2024-11-19,9857
5512,力麒,9,0,9,元大-蘆洲,2024-11-19,9857
4968,立積,12,3,9,元大-蘆洲,2024-11-19,9857
2605,新興,18,9,9,元大-蘆洲,2024-11-19,9857
2365,昆盈,10,1,9,元大-蘆洲,2024-11-19,9857
00948B,中信優息投資級債,530,0,530,元大-蘆洲,2024-11-20,9857
2349,錸德,677,356,321,元大-蘆洲,2024-11-20,9857
2880,華南金,104,0,104,元大-蘆洲,2024-11-20,9857
2204,中華,121,23,98,元大-蘆洲,2024-11-20,9857
2618,長榮航,182,88,94,元大-蘆洲,2024-11-20,9857
00937B,群益ESG投等債20,81,5,76,元大-蘆洲,2024-11-20,9857
00878,國泰永續高股息,90,22,68,元大-蘆洲,2024-11-20,9857
00943,兆豐電子高息等權,60,0,60,元大-蘆洲,2024-11-20,9857
00932,兆豐永續高息等權,45,0,45,元大-蘆洲,2024-11-20,9857
3024,憶聲,52,9,43,元大-蘆洲,2024-11-20,9857
2206,三陽工業,62,19,43,元大-蘆洲,2024-11-20,9857
00953B,群益優選非投等債,42,0,42,元大-蘆洲,2024-11-20,9857
00892,富邦台灣半導體,40,0,40,元大-蘆洲,2024-11-20,9857
2329,華泰,36,3,33,元大-蘆洲,2024-11-20,9857
00930,永豐ESG低碳高息,32,0,32,元大-蘆洲,2024-11-20,9857
4956,光鋐,78,50,28,元大-蘆洲,2024-11-20,9857
2303,聯電,61,35,26,元大-蘆洲,2024-11-20,9857
2313,華通,26,1,25,元大-蘆洲,2024-11-20,9857
2356,英業達,58,34,24,元大-蘆洲,2024-11-20,9857
0056,元大高股息,28,4,24,元大-蘆洲,2024-11-20,9857
4729,熒茂,42,19,23,元大-蘆洲,2024-11-20,9857
00830,國泰費城半導體,21,0,21,元大-蘆洲,2024-11-20,9857
00673R,期元大S＆P原油反1,21,0,21,元大-蘆洲,2024-11-20,9857
2002,中鋼,26,5,21,元大-蘆洲,2024-11-20,9857
2885,元大金,20,1,19,元大-蘆洲,2024-11-20,9857
3167,大量,60,42,18,元大-蘆洲,2024-11-20,9857
6558,興能高,21,3,18,元大-蘆洲,2024-11-20,9857
00687B,國泰20年美債,142,126,16,元大-蘆洲,2024-11-20,9857
2646,星宇航空,28,12,16,元大-蘆洲,2024-11-20,9857
3447,展達,32,16,16,元大-蘆洲,2024-11-20,9857
9105,泰金寶-DR,147,131,16,元大-蘆洲,2024-11-20,9857
3019,亞光,23,8,15,元大-蘆洲,2024-11-20,9857
00927,群益半導體收益,15,0,15,元大-蘆洲,2024-11-20,9857
1301,台塑,15,1,14,元大-蘆洲,2024-11-20,9857
8027,鈦昇,20,6,14,元大-蘆洲,2024-11-20,9857
3515,華擎,16,2,14,元大-蘆洲,2024-11-20,9857
1721,三晃,14,0,14,元大-蘆洲,2024-11-20,9857
2330,台積電,17,3,14,元大-蘆洲,2024-11-20,9857
3231,緯創,48,34,14,元大-蘆洲,2024-11-20,9857
2363,矽統,24,11,13,元大-蘆洲,2024-11-20,9857
2353,宏��,13,0,13,元大-蘆洲,2024-11-20,9857
2409,友達,13,0,13,元大-蘆洲,2024-11-20,9857
0050,元大台灣50,13,0,13,元大-蘆洲,2024-11-20,9857
006208,富邦台50,15,3,12,元大-蘆洲,2024-11-20,9857
1319,東陽,14,2,12,元大-蘆洲,2024-11-20,9857
1734,杏輝,12,0,12,元大-蘆洲,2024-11-20,9857
4123,晟德,15,3,12,元大-蘆洲,2024-11-20,9857
3293,鈊象,21,9,12,元大-蘆洲,2024-11-20,9857
2489,瑞軒,12,0,12,元大-蘆洲,2024-11-20,9857
9958,世紀鋼,11,0,11,元大-蘆洲,2024-11-20,9857
00919,群益台灣精選高息,734,28,706,元大-蘆洲,2024-11-21,9857
2204,中華,382,88,294,元大-蘆洲,2024-11-21,9857
00632R,元大台灣50反1,330,110,220,元大-蘆洲,2024-11-21,9857
00953B,群益優選非投等債,135,0,135,元大-蘆洲,2024-11-21,9857
00878,國泰永續高股息,148,34,114,元大-蘆洲,2024-11-21,9857
2303,聯電,127,52,75,元大-蘆洲,2024-11-21,9857
1815,富喬,164,90,74,元大-蘆洲,2024-11-21,9857
2455,全新,86,24,62,元大-蘆洲,2024-11-21,9857
3548,兆利,76,26,50,元大-蘆洲,2024-11-21,9857
8070,長華*,50,1,49,元大-蘆洲,2024-11-21,9857
8086,宏捷科,54,11,43,元大-蘆洲,2024-11-21,9857
00688L,國泰20年美債正2,40,0,40,元大-蘆洲,2024-11-21,9857
00753L,中信中國50正2,40,0,40,元大-蘆洲,2024-11-21,9857
3019,亞光,46,14,32,元大-蘆洲,2024-11-21,9857
1471,首利,35,5,30,元大-蘆洲,2024-11-21,9857
2890,永豐金,43,13,30,元大-蘆洲,2024-11-21,9857
00687B,國泰20年美債,56,27,29,元大-蘆洲,2024-11-21,9857
2618,長榮航,67,40,27,元大-蘆洲,2024-11-21,9857
2330,台積電,29,2,27,元大-蘆洲,2024-11-21,9857
8104,錸寶,242,217,25,元大-蘆洲,2024-11-21,9857
0056,元大高股息,53,28,25,元大-蘆洲,2024-11-21,9857
00959B,大華投等美債15Y+,24,0,24,元大-蘆洲,2024-11-21,9857
00830,國泰費城半導體,23,0,23,元大-蘆洲,2024-11-21,9857
3323,加百裕,51,29,22,元大-蘆洲,2024-11-21,9857
3062,建漢,25,4,21,元大-蘆洲,2024-11-21,9857
006208,富邦台50,24,3,21,元大-蘆洲,2024-11-21,9857
2881,富邦金,21,1,20,元大-蘆洲,2024-11-21,9857
1312,國喬,20,0,20,元大-蘆洲,2024-11-21,9857
6541,泰福-KY,22,2,20,元大-蘆洲,2024-11-21,9857
00950B,凱基A級公司債,20,0,20,元大-蘆洲,2024-11-21,9857
1710,東聯,20,0,20,元大-蘆洲,2024-11-21,9857
3374,精材,29,9,20,元大-蘆洲,2024-11-21,9857
00922,國泰台灣領袖50,19,0,19,元大-蘆洲,2024-11-21,9857
3163,波若威,20,2,18,元大-蘆洲,2024-11-21,9857
2317,鴻海,53,35,18,元大-蘆洲,2024-11-21,9857
1301,台塑,17,0,17,元大-蘆洲,2024-11-21,9857
00713,元大台灣高息低波,17,1,16,元大-蘆洲,2024-11-21,9857
2607,榮運,16,0,16,元大-蘆洲,2024-11-21,9857
9945,潤泰新,16,0,16,元大-蘆洲,2024-11-21,9857
2413,環科,33,17,16,元大-蘆洲,2024-11-21,9857
6170,統振,16,0,16,元大-蘆洲,2024-11-21,9857
4716,大立,16,0,16,元大-蘆洲,2024-11-21,9857
1611,中電,16,1,15,元大-蘆洲,2024-11-21,9857
8076,伍豐,15,0,15,元大-蘆洲,2024-11-21,9857
2615,萬海,87,72,15,元大-蘆洲,2024-11-21,9857
3303,岱稜,17,3,14,元大-蘆洲,2024-11-21,9857
2365,昆盈,13,0,13,元大-蘆洲,2024-11-21,9857
2357,華碩,14,1,13,元大-蘆洲,2024-11-21,9857
00915,凱基優選高股息30,13,0,13,元大-蘆洲,2024-11-21,9857
3481,群創,23,10,13,元大-蘆洲,2024-11-21,9857
9105,泰金寶-DR,1306,1158,148,元大-蘆洲,2024-11-22,9857
2834,臺企銀,191,64,127,元大-蘆洲,2024-11-22,9857
1802,台玻,232,106,126,元大-蘆洲,2024-11-22,9857
00637L,元大滬深300正2,216,102,114,元大-蘆洲,2024-11-22,9857
2609,陽明,166,84,82,元大-蘆洲,2024-11-22,9857
00753L,中信中國50正2,74,1,73,元大-蘆洲,2024-11-22,9857
6134,萬旭,112,44,68,元大-蘆洲,2024-11-22,9857
1569,濱川,84,19,65,元大-蘆洲,2024-11-22,9857
00953B,群益優選非投等債,64,0,64,元大-蘆洲,2024-11-22,9857
3706,神達,496,444,52,元大-蘆洲,2024-11-22,9857
00665L,富邦�琤肭磪囓�2,50,2,48,元大-蘆洲,2024-11-22,9857
3019,亞光,61,20,41,元大-蘆洲,2024-11-22,9857
3593,力銘,37,1,36,元大-蘆洲,2024-11-22,9857
3702,大聯大,69,34,35,元大-蘆洲,2024-11-22,9857
00673R,期元大S＆P原油反1,32,0,32,元大-蘆洲,2024-11-22,9857
3211,順達,32,1,31,元大-蘆洲,2024-11-22,9857
2905,三商,30,0,30,元大-蘆洲,2024-11-22,9857
2539,櫻花建,43,14,29,元大-蘆洲,2024-11-22,9857
3088,艾訊,30,1,29,元大-蘆洲,2024-11-22,9857
1301,台塑,32,3,29,元大-蘆洲,2024-11-22,9857
3027,盛達,41,14,27,元大-蘆洲,2024-11-22,9857
912000,晨訊科-DR,26,0,26,元大-蘆洲,2024-11-22,9857
00882,中信中國高股息,26,1,25,元大-蘆洲,2024-11-22,9857
8150,南茂,27,3,24,元大-蘆洲,2024-11-22,9857
00878,國泰永續高股息,31,8,23,元大-蘆洲,2024-11-22,9857
2002,中鋼,32,10,22,元大-蘆洲,2024-11-22,9857
2903,遠百,22,0,22,元大-蘆洲,2024-11-22,9857
00679B,元大美債20年,33,12,21,元大-蘆洲,2024-11-22,9857
4513,福裕,32,11,21,元大-蘆洲,2024-11-22,9857
4306,炎洲,21,0,21,元大-蘆洲,2024-11-22,9857
3520,華盈,20,0,20,元大-蘆洲,2024-11-22,9857
00719B,元大美債1-3,20,0,20,元大-蘆洲,2024-11-22,9857
2504,國產,20,0,20,元大-蘆洲,2024-11-22,9857
1471,首利,23,3,20,元大-蘆洲,2024-11-22,9857
1702,南僑,21,1,20,元大-蘆洲,2024-11-22,9857
5426,振發,27,9,18,元大-蘆洲,2024-11-22,9857
2392,正崴,40,23,17,元大-蘆洲,2024-11-22,9857
00909,國泰數位支付服務,22,5,17,元大-蘆洲,2024-11-22,9857
1513,中興電,19,3,16,元大-蘆洲,2024-11-22,9857
00922,國泰台灣領袖50,17,3,14,元大-蘆洲,2024-11-22,9857
8047,星雲,13,0,13,元大-蘆洲,2024-11-22,9857
6257,矽格,13,0,13,元大-蘆洲,2024-11-22,9857
8163,達方,33,21,12,元大-蘆洲,2024-11-22,9857
2615,萬海,31,19,12,元大-蘆洲,2024-11-22,9857
6187,萬潤,16,5,11,元大-蘆洲,2024-11-22,9857
00950B,凱基A級公司債,11,0,11,元大-蘆洲,2024-11-22,9857
5871,中租-KY,11,0,11,元大-蘆洲,2024-11-22,9857
1519,華城,35,25,10,元大-蘆洲,2024-11-22,9857
2486,一詮,17,6,11,元大-蘆洲,2024-11-22,9857
5328,華容,10,0,10,元大-蘆洲,2024-11-22,9857
1815,富喬,1296,534,762,元大-蘆洲,2024-11-25,9857
00948B,中信優息投資級債,201,5,196,元大-蘆洲,2024-11-25,9857
2312,金寶,1114,920,194,元大-蘆洲,2024-11-25,9857
00632R,元大台灣50反1,134,8,126,元大-蘆洲,2024-11-25,9857
2303,聯電,163,46,117,元大-蘆洲,2024-11-25,9857
00673R,期元大S＆P原油反1,111,1,110,元大-蘆洲,2024-11-25,9857
00953B,群益優選非投等債,110,0,110,元大-蘆洲,2024-11-25,9857
00919,群益台灣精選高息,113,11,102,元大-蘆洲,2024-11-25,9857
2618,長榮航,140,66,74,元大-蘆洲,2024-11-25,9857
2206,三陽工業,62,0,62,元大-蘆洲,2024-11-25,9857
1569,濱川,111,51,60,元大-蘆洲,2024-11-25,9857
00753L,中信中國50正2,59,0,59,元大-蘆洲,2024-11-25,9857
1314,中石化,57,9,48,元大-蘆洲,2024-11-25,9857
2344,華邦電,41,0,41,元大-蘆洲,2024-11-25,9857
2539,櫻花建,37,0,37,元大-蘆洲,2024-11-25,9857
2915,潤泰全,40,4,36,元大-蘆洲,2024-11-25,9857
00887,永豐中國科技50大,26,0,26,元大-蘆洲,2024-11-25,9857
2883B,凱基金乙特,26,0,26,元大-蘆洲,2024-11-25,9857
2603,長榮,116,91,25,元大-蘆洲,2024-11-25,9857
2515,中工,23,0,23,元大-蘆洲,2024-11-25,9857
00637L,元大滬深300正2,25,5,20,元大-蘆洲,2024-11-25,9857
1532,勤美,20,0,20,元大-蘆洲,2024-11-25,9857
2332,友訊,26,8,18,元大-蘆洲,2024-11-25,9857
3013,晟銘電,24,6,18,元大-蘆洲,2024-11-25,9857
2449,京元電子,46,29,17,元大-蘆洲,2024-11-25,9857
1702,南僑,16,0,16,元大-蘆洲,2024-11-25,9857
5465,富驊,24,9,15,元大-蘆洲,2024-11-25,9857
3114,好德,43,28,15,元大-蘆洲,2024-11-25,9857
3694,海華,20,5,15,元大-蘆洲,2024-11-25,9857
3710,連展投控,18,4,14,元大-蘆洲,2024-11-25,9857
1301,台塑,18,4,14,元大-蘆洲,2024-11-25,9857
2885,元大金,21,8,13,元大-蘆洲,2024-11-25,9857
3149,正達,19,6,13,元大-蘆洲,2024-11-25,9857
5522,遠雄,15,3,12,元大-蘆洲,2024-11-25,9857
6202,盛群,12,0,12,元大-蘆洲,2024-11-25,9857
4716,大立,12,0,12,元大-蘆洲,2024-11-25,9857
3702,大聯大,11,0,11,元大-蘆洲,2024-11-25,9857
5469,瀚宇博,12,1,11,元大-蘆洲,2024-11-25,9857
2330,台積電,14,3,11,元大-蘆洲,2024-11-25,9857
6190,萬泰科,11,1,10,元大-蘆洲,2024-11-25,9857
2545,皇翔,10,0,10,元大-蘆洲,2024-11-25,9857
2101,南港,10,0,10,元大-蘆洲,2024-11-25,9857
3016,嘉晶,11,1,10,元大-蘆洲,2024-11-25,9857
3015,全漢,13,3,10,元大-蘆洲,2024-11-25,9857
2363,矽統,11,1,10,元大-蘆洲,2024-11-25,9857
3031,佰鴻,12,2,10,元大-蘆洲,2024-11-25,9857
5328,華容,10,0,10,元大-蘆洲,2024-11-25,9857
2342,茂矽,10,0,10,元大-蘆洲,2024-11-25,9857
2634,漢翔,10,0,10,元大-蘆洲,2024-11-25,9857
2023,燁輝,10,1,9,元大-蘆洲,2024-11-25,9857
2312,金寶,899,450,449,元大-蘆洲,2024-11-26,9857
1815,富喬,300,137,163,元大-蘆洲,2024-11-26,9857
00930,永豐ESG低碳高息,127,0,127,元大-蘆洲,2024-11-26,9857
9105,泰金寶-DR,368,243,125,元大-蘆洲,2024-11-26,9857
3706,神達,374,250,124,元大-蘆洲,2024-11-26,9857
2317,鴻海,167,44,123,元大-蘆洲,2024-11-26,9857
6104,創惟,171,75,96,元大-蘆洲,2024-11-26,9857
2354,鴻準,115,31,84,元大-蘆洲,2024-11-26,9857
00950B,凱基A級公司債,61,0,61,元大-蘆洲,2024-11-26,9857
00741B,富邦全球非投等債,55,0,55,元大-蘆洲,2024-11-26,9857
2344,華邦電,58,8,50,元大-蘆洲,2024-11-26,9857
00878,國泰永續高股息,60,11,49,元大-蘆洲,2024-11-26,9857
2609,陽明,66,18,48,元大-蘆洲,2024-11-26,9857
00905,FT臺灣Smart,48,1,47,元大-蘆洲,2024-11-26,9857
9904,寶成,48,4,44,元大-蘆洲,2024-11-26,9857
2204,中華,66,23,43,元大-蘆洲,2024-11-26,9857
5309,系統電,209,168,41,元大-蘆洲,2024-11-26,9857
00919,群益台灣精選高息,60,20,40,元大-蘆洲,2024-11-26,9857
2426,鼎元,96,57,39,元大-蘆洲,2024-11-26,9857
2371,大同,44,6,38,元大-蘆洲,2024-11-26,9857
2464,盟立,35,0,35,元大-蘆洲,2024-11-26,9857
3231,緯創,80,49,31,元大-蘆洲,2024-11-26,9857
2330,台積電,33,2,31,元大-蘆洲,2024-11-26,9857
3338,泰碩,32,3,29,元大-蘆洲,2024-11-26,9857
2337,旺宏,28,1,27,元大-蘆洲,2024-11-26,9857
5452,佶優,40,16,24,元大-蘆洲,2024-11-26,9857
3481,群創,32,9,23,元大-蘆洲,2024-11-26,9857
2605,新興,23,0,23,元大-蘆洲,2024-11-26,9857
2636,台驊控股,23,0,23,元大-蘆洲,2024-11-26,9857
2303,聯電,72,49,23,元大-蘆洲,2024-11-26,9857
3323,加百裕,188,166,22,元大-蘆洲,2024-11-26,9857
00918,大華優利高填息30,29,7,22,元大-蘆洲,2024-11-26,9857
00915,凱基優選高股息30,27,6,21,元大-蘆洲,2024-11-26,9857
1563,巧新,21,0,21,元大-蘆洲,2024-11-26,9857
1524,耿鼎,60,39,21,元大-蘆洲,2024-11-26,9857
2206,三陽工業,21,0,21,元大-蘆洲,2024-11-26,9857
1314,中石化,21,0,21,元大-蘆洲,2024-11-26,9857
00665L,富邦�琤肭磪囓�2,50,30,20,元大-蘆洲,2024-11-26,9857
00953B,群益優選非投等債,20,0,20,元大-蘆洲,2024-11-26,9857
5014,建錩,20,0,20,元大-蘆洲,2024-11-26,9857
2883B,凱基金乙特,20,0,20,元大-蘆洲,2024-11-26,9857
2349,錸德,110,91,19,元大-蘆洲,2024-11-26,9857
2419,仲琦,35,16,19,元大-蘆洲,2024-11-26,9857
2615,萬海,30,12,18,元大-蘆洲,2024-11-26,9857
3293,鈊象,20,3,17,元大-蘆洲,2024-11-26,9857
2401,凌陽,17,0,17,元大-蘆洲,2024-11-26,9857
6862,三集瑞-KY,17,0,17,元大-蘆洲,2024-11-26,9857
8096,擎亞,22,5,17,元大-蘆洲,2024-11-26,9857
00937B,群益ESG投等債20,20,4,16,元大-蘆洲,2024-11-26,9857
2890,永豐金,16,0,16,元大-蘆洲,2024-11-26,9857
0056,元大高股息,890,10,880,元大-蘆洲,2024-11-27,9857
00919,群益台灣精選高息,372,50,322,元大-蘆洲,2024-11-27,9857
2303,聯電,336,22,314,元大-蘆洲,2024-11-27,9857
00940,元大台灣價值高息,242,2,240,元大-蘆洲,2024-11-27,9857
00878,國泰永續高股息,258,74,184,元大-蘆洲,2024-11-27,9857
3231,緯創,196,78,118,元大-蘆洲,2024-11-27,9857
00918,大華優利高填息30,112,5,107,元大-蘆洲,2024-11-27,9857
3450,聯鈞,136,40,96,元大-蘆洲,2024-11-27,9857
1536,和大,299,232,67,元大-蘆洲,2024-11-27,9857
00934,中信成長高股息,66,0,66,元大-蘆洲,2024-11-27,9857
3694,海華,60,0,60,元大-蘆洲,2024-11-27,9857
2317,鴻海,199,143,56,元大-蘆洲,2024-11-27,9857
2539,櫻花建,54,0,54,元大-蘆洲,2024-11-27,9857
2457,飛宏,59,6,53,元大-蘆洲,2024-11-27,9857
8070,長華*,53,1,52,元大-蘆洲,2024-11-27,9857
2332,友訊,148,97,51,元大-蘆洲,2024-11-27,9857
00930,永豐ESG低碳高息,148,97,51,元大-蘆洲,2024-11-27,9857
00953B,群益優選非投等債,49,0,49,元大-蘆洲,2024-11-27,9857
00712,復華富時不動產,60,15,45,元大-蘆洲,2024-11-27,9857
00915,凱基優選高股息30,40,0,40,元大-蘆洲,2024-11-27,9857
2426,鼎元,60,21,39,元大-蘆洲,2024-11-27,9857
2330,台積電,45,6,39,元大-蘆洲,2024-11-27,9857
6005,群益證,35,2,33,元大-蘆洲,2024-11-27,9857
006208,富邦台50,33,1,32,元大-蘆洲,2024-11-27,9857
2498,宏達電,66,35,31,元大-蘆洲,2024-11-27,9857
00715L,期街口布蘭特正2,30,0,30,元大-蘆洲,2024-11-27,9857
3090,日電貿,57,27,30,元大-蘆洲,2024-11-27,9857
2382,廣達,36,8,28,元大-蘆洲,2024-11-27,9857
3260,威剛,27,0,27,元大-蘆洲,2024-11-27,9857
3037,欣興,48,21,27,元大-蘆洲,2024-11-27,9857
2344,華邦電,87,61,26,元大-蘆洲,2024-11-27,9857
00881,國泰台灣5G+,27,2,25,元大-蘆洲,2024-11-27,9857
2354,鴻準,44,20,24,元大-蘆洲,2024-11-27,9857
6770,力積電,61,37,24,元大-蘆洲,2024-11-27,9857
2376,技嘉,29,5,24,元大-蘆洲,2024-11-27,9857
2603,長榮,112,89,23,元大-蘆洲,2024-11-27,9857
00922,國泰台灣領袖50,22,0,22,元大-蘆洲,2024-11-27,9857
3323,加百裕,139,117,22,元大-蘆洲,2024-11-27,9857
3711,日月光投控,21,0,21,元大-蘆洲,2024-11-27,9857
6589,台康生技,21,0,21,元大-蘆洲,2024-11-27,9857
0050,元大台灣50,22,1,21,元大-蘆洲,2024-11-27,9857
1605,華新,24,3,21,元大-蘆洲,2024-11-27,9857
00929,復華台灣科技優息,147,127,20,元大-蘆洲,2024-11-27,9857
1319,東陽,38,18,20,元大-蘆洲,2024-11-27,9857
5328,華容,22,3,19,元大-蘆洲,2024-11-27,9857
4938,和碩,19,0,19,元大-蘆洲,2024-11-27,9857
2881,富邦金,19,0,19,元大-蘆洲,2024-11-27,9857
8150,南茂,19,1,18,元大-蘆洲,2024-11-27,9857
4562,穎漢,92,74,18,元大-蘆洲,2024-11-27,9857
2353,宏��,22,4,18,元大-蘆洲,2024-11-27,9857
00878,國泰永續高股息,351,69,282,元大-蘆洲,2024-11-28,9857
2303,聯電,212,34,178,元大-蘆洲,2024-11-28,9857
2206,三陽工業,154,2,152,元大-蘆洲,2024-11-28,9857
6104,創惟,201,57,144,元大-蘆洲,2024-11-28,9857
00919,群益台灣精選高息,384,249,135,元大-蘆洲,2024-11-28,9857
00943,兆豐電子高息等權,99,3,96,元大-蘆洲,2024-11-28,9857
00929,復華台灣科技優息,154,59,95,元大-蘆洲,2024-11-28,9857
00680L,元大美債20正2,111,25,86,元大-蘆洲,2024-11-28,9857
8086,宏捷科,77,8,69,元大-蘆洲,2024-11-28,9857
00882,中信中國高股息,74,12,62,元大-蘆洲,2024-11-28,9857
00915,凱基優選高股息30,74,13,61,元大-蘆洲,2024-11-28,9857
4510,高鋒,230,171,59,元大-蘆洲,2024-11-28,9857
2498,宏達電,66,9,57,元大-蘆洲,2024-11-28,9857
3481,群創,65,10,55,元大-蘆洲,2024-11-28,9857
8171,天宇,69,15,54,元大-蘆洲,2024-11-28,9857
0056,元大高股息,146,93,53,元大-蘆洲,2024-11-28,9857
00918,大華優利高填息30,49,0,49,元大-蘆洲,2024-11-28,9857
00953B,群益優選非投等債,48,0,48,元大-蘆洲,2024-11-28,9857
4991,環宇-KY,60,14,46,元大-蘆洲,2024-11-28,9857
00905,FT臺灣Smart,36,0,36,元大-蘆洲,2024-11-28,9857
2344,華邦電,46,16,30,元大-蘆洲,2024-11-28,9857
00673R,期元大S＆P原油反1,30,2,28,元大-蘆洲,2024-11-28,9857
1434,福懋,28,0,28,元大-蘆洲,2024-11-28,9857
3597,映興,27,0,27,元大-蘆洲,2024-11-28,9857
3694,海華,26,0,26,元大-蘆洲,2024-11-28,9857
00891,中信關鍵半導體,25,0,25,元大-蘆洲,2024-11-28,9857
2419,仲琦,27,4,23,元大-蘆洲,2024-11-28,9857
3380,明泰,23,0,23,元大-蘆洲,2024-11-28,9857
2402,毅嘉,28,5,23,元大-蘆洲,2024-11-28,9857
2426,鼎元,95,73,22,元大-蘆洲,2024-11-28,9857
00946,群益科技高息成長,23,1,22,元大-蘆洲,2024-11-28,9857
1605,華新,60,39,21,元大-蘆洲,2024-11-28,9857
2883,凱基金,20,0,20,元大-蘆洲,2024-11-28,9857
00922,國泰台灣領袖50,20,0,20,元大-蘆洲,2024-11-28,9857
1522,堤維西,40,20,20,元大-蘆洲,2024-11-28,9857
00713,元大台灣高息低波,18,0,18,元大-蘆洲,2024-11-28,9857
1314,中石化,17,0,17,元大-蘆洲,2024-11-28,9857
2332,友訊,376,359,17,元大-蘆洲,2024-11-28,9857
00935,野村臺灣新科技50,17,0,17,元大-蘆洲,2024-11-28,9857
00720B,元大投資級公司債,16,1,15,元大-蘆洲,2024-11-28,9857
2486,一詮,16,1,15,元大-蘆洲,2024-11-28,9857
4562,穎漢,18,3,15,元大-蘆洲,2024-11-28,9857
6530,創威,23,8,15,元大-蘆洲,2024-11-28,9857
6156,松上,15,1,14,元大-蘆洲,2024-11-28,9857
8929,富堡,14,0,14,元大-蘆洲,2024-11-28,9857
1301,台塑,17,3,14,元大-蘆洲,2024-11-28,9857
2002,中鋼,17,3,14,元大-蘆洲,2024-11-28,9857
00850,元大臺灣ESG永續,24,10,14,元大-蘆洲,2024-11-28,9857
2881,富邦金,13,0,13,元大-蘆洲,2024-11-28,9857
2495,普安,16,3,13,元大-蘆洲,2024-11-28,9857
6770,力積電,404,1,403,元大-蘆洲,2024-11-29,9857
5426,振發,223,7,216,元大-蘆洲,2024-11-29,9857
9105,泰金寶-DR,210,97,113,元大-蘆洲,2024-11-29,9857
2002,中鋼,91,1,90,元大-蘆洲,2024-11-29,9857
00940,元大台灣價值高息,90,10,80,元大-蘆洲,2024-11-29,9857
00878,國泰永續高股息,76,12,64,元大-蘆洲,2024-11-29,9857
4303,信立,89,29,60,元大-蘆洲,2024-11-29,9857
00919,群益台灣精選高息,76,18,58,元大-蘆洲,2024-11-29,9857
2303,聯電,81,26,55,元大-蘆洲,2024-11-29,9857
2392,正崴,81,33,48,元大-蘆洲,2024-11-29,9857
00953B,群益優選非投等債,48,0,48,元大-蘆洲,2024-11-29,9857
00715L,期街口布蘭特正2,51,4,47,元大-蘆洲,2024-11-29,9857
8163,達方,74,30,44,元大-蘆洲,2024-11-29,9857
1301,台塑,45,3,42,元大-蘆洲,2024-11-29,9857
6104,創惟,56,15,41,元大-蘆洲,2024-11-29,9857
2312,金寶,160,120,40,元大-蘆洲,2024-11-29,9857
00950B,凱基A級公司債,89,50,39,元大-蘆洲,2024-11-29,9857
0056,元大高股息,36,2,34,元大-蘆洲,2024-11-29,9857
2367,燿華,36,3,33,元大-蘆洲,2024-11-29,9857
2883,凱基金,35,4,31,元大-蘆洲,2024-11-29,9857
00929,復華台灣科技優息,44,14,30,元大-蘆洲,2024-11-29,9857
2603,長榮,43,15,28,元大-蘆洲,2024-11-29,9857
2880,華南金,36,10,26,元大-蘆洲,2024-11-29,9857
2344,華邦電,40,15,25,元大-蘆洲,2024-11-29,9857
9904,寶成,25,0,25,元大-蘆洲,2024-11-29,9857
00915,凱基優選高股息30,27,3,24,元大-蘆洲,2024-11-29,9857
00922,國泰台灣領袖50,22,1,21,元大-蘆洲,2024-11-29,9857
3511,矽瑪,22,1,21,元大-蘆洲,2024-11-29,9857
00650L,復華香港正2,20,0,20,元大-蘆洲,2024-11-29,9857
1605,華新,25,5,20,元大-蘆洲,2024-11-29,9857
2317,鴻海,25,5,20,元大-蘆洲,2024-11-29,9857
6173,信昌電,19,0,19,元大-蘆洲,2024-11-29,9857
2498,宏達電,22,5,17,元大-蘆洲,2024-11-29,9857
2330,台積電,18,2,16,元大-蘆洲,2024-11-29,9857
2515,中工,16,0,16,元大-蘆洲,2024-11-29,9857
3090,日電貿,31,15,16,元大-蘆洲,2024-11-29,9857
8104,錸寶,19,5,14,元大-蘆洲,2024-11-29,9857
2382,廣達,17,4,13,元大-蘆洲,2024-11-29,9857
1611,中電,17,4,13,元大-蘆洲,2024-11-29,9857
2601,益航,13,0,13,元大-蘆洲,2024-11-29,9857
5880,合庫金,13,0,13,元大-蘆洲,2024-11-29,9857
2891,中信金,16,4,12,元大-蘆洲,2024-11-29,9857
2609,陽明,58,45,13,元大-蘆洲,2024-11-29,9857
00720B,元大投資級公司債,15,3,12,元大-蘆洲,2024-11-29,9857
9933,中鼎,12,0,12,元大-蘆洲,2024-11-29,9857
2356,英業達,14,2,12,元大-蘆洲,2024-11-29,9857
2884,玉山金,13,2,11,元大-蘆洲,2024-11-29,9857
3715,定穎投控,12,1,11,元大-蘆洲,2024-11-29,9857
2337,旺宏,11,0,11,元大-蘆洲,2024-11-29,9857
2539,櫻花建,11,0,11,元大-蘆洲,2024-11-29,9857
00953B,群益優選非投等債,112,0,112,元大-蘆洲,2024-12-02,9857
2801,彰銀,100,1,99,元大-蘆洲,2024-12-02,9857
2337,旺宏,116,20,96,元大-蘆洲,2024-12-02,9857
5439,高技,108,22,86,元大-蘆洲,2024-12-02,9857
1802,台玻,90,10,80,元大-蘆洲,2024-12-02,9857
00918,大華優利高填息30,98,19,79,元大-蘆洲,2024-12-02,9857
6274,台燿,61,14,47,元大-蘆洲,2024-12-02,9857
2317,鴻海,46,8,38,元大-蘆洲,2024-12-02,9857
1101,台泥,37,0,37,元大-蘆洲,2024-12-02,9857
4979,華星光,163,127,36,元大-蘆洲,2024-12-02,9857
1605,華新,50,15,35,元大-蘆洲,2024-12-02,9857
2609,陽明,80,49,31,元大-蘆洲,2024-12-02,9857
4123,晟德,37,7,30,元大-蘆洲,2024-12-02,9857
0056,元大高股息,43,14,29,元大-蘆洲,2024-12-02,9857
3706,神達,430,405,25,元大-蘆洲,2024-12-02,9857
1434,福懋,22,0,22,元大-蘆洲,2024-12-02,9857
2345,智邦,21,1,20,元大-蘆洲,2024-12-02,9857
00959B,大華投等美債15Y+,29,10,19,元大-蘆洲,2024-12-02,9857
2375,凱美,30,12,18,元大-蘆洲,2024-12-02,9857
2344,華邦電,20,2,18,元大-蘆洲,2024-12-02,9857
5244,弘凱,48,31,17,元大-蘆洲,2024-12-02,9857
2883B,凱基金乙特,16,0,16,元大-蘆洲,2024-12-02,9857
2408,南亞科,17,1,16,元大-蘆洲,2024-12-02,9857
1504,東元,23,8,15,元大-蘆洲,2024-12-02,9857
1301,台塑,18,3,15,元大-蘆洲,2024-12-02,9857
5309,系統電,94,80,14,元大-蘆洲,2024-12-02,9857
3090,日電貿,28,14,14,元大-蘆洲,2024-12-02,9857
2356,英業達,16,3,13,元大-蘆洲,2024-12-02,9857
2363,矽統,18,5,13,元大-蘆洲,2024-12-02,9857
8027,鈦昇,16,3,13,元大-蘆洲,2024-12-02,9857
2349,錸德,14,1,13,元大-蘆洲,2024-12-02,9857
1314,中石化,12,0,12,元大-蘆洲,2024-12-02,9857
5534,長虹,12,0,12,元大-蘆洲,2024-12-02,9857
4128,中天,12,0,12,元大-蘆洲,2024-12-02,9857
00712,復華富時不動產,25,13,12,元大-蘆洲,2024-12-02,9857
2504,國產,18,7,11,元大-蘆洲,2024-12-02,9857
8076,伍豐,25,14,11,元大-蘆洲,2024-12-02,9857
00934,中信成長高股息,11,0,11,元大-蘆洲,2024-12-02,9857
2486,一詮,10,0,10,元大-蘆洲,2024-12-02,9857
00905,FT臺灣Smart,10,0,10,元大-蘆洲,2024-12-02,9857
3264,欣銓,10,0,10,元大-蘆洲,2024-12-02,9857
6757,台灣虎航,11,1,10,元大-蘆洲,2024-12-02,9857
00932,兆豐永續高息等權,16,6,10,元大-蘆洲,2024-12-02,9857
3576,聯合再生,10,0,10,元大-蘆洲,2024-12-02,9857
8163,達方,10,0,10,元大-蘆洲,2024-12-02,9857
3013,晟銘電,31,21,10,元大-蘆洲,2024-12-02,9857
3025,星通,17,8,9,元大-蘆洲,2024-12-02,9857
00665L,富邦�琤肭磪囓�2,11,2,9,元大-蘆洲,2024-12-02,9857
2444,兆勁,9,0,9,元大-蘆洲,2024-12-02,9857
5386,青雲,10,1,9,元大-蘆洲,2024-12-02,9857
00919,群益台灣精選高息,320,70,250,元大-蘆洲,2024-12-03,9857
9105,泰金寶-DR,614,398,216,元大-蘆洲,2024-12-03,9857
2206,三陽工業,187,0,187,元大-蘆洲,2024-12-03,9857
00953B,群益優選非投等債,178,0,178,元大-蘆洲,2024-12-03,9857
2887,台新金,120,0,120,元大-蘆洲,2024-12-03,9857
6104,創惟,152,34,118,元大-蘆洲,2024-12-03,9857
3231,緯創,121,22,99,元大-蘆洲,2024-12-03,9857
4977,眾達-KY,160,81,79,元大-蘆洲,2024-12-03,9857
00637L,元大滬深300正2,190,122,68,元大-蘆洲,2024-12-03,9857
2303,聯電,85,20,65,元大-蘆洲,2024-12-03,9857
5439,高技,78,23,55,元大-蘆洲,2024-12-03,9857
00878,國泰永續高股息,85,30,55,元大-蘆洲,2024-12-03,9857
00648R,元大S＆P500反1,50,0,50,元大-蘆洲,2024-12-03,9857
00671R,富邦NASDAQ反1,40,0,40,元大-蘆洲,2024-12-03,9857
00720B,元大投資級公司債,43,6,37,元大-蘆洲,2024-12-03,9857
2382,廣達,82,48,34,元大-蘆洲,2024-12-03,9857
9908,大台北,30,0,30,元大-蘆洲,2024-12-03,9857
8028,昇陽半導體,36,12,24,元大-蘆洲,2024-12-03,9857
2317,鴻海,78,55,23,元大-蘆洲,2024-12-03,9857
00713,元大台灣高息低波,21,2,19,元大-蘆洲,2024-12-03,9857
2014,中鴻,20,1,19,元大-蘆洲,2024-12-03,9857
00918,大華優利高填息30,34,16,18,元大-蘆洲,2024-12-03,9857
8076,伍豐,18,0,18,元大-蘆洲,2024-12-03,9857
4991,環宇-KY,106,89,17,元大-蘆洲,2024-12-03,9857
5907,大洋-KY,17,0,17,元大-蘆洲,2024-12-03,9857
3049,精金,22,6,16,元大-蘆洲,2024-12-03,9857
00715L,期街口布蘭特正2,15,0,15,元大-蘆洲,2024-12-03,9857
1319,東陽,27,12,15,元大-蘆洲,2024-12-03,9857
2353,宏��,16,3,13,元大-蘆洲,2024-12-03,9857
00924,復華S＆P500成長,13,0,13,元大-蘆洲,2024-12-03,9857
6176,瑞儀,12,0,12,元大-蘆洲,2024-12-03,9857
6147,頎邦,12,0,12,元大-蘆洲,2024-12-03,9857
2498,宏達電,27,15,12,元大-蘆洲,2024-12-03,9857
3625,西勝,22,10,12,元大-蘆洲,2024-12-03,9857
4526,東台,12,0,12,元大-蘆洲,2024-12-03,9857
3027,盛達,15,3,12,元大-蘆洲,2024-12-03,9857
6269,台郡,11,0,11,元大-蘆洲,2024-12-03,9857
2375,凱美,32,21,11,元大-蘆洲,2024-12-03,9857
2504,國產,11,0,11,元大-蘆洲,2024-12-03,9857
4931,新盛力,13,2,11,元大-蘆洲,2024-12-03,9857
3005,神基,10,0,10,元大-蘆洲,2024-12-03,9857
6443,元晶,10,0,10,元大-蘆洲,2024-12-03,9857
3031,佰鴻,11,1,10,元大-蘆洲,2024-12-03,9857
3013,晟銘電,17,7,10,元大-蘆洲,2024-12-03,9857
2489,瑞軒,10,0,10,元大-蘆洲,2024-12-03,9857
2889,國票金,10,0,10,元大-蘆洲,2024-12-03,9857
5328,華容,16,6,10,元大-蘆洲,2024-12-03,9857
3324,雙鴻,21,11,10,元大-蘆洲,2024-12-03,9857
5483,中美晶,10,1,9,元大-蘆洲,2024-12-03,9857
6873,泓德能源,10,1,9,元大-蘆洲,2024-12-03,9857
00953B,群益優選非投等債,2983,0,2983,元大-蘆洲,2024-12-04,9857
00712,復華富時不動產,239,0,239,元大-蘆洲,2024-12-04,9857
6770,力積電,235,23,212,元大-蘆洲,2024-12-04,9857
5439,高技,210,34,176,元大-蘆洲,2024-12-04,9857
00959B,大華投等美債15Y+,164,0,164,元大-蘆洲,2024-12-04,9857
1536,和大,157,6,151,元大-蘆洲,2024-12-04,9857
3706,神達,632,520,112,元大-蘆洲,2024-12-04,9857
2887,台新金,111,2,109,元大-蘆洲,2024-12-04,9857
3058,立德,110,2,108,元大-蘆洲,2024-12-04,9857
2312,金寶,148,45,103,元大-蘆洲,2024-12-04,9857
2801,彰銀,101,0,101,元大-蘆洲,2024-12-04,9857
00918,大華優利高填息30,89,1,88,元大-蘆洲,2024-12-04,9857
00878,國泰永續高股息,93,11,82,元大-蘆洲,2024-12-04,9857
00950B,凱基A級公司債,72,0,72,元大-蘆洲,2024-12-04,9857
0056,元大高股息,69,2,67,元大-蘆洲,2024-12-04,9857
00673R,期元大S＆P原油反1,57,0,57,元大-蘆洲,2024-12-04,9857
6274,台燿,73,18,55,元大-蘆洲,2024-12-04,9857
6449,鈺邦,63,9,54,元大-蘆洲,2024-12-04,9857
2455,全新,58,6,52,元大-蘆洲,2024-12-04,9857
2337,旺宏,54,2,52,元大-蘆洲,2024-12-04,9857
3380,明泰,48,9,39,元大-蘆洲,2024-12-04,9857
00948B,中信優息投資級債,38,0,38,元大-蘆洲,2024-12-04,9857
6426,統新,40,2,38,元大-蘆洲,2024-12-04,9857
00933B,國泰10Y+金融債,70,36,34,元大-蘆洲,2024-12-04,9857
2367,燿華,33,0,33,元大-蘆洲,2024-12-04,9857
2206,三陽工業,30,0,30,元大-蘆洲,2024-12-04,9857
1905,華紙,30,2,28,元大-蘆洲,2024-12-04,9857
6732,昇佳電子,28,1,27,元大-蘆洲,2024-12-04,9857
2891,中信金,39,14,25,元大-蘆洲,2024-12-04,9857
00679B,元大美債20年,30,5,25,元大-蘆洲,2024-12-04,9857
00915,凱基優選高股息30,24,0,24,元大-蘆洲,2024-12-04,9857
2303,聯電,44,21,23,元大-蘆洲,2024-12-04,9857
2405,輔信,24,2,22,元大-蘆洲,2024-12-04,9857
6541,泰福-KY,21,0,21,元大-蘆洲,2024-12-04,9857
00650L,復華香港正2,20,0,20,元大-蘆洲,2024-12-04,9857
6127,九豪,25,9,16,元大-蘆洲,2024-12-04,9857
2329,華泰,25,10,15,元大-蘆洲,2024-12-04,9857
2002,中鋼,16,1,15,元大-蘆洲,2024-12-04,9857
5371,中光電,28,13,15,元大-蘆洲,2024-12-04,9857
9933,中鼎,15,1,14,元大-蘆洲,2024-12-04,9857
3665,貿聯-KY,27,13,14,元大-蘆洲,2024-12-04,9857
6134,萬旭,52,38,14,元大-蘆洲,2024-12-04,9857
2392,正崴,18,5,13,元大-蘆洲,2024-12-04,9857
00713,元大台灣高息低波,13,0,13,元大-蘆洲,2024-12-04,9857
6431,光麗-KY,20,7,13,元大-蘆洲,2024-12-04,9857
6901,鑽石投資,22,9,13,元大-蘆洲,2024-12-04,9857
5309,系統電,130,117,13,元大-蘆洲,2024-12-04,9857
2062,橋椿,22,10,12,元大-蘆洲,2024-12-04,9857
6757,台灣虎航,24,12,12,元大-蘆洲,2024-12-04,9857
6603,富強鑫,12,0,12,元大-蘆洲,2024-12-04,9857
2354,鴻準,637,291,346,元大-蘆洲,2024-12-05,9857
00712,復華富時不動產,137,4,133,元大-蘆洲,2024-12-05,9857
2312,金寶,186,72,114,元大-蘆洲,2024-12-05,9857
2337,旺宏,87,3,84,元大-蘆洲,2024-12-05,9857
00950B,凱基A級公司債,115,32,83,元大-蘆洲,2024-12-05,9857
00715L,期街口布蘭特正2,81,2,79,元大-蘆洲,2024-12-05,9857
00918,大華優利高填息30,90,25,65,元大-蘆洲,2024-12-05,9857
6962,ITH-KY,59,3,56,元大-蘆洲,2024-12-05,9857
5439,高技,55,3,52,元大-蘆洲,2024-12-05,9857
3481,群創,62,17,45,元大-蘆洲,2024-12-05,9857
2002,中鋼,45,3,42,元大-蘆洲,2024-12-05,9857
2332,友訊,44,3,41,元大-蘆洲,2024-12-05,9857
1434,福懋,38,0,38,元大-蘆洲,2024-12-05,9857
0056,元大高股息,45,7,38,元大-蘆洲,2024-12-05,9857
1605,華新,38,0,38,元大-蘆洲,2024-12-05,9857
3712,永崴投控,53,16,37,元大-蘆洲,2024-12-05,9857
00953B,群益優選非投等債,34,0,34,元大-蘆洲,2024-12-05,9857
3323,加百裕,159,129,30,元大-蘆洲,2024-12-05,9857
2392,正崴,73,43,30,元大-蘆洲,2024-12-05,9857
8076,伍豐,28,0,28,元大-蘆洲,2024-12-05,9857
2317,鴻海,42,14,28,元大-蘆洲,2024-12-05,9857
3058,立德,26,0,26,元大-蘆洲,2024-12-05,9857
1802,台玻,36,11,25,元大-蘆洲,2024-12-05,9857
8044,網家,30,6,24,元大-蘆洲,2024-12-05,9857
2375,凱美,76,53,23,元大-蘆洲,2024-12-05,9857
3163,波若威,78,57,21,元大-蘆洲,2024-12-05,9857
3706,神達,162,141,21,元大-蘆洲,2024-12-05,9857
5328,華容,143,122,21,元大-蘆洲,2024-12-05,9857
2303,聯電,83,62,21,元大-蘆洲,2024-12-05,9857
6187,萬潤,26,6,20,元大-蘆洲,2024-12-05,9857
8011,台通,24,5,19,元大-蘆洲,2024-12-05,9857
2344,華邦電,33,15,18,元大-蘆洲,2024-12-05,9857
2542,興富發,19,1,18,元大-蘆洲,2024-12-05,9857
2204,中華,26,10,16,元大-蘆洲,2024-12-05,9857
8163,達方,16,0,16,元大-蘆洲,2024-12-05,9857
1471,首利,29,13,16,元大-蘆洲,2024-12-05,9857
8043,蜜望實,16,0,16,元大-蘆洲,2024-12-05,9857
2014,中鴻,15,0,15,元大-蘆洲,2024-12-05,9857
4127,天良,15,0,15,元大-蘆洲,2024-12-05,9857
2349,錸德,26,11,15,元大-蘆洲,2024-12-05,9857
6134,萬旭,19,4,15,元大-蘆洲,2024-12-05,9857
2472,立隆電,45,30,15,元大-蘆洲,2024-12-05,9857
1905,華紙,20,5,15,元大-蘆洲,2024-12-05,9857
1815,富喬,304,289,15,元大-蘆洲,2024-12-05,9857
3450,聯鈞,42,28,14,元大-蘆洲,2024-12-05,9857
6558,興能高,226,212,14,元大-蘆洲,2024-12-05,9857
00915,凱基優選高股息30,37,24,13,元大-蘆洲,2024-12-05,9857
4977,眾達-KY,65,52,13,元大-蘆洲,2024-12-05,9857
8942,森鉅,13,0,13,元大-蘆洲,2024-12-05,9857
2367,燿華,65,52,13,元大-蘆洲,2024-12-05,9857
00953B,群益優選非投等債,1421,0,1421,元大-蘆洲,2024-12-06,9857
2887,台新金,215,7,208,元大-蘆洲,2024-12-06,9857
2337,旺宏,118,27,91,元大-蘆洲,2024-12-06,9857
00919,群益台灣精選高息,142,55,87,元大-蘆洲,2024-12-06,9857
00915,凱基優選高股息30,69,0,69,元大-蘆洲,2024-12-06,9857
4919,新唐,102,46,56,元大-蘆洲,2024-12-06,9857
3593,力銘,52,0,52,元大-蘆洲,2024-12-06,9857
2206,三陽工業,50,0,50,元大-蘆洲,2024-12-06,9857
00637L,元大滬深300正2,380,330,50,元大-蘆洲,2024-12-06,9857
00965,元大航太防衛科技,47,0,47,元大-蘆洲,2024-12-06,9857
3037,欣興,54,7,47,元大-蘆洲,2024-12-06,9857
00918,大華優利高填息30,49,4,45,元大-蘆洲,2024-12-06,9857
00715L,期街口布蘭特正2,38,0,38,元大-蘆洲,2024-12-06,9857
1540,喬福,36,0,36,元大-蘆洲,2024-12-06,9857
00905,FT臺灣Smart,31,0,31,元大-蘆洲,2024-12-06,9857
4952,凌通,35,5,30,元大-蘆洲,2024-12-06,9857
2317,鴻海,39,11,28,元大-蘆洲,2024-12-06,9857
3591,艾笛森,37,11,26,元大-蘆洲,2024-12-06,9857
2204,中華,25,0,25,元大-蘆洲,2024-12-06,9857
00930,永豐ESG低碳高息,25,0,25,元大-蘆洲,2024-12-06,9857
2486,一詮,25,1,24,元大-蘆洲,2024-12-06,9857
2427,三商電,78,54,24,元大-蘆洲,2024-12-06,9857
2388,威盛,29,6,23,元大-蘆洲,2024-12-06,9857
4729,熒茂,23,1,22,元大-蘆洲,2024-12-06,9857
00946,群益科技高息成長,22,0,22,元大-蘆洲,2024-12-06,9857
6426,統新,200,178,22,元大-蘆洲,2024-12-06,9857
3062,建漢,23,2,21,元大-蘆洲,2024-12-06,9857
3032,偉訓,41,21,20,元大-蘆洲,2024-12-06,9857
1605,華新,48,30,18,元大-蘆洲,2024-12-06,9857
2312,金寶,82,65,17,元大-蘆洲,2024-12-06,9857
2493,揚博,16,0,16,元大-蘆洲,2024-12-06,9857
2405,輔信,76,60,16,元大-蘆洲,2024-12-06,9857
00900,富邦特選高股息30,15,0,15,元大-蘆洲,2024-12-06,9857
4931,新盛力,69,55,14,元大-蘆洲,2024-12-06,9857
6214,精誠,31,17,14,元大-蘆洲,2024-12-06,9857
4743,合一,23,9,14,元大-蘆洲,2024-12-06,9857
1471,首利,13,0,13,元大-蘆洲,2024-12-06,9857
6763,綠界科技*,19,6,13,元大-蘆洲,2024-12-06,9857
00932,兆豐永續高息等權,13,0,13,元大-蘆洲,2024-12-06,9857
2457,飛宏,23,10,13,元大-蘆洲,2024-12-06,9857
1802,台玻,42,30,12,元大-蘆洲,2024-12-06,9857
2371,大同,12,0,12,元大-蘆洲,2024-12-06,9857
2442,新美齊,12,0,12,元大-蘆洲,2024-12-06,9857
5328,華容,13,1,12,元大-蘆洲,2024-12-06,9857
3003,健和興,23,12,11,元大-蘆洲,2024-12-06,9857
00881,國泰台灣5G+,20,9,11,元大-蘆洲,2024-12-06,9857
00878,國泰永續高股息,20,9,11,元大-蘆洲,2024-12-06,9857
2241,艾姆勒,11,0,11,元大-蘆洲,2024-12-06,9857
00646,元大S＆P500,11,0,11,元大-蘆洲,2024-12-06,9857
2455,全新,13,2,11,元大-蘆洲,2024-12-06,9857
2801,彰銀,310,15,295,元大-蘆洲,2024-12-09,9857
00965,元大航太防衛科技,139,10,129,元大-蘆洲,2024-12-09,9857
00929,復華台灣科技優息,173,49,124,元大-蘆洲,2024-12-09,9857
2206,三陽工業,82,0,82,元大-蘆洲,2024-12-09,9857
2349,錸德,74,3,71,元大-蘆洲,2024-12-09,9857
00715L,期街口布蘭特正2,70,0,70,元大-蘆洲,2024-12-09,9857
3037,欣興,79,21,58,元大-蘆洲,2024-12-09,9857
00637L,元大滬深300正2,180,124,56,元大-蘆洲,2024-12-09,9857
2317,鴻海,58,3,55,元大-蘆洲,2024-12-09,9857
2887,台新金,56,3,53,元大-蘆洲,2024-12-09,9857
9105,泰金寶-DR,55,2,53,元大-蘆洲,2024-12-09,9857
3706,神達,204,154,50,元大-蘆洲,2024-12-09,9857
00650L,復華香港正2,50,0,50,元大-蘆洲,2024-12-09,9857
2002,中鋼,48,1,47,元大-蘆洲,2024-12-09,9857
6757,台灣虎航,40,0,40,元大-蘆洲,2024-12-09,9857
1301,台塑,55,17,38,元大-蘆洲,2024-12-09,9857
2313,華通,61,23,38,元大-蘆洲,2024-12-09,9857
2354,鴻準,129,91,38,元大-蘆洲,2024-12-09,9857
2615,萬海,95,58,37,元大-蘆洲,2024-12-09,9857
00918,大華優利高填息30,68,32,36,元大-蘆洲,2024-12-09,9857
0056,元大高股息,36,0,36,元大-蘆洲,2024-12-09,9857
2399,映泰,238,206,32,元大-蘆洲,2024-12-09,9857
00881,國泰台灣5G+,29,2,27,元大-蘆洲,2024-12-09,9857
4931,新盛力,34,10,24,元大-蘆洲,2024-12-09,9857
2489,瑞軒,24,0,24,元大-蘆洲,2024-12-09,9857
1802,台玻,23,0,23,元大-蘆洲,2024-12-09,9857
1522,堤維西,22,1,21,元大-蘆洲,2024-12-09,9857
2337,旺宏,24,3,21,元大-蘆洲,2024-12-09,9857
00885,富邦越南,21,0,21,元大-蘆洲,2024-12-09,9857
3032,偉訓,48,27,21,元大-蘆洲,2024-12-09,9857
3062,建漢,21,1,20,元大-蘆洲,2024-12-09,9857
00670L,富邦NASDAQ正2,21,1,20,元大-蘆洲,2024-12-09,9857
3593,力銘,20,0,20,元大-蘆洲,2024-12-09,9857
3024,憶聲,25,6,19,元大-蘆洲,2024-12-09,9857
3712,永崴投控,35,16,19,元大-蘆洲,2024-12-09,9857
3481,群創,38,19,19,元大-蘆洲,2024-12-09,9857
3211,順達,128,110,18,元大-蘆洲,2024-12-09,9857
00662,富邦NASDAQ,18,0,18,元大-蘆洲,2024-12-09,9857
2449,京元電子,30,13,17,元大-蘆洲,2024-12-09,9857
1605,華新,26,9,17,元大-蘆洲,2024-12-09,9857
2436,偉詮電,50,33,17,元大-蘆洲,2024-12-09,9857
00953B,群益優選非投等債,15,0,15,元大-蘆洲,2024-12-09,9857
3380,明泰,15,0,15,元大-蘆洲,2024-12-09,9857
3088,艾訊,19,4,15,元大-蘆洲,2024-12-09,9857
00887,永豐中國科技50大,15,0,15,元大-蘆洲,2024-12-09,9857
6214,精誠,23,8,15,元大-蘆洲,2024-12-09,9857
6443,元晶,44,30,14,元大-蘆洲,2024-12-09,9857
4979,華星光,20,7,13,元大-蘆洲,2024-12-09,9857
2915,潤泰全,13,0,13,元大-蘆洲,2024-12-09,9857
00915,凱基優選高股息30,19,7,12,元大-蘆洲,2024-12-09,9857
00882,中信中國高股息,157,21,136,元大-蘆洲,2024-12-10,9857
2344,華邦電,131,1,130,元大-蘆洲,2024-12-10,9857
00918,大華優利高填息30,125,1,124,元大-蘆洲,2024-12-10,9857
2317,鴻海,146,35,111,元大-蘆洲,2024-12-10,9857
2303,聯電,99,9,90,元大-蘆洲,2024-12-10,9857
00665L,富邦�琤肭磪囓�2,93,15,78,元大-蘆洲,2024-12-10,9857
1449,佳和,216,141,75,元大-蘆洲,2024-12-10,9857
2609,陽明,185,113,72,元大-蘆洲,2024-12-10,9857
00687B,國泰20年美債,97,30,67,元大-蘆洲,2024-12-10,9857
00968B,元大優息投等債,83,20,63,元大-蘆洲,2024-12-10,9857
2603,長榮,68,9,59,元大-蘆洲,2024-12-10,9857
3706,神達,441,383,58,元大-蘆洲,2024-12-10,9857
3037,欣興,57,5,52,元大-蘆洲,2024-12-10,9857
00940,元大台灣價值高息,57,11,46,元大-蘆洲,2024-12-10,9857
00965,元大航太防衛科技,50,7,43,元大-蘆洲,2024-12-10,9857
2367,燿華,41,1,40,元大-蘆洲,2024-12-10,9857
1733,五鼎,33,0,33,元大-蘆洲,2024-12-10,9857
0056,元大高股息,48,16,32,元大-蘆洲,2024-12-10,9857
00919,群益台灣精選高息,62,31,31,元大-蘆洲,2024-12-10,9857
6829,千附精密,30,0,30,元大-蘆洲,2024-12-10,9857
1611,中電,30,5,25,元大-蘆洲,2024-12-10,9857
2363,矽統,102,82,20,元大-蘆洲,2024-12-10,9857
1216,統一,20,0,20,元大-蘆洲,2024-12-10,9857
00719B,元大美債1-3,20,0,20,元大-蘆洲,2024-12-10,9857
00688L,國泰20年美債正2,20,0,20,元大-蘆洲,2024-12-10,9857
1815,富喬,73,53,20,元大-蘆洲,2024-12-10,9857
2206,三陽工業,20,1,19,元大-蘆洲,2024-12-10,9857
1446,宏和,19,0,19,元大-蘆洲,2024-12-10,9857
00679B,元大美債20年,37,18,19,元大-蘆洲,2024-12-10,9857
2449,京元電子,27,8,19,元大-蘆洲,2024-12-10,9857
00936,台新永續高息中小,18,1,17,元大-蘆洲,2024-12-10,9857
2324,仁寶,25,8,17,元大-蘆洲,2024-12-10,9857
2382,廣達,25,8,17,元大-蘆洲,2024-12-10,9857
6962,ITH-KY,17,1,16,元大-蘆洲,2024-12-10,9857
2615,萬海,36,20,16,元大-蘆洲,2024-12-10,9857
006208,富邦台50,16,1,15,元大-蘆洲,2024-12-10,9857
2915,潤泰全,15,0,15,元大-蘆洲,2024-12-10,9857
1711,永光,18,3,15,元大-蘆洲,2024-12-10,9857
00945B,凱基美國非投等債,15,0,15,元大-蘆洲,2024-12-10,9857
00713,元大台灣高息低波,22,7,15,元大-蘆洲,2024-12-10,9857
00909,國泰數位支付服務,15,0,15,元大-蘆洲,2024-12-10,9857
6684,安格,27,13,14,元大-蘆洲,2024-12-10,9857
9105,泰金寶-DR,17,3,14,元大-蘆洲,2024-12-10,9857
00946,群益科技高息成長,15,2,13,元大-蘆洲,2024-12-10,9857
4991,環宇-KY,28,15,13,元大-蘆洲,2024-12-10,9857
3714,富采,13,0,13,元大-蘆洲,2024-12-10,9857
1802,台玻,37,25,12,元大-蘆洲,2024-12-10,9857
8068,全達,11,0,11,元大-蘆洲,2024-12-10,9857
2834,臺企銀,10,0,10,元大-蘆洲,2024-12-10,9857
00924,復華S＆P500成長,10,0,10,元大-蘆洲,2024-12-10,9857
3189,景碩,407,65,342,元大-蘆洲,2024-12-11,9857
00918,大華優利高填息30,240,0,240,元大-蘆洲,2024-12-11,9857
6770,力積電,329,104,225,元大-蘆洲,2024-12-11,9857
2313,華通,365,220,145,元大-蘆洲,2024-12-11,9857
2344,華邦電,166,40,126,元大-蘆洲,2024-12-11,9857
0056,元大高股息,81,0,81,元大-蘆洲,2024-12-11,9857
00919,群益台灣精選高息,120,49,71,元大-蘆洲,2024-12-11,9857
00940,元大台灣價值高息,70,2,68,元大-蘆洲,2024-12-11,9857
2317,鴻海,100,39,61,元大-蘆洲,2024-12-11,9857
1101,台泥,63,4,59,元大-蘆洲,2024-12-11,9857
00753L,中信中國50正2,60,1,59,元大-蘆洲,2024-12-11,9857
2618,長榮航,114,55,59,元大-蘆洲,2024-12-11,9857
00915,凱基優選高股息30,58,2,56,元大-蘆洲,2024-12-11,9857
3576,聯合再生,52,0,52,元大-蘆洲,2024-12-11,9857
2915,潤泰全,45,0,45,元大-蘆洲,2024-12-11,9857
2303,聯電,56,14,42,元大-蘆洲,2024-12-11,9857
00937B,群益ESG投等債20,48,8,40,元大-蘆洲,2024-12-11,9857
00878,國泰永續高股息,51,14,37,元大-蘆洲,2024-12-11,9857
2609,陽明,78,42,36,元大-蘆洲,2024-12-11,9857
00680L,元大美債20正2,35,0,35,元大-蘆洲,2024-12-11,9857
00950B,凱基A級公司債,34,0,34,元大-蘆洲,2024-12-11,9857
2312,金寶,45,12,33,元大-蘆洲,2024-12-11,9857
2515,中工,38,6,32,元大-蘆洲,2024-12-11,9857
2002,中鋼,32,0,32,元大-蘆洲,2024-12-11,9857
00673R,期元大S＆P原油反1,30,0,30,元大-蘆洲,2024-12-11,9857
6695,芯鼎,51,22,29,元大-蘆洲,2024-12-11,9857
9904,寶成,32,3,29,元大-蘆洲,2024-12-11,9857
3231,緯創,50,22,28,元大-蘆洲,2024-12-11,9857
2610,華航,57,30,27,元大-蘆洲,2024-12-11,9857
2363,矽統,44,17,27,元大-蘆洲,2024-12-11,9857
3037,欣興,29,3,26,元大-蘆洲,2024-12-11,9857
00922,國泰台灣領袖50,29,3,26,元大-蘆洲,2024-12-11,9857
1785,光洋科,32,7,25,元大-蘆洲,2024-12-11,9857
00713,元大台灣高息低波,24,0,24,元大-蘆洲,2024-12-11,9857
00881,國泰台灣5G+,22,0,22,元大-蘆洲,2024-12-11,9857
3704,合勤控,25,3,22,元大-蘆洲,2024-12-11,9857
3265,台星科,21,0,21,元大-蘆洲,2024-12-11,9857
1609,大亞,21,0,21,元大-蘆洲,2024-12-11,9857
2382,廣達,31,10,21,元大-蘆洲,2024-12-11,9857
2408,南亞科,25,5,20,元大-蘆洲,2024-12-11,9857
2887,台新金,20,0,20,元大-蘆洲,2024-12-11,9857
2206,三陽工業,20,0,20,元大-蘆洲,2024-12-11,9857
2014,中鴻,20,0,20,元大-蘆洲,2024-12-11,9857
5469,瀚宇博,20,0,20,元大-蘆洲,2024-12-11,9857
3715,定穎投控,28,10,18,元大-蘆洲,2024-12-11,9857
1733,五鼎,18,0,18,元大-蘆洲,2024-12-11,9857
00688L,國泰20年美債正2,18,0,18,元大-蘆洲,2024-12-11,9857
3234,光環,19,1,18,元大-蘆洲,2024-12-11,9857
2486,一詮,28,10,18,元大-蘆洲,2024-12-11,9857
8054,安國,171,154,17,元大-蘆洲,2024-12-11,9857
00680L,元大美債20正2,285,0,285,元大-蘆洲,2024-12-12,9857
00918,大華優利高填息30,147,11,136,元大-蘆洲,2024-12-12,9857
00919,群益台灣精選高息,109,16,93,元大-蘆洲,2024-12-12,9857
3037,欣興,167,96,71,元大-蘆洲,2024-12-12,9857
00950B,凱基A級公司債,69,0,69,元大-蘆洲,2024-12-12,9857
2303,聯電,107,42,65,元大-蘆洲,2024-12-12,9857
2328,廣宇,149,91,58,元大-蘆洲,2024-12-12,9857
00915,凱基優選高股息30,46,3,43,元大-蘆洲,2024-12-12,9857
4540,全球傳動,60,18,42,元大-蘆洲,2024-12-12,9857
00688L,國泰20年美債正2,41,0,41,元大-蘆洲,2024-12-12,9857
00687B,國泰20年美債,46,5,41,元大-蘆洲,2024-12-12,9857
2312,金寶,123,82,41,元大-蘆洲,2024-12-12,9857
2337,旺宏,38,2,36,元大-蘆洲,2024-12-12,9857
00679B,元大美債20年,36,1,35,元大-蘆洲,2024-12-12,9857
2520,冠德,33,2,31,元大-蘆洲,2024-12-12,9857
4979,華星光,58,28,30,元大-蘆洲,2024-12-12,9857
00720B,元大投資級公司債,30,0,30,元大-蘆洲,2024-12-12,9857
00713,元大台灣高息低波,31,2,29,元大-蘆洲,2024-12-12,9857
00673R,期元大S＆P原油反1,29,0,29,元大-蘆洲,2024-12-12,9857
00948B,中信優息投資級債,29,0,29,元大-蘆洲,2024-12-12,9857
2354,鴻準,93,65,28,元大-蘆洲,2024-12-12,9857
4526,東台,37,11,26,元大-蘆洲,2024-12-12,9857
3221,台嘉碩,24,0,24,元大-蘆洲,2024-12-12,9857
2313,華通,181,160,21,元大-蘆洲,2024-12-12,9857
3013,晟銘電,41,20,21,元大-蘆洲,2024-12-12,9857
6163,華電網,24,3,21,元大-蘆洲,2024-12-12,9857
1301,台塑,31,10,21,元大-蘆洲,2024-12-12,9857
00933B,國泰10Y+金融債,20,0,20,元大-蘆洲,2024-12-12,9857
2618,長榮航,36,16,20,元大-蘆洲,2024-12-12,9857
00751B,元大AAA至A公司債,20,0,20,元大-蘆洲,2024-12-12,9857
00637L,元大滬深300正2,150,131,19,元大-蘆洲,2024-12-12,9857
1733,五鼎,18,0,18,元大-蘆洲,2024-12-12,9857
6288,聯嘉,18,0,18,元大-蘆洲,2024-12-12,9857
00945B,凱基美國非投等債,17,0,17,元大-蘆洲,2024-12-12,9857
2834,臺企銀,22,6,16,元大-蘆洲,2024-12-12,9857
2002,中鋼,26,12,14,元大-蘆洲,2024-12-12,9857
3041,揚智,131,117,14,元大-蘆洲,2024-12-12,9857
6757,台灣虎航,15,1,14,元大-蘆洲,2024-12-12,9857
2382,廣達,20,6,14,元大-蘆洲,2024-12-12,9857
3051,力特,16,3,13,元大-蘆洲,2024-12-12,9857
3211,順達,22,10,12,元大-蘆洲,2024-12-12,9857
00967B,元大優息美債,12,0,12,元大-蘆洲,2024-12-12,9857
3032,偉訓,33,21,12,元大-蘆洲,2024-12-12,9857
2324,仁寶,16,4,12,元大-蘆洲,2024-12-12,9857
2317,鴻海,55,43,12,元大-蘆洲,2024-12-12,9857
2374,佳能,48,36,12,元大-蘆洲,2024-12-12,9857
2887,台新金,141,129,12,元大-蘆洲,2024-12-12,9857
1504,東元,13,2,11,元大-蘆洲,2024-12-12,9857
3702,大聯大,14,3,11,元大-蘆洲,2024-12-12,9857
8028,昇陽半導體,23,12,11,元大-蘆洲,2024-12-12,9857
00919,群益台灣精選高息,268,10,258,元大-蘆洲,2024-12-13,9857
00918,大華優利高填息30,209,16,193,元大-蘆洲,2024-12-13,9857
2206,三陽工業,185,0,185,元大-蘆洲,2024-12-13,9857
00753L,中信中國50正2,164,11,153,元大-蘆洲,2024-12-13,9857
2303,聯電,187,63,124,元大-蘆洲,2024-12-13,9857
00915,凱基優選高股息30,134,12,122,元大-蘆洲,2024-12-13,9857
00680L,元大美債20正2,118,0,118,元大-蘆洲,2024-12-13,9857
00637L,元大滬深300正2,113,0,113,元大-蘆洲,2024-12-13,9857
0056,元大高股息,112,10,102,元大-蘆洲,2024-12-13,9857
00878,國泰永續高股息,140,41,99,元大-蘆洲,2024-12-13,9857
3481,群創,114,20,94,元大-蘆洲,2024-12-13,9857
4906,正文,89,1,88,元大-蘆洲,2024-12-13,9857
2887,台新金,71,0,71,元大-蘆洲,2024-12-13,9857
3694,海華,72,4,68,元大-蘆洲,2024-12-13,9857
3221,台嘉碩,63,0,63,元大-蘆洲,2024-12-13,9857
2317,鴻海,77,15,62,元大-蘆洲,2024-12-13,9857
00959B,大華投等美債15Y+,54,0,54,元大-蘆洲,2024-12-13,9857
00679B,元大美債20年,73,19,54,元大-蘆洲,2024-12-13,9857
3037,欣興,79,27,52,元大-蘆洲,2024-12-13,9857
00688L,國泰20年美債正2,50,0,50,元大-蘆洲,2024-12-13,9857
3576,聯合再生,70,20,50,元大-蘆洲,2024-12-13,9857
00950B,凱基A級公司債,47,0,47,元大-蘆洲,2024-12-13,9857
3058,立德,45,0,45,元大-蘆洲,2024-12-13,9857
00887,永豐中國科技50大,44,0,44,元大-蘆洲,2024-12-13,9857
00713,元大台灣高息低波,52,11,41,元大-蘆洲,2024-12-13,9857
2367,燿華,49,8,41,元大-蘆洲,2024-12-13,9857
2354,鴻準,86,45,41,元大-蘆洲,2024-12-13,9857
4931,新盛力,81,43,38,元大-蘆洲,2024-12-13,9857
1540,喬福,37,0,37,元大-蘆洲,2024-12-13,9857
00665L,富邦�琤肭磪囓�2,36,0,36,元大-蘆洲,2024-12-13,9857
00953B,群益優選非投等債,36,0,36,元大-蘆洲,2024-12-13,9857
00937B,群益ESG投等債20,42,7,35,元大-蘆洲,2024-12-13,9857
00650L,復華香港正2,35,0,35,元大-蘆洲,2024-12-13,9857
00720B,元大投資級公司債,34,0,34,元大-蘆洲,2024-12-13,9857
3231,緯創,49,15,34,元大-蘆洲,2024-12-13,9857
2002,中鋼,34,2,32,元大-蘆洲,2024-12-13,9857
00946,群益科技高息成長,31,2,29,元大-蘆洲,2024-12-13,9857
1733,五鼎,27,0,27,元大-蘆洲,2024-12-13,9857
00673R,期元大S＆P原油反1,26,0,26,元大-蘆洲,2024-12-13,9857
2348,海悅,27,3,24,元大-蘆洲,2024-12-13,9857
00965,元大航太防衛科技,25,1,24,元大-蘆洲,2024-12-13,9857
5278,尚凡*,24,0,24,元大-蘆洲,2024-12-13,9857
3706,神達,205,183,22,元大-蘆洲,2024-12-13,9857
2542,興富發,22,1,21,元大-蘆洲,2024-12-13,9857
6126,信音,21,0,21,元大-蘆洲,2024-12-13,9857
00948B,中信優息投資級債,22,1,21,元大-蘆洲,2024-12-13,9857
1402,遠東新,22,2,20,元大-蘆洲,2024-12-13,9857
00706L,期元大S＆P日圓正2,20,0,20,元大-蘆洲,2024-12-13,9857
2353,宏��,31,12,19,元大-蘆洲,2024-12-13,9857
1464,得力,17,0,17,元大-蘆洲,2024-12-13,9857
00918,大華優利高填息30,290,126,164,元大-蘆洲,2024-12-16,9857
00919,群益台灣精選高息,218,59,159,元大-蘆洲,2024-12-16,9857
00673R,期元大S＆P原油反1,107,0,107,元大-蘆洲,2024-12-16,9857
00637L,元大滬深300正2,107,4,103,元大-蘆洲,2024-12-16,9857
2206,三陽工業,101,0,101,元大-蘆洲,2024-12-16,9857
2002,中鋼,121,22,99,元大-蘆洲,2024-12-16,9857
0056,元大高股息,102,9,93,元大-蘆洲,2024-12-16,9857
2486,一詮,83,7,76,元大-蘆洲,2024-12-16,9857
1464,得力,65,0,65,元大-蘆洲,2024-12-16,9857
00915,凱基優選高股息30,67,7,60,元大-蘆洲,2024-12-16,9857
00937B,群益ESG投等債20,85,28,57,元大-蘆洲,2024-12-16,9857
3231,緯創,70,14,56,元大-蘆洲,2024-12-16,9857
00948B,中信優息投資級債,64,9,55,元大-蘆洲,2024-12-16,9857
3481,群創,76,22,54,元大-蘆洲,2024-12-16,9857
00687B,國泰20年美債,56,3,53,元大-蘆洲,2024-12-16,9857
00679B,元大美債20年,89,41,48,元大-蘆洲,2024-12-16,9857
2317,鴻海,84,41,43,元大-蘆洲,2024-12-16,9857
2455,全新,49,6,43,元大-蘆洲,2024-12-16,9857
3694,海華,43,0,43,元大-蘆洲,2024-12-16,9857
2609,陽明,109,72,37,元大-蘆洲,2024-12-16,9857
911868,同方友友-DR,35,0,35,元大-蘆洲,2024-12-16,9857
2303,聯電,68,36,32,元大-蘆洲,2024-12-16,9857
00688L,國泰20年美債正2,32,0,32,元大-蘆洲,2024-12-16,9857
3221,台嘉碩,32,0,32,元大-蘆洲,2024-12-16,9857
00878,國泰永續高股息,77,46,31,元大-蘆洲,2024-12-16,9857
00933B,國泰10Y+金融債,31,0,31,元大-蘆洲,2024-12-16,9857
00946,群益科技高息成長,30,0,30,元大-蘆洲,2024-12-16,9857
1733,五鼎,30,0,30,元大-蘆洲,2024-12-16,9857
3450,聯鈞,50,22,28,元大-蘆洲,2024-12-16,9857
3062,建漢,31,3,28,元大-蘆洲,2024-12-16,9857
2332,友訊,28,1,27,元大-蘆洲,2024-12-16,9857
2344,華邦電,56,30,26,元大-蘆洲,2024-12-16,9857
2618,長榮航,40,14,26,元大-蘆洲,2024-12-16,9857
3189,景碩,39,14,25,元大-蘆洲,2024-12-16,9857
1301,台塑,43,18,25,元大-蘆洲,2024-12-16,9857
2427,三商電,25,0,25,元大-蘆洲,2024-12-16,9857
00680L,元大美債20正2,25,0,25,元大-蘆洲,2024-12-16,9857
00959B,大華投等美債15Y+,24,0,24,元大-蘆洲,2024-12-16,9857
1802,台玻,27,3,24,元大-蘆洲,2024-12-16,9857
00969B,元大零息超長美債,23,0,23,元大-蘆洲,2024-12-16,9857
2382,廣達,38,16,22,元大-蘆洲,2024-12-16,9857
4938,和碩,21,0,21,元大-蘆洲,2024-12-16,9857
9925,新保,20,0,20,元大-蘆洲,2024-12-16,9857
5608,四維航,20,0,20,元大-蘆洲,2024-12-16,9857
3380,明泰,19,0,19,元大-蘆洲,2024-12-16,9857
6213,聯茂,23,5,18,元大-蘆洲,2024-12-16,9857
6541,泰福-KY,17,0,17,元大-蘆洲,2024-12-16,9857
00887,永豐中國科技50大,17,0,17,元大-蘆洲,2024-12-16,9857
00720B,元大投資級公司債,16,0,16,元大-蘆洲,2024-12-16,9857
2468,華經,24,8,16,元大-蘆洲,2024-12-16,9857
00687B,國泰20年美債,175,7,168,元大-蘆洲,2024-12-17,9857
00937B,群益ESG投等債20,185,45,140,元大-蘆洲,2024-12-17,9857
00680L,元大美債20正2,106,0,106,元大-蘆洲,2024-12-17,9857
00915,凱基優選高股息30,103,12,91,元大-蘆洲,2024-12-17,9857
00713,元大台灣高息低波,85,0,85,元大-蘆洲,2024-12-17,9857
00959B,大華投等美債15Y+,71,0,71,元大-蘆洲,2024-12-17,9857
2303,聯電,149,83,66,元大-蘆洲,2024-12-17,9857
0056,元大高股息,65,8,57,元大-蘆洲,2024-12-17,9857
00918,大華優利高填息30,70,15,55,元大-蘆洲,2024-12-17,9857
00753L,中信中國50正2,60,5,55,元大-蘆洲,2024-12-17,9857
2915,潤泰全,52,0,52,元大-蘆洲,2024-12-17,9857
00950B,凱基A級公司債,50,0,50,元大-蘆洲,2024-12-17,9857
2374,佳能,323,277,46,元大-蘆洲,2024-12-17,9857
00922,國泰台灣領袖50,40,1,39,元大-蘆洲,2024-12-17,9857
2834,臺企銀,35,0,35,元大-蘆洲,2024-12-17,9857
6215,和椿,63,30,33,元大-蘆洲,2024-12-17,9857
00878,國泰永續高股息,49,17,32,元大-蘆洲,2024-12-17,9857
00945B,凱基美國非投等債,30,0,30,元大-蘆洲,2024-12-17,9857
3231,緯創,57,27,30,元大-蘆洲,2024-12-17,9857
6223,旺矽,35,7,28,元大-蘆洲,2024-12-17,9857
2323,中環,31,3,28,元大-蘆洲,2024-12-17,9857
2402,毅嘉,28,1,27,元大-蘆洲,2024-12-17,9857
5880,合庫金,29,2,27,元大-蘆洲,2024-12-17,9857
00688L,國泰20年美債正2,26,0,26,元大-蘆洲,2024-12-17,9857
3545,敦泰,32,9,23,元大-蘆洲,2024-12-17,9857
2520,冠德,23,0,23,元大-蘆洲,2024-12-17,9857
6541,泰福-KY,23,0,23,元大-蘆洲,2024-12-17,9857
2449,京元電子,34,11,23,元大-蘆洲,2024-12-17,9857
2002,中鋼,23,1,22,元大-蘆洲,2024-12-17,9857
00712,復華富時不動產,23,1,22,元大-蘆洲,2024-12-17,9857
1722,台肥,21,0,21,元大-蘆洲,2024-12-17,9857
6188,廣明,66,45,21,元大-蘆洲,2024-12-17,9857
2409,友達,21,0,21,元大-蘆洲,2024-12-17,9857
00651R,復華香港反1,20,0,20,元大-蘆洲,2024-12-17,9857
00679B,元大美債20年,20,2,18,元大-蘆洲,2024-12-17,9857
2887,台新金,20,2,18,元大-蘆洲,2024-12-17,9857
6220,岳豐,17,0,17,元大-蘆洲,2024-12-17,9857
2317,鴻海,43,28,15,元大-蘆洲,2024-12-17,9857
00733,富邦臺灣中小,15,0,15,元大-蘆洲,2024-12-17,9857
2206,三陽工業,15,0,15,元大-蘆洲,2024-12-17,9857
1909,榮成,15,0,15,元大-蘆洲,2024-12-17,9857
1815,富喬,35,20,15,元大-蘆洲,2024-12-17,9857
2312,金寶,54,39,15,元大-蘆洲,2024-12-17,9857
8249,菱光,70,56,14,元大-蘆洲,2024-12-17,9857
3443,創意,26,12,14,元大-蘆洲,2024-12-17,9857
2883,凱基金,18,4,14,元大-蘆洲,2024-12-17,9857
1536,和大,28,14,14,元大-蘆洲,2024-12-17,9857
1314,中石化,13,0,13,元大-蘆洲,2024-12-17,9857
2609,陽明,38,25,13,元大-蘆洲,2024-12-17,9857
4534,慶騰,15,2,13,元大-蘆洲,2024-12-17,9857
9105,泰金寶-DR,986,530,456,元大-蘆洲,2024-12-18,9857
00712,復華富時不動產,254,0,254,元大-蘆洲,2024-12-18,9857
00680L,元大美債20正2,211,2,209,元大-蘆洲,2024-12-18,9857
00918,大華優利高填息30,195,3,192,元大-蘆洲,2024-12-18,9857
5243,乙盛-KY,217,30,187,元大-蘆洲,2024-12-18,9857
3019,亞光,310,166,144,元大-蘆洲,2024-12-18,9857
00937B,群益ESG投等債20,107,1,106,元大-蘆洲,2024-12-18,9857
2890,永豐金,86,5,81,元大-蘆洲,2024-12-18,9857
3481,群創,76,8,68,元大-蘆洲,2024-12-18,9857
8249,菱光,201,136,65,元大-蘆洲,2024-12-18,9857
5439,高技,60,4,56,元大-蘆洲,2024-12-18,9857
2801,彰銀,50,0,50,元大-蘆洲,2024-12-18,9857
00679B,元大美債20年,52,2,50,元大-蘆洲,2024-12-18,9857
00673R,期元大S＆P原油反1,50,4,46,元大-蘆洲,2024-12-18,9857
00631L,元大台灣50正2,45,0,45,元大-蘆洲,2024-12-18,9857
2303,聯電,185,140,45,元大-蘆洲,2024-12-18,9857
2891,中信金,47,2,45,元大-蘆洲,2024-12-18,9857
1314,中石化,47,3,44,元大-蘆洲,2024-12-18,9857
2409,友達,54,11,43,元大-蘆洲,2024-12-18,9857
00878,國泰永續高股息,59,17,42,元大-蘆洲,2024-12-18,9857
2206,三陽工業,40,0,40,元大-蘆洲,2024-12-18,9857
00950B,凱基A級公司債,38,0,38,元大-蘆洲,2024-12-18,9857
2312,金寶,47,9,38,元大-蘆洲,2024-12-18,9857
2365,昆盈,37,4,33,元大-蘆洲,2024-12-18,9857
00919,群益台灣精選高息,93,65,28,元大-蘆洲,2024-12-18,9857
00891,中信關鍵半導體,27,1,26,元大-蘆洲,2024-12-18,9857
3231,緯創,42,16,26,元大-蘆洲,2024-12-18,9857
00969B,元大零息超長美債,25,0,25,元大-蘆洲,2024-12-18,9857
2915,潤泰全,25,0,25,元大-蘆洲,2024-12-18,9857
6215,和椿,47,22,25,元大-蘆洲,2024-12-18,9857
2408,南亞科,57,34,23,元大-蘆洲,2024-12-18,9857
2392,正崴,26,5,21,元大-蘆洲,2024-12-18,9857
2489,瑞軒,21,0,21,元大-蘆洲,2024-12-18,9857
1733,五鼎,20,0,20,元大-蘆洲,2024-12-18,9857
3059,華晶科,27,8,19,元大-蘆洲,2024-12-18,9857
2883,凱基金,30,12,18,元大-蘆洲,2024-12-18,9857
8027,鈦昇,18,0,18,元大-蘆洲,2024-12-18,9857
2520,冠德,19,1,18,元大-蘆洲,2024-12-18,9857
1513,中興電,22,5,17,元大-蘆洲,2024-12-18,9857
1722,台肥,21,5,16,元大-蘆洲,2024-12-18,9857
3706,神達,190,175,15,元大-蘆洲,2024-12-18,9857
8044,網家,15,0,15,元大-蘆洲,2024-12-18,9857
00632R,元大台灣50反1,15,0,15,元大-蘆洲,2024-12-18,9857
2002,中鋼,16,2,14,元大-蘆洲,2024-12-18,9857
5371,中光電,50,36,14,元大-蘆洲,2024-12-18,9857
1442,名軒,27,14,13,元大-蘆洲,2024-12-18,9857
2887,台新金,14,2,12,元大-蘆洲,2024-12-18,9857
2504,國產,14,2,12,元大-蘆洲,2024-12-18,9857
2332,友訊,13,1,12,元大-蘆洲,2024-12-18,9857
2367,燿華,36,24,12,元大-蘆洲,2024-12-18,9857
00937B,群益ESG投等債20,401,60,341,元大-蘆洲,2024-12-19,9857
00918,大華優利高填息30,272,23,249,元大-蘆洲,2024-12-19,9857
00680L,元大美債20正2,251,22,229,元大-蘆洲,2024-12-19,9857
00712,復華富時不動產,215,0,215,元大-蘆洲,2024-12-19,9857
2838,聯邦銀,201,0,201,元大-蘆洲,2024-12-19,9857
2883,凱基金,183,2,181,元大-蘆洲,2024-12-19,9857
2206,三陽工業,152,1,151,元大-蘆洲,2024-12-19,9857
00950B,凱基A級公司債,121,0,121,元大-蘆洲,2024-12-19,9857
00687B,國泰20年美債,139,23,116,元大-蘆洲,2024-12-19,9857
2887,台新金,110,3,107,元大-蘆洲,2024-12-19,9857
2313,華通,109,12,97,元大-蘆洲,2024-12-19,9857
0056,元大高股息,106,13,93,元大-蘆洲,2024-12-19,9857
00959B,大華投等美債15Y+,89,0,89,元大-蘆洲,2024-12-19,9857
3481,群創,103,17,86,元大-蘆洲,2024-12-19,9857
9105,泰金寶-DR,234,157,77,元大-蘆洲,2024-12-19,9857
00965,元大航太防衛科技,275,201,74,元大-蘆洲,2024-12-19,9857
00878,國泰永續高股息,87,14,73,元大-蘆洲,2024-12-19,9857
2349,錸德,70,2,68,元大-蘆洲,2024-12-19,9857
2317,鴻海,75,11,64,元大-蘆洲,2024-12-19,9857
00679B,元大美債20年,85,23,62,元大-蘆洲,2024-12-19,9857
2344,華邦電,71,11,60,元大-蘆洲,2024-12-19,9857
2915,潤泰全,60,0,60,元大-蘆洲,2024-12-19,9857
00688L,國泰20年美債正2,59,0,59,元大-蘆洲,2024-12-19,9857
00915,凱基優選高股息30,77,20,57,元大-蘆洲,2024-12-19,9857
2331,精英,50,0,50,元大-蘆洲,2024-12-19,9857
00968B,元大優息投等債,57,10,47,元大-蘆洲,2024-12-19,9857
2880,華南金,44,1,43,元大-蘆洲,2024-12-19,9857
2409,友達,48,11,37,元大-蘆洲,2024-12-19,9857
00757,統一FANG+,40,7,33,元大-蘆洲,2024-12-19,9857
2303,聯電,58,26,32,元大-蘆洲,2024-12-19,9857
6689,伊雲谷,30,0,30,元大-蘆洲,2024-12-19,9857
8249,菱光,61,31,30,元大-蘆洲,2024-12-19,9857
3231,緯創,36,8,28,元大-蘆洲,2024-12-19,9857
1733,五鼎,28,0,28,元大-蘆洲,2024-12-19,9857
2881,富邦金,27,0,27,元大-蘆洲,2024-12-19,9857
5880,合庫金,28,2,26,元大-蘆洲,2024-12-19,9857
9958,世紀鋼,29,4,25,元大-蘆洲,2024-12-19,9857
2609,陽明,67,42,25,元大-蘆洲,2024-12-19,9857
2354,鴻準,45,20,25,元大-蘆洲,2024-12-19,9857
2867,三商壽,25,0,25,元大-蘆洲,2024-12-19,9857
00830,國泰費城半導體,24,0,24,元大-蘆洲,2024-12-19,9857
2834,臺企銀,24,0,24,元大-蘆洲,2024-12-19,9857
5351,鈺創,29,6,23,元大-蘆洲,2024-12-19,9857
3260,威剛,26,4,22,元大-蘆洲,2024-12-19,9857
006208,富邦台50,21,1,20,元大-蘆洲,2024-12-19,9857
00963,中信全球高股息,20,0,20,元大-蘆洲,2024-12-19,9857
2633,台灣高鐵,20,0,20,元大-蘆洲,2024-12-19,9857
3704,合勤控,24,4,20,元大-蘆洲,2024-12-19,9857
00933B,國泰10Y+金融債,20,0,20,元大-蘆洲,2024-12-19,9857
5328,華容,24,6,18,元大-蘆洲,2024-12-19,9857
