Ticker,Name,buy,sell,diff,Branch,Date,Branch_Code
2609,陽明,115,7,108,元大-大天母,2023-01-03,9893
2449,京元電子,87,0,87,元大-大天母,2023-01-03,9893
00637L,元大滬深300正2,143,58,85,元大-大天母,2023-01-03,9893
3704,合勤控,63,8,55,元大-大天母,2023-01-03,9893
00632R,元大台灣50反1,45,3,42,元大-大天母,2023-01-03,9893
00878,國泰永續高股息,35,0,35,元大-大天母,2023-01-03,9893
2317,鴻海,42,11,31,元大-大天母,2023-01-03,9893
2892,第一金,38,8,30,元大-大天母,2023-01-03,9893
3022,威強電,30,0,30,元大-大天母,2023-01-03,9893
1605,華新,33,9,24,元大-大天母,2023-01-03,9893
2603,長榮,132,110,22,元大-大天母,2023-01-03,9893
1720,生達,23,1,22,元大-大天母,2023-01-03,9893
3207,耀勝,20,0,20,元大-大天母,2023-01-03,9893
4111,濟生,20,0,20,元大-大天母,2023-01-03,9893
2641,正德,20,0,20,元大-大天母,2023-01-03,9893
4114,健喬,41,24,17,元大-大天母,2023-01-03,9893
3508,位速,15,0,15,元大-大天母,2023-01-03,9893
8478,東哥遊艇,15,0,15,元大-大天母,2023-01-03,9893
2338,光罩,18,4,14,元大-大天母,2023-01-03,9893
2634,漢翔,17,3,14,元大-大天母,2023-01-03,9893
2354,鴻準,14,2,12,元大-大天母,2023-01-03,9893
2618,長榮航,16,4,12,元大-大天母,2023-01-03,9893
1101,台泥,11,0,11,元大-大天母,2023-01-03,9893
4746,台耀,14,4,10,元大-大天母,2023-01-03,9893
1434,福懋,10,0,10,元大-大天母,2023-01-03,9893
4107,邦特,10,0,10,元大-大天母,2023-01-03,9893
4173,久裕,10,0,10,元大-大天母,2023-01-03,9893
3711,日月光投控,10,0,10,元大-大天母,2023-01-03,9893
9802,鈺齊-KY,9,1,8,元大-大天母,2023-01-03,9893
4123,晟德,8,0,8,元大-大天母,2023-01-03,9893
1342,八貫,9,1,8,元大-大天母,2023-01-03,9893
5880,合庫金,7,0,7,元大-大天母,2023-01-03,9893
5009,榮剛,10,3,7,元大-大天母,2023-01-03,9893
3680,家登,11,4,7,元大-大天母,2023-01-03,9893
4147,中裕,7,0,7,元大-大天母,2023-01-03,9893
2885,元大金,10,4,6,元大-大天母,2023-01-03,9893
1781,合世,6,0,6,元大-大天母,2023-01-03,9893
1529,樂事綠能,7,1,6,元大-大天母,2023-01-03,9893
2851,中再保,5,0,5,元大-大天母,2023-01-03,9893
6547,高端疫苗,25,20,5,元大-大天母,2023-01-03,9893
2344,華邦電,5,0,5,元大-大天母,2023-01-03,9893
9904,寶成,5,0,5,元大-大天母,2023-01-03,9893
6515,穎崴,5,0,5,元大-大天母,2023-01-03,9893
3693,營邦,5,0,5,元大-大天母,2023-01-03,9893
2812,台中銀,5,0,5,元大-大天母,2023-01-03,9893
2732,六角,5,0,5,元大-大天母,2023-01-03,9893
0056,元大高股息,11,7,4,元大-大天母,2023-01-03,9893
2201,裕隆,6,2,4,元大-大天母,2023-01-03,9893
1301,台塑,5,1,4,元大-大天母,2023-01-03,9893
3548,兆利,4,0,4,元大-大天母,2023-01-03,9893
2609,陽明,61,7,54,元大-大天母,2023-01-04,9893
00878,國泰永續高股息,43,2,41,元大-大天母,2023-01-04,9893
3034,聯詠,41,2,39,元大-大天母,2023-01-04,9893
2884,玉山金,38,0,38,元大-大天母,2023-01-04,9893
6477,安集,35,0,35,元大-大天母,2023-01-04,9893
3022,威強電,35,1,34,元大-大天母,2023-01-04,9893
00706L,期元大S＆P日圓正2,50,20,30,元大-大天母,2023-01-04,9893
6741,91APP*-KY,30,1,29,元大-大天母,2023-01-04,9893
2603,長榮,31,9,22,元大-大天母,2023-01-04,9893
8086,宏捷科,24,3,21,元大-大天母,2023-01-04,9893
1609,大亞,27,6,21,元大-大天母,2023-01-04,9893
6235,華孚,34,13,21,元大-大天母,2023-01-04,9893
00720B,元大投資級公司債,20,0,20,元大-大天母,2023-01-04,9893
2363,矽統,20,4,16,元大-大天母,2023-01-04,9893
0056,元大高股息,16,0,16,元大-大天母,2023-01-04,9893
1813,寶利徠,15,0,15,元大-大天母,2023-01-04,9893
2014,中鴻,17,2,15,元大-大天母,2023-01-04,9893
3551,世禾,14,0,14,元大-大天母,2023-01-04,9893
00902,中信電池及儲能,13,0,13,元大-大天母,2023-01-04,9893
3027,盛達,27,15,12,元大-大天母,2023-01-04,9893
4168,醣聯,10,0,10,元大-大天母,2023-01-04,9893
4107,邦特,10,0,10,元大-大天母,2023-01-04,9893
4111,濟生,10,0,10,元大-大天母,2023-01-04,9893
3686,達能,10,0,10,元大-大天母,2023-01-04,9893
2449,京元電子,10,0,10,元大-大天母,2023-01-04,9893
2367,燿華,10,2,8,元大-大天母,2023-01-04,9893
2498,宏達電,31,23,8,元大-大天母,2023-01-04,9893
2303,聯電,25,17,8,元大-大天母,2023-01-04,9893
00881,國泰台灣5G+,8,0,8,元大-大天母,2023-01-04,9893
5353,台林,15,7,8,元大-大天母,2023-01-04,9893
2883,凱基金,7,0,7,元大-大天母,2023-01-04,9893
1314,中石化,7,0,7,元大-大天母,2023-01-04,9893
2610,華航,8,1,7,元大-大天母,2023-01-04,9893
2338,光罩,9,3,6,元大-大天母,2023-01-04,9893
00893,國泰智能電動車,6,0,6,元大-大天母,2023-01-04,9893
1760,寶齡富錦,7,1,6,元大-大天母,2023-01-04,9893
6167,久正,6,0,6,元大-大天母,2023-01-04,9893
00751B,元大AAA至A公司債,6,0,6,元大-大天母,2023-01-04,9893
4931,新盛力,7,1,6,元大-大天母,2023-01-04,9893
2467,志聖,6,0,6,元大-大天母,2023-01-04,9893
4133,亞諾法,15,9,6,元大-大天母,2023-01-04,9893
1795,美時,9,4,5,元大-大天母,2023-01-04,9893
2890,永豐金,6,1,5,元大-大天母,2023-01-04,9893
2007,燁興,5,0,5,元大-大天母,2023-01-04,9893
1907,永豐餘,5,0,5,元大-大天母,2023-01-04,9893
00676R,富邦臺灣加權反1,5,0,5,元大-大天母,2023-01-04,9893
9924,福興,5,0,5,元大-大天母,2023-01-04,9893
2637,慧洋-KY,8,3,5,元大-大天母,2023-01-04,9893
1802,台玻,5,0,5,元大-大天母,2023-01-04,9893
00715L,期街口布蘭特正2,10,5,5,元大-大天母,2023-01-04,9893
6265,方土昶,101,0,101,元大-大天母,2023-01-05,9893
8069,元太,65,0,65,元大-大天母,2023-01-05,9893
2376,技嘉,60,5,55,元大-大天母,2023-01-05,9893
3260,威剛,56,5,51,元大-大天母,2023-01-05,9893
00706L,期元大S＆P日圓正2,50,0,50,元大-大天母,2023-01-05,9893
00639,富邦深100,50,0,50,元大-大天母,2023-01-05,9893
2409,友達,46,0,46,元大-大天母,2023-01-05,9893
4130,健亞,42,0,42,元大-大天母,2023-01-05,9893
5512,力麒,36,0,36,元大-大天母,2023-01-05,9893
3090,日電貿,35,0,35,元大-大天母,2023-01-05,9893
6202,盛群,35,0,35,元大-大天母,2023-01-05,9893
3714,富采,39,7,32,元大-大天母,2023-01-05,9893
6104,創惟,35,4,31,元大-大天母,2023-01-05,9893
1444,力麗,30,0,30,元大-大天母,2023-01-05,9893
6414,樺漢,30,1,29,元大-大天母,2023-01-05,9893
2408,南亞科,37,10,27,元大-大天母,2023-01-05,9893
1605,華新,46,20,26,元大-大天母,2023-01-05,9893
2303,聯電,27,2,25,元大-大天母,2023-01-05,9893
2455,全新,28,3,25,元大-大天母,2023-01-05,9893
1504,東元,28,3,25,元大-大天母,2023-01-05,9893
006207,復華滬深,20,0,20,元大-大天母,2023-01-05,9893
4190,佐登-KY,20,0,20,元大-大天母,2023-01-05,9893
8222,寶一,20,1,19,元大-大天母,2023-01-05,9893
6689,伊雲谷,18,0,18,元大-大天母,2023-01-05,9893
4114,健喬,25,10,15,元大-大天母,2023-01-05,9893
00753L,中信中國50正2,15,0,15,元大-大天母,2023-01-05,9893
6118,建達,14,1,13,元大-大天母,2023-01-05,9893
2614,東森,14,2,12,元大-大天母,2023-01-05,9893
1513,中興電,41,30,11,元大-大天母,2023-01-05,9893
2449,京元電子,11,0,11,元大-大天母,2023-01-05,9893
3661,世芯-KY,13,3,10,元大-大天母,2023-01-05,9893
1721,三晃,10,0,10,元大-大天母,2023-01-05,9893
4533,協易機,10,0,10,元大-大天母,2023-01-05,9893
1536,和大,10,0,10,元大-大天母,2023-01-05,9893
3232,昱捷,10,0,10,元大-大天母,2023-01-05,9893
2351,順德,10,0,10,元大-大天母,2023-01-05,9893
2312,金寶,10,0,10,元大-大天母,2023-01-05,9893
3141,晶宏,10,0,10,元大-大天母,2023-01-05,9893
2406,國碩,10,0,10,元大-大天母,2023-01-05,9893
6592,和潤企業,10,0,10,元大-大天母,2023-01-05,9893
2454,聯發科,13,4,9,元大-大天母,2023-01-05,9893
5284,jpp-KY,12,3,9,元大-大天母,2023-01-05,9893
5009,榮剛,11,2,9,元大-大天母,2023-01-05,9893
4977,眾達-KY,10,1,9,元大-大天母,2023-01-05,9893
2344,華邦電,32,23,9,元大-大天母,2023-01-05,9893
3708,上緯投控,8,0,8,元大-大天母,2023-01-05,9893
2428,興勤,8,0,8,元大-大天母,2023-01-05,9893
2313,華通,12,4,8,元大-大天母,2023-01-05,9893
1417,嘉裕,20,12,8,元大-大天母,2023-01-05,9893
3551,世禾,8,0,8,元大-大天母,2023-01-05,9893
00665L,富邦�琤肭磪囓�2,100,0,100,元大-大天母,2023-01-06,9893
2458,義隆,97,4,93,元大-大天母,2023-01-06,9893
4168,醣聯,74,0,74,元大-大天母,2023-01-06,9893
1817,凱撒衛,64,0,64,元大-大天母,2023-01-06,9893
00680L,元大美債20正2,60,1,59,元大-大天母,2023-01-06,9893
4114,健喬,70,12,58,元大-大天母,2023-01-06,9893
3260,威剛,50,0,50,元大-大天母,2023-01-06,9893
00706L,期元大S＆P日圓正2,50,0,50,元大-大天母,2023-01-06,9893
5425,台半,45,3,42,元大-大天母,2023-01-06,9893
00683L,期元大美元指正2,42,0,42,元大-大天母,2023-01-06,9893
2486,一詮,35,0,35,元大-大天母,2023-01-06,9893
3704,合勤控,65,34,31,元大-大天母,2023-01-06,9893
1519,華城,65,48,17,元大-大天母,2023-01-06,9893
2419,仲琦,18,2,16,元大-大天母,2023-01-06,9893
2634,漢翔,16,0,16,元大-大天母,2023-01-06,9893
2498,宏達電,23,8,15,元大-大天母,2023-01-06,9893
1314,中石化,14,0,14,元大-大天母,2023-01-06,9893
6245,立端,14,1,13,元大-大天母,2023-01-06,9893
2317,鴻海,13,0,13,元大-大天母,2023-01-06,9893
3017,奇鋐,11,0,11,元大-大天母,2023-01-06,9893
1101,台泥,10,0,10,元大-大天母,2023-01-06,9893
1909,榮成,10,0,10,元大-大天母,2023-01-06,9893
4763,材料-KY,11,1,10,元大-大天母,2023-01-06,9893
4111,濟生,10,0,10,元大-大天母,2023-01-06,9893
8046,南電,14,4,10,元大-大天母,2023-01-06,9893
3661,世芯-KY,15,5,10,元大-大天母,2023-01-06,9893
5351,鈺創,10,0,10,元大-大天母,2023-01-06,9893
1536,和大,10,0,10,元大-大天母,2023-01-06,9893
2371,大同,10,0,10,元大-大天母,2023-01-06,9893
2603,長榮,13,4,9,元大-大天母,2023-01-06,9893
00885,富邦越南,8,0,8,元大-大天母,2023-01-06,9893
3548,兆利,8,0,8,元大-大天母,2023-01-06,9893
6290,良維,8,0,8,元大-大天母,2023-01-06,9893
6155,鈞寶,8,0,8,元大-大天母,2023-01-06,9893
00891,中信關鍵半導體,10,2,8,元大-大天母,2023-01-06,9893
3708,上緯投控,7,0,7,元大-大天母,2023-01-06,9893
2884,玉山金,7,0,7,元大-大天母,2023-01-06,9893
4746,台耀,11,4,7,元大-大天母,2023-01-06,9893
00720B,元大投資級公司債,7,0,7,元大-大天母,2023-01-06,9893
6689,伊雲谷,11,4,7,元大-大天母,2023-01-06,9893
6176,瑞儀,6,0,6,元大-大天母,2023-01-06,9893
2105,正新,6,0,6,元大-大天母,2023-01-06,9893
1513,中興電,46,40,6,元大-大天母,2023-01-06,9893
2888,新光金,5,0,5,元大-大天母,2023-01-06,9893
1810,和成,5,0,5,元大-大天母,2023-01-06,9893
2707,晶華,5,0,5,元大-大天母,2023-01-06,9893
3551,世禾,5,0,5,元大-大天母,2023-01-06,9893
2618,長榮航,5,1,4,元大-大天母,2023-01-06,9893
6284,佳邦,4,0,4,元大-大天母,2023-01-06,9893
5608,四維航,5,1,4,元大-大天母,2023-01-06,9893
00665L,富邦�琤肭磪囓�2,260,0,260,元大-大天母,2023-01-09,9893
2014,中鴻,115,58,57,元大-大天母,2023-01-09,9893
1605,華新,51,9,42,元大-大天母,2023-01-09,9893
5009,榮剛,44,4,40,元大-大天母,2023-01-09,9893
2610,華航,52,21,31,元大-大天母,2023-01-09,9893
8086,宏捷科,32,3,29,元大-大天母,2023-01-09,9893
2009,第一銅,40,12,28,元大-大天母,2023-01-09,9893
2359,所羅門,31,4,27,元大-大天母,2023-01-09,9893
00878,國泰永續高股息,42,16,26,元大-大天母,2023-01-09,9893
2851,中再保,25,1,24,元大-大天母,2023-01-09,9893
4168,醣聯,22,0,22,元大-大天母,2023-01-09,9893
9924,福興,20,0,20,元大-大天母,2023-01-09,9893
1609,大亞,20,0,20,元大-大天母,2023-01-09,9893
00633L,富邦上証正2,30,11,19,元大-大天母,2023-01-09,9893
2449,京元電子,20,3,17,元大-大天母,2023-01-09,9893
2634,漢翔,16,1,15,元大-大天母,2023-01-09,9893
6269,台郡,15,0,15,元大-大天母,2023-01-09,9893
1532,勤美,15,0,15,元大-大天母,2023-01-09,9893
3027,盛達,16,2,14,元大-大天母,2023-01-09,9893
2458,義隆,22,9,13,元大-大天母,2023-01-09,9893
3014,聯陽,14,2,12,元大-大天母,2023-01-09,9893
6245,立端,10,0,10,元大-大天母,2023-01-09,9893
00671R,富邦NASDAQ反1,10,0,10,元大-大天母,2023-01-09,9893
1467,南緯,10,0,10,元大-大天母,2023-01-09,9893
6220,岳豐,10,0,10,元大-大天母,2023-01-09,9893
3481,群創,17,8,9,元大-大天母,2023-01-09,9893
2367,燿華,12,3,9,元大-大天母,2023-01-09,9893
1712,興農,8,0,8,元大-大天母,2023-01-09,9893
5351,鈺創,12,4,8,元大-大天母,2023-01-09,9893
3162,精確,8,0,8,元大-大天母,2023-01-09,9893
6770,力積電,26,18,8,元大-大天母,2023-01-09,9893
00647L,元大S＆P500正2,7,0,7,元大-大天母,2023-01-09,9893
6166,凌華,7,0,7,元大-大天母,2023-01-09,9893
00772B,中信高評級公司債,7,0,7,元大-大天母,2023-01-09,9893
5353,台林,7,0,7,元大-大天母,2023-01-09,9893
1907,永豐餘,7,0,7,元大-大天母,2023-01-09,9893
00902,中信電池及儲能,15,8,7,元大-大天母,2023-01-09,9893
8028,昇陽半導體,6,0,6,元大-大天母,2023-01-09,9893
1314,中石化,6,0,6,元大-大天母,2023-01-09,9893
2351,順德,6,0,6,元大-大天母,2023-01-09,9893
6235,華孚,6,0,6,元大-大天母,2023-01-09,9893
4919,新唐,18,12,6,元大-大天母,2023-01-09,9893
00715L,期街口布蘭特正2,6,0,6,元大-大天母,2023-01-09,9893
6133,金橋,19,13,6,元大-大天母,2023-01-09,9893
8284,三竹,6,0,6,元大-大天母,2023-01-09,9893
1319,東陽,7,2,5,元大-大天母,2023-01-09,9893
4533,協易機,5,0,5,元大-大天母,2023-01-09,9893
1813,寶利徠,5,0,5,元大-大天母,2023-01-09,9893
3090,日電貿,5,0,5,元大-大天母,2023-01-09,9893
3704,合勤控,17,12,5,元大-大天母,2023-01-09,9893
6245,立端,209,4,205,元大-大天母,2023-01-10,9893
2748,雲品,203,1,202,元大-大天母,2023-01-10,9893
2891,中信金,139,12,127,元大-大天母,2023-01-10,9893
2428,興勤,52,4,48,元大-大天母,2023-01-10,9893
8086,宏捷科,44,2,42,元大-大天母,2023-01-10,9893
0056,元大高股息,43,9,34,元大-大天母,2023-01-10,9893
2408,南亞科,60,26,34,元大-大天母,2023-01-10,9893
2419,仲琦,28,2,26,元大-大天母,2023-01-10,9893
00878,國泰永續高股息,33,10,23,元大-大天母,2023-01-10,9893
1701,中化,22,0,22,元大-大天母,2023-01-10,9893
00893,國泰智能電動車,23,1,22,元大-大天母,2023-01-10,9893
4142,國光生,22,0,22,元大-大天母,2023-01-10,9893
2449,京元電子,20,0,20,元大-大天母,2023-01-10,9893
6443,元晶,24,5,19,元大-大天母,2023-01-10,9893
8049,晶采,20,2,18,元大-大天母,2023-01-10,9893
2916,滿心,17,0,17,元大-大天母,2023-01-10,9893
1712,興農,16,0,16,元大-大天母,2023-01-10,9893
3022,威強電,15,0,15,元大-大天母,2023-01-10,9893
2618,長榮航,31,16,15,元大-大天母,2023-01-10,9893
2882,國泰金,15,2,13,元大-大天母,2023-01-10,9893
3037,欣興,17,5,12,元大-大天母,2023-01-10,9893
5609,中菲行,12,0,12,元大-大天母,2023-01-10,9893
8938,明安,11,0,11,元大-大天母,2023-01-10,9893
6282,康舒,12,1,11,元大-大天母,2023-01-10,9893
8046,南電,11,0,11,元大-大天母,2023-01-10,9893
8478,東哥遊艇,11,0,11,元大-大天母,2023-01-10,9893
2009,第一銅,26,16,10,元大-大天母,2023-01-10,9893
4533,協易機,10,0,10,元大-大天母,2023-01-10,9893
00753L,中信中國50正2,20,10,10,元大-大天母,2023-01-10,9893
2010,春源,10,0,10,元大-大天母,2023-01-10,9893
00772B,中信高評級公司債,10,0,10,元大-大天母,2023-01-10,9893
1503,士電,13,4,9,元大-大天母,2023-01-10,9893
8028,昇陽半導體,20,12,8,元大-大天母,2023-01-10,9893
2612,中航,10,2,8,元大-大天母,2023-01-10,9893
2498,宏達電,32,24,8,元大-大天母,2023-01-10,9893
6770,力積電,11,3,8,元大-大天母,2023-01-10,9893
2609,陽明,23,16,7,元大-大天母,2023-01-10,9893
2884,玉山金,7,0,7,元大-大天母,2023-01-10,9893
6589,台康生技,7,0,7,元大-大天母,2023-01-10,9893
5388,中磊,7,0,7,元大-大天母,2023-01-10,9893
6104,創惟,11,4,7,元大-大天母,2023-01-10,9893
00900,富邦特選高股息30,7,0,7,元大-大天母,2023-01-10,9893
2208,台船,7,0,7,元大-大天母,2023-01-10,9893
2454,聯發科,15,8,7,元大-大天母,2023-01-10,9893
1524,耿鼎,9,3,6,元大-大天母,2023-01-10,9893
3680,家登,6,0,6,元大-大天母,2023-01-10,9893
2338,光罩,6,0,6,元大-大天母,2023-01-10,9893
3454,晶睿,11,5,6,元大-大天母,2023-01-10,9893
1101,台泥,7,1,6,元大-大天母,2023-01-10,9893
6806,森崴能源,6,0,6,元大-大天母,2023-01-10,9893
5284,jpp-KY,144,9,135,元大-大天母,2023-01-11,9893
6752,叡揚,84,1,83,元大-大天母,2023-01-11,9893
2748,雲品,70,0,70,元大-大天母,2023-01-11,9893
2891,中信金,60,1,59,元大-大天母,2023-01-11,9893
2892,第一金,39,1,38,元大-大天母,2023-01-11,9893
2002,中鋼,40,3,37,元大-大天母,2023-01-11,9893
0056,元大高股息,57,21,36,元大-大天母,2023-01-11,9893
4142,國光生,30,0,30,元大-大天母,2023-01-11,9893
3704,合勤控,35,16,19,元大-大天母,2023-01-11,9893
1529,樂事綠能,43,25,18,元大-大天母,2023-01-11,9893
1813,寶利徠,17,0,17,元大-大天母,2023-01-11,9893
1817,凱撒衛,15,0,15,元大-大天母,2023-01-11,9893
2888,新光金,14,0,14,元大-大天母,2023-01-11,9893
2356,英業達,13,0,13,元大-大天母,2023-01-11,9893
1560,中砂,12,0,12,元大-大天母,2023-01-11,9893
1217,愛之味,12,0,12,元大-大天母,2023-01-11,9893
2527,宏璟,11,0,11,元大-大天母,2023-01-11,9893
6533,晶心科,12,2,10,元大-大天母,2023-01-11,9893
2615,萬海,14,4,10,元大-大天母,2023-01-11,9893
2201,裕隆,12,2,10,元大-大天母,2023-01-11,9893
4960,誠美材,10,0,10,元大-大天母,2023-01-11,9893
2345,智邦,11,1,10,元大-大天母,2023-01-11,9893
4973,廣穎,10,0,10,元大-大天母,2023-01-11,9893
00652,富邦印度,10,0,10,元大-大天母,2023-01-11,9893
5426,振發,10,0,10,元大-大天母,2023-01-11,9893
1701,中化,15,5,10,元大-大天母,2023-01-11,9893
2419,仲琦,13,3,10,元大-大天母,2023-01-11,9893
3494,誠研,10,0,10,元大-大天母,2023-01-11,9893
00686R,群益臺灣加權反1,10,0,10,元大-大天母,2023-01-11,9893
2633,台灣高鐵,10,0,10,元大-大天母,2023-01-11,9893
00715L,期街口布蘭特正2,10,0,10,元大-大天母,2023-01-11,9893
3232,昱捷,10,0,10,元大-大天母,2023-01-11,9893
2313,華通,10,0,10,元大-大天母,2023-01-11,9893
8436,大江,10,0,10,元大-大天母,2023-01-11,9893
00893,國泰智能電動車,10,1,9,元大-大天母,2023-01-11,9893
1219,福壽,11,2,9,元大-大天母,2023-01-11,9893
00878,國泰永續高股息,76,68,8,元大-大天母,2023-01-11,9893
2634,漢翔,10,2,8,元大-大天母,2023-01-11,9893
3027,盛達,27,19,8,元大-大天母,2023-01-11,9893
5607,遠雄港,8,0,8,元大-大天母,2023-01-11,9893
6239,力成,8,0,8,元大-大天母,2023-01-11,9893
3380,明泰,9,2,7,元大-大天母,2023-01-11,9893
6443,元晶,24,17,7,元大-大天母,2023-01-11,9893
00679B,元大美債20年,8,2,6,元大-大天母,2023-01-11,9893
6104,創惟,7,1,6,元大-大天母,2023-01-11,9893
8249,菱光,7,1,6,元大-大天母,2023-01-11,9893
1503,士電,10,4,6,元大-大天母,2023-01-11,9893
3402,漢科,6,0,6,元大-大天母,2023-01-11,9893
2457,飛宏,7,1,6,元大-大天母,2023-01-11,9893
3163,波若威,10,4,6,元大-大天母,2023-01-11,9893
2891,中信金,110,0,110,元大-大天母,2023-01-12,9893
2834,臺企銀,102,0,102,元大-大天母,2023-01-12,9893
2206,三陽工業,100,0,100,元大-大天母,2023-01-12,9893
00753L,中信中國50正2,47,1,46,元大-大天母,2023-01-12,9893
2748,雲品,35,1,34,元大-大天母,2023-01-12,9893
00673R,期元大S＆P原油反1,33,0,33,元大-大天母,2023-01-12,9893
2634,漢翔,31,0,31,元大-大天母,2023-01-12,9893
2892,第一金,31,2,29,元大-大天母,2023-01-12,9893
1101,台泥,32,5,27,元大-大天母,2023-01-12,9893
4931,新盛力,25,0,25,元大-大天母,2023-01-12,9893
00878,國泰永續高股息,25,0,25,元大-大天母,2023-01-12,9893
4142,國光生,21,0,21,元大-大天母,2023-01-12,9893
2884,玉山金,21,1,20,元大-大天母,2023-01-12,9893
5284,jpp-KY,20,0,20,元大-大天母,2023-01-12,9893
1609,大亞,20,0,20,元大-大天母,2023-01-12,9893
00882,中信中國高股息,13,0,13,元大-大天母,2023-01-12,9893
2308,台達電,12,0,12,元大-大天母,2023-01-12,9893
2201,裕隆,14,2,12,元大-大天母,2023-01-12,9893
1608,華榮,14,2,12,元大-大天母,2023-01-12,9893
1809,中釉,19,7,12,元大-大天母,2023-01-12,9893
4114,健喬,23,11,12,元大-大天母,2023-01-12,9893
1605,華新,33,21,12,元大-大天母,2023-01-12,9893
6770,力積電,11,0,11,元大-大天母,2023-01-12,9893
1519,華城,14,3,11,元大-大天母,2023-01-12,9893
3037,欣興,10,0,10,元大-大天母,2023-01-12,9893
8069,元太,115,105,10,元大-大天母,2023-01-12,9893
2608,嘉里大榮,10,0,10,元大-大天母,2023-01-12,9893
4973,廣穎,10,0,10,元大-大天母,2023-01-12,9893
5609,中菲行,10,0,10,元大-大天母,2023-01-12,9893
2535,達欣工,10,0,10,元大-大天母,2023-01-12,9893
00665L,富邦�琤肭磪囓�2,10,0,10,元大-大天母,2023-01-12,9893
5871,中租-KY,13,3,10,元大-大天母,2023-01-12,9893
3293,鈊象,9,0,9,元大-大天母,2023-01-12,9893
1701,中化,9,0,9,元大-大天母,2023-01-12,9893
4904,遠傳,10,1,9,元大-大天母,2023-01-12,9893
00905,FT臺灣Smart,9,0,9,元大-大天母,2023-01-12,9893
2009,第一銅,62,53,9,元大-大天母,2023-01-12,9893
2633,台灣高鐵,9,0,9,元大-大天母,2023-01-12,9893
2603,長榮,17,8,9,元大-大天母,2023-01-12,9893
4536,拓凱,8,0,8,元大-大天母,2023-01-12,9893
3687,歐買尬,10,2,8,元大-大天母,2023-01-12,9893
8938,明安,10,2,8,元大-大天母,2023-01-12,9893
6285,啟��,8,0,8,元大-大天母,2023-01-12,9893
2356,英業達,8,0,8,元大-大天母,2023-01-12,9893
0056,元大高股息,8,1,7,元大-大天母,2023-01-12,9893
4190,佐登-KY,7,0,7,元大-大天母,2023-01-12,9893
3093,港建*,7,0,7,元大-大天母,2023-01-12,9893
6605,帝寶,7,0,7,元大-大天母,2023-01-12,9893
4743,合一,7,1,6,元大-大天母,2023-01-12,9893
4162,智擎,6,0,6,元大-大天母,2023-01-12,9893
2883,凱基金,366,7,359,元大-大天母,2023-01-13,9893
2891,中信金,117,0,117,元大-大天母,2023-01-13,9893
2006,東和鋼鐵,60,0,60,元大-大天母,2023-01-13,9893
8069,元太,61,6,55,元大-大天母,2023-01-13,9893
2312,金寶,50,0,50,元大-大天母,2023-01-13,9893
00878,國泰永續高股息,44,5,39,元大-大天母,2023-01-13,9893
8050,廣積,34,6,28,元大-大天母,2023-01-13,9893
2498,宏達電,46,23,23,元大-大天母,2023-01-13,9893
6752,叡揚,21,0,21,元大-大天母,2023-01-13,9893
4915,致伸,20,0,20,元大-大天母,2023-01-13,9893
1813,寶利徠,20,0,20,元大-大天母,2023-01-13,9893
2889,國票金,17,0,17,元大-大天母,2023-01-13,9893
1701,中化,19,4,15,元大-大天母,2023-01-13,9893
6443,元晶,18,4,14,元大-大天母,2023-01-13,9893
2609,陽明,21,9,12,元大-大天母,2023-01-13,9893
2634,漢翔,12,1,11,元大-大天母,2023-01-13,9893
4130,健亞,11,0,11,元大-大天母,2023-01-13,9893
2882,國泰金,17,6,11,元大-大天母,2023-01-13,9893
5284,jpp-KY,10,0,10,元大-大天母,2023-01-13,9893
2608,嘉里大榮,10,0,10,元大-大天母,2023-01-13,9893
2748,雲品,11,1,10,元大-大天母,2023-01-13,9893
3680,家登,12,3,9,元大-大天母,2023-01-13,9893
2736,富野,8,0,8,元大-大天母,2023-01-13,9893
5609,中菲行,8,0,8,元大-大天母,2023-01-13,9893
00676R,富邦臺灣加權反1,7,0,7,元大-大天母,2023-01-13,9893
00720B,元大投資級公司債,7,0,7,元大-大天母,2023-01-13,9893
6166,凌華,7,0,7,元大-大天母,2023-01-13,9893
3515,華擎,6,0,6,元大-大天母,2023-01-13,9893
6134,萬旭,6,0,6,元大-大天母,2023-01-13,9893
00882,中信中國高股息,6,0,6,元大-大天母,2023-01-13,9893
6150,撼訊,6,0,6,元大-大天母,2023-01-13,9893
3548,兆利,6,0,6,元大-大天母,2023-01-13,9893
3708,上緯投控,6,0,6,元大-大天母,2023-01-13,9893
4961,天鈺,10,5,5,元大-大天母,2023-01-13,9893
2314,台揚,5,0,5,元大-大天母,2023-01-13,9893
2376,技嘉,5,0,5,元大-大天母,2023-01-13,9893
5529,鉅陞,5,0,5,元大-大天母,2023-01-13,9893
1319,東陽,5,0,5,元大-大天母,2023-01-13,9893
4533,協易機,5,0,5,元大-大天母,2023-01-13,9893
4173,久裕,5,0,5,元大-大天母,2023-01-13,9893
00751B,元大AAA至A公司債,5,0,5,元大-大天母,2023-01-13,9893
1513,中興電,9,5,4,元大-大天母,2023-01-13,9893
6245,立端,15,11,4,元大-大天母,2023-01-13,9893
0056,元大高股息,8,4,4,元大-大天母,2023-01-13,9893
3479,安勤,6,2,4,元大-大天母,2023-01-13,9893
2812,台中銀,4,0,4,元大-大天母,2023-01-13,9893
3374,精材,11,7,4,元大-大天母,2023-01-13,9893
5608,四維航,5,1,4,元大-大天母,2023-01-13,9893
00708L,期元大S＆P黃金正2,4,0,4,元大-大天母,2023-01-13,9893
00633L,富邦上証正2,5,1,4,元大-大天母,2023-01-13,9893
2609,陽明,132,7,125,元大-大天母,2023-01-16,9893
00673R,期元大S＆P原油反1,63,0,63,元大-大天母,2023-01-16,9893
2317,鴻海,80,22,58,元大-大天母,2023-01-16,9893
00878,國泰永續高股息,48,9,39,元大-大天母,2023-01-16,9893
2610,華航,46,10,36,元大-大天母,2023-01-16,9893
2344,華邦電,35,2,33,元大-大天母,2023-01-16,9893
4130,健亞,30,0,30,元大-大天母,2023-01-16,9893
00633L,富邦上証正2,50,20,30,元大-大天母,2023-01-16,9893
1319,東陽,25,0,25,元大-大天母,2023-01-16,9893
2347,聯強,23,0,23,元大-大天母,2023-01-16,9893
00720B,元大投資級公司債,20,0,20,元大-大天母,2023-01-16,9893
2312,金寶,17,0,17,元大-大天母,2023-01-16,9893
2634,漢翔,18,2,16,元大-大天母,2023-01-16,9893
8420,明揚,17,2,15,元大-大天母,2023-01-16,9893
5609,中菲行,15,0,15,元大-大天母,2023-01-16,9893
4162,智擎,15,0,15,元大-大天母,2023-01-16,9893
0056,元大高股息,16,2,14,元大-大天母,2023-01-16,9893
9945,潤泰新,17,3,14,元大-大天母,2023-01-16,9893
2002,中鋼,16,3,13,元大-大天母,2023-01-16,9893
6752,叡揚,13,0,13,元大-大天母,2023-01-16,9893
2419,仲琦,12,0,12,元大-大天母,2023-01-16,9893
3231,緯創,11,0,11,元大-大天母,2023-01-16,9893
3013,晟銘電,10,0,10,元大-大天母,2023-01-16,9893
1813,寶利徠,10,0,10,元大-大天母,2023-01-16,9893
00751B,元大AAA至A公司債,10,0,10,元大-大天母,2023-01-16,9893
4720,德淵,10,0,10,元大-大天母,2023-01-16,9893
2476,鉅祥,10,0,10,元大-大天母,2023-01-16,9893
5439,高技,10,0,10,元大-大天母,2023-01-16,9893
1720,生達,10,0,10,元大-大天母,2023-01-16,9893
1304,台聚,10,0,10,元大-大天母,2023-01-16,9893
4979,華星光,17,7,10,元大-大天母,2023-01-16,9893
2014,中鴻,16,7,9,元大-大天母,2023-01-16,9893
4114,健喬,15,7,8,元大-大天母,2023-01-16,9893
2618,長榮航,9,1,8,元大-大天母,2023-01-16,9893
6741,91APP*-KY,9,2,7,元大-大天母,2023-01-16,9893
00706L,期元大S＆P日圓正2,7,0,7,元大-大天母,2023-01-16,9893
00679B,元大美債20年,6,0,6,元大-大天母,2023-01-16,9893
1708,東鹼,6,0,6,元大-大天母,2023-01-16,9893
2542,興富發,6,0,6,元大-大天母,2023-01-16,9893
2375,凱美,6,0,6,元大-大天母,2023-01-16,9893
00885,富邦越南,6,0,6,元大-大天母,2023-01-16,9893
00770,國泰北美科技,6,0,6,元大-大天母,2023-01-16,9893
2883,凱基金,11,5,6,元大-大天母,2023-01-16,9893
4961,天鈺,7,2,5,元大-大天母,2023-01-16,9893
2369,菱生,5,0,5,元大-大天母,2023-01-16,9893
8076,伍豐,5,0,5,元大-大天母,2023-01-16,9893
2009,第一銅,11,6,5,元大-大天母,2023-01-16,9893
5607,遠雄港,5,0,5,元大-大天母,2023-01-16,9893
00641R,富邦日本反1,5,0,5,元大-大天母,2023-01-16,9893
8054,安國,5,0,5,元大-大天母,2023-01-16,9893
1101,台泥,185,25,160,元大-大天母,2023-01-17,9893
2545,皇翔,153,0,153,元大-大天母,2023-01-17,9893
00637L,元大滬深300正2,127,1,126,元大-大天母,2023-01-17,9893
2344,華邦電,120,6,114,元大-大天母,2023-01-17,9893
6116,彩晶,100,1,99,元大-大天母,2023-01-17,9893
2006,東和鋼鐵,65,0,65,元大-大天母,2023-01-17,9893
00720B,元大投資級公司債,48,0,48,元大-大天母,2023-01-17,9893
00633L,富邦上証正2,71,25,46,元大-大天母,2023-01-17,9893
8069,元太,46,1,45,元大-大天母,2023-01-17,9893
2883,凱基金,56,12,44,元大-大天母,2023-01-17,9893
5014,建錩,43,0,43,元大-大天母,2023-01-17,9893
1434,福懋,30,0,30,元大-大天母,2023-01-17,9893
00882,中信中國高股息,27,0,27,元大-大天母,2023-01-17,9893
1813,寶利徠,20,0,20,元大-大天母,2023-01-17,9893
2458,義隆,20,0,20,元大-大天母,2023-01-17,9893
5284,jpp-KY,30,11,19,元大-大天母,2023-01-17,9893
0050,元大台灣50,20,2,18,元大-大天母,2023-01-17,9893
00753L,中信中國50正2,17,0,17,元大-大天母,2023-01-17,9893
3013,晟銘電,18,1,17,元大-大天母,2023-01-17,9893
3481,群創,20,3,17,元大-大天母,2023-01-17,9893
3037,欣興,36,21,15,元大-大天母,2023-01-17,9893
2618,長榮航,24,9,15,元大-大天母,2023-01-17,9893
2014,中鴻,28,15,13,元大-大天母,2023-01-17,9893
2610,華航,13,0,13,元大-大天母,2023-01-17,9893
00706L,期元大S＆P日圓正2,13,0,13,元大-大天母,2023-01-17,9893
5609,中菲行,11,0,11,元大-大天母,2023-01-17,9893
2851,中再保,12,1,11,元大-大天母,2023-01-17,9893
2317,鴻海,13,2,11,元大-大天母,2023-01-17,9893
2884,玉山金,11,0,11,元大-大天母,2023-01-17,9893
00679B,元大美債20年,10,0,10,元大-大天母,2023-01-17,9893
2105,正新,15,5,10,元大-大天母,2023-01-17,9893
2104,國際中橡,10,0,10,元大-大天母,2023-01-17,9893
8050,廣積,10,0,10,元大-大天母,2023-01-17,9893
00665L,富邦�琤肭磪囓�2,10,0,10,元大-大天母,2023-01-17,9893
8110,華東,10,0,10,元大-大天母,2023-01-17,9893
00878,國泰永續高股息,9,0,9,元大-大天母,2023-01-17,9893
2484,希華,10,1,9,元大-大天母,2023-01-17,9893
4746,台耀,12,3,9,元大-大天母,2023-01-17,9893
1795,美時,17,8,9,元大-大天母,2023-01-17,9893
2891,中信金,14,5,9,元大-大天母,2023-01-17,9893
2323,中環,10,1,9,元大-大天母,2023-01-17,9893
1312,國喬,6,0,6,元大-大天母,2023-01-17,9893
1560,中砂,8,2,6,元大-大天母,2023-01-17,9893
00795B,中信美國公債20年,6,0,6,元大-大天母,2023-01-17,9893
00676R,富邦臺灣加權反1,6,0,6,元大-大天母,2023-01-17,9893
8155,博智,17,11,6,元大-大天母,2023-01-17,9893
3305,昇貿,6,0,6,元大-大天母,2023-01-17,9893
006208,富邦台50,5,0,5,元大-大天母,2023-01-17,9893
8046,南電,5,0,5,元大-大天母,2023-01-17,9893
1527,鑽全,5,0,5,元大-大天母,2023-01-17,9893
00878,國泰永續高股息,195,90,105,元大-大天母,2023-01-30,9893
5309,系統電,100,0,100,元大-大天母,2023-01-30,9893
00830,國泰費城半導體,80,1,79,元大-大天母,2023-01-30,9893
00632R,元大台灣50反1,90,15,75,元大-大天母,2023-01-30,9893
2436,偉詮電,52,0,52,元大-大天母,2023-01-30,9893
2520,冠德,51,0,51,元大-大天母,2023-01-30,9893
1409,新纖,50,0,50,元大-大天母,2023-01-30,9893
2354,鴻準,52,3,49,元大-大天母,2023-01-30,9893
2748,雲品,100,60,40,元大-大天母,2023-01-30,9893
9933,中鼎,42,2,40,元大-大天母,2023-01-30,9893
3447,展達,40,1,39,元大-大天母,2023-01-30,9893
2317,鴻海,53,18,35,元大-大天母,2023-01-30,9893
2376,技嘉,107,75,32,元大-大天母,2023-01-30,9893
00676R,富邦臺灣加權反1,32,0,32,元大-大天母,2023-01-30,9893
2408,南亞科,52,20,32,元大-大天母,2023-01-30,9893
4167,松瑞藥,30,0,30,元大-大天母,2023-01-30,9893
2891,中信金,30,3,27,元大-大天母,2023-01-30,9893
8049,晶采,30,4,26,元大-大天母,2023-01-30,9893
6202,盛群,25,0,25,元大-大天母,2023-01-30,9893
8358,金居,43,18,25,元大-大天母,2023-01-30,9893
1309,台達化,20,0,20,元大-大天母,2023-01-30,9893
3532,台勝科,21,1,20,元大-大天母,2023-01-30,9893
2481,強茂,32,14,18,元大-大天母,2023-01-30,9893
2363,矽統,20,2,18,元大-大天母,2023-01-30,9893
4137,麗豐-KY,17,0,17,元大-大天母,2023-01-30,9893
4763,材料-KY,17,1,16,元大-大天母,2023-01-30,9893
6470,宇智,12,0,12,元大-大天母,2023-01-30,9893
8234,新漢,12,0,12,元大-大天母,2023-01-30,9893
00683L,期元大美元指正2,12,0,12,元大-大天母,2023-01-30,9893
1809,中釉,12,0,12,元大-大天母,2023-01-30,9893
3624,光頡,17,6,11,元大-大天母,2023-01-30,9893
1795,美時,15,4,11,元大-大天母,2023-01-30,9893
00673R,期元大S＆P原油反1,11,0,11,元大-大天母,2023-01-30,9893
4162,智擎,10,0,10,元大-大天母,2023-01-30,9893
2312,金寶,10,0,10,元大-大天母,2023-01-30,9893
1711,永光,10,0,10,元大-大天母,2023-01-30,9893
8069,元太,19,9,10,元大-大天母,2023-01-30,9893
00905,FT臺灣Smart,10,0,10,元大-大天母,2023-01-30,9893
1532,勤美,10,0,10,元大-大天母,2023-01-30,9893
6153,嘉聯益,10,0,10,元大-大天母,2023-01-30,9893
3363,上詮,10,0,10,元大-大天母,2023-01-30,9893
3147,大綜,9,0,9,元大-大天母,2023-01-30,9893
2851,中再保,9,0,9,元大-大天母,2023-01-30,9893
6592,和潤企業,10,1,9,元大-大天母,2023-01-30,9893
4919,新唐,23,14,9,元大-大天母,2023-01-30,9893
6182,合晶,11,3,8,元大-大天母,2023-01-30,9893
4768,晶呈科技,10,2,8,元大-大天母,2023-01-30,9893
00679B,元大美債20年,9,1,8,元大-大天母,2023-01-30,9893
8996,高力,8,1,7,元大-大天母,2023-01-30,9893
3305,昇貿,7,0,7,元大-大天母,2023-01-30,9893
2884,玉山金,298,0,298,元大-大天母,2023-01-31,9893
00905,FT臺灣Smart,150,25,125,元大-大天母,2023-01-31,9893
9907,統一實,100,1,99,元大-大天母,2023-01-31,9893
00753L,中信中國50正2,112,22,90,元大-大天母,2023-01-31,9893
00683L,期元大美元指正2,62,0,62,元大-大天母,2023-01-31,9893
00878,國泰永續高股息,94,35,59,元大-大天母,2023-01-31,9893
2330,台積電,62,13,49,元大-大天母,2023-01-31,9893
1101,台泥,45,3,42,元大-大天母,2023-01-31,9893
2892,第一金,48,7,41,元大-大天母,2023-01-31,9893
8358,金居,61,20,41,元大-大天母,2023-01-31,9893
6188,廣明,40,3,37,元大-大天母,2023-01-31,9893
1312,國喬,38,3,35,元大-大天母,2023-01-31,9893
6282,康舒,115,81,34,元大-大天母,2023-01-31,9893
2201,裕隆,152,121,31,元大-大天母,2023-01-31,9893
00665L,富邦�琤肭磪囓�2,30,0,30,元大-大天母,2023-01-31,9893
00673R,期元大S＆P原油反1,40,11,29,元大-大天母,2023-01-31,9893
2354,鴻準,28,1,27,元大-大天母,2023-01-31,9893
2885,元大金,28,2,26,元大-大天母,2023-01-31,9893
006208,富邦台50,26,0,26,元大-大天母,2023-01-31,9893
5347,世界,28,2,26,元大-大天母,2023-01-31,9893
2303,聯電,115,90,25,元大-大天母,2023-01-31,9893
5880,合庫金,24,1,23,元大-大天母,2023-01-31,9893
00679B,元大美債20年,20,0,20,元大-大天母,2023-01-31,9893
3363,上詮,20,0,20,元大-大天母,2023-01-31,9893
8049,晶采,20,0,20,元大-大天母,2023-01-31,9893
00882,中信中國高股息,18,0,18,元大-大天母,2023-01-31,9893
9958,世紀鋼,23,5,18,元大-大天母,2023-01-31,9893
6508,惠光,15,0,15,元大-大天母,2023-01-31,9893
5609,中菲行,15,0,15,元大-大天母,2023-01-31,9893
2328,廣宇,15,1,14,元大-大天母,2023-01-31,9893
3081,聯亞,13,0,13,元大-大天母,2023-01-31,9893
4746,台耀,14,1,13,元大-大天母,2023-01-31,9893
00633L,富邦上証正2,13,0,13,元大-大天母,2023-01-31,9893
9939,宏全,14,1,13,元大-大天母,2023-01-31,9893
4979,華星光,43,30,13,元大-大天母,2023-01-31,9893
2412,中華電,17,5,12,元大-大天母,2023-01-31,9893
6122,擎邦,12,1,11,元大-大天母,2023-01-31,9893
1104,環泥,10,0,10,元大-大天母,2023-01-31,9893
2474,可成,10,0,10,元大-大天母,2023-01-31,9893
2023,燁輝,10,0,10,元大-大天母,2023-01-31,9893
2727,王品,10,0,10,元大-大天母,2023-01-31,9893
6245,立端,15,5,10,元大-大天母,2023-01-31,9893
8150,南茂,10,1,9,元大-大天母,2023-01-31,9893
1218,泰山,10,1,9,元大-大天母,2023-01-31,9893
6155,鈞寶,9,0,9,元大-大天母,2023-01-31,9893
2482,連宇,37,28,9,元大-大天母,2023-01-31,9893
2415,錩新,14,5,9,元大-大天母,2023-01-31,9893
8038,長園科,11,2,9,元大-大天母,2023-01-31,9893
2615,萬海,13,4,9,元大-大天母,2023-01-31,9893
00885,富邦越南,8,0,8,元大-大天母,2023-01-31,9893
2515,中工,300,0,300,元大-大天母,2023-02-01,9893
00878,國泰永續高股息,249,10,239,元大-大天母,2023-02-01,9893
2030,彰源,103,1,102,元大-大天母,2023-02-01,9893
5309,系統電,103,4,99,元大-大天母,2023-02-01,9893
2891,中信金,74,6,68,元大-大天母,2023-02-01,9893
2482,連宇,81,14,67,元大-大天母,2023-02-01,9893
2618,長榮航,141,80,61,元大-大天母,2023-02-01,9893
00637L,元大滬深300正2,85,27,58,元大-大天母,2023-02-01,9893
00905,FT臺灣Smart,46,0,46,元大-大天母,2023-02-01,9893
3090,日電貿,40,0,40,元大-大天母,2023-02-01,9893
2610,華航,92,57,35,元大-大天母,2023-02-01,9893
2317,鴻海,35,5,30,元大-大天母,2023-02-01,9893
4720,德淵,28,0,28,元大-大天母,2023-02-01,9893
2002,中鋼,41,16,25,元大-大天母,2023-02-01,9893
6284,佳邦,24,1,23,元大-大天母,2023-02-01,9893
0050,元大台灣50,22,0,22,元大-大天母,2023-02-01,9893
2006,東和鋼鐵,20,0,20,元大-大天母,2023-02-01,9893
00633L,富邦上証正2,50,30,20,元大-大天母,2023-02-01,9893
00642U,期元大S＆P石油,20,0,20,元大-大天母,2023-02-01,9893
8049,晶采,20,0,20,元大-大天母,2023-02-01,9893
5285,界霖,20,3,17,元大-大天母,2023-02-01,9893
4919,新唐,51,34,17,元大-大天母,2023-02-01,9893
3479,安勤,17,1,16,元大-大天母,2023-02-01,9893
2009,第一銅,35,21,14,元大-大天母,2023-02-01,9893
4977,眾達-KY,19,5,14,元大-大天母,2023-02-01,9893
2412,中華電,13,0,13,元大-大天母,2023-02-01,9893
1519,華城,27,14,13,元大-大天母,2023-02-01,9893
6174,安��,12,0,12,元大-大天母,2023-02-01,9893
3704,合勤控,36,24,12,元大-大天母,2023-02-01,9893
8050,廣積,13,1,12,元大-大天母,2023-02-01,9893
1101,台泥,13,2,11,元大-大天母,2023-02-01,9893
00673R,期元大S＆P原油反1,11,0,11,元大-大天母,2023-02-01,9893
2312,金寶,11,0,11,元大-大天母,2023-02-01,9893
1817,凱撒衛,10,0,10,元大-大天母,2023-02-01,9893
00891,中信關鍵半導體,10,0,10,元大-大天母,2023-02-01,9893
5351,鈺創,15,5,10,元大-大天母,2023-02-01,9893
2363,矽統,30,20,10,元大-大天母,2023-02-01,9893
6182,合晶,13,3,10,元大-大天母,2023-02-01,9893
2367,燿華,10,0,10,元大-大天母,2023-02-01,9893
2352,佳世達,10,0,10,元大-大天母,2023-02-01,9893
00665L,富邦�琤肭磪囓�2,10,0,10,元大-大天母,2023-02-01,9893
4175,杏一,10,0,10,元大-大天母,2023-02-01,9893
00679B,元大美債20年,10,0,10,元大-大天母,2023-02-01,9893
2415,錩新,9,0,9,元大-大天母,2023-02-01,9893
6244,茂迪,9,0,9,元大-大天母,2023-02-01,9893
4164,承業醫,14,5,9,元大-大天母,2023-02-01,9893
6155,鈞寶,9,0,9,元大-大天母,2023-02-01,9893
3481,群創,9,0,9,元大-大天母,2023-02-01,9893
9933,中鼎,10,2,8,元大-大天母,2023-02-01,9893
8478,東哥遊艇,17,9,8,元大-大天母,2023-02-01,9893
2344,華邦電,784,209,575,元大-大天母,2023-02-02,9893
00878,國泰永續高股息,412,74,338,元大-大天母,2023-02-02,9893
00665L,富邦�琤肭磪囓�2,140,0,140,元大-大天母,2023-02-02,9893
00632R,元大台灣50反1,160,40,120,元大-大天母,2023-02-02,9893
2006,東和鋼鐵,77,0,77,元大-大天母,2023-02-02,9893
5351,鈺創,101,31,70,元大-大天母,2023-02-02,9893
00688L,國泰20年美債正2,61,0,61,元大-大天母,2023-02-02,9893
5603,陸海,50,0,50,元大-大天母,2023-02-02,9893
1409,新纖,50,0,50,元大-大天母,2023-02-02,9893
6104,創惟,62,15,47,元大-大天母,2023-02-02,9893
00715L,期街口布蘭特正2,44,0,44,元大-大天母,2023-02-02,9893
3048,益登,44,1,43,元大-大天母,2023-02-02,9893
3122,笙泉,40,0,40,元大-大天母,2023-02-02,9893
5425,台半,36,6,30,元大-大天母,2023-02-02,9893
1809,中釉,27,0,27,元大-大天母,2023-02-02,9893
2618,長榮航,48,23,25,元大-大天母,2023-02-02,9893
2376,技嘉,25,1,24,元大-大天母,2023-02-02,9893
2367,燿華,21,0,21,元大-大天母,2023-02-02,9893
00676R,富邦臺灣加權反1,20,0,20,元大-大天母,2023-02-02,9893
5258,虹堡,28,8,20,元大-大天母,2023-02-02,9893
2347,聯強,20,0,20,元大-大天母,2023-02-02,9893
6546,正基,24,6,18,元大-大天母,2023-02-02,9893
0050,元大台灣50,24,6,18,元大-大天母,2023-02-02,9893
00679B,元大美債20年,16,0,16,元大-大天母,2023-02-02,9893
2317,鴻海,17,2,15,元大-大天母,2023-02-02,9893
8038,長園科,17,2,15,元大-大天母,2023-02-02,9893
6188,廣明,15,0,15,元大-大天母,2023-02-02,9893
2888,新光金,14,0,14,元大-大天母,2023-02-02,9893
1612,宏泰,14,0,14,元大-大天母,2023-02-02,9893
6239,力成,17,3,14,元大-大天母,2023-02-02,9893
2884,玉山金,13,0,13,元大-大天母,2023-02-02,9893
5285,界霖,13,0,13,元大-大天母,2023-02-02,9893
3624,光頡,13,0,13,元大-大天母,2023-02-02,9893
2371,大同,12,0,12,元大-大天母,2023-02-02,9893
3189,景碩,13,1,12,元大-大天母,2023-02-02,9893
9933,中鼎,15,3,12,元大-大天母,2023-02-02,9893
6609,瀧澤科,13,2,11,元大-大天母,2023-02-02,9893
6278,台表科,31,20,11,元大-大天母,2023-02-02,9893
8436,大江,10,0,10,元大-大天母,2023-02-02,9893
3162,精確,20,10,10,元大-大天母,2023-02-02,9893
9958,世紀鋼,10,0,10,元大-大天母,2023-02-02,9893
4114,健喬,13,3,10,元大-大天母,2023-02-02,9893
2540,愛山林,10,0,10,元大-大天母,2023-02-02,9893
2492,華新科,20,10,10,元大-大天母,2023-02-02,9893
6155,鈞寶,10,0,10,元大-大天母,2023-02-02,9893
4167,松瑞藥,10,0,10,元大-大天母,2023-02-02,9893
3419,譁裕,10,0,10,元大-大天母,2023-02-02,9893
3062,建漢,10,0,10,元大-大天母,2023-02-02,9893
2945,三商家購,9,0,9,元大-大天母,2023-02-02,9893
1519,華城,30,21,9,元大-大天母,2023-02-02,9893
00753L,中信中國50正2,122,0,122,元大-大天母,2023-02-03,9893
2882,國泰金,130,15,115,元大-大天母,2023-02-03,9893
00900,富邦特選高股息30,104,2,102,元大-大天母,2023-02-03,9893
5309,系統電,102,2,100,元大-大天母,2023-02-03,9893
2834,臺企銀,100,2,98,元大-大天母,2023-02-03,9893
2103,台橡,90,0,90,元大-大天母,2023-02-03,9893
00665L,富邦�琤肭磪囓�2,80,0,80,元大-大天母,2023-02-03,9893
8049,晶采,70,0,70,元大-大天母,2023-02-03,9893
3033,威健,70,0,70,元大-大天母,2023-02-03,9893
00688L,國泰20年美債正2,60,0,60,元大-大天母,2023-02-03,9893
1409,新纖,60,1,59,元大-大天母,2023-02-03,9893
2609,陽明,92,35,57,元大-大天母,2023-02-03,9893
2413,環科,75,18,57,元大-大天母,2023-02-03,9893
3048,益登,55,2,53,元大-大天母,2023-02-03,9893
00632R,元大台灣50反1,52,0,52,元大-大天母,2023-02-03,9893
9105,泰金寶-DR,50,5,45,元大-大天母,2023-02-03,9893
2344,華邦電,80,37,43,元大-大天母,2023-02-03,9893
2484,希華,49,6,43,元大-大天母,2023-02-03,9893
3037,欣興,49,8,41,元大-大天母,2023-02-03,9893
2481,強茂,58,18,40,元大-大天母,2023-02-03,9893
00715L,期街口布蘭特正2,36,3,33,元大-大天母,2023-02-03,9893
3701,大眾控,35,4,31,元大-大天母,2023-02-03,9893
2352,佳世達,32,3,29,元大-大天母,2023-02-03,9893
00720B,元大投資級公司債,29,0,29,元大-大天母,2023-02-03,9893
00633L,富邦上証正2,27,0,27,元大-大天母,2023-02-03,9893
00905,FT臺灣Smart,26,0,26,元大-大天母,2023-02-03,9893
2891,中信金,26,1,25,元大-大天母,2023-02-03,9893
2614,東森,32,7,25,元大-大天母,2023-02-03,9893
4167,松瑞藥,35,10,25,元大-大天母,2023-02-03,9893
2206,三陽工業,25,0,25,元大-大天母,2023-02-03,9893
2603,長榮,144,119,25,元大-大天母,2023-02-03,9893
2108,南帝,24,0,24,元大-大天母,2023-02-03,9893
2498,宏達電,63,40,23,元大-大天母,2023-02-03,9893
00882,中信中國高股息,49,27,22,元大-大天母,2023-02-03,9893
2002,中鋼,27,5,22,元大-大天母,2023-02-03,9893
3021,鴻名,33,11,22,元大-大天母,2023-02-03,9893
9939,宏全,22,0,22,元大-大天母,2023-02-03,9893
2618,長榮航,53,31,22,元大-大天母,2023-02-03,9893
2363,矽統,20,0,20,元大-大天母,2023-02-03,9893
1806,冠軍,20,0,20,元大-大天母,2023-02-03,9893
00878,國泰永續高股息,99,79,20,元大-大天母,2023-02-03,9893
2883,凱基金,19,0,19,元大-大天母,2023-02-03,9893
2615,萬海,23,4,19,元大-大天母,2023-02-03,9893
6806,森崴能源,19,0,19,元大-大天母,2023-02-03,9893
3141,晶宏,24,8,16,元大-大天母,2023-02-03,9893
2201,裕隆,22,6,16,元大-大天母,2023-02-03,9893
6789,采鈺,16,1,15,元大-大天母,2023-02-03,9893
3128,昇銳,14,0,14,元大-大天母,2023-02-03,9893
3041,揚智,16,2,14,元大-大天母,2023-02-03,9893
4114,健喬,17,3,14,元大-大天母,2023-02-03,9893
00878,國泰永續高股息,224,6,218,元大-大天母,2023-02-06,9893
1809,中釉,202,3,199,元大-大天母,2023-02-06,9893
1718,中纖,150,0,150,元大-大天母,2023-02-06,9893
00701,國泰股利精選30,121,0,121,元大-大天母,2023-02-06,9893
2303,聯電,141,25,116,元大-大天母,2023-02-06,9893
5284,jpp-KY,100,0,100,元大-大天母,2023-02-06,9893
3224,三顧,100,0,100,元大-大天母,2023-02-06,9893
1795,美時,73,17,56,元大-大天母,2023-02-06,9893
9105,泰金寶-DR,54,1,53,元大-大天母,2023-02-06,9893
2888,新光金,46,1,45,元大-大天母,2023-02-06,9893
00637L,元大滬深300正2,42,0,42,元大-大天母,2023-02-06,9893
00665L,富邦�琤肭磪囓�2,40,0,40,元大-大天母,2023-02-06,9893
2103,台橡,40,0,40,元大-大天母,2023-02-06,9893
00882,中信中國高股息,38,1,37,元大-大天母,2023-02-06,9893
00753L,中信中國50正2,32,1,31,元大-大天母,2023-02-06,9893
2330,台積電,33,3,30,元大-大天母,2023-02-06,9893
3701,大眾控,29,1,28,元大-大天母,2023-02-06,9893
1720,生達,33,5,28,元大-大天母,2023-02-06,9893
3163,波若威,30,4,26,元大-大天母,2023-02-06,9893
6284,佳邦,26,0,26,元大-大天母,2023-02-06,9893
2105,正新,25,0,25,元大-大天母,2023-02-06,9893
00683L,期元大美元指正2,25,0,25,元大-大天母,2023-02-06,9893
00919,群益台灣精選高息,25,0,25,元大-大天母,2023-02-06,9893
2413,環科,23,0,23,元大-大天母,2023-02-06,9893
9958,世紀鋼,23,1,22,元大-大天母,2023-02-06,9893
00715L,期街口布蘭特正2,22,0,22,元大-大天母,2023-02-06,9893
6133,金橋,25,3,22,元大-大天母,2023-02-06,9893
6155,鈞寶,29,7,22,元大-大天母,2023-02-06,9893
2609,陽明,23,2,21,元大-大天母,2023-02-06,9893
2347,聯強,20,0,20,元大-大天母,2023-02-06,9893
2201,裕隆,21,1,20,元大-大天母,2023-02-06,9893
2882,國泰金,25,5,20,元大-大天母,2023-02-06,9893
3118,進階,18,0,18,元大-大天母,2023-02-06,9893
2892,第一金,21,3,18,元大-大天母,2023-02-06,9893
1605,華新,33,16,17,元大-大天母,2023-02-06,9893
00679B,元大美債20年,16,0,16,元大-大天母,2023-02-06,9893
2634,漢翔,31,15,16,元大-大天母,2023-02-06,9893
5009,榮剛,16,0,16,元大-大天母,2023-02-06,9893
00633L,富邦上証正2,15,0,15,元大-大天母,2023-02-06,9893
1236,宏亞,15,0,15,元大-大天母,2023-02-06,9893
6165,浪凡,15,0,15,元大-大天母,2023-02-06,9893
8069,元太,20,5,15,元大-大天母,2023-02-06,9893
1101,台泥,20,6,14,元大-大天母,2023-02-06,9893
2368,金像電,16,2,14,元大-大天母,2023-02-06,9893
6245,立端,16,3,13,元大-大天母,2023-02-06,9893
1785,光洋科,15,2,13,元大-大天母,2023-02-06,9893
2002,中鋼,12,0,12,元大-大天母,2023-02-06,9893
5529,鉅陞,12,0,12,元大-大天母,2023-02-06,9893
8358,金居,17,5,12,元大-大天母,2023-02-06,9893
00680L,元大美債20正2,11,0,11,元大-大天母,2023-02-06,9893
00715L,期街口布蘭特正2,412,0,412,元大-大天母,2023-02-07,9893
2353,宏��,316,4,312,元大-大天母,2023-02-07,9893
1305,華夏,174,0,174,元大-大天母,2023-02-07,9893
8049,晶采,70,0,70,元大-大天母,2023-02-07,9893
1718,中纖,60,0,60,元大-大天母,2023-02-07,9893
00701,國泰股利精選30,60,0,60,元大-大天母,2023-02-07,9893
2610,華航,58,4,54,元大-大天母,2023-02-07,9893
1752,南光,67,17,50,元大-大天母,2023-02-07,9893
00683L,期元大美元指正2,47,0,47,元大-大天母,2023-02-07,9893
6411,晶焱,48,1,47,元大-大天母,2023-02-07,9893
1605,華新,52,8,44,元大-大天母,2023-02-07,9893
9105,泰金寶-DR,38,2,36,元大-大天母,2023-02-07,9893
00885,富邦越南,35,0,35,元大-大天母,2023-02-07,9893
3447,展達,36,4,32,元大-大天母,2023-02-07,9893
5309,系統電,36,5,31,元大-大天母,2023-02-07,9893
2515,中工,30,0,30,元大-大天母,2023-02-07,9893
1809,中釉,29,1,28,元大-大天母,2023-02-07,9893
2891,中信金,27,0,27,元大-大天母,2023-02-07,9893
6155,鈞寶,23,0,23,元大-大天母,2023-02-07,9893
6188,廣明,20,0,20,元大-大天母,2023-02-07,9893
4979,華星光,28,10,18,元大-大天母,2023-02-07,9893
00679B,元大美債20年,16,0,16,元大-大天母,2023-02-07,9893
2883,凱基金,16,0,16,元大-大天母,2023-02-07,9893
1810,和成,16,0,16,元大-大天母,2023-02-07,9893
4743,合一,23,7,16,元大-大天母,2023-02-07,9893
1308,亞聚,19,3,16,元大-大天母,2023-02-07,9893
2884,玉山金,15,0,15,元大-大天母,2023-02-07,9893
00632R,元大台灣50反1,14,0,14,元大-大天母,2023-02-07,9893
00720B,元大投資級公司債,13,0,13,元大-大天母,2023-02-07,9893
00751B,元大AAA至A公司債,13,0,13,元大-大天母,2023-02-07,9893
9945,潤泰新,14,1,13,元大-大天母,2023-02-07,9893
6104,創惟,16,4,12,元大-大天母,2023-02-07,9893
2436,偉詮電,22,10,12,元大-大天母,2023-02-07,9893
2201,裕隆,21,10,11,元大-大天母,2023-02-07,9893
2634,漢翔,38,27,11,元大-大天母,2023-02-07,9893
3481,群創,39,28,11,元大-大天母,2023-02-07,9893
3037,欣興,12,2,10,元大-大天母,2023-02-07,9893
1717,長興,20,10,10,元大-大天母,2023-02-07,9893
4927,泰鼎-KY,10,0,10,元大-大天母,2023-02-07,9893
1813,寶利徠,10,0,10,元大-大天母,2023-02-07,9893
3033,威健,10,0,10,元大-大天母,2023-02-07,9893
2498,宏達電,17,8,9,元大-大天母,2023-02-07,9893
3141,晶宏,9,0,9,元大-大天母,2023-02-07,9893
1760,寶齡富錦,42,33,9,元大-大天母,2023-02-07,9893
6770,力積電,9,1,8,元大-大天母,2023-02-07,9893
1504,東元,8,0,8,元大-大天母,2023-02-07,9893
4114,健喬,22,14,8,元大-大天母,2023-02-07,9893
00882,中信中國高股息,8,0,8,元大-大天母,2023-02-07,9893
2485,兆赫,8,0,8,元大-大天母,2023-02-07,9893
2243,宏旭-KY,12,4,8,元大-大天母,2023-02-07,9893
6245,立端,299,21,278,元大-大天母,2023-02-08,9893
00878,國泰永續高股息,244,14,230,元大-大天母,2023-02-08,9893
2834,臺企銀,201,0,201,元大-大天母,2023-02-08,9893
2409,友達,212,73,139,元大-大天母,2023-02-08,9893
00895,富邦未來車,107,2,105,元大-大天母,2023-02-08,9893
3447,展達,130,29,101,元大-大天母,2023-02-08,9893
1718,中纖,81,0,81,元大-大天母,2023-02-08,9893
00632R,元大台灣50反1,77,0,77,元大-大天母,2023-02-08,9893
3224,三顧,60,0,60,元大-大天母,2023-02-08,9893
2376,技嘉,68,8,60,元大-大天母,2023-02-08,9893
2884,玉山金,67,11,56,元大-大天母,2023-02-08,9893
4743,合一,64,19,45,元大-大天母,2023-02-08,9893
6411,晶焱,40,3,37,元大-大天母,2023-02-08,9893
1809,中釉,34,0,34,元大-大天母,2023-02-08,9893
00679B,元大美債20年,31,0,31,元大-大天母,2023-02-08,9893
1434,福懋,30,0,30,元大-大天母,2023-02-08,9893
2727,王品,34,6,28,元大-大天母,2023-02-08,9893
00670L,富邦NASDAQ正2,30,3,27,元大-大天母,2023-02-08,9893
00683L,期元大美元指正2,25,0,25,元大-大天母,2023-02-08,9893
3264,欣銓,32,8,24,元大-大天母,2023-02-08,9893
00893,國泰智能電動車,27,3,24,元大-大天母,2023-02-08,9893
6182,合晶,22,0,22,元大-大天母,2023-02-08,9893
3682,亞太電,20,0,20,元大-大天母,2023-02-08,9893
2477,美隆電,20,0,20,元大-大天母,2023-02-08,9893
1584,精剛,23,3,20,元大-大天母,2023-02-08,9893
2317,鴻海,21,2,19,元大-大天母,2023-02-08,9893
8086,宏捷科,22,3,19,元大-大天母,2023-02-08,9893
00772B,中信高評級公司債,18,0,18,元大-大天母,2023-02-08,9893
3706,神達,21,4,17,元大-大天母,2023-02-08,9893
2732,六角,15,0,15,元大-大天母,2023-02-08,9893
2349,錸德,15,0,15,元大-大天母,2023-02-08,9893
1711,永光,15,0,15,元大-大天母,2023-02-08,9893
00753L,中信中國50正2,17,2,15,元大-大天母,2023-02-08,9893
00676R,富邦臺灣加權反1,15,0,15,元大-大天母,2023-02-08,9893
2338,光罩,21,7,14,元大-大天母,2023-02-08,9893
6155,鈞寶,14,0,14,元大-大天母,2023-02-08,9893
2009,第一銅,81,67,14,元大-大天母,2023-02-08,9893
6104,創惟,19,7,12,元大-大天母,2023-02-08,9893
00890B,凱基ESG BBB債,12,0,12,元大-大天母,2023-02-08,9893
3520,華盈,12,0,12,元大-大天母,2023-02-08,9893
8069,元太,13,1,12,元大-大天母,2023-02-08,9893
00637L,元大滬深300正2,12,0,12,元大-大天母,2023-02-08,9893
3189,景碩,11,0,11,元大-大天母,2023-02-08,9893
8105,凌巨,11,0,11,元大-大天母,2023-02-08,9893
3034,聯詠,14,4,10,元大-大天母,2023-02-08,9893
00900,富邦特選高股息30,10,0,10,元大-大天母,2023-02-08,9893
5014,建錩,10,0,10,元大-大天母,2023-02-08,9893
1817,凱撒衛,10,0,10,元大-大天母,2023-02-08,9893
00888,永豐台灣ESG,10,0,10,元大-大天母,2023-02-08,9893
6191,精成科,10,0,10,元大-大天母,2023-02-08,9893
00878,國泰永續高股息,112,13,99,元大-大天母,2023-02-09,9893
2344,華邦電,133,57,76,元大-大天母,2023-02-09,9893
3576,聯合再生,74,0,74,元大-大天母,2023-02-09,9893
6129,普誠,74,18,56,元大-大天母,2023-02-09,9893
1409,新纖,49,1,48,元大-大天母,2023-02-09,9893
2349,錸德,46,0,46,元大-大天母,2023-02-09,9893
6182,合晶,42,1,41,元大-大天母,2023-02-09,9893
00676R,富邦臺灣加權反1,40,0,40,元大-大天母,2023-02-09,9893
3224,三顧,40,0,40,元大-大天母,2023-02-09,9893
4162,智擎,42,6,36,元大-大天母,2023-02-09,9893
3706,神達,34,1,33,元大-大天母,2023-02-09,9893
2603,長榮,34,2,32,元大-大天母,2023-02-09,9893
2801,彰銀,31,0,31,元大-大天母,2023-02-09,9893
1718,中纖,29,0,29,元大-大天母,2023-02-09,9893
3545,敦泰,27,0,27,元大-大天母,2023-02-09,9893
2498,宏達電,43,17,26,元大-大天母,2023-02-09,9893
00683L,期元大美元指正2,23,0,23,元大-大天母,2023-02-09,9893
3710,連展投控,22,0,22,元大-大天母,2023-02-09,9893
4931,新盛力,36,15,21,元大-大天母,2023-02-09,9893
3078,僑威,22,1,21,元大-大天母,2023-02-09,9893
4167,松瑞藥,20,0,20,元大-大天母,2023-02-09,9893
9939,宏全,20,0,20,元大-大天母,2023-02-09,9893
00900,富邦特選高股息30,20,0,20,元大-大天母,2023-02-09,9893
00637L,元大滬深300正2,20,3,17,元大-大天母,2023-02-09,9893
6531,愛普*,25,9,16,元大-大天母,2023-02-09,9893
6435,大中,15,0,15,元大-大天母,2023-02-09,9893
6411,晶焱,20,5,15,元大-大天母,2023-02-09,9893
0056,元大高股息,16,1,15,元大-大天母,2023-02-09,9893
2748,雲品,54,40,14,元大-大天母,2023-02-09,9893
5203,訊連,20,8,12,元大-大天母,2023-02-09,9893
3037,欣興,12,1,11,元大-大天母,2023-02-09,9893
2408,南亞科,11,0,11,元大-大天母,2023-02-09,9893
5014,建錩,11,0,11,元大-大天母,2023-02-09,9893
2404,漢唐,11,0,11,元大-大天母,2023-02-09,9893
00679B,元大美債20年,11,0,11,元大-大天母,2023-02-09,9893
6235,華孚,90,79,11,元大-大天母,2023-02-09,9893
6165,浪凡,10,0,10,元大-大天母,2023-02-09,9893
1519,華城,12,2,10,元大-大天母,2023-02-09,9893
1721,三晃,10,0,10,元大-大天母,2023-02-09,9893
2477,美隆電,10,0,10,元大-大天母,2023-02-09,9893
6770,力積電,10,0,10,元大-大天母,2023-02-09,9893
6143,振曜,9,0,9,元大-大天母,2023-02-09,9893
1514,亞力,11,2,9,元大-大天母,2023-02-09,9893
6245,立端,35,26,9,元大-大天母,2023-02-09,9893
6138,茂達,11,3,8,元大-大天母,2023-02-09,9893
6589,台康生技,11,3,8,元大-大天母,2023-02-09,9893
00713,元大台灣高息低波,10,2,8,元大-大天母,2023-02-09,9893
2945,三商家購,8,0,8,元大-大天母,2023-02-09,9893
5340,建榮,11,3,8,元大-大天母,2023-02-09,9893
5607,遠雄港,8,0,8,元大-大天母,2023-02-09,9893
6245,立端,245,26,219,元大-大天母,2023-02-10,9893
00878,國泰永續高股息,194,52,142,元大-大天母,2023-02-10,9893
6770,力積電,84,1,83,元大-大天母,2023-02-10,9893
2618,長榮航,81,15,66,元大-大天母,2023-02-10,9893
2006,東和鋼鐵,62,0,62,元大-大天母,2023-02-10,9893
2498,宏達電,77,18,59,元大-大天母,2023-02-10,9893
3447,展達,62,4,58,元大-大天母,2023-02-10,9893
2344,華邦電,85,30,55,元大-大天母,2023-02-10,9893
1437,勤益控,61,6,55,元大-大天母,2023-02-10,9893
3048,益登,45,0,45,元大-大天母,2023-02-10,9893
3682,亞太電,40,0,40,元大-大天母,2023-02-10,9893
2881,富邦金,50,12,38,元大-大天母,2023-02-10,9893
2610,華航,51,13,38,元大-大天母,2023-02-10,9893
2201,裕隆,51,15,36,元大-大天母,2023-02-10,9893
4137,麗豐-KY,30,0,30,元大-大天母,2023-02-10,9893
8150,南茂,30,0,30,元大-大天母,2023-02-10,9893
1605,華新,47,21,26,元大-大天母,2023-02-10,9893
00893,國泰智能電動車,27,2,25,元大-大天母,2023-02-10,9893
2748,雲品,25,0,25,元大-大天母,2023-02-10,9893
6830,汎銓,20,0,20,元大-大天母,2023-02-10,9893
1434,福懋,20,0,20,元大-大天母,2023-02-10,9893
3034,聯詠,22,3,19,元大-大天母,2023-02-10,9893
3479,安勤,45,26,19,元大-大天母,2023-02-10,9893
1809,中釉,19,0,19,元大-大天母,2023-02-10,9893
1101,台泥,23,5,18,元大-大天母,2023-02-10,9893
8358,金居,18,0,18,元大-大天母,2023-02-10,9893
4931,新盛力,24,7,17,元大-大天母,2023-02-10,9893
2413,環科,20,3,17,元大-大天母,2023-02-10,9893
1519,華城,18,1,17,元大-大天母,2023-02-10,9893
6443,元晶,40,24,16,元大-大天母,2023-02-10,9893
2603,長榮,29,14,15,元大-大天母,2023-02-10,9893
4167,松瑞藥,15,0,15,元大-大天母,2023-02-10,9893
8420,明揚,15,0,15,元大-大天母,2023-02-10,9893
5609,中菲行,15,0,15,元大-大天母,2023-02-10,9893
0056,元大高股息,15,2,13,元大-大天母,2023-02-10,9893
1312,國喬,13,0,13,元大-大天母,2023-02-10,9893
1514,亞力,13,0,13,元大-大天母,2023-02-10,9893
6285,啟��,17,4,13,元大-大天母,2023-02-10,9893
3037,欣興,18,6,12,元大-大天母,2023-02-10,9893
5014,建錩,12,0,12,元大-大天母,2023-02-10,9893
2882,國泰金,12,0,12,元大-大天母,2023-02-10,9893
00900,富邦特選高股息30,12,0,12,元大-大天母,2023-02-10,9893
2409,友達,14,3,11,元大-大天母,2023-02-10,9893
5258,虹堡,13,2,11,元大-大天母,2023-02-10,9893
2009,第一銅,11,0,11,元大-大天母,2023-02-10,9893
2888,新光金,13,2,11,元大-大天母,2023-02-10,9893
3141,晶宏,10,0,10,元大-大天母,2023-02-10,9893
2520,冠德,10,0,10,元大-大天母,2023-02-10,9893
6477,安集,10,0,10,元大-大天母,2023-02-10,9893
3432,台端,10,0,10,元大-大天母,2023-02-10,9893
00878,國泰永續高股息,189,36,153,元大-大天母,2023-02-13,9893
2303,聯電,98,18,80,元大-大天母,2023-02-13,9893
3078,僑威,79,0,79,元大-大天母,2023-02-13,9893
2610,華航,53,1,52,元大-大天母,2023-02-13,9893
00900,富邦特選高股息30,51,8,43,元大-大天母,2023-02-13,9893
6770,力積電,46,6,40,元大-大天母,2023-02-13,9893
1809,中釉,39,0,39,元大-大天母,2023-02-13,9893
00885,富邦越南,32,0,32,元大-大天母,2023-02-13,9893
00679B,元大美債20年,28,0,28,元大-大天母,2023-02-13,9893
2201,裕隆,31,7,24,元大-大天母,2023-02-13,9893
3207,耀勝,37,13,24,元大-大天母,2023-02-13,9893
00772B,中信高評級公司債,24,0,24,元大-大天母,2023-02-13,9893
8071,能率網通,25,2,23,元大-大天母,2023-02-13,9893
2347,聯強,21,0,21,元大-大天母,2023-02-13,9893
0056,元大高股息,24,4,20,元大-大天母,2023-02-13,9893
3591,艾笛森,21,1,20,元大-大天母,2023-02-13,9893
2376,技嘉,22,2,20,元大-大天母,2023-02-13,9893
3037,欣興,24,5,19,元大-大天母,2023-02-13,9893
2618,長榮航,22,4,18,元大-大天母,2023-02-13,9893
1605,華新,20,3,17,元大-大天母,2023-02-13,9893
6235,華孚,22,5,17,元大-大天母,2023-02-13,9893
2890,永豐金,17,0,17,元大-大天母,2023-02-13,9893
2880,華南金,16,0,16,元大-大天母,2023-02-13,9893
6589,台康生技,17,1,16,元大-大天母,2023-02-13,9893
2634,漢翔,24,9,15,元大-大天母,2023-02-13,9893
5608,四維航,16,1,15,元大-大天母,2023-02-13,9893
8044,網家,15,0,15,元大-大天母,2023-02-13,9893
5353,台林,14,0,14,元大-大天母,2023-02-13,9893
00680L,元大美債20正2,13,0,13,元大-大天母,2023-02-13,9893
3455,由田,13,0,13,元大-大天母,2023-02-13,9893
2605,新興,12,0,12,元大-大天母,2023-02-13,9893
2603,長榮,19,8,11,元大-大天母,2023-02-13,9893
3481,群創,11,0,11,元大-大天母,2023-02-13,9893
5529,鉅陞,11,0,11,元大-大天母,2023-02-13,9893
5347,世界,11,0,11,元大-大天母,2023-02-13,9893
2867,三商壽,11,0,11,元大-大天母,2023-02-13,9893
1734,杏輝,10,0,10,元大-大天母,2023-02-13,9893
3705,永信,10,0,10,元大-大天母,2023-02-13,9893
3232,昱捷,10,0,10,元大-大天母,2023-02-13,9893
2413,環科,10,0,10,元大-大天母,2023-02-13,9893
00665L,富邦�琤肭磪囓�2,10,0,10,元大-大天母,2023-02-13,9893
2945,三商家購,10,0,10,元大-大天母,2023-02-13,9893
5009,榮剛,10,0,10,元大-大天母,2023-02-13,9893
3149,正達,10,0,10,元大-大天母,2023-02-13,9893
8069,元太,16,6,10,元大-大天母,2023-02-13,9893
3374,精材,9,0,9,元大-大天母,2023-02-13,9893
1795,美時,46,37,9,元大-大天母,2023-02-13,9893
3624,光頡,13,4,9,元大-大天母,2023-02-13,9893
2328,廣宇,10,1,9,元大-大天母,2023-02-13,9893
5315,光聯,10,1,9,元大-大天母,2023-02-13,9893
2731,雄獅,113,1,112,元大-大天母,2023-02-14,9893
5284,jpp-KY,104,0,104,元大-大天母,2023-02-14,9893
2031,新光鋼,105,5,100,元大-大天母,2023-02-14,9893
8105,凌巨,100,10,90,元大-大天母,2023-02-14,9893
00673R,期元大S＆P原油反1,83,0,83,元大-大天母,2023-02-14,9893
00632R,元大台灣50反1,79,5,74,元大-大天母,2023-02-14,9893
00648R,元大S＆P500反1,50,0,50,元大-大天母,2023-02-14,9893
6290,良維,52,7,45,元大-大天母,2023-02-14,9893
1513,中興電,45,5,40,元大-大天母,2023-02-14,9893
00753L,中信中國50正2,34,9,25,元大-大天母,2023-02-14,9893
6443,元晶,21,0,21,元大-大天母,2023-02-14,9893
6806,森崴能源,21,0,21,元大-大天母,2023-02-14,9893
2010,春源,20,0,20,元大-大天母,2023-02-14,9893
3682,亞太電,20,0,20,元大-大天母,2023-02-14,9893
1434,福懋,20,0,20,元大-大天母,2023-02-14,9893
2453,凌群,45,27,18,元大-大天母,2023-02-14,9893
3042,晶技,18,0,18,元大-大天母,2023-02-14,9893
3022,威強電,21,4,17,元大-大天母,2023-02-14,9893
1605,華新,26,9,17,元大-大天母,2023-02-14,9893
0056,元大高股息,18,2,16,元大-大天母,2023-02-14,9893
1447,力鵬,16,0,16,元大-大天母,2023-02-14,9893
00900,富邦特選高股息30,16,0,16,元大-大天母,2023-02-14,9893
6180,橘子,33,18,15,元大-大天母,2023-02-14,9893
4974,亞泰,15,0,15,元大-大天母,2023-02-14,9893
3324,雙鴻,20,5,15,元大-大天母,2023-02-14,9893
2344,華邦電,24,10,14,元大-大天母,2023-02-14,9893
2603,長榮,30,16,14,元大-大天母,2023-02-14,9893
8284,三竹,12,0,12,元大-大天母,2023-02-14,9893
2834,臺企銀,16,4,12,元大-大天母,2023-02-14,9893
2338,光罩,12,0,12,元大-大天母,2023-02-14,9893
4114,健喬,19,7,12,元大-大天母,2023-02-14,9893
2888,新光金,16,4,12,元大-大天母,2023-02-14,9893
00882,中信中國高股息,11,0,11,元大-大天母,2023-02-14,9893
2324,仁寶,11,0,11,元大-大天母,2023-02-14,9893
2615,萬海,12,1,11,元大-大天母,2023-02-14,9893
00676R,富邦臺灣加權反1,10,0,10,元大-大天母,2023-02-14,9893
5351,鈺創,16,6,10,元大-大天母,2023-02-14,9893
6288,聯嘉,10,0,10,元大-大天母,2023-02-14,9893
2945,三商家購,10,0,10,元大-大天母,2023-02-14,9893
00665L,富邦�琤肭磪囓�2,10,0,10,元大-大天母,2023-02-14,9893
1402,遠東新,10,0,10,元大-大天母,2023-02-14,9893
5512,力麒,10,0,10,元大-大天母,2023-02-14,9893
00680L,元大美債20正2,10,0,10,元大-大天母,2023-02-14,9893
6123,上奇,9,0,9,元大-大天母,2023-02-14,9893
2371,大同,9,0,9,元大-大天母,2023-02-14,9893
2009,第一銅,19,10,9,元大-大天母,2023-02-14,9893
6541,泰福-KY,18,9,9,元大-大天母,2023-02-14,9893
3260,威剛,12,3,9,元大-大天母,2023-02-14,9893
3479,安勤,57,48,9,元大-大天母,2023-02-14,9893
2034,允強,10,1,9,元大-大天母,2023-02-14,9893
2884,玉山金,210,0,210,元大-大天母,2023-02-15,9893
2891,中信金,179,0,179,元大-大天母,2023-02-15,9893
00878,國泰永續高股息,201,30,171,元大-大天母,2023-02-15,9893
00891,中信關鍵半導體,102,0,102,元大-大天母,2023-02-15,9893
2748,雲品,96,9,87,元大-大天母,2023-02-15,9893
00893,國泰智能電動車,120,39,81,元大-大天母,2023-02-15,9893
3027,盛達,75,2,73,元大-大天母,2023-02-15,9893
00892,富邦台灣半導體,61,0,61,元大-大天母,2023-02-15,9893
5347,世界,56,0,56,元大-大天母,2023-02-15,9893
0056,元大高股息,58,6,52,元大-大天母,2023-02-15,9893
00671R,富邦NASDAQ反1,50,0,50,元大-大天母,2023-02-15,9893
3048,益登,50,0,50,元大-大天母,2023-02-15,9893
2031,新光鋼,49,0,49,元大-大天母,2023-02-15,9893
00753L,中信中國50正2,52,10,42,元大-大天母,2023-02-15,9893
00900,富邦特選高股息30,44,2,42,元大-大天母,2023-02-15,9893
2002,中鋼,45,4,41,元大-大天母,2023-02-15,9893
2330,台積電,68,31,37,元大-大天母,2023-02-15,9893
00679B,元大美債20年,37,0,37,元大-大天母,2023-02-15,9893
6188,廣明,42,9,33,元大-大天母,2023-02-15,9893
2618,長榮航,48,18,30,元大-大天母,2023-02-15,9893
2609,陽明,30,1,29,元大-大天母,2023-02-15,9893
3703,欣陸,30,5,25,元大-大天母,2023-02-15,9893
2883,凱基金,25,4,21,元大-大天母,2023-02-15,9893
00665L,富邦�琤肭磪囓�2,21,0,21,元大-大天母,2023-02-15,9893
006208,富邦台50,20,0,20,元大-大天母,2023-02-15,9893
8071,能率網通,21,3,18,元大-大天母,2023-02-15,9893
2743,山富,24,7,17,元大-大天母,2023-02-15,9893
3710,連展投控,23,7,16,元大-大天母,2023-02-15,9893
00692,富邦公司治理,16,0,16,元大-大天母,2023-02-15,9893
1447,力鵬,15,0,15,元大-大天母,2023-02-15,9893
6278,台表科,71,56,15,元大-大天母,2023-02-15,9893
3324,雙鴻,15,0,15,元大-大天母,2023-02-15,9893
2731,雄獅,24,9,15,元大-大天母,2023-02-15,9893
2520,冠德,13,0,13,元大-大天母,2023-02-15,9893
5009,榮剛,23,10,13,元大-大天母,2023-02-15,9893
00882,中信中國高股息,13,0,13,元大-大天母,2023-02-15,9893
2371,大同,21,8,13,元大-大天母,2023-02-15,9893
5905,南仁湖,13,1,12,元大-大天母,2023-02-15,9893
2880,華南金,11,0,11,元大-大天母,2023-02-15,9893
2344,華邦電,12,1,11,元大-大天母,2023-02-15,9893
0050,元大台灣50,10,0,10,元大-大天母,2023-02-15,9893
2753,八方雲集,10,0,10,元大-大天母,2023-02-15,9893
4923,力士,10,0,10,元大-大天母,2023-02-15,9893
4977,眾達-KY,11,1,10,元大-大天母,2023-02-15,9893
4967,十銓,10,0,10,元大-大天母,2023-02-15,9893
6150,撼訊,10,0,10,元大-大天母,2023-02-15,9893
6101,寬魚國際,10,0,10,元大-大天母,2023-02-15,9893
8033,雷虎,12,3,9,元大-大天母,2023-02-15,9893
6142,友勁,9,0,9,元大-大天母,2023-02-15,9893
5258,虹堡,12,3,9,元大-大天母,2023-02-15,9893
2889,國票金,298,0,298,元大-大天母,2023-02-16,9893
2834,臺企銀,129,0,129,元大-大天母,2023-02-16,9893
00878,國泰永續高股息,125,4,121,元大-大天母,2023-02-16,9893
2031,新光鋼,101,0,101,元大-大天母,2023-02-16,9893
2888,新光金,56,2,54,元大-大天母,2023-02-16,9893
00671R,富邦NASDAQ反1,53,0,53,元大-大天母,2023-02-16,9893
8069,元太,87,37,50,元大-大天母,2023-02-16,9893
00679B,元大美債20年,42,0,42,元大-大天母,2023-02-16,9893
2707,晶華,42,3,39,元大-大天母,2023-02-16,9893
1101,台泥,39,1,38,元大-大天母,2023-02-16,9893
00641R,富邦日本反1,30,0,30,元大-大天母,2023-02-16,9893
3591,艾笛森,30,0,30,元大-大天母,2023-02-16,9893
6411,晶焱,31,2,29,元大-大天母,2023-02-16,9893
2641,正德,21,0,21,元大-大天母,2023-02-16,9893
2520,冠德,20,0,20,元大-大天母,2023-02-16,9893
2885,元大金,16,0,16,元大-大天母,2023-02-16,9893
2427,三商電,15,0,15,元大-大天母,2023-02-16,9893
4979,華星光,21,8,13,元大-大天母,2023-02-16,9893
2609,陽明,17,4,13,元大-大天母,2023-02-16,9893
6672,騰輝電子-KY,12,0,12,元大-大天母,2023-02-16,9893
3264,欣銓,12,0,12,元大-大天母,2023-02-16,9893
00720B,元大投資級公司債,11,0,11,元大-大天母,2023-02-16,9893
2230,泰茂,11,0,11,元大-大天母,2023-02-16,9893
3231,緯創,12,1,11,元大-大天母,2023-02-16,9893
8071,能率網通,16,5,11,元大-大天母,2023-02-16,9893
3530,晶相光,11,0,11,元大-大天母,2023-02-16,9893
3479,安勤,13,3,10,元大-大天母,2023-02-16,9893
8112,至上,10,0,10,元大-大天母,2023-02-16,9893
2027,大成鋼,21,11,10,元大-大天母,2023-02-16,9893
2618,長榮航,118,108,10,元大-大天母,2023-02-16,9893
00676R,富邦臺灣加權反1,10,0,10,元大-大天母,2023-02-16,9893
3035,智原,20,10,10,元大-大天母,2023-02-16,9893
00680L,元大美債20正2,10,1,9,元大-大天母,2023-02-16,9893
9933,中鼎,9,0,9,元大-大天母,2023-02-16,9893
6697,東捷資訊,9,0,9,元大-大天母,2023-02-16,9893
2006,東和鋼鐵,9,0,9,元大-大天母,2023-02-16,9893
3624,光頡,18,9,9,元大-大天母,2023-02-16,9893
5371,中光電,30,21,9,元大-大天母,2023-02-16,9893
9105,泰金寶-DR,9,0,9,元大-大天母,2023-02-16,9893
1909,榮成,10,1,9,元大-大天母,2023-02-16,9893
00646,元大S＆P500,9,0,9,元大-大天母,2023-02-16,9893
00885,富邦越南,15,7,8,元大-大天母,2023-02-16,9893
3037,欣興,28,20,8,元大-大天母,2023-02-16,9893
1513,中興電,19,11,8,元大-大天母,2023-02-16,9893
3189,景碩,10,2,8,元大-大天母,2023-02-16,9893
3105,穩懋,8,0,8,元大-大天母,2023-02-16,9893
4958,臻鼎-KY,8,0,8,元大-大天母,2023-02-16,9893
6589,台康生技,8,0,8,元大-大天母,2023-02-16,9893
1701,中化,8,0,8,元大-大天母,2023-02-16,9893
1409,新纖,8,0,8,元大-大天母,2023-02-16,9893
6116,彩晶,208,15,193,元大-大天母,2023-02-17,9893
2610,華航,258,86,172,元大-大天母,2023-02-17,9893
00632R,元大台灣50反1,100,0,100,元大-大天母,2023-02-17,9893
3479,安勤,100,1,99,元大-大天母,2023-02-17,9893
00679B,元大美債20年,65,0,65,元大-大天母,2023-02-17,9893
2031,新光鋼,50,0,50,元大-大天母,2023-02-17,9893
9105,泰金寶-DR,48,0,48,元大-大天母,2023-02-17,9893
2609,陽明,50,3,47,元大-大天母,2023-02-17,9893
2618,長榮航,52,8,44,元大-大天母,2023-02-17,9893
2014,中鴻,48,16,32,元大-大天母,2023-02-17,9893
2605,新興,41,10,31,元大-大天母,2023-02-17,9893
1444,力麗,30,0,30,元大-大天母,2023-02-17,9893
00665L,富邦�琤肭磪囓�2,30,0,30,元大-大天母,2023-02-17,9893
2344,華邦電,89,62,27,元大-大天母,2023-02-17,9893
2705,六福,28,1,27,元大-大天母,2023-02-17,9893
8936,國統,27,0,27,元大-大天母,2023-02-17,9893
00680L,元大美債20正2,26,0,26,元大-大天母,2023-02-17,9893
1514,亞力,31,6,25,元大-大天母,2023-02-17,9893
00753L,中信中國50正2,27,2,25,元大-大天母,2023-02-17,9893
2603,長榮,26,2,24,元大-大天母,2023-02-17,9893
4541,晟田,54,32,22,元大-大天母,2023-02-17,9893
2337,旺宏,23,1,22,元大-大天母,2023-02-17,9893
00637L,元大滬深300正2,22,0,22,元大-大天母,2023-02-17,9893
2312,金寶,20,0,20,元大-大天母,2023-02-17,9893
8222,寶一,26,6,20,元大-大天母,2023-02-17,9893
00706L,期元大S＆P日圓正2,20,0,20,元大-大天母,2023-02-17,9893
5371,中光電,20,1,19,元大-大天母,2023-02-17,9893
8940,新天地,24,5,19,元大-大天母,2023-02-17,9893
0056,元大高股息,18,1,17,元大-大天母,2023-02-17,9893
00654R,富邦印度反1,16,0,16,元大-大天母,2023-02-17,9893
8383,千附,16,0,16,元大-大天母,2023-02-17,9893
4977,眾達-KY,24,8,16,元大-大天母,2023-02-17,9893
4720,德淵,16,0,16,元大-大天母,2023-02-17,9893
6411,晶焱,34,18,16,元大-大天母,2023-02-17,9893
2886,兆豐金,17,2,15,元大-大天母,2023-02-17,9893
1752,南光,15,1,14,元大-大天母,2023-02-17,9893
00724B,群益投資級金融債,14,0,14,元大-大天母,2023-02-17,9893
00715L,期街口布蘭特正2,20,6,14,元大-大天母,2023-02-17,9893
00893,國泰智能電動車,14,0,14,元大-大天母,2023-02-17,9893
3037,欣興,16,3,13,元大-大天母,2023-02-17,9893
2634,漢翔,24,11,13,元大-大天母,2023-02-17,9893
1342,八貫,17,4,13,元大-大天母,2023-02-17,9893
006208,富邦台50,13,0,13,元大-大天母,2023-02-17,9893
8069,元太,12,0,12,元大-大天母,2023-02-17,9893
4919,新唐,13,1,12,元大-大天母,2023-02-17,9893
6271,同欣電,11,0,11,元大-大天母,2023-02-17,9893
00902,中信電池及儲能,11,0,11,元大-大天母,2023-02-17,9893
00891,中信關鍵半導體,10,0,10,元大-大天母,2023-02-17,9893
3661,世芯-KY,21,11,10,元大-大天母,2023-02-17,9893
2444,兆勁,10,0,10,元大-大天母,2023-02-17,9893
3481,群創,427,72,355,元大-大天母,2023-02-20,9893
2313,華通,145,0,145,元大-大天母,2023-02-20,9893
9105,泰金寶-DR,120,0,120,元大-大天母,2023-02-20,9893
3224,三顧,127,7,120,元大-大天母,2023-02-20,9893
2889,國票金,102,0,102,元大-大天母,2023-02-20,9893
1103,嘉泥,91,1,90,元大-大天母,2023-02-20,9893
2610,華航,183,124,59,元大-大天母,2023-02-20,9893
3048,益登,60,4,56,元大-大天母,2023-02-20,9893
2444,兆勁,50,0,50,元大-大天母,2023-02-20,9893
00760B,復華新興企業債,47,0,47,元大-大天母,2023-02-20,9893
2419,仲琦,49,3,46,元大-大天母,2023-02-20,9893
2618,長榮航,104,61,43,元大-大天母,2023-02-20,9893
3576,聯合再生,40,0,40,元大-大天母,2023-02-20,9893
2368,金像電,41,6,35,元大-大天母,2023-02-20,9893
00715L,期街口布蘭特正2,29,0,29,元大-大天母,2023-02-20,9893
1909,榮成,30,1,29,元大-大天母,2023-02-20,9893
1513,中興電,44,16,28,元大-大天母,2023-02-20,9893
00680L,元大美債20正2,27,0,27,元大-大天母,2023-02-20,9893
00679B,元大美債20年,26,0,26,元大-大天母,2023-02-20,9893
00713,元大台灣高息低波,25,2,23,元大-大天母,2023-02-20,9893
2486,一詮,21,0,21,元大-大天母,2023-02-20,9893
1444,力麗,20,0,20,元大-大天母,2023-02-20,9893
2838,聯邦銀,20,0,20,元大-大天母,2023-02-20,9893
5701,劍湖山,20,0,20,元大-大天母,2023-02-20,9893
5371,中光電,20,0,20,元大-大天母,2023-02-20,9893
6697,東捷資訊,19,0,19,元大-大天母,2023-02-20,9893
9958,世紀鋼,21,4,17,元大-大天母,2023-02-20,9893
8358,金居,23,7,16,元大-大天母,2023-02-20,9893
2337,旺宏,20,4,16,元大-大天母,2023-02-20,9893
00669R,國泰美國道瓊反1,15,0,15,元大-大天母,2023-02-20,9893
3521,鴻翊,15,0,15,元大-大天母,2023-02-20,9893
2542,興富發,14,0,14,元大-大天母,2023-02-20,9893
2731,雄獅,21,8,13,元大-大天母,2023-02-20,9893
9103,美德醫療-DR,13,0,13,元大-大天母,2023-02-20,9893
2867,三商壽,12,0,12,元大-大天母,2023-02-20,9893
1101,台泥,16,5,11,元大-大天母,2023-02-20,9893
0056,元大高股息,17,5,12,元大-大天母,2023-02-20,9893
2317,鴻海,20,9,11,元大-大天母,2023-02-20,9893
00637L,元大滬深300正2,22,11,11,元大-大天母,2023-02-20,9893
6741,91APP*-KY,17,7,10,元大-大天母,2023-02-20,9893
4148,全宇生技-KY,10,0,10,元大-大天母,2023-02-20,9893
1519,華城,35,25,10,元大-大天母,2023-02-20,9893
6125,廣運,10,0,10,元大-大天母,2023-02-20,9893
00665L,富邦�琤肭磪囓�2,10,0,10,元大-大天母,2023-02-20,9893
6245,立端,50,40,10,元大-大天母,2023-02-20,9893
8420,明揚,9,0,9,元大-大天母,2023-02-20,9893
2477,美隆電,9,0,9,元大-大天母,2023-02-20,9893
2945,三商家購,9,0,9,元大-大天母,2023-02-20,9893
4536,拓凱,11,2,9,元大-大天母,2023-02-20,9893
6541,泰福-KY,9,0,9,元大-大天母,2023-02-20,9893
6116,彩晶,514,11,503,元大-大天母,2023-02-21,9893
1314,中石化,250,1,249,元大-大天母,2023-02-21,9893
2884,玉山金,285,42,243,元大-大天母,2023-02-21,9893
1305,華夏,165,0,165,元大-大天母,2023-02-21,9893
3594,磐儀,114,17,97,元大-大天母,2023-02-21,9893
5609,中菲行,179,96,83,元大-大天母,2023-02-21,9893
4167,松瑞藥,70,0,70,元大-大天母,2023-02-21,9893
8011,台通,56,0,56,元大-大天母,2023-02-21,9893
2367,燿華,55,2,53,元大-大天母,2023-02-21,9893
2618,長榮航,56,7,49,元大-大天母,2023-02-21,9893
1103,嘉泥,50,1,49,元大-大天母,2023-02-21,9893
1605,華新,56,13,43,元大-大天母,2023-02-21,9893
2027,大成鋼,45,6,39,元大-大天母,2023-02-21,9893
4916,事欣科,43,5,38,元大-大天母,2023-02-21,9893
6153,嘉聯益,38,0,38,元大-大天母,2023-02-21,9893
5512,力麒,39,3,36,元大-大天母,2023-02-21,9893
00878,國泰永續高股息,37,2,35,元大-大天母,2023-02-21,9893
8358,金居,37,3,34,元大-大天母,2023-02-21,9893
1434,福懋,30,0,30,元大-大天母,2023-02-21,9893
2344,華邦電,49,21,28,元大-大天母,2023-02-21,9893
6235,華孚,45,18,27,元大-大天母,2023-02-21,9893
2883,凱基金,29,2,27,元大-大天母,2023-02-21,9893
2201,裕隆,35,10,25,元大-大天母,2023-02-21,9893
3498,陽程,25,0,25,元大-大天母,2023-02-21,9893
5340,建榮,36,13,23,元大-大天母,2023-02-21,9893
1513,中興電,46,25,21,元大-大天母,2023-02-21,9893
2031,新光鋼,20,0,20,元大-大天母,2023-02-21,9893
2371,大同,20,0,20,元大-大天母,2023-02-21,9893
4977,眾達-KY,20,2,18,元大-大天母,2023-02-21,9893
2812,台中銀,18,1,17,元大-大天母,2023-02-21,9893
3508,位速,17,0,17,元大-大天母,2023-02-21,9893
1342,八貫,22,6,16,元大-大天母,2023-02-21,9893
2457,飛宏,32,16,16,元大-大天母,2023-02-21,9893
6669,緯穎,17,2,15,元大-大天母,2023-02-21,9893
2427,三商電,15,0,15,元大-大天母,2023-02-21,9893
2614,東森,16,1,15,元大-大天母,2023-02-21,9893
1810,和成,16,1,15,元大-大天母,2023-02-21,9893
2498,宏達電,33,18,15,元大-大天母,2023-02-21,9893
5905,南仁湖,15,0,15,元大-大天母,2023-02-21,9893
6558,興能高,14,0,14,元大-大天母,2023-02-21,9893
6104,創惟,21,8,13,元大-大天母,2023-02-21,9893
2892,第一金,16,4,12,元大-大天母,2023-02-21,9893
2352,佳世達,12,0,12,元大-大天母,2023-02-21,9893
1612,宏泰,12,1,11,元大-大天母,2023-02-21,9893
00760B,復華新興企業債,11,0,11,元大-大天母,2023-02-21,9893
8044,網家,11,0,11,元大-大天母,2023-02-21,9893
3402,漢科,10,0,10,元大-大天母,2023-02-21,9893
2617,台航,10,0,10,元大-大天母,2023-02-21,9893
00665L,富邦�琤肭磪囓�2,10,0,10,元大-大天母,2023-02-21,9893
4915,致伸,13,3,10,元大-大天母,2023-02-21,9893
00632R,元大台灣50反1,500,0,500,元大-大天母,2023-02-22,9893
2891,中信金,300,31,269,元大-大天母,2023-02-22,9893
2609,陽明,233,13,220,元大-大天母,2023-02-22,9893
2303,聯電,150,20,130,元大-大天母,2023-02-22,9893
00671R,富邦NASDAQ反1,120,0,120,元大-大天母,2023-02-22,9893
1305,華夏,112,1,111,元大-大天母,2023-02-22,9893
6116,彩晶,112,4,108,元大-大天母,2023-02-22,9893
3362,先進光,90,10,80,元大-大天母,2023-02-22,9893
3048,益登,77,0,77,元大-大天母,2023-02-22,9893
2882,國泰金,61,0,61,元大-大天母,2023-02-22,9893
2376,技嘉,60,2,58,元大-大天母,2023-02-22,9893
00878,國泰永續高股息,164,107,57,元大-大天母,2023-02-22,9893
8011,台通,51,0,51,元大-大天母,2023-02-22,9893
6153,嘉聯益,52,2,50,元大-大天母,2023-02-22,9893
3224,三顧,50,2,48,元大-大天母,2023-02-22,9893
6245,立端,49,5,44,元大-大天母,2023-02-22,9893
2618,長榮航,50,8,42,元大-大天母,2023-02-22,9893
4167,松瑞藥,40,0,40,元大-大天母,2023-02-22,9893
2884,玉山金,49,10,39,元大-大天母,2023-02-22,9893
1503,士電,41,3,38,元大-大天母,2023-02-22,9893
9955,佳龍,36,0,36,元大-大天母,2023-02-22,9893
00753L,中信中國50正2,52,17,35,元大-大天母,2023-02-22,9893
2457,飛宏,34,2,32,元大-大天母,2023-02-22,9893
00706L,期元大S＆P日圓正2,30,0,30,元大-大天母,2023-02-22,9893
4956,光鋐,30,0,30,元大-大天母,2023-02-22,9893
1103,嘉泥,30,0,30,元大-大天母,2023-02-22,9893
4977,眾達-KY,30,1,29,元大-大天母,2023-02-22,9893
3035,智原,43,14,29,元大-大天母,2023-02-22,9893
1519,華城,52,28,24,元大-大天母,2023-02-22,9893
00902,中信電池及儲能,24,0,24,元大-大天母,2023-02-22,9893
3037,欣興,27,4,23,元大-大天母,2023-02-22,9893
6715,嘉基,22,1,21,元大-大天母,2023-02-22,9893
2834,臺企銀,28,7,21,元大-大天母,2023-02-22,9893
3594,磐儀,23,3,20,元大-大天母,2023-02-22,9893
8105,凌巨,49,30,19,元大-大天母,2023-02-22,9893
2031,新光鋼,25,6,19,元大-大天母,2023-02-22,9893
1795,美時,30,12,18,元大-大天母,2023-02-22,9893
2485,兆赫,18,0,18,元大-大天母,2023-02-22,9893
2603,長榮,43,26,17,元大-大天母,2023-02-22,9893
1409,新纖,17,0,17,元大-大天母,2023-02-22,9893
8071,能率網通,26,9,17,元大-大天母,2023-02-22,9893
6282,康舒,44,28,16,元大-大天母,2023-02-22,9893
2201,裕隆,18,2,16,元大-大天母,2023-02-22,9893
2468,華經,15,0,15,元大-大天母,2023-02-22,9893
1101,台泥,17,3,14,元大-大天母,2023-02-22,9893
4979,華星光,17,3,14,元大-大天母,2023-02-22,9893
00680L,元大美債20正2,14,0,14,元大-大天母,2023-02-22,9893
2731,雄獅,23,9,14,元大-大天母,2023-02-22,9893
5609,中菲行,101,87,14,元大-大天母,2023-02-22,9893
2344,華邦電,63,50,13,元大-大天母,2023-02-22,9893
00632R,元大台灣50反1,161,0,161,元大-大天母,2023-02-23,9893
8016,矽創,100,0,100,元大-大天母,2023-02-23,9893
1584,精剛,79,7,72,元大-大天母,2023-02-23,9893
2303,聯電,78,10,68,元大-大天母,2023-02-23,9893
2886,兆豐金,61,0,61,元大-大天母,2023-02-23,9893
2892,第一金,72,12,60,元大-大天母,2023-02-23,9893
00907,永豐優息存股,50,0,50,元大-大天母,2023-02-23,9893
5701,劍湖山,50,0,50,元大-大天母,2023-02-23,9893
00905,FT臺灣Smart,50,1,49,元大-大天母,2023-02-23,9893
1444,力麗,82,37,45,元大-大天母,2023-02-23,9893
2409,友達,48,5,43,元大-大天母,2023-02-23,9893
2736,富野,47,7,40,元大-大天母,2023-02-23,9893
00676R,富邦臺灣加權反1,40,0,40,元大-大天母,2023-02-23,9893
2465,麗臺,40,0,40,元大-大天母,2023-02-23,9893
00637L,元大滬深300正2,34,0,34,元大-大天母,2023-02-23,9893
6153,嘉聯益,34,0,34,元大-大天母,2023-02-23,9893
2313,華通,32,0,32,元大-大天母,2023-02-23,9893
6732,昇佳電子,35,4,31,元大-大天母,2023-02-23,9893
5243,乙盛-KY,32,1,31,元大-大天母,2023-02-23,9893
2618,長榮航,34,6,28,元大-大天母,2023-02-23,9893
3481,群創,29,3,26,元大-大天母,2023-02-23,9893
2834,臺企銀,27,2,25,元大-大天母,2023-02-23,9893
4137,麗豐-KY,26,1,25,元大-大天母,2023-02-23,9893
6269,台郡,25,0,25,元大-大天母,2023-02-23,9893
4770,上品,25,0,25,元大-大天母,2023-02-23,9893
3037,欣興,27,3,24,元大-大天母,2023-02-23,9893
2520,冠德,21,0,21,元大-大天母,2023-02-23,9893
8938,明安,26,5,21,元大-大天母,2023-02-23,9893
1103,嘉泥,21,0,21,元大-大天母,2023-02-23,9893
8044,網家,20,0,20,元大-大天母,2023-02-23,9893
3540,曜越,20,0,20,元大-大天母,2023-02-23,9893
8940,新天地,19,0,19,元大-大天母,2023-02-23,9893
6116,彩晶,19,0,19,元大-大天母,2023-02-23,9893
5905,南仁湖,19,0,19,元大-大天母,2023-02-23,9893
3673,TPK-KY,20,1,19,元大-大天母,2023-02-23,9893
2002,中鋼,25,6,19,元大-大天母,2023-02-23,9893
6517,保勝光學,21,3,18,元大-大天母,2023-02-23,9893
00715L,期街口布蘭特正2,16,0,16,元大-大天母,2023-02-23,9893
00751B,元大AAA至A公司債,15,0,15,元大-大天母,2023-02-23,9893
2731,雄獅,17,3,14,元大-大天母,2023-02-23,9893
2610,華航,32,18,14,元大-大天母,2023-02-23,9893
1519,華城,16,3,13,元大-大天母,2023-02-23,9893
5475,德宏,13,0,13,元大-大天母,2023-02-23,9893
5609,中菲行,112,99,13,元大-大天母,2023-02-23,9893
00720B,元大投資級公司債,12,0,12,元大-大天母,2023-02-23,9893
2903,遠百,12,0,12,元大-大天母,2023-02-23,9893
2634,漢翔,15,3,12,元大-大天母,2023-02-23,9893
3380,明泰,21,9,12,元大-大天母,2023-02-23,9893
00772B,中信高評級公司債,11,0,11,元大-大天母,2023-02-23,9893
2881,富邦金,13,2,11,元大-大天母,2023-02-23,9893
2409,友達,302,16,286,元大-大天母,2023-02-24,9893
2605,新興,349,79,270,元大-大天母,2023-02-24,9893
2368,金像電,213,26,187,元大-大天母,2023-02-24,9893
2892,第一金,79,0,79,元大-大天母,2023-02-24,9893
2303,聯電,87,14,73,元大-大天母,2023-02-24,9893
00878,國泰永續高股息,101,30,71,元大-大天母,2023-02-24,9893
3224,三顧,50,0,50,元大-大天母,2023-02-24,9893
00671R,富邦NASDAQ反1,50,0,50,元大-大天母,2023-02-24,9893
4904,遠傳,45,0,45,元大-大天母,2023-02-24,9893
3031,佰鴻,42,0,42,元大-大天母,2023-02-24,9893
1717,長興,40,0,40,元大-大天母,2023-02-24,9893
2618,長榮航,44,5,39,元大-大天母,2023-02-24,9893
6443,元晶,40,1,39,元大-大天母,2023-02-24,9893
5450,南良,40,1,39,元大-大天母,2023-02-24,9893
00637L,元大滬深300正2,58,25,33,元大-大天母,2023-02-24,9893
3037,欣興,49,16,33,元大-大天母,2023-02-24,9893
3362,先進光,40,10,30,元大-大天母,2023-02-24,9893
00676R,富邦臺灣加權反1,30,0,30,元大-大天母,2023-02-24,9893
5469,瀚宇博,30,0,30,元大-大天母,2023-02-24,9893
6153,嘉聯益,30,0,30,元大-大天母,2023-02-24,9893
2317,鴻海,37,7,30,元大-大天母,2023-02-24,9893
1219,福壽,35,6,29,元大-大天母,2023-02-24,9893
2014,中鴻,65,36,29,元大-大天母,2023-02-24,9893
8150,南茂,27,0,27,元大-大天母,2023-02-24,9893
2520,冠德,31,5,26,元大-大天母,2023-02-24,9893
2313,華通,26,0,26,元大-大天母,2023-02-24,9893
3027,盛達,29,3,26,元大-大天母,2023-02-24,9893
5512,力麒,24,0,24,元大-大天母,2023-02-24,9893
00712,復華富時不動產,23,0,23,元大-大天母,2023-02-24,9893
3576,聯合再生,22,0,22,元大-大天母,2023-02-24,9893
2601,益航,28,6,22,元大-大天母,2023-02-24,9893
8033,雷虎,28,7,21,元大-大天母,2023-02-24,9893
1447,力鵬,22,1,21,元大-大天母,2023-02-24,9893
00753L,中信中國50正2,35,15,20,元大-大天母,2023-02-24,9893
3443,創意,21,1,20,元大-大天母,2023-02-24,9893
00632R,元大台灣50反1,110,90,20,元大-大天母,2023-02-24,9893
2610,華航,26,6,20,元大-大天母,2023-02-24,9893
3661,世芯-KY,26,8,18,元大-大天母,2023-02-24,9893
00882,中信中國高股息,18,0,18,元大-大天母,2023-02-24,9893
8215,明基材,20,3,17,元大-大天母,2023-02-24,9893
4974,亞泰,18,1,17,元大-大天母,2023-02-24,9893
3081,聯亞,18,1,17,元大-大天母,2023-02-24,9893
3211,順達,16,0,16,元大-大天母,2023-02-24,9893
2498,宏達電,26,11,15,元大-大天母,2023-02-24,9893
5609,中菲行,110,95,15,元大-大天母,2023-02-24,9893
3303,岱稜,15,0,15,元大-大天母,2023-02-24,9893
3207,耀勝,16,1,15,元大-大天母,2023-02-24,9893
3535,晶彩科,15,0,15,元大-大天母,2023-02-24,9893
00633L,富邦上証正2,13,0,13,元大-大天母,2023-02-24,9893
4915,致伸,17,4,13,元大-大天母,2023-02-24,9893
9945,潤泰新,780,16,764,元大-大天母,2023-03-01,9893
2897,王道銀行,362,0,362,元大-大天母,2023-03-01,9893
5608,四維航,183,22,161,元大-大天母,2023-03-01,9893
00878,國泰永續高股息,146,8,138,元大-大天母,2023-03-01,9893
3703,欣陸,105,0,105,元大-大天母,2023-03-01,9893
5498,凱崴,87,0,87,元大-大天母,2023-03-01,9893
6190,萬泰科,47,0,47,元大-大天母,2023-03-01,9893
1101,台泥,50,4,46,元大-大天母,2023-03-01,9893
2002,中鋼,83,39,44,元大-大天母,2023-03-01,9893
4904,遠傳,40,0,40,元大-大天母,2023-03-01,9893
2344,華邦電,34,0,34,元大-大天母,2023-03-01,9893
1587,吉茂,30,0,30,元大-大天母,2023-03-01,9893
5521,工信,30,0,30,元大-大天母,2023-03-01,9893
8050,廣積,29,1,28,元大-大天母,2023-03-01,9893
1701,中化,26,0,26,元大-大天母,2023-03-01,9893
3706,神達,30,4,26,元大-大天母,2023-03-01,9893
3652,精聯,25,0,25,元大-大天母,2023-03-01,9893
1712,興農,25,0,25,元大-大天母,2023-03-01,9893
5009,榮剛,30,6,24,元大-大天母,2023-03-01,9893
2812,台中銀,23,0,23,元大-大天母,2023-03-01,9893
6153,嘉聯益,22,0,22,元大-大天母,2023-03-01,9893
3081,聯亞,21,0,21,元大-大天母,2023-03-01,9893
1103,嘉泥,20,0,20,元大-大天母,2023-03-01,9893
2430,燦坤,20,1,19,元大-大天母,2023-03-01,9893
2617,台航,24,5,19,元大-大天母,2023-03-01,9893
2618,長榮航,19,1,18,元大-大天母,2023-03-01,9893
3034,聯詠,21,4,17,元大-大天母,2023-03-01,9893
2891,中信金,22,7,15,元大-大天母,2023-03-01,9893
1402,遠東新,15,0,15,元大-大天母,2023-03-01,9893
1447,力鵬,15,0,15,元大-大天母,2023-03-01,9893
2603,長榮,18,3,15,元大-大天母,2023-03-01,9893
00679B,元大美債20年,14,0,14,元大-大天母,2023-03-01,9893
2031,新光鋼,14,0,14,元大-大天母,2023-03-01,9893
8150,南茂,15,1,14,元大-大天母,2023-03-01,9893
2885,元大金,23,9,14,元大-大天母,2023-03-01,9893
3035,智原,18,5,13,元大-大天母,2023-03-01,9893
5475,德宏,13,0,13,元大-大天母,2023-03-01,9893
8442,威宏-KY,13,0,13,元大-大天母,2023-03-01,9893
4432,銘旺實,12,0,12,元大-大天母,2023-03-01,9893
5512,力麒,21,9,12,元大-大天母,2023-03-01,9893
2412,中華電,12,0,12,元大-大天母,2023-03-01,9893
2882,國泰金,14,3,11,元大-大天母,2023-03-01,9893
00763U,期街口道瓊銅,11,0,11,元大-大天母,2023-03-01,9893
6470,宇智,13,2,11,元大-大天母,2023-03-01,9893
6274,台燿,13,2,11,元大-大天母,2023-03-01,9893
3231,緯創,10,0,10,元大-大天母,2023-03-01,9893
2609,陽明,32,22,10,元大-大天母,2023-03-01,9893
6547,高端疫苗,12,2,10,元大-大天母,2023-03-01,9893
1717,長興,10,0,10,元大-大天母,2023-03-01,9893
1718,中纖,10,0,10,元大-大天母,2023-03-01,9893
3481,群創,627,12,615,元大-大天母,2023-03-02,9893
00878,國泰永續高股息,301,15,286,元大-大天母,2023-03-02,9893
1605,華新,262,18,244,元大-大天母,2023-03-02,9893
00637L,元大滬深300正2,90,3,87,元大-大天母,2023-03-02,9893
5284,jpp-KY,85,5,80,元大-大天母,2023-03-02,9893
6275,元山,70,0,70,元大-大天母,2023-03-02,9893
2303,聯電,67,8,59,元大-大天母,2023-03-02,9893
00713,元大台灣高息低波,59,5,54,元大-大天母,2023-03-02,9893
3048,益登,50,0,50,元大-大天母,2023-03-02,9893
00772B,中信高評級公司債,42,0,42,元大-大天母,2023-03-02,9893
2892,第一金,42,0,42,元大-大天母,2023-03-02,9893
00679B,元大美債20年,40,0,40,元大-大天母,2023-03-02,9893
2312,金寶,40,0,40,元大-大天母,2023-03-02,9893
00632R,元大台灣50反1,40,0,40,元大-大天母,2023-03-02,9893
6139,亞翔,58,19,39,元大-大天母,2023-03-02,9893
2834,臺企銀,38,3,35,元大-大天母,2023-03-02,9893
3703,欣陸,35,0,35,元大-大天母,2023-03-02,9893
2897,王道銀行,42,14,28,元大-大天母,2023-03-02,9893
1504,東元,27,0,27,元大-大天母,2023-03-02,9893
1101,台泥,25,2,23,元大-大天母,2023-03-02,9893
6477,安集,23,0,23,元大-大天母,2023-03-02,9893
5439,高技,40,17,23,元大-大天母,2023-03-02,9893
9958,世紀鋼,21,0,21,元大-大天母,2023-03-02,9893
3290,東浦,20,0,20,元大-大天母,2023-03-02,9893
00885,富邦越南,20,0,20,元大-大天母,2023-03-02,9893
4720,德淵,20,0,20,元大-大天母,2023-03-02,9893
2430,燦坤,20,0,20,元大-大天母,2023-03-02,9893
5498,凱崴,19,0,19,元大-大天母,2023-03-02,9893
2605,新興,26,7,19,元大-大天母,2023-03-02,9893
6153,嘉聯益,33,15,18,元大-大天母,2023-03-02,9893
3652,精聯,21,3,18,元大-大天母,2023-03-02,9893
2468,華經,16,1,15,元大-大天母,2023-03-02,9893
1513,中興電,21,7,14,元大-大天母,2023-03-02,9893
5609,中菲行,210,196,14,元大-大天母,2023-03-02,9893
2882,國泰金,14,0,14,元大-大天母,2023-03-02,9893
1709,和益,13,0,13,元大-大天母,2023-03-02,9893
2888,新光金,13,0,13,元大-大天母,2023-03-02,9893
6470,宇智,20,7,13,元大-大天母,2023-03-02,9893
3661,世芯-KY,14,1,13,元大-大天母,2023-03-02,9893
4541,晟田,12,0,12,元大-大天母,2023-03-02,9893
1717,長興,11,0,11,元大-大天母,2023-03-02,9893
3071,協禧,11,0,11,元大-大天母,2023-03-02,9893
8033,雷虎,15,4,11,元大-大天母,2023-03-02,9893
6578,達邦蛋白,11,0,11,元大-大天母,2023-03-02,9893
8938,明安,11,0,11,元大-大天母,2023-03-02,9893
2891,中信金,12,2,10,元大-大天母,2023-03-02,9893
5258,虹堡,11,1,10,元大-大天母,2023-03-02,9893
2481,強茂,10,0,10,元大-大天母,2023-03-02,9893
1813,寶利徠,10,0,10,元大-大天母,2023-03-02,9893
5905,南仁湖,10,0,10,元大-大天母,2023-03-02,9893
2891,中信金,307,0,307,元大-大天母,2023-03-03,9893
2845,遠東銀,155,0,155,元大-大天母,2023-03-03,9893
2340,台亞,51,0,51,元大-大天母,2023-03-03,9893
6206,飛捷,41,0,41,元大-大天母,2023-03-03,9893
5410,國眾,45,5,40,元大-大天母,2023-03-03,9893
6275,元山,40,0,40,元大-大天母,2023-03-03,9893
6160,欣技,37,0,37,元大-大天母,2023-03-03,9893
1786,科妍,35,0,35,元大-大天母,2023-03-03,9893
3081,聯亞,34,0,34,元大-大天母,2023-03-03,9893
6190,萬泰科,32,0,32,元大-大天母,2023-03-03,9893
6189,豐藝,32,0,32,元大-大天母,2023-03-03,9893
3652,精聯,59,28,31,元大-大天母,2023-03-03,9893
3443,創意,31,1,30,元大-大天母,2023-03-03,9893
6153,嘉聯益,30,0,30,元大-大天母,2023-03-03,9893
8046,南電,37,8,29,元大-大天母,2023-03-03,9893
3035,智原,38,9,29,元大-大天母,2023-03-03,9893
6576,逸達,31,2,29,元大-大天母,2023-03-03,9893
2748,雲品,26,1,25,元大-大天母,2023-03-03,9893
1504,東元,30,6,24,元大-大天母,2023-03-03,9893
00751B,元大AAA至A公司債,24,0,24,元大-大天母,2023-03-03,9893
3016,嘉晶,24,0,24,元大-大天母,2023-03-03,9893
6245,立端,46,24,22,元大-大天母,2023-03-03,9893
3380,明泰,22,2,20,元大-大天母,2023-03-03,9893
00712,復華富時不動產,20,0,20,元大-大天母,2023-03-03,9893
2609,陽明,60,41,19,元大-大天母,2023-03-03,9893
1605,華新,38,20,18,元大-大天母,2023-03-03,9893
6288,聯嘉,17,1,16,元大-大天母,2023-03-03,9893
5512,力麒,16,0,16,元大-大天母,2023-03-03,9893
3162,精確,17,3,14,元大-大天母,2023-03-03,9893
6290,良維,14,0,14,元大-大天母,2023-03-03,9893
6188,廣明,52,38,14,元大-大天母,2023-03-03,9893
2385,群光,15,1,14,元大-大天母,2023-03-03,9893
2617,台航,13,1,12,元大-大天母,2023-03-03,9893
2641,正德,17,5,12,元大-大天母,2023-03-03,9893
00680L,元大美債20正2,16,5,11,元大-大天母,2023-03-03,9893
1434,福懋,11,0,11,元大-大天母,2023-03-03,9893
3710,連展投控,10,0,10,元大-大天母,2023-03-03,9893
2812,台中銀,10,0,10,元大-大天母,2023-03-03,9893
1536,和大,10,0,10,元大-大天母,2023-03-03,9893
5302,太欣,10,0,10,元大-大天母,2023-03-03,9893
2458,義隆,10,0,10,元大-大天母,2023-03-03,9893
00637L,元大滬深300正2,11,1,10,元大-大天母,2023-03-03,9893
3374,精材,10,0,10,元大-大天母,2023-03-03,9893
2884,玉山金,14,4,10,元大-大天母,2023-03-03,9893
3661,世芯-KY,13,4,9,元大-大天母,2023-03-03,9893
00679B,元大美債20年,13,4,9,元大-大天母,2023-03-03,9893
6235,華孚,83,74,9,元大-大天母,2023-03-03,9893
6248,沛波,9,0,9,元大-大天母,2023-03-03,9893
8050,廣積,12,3,9,元大-大天母,2023-03-03,9893
6443,元晶,12,3,9,元大-大天母,2023-03-03,9893
6770,力積電,827,12,815,元大-大天母,2023-03-06,9893
1504,東元,252,8,244,元大-大天母,2023-03-06,9893
2031,新光鋼,188,0,188,元大-大天母,2023-03-06,9893
3013,晟銘電,98,1,97,元大-大天母,2023-03-06,9893
00830,國泰費城半導體,76,0,76,元大-大天母,2023-03-06,9893
00713,元大台灣高息低波,82,8,74,元大-大天母,2023-03-06,9893
2610,華航,77,9,68,元大-大天母,2023-03-06,9893
00632R,元大台灣50反1,205,140,65,元大-大天母,2023-03-06,9893
00669R,國泰美國道瓊反1,50,0,50,元大-大天母,2023-03-06,9893
00676R,富邦臺灣加權反1,50,0,50,元大-大天母,2023-03-06,9893
3048,益登,50,0,50,元大-大天母,2023-03-06,9893
2637,慧洋-KY,57,8,49,元大-大天母,2023-03-06,9893
3624,光頡,55,9,46,元大-大天母,2023-03-06,9893
2312,金寶,40,0,40,元大-大天母,2023-03-06,9893
4155,訊映,40,0,40,元大-大天母,2023-03-06,9893
6188,廣明,39,1,38,元大-大天母,2023-03-06,9893
1101,台泥,40,4,36,元大-大天母,2023-03-06,9893
6111,大宇資,34,0,34,元大-大天母,2023-03-06,9893
6275,元山,32,0,32,元大-大天母,2023-03-06,9893
5608,四維航,30,2,28,元大-大天母,2023-03-06,9893
5475,德宏,27,0,27,元大-大天母,2023-03-06,9893
2327,國巨,27,1,26,元大-大天母,2023-03-06,9893
6245,立端,28,3,25,元大-大天母,2023-03-06,9893
5347,世界,30,5,25,元大-大天母,2023-03-06,9893
3031,佰鴻,30,6,24,元大-大天母,2023-03-06,9893
00670L,富邦NASDAQ正2,24,1,23,元大-大天母,2023-03-06,9893
6190,萬泰科,22,0,22,元大-大天母,2023-03-06,9893
00648R,元大S＆P500反1,20,0,20,元大-大天母,2023-03-06,9893
6416,瑞祺電通,20,0,20,元大-大天母,2023-03-06,9893
2344,華邦電,97,77,20,元大-大天母,2023-03-06,9893
3264,欣銓,22,3,19,元大-大天母,2023-03-06,9893
2641,正德,19,2,17,元大-大天母,2023-03-06,9893
1605,華新,25,8,17,元大-大天母,2023-03-06,9893
2617,台航,17,0,17,元大-大天母,2023-03-06,9893
2393,億光,17,0,17,元大-大天母,2023-03-06,9893
2891,中信金,16,0,16,元大-大天母,2023-03-06,9893
3006,晶豪科,18,2,16,元大-大天母,2023-03-06,9893
8103,瀚荃,16,0,16,元大-大天母,2023-03-06,9893
6118,建達,15,0,15,元大-大天母,2023-03-06,9893
4137,麗豐-KY,15,0,15,元大-大天母,2023-03-06,9893
3521,鴻翊,15,0,15,元大-大天母,2023-03-06,9893
1513,中興電,16,1,15,元大-大天母,2023-03-06,9893
6799,來頡,15,1,14,元大-大天母,2023-03-06,9893
1813,寶利徠,14,0,14,元大-大天母,2023-03-06,9893
2609,陽明,41,28,13,元大-大天母,2023-03-06,9893
00631L,元大台灣50正2,13,0,13,元大-大天母,2023-03-06,9893
2002,中鋼,24,12,12,元大-大天母,2023-03-06,9893
00647L,元大S＆P500正2,12,0,12,元大-大天母,2023-03-06,9893
2337,旺宏,13,1,12,元大-大天母,2023-03-06,9893
5340,建榮,12,0,12,元大-大天母,2023-03-06,9893
6116,彩晶,502,1,501,元大-大天母,2023-03-07,9893
00665L,富邦�琤肭磪囓�2,160,0,160,元大-大天母,2023-03-07,9893
4155,訊映,145,0,145,元大-大天母,2023-03-07,9893
00673R,期元大S＆P原油反1,89,0,89,元大-大天母,2023-03-07,9893
2031,新光鋼,88,0,88,元大-大天母,2023-03-07,9893
6188,廣明,108,40,68,元大-大天母,2023-03-07,9893
00713,元大台灣高息低波,50,0,50,元大-大天母,2023-03-07,9893
1718,中纖,52,4,48,元大-大天母,2023-03-07,9893
2834,臺企銀,48,1,47,元大-大天母,2023-03-07,9893
2486,一詮,62,16,46,元大-大天母,2023-03-07,9893
5608,四維航,36,0,36,元大-大天母,2023-03-07,9893
2344,華邦電,71,35,36,元大-大天母,2023-03-07,9893
2609,陽明,61,26,35,元大-大天母,2023-03-07,9893
2327,國巨,32,1,31,元大-大天母,2023-03-07,9893
00641R,富邦日本反1,30,0,30,元大-大天母,2023-03-07,9893
00676R,富邦臺灣加權反1,30,0,30,元大-大天母,2023-03-07,9893
3481,群創,33,6,27,元大-大天母,2023-03-07,9893
2610,華航,25,2,23,元大-大天母,2023-03-07,9893
6275,元山,23,0,23,元大-大天母,2023-03-07,9893
5425,台半,43,20,23,元大-大天母,2023-03-07,9893
00679B,元大美債20年,22,2,20,元大-大天母,2023-03-07,9893
8349,�矬�,20,0,20,元大-大天母,2023-03-07,9893
4908,前鼎,20,0,20,元大-大天母,2023-03-07,9893
3047,訊舟,20,1,19,元大-大天母,2023-03-07,9893
00637L,元大滬深300正2,38,20,18,元大-大天母,2023-03-07,9893
2704,國賓,18,0,18,元大-大天母,2023-03-07,9893
5243,乙盛-KY,21,3,18,元大-大天母,2023-03-07,9893
8049,晶采,18,0,18,元大-大天母,2023-03-07,9893
1519,華城,48,31,17,元大-大天母,2023-03-07,9893
9944,新麗,15,0,15,元大-大天母,2023-03-07,9893
1524,耿鼎,15,0,15,元大-大天母,2023-03-07,9893
4171,瑞基,14,0,14,元大-大天母,2023-03-07,9893
6770,力積電,37,25,12,元大-大天母,2023-03-07,9893
6231,系微,20,8,12,元大-大天母,2023-03-07,9893
6282,康舒,17,5,12,元大-大天母,2023-03-07,9893
2352,佳世達,12,0,12,元大-大天母,2023-03-07,9893
00720B,元大投資級公司債,11,0,11,元大-大天母,2023-03-07,9893
1513,中興電,22,11,11,元大-大天母,2023-03-07,9893
1210,大成,11,0,11,元大-大天母,2023-03-07,9893
6288,聯嘉,27,16,11,元大-大天母,2023-03-07,9893
5498,凱崴,11,0,11,元大-大天母,2023-03-07,9893
2468,華經,10,0,10,元大-大天母,2023-03-07,9893
5469,瀚宇博,10,0,10,元大-大天母,2023-03-07,9893
5512,力麒,10,0,10,元大-大天母,2023-03-07,9893
2867,三商壽,10,0,10,元大-大天母,2023-03-07,9893
2009,第一銅,10,0,10,元大-大天母,2023-03-07,9893
8033,雷虎,10,0,10,元大-大天母,2023-03-07,9893
5347,世界,10,1,9,元大-大天母,2023-03-07,9893
8171,天宇,13,4,9,元大-大天母,2023-03-07,9893
3652,精聯,10,1,9,元大-大天母,2023-03-07,9893
2329,華泰,343,0,343,元大-大天母,2023-03-08,9893
6116,彩晶,148,4,144,元大-大天母,2023-03-08,9893
1504,東元,134,13,121,元大-大天母,2023-03-08,9893
9933,中鼎,87,3,84,元大-大天母,2023-03-08,9893
00878,國泰永續高股息,67,9,58,元大-大天母,2023-03-08,9893
2376,技嘉,56,1,55,元大-大天母,2023-03-08,9893
00706L,期元大S＆P日圓正2,55,0,55,元大-大天母,2023-03-08,9893
2031,新光鋼,55,0,55,元大-大天母,2023-03-08,9893
1514,亞力,56,4,52,元大-大天母,2023-03-08,9893
00665L,富邦�琤肭磪囓�2,50,0,50,元大-大天母,2023-03-08,9893
5243,乙盛-KY,52,2,50,元大-大天母,2023-03-08,9893
4904,遠傳,50,5,45,元大-大天母,2023-03-08,9893
00923,群益台ESG低碳50,37,0,37,元大-大天母,2023-03-08,9893
8071,能率網通,33,0,33,元大-大天母,2023-03-08,9893
8103,瀚荃,30,0,30,元大-大天母,2023-03-08,9893
00753L,中信中國50正2,29,2,27,元大-大天母,2023-03-08,9893
00632R,元大台灣50反1,100,75,25,元大-大天母,2023-03-08,9893
3046,建��,34,11,23,元大-大天母,2023-03-08,9893
4432,銘旺實,22,0,22,元大-大天母,2023-03-08,9893
2405,輔信,22,0,22,元大-大天母,2023-03-08,9893
4533,協易機,21,0,21,元大-大天母,2023-03-08,9893
4960,誠美材,20,3,17,元大-大天母,2023-03-08,9893
1101,台泥,23,7,16,元大-大天母,2023-03-08,9893
5009,榮剛,58,42,16,元大-大天母,2023-03-08,9893
1524,耿鼎,27,11,16,元大-大天母,2023-03-08,9893
1102,亞泥,15,0,15,元大-大天母,2023-03-08,9893
00633L,富邦上証正2,25,10,15,元大-大天母,2023-03-08,9893
5351,鈺創,16,1,15,元大-大天母,2023-03-08,9893
006208,富邦台50,14,0,14,元大-大天母,2023-03-08,9893
2454,聯發科,14,0,14,元大-大天母,2023-03-08,9893
00900,富邦特選高股息30,19,5,14,元大-大天母,2023-03-08,9893
00637L,元大滬深300正2,14,0,14,元大-大天母,2023-03-08,9893
3022,威強電,23,10,13,元大-大天母,2023-03-08,9893
2303,聯電,78,65,13,元大-大天母,2023-03-08,9893
2609,陽明,42,30,12,元大-大天母,2023-03-08,9893
2520,冠德,12,0,12,元大-大天母,2023-03-08,9893
1301,台塑,12,0,12,元大-大天母,2023-03-08,9893
1710,東聯,13,1,12,元大-大天母,2023-03-08,9893
5608,四維航,13,1,12,元大-大天母,2023-03-08,9893
2354,鴻準,13,2,11,元大-大天母,2023-03-08,9893
00893,國泰智能電動車,11,0,11,元大-大天母,2023-03-08,9893
00738U,期元大道瓊白銀,11,0,11,元大-大天母,2023-03-08,9893
4973,廣穎,11,0,11,元大-大天母,2023-03-08,9893
6799,來頡,21,10,11,元大-大天母,2023-03-08,9893
2801,彰銀,10,0,10,元大-大天母,2023-03-08,9893
1103,嘉泥,10,0,10,元大-大天母,2023-03-08,9893
9105,泰金寶-DR,10,0,10,元大-大天母,2023-03-08,9893
3264,欣銓,58,48,10,元大-大天母,2023-03-08,9893
2317,鴻海,12,3,9,元大-大天母,2023-03-08,9893
2881,富邦金,12,3,9,元大-大天母,2023-03-08,9893
5609,中菲行,195,0,195,元大-大天母,2023-03-09,9893
3231,緯創,159,11,148,元大-大天母,2023-03-09,9893
3481,群創,143,15,128,元大-大天母,2023-03-09,9893
5284,jpp-KY,103,0,103,元大-大天母,2023-03-09,9893
3294,英濟,74,0,74,元大-大天母,2023-03-09,9893
1718,中纖,62,0,62,元大-大天母,2023-03-09,9893
00878,國泰永續高股息,70,10,60,元大-大天母,2023-03-09,9893
6443,元晶,55,9,46,元大-大天母,2023-03-09,9893
2401,凌陽,46,0,46,元大-大天母,2023-03-09,9893
2317,鴻海,52,10,42,元大-大天母,2023-03-09,9893
00665L,富邦�琤肭磪囓�2,40,0,40,元大-大天母,2023-03-09,9893
2344,華邦電,52,13,39,元大-大天母,2023-03-09,9893
1605,華新,62,28,34,元大-大天母,2023-03-09,9893
1103,嘉泥,32,0,32,元大-大天母,2023-03-09,9893
3455,由田,30,0,30,元大-大天母,2023-03-09,9893
6016,康和證,30,0,30,元大-大天母,2023-03-09,9893
2486,一詮,60,31,29,元大-大天母,2023-03-09,9893
2363,矽統,30,1,29,元大-大天母,2023-03-09,9893
0056,元大高股息,32,5,27,元大-大天母,2023-03-09,9893
2891,中信金,27,0,27,元大-大天母,2023-03-09,9893
6235,華孚,33,8,25,元大-大天母,2023-03-09,9893
2881,富邦金,24,1,23,元大-大天母,2023-03-09,9893
3617,碩天,22,0,22,元大-大天母,2023-03-09,9893
5243,乙盛-KY,21,0,21,元大-大天母,2023-03-09,9893
00641R,富邦日本反1,20,0,20,元大-大天母,2023-03-09,9893
2314,台揚,21,1,20,元大-大天母,2023-03-09,9893
2618,長榮航,44,25,19,元大-大天母,2023-03-09,9893
4973,廣穎,19,0,19,元大-大天母,2023-03-09,9893
4966,譜瑞-KY,20,1,19,元大-大天母,2023-03-09,9893
6290,良維,22,4,18,元大-大天母,2023-03-09,9893
00713,元大台灣高息低波,17,0,17,元大-大天母,2023-03-09,9893
00637L,元大滬深300正2,17,0,17,元大-大天母,2023-03-09,9893
1303,南亞,17,0,17,元大-大天母,2023-03-09,9893
00900,富邦特選高股息30,25,8,17,元大-大天母,2023-03-09,9893
6168,宏齊,17,0,17,元大-大天母,2023-03-09,9893
2027,大成鋼,17,0,17,元大-大天母,2023-03-09,9893
8105,凌巨,25,8,17,元大-大天母,2023-03-09,9893
8046,南電,22,6,16,元大-大天母,2023-03-09,9893
6129,普誠,20,4,16,元大-大天母,2023-03-09,9893
4163,鐿鈦,19,4,15,元大-大天母,2023-03-09,9893
6142,友勁,15,0,15,元大-大天母,2023-03-09,9893
00751B,元大AAA至A公司債,14,0,14,元大-大天母,2023-03-09,9893
4976,佳凌,17,3,14,元大-大天母,2023-03-09,9893
2338,光罩,15,2,13,元大-大天母,2023-03-09,9893
1402,遠東新,13,0,13,元大-大天母,2023-03-09,9893
2002,中鋼,16,3,13,元大-大天母,2023-03-09,9893
2388,威盛,22,9,13,元大-大天母,2023-03-09,9893
5706,鳳凰,13,1,12,元大-大天母,2023-03-09,9893
2371,大同,13,1,12,元大-大天母,2023-03-09,9893
1305,華夏,12,0,12,元大-大天母,2023-03-09,9893
00632R,元大台灣50反1,443,180,263,元大-大天母,2023-03-10,9893
00878,國泰永續高股息,172,26,146,元大-大天母,2023-03-10,9893
2897,王道銀行,100,0,100,元大-大天母,2023-03-10,9893
2609,陽明,280,187,93,元大-大天母,2023-03-10,9893
6443,元晶,84,2,82,元大-大天母,2023-03-10,9893
00664R,國泰臺灣加權反1,80,0,80,元大-大天母,2023-03-10,9893
2618,長榮航,70,1,69,元大-大天母,2023-03-10,9893
00680L,元大美債20正2,86,23,63,元大-大天母,2023-03-10,9893
2371,大同,58,0,58,元大-大天母,2023-03-10,9893
2883,凱基金,57,1,56,元大-大天母,2023-03-10,9893
2401,凌陽,51,0,51,元大-大天母,2023-03-10,9893
2610,華航,63,13,50,元大-大天母,2023-03-10,9893
1584,精剛,57,8,49,元大-大天母,2023-03-10,9893
2344,華邦電,50,4,46,元大-大天母,2023-03-10,9893
5425,台半,66,22,44,元大-大天母,2023-03-10,9893
4142,國光生,42,3,39,元大-大天母,2023-03-10,9893
2884,玉山金,39,1,38,元大-大天母,2023-03-10,9893
8069,元太,42,4,38,元大-大天母,2023-03-10,9893
2303,聯電,92,57,35,元大-大天母,2023-03-10,9893
1103,嘉泥,33,0,33,元大-大天母,2023-03-10,9893
2888,新光金,28,0,28,元大-大天母,2023-03-10,9893
00713,元大台灣高息低波,26,0,26,元大-大天母,2023-03-10,9893
2890,永豐金,25,0,25,元大-大天母,2023-03-10,9893
00923,群益台ESG低碳50,24,0,24,元大-大天母,2023-03-10,9893
8071,能率網通,35,11,24,元大-大天母,2023-03-10,9893
00715L,期街口布蘭特正2,23,0,23,元大-大天母,2023-03-10,9893
8112,至上,24,1,23,元大-大天母,2023-03-10,9893
0056,元大高股息,67,45,22,元大-大天母,2023-03-10,9893
5880,合庫金,32,10,22,元大-大天母,2023-03-10,9893
3019,亞光,22,0,22,元大-大天母,2023-03-10,9893
2891,中信金,21,0,21,元大-大天母,2023-03-10,9893
2317,鴻海,30,9,21,元大-大天母,2023-03-10,9893
00665L,富邦�琤肭磪囓�2,20,0,20,元大-大天母,2023-03-10,9893
6477,安集,20,0,20,元大-大天母,2023-03-10,9893
6416,瑞祺電通,20,0,20,元大-大天母,2023-03-10,9893
3576,聯合再生,20,1,19,元大-大天母,2023-03-10,9893
2603,長榮,108,89,19,元大-大天母,2023-03-10,9893
8044,網家,18,0,18,元大-大天母,2023-03-10,9893
8215,明基材,18,0,18,元大-大天母,2023-03-10,9893
6174,安��,18,0,18,元大-大天母,2023-03-10,9893
0050,元大台灣50,22,4,18,元大-大天母,2023-03-10,9893
3034,聯詠,17,0,17,元大-大天母,2023-03-10,9893
4977,眾達-KY,18,1,17,元大-大天母,2023-03-10,9893
3207,耀勝,29,12,17,元大-大天母,2023-03-10,9893
2330,台積電,19,2,17,元大-大天母,2023-03-10,9893
3209,全科,16,0,16,元大-大天母,2023-03-10,9893
2641,正德,18,2,16,元大-大天母,2023-03-10,9893
3027,盛達,18,2,16,元大-大天母,2023-03-10,9893
1718,中纖,15,0,15,元大-大天母,2023-03-10,9893
4432,銘旺實,15,0,15,元大-大天母,2023-03-10,9893
00878,國泰永續高股息,226,55,171,元大-大天母,2023-03-13,9893
00632R,元大台灣50反1,368,200,168,元大-大天母,2023-03-13,9893
2897,王道銀行,101,1,100,元大-大天母,2023-03-13,9893
2357,華碩,89,0,89,元大-大天母,2023-03-13,9893
2609,陽明,113,40,73,元大-大天母,2023-03-13,9893
4904,遠傳,73,3,70,元大-大天母,2023-03-13,9893
00882,中信中國高股息,61,0,61,元大-大天母,2023-03-13,9893
0056,元大高股息,85,26,59,元大-大天母,2023-03-13,9893
00633L,富邦上証正2,52,0,52,元大-大天母,2023-03-13,9893
8112,至上,51,15,36,元大-大天母,2023-03-13,9893
5009,榮剛,43,7,36,元大-大天母,2023-03-13,9893
5609,中菲行,30,0,30,元大-大天母,2023-03-13,9893
00637L,元大滬深300正2,31,1,30,元大-大天母,2023-03-13,9893
00713,元大台灣高息低波,25,2,23,元大-大天母,2023-03-13,9893
6245,立端,50,27,23,元大-大天母,2023-03-13,9893
2618,長榮航,22,1,21,元大-大天母,2023-03-13,9893
3682,亞太電,20,0,20,元大-大天母,2023-03-13,9893
3294,英濟,20,0,20,元大-大天母,2023-03-13,9893
2834,臺企銀,37,17,20,元大-大天母,2023-03-13,9893
6547,高端疫苗,24,6,18,元大-大天母,2023-03-13,9893
2640,大車隊,18,0,18,元大-大天母,2023-03-13,9893
1605,華新,30,13,17,元大-大天母,2023-03-13,9893
9944,新麗,17,0,17,元大-大天母,2023-03-13,9893
5701,劍湖山,17,0,17,元大-大天母,2023-03-13,9893
2610,華航,46,30,16,元大-大天母,2023-03-13,9893
6770,力積電,16,0,16,元大-大天母,2023-03-13,9893
9933,中鼎,19,4,15,元大-大天母,2023-03-13,9893
3624,光頡,26,11,15,元大-大天母,2023-03-13,9893
2883,凱基金,30,16,14,元大-大天母,2023-03-13,9893
1569,濱川,13,0,13,元大-大天母,2023-03-13,9893
2481,強茂,12,0,12,元大-大天母,2023-03-13,9893
00715L,期街口布蘭特正2,12,0,12,元大-大天母,2023-03-13,9893
5876,上海商銀,12,0,12,元大-大天母,2023-03-13,9893
3046,建��,36,25,11,元大-大天母,2023-03-13,9893
2641,正德,12,1,11,元大-大天母,2023-03-13,9893
4915,致伸,22,11,11,元大-大天母,2023-03-13,9893
8163,達方,10,0,10,元大-大天母,2023-03-13,9893
00664R,國泰臺灣加權反1,10,0,10,元大-大天母,2023-03-13,9893
3048,益登,10,0,10,元大-大天母,2023-03-13,9893
1519,華城,11,2,9,元大-大天母,2023-03-13,9893
3034,聯詠,11,2,9,元大-大天母,2023-03-13,9893
2890,永豐金,9,0,9,元大-大天母,2023-03-13,9893
2305,全友,11,2,9,元大-大天母,2023-03-13,9893
00772B,中信高評級公司債,9,0,9,元大-大天母,2023-03-13,9893
1314,中石化,8,0,8,元大-大天母,2023-03-13,9893
3264,欣銓,27,19,8,元大-大天母,2023-03-13,9893
3441,聯一光,10,2,8,元大-大天母,2023-03-13,9893
1504,東元,13,5,8,元大-大天母,2023-03-13,9893
2211,長榮鋼,8,0,8,元大-大天母,2023-03-13,9893
2405,輔信,8,0,8,元大-大天母,2023-03-13,9893
2409,友達,438,0,438,元大-大天母,2023-03-14,9893
00878,國泰永續高股息,315,25,290,元大-大天母,2023-03-14,9893
2618,長榮航,430,337,93,元大-大天母,2023-03-14,9893
2376,技嘉,51,0,51,元大-大天母,2023-03-14,9893
2031,新光鋼,50,0,50,元大-大天母,2023-03-14,9893
00688L,國泰20年美債正2,50,0,50,元大-大天母,2023-03-14,9893
5609,中菲行,46,0,46,元大-大天母,2023-03-14,9893
2609,陽明,101,57,44,元大-大天母,2023-03-14,9893
2891,中信金,44,1,43,元大-大天母,2023-03-14,9893
00715L,期街口布蘭特正2,41,0,41,元大-大天母,2023-03-14,9893
00664R,國泰臺灣加權反1,40,0,40,元大-大天母,2023-03-14,9893
6275,元山,35,0,35,元大-大天母,2023-03-14,9893
2331,精英,38,3,35,元大-大天母,2023-03-14,9893
5425,台半,34,1,33,元大-大天母,2023-03-14,9893
2640,大車隊,32,0,32,元大-大天母,2023-03-14,9893
9945,潤泰新,30,1,29,元大-大天母,2023-03-14,9893
2610,華航,60,31,29,元大-大天母,2023-03-14,9893
3481,群創,35,7,28,元大-大天母,2023-03-14,9893
2882,國泰金,33,5,28,元大-大天母,2023-03-14,9893
2303,聯電,42,14,28,元大-大天母,2023-03-14,9893
00915,凱基優選高股息30,28,0,28,元大-大天母,2023-03-14,9893
00665L,富邦�琤肭磪囓�2,41,20,21,元大-大天母,2023-03-14,9893
1307,三芳,20,0,20,元大-大天母,2023-03-14,9893
00882,中信中國高股息,19,0,19,元大-大天母,2023-03-14,9893
1605,華新,21,3,18,元大-大天母,2023-03-14,9893
4958,臻鼎-KY,18,1,17,元大-大天母,2023-03-14,9893
00903,富邦元宇宙,17,0,17,元大-大天母,2023-03-14,9893
00923,群益台ESG低碳50,16,0,16,元大-大天母,2023-03-14,9893
2308,台達電,16,1,15,元大-大天母,2023-03-14,9893
00753L,中信中國50正2,15,0,15,元大-大天母,2023-03-14,9893
2883,凱基金,35,21,14,元大-大天母,2023-03-14,9893
2834,臺企銀,32,18,14,元大-大天母,2023-03-14,9893
1514,亞力,15,1,14,元大-大天母,2023-03-14,9893
00713,元大台灣高息低波,13,0,13,元大-大天母,2023-03-14,9893
1219,福壽,15,2,13,元大-大天母,2023-03-14,9893
2520,冠德,14,1,13,元大-大天母,2023-03-14,9893
1560,中砂,15,2,13,元大-大天母,2023-03-14,9893
2892,第一金,15,2,13,元大-大天母,2023-03-14,9893
2201,裕隆,15,3,12,元大-大天母,2023-03-14,9893
2408,南亞科,12,0,12,元大-大天母,2023-03-14,9893
00885,富邦越南,12,0,12,元大-大天母,2023-03-14,9893
5230,雷笛克光學,12,0,12,元大-大天母,2023-03-14,9893
1314,中石化,12,0,12,元大-大天母,2023-03-14,9893
2753,八方雲集,14,2,12,元大-大天母,2023-03-14,9893
2615,萬海,20,8,12,元大-大天母,2023-03-14,9893
8112,至上,42,30,12,元大-大天母,2023-03-14,9893
2881,富邦金,15,3,12,元大-大天母,2023-03-14,9893
2880,華南金,12,1,11,元大-大天母,2023-03-14,9893
2641,正德,15,4,11,元大-大天母,2023-03-14,9893
00712,復華富時不動產,11,0,11,元大-大天母,2023-03-14,9893
2031,新光鋼,188,0,188,元大-大天母,2023-03-15,9893
1402,遠東新,146,0,146,元大-大天母,2023-03-15,9893
00878,國泰永續高股息,140,12,128,元大-大天母,2023-03-15,9893
5609,中菲行,114,2,112,元大-大天母,2023-03-15,9893
00715L,期街口布蘭特正2,109,0,109,元大-大天母,2023-03-15,9893
2641,正德,114,18,96,元大-大天母,2023-03-15,9893
3711,日月光投控,86,1,85,元大-大天母,2023-03-15,9893
3624,光頡,104,28,76,元大-大天母,2023-03-15,9893
00680L,元大美債20正2,64,1,63,元大-大天母,2023-03-15,9893
2727,王品,50,0,50,元大-大天母,2023-03-15,9893
1718,中纖,50,0,50,元大-大天母,2023-03-15,9893
2603,長榮,118,68,50,元大-大天母,2023-03-15,9893
2363,矽統,50,1,49,元大-大天母,2023-03-15,9893
2888,新光金,47,0,47,元大-大天母,2023-03-15,9893
2312,金寶,48,2,46,元大-大天母,2023-03-15,9893
00665L,富邦�琤肭磪囓�2,39,0,39,元大-大天母,2023-03-15,9893
2834,臺企銀,54,17,37,元大-大天母,2023-03-15,9893
2607,榮運,42,6,36,元大-大天母,2023-03-15,9893
2891,中信金,31,0,31,元大-大天母,2023-03-15,9893
2027,大成鋼,40,10,30,元大-大天母,2023-03-15,9893
00713,元大台灣高息低波,29,0,29,元大-大天母,2023-03-15,9893
2880,華南金,30,1,29,元大-大天母,2023-03-15,9893
4938,和碩,29,0,29,元大-大天母,2023-03-15,9893
5009,榮剛,38,10,28,元大-大天母,2023-03-15,9893
2637,慧洋-KY,30,2,28,元大-大天母,2023-03-15,9893
2357,華碩,30,2,28,元大-大天母,2023-03-15,9893
2881,富邦金,26,0,26,元大-大天母,2023-03-15,9893
1101,台泥,34,10,24,元大-大天母,2023-03-15,9893
3289,宜特,23,1,22,元大-大天母,2023-03-15,9893
1316,上曜,27,6,21,元大-大天母,2023-03-15,9893
2884,玉山金,22,1,21,元大-大天母,2023-03-15,9893
2883,凱基金,27,7,20,元大-大天母,2023-03-15,9893
00676R,富邦臺灣加權反1,20,0,20,元大-大天母,2023-03-15,9893
1460,宏遠,20,0,20,元大-大天母,2023-03-15,9893
1314,中石化,20,0,20,元大-大天母,2023-03-15,9893
3703,欣陸,20,0,20,元大-大天母,2023-03-15,9893
00679B,元大美債20年,22,3,19,元大-大天母,2023-03-15,9893
00915,凱基優選高股息30,18,0,18,元大-大天母,2023-03-15,9893
1504,東元,23,6,17,元大-大天母,2023-03-15,9893
6245,立端,24,8,16,元大-大天母,2023-03-15,9893
2614,東森,16,0,16,元大-大天母,2023-03-15,9893
3094,聯傑,36,20,16,元大-大天母,2023-03-15,9893
2534,宏盛,15,0,15,元大-大天母,2023-03-15,9893
5230,雷笛克光學,15,0,15,元大-大天母,2023-03-15,9893
1326,台化,15,0,15,元大-大天母,2023-03-15,9893
00670L,富邦NASDAQ正2,15,0,15,元大-大天母,2023-03-15,9893
2801,彰銀,25,10,15,元大-大天母,2023-03-15,9893
0056,元大高股息,14,0,14,元大-大天母,2023-03-15,9893
2606,裕民,19,7,12,元大-大天母,2023-03-15,9893
4979,華星光,11,0,11,元大-大天母,2023-03-15,9893
6116,彩晶,400,0,400,元大-大天母,2023-03-16,9893
2891,中信金,394,1,393,元大-大天母,2023-03-16,9893
00715L,期街口布蘭特正2,278,9,269,元大-大天母,2023-03-16,9893
3030,德律,121,0,121,元大-大天母,2023-03-16,9893
00878,國泰永續高股息,123,11,112,元大-大天母,2023-03-16,9893
2897,王道銀行,100,2,98,元大-大天母,2023-03-16,9893
2610,華航,77,10,67,元大-大天母,2023-03-16,9893
2603,長榮,67,14,53,元大-大天母,2023-03-16,9893
2609,陽明,125,84,41,元大-大天母,2023-03-16,9893
2401,凌陽,40,0,40,元大-大天母,2023-03-16,9893
00632R,元大台灣50反1,80,40,40,元大-大天母,2023-03-16,9893
3088,艾訊,41,2,39,元大-大天母,2023-03-16,9893
00713,元大台灣高息低波,35,0,35,元大-大天母,2023-03-16,9893
0056,元大高股息,50,15,35,元大-大天母,2023-03-16,9893
6443,元晶,78,45,33,元大-大天母,2023-03-16,9893
5425,台半,38,7,31,元大-大天母,2023-03-16,9893
0055,元大MSCI金融,30,0,30,元大-大天母,2023-03-16,9893
2885,元大金,29,1,28,元大-大天母,2023-03-16,9893
3703,欣陸,30,4,26,元大-大天母,2023-03-16,9893
4306,炎洲,24,0,24,元大-大天母,2023-03-16,9893
00642U,期元大S＆P石油,23,0,23,元大-大天母,2023-03-16,9893
2880,華南金,24,1,23,元大-大天母,2023-03-16,9893
2405,輔信,22,0,22,元大-大天母,2023-03-16,9893
2883,凱基金,22,1,21,元大-大天母,2023-03-16,9893
5603,陸海,21,0,21,元大-大天母,2023-03-16,9893
2892,第一金,23,3,20,元大-大天母,2023-03-16,9893
6129,普誠,20,0,20,元大-大天母,2023-03-16,9893
8016,矽創,21,1,20,元大-大天母,2023-03-16,9893
1307,三芳,20,0,20,元大-大天母,2023-03-16,9893
6005,群益證,20,0,20,元大-大天母,2023-03-16,9893
4304,勝昱,20,0,20,元大-大天母,2023-03-16,9893
2337,旺宏,21,2,19,元大-大天母,2023-03-16,9893
6589,台康生技,18,0,18,元大-大天母,2023-03-16,9893
2457,飛宏,26,8,18,元大-大天母,2023-03-16,9893
00712,復華富時不動產,17,0,17,元大-大天母,2023-03-16,9893
00664R,國泰臺灣加權反1,17,0,17,元大-大天母,2023-03-16,9893
1210,大成,17,1,16,元大-大天母,2023-03-16,9893
4973,廣穎,15,0,15,元大-大天母,2023-03-16,9893
8163,達方,15,0,15,元大-大天母,2023-03-16,9893
2882,國泰金,23,9,14,元大-大天母,2023-03-16,9893
00720B,元大投資級公司債,23,10,13,元大-大天母,2023-03-16,9893
00631L,元大台灣50正2,16,4,12,元大-大天母,2023-03-16,9893
2201,裕隆,19,7,12,元大-大天母,2023-03-16,9893
8050,廣積,13,1,12,元大-大天母,2023-03-16,9893
3010,華立,12,0,12,元大-大天母,2023-03-16,9893
2889,國票金,12,0,12,元大-大天母,2023-03-16,9893
1605,華新,21,9,12,元大-大天母,2023-03-16,9893
6271,同欣電,13,2,11,元大-大天母,2023-03-16,9893
2002,中鋼,14,3,11,元大-大天母,2023-03-16,9893
4721,美琪瑪,11,0,11,元大-大天母,2023-03-16,9893
00632R,元大台灣50反1,435,60,375,元大-大天母,2023-03-17,9893
8926,台汽電,121,0,121,元大-大天母,2023-03-17,9893
6116,彩晶,100,0,100,元大-大天母,2023-03-17,9893
00720B,元大投資級公司債,102,5,97,元大-大天母,2023-03-17,9893
00637L,元大滬深300正2,123,32,91,元大-大天母,2023-03-17,9893
2888,新光金,67,0,67,元大-大天母,2023-03-17,9893
2376,技嘉,55,0,55,元大-大天母,2023-03-17,9893
5603,陸海,40,0,40,元大-大天母,2023-03-17,9893
2891,中信金,72,32,40,元大-大天母,2023-03-17,9893
2881,富邦金,36,0,36,元大-大天母,2023-03-17,9893
2610,華航,40,10,30,元大-大天母,2023-03-17,9893
00712,復華富時不動產,30,0,30,元大-大天母,2023-03-17,9893
4976,佳凌,32,4,28,元大-大天母,2023-03-17,9893
2897,王道銀行,31,3,28,元大-大天母,2023-03-17,9893
00878,國泰永續高股息,37,10,27,元大-大天母,2023-03-17,9893
3048,益登,26,0,26,元大-大天母,2023-03-17,9893
2014,中鴻,27,2,25,元大-大天母,2023-03-17,9893
2031,新光鋼,33,8,25,元大-大天母,2023-03-17,9893
3207,耀勝,21,0,21,元大-大天母,2023-03-17,9893
00830,國泰費城半導體,29,9,20,元大-大天母,2023-03-17,9893
1316,上曜,20,1,19,元大-大天母,2023-03-17,9893
1319,東陽,13,0,13,元大-大天母,2023-03-17,9893
2548,華固,13,0,13,元大-大天母,2023-03-17,9893
0056,元大高股息,14,2,12,元大-大天母,2023-03-17,9893
00670L,富邦NASDAQ正2,12,0,12,元大-大天母,2023-03-17,9893
1101,台泥,13,1,12,元大-大天母,2023-03-17,9893
2328,廣宇,12,0,12,元大-大天母,2023-03-17,9893
3481,群創,79,67,12,元大-大天母,2023-03-17,9893
2027,大成鋼,13,1,12,元大-大天母,2023-03-17,9893
5483,中美晶,11,0,11,元大-大天母,2023-03-17,9893
2884,玉山金,11,0,11,元大-大天母,2023-03-17,9893
2614,東森,11,0,11,元大-大天母,2023-03-17,9893
3264,欣銓,18,7,11,元大-大天母,2023-03-17,9893
2880,華南金,11,0,11,元大-大天母,2023-03-17,9893
2481,強茂,11,1,10,元大-大天母,2023-03-17,9893
4966,譜瑞-KY,46,36,10,元大-大天母,2023-03-17,9893
2105,正新,10,0,10,元大-大天母,2023-03-17,9893
1813,寶利徠,10,0,10,元大-大天母,2023-03-17,9893
2030,彰源,10,0,10,元大-大天母,2023-03-17,9893
3540,曜越,10,0,10,元大-大天母,2023-03-17,9893
2468,華經,10,0,10,元大-大天母,2023-03-17,9893
3010,華立,11,1,10,元大-大天母,2023-03-17,9893
5340,建榮,10,0,10,元大-大天母,2023-03-17,9893
00679B,元大美債20年,10,1,9,元大-大天母,2023-03-17,9893
00902,中信電池及儲能,9,0,9,元大-大天母,2023-03-17,9893
2887,台新金,10,1,9,元大-大天母,2023-03-17,9893
3374,精材,9,0,9,元大-大天母,2023-03-17,9893
3189,景碩,9,0,9,元大-大天母,2023-03-17,9893
3708,上緯投控,9,0,9,元大-大天母,2023-03-17,9893
2382,廣達,12,4,8,元大-大天母,2023-03-17,9893
00632R,元大台灣50反1,499,0,499,元大-大天母,2023-03-20,9893
2892,第一金,110,1,109,元大-大天母,2023-03-20,9893
00715L,期街口布蘭特正2,72,0,72,元大-大天母,2023-03-20,9893
2748,雲品,72,3,69,元大-大天母,2023-03-20,9893
00878,國泰永續高股息,80,13,67,元大-大天母,2023-03-20,9893
3017,奇鋐,62,3,59,元大-大天母,2023-03-20,9893
2845,遠東銀,50,2,48,元大-大天母,2023-03-20,9893
3545,敦泰,44,5,39,元大-大天母,2023-03-20,9893
4977,眾達-KY,36,2,34,元大-大天母,2023-03-20,9893
3078,僑威,30,0,30,元大-大天母,2023-03-20,9893
00772B,中信高評級公司債,28,0,28,元大-大天母,2023-03-20,9893
3030,德律,25,0,25,元大-大天母,2023-03-20,9893
1605,華新,38,13,25,元大-大天母,2023-03-20,9893
8222,寶一,32,9,23,元大-大天母,2023-03-20,9893
00680L,元大美債20正2,26,4,22,元大-大天母,2023-03-20,9893
6244,茂迪,48,28,20,元大-大天母,2023-03-20,9893
8358,金居,20,0,20,元大-大天母,2023-03-20,9893
1432,大魯閣,20,1,19,元大-大天母,2023-03-20,9893
1529,樂事綠能,27,8,19,元大-大天母,2023-03-20,9893
2402,毅嘉,16,0,16,元大-大天母,2023-03-20,9893
00642U,期元大S＆P石油,16,0,16,元大-大天母,2023-03-20,9893
1712,興農,16,0,16,元大-大天母,2023-03-20,9893
2330,台積電,16,0,16,元大-大天母,2023-03-20,9893
1813,寶利徠,15,0,15,元大-大天母,2023-03-20,9893
00888,永豐台灣ESG,15,0,15,元大-大天母,2023-03-20,9893
2882,國泰金,34,20,14,元大-大天母,2023-03-20,9893
00885,富邦越南,27,13,14,元大-大天母,2023-03-20,9893
2883,凱基金,16,2,14,元大-大天母,2023-03-20,9893
3031,佰鴻,14,0,14,元大-大天母,2023-03-20,9893
3661,世芯-KY,17,3,14,元大-大天母,2023-03-20,9893
2881,富邦金,12,0,12,元大-大天母,2023-03-20,9893
5225,東科-KY,12,0,12,元大-大天母,2023-03-20,9893
00633L,富邦上証正2,12,0,12,元大-大天母,2023-03-20,9893
6719,力智,19,7,12,元大-大天母,2023-03-20,9893
2603,長榮,15,4,11,元大-大天母,2023-03-20,9893
3432,台端,11,0,11,元大-大天母,2023-03-20,9893
00637L,元大滬深300正2,11,0,11,元大-大天母,2023-03-20,9893
6770,力積電,11,1,10,元大-大天母,2023-03-20,9893
2539,櫻花建,10,0,10,元大-大天母,2023-03-20,9893
8050,廣積,11,1,10,元大-大天母,2023-03-20,9893
2312,金寶,10,0,10,元大-大天母,2023-03-20,9893
2851,中再保,10,0,10,元大-大天母,2023-03-20,9893
00751B,元大AAA至A公司債,9,0,9,元大-大天母,2023-03-20,9893
00679B,元大美債20年,19,10,9,元大-大天母,2023-03-20,9893
3576,聯合再生,12,3,9,元大-大天母,2023-03-20,9893
2103,台橡,8,0,8,元大-大天母,2023-03-20,9893
1609,大亞,7,0,7,元大-大天母,2023-03-20,9893
00720B,元大投資級公司債,16,9,7,元大-大天母,2023-03-20,9893
1903,士紙,7,0,7,元大-大天母,2023-03-20,9893
5607,遠雄港,7,0,7,元大-大天母,2023-03-20,9893
2409,友達,1009,1,1008,元大-大天母,2023-03-21,9893
2609,陽明,119,3,116,元大-大天母,2023-03-21,9893
00688L,國泰20年美債正2,101,0,101,元大-大天母,2023-03-21,9893
00632R,元大台灣50反1,105,35,70,元大-大天母,2023-03-21,9893
3029,零壹,73,21,52,元大-大天母,2023-03-21,9893
2413,環科,54,3,51,元大-大天母,2023-03-21,9893
2104,國際中橡,50,0,50,元大-大天母,2023-03-21,9893
9942,茂順,50,0,50,元大-大天母,2023-03-21,9893
00878,國泰永續高股息,47,8,39,元大-大天母,2023-03-21,9893
2303,聯電,43,7,36,元大-大天母,2023-03-21,9893
6207,雷科,30,0,30,元大-大天母,2023-03-21,9893
2485,兆赫,30,0,30,元大-大天母,2023-03-21,9893
00751B,元大AAA至A公司債,23,0,23,元大-大天母,2023-03-21,9893
5203,訊連,24,1,23,元大-大天母,2023-03-21,9893
1707,葡萄王,20,0,20,元大-大天母,2023-03-21,9893
3017,奇鋐,34,15,19,元大-大天母,2023-03-21,9893
5425,台半,30,11,19,元大-大天母,2023-03-21,9893
2520,冠德,23,5,18,元大-大天母,2023-03-21,9893
4934,太極,18,1,17,元大-大天母,2023-03-21,9893
6160,欣技,21,4,17,元大-大天母,2023-03-21,9893
6189,豐藝,17,0,17,元大-大天母,2023-03-21,9893
4746,台耀,16,0,16,元大-大天母,2023-03-21,9893
6245,立端,69,55,14,元大-大天母,2023-03-21,9893
2302,麗正,15,1,14,元大-大天母,2023-03-21,9893
2453,凌群,36,22,14,元大-大天母,2023-03-21,9893
2368,金像電,25,12,13,元大-大天母,2023-03-21,9893
6244,茂迪,54,42,12,元大-大天母,2023-03-21,9893
1432,大魯閣,12,0,12,元大-大天母,2023-03-21,9893
3162,精確,21,9,12,元大-大天母,2023-03-21,9893
2891,中信金,12,1,11,元大-大天母,2023-03-21,9893
1219,福壽,13,2,11,元大-大天母,2023-03-21,9893
6443,元晶,24,13,11,元大-大天母,2023-03-21,9893
5701,劍湖山,10,0,10,元大-大天母,2023-03-21,9893
00669R,國泰美國道瓊反1,10,0,10,元大-大天母,2023-03-21,9893
9105,泰金寶-DR,10,0,10,元大-大天母,2023-03-21,9893
00712,復華富時不動產,10,0,10,元大-大天母,2023-03-21,9893
2704,國賓,10,0,10,元大-大天母,2023-03-21,9893
00720B,元大投資級公司債,10,0,10,元大-大天母,2023-03-21,9893
2458,義隆,10,0,10,元大-大天母,2023-03-21,9893
2323,中環,10,0,10,元大-大天母,2023-03-21,9893
00917,中信特選金融,10,0,10,元大-大天母,2023-03-21,9893
3004,豐達科,10,0,10,元大-大天母,2023-03-21,9893
6442,光聖,10,0,10,元大-大天母,2023-03-21,9893
6140,訊達,10,0,10,元大-大天母,2023-03-21,9893
2727,王品,10,1,9,元大-大天母,2023-03-21,9893
3481,群創,51,42,9,元大-大天母,2023-03-21,9893
6188,廣明,15,6,9,元大-大天母,2023-03-21,9893
3322,建舜電,8,0,8,元大-大天母,2023-03-21,9893
2834,臺企銀,27,19,8,元大-大天母,2023-03-21,9893
00882,中信中國高股息,8,0,8,元大-大天母,2023-03-21,9893
5465,富驊,590,1,589,元大-大天母,2023-03-22,9893
6288,聯嘉,135,18,117,元大-大天母,2023-03-22,9893
6443,元晶,97,2,95,元大-大天母,2023-03-22,9893
2368,金像電,102,18,84,元大-大天母,2023-03-22,9893
2344,華邦電,74,2,72,元大-大天母,2023-03-22,9893
8121,越峰,66,0,66,元大-大天母,2023-03-22,9893
1101,台泥,55,0,55,元大-大天母,2023-03-22,9893
1314,中石化,50,1,49,元大-大天母,2023-03-22,9893
3030,德律,37,0,37,元大-大天母,2023-03-22,9893
00885,富邦越南,34,0,34,元大-大天母,2023-03-22,9893
00720B,元大投資級公司債,43,10,33,元大-大天母,2023-03-22,9893
2545,皇翔,30,0,30,元大-大天母,2023-03-22,9893
00706L,期元大S＆P日圓正2,30,0,30,元大-大天母,2023-03-22,9893
2228,劍麟,30,0,30,元大-大天母,2023-03-22,9893
1524,耿鼎,50,23,27,元大-大天母,2023-03-22,9893
3306,鼎天,26,0,26,元大-大天母,2023-03-22,9893
6153,嘉聯益,26,0,26,元大-大天母,2023-03-22,9893
3071,協禧,25,0,25,元大-大天母,2023-03-22,9893
2363,矽統,25,0,25,元大-大天母,2023-03-22,9893
4934,太極,28,6,22,元大-大天母,2023-03-22,9893
6122,擎邦,26,4,22,元大-大天母,2023-03-22,9893
2455,全新,21,0,21,元大-大天母,2023-03-22,9893
6276,安鈦克,20,0,20,元大-大天母,2023-03-22,9893
3680,家登,20,1,19,元大-大天母,2023-03-22,9893
00679B,元大美債20年,22,4,18,元大-大天母,2023-03-22,9893
3622,洋華,18,0,18,元大-大天母,2023-03-22,9893
3264,欣銓,20,3,17,元大-大天母,2023-03-22,9893
00892,富邦台灣半導體,17,0,17,元大-大天母,2023-03-22,9893
1219,福壽,17,1,16,元大-大天母,2023-03-22,9893
2409,友達,15,0,15,元大-大天母,2023-03-22,9893
1813,寶利徠,15,0,15,元大-大天母,2023-03-22,9893
1326,台化,15,0,15,元大-大天母,2023-03-22,9893
4973,廣穎,15,0,15,元大-大天母,2023-03-22,9893
3047,訊舟,15,1,14,元大-大天母,2023-03-22,9893
6189,豐藝,14,0,14,元大-大天母,2023-03-22,9893
2328,廣宇,15,2,13,元大-大天母,2023-03-22,9893
2332,友訊,12,0,12,元大-大天母,2023-03-22,9893
3038,全台,28,16,12,元大-大天母,2023-03-22,9893
2354,鴻準,12,0,12,元大-大天母,2023-03-22,9893
3673,TPK-KY,17,5,12,元大-大天母,2023-03-22,9893
00724B,群益投資級金融債,12,0,12,元大-大天母,2023-03-22,9893
00878,國泰永續高股息,31,19,12,元大-大天母,2023-03-22,9893
8046,南電,18,7,11,元大-大天母,2023-03-22,9893
2401,凌陽,11,0,11,元大-大天母,2023-03-22,9893
3481,群創,11,0,11,元大-大天母,2023-03-22,9893
2481,強茂,25,14,11,元大-大天母,2023-03-22,9893
00923,群益台ESG低碳50,10,0,10,元大-大天母,2023-03-22,9893
00753L,中信中國50正2,20,10,10,元大-大天母,2023-03-22,9893
3666,光耀,10,0,10,元大-大天母,2023-03-22,9893
3664,安瑞-KY,10,0,10,元大-大天母,2023-03-22,9893
00632R,元大台灣50反1,532,11,521,元大-大天母,2023-03-23,9893
4550,長佳,334,0,334,元大-大天母,2023-03-23,9893
3030,德律,118,0,118,元大-大天母,2023-03-23,9893
3491,昇達科,100,0,100,元大-大天母,2023-03-23,9893
2027,大成鋼,85,5,80,元大-大天母,2023-03-23,9893
00720B,元大投資級公司債,73,2,71,元大-大天母,2023-03-23,9893
1504,東元,147,77,70,元大-大天母,2023-03-23,9893
3481,群創,66,3,63,元大-大天母,2023-03-23,9893
3710,連展投控,61,3,58,元大-大天母,2023-03-23,9893
4744,皇將,50,0,50,元大-大天母,2023-03-23,9893
3260,威剛,80,30,50,元大-大天母,2023-03-23,9893
2401,凌陽,40,0,40,元大-大天母,2023-03-23,9893
00898,國泰基因免疫革命,33,2,31,元大-大天母,2023-03-23,9893
3653,健策,30,2,28,元大-大天母,2023-03-23,9893
3322,建舜電,31,4,27,元大-大天母,2023-03-23,9893
2402,毅嘉,60,35,25,元大-大天母,2023-03-23,9893
8069,元太,26,2,24,元大-大天母,2023-03-23,9893
2228,劍麟,20,0,20,元大-大天母,2023-03-23,9893
3715,定穎投控,20,0,20,元大-大天母,2023-03-23,9893
6233,旺玖,21,2,19,元大-大天母,2023-03-23,9893
3013,晟銘電,18,0,18,元大-大天母,2023-03-23,9893
5351,鈺創,32,15,17,元大-大天母,2023-03-23,9893
3290,東浦,15,0,15,元大-大天母,2023-03-23,9893
8415,大國鋼,15,0,15,元大-大天母,2023-03-23,9893
3443,創意,24,10,14,元大-大天母,2023-03-23,9893
1513,中興電,18,5,13,元大-大天母,2023-03-23,9893
00637L,元大滬深300正2,15,2,13,元大-大天母,2023-03-23,9893
2634,漢翔,21,8,13,元大-大天母,2023-03-23,9893
3081,聯亞,14,1,13,元大-大天母,2023-03-23,9893
8050,廣積,17,4,13,元大-大天母,2023-03-23,9893
2030,彰源,12,0,12,元大-大天母,2023-03-23,9893
9942,茂順,12,0,12,元大-大天母,2023-03-23,9893
00679B,元大美債20年,12,0,12,元大-大天母,2023-03-23,9893
2606,裕民,17,6,11,元大-大天母,2023-03-23,9893
6182,合晶,12,1,11,元大-大天母,2023-03-23,9893
1453,大將,14,3,11,元大-大天母,2023-03-23,9893
6282,康舒,15,5,10,元大-大天母,2023-03-23,9893
1591,駿吉-KY,10,0,10,元大-大天母,2023-03-23,9893
6276,安鈦克,12,2,10,元大-大天母,2023-03-23,9893
2497,怡利電,10,0,10,元大-大天母,2023-03-23,9893
00712,復華富時不動產,10,0,10,元大-大天母,2023-03-23,9893
8099,大世科,10,0,10,元大-大天母,2023-03-23,9893
2428,興勤,9,0,9,元大-大天母,2023-03-23,9893
1342,八貫,9,0,9,元大-大天母,2023-03-23,9893
8431,匯鑽科,11,2,9,元大-大天母,2023-03-23,9893
00900,富邦特選高股息30,10,1,9,元大-大天母,2023-03-23,9893
3363,上詮,11,2,9,元大-大天母,2023-03-23,9893
2338,光罩,10,2,8,元大-大天母,2023-03-23,9893
1460,宏遠,8,0,8,元大-大天母,2023-03-23,9893
8176,智捷,8,0,8,元大-大天母,2023-03-23,9893
4550,長佳,126,0,126,元大-大天母,2023-03-24,9893
1101,台泥,106,2,104,元大-大天母,2023-03-24,9893
3260,威剛,101,5,96,元大-大天母,2023-03-24,9893
5289,宜鼎,61,1,60,元大-大天母,2023-03-24,9893
1603,華電,49,0,49,元大-大天母,2023-03-24,9893
00753L,中信中國50正2,61,15,46,元大-大天母,2023-03-24,9893
1609,大亞,70,26,44,元大-大天母,2023-03-24,9893
3715,定穎投控,51,8,43,元大-大天母,2023-03-24,9893
2618,長榮航,55,14,41,元大-大天母,2023-03-24,9893
5603,陸海,30,0,30,元大-大天母,2023-03-24,9893
2367,燿華,30,2,28,元大-大天母,2023-03-24,9893
2520,冠德,28,0,28,元大-大天母,2023-03-24,9893
00892,富邦台灣半導體,27,0,27,元大-大天母,2023-03-24,9893
3094,聯傑,36,9,27,元大-大天母,2023-03-24,9893
2303,聯電,43,16,27,元大-大天母,2023-03-24,9893
0056,元大高股息,34,8,26,元大-大天母,2023-03-24,9893
1402,遠東新,25,0,25,元大-大天母,2023-03-24,9893
2515,中工,24,0,24,元大-大天母,2023-03-24,9893
5284,jpp-KY,223,200,23,元大-大天母,2023-03-24,9893
3441,聯一光,34,12,22,元大-大天母,2023-03-24,9893
6245,立端,139,119,20,元大-大天母,2023-03-24,9893
3322,建舜電,20,0,20,元大-大天母,2023-03-24,9893
2634,漢翔,24,4,20,元大-大天母,2023-03-24,9893
2107,厚生,20,0,20,元大-大天母,2023-03-24,9893
1307,三芳,20,0,20,元大-大天母,2023-03-24,9893
8222,寶一,23,3,20,元大-大天母,2023-03-24,9893
00712,復華富時不動產,21,2,19,元大-大天母,2023-03-24,9893
2882,國泰金,19,0,19,元大-大天母,2023-03-24,9893
2472,立隆電,20,2,18,元大-大天母,2023-03-24,9893
2609,陽明,22,6,16,元大-大天母,2023-03-24,9893
00720B,元大投資級公司債,15,0,15,元大-大天母,2023-03-24,9893
2891,中信金,15,0,15,元大-大天母,2023-03-24,9893
6276,安鈦克,15,0,15,元大-大天母,2023-03-24,9893
2228,劍麟,15,0,15,元大-大天母,2023-03-24,9893
8099,大世科,15,0,15,元大-大天母,2023-03-24,9893
3714,富采,66,53,13,元大-大天母,2023-03-24,9893
2834,臺企銀,21,8,13,元大-大天母,2023-03-24,9893
00637L,元大滬深300正2,23,10,13,元大-大天母,2023-03-24,9893
00902,中信電池及儲能,12,0,12,元大-大天母,2023-03-24,9893
6213,聯茂,17,6,11,元大-大天母,2023-03-24,9893
2313,華通,21,10,11,元大-大天母,2023-03-24,9893
00679B,元大美債20年,22,11,11,元大-大天母,2023-03-24,9893
2883B,凱基金乙特,11,0,11,元大-大天母,2023-03-24,9893
2886,兆豐金,12,2,10,元大-大天母,2023-03-24,9893
1338,廣華-KY,10,0,10,元大-大天母,2023-03-24,9893
2486,一詮,10,0,10,元大-大天母,2023-03-24,9893
8088,品安,14,4,10,元大-大天母,2023-03-24,9893
3217,優群,23,13,10,元大-大天母,2023-03-24,9893
2915,潤泰全,10,0,10,元大-大天母,2023-03-24,9893
2451,創見,10,0,10,元大-大天母,2023-03-24,9893
4904,遠傳,350,0,350,元大-大天母,2023-03-27,9893
2371,大同,154,2,152,元大-大天母,2023-03-27,9893
1605,華新,108,26,82,元大-大天母,2023-03-27,9893
5284,jpp-KY,114,38,76,元大-大天母,2023-03-27,9893
1101,台泥,70,0,70,元大-大天母,2023-03-27,9893
3715,定穎投控,67,13,54,元大-大天母,2023-03-27,9893
00680L,元大美債20正2,33,2,31,元大-大天母,2023-03-27,9893
3231,緯創,40,9,31,元大-大天母,2023-03-27,9893
6153,嘉聯益,30,0,30,元大-大天母,2023-03-27,9893
6177,達麗,28,0,28,元大-大天母,2023-03-27,9893
2201,裕隆,43,16,27,元大-大天母,2023-03-27,9893
6226,光鼎,36,10,26,元大-大天母,2023-03-27,9893
00882,中信中國高股息,44,20,24,元大-大天母,2023-03-27,9893
3714,富采,30,6,24,元大-大天母,2023-03-27,9893
2354,鴻準,24,0,24,元大-大天母,2023-03-27,9893
6134,萬旭,24,0,24,元大-大天母,2023-03-27,9893
2328,廣宇,26,2,24,元大-大天母,2023-03-27,9893
2344,華邦電,66,42,24,元大-大天母,2023-03-27,9893
2606,裕民,22,0,22,元大-大天母,2023-03-27,9893
5381,合正,21,0,21,元大-大天母,2023-03-27,9893
2228,劍麟,20,0,20,元大-大天母,2023-03-27,9893
5425,台半,34,15,19,元大-大天母,2023-03-27,9893
6443,元晶,103,85,18,元大-大天母,2023-03-27,9893
3481,群創,18,0,18,元大-大天母,2023-03-27,9893
3071,協禧,16,0,16,元大-大天母,2023-03-27,9893
3031,佰鴻,16,0,16,元大-大天母,2023-03-27,9893
00753L,中信中國50正2,18,3,15,元大-大天母,2023-03-27,9893
3499,環天科,15,0,15,元大-大天母,2023-03-27,9893
2520,冠德,15,0,15,元大-大天母,2023-03-27,9893
3035,智原,32,18,14,元大-大天母,2023-03-27,9893
5512,力麒,12,0,12,元大-大天母,2023-03-27,9893
5475,德宏,12,0,12,元大-大天母,2023-03-27,9893
1513,中興電,15,3,12,元大-大天母,2023-03-27,9893
6733,博晟生醫,12,0,12,元大-大天母,2023-03-27,9893
00751B,元大AAA至A公司債,12,0,12,元大-大天母,2023-03-27,9893
8071,能率網通,12,0,12,元大-大天母,2023-03-27,9893
2482,連宇,68,56,12,元大-大天母,2023-03-27,9893
8938,明安,11,0,11,元大-大天母,2023-03-27,9893
4974,亞泰,10,0,10,元大-大天母,2023-03-27,9893
00720B,元大投資級公司債,10,0,10,元大-大天母,2023-03-27,9893
2014,中鴻,10,0,10,元大-大天母,2023-03-27,9893
2883B,凱基金乙特,10,0,10,元大-大天母,2023-03-27,9893
4977,眾達-KY,10,0,10,元大-大天母,2023-03-27,9893
2834,臺企銀,30,20,10,元大-大天母,2023-03-27,9893
2515,中工,10,0,10,元大-大天母,2023-03-27,9893
2438,翔耀,10,0,10,元大-大天母,2023-03-27,9893
5388,中磊,10,0,10,元大-大天母,2023-03-27,9893
6806,森崴能源,13,3,10,元大-大天母,2023-03-27,9893
5905,南仁湖,10,0,10,元大-大天母,2023-03-27,9893
3653,健策,15,5,10,元大-大天母,2023-03-27,9893
3030,德律,179,0,179,元大-大天母,2023-03-28,9893
5381,合正,100,0,100,元大-大天母,2023-03-28,9893
1605,華新,127,30,97,元大-大天母,2023-03-28,9893
2204,中華,100,6,94,元大-大天母,2023-03-28,9893
2371,大同,72,14,58,元大-大天母,2023-03-28,9893
5425,台半,82,31,51,元大-大天母,2023-03-28,9893
3605,宏致,50,0,50,元大-大天母,2023-03-28,9893
6153,嘉聯益,36,0,36,元大-大天母,2023-03-28,9893
3218,大學光,38,3,35,元大-大天母,2023-03-28,9893
2303,聯電,34,1,33,元大-大天母,2023-03-28,9893
1101,台泥,36,4,32,元大-大天母,2023-03-28,9893
2401,凌陽,31,0,31,元大-大天母,2023-03-28,9893
6026,福邦證,27,0,27,元大-大天母,2023-03-28,9893
3499,環天科,25,0,25,元大-大天母,2023-03-28,9893
2640,大車隊,22,0,22,元大-大天母,2023-03-28,9893
5011,久陽,22,0,22,元大-大天母,2023-03-28,9893
2472,立隆電,21,0,21,元大-大天母,2023-03-28,9893
3380,明泰,20,1,19,元大-大天母,2023-03-28,9893
2481,強茂,54,35,19,元大-大天母,2023-03-28,9893
3264,欣銓,22,4,18,元大-大天母,2023-03-28,9893
00882,中信中國高股息,17,0,17,元大-大天母,2023-03-28,9893
3037,欣興,24,8,16,元大-大天母,2023-03-28,9893
6104,創惟,20,5,15,元大-大天母,2023-03-28,9893
3028,增你強,15,0,15,元大-大天母,2023-03-28,9893
6245,立端,17,2,15,元大-大天母,2023-03-28,9893
00679B,元大美債20年,16,1,15,元大-大天母,2023-03-28,9893
3224,三顧,14,0,14,元大-大天母,2023-03-28,9893
2637,慧洋-KY,13,0,13,元大-大天母,2023-03-28,9893
4432,銘旺實,13,0,13,元大-大天母,2023-03-28,9893
5521,工信,13,0,13,元大-大天母,2023-03-28,9893
2409,友達,13,0,13,元大-大天母,2023-03-28,9893
6558,興能高,13,0,13,元大-大天母,2023-03-28,9893
3703,欣陸,12,0,12,元大-大天母,2023-03-28,9893
2337,旺宏,12,0,12,元大-大天母,2023-03-28,9893
3702,大聯大,12,0,12,元大-大天母,2023-03-28,9893
3481,群創,12,1,11,元大-大天母,2023-03-28,9893
6288,聯嘉,22,11,11,元大-大天母,2023-03-28,9893
3025,星通,14,3,11,元大-大天母,2023-03-28,9893
3455,由田,11,0,11,元大-大天母,2023-03-28,9893
6235,華孚,17,6,11,元大-大天母,2023-03-28,9893
3260,威剛,12,1,11,元大-大天母,2023-03-28,9893
2883B,凱基金乙特,11,0,11,元大-大天母,2023-03-28,9893
1504,東元,25,14,11,元大-大天母,2023-03-28,9893
00655L,國泰中國A50正2,11,0,11,元大-大天母,2023-03-28,9893
2454,聯發科,12,1,11,元大-大天母,2023-03-28,9893
00720B,元大投資級公司債,11,0,11,元大-大天母,2023-03-28,9893
2497,怡利電,11,0,11,元大-大天母,2023-03-28,9893
3035,智原,31,21,10,元大-大天母,2023-03-28,9893
3033,威健,10,0,10,元大-大天母,2023-03-28,9893
4916,事欣科,10,0,10,元大-大天母,2023-03-28,9893
3034,聯詠,103,0,103,元大-大天母,2023-03-29,9893
0050,元大台灣50,91,1,90,元大-大天母,2023-03-29,9893
2303,聯電,111,45,66,元大-大天母,2023-03-29,9893
2371,大同,75,13,62,元大-大天母,2023-03-29,9893
3308,聯德,40,0,40,元大-大天母,2023-03-29,9893
1605,華新,48,10,38,元大-大天母,2023-03-29,9893
3218,大學光,39,1,38,元大-大天母,2023-03-29,9893
00632R,元大台灣50反1,40,4,36,元大-大天母,2023-03-29,9893
2640,大車隊,33,0,33,元大-大天母,2023-03-29,9893
2359,所羅門,33,2,31,元大-大天母,2023-03-29,9893
2481,強茂,35,5,30,元大-大天母,2023-03-29,9893
3617,碩天,30,0,30,元大-大天母,2023-03-29,9893
6270,倍微,30,1,29,元大-大天母,2023-03-29,9893
00679B,元大美債20年,22,0,22,元大-大天母,2023-03-29,9893
00885,富邦越南,44,22,22,元大-大天母,2023-03-29,9893
2401,凌陽,20,0,20,元大-大天母,2023-03-29,9893
3380,明泰,20,0,20,元大-大天母,2023-03-29,9893
5381,合正,18,0,18,元大-大天母,2023-03-29,9893
00882,中信中國高股息,17,0,17,元大-大天母,2023-03-29,9893
2609,陽明,18,2,16,元大-大天母,2023-03-29,9893
1307,三芳,15,0,15,元大-大天母,2023-03-29,9893
3272,東碩,14,0,14,元大-大天母,2023-03-29,9893
1708,東鹼,16,2,14,元大-大天母,2023-03-29,9893
1609,大亞,30,17,13,元大-大天母,2023-03-29,9893
00633L,富邦上証正2,12,0,12,元大-大天母,2023-03-29,9893
3483,力致,11,0,11,元大-大天母,2023-03-29,9893
1220,台榮,11,0,11,元大-大天母,2023-03-29,9893
3016,嘉晶,10,0,10,元大-大天母,2023-03-29,9893
00637L,元大滬深300正2,47,37,10,元大-大天母,2023-03-29,9893
6177,達麗,10,0,10,元大-大天母,2023-03-29,9893
2603,長榮,12,3,9,元大-大天母,2023-03-29,9893
00922,國泰台灣領袖50,9,0,9,元大-大天母,2023-03-29,9893
00720B,元大投資級公司債,8,0,8,元大-大天母,2023-03-29,9893
3356,奇偶,7,0,7,元大-大天母,2023-03-29,9893
6558,興能高,7,0,7,元大-大天母,2023-03-29,9893
2645,長榮航太,7,1,6,元大-大天母,2023-03-29,9893
1813,寶利徠,6,0,6,元大-大天母,2023-03-29,9893
3031,佰鴻,6,0,6,元大-大天母,2023-03-29,9893
2637,慧洋-KY,6,0,6,元大-大天母,2023-03-29,9893
9958,世紀鋼,6,0,6,元大-大天母,2023-03-29,9893
2545,皇翔,6,0,6,元大-大天母,2023-03-29,9893
3071,協禧,6,0,6,元大-大天母,2023-03-29,9893
2888,新光金,7,1,6,元大-大天母,2023-03-29,9893
2882,國泰金,6,0,6,元大-大天母,2023-03-29,9893
8076,伍豐,5,0,5,元大-大天母,2023-03-29,9893
1460,宏遠,5,0,5,元大-大天母,2023-03-29,9893
3152,璟德,5,0,5,元大-大天母,2023-03-29,9893
2498,宏達電,24,19,5,元大-大天母,2023-03-29,9893
1762,中化生,6,1,5,元大-大天母,2023-03-29,9893
2397,友通,5,0,5,元大-大天母,2023-03-29,9893
2883,凱基金,158,5,153,元大-大天母,2023-03-30,9893
2882,國泰金,102,0,102,元大-大天母,2023-03-30,9893
00632R,元大台灣50反1,90,0,90,元大-大天母,2023-03-30,9893
5309,系統電,85,6,79,元大-大天母,2023-03-30,9893
2515,中工,100,30,70,元大-大天母,2023-03-30,9893
3011,今皓,70,1,69,元大-大天母,2023-03-30,9893
6133,金橋,53,16,37,元大-大天母,2023-03-30,9893
2303,聯電,45,10,35,元大-大天母,2023-03-30,9893
4977,眾達-KY,44,12,32,元大-大天母,2023-03-30,9893
00753L,中信中國50正2,32,3,29,元大-大天母,2023-03-30,9893
3443,創意,30,4,26,元大-大天母,2023-03-30,9893
3033,威健,21,0,21,元大-大天母,2023-03-30,9893
5243,乙盛-KY,21,0,21,元大-大天母,2023-03-30,9893
2801,彰銀,20,0,20,元大-大天母,2023-03-30,9893
1813,寶利徠,20,0,20,元大-大天母,2023-03-30,9893
1605,華新,29,10,19,元大-大天母,2023-03-30,9893
3661,世芯-KY,17,0,17,元大-大天母,2023-03-30,9893
2881,富邦金,26,9,17,元大-大天母,2023-03-30,9893
2481,強茂,16,0,16,元大-大天母,2023-03-30,9893
1219,福壽,18,2,16,元大-大天母,2023-03-30,9893
2889,國票金,15,0,15,元大-大天母,2023-03-30,9893
2753,八方雲集,14,0,14,元大-大天母,2023-03-30,9893
00679B,元大美債20年,17,5,12,元大-大天母,2023-03-30,9893
1519,華城,17,5,12,元大-大天母,2023-03-30,9893
2344,華邦電,55,43,12,元大-大天母,2023-03-30,9893
3706,神達,12,0,12,元大-大天母,2023-03-30,9893
1752,南光,14,2,12,元大-大天母,2023-03-30,9893
6245,立端,23,12,11,元大-大天母,2023-03-30,9893
2424,隴華,10,0,10,元大-大天母,2023-03-30,9893
2493,揚博,10,0,10,元大-大天母,2023-03-30,9893
1517,利奇,10,0,10,元大-大天母,2023-03-30,9893
3308,聯德,10,0,10,元大-大天母,2023-03-30,9893
3059,華晶科,10,0,10,元大-大天母,2023-03-30,9893
2640,大車隊,10,0,10,元大-大天母,2023-03-30,9893
5381,合正,10,0,10,元大-大天母,2023-03-30,9893
6863,永道-KY,10,0,10,元大-大天母,2023-03-30,9893
5351,鈺創,11,1,10,元大-大天母,2023-03-30,9893
2748,雲品,18,9,9,元大-大天母,2023-03-30,9893
1909,榮成,10,1,9,元大-大天母,2023-03-30,9893
3617,碩天,8,0,8,元大-大天母,2023-03-30,9893
2427,三商電,8,0,8,元大-大天母,2023-03-30,9893
2890,永豐金,7,0,7,元大-大天母,2023-03-30,9893
6288,聯嘉,11,4,7,元大-大天母,2023-03-30,9893
2610,華航,7,0,7,元大-大天母,2023-03-30,9893
2867,三商壽,7,0,7,元大-大天母,2023-03-30,9893
6770,力積電,6,0,6,元大-大天母,2023-03-30,9893
00878,國泰永續高股息,24,18,6,元大-大天母,2023-03-30,9893
2888,新光金,6,0,6,元大-大天母,2023-03-30,9893
8086,宏捷科,15,9,6,元大-大天母,2023-03-30,9893
1437,勤益控,6,0,6,元大-大天母,2023-03-30,9893
5475,德宏,102,0,102,元大-大天母,2023-03-31,9893
1605,華新,96,9,87,元大-大天母,2023-03-31,9893
1477,聚陽,81,0,81,元大-大天母,2023-03-31,9893
5309,系統電,83,11,72,元大-大天母,2023-03-31,9893
2834,臺企銀,61,2,59,元大-大天母,2023-03-31,9893
4904,遠傳,50,2,48,元大-大天母,2023-03-31,9893
3006,晶豪科,71,24,47,元大-大天母,2023-03-31,9893
3711,日月光投控,33,1,32,元大-大天母,2023-03-31,9893
8299,群聯,31,3,28,元大-大天母,2023-03-31,9893
8110,華東,31,3,28,元大-大天母,2023-03-31,9893
2640,大車隊,25,0,25,元大-大天母,2023-03-31,9893
3088,艾訊,23,1,22,元大-大天母,2023-03-31,9893
6776,展�眥篕�,20,0,20,元大-大天母,2023-03-31,9893
2409,友達,20,4,16,元大-大天母,2023-03-31,9893
2243,宏旭-KY,16,0,16,元大-大天母,2023-03-31,9893
2337,旺宏,27,12,15,元大-大天母,2023-03-31,9893
00922,國泰台灣領袖50,15,0,15,元大-大天母,2023-03-31,9893
3624,光頡,20,5,15,元大-大天母,2023-03-31,9893
2002,中鋼,18,3,15,元大-大天母,2023-03-31,9893
2393,億光,14,0,14,元大-大天母,2023-03-31,9893
2753,八方雲集,17,3,14,元大-大天母,2023-03-31,9893
8050,廣積,24,11,13,元大-大天母,2023-03-31,9893
2344,華邦電,195,183,12,元大-大天母,2023-03-31,9893
3491,昇達科,14,2,12,元大-大天母,2023-03-31,9893
4976,佳凌,11,0,11,元大-大天母,2023-03-31,9893
2882,國泰金,11,1,10,元大-大天母,2023-03-31,9893
00646,元大S＆P500,10,0,10,元大-大天母,2023-03-31,9893
1338,廣華-KY,10,0,10,元大-大天母,2023-03-31,9893
2359,所羅門,10,0,10,元大-大天母,2023-03-31,9893
5381,合正,10,0,10,元大-大天母,2023-03-31,9893
6153,嘉聯益,10,0,10,元大-大天母,2023-03-31,9893
6753,龍德造船,10,0,10,元大-大天母,2023-03-31,9893
4755,三福化,9,0,9,元大-大天母,2023-03-31,9893
6290,良維,11,2,9,元大-大天母,2023-03-31,9893
2883,凱基金,9,0,9,元大-大天母,2023-03-31,9893
8155,博智,9,0,9,元大-大天母,2023-03-31,9893
00885,富邦越南,9,0,9,元大-大天母,2023-03-31,9893
2889,國票金,10,2,8,元大-大天母,2023-03-31,9893
1795,美時,9,1,8,元大-大天母,2023-03-31,9893
1513,中興電,16,8,8,元大-大天母,2023-03-31,9893
1314,中石化,8,0,8,元大-大天母,2023-03-31,9893
3090,日電貿,8,0,8,元大-大天母,2023-03-31,9893
2493,揚博,10,2,8,元大-大天母,2023-03-31,9893
3037,欣興,18,11,7,元大-大天母,2023-03-31,9893
6245,立端,12,5,7,元大-大天母,2023-03-31,9893
1720,生達,7,0,7,元大-大天母,2023-03-31,9893
4973,廣穎,10,3,7,元大-大天母,2023-03-31,9893
3093,港建*,7,0,7,元大-大天母,2023-03-31,9893
6835,圓裕,7,0,7,元大-大天母,2023-03-31,9893
1760,寶齡富錦,9,3,6,元大-大天母,2023-03-31,9893
1229,聯華,362,2,360,元大-大天母,2023-04-06,9893
1218,泰山,106,13,93,元大-大天母,2023-04-06,9893
00893,國泰智能電動車,68,0,68,元大-大天母,2023-04-06,9893
00720B,元大投資級公司債,66,4,62,元大-大天母,2023-04-06,9893
2344,華邦電,99,50,49,元大-大天母,2023-04-06,9893
00673R,期元大S＆P原油反1,45,0,45,元大-大天母,2023-04-06,9893
00713,元大台灣高息低波,45,1,44,元大-大天母,2023-04-06,9893
5905,南仁湖,41,0,41,元大-大天母,2023-04-06,9893
1314,中石化,40,0,40,元大-大天母,2023-04-06,9893
3178,公準,35,0,35,元大-大天母,2023-04-06,9893
2897,王道銀行,36,4,32,元大-大天母,2023-04-06,9893
00637L,元大滬深300正2,46,15,31,元大-大天母,2023-04-06,9893
00676R,富邦臺灣加權反1,30,0,30,元大-大天母,2023-04-06,9893
3703,欣陸,30,0,30,元大-大天母,2023-04-06,9893
1477,聚陽,32,2,30,元大-大天母,2023-04-06,9893
00753L,中信中國50正2,30,0,30,元大-大天母,2023-04-06,9893
00878,國泰永續高股息,37,7,30,元大-大天母,2023-04-06,9893
1813,寶利徠,30,1,29,元大-大天母,2023-04-06,9893
2606,裕民,36,7,29,元大-大天母,2023-04-06,9893
00902,中信電池及儲能,29,0,29,元大-大天母,2023-04-06,9893
6142,友勁,25,0,25,元大-大天母,2023-04-06,9893
00888,永豐台灣ESG,25,1,24,元大-大天母,2023-04-06,9893
3430,奇鈦科,25,1,24,元大-大天母,2023-04-06,9893
2317,鴻海,26,3,23,元大-大天母,2023-04-06,9893
2637,慧洋-KY,28,7,21,元大-大天母,2023-04-06,9893
2401,凌陽,20,0,20,元大-大天母,2023-04-06,9893
4130,健亞,20,0,20,元大-大天母,2023-04-06,9893
2017,官田鋼,20,0,20,元大-大天母,2023-04-06,9893
5381,合正,20,0,20,元大-大天母,2023-04-06,9893
1220,台榮,20,0,20,元大-大天母,2023-04-06,9893
1714,和桐,20,0,20,元大-大天母,2023-04-06,9893
006208,富邦台50,19,0,19,元大-大天母,2023-04-06,9893
6548,長科*,23,4,19,元大-大天母,2023-04-06,9893
3624,光頡,20,1,19,元大-大天母,2023-04-06,9893
2609,陽明,28,11,17,元大-大天母,2023-04-06,9893
5452,佶優,16,0,16,元大-大天母,2023-04-06,9893
2455,全新,16,0,16,元大-大天母,2023-04-06,9893
00891,中信關鍵半導體,16,0,16,元大-大天母,2023-04-06,9893
2444,兆勁,15,0,15,元大-大天母,2023-04-06,9893
1605,華新,32,17,15,元大-大天母,2023-04-06,9893
00751B,元大AAA至A公司債,15,0,15,元大-大天母,2023-04-06,9893
0050,元大台灣50,22,8,14,元大-大天母,2023-04-06,9893
00679B,元大美債20年,20,6,14,元大-大天母,2023-04-06,9893
4979,華星光,19,5,14,元大-大天母,2023-04-06,9893
00882,中信中國高股息,12,0,12,元大-大天母,2023-04-06,9893
2883,凱基金,12,0,12,元大-大天母,2023-04-06,9893
00772B,中信高評級公司債,12,0,12,元大-大天母,2023-04-06,9893
2331,精英,12,0,12,元大-大天母,2023-04-06,9893
2454,聯發科,12,0,12,元大-大天母,2023-04-06,9893
1560,中砂,14,3,11,元大-大天母,2023-04-06,9893
5452,佶優,116,13,103,元大-大天母,2023-04-07,9893
00676R,富邦臺灣加權反1,100,0,100,元大-大天母,2023-04-07,9893
4968,立積,100,8,92,元大-大天母,2023-04-07,9893
00720B,元大投資級公司債,91,2,89,元大-大天母,2023-04-07,9893
3207,耀勝,70,0,70,元大-大天母,2023-04-07,9893
1229,聯華,72,3,69,元大-大天母,2023-04-07,9893
00632R,元大台灣50反1,80,20,60,元大-大天母,2023-04-07,9893
6285,啟��,57,2,55,元大-大天母,2023-04-07,9893
1218,泰山,51,0,51,元大-大天母,2023-04-07,9893
4953,緯軟,51,2,49,元大-大天母,2023-04-07,9893
8420,明揚,36,0,36,元大-大天母,2023-04-07,9893
2867,三商壽,33,0,33,元大-大天母,2023-04-07,9893
8299,群聯,30,0,30,元大-大天母,2023-04-07,9893
3178,公準,25,1,24,元大-大天母,2023-04-07,9893
1301,台塑,23,1,22,元大-大天母,2023-04-07,9893
2356,英業達,26,5,21,元大-大天母,2023-04-07,9893
00751B,元大AAA至A公司債,25,4,21,元大-大天母,2023-04-07,9893
3704,合勤控,21,0,21,元大-大天母,2023-04-07,9893
3264,欣銓,25,5,20,元大-大天母,2023-04-07,9893
6197,佳必琪,26,7,19,元大-大天母,2023-04-07,9893
1504,東元,65,46,19,元大-大天母,2023-04-07,9893
3006,晶豪科,31,12,19,元大-大天母,2023-04-07,9893
2545,皇翔,19,0,19,元大-大天母,2023-04-07,9893
2376,技嘉,17,0,17,元大-大天母,2023-04-07,9893
00885,富邦越南,38,22,16,元大-大天母,2023-04-07,9893
2364,倫飛,16,0,16,元大-大天母,2023-04-07,9893
00633L,富邦上証正2,20,4,16,元大-大天母,2023-04-07,9893
1810,和成,18,3,15,元大-大天母,2023-04-07,9893
6698,旭暉應材,15,0,15,元大-大天母,2023-04-07,9893
3047,訊舟,15,0,15,元大-大天母,2023-04-07,9893
8071,能率網通,15,0,15,元大-大天母,2023-04-07,9893
2454,聯發科,15,1,14,元大-大天母,2023-04-07,9893
00712,復華富時不動產,13,0,13,元大-大天母,2023-04-07,9893
8383,千附,14,1,13,元大-大天母,2023-04-07,9893
4566,時碩工業,12,0,12,元大-大天母,2023-04-07,9893
2889,國票金,11,0,11,元大-大天母,2023-04-07,9893
5403,中菲,11,0,11,元大-大天母,2023-04-07,9893
4979,華星光,17,6,11,元大-大天母,2023-04-07,9893
6278,台表科,40,29,11,元大-大天母,2023-04-07,9893
3624,光頡,11,0,11,元大-大天母,2023-04-07,9893
3260,威剛,13,3,10,元大-大天母,2023-04-07,9893
2640,大車隊,10,0,10,元大-大天母,2023-04-07,9893
2618,長榮航,10,0,10,元大-大天母,2023-04-07,9893
1813,寶利徠,10,0,10,元大-大天母,2023-04-07,9893
3224,三顧,10,0,10,元大-大天母,2023-04-07,9893
2801,彰銀,10,0,10,元大-大天母,2023-04-07,9893
5388,中磊,9,0,9,元大-大天母,2023-04-07,9893
00637L,元大滬深300正2,33,24,9,元大-大天母,2023-04-07,9893
8271,宇瞻,12,3,9,元大-大天母,2023-04-07,9893
8227,巨有科技,10,2,8,元大-大天母,2023-04-07,9893
2885,元大金,104,0,104,元大-大天母,2023-04-10,9893
0056,元大高股息,105,6,99,元大-大天母,2023-04-10,9893
2402,毅嘉,69,2,67,元大-大天母,2023-04-10,9893
6278,台表科,69,8,61,元大-大天母,2023-04-10,9893
5603,陸海,60,0,60,元大-大天母,2023-04-10,9893
00680L,元大美債20正2,59,2,57,元大-大天母,2023-04-10,9893
2867,三商壽,57,0,57,元大-大天母,2023-04-10,9893
3034,聯詠,52,2,50,元大-大天母,2023-04-10,9893
00922,國泰台灣領袖50,50,0,50,元大-大天母,2023-04-10,9893
00676R,富邦臺灣加權反1,40,0,40,元大-大天母,2023-04-10,9893
2634,漢翔,54,15,39,元大-大天母,2023-04-10,9893
4746,台耀,49,11,38,元大-大天母,2023-04-10,9893
1605,華新,36,6,30,元大-大天母,2023-04-10,9893
1609,大亞,30,1,29,元大-大天母,2023-04-10,9893
8071,能率網通,25,0,25,元大-大天母,2023-04-10,9893
3711,日月光投控,23,0,23,元大-大天母,2023-04-10,9893
2317,鴻海,27,4,23,元大-大天母,2023-04-10,9893
00885,富邦越南,22,0,22,元大-大天母,2023-04-10,9893
4129,聯合,20,0,20,元大-大天母,2023-04-10,9893
00632R,元大台灣50反1,20,0,20,元大-大天母,2023-04-10,9893
2609,陽明,44,24,20,元大-大天母,2023-04-10,9893
1301,台塑,18,0,18,元大-大天母,2023-04-10,9893
1504,東元,56,39,17,元大-大天母,2023-04-10,9893
6276,安鈦克,20,3,17,元大-大天母,2023-04-10,9893
00679B,元大美債20年,17,1,16,元大-大天母,2023-04-10,9893
2640,大車隊,15,0,15,元大-大天母,2023-04-10,9893
2454,聯發科,15,2,13,元大-大天母,2023-04-10,9893
6770,力積電,14,1,13,元大-大天母,2023-04-10,9893
4171,瑞基,13,0,13,元大-大天母,2023-04-10,9893
1904,正隆,12,0,12,元大-大天母,2023-04-10,9893
8420,明揚,12,0,12,元大-大天母,2023-04-10,9893
3443,創意,17,6,11,元大-大天母,2023-04-10,9893
2881,富邦金,22,11,11,元大-大天母,2023-04-10,9893
00720B,元大投資級公司債,11,1,10,元大-大天母,2023-04-10,9893
8111,立��,10,0,10,元大-大天母,2023-04-10,9893
2850,新產,10,0,10,元大-大天母,2023-04-10,9893
3264,欣銓,10,0,10,元大-大天母,2023-04-10,9893
6197,佳必琪,16,6,10,元大-大天母,2023-04-10,9893
8121,越峰,10,0,10,元大-大天母,2023-04-10,9893
6477,安集,13,3,10,元大-大天母,2023-04-10,9893
6443,元晶,10,0,10,元大-大天母,2023-04-10,9893
8112,至上,12,2,10,元大-大天母,2023-04-10,9893
2344,華邦電,56,47,9,元大-大天母,2023-04-10,9893
00888,永豐台灣ESG,9,0,9,元大-大天母,2023-04-10,9893
00673R,期元大S＆P原油反1,9,0,9,元大-大天母,2023-04-10,9893
8028,昇陽半導體,12,3,9,元大-大天母,2023-04-10,9893
3661,世芯-KY,12,3,9,元大-大天母,2023-04-10,9893
6470,宇智,8,0,8,元大-大天母,2023-04-10,9893
2421,建準,8,0,8,元大-大天母,2023-04-10,9893
00655L,國泰中國A50正2,8,0,8,元大-大天母,2023-04-10,9893
2515,中工,100,6,94,元大-大天母,2023-04-11,9893
0056,元大高股息,88,10,78,元大-大天母,2023-04-11,9893
00878,國泰永續高股息,99,25,74,元大-大天母,2023-04-11,9893
2303,聯電,69,3,66,元大-大天母,2023-04-11,9893
3047,訊舟,52,0,52,元大-大天母,2023-04-11,9893
3034,聯詠,50,4,46,元大-大天母,2023-04-11,9893
3006,晶豪科,78,38,40,元大-大天母,2023-04-11,9893
00676R,富邦臺灣加權反1,40,0,40,元大-大天母,2023-04-11,9893
2640,大車隊,35,0,35,元大-大天母,2023-04-11,9893
2882,國泰金,45,12,33,元大-大天母,2023-04-11,9893
6245,立端,25,3,22,元大-大天母,2023-04-11,9893
00632R,元大台灣50反1,22,0,22,元大-大天母,2023-04-11,9893
3290,東浦,31,10,21,元大-大天母,2023-04-11,9893
3455,由田,20,0,20,元大-大天母,2023-04-11,9893
5603,陸海,20,0,20,元大-大天母,2023-04-11,9893
9904,寶成,20,1,19,元大-大天母,2023-04-11,9893
3545,敦泰,32,14,18,元大-大天母,2023-04-11,9893
2020,美亞,15,0,15,元大-大天母,2023-04-11,9893
8050,廣積,14,1,13,元大-大天母,2023-04-11,9893
2633,台灣高鐵,14,1,13,元大-大天母,2023-04-11,9893
6770,力積電,15,2,13,元大-大天母,2023-04-11,9893
00650L,復華香港正2,13,0,13,元大-大天母,2023-04-11,9893
00888,永豐台灣ESG,12,0,12,元大-大天母,2023-04-11,9893
6203,海韻電,12,0,12,元大-大天母,2023-04-11,9893
00679B,元大美債20年,17,6,11,元大-大天母,2023-04-11,9893
00680L,元大美債20正2,13,2,11,元大-大天母,2023-04-11,9893
2317,鴻海,26,15,11,元大-大天母,2023-04-11,9893
1813,寶利徠,10,0,10,元大-大天母,2023-04-11,9893
8183,精星,11,1,10,元大-大天母,2023-04-11,9893
4128,中天,11,1,10,元大-大天母,2023-04-11,9893
3312,弘憶股,10,0,10,元大-大天母,2023-04-11,9893
00720B,元大投資級公司債,10,0,10,元大-大天母,2023-04-11,9893
6005,群益證,10,0,10,元大-大天母,2023-04-11,9893
00637L,元大滬深300正2,12,2,10,元大-大天母,2023-04-11,9893
3479,安勤,15,6,9,元大-大天母,2023-04-11,9893
5871,中租-KY,10,1,9,元大-大天母,2023-04-11,9893
5284,jpp-KY,9,1,8,元大-大天母,2023-04-11,9893
5299,杰力,8,0,8,元大-大天母,2023-04-11,9893
00712,復華富時不動產,8,1,7,元大-大天母,2023-04-11,9893
00885,富邦越南,7,0,7,元大-大天母,2023-04-11,9893
006208,富邦台50,7,0,7,元大-大天母,2023-04-11,9893
1618,合機,8,1,7,元大-大天母,2023-04-11,9893
5353,台林,7,0,7,元大-大天母,2023-04-11,9893
3042,晶技,10,3,7,元大-大天母,2023-04-11,9893
4432,銘旺實,7,0,7,元大-大天母,2023-04-11,9893
2883,凱基金,7,0,7,元大-大天母,2023-04-11,9893
3029,零壹,11,5,6,元大-大天母,2023-04-11,9893
00648R,元大S＆P500反1,6,0,6,元大-大天母,2023-04-11,9893
2364,倫飛,7,1,6,元大-大天母,2023-04-11,9893
3094,聯傑,11,5,6,元大-大天母,2023-04-11,9893
6245,立端,176,2,174,元大-大天母,2023-04-12,9893
00673R,期元大S＆P原油反1,101,0,101,元大-大天母,2023-04-12,9893
2371,大同,119,18,101,元大-大天母,2023-04-12,9893
3264,欣銓,100,5,95,元大-大天母,2023-04-12,9893
00676R,富邦臺灣加權反1,70,0,70,元大-大天母,2023-04-12,9893
6282,康舒,62,3,59,元大-大天母,2023-04-12,9893
4904,遠傳,50,0,50,元大-大天母,2023-04-12,9893
1314,中石化,50,6,44,元大-大天母,2023-04-12,9893
00713,元大台灣高息低波,44,1,43,元大-大天母,2023-04-12,9893
2344,華邦電,69,30,39,元大-大天母,2023-04-12,9893
4746,台耀,44,7,37,元大-大天母,2023-04-12,9893
2609,陽明,47,10,37,元大-大天母,2023-04-12,9893
3015,全漢,35,0,35,元大-大天母,2023-04-12,9893
2358,廷鑫,32,0,32,元大-大天母,2023-04-12,9893
00637L,元大滬深300正2,27,0,27,元大-大天母,2023-04-12,9893
3011,今皓,30,5,25,元大-大天母,2023-04-12,9893
2330,台積電,26,1,25,元大-大天母,2023-04-12,9893
2812,台中銀,22,0,22,元大-大天母,2023-04-12,9893
00757,統一FANG+,20,0,20,元大-大天母,2023-04-12,9893
5469,瀚宇博,20,0,20,元大-大天母,2023-04-12,9893
5425,台半,29,10,19,元大-大天母,2023-04-12,9893
00712,復華富時不動產,18,0,18,元大-大天母,2023-04-12,9893
3518,柏騰,16,0,16,元大-大天母,2023-04-12,9893
4968,立積,24,9,15,元大-大天母,2023-04-12,9893
2454,聯發科,15,0,15,元大-大天母,2023-04-12,9893
6732,昇佳電子,15,1,14,元大-大天母,2023-04-12,9893
8088,品安,19,6,13,元大-大天母,2023-04-12,9893
6548,長科*,14,1,13,元大-大天母,2023-04-12,9893
2455,全新,16,3,13,元大-大天母,2023-04-12,9893
2367,燿華,13,1,12,元大-大天母,2023-04-12,9893
5388,中磊,13,1,12,元大-大天母,2023-04-12,9893
00891,中信關鍵半導體,12,0,12,元大-大天母,2023-04-12,9893
8033,雷虎,12,0,12,元大-大天母,2023-04-12,9893
3047,訊舟,11,0,11,元大-大天母,2023-04-12,9893
3027,盛達,13,2,11,元大-大天母,2023-04-12,9893
4155,訊映,14,3,11,元大-大天母,2023-04-12,9893
00878,國泰永續高股息,23,13,10,元大-大天母,2023-04-12,9893
3209,全科,21,11,10,元大-大天母,2023-04-12,9893
5381,合正,10,0,10,元大-大天母,2023-04-12,9893
1720,生達,12,2,10,元大-大天母,2023-04-12,9893
9105,泰金寶-DR,10,0,10,元大-大天母,2023-04-12,9893
1709,和益,10,0,10,元大-大天母,2023-04-12,9893
1219,福壽,14,4,10,元大-大天母,2023-04-12,9893
2233,宇隆,13,3,10,元大-大天母,2023-04-12,9893
00679B,元大美債20年,10,1,9,元大-大天母,2023-04-12,9893
3545,敦泰,22,13,9,元大-大天母,2023-04-12,9893
00902,中信電池及儲能,9,0,9,元大-大天母,2023-04-12,9893
1611,中電,12,3,9,元大-大天母,2023-04-12,9893
1513,中興電,70,61,9,元大-大天母,2023-04-12,9893
2317,鴻海,8,0,8,元大-大天母,2023-04-12,9893
6245,立端,160,4,156,元大-大天母,2023-04-13,9893
5353,台林,119,24,95,元大-大天母,2023-04-13,9893
6443,元晶,65,5,60,元大-大天母,2023-04-13,9893
1589,永冠-KY,60,0,60,元大-大天母,2023-04-13,9893
5381,合正,55,0,55,元大-大天母,2023-04-13,9893
1210,大成,62,8,54,元大-大天母,2023-04-13,9893
00673R,期元大S＆P原油反1,52,0,52,元大-大天母,2023-04-13,9893
1314,中石化,169,125,44,元大-大天母,2023-04-13,9893
00676R,富邦臺灣加權反1,40,0,40,元大-大天母,2023-04-13,9893
4904,遠傳,40,1,39,元大-大天母,2023-04-13,9893
3711,日月光投控,68,30,38,元大-大天母,2023-04-13,9893
8109,博大,35,0,35,元大-大天母,2023-04-13,9893
1217,愛之味,35,0,35,元大-大天母,2023-04-13,9893
0050,元大台灣50,38,3,35,元大-大天母,2023-04-13,9893
4968,立積,43,9,34,元大-大天母,2023-04-13,9893
3312,弘憶股,32,0,32,元大-大天母,2023-04-13,9893
2330,台積電,46,15,31,元大-大天母,2023-04-13,9893
1524,耿鼎,33,3,30,元大-大天母,2023-04-13,9893
1718,中纖,30,0,30,元大-大天母,2023-04-13,9893
1513,中興電,64,35,29,元大-大天母,2023-04-13,9893
9962,有益,29,1,28,元大-大天母,2023-04-13,9893
6026,福邦證,25,0,25,元大-大天母,2023-04-13,9893
00712,復華富時不動產,25,0,25,元大-大天母,2023-04-13,9893
6104,創惟,34,10,24,元大-大天母,2023-04-13,9893
00891,中信關鍵半導體,24,0,24,元大-大天母,2023-04-13,9893
8046,南電,23,0,23,元大-大天母,2023-04-13,9893
00679B,元大美債20年,23,0,23,元大-大天母,2023-04-13,9893
3545,敦泰,35,12,23,元大-大天母,2023-04-13,9893
5009,榮剛,42,19,23,元大-大天母,2023-04-13,9893
2454,聯發科,20,0,20,元大-大天母,2023-04-13,9893
1714,和桐,77,57,20,元大-大天母,2023-04-13,9893
5880,合庫金,20,0,20,元大-大天母,2023-04-13,9893
00888,永豐台灣ESG,20,0,20,元大-大天母,2023-04-13,9893
2892,第一金,24,4,20,元大-大天母,2023-04-13,9893
3576,聯合再生,73,54,19,元大-大天母,2023-04-13,9893
4977,眾達-KY,19,0,19,元大-大天母,2023-04-13,9893
2882,國泰金,43,25,18,元大-大天母,2023-04-13,9893
1504,東元,83,65,18,元大-大天母,2023-04-13,9893
2915,潤泰全,17,0,17,元大-大天母,2023-04-13,9893
8028,昇陽半導體,18,2,16,元大-大天母,2023-04-13,9893
3231,緯創,35,20,15,元大-大天母,2023-04-13,9893
006208,富邦台50,15,0,15,元大-大天母,2023-04-13,9893
8050,廣積,16,1,15,元大-大天母,2023-04-13,9893
3363,上詮,29,14,15,元大-大天母,2023-04-13,9893
00881,國泰台灣5G+,14,0,14,元大-大天母,2023-04-13,9893
00900,富邦特選高股息30,14,0,14,元大-大天母,2023-04-13,9893
1609,大亞,56,42,14,元大-大天母,2023-04-13,9893
00772B,中信高評級公司債,13,0,13,元大-大天母,2023-04-13,9893
4746,台耀,25,12,13,元大-大天母,2023-04-13,9893
1605,華新,31,18,13,元大-大天母,2023-04-13,9893
2705,六福,218,8,210,元大-大天母,2023-04-14,9893
3481,群創,135,13,122,元大-大天母,2023-04-14,9893
3015,全漢,133,59,74,元大-大天母,2023-04-14,9893
2303,聯電,89,22,67,元大-大天母,2023-04-14,9893
2748,雲品,88,25,63,元大-大天母,2023-04-14,9893
00632R,元大台灣50反1,100,40,60,元大-大天母,2023-04-14,9893
2867,三商壽,52,0,52,元大-大天母,2023-04-14,9893
2634,漢翔,92,50,42,元大-大天母,2023-04-14,9893
5603,陸海,41,0,41,元大-大天母,2023-04-14,9893
1504,東元,103,64,39,元大-大天母,2023-04-14,9893
2002,中鋼,39,1,38,元大-大天母,2023-04-14,9893
00679B,元大美債20年,40,4,36,元大-大天母,2023-04-14,9893
8084,巨虹,31,0,31,元大-大天母,2023-04-14,9893
2882,國泰金,43,12,31,元大-大天母,2023-04-14,9893
6443,元晶,51,20,31,元大-大天母,2023-04-14,9893
2881,富邦金,31,3,28,元大-大天母,2023-04-14,9893
2515,中工,34,9,25,元大-大天母,2023-04-14,9893
4968,立積,29,4,25,元大-大天母,2023-04-14,9893
5009,榮剛,37,13,24,元大-大天母,2023-04-14,9893
2382,廣達,28,5,23,元大-大天母,2023-04-14,9893
5607,遠雄港,23,0,23,元大-大天母,2023-04-14,9893
5498,凱崴,20,0,20,元大-大天母,2023-04-14,9893
1584,精剛,30,11,19,元大-大天母,2023-04-14,9893
3447,展達,20,1,19,元大-大天母,2023-04-14,9893
00680L,元大美債20正2,29,10,19,元大-大天母,2023-04-14,9893
3088,艾訊,20,1,19,元大-大天母,2023-04-14,9893
2356,英業達,18,1,17,元大-大天母,2023-04-14,9893
2368,金像電,26,9,17,元大-大天母,2023-04-14,9893
00712,復華富時不動產,15,0,15,元大-大天母,2023-04-14,9893
4147,中裕,20,6,14,元大-大天母,2023-04-14,9893
6509,聚和,19,5,14,元大-大天母,2023-04-14,9893
4541,晟田,37,24,13,元大-大天母,2023-04-14,9893
1720,生達,17,4,13,元大-大天母,2023-04-14,9893
1218,泰山,15,2,13,元大-大天母,2023-04-14,9893
1513,中興電,27,14,13,元大-大天母,2023-04-14,9893
00725B,國泰投資級公司債,12,0,12,元大-大天母,2023-04-14,9893
4746,台耀,11,0,11,元大-大天母,2023-04-14,9893
5425,台半,20,10,10,元大-大天母,2023-04-14,9893
2454,聯發科,12,2,10,元大-大天母,2023-04-14,9893
2501,國建,10,0,10,元大-大天母,2023-04-14,9893
8183,精星,10,0,10,元大-大天母,2023-04-14,9893
5403,中菲,10,0,10,元大-大天母,2023-04-14,9893
4174,浩鼎,10,0,10,元大-大天母,2023-04-14,9893
4938,和碩,11,1,10,元大-大天母,2023-04-14,9893
2891,中信金,10,0,10,元大-大天母,2023-04-14,9893
1714,和桐,10,0,10,元大-大天母,2023-04-14,9893
4306,炎洲,10,0,10,元大-大天母,2023-04-14,9893
6179,亞通,10,0,10,元大-大天母,2023-04-14,9893
2455,全新,11,1,10,元大-大天母,2023-04-14,9893
6732,昇佳電子,10,0,10,元大-大天母,2023-04-14,9893
6016,康和證,150,0,150,元大-大天母,2023-04-17,9893
1215,卜蜂,91,7,84,元大-大天母,2023-04-17,9893
6245,立端,76,5,71,元大-大天母,2023-04-17,9893
2312,金寶,62,1,61,元大-大天母,2023-04-17,9893
2634,漢翔,145,95,50,元大-大天母,2023-04-17,9893
2331,精英,51,3,48,元大-大天母,2023-04-17,9893
2610,華航,40,0,40,元大-大天母,2023-04-17,9893
00676R,富邦臺灣加權反1,40,0,40,元大-大天母,2023-04-17,9893
4526,東台,35,0,35,元大-大天母,2023-04-17,9893
1514,亞力,50,15,35,元大-大天母,2023-04-17,9893
1789,神隆,33,0,33,元大-大天母,2023-04-17,9893
00878,國泰永續高股息,36,5,31,元大-大天母,2023-04-17,9893
6282,康舒,40,9,31,元大-大天母,2023-04-17,9893
00772B,中信高評級公司債,31,0,31,元大-大天母,2023-04-17,9893
1783,和康生,31,0,31,元大-大天母,2023-04-17,9893
2705,六福,31,0,31,元大-大天母,2023-04-17,9893
00720B,元大投資級公司債,30,0,30,元大-大天母,2023-04-17,9893
2208,台船,159,131,28,元大-大天母,2023-04-17,9893
3025,星通,31,6,25,元大-大天母,2023-04-17,9893
8109,博大,25,0,25,元大-大天母,2023-04-17,9893
5381,合正,50,26,24,元大-大天母,2023-04-17,9893
00679B,元大美債20年,22,0,22,元大-大天母,2023-04-17,9893
1802,台玻,23,1,22,元大-大天母,2023-04-17,9893
4534,慶騰,20,0,20,元大-大天母,2023-04-17,9893
1813,寶利徠,20,0,20,元大-大天母,2023-04-17,9893
9945,潤泰新,20,1,19,元大-大天母,2023-04-17,9893
4114,健喬,20,1,19,元大-大天母,2023-04-17,9893
00712,復華富時不動產,19,0,19,元大-大天母,2023-04-17,9893
2002,中鋼,25,7,18,元大-大天母,2023-04-17,9893
5607,遠雄港,18,0,18,元大-大天母,2023-04-17,9893
1229,聯華,19,4,15,元大-大天母,2023-04-17,9893
1503,士電,18,4,14,元大-大天母,2023-04-17,9893
6182,合晶,14,0,14,元大-大天母,2023-04-17,9893
3059,華晶科,15,1,14,元大-大天母,2023-04-17,9893
3231,緯創,27,14,13,元大-大天母,2023-04-17,9893
2329,華泰,19,6,13,元大-大天母,2023-04-17,9893
3047,訊舟,15,2,13,元大-大天母,2023-04-17,9893
3029,零壹,49,36,13,元大-大天母,2023-04-17,9893
2355,敬鵬,13,0,13,元大-大天母,2023-04-17,9893
00888,永豐台灣ESG,13,0,13,元大-大天母,2023-04-17,9893
2454,聯發科,13,0,13,元大-大天母,2023-04-17,9893
2885,元大金,12,0,12,元大-大天母,2023-04-17,9893
6125,廣運,12,0,12,元大-大天母,2023-04-17,9893
2206,三陽工業,24,13,11,元大-大天母,2023-04-17,9893
1618,合機,11,0,11,元大-大天母,2023-04-17,9893
5410,國眾,11,0,11,元大-大天母,2023-04-17,9893
3481,群創,31,20,11,元大-大天母,2023-04-17,9893
2359,所羅門,18,7,11,元大-大天母,2023-04-17,9893
2834,臺企銀,21,10,11,元大-大天母,2023-04-17,9893
3207,耀勝,12,2,10,元大-大天母,2023-04-17,9893
2204,中華,141,3,138,元大-大天母,2023-04-18,9893
00878,國泰永續高股息,98,2,96,元大-大天母,2023-04-18,9893
5465,富驊,72,4,68,元大-大天母,2023-04-18,9893
2634,漢翔,99,31,68,元大-大天母,2023-04-18,9893
3231,緯創,69,8,61,元大-大天母,2023-04-18,9893
00688L,國泰20年美債正2,52,0,52,元大-大天母,2023-04-18,9893
8033,雷虎,105,62,43,元大-大天母,2023-04-18,9893
5607,遠雄港,45,2,43,元大-大天母,2023-04-18,9893
00720B,元大投資級公司債,41,0,41,元大-大天母,2023-04-18,9893
5309,系統電,39,0,39,元大-大天母,2023-04-18,9893
00633L,富邦上証正2,50,14,36,元大-大天母,2023-04-18,9893
00680L,元大美債20正2,33,2,31,元大-大天母,2023-04-18,9893
1802,台玻,31,0,31,元大-大天母,2023-04-18,9893
8109,博大,25,0,25,元大-大天母,2023-04-18,9893
6160,欣技,35,11,24,元大-大天母,2023-04-18,9893
3147,大綜,23,0,23,元大-大天母,2023-04-18,9893
00679B,元大美債20年,23,0,23,元大-大天母,2023-04-18,9893
8105,凌巨,21,0,21,元大-大天母,2023-04-18,9893
2515,中工,21,0,21,元大-大天母,2023-04-18,9893
5009,榮剛,32,11,21,元大-大天母,2023-04-18,9893
4934,太極,20,0,20,元大-大天母,2023-04-18,9893
00789B,復華公司債A3,19,0,19,元大-大天母,2023-04-18,9893
3481,群創,35,16,19,元大-大天母,2023-04-18,9893
00891,中信關鍵半導體,30,12,18,元大-大天母,2023-04-18,9893
2457,飛宏,138,121,17,元大-大天母,2023-04-18,9893
00673R,期元大S＆P原油反1,17,0,17,元大-大天母,2023-04-18,9893
1609,大亞,22,6,16,元大-大天母,2023-04-18,9893
6143,振曜,16,0,16,元大-大天母,2023-04-18,9893
2601,益航,26,10,16,元大-大天母,2023-04-18,9893
4743,合一,21,5,16,元大-大天母,2023-04-18,9893
2897,王道銀行,14,0,14,元大-大天母,2023-04-18,9893
00751B,元大AAA至A公司債,14,0,14,元大-大天母,2023-04-18,9893
6190,萬泰科,19,6,13,元大-大天母,2023-04-18,9893
5227,立凱-KY,13,0,13,元大-大天母,2023-04-18,9893
3624,光頡,21,8,13,元大-大天母,2023-04-18,9893
2382,廣達,15,2,13,元大-大天母,2023-04-18,9893
3059,華晶科,12,0,12,元大-大天母,2023-04-18,9893
6182,合晶,13,1,12,元大-大天母,2023-04-18,9893
00772B,中信高評級公司債,21,10,11,元大-大天母,2023-04-18,9893
2359,所羅門,22,11,11,元大-大天母,2023-04-18,9893
4304,勝昱,11,0,11,元大-大天母,2023-04-18,9893
3013,晟銘電,17,7,10,元大-大天母,2023-04-18,9893
1219,福壽,10,0,10,元大-大天母,2023-04-18,9893
3264,欣銓,10,0,10,元大-大天母,2023-04-18,9893
4161,聿新科,10,0,10,元大-大天母,2023-04-18,9893
2363,矽統,10,0,10,元大-大天母,2023-04-18,9893
4128,中天,10,0,10,元大-大天母,2023-04-18,9893
00757,統一FANG+,10,0,10,元大-大天母,2023-04-18,9893
1533,車王電,12,2,10,元大-大天母,2023-04-18,9893
1440,南紡,10,0,10,元大-大天母,2023-04-18,9893
3481,群創,162,28,134,元大-大天母,2023-04-19,9893
8111,立��,86,6,80,元大-大天母,2023-04-19,9893
2409,友達,69,4,65,元大-大天母,2023-04-19,9893
3058,立德,75,12,63,元大-大天母,2023-04-19,9893
2520,冠德,56,1,55,元大-大天母,2023-04-19,9893
3363,上詮,60,6,54,元大-大天母,2023-04-19,9893
6806,森崴能源,56,3,53,元大-大天母,2023-04-19,9893
00888,永豐台灣ESG,38,0,38,元大-大天母,2023-04-19,9893
3004,豐達科,65,28,37,元大-大天母,2023-04-19,9893
8440,綠電,36,0,36,元大-大天母,2023-04-19,9893
8069,元太,41,7,34,元大-大天母,2023-04-19,9893
2812,台中銀,33,0,33,元大-大天母,2023-04-19,9893
2748,雲品,49,17,32,元大-大天母,2023-04-19,9893
1447,力鵬,30,0,30,元大-大天母,2023-04-19,9893
6005,群益證,36,7,29,元大-大天母,2023-04-19,9893
6213,聯茂,40,13,27,元大-大天母,2023-04-19,9893
5607,遠雄港,26,1,25,元大-大天母,2023-04-19,9893
5603,陸海,25,0,25,元大-大天母,2023-04-19,9893
00878,國泰永續高股息,35,12,23,元大-大天母,2023-04-19,9893
3545,敦泰,23,0,23,元大-大天母,2023-04-19,9893
4510,高鋒,22,0,22,元大-大天母,2023-04-19,9893
3078,僑威,41,21,20,元大-大天母,2023-04-19,9893
2317,鴻海,40,22,18,元大-大天母,2023-04-19,9893
3264,欣銓,20,2,18,元大-大天母,2023-04-19,9893
8284,三竹,19,2,17,元大-大天母,2023-04-19,9893
6770,力積電,23,6,17,元大-大天母,2023-04-19,9893
2313,華通,16,0,16,元大-大天母,2023-04-19,9893
1813,寶利徠,16,0,16,元大-大天母,2023-04-19,9893
2884,玉山金,17,2,15,元大-大天母,2023-04-19,9893
2457,飛宏,53,38,15,元大-大天母,2023-04-19,9893
2344,華邦電,17,2,15,元大-大天母,2023-04-19,9893
3094,聯傑,27,12,15,元大-大天母,2023-04-19,9893
6488,環球晶,14,0,14,元大-大天母,2023-04-19,9893
00680L,元大美債20正2,14,0,14,元大-大天母,2023-04-19,9893
2498,宏達電,32,18,14,元大-大天母,2023-04-19,9893
2330,台積電,19,5,14,元大-大天母,2023-04-19,9893
8046,南電,14,1,13,元大-大天母,2023-04-19,9893
6182,合晶,14,1,13,元大-大天母,2023-04-19,9893
2886,兆豐金,17,4,13,元大-大天母,2023-04-19,9893
006208,富邦台50,13,0,13,元大-大天母,2023-04-19,9893
0056,元大高股息,13,0,13,元大-大天母,2023-04-19,9893
2645,長榮航太,12,0,12,元大-大天母,2023-04-19,9893
00891,中信關鍵半導體,12,0,12,元大-大天母,2023-04-19,9893
1514,亞力,13,1,12,元大-大天母,2023-04-19,9893
1802,台玻,12,0,12,元大-大天母,2023-04-19,9893
2887,台新金,12,0,12,元大-大天母,2023-04-19,9893
3059,華晶科,12,0,12,元大-大天母,2023-04-19,9893
00905,FT臺灣Smart,12,0,12,元大-大天母,2023-04-19,9893
9938,百和,11,0,11,元大-大天母,2023-04-19,9893
6205,詮欣,11,0,11,元大-大天母,2023-04-19,9893
6443,元晶,89,9,80,元大-大天母,2023-04-20,9893
00878,國泰永續高股息,75,0,75,元大-大天母,2023-04-20,9893
6245,立端,67,4,63,元大-大天母,2023-04-20,9893
2409,友達,43,0,43,元大-大天母,2023-04-20,9893
00632R,元大台灣50反1,85,45,40,元大-大天母,2023-04-20,9893
1795,美時,48,11,37,元大-大天母,2023-04-20,9893
1609,大亞,103,71,32,元大-大天母,2023-04-20,9893
0056,元大高股息,33,3,30,元大-大天母,2023-04-20,9893
3059,華晶科,27,0,27,元大-大天母,2023-04-20,9893
00713,元大台灣高息低波,25,0,25,元大-大天母,2023-04-20,9893
4123,晟德,30,5,25,元大-大天母,2023-04-20,9893
2303,聯電,30,6,24,元大-大天母,2023-04-20,9893
2338,光罩,28,5,23,元大-大天母,2023-04-20,9893
00680L,元大美債20正2,22,0,22,元大-大天母,2023-04-20,9893
3081,聯亞,22,0,22,元大-大天母,2023-04-20,9893
2327,國巨,34,13,21,元大-大天母,2023-04-20,9893
00637L,元大滬深300正2,42,21,21,元大-大天母,2023-04-20,9893
2634,漢翔,46,26,20,元大-大天母,2023-04-20,9893
00687B,國泰20年美債,20,0,20,元大-大天母,2023-04-20,9893
5475,德宏,20,0,20,元大-大天母,2023-04-20,9893
2888,新光金,20,0,20,元大-大天母,2023-04-20,9893
1104,環泥,20,0,20,元大-大天母,2023-04-20,9893
2103,台橡,19,0,19,元大-大天母,2023-04-20,9893
6239,力成,20,1,19,元大-大天母,2023-04-20,9893
4130,健亞,18,0,18,元大-大天母,2023-04-20,9893
1802,台玻,17,0,17,元大-大天母,2023-04-20,9893
6288,聯嘉,38,21,17,元大-大天母,2023-04-20,9893
6129,普誠,17,0,17,元大-大天母,2023-04-20,9893
00720B,元大投資級公司債,17,0,17,元大-大天母,2023-04-20,9893
5403,中菲,17,0,17,元大-大天母,2023-04-20,9893
6712,長聖,16,0,16,元大-大天母,2023-04-20,9893
2913,農林,89,73,16,元大-大天母,2023-04-20,9893
1760,寶齡富錦,29,14,15,元大-大天母,2023-04-20,9893
8069,元太,16,1,15,元大-大天母,2023-04-20,9893
3094,聯傑,17,2,15,元大-大天母,2023-04-20,9893
3576,聯合再生,24,9,15,元大-大天母,2023-04-20,9893
6835,圓裕,14,0,14,元大-大天母,2023-04-20,9893
3047,訊舟,14,0,14,元大-大天母,2023-04-20,9893
3374,精材,14,0,14,元大-大天母,2023-04-20,9893
2498,宏達電,30,17,13,元大-大天母,2023-04-20,9893
1524,耿鼎,16,3,13,元大-大天母,2023-04-20,9893
6125,廣運,13,0,13,元大-大天母,2023-04-20,9893
1904,正隆,43,30,13,元大-大天母,2023-04-20,9893
4934,太極,12,0,12,元大-大天母,2023-04-20,9893
00912,中信臺灣智慧50,12,0,12,元大-大天母,2023-04-20,9893
3624,光頡,12,0,12,元大-大天母,2023-04-20,9893
6244,茂迪,50,40,10,元大-大天母,2023-04-20,9893
00905,FT臺灣Smart,10,0,10,元大-大天母,2023-04-20,9893
3466,德晉,10,0,10,元大-大天母,2023-04-20,9893
3209,全科,10,0,10,元大-大天母,2023-04-20,9893
1314,中石化,200,0,200,元大-大天母,2023-04-21,9893
4741,泓瀚,125,0,125,元大-大天母,2023-04-21,9893
2706,第一店,80,0,80,元大-大天母,2023-04-21,9893
00715L,期街口布蘭特正2,72,0,72,元大-大天母,2023-04-21,9893
1229,聯華,69,0,69,元大-大天母,2023-04-21,9893
00922,國泰台灣領袖50,51,0,51,元大-大天母,2023-04-21,9893
00888,永豐台灣ESG,40,0,40,元大-大天母,2023-04-21,9893
4114,健喬,36,0,36,元大-大天母,2023-04-21,9893
4904,遠傳,37,1,36,元大-大天母,2023-04-21,9893
9962,有益,32,0,32,元大-大天母,2023-04-21,9893
4164,承業醫,38,8,30,元大-大天母,2023-04-21,9893
2610,華航,34,5,29,元大-大天母,2023-04-21,9893
5529,鉅陞,28,0,28,元大-大天母,2023-04-21,9893
5425,台半,28,1,27,元大-大天母,2023-04-21,9893
3714,富采,77,51,26,元大-大天母,2023-04-21,9893
6244,茂迪,38,14,24,元大-大天母,2023-04-21,9893
5347,世界,24,0,24,元大-大天母,2023-04-21,9893
00878,國泰永續高股息,49,26,23,元大-大天母,2023-04-21,9893
2344,華邦電,27,5,22,元大-大天母,2023-04-21,9893
2609,陽明,22,0,22,元大-大天母,2023-04-21,9893
3711,日月光投控,23,1,22,元大-大天母,2023-04-21,9893
6248,沛波,22,1,21,元大-大天母,2023-04-21,9893
6026,福邦證,20,0,20,元大-大天母,2023-04-21,9893
6271,同欣電,19,2,17,元大-大天母,2023-04-21,9893
2707,晶華,20,3,17,元大-大天母,2023-04-21,9893
5607,遠雄港,16,0,16,元大-大天母,2023-04-21,9893
5475,德宏,16,0,16,元大-大天母,2023-04-21,9893
2520,冠德,15,0,15,元大-大天母,2023-04-21,9893
1813,寶利徠,15,0,15,元大-大天母,2023-04-21,9893
2633,台灣高鐵,16,1,15,元大-大天母,2023-04-21,9893
00753L,中信中國50正2,18,3,15,元大-大天母,2023-04-21,9893
2317,鴻海,33,19,14,元大-大天母,2023-04-21,9893
2882,國泰金,16,2,14,元大-大天母,2023-04-21,9893
8284,三竹,13,0,13,元大-大天母,2023-04-21,9893
2352,佳世達,12,0,12,元大-大天母,2023-04-21,9893
1809,中釉,12,0,12,元大-大天母,2023-04-21,9893
2645,長榮航太,12,1,11,元大-大天母,2023-04-21,9893
2313,華通,11,0,11,元大-大天母,2023-04-21,9893
1760,寶齡富錦,19,8,11,元大-大天母,2023-04-21,9893
2355,敬鵬,11,0,11,元大-大天母,2023-04-21,9893
3535,晶彩科,10,0,10,元大-大天母,2023-04-21,9893
1305,華夏,10,0,10,元大-大天母,2023-04-21,9893
6140,訊達,10,0,10,元大-大天母,2023-04-21,9893
2536,宏普,10,0,10,元大-大天母,2023-04-21,9893
3081,聯亞,10,0,10,元大-大天母,2023-04-21,9893
00655L,國泰中國A50正2,10,0,10,元大-大天母,2023-04-21,9893
8215,明基材,10,0,10,元大-大天母,2023-04-21,9893
3374,精材,10,0,10,元大-大天母,2023-04-21,9893
3209,全科,10,0,10,元大-大天母,2023-04-21,9893
6770,力積電,9,0,9,元大-大天母,2023-04-21,9893
4741,泓瀚,275,125,150,元大-大天母,2023-04-24,9893
00680L,元大美債20正2,58,0,58,元大-大天母,2023-04-24,9893
1905,華紙,90,33,57,元大-大天母,2023-04-24,9893
3481,群創,37,2,35,元大-大天母,2023-04-24,9893
2520,冠德,35,0,35,元大-大天母,2023-04-24,9893
1101,台泥,53,20,33,元大-大天母,2023-04-24,9893
00655L,國泰中國A50正2,40,8,32,元大-大天母,2023-04-24,9893
2886,兆豐金,33,1,32,元大-大天母,2023-04-24,9893
2317,鴻海,24,0,24,元大-大天母,2023-04-24,9893
4164,承業醫,21,1,20,元大-大天母,2023-04-24,9893
4960,誠美材,20,0,20,元大-大天母,2023-04-24,9893
2495,普安,22,2,20,元大-大天母,2023-04-24,9893
5469,瀚宇博,20,0,20,元大-大天母,2023-04-24,9893
1104,環泥,20,0,20,元大-大天母,2023-04-24,9893
2707,晶華,20,1,19,元大-大天母,2023-04-24,9893
00885,富邦越南,21,3,18,元大-大天母,2023-04-24,9893
00637L,元大滬深300正2,17,0,17,元大-大天母,2023-04-24,9893
2324,仁寶,18,1,17,元大-大天母,2023-04-24,9893
3094,聯傑,18,2,16,元大-大天母,2023-04-24,9893
0056,元大高股息,17,2,15,元大-大天母,2023-04-24,9893
2313,華通,14,0,14,元大-大天母,2023-04-24,9893
2913,農林,33,19,14,元大-大天母,2023-04-24,9893
00902,中信電池及儲能,23,10,13,元大-大天母,2023-04-24,9893
1720,生達,25,12,13,元大-大天母,2023-04-24,9893
00912,中信臺灣智慧50,13,0,13,元大-大天母,2023-04-24,9893
1907,永豐餘,13,1,12,元大-大天母,2023-04-24,9893
00751B,元大AAA至A公司債,12,0,12,元大-大天母,2023-04-24,9893
6443,元晶,22,10,12,元大-大天母,2023-04-24,9893
00633L,富邦上証正2,11,0,11,元大-大天母,2023-04-24,9893
1605,華新,13,3,10,元大-大天母,2023-04-24,9893
2834,臺企銀,10,0,10,元大-大天母,2023-04-24,9893
2610,華航,20,10,10,元大-大天母,2023-04-24,9893
2812,台中銀,10,0,10,元大-大天母,2023-04-24,9893
3576,聯合再生,10,1,9,元大-大天母,2023-04-24,9893
3035,智原,10,1,9,元大-大天母,2023-04-24,9893
2609,陽明,11,2,9,元大-大天母,2023-04-24,9893
2002,中鋼,9,0,9,元大-大天母,2023-04-24,9893
00715L,期街口布蘭特正2,9,0,9,元大-大天母,2023-04-24,9893
2887,台新金,10,1,9,元大-大天母,2023-04-24,9893
4755,三福化,13,5,8,元大-大天母,2023-04-24,9893
4737,華廣,8,0,8,元大-大天母,2023-04-24,9893
3078,僑威,17,9,8,元大-大天母,2023-04-24,9893
2457,飛宏,24,16,8,元大-大天母,2023-04-24,9893
2409,友達,10,3,7,元大-大天母,2023-04-24,9893
00772B,中信高評級公司債,7,0,7,元大-大天母,2023-04-24,9893
4566,時碩工業,9,2,7,元大-大天母,2023-04-24,9893
1810,和成,7,0,7,元大-大天母,2023-04-24,9893
3374,精材,7,0,7,元大-大天母,2023-04-24,9893
0050,元大台灣50,7,0,7,元大-大天母,2023-04-24,9893
2330,台積電,12,5,7,元大-大天母,2023-04-24,9893
3231,緯創,147,10,137,元大-大天母,2023-04-25,9893
2303,聯電,120,12,108,元大-大天母,2023-04-25,9893
0056,元大高股息,102,2,100,元大-大天母,2023-04-25,9893
00923,群益台ESG低碳50,77,0,77,元大-大天母,2023-04-25,9893
6443,元晶,74,0,74,元大-大天母,2023-04-25,9893
2515,中工,101,30,71,元大-大天母,2023-04-25,9893
1503,士電,75,13,62,元大-大天母,2023-04-25,9893
1310,台苯,132,73,59,元大-大天母,2023-04-25,9893
4121,優盛,60,3,57,元大-大天母,2023-04-25,9893
1314,中石化,58,5,53,元大-大天母,2023-04-25,9893
2355,敬鵬,53,0,53,元大-大天母,2023-04-25,9893
3037,欣興,57,5,52,元大-大天母,2023-04-25,9893
2706,第一店,50,0,50,元大-大天母,2023-04-25,9893
3715,定穎投控,50,2,48,元大-大天母,2023-04-25,9893
006208,富邦台50,46,1,45,元大-大天母,2023-04-25,9893
3481,群創,60,21,39,元大-大天母,2023-04-25,9893
3024,憶聲,35,0,35,元大-大天母,2023-04-25,9893
5607,遠雄港,35,2,33,元大-大天母,2023-04-25,9893
2610,華航,37,5,32,元大-大天母,2023-04-25,9893
2206,三陽工業,53,21,32,元大-大天母,2023-04-25,9893
1312,國喬,30,1,29,元大-大天母,2023-04-25,9893
2317,鴻海,35,7,28,元大-大天母,2023-04-25,9893
2520,冠德,28,0,28,元大-大天母,2023-04-25,9893
5529,鉅陞,27,0,27,元大-大天母,2023-04-25,9893
1905,華紙,137,110,27,元大-大天母,2023-04-25,9893
00751B,元大AAA至A公司債,24,1,23,元大-大天母,2023-04-25,9893
0050,元大台灣50,23,0,23,元大-大天母,2023-04-25,9893
2409,友達,23,1,22,元大-大天母,2023-04-25,9893
8069,元太,24,3,21,元大-大天母,2023-04-25,9893
00881,國泰台灣5G+,21,0,21,元大-大天母,2023-04-25,9893
2634,漢翔,109,88,21,元大-大天母,2023-04-25,9893
2832,台產,20,0,20,元大-大天母,2023-04-25,9893
1813,寶利徠,20,0,20,元大-大天母,2023-04-25,9893
4164,承業醫,23,4,19,元大-大天母,2023-04-25,9893
1104,環泥,20,2,18,元大-大天母,2023-04-25,9893
00772B,中信高評級公司債,20,2,18,元大-大天母,2023-04-25,9893
00888,永豐台灣ESG,17,0,17,元大-大天母,2023-04-25,9893
00632R,元大台灣50反1,81,65,16,元大-大天母,2023-04-25,9893
00891,中信關鍵半導體,19,4,15,元大-大天母,2023-04-25,9893
1101,台泥,31,16,15,元大-大天母,2023-04-25,9893
6182,合晶,15,0,15,元大-大天母,2023-04-25,9893
2457,飛宏,46,32,14,元大-大天母,2023-04-25,9893
3576,聯合再生,14,0,14,元大-大天母,2023-04-25,9893
1605,華新,19,6,13,元大-大天母,2023-04-25,9893
3714,富采,13,0,13,元大-大天母,2023-04-25,9893
3705,永信,13,0,13,元大-大天母,2023-04-25,9893
3094,聯傑,13,0,13,元大-大天母,2023-04-25,9893
6274,台燿,16,3,13,元大-大天母,2023-04-25,9893
00637L,元大滬深300正2,15,2,13,元大-大天母,2023-04-25,9893
8046,南電,13,0,13,元大-大天母,2023-04-25,9893
00720B,元大投資級公司債,142,23,119,元大-大天母,2023-04-26,9893
2515,中工,101,5,96,元大-大天母,2023-04-26,9893
00680L,元大美債20正2,80,10,70,元大-大天母,2023-04-26,9893
3017,奇鋐,73,3,70,元大-大天母,2023-04-26,9893
0056,元大高股息,75,15,60,元大-大天母,2023-04-26,9893
2449,京元電子,50,0,50,元大-大天母,2023-04-26,9893
00715L,期街口布蘭特正2,50,0,50,元大-大天母,2023-04-26,9893
4904,遠傳,50,0,50,元大-大天母,2023-04-26,9893
00885,富邦越南,68,23,45,元大-大天母,2023-04-26,9893
1603,華電,43,0,43,元大-大天母,2023-04-26,9893
4121,優盛,42,0,42,元大-大天母,2023-04-26,9893
2545,皇翔,28,0,28,元大-大天母,2023-04-26,9893
4979,華星光,37,11,26,元大-大天母,2023-04-26,9893
0050,元大台灣50,26,1,25,元大-大天母,2023-04-26,9893
2883,凱基金,25,1,24,元大-大天母,2023-04-26,9893
2383,台光電,23,0,23,元大-大天母,2023-04-26,9893
2303,聯電,43,21,22,元大-大天母,2023-04-26,9893
2308,台達電,22,1,21,元大-大天母,2023-04-26,9893
006208,富邦台50,19,0,19,元大-大天母,2023-04-26,9893
2609,陽明,23,5,18,元大-大天母,2023-04-26,9893
3711,日月光投控,18,0,18,元大-大天母,2023-04-26,9893
3624,光頡,36,20,16,元大-大天母,2023-04-26,9893
5425,台半,19,4,15,元大-大天母,2023-04-26,9893
1802,台玻,16,1,15,元大-大天母,2023-04-26,9893
2330,台積電,22,7,15,元大-大天母,2023-04-26,9893
5607,遠雄港,16,3,13,元大-大天母,2023-04-26,9893
00712,復華富時不動產,13,0,13,元大-大天母,2023-04-26,9893
3035,智原,25,13,12,元大-大天母,2023-04-26,9893
9955,佳龍,32,20,12,元大-大天母,2023-04-26,9893
2603,長榮,11,0,11,元大-大天母,2023-04-26,9893
6271,同欣電,12,2,10,元大-大天母,2023-04-26,9893
1813,寶利徠,10,0,10,元大-大天母,2023-04-26,9893
5529,鉅陞,10,0,10,元大-大天母,2023-04-26,9893
6104,創惟,13,3,10,元大-大天母,2023-04-26,9893
4164,承業醫,11,1,10,元大-大天母,2023-04-26,9893
3078,僑威,20,11,9,元大-大天母,2023-04-26,9893
4123,晟德,12,3,9,元大-大天母,2023-04-26,9893
2495,普安,9,1,8,元大-大天母,2023-04-26,9893
8222,寶一,16,8,8,元大-大天母,2023-04-26,9893
2882,國泰金,7,0,7,元大-大天母,2023-04-26,9893
1504,東元,13,6,7,元大-大天母,2023-04-26,9893
8088,品安,10,3,7,元大-大天母,2023-04-26,9893
2367,燿華,7,0,7,元大-大天母,2023-04-26,9893
6829,千附精密,12,5,7,元大-大天母,2023-04-26,9893
4128,中天,6,0,6,元大-大天母,2023-04-26,9893
4174,浩鼎,6,0,6,元大-大天母,2023-04-26,9893
2337,旺宏,8,2,6,元大-大天母,2023-04-26,9893
6461,益得,7,1,6,元大-大天母,2023-04-26,9893
6770,力積電,7,2,5,元大-大天母,2023-04-26,9893
4977,眾達-KY,11,6,5,元大-大天母,2023-04-26,9893
00715L,期街口布蘭特正2,116,0,116,元大-大天母,2023-04-27,9893
8049,晶采,80,0,80,元大-大天母,2023-04-27,9893
2002,中鋼,74,10,64,元大-大天母,2023-04-27,9893
3047,訊舟,54,0,54,元大-大天母,2023-04-27,9893
4741,泓瀚,38,0,38,元大-大天母,2023-04-27,9893
1711,永光,143,105,38,元大-大天母,2023-04-27,9893
6235,華孚,32,0,32,元大-大天母,2023-04-27,9893
3081,聯亞,31,0,31,元大-大天母,2023-04-27,9893
3059,華晶科,32,2,30,元大-大天母,2023-04-27,9893
2609,陽明,32,2,30,元大-大天母,2023-04-27,9893
3380,明泰,30,1,29,元大-大天母,2023-04-27,9893
3017,奇鋐,36,9,27,元大-大天母,2023-04-27,9893
2881,富邦金,25,0,25,元大-大天母,2023-04-27,9893
2204,中華,25,1,24,元大-大天母,2023-04-27,9893
2498,宏達電,26,5,21,元大-大天母,2023-04-27,9893
8046,南電,22,2,20,元大-大天母,2023-04-27,9893
2312,金寶,23,3,20,元大-大天母,2023-04-27,9893
00632R,元大台灣50反1,30,10,20,元大-大天母,2023-04-27,9893
6672,騰輝電子-KY,20,0,20,元大-大天母,2023-04-27,9893
4566,時碩工業,19,0,19,元大-大天母,2023-04-27,9893
2603,長榮,17,0,17,元大-大天母,2023-04-27,9893
2882,國泰金,19,2,17,元大-大天母,2023-04-27,9893
6139,亞翔,16,0,16,元大-大天母,2023-04-27,9893
00679B,元大美債20年,15,1,14,元大-大天母,2023-04-27,9893
2409,友達,15,0,15,元大-大天母,2023-04-27,9893
1605,華新,24,10,14,元大-大天母,2023-04-27,9893
2352,佳世達,15,2,13,元大-大天母,2023-04-27,9893
8403,盛弘,45,32,13,元大-大天母,2023-04-27,9893
5607,遠雄港,12,1,11,元大-大天母,2023-04-27,9893
00683L,期元大美元指正2,11,0,11,元大-大天母,2023-04-27,9893
1612,宏泰,11,0,11,元大-大天母,2023-04-27,9893
1104,環泥,18,7,11,元大-大天母,2023-04-27,9893
2330,台積電,12,2,10,元大-大天母,2023-04-27,9893
6446,藥華藥,15,5,10,元大-大天母,2023-04-27,9893
5529,鉅陞,10,0,10,元大-大天母,2023-04-27,9893
1731,美吾華,10,0,10,元大-大天母,2023-04-27,9893
2314,台揚,10,0,10,元大-大天母,2023-04-27,9893
5315,光聯,10,0,10,元大-大天母,2023-04-27,9893
1589,永冠-KY,10,0,10,元大-大天母,2023-04-27,9893
9105,泰金寶-DR,10,0,10,元大-大天母,2023-04-27,9893
1717,長興,10,0,10,元大-大天母,2023-04-27,9893
3231,緯創,55,45,10,元大-大天母,2023-04-27,9893
2634,漢翔,123,114,9,元大-大天母,2023-04-27,9893
6248,沛波,10,1,9,元大-大天母,2023-04-27,9893
2630,亞航,9,0,9,元大-大天母,2023-04-27,9893
4911,德英,9,0,9,元大-大天母,2023-04-27,9893
6282,康舒,13,4,9,元大-大天母,2023-04-27,9893
2421,建準,9,0,9,元大-大天母,2023-04-27,9893
2892,第一金,9,1,8,元大-大天母,2023-04-27,9893
2485,兆赫,8,0,8,元大-大天母,2023-04-27,9893
3481,群創,142,0,142,元大-大天母,2023-04-28,9893
2881,富邦金,104,2,102,元大-大天母,2023-04-28,9893
3017,奇鋐,103,3,100,元大-大天母,2023-04-28,9893
2409,友達,79,3,76,元大-大天母,2023-04-28,9893
00664R,國泰臺灣加權反1,50,0,50,元大-大天母,2023-04-28,9893
2892,第一金,68,22,46,元大-大天母,2023-04-28,9893
3545,敦泰,44,6,38,元大-大天母,2023-04-28,9893
4741,泓瀚,35,0,35,元大-大天母,2023-04-28,9893
00885,富邦越南,40,10,30,元大-大天母,2023-04-28,9893
2208,台船,30,0,30,元大-大天母,2023-04-28,9893
3704,合勤控,29,1,28,元大-大天母,2023-04-28,9893
3624,光頡,50,22,28,元大-大天母,2023-04-28,9893
2022,聚亨,23,0,23,元大-大天母,2023-04-28,9893
6180,橘子,22,0,22,元大-大天母,2023-04-28,9893
00680L,元大美債20正2,22,0,22,元大-大天母,2023-04-28,9893
4977,眾達-KY,18,1,17,元大-大天母,2023-04-28,9893
1905,華紙,38,23,15,元大-大天母,2023-04-28,9893
5009,榮剛,21,8,13,元大-大天母,2023-04-28,9893
6829,千附精密,35,22,13,元大-大天母,2023-04-28,9893
1101,台泥,24,11,13,元大-大天母,2023-04-28,9893
6770,力積電,14,2,12,元大-大天母,2023-04-28,9893
2368,金像電,12,0,12,元大-大天母,2023-04-28,9893
2634,漢翔,55,43,12,元大-大天母,2023-04-28,9893
2945,三商家購,11,0,11,元大-大天母,2023-04-28,9893
6266,泰詠,12,1,11,元大-大天母,2023-04-28,9893
2880,華南金,13,3,10,元大-大天母,2023-04-28,9893
1402,遠東新,10,0,10,元大-大天母,2023-04-28,9893
2385,群光,10,0,10,元大-大天母,2023-04-28,9893
4572,駐龍,19,9,10,元大-大天母,2023-04-28,9893
3217,優群,10,0,10,元大-大天母,2023-04-28,9893
5529,鉅陞,10,0,10,元大-大天母,2023-04-28,9893
3374,精材,10,0,10,元大-大天母,2023-04-28,9893
6223,旺矽,10,0,10,元大-大天母,2023-04-28,9893
2603,長榮,116,106,10,元大-大天母,2023-04-28,9893
6282,康舒,26,17,9,元大-大天母,2023-04-28,9893
0050,元大台灣50,10,1,9,元大-大天母,2023-04-28,9893
1609,大亞,9,0,9,元大-大天母,2023-04-28,9893
3004,豐達科,17,8,9,元大-大天母,2023-04-28,9893
00751B,元大AAA至A公司債,9,0,9,元大-大天母,2023-04-28,9893
3380,明泰,10,1,9,元大-大天母,2023-04-28,9893
00715L,期街口布蘭特正2,8,0,8,元大-大天母,2023-04-28,9893
2801,彰銀,10,2,8,元大-大天母,2023-04-28,9893
00772B,中信高評級公司債,8,0,8,元大-大天母,2023-04-28,9893
00679B,元大美債20年,10,2,8,元大-大天母,2023-04-28,9893
00725B,國泰投資級公司債,8,0,8,元大-大天母,2023-04-28,9893
2303,聯電,36,29,7,元大-大天母,2023-04-28,9893
6125,廣運,10,3,7,元大-大天母,2023-04-28,9893
1310,台苯,7,0,7,元大-大天母,2023-04-28,9893
2230,泰茂,17,10,7,元大-大天母,2023-04-28,9893
00773B,中信優先金融債,6,0,6,元大-大天母,2023-04-28,9893
2834,臺企銀,200,59,141,元大-大天母,2023-05-02,9893
00713,元大台灣高息低波,109,2,107,元大-大天母,2023-05-02,9893
8403,盛弘,81,3,78,元大-大天母,2023-05-02,9893
00878,國泰永續高股息,131,56,75,元大-大天母,2023-05-02,9893
4164,承業醫,68,1,67,元大-大天母,2023-05-02,9893
1609,大亞,67,8,59,元大-大天母,2023-05-02,9893
8088,品安,55,2,53,元大-大天母,2023-05-02,9893
6245,立端,72,20,52,元大-大天母,2023-05-02,9893
2344,華邦電,50,16,34,元大-大天母,2023-05-02,9893
2383,台光電,34,0,34,元大-大天母,2023-05-02,9893
2520,冠德,33,0,33,元大-大天母,2023-05-02,9893
2101,南港,30,0,30,元大-大天母,2023-05-02,9893
00680L,元大美債20正2,26,0,26,元大-大天母,2023-05-02,9893
2945,三商家購,26,0,26,元大-大天母,2023-05-02,9893
2204,中華,25,0,25,元大-大天母,2023-05-02,9893
00772B,中信高評級公司債,24,0,24,元大-大天母,2023-05-02,9893
2603,長榮,26,4,22,元大-大天母,2023-05-02,9893
4747,強生,22,0,22,元大-大天母,2023-05-02,9893
1802,台玻,20,1,19,元大-大天母,2023-05-02,9893
6139,亞翔,19,1,18,元大-大天母,2023-05-02,9893
8011,台通,18,0,18,元大-大天母,2023-05-02,9893
4114,健喬,20,3,17,元大-大天母,2023-05-02,9893
5009,榮剛,18,2,16,元大-大天母,2023-05-02,9893
5351,鈺創,16,0,16,元大-大天母,2023-05-02,9893
4541,晟田,35,20,15,元大-大天母,2023-05-02,9893
6111,大宇資,22,7,15,元大-大天母,2023-05-02,9893
4916,事欣科,17,2,15,元大-大天母,2023-05-02,9893
3576,聯合再生,29,15,14,元大-大天母,2023-05-02,9893
4130,健亞,13,0,13,元大-大天母,2023-05-02,9893
00773B,中信優先金融債,13,0,13,元大-大天母,2023-05-02,9893
6221,晉泰,11,0,11,元大-大天母,2023-05-02,9893
2634,漢翔,27,17,10,元大-大天母,2023-05-02,9893
2454,聯發科,10,0,10,元大-大天母,2023-05-02,9893
6278,台表科,12,2,10,元大-大天母,2023-05-02,9893
4439,冠星-KY,10,0,10,元大-大天母,2023-05-02,9893
8222,寶一,24,14,10,元大-大天母,2023-05-02,9893
2801,彰銀,11,1,10,元大-大天母,2023-05-02,9893
2707,晶華,12,2,10,元大-大天母,2023-05-02,9893
1535,中宇,10,0,10,元大-大天母,2023-05-02,9893
1785,光洋科,10,0,10,元大-大天母,2023-05-02,9893
3522,御嵿,10,0,10,元大-大天母,2023-05-02,9893
3479,安勤,25,15,10,元大-大天母,2023-05-02,9893
6218,豪勉,10,0,10,元大-大天母,2023-05-02,9893
2881,富邦金,12,3,9,元大-大天母,2023-05-02,9893
8093,保銳,11,2,9,元大-大天母,2023-05-02,9893
4138,曜亞,9,0,9,元大-大天母,2023-05-02,9893
1519,華城,47,38,9,元大-大天母,2023-05-02,9893
00715L,期街口布蘭特正2,9,0,9,元大-大天母,2023-05-02,9893
8033,雷虎,11,2,9,元大-大天母,2023-05-02,9893
2002,中鋼,28,19,9,元大-大天母,2023-05-02,9893
6116,彩晶,201,0,201,元大-大天母,2023-05-03,9893
00632R,元大台灣50反1,200,0,200,元大-大天母,2023-05-03,9893
2897,王道銀行,101,0,101,元大-大天母,2023-05-03,9893
00878,國泰永續高股息,119,22,97,元大-大天母,2023-05-03,9893
00715L,期街口布蘭特正2,80,0,80,元大-大天母,2023-05-03,9893
2609,陽明,58,7,51,元大-大天母,2023-05-03,9893
00893,國泰智能電動車,50,3,47,元大-大天母,2023-05-03,9893
2945,三商家購,47,0,47,元大-大天母,2023-05-03,9893
2603,長榮,52,11,41,元大-大天母,2023-05-03,9893
2883,凱基金,51,11,40,元大-大天母,2023-05-03,9893
3481,群創,44,10,34,元大-大天母,2023-05-03,9893
00655L,國泰中國A50正2,30,0,30,元大-大天母,2023-05-03,9893
2634,漢翔,55,27,28,元大-大天母,2023-05-03,9893
00712,復華富時不動產,28,2,26,元大-大天母,2023-05-03,9893
00633L,富邦上証正2,25,0,25,元大-大天母,2023-05-03,9893
00690,兆豐藍籌30,24,0,24,元大-大天母,2023-05-03,9893
6139,亞翔,24,0,24,元大-大天母,2023-05-03,9893
3231,緯創,37,13,24,元大-大天母,2023-05-03,9893
6111,大宇資,38,16,22,元大-大天母,2023-05-03,9893
4168,醣聯,20,0,20,元大-大天母,2023-05-03,9893
6278,台表科,45,27,18,元大-大天母,2023-05-03,9893
6625,必應,24,6,18,元大-大天母,2023-05-03,9893
4977,眾達-KY,18,0,18,元大-大天母,2023-05-03,9893
2892,第一金,18,2,16,元大-大天母,2023-05-03,9893
6245,立端,17,1,16,元大-大天母,2023-05-03,9893
0056,元大高股息,20,4,16,元大-大天母,2023-05-03,9893
00885,富邦越南,19,3,16,元大-大天母,2023-05-03,9893
3032,偉訓,18,2,16,元大-大天母,2023-05-03,9893
00720B,元大投資級公司債,15,0,15,元大-大天母,2023-05-03,9893
1504,東元,26,11,15,元大-大天母,2023-05-03,9893
00753L,中信中國50正2,15,0,15,元大-大天母,2023-05-03,9893
1514,亞力,25,10,15,元大-大天母,2023-05-03,9893
3029,零壹,26,13,13,元大-大天母,2023-05-03,9893
3006,晶豪科,13,0,13,元大-大天母,2023-05-03,9893
1104,環泥,26,13,13,元大-大天母,2023-05-03,9893
6596,寬宏藝術,12,0,12,元大-大天母,2023-05-03,9893
5607,遠雄港,12,0,12,元大-大天母,2023-05-03,9893
6282,康舒,21,9,12,元大-大天母,2023-05-03,9893
2002,中鋼,13,1,12,元大-大天母,2023-05-03,9893
4968,立積,19,8,11,元大-大天母,2023-05-03,9893
8358,金居,11,0,11,元大-大天母,2023-05-03,9893
4108,懷特,11,0,11,元大-大天母,2023-05-03,9893
5465,富驊,12,1,11,元大-大天母,2023-05-03,9893
1584,精剛,10,0,10,元大-大天母,2023-05-03,9893
1709,和益,10,0,10,元大-大天母,2023-05-03,9893
00706L,期元大S＆P日圓正2,10,0,10,元大-大天母,2023-05-03,9893
8046,南電,10,0,10,元大-大天母,2023-05-03,9893
2344,華邦電,36,26,10,元大-大天母,2023-05-03,9893
2615,萬海,9,0,9,元大-大天母,2023-05-03,9893
1711,永光,11,2,9,元大-大天母,2023-05-03,9893
5356,協益,437,0,437,元大-大天母,2023-05-04,9893
00715L,期街口布蘭特正2,439,53,386,元大-大天母,2023-05-04,9893
2897,王道銀行,200,0,200,元大-大天母,2023-05-04,9893
1701,中化,123,1,122,元大-大天母,2023-05-04,9893
2707,晶華,61,7,54,元大-大天母,2023-05-04,9893
00878,國泰永續高股息,57,10,47,元大-大天母,2023-05-04,9893
1721,三晃,43,5,38,元大-大天母,2023-05-04,9893
6245,立端,42,10,32,元大-大天母,2023-05-04,9893
3624,光頡,32,1,31,元大-大天母,2023-05-04,9893
1589,永冠-KY,30,1,29,元大-大天母,2023-05-04,9893
00712,復華富時不動產,27,0,27,元大-大天母,2023-05-04,9893
4711,永純,23,0,23,元大-大天母,2023-05-04,9893
3202,樺晟,31,10,21,元大-大天母,2023-05-04,9893
6139,亞翔,20,0,20,元大-大天母,2023-05-04,9893
6443,元晶,20,0,20,元大-大天母,2023-05-04,9893
00706L,期元大S＆P日圓正2,20,0,20,元大-大天母,2023-05-04,9893
00674R,期元大S＆P黃金反1,20,0,20,元大-大天母,2023-05-04,9893
0056,元大高股息,21,2,19,元大-大天母,2023-05-04,9893
00679B,元大美債20年,26,7,19,元大-大天母,2023-05-04,9893
2409,友達,18,0,18,元大-大天母,2023-05-04,9893
4541,晟田,22,6,16,元大-大天母,2023-05-04,9893
2609,陽明,32,17,15,元大-大天母,2023-05-04,9893
3032,偉訓,15,0,15,元大-大天母,2023-05-04,9893
2002,中鋼,15,0,15,元大-大天母,2023-05-04,9893
8215,明基材,15,0,15,元大-大天母,2023-05-04,9893
00642U,期元大S＆P石油,14,0,14,元大-大天母,2023-05-04,9893
00772B,中信高評級公司債,13,0,13,元大-大天母,2023-05-04,9893
2317,鴻海,13,0,13,元大-大天母,2023-05-04,9893
2457,飛宏,20,7,13,元大-大天母,2023-05-04,9893
2748,雲品,28,15,13,元大-大天母,2023-05-04,9893
4123,晟德,14,1,13,元大-大天母,2023-05-04,9893
3071,協禧,14,1,13,元大-大天母,2023-05-04,9893
4916,事欣科,15,3,12,元大-大天母,2023-05-04,9893
4130,健亞,12,0,12,元大-大天母,2023-05-04,9893
3078,僑威,16,5,11,元大-大天母,2023-05-04,9893
5906,台南-KY,11,0,11,元大-大天母,2023-05-04,9893
2945,三商家購,11,0,11,元大-大天母,2023-05-04,9893
00757,統一FANG+,10,0,10,元大-大天母,2023-05-04,9893
3209,全科,10,0,10,元大-大天母,2023-05-04,9893
6276,安鈦克,10,0,10,元大-大天母,2023-05-04,9893
6470,宇智,10,0,10,元大-大天母,2023-05-04,9893
1809,中釉,10,0,10,元大-大天母,2023-05-04,9893
8046,南電,10,0,10,元大-大天母,2023-05-04,9893
1784,訊聯,10,0,10,元大-大天母,2023-05-04,9893
5871,中租-KY,10,0,10,元大-大天母,2023-05-04,9893
00891,中信關鍵半導體,10,0,10,元大-大天母,2023-05-04,9893
6589,台康生技,17,7,10,元大-大天母,2023-05-04,9893
1514,亞力,13,3,10,元大-大天母,2023-05-04,9893
3708,上緯投控,10,0,10,元大-大天母,2023-05-04,9893
1535,中宇,10,0,10,元大-大天母,2023-05-04,9893
2897,王道銀行,500,0,500,元大-大天母,2023-05-05,9893
1711,永光,251,5,246,元大-大天母,2023-05-05,9893
5356,協益,154,2,152,元大-大天母,2023-05-05,9893
3017,奇鋐,116,17,99,元大-大天母,2023-05-05,9893
00751B,元大AAA至A公司債,62,9,53,元大-大天母,2023-05-05,9893
2706,第一店,50,0,50,元大-大天母,2023-05-05,9893
2353,宏��,57,11,46,元大-大天母,2023-05-05,9893
00632R,元大台灣50反1,60,20,40,元大-大天母,2023-05-05,9893
00642U,期元大S＆P石油,35,0,35,元大-大天母,2023-05-05,9893
2313,華通,32,0,32,元大-大天母,2023-05-05,9893
00715L,期街口布蘭特正2,30,0,30,元大-大天母,2023-05-05,9893
3704,合勤控,30,0,30,元大-大天母,2023-05-05,9893
6127,九豪,33,4,29,元大-大天母,2023-05-05,9893
00712,復華富時不動產,28,0,28,元大-大天母,2023-05-05,9893
6139,亞翔,28,0,28,元大-大天母,2023-05-05,9893
8215,明基材,31,4,27,元大-大天母,2023-05-05,9893
4147,中裕,28,1,27,元大-大天母,2023-05-05,9893
1529,樂事綠能,30,3,27,元大-大天母,2023-05-05,9893
1605,華新,59,32,27,元大-大天母,2023-05-05,9893
3714,富采,26,1,25,元大-大天母,2023-05-05,9893
00772B,中信高評級公司債,27,4,23,元大-大天母,2023-05-05,9893
00720B,元大投資級公司債,23,0,23,元大-大天母,2023-05-05,9893
00679B,元大美債20年,25,3,22,元大-大天母,2023-05-05,9893
00878,國泰永續高股息,24,2,22,元大-大天母,2023-05-05,9893
1305,華夏,21,0,21,元大-大天母,2023-05-05,9893
1103,嘉泥,20,0,20,元大-大天母,2023-05-05,9893
2337,旺宏,20,0,20,元大-大天母,2023-05-05,9893
00773B,中信優先金融債,18,0,18,元大-大天母,2023-05-05,9893
4108,懷特,18,0,18,元大-大天母,2023-05-05,9893
2640,大車隊,16,0,16,元大-大天母,2023-05-05,9893
6732,昇佳電子,15,0,15,元大-大天母,2023-05-05,9893
3338,泰碩,21,6,15,元大-大天母,2023-05-05,9893
2358,廷鑫,15,0,15,元大-大天母,2023-05-05,9893
3231,緯創,28,14,14,元大-大天母,2023-05-05,9893
5410,國眾,14,0,14,元大-大天母,2023-05-05,9893
8403,盛弘,14,0,14,元大-大天母,2023-05-05,9893
1609,大亞,93,80,13,元大-大天母,2023-05-05,9893
6672,騰輝電子-KY,13,0,13,元大-大天母,2023-05-05,9893
5227,立凱-KY,11,0,11,元大-大天母,2023-05-05,9893
2303,聯電,16,5,11,元大-大天母,2023-05-05,9893
8932,智通*,11,0,11,元大-大天母,2023-05-05,9893
3702,大聯大,11,0,11,元大-大天母,2023-05-05,9893
5353,台林,16,5,11,元大-大天母,2023-05-05,9893
5321,美而快,15,4,11,元大-大天母,2023-05-05,9893
00830,國泰費城半導體,10,0,10,元大-大天母,2023-05-05,9893
8024,佑華,10,0,10,元大-大天母,2023-05-05,9893
2405,輔信,10,0,10,元大-大天母,2023-05-05,9893
3508,位速,10,0,10,元大-大天母,2023-05-05,9893
2634,漢翔,15,7,8,元大-大天母,2023-05-05,9893
1519,華城,10,2,8,元大-大天母,2023-05-05,9893
00720B,元大投資級公司債,176,8,168,元大-大天母,2023-05-08,9893
1701,中化,139,6,133,元大-大天母,2023-05-08,9893
00715L,期街口布蘭特正2,136,8,128,元大-大天母,2023-05-08,9893
1605,華新,117,16,101,元大-大天母,2023-05-08,9893
2897,王道銀行,100,0,100,元大-大天母,2023-05-08,9893
00671R,富邦NASDAQ反1,100,0,100,元大-大天母,2023-05-08,9893
00751B,元大AAA至A公司債,74,0,74,元大-大天母,2023-05-08,9893
6139,亞翔,52,1,51,元大-大天母,2023-05-08,9893
00920,富邦ESG綠色電力,50,0,50,元大-大天母,2023-05-08,9893
00648R,元大S＆P500反1,50,0,50,元大-大天母,2023-05-08,9893
00669R,國泰美國道瓊反1,50,0,50,元大-大天母,2023-05-08,9893
2851,中再保,41,0,41,元大-大天母,2023-05-08,9893
3038,全台,36,1,35,元大-大天母,2023-05-08,9893
00641R,富邦日本反1,30,0,30,元大-大天母,2023-05-08,9893
1234,黑松,30,0,30,元大-大天母,2023-05-08,9893
1903,士紙,29,0,29,元大-大天母,2023-05-08,9893
6443,元晶,36,10,26,元大-大天母,2023-05-08,9893
3481,群創,24,1,23,元大-大天母,2023-05-08,9893
00679B,元大美債20年,22,0,22,元大-大天母,2023-05-08,9893
6806,森崴能源,32,10,22,元大-大天母,2023-05-08,9893
1314,中石化,21,0,21,元大-大天母,2023-05-08,9893
3232,昱捷,20,0,20,元大-大天母,2023-05-08,9893
00680L,元大美債20正2,20,0,20,元大-大天母,2023-05-08,9893
5469,瀚宇博,19,0,19,元大-大天母,2023-05-08,9893
6125,廣運,32,14,18,元大-大天母,2023-05-08,9893
1612,宏泰,21,3,18,元大-大天母,2023-05-08,9893
3714,富采,32,15,17,元大-大天母,2023-05-08,9893
00773B,中信優先金融債,17,0,17,元大-大天母,2023-05-08,9893
2888,新光金,17,1,16,元大-大天母,2023-05-08,9893
2359,所羅門,20,4,16,元大-大天母,2023-05-08,9893
00713,元大台灣高息低波,15,0,15,元大-大天母,2023-05-08,9893
5011,久陽,15,1,14,元大-大天母,2023-05-08,9893
1907,永豐餘,14,0,14,元大-大天母,2023-05-08,9893
1529,樂事綠能,22,8,14,元大-大天母,2023-05-08,9893
3511,矽瑪,14,0,14,元大-大天母,2023-05-08,9893
3209,全科,13,0,13,元大-大天母,2023-05-08,9893
1809,中釉,12,0,12,元大-大天母,2023-05-08,9893
6790,永豐實,11,0,11,元大-大天母,2023-05-08,9893
00675L,富邦臺灣加權正2,11,0,11,元大-大天母,2023-05-08,9893
00654R,富邦印度反1,11,0,11,元大-大天母,2023-05-08,9893
2916,滿心,11,0,11,元大-大天母,2023-05-08,9893
00756B,群益投等新興公債,10,0,10,元大-大天母,2023-05-08,9893
3591,艾笛森,16,6,10,元大-大天母,2023-05-08,9893
1714,和桐,10,0,10,元大-大天母,2023-05-08,9893
1810,和成,10,0,10,元大-大天母,2023-05-08,9893
1447,力鵬,10,0,10,元大-大天母,2023-05-08,9893
1215,卜蜂,10,0,10,元大-大天母,2023-05-08,9893
4130,健亞,10,0,10,元大-大天母,2023-05-08,9893
4976,佳凌,10,0,10,元大-大天母,2023-05-08,9893
2101,南港,10,0,10,元大-大天母,2023-05-08,9893
2885,元大金,187,1,186,元大-大天母,2023-05-09,9893
1903,士紙,177,0,177,元大-大天母,2023-05-09,9893
6443,元晶,107,1,106,元大-大天母,2023-05-09,9893
8403,盛弘,53,5,48,元大-大天母,2023-05-09,9893
00720B,元大投資級公司債,51,4,47,元大-大天母,2023-05-09,9893
2888,新光金,48,3,45,元大-大天母,2023-05-09,9893
1504,東元,70,33,37,元大-大天母,2023-05-09,9893
8033,雷虎,43,10,33,元大-大天母,2023-05-09,9893
00885,富邦越南,32,0,32,元大-大天母,2023-05-09,9893
00680L,元大美債20正2,32,0,32,元大-大天母,2023-05-09,9893
2892,第一金,34,4,30,元大-大天母,2023-05-09,9893
2609,陽明,33,4,29,元大-大天母,2023-05-09,9893
2634,漢翔,38,10,28,元大-大天母,2023-05-09,9893
00751B,元大AAA至A公司債,28,0,28,元大-大天母,2023-05-09,9893
00679B,元大美債20年,28,0,28,元大-大天母,2023-05-09,9893
1513,中興電,71,43,28,元大-大天母,2023-05-09,9893
00878,國泰永續高股息,27,0,27,元大-大天母,2023-05-09,9893
3338,泰碩,24,0,24,元大-大天母,2023-05-09,9893
1101,台泥,35,12,23,元大-大天母,2023-05-09,9893
00690,兆豐藍籌30,21,0,21,元大-大天母,2023-05-09,9893
2915,潤泰全,20,0,20,元大-大天母,2023-05-09,9893
1701,中化,20,0,20,元大-大天母,2023-05-09,9893
6770,力積電,20,0,20,元大-大天母,2023-05-09,9893
00654R,富邦印度反1,19,0,19,元大-大天母,2023-05-09,9893
5607,遠雄港,19,0,19,元大-大天母,2023-05-09,9893
3537,堡達,19,0,19,元大-大天母,2023-05-09,9893
1603,華電,18,0,18,元大-大天母,2023-05-09,9893
3704,合勤控,19,2,17,元大-大天母,2023-05-09,9893
1784,訊聯,17,0,17,元大-大天母,2023-05-09,9893
2834,臺企銀,17,0,17,元大-大天母,2023-05-09,9893
8024,佑華,16,0,16,元大-大天母,2023-05-09,9893
4138,曜亞,16,0,16,元大-大天母,2023-05-09,9893
1609,大亞,23,8,15,元大-大天母,2023-05-09,9893
1612,宏泰,20,5,15,元大-大天母,2023-05-09,9893
1444,力麗,20,5,15,元大-大天母,2023-05-09,9893
6606,建德工業,14,0,14,元大-大天母,2023-05-09,9893
5410,國眾,14,0,14,元大-大天母,2023-05-09,9893
3479,安勤,18,5,13,元大-大天母,2023-05-09,9893
2640,大車隊,13,0,13,元大-大天母,2023-05-09,9893
6112,邁達特,22,9,13,元大-大天母,2023-05-09,9893
8215,明基材,14,2,12,元大-大天母,2023-05-09,9893
00772B,中信高評級公司債,12,0,12,元大-大天母,2023-05-09,9893
00687B,國泰20年美債,12,0,12,元大-大天母,2023-05-09,9893
4503,金雨,21,9,12,元大-大天母,2023-05-09,9893
2916,滿心,13,1,12,元大-大天母,2023-05-09,9893
4130,健亞,11,0,11,元大-大天母,2023-05-09,9893
3484,崧騰,12,1,11,元大-大天母,2023-05-09,9893
4108,懷特,12,1,11,元大-大天母,2023-05-09,9893
2344,華邦電,23,12,11,元大-大天母,2023-05-09,9893
8926,台汽電,16,6,10,元大-大天母,2023-05-09,9893
1903,士紙,250,0,250,元大-大天母,2023-05-10,9893
3231,緯創,191,21,170,元大-大天母,2023-05-10,9893
4138,曜亞,153,16,137,元大-大天母,2023-05-10,9893
8426,紅木-KY,73,0,73,元大-大天母,2023-05-10,9893
00633L,富邦上証正2,68,0,68,元大-大天母,2023-05-10,9893
00680L,元大美債20正2,59,0,59,元大-大天母,2023-05-10,9893
6213,聯茂,62,10,52,元大-大天母,2023-05-10,9893
2888,新光金,50,0,50,元大-大天母,2023-05-10,9893
2030,彰源,45,1,44,元大-大天母,2023-05-10,9893
00637L,元大滬深300正2,49,6,43,元大-大天母,2023-05-10,9893
3416,融程電,40,0,40,元大-大天母,2023-05-10,9893
4123,晟德,40,0,40,元大-大天母,2023-05-10,9893
1784,訊聯,40,0,40,元大-大天母,2023-05-10,9893
00878,國泰永續高股息,52,17,35,元大-大天母,2023-05-10,9893
1310,台苯,30,0,30,元大-大天母,2023-05-10,9893
0056,元大高股息,24,0,24,元大-大天母,2023-05-10,9893
3037,欣興,25,3,22,元大-大天母,2023-05-10,9893
1752,南光,24,3,21,元大-大天母,2023-05-10,9893
5607,遠雄港,20,0,20,元大-大天母,2023-05-10,9893
6274,台燿,19,0,19,元大-大天母,2023-05-10,9893
2812,台中銀,20,2,18,元大-大天母,2023-05-10,9893
3715,定穎投控,20,2,18,元大-大天母,2023-05-10,9893
2303,聯電,29,12,17,元大-大天母,2023-05-10,9893
2330,台積電,17,1,16,元大-大天母,2023-05-10,9893
00753L,中信中國50正2,16,0,16,元大-大天母,2023-05-10,9893
2369,菱生,15,0,15,元大-大天母,2023-05-10,9893
2882,國泰金,14,1,13,元大-大天母,2023-05-10,9893
2027,大成鋼,13,0,13,元大-大天母,2023-05-10,9893
00713,元大台灣高息低波,13,1,12,元大-大天母,2023-05-10,9893
00900,富邦特選高股息30,12,0,12,元大-大天母,2023-05-10,9893
2409,友達,12,0,12,元大-大天母,2023-05-10,9893
2883,凱基金,30,18,12,元大-大天母,2023-05-10,9893
6216,居易,12,0,12,元大-大天母,2023-05-10,9893
00688L,國泰20年美債正2,11,0,11,元大-大天母,2023-05-10,9893
00751B,元大AAA至A公司債,11,0,11,元大-大天母,2023-05-10,9893
8085,福華,11,0,11,元大-大天母,2023-05-10,9893
6517,保勝光學,10,0,10,元大-大天母,2023-05-10,9893
2892,第一金,13,3,10,元大-大天母,2023-05-10,9893
1813,寶利徠,10,0,10,元大-大天母,2023-05-10,9893
3576,聯合再生,10,0,10,元大-大天母,2023-05-10,9893
6446,藥華藥,11,1,10,元大-大天母,2023-05-10,9893
2851,中再保,10,0,10,元大-大天母,2023-05-10,9893
2348,海悅,10,0,10,元大-大天母,2023-05-10,9893
3017,奇鋐,10,1,9,元大-大天母,2023-05-10,9893
2387,精元,11,2,9,元大-大天母,2023-05-10,9893
3689,湧德,10,1,9,元大-大天母,2023-05-10,9893
2324,仁寶,10,1,9,元大-大天母,2023-05-10,9893
3013,晟銘電,11,2,9,元大-大天母,2023-05-10,9893
2504,國產,9,0,9,元大-大天母,2023-05-10,9893
2457,飛宏,20,11,9,元大-大天母,2023-05-10,9893
2618,長榮航,575,24,551,元大-大天母,2023-05-11,9893
1603,華電,155,0,155,元大-大天母,2023-05-11,9893
2610,華航,73,2,71,元大-大天母,2023-05-11,9893
00878,國泰永續高股息,58,2,56,元大-大天母,2023-05-11,9893
5284,jpp-KY,52,0,52,元大-大天母,2023-05-11,9893
2609,陽明,50,1,49,元大-大天母,2023-05-11,9893
2371,大同,53,5,48,元大-大天母,2023-05-11,9893
00679B,元大美債20年,46,0,46,元大-大天母,2023-05-11,9893
5498,凱崴,40,2,38,元大-大天母,2023-05-11,9893
1314,中石化,35,0,35,元大-大天母,2023-05-11,9893
00751B,元大AAA至A公司債,32,0,32,元大-大天母,2023-05-11,9893
1605,華新,32,0,32,元大-大天母,2023-05-11,9893
2606,裕民,33,1,32,元大-大天母,2023-05-11,9893
1310,台苯,30,0,30,元大-大天母,2023-05-11,9893
2201,裕隆,31,3,28,元大-大天母,2023-05-11,9893
8426,紅木-KY,27,0,27,元大-大天母,2023-05-11,9893
6179,亞通,32,6,26,元大-大天母,2023-05-11,9893
2637,慧洋-KY,25,0,25,元大-大天母,2023-05-11,9893
3363,上詮,31,6,25,元大-大天母,2023-05-11,9893
8049,晶采,45,20,25,元大-大天母,2023-05-11,9893
4503,金雨,45,24,21,元大-大天母,2023-05-11,9893
1444,力麗,20,0,20,元大-大天母,2023-05-11,9893
2312,金寶,25,5,20,元大-大天母,2023-05-11,9893
3011,今皓,20,0,20,元大-大天母,2023-05-11,9893
00655L,國泰中國A50正2,20,0,20,元大-大天母,2023-05-11,9893
4973,廣穎,20,0,20,元大-大天母,2023-05-11,9893
2303,聯電,31,12,19,元大-大天母,2023-05-11,9893
6741,91APP*-KY,32,13,19,元大-大天母,2023-05-11,9893
5607,遠雄港,18,0,18,元大-大天母,2023-05-11,9893
2883,凱基金,21,3,18,元大-大天母,2023-05-11,9893
2640,大車隊,17,0,17,元大-大天母,2023-05-11,9893
6213,聯茂,23,7,16,元大-大天母,2023-05-11,9893
00789B,復華公司債A3,16,0,16,元大-大天母,2023-05-11,9893
3714,富采,31,15,16,元大-大天母,2023-05-11,9893
3481,群創,16,0,16,元大-大天母,2023-05-11,9893
6278,台表科,31,16,15,元大-大天母,2023-05-11,9893
4737,華廣,14,0,14,元大-大天母,2023-05-11,9893
00720B,元大投資級公司債,14,0,14,元大-大天母,2023-05-11,9893
3004,豐達科,14,0,14,元大-大天母,2023-05-11,9893
1905,華紙,20,6,14,元大-大天母,2023-05-11,9893
2886,兆豐金,13,0,13,元大-大天母,2023-05-11,9893
2369,菱生,13,0,13,元大-大天母,2023-05-11,9893
6697,東捷資訊,13,0,13,元大-大天母,2023-05-11,9893
00772B,中信高評級公司債,12,0,12,元大-大天母,2023-05-11,9893
1711,永光,12,0,12,元大-大天母,2023-05-11,9893
00885,富邦越南,12,0,12,元大-大天母,2023-05-11,9893
6167,久正,12,0,12,元大-大天母,2023-05-11,9893
2317,鴻海,13,2,11,元大-大天母,2023-05-11,9893
2387,精元,11,0,11,元大-大天母,2023-05-11,9893
3380,明泰,11,0,11,元大-大天母,2023-05-11,9893
00632R,元大台灣50反1,132,5,127,元大-大天母,2023-05-12,9893
2515,中工,103,0,103,元大-大天母,2023-05-12,9893
3481,群創,68,2,66,元大-大天母,2023-05-12,9893
4979,華星光,53,0,53,元大-大天母,2023-05-12,9893
2031,新光鋼,51,0,51,元大-大天母,2023-05-12,9893
2801,彰銀,46,0,46,元大-大天母,2023-05-12,9893
2885,元大金,48,6,42,元大-大天母,2023-05-12,9893
2409,友達,60,22,38,元大-大天母,2023-05-12,9893
00878,國泰永續高股息,36,1,35,元大-大天母,2023-05-12,9893
1218,泰山,36,3,33,元大-大天母,2023-05-12,9893
00637L,元大滬深300正2,33,0,33,元大-大天母,2023-05-12,9893
3576,聯合再生,31,0,31,元大-大天母,2023-05-12,9893
1108,幸福,30,0,30,元大-大天母,2023-05-12,9893
00713,元大台灣高息低波,26,0,26,元大-大天母,2023-05-12,9893
4550,長佳,21,0,21,元大-大天母,2023-05-12,9893
00655L,國泰中國A50正2,20,0,20,元大-大天母,2023-05-12,9893
3059,華晶科,20,0,20,元大-大天母,2023-05-12,9893
1101,台泥,21,3,18,元大-大天母,2023-05-12,9893
1227,佳格,18,0,18,元大-大天母,2023-05-12,9893
8403,盛弘,26,10,16,元大-大天母,2023-05-12,9893
00712,復華富時不動產,16,0,16,元大-大天母,2023-05-12,9893
2356,英業達,33,18,15,元大-大天母,2023-05-12,9893
6276,安鈦克,20,5,15,元大-大天母,2023-05-12,9893
2884,玉山金,13,0,13,元大-大天母,2023-05-12,9893
2027,大成鋼,13,0,13,元大-大天母,2023-05-12,9893
2002,中鋼,15,2,13,元大-大天母,2023-05-12,9893
3032,偉訓,22,10,12,元大-大天母,2023-05-12,9893
6282,康舒,14,2,12,元大-大天母,2023-05-12,9893
6469,大樹,13,1,12,元大-大天母,2023-05-12,9893
1905,華紙,29,18,11,元大-大天母,2023-05-12,9893
2014,中鴻,10,0,10,元大-大天母,2023-05-12,9893
006206,元大上證50,10,0,10,元大-大天母,2023-05-12,9893
3479,安勤,12,2,10,元大-大天母,2023-05-12,9893
2640,大車隊,10,0,10,元大-大天母,2023-05-12,9893
6288,聯嘉,10,0,10,元大-大天母,2023-05-12,9893
2882,國泰金,15,6,9,元大-大天母,2023-05-12,9893
4503,金雨,13,5,8,元大-大天母,2023-05-12,9893
2736,富野,11,3,8,元大-大天母,2023-05-12,9893
00690,兆豐藍籌30,7,0,7,元大-大天母,2023-05-12,9893
6703,軒郁,9,2,7,元大-大天母,2023-05-12,9893
2609,陽明,10,4,6,元大-大天母,2023-05-12,9893
5483,中美晶,6,0,6,元大-大天母,2023-05-12,9893
00633L,富邦上証正2,6,0,6,元大-大天母,2023-05-12,9893
6491,晶碩,6,0,6,元大-大天母,2023-05-12,9893
2303,聯電,57,51,6,元大-大天母,2023-05-12,9893
1736,喬山,6,0,6,元大-大天母,2023-05-12,9893
6697,東捷資訊,6,0,6,元大-大天母,2023-05-12,9893
4175,杏一,7,1,6,元大-大天母,2023-05-12,9893
2890,永豐金,5,0,5,元大-大天母,2023-05-12,9893
3034,聯詠,5,0,5,元大-大天母,2023-05-12,9893
00878,國泰永續高股息,172,32,140,元大-大天母,2023-05-15,9893
2031,新光鋼,82,0,82,元大-大天母,2023-05-15,9893
2331,精英,91,17,74,元大-大天母,2023-05-15,9893
3363,上詮,86,15,71,元大-大天母,2023-05-15,9893
6703,軒郁,72,5,67,元大-大天母,2023-05-15,9893
2317,鴻海,62,0,62,元大-大天母,2023-05-15,9893
00632R,元大台灣50反1,62,7,55,元大-大天母,2023-05-15,9893
00679B,元大美債20年,52,0,52,元大-大天母,2023-05-15,9893
00688L,國泰20年美債正2,52,0,52,元大-大天母,2023-05-15,9893
2618,長榮航,49,4,45,元大-大天母,2023-05-15,9893
1905,華紙,56,14,42,元大-大天母,2023-05-15,9893
1471,首利,39,0,39,元大-大天母,2023-05-15,9893
00751B,元大AAA至A公司債,31,0,31,元大-大天母,2023-05-15,9893
3231,緯創,80,50,30,元大-大天母,2023-05-15,9893
8049,晶采,30,0,30,元大-大天母,2023-05-15,9893
3046,建��,39,13,26,元大-大天母,2023-05-15,9893
00680L,元大美債20正2,26,1,25,元大-大天母,2023-05-15,9893
3202,樺晟,33,8,25,元大-大天母,2023-05-15,9893
5009,榮剛,24,1,23,元大-大天母,2023-05-15,9893
00891,中信關鍵半導體,20,0,20,元大-大天母,2023-05-15,9893
6282,康舒,22,2,20,元大-大天母,2023-05-15,9893
1503,士電,20,0,20,元大-大天母,2023-05-15,9893
3540,曜越,20,0,20,元大-大天母,2023-05-15,9893
3059,華晶科,20,0,20,元大-大天母,2023-05-15,9893
2356,英業達,31,11,20,元大-大天母,2023-05-15,9893
00772B,中信高評級公司債,20,1,19,元大-大天母,2023-05-15,9893
2489,瑞軒,20,1,19,元大-大天母,2023-05-15,9893
00642U,期元大S＆P石油,17,0,17,元大-大天母,2023-05-15,9893
00720B,元大投資級公司債,16,0,16,元大-大天母,2023-05-15,9893
1813,寶利徠,15,0,15,元大-大天母,2023-05-15,9893
0050,元大台灣50,14,0,14,元大-大天母,2023-05-15,9893
00715L,期街口布蘭特正2,14,0,14,元大-大天母,2023-05-15,9893
6216,居易,12,0,12,元大-大天母,2023-05-15,9893
3058,立德,15,3,12,元大-大天母,2023-05-15,9893
6194,育富,12,0,12,元大-大天母,2023-05-15,9893
1529,樂事綠能,11,0,11,元大-大天母,2023-05-15,9893
1711,永光,10,0,10,元大-大天母,2023-05-15,9893
1609,大亞,11,1,10,元大-大天母,2023-05-15,9893
4566,時碩工業,10,0,10,元大-大天母,2023-05-15,9893
4123,晟德,12,2,10,元大-大天母,2023-05-15,9893
2883B,凱基金乙特,10,0,10,元大-大天母,2023-05-15,9893
3706,神達,10,0,10,元大-大天母,2023-05-15,9893
2303,聯電,47,37,10,元大-大天母,2023-05-15,9893
2887,台新金,11,1,10,元大-大天母,2023-05-15,9893
1103,嘉泥,10,0,10,元大-大天母,2023-05-15,9893
9105,泰金寶-DR,10,0,10,元大-大天母,2023-05-15,9893
6517,保勝光學,10,0,10,元大-大天母,2023-05-15,9893
3576,聯合再生,9,0,9,元大-大天母,2023-05-15,9893
1227,佳格,8,0,8,元大-大天母,2023-05-15,9893
5515,建國,8,0,8,元大-大天母,2023-05-15,9893
00679B,元大美債20年,87,0,87,元大-大天母,2023-05-16,9893
00680L,元大美債20正2,65,0,65,元大-大天母,2023-05-16,9893
3006,晶豪科,54,5,49,元大-大天母,2023-05-16,9893
00751B,元大AAA至A公司債,41,0,41,元大-大天母,2023-05-16,9893
3479,安勤,42,2,40,元大-大天母,2023-05-16,9893
00772B,中信高評級公司債,34,0,34,元大-大天母,2023-05-16,9893
1504,東元,39,7,32,元大-大天母,2023-05-16,9893
8076,伍豐,47,16,31,元大-大天母,2023-05-16,9893
8069,元太,153,122,31,元大-大天母,2023-05-16,9893
00641R,富邦日本反1,30,0,30,元大-大天母,2023-05-16,9893
2303,聯電,37,9,28,元大-大天母,2023-05-16,9893
2317,鴻海,28,1,27,元大-大天母,2023-05-16,9893
4743,合一,23,0,23,元大-大天母,2023-05-16,9893
00878,國泰永續高股息,99,76,23,元大-大天母,2023-05-16,9893
3051,力特,22,0,22,元大-大天母,2023-05-16,9893
00654R,富邦印度反1,20,0,20,元大-大天母,2023-05-16,9893
2031,新光鋼,19,0,19,元大-大天母,2023-05-16,9893
1905,華紙,22,6,16,元大-大天母,2023-05-16,9893
4130,健亞,14,0,14,元大-大天母,2023-05-16,9893
00720B,元大投資級公司債,11,0,11,元大-大天母,2023-05-16,9893
1701,中化,10,0,10,元大-大天母,2023-05-16,9893
1234,黑松,10,0,10,元大-大天母,2023-05-16,9893
6776,展�眥篕�,10,0,10,元大-大天母,2023-05-16,9893
2897,王道銀行,10,0,10,元大-大天母,2023-05-16,9893
5347,世界,10,0,10,元大-大天母,2023-05-16,9893
3231,緯創,43,33,10,元大-大天母,2023-05-16,9893
9944,新麗,10,0,10,元大-大天母,2023-05-16,9893
2640,大車隊,10,0,10,元大-大天母,2023-05-16,9893
8271,宇瞻,11,1,10,元大-大天母,2023-05-16,9893
1101,台泥,11,1,10,元大-大天母,2023-05-16,9893
2471,資通,9,0,9,元大-大天母,2023-05-16,9893
6245,立端,16,8,8,元大-大天母,2023-05-16,9893
1608,華榮,8,0,8,元大-大天母,2023-05-16,9893
2603,長榮,8,0,8,元大-大天母,2023-05-16,9893
1720,生達,8,0,8,元大-大天母,2023-05-16,9893
8215,明基材,8,1,7,元大-大天母,2023-05-16,9893
4432,銘旺實,7,0,7,元大-大天母,2023-05-16,9893
1813,寶利徠,7,0,7,元大-大天母,2023-05-16,9893
2331,精英,11,4,7,元大-大天母,2023-05-16,9893
2637,慧洋-KY,10,3,7,元大-大天母,2023-05-16,9893
2368,金像電,13,6,7,元大-大天母,2023-05-16,9893
5607,遠雄港,8,1,7,元大-大天母,2023-05-16,9893
4919,新唐,8,2,6,元大-大天母,2023-05-16,9893
1402,遠東新,5,0,5,元大-大天母,2023-05-16,9893
00725B,國泰投資級公司債,5,0,5,元大-大天母,2023-05-16,9893
1612,宏泰,5,0,5,元大-大天母,2023-05-16,9893
4804,大略-KY,5,0,5,元大-大天母,2023-05-16,9893
00905,FT臺灣Smart,5,0,5,元大-大天母,2023-05-16,9893
6517,保勝光學,16,11,5,元大-大天母,2023-05-16,9893
1457,宜進,5,0,5,元大-大天母,2023-05-16,9893
00878,國泰永續高股息,279,37,242,元大-大天母,2023-05-17,9893
00632R,元大台灣50反1,568,340,228,元大-大天母,2023-05-17,9893
2206,三陽工業,125,20,105,元大-大天母,2023-05-17,9893
3673,TPK-KY,101,31,70,元大-大天母,2023-05-17,9893
00680L,元大美債20正2,68,0,68,元大-大天母,2023-05-17,9893
3715,定穎投控,61,0,61,元大-大天母,2023-05-17,9893
2890,永豐金,60,4,56,元大-大天母,2023-05-17,9893
00637L,元大滬深300正2,52,0,52,元大-大天母,2023-05-17,9893
3363,上詮,52,2,50,元大-大天母,2023-05-17,9893
6282,康舒,49,4,45,元大-大天母,2023-05-17,9893
00751B,元大AAA至A公司債,37,0,37,元大-大天母,2023-05-17,9893
4123,晟德,31,0,31,元大-大天母,2023-05-17,9893
00720B,元大投資級公司債,29,0,29,元大-大天母,2023-05-17,9893
2618,長榮航,58,32,26,元大-大天母,2023-05-17,9893
6242,立康,24,0,24,元大-大天母,2023-05-17,9893
00772B,中信高評級公司債,22,0,22,元大-大天母,2023-05-17,9893
5425,台半,23,1,22,元大-大天母,2023-05-17,9893
3680,家登,27,7,20,元大-大天母,2023-05-17,9893
00885,富邦越南,20,1,19,元大-大天母,2023-05-17,9893
3047,訊舟,18,0,18,元大-大天母,2023-05-17,9893
5351,鈺創,24,8,16,元大-大天母,2023-05-17,9893
2886,兆豐金,20,4,16,元大-大天母,2023-05-17,9893
6191,精成科,17,3,14,元大-大天母,2023-05-17,9893
5315,光聯,13,0,13,元大-大天母,2023-05-17,9893
4927,泰鼎-KY,12,0,12,元大-大天母,2023-05-17,9893
1612,宏泰,14,2,12,元大-大天母,2023-05-17,9893
00679B,元大美債20年,13,1,12,元大-大天母,2023-05-17,9893
4114,健喬,12,0,12,元大-大天母,2023-05-17,9893
1605,華新,17,5,12,元大-大天母,2023-05-17,9893
2834,臺企銀,20,9,11,元大-大天母,2023-05-17,9893
3704,合勤控,25,14,11,元大-大天母,2023-05-17,9893
2812,台中銀,12,1,11,元大-大天母,2023-05-17,9893
5607,遠雄港,11,0,11,元大-大天母,2023-05-17,9893
8046,南電,17,6,11,元大-大天母,2023-05-17,9893
9944,新麗,10,0,10,元大-大天母,2023-05-17,9893
6243,迅杰,10,0,10,元大-大天母,2023-05-17,9893
1409,新纖,10,0,10,元大-大天母,2023-05-17,9893
2101,南港,10,0,10,元大-大天母,2023-05-17,9893
2355,敬鵬,10,0,10,元大-大天母,2023-05-17,9893
4130,健亞,10,0,10,元大-大天母,2023-05-17,9893
9907,統一實,10,0,10,元大-大天母,2023-05-17,9893
6160,欣技,26,16,10,元大-大天母,2023-05-17,9893
3479,安勤,9,0,9,元大-大天母,2023-05-17,9893
1709,和益,10,1,9,元大-大天母,2023-05-17,9893
6153,嘉聯益,8,0,8,元大-大天母,2023-05-17,9893
4906,正文,8,0,8,元大-大天母,2023-05-17,9893
2313,華通,8,0,8,元大-大天母,2023-05-17,9893
1720,生達,12,5,7,元大-大天母,2023-05-17,9893
1310,台苯,8,1,7,元大-大天母,2023-05-17,9893
2327,國巨,8,1,7,元大-大天母,2023-05-17,9893
00680L,元大美債20正2,254,0,254,元大-大天母,2023-05-18,9893
00713,元大台灣高息低波,103,3,100,元大-大天母,2023-05-18,9893
2206,三陽工業,99,11,88,元大-大天母,2023-05-18,9893
6242,立康,83,0,83,元大-大天母,2023-05-18,9893
4906,正文,76,5,71,元大-大天母,2023-05-18,9893
2881,富邦金,85,19,66,元大-大天母,2023-05-18,9893
3673,TPK-KY,67,14,53,元大-大天母,2023-05-18,9893
1216,統一,51,0,51,元大-大天母,2023-05-18,9893
2204,中華,44,5,39,元大-大天母,2023-05-18,9893
3047,訊舟,33,0,33,元大-大天母,2023-05-18,9893
2338,光罩,32,1,31,元大-大天母,2023-05-18,9893
2492,華新科,27,0,27,元大-大天母,2023-05-18,9893
2103,台橡,25,0,25,元大-大天母,2023-05-18,9893
00882,中信中國高股息,24,0,24,元大-大天母,2023-05-18,9893
6188,廣明,25,1,24,元大-大天母,2023-05-18,9893
1227,佳格,22,0,22,元大-大天母,2023-05-18,9893
00676R,富邦臺灣加權反1,21,0,21,元大-大天母,2023-05-18,9893
2313,華通,20,0,20,元大-大天母,2023-05-18,9893
5475,德宏,20,0,20,元大-大天母,2023-05-18,9893
00885,富邦越南,40,20,20,元大-大天母,2023-05-18,9893
00679B,元大美債20年,19,1,18,元大-大天母,2023-05-18,9893
6472,保瑞,19,5,14,元大-大天母,2023-05-18,9893
4931,新盛力,26,13,13,元大-大天母,2023-05-18,9893
2520,冠德,13,0,13,元大-大天母,2023-05-18,9893
2834,臺企銀,12,0,12,元大-大天母,2023-05-18,9893
3362,先進光,13,1,12,元大-大天母,2023-05-18,9893
00637L,元大滬深300正2,12,0,12,元大-大天母,2023-05-18,9893
2323,中環,18,6,12,元大-大天母,2023-05-18,9893
3617,碩天,12,2,10,元大-大天母,2023-05-18,9893
6005,群益證,10,0,10,元大-大天母,2023-05-18,9893
8049,晶采,10,0,10,元大-大天母,2023-05-18,9893
2383,台光電,10,0,10,元大-大天母,2023-05-18,9893
00751B,元大AAA至A公司債,10,0,10,元大-大天母,2023-05-18,9893
5227,立凱-KY,10,1,9,元大-大天母,2023-05-18,9893
5011,久陽,10,1,9,元大-大天母,2023-05-18,9893
2515,中工,10,1,9,元大-大天母,2023-05-18,9893
5315,光聯,9,0,9,元大-大天母,2023-05-18,9893
2504,國產,10,1,9,元大-大天母,2023-05-18,9893
5410,國眾,9,0,9,元大-大天母,2023-05-18,9893
4919,新唐,11,2,9,元大-大天母,2023-05-18,9893
8046,南電,10,2,8,元大-大天母,2023-05-18,9893
6168,宏齊,8,0,8,元大-大天母,2023-05-18,9893
4138,曜亞,8,0,8,元大-大天母,2023-05-18,9893
6829,千附精密,8,0,8,元大-大天母,2023-05-18,9893
6214,精誠,16,8,8,元大-大天母,2023-05-18,9893
5425,台半,19,11,8,元大-大天母,2023-05-18,9893
2633,台灣高鐵,10,2,8,元大-大天母,2023-05-18,9893
00878,國泰永續高股息,48,41,7,元大-大天母,2023-05-18,9893
1319,東陽,12,5,7,元大-大天母,2023-05-18,9893
00673R,期元大S＆P原油反1,7,0,7,元大-大天母,2023-05-18,9893
6535,順藥,327,6,321,元大-大天母,2023-05-19,9893
1720,生達,146,8,138,元大-大天母,2023-05-19,9893
3044,健鼎,117,5,112,元大-大天母,2023-05-19,9893
00632R,元大台灣50反1,111,0,111,元大-大天母,2023-05-19,9893
00885,富邦越南,83,0,83,元大-大天母,2023-05-19,9893
1504,東元,121,65,56,元大-大天母,2023-05-19,9893
00688L,國泰20年美債正2,53,0,53,元大-大天母,2023-05-19,9893
00888,永豐台灣ESG,53,1,52,元大-大天母,2023-05-19,9893
1605,華新,60,10,50,元大-大天母,2023-05-19,9893
2890,永豐金,54,4,50,元大-大天母,2023-05-19,9893
00680L,元大美債20正2,49,0,49,元大-大天母,2023-05-19,9893
6509,聚和,53,8,45,元大-大天母,2023-05-19,9893
8109,博大,45,0,45,元大-大天母,2023-05-19,9893
2323,中環,59,17,42,元大-大天母,2023-05-19,9893
00679B,元大美債20年,40,0,40,元大-大天母,2023-05-19,9893
00637L,元大滬深300正2,36,0,36,元大-大天母,2023-05-19,9893
00751B,元大AAA至A公司債,34,0,34,元大-大天母,2023-05-19,9893
5009,榮剛,45,17,28,元大-大天母,2023-05-19,9893
1503,士電,42,15,27,元大-大天母,2023-05-19,9893
2303,聯電,27,0,27,元大-大天母,2023-05-19,9893
3178,公準,25,0,25,元大-大天母,2023-05-19,9893
8044,網家,25,0,25,元大-大天母,2023-05-19,9893
6125,廣運,25,0,25,元大-大天母,2023-05-19,9893
2883,凱基金,25,2,23,元大-大天母,2023-05-19,9893
2331,精英,22,0,22,元大-大天母,2023-05-19,9893
2610,華航,156,134,22,元大-大天母,2023-05-19,9893
2014,中鴻,22,1,21,元大-大天母,2023-05-19,9893
2332,友訊,23,2,21,元大-大天母,2023-05-19,9893
1609,大亞,32,11,21,元大-大天母,2023-05-19,9893
3673,TPK-KY,27,7,20,元大-大天母,2023-05-19,9893
3209,全科,20,0,20,元大-大天母,2023-05-19,9893
2881,富邦金,32,13,19,元大-大天母,2023-05-19,9893
1727,中華化,19,0,19,元大-大天母,2023-05-19,9893
00753L,中信中國50正2,18,0,18,元大-大天母,2023-05-19,9893
00687B,國泰20年美債,17,0,17,元大-大天母,2023-05-19,9893
6770,力積電,23,7,16,元大-大天母,2023-05-19,9893
00713,元大台灣高息低波,25,9,16,元大-大天母,2023-05-19,9893
2731,雄獅,25,9,16,元大-大天母,2023-05-19,9893
2457,飛宏,18,3,15,元大-大天母,2023-05-19,9893
2489,瑞軒,35,20,15,元大-大天母,2023-05-19,9893
6776,展�眥篕�,15,0,15,元大-大天母,2023-05-19,9893
00671R,富邦NASDAQ反1,14,0,14,元大-大天母,2023-05-19,9893
2892,第一金,25,11,14,元大-大天母,2023-05-19,9893
3029,零壹,24,12,12,元大-大天母,2023-05-19,9893
2520,冠德,12,0,12,元大-大天母,2023-05-19,9893
5425,台半,12,0,12,元大-大天母,2023-05-19,9893
2883B,凱基金乙特,12,0,12,元大-大天母,2023-05-19,9893
4142,國光生,12,0,12,元大-大天母,2023-05-19,9893
4572,駐龍,12,0,12,元大-大天母,2023-05-19,9893
6288,聯嘉,16,5,11,元大-大天母,2023-05-19,9893
2890,永豐金,103,0,103,元大-大天母,2023-05-22,9893
9105,泰金寶-DR,100,0,100,元大-大天母,2023-05-22,9893
00680L,元大美債20正2,87,0,87,元大-大天母,2023-05-22,9893
8085,福華,80,0,80,元大-大天母,2023-05-22,9893
2303,聯電,86,7,79,元大-大天母,2023-05-22,9893
00632R,元大台灣50反1,60,0,60,元大-大天母,2023-05-22,9893
3694,海華,60,4,56,元大-大天母,2023-05-22,9893
00715L,期街口布蘭特正2,57,3,54,元大-大天母,2023-05-22,9893
00885,富邦越南,51,12,39,元大-大天母,2023-05-22,9893
1608,華榮,44,8,36,元大-大天母,2023-05-22,9893
2892,第一金,37,3,34,元大-大天母,2023-05-22,9893
3675,德微,34,2,32,元大-大天母,2023-05-22,9893
6190,萬泰科,30,0,30,元大-大天母,2023-05-22,9893
2323,中環,35,8,27,元大-大天母,2023-05-22,9893
00751B,元大AAA至A公司債,24,0,24,元大-大天母,2023-05-22,9893
00795B,中信美國公債20年,23,0,23,元大-大天母,2023-05-22,9893
2801,彰銀,23,1,22,元大-大天母,2023-05-22,9893
1314,中石化,20,0,20,元大-大天母,2023-05-22,9893
3044,健鼎,23,3,20,元大-大天母,2023-05-22,9893
2880,華南金,20,0,20,元大-大天母,2023-05-22,9893
3037,欣興,30,14,16,元大-大天母,2023-05-22,9893
00720B,元大投資級公司債,18,3,15,元大-大天母,2023-05-22,9893
00725B,國泰投資級公司債,15,0,15,元大-大天母,2023-05-22,9893
3035,智原,16,2,14,元大-大天母,2023-05-22,9893
3051,力特,13,0,13,元大-大天母,2023-05-22,9893
2609,陽明,16,4,12,元大-大天母,2023-05-22,9893
6441,廣錠,21,9,12,元大-大天母,2023-05-22,9893
1503,士電,24,13,11,元大-大天母,2023-05-22,9893
3706,神達,19,8,11,元大-大天母,2023-05-22,9893
6282,康舒,48,37,11,元大-大天母,2023-05-22,9893
2317,鴻海,11,0,11,元大-大天母,2023-05-22,9893
1227,佳格,15,4,11,元大-大天母,2023-05-22,9893
3038,全台,13,3,10,元大-大天母,2023-05-22,9893
00753L,中信中國50正2,20,10,10,元大-大天母,2023-05-22,9893
8222,寶一,35,25,10,元大-大天母,2023-05-22,9893
4979,華星光,15,5,10,元大-大天母,2023-05-22,9893
1402,遠東新,10,0,10,元大-大天母,2023-05-22,9893
2489,瑞軒,10,0,10,元大-大天母,2023-05-22,9893
2913,農林,10,0,10,元大-大天母,2023-05-22,9893
1528,恩德,10,1,9,元大-大天母,2023-05-22,9893
3491,昇達科,12,3,9,元大-大天母,2023-05-22,9893
00900,富邦特選高股息30,10,1,9,元大-大天母,2023-05-22,9893
2368,金像電,11,2,9,元大-大天母,2023-05-22,9893
8088,品安,8,0,8,元大-大天母,2023-05-22,9893
5009,榮剛,13,5,8,元大-大天母,2023-05-22,9893
3290,東浦,9,1,8,元大-大天母,2023-05-22,9893
6234,高僑,10,3,7,元大-大天母,2023-05-22,9893
2402,毅嘉,7,0,7,元大-大天母,2023-05-22,9893
3481,群創,81,74,7,元大-大天母,2023-05-22,9893
2356,英業達,8,1,7,元大-大天母,2023-05-22,9893
2886,兆豐金,102,1,101,元大-大天母,2023-05-23,9893
2603,長榮,187,101,86,元大-大天母,2023-05-23,9893
5351,鈺創,55,1,54,元大-大天母,2023-05-23,9893
2610,華航,64,12,52,元大-大天母,2023-05-23,9893
8210,勤誠,33,1,32,元大-大天母,2023-05-23,9893
2618,長榮航,93,62,31,元大-大天母,2023-05-23,9893
2882,國泰金,31,2,29,元大-大天母,2023-05-23,9893
00680L,元大美債20正2,27,0,27,元大-大天母,2023-05-23,9893
3059,華晶科,27,0,27,元大-大天母,2023-05-23,9893
00687B,國泰20年美債,24,0,24,元大-大天母,2023-05-23,9893
00637L,元大滬深300正2,24,0,24,元大-大天母,2023-05-23,9893
8255,朋程,25,1,24,元大-大天母,2023-05-23,9893
8109,博大,22,0,22,元大-大天母,2023-05-23,9893
3062,建漢,20,0,20,元大-大天母,2023-05-23,9893
1609,大亞,22,3,19,元大-大天母,2023-05-23,9893
2303,聯電,33,16,17,元大-大天母,2023-05-23,9893
3479,安勤,17,1,16,元大-大天母,2023-05-23,9893
1605,華新,16,0,16,元大-大天母,2023-05-23,9893
9943,好樂迪,16,1,15,元大-大天母,2023-05-23,9893
3088,艾訊,15,0,15,元大-大天母,2023-05-23,9893
2368,金像電,17,2,15,元大-大天母,2023-05-23,9893
6703,軒郁,14,0,14,元大-大天母,2023-05-23,9893
2344,華邦電,28,14,14,元大-大天母,2023-05-23,9893
6441,廣錠,15,1,14,元大-大天母,2023-05-23,9893
1584,精剛,16,2,14,元大-大天母,2023-05-23,9893
00715L,期街口布蘭特正2,13,0,13,元大-大天母,2023-05-23,9893
2515,中工,13,0,13,元大-大天母,2023-05-23,9893
2383,台光電,13,0,13,元大-大天母,2023-05-23,9893
2881,富邦金,43,31,12,元大-大天母,2023-05-23,9893
00679B,元大美債20年,12,0,12,元大-大天母,2023-05-23,9893
1528,恩德,25,13,12,元大-大天母,2023-05-23,9893
2851,中再保,12,0,12,元大-大天母,2023-05-23,9893
00720B,元大投資級公司債,11,0,11,元大-大天母,2023-05-23,9893
00751B,元大AAA至A公司債,11,0,11,元大-大天母,2023-05-23,9893
00772B,中信高評級公司債,11,0,11,元大-大天母,2023-05-23,9893
6288,聯嘉,15,4,11,元大-大天母,2023-05-23,9893
2520,冠德,11,0,11,元大-大天母,2023-05-23,9893
00882,中信中國高股息,10,0,10,元大-大天母,2023-05-23,9893
3540,曜越,10,0,10,元大-大天母,2023-05-23,9893
1440,南紡,10,0,10,元大-大天母,2023-05-23,9893
2421,建準,26,16,10,元大-大天母,2023-05-23,9893
1810,和成,10,0,10,元大-大天母,2023-05-23,9893
3694,海華,10,0,10,元大-大天母,2023-05-23,9893
00753L,中信中國50正2,10,0,10,元大-大天母,2023-05-23,9893
6438,迅得,10,0,10,元大-大天母,2023-05-23,9893
5315,光聯,13,4,9,元大-大天母,2023-05-23,9893
1720,生達,14,5,9,元大-大天母,2023-05-23,9893
2313,華通,10,1,9,元大-大天母,2023-05-23,9893
8049,晶采,9,0,9,元大-大天母,2023-05-23,9893
00688L,國泰20年美債正2,9,0,9,元大-大天母,2023-05-23,9893
2610,華航,252,22,230,元大-大天母,2023-05-24,9893
3041,揚智,155,0,155,元大-大天母,2023-05-24,9893
2886,兆豐金,128,1,127,元大-大天母,2023-05-24,9893
2890,永豐金,108,1,107,元大-大天母,2023-05-24,9893
2201,裕隆,60,2,58,元大-大天母,2023-05-24,9893
4123,晟德,56,2,54,元大-大天母,2023-05-24,9893
00632R,元大台灣50反1,48,0,48,元大-大天母,2023-05-24,9893
2376,技嘉,52,6,46,元大-大天母,2023-05-24,9893
00878,國泰永續高股息,45,3,42,元大-大天母,2023-05-24,9893
4121,優盛,39,0,39,元大-大天母,2023-05-24,9893
2702,華園,35,1,34,元大-大天母,2023-05-24,9893
00679B,元大美債20年,32,0,32,元大-大天母,2023-05-24,9893
6207,雷科,30,0,30,元大-大天母,2023-05-24,9893
5464,霖宏,29,0,29,元大-大天母,2023-05-24,9893
00882,中信中國高股息,25,0,25,元大-大天母,2023-05-24,9893
00885,富邦越南,25,0,25,元大-大天母,2023-05-24,9893
2913,農林,20,0,20,元大-大天母,2023-05-24,9893
00655L,國泰中國A50正2,20,0,20,元大-大天母,2023-05-24,9893
2915,潤泰全,20,0,20,元大-大天母,2023-05-24,9893
4729,熒茂,20,0,20,元大-大天母,2023-05-24,9893
1795,美時,26,7,19,元大-大天母,2023-05-24,9893
1727,中華化,20,2,18,元大-大天母,2023-05-24,9893
1609,大亞,19,1,18,元大-大天母,2023-05-24,9893
2888,新光金,17,0,17,元大-大天母,2023-05-24,9893
00772B,中信高評級公司債,17,0,17,元大-大天母,2023-05-24,9893
2328,廣宇,17,1,16,元大-大天母,2023-05-24,9893
8076,伍豐,19,4,15,元大-大天母,2023-05-24,9893
2368,金像電,21,6,15,元大-大天母,2023-05-24,9893
6161,捷波,15,0,15,元大-大天母,2023-05-24,9893
6245,立端,35,20,15,元大-大天母,2023-05-24,9893
00633L,富邦上証正2,24,10,14,元大-大天母,2023-05-24,9893
00712,復華富時不動產,12,0,12,元大-大天母,2023-05-24,9893
3035,智原,12,1,11,元大-大天母,2023-05-24,9893
8271,宇瞻,11,0,11,元大-大天母,2023-05-24,9893
3491,昇達科,11,0,11,元大-大天母,2023-05-24,9893
2892,第一金,15,5,10,元大-大天母,2023-05-24,9893
3034,聯詠,10,0,10,元大-大天母,2023-05-24,9893
2103,台橡,10,0,10,元大-大天母,2023-05-24,9893
1810,和成,10,0,10,元大-大天母,2023-05-24,9893
4168,醣聯,10,0,10,元大-大天母,2023-05-24,9893
2515,中工,10,0,10,元大-大天母,2023-05-24,9893
6122,擎邦,11,1,10,元大-大天母,2023-05-24,9893
6457,紘康,10,0,10,元大-大天母,2023-05-24,9893
00720B,元大投資級公司債,11,1,10,元大-大天母,2023-05-24,9893
2614,東森,10,0,10,元大-大天母,2023-05-24,9893
4746,台耀,21,11,10,元大-大天母,2023-05-24,9893
1584,精剛,9,0,9,元大-大天母,2023-05-24,9893
2630,亞航,34,25,9,元大-大天母,2023-05-24,9893
00928,中信上櫃ESG30,10,1,9,元大-大天母,2023-05-24,9893
2722,夏都,9,0,9,元大-大天母,2023-05-24,9893
2892,第一金,112,4,108,元大-大天母,2023-05-25,9893
00688L,國泰20年美債正2,104,1,103,元大-大天母,2023-05-25,9893
2885,元大金,97,0,97,元大-大天母,2023-05-25,9893
2331,精英,92,5,87,元大-大天母,2023-05-25,9893
006206,元大上證50,70,0,70,元大-大天母,2023-05-25,9893
1605,華新,64,2,62,元大-大天母,2023-05-25,9893
3044,健鼎,60,0,60,元大-大天母,2023-05-25,9893
00882,中信中國高股息,79,21,58,元大-大天母,2023-05-25,9893
00632R,元大台灣50反1,82,32,50,元大-大天母,2023-05-25,9893
2890,永豐金,50,0,50,元大-大天母,2023-05-25,9893
2349,錸德,43,0,43,元大-大天母,2023-05-25,9893
3011,今皓,40,0,40,元大-大天母,2023-05-25,9893
2891,中信金,39,2,37,元大-大天母,2023-05-25,9893
2702,華園,38,1,37,元大-大天母,2023-05-25,9893
6443,元晶,37,2,35,元大-大天母,2023-05-25,9893
2427,三商電,34,1,33,元大-大天母,2023-05-25,9893
00715L,期街口布蘭特正2,38,6,32,元大-大天母,2023-05-25,9893
3050,鈺德,31,0,31,元大-大天母,2023-05-25,9893
4564,元翎,67,36,31,元大-大天母,2023-05-25,9893
00679B,元大美債20年,38,8,30,元大-大天母,2023-05-25,9893
00637L,元大滬深300正2,45,16,29,元大-大天母,2023-05-25,9893
2206,三陽工業,32,3,29,元大-大天母,2023-05-25,9893
6274,台燿,31,5,26,元大-大天母,2023-05-25,9893
00753L,中信中國50正2,25,0,25,元大-大天母,2023-05-25,9893
2630,亞航,60,37,23,元大-大天母,2023-05-25,9893
00687B,國泰20年美債,22,0,22,元大-大天母,2023-05-25,9893
2457,飛宏,25,3,22,元大-大天母,2023-05-25,9893
2014,中鴻,20,0,20,元大-大天母,2023-05-25,9893
1310,台苯,20,0,20,元大-大天母,2023-05-25,9893
2382,廣達,35,15,20,元大-大天母,2023-05-25,9893
3035,智原,38,19,19,元大-大天母,2023-05-25,9893
2736,富野,27,8,19,元大-大天母,2023-05-25,9893
00751B,元大AAA至A公司債,18,0,18,元大-大天母,2023-05-25,9893
2402,毅嘉,27,9,18,元大-大天母,2023-05-25,9893
2303,聯電,32,14,18,元大-大天母,2023-05-25,9893
2882,國泰金,20,3,17,元大-大天母,2023-05-25,9893
2313,華通,25,8,17,元大-大天母,2023-05-25,9893
2883,凱基金,16,0,16,元大-大天母,2023-05-25,9893
1504,東元,42,26,16,元大-大天母,2023-05-25,9893
3363,上詮,22,6,16,元大-大天母,2023-05-25,9893
6164,華興,17,1,16,元大-大天母,2023-05-25,9893
3178,公準,15,0,15,元大-大天母,2023-05-25,9893
00633L,富邦上証正2,14,0,14,元大-大天母,2023-05-25,9893
2884,玉山金,24,10,14,元大-大天母,2023-05-25,9893
2317,鴻海,14,1,13,元大-大天母,2023-05-25,9893
4746,台耀,27,14,13,元大-大天母,2023-05-25,9893
8937,合騏,13,0,13,元大-大天母,2023-05-25,9893
6150,撼訊,12,0,12,元大-大天母,2023-05-25,9893
5880,合庫金,32,20,12,元大-大天母,2023-05-25,9893
5876,上海商銀,12,0,12,元大-大天母,2023-05-25,9893
2548,華固,101,0,101,元大-大天母,2023-05-26,9893
5443,均豪,59,1,58,元大-大天母,2023-05-26,9893
2323,中環,87,33,54,元大-大天母,2023-05-26,9893
1905,華紙,53,0,53,元大-大天母,2023-05-26,9893
00637L,元大滬深300正2,51,0,51,元大-大天母,2023-05-26,9893
2301,光寶科,45,4,41,元大-大天母,2023-05-26,9893
3011,今皓,41,0,41,元大-大天母,2023-05-26,9893
2882,國泰金,40,2,38,元大-大天母,2023-05-26,9893
2886,兆豐金,57,20,37,元大-大天母,2023-05-26,9893
00680L,元大美債20正2,37,0,37,元大-大天母,2023-05-26,9893
5512,力麒,31,1,30,元大-大天母,2023-05-26,9893
2851,中再保,30,0,30,元大-大天母,2023-05-26,9893
3646,艾恩特,34,4,30,元大-大天母,2023-05-26,9893
2489,瑞軒,27,0,27,元大-大天母,2023-05-26,9893
2883,凱基金,28,2,26,元大-大天母,2023-05-26,9893
00715L,期街口布蘭特正2,24,0,24,元大-大天母,2023-05-26,9893
00712,復華富時不動產,24,3,21,元大-大天母,2023-05-26,9893
6456,GIS-KY,21,0,21,元大-大天母,2023-05-26,9893
3289,宜特,21,0,21,元大-大天母,2023-05-26,9893
00679B,元大美債20年,20,0,20,元大-大天母,2023-05-26,9893
2427,三商電,20,0,20,元大-大天母,2023-05-26,9893
1711,永光,19,0,19,元大-大天母,2023-05-26,9893
1609,大亞,28,10,18,元大-大天母,2023-05-26,9893
0055,元大MSCI金融,18,0,18,元大-大天母,2023-05-26,9893
3481,群創,22,5,17,元大-大天母,2023-05-26,9893
4564,元翎,67,50,17,元大-大天母,2023-05-26,9893
2881,富邦金,17,0,17,元大-大天母,2023-05-26,9893
00772B,中信高評級公司債,16,0,16,元大-大天母,2023-05-26,9893
3094,聯傑,18,2,16,元大-大天母,2023-05-26,9893
6167,久正,15,0,15,元大-大天母,2023-05-26,9893
3078,僑威,18,4,14,元大-大天母,2023-05-26,9893
5880,合庫金,14,0,14,元大-大天母,2023-05-26,9893
6443,元晶,34,21,13,元大-大天母,2023-05-26,9893
6125,廣運,15,2,13,元大-大天母,2023-05-26,9893
6770,力積電,14,1,13,元大-大天母,2023-05-26,9893
8044,網家,13,0,13,元大-大天母,2023-05-26,9893
1612,宏泰,12,0,12,元大-大天母,2023-05-26,9893
8050,廣積,12,0,12,元大-大天母,2023-05-26,9893
4746,台耀,17,5,12,元大-大天母,2023-05-26,9893
2371,大同,50,39,11,元大-大天母,2023-05-26,9893
3005,神基,12,1,11,元大-大天母,2023-05-26,9893
4142,國光生,11,0,11,元大-大天母,2023-05-26,9893
2412,中華電,10,0,10,元大-大天母,2023-05-26,9893
2884,玉山金,12,2,10,元大-大天母,2023-05-26,9893
2515,中工,10,0,10,元大-大天母,2023-05-26,9893
2375,凱美,10,0,10,元大-大天母,2023-05-26,9893
2736,富野,25,15,10,元大-大天母,2023-05-26,9893
00676R,富邦臺灣加權反1,10,0,10,元大-大天母,2023-05-26,9893
8109,博大,10,0,10,元大-大天母,2023-05-26,9893
2609,陽明,14,4,10,元大-大天母,2023-05-26,9893
3265,台星科,135,37,98,元大-大天母,2023-05-29,9893
6282,康舒,86,19,67,元大-大天母,2023-05-29,9893
1218,泰山,65,4,61,元大-大天母,2023-05-29,9893
2886,兆豐金,61,3,58,元大-大天母,2023-05-29,9893
00632R,元大台灣50反1,116,60,56,元大-大天母,2023-05-29,9893
3025,星通,68,23,45,元大-大天母,2023-05-29,9893
2303,聯電,95,51,44,元大-大天母,2023-05-29,9893
00679B,元大美債20年,60,21,39,元大-大天母,2023-05-29,9893
00687B,國泰20年美債,37,0,37,元大-大天母,2023-05-29,9893
006206,元大上證50,30,0,30,元大-大天母,2023-05-29,9893
2851,中再保,30,0,30,元大-大天母,2023-05-29,9893
9902,台火,30,0,30,元大-大天母,2023-05-29,9893
2427,三商電,29,0,29,元大-大天母,2023-05-29,9893
8069,元太,27,1,26,元大-大天母,2023-05-29,9893
3443,創意,29,4,25,元大-大天母,2023-05-29,9893
4908,前鼎,25,0,25,元大-大天母,2023-05-29,9893
00637L,元大滬深300正2,24,0,24,元大-大天母,2023-05-29,9893
00891,中信關鍵半導體,34,10,24,元大-大天母,2023-05-29,9893
0056,元大高股息,82,61,21,元大-大天母,2023-05-29,9893
9944,新麗,20,0,20,元大-大天母,2023-05-29,9893
1101,台泥,20,2,18,元大-大天母,2023-05-29,9893
2344,華邦電,111,93,18,元大-大天母,2023-05-29,9893
2002,中鋼,25,7,18,元大-大天母,2023-05-29,9893
3481,群創,25,10,15,元大-大天母,2023-05-29,9893
3532,台勝科,16,1,15,元大-大天母,2023-05-29,9893
3037,欣興,21,6,15,元大-大天母,2023-05-29,9893
8046,南電,15,1,14,元大-大天母,2023-05-29,9893
3711,日月光投控,14,0,14,元大-大天母,2023-05-29,9893
00680L,元大美債20正2,13,0,13,元大-大天母,2023-05-29,9893
2753,八方雲集,12,0,12,元大-大天母,2023-05-29,9893
2105,正新,11,0,11,元大-大天母,2023-05-29,9893
00772B,中信高評級公司債,11,0,11,元大-大天母,2023-05-29,9893
00712,復華富時不動產,11,0,11,元大-大天母,2023-05-29,9893
4564,元翎,13,3,10,元大-大天母,2023-05-29,9893
6547,高端疫苗,11,1,10,元大-大天母,2023-05-29,9893
1802,台玻,10,0,10,元大-大天母,2023-05-29,9893
6579,研揚,10,0,10,元大-大天母,2023-05-29,9893
6015,宏遠證,10,0,10,元大-大天母,2023-05-29,9893
8043,蜜望實,10,0,10,元大-大天母,2023-05-29,9893
2489,瑞軒,10,0,10,元大-大天母,2023-05-29,9893
1477,聚陽,10,0,10,元大-大天母,2023-05-29,9893
2412,中華電,9,0,9,元大-大天母,2023-05-29,9893
00673R,期元大S＆P原油反1,9,0,9,元大-大天母,2023-05-29,9893
6274,台燿,10,1,9,元大-大天母,2023-05-29,9893
6186,新潤,9,0,9,元大-大天母,2023-05-29,9893
6285,啟��,10,1,9,元大-大天母,2023-05-29,9893
9958,世紀鋼,16,8,8,元大-大天母,2023-05-29,9893
00688L,國泰20年美債正2,8,0,8,元大-大天母,2023-05-29,9893
00895,富邦未來車,8,0,8,元大-大天母,2023-05-29,9893
8996,高力,8,0,8,元大-大天母,2023-05-29,9893
2201,裕隆,182,78,104,元大-大天母,2023-05-30,9893
6438,迅得,100,11,89,元大-大天母,2023-05-30,9893
1301,台塑,75,0,75,元大-大天母,2023-05-30,9893
2548,華固,74,0,74,元大-大天母,2023-05-30,9893
2705,六福,70,1,69,元大-大天母,2023-05-30,9893
00882,中信中國高股息,90,26,64,元大-大天母,2023-05-30,9893
3078,僑威,67,10,57,元大-大天母,2023-05-30,9893
3305,昇貿,54,4,50,元大-大天母,2023-05-30,9893
00878,國泰永續高股息,77,29,48,元大-大天母,2023-05-30,9893
3025,星通,56,9,47,元大-大天母,2023-05-30,9893
2356,英業達,65,19,46,元大-大天母,2023-05-30,9893
8059,凱碩,49,3,46,元大-大天母,2023-05-30,9893
2332,友訊,39,2,37,元大-大天母,2023-05-30,9893
00720B,元大投資級公司債,34,0,34,元大-大天母,2023-05-30,9893
3044,健鼎,40,6,34,元大-大天母,2023-05-30,9893
2881,富邦金,42,10,32,元大-大天母,2023-05-30,9893
00753L,中信中國50正2,30,0,30,元大-大天母,2023-05-30,9893
006206,元大上證50,30,0,30,元大-大天母,2023-05-30,9893
5498,凱崴,32,5,27,元大-大天母,2023-05-30,9893
2427,三商電,29,2,27,元大-大天母,2023-05-30,9893
2344,華邦電,54,28,26,元大-大天母,2023-05-30,9893
3047,訊舟,23,0,23,元大-大天母,2023-05-30,9893
9944,新麗,23,2,21,元大-大天母,2023-05-30,9893
2489,瑞軒,20,0,20,元大-大天母,2023-05-30,9893
1314,中石化,20,0,20,元大-大天母,2023-05-30,9893
1434,福懋,20,0,20,元大-大天母,2023-05-30,9893
8215,明基材,20,0,20,元大-大天母,2023-05-30,9893
3011,今皓,20,0,20,元大-大天母,2023-05-30,9893
2331,精英,25,7,18,元大-大天母,2023-05-30,9893
2002,中鋼,16,0,16,元大-大天母,2023-05-30,9893
6168,宏齊,16,0,16,元大-大天母,2023-05-30,9893
5475,德宏,15,0,15,元大-大天母,2023-05-30,9893
2369,菱生,15,0,15,元大-大天母,2023-05-30,9893
00687B,國泰20年美債,15,0,15,元大-大天母,2023-05-30,9893
2412,中華電,17,2,15,元大-大天母,2023-05-30,9893
2618,長榮航,74,59,15,元大-大天母,2023-05-30,9893
6188,廣明,17,3,14,元大-大天母,2023-05-30,9893
1609,大亞,19,5,14,元大-大天母,2023-05-30,9893
6121,新普,13,0,13,元大-大天母,2023-05-30,9893
2883,凱基金,13,0,13,元大-大天母,2023-05-30,9893
2916,滿心,14,1,13,元大-大天母,2023-05-30,9893
3481,群創,23,11,12,元大-大天母,2023-05-30,9893
4979,華星光,38,26,12,元大-大天母,2023-05-30,9893
2388,威盛,20,8,12,元大-大天母,2023-05-30,9893
4130,健亞,12,0,12,元大-大天母,2023-05-30,9893
1603,華電,12,0,12,元大-大天母,2023-05-30,9893
8926,台汽電,12,1,11,元大-大天母,2023-05-30,9893
00712,復華富時不動產,11,0,11,元大-大天母,2023-05-30,9893
6269,台郡,11,0,11,元大-大天母,2023-05-30,9893
3363,上詮,19,9,10,元大-大天母,2023-05-30,9893
2705,六福,323,0,323,元大-大天母,2023-05-31,9893
2890,永豐金,121,0,121,元大-大天母,2023-05-31,9893
00882,中信中國高股息,159,48,111,元大-大天母,2023-05-31,9893
4927,泰鼎-KY,102,1,101,元大-大天母,2023-05-31,9893
2881,富邦金,100,0,100,元大-大天母,2023-05-31,9893
2886,兆豐金,77,0,77,元大-大天母,2023-05-31,9893
2408,南亞科,73,11,62,元大-大天母,2023-05-31,9893
6026,福邦證,60,0,60,元大-大天母,2023-05-31,9893
00753L,中信中國50正2,50,0,50,元大-大天母,2023-05-31,9893
2371,大同,102,53,49,元大-大天母,2023-05-31,9893
4123,晟德,40,0,40,元大-大天母,2023-05-31,9893
6282,康舒,46,7,39,元大-大天母,2023-05-31,9893
00715L,期街口布蘭特正2,38,0,38,元大-大天母,2023-05-31,9893
0056,元大高股息,45,12,33,元大-大天母,2023-05-31,9893
00720B,元大投資級公司債,36,3,33,元大-大天母,2023-05-31,9893
2356,英業達,33,3,30,元大-大天母,2023-05-31,9893
2427,三商電,29,0,29,元大-大天母,2023-05-31,9893
2328,廣宇,44,16,28,元大-大天母,2023-05-31,9893
2548,華固,28,1,27,元大-大天母,2023-05-31,9893
2344,華邦電,63,36,27,元大-大天母,2023-05-31,9893
2330,台積電,32,6,26,元大-大天母,2023-05-31,9893
6770,力積電,25,1,24,元大-大天母,2023-05-31,9893
4979,華星光,38,16,22,元大-大天母,2023-05-31,9893
00642U,期元大S＆P石油,22,0,22,元大-大天母,2023-05-31,9893
2883,凱基金,24,2,22,元大-大天母,2023-05-31,9893
00679B,元大美債20年,21,0,21,元大-大天母,2023-05-31,9893
00633L,富邦上証正2,20,0,20,元大-大天母,2023-05-31,9893
6223,旺矽,22,2,20,元大-大天母,2023-05-31,9893
5531,鄉林,20,0,20,元大-大天母,2023-05-31,9893
6168,宏齊,20,0,20,元大-大天母,2023-05-31,9893
6245,立端,33,14,19,元大-大天母,2023-05-31,9893
4958,臻鼎-KY,20,1,19,元大-大天母,2023-05-31,9893
2201,裕隆,28,9,19,元大-大天母,2023-05-31,9893
00637L,元大滬深300正2,25,7,18,元大-大天母,2023-05-31,9893
2515,中工,242,225,17,元大-大天母,2023-05-31,9893
1603,華電,51,35,16,元大-大天母,2023-05-31,9893
6125,廣運,17,1,16,元大-大天母,2023-05-31,9893
5351,鈺創,33,17,16,元大-大天母,2023-05-31,9893
2317,鴻海,23,7,16,元大-大天母,2023-05-31,9893
3032,偉訓,17,2,15,元大-大天母,2023-05-31,9893
3583,辛耘,14,0,14,元大-大天母,2023-05-31,9893
9944,新麗,14,2,12,元大-大天母,2023-05-31,9893
2006,東和鋼鐵,11,0,11,元大-大天母,2023-05-31,9893
2834,臺企銀,11,0,11,元大-大天母,2023-05-31,9893
2451,創見,12,1,11,元大-大天母,2023-05-31,9893
3711,日月光投控,11,0,11,元大-大天母,2023-05-31,9893
2345,智邦,12,1,11,元大-大天母,2023-05-31,9893
6121,新普,10,0,10,元大-大天母,2023-05-31,9893
00655L,國泰中國A50正2,10,0,10,元大-大天母,2023-05-31,9893
3035,智原,11,1,10,元大-大天母,2023-05-31,9893
2618,長榮航,440,142,298,元大-大天母,2023-06-01,9893
2515,中工,248,12,236,元大-大天母,2023-06-01,9893
2888,新光金,221,0,221,元大-大天母,2023-06-01,9893
2705,六福,171,7,164,元大-大天母,2023-06-01,9893
00715L,期街口布蘭特正2,134,0,134,元大-大天母,2023-06-01,9893
00687B,國泰20年美債,77,0,77,元大-大天母,2023-06-01,9893
00633L,富邦上証正2,50,0,50,元大-大天母,2023-06-01,9893
00632R,元大台灣50反1,42,0,42,元大-大天母,2023-06-01,9893
3260,威剛,46,5,41,元大-大天母,2023-06-01,9893
2323,中環,58,18,40,元大-大天母,2023-06-01,9893
2303,聯電,50,11,39,元大-大天母,2023-06-01,9893
3504,揚明光,32,2,30,元大-大天母,2023-06-01,9893
5355,佳總,30,0,30,元大-大天母,2023-06-01,9893
6180,橘子,49,20,29,元大-大天母,2023-06-01,9893
00891,中信關鍵半導體,26,0,26,元大-大天母,2023-06-01,9893
6015,宏遠證,30,4,26,元大-大天母,2023-06-01,9893
0056,元大高股息,39,14,25,元大-大天母,2023-06-01,9893
3013,晟銘電,54,30,24,元大-大天母,2023-06-01,9893
4564,元翎,37,13,24,元大-大天母,2023-06-01,9893
4916,事欣科,25,1,24,元大-大天母,2023-06-01,9893
6443,元晶,22,2,20,元大-大天母,2023-06-01,9893
00772B,中信高評級公司債,19,0,19,元大-大天母,2023-06-01,9893
6125,廣運,20,1,19,元大-大天母,2023-06-01,9893
2892,第一金,33,15,18,元大-大天母,2023-06-01,9893
2881,富邦金,21,2,19,元大-大天母,2023-06-01,9893
1503,士電,20,3,17,元大-大天母,2023-06-01,9893
00919,群益台灣精選高息,17,0,17,元大-大天母,2023-06-01,9893
2330,台積電,22,6,16,元大-大天母,2023-06-01,9893
2376,技嘉,23,7,16,元大-大天母,2023-06-01,9893
2427,三商電,29,14,15,元大-大天母,2023-06-01,9893
00679B,元大美債20年,14,0,14,元大-大天母,2023-06-01,9893
6288,聯嘉,15,1,14,元大-大天母,2023-06-01,9893
8222,寶一,16,3,13,元大-大天母,2023-06-01,9893
1605,華新,13,0,13,元大-大天母,2023-06-01,9893
00720B,元大投資級公司債,12,0,12,元大-大天母,2023-06-01,9893
1504,東元,14,2,12,元大-大天母,2023-06-01,9893
2408,南亞科,12,0,12,元大-大天母,2023-06-01,9893
4915,致伸,12,0,12,元大-大天母,2023-06-01,9893
00642U,期元大S＆P石油,12,0,12,元大-大天母,2023-06-01,9893
2455,全新,19,8,11,元大-大天母,2023-06-01,9893
2382,廣達,20,9,11,元大-大天母,2023-06-01,9893
00680L,元大美債20正2,11,0,11,元大-大天母,2023-06-01,9893
8088,品安,16,5,11,元大-大天母,2023-06-01,9893
3033,威健,11,0,11,元大-大天母,2023-06-01,9893
00751B,元大AAA至A公司債,10,0,10,元大-大天母,2023-06-01,9893
00713,元大台灣高息低波,11,1,10,元大-大天母,2023-06-01,9893
3025,星通,13,3,10,元大-大天母,2023-06-01,9893
1710,東聯,10,0,10,元大-大天母,2023-06-01,9893
2467,志聖,10,0,10,元大-大天母,2023-06-01,9893
4909,新復興,10,0,10,元大-大天母,2023-06-01,9893
2897,王道銀行,200,10,190,元大-大天母,2023-06-02,9893
00926,凱基全球菁英55,185,0,185,元大-大天母,2023-06-02,9893
00632R,元大台灣50反1,160,0,160,元大-大天母,2023-06-02,9893
2888,新光金,112,0,112,元大-大天母,2023-06-02,9893
2610,華航,142,39,103,元大-大天母,2023-06-02,9893
3260,威剛,87,2,85,元大-大天母,2023-06-02,9893
6239,力成,60,2,58,元大-大天母,2023-06-02,9893
2883,凱基金,54,0,54,元大-大天母,2023-06-02,9893
00713,元大台灣高息低波,73,23,50,元大-大天母,2023-06-02,9893
00637L,元大滬深300正2,55,6,49,元大-大天母,2023-06-02,9893
2382,廣達,66,26,40,元大-大天母,2023-06-02,9893
6207,雷科,38,0,38,元大-大天母,2023-06-02,9893
4908,前鼎,39,1,38,元大-大天母,2023-06-02,9893
2359,所羅門,38,5,33,元大-大天母,2023-06-02,9893
2371,大同,38,5,33,元大-大天母,2023-06-02,9893
1608,華榮,41,10,31,元大-大天母,2023-06-02,9893
3712,永崴投控,32,1,31,元大-大天母,2023-06-02,9893
2903,遠百,30,0,30,元大-大天母,2023-06-02,9893
6167,久正,36,8,28,元大-大天母,2023-06-02,9893
1301,台塑,25,0,25,元大-大天母,2023-06-02,9893
0056,元大高股息,83,58,25,元大-大天母,2023-06-02,9893
1806,冠軍,21,0,21,元大-大天母,2023-06-02,9893
1434,福懋,20,0,20,元大-大天母,2023-06-02,9893
5439,高技,21,1,20,元大-大天母,2023-06-02,9893
5371,中光電,20,0,20,元大-大天母,2023-06-02,9893
2913,農林,23,3,20,元大-大天母,2023-06-02,9893
2520,冠德,20,0,20,元大-大天母,2023-06-02,9893
8271,宇瞻,29,9,20,元大-大天母,2023-06-02,9893
6015,宏遠證,30,10,20,元大-大天母,2023-06-02,9893
1717,長興,22,3,19,元大-大天母,2023-06-02,9893
2892,第一金,22,4,18,元大-大天母,2023-06-02,9893
2530,華建,18,0,18,元大-大天母,2023-06-02,9893
4147,中裕,18,2,16,元大-大天母,2023-06-02,9893
8112,至上,23,8,15,元大-大天母,2023-06-02,9893
4979,華星光,42,27,15,元大-大天母,2023-06-02,9893
2236,百達-KY,25,10,15,元大-大天母,2023-06-02,9893
00919,群益台灣精選高息,14,0,14,元大-大天母,2023-06-02,9893
8088,品安,25,12,13,元大-大天母,2023-06-02,9893
5483,中美晶,13,0,13,元大-大天母,2023-06-02,9893
1603,華電,23,11,12,元大-大天母,2023-06-02,9893
2504,國產,12,0,12,元大-大天母,2023-06-02,9893
9902,台火,12,0,12,元大-大天母,2023-06-02,9893
5355,佳總,12,0,12,元大-大天母,2023-06-02,9893
3546,宇峻,12,1,11,元大-大天母,2023-06-02,9893
2367,燿華,13,2,11,元大-大天母,2023-06-02,9893
2409,友達,17,6,11,元大-大天母,2023-06-02,9893
2753,八方雲集,14,3,11,元大-大天母,2023-06-02,9893
2457,飛宏,26,16,10,元大-大天母,2023-06-02,9893
2615,萬海,21,11,10,元大-大天母,2023-06-02,9893
6271,同欣電,10,0,10,元大-大天母,2023-06-02,9893
3481,群創,310,112,198,元大-大天母,2023-06-05,9893
2888,新光金,310,155,155,元大-大天母,2023-06-05,9893
2303,聯電,121,2,119,元大-大天母,2023-06-05,9893
2353,宏��,120,33,87,元大-大天母,2023-06-05,9893
2610,華航,97,32,65,元大-大天母,2023-06-05,9893
00713,元大台灣高息低波,63,0,63,元大-大天母,2023-06-05,9893
2383,台光電,50,0,50,元大-大天母,2023-06-05,9893
00919,群益台灣精選高息,49,1,48,元大-大天母,2023-06-05,9893
2891,中信金,53,7,46,元大-大天母,2023-06-05,9893
2705,六福,41,0,41,元大-大天母,2023-06-05,9893
3693,營邦,40,0,40,元大-大天母,2023-06-05,9893
2520,冠德,38,0,38,元大-大天母,2023-06-05,9893
1815,富喬,33,0,33,元大-大天母,2023-06-05,9893
2331,精英,33,0,33,元大-大天母,2023-06-05,9893
2474,可成,30,0,30,元大-大天母,2023-06-05,9893
6015,宏遠證,30,0,30,元大-大天母,2023-06-05,9893
6239,力成,26,0,26,元大-大天母,2023-06-05,9893
9933,中鼎,25,0,25,元大-大天母,2023-06-05,9893
4743,合一,24,1,23,元大-大天母,2023-06-05,9893
00720B,元大投資級公司債,23,0,23,元大-大天母,2023-06-05,9893
6142,友勁,23,0,23,元大-大天母,2023-06-05,9893
2344,華邦電,46,23,23,元大-大天母,2023-06-05,9893
6446,藥華藥,24,4,20,元大-大天母,2023-06-05,9893
2423,固緯,20,0,20,元大-大天母,2023-06-05,9893
00679B,元大美債20年,19,0,19,元大-大天母,2023-06-05,9893
9950,萬國通,19,0,19,元大-大天母,2023-06-05,9893
0050,元大台灣50,19,0,19,元大-大天母,2023-06-05,9893
2603,長榮,19,2,17,元大-大天母,2023-06-05,9893
2371,大同,24,6,18,元大-大天母,2023-06-05,9893
6214,精誠,23,7,16,元大-大天母,2023-06-05,9893
00882,中信中國高股息,29,13,16,元大-大天母,2023-06-05,9893
3037,欣興,15,0,15,元大-大天母,2023-06-05,9893
3078,僑威,37,22,15,元大-大天母,2023-06-05,9893
2349,錸德,35,20,15,元大-大天母,2023-06-05,9893
8358,金居,29,14,15,元大-大天母,2023-06-05,9893
2881,富邦金,21,7,14,元大-大天母,2023-06-05,9893
2867,三商壽,12,0,12,元大-大天母,2023-06-05,9893
1101,台泥,18,6,12,元大-大天母,2023-06-05,9893
2337,旺宏,13,1,12,元大-大天母,2023-06-05,9893
3706,神達,41,29,12,元大-大天母,2023-06-05,9893
1319,東陽,12,1,11,元大-大天母,2023-06-05,9893
00673R,期元大S＆P原油反1,11,0,11,元大-大天母,2023-06-05,9893
3701,大眾控,12,1,11,元大-大天母,2023-06-05,9893
2484,希華,11,0,11,元大-大天母,2023-06-05,9893
1514,亞力,48,38,10,元大-大天母,2023-06-05,9893
2363,矽統,10,0,10,元大-大天母,2023-06-05,9893
3209,全科,10,0,10,元大-大天母,2023-06-05,9893
4906,正文,22,12,10,元大-大天母,2023-06-05,9893
5410,國眾,10,0,10,元大-大天母,2023-06-05,9893
00665L,富邦�琤肭磪囓�2,10,0,10,元大-大天母,2023-06-05,9893
00927,群益半導體收益,140,0,140,元大-大天母,2023-06-06,9893
2303,聯電,123,6,117,元大-大天母,2023-06-06,9893
4915,致伸,60,0,60,元大-大天母,2023-06-06,9893
3583,辛耘,57,3,54,元大-大天母,2023-06-06,9893
00679B,元大美債20年,50,0,50,元大-大天母,2023-06-06,9893
2888,新光金,64,15,49,元大-大天母,2023-06-06,9893
1603,華電,77,33,44,元大-大天母,2023-06-06,9893
00919,群益台灣精選高息,43,1,42,元大-大天母,2023-06-06,9893
2883,凱基金,48,6,42,元大-大天母,2023-06-06,9893
00753L,中信中國50正2,60,20,40,元大-大天母,2023-06-06,9893
2545,皇翔,34,0,34,元大-大天母,2023-06-06,9893
5531,鄉林,34,1,33,元大-大天母,2023-06-06,9893
2489,瑞軒,34,2,32,元大-大天母,2023-06-06,9893
6276,安鈦克,30,1,29,元大-大天母,2023-06-06,9893
00637L,元大滬深300正2,75,47,28,元大-大天母,2023-06-06,9893
00713,元大台灣高息低波,27,1,26,元大-大天母,2023-06-06,9893
1609,大亞,128,106,22,元大-大天母,2023-06-06,9893
2402,毅嘉,45,23,22,元大-大天母,2023-06-06,9893
3047,訊舟,22,0,22,元大-大天母,2023-06-06,9893
6443,元晶,43,22,21,元大-大天母,2023-06-06,9893
9902,台火,20,0,20,元大-大天母,2023-06-06,9893
2485,兆赫,20,0,20,元大-大天母,2023-06-06,9893
8088,品安,21,1,20,元大-大天母,2023-06-06,9893
9950,萬國通,20,0,20,元大-大天母,2023-06-06,9893
00680L,元大美債20正2,19,0,19,元大-大天母,2023-06-06,9893
6527,明達醫,17,0,17,元大-大天母,2023-06-06,9893
2014,中鴻,20,3,17,元大-大天母,2023-06-06,9893
1905,華紙,40,24,16,元大-大天母,2023-06-06,9893
00632R,元大台灣50反1,16,0,16,元大-大天母,2023-06-06,9893
00712,復華富時不動產,17,1,16,元大-大天母,2023-06-06,9893
4977,眾達-KY,15,0,15,元大-大天母,2023-06-06,9893
00715L,期街口布蘭特正2,18,3,15,元大-大天母,2023-06-06,9893
4906,正文,16,1,15,元大-大天母,2023-06-06,9893
3504,揚明光,19,4,15,元大-大天母,2023-06-06,9893
5512,力麒,15,0,15,元大-大天母,2023-06-06,9893
2313,華通,21,7,14,元大-大天母,2023-06-06,9893
3706,神達,21,7,14,元大-大天母,2023-06-06,9893
2331,精英,14,0,14,元大-大天母,2023-06-06,9893
1528,恩德,16,2,14,元大-大天母,2023-06-06,9893
5388,中磊,14,0,14,元大-大天母,2023-06-06,9893
2603,長榮,16,3,13,元大-大天母,2023-06-06,9893
3437,榮創,13,0,13,元大-大天母,2023-06-06,9893
6116,彩晶,13,0,13,元大-大天母,2023-06-06,9893
2630,亞航,25,12,13,元大-大天母,2023-06-06,9893
3231,緯創,56,44,12,元大-大天母,2023-06-06,9893
4114,健喬,12,0,12,元大-大天母,2023-06-06,9893
6111,大宇資,15,3,12,元大-大天母,2023-06-06,9893
2461,光群雷,33,21,12,元大-大天母,2023-06-06,9893
2706,第一店,15,3,12,元大-大天母,2023-06-06,9893
5864,致和證,15,4,11,元大-大天母,2023-06-06,9893
00679B,元大美債20年,169,0,169,元大-大天母,2023-06-07,9893
2891,中信金,100,0,100,元大-大天母,2023-06-07,9893
00637L,元大滬深300正2,69,0,69,元大-大天母,2023-06-07,9893
6282,康舒,76,10,66,元大-大天母,2023-06-07,9893
6285,啟��,57,6,51,元大-大天母,2023-06-07,9893
3479,安勤,50,0,50,元大-大天母,2023-06-07,9893
1102,亞泥,50,1,49,元大-大天母,2023-06-07,9893
00919,群益台灣精選高息,42,0,42,元大-大天母,2023-06-07,9893
3630,新鉅科,45,6,39,元大-大天母,2023-06-07,9893
2618,長榮航,46,8,38,元大-大天母,2023-06-07,9893
00632R,元大台灣50反1,40,5,35,元大-大天母,2023-06-07,9893
00720B,元大投資級公司債,44,10,34,元大-大天母,2023-06-07,9893
1301,台塑,32,0,32,元大-大天母,2023-06-07,9893
2637,慧洋-KY,30,0,30,元大-大天母,2023-06-07,9893
00687B,國泰20年美債,30,0,30,元大-大天母,2023-06-07,9893
5388,中磊,33,3,30,元大-大天母,2023-06-07,9893
2633,台灣高鐵,30,0,30,元大-大天母,2023-06-07,9893
3078,僑威,51,27,24,元大-大天母,2023-06-07,9893
6188,廣明,26,6,20,元大-大天母,2023-06-07,9893
3209,全科,20,0,20,元大-大天母,2023-06-07,9893
9950,萬國通,20,0,20,元大-大天母,2023-06-07,9893
2347,聯強,18,1,17,元大-大天母,2023-06-07,9893
00882,中信中國高股息,17,0,17,元大-大天母,2023-06-07,9893
2399,映泰,20,3,17,元大-大天母,2023-06-07,9893
6177,達麗,17,0,17,元大-大天母,2023-06-07,9893
3673,TPK-KY,18,1,17,元大-大天母,2023-06-07,9893
00645,富邦日本,16,0,16,元大-大天母,2023-06-07,9893
3504,揚明光,15,0,15,元大-大天母,2023-06-07,9893
1903,士紙,15,0,15,元大-大天母,2023-06-07,9893
2331,精英,14,0,14,元大-大天母,2023-06-07,9893
4977,眾達-KY,14,1,13,元大-大天母,2023-06-07,9893
2231,為升,13,0,13,元大-大天母,2023-06-07,9893
3701,大眾控,18,5,13,元大-大天母,2023-06-07,9893
1609,大亞,163,150,13,元大-大天母,2023-06-07,9893
8076,伍豐,33,21,12,元大-大天母,2023-06-07,9893
5706,鳳凰,24,12,12,元大-大天母,2023-06-07,9893
00712,復華富時不動產,12,0,12,元大-大天母,2023-06-07,9893
3094,聯傑,14,3,11,元大-大天母,2023-06-07,9893
8215,明基材,13,2,11,元大-大天母,2023-06-07,9893
4908,前鼎,10,0,10,元大-大天母,2023-06-07,9893
2388,威盛,14,4,10,元大-大天母,2023-06-07,9893
1104,環泥,10,0,10,元大-大天母,2023-06-07,9893
5607,遠雄港,10,0,10,元大-大天母,2023-06-07,9893
00661,元大日經225,10,0,10,元大-大天母,2023-06-07,9893
5876,上海商銀,10,0,10,元大-大天母,2023-06-07,9893
9105,泰金寶-DR,10,0,10,元大-大天母,2023-06-07,9893
2302,麗正,10,0,10,元大-大天母,2023-06-07,9893
9902,台火,10,0,10,元大-大天母,2023-06-07,9893
6175,立敦,10,0,10,元大-大天母,2023-06-07,9893
2883B,凱基金乙特,10,0,10,元大-大天母,2023-06-07,9893
6680,鑫創電子,172,0,172,元大-大天母,2023-06-08,9893
8048,德勝,124,4,120,元大-大天母,2023-06-08,9893
00688L,國泰20年美債正2,107,0,107,元大-大天母,2023-06-08,9893
1903,士紙,128,34,94,元大-大天母,2023-06-08,9893
00679B,元大美債20年,92,7,85,元大-大天母,2023-06-08,9893
1519,華城,64,2,62,元大-大天母,2023-06-08,9893
00919,群益台灣精選高息,78,21,57,元大-大天母,2023-06-08,9893
3576,聯合再生,53,2,51,元大-大天母,2023-06-08,9893
3094,聯傑,55,5,50,元大-大天母,2023-06-08,9893
1603,華電,47,0,47,元大-大天母,2023-06-08,9893
1605,華新,45,1,44,元大-大天母,2023-06-08,9893
2201,裕隆,43,1,42,元大-大天母,2023-06-08,9893
1909,榮成,40,0,40,元大-大天母,2023-06-08,9893
8011,台通,43,3,40,元大-大天母,2023-06-08,9893
2423,固緯,40,2,38,元大-大天母,2023-06-08,9893
9944,新麗,36,0,36,元大-大天母,2023-06-08,9893
6625,必應,38,3,35,元大-大天母,2023-06-08,9893
00680L,元大美債20正2,35,0,35,元大-大天母,2023-06-08,9893
2890,永豐金,32,1,31,元大-大天母,2023-06-08,9893
2344,華邦電,59,28,31,元大-大天母,2023-06-08,9893
4927,泰鼎-KY,30,0,30,元大-大天母,2023-06-08,9893
9950,萬國通,27,0,27,元大-大天母,2023-06-08,9893
2211,長榮鋼,32,5,27,元大-大天母,2023-06-08,9893
6691,洋基工程,23,0,23,元大-大天母,2023-06-08,9893
1442,名軒,21,0,21,元大-大天母,2023-06-08,9893
9902,台火,20,0,20,元大-大天母,2023-06-08,9893
00632R,元大台灣50反1,30,10,20,元大-大天母,2023-06-08,9893
3680,家登,22,2,20,元大-大天母,2023-06-08,9893
0056,元大高股息,56,37,19,元大-大天母,2023-06-08,9893
00891,中信關鍵半導體,19,0,19,元大-大天母,2023-06-08,9893
00713,元大台灣高息低波,17,0,17,元大-大天母,2023-06-08,9893
2009,第一銅,20,3,17,元大-大天母,2023-06-08,9893
2347,聯強,17,0,17,元大-大天母,2023-06-08,9893
3035,智原,17,1,16,元大-大天母,2023-06-08,9893
3706,神達,20,4,16,元大-大天母,2023-06-08,9893
1314,中石化,15,0,15,元大-大天母,2023-06-08,9893
020022,元大電動車N,15,0,15,元大-大天母,2023-06-08,9893
00645,富邦日本,22,7,15,元大-大天母,2023-06-08,9893
1504,東元,20,6,14,元大-大天母,2023-06-08,9893
00751B,元大AAA至A公司債,15,1,14,元大-大天母,2023-06-08,9893
00772B,中信高評級公司債,14,0,14,元大-大天母,2023-06-08,9893
6285,啟��,16,2,14,元大-大天母,2023-06-08,9893
2302,麗正,14,0,14,元大-大天母,2023-06-08,9893
1760,寶齡富錦,14,0,14,元大-大天母,2023-06-08,9893
2883,凱基金,33,19,14,元大-大天母,2023-06-08,9893
00795B,中信美國公債20年,14,0,14,元大-大天母,2023-06-08,9893
3325,旭品,14,1,13,元大-大天母,2023-06-08,9893
2409,友達,18,5,13,元大-大天母,2023-06-08,9893
2382,廣達,27,14,13,元大-大天母,2023-06-08,9893
2388,威盛,16,3,13,元大-大天母,2023-06-08,9893
1903,士紙,537,69,468,元大-大天母,2023-06-09,9893
3231,緯創,364,73,291,元大-大天母,2023-06-09,9893
2888,新光金,222,56,166,元大-大天母,2023-06-09,9893
00753L,中信中國50正2,115,0,115,元大-大天母,2023-06-09,9893
1102,亞泥,76,0,76,元大-大天母,2023-06-09,9893
00929,復華台灣科技優息,64,0,64,元大-大天母,2023-06-09,9893
3673,TPK-KY,53,7,46,元大-大天母,2023-06-09,9893
3617,碩天,45,1,44,元大-大天母,2023-06-09,9893
9950,萬國通,40,0,40,元大-大天母,2023-06-09,9893
3264,欣銓,36,0,36,元大-大天母,2023-06-09,9893
2482,連宇,77,44,33,元大-大天母,2023-06-09,9893
2201,裕隆,40,8,32,元大-大天母,2023-06-09,9893
2337,旺宏,38,6,32,元大-大天母,2023-06-09,9893
1504,東元,29,0,29,元大-大天母,2023-06-09,9893
2388,威盛,36,9,27,元大-大天母,2023-06-09,9893
6288,聯嘉,47,21,26,元大-大天母,2023-06-09,9893
2618,長榮航,65,39,26,元大-大天母,2023-06-09,9893
3680,家登,26,1,25,元大-大天母,2023-06-09,9893
00882,中信中國高股息,25,0,25,元大-大天母,2023-06-09,9893
1533,車王電,31,8,23,元大-大天母,2023-06-09,9893
00919,群益台灣精選高息,22,0,22,元大-大天母,2023-06-09,9893
2323,中環,337,316,21,元大-大天母,2023-06-09,9893
1909,榮成,20,0,20,元大-大天母,2023-06-09,9893
2313,華通,21,1,20,元大-大天母,2023-06-09,9893
00680L,元大美債20正2,20,0,20,元大-大天母,2023-06-09,9893
9904,寶成,20,0,20,元大-大天母,2023-06-09,9893
2705,六福,19,0,19,元大-大天母,2023-06-09,9893
6122,擎邦,38,20,18,元大-大天母,2023-06-09,9893
1605,華新,47,30,17,元大-大天母,2023-06-09,9893
6472,保瑞,18,1,17,元大-大天母,2023-06-09,9893
1432,大魯閣,17,0,17,元大-大天母,2023-06-09,9893
3481,群創,15,0,15,元大-大天母,2023-06-09,9893
00772B,中信高評級公司債,15,0,15,元大-大天母,2023-06-09,9893
5469,瀚宇博,15,0,15,元大-大天母,2023-06-09,9893
00642U,期元大S＆P石油,15,0,15,元大-大天母,2023-06-09,9893
00722B,群益投資級電信債,15,0,15,元大-大天母,2023-06-09,9893
9945,潤泰新,15,0,15,元大-大天母,2023-06-09,9893
8034,榮群,20,7,13,元大-大天母,2023-06-09,9893
8011,台通,12,0,12,元大-大天母,2023-06-09,9893
4927,泰鼎-KY,12,0,12,元大-大天母,2023-06-09,9893
2356,英業達,57,46,11,元大-大天母,2023-06-09,9893
3363,上詮,17,6,11,元大-大天母,2023-06-09,9893
00927,群益半導體收益,11,0,11,元大-大天母,2023-06-09,9893
6443,元晶,31,20,11,元大-大天母,2023-06-09,9893
1101,台泥,13,2,11,元大-大天母,2023-06-09,9893
6271,同欣電,11,1,10,元大-大天母,2023-06-09,9893
2308,台達電,10,0,10,元大-大天母,2023-06-09,9893
2903,遠百,10,0,10,元大-大天母,2023-06-09,9893
1301,台塑,10,0,10,元大-大天母,2023-06-09,9893
2633,台灣高鐵,11,1,10,元大-大天母,2023-06-09,9893
00632R,元大台灣50反1,249,112,137,元大-大天母,2023-06-12,9893
3231,緯創,121,32,89,元大-大天母,2023-06-12,9893
6789,采鈺,81,3,78,元大-大天母,2023-06-12,9893
1102,亞泥,75,0,75,元大-大天母,2023-06-12,9893
2344,華邦電,122,50,72,元大-大天母,2023-06-12,9893
00712,復華富時不動產,60,0,60,元大-大天母,2023-06-12,9893
2353,宏��,63,3,60,元大-大天母,2023-06-12,9893
3545,敦泰,60,0,60,元大-大天母,2023-06-12,9893
5381,合正,60,0,60,元大-大天母,2023-06-12,9893
3047,訊舟,51,1,50,元大-大天母,2023-06-12,9893
1314,中石化,46,0,46,元大-大天母,2023-06-12,9893
5864,致和證,46,0,46,元大-大天母,2023-06-12,9893
2884,玉山金,60,15,45,元大-大天母,2023-06-12,9893
3673,TPK-KY,41,0,41,元大-大天母,2023-06-12,9893
2801,彰銀,40,0,40,元大-大天母,2023-06-12,9893
3078,僑威,49,10,39,元大-大天母,2023-06-12,9893
00919,群益台灣精選高息,36,0,36,元大-大天母,2023-06-12,9893
5529,鉅陞,35,1,34,元大-大天母,2023-06-12,9893
2412,中華電,35,4,31,元大-大天母,2023-06-12,9893
3264,欣銓,39,9,30,元大-大天母,2023-06-12,9893
3011,今皓,30,0,30,元大-大天母,2023-06-12,9893
6443,元晶,70,45,25,元大-大天母,2023-06-12,9893
1907,永豐餘,22,0,22,元大-大天母,2023-06-12,9893
4188,安克,22,0,22,元大-大天母,2023-06-12,9893
8358,金居,22,0,22,元大-大天母,2023-06-12,9893
5425,台半,31,10,21,元大-大天母,2023-06-12,9893
1533,車王電,32,11,21,元大-大天母,2023-06-12,9893
6245,立端,20,0,20,元大-大天母,2023-06-12,9893
1909,榮成,20,0,20,元大-大天母,2023-06-12,9893
2705,六福,23,3,20,元大-大天母,2023-06-12,9893
4960,誠美材,20,0,20,元大-大天母,2023-06-12,9893
8069,元太,32,12,20,元大-大天母,2023-06-12,9893
1319,東陽,20,1,19,元大-大天母,2023-06-12,9893
4977,眾達-KY,40,21,19,元大-大天母,2023-06-12,9893
1301,台塑,20,1,19,元大-大天母,2023-06-12,9893
3481,群創,26,8,18,元大-大天母,2023-06-12,9893
2303,聯電,47,29,18,元大-大天母,2023-06-12,9893
2610,華航,36,19,17,元大-大天母,2023-06-12,9893
2328,廣宇,21,4,17,元大-大天母,2023-06-12,9893
1513,中興電,19,3,16,元大-大天母,2023-06-12,9893
00648R,元大S＆P500反1,16,0,16,元大-大天母,2023-06-12,9893
2534,宏盛,16,0,16,元大-大天母,2023-06-12,9893
00720B,元大投資級公司債,15,0,15,元大-大天母,2023-06-12,9893
6691,洋基工程,17,2,15,元大-大天母,2023-06-12,9893
6485,點序,15,0,15,元大-大天母,2023-06-12,9893
4171,瑞基,14,0,14,元大-大天母,2023-06-12,9893
9907,統一實,14,0,14,元大-大天母,2023-06-12,9893
5439,高技,20,6,14,元大-大天母,2023-06-12,9893
00895,富邦未來車,14,0,14,元大-大天母,2023-06-12,9893
9942,茂順,13,0,13,元大-大天母,2023-06-12,9893
00632R,元大台灣50反1,279,60,219,元大-大天母,2023-06-13,9893
00665L,富邦�琤肭磪囓�2,200,0,200,元大-大天母,2023-06-13,9893
6005,群益證,150,0,150,元大-大天母,2023-06-13,9893
3231,緯創,130,44,86,元大-大天母,2023-06-13,9893
1102,亞泥,76,0,76,元大-大天母,2023-06-13,9893
2888,新光金,79,14,65,元大-大天母,2023-06-13,9893
3207,耀勝,60,0,60,元大-大天母,2023-06-13,9893
00929,復華台灣科技優息,49,0,49,元大-大天母,2023-06-13,9893
00642U,期元大S＆P石油,45,0,45,元大-大天母,2023-06-13,9893
1301,台塑,41,0,41,元大-大天母,2023-06-13,9893
00715L,期街口布蘭特正2,35,0,35,元大-大天母,2023-06-13,9893
2324,仁寶,38,6,32,元大-大天母,2023-06-13,9893
3035,智原,51,19,32,元大-大天母,2023-06-13,9893
9950,萬國通,30,0,30,元大-大天母,2023-06-13,9893
2412,中華電,30,2,28,元大-大天母,2023-06-13,9893
00919,群益台灣精選高息,73,46,27,元大-大天母,2023-06-13,9893
2301,光寶科,33,8,25,元大-大天母,2023-06-13,9893
00648R,元大S＆P500反1,25,0,25,元大-大天母,2023-06-13,9893
6120,達運,24,1,23,元大-大天母,2023-06-13,9893
4960,誠美材,22,0,22,元大-大天母,2023-06-13,9893
6196,帆宣,30,8,22,元大-大天母,2023-06-13,9893
00881,國泰台灣5G+,31,9,22,元大-大天母,2023-06-13,9893
4726,永昕,23,2,21,元大-大天母,2023-06-13,9893
2352,佳世達,45,26,19,元大-大天母,2023-06-13,9893
8050,廣積,28,10,18,元大-大天母,2023-06-13,9893
00882,中信中國高股息,26,8,18,元大-大天母,2023-06-13,9893
4968,立積,18,0,18,元大-大天母,2023-06-13,9893
6843,進典,17,0,17,元大-大天母,2023-06-13,9893
1609,大亞,22,6,16,元大-大天母,2023-06-13,9893
9933,中鼎,24,8,16,元大-大天母,2023-06-13,9893
6245,立端,22,7,15,元大-大天母,2023-06-13,9893
00891,中信關鍵半導體,20,5,15,元大-大天母,2023-06-13,9893
5425,台半,29,14,15,元大-大天母,2023-06-13,9893
2480,敦陽科,15,0,15,元大-大天母,2023-06-13,9893
1605,華新,15,1,14,元大-大天母,2023-06-13,9893
3308,聯德,14,0,14,元大-大天母,2023-06-13,9893
3030,德律,15,1,14,元大-大天母,2023-06-13,9893
2891,中信金,15,2,13,元大-大天母,2023-06-13,9893
1513,中興電,16,3,13,元大-大天母,2023-06-13,9893
2882,國泰金,16,3,13,元大-大天母,2023-06-13,9893
2312,金寶,14,1,13,元大-大天母,2023-06-13,9893
2834,臺企銀,19,6,13,元大-大天母,2023-06-13,9893
2425,承啟,16,3,13,元大-大天母,2023-06-13,9893
4908,前鼎,12,0,12,元大-大天母,2023-06-13,9893
5880,合庫金,12,0,12,元大-大天母,2023-06-13,9893
6577,勁豐,17,5,12,元大-大天母,2023-06-13,9893
6271,同欣電,12,1,11,元大-大天母,2023-06-13,9893
4741,泓瀚,13,2,11,元大-大天母,2023-06-13,9893
2062,橋椿,11,0,11,元大-大天母,2023-06-13,9893
4564,元翎,11,0,11,元大-大天母,2023-06-13,9893
6282,康舒,376,17,359,元大-大天母,2023-06-14,9893
2834,臺企銀,196,25,171,元大-大天母,2023-06-14,9893
2534,宏盛,134,0,134,元大-大天母,2023-06-14,9893
2886,兆豐金,109,1,108,元大-大天母,2023-06-14,9893
2301,光寶科,105,0,105,元大-大天母,2023-06-14,9893
00688L,國泰20年美債正2,102,0,102,元大-大天母,2023-06-14,9893
2356,英業達,214,113,101,元大-大天母,2023-06-14,9893
00919,群益台灣精選高息,67,11,56,元大-大天母,2023-06-14,9893
00712,復華富時不動產,55,0,55,元大-大天母,2023-06-14,9893
3711,日月光投控,56,2,54,元大-大天母,2023-06-14,9893
1102,亞泥,50,0,50,元大-大天母,2023-06-14,9893
6235,華孚,57,7,50,元大-大天母,2023-06-14,9893
00665L,富邦�琤肭磪囓�2,50,0,50,元大-大天母,2023-06-14,9893
1609,大亞,134,88,46,元大-大天母,2023-06-14,9893
6290,良維,41,0,41,元大-大天母,2023-06-14,9893
4906,正文,44,10,34,元大-大天母,2023-06-14,9893
6285,啟��,35,3,32,元大-大天母,2023-06-14,9893
3128,昇銳,35,7,28,元大-大天母,2023-06-14,9893
1806,冠軍,75,50,25,元大-大天母,2023-06-14,9893
4564,元翎,32,8,24,元大-大天母,2023-06-14,9893
3454,晶睿,24,3,21,元大-大天母,2023-06-14,9893
2618,長榮航,302,282,20,元大-大天母,2023-06-14,9893
6577,勁豐,20,0,20,元大-大天母,2023-06-14,9893
3630,新鉅科,20,0,20,元大-大天母,2023-06-14,9893
6015,宏遠證,20,0,20,元大-大天母,2023-06-14,9893
6151,晉倫,20,0,20,元大-大天母,2023-06-14,9893
8069,元太,20,1,19,元大-大天母,2023-06-14,9893
6770,力積電,44,25,19,元大-大天母,2023-06-14,9893
5347,世界,21,2,19,元大-大天母,2023-06-14,9893
8050,廣積,59,40,19,元大-大天母,2023-06-14,9893
3714,富采,23,5,18,元大-大天母,2023-06-14,9893
00720B,元大投資級公司債,17,0,17,元大-大天母,2023-06-14,9893
2329,華泰,21,5,16,元大-大天母,2023-06-14,9893
1802,台玻,15,0,15,元大-大天母,2023-06-14,9893
9933,中鼎,15,0,15,元大-大天母,2023-06-14,9893
6182,合晶,22,7,15,元大-大天母,2023-06-14,9893
2851,中再保,15,0,15,元大-大天母,2023-06-14,9893
3030,德律,49,34,15,元大-大天母,2023-06-14,9893
6719,力智,14,0,14,元大-大天母,2023-06-14,9893
2457,飛宏,21,7,14,元大-大天母,2023-06-14,9893
2405,輔信,30,16,14,元大-大天母,2023-06-14,9893
2520,冠德,14,0,14,元大-大天母,2023-06-14,9893
00929,復華台灣科技優息,15,1,14,元大-大天母,2023-06-14,9893
00679B,元大美債20年,13,0,13,元大-大天母,2023-06-14,9893
6104,創惟,17,4,13,元大-大天母,2023-06-14,9893
00648R,元大S＆P500反1,13,0,13,元大-大天母,2023-06-14,9893
6167,久正,17,4,13,元大-大天母,2023-06-14,9893
6691,洋基工程,16,3,13,元大-大天母,2023-06-14,9893
00795B,中信美國公債20年,13,0,13,元大-大天母,2023-06-14,9893
6196,帆宣,17,5,12,元大-大天母,2023-06-14,9893
6282,康舒,686,134,552,元大-大天母,2023-06-15,9893
8049,晶采,141,19,122,元大-大天母,2023-06-15,9893
00919,群益台灣精選高息,121,46,75,元大-大天母,2023-06-15,9893
00715L,期街口布蘭特正2,50,0,50,元大-大天母,2023-06-15,9893
2888,新光金,46,2,44,元大-大天母,2023-06-15,9893
3055,蔚華科,54,13,41,元大-大天母,2023-06-15,9893
2892,第一金,44,8,36,元大-大天母,2023-06-15,9893
4157,太景*-KY,38,2,36,元大-大天母,2023-06-15,9893
1609,大亞,50,17,33,元大-大天母,2023-06-15,9893
00892,富邦台灣半導體,30,0,30,元大-大天母,2023-06-15,9893
3260,威剛,35,9,26,元大-大天母,2023-06-15,9893
00642U,期元大S＆P石油,26,0,26,元大-大天母,2023-06-15,9893
8050,廣積,24,0,24,元大-大天母,2023-06-15,9893
2344,華邦電,29,6,23,元大-大天母,2023-06-15,9893
5475,德宏,22,0,22,元大-大天母,2023-06-15,9893
00712,復華富時不動產,22,0,22,元大-大天母,2023-06-15,9893
2609,陽明,41,20,21,元大-大天母,2023-06-15,9893
2539,櫻花建,20,0,20,元大-大天母,2023-06-15,9893
00922,國泰台灣領袖50,20,0,20,元大-大天母,2023-06-15,9893
9904,寶成,20,0,20,元大-大天母,2023-06-15,9893
00900,富邦特選高股息30,30,12,18,元大-大天母,2023-06-15,9893
00885,富邦越南,24,6,18,元大-大天母,2023-06-15,9893
3707,漢磊,21,4,17,元大-大天母,2023-06-15,9893
2108,南帝,17,0,17,元大-大天母,2023-06-15,9893
5324,士開,16,0,16,元大-大天母,2023-06-15,9893
6245,立端,25,10,15,元大-大天母,2023-06-15,9893
1611,中電,28,13,15,元大-大天母,2023-06-15,9893
3033,威健,16,1,15,元大-大天母,2023-06-15,9893
2891,中信金,15,0,15,元大-大天母,2023-06-15,9893
2736,富野,15,1,14,元大-大天母,2023-06-15,9893
8076,伍豐,22,8,14,元大-大天母,2023-06-15,9893
1905,華紙,15,2,13,元大-大天母,2023-06-15,9893
8150,南茂,22,10,12,元大-大天母,2023-06-15,9893
2883,凱基金,12,0,12,元大-大天母,2023-06-15,9893
3032,偉訓,11,0,11,元大-大天母,2023-06-15,9893
2211,長榮鋼,11,0,11,元大-大天母,2023-06-15,9893
3011,今皓,11,0,11,元大-大天母,2023-06-15,9893
6485,點序,15,4,11,元大-大天母,2023-06-15,9893
2449,京元電子,18,7,11,元大-大天母,2023-06-15,9893
3374,精材,15,4,11,元大-大天母,2023-06-15,9893
2707,晶華,10,0,10,元大-大天母,2023-06-15,9893
3058,立德,10,0,10,元大-大天母,2023-06-15,9893
4168,醣聯,10,0,10,元大-大天母,2023-06-15,9893
3047,訊舟,10,0,10,元大-大天母,2023-06-15,9893
1524,耿鼎,15,6,9,元大-大天母,2023-06-15,9893
6546,正基,9,0,9,元大-大天母,2023-06-15,9893
2401,凌陽,42,33,9,元大-大天母,2023-06-15,9893
8358,金居,11,2,9,元大-大天母,2023-06-15,9893
4952,凌通,9,0,9,元大-大天母,2023-06-15,9893
9933,中鼎,9,0,9,元大-大天母,2023-06-15,9893
2312,金寶,273,11,262,元大-大天母,2023-06-16,9893
2371,大同,348,133,215,元大-大天母,2023-06-16,9893
00665L,富邦�琤肭磪囓�2,200,30,170,元大-大天母,2023-06-16,9893
2610,華航,334,209,125,元大-大天母,2023-06-16,9893
2888,新光金,140,22,118,元大-大天母,2023-06-16,9893
2401,凌陽,109,13,96,元大-大天母,2023-06-16,9893
00919,群益台灣精選高息,109,32,77,元大-大天母,2023-06-16,9893
1802,台玻,89,20,69,元大-大天母,2023-06-16,9893
00712,復華富時不動產,63,3,60,元大-大天母,2023-06-16,9893
2618,長榮航,188,135,53,元大-大天母,2023-06-16,9893
2331,精英,57,6,51,元大-大天母,2023-06-16,9893
3693,營邦,51,0,51,元大-大天母,2023-06-16,9893
2883,凱基金,49,0,49,元大-大天母,2023-06-16,9893
4960,誠美材,50,2,48,元大-大天母,2023-06-16,9893
6443,元晶,66,21,45,元大-大天母,2023-06-16,9893
00713,元大台灣高息低波,78,36,42,元大-大天母,2023-06-16,9893
1444,力麗,40,0,40,元大-大天母,2023-06-16,9893
1434,福懋,40,0,40,元大-大天母,2023-06-16,9893
00648R,元大S＆P500反1,38,0,38,元大-大天母,2023-06-16,9893
5529,鉅陞,34,0,34,元大-大天母,2023-06-16,9893
0056,元大高股息,72,41,31,元大-大天母,2023-06-16,9893
00720B,元大投資級公司債,29,1,28,元大-大天母,2023-06-16,9893
2404,漢唐,28,1,27,元大-大天母,2023-06-16,9893
2645,長榮航太,31,5,26,元大-大天母,2023-06-16,9893
2890,永豐金,27,1,26,元大-大天母,2023-06-16,9893
3356,奇偶,35,10,25,元大-大天母,2023-06-16,9893
1907,永豐餘,26,1,25,元大-大天母,2023-06-16,9893
6770,力積電,30,6,24,元大-大天母,2023-06-16,9893
3032,偉訓,27,3,24,元大-大天母,2023-06-16,9893
5347,世界,24,0,24,元大-大天母,2023-06-16,9893
1533,車王電,25,2,23,元大-大天母,2023-06-16,9893
3264,欣銓,31,9,22,元大-大天母,2023-06-16,9893
3479,安勤,26,4,22,元大-大天母,2023-06-16,9893
4743,合一,29,8,21,元大-大天母,2023-06-16,9893
00669R,國泰美國道瓊反1,20,0,20,元大-大天母,2023-06-16,9893
00700,富邦�琤肭磪�,20,0,20,元大-大天母,2023-06-16,9893
2359,所羅門,59,39,20,元大-大天母,2023-06-16,9893
3714,富采,21,1,20,元大-大天母,2023-06-16,9893
3207,耀勝,20,1,19,元大-大天母,2023-06-16,9893
3346,麗清,18,0,18,元大-大天母,2023-06-16,9893
3131,弘塑,20,2,18,元大-大天母,2023-06-16,9893
9933,中鼎,17,0,17,元大-大天母,2023-06-16,9893
8027,鈦昇,24,7,17,元大-大天母,2023-06-16,9893
2356,英業達,60,44,16,元大-大天母,2023-06-16,9893
00645,富邦日本,16,0,16,元大-大天母,2023-06-16,9893
00722B,群益投資級電信債,16,0,16,元大-大天母,2023-06-16,9893
2603,長榮,36,20,16,元大-大天母,2023-06-16,9893
1609,大亞,46,31,15,元大-大天母,2023-06-16,9893
1905,華紙,15,0,15,元大-大天母,2023-06-16,9893
6606,建德工業,15,0,15,元大-大天母,2023-06-16,9893
00885,富邦越南,200,2,198,元大-大天母,2023-06-19,9893
2603,長榮,173,3,170,元大-大天母,2023-06-19,9893
2409,友達,231,93,138,元大-大天母,2023-06-19,9893
3090,日電貿,100,1,99,元大-大天母,2023-06-19,9893
00720B,元大投資級公司債,103,8,95,元大-大天母,2023-06-19,9893
2371,大同,72,22,50,元大-大天母,2023-06-19,9893
2104,國際中橡,68,30,38,元大-大天母,2023-06-19,9893
2323,中環,42,6,36,元大-大天母,2023-06-19,9893
2312,金寶,52,17,35,元大-大天母,2023-06-19,9893
3231,緯創,64,32,32,元大-大天母,2023-06-19,9893
00687B,國泰20年美債,30,0,30,元大-大天母,2023-06-19,9893
2421,建準,47,17,30,元大-大天母,2023-06-19,9893
2609,陽明,28,1,27,元大-大天母,2023-06-19,9893
2362,藍天,25,0,25,元大-大天母,2023-06-19,9893
3706,神達,34,9,25,元大-大天母,2023-06-19,9893
9904,寶成,22,0,22,元大-大天母,2023-06-19,9893
3645,達邁,22,0,22,元大-大天母,2023-06-19,9893
00712,復華富時不動產,22,0,22,元大-大天母,2023-06-19,9893
2344,華邦電,22,1,21,元大-大天母,2023-06-19,9893
00655L,國泰中國A50正2,20,0,20,元大-大天母,2023-06-19,9893
2353,宏��,57,37,20,元大-大天母,2023-06-19,9893
1513,中興電,89,69,20,元大-大天母,2023-06-19,9893
6443,元晶,29,10,19,元大-大天母,2023-06-19,9893
00640L,富邦日本正2,19,0,19,元大-大天母,2023-06-19,9893
1605,華新,36,17,19,元大-大天母,2023-06-19,9893
2618,長榮航,45,26,19,元大-大天母,2023-06-19,9893
8926,台汽電,18,0,18,元大-大天母,2023-06-19,9893
4720,德淵,18,0,18,元大-大天母,2023-06-19,9893
3260,威剛,24,7,17,元大-大天母,2023-06-19,9893
2908,特力,17,0,17,元大-大天母,2023-06-19,9893
1503,士電,17,2,15,元大-大天母,2023-06-19,9893
2303,聯電,25,11,14,元大-大天母,2023-06-19,9893
2014,中鴻,14,1,13,元大-大天母,2023-06-19,9893
2481,強茂,14,1,13,元大-大天母,2023-06-19,9893
2504,國產,12,0,12,元大-大天母,2023-06-19,9893
2368,金像電,14,2,12,元大-大天母,2023-06-19,9893
3380,明泰,13,1,12,元大-大天母,2023-06-19,9893
6180,橘子,12,0,12,元大-大天母,2023-06-19,9893
2887,台新金,22,11,11,元大-大天母,2023-06-19,9893
00713,元大台灣高息低波,13,1,12,元大-大天母,2023-06-19,9893
1342,八貫,11,0,11,元大-大天母,2023-06-19,9893
2630,亞航,15,4,11,元大-大天母,2023-06-19,9893
6139,亞翔,10,0,10,元大-大天母,2023-06-19,9893
00921,兆豐龍頭等權重,10,0,10,元大-大天母,2023-06-19,9893
00753L,中信中國50正2,10,0,10,元大-大天母,2023-06-19,9893
2607,榮運,10,0,10,元大-大天母,2023-06-19,9893
1909,榮成,10,0,10,元大-大天母,2023-06-19,9893
00900,富邦特選高股息30,10,0,10,元大-大天母,2023-06-19,9893
3702,大聯大,10,0,10,元大-大天母,2023-06-19,9893
8011,台通,10,0,10,元大-大天母,2023-06-19,9893
2603,長榮,211,18,193,元大-大天母,2023-06-20,9893
3481,群創,178,9,169,元大-大天母,2023-06-20,9893
5347,世界,158,0,158,元大-大天母,2023-06-20,9893
2105,正新,155,2,153,元大-大天母,2023-06-20,9893
2323,中環,174,25,149,元大-大天母,2023-06-20,9893
2454,聯發科,100,0,100,元大-大天母,2023-06-20,9893
2880,華南金,100,0,100,元大-大天母,2023-06-20,9893
1609,大亞,57,5,52,元大-大天母,2023-06-20,9893
2886,兆豐金,51,0,51,元大-大天母,2023-06-20,9893
2888,新光金,40,1,39,元大-大天母,2023-06-20,9893
5512,力麒,52,16,36,元大-大天母,2023-06-20,9893
4744,皇將,33,0,33,元大-大天母,2023-06-20,9893
8085,福華,30,0,30,元大-大天母,2023-06-20,9893
2534,宏盛,29,0,29,元大-大天母,2023-06-20,9893
2610,華航,67,43,24,元大-大天母,2023-06-20,9893
2337,旺宏,30,7,23,元大-大天母,2023-06-20,9893
00882,中信中國高股息,21,0,21,元大-大天母,2023-06-20,9893
2618,長榮航,54,33,21,元大-大天母,2023-06-20,9893
6657,華安,21,0,21,元大-大天母,2023-06-20,9893
2204,中華,20,0,20,元大-大天母,2023-06-20,9893
00665L,富邦�琤肭磪囓�2,20,0,20,元大-大天母,2023-06-20,9893
1802,台玻,23,4,19,元大-大天母,2023-06-20,9893
00885,富邦越南,20,1,19,元大-大天母,2023-06-20,9893
2489,瑞軒,25,8,17,元大-大天母,2023-06-20,9893
1795,美時,15,0,15,元大-大天母,2023-06-20,9893
2457,飛宏,24,9,15,元大-大天母,2023-06-20,9893
2303,聯電,77,62,15,元大-大天母,2023-06-20,9893
00720B,元大投資級公司債,19,5,14,元大-大天母,2023-06-20,9893
00713,元大台灣高息低波,18,5,13,元大-大天母,2023-06-20,9893
2356,英業達,68,55,13,元大-大天母,2023-06-20,9893
2504,國產,13,0,13,元大-大天母,2023-06-20,9893
4541,晟田,26,13,13,元大-大天母,2023-06-20,9893
2801,彰銀,13,0,13,元大-大天母,2023-06-20,9893
1605,華新,46,33,13,元大-大天母,2023-06-20,9893
2545,皇翔,13,0,13,元大-大天母,2023-06-20,9893
1714,和桐,12,0,12,元大-大天母,2023-06-20,9893
00722B,群益投資級電信債,12,0,12,元大-大天母,2023-06-20,9893
1103,嘉泥,16,5,11,元大-大天母,2023-06-20,9893
4726,永昕,11,0,11,元大-大天母,2023-06-20,9893
1529,樂事綠能,13,2,11,元大-大天母,2023-06-20,9893
1319,東陽,12,1,11,元大-大天母,2023-06-20,9893
2630,亞航,13,2,11,元大-大天母,2023-06-20,9893
006208,富邦台50,11,1,10,元大-大天母,2023-06-20,9893
2486,一詮,10,0,10,元大-大天母,2023-06-20,9893
00712,復華富時不動產,11,1,10,元大-大天母,2023-06-20,9893
6194,育富,10,0,10,元大-大天母,2023-06-20,9893
3625,西勝,10,0,10,元大-大天母,2023-06-20,9893
3036,文曄,10,0,10,元大-大天母,2023-06-20,9893
6188,廣明,15,5,10,元大-大天母,2023-06-20,9893
5701,劍湖山,10,0,10,元大-大天母,2023-06-20,9893
2371,大同,200,55,145,元大-大天母,2023-06-21,9893
2323,中環,146,7,139,元大-大天母,2023-06-21,9893
2607,榮運,102,7,95,元大-大天母,2023-06-21,9893
3380,明泰,76,12,64,元大-大天母,2023-06-21,9893
6116,彩晶,75,11,64,元大-大天母,2023-06-21,9893
1444,力麗,60,0,60,元大-大天母,2023-06-21,9893
2312,金寶,108,55,53,元大-大天母,2023-06-21,9893
3011,今皓,50,0,50,元大-大天母,2023-06-21,9893
5876,上海商銀,50,0,50,元大-大天母,2023-06-21,9893
2545,皇翔,49,0,49,元大-大天母,2023-06-21,9893
6290,良維,53,6,47,元大-大天母,2023-06-21,9893
00712,復華富時不動產,46,0,46,元大-大天母,2023-06-21,9893
5347,世界,40,0,40,元大-大天母,2023-06-21,9893
1314,中石化,40,0,40,元大-大天母,2023-06-21,9893
2705,六福,145,108,37,元大-大天母,2023-06-21,9893
1721,三晃,32,4,28,元大-大天母,2023-06-21,9893
2618,長榮航,36,8,28,元大-大天母,2023-06-21,9893
1605,華新,31,4,27,元大-大天母,2023-06-21,9893
2603,長榮,34,7,27,元大-大天母,2023-06-21,9893
1210,大成,25,0,25,元大-大天母,2023-06-21,9893
2610,華航,77,53,24,元大-大天母,2023-06-21,9893
2454,聯發科,32,9,23,元大-大天母,2023-06-21,9893
00720B,元大投資級公司債,31,8,23,元大-大天母,2023-06-21,9893
5425,台半,41,18,23,元大-大天母,2023-06-21,9893
2707,晶華,23,0,23,元大-大天母,2023-06-21,9893
00891,中信關鍵半導體,20,0,20,元大-大天母,2023-06-21,9893
2890,永豐金,20,0,20,元大-大天母,2023-06-21,9893
3680,家登,20,0,20,元大-大天母,2023-06-21,9893
2712,遠雄來,19,0,19,元大-大天母,2023-06-21,9893
3047,訊舟,17,0,17,元大-大天母,2023-06-21,9893
4916,事欣科,42,26,16,元大-大天母,2023-06-21,9893
6217,中探針,17,1,16,元大-大天母,2023-06-21,9893
00637L,元大滬深300正2,15,0,15,元大-大天母,2023-06-21,9893
00764B,群益25年美債,15,0,15,元大-大天母,2023-06-21,9893
00665L,富邦�琤肭磪囓�2,15,0,15,元大-大天母,2023-06-21,9893
6139,亞翔,15,0,15,元大-大天母,2023-06-21,9893
006208,富邦台50,14,0,14,元大-大天母,2023-06-21,9893
3006,晶豪科,14,0,14,元大-大天母,2023-06-21,9893
2702,華園,18,5,13,元大-大天母,2023-06-21,9893
5324,士開,13,0,13,元大-大天母,2023-06-21,9893
3325,旭品,31,19,12,元大-大天母,2023-06-21,9893
6120,達運,19,7,12,元大-大天母,2023-06-21,9893
1303,南亞,11,0,11,元大-大天母,2023-06-21,9893
2520,冠德,11,0,11,元大-大天母,2023-06-21,9893
00753L,中信中國50正2,15,4,11,元大-大天母,2023-06-21,9893
3078,僑威,19,9,10,元大-大天母,2023-06-21,9893
4766,南寶,10,0,10,元大-大天母,2023-06-21,9893
2882,國泰金,10,0,10,元大-大天母,2023-06-21,9893
3016,嘉晶,10,0,10,元大-大天母,2023-06-21,9893
00706L,期元大S＆P日圓正2,10,0,10,元大-大天母,2023-06-21,9893
2312,金寶,218,5,213,元大-大天母,2023-06-26,9893
2371,大同,186,41,145,元大-大天母,2023-06-26,9893
2888,新光金,139,34,105,元大-大天母,2023-06-26,9893
2344,華邦電,126,27,99,元大-大天母,2023-06-26,9893
2885,元大金,95,3,92,元大-大天母,2023-06-26,9893
2409,友達,73,5,68,元大-大天母,2023-06-26,9893
4938,和碩,69,3,66,元大-大天母,2023-06-26,9893
1605,華新,73,8,65,元大-大天母,2023-06-26,9893
3481,群創,89,29,60,元大-大天母,2023-06-26,9893
5347,世界,51,0,51,元大-大天母,2023-06-26,9893
3665,貿聯-KY,51,0,51,元大-大天母,2023-06-26,9893
2548,華固,50,0,50,元大-大天母,2023-06-26,9893
00687B,國泰20年美債,50,0,50,元大-大天母,2023-06-26,9893
2883,凱基金,55,5,50,元大-大天母,2023-06-26,9893
2303,聯電,81,31,50,元大-大天母,2023-06-26,9893
2748,雲品,34,0,34,元大-大天母,2023-06-26,9893
00633L,富邦上証正2,72,40,32,元大-大天母,2023-06-26,9893
6116,彩晶,35,3,32,元大-大天母,2023-06-26,9893
00642U,期元大S＆P石油,30,0,30,元大-大天母,2023-06-26,9893
3032,偉訓,35,7,28,元大-大天母,2023-06-26,9893
00882,中信中國高股息,25,0,25,元大-大天母,2023-06-26,9893
2405,輔信,24,0,24,元大-大天母,2023-06-26,9893
1313,聯成,25,2,23,元大-大天母,2023-06-26,9893
1531,高林股,23,0,23,元大-大天母,2023-06-26,9893
3131,弘塑,23,1,22,元大-大天母,2023-06-26,9893
2867,三商壽,22,0,22,元大-大天母,2023-06-26,9893
5519,隆大,21,0,21,元大-大天母,2023-06-26,9893
2501,國建,21,0,21,元大-大天母,2023-06-26,9893
2852,第一保,21,0,21,元大-大天母,2023-06-26,9893
00713,元大台灣高息低波,20,0,20,元大-大天母,2023-06-26,9893
1906,寶隆,20,0,20,元大-大天母,2023-06-26,9893
006206,元大上證50,20,0,20,元大-大天母,2023-06-26,9893
6541,泰福-KY,20,0,20,元大-大天母,2023-06-26,9893
2890,永豐金,30,10,20,元大-大天母,2023-06-26,9893
00753L,中信中國50正2,30,11,19,元大-大天母,2023-06-26,9893
2736,富野,29,10,19,元大-大天母,2023-06-26,9893
2913,農林,37,19,18,元大-大天母,2023-06-26,9893
3264,欣銓,31,14,17,元大-大天母,2023-06-26,9893
4746,台耀,36,19,17,元大-大天母,2023-06-26,9893
3380,明泰,17,0,17,元大-大天母,2023-06-26,9893
3703,欣陸,17,0,17,元大-大天母,2023-06-26,9893
1325,恆大,16,0,16,元大-大天母,2023-06-26,9893
3705,永信,15,0,15,元大-大天母,2023-06-26,9893
00764B,群益25年美債,15,0,15,元大-大天母,2023-06-26,9893
5475,德宏,15,0,15,元大-大天母,2023-06-26,9893
2104,國際中橡,15,0,15,元大-大天母,2023-06-26,9893
3543,州巧,14,0,14,元大-大天母,2023-06-26,9893
3362,先進光,15,2,13,元大-大天母,2023-06-26,9893
3033,威健,15,2,13,元大-大天母,2023-06-26,9893
1227,佳格,13,0,13,元大-大天母,2023-06-26,9893
2603,長榮,220,42,178,元大-大天母,2023-06-27,9893
2610,華航,184,20,164,元大-大天母,2023-06-27,9893
2888,新光金,136,0,136,元大-大天母,2023-06-27,9893
2204,中華,120,0,120,元大-大天母,2023-06-27,9893
00922,國泰台灣領袖50,92,0,92,元大-大天母,2023-06-27,9893
2340,台亞,101,25,76,元大-大天母,2023-06-27,9893
2344,華邦電,57,0,57,元大-大天母,2023-06-27,9893
2618,長榮航,118,68,50,元大-大天母,2023-06-27,9893
2303,聯電,92,43,49,元大-大天母,2023-06-27,9893
1907,永豐餘,46,0,46,元大-大天母,2023-06-27,9893
1605,華新,60,18,42,元大-大天母,2023-06-27,9893
2913,農林,42,2,40,元大-大天母,2023-06-27,9893
6472,保瑞,46,6,40,元大-大天母,2023-06-27,9893
0056,元大高股息,55,20,35,元大-大天母,2023-06-27,9893
4113,聯上,27,0,27,元大-大天母,2023-06-27,9893
4561,健椿,25,0,25,元大-大天母,2023-06-27,9893
1905,華紙,33,8,25,元大-大天母,2023-06-27,9893
1529,樂事綠能,27,2,25,元大-大天母,2023-06-27,9893
3711,日月光投控,26,1,25,元大-大天母,2023-06-27,9893
00919,群益台灣精選高息,26,2,24,元大-大天母,2023-06-27,9893
00878,國泰永續高股息,55,31,24,元大-大天母,2023-06-27,9893
00683L,期元大美元指正2,23,0,23,元大-大天母,2023-06-27,9893
2883,凱基金,22,0,22,元大-大天母,2023-06-27,9893
1101,台泥,26,4,22,元大-大天母,2023-06-27,9893
1326,台化,22,0,22,元大-大天母,2023-06-27,9893
5864,致和證,21,0,21,元大-大天母,2023-06-27,9893
2356,英業達,28,7,21,元大-大天母,2023-06-27,9893
1609,大亞,166,146,20,元大-大天母,2023-06-27,9893
3078,僑威,27,8,19,元大-大天母,2023-06-27,9893
2363,矽統,19,0,19,元大-大天母,2023-06-27,9893
6443,元晶,20,1,19,元大-大天母,2023-06-27,9893
3207,耀勝,19,1,18,元大-大天母,2023-06-27,9893
5519,隆大,18,0,18,元大-大天母,2023-06-27,9893
1471,首利,17,0,17,元大-大天母,2023-06-27,9893
2382,廣達,23,6,17,元大-大天母,2023-06-27,9893
2409,友達,18,2,16,元大-大天母,2023-06-27,9893
3605,宏致,16,0,16,元大-大天母,2023-06-27,9893
3032,偉訓,65,49,16,元大-大天母,2023-06-27,9893
8358,金居,16,1,15,元大-大天母,2023-06-27,9893
2388,威盛,15,2,13,元大-大天母,2023-06-27,9893
1785,光洋科,19,6,13,元大-大天母,2023-06-27,9893
2313,華通,20,7,13,元大-大天母,2023-06-27,9893
1301,台塑,12,0,12,元大-大天母,2023-06-27,9893
0050,元大台灣50,12,0,12,元大-大天母,2023-06-27,9893
1513,中興電,38,26,12,元大-大天母,2023-06-27,9893
1597,直得,12,0,12,元大-大天母,2023-06-27,9893
2331,精英,21,9,12,元大-大天母,2023-06-27,9893
6414,樺漢,12,0,12,元大-大天母,2023-06-27,9893
6217,中探針,12,1,11,元大-大天母,2023-06-27,9893
2736,富野,12,1,11,元大-大天母,2023-06-27,9893
2885,元大金,117,17,100,元大-大天母,2023-06-28,9893
1605,華新,119,26,93,元大-大天母,2023-06-28,9893
00706L,期元大S＆P日圓正2,60,0,60,元大-大天母,2023-06-28,9893
2548,華固,50,0,50,元大-大天母,2023-06-28,9893
4113,聯上,44,0,44,元大-大天母,2023-06-28,9893
00642U,期元大S＆P石油,43,0,43,元大-大天母,2023-06-28,9893
00715L,期街口布蘭特正2,41,0,41,元大-大天母,2023-06-28,9893
1444,力麗,43,4,39,元大-大天母,2023-06-28,9893
2630,亞航,74,38,36,元大-大天母,2023-06-28,9893
5347,世界,33,0,33,元大-大天母,2023-06-28,9893
2340,台亞,34,2,32,元大-大天母,2023-06-28,9893
2913,農林,53,22,31,元大-大天母,2023-06-28,9893
6111,大宇資,33,8,25,元大-大天母,2023-06-28,9893
6148,驊宏資,31,7,24,元大-大天母,2023-06-28,9893
3231,緯創,81,58,23,元大-大天母,2023-06-28,9893
2104,國際中橡,23,0,23,元大-大天母,2023-06-28,9893
3019,亞光,20,0,20,元大-大天母,2023-06-28,9893
00753L,中信中國50正2,20,0,20,元大-大天母,2023-06-28,9893
3038,全台,27,8,19,元大-大天母,2023-06-28,9893
2371,大同,100,81,19,元大-大天母,2023-06-28,9893
00674R,期元大S＆P黃金反1,18,0,18,元大-大天母,2023-06-28,9893
4746,台耀,42,25,17,元大-大天母,2023-06-28,9893
3013,晟銘電,20,3,17,元大-大天母,2023-06-28,9893
00919,群益台灣精選高息,27,10,17,元大-大天母,2023-06-28,9893
0056,元大高股息,22,6,16,元大-大天母,2023-06-28,9893
1303,南亞,20,4,16,元大-大天母,2023-06-28,9893
9945,潤泰新,15,0,15,元大-大天母,2023-06-28,9893
3260,威剛,27,14,13,元大-大天母,2023-06-28,9893
2002,中鋼,15,3,12,元大-大天母,2023-06-28,9893
5425,台半,13,1,12,元大-大天母,2023-06-28,9893
3711,日月光投控,12,0,12,元大-大天母,2023-06-28,9893
1752,南光,12,0,12,元大-大天母,2023-06-28,9893
1314,中石化,12,0,12,元大-大天母,2023-06-28,9893
5340,建榮,12,0,12,元大-大天母,2023-06-28,9893
0050,元大台灣50,11,0,11,元大-大天母,2023-06-28,9893
6196,帆宣,11,0,11,元大-大天母,2023-06-28,9893
1609,大亞,12,1,11,元大-大天母,2023-06-28,9893
1525,江申,18,7,11,元大-大天母,2023-06-28,9893
6179,亞通,32,21,11,元大-大天母,2023-06-28,9893
2892,第一金,15,5,10,元大-大天母,2023-06-28,9893
3481,群創,34,24,10,元大-大天母,2023-06-28,9893
1795,美時,19,9,10,元大-大天母,2023-06-28,9893
2206,三陽工業,12,3,9,元大-大天母,2023-06-28,9893
3036,文曄,10,1,9,元大-大天母,2023-06-28,9893
2883,凱基金,59,50,9,元大-大天母,2023-06-28,9893
00878,國泰永續高股息,18,9,9,元大-大天母,2023-06-28,9893
1519,華城,16,8,8,元大-大天母,2023-06-28,9893
1301,台塑,8,0,8,元大-大天母,2023-06-28,9893
6443,元晶,51,43,8,元大-大天母,2023-06-28,9893
00720B,元大投資級公司債,8,0,8,元大-大天母,2023-06-28,9893
3059,華晶科,115,0,115,元大-大天母,2023-06-29,9893
00885,富邦越南,105,5,100,元大-大天母,2023-06-29,9893
4927,泰鼎-KY,100,2,98,元大-大天母,2023-06-29,9893
3035,智原,94,5,89,元大-大天母,2023-06-29,9893
2371,大同,94,25,69,元大-大天母,2023-06-29,9893
2317,鴻海,69,2,67,元大-大天母,2023-06-29,9893
2303,聯電,82,15,67,元大-大天母,2023-06-29,9893
00706L,期元大S＆P日圓正2,51,0,51,元大-大天母,2023-06-29,9893
2618,長榮航,54,4,50,元大-大天母,2023-06-29,9893
00665L,富邦�琤肭磪囓�2,50,0,50,元大-大天母,2023-06-29,9893
1605,華新,45,2,43,元大-大天母,2023-06-29,9893
1609,大亞,41,0,41,元大-大天母,2023-06-29,9893
2888,新光金,39,5,34,元大-大天母,2023-06-29,9893
4414,如興,30,0,30,元大-大天母,2023-06-29,9893
3025,星通,41,11,30,元大-大天母,2023-06-29,9893
3047,訊舟,29,0,29,元大-大天母,2023-06-29,9893
5347,世界,30,2,28,元大-大天母,2023-06-29,9893
2347,聯強,26,0,26,元大-大天母,2023-06-29,9893
3207,耀勝,41,16,25,元大-大天母,2023-06-29,9893
2206,三陽工業,25,2,23,元大-大天母,2023-06-29,9893
2885,元大金,24,1,23,元大-大天母,2023-06-29,9893
4123,晟德,87,64,23,元大-大天母,2023-06-29,9893
2884,玉山金,21,0,21,元大-大天母,2023-06-29,9893
6142,友勁,21,0,21,元大-大天母,2023-06-29,9893
4746,台耀,35,15,20,元大-大天母,2023-06-29,9893
00642U,期元大S＆P石油,20,0,20,元大-大天母,2023-06-29,9893
6446,藥華藥,20,0,20,元大-大天母,2023-06-29,9893
2474,可成,20,0,20,元大-大天母,2023-06-29,9893
2707,晶華,21,1,20,元大-大天母,2023-06-29,9893
00919,群益台灣精選高息,21,3,18,元大-大天母,2023-06-29,9893
3558,神準,19,2,17,元大-大天母,2023-06-29,9893
00878,國泰永續高股息,57,41,16,元大-大天母,2023-06-29,9893
8011,台通,16,0,16,元大-大天母,2023-06-29,9893
2419,仲琦,51,35,16,元大-大天母,2023-06-29,9893
3260,威剛,40,25,15,元大-大天母,2023-06-29,9893
1304,台聚,16,1,15,元大-大天母,2023-06-29,9893
00922,國泰台灣領袖50,14,0,14,元大-大天母,2023-06-29,9893
2412,中華電,14,1,13,元大-大天母,2023-06-29,9893
2913,農林,12,0,12,元大-大天母,2023-06-29,9893
1513,中興電,20,8,12,元大-大天母,2023-06-29,9893
3711,日月光投控,13,1,12,元大-大天母,2023-06-29,9893
1417,嘉裕,11,0,11,元大-大天母,2023-06-29,9893
4968,立積,18,7,11,元大-大天母,2023-06-29,9893
3209,全科,11,0,11,元大-大天母,2023-06-29,9893
6111,大宇資,12,1,11,元大-大天母,2023-06-29,9893
2892,第一金,19,9,10,元大-大天母,2023-06-29,9893
2002,中鋼,15,5,10,元大-大天母,2023-06-29,9893
3264,欣銓,10,0,10,元大-大天母,2023-06-29,9893
3702,大聯大,10,0,10,元大-大天母,2023-06-29,9893
3346,麗清,10,0,10,元大-大天母,2023-06-29,9893
2323,中環,639,8,631,元大-大天母,2023-06-30,9893
8210,勤誠,161,13,148,元大-大天母,2023-06-30,9893
2603,長榮,219,108,111,元大-大天母,2023-06-30,9893
00688L,國泰20年美債正2,104,0,104,元大-大天母,2023-06-30,9893
1605,華新,93,28,65,元大-大天母,2023-06-30,9893
3703,欣陸,58,0,58,元大-大天母,2023-06-30,9893
2610,華航,73,17,56,元大-大天母,2023-06-30,9893
2883,凱基金,58,3,55,元大-大天母,2023-06-30,9893
9105,泰金寶-DR,66,13,53,元大-大天母,2023-06-30,9893
6576,逸達,52,2,50,元大-大天母,2023-06-30,9893
00878,國泰永續高股息,64,19,45,元大-大天母,2023-06-30,9893
00885,富邦越南,40,0,40,元大-大天母,2023-06-30,9893
4164,承業醫,42,2,40,元大-大天母,2023-06-30,9893
6806,森崴能源,41,2,39,元大-大天母,2023-06-30,9893
2419,仲琦,58,24,34,元大-大天母,2023-06-30,9893
2618,長榮航,39,8,31,元大-大天母,2023-06-30,9893
9946,三發地產,31,0,31,元大-大天母,2023-06-30,9893
4543,萬在,31,1,30,元大-大天母,2023-06-30,9893
2753,八方雲集,32,4,28,元大-大天母,2023-06-30,9893
4130,健亞,28,0,28,元大-大天母,2023-06-30,9893
3047,訊舟,26,0,26,元大-大天母,2023-06-30,9893
3025,星通,27,2,25,元大-大天母,2023-06-30,9893
00632R,元大台灣50反1,30,5,25,元大-大天母,2023-06-30,9893
2474,可成,22,0,22,元大-大天母,2023-06-30,9893
2340,台亞,21,0,21,元大-大天母,2023-06-30,9893
00680L,元大美債20正2,21,0,21,元大-大天母,2023-06-30,9893
3034,聯詠,21,1,20,元大-大天母,2023-06-30,9893
2538,基泰,20,0,20,元大-大天母,2023-06-30,9893
3260,威剛,28,8,20,元大-大天母,2023-06-30,9893
00730,富邦臺灣優質高息,20,0,20,元大-大天母,2023-06-30,9893
2515,中工,25,5,20,元大-大天母,2023-06-30,9893
2312,金寶,20,0,20,元大-大天母,2023-06-30,9893
8085,福華,20,0,20,元大-大天母,2023-06-30,9893
4157,太景*-KY,27,8,19,元大-大天母,2023-06-30,9893
2884,玉山金,21,3,18,元大-大天母,2023-06-30,9893
1220,台榮,18,0,18,元大-大天母,2023-06-30,9893
6405,悅城,18,0,18,元大-大天母,2023-06-30,9893
2885,元大金,18,0,18,元大-大天母,2023-06-30,9893
2820,華票,17,0,17,元大-大天母,2023-06-30,9893
00645,富邦日本,18,1,17,元大-大天母,2023-06-30,9893
2409,友達,15,0,15,元大-大天母,2023-06-30,9893
1789,神隆,25,10,15,元大-大天母,2023-06-30,9893
2301,光寶科,17,3,14,元大-大天母,2023-06-30,9893
5439,高技,20,6,14,元大-大天母,2023-06-30,9893
2344,華邦電,49,35,14,元大-大天母,2023-06-30,9893
3035,智原,17,4,13,元大-大天母,2023-06-30,9893
6285,啟��,14,1,13,元大-大天母,2023-06-30,9893
5392,能率,13,0,13,元大-大天母,2023-06-30,9893
3711,日月光投控,22,9,13,元大-大天母,2023-06-30,9893
00687B,國泰20年美債,13,1,12,元大-大天母,2023-06-30,9893
4938,和碩,175,8,167,元大-大天母,2023-07-03,9893
2371,大同,195,81,114,元大-大天母,2023-07-03,9893
2515,中工,106,7,99,元大-大天母,2023-07-03,9893
6153,嘉聯益,98,11,87,元大-大天母,2023-07-03,9893
2603,長榮,96,27,69,元大-大天母,2023-07-03,9893
3207,耀勝,71,6,65,元大-大天母,2023-07-03,9893
3711,日月光投控,63,1,62,元大-大天母,2023-07-03,9893
2303,聯電,143,88,55,元大-大天母,2023-07-03,9893
3025,星通,58,11,47,元大-大天母,2023-07-03,9893
4532,瑞智,51,4,47,元大-大天母,2023-07-03,9893
00632R,元大台灣50反1,45,0,45,元大-大天母,2023-07-03,9893
3447,展達,46,3,43,元大-大天母,2023-07-03,9893
2883,凱基金,73,36,37,元大-大天母,2023-07-03,9893
8085,福華,35,0,35,元大-大天母,2023-07-03,9893
1905,華紙,75,41,34,元大-大天母,2023-07-03,9893
4746,台耀,37,4,33,元大-大天母,2023-07-03,9893
3045,台灣大,33,0,33,元大-大天母,2023-07-03,9893
2101,南港,32,0,32,元大-大天母,2023-07-03,9893
8049,晶采,31,1,30,元大-大天母,2023-07-03,9893
5475,德宏,30,0,30,元大-大天母,2023-07-03,9893
3675,德微,28,0,28,元大-大天母,2023-07-03,9893
6120,達運,27,0,27,元大-大天母,2023-07-03,9893
4130,健亞,23,0,23,元大-大天母,2023-07-03,9893
2347,聯強,21,0,21,元大-大天母,2023-07-03,9893
3033,威健,21,0,21,元大-大天母,2023-07-03,9893
4113,聯上,20,0,20,元大-大天母,2023-07-03,9893
6163,華電網,20,0,20,元大-大天母,2023-07-03,9893
2010,春源,20,0,20,元大-大天母,2023-07-03,9893
6806,森崴能源,21,2,19,元大-大天母,2023-07-03,9893
2356,英業達,89,71,18,元大-大天母,2023-07-03,9893
3481,群創,32,14,18,元大-大天母,2023-07-03,9893
8354,冠好,17,0,17,元大-大天母,2023-07-03,9893
00772B,中信高評級公司債,17,1,16,元大-大天母,2023-07-03,9893
3011,今皓,20,5,15,元大-大天母,2023-07-03,9893
6188,廣明,32,17,15,元大-大天母,2023-07-03,9893
2882,國泰金,14,0,14,元大-大天母,2023-07-03,9893
3346,麗清,15,1,14,元大-大天母,2023-07-03,9893
1909,榮成,13,0,13,元大-大天母,2023-07-03,9893
9907,統一實,14,1,13,元大-大天母,2023-07-03,9893
020038,元大ESG配息N,13,0,13,元大-大天母,2023-07-03,9893
5607,遠雄港,12,0,12,元大-大天母,2023-07-03,9893
4726,永昕,12,0,12,元大-大天母,2023-07-03,9893
4164,承業醫,13,1,12,元大-大天母,2023-07-03,9893
2885,元大金,12,1,11,元大-大天母,2023-07-03,9893
00712,復華富時不動產,11,0,11,元大-大天母,2023-07-03,9893
6747,亨泰光,11,0,11,元大-大天母,2023-07-03,9893
3034,聯詠,13,2,11,元大-大天母,2023-07-03,9893
0056,元大高股息,44,34,10,元大-大天母,2023-07-03,9893
2444,兆勁,10,0,10,元大-大天母,2023-07-03,9893
8034,榮群,10,0,10,元大-大天母,2023-07-03,9893
2312,金寶,1275,82,1193,元大-大天母,2023-07-04,9893
3706,神達,489,122,367,元大-大天母,2023-07-04,9893
2883,凱基金,258,8,250,元大-大天母,2023-07-04,9893
6153,嘉聯益,146,2,144,元大-大天母,2023-07-04,9893
2368,金像電,113,18,95,元大-大天母,2023-07-04,9893
2882,國泰金,106,12,94,元大-大天母,2023-07-04,9893
2603,長榮,188,101,87,元大-大天母,2023-07-04,9893
2609,陽明,250,167,83,元大-大天母,2023-07-04,9893
3231,緯創,203,136,67,元大-大天母,2023-07-04,9893
6282,康舒,231,169,62,元大-大天母,2023-07-04,9893
2615,萬海,104,42,62,元大-大天母,2023-07-04,9893
2329,華泰,84,24,60,元大-大天母,2023-07-04,9893
3178,公準,60,0,60,元大-大天母,2023-07-04,9893
2449,京元電子,64,6,58,元大-大天母,2023-07-04,9893
8049,晶采,81,24,57,元大-大天母,2023-07-04,9893
2301,光寶科,54,12,42,元大-大天母,2023-07-04,9893
1504,東元,44,4,40,元大-大天母,2023-07-04,9893
6213,聯茂,50,11,39,元大-大天母,2023-07-04,9893
2201,裕隆,35,0,35,元大-大天母,2023-07-04,9893
1905,華紙,67,33,34,元大-大天母,2023-07-04,9893
00645,富邦日本,32,0,32,元大-大天母,2023-07-04,9893
00720B,元大投資級公司債,32,0,32,元大-大天母,2023-07-04,9893
1471,首利,32,0,32,元大-大天母,2023-07-04,9893
3055,蔚華科,36,5,31,元大-大天母,2023-07-04,9893
1319,東陽,30,0,30,元大-大天母,2023-07-04,9893
2888,新光金,31,2,29,元大-大天母,2023-07-04,9893
4743,合一,29,0,29,元大-大天母,2023-07-04,9893
6122,擎邦,33,5,28,元大-大天母,2023-07-04,9893
2421,建準,61,35,26,元大-大天母,2023-07-04,9893
3711,日月光投控,28,5,23,元大-大天母,2023-07-04,9893
1522,堤維西,56,33,23,元大-大天母,2023-07-04,9893
6691,洋基工程,22,0,22,元大-大天母,2023-07-04,9893
2637,慧洋-KY,22,0,22,元大-大天母,2023-07-04,9893
3447,展達,24,2,22,元大-大天母,2023-07-04,9893
6470,宇智,46,24,22,元大-大天母,2023-07-04,9893
3078,僑威,23,2,21,元大-大天母,2023-07-04,9893
3092,鴻碩,21,0,21,元大-大天母,2023-07-04,9893
6443,元晶,20,0,20,元大-大天母,2023-07-04,9893
4549,桓達,20,0,20,元大-大天母,2023-07-04,9893
1301,台塑,20,0,20,元大-大天母,2023-07-04,9893
3591,艾笛森,20,1,19,元大-大天母,2023-07-04,9893
3260,威剛,41,25,16,元大-大天母,2023-07-04,9893
2753,八方雲集,16,0,16,元大-大天母,2023-07-04,9893
1314,中石化,15,0,15,元大-大天母,2023-07-04,9893
1789,神隆,15,0,15,元大-大天母,2023-07-04,9893
3673,TPK-KY,20,6,14,元大-大天母,2023-07-04,9893
4533,協易機,14,0,14,元大-大天母,2023-07-04,9893
8050,廣積,40,26,14,元大-大天母,2023-07-04,9893
1795,美時,17,3,14,元大-大天母,2023-07-04,9893
8112,至上,16,3,13,元大-大天母,2023-07-04,9893
2609,陽明,646,100,546,元大-大天母,2023-07-05,9893
3231,緯創,183,47,136,元大-大天母,2023-07-05,9893
2883,凱基金,140,6,134,元大-大天母,2023-07-05,9893
5347,世界,103,2,101,元大-大天母,2023-07-05,9893
2885,元大金,90,0,90,元大-大天母,2023-07-05,9893
2356,英業達,122,40,82,元大-大天母,2023-07-05,9893
2312,金寶,64,7,57,元大-大天母,2023-07-05,9893
3481,群創,59,2,57,元大-大天母,2023-07-05,9893
3346,麗清,54,1,53,元大-大天母,2023-07-05,9893
1795,美時,51,2,49,元大-大天母,2023-07-05,9893
6153,嘉聯益,44,0,44,元大-大天母,2023-07-05,9893
2419,仲琦,55,15,40,元大-大天母,2023-07-05,9893
6770,力積電,54,15,39,元大-大天母,2023-07-05,9893
00878,國泰永續高股息,39,8,31,元大-大天母,2023-07-05,9893
2618,長榮航,119,88,31,元大-大天母,2023-07-05,9893
00687B,國泰20年美債,30,0,30,元大-大天母,2023-07-05,9893
4414,如興,30,0,30,元大-大天母,2023-07-05,9893
4904,遠傳,27,0,27,元大-大天母,2023-07-05,9893
0056,元大高股息,48,21,27,元大-大天母,2023-07-05,9893
2888,新光金,69,42,27,元大-大天母,2023-07-05,9893
00712,復華富時不動產,27,0,27,元大-大天母,2023-07-05,9893
6276,安鈦克,27,0,27,元大-大天母,2023-07-05,9893
00929,復華台灣科技優息,28,2,26,元大-大天母,2023-07-05,9893
5258,虹堡,29,3,26,元大-大天母,2023-07-05,9893
3706,神達,26,2,24,元大-大天母,2023-07-05,9893
2206,三陽工業,26,2,24,元大-大天母,2023-07-05,9893
2369,菱生,26,2,24,元大-大天母,2023-07-05,9893
9933,中鼎,26,3,23,元大-大天母,2023-07-05,9893
4915,致伸,22,1,21,元大-大天母,2023-07-05,9893
1903,士紙,22,1,21,元大-大天母,2023-07-05,9893
6257,矽格,26,5,21,元大-大天母,2023-07-05,9893
1414,東和,20,0,20,元大-大天母,2023-07-05,9893
1611,中電,37,17,20,元大-大天母,2023-07-05,9893
1528,恩德,22,3,19,元大-大天母,2023-07-05,9893
4909,新復興,20,2,18,元大-大天母,2023-07-05,9893
1513,中興電,27,9,18,元大-大天母,2023-07-05,9893
2402,毅嘉,31,14,17,元大-大天母,2023-07-05,9893
1905,華紙,25,8,17,元大-大天母,2023-07-05,9893
00645,富邦日本,21,4,17,元大-大天母,2023-07-05,9893
00633L,富邦上証正2,32,15,17,元大-大天母,2023-07-05,9893
3447,展達,17,0,17,元大-大天母,2023-07-05,9893
3380,明泰,16,0,16,元大-大天母,2023-07-05,9893
4919,新唐,36,20,16,元大-大天母,2023-07-05,9893
1101,台泥,16,1,15,元大-大天母,2023-07-05,9893
4549,桓達,15,0,15,元大-大天母,2023-07-05,9893
6133,金橋,15,0,15,元大-大天母,2023-07-05,9893
6108,競國,15,0,15,元大-大天母,2023-07-05,9893
00881,國泰台灣5G+,22,8,14,元大-大天母,2023-07-05,9893
1471,首利,15,1,14,元大-大天母,2023-07-05,9893
1319,東陽,14,0,14,元大-大天母,2023-07-05,9893
2883,凱基金,281,4,277,元大-大天母,2023-07-06,9893
2609,陽明,310,60,250,元大-大天母,2023-07-06,9893
2891,中信金,137,0,137,元大-大天母,2023-07-06,9893
5864,致和證,115,0,115,元大-大天母,2023-07-06,9893
00688L,國泰20年美債正2,103,0,103,元大-大天母,2023-07-06,9893
2329,華泰,102,11,91,元大-大天母,2023-07-06,9893
3711,日月光投控,72,3,69,元大-大天母,2023-07-06,9893
5347,世界,73,5,68,元大-大天母,2023-07-06,9893
5876,上海商銀,60,0,60,元大-大天母,2023-07-06,9893
6282,康舒,143,83,60,元大-大天母,2023-07-06,9893
2886,兆豐金,65,8,57,元大-大天母,2023-07-06,9893
2812,台中銀,51,0,51,元大-大天母,2023-07-06,9893
2330,台積電,49,2,47,元大-大天母,2023-07-06,9893
2881,富邦金,47,0,47,元大-大天母,2023-07-06,9893
00922,國泰台灣領袖50,43,0,43,元大-大天母,2023-07-06,9893
00720B,元大投資級公司債,54,11,43,元大-大天母,2023-07-06,9893
6111,大宇資,62,20,42,元大-大天母,2023-07-06,9893
0056,元大高股息,55,17,38,元大-大天母,2023-07-06,9893
1326,台化,37,0,37,元大-大天母,2023-07-06,9893
2382,廣達,64,31,33,元大-大天母,2023-07-06,9893
4739,康普,30,0,30,元大-大天母,2023-07-06,9893
6108,競國,30,0,30,元大-大天母,2023-07-06,9893
3207,耀勝,31,3,28,元大-大天母,2023-07-06,9893
00673R,期元大S＆P原油反1,28,0,28,元大-大天母,2023-07-06,9893
8215,明基材,63,35,28,元大-大天母,2023-07-06,9893
0050,元大台灣50,30,2,28,元大-大天母,2023-07-06,9893
006208,富邦台50,27,0,27,元大-大天母,2023-07-06,9893
2610,華航,57,31,26,元大-大天母,2023-07-06,9893
6770,力積電,23,0,23,元大-大天母,2023-07-06,9893
2356,英業達,59,37,22,元大-大天母,2023-07-06,9893
2884,玉山金,21,0,21,元大-大天母,2023-07-06,9893
00637L,元大滬深300正2,21,0,21,元大-大天母,2023-07-06,9893
2885,元大金,26,6,20,元大-大天母,2023-07-06,9893
3293,鈊象,20,0,20,元大-大天母,2023-07-06,9893
1589,永冠-KY,20,0,20,元大-大天母,2023-07-06,9893
2405,輔信,20,0,20,元大-大天母,2023-07-06,9893
1609,大亞,36,17,19,元大-大天母,2023-07-06,9893
1314,中石化,19,0,19,元大-大天母,2023-07-06,9893
00764B,群益25年美債,20,2,18,元大-大天母,2023-07-06,9893
2887,台新金,18,0,18,元大-大天母,2023-07-06,9893
2888,新光金,20,2,18,元大-大天母,2023-07-06,9893
2753,八方雲集,20,2,18,元大-大天母,2023-07-06,9893
00645,富邦日本,21,3,18,元大-大天母,2023-07-06,9893
00680L,元大美債20正2,18,0,18,元大-大天母,2023-07-06,9893
3481,群創,40,23,17,元大-大天母,2023-07-06,9893
3025,星通,20,3,17,元大-大天母,2023-07-06,9893
2002,中鋼,28,11,17,元大-大天母,2023-07-06,9893
2317,鴻海,22,5,17,元大-大天母,2023-07-06,9893
3260,威剛,21,6,15,元大-大天母,2023-07-06,9893
1303,南亞,15,0,15,元大-大天母,2023-07-06,9893
00632R,元大台灣50反1,991,0,991,元大-大天母,2023-07-07,9893
2312,金寶,547,31,516,元大-大天母,2023-07-07,9893
4527,方土霖,380,0,380,元大-大天母,2023-07-07,9893
00679B,元大美債20年,372,0,372,元大-大天母,2023-07-07,9893
00772B,中信高評級公司債,305,11,294,元大-大天母,2023-07-07,9893
2883,凱基金,191,8,183,元大-大天母,2023-07-07,9893
1301,台塑,124,0,124,元大-大天母,2023-07-07,9893
4927,泰鼎-KY,101,4,97,元大-大天母,2023-07-07,9893
2344,華邦電,80,11,69,元大-大天母,2023-07-07,9893
5347,世界,89,30,59,元大-大天母,2023-07-07,9893
2890,永豐金,59,10,49,元大-大天母,2023-07-07,9893
3234,光環,45,0,45,元大-大天母,2023-07-07,9893
2031,新光鋼,42,0,42,元大-大天母,2023-07-07,9893
6278,台表科,90,49,41,元大-大天母,2023-07-07,9893
3033,威健,36,1,35,元大-大天母,2023-07-07,9893
1101,台泥,35,3,32,元大-大天母,2023-07-07,9893
2340,台亞,45,14,31,元大-大天母,2023-07-07,9893
0056,元大高股息,69,38,31,元大-大天母,2023-07-07,9893
2401,凌陽,46,16,30,元大-大天母,2023-07-07,9893
2882,國泰金,30,1,29,元大-大天母,2023-07-07,9893
3059,華晶科,29,0,29,元大-大天母,2023-07-07,9893
1604,聲寶,30,1,29,元大-大天母,2023-07-07,9893
00929,復華台灣科技優息,29,0,29,元大-大天母,2023-07-07,9893
00922,國泰台灣領袖50,29,0,29,元大-大天母,2023-07-07,9893
8215,明基材,33,6,27,元大-大天母,2023-07-07,9893
6443,元晶,39,13,26,元大-大天母,2023-07-07,9893
2887,台新金,26,2,24,元大-大天母,2023-07-07,9893
5607,遠雄港,25,1,24,元大-大天母,2023-07-07,9893
2884,玉山金,30,7,23,元大-大天母,2023-07-07,9893
2382,廣達,50,27,23,元大-大天母,2023-07-07,9893
2633,台灣高鐵,23,0,23,元大-大天母,2023-07-07,9893
3673,TPK-KY,29,7,22,元大-大天母,2023-07-07,9893
5864,致和證,21,0,21,元大-大天母,2023-07-07,9893
3037,欣興,26,6,20,元大-大天母,2023-07-07,9893
2405,輔信,30,10,20,元大-大天母,2023-07-07,9893
2201,裕隆,20,0,20,元大-大天母,2023-07-07,9893
5469,瀚宇博,20,0,20,元大-大天母,2023-07-07,9893
2359,所羅門,25,7,18,元大-大天母,2023-07-07,9893
00751B,元大AAA至A公司債,18,0,18,元大-大天母,2023-07-07,9893
3481,群創,1017,1000,17,元大-大天母,2023-07-07,9893
2002,中鋼,28,11,17,元大-大天母,2023-07-07,9893
00878,國泰永續高股息,33,16,17,元大-大天母,2023-07-07,9893
00722B,群益投資級電信債,16,0,16,元大-大天母,2023-07-07,9893
2454,聯發科,15,0,15,元大-大天母,2023-07-07,9893
6235,華孚,14,0,14,元大-大天母,2023-07-07,9893
4174,浩鼎,13,0,13,元大-大天母,2023-07-07,9893
2834,臺企銀,15,2,13,元大-大天母,2023-07-07,9893
1447,力鵬,12,0,12,元大-大天母,2023-07-07,9893
00753L,中信中國50正2,22,10,12,元大-大天母,2023-07-07,9893
6576,逸達,13,1,12,元大-大天母,2023-07-07,9893
2408,南亞科,185,1,184,元大-大天母,2023-07-10,9893
2834,臺企銀,151,0,151,元大-大天母,2023-07-10,9893
00679B,元大美債20年,159,25,134,元大-大天母,2023-07-10,9893
00772B,中信高評級公司債,102,0,102,元大-大天母,2023-07-10,9893
4173,久裕,80,2,78,元大-大天母,2023-07-10,9893
5347,世界,63,0,63,元大-大天母,2023-07-10,9893
4532,瑞智,208,153,55,元大-大天母,2023-07-10,9893
2356,英業達,48,4,44,元大-大天母,2023-07-10,9893
3011,今皓,44,0,44,元大-大天母,2023-07-10,9893
2884,玉山金,43,0,43,元大-大天母,2023-07-10,9893
1101,台泥,49,10,39,元大-大天母,2023-07-10,9893
00929,復華台灣科技優息,39,0,39,元大-大天母,2023-07-10,9893
2489,瑞軒,34,0,34,元大-大天母,2023-07-10,9893
2618,長榮航,39,6,33,元大-大天母,2023-07-10,9893
3231,緯創,78,46,32,元大-大天母,2023-07-10,9893
6120,達運,32,1,31,元大-大天母,2023-07-10,9893
1909,榮成,30,0,30,元大-大天母,2023-07-10,9893
2303,聯電,42,13,29,元大-大天母,2023-07-10,9893
2882,國泰金,40,11,29,元大-大天母,2023-07-10,9893
4123,晟德,30,1,29,元大-大天母,2023-07-10,9893
8050,廣積,40,12,28,元大-大天母,2023-07-10,9893
2886,兆豐金,40,12,28,元大-大天母,2023-07-10,9893
2353,宏��,32,4,28,元大-大天母,2023-07-10,9893
3163,波若威,36,10,26,元大-大天母,2023-07-10,9893
2603,長榮,43,19,24,元大-大天母,2023-07-10,9893
2405,輔信,24,0,24,元大-大天母,2023-07-10,9893
5864,致和證,25,2,23,元大-大天母,2023-07-10,9893
5607,遠雄港,23,0,23,元大-大天母,2023-07-10,9893
2486,一詮,40,18,22,元大-大天母,2023-07-10,9893
3028,增你強,21,0,21,元大-大天母,2023-07-10,9893
5009,榮剛,23,2,21,元大-大天母,2023-07-10,9893
3059,華晶科,23,2,21,元大-大天母,2023-07-10,9893
5475,德宏,21,0,21,元大-大天母,2023-07-10,9893
2454,聯發科,21,0,21,元大-大天母,2023-07-10,9893
1802,台玻,20,0,20,元大-大天母,2023-07-10,9893
2903,遠百,20,0,20,元大-大天母,2023-07-10,9893
3645,達邁,23,4,19,元大-大天母,2023-07-10,9893
6662,樂斯科,20,1,19,元大-大天母,2023-07-10,9893
00673R,期元大S＆P原油反1,17,0,17,元大-大天母,2023-07-10,9893
4503,金雨,22,5,17,元大-大天母,2023-07-10,9893
2344,華邦電,39,23,16,元大-大天母,2023-07-10,9893
00688L,國泰20年美債正2,15,0,15,元大-大天母,2023-07-10,9893
00751B,元大AAA至A公司債,15,0,15,元大-大天母,2023-07-10,9893
5381,合正,15,0,15,元大-大天母,2023-07-10,9893
4979,華星光,26,12,14,元大-大天母,2023-07-10,9893
3711,日月光投控,14,0,14,元大-大天母,2023-07-10,9893
2916,滿心,14,0,14,元大-大天母,2023-07-10,9893
2419,仲琦,21,7,14,元大-大天母,2023-07-10,9893
6203,海韻電,13,0,13,元大-大天母,2023-07-10,9893
3324,雙鴻,13,0,13,元大-大天母,2023-07-10,9893
00679B,元大美債20年,205,0,205,元大-大天母,2023-07-11,9893
2888,新光金,180,0,180,元大-大天母,2023-07-11,9893
2609,陽明,159,34,125,元大-大天母,2023-07-11,9893
2340,台亞,195,94,101,元大-大天母,2023-07-11,9893
2371,大同,118,18,100,元大-大天母,2023-07-11,9893
4527,方土霖,77,7,70,元大-大天母,2023-07-11,9893
4173,久裕,55,0,55,元大-大天母,2023-07-11,9893
2402,毅嘉,60,5,55,元大-大天母,2023-07-11,9893
6190,萬泰科,51,2,49,元大-大天母,2023-07-11,9893
2867,三商壽,50,3,47,元大-大天母,2023-07-11,9893
2916,滿心,43,0,43,元大-大天母,2023-07-11,9893
2423,固緯,40,0,40,元大-大天母,2023-07-11,9893
00632R,元大台灣50反1,140,100,40,元大-大天母,2023-07-11,9893
2329,華泰,55,15,40,元大-大天母,2023-07-11,9893
6662,樂斯科,37,0,37,元大-大天母,2023-07-11,9893
2323,中環,39,2,37,元大-大天母,2023-07-11,9893
1540,喬福,37,1,36,元大-大天母,2023-07-11,9893
00687B,國泰20年美債,36,0,36,元大-大天母,2023-07-11,9893
5607,遠雄港,36,0,36,元大-大天母,2023-07-11,9893
6182,合晶,37,4,33,元大-大天母,2023-07-11,9893
00927,群益半導體收益,32,0,32,元大-大天母,2023-07-11,9893
2449,京元電子,32,4,28,元大-大天母,2023-07-11,9893
1605,華新,29,2,27,元大-大天母,2023-07-11,9893
2618,長榮航,49,24,25,元大-大天母,2023-07-11,9893
1905,華紙,25,1,24,元大-大天母,2023-07-11,9893
4960,誠美材,22,0,22,元大-大天母,2023-07-11,9893
1528,恩德,32,10,22,元大-大天母,2023-07-11,9893
2303,聯電,33,12,21,元大-大天母,2023-07-11,9893
1101,台泥,23,2,21,元大-大天母,2023-07-11,9893
1308,亞聚,21,0,21,元大-大天母,2023-07-11,9893
4989,榮科,21,0,21,元大-大天母,2023-07-11,9893
3207,耀勝,21,0,21,元大-大天母,2023-07-11,9893
2014,中鴻,20,0,20,元大-大天母,2023-07-11,9893
3666,光耀,21,1,20,元大-大天母,2023-07-11,9893
2610,華航,147,128,19,元大-大天母,2023-07-11,9893
4746,台耀,24,5,19,元大-大天母,2023-07-11,9893
3707,漢磊,32,15,17,元大-大天母,2023-07-11,9893
2634,漢翔,16,0,16,元大-大天母,2023-07-11,9893
8210,勤誠,18,4,14,元大-大天母,2023-07-11,9893
1514,亞力,14,0,14,元大-大天母,2023-07-11,9893
1795,美時,17,3,14,元大-大天母,2023-07-11,9893
4510,高鋒,17,3,14,元大-大天母,2023-07-11,9893
9904,寶成,13,0,13,元大-大天母,2023-07-11,9893
8086,宏捷科,13,0,13,元大-大天母,2023-07-11,9893
1303,南亞,13,0,13,元大-大天母,2023-07-11,9893
2362,藍天,12,0,12,元大-大天母,2023-07-11,9893
6217,中探針,16,4,12,元大-大天母,2023-07-11,9893
3645,達邁,11,0,11,元大-大天母,2023-07-11,9893
1903,士紙,11,0,11,元大-大天母,2023-07-11,9893
3305,昇貿,19,8,11,元大-大天母,2023-07-11,9893
2340,台亞,282,3,279,元大-大天母,2023-07-12,9893
3231,緯創,335,88,247,元大-大天母,2023-07-12,9893
2301,光寶科,249,60,189,元大-大天母,2023-07-12,9893
6187,萬潤,161,13,148,元大-大天母,2023-07-12,9893
00679B,元大美債20年,114,1,113,元大-大天母,2023-07-12,9893
00772B,中信高評級公司債,101,0,101,元大-大天母,2023-07-12,9893
5258,虹堡,103,6,97,元大-大天母,2023-07-12,9893
1210,大成,95,0,95,元大-大天母,2023-07-12,9893
4173,久裕,84,0,84,元大-大天母,2023-07-12,9893
2887,台新金,69,0,69,元大-大天母,2023-07-12,9893
8088,品安,67,0,67,元大-大天母,2023-07-12,9893
8936,國統,62,1,61,元大-大天母,2023-07-12,9893
2027,大成鋼,60,0,60,元大-大天母,2023-07-12,9893
3706,神達,155,97,58,元大-大天母,2023-07-12,9893
2382,廣達,112,55,57,元大-大天母,2023-07-12,9893
00712,復華富時不動產,55,0,55,元大-大天母,2023-07-12,9893
2329,華泰,63,11,52,元大-大天母,2023-07-12,9893
3234,光環,54,2,52,元大-大天母,2023-07-12,9893
6703,軒郁,52,1,51,元大-大天母,2023-07-12,9893
2323,中環,66,15,51,元大-大天母,2023-07-12,9893
00676R,富邦臺灣加權反1,50,0,50,元大-大天母,2023-07-12,9893
00673R,期元大S＆P原油反1,46,0,46,元大-大天母,2023-07-12,9893
2882,國泰金,44,4,40,元大-大天母,2023-07-12,9893
00905,FT臺灣Smart,34,0,34,元大-大天母,2023-07-12,9893
2449,京元電子,40,8,32,元大-大天母,2023-07-12,9893
2303,聯電,58,26,32,元大-大天母,2023-07-12,9893
00720B,元大投資級公司債,31,0,31,元大-大天母,2023-07-12,9893
2399,映泰,38,8,30,元大-大天母,2023-07-12,9893
2636,台驊控股,30,0,30,元大-大天母,2023-07-12,9893
9802,鈺齊-KY,23,0,23,元大-大天母,2023-07-12,9893
4908,前鼎,22,0,22,元大-大天母,2023-07-12,9893
1108,幸福,20,0,20,元大-大天母,2023-07-12,9893
5243,乙盛-KY,20,0,20,元大-大天母,2023-07-12,9893
2916,滿心,25,6,19,元大-大天母,2023-07-12,9893
2457,飛宏,57,38,19,元大-大天母,2023-07-12,9893
1301,台塑,19,1,18,元大-大天母,2023-07-12,9893
6285,啟��,24,7,17,元大-大天母,2023-07-12,9893
3666,光耀,17,0,17,元大-大天母,2023-07-12,9893
6585,鼎基,17,0,17,元大-大天母,2023-07-12,9893
3521,鴻翊,16,0,16,元大-大天母,2023-07-12,9893
1528,恩德,15,0,15,元大-大天母,2023-07-12,9893
00764B,群益25年美債,15,0,15,元大-大天母,2023-07-12,9893
00888,永豐台灣ESG,14,0,14,元大-大天母,2023-07-12,9893
00680L,元大美債20正2,14,0,14,元大-大天母,2023-07-12,9893
2501,國建,14,1,13,元大-大天母,2023-07-12,9893
1589,永冠-KY,13,0,13,元大-大天母,2023-07-12,9893
4726,永昕,13,0,13,元大-大天母,2023-07-12,9893
1303,南亞,12,0,12,元大-大天母,2023-07-12,9893
8028,昇陽半導體,14,2,12,元大-大天母,2023-07-12,9893
6235,華孚,20,8,12,元大-大天母,2023-07-12,9893
2301,光寶科,223,60,163,元大-大天母,2023-07-13,9893
2618,長榮航,161,31,130,元大-大天母,2023-07-13,9893
2303,聯電,115,23,92,元大-大天母,2023-07-13,9893
00772B,中信高評級公司債,101,20,81,元大-大天母,2023-07-13,9893
3047,訊舟,73,1,72,元大-大天母,2023-07-13,9893
00676R,富邦臺灣加權反1,70,0,70,元大-大天母,2023-07-13,9893
00673R,期元大S＆P原油反1,66,0,66,元大-大天母,2023-07-13,9893
3694,海華,60,0,60,元大-大天母,2023-07-13,9893
00679B,元大美債20年,60,1,59,元大-大天母,2023-07-13,9893
2324,仁寶,74,20,54,元大-大天母,2023-07-13,9893
2882,國泰金,53,12,41,元大-大天母,2023-07-13,9893
3011,今皓,40,1,39,元大-大天母,2023-07-13,9893
3032,偉訓,56,18,38,元大-大天母,2023-07-13,9893
00929,復華台灣科技優息,44,6,38,元大-大天母,2023-07-13,9893
2609,陽明,71,35,36,元大-大天母,2023-07-13,9893
00637L,元大滬深300正2,96,61,35,元大-大天母,2023-07-13,9893
5009,榮剛,33,3,30,元大-大天母,2023-07-13,9893
2881,富邦金,30,3,27,元大-大天母,2023-07-13,9893
1609,大亞,31,5,26,元大-大天母,2023-07-13,9893
4543,萬在,26,0,26,元大-大天母,2023-07-13,9893
2633,台灣高鐵,26,0,26,元大-大天母,2023-07-13,9893
6285,啟��,34,11,23,元大-大天母,2023-07-13,9893
2323,中環,26,3,23,元大-大天母,2023-07-13,9893
2401,凌陽,32,9,23,元大-大天母,2023-07-13,9893
8150,南茂,23,0,23,元大-大天母,2023-07-13,9893
2636,台驊控股,21,0,21,元大-大天母,2023-07-13,9893
00930,永豐ESG低碳高息,21,0,21,元大-大天母,2023-07-13,9893
4173,久裕,21,0,21,元大-大天母,2023-07-13,9893
00753L,中信中國50正2,26,5,21,元大-大天母,2023-07-13,9893
8046,南電,23,2,21,元大-大天母,2023-07-13,9893
8261,富鼎,21,1,20,元大-大天母,2023-07-13,9893
6005,群益證,25,5,20,元大-大天母,2023-07-13,9893
2834,臺企銀,20,0,20,元大-大天母,2023-07-13,9893
1312,國喬,20,0,20,元大-大天母,2023-07-13,9893
4510,高鋒,18,0,18,元大-大天母,2023-07-13,9893
1903,士紙,22,5,17,元大-大天母,2023-07-13,9893
4938,和碩,35,18,17,元大-大天母,2023-07-13,9893
3666,光耀,23,6,17,元大-大天母,2023-07-13,9893
6672,騰輝電子-KY,16,0,16,元大-大天母,2023-07-13,9893
4532,瑞智,29,13,16,元大-大天母,2023-07-13,9893
2610,華航,67,51,16,元大-大天母,2023-07-13,9893
3002,歐格,15,0,15,元大-大天母,2023-07-13,9893
1528,恩德,15,0,15,元大-大天母,2023-07-13,9893
6188,廣明,51,36,15,元大-大天母,2023-07-13,9893
6125,廣運,15,1,14,元大-大天母,2023-07-13,9893
2376,技嘉,76,62,14,元大-大天母,2023-07-13,9893
6443,元晶,43,30,13,元大-大天母,2023-07-13,9893
1301,台塑,13,1,12,元大-大天母,2023-07-13,9893
2820,華票,12,0,12,元大-大天母,2023-07-13,9893
3693,營邦,14,2,12,元大-大天母,2023-07-13,9893
2340,台亞,1086,44,1042,元大-大天母,2023-07-14,9893
2371,大同,349,205,144,元大-大天母,2023-07-14,9893
2409,友達,136,16,120,元大-大天母,2023-07-14,9893
2324,仁寶,125,7,118,元大-大天母,2023-07-14,9893
2610,華航,174,70,104,元大-大天母,2023-07-14,9893
00637L,元大滬深300正2,100,2,98,元大-大天母,2023-07-14,9893
00676R,富邦臺灣加權反1,76,0,76,元大-大天母,2023-07-14,9893
2618,長榮航,249,182,67,元大-大天母,2023-07-14,9893
8086,宏捷科,50,0,50,元大-大天母,2023-07-14,9893
3011,今皓,61,11,50,元大-大天母,2023-07-14,9893
6187,萬潤,41,2,39,元大-大天母,2023-07-14,9893
3694,海華,39,0,39,元大-大天母,2023-07-14,9893
8114,振樺電,38,0,38,元大-大天母,2023-07-14,9893
00929,復華台灣科技優息,37,0,37,元大-大天母,2023-07-14,9893
2201,裕隆,42,5,37,元大-大天母,2023-07-14,9893
6235,華孚,49,20,29,元大-大天母,2023-07-14,9893
2382,廣達,110,85,25,元大-大天母,2023-07-14,9893
6005,群益證,25,1,24,元大-大天母,2023-07-14,9893
1903,士紙,26,2,24,元大-大天母,2023-07-14,9893
3689,湧德,26,3,23,元大-大天母,2023-07-14,9893
1227,佳格,22,0,22,元大-大天母,2023-07-14,9893
2376,技嘉,73,52,21,元大-大天母,2023-07-14,9893
6168,宏齊,21,0,21,元大-大天母,2023-07-14,9893
3693,營邦,41,21,20,元大-大天母,2023-07-14,9893
2881,富邦金,25,7,18,元大-大天母,2023-07-14,9893
1609,大亞,23,6,17,元大-大天母,2023-07-14,9893
5009,榮剛,19,2,17,元大-大天母,2023-07-14,9893
00882,中信中國高股息,17,0,17,元大-大天母,2023-07-14,9893
2344,華邦電,44,28,16,元大-大天母,2023-07-14,9893
3032,偉訓,36,20,16,元大-大天母,2023-07-14,9893
2449,京元電子,30,15,15,元大-大天母,2023-07-14,9893
4744,皇將,15,0,15,元大-大天母,2023-07-14,9893
6190,萬泰科,62,47,15,元大-大天母,2023-07-14,9893
00673R,期元大S＆P原油反1,14,0,14,元大-大天母,2023-07-14,9893
8050,廣積,46,32,14,元大-大天母,2023-07-14,9893
2885,元大金,20,7,13,元大-大天母,2023-07-14,9893
1612,宏泰,14,1,13,元大-大天母,2023-07-14,9893
00687B,國泰20年美債,12,0,12,元大-大天母,2023-07-14,9893
3060,銘異,11,0,11,元大-大天母,2023-07-14,9893
00907,永豐優息存股,11,0,11,元大-大天母,2023-07-14,9893
00714,群益道瓊美國地產,11,0,11,元大-大天母,2023-07-14,9893
3576,聯合再生,11,0,11,元大-大天母,2023-07-14,9893
8215,明基材,10,0,10,元大-大天母,2023-07-14,9893
00888,永豐台灣ESG,10,0,10,元大-大天母,2023-07-14,9893
2603,長榮,64,54,10,元大-大天母,2023-07-14,9893
3483,力致,10,0,10,元大-大天母,2023-07-14,9893
4127,天良,10,0,10,元大-大天母,2023-07-14,9893
00757,統一FANG+,10,1,9,元大-大天母,2023-07-14,9893
8358,金居,47,38,9,元大-大天母,2023-07-14,9893
2355,敬鵬,25,16,9,元大-大天母,2023-07-14,9893
2340,台亞,566,65,501,元大-大天母,2023-07-17,9893
4927,泰鼎-KY,200,0,200,元大-大天母,2023-07-17,9893
2105,正新,203,6,197,元大-大天母,2023-07-17,9893
6203,海韻電,150,0,150,元大-大天母,2023-07-17,9893
3011,今皓,61,0,61,元大-大天母,2023-07-17,9893
2103,台橡,60,0,60,元大-大天母,2023-07-17,9893
00929,復華台灣科技優息,59,1,58,元大-大天母,2023-07-17,9893
1711,永光,61,3,58,元大-大天母,2023-07-17,9893
6216,居易,57,0,57,元大-大天母,2023-07-17,9893
2031,新光鋼,60,4,56,元大-大天母,2023-07-17,9893
00753L,中信中國50正2,50,1,49,元大-大天母,2023-07-17,9893
2401,凌陽,48,9,39,元大-大天母,2023-07-17,9893
00878,國泰永續高股息,67,29,38,元大-大天母,2023-07-17,9893
00720B,元大投資級公司債,35,0,35,元大-大天母,2023-07-17,9893
2312,金寶,117,84,33,元大-大天母,2023-07-17,9893
2405,輔信,30,0,30,元大-大天母,2023-07-17,9893
00679B,元大美債20年,30,0,30,元大-大天母,2023-07-17,9893
3037,欣興,36,7,29,元大-大天母,2023-07-17,9893
3025,星通,31,2,29,元大-大天母,2023-07-17,9893
00772B,中信高評級公司債,32,4,28,元大-大天母,2023-07-17,9893
2313,華通,98,70,28,元大-大天母,2023-07-17,9893
2356,英業達,75,49,26,元大-大天母,2023-07-17,9893
6005,群益證,50,25,25,元大-大天母,2023-07-17,9893
3058,立德,25,0,25,元大-大天母,2023-07-17,9893
00882,中信中國高股息,27,2,25,元大-大天母,2023-07-17,9893
020038,元大ESG配息N,25,0,25,元大-大天母,2023-07-17,9893
5009,榮剛,30,6,24,元大-大天母,2023-07-17,9893
2609,陽明,30,7,23,元大-大天母,2023-07-17,9893
1504,東元,40,18,22,元大-大天母,2023-07-17,9893
1101,台泥,22,1,21,元大-大天母,2023-07-17,9893
2618,長榮航,57,37,20,元大-大天母,2023-07-17,9893
1402,遠東新,20,0,20,元大-大天母,2023-07-17,9893
2355,敬鵬,20,0,20,元大-大天母,2023-07-17,9893
2607,榮運,30,10,20,元大-大天母,2023-07-17,9893
4130,健亞,18,0,18,元大-大天母,2023-07-17,9893
2388,威盛,27,11,16,元大-大天母,2023-07-17,9893
00900,富邦特選高股息30,23,7,16,元大-大天母,2023-07-17,9893
8049,晶采,16,0,16,元大-大天母,2023-07-17,9893
5607,遠雄港,29,13,16,元大-大天母,2023-07-17,9893
5439,高技,17,2,15,元大-大天母,2023-07-17,9893
2201,裕隆,17,2,15,元大-大天母,2023-07-17,9893
00633L,富邦上証正2,26,12,14,元大-大天母,2023-07-17,9893
6217,中探針,14,0,14,元大-大天母,2023-07-17,9893
2303,聯電,52,39,13,元大-大天母,2023-07-17,9893
2328,廣宇,21,8,13,元大-大天母,2023-07-17,9893
5426,振發,13,0,13,元大-大天母,2023-07-17,9893
00715L,期街口布蘭特正2,22,9,13,元大-大天母,2023-07-17,9893
8936,國統,17,5,12,元大-大天母,2023-07-17,9893
6446,藥華藥,19,7,12,元大-大天母,2023-07-17,9893
4116,明基醫,12,0,12,元大-大天母,2023-07-17,9893
4938,和碩,416,65,351,元大-大天母,2023-07-18,9893
2340,台亞,248,40,208,元大-大天母,2023-07-18,9893
00715L,期街口布蘭特正2,198,2,196,元大-大天母,2023-07-18,9893
6282,康舒,254,99,155,元大-大天母,2023-07-18,9893
1102,亞泥,151,5,146,元大-大天母,2023-07-18,9893
8926,台汽電,123,13,110,元大-大天母,2023-07-18,9893
3483,力致,125,18,107,元大-大天母,2023-07-18,9893
2303,聯電,113,6,107,元大-大天母,2023-07-18,9893
2883,凱基金,107,2,105,元大-大天母,2023-07-18,9893
6147,頎邦,101,0,101,元大-大天母,2023-07-18,9893
00929,復華台灣科技優息,115,22,93,元大-大天母,2023-07-18,9893
2449,京元電子,128,40,88,元大-大天母,2023-07-18,9893
2324,仁寶,133,52,81,元大-大天母,2023-07-18,9893
00772B,中信高評級公司債,71,0,71,元大-大天母,2023-07-18,9893
3033,威健,74,4,70,元大-大天母,2023-07-18,9893
2618,長榮航,97,41,56,元大-大天母,2023-07-18,9893
2892,第一金,68,12,56,元大-大天母,2023-07-18,9893
2401,凌陽,61,6,55,元大-大天母,2023-07-18,9893
2204,中華,50,0,50,元大-大天母,2023-07-18,9893
1402,遠東新,50,2,48,元大-大天母,2023-07-18,9893
3011,今皓,50,3,47,元大-大天母,2023-07-18,9893
3305,昇貿,56,12,44,元大-大天母,2023-07-18,9893
3711,日月光投控,44,2,42,元大-大天母,2023-07-18,9893
6216,居易,41,0,41,元大-大天母,2023-07-18,9893
2031,新光鋼,36,0,36,元大-大天母,2023-07-18,9893
1789,神隆,78,43,35,元大-大天母,2023-07-18,9893
5469,瀚宇博,57,22,35,元大-大天母,2023-07-18,9893
2481,強茂,82,47,35,元大-大天母,2023-07-18,9893
00882,中信中國高股息,33,0,33,元大-大天母,2023-07-18,9893
2607,榮運,30,0,30,元大-大天母,2023-07-18,9893
8086,宏捷科,30,0,30,元大-大天母,2023-07-18,9893
6217,中探針,29,0,29,元大-大天母,2023-07-18,9893
1101,台泥,37,10,27,元大-大天母,2023-07-18,9893
3071,協禧,40,13,27,元大-大天母,2023-07-18,9893
6117,迎廣,27,0,27,元大-大天母,2023-07-18,9893
2617,台航,30,3,27,元大-大天母,2023-07-18,9893
1905,華紙,25,0,25,元大-大天母,2023-07-18,9893
3715,定穎投控,92,68,24,元大-大天母,2023-07-18,9893
1611,中電,22,0,22,元大-大天母,2023-07-18,9893
00720B,元大投資級公司債,22,0,22,元大-大天母,2023-07-18,9893
3227,原相,30,8,22,元大-大天母,2023-07-18,9893
2356,英業達,227,205,22,元大-大天母,2023-07-18,9893
4746,台耀,35,14,21,元大-大天母,2023-07-18,9893
5426,振發,20,0,20,元大-大天母,2023-07-18,9893
3441,聯一光,20,0,20,元大-大天母,2023-07-18,9893
1612,宏泰,22,3,19,元大-大天母,2023-07-18,9893
2610,華航,47,28,19,元大-大天母,2023-07-18,9893
1513,中興電,28,10,18,元大-大天母,2023-07-18,9893
8011,台通,26,10,16,元大-大天母,2023-07-18,9893
1795,美時,19,4,15,元大-大天母,2023-07-18,9893
00752,中信中國50,499,0,499,元大-大天母,2023-07-19,9893
2618,長榮航,214,33,181,元大-大天母,2023-07-19,9893
2883,凱基金,155,0,155,元大-大天母,2023-07-19,9893
2886,兆豐金,161,7,154,元大-大天母,2023-07-19,9893
2353,宏��,164,56,108,元大-大天母,2023-07-19,9893
8926,台汽電,100,0,100,元大-大天母,2023-07-19,9893
2890,永豐金,102,4,98,元大-大天母,2023-07-19,9893
1609,大亞,83,11,72,元大-大天母,2023-07-19,9893
00878,國泰永續高股息,106,40,66,元大-大天母,2023-07-19,9893
3711,日月光投控,67,1,66,元大-大天母,2023-07-19,9893
2031,新光鋼,65,1,64,元大-大天母,2023-07-19,9893
2610,華航,65,10,55,元大-大天母,2023-07-19,9893
1504,東元,59,6,53,元大-大天母,2023-07-19,9893
00885,富邦越南,52,3,49,元大-大天母,2023-07-19,9893
00929,復華台灣科技優息,47,0,47,元大-大天母,2023-07-19,9893
3045,台灣大,45,0,45,元大-大天母,2023-07-19,9893
6121,新普,41,0,41,元大-大天母,2023-07-19,9893
4566,時碩工業,51,10,41,元大-大天母,2023-07-19,9893
3037,欣興,109,69,40,元大-大天母,2023-07-19,9893
2340,台亞,53,13,40,元大-大天母,2023-07-19,9893
5009,榮剛,40,0,40,元大-大天母,2023-07-19,9893
2204,中華,39,0,39,元大-大天母,2023-07-19,9893
00882,中信中國高股息,36,0,36,元大-大天母,2023-07-19,9893
5426,振發,35,0,35,元大-大天母,2023-07-19,9893
1102,亞泥,34,0,34,元大-大天母,2023-07-19,9893
4927,泰鼎-KY,33,0,33,元大-大天母,2023-07-19,9893
1402,遠東新,31,0,31,元大-大天母,2023-07-19,9893
3011,今皓,30,0,30,元大-大天母,2023-07-19,9893
2913,農林,30,0,30,元大-大天母,2023-07-19,9893
6282,康舒,62,33,29,元大-大天母,2023-07-19,9893
6128,上福,25,0,25,元大-大天母,2023-07-19,9893
2329,華泰,93,68,25,元大-大天母,2023-07-19,9893
1789,神隆,61,37,24,元大-大天母,2023-07-19,9893
00895,富邦未來車,23,0,23,元大-大天母,2023-07-19,9893
3661,世芯-KY,26,3,23,元大-大天母,2023-07-19,9893
2404,漢唐,22,0,22,元大-大天母,2023-07-19,9893
6161,捷波,33,11,22,元大-大天母,2023-07-19,9893
2323,中環,22,0,22,元大-大天母,2023-07-19,9893
3481,群創,41,20,21,元大-大天母,2023-07-19,9893
2313,華通,21,1,20,元大-大天母,2023-07-19,9893
3260,威剛,22,3,19,元大-大天母,2023-07-19,9893
00919,群益台灣精選高息,18,1,17,元大-大天母,2023-07-19,9893
2316,楠梓電,32,16,16,元大-大天母,2023-07-19,9893
2344,華邦電,36,20,16,元大-大天母,2023-07-19,9893
1907,永豐餘,16,2,14,元大-大天母,2023-07-19,9893
2201,裕隆,14,0,14,元大-大天母,2023-07-19,9893
2892,第一金,23,10,13,元大-大天母,2023-07-19,9893
3149,正達,14,1,13,元大-大天母,2023-07-19,9893
1314,中石化,39,26,13,元大-大天母,2023-07-19,9893
3709,鑫聯大投控,13,0,13,元大-大天母,2023-07-19,9893
2881,富邦金,125,14,111,元大-大天母,2023-07-20,9893
3481,群創,169,67,102,元大-大天母,2023-07-20,9893
2303,聯電,112,39,73,元大-大天母,2023-07-20,9893
2409,友達,51,6,45,元大-大天母,2023-07-20,9893
00753L,中信中國50正2,51,7,44,元大-大天母,2023-07-20,9893
1786,科妍,46,3,43,元大-大天母,2023-07-20,9893
4123,晟德,116,76,40,元大-大天母,2023-07-20,9893
00929,復華台灣科技優息,214,180,34,元大-大天母,2023-07-20,9893
4746,台耀,47,14,33,元大-大天母,2023-07-20,9893
2812,台中銀,30,0,30,元大-大天母,2023-07-20,9893
3532,台勝科,30,0,30,元大-大天母,2023-07-20,9893
3265,台星科,32,2,30,元大-大天母,2023-07-20,9893
2891,中信金,29,1,28,元大-大天母,2023-07-20,9893
8155,博智,29,3,26,元大-大天母,2023-07-20,9893
3037,欣興,34,8,26,元大-大天母,2023-07-20,9893
1102,亞泥,28,3,25,元大-大天母,2023-07-20,9893
2405,輔信,39,15,24,元大-大天母,2023-07-20,9893
2606,裕民,27,3,24,元大-大天母,2023-07-20,9893
2329,華泰,82,58,24,元大-大天母,2023-07-20,9893
6187,萬潤,26,3,23,元大-大天母,2023-07-20,9893
3581,博磊,25,2,23,元大-大天母,2023-07-20,9893
6196,帆宣,25,4,21,元大-大天母,2023-07-20,9893
2887,台新金,25,4,21,元大-大天母,2023-07-20,9893
2801,彰銀,21,0,21,元大-大天母,2023-07-20,9893
2637,慧洋-KY,20,0,20,元大-大天母,2023-07-20,9893
00772B,中信高評級公司債,20,1,19,元大-大天母,2023-07-20,9893
8050,廣積,21,2,19,元大-大天母,2023-07-20,9893
3346,麗清,47,28,19,元大-大天母,2023-07-20,9893
6161,捷波,21,2,19,元大-大天母,2023-07-20,9893
2482,連宇,18,0,18,元大-大天母,2023-07-20,9893
1514,亞力,23,6,17,元大-大天母,2023-07-20,9893
2317,鴻海,17,1,16,元大-大天母,2023-07-20,9893
1529,樂事綠能,25,9,16,元大-大天母,2023-07-20,9893
2330,台積電,18,3,15,元大-大天母,2023-07-20,9893
3289,宜特,18,3,15,元大-大天母,2023-07-20,9893
00712,復華富時不動產,14,0,14,元大-大天母,2023-07-20,9893
6188,廣明,24,10,14,元大-大天母,2023-07-20,9893
2332,友訊,14,0,14,元大-大天母,2023-07-20,9893
2630,亞航,16,2,14,元大-大天母,2023-07-20,9893
5483,中美晶,14,0,14,元大-大天母,2023-07-20,9893
1227,佳格,13,0,13,元大-大天母,2023-07-20,9893
00919,群益台灣精選高息,14,2,12,元大-大天母,2023-07-20,9893
2337,旺宏,12,0,12,元大-大天母,2023-07-20,9893
3056,富華新,14,2,12,元大-大天母,2023-07-20,9893
6282,康舒,49,37,12,元大-大天母,2023-07-20,9893
1101,台泥,15,4,11,元大-大天母,2023-07-20,9893
1789,神隆,86,75,11,元大-大天母,2023-07-20,9893
4541,晟田,11,0,11,元大-大天母,2023-07-20,9893
6579,研揚,11,0,11,元大-大天母,2023-07-20,9893
6285,啟��,16,5,11,元大-大天母,2023-07-20,9893
6187,萬潤,137,0,137,元大-大天母,2023-07-21,9893
6016,康和證,130,1,129,元大-大天母,2023-07-21,9893
2303,聯電,230,119,111,元大-大天母,2023-07-21,9893
00679B,元大美債20年,107,1,106,元大-大天母,2023-07-21,9893
2382,廣達,167,64,103,元大-大天母,2023-07-21,9893
5347,世界,98,0,98,元大-大天母,2023-07-21,9893
3689,湧德,101,6,95,元大-大天母,2023-07-21,9893
1101,台泥,63,2,61,元大-大天母,2023-07-21,9893
2002,中鋼,69,9,60,元大-大天母,2023-07-21,9893
6245,立端,55,1,54,元大-大天母,2023-07-21,9893
3227,原相,53,0,53,元大-大天母,2023-07-21,9893
6214,精誠,51,2,49,元大-大天母,2023-07-21,9893
2330,台積電,54,6,48,元大-大天母,2023-07-21,9893
00753L,中信中國50正2,52,5,47,元大-大天母,2023-07-21,9893
2609,陽明,77,31,46,元大-大天母,2023-07-21,9893
6679,鈺太,40,0,40,元大-大天母,2023-07-21,9893
1560,中砂,47,8,39,元大-大天母,2023-07-21,9893
1102,亞泥,38,0,38,元大-大天母,2023-07-21,9893
8049,晶采,36,3,33,元大-大天母,2023-07-21,9893
2201,裕隆,35,4,31,元大-大天母,2023-07-21,9893
6213,聯茂,64,33,31,元大-大天母,2023-07-21,9893
2425,承啟,39,10,29,元大-大天母,2023-07-21,9893
2369,菱生,30,1,29,元大-大天母,2023-07-21,9893
6133,金橋,30,1,29,元大-大天母,2023-07-21,9893
2344,華邦電,48,22,26,元大-大天母,2023-07-21,9893
1313,聯成,26,0,26,元大-大天母,2023-07-21,9893
3711,日月光投控,25,0,25,元大-大天母,2023-07-21,9893
9105,泰金寶-DR,30,5,25,元大-大天母,2023-07-21,9893
00680L,元大美債20正2,24,0,24,元大-大天母,2023-07-21,9893
4123,晟德,36,12,24,元大-大天母,2023-07-21,9893
3037,欣興,231,208,23,元大-大天母,2023-07-21,9893
2618,長榮航,31,9,22,元大-大天母,2023-07-21,9893
00929,復華台灣科技優息,23,1,22,元大-大天母,2023-07-21,9893
5340,建榮,27,5,22,元大-大天母,2023-07-21,9893
1612,宏泰,23,2,21,元大-大天母,2023-07-21,9893
1905,華紙,21,0,21,元大-大天母,2023-07-21,9893
2486,一詮,20,0,20,元大-大天母,2023-07-21,9893
00927,群益半導體收益,20,0,20,元大-大天母,2023-07-21,9893
2204,中華,20,0,20,元大-大天母,2023-07-21,9893
6120,達運,22,2,20,元大-大天母,2023-07-21,9893
5425,台半,22,2,20,元大-大天母,2023-07-21,9893
2884,玉山金,23,3,20,元大-大天母,2023-07-21,9893
1513,中興電,125,106,19,元大-大天母,2023-07-21,9893
3078,僑威,23,4,19,元大-大天母,2023-07-21,9893
2027,大成鋼,22,3,19,元大-大天母,2023-07-21,9893
00919,群益台灣精選高息,20,2,18,元大-大天母,2023-07-21,9893
2317,鴻海,19,2,17,元大-大天母,2023-07-21,9893
3709,鑫聯大投控,17,0,17,元大-大天母,2023-07-21,9893
3047,訊舟,17,0,17,元大-大天母,2023-07-21,9893
2633,台灣高鐵,17,0,17,元大-大天母,2023-07-21,9893
1217,愛之味,501,1,500,元大-大天母,2023-07-24,9893
6591,動力-KY,170,7,163,元大-大天母,2023-07-24,9893
1301,台塑,102,0,102,元大-大天母,2023-07-24,9893
3481,群創,104,4,100,元大-大天母,2023-07-24,9893
2534,宏盛,90,6,84,元大-大天母,2023-07-24,9893
2886,兆豐金,71,1,70,元大-大天母,2023-07-24,9893
2885,元大金,68,1,67,元大-大天母,2023-07-24,9893
2461,光群雷,61,9,52,元大-大天母,2023-07-24,9893
3189,景碩,42,0,42,元大-大天母,2023-07-24,9893
2356,英業達,69,28,41,元大-大天母,2023-07-24,9893
4746,台耀,63,23,40,元大-大天母,2023-07-24,9893
4532,瑞智,55,17,38,元大-大天母,2023-07-24,9893
2467,志聖,37,0,37,元大-大天母,2023-07-24,9893
1102,亞泥,33,0,33,元大-大天母,2023-07-24,9893
2367,燿華,32,0,32,元大-大天母,2023-07-24,9893
2891,中信金,38,6,32,元大-大天母,2023-07-24,9893
5347,世界,30,0,30,元大-大天母,2023-07-24,9893
2369,菱生,30,0,30,元大-大天母,2023-07-24,9893
2888,新光金,31,2,29,元大-大天母,2023-07-24,9893
1609,大亞,86,57,29,元大-大天母,2023-07-24,9893
1903,士紙,121,93,28,元大-大天母,2023-07-24,9893
2887,台新金,24,0,24,元大-大天母,2023-07-24,9893
2313,華通,25,2,23,元大-大天母,2023-07-24,9893
6245,立端,23,1,22,元大-大天母,2023-07-24,9893
4977,眾達-KY,21,0,21,元大-大天母,2023-07-24,9893
2323,中環,21,0,21,元大-大天母,2023-07-24,9893
2382,廣達,127,106,21,元大-大天母,2023-07-24,9893
6670,復盛應用,20,0,20,元大-大天母,2023-07-24,9893
2607,榮運,20,0,20,元大-大天母,2023-07-24,9893
1785,光洋科,20,0,20,元大-大天母,2023-07-24,9893
4510,高鋒,20,0,20,元大-大天母,2023-07-24,9893
3653,健策,20,0,20,元大-大天母,2023-07-24,9893
00929,復華台灣科技優息,19,0,19,元大-大天母,2023-07-24,9893
3706,神達,36,18,18,元大-大天母,2023-07-24,9893
2520,冠德,17,0,17,元大-大天母,2023-07-24,9893
6276,安鈦克,16,0,16,元大-大天母,2023-07-24,9893
3338,泰碩,38,22,16,元大-大天母,2023-07-24,9893
2353,宏��,59,44,15,元大-大天母,2023-07-24,9893
1313,聯成,19,4,15,元大-大天母,2023-07-24,9893
2436,偉詮電,15,0,15,元大-大天母,2023-07-24,9893
2201,裕隆,24,9,15,元大-大天母,2023-07-24,9893
00882,中信中國高股息,17,3,14,元大-大天母,2023-07-24,9893
1503,士電,19,6,13,元大-大天母,2023-07-24,9893
2449,京元電子,13,0,13,元大-大天母,2023-07-24,9893
1305,華夏,13,0,13,元大-大天母,2023-07-24,9893
4953,緯軟,20,7,13,元大-大天母,2023-07-24,9893
2327,國巨,15,2,13,元大-大天母,2023-07-24,9893
1513,中興電,57,45,12,元大-大天母,2023-07-24,9893
00881,國泰台灣5G+,12,0,12,元大-大天母,2023-07-24,9893
2882,國泰金,13,1,12,元大-大天母,2023-07-24,9893
00679B,元大美債20年,226,5,221,元大-大天母,2023-07-25,9893
2312,金寶,221,0,221,元大-大天母,2023-07-25,9893
00632R,元大台灣50反1,230,60,170,元大-大天母,2023-07-25,9893
2534,宏盛,140,0,140,元大-大天母,2023-07-25,9893
00878,國泰永續高股息,137,17,120,元大-大天母,2023-07-25,9893
2324,仁寶,158,43,115,元大-大天母,2023-07-25,9893
1710,東聯,100,0,100,元大-大天母,2023-07-25,9893
00772B,中信高評級公司債,102,8,94,元大-大天母,2023-07-25,9893
2002,中鋼,72,5,67,元大-大天母,2023-07-25,9893
2352,佳世達,56,2,54,元大-大天母,2023-07-25,9893
2890,永豐金,51,1,50,元大-大天母,2023-07-25,9893
6239,力成,46,0,46,元大-大天母,2023-07-25,9893
2883,凱基金,55,11,44,元大-大天母,2023-07-25,9893
00720B,元大投資級公司債,46,4,42,元大-大天母,2023-07-25,9893
8011,台通,32,0,32,元大-大天母,2023-07-25,9893
2610,華航,38,9,29,元大-大天母,2023-07-25,9893
6282,康舒,35,7,28,元大-大天母,2023-07-25,9893
4168,醣聯,31,3,28,元大-大天母,2023-07-25,9893
2485,兆赫,27,0,27,元大-大天母,2023-07-25,9893
00700,富邦�琤肭磪�,25,0,25,元大-大天母,2023-07-25,9893
2454,聯發科,24,0,24,元大-大天母,2023-07-25,9893
2337,旺宏,24,0,24,元大-大天母,2023-07-25,9893
00919,群益台灣精選高息,37,15,22,元大-大天母,2023-07-25,9893
3189,景碩,23,1,22,元大-大天母,2023-07-25,9893
4747,強生,21,0,21,元大-大天母,2023-07-25,9893
2344,華邦電,23,2,21,元大-大天母,2023-07-25,9893
6209,今國光,21,0,21,元大-大天母,2023-07-25,9893
6190,萬泰科,20,0,20,元大-大天母,2023-07-25,9893
2387,精元,20,0,20,元大-大天母,2023-07-25,9893
5347,世界,19,0,19,元大-大天母,2023-07-25,9893
3324,雙鴻,19,0,19,元大-大天母,2023-07-25,9893
1609,大亞,25,7,18,元大-大天母,2023-07-25,9893
00673R,期元大S＆P原油反1,18,0,18,元大-大天母,2023-07-25,9893
3044,健鼎,35,17,18,元大-大天母,2023-07-25,9893
00929,復華台灣科技優息,17,0,17,元大-大天母,2023-07-25,9893
2338,光罩,16,0,16,元大-大天母,2023-07-25,9893
1905,華紙,43,27,16,元大-大天母,2023-07-25,9893
6191,精成科,25,9,16,元大-大天母,2023-07-25,9893
2317,鴻海,58,42,16,元大-大天母,2023-07-25,9893
4938,和碩,22,6,16,元大-大天母,2023-07-25,9893
8033,雷虎,15,0,15,元大-大天母,2023-07-25,9893
2316,楠梓電,18,4,14,元大-大天母,2023-07-25,9893
4953,緯軟,20,6,14,元大-大天母,2023-07-25,9893
2609,陽明,20,7,13,元大-大天母,2023-07-25,9893
6104,創惟,14,1,13,元大-大天母,2023-07-25,9893
3024,憶聲,12,0,12,元大-大天母,2023-07-25,9893
1529,樂事綠能,13,1,12,元大-大天母,2023-07-25,9893
6125,廣運,22,11,11,元大-大天母,2023-07-25,9893
6579,研揚,12,1,11,元大-大天母,2023-07-25,9893
3013,晟銘電,16,5,11,元大-大天母,2023-07-25,9893
5457,宣德,295,1,294,元大-大天母,2023-07-26,9893
2301,光寶科,220,25,195,元大-大天母,2023-07-26,9893
2368,金像電,218,27,191,元大-大天母,2023-07-26,9893
00679B,元大美債20年,146,2,144,元大-大天母,2023-07-26,9893
1903,士紙,201,87,114,元大-大天母,2023-07-26,9893
00772B,中信高評級公司債,113,2,111,元大-大天母,2023-07-26,9893
3481,群創,254,150,104,元大-大天母,2023-07-26,9893
5347,世界,101,0,101,元大-大天母,2023-07-26,9893
1504,東元,135,42,93,元大-大天母,2023-07-26,9893
2382,廣達,125,44,81,元大-大天母,2023-07-26,9893
2337,旺宏,52,0,52,元大-大天母,2023-07-26,9893
00929,復華台灣科技優息,49,0,49,元大-大天母,2023-07-26,9893
00753L,中信中國50正2,43,0,43,元大-大天母,2023-07-26,9893
3704,合勤控,41,0,41,元大-大天母,2023-07-26,9893
1609,大亞,54,14,40,元大-大天母,2023-07-26,9893
6190,萬泰科,47,8,39,元大-大天母,2023-07-26,9893
2485,兆赫,39,0,39,元大-大天母,2023-07-26,9893
5609,中菲行,36,0,36,元大-大天母,2023-07-26,9893
4979,華星光,36,0,36,元大-大天母,2023-07-26,9893
2612,中航,35,0,35,元大-大天母,2023-07-26,9893
2062,橋椿,35,0,35,元大-大天母,2023-07-26,9893
1710,東聯,30,0,30,元大-大天母,2023-07-26,9893
8011,台通,29,0,29,元大-大天母,2023-07-26,9893
6239,力成,31,2,29,元大-大天母,2023-07-26,9893
00673R,期元大S＆P原油反1,29,0,29,元大-大天母,2023-07-26,9893
2501,國建,26,0,26,元大-大天母,2023-07-26,9893
4142,國光生,26,0,26,元大-大天母,2023-07-26,9893
2303,聯電,42,17,25,元大-大天母,2023-07-26,9893
4977,眾達-KY,25,0,25,元大-大天母,2023-07-26,9893
2344,華邦電,26,1,25,元大-大天母,2023-07-26,9893
6640,均華,23,0,23,元大-大天母,2023-07-26,9893
3047,訊舟,22,0,22,元大-大天母,2023-07-26,9893
2376,技嘉,49,27,22,元大-大天母,2023-07-26,9893
6117,迎廣,25,3,22,元大-大天母,2023-07-26,9893
6179,亞通,22,0,22,元大-大天母,2023-07-26,9893
4123,晟德,24,3,21,元大-大天母,2023-07-26,9893
00751B,元大AAA至A公司債,21,0,21,元大-大天母,2023-07-26,9893
00633L,富邦上証正2,20,0,20,元大-大天母,2023-07-26,9893
6841,長佳智能,31,11,20,元大-大天母,2023-07-26,9893
2002,中鋼,30,11,19,元大-大天母,2023-07-26,9893
5243,乙盛-KY,20,1,19,元大-大天母,2023-07-26,9893
6438,迅得,20,2,18,元大-大天母,2023-07-26,9893
8358,金居,62,44,18,元大-大天母,2023-07-26,9893
6153,嘉聯益,18,0,18,元大-大天母,2023-07-26,9893
00680L,元大美債20正2,17,0,17,元大-大天母,2023-07-26,9893
1795,美時,27,10,17,元大-大天母,2023-07-26,9893
00927,群益半導體收益,16,0,16,元大-大天母,2023-07-26,9893
6275,元山,17,1,16,元大-大天母,2023-07-26,9893
6426,統新,17,1,16,元大-大天母,2023-07-26,9893
1471,首利,16,0,16,元大-大天母,2023-07-26,9893
1305,華夏,305,10,295,元大-大天母,2023-07-27,9893
2340,台亞,306,15,291,元大-大天母,2023-07-27,9893
1710,東聯,260,7,253,元大-大天母,2023-07-27,9893
2897,王道銀行,200,0,200,元大-大天母,2023-07-27,9893
2534,宏盛,175,0,175,元大-大天母,2023-07-27,9893
6282,康舒,213,95,118,元大-大天母,2023-07-27,9893
00676R,富邦臺灣加權反1,110,0,110,元大-大天母,2023-07-27,9893
00772B,中信高評級公司債,104,0,104,元大-大天母,2023-07-27,9893
1210,大成,105,6,99,元大-大天母,2023-07-27,9893
2891,中信金,108,30,78,元大-大天母,2023-07-27,9893
00715L,期街口布蘭特正2,75,5,70,元大-大天母,2023-07-27,9893
2355,敬鵬,52,0,52,元大-大天母,2023-07-27,9893
8433,弘帆,51,0,51,元大-大天母,2023-07-27,9893
3045,台灣大,50,0,50,元大-大天母,2023-07-27,9893
2881,富邦金,59,15,44,元大-大天母,2023-07-27,9893
00679B,元大美債20年,42,2,40,元大-大天母,2023-07-27,9893
2884,玉山金,41,7,34,元大-大天母,2023-07-27,9893
3037,欣興,90,57,33,元大-大天母,2023-07-27,9893
2353,宏��,37,9,28,元大-大天母,2023-07-27,9893
5425,台半,35,8,27,元大-大天母,2023-07-27,9893
1504,東元,32,6,26,元大-大天母,2023-07-27,9893
2002,中鋼,49,24,25,元大-大天母,2023-07-27,9893
5609,中菲行,25,0,25,元大-大天母,2023-07-27,9893
00929,復華台灣科技優息,22,0,22,元大-大天母,2023-07-27,9893
2425,承啟,30,8,22,元大-大天母,2023-07-27,9893
8926,台汽電,22,1,21,元大-大天母,2023-07-27,9893
2641,正德,20,0,20,元大-大天母,2023-07-27,9893
4533,協易機,30,10,20,元大-大天母,2023-07-27,9893
6188,廣明,48,29,19,元大-大天母,2023-07-27,9893
9904,寶成,20,1,19,元大-大天母,2023-07-27,9893
2887,台新金,29,10,19,元大-大天母,2023-07-27,9893
2354,鴻準,20,1,19,元大-大天母,2023-07-27,9893
8011,台通,18,0,18,元大-大天母,2023-07-27,9893
2609,陽明,33,16,17,元大-大天母,2023-07-27,9893
5880,合庫金,21,4,17,元大-大天母,2023-07-27,9893
3004,豐達科,20,3,17,元大-大天母,2023-07-27,9893
3056,富華新,16,0,16,元大-大天母,2023-07-27,9893
3032,偉訓,17,2,15,元大-大天母,2023-07-27,9893
2812,台中銀,14,0,14,元大-大天母,2023-07-27,9893
6579,研揚,15,1,14,元大-大天母,2023-07-27,9893
00902,中信電池及儲能,19,5,14,元大-大天母,2023-07-27,9893
5234,達興材料,14,0,14,元大-大天母,2023-07-27,9893
2313,華通,13,0,13,元大-大天母,2023-07-27,9893
2301,光寶科,20,7,13,元大-大天母,2023-07-27,9893
00795B,中信美國公債20年,12,0,12,元大-大天母,2023-07-27,9893
00673R,期元大S＆P原油反1,12,0,12,元大-大天母,2023-07-27,9893
3704,合勤控,17,5,12,元大-大天母,2023-07-27,9893
5009,榮剛,12,0,12,元大-大天母,2023-07-27,9893
6015,宏遠證,12,0,12,元大-大天母,2023-07-27,9893
8234,新漢,19,8,11,元大-大天母,2023-07-27,9893
2883,凱基金,446,1,445,元大-大天母,2023-07-28,9893
1710,東聯,424,1,423,元大-大天母,2023-07-28,9893
00679B,元大美債20年,255,2,253,元大-大天母,2023-07-28,9893
2352,佳世達,191,2,189,元大-大天母,2023-07-28,9893
00772B,中信高評級公司債,106,1,105,元大-大天母,2023-07-28,9893
4979,華星光,109,10,99,元大-大天母,2023-07-28,9893
3264,欣銓,98,4,94,元大-大天母,2023-07-28,9893
3163,波若威,113,43,70,元大-大天母,2023-07-28,9893
2002,中鋼,67,0,67,元大-大天母,2023-07-28,9893
2892,第一金,70,4,66,元大-大天母,2023-07-28,9893
8358,金居,91,31,60,元大-大天母,2023-07-28,9893
2618,長榮航,66,8,58,元大-大天母,2023-07-28,9893
2105,正新,53,0,53,元大-大天母,2023-07-28,9893
1905,華紙,106,54,52,元大-大天母,2023-07-28,9893
2605,新興,50,0,50,元大-大天母,2023-07-28,9893
8926,台汽電,46,0,46,元大-大天母,2023-07-28,9893
2705,六福,46,3,43,元大-大天母,2023-07-28,9893
6245,立端,43,1,42,元大-大天母,2023-07-28,9893
2312,金寶,40,0,40,元大-大天母,2023-07-28,9893
3038,全台,56,17,39,元大-大天母,2023-07-28,9893
00720B,元大投資級公司債,37,0,37,元大-大天母,2023-07-28,9893
00680L,元大美債20正2,35,0,35,元大-大天母,2023-07-28,9893
6188,廣明,52,17,35,元大-大天母,2023-07-28,9893
1609,大亞,35,2,33,元大-大天母,2023-07-28,9893
6126,信音,37,4,33,元大-大天母,2023-07-28,9893
00687B,國泰20年美債,31,0,31,元大-大天母,2023-07-28,9893
6168,宏齊,31,0,31,元大-大天母,2023-07-28,9893
00700,富邦�琤肭磪�,29,0,29,元大-大天母,2023-07-28,9893
1802,台玻,29,0,29,元大-大天母,2023-07-28,9893
00751B,元大AAA至A公司債,27,0,27,元大-大天母,2023-07-28,9893
2885,元大金,46,20,26,元大-大天母,2023-07-28,9893
00795B,中信美國公債20年,26,0,26,元大-大天母,2023-07-28,9893
00885,富邦越南,30,5,25,元大-大天母,2023-07-28,9893
2485,兆赫,24,0,24,元大-大天母,2023-07-28,9893
8028,昇陽半導體,25,1,24,元大-大天母,2023-07-28,9893
6116,彩晶,23,0,23,元大-大天母,2023-07-28,9893
3234,光環,23,0,23,元大-大天母,2023-07-28,9893
2062,橋椿,22,0,22,元大-大天母,2023-07-28,9893
3231,緯創,345,323,22,元大-大天母,2023-07-28,9893
3272,東碩,21,0,21,元大-大天母,2023-07-28,9893
2882,國泰金,21,1,20,元大-大天母,2023-07-28,9893
6133,金橋,20,0,20,元大-大天母,2023-07-28,9893
3051,力特,21,1,20,元大-大天母,2023-07-28,9893
2027,大成鋼,28,8,20,元大-大天母,2023-07-28,9893
00905,FT臺灣Smart,20,0,20,元大-大天母,2023-07-28,9893
6239,力成,21,1,20,元大-大天母,2023-07-28,9893
2641,正德,20,0,20,元大-大天母,2023-07-28,9893
2610,華航,34,14,20,元大-大天母,2023-07-28,9893
1727,中華化,17,0,17,元大-大天母,2023-07-28,9893
2888,新光金,71,54,17,元大-大天母,2023-07-28,9893
2312,金寶,753,187,566,元大-大天母,2023-07-31,9893
00637L,元大滬深300正2,527,39,488,元大-大天母,2023-07-31,9893
1710,東聯,441,0,441,元大-大天母,2023-07-31,9893
2301,光寶科,428,154,274,元大-大天母,2023-07-31,9893
1305,華夏,266,1,265,元大-大天母,2023-07-31,9893
2420,新巨,196,3,193,元大-大天母,2023-07-31,9893
00878,國泰永續高股息,205,59,146,元大-大天母,2023-07-31,9893
2609,陽明,128,3,125,元大-大天母,2023-07-31,9893
8011,台通,92,0,92,元大-大天母,2023-07-31,9893
5284,jpp-KY,111,22,89,元大-大天母,2023-07-31,9893
2888,新光金,167,90,77,元大-大天母,2023-07-31,9893
00679B,元大美債20年,73,3,70,元大-大天母,2023-07-31,9893
3711,日月光投控,72,5,67,元大-大天母,2023-07-31,9893
2534,宏盛,65,0,65,元大-大天母,2023-07-31,9893
00700,富邦�琤肭磪�,60,0,60,元大-大天母,2023-07-31,9893
2461,光群雷,52,5,47,元大-大天母,2023-07-31,9893
00885,富邦越南,44,0,44,元大-大天母,2023-07-31,9893
2458,義隆,36,0,36,元大-大天母,2023-07-31,9893
8049,晶采,35,0,35,元大-大天母,2023-07-31,9893
2002,中鋼,71,40,31,元大-大天母,2023-07-31,9893
3264,欣銓,38,9,29,元大-大天母,2023-07-31,9893
2330,台積電,30,1,29,元大-大天母,2023-07-31,9893
2027,大成鋼,29,0,29,元大-大天母,2023-07-31,9893
2303,聯電,44,16,28,元大-大天母,2023-07-31,9893
1319,東陽,44,17,27,元大-大天母,2023-07-31,9893
4979,華星光,34,8,26,元大-大天母,2023-07-31,9893
2412,中華電,25,0,25,元大-大天母,2023-07-31,9893
3092,鴻碩,32,7,25,元大-大天母,2023-07-31,9893
3481,群創,195,171,24,元大-大天母,2023-07-31,9893
6770,力積電,23,2,21,元大-大天母,2023-07-31,9893
00919,群益台灣精選高息,23,2,21,元大-大天母,2023-07-31,9893
6120,達運,23,3,20,元大-大天母,2023-07-31,9893
3438,類比科,20,0,20,元大-大天母,2023-07-31,9893
2641,正德,20,0,20,元大-大天母,2023-07-31,9893
6290,良維,20,0,20,元大-大天母,2023-07-31,9893
8358,金居,44,24,20,元大-大天母,2023-07-31,9893
9941,裕融,22,3,19,元大-大天母,2023-07-31,9893
2356,英業達,30,11,19,元大-大天母,2023-07-31,9893
8433,弘帆,20,1,19,元大-大天母,2023-07-31,9893
2382,廣達,88,69,19,元大-大天母,2023-07-31,9893
00929,復華台灣科技優息,34,15,19,元大-大天母,2023-07-31,9893
1609,大亞,20,2,18,元大-大天母,2023-07-31,9893
2618,長榮航,24,5,19,元大-大天母,2023-07-31,9893
3031,佰鴻,20,2,18,元大-大天母,2023-07-31,9893
00633L,富邦上証正2,50,32,18,元大-大天母,2023-07-31,9893
9945,潤泰新,20,3,17,元大-大天母,2023-07-31,9893
3231,緯創,128,112,16,元大-大天母,2023-07-31,9893
2329,華泰,192,175,17,元大-大天母,2023-07-31,9893
5425,台半,23,7,16,元大-大天母,2023-07-31,9893
1605,華新,17,2,15,元大-大天母,2023-07-31,9893
2352,佳世達,278,42,236,元大-大天母,2023-08-01,9893
6116,彩晶,216,0,216,元大-大天母,2023-08-01,9893
2888,新光金,252,57,195,元大-大天母,2023-08-01,9893
8926,台汽電,85,0,85,元大-大天母,2023-08-01,9893
2913,農林,138,54,84,元大-大天母,2023-08-01,9893
2534,宏盛,60,0,60,元大-大天母,2023-08-01,9893
00885,富邦越南,52,0,52,元大-大天母,2023-08-01,9893
3558,神準,62,10,52,元大-大天母,2023-08-01,9893
4747,強生,48,0,48,元大-大天母,2023-08-01,9893
00673R,期元大S＆P原油反1,46,0,46,元大-大天母,2023-08-01,9893
3032,偉訓,46,5,41,元大-大天母,2023-08-01,9893
00929,復華台灣科技優息,59,19,40,元大-大天母,2023-08-01,9893
2641,正德,40,0,40,元大-大天母,2023-08-01,9893
6282,康舒,90,51,39,元大-大天母,2023-08-01,9893
2377,微星,32,0,32,元大-大天母,2023-08-01,9893
6245,立端,31,0,31,元大-大天母,2023-08-01,9893
00882,中信中國高股息,30,0,30,元大-大天母,2023-08-01,9893
6114,久威,31,1,30,元大-大天母,2023-08-01,9893
2303,聯電,44,17,27,元大-大天母,2023-08-01,9893
8049,晶采,25,0,25,元大-大天母,2023-08-01,9893
5388,中磊,36,12,24,元大-大天母,2023-08-01,9893
2881,富邦金,33,10,23,元大-大天母,2023-08-01,9893
2009,第一銅,27,4,23,元大-大天母,2023-08-01,9893
2312,金寶,29,7,22,元大-大天母,2023-08-01,9893
00752,中信中國50,22,0,22,元大-大天母,2023-08-01,9893
4979,華星光,32,14,18,元大-大天母,2023-08-01,9893
5609,中菲行,21,4,17,元大-大天母,2023-08-01,9893
2344,華邦電,18,1,17,元大-大天母,2023-08-01,9893
2412,中華電,16,0,16,元大-大天母,2023-08-01,9893
6161,捷波,16,0,16,元大-大天母,2023-08-01,9893
3596,智易,14,0,14,元大-大天母,2023-08-01,9893
2313,華通,13,0,13,元大-大天母,2023-08-01,9893
2206,三陽工業,14,1,13,元大-大天母,2023-08-01,9893
3105,穩懋,17,5,12,元大-大天母,2023-08-01,9893
2889,國票金,12,0,12,元大-大天母,2023-08-01,9893
1802,台玻,25,13,12,元大-大天母,2023-08-01,9893
6234,高僑,45,33,12,元大-大天母,2023-08-01,9893
3257,虹冠電,13,1,12,元大-大天母,2023-08-01,9893
2301,光寶科,60,49,11,元大-大天母,2023-08-01,9893
6472,保瑞,12,2,10,元大-大天母,2023-08-01,9893
6670,復盛應用,10,0,10,元大-大天母,2023-08-01,9893
1717,長興,10,0,10,元大-大天母,2023-08-01,9893
2340,台亞,10,0,10,元大-大天母,2023-08-01,9893
1308,亞聚,10,0,10,元大-大天母,2023-08-01,9893
5426,振發,10,0,10,元大-大天母,2023-08-01,9893
4919,新唐,12,3,9,元大-大天母,2023-08-01,9893
3209,全科,9,0,9,元大-大天母,2023-08-01,9893
2455,全新,14,5,9,元大-大天母,2023-08-01,9893
2607,榮運,9,0,9,元大-大天母,2023-08-01,9893
2330,台積電,8,0,8,元大-大天母,2023-08-01,9893
1314,中石化,317,0,317,元大-大天母,2023-08-02,9893
00878,國泰永續高股息,210,18,192,元大-大天母,2023-08-02,9893
00679B,元大美債20年,172,0,172,元大-大天母,2023-08-02,9893
3163,波若威,189,33,156,元大-大天母,2023-08-02,9893
3231,緯創,243,89,154,元大-大天母,2023-08-02,9893
1605,華新,218,65,153,元大-大天母,2023-08-02,9893
00923,群益台ESG低碳50,148,0,148,元大-大天母,2023-08-02,9893
2892,第一金,154,27,127,元大-大天母,2023-08-02,9893
2352,佳世達,125,2,123,元大-大天母,2023-08-02,9893
8926,台汽電,111,0,111,元大-大天母,2023-08-02,9893
00688L,國泰20年美債正2,103,0,103,元大-大天母,2023-08-02,9893
2885,元大金,105,4,101,元大-大天母,2023-08-02,9893
00900,富邦特選高股息30,104,5,99,元大-大天母,2023-08-02,9893
00907,永豐優息存股,94,0,94,元大-大天母,2023-08-02,9893
3481,群創,191,102,89,元大-大天母,2023-08-02,9893
00680L,元大美債20正2,91,10,81,元大-大天母,2023-08-02,9893
2886,兆豐金,95,17,78,元大-大天母,2023-08-02,9893
2301,光寶科,101,27,74,元大-大天母,2023-08-02,9893
0056,元大高股息,98,26,72,元大-大天母,2023-08-02,9893
00687B,國泰20年美債,70,0,70,元大-大天母,2023-08-02,9893
00772B,中信高評級公司債,107,40,67,元大-大天母,2023-08-02,9893
2534,宏盛,65,0,65,元大-大天母,2023-08-02,9893
2382,廣達,100,39,61,元大-大天母,2023-08-02,9893
00673R,期元大S＆P原油反1,85,25,60,元大-大天母,2023-08-02,9893
2323,中環,62,2,60,元大-大天母,2023-08-02,9893
6443,元晶,51,0,51,元大-大天母,2023-08-02,9893
6168,宏齊,50,0,50,元大-大天母,2023-08-02,9893
2515,中工,50,0,50,元大-大天母,2023-08-02,9893
5425,台半,52,4,48,元大-大天母,2023-08-02,9893
00929,復華台灣科技優息,48,4,44,元大-大天母,2023-08-02,9893
00720B,元大投資級公司債,44,0,44,元大-大天母,2023-08-02,9893
3711,日月光投控,44,1,43,元大-大天母,2023-08-02,9893
00751B,元大AAA至A公司債,42,0,42,元大-大天母,2023-08-02,9893
2618,長榮航,77,36,41,元大-大天母,2023-08-02,9893
6153,嘉聯益,41,0,41,元大-大天母,2023-08-02,9893
1905,華紙,82,42,40,元大-大天母,2023-08-02,9893
00753L,中信中國50正2,48,9,39,元大-大天母,2023-08-02,9893
4919,新唐,37,0,37,元大-大天母,2023-08-02,9893
2882,國泰金,38,2,36,元大-大天母,2023-08-02,9893
8050,廣積,38,3,35,元大-大天母,2023-08-02,9893
1785,光洋科,77,43,34,元大-大天母,2023-08-02,9893
3038,全台,30,0,30,元大-大天母,2023-08-02,9893
3264,欣銓,43,13,30,元大-大天母,2023-08-02,9893
00633L,富邦上証正2,31,1,30,元大-大天母,2023-08-02,9893
4977,眾達-KY,30,0,30,元大-大天母,2023-08-02,9893
00897,富邦基因免疫生技,30,0,30,元大-大天母,2023-08-02,9893
2498,宏達電,35,6,29,元大-大天母,2023-08-02,9893
4142,國光生,37,11,26,元大-大天母,2023-08-02,9893
5452,佶優,25,0,25,元大-大天母,2023-08-02,9893
2344,華邦電,36,11,25,元大-大天母,2023-08-02,9893
00679B,元大美債20年,282,4,278,元大-大天母,2023-08-04,9893
00878,國泰永續高股息,245,34,211,元大-大天母,2023-08-04,9893
00680L,元大美債20正2,209,0,209,元大-大天母,2023-08-04,9893
2449,京元電子,206,4,202,元大-大天母,2023-08-04,9893
6187,萬潤,206,5,201,元大-大天母,2023-08-04,9893
00671R,富邦NASDAQ反1,200,0,200,元大-大天母,2023-08-04,9893
00687B,國泰20年美債,190,0,190,元大-大天母,2023-08-04,9893
2352,佳世達,159,16,143,元大-大天母,2023-08-04,9893
00751B,元大AAA至A公司債,129,0,129,元大-大天母,2023-08-04,9893
2913,農林,200,71,129,元大-大天母,2023-08-04,9893
00795B,中信美國公債20年,119,0,119,元大-大天母,2023-08-04,9893
2891,中信金,137,40,97,元大-大天母,2023-08-04,9893
2888,新光金,79,0,79,元大-大天母,2023-08-04,9893
1605,華新,99,38,61,元大-大天母,2023-08-04,9893
00720B,元大投資級公司債,60,0,60,元大-大天母,2023-08-04,9893
00673R,期元大S＆P原油反1,57,0,57,元大-大天母,2023-08-04,9893
00772B,中信高評級公司債,54,0,54,元大-大天母,2023-08-04,9893
00688L,國泰20年美債正2,53,0,53,元大-大天母,2023-08-04,9893
2344,華邦電,76,38,38,元大-大天母,2023-08-04,9893
2886,兆豐金,43,6,37,元大-大天母,2023-08-04,9893
8215,明基材,35,2,33,元大-大天母,2023-08-04,9893
00900,富邦特選高股息30,34,1,33,元大-大天母,2023-08-04,9893
2002,中鋼,32,0,32,元大-大天母,2023-08-04,9893
2330,台積電,31,1,30,元大-大天母,2023-08-04,9893
1711,永光,30,0,30,元大-大天母,2023-08-04,9893
8049,晶采,30,0,30,元大-大天母,2023-08-04,9893
00929,復華台灣科技優息,31,3,28,元大-大天母,2023-08-04,9893
2545,皇翔,26,0,26,元大-大天母,2023-08-04,9893
1210,大成,27,1,26,元大-大天母,2023-08-04,9893
1903,士紙,49,24,25,元大-大天母,2023-08-04,9893
00907,永豐優息存股,29,4,25,元大-大天母,2023-08-04,9893
6561,是方,22,0,22,元大-大天母,2023-08-04,9893
00764B,群益25年美債,20,0,20,元大-大天母,2023-08-04,9893
6153,嘉聯益,20,0,20,元大-大天母,2023-08-04,9893
5432,新門,21,1,20,元大-大天母,2023-08-04,9893
3021,鴻名,20,0,20,元大-大天母,2023-08-04,9893
2471,資通,20,0,20,元大-大天母,2023-08-04,9893
3356,奇偶,20,0,20,元大-大天母,2023-08-04,9893
3264,欣銓,31,15,16,元大-大天母,2023-08-04,9893
5371,中光電,32,17,15,元大-大天母,2023-08-04,9893
5871,中租-KY,14,1,13,元大-大天母,2023-08-04,9893
4746,台耀,16,3,13,元大-大天母,2023-08-04,9893
1305,華夏,13,0,13,元大-大天母,2023-08-04,9893
8028,昇陽半導體,16,3,13,元大-大天母,2023-08-04,9893
00715L,期街口布蘭特正2,21,8,13,元大-大天母,2023-08-04,9893
3481,群創,87,74,13,元大-大天母,2023-08-04,9893
2206,三陽工業,14,2,12,元大-大天母,2023-08-04,9893
00923,群益台ESG低碳50,12,0,12,元大-大天母,2023-08-04,9893
3653,健策,12,0,12,元大-大天母,2023-08-04,9893
2455,全新,23,11,12,元大-大天母,2023-08-04,9893
00931B,統一美債20年,219,0,219,元大-大天母,2023-08-07,9893
00929,復華台灣科技優息,315,110,205,元大-大天母,2023-08-07,9893
1210,大成,201,0,201,元大-大天母,2023-08-07,9893
3032,偉訓,294,97,197,元大-大天母,2023-08-07,9893
4960,誠美材,183,0,183,元大-大天母,2023-08-07,9893
5880,合庫金,164,2,162,元大-大天母,2023-08-07,9893
3017,奇鋐,151,4,147,元大-大天母,2023-08-07,9893
2892,第一金,131,23,108,元大-大天母,2023-08-07,9893
00632R,元大台灣50反1,95,0,95,元大-大天母,2023-08-07,9893
3090,日電貿,70,1,69,元大-大天母,2023-08-07,9893
00753L,中信中國50正2,69,3,66,元大-大天母,2023-08-07,9893
2913,農林,67,9,58,元大-大天母,2023-08-07,9893
2890,永豐金,59,5,54,元大-大天母,2023-08-07,9893
2618,長榮航,63,18,45,元大-大天母,2023-08-07,9893
00720B,元大投資級公司債,42,0,42,元大-大天母,2023-08-07,9893
2610,華航,46,9,37,元大-大天母,2023-08-07,9893
00673R,期元大S＆P原油反1,37,0,37,元大-大天母,2023-08-07,9893
2329,華泰,45,10,35,元大-大天母,2023-08-07,9893
3056,富華新,36,5,31,元大-大天母,2023-08-07,9893
3323,加百裕,31,2,29,元大-大天母,2023-08-07,9893
2312,金寶,29,1,28,元大-大天母,2023-08-07,9893
1904,正隆,29,3,26,元大-大天母,2023-08-07,9893
2409,友達,33,8,25,元大-大天母,2023-08-07,9893
3715,定穎投控,38,13,25,元大-大天母,2023-08-07,9893
8926,台汽電,24,2,22,元大-大天母,2023-08-07,9893
2891,中信金,25,4,21,元大-大天母,2023-08-07,9893
00637L,元大滬深300正2,33,13,20,元大-大天母,2023-08-07,9893
2545,皇翔,19,0,19,元大-大天母,2023-08-07,9893
5371,中光電,30,11,19,元大-大天母,2023-08-07,9893
1609,大亞,28,10,18,元大-大天母,2023-08-07,9893
00715L,期街口布蘭特正2,20,3,17,元大-大天母,2023-08-07,9893
00687B,國泰20年美債,30,15,15,元大-大天母,2023-08-07,9893
00633L,富邦上証正2,15,0,15,元大-大天母,2023-08-07,9893
00751B,元大AAA至A公司債,15,0,15,元大-大天母,2023-08-07,9893
8033,雷虎,15,0,15,元大-大天母,2023-08-07,9893
2352,佳世達,22,8,14,元大-大天母,2023-08-07,9893
8034,榮群,15,1,14,元大-大天母,2023-08-07,9893
2609,陽明,25,12,13,元大-大天母,2023-08-07,9893
4953,緯軟,13,1,12,元大-大天母,2023-08-07,9893
2881,富邦金,13,1,12,元大-大天母,2023-08-07,9893
2344,華邦電,29,17,12,元大-大天母,2023-08-07,9893
6223,旺矽,17,5,12,元大-大天母,2023-08-07,9893
3044,健鼎,15,3,12,元大-大天母,2023-08-07,9893
1216,統一,12,1,11,元大-大天母,2023-08-07,9893
8289,泰藝,11,0,11,元大-大天母,2023-08-07,9893
00795B,中信美國公債20年,11,0,11,元大-大天母,2023-08-07,9893
00923,群益台ESG低碳50,13,2,11,元大-大天母,2023-08-07,9893
4747,強生,10,0,10,元大-大天母,2023-08-07,9893
2530,華建,10,0,10,元大-大天母,2023-08-07,9893
8163,達方,10,0,10,元大-大天母,2023-08-07,9893
00665L,富邦�琤肭磪囓�2,201,1,200,元大-大天母,2023-08-08,9893
00900,富邦特選高股息30,141,2,139,元大-大天母,2023-08-08,9893
2891,中信金,132,22,110,元大-大天母,2023-08-08,9893
00931B,統一美債20年,109,0,109,元大-大天母,2023-08-08,9893
00929,復華台灣科技優息,113,14,99,元大-大天母,2023-08-08,9893
3231,緯創,273,184,89,元大-大天母,2023-08-08,9893
2886,兆豐金,87,3,84,元大-大天母,2023-08-08,9893
00753L,中信中國50正2,75,0,75,元大-大天母,2023-08-08,9893
2356,英業達,155,85,70,元大-大天母,2023-08-08,9893
2892,第一金,79,9,70,元大-大天母,2023-08-08,9893
3056,富華新,71,6,65,元大-大天母,2023-08-08,9893
2913,農林,67,12,55,元大-大天母,2023-08-08,9893
8926,台汽電,56,1,55,元大-大天母,2023-08-08,9893
2883,凱基金,63,9,54,元大-大天母,2023-08-08,9893
5347,世界,50,0,50,元大-大天母,2023-08-08,9893
2890,永豐金,48,2,46,元大-大天母,2023-08-08,9893
6153,嘉聯益,44,0,44,元大-大天母,2023-08-08,9893
3363,上詮,66,25,41,元大-大天母,2023-08-08,9893
2376,技嘉,51,11,40,元大-大天母,2023-08-08,9893
2454,聯發科,35,1,34,元大-大天母,2023-08-08,9893
4747,強生,42,9,33,元大-大天母,2023-08-08,9893
3706,神達,41,9,32,元大-大天母,2023-08-08,9893
00751B,元大AAA至A公司債,31,0,31,元大-大天母,2023-08-08,9893
2382,廣達,226,195,31,元大-大天母,2023-08-08,9893
2630,亞航,31,0,31,元大-大天母,2023-08-08,9893
1215,卜蜂,30,0,30,元大-大天母,2023-08-08,9893
4973,廣穎,30,0,30,元大-大天母,2023-08-08,9893
2303,聯電,55,28,27,元大-大天母,2023-08-08,9893
3045,台灣大,27,0,27,元大-大天母,2023-08-08,9893
1795,美時,26,1,25,元大-大天母,2023-08-08,9893
2609,陽明,27,2,25,元大-大天母,2023-08-08,9893
2301,光寶科,52,28,24,元大-大天母,2023-08-08,9893
3013,晟銘電,28,4,24,元大-大天母,2023-08-08,9893
1217,愛之味,22,0,22,元大-大天母,2023-08-08,9893
4977,眾達-KY,21,0,21,元大-大天母,2023-08-08,9893
2329,華泰,36,15,21,元大-大天母,2023-08-08,9893
1447,力鵬,20,0,20,元大-大天母,2023-08-08,9893
00679B,元大美債20年,19,1,18,元大-大天母,2023-08-08,9893
8027,鈦昇,21,3,18,元大-大天母,2023-08-08,9893
6207,雷科,18,1,17,元大-大天母,2023-08-08,9893
1609,大亞,48,32,16,元大-大天母,2023-08-08,9893
5483,中美晶,16,0,16,元大-大天母,2023-08-08,9893
2344,華邦電,31,15,16,元大-大天母,2023-08-08,9893
00923,群益台ESG低碳50,17,1,16,元大-大天母,2023-08-08,9893
00927,群益半導體收益,15,0,15,元大-大天母,2023-08-08,9893
00701,國泰股利精選30,15,0,15,元大-大天母,2023-08-08,9893
5880,合庫金,13,0,13,元大-大天母,2023-08-08,9893
00885,富邦越南,27,14,13,元大-大天母,2023-08-08,9893
0050,元大台灣50,13,0,13,元大-大天母,2023-08-08,9893
00719B,元大美債1-3,13,1,12,元大-大天母,2023-08-08,9893
1802,台玻,565,15,550,元大-大天母,2023-08-09,9893
2363,矽統,515,54,461,元大-大天母,2023-08-09,9893
6418,詠昇,363,0,363,元大-大天母,2023-08-09,9893
00931B,統一美債20年,165,3,162,元大-大天母,2023-08-09,9893
00929,復華台灣科技優息,121,0,121,元大-大天母,2023-08-09,9893
3231,緯創,185,79,106,元大-大天母,2023-08-09,9893
00665L,富邦�琤肭磪囓�2,100,0,100,元大-大天母,2023-08-09,9893
00671R,富邦NASDAQ反1,100,0,100,元大-大天母,2023-08-09,9893
2303,聯電,89,4,85,元大-大天母,2023-08-09,9893
4960,誠美材,100,16,84,元大-大天母,2023-08-09,9893
2316,楠梓電,84,3,81,元大-大天母,2023-08-09,9893
00900,富邦特選高股息30,78,5,73,元大-大天母,2023-08-09,9893
8926,台汽電,72,0,72,元大-大天母,2023-08-09,9893
2891,中信金,72,3,69,元大-大天母,2023-08-09,9893
1210,大成,54,0,54,元大-大天母,2023-08-09,9893
00878,國泰永續高股息,64,12,52,元大-大天母,2023-08-09,9893
3481,群創,82,30,52,元大-大天母,2023-08-09,9893
4973,廣穎,50,0,50,元大-大天母,2023-08-09,9893
2886,兆豐金,60,12,48,元大-大天母,2023-08-09,9893
00885,富邦越南,48,1,47,元大-大天母,2023-08-09,9893
2449,京元電子,43,3,40,元大-大天母,2023-08-09,9893
2890,永豐金,38,2,36,元大-大天母,2023-08-09,9893
6026,福邦證,35,0,35,元大-大天母,2023-08-09,9893
3047,訊舟,34,0,34,元大-大天母,2023-08-09,9893
3630,新鉅科,35,3,32,元大-大天母,2023-08-09,9893
2409,友達,51,19,32,元大-大天母,2023-08-09,9893
3038,全台,31,0,31,元大-大天母,2023-08-09,9893
3532,台勝科,30,0,30,元大-大天母,2023-08-09,9893
2022,聚亨,30,0,30,元大-大天母,2023-08-09,9893
00720B,元大投資級公司債,33,5,28,元大-大天母,2023-08-09,9893
2534,宏盛,26,0,26,元大-大天母,2023-08-09,9893
4906,正文,28,3,25,元大-大天母,2023-08-09,9893
5880,合庫金,23,0,23,元大-大天母,2023-08-09,9893
4977,眾達-KY,23,1,22,元大-大天母,2023-08-09,9893
3715,定穎投控,26,5,21,元大-大天母,2023-08-09,9893
6168,宏齊,21,0,21,元大-大天母,2023-08-09,9893
2493,揚博,20,0,20,元大-大天母,2023-08-09,9893
00680L,元大美債20正2,24,4,20,元大-大天母,2023-08-09,9893
5347,世界,20,0,20,元大-大天母,2023-08-09,9893
1605,華新,20,3,17,元大-大天母,2023-08-09,9893
00919,群益台灣精選高息,15,0,15,元大-大天母,2023-08-09,9893
2357,華碩,26,12,14,元大-大天母,2023-08-09,9893
1609,大亞,36,22,14,元大-大天母,2023-08-09,9893
6016,康和證,14,0,14,元大-大天母,2023-08-09,9893
00679B,元大美債20年,16,3,13,元大-大天母,2023-08-09,9893
2634,漢翔,25,12,13,元大-大天母,2023-08-09,9893
8050,廣積,14,1,13,元大-大天母,2023-08-09,9893
1513,中興電,26,14,12,元大-大天母,2023-08-09,9893
6153,嘉聯益,12,0,12,元大-大天母,2023-08-09,9893
1717,長興,11,0,11,元大-大天母,2023-08-09,9893
2363,矽統,809,9,800,元大-大天母,2023-08-10,9893
1802,台玻,423,48,375,元大-大天母,2023-08-10,9893
2891,中信金,370,102,268,元大-大天母,2023-08-10,9893
6418,詠昇,256,8,248,元大-大天母,2023-08-10,9893
3481,群創,233,6,227,元大-大天母,2023-08-10,9893
00929,復華台灣科技優息,223,1,222,元大-大天母,2023-08-10,9893
00878,國泰永續高股息,143,33,110,元大-大天母,2023-08-10,9893
1305,華夏,105,1,104,元大-大天母,2023-08-10,9893
00671R,富邦NASDAQ反1,100,0,100,元大-大天母,2023-08-10,9893
3231,緯創,292,196,96,元大-大天母,2023-08-10,9893
00900,富邦特選高股息30,101,9,92,元大-大天母,2023-08-10,9893
4960,誠美材,80,1,79,元大-大天母,2023-08-10,9893
0056,元大高股息,82,11,71,元大-大天母,2023-08-10,9893
00706L,期元大S＆P日圓正2,70,0,70,元大-大天母,2023-08-10,9893
1217,愛之味,72,3,69,元大-大天母,2023-08-10,9893
6026,福邦證,67,0,67,元大-大天母,2023-08-10,9893
00751B,元大AAA至A公司債,63,0,63,元大-大天母,2023-08-10,9893
2534,宏盛,62,0,62,元大-大天母,2023-08-10,9893
2888,新光金,86,24,62,元大-大天母,2023-08-10,9893
5426,振發,60,0,60,元大-大天母,2023-08-10,9893
2610,華航,80,30,50,元大-大天母,2023-08-10,9893
2467,志聖,49,0,49,元大-大天母,2023-08-10,9893
2002,中鋼,56,8,48,元大-大天母,2023-08-10,9893
6245,立端,42,0,42,元大-大天母,2023-08-10,9893
2409,友達,41,0,41,元大-大天母,2023-08-10,9893
2855,統一證,40,1,39,元大-大天母,2023-08-10,9893
00722B,群益投資級電信債,35,0,35,元大-大天母,2023-08-10,9893
2312,金寶,39,5,34,元大-大天母,2023-08-10,9893
00931B,統一美債20年,36,2,34,元大-大天母,2023-08-10,9893
5009,榮剛,34,0,34,元大-大天母,2023-08-10,9893
00673R,期元大S＆P原油反1,33,0,33,元大-大天母,2023-08-10,9893
2886,兆豐金,34,3,31,元大-大天母,2023-08-10,9893
5607,遠雄港,31,0,31,元大-大天母,2023-08-10,9893
8996,高力,43,13,30,元大-大天母,2023-08-10,9893
5347,世界,30,0,30,元大-大天母,2023-08-10,9893
00923,群益台ESG低碳50,30,0,30,元大-大天母,2023-08-10,9893
00753L,中信中國50正2,29,0,29,元大-大天母,2023-08-10,9893
2516,新建,30,2,28,元大-大天母,2023-08-10,9893
4906,正文,29,2,27,元大-大天母,2023-08-10,9893
1447,力鵬,25,0,25,元大-大天母,2023-08-10,9893
3356,奇偶,26,1,25,元大-大天母,2023-08-10,9893
1905,華紙,27,3,24,元大-大天母,2023-08-10,9893
1708,東鹼,24,0,24,元大-大天母,2023-08-10,9893
6432,今展科,23,0,23,元大-大天母,2023-08-10,9893
2340,台亞,23,0,23,元大-大天母,2023-08-10,9893
3038,全台,22,1,21,元大-大天母,2023-08-10,9893
4977,眾達-KY,23,2,21,元大-大天母,2023-08-10,9893
1201,味全,20,0,20,元大-大天母,2023-08-10,9893
3037,欣興,27,7,20,元大-大天母,2023-08-10,9893
3045,台灣大,20,1,19,元大-大天母,2023-08-10,9893
2891,中信金,399,2,397,元大-大天母,2023-08-11,9893
00931B,統一美債20年,173,0,173,元大-大天母,2023-08-11,9893
2834,臺企銀,132,0,132,元大-大天母,2023-08-11,9893
00688L,國泰20年美債正2,104,0,104,元大-大天母,2023-08-11,9893
3481,群創,148,48,100,元大-大天母,2023-08-11,9893
5347,世界,80,0,80,元大-大天母,2023-08-11,9893
00929,復華台灣科技優息,75,2,73,元大-大天母,2023-08-11,9893
2382,廣達,407,345,62,元大-大天母,2023-08-11,9893
00900,富邦特選高股息30,50,2,48,元大-大天母,2023-08-11,9893
2618,長榮航,107,63,44,元大-大天母,2023-08-11,9893
00655L,國泰中國A50正2,40,0,40,元大-大天母,2023-08-11,9893
8926,台汽電,37,3,34,元大-大天母,2023-08-11,9893
00923,群益台ESG低碳50,35,1,34,元大-大天母,2023-08-11,9893
2345,智邦,36,3,33,元大-大天母,2023-08-11,9893
2888,新光金,83,50,33,元大-大天母,2023-08-11,9893
2609,陽明,33,1,32,元大-大天母,2023-08-11,9893
00679B,元大美債20年,32,0,32,元大-大天母,2023-08-11,9893
2363,矽統,49,19,30,元大-大天母,2023-08-11,9893
1101,台泥,46,16,30,元大-大天母,2023-08-11,9893
2409,友達,28,1,27,元大-大天母,2023-08-11,9893
2356,英業達,43,15,28,元大-大天母,2023-08-11,9893
00751B,元大AAA至A公司債,25,0,25,元大-大天母,2023-08-11,9893
2881,富邦金,30,5,25,元大-大天母,2023-08-11,9893
6026,福邦證,25,0,25,元大-大天母,2023-08-11,9893
2913,農林,27,3,24,元大-大天母,2023-08-11,9893
00680L,元大美債20正2,24,0,24,元大-大天母,2023-08-11,9893
6116,彩晶,24,0,24,元大-大天母,2023-08-11,9893
2317,鴻海,24,1,23,元大-大天母,2023-08-11,9893
2801,彰銀,23,0,23,元大-大天母,2023-08-11,9893
2002,中鋼,25,2,23,元大-大天母,2023-08-11,9893
2344,華邦電,38,15,23,元大-大天母,2023-08-11,9893
2516,新建,23,0,23,元大-大天母,2023-08-11,9893
3231,緯創,82,59,23,元大-大天母,2023-08-11,9893
2886,兆豐金,25,3,22,元大-大天母,2023-08-11,9893
2352,佳世達,33,12,21,元大-大天母,2023-08-11,9893
4414,如興,20,0,20,元大-大天母,2023-08-11,9893
00752,中信中國50,20,0,20,元大-大天母,2023-08-11,9893
5432,新門,21,1,20,元大-大天母,2023-08-11,9893
2467,志聖,20,0,20,元大-大天母,2023-08-11,9893
8234,新漢,21,1,20,元大-大天母,2023-08-11,9893
2204,中華,18,0,18,元大-大天母,2023-08-11,9893
2440,太空梭,16,0,16,元大-大天母,2023-08-11,9893
2206,三陽工業,17,2,15,元大-大天母,2023-08-11,9893
2022,聚亨,15,0,15,元大-大天母,2023-08-11,9893
8942,森鉅,16,1,15,元大-大天母,2023-08-11,9893
2882,國泰金,16,1,15,元大-大天母,2023-08-11,9893
2330,台積電,19,4,15,元大-大天母,2023-08-11,9893
00919,群益台灣精選高息,14,0,14,元大-大天母,2023-08-11,9893
5607,遠雄港,15,1,14,元大-大天母,2023-08-11,9893
00922,國泰台灣領袖50,13,0,13,元大-大天母,2023-08-11,9893
2002,中鋼,167,0,167,元大-大天母,2023-08-14,9893
00900,富邦特選高股息30,154,1,153,元大-大天母,2023-08-14,9893
00929,復華台灣科技優息,141,0,141,元大-大天母,2023-08-14,9893
1305,華夏,92,0,92,元大-大天母,2023-08-14,9893
2610,華航,78,17,61,元大-大天母,2023-08-14,9893
00680L,元大美債20正2,60,0,60,元大-大天母,2023-08-14,9893
5347,世界,60,0,60,元大-大天母,2023-08-14,9893
1708,東鹼,57,0,57,元大-大天母,2023-08-14,9893
00665L,富邦�琤肭磪囓�2,55,0,55,元大-大天母,2023-08-14,9893
00931B,統一美債20年,61,10,51,元大-大天母,2023-08-14,9893
3005,神基,51,0,51,元大-大天母,2023-08-14,9893
00878,國泰永續高股息,97,47,50,元大-大天母,2023-08-14,9893
00706L,期元大S＆P日圓正2,50,0,50,元大-大天母,2023-08-14,9893
2609,陽明,65,15,50,元大-大天母,2023-08-14,9893
00671R,富邦NASDAQ反1,50,0,50,元大-大天母,2023-08-14,9893
3037,欣興,57,8,49,元大-大天母,2023-08-14,9893
1711,永光,50,3,47,元大-大天母,2023-08-14,9893
3056,富華新,47,1,46,元大-大天母,2023-08-14,9893
6203,海韻電,45,0,45,元大-大天母,2023-08-14,9893
2618,長榮航,63,19,44,元大-大天母,2023-08-14,9893
00885,富邦越南,47,9,38,元大-大天母,2023-08-14,9893
2890,永豐金,40,3,37,元大-大天母,2023-08-14,9893
6026,福邦證,31,0,31,元大-大天母,2023-08-14,9893
00633L,富邦上証正2,51,20,31,元大-大天母,2023-08-14,9893
2401,凌陽,34,3,31,元大-大天母,2023-08-14,9893
1447,力鵬,30,0,30,元大-大天母,2023-08-14,9893
2515,中工,40,10,30,元大-大天母,2023-08-14,9893
6668,中揚光,31,1,30,元大-大天母,2023-08-14,9893
00650L,復華香港正2,30,0,30,元大-大天母,2023-08-14,9893
2344,華邦電,63,34,29,元大-大天母,2023-08-14,9893
3045,台灣大,28,0,28,元大-大天母,2023-08-14,9893
2913,農林,27,0,27,元大-大天母,2023-08-14,9893
00882,中信中國高股息,31,6,25,元大-大天母,2023-08-14,9893
3714,富采,33,9,24,元大-大天母,2023-08-14,9893
2323,中環,28,5,23,元大-大天母,2023-08-14,9893
3703,欣陸,23,0,23,元大-大天母,2023-08-14,9893
3711,日月光投控,24,1,23,元大-大天母,2023-08-14,9893
3231,緯創,60,38,22,元大-大天母,2023-08-14,9893
2312,金寶,22,0,22,元大-大天母,2023-08-14,9893
00753L,中信中國50正2,26,5,21,元大-大天母,2023-08-14,9893
1785,光洋科,20,0,20,元大-大天母,2023-08-14,9893
2891,中信金,45,26,19,元大-大天母,2023-08-14,9893
8234,新漢,19,0,19,元大-大天母,2023-08-14,9893
4737,華廣,18,0,18,元大-大天母,2023-08-14,9893
3078,僑威,32,14,18,元大-大天母,2023-08-14,9893
2330,台積電,18,2,16,元大-大天母,2023-08-14,9893
4123,晟德,37,21,16,元大-大天母,2023-08-14,9893
00679B,元大美債20年,18,2,16,元大-大天母,2023-08-14,9893
2206,三陽工業,41,26,15,元大-大天母,2023-08-14,9893
2748,雲品,15,1,14,元大-大天母,2023-08-14,9893
2376,技嘉,318,21,297,元大-大天母,2023-08-15,9893
2382,廣達,348,57,291,元大-大天母,2023-08-15,9893
00923,群益台ESG低碳50,117,0,117,元大-大天母,2023-08-15,9893
00900,富邦特選高股息30,109,4,105,元大-大天母,2023-08-15,9893
6188,廣明,120,16,104,元大-大天母,2023-08-15,9893
00929,復華台灣科技優息,97,5,92,元大-大天母,2023-08-15,9893
00931B,統一美債20年,80,0,80,元大-大天母,2023-08-15,9893
00878,國泰永續高股息,167,91,76,元大-大天母,2023-08-15,9893
2892,第一金,66,3,63,元大-大天母,2023-08-15,9893
00894,中信小資高價30,60,0,60,元大-大天母,2023-08-15,9893
00632R,元大台灣50反1,70,12,58,元大-大天母,2023-08-15,9893
1802,台玻,51,1,50,元大-大天母,2023-08-15,9893
00706L,期元大S＆P日圓正2,50,0,50,元大-大天母,2023-08-15,9893
2352,佳世達,42,1,41,元大-大天母,2023-08-15,9893
2886,兆豐金,45,4,41,元大-大天母,2023-08-15,9893
2881,富邦金,35,2,33,元大-大天母,2023-08-15,9893
2002,中鋼,39,6,33,元大-大天母,2023-08-15,9893
2317,鴻海,52,22,30,元大-大天母,2023-08-15,9893
00720B,元大投資級公司債,27,0,27,元大-大天母,2023-08-15,9893
2887,台新金,25,0,25,元大-大天母,2023-08-15,9893
00772B,中信高評級公司債,23,0,23,元大-大天母,2023-08-15,9893
3205,佰研,21,0,21,元大-大天母,2023-08-15,9893
6191,精成科,26,6,20,元大-大天母,2023-08-15,9893
00881,國泰台灣5G+,20,0,20,元大-大天母,2023-08-15,9893
1217,愛之味,20,0,20,元大-大天母,2023-08-15,9893
1305,華夏,17,0,17,元大-大天母,2023-08-15,9893
6005,群益證,15,0,15,元大-大天母,2023-08-15,9893
3714,富采,18,3,15,元大-大天母,2023-08-15,9893
00680L,元大美債20正2,20,5,15,元大-大天母,2023-08-15,9893
00637L,元大滬深300正2,52,38,14,元大-大天母,2023-08-15,9893
00679B,元大美債20年,14,0,14,元大-大天母,2023-08-15,9893
6116,彩晶,13,0,13,元大-大天母,2023-08-15,9893
1785,光洋科,13,0,13,元大-大天母,2023-08-15,9893
1102,亞泥,12,0,12,元大-大天母,2023-08-15,9893
1905,華紙,12,0,12,元大-大天母,2023-08-15,9893
00857B,永豐20年美公債,12,0,12,元大-大天母,2023-08-15,9893
1709,和益,12,0,12,元大-大天母,2023-08-15,9893
6213,聯茂,25,13,12,元大-大天母,2023-08-15,9893
2618,長榮航,52,41,11,元大-大天母,2023-08-15,9893
1216,統一,11,0,11,元大-大天母,2023-08-15,9893
2345,智邦,12,1,11,元大-大天母,2023-08-15,9893
2420,新巨,11,0,11,元大-大天母,2023-08-15,9893
2230,泰茂,12,2,10,元大-大天母,2023-08-15,9893
3653,健策,21,11,10,元大-大天母,2023-08-15,9893
5347,世界,10,0,10,元大-大天母,2023-08-15,9893
3045,台灣大,10,0,10,元大-大天母,2023-08-15,9893
1532,勤美,10,0,10,元大-大天母,2023-08-15,9893
00738U,期元大道瓊白銀,10,0,10,元大-大天母,2023-08-15,9893
2634,漢翔,13,3,10,元大-大天母,2023-08-15,9893
4973,廣穎,10,0,10,元大-大天母,2023-08-15,9893
1305,華夏,461,0,461,元大-大天母,2023-08-16,9893
2329,華泰,256,80,176,元大-大天母,2023-08-16,9893
1301,台塑,114,0,114,元大-大天母,2023-08-16,9893
2891,中信金,125,15,110,元大-大天母,2023-08-16,9893
6116,彩晶,102,0,102,元大-大天母,2023-08-16,9893
2324,仁寶,131,42,89,元大-大天母,2023-08-16,9893
2303,聯電,82,7,75,元大-大天母,2023-08-16,9893
00878,國泰永續高股息,85,16,69,元大-大天母,2023-08-16,9893
3030,德律,68,0,68,元大-大天母,2023-08-16,9893
2002,中鋼,64,0,64,元大-大天母,2023-08-16,9893
3483,力致,72,12,60,元大-大天母,2023-08-16,9893
00929,復華台灣科技優息,77,20,57,元大-大天母,2023-08-16,9893
00923,群益台ESG低碳50,54,0,54,元大-大天母,2023-08-16,9893
00671R,富邦NASDAQ反1,50,0,50,元大-大天母,2023-08-16,9893
00706L,期元大S＆P日圓正2,50,0,50,元大-大天母,2023-08-16,9893
2892,第一金,58,9,49,元大-大天母,2023-08-16,9893
00751B,元大AAA至A公司債,50,1,49,元大-大天母,2023-08-16,9893
8210,勤誠,57,11,46,元大-大天母,2023-08-16,9893
2345,智邦,46,1,45,元大-大天母,2023-08-16,9893
5347,世界,43,0,43,元大-大天母,2023-08-16,9893
00679B,元大美債20年,46,8,38,元大-大天母,2023-08-16,9893
3481,群創,32,0,32,元大-大天母,2023-08-16,9893
1802,台玻,30,0,30,元大-大天母,2023-08-16,9893
2884,玉山金,29,1,28,元大-大天母,2023-08-16,9893
00931B,統一美債20年,27,0,27,元大-大天母,2023-08-16,9893
1101,台泥,24,0,24,元大-大天母,2023-08-16,9893
00772B,中信高評級公司債,32,10,22,元大-大天母,2023-08-16,9893
3209,全科,20,0,20,元大-大天母,2023-08-16,9893
1710,東聯,20,0,20,元大-大天母,2023-08-16,9893
3511,矽瑪,20,0,20,元大-大天母,2023-08-16,9893
2520,冠德,20,0,20,元大-大天母,2023-08-16,9893
2886,兆豐金,25,6,19,元大-大天母,2023-08-16,9893
0050,元大台灣50,18,1,17,元大-大天母,2023-08-16,9893
00902,中信電池及儲能,17,0,17,元大-大天母,2023-08-16,9893
2812,台中銀,21,4,17,元大-大天母,2023-08-16,9893
1708,東鹼,15,0,15,元大-大天母,2023-08-16,9893
00882,中信中國高股息,26,12,14,元大-大天母,2023-08-16,9893
00907,永豐優息存股,15,2,13,元大-大天母,2023-08-16,9893
2330,台積電,16,3,13,元大-大天母,2023-08-16,9893
00900,富邦特選高股息30,33,20,13,元大-大天母,2023-08-16,9893
6472,保瑞,22,10,12,元大-大天母,2023-08-16,9893
1504,東元,14,2,12,元大-大天母,2023-08-16,9893
6161,捷波,11,0,11,元大-大天母,2023-08-16,9893
2883,凱基金,11,0,11,元大-大天母,2023-08-16,9893
2548,華固,11,0,11,元大-大天母,2023-08-16,9893
6120,達運,11,0,11,元大-大天母,2023-08-16,9893
00795B,中信美國公債20年,11,0,11,元大-大天母,2023-08-16,9893
1312,國喬,11,0,11,元大-大天母,2023-08-16,9893
1605,華新,47,36,11,元大-大天母,2023-08-16,9893
2464,盟立,11,0,11,元大-大天母,2023-08-16,9893
3483,力致,242,4,238,元大-大天母,2023-08-17,9893
1210,大成,201,1,200,元大-大天母,2023-08-17,9893
00679B,元大美債20年,131,0,131,元大-大天母,2023-08-17,9893
2885,元大金,110,2,108,元大-大天母,2023-08-17,9893
1301,台塑,106,0,106,元大-大天母,2023-08-17,9893
00665L,富邦�琤肭磪囓�2,103,1,102,元大-大天母,2023-08-17,9893
00688L,國泰20年美債正2,102,0,102,元大-大天母,2023-08-17,9893
00680L,元大美債20正2,83,0,83,元大-大天母,2023-08-17,9893
2002,中鋼,121,42,79,元大-大天母,2023-08-17,9893
2303,聯電,108,40,68,元大-大天母,2023-08-17,9893
1519,華城,66,3,63,元大-大天母,2023-08-17,9893
2449,京元電子,62,1,61,元大-大天母,2023-08-17,9893
2888,新光金,58,0,58,元大-大天母,2023-08-17,9893
4763,材料-KY,56,2,54,元大-大天母,2023-08-17,9893
00929,復華台灣科技優息,75,22,53,元大-大天母,2023-08-17,9893
00650L,復華香港正2,57,7,50,元大-大天母,2023-08-17,9893
6443,元晶,50,0,50,元大-大天母,2023-08-17,9893
2609,陽明,56,7,49,元大-大天母,2023-08-17,9893
8996,高力,49,4,45,元大-大天母,2023-08-17,9893
3231,緯創,190,146,44,元大-大天母,2023-08-17,9893
3030,德律,42,0,42,元大-大天母,2023-08-17,9893
3711,日月光投控,42,1,41,元大-大天母,2023-08-17,9893
1802,台玻,35,1,34,元大-大天母,2023-08-17,9893
00751B,元大AAA至A公司債,33,0,33,元大-大天母,2023-08-17,9893
00706L,期元大S＆P日圓正2,31,0,31,元大-大天母,2023-08-17,9893
00923,群益台ESG低碳50,32,2,30,元大-大天母,2023-08-17,9893
00673R,期元大S＆P原油反1,30,2,28,元大-大天母,2023-08-17,9893
2913,農林,28,1,27,元大-大天母,2023-08-17,9893
00715L,期街口布蘭特正2,25,0,25,元大-大天母,2023-08-17,9893
00882,中信中國高股息,24,0,24,元大-大天母,2023-08-17,9893
2618,長榮航,39,17,22,元大-大天母,2023-08-17,9893
1815,富喬,21,0,21,元大-大天母,2023-08-17,9893
8050,廣積,20,0,20,元大-大天母,2023-08-17,9893
00655L,國泰中國A50正2,20,0,20,元大-大天母,2023-08-17,9893
8043,蜜望實,20,0,20,元大-大天母,2023-08-17,9893
2886,兆豐金,27,9,18,元大-大天母,2023-08-17,9893
6168,宏齊,17,0,17,元大-大天母,2023-08-17,9893
2892,第一金,20,3,17,元大-大天母,2023-08-17,9893
1101,台泥,20,4,16,元大-大天母,2023-08-17,9893
00922,國泰台灣領袖50,16,0,16,元大-大天母,2023-08-17,9893
6278,台表科,28,13,15,元大-大天母,2023-08-17,9893
0050,元大台灣50,15,0,15,元大-大天母,2023-08-17,9893
00931B,統一美債20年,14,0,14,元大-大天母,2023-08-17,9893
00720B,元大投資級公司債,18,4,14,元大-大天母,2023-08-17,9893
2882,國泰金,13,1,12,元大-大天母,2023-08-17,9893
5347,世界,12,0,12,元大-大天母,2023-08-17,9893
2897,王道銀行,12,0,12,元大-大天母,2023-08-17,9893
2903,遠百,12,0,12,元大-大天母,2023-08-17,9893
00885,富邦越南,12,0,12,元大-大天母,2023-08-17,9893
5876,上海商銀,11,0,11,元大-大天母,2023-08-17,9893
2363,矽統,300,56,244,元大-大天母,2023-08-18,9893
2206,三陽工業,189,12,177,元大-大天母,2023-08-18,9893
3231,緯創,254,149,105,元大-大天母,2023-08-18,9893
2356,英業達,121,32,89,元大-大天母,2023-08-18,9893
2382,廣達,142,68,74,元大-大天母,2023-08-18,9893
5347,世界,72,0,72,元大-大天母,2023-08-18,9893
00929,復華台灣科技優息,170,98,72,元大-大天母,2023-08-18,9893
3030,德律,60,0,60,元大-大天母,2023-08-18,9893
2402,毅嘉,95,52,43,元大-大天母,2023-08-18,9893
00719B,元大美債1-3,42,0,42,元大-大天母,2023-08-18,9893
00632R,元大台灣50反1,40,0,40,元大-大天母,2023-08-18,9893
3706,神達,120,83,37,元大-大天母,2023-08-18,9893
1504,東元,39,2,37,元大-大天母,2023-08-18,9893
6538,倉和,36,6,30,元大-大天母,2023-08-18,9893
00753L,中信中國50正2,30,0,30,元大-大天母,2023-08-18,9893
3056,富華新,36,6,30,元大-大天母,2023-08-18,9893
3704,合勤控,30,0,30,元大-大天母,2023-08-18,9893
1471,首利,42,13,29,元大-大天母,2023-08-18,9893
1513,中興電,54,26,28,元大-大天母,2023-08-18,9893
2027,大成鋼,27,0,27,元大-大天母,2023-08-18,9893
6125,廣運,27,2,25,元大-大天母,2023-08-18,9893
2312,金寶,32,9,23,元大-大天母,2023-08-18,9893
2409,友達,32,10,22,元大-大天母,2023-08-18,9893
2892,第一金,31,9,22,元大-大天母,2023-08-18,9893
1903,士紙,20,0,20,元大-大天母,2023-08-18,9893
00655L,國泰中國A50正2,20,0,20,元大-大天母,2023-08-18,9893
6016,康和證,20,0,20,元大-大天母,2023-08-18,9893
5432,新門,20,1,19,元大-大天母,2023-08-18,9893
2344,華邦電,68,50,18,元大-大天母,2023-08-18,9893
3207,耀勝,18,1,17,元大-大天母,2023-08-18,9893
1319,東陽,23,6,17,元大-大天母,2023-08-18,9893
6282,康舒,21,4,17,元大-大天母,2023-08-18,9893
00900,富邦特選高股息30,16,0,16,元大-大天母,2023-08-18,9893
00712,復華富時不動產,26,10,16,元大-大天母,2023-08-18,9893
0050,元大台灣50,16,1,15,元大-大天母,2023-08-18,9893
2886,兆豐金,16,1,15,元大-大天母,2023-08-18,9893
2618,長榮航,20,5,15,元大-大天母,2023-08-18,9893
1708,東鹼,15,0,15,元大-大天母,2023-08-18,9893
00679B,元大美債20年,14,0,14,元大-大天母,2023-08-18,9893
3035,智原,47,33,14,元大-大天母,2023-08-18,9893
2301,光寶科,28,15,13,元大-大天母,2023-08-18,9893
2236,百達-KY,19,7,12,元大-大天母,2023-08-18,9893
2308,台達電,12,0,12,元大-大天母,2023-08-18,9893
00923,群益台ESG低碳50,11,0,11,元大-大天母,2023-08-18,9893
6216,居易,11,0,11,元大-大天母,2023-08-18,9893
1101,台泥,24,13,11,元大-大天母,2023-08-18,9893
2812,台中銀,10,0,10,元大-大天母,2023-08-18,9893
6203,海韻電,10,0,10,元大-大天母,2023-08-18,9893
2467,志聖,10,0,10,元大-大天母,2023-08-18,9893
2641,正德,15,5,10,元大-大天母,2023-08-18,9893
00632R,元大台灣50反1,240,1,239,元大-大天母,2023-08-21,9893
2534,宏盛,220,0,220,元大-大天母,2023-08-21,9893
5347,世界,130,2,128,元大-大天母,2023-08-21,9893
1305,華夏,110,3,107,元大-大天母,2023-08-21,9893
2206,三陽工業,75,0,75,元大-大天母,2023-08-21,9893
3056,富華新,109,54,55,元大-大天母,2023-08-21,9893
2609,陽明,64,12,52,元大-大天母,2023-08-21,9893
00752,中信中國50,50,0,50,元大-大天母,2023-08-21,9893
2211,長榮鋼,44,4,40,元大-大天母,2023-08-21,9893
00652,富邦印度,30,0,30,元大-大天母,2023-08-21,9893
00720B,元大投資級公司債,25,0,25,元大-大天母,2023-08-21,9893
00929,復華台灣科技優息,24,2,22,元大-大天母,2023-08-21,9893
5608,四維航,25,3,22,元大-大天母,2023-08-21,9893
00679B,元大美債20年,20,0,20,元大-大天母,2023-08-21,9893
3441,聯一光,22,2,20,元大-大天母,2023-08-21,9893
00680L,元大美債20正2,20,0,20,元大-大天母,2023-08-21,9893
00660,元大歐洲50,20,0,20,元大-大天母,2023-08-21,9893
2382,廣達,50,30,20,元大-大天母,2023-08-21,9893
00751B,元大AAA至A公司債,19,0,19,元大-大天母,2023-08-21,9893
00673R,期元大S＆P原油反1,19,0,19,元大-大天母,2023-08-21,9893
2606,裕民,27,10,17,元大-大天母,2023-08-21,9893
0050,元大台灣50,16,0,16,元大-大天母,2023-08-21,9893
1903,士紙,16,0,16,元大-大天母,2023-08-21,9893
2913,農林,20,4,16,元大-大天母,2023-08-21,9893
2467,志聖,15,0,15,元大-大天母,2023-08-21,9893
00882,中信中國高股息,14,0,14,元大-大天母,2023-08-21,9893
00931B,統一美債20年,13,0,13,元大-大天母,2023-08-21,9893
3051,力特,23,10,13,元大-大天母,2023-08-21,9893
2612,中航,13,1,12,元大-大天母,2023-08-21,9893
2641,正德,11,0,11,元大-大天母,2023-08-21,9893
3035,智原,16,6,10,元大-大天母,2023-08-21,9893
00885,富邦越南,12,2,10,元大-大天母,2023-08-21,9893
4973,廣穎,10,0,10,元大-大天母,2023-08-21,9893
00650L,復華香港正2,10,0,10,元大-大天母,2023-08-21,9893
2883B,凱基金乙特,10,0,10,元大-大天母,2023-08-21,9893
3047,訊舟,10,0,10,元大-大天母,2023-08-21,9893
2610,華航,21,11,10,元大-大天母,2023-08-21,9893
2520,冠德,30,20,10,元大-大天母,2023-08-21,9893
00712,復華富時不動產,10,0,10,元大-大天母,2023-08-21,9893
00919,群益台灣精選高息,9,0,9,元大-大天母,2023-08-21,9893
2892,第一金,13,3,10,元大-大天母,2023-08-21,9893
9938,百和,9,0,9,元大-大天母,2023-08-21,9893
2457,飛宏,11,2,9,元大-大天母,2023-08-21,9893
2323,中環,10,1,9,元大-大天母,2023-08-21,9893
2485,兆赫,11,2,9,元大-大天母,2023-08-21,9893
8932,智通*,9,0,9,元大-大天母,2023-08-21,9893
2449,京元電子,11,2,9,元大-大天母,2023-08-21,9893
2303,聯電,9,1,8,元大-大天母,2023-08-21,9893
2324,仁寶,16,8,8,元大-大天母,2023-08-21,9893
2354,鴻準,8,0,8,元大-大天母,2023-08-21,9893
1305,華夏,142,0,142,元大-大天母,2023-08-22,9893
2637,慧洋-KY,101,0,101,元大-大天母,2023-08-22,9893
3206,志豐,80,0,80,元大-大天母,2023-08-22,9893
2888,新光金,79,0,79,元大-大天母,2023-08-22,9893
2891,中信金,80,5,75,元大-大天母,2023-08-22,9893
3030,德律,55,0,55,元大-大天母,2023-08-22,9893
00665L,富邦�琤肭磪囓�2,50,0,50,元大-大天母,2023-08-22,9893
2515,中工,42,0,42,元大-大天母,2023-08-22,9893
2359,所羅門,41,0,41,元大-大天母,2023-08-22,9893
6231,系微,41,0,41,元大-大天母,2023-08-22,9893
2383,台光電,40,1,39,元大-大天母,2023-08-22,9893
2324,仁寶,79,42,37,元大-大天母,2023-08-22,9893
00929,復華台灣科技優息,60,23,37,元大-大天母,2023-08-22,9893
6170,統振,36,0,36,元大-大天母,2023-08-22,9893
2618,長榮航,95,60,35,元大-大天母,2023-08-22,9893
00680L,元大美債20正2,35,0,35,元大-大天母,2023-08-22,9893
00720B,元大投資級公司債,33,0,33,元大-大天母,2023-08-22,9893
00679B,元大美債20年,33,0,33,元大-大天母,2023-08-22,9893
2701,萬企,30,0,30,元大-大天母,2023-08-22,9893
2363,矽統,135,109,26,元大-大天母,2023-08-22,9893
3047,訊舟,26,0,26,元大-大天母,2023-08-22,9893
2887,台新金,26,0,26,元大-大天母,2023-08-22,9893
2382,廣達,79,57,22,元大-大天母,2023-08-22,9893
3045,台灣大,24,2,22,元大-大天母,2023-08-22,9893
2883,凱基金,21,0,21,元大-大天母,2023-08-22,9893
0056,元大高股息,31,10,21,元大-大天母,2023-08-22,9893
1101,台泥,20,0,20,元大-大天母,2023-08-22,9893
2014,中鴻,20,0,20,元大-大天母,2023-08-22,9893
3669,圓展,20,0,20,元大-大天母,2023-08-22,9893
3205,佰研,20,0,20,元大-大天母,2023-08-22,9893
3715,定穎投控,20,1,19,元大-大天母,2023-08-22,9893
2323,中環,20,2,18,元大-大天母,2023-08-22,9893
1504,東元,18,1,17,元大-大天母,2023-08-22,9893
2332,友訊,22,5,17,元大-大天母,2023-08-22,9893
2605,新興,24,8,16,元大-大天母,2023-08-22,9893
1471,首利,41,25,16,元大-大天母,2023-08-22,9893
2377,微星,16,1,15,元大-大天母,2023-08-22,9893
2002,中鋼,15,1,14,元大-大天母,2023-08-22,9893
3308,聯德,59,45,14,元大-大天母,2023-08-22,9893
00688L,國泰20年美債正2,13,0,13,元大-大天母,2023-08-22,9893
2892,第一金,14,1,13,元大-大天母,2023-08-22,9893
6275,元山,15,3,12,元大-大天母,2023-08-22,9893
2401,凌陽,12,0,12,元大-大天母,2023-08-22,9893
3325,旭品,14,2,12,元大-大天母,2023-08-22,9893
3163,波若威,19,8,11,元大-大天母,2023-08-22,9893
00713,元大台灣高息低波,12,1,11,元大-大天母,2023-08-22,9893
2885,元大金,12,1,11,元大-大天母,2023-08-22,9893
3032,偉訓,14,3,11,元大-大天母,2023-08-22,9893
00885,富邦越南,11,0,11,元大-大天母,2023-08-22,9893
00753L,中信中國50正2,11,0,11,元大-大天母,2023-08-22,9893
3206,志豐,204,0,204,元大-大天母,2023-08-23,9893
00929,復華台灣科技優息,131,41,90,元大-大天母,2023-08-23,9893
2534,宏盛,84,0,84,元大-大天母,2023-08-23,9893
1305,華夏,82,0,82,元大-大天母,2023-08-23,9893
3030,德律,71,0,71,元大-大天母,2023-08-23,9893
00632R,元大台灣50反1,58,0,58,元大-大天母,2023-08-23,9893
1439,雋揚,55,0,55,元大-大天母,2023-08-23,9893
3059,華晶科,52,0,52,元大-大天母,2023-08-23,9893
0056,元大高股息,62,14,48,元大-大天母,2023-08-23,9893
3013,晟銘電,150,106,44,元大-大天母,2023-08-23,9893
3715,定穎投控,87,45,42,元大-大天母,2023-08-23,9893
8926,台汽電,40,0,40,元大-大天母,2023-08-23,9893
2338,光罩,32,1,31,元大-大天母,2023-08-23,9893
3051,力特,39,9,30,元大-大天母,2023-08-23,9893
3511,矽瑪,30,0,30,元大-大天母,2023-08-23,9893
8027,鈦昇,24,2,22,元大-大天母,2023-08-23,9893
2014,中鴻,22,0,22,元大-大天母,2023-08-23,9893
2301,光寶科,27,5,22,元大-大天母,2023-08-23,9893
2329,華泰,35,14,21,元大-大天母,2023-08-23,9893
8358,金居,28,7,21,元大-大天母,2023-08-23,9893
00673R,期元大S＆P原油反1,20,0,20,元大-大天母,2023-08-23,9893
1301,台塑,24,4,20,元大-大天母,2023-08-23,9893
1471,首利,54,34,20,元大-大天母,2023-08-23,9893
2618,長榮航,72,55,17,元大-大天母,2023-08-23,9893
2610,華航,38,21,17,元大-大天母,2023-08-23,9893
3078,僑威,21,5,16,元大-大天母,2023-08-23,9893
4123,晟德,16,0,16,元大-大天母,2023-08-23,9893
00720B,元大投資級公司債,20,5,15,元大-大天母,2023-08-23,9893
6231,系微,15,1,14,元大-大天母,2023-08-23,9893
6799,來頡,14,0,14,元大-大天母,2023-08-23,9893
2630,亞航,13,0,13,元大-大天母,2023-08-23,9893
9958,世紀鋼,15,2,13,元大-大天母,2023-08-23,9893
5452,佶優,14,2,12,元大-大天母,2023-08-23,9893
2609,陽明,17,5,12,元大-大天母,2023-08-23,9893
2377,微星,12,0,12,元大-大天母,2023-08-23,9893
1905,華紙,13,1,12,元大-大天母,2023-08-23,9893
5371,中光電,20,9,11,元大-大天母,2023-08-23,9893
3037,欣興,13,2,11,元大-大天母,2023-08-23,9893
1447,力鵬,10,0,10,元大-大天母,2023-08-23,9893
4973,廣穎,10,0,10,元大-大天母,2023-08-23,9893
2883B,凱基金乙特,10,0,10,元大-大天母,2023-08-23,9893
00892,富邦台灣半導體,10,0,10,元大-大天母,2023-08-23,9893
2382,廣達,44,34,10,元大-大天母,2023-08-23,9893
4581,光隆精密-KY,10,1,9,元大-大天母,2023-08-23,9893
6274,台燿,13,5,8,元大-大天母,2023-08-23,9893
00670L,富邦NASDAQ正2,8,0,8,元大-大天母,2023-08-23,9893
6275,元山,10,2,8,元大-大天母,2023-08-23,9893
2409,友達,27,20,7,元大-大天母,2023-08-23,9893
2421,建準,10,3,7,元大-大天母,2023-08-23,9893
1609,大亞,7,0,7,元大-大天母,2023-08-23,9893
3021,鴻名,451,5,446,元大-大天母,2023-08-24,9893
00919,群益台灣精選高息,296,4,292,元大-大天母,2023-08-24,9893
2031,新光鋼,121,0,121,元大-大天母,2023-08-24,9893
3231,緯創,264,146,118,元大-大天母,2023-08-24,9893
2363,矽統,355,244,111,元大-大天母,2023-08-24,9893
1519,華城,123,15,108,元大-大天母,2023-08-24,9893
00878,國泰永續高股息,149,63,86,元大-大天母,2023-08-24,9893
00882,中信中國高股息,80,0,80,元大-大天母,2023-08-24,9893
00929,復華台灣科技優息,163,93,70,元大-大天母,2023-08-24,9893
2883,凱基金,64,0,64,元大-大天母,2023-08-24,9893
3324,雙鴻,64,6,58,元大-大天母,2023-08-24,9893
4763,材料-KY,44,1,43,元大-大天母,2023-08-24,9893
00660,元大歐洲50,40,0,40,元大-大天母,2023-08-24,9893
3059,華晶科,40,0,40,元大-大天母,2023-08-24,9893
2324,仁寶,47,10,37,元大-大天母,2023-08-24,9893
00885,富邦越南,35,0,35,元大-大天母,2023-08-24,9893
2356,英業達,65,31,34,元大-大天母,2023-08-24,9893
1903,士紙,32,0,32,元大-大天母,2023-08-24,9893
2338,光罩,33,1,32,元大-大天母,2023-08-24,9893
2610,華航,39,8,31,元大-大天母,2023-08-24,9893
2419,仲琦,49,18,31,元大-大天母,2023-08-24,9893
3531,先益,30,0,30,元大-大天母,2023-08-24,9893
00676R,富邦臺灣加權反1,28,0,28,元大-大天母,2023-08-24,9893
6170,統振,27,0,27,元大-大天母,2023-08-24,9893
2002,中鋼,24,1,23,元大-大天母,2023-08-24,9893
00715L,期街口布蘭特正2,22,0,22,元大-大天母,2023-08-24,9893
2884,玉山金,21,0,21,元大-大天母,2023-08-24,9893
3013,晟銘電,56,35,21,元大-大天母,2023-08-24,9893
5371,中光電,22,4,18,元大-大天母,2023-08-24,9893
3030,德律,18,0,18,元大-大天母,2023-08-24,9893
3587,閎康,23,7,16,元大-大天母,2023-08-24,9893
6167,久正,23,7,16,元大-大天母,2023-08-24,9893
4960,誠美材,18,2,16,元大-大天母,2023-08-24,9893
2634,漢翔,60,44,16,元大-大天母,2023-08-24,9893
2462,良得電,15,0,15,元大-大天母,2023-08-24,9893
2337,旺宏,15,0,15,元大-大天母,2023-08-24,9893
3147,大綜,15,0,15,元大-大天母,2023-08-24,9893
2399,映泰,21,6,15,元大-大天母,2023-08-24,9893
2355,敬鵬,15,1,14,元大-大天母,2023-08-24,9893
3048,益登,13,0,13,元大-大天母,2023-08-24,9893
9933,中鼎,13,0,13,元大-大天母,2023-08-24,9893
2913,農林,13,0,13,元大-大天母,2023-08-24,9893
1795,美時,12,0,12,元大-大天母,2023-08-24,9893
1319,東陽,28,16,12,元大-大天母,2023-08-24,9893
3714,富采,15,3,12,元大-大天母,2023-08-24,9893
2618,長榮航,16,4,12,元大-大天母,2023-08-24,9893
6188,廣明,14,2,12,元大-大天母,2023-08-24,9893
6117,迎廣,13,2,11,元大-大天母,2023-08-24,9893
00753L,中信中國50正2,20,10,10,元大-大天母,2023-08-24,9893
2641,正德,10,0,10,元大-大天母,2023-08-24,9893
3711,日月光投控,403,111,292,元大-大天母,2023-08-25,9893
3231,緯創,792,536,256,元大-大天母,2023-08-25,9893
2303,聯電,245,50,195,元大-大天母,2023-08-25,9893
00878,國泰永續高股息,174,65,109,元大-大天母,2023-08-25,9893
2382,廣達,137,30,107,元大-大天母,2023-08-25,9893
00676R,富邦臺灣加權反1,100,0,100,元大-大天母,2023-08-25,9893
3037,欣興,85,6,79,元大-大天母,2023-08-25,9893
00632R,元大台灣50反1,400,325,75,元大-大天母,2023-08-25,9893
00919,群益台灣精選高息,75,2,73,元大-大天母,2023-08-25,9893
2353,宏��,74,8,66,元大-大天母,2023-08-25,9893
3048,益登,60,0,60,元大-大天母,2023-08-25,9893
2363,矽統,249,193,56,元大-大天母,2023-08-25,9893
2002,中鋼,56,0,56,元大-大天母,2023-08-25,9893
00706L,期元大S＆P日圓正2,50,0,50,元大-大天母,2023-08-25,9893
00637L,元大滬深300正2,50,4,46,元大-大天母,2023-08-25,9893
3234,光環,41,0,41,元大-大天母,2023-08-25,9893
2891,中信金,44,5,39,元大-大天母,2023-08-25,9893
1513,中興電,34,2,32,元大-大天母,2023-08-25,9893
4763,材料-KY,33,3,30,元大-大天母,2023-08-25,9893
4130,健亞,30,0,30,元大-大天母,2023-08-25,9893
2388,威盛,34,7,27,元大-大天母,2023-08-25,9893
3059,華晶科,28,1,27,元大-大天母,2023-08-25,9893
2634,漢翔,50,23,27,元大-大天母,2023-08-25,9893
2376,技嘉,39,14,25,元大-大天母,2023-08-25,9893
6219,富旺,25,0,25,元大-大天母,2023-08-25,9893
00929,復華台灣科技優息,64,40,24,元大-大天母,2023-08-25,9893
8222,寶一,30,7,23,元大-大天母,2023-08-25,9893
0050,元大台灣50,22,0,22,元大-大天母,2023-08-25,9893
2301,光寶科,41,20,21,元大-大天母,2023-08-25,9893
6170,統振,41,21,20,元大-大天母,2023-08-25,9893
2330,台積電,23,7,16,元大-大天母,2023-08-25,9893
0056,元大高股息,19,3,16,元大-大天母,2023-08-25,9893
6213,聯茂,64,48,16,元大-大天母,2023-08-25,9893
4543,萬在,26,11,15,元大-大天母,2023-08-25,9893
2031,新光鋼,15,0,15,元大-大天母,2023-08-25,9893
3715,定穎投控,15,0,15,元大-大天母,2023-08-25,9893
3030,德律,14,0,14,元大-大天母,2023-08-25,9893
00893,國泰智能電動車,13,0,13,元大-大天母,2023-08-25,9893
2419,仲琦,14,1,13,元大-大天母,2023-08-25,9893
00900,富邦特選高股息30,13,0,13,元大-大天母,2023-08-25,9893
00757,統一FANG+,11,0,11,元大-大天母,2023-08-25,9893
2332,友訊,18,7,11,元大-大天母,2023-08-25,9893
3045,台灣大,12,1,11,元大-大天母,2023-08-25,9893
2633,台灣高鐵,11,0,11,元大-大天母,2023-08-25,9893
3058,立德,10,0,10,元大-大天母,2023-08-25,9893
00673R,期元大S＆P原油反1,10,0,10,元大-大天母,2023-08-25,9893
8049,晶采,10,0,10,元大-大天母,2023-08-25,9893
00857B,永豐20年美公債,10,0,10,元大-大天母,2023-08-25,9893
6205,詮欣,10,0,10,元大-大天母,2023-08-25,9893
2313,華通,11,2,9,元大-大天母,2023-08-25,9893
00632R,元大台灣50反1,105,0,105,元大-大天母,2023-08-28,9893
00706L,期元大S＆P日圓正2,57,0,57,元大-大天母,2023-08-28,9893
2618,長榮航,54,4,50,元大-大天母,2023-08-28,9893
3455,由田,45,0,45,元大-大天母,2023-08-28,9893
3231,緯創,129,92,37,元大-大天母,2023-08-28,9893
6219,富旺,35,0,35,元大-大天母,2023-08-28,9893
2610,華航,36,3,33,元大-大天母,2023-08-28,9893
4906,正文,37,6,31,元大-大天母,2023-08-28,9893
2328,廣宇,31,0,31,元大-大天母,2023-08-28,9893
2414,精技,30,0,30,元大-大天母,2023-08-28,9893
00929,復華台灣科技優息,29,1,28,元大-大天母,2023-08-28,9893
2881,富邦金,35,7,28,元大-大天母,2023-08-28,9893
1708,東鹼,29,2,27,元大-大天母,2023-08-28,9893
3059,華晶科,26,0,26,元大-大天母,2023-08-28,9893
2356,英業達,30,5,25,元大-大天母,2023-08-28,9893
2472,立隆電,25,0,25,元大-大天母,2023-08-28,9893
2332,友訊,34,12,22,元大-大天母,2023-08-28,9893
6285,啟��,29,8,21,元大-大天母,2023-08-28,9893
00931B,統一美債20年,20,0,20,元大-大天母,2023-08-28,9893
6156,松上,20,0,20,元大-大天母,2023-08-28,9893
1903,士紙,16,0,16,元大-大天母,2023-08-28,9893
00882,中信中國高股息,35,20,15,元大-大天母,2023-08-28,9893
2355,敬鵬,16,1,15,元大-大天母,2023-08-28,9893
3380,明泰,21,7,14,元大-大天母,2023-08-28,9893
2301,光寶科,19,6,13,元大-大天母,2023-08-28,9893
2399,映泰,13,0,13,元大-大天母,2023-08-28,9893
2485,兆赫,22,9,13,元大-大天母,2023-08-28,9893
2412,中華電,12,0,12,元大-大天母,2023-08-28,9893
2401,凌陽,12,0,12,元大-大天母,2023-08-28,9893
00900,富邦特選高股息30,12,0,12,元大-大天母,2023-08-28,9893
1301,台塑,12,0,12,元大-大天母,2023-08-28,9893
2354,鴻準,11,0,11,元大-大天母,2023-08-28,9893
2498,宏達電,11,0,11,元大-大天母,2023-08-28,9893
2388,威盛,43,33,10,元大-大天母,2023-08-28,9893
2369,菱生,10,0,10,元大-大天母,2023-08-28,9893
4128,中天,10,0,10,元大-大天母,2023-08-28,9893
2520,冠德,10,0,10,元大-大天母,2023-08-28,9893
6197,佳必琪,10,0,10,元大-大天母,2023-08-28,9893
2704,國賓,10,0,10,元大-大天母,2023-08-28,9893
2484,希華,10,0,10,元大-大天母,2023-08-28,9893
2449,京元電子,29,19,10,元大-大天母,2023-08-28,9893
5315,光聯,10,0,10,元大-大天母,2023-08-28,9893
6418,詠昇,10,0,10,元大-大天母,2023-08-28,9893
2002,中鋼,13,4,9,元大-大天母,2023-08-28,9893
2387,精元,10,1,9,元大-大天母,2023-08-28,9893
1513,中興電,15,6,9,元大-大天母,2023-08-28,9893
2897,王道銀行,8,0,8,元大-大天母,2023-08-28,9893
3356,奇偶,7,0,7,元大-大天母,2023-08-28,9893
5225,東科-KY,37,30,7,元大-大天母,2023-08-28,9893
8210,勤誠,9,2,7,元大-大天母,2023-08-28,9893
2534,宏盛,260,0,260,元大-大天母,2023-08-29,9893
00632R,元大台灣50反1,100,0,100,元大-大天母,2023-08-29,9893
2002,中鋼,80,3,77,元大-大天母,2023-08-29,9893
4979,華星光,54,9,45,元大-大天母,2023-08-29,9893
2014,中鴻,41,0,41,元大-大天母,2023-08-29,9893
00929,復華台灣科技優息,50,19,31,元大-大天母,2023-08-29,9893
00751B,元大AAA至A公司債,30,0,30,元大-大天母,2023-08-29,9893
2356,英業達,30,4,26,元大-大天母,2023-08-29,9893
8222,寶一,35,10,25,元大-大天母,2023-08-29,9893
6219,富旺,23,0,23,元大-大天母,2023-08-29,9893
3048,益登,22,0,22,元大-大天母,2023-08-29,9893
2606,裕民,22,1,21,元大-大天母,2023-08-29,9893
6535,順藥,20,0,20,元大-大天母,2023-08-29,9893
1471,首利,50,30,20,元大-大天母,2023-08-29,9893
9958,世紀鋼,22,3,19,元大-大天母,2023-08-29,9893
1409,新纖,30,11,19,元大-大天母,2023-08-29,9893
2704,國賓,18,0,18,元大-大天母,2023-08-29,9893
3706,神達,20,3,17,元大-大天母,2023-08-29,9893
2303,聯電,65,49,16,元大-大天母,2023-08-29,9893
2031,新光鋼,15,0,15,元大-大天母,2023-08-29,9893
5381,合正,11,0,11,元大-大天母,2023-08-29,9893
3227,原相,10,0,10,元大-大天母,2023-08-29,9893
5355,佳總,10,0,10,元大-大天母,2023-08-29,9893
00680L,元大美債20正2,10,0,10,元大-大天母,2023-08-29,9893
006207,復華滬深,10,0,10,元大-大天母,2023-08-29,9893
2520,冠德,10,0,10,元大-大天母,2023-08-29,9893
3047,訊舟,10,0,10,元大-大天母,2023-08-29,9893
0056,元大高股息,9,0,9,元大-大天母,2023-08-29,9893
3481,群創,10,1,9,元大-大天母,2023-08-29,9893
5009,榮剛,12,3,9,元大-大天母,2023-08-29,9893
6282,康舒,9,0,9,元大-大天母,2023-08-29,9893
6155,鈞寶,12,3,9,元大-大天母,2023-08-29,9893
6517,保勝光學,8,0,8,元大-大天母,2023-08-29,9893
3231,緯創,71,63,8,元大-大天母,2023-08-29,9893
3305,昇貿,8,0,8,元大-大天母,2023-08-29,9893
2312,金寶,8,0,8,元大-大天母,2023-08-29,9893
2486,一詮,8,0,8,元大-大天母,2023-08-29,9893
1216,統一,10,2,8,元大-大天母,2023-08-29,9893
2886,兆豐金,10,3,7,元大-大天母,2023-08-29,9893
2545,皇翔,9,2,7,元大-大天母,2023-08-29,9893
3715,定穎投控,12,5,7,元大-大天母,2023-08-29,9893
00892,富邦台灣半導體,7,0,7,元大-大天母,2023-08-29,9893
2330,台積電,8,1,7,元大-大天母,2023-08-29,9893
4934,太極,6,0,6,元大-大天母,2023-08-29,9893
5483,中美晶,7,1,6,元大-大天母,2023-08-29,9893
2615,萬海,6,0,6,元大-大天母,2023-08-29,9893
2903,遠百,6,0,6,元大-大天母,2023-08-29,9893
1513,中興電,7,1,6,元大-大天母,2023-08-29,9893
2891,中信金,6,0,6,元大-大天母,2023-08-29,9893
8210,勤誠,5,0,5,元大-大天母,2023-08-29,9893
6418,詠昇,364,0,364,元大-大天母,2023-08-30,9893
2337,旺宏,506,194,312,元大-大天母,2023-08-30,9893
00665L,富邦�琤肭磪囓�2,300,1,299,元大-大天母,2023-08-30,9893
3481,群創,145,0,145,元大-大天母,2023-08-30,9893
4563,百德,174,31,143,元大-大天母,2023-08-30,9893
2344,華邦電,164,38,126,元大-大天母,2023-08-30,9893
8358,金居,131,18,113,元大-大天母,2023-08-30,9893
00637L,元大滬深300正2,74,0,74,元大-大天母,2023-08-30,9893
00676R,富邦臺灣加權反1,60,0,60,元大-大天母,2023-08-30,9893
4927,泰鼎-KY,75,20,55,元大-大天母,2023-08-30,9893
3044,健鼎,55,2,53,元大-大天母,2023-08-30,9893
00633L,富邦上証正2,51,0,51,元大-大天母,2023-08-30,9893
006206,元大上證50,50,0,50,元大-大天母,2023-08-30,9893
00753L,中信中國50正2,51,5,46,元大-大天母,2023-08-30,9893
3356,奇偶,38,0,38,元大-大天母,2023-08-30,9893
00632R,元大台灣50反1,100,65,35,元大-大天母,2023-08-30,9893
2618,長榮航,46,13,33,元大-大天母,2023-08-30,9893
00680L,元大美債20正2,35,2,33,元大-大天母,2023-08-30,9893
5009,榮剛,33,1,32,元大-大天母,2023-08-30,9893
3030,德律,30,0,30,元大-大天母,2023-08-30,9893
4147,中裕,33,6,27,元大-大天母,2023-08-30,9893
6799,來頡,25,2,23,元大-大天母,2023-08-30,9893
3056,富華新,21,0,21,元大-大天母,2023-08-30,9893
2610,華航,28,7,21,元大-大天母,2023-08-30,9893
6806,森崴能源,23,2,21,元大-大天母,2023-08-30,9893
3325,旭品,28,8,20,元大-大天母,2023-08-30,9893
2414,精技,20,0,20,元大-大天母,2023-08-30,9893
2206,三陽工業,41,21,20,元大-大天母,2023-08-30,9893
2312,金寶,27,7,20,元大-大天母,2023-08-30,9893
2834,臺企銀,23,4,19,元大-大天母,2023-08-30,9893
1513,中興電,20,1,19,元大-大天母,2023-08-30,9893
2609,陽明,17,0,17,元大-大天母,2023-08-30,9893
2331,精英,41,26,15,元大-大天母,2023-08-30,9893
2484,希華,14,0,14,元大-大天母,2023-08-30,9893
1591,駿吉-KY,14,0,14,元大-大天母,2023-08-30,9893
2316,楠梓電,13,0,13,元大-大天母,2023-08-30,9893
2892,第一金,18,6,12,元大-大天母,2023-08-30,9893
2812,台中銀,17,5,12,元大-大天母,2023-08-30,9893
8069,元太,14,2,12,元大-大天母,2023-08-30,9893
6443,元晶,12,0,12,元大-大天母,2023-08-30,9893
2340,台亞,11,0,11,元大-大天母,2023-08-30,9893
6126,信音,13,2,11,元大-大天母,2023-08-30,9893
6120,達運,10,0,10,元大-大天母,2023-08-30,9893
1215,卜蜂,10,0,10,元大-大天母,2023-08-30,9893
00706L,期元大S＆P日圓正2,10,0,10,元大-大天母,2023-08-30,9893
8215,明基材,10,0,10,元大-大天母,2023-08-30,9893
2881,富邦金,9,0,9,元大-大天母,2023-08-30,9893
4123,晟德,9,0,9,元大-大天母,2023-08-30,9893
5469,瀚宇博,9,0,9,元大-大天母,2023-08-30,9893
00679B,元大美債20年,10,2,8,元大-大天母,2023-08-30,9893
3044,健鼎,162,9,153,元大-大天母,2023-08-31,9893
8299,群聯,103,4,99,元大-大天母,2023-08-31,9893
6806,森崴能源,67,0,67,元大-大天母,2023-08-31,9893
2610,華航,66,3,63,元大-大天母,2023-08-31,9893
2891,中信金,58,0,58,元大-大天母,2023-08-31,9893
1802,台玻,68,10,58,元大-大天母,2023-08-31,9893
006206,元大上證50,50,0,50,元大-大天母,2023-08-31,9893
6217,中探針,37,0,37,元大-大天母,2023-08-31,9893
2376,技嘉,48,14,34,元大-大天母,2023-08-31,9893
2434,統懋,33,0,33,元大-大天母,2023-08-31,9893
6285,啟��,37,5,32,元大-大天母,2023-08-31,9893
00637L,元大滬深300正2,31,0,31,元大-大天母,2023-08-31,9893
5285,界霖,30,0,30,元大-大天母,2023-08-31,9893
6491,晶碩,30,4,26,元大-大天母,2023-08-31,9893
2353,宏��,28,3,25,元大-大天母,2023-08-31,9893
00923,群益台ESG低碳50,25,0,25,元大-大天母,2023-08-31,9893
00902,中信電池及儲能,25,0,25,元大-大天母,2023-08-31,9893
3356,奇偶,24,0,24,元大-大天母,2023-08-31,9893
2206,三陽工業,25,1,24,元大-大天母,2023-08-31,9893
00929,復華台灣科技優息,35,14,21,元大-大天母,2023-08-31,9893
5009,榮剛,24,3,21,元大-大天母,2023-08-31,9893
00753L,中信中國50正2,19,0,19,元大-大天母,2023-08-31,9893
2887,台新金,28,10,18,元大-大天母,2023-08-31,9893
2303,聯電,53,36,17,元大-大天母,2023-08-31,9893
00878,國泰永續高股息,18,1,17,元大-大天母,2023-08-31,9893
2888,新光金,17,0,17,元大-大天母,2023-08-31,9893
2884,玉山金,16,0,16,元大-大天母,2023-08-31,9893
00919,群益台灣精選高息,15,0,15,元大-大天母,2023-08-31,9893
2618,長榮航,34,19,15,元大-大天母,2023-08-31,9893
2634,漢翔,39,26,13,元大-大天母,2023-08-31,9893
2883,凱基金,13,0,13,元大-大天母,2023-08-31,9893
2409,友達,16,3,13,元大-大天母,2023-08-31,9893
2002,中鋼,23,10,13,元大-大天母,2023-08-31,9893
2886,兆豐金,12,0,12,元大-大天母,2023-08-31,9893
6741,91APP*-KY,11,0,11,元大-大天母,2023-08-31,9893
6799,來頡,11,0,11,元大-大天母,2023-08-31,9893
2367,燿華,21,10,11,元大-大天母,2023-08-31,9893
2606,裕民,12,1,11,元大-大天母,2023-08-31,9893
2892,第一金,26,16,10,元大-大天母,2023-08-31,9893
2801,彰銀,10,0,10,元大-大天母,2023-08-31,9893
00922,國泰台灣領袖50,10,0,10,元大-大天母,2023-08-31,9893
00891,中信關鍵半導體,10,0,10,元大-大天母,2023-08-31,9893
2491,吉祥全,10,0,10,元大-大天母,2023-08-31,9893
6168,宏齊,10,0,10,元大-大天母,2023-08-31,9893
1471,首利,31,21,10,元大-大天母,2023-08-31,9893
2330,台積電,10,0,10,元大-大天母,2023-08-31,9893
2022,聚亨,9,0,9,元大-大天母,2023-08-31,9893
00687B,國泰20年美債,9,0,9,元大-大天母,2023-08-31,9893
1301,台塑,10,2,8,元大-大天母,2023-08-31,9893
4743,合一,9,1,8,元大-大天母,2023-08-31,9893
4909,新復興,462,57,405,元大-大天母,2023-09-01,9893
00929,復華台灣科技優息,162,2,160,元大-大天母,2023-09-01,9893
2891,中信金,152,1,151,元大-大天母,2023-09-01,9893
3231,緯創,135,29,106,元大-大天母,2023-09-01,9893
2607,榮運,82,1,81,元大-大天母,2023-09-01,9893
3044,健鼎,68,10,58,元大-大天母,2023-09-01,9893
2328,廣宇,60,4,56,元大-大天母,2023-09-01,9893
1101,台泥,56,0,56,元大-大天母,2023-09-01,9893
6153,嘉聯益,54,0,54,元大-大天母,2023-09-01,9893
2881,富邦金,42,7,35,元大-大天母,2023-09-01,9893
2337,旺宏,51,16,35,元大-大天母,2023-09-01,9893
00932,兆豐永續高息等權,34,0,34,元大-大天母,2023-09-01,9893
2610,華航,38,5,33,元大-大天母,2023-09-01,9893
1471,首利,35,2,33,元大-大天母,2023-09-01,9893
00753L,中信中國50正2,36,3,33,元大-大天母,2023-09-01,9893
2645,長榮航太,35,4,31,元大-大天母,2023-09-01,9893
6155,鈞寶,32,2,30,元大-大天母,2023-09-01,9893
00919,群益台灣精選高息,29,1,28,元大-大天母,2023-09-01,9893
1806,冠軍,25,0,25,元大-大天母,2023-09-01,9893
6491,晶碩,25,1,24,元大-大天母,2023-09-01,9893
2485,兆赫,37,16,21,元大-大天母,2023-09-01,9893
2520,冠德,30,10,20,元大-大天母,2023-09-01,9893
2206,三陽工業,23,3,20,元大-大天母,2023-09-01,9893
8210,勤誠,22,2,20,元大-大天母,2023-09-01,9893
2329,華泰,24,5,19,元大-大天母,2023-09-01,9893
2883,凱基金,20,2,18,元大-大天母,2023-09-01,9893
3078,僑威,35,19,16,元大-大天母,2023-09-01,9893
5285,界霖,15,0,15,元大-大天母,2023-09-01,9893
5864,致和證,15,0,15,元大-大天母,2023-09-01,9893
2428,興勤,17,2,15,元大-大天母,2023-09-01,9893
3037,欣興,17,4,13,元大-大天母,2023-09-01,9893
2402,毅嘉,106,93,13,元大-大天母,2023-09-01,9893
00878,國泰永續高股息,19,6,13,元大-大天母,2023-09-01,9893
2382,廣達,26,14,12,元大-大天母,2023-09-01,9893
2356,英業達,14,2,12,元大-大天母,2023-09-01,9893
1605,華新,43,31,12,元大-大天母,2023-09-01,9893
2377,微星,12,0,12,元大-大天母,2023-09-01,9893
2331,精英,21,10,11,元大-大天母,2023-09-01,9893
6197,佳必琪,11,0,11,元大-大天母,2023-09-01,9893
1513,中興電,35,24,11,元大-大天母,2023-09-01,9893
6770,力積電,10,0,10,元大-大天母,2023-09-01,9893
6446,藥華藥,12,2,10,元大-大天母,2023-09-01,9893
0056,元大高股息,12,2,10,元大-大天母,2023-09-01,9893
2332,友訊,13,3,10,元大-大天母,2023-09-01,9893
6122,擎邦,32,22,10,元大-大天母,2023-09-01,9893
4919,新唐,10,0,10,元大-大天母,2023-09-01,9893
6732,昇佳電子,10,0,10,元大-大天母,2023-09-01,9893
3056,富華新,9,0,9,元大-大天母,2023-09-01,9893
2884,玉山金,10,2,8,元大-大天母,2023-09-01,9893
1727,中華化,10,2,8,元大-大天母,2023-09-01,9893
5381,合正,147,44,103,元大-大天母,2023-09-04,9893
00688L,國泰20年美債正2,101,0,101,元大-大天母,2023-09-04,9893
00919,群益台灣精選高息,89,2,87,元大-大天母,2023-09-04,9893
00719B,元大美債1-3,80,0,80,元大-大天母,2023-09-04,9893
2103,台橡,75,0,75,元大-大天母,2023-09-04,9893
00752,中信中國50,52,0,52,元大-大天母,2023-09-04,9893
6732,昇佳電子,52,4,48,元大-大天母,2023-09-04,9893
8049,晶采,45,0,45,元大-大天母,2023-09-04,9893
00929,復華台灣科技優息,45,5,40,元大-大天母,2023-09-04,9893
2492,華新科,54,14,40,元大-大天母,2023-09-04,9893
00931B,統一美債20年,33,0,33,元大-大天母,2023-09-04,9893
2328,廣宇,33,0,33,元大-大天母,2023-09-04,9893
00680L,元大美債20正2,30,0,30,元大-大天母,2023-09-04,9893
1304,台聚,30,0,30,元大-大天母,2023-09-04,9893
3481,群創,89,60,29,元大-大天母,2023-09-04,9893
3056,富華新,26,0,26,元大-大天母,2023-09-04,9893
2537,聯上發,25,0,25,元大-大天母,2023-09-04,9893
00720B,元大投資級公司債,24,0,24,元大-大天母,2023-09-04,9893
8088,品安,23,0,23,元大-大天母,2023-09-04,9893
5009,榮剛,24,2,22,元大-大天母,2023-09-04,9893
5432,新門,20,0,20,元大-大天母,2023-09-04,9893
00878,國泰永續高股息,31,11,20,元大-大天母,2023-09-04,9893
1909,榮成,40,21,19,元大-大天母,2023-09-04,9893
2892,第一金,26,7,19,元大-大天母,2023-09-04,9893
00679B,元大美債20年,18,0,18,元大-大天母,2023-09-04,9893
2409,友達,18,2,16,元大-大天母,2023-09-04,9893
3338,泰碩,28,12,16,元大-大天母,2023-09-04,9893
00673R,期元大S＆P原油反1,15,0,15,元大-大天母,2023-09-04,9893
2329,華泰,20,6,14,元大-大天母,2023-09-04,9893
1447,力鵬,21,7,14,元大-大天母,2023-09-04,9893
3548,兆利,19,6,13,元大-大天母,2023-09-04,9893
2634,漢翔,15,2,13,元大-大天母,2023-09-04,9893
6547,高端疫苗,17,5,12,元大-大天母,2023-09-04,9893
3324,雙鴻,30,18,12,元大-大天母,2023-09-04,9893
00772B,中信高評級公司債,11,0,11,元大-大天母,2023-09-04,9893
3703,欣陸,11,0,11,元大-大天母,2023-09-04,9893
2363,矽統,38,27,11,元大-大天母,2023-09-04,9893
1444,力麗,13,2,11,元大-大天母,2023-09-04,9893
2618,長榮航,18,7,11,元大-大天母,2023-09-04,9893
6153,嘉聯益,11,0,11,元大-大天母,2023-09-04,9893
1904,正隆,11,1,10,元大-大天母,2023-09-04,9893
6811,宏�硌穈T,21,11,10,元大-大天母,2023-09-04,9893
2455,全新,13,3,10,元大-大天母,2023-09-04,9893
2404,漢唐,10,0,10,元大-大天母,2023-09-04,9893
6205,詮欣,10,0,10,元大-大天母,2023-09-04,9893
00921,兆豐龍頭等權重,10,0,10,元大-大天母,2023-09-04,9893
5340,建榮,10,1,9,元大-大天母,2023-09-04,9893
3105,穩懋,12,3,9,元大-大天母,2023-09-04,9893
00923,群益台ESG低碳50,9,0,9,元大-大天母,2023-09-04,9893
2608,嘉里大榮,9,0,9,元大-大天母,2023-09-04,9893
00878,國泰永續高股息,191,22,169,元大-大天母,2023-09-05,9893
1314,中石化,103,0,103,元大-大天母,2023-09-05,9893
2609,陽明,107,4,103,元大-大天母,2023-09-05,9893
00929,復華台灣科技優息,182,83,99,元大-大天母,2023-09-05,9893
00915,凱基優選高股息30,73,0,73,元大-大天母,2023-09-05,9893
2344,華邦電,81,22,59,元大-大天母,2023-09-05,9893
00713,元大台灣高息低波,60,3,57,元大-大天母,2023-09-05,9893
2485,兆赫,53,0,53,元大-大天母,2023-09-05,9893
00752,中信中國50,44,0,44,元大-大天母,2023-09-05,9893
6118,建達,40,0,40,元大-大天母,2023-09-05,9893
3324,雙鴻,49,15,34,元大-大天母,2023-09-05,9893
2606,裕民,43,10,33,元大-大天母,2023-09-05,9893
6531,愛普*,32,1,31,元大-大天母,2023-09-05,9893
6732,昇佳電子,30,0,30,元大-大天母,2023-09-05,9893
00902,中信電池及儲能,25,0,25,元大-大天母,2023-09-05,9893
3047,訊舟,25,0,25,元大-大天母,2023-09-05,9893
2002,中鋼,25,1,24,元大-大天母,2023-09-05,9893
2363,矽統,63,41,22,元大-大天母,2023-09-05,9893
2891,中信金,20,0,20,元大-大天母,2023-09-05,9893
1909,榮成,20,0,20,元大-大天母,2023-09-05,9893
5880,合庫金,19,0,19,元大-大天母,2023-09-05,9893
5457,宣德,37,19,18,元大-大天母,2023-09-05,9893
00720B,元大投資級公司債,17,0,17,元大-大天母,2023-09-05,9893
6122,擎邦,73,57,16,元大-大天母,2023-09-05,9893
3548,兆利,16,0,16,元大-大天母,2023-09-05,9893
00712,復華富時不動產,16,0,16,元大-大天母,2023-09-05,9893
6284,佳邦,15,0,15,元大-大天母,2023-09-05,9893
6443,元晶,16,1,15,元大-大天母,2023-09-05,9893
2022,聚亨,15,0,15,元大-大天母,2023-09-05,9893
00679B,元大美債20年,14,0,14,元大-大天母,2023-09-05,9893
2618,長榮航,32,18,14,元大-大天母,2023-09-05,9893
5443,均豪,14,0,14,元大-大天母,2023-09-05,9893
5009,榮剛,14,0,14,元大-大天母,2023-09-05,9893
00900,富邦特選高股息30,16,2,14,元大-大天母,2023-09-05,9893
6153,嘉聯益,13,0,13,元大-大天母,2023-09-05,9893
2884,玉山金,13,0,13,元大-大天母,2023-09-05,9893
2913,農林,12,0,12,元大-大天母,2023-09-05,9893
00753L,中信中國50正2,40,28,12,元大-大天母,2023-09-05,9893
2492,華新科,14,2,12,元大-大天母,2023-09-05,9893
2409,友達,11,0,11,元大-大天母,2023-09-05,9893
2645,長榮航太,11,0,11,元大-大天母,2023-09-05,9893
8069,元太,13,2,11,元大-大天母,2023-09-05,9893
1313,聯成,11,0,11,元大-大天母,2023-09-05,9893
3025,星通,11,0,11,元大-大天母,2023-09-05,9893
2301,光寶科,13,3,10,元大-大天母,2023-09-05,9893
1447,力鵬,10,0,10,元大-大天母,2023-09-05,9893
2349,錸德,10,0,10,元大-大天母,2023-09-05,9893
3545,敦泰,42,32,10,元大-大天母,2023-09-05,9893
3167,大量,10,0,10,元大-大天母,2023-09-05,9893
6235,華孚,18,8,10,元大-大天母,2023-09-05,9893
00857B,永豐20年美公債,200,0,200,元大-大天母,2023-09-06,9893
00665L,富邦�琤肭磪囓�2,200,0,200,元大-大天母,2023-09-06,9893
00929,復華台灣科技優息,208,41,167,元大-大天母,2023-09-06,9893
1101,台泥,118,11,107,元大-大天母,2023-09-06,9893
00915,凱基優選高股息30,127,35,92,元大-大天母,2023-09-06,9893
00919,群益台灣精選高息,95,27,68,元大-大天母,2023-09-06,9893
2834,臺企銀,62,0,62,元大-大天母,2023-09-06,9893
4563,百德,69,9,60,元大-大天母,2023-09-06,9893
00706L,期元大S＆P日圓正2,53,0,53,元大-大天母,2023-09-06,9893
00633L,富邦上証正2,52,0,52,元大-大天母,2023-09-06,9893
1802,台玻,52,2,50,元大-大天母,2023-09-06,9893
00918,大華優利高填息30,45,0,45,元大-大天母,2023-09-06,9893
2401,凌陽,53,8,45,元大-大天母,2023-09-06,9893
2903,遠百,40,1,39,元大-大天母,2023-09-06,9893
3567,逸昌,69,30,39,元大-大天母,2023-09-06,9893
2886,兆豐金,38,0,38,元大-大天母,2023-09-06,9893
9958,世紀鋼,54,18,36,元大-大天母,2023-09-06,9893
00795B,中信美國公債20年,31,0,31,元大-大天母,2023-09-06,9893
3034,聯詠,30,0,30,元大-大天母,2023-09-06,9893
3715,定穎投控,62,36,26,元大-大天母,2023-09-06,9893
3455,由田,25,0,25,元大-大天母,2023-09-06,9893
2363,矽統,87,62,25,元大-大天母,2023-09-06,9893
2409,友達,96,72,24,元大-大天母,2023-09-06,9893
8069,元太,24,0,24,元大-大天母,2023-09-06,9893
3615,安可,25,1,24,元大-大天母,2023-09-06,9893
3481,群創,199,176,23,元大-大天母,2023-09-06,9893
2618,長榮航,25,2,23,元大-大天母,2023-09-06,9893
3047,訊舟,22,0,22,元大-大天母,2023-09-06,9893
8358,金居,31,11,20,元大-大天母,2023-09-06,9893
6198,瑞築,20,0,20,元大-大天母,2023-09-06,9893
1904,正隆,20,0,20,元大-大天母,2023-09-06,9893
5864,致和證,20,0,20,元大-大天母,2023-09-06,9893
1909,榮成,20,0,20,元大-大天母,2023-09-06,9893
00673R,期元大S＆P原油反1,22,3,19,元大-大天母,2023-09-06,9893
9927,泰銘,19,1,18,元大-大天母,2023-09-06,9893
4746,台耀,26,9,17,元大-大天母,2023-09-06,9893
1227,佳格,17,0,17,元大-大天母,2023-09-06,9893
8033,雷虎,16,0,16,元大-大天母,2023-09-06,9893
00932,兆豐永續高息等權,15,0,15,元大-大天母,2023-09-06,9893
2344,華邦電,26,12,14,元大-大天母,2023-09-06,9893
2002,中鋼,15,1,14,元大-大天母,2023-09-06,9893
00679B,元大美債20年,14,0,14,元大-大天母,2023-09-06,9893
2376,技嘉,28,14,14,元大-大天母,2023-09-06,9893
00753L,中信中國50正2,14,0,14,元大-大天母,2023-09-06,9893
6213,聯茂,63,49,14,元大-大天母,2023-09-06,9893
2887,台新金,14,0,14,元大-大天母,2023-09-06,9893
5347,世界,13,0,13,元大-大天母,2023-09-06,9893
0050,元大台灣50,12,0,12,元大-大天母,2023-09-06,9893
5880,合庫金,13,1,12,元大-大天母,2023-09-06,9893
00931B,統一美債20年,12,0,12,元大-大天母,2023-09-06,9893
00929,復華台灣科技優息,305,104,201,元大-大天母,2023-09-07,9893
2834,臺企銀,101,0,101,元大-大天母,2023-09-07,9893
8112,至上,100,15,85,元大-大天母,2023-09-07,9893
00919,群益台灣精選高息,98,15,83,元大-大天母,2023-09-07,9893
6485,點序,81,3,78,元大-大天母,2023-09-07,9893
2344,華邦電,89,13,76,元大-大天母,2023-09-07,9893
2313,華通,137,70,67,元大-大天母,2023-09-07,9893
3260,威剛,67,4,63,元大-大天母,2023-09-07,9893
2303,聯電,58,8,50,元大-大天母,2023-09-07,9893
00918,大華優利高填息30,50,0,50,元大-大天母,2023-09-07,9893
3257,虹冠電,50,6,44,元大-大天母,2023-09-07,9893
00637L,元大滬深300正2,43,0,43,元大-大天母,2023-09-07,9893
3047,訊舟,41,0,41,元大-大天母,2023-09-07,9893
2323,中環,40,0,40,元大-大天母,2023-09-07,9893
3217,優群,36,0,36,元大-大天母,2023-09-07,9893
00679B,元大美債20年,33,0,33,元大-大天母,2023-09-07,9893
3715,定穎投控,76,47,29,元大-大天母,2023-09-07,9893
3323,加百裕,30,1,29,元大-大天母,2023-09-07,9893
8033,雷虎,26,0,26,元大-大天母,2023-09-07,9893
2356,英業達,27,3,24,元大-大天母,2023-09-07,9893
2382,廣達,84,60,24,元大-大天母,2023-09-07,9893
2330,台積電,24,0,24,元大-大天母,2023-09-07,9893
2884,玉山金,24,0,24,元大-大天母,2023-09-07,9893
00878,國泰永續高股息,32,11,21,元大-大天母,2023-09-07,9893
6811,宏�硌穈T,21,0,21,元大-大天母,2023-09-07,9893
6120,達運,20,0,20,元大-大天母,2023-09-07,9893
3231,緯創,44,25,19,元大-大天母,2023-09-07,9893
3596,智易,21,2,19,元大-大天母,2023-09-07,9893
3704,合勤控,30,11,19,元大-大天母,2023-09-07,9893
4760,勤凱,18,0,18,元大-大天母,2023-09-07,9893
2891,中信金,15,0,15,元大-大天母,2023-09-07,9893
1447,力鵬,15,0,15,元大-大天母,2023-09-07,9893
2505,國揚,15,0,15,元大-大天母,2023-09-07,9893
2002,中鋼,16,1,15,元大-大天母,2023-09-07,9893
2375,凱美,15,0,15,元大-大天母,2023-09-07,9893
3481,群創,16,2,14,元大-大天母,2023-09-07,9893
0056,元大高股息,14,0,14,元大-大天母,2023-09-07,9893
00713,元大台灣高息低波,15,1,14,元大-大天母,2023-09-07,9893
2881,富邦金,14,0,14,元大-大天母,2023-09-07,9893
3548,兆利,17,3,14,元大-大天母,2023-09-07,9893
6153,嘉聯益,14,0,14,元大-大天母,2023-09-07,9893
1616,億泰,14,0,14,元大-大天母,2023-09-07,9893
2492,華新科,15,2,13,元大-大天母,2023-09-07,9893
2618,長榮航,19,7,12,元大-大天母,2023-09-07,9893
5225,東科-KY,19,7,12,元大-大天母,2023-09-07,9893
2409,友達,22,10,12,元大-大天母,2023-09-07,9893
00915,凱基優選高股息30,26,15,11,元大-大天母,2023-09-07,9893
00932,兆豐永續高息等權,11,0,11,元大-大天母,2023-09-07,9893
00680L,元大美債20正2,11,0,11,元大-大天母,2023-09-07,9893
4908,前鼎,16,5,11,元大-大天母,2023-09-07,9893
00929,復華台灣科技優息,633,486,147,元大-大天母,2023-09-08,9893
00679B,元大美債20年,110,0,110,元大-大天母,2023-09-08,9893
00918,大華優利高填息30,75,0,75,元大-大天母,2023-09-08,9893
00919,群益台灣精選高息,89,34,55,元大-大天母,2023-09-08,9893
00772B,中信高評級公司債,50,0,50,元大-大天母,2023-09-08,9893
6732,昇佳電子,35,0,35,元大-大天母,2023-09-08,9893
2353,宏��,35,0,35,元大-大天母,2023-09-08,9893
2485,兆赫,43,10,33,元大-大天母,2023-09-08,9893
3711,日月光投控,31,0,31,元大-大天母,2023-09-08,9893
2382,廣達,45,14,31,元大-大天母,2023-09-08,9893
1609,大亞,29,0,29,元大-大天母,2023-09-08,9893
3048,益登,27,0,27,元大-大天母,2023-09-08,9893
2630,亞航,69,43,26,元大-大天母,2023-09-08,9893
2330,台積電,30,5,25,元大-大天母,2023-09-08,9893
3213,茂訊,60,35,25,元大-大天母,2023-09-08,9893
2618,長榮航,29,5,24,元大-大天母,2023-09-08,9893
3047,訊舟,23,0,23,元大-大天母,2023-09-08,9893
2206,三陽工業,28,5,23,元大-大天母,2023-09-08,9893
2404,漢唐,23,0,23,元大-大天母,2023-09-08,9893
00878,國泰永續高股息,30,8,22,元大-大天母,2023-09-08,9893
1802,台玻,21,0,21,元大-大天母,2023-09-08,9893
8069,元太,22,2,20,元大-大天母,2023-09-08,9893
2883,凱基金,20,0,20,元大-大天母,2023-09-08,9893
3406,玉晶光,21,1,20,元大-大天母,2023-09-08,9893
2344,華邦電,31,12,19,元大-大天母,2023-09-08,9893
00633L,富邦上証正2,19,0,19,元大-大天母,2023-09-08,9893
3704,合勤控,27,9,18,元大-大天母,2023-09-08,9893
6770,力積電,17,0,17,元大-大天母,2023-09-08,9893
2356,英業達,29,14,15,元大-大天母,2023-09-08,9893
2704,國賓,15,0,15,元大-大天母,2023-09-08,9893
4760,勤凱,16,1,15,元大-大天母,2023-09-08,9893
4746,台耀,14,0,14,元大-大天母,2023-09-08,9893
3374,精材,14,0,14,元大-大天母,2023-09-08,9893
8112,至上,20,6,14,元大-大天母,2023-09-08,9893
1471,首利,30,16,14,元大-大天母,2023-09-08,9893
1513,中興電,15,3,12,元大-大天母,2023-09-08,9893
3056,富華新,13,1,12,元大-大天母,2023-09-08,9893
2486,一詮,28,16,12,元大-大天母,2023-09-08,9893
3231,緯創,30,19,11,元大-大天母,2023-09-08,9893
2408,南亞科,13,2,11,元大-大天母,2023-09-08,9893
1540,喬福,10,0,10,元大-大天母,2023-09-08,9893
2498,宏達電,10,0,10,元大-大天母,2023-09-08,9893
2377,微星,10,0,10,元大-大天母,2023-09-08,9893
5215,科嘉-KY,10,0,10,元大-大天母,2023-09-08,9893
4938,和碩,10,0,10,元大-大天母,2023-09-08,9893
00882,中信中國高股息,11,1,10,元大-大天母,2023-09-08,9893
1326,台化,10,0,10,元大-大天母,2023-09-08,9893
6191,精成科,21,11,10,元大-大天母,2023-09-08,9893
1447,力鵬,10,0,10,元大-大天母,2023-09-08,9893
2332,友訊,12,3,9,元大-大天母,2023-09-08,9893
00676R,富邦臺灣加權反1,200,0,200,元大-大天母,2023-09-11,9893
00929,復華台灣科技優息,427,250,177,元大-大天母,2023-09-11,9893
00919,群益台灣精選高息,198,48,150,元大-大天母,2023-09-11,9893
00679B,元大美債20年,116,0,116,元大-大天母,2023-09-11,9893
00772B,中信高評級公司債,91,0,91,元大-大天母,2023-09-11,9893
2301,光寶科,111,23,88,元大-大天母,2023-09-11,9893
3711,日月光投控,80,0,80,元大-大天母,2023-09-11,9893
9958,世紀鋼,77,3,74,元大-大天母,2023-09-11,9893
0056,元大高股息,78,25,53,元大-大天母,2023-09-11,9893
5284,jpp-KY,54,3,51,元大-大天母,2023-09-11,9893
5426,振發,50,0,50,元大-大天母,2023-09-11,9893
00931B,統一美債20年,45,0,45,元大-大天母,2023-09-11,9893
00932,兆豐永續高息等權,48,5,43,元大-大天母,2023-09-11,9893
8926,台汽電,40,0,40,元大-大天母,2023-09-11,9893
2382,廣達,64,24,40,元大-大天母,2023-09-11,9893
2356,英業達,41,7,34,元大-大天母,2023-09-11,9893
00923,群益台ESG低碳50,34,3,31,元大-大天母,2023-09-11,9893
5521,工信,30,0,30,元大-大天母,2023-09-11,9893
00918,大華優利高填息30,36,9,27,元大-大天母,2023-09-11,9893
2313,華通,31,6,25,元大-大天母,2023-09-11,9893
2312,金寶,25,0,25,元大-大天母,2023-09-11,9893
3048,益登,25,0,25,元大-大天母,2023-09-11,9893
2376,技嘉,51,29,22,元大-大天母,2023-09-11,9893
5432,新門,20,0,20,元大-大天母,2023-09-11,9893
1609,大亞,20,0,20,元大-大天母,2023-09-11,9893
2618,長榮航,26,7,19,元大-大天母,2023-09-11,9893
2330,台積電,22,3,19,元大-大天母,2023-09-11,9893
6104,創惟,22,3,19,元大-大天母,2023-09-11,9893
2352,佳世達,21,2,19,元大-大天母,2023-09-11,9893
2388,威盛,22,4,18,元大-大天母,2023-09-11,9893
2610,華航,19,1,18,元大-大天母,2023-09-11,9893
2409,友達,23,6,17,元大-大天母,2023-09-11,9893
2363,矽統,30,13,17,元大-大天母,2023-09-11,9893
00915,凱基優選高股息30,15,0,15,元大-大天母,2023-09-11,9893
1447,力鵬,15,0,15,元大-大天母,2023-09-11,9893
2520,冠德,15,0,15,元大-大天母,2023-09-11,9893
8033,雷虎,20,5,15,元大-大天母,2023-09-11,9893
6207,雷科,14,0,14,元大-大天母,2023-09-11,9893
3694,海華,13,0,13,元大-大天母,2023-09-11,9893
1612,宏泰,13,0,13,元大-大天母,2023-09-11,9893
2423,固緯,13,0,13,元大-大天母,2023-09-11,9893
6531,愛普*,14,2,12,元大-大天母,2023-09-11,9893
2838,聯邦銀,12,0,12,元大-大天母,2023-09-11,9893
1802,台玻,12,0,12,元大-大天母,2023-09-11,9893
6125,廣運,13,1,12,元大-大天母,2023-09-11,9893
8215,明基材,12,0,12,元大-大天母,2023-09-11,9893
00720B,元大投資級公司債,12,0,12,元大-大天母,2023-09-11,9893
2427,三商電,28,17,11,元大-大天母,2023-09-11,9893
2493,揚博,13,2,11,元大-大天母,2023-09-11,9893
6191,精成科,12,2,10,元大-大天母,2023-09-11,9893
3011,今皓,100,0,100,元大-大天母,2023-09-12,9893
00919,群益台灣精選高息,97,15,82,元大-大天母,2023-09-12,9893
6282,康舒,73,2,71,元大-大天母,2023-09-12,9893
2340,台亞,48,5,43,元大-大天母,2023-09-12,9893
2031,新光鋼,40,0,40,元大-大天母,2023-09-12,9893
5706,鳳凰,45,5,40,元大-大天母,2023-09-12,9893
00878,國泰永續高股息,79,39,40,元大-大天母,2023-09-12,9893
3276,宇環,47,10,37,元大-大天母,2023-09-12,9893
1471,首利,38,2,36,元大-大天母,2023-09-12,9893
2301,光寶科,32,1,31,元大-大天母,2023-09-12,9893
1304,台聚,30,0,30,元大-大天母,2023-09-12,9893
3455,由田,30,2,28,元大-大天母,2023-09-12,9893
3231,緯創,69,42,27,元大-大天母,2023-09-12,9893
5475,德宏,27,0,27,元大-大天母,2023-09-12,9893
2882,國泰金,26,0,26,元大-大天母,2023-09-12,9893
3624,光頡,27,1,26,元大-大天母,2023-09-12,9893
3260,威剛,113,87,26,元大-大天母,2023-09-12,9893
2454,聯發科,31,5,26,元大-大天母,2023-09-12,9893
8112,至上,38,13,25,元大-大天母,2023-09-12,9893
2206,三陽工業,23,2,21,元大-大天母,2023-09-12,9893
2884,玉山金,21,0,21,元大-大天母,2023-09-12,9893
2881,富邦金,20,0,20,元大-大天母,2023-09-12,9893
2838,聯邦銀,20,0,20,元大-大天母,2023-09-12,9893
2618,長榮航,29,10,19,元大-大天母,2023-09-12,9893
2402,毅嘉,19,0,19,元大-大天母,2023-09-12,9893
8016,矽創,22,3,19,元大-大天母,2023-09-12,9893
1314,中石化,18,0,18,元大-大天母,2023-09-12,9893
6125,廣運,61,43,18,元大-大天母,2023-09-12,9893
2404,漢唐,18,1,17,元大-大天母,2023-09-12,9893
2356,英業達,27,11,16,元大-大天母,2023-09-12,9893
2002,中鋼,15,0,15,元大-大天母,2023-09-12,9893
00751B,元大AAA至A公司債,15,0,15,元大-大天母,2023-09-12,9893
00918,大華優利高填息30,15,0,15,元大-大天母,2023-09-12,9893
2892,第一金,27,13,14,元大-大天母,2023-09-12,9893
3528,安馳,13,0,13,元大-大天母,2023-09-12,9893
2610,華航,18,6,12,元大-大天母,2023-09-12,9893
2371,大同,12,0,12,元大-大天母,2023-09-12,9893
00655L,國泰中國A50正2,12,0,12,元大-大天母,2023-09-12,9893
3515,華擎,11,0,11,元大-大天母,2023-09-12,9893
2516,新建,10,0,10,元大-大天母,2023-09-12,9893
2645,長榮航太,11,1,10,元大-大天母,2023-09-12,9893
6446,藥華藥,14,4,10,元大-大天母,2023-09-12,9893
0056,元大高股息,11,1,10,元大-大天母,2023-09-12,9893
1710,東聯,10,0,10,元大-大天母,2023-09-12,9893
2468,華經,10,0,10,元大-大天母,2023-09-12,9893
4207,環泰,10,0,10,元大-大天母,2023-09-12,9893
2358,廷鑫,10,0,10,元大-大天母,2023-09-12,9893
4953,緯軟,9,0,9,元大-大天母,2023-09-12,9893
2409,友達,12,4,8,元大-大天母,2023-09-12,9893
6117,迎廣,8,0,8,元大-大天母,2023-09-12,9893
2313,華通,177,17,160,元大-大天母,2023-09-13,9893
2890,永豐金,126,8,118,元大-大天母,2023-09-13,9893
00929,復華台灣科技優息,351,237,114,元大-大天母,2023-09-13,9893
00931B,統一美債20年,110,0,110,元大-大天母,2023-09-13,9893
9938,百和,60,3,57,元大-大天母,2023-09-13,9893
6168,宏齊,53,0,53,元大-大天母,2023-09-13,9893
2534,宏盛,72,20,52,元大-大天母,2023-09-13,9893
00878,國泰永續高股息,62,10,52,元大-大天母,2023-09-13,9893
1717,長興,100,50,50,元大-大天母,2023-09-13,9893
00919,群益台灣精選高息,46,5,41,元大-大天母,2023-09-13,9893
00918,大華優利高填息30,40,1,39,元大-大天母,2023-09-13,9893
00751B,元大AAA至A公司債,39,0,39,元大-大天母,2023-09-13,9893
3624,光頡,39,5,34,元大-大天母,2023-09-13,9893
5880,合庫金,33,0,33,元大-大天母,2023-09-13,9893
3704,合勤控,37,6,31,元大-大天母,2023-09-13,9893
3363,上詮,39,12,27,元大-大天母,2023-09-13,9893
2353,宏��,25,1,24,元大-大天母,2023-09-13,9893
6170,統振,25,2,23,元大-大天母,2023-09-13,9893
2402,毅嘉,27,6,21,元大-大天母,2023-09-13,9893
3047,訊舟,20,0,20,元大-大天母,2023-09-13,9893
3011,今皓,20,0,20,元大-大天母,2023-09-13,9893
1210,大成,20,0,20,元大-大天母,2023-09-13,9893
3481,群創,18,0,18,元大-大天母,2023-09-13,9893
00713,元大台灣高息低波,16,1,15,元大-大天母,2023-09-13,9893
00673R,期元大S＆P原油反1,15,0,15,元大-大天母,2023-09-13,9893
00772B,中信高評級公司債,14,0,14,元大-大天母,2023-09-13,9893
3322,建舜電,15,1,14,元大-大天母,2023-09-13,9893
00720B,元大投資級公司債,14,1,13,元大-大天母,2023-09-13,9893
8358,金居,13,1,12,元大-大天母,2023-09-13,9893
2887,台新金,11,0,11,元大-大天母,2023-09-13,9893
1102,亞泥,11,0,11,元大-大天母,2023-09-13,9893
6188,廣明,13,3,10,元大-大天母,2023-09-13,9893
6288,聯嘉,15,5,10,元大-大天母,2023-09-13,9893
3028,增你強,11,1,10,元大-大天母,2023-09-13,9893
2352,佳世達,19,9,10,元大-大天母,2023-09-13,9893
2344,華邦電,10,0,10,元大-大天母,2023-09-13,9893
3231,緯創,45,36,9,元大-大天母,2023-09-13,9893
3706,神達,9,0,9,元大-大天母,2023-09-13,9893
3037,欣興,10,1,9,元大-大天母,2023-09-13,9893
3048,益登,9,0,9,元大-大天母,2023-09-13,9893
2375,凱美,9,0,9,元大-大天母,2023-09-13,9893
3661,世芯-KY,15,7,8,元大-大天母,2023-09-13,9893
1568,倉佑,36,28,8,元大-大天母,2023-09-13,9893
5009,榮剛,9,1,8,元大-大天母,2023-09-13,9893
3532,台勝科,9,1,8,元大-大天母,2023-09-13,9893
2208,台船,10,2,8,元大-大天母,2023-09-13,9893
2329,華泰,9,1,8,元大-大天母,2023-09-13,9893
1809,中釉,18,11,7,元大-大天母,2023-09-13,9893
00710B,復華彭博非投等債,7,0,7,元大-大天母,2023-09-13,9893
8069,元太,11,5,6,元大-大天母,2023-09-13,9893
00929,復華台灣科技優息,291,42,249,元大-大天母,2023-09-14,9893
00632R,元大台灣50反1,210,115,95,元大-大天母,2023-09-14,9893
3011,今皓,80,0,80,元大-大天母,2023-09-14,9893
00919,群益台灣精選高息,62,2,60,元大-大天母,2023-09-14,9893
3017,奇鋐,64,6,58,元大-大天母,2023-09-14,9893
00751B,元大AAA至A公司債,58,8,50,元大-大天母,2023-09-14,9893
2885,元大金,62,17,45,元大-大天母,2023-09-14,9893
2618,長榮航,70,36,34,元大-大天母,2023-09-14,9893
2538,基泰,33,0,33,元大-大天母,2023-09-14,9893
3481,群創,33,0,33,元大-大天母,2023-09-14,9893
2014,中鴻,32,0,32,元大-大天母,2023-09-14,9893
3624,光頡,32,0,32,元大-大天母,2023-09-14,9893
8069,元太,35,4,31,元大-大天母,2023-09-14,9893
6668,中揚光,30,0,30,元大-大天母,2023-09-14,9893
2382,廣達,52,23,29,元大-大天母,2023-09-14,9893
2371,大同,69,40,29,元大-大天母,2023-09-14,9893
5608,四維航,30,3,27,元大-大天母,2023-09-14,9893
00712,復華富時不動產,29,5,24,元大-大天母,2023-09-14,9893
4561,健椿,25,1,24,元大-大天母,2023-09-14,9893
6170,統振,27,3,24,元大-大天母,2023-09-14,9893
2405,輔信,29,6,23,元大-大天母,2023-09-14,9893
8150,南茂,29,6,23,元大-大天母,2023-09-14,9893
2637,慧洋-KY,38,16,22,元大-大天母,2023-09-14,9893
00918,大華優利高填息30,28,7,21,元大-大天母,2023-09-14,9893
2834,臺企銀,19,0,19,元大-大天母,2023-09-14,9893
9938,百和,45,26,19,元大-大天母,2023-09-14,9893
2340,台亞,20,3,17,元大-大天母,2023-09-14,9893
2312,金寶,21,5,16,元大-大天母,2023-09-14,9893
00713,元大台灣高息低波,17,2,15,元大-大天母,2023-09-14,9893
2801,彰銀,16,1,15,元大-大天母,2023-09-14,9893
2530,華建,14,0,14,元大-大天母,2023-09-14,9893
00715L,期街口布蘭特正2,13,0,13,元大-大天母,2023-09-14,9893
1340,勝悅-KY,13,0,13,元大-大天母,2023-09-14,9893
2890,永豐金,134,121,13,元大-大天母,2023-09-14,9893
4979,華星光,32,20,12,元大-大天母,2023-09-14,9893
5009,榮剛,17,5,12,元大-大天母,2023-09-14,9893
1612,宏泰,11,0,11,元大-大天母,2023-09-14,9893
1522,堤維西,39,28,11,元大-大天母,2023-09-14,9893
3013,晟銘電,13,2,11,元大-大天母,2023-09-14,9893
2880,華南金,12,1,11,元大-大天母,2023-09-14,9893
3178,公準,14,3,11,元大-大天母,2023-09-14,9893
4915,致伸,12,1,11,元大-大天母,2023-09-14,9893
3163,波若威,25,14,11,元大-大天母,2023-09-14,9893
3005,神基,11,1,10,元大-大天母,2023-09-14,9893
3596,智易,10,0,10,元大-大天母,2023-09-14,9893
8240,華宏,10,0,10,元大-大天母,2023-09-14,9893
3338,泰碩,12,2,10,元大-大天母,2023-09-14,9893
2892,第一金,17,8,9,元大-大天母,2023-09-14,9893
2515,中工,9,0,9,元大-大天母,2023-09-14,9893
2006,東和鋼鐵,10,1,9,元大-大天母,2023-09-14,9893
00929,復華台灣科技優息,886,446,440,元大-大天母,2023-09-15,9893
2834,臺企銀,170,1,169,元大-大天母,2023-09-15,9893
8467,波力-KY,114,0,114,元大-大天母,2023-09-15,9893
1605,華新,122,9,113,元大-大天母,2023-09-15,9893
00919,群益台灣精選高息,134,38,96,元大-大天母,2023-09-15,9893
2486,一詮,196,125,71,元大-大天母,2023-09-15,9893
2890,永豐金,71,0,71,元大-大天母,2023-09-15,9893
3047,訊舟,67,0,67,元大-大天母,2023-09-15,9893
00679B,元大美債20年,67,4,63,元大-大天母,2023-09-15,9893
8046,南電,67,11,56,元大-大天母,2023-09-15,9893
00915,凱基優選高股息30,47,1,46,元大-大天母,2023-09-15,9893
2618,長榮航,101,56,45,元大-大天母,2023-09-15,9893
4973,廣穎,40,0,40,元大-大天母,2023-09-15,9893
8016,矽創,40,3,37,元大-大天母,2023-09-15,9893
9938,百和,44,10,34,元大-大天母,2023-09-15,9893
6197,佳必琪,30,0,30,元大-大天母,2023-09-15,9893
3596,智易,39,11,28,元大-大天母,2023-09-15,9893
3048,益登,28,0,28,元大-大天母,2023-09-15,9893
8299,群聯,30,2,28,元大-大天母,2023-09-15,9893
2884,玉山金,29,5,24,元大-大天母,2023-09-15,9893
2891,中信金,37,14,23,元大-大天母,2023-09-15,9893
2615,萬海,34,13,21,元大-大天母,2023-09-15,9893
2356,英業達,51,30,21,元大-大天母,2023-09-15,9893
3669,圓展,20,0,20,元大-大天母,2023-09-15,9893
2002,中鋼,25,6,19,元大-大天母,2023-09-15,9893
3043,科風,21,2,19,元大-大天母,2023-09-15,9893
2605,新興,44,25,19,元大-大天母,2023-09-15,9893
2376,技嘉,20,2,18,元大-大天母,2023-09-15,9893
00931B,統一美債20年,17,0,17,元大-大天母,2023-09-15,9893
1903,士紙,17,0,17,元大-大天母,2023-09-15,9893
2316,楠梓電,16,0,16,元大-大天母,2023-09-15,9893
2801,彰銀,15,0,15,元大-大天母,2023-09-15,9893
00632R,元大台灣50反1,85,70,15,元大-大天母,2023-09-15,9893
2645,長榮航太,15,1,14,元大-大天母,2023-09-15,9893
2610,華航,28,14,14,元大-大天母,2023-09-15,9893
2317,鴻海,14,0,14,元大-大天母,2023-09-15,9893
3028,增你強,14,0,14,元大-大天母,2023-09-15,9893
2888,新光金,15,2,13,元大-大天母,2023-09-15,9893
3035,智原,28,16,12,元大-大天母,2023-09-15,9893
2883,凱基金,12,0,12,元大-大天母,2023-09-15,9893
2880,華南金,12,0,12,元大-大天母,2023-09-15,9893
2608,嘉里大榮,12,0,12,元大-大天母,2023-09-15,9893
00900,富邦特選高股息30,17,5,12,元大-大天母,2023-09-15,9893
6173,信昌電,13,1,12,元大-大天母,2023-09-15,9893
3032,偉訓,13,2,11,元大-大天母,2023-09-15,9893
2498,宏達電,11,0,11,元大-大天母,2023-09-15,9893
2375,凱美,11,0,11,元大-大天母,2023-09-15,9893
2382,廣達,18,8,10,元大-大天母,2023-09-15,9893
00687B,國泰20年美債,10,0,10,元大-大天母,2023-09-15,9893
8049,晶采,10,0,10,元大-大天母,2023-09-15,9893
00929,復華台灣科技優息,401,75,326,元大-大天母,2023-09-18,9893
2801,彰銀,307,0,307,元大-大天母,2023-09-18,9893
00919,群益台灣精選高息,160,1,159,元大-大天母,2023-09-18,9893
2303,聯電,93,2,91,元大-大天母,2023-09-18,9893
3715,定穎投控,164,82,82,元大-大天母,2023-09-18,9893
00679B,元大美債20年,82,2,80,元大-大天母,2023-09-18,9893
00680L,元大美債20正2,80,0,80,元大-大天母,2023-09-18,9893
00751B,元大AAA至A公司債,70,0,70,元大-大天母,2023-09-18,9893
3231,緯創,84,29,55,元大-大天母,2023-09-18,9893
00931B,統一美債20年,51,0,51,元大-大天母,2023-09-18,9893
2890,永豐金,61,15,46,元大-大天母,2023-09-18,9893
9904,寶成,44,1,43,元大-大天母,2023-09-18,9893
00878,國泰永續高股息,43,9,34,元大-大天母,2023-09-18,9893
00918,大華優利高填息30,33,0,33,元大-大天母,2023-09-18,9893
2889,國票金,33,0,33,元大-大天母,2023-09-18,9893
0056,元大高股息,41,9,32,元大-大天母,2023-09-18,9893
2330,台積電,38,7,31,元大-大天母,2023-09-18,9893
00720B,元大投資級公司債,29,0,29,元大-大天母,2023-09-18,9893
3048,益登,29,0,29,元大-大天母,2023-09-18,9893
2606,裕民,30,2,28,元大-大天母,2023-09-18,9893
3037,欣興,38,11,27,元大-大天母,2023-09-18,9893
3047,訊舟,26,0,26,元大-大天母,2023-09-18,9893
2356,英業達,31,7,24,元大-大天母,2023-09-18,9893
2301,光寶科,23,1,22,元大-大天母,2023-09-18,9893
2838,聯邦銀,22,0,22,元大-大天母,2023-09-18,9893
00713,元大台灣高息低波,27,6,21,元大-大天母,2023-09-18,9893
4973,廣穎,20,0,20,元大-大天母,2023-09-18,9893
3438,類比科,20,0,20,元大-大天母,2023-09-18,9893
2488,漢平,20,0,20,元大-大天母,2023-09-18,9893
8234,新漢,20,1,19,元大-大天母,2023-09-18,9893
1340,勝悅-KY,16,0,16,元大-大天母,2023-09-18,9893
00924,復華S＆P500成長,15,0,15,元大-大天母,2023-09-18,9893
1584,精剛,16,1,15,元大-大天母,2023-09-18,9893
2618,長榮航,28,14,14,元大-大天母,2023-09-18,9893
3711,日月光投控,14,0,14,元大-大天母,2023-09-18,9893
00915,凱基優選高股息30,13,0,13,元大-大天母,2023-09-18,9893
00882,中信中國高股息,13,0,13,元大-大天母,2023-09-18,9893
2884,玉山金,19,6,13,元大-大天母,2023-09-18,9893
6288,聯嘉,13,0,13,元大-大天母,2023-09-18,9893
2382,廣達,21,8,13,元大-大天母,2023-09-18,9893
006208,富邦台50,14,1,13,元大-大天母,2023-09-18,9893
3363,上詮,28,16,12,元大-大天母,2023-09-18,9893
2885,元大金,31,19,12,元大-大天母,2023-09-18,9893
2375,凱美,12,1,11,元大-大天母,2023-09-18,9893
6426,統新,11,0,11,元大-大天母,2023-09-18,9893
00795B,中信美國公債20年,11,0,11,元大-大天母,2023-09-18,9893
3481,群創,12,1,11,元大-大天母,2023-09-18,9893
4766,南寶,10,0,10,元大-大天母,2023-09-18,9893
3078,僑威,10,0,10,元大-大天母,2023-09-18,9893
4123,晟德,10,0,10,元大-大天母,2023-09-18,9893
2801,彰銀,312,0,312,元大-大天母,2023-09-19,9893
00929,復華台灣科技優息,273,4,269,元大-大天母,2023-09-19,9893
1712,興農,100,1,99,元大-大天母,2023-09-19,9893
00919,群益台灣精選高息,72,7,65,元大-大天母,2023-09-19,9893
4958,臻鼎-KY,64,1,63,元大-大天母,2023-09-19,9893
3059,華晶科,63,0,63,元大-大天母,2023-09-19,9893
1802,台玻,72,12,60,元大-大天母,2023-09-19,9893
2890,永豐金,62,12,50,元大-大天母,2023-09-19,9893
2376,技嘉,56,18,38,元大-大天母,2023-09-19,9893
3047,訊舟,37,0,37,元大-大天母,2023-09-19,9893
3037,欣興,47,15,32,元大-大天母,2023-09-19,9893
3048,益登,30,0,30,元大-大天母,2023-09-19,9893
2605,新興,36,7,29,元大-大天母,2023-09-19,9893
00932,兆豐永續高息等權,27,0,27,元大-大天母,2023-09-19,9893
3163,波若威,36,9,27,元大-大天母,2023-09-19,9893
3669,圓展,25,0,25,元大-大天母,2023-09-19,9893
2329,華泰,51,28,23,元大-大天母,2023-09-19,9893
00921,兆豐龍頭等權重,23,0,23,元大-大天母,2023-09-19,9893
2618,長榮航,29,6,23,元大-大天母,2023-09-19,9893
2356,英業達,30,8,22,元大-大天母,2023-09-19,9893
2498,宏達電,20,0,20,元大-大天母,2023-09-19,9893
00636,國泰中國A50,20,0,20,元大-大天母,2023-09-19,9893
00752,中信中國50,20,0,20,元大-大天母,2023-09-19,9893
2615,萬海,21,1,20,元大-大天母,2023-09-19,9893
00878,國泰永續高股息,24,4,20,元大-大天母,2023-09-19,9893
00882,中信中國高股息,19,0,19,元大-大天母,2023-09-19,9893
2606,裕民,20,2,18,元大-大天母,2023-09-19,9893
1524,耿鼎,20,3,17,元大-大天母,2023-09-19,9893
6266,泰詠,20,3,17,元大-大天母,2023-09-19,9893
3231,緯創,80,64,16,元大-大天母,2023-09-19,9893
2330,台積電,17,1,16,元大-大天母,2023-09-19,9893
8358,金居,16,1,15,元大-大天母,2023-09-19,9893
1815,富喬,20,6,14,元大-大天母,2023-09-19,9893
3078,僑威,16,2,14,元大-大天母,2023-09-19,9893
6173,信昌電,14,0,14,元大-大天母,2023-09-19,9893
2393,億光,13,0,13,元大-大天母,2023-09-19,9893
6288,聯嘉,13,0,13,元大-大天母,2023-09-19,9893
3028,增你強,13,0,13,元大-大天母,2023-09-19,9893
6285,啟��,18,5,13,元大-大天母,2023-09-19,9893
3035,智原,17,5,12,元大-大天母,2023-09-19,9893
2331,精英,15,3,12,元大-大天母,2023-09-19,9893
2536,宏普,11,0,11,元大-大天母,2023-09-19,9893
3260,威剛,13,3,10,元大-大天母,2023-09-19,9893
6150,撼訊,25,15,10,元大-大天母,2023-09-19,9893
1522,堤維西,20,10,10,元大-大天母,2023-09-19,9893
3680,家登,11,1,10,元大-大天母,2023-09-19,9893
5355,佳總,10,0,10,元大-大天母,2023-09-19,9893
6108,競國,10,0,10,元大-大天母,2023-09-19,9893
5284,jpp-KY,10,0,10,元大-大天母,2023-09-19,9893
5521,工信,10,0,10,元大-大天母,2023-09-19,9893
00929,復華台灣科技優息,898,501,397,元大-大天母,2023-09-20,9893
2367,燿華,168,64,104,元大-大天母,2023-09-20,9893
00919,群益台灣精選高息,71,6,65,元大-大天母,2023-09-20,9893
00715L,期街口布蘭特正2,65,0,65,元大-大天母,2023-09-20,9893
00650L,復華香港正2,50,0,50,元大-大天母,2023-09-20,9893
2637,慧洋-KY,37,2,35,元大-大天母,2023-09-20,9893
1605,華新,40,5,35,元大-大天母,2023-09-20,9893
3048,益登,35,0,35,元大-大天母,2023-09-20,9893
2885,元大金,38,6,32,元大-大天母,2023-09-20,9893
1340,勝悅-KY,30,0,30,元大-大天母,2023-09-20,9893
2328,廣宇,29,0,29,元大-大天母,2023-09-20,9893
2883,凱基金,29,0,29,元大-大天母,2023-09-20,9893
1101,台泥,29,0,29,元大-大天母,2023-09-20,9893
2330,台積電,30,1,29,元大-大天母,2023-09-20,9893
2329,華泰,49,22,27,元大-大天母,2023-09-20,9893
00931B,統一美債20年,27,0,27,元大-大天母,2023-09-20,9893
3265,台星科,40,19,21,元大-大天母,2023-09-20,9893
2301,光寶科,25,4,21,元大-大天母,2023-09-20,9893
00915,凱基優選高股息30,21,0,21,元大-大天母,2023-09-20,9893
3481,群創,21,0,21,元大-大天母,2023-09-20,9893
8034,榮群,35,15,20,元大-大天母,2023-09-20,9893
6245,立端,20,0,20,元大-大天母,2023-09-20,9893
8085,福華,20,0,20,元大-大天母,2023-09-20,9893
00751B,元大AAA至A公司債,17,0,17,元大-大天母,2023-09-20,9893
3037,欣興,24,8,16,元大-大天母,2023-09-20,9893
1477,聚陽,17,1,16,元大-大天母,2023-09-20,9893
2201,裕隆,19,3,16,元大-大天母,2023-09-20,9893
2601,益航,21,6,15,元大-大天母,2023-09-20,9893
00932,兆豐永續高息等權,15,0,15,元大-大天母,2023-09-20,9893
1795,美時,15,1,14,元大-大天母,2023-09-20,9893
8054,安國,19,5,14,元大-大天母,2023-09-20,9893
00878,國泰永續高股息,23,10,13,元大-大天母,2023-09-20,9893
00637L,元大滬深300正2,25,12,13,元大-大天母,2023-09-20,9893
1809,中釉,15,2,13,元大-大天母,2023-09-20,9893
8110,華東,13,0,13,元大-大天母,2023-09-20,9893
2449,京元電子,49,37,12,元大-大天母,2023-09-20,9893
6901,鑽石投資,13,2,11,元大-大天母,2023-09-20,9893
2409,友達,13,2,11,元大-大天母,2023-09-20,9893
3059,華晶科,12,1,11,元大-大天母,2023-09-20,9893
2303,聯電,24,14,10,元大-大天母,2023-09-20,9893
2382,廣達,223,213,10,元大-大天母,2023-09-20,9893
2332,友訊,10,0,10,元大-大天母,2023-09-20,9893
3011,今皓,10,0,10,元大-大天母,2023-09-20,9893
00679B,元大美債20年,16,6,10,元大-大天母,2023-09-20,9893
2025,千興,10,0,10,元大-大天母,2023-09-20,9893
4306,炎洲,10,0,10,元大-大天母,2023-09-20,9893
3709,鑫聯大投控,11,1,10,元大-大天母,2023-09-20,9893
3005,神基,12,2,10,元大-大天母,2023-09-20,9893
00738U,期元大道瓊白銀,10,0,10,元大-大天母,2023-09-20,9893
2511,太子,10,0,10,元大-大天母,2023-09-20,9893
1809,中釉,321,22,299,元大-大天母,2023-09-21,9893
00929,復華台灣科技優息,747,467,280,元大-大天母,2023-09-21,9893
2891,中信金,142,0,142,元大-大天母,2023-09-21,9893
1101,台泥,155,20,135,元大-大天母,2023-09-21,9893
2890,永豐金,115,0,115,元大-大天母,2023-09-21,9893
00650L,復華香港正2,70,0,70,元大-大天母,2023-09-21,9893
0050,元大台灣50,53,0,53,元大-大天母,2023-09-21,9893
2027,大成鋼,49,0,49,元大-大天母,2023-09-21,9893
2367,燿華,53,9,44,元大-大天母,2023-09-21,9893
00881,國泰台灣5G+,42,0,42,元大-大天母,2023-09-21,9893
00680L,元大美債20正2,41,0,41,元大-大天母,2023-09-21,9893
2330,台積電,48,7,41,元大-大天母,2023-09-21,9893
2328,廣宇,39,0,39,元大-大天母,2023-09-21,9893
6153,嘉聯益,38,0,38,元大-大天母,2023-09-21,9893
2885,元大金,44,14,30,元大-大天母,2023-09-21,9893
00679B,元大美債20年,29,0,29,元大-大天母,2023-09-21,9893
3048,益登,26,0,26,元大-大天母,2023-09-21,9893
3078,僑威,28,2,26,元大-大天母,2023-09-21,9893
8069,元太,26,2,24,元大-大天母,2023-09-21,9893
2201,裕隆,27,3,24,元大-大天母,2023-09-21,9893
00673R,期元大S＆P原油反1,23,0,23,元大-大天母,2023-09-21,9893
6245,立端,22,0,22,元大-大天母,2023-09-21,9893
0056,元大高股息,39,18,21,元大-大天母,2023-09-21,9893
1702,南僑,21,0,21,元大-大天母,2023-09-21,9893
2637,慧洋-KY,21,0,21,元大-大天母,2023-09-21,9893
2354,鴻準,28,7,21,元大-大天母,2023-09-21,9893
00631L,元大台灣50正2,20,0,20,元大-大天母,2023-09-21,9893
1903,士紙,20,0,20,元大-大天母,2023-09-21,9893
5258,虹堡,20,0,20,元大-大天母,2023-09-21,9893
2707,晶華,20,0,20,元大-大天母,2023-09-21,9893
2882,國泰金,20,1,19,元大-大天母,2023-09-21,9893
8112,至上,21,2,19,元大-大天母,2023-09-21,9893
2834,臺企銀,25,6,19,元大-大天母,2023-09-21,9893
2317,鴻海,21,2,19,元大-大天母,2023-09-21,9893
5880,合庫金,18,0,18,元大-大天母,2023-09-21,9893
2892,第一金,31,15,16,元大-大天母,2023-09-21,9893
8085,福華,16,0,16,元大-大天母,2023-09-21,9893
2344,華邦電,32,16,16,元大-大天母,2023-09-21,9893
2883,凱基金,15,1,14,元大-大天母,2023-09-21,9893
4977,眾達-KY,15,1,14,元大-大天母,2023-09-21,9893
3605,宏致,14,0,14,元大-大天母,2023-09-21,9893
00932,兆豐永續高息等權,14,0,14,元大-大天母,2023-09-21,9893
5471,松翰,13,0,13,元大-大天母,2023-09-21,9893
2467,志聖,13,0,13,元大-大天母,2023-09-21,9893
5009,榮剛,13,0,13,元大-大天母,2023-09-21,9893
2211,長榮鋼,15,2,13,元大-大天母,2023-09-21,9893
00922,國泰台灣領袖50,13,0,13,元大-大天母,2023-09-21,9893
00918,大華優利高填息30,13,0,13,元大-大天母,2023-09-21,9893
1522,堤維西,14,2,12,元大-大天母,2023-09-21,9893
2610,華航,18,7,11,元大-大天母,2023-09-21,9893
2801,彰銀,202,0,202,元大-大天母,2023-09-22,9893
00679B,元大美債20年,184,14,170,元大-大天母,2023-09-22,9893
2891,中信金,141,0,141,元大-大天母,2023-09-22,9893
00929,復華台灣科技優息,109,2,107,元大-大天母,2023-09-22,9893
1444,力麗,107,3,104,元大-大天母,2023-09-22,9893
00688L,國泰20年美債正2,102,0,102,元大-大天母,2023-09-22,9893
2885,元大金,98,2,96,元大-大天母,2023-09-22,9893
00720B,元大投資級公司債,81,0,81,元大-大天母,2023-09-22,9893
00751B,元大AAA至A公司債,72,0,72,元大-大天母,2023-09-22,9893
2303,聯電,72,9,63,元大-大天母,2023-09-22,9893
00931B,統一美債20年,59,0,59,元大-大天母,2023-09-22,9893
6168,宏齊,56,5,51,元大-大天母,2023-09-22,9893
1101,台泥,36,1,35,元大-大天母,2023-09-22,9893
2330,台積電,39,5,34,元大-大天母,2023-09-22,9893
00772B,中信高評級公司債,33,0,33,元大-大天母,2023-09-22,9893
2367,燿華,32,0,32,元大-大天母,2023-09-22,9893
00712,復華富時不動產,31,0,31,元大-大天母,2023-09-22,9893
3011,今皓,30,0,30,元大-大天母,2023-09-22,9893
00680L,元大美債20正2,29,0,29,元大-大天母,2023-09-22,9893
3706,神達,53,25,28,元大-大天母,2023-09-22,9893
3036,文曄,58,31,27,元大-大天母,2023-09-22,9893
8467,波力-KY,26,0,26,元大-大天母,2023-09-22,9893
0050,元大台灣50,27,1,26,元大-大天母,2023-09-22,9893
00919,群益台灣精選高息,28,5,23,元大-大天母,2023-09-22,9893
2316,楠梓電,25,4,21,元大-大天母,2023-09-22,9893
6155,鈞寶,30,9,21,元大-大天母,2023-09-22,9893
3048,益登,20,0,20,元大-大天母,2023-09-22,9893
4919,新唐,21,1,20,元大-大天母,2023-09-22,9893
2399,映泰,20,0,20,元大-大天母,2023-09-22,9893
2027,大成鋼,20,0,20,元大-大天母,2023-09-22,9893
2618,長榮航,59,40,19,元大-大天母,2023-09-22,9893
2468,華經,24,7,17,元大-大天母,2023-09-22,9893
2882,國泰金,16,0,16,元大-大天母,2023-09-22,9893
6282,康舒,17,1,16,元大-大天母,2023-09-22,9893
00687B,國泰20年美債,15,0,15,元大-大天母,2023-09-22,9893
2888,新光金,15,0,15,元大-大天母,2023-09-22,9893
6278,台表科,16,1,15,元大-大天母,2023-09-22,9893
6443,元晶,15,1,14,元大-大天母,2023-09-22,9893
4979,華星光,47,34,13,元大-大天母,2023-09-22,9893
2337,旺宏,12,1,11,元大-大天母,2023-09-22,9893
4766,南寶,11,0,11,元大-大天母,2023-09-22,9893
2610,華航,27,16,11,元大-大天母,2023-09-22,9893
6670,復盛應用,10,0,10,元大-大天母,2023-09-22,9893
8046,南電,10,0,10,元大-大天母,2023-09-22,9893
00753L,中信中國50正2,15,5,10,元大-大天母,2023-09-22,9893
2548,華固,10,0,10,元大-大天母,2023-09-22,9893
00673R,期元大S＆P原油反1,10,0,10,元大-大天母,2023-09-22,9893
2883B,凱基金乙特,10,0,10,元大-大天母,2023-09-22,9893
00928,中信上櫃ESG30,10,0,10,元大-大天母,2023-09-22,9893
2881,富邦金,10,0,10,元大-大天母,2023-09-22,9893
00665L,富邦�琤肭磪囓�2,301,1,300,元大-大天母,2023-09-25,9893
2883,凱基金,271,0,271,元大-大天母,2023-09-25,9893
6274,台燿,210,7,203,元大-大天母,2023-09-25,9893
1101,台泥,111,0,111,元大-大天母,2023-09-25,9893
5284,jpp-KY,90,5,85,元大-大天母,2023-09-25,9893
00929,復華台灣科技優息,98,19,79,元大-大天母,2023-09-25,9893
00919,群益台灣精選高息,76,0,76,元大-大天母,2023-09-25,9893
6168,宏齊,68,2,66,元大-大天母,2023-09-25,9893
3048,益登,40,0,40,元大-大天母,2023-09-25,9893
6245,立端,43,4,39,元大-大天母,2023-09-25,9893
2363,矽統,51,15,36,元大-大天母,2023-09-25,9893
00719B,元大美債1-3,31,0,31,元大-大天母,2023-09-25,9893
00679B,元大美債20年,30,0,30,元大-大天母,2023-09-25,9893
9938,百和,30,1,29,元大-大天母,2023-09-25,9893
2367,燿華,29,3,26,元大-大天母,2023-09-25,9893
00753L,中信中國50正2,25,0,25,元大-大天母,2023-09-25,9893
3363,上詮,53,29,24,元大-大天母,2023-09-25,9893
2317,鴻海,24,0,24,元大-大天母,2023-09-25,9893
2882,國泰金,21,0,21,元大-大天母,2023-09-25,9893
1909,榮成,20,0,20,元大-大天母,2023-09-25,9893
5432,新門,20,0,20,元大-大天母,2023-09-25,9893
6216,居易,20,0,20,元大-大天母,2023-09-25,9893
00878,國泰永續高股息,33,14,19,元大-大天母,2023-09-25,9893
8928,鉅明,19,0,19,元大-大天母,2023-09-25,9893
2449,京元電子,23,5,18,元大-大天母,2023-09-25,9893
2610,華航,15,0,15,元大-大天母,2023-09-25,9893
2344,華邦電,33,18,15,元大-大天母,2023-09-25,9893
1447,力鵬,15,0,15,元大-大天母,2023-09-25,9893
3706,神達,33,19,14,元大-大天母,2023-09-25,9893
00795B,中信美國公債20年,14,0,14,元大-大天母,2023-09-25,9893
00751B,元大AAA至A公司債,14,1,13,元大-大天母,2023-09-25,9893
6275,元山,13,0,13,元大-大天母,2023-09-25,9893
00921,兆豐龍頭等權重,12,0,12,元大-大天母,2023-09-25,9893
00931B,統一美債20年,11,0,11,元大-大天母,2023-09-25,9893
2330,台積電,14,3,11,元大-大天母,2023-09-25,9893
3605,宏致,10,0,10,元大-大天母,2023-09-25,9893
6552,易華電,10,0,10,元大-大天母,2023-09-25,9893
00772B,中信高評級公司債,11,1,10,元大-大天母,2023-09-25,9893
2425,承啟,11,1,10,元大-大天母,2023-09-25,9893
0050,元大台灣50,9,0,9,元大-大天母,2023-09-25,9893
3338,泰碩,11,2,9,元大-大天母,2023-09-25,9893
8016,矽創,10,1,9,元大-大天母,2023-09-25,9893
2377,微星,8,0,8,元大-大天母,2023-09-25,9893
6442,光聖,22,14,8,元大-大天母,2023-09-25,9893
2313,華通,17,9,8,元大-大天母,2023-09-25,9893
2388,威盛,20,12,8,元大-大天母,2023-09-25,9893
6125,廣運,7,0,7,元大-大天母,2023-09-25,9893
00712,復華富時不動產,9,2,7,元大-大天母,2023-09-25,9893
8034,榮群,8,1,7,元大-大天母,2023-09-25,9893
2615,萬海,8,1,7,元大-大天母,2023-09-25,9893
2801,彰銀,301,0,301,元大-大天母,2023-09-26,9893
00679B,元大美債20年,182,1,181,元大-大天母,2023-09-26,9893
00671R,富邦NASDAQ反1,100,0,100,元大-大天母,2023-09-26,9893
6806,森崴能源,105,9,96,元大-大天母,2023-09-26,9893
2883,凱基金,91,1,90,元大-大天母,2023-09-26,9893
00680L,元大美債20正2,68,0,68,元大-大天母,2023-09-26,9893
6168,宏齊,62,1,61,元大-大天母,2023-09-26,9893
2303,聯電,72,18,54,元大-大天母,2023-09-26,9893
3711,日月光投控,49,0,49,元大-大天母,2023-09-26,9893
2317,鴻海,40,0,40,元大-大天母,2023-09-26,9893
00929,復華台灣科技優息,61,21,40,元大-大天母,2023-09-26,9893
00751B,元大AAA至A公司債,49,11,38,元大-大天母,2023-09-26,9893
2002,中鋼,33,0,33,元大-大天母,2023-09-26,9893
2880,華南金,33,0,33,元大-大天母,2023-09-26,9893
0050,元大台灣50,32,0,32,元大-大天母,2023-09-26,9893
00919,群益台灣精選高息,31,0,31,元大-大天母,2023-09-26,9893
1802,台玻,30,0,30,元大-大天母,2023-09-26,9893
1522,堤維西,45,16,29,元大-大天母,2023-09-26,9893
00720B,元大投資級公司債,28,0,28,元大-大天母,2023-09-26,9893
00632R,元大台灣50反1,50,23,27,元大-大天母,2023-09-26,9893
2330,台積電,33,8,25,元大-大天母,2023-09-26,9893
00931B,統一美債20年,22,0,22,元大-大天母,2023-09-26,9893
2542,興富發,23,1,22,元大-大天母,2023-09-26,9893
2376,技嘉,26,7,19,元大-大天母,2023-09-26,9893
1101,台泥,32,13,19,元大-大天母,2023-09-26,9893
00878,國泰永續高股息,21,3,18,元大-大天母,2023-09-26,9893
00915,凱基優選高股息30,17,0,17,元大-大天母,2023-09-26,9893
2337,旺宏,18,1,17,元大-大天母,2023-09-26,9893
1903,士紙,16,0,16,元大-大天母,2023-09-26,9893
2363,矽統,54,39,15,元大-大天母,2023-09-26,9893
2888,新光金,15,0,15,元大-大天母,2023-09-26,9893
2892,第一金,22,8,14,元大-大天母,2023-09-26,9893
00772B,中信高評級公司債,23,10,13,元大-大天母,2023-09-26,9893
00905,FT臺灣Smart,13,0,13,元大-大天母,2023-09-26,9893
2641,正德,12,0,12,元大-大天母,2023-09-26,9893
5381,合正,13,1,12,元大-大天母,2023-09-26,9893
6531,愛普*,14,3,11,元大-大天母,2023-09-26,9893
3034,聯詠,11,0,11,元大-大天母,2023-09-26,9893
00719B,元大美債1-3,11,0,11,元大-大天母,2023-09-26,9893
8112,至上,11,0,11,元大-大天母,2023-09-26,9893
3715,定穎投控,82,71,11,元大-大天母,2023-09-26,9893
1447,力鵬,25,15,10,元大-大天母,2023-09-26,9893
2883B,凱基金乙特,10,0,10,元大-大天母,2023-09-26,9893
1611,中電,10,0,10,元大-大天母,2023-09-26,9893
00882,中信中國高股息,10,0,10,元大-大天母,2023-09-26,9893
4919,新唐,10,0,10,元大-大天母,2023-09-26,9893
8046,南電,10,0,10,元大-大天母,2023-09-26,9893
4961,天鈺,11,1,10,元大-大天母,2023-09-26,9893
0056,元大高股息,20,11,9,元大-大天母,2023-09-26,9893
00687B,國泰20年美債,10,1,9,元大-大天母,2023-09-26,9893
2002,中鋼,239,92,147,元大-大天母,2023-09-27,9893
00929,復華台灣科技優息,107,10,97,元大-大天母,2023-09-27,9893
1815,富喬,84,5,79,元大-大天母,2023-09-27,9893
00919,群益台灣精選高息,43,1,42,元大-大天母,2023-09-27,9893
0056,元大高股息,58,17,41,元大-大天母,2023-09-27,9893
00676R,富邦臺灣加權反1,40,0,40,元大-大天母,2023-09-27,9893
00632R,元大台灣50反1,40,0,40,元大-大天母,2023-09-27,9893
6128,上福,30,1,29,元大-大天母,2023-09-27,9893
6168,宏齊,29,0,29,元大-大天母,2023-09-27,9893
6235,華孚,29,5,24,元大-大天母,2023-09-27,9893
2303,聯電,67,47,20,元大-大天母,2023-09-27,9893
2891,中信金,27,7,20,元大-大天母,2023-09-27,9893
1312,國喬,20,0,20,元大-大天母,2023-09-27,9893
2337,旺宏,20,3,17,元大-大天母,2023-09-27,9893
3048,益登,17,0,17,元大-大天母,2023-09-27,9893
3630,新鉅科,20,4,16,元大-大天母,2023-09-27,9893
2211,長榮鋼,16,0,16,元大-大天母,2023-09-27,9893
1609,大亞,35,22,13,元大-大天母,2023-09-27,9893
4961,天鈺,15,2,13,元大-大天母,2023-09-27,9893
1513,中興電,15,2,13,元大-大天母,2023-09-27,9893
1522,堤維西,17,5,12,元大-大天母,2023-09-27,9893
00751B,元大AAA至A公司債,12,0,12,元大-大天母,2023-09-27,9893
00878,國泰永續高股息,26,15,11,元大-大天母,2023-09-27,9893
6288,聯嘉,11,0,11,元大-大天母,2023-09-27,9893
00720B,元大投資級公司債,17,7,10,元大-大天母,2023-09-27,9893
6155,鈞寶,10,0,10,元大-大天母,2023-09-27,9893
6122,擎邦,10,0,10,元大-大天母,2023-09-27,9893
3013,晟銘電,11,1,10,元大-大天母,2023-09-27,9893
1229,聯華,10,0,10,元大-大天母,2023-09-27,9893
2641,正德,10,0,10,元大-大天母,2023-09-27,9893
2455,全新,10,0,10,元大-大天母,2023-09-27,9893
6139,亞翔,20,11,9,元大-大天母,2023-09-27,9893
00712,復華富時不動產,12,3,9,元大-大天母,2023-09-27,9893
0050,元大台灣50,9,1,8,元大-大天母,2023-09-27,9893
1101,台泥,8,0,8,元大-大天母,2023-09-27,9893
5347,世界,8,0,8,元大-大天母,2023-09-27,9893
1612,宏泰,19,11,8,元大-大天母,2023-09-27,9893
2605,新興,8,0,8,元大-大天母,2023-09-27,9893
4147,中裕,8,0,8,元大-大天母,2023-09-27,9893
00932,兆豐永續高息等權,8,0,8,元大-大天母,2023-09-27,9893
8088,品安,8,1,7,元大-大天母,2023-09-27,9893
1809,中釉,9,2,7,元大-大天母,2023-09-27,9893
2313,華通,9,2,7,元大-大天母,2023-09-27,9893
1301,台塑,7,0,7,元大-大天母,2023-09-27,9893
2317,鴻海,7,1,6,元大-大天母,2023-09-27,9893
4979,華星光,53,47,6,元大-大天母,2023-09-27,9893
00708L,期元大S＆P黃金正2,6,0,6,元大-大天母,2023-09-27,9893
3071,協禧,6,0,6,元大-大天母,2023-09-27,9893
2892,第一金,7,2,5,元大-大天母,2023-09-27,9893
2881,富邦金,6,1,5,元大-大天母,2023-09-27,9893
2002,中鋼,182,39,143,元大-大天母,2023-09-28,9893
3231,緯創,153,48,105,元大-大天母,2023-09-28,9893
00665L,富邦�琤肭磪囓�2,80,0,80,元大-大天母,2023-09-28,9893
2885,元大金,91,15,76,元大-大天母,2023-09-28,9893
2344,華邦電,77,2,75,元大-大天母,2023-09-28,9893
00720B,元大投資級公司債,56,0,56,元大-大天母,2023-09-28,9893
00676R,富邦臺灣加權反1,50,0,50,元大-大天母,2023-09-28,9893
00688L,國泰20年美債正2,50,0,50,元大-大天母,2023-09-28,9893
00679B,元大美債20年,51,2,49,元大-大天母,2023-09-28,9893
00772B,中信高評級公司債,60,15,45,元大-大天母,2023-09-28,9893
3715,定穎投控,95,56,39,元大-大天母,2023-09-28,9893
6168,宏齊,37,0,37,元大-大天母,2023-09-28,9893
00929,復華台灣科技優息,41,5,36,元大-大天母,2023-09-28,9893
2538,基泰,35,0,35,元大-大天母,2023-09-28,9893
00795B,中信美國公債20年,37,5,32,元大-大天母,2023-09-28,9893
2891,中信金,31,0,31,元大-大天母,2023-09-28,9893
2329,華泰,55,27,28,元大-大天母,2023-09-28,9893
2408,南亞科,27,2,25,元大-大天母,2023-09-28,9893
2605,新興,35,10,25,元大-大天母,2023-09-28,9893
6271,同欣電,32,10,22,元大-大天母,2023-09-28,9893
1210,大成,20,0,20,元大-大天母,2023-09-28,9893
00905,FT臺灣Smart,21,1,20,元大-大天母,2023-09-28,9893
8358,金居,18,0,18,元大-大天母,2023-09-28,9893
00673R,期元大S＆P原油反1,17,0,17,元大-大天母,2023-09-28,9893
8299,群聯,16,0,16,元大-大天母,2023-09-28,9893
3105,穩懋,15,1,14,元大-大天母,2023-09-28,9893
1101,台泥,13,0,13,元大-大天母,2023-09-28,9893
3037,欣興,13,0,13,元大-大天母,2023-09-28,9893
00931B,統一美債20年,14,1,13,元大-大天母,2023-09-28,9893
2610,華航,13,0,13,元大-大天母,2023-09-28,9893
3481,群創,12,0,12,元大-大天母,2023-09-28,9893
2317,鴻海,12,0,12,元大-大天母,2023-09-28,9893
2886,兆豐金,12,0,12,元大-大天母,2023-09-28,9893
4987,科誠,11,0,11,元大-大天母,2023-09-28,9893
2208,台船,10,0,10,元大-大天母,2023-09-28,9893
00919,群益台灣精選高息,9,0,9,元大-大天母,2023-09-28,9893
8088,品安,12,3,9,元大-大天母,2023-09-28,9893
3317,尼克森,9,0,9,元大-大天母,2023-09-28,9893
3006,晶豪科,10,2,8,元大-大天母,2023-09-28,9893
00680L,元大美債20正2,8,0,8,元大-大天母,2023-09-28,9893
2353,宏��,8,0,8,元大-大天母,2023-09-28,9893
00751B,元大AAA至A公司債,7,0,7,元大-大天母,2023-09-28,9893
2356,英業達,13,6,7,元大-大天母,2023-09-28,9893
2388,威盛,9,2,7,元大-大天母,2023-09-28,9893
6235,華孚,14,7,7,元大-大天母,2023-09-28,9893
9945,潤泰新,7,0,7,元大-大天母,2023-09-28,9893
2363,矽統,55,48,7,元大-大天母,2023-09-28,9893
2308,台達電,6,0,6,元大-大天母,2023-09-28,9893
3376,新日興,6,0,6,元大-大天母,2023-09-28,9893
2618,長榮航,11,5,6,元大-大天母,2023-09-28,9893
3450,聯鈞,214,11,203,元大-大天母,2023-10-02,9893
00688L,國泰20年美債正2,68,0,68,元大-大天母,2023-10-02,9893
00720B,元大投資級公司債,57,5,52,元大-大天母,2023-10-02,9893
2885,元大金,47,0,47,元大-大天母,2023-10-02,9893
2363,矽統,68,22,46,元大-大天母,2023-10-02,9893
6274,台燿,69,26,43,元大-大天母,2023-10-02,9893
2409,友達,41,3,38,元大-大天母,2023-10-02,9893
00715L,期街口布蘭特正2,36,0,36,元大-大天母,2023-10-02,9893
5464,霖宏,35,0,35,元大-大天母,2023-10-02,9893
00919,群益台灣精選高息,30,1,29,元大-大天母,2023-10-02,9893
5426,振發,30,3,27,元大-大天母,2023-10-02,9893
3483,力致,29,4,25,元大-大天母,2023-10-02,9893
3325,旭品,30,6,24,元大-大天母,2023-10-02,9893
4923,力士,22,0,22,元大-大天母,2023-10-02,9893
2323,中環,21,0,21,元大-大天母,2023-10-02,9893
6443,元晶,20,0,20,元大-大天母,2023-10-02,9893
3580,友威科,20,0,20,元大-大天母,2023-10-02,9893
00679B,元大美債20年,30,11,19,元大-大天母,2023-10-02,9893
3481,群創,112,95,17,元大-大天母,2023-10-02,9893
00676R,富邦臺灣加權反1,17,0,17,元大-大天母,2023-10-02,9893
6125,廣運,22,5,17,元大-大天母,2023-10-02,9893
00751B,元大AAA至A公司債,16,0,16,元大-大天母,2023-10-02,9893
2313,華通,23,7,16,元大-大天母,2023-10-02,9893
2002,中鋼,23,8,15,元大-大天母,2023-10-02,9893
2888,新光金,15,0,15,元大-大天母,2023-10-02,9893
2344,華邦電,21,6,15,元大-大天母,2023-10-02,9893
00673R,期元大S＆P原油反1,20,6,14,元大-大天母,2023-10-02,9893
2634,漢翔,17,4,13,元大-大天母,2023-10-02,9893
2316,楠梓電,18,6,12,元大-大天母,2023-10-02,9893
3105,穩懋,12,0,12,元大-大天母,2023-10-02,9893
2208,台船,11,0,11,元大-大天母,2023-10-02,9893
5452,佶優,11,0,11,元大-大天母,2023-10-02,9893
2609,陽明,15,4,11,元大-大天母,2023-10-02,9893
2337,旺宏,14,3,11,元大-大天母,2023-10-02,9893
00931B,統一美債20年,11,0,11,元大-大天母,2023-10-02,9893
5521,工信,10,0,10,元大-大天母,2023-10-02,9893
00772B,中信高評級公司債,9,0,9,元大-大天母,2023-10-02,9893
3363,上詮,21,12,9,元大-大天母,2023-10-02,9893
2884,玉山金,8,0,8,元大-大天母,2023-10-02,9893
00674R,期元大S＆P黃金反1,8,0,8,元大-大天母,2023-10-02,9893
1215,卜蜂,8,0,8,元大-大天母,2023-10-02,9893
3231,緯創,174,167,7,元大-大天母,2023-10-02,9893
5880,合庫金,7,0,7,元大-大天母,2023-10-02,9893
2887,台新金,7,0,7,元大-大天母,2023-10-02,9893
1471,首利,9,2,7,元大-大天母,2023-10-02,9893
2892,第一金,8,1,7,元大-大天母,2023-10-02,9893
2376,技嘉,26,19,7,元大-大天母,2023-10-02,9893
8996,高力,8,1,7,元大-大天母,2023-10-02,9893
2801,彰銀,6,0,6,元大-大天母,2023-10-02,9893
3051,力特,10,4,6,元大-大天母,2023-10-02,9893
6274,台燿,301,18,283,元大-大天母,2023-10-03,9893
2323,中環,180,0,180,元大-大天母,2023-10-03,9893
00665L,富邦�琤肭磪囓�2,166,0,166,元大-大天母,2023-10-03,9893
0056,元大高股息,153,1,152,元大-大天母,2023-10-03,9893
3231,緯創,327,199,128,元大-大天母,2023-10-03,9893
2002,中鋼,121,11,110,元大-大天母,2023-10-03,9893
2885,元大金,80,0,80,元大-大天母,2023-10-03,9893
00929,復華台灣科技優息,234,163,71,元大-大天母,2023-10-03,9893
00715L,期街口布蘭特正2,62,0,62,元大-大天母,2023-10-03,9893
1815,富喬,73,12,61,元大-大天母,2023-10-03,9893
6117,迎廣,61,1,60,元大-大天母,2023-10-03,9893
00713,元大台灣高息低波,52,0,52,元大-大天母,2023-10-03,9893
00650L,復華香港正2,50,0,50,元大-大天母,2023-10-03,9893
00664R,國泰臺灣加權反1,45,0,45,元大-大天母,2023-10-03,9893
2409,友達,65,23,42,元大-大天母,2023-10-03,9893
8088,品安,48,10,38,元大-大天母,2023-10-03,9893
00918,大華優利高填息30,36,0,36,元大-大天母,2023-10-03,9893
00919,群益台灣精選高息,71,37,34,元大-大天母,2023-10-03,9893
00922,國泰台灣領袖50,34,0,34,元大-大天母,2023-10-03,9893
6168,宏齊,261,227,34,元大-大天母,2023-10-03,9893
00882,中信中國高股息,31,0,31,元大-大天母,2023-10-03,9893
4977,眾達-KY,38,7,31,元大-大天母,2023-10-03,9893
2382,廣達,43,15,28,元大-大天母,2023-10-03,9893
00720B,元大投資級公司債,39,13,26,元大-大天母,2023-10-03,9893
00931B,統一美債20年,30,5,25,元大-大天母,2023-10-03,9893
2891,中信金,26,1,25,元大-大天母,2023-10-03,9893
3078,僑威,28,3,25,元大-大天母,2023-10-03,9893
1603,華電,30,6,24,元大-大天母,2023-10-03,9893
3715,定穎投控,43,19,24,元大-大天母,2023-10-03,9893
00878,國泰永續高股息,29,6,23,元大-大天母,2023-10-03,9893
3481,群創,23,0,23,元大-大天母,2023-10-03,9893
8112,至上,31,8,23,元大-大天母,2023-10-03,9893
2201,裕隆,29,6,23,元大-大天母,2023-10-03,9893
2317,鴻海,29,7,22,元大-大天母,2023-10-03,9893
1301,台塑,22,0,22,元大-大天母,2023-10-03,9893
2882,國泰金,20,0,20,元大-大天母,2023-10-03,9893
9930,中聯資源,20,0,20,元大-大天母,2023-10-03,9893
3552,同致,20,0,20,元大-大天母,2023-10-03,9893
2230,泰茂,21,3,18,元大-大天母,2023-10-03,9893
6235,華孚,22,7,15,元大-大天母,2023-10-03,9893
2356,英業達,15,1,14,元大-大天母,2023-10-03,9893
5483,中美晶,14,0,14,元大-大天母,2023-10-03,9893
1609,大亞,16,2,14,元大-大天母,2023-10-03,9893
1303,南亞,14,0,14,元大-大天母,2023-10-03,9893
2603,長榮,18,5,13,元大-大天母,2023-10-03,9893
00679B,元大美債20年,13,0,13,元大-大天母,2023-10-03,9893
2883,凱基金,13,0,13,元大-大天母,2023-10-03,9893
6213,聯茂,16,3,13,元大-大天母,2023-10-03,9893
1605,華新,12,0,12,元大-大天母,2023-10-03,9893
2427,三商電,21,9,12,元大-大天母,2023-10-03,9893
00632R,元大台灣50反1,645,20,625,元大-大天母,2023-10-04,9893
2883,凱基金,344,7,337,元大-大天母,2023-10-04,9893
2801,彰銀,311,0,311,元大-大天母,2023-10-04,9893
4904,遠傳,150,0,150,元大-大天母,2023-10-04,9893
00929,復華台灣科技優息,138,2,136,元大-大天母,2023-10-04,9893
00665L,富邦�琤肭磪囓�2,180,60,120,元大-大天母,2023-10-04,9893
00720B,元大投資級公司債,106,0,106,元大-大天母,2023-10-04,9893
00772B,中信高評級公司債,80,0,80,元大-大天母,2023-10-04,9893
2891,中信金,68,0,68,元大-大天母,2023-10-04,9893
0056,元大高股息,72,5,67,元大-大天母,2023-10-04,9893
00679B,元大美債20年,61,1,60,元大-大天母,2023-10-04,9893
2303,聯電,60,2,58,元大-大天母,2023-10-04,9893
1301,台塑,55,0,55,元大-大天母,2023-10-04,9893
3045,台灣大,53,0,53,元大-大天母,2023-10-04,9893
2405,輔信,51,0,51,元大-大天母,2023-10-04,9893
00671R,富邦NASDAQ反1,50,0,50,元大-大天母,2023-10-04,9893
3356,奇偶,36,0,36,元大-大天母,2023-10-04,9893
2330,台積電,40,5,35,元大-大天母,2023-10-04,9893
3714,富采,33,0,33,元大-大天母,2023-10-04,9893
2353,宏��,33,1,32,元大-大天母,2023-10-04,9893
00712,復華富時不動產,30,0,30,元大-大天母,2023-10-04,9893
3033,威健,30,0,30,元大-大天母,2023-10-04,9893
2323,中環,30,0,30,元大-大天母,2023-10-04,9893
00680L,元大美債20正2,29,0,29,元大-大天母,2023-10-04,9893
00931B,統一美債20年,27,0,27,元大-大天母,2023-10-04,9893
3048,益登,27,0,27,元大-大天母,2023-10-04,9893
8215,明基材,26,0,26,元大-大天母,2023-10-04,9893
2834,臺企銀,25,0,25,元大-大天母,2023-10-04,9893
2884,玉山金,26,5,21,元大-大天母,2023-10-04,9893
6204,艾華,20,0,20,元大-大天母,2023-10-04,9893
5880,合庫金,19,0,19,元大-大天母,2023-10-04,9893
6443,元晶,20,1,19,元大-大天母,2023-10-04,9893
3481,群創,19,0,19,元大-大天母,2023-10-04,9893
2317,鴻海,18,0,18,元大-大天母,2023-10-04,9893
2887,台新金,17,0,17,元大-大天母,2023-10-04,9893
1815,富喬,44,28,16,元大-大天母,2023-10-04,9893
0050,元大台灣50,17,1,16,元大-大天母,2023-10-04,9893
2881,富邦金,15,0,15,元大-大天母,2023-10-04,9893
2377,微星,15,0,15,元大-大天母,2023-10-04,9893
2206,三陽工業,17,2,15,元大-大天母,2023-10-04,9893
2543,皇昌,16,1,15,元大-大天母,2023-10-04,9893
6122,擎邦,15,0,15,元大-大天母,2023-10-04,9893
00751B,元大AAA至A公司債,21,6,15,元大-大天母,2023-10-04,9893
00922,國泰台灣領袖50,14,0,14,元大-大天母,2023-10-04,9893
2882,國泰金,14,0,14,元大-大天母,2023-10-04,9893
00919,群益台灣精選高息,12,0,12,元大-大天母,2023-10-04,9893
1215,卜蜂,12,0,12,元大-大天母,2023-10-04,9893
4961,天鈺,11,0,11,元大-大天母,2023-10-04,9893
2633,台灣高鐵,11,0,11,元大-大天母,2023-10-04,9893
00918,大華優利高填息30,11,0,11,元大-大天母,2023-10-04,9893
9105,泰金寶-DR,201,2,199,元大-大天母,2023-10-05,9893
3035,智原,131,17,114,元大-大天母,2023-10-05,9893
2390,云辰,100,0,100,元大-大天母,2023-10-05,9893
2408,南亞科,101,4,97,元大-大天母,2023-10-05,9893
2618,長榮航,210,118,92,元大-大天母,2023-10-05,9893
5258,虹堡,52,0,52,元大-大天母,2023-10-05,9893
00664R,國泰臺灣加權反1,45,0,45,元大-大天母,2023-10-05,9893
00929,復華台灣科技優息,43,1,42,元大-大天母,2023-10-05,9893
6768,志強-KY,38,0,38,元大-大天母,2023-10-05,9893
3231,緯創,48,14,34,元大-大天母,2023-10-05,9893
2538,基泰,32,1,31,元大-大天母,2023-10-05,9893
00712,復華富時不動產,28,0,28,元大-大天母,2023-10-05,9893
2002,中鋼,27,2,25,元大-大天母,2023-10-05,9893
00671R,富邦NASDAQ反1,25,0,25,元大-大天母,2023-10-05,9893
2363,矽統,40,19,21,元大-大天母,2023-10-05,9893
6570,維田,20,0,20,元大-大天母,2023-10-05,9893
00882,中信中國高股息,20,0,20,元大-大天母,2023-10-05,9893
2834,臺企銀,20,0,20,元大-大天母,2023-10-05,9893
8112,至上,44,24,20,元大-大天母,2023-10-05,9893
3032,偉訓,20,2,18,元大-大天母,2023-10-05,9893
1101,台泥,35,18,17,元大-大天母,2023-10-05,9893
5009,榮剛,20,4,16,元大-大天母,2023-10-05,9893
2330,台積電,17,4,13,元大-大天母,2023-10-05,9893
1605,華新,27,14,13,元大-大天母,2023-10-05,9893
00680L,元大美債20正2,12,0,12,元大-大天母,2023-10-05,9893
00676R,富邦臺灣加權反1,12,0,12,元大-大天母,2023-10-05,9893
00772B,中信高評級公司債,13,2,11,元大-大天母,2023-10-05,9893
00922,國泰台灣領袖50,11,0,11,元大-大天母,2023-10-05,9893
6168,宏齊,26,15,11,元大-大天母,2023-10-05,9893
1789,神隆,11,0,11,元大-大天母,2023-10-05,9893
2882,國泰金,11,1,10,元大-大天母,2023-10-05,9893
3707,漢磊,10,0,10,元大-大天母,2023-10-05,9893
3450,聯鈞,10,0,10,元大-大天母,2023-10-05,9893
2312,金寶,10,0,10,元大-大天母,2023-10-05,9893
2464,盟立,10,0,10,元大-大天母,2023-10-05,9893
1316,上曜,10,0,10,元大-大天母,2023-10-05,9893
3532,台勝科,10,0,10,元大-大天母,2023-10-05,9893
3211,順達,10,0,10,元大-大天母,2023-10-05,9893
2820,華票,10,0,10,元大-大天母,2023-10-05,9893
2377,微星,10,0,10,元大-大天母,2023-10-05,9893
5498,凱崴,10,0,10,元大-大天母,2023-10-05,9893
00931B,統一美債20年,10,1,9,元大-大天母,2023-10-05,9893
1313,聯成,8,0,8,元大-大天母,2023-10-05,9893
6451,訊芯-KY,28,20,8,元大-大天母,2023-10-05,9893
3078,僑威,16,8,8,元大-大天母,2023-10-05,9893
3483,力致,25,17,8,元大-大天母,2023-10-05,9893
2352,佳世達,7,0,7,元大-大天母,2023-10-05,9893
3037,欣興,9,2,7,元大-大天母,2023-10-05,9893
6235,華孚,17,10,7,元大-大天母,2023-10-05,9893
3044,健鼎,9,3,6,元大-大天母,2023-10-05,9893
5439,高技,258,35,223,元大-大天母,2023-10-06,9893
00929,復華台灣科技優息,229,20,209,元大-大天母,2023-10-06,9893
2618,長榮航,137,27,110,元大-大天母,2023-10-06,9893
2885,元大金,81,0,81,元大-大天母,2023-10-06,9893
00632R,元大台灣50反1,80,0,80,元大-大天母,2023-10-06,9893
1605,華新,78,22,56,元大-大天母,2023-10-06,9893
3035,智原,37,1,36,元大-大天母,2023-10-06,9893
2888,新光金,35,0,35,元大-大天母,2023-10-06,9893
6168,宏齊,63,29,34,元大-大天母,2023-10-06,9893
00919,群益台灣精選高息,51,20,31,元大-大天母,2023-10-06,9893
2323,中環,31,0,31,元大-大天母,2023-10-06,9893
3231,緯創,67,37,30,元大-大天母,2023-10-06,9893
00715L,期街口布蘭特正2,29,0,29,元大-大天母,2023-10-06,9893
3666,光耀,30,1,29,元大-大天母,2023-10-06,9893
2409,友達,25,0,25,元大-大天母,2023-10-06,9893
3483,力致,30,5,25,元大-大天母,2023-10-06,9893
00679B,元大美債20年,24,0,24,元大-大天母,2023-10-06,9893
00751B,元大AAA至A公司債,21,0,21,元大-大天母,2023-10-06,9893
00720B,元大投資級公司債,20,0,20,元大-大天母,2023-10-06,9893
2486,一詮,47,29,18,元大-大天母,2023-10-06,9893
2610,華航,54,37,17,元大-大天母,2023-10-06,9893
2883,凱基金,17,0,17,元大-大天母,2023-10-06,9893
2505,國揚,15,0,15,元大-大天母,2023-10-06,9893
2543,皇昌,15,0,15,元大-大天母,2023-10-06,9893
6451,訊芯-KY,16,2,14,元大-大天母,2023-10-06,9893
6670,復盛應用,12,0,12,元大-大天母,2023-10-06,9893
4923,力士,12,0,12,元大-大天母,2023-10-06,9893
9105,泰金寶-DR,12,0,12,元大-大天母,2023-10-06,9893
00680L,元大美債20正2,12,0,12,元大-大天母,2023-10-06,9893
3711,日月光投控,13,1,12,元大-大天母,2023-10-06,9893
2360,致茂,11,0,11,元大-大天母,2023-10-06,9893
3037,欣興,15,5,10,元大-大天母,2023-10-06,9893
2453,凌群,11,1,10,元大-大天母,2023-10-06,9893
00719B,元大美債1-3,10,0,10,元大-大天母,2023-10-06,9893
2881,富邦金,10,0,10,元大-大天母,2023-10-06,9893
1340,勝悅-KY,10,0,10,元大-大天母,2023-10-06,9893
3048,益登,10,0,10,元大-大天母,2023-10-06,9893
6462,神盾,11,1,10,元大-大天母,2023-10-06,9893
1447,力鵬,10,0,10,元大-大天母,2023-10-06,9893
2395,研華,10,0,10,元大-大天母,2023-10-06,9893
6122,擎邦,18,8,10,元大-大天母,2023-10-06,9893
2031,新光鋼,10,1,9,元大-大天母,2023-10-06,9893
2388,威盛,10,1,9,元大-大天母,2023-10-06,9893
6768,志強-KY,9,0,9,元大-大天母,2023-10-06,9893
3380,明泰,10,2,8,元大-大天母,2023-10-06,9893
3704,合勤控,8,0,8,元大-大天母,2023-10-06,9893
2468,華經,69,61,8,元大-大天母,2023-10-06,9893
3363,上詮,14,6,8,元大-大天母,2023-10-06,9893
2402,毅嘉,8,1,7,元大-大天母,2023-10-06,9893
1324,地球,7,0,7,元大-大天母,2023-10-06,9893
2312,金寶,1200,11,1189,元大-大天母,2023-10-11,9893
3231,緯創,288,77,211,元大-大天母,2023-10-11,9893
00637L,元大滬深300正2,202,0,202,元大-大天母,2023-10-11,9893
1210,大成,200,0,200,元大-大天母,2023-10-11,9893
2889,國票金,182,6,176,元大-大天母,2023-10-11,9893
0056,元大高股息,113,8,105,元大-大天母,2023-10-11,9893
2365,昆盈,80,3,77,元大-大天母,2023-10-11,9893
2636,台驊控股,70,0,70,元大-大天母,2023-10-11,9893
2031,新光鋼,57,0,57,元大-大天母,2023-10-11,9893
00878,國泰永續高股息,92,37,55,元大-大天母,2023-10-11,9893
2542,興富發,48,0,48,元大-大天母,2023-10-11,9893
2618,長榮航,57,11,46,元大-大天母,2023-10-11,9893
1903,士紙,42,0,42,元大-大天母,2023-10-11,9893
2609,陽明,51,11,40,元大-大天母,2023-10-11,9893
00706L,期元大S＆P日圓正2,40,0,40,元大-大天母,2023-10-11,9893
3013,晟銘電,70,37,33,元大-大天母,2023-10-11,9893
4977,眾達-KY,32,0,32,元大-大天母,2023-10-11,9893
00687B,國泰20年美債,30,0,30,元大-大天母,2023-10-11,9893
2344,華邦電,86,57,29,元大-大天母,2023-10-11,9893
1815,富喬,31,4,27,元大-大天母,2023-10-11,9893
2376,技嘉,42,19,23,元大-大天母,2023-10-11,9893
3706,神達,26,3,23,元大-大天母,2023-10-11,9893
3483,力致,24,3,21,元大-大天母,2023-10-11,9893
5469,瀚宇博,22,1,21,元大-大天母,2023-10-11,9893
3236,千如,20,0,20,元大-大天母,2023-10-11,9893
6432,今展科,20,1,19,元大-大天母,2023-10-11,9893
2610,華航,30,12,18,元大-大天母,2023-10-11,9893
6530,創威,20,3,17,元大-大天母,2023-10-11,9893
6167,久正,16,0,16,元大-大天母,2023-10-11,9893
00900,富邦特選高股息30,15,0,15,元大-大天母,2023-10-11,9893
4561,健椿,15,0,15,元大-大天母,2023-10-11,9893
5426,振發,15,0,15,元大-大天母,2023-10-11,9893
3518,柏騰,15,0,15,元大-大天母,2023-10-11,9893
5351,鈺創,21,6,15,元大-大天母,2023-10-11,9893
2603,長榮,20,5,15,元大-大天母,2023-10-11,9893
00919,群益台灣精選高息,21,7,14,元大-大天母,2023-10-11,9893
00722B,群益投資級電信債,13,0,13,元大-大天母,2023-10-11,9893
4105,東洋,13,0,13,元大-大天母,2023-10-11,9893
2515,中工,12,0,12,元大-大天母,2023-10-11,9893
1215,卜蜂,12,0,12,元大-大天母,2023-10-11,9893
2743,山富,12,0,12,元大-大天母,2023-10-11,9893
3363,上詮,13,1,12,元大-大天母,2023-10-11,9893
3037,欣興,18,7,11,元大-大天母,2023-10-11,9893
00881,國泰台灣5G+,11,0,11,元大-大天母,2023-10-11,9893
6443,元晶,21,10,11,元大-大天母,2023-10-11,9893
2204,中華,13,2,11,元大-大天母,2023-10-11,9893
00915,凱基優選高股息30,11,0,11,元大-大天母,2023-10-11,9893
2887,台新金,10,0,10,元大-大天母,2023-10-11,9893
1515,力山,10,0,10,元大-大天母,2023-10-11,9893
1447,力鵬,15,5,10,元大-大天母,2023-10-11,9893
5439,高技,207,11,196,元大-大天母,2023-10-12,9893
2889,國票金,120,3,117,元大-大天母,2023-10-12,9893
00929,復華台灣科技優息,114,1,113,元大-大天母,2023-10-12,9893
3035,智原,106,7,99,元大-大天母,2023-10-12,9893
2323,中環,80,0,80,元大-大天母,2023-10-12,9893
8926,台汽電,60,0,60,元大-大天母,2023-10-12,9893
2031,新光鋼,60,0,60,元大-大天母,2023-10-12,9893
0056,元大高股息,70,12,58,元大-大天母,2023-10-12,9893
00665L,富邦�琤肭磪囓�2,50,7,43,元大-大天母,2023-10-12,9893
2636,台驊控股,43,0,43,元大-大天母,2023-10-12,9893
6168,宏齊,363,320,43,元大-大天母,2023-10-12,9893
00795B,中信美國公債20年,37,1,36,元大-大天母,2023-10-12,9893
2492,華新科,41,10,31,元大-大天母,2023-10-12,9893
2365,昆盈,31,0,31,元大-大天母,2023-10-12,9893
6275,元山,30,0,30,元大-大天母,2023-10-12,9893
00878,國泰永續高股息,53,27,26,元大-大天母,2023-10-12,9893
00706L,期元大S＆P日圓正2,25,0,25,元大-大天母,2023-10-12,9893
00632R,元大台灣50反1,25,0,25,元大-大天母,2023-10-12,9893
3483,力致,28,5,23,元大-大天母,2023-10-12,9893
1903,士紙,23,0,23,元大-大天母,2023-10-12,9893
2353,宏��,24,2,22,元大-大天母,2023-10-12,9893
2356,英業達,23,2,21,元大-大天母,2023-10-12,9893
6231,系微,23,2,21,元大-大天母,2023-10-12,9893
5301,寶得利,20,0,20,元大-大天母,2023-10-12,9893
6770,力積電,21,2,19,元大-大天母,2023-10-12,9893
2327,國巨,20,2,18,元大-大天母,2023-10-12,9893
00922,國泰台灣領袖50,17,0,17,元大-大天母,2023-10-12,9893
1101,台泥,18,1,17,元大-大天母,2023-10-12,9893
2025,千興,19,2,17,元大-大天母,2023-10-12,9893
00715L,期街口布蘭特正2,16,0,16,元大-大天母,2023-10-12,9893
3163,波若威,18,3,15,元大-大天母,2023-10-12,9893
3025,星通,24,9,15,元大-大天母,2023-10-12,9893
2427,三商電,18,4,14,元大-大天母,2023-10-12,9893
3447,展達,14,0,14,元大-大天母,2023-10-12,9893
2408,南亞科,21,7,14,元大-大天母,2023-10-12,9893
00720B,元大投資級公司債,14,0,14,元大-大天母,2023-10-12,9893
2376,技嘉,26,12,14,元大-大天母,2023-10-12,9893
2449,京元電子,21,8,13,元大-大天母,2023-10-12,9893
2886,兆豐金,20,8,12,元大-大天母,2023-10-12,9893
5222,全訊,13,1,12,元大-大天母,2023-10-12,9893
2303,聯電,41,29,12,元大-大天母,2023-10-12,9893
00679B,元大美債20年,17,5,12,元大-大天母,2023-10-12,9893
6285,啟��,12,2,10,元大-大天母,2023-10-12,9893
00642U,期元大S＆P石油,10,0,10,元大-大天母,2023-10-12,9893
3380,明泰,10,0,10,元大-大天母,2023-10-12,9893
1618,合機,10,0,10,元大-大天母,2023-10-12,9893
3276,宇環,10,0,10,元大-大天母,2023-10-12,9893
2542,興富發,11,1,10,元大-大天母,2023-10-12,9893
1815,富喬,17,7,10,元大-大天母,2023-10-12,9893
2881,富邦金,10,0,10,元大-大天母,2023-10-12,9893
00688L,國泰20年美債正2,101,0,101,元大-大天母,2023-10-13,9893
6168,宏齊,277,189,88,元大-大天母,2023-10-13,9893
0056,元大高股息,77,2,75,元大-大天母,2023-10-13,9893
00751B,元大AAA至A公司債,74,0,74,元大-大天母,2023-10-13,9893
00680L,元大美債20正2,72,0,72,元大-大天母,2023-10-13,9893
3231,緯創,100,39,61,元大-大天母,2023-10-13,9893
2889,國票金,60,0,60,元大-大天母,2023-10-13,9893
00720B,元大投資級公司債,56,0,56,元大-大天母,2023-10-13,9893
2301,光寶科,57,1,56,元大-大天母,2023-10-13,9893
00878,國泰永續高股息,57,3,54,元大-大天母,2023-10-13,9893
3078,僑威,75,22,53,元大-大天母,2023-10-13,9893
00671R,富邦NASDAQ反1,50,0,50,元大-大天母,2023-10-13,9893
00715L,期街口布蘭特正2,51,2,49,元大-大天母,2023-10-13,9893
2365,昆盈,45,0,45,元大-大天母,2023-10-13,9893
1101,台泥,51,10,41,元大-大天母,2023-10-13,9893
006206,元大上證50,40,0,40,元大-大天母,2023-10-13,9893
2353,宏��,40,1,39,元大-大天母,2023-10-13,9893
4904,遠傳,38,0,38,元大-大天母,2023-10-13,9893
2618,長榮航,50,16,34,元大-大天母,2023-10-13,9893
6114,久威,30,0,30,元大-大天母,2023-10-13,9893
1524,耿鼎,34,4,30,元大-大天母,2023-10-13,9893
00919,群益台灣精選高息,30,1,29,元大-大天母,2023-10-13,9893
2356,英業達,40,13,27,元大-大天母,2023-10-13,9893
2382,廣達,47,21,26,元大-大天母,2023-10-13,9893
1903,士紙,23,0,23,元大-大天母,2023-10-13,9893
8926,台汽電,23,1,22,元大-大天母,2023-10-13,9893
00679B,元大美債20年,22,0,22,元大-大天母,2023-10-13,9893
00929,復華台灣科技優息,73,52,21,元大-大天母,2023-10-13,9893
2486,一詮,22,1,21,元大-大天母,2023-10-13,9893
2031,新光鋼,20,0,20,元大-大天母,2023-10-13,9893
2495,普安,20,1,19,元大-大天母,2023-10-13,9893
5607,遠雄港,19,0,19,元大-大天母,2023-10-13,9893
00637L,元大滬深300正2,19,0,19,元大-大天母,2023-10-13,9893
2886,兆豐金,23,4,19,元大-大天母,2023-10-13,9893
5469,瀚宇博,22,4,18,元大-大天母,2023-10-13,9893
1731,美吾華,18,0,18,元大-大天母,2023-10-13,9893
2344,華邦電,27,10,17,元大-大天母,2023-10-13,9893
4105,東洋,17,0,17,元大-大天母,2023-10-13,9893
3715,定穎投控,45,30,15,元大-大天母,2023-10-13,9893
2376,技嘉,29,15,14,元大-大天母,2023-10-13,9893
2308,台達電,15,1,14,元大-大天母,2023-10-13,9893
00712,復華富時不動產,12,0,12,元大-大天母,2023-10-13,9893
3481,群創,13,1,12,元大-大天母,2023-10-13,9893
1609,大亞,11,0,11,元大-大天母,2023-10-13,9893
00753L,中信中國50正2,11,0,11,元大-大天母,2023-10-13,9893
6577,勁豐,11,0,11,元大-大天母,2023-10-13,9893
2105,正新,10,0,10,元大-大天母,2023-10-13,9893
2915,潤泰全,10,0,10,元大-大天母,2023-10-13,9893
3454,晶睿,10,0,10,元大-大天母,2023-10-13,9893
2395,研華,10,0,10,元大-大天母,2023-10-13,9893
6482,弘煜科,250,0,250,元大-大天母,2023-10-16,9893
00922,國泰台灣領袖50,163,0,163,元大-大天母,2023-10-16,9893
1314,中石化,169,12,157,元大-大天母,2023-10-16,9893
6290,良維,129,1,128,元大-大天母,2023-10-16,9893
2515,中工,137,20,117,元大-大天母,2023-10-16,9893
0056,元大高股息,195,82,113,元大-大天母,2023-10-16,9893
2363,矽統,140,64,76,元大-大天母,2023-10-16,9893
2328,廣宇,68,0,68,元大-大天母,2023-10-16,9893
00664R,國泰臺灣加權反1,60,0,60,元大-大天母,2023-10-16,9893
6168,宏齊,60,1,59,元大-大天母,2023-10-16,9893
2607,榮運,60,2,58,元大-大天母,2023-10-16,9893
2344,華邦電,87,34,53,元大-大天母,2023-10-16,9893
2520,冠德,49,0,49,元大-大天母,2023-10-16,9893
00919,群益台灣精選高息,46,0,46,元大-大天母,2023-10-16,9893
006206,元大上證50,40,0,40,元大-大天母,2023-10-16,9893
00720B,元大投資級公司債,41,1,40,元大-大天母,2023-10-16,9893
1903,士紙,36,0,36,元大-大天母,2023-10-16,9893
1609,大亞,37,2,35,元大-大天母,2023-10-16,9893
1905,華紙,42,7,35,元大-大天母,2023-10-16,9893
2206,三陽工業,34,0,34,元大-大天母,2023-10-16,9893
2201,裕隆,35,3,32,元大-大天母,2023-10-16,9893
3706,神達,35,4,31,元大-大天母,2023-10-16,9893
3037,欣興,35,5,30,元大-大天母,2023-10-16,9893
5426,振發,30,0,30,元大-大天母,2023-10-16,9893
00878,國泰永續高股息,41,13,28,元大-大天母,2023-10-16,9893
1712,興農,26,0,26,元大-大天母,2023-10-16,9893
00671R,富邦NASDAQ反1,25,0,25,元大-大天母,2023-10-16,9893
00673R,期元大S＆P原油反1,24,0,24,元大-大天母,2023-10-16,9893
4977,眾達-KY,29,5,24,元大-大天母,2023-10-16,9893
00637L,元大滬深300正2,23,0,23,元大-大天母,2023-10-16,9893
2301,光寶科,26,4,22,元大-大天母,2023-10-16,9893
5425,台半,24,2,22,元大-大天母,2023-10-16,9893
1513,中興電,21,0,21,元大-大天母,2023-10-16,9893
1605,華新,24,4,20,元大-大天母,2023-10-16,9893
00900,富邦特選高股息30,20,0,20,元大-大天母,2023-10-16,9893
5284,jpp-KY,20,0,20,元大-大天母,2023-10-16,9893
2636,台驊控股,20,0,20,元大-大天母,2023-10-16,9893
6505,台塑化,20,0,20,元大-大天母,2023-10-16,9893
3272,東碩,20,0,20,元大-大天母,2023-10-16,9893
3576,聯合再生,20,0,20,元大-大天母,2023-10-16,9893
2883,凱基金,20,1,19,元大-大天母,2023-10-16,9893
2356,英業達,32,14,18,元大-大天母,2023-10-16,9893
5210,寶碩,20,3,17,元大-大天母,2023-10-16,9893
6770,力積電,22,6,16,元大-大天母,2023-10-16,9893
00679B,元大美債20年,16,0,16,元大-大天母,2023-10-16,9893
6282,康舒,14,0,14,元大-大天母,2023-10-16,9893
4168,醣聯,14,0,14,元大-大天母,2023-10-16,9893
6533,晶心科,12,1,11,元大-大天母,2023-10-16,9893
00923,群益台ESG低碳50,11,0,11,元大-大天母,2023-10-16,9893
3264,欣銓,13,2,11,元大-大天母,2023-10-16,9893
00900,富邦特選高股息30,487,0,487,元大-大天母,2023-10-17,9893
2883,凱基金,250,12,238,元大-大天母,2023-10-17,9893
6290,良維,195,4,191,元大-大天母,2023-10-17,9893
0056,元大高股息,168,1,167,元大-大天母,2023-10-17,9893
2885,元大金,141,10,131,元大-大天母,2023-10-17,9893
6770,力積電,143,15,128,元大-大天母,2023-10-17,9893
1314,中石化,100,1,99,元大-大天母,2023-10-17,9893
2892,第一金,69,5,64,元大-大天母,2023-10-17,9893
4714,永捷,60,0,60,元大-大天母,2023-10-17,9893
1903,士紙,58,0,58,元大-大天母,2023-10-17,9893
2377,微星,56,0,56,元大-大天母,2023-10-17,9893
2607,榮運,60,4,56,元大-大天母,2023-10-17,9893
2618,長榮航,62,9,53,元大-大天母,2023-10-17,9893
5210,寶碩,46,0,46,元大-大天母,2023-10-17,9893
3376,新日興,51,7,44,元大-大天母,2023-10-17,9893
3325,旭品,43,0,43,元大-大天母,2023-10-17,9893
00751B,元大AAA至A公司債,41,0,41,元大-大天母,2023-10-17,9893
00878,國泰永續高股息,43,2,41,元大-大天母,2023-10-17,9893
3484,崧騰,36,1,35,元大-大天母,2023-10-17,9893
1609,大亞,34,0,34,元大-大天母,2023-10-17,9893
3231,緯創,121,87,34,元大-大天母,2023-10-17,9893
3078,僑威,64,33,31,元大-大天母,2023-10-17,9893
00720B,元大投資級公司債,29,0,29,元大-大天母,2023-10-17,9893
1513,中興電,29,1,28,元大-大天母,2023-10-17,9893
8936,國統,25,0,25,元大-大天母,2023-10-17,9893
2886,兆豐金,46,22,24,元大-大天母,2023-10-17,9893
9925,新保,20,0,20,元大-大天母,2023-10-17,9893
5426,振發,20,0,20,元大-大天母,2023-10-17,9893
3272,東碩,20,0,20,元大-大天母,2023-10-17,9893
5469,瀚宇博,20,1,19,元大-大天母,2023-10-17,9893
3363,上詮,33,15,18,元大-大天母,2023-10-17,9893
020039,元大加權N,22,4,18,元大-大天母,2023-10-17,9893
00715L,期街口布蘭特正2,24,6,18,元大-大天母,2023-10-17,9893
3234,光環,25,7,18,元大-大天母,2023-10-17,9893
2436,偉詮電,22,6,16,元大-大天母,2023-10-17,9893
2049,上銀,15,0,15,元大-大天母,2023-10-17,9893
4938,和碩,14,0,14,元大-大天母,2023-10-17,9893
00687B,國泰20年美債,16,3,13,元大-大天母,2023-10-17,9893
8926,台汽電,13,0,13,元大-大天母,2023-10-17,9893
1447,力鵬,12,0,12,元大-大天母,2023-10-17,9893
3122,笙泉,12,0,12,元大-大天母,2023-10-17,9893
8048,德勝,15,3,12,元大-大天母,2023-10-17,9893
2376,技嘉,22,11,11,元大-大天母,2023-10-17,9893
2369,菱生,13,3,10,元大-大天母,2023-10-17,9893
2915,潤泰全,10,0,10,元大-大天母,2023-10-17,9893
1909,榮成,10,0,10,元大-大天母,2023-10-17,9893
2206,三陽工業,10,0,10,元大-大天母,2023-10-17,9893
2838,聯邦銀,10,0,10,元大-大天母,2023-10-17,9893
8289,泰藝,10,0,10,元大-大天母,2023-10-17,9893
3715,定穎投控,31,22,9,元大-大天母,2023-10-17,9893
2303,聯電,1089,170,919,元大-大天母,2023-10-18,9893
6290,良維,191,0,191,元大-大天母,2023-10-18,9893
0056,元大高股息,315,130,185,元大-大天母,2023-10-18,9893
2607,榮運,164,7,157,元大-大天母,2023-10-18,9893
00688L,國泰20年美債正2,100,0,100,元大-大天母,2023-10-18,9893
2890,永豐金,79,0,79,元大-大天母,2023-10-18,9893
00878,國泰永續高股息,141,71,70,元大-大天母,2023-10-18,9893
2515,中工,65,4,61,元大-大天母,2023-10-18,9893
2382,廣達,93,33,60,元大-大天母,2023-10-18,9893
2344,華邦電,70,11,59,元大-大天母,2023-10-18,9893
9938,百和,75,17,58,元大-大天母,2023-10-18,9893
00720B,元大投資級公司債,48,0,48,元大-大天母,2023-10-18,9893
1102,亞泥,48,0,48,元大-大天母,2023-10-18,9893
2388,威盛,107,62,45,元大-大天母,2023-10-18,9893
1903,士紙,36,0,36,元大-大天母,2023-10-18,9893
1815,富喬,47,13,34,元大-大天母,2023-10-18,9893
3207,耀勝,34,4,30,元大-大天母,2023-10-18,9893
6282,康舒,31,3,28,元大-大天母,2023-10-18,9893
2606,裕民,30,3,27,元大-大天母,2023-10-18,9893
6216,居易,27,0,27,元大-大天母,2023-10-18,9893
00751B,元大AAA至A公司債,26,0,26,元大-大天母,2023-10-18,9893
1101,台泥,28,3,25,元大-大天母,2023-10-18,9893
8936,國統,25,0,25,元大-大天母,2023-10-18,9893
2330,台積電,26,1,25,元大-大天母,2023-10-18,9893
2317,鴻海,25,2,23,元大-大天母,2023-10-18,9893
2399,映泰,24,1,23,元大-大天母,2023-10-18,9893
6168,宏齊,133,112,21,元大-大天母,2023-10-18,9893
00632R,元大台灣50反1,20,0,20,元大-大天母,2023-10-18,9893
00671R,富邦NASDAQ反1,20,0,20,元大-大天母,2023-10-18,9893
00922,國泰台灣領袖50,52,32,20,元大-大天母,2023-10-18,9893
1609,大亞,20,1,19,元大-大天母,2023-10-18,9893
2376,技嘉,32,13,19,元大-大天母,2023-10-18,9893
2610,華航,48,30,18,元大-大天母,2023-10-18,9893
3481,群創,22,4,18,元大-大天母,2023-10-18,9893
2329,華泰,19,2,17,元大-大天母,2023-10-18,9893
00919,群益台灣精選高息,46,30,16,元大-大天母,2023-10-18,9893
2355,敬鵬,15,0,15,元大-大天母,2023-10-18,9893
00679B,元大美債20年,15,0,15,元大-大天母,2023-10-18,9893
6770,力積電,17,3,14,元大-大天母,2023-10-18,9893
3078,僑威,44,31,13,元大-大天母,2023-10-18,9893
3032,偉訓,13,0,13,元大-大天母,2023-10-18,9893
6505,台塑化,13,0,13,元大-大天母,2023-10-18,9893
3548,兆利,18,5,13,元大-大天母,2023-10-18,9893
3325,旭品,13,1,12,元大-大天母,2023-10-18,9893
1584,精剛,12,0,12,元大-大天母,2023-10-18,9893
00932,兆豐永續高息等權,12,0,12,元大-大天母,2023-10-18,9893
2743,山富,12,0,12,元大-大天母,2023-10-18,9893
6213,聯茂,54,42,12,元大-大天母,2023-10-18,9893
3715,定穎投控,35,24,11,元大-大天母,2023-10-18,9893
2201,裕隆,13,2,11,元大-大天母,2023-10-18,9893
6168,宏齊,259,52,207,元大-大天母,2023-10-19,9893
00680L,元大美債20正2,166,0,166,元大-大天母,2023-10-19,9893
0056,元大高股息,181,16,165,元大-大天母,2023-10-19,9893
00679B,元大美債20年,142,0,142,元大-大天母,2023-10-19,9893
00720B,元大投資級公司債,116,0,116,元大-大天母,2023-10-19,9893
00688L,國泰20年美債正2,101,0,101,元大-大天母,2023-10-19,9893
2883,凱基金,100,0,100,元大-大天母,2023-10-19,9893
00772B,中信高評級公司債,96,0,96,元大-大天母,2023-10-19,9893
1101,台泥,116,32,84,元大-大天母,2023-10-19,9893
2886,兆豐金,105,22,83,元大-大天母,2023-10-19,9893
2890,永豐金,70,2,68,元大-大天母,2023-10-19,9893
5258,虹堡,65,0,65,元大-大天母,2023-10-19,9893
1314,中石化,100,46,54,元大-大天母,2023-10-19,9893
00632R,元大台灣50反1,50,0,50,元大-大天母,2023-10-19,9893
3272,東碩,45,0,45,元大-大天母,2023-10-19,9893
00637L,元大滬深300正2,44,0,44,元大-大天母,2023-10-19,9893
2317,鴻海,50,7,43,元大-大天母,2023-10-19,9893
00878,國泰永續高股息,100,61,39,元大-大天母,2023-10-19,9893
2885,元大金,39,1,38,元大-大天母,2023-10-19,9893
00751B,元大AAA至A公司債,37,0,37,元大-大天母,2023-10-19,9893
3706,神達,33,1,32,元大-大天母,2023-10-19,9893
00931B,統一美債20年,26,3,23,元大-大天母,2023-10-19,9893
00922,國泰台灣領袖50,23,0,23,元大-大天母,2023-10-19,9893
2382,廣達,45,23,22,元大-大天母,2023-10-19,9893
2888,新光金,27,5,22,元大-大天母,2023-10-19,9893
00671R,富邦NASDAQ反1,20,0,20,元大-大天母,2023-10-19,9893
006206,元大上證50,20,0,20,元大-大天母,2023-10-19,9893
00638R,元大滬深300反1,20,0,20,元大-大天母,2023-10-19,9893
8467,波力-KY,20,0,20,元大-大天母,2023-10-19,9893
2002,中鋼,21,2,19,元大-大天母,2023-10-19,9893
00753L,中信中國50正2,18,0,18,元大-大天母,2023-10-19,9893
00712,復華富時不動產,16,0,16,元大-大天母,2023-10-19,9893
00933B,國泰10Y+金融債,17,1,16,元大-大天母,2023-10-19,9893
6901,鑽石投資,15,0,15,元大-大天母,2023-10-19,9893
00929,復華台灣科技優息,191,177,14,元大-大天母,2023-10-19,9893
2201,裕隆,23,10,13,元大-大天母,2023-10-19,9893
1905,華紙,13,0,13,元大-大天母,2023-10-19,9893
3545,敦泰,13,3,10,元大-大天母,2023-10-19,9893
8936,國統,10,0,10,元大-大天母,2023-10-19,9893
4960,誠美材,10,0,10,元大-大天母,2023-10-19,9893
00719B,元大美債1-3,10,0,10,元大-大天母,2023-10-19,9893
3028,增你強,10,0,10,元大-大天母,2023-10-19,9893
2520,冠德,10,0,10,元大-大天母,2023-10-19,9893
8358,金居,11,1,10,元大-大天母,2023-10-19,9893
3491,昇達科,11,1,10,元大-大天母,2023-10-19,9893
2324,仁寶,16,6,10,元大-大天母,2023-10-19,9893
9945,潤泰新,9,0,9,元大-大天母,2023-10-19,9893
5347,世界,11,2,9,元大-大天母,2023-10-19,9893
3305,昇貿,10,2,8,元大-大天母,2023-10-19,9893
3450,聯鈞,10,2,8,元大-大天母,2023-10-19,9893
00929,復華台灣科技優息,256,64,192,元大-大天母,2023-10-20,9893
2883,凱基金,93,0,93,元大-大天母,2023-10-20,9893
2888,新光金,87,1,86,元大-大天母,2023-10-20,9893
2890,永豐金,109,24,85,元大-大天母,2023-10-20,9893
2885,元大金,77,3,74,元大-大天母,2023-10-20,9893
0056,元大高股息,101,31,70,元大-大天母,2023-10-20,9893
2382,廣達,76,19,57,元大-大天母,2023-10-20,9893
00878,國泰永續高股息,153,97,56,元大-大天母,2023-10-20,9893
00665L,富邦�琤肭磪囓�2,101,50,51,元大-大天母,2023-10-20,9893
006206,元大上證50,50,0,50,元大-大天母,2023-10-20,9893
2886,兆豐金,68,23,45,元大-大天母,2023-10-20,9893
1903,士紙,38,0,38,元大-大天母,2023-10-20,9893
2204,中華,39,4,35,元大-大天母,2023-10-20,9893
1324,地球,37,3,34,元大-大天母,2023-10-20,9893
2002,中鋼,34,2,32,元大-大天母,2023-10-20,9893
3322,建舜電,33,1,32,元大-大天母,2023-10-20,9893
2412,中華電,31,0,31,元大-大天母,2023-10-20,9893
00922,國泰台灣領袖50,30,3,27,元大-大天母,2023-10-20,9893
2303,聯電,135,109,26,元大-大天母,2023-10-20,9893
00632R,元大台灣50反1,50,25,25,元大-大天母,2023-10-20,9893
00712,復華富時不動產,25,1,24,元大-大天母,2023-10-20,9893
8176,智捷,23,0,23,元大-大天母,2023-10-20,9893
00751B,元大AAA至A公司債,21,0,21,元大-大天母,2023-10-20,9893
2618,長榮航,28,7,21,元大-大天母,2023-10-20,9893
2305,全友,22,1,21,元大-大天母,2023-10-20,9893
2449,京元電子,41,21,20,元大-大天母,2023-10-20,9893
9105,泰金寶-DR,20,0,20,元大-大天母,2023-10-20,9893
3557,嘉威,20,0,20,元大-大天母,2023-10-20,9893
3709,鑫聯大投控,20,0,20,元大-大天母,2023-10-20,9893
2377,微星,16,0,16,元大-大天母,2023-10-20,9893
3231,緯創,107,91,16,元大-大天母,2023-10-20,9893
8069,元太,15,0,15,元大-大天母,2023-10-20,9893
00679B,元大美債20年,15,0,15,元大-大天母,2023-10-20,9893
6770,力積電,16,1,15,元大-大天母,2023-10-20,9893
1802,台玻,24,10,14,元大-大天母,2023-10-20,9893
3617,碩天,16,2,14,元大-大天母,2023-10-20,9893
2363,矽統,37,25,12,元大-大天母,2023-10-20,9893
8016,矽創,11,0,11,元大-大天母,2023-10-20,9893
3202,樺晟,11,0,11,元大-大天母,2023-10-20,9893
6288,聯嘉,11,0,11,元大-大天母,2023-10-20,9893
2801,彰銀,11,0,11,元大-大天母,2023-10-20,9893
2881,富邦金,26,16,10,元大-大天母,2023-10-20,9893
2409,友達,30,20,10,元大-大天母,2023-10-20,9893
1731,美吾華,10,0,10,元大-大天母,2023-10-20,9893
2838,聯邦銀,10,0,10,元大-大天母,2023-10-20,9893
2323,中環,10,0,10,元大-大天母,2023-10-20,9893
3484,崧騰,10,0,10,元大-大天母,2023-10-20,9893
2867,三商壽,10,0,10,元大-大天母,2023-10-20,9893
2501,國建,10,0,10,元大-大天母,2023-10-20,9893
6278,台表科,10,0,10,元大-大天母,2023-10-20,9893
2801,彰銀,300,0,300,元大-大天母,2023-10-23,9893
2885,元大金,161,1,160,元大-大天母,2023-10-23,9893
00929,復華台灣科技優息,137,0,137,元大-大天母,2023-10-23,9893
2317,鴻海,118,2,116,元大-大天母,2023-10-23,9893
6494,九齊,64,0,64,元大-大天母,2023-10-23,9893
00680L,元大美債20正2,61,0,61,元大-大天母,2023-10-23,9893
00720B,元大投資級公司債,60,0,60,元大-大天母,2023-10-23,9893
2891,中信金,59,0,59,元大-大天母,2023-10-23,9893
00919,群益台灣精選高息,53,0,53,元大-大天母,2023-10-23,9893
2892,第一金,77,27,50,元大-大天母,2023-10-23,9893
6147,頎邦,50,2,48,元大-大天母,2023-10-23,9893
2605,新興,55,7,48,元大-大天母,2023-10-23,9893
00712,復華富時不動產,37,6,31,元大-大天母,2023-10-23,9893
00878,國泰永續高股息,71,41,30,元大-大天母,2023-10-23,9893
2002,中鋼,32,5,27,元大-大天母,2023-10-23,9893
2886,兆豐金,50,27,23,元大-大天母,2023-10-23,9893
8085,福華,23,0,23,元大-大天母,2023-10-23,9893
2637,慧洋-KY,22,0,22,元大-大天母,2023-10-23,9893
3048,益登,23,1,22,元大-大天母,2023-10-23,9893
2201,裕隆,22,1,21,元大-大天母,2023-10-23,9893
2542,興富發,20,0,20,元大-大天母,2023-10-23,9893
3438,類比科,20,0,20,元大-大天母,2023-10-23,9893
00638R,元大滬深300反1,20,0,20,元大-大天母,2023-10-23,9893
00751B,元大AAA至A公司債,19,0,19,元大-大天母,2023-10-23,9893
00715L,期街口布蘭特正2,18,0,18,元大-大天母,2023-10-23,9893
9105,泰金寶-DR,18,0,18,元大-大天母,2023-10-23,9893
2881,富邦金,21,4,17,元大-大天母,2023-10-23,9893
2888,新光金,26,10,16,元大-大天母,2023-10-23,9893
0056,元大高股息,63,48,15,元大-大天母,2023-10-23,9893
5475,德宏,14,0,14,元大-大天母,2023-10-23,9893
00922,國泰台灣領袖50,14,1,13,元大-大天母,2023-10-23,9893
00893,國泰智能電動車,12,0,12,元大-大天母,2023-10-23,9893
2883,凱基金,12,0,12,元大-大天母,2023-10-23,9893
00631L,元大台灣50正2,12,0,12,元大-大天母,2023-10-23,9893
3325,旭品,11,0,11,元大-大天母,2023-10-23,9893
2412,中華電,12,1,11,元大-大天母,2023-10-23,9893
3711,日月光投控,11,0,11,元大-大天母,2023-10-23,9893
00679B,元大美債20年,10,0,10,元大-大天母,2023-10-23,9893
2478,大毅,10,0,10,元大-大天母,2023-10-23,9893
3276,宇環,10,0,10,元大-大天母,2023-10-23,9893
1460,宏遠,10,0,10,元大-大天母,2023-10-23,9893
2230,泰茂,10,0,10,元大-大天母,2023-10-23,9893
00664R,國泰臺灣加權反1,10,0,10,元大-大天母,2023-10-23,9893
2330,台積電,13,4,9,元大-大天母,2023-10-23,9893
3006,晶豪科,15,6,9,元大-大天母,2023-10-23,9893
4958,臻鼎-KY,9,0,9,元大-大天母,2023-10-23,9893
1605,華新,12,3,9,元大-大天母,2023-10-23,9893
8936,國統,9,0,9,元大-大天母,2023-10-23,9893
0050,元大台灣50,10,2,8,元大-大天母,2023-10-23,9893
01003T,兆豐新光R1,8,0,8,元大-大天母,2023-10-23,9893
6168,宏齊,167,73,94,元大-大天母,2023-10-24,9893
00712,復華富時不動產,66,0,66,元大-大天母,2023-10-24,9893
1711,永光,63,0,63,元大-大天母,2023-10-24,9893
9105,泰金寶-DR,63,0,63,元大-大天母,2023-10-24,9893
2892,第一金,57,1,56,元大-大天母,2023-10-24,9893
2317,鴻海,123,73,50,元大-大天母,2023-10-24,9893
00720B,元大投資級公司債,50,2,48,元大-大天母,2023-10-24,9893
00679B,元大美債20年,65,21,44,元大-大天母,2023-10-24,9893
2369,菱生,86,49,37,元大-大天母,2023-10-24,9893
6156,松上,35,0,35,元大-大天母,2023-10-24,9893
2520,冠德,30,0,30,元大-大天母,2023-10-24,9893
6194,育富,30,2,28,元大-大天母,2023-10-24,9893
2618,長榮航,28,2,26,元大-大天母,2023-10-24,9893
8936,國統,31,6,25,元大-大天母,2023-10-24,9893
00715L,期街口布蘭特正2,30,5,25,元大-大天母,2023-10-24,9893
00919,群益台灣精選高息,23,0,23,元大-大天母,2023-10-24,9893
2363,矽統,22,0,22,元大-大天母,2023-10-24,9893
3709,鑫聯大投控,20,0,20,元大-大天母,2023-10-24,9893
2337,旺宏,24,6,18,元大-大天母,2023-10-24,9893
6669,緯穎,24,7,17,元大-大天母,2023-10-24,9893
2886,兆豐金,19,3,16,元大-大天母,2023-10-24,9893
2801,彰銀,15,0,15,元大-大天母,2023-10-24,9893
8110,華東,18,3,15,元大-大天母,2023-10-24,9893
2891,中信金,16,2,14,元大-大天母,2023-10-24,9893
4960,誠美材,15,1,14,元大-大天母,2023-10-24,9893
2890,永豐金,14,1,13,元大-大天母,2023-10-24,9893
3711,日月光投控,13,0,13,元大-大天母,2023-10-24,9893
2885,元大金,14,1,13,元大-大天母,2023-10-24,9893
5609,中菲行,13,1,12,元大-大天母,2023-10-24,9893
0050,元大台灣50,12,0,12,元大-大天母,2023-10-24,9893
2947,振宇五金,11,0,11,元大-大天母,2023-10-24,9893
2352,佳世達,11,0,11,元大-大天母,2023-10-24,9893
3051,力特,42,31,11,元大-大天母,2023-10-24,9893
2002,中鋼,37,27,10,元大-大天母,2023-10-24,9893
00751B,元大AAA至A公司債,11,1,10,元大-大天母,2023-10-24,9893
00722B,群益投資級電信債,10,0,10,元大-大天母,2023-10-24,9893
2882,國泰金,10,0,10,元大-大天母,2023-10-24,9893
3715,定穎投控,47,38,9,元大-大天母,2023-10-24,9893
1609,大亞,11,2,9,元大-大天母,2023-10-24,9893
1402,遠東新,9,0,9,元大-大天母,2023-10-24,9893
3202,樺晟,10,1,9,元大-大天母,2023-10-24,9893
1324,地球,24,15,9,元大-大天母,2023-10-24,9893
2368,金像電,12,3,9,元大-大天母,2023-10-24,9893
5009,榮剛,8,0,8,元大-大天母,2023-10-24,9893
2884,玉山金,13,5,8,元大-大天母,2023-10-24,9893
0056,元大高股息,21,14,7,元大-大天母,2023-10-24,9893
00631L,元大台灣50正2,9,2,7,元大-大天母,2023-10-24,9893
2344,華邦電,18,12,6,元大-大天母,2023-10-24,9893
3325,旭品,25,19,6,元大-大天母,2023-10-24,9893
2610,華航,10,4,6,元大-大天母,2023-10-24,9893
2883,凱基金,101,0,101,元大-大天母,2023-10-25,9893
5439,高技,112,13,99,元大-大天母,2023-10-25,9893
6138,茂達,100,2,98,元大-大天母,2023-10-25,9893
2886,兆豐金,66,3,63,元大-大天母,2023-10-25,9893
2634,漢翔,59,0,59,元大-大天母,2023-10-25,9893
1314,中石化,50,0,50,元大-大天母,2023-10-25,9893
2344,華邦電,60,11,49,元大-大天母,2023-10-25,9893
6168,宏齊,50,2,48,元大-大天母,2023-10-25,9893
6799,來頡,40,0,40,元大-大天母,2023-10-25,9893
6418,詠昇,36,0,36,元大-大天母,2023-10-25,9893
5493,三聯,30,0,30,元大-大天母,2023-10-25,9893
2515,中工,54,24,30,元大-大天母,2023-10-25,9893
00715L,期街口布蘭特正2,30,1,29,元大-大天母,2023-10-25,9893
6153,嘉聯益,25,0,25,元大-大天母,2023-10-25,9893
2890,永豐金,25,0,25,元大-大天母,2023-10-25,9893
2337,旺宏,38,15,23,元大-大天母,2023-10-25,9893
00929,復華台灣科技優息,24,1,23,元大-大天母,2023-10-25,9893
3234,光環,22,0,22,元大-大天母,2023-10-25,9893
2464,盟立,21,0,21,元大-大天母,2023-10-25,9893
3025,星通,30,9,21,元大-大天母,2023-10-25,9893
6114,久威,45,24,21,元大-大天母,2023-10-25,9893
6156,松上,30,10,20,元大-大天母,2023-10-25,9893
9105,泰金寶-DR,29,10,19,元大-大天母,2023-10-25,9893
00919,群益台灣精選高息,18,0,18,元大-大天母,2023-10-25,9893
2401,凌陽,27,10,17,元大-大天母,2023-10-25,9893
3711,日月光投控,15,1,14,元大-大天母,2023-10-25,9893
3037,欣興,21,7,14,元大-大天母,2023-10-25,9893
00922,國泰台灣領袖50,13,0,13,元大-大天母,2023-10-25,9893
2356,英業達,17,4,13,元大-大天母,2023-10-25,9893
3056,富華新,13,0,13,元大-大天母,2023-10-25,9893
00679B,元大美債20年,17,5,12,元大-大天母,2023-10-25,9893
3481,群創,21,10,11,元大-大天母,2023-10-25,9893
3078,僑威,21,10,11,元大-大天母,2023-10-25,9893
00637L,元大滬深300正2,19,8,11,元大-大天母,2023-10-25,9893
2637,慧洋-KY,11,0,11,元大-大天母,2023-10-25,9893
6451,訊芯-KY,13,3,10,元大-大天母,2023-10-25,9893
2371,大同,10,0,10,元大-大天母,2023-10-25,9893
1519,華城,10,0,10,元大-大天母,2023-10-25,9893
8049,晶采,10,0,10,元大-大天母,2023-10-25,9893
3363,上詮,14,4,10,元大-大天母,2023-10-25,9893
4908,前鼎,11,1,10,元大-大天母,2023-10-25,9893
3535,晶彩科,10,0,10,元大-大天母,2023-10-25,9893
2323,中環,10,0,10,元大-大天母,2023-10-25,9893
6191,精成科,10,2,8,元大-大天母,2023-10-25,9893
5522,遠雄,8,0,8,元大-大天母,2023-10-25,9893
2465,麗臺,26,18,8,元大-大天母,2023-10-25,9893
3163,波若威,21,13,8,元大-大天母,2023-10-25,9893
00751B,元大AAA至A公司債,7,0,7,元大-大天母,2023-10-25,9893
2301,光寶科,9,2,7,元大-大天母,2023-10-25,9893
00772B,中信高評級公司債,7,0,7,元大-大天母,2023-10-25,9893
2892,第一金,202,3,199,元大-大天母,2023-10-26,9893
00929,復華台灣科技優息,212,26,186,元大-大天母,2023-10-26,9893
5439,高技,180,7,173,元大-大天母,2023-10-26,9893
2883,凱基金,147,2,145,元大-大天母,2023-10-26,9893
00706L,期元大S＆P日圓正2,140,0,140,元大-大天母,2023-10-26,9893
00919,群益台灣精選高息,122,0,122,元大-大天母,2023-10-26,9893
5258,虹堡,136,34,102,元大-大天母,2023-10-26,9893
1721,三晃,121,21,100,元大-大天母,2023-10-26,9893
0056,元大高股息,101,9,92,元大-大天母,2023-10-26,9893
2344,華邦電,117,28,89,元大-大天母,2023-10-26,9893
00922,國泰台灣領袖50,85,0,85,元大-大天母,2023-10-26,9893
00878,國泰永續高股息,85,1,84,元大-大天母,2023-10-26,9893
2634,漢翔,74,5,69,元大-大天母,2023-10-26,9893
00885,富邦越南,51,1,50,元大-大天母,2023-10-26,9893
00751B,元大AAA至A公司債,47,0,47,元大-大天母,2023-10-26,9893
1301,台塑,48,1,47,元大-大天母,2023-10-26,9893
4906,正文,52,5,47,元大-大天母,2023-10-26,9893
8213,志超,36,0,36,元大-大天母,2023-10-26,9893
0050,元大台灣50,37,2,35,元大-大天母,2023-10-26,9893
1524,耿鼎,58,27,31,元大-大天母,2023-10-26,9893
6443,元晶,30,0,30,元大-大天母,2023-10-26,9893
2330,台積電,33,4,29,元大-大天母,2023-10-26,9893
00631L,元大台灣50正2,32,4,28,元大-大天母,2023-10-26,9893
2890,永豐金,25,0,25,元大-大天母,2023-10-26,9893
8085,福華,24,0,24,元大-大天母,2023-10-26,9893
3019,亞光,23,0,23,元大-大天母,2023-10-26,9893
3711,日月光投控,23,1,22,元大-大天母,2023-10-26,9893
6770,力積電,23,1,22,元大-大天母,2023-10-26,9893
00712,復華富時不動產,25,4,21,元大-大天母,2023-10-26,9893
6156,松上,24,3,21,元大-大天母,2023-10-26,9893
2886,兆豐金,29,9,20,元大-大天母,2023-10-26,9893
6173,信昌電,20,0,20,元大-大天母,2023-10-26,9893
8358,金居,20,1,19,元大-大天母,2023-10-26,9893
3545,敦泰,22,3,19,元大-大天母,2023-10-26,9893
2382,廣達,28,10,18,元大-大天母,2023-10-26,9893
3234,光環,17,0,17,元大-大天母,2023-10-26,9893
3105,穩懋,16,0,16,元大-大天母,2023-10-26,9893
00687B,國泰20年美債,15,0,15,元大-大天母,2023-10-26,9893
2313,華通,18,3,15,元大-大天母,2023-10-26,9893
3058,立德,14,0,14,元大-大天母,2023-10-26,9893
5871,中租-KY,13,0,13,元大-大天母,2023-10-26,9893
6168,宏齊,120,107,13,元大-大天母,2023-10-26,9893
2408,南亞科,16,3,13,元大-大天母,2023-10-26,9893
00757,統一FANG+,12,0,12,元大-大天母,2023-10-26,9893
3048,益登,17,5,12,元大-大天母,2023-10-26,9893
2816,旺旺保,15,3,12,元大-大天母,2023-10-26,9893
2637,慧洋-KY,12,0,12,元大-大天母,2023-10-26,9893
2465,麗臺,18,6,12,元大-大天母,2023-10-26,9893
1795,美時,19,7,12,元大-大天母,2023-10-26,9893
6202,盛群,11,0,11,元大-大天母,2023-10-26,9893
00632R,元大台灣50反1,250,0,250,元大-大天母,2023-10-27,9893
00929,復華台灣科技優息,158,5,153,元大-大天母,2023-10-27,9893
2317,鴻海,125,2,123,元大-大天母,2023-10-27,9893
6168,宏齊,80,0,80,元大-大天母,2023-10-27,9893
2376,技嘉,42,3,39,元大-大天母,2023-10-27,9893
3438,類比科,30,0,30,元大-大天母,2023-10-27,9893
1711,永光,30,0,30,元大-大天母,2023-10-27,9893
00719B,元大美債1-3,30,0,30,元大-大天母,2023-10-27,9893
3234,光環,31,1,30,元大-大天母,2023-10-27,9893
00712,復華富時不動產,29,0,29,元大-大天母,2023-10-27,9893
2888,新光金,52,24,28,元大-大天母,2023-10-27,9893
2201,裕隆,28,1,27,元大-大天母,2023-10-27,9893
3325,旭品,25,0,25,元大-大天母,2023-10-27,9893
3322,建舜電,25,0,25,元大-大天母,2023-10-27,9893
2405,輔信,25,0,25,元大-大天母,2023-10-27,9893
00715L,期街口布蘭特正2,41,17,24,元大-大天母,2023-10-27,9893
2329,華泰,27,3,24,元大-大天母,2023-10-27,9893
1903,士紙,23,0,23,元大-大天母,2023-10-27,9893
2363,矽統,27,4,23,元大-大天母,2023-10-27,9893
3264,欣銓,26,4,22,元大-大天母,2023-10-27,9893
1101,台泥,30,10,20,元大-大天母,2023-10-27,9893
8086,宏捷科,20,0,20,元大-大天母,2023-10-27,9893
2883,凱基金,13,0,13,元大-大天母,2023-10-27,9893
9105,泰金寶-DR,13,0,13,元大-大天母,2023-10-27,9893
2485,兆赫,14,1,13,元大-大天母,2023-10-27,9893
0050,元大台灣50,17,4,13,元大-大天母,2023-10-27,9893
2002,中鋼,14,2,12,元大-大天母,2023-10-27,9893
1609,大亞,12,0,12,元大-大天母,2023-10-27,9893
2308,台達電,14,2,12,元大-大天母,2023-10-27,9893
3324,雙鴻,14,3,11,元大-大天母,2023-10-27,9893
3048,益登,11,0,11,元大-大天母,2023-10-27,9893
4977,眾達-KY,11,0,11,元大-大天母,2023-10-27,9893
8936,國統,11,0,11,元大-大天母,2023-10-27,9893
8054,安國,19,8,11,元大-大天母,2023-10-27,9893
3231,緯創,94,83,11,元大-大天母,2023-10-27,9893
1324,地球,10,0,10,元大-大天母,2023-10-27,9893
1905,華紙,10,0,10,元大-大天母,2023-10-27,9893
6577,勁豐,10,0,10,元大-大天母,2023-10-27,9893
2103,台橡,10,0,10,元大-大天母,2023-10-27,9893
2408,南亞科,11,1,10,元大-大天母,2023-10-27,9893
2337,旺宏,18,8,10,元大-大天母,2023-10-27,9893
6274,台燿,9,1,8,元大-大天母,2023-10-27,9893
4960,誠美材,8,0,8,元大-大天母,2023-10-27,9893
3363,上詮,9,1,8,元大-大天母,2023-10-27,9893
2892,第一金,8,0,8,元大-大天母,2023-10-27,9893
8358,金居,8,1,7,元大-大天母,2023-10-27,9893
3276,宇環,8,1,7,元大-大天母,2023-10-27,9893
9955,佳龍,7,0,7,元大-大天母,2023-10-27,9893
2425,承啟,8,1,7,元大-大天母,2023-10-27,9893
3701,大眾控,6,0,6,元大-大天母,2023-10-27,9893
2883,凱基金,332,14,318,元大-大天母,2023-10-30,9893
2885,元大金,262,1,261,元大-大天母,2023-10-30,9893
2317,鴻海,186,22,164,元大-大天母,2023-10-30,9893
1721,三晃,51,1,50,元大-大天母,2023-10-30,9893
3714,富采,50,0,50,元大-大天母,2023-10-30,9893
2892,第一金,53,10,43,元大-大天母,2023-10-30,9893
2618,長榮航,42,1,41,元大-大天母,2023-10-30,9893
00878,國泰永續高股息,40,1,39,元大-大天母,2023-10-30,9893
3234,光環,49,10,39,元大-大天母,2023-10-30,9893
00720B,元大投資級公司債,35,0,35,元大-大天母,2023-10-30,9893
8054,安國,50,15,35,元大-大天母,2023-10-30,9893
2886,兆豐金,36,5,31,元大-大天母,2023-10-30,9893
6668,中揚光,30,0,30,元大-大天母,2023-10-30,9893
00751B,元大AAA至A公司債,23,0,23,元大-大天母,2023-10-30,9893
2641,正德,23,0,23,元大-大天母,2023-10-30,9893
6526,達發,22,0,22,元大-大天母,2023-10-30,9893
3231,緯創,40,20,20,元大-大天母,2023-10-30,9893
6216,居易,19,2,17,元大-大天母,2023-10-30,9893
2353,宏��,16,0,16,元大-大天母,2023-10-30,9893
6477,安集,15,0,15,元大-大天母,2023-10-30,9893
2376,技嘉,13,1,12,元大-大天母,2023-10-30,9893
5258,虹堡,18,6,12,元大-大天母,2023-10-30,9893
3048,益登,12,0,12,元大-大天母,2023-10-30,9893
6117,迎廣,31,19,12,元大-大天母,2023-10-30,9893
3711,日月光投控,12,0,12,元大-大天母,2023-10-30,9893
2330,台積電,15,5,10,元大-大天母,2023-10-30,9893
0050,元大台灣50,11,1,10,元大-大天母,2023-10-30,9893
3715,定穎投控,36,26,10,元大-大天母,2023-10-30,9893
00933B,國泰10Y+金融債,10,0,10,元大-大天母,2023-10-30,9893
2888,新光金,10,0,10,元大-大天母,2023-10-30,9893
00772B,中信高評級公司債,10,0,10,元大-大天母,2023-10-30,9893
00918,大華優利高填息30,10,0,10,元大-大天母,2023-10-30,9893
2478,大毅,10,0,10,元大-大天母,2023-10-30,9893
4162,智擎,20,10,10,元大-大天母,2023-10-30,9893
00664R,國泰臺灣加權反1,10,0,10,元大-大天母,2023-10-30,9893
1711,永光,10,0,10,元大-大天母,2023-10-30,9893
00712,復華富時不動產,9,0,9,元大-大天母,2023-10-30,9893
6472,保瑞,14,5,9,元大-大天母,2023-10-30,9893
2485,兆赫,16,7,9,元大-大天母,2023-10-30,9893
5215,科嘉-KY,10,1,9,元大-大天母,2023-10-30,9893
2891,中信金,18,10,8,元大-大天母,2023-10-30,9893
2887,台新金,18,10,8,元大-大天母,2023-10-30,9893
1524,耿鼎,11,3,8,元大-大天母,2023-10-30,9893
2882,國泰金,7,0,7,元大-大天母,2023-10-30,9893
1565,精華,7,0,7,元大-大天母,2023-10-30,9893
2002,中鋼,18,11,7,元大-大天母,2023-10-30,9893
5287,數字,7,0,7,元大-大天母,2023-10-30,9893
2912,統一超,6,0,6,元大-大天母,2023-10-30,9893
2884,玉山金,16,10,6,元大-大天母,2023-10-30,9893
00931B,統一美債20年,6,0,6,元大-大天母,2023-10-30,9893
5439,高技,163,1,162,元大-大天母,2023-10-31,9893
6168,宏齊,134,5,129,元大-大天母,2023-10-31,9893
2888,新光金,116,2,114,元大-大天母,2023-10-31,9893
3006,晶豪科,105,6,99,元大-大天母,2023-10-31,9893
1903,士紙,78,0,78,元大-大天母,2023-10-31,9893
2892,第一金,78,2,76,元大-大天母,2023-10-31,9893
3048,益登,71,0,71,元大-大天母,2023-10-31,9893
00878,國泰永續高股息,68,9,59,元大-大天母,2023-10-31,9893
0056,元大高股息,74,23,51,元大-大天母,2023-10-31,9893
3532,台勝科,48,0,48,元大-大天母,2023-10-31,9893
2344,華邦電,48,3,45,元大-大天母,2023-10-31,9893
00919,群益台灣精選高息,45,0,45,元大-大天母,2023-10-31,9893
0050,元大台灣50,44,0,44,元大-大天母,2023-10-31,9893
2382,廣達,67,27,40,元大-大天母,2023-10-31,9893
5284,jpp-KY,31,1,30,元大-大天母,2023-10-31,9893
00631L,元大台灣50正2,29,0,29,元大-大天母,2023-10-31,9893
2303,聯電,49,20,29,元大-大天母,2023-10-31,9893
00922,國泰台灣領袖50,28,0,28,元大-大天母,2023-10-31,9893
6213,聯茂,69,42,27,元大-大天母,2023-10-31,9893
8213,志超,27,0,27,元大-大天母,2023-10-31,9893
3094,聯傑,39,13,26,元大-大天母,2023-10-31,9893
2388,威盛,37,12,25,元大-大天母,2023-10-31,9893
2332,友訊,21,0,21,元大-大天母,2023-10-31,9893
4960,誠美材,38,17,21,元大-大天母,2023-10-31,9893
6156,松上,20,0,20,元大-大天母,2023-10-31,9893
1711,永光,20,0,20,元大-大天母,2023-10-31,9893
6668,中揚光,20,0,20,元大-大天母,2023-10-31,9893
2329,華泰,26,7,19,元大-大天母,2023-10-31,9893
00715L,期街口布蘭特正2,19,3,16,元大-大天母,2023-10-31,9893
00772B,中信高評級公司債,15,0,15,元大-大天母,2023-10-31,9893
4973,廣穎,23,8,15,元大-大天母,2023-10-31,9893
3346,麗清,16,1,15,元大-大天母,2023-10-31,9893
3056,富華新,15,0,15,元大-大天母,2023-10-31,9893
00929,復華台灣科技優息,47,33,14,元大-大天母,2023-10-31,9893
9958,世紀鋼,27,13,14,元大-大天母,2023-10-31,9893
3078,僑威,22,8,14,元大-大天母,2023-10-31,9893
8482,商億-KY,14,0,14,元大-大天母,2023-10-31,9893
2404,漢唐,16,2,14,元大-大天母,2023-10-31,9893
1101,台泥,20,7,13,元大-大天母,2023-10-31,9893
1605,華新,12,0,12,元大-大天母,2023-10-31,9893
8054,安國,16,4,12,元大-大天母,2023-10-31,9893
4977,眾達-KY,13,1,12,元大-大天母,2023-10-31,9893
4906,正文,12,0,12,元大-大天母,2023-10-31,9893
6290,良維,11,0,11,元大-大天母,2023-10-31,9893
2882,國泰金,11,0,11,元大-大天母,2023-10-31,9893
3032,偉訓,13,2,11,元大-大天母,2023-10-31,9893
1447,力鵬,10,0,10,元大-大天母,2023-10-31,9893
2483,百容,10,0,10,元大-大天母,2023-10-31,9893
3372,典範,10,0,10,元大-大天母,2023-10-31,9893
2481,強茂,20,10,10,元大-大天母,2023-10-31,9893
00934,中信成長高股息,265,0,265,元大-大天母,2023-11-01,9893
00878,國泰永續高股息,91,0,91,元大-大天母,2023-11-01,9893
3048,益登,91,0,91,元大-大天母,2023-11-01,9893
2610,華航,104,28,76,元大-大天母,2023-11-01,9893
00712,復華富時不動產,54,2,52,元大-大天母,2023-11-01,9893
00679B,元大美債20年,54,3,51,元大-大天母,2023-11-01,9893
1721,三晃,40,0,40,元大-大天母,2023-11-01,9893
00929,復華台灣科技優息,31,0,31,元大-大天母,2023-11-01,9893
6126,信音,30,0,30,元大-大天母,2023-11-01,9893
6443,元晶,30,0,30,元大-大天母,2023-11-01,9893
5521,工信,24,0,24,元大-大天母,2023-11-01,9893
3576,聯合再生,20,0,20,元大-大天母,2023-11-01,9893
4973,廣穎,20,0,20,元大-大天母,2023-11-01,9893
1905,華紙,20,0,20,元大-大天母,2023-11-01,9893
2382,廣達,28,9,19,元大-大天母,2023-11-01,9893
00933B,國泰10Y+金融債,18,0,18,元大-大天母,2023-11-01,9893
8039,台虹,16,0,16,元大-大天母,2023-11-01,9893
5009,榮剛,15,0,15,元大-大天母,2023-11-01,9893
6139,亞翔,16,2,14,元大-大天母,2023-11-01,9893
00935,野村臺灣新科技50,13,0,13,元大-大天母,2023-11-01,9893
2344,華邦電,13,0,13,元大-大天母,2023-11-01,9893
00751B,元大AAA至A公司債,13,0,13,元大-大天母,2023-11-01,9893
6285,啟��,17,5,12,元大-大天母,2023-11-01,9893
3322,建舜電,15,3,12,元大-大天母,2023-11-01,9893
00680L,元大美債20正2,12,0,12,元大-大天母,2023-11-01,9893
00922,國泰台灣領袖50,10,0,10,元大-大天母,2023-11-01,9893
3013,晟銘電,16,6,10,元大-大天母,2023-11-01,9893
6770,力積電,21,11,10,元大-大天母,2023-11-01,9893
00850,元大臺灣ESG永續,10,0,10,元大-大天母,2023-11-01,9893
2913,農林,10,0,10,元大-大天母,2023-11-01,9893
1709,和益,10,0,10,元大-大天母,2023-11-01,9893
1312,國喬,10,0,10,元大-大天母,2023-11-01,9893
6415,矽力*-KY,11,1,10,元大-大天母,2023-11-01,9893
2308,台達電,11,1,10,元大-大天母,2023-11-01,9893
00885,富邦越南,9,0,9,元大-大天母,2023-11-01,9893
3051,力特,9,0,9,元大-大天母,2023-11-01,9893
5483,中美晶,15,6,9,元大-大天母,2023-11-01,9893
2206,三陽工業,9,0,9,元大-大天母,2023-11-01,9893
3265,台星科,8,0,8,元大-大天母,2023-11-01,9893
3704,合勤控,22,14,8,元大-大天母,2023-11-01,9893
2417,圓剛,30,22,8,元大-大天母,2023-11-01,9893
3363,上詮,13,5,8,元大-大天母,2023-11-01,9893
3094,聯傑,11,3,8,元大-大天母,2023-11-01,9893
6168,宏齊,32,24,8,元大-大天母,2023-11-01,9893
2891,中信金,7,0,7,元大-大天母,2023-11-01,9893
3036,文曄,9,2,7,元大-大天母,2023-11-01,9893
4915,致伸,8,1,7,元大-大天母,2023-11-01,9893
2465,麗臺,10,3,7,元大-大天母,2023-11-01,9893
2314,台揚,7,0,7,元大-大天母,2023-11-01,9893
0056,元大高股息,12,5,7,元大-大天母,2023-11-01,9893
00878,國泰永續高股息,280,33,247,元大-大天母,2023-11-02,9893
3715,定穎投控,148,36,112,元大-大天母,2023-11-02,9893
00632R,元大台灣50反1,100,0,100,元大-大天母,2023-11-02,9893
6271,同欣電,100,0,100,元大-大天母,2023-11-02,9893
3260,威剛,106,15,91,元大-大天母,2023-11-02,9893
1711,永光,70,0,70,元大-大天母,2023-11-02,9893
2409,友達,60,4,56,元大-大天母,2023-11-02,9893
2618,長榮航,107,66,41,元大-大天母,2023-11-02,9893
2520,冠德,40,0,40,元大-大天母,2023-11-02,9893
00934,中信成長高股息,34,0,34,元大-大天母,2023-11-02,9893
2211,長榮鋼,34,10,24,元大-大天母,2023-11-02,9893
9105,泰金寶-DR,23,2,21,元大-大天母,2023-11-02,9893
00633L,富邦上証正2,20,0,20,元大-大天母,2023-11-02,9893
00676R,富邦臺灣加權反1,20,0,20,元大-大天母,2023-11-02,9893
6122,擎邦,20,0,20,元大-大天母,2023-11-02,9893
0056,元大高股息,66,48,18,元大-大天母,2023-11-02,9893
6282,康舒,16,0,16,元大-大天母,2023-11-02,9893
00646,元大S＆P500,15,0,15,元大-大天母,2023-11-02,9893
00715L,期街口布蘭特正2,13,0,13,元大-大天母,2023-11-02,9893
6126,信音,13,0,13,元大-大天母,2023-11-02,9893
8299,群聯,15,3,12,元大-大天母,2023-11-02,9893
3048,益登,12,0,12,元大-大天母,2023-11-02,9893
6799,來頡,12,0,12,元大-大天母,2023-11-02,9893
2376,技嘉,16,5,11,元大-大天母,2023-11-02,9893
2404,漢唐,11,0,11,元大-大天母,2023-11-02,9893
2230,泰茂,10,0,10,元大-大天母,2023-11-02,9893
2850,新產,10,0,10,元大-大天母,2023-11-02,9893
6168,宏齊,10,0,10,元大-大天母,2023-11-02,9893
1522,堤維西,10,0,10,元大-大天母,2023-11-02,9893
5215,科嘉-KY,10,0,10,元大-大天母,2023-11-02,9893
6411,晶焱,11,1,10,元大-大天母,2023-11-02,9893
2353,宏��,10,1,9,元大-大天母,2023-11-02,9893
3545,敦泰,13,5,8,元大-大天母,2023-11-02,9893
1313,聯成,9,2,7,元大-大天母,2023-11-02,9893
1795,美時,18,11,7,元大-大天母,2023-11-02,9893
3231,緯創,68,61,7,元大-大天母,2023-11-02,9893
3090,日電貿,6,0,6,元大-大天母,2023-11-02,9893
2607,榮運,6,0,6,元大-大天母,2023-11-02,9893
4909,新復興,7,1,6,元大-大天母,2023-11-02,9893
8358,金居,6,0,6,元大-大天母,2023-11-02,9893
2504,國產,6,0,6,元大-大天母,2023-11-02,9893
4763,材料-KY,16,11,5,元大-大天母,2023-11-02,9893
00757,統一FANG+,5,0,5,元大-大天母,2023-11-02,9893
2402,毅嘉,5,0,5,元大-大天母,2023-11-02,9893
6461,益得,5,0,5,元大-大天母,2023-11-02,9893
1447,力鵬,5,0,5,元大-大天母,2023-11-02,9893
3483,力致,5,0,5,元大-大天母,2023-11-02,9893
8215,明基材,5,0,5,元大-大天母,2023-11-02,9893
00687B,國泰20年美債,5,1,4,元大-大天母,2023-11-02,9893
00902,中信電池及儲能,4,0,4,元大-大天母,2023-11-02,9893
00929,復華台灣科技優息,164,49,115,元大-大天母,2023-11-03,9893
2363,矽統,382,292,90,元大-大天母,2023-11-03,9893
1903,士紙,79,15,64,元大-大天母,2023-11-03,9893
9924,福興,60,0,60,元大-大天母,2023-11-03,9893
00919,群益台灣精選高息,70,11,59,元大-大天母,2023-11-03,9893
6271,同欣電,57,3,54,元大-大天母,2023-11-03,9893
00632R,元大台灣50反1,50,0,50,元大-大天母,2023-11-03,9893
5284,jpp-KY,50,0,50,元大-大天母,2023-11-03,9893
00878,國泰永續高股息,55,6,49,元大-大天母,2023-11-03,9893
8039,台虹,43,0,43,元大-大天母,2023-11-03,9893
6168,宏齊,71,29,42,元大-大天母,2023-11-03,9893
1711,永光,30,0,30,元大-大天母,2023-11-03,9893
6770,力積電,76,47,29,元大-大天母,2023-11-03,9893
8150,南茂,30,1,29,元大-大天母,2023-11-03,9893
3019,亞光,30,5,25,元大-大天母,2023-11-03,9893
1560,中砂,54,30,24,元大-大天母,2023-11-03,9893
00934,中信成長高股息,23,0,23,元大-大天母,2023-11-03,9893
5432,新門,20,0,20,元大-大天母,2023-11-03,9893
6156,松上,19,3,16,元大-大天母,2023-11-03,9893
3011,今皓,16,0,16,元大-大天母,2023-11-03,9893
2382,廣達,23,7,16,元大-大天母,2023-11-03,9893
2376,技嘉,19,4,15,元大-大天母,2023-11-03,9893
2332,友訊,14,0,14,元大-大天母,2023-11-03,9893
2317,鴻海,25,12,13,元大-大天母,2023-11-03,9893
1584,精剛,15,2,13,元大-大天母,2023-11-03,9893
2458,義隆,16,4,12,元大-大天母,2023-11-03,9893
00712,復華富時不動產,16,5,11,元大-大天母,2023-11-03,9893
00764B,群益25年美債,11,0,11,元大-大天母,2023-11-03,9893
2371,大同,11,0,11,元大-大天母,2023-11-03,9893
00935,野村臺灣新科技50,10,0,10,元大-大天母,2023-11-03,9893
4167,松瑞藥,10,0,10,元大-大天母,2023-11-03,9893
00923,群益台ESG低碳50,10,1,9,元大-大天母,2023-11-03,9893
1795,美時,12,3,9,元大-大天母,2023-11-03,9893
3034,聯詠,10,1,9,元大-大天母,2023-11-03,9893
2353,宏��,8,0,8,元大-大天母,2023-11-03,9893
4108,懷特,8,0,8,元大-大天母,2023-11-03,9893
5347,世界,8,0,8,元大-大天母,2023-11-03,9893
00720B,元大投資級公司債,32,24,8,元大-大天母,2023-11-03,9893
2903,遠百,8,0,8,元大-大天母,2023-11-03,9893
2358,廷鑫,10,2,8,元大-大天母,2023-11-03,9893
00676R,富邦臺灣加權反1,8,0,8,元大-大天母,2023-11-03,9893
2356,英業達,8,1,7,元大-大天母,2023-11-03,9893
00673R,期元大S＆P原油反1,7,0,7,元大-大天母,2023-11-03,9893
8215,明基材,7,0,7,元大-大天母,2023-11-03,9893
2605,新興,13,6,7,元大-大天母,2023-11-03,9893
3231,緯創,57,51,6,元大-大天母,2023-11-03,9893
6202,盛群,6,0,6,元大-大天母,2023-11-03,9893
2548,華固,6,0,6,元大-大天母,2023-11-03,9893
2520,冠德,6,0,6,元大-大天母,2023-11-03,9893
3653,健策,6,0,6,元大-大天母,2023-11-03,9893
2388,威盛,136,31,105,元大-大天母,2023-11-06,9893
2891,中信金,102,26,76,元大-大天母,2023-11-06,9893
2618,長榮航,122,54,68,元大-大天母,2023-11-06,9893
00935,野村臺灣新科技50,68,0,68,元大-大天母,2023-11-06,9893
1102,亞泥,60,3,57,元大-大天母,2023-11-06,9893
8433,弘帆,50,0,50,元大-大天母,2023-11-06,9893
00632R,元大台灣50反1,50,0,50,元大-大天母,2023-11-06,9893
6770,力積電,67,18,49,元大-大天母,2023-11-06,9893
3376,新日興,53,4,49,元大-大天母,2023-11-06,9893
3011,今皓,36,0,36,元大-大天母,2023-11-06,9893
3019,亞光,31,0,31,元大-大天母,2023-11-06,9893
00922,國泰台灣領袖50,29,0,29,元大-大天母,2023-11-06,9893
00720B,元大投資級公司債,25,0,25,元大-大天母,2023-11-06,9893
3324,雙鴻,29,5,24,元大-大天母,2023-11-06,9893
3545,敦泰,30,7,23,元大-大天母,2023-11-06,9893
00931B,統一美債20年,22,0,22,元大-大天母,2023-11-06,9893
3576,聯合再生,24,3,21,元大-大天母,2023-11-06,9893
3013,晟銘電,25,4,21,元大-大天母,2023-11-06,9893
1721,三晃,26,6,20,元大-大天母,2023-11-06,9893
6156,松上,21,1,20,元大-大天母,2023-11-06,9893
1711,永光,20,0,20,元大-大天母,2023-11-06,9893
00933B,國泰10Y+金融債,20,0,20,元大-大天母,2023-11-06,9893
2363,矽統,61,41,20,元大-大天母,2023-11-06,9893
00715L,期街口布蘭特正2,20,1,19,元大-大天母,2023-11-06,9893
2609,陽明,37,18,19,元大-大天母,2023-11-06,9893
6168,宏齊,25,6,19,元大-大天母,2023-11-06,9893
3228,金麗科,20,2,18,元大-大天母,2023-11-06,9893
00679B,元大美債20年,19,2,17,元大-大天母,2023-11-06,9893
8110,華東,19,3,16,元大-大天母,2023-11-06,9893
8150,南茂,22,6,16,元大-大天母,2023-11-06,9893
9911,櫻花,15,0,15,元大-大天母,2023-11-06,9893
5009,榮剛,23,8,15,元大-大天母,2023-11-06,9893
1560,中砂,16,1,15,元大-大天母,2023-11-06,9893
1524,耿鼎,18,4,14,元大-大天母,2023-11-06,9893
2002,中鋼,19,5,14,元大-大天母,2023-11-06,9893
9921,巨大,13,0,13,元大-大天母,2023-11-06,9893
2883,凱基金,20,8,12,元大-大天母,2023-11-06,9893
2486,一詮,13,1,12,元大-大天母,2023-11-06,9893
00642U,期元大S＆P石油,12,0,12,元大-大天母,2023-11-06,9893
00687B,國泰20年美債,11,0,11,元大-大天母,2023-11-06,9893
00915,凱基優選高股息30,10,0,10,元大-大天母,2023-11-06,9893
2014,中鴻,15,5,10,元大-大天母,2023-11-06,9893
1447,力鵬,10,0,10,元大-大天母,2023-11-06,9893
8050,廣積,10,0,10,元大-大天母,2023-11-06,9893
2206,三陽工業,14,5,9,元大-大天母,2023-11-06,9893
4908,前鼎,25,16,9,元大-大天母,2023-11-06,9893
2520,冠德,9,0,9,元大-大天母,2023-11-06,9893
6133,金橋,10,1,9,元大-大天母,2023-11-06,9893
5328,華容,9,0,9,元大-大天母,2023-11-06,9893
5258,虹堡,18,10,8,元大-大天母,2023-11-06,9893
2890,永豐金,500,2,498,元大-大天母,2023-11-07,9893
00922,國泰台灣領袖50,102,0,102,元大-大天母,2023-11-07,9893
00706L,期元大S＆P日圓正2,75,0,75,元大-大天母,2023-11-07,9893
1449,佳和,80,14,66,元大-大天母,2023-11-07,9893
3090,日電貿,66,1,65,元大-大天母,2023-11-07,9893
00934,中信成長高股息,58,1,57,元大-大天母,2023-11-07,9893
2618,長榮航,56,2,54,元大-大天母,2023-11-07,9893
3689,湧德,50,4,46,元大-大天母,2023-11-07,9893
2344,華邦電,61,20,41,元大-大天母,2023-11-07,9893
6168,宏齊,104,64,40,元大-大天母,2023-11-07,9893
3052,夆典,40,0,40,元大-大天母,2023-11-07,9893
1795,美時,46,6,40,元大-大天母,2023-11-07,9893
2610,華航,45,6,39,元大-大天母,2023-11-07,9893
3669,圓展,39,0,39,元大-大天母,2023-11-07,9893
2743,山富,64,28,36,元大-大天母,2023-11-07,9893
6126,信音,34,0,34,元大-大天母,2023-11-07,9893
8043,蜜望實,30,0,30,元大-大天母,2023-11-07,9893
00715L,期街口布蘭特正2,29,0,29,元大-大天母,2023-11-07,9893
2206,三陽工業,32,3,29,元大-大天母,2023-11-07,9893
2002,中鋼,30,2,28,元大-大天母,2023-11-07,9893
8299,群聯,51,25,26,元大-大天母,2023-11-07,9893
4167,松瑞藥,32,7,25,元大-大天母,2023-11-07,9893
00878,國泰永續高股息,30,9,21,元大-大天母,2023-11-07,9893
2882,國泰金,20,0,20,元大-大天母,2023-11-07,9893
1711,永光,20,0,20,元大-大天母,2023-11-07,9893
3211,順達,20,0,20,元大-大天母,2023-11-07,9893
2393,億光,20,0,20,元大-大天母,2023-11-07,9893
2317,鴻海,18,1,17,元大-大天母,2023-11-07,9893
6173,信昌電,14,0,14,元大-大天母,2023-11-07,9893
2634,漢翔,16,3,13,元大-大天母,2023-11-07,9893
00900,富邦特選高股息30,15,2,13,元大-大天母,2023-11-07,9893
2504,國產,12,0,12,元大-大天母,2023-11-07,9893
00631L,元大台灣50正2,11,0,11,元大-大天母,2023-11-07,9893
2314,台揚,13,2,11,元大-大天母,2023-11-07,9893
2637,慧洋-KY,11,0,11,元大-大天母,2023-11-07,9893
1524,耿鼎,13,2,11,元大-大天母,2023-11-07,9893
6155,鈞寶,10,0,10,元大-大天母,2023-11-07,9893
2486,一詮,12,2,10,元大-大天母,2023-11-07,9893
3105,穩懋,9,0,9,元大-大天母,2023-11-07,9893
5471,松翰,10,1,9,元大-大天母,2023-11-07,9893
6274,台燿,8,0,8,元大-大天母,2023-11-07,9893
2498,宏達電,8,0,8,元大-大天母,2023-11-07,9893
3622,洋華,8,0,8,元大-大天母,2023-11-07,9893
4162,智擎,18,10,8,元大-大天母,2023-11-07,9893
1785,光洋科,10,3,7,元大-大天母,2023-11-07,9893
00931B,統一美債20年,7,0,7,元大-大天母,2023-11-07,9893
6278,台表科,7,0,7,元大-大天母,2023-11-07,9893
5351,鈺創,10,3,7,元大-大天母,2023-11-07,9893
6282,康舒,7,0,7,元大-大天母,2023-11-07,9893
8110,華東,10,3,7,元大-大天母,2023-11-07,9893
3231,緯創,624,252,372,元大-大天母,2023-11-08,9893
1815,富喬,294,7,287,元大-大天母,2023-11-08,9893
00715L,期街口布蘭特正2,158,6,152,元大-大天母,2023-11-08,9893
6138,茂達,101,2,99,元大-大天母,2023-11-08,9893
2206,三陽工業,114,17,97,元大-大天母,2023-11-08,9893
1314,中石化,100,4,96,元大-大天母,2023-11-08,9893
1721,三晃,88,3,85,元大-大天母,2023-11-08,9893
2303,聯電,74,11,63,元大-大天母,2023-11-08,9893
6168,宏齊,55,1,54,元大-大天母,2023-11-08,9893
00632R,元大台灣50反1,50,0,50,元大-大天母,2023-11-08,9893
00706L,期元大S＆P日圓正2,35,0,35,元大-大天母,2023-11-08,9893
2916,滿心,30,0,30,元大-大天母,2023-11-08,9893
2468,華經,30,0,30,元大-大天母,2023-11-08,9893
00676R,富邦臺灣加權反1,30,0,30,元大-大天母,2023-11-08,9893
5905,南仁湖,26,0,26,元大-大天母,2023-11-08,9893
2317,鴻海,30,4,26,元大-大天母,2023-11-08,9893
9105,泰金寶-DR,25,0,25,元大-大天母,2023-11-08,9893
6122,擎邦,35,11,24,元大-大天母,2023-11-08,9893
8043,蜜望實,24,0,24,元大-大天母,2023-11-08,9893
00648R,元大S＆P500反1,24,0,24,元大-大天母,2023-11-08,9893
00929,復華台灣科技優息,37,14,23,元大-大天母,2023-11-08,9893
00882,中信中國高股息,22,0,22,元大-大天母,2023-11-08,9893
2618,長榮航,60,40,20,元大-大天母,2023-11-08,9893
3689,湧德,21,1,20,元大-大天母,2023-11-08,9893
00713,元大台灣高息低波,20,0,20,元大-大天母,2023-11-08,9893
1710,東聯,20,0,20,元大-大天母,2023-11-08,9893
6126,信音,19,0,19,元大-大天母,2023-11-08,9893
00674R,期元大S＆P黃金反1,18,0,18,元大-大天母,2023-11-08,9893
6202,盛群,18,1,17,元大-大天母,2023-11-08,9893
2388,威盛,42,26,16,元大-大天母,2023-11-08,9893
2376,技嘉,31,16,15,元大-大天母,2023-11-08,9893
4968,立積,16,1,15,元大-大天母,2023-11-08,9893
5347,世界,19,5,14,元大-大天母,2023-11-08,9893
3090,日電貿,15,1,14,元大-大天母,2023-11-08,9893
00900,富邦特選高股息30,13,0,13,元大-大天母,2023-11-08,9893
2330,台積電,20,7,13,元大-大天母,2023-11-08,9893
00680L,元大美債20正2,15,2,13,元大-大天母,2023-11-08,9893
3048,益登,12,0,12,元大-大天母,2023-11-08,9893
3217,優群,16,4,12,元大-大天母,2023-11-08,9893
2617,台航,10,0,10,元大-大天母,2023-11-08,9893
4167,松瑞藥,25,15,10,元大-大天母,2023-11-08,9893
6426,統新,11,1,10,元大-大天母,2023-11-08,9893
2436,偉詮電,10,0,10,元大-大天母,2023-11-08,9893
2453,凌群,11,2,9,元大-大天母,2023-11-08,9893
6176,瑞儀,12,3,9,元大-大天母,2023-11-08,9893
2637,慧洋-KY,11,2,9,元大-大天母,2023-11-08,9893
3022,威強電,9,0,9,元大-大天母,2023-11-08,9893
3325,旭品,8,0,8,元大-大天母,2023-11-08,9893
00714,群益道瓊美國地產,8,0,8,元大-大天母,2023-11-08,9893
3483,力致,10,2,8,元大-大天母,2023-11-08,9893
00715L,期街口布蘭特正2,168,0,168,元大-大天母,2023-11-09,9893
3548,兆利,144,7,137,元大-大天母,2023-11-09,9893
2374,佳能,115,10,105,元大-大天母,2023-11-09,9893
2329,華泰,206,126,80,元大-大天母,2023-11-09,9893
2610,華航,65,1,64,元大-大天母,2023-11-09,9893
3231,緯創,135,77,58,元大-大天母,2023-11-09,9893
00936,台新永續高息中小,56,0,56,元大-大天母,2023-11-09,9893
4906,正文,50,0,50,元大-大天母,2023-11-09,9893
2888,新光金,40,0,40,元大-大天母,2023-11-09,9893
6168,宏齊,45,7,38,元大-大天母,2023-11-09,9893
00679B,元大美債20年,52,16,36,元大-大天母,2023-11-09,9893
00676R,富邦臺灣加權反1,36,0,36,元大-大天母,2023-11-09,9893
00632R,元大台灣50反1,34,0,34,元大-大天母,2023-11-09,9893
5347,世界,30,0,30,元大-大天母,2023-11-09,9893
00751B,元大AAA至A公司債,27,3,24,元大-大天母,2023-11-09,9893
00722B,群益投資級電信債,22,0,22,元大-大天母,2023-11-09,9893
3701,大眾控,21,0,21,元大-大天母,2023-11-09,9893
3709,鑫聯大投控,20,0,20,元大-大天母,2023-11-09,9893
2388,威盛,34,14,20,元大-大天母,2023-11-09,9893
00915,凱基優選高股息30,21,3,18,元大-大天母,2023-11-09,9893
3078,僑威,18,0,18,元大-大天母,2023-11-09,9893
2376,技嘉,41,24,17,元大-大天母,2023-11-09,9893
3094,聯傑,20,3,17,元大-大天母,2023-11-09,9893
6530,創威,31,14,17,元大-大天母,2023-11-09,9893
2059,川湖,17,0,17,元大-大天母,2023-11-09,9893
3715,定穎投控,17,2,15,元大-大天母,2023-11-09,9893
6278,台表科,14,0,14,元大-大天母,2023-11-09,9893
6799,來頡,15,2,13,元大-大天母,2023-11-09,9893
00795B,中信美國公債20年,14,2,12,元大-大天母,2023-11-09,9893
3260,威剛,14,2,12,元大-大天母,2023-11-09,9893
00753L,中信中國50正2,12,0,12,元大-大天母,2023-11-09,9893
3483,力致,11,0,11,元大-大天母,2023-11-09,9893
4967,十銓,13,2,11,元大-大天母,2023-11-09,9893
00687B,國泰20年美債,12,2,10,元大-大天母,2023-11-09,9893
2637,慧洋-KY,10,0,10,元大-大天母,2023-11-09,9893
3484,崧騰,10,0,10,元大-大天母,2023-11-09,9893
3705,永信,10,0,10,元大-大天母,2023-11-09,9893
2010,春源,10,0,10,元大-大天母,2023-11-09,9893
2745,五福,10,0,10,元大-大天母,2023-11-09,9893
2916,滿心,10,0,10,元大-大天母,2023-11-09,9893
3014,聯陽,13,3,10,元大-大天母,2023-11-09,9893
2308,台達電,11,2,9,元大-大天母,2023-11-09,9893
2201,裕隆,15,6,9,元大-大天母,2023-11-09,9893
2313,華通,19,11,8,元大-大天母,2023-11-09,9893
2451,創見,10,2,8,元大-大天母,2023-11-09,9893
4934,太極,8,0,8,元大-大天母,2023-11-09,9893
3645,達邁,8,0,8,元大-大天母,2023-11-09,9893
2360,致茂,8,0,8,元大-大天母,2023-11-09,9893
3217,優群,11,3,8,元大-大天母,2023-11-09,9893
0050,元大台灣50,7,0,7,元大-大天母,2023-11-09,9893
00904,新光臺灣半導體30,111,0,111,元大-大天母,2023-11-10,9893
3605,宏致,100,0,100,元大-大天母,2023-11-10,9893
2363,矽統,144,54,90,元大-大天母,2023-11-10,9893
00680L,元大美債20正2,73,0,73,元大-大天母,2023-11-10,9893
1314,中石化,67,0,67,元大-大天母,2023-11-10,9893
3011,今皓,50,0,50,元大-大天母,2023-11-10,9893
6901,鑽石投資,54,11,43,元大-大天母,2023-11-10,9893
8210,勤誠,40,0,40,元大-大天母,2023-11-10,9893
00688L,國泰20年美債正2,40,0,40,元大-大天母,2023-11-10,9893
00878,國泰永續高股息,37,0,37,元大-大天母,2023-11-10,9893
6168,宏齊,31,0,31,元大-大天母,2023-11-10,9893
4111,濟生,30,0,30,元大-大天母,2023-11-10,9893
00936,台新永續高息中小,33,5,28,元大-大天母,2023-11-10,9893
00919,群益台灣精選高息,26,2,24,元大-大天母,2023-11-10,9893
00679B,元大美債20年,36,13,23,元大-大天母,2023-11-10,9893
2399,映泰,22,0,22,元大-大天母,2023-11-10,9893
2002,中鋼,20,0,20,元大-大天母,2023-11-10,9893
00751B,元大AAA至A公司債,20,0,20,元大-大天母,2023-11-10,9893
00632R,元大台灣50反1,20,0,20,元大-大天母,2023-11-10,9893
2495,普安,20,0,20,元大-大天母,2023-11-10,9893
6271,同欣電,18,0,18,元大-大天母,2023-11-10,9893
3090,日電貿,17,0,17,元大-大天母,2023-11-10,9893
4108,懷特,15,0,15,元大-大天母,2023-11-10,9893
3312,弘憶股,17,2,15,元大-大天母,2023-11-10,9893
2913,農林,14,0,14,元大-大天母,2023-11-10,9893
2344,華邦電,18,5,13,元大-大天母,2023-11-10,9893
2834,臺企銀,12,0,12,元大-大天母,2023-11-10,9893
8433,弘帆,12,0,12,元大-大天母,2023-11-10,9893
3484,崧騰,11,0,11,元大-大天母,2023-11-10,9893
4107,邦特,11,0,11,元大-大天母,2023-11-10,9893
4977,眾達-KY,11,0,11,元大-大天母,2023-11-10,9893
8034,榮群,27,16,11,元大-大天母,2023-11-10,9893
3363,上詮,15,5,10,元大-大天母,2023-11-10,9893
1522,堤維西,10,0,10,元大-大天母,2023-11-10,9893
2108,南帝,10,0,10,元大-大天母,2023-11-10,9893
2748,雲品,10,0,10,元大-大天母,2023-11-10,9893
3481,群創,11,1,10,元大-大天母,2023-11-10,9893
3052,夆典,10,0,10,元大-大天母,2023-11-10,9893
4128,中天,28,18,10,元大-大天母,2023-11-10,9893
6112,邁達特,10,0,10,元大-大天母,2023-11-10,9893
2637,慧洋-KY,10,0,10,元大-大天母,2023-11-10,9893
2801,彰銀,9,0,9,元大-大天母,2023-11-10,9893
00720B,元大投資級公司債,9,0,9,元大-大天母,2023-11-10,9893
2201,裕隆,10,1,9,元大-大天母,2023-11-10,9893
1210,大成,11,2,9,元大-大天母,2023-11-10,9893
2382,廣達,18,9,9,元大-大天母,2023-11-10,9893
2338,光罩,9,0,9,元大-大天母,2023-11-10,9893
2408,南亞科,8,0,8,元大-大天母,2023-11-10,9893
2376,技嘉,18,10,8,元大-大天母,2023-11-10,9893
2425,承啟,8,0,8,元大-大天母,2023-11-10,9893
2607,榮運,652,8,644,元大-大天母,2023-11-13,9893
00665L,富邦�琤肭磪囓�2,200,0,200,元大-大天母,2023-11-13,9893
2412,中華電,200,2,198,元大-大天母,2023-11-13,9893
00929,復華台灣科技優息,140,17,123,元大-大天母,2023-11-13,9893
6138,茂達,124,1,123,元大-大天母,2023-11-13,9893
1815,富喬,110,0,110,元大-大天母,2023-11-13,9893
00680L,元大美債20正2,125,15,110,元大-大天母,2023-11-13,9893
00632R,元大台灣50反1,82,0,82,元大-大天母,2023-11-13,9893
2888,新光金,60,0,60,元大-大天母,2023-11-13,9893
8433,弘帆,59,0,59,元大-大天母,2023-11-13,9893
1903,士紙,57,0,57,元大-大天母,2023-11-13,9893
2031,新光鋼,56,0,56,元大-大天母,2023-11-13,9893
6104,創惟,51,2,49,元大-大天母,2023-11-13,9893
1519,華城,61,16,45,元大-大天母,2023-11-13,9893
00919,群益台灣精選高息,41,0,41,元大-大天母,2023-11-13,9893
2618,長榮航,39,2,37,元大-大天母,2023-11-13,9893
00679B,元大美債20年,58,22,36,元大-大天母,2023-11-13,9893
6670,復盛應用,31,0,31,元大-大天母,2023-11-13,9893
2834,臺企銀,31,0,31,元大-大天母,2023-11-13,9893
3325,旭品,30,0,30,元大-大天母,2023-11-13,9893
6275,元山,30,0,30,元大-大天母,2023-11-13,9893
2206,三陽工業,26,0,26,元大-大天母,2023-11-13,9893
00894,中信小資高價30,25,0,25,元大-大天母,2023-11-13,9893
2369,菱生,29,6,23,元大-大天母,2023-11-13,9893
2504,國產,22,0,22,元大-大天母,2023-11-13,9893
2025,千興,22,0,22,元大-大天母,2023-11-13,9893
00878,國泰永續高股息,78,56,22,元大-大天母,2023-11-13,9893
2363,矽統,32,11,21,元大-大天母,2023-11-13,9893
1711,永光,20,0,20,元大-大天母,2023-11-13,9893
6204,艾華,20,0,20,元大-大天母,2023-11-13,9893
00687B,國泰20年美債,20,0,20,元大-大天母,2023-11-13,9893
00892,富邦台灣半導體,17,2,15,元大-大天母,2023-11-13,9893
1609,大亞,15,0,15,元大-大天母,2023-11-13,9893
00921,兆豐龍頭等權重,15,0,15,元大-大天母,2023-11-13,9893
2382,廣達,30,16,14,元大-大天母,2023-11-13,9893
5469,瀚宇博,14,0,14,元大-大天母,2023-11-13,9893
8358,金居,13,0,13,元大-大天母,2023-11-13,9893
2353,宏��,20,8,12,元大-大天母,2023-11-13,9893
3483,力致,13,1,12,元大-大天母,2023-11-13,9893
5225,東科-KY,12,0,12,元大-大天母,2023-11-13,9893
6703,軒郁,11,0,11,元大-大天母,2023-11-13,9893
2352,佳世達,13,2,11,元大-大天母,2023-11-13,9893
6805,富世達,12,1,11,元大-大天母,2023-11-13,9893
00692,富邦公司治理,12,1,11,元大-大天母,2023-11-13,9893
00688L,國泰20年美債正2,11,0,11,元大-大天母,2023-11-13,9893
00676R,富邦臺灣加權反1,10,0,10,元大-大天母,2023-11-13,9893
00715L,期街口布蘭特正2,10,0,10,元大-大天母,2023-11-13,9893
00850,元大臺灣ESG永續,10,0,10,元大-大天母,2023-11-13,9893
3078,僑威,14,4,10,元大-大天母,2023-11-13,9893
00885,富邦越南,10,0,10,元大-大天母,2023-11-13,9893
3231,緯創,115,30,85,元大-大天母,2023-11-14,9893
2892,第一金,82,2,80,元大-大天母,2023-11-14,9893
2485,兆赫,71,0,71,元大-大天母,2023-11-14,9893
1717,長興,52,2,50,元大-大天母,2023-11-14,9893
2883,凱基金,47,0,47,元大-大天母,2023-11-14,9893
00680L,元大美債20正2,45,0,45,元大-大天母,2023-11-14,9893
2897,王道銀行,40,0,40,元大-大天母,2023-11-14,9893
00929,復華台灣科技優息,40,5,35,元大-大天母,2023-11-14,9893
6216,居易,32,0,32,元大-大天母,2023-11-14,9893
6194,育富,30,0,30,元大-大天母,2023-11-14,9893
00878,國泰永續高股息,70,44,26,元大-大天母,2023-11-14,9893
6643,M31,28,3,25,元大-大天母,2023-11-14,9893
1515,力山,48,23,25,元大-大天母,2023-11-14,9893
6667,信紘科,25,1,24,元大-大天母,2023-11-14,9893
3056,富華新,23,0,23,元大-大天母,2023-11-14,9893
2886,兆豐金,22,1,21,元大-大天母,2023-11-14,9893
4572,駐龍,25,5,20,元大-大天母,2023-11-14,9893
2618,長榮航,18,0,18,元大-大天母,2023-11-14,9893
2534,宏盛,16,0,16,元大-大天母,2023-11-14,9893
6482,弘煜科,16,0,16,元大-大天母,2023-11-14,9893
2404,漢唐,16,2,14,元大-大天母,2023-11-14,9893
00904,新光臺灣半導體30,14,1,13,元大-大天母,2023-11-14,9893
2405,輔信,13,0,13,元大-大天母,2023-11-14,9893
00936,台新永續高息中小,12,0,12,元大-大天母,2023-11-14,9893
1314,中石化,12,0,12,元大-大天母,2023-11-14,9893
2609,陽明,72,60,12,元大-大天母,2023-11-14,9893
8050,廣積,12,0,12,元大-大天母,2023-11-14,9893
2337,旺宏,13,1,12,元大-大天母,2023-11-14,9893
2743,山富,12,1,11,元大-大天母,2023-11-14,9893
8403,盛弘,11,0,11,元大-大天母,2023-11-14,9893
2515,中工,10,0,10,元大-大天母,2023-11-14,9893
00692,富邦公司治理,10,0,10,元大-大天母,2023-11-14,9893
00890B,凱基ESG BBB債,10,0,10,元大-大天母,2023-11-14,9893
3234,光環,10,0,10,元大-大天母,2023-11-14,9893
6670,復盛應用,10,0,10,元大-大天母,2023-11-14,9893
1416,廣豐,10,0,10,元大-大天母,2023-11-14,9893
1760,寶齡富錦,12,2,10,元大-大天母,2023-11-14,9893
2356,英業達,13,3,10,元大-大天母,2023-11-14,9893
00688L,國泰20年美債正2,10,0,10,元大-大天母,2023-11-14,9893
00679B,元大美債20年,12,3,9,元大-大天母,2023-11-14,9893
2429,銘旺科,9,0,9,元大-大天母,2023-11-14,9893
3163,波若威,9,0,9,元大-大天母,2023-11-14,9893
2417,圓剛,22,13,9,元大-大天母,2023-11-14,9893
3048,益登,12,3,9,元大-大天母,2023-11-14,9893
2645,長榮航太,10,2,8,元大-大天母,2023-11-14,9893
2313,華通,19,11,8,元大-大天母,2023-11-14,9893
4743,合一,10,2,8,元大-大天母,2023-11-14,9893
4128,中天,8,1,7,元大-大天母,2023-11-14,9893
1504,東元,16,9,7,元大-大天母,2023-11-14,9893
3006,晶豪科,19,12,7,元大-大天母,2023-11-14,9893
00878,國泰永續高股息,205,19,186,元大-大天母,2023-11-15,9893
2607,榮運,169,18,151,元大-大天母,2023-11-15,9893
1815,富喬,107,2,105,元大-大天母,2023-11-15,9893
3324,雙鴻,95,10,85,元大-大天母,2023-11-15,9893
3036,文曄,65,0,65,元大-大天母,2023-11-15,9893
00632R,元大台灣50反1,133,70,63,元大-大天母,2023-11-15,9893
9928,中視,55,0,55,元大-大天母,2023-11-15,9893
00648R,元大S＆P500反1,46,0,46,元大-大天母,2023-11-15,9893
3176,基亞,37,0,37,元大-大天母,2023-11-15,9893
2836,高雄銀,37,0,37,元大-大天母,2023-11-15,9893
006206,元大上證50,30,0,30,元大-大天母,2023-11-15,9893
00891,中信關鍵半導體,35,7,28,元大-大天母,2023-11-15,9893
6526,達發,28,0,28,元大-大天母,2023-11-15,9893
6274,台燿,38,12,26,元大-大天母,2023-11-15,9893
00919,群益台灣精選高息,24,0,24,元大-大天母,2023-11-15,9893
3706,神達,26,2,24,元大-大天母,2023-11-15,9893
2449,京元電子,46,24,22,元大-大天母,2023-11-15,9893
2376,技嘉,31,9,22,元大-大天母,2023-11-15,9893
4167,松瑞藥,21,0,21,元大-大天母,2023-11-15,9893
00720B,元大投資級公司債,20,0,20,元大-大天母,2023-11-15,9893
2331,精英,21,1,20,元大-大天母,2023-11-15,9893
6426,統新,20,0,20,元大-大天母,2023-11-15,9893
2897,王道銀行,20,0,20,元大-大天母,2023-11-15,9893
00933B,國泰10Y+金融債,20,0,20,元大-大天母,2023-11-15,9893
6482,弘煜科,20,0,20,元大-大天母,2023-11-15,9893
2436,偉詮電,20,0,20,元大-大天母,2023-11-15,9893
1609,大亞,21,1,20,元大-大天母,2023-11-15,9893
1721,三晃,19,1,18,元大-大天母,2023-11-15,9893
1618,合機,30,12,18,元大-大天母,2023-11-15,9893
6805,富世達,19,2,17,元大-大天母,2023-11-15,9893
2534,宏盛,17,1,16,元大-大天母,2023-11-15,9893
6182,合晶,24,8,16,元大-大天母,2023-11-15,9893
3105,穩懋,20,4,16,元大-大天母,2023-11-15,9893
8433,弘帆,16,0,16,元大-大天母,2023-11-15,9893
3147,大綜,23,7,16,元大-大天母,2023-11-15,9893
9927,泰銘,21,6,15,元大-大天母,2023-11-15,9893
2705,六福,15,0,15,元大-大天母,2023-11-15,9893
8215,明基材,14,0,14,元大-大天母,2023-11-15,9893
2363,矽統,134,121,13,元大-大天母,2023-11-15,9893
1477,聚陽,23,10,13,元大-大天母,2023-11-15,9893
4968,立積,13,0,13,元大-大天母,2023-11-15,9893
8054,安國,16,4,12,元大-大天母,2023-11-15,9893
3362,先進光,15,3,12,元大-大天母,2023-11-15,9893
3048,益登,12,0,12,元大-大天母,2023-11-15,9893
3521,鴻翊,12,0,12,元大-大天母,2023-11-15,9893
1313,聯成,13,2,11,元大-大天母,2023-11-15,9893
2353,宏��,13,3,10,元大-大天母,2023-11-15,9893
4908,前鼎,11,1,10,元大-大天母,2023-11-15,9893
2429,銘旺科,10,0,10,元大-大天母,2023-11-15,9893
2637,慧洋-KY,10,0,10,元大-大天母,2023-11-15,9893
00878,國泰永續高股息,136,17,119,元大-大天母,2023-11-16,9893
2607,榮運,132,16,116,元大-大天母,2023-11-16,9893
00688L,國泰20年美債正2,101,5,96,元大-大天母,2023-11-16,9893
00679B,元大美債20年,84,5,79,元大-大天母,2023-11-16,9893
2882,國泰金,89,23,66,元大-大天母,2023-11-16,9893
6509,聚和,60,0,60,元大-大天母,2023-11-16,9893
5464,霖宏,58,0,58,元大-大天母,2023-11-16,9893
3548,兆利,65,11,54,元大-大天母,2023-11-16,9893
00929,復華台灣科技優息,51,0,51,元大-大天母,2023-11-16,9893
3669,圓展,50,0,50,元大-大天母,2023-11-16,9893
6168,宏齊,72,24,48,元大-大天母,2023-11-16,9893
2344,華邦電,87,40,47,元大-大天母,2023-11-16,9893
2897,王道銀行,40,0,40,元大-大天母,2023-11-16,9893
3048,益登,41,2,39,元大-大天母,2023-11-16,9893
6584,南俊國際,41,2,39,元大-大天母,2023-11-16,9893
5706,鳳凰,35,2,33,元大-大天母,2023-11-16,9893
3576,聯合再生,30,0,30,元大-大天母,2023-11-16,9893
6526,達發,28,0,28,元大-大天母,2023-11-16,9893
3006,晶豪科,41,14,27,元大-大天母,2023-11-16,9893
3260,威剛,28,2,26,元大-大天母,2023-11-16,9893
3285,微端,25,0,25,元大-大天母,2023-11-16,9893
2417,圓剛,50,25,25,元大-大天母,2023-11-16,9893
00715L,期街口布蘭特正2,26,1,25,元大-大天母,2023-11-16,9893
2329,華泰,97,72,25,元大-大天母,2023-11-16,9893
6456,GIS-KY,24,0,24,元大-大天母,2023-11-16,9893
00772B,中信高評級公司債,23,0,23,元大-大天母,2023-11-16,9893
00669R,國泰美國道瓊反1,20,0,20,元大-大天母,2023-11-16,9893
006206,元大上證50,20,0,20,元大-大天母,2023-11-16,9893
6120,達運,20,0,20,元大-大天母,2023-11-16,9893
3483,力致,20,0,20,元大-大天母,2023-11-16,9893
00680L,元大美債20正2,50,34,16,元大-大天母,2023-11-16,9893
2337,旺宏,14,0,14,元大-大天母,2023-11-16,9893
2404,漢唐,15,1,14,元大-大天母,2023-11-16,9893
3521,鴻翊,13,0,13,元大-大天母,2023-11-16,9893
2836,高雄銀,13,0,13,元大-大天母,2023-11-16,9893
8927,北基,13,0,13,元大-大天母,2023-11-16,9893
1477,聚陽,12,0,12,元大-大天母,2023-11-16,9893
3694,海華,15,3,12,元大-大天母,2023-11-16,9893
3346,麗清,12,0,12,元大-大天母,2023-11-16,9893
00637L,元大滬深300正2,11,0,11,元大-大天母,2023-11-16,9893
1504,東元,23,12,11,元大-大天母,2023-11-16,9893
2331,精英,11,0,11,元大-大天母,2023-11-16,9893
00751B,元大AAA至A公司債,11,0,11,元大-大天母,2023-11-16,9893
2382,廣達,25,14,11,元大-大天母,2023-11-16,9893
2903,遠百,10,0,10,元大-大天母,2023-11-16,9893
2754,亞洲藏壽司,10,0,10,元大-大天母,2023-11-16,9893
2476,鉅祥,10,0,10,元大-大天母,2023-11-16,9893
1711,永光,10,0,10,元大-大天母,2023-11-16,9893
00719B,元大美債1-3,10,0,10,元大-大天母,2023-11-16,9893
5230,雷笛克光學,10,0,10,元大-大天母,2023-11-16,9893
00688L,國泰20年美債正2,200,0,200,元大-大天母,2023-11-17,9893
1802,台玻,150,0,150,元大-大天母,2023-11-17,9893
2388,威盛,137,18,119,元大-大天母,2023-11-17,9893
00933B,國泰10Y+金融債,99,0,99,元大-大天母,2023-11-17,9893
3444,利機,90,0,90,元大-大天母,2023-11-17,9893
6270,倍微,80,0,80,元大-大天母,2023-11-17,9893
2344,華邦電,104,32,72,元大-大天母,2023-11-17,9893
5340,建榮,70,0,70,元大-大天母,2023-11-17,9893
00715L,期街口布蘭特正2,60,0,60,元大-大天母,2023-11-17,9893
2031,新光鋼,50,0,50,元大-大天母,2023-11-17,9893
3312,弘憶股,50,0,50,元大-大天母,2023-11-17,9893
006206,元大上證50,50,0,50,元大-大天母,2023-11-17,9893
2002,中鋼,42,0,42,元大-大天母,2023-11-17,9893
2883,凱基金,34,0,34,元大-大天母,2023-11-17,9893
8049,晶采,40,10,30,元大-大天母,2023-11-17,9893
2485,兆赫,30,1,29,元大-大天母,2023-11-17,9893
00929,復華台灣科技優息,47,20,27,元大-大天母,2023-11-17,9893
00632R,元大台灣50反1,25,0,25,元大-大天母,2023-11-17,9893
2345,智邦,25,0,25,元大-大天母,2023-11-17,9893
9933,中鼎,27,2,25,元大-大天母,2023-11-17,9893
2495,普安,30,6,24,元大-大天母,2023-11-17,9893
006208,富邦台50,24,1,23,元大-大天母,2023-11-17,9893
00882,中信中國高股息,23,0,23,元大-大天母,2023-11-17,9893
00720B,元大投資級公司債,22,0,22,元大-大天母,2023-11-17,9893
2739,寒舍,22,0,22,元大-大天母,2023-11-17,9893
8046,南電,20,0,20,元大-大天母,2023-11-17,9893
2515,中工,19,0,19,元大-大天母,2023-11-17,9893
3715,定穎投控,51,33,18,元大-大天母,2023-11-17,9893
2331,精英,20,2,18,元大-大天母,2023-11-17,9893
2405,輔信,20,2,18,元大-大天母,2023-11-17,9893
3041,揚智,72,57,15,元大-大天母,2023-11-17,9893
2063,世鎧,15,0,15,元大-大天母,2023-11-17,9893
2641,正德,25,10,15,元大-大天母,2023-11-17,9893
00936,台新永續高息中小,15,0,15,元大-大天母,2023-11-17,9893
00878,國泰永續高股息,19,5,14,元大-大天母,2023-11-17,9893
2356,英業達,15,2,13,元大-大天母,2023-11-17,9893
2609,陽明,12,0,12,元大-大天母,2023-11-17,9893
2734,易飛網,12,0,12,元大-大天母,2023-11-17,9893
00919,群益台灣精選高息,18,6,12,元大-大天母,2023-11-17,9893
2027,大成鋼,12,1,11,元大-大天母,2023-11-17,9893
6584,南俊國際,12,1,11,元大-大天母,2023-11-17,9893
4105,東洋,11,0,11,元大-大天母,2023-11-17,9893
2468,華經,11,0,11,元大-大天母,2023-11-17,9893
5531,鄉林,11,0,11,元大-大天母,2023-11-17,9893
4979,華星光,12,1,11,元大-大天母,2023-11-17,9893
1711,永光,10,0,10,元大-大天母,2023-11-17,9893
3032,偉訓,10,0,10,元大-大天母,2023-11-17,9893
2211,長榮鋼,10,0,10,元大-大天母,2023-11-17,9893
00637L,元大滬深300正2,10,0,10,元大-大天母,2023-11-17,9893
8433,弘帆,10,0,10,元大-大天母,2023-11-17,9893
2890,永豐金,160,1,159,元大-大天母,2023-11-20,9893
3548,兆利,168,13,155,元大-大天母,2023-11-20,9893
6274,台燿,124,5,119,元大-大天母,2023-11-20,9893
2883,凱基金,120,3,117,元大-大天母,2023-11-20,9893
00680L,元大美債20正2,93,7,86,元大-大天母,2023-11-20,9893
2303,聯電,147,72,75,元大-大天母,2023-11-20,9893
3048,益登,59,0,59,元大-大天母,2023-11-20,9893
00679B,元大美債20年,52,1,51,元大-大天母,2023-11-20,9893
3512,皇龍,50,0,50,元大-大天母,2023-11-20,9893
00632R,元大台灣50反1,50,0,50,元大-大天母,2023-11-20,9893
2886,兆豐金,57,7,50,元大-大天母,2023-11-20,9893
00720B,元大投資級公司債,43,0,43,元大-大天母,2023-11-20,9893
2409,友達,38,0,38,元大-大天母,2023-11-20,9893
2739,寒舍,31,1,30,元大-大天母,2023-11-20,9893
2006,東和鋼鐵,30,0,30,元大-大天母,2023-11-20,9893
2734,易飛網,30,2,28,元大-大天母,2023-11-20,9893
3563,牧德,27,1,26,元大-大天母,2023-11-20,9893
2610,華航,28,5,23,元大-大天母,2023-11-20,9893
3715,定穎投控,87,64,23,元大-大天母,2023-11-20,9893
9904,寶成,22,0,22,元大-大天母,2023-11-20,9893
2027,大成鋼,22,0,22,元大-大天母,2023-11-20,9893
8046,南電,20,0,20,元大-大天母,2023-11-20,9893
2634,漢翔,24,4,20,元大-大天母,2023-11-20,9893
00878,國泰永續高股息,19,1,18,元大-大天母,2023-11-20,9893
1795,美時,38,21,17,元大-大天母,2023-11-20,9893
6237,驊訊,35,18,17,元大-大天母,2023-11-20,9893
2485,兆赫,20,4,16,元大-大天母,2023-11-20,9893
00918,大華優利高填息30,15,0,15,元大-大天母,2023-11-20,9893
2377,微星,16,2,14,元大-大天母,2023-11-20,9893
6108,競國,14,0,14,元大-大天母,2023-11-20,9893
2301,光寶科,15,1,14,元大-大天母,2023-11-20,9893
2421,建準,13,0,13,元大-大天母,2023-11-20,9893
2515,中工,12,0,12,元大-大天母,2023-11-20,9893
3105,穩懋,13,2,11,元大-大天母,2023-11-20,9893
1522,堤維西,11,0,11,元大-大天母,2023-11-20,9893
2618,長榮航,68,57,11,元大-大天母,2023-11-20,9893
6805,富世達,14,3,11,元大-大天母,2023-11-20,9893
2387,精元,13,2,11,元大-大天母,2023-11-20,9893
00927,群益半導體收益,11,0,11,元大-大天母,2023-11-20,9893
2543,皇昌,22,11,11,元大-大天母,2023-11-20,9893
1609,大亞,13,2,11,元大-大天母,2023-11-20,9893
2395,研華,10,0,10,元大-大天母,2023-11-20,9893
5210,寶碩,10,0,10,元大-大天母,2023-11-20,9893
3483,力致,12,2,10,元大-大天母,2023-11-20,9893
2344,華邦電,19,9,10,元大-大天母,2023-11-20,9893
2417,圓剛,10,1,9,元大-大天母,2023-11-20,9893
1815,富喬,9,0,9,元大-大天母,2023-11-20,9893
3051,力特,10,1,9,元大-大天母,2023-11-20,9893
3481,群創,61,53,8,元大-大天母,2023-11-20,9893
2492,華新科,9,1,8,元大-大天母,2023-11-20,9893
2618,長榮航,534,15,519,元大-大天母,2023-11-21,9893
3711,日月光投控,500,10,490,元大-大天母,2023-11-21,9893
8150,南茂,295,15,280,元大-大天母,2023-11-21,9893
6168,宏齊,330,181,149,元大-大天母,2023-11-21,9893
2031,新光鋼,100,0,100,元大-大天母,2023-11-21,9893
00680L,元大美債20正2,117,26,91,元大-大天母,2023-11-21,9893
2534,宏盛,90,1,89,元大-大天母,2023-11-21,9893
8926,台汽電,70,0,70,元大-大天母,2023-11-21,9893
6526,達發,66,0,66,元大-大天母,2023-11-21,9893
3059,華晶科,80,21,59,元大-大天母,2023-11-21,9893
3030,德律,57,0,57,元大-大天母,2023-11-21,9893
2328,廣宇,54,1,53,元大-大天母,2023-11-21,9893
2332,友訊,51,0,51,元大-大天母,2023-11-21,9893
6127,九豪,49,1,48,元大-大天母,2023-11-21,9893
5351,鈺創,88,42,46,元大-大天母,2023-11-21,9893
00929,復華台灣科技優息,85,40,45,元大-大天母,2023-11-21,9893
00919,群益台灣精選高息,47,3,44,元大-大天母,2023-11-21,9893
2484,希華,44,1,43,元大-大天母,2023-11-21,9893
3037,欣興,67,25,42,元大-大天母,2023-11-21,9893
2897,王道銀行,40,0,40,元大-大天母,2023-11-21,9893
00751B,元大AAA至A公司債,35,0,35,元大-大天母,2023-11-21,9893
2379,瑞昱,35,0,35,元大-大天母,2023-11-21,9893
8936,國統,38,4,34,元大-大天母,2023-11-21,9893
00720B,元大投資級公司債,31,0,31,元大-大天母,2023-11-21,9893
3041,揚智,127,97,30,元大-大天母,2023-11-21,9893
2303,聯電,64,35,29,元大-大天母,2023-11-21,9893
00712,復華富時不動產,31,4,27,元大-大天母,2023-11-21,9893
2354,鴻準,26,0,26,元大-大天母,2023-11-21,9893
2344,華邦電,36,10,26,元大-大天母,2023-11-21,9893
2352,佳世達,26,1,25,元大-大天母,2023-11-21,9893
3483,力致,26,3,23,元大-大天母,2023-11-21,9893
00633L,富邦上証正2,22,1,21,元大-大天母,2023-11-21,9893
00934,中信成長高股息,26,6,20,元大-大天母,2023-11-21,9893
00679B,元大美債20年,20,0,20,元大-大天母,2023-11-21,9893
3438,類比科,20,0,20,元大-大天母,2023-11-21,9893
8046,南電,21,3,18,元大-大天母,2023-11-21,9893
3013,晟銘電,26,8,18,元大-大天母,2023-11-21,9893
2468,華經,18,0,18,元大-大天母,2023-11-21,9893
6855,數泓科,16,0,16,元大-大天母,2023-11-21,9893
2313,華通,61,46,15,元大-大天母,2023-11-21,9893
1477,聚陽,12,0,12,元大-大天母,2023-11-21,9893
3006,晶豪科,17,5,12,元大-大天母,2023-11-21,9893
8289,泰藝,12,0,12,元大-大天母,2023-11-21,9893
2516,新建,19,7,12,元大-大天母,2023-11-21,9893
2449,京元電子,12,0,12,元大-大天母,2023-11-21,9893
0050,元大台灣50,45,34,11,元大-大天母,2023-11-21,9893
8261,富鼎,13,2,11,元大-大天母,2023-11-21,9893
2436,偉詮電,11,0,11,元大-大天母,2023-11-21,9893
00902,中信電池及儲能,11,0,11,元大-大天母,2023-11-21,9893
2367,燿華,32,21,11,元大-大天母,2023-11-21,9893
8040,九暘,311,16,295,元大-大天母,2023-11-22,9893
2534,宏盛,208,12,196,元大-大天母,2023-11-22,9893
2883,凱基金,261,135,126,元大-大天母,2023-11-22,9893
3231,緯創,134,16,118,元大-大天母,2023-11-22,9893
2031,新光鋼,90,1,89,元大-大天母,2023-11-22,9893
2618,長榮航,152,66,86,元大-大天母,2023-11-22,9893
3030,德律,64,1,63,元大-大天母,2023-11-22,9893
6168,宏齊,190,129,61,元大-大天母,2023-11-22,9893
2382,廣達,63,7,56,元大-大天母,2023-11-22,9893
2731,雄獅,55,3,52,元大-大天母,2023-11-22,9893
2748,雲品,53,4,49,元大-大天母,2023-11-22,9893
6855,數泓科,41,0,41,元大-大天母,2023-11-22,9893
8016,矽創,40,3,37,元大-大天母,2023-11-22,9893
6526,達發,32,2,30,元大-大天母,2023-11-22,9893
8404,百和興業-KY,30,0,30,元大-大天母,2023-11-22,9893
5880,合庫金,40,10,30,元大-大天母,2023-11-22,9893
6517,保勝光學,30,1,29,元大-大天母,2023-11-22,9893
2356,英業達,34,6,28,元大-大天母,2023-11-22,9893
2801,彰銀,27,0,27,元大-大天母,2023-11-22,9893
2376,技嘉,38,13,25,元大-大天母,2023-11-22,9893
6153,嘉聯益,24,0,24,元大-大天母,2023-11-22,9893
00905,FT臺灣Smart,23,0,23,元大-大天母,2023-11-22,9893
2002,中鋼,25,2,23,元大-大天母,2023-11-22,9893
2301,光寶科,25,3,22,元大-大天母,2023-11-22,9893
1477,聚陽,22,1,21,元大-大天母,2023-11-22,9893
3325,旭品,34,13,21,元大-大天母,2023-11-22,9893
2897,王道銀行,20,0,20,元大-大天母,2023-11-22,9893
3312,弘憶股,20,0,20,元大-大天母,2023-11-22,9893
2739,寒舍,21,1,20,元大-大天母,2023-11-22,9893
2707,晶華,20,0,20,元大-大天母,2023-11-22,9893
8926,台汽電,20,0,20,元大-大天母,2023-11-22,9893
00636,國泰中國A50,20,0,20,元大-大天母,2023-11-22,9893
00665L,富邦�琤肭磪囓�2,20,0,20,元大-大天母,2023-11-22,9893
6204,艾華,21,2,19,元大-大天母,2023-11-22,9893
2330,台積電,20,3,17,元大-大天母,2023-11-22,9893
1711,永光,20,3,17,元大-大天母,2023-11-22,9893
6585,鼎基,18,1,17,元大-大天母,2023-11-22,9893
3483,力致,17,1,16,元大-大天母,2023-11-22,9893
2888,新光金,26,10,16,元大-大天母,2023-11-22,9893
00679B,元大美債20年,16,0,16,元大-大天母,2023-11-22,9893
2890,永豐金,16,0,16,元大-大天母,2023-11-22,9893
1319,東陽,15,0,15,元大-大天母,2023-11-22,9893
00936,台新永續高息中小,15,0,15,元大-大天母,2023-11-22,9893
00931B,統一美債20年,15,0,15,元大-大天母,2023-11-22,9893
00715L,期街口布蘭特正2,15,0,15,元大-大天母,2023-11-22,9893
2363,矽統,35,21,14,元大-大天母,2023-11-22,9893
6186,新潤,14,0,14,元大-大天母,2023-11-22,9893
2367,燿華,22,9,13,元大-大天母,2023-11-22,9893
5009,榮剛,14,1,13,元大-大天母,2023-11-22,9893
0050,元大台灣50,16,3,13,元大-大天母,2023-11-22,9893
2455,全新,211,5,206,元大-大天母,2023-11-23,9893
2031,新光鋼,130,0,130,元大-大天母,2023-11-23,9893
3312,弘憶股,120,0,120,元大-大天母,2023-11-23,9893
2002,中鋼,133,28,105,元大-大天母,2023-11-23,9893
00720B,元大投資級公司債,91,3,88,元大-大天母,2023-11-23,9893
00715L,期街口布蘭特正2,71,0,71,元大-大天母,2023-11-23,9893
5521,工信,77,16,61,元大-大天母,2023-11-23,9893
3029,零壹,51,0,51,元大-大天母,2023-11-23,9893
2731,雄獅,58,11,47,元大-大天母,2023-11-23,9893
00919,群益台灣精選高息,61,17,44,元大-大天母,2023-11-23,9893
4908,前鼎,61,17,44,元大-大天母,2023-11-23,9893
2748,雲品,43,2,41,元大-大天母,2023-11-23,9893
2457,飛宏,55,19,36,元大-大天母,2023-11-23,9893
00751B,元大AAA至A公司債,46,10,36,元大-大天母,2023-11-23,9893
3231,緯創,54,19,35,元大-大天母,2023-11-23,9893
6168,宏齊,79,49,30,元大-大天母,2023-11-23,9893
6282,康舒,103,74,29,元大-大天母,2023-11-23,9893
6901,鑽石投資,32,3,29,元大-大天母,2023-11-23,9893
00929,復華台灣科技優息,138,110,28,元大-大天母,2023-11-23,9893
2382,廣達,34,6,28,元大-大天母,2023-11-23,9893
1319,東陽,31,3,28,元大-大天母,2023-11-23,9893
3605,宏致,30,3,27,元大-大天母,2023-11-23,9893
0056,元大高股息,39,13,26,元大-大天母,2023-11-23,9893
2883,凱基金,26,0,26,元大-大天母,2023-11-23,9893
3046,建��,25,0,25,元大-大天母,2023-11-23,9893
1101,台泥,29,5,24,元大-大天母,2023-11-23,9893
1337,再生-KY,23,0,23,元大-大天母,2023-11-23,9893
8271,宇瞻,22,0,22,元大-大天母,2023-11-23,9893
3715,定穎投控,68,46,22,元大-大天母,2023-11-23,9893
6855,數泓科,24,2,22,元大-大天母,2023-11-23,9893
1568,倉佑,21,0,21,元大-大天母,2023-11-23,9893
2707,晶華,20,0,20,元大-大天母,2023-11-23,9893
6275,元山,22,3,19,元大-大天母,2023-11-23,9893
00934,中信成長高股息,18,0,18,元大-大天母,2023-11-23,9893
3701,大眾控,19,1,18,元大-大天母,2023-11-23,9893
6584,南俊國際,17,0,17,元大-大天母,2023-11-23,9893
3694,海華,33,16,17,元大-大天母,2023-11-23,9893
6139,亞翔,33,17,16,元大-大天母,2023-11-23,9893
2891,中信金,18,3,15,元大-大天母,2023-11-23,9893
00740B,富邦全球投等債,14,0,14,元大-大天母,2023-11-23,9893
3037,欣興,14,0,14,元大-大天母,2023-11-23,9893
6112,邁達特,15,1,14,元大-大天母,2023-11-23,9893
8024,佑華,13,0,13,元大-大天母,2023-11-23,9893
2492,華新科,15,2,13,元大-大天母,2023-11-23,9893
3047,訊舟,23,10,13,元大-大天母,2023-11-23,9893
3059,華晶科,19,7,12,元大-大天母,2023-11-23,9893
6138,茂達,13,1,12,元大-大天母,2023-11-23,9893
00637L,元大滬深300正2,11,0,11,元大-大天母,2023-11-23,9893
2468,華經,11,0,11,元大-大天母,2023-11-23,9893
2317,鴻海,14,4,10,元大-大天母,2023-11-23,9893
2618,長榮航,255,12,243,元大-大天母,2023-11-24,9893
6168,宏齊,674,533,141,元大-大天母,2023-11-24,9893
2534,宏盛,120,0,120,元大-大天母,2023-11-24,9893
2883,凱基金,120,1,119,元大-大天母,2023-11-24,9893
3105,穩懋,123,18,105,元大-大天母,2023-11-24,9893
00688L,國泰20年美債正2,100,0,100,元大-大天母,2023-11-24,9893
4968,立積,106,13,93,元大-大天母,2023-11-24,9893
2031,新光鋼,50,0,50,元大-大天母,2023-11-24,9893
8086,宏捷科,50,8,42,元大-大天母,2023-11-24,9893
2344,華邦電,58,28,30,元大-大天母,2023-11-24,9893
3030,德律,30,0,30,元大-大天母,2023-11-24,9893
3056,富華新,30,0,30,元大-大天母,2023-11-24,9893
1101,台泥,32,3,29,元大-大天母,2023-11-24,9893
00715L,期街口布蘭特正2,30,6,24,元大-大天母,2023-11-24,9893
3325,旭品,23,0,23,元大-大天母,2023-11-24,9893
5351,鈺創,41,19,22,元大-大天母,2023-11-24,9893
2888,新光金,34,12,22,元大-大天母,2023-11-24,9893
1609,大亞,26,5,21,元大-大天母,2023-11-24,9893
5521,工信,21,1,20,元大-大天母,2023-11-24,9893
3528,安馳,20,0,20,元大-大天母,2023-11-24,9893
2324,仁寶,35,16,19,元大-大天母,2023-11-24,9893
00905,FT臺灣Smart,17,1,16,元大-大天母,2023-11-24,9893
3694,海華,42,27,15,元大-大天母,2023-11-24,9893
00679B,元大美債20年,17,3,14,元大-大天母,2023-11-24,9893
1808,潤隆,15,1,14,元大-大天母,2023-11-24,9893
00929,復華台灣科技優息,13,0,13,元大-大天母,2023-11-24,9893
3006,晶豪科,46,33,13,元大-大天母,2023-11-24,9893
1584,精剛,14,1,13,元大-大天母,2023-11-24,9893
2408,南亞科,14,1,13,元大-大天母,2023-11-24,9893
8183,精星,13,0,13,元大-大天母,2023-11-24,9893
00751B,元大AAA至A公司債,13,0,13,元大-大天母,2023-11-24,9893
1337,再生-KY,12,0,12,元大-大天母,2023-11-24,9893
6235,華孚,18,7,11,元大-大天母,2023-11-24,9893
5443,均豪,11,0,11,元大-大天母,2023-11-24,9893
1532,勤美,11,0,11,元大-大天母,2023-11-24,9893
5529,鉅陞,11,0,11,元大-大天母,2023-11-24,9893
2516,新建,11,0,11,元大-大天母,2023-11-24,9893
2351,順德,10,0,10,元大-大天母,2023-11-24,9893
6261,久元,10,0,10,元大-大天母,2023-11-24,9893
00933B,國泰10Y+金融債,10,0,10,元大-大天母,2023-11-24,9893
00918,大華優利高填息30,10,0,10,元大-大天母,2023-11-24,9893
2515,中工,10,0,10,元大-大天母,2023-11-24,9893
6855,數泓科,10,0,10,元大-大天母,2023-11-24,9893
1591,駿吉-KY,10,0,10,元大-大天母,2023-11-24,9893
2465,麗臺,10,0,10,元大-大天母,2023-11-24,9893
2323,中環,10,0,10,元大-大天母,2023-11-24,9893
2891,中信金,9,0,9,元大-大天母,2023-11-24,9893
2353,宏��,16,7,9,元大-大天母,2023-11-24,9893
00915,凱基優選高股息30,10,1,9,元大-大天母,2023-11-24,9893
2211,長榮鋼,10,1,9,元大-大天母,2023-11-24,9893
00665L,富邦�琤肭磪囓�2,213,0,213,元大-大天母,2023-11-27,9893
2889,國票金,180,0,180,元大-大天母,2023-11-27,9893
00680L,元大美債20正2,127,0,127,元大-大天母,2023-11-27,9893
2883,凱基金,199,81,118,元大-大天母,2023-11-27,9893
00688L,國泰20年美債正2,100,0,100,元大-大天母,2023-11-27,9893
2412,中華電,73,0,73,元大-大天母,2023-11-27,9893
00919,群益台灣精選高息,57,0,57,元大-大天母,2023-11-27,9893
00637L,元大滬深300正2,53,5,48,元大-大天母,2023-11-27,9893
3231,緯創,81,37,44,元大-大天母,2023-11-27,9893
3030,德律,40,0,40,元大-大天母,2023-11-27,9893
2534,宏盛,40,0,40,元大-大天母,2023-11-27,9893
00715L,期街口布蘭特正2,49,10,39,元大-大天母,2023-11-27,9893
00679B,元大美債20年,39,3,36,元大-大天母,2023-11-27,9893
00720B,元大投資級公司債,31,0,31,元大-大天母,2023-11-27,9893
3706,神達,31,1,30,元大-大天母,2023-11-27,9893
2382,廣達,34,5,29,元大-大天母,2023-11-27,9893
5347,世界,54,25,29,元大-大天母,2023-11-27,9893
2344,華邦電,44,15,29,元大-大天母,2023-11-27,9893
00751B,元大AAA至A公司債,27,0,27,元大-大天母,2023-11-27,9893
8936,國統,47,22,25,元大-大天母,2023-11-27,9893
2399,映泰,30,6,24,元大-大天母,2023-11-27,9893
4533,協易機,20,0,20,元大-大天母,2023-11-27,9893
2478,大毅,20,0,20,元大-大天母,2023-11-27,9893
5432,新門,20,0,20,元大-大天母,2023-11-27,9893
8299,群聯,20,0,20,元大-大天母,2023-11-27,9893
00929,復華台灣科技優息,27,8,19,元大-大天母,2023-11-27,9893
6127,九豪,26,8,18,元大-大天母,2023-11-27,9893
00878,國泰永續高股息,29,11,18,元大-大天母,2023-11-27,9893
2947,振宇五金,17,0,17,元大-大天母,2023-11-27,9893
3078,僑威,17,0,17,元大-大天母,2023-11-27,9893
1101,台泥,17,0,17,元大-大天母,2023-11-27,9893
2891,中信金,25,8,17,元大-大天母,2023-11-27,9893
3017,奇鋐,38,22,16,元大-大天母,2023-11-27,9893
8436,大江,15,0,15,元大-大天母,2023-11-27,9893
6456,GIS-KY,19,4,15,元大-大天母,2023-11-27,9893
00674R,期元大S＆P黃金反1,15,0,15,元大-大天母,2023-11-27,9893
00772B,中信高評級公司債,14,0,14,元大-大天母,2023-11-27,9893
6282,康舒,23,9,14,元大-大天母,2023-11-27,9893
2211,長榮鋼,15,1,14,元大-大天母,2023-11-27,9893
5529,鉅陞,14,0,14,元大-大天母,2023-11-27,9893
2356,英業達,13,0,13,元大-大天母,2023-11-27,9893
5880,合庫金,14,1,13,元大-大天母,2023-11-27,9893
2357,華碩,12,0,12,元大-大天母,2023-11-27,9893
2365,昆盈,12,0,12,元大-大天母,2023-11-27,9893
2317,鴻海,14,2,12,元大-大天母,2023-11-27,9893
0056,元大高股息,21,10,11,元大-大天母,2023-11-27,9893
00902,中信電池及儲能,11,0,11,元大-大天母,2023-11-27,9893
6855,數泓科,11,0,11,元大-大天母,2023-11-27,9893
00905,FT臺灣Smart,13,2,11,元大-大天母,2023-11-27,9893
1449,佳和,13,3,10,元大-大天母,2023-11-27,9893
2408,南亞科,200,31,169,元大-大天母,2023-11-28,9893
6235,華孚,126,7,119,元大-大天母,2023-11-28,9893
00687B,國泰20年美債,82,0,82,元大-大天母,2023-11-28,9893
3030,德律,60,0,60,元大-大天母,2023-11-28,9893
5483,中美晶,65,9,56,元大-大天母,2023-11-28,9893
00632R,元大台灣50反1,75,20,55,元大-大天母,2023-11-28,9893
3532,台勝科,50,0,50,元大-大天母,2023-11-28,9893
00665L,富邦�琤肭磪囓�2,50,0,50,元大-大天母,2023-11-28,9893
6462,神盾,52,10,42,元大-大天母,2023-11-28,9893
1101,台泥,55,14,41,元大-大天母,2023-11-28,9893
00933B,國泰10Y+金融債,40,0,40,元大-大天母,2023-11-28,9893
1701,中化,44,5,39,元大-大天母,2023-11-28,9893
6282,康舒,55,20,35,元大-大天母,2023-11-28,9893
6435,大中,30,0,30,元大-大天母,2023-11-28,9893
2303,聯電,73,46,27,元大-大天母,2023-11-28,9893
3481,群創,34,10,24,元大-大天母,2023-11-28,9893
2801,彰銀,23,0,23,元大-大天母,2023-11-28,9893
2367,燿華,45,22,23,元大-大天母,2023-11-28,9893
9933,中鼎,25,3,22,元大-大天母,2023-11-28,9893
3231,緯創,47,26,21,元大-大天母,2023-11-28,9893
8034,榮群,20,0,20,元大-大天母,2023-11-28,9893
4128,中天,20,0,20,元大-大天母,2023-11-28,9893
3005,神基,22,4,18,元大-大天母,2023-11-28,9893
00712,復華富時不動產,20,2,18,元大-大天母,2023-11-28,9893
2399,映泰,18,1,17,元大-大天母,2023-11-28,9893
00679B,元大美債20年,25,9,16,元大-大天母,2023-11-28,9893
4114,健喬,55,40,15,元大-大天母,2023-11-28,9893
2427,三商電,15,0,15,元大-大天母,2023-11-28,9893
4157,太景*-KY,16,1,15,元大-大天母,2023-11-28,9893
0056,元大高股息,15,1,14,元大-大天母,2023-11-28,9893
2534,宏盛,13,0,13,元大-大天母,2023-11-28,9893
3045,台灣大,13,0,13,元大-大天母,2023-11-28,9893
00751B,元大AAA至A公司債,21,9,12,元大-大天母,2023-11-28,9893
00719B,元大美債1-3,12,0,12,元大-大天母,2023-11-28,9893
1301,台塑,16,4,12,元大-大天母,2023-11-28,9893
3152,璟德,11,0,11,元大-大天母,2023-11-28,9893
2355,敬鵬,12,1,11,元大-大天母,2023-11-28,9893
4142,國光生,11,0,11,元大-大天母,2023-11-28,9893
3521,鴻翊,11,0,11,元大-大天母,2023-11-28,9893
2383,台光電,21,11,10,元大-大天母,2023-11-28,9893
9921,巨大,11,1,10,元大-大天母,2023-11-28,9893
2353,宏��,13,3,10,元大-大天母,2023-11-28,9893
6712,長聖,10,0,10,元大-大天母,2023-11-28,9893
2404,漢唐,10,0,10,元大-大天母,2023-11-28,9893
1734,杏輝,10,0,10,元大-大天母,2023-11-28,9893
2897,王道銀行,10,0,10,元大-大天母,2023-11-28,9893
6770,力積電,10,0,10,元大-大天母,2023-11-28,9893
2027,大成鋼,11,1,10,元大-大天母,2023-11-28,9893
2002,中鋼,11,2,9,元大-大天母,2023-11-28,9893
00932,兆豐永續高息等權,9,0,9,元大-大天母,2023-11-28,9893
00665L,富邦�琤肭磪囓�2,276,0,276,元大-大天母,2023-11-29,9893
2618,長榮航,153,20,133,元大-大天母,2023-11-29,9893
3605,宏致,120,0,120,元大-大天母,2023-11-29,9893
3260,威剛,101,2,99,元大-大天母,2023-11-29,9893
2399,映泰,100,2,98,元大-大天母,2023-11-29,9893
00650L,復華香港正2,69,0,69,元大-大天母,2023-11-29,9893
2401,凌陽,64,1,63,元大-大天母,2023-11-29,9893
2889,國票金,62,0,62,元大-大天母,2023-11-29,9893
2891,中信金,60,2,58,元大-大天母,2023-11-29,9893
2615,萬海,51,0,51,元大-大天母,2023-11-29,9893
1210,大成,51,0,51,元大-大天母,2023-11-29,9893
1101,台泥,51,5,46,元大-大天母,2023-11-29,9893
2408,南亞科,57,12,45,元大-大天母,2023-11-29,9893
00637L,元大滬深300正2,45,0,45,元大-大天母,2023-11-29,9893
2369,菱生,69,33,36,元大-大天母,2023-11-29,9893
6789,采鈺,52,17,35,元大-大天母,2023-11-29,9893
00882,中信中國高股息,34,0,34,元大-大天母,2023-11-29,9893
00933B,國泰10Y+金融債,34,0,34,元大-大天母,2023-11-29,9893
6243,迅杰,41,10,31,元大-大天母,2023-11-29,9893
2303,聯電,86,60,26,元大-大天母,2023-11-29,9893
00632R,元大台灣50反1,25,0,25,元大-大天母,2023-11-29,9893
1503,士電,24,0,24,元大-大天母,2023-11-29,9893
00919,群益台灣精選高息,28,5,23,元大-大天母,2023-11-29,9893
2534,宏盛,22,0,22,元大-大天母,2023-11-29,9893
1477,聚陽,22,0,22,元大-大天母,2023-11-29,9893
2610,華航,22,2,20,元大-大天母,2023-11-29,9893
1605,華新,22,2,20,元大-大天母,2023-11-29,9893
3570,大塚,20,0,20,元大-大天母,2023-11-29,9893
00751B,元大AAA至A公司債,20,1,19,元大-大天母,2023-11-29,9893
2330,台積電,21,3,18,元大-大天母,2023-11-29,9893
2897,王道銀行,17,0,17,元大-大天母,2023-11-29,9893
00885,富邦越南,16,0,16,元大-大天母,2023-11-29,9893
4114,健喬,22,6,16,元大-大天母,2023-11-29,9893
00752,中信中國50,15,0,15,元大-大天母,2023-11-29,9893
1612,宏泰,15,0,15,元大-大天母,2023-11-29,9893
2317,鴻海,14,1,13,元大-大天母,2023-11-29,9893
3047,訊舟,17,4,13,元大-大天母,2023-11-29,9893
1584,精剛,12,0,12,元大-大天母,2023-11-29,9893
4967,十銓,11,0,11,元大-大天母,2023-11-29,9893
1532,勤美,11,0,11,元大-大天母,2023-11-29,9893
2412,中華電,11,0,11,元大-大天母,2023-11-29,9893
00712,復華富時不動產,13,2,11,元大-大天母,2023-11-29,9893
4744,皇將,10,0,10,元大-大天母,2023-11-29,9893
4133,亞諾法,10,0,10,元大-大天母,2023-11-29,9893
00645,富邦日本,10,0,10,元大-大天母,2023-11-29,9893
2484,希華,11,1,10,元大-大天母,2023-11-29,9893
6248,沛波,10,0,10,元大-大天母,2023-11-29,9893
8112,至上,14,4,10,元大-大天母,2023-11-29,9893
00753L,中信中國50正2,10,0,10,元大-大天母,2023-11-29,9893
00934,中信成長高股息,10,0,10,元大-大天母,2023-11-29,9893
5439,高技,168,21,147,元大-大天母,2023-11-30,9893
2329,華泰,368,237,131,元大-大天母,2023-11-30,9893
00665L,富邦�琤肭磪囓�2,100,0,100,元大-大天母,2023-11-30,9893
00720B,元大投資級公司債,95,2,93,元大-大天母,2023-11-30,9893
3022,威強電,94,7,87,元大-大天母,2023-11-30,9893
00751B,元大AAA至A公司債,67,0,67,元大-大天母,2023-11-30,9893
5272,笙科,52,1,51,元大-大天母,2023-11-30,9893
2637,慧洋-KY,51,1,50,元大-大天母,2023-11-30,9893
00706L,期元大S＆P日圓正2,50,0,50,元大-大天母,2023-11-30,9893
3059,華晶科,64,17,47,元大-大天母,2023-11-30,9893
3675,德微,43,1,42,元大-大天母,2023-11-30,9893
2609,陽明,35,2,33,元大-大天母,2023-11-30,9893
1312,國喬,30,0,30,元大-大天母,2023-11-30,9893
2705,六福,30,0,30,元大-大天母,2023-11-30,9893
1449,佳和,32,3,29,元大-大天母,2023-11-30,9893
3374,精材,33,6,27,元大-大天母,2023-11-30,9893
6488,環球晶,27,1,26,元大-大天母,2023-11-30,9893
0050,元大台灣50,25,0,25,元大-大天母,2023-11-30,9893
6712,長聖,25,0,25,元大-大天母,2023-11-30,9893
8112,至上,30,6,24,元大-大天母,2023-11-30,9893
2388,威盛,27,4,23,元大-大天母,2023-11-30,9893
2317,鴻海,23,0,23,元大-大天母,2023-11-30,9893
5347,世界,25,3,22,元大-大天母,2023-11-30,9893
2449,京元電子,26,4,22,元大-大天母,2023-11-30,9893
3687,歐買尬,25,4,21,元大-大天母,2023-11-30,9893
00933B,國泰10Y+金融債,20,0,20,元大-大天母,2023-11-30,9893
5607,遠雄港,20,0,20,元大-大天母,2023-11-30,9893
6494,九齊,22,2,20,元大-大天母,2023-11-30,9893
3227,原相,26,7,19,元大-大天母,2023-11-30,9893
2303,聯電,25,8,17,元大-大天母,2023-11-30,9893
3236,千如,17,0,17,元大-大天母,2023-11-30,9893
2313,華通,39,22,17,元大-大天母,2023-11-30,9893
2344,華邦電,77,60,17,元大-大天母,2023-11-30,9893
3231,緯創,35,18,17,元大-大天母,2023-11-30,9893
1752,南光,20,5,15,元大-大天母,2023-11-30,9893
4908,前鼎,14,0,14,元大-大天母,2023-11-30,9893
3147,大綜,17,4,13,元大-大天母,2023-11-30,9893
2404,漢唐,13,0,13,元大-大天母,2023-11-30,9893
3030,德律,12,0,12,元大-大天母,2023-11-30,9893
00935,野村臺灣新科技50,12,0,12,元大-大天母,2023-11-30,9893
6257,矽格,14,3,11,元大-大天母,2023-11-30,9893
1477,聚陽,12,1,11,元大-大天母,2023-11-30,9893
2534,宏盛,11,0,11,元大-大天母,2023-11-30,9893
2883,凱基金,143,132,11,元大-大天母,2023-11-30,9893
9933,中鼎,11,1,10,元大-大天母,2023-11-30,9893
2492,華新科,15,5,10,元大-大天母,2023-11-30,9893
00764B,群益25年美債,10,0,10,元大-大天母,2023-11-30,9893
2945,三商家購,10,0,10,元大-大天母,2023-11-30,9893
3010,華立,10,0,10,元大-大天母,2023-11-30,9893
5381,合正,14,4,10,元大-大天母,2023-11-30,9893
2382,廣達,164,4,160,元大-大天母,2023-12-01,9893
2367,燿華,152,12,140,元大-大天母,2023-12-01,9893
00688L,國泰20年美債正2,100,0,100,元大-大天母,2023-12-01,9893
00919,群益台灣精選高息,100,7,93,元大-大天母,2023-12-01,9893
1795,美時,115,28,87,元大-大天母,2023-12-01,9893
2883,凱基金,77,9,68,元大-大天母,2023-12-01,9893
2609,陽明,136,70,66,元大-大天母,2023-12-01,9893
8436,大江,60,4,56,元大-大天母,2023-12-01,9893
5328,華容,79,26,53,元大-大天母,2023-12-01,9893
006206,元大上證50,50,0,50,元大-大天母,2023-12-01,9893
2886,兆豐金,48,1,47,元大-大天母,2023-12-01,9893
5607,遠雄港,45,0,45,元大-大天母,2023-12-01,9893
5439,高技,52,9,43,元大-大天母,2023-12-01,9893
00935,野村臺灣新科技50,40,0,40,元大-大天母,2023-12-01,9893
0056,元大高股息,36,3,33,元大-大天母,2023-12-01,9893
00680L,元大美債20正2,32,1,31,元大-大天母,2023-12-01,9893
6233,旺玖,62,31,31,元大-大天母,2023-12-01,9893
2618,長榮航,35,5,30,元大-大天母,2023-12-01,9893
1528,恩德,30,0,30,元大-大天母,2023-12-01,9893
6122,擎邦,30,0,30,元大-大天母,2023-12-01,9893
6168,宏齊,30,1,29,元大-大天母,2023-12-01,9893
3374,精材,30,1,29,元大-大天母,2023-12-01,9893
00637L,元大滬深300正2,26,0,26,元大-大天母,2023-12-01,9893
1609,大亞,25,1,24,元大-大天母,2023-12-01,9893
1101,台泥,23,0,23,元大-大天母,2023-12-01,9893
00715L,期街口布蘭特正2,23,0,23,元大-大天母,2023-12-01,9893
5880,合庫金,23,0,23,元大-大天母,2023-12-01,9893
3257,虹冠電,22,0,22,元大-大天母,2023-12-01,9893
2891,中信金,26,4,22,元大-大天母,2023-12-01,9893
3022,威強電,22,1,21,元大-大天母,2023-12-01,9893
00915,凱基優選高股息30,25,5,20,元大-大天母,2023-12-01,9893
2009,第一銅,20,0,20,元大-大天母,2023-12-01,9893
2897,王道銀行,20,0,20,元大-大天母,2023-12-01,9893
1701,中化,32,12,20,元大-大天母,2023-12-01,9893
6016,康和證,20,0,20,元大-大天母,2023-12-01,9893
6282,康舒,33,16,17,元大-大天母,2023-12-01,9893
2317,鴻海,20,3,17,元大-大天母,2023-12-01,9893
2324,仁寶,16,0,16,元大-大天母,2023-12-01,9893
2401,凌陽,33,17,16,元大-大天母,2023-12-01,9893
00931B,統一美債20年,16,0,16,元大-大天母,2023-12-01,9893
2211,長榮鋼,15,0,15,元大-大天母,2023-12-01,9893
1219,福壽,15,0,15,元大-大天母,2023-12-01,9893
00722B,群益投資級電信債,15,0,15,元大-大天母,2023-12-01,9893
8054,安國,18,3,15,元大-大天母,2023-12-01,9893
6625,必應,21,7,14,元大-大天母,2023-12-01,9893
3483,力致,16,2,14,元大-大天母,2023-12-01,9893
2340,台亞,13,0,13,元大-大天母,2023-12-01,9893
3706,神達,44,31,13,元大-大天母,2023-12-01,9893
3236,千如,13,0,13,元大-大天母,2023-12-01,9893
1582,信錦,50,37,13,元大-大天母,2023-12-01,9893
2409,友達,140,5,135,元大-大天母,2023-12-04,9893
2355,敬鵬,145,25,120,元大-大天母,2023-12-04,9893
00665L,富邦�琤肭磪囓�2,101,0,101,元大-大天母,2023-12-04,9893
00720B,元大投資級公司債,93,0,93,元大-大天母,2023-12-04,9893
00751B,元大AAA至A公司債,92,3,89,元大-大天母,2023-12-04,9893
2303,聯電,105,24,81,元大-大天母,2023-12-04,9893
8436,大江,70,1,69,元大-大天母,2023-12-04,9893
6693,廣閎科,60,0,60,元大-大天母,2023-12-04,9893
2534,宏盛,60,0,60,元大-大天母,2023-12-04,9893
1101,台泥,59,0,59,元大-大天母,2023-12-04,9893
00650L,復華香港正2,51,0,51,元大-大天母,2023-12-04,9893
3231,緯創,75,27,48,元大-大天母,2023-12-04,9893
00905,FT臺灣Smart,50,2,48,元大-大天母,2023-12-04,9893
00919,群益台灣精選高息,106,61,45,元大-大天母,2023-12-04,9893
3715,定穎投控,74,29,45,元大-大天母,2023-12-04,9893
5328,華容,55,12,43,元大-大天母,2023-12-04,9893
00922,國泰台灣領袖50,42,0,42,元大-大天母,2023-12-04,9893
2883,凱基金,41,0,41,元大-大天母,2023-12-04,9893
6168,宏齊,379,339,40,元大-大天母,2023-12-04,9893
6499,益安,40,0,40,元大-大天母,2023-12-04,9893
2705,六福,40,0,40,元大-大天母,2023-12-04,9893
00715L,期街口布蘭特正2,39,0,39,元大-大天母,2023-12-04,9893
00918,大華優利高填息30,43,6,37,元大-大天母,2023-12-04,9893
2401,凌陽,33,0,33,元大-大天母,2023-12-04,9893
2478,大毅,32,0,32,元大-大天母,2023-12-04,9893
1795,美時,49,17,32,元大-大天母,2023-12-04,9893
00904,新光臺灣半導體30,27,0,27,元大-大天母,2023-12-04,9893
1609,大亞,24,0,24,元大-大天母,2023-12-04,9893
3706,神達,25,3,22,元大-大天母,2023-12-04,9893
5607,遠雄港,21,0,21,元大-大天母,2023-12-04,9893
00679B,元大美債20年,26,5,21,元大-大天母,2023-12-04,9893
9910,豐泰,20,0,20,元大-大天母,2023-12-04,9893
00898,國泰基因免疫革命,20,0,20,元大-大天母,2023-12-04,9893
4951,精拓科,20,0,20,元大-大天母,2023-12-04,9893
00687B,國泰20年美債,20,0,20,元大-大天母,2023-12-04,9893
00931B,統一美債20年,22,3,19,元大-大天母,2023-12-04,9893
1605,華新,70,52,18,元大-大天母,2023-12-04,9893
3481,群創,150,132,18,元大-大天母,2023-12-04,9893
00714,群益道瓊美國地產,18,0,18,元大-大天母,2023-12-04,9893
6799,來頡,19,2,17,元大-大天母,2023-12-04,9893
1440,南紡,20,3,17,元大-大天母,2023-12-04,9893
3022,威強電,17,0,17,元大-大天母,2023-12-04,9893
6235,華孚,18,2,16,元大-大天母,2023-12-04,9893
00680L,元大美債20正2,18,2,16,元大-大天母,2023-12-04,9893
3078,僑威,28,12,16,元大-大天母,2023-12-04,9893
2332,友訊,20,4,16,元大-大天母,2023-12-04,9893
8163,達方,20,4,16,元大-大天母,2023-12-04,9893
2329,華泰,78,62,16,元大-大天母,2023-12-04,9893
00728,第一金工業30,13,0,13,元大-大天母,2023-12-04,9893
2412,中華電,13,0,13,元大-大天母,2023-12-04,9893
00937B,群益ESG投等債20,346,0,346,元大-大天母,2023-12-05,9893
00632R,元大台灣50反1,320,0,320,元大-大天母,2023-12-05,9893
00680L,元大美債20正2,254,4,250,元大-大天母,2023-12-05,9893
6168,宏齊,202,1,201,元大-大天母,2023-12-05,9893
3231,緯創,104,16,88,元大-大天母,2023-12-05,9893
00919,群益台灣精選高息,103,17,86,元大-大天母,2023-12-05,9893
00650L,復華香港正2,80,0,80,元大-大天母,2023-12-05,9893
2371,大同,92,14,78,元大-大天母,2023-12-05,9893
00918,大華優利高填息30,78,6,72,元大-大天母,2023-12-05,9893
2705,六福,70,0,70,元大-大天母,2023-12-05,9893
5469,瀚宇博,73,6,67,元大-大天母,2023-12-05,9893
00720B,元大投資級公司債,59,4,55,元大-大天母,2023-12-05,9893
4167,松瑞藥,61,10,51,元大-大天母,2023-12-05,9893
00715L,期街口布蘭特正2,48,0,48,元大-大天母,2023-12-05,9893
2534,宏盛,46,0,46,元大-大天母,2023-12-05,9893
2618,長榮航,51,6,45,元大-大天母,2023-12-05,9893
1477,聚陽,45,0,45,元大-大天母,2023-12-05,9893
1605,華新,42,1,41,元大-大天母,2023-12-05,9893
2637,慧洋-KY,75,38,37,元大-大天母,2023-12-05,9893
3022,威強電,41,5,36,元大-大天母,2023-12-05,9893
2601,益航,49,14,35,元大-大天母,2023-12-05,9893
3481,群創,61,27,34,元大-大天母,2023-12-05,9893
00878,國泰永續高股息,37,4,33,元大-大天母,2023-12-05,9893
00671R,富邦NASDAQ反1,30,0,30,元大-大天母,2023-12-05,9893
3011,今皓,30,0,30,元大-大天母,2023-12-05,9893
00882,中信中國高股息,29,0,29,元大-大天母,2023-12-05,9893
3322,建舜電,29,2,27,元大-大天母,2023-12-05,9893
2891,中信金,29,2,27,元大-大天母,2023-12-05,9893
00751B,元大AAA至A公司債,27,0,27,元大-大天母,2023-12-05,9893
6712,長聖,25,0,25,元大-大天母,2023-12-05,9893
0056,元大高股息,37,15,22,元大-大天母,2023-12-05,9893
2543,皇昌,23,1,22,元大-大天母,2023-12-05,9893
1440,南紡,21,0,21,元大-大天母,2023-12-05,9893
3380,明泰,25,4,21,元大-大天母,2023-12-05,9893
2883,凱基金,21,0,21,元大-大天母,2023-12-05,9893
00922,國泰台灣領袖50,22,1,21,元大-大天母,2023-12-05,9893
00687B,國泰20年美債,25,6,19,元大-大天母,2023-12-05,9893
5609,中菲行,19,0,19,元大-大天母,2023-12-05,9893
6894,衛司特,18,0,18,元大-大天母,2023-12-05,9893
2606,裕民,281,265,16,元大-大天母,2023-12-05,9893
2449,京元電子,29,13,16,元大-大天母,2023-12-05,9893
3037,欣興,16,1,15,元大-大天母,2023-12-05,9893
00764B,群益25年美債,15,0,15,元大-大天母,2023-12-05,9893
2344,華邦電,17,2,15,元大-大天母,2023-12-05,9893
1808,潤隆,14,0,14,元大-大天母,2023-12-05,9893
2886,兆豐金,15,1,14,元大-大天母,2023-12-05,9893
2641,正德,81,67,14,元大-大天母,2023-12-05,9893
2610,華航,14,0,14,元大-大天母,2023-12-05,9893
1514,亞力,37,23,14,元大-大天母,2023-12-05,9893
2317,鴻海,13,0,13,元大-大天母,2023-12-05,9893
00680L,元大美債20正2,436,5,431,元大-大天母,2023-12-06,9893
00679B,元大美債20年,148,1,147,元大-大天母,2023-12-06,9893
2534,宏盛,110,0,110,元大-大天母,2023-12-06,9893
9945,潤泰新,106,6,100,元大-大天母,2023-12-06,9893
00665L,富邦�琤肭磪囓�2,100,0,100,元大-大天母,2023-12-06,9893
00878,國泰永續高股息,90,1,89,元大-大天母,2023-12-06,9893
2705,六福,85,0,85,元大-大天母,2023-12-06,9893
2344,華邦電,88,12,76,元大-大天母,2023-12-06,9893
00751B,元大AAA至A公司債,59,6,53,元大-大天母,2023-12-06,9893
3265,台星科,52,6,46,元大-大天母,2023-12-06,9893
6168,宏齊,61,19,42,元大-大天母,2023-12-06,9893
00715L,期街口布蘭特正2,38,0,38,元大-大天母,2023-12-06,9893
3481,群創,34,1,33,元大-大天母,2023-12-06,9893
2399,映泰,51,19,32,元大-大天母,2023-12-06,9893
1795,美時,31,0,31,元大-大天母,2023-12-06,9893
3105,穩懋,36,6,30,元大-大天母,2023-12-06,9893
3056,富華新,30,0,30,元大-大天母,2023-12-06,9893
00637L,元大滬深300正2,32,3,29,元大-大天母,2023-12-06,9893
1101,台泥,26,0,26,元大-大天母,2023-12-06,9893
6547,高端疫苗,25,0,25,元大-大天母,2023-12-06,9893
00921,兆豐龍頭等權重,24,0,24,元大-大天母,2023-12-06,9893
1513,中興電,30,10,20,元大-大天母,2023-12-06,9893
5432,新門,22,2,20,元大-大天母,2023-12-06,9893
00671R,富邦NASDAQ反1,20,0,20,元大-大天母,2023-12-06,9893
2258,鴻華先進-創,20,0,20,元大-大天母,2023-12-06,9893
00764B,群益25年美債,20,0,20,元大-大天母,2023-12-06,9893
4951,精拓科,20,0,20,元大-大天母,2023-12-06,9893
00919,群益台灣精選高息,33,14,19,元大-大天母,2023-12-06,9893
6271,同欣電,18,0,18,元大-大天母,2023-12-06,9893
00669R,國泰美國道瓊反1,16,0,16,元大-大天母,2023-12-06,9893
2377,微星,16,0,16,元大-大天母,2023-12-06,9893
2327,國巨,16,0,16,元大-大天母,2023-12-06,9893
1514,亞力,79,64,15,元大-大天母,2023-12-06,9893
1504,東元,46,31,15,元大-大天母,2023-12-06,9893
2317,鴻海,15,0,15,元大-大天母,2023-12-06,9893
6207,雷科,14,0,14,元大-大天母,2023-12-06,9893
00918,大華優利高填息30,44,31,13,元大-大天母,2023-12-06,9893
2441,超豐,13,0,13,元大-大天母,2023-12-06,9893
2419,仲琦,42,29,13,元大-大天母,2023-12-06,9893
3029,零壹,12,0,12,元大-大天母,2023-12-06,9893
00687B,國泰20年美債,13,1,12,元大-大天母,2023-12-06,9893
2049,上銀,12,1,11,元大-大天母,2023-12-06,9893
3078,僑威,11,0,11,元大-大天母,2023-12-06,9893
2606,裕民,21,10,11,元大-大天母,2023-12-06,9893
2308,台達電,12,1,11,元大-大天母,2023-12-06,9893
1312,國喬,11,0,11,元大-大天母,2023-12-06,9893
2371,大同,11,0,11,元大-大天母,2023-12-06,9893
00642U,期元大S＆P石油,10,0,10,元大-大天母,2023-12-06,9893
3356,奇偶,10,0,10,元大-大天母,2023-12-06,9893
006206,元大上證50,10,0,10,元大-大天母,2023-12-06,9893
00919,群益台灣精選高息,243,3,240,元大-大天母,2023-12-07,9893
00687B,國泰20年美債,147,0,147,元大-大天母,2023-12-07,9893
00679B,元大美債20年,178,51,127,元大-大天母,2023-12-07,9893
3022,威強電,80,4,76,元大-大天母,2023-12-07,9893
00715L,期街口布蘭特正2,71,4,67,元大-大天母,2023-12-07,9893
2303,聯電,79,15,64,元大-大天母,2023-12-07,9893
00929,復華台灣科技優息,55,0,55,元大-大天母,2023-12-07,9893
1618,合機,47,5,42,元大-大天母,2023-12-07,9893
2891,中信金,39,1,38,元大-大天母,2023-12-07,9893
00680L,元大美債20正2,40,4,36,元大-大天母,2023-12-07,9893
00720B,元大投資級公司債,58,23,35,元大-大天母,2023-12-07,9893
2356,英業達,33,1,32,元大-大天母,2023-12-07,9893
2027,大成鋼,31,0,31,元大-大天母,2023-12-07,9893
00688L,國泰20年美債正2,31,0,31,元大-大天母,2023-12-07,9893
1522,堤維西,55,24,31,元大-大天母,2023-12-07,9893
1216,統一,31,0,31,元大-大天母,2023-12-07,9893
2882,國泰金,28,1,27,元大-大天母,2023-12-07,9893
00751B,元大AAA至A公司債,27,0,27,元大-大天母,2023-12-07,9893
3715,定穎投控,46,21,25,元大-大天母,2023-12-07,9893
00671R,富邦NASDAQ反1,25,0,25,元大-大天母,2023-12-07,9893
8054,安國,29,5,24,元大-大天母,2023-12-07,9893
2609,陽明,30,8,22,元大-大天母,2023-12-07,9893
2344,華邦電,23,1,22,元大-大天母,2023-12-07,9893
4933,友輝,21,0,21,元大-大天母,2023-12-07,9893
6168,宏齊,127,106,21,元大-大天母,2023-12-07,9893
4128,中天,20,0,20,元大-大天母,2023-12-07,9893
3011,今皓,20,0,20,元大-大天母,2023-12-07,9893
5426,振發,40,20,20,元大-大天母,2023-12-07,9893
2359,所羅門,30,10,20,元大-大天母,2023-12-07,9893
00722B,群益投資級電信債,24,4,20,元大-大天母,2023-12-07,9893
0056,元大高股息,22,2,20,元大-大天母,2023-12-07,9893
1513,中興電,42,23,19,元大-大天母,2023-12-07,9893
3312,弘憶股,20,1,19,元大-大天母,2023-12-07,9893
2610,華航,26,8,18,元大-大天母,2023-12-07,9893
3481,群創,21,3,18,元大-大天母,2023-12-07,9893
00713,元大台灣高息低波,18,1,17,元大-大天母,2023-12-07,9893
00922,國泰台灣領袖50,17,0,17,元大-大天母,2023-12-07,9893
2881,富邦金,17,1,16,元大-大天母,2023-12-07,9893
4973,廣穎,16,0,16,元大-大天母,2023-12-07,9893
2330,台積電,18,2,16,元大-大天母,2023-12-07,9893
00850,元大臺灣ESG永續,15,0,15,元大-大天母,2023-12-07,9893
4967,十銓,23,9,14,元大-大天母,2023-12-07,9893
3265,台星科,14,0,14,元大-大天母,2023-12-07,9893
1722,台肥,14,0,14,元大-大天母,2023-12-07,9893
2206,三陽工業,14,1,13,元大-大天母,2023-12-07,9893
1319,東陽,16,4,12,元大-大天母,2023-12-07,9893
4167,松瑞藥,12,0,12,元大-大天母,2023-12-07,9893
2615,萬海,12,0,12,元大-大天母,2023-12-07,9893
00795B,中信美國公債20年,11,0,11,元大-大天母,2023-12-07,9893
8086,宏捷科,14,4,10,元大-大天母,2023-12-07,9893
2329,華泰,437,20,417,元大-大天母,2023-12-08,9893
00937B,群益ESG投等債20,371,10,361,元大-大天母,2023-12-08,9893
2371,大同,205,12,193,元大-大天母,2023-12-08,9893
3607,谷崧,149,8,141,元大-大天母,2023-12-08,9893
00929,復華台灣科技優息,130,2,128,元大-大天母,2023-12-08,9893
2888,新光金,115,10,105,元大-大天母,2023-12-08,9893
00919,群益台灣精選高息,99,24,75,元大-大天母,2023-12-08,9893
00632R,元大台灣50反1,75,0,75,元大-大天母,2023-12-08,9893
3022,威強電,62,1,61,元大-大天母,2023-12-08,9893
8112,至上,93,36,57,元大-大天母,2023-12-08,9893
3011,今皓,50,0,50,元大-大天母,2023-12-08,9893
2376,技嘉,75,28,47,元大-大天母,2023-12-08,9893
3390,旭軟,60,17,43,元大-大天母,2023-12-08,9893
2705,六福,42,0,42,元大-大天母,2023-12-08,9893
3438,類比科,42,1,41,元大-大天母,2023-12-08,9893
6207,雷科,42,2,40,元大-大天母,2023-12-08,9893
2641,正德,43,4,39,元大-大天母,2023-12-08,9893
00715L,期街口布蘭特正2,40,4,36,元大-大天母,2023-12-08,9893
00687B,國泰20年美債,45,9,36,元大-大天母,2023-12-08,9893
3231,緯創,63,29,34,元大-大天母,2023-12-08,9893
6799,來頡,34,3,31,元大-大天母,2023-12-08,9893
3605,宏致,31,0,31,元大-大天母,2023-12-08,9893
3059,華晶科,31,2,29,元大-大天母,2023-12-08,9893
2356,英業達,33,6,27,元大-大天母,2023-12-08,9893
2618,長榮航,87,62,25,元大-大天母,2023-12-08,9893
2801,彰銀,25,0,25,元大-大天母,2023-12-08,9893
00751B,元大AAA至A公司債,24,0,24,元大-大天母,2023-12-08,9893
8996,高力,23,0,23,元大-大天母,2023-12-08,9893
6170,統振,26,4,22,元大-大天母,2023-12-08,9893
2352,佳世達,21,0,21,元大-大天母,2023-12-08,9893
00934,中信成長高股息,21,0,21,元大-大天母,2023-12-08,9893
00680L,元大美債20正2,23,2,21,元大-大天母,2023-12-08,9893
6237,驊訊,21,1,20,元大-大天母,2023-12-08,9893
3234,光環,17,0,17,元大-大天母,2023-12-08,9893
2882,國泰金,17,1,16,元大-大天母,2023-12-08,9893
2471,資通,12,0,12,元大-大天母,2023-12-08,9893
2881,富邦金,14,2,12,元大-大天母,2023-12-08,9893
2365,昆盈,14,2,12,元大-大天母,2023-12-08,9893
2892,第一金,12,0,12,元大-大天母,2023-12-08,9893
1503,士電,36,24,12,元大-大天母,2023-12-08,9893
2606,裕民,14,3,11,元大-大天母,2023-12-08,9893
5609,中菲行,11,0,11,元大-大天母,2023-12-08,9893
1609,大亞,25,14,11,元大-大天母,2023-12-08,9893
2002,中鋼,15,4,11,元大-大天母,2023-12-08,9893
1795,美時,21,10,11,元大-大天母,2023-12-08,9893
6703,軒郁,10,0,10,元大-大天母,2023-12-08,9893
2884,玉山金,10,0,10,元大-大天母,2023-12-08,9893
8110,華東,10,0,10,元大-大天母,2023-12-08,9893
8936,國統,10,0,10,元大-大天母,2023-12-08,9893
00936,台新永續高息中小,10,0,10,元大-大天母,2023-12-08,9893
00919,群益台灣精選高息,316,35,281,元大-大天母,2023-12-11,9893
3605,宏致,105,0,105,元大-大天母,2023-12-11,9893
2344,華邦電,116,20,96,元大-大天母,2023-12-11,9893
00679B,元大美債20年,54,2,52,元大-大天母,2023-12-11,9893
1515,力山,51,1,50,元大-大天母,2023-12-11,9893
00688L,國泰20年美債正2,44,0,44,元大-大天母,2023-12-11,9893
00662,富邦NASDAQ,30,0,30,元大-大天母,2023-12-11,9893
00892,富邦台灣半導體,35,5,30,元大-大天母,2023-12-11,9893
2388,威盛,34,5,29,元大-大天母,2023-12-11,9893
00751B,元大AAA至A公司債,29,0,29,元大-大天母,2023-12-11,9893
2002,中鋼,32,7,25,元大-大天母,2023-12-11,9893
3211,順達,31,6,25,元大-大天母,2023-12-11,9893
5426,振發,40,15,25,元大-大天母,2023-12-11,9893
2883,凱基金,27,2,25,元大-大天母,2023-12-11,9893
5529,鉅陞,24,0,24,元大-大天母,2023-12-11,9893
4979,華星光,50,26,24,元大-大天母,2023-12-11,9893
3310,佳穎,24,1,23,元大-大天母,2023-12-11,9893
6235,華孚,22,0,22,元大-大天母,2023-12-11,9893
3576,聯合再生,30,8,22,元大-大天母,2023-12-11,9893
0050,元大台灣50,21,0,21,元大-大天母,2023-12-11,9893
4953,緯軟,22,1,21,元大-大天母,2023-12-11,9893
00713,元大台灣高息低波,20,0,20,元大-大天母,2023-12-11,9893
00706L,期元大S＆P日圓正2,20,0,20,元大-大天母,2023-12-11,9893
00680L,元大美債20正2,30,10,20,元大-大天母,2023-12-11,9893
3630,新鉅科,20,0,20,元大-大天母,2023-12-11,9893
2618,長榮航,31,12,19,元大-大天母,2023-12-11,9893
4933,友輝,20,1,19,元大-大天母,2023-12-11,9893
1609,大亞,31,12,19,元大-大天母,2023-12-11,9893
3499,環天科,21,3,18,元大-大天母,2023-12-11,9893
6150,撼訊,23,5,18,元大-大天母,2023-12-11,9893
6167,久正,17,0,17,元大-大天母,2023-12-11,9893
2605,新興,19,2,17,元大-大天母,2023-12-11,9893
00929,復華台灣科技優息,24,8,16,元大-大天母,2023-12-11,9893
2476,鉅祥,23,7,16,元大-大天母,2023-12-11,9893
1905,華紙,19,3,16,元大-大天母,2023-12-11,9893
1101,台泥,18,2,16,元大-大天母,2023-12-11,9893
00687B,國泰20年美債,15,0,15,元大-大天母,2023-12-11,9893
5243,乙盛-KY,15,0,15,元大-大天母,2023-12-11,9893
3615,安可,15,0,15,元大-大天母,2023-12-11,9893
2449,京元電子,13,0,13,元大-大天母,2023-12-11,9893
00633L,富邦上証正2,13,0,13,元大-大天母,2023-12-11,9893
2427,三商電,14,1,13,元大-大天母,2023-12-11,9893
2543,皇昌,15,2,13,元大-大天母,2023-12-11,9893
8996,高力,12,0,12,元大-大天母,2023-12-11,9893
3231,緯創,49,37,12,元大-大天母,2023-12-11,9893
3032,偉訓,12,0,12,元大-大天母,2023-12-11,9893
1219,福壽,12,0,12,元大-大天母,2023-12-11,9893
6168,宏齊,26,14,12,元大-大天母,2023-12-11,9893
3450,聯鈞,11,0,11,元大-大天母,2023-12-11,9893
3010,華立,11,0,11,元大-大天母,2023-12-11,9893
2344,華邦電,332,7,325,元大-大天母,2023-12-12,9893
3380,明泰,154,15,139,元大-大天母,2023-12-12,9893
00919,群益台灣精選高息,203,64,139,元大-大天母,2023-12-12,9893
2371,大同,152,21,131,元大-大天母,2023-12-12,9893
4720,德淵,116,0,116,元大-大天母,2023-12-12,9893
00687B,國泰20年美債,93,0,93,元大-大天母,2023-12-12,9893
5426,振發,82,2,80,元大-大天母,2023-12-12,9893
6214,精誠,64,1,63,元大-大天母,2023-12-12,9893
5609,中菲行,60,1,59,元大-大天母,2023-12-12,9893
5521,工信,117,61,56,元大-大天母,2023-12-12,9893
3231,緯創,66,15,51,元大-大天母,2023-12-12,9893
8086,宏捷科,52,2,50,元大-大天母,2023-12-12,9893
00633L,富邦上証正2,50,3,47,元大-大天母,2023-12-12,9893
00918,大華優利高填息30,65,19,46,元大-大天母,2023-12-12,9893
2609,陽明,62,16,46,元大-大天母,2023-12-12,9893
2365,昆盈,45,2,43,元大-大天母,2023-12-12,9893
2484,希華,41,0,41,元大-大天母,2023-12-12,9893
00706L,期元大S＆P日圓正2,40,0,40,元大-大天母,2023-12-12,9893
2313,華通,45,14,31,元大-大天母,2023-12-12,9893
2705,六福,30,0,30,元大-大天母,2023-12-12,9893
4908,前鼎,33,4,29,元大-大天母,2023-12-12,9893
2399,映泰,30,2,28,元大-大天母,2023-12-12,9893
2355,敬鵬,35,8,27,元大-大天母,2023-12-12,9893
00679B,元大美債20年,25,0,25,元大-大天母,2023-12-12,9893
2442,新美齊,24,0,24,元大-大天母,2023-12-12,9893
6670,復盛應用,26,2,24,元大-大天母,2023-12-12,9893
2704,國賓,23,0,23,元大-大天母,2023-12-12,9893
8096,擎亞,36,16,20,元大-大天母,2023-12-12,9893
5324,士開,22,2,20,元大-大天母,2023-12-12,9893
6292,迅德,33,13,20,元大-大天母,2023-12-12,9893
2337,旺宏,20,0,20,元大-大天母,2023-12-12,9893
1477,聚陽,20,0,20,元大-大天母,2023-12-12,9893
8112,至上,47,27,20,元大-大天母,2023-12-12,9893
2534,宏盛,19,0,19,元大-大天母,2023-12-12,9893
1618,合機,58,40,18,元大-大天母,2023-12-12,9893
00915,凱基優選高股息30,17,0,17,元大-大天母,2023-12-12,9893
00720B,元大投資級公司債,17,0,17,元大-大天母,2023-12-12,9893
00688L,國泰20年美債正2,17,0,17,元大-大天母,2023-12-12,9893
00937B,群益ESG投等債20,35,18,17,元大-大天母,2023-12-12,9893
2474,可成,17,0,17,元大-大天母,2023-12-12,9893
4953,緯軟,19,2,17,元大-大天母,2023-12-12,9893
3260,威剛,19,3,16,元大-大天母,2023-12-12,9893
6488,環球晶,15,0,15,元大-大天母,2023-12-12,9893
3105,穩懋,16,1,15,元大-大天母,2023-12-12,9893
1219,福壽,15,0,15,元大-大天母,2023-12-12,9893
2308,台達電,15,1,14,元大-大天母,2023-12-12,9893
2429,銘旺科,13,0,13,元大-大天母,2023-12-12,9893
2383,台光電,16,4,12,元大-大天母,2023-12-12,9893
3346,麗清,12,0,12,元大-大天母,2023-12-12,9893
4536,拓凱,11,0,11,元大-大天母,2023-12-12,9893
4906,正文,203,13,190,元大-大天母,2023-12-13,9893
2387,精元,200,27,173,元大-大天母,2023-12-13,9893
00929,復華台灣科技優息,151,31,120,元大-大天母,2023-12-13,9893
2002,中鋼,109,1,108,元大-大天母,2023-12-13,9893
006206,元大上證50,100,0,100,元大-大天母,2023-12-13,9893
8358,金居,100,7,93,元大-大天母,2023-12-13,9893
8299,群聯,80,0,80,元大-大天母,2023-12-13,9893
00915,凱基優選高股息30,63,0,63,元大-大天母,2023-12-13,9893
2027,大成鋼,62,0,62,元大-大天母,2023-12-13,9893
00715L,期街口布蘭特正2,75,20,55,元大-大天母,2023-12-13,9893
2618,長榮航,90,42,48,元大-大天母,2023-12-13,9893
00687B,國泰20年美債,46,0,46,元大-大天母,2023-12-13,9893
2705,六福,43,0,43,元大-大天母,2023-12-13,9893
00637L,元大滬深300正2,43,2,41,元大-大天母,2023-12-13,9893
3374,精材,35,0,35,元大-大天母,2023-12-13,9893
00662,富邦NASDAQ,30,0,30,元大-大天母,2023-12-13,9893
6204,艾華,32,2,30,元大-大天母,2023-12-13,9893
00918,大華優利高填息30,30,0,30,元大-大天母,2023-12-13,9893
3105,穩懋,27,0,27,元大-大天母,2023-12-13,9893
2634,漢翔,26,0,26,元大-大天母,2023-12-13,9893
2331,精英,25,0,25,元大-大天母,2023-12-13,9893
2211,長榮鋼,24,0,24,元大-大天母,2023-12-13,9893
1795,美時,33,10,23,元大-大天母,2023-12-13,9893
2882,國泰金,23,0,23,元大-大天母,2023-12-13,9893
2105,正新,21,0,21,元大-大天母,2023-12-13,9893
00891,中信關鍵半導體,20,0,20,元大-大天母,2023-12-13,9893
2615,萬海,24,4,20,元大-大天母,2023-12-13,9893
00671R,富邦NASDAQ反1,20,0,20,元大-大天母,2023-12-13,9893
1312,國喬,20,0,20,元大-大天母,2023-12-13,9893
4977,眾達-KY,20,0,20,元大-大天母,2023-12-13,9893
2515,中工,30,12,18,元大-大天母,2023-12-13,9893
3019,亞光,25,7,18,元大-大天母,2023-12-13,9893
8097,常珵,18,0,18,元大-大天母,2023-12-13,9893
00642U,期元大S＆P石油,18,0,18,元大-大天母,2023-12-13,9893
1609,大亞,19,2,17,元大-大天母,2023-12-13,9893
1219,福壽,17,0,17,元大-大天母,2023-12-13,9893
4933,友輝,58,41,17,元大-大天母,2023-12-13,9893
6104,創惟,18,1,17,元大-大天母,2023-12-13,9893
3006,晶豪科,24,8,16,元大-大天母,2023-12-13,9893
00933B,國泰10Y+金融債,16,0,16,元大-大天母,2023-12-13,9893
3390,旭軟,17,1,16,元大-大天母,2023-12-13,9893
2442,新美齊,15,0,15,元大-大天母,2023-12-13,9893
2885,元大金,18,4,14,元大-大天母,2023-12-13,9893
3017,奇鋐,30,16,14,元大-大天母,2023-12-13,9893
4979,華星光,17,4,13,元大-大天母,2023-12-13,9893
2897,王道銀行,13,0,13,元大-大天母,2023-12-13,9893
2609,陽明,14,1,13,元大-大天母,2023-12-13,9893
00722B,群益投資級電信債,13,0,13,元大-大天母,2023-12-13,9893
2062,橋椿,11,0,11,元大-大天母,2023-12-13,9893
2330,台積電,11,0,11,元大-大天母,2023-12-13,9893
2363,矽統,2063,102,1961,元大-大天母,2023-12-14,9893
00919,群益台灣精選高息,320,95,225,元大-大天母,2023-12-14,9893
2534,宏盛,157,0,157,元大-大天母,2023-12-14,9893
00687B,國泰20年美債,128,0,128,元大-大天母,2023-12-14,9893
2211,長榮鋼,78,1,77,元大-大天母,2023-12-14,9893
2888,新光金,85,20,65,元大-大天母,2023-12-14,9893
2883,凱基金,74,13,61,元大-大天母,2023-12-14,9893
2359,所羅門,51,1,50,元大-大天母,2023-12-14,9893
1321,大洋,48,0,48,元大-大天母,2023-12-14,9893
00637L,元大滬深300正2,57,15,42,元大-大天母,2023-12-14,9893
2705,六福,40,0,40,元大-大天母,2023-12-14,9893
0056,元大高股息,70,35,35,元大-大天母,2023-12-14,9893
00706L,期元大S＆P日圓正2,55,20,35,元大-大天母,2023-12-14,9893
00937B,群益ESG投等債20,101,68,33,元大-大天母,2023-12-14,9893
2812,台中銀,30,0,30,元大-大天母,2023-12-14,9893
00936,台新永續高息中小,30,0,30,元大-大天母,2023-12-14,9893
3715,定穎投控,34,7,27,元大-大天母,2023-12-14,9893
2515,中工,28,2,26,元大-大天母,2023-12-14,9893
3390,旭軟,28,2,26,元大-大天母,2023-12-14,9893
00933B,國泰10Y+金融債,24,0,24,元大-大天母,2023-12-14,9893
2704,國賓,26,3,23,元大-大天母,2023-12-14,9893
6799,來頡,22,0,22,元大-大天母,2023-12-14,9893
2344,華邦電,45,24,21,元大-大天母,2023-12-14,9893
4766,南寶,20,0,20,元大-大天母,2023-12-14,9893
5225,東科-KY,20,0,20,元大-大天母,2023-12-14,9893
2476,鉅祥,21,2,19,元大-大天母,2023-12-14,9893
2442,新美齊,17,0,17,元大-大天母,2023-12-14,9893
3227,原相,16,0,16,元大-大天母,2023-12-14,9893
2609,陽明,16,0,16,元大-大天母,2023-12-14,9893
2329,華泰,28,12,16,元大-大天母,2023-12-14,9893
2324,仁寶,28,12,16,元大-大天母,2023-12-14,9893
8011,台通,15,0,15,元大-大天母,2023-12-14,9893
6703,軒郁,15,0,15,元大-大天母,2023-12-14,9893
00669R,國泰美國道瓊反1,15,0,15,元大-大天母,2023-12-14,9893
5498,凱崴,16,1,15,元大-大天母,2023-12-14,9893
8112,至上,53,39,14,元大-大天母,2023-12-14,9893
2387,精元,22,8,14,元大-大天母,2023-12-14,9893
00715L,期街口布蘭特正2,14,0,14,元大-大天母,2023-12-14,9893
2472,立隆電,21,7,14,元大-大天母,2023-12-14,9893
00922,國泰台灣領袖50,14,0,14,元大-大天母,2023-12-14,9893
3006,晶豪科,23,10,13,元大-大天母,2023-12-14,9893
6770,力積電,15,2,13,元大-大天母,2023-12-14,9893
8068,全達,32,19,13,元大-大天母,2023-12-14,9893
1609,大亞,13,0,13,元大-大天母,2023-12-14,9893
00918,大華優利高填息30,17,4,13,元大-大天母,2023-12-14,9893
1815,富喬,12,0,12,元大-大天母,2023-12-14,9893
2383,台光電,18,6,12,元大-大天母,2023-12-14,9893
6245,立端,12,0,12,元大-大天母,2023-12-14,9893
00931B,統一美債20年,12,0,12,元大-大天母,2023-12-14,9893
1809,中釉,17,6,11,元大-大天母,2023-12-14,9893
00680L,元大美債20正2,185,10,175,元大-大天母,2023-12-15,9893
00637L,元大滬深300正2,189,21,168,元大-大天母,2023-12-15,9893
6546,正基,155,1,154,元大-大天母,2023-12-15,9893
00937B,群益ESG投等債20,147,3,144,元大-大天母,2023-12-15,9893
2105,正新,127,2,125,元大-大天母,2023-12-15,9893
00687B,國泰20年美債,117,0,117,元大-大天母,2023-12-15,9893
1321,大洋,112,0,112,元大-大天母,2023-12-15,9893
2388,威盛,119,13,106,元大-大天母,2023-12-15,9893
00919,群益台灣精選高息,235,133,102,元大-大天母,2023-12-15,9893
3217,優群,94,3,91,元大-大天母,2023-12-15,9893
5425,台半,96,9,87,元大-大天母,2023-12-15,9893
0056,元大高股息,113,26,87,元大-大天母,2023-12-15,9893
3260,威剛,95,9,86,元大-大天母,2023-12-15,9893
9939,宏全,80,0,80,元大-大天母,2023-12-15,9893
00878,國泰永續高股息,89,12,77,元大-大天母,2023-12-15,9893
2356,英業達,451,376,75,元大-大天母,2023-12-15,9893
2705,六福,70,0,70,元大-大天母,2023-12-15,9893
00929,復華台灣科技優息,146,84,62,元大-大天母,2023-12-15,9893
00720B,元大投資級公司債,60,0,60,元大-大天母,2023-12-15,9893
00933B,國泰10Y+金融債,59,0,59,元大-大天母,2023-12-15,9893
2332,友訊,54,0,54,元大-大天母,2023-12-15,9893
3576,聯合再生,50,0,50,元大-大天母,2023-12-15,9893
00753L,中信中國50正2,50,0,50,元大-大天母,2023-12-15,9893
2485,兆赫,45,0,45,元大-大天母,2023-12-15,9893
00918,大華優利高填息30,47,4,43,元大-大天母,2023-12-15,9893
00679B,元大美債20年,52,17,35,元大-大天母,2023-12-15,9893
3607,谷崧,27,0,27,元大-大天母,2023-12-15,9893
00713,元大台灣高息低波,27,0,27,元大-大天母,2023-12-15,9893
6126,信音,25,0,25,元大-大天母,2023-12-15,9893
3706,神達,29,5,24,元大-大天母,2023-12-15,9893
1513,中興電,31,8,23,元大-大天母,2023-12-15,9893
4961,天鈺,23,1,22,元大-大天母,2023-12-15,9893
8110,華東,24,2,22,元大-大天母,2023-12-15,9893
00921,兆豐龍頭等權重,22,0,22,元大-大天母,2023-12-15,9893
8112,至上,61,40,21,元大-大天母,2023-12-15,9893
6488,環球晶,29,8,21,元大-大天母,2023-12-15,9893
6245,立端,21,1,20,元大-大天母,2023-12-15,9893
00662,富邦NASDAQ,20,0,20,元大-大天母,2023-12-15,9893
00764B,群益25年美債,20,0,20,元大-大天母,2023-12-15,9893
2359,所羅門,20,1,19,元大-大天母,2023-12-15,9893
6741,91APP*-KY,20,1,19,元大-大天母,2023-12-15,9893
6263,普萊德,23,4,19,元大-大天母,2023-12-15,9893
00772B,中信高評級公司債,23,4,19,元大-大天母,2023-12-15,9893
3703,欣陸,20,2,18,元大-大天母,2023-12-15,9893
2017,官田鋼,18,0,18,元大-大天母,2023-12-15,9893
2801,彰銀,17,0,17,元大-大天母,2023-12-15,9893
2353,宏��,16,0,16,元大-大天母,2023-12-15,9893
2436,偉詮電,16,0,16,元大-大天母,2023-12-15,9893
2442,新美齊,16,0,16,元大-大天母,2023-12-15,9893
00885,富邦越南,15,0,15,元大-大天母,2023-12-15,9893
2607,榮運,407,33,374,元大-大天母,2023-12-18,9893
6168,宏齊,695,354,341,元大-大天母,2023-12-18,9893
00688L,國泰20年美債正2,235,6,229,元大-大天母,2023-12-18,9893
00680L,元大美債20正2,166,13,153,元大-大天母,2023-12-18,9893
00687B,國泰20年美債,154,29,125,元大-大天母,2023-12-18,9893
00885,富邦越南,106,0,106,元大-大天母,2023-12-18,9893
2352,佳世達,101,0,101,元大-大天母,2023-12-18,9893
2534,宏盛,100,0,100,元大-大天母,2023-12-18,9893
00919,群益台灣精選高息,113,16,97,元大-大天母,2023-12-18,9893
3047,訊舟,109,40,69,元大-大天母,2023-12-18,9893
00929,復華台灣科技優息,134,74,60,元大-大天母,2023-12-18,9893
00935,野村臺灣新科技50,56,0,56,元大-大天母,2023-12-18,9893
8086,宏捷科,52,1,51,元大-大天母,2023-12-18,9893
2888,新光金,53,2,51,元大-大天母,2023-12-18,9893
00632R,元大台灣50反1,55,5,50,元大-大天母,2023-12-18,9893
4906,正文,50,0,50,元大-大天母,2023-12-18,9893
8069,元太,46,0,46,元大-大天母,2023-12-18,9893
2610,華航,41,0,41,元大-大天母,2023-12-18,9893
2332,友訊,48,8,40,元大-大天母,2023-12-18,9893
00724B,群益投資級金融債,35,0,35,元大-大天母,2023-12-18,9893
2211,長榮鋼,38,3,35,元大-大天母,2023-12-18,9893
2485,兆赫,35,2,33,元大-大天母,2023-12-18,9893
2027,大成鋼,44,12,32,元大-大天母,2023-12-18,9893
2356,英業達,81,50,31,元大-大天母,2023-12-18,9893
2401,凌陽,35,5,30,元大-大天母,2023-12-18,9893
5432,新門,34,4,30,元大-大天母,2023-12-18,9893
2031,新光鋼,35,10,25,元大-大天母,2023-12-18,9893
00933B,國泰10Y+金融債,22,0,22,元大-大天母,2023-12-18,9893
1618,合機,25,4,21,元大-大天母,2023-12-18,9893
2101,南港,20,0,20,元大-大天母,2023-12-18,9893
00753L,中信中國50正2,20,0,20,元大-大天母,2023-12-18,9893
00934,中信成長高股息,20,0,20,元大-大天母,2023-12-18,9893
00764B,群益25年美債,20,0,20,元大-大天母,2023-12-18,9893
00662,富邦NASDAQ,20,0,20,元大-大天母,2023-12-18,9893
8182,加高,20,0,20,元大-大天母,2023-12-18,9893
3481,群創,24,5,19,元大-大天母,2023-12-18,9893
00921,兆豐龍頭等權重,18,0,18,元大-大天母,2023-12-18,9893
2030,彰源,20,3,17,元大-大天母,2023-12-18,9893
2882,國泰金,15,0,15,元大-大天母,2023-12-18,9893
2023,燁輝,88,73,15,元大-大天母,2023-12-18,9893
2313,華通,18,3,15,元大-大天母,2023-12-18,9893
00648R,元大S＆P500反1,15,0,15,元大-大天母,2023-12-18,9893
0056,元大高股息,32,17,15,元大-大天母,2023-12-18,9893
3032,偉訓,14,0,14,元大-大天母,2023-12-18,9893
3607,谷崧,14,0,14,元大-大天母,2023-12-18,9893
2359,所羅門,17,3,14,元大-大天母,2023-12-18,9893
00679B,元大美債20年,68,54,14,元大-大天母,2023-12-18,9893
3024,憶聲,13,0,13,元大-大天母,2023-12-18,9893
2636,台驊控股,14,2,12,元大-大天母,2023-12-18,9893
00772B,中信高評級公司債,12,0,12,元大-大天母,2023-12-18,9893
00751B,元大AAA至A公司債,183,0,183,元大-大天母,2023-12-19,9893
00680L,元大美債20正2,172,12,160,元大-大天母,2023-12-19,9893
5314,世紀,151,0,151,元大-大天母,2023-12-19,9893
00929,復華台灣科技優息,237,96,141,元大-大天母,2023-12-19,9893
2618,長榮航,116,8,108,元大-大天母,2023-12-19,9893
2344,華邦電,114,19,95,元大-大天母,2023-12-19,9893
2534,宏盛,90,0,90,元大-大天母,2023-12-19,9893
2356,英業達,111,22,89,元大-大天母,2023-12-19,9893
2610,華航,99,13,86,元大-大天母,2023-12-19,9893
3605,宏致,76,0,76,元大-大天母,2023-12-19,9893
5521,工信,77,7,70,元大-大天母,2023-12-19,9893
2801,彰銀,62,0,62,元大-大天母,2023-12-19,9893
2883,凱基金,69,11,58,元大-大天母,2023-12-19,9893
4133,亞諾法,50,1,49,元大-大天母,2023-12-19,9893
00937B,群益ESG投等債20,82,33,49,元大-大天母,2023-12-19,9893
0056,元大高股息,56,10,46,元大-大天母,2023-12-19,9893
2332,友訊,41,0,41,元大-大天母,2023-12-19,9893
6168,宏齊,115,76,39,元大-大天母,2023-12-19,9893
00720B,元大投資級公司債,37,0,37,元大-大天母,2023-12-19,9893
1609,大亞,38,2,36,元大-大天母,2023-12-19,9893
3006,晶豪科,42,6,36,元大-大天母,2023-12-19,9893
2399,映泰,32,0,32,元大-大天母,2023-12-19,9893
00679B,元大美債20年,57,26,31,元大-大天母,2023-12-19,9893
2401,凌陽,33,3,30,元大-大天母,2023-12-19,9893
5426,振發,31,2,29,元大-大天母,2023-12-19,9893
2027,大成鋼,43,15,28,元大-大天母,2023-12-19,9893
00878,國泰永續高股息,29,2,27,元大-大天母,2023-12-19,9893
2887,台新金,35,10,25,元大-大天母,2023-12-19,9893
00934,中信成長高股息,28,4,24,元大-大天母,2023-12-19,9893
4744,皇將,24,0,24,元大-大天母,2023-12-19,9893
2881,富邦金,24,0,24,元大-大天母,2023-12-19,9893
2913,農林,28,5,23,元大-大天母,2023-12-19,9893
2889,國票金,22,0,22,元大-大天母,2023-12-19,9893
6191,精成科,26,4,22,元大-大天母,2023-12-19,9893
9910,豐泰,21,0,21,元大-大天母,2023-12-19,9893
2337,旺宏,22,1,21,元大-大天母,2023-12-19,9893
2352,佳世達,20,0,20,元大-大天母,2023-12-19,9893
2882,國泰金,22,2,20,元大-大天母,2023-12-19,9893
2108,南帝,20,0,20,元大-大天母,2023-12-19,9893
3709,鑫聯大投控,20,0,20,元大-大天母,2023-12-19,9893
00662,富邦NASDAQ,20,0,20,元大-大天母,2023-12-19,9893
1524,耿鼎,21,2,19,元大-大天母,2023-12-19,9893
00713,元大台灣高息低波,19,1,18,元大-大天母,2023-12-19,9893
00930,永豐ESG低碳高息,18,0,18,元大-大天母,2023-12-19,9893
1513,中興電,28,11,17,元大-大天母,2023-12-19,9893
1708,東鹼,17,0,17,元大-大天母,2023-12-19,9893
2002,中鋼,24,7,17,元大-大天母,2023-12-19,9893
3231,緯創,40,25,15,元大-大天母,2023-12-19,9893
00687B,國泰20年美債,20,6,14,元大-大天母,2023-12-19,9893
6263,普萊德,19,5,14,元大-大天母,2023-12-19,9893
2515,中工,333,51,282,元大-大天母,2023-12-20,9893
2618,長榮航,213,12,201,元大-大天母,2023-12-20,9893
00751B,元大AAA至A公司債,174,1,173,元大-大天母,2023-12-20,9893
2312,金寶,176,54,122,元大-大天母,2023-12-20,9893
1781,合世,100,0,100,元大-大天母,2023-12-20,9893
00919,群益台灣精選高息,96,5,91,元大-大天母,2023-12-20,9893
2891,中信金,81,1,80,元大-大天母,2023-12-20,9893
00679B,元大美債20年,83,7,76,元大-大天母,2023-12-20,9893
2889,國票金,60,0,60,元大-大天母,2023-12-20,9893
6168,宏齊,391,333,58,元大-大天母,2023-12-20,9893
3211,順達,58,2,56,元大-大天母,2023-12-20,9893
00687B,國泰20年美債,57,2,55,元大-大天母,2023-12-20,9893
3576,聯合再生,54,4,50,元大-大天母,2023-12-20,9893
00720B,元大投資級公司債,33,0,33,元大-大天母,2023-12-20,9893
00688L,國泰20年美債正2,52,22,30,元大-大天母,2023-12-20,9893
2913,農林,30,0,30,元大-大天母,2023-12-20,9893
4116,明基醫,35,5,30,元大-大天母,2023-12-20,9893
2006,東和鋼鐵,30,1,29,元大-大天母,2023-12-20,9893
00937B,群益ESG投等債20,29,1,28,元大-大天母,2023-12-20,9893
3006,晶豪科,51,24,27,元大-大天母,2023-12-20,9893
3715,定穎投控,27,2,25,元大-大天母,2023-12-20,9893
2886,兆豐金,27,2,25,元大-大天母,2023-12-20,9893
6156,松上,27,3,24,元大-大天母,2023-12-20,9893
00934,中信成長高股息,22,0,22,元大-大天母,2023-12-20,9893
00929,復華台灣科技優息,70,49,21,元大-大天母,2023-12-20,9893
6585,鼎基,22,3,19,元大-大天母,2023-12-20,9893
1304,台聚,20,1,19,元大-大天母,2023-12-20,9893
3231,緯創,68,50,18,元大-大天母,2023-12-20,9893
6213,聯茂,29,12,17,元大-大天母,2023-12-20,9893
2485,兆赫,16,0,16,元大-大天母,2023-12-20,9893
3265,台星科,16,1,15,元大-大天母,2023-12-20,9893
5469,瀚宇博,16,1,15,元大-大天母,2023-12-20,9893
00933B,國泰10Y+金融債,14,0,14,元大-大天母,2023-12-20,9893
5521,工信,20,6,14,元大-大天母,2023-12-20,9893
8930,青鋼,14,0,14,元大-大天母,2023-12-20,9893
2014,中鴻,48,35,13,元大-大天母,2023-12-20,9893
3037,欣興,15,2,13,元大-大天母,2023-12-20,9893
3014,聯陽,11,0,11,元大-大天母,2023-12-20,9893
00892,富邦台灣半導體,11,0,11,元大-大天母,2023-12-20,9893
2020,美亞,11,0,11,元大-大天母,2023-12-20,9893
3483,力致,11,0,11,元大-大天母,2023-12-20,9893
5508,永信建,11,0,11,元大-大天母,2023-12-20,9893
6205,詮欣,12,1,11,元大-大天母,2023-12-20,9893
020040,元大上櫃ESG龍頭N,10,0,10,元大-大天母,2023-12-20,9893
2022,聚亨,10,0,10,元大-大天母,2023-12-20,9893
6488,環球晶,10,0,10,元大-大天母,2023-12-20,9893
6703,軒郁,9,0,9,元大-大天母,2023-12-20,9893
00882,中信中國高股息,9,0,9,元大-大天母,2023-12-20,9893
4938,和碩,10,1,9,元大-大天母,2023-12-20,9893
00935,野村臺灣新科技50,9,0,9,元大-大天母,2023-12-20,9893
4305,世坤,205,0,205,元大-大天母,2023-12-21,9893
2801,彰銀,143,0,143,元大-大天母,2023-12-21,9893
00919,群益台灣精選高息,142,1,141,元大-大天母,2023-12-21,9893
3605,宏致,140,0,140,元大-大天母,2023-12-21,9893
2886,兆豐金,134,3,131,元大-大天母,2023-12-21,9893
9105,泰金寶-DR,446,321,125,元大-大天母,2023-12-21,9893
00680L,元大美債20正2,122,10,112,元大-大天母,2023-12-21,9893
6168,宏齊,115,10,105,元大-大天母,2023-12-21,9893
2312,金寶,106,3,103,元大-大天母,2023-12-21,9893
00929,復華台灣科技優息,125,30,95,元大-大天母,2023-12-21,9893
2892,第一金,72,1,71,元大-大天母,2023-12-21,9893
2324,仁寶,100,33,67,元大-大天母,2023-12-21,9893
2353,宏��,95,37,58,元大-大天母,2023-12-21,9893
00632R,元大台灣50反1,50,6,44,元大-大天母,2023-12-21,9893
00772B,中信高評級公司債,40,0,40,元大-大天母,2023-12-21,9893
00935,野村臺灣新科技50,27,0,27,元大-大天母,2023-12-21,9893
2330,台積電,26,0,26,元大-大天母,2023-12-21,9893
2331,精英,32,6,26,元大-大天母,2023-12-21,9893
2014,中鴻,31,7,24,元大-大天母,2023-12-21,9893
00662,富邦NASDAQ,21,0,21,元大-大天母,2023-12-21,9893
2442,新美齊,21,0,21,元大-大天母,2023-12-21,9893
3047,訊舟,20,0,20,元大-大天母,2023-12-21,9893
00878,國泰永續高股息,23,4,19,元大-大天母,2023-12-21,9893
5426,振發,19,0,19,元大-大天母,2023-12-21,9893
2303,聯電,21,2,19,元大-大天母,2023-12-21,9893
00753L,中信中國50正2,17,0,17,元大-大天母,2023-12-21,9893
8088,品安,23,6,17,元大-大天母,2023-12-21,9893
00751B,元大AAA至A公司債,16,0,16,元大-大天母,2023-12-21,9893
1711,永光,15,0,15,元大-大天母,2023-12-21,9893
5608,四維航,20,5,15,元大-大天母,2023-12-21,9893
1304,台聚,15,1,14,元大-大天母,2023-12-21,9893
9919,康那香,41,27,14,元大-大天母,2023-12-21,9893
1795,美時,16,2,14,元大-大天母,2023-12-21,9893
2002,中鋼,15,1,14,元大-大天母,2023-12-21,9893
2362,藍天,14,1,13,元大-大天母,2023-12-21,9893
1732,毛寶,22,9,13,元大-大天母,2023-12-21,9893
00687B,國泰20年美債,12,0,12,元大-大天母,2023-12-21,9893
2323,中環,13,1,12,元大-大天母,2023-12-21,9893
3094,聯傑,12,0,12,元大-大天母,2023-12-21,9893
1752,南光,12,0,12,元大-大天母,2023-12-21,9893
00918,大華優利高填息30,11,0,11,元大-大天母,2023-12-21,9893
9933,中鼎,12,1,11,元大-大天母,2023-12-21,9893
4303,信立,11,0,11,元大-大天母,2023-12-21,9893
3010,華立,11,0,11,元大-大天母,2023-12-21,9893
3005,神基,11,0,11,元大-大天母,2023-12-21,9893
1722,台肥,10,0,10,元大-大天母,2023-12-21,9893
1609,大亞,14,4,10,元大-大天母,2023-12-21,9893
2883,凱基金,10,0,10,元大-大天母,2023-12-21,9893
4142,國光生,10,0,10,元大-大天母,2023-12-21,9893
6173,信昌電,11,1,10,元大-大天母,2023-12-21,9893
2891,中信金,303,5,298,元大-大天母,2023-12-22,9893
6168,宏齊,188,0,188,元大-大天母,2023-12-22,9893
2801,彰銀,124,0,124,元大-大天母,2023-12-22,9893
4305,世坤,108,0,108,元大-大天母,2023-12-22,9893
00665L,富邦�琤肭磪囓�2,102,0,102,元大-大天母,2023-12-22,9893
00688L,國泰20年美債正2,94,0,94,元大-大天母,2023-12-22,9893
2356,英業達,304,243,61,元大-大天母,2023-12-22,9893
4906,正文,51,1,50,元大-大天母,2023-12-22,9893
9105,泰金寶-DR,64,19,45,元大-大天母,2023-12-22,9893
00633L,富邦上証正2,46,8,38,元大-大天母,2023-12-22,9893
00929,復華台灣科技優息,39,2,37,元大-大天母,2023-12-22,9893
00687B,國泰20年美債,38,3,35,元大-大天母,2023-12-22,9893
3211,順達,32,0,32,元大-大天母,2023-12-22,9893
6207,雷科,35,4,31,元大-大天母,2023-12-22,9893
2376,技嘉,35,5,30,元大-大天母,2023-12-22,9893
3231,緯創,36,6,30,元大-大天母,2023-12-22,9893
5258,虹堡,28,0,28,元大-大天母,2023-12-22,9893
6204,艾華,35,7,28,元大-大天母,2023-12-22,9893
4979,華星光,26,0,26,元大-大天母,2023-12-22,9893
3483,力致,26,1,25,元大-大天母,2023-12-22,9893
00919,群益台灣精選高息,36,11,25,元大-大天母,2023-12-22,9893
00680L,元大美債20正2,26,2,24,元大-大天母,2023-12-22,9893
8110,華東,25,1,24,元大-大天母,2023-12-22,9893
00720B,元大投資級公司債,18,0,18,元大-大天母,2023-12-22,9893
9919,康那香,18,1,17,元大-大天母,2023-12-22,9893
2355,敬鵬,27,11,16,元大-大天母,2023-12-22,9893
2449,京元電子,16,0,16,元大-大天母,2023-12-22,9893
2543,皇昌,15,0,15,元大-大天母,2023-12-22,9893
4533,協易機,15,0,15,元大-大天母,2023-12-22,9893
9910,豐泰,14,0,14,元大-大天母,2023-12-22,9893
2387,精元,15,1,14,元大-大天母,2023-12-22,9893
00922,國泰台灣領袖50,16,2,14,元大-大天母,2023-12-22,9893
8996,高力,11,0,11,元大-大天母,2023-12-22,9893
00933B,國泰10Y+金融債,11,0,11,元大-大天母,2023-12-22,9893
6182,合晶,11,0,11,元大-大天母,2023-12-22,9893
5498,凱崴,11,0,11,元大-大天母,2023-12-22,9893
1477,聚陽,12,1,11,元大-大天母,2023-12-22,9893
8050,廣積,10,0,10,元大-大天母,2023-12-22,9893
2014,中鴻,18,8,10,元大-大天母,2023-12-22,9893
2362,藍天,10,0,10,元大-大天母,2023-12-22,9893
00753L,中信中國50正2,10,0,10,元大-大天母,2023-12-22,9893
3048,益登,10,0,10,元大-大天母,2023-12-22,9893
00725B,國泰投資級公司債,10,0,10,元大-大天母,2023-12-22,9893
2303,聯電,17,7,10,元大-大天母,2023-12-22,9893
2331,精英,23,13,10,元大-大天母,2023-12-22,9893
00772B,中信高評級公司債,28,19,9,元大-大天母,2023-12-22,9893
2882,國泰金,9,0,9,元大-大天母,2023-12-22,9893
3715,定穎投控,10,1,9,元大-大天母,2023-12-22,9893
2886,兆豐金,12,3,9,元大-大天母,2023-12-22,9893
3588,通嘉,9,0,9,元大-大天母,2023-12-22,9893
00680L,元大美債20正2,316,28,288,元大-大天母,2023-12-25,9893
2331,精英,142,8,134,元大-大天母,2023-12-25,9893
2610,華航,167,100,67,元大-大天母,2023-12-25,9893
2603,長榮,90,31,59,元大-大天母,2023-12-25,9893
00919,群益台灣精選高息,61,3,58,元大-大天母,2023-12-25,9893
9938,百和,55,0,55,元大-大天母,2023-12-25,9893
3576,聯合再生,54,0,54,元大-大天母,2023-12-25,9893
00929,復華台灣科技優息,72,22,50,元大-大天母,2023-12-25,9893
1905,華紙,50,0,50,元大-大天母,2023-12-25,9893
1321,大洋,45,0,45,元大-大天母,2023-12-25,9893
8050,廣積,42,1,41,元大-大天母,2023-12-25,9893
6435,大中,48,8,40,元大-大天母,2023-12-25,9893
2883,凱基金,35,0,35,元大-大天母,2023-12-25,9893
00931B,統一美債20年,32,0,32,元大-大天母,2023-12-25,9893
9904,寶成,31,0,31,元大-大天母,2023-12-25,9893
00720B,元大投資級公司債,30,0,30,元大-大天母,2023-12-25,9893
00679B,元大美債20年,32,2,30,元大-大天母,2023-12-25,9893
9910,豐泰,30,0,30,元大-大天母,2023-12-25,9893
00753L,中信中國50正2,30,0,30,元大-大天母,2023-12-25,9893
2363,矽統,31,2,29,元大-大天母,2023-12-25,9893
2362,藍天,29,1,28,元大-大天母,2023-12-25,9893
6168,宏齊,28,0,28,元大-大天母,2023-12-25,9893
2313,華通,29,5,24,元大-大天母,2023-12-25,9893
2449,京元電子,25,2,23,元大-大天母,2023-12-25,9893
2615,萬海,29,8,21,元大-大天母,2023-12-25,9893
2609,陽明,279,259,20,元大-大天母,2023-12-25,9893
4766,南寶,20,0,20,元大-大天母,2023-12-25,9893
2409,友達,22,2,20,元大-大天母,2023-12-25,9893
6667,信紘科,20,0,20,元大-大天母,2023-12-25,9893
2472,立隆電,16,0,16,元大-大天母,2023-12-25,9893
9105,泰金寶-DR,29,13,16,元大-大天母,2023-12-25,9893
2881,富邦金,17,2,15,元大-大天母,2023-12-25,9893
00918,大華優利高填息30,14,0,14,元大-大天母,2023-12-25,9893
3031,佰鴻,13,0,13,元大-大天母,2023-12-25,9893
6278,台表科,17,4,13,元大-大天母,2023-12-25,9893
1907,永豐餘,12,0,12,元大-大天母,2023-12-25,9893
00933B,國泰10Y+金融債,12,1,11,元大-大天母,2023-12-25,9893
00772B,中信高評級公司債,11,0,11,元大-大天母,2023-12-25,9893
2606,裕民,10,0,10,元大-大天母,2023-12-25,9893
3521,鴻翊,40,30,10,元大-大天母,2023-12-25,9893
1609,大亞,10,0,10,元大-大天母,2023-12-25,9893
1795,美時,13,3,10,元大-大天母,2023-12-25,9893
00937B,群益ESG投等債20,14,5,9,元大-大天母,2023-12-25,9893
3715,定穎投控,28,19,9,元大-大天母,2023-12-25,9893
2371,大同,10,1,9,元大-大天母,2023-12-25,9893
3051,力特,12,3,9,元大-大天母,2023-12-25,9893
2884,玉山金,9,1,8,元大-大天母,2023-12-25,9893
5469,瀚宇博,10,2,8,元大-大天母,2023-12-25,9893
4533,協易機,8,0,8,元大-大天母,2023-12-25,9893
6112,邁達特,8,0,8,元大-大天母,2023-12-25,9893
00632R,元大台灣50反1,190,0,190,元大-大天母,2023-12-26,9893
00929,復華台灣科技優息,139,49,90,元大-大天母,2023-12-26,9893
2618,長榮航,56,4,52,元大-大天母,2023-12-26,9893
3438,類比科,54,7,47,元大-大天母,2023-12-26,9893
9939,宏全,41,0,41,元大-大天母,2023-12-26,9893
9938,百和,40,0,40,元大-大天母,2023-12-26,9893
1321,大洋,35,0,35,元大-大天母,2023-12-26,9893
00751B,元大AAA至A公司債,34,0,34,元大-大天母,2023-12-26,9893
6168,宏齊,33,0,33,元大-大天母,2023-12-26,9893
00687B,國泰20年美債,37,4,33,元大-大天母,2023-12-26,9893
2881,富邦金,31,0,31,元大-大天母,2023-12-26,9893
2636,台驊控股,26,0,26,元大-大天母,2023-12-26,9893
3231,緯創,41,17,24,元大-大天母,2023-12-26,9893
2101,南港,22,0,22,元大-大天母,2023-12-26,9893
00905,FT臺灣Smart,20,0,20,元大-大天母,2023-12-26,9893
006206,元大上證50,20,0,20,元大-大天母,2023-12-26,9893
6733,博晟生醫,20,0,20,元大-大天母,2023-12-26,9893
00919,群益台灣精選高息,23,6,17,元大-大天母,2023-12-26,9893
00720B,元大投資級公司債,17,2,15,元大-大天母,2023-12-26,9893
00725B,國泰投資級公司債,14,0,14,元大-大天母,2023-12-26,9893
00679B,元大美債20年,15,3,12,元大-大天母,2023-12-26,9893
2498,宏達電,13,1,12,元大-大天母,2023-12-26,9893
8068,全達,15,3,12,元大-大天母,2023-12-26,9893
4766,南寶,11,0,11,元大-大天母,2023-12-26,9893
6182,合晶,11,0,11,元大-大天母,2023-12-26,9893
2382,廣達,16,5,11,元大-大天母,2023-12-26,9893
2027,大成鋼,10,0,10,元大-大天母,2023-12-26,9893
2897,王道銀行,20,10,10,元大-大天母,2023-12-26,9893
1789,神隆,10,0,10,元大-大天母,2023-12-26,9893
8110,華東,11,1,10,元大-大天母,2023-12-26,9893
1309,台達化,10,0,10,元大-大天母,2023-12-26,9893
6233,旺玖,10,0,10,元大-大天母,2023-12-26,9893
2331,精英,11,1,10,元大-大天母,2023-12-26,9893
2371,大同,11,1,10,元大-大天母,2023-12-26,9893
2892,第一金,30,20,10,元大-大天母,2023-12-26,9893
3227,原相,9,0,9,元大-大天母,2023-12-26,9893
6462,神盾,12,3,9,元大-大天母,2023-12-26,9893
2365,昆盈,14,5,9,元大-大天母,2023-12-26,9893
3264,欣銓,12,3,9,元大-大天母,2023-12-26,9893
2363,矽統,12,3,9,元大-大天母,2023-12-26,9893
2605,新興,9,0,9,元大-大天母,2023-12-26,9893
6667,信紘科,15,6,9,元大-大天母,2023-12-26,9893
4979,華星光,10,1,9,元大-大天母,2023-12-26,9893
2399,映泰,8,0,8,元大-大天母,2023-12-26,9893
00888,永豐台灣ESG,10,2,8,元大-大天母,2023-12-26,9893
2356,英業達,42,35,7,元大-大天母,2023-12-26,9893
8069,元太,11,5,6,元大-大天母,2023-12-26,9893
2615,萬海,11,5,6,元大-大天母,2023-12-26,9893
8054,安國,6,0,6,元大-大天母,2023-12-26,9893
2915,潤泰全,6,0,6,元大-大天母,2023-12-26,9893
00937B,群益ESG投等債20,173,0,173,元大-大天母,2023-12-27,9893
6509,聚和,109,1,108,元大-大天母,2023-12-27,9893
2353,宏��,242,156,86,元大-大天母,2023-12-27,9893
2618,長榮航,74,8,66,元大-大天母,2023-12-27,9893
00751B,元大AAA至A公司債,62,1,61,元大-大天母,2023-12-27,9893
3481,群創,113,67,46,元大-大天母,2023-12-27,9893
2331,精英,44,1,43,元大-大天母,2023-12-27,9893
00687B,國泰20年美債,44,4,40,元大-大天母,2023-12-27,9893
00929,復華台灣科技優息,44,7,37,元大-大天母,2023-12-27,9893
2881,富邦金,31,0,31,元大-大天母,2023-12-27,9893
2465,麗臺,31,1,30,元大-大天母,2023-12-27,9893
6168,宏齊,130,103,27,元大-大天母,2023-12-27,9893
3532,台勝科,30,6,24,元大-大天母,2023-12-27,9893
1609,大亞,24,0,24,元大-大天母,2023-12-27,9893
2634,漢翔,23,1,22,元大-大天母,2023-12-27,9893
2636,台驊控股,21,0,21,元大-大天母,2023-12-27,9893
0056,元大高股息,125,104,21,元大-大天母,2023-12-27,9893
00632R,元大台灣50反1,27,7,20,元大-大天母,2023-12-27,9893
00679B,元大美債20年,22,6,16,元大-大天母,2023-12-27,9893
8936,國統,44,29,15,元大-大天母,2023-12-27,9893
2362,藍天,17,2,15,元大-大天母,2023-12-27,9893
2376,技嘉,25,11,14,元大-大天母,2023-12-27,9893
00919,群益台灣精選高息,27,13,14,元大-大天母,2023-12-27,9893
3545,敦泰,15,1,14,元大-大天母,2023-12-27,9893
1785,光洋科,13,0,13,元大-大天母,2023-12-27,9893
2313,華通,15,3,12,元大-大天母,2023-12-27,9893
6290,良維,12,0,12,元大-大天母,2023-12-27,9893
5469,瀚宇博,12,0,12,元大-大天母,2023-12-27,9893
1513,中興電,11,0,11,元大-大天母,2023-12-27,9893
2892,第一金,10,0,10,元大-大天母,2023-12-27,9893
2405,輔信,35,25,10,元大-大天母,2023-12-27,9893
8011,台通,10,0,10,元大-大天母,2023-12-27,9893
3483,力致,10,0,10,元大-大天母,2023-12-27,9893
2105,正新,11,1,10,元大-大天母,2023-12-27,9893
2323,中環,20,10,10,元大-大天母,2023-12-27,9893
3346,麗清,12,2,10,元大-大天母,2023-12-27,9893
6248,沛波,10,0,10,元大-大天母,2023-12-27,9893
6670,復盛應用,10,0,10,元大-大天母,2023-12-27,9893
2020,美亞,10,1,9,元大-大天母,2023-12-27,9893
00720B,元大投資級公司債,8,0,8,元大-大天母,2023-12-27,9893
3548,兆利,11,3,8,元大-大天母,2023-12-27,9893
2399,映泰,12,4,8,元大-大天母,2023-12-27,9893
8054,安國,8,0,8,元大-大天母,2023-12-27,9893
8070,長華*,8,0,8,元大-大天母,2023-12-27,9893
6494,九齊,7,0,7,元大-大天母,2023-12-27,9893
4720,德淵,7,0,7,元大-大天母,2023-12-27,9893
1582,信錦,12,5,7,元大-大天母,2023-12-27,9893
3450,聯鈞,7,0,7,元大-大天母,2023-12-27,9893
3374,精材,7,0,7,元大-大天母,2023-12-27,9893
00918,大華優利高填息30,6,0,6,元大-大天母,2023-12-27,9893
00665L,富邦�琤肭磪囓�2,210,0,210,元大-大天母,2023-12-28,9893
00633L,富邦上証正2,200,3,197,元大-大天母,2023-12-28,9893
2324,仁寶,170,59,111,元大-大天母,2023-12-28,9893
6168,宏齊,91,0,91,元大-大天母,2023-12-28,9893
2312,金寶,80,5,75,元大-大天母,2023-12-28,9893
00919,群益台灣精選高息,107,32,75,元大-大天母,2023-12-28,9893
00937B,群益ESG投等債20,79,4,75,元大-大天母,2023-12-28,9893
3390,旭軟,61,10,51,元大-大天母,2023-12-28,9893
2603,長榮,58,8,50,元大-大天母,2023-12-28,9893
00688L,國泰20年美債正2,60,11,49,元大-大天母,2023-12-28,9893
00933B,國泰10Y+金融債,40,1,39,元大-大天母,2023-12-28,9893
5011,久陽,36,0,36,元大-大天母,2023-12-28,9893
3694,海華,38,6,32,元大-大天母,2023-12-28,9893
2442,新美齊,31,0,31,元大-大天母,2023-12-28,9893
00751B,元大AAA至A公司債,30,0,30,元大-大天母,2023-12-28,9893
2344,華邦電,209,179,30,元大-大天母,2023-12-28,9893
2331,精英,32,6,26,元大-大天母,2023-12-28,9893
3376,新日興,32,7,25,元大-大天母,2023-12-28,9893
8936,國統,25,1,24,元大-大天母,2023-12-28,9893
00934,中信成長高股息,23,1,22,元大-大天母,2023-12-28,9893
00918,大華優利高填息30,28,7,21,元大-大天母,2023-12-28,9893
4939,亞電,21,0,21,元大-大天母,2023-12-28,9893
6189,豐藝,24,3,21,元大-大天母,2023-12-28,9893
8081,致新,25,4,21,元大-大天母,2023-12-28,9893
00929,復華台灣科技優息,59,39,20,元大-大天母,2023-12-28,9893
3006,晶豪科,56,37,19,元大-大天母,2023-12-28,9893
1514,亞力,66,49,17,元大-大天母,2023-12-28,9893
00687B,國泰20年美債,17,0,17,元大-大天母,2023-12-28,9893
2405,輔信,16,2,14,元大-大天母,2023-12-28,9893
2618,長榮航,15,2,13,元大-大天母,2023-12-28,9893
00673R,期元大S＆P原油反1,13,0,13,元大-大天母,2023-12-28,9893
3188,鑫龍騰,12,0,12,元大-大天母,2023-12-28,9893
6207,雷科,12,0,12,元大-大天母,2023-12-28,9893
00753L,中信中國50正2,12,0,12,元大-大天母,2023-12-28,9893
8050,廣積,12,0,12,元大-大天母,2023-12-28,9893
6026,福邦證,11,0,11,元大-大天母,2023-12-28,9893
2850,新產,11,0,11,元大-大天母,2023-12-28,9893
5351,鈺創,19,8,11,元大-大天母,2023-12-28,9893
4961,天鈺,10,0,10,元大-大天母,2023-12-28,9893
2498,宏達電,11,1,10,元大-大天母,2023-12-28,9893
4128,中天,10,0,10,元大-大天母,2023-12-28,9893
00927,群益半導體收益,10,0,10,元大-大天母,2023-12-28,9893
2436,偉詮電,16,6,10,元大-大天母,2023-12-28,9893
2020,美亞,10,0,10,元大-大天母,2023-12-28,9893
3338,泰碩,24,14,10,元大-大天母,2023-12-28,9893
1313,聯成,12,2,10,元大-大天母,2023-12-28,9893
2832,台產,10,0,10,元大-大天母,2023-12-28,9893
3483,力致,13,3,10,元大-大天母,2023-12-28,9893
00881,國泰台灣5G+,10,0,10,元大-大天母,2023-12-28,9893
4107,邦特,10,0,10,元大-大天母,2023-12-28,9893
00937B,群益ESG投等債20,145,0,145,元大-大天母,2023-12-29,9893
00687B,國泰20年美債,97,0,97,元大-大天母,2023-12-29,9893
00933B,國泰10Y+金融債,94,0,94,元大-大天母,2023-12-29,9893
1503,士電,60,4,56,元大-大天母,2023-12-29,9893
00919,群益台灣精選高息,80,30,50,元大-大天母,2023-12-29,9893
2465,麗臺,44,1,43,元大-大天母,2023-12-29,9893
6168,宏齊,41,0,41,元大-大天母,2023-12-29,9893
2515,中工,35,0,35,元大-大天母,2023-12-29,9893
00751B,元大AAA至A公司債,31,0,31,元大-大天母,2023-12-29,9893
1514,亞力,38,9,29,元大-大天母,2023-12-29,9893
00929,復華台灣科技優息,36,10,26,元大-大天母,2023-12-29,9893
6263,普萊德,36,12,24,元大-大天母,2023-12-29,9893
1609,大亞,28,5,23,元大-大天母,2023-12-29,9893
8478,東哥遊艇,22,0,22,元大-大天母,2023-12-29,9893
00679B,元大美債20年,22,0,22,元大-大天母,2023-12-29,9893
8112,至上,27,6,21,元大-大天母,2023-12-29,9893
2442,新美齊,21,0,21,元大-大天母,2023-12-29,9893
6799,來頡,25,5,20,元大-大天母,2023-12-29,9893
2352,佳世達,64,44,20,元大-大天母,2023-12-29,9893
00720B,元大投資級公司債,19,1,18,元大-大天母,2023-12-29,9893
2609,陽明,23,6,17,元大-大天母,2023-12-29,9893
2881,富邦金,20,3,17,元大-大天母,2023-12-29,9893
2010,春源,20,3,17,元大-大天母,2023-12-29,9893
3006,晶豪科,44,27,17,元大-大天母,2023-12-29,9893
1101,台泥,16,0,16,元大-大天母,2023-12-29,9893
1513,中興電,17,1,16,元大-大天母,2023-12-29,9893
00795B,中信美國公債20年,21,5,16,元大-大天母,2023-12-29,9893
2467,志聖,15,0,15,元大-大天母,2023-12-29,9893
2211,長榮鋼,16,2,14,元大-大天母,2023-12-29,9893
2405,輔信,15,1,14,元大-大天母,2023-12-29,9893
00931B,統一美債20年,14,1,13,元大-大天母,2023-12-29,9893
1605,華新,15,2,13,元大-大天母,2023-12-29,9893
8081,致新,13,0,13,元大-大天母,2023-12-29,9893
2331,精英,12,0,12,元大-大天母,2023-12-29,9893
2883,凱基金,18,6,12,元大-大天母,2023-12-29,9893
2408,南亞科,12,0,12,元大-大天母,2023-12-29,9893
2409,友達,12,0,12,元大-大天母,2023-12-29,9893
2101,南港,11,0,11,元大-大天母,2023-12-29,9893
0050,元大台灣50,11,1,10,元大-大天母,2023-12-29,9893
3260,威剛,19,8,11,元大-大天母,2023-12-29,9893
2376,技嘉,24,14,10,元大-大天母,2023-12-29,9893
1437,勤益控,12,2,10,元大-大天母,2023-12-29,9893
2850,新產,20,10,10,元大-大天母,2023-12-29,9893
2323,中環,21,11,10,元大-大天母,2023-12-29,9893
00664R,國泰臺灣加權反1,10,0,10,元大-大天母,2023-12-29,9893
2363,矽統,10,0,10,元大-大天母,2023-12-29,9893
5426,振發,25,16,9,元大-大天母,2023-12-29,9893
2038,海光,10,1,9,元大-大天母,2023-12-29,9893
1612,宏泰,10,1,9,元大-大天母,2023-12-29,9893
8068,全達,9,0,9,元大-大天母,2023-12-29,9893
00937B,群益ESG投等債20,515,1,514,元大-大天母,2024-01-02,9893
2891,中信金,204,23,181,元大-大天母,2024-01-02,9893
3231,緯創,159,29,130,元大-大天母,2024-01-02,9893
00633L,富邦上証正2,129,10,119,元大-大天母,2024-01-02,9893
00929,復華台灣科技優息,123,7,116,元大-大天母,2024-01-02,9893
2324,仁寶,115,8,107,元大-大天母,2024-01-02,9893
00919,群益台灣精選高息,111,8,103,元大-大天母,2024-01-02,9893
2449,京元電子,103,2,101,元大-大天母,2024-01-02,9893
6239,力成,100,0,100,元大-大天母,2024-01-02,9893
2344,華邦電,100,17,83,元大-大天母,2024-01-02,9893
6168,宏齊,76,0,76,元大-大天母,2024-01-02,9893
2301,光寶科,75,0,75,元大-大天母,2024-01-02,9893
00751B,元大AAA至A公司債,63,0,63,元大-大天母,2024-01-02,9893
3188,鑫龍騰,60,0,60,元大-大天母,2024-01-02,9893
00720B,元大投資級公司債,51,0,51,元大-大天母,2024-01-02,9893
6116,彩晶,53,3,50,元大-大天母,2024-01-02,9893
00753L,中信中國50正2,50,0,50,元大-大天母,2024-01-02,9893
2362,藍天,91,42,49,元大-大天母,2024-01-02,9893
2845,遠東銀,47,0,47,元大-大天母,2024-01-02,9893
00772B,中信高評級公司債,45,0,45,元大-大天母,2024-01-02,9893
2883,凱基金,44,0,44,元大-大天母,2024-01-02,9893
2303,聯電,55,12,43,元大-大天母,2024-01-02,9893
0056,元大高股息,54,12,42,元大-大天母,2024-01-02,9893
00687B,國泰20年美債,43,5,38,元大-大天母,2024-01-02,9893
2454,聯發科,37,0,37,元大-大天母,2024-01-02,9893
5011,久陽,35,0,35,元大-大天母,2024-01-02,9893
3390,旭軟,41,9,32,元大-大天母,2024-01-02,9893
8446,華研,25,0,25,元大-大天母,2024-01-02,9893
2409,友達,30,5,25,元大-大天母,2024-01-02,9893
6170,統振,33,10,23,元大-大天母,2024-01-02,9893
2605,新興,26,3,23,元大-大天母,2024-01-02,9893
8054,安國,22,1,21,元大-大天母,2024-01-02,9893
00922,國泰台灣領袖50,21,0,21,元大-大天母,2024-01-02,9893
2903,遠百,20,0,20,元大-大天母,2024-01-02,9893
1733,五鼎,31,11,20,元大-大天母,2024-01-02,9893
00679B,元大美債20年,43,24,19,元大-大天母,2024-01-02,9893
2383,台光電,18,0,18,元大-大天母,2024-01-02,9893
00680L,元大美債20正2,18,0,18,元大-大天母,2024-01-02,9893
00935,野村臺灣新科技50,18,0,18,元大-大天母,2024-01-02,9893
00934,中信成長高股息,17,1,16,元大-大天母,2024-01-02,9893
1604,聲寶,15,0,15,元大-大天母,2024-01-02,9893
2607,榮運,16,1,15,元大-大天母,2024-01-02,9893
2382,廣達,20,6,14,元大-大天母,2024-01-02,9893
00931B,統一美債20年,14,0,14,元大-大天母,2024-01-02,9893
1612,宏泰,14,1,13,元大-大天母,2024-01-02,9893
2641,正德,14,2,12,元大-大天母,2024-01-02,9893
00918,大華優利高填息30,11,0,11,元大-大天母,2024-01-02,9893
00878,國泰永續高股息,45,33,12,元大-大天母,2024-01-02,9893
6643,M31,13,2,11,元大-大天母,2024-01-02,9893
2636,台驊控股,12,1,11,元大-大天母,2024-01-02,9893
00929,復華台灣科技優息,254,46,208,元大-大天母,2024-01-03,9893
00680L,元大美債20正2,202,19,183,元大-大天母,2024-01-03,9893
00937B,群益ESG投等債20,188,8,180,元大-大天母,2024-01-03,9893
2618,長榮航,228,97,131,元大-大天母,2024-01-03,9893
2891,中信金,105,1,104,元大-大天母,2024-01-03,9893
00919,群益台灣精選高息,119,18,101,元大-大天母,2024-01-03,9893
2303,聯電,97,0,97,元大-大天母,2024-01-03,9893
2353,宏��,212,117,95,元大-大天母,2024-01-03,9893
3711,日月光投控,85,0,85,元大-大天母,2024-01-03,9893
2031,新光鋼,84,1,83,元大-大天母,2024-01-03,9893
6168,宏齊,67,0,67,元大-大天母,2024-01-03,9893
1809,中釉,60,2,58,元大-大天母,2024-01-03,9893
00878,國泰永續高股息,97,44,53,元大-大天母,2024-01-03,9893
0056,元大高股息,121,73,48,元大-大天母,2024-01-03,9893
6140,訊達,39,3,36,元大-大天母,2024-01-03,9893
5426,振發,34,0,34,元大-大天母,2024-01-03,9893
2301,光寶科,32,0,32,元大-大天母,2024-01-03,9893
2467,志聖,33,2,31,元大-大天母,2024-01-03,9893
3260,威剛,33,3,30,元大-大天母,2024-01-03,9893
2377,微星,32,3,29,元大-大天母,2024-01-03,9893
00720B,元大投資級公司債,29,0,29,元大-大天母,2024-01-03,9893
4939,亞電,43,15,28,元大-大天母,2024-01-03,9893
2449,京元電子,29,3,26,元大-大天母,2024-01-03,9893
2886,兆豐金,26,0,26,元大-大天母,2024-01-03,9893
2344,華邦電,44,19,25,元大-大天母,2024-01-03,9893
2371,大同,35,10,25,元大-大天母,2024-01-03,9893
00934,中信成長高股息,27,3,24,元大-大天母,2024-01-03,9893
6163,華電網,30,6,24,元大-大天母,2024-01-03,9893
3231,緯創,47,24,23,元大-大天母,2024-01-03,9893
2882,國泰金,22,0,22,元大-大天母,2024-01-03,9893
5529,鉅陞,21,0,21,元大-大天母,2024-01-03,9893
00637L,元大滬深300正2,21,0,21,元大-大天母,2024-01-03,9893
00935,野村臺灣新科技50,20,0,20,元大-大天母,2024-01-03,9893
2330,台積電,36,17,19,元大-大天母,2024-01-03,9893
2897,王道銀行,20,1,19,元大-大天母,2024-01-03,9893
00715L,期街口布蘭特正2,21,3,18,元大-大天母,2024-01-03,9893
00900,富邦特選高股息30,22,4,18,元大-大天母,2024-01-03,9893
3006,晶豪科,24,9,15,元大-大天母,2024-01-03,9893
2324,仁寶,25,10,15,元大-大天母,2024-01-03,9893
00882,中信中國高股息,20,5,15,元大-大天母,2024-01-03,9893
2610,華航,20,5,15,元大-大天母,2024-01-03,9893
2408,南亞科,16,1,15,元大-大天母,2024-01-03,9893
2885,元大金,15,1,14,元大-大天母,2024-01-03,9893
00922,國泰台灣領袖50,15,1,14,元大-大天母,2024-01-03,9893
2504,國產,14,0,14,元大-大天母,2024-01-03,9893
2362,藍天,20,7,13,元大-大天母,2024-01-03,9893
2515,中工,15,2,13,元大-大天母,2024-01-03,9893
00891,中信關鍵半導體,12,0,12,元大-大天母,2024-01-03,9893
3338,泰碩,12,0,12,元大-大天母,2024-01-03,9893
2887,台新金,13,2,11,元大-大天母,2024-01-03,9893
00937B,群益ESG投等債20,274,4,270,元大-大天母,2024-01-04,9893
00751B,元大AAA至A公司債,236,0,236,元大-大天母,2024-01-04,9893
2449,京元電子,109,2,107,元大-大天母,2024-01-04,9893
2891,中信金,100,14,86,元大-大天母,2024-01-04,9893
2002,中鋼,88,3,85,元大-大天母,2024-01-04,9893
00720B,元大投資級公司債,79,0,79,元大-大天母,2024-01-04,9893
00929,復華台灣科技優息,80,12,68,元大-大天母,2024-01-04,9893
1809,中釉,68,0,68,元大-大天母,2024-01-04,9893
6207,雷科,53,0,53,元大-大天母,2024-01-04,9893
2031,新光鋼,52,0,52,元大-大天母,2024-01-04,9893
1314,中石化,50,0,50,元大-大天母,2024-01-04,9893
00632R,元大台灣50反1,50,0,50,元大-大天母,2024-01-04,9893
6168,宏齊,50,1,49,元大-大天母,2024-01-04,9893
2344,華邦電,49,1,48,元大-大天母,2024-01-04,9893
6140,訊達,48,7,41,元大-大天母,2024-01-04,9893
00904,新光臺灣半導體30,40,0,40,元大-大天母,2024-01-04,9893
3231,緯創,77,44,33,元大-大天母,2024-01-04,9893
00637L,元大滬深300正2,32,0,32,元大-大天母,2024-01-04,9893
2610,華航,36,5,31,元大-大天母,2024-01-04,9893
3714,富采,30,0,30,元大-大天母,2024-01-04,9893
3706,神達,32,2,30,元大-大天母,2024-01-04,9893
3078,僑威,29,2,27,元大-大天母,2024-01-04,9893
00706L,期元大S＆P日圓正2,57,30,27,元大-大天母,2024-01-04,9893
2486,一詮,41,15,26,元大-大天母,2024-01-04,9893
2882,國泰金,25,0,25,元大-大天母,2024-01-04,9893
2376,技嘉,31,6,25,元大-大天母,2024-01-04,9893
00712,復華富時不動產,26,2,24,元大-大天母,2024-01-04,9893
1305,華夏,20,0,20,元大-大天母,2024-01-04,9893
2331,精英,20,1,19,元大-大天母,2024-01-04,9893
2377,微星,20,1,19,元大-大天母,2024-01-04,9893
00933B,國泰10Y+金融債,18,0,18,元大-大天母,2024-01-04,9893
00935,野村臺灣新科技50,17,0,17,元大-大天母,2024-01-04,9893
00919,群益台灣精選高息,35,18,17,元大-大天母,2024-01-04,9893
3228,金麗科,17,1,16,元大-大天母,2024-01-04,9893
00927,群益半導體收益,16,0,16,元大-大天母,2024-01-04,9893
6799,來頡,17,1,16,元大-大天母,2024-01-04,9893
5529,鉅陞,15,0,15,元大-大天母,2024-01-04,9893
2736,富野,14,0,14,元大-大天母,2024-01-04,9893
3037,欣興,16,3,13,元大-大天母,2024-01-04,9893
1210,大成,13,0,13,元大-大天母,2024-01-04,9893
00934,中信成長高股息,13,0,13,元大-大天母,2024-01-04,9893
5521,工信,113,101,12,元大-大天母,2024-01-04,9893
00930,永豐ESG低碳高息,11,0,11,元大-大天母,2024-01-04,9893
00885,富邦越南,14,3,11,元大-大天母,2024-01-04,9893
6213,聯茂,187,176,11,元大-大天母,2024-01-04,9893
0056,元大高股息,27,17,10,元大-大天母,2024-01-04,9893
2467,志聖,10,0,10,元大-大天母,2024-01-04,9893
2355,敬鵬,13,3,10,元大-大天母,2024-01-04,9893
020039,元大加權N,10,0,10,元大-大天母,2024-01-04,9893
8121,越峰,10,0,10,元大-大天母,2024-01-04,9893
2515,中工,240,0,240,元大-大天母,2024-01-05,9893
00937B,群益ESG投等債20,184,12,172,元大-大天母,2024-01-05,9893
2618,長榮航,187,83,104,元大-大天母,2024-01-05,9893
3380,明泰,74,8,66,元大-大天母,2024-01-05,9893
00751B,元大AAA至A公司債,60,0,60,元大-大天母,2024-01-05,9893
00929,復華台灣科技優息,73,22,51,元大-大天母,2024-01-05,9893
2610,華航,56,6,50,元大-大天母,2024-01-05,9893
2324,仁寶,65,18,47,元大-大天母,2024-01-05,9893
5244,弘凱,45,0,45,元大-大天母,2024-01-05,9893
00919,群益台灣精選高息,44,5,39,元大-大天母,2024-01-05,9893
00720B,元大投資級公司債,54,19,35,元大-大天母,2024-01-05,9893
0056,元大高股息,37,4,33,元大-大天母,2024-01-05,9893
00687B,國泰20年美債,33,2,31,元大-大天母,2024-01-05,9893
8096,擎亞,104,77,27,元大-大天母,2024-01-05,9893
2356,英業達,58,31,27,元大-大天母,2024-01-05,9893
1325,恆大,22,0,22,元大-大天母,2024-01-05,9893
3711,日月光投控,22,0,22,元大-大天母,2024-01-05,9893
00922,國泰台灣領袖50,20,0,20,元大-大天母,2024-01-05,9893
8150,南茂,22,2,20,元大-大天母,2024-01-05,9893
5432,新門,24,5,19,元大-大天母,2024-01-05,9893
3390,旭軟,48,31,17,元大-大天母,2024-01-05,9893
00935,野村臺灣新科技50,17,0,17,元大-大天母,2024-01-05,9893
5515,建國,17,2,15,元大-大天母,2024-01-05,9893
6126,信音,15,0,15,元大-大天母,2024-01-05,9893
2353,宏��,77,63,14,元大-大天母,2024-01-05,9893
00927,群益半導體收益,13,0,13,元大-大天母,2024-01-05,9893
8046,南電,13,0,13,元大-大天母,2024-01-05,9893
00772B,中信高評級公司債,12,0,12,元大-大天母,2024-01-05,9893
5529,鉅陞,12,0,12,元大-大天母,2024-01-05,9893
6282,康舒,14,2,12,元大-大天母,2024-01-05,9893
3481,群創,305,294,11,元大-大天母,2024-01-05,9893
00918,大華優利高填息30,11,0,11,元大-大天母,2024-01-05,9893
2455,全新,16,5,11,元大-大天母,2024-01-05,9893
00850,元大臺灣ESG永續,10,0,10,元大-大天母,2024-01-05,9893
00881,國泰台灣5G+,10,0,10,元大-大天母,2024-01-05,9893
6679,鈺太,10,0,10,元大-大天母,2024-01-05,9893
00725B,國泰投資級公司債,10,0,10,元大-大天母,2024-01-05,9893
4155,訊映,10,0,10,元大-大天母,2024-01-05,9893
6593,台灣銘板,14,4,10,元大-大天母,2024-01-05,9893
2208,台船,10,0,10,元大-大天母,2024-01-05,9893
2395,研華,10,0,10,元大-大天母,2024-01-05,9893
2477,美隆電,10,0,10,元大-大天母,2024-01-05,9893
6550,北極星藥業-KY,10,0,10,元大-大天母,2024-01-05,9893
2637,慧洋-KY,16,6,10,元大-大天母,2024-01-05,9893
00931B,統一美債20年,10,0,10,元大-大天母,2024-01-05,9893
6278,台表科,15,6,9,元大-大天母,2024-01-05,9893
3264,欣銓,9,0,9,元大-大天母,2024-01-05,9893
4737,華廣,8,0,8,元大-大天母,2024-01-05,9893
2388,威盛,11,3,8,元大-大天母,2024-01-05,9893
00757,統一FANG+,8,0,8,元大-大天母,2024-01-05,9893
00665L,富邦�琤肭磪囓�2,302,0,302,元大-大天母,2024-01-08,9893
2883,凱基金,242,70,172,元大-大天母,2024-01-08,9893
2515,中工,157,1,156,元大-大天母,2024-01-08,9893
00751B,元大AAA至A公司債,146,1,145,元大-大天母,2024-01-08,9893
00929,復華台灣科技優息,157,16,141,元大-大天母,2024-01-08,9893
00637L,元大滬深300正2,115,5,110,元大-大天母,2024-01-08,9893
3035,智原,104,7,97,元大-大天母,2024-01-08,9893
2449,京元電子,86,0,86,元大-大天母,2024-01-08,9893
2353,宏��,113,57,56,元大-大天母,2024-01-08,9893
2489,瑞軒,61,6,55,元大-大天母,2024-01-08,9893
2303,聯電,59,4,55,元大-大天母,2024-01-08,9893
3576,聯合再生,51,0,51,元大-大天母,2024-01-08,9893
2915,潤泰全,50,0,50,元大-大天母,2024-01-08,9893
2882,國泰金,47,1,46,元大-大天母,2024-01-08,9893
3231,緯創,85,42,43,元大-大天母,2024-01-08,9893
1805,寶徠,40,0,40,元大-大天母,2024-01-08,9893
00927,群益半導體收益,38,0,38,元大-大天母,2024-01-08,9893
3017,奇鋐,44,6,38,元大-大天母,2024-01-08,9893
2605,新興,36,0,36,元大-大天母,2024-01-08,9893
6770,力積電,50,15,35,元大-大天母,2024-01-08,9893
00753L,中信中國50正2,32,0,32,元大-大天母,2024-01-08,9893
00885,富邦越南,30,0,30,元大-大天母,2024-01-08,9893
6223,旺矽,32,2,30,元大-大天母,2024-01-08,9893
6239,力成,30,0,30,元大-大天母,2024-01-08,9893
00679B,元大美債20年,36,7,29,元大-大天母,2024-01-08,9893
2317,鴻海,32,3,29,元大-大天母,2024-01-08,9893
6263,普萊德,34,6,28,元大-大天母,2024-01-08,9893
3481,群創,52,28,24,元大-大天母,2024-01-08,9893
2409,友達,28,5,23,元大-大天母,2024-01-08,9893
0050,元大台灣50,25,3,22,元大-大天母,2024-01-08,9893
00904,新光臺灣半導體30,20,0,20,元大-大天母,2024-01-08,9893
006206,元大上證50,20,0,20,元大-大天母,2024-01-08,9893
2630,亞航,23,4,19,元大-大天母,2024-01-08,9893
3019,亞光,20,1,19,元大-大天母,2024-01-08,9893
2607,榮運,23,4,19,元大-大天母,2024-01-08,9893
0056,元大高股息,29,11,18,元大-大天母,2024-01-08,9893
4306,炎洲,17,0,17,元大-大天母,2024-01-08,9893
2211,長榮鋼,17,0,17,元大-大天母,2024-01-08,9893
00770,國泰北美科技,16,0,16,元大-大天母,2024-01-08,9893
00772B,中信高評級公司債,20,5,15,元大-大天母,2024-01-08,9893
2885,元大金,17,3,14,元大-大天母,2024-01-08,9893
00931B,統一美債20年,13,0,13,元大-大天母,2024-01-08,9893
00687B,國泰20年美債,11,0,11,元大-大天母,2024-01-08,9893
1815,富喬,11,0,11,元大-大天母,2024-01-08,9893
3094,聯傑,11,0,11,元大-大天母,2024-01-08,9893
2355,敬鵬,11,1,10,元大-大天母,2024-01-08,9893
4979,華星光,14,4,10,元大-大天母,2024-01-08,9893
2477,美隆電,10,0,10,元大-大天母,2024-01-08,9893
4542,科嶠,15,5,10,元大-大天母,2024-01-08,9893
00882,中信中國高股息,10,0,10,元大-大天母,2024-01-08,9893
00715L,期街口布蘭特正2,253,0,253,元大-大天母,2024-01-09,9893
00919,群益台灣精選高息,228,14,214,元大-大天母,2024-01-09,9893
00720B,元大投資級公司債,194,0,194,元大-大天母,2024-01-09,9893
6735,美達科技,133,0,133,元大-大天母,2024-01-09,9893
2031,新光鋼,124,0,124,元大-大天母,2024-01-09,9893
2609,陽明,193,79,114,元大-大天母,2024-01-09,9893
2748,雲品,104,2,102,元大-大天母,2024-01-09,9893
00665L,富邦�琤肭磪囓�2,141,41,100,元大-大天母,2024-01-09,9893
2610,華航,62,0,62,元大-大天母,2024-01-09,9893
0056,元大高股息,65,6,59,元大-大天母,2024-01-09,9893
2515,中工,56,1,55,元大-大天母,2024-01-09,9893
2382,廣達,70,19,51,元大-大天母,2024-01-09,9893
1409,新纖,50,0,50,元大-大天母,2024-01-09,9893
00687B,國泰20年美債,89,40,49,元大-大天母,2024-01-09,9893
6207,雷科,49,0,49,元大-大天母,2024-01-09,9893
2460,建通,45,0,45,元大-大天母,2024-01-09,9893
6168,宏齊,46,1,45,元大-大天母,2024-01-09,9893
4956,光鋐,71,27,44,元大-大天母,2024-01-09,9893
2449,京元電子,61,21,40,元大-大天母,2024-01-09,9893
6276,安鈦克,38,0,38,元大-大天母,2024-01-09,9893
3078,僑威,36,4,32,元大-大天母,2024-01-09,9893
2634,漢翔,32,7,25,元大-大天母,2024-01-09,9893
4737,華廣,24,0,24,元大-大天母,2024-01-09,9893
2618,長榮航,53,29,24,元大-大天母,2024-01-09,9893
2308,台達電,25,1,24,元大-大天母,2024-01-09,9893
2615,萬海,25,3,22,元大-大天母,2024-01-09,9893
00713,元大台灣高息低波,22,1,21,元大-大天母,2024-01-09,9893
2356,英業達,61,40,21,元大-大天母,2024-01-09,9893
3048,益登,20,0,20,元大-大天母,2024-01-09,9893
00679B,元大美債20年,22,2,20,元大-大天母,2024-01-09,9893
5609,中菲行,20,0,20,元大-大天母,2024-01-09,9893
00719B,元大美債1-3,20,0,20,元大-大天母,2024-01-09,9893
2534,宏盛,20,0,20,元大-大天母,2024-01-09,9893
2504,國產,20,0,20,元大-大天母,2024-01-09,9893
3231,緯創,178,159,19,元大-大天母,2024-01-09,9893
3022,威強電,19,0,19,元大-大天母,2024-01-09,9893
8112,至上,21,3,18,元大-大天母,2024-01-09,9893
2002,中鋼,19,1,18,元大-大天母,2024-01-09,9893
2303,聯電,23,6,17,元大-大天母,2024-01-09,9893
6235,華孚,22,6,16,元大-大天母,2024-01-09,9893
2363,矽統,41,25,16,元大-大天母,2024-01-09,9893
3293,鈊象,19,3,16,元大-大天母,2024-01-09,9893
6770,力積電,33,17,16,元大-大天母,2024-01-09,9893
00929,復華台灣科技優息,45,29,16,元大-大天母,2024-01-09,9893
2317,鴻海,22,6,16,元大-大天母,2024-01-09,9893
2101,南港,15,0,15,元大-大天母,2024-01-09,9893
8049,晶采,15,0,15,元大-大天母,2024-01-09,9893
3228,金麗科,15,0,15,元大-大天母,2024-01-09,9893
2736,富野,13,0,13,元大-大天母,2024-01-09,9893
2881,富邦金,14,1,13,元大-大天母,2024-01-09,9893
2891,中信金,103,1,102,元大-大天母,2024-01-10,9893
1301,台塑,104,4,100,元大-大天母,2024-01-10,9893
00665L,富邦�琤肭磪囓�2,250,150,100,元大-大天母,2024-01-10,9893
2603,長榮,91,13,78,元大-大天母,2024-01-10,9893
2356,英業達,101,27,74,元大-大天母,2024-01-10,9893
1101,台泥,70,0,70,元大-大天母,2024-01-10,9893
6735,美達科技,63,0,63,元大-大天母,2024-01-10,9893
00919,群益台灣精選高息,67,4,63,元大-大天母,2024-01-10,9893
2609,陽明,97,39,58,元大-大天母,2024-01-10,9893
00751B,元大AAA至A公司債,55,1,54,元大-大天母,2024-01-10,9893
00922,國泰台灣領袖50,52,0,52,元大-大天母,2024-01-10,9893
2748,雲品,50,0,50,元大-大天母,2024-01-10,9893
2618,長榮航,56,12,44,元大-大天母,2024-01-10,9893
2353,宏��,179,135,44,元大-大天母,2024-01-10,9893
00878,國泰永續高股息,44,0,44,元大-大天母,2024-01-10,9893
2409,友達,39,0,39,元大-大天母,2024-01-10,9893
3048,益登,39,0,39,元大-大天母,2024-01-10,9893
00929,復華台灣科技優息,50,15,35,元大-大天母,2024-01-10,9893
2897,王道銀行,34,0,34,元大-大天母,2024-01-10,9893
3711,日月光投控,30,0,30,元大-大天母,2024-01-10,9893
4737,華廣,29,0,29,元大-大天母,2024-01-10,9893
0056,元大高股息,36,10,26,元大-大天母,2024-01-10,9893
2376,技嘉,24,0,24,元大-大天母,2024-01-10,9893
00679B,元大美債20年,29,6,23,元大-大天母,2024-01-10,9893
5529,鉅陞,23,0,23,元大-大天母,2024-01-10,9893
3056,富華新,23,0,23,元大-大天母,2024-01-10,9893
2324,仁寶,27,4,23,元大-大天母,2024-01-10,9893
3570,大塚,21,0,21,元大-大天母,2024-01-10,9893
00680L,元大美債20正2,21,0,21,元大-大天母,2024-01-10,9893
8081,致新,20,0,20,元大-大天母,2024-01-10,9893
2634,漢翔,36,18,18,元大-大天母,2024-01-10,9893
1609,大亞,18,1,17,元大-大天母,2024-01-10,9893
2515,中工,37,20,17,元大-大天母,2024-01-10,9893
2308,台達電,17,0,17,元大-大天母,2024-01-10,9893
00904,新光臺灣半導體30,28,12,16,元大-大天母,2024-01-10,9893
3017,奇鋐,30,16,14,元大-大天母,2024-01-10,9893
2301,光寶科,18,4,14,元大-大天母,2024-01-10,9893
1612,宏泰,15,1,14,元大-大天母,2024-01-10,9893
5876,上海商銀,22,8,14,元大-大天母,2024-01-10,9893
00770,國泰北美科技,14,0,14,元大-大天母,2024-01-10,9893
00646,元大S＆P500,13,0,13,元大-大天母,2024-01-10,9893
2027,大成鋼,13,0,13,元大-大天母,2024-01-10,9893
0050,元大台灣50,12,0,12,元大-大天母,2024-01-10,9893
2489,瑞軒,12,0,12,元大-大天母,2024-01-10,9893
6770,力積電,14,2,12,元大-大天母,2024-01-10,9893
3481,群創,43,31,12,元大-大天母,2024-01-10,9893
6140,訊達,46,34,12,元大-大天母,2024-01-10,9893
2881,富邦金,11,0,11,元大-大天母,2024-01-10,9893
2401,凌陽,11,0,11,元大-大天母,2024-01-10,9893
5521,工信,14,3,11,元大-大天母,2024-01-10,9893
8034,榮群,226,3,223,元大-大天母,2024-01-11,9893
2883,凱基金,209,31,178,元大-大天母,2024-01-11,9893
00929,復華台灣科技優息,145,22,123,元大-大天母,2024-01-11,9893
2534,宏盛,110,24,86,元大-大天母,2024-01-11,9893
8069,元太,54,0,54,元大-大天母,2024-01-11,9893
00919,群益台灣精選高息,54,0,54,元大-大天母,2024-01-11,9893
2609,陽明,58,5,53,元大-大天母,2024-01-11,9893
00904,新光臺灣半導體30,51,0,51,元大-大天母,2024-01-11,9893
00922,國泰台灣領袖50,47,0,47,元大-大天母,2024-01-11,9893
2610,華航,52,6,46,元大-大天母,2024-01-11,9893
4956,光鋐,98,52,46,元大-大天母,2024-01-11,9893
2344,華邦電,44,1,43,元大-大天母,2024-01-11,9893
6120,達運,166,128,38,元大-大天母,2024-01-11,9893
2329,華泰,63,30,33,元大-大天母,2024-01-11,9893
00881,國泰台灣5G+,32,0,32,元大-大天母,2024-01-11,9893
2409,友達,43,12,31,元大-大天母,2024-01-11,9893
1903,士紙,42,11,31,元大-大天母,2024-01-11,9893
3438,類比科,33,3,30,元大-大天母,2024-01-11,9893
0056,元大高股息,69,41,28,元大-大天母,2024-01-11,9893
00927,群益半導體收益,28,0,28,元大-大天母,2024-01-11,9893
3025,星通,39,13,26,元大-大天母,2024-01-11,9893
3037,欣興,26,1,25,元大-大天母,2024-01-11,9893
00934,中信成長高股息,23,0,23,元大-大天母,2024-01-11,9893
6163,華電網,22,1,21,元大-大天母,2024-01-11,9893
4737,華廣,21,0,21,元大-大天母,2024-01-11,9893
6204,艾華,22,1,21,元大-大天母,2024-01-11,9893
2603,長榮,25,5,20,元大-大天母,2024-01-11,9893
00933B,國泰10Y+金融債,22,2,20,元大-大天母,2024-01-11,9893
00715L,期街口布蘭特正2,20,0,20,元大-大天母,2024-01-11,9893
2399,映泰,20,0,20,元大-大天母,2024-01-11,9893
2408,南亞科,21,1,20,元大-大天母,2024-01-11,9893
3390,旭軟,19,0,19,元大-大天母,2024-01-11,9893
1301,台塑,22,3,19,元大-大天母,2024-01-11,9893
2605,新興,20,2,18,元大-大天母,2024-01-11,9893
5302,太欣,17,0,17,元大-大天母,2024-01-11,9893
2897,王道銀行,17,0,17,元大-大天母,2024-01-11,9893
2449,京元電子,28,12,16,元大-大天母,2024-01-11,9893
00740B,富邦全球投等債,14,0,14,元大-大天母,2024-01-11,9893
6139,亞翔,14,0,14,元大-大天母,2024-01-11,9893
3033,威健,22,9,13,元大-大天母,2024-01-11,9893
3481,群創,137,125,12,元大-大天母,2024-01-11,9893
1504,東元,13,1,12,元大-大天母,2024-01-11,9893
2454,聯發科,13,2,11,元大-大天母,2024-01-11,9893
9914,美利達,11,0,11,元大-大天母,2024-01-11,9893
0050,元大台灣50,13,2,11,元大-大天母,2024-01-11,9893
5469,瀚宇博,11,0,11,元大-大天母,2024-01-11,9893
2308,台達電,11,1,10,元大-大天母,2024-01-11,9893
3227,原相,10,0,10,元大-大天母,2024-01-11,9893
4961,天鈺,10,0,10,元大-大天母,2024-01-11,9893
5009,榮剛,11,1,10,元大-大天母,2024-01-11,9893
1210,大成,201,0,201,元大-大天母,2024-01-12,9893
2353,宏��,195,63,132,元大-大天母,2024-01-12,9893
2883,凱基金,109,0,109,元大-大天母,2024-01-12,9893
6290,良維,101,0,101,元大-大天母,2024-01-12,9893
5284,jpp-KY,100,0,100,元大-大天母,2024-01-12,9893
00929,復華台灣科技優息,98,3,95,元大-大天母,2024-01-12,9893
2371,大同,120,33,87,元大-大天母,2024-01-12,9893
2891,中信金,86,0,86,元大-大天母,2024-01-12,9893
00637L,元大滬深300正2,69,2,67,元大-大天母,2024-01-12,9893
00770,國泰北美科技,40,0,40,元大-大天母,2024-01-12,9893
0056,元大高股息,38,5,33,元大-大天母,2024-01-12,9893
4956,光鋐,55,22,33,元大-大天母,2024-01-12,9893
00919,群益台灣精選高息,33,2,31,元大-大天母,2024-01-12,9893
3706,神達,37,6,31,元大-大天母,2024-01-12,9893
4973,廣穎,30,0,30,元大-大天母,2024-01-12,9893
2382,廣達,83,53,30,元大-大天母,2024-01-12,9893
3017,奇鋐,41,13,28,元大-大天母,2024-01-12,9893
4953,緯軟,29,1,28,元大-大天母,2024-01-12,9893
2881,富邦金,25,0,25,元大-大天母,2024-01-12,9893
00881,國泰台灣5G+,24,0,24,元大-大天母,2024-01-12,9893
00927,群益半導體收益,23,0,23,元大-大天母,2024-01-12,9893
2885,元大金,25,3,22,元大-大天母,2024-01-12,9893
2884,玉山金,22,0,22,元大-大天母,2024-01-12,9893
2477,美隆電,20,0,20,元大-大天母,2024-01-12,9893
6126,信音,20,0,20,元大-大天母,2024-01-12,9893
6120,達運,20,2,18,元大-大天母,2024-01-12,9893
2324,仁寶,23,6,17,元大-大天母,2024-01-12,9893
00904,新光臺灣半導體30,18,2,16,元大-大天母,2024-01-12,9893
2421,建準,17,2,15,元大-大天母,2024-01-12,9893
6163,華電網,14,1,13,元大-大天母,2024-01-12,9893
6770,力積電,12,0,12,元大-大天母,2024-01-12,9893
2449,京元電子,27,15,12,元大-大天母,2024-01-12,9893
6668,中揚光,12,0,12,元大-大天母,2024-01-12,9893
8054,安國,12,0,12,元大-大天母,2024-01-12,9893
4979,華星光,13,2,11,元大-大天母,2024-01-12,9893
6523,達爾膚,11,0,11,元大-大天母,2024-01-12,9893
00679B,元大美債20年,11,0,11,元大-大天母,2024-01-12,9893
3025,星通,43,33,10,元大-大天母,2024-01-12,9893
8150,南茂,31,21,10,元大-大天母,2024-01-12,9893
3515,華擎,10,0,10,元大-大天母,2024-01-12,9893
2897,王道銀行,10,0,10,元大-大天母,2024-01-12,9893
3147,大綜,11,1,10,元大-大天母,2024-01-12,9893
6204,艾華,10,0,10,元大-大天母,2024-01-12,9893
5222,全訊,10,0,10,元大-大天母,2024-01-12,9893
2483,百容,10,0,10,元大-大天母,2024-01-12,9893
1752,南光,10,0,10,元大-大天母,2024-01-12,9893
6596,寬宏藝術,10,0,10,元大-大天母,2024-01-12,9893
4908,前鼎,10,0,10,元大-大天母,2024-01-12,9893
4743,合一,10,0,10,元大-大天母,2024-01-12,9893
3044,健鼎,10,1,9,元大-大天母,2024-01-12,9893
2891,中信金,337,5,332,元大-大天母,2024-01-15,9893
0056,元大高股息,107,6,101,元大-大天母,2024-01-15,9893
00665L,富邦�琤肭磪囓�2,200,100,100,元大-大天母,2024-01-15,9893
2353,宏��,114,28,86,元大-大天母,2024-01-15,9893
3231,緯創,104,38,66,元大-大天母,2024-01-15,9893
2603,長榮,113,50,63,元大-大天母,2024-01-15,9893
2618,長榮航,67,10,57,元大-大天母,2024-01-15,9893
2890,永豐金,56,0,56,元大-大天母,2024-01-15,9893
8085,福華,77,24,53,元大-大天母,2024-01-15,9893
00929,復華台灣科技優息,85,40,45,元大-大天母,2024-01-15,9893
1615,大山,37,1,36,元大-大天母,2024-01-15,9893
1711,永光,34,2,32,元大-大天母,2024-01-15,9893
2409,友達,32,2,30,元大-大天母,2024-01-15,9893
1805,寶徠,28,0,28,元大-大天母,2024-01-15,9893
00902,中信電池及儲能,31,3,28,元大-大天母,2024-01-15,9893
00687B,國泰20年美債,26,0,26,元大-大天母,2024-01-15,9893
5302,太欣,23,0,23,元大-大天母,2024-01-15,9893
2897,王道銀行,22,0,22,元大-大天母,2024-01-15,9893
2377,微星,23,2,21,元大-大天母,2024-01-15,9893
2610,華航,25,4,21,元大-大天母,2024-01-15,9893
3036,文曄,22,1,21,元大-大天母,2024-01-15,9893
6168,宏齊,37,16,21,元大-大天母,2024-01-15,9893
00878,國泰永續高股息,31,11,20,元大-大天母,2024-01-15,9893
6192,巨路,20,0,20,元大-大天母,2024-01-15,9893
2303,聯電,31,11,20,元大-大天母,2024-01-15,9893
00927,群益半導體收益,22,2,20,元大-大天母,2024-01-15,9893
3481,群創,30,12,18,元大-大天母,2024-01-15,9893
8110,華東,18,0,18,元大-大天母,2024-01-15,9893
2883,凱基金,19,1,18,元大-大天母,2024-01-15,9893
2356,英業達,45,27,18,元大-大天母,2024-01-15,9893
00770,國泰北美科技,20,3,17,元大-大天母,2024-01-15,9893
00919,群益台灣精選高息,25,10,15,元大-大天母,2024-01-15,9893
2634,漢翔,26,12,14,元大-大天母,2024-01-15,9893
3149,正達,13,0,13,元大-大天母,2024-01-15,9893
5244,弘凱,13,0,13,元大-大天母,2024-01-15,9893
2882,國泰金,12,0,12,元大-大天母,2024-01-15,9893
00937B,群益ESG投等債20,15,3,12,元大-大天母,2024-01-15,9893
2887,台新金,11,0,11,元大-大天母,2024-01-15,9893
3450,聯鈞,11,0,11,元大-大天母,2024-01-15,9893
1326,台化,11,0,11,元大-大天母,2024-01-15,9893
00881,國泰台灣5G+,16,5,11,元大-大天母,2024-01-15,9893
00850,元大臺灣ESG永續,10,0,10,元大-大天母,2024-01-15,9893
3017,奇鋐,10,0,10,元大-大天母,2024-01-15,9893
3081,聯亞,10,0,10,元大-大天母,2024-01-15,9893
00900,富邦特選高股息30,10,0,10,元大-大天母,2024-01-15,9893
4128,中天,10,0,10,元大-大天母,2024-01-15,9893
2477,美隆電,10,0,10,元大-大天母,2024-01-15,9893
00904,新光臺灣半導體30,11,1,10,元大-大天母,2024-01-15,9893
2208,台船,11,2,9,元大-大天母,2024-01-15,9893
0050,元大台灣50,10,1,9,元大-大天母,2024-01-15,9893
3481,群創,2128,244,1884,元大-大天母,2024-01-16,9893
00665L,富邦�琤肭磪囓�2,300,100,200,元大-大天母,2024-01-16,9893
0056,元大高股息,142,14,128,元大-大天母,2024-01-16,9893
00637L,元大滬深300正2,122,2,120,元大-大天母,2024-01-16,9893
3034,聯詠,116,2,114,元大-大天母,2024-01-16,9893
2002,中鋼,110,3,107,元大-大天母,2024-01-16,9893
2883,凱基金,111,5,106,元大-大天母,2024-01-16,9893
6735,美達科技,95,0,95,元大-大天母,2024-01-16,9893
2534,宏盛,109,30,79,元大-大天母,2024-01-16,9893
2888,新光金,69,0,69,元大-大天母,2024-01-16,9893
2353,宏��,79,15,64,元大-大天母,2024-01-16,9893
00922,國泰台灣領袖50,63,0,63,元大-大天母,2024-01-16,9893
00927,群益半導體收益,58,0,58,元大-大天母,2024-01-16,9893
1711,永光,57,0,57,元大-大天母,2024-01-16,9893
00919,群益台灣精選高息,66,11,55,元大-大天母,2024-01-16,9893
2890,永豐金,55,0,55,元大-大天母,2024-01-16,9893
2603,長榮,68,18,50,元大-大天母,2024-01-16,9893
4714,永捷,50,0,50,元大-大天母,2024-01-16,9893
00878,國泰永續高股息,45,4,41,元大-大天母,2024-01-16,9893
1326,台化,40,1,39,元大-大天母,2024-01-16,9893
2486,一詮,47,11,36,元大-大天母,2024-01-16,9893
1809,中釉,35,0,35,元大-大天母,2024-01-16,9893
1609,大亞,38,3,35,元大-大天母,2024-01-16,9893
2618,長榮航,41,8,33,元大-大天母,2024-01-16,9893
3483,力致,27,0,27,元大-大天母,2024-01-16,9893
2882,國泰金,25,0,25,元大-大天母,2024-01-16,9893
3024,憶聲,25,0,25,元大-大天母,2024-01-16,9893
00881,國泰台灣5G+,25,2,23,元大-大天母,2024-01-16,9893
6799,來頡,33,10,23,元大-大天母,2024-01-16,9893
2344,華邦電,23,0,23,元大-大天母,2024-01-16,9893
2881,富邦金,22,0,22,元大-大天母,2024-01-16,9893
3287,廣寰科,56,34,22,元大-大天母,2024-01-16,9893
1524,耿鼎,23,1,22,元大-大天母,2024-01-16,9893
2609,陽明,58,36,22,元大-大天母,2024-01-16,9893
00902,中信電池及儲能,24,3,21,元大-大天母,2024-01-16,9893
3711,日月光投控,21,1,20,元大-大天母,2024-01-16,9893
5284,jpp-KY,20,0,20,元大-大天母,2024-01-16,9893
00888,永豐台灣ESG,20,0,20,元大-大天母,2024-01-16,9893
5272,笙科,20,0,20,元大-大天母,2024-01-16,9893
6168,宏齊,20,0,20,元大-大天母,2024-01-16,9893
2892,第一金,21,2,19,元大-大天母,2024-01-16,9893
2886,兆豐金,20,1,19,元大-大天母,2024-01-16,9893
00770,國泰北美科技,23,4,19,元大-大天母,2024-01-16,9893
2504,國產,18,0,18,元大-大天母,2024-01-16,9893
2897,王道銀行,18,0,18,元大-大天母,2024-01-16,9893
6901,鑽石投資,17,0,17,元大-大天母,2024-01-16,9893
2732,六角,20,3,17,元大-大天母,2024-01-16,9893
1301,台塑,17,0,17,元大-大天母,2024-01-16,9893
6505,台塑化,16,0,16,元大-大天母,2024-01-16,9893
6116,彩晶,16,0,16,元大-大天母,2024-01-16,9893
00929,復華台灣科技優息,281,7,274,元大-大天母,2024-01-17,9893
00665L,富邦�琤肭磪囓�2,300,100,200,元大-大天母,2024-01-17,9893
0056,元大高股息,186,20,166,元大-大天母,2024-01-17,9893
2888,新光金,140,0,140,元大-大天母,2024-01-17,9893
2371,大同,158,20,138,元大-大天母,2024-01-17,9893
00919,群益台灣精選高息,134,1,133,元大-大天母,2024-01-17,9893
00679B,元大美債20年,123,2,121,元大-大天母,2024-01-17,9893
00772B,中信高評級公司債,100,0,100,元大-大天母,2024-01-17,9893
2303,聯電,148,51,97,元大-大天母,2024-01-17,9893
00680L,元大美債20正2,106,10,96,元大-大天母,2024-01-17,9893
1101,台泥,96,2,94,元大-大天母,2024-01-17,9893
0050,元大台灣50,87,3,84,元大-大天母,2024-01-17,9893
00937B,群益ESG投等債20,80,6,74,元大-大天母,2024-01-17,9893
00922,國泰台灣領袖50,73,0,73,元大-大天母,2024-01-17,9893
00882,中信中國高股息,68,0,68,元大-大天母,2024-01-17,9893
00706L,期元大S＆P日圓正2,65,0,65,元大-大天母,2024-01-17,9893
2344,華邦電,71,11,60,元大-大天母,2024-01-17,9893
00878,國泰永續高股息,75,16,59,元大-大天母,2024-01-17,9893
8085,福華,54,0,54,元大-大天母,2024-01-17,9893
2887,台新金,55,1,54,元大-大天母,2024-01-17,9893
2486,一詮,91,38,53,元大-大天母,2024-01-17,9893
2892,第一金,57,4,53,元大-大天母,2024-01-17,9893
4973,廣穎,50,0,50,元大-大天母,2024-01-17,9893
2312,金寶,43,0,43,元大-大天母,2024-01-17,9893
2610,華航,40,0,40,元大-大天母,2024-01-17,9893
00720B,元大投資級公司債,39,0,39,元大-大天母,2024-01-17,9893
3048,益登,39,0,39,元大-大天母,2024-01-17,9893
6213,聯茂,206,168,38,元大-大天母,2024-01-17,9893
6735,美達科技,35,0,35,元大-大天母,2024-01-17,9893
2883,凱基金,45,11,34,元大-大天母,2024-01-17,9893
00881,國泰台灣5G+,30,0,30,元大-大天母,2024-01-17,9893
3149,正達,31,3,28,元大-大天母,2024-01-17,9893
2308,台達電,33,7,26,元大-大天母,2024-01-17,9893
2882,國泰金,23,0,23,元大-大天母,2024-01-17,9893
2609,陽明,49,27,22,元大-大天母,2024-01-17,9893
00902,中信電池及儲能,22,0,22,元大-大天母,2024-01-17,9893
2376,技嘉,23,2,21,元大-大天母,2024-01-17,9893
2884,玉山金,22,1,21,元大-大天母,2024-01-17,9893
6770,力積電,42,21,21,元大-大天母,2024-01-17,9893
2364,倫飛,21,0,21,元大-大天母,2024-01-17,9893
2002,中鋼,31,10,21,元大-大天母,2024-01-17,9893
3059,華晶科,20,0,20,元大-大天母,2024-01-17,9893
2897,王道銀行,20,0,20,元大-大天母,2024-01-17,9893
3532,台勝科,20,0,20,元大-大天母,2024-01-17,9893
2356,英業達,28,8,20,元大-大天母,2024-01-17,9893
6282,康舒,20,1,19,元大-大天母,2024-01-17,9893
6695,芯鼎,39,21,18,元大-大天母,2024-01-17,9893
2886,兆豐金,28,11,17,元大-大天母,2024-01-17,9893
6523,達爾膚,17,0,17,元大-大天母,2024-01-17,9893
1795,美時,24,7,17,元大-大天母,2024-01-17,9893
2801,彰銀,400,0,400,元大-大天母,2024-01-18,9893
00637L,元大滬深300正2,341,12,329,元大-大天母,2024-01-18,9893
4960,誠美材,191,2,189,元大-大天母,2024-01-18,9893
00929,復華台灣科技優息,164,12,152,元大-大天母,2024-01-18,9893
2332,友訊,146,3,143,元大-大天母,2024-01-18,9893
00687B,國泰20年美債,91,0,91,元大-大天母,2024-01-18,9893
6120,達運,70,10,60,元大-大天母,2024-01-18,9893
2303,聯電,69,12,57,元大-大天母,2024-01-18,9893
00919,群益台灣精選高息,73,20,53,元大-大天母,2024-01-18,9893
00902,中信電池及儲能,50,0,50,元大-大天母,2024-01-18,9893
0056,元大高股息,55,5,50,元大-大天母,2024-01-18,9893
5426,振發,112,68,44,元大-大天母,2024-01-18,9893
2886,兆豐金,46,2,44,元大-大天母,2024-01-18,9893
00753L,中信中國50正2,42,0,42,元大-大天母,2024-01-18,9893
2618,長榮航,56,15,41,元大-大天母,2024-01-18,9893
8043,蜜望實,40,0,40,元大-大天母,2024-01-18,9893
00882,中信中國高股息,38,3,35,元大-大天母,2024-01-18,9893
6215,和椿,35,0,35,元大-大天母,2024-01-18,9893
2324,仁寶,47,15,32,元大-大天母,2024-01-18,9893
6290,良維,33,6,27,元大-大天母,2024-01-18,9893
3029,零壹,75,48,27,元大-大天母,2024-01-18,9893
3047,訊舟,32,8,24,元大-大天母,2024-01-18,9893
1101,台泥,22,1,21,元大-大天母,2024-01-18,9893
8112,至上,24,4,20,元大-大天母,2024-01-18,9893
6432,今展科,20,0,20,元大-大天母,2024-01-18,9893
00931B,統一美債20年,17,0,17,元大-大天母,2024-01-18,9893
6531,愛普*,32,17,15,元大-大天母,2024-01-18,9893
5388,中磊,15,0,15,元大-大天母,2024-01-18,9893
00904,新光臺灣半導體30,14,0,14,元大-大天母,2024-01-18,9893
2882,國泰金,17,4,13,元大-大天母,2024-01-18,9893
2892,第一金,17,4,13,元大-大天母,2024-01-18,9893
4909,新復興,22,9,13,元大-大天母,2024-01-18,9893
2543,皇昌,12,0,12,元大-大天母,2024-01-18,9893
00680L,元大美債20正2,12,0,12,元大-大天母,2024-01-18,9893
00850,元大臺灣ESG永續,12,0,12,元大-大天母,2024-01-18,9893
00720B,元大投資級公司債,11,0,11,元大-大天母,2024-01-18,9893
3032,偉訓,11,0,11,元大-大天母,2024-01-18,9893
00706L,期元大S＆P日圓正2,11,0,11,元大-大天母,2024-01-18,9893
2897,王道銀行,11,0,11,元大-大天母,2024-01-18,9893
4973,廣穎,11,0,11,元大-大天母,2024-01-18,9893
6533,晶心科,15,5,10,元大-大天母,2024-01-18,9893
3034,聯詠,10,0,10,元大-大天母,2024-01-18,9893
1528,恩德,15,5,10,元大-大天母,2024-01-18,9893
6161,捷波,10,0,10,元大-大天母,2024-01-18,9893
00642U,期元大S＆P石油,10,0,10,元大-大天母,2024-01-18,9893
2535,達欣工,10,0,10,元大-大天母,2024-01-18,9893
3188,鑫龍騰,10,0,10,元大-大天母,2024-01-18,9893
4953,緯軟,10,0,10,元大-大天母,2024-01-18,9893
6770,力積電,10,0,10,元大-大天母,2024-01-18,9893
4155,訊映,10,0,10,元大-大天母,2024-01-18,9893
3481,群創,1129,216,913,元大-大天母,2024-01-19,9893
00665L,富邦�琤肭磪囓�2,300,0,300,元大-大天母,2024-01-19,9893
00679B,元大美債20年,186,0,186,元大-大天母,2024-01-19,9893
00680L,元大美債20正2,177,0,177,元大-大天母,2024-01-19,9893
6233,旺玖,152,22,130,元大-大天母,2024-01-19,9893
00772B,中信高評級公司債,120,5,115,元大-大天母,2024-01-19,9893
00637L,元大滬深300正2,147,38,109,元大-大天母,2024-01-19,9893
5351,鈺創,106,6,100,元大-大天母,2024-01-19,9893
2387,精元,97,0,97,元大-大天母,2024-01-19,9893
00929,復華台灣科技優息,77,1,76,元大-大天母,2024-01-19,9893
00919,群益台灣精選高息,70,0,70,元大-大天母,2024-01-19,9893
6120,達運,90,23,67,元大-大天母,2024-01-19,9893
2303,聯電,88,27,61,元大-大天母,2024-01-19,9893
00751B,元大AAA至A公司債,55,0,55,元大-大天母,2024-01-19,9893
2353,宏��,87,38,49,元大-大天母,2024-01-19,9893
3033,威健,58,13,45,元大-大天母,2024-01-19,9893
00720B,元大投資級公司債,40,1,39,元大-大天母,2024-01-19,9893
00931B,統一美債20年,35,0,35,元大-大天母,2024-01-19,9893
6125,廣運,34,1,33,元大-大天母,2024-01-19,9893
00905,FT臺灣Smart,43,11,32,元大-大天母,2024-01-19,9893
3149,正達,30,0,30,元大-大天母,2024-01-19,9893
3048,益登,30,0,30,元大-大天母,2024-01-19,9893
00687B,國泰20年美債,27,0,27,元大-大天母,2024-01-19,9893
2883,凱基金,29,2,27,元大-大天母,2024-01-19,9893
2002,中鋼,26,0,26,元大-大天母,2024-01-19,9893
3583,辛耘,26,1,25,元大-大天母,2024-01-19,9893
2888,新光金,30,7,23,元大-大天母,2024-01-19,9893
2485,兆赫,22,0,22,元大-大天母,2024-01-19,9893
2618,長榮航,23,2,21,元大-大天母,2024-01-19,9893
00882,中信中國高股息,23,3,20,元大-大天母,2024-01-19,9893
5244,弘凱,20,0,20,元大-大天母,2024-01-19,9893
00904,新光臺灣半導體30,21,1,20,元大-大天母,2024-01-19,9893
5432,新門,20,1,19,元大-大天母,2024-01-19,9893
5880,合庫金,18,0,18,元大-大天母,2024-01-19,9893
2610,華航,17,0,17,元大-大天母,2024-01-19,9893
2409,友達,41,26,15,元大-大天母,2024-01-19,9893
2615,萬海,19,4,15,元大-大天母,2024-01-19,9893
2515,中工,15,0,15,元大-大天母,2024-01-19,9893
2603,長榮,17,3,14,元大-大天母,2024-01-19,9893
2534,宏盛,13,0,13,元大-大天母,2024-01-19,9893
2609,陽明,37,25,12,元大-大天母,2024-01-19,9893
3036,文曄,25,13,12,元大-大天母,2024-01-19,9893
2356,英業達,83,72,11,元大-大天母,2024-01-19,9893
3010,華立,11,0,11,元大-大天母,2024-01-19,9893
1101,台泥,13,2,11,元大-大天母,2024-01-19,9893
2230,泰茂,12,1,11,元大-大天母,2024-01-19,9893
00918,大華優利高填息30,25,15,10,元大-大天母,2024-01-19,9893
3287,廣寰科,51,41,10,元大-大天母,2024-01-19,9893
00933B,國泰10Y+金融債,10,0,10,元大-大天母,2024-01-19,9893
5347,世界,10,0,10,元大-大天母,2024-01-19,9893
6120,達運,140,2,138,元大-大天母,2024-01-22,9893
3231,緯創,376,242,134,元大-大天母,2024-01-22,9893
00751B,元大AAA至A公司債,102,10,92,元大-大天母,2024-01-22,9893
2883,凱基金,74,2,72,元大-大天母,2024-01-22,9893
00937B,群益ESG投等債20,69,3,66,元大-大天母,2024-01-22,9893
00933B,國泰10Y+金融債,63,0,63,元大-大天母,2024-01-22,9893
00915,凱基優選高股息30,51,1,50,元大-大天母,2024-01-22,9893
00680L,元大美債20正2,47,1,46,元大-大天母,2024-01-22,9893
9105,泰金寶-DR,45,0,45,元大-大天母,2024-01-22,9893
00679B,元大美債20年,39,1,38,元大-大天母,2024-01-22,9893
2329,華泰,68,30,38,元大-大天母,2024-01-22,9893
00902,中信電池及儲能,34,0,34,元大-大天母,2024-01-22,9893
00882,中信中國高股息,37,6,31,元大-大天母,2024-01-22,9893
3694,海華,25,0,25,元大-大天母,2024-01-22,9893
2884,玉山金,24,0,24,元大-大天母,2024-01-22,9893
6668,中揚光,24,0,24,元大-大天母,2024-01-22,9893
00904,新光臺灣半導體30,23,0,23,元大-大天母,2024-01-22,9893
6285,啟��,22,2,20,元大-大天母,2024-01-22,9893
3450,聯鈞,20,0,20,元大-大天母,2024-01-22,9893
00688L,國泰20年美債正2,20,0,20,元大-大天母,2024-01-22,9893
1795,美時,20,1,19,元大-大天母,2024-01-22,9893
6292,迅德,21,2,19,元大-大天母,2024-01-22,9893
1608,華榮,17,0,17,元大-大天母,2024-01-22,9893
2409,友達,20,3,17,元大-大天母,2024-01-22,9893
2609,陽明,32,15,17,元大-大天母,2024-01-22,9893
00770,國泰北美科技,16,0,16,元大-大天母,2024-01-22,9893
6187,萬潤,27,11,16,元大-大天母,2024-01-22,9893
00919,群益台灣精選高息,16,1,15,元大-大天母,2024-01-22,9893
8034,榮群,21,6,15,元大-大天母,2024-01-22,9893
2845,遠東銀,15,0,15,元大-大天母,2024-01-22,9893
2701,萬企,15,0,15,元大-大天母,2024-01-22,9893
1326,台化,15,0,15,元大-大天母,2024-01-22,9893
3037,欣興,20,7,13,元大-大天母,2024-01-22,9893
2316,楠梓電,15,2,13,元大-大天母,2024-01-22,9893
2332,友訊,13,0,13,元大-大天母,2024-01-22,9893
2887,台新金,36,23,13,元大-大天母,2024-01-22,9893
2301,光寶科,17,5,12,元大-大天母,2024-01-22,9893
2359,所羅門,23,11,12,元大-大天母,2024-01-22,9893
2891,中信金,12,0,12,元大-大天母,2024-01-22,9893
1528,恩德,12,0,12,元大-大天母,2024-01-22,9893
6146,耕興,11,0,11,元大-大天母,2024-01-22,9893
00850,元大臺灣ESG永續,11,0,11,元大-大天母,2024-01-22,9893
2706,第一店,10,0,10,元大-大天母,2024-01-22,9893
4737,華廣,10,0,10,元大-大天母,2024-01-22,9893
1711,永光,10,0,10,元大-大天母,2024-01-22,9893
2401,凌陽,10,0,10,元大-大天母,2024-01-22,9893
2308,台達電,16,6,10,元大-大天母,2024-01-22,9893
3483,力致,11,1,10,元大-大天母,2024-01-22,9893
3265,台星科,19,10,9,元大-大天母,2024-01-22,9893
6278,台表科,8,0,8,元大-大天母,2024-01-22,9893
00937B,群益ESG投等債20,500,0,500,元大-大天母,2024-01-23,9893
5398,慕康生醫,350,0,350,元大-大天母,2024-01-23,9893
2891,中信金,118,0,118,元大-大天母,2024-01-23,9893
00632R,元大台灣50反1,82,0,82,元大-大天母,2024-01-23,9893
5426,振發,173,92,81,元大-大天母,2024-01-23,9893
3481,群創,147,80,67,元大-大天母,2024-01-23,9893
2618,長榮航,79,13,66,元大-大天母,2024-01-23,9893
6120,達運,50,0,50,元大-大天母,2024-01-23,9893
8049,晶采,41,0,41,元大-大天母,2024-01-23,9893
2377,微星,43,3,40,元大-大天母,2024-01-23,9893
00679B,元大美債20年,39,1,38,元大-大天母,2024-01-23,9893
1711,永光,40,2,38,元大-大天母,2024-01-23,9893
00929,復華台灣科技優息,39,3,36,元大-大天母,2024-01-23,9893
2460,建通,39,4,35,元大-大天母,2024-01-23,9893
00900,富邦特選高股息30,33,0,33,元大-大天母,2024-01-23,9893
2344,華邦電,61,29,32,元大-大天母,2024-01-23,9893
00712,復華富時不動產,31,1,30,元大-大天母,2024-01-23,9893
6124,業強,31,1,30,元大-大天母,2024-01-23,9893
1409,新纖,30,1,29,元大-大天母,2024-01-23,9893
3047,訊舟,28,1,27,元大-大天母,2024-01-23,9893
2101,南港,25,0,25,元大-大天母,2024-01-23,9893
00933B,國泰10Y+金融債,71,50,21,元大-大天母,2024-01-23,9893
6425,易發,26,6,20,元大-大天母,2024-01-23,9893
2884,玉山金,17,0,17,元大-大天母,2024-01-23,9893
2449,京元電子,19,2,17,元大-大天母,2024-01-23,9893
6179,亞通,17,0,17,元大-大天母,2024-01-23,9893
00919,群益台灣精選高息,19,3,16,元大-大天母,2024-01-23,9893
2886,兆豐金,16,0,16,元大-大天母,2024-01-23,9893
3363,上詮,16,0,16,元大-大天母,2024-01-23,9893
2636,台驊控股,16,0,16,元大-大天母,2024-01-23,9893
2609,陽明,29,14,15,元大-大天母,2024-01-23,9893
3483,力致,15,1,14,元大-大天母,2024-01-23,9893
8112,至上,14,0,14,元大-大天母,2024-01-23,9893
3545,敦泰,18,5,13,元大-大天母,2024-01-23,9893
3189,景碩,14,2,12,元大-大天母,2024-01-23,9893
6146,耕興,12,0,12,元大-大天母,2024-01-23,9893
00680L,元大美債20正2,15,3,12,元大-大天母,2024-01-23,9893
4735,豪展,12,0,12,元大-大天母,2024-01-23,9893
6443,元晶,12,0,12,元大-大天母,2024-01-23,9893
5880,合庫金,12,0,12,元大-大天母,2024-01-23,9893
00770,國泰北美科技,11,0,11,元大-大天母,2024-01-23,9893
2332,友訊,15,4,11,元大-大天母,2024-01-23,9893
2603,長榮,22,11,11,元大-大天母,2024-01-23,9893
2801,彰銀,10,0,10,元大-大天母,2024-01-23,9893
4919,新唐,11,1,10,元大-大天母,2024-01-23,9893
00738U,期元大道瓊白銀,10,0,10,元大-大天母,2024-01-23,9893
9105,泰金寶-DR,10,0,10,元大-大天母,2024-01-23,9893
6112,邁達特,11,1,10,元大-大天母,2024-01-23,9893
1517,利奇,10,0,10,元大-大天母,2024-01-23,9893
1227,佳格,10,0,10,元大-大天母,2024-01-23,9893
00633L,富邦上証正2,2013,0,2013,元大-大天母,2024-01-24,9893
5398,慕康生醫,249,10,239,元大-大天母,2024-01-24,9893
00637L,元大滬深300正2,168,27,141,元大-大天母,2024-01-24,9893
00632R,元大台灣50反1,140,0,140,元大-大天母,2024-01-24,9893
2421,建準,109,6,103,元大-大天母,2024-01-24,9893
2498,宏達電,98,0,98,元大-大天母,2024-01-24,9893
3047,訊舟,114,18,96,元大-大天母,2024-01-24,9893
00937B,群益ESG投等債20,94,0,94,元大-大天母,2024-01-24,9893
00688L,國泰20年美債正2,59,0,59,元大-大天母,2024-01-24,9893
4906,正文,57,0,57,元大-大天母,2024-01-24,9893
6799,來頡,56,3,53,元大-大天母,2024-01-24,9893
00680L,元大美債20正2,52,0,52,元大-大天母,2024-01-24,9893
00720B,元大投資級公司債,48,0,48,元大-大天母,2024-01-24,9893
3033,威健,74,28,46,元大-大天母,2024-01-24,9893
3324,雙鴻,42,0,42,元大-大天母,2024-01-24,9893
4938,和碩,49,11,38,元大-大天母,2024-01-24,9893
4129,聯合,77,41,36,元大-大天母,2024-01-24,9893
3231,緯創,71,37,34,元大-大天母,2024-01-24,9893
8112,至上,33,0,33,元大-大天母,2024-01-24,9893
2476,鉅祥,32,1,31,元大-大天母,2024-01-24,9893
5426,振發,52,21,31,元大-大天母,2024-01-24,9893
6770,力積電,39,11,28,元大-大天母,2024-01-24,9893
2884,玉山金,27,0,27,元大-大天母,2024-01-24,9893
00878,國泰永續高股息,29,5,24,元大-大天母,2024-01-24,9893
5244,弘凱,23,0,23,元大-大天母,2024-01-24,9893
6126,信音,22,1,21,元大-大天母,2024-01-24,9893
4746,台耀,26,5,21,元大-大天母,2024-01-24,9893
2344,華邦電,44,23,21,元大-大天母,2024-01-24,9893
00772B,中信高評級公司債,21,1,20,元大-大天母,2024-01-24,9893
2454,聯發科,23,3,20,元大-大天母,2024-01-24,9893
6204,艾華,22,3,19,元大-大天母,2024-01-24,9893
2376,技嘉,18,0,18,元大-大天母,2024-01-24,9893
00933B,國泰10Y+金融債,18,0,18,元大-大天母,2024-01-24,9893
00687B,國泰20年美債,19,3,16,元大-大天母,2024-01-24,9893
6168,宏齊,16,0,16,元大-大天母,2024-01-24,9893
00929,復華台灣科技優息,38,23,15,元大-大天母,2024-01-24,9893
6116,彩晶,15,0,15,元大-大天母,2024-01-24,9893
2324,仁寶,29,15,14,元大-大天母,2024-01-24,9893
2101,南港,13,0,13,元大-大天母,2024-01-24,9893
1809,中釉,22,10,12,元大-大天母,2024-01-24,9893
6111,大宇資,32,21,11,元大-大天母,2024-01-24,9893
2457,飛宏,11,0,11,元大-大天母,2024-01-24,9893
00679B,元大美債20年,12,2,10,元大-大天母,2024-01-24,9893
3483,力致,21,11,10,元大-大天母,2024-01-24,9893
1444,力麗,10,0,10,元大-大天母,2024-01-24,9893
00706L,期元大S＆P日圓正2,10,0,10,元大-大天母,2024-01-24,9893
2374,佳能,13,4,9,元大-大天母,2024-01-24,9893
2377,微星,10,1,9,元大-大天母,2024-01-24,9893
3490,單井,10,1,9,元大-大天母,2024-01-24,9893
2356,英業達,44,35,9,元大-大天母,2024-01-24,9893
00633L,富邦上証正2,3102,7,3095,元大-大天母,2024-01-25,9893
00632R,元大台灣50反1,100,0,100,元大-大天母,2024-01-25,9893
2421,建準,106,8,98,元大-大天母,2024-01-25,9893
2365,昆盈,108,10,98,元大-大天母,2024-01-25,9893
2449,京元電子,93,5,88,元大-大天母,2024-01-25,9893
00679B,元大美債20年,78,5,73,元大-大天母,2024-01-25,9893
00937B,群益ESG投等債20,71,0,71,元大-大天母,2024-01-25,9893
2603,長榮,68,5,63,元大-大天母,2024-01-25,9893
00688L,國泰20年美債正2,62,0,62,元大-大天母,2024-01-25,9893
00680L,元大美債20正2,60,0,60,元大-大天母,2024-01-25,9893
00637L,元大滬深300正2,184,132,52,元大-大天母,2024-01-25,9893
5488,松普,47,0,47,元大-大天母,2024-01-25,9893
00687B,國泰20年美債,50,10,40,元大-大天母,2024-01-25,9893
2353,宏��,91,51,40,元大-大天母,2024-01-25,9893
1524,耿鼎,47,7,40,元大-大天母,2024-01-25,9893
2618,長榮航,38,0,38,元大-大天母,2024-01-25,9893
2308,台達電,37,0,37,元大-大天母,2024-01-25,9893
00720B,元大投資級公司債,35,0,35,元大-大天母,2024-01-25,9893
6152,百一,35,0,35,元大-大天母,2024-01-25,9893
6191,精成科,35,0,35,元大-大天母,2024-01-25,9893
6263,普萊德,35,2,33,元大-大天母,2024-01-25,9893
8105,凌巨,32,0,32,元大-大天母,2024-01-25,9893
1609,大亞,27,0,27,元大-大天母,2024-01-25,9893
8936,國統,43,17,26,元大-大天母,2024-01-25,9893
00751B,元大AAA至A公司債,23,0,23,元大-大天母,2024-01-25,9893
6805,富世達,22,0,22,元大-大天母,2024-01-25,9893
8049,晶采,22,0,22,元大-大天母,2024-01-25,9893
3706,神達,28,7,21,元大-大天母,2024-01-25,9893
00753L,中信中國50正2,20,0,20,元大-大天母,2024-01-25,9893
2855,統一證,20,0,20,元大-大天母,2024-01-25,9893
1217,愛之味,20,0,20,元大-大天母,2024-01-25,9893
4938,和碩,19,0,19,元大-大天母,2024-01-25,9893
00882,中信中國高股息,29,10,19,元大-大天母,2024-01-25,9893
8147,正淩,20,1,19,元大-大天母,2024-01-25,9893
3231,緯創,93,74,19,元大-大天母,2024-01-25,9893
5478,智冠,21,5,16,元大-大天母,2024-01-25,9893
2313,華通,34,18,16,元大-大天母,2024-01-25,9893
8926,台汽電,15,0,15,元大-大天母,2024-01-25,9893
2485,兆赫,15,0,15,元大-大天母,2024-01-25,9893
1795,美時,19,4,15,元大-大天母,2024-01-25,9893
2356,英業達,45,31,14,元大-大天母,2024-01-25,9893
8112,至上,14,0,14,元大-大天母,2024-01-25,9893
2745,五福,13,0,13,元大-大天母,2024-01-25,9893
3276,宇環,13,0,13,元大-大天母,2024-01-25,9893
6695,芯鼎,16,3,13,元大-大天母,2024-01-25,9893
2634,漢翔,13,0,13,元大-大天母,2024-01-25,9893
00770,國泰北美科技,13,0,13,元大-大天母,2024-01-25,9893
4162,智擎,14,1,13,元大-大天母,2024-01-25,9893
2457,飛宏,15,2,13,元大-大天母,2024-01-25,9893
00919,群益台灣精選高息,14,2,12,元大-大天母,2024-01-25,9893
00665L,富邦�琤肭磪囓�2,280,0,280,元大-大天母,2024-01-26,9893
00637L,元大滬深300正2,262,5,257,元大-大天母,2024-01-26,9893
2303,聯電,155,8,147,元大-大天母,2024-01-26,9893
00878,國泰永續高股息,102,23,79,元大-大天母,2024-01-26,9893
2356,英業達,98,27,71,元大-大天母,2024-01-26,9893
2353,宏��,88,24,64,元大-大天母,2024-01-26,9893
00632R,元大台灣50反1,60,0,60,元大-大天母,2024-01-26,9893
6270,倍微,72,14,58,元大-大天母,2024-01-26,9893
2324,仁寶,84,28,56,元大-大天母,2024-01-26,9893
6239,力成,55,1,54,元大-大天母,2024-01-26,9893
5488,松普,50,0,50,元大-大天母,2024-01-26,9893
8085,福華,51,1,50,元大-大天母,2024-01-26,9893
00753L,中信中國50正2,50,0,50,元大-大天母,2024-01-26,9893
3231,緯創,84,35,49,元大-大天母,2024-01-26,9893
00919,群益台灣精選高息,53,7,46,元大-大天母,2024-01-26,9893
0056,元大高股息,53,10,43,元大-大天母,2024-01-26,9893
2498,宏達電,40,0,40,元大-大天母,2024-01-26,9893
3438,類比科,40,0,40,元大-大天母,2024-01-26,9893
3535,晶彩科,41,3,38,元大-大天母,2024-01-26,9893
2618,長榮航,62,26,36,元大-大天母,2024-01-26,9893
2377,微星,36,1,35,元大-大天母,2024-01-26,9893
2376,技嘉,38,7,31,元大-大天母,2024-01-26,9893
00687B,國泰20年美債,35,10,25,元大-大天母,2024-01-26,9893
2031,新光鋼,24,0,24,元大-大天母,2024-01-26,9893
2472,立隆電,22,0,22,元大-大天母,2024-01-26,9893
00680L,元大美債20正2,22,0,22,元大-大天母,2024-01-26,9893
5426,振發,69,47,22,元大-大天母,2024-01-26,9893
3312,弘憶股,48,27,21,元大-大天母,2024-01-26,9893
00929,復華台灣科技優息,22,1,21,元大-大天母,2024-01-26,9893
00882,中信中國高股息,26,6,20,元大-大天母,2024-01-26,9893
2382,廣達,34,15,19,元大-大天母,2024-01-26,9893
3706,神達,27,8,19,元大-大天母,2024-01-26,9893
00922,國泰台灣領袖50,18,0,18,元大-大天母,2024-01-26,9893
6168,宏齊,18,0,18,元大-大天母,2024-01-26,9893
1301,台塑,22,5,17,元大-大天母,2024-01-26,9893
00679B,元大美債20年,17,1,16,元大-大天母,2024-01-26,9893
3661,世芯-KY,22,6,16,元大-大天母,2024-01-26,9893
00937B,群益ESG投等債20,15,2,13,元大-大天母,2024-01-26,9893
00881,國泰台灣5G+,13,0,13,元大-大天母,2024-01-26,9893
3665,貿聯-KY,12,0,12,元大-大天母,2024-01-26,9893
8049,晶采,12,0,12,元大-大天母,2024-01-26,9893
1539,巨庭,11,0,11,元大-大天母,2024-01-26,9893
6770,力積電,11,0,11,元大-大天母,2024-01-26,9893
6263,普萊德,12,1,11,元大-大天母,2024-01-26,9893
4956,光鋐,11,0,11,元大-大天母,2024-01-26,9893
00642U,期元大S＆P石油,12,1,11,元大-大天母,2024-01-26,9893
2417,圓剛,10,0,10,元大-大天母,2024-01-26,9893
1612,宏泰,10,0,10,元大-大天母,2024-01-26,9893
3094,聯傑,10,0,10,元大-大天母,2024-01-26,9893
6120,達運,60,50,10,元大-大天母,2024-01-26,9893
00937B,群益ESG投等債20,121,0,121,元大-大天母,2024-01-29,9893
8064,東捷,109,5,104,元大-大天母,2024-01-29,9893
2303,聯電,112,20,92,元大-大天母,2024-01-29,9893
00688L,國泰20年美債正2,51,0,51,元大-大天母,2024-01-29,9893
3591,艾笛森,50,0,50,元大-大天母,2024-01-29,9893
2211,長榮鋼,48,2,46,元大-大天母,2024-01-29,9893
3324,雙鴻,51,7,44,元大-大天母,2024-01-29,9893
2484,希華,43,0,43,元大-大天母,2024-01-29,9893
6161,捷波,31,0,31,元大-大天母,2024-01-29,9893
2705,六福,30,0,30,元大-大天母,2024-01-29,9893
00753L,中信中國50正2,30,0,30,元大-大天母,2024-01-29,9893
00679B,元大美債20年,27,0,27,元大-大天母,2024-01-29,9893
2382,廣達,29,4,25,元大-大天母,2024-01-29,9893
8054,安國,34,11,23,元大-大天母,2024-01-29,9893
00902,中信電池及儲能,21,0,21,元大-大天母,2024-01-29,9893
8039,台虹,20,0,20,元大-大天母,2024-01-29,9893
00720B,元大投資級公司債,22,2,20,元大-大天母,2024-01-29,9893
6494,九齊,20,0,20,元大-大天母,2024-01-29,9893
2356,英業達,35,17,18,元大-大天母,2024-01-29,9893
4938,和碩,21,5,16,元大-大天母,2024-01-29,9893
00770,國泰北美科技,16,0,16,元大-大天母,2024-01-29,9893
2337,旺宏,14,0,14,元大-大天母,2024-01-29,9893
6198,瑞築,14,0,14,元大-大天母,2024-01-29,9893
2104,國際中橡,13,0,13,元大-大天母,2024-01-29,9893
00687B,國泰20年美債,12,0,12,元大-大天母,2024-01-29,9893
00933B,國泰10Y+金融債,12,0,12,元大-大天母,2024-01-29,9893
8071,能率網通,14,2,12,元大-大天母,2024-01-29,9893
1301,台塑,11,0,11,元大-大天母,2024-01-29,9893
6168,宏齊,11,0,11,元大-大天母,2024-01-29,9893
8936,國統,10,0,10,元大-大天母,2024-01-29,9893
3228,金麗科,10,0,10,元大-大天母,2024-01-29,9893
3338,泰碩,10,0,10,元大-大天母,2024-01-29,9893
2706,第一店,10,0,10,元大-大天母,2024-01-29,9893
00665L,富邦�琤肭磪囓�2,10,0,10,元大-大天母,2024-01-29,9893
1402,遠東新,10,0,10,元大-大天母,2024-01-29,9893
00638R,元大滬深300反1,10,0,10,元大-大天母,2024-01-29,9893
2883B,凱基金乙特,10,0,10,元大-大天母,2024-01-29,9893
2634,漢翔,10,0,10,元大-大天母,2024-01-29,9893
8213,志超,10,0,10,元大-大天母,2024-01-29,9893
8932,智通*,10,0,10,元大-大天母,2024-01-29,9893
6120,達運,10,0,10,元大-大天母,2024-01-29,9893
1305,華夏,9,0,9,元大-大天母,2024-01-29,9893
5469,瀚宇博,13,4,9,元大-大天母,2024-01-29,9893
2897,王道銀行,10,1,9,元大-大天母,2024-01-29,9893
2732,六角,9,0,9,元大-大天母,2024-01-29,9893
6425,易發,8,0,8,元大-大天母,2024-01-29,9893
8147,正淩,9,2,7,元大-大天母,2024-01-29,9893
00673R,期元大S＆P原油反1,7,0,7,元大-大天母,2024-01-29,9893
6271,同欣電,7,0,7,元大-大天母,2024-01-29,9893
6462,神盾,19,12,7,元大-大天母,2024-01-29,9893
00633L,富邦上証正2,506,0,506,元大-大天母,2024-01-30,9893
2421,建準,263,135,128,元大-大天母,2024-01-30,9893
00637L,元大滬深300正2,166,51,115,元大-大天母,2024-01-30,9893
5498,凱崴,109,29,80,元大-大天母,2024-01-30,9893
3481,群創,92,29,63,元大-大天母,2024-01-30,9893
2303,聯電,66,6,60,元大-大天母,2024-01-30,9893
1809,中釉,50,0,50,元大-大天母,2024-01-30,9893
2031,新光鋼,53,4,49,元大-大天母,2024-01-30,9893
3324,雙鴻,57,8,49,元大-大天母,2024-01-30,9893
2891,中信金,100,56,44,元大-大天母,2024-01-30,9893
3034,聯詠,41,0,41,元大-大天母,2024-01-30,9893
2449,京元電子,50,10,40,元大-大天母,2024-01-30,9893
3033,威健,44,7,37,元大-大天母,2024-01-30,9893
8064,東捷,46,11,35,元大-大天母,2024-01-30,9893
2344,華邦電,35,1,34,元大-大天母,2024-01-30,9893
00679B,元大美債20年,42,9,33,元大-大天母,2024-01-30,9893
3715,定穎投控,41,12,29,元大-大天母,2024-01-30,9893
2324,仁寶,23,0,23,元大-大天母,2024-01-30,9893
2365,昆盈,28,6,22,元大-大天母,2024-01-30,9893
6237,驊訊,21,0,21,元大-大天母,2024-01-30,9893
6523,達爾膚,21,0,21,元大-大天母,2024-01-30,9893
00902,中信電池及儲能,20,0,20,元大-大天母,2024-01-30,9893
4960,誠美材,22,2,20,元大-大天母,2024-01-30,9893
00927,群益半導體收益,20,0,20,元大-大天母,2024-01-30,9893
2732,六角,20,0,20,元大-大天母,2024-01-30,9893
5432,新門,21,1,20,元大-大天母,2024-01-30,9893
00687B,國泰20年美債,19,0,19,元大-大天母,2024-01-30,9893
6270,倍微,20,1,19,元大-大天母,2024-01-30,9893
4532,瑞智,18,0,18,元大-大天母,2024-01-30,9893
2337,旺宏,18,1,17,元大-大天母,2024-01-30,9893
6198,瑞築,16,0,16,元大-大天母,2024-01-30,9893
6640,均華,15,0,15,元大-大天母,2024-01-30,9893
2308,台達電,15,1,14,元大-大天母,2024-01-30,9893
4938,和碩,14,0,14,元大-大天母,2024-01-30,9893
6191,精成科,14,0,14,元大-大天母,2024-01-30,9893
1805,寶徠,13,0,13,元大-大天母,2024-01-30,9893
3189,景碩,21,8,13,元大-大天母,2024-01-30,9893
2892,第一金,12,0,12,元大-大天母,2024-01-30,9893
00915,凱基優選高股息30,11,0,11,元大-大天母,2024-01-30,9893
9105,泰金寶-DR,12,1,11,元大-大天母,2024-01-30,9893
2609,陽明,14,4,10,元大-大天母,2024-01-30,9893
2377,微星,10,0,10,元大-大天母,2024-01-30,9893
00642U,期元大S＆P石油,10,0,10,元大-大天母,2024-01-30,9893
00671R,富邦NASDAQ反1,10,0,10,元大-大天母,2024-01-30,9893
6538,倉和,10,0,10,元大-大天母,2024-01-30,9893
3380,明泰,21,11,10,元大-大天母,2024-01-30,9893
9919,康那香,10,0,10,元大-大天母,2024-01-30,9893
1305,華夏,10,0,10,元大-大天母,2024-01-30,9893
00753L,中信中國50正2,10,0,10,元大-大天母,2024-01-30,9893
2338,光罩,11,2,9,元大-大天母,2024-01-30,9893
2303,聯電,77,6,71,元大-大天母,2024-01-31,9893
6113,亞矽,209,139,70,元大-大天母,2024-01-31,9893
2405,輔信,70,0,70,元大-大天母,2024-01-31,9893
8271,宇瞻,60,0,60,元大-大天母,2024-01-31,9893
3231,緯創,92,32,60,元大-大天母,2024-01-31,9893
2308,台達電,38,1,37,元大-大天母,2024-01-31,9893
2449,京元電子,36,1,35,元大-大天母,2024-01-31,9893
2330,台積電,41,9,32,元大-大天母,2024-01-31,9893
2534,宏盛,30,0,30,元大-大天母,2024-01-31,9893
1535,中宇,30,1,29,元大-大天母,2024-01-31,9893
3481,群創,85,56,29,元大-大天母,2024-01-31,9893
00937B,群益ESG投等債20,35,7,28,元大-大天母,2024-01-31,9893
8112,至上,28,1,27,元大-大天母,2024-01-31,9893
00679B,元大美債20年,36,9,27,元大-大天母,2024-01-31,9893
2382,廣達,28,2,26,元大-大天母,2024-01-31,9893
2376,技嘉,32,7,25,元大-大天母,2024-01-31,9893
3706,神達,26,1,25,元大-大天母,2024-01-31,9893
2603,長榮,25,2,23,元大-大天母,2024-01-31,9893
2353,宏��,24,2,22,元大-大天母,2024-01-31,9893
6108,競國,42,21,21,元大-大天母,2024-01-31,9893
2031,新光鋼,31,10,21,元大-大天母,2024-01-31,9893
6179,亞通,21,0,21,元大-大天母,2024-01-31,9893
8049,晶采,21,0,21,元大-大天母,2024-01-31,9893
00637L,元大滬深300正2,63,42,21,元大-大天母,2024-01-31,9893
2356,英業達,45,25,20,元大-大天母,2024-01-31,9893
0056,元大高股息,30,10,20,元大-大天母,2024-01-31,9893
00753L,中信中國50正2,20,0,20,元大-大天母,2024-01-31,9893
5403,中菲,20,0,20,元大-大天母,2024-01-31,9893
1560,中砂,28,8,20,元大-大天母,2024-01-31,9893
8431,匯鑽科,21,2,19,元大-大天母,2024-01-31,9893
2609,陽明,28,11,17,元大-大天母,2024-01-31,9893
00687B,國泰20年美債,20,4,16,元大-大天母,2024-01-31,9893
2465,麗臺,16,1,15,元大-大天母,2024-01-31,9893
0050,元大台灣50,14,0,14,元大-大天母,2024-01-31,9893
6715,嘉基,14,1,13,元大-大天母,2024-01-31,9893
4763,材料-KY,11,0,11,元大-大天母,2024-01-31,9893
00919,群益台灣精選高息,18,7,11,元大-大天母,2024-01-31,9893
4919,新唐,11,0,11,元大-大天母,2024-01-31,9893
2002,中鋼,11,0,11,元大-大天母,2024-01-31,9893
3289,宜特,12,1,11,元大-大天母,2024-01-31,9893
3035,智原,12,2,10,元大-大天母,2024-01-31,9893
1799,易威,10,0,10,元大-大天母,2024-01-31,9893
3228,金麗科,10,0,10,元大-大天母,2024-01-31,9893
00638R,元大滬深300反1,10,0,10,元大-大天母,2024-01-31,9893
2412,中華電,10,0,10,元大-大天母,2024-01-31,9893
8489,三貝德,30,20,10,元大-大天母,2024-01-31,9893
00720B,元大投資級公司債,10,0,10,元大-大天母,2024-01-31,9893
6203,海韻電,10,0,10,元大-大天母,2024-01-31,9893
2732,六角,10,0,10,元大-大天母,2024-01-31,9893
8210,勤誠,18,8,10,元大-大天母,2024-01-31,9893
2890,永豐金,300,1,299,元大-大天母,2024-02-01,9893
00637L,元大滬深300正2,242,15,227,元大-大天母,2024-02-01,9893
2449,京元電子,160,1,159,元大-大天母,2024-02-01,9893
00753L,中信中國50正2,92,0,92,元大-大天母,2024-02-01,9893
2609,陽明,119,28,91,元大-大天母,2024-02-01,9893
4953,緯軟,73,1,72,元大-大天母,2024-02-01,9893
2885,元大金,65,2,63,元大-大天母,2024-02-01,9893
3289,宜特,81,29,52,元大-大天母,2024-02-01,9893
3047,訊舟,55,6,49,元大-大天母,2024-02-01,9893
3530,晶相光,38,8,30,元大-大天母,2024-02-01,9893
2534,宏盛,30,0,30,元大-大天母,2024-02-01,9893
2812,台中銀,58,29,29,元大-大天母,2024-02-01,9893
2303,聯電,50,21,29,元大-大天母,2024-02-01,9893
1609,大亞,28,0,28,元大-大天母,2024-02-01,9893
8085,福華,33,8,25,元大-大天母,2024-02-01,9893
00878,國泰永續高股息,43,18,25,元大-大天母,2024-02-01,9893
3050,鈺德,32,8,24,元大-大天母,2024-02-01,9893
8936,國統,48,25,23,元大-大天母,2024-02-01,9893
3711,日月光投控,23,0,23,元大-大天母,2024-02-01,9893
3615,安可,30,8,22,元大-大天母,2024-02-01,9893
1325,恆大,25,5,20,元大-大天母,2024-02-01,9893
3188,鑫龍騰,20,0,20,元大-大天母,2024-02-01,9893
6116,彩晶,21,1,20,元大-大天母,2024-02-01,9893
6538,倉和,21,1,20,元大-大天母,2024-02-01,9893
6425,易發,29,10,19,元大-大天母,2024-02-01,9893
6121,新普,18,0,18,元大-大天母,2024-02-01,9893
2405,輔信,24,6,18,元大-大天母,2024-02-01,9893
00919,群益台灣精選高息,23,5,18,元大-大天母,2024-02-01,9893
3483,力致,19,1,18,元大-大天母,2024-02-01,9893
1101,台泥,20,3,17,元大-大天母,2024-02-01,9893
00882,中信中國高股息,17,0,17,元大-大天母,2024-02-01,9893
3363,上詮,43,26,17,元大-大天母,2024-02-01,9893
2369,菱生,18,2,16,元大-大天母,2024-02-01,9893
3492,長盛,15,0,15,元大-大天母,2024-02-01,9893
6805,富世達,14,0,14,元大-大天母,2024-02-01,9893
2379,瑞昱,15,1,14,元大-大天母,2024-02-01,9893
8096,擎亞,29,15,14,元大-大天母,2024-02-01,9893
3312,弘憶股,22,8,14,元大-大天母,2024-02-01,9893
2330,台積電,21,8,13,元大-大天母,2024-02-01,9893
00679B,元大美債20年,19,6,13,元大-大天母,2024-02-01,9893
2382,廣達,16,4,12,元大-大天母,2024-02-01,9893
2888,新光金,25,13,12,元大-大天母,2024-02-01,9893
3122,笙泉,12,0,12,元大-大天母,2024-02-01,9893
2313,華通,22,10,12,元大-大天母,2024-02-01,9893
6695,芯鼎,58,46,12,元大-大天母,2024-02-01,9893
8111,立��,15,4,11,元大-大天母,2024-02-01,9893
8271,宇瞻,11,0,11,元大-大天母,2024-02-01,9893
2344,華邦電,31,20,11,元大-大天母,2024-02-01,9893
8473,山林水,12,2,10,元大-大天母,2024-02-01,9893
1799,易威,10,0,10,元大-大天母,2024-02-01,9893
2885,元大金,301,0,301,元大-大天母,2024-02-02,9893
2890,永豐金,200,2,198,元大-大天母,2024-02-02,9893
8059,凱碩,116,0,116,元大-大天母,2024-02-02,9893
2498,宏達電,187,75,112,元大-大天母,2024-02-02,9893
00937B,群益ESG投等債20,163,60,103,元大-大天母,2024-02-02,9893
3289,宜特,94,8,86,元大-大天母,2024-02-02,9893
2353,宏��,96,13,83,元大-大天母,2024-02-02,9893
2303,聯電,106,24,82,元大-大天母,2024-02-02,9893
2449,京元電子,80,0,80,元大-大天母,2024-02-02,9893
00690,兆豐藍籌30,74,0,74,元大-大天母,2024-02-02,9893
3711,日月光投控,53,1,52,元大-大天母,2024-02-02,9893
2636,台驊控股,50,0,50,元大-大天母,2024-02-02,9893
00679B,元大美債20年,60,12,48,元大-大天母,2024-02-02,9893
2344,華邦電,51,2,49,元大-大天母,2024-02-02,9893
8271,宇瞻,48,0,48,元大-大天母,2024-02-02,9893
2889,國票金,46,0,46,元大-大天母,2024-02-02,9893
2484,希華,44,0,44,元大-大天母,2024-02-02,9893
3047,訊舟,40,0,40,元大-大天母,2024-02-02,9893
2345,智邦,40,1,39,元大-大天母,2024-02-02,9893
2603,長榮,46,11,35,元大-大天母,2024-02-02,9893
3483,力致,42,7,35,元大-大天母,2024-02-02,9893
2812,台中銀,36,2,34,元大-大天母,2024-02-02,9893
00715L,期街口布蘭特正2,34,0,34,元大-大天母,2024-02-02,9893
00637L,元大滬深300正2,75,43,32,元大-大天母,2024-02-02,9893
6263,普萊德,31,2,29,元大-大天母,2024-02-02,9893
2027,大成鋼,26,0,26,元大-大天母,2024-02-02,9893
9904,寶成,25,0,25,元大-大天母,2024-02-02,9893
3380,明泰,26,1,25,元大-大天母,2024-02-02,9893
2891,中信金,24,0,24,元大-大天母,2024-02-02,9893
00720B,元大投資級公司債,24,0,24,元大-大天母,2024-02-02,9893
3376,新日興,60,37,23,元大-大天母,2024-02-02,9893
2609,陽明,25,3,22,元大-大天母,2024-02-02,9893
8996,高力,36,14,22,元大-大天母,2024-02-02,9893
00687B,國泰20年美債,25,3,22,元大-大天母,2024-02-02,9893
2364,倫飛,22,1,21,元大-大天母,2024-02-02,9893
00933B,國泰10Y+金融債,21,1,20,元大-大天母,2024-02-02,9893
4755,三福化,21,1,20,元大-大天母,2024-02-02,9893
4906,正文,21,1,20,元大-大天母,2024-02-02,9893
00669R,國泰美國道瓊反1,20,0,20,元大-大天母,2024-02-02,9893
2883,凱基金,20,0,20,元大-大天母,2024-02-02,9893
6116,彩晶,21,2,19,元大-大天母,2024-02-02,9893
00753L,中信中國50正2,18,0,18,元大-大天母,2024-02-02,9893
1809,中釉,17,0,17,元大-大天母,2024-02-02,9893
2745,五福,17,0,17,元大-大天母,2024-02-02,9893
3363,上詮,48,32,16,元大-大天母,2024-02-02,9893
6113,亞矽,36,21,15,元大-大天母,2024-02-02,9893
2408,南亞科,15,0,15,元大-大天母,2024-02-02,9893
8039,台虹,15,0,15,元大-大天母,2024-02-02,9893
4960,誠美材,15,0,15,元大-大天母,2024-02-02,9893
6161,捷波,15,0,15,元大-大天母,2024-02-02,9893
2886,兆豐金,225,41,184,元大-大天母,2024-02-05,9893
00919,群益台灣精選高息,149,1,148,元大-大天母,2024-02-05,9893
00680L,元大美債20正2,127,3,124,元大-大天母,2024-02-05,9893
4953,緯軟,99,1,98,元大-大天母,2024-02-05,9893
00937B,群益ESG投等債20,96,0,96,元大-大天母,2024-02-05,9893
2609,陽明,111,20,91,元大-大天母,2024-02-05,9893
00929,復華台灣科技優息,77,1,76,元大-大天母,2024-02-05,9893
2498,宏達電,115,46,69,元大-大天母,2024-02-05,9893
2368,金像電,135,70,65,元大-大天母,2024-02-05,9893
00688L,國泰20年美債正2,82,20,62,元大-大天母,2024-02-05,9893
2303,聯電,60,5,55,元大-大天母,2024-02-05,9893
2025,千興,52,0,52,元大-大天母,2024-02-05,9893
1210,大成,51,0,51,元大-大天母,2024-02-05,9893
2890,永豐金,50,0,50,元大-大天母,2024-02-05,9893
3289,宜特,51,2,49,元大-大天母,2024-02-05,9893
00878,國泰永續高股息,50,2,48,元大-大天母,2024-02-05,9893
3711,日月光投控,42,1,41,元大-大天母,2024-02-05,9893
2884,玉山金,38,1,37,元大-大天母,2024-02-05,9893
00679B,元大美債20年,38,1,37,元大-大天母,2024-02-05,9893
2382,廣達,56,20,36,元大-大天母,2024-02-05,9893
8271,宇瞻,32,0,32,元大-大天母,2024-02-05,9893
1711,永光,30,0,30,元大-大天母,2024-02-05,9893
6204,艾華,30,0,30,元大-大天母,2024-02-05,9893
00687B,國泰20年美債,30,0,30,元大-大天母,2024-02-05,9893
3034,聯詠,31,5,26,元大-大天母,2024-02-05,9893
00753L,中信中國50正2,26,0,26,元大-大天母,2024-02-05,9893
3694,海華,24,3,21,元大-大天母,2024-02-05,9893
1102,亞泥,20,0,20,元大-大天母,2024-02-05,9893
3450,聯鈞,20,0,20,元大-大天母,2024-02-05,9893
00712,復華富時不動產,19,0,19,元大-大天母,2024-02-05,9893
2301,光寶科,20,3,17,元大-大天母,2024-02-05,9893
0061,元大寶滬深,16,0,16,元大-大天母,2024-02-05,9893
3346,麗清,15,0,15,元大-大天母,2024-02-05,9893
5284,jpp-KY,31,17,14,元大-大天母,2024-02-05,9893
00751B,元大AAA至A公司債,14,0,14,元大-大天母,2024-02-05,9893
2883,凱基金,23,9,14,元大-大天母,2024-02-05,9893
6126,信音,13,0,13,元大-大天母,2024-02-05,9893
6684,安格,17,4,13,元大-大天母,2024-02-05,9893
3563,牧德,13,0,13,元大-大天母,2024-02-05,9893
4979,華星光,12,0,12,元大-大天母,2024-02-05,9893
00933B,國泰10Y+金融債,12,0,12,元大-大天母,2024-02-05,9893
2603,長榮,14,3,11,元大-大天母,2024-02-05,9893
5340,建榮,11,0,11,元大-大天母,2024-02-05,9893
00715L,期街口布蘭特正2,14,3,11,元大-大天母,2024-02-05,9893
00931B,統一美債20年,11,0,11,元大-大天母,2024-02-05,9893
0056,元大高股息,19,8,11,元大-大天母,2024-02-05,9893
3530,晶相光,51,41,10,元大-大天母,2024-02-05,9893
1305,華夏,10,0,10,元大-大天母,2024-02-05,9893
2855,統一證,10,0,10,元大-大天母,2024-02-05,9893
1532,勤美,10,0,10,元大-大天母,2024-02-05,9893
00680L,元大美債20正2,581,0,581,元大-大天母,2024-02-15,9893
00929,復華台灣科技優息,309,52,257,元大-大天母,2024-02-15,9893
00937B,群益ESG投等債20,191,19,172,元大-大天母,2024-02-15,9893
00933B,國泰10Y+金融債,170,2,168,元大-大天母,2024-02-15,9893
00632R,元大台灣50反1,165,0,165,元大-大天母,2024-02-15,9893
3481,群創,217,73,144,元大-大天母,2024-02-15,9893
3047,訊舟,151,12,139,元大-大天母,2024-02-15,9893
4714,永捷,146,18,128,元大-大天母,2024-02-15,9893
5439,高技,102,0,102,元大-大天母,2024-02-15,9893
00679B,元大美債20年,99,6,93,元大-大天母,2024-02-15,9893
5488,松普,85,0,85,元大-大天母,2024-02-15,9893
6104,創惟,100,16,84,元大-大天母,2024-02-15,9893
00751B,元大AAA至A公司債,76,0,76,元大-大天母,2024-02-15,9893
2705,六福,65,0,65,元大-大天母,2024-02-15,9893
3034,聯詠,67,3,64,元大-大天母,2024-02-15,9893
00688L,國泰20年美債正2,65,2,63,元大-大天母,2024-02-15,9893
2353,宏��,85,24,61,元大-大天母,2024-02-15,9893
00687B,國泰20年美債,79,22,57,元大-大天母,2024-02-15,9893
3015,全漢,60,5,55,元大-大天母,2024-02-15,9893
2331,精英,53,0,53,元大-大天母,2024-02-15,9893
2301,光寶科,56,6,50,元大-大天母,2024-02-15,9893
1210,大成,45,0,45,元大-大天母,2024-02-15,9893
2352,佳世達,43,0,43,元大-大天母,2024-02-15,9893
00857B,永豐20年美公債,40,0,40,元大-大天母,2024-02-15,9893
2636,台驊控股,40,0,40,元大-大天母,2024-02-15,9893
2344,華邦電,77,40,37,元大-大天母,2024-02-15,9893
00922,國泰台灣領袖50,116,82,34,元大-大天母,2024-02-15,9893
2408,南亞科,31,0,31,元大-大天母,2024-02-15,9893
1321,大洋,30,0,30,元大-大天母,2024-02-15,9893
6177,達麗,29,0,29,元大-大天母,2024-02-15,9893
2886,兆豐金,30,1,29,元大-大天母,2024-02-15,9893
2634,漢翔,33,5,28,元大-大天母,2024-02-15,9893
1522,堤維西,29,1,28,元大-大天母,2024-02-15,9893
00795B,中信美國公債20年,30,5,25,元大-大天母,2024-02-15,9893
1711,永光,25,0,25,元大-大天母,2024-02-15,9893
2313,華通,30,6,24,元大-大天母,2024-02-15,9893
00772B,中信高評級公司債,24,0,24,元大-大天母,2024-02-15,9893
00712,復華富時不動產,22,1,21,元大-大天母,2024-02-15,9893
2308,台達電,24,4,20,元大-大天母,2024-02-15,9893
00907,永豐優息存股,20,0,20,元大-大天母,2024-02-15,9893
3570,大塚,20,0,20,元大-大天母,2024-02-15,9893
00768B,復華20年美債,20,0,20,元大-大天母,2024-02-15,9893
2504,國產,19,0,19,元大-大天母,2024-02-15,9893
2603,長榮,40,21,19,元大-大天母,2024-02-15,9893
5432,新門,20,2,18,元大-大天母,2024-02-15,9893
3715,定穎投控,26,8,18,元大-大天母,2024-02-15,9893
5234,達興材料,20,3,17,元大-大天母,2024-02-15,9893
00725B,國泰投資級公司債,17,0,17,元大-大天母,2024-02-15,9893
8996,高力,21,4,17,元大-大天母,2024-02-15,9893
2607,榮運,16,0,16,元大-大天母,2024-02-15,9893
00680L,元大美債20正2,177,33,144,元大-大天母,2024-02-16,9893
00937B,群益ESG投等債20,89,1,88,元大-大天母,2024-02-16,9893
00720B,元大投資級公司債,71,5,66,元大-大天母,2024-02-16,9893
2313,華通,104,38,66,元大-大天母,2024-02-16,9893
00679B,元大美債20年,66,1,65,元大-大天母,2024-02-16,9893
4420,光明,63,0,63,元大-大天母,2024-02-16,9893
2890,永豐金,56,2,54,元大-大天母,2024-02-16,9893
00687B,國泰20年美債,47,0,47,元大-大天母,2024-02-16,9893
00933B,國泰10Y+金融債,46,1,45,元大-大天母,2024-02-16,9893
2382,廣達,132,87,45,元大-大天母,2024-02-16,9893
1471,首利,45,2,43,元大-大天母,2024-02-16,9893
5498,凱崴,43,0,43,元大-大天母,2024-02-16,9893
8473,山林水,43,0,43,元大-大天母,2024-02-16,9893
6285,啟��,41,0,41,元大-大天母,2024-02-16,9893
2404,漢唐,50,10,40,元大-大天母,2024-02-16,9893
1101,台泥,43,4,39,元大-大天母,2024-02-16,9893
1785,光洋科,42,4,38,元大-大天母,2024-02-16,9893
1809,中釉,42,6,36,元大-大天母,2024-02-16,9893
1504,東元,53,17,36,元大-大天母,2024-02-16,9893
2892,第一金,37,1,36,元大-大天母,2024-02-16,9893
1711,永光,40,5,35,元大-大天母,2024-02-16,9893
8054,安國,40,7,33,元大-大天母,2024-02-16,9893
6164,華興,48,15,33,元大-大天母,2024-02-16,9893
1316,上曜,39,9,30,元大-大天母,2024-02-16,9893
00673R,期元大S＆P原油反1,26,0,26,元大-大天母,2024-02-16,9893
8936,國統,36,11,25,元大-大天母,2024-02-16,9893
5880,合庫金,25,0,25,元大-大天母,2024-02-16,9893
00936,台新永續高息中小,23,0,23,元大-大天母,2024-02-16,9893
2377,微星,47,25,22,元大-大天母,2024-02-16,9893
2891,中信金,24,3,21,元大-大天母,2024-02-16,9893
6263,普萊德,21,0,21,元大-大天母,2024-02-16,9893
2329,華泰,81,61,20,元大-大天母,2024-02-16,9893
00751B,元大AAA至A公司債,20,0,20,元大-大天母,2024-02-16,9893
6830,汎銓,20,0,20,元大-大天母,2024-02-16,9893
00919,群益台灣精選高息,36,17,19,元大-大天母,2024-02-16,9893
6719,力智,26,7,19,元大-大天母,2024-02-16,9893
2514,龍邦,19,0,19,元大-大天母,2024-02-16,9893
2363,矽統,35,16,19,元大-大天母,2024-02-16,9893
2303,聯電,88,70,18,元大-大天母,2024-02-16,9893
2609,陽明,44,26,18,元大-大天母,2024-02-16,9893
2603,長榮,25,8,17,元大-大天母,2024-02-16,9893
00931B,統一美債20年,17,0,17,元大-大天母,2024-02-16,9893
3376,新日興,29,12,17,元大-大天母,2024-02-16,9893
3209,全科,20,4,16,元大-大天母,2024-02-16,9893
3010,華立,17,1,16,元大-大天母,2024-02-16,9893
1815,富喬,22,6,16,元大-大天母,2024-02-16,9893
4556,旭然,15,0,15,元大-大天母,2024-02-16,9893
3036,文曄,16,2,14,元大-大天母,2024-02-16,9893
5871,中租-KY,16,2,14,元大-大天母,2024-02-16,9893
00795B,中信美國公債20年,13,0,13,元大-大天母,2024-02-16,9893
6288,聯嘉,618,100,518,元大-大天母,2024-02-19,9893
00919,群益台灣精選高息,215,12,203,元大-大天母,2024-02-19,9893
00637L,元大滬深300正2,186,35,151,元大-大天母,2024-02-19,9893
00937B,群益ESG投等債20,133,0,133,元大-大天母,2024-02-19,9893
1455,集盛,123,0,123,元大-大天母,2024-02-19,9893
4420,光明,122,2,120,元大-大天母,2024-02-19,9893
5498,凱崴,109,5,104,元大-大天母,2024-02-19,9893
2303,聯電,101,7,94,元大-大天母,2024-02-19,9893
2489,瑞軒,134,41,93,元大-大天母,2024-02-19,9893
00753L,中信中國50正2,91,3,88,元大-大天母,2024-02-19,9893
2382,廣達,86,12,74,元大-大天母,2024-02-19,9893
2353,宏��,103,38,65,元大-大天母,2024-02-19,9893
00720B,元大投資級公司債,61,0,61,元大-大天母,2024-02-19,9893
2356,英業達,73,13,60,元大-大天母,2024-02-19,9893
2006,東和鋼鐵,50,0,50,元大-大天母,2024-02-19,9893
8085,福華,51,3,48,元大-大天母,2024-02-19,9893
00679B,元大美債20年,48,0,48,元大-大天母,2024-02-19,9893
00878,國泰永續高股息,94,48,46,元大-大天母,2024-02-19,9893
2515,中工,47,2,45,元大-大天母,2024-02-19,9893
2358,廷鑫,50,6,44,元大-大天母,2024-02-19,9893
4707,磐亞,40,0,40,元大-大天母,2024-02-19,9893
3047,訊舟,46,7,39,元大-大天母,2024-02-19,9893
2329,華泰,127,89,38,元大-大天母,2024-02-19,9893
2365,昆盈,278,242,36,元大-大天母,2024-02-19,9893
00933B,國泰10Y+金融債,36,0,36,元大-大天母,2024-02-19,9893
4909,新復興,58,22,36,元大-大天母,2024-02-19,9893
2457,飛宏,52,17,35,元大-大天母,2024-02-19,9893
4702,中美實,35,0,35,元大-大天母,2024-02-19,9893
00650L,復華香港正2,35,0,35,元大-大天母,2024-02-19,9893
2406,國碩,40,6,34,元大-大天母,2024-02-19,9893
3231,緯創,128,95,33,元大-大天母,2024-02-19,9893
2369,菱生,118,88,30,元大-大天母,2024-02-19,9893
6164,華興,33,4,29,元大-大天母,2024-02-19,9893
3034,聯詠,32,3,29,元大-大天母,2024-02-19,9893
6274,台燿,36,10,26,元大-大天母,2024-02-19,9893
5355,佳總,35,9,26,元大-大天母,2024-02-19,9893
3438,類比科,31,6,25,元大-大天母,2024-02-19,9893
2886,兆豐金,32,7,25,元大-大天母,2024-02-19,9893
3376,新日興,44,22,22,元大-大天母,2024-02-19,9893
3044,健鼎,23,1,22,元大-大天母,2024-02-19,9893
1809,中釉,27,5,22,元大-大天母,2024-02-19,9893
2465,麗臺,23,2,21,元大-大天母,2024-02-19,9893
8936,國統,30,10,20,元大-大天母,2024-02-19,9893
2405,輔信,35,15,20,元大-大天母,2024-02-19,9893
00902,中信電池及儲能,20,0,20,元大-大天母,2024-02-19,9893
2498,宏達電,35,16,19,元大-大天母,2024-02-19,9893
2634,漢翔,21,2,19,元大-大天母,2024-02-19,9893
4960,誠美材,22,3,19,元大-大天母,2024-02-19,9893
3437,榮創,27,9,18,元大-大天母,2024-02-19,9893
1513,中興電,42,25,17,元大-大天母,2024-02-19,9893
00680L,元大美債20正2,271,0,271,元大-大天母,2024-02-20,9893
2031,新光鋼,233,3,230,元大-大天母,2024-02-20,9893
00751B,元大AAA至A公司債,158,0,158,元大-大天母,2024-02-20,9893
3037,欣興,146,14,132,元大-大天母,2024-02-20,9893
00937B,群益ESG投等債20,130,3,127,元大-大天母,2024-02-20,9893
2890,永豐金,116,5,111,元大-大天母,2024-02-20,9893
6288,聯嘉,109,0,109,元大-大天母,2024-02-20,9893
2617,台航,100,0,100,元大-大天母,2024-02-20,9893
00673R,期元大S＆P原油反1,97,0,97,元大-大天母,2024-02-20,9893
2006,東和鋼鐵,80,0,80,元大-大天母,2024-02-20,9893
3481,群創,78,14,64,元大-大天母,2024-02-20,9893
2834,臺企銀,52,0,52,元大-大天母,2024-02-20,9893
1316,上曜,59,8,51,元大-大天母,2024-02-20,9893
3041,揚智,65,15,50,元大-大天母,2024-02-20,9893
3231,緯創,85,44,41,元大-大天母,2024-02-20,9893
8935,邦泰,39,0,39,元大-大天母,2024-02-20,9893
2344,華邦電,47,8,39,元大-大天母,2024-02-20,9893
2303,聯電,62,24,38,元大-大天母,2024-02-20,9893
00688L,國泰20年美債正2,40,2,38,元大-大天母,2024-02-20,9893
4766,南寶,35,0,35,元大-大天母,2024-02-20,9893
00679B,元大美債20年,34,0,34,元大-大天母,2024-02-20,9893
2489,瑞軒,57,24,33,元大-大天母,2024-02-20,9893
6282,康舒,55,25,30,元大-大天母,2024-02-20,9893
5534,長虹,30,0,30,元大-大天母,2024-02-20,9893
6204,艾華,30,0,30,元大-大天母,2024-02-20,9893
4106,雃博,29,0,29,元大-大天母,2024-02-20,9893
00933B,國泰10Y+金融債,29,0,29,元大-大天母,2024-02-20,9893
6176,瑞儀,29,1,28,元大-大天母,2024-02-20,9893
2367,燿華,34,6,28,元大-大天母,2024-02-20,9893
9105,泰金寶-DR,27,0,27,元大-大天母,2024-02-20,9893
00720B,元大投資級公司債,25,0,25,元大-大天母,2024-02-20,9893
00632R,元大台灣50反1,25,0,25,元大-大天母,2024-02-20,9893
00927,群益半導體收益,25,2,23,元大-大天母,2024-02-20,9893
3706,神達,29,6,23,元大-大天母,2024-02-20,9893
00753L,中信中國50正2,22,0,22,元大-大天母,2024-02-20,9893
6189,豐藝,26,7,19,元大-大天母,2024-02-20,9893
2363,矽統,17,1,16,元大-大天母,2024-02-20,9893
00687B,國泰20年美債,17,1,16,元大-大天母,2024-02-20,9893
2485,兆赫,15,0,15,元大-大天母,2024-02-20,9893
6770,力積電,14,0,14,元大-大天母,2024-02-20,9893
2408,南亞科,18,4,14,元大-大天母,2024-02-20,9893
8436,大江,15,1,14,元大-大天母,2024-02-20,9893
8050,廣積,13,0,13,元大-大天母,2024-02-20,9893
8996,高力,19,6,13,元大-大天母,2024-02-20,9893
6126,信音,56,44,12,元大-大天母,2024-02-20,9893
2313,華通,39,27,12,元大-大天母,2024-02-20,9893
2897,王道銀行,12,0,12,元大-大天母,2024-02-20,9893
9941,裕融,11,0,11,元大-大天母,2024-02-20,9893
8112,至上,17,6,11,元大-大天母,2024-02-20,9893
1717,長興,11,0,11,元大-大天母,2024-02-20,9893
2886,兆豐金,207,20,187,元大-大天母,2024-02-21,9893
2890,永豐金,190,30,160,元大-大天母,2024-02-21,9893
00919,群益台灣精選高息,169,25,144,元大-大天母,2024-02-21,9893
9105,泰金寶-DR,217,84,133,元大-大天母,2024-02-21,9893
2031,新光鋼,132,3,129,元大-大天母,2024-02-21,9893
00937B,群益ESG投等債20,130,3,127,元大-大天母,2024-02-21,9893
2385,群光,104,2,102,元大-大天母,2024-02-21,9893
00878,國泰永續高股息,101,1,100,元大-大天母,2024-02-21,9893
3005,神基,109,13,96,元大-大天母,2024-02-21,9893
1809,中釉,96,9,87,元大-大天母,2024-02-21,9893
3231,緯創,132,45,87,元大-大天母,2024-02-21,9893
00929,復華台灣科技優息,134,48,86,元大-大天母,2024-02-21,9893
3047,訊舟,128,47,81,元大-大天母,2024-02-21,9893
2303,聯電,89,10,79,元大-大天母,2024-02-21,9893
3363,上詮,129,54,75,元大-大天母,2024-02-21,9893
1316,上曜,80,6,74,元大-大天母,2024-02-21,9893
00679B,元大美債20年,73,0,73,元大-大天母,2024-02-21,9893
00933B,國泰10Y+金融債,63,0,63,元大-大天母,2024-02-21,9893
2609,陽明,119,59,60,元大-大天母,2024-02-21,9893
00687B,國泰20年美債,62,3,59,元大-大天母,2024-02-21,9893
6288,聯嘉,59,0,59,元大-大天母,2024-02-21,9893
2006,東和鋼鐵,52,0,52,元大-大天母,2024-02-21,9893
3481,群創,55,4,51,元大-大天母,2024-02-21,9893
1528,恩德,57,10,47,元大-大天母,2024-02-21,9893
3044,健鼎,46,1,45,元大-大天母,2024-02-21,9893
6290,良維,70,31,39,元大-大天母,2024-02-21,9893
2382,廣達,42,5,37,元大-大天母,2024-02-21,9893
2353,宏��,68,32,36,元大-大天母,2024-02-21,9893
2885,元大金,36,1,35,元大-大天母,2024-02-21,9893
3714,富采,33,0,33,元大-大天母,2024-02-21,9893
4960,誠美材,32,0,32,元大-大天母,2024-02-21,9893
2331,精英,31,0,31,元大-大天母,2024-02-21,9893
4973,廣穎,30,0,30,元大-大天母,2024-02-21,9893
1102,亞泥,36,7,29,元大-大天母,2024-02-21,9893
6233,旺玖,34,7,27,元大-大天母,2024-02-21,9893
2330,台積電,27,0,27,元大-大天母,2024-02-21,9893
00632R,元大台灣50反1,26,0,26,元大-大天母,2024-02-21,9893
00712,復華富時不動產,25,0,25,元大-大天母,2024-02-21,9893
5443,均豪,108,84,24,元大-大天母,2024-02-21,9893
3712,永崴投控,25,1,24,元大-大天母,2024-02-21,9893
2406,國碩,23,1,22,元大-大天母,2024-02-21,9893
9912,偉聯,21,0,21,元大-大天母,2024-02-21,9893
00673R,期元大S＆P原油反1,20,0,20,元大-大天母,2024-02-21,9893
5403,中菲,20,0,20,元大-大天母,2024-02-21,9893
6179,亞通,20,1,19,元大-大天母,2024-02-21,9893
2347,聯強,19,0,19,元大-大天母,2024-02-21,9893
2543,皇昌,35,16,19,元大-大天母,2024-02-21,9893
00891,中信關鍵半導體,18,0,18,元大-大天母,2024-02-21,9893
3041,揚智,24,7,17,元大-大天母,2024-02-21,9893
00720B,元大投資級公司債,16,0,16,元大-大天母,2024-02-21,9893
1815,富喬,557,5,552,元大-大天母,2024-02-22,9893
2883,凱基金,493,15,478,元大-大天母,2024-02-22,9893
5498,凱崴,344,34,310,元大-大天母,2024-02-22,9893
00679B,元大美債20年,266,0,266,元大-大天母,2024-02-22,9893
2890,永豐金,281,101,180,元大-大天母,2024-02-22,9893
00772B,中信高評級公司債,155,0,155,元大-大天母,2024-02-22,9893
00937B,群益ESG投等債20,152,0,152,元大-大天母,2024-02-22,9893
9934,成霖,140,5,135,元大-大天母,2024-02-22,9893
00680L,元大美債20正2,131,0,131,元大-大天母,2024-02-22,9893
2385,群光,131,5,126,元大-大天母,2024-02-22,9893
2371,大同,152,54,98,元大-大天母,2024-02-22,9893
2885,元大金,106,18,88,元大-大天母,2024-02-22,9893
8926,台汽電,132,46,86,元大-大天母,2024-02-22,9893
2892,第一金,92,10,82,元大-大天母,2024-02-22,9893
00687B,國泰20年美債,75,1,74,元大-大天母,2024-02-22,9893
3231,緯創,112,38,74,元大-大天母,2024-02-22,9893
00673R,期元大S＆P原油反1,60,0,60,元大-大天母,2024-02-22,9893
9105,泰金寶-DR,57,0,57,元大-大天母,2024-02-22,9893
6126,信音,66,10,56,元大-大天母,2024-02-22,9893
00637L,元大滬深300正2,52,4,48,元大-大天母,2024-02-22,9893
2331,精英,49,4,45,元大-大天母,2024-02-22,9893
2356,英業達,74,30,44,元大-大天母,2024-02-22,9893
2460,建通,53,11,42,元大-大天母,2024-02-22,9893
00753L,中信中國50正2,57,15,42,元大-大天母,2024-02-22,9893
00676R,富邦臺灣加權反1,42,0,42,元大-大天母,2024-02-22,9893
2883B,凱基金乙特,40,0,40,元大-大天母,2024-02-22,9893
2353,宏��,55,15,40,元大-大天母,2024-02-22,9893
4909,新復興,56,17,39,元大-大天母,2024-02-22,9893
1809,中釉,50,12,38,元大-大天母,2024-02-22,9893
8936,國統,49,15,34,元大-大天母,2024-02-22,9893
4526,東台,33,1,32,元大-大天母,2024-02-22,9893
2211,長榮鋼,31,0,31,元大-大天母,2024-02-22,9893
3312,弘憶股,31,1,30,元大-大天母,2024-02-22,9893
5534,長虹,30,0,30,元大-大天母,2024-02-22,9893
00645,富邦日本,29,0,29,元大-大天母,2024-02-22,9893
1102,亞泥,27,0,27,元大-大天母,2024-02-22,9893
00650L,復華香港正2,26,0,26,元大-大天母,2024-02-22,9893
00632R,元大台灣50反1,25,0,25,元大-大天母,2024-02-22,9893
3221,台嘉碩,28,3,25,元大-大天母,2024-02-22,9893
00922,國泰台灣領袖50,40,16,24,元大-大天母,2024-02-22,9893
2379,瑞昱,28,5,23,元大-大天母,2024-02-22,9893
00933B,國泰10Y+金融債,23,1,22,元大-大天母,2024-02-22,9893
8050,廣積,20,0,20,元大-大天母,2024-02-22,9893
8049,晶采,20,0,20,元大-大天母,2024-02-22,9893
6438,迅得,20,1,19,元大-大天母,2024-02-22,9893
6113,亞矽,21,2,19,元大-大天母,2024-02-22,9893
2363,矽統,21,3,18,元大-大天母,2024-02-22,9893
2405,輔信,29,11,18,元大-大天母,2024-02-22,9893
00795B,中信美國公債20年,20,3,17,元大-大天母,2024-02-22,9893
1795,美時,15,0,15,元大-大天母,2024-02-22,9893
2892,第一金,351,11,340,元大-大天母,2024-02-23,9893
00937B,群益ESG投等債20,252,0,252,元大-大天母,2024-02-23,9893
2885,元大金,208,1,207,元大-大天母,2024-02-23,9893
2617,台航,150,0,150,元大-大天母,2024-02-23,9893
3231,緯創,157,38,119,元大-大天母,2024-02-23,9893
2618,長榮航,105,8,97,元大-大天母,2024-02-23,9893
2353,宏��,101,5,96,元大-大天母,2024-02-23,9893
00753L,中信中國50正2,100,4,96,元大-大天母,2024-02-23,9893
2886,兆豐金,87,0,87,元大-大天母,2024-02-23,9893
00896,中信綠能及電動車,65,5,60,元大-大天母,2024-02-23,9893
2211,長榮鋼,60,0,60,元大-大天母,2024-02-23,9893
6167,久正,77,19,58,元大-大天母,2024-02-23,9893
6613,朋億*,80,29,51,元大-大天母,2024-02-23,9893
3044,健鼎,64,14,50,元大-大天母,2024-02-23,9893
00632R,元大台灣50反1,55,5,50,元大-大天母,2024-02-23,9893
5534,長虹,50,0,50,元大-大天母,2024-02-23,9893
8097,常珵,49,0,49,元大-大天母,2024-02-23,9893
5452,佶優,52,4,48,元大-大天母,2024-02-23,9893
2344,華邦電,70,23,47,元大-大天母,2024-02-23,9893
00679B,元大美債20年,47,1,46,元大-大天母,2024-02-23,9893
2603,長榮,56,10,46,元大-大天母,2024-02-23,9893
2303,聯電,54,13,41,元大-大天母,2024-02-23,9893
8064,東捷,51,10,41,元大-大天母,2024-02-23,9893
4973,廣穎,40,0,40,元大-大天母,2024-02-23,9893
2352,佳世達,43,3,40,元大-大天母,2024-02-23,9893
00919,群益台灣精選高息,83,47,36,元大-大天母,2024-02-23,9893
1102,亞泥,35,0,35,元大-大天母,2024-02-23,9893
9105,泰金寶-DR,32,0,32,元大-大天母,2024-02-23,9893
9904,寶成,38,10,28,元大-大天母,2024-02-23,9893
2610,華航,28,1,27,元大-大天母,2024-02-23,9893
6176,瑞儀,25,1,24,元大-大天母,2024-02-23,9893
2356,英業達,199,176,23,元大-大天母,2024-02-23,9893
00934,中信成長高股息,24,2,22,元大-大天母,2024-02-23,9893
2838,聯邦銀,22,0,22,元大-大天母,2024-02-23,9893
6263,普萊德,21,0,21,元大-大天母,2024-02-23,9893
4958,臻鼎-KY,20,0,20,元大-大天母,2024-02-23,9893
2460,建通,22,2,20,元大-大天母,2024-02-23,9893
2355,敬鵬,20,0,20,元大-大天母,2024-02-23,9893
2882,國泰金,20,0,20,元大-大天母,2024-02-23,9893
1815,富喬,23,4,19,元大-大天母,2024-02-23,9893
00933B,國泰10Y+金融債,19,0,19,元大-大天母,2024-02-23,9893
2421,建準,24,6,18,元大-大天母,2024-02-23,9893
00764B,群益25年美債,17,0,17,元大-大天母,2024-02-23,9893
4960,誠美材,18,1,17,元大-大天母,2024-02-23,9893
8926,台汽電,51,35,16,元大-大天母,2024-02-23,9893
6282,康舒,22,6,16,元大-大天母,2024-02-23,9893
5469,瀚宇博,17,1,16,元大-大天母,2024-02-23,9893
1305,華夏,15,0,15,元大-大天母,2024-02-23,9893
2913,農林,15,0,15,元大-大天母,2024-02-23,9893
00751B,元大AAA至A公司債,15,0,15,元大-大天母,2024-02-23,9893
6168,宏齊,474,7,467,元大-大天母,2024-02-26,9893
2892,第一金,257,8,249,元大-大天母,2024-02-26,9893
2890,永豐金,200,0,200,元大-大天母,2024-02-26,9893
00878,國泰永續高股息,189,2,187,元大-大天母,2024-02-26,9893
00679B,元大美債20年,195,11,184,元大-大天母,2024-02-26,9893
1504,東元,155,3,152,元大-大天母,2024-02-26,9893
2885,元大金,109,0,109,元大-大天母,2024-02-26,9893
3583,辛耘,268,165,103,元大-大天母,2024-02-26,9893
00929,復華台灣科技優息,113,12,101,元大-大天母,2024-02-26,9893
00933B,國泰10Y+金融債,99,2,97,元大-大天母,2024-02-26,9893
00665L,富邦�琤肭磪囓�2,70,0,70,元大-大天母,2024-02-26,9893
3231,緯創,75,20,55,元大-大天母,2024-02-26,9893
00687B,國泰20年美債,60,7,53,元大-大天母,2024-02-26,9893
6226,光鼎,51,0,51,元大-大天母,2024-02-26,9893
2547,日勝生,50,0,50,元大-大天母,2024-02-26,9893
1609,大亞,81,31,50,元大-大天母,2024-02-26,9893
1513,中興電,109,65,44,元大-大天母,2024-02-26,9893
2371,大同,106,64,42,元大-大天母,2024-02-26,9893
1514,亞力,78,36,42,元大-大天母,2024-02-26,9893
00680L,元大美債20正2,59,19,40,元大-大天母,2024-02-26,9893
2002,中鋼,41,2,39,元大-大天母,2024-02-26,9893
2495,普安,42,3,39,元大-大天母,2024-02-26,9893
2382,廣達,42,4,38,元大-大天母,2024-02-26,9893
5452,佶優,70,34,36,元大-大天母,2024-02-26,9893
2520,冠德,36,0,36,元大-大天母,2024-02-26,9893
3687,歐買尬,35,1,34,元大-大天母,2024-02-26,9893
2301,光寶科,37,4,33,元大-大天母,2024-02-26,9893
3481,群創,33,0,33,元大-大天母,2024-02-26,9893
2609,陽明,44,12,32,元大-大天母,2024-02-26,9893
3532,台勝科,31,0,31,元大-大天母,2024-02-26,9893
6830,汎銓,27,0,27,元大-大天母,2024-02-26,9893
2467,志聖,30,5,25,元大-大天母,2024-02-26,9893
4908,前鼎,40,17,23,元大-大天母,2024-02-26,9893
006206,元大上證50,21,0,21,元大-大天母,2024-02-26,9893
00676R,富邦臺灣加權反1,20,0,20,元大-大天母,2024-02-26,9893
0061,元大寶滬深,20,0,20,元大-大天母,2024-02-26,9893
1536,和大,23,3,20,元大-大天母,2024-02-26,9893
2313,華通,25,6,19,元大-大天母,2024-02-26,9893
00850,元大臺灣ESG永續,20,1,19,元大-大天母,2024-02-26,9893
5488,松普,21,2,19,元大-大天母,2024-02-26,9893
00922,國泰台灣領袖50,20,2,18,元大-大天母,2024-02-26,9893
2363,矽統,49,32,17,元大-大天母,2024-02-26,9893
2353,宏��,29,12,17,元大-大天母,2024-02-26,9893
5381,合正,19,2,17,元大-大天母,2024-02-26,9893
2303,聯電,20,3,17,元大-大天母,2024-02-26,9893
8473,山林水,17,0,17,元大-大天母,2024-02-26,9893
00753L,中信中國50正2,35,18,17,元大-大天母,2024-02-26,9893
2605,新興,23,6,17,元大-大天母,2024-02-26,9893
1305,華夏,15,0,15,元大-大天母,2024-02-26,9893
3289,宜特,16,1,15,元大-大天母,2024-02-26,9893
00878,國泰永續高股息,338,28,310,元大-大天母,2024-02-27,9893
00937B,群益ESG投等債20,270,1,269,元大-大天母,2024-02-27,9893
00687B,國泰20年美債,248,2,246,元大-大天母,2024-02-27,9893
6168,宏齊,319,84,235,元大-大天母,2024-02-27,9893
3231,緯創,175,59,116,元大-大天母,2024-02-27,9893
2371,大同,143,35,108,元大-大天母,2024-02-27,9893
2617,台航,101,6,95,元大-大天母,2024-02-27,9893
2382,廣達,91,6,85,元大-大天母,2024-02-27,9893
00632R,元大台灣50反1,75,0,75,元大-大天母,2024-02-27,9893
00679B,元大美債20年,85,20,65,元大-大天母,2024-02-27,9893
2363,矽統,138,74,64,元大-大天母,2024-02-27,9893
00922,國泰台灣領袖50,61,0,61,元大-大天母,2024-02-27,9893
3044,健鼎,62,3,59,元大-大天母,2024-02-27,9893
0056,元大高股息,67,14,53,元大-大天母,2024-02-27,9893
00913,兆豐台灣晶圓製造,51,0,51,元大-大天母,2024-02-27,9893
00641R,富邦日本反1,50,0,50,元大-大天母,2024-02-27,9893
2006,東和鋼鐵,50,1,49,元大-大天母,2024-02-27,9893
6176,瑞儀,41,0,41,元大-大天母,2024-02-27,9893
00882,中信中國高股息,39,0,39,元大-大天母,2024-02-27,9893
2883,凱基金,40,1,39,元大-大天母,2024-02-27,9893
3706,神達,39,2,37,元大-大天母,2024-02-27,9893
3583,辛耘,55,21,34,元大-大天母,2024-02-27,9893
00933B,國泰10Y+金融債,52,20,32,元大-大天母,2024-02-27,9893
00885,富邦越南,51,20,31,元大-大天母,2024-02-27,9893
1102,亞泥,30,1,29,元大-大天母,2024-02-27,9893
1604,聲寶,28,0,28,元大-大天母,2024-02-27,9893
4503,金雨,31,4,27,元大-大天母,2024-02-27,9893
2353,宏��,44,18,26,元大-大天母,2024-02-27,9893
00753L,中信中國50正2,25,0,25,元大-大天母,2024-02-27,9893
3289,宜特,26,1,25,元大-大天母,2024-02-27,9893
2412,中華電,25,0,25,元大-大天母,2024-02-27,9893
3689,湧德,37,12,25,元大-大天母,2024-02-27,9893
8096,擎亞,112,88,24,元大-大天母,2024-02-27,9893
3037,欣興,90,67,23,元大-大天母,2024-02-27,9893
2211,長榮鋼,22,0,22,元大-大天母,2024-02-27,9893
3227,原相,29,7,22,元大-大天母,2024-02-27,9893
3376,新日興,26,5,21,元大-大天母,2024-02-27,9893
00918,大華優利高填息30,23,3,20,元大-大天母,2024-02-27,9893
8046,南電,20,1,19,元大-大天母,2024-02-27,9893
4303,信立,21,3,18,元大-大天母,2024-02-27,9893
4526,東台,21,3,18,元大-大天母,2024-02-27,9893
6282,康舒,20,2,18,元大-大天母,2024-02-27,9893
6126,信音,26,9,17,元大-大天母,2024-02-27,9893
4747,強生,17,0,17,元大-大天母,2024-02-27,9893
6125,廣運,70,53,17,元大-大天母,2024-02-27,9893
8027,鈦昇,25,8,17,元大-大天母,2024-02-27,9893
6426,統新,20,3,17,元大-大天母,2024-02-27,9893
00935,野村臺灣新科技50,20,4,16,元大-大天母,2024-02-27,9893
3481,群創,21,5,16,元大-大天母,2024-02-27,9893
1722,台肥,16,0,16,元大-大天母,2024-02-27,9893
00919,群益台灣精選高息,266,78,188,元大-大天母,2024-02-29,9893
00937B,群益ESG投等債20,165,3,162,元大-大天母,2024-02-29,9893
2421,建準,132,2,130,元大-大天母,2024-02-29,9893
00680L,元大美債20正2,117,0,117,元大-大天母,2024-02-29,9893
5347,世界,114,0,114,元大-大天母,2024-02-29,9893
2449,京元電子,103,7,96,元大-大天母,2024-02-29,9893
00753L,中信中國50正2,87,0,87,元大-大天母,2024-02-29,9893
2303,聯電,154,77,77,元大-大天母,2024-02-29,9893
2376,技嘉,58,9,49,元大-大天母,2024-02-29,9893
5452,佶優,72,23,49,元大-大天母,2024-02-29,9893
2417,圓剛,82,34,48,元大-大天母,2024-02-29,9893
00878,國泰永續高股息,64,16,48,元大-大天母,2024-02-29,9893
00687B,國泰20年美債,46,1,45,元大-大天母,2024-02-29,9893
00929,復華台灣科技優息,123,82,41,元大-大天母,2024-02-29,9893
00688L,國泰20年美債正2,50,10,40,元大-大天母,2024-02-29,9893
2329,華泰,73,35,38,元大-大天母,2024-02-29,9893
3591,艾笛森,37,0,37,元大-大天母,2024-02-29,9893
3231,緯創,69,33,36,元大-大天母,2024-02-29,9893
2006,東和鋼鐵,37,1,36,元大-大天母,2024-02-29,9893
00650L,復華香港正2,35,0,35,元大-大天母,2024-02-29,9893
2834,臺企銀,36,1,35,元大-大天母,2024-02-29,9893
2353,宏��,36,4,32,元大-大天母,2024-02-29,9893
2363,矽統,34,2,32,元大-大天母,2024-02-29,9893
00673R,期元大S＆P原油反1,32,0,32,元大-大天母,2024-02-29,9893
2406,國碩,31,0,31,元大-大天母,2024-02-29,9893
00676R,富邦臺灣加權反1,30,0,30,元大-大天母,2024-02-29,9893
1711,永光,77,49,28,元大-大天母,2024-02-29,9893
2235,謚源,27,0,27,元大-大天母,2024-02-29,9893
6613,朋億*,28,1,27,元大-大天母,2024-02-29,9893
00720B,元大投資級公司債,26,3,23,元大-大天母,2024-02-29,9893
8926,台汽電,40,17,23,元大-大天母,2024-02-29,9893
3037,欣興,31,9,22,元大-大天母,2024-02-29,9893
3372,典範,21,1,20,元大-大天母,2024-02-29,9893
2368,金像電,26,7,19,元大-大天母,2024-02-29,9893
3689,湧德,22,4,18,元大-大天母,2024-02-29,9893
2317,鴻海,25,8,17,元大-大天母,2024-02-29,9893
2605,新興,26,9,17,元大-大天母,2024-02-29,9893
3044,健鼎,17,0,17,元大-大天母,2024-02-29,9893
1809,中釉,21,5,16,元大-大天母,2024-02-29,9893
2915,潤泰全,17,2,15,元大-大天母,2024-02-29,9893
2355,敬鵬,18,4,14,元大-大天母,2024-02-29,9893
6691,洋基工程,14,0,14,元大-大天母,2024-02-29,9893
3481,群創,14,0,14,元大-大天母,2024-02-29,9893
1535,中宇,17,3,14,元大-大天母,2024-02-29,9893
2002,中鋼,14,1,13,元大-大天母,2024-02-29,9893
3581,博磊,14,1,13,元大-大天母,2024-02-29,9893
4979,華星光,13,0,13,元大-大天母,2024-02-29,9893
2330,台積電,16,3,13,元大-大天母,2024-02-29,9893
00679B,元大美債20年,12,0,12,元大-大天母,2024-02-29,9893
6799,來頡,17,5,12,元大-大天母,2024-02-29,9893
3005,神基,239,23,216,元大-大天母,2024-03-01,9893
00937B,群益ESG投等債20,205,2,203,元大-大天母,2024-03-01,9893
8086,宏捷科,204,4,200,元大-大天母,2024-03-01,9893
2303,聯電,202,9,193,元大-大天母,2024-03-01,9893
2376,技嘉,208,65,143,元大-大天母,2024-03-01,9893
00637L,元大滬深300正2,140,18,122,元大-大天母,2024-03-01,9893
4543,萬在,133,16,117,元大-大天母,2024-03-01,9893
00919,群益台灣精選高息,169,61,108,元大-大天母,2024-03-01,9893
2890,永豐金,104,0,104,元大-大天母,2024-03-01,9893
2617,台航,100,0,100,元大-大天母,2024-03-01,9893
5309,系統電,180,80,100,元大-大天母,2024-03-01,9893
2892,第一金,101,2,99,元大-大天母,2024-03-01,9893
00929,復華台灣科技優息,124,61,63,元大-大天母,2024-03-01,9893
2383,台光電,55,0,55,元大-大天母,2024-03-01,9893
1711,永光,56,2,54,元大-大天母,2024-03-01,9893
00857B,永豐20年美公債,50,0,50,元大-大天母,2024-03-01,9893
00666R,富邦�琤肭磪齯�1,50,0,50,元大-大天母,2024-03-01,9893
00679B,元大美債20年,48,4,44,元大-大天母,2024-03-01,9893
1409,新纖,44,0,44,元大-大天母,2024-03-01,9893
3048,益登,40,0,40,元大-大天母,2024-03-01,9893
6176,瑞儀,41,2,39,元大-大天母,2024-03-01,9893
2618,長榮航,54,17,37,元大-大天母,2024-03-01,9893
00720B,元大投資級公司債,36,0,36,元大-大天母,2024-03-01,9893
4102,永日,35,0,35,元大-大天母,2024-03-01,9893
8085,福華,133,99,34,元大-大天母,2024-03-01,9893
2006,東和鋼鐵,35,1,34,元大-大天母,2024-03-01,9893
2637,慧洋-KY,32,1,31,元大-大天母,2024-03-01,9893
00918,大華優利高填息30,35,8,27,元大-大天母,2024-03-01,9893
3324,雙鴻,33,7,26,元大-大天母,2024-03-01,9893
3036,文曄,42,16,26,元大-大天母,2024-03-01,9893
6290,良維,105,80,25,元大-大天母,2024-03-01,9893
2399,映泰,45,22,23,元大-大天母,2024-03-01,9893
3588,通嘉,24,1,23,元大-大天母,2024-03-01,9893
2882,國泰金,25,4,21,元大-大天母,2024-03-01,9893
00933B,國泰10Y+金融債,25,5,20,元大-大天母,2024-03-01,9893
3532,台勝科,30,10,20,元大-大天母,2024-03-01,9893
1312,國喬,20,0,20,元大-大天母,2024-03-01,9893
3687,歐買尬,20,0,20,元大-大天母,2024-03-01,9893
1903,士紙,20,0,20,元大-大天母,2024-03-01,9893
6435,大中,20,0,20,元大-大天母,2024-03-01,9893
2636,台驊控股,19,0,19,元大-大天母,2024-03-01,9893
2476,鉅祥,19,0,19,元大-大天母,2024-03-01,9893
5272,笙科,25,6,19,元大-大天母,2024-03-01,9893
6509,聚和,19,0,19,元大-大天母,2024-03-01,9893
1513,中興電,84,66,18,元大-大天母,2024-03-01,9893
5202,力新,23,5,18,元大-大天母,2024-03-01,9893
9105,泰金寶-DR,20,4,16,元大-大天母,2024-03-01,9893
1535,中宇,24,8,16,元大-大天母,2024-03-01,9893
2352,佳世達,20,4,16,元大-大天母,2024-03-01,9893
8936,國統,25,10,15,元大-大天母,2024-03-01,9893
00919,群益台灣精選高息,1221,33,1188,元大-大天母,2024-03-04,9893
1815,富喬,500,55,445,元大-大天母,2024-03-04,9893
00665L,富邦�琤肭磪囓�2,244,2,242,元大-大天母,2024-03-04,9893
00937B,群益ESG投等債20,221,1,220,元大-大天母,2024-03-04,9893
00632R,元大台灣50反1,148,0,148,元大-大天母,2024-03-04,9893
2406,國碩,146,12,134,元大-大天母,2024-03-04,9893
00673R,期元大S＆P原油反1,104,0,104,元大-大天母,2024-03-04,9893
2885,元大金,100,0,100,元大-大天母,2024-03-04,9893
5309,系統電,100,0,100,元大-大天母,2024-03-04,9893
9933,中鼎,100,0,100,元大-大天母,2024-03-04,9893
00902,中信電池及儲能,100,4,96,元大-大天母,2024-03-04,9893
4974,亞泰,92,1,91,元大-大天母,2024-03-04,9893
2371,大同,181,92,89,元大-大天母,2024-03-04,9893
3047,訊舟,83,0,83,元大-大天母,2024-03-04,9893
00929,復華台灣科技優息,157,85,72,元大-大天母,2024-03-04,9893
8926,台汽電,69,2,67,元大-大天母,2024-03-04,9893
4995,晶達,65,0,65,元大-大天母,2024-03-04,9893
2324,仁寶,192,128,64,元大-大天母,2024-03-04,9893
2006,東和鋼鐵,63,0,63,元大-大天母,2024-03-04,9893
2367,燿華,174,111,63,元大-大天母,2024-03-04,9893
1711,永光,56,1,55,元大-大天母,2024-03-04,9893
8049,晶采,62,7,55,元大-大天母,2024-03-04,9893
3356,奇偶,162,107,55,元大-大天母,2024-03-04,9893
00830,國泰費城半導體,53,2,51,元大-大天母,2024-03-04,9893
2312,金寶,53,2,51,元大-大天母,2024-03-04,9893
5347,世界,52,2,50,元大-大天母,2024-03-04,9893
00905,FT臺灣Smart,50,0,50,元大-大天母,2024-03-04,9893
9105,泰金寶-DR,50,0,50,元大-大天母,2024-03-04,9893
2105,正新,53,4,49,元大-大天母,2024-03-04,9893
00918,大華優利高填息30,48,0,48,元大-大天母,2024-03-04,9893
3231,緯創,73,26,47,元大-大天母,2024-03-04,9893
00687B,國泰20年美債,46,1,45,元大-大天母,2024-03-04,9893
3481,群創,50,8,42,元大-大天母,2024-03-04,9893
8112,至上,52,10,42,元大-大天母,2024-03-04,9893
2353,宏��,76,36,40,元大-大天母,2024-03-04,9893
2637,慧洋-KY,43,6,37,元大-大天母,2024-03-04,9893
6214,精誠,36,0,36,元大-大天母,2024-03-04,9893
4973,廣穎,31,0,31,元大-大天母,2024-03-04,9893
1785,光洋科,51,20,31,元大-大天母,2024-03-04,9893
00676R,富邦臺灣加權反1,30,0,30,元大-大天母,2024-03-04,9893
1615,大山,29,0,29,元大-大天母,2024-03-04,9893
3083,網龍,27,0,27,元大-大天母,2024-03-04,9893
00915,凱基優選高股息30,38,11,27,元大-大天母,2024-03-04,9893
00927,群益半導體收益,26,0,26,元大-大天母,2024-03-04,9893
00679B,元大美債20年,49,24,25,元大-大天母,2024-03-04,9893
2405,輔信,25,0,25,元大-大天母,2024-03-04,9893
6005,群益證,28,3,25,元大-大天母,2024-03-04,9893
6770,力積電,25,1,24,元大-大天母,2024-03-04,9893
2634,漢翔,27,3,24,元大-大天母,2024-03-04,9893
6290,良維,37,15,22,元大-大天母,2024-03-04,9893
1815,富喬,595,19,576,元大-大天母,2024-03-05,9893
00919,群益台灣精選高息,227,64,163,元大-大天母,2024-03-05,9893
5609,中菲行,134,0,134,元大-大天母,2024-03-05,9893
2324,仁寶,128,15,113,元大-大天母,2024-03-05,9893
2885,元大金,104,1,103,元大-大天母,2024-03-05,9893
5347,世界,100,0,100,元大-大天母,2024-03-05,9893
4906,正文,156,58,98,元大-大天母,2024-03-05,9893
1216,統一,99,1,98,元大-大天母,2024-03-05,9893
00937B,群益ESG投等債20,97,2,95,元大-大天母,2024-03-05,9893
00929,復華台灣科技優息,219,140,79,元大-大天母,2024-03-05,9893
00878,國泰永續高股息,102,26,76,元大-大天母,2024-03-05,9893
2887,台新金,70,0,70,元大-大天母,2024-03-05,9893
3481,群創,80,12,68,元大-大天母,2024-03-05,9893
00753L,中信中國50正2,62,0,62,元大-大天母,2024-03-05,9893
1711,永光,60,0,60,元大-大天母,2024-03-05,9893
1905,華紙,55,0,55,元大-大天母,2024-03-05,9893
6176,瑞儀,52,0,52,元大-大天母,2024-03-05,9893
00720B,元大投資級公司債,50,0,50,元大-大天母,2024-03-05,9893
00915,凱基優選高股息30,51,1,50,元大-大天母,2024-03-05,9893
1795,美時,53,5,48,元大-大天母,2024-03-05,9893
3163,波若威,62,17,45,元大-大天母,2024-03-05,9893
2440,太空梭,44,0,44,元大-大天母,2024-03-05,9893
2883,凱基金,61,21,40,元大-大天母,2024-03-05,9893
2301,光寶科,45,6,39,元大-大天母,2024-03-05,9893
1582,信錦,38,0,38,元大-大天母,2024-03-05,9893
00679B,元大美債20年,37,0,37,元大-大天母,2024-03-05,9893
00918,大華優利高填息30,42,6,36,元大-大天母,2024-03-05,9893
00632R,元大台灣50反1,35,0,35,元大-大天母,2024-03-05,9893
8926,台汽電,57,26,31,元大-大天母,2024-03-05,9893
4915,致伸,31,0,31,元大-大天母,2024-03-05,9893
1903,士紙,30,0,30,元大-大天母,2024-03-05,9893
2603,長榮,54,25,29,元大-大天母,2024-03-05,9893
2002,中鋼,30,2,28,元大-大天母,2024-03-05,9893
6591,動力-KY,33,5,28,元大-大天母,2024-03-05,9893
2382,廣達,47,19,28,元大-大天母,2024-03-05,9893
00665L,富邦�琤肭磪囓�2,64,38,26,元大-大天母,2024-03-05,9893
00687B,國泰20年美債,34,10,24,元大-大天母,2024-03-05,9893
8163,達方,44,21,23,元大-大天母,2024-03-05,9893
2354,鴻準,23,0,23,元大-大天母,2024-03-05,9893
00902,中信電池及儲能,23,0,23,元大-大天母,2024-03-05,9893
0056,元大高股息,60,39,21,元大-大天母,2024-03-05,9893
3078,僑威,21,0,21,元大-大天母,2024-03-05,9893
6179,亞通,20,0,20,元大-大天母,2024-03-05,9893
006206,元大上證50,20,0,20,元大-大天母,2024-03-05,9893
6426,統新,20,0,20,元大-大天母,2024-03-05,9893
3594,磐儀,20,0,20,元大-大天母,2024-03-05,9893
6494,九齊,20,0,20,元大-大天母,2024-03-05,9893
3044,健鼎,23,5,18,元大-大天母,2024-03-05,9893
4979,華星光,20,2,18,元大-大天母,2024-03-05,9893
1326,台化,18,0,18,元大-大天母,2024-03-05,9893
00919,群益台灣精選高息,222,47,175,元大-大天母,2024-03-06,9893
4306,炎洲,191,28,163,元大-大天母,2024-03-06,9893
5609,中菲行,139,2,137,元大-大天母,2024-03-06,9893
2352,佳世達,116,7,109,元大-大天母,2024-03-06,9893
1301,台塑,101,0,101,元大-大天母,2024-03-06,9893
00632R,元大台灣50反1,92,10,82,元大-大天母,2024-03-06,9893
2006,東和鋼鐵,80,0,80,元大-大天母,2024-03-06,9893
8926,台汽電,88,9,79,元大-大天母,2024-03-06,9893
2888,新光金,88,10,78,元大-大天母,2024-03-06,9893
3231,緯創,84,17,67,元大-大天母,2024-03-06,9893
2617,台航,65,0,65,元大-大天母,2024-03-06,9893
2618,長榮航,52,0,52,元大-大天母,2024-03-06,9893
00902,中信電池及儲能,48,0,48,元大-大天母,2024-03-06,9893
2031,新光鋼,51,8,43,元大-大天母,2024-03-06,9893
00712,復華富時不動產,42,0,42,元大-大天母,2024-03-06,9893
2421,建準,57,15,42,元大-大天母,2024-03-06,9893
1609,大亞,115,75,40,元大-大天母,2024-03-06,9893
2836,高雄銀,40,0,40,元大-大天母,2024-03-06,9893
2441,超豐,41,1,40,元大-大天母,2024-03-06,9893
00915,凱基優選高股息30,40,0,40,元大-大天母,2024-03-06,9893
6023,元大期,40,0,40,元大-大天母,2024-03-06,9893
3037,欣興,42,4,38,元大-大天母,2024-03-06,9893
6509,聚和,39,1,38,元大-大天母,2024-03-06,9893
6275,元山,57,22,35,元大-大天母,2024-03-06,9893
2504,國產,36,1,35,元大-大天母,2024-03-06,9893
2634,漢翔,34,0,34,元大-大天母,2024-03-06,9893
2344,華邦電,60,26,34,元大-大天母,2024-03-06,9893
00937B,群益ESG投等債20,36,3,33,元大-大天母,2024-03-06,9893
5009,榮剛,33,2,31,元大-大天母,2024-03-06,9893
2484,希華,31,0,31,元大-大天母,2024-03-06,9893
00753L,中信中國50正2,31,2,29,元大-大天母,2024-03-06,9893
3312,弘憶股,34,7,27,元大-大天母,2024-03-06,9893
2637,慧洋-KY,27,1,26,元大-大天母,2024-03-06,9893
6163,華電網,40,14,26,元大-大天母,2024-03-06,9893
2610,華航,26,1,25,元大-大天母,2024-03-06,9893
2301,光寶科,28,3,25,元大-大天母,2024-03-06,9893
6179,亞通,33,8,25,元大-大天母,2024-03-06,9893
00918,大華優利高填息30,29,5,24,元大-大天母,2024-03-06,9893
1608,華榮,33,9,24,元大-大天母,2024-03-06,9893
0061,元大寶滬深,25,1,24,元大-大天母,2024-03-06,9893
2449,京元電子,60,37,23,元大-大天母,2024-03-06,9893
1903,士紙,23,0,23,元大-大天母,2024-03-06,9893
3689,湧德,60,38,22,元大-大天母,2024-03-06,9893
6187,萬潤,21,0,21,元大-大天母,2024-03-06,9893
6531,愛普*,26,6,20,元大-大天母,2024-03-06,9893
00651R,復華香港反1,20,0,20,元大-大天母,2024-03-06,9893
8163,達方,60,40,20,元大-大天母,2024-03-06,9893
2609,陽明,32,12,20,元大-大天母,2024-03-06,9893
2472,立隆電,20,0,20,元大-大天母,2024-03-06,9893
5347,世界,21,1,20,元大-大天母,2024-03-06,9893
8091,翔名,288,0,288,元大-大天母,2024-03-07,9893
3231,緯創,189,23,166,元大-大天母,2024-03-07,9893
3163,波若威,173,20,153,元大-大天母,2024-03-07,9893
2031,新光鋼,134,1,133,元大-大天母,2024-03-07,9893
6245,立端,136,18,118,元大-大天母,2024-03-07,9893
00679B,元大美債20年,132,18,114,元大-大天母,2024-03-07,9893
8926,台汽電,113,10,103,元大-大天母,2024-03-07,9893
2892,第一金,104,5,99,元大-大天母,2024-03-07,9893
1210,大成,101,2,99,元大-大天母,2024-03-07,9893
3532,台勝科,95,0,95,元大-大天母,2024-03-07,9893
1711,永光,90,0,90,元大-大天母,2024-03-07,9893
9933,中鼎,101,12,89,元大-大天母,2024-03-07,9893
2617,台航,85,1,84,元大-大天母,2024-03-07,9893
2301,光寶科,86,3,83,元大-大天母,2024-03-07,9893
2027,大成鋼,86,4,82,元大-大天母,2024-03-07,9893
1785,光洋科,80,13,67,元大-大天母,2024-03-07,9893
6168,宏齊,67,3,64,元大-大天母,2024-03-07,9893
1102,亞泥,63,0,63,元大-大天母,2024-03-07,9893
1903,士紙,63,0,63,元大-大天母,2024-03-07,9893
4961,天鈺,61,0,61,元大-大天母,2024-03-07,9893
00637L,元大滬深300正2,62,7,55,元大-大天母,2024-03-07,9893
2358,廷鑫,55,0,55,元大-大天母,2024-03-07,9893
2352,佳世達,55,1,54,元大-大天母,2024-03-07,9893
6197,佳必琪,52,1,51,元大-大天母,2024-03-07,9893
3264,欣銓,61,11,50,元大-大天母,2024-03-07,9893
2359,所羅門,48,3,45,元大-大天母,2024-03-07,9893
00919,群益台灣精選高息,182,139,43,元大-大天母,2024-03-07,9893
3083,網龍,43,1,42,元大-大天母,2024-03-07,9893
2006,東和鋼鐵,40,0,40,元大-大天母,2024-03-07,9893
6139,亞翔,40,3,37,元大-大天母,2024-03-07,9893
00896,中信綠能及電動車,38,3,35,元大-大天母,2024-03-07,9893
8476,台境*,35,0,35,元大-大天母,2024-03-07,9893
2371,大同,38,4,34,元大-大天母,2024-03-07,9893
00751B,元大AAA至A公司債,40,7,33,元大-大天母,2024-03-07,9893
6204,艾華,32,0,32,元大-大天母,2024-03-07,9893
00937B,群益ESG投等債20,51,20,31,元大-大天母,2024-03-07,9893
5488,松普,31,0,31,元大-大天母,2024-03-07,9893
8039,台虹,30,0,30,元大-大天母,2024-03-07,9893
00676R,富邦臺灣加權反1,30,0,30,元大-大天母,2024-03-07,9893
2515,中工,36,7,29,元大-大天母,2024-03-07,9893
3338,泰碩,174,145,29,元大-大天母,2024-03-07,9893
2607,榮運,34,5,29,元大-大天母,2024-03-07,9893
00673R,期元大S＆P原油反1,29,0,29,元大-大天母,2024-03-07,9893
1609,大亞,39,10,29,元大-大天母,2024-03-07,9893
00632R,元大台灣50反1,128,100,28,元大-大天母,2024-03-07,9893
6190,萬泰科,35,8,27,元大-大天母,2024-03-07,9893
00687B,國泰20年美債,33,6,27,元大-大天母,2024-03-07,9893
5521,工信,35,9,26,元大-大天母,2024-03-07,9893
00892,富邦台灣半導體,30,4,26,元大-大天母,2024-03-07,9893
00722B,群益投資級電信債,25,0,25,元大-大天母,2024-03-07,9893
2031,新光鋼,447,1,446,元大-大天母,2024-03-08,9893
8926,台汽電,130,13,117,元大-大天母,2024-03-08,9893
3163,波若威,120,28,92,元大-大天母,2024-03-08,9893
1711,永光,90,1,89,元大-大天母,2024-03-08,9893
6168,宏齊,85,0,85,元大-大天母,2024-03-08,9893
5609,中菲行,71,2,69,元大-大天母,2024-03-08,9893
8091,翔名,65,2,63,元大-大天母,2024-03-08,9893
6179,亞通,60,3,57,元大-大天母,2024-03-08,9893
2014,中鴻,52,0,52,元大-大天母,2024-03-08,9893
5347,世界,66,15,51,元大-大天母,2024-03-08,9893
2617,台航,50,0,50,元大-大天母,2024-03-08,9893
3047,訊舟,50,0,50,元大-大天母,2024-03-08,9893
1210,大成,50,0,50,元大-大天母,2024-03-08,9893
4977,眾達-KY,50,0,50,元大-大天母,2024-03-08,9893
2360,致茂,52,2,50,元大-大天母,2024-03-08,9893
2836,高雄銀,66,18,48,元大-大天母,2024-03-08,9893
2540,愛山林,48,0,48,元大-大天母,2024-03-08,9893
00937B,群益ESG投等債20,46,0,46,元大-大天母,2024-03-08,9893
8105,凌巨,49,3,46,元大-大天母,2024-03-08,9893
2347,聯強,44,0,44,元大-大天母,2024-03-08,9893
5443,均豪,46,3,43,元大-大天母,2024-03-08,9893
00918,大華優利高填息30,73,30,43,元大-大天母,2024-03-08,9893
00679B,元大美債20年,39,2,37,元大-大天母,2024-03-08,9893
2377,微星,43,7,36,元大-大天母,2024-03-08,9893
3006,晶豪科,35,0,35,元大-大天母,2024-03-08,9893
2498,宏達電,47,13,34,元大-大天母,2024-03-08,9893
00706L,期元大S＆P日圓正2,34,0,34,元大-大天母,2024-03-08,9893
5521,工信,35,1,34,元大-大天母,2024-03-08,9893
1815,富喬,50,16,34,元大-大天母,2024-03-08,9893
6005,群益證,79,48,31,元大-大天母,2024-03-08,9893
5534,長虹,30,0,30,元大-大天母,2024-03-08,9893
00648R,元大S＆P500反1,30,0,30,元大-大天母,2024-03-08,9893
2408,南亞科,29,0,29,元大-大天母,2024-03-08,9893
1725,元禎,29,0,29,元大-大天母,2024-03-08,9893
2329,華泰,33,5,28,元大-大天母,2024-03-08,9893
2313,華通,36,8,28,元大-大天母,2024-03-08,9893
3645,達邁,46,18,28,元大-大天母,2024-03-08,9893
2634,漢翔,34,7,27,元大-大天母,2024-03-08,9893
00673R,期元大S＆P原油反1,26,0,26,元大-大天母,2024-03-08,9893
1903,士紙,26,0,26,元大-大天母,2024-03-08,9893
6806,森崴能源,37,12,25,元大-大天母,2024-03-08,9893
3587,閎康,26,2,24,元大-大天母,2024-03-08,9893
8086,宏捷科,36,14,22,元大-大天母,2024-03-08,9893
3711,日月光投控,49,28,21,元大-大天母,2024-03-08,9893
1905,華紙,21,0,21,元大-大天母,2024-03-08,9893
00676R,富邦臺灣加權反1,20,0,20,元大-大天母,2024-03-08,9893
6591,動力-KY,27,7,20,元大-大天母,2024-03-08,9893
00671R,富邦NASDAQ反1,20,0,20,元大-大天母,2024-03-08,9893
5512,力麒,21,1,20,元大-大天母,2024-03-08,9893
0056,元大高股息,68,49,19,元大-大天母,2024-03-08,9893
8040,九暘,838,6,832,元大-大天母,2024-03-11,9893
2303,聯電,590,175,415,元大-大天母,2024-03-11,9893
00937B,群益ESG投等債20,210,21,189,元大-大天母,2024-03-11,9893
00857B,永豐20年美公債,179,2,177,元大-大天母,2024-03-11,9893
1409,新纖,152,0,152,元大-大天母,2024-03-11,9893
2886,兆豐金,104,20,84,元大-大天母,2024-03-11,9893
2883,凱基金,95,21,74,元大-大天母,2024-03-11,9893
00632R,元大台灣50反1,72,0,72,元大-大天母,2024-03-11,9893
2881,富邦金,74,3,71,元大-大天母,2024-03-11,9893
00929,復華台灣科技優息,100,38,62,元大-大天母,2024-03-11,9893
5347,世界,64,3,61,元大-大天母,2024-03-11,9893
00655L,國泰中國A50正2,60,0,60,元大-大天母,2024-03-11,9893
2006,東和鋼鐵,60,1,59,元大-大天母,2024-03-11,9893
00687B,國泰20年美債,58,1,57,元大-大天母,2024-03-11,9893
2031,新光鋼,57,0,57,元大-大天母,2024-03-11,9893
3711,日月光投控,58,4,54,元大-大天母,2024-03-11,9893
2890,永豐金,57,3,54,元大-大天母,2024-03-11,9893
3048,益登,53,0,53,元大-大天母,2024-03-11,9893
2882,國泰金,90,39,51,元大-大天母,2024-03-11,9893
3047,訊舟,50,0,50,元大-大天母,2024-03-11,9893
1711,永光,50,0,50,元大-大天母,2024-03-11,9893
3163,波若威,139,89,50,元大-大天母,2024-03-11,9893
6187,萬潤,50,1,49,元大-大天母,2024-03-11,9893
2211,長榮鋼,49,1,48,元大-大天母,2024-03-11,9893
2371,大同,44,4,40,元大-大天母,2024-03-11,9893
2301,光寶科,38,0,38,元大-大天母,2024-03-11,9893
2367,燿華,68,34,34,元大-大天母,2024-03-11,9893
2330,台積電,46,13,33,元大-大天母,2024-03-11,9893
2344,華邦電,37,4,33,元大-大天母,2024-03-11,9893
2701,萬企,30,0,30,元大-大天母,2024-03-11,9893
1712,興農,30,0,30,元大-大天母,2024-03-11,9893
2885,元大金,34,6,28,元大-大天母,2024-03-11,9893
00918,大華優利高填息30,63,35,28,元大-大天母,2024-03-11,9893
8150,南茂,29,3,26,元大-大天母,2024-03-11,9893
2892,第一金,24,0,24,元大-大天母,2024-03-11,9893
00933B,國泰10Y+金融債,23,0,23,元大-大天母,2024-03-11,9893
2504,國產,22,0,22,元大-大天母,2024-03-11,9893
2359,所羅門,29,7,22,元大-大天母,2024-03-11,9893
6176,瑞儀,23,2,21,元大-大天母,2024-03-11,9893
0061,元大寶滬深,20,0,20,元大-大天母,2024-03-11,9893
3631,晟楠,20,0,20,元大-大天母,2024-03-11,9893
3615,安可,20,0,20,元大-大天母,2024-03-11,9893
6613,朋億*,20,0,20,元大-大天母,2024-03-11,9893
2834,臺企銀,19,0,19,元大-大天母,2024-03-11,9893
6275,元山,22,3,19,元大-大天母,2024-03-11,9893
1609,大亞,21,2,19,元大-大天母,2024-03-11,9893
6278,台表科,43,24,19,元大-大天母,2024-03-11,9893
6805,富世達,19,1,18,元大-大天母,2024-03-11,9893
00715L,期街口布蘭特正2,18,0,18,元大-大天母,2024-03-11,9893
1326,台化,17,0,17,元大-大天母,2024-03-11,9893
2317,鴻海,2308,245,2063,元大-大天母,2024-03-12,9893
8040,九暘,520,24,496,元大-大天母,2024-03-12,9893
2006,東和鋼鐵,220,10,210,元大-大天母,2024-03-12,9893
2313,華通,248,109,139,元大-大天母,2024-03-12,9893
2371,大同,253,122,131,元大-大天母,2024-03-12,9893
00857B,永豐20年美公債,122,1,121,元大-大天母,2024-03-12,9893
5609,中菲行,108,0,108,元大-大天母,2024-03-12,9893
2890,永豐金,105,1,104,元大-大天母,2024-03-12,9893
5347,世界,104,8,96,元大-大天母,2024-03-12,9893
9933,中鼎,102,13,89,元大-大天母,2024-03-12,9893
00706L,期元大S＆P日圓正2,59,0,59,元大-大天母,2024-03-12,9893
2367,燿華,174,116,58,元大-大天母,2024-03-12,9893
00632R,元大台灣50反1,58,0,58,元大-大天母,2024-03-12,9893
00687B,國泰20年美債,58,0,58,元大-大天母,2024-03-12,9893
2610,華航,67,11,56,元大-大天母,2024-03-12,9893
2634,漢翔,53,1,52,元大-大天母,2024-03-12,9893
6806,森崴能源,55,4,51,元大-大天母,2024-03-12,9893
2332,友訊,50,0,50,元大-大天母,2024-03-12,9893
1409,新纖,50,0,50,元大-大天母,2024-03-12,9893
00751B,元大AAA至A公司債,47,2,45,元大-大天母,2024-03-12,9893
2885,元大金,48,5,43,元大-大天母,2024-03-12,9893
5519,隆大,58,20,38,元大-大天母,2024-03-12,9893
00918,大華優利高填息30,101,64,37,元大-大天母,2024-03-12,9893
8936,國統,46,11,35,元大-大天母,2024-03-12,9893
2836,高雄銀,55,22,33,元大-大天母,2024-03-12,9893
4714,永捷,60,29,31,元大-大天母,2024-03-12,9893
2344,華邦電,33,2,31,元大-大天母,2024-03-12,9893
00881,國泰台灣5G+,27,0,27,元大-大天母,2024-03-12,9893
5488,松普,52,25,27,元大-大天母,2024-03-12,9893
00919,群益台灣精選高息,50,23,27,元大-大天母,2024-03-12,9893
1513,中興電,59,33,26,元大-大天母,2024-03-12,9893
00933B,國泰10Y+金融債,24,0,24,元大-大天母,2024-03-12,9893
1805,寶徠,44,20,24,元大-大天母,2024-03-12,9893
1316,上曜,24,0,24,元大-大天母,2024-03-12,9893
8096,擎亞,38,16,22,元大-大天母,2024-03-12,9893
1303,南亞,24,2,22,元大-大天母,2024-03-12,9893
00885,富邦越南,22,0,22,元大-大天母,2024-03-12,9893
1582,信錦,50,29,21,元大-大天母,2024-03-12,9893
4919,新唐,22,1,21,元大-大天母,2024-03-12,9893
2323,中環,27,6,21,元大-大天母,2024-03-12,9893
3540,曜越,24,3,21,元大-大天母,2024-03-12,9893
00921,兆豐龍頭等權重,20,0,20,元大-大天母,2024-03-12,9893
00936,台新永續高息中小,20,0,20,元大-大天母,2024-03-12,9893
8150,南茂,33,13,20,元大-大天母,2024-03-12,9893
3438,類比科,20,0,20,元大-大天母,2024-03-12,9893
00676R,富邦臺灣加權反1,20,0,20,元大-大天母,2024-03-12,9893
00934,中信成長高股息,20,0,20,元大-大天母,2024-03-12,9893
1101,台泥,20,1,19,元大-大天母,2024-03-12,9893
2376,技嘉,23,4,19,元大-大天母,2024-03-12,9893
2301,光寶科,24,5,19,元大-大天母,2024-03-12,9893
00687B,國泰20年美債,233,11,222,元大-大天母,2024-03-13,9893
00919,群益台灣精選高息,243,35,208,元大-大天母,2024-03-13,9893
3231,緯創,245,42,203,元大-大天母,2024-03-13,9893
2006,東和鋼鐵,130,0,130,元大-大天母,2024-03-13,9893
00918,大華優利高填息30,135,5,130,元大-大天母,2024-03-13,9893
1616,億泰,130,3,127,元大-大天母,2024-03-13,9893
8040,九暘,119,5,114,元大-大天母,2024-03-13,9893
4906,正文,116,6,110,元大-大天母,2024-03-13,9893
6168,宏齊,100,0,100,元大-大天母,2024-03-13,9893
6016,康和證,104,13,91,元大-大天母,2024-03-13,9893
00937B,群益ESG投等債20,93,3,90,元大-大天母,2024-03-13,9893
00885,富邦越南,90,0,90,元大-大天母,2024-03-13,9893
2031,新光鋼,80,0,80,元大-大天母,2024-03-13,9893
2449,京元電子,82,5,77,元大-大天母,2024-03-13,9893
00679B,元大美債20年,48,2,46,元大-大天母,2024-03-13,9893
00933B,國泰10Y+金融債,45,0,45,元大-大天母,2024-03-13,9893
3048,益登,42,0,42,元大-大天母,2024-03-13,9893
5488,松普,70,30,40,元大-大天母,2024-03-13,9893
00929,復華台灣科技優息,157,117,40,元大-大天母,2024-03-13,9893
4714,永捷,66,28,38,元大-大天母,2024-03-13,9893
5443,均豪,54,16,38,元大-大天母,2024-03-13,9893
6213,聯茂,150,114,36,元大-大天母,2024-03-13,9893
2610,華航,38,3,35,元大-大天母,2024-03-13,9893
2618,長榮航,44,9,35,元大-大天母,2024-03-13,9893
2344,華邦電,45,12,33,元大-大天母,2024-03-13,9893
1608,華榮,35,2,33,元大-大天母,2024-03-13,9893
3234,光環,34,2,32,元大-大天母,2024-03-13,9893
1409,新纖,31,0,31,元大-大天母,2024-03-13,9893
00905,FT臺灣Smart,30,0,30,元大-大天母,2024-03-13,9893
2886,兆豐金,51,22,29,元大-大天母,2024-03-13,9893
00751B,元大AAA至A公司債,27,1,26,元大-大天母,2024-03-13,9893
00857B,永豐20年美公債,26,0,26,元大-大天母,2024-03-13,9893
1805,寶徠,25,0,25,元大-大天母,2024-03-13,9893
00637L,元大滬深300正2,40,16,24,元大-大天母,2024-03-13,9893
2408,南亞科,38,14,24,元大-大天母,2024-03-13,9893
3714,富采,25,2,23,元大-大天母,2024-03-13,9893
2382,廣達,38,16,22,元大-大天母,2024-03-13,9893
5483,中美晶,26,5,21,元大-大天母,2024-03-13,9893
1524,耿鼎,110,90,20,元大-大天母,2024-03-13,9893
1305,華夏,20,0,20,元大-大天母,2024-03-13,9893
1731,美吾華,20,0,20,元大-大天母,2024-03-13,9893
4973,廣穎,20,0,20,元大-大天母,2024-03-13,9893
3443,創意,20,1,19,元大-大天母,2024-03-13,9893
2241,艾姆勒,34,15,19,元大-大天母,2024-03-13,9893
6116,彩晶,20,1,19,元大-大天母,2024-03-13,9893
3583,辛耘,26,7,19,元大-大天母,2024-03-13,9893
5410,國眾,22,3,19,元大-大天母,2024-03-13,9893
3706,神達,35,16,19,元大-大天母,2024-03-13,9893
3071,協禧,28,9,19,元大-大天母,2024-03-13,9893
2543,皇昌,26,9,17,元大-大天母,2024-03-13,9893
1455,集盛,1003,11,992,元大-大天母,2024-03-14,9893
2889,國票金,504,18,486,元大-大天母,2024-03-14,9893
00919,群益台灣精選高息,511,108,403,元大-大天母,2024-03-14,9893
00929,復華台灣科技優息,278,107,171,元大-大天母,2024-03-14,9893
2504,國產,118,5,113,元大-大天母,2024-03-14,9893
2303,聯電,523,419,104,元大-大天母,2024-03-14,9893
2449,京元電子,103,0,103,元大-大天母,2024-03-14,9893
1301,台塑,106,3,103,元大-大天母,2024-03-14,9893
3005,神基,229,131,98,元大-大天母,2024-03-14,9893
1316,上曜,135,40,95,元大-大天母,2024-03-14,9893
5609,中菲行,96,1,95,元大-大天母,2024-03-14,9893
2883,凱基金,177,94,83,元大-大天母,2024-03-14,9893
2109,華豐,70,0,70,元大-大天母,2024-03-14,9893
00751B,元大AAA至A公司債,62,0,62,元大-大天母,2024-03-14,9893
3711,日月光投控,65,4,61,元大-大天母,2024-03-14,9893
4532,瑞智,60,0,60,元大-大天母,2024-03-14,9893
2618,長榮航,104,46,58,元大-大天母,2024-03-14,9893
8926,台汽電,63,10,53,元大-大天母,2024-03-14,9893
2354,鴻準,82,32,50,元大-大天母,2024-03-14,9893
1616,億泰,51,1,50,元大-大天母,2024-03-14,9893
2353,宏��,52,5,47,元大-大天母,2024-03-14,9893
2382,廣達,52,8,44,元大-大天母,2024-03-14,9893
00918,大華優利高填息30,53,12,41,元大-大天母,2024-03-14,9893
1409,新纖,40,0,40,元大-大天母,2024-03-14,9893
2377,微星,43,3,40,元大-大天母,2024-03-14,9893
5534,長虹,40,0,40,元大-大天母,2024-03-14,9893
00679B,元大美債20年,47,8,39,元大-大天母,2024-03-14,9893
3231,緯創,70,31,39,元大-大天母,2024-03-14,9893
2603,長榮,59,20,39,元大-大天母,2024-03-14,9893
2323,中環,36,0,36,元大-大天母,2024-03-14,9893
00706L,期元大S＆P日圓正2,35,0,35,元大-大天母,2024-03-14,9893
00720B,元大投資級公司債,35,1,34,元大-大天母,2024-03-14,9893
6790,永豐實,36,4,32,元大-大天母,2024-03-14,9893
6176,瑞儀,38,7,31,元大-大天母,2024-03-14,9893
1314,中石化,30,0,30,元大-大天母,2024-03-14,9893
4714,永捷,62,32,30,元大-大天母,2024-03-14,9893
2006,東和鋼鐵,30,0,30,元大-大天母,2024-03-14,9893
00687B,國泰20年美債,43,14,29,元大-大天母,2024-03-14,9893
6425,易發,29,0,29,元大-大天母,2024-03-14,9893
00915,凱基優選高股息30,28,0,28,元大-大天母,2024-03-14,9893
3048,益登,28,0,28,元大-大天母,2024-03-14,9893
00857B,永豐20年美公債,27,0,27,元大-大天母,2024-03-14,9893
00680L,元大美債20正2,27,0,27,元大-大天母,2024-03-14,9893
3017,奇鋐,33,7,26,元大-大天母,2024-03-14,9893
8040,九暘,38,12,26,元大-大天母,2024-03-14,9893
00665L,富邦�琤肭磪囓�2,36,11,25,元大-大天母,2024-03-14,9893
00937B,群益ESG投等債20,26,2,24,元大-大天母,2024-03-14,9893
2301,光寶科,24,1,23,元大-大天母,2024-03-14,9893
2356,英業達,45,22,23,元大-大天母,2024-03-14,9893
2404,漢唐,22,0,22,元大-大天母,2024-03-14,9893
00937B,群益ESG投等債20,327,1,326,元大-大天母,2024-03-15,9893
00919,群益台灣精選高息,292,32,260,元大-大天母,2024-03-15,9893
2886,兆豐金,245,8,237,元大-大天母,2024-03-15,9893
2834,臺企銀,266,48,218,元大-大天母,2024-03-15,9893
00941,中信上游半導體,184,64,120,元大-大天母,2024-03-15,9893
00915,凱基優選高股息30,135,21,114,元大-大天母,2024-03-15,9893
1210,大成,107,0,107,元大-大天母,2024-03-15,9893
2618,長榮航,159,56,103,元大-大天母,2024-03-15,9893
2377,微星,75,3,72,元大-大天母,2024-03-15,9893
00687B,國泰20年美債,87,15,72,元大-大天母,2024-03-15,9893
3481,群創,318,247,71,元大-大天母,2024-03-15,9893
00679B,元大美債20年,73,7,66,元大-大天母,2024-03-15,9893
2603,長榮,179,116,63,元大-大天母,2024-03-15,9893
2367,燿華,63,4,59,元大-大天母,2024-03-15,9893
5609,中菲行,57,2,55,元大-大天母,2024-03-15,9893
1316,上曜,55,3,52,元大-大天母,2024-03-15,9893
2409,友達,51,2,49,元大-大天母,2024-03-15,9893
00673R,期元大S＆P原油反1,46,0,46,元大-大天母,2024-03-15,9893
2365,昆盈,40,0,40,元大-大天母,2024-03-15,9893
00903,富邦元宇宙,40,0,40,元大-大天母,2024-03-15,9893
6016,康和證,42,5,37,元大-大天母,2024-03-15,9893
3048,益登,36,0,36,元大-大天母,2024-03-15,9893
00923,群益台ESG低碳50,36,0,36,元大-大天母,2024-03-15,9893
2330,台積電,55,19,36,元大-大天母,2024-03-15,9893
6176,瑞儀,37,5,32,元大-大天母,2024-03-15,9893
00751B,元大AAA至A公司債,31,0,31,元大-大天母,2024-03-15,9893
2328,廣宇,35,5,30,元大-大天母,2024-03-15,9893
2006,東和鋼鐵,30,0,30,元大-大天母,2024-03-15,9893
1216,統一,29,0,29,元大-大天母,2024-03-15,9893
2609,陽明,58,29,29,元大-大天母,2024-03-15,9893
1532,勤美,28,0,28,元大-大天母,2024-03-15,9893
1303,南亞,28,0,28,元大-大天母,2024-03-15,9893
2331,精英,28,0,28,元大-大天母,2024-03-15,9893
6126,信音,89,62,27,元大-大天母,2024-03-15,9893
9933,中鼎,32,6,26,元大-大天母,2024-03-15,9893
4306,炎洲,25,0,25,元大-大天母,2024-03-15,9893
2882,國泰金,48,24,24,元大-大天母,2024-03-15,9893
00712,復華富時不動產,23,0,23,元大-大天母,2024-03-15,9893
1513,中興電,38,16,22,元大-大天母,2024-03-15,9893
00933B,國泰10Y+金融債,21,0,21,元大-大天母,2024-03-15,9893
00753L,中信中國50正2,71,50,21,元大-大天母,2024-03-15,9893
00713,元大台灣高息低波,20,0,20,元大-大天母,2024-03-15,9893
00921,兆豐龍頭等權重,20,0,20,元大-大天母,2024-03-15,9893
1409,新纖,20,0,20,元大-大天母,2024-03-15,9893
5403,中菲,20,0,20,元大-大天母,2024-03-15,9893
6204,艾華,20,0,20,元大-大天母,2024-03-15,9893
2356,英業達,43,23,20,元大-大天母,2024-03-15,9893
00720B,元大投資級公司債,20,1,19,元大-大天母,2024-03-15,9893
2354,鴻準,97,78,19,元大-大天母,2024-03-15,9893
00936,台新永續高息中小,20,1,19,元大-大天母,2024-03-15,9893
00632R,元大台灣50反1,710,50,660,元大-大天母,2024-03-18,9893
00937B,群益ESG投等債20,250,4,246,元大-大天母,2024-03-18,9893
2889,國票金,235,5,230,元大-大天母,2024-03-18,9893
2618,長榮航,155,32,123,元大-大天母,2024-03-18,9893
00919,群益台灣精選高息,180,64,116,元大-大天母,2024-03-18,9893
3005,神基,115,4,111,元大-大天母,2024-03-18,9893
2408,南亞科,105,0,105,元大-大天母,2024-03-18,9893
00885,富邦越南,102,0,102,元大-大天母,2024-03-18,9893
2882,國泰金,150,49,101,元大-大天母,2024-03-18,9893
2353,宏��,108,10,98,元大-大天母,2024-03-18,9893
00941,中信上游半導體,107,12,95,元大-大天母,2024-03-18,9893
1409,新纖,91,0,91,元大-大天母,2024-03-18,9893
00700,富邦�琤肭磪�,87,0,87,元大-大天母,2024-03-18,9893
2883,凱基金,97,31,66,元大-大天母,2024-03-18,9893
00680L,元大美債20正2,61,0,61,元大-大天母,2024-03-18,9893
8089,康全電訊,62,1,61,元大-大天母,2024-03-18,9893
00933B,國泰10Y+金融債,73,14,59,元大-大天母,2024-03-18,9893
00687B,國泰20年美債,70,16,54,元大-大天母,2024-03-18,9893
00857B,永豐20年美公債,52,2,50,元大-大天母,2024-03-18,9893
4961,天鈺,71,22,49,元大-大天母,2024-03-18,9893
3083,網龍,49,0,49,元大-大天母,2024-03-18,9893
2303,聯電,60,11,49,元大-大天母,2024-03-18,9893
00679B,元大美債20年,57,12,45,元大-大天母,2024-03-18,9893
2501,國建,40,5,35,元大-大天母,2024-03-18,9893
8349,�矬�,36,2,34,元大-大天母,2024-03-18,9893
8473,山林水,33,0,33,元大-大天母,2024-03-18,9893
2603,長榮,71,38,33,元大-大天母,2024-03-18,9893
2881,富邦金,32,1,31,元大-大天母,2024-03-18,9893
2331,精英,38,8,30,元大-大天母,2024-03-18,9893
8112,至上,34,6,28,元大-大天母,2024-03-18,9893
1312,國喬,30,4,26,元大-大天母,2024-03-18,9893
2449,京元電子,44,19,25,元大-大天母,2024-03-18,9893
2313,華通,41,17,24,元大-大天母,2024-03-18,9893
2357,華碩,27,3,24,元大-大天母,2024-03-18,9893
5609,中菲行,23,0,23,元大-大天母,2024-03-18,9893
00918,大華優利高填息30,28,6,22,元大-大天母,2024-03-18,9893
00923,群益台ESG低碳50,20,0,20,元大-大天母,2024-03-18,9893
00935,野村臺灣新科技50,20,0,20,元大-大天母,2024-03-18,9893
8088,品安,20,0,20,元大-大天母,2024-03-18,9893
4977,眾達-KY,20,0,20,元大-大天母,2024-03-18,9893
1216,統一,20,1,19,元大-大天母,2024-03-18,9893
2609,陽明,25,6,19,元大-大天母,2024-03-18,9893
3570,大塚,19,0,19,元大-大天母,2024-03-18,9893
3479,安勤,20,1,19,元大-大天母,2024-03-18,9893
2409,友達,19,2,17,元大-大天母,2024-03-18,9893
1535,中宇,20,3,17,元大-大天母,2024-03-18,9893
5521,工信,15,0,15,元大-大天母,2024-03-18,9893
4714,永捷,25,11,14,元大-大天母,2024-03-18,9893
2025,千興,15,1,14,元大-大天母,2024-03-18,9893
2352,佳世達,19,5,14,元大-大天母,2024-03-18,9893
6274,台燿,270,16,254,元大-大天母,2024-03-19,9893
3083,網龍,145,4,141,元大-大天母,2024-03-19,9893
00680L,元大美債20正2,117,0,117,元大-大天母,2024-03-19,9893
2890,永豐金,103,2,101,元大-大天母,2024-03-19,9893
2889,國票金,86,0,86,元大-大天母,2024-03-19,9893
2308,台達電,97,28,69,元大-大天母,2024-03-19,9893
00941,中信上游半導體,65,0,65,元大-大天母,2024-03-19,9893
00857B,永豐20年美公債,64,1,63,元大-大天母,2024-03-19,9893
2618,長榮航,60,10,50,元大-大天母,2024-03-19,9893
1342,八貫,43,0,43,元大-大天母,2024-03-19,9893
2377,微星,43,1,42,元大-大天母,2024-03-19,9893
4766,南寶,44,2,42,元大-大天母,2024-03-19,9893
5609,中菲行,43,1,42,元大-大天母,2024-03-19,9893
2515,中工,63,23,40,元大-大天母,2024-03-19,9893
3312,弘憶股,53,15,38,元大-大天母,2024-03-19,9893
6275,元山,38,4,34,元大-大天母,2024-03-19,9893
1616,億泰,33,0,33,元大-大天母,2024-03-19,9893
00934,中信成長高股息,32,0,32,元大-大天母,2024-03-19,9893
00936,台新永續高息中小,30,0,30,元大-大天母,2024-03-19,9893
00673R,期元大S＆P原油反1,29,0,29,元大-大天母,2024-03-19,9893
00937B,群益ESG投等債20,35,6,29,元大-大天母,2024-03-19,9893
2493,揚博,28,0,28,元大-大天母,2024-03-19,9893
8383,千附,30,2,28,元大-大天母,2024-03-19,9893
00687B,國泰20年美債,26,0,26,元大-大天母,2024-03-19,9893
2353,宏��,30,4,26,元大-大天母,2024-03-19,9893
2371,大同,50,25,25,元大-大天母,2024-03-19,9893
2354,鴻準,54,31,23,元大-大天母,2024-03-19,9893
6213,聯茂,40,17,23,元大-大天母,2024-03-19,9893
8089,康全電訊,23,1,22,元大-大天母,2024-03-19,9893
1609,大亞,31,9,22,元大-大天母,2024-03-19,9893
2344,華邦電,22,0,22,元大-大天母,2024-03-19,9893
00679B,元大美債20年,26,6,20,元大-大天母,2024-03-19,9893
3481,群創,22,2,20,元大-大天母,2024-03-19,9893
2540,愛山林,20,0,20,元大-大天母,2024-03-19,9893
2617,台航,20,0,20,元大-大天母,2024-03-19,9893
2401,凌陽,20,0,20,元大-大天母,2024-03-19,9893
4127,天良,20,0,20,元大-大天母,2024-03-19,9893
5202,力新,20,0,20,元大-大天母,2024-03-19,9893
9904,寶成,21,1,20,元大-大天母,2024-03-19,9893
6204,艾華,20,0,20,元大-大天母,2024-03-19,9893
6613,朋億*,18,0,18,元大-大天母,2024-03-19,9893
00933B,國泰10Y+金融債,17,0,17,元大-大天母,2024-03-19,9893
3289,宜特,20,3,17,元大-大天母,2024-03-19,9893
6125,廣運,18,1,17,元大-大天母,2024-03-19,9893
2362,藍天,16,0,16,元大-大天母,2024-03-19,9893
2887,台新金,16,1,15,元大-大天母,2024-03-19,9893
1409,新纖,15,0,15,元大-大天母,2024-03-19,9893
1605,華新,18,4,14,元大-大天母,2024-03-19,9893
2393,億光,14,0,14,元大-大天母,2024-03-19,9893
2382,廣達,32,18,14,元大-大天母,2024-03-19,9893
00919,群益台灣精選高息,630,56,574,元大-大天母,2024-03-20,9893
00939,統一台灣高息動能,581,75,506,元大-大天母,2024-03-20,9893
4938,和碩,327,53,274,元大-大天母,2024-03-20,9893
3059,華晶科,135,1,134,元大-大天母,2024-03-20,9893
2618,長榮航,129,10,119,元大-大天母,2024-03-20,9893
2889,國票金,120,3,117,元大-大天母,2024-03-20,9893
3481,群創,114,4,110,元大-大天母,2024-03-20,9893
6770,力積電,114,10,104,元大-大天母,2024-03-20,9893
2890,永豐金,103,0,103,元大-大天母,2024-03-20,9893
2603,長榮,136,51,85,元大-大天母,2024-03-20,9893
2006,東和鋼鐵,65,0,65,元大-大天母,2024-03-20,9893
00679B,元大美債20年,75,12,63,元大-大天母,2024-03-20,9893
1314,中石化,62,0,62,元大-大天母,2024-03-20,9893
2344,華邦電,74,13,61,元大-大天母,2024-03-20,9893
00680L,元大美債20正2,56,0,56,元大-大天母,2024-03-20,9893
1336,台翰,50,0,50,元大-大天母,2024-03-20,9893
4513,福裕,50,0,50,元大-大天母,2024-03-20,9893
2888,新光金,61,11,50,元大-大天母,2024-03-20,9893
4127,天良,66,20,46,元大-大天母,2024-03-20,9893
00882,中信中國高股息,42,0,42,元大-大天母,2024-03-20,9893
00645,富邦日本,40,1,39,元大-大天母,2024-03-20,9893
2382,廣達,48,9,39,元大-大天母,2024-03-20,9893
2354,鴻準,115,77,38,元大-大天母,2024-03-20,9893
2002,中鋼,38,0,38,元大-大天母,2024-03-20,9893
3322,建舜電,40,3,37,元大-大天母,2024-03-20,9893
2609,陽明,39,4,35,元大-大天母,2024-03-20,9893
00941,中信上游半導體,38,4,34,元大-大天母,2024-03-20,9893
6753,龍德造船,37,6,31,元大-大天母,2024-03-20,9893
6274,台燿,37,8,29,元大-大天母,2024-03-20,9893
2891,中信金,28,0,28,元大-大天母,2024-03-20,9893
6217,中探針,30,3,27,元大-大天母,2024-03-20,9893
00937B,群益ESG投等債20,27,0,27,元大-大天母,2024-03-20,9893
00773B,中信優先金融債,25,0,25,元大-大天母,2024-03-20,9893
1101,台泥,25,1,24,元大-大天母,2024-03-20,9893
00934,中信成長高股息,23,1,22,元大-大天母,2024-03-20,9893
2356,英業達,57,35,22,元大-大天母,2024-03-20,9893
00933B,國泰10Y+金融債,60,39,21,元大-大天母,2024-03-20,9893
5403,中菲,21,0,21,元大-大天母,2024-03-20,9893
00733,富邦臺灣中小,21,0,21,元大-大天母,2024-03-20,9893
00936,台新永續高息中小,21,0,21,元大-大天母,2024-03-20,9893
2377,微星,20,0,20,元大-大天母,2024-03-20,9893
00661,元大日經225,20,0,20,元大-大天母,2024-03-20,9893
1612,宏泰,20,0,20,元大-大天母,2024-03-20,9893
6213,聯茂,44,24,20,元大-大天母,2024-03-20,9893
4973,廣穎,20,0,20,元大-大天母,2024-03-20,9893
6590,普鴻,20,0,20,元大-大天母,2024-03-20,9893
9934,成霖,20,0,20,元大-大天母,2024-03-20,9893
2504,國產,19,0,19,元大-大天母,2024-03-20,9893
3312,弘憶股,34,15,19,元大-大天母,2024-03-20,9893
3231,緯創,100,81,19,元大-大天母,2024-03-20,9893
00939,統一台灣高息動能,341,11,330,元大-大天母,2024-03-21,9893
3083,網龍,297,2,295,元大-大天母,2024-03-21,9893
00931B,統一美債20年,270,0,270,元大-大天母,2024-03-21,9893
2367,燿華,230,39,191,元大-大天母,2024-03-21,9893
00919,群益台灣精選高息,246,82,164,元大-大天母,2024-03-21,9893
00687B,國泰20年美債,119,1,118,元大-大天母,2024-03-21,9893
00679B,元大美債20年,105,5,100,元大-大天母,2024-03-21,9893
1210,大成,100,0,100,元大-大天母,2024-03-21,9893
2880,華南金,90,1,89,元大-大天母,2024-03-21,9893
2618,長榮航,78,2,76,元大-大天母,2024-03-21,9893
2354,鴻準,125,60,65,元大-大天母,2024-03-21,9893
2387,精元,62,0,62,元大-大天母,2024-03-21,9893
2401,凌陽,58,0,58,元大-大天母,2024-03-21,9893
2603,長榮,86,46,40,元大-大天母,2024-03-21,9893
2889,國票金,40,0,40,元大-大天母,2024-03-21,9893
00669R,國泰美國道瓊反1,40,0,40,元大-大天母,2024-03-21,9893
1326,台化,39,0,39,元大-大天母,2024-03-21,9893
6207,雷科,39,2,37,元大-大天母,2024-03-21,9893
00720B,元大投資級公司債,36,0,36,元大-大天母,2024-03-21,9893
2303,聯電,70,38,32,元大-大天母,2024-03-21,9893
00671R,富邦NASDAQ反1,30,0,30,元大-大天母,2024-03-21,9893
3532,台勝科,30,0,30,元大-大天母,2024-03-21,9893
00648R,元大S＆P500反1,30,0,30,元大-大天母,2024-03-21,9893
00664R,國泰臺灣加權反1,27,0,27,元大-大天母,2024-03-21,9893
2408,南亞科,63,36,27,元大-大天母,2024-03-21,9893
00937B,群益ESG投等債20,26,0,26,元大-大天母,2024-03-21,9893
2377,微星,27,1,26,元大-大天母,2024-03-21,9893
00751B,元大AAA至A公司債,25,0,25,元大-大天母,2024-03-21,9893
1785,光洋科,52,27,25,元大-大天母,2024-03-21,9893
3041,揚智,31,7,24,元大-大天母,2024-03-21,9893
00676R,富邦臺灣加權反1,40,16,24,元大-大天母,2024-03-21,9893
2324,仁寶,34,10,24,元大-大天母,2024-03-21,9893
5483,中美晶,30,7,23,元大-大天母,2024-03-21,9893
2885,元大金,30,9,21,元大-大天母,2024-03-21,9893
1513,中興電,63,42,21,元大-大天母,2024-03-21,9893
8473,山林水,22,1,21,元大-大天母,2024-03-21,9893
4127,天良,20,0,20,元大-大天母,2024-03-21,9893
0061,元大寶滬深,20,0,20,元大-大天母,2024-03-21,9893
1906,寶隆,20,0,20,元大-大天母,2024-03-21,9893
3056,富華新,19,0,19,元大-大天母,2024-03-21,9893
2323,中環,52,33,19,元大-大天母,2024-03-21,9893
2915,潤泰全,20,1,19,元大-大天母,2024-03-21,9893
1434,福懋,18,0,18,元大-大天母,2024-03-21,9893
2820,華票,20,2,18,元大-大天母,2024-03-21,9893
2385,群光,17,0,17,元大-大天母,2024-03-21,9893
5609,中菲行,18,2,16,元大-大天母,2024-03-21,9893
1805,寶徠,16,0,16,元大-大天母,2024-03-21,9893
2376,技嘉,20,5,15,元大-大天母,2024-03-21,9893
2206,三陽工業,16,1,15,元大-大天母,2024-03-21,9893
2406,國碩,16,2,14,元大-大天母,2024-03-21,9893
3083,網龍,1004,84,920,元大-大天母,2024-03-22,9893
00665L,富邦�琤肭磪囓�2,425,0,425,元大-大天母,2024-03-22,9893
2455,全新,236,2,234,元大-大天母,2024-03-22,9893
3706,神達,321,115,206,元大-大天母,2024-03-22,9893
2886,兆豐金,173,1,172,元大-大天母,2024-03-22,9893
1301,台塑,180,17,163,元大-大天母,2024-03-22,9893
00939,統一台灣高息動能,172,13,159,元大-大天母,2024-03-22,9893
6213,聯茂,143,12,131,元大-大天母,2024-03-22,9893
9904,寶成,102,0,102,元大-大天母,2024-03-22,9893
2353,宏��,268,174,94,元大-大天母,2024-03-22,9893
00679B,元大美債20年,94,1,93,元大-大天母,2024-03-22,9893
2889,國票金,81,0,81,元大-大天母,2024-03-22,9893
4714,永捷,82,7,75,元大-大天母,2024-03-22,9893
2303,聯電,121,60,61,元大-大天母,2024-03-22,9893
5469,瀚宇博,60,1,59,元大-大天母,2024-03-22,9893
5609,中菲行,58,0,58,元大-大天母,2024-03-22,9893
5443,均豪,55,0,55,元大-大天母,2024-03-22,9893
2882,國泰金,106,52,54,元大-大天母,2024-03-22,9893
8059,凱碩,51,0,51,元大-大天母,2024-03-22,9893
1718,中纖,345,295,50,元大-大天母,2024-03-22,9893
00929,復華台灣科技優息,60,10,50,元大-大天母,2024-03-22,9893
2344,華邦電,84,36,48,元大-大天母,2024-03-22,9893
1504,東元,86,39,47,元大-大天母,2024-03-22,9893
2618,長榮航,80,35,45,元大-大天母,2024-03-22,9893
3438,類比科,43,1,42,元大-大天母,2024-03-22,9893
2603,長榮,74,33,41,元大-大天母,2024-03-22,9893
9938,百和,40,0,40,元大-大天母,2024-03-22,9893
5498,凱崴,41,2,39,元大-大天母,2024-03-22,9893
8112,至上,55,17,38,元大-大天母,2024-03-22,9893
2354,鴻準,57,21,36,元大-大天母,2024-03-22,9893
6121,新普,30,0,30,元大-大天母,2024-03-22,9893
00687B,國泰20年美債,31,1,30,元大-大天母,2024-03-22,9893
00937B,群益ESG投等債20,30,0,30,元大-大天母,2024-03-22,9893
00936,台新永續高息中小,30,0,30,元大-大天母,2024-03-22,9893
6438,迅得,29,0,29,元大-大天母,2024-03-22,9893
1809,中釉,29,0,29,元大-大天母,2024-03-22,9893
8936,國統,30,4,26,元大-大天母,2024-03-22,9893
00905,FT臺灣Smart,24,0,24,元大-大天母,2024-03-22,9893
1605,華新,26,3,23,元大-大天母,2024-03-22,9893
5483,中美晶,28,5,23,元大-大天母,2024-03-22,9893
2323,中環,22,0,22,元大-大天母,2024-03-22,9893
3047,訊舟,27,5,22,元大-大天母,2024-03-22,9893
00941,中信上游半導體,66,45,21,元大-大天母,2024-03-22,9893
2888,新光金,21,0,21,元大-大天母,2024-03-22,9893
6179,亞通,34,13,21,元大-大天母,2024-03-22,9893
9934,成霖,20,0,20,元大-大天母,2024-03-22,9893
1326,台化,20,0,20,元大-大天母,2024-03-22,9893
6188,廣明,33,14,19,元大-大天母,2024-03-22,9893
5474,聰泰,20,1,19,元大-大天母,2024-03-22,9893
8271,宇瞻,27,8,19,元大-大天母,2024-03-22,9893
3083,網龍,288,0,288,元大-大天母,2024-03-25,9893
2618,長榮航,183,32,151,元大-大天母,2024-03-25,9893
00939,統一台灣高息動能,149,6,143,元大-大天母,2024-03-25,9893
2356,英業達,129,28,101,元大-大天母,2024-03-25,9893
00679B,元大美債20年,107,11,96,元大-大天母,2024-03-25,9893
00665L,富邦�琤肭磪囓�2,105,10,95,元大-大天母,2024-03-25,9893
2303,聯電,111,22,89,元大-大天母,2024-03-25,9893
00937B,群益ESG投等債20,115,33,82,元大-大天母,2024-03-25,9893
8088,品安,70,0,70,元大-大天母,2024-03-25,9893
00929,復華台灣科技優息,125,59,66,元大-大天母,2024-03-25,9893
1609,大亞,227,173,54,元大-大天母,2024-03-25,9893
2886,兆豐金,55,3,52,元大-大天母,2024-03-25,9893
5398,慕康生醫,50,0,50,元大-大天母,2024-03-25,9893
5609,中菲行,73,29,44,元大-大天母,2024-03-25,9893
1612,宏泰,55,12,43,元大-大天母,2024-03-25,9893
2903,遠百,40,0,40,元大-大天母,2024-03-25,9893
3010,華立,41,3,38,元大-大天母,2024-03-25,9893
1718,中纖,40,2,38,元大-大天母,2024-03-25,9893
00891,中信關鍵半導體,37,0,37,元大-大天母,2024-03-25,9893
2376,技嘉,51,14,37,元大-大天母,2024-03-25,9893
2834,臺企銀,47,12,35,元大-大天母,2024-03-25,9893
3056,富華新,35,0,35,元大-大天母,2024-03-25,9893
3059,華晶科,82,48,34,元大-大天母,2024-03-25,9893
00720B,元大投資級公司債,33,0,33,元大-大天母,2024-03-25,9893
00632R,元大台灣50反1,41,10,31,元大-大天母,2024-03-25,9893
5432,新門,30,0,30,元大-大天母,2024-03-25,9893
5222,全訊,31,2,29,元大-大天母,2024-03-25,9893
8085,福華,26,0,26,元大-大天母,2024-03-25,9893
2406,國碩,26,1,25,元大-大天母,2024-03-25,9893
0056,元大高股息,28,5,23,元大-大天母,2024-03-25,9893
1101,台泥,22,0,22,元大-大天母,2024-03-25,9893
3037,欣興,27,6,21,元大-大天母,2024-03-25,9893
3704,合勤控,21,1,20,元大-大天母,2024-03-25,9893
00650L,復華香港正2,20,0,20,元大-大天母,2024-03-25,9893
2441,超豐,20,0,20,元大-大天母,2024-03-25,9893
3062,建漢,28,9,19,元大-大天母,2024-03-25,9893
2009,第一銅,20,1,19,元大-大天母,2024-03-25,9893
3706,神達,27,11,16,元大-大天母,2024-03-25,9893
6414,樺漢,18,2,16,元大-大天母,2024-03-25,9893
4938,和碩,33,17,16,元大-大天母,2024-03-25,9893
2352,佳世達,25,10,15,元大-大天母,2024-03-25,9893
3163,波若威,22,7,15,元大-大天母,2024-03-25,9893
1434,福懋,20,5,15,元大-大天母,2024-03-25,9893
00722B,群益投資級電信債,15,0,15,元大-大天母,2024-03-25,9893
00772B,中信高評級公司債,19,5,14,元大-大天母,2024-03-25,9893
2882,國泰金,12,0,12,元大-大天母,2024-03-25,9893
6189,豐藝,19,7,12,元大-大天母,2024-03-25,9893
3708,上緯投控,17,5,12,元大-大天母,2024-03-25,9893
8110,華東,12,0,12,元大-大天母,2024-03-25,9893
3231,緯創,39,27,12,元大-大天母,2024-03-25,9893
2371,大同,793,587,206,元大-大天母,2024-03-26,9893
00939,統一台灣高息動能,215,11,204,元大-大天母,2024-03-26,9893
2511,太子,200,0,200,元大-大天母,2024-03-26,9893
2618,長榮航,196,26,170,元大-大天母,2024-03-26,9893
3231,緯創,196,27,169,元大-大天母,2024-03-26,9893
4584,君帆,160,0,160,元大-大天母,2024-03-26,9893
2323,中環,111,13,98,元大-大天母,2024-03-26,9893
2356,英業達,109,36,73,元大-大天母,2024-03-26,9893
2303,聯電,127,55,72,元大-大天母,2024-03-26,9893
2417,圓剛,156,92,64,元大-大天母,2024-03-26,9893
2441,超豐,61,0,61,元大-大天母,2024-03-26,9893
00919,群益台灣精選高息,202,146,56,元大-大天母,2024-03-26,9893
2354,鴻準,81,27,54,元大-大天母,2024-03-26,9893
8936,國統,91,42,49,元大-大天母,2024-03-26,9893
2344,華邦電,56,7,49,元大-大天母,2024-03-26,9893
00632R,元大台灣50反1,78,33,45,元大-大天母,2024-03-26,9893
00933B,國泰10Y+金融債,46,1,45,元大-大天母,2024-03-26,9893
3059,華晶科,60,18,42,元大-大天母,2024-03-26,9893
9950,萬國通,40,0,40,元大-大天母,2024-03-26,9893
3441,聯一光,37,0,37,元大-大天母,2024-03-26,9893
1605,華新,57,23,34,元大-大天母,2024-03-26,9893
00720B,元大投資級公司債,34,0,34,元大-大天母,2024-03-26,9893
0056,元大高股息,49,15,34,元大-大天母,2024-03-26,9893
00941,中信上游半導體,66,33,33,元大-大天母,2024-03-26,9893
8383,千附,33,1,32,元大-大天母,2024-03-26,9893
2406,國碩,34,2,32,元大-大天母,2024-03-26,9893
6126,信音,30,1,29,元大-大天母,2024-03-26,9893
1504,東元,52,24,28,元大-大天母,2024-03-26,9893
1612,宏泰,31,3,28,元大-大天母,2024-03-26,9893
9105,泰金寶-DR,27,0,27,元大-大天母,2024-03-26,9893
1513,中興電,105,79,26,元大-大天母,2024-03-26,9893
6139,亞翔,31,6,25,元大-大天母,2024-03-26,9893
3481,群創,28,3,25,元大-大天母,2024-03-26,9893
5521,工信,24,0,24,元大-大天母,2024-03-26,9893
6477,安集,38,15,23,元大-大天母,2024-03-26,9893
4714,永捷,42,20,22,元大-大天母,2024-03-26,9893
6188,廣明,30,8,22,元大-大天母,2024-03-26,9893
6217,中探針,22,0,22,元大-大天母,2024-03-26,9893
00679B,元大美債20年,23,2,21,元大-大天母,2024-03-26,9893
1785,光洋科,21,0,21,元大-大天母,2024-03-26,9893
5474,聰泰,21,0,21,元大-大天母,2024-03-26,9893
2106,建大,20,0,20,元大-大天母,2024-03-26,9893
00753L,中信中國50正2,27,7,20,元大-大天母,2024-03-26,9893
6016,康和證,19,0,19,元大-大天母,2024-03-26,9893
3048,益登,17,0,17,元大-大天母,2024-03-26,9893
1618,合機,29,12,17,元大-大天母,2024-03-26,9893
4973,廣穎,22,5,17,元大-大天母,2024-03-26,9893
6443,元晶,26,10,16,元大-大天母,2024-03-26,9893
2476,鉅祥,23,7,16,元大-大天母,2024-03-26,9893
6179,亞通,33,17,16,元大-大天母,2024-03-26,9893
2511,太子,800,0,800,元大-大天母,2024-03-27,9893
3013,晟銘電,602,3,599,元大-大天母,2024-03-27,9893
00929,復華台灣科技優息,184,20,164,元大-大天母,2024-03-27,9893
00919,群益台灣精選高息,170,80,90,元大-大天母,2024-03-27,9893
2371,大同,159,72,87,元大-大天母,2024-03-27,9893
2882,國泰金,85,1,84,元大-大天母,2024-03-27,9893
3703,欣陸,80,0,80,元大-大天母,2024-03-27,9893
00937B,群益ESG投等債20,96,21,75,元大-大天母,2024-03-27,9893
3056,富華新,75,0,75,元大-大天母,2024-03-27,9893
2834,臺企銀,74,0,74,元大-大天母,2024-03-27,9893
3231,緯創,94,22,72,元大-大天母,2024-03-27,9893
3217,優群,65,1,64,元大-大天母,2024-03-27,9893
2367,燿華,68,5,63,元大-大天母,2024-03-27,9893
00720B,元大投資級公司債,64,4,60,元大-大天母,2024-03-27,9893
6016,康和證,50,0,50,元大-大天母,2024-03-27,9893
6668,中揚光,54,4,50,元大-大天母,2024-03-27,9893
2913,農林,50,4,46,元大-大天母,2024-03-27,9893
4961,天鈺,55,13,42,元大-大天母,2024-03-27,9893
2002,中鋼,39,1,38,元大-大天母,2024-03-27,9893
6873,泓德能源,36,0,36,元大-大天母,2024-03-27,9893
2881,富邦金,36,0,36,元大-大天母,2024-03-27,9893
1504,東元,37,2,35,元大-大天母,2024-03-27,9893
2301,光寶科,36,5,31,元大-大天母,2024-03-27,9893
6752,叡揚,30,0,30,元大-大天母,2024-03-27,9893
6190,萬泰科,28,1,27,元大-大天母,2024-03-27,9893
2883,凱基金,78,51,27,元大-大天母,2024-03-27,9893
2884,玉山金,25,1,24,元大-大天母,2024-03-27,9893
2377,微星,22,0,22,元大-大天母,2024-03-27,9893
5432,新門,20,0,20,元大-大天母,2024-03-27,9893
6292,迅德,20,0,20,元大-大天母,2024-03-27,9893
3059,華晶科,19,0,19,元大-大天母,2024-03-27,9893
2609,陽明,24,7,17,元大-大天母,2024-03-27,9893
6125,廣運,16,2,14,元大-大天母,2024-03-27,9893
2486,一詮,14,1,13,元大-大天母,2024-03-27,9893
9933,中鼎,25,12,13,元大-大天母,2024-03-27,9893
2801,彰銀,13,0,13,元大-大天母,2024-03-27,9893
2324,仁寶,14,2,12,元大-大天母,2024-03-27,9893
8096,擎亞,13,1,12,元大-大天母,2024-03-27,9893
2891,中信金,17,5,12,元大-大天母,2024-03-27,9893
2409,友達,14,3,11,元大-大天母,2024-03-27,9893
0050,元大台灣50,10,0,10,元大-大天母,2024-03-27,9893
4908,前鼎,10,0,10,元大-大天母,2024-03-27,9893
6576,逸達,10,0,10,元大-大天母,2024-03-27,9893
00891,中信關鍵半導體,10,0,10,元大-大天母,2024-03-27,9893
00918,大華優利高填息30,12,2,10,元大-大天母,2024-03-27,9893
2369,菱生,12,2,10,元大-大天母,2024-03-27,9893
1616,億泰,12,2,10,元大-大天母,2024-03-27,9893
2605,新興,11,1,10,元大-大天母,2024-03-27,9893
1721,三晃,10,0,10,元大-大天母,2024-03-27,9893
00676R,富邦臺灣加權反1,10,0,10,元大-大天母,2024-03-27,9893
2883,凱基金,269,60,209,元大-大天母,2024-03-28,9893
2332,友訊,171,0,171,元大-大天母,2024-03-28,9893
2633,台灣高鐵,120,9,111,元大-大天母,2024-03-28,9893
1789,神隆,121,16,105,元大-大天母,2024-03-28,9893
2886,兆豐金,108,5,103,元大-大天母,2024-03-28,9893
3707,漢磊,100,1,99,元大-大天母,2024-03-28,9893
3015,全漢,80,0,80,元大-大天母,2024-03-28,9893
2618,長榮航,87,11,76,元大-大天母,2024-03-28,9893
2485,兆赫,70,0,70,元大-大天母,2024-03-28,9893
2301,光寶科,87,21,66,元大-大天母,2024-03-28,9893
3706,神達,86,20,66,元大-大天母,2024-03-28,9893
00722B,群益投資級電信債,60,0,60,元大-大天母,2024-03-28,9893
2892,第一金,102,45,57,元大-大天母,2024-03-28,9893
3234,光環,57,0,57,元大-大天母,2024-03-28,9893
4961,天鈺,54,0,54,元大-大天母,2024-03-28,9893
3217,優群,53,1,52,元大-大天母,2024-03-28,9893
1314,中石化,50,5,45,元大-大天母,2024-03-28,9893
00885,富邦越南,62,22,40,元大-大天母,2024-03-28,9893
3703,欣陸,40,0,40,元大-大天母,2024-03-28,9893
3005,神基,46,8,38,元大-大天母,2024-03-28,9893
4714,永捷,101,65,36,元大-大天母,2024-03-28,9893
6179,亞通,48,12,36,元大-大天母,2024-03-28,9893
1609,大亞,72,37,35,元大-大天母,2024-03-28,9893
00941,中信上游半導體,48,14,34,元大-大天母,2024-03-28,9893
8033,雷虎,44,14,30,元大-大天母,2024-03-28,9893
2356,英業達,45,15,30,元大-大天母,2024-03-28,9893
2377,微星,29,0,29,元大-大天母,2024-03-28,9893
1731,美吾華,26,0,26,元大-大天母,2024-03-28,9893
6196,帆宣,25,0,25,元大-大天母,2024-03-28,9893
1584,精剛,25,0,25,元大-大天母,2024-03-28,9893
8299,群聯,25,0,25,元大-大天母,2024-03-28,9893
3481,群創,25,2,23,元大-大天母,2024-03-28,9893
2845,遠東銀,23,0,23,元大-大天母,2024-03-28,9893
1773,勝一,23,1,22,元大-大天母,2024-03-28,9893
2913,農林,26,5,21,元大-大天母,2024-03-28,9893
00751B,元大AAA至A公司債,21,0,21,元大-大天母,2024-03-28,9893
1513,中興電,45,25,20,元大-大天母,2024-03-28,9893
1616,億泰,23,3,20,元大-大天母,2024-03-28,9893
9934,成霖,20,0,20,元大-大天母,2024-03-28,9893
6457,紘康,43,24,19,元大-大天母,2024-03-28,9893
2882,國泰金,26,8,18,元大-大天母,2024-03-28,9893
2609,陽明,21,3,18,元大-大天母,2024-03-28,9893
6204,艾華,20,2,18,元大-大天母,2024-03-28,9893
2884,玉山金,24,6,18,元大-大天母,2024-03-28,9893
9945,潤泰新,20,3,17,元大-大天母,2024-03-28,9893
1795,美時,20,4,16,元大-大天母,2024-03-28,9893
1815,富喬,25,9,16,元大-大天母,2024-03-28,9893
6176,瑞儀,16,0,16,元大-大天母,2024-03-28,9893
2605,新興,15,0,15,元大-大天母,2024-03-28,9893
1477,聚陽,26,11,15,元大-大天母,2024-03-28,9893
00632R,元大台灣50反1,201,0,201,元大-大天母,2024-03-29,9893
1101,台泥,192,9,183,元大-大天母,2024-03-29,9893
2332,友訊,115,0,115,元大-大天母,2024-03-29,9893
3703,欣陸,97,10,87,元大-大天母,2024-03-29,9893
6245,立端,85,0,85,元大-大天母,2024-03-29,9893
2317,鴻海,136,79,57,元大-大天母,2024-03-29,9893
2301,光寶科,69,16,53,元大-大天母,2024-03-29,9893
2888,新光金,52,0,52,元大-大天母,2024-03-29,9893
2889,國票金,49,0,49,元大-大天母,2024-03-29,9893
4958,臻鼎-KY,57,12,45,元大-大天母,2024-03-29,9893
6651,全宇昕,55,12,43,元大-大天母,2024-03-29,9893
9934,成霖,42,0,42,元大-大天母,2024-03-29,9893
1789,神隆,45,7,38,元大-大天母,2024-03-29,9893
2331,精英,39,2,37,元大-大天母,2024-03-29,9893
2303,聯電,89,57,32,元大-大天母,2024-03-29,9893
00941,中信上游半導體,33,3,30,元大-大天母,2024-03-29,9893
1609,大亞,39,11,28,元大-大天母,2024-03-29,9893
2324,仁寶,43,15,28,元大-大天母,2024-03-29,9893
2354,鴻準,43,17,26,元大-大天母,2024-03-29,9893
3706,神達,48,24,24,元大-大天母,2024-03-29,9893
00637L,元大滬深300正2,44,23,21,元大-大天母,2024-03-29,9893
3178,公準,20,0,20,元大-大天母,2024-03-29,9893
8473,山林水,21,1,20,元大-大天母,2024-03-29,9893
2365,昆盈,22,2,20,元大-大天母,2024-03-29,9893
1603,華電,20,0,20,元大-大天母,2024-03-29,9893
3570,大塚,20,0,20,元大-大天母,2024-03-29,9893
3062,建漢,23,3,20,元大-大天母,2024-03-29,9893
6121,新普,20,0,20,元大-大天母,2024-03-29,9893
6005,群益證,20,1,19,元大-大天母,2024-03-29,9893
2603,長榮,61,43,18,元大-大天母,2024-03-29,9893
00937B,群益ESG投等債20,29,12,17,元大-大天母,2024-03-29,9893
2409,友達,17,1,16,元大-大天母,2024-03-29,9893
6591,動力-KY,17,1,16,元大-大天母,2024-03-29,9893
5388,中磊,16,1,15,元大-大天母,2024-03-29,9893
6875,國邑*,15,1,14,元大-大天母,2024-03-29,9893
2882,國泰金,21,9,12,元大-大天母,2024-03-29,9893
9945,潤泰新,12,0,12,元大-大天母,2024-03-29,9893
8033,雷虎,20,8,12,元大-大天母,2024-03-29,9893
2880,華南金,20,8,12,元大-大天母,2024-03-29,9893
3047,訊舟,10,0,10,元大-大天母,2024-03-29,9893
2367,燿華,52,42,10,元大-大天母,2024-03-29,9893
6168,宏齊,12,2,10,元大-大天母,2024-03-29,9893
8085,福華,13,3,10,元大-大天母,2024-03-29,9893
3714,富采,10,0,10,元大-大天母,2024-03-29,9893
3615,安可,10,0,10,元大-大天母,2024-03-29,9893
1905,華紙,10,0,10,元大-大天母,2024-03-29,9893
8096,擎亞,11,1,10,元大-大天母,2024-03-29,9893
00638R,元大滬深300反1,10,0,10,元大-大天母,2024-03-29,9893
4306,炎洲,10,0,10,元大-大天母,2024-03-29,9893
00902,中信電池及儲能,10,0,10,元大-大天母,2024-03-29,9893
6806,森崴能源,368,3,365,元大-大天母,2024-04-01,9893
00940,元大台灣價值高息,1562,1360,202,元大-大天母,2024-04-01,9893
3714,富采,191,1,190,元大-大天母,2024-04-01,9893
00937B,群益ESG投等債20,195,36,159,元大-大天母,2024-04-01,9893
2492,華新科,110,13,97,元大-大天母,2024-04-01,9893
3707,漢磊,89,10,79,元大-大天母,2024-04-01,9893
2382,廣達,99,21,78,元大-大天母,2024-04-01,9893
3231,緯創,98,21,77,元大-大天母,2024-04-01,9893
6873,泓德能源,79,2,77,元大-大天母,2024-04-01,9893
00939,統一台灣高息動能,72,0,72,元大-大天母,2024-04-01,9893
3059,華晶科,88,18,70,元大-大天母,2024-04-01,9893
5234,達興材料,71,1,70,元大-大天母,2024-04-01,9893
1609,大亞,66,5,61,元大-大天母,2024-04-01,9893
4114,健喬,60,0,60,元大-大天母,2024-04-01,9893
8064,東捷,60,1,59,元大-大天母,2024-04-01,9893
00632R,元大台灣50反1,51,0,51,元大-大天母,2024-04-01,9893
6282,康舒,50,0,50,元大-大天母,2024-04-01,9893
2889,國票金,99,55,44,元大-大天母,2024-04-01,9893
00919,群益台灣精選高息,59,17,42,元大-大天母,2024-04-01,9893
3703,欣陸,41,0,41,元大-大天母,2024-04-01,9893
2603,長榮,49,9,40,元大-大天母,2024-04-01,9893
2356,英業達,65,29,36,元大-大天母,2024-04-01,9893
6462,神盾,48,13,35,元大-大天母,2024-04-01,9893
6121,新普,32,1,31,元大-大天母,2024-04-01,9893
9945,潤泰新,32,1,31,元大-大天母,2024-04-01,9893
2891,中信金,68,38,30,元大-大天母,2024-04-01,9893
6284,佳邦,30,0,30,元大-大天母,2024-04-01,9893
8086,宏捷科,30,1,29,元大-大天母,2024-04-01,9893
00929,復華台灣科技優息,34,6,28,元大-大天母,2024-04-01,9893
3711,日月光投控,42,14,28,元大-大天母,2024-04-01,9893
2303,聯電,32,5,27,元大-大天母,2024-04-01,9893
2354,鴻準,76,49,27,元大-大天母,2024-04-01,9893
4716,大立,26,0,26,元大-大天母,2024-04-01,9893
4419,皇家美食,25,0,25,元大-大天母,2024-04-01,9893
4938,和碩,24,0,24,元大-大天母,2024-04-01,9893
4973,廣穎,23,0,23,元大-大天母,2024-04-01,9893
2892,第一金,22,0,22,元大-大天母,2024-04-01,9893
1603,華電,22,0,22,元大-大天母,2024-04-01,9893
2308,台達電,24,4,20,元大-大天母,2024-04-01,9893
00687B,國泰20年美債,21,1,20,元大-大天母,2024-04-01,9893
00706L,期元大S＆P日圓正2,20,0,20,元大-大天母,2024-04-01,9893
00930,永豐ESG低碳高息,20,0,20,元大-大天母,2024-04-01,9893
00905,FT臺灣Smart,20,0,20,元大-大天母,2024-04-01,9893
1789,神隆,20,0,20,元大-大天母,2024-04-01,9893
5432,新門,20,0,20,元大-大天母,2024-04-01,9893
00720B,元大投資級公司債,20,0,20,元大-大天母,2024-04-01,9893
6616,特昇-KY,20,0,20,元大-大天母,2024-04-01,9893
1301,台塑,24,5,19,元大-大天母,2024-04-01,9893
1101,台泥,21,4,17,元大-大天母,2024-04-01,9893
3706,神達,21,5,16,元大-大天母,2024-04-01,9893
00940,元大台灣價值高息,640,70,570,元大-大天母,2024-04-02,9893
4953,緯軟,191,2,189,元大-大天母,2024-04-02,9893
00933B,國泰10Y+金融債,143,22,121,元大-大天母,2024-04-02,9893
4919,新唐,102,3,99,元大-大天母,2024-04-02,9893
6505,台塑化,84,0,84,元大-大天母,2024-04-02,9893
00632R,元大台灣50反1,127,50,77,元大-大天母,2024-04-02,9893
00937B,群益ESG投等債20,61,1,60,元大-大天母,2024-04-02,9893
1815,富喬,83,25,58,元大-大天母,2024-04-02,9893
6016,康和證,70,15,55,元大-大天母,2024-04-02,9893
00650L,復華香港正2,50,0,50,元大-大天母,2024-04-02,9893
6284,佳邦,49,0,49,元大-大天母,2024-04-02,9893
00941,中信上游半導體,63,14,49,元大-大天母,2024-04-02,9893
6806,森崴能源,50,1,49,元大-大天母,2024-04-02,9893
2371,大同,65,23,42,元大-大天母,2024-04-02,9893
2618,長榮航,42,3,39,元大-大天母,2024-04-02,9893
6005,群益證,50,12,38,元大-大天母,2024-04-02,9893
00720B,元大投資級公司債,35,0,35,元大-大天母,2024-04-02,9893
00687B,國泰20年美債,32,0,32,元大-大天母,2024-04-02,9893
8033,雷虎,36,6,30,元大-大天母,2024-04-02,9893
1905,華紙,30,0,30,元大-大天母,2024-04-02,9893
00637L,元大滬深300正2,40,12,28,元大-大天母,2024-04-02,9893
2439,美律,29,1,28,元大-大天母,2024-04-02,9893
3570,大塚,25,0,25,元大-大天母,2024-04-02,9893
00751B,元大AAA至A公司債,25,0,25,元大-大天母,2024-04-02,9893
00673R,期元大S＆P原油反1,24,0,24,元大-大天母,2024-04-02,9893
5880,合庫金,24,0,24,元大-大天母,2024-04-02,9893
00679B,元大美債20年,33,10,23,元大-大天母,2024-04-02,9893
1609,大亞,37,15,22,元大-大天母,2024-04-02,9893
2408,南亞科,27,5,22,元大-大天母,2024-04-02,9893
6196,帆宣,32,11,21,元大-大天母,2024-04-02,9893
2356,英業達,34,13,21,元大-大天母,2024-04-02,9893
00680L,元大美債20正2,23,2,21,元大-大天母,2024-04-02,9893
3015,全漢,20,0,20,元大-大天母,2024-04-02,9893
2014,中鴻,20,0,20,元大-大天母,2024-04-02,9893
4747,強生,20,0,20,元大-大天母,2024-04-02,9893
6616,特昇-KY,20,0,20,元大-大天母,2024-04-02,9893
6179,亞通,21,1,20,元大-大天母,2024-04-02,9893
2458,義隆,19,0,19,元大-大天母,2024-04-02,9893
6643,M31,20,1,19,元大-大天母,2024-04-02,9893
6278,台表科,31,12,19,元大-大天母,2024-04-02,9893
2809,京城銀,20,1,19,元大-大天母,2024-04-02,9893
1304,台聚,19,0,19,元大-大天母,2024-04-02,9893
6126,信音,20,1,19,元大-大天母,2024-04-02,9893
5474,聰泰,20,1,19,元大-大天母,2024-04-02,9893
7402,邑錡,36,18,18,元大-大天母,2024-04-02,9893
6785,昱展新藥,18,0,18,元大-大天母,2024-04-02,9893
00902,中信電池及儲能,18,0,18,元大-大天母,2024-04-02,9893
2374,佳能,20,3,17,元大-大天母,2024-04-02,9893
2637,慧洋-KY,17,0,17,元大-大天母,2024-04-02,9893
6873,泓德能源,17,0,17,元大-大天母,2024-04-02,9893
00937B,群益ESG投等債20,219,5,214,元大-大天母,2024-04-03,9893
6120,達運,205,14,191,元大-大天母,2024-04-03,9893
3481,群創,147,0,147,元大-大天母,2024-04-03,9893
2409,友達,137,1,136,元大-大天母,2024-04-03,9893
00927,群益半導體收益,112,0,112,元大-大天母,2024-04-03,9893
1795,美時,122,17,105,元大-大天母,2024-04-03,9893
6806,森崴能源,103,2,101,元大-大天母,2024-04-03,9893
3715,定穎投控,124,24,100,元大-大天母,2024-04-03,9893
6202,盛群,97,0,97,元大-大天母,2024-04-03,9893
00720B,元大投資級公司債,95,0,95,元大-大天母,2024-04-03,9893
00940,元大台灣價值高息,167,94,73,元大-大天母,2024-04-03,9893
00665L,富邦�琤肭磪囓�2,104,33,71,元大-大天母,2024-04-03,9893
00933B,國泰10Y+金融債,76,10,66,元大-大天母,2024-04-03,9893
1101,台泥,72,12,60,元大-大天母,2024-04-03,9893
2382,廣達,61,9,52,元大-大天母,2024-04-03,9893
2891,中信金,62,20,42,元大-大天母,2024-04-03,9893
2376,技嘉,58,16,42,元大-大天母,2024-04-03,9893
00941,中信上游半導體,41,0,41,元大-大天母,2024-04-03,9893
0056,元大高股息,45,5,40,元大-大天母,2024-04-03,9893
2889,國票金,205,165,40,元大-大天母,2024-04-03,9893
00679B,元大美債20年,40,1,39,元大-大天母,2024-04-03,9893
8088,品安,41,3,38,元大-大天母,2024-04-03,9893
1434,福懋,38,0,38,元大-大天母,2024-04-03,9893
2609,陽明,35,0,35,元大-大天母,2024-04-03,9893
4961,天鈺,47,12,35,元大-大天母,2024-04-03,9893
00673R,期元大S＆P原油反1,34,0,34,元大-大天母,2024-04-03,9893
00929,復華台灣科技優息,51,19,32,元大-大天母,2024-04-03,9893
6245,立端,32,0,32,元大-大天母,2024-04-03,9893
1609,大亞,53,21,32,元大-大天母,2024-04-03,9893
00902,中信電池及儲能,30,0,30,元大-大天母,2024-04-03,9893
2010,春源,36,6,30,元大-大天母,2024-04-03,9893
00905,FT臺灣Smart,30,0,30,元大-大天母,2024-04-03,9893
2881,富邦金,30,0,30,元大-大天母,2024-04-03,9893
4953,緯軟,27,0,27,元大-大天母,2024-04-03,9893
00680L,元大美債20正2,26,0,26,元大-大天母,2024-04-03,9893
1527,鑽全,26,0,26,元大-大天母,2024-04-03,9893
2880,華南金,23,0,23,元大-大天母,2024-04-03,9893
2892,第一金,24,2,22,元大-大天母,2024-04-03,9893
5876,上海商銀,21,0,21,元大-大天母,2024-04-03,9893
1504,東元,26,5,21,元大-大天母,2024-04-03,9893
1314,中石化,21,1,20,元大-大天母,2024-04-03,9893
2371,大同,31,11,20,元大-大天母,2024-04-03,9893
6616,特昇-KY,20,0,20,元大-大天母,2024-04-03,9893
2383,台光電,20,0,20,元大-大天母,2024-04-03,9893
6126,信音,21,2,19,元大-大天母,2024-04-03,9893
2317,鴻海,107,89,18,元大-大天母,2024-04-03,9893
6196,帆宣,19,0,19,元大-大天母,2024-04-03,9893
00687B,國泰20年美債,18,0,18,元大-大天母,2024-04-03,9893
00919,群益台灣精選高息,17,0,17,元大-大天母,2024-04-03,9893
3048,益登,17,0,17,元大-大天母,2024-04-03,9893
00940,元大台灣價值高息,1147,146,1001,元大-大天母,2024-04-08,9893
00680L,元大美債20正2,219,17,202,元大-大天母,2024-04-08,9893
1101,台泥,110,1,109,元大-大天母,2024-04-08,9893
6274,台燿,104,5,99,元大-大天母,2024-04-08,9893
00679B,元大美債20年,96,1,95,元大-大天母,2024-04-08,9893
00933B,國泰10Y+金融債,93,0,93,元大-大天母,2024-04-08,9893
00937B,群益ESG投等債20,89,0,89,元大-大天母,2024-04-08,9893
00929,復華台灣科技優息,102,24,78,元大-大天母,2024-04-08,9893
4532,瑞智,78,3,75,元大-大天母,2024-04-08,9893
6788,華景電,70,0,70,元大-大天母,2024-04-08,9893
6120,達運,147,88,59,元大-大天母,2024-04-08,9893
5324,士開,60,5,55,元大-大天母,2024-04-08,9893
6288,聯嘉,52,1,51,元大-大天母,2024-04-08,9893
6432,今展科,50,0,50,元大-大天母,2024-04-08,9893
00687B,國泰20年美債,57,8,49,元大-大天母,2024-04-08,9893
2889,國票金,46,0,46,元大-大天母,2024-04-08,9893
5521,工信,53,10,43,元大-大天母,2024-04-08,9893
6806,森崴能源,48,6,42,元大-大天母,2024-04-08,9893
8112,至上,53,12,41,元大-大天母,2024-04-08,9893
00720B,元大投資級公司債,38,0,38,元大-大天母,2024-04-08,9893
8044,網家,37,0,37,元大-大天母,2024-04-08,9893
4938,和碩,67,31,36,元大-大天母,2024-04-08,9893
8111,立��,36,2,34,元大-大天母,2024-04-08,9893
1609,大亞,68,35,33,元大-大天母,2024-04-08,9893
2371,大同,46,13,33,元大-大天母,2024-04-08,9893
00919,群益台灣精選高息,45,13,32,元大-大天母,2024-04-08,9893
6121,新普,31,0,31,元大-大天母,2024-04-08,9893
00751B,元大AAA至A公司債,30,0,30,元大-大天母,2024-04-08,9893
3062,建漢,31,1,30,元大-大天母,2024-04-08,9893
1734,杏輝,30,0,30,元大-大天母,2024-04-08,9893
2344,華邦電,30,0,30,元大-大天母,2024-04-08,9893
2356,英業達,36,7,29,元大-大天母,2024-04-08,9893
00632R,元大台灣50反1,32,3,29,元大-大天母,2024-04-08,9893
4746,台耀,38,11,27,元大-大天母,2024-04-08,9893
2324,仁寶,29,4,25,元大-大天母,2024-04-08,9893
3481,群創,28,5,23,元大-大天母,2024-04-08,9893
00931B,統一美債20年,22,0,22,元大-大天母,2024-04-08,9893
2882,國泰金,21,0,21,元大-大天母,2024-04-08,9893
00795B,中信美國公債20年,21,0,21,元大-大天母,2024-04-08,9893
3324,雙鴻,27,6,21,元大-大天母,2024-04-08,9893
3023,信邦,20,0,20,元大-大天母,2024-04-08,9893
1785,光洋科,23,3,20,元大-大天母,2024-04-08,9893
6204,艾華,20,1,19,元大-大天母,2024-04-08,9893
4128,中天,18,0,18,元大-大天母,2024-04-08,9893
8088,品安,21,3,18,元大-大天母,2024-04-08,9893
2515,中工,28,11,17,元大-大天母,2024-04-08,9893
3013,晟銘電,33,16,17,元大-大天母,2024-04-08,9893
6026,福邦證,17,0,17,元大-大天母,2024-04-08,9893
00878,國泰永續高股息,21,5,16,元大-大天母,2024-04-08,9893
00772B,中信高評級公司債,15,0,15,元大-大天母,2024-04-08,9893
00632R,元大台灣50反1,403,0,403,元大-大天母,2024-04-09,9893
3231,緯創,307,50,257,元大-大天母,2024-04-09,9893
2515,中工,192,19,173,元大-大天母,2024-04-09,9893
00940,元大台灣價值高息,188,27,161,元大-大天母,2024-04-09,9893
6168,宏齊,211,87,124,元大-大天母,2024-04-09,9893
00937B,群益ESG投等債20,121,1,120,元大-大天母,2024-04-09,9893
2634,漢翔,159,50,109,元大-大天母,2024-04-09,9893
3083,網龍,109,0,109,元大-大天母,2024-04-09,9893
00680L,元大美債20正2,100,8,92,元大-大天母,2024-04-09,9893
2520,冠德,71,0,71,元大-大天母,2024-04-09,9893
00679B,元大美債20年,65,1,64,元大-大天母,2024-04-09,9893
8349,�矬�,50,0,50,元大-大天母,2024-04-09,9893
3060,銘異,54,5,49,元大-大天母,2024-04-09,9893
1527,鑽全,47,0,47,元大-大天母,2024-04-09,9893
2365,昆盈,60,13,47,元大-大天母,2024-04-09,9893
2882,國泰金,122,80,42,元大-大天母,2024-04-09,9893
5432,新門,40,0,40,元大-大天母,2024-04-09,9893
4973,廣穎,40,0,40,元大-大天母,2024-04-09,9893
2498,宏達電,37,0,37,元大-大天母,2024-04-09,9893
2014,中鴻,46,9,37,元大-大天母,2024-04-09,9893
2354,鴻準,46,10,36,元大-大天母,2024-04-09,9893
6189,豐藝,42,8,34,元大-大天母,2024-04-09,9893
00676R,富邦臺灣加權反1,34,0,34,元大-大天母,2024-04-09,9893
4533,協易機,64,31,33,元大-大天母,2024-04-09,9893
3706,神達,34,4,30,元大-大天母,2024-04-09,9893
3013,晟銘電,54,27,27,元大-大天母,2024-04-09,9893
2883,凱基金,36,9,27,元大-大天母,2024-04-09,9893
6188,廣明,37,10,27,元大-大天母,2024-04-09,9893
8033,雷虎,33,8,25,元大-大天母,2024-04-09,9893
4714,永捷,35,11,24,元大-大天母,2024-04-09,9893
1477,聚陽,24,0,24,元大-大天母,2024-04-09,9893
2371,大同,57,35,22,元大-大天母,2024-04-09,9893
1733,五鼎,22,0,22,元大-大天母,2024-04-09,9893
6207,雷科,85,64,21,元大-大天母,2024-04-09,9893
8085,福華,23,2,21,元大-大天母,2024-04-09,9893
4938,和碩,23,2,21,元大-大天母,2024-04-09,9893
5469,瀚宇博,21,0,21,元大-大天母,2024-04-09,9893
2450,神腦,20,0,20,元大-大天母,2024-04-09,9893
6613,朋億*,20,0,20,元大-大天母,2024-04-09,9893
6274,台燿,24,5,19,元大-大天母,2024-04-09,9893
2337,旺宏,21,2,19,元大-大天母,2024-04-09,9893
2486,一詮,37,18,19,元大-大天母,2024-04-09,9893
2301,光寶科,25,7,18,元大-大天母,2024-04-09,9893
2537,聯上發,24,6,18,元大-大天母,2024-04-09,9893
8096,擎亞,21,3,18,元大-大天母,2024-04-09,9893
00933B,國泰10Y+金融債,17,0,17,元大-大天母,2024-04-09,9893
8054,安國,23,6,17,元大-大天母,2024-04-09,9893
00929,復華台灣科技優息,22,7,15,元大-大天母,2024-04-09,9893
00857B,永豐20年美公債,15,0,15,元大-大天母,2024-04-09,9893
8039,台虹,16,1,15,元大-大天母,2024-04-09,9893
2882,國泰金,219,9,210,元大-大天母,2024-04-10,9893
2883,凱基金,187,31,156,元大-大天母,2024-04-10,9893
2889,國票金,144,1,143,元大-大天母,2024-04-10,9893
3013,晟銘電,109,25,84,元大-大天母,2024-04-10,9893
3033,威健,97,19,78,元大-大天母,2024-04-10,9893
3231,緯創,113,40,73,元大-大天母,2024-04-10,9893
3481,群創,95,22,73,元大-大天母,2024-04-10,9893
2382,廣達,98,26,72,元大-大天母,2024-04-10,9893
6719,力智,68,5,63,元大-大天母,2024-04-10,9893
2329,華泰,100,38,62,元大-大天母,2024-04-10,9893
2515,中工,88,33,55,元大-大天母,2024-04-10,9893
2031,新光鋼,52,0,52,元大-大天母,2024-04-10,9893
6168,宏齊,50,0,50,元大-大天母,2024-04-10,9893
00927,群益半導體收益,50,0,50,元大-大天母,2024-04-10,9893
6415,矽力*-KY,48,2,46,元大-大天母,2024-04-10,9893
00940,元大台灣價值高息,110,66,44,元大-大天母,2024-04-10,9893
3005,神基,43,1,42,元大-大天母,2024-04-10,9893
3083,網龍,41,0,41,元大-大天母,2024-04-10,9893
6016,康和證,40,0,40,元大-大天母,2024-04-10,9893
2891,中信金,52,15,37,元大-大天母,2024-04-10,9893
2324,仁寶,40,5,35,元大-大天母,2024-04-10,9893
5521,工信,35,0,35,元大-大天母,2024-04-10,9893
2634,漢翔,61,27,34,元大-大天母,2024-04-10,9893
2890,永豐金,35,3,32,元大-大天母,2024-04-10,9893
00752,中信中國50,30,0,30,元大-大天母,2024-04-10,9893
2520,冠德,30,0,30,元大-大天母,2024-04-10,9893
1513,中興電,72,43,29,元大-大天母,2024-04-10,9893
1608,華榮,96,68,28,元大-大天母,2024-04-10,9893
2888,新光金,38,12,26,元大-大天母,2024-04-10,9893
2365,昆盈,26,0,26,元大-大天母,2024-04-10,9893
2376,技嘉,35,10,25,元大-大天母,2024-04-10,9893
6121,新普,25,0,25,元大-大天母,2024-04-10,9893
2609,陽明,46,23,23,元大-大天母,2024-04-10,9893
2108,南帝,23,0,23,元大-大天母,2024-04-10,9893
1503,士電,47,25,22,元大-大天母,2024-04-10,9893
3444,利機,20,0,20,元大-大天母,2024-04-10,9893
00637L,元大滬深300正2,25,5,20,元大-大天母,2024-04-10,9893
9939,宏全,20,0,20,元大-大天母,2024-04-10,9893
2337,旺宏,20,0,20,元大-大天母,2024-04-10,9893
2009,第一銅,49,30,19,元大-大天母,2024-04-10,9893
4167,松瑞藥,20,1,19,元大-大天母,2024-04-10,9893
4533,協易機,57,39,18,元大-大天母,2024-04-10,9893
00679B,元大美債20年,21,4,17,元大-大天母,2024-04-10,9893
6278,台表科,22,5,17,元大-大天母,2024-04-10,9893
6788,華景電,17,0,17,元大-大天母,2024-04-10,9893
3499,環天科,17,0,17,元大-大天母,2024-04-10,9893
00919,群益台灣精選高息,22,6,16,元大-大天母,2024-04-10,9893
8227,巨有科技,16,0,16,元大-大天母,2024-04-10,9893
00929,復華台灣科技優息,17,2,15,元大-大天母,2024-04-10,9893
1785,光洋科,32,17,15,元大-大天母,2024-04-10,9893
3481,群創,370,3,367,元大-大天母,2024-04-11,9893
6016,康和證,120,0,120,元大-大天母,2024-04-11,9893
00679B,元大美債20年,105,0,105,元大-大天母,2024-04-11,9893
00680L,元大美債20正2,102,3,99,元大-大天母,2024-04-11,9893
00937B,群益ESG投等債20,91,4,87,元大-大天母,2024-04-11,9893
00720B,元大投資級公司債,86,0,86,元大-大天母,2024-04-11,9893
00933B,國泰10Y+金融債,82,0,82,元大-大天母,2024-04-11,9893
1736,喬山,81,2,79,元大-大天母,2024-04-11,9893
2303,聯電,86,20,66,元大-大天母,2024-04-11,9893
4533,協易機,76,14,62,元大-大天母,2024-04-11,9893
2317,鴻海,120,65,55,元大-大天母,2024-04-11,9893
4714,永捷,54,2,52,元大-大天母,2024-04-11,9893
00687B,國泰20年美債,52,2,50,元大-大天母,2024-04-11,9893
1527,鑽全,48,0,48,元大-大天母,2024-04-11,9893
2498,宏達電,47,0,47,元大-大天母,2024-04-11,9893
0056,元大高股息,65,23,42,元大-大天母,2024-04-11,9893
6126,信音,41,2,39,元大-大天母,2024-04-11,9893
3034,聯詠,40,1,39,元大-大天母,2024-04-11,9893
6873,泓德能源,38,0,38,元大-大天母,2024-04-11,9893
5324,士開,38,0,38,元大-大天母,2024-04-11,9893
00712,復華富時不動產,37,0,37,元大-大天母,2024-04-11,9893
2354,鴻準,50,13,37,元大-大天母,2024-04-11,9893
2409,友達,35,0,35,元大-大天母,2024-04-11,9893
2030,彰源,35,0,35,元大-大天母,2024-04-11,9893
2520,冠德,38,3,35,元大-大天母,2024-04-11,9893
1609,大亞,206,175,31,元大-大天母,2024-04-11,9893
00885,富邦越南,31,0,31,元大-大天母,2024-04-11,9893
00751B,元大AAA至A公司債,31,0,31,元大-大天母,2024-04-11,9893
6799,來頡,30,0,30,元大-大天母,2024-04-11,9893
2706,第一店,50,20,30,元大-大天母,2024-04-11,9893
1605,華新,34,5,29,元大-大天母,2024-04-11,9893
3714,富采,29,1,28,元大-大天母,2024-04-11,9893
6425,易發,27,0,27,元大-大天母,2024-04-11,9893
00878,國泰永續高股息,26,0,26,元大-大天母,2024-04-11,9893
2634,漢翔,43,18,25,元大-大天母,2024-04-11,9893
2009,第一銅,45,21,24,元大-大天母,2024-04-11,9893
2348,海悅,23,0,23,元大-大天母,2024-04-11,9893
00929,復華台灣科技優息,43,21,22,元大-大天母,2024-04-11,9893
3032,偉訓,23,2,21,元大-大天母,2024-04-11,9893
00941,中信上游半導體,22,1,21,元大-大天母,2024-04-11,9893
00918,大華優利高填息30,21,1,20,元大-大天母,2024-04-11,9893
6472,保瑞,23,3,20,元大-大天母,2024-04-11,9893
4747,強生,20,0,20,元大-大天母,2024-04-11,9893
5531,鄉林,20,0,20,元大-大天母,2024-04-11,9893
3490,單井,20,0,20,元大-大天母,2024-04-11,9893
9958,世紀鋼,20,1,19,元大-大天母,2024-04-11,9893
2329,華泰,35,16,19,元大-大天母,2024-04-11,9893
6168,宏齊,19,0,19,元大-大天母,2024-04-11,9893
2607,榮運,26,7,19,元大-大天母,2024-04-11,9893
6789,采鈺,18,0,18,元大-大天母,2024-04-11,9893
00680L,元大美債20正2,515,0,515,元大-大天母,2024-04-12,9893
00665L,富邦�琤肭磪囓�2,481,20,461,元大-大天母,2024-04-12,9893
00940,元大台灣價值高息,353,112,241,元大-大天母,2024-04-12,9893
2344,華邦電,167,5,162,元大-大天母,2024-04-12,9893
2501,國建,136,27,109,元大-大天母,2024-04-12,9893
8271,宇瞻,107,2,105,元大-大天母,2024-04-12,9893
9955,佳龍,93,2,91,元大-大天母,2024-04-12,9893
2353,宏��,182,103,79,元大-大天母,2024-04-12,9893
2809,京城銀,70,0,70,元大-大天母,2024-04-12,9893
3034,聯詠,67,4,63,元大-大天母,2024-04-12,9893
3372,典範,61,1,60,元大-大天母,2024-04-12,9893
00679B,元大美債20年,58,0,58,元大-大天母,2024-04-12,9893
2882,國泰金,54,3,51,元大-大天母,2024-04-12,9893
4513,福裕,50,0,50,元大-大天母,2024-04-12,9893
2511,太子,50,1,49,元大-大天母,2024-04-12,9893
00687B,國泰20年美債,53,5,48,元大-大天母,2024-04-12,9893
1711,永光,47,0,47,元大-大天母,2024-04-12,9893
2382,廣達,61,19,42,元大-大天母,2024-04-12,9893
0056,元大高股息,38,2,36,元大-大天母,2024-04-12,9893
3231,緯創,54,24,30,元大-大天母,2024-04-12,9893
00720B,元大投資級公司債,30,0,30,元大-大天母,2024-04-12,9893
00933B,國泰10Y+金融債,51,22,29,元大-大天母,2024-04-12,9893
2618,長榮航,40,12,28,元大-大天母,2024-04-12,9893
3490,單井,30,3,27,元大-大天母,2024-04-12,9893
6278,台表科,29,4,25,元大-大天母,2024-04-12,9893
1101,台泥,34,10,24,元大-大天母,2024-04-12,9893
3714,富采,25,2,23,元大-大天母,2024-04-12,9893
3715,定穎投控,23,0,23,元大-大天母,2024-04-12,9893
2881,富邦金,24,2,22,元大-大天母,2024-04-12,9893
2515,中工,25,3,22,元大-大天母,2024-04-12,9893
2892,第一金,24,2,22,元大-大天母,2024-04-12,9893
00878,國泰永續高股息,28,7,21,元大-大天母,2024-04-12,9893
2889,國票金,20,0,20,元大-大天母,2024-04-12,9893
2832,台產,20,1,19,元大-大天母,2024-04-12,9893
00931B,統一美債20年,30,12,18,元大-大天母,2024-04-12,9893
3060,銘異,23,5,18,元大-大天母,2024-04-12,9893
00751B,元大AAA至A公司債,18,0,18,元大-大天母,2024-04-12,9893
00753L,中信中國50正2,16,0,16,元大-大天母,2024-04-12,9893
2467,志聖,17,2,15,元大-大天母,2024-04-12,9893
2355,敬鵬,17,2,15,元大-大天母,2024-04-12,9893
5425,台半,17,2,15,元大-大天母,2024-04-12,9893
6016,康和證,15,0,15,元大-大天母,2024-04-12,9893
00919,群益台灣精選高息,16,1,15,元大-大天母,2024-04-12,9893
2376,技嘉,32,18,14,元大-大天母,2024-04-12,9893
00941,中信上游半導體,15,1,14,元大-大天母,2024-04-12,9893
5880,合庫金,14,0,14,元大-大天母,2024-04-12,9893
3138,耀登,14,1,13,元大-大天母,2024-04-12,9893
4303,信立,14,1,13,元大-大天母,2024-04-12,9893
6664,群翊,15,2,13,元大-大天母,2024-04-12,9893
00937B,群益ESG投等債20,14,2,12,元大-大天母,2024-04-12,9893
2371,大同,840,187,653,元大-大天母,2024-04-15,9893
2883,凱基金,352,14,338,元大-大天母,2024-04-15,9893
3059,華晶科,347,25,322,元大-大天母,2024-04-15,9893
00929,復華台灣科技優息,153,24,129,元大-大天母,2024-04-15,9893
00940,元大台灣價值高息,155,30,125,元大-大天母,2024-04-15,9893
3060,銘異,125,4,121,元大-大天母,2024-04-15,9893
00720B,元大投資級公司債,111,2,109,元大-大天母,2024-04-15,9893
1605,華新,163,55,108,元大-大天母,2024-04-15,9893
5009,榮剛,110,3,107,元大-大天母,2024-04-15,9893
2645,長榮航太,104,8,96,元大-大天母,2024-04-15,9893
2303,聯電,86,4,82,元大-大天母,2024-04-15,9893
8085,福華,69,2,67,元大-大天母,2024-04-15,9893
4953,緯軟,65,0,65,元大-大天母,2024-04-15,9893
00939,統一台灣高息動能,58,0,58,元大-大天母,2024-04-15,9893
0056,元大高股息,85,30,55,元大-大天母,2024-04-15,9893
5234,達興材料,54,3,51,元大-大天母,2024-04-15,9893
2913,農林,48,4,44,元大-大天母,2024-04-15,9893
00885,富邦越南,50,10,40,元大-大天母,2024-04-15,9893
6278,台表科,40,1,39,元大-大天母,2024-04-15,9893
2610,華航,46,7,39,元大-大天母,2024-04-15,9893
1513,中興電,113,76,37,元大-大天母,2024-04-15,9893
00733,富邦臺灣中小,38,1,37,元大-大天母,2024-04-15,9893
00933B,國泰10Y+金融債,36,0,36,元大-大天母,2024-04-15,9893
00941,中信上游半導體,38,4,34,元大-大天母,2024-04-15,9893
2637,慧洋-KY,43,11,32,元大-大天母,2024-04-15,9893
1795,美時,39,8,31,元大-大天母,2024-04-15,9893
5324,士開,31,0,31,元大-大天母,2024-04-15,9893
2367,燿華,57,27,30,元大-大天母,2024-04-15,9893
2836,高雄銀,30,1,29,元大-大天母,2024-04-15,9893
4714,永捷,31,2,29,元大-大天母,2024-04-15,9893
3706,神達,37,8,29,元大-大天母,2024-04-15,9893
00715L,期街口布蘭特正2,32,4,28,元大-大天母,2024-04-15,9893
3033,威健,27,2,25,元大-大天母,2024-04-15,9893
6168,宏齊,24,0,24,元大-大天母,2024-04-15,9893
2317,鴻海,51,28,23,元大-大天母,2024-04-15,9893
2301,光寶科,26,3,23,元大-大天母,2024-04-15,9893
3622,洋華,52,29,23,元大-大天母,2024-04-15,9893
00878,國泰永續高股息,41,19,22,元大-大天母,2024-04-15,9893
00665L,富邦�琤肭磪囓�2,51,30,21,元大-大天母,2024-04-15,9893
6282,康舒,20,0,20,元大-大天母,2024-04-15,9893
1445,大宇,20,0,20,元大-大天母,2024-04-15,9893
1815,富喬,21,1,20,元大-大天母,2024-04-15,9893
2506,太設,20,0,20,元大-大天母,2024-04-15,9893
6026,福邦證,20,0,20,元大-大天母,2024-04-15,9893
2201,裕隆,20,0,20,元大-大天母,2024-04-15,9893
4919,新唐,21,1,20,元大-大天母,2024-04-15,9893
6126,信音,20,0,20,元大-大天母,2024-04-15,9893
2353,宏��,46,26,20,元大-大天母,2024-04-15,9893
6290,良維,24,6,18,元大-大天母,2024-04-15,9893
00922,國泰台灣領袖50,19,1,18,元大-大天母,2024-04-15,9893
00940,元大台灣價值高息,1037,108,929,元大-大天母,2024-04-16,9893
00671R,富邦NASDAQ反1,575,0,575,元大-大天母,2024-04-16,9893
00632R,元大台灣50反1,661,238,423,元大-大天母,2024-04-16,9893
00937B,群益ESG投等債20,268,1,267,元大-大天母,2024-04-16,9893
0056,元大高股息,263,3,260,元大-大天母,2024-04-16,9893
00929,復華台灣科技優息,267,60,207,元大-大天母,2024-04-16,9893
2890,永豐金,200,15,185,元大-大天母,2024-04-16,9893
2883,凱基金,200,19,181,元大-大天母,2024-04-16,9893
2867,三商壽,173,47,126,元大-大天母,2024-04-16,9893
2301,光寶科,100,1,99,元大-大天母,2024-04-16,9893
00919,群益台灣精選高息,204,114,90,元大-大天母,2024-04-16,9893
6016,康和證,86,0,86,元大-大天母,2024-04-16,9893
3481,群創,88,9,79,元大-大天母,2024-04-16,9893
00939,統一台灣高息動能,78,0,78,元大-大天母,2024-04-16,9893
1605,華新,136,59,77,元大-大天母,2024-04-16,9893
00878,國泰永續高股息,152,75,77,元大-大天母,2024-04-16,9893
6505,台塑化,75,0,75,元大-大天母,2024-04-16,9893
2886,兆豐金,72,1,71,元大-大天母,2024-04-16,9893
2897,王道銀行,65,0,65,元大-大天母,2024-04-16,9893
2892,第一金,66,1,65,元大-大天母,2024-04-16,9893
2382,廣達,71,7,64,元大-大天母,2024-04-16,9893
00885,富邦越南,63,0,63,元大-大天母,2024-04-16,9893
4953,緯軟,62,0,62,元大-大天母,2024-04-16,9893
2884,玉山金,61,0,61,元大-大天母,2024-04-16,9893
5324,士開,61,0,61,元大-大天母,2024-04-16,9893
2331,精英,60,0,60,元大-大天母,2024-04-16,9893
00922,國泰台灣領袖50,60,4,56,元大-大天母,2024-04-16,9893
2344,華邦電,54,0,54,元大-大天母,2024-04-16,9893
00720B,元大投資級公司債,54,0,54,元大-大天母,2024-04-16,9893
3711,日月光投控,53,1,52,元大-大天母,2024-04-16,9893
2484,希華,51,0,51,元大-大天母,2024-04-16,9893
2353,宏��,53,6,47,元大-大天母,2024-04-16,9893
6245,立端,46,0,46,元大-大天母,2024-04-16,9893
2408,南亞科,45,0,45,元大-大天母,2024-04-16,9893
6239,力成,46,1,45,元大-大天母,2024-04-16,9893
2303,聯電,71,28,43,元大-大天母,2024-04-16,9893
2330,台積電,53,11,42,元大-大天母,2024-04-16,9893
1618,合機,165,125,40,元大-大天母,2024-04-16,9893
6217,中探針,41,2,39,元大-大天母,2024-04-16,9893
9938,百和,41,2,39,元大-大天母,2024-04-16,9893
00715L,期街口布蘭特正2,39,0,39,元大-大天母,2024-04-16,9893
00751B,元大AAA至A公司債,47,11,36,元大-大天母,2024-04-16,9893
00712,復華富時不動產,36,0,36,元大-大天母,2024-04-16,9893
00679B,元大美債20年,36,0,36,元大-大天母,2024-04-16,9893
00687B,國泰20年美債,48,14,34,元大-大天母,2024-04-16,9893
2887,台新金,32,0,32,元大-大天母,2024-04-16,9893
1101,台泥,43,11,32,元大-大天母,2024-04-16,9893
00927,群益半導體收益,32,1,31,元大-大天母,2024-04-16,9893
2363,矽統,47,17,30,元大-大天母,2024-04-16,9893
3231,緯創,99,73,26,元大-大天母,2024-04-16,9893
00937B,群益ESG投等債20,329,0,329,元大-大天母,2024-04-17,9893
2886,兆豐金,243,15,228,元大-大天母,2024-04-17,9893
2511,太子,200,0,200,元大-大天母,2024-04-17,9893
6190,萬泰科,182,2,180,元大-大天母,2024-04-17,9893
00929,復華台灣科技優息,181,3,178,元大-大天母,2024-04-17,9893
00940,元大台灣價值高息,171,16,155,元大-大天母,2024-04-17,9893
3231,緯創,233,88,145,元大-大天母,2024-04-17,9893
1605,華新,235,105,130,元大-大天母,2024-04-17,9893
00687B,國泰20年美債,101,5,96,元大-大天母,2024-04-17,9893
2303,聯電,84,3,81,元大-大天母,2024-04-17,9893
00676R,富邦臺灣加權反1,80,0,80,元大-大天母,2024-04-17,9893
1467,南緯,80,0,80,元大-大天母,2024-04-17,9893
2618,長榮航,73,3,70,元大-大天母,2024-04-17,9893
00665L,富邦�琤肭磪囓�2,74,10,64,元大-大天母,2024-04-17,9893
4533,協易機,62,0,62,元大-大天母,2024-04-17,9893
00641R,富邦日本反1,60,0,60,元大-大天母,2024-04-17,9893
00720B,元大投資級公司債,64,10,54,元大-大天母,2024-04-17,9893
1611,中電,57,4,53,元大-大天母,2024-04-17,9893
4306,炎洲,50,0,50,元大-大天母,2024-04-17,9893
2408,南亞科,44,0,44,元大-大天母,2024-04-17,9893
00679B,元大美債20年,45,2,43,元大-大天母,2024-04-17,9893
00751B,元大AAA至A公司債,63,20,43,元大-大天母,2024-04-17,9893
00933B,國泰10Y+金融債,40,0,40,元大-大天母,2024-04-17,9893
2317,鴻海,66,28,38,元大-大天母,2024-04-17,9893
2301,光寶科,38,1,37,元大-大天母,2024-04-17,9893
00637L,元大滬深300正2,36,3,33,元大-大天母,2024-04-17,9893
00753L,中信中國50正2,32,0,32,元大-大天母,2024-04-17,9893
4138,曜亞,30,0,30,元大-大天母,2024-04-17,9893
2891,中信金,60,34,26,元大-大天母,2024-04-17,9893
2850,新產,25,0,25,元大-大天母,2024-04-17,9893
00650L,復華香港正2,77,52,25,元大-大天母,2024-04-17,9893
2547,日勝生,25,0,25,元大-大天母,2024-04-17,9893
9955,佳龍,38,15,23,元大-大天母,2024-04-17,9893
1303,南亞,22,0,22,元大-大天母,2024-04-17,9893
3673,TPK-KY,21,0,21,元大-大天母,2024-04-17,9893
2367,燿華,61,40,21,元大-大天母,2024-04-17,9893
00712,復華富時不動產,21,0,21,元大-大天母,2024-04-17,9893
3441,聯一光,20,0,20,元大-大天母,2024-04-17,9893
00941,中信上游半導體,23,4,19,元大-大天母,2024-04-17,9893
2520,冠德,20,1,19,元大-大天母,2024-04-17,9893
00857B,永豐20年美公債,19,0,19,元大-大天母,2024-04-17,9893
00772B,中信高評級公司債,21,2,19,元大-大天母,2024-04-17,9893
0056,元大高股息,97,78,19,元大-大天母,2024-04-17,9893
2363,矽統,43,25,18,元大-大天母,2024-04-17,9893
00878,國泰永續高股息,21,4,17,元大-大天母,2024-04-17,9893
2603,長榮,31,14,17,元大-大天母,2024-04-17,9893
00891,中信關鍵半導體,16,0,16,元大-大天母,2024-04-17,9893
6550,北極星藥業-KY,16,0,16,元大-大天母,2024-04-17,9893
00939,統一台灣高息動能,17,1,16,元大-大天母,2024-04-17,9893
8046,南電,22,7,15,元大-大天母,2024-04-17,9893
2371,大同,846,208,638,元大-大天母,2024-04-18,9893
2882,國泰金,311,13,298,元大-大天母,2024-04-18,9893
2027,大成鋼,166,10,156,元大-大天母,2024-04-18,9893
2537,聯上發,152,1,151,元大-大天母,2024-04-18,9893
6264,富裔,141,5,136,元大-大天母,2024-04-18,9893
00940,元大台灣價值高息,180,52,128,元大-大天母,2024-04-18,9893
3052,夆典,137,13,124,元大-大天母,2024-04-18,9893
00937B,群益ESG投等債20,111,0,111,元大-大天母,2024-04-18,9893
0056,元大高股息,95,12,83,元大-大天母,2024-04-18,9893
1609,大亞,169,93,76,元大-大天母,2024-04-18,9893
00679B,元大美債20年,74,0,74,元大-大天母,2024-04-18,9893
1605,華新,134,64,70,元大-大天母,2024-04-18,9893
6190,萬泰科,60,0,60,元大-大天母,2024-04-18,9893
1611,中電,86,28,58,元大-大天母,2024-04-18,9893
2367,燿華,73,19,54,元大-大天母,2024-04-18,9893
00772B,中信高評級公司債,51,0,51,元大-大天母,2024-04-18,9893
2610,華航,54,8,46,元大-大天母,2024-04-18,9893
2241,艾姆勒,45,0,45,元大-大天母,2024-04-18,9893
00919,群益台灣精選高息,48,5,43,元大-大天母,2024-04-18,9893
2897,王道銀行,41,0,41,元大-大天母,2024-04-18,9893
2329,華泰,59,20,39,元大-大天母,2024-04-18,9893
5522,遠雄,37,0,37,元大-大天母,2024-04-18,9893
2344,華邦電,50,13,37,元大-大天母,2024-04-18,9893
00720B,元大投資級公司債,34,0,34,元大-大天母,2024-04-18,9893
1608,華榮,72,39,33,元大-大天母,2024-04-18,9893
6239,力成,32,0,32,元大-大天母,2024-04-18,9893
2354,鴻準,31,1,30,元大-大天母,2024-04-18,9893
00641R,富邦日本反1,30,0,30,元大-大天母,2024-04-18,9893
1718,中纖,30,0,30,元大-大天母,2024-04-18,9893
00688L,國泰20年美債正2,29,0,29,元大-大天母,2024-04-18,9893
2382,廣達,35,7,28,元大-大天母,2024-04-18,9893
1532,勤美,37,9,28,元大-大天母,2024-04-18,9893
1108,幸福,31,3,28,元大-大天母,2024-04-18,9893
3711,日月光投控,28,1,27,元大-大天母,2024-04-18,9893
3013,晟銘電,72,46,26,元大-大天母,2024-04-18,9893
6282,康舒,27,1,26,元大-大天母,2024-04-18,9893
2465,麗臺,37,11,26,元大-大天母,2024-04-18,9893
2303,聯電,35,12,23,元大-大天母,2024-04-18,9893
00941,中信上游半導體,53,30,23,元大-大天母,2024-04-18,9893
00715L,期街口布蘭特正2,26,3,23,元大-大天母,2024-04-18,9893
00632R,元大台灣50反1,46,25,21,元大-大天母,2024-04-18,9893
2007,燁興,22,1,21,元大-大天母,2024-04-18,9893
8111,立��,20,0,20,元大-大天母,2024-04-18,9893
00942B,台新美A公司債20+,20,0,20,元大-大天母,2024-04-18,9893
3035,智原,22,2,20,元大-大天母,2024-04-18,9893
00733,富邦臺灣中小,19,1,18,元大-大天母,2024-04-18,9893
2630,亞航,25,7,18,元大-大天母,2024-04-18,9893
2474,可成,18,0,18,元大-大天母,2024-04-18,9893
3481,群創,50,33,17,元大-大天母,2024-04-18,9893
6432,今展科,20,3,17,元大-大天母,2024-04-18,9893
00929,復華台灣科技優息,401,10,391,元大-大天母,2024-04-19,9893
2303,聯電,380,13,367,元大-大天母,2024-04-19,9893
00940,元大台灣價值高息,582,274,308,元大-大天母,2024-04-19,9893
2511,太子,251,2,249,元大-大天母,2024-04-19,9893
0056,元大高股息,239,29,210,元大-大天母,2024-04-19,9893
2330,台積電,225,28,197,元大-大天母,2024-04-19,9893
00882,中信中國高股息,150,0,150,元大-大天母,2024-04-19,9893
2618,長榮航,161,21,140,元大-大天母,2024-04-19,9893
3703,欣陸,118,20,98,元大-大天母,2024-04-19,9893
00878,國泰永續高股息,116,20,96,元大-大天母,2024-04-19,9893
2834,臺企銀,111,27,84,元大-大天母,2024-04-19,9893
2498,宏達電,82,0,82,元大-大天母,2024-04-19,9893
4953,緯軟,76,1,75,元大-大天母,2024-04-19,9893
2515,中工,172,103,69,元大-大天母,2024-04-19,9893
00919,群益台灣精選高息,126,59,67,元大-大天母,2024-04-19,9893
2301,光寶科,77,12,65,元大-大天母,2024-04-19,9893
00939,統一台灣高息動能,63,0,63,元大-大天母,2024-04-19,9893
5512,力麒,85,24,61,元大-大天母,2024-04-19,9893
3666,光耀,52,0,52,元大-大天母,2024-04-19,9893
1312,國喬,50,0,50,元大-大天母,2024-04-19,9893
0050,元大台灣50,53,5,48,元大-大天母,2024-04-19,9893
1609,大亞,433,386,47,元大-大天母,2024-04-19,9893
5434,崇越,62,15,47,元大-大天母,2024-04-19,9893
3711,日月光投控,47,4,43,元大-大天母,2024-04-19,9893
2101,南港,92,49,43,元大-大天母,2024-04-19,9893
6215,和椿,46,5,41,元大-大天母,2024-04-19,9893
2317,鴻海,80,39,41,元大-大天母,2024-04-19,9893
2356,英業達,52,12,40,元大-大天母,2024-04-19,9893
00941,中信上游半導體,42,6,36,元大-大天母,2024-04-19,9893
00881,國泰台灣5G+,39,3,36,元大-大天母,2024-04-19,9893
2408,南亞科,37,3,34,元大-大天母,2024-04-19,9893
1805,寶徠,43,10,33,元大-大天母,2024-04-19,9893
8086,宏捷科,31,0,31,元大-大天母,2024-04-19,9893
6190,萬泰科,32,1,31,元大-大天母,2024-04-19,9893
2885,元大金,30,1,29,元大-大天母,2024-04-19,9893
00654R,富邦印度反1,28,0,28,元大-大天母,2024-04-19,9893
00922,國泰台灣領袖50,27,0,27,元大-大天母,2024-04-19,9893
1434,福懋,30,5,25,元大-大天母,2024-04-19,9893
6668,中揚光,31,6,25,元大-大天母,2024-04-19,9893
2062,橋椿,30,5,25,元大-大天母,2024-04-19,9893
00891,中信關鍵半導體,26,1,25,元大-大天母,2024-04-19,9893
2547,日勝生,33,9,24,元大-大天母,2024-04-19,9893
6239,力成,24,0,24,元大-大天母,2024-04-19,9893
2882,國泰金,37,13,24,元大-大天母,2024-04-19,9893
5347,世界,25,2,23,元大-大天母,2024-04-19,9893
2454,聯發科,31,8,23,元大-大天母,2024-04-19,9893
2883,凱基金,33,11,22,元大-大天母,2024-04-19,9893
2441,超豐,22,0,22,元大-大天母,2024-04-19,9893
00923,群益台ESG低碳50,22,0,22,元大-大天母,2024-04-19,9893
2845,遠東銀,21,0,21,元大-大天母,2024-04-19,9893
00665L,富邦�琤肭磪囓�2,300,0,300,元大-大天母,2024-04-22,9893
3481,群創,178,6,172,元大-大天母,2024-04-22,9893
2371,大同,413,241,172,元大-大天母,2024-04-22,9893
00940,元大台灣價值高息,289,125,164,元大-大天母,2024-04-22,9893
2511,太子,169,22,147,元大-大天母,2024-04-22,9893
00929,復華台灣科技優息,180,71,109,元大-大天母,2024-04-22,9893
5512,力麒,171,69,102,元大-大天母,2024-04-22,9893
4306,炎洲,192,93,99,元大-大天母,2024-04-22,9893
0056,元大高股息,99,6,93,元大-大天母,2024-04-22,9893
00919,群益台灣精選高息,114,31,83,元大-大天母,2024-04-22,9893
00937B,群益ESG投等債20,78,10,68,元大-大天母,2024-04-22,9893
2409,友達,108,41,67,元大-大天母,2024-04-22,9893
8069,元太,71,5,66,元大-大天母,2024-04-22,9893
00878,國泰永續高股息,69,5,64,元大-大天母,2024-04-22,9893
1440,南紡,70,8,62,元大-大天母,2024-04-22,9893
00939,統一台灣高息動能,59,1,58,元大-大天母,2024-04-22,9893
2886,兆豐金,63,5,58,元大-大天母,2024-04-22,9893
3703,欣陸,148,91,57,元大-大天母,2024-04-22,9893
2617,台航,56,0,56,元大-大天母,2024-04-22,9893
1216,統一,85,32,53,元大-大天母,2024-04-22,9893
3231,緯創,86,35,51,元大-大天母,2024-04-22,9893
6264,富裔,50,0,50,元大-大天母,2024-04-22,9893
00641R,富邦日本反1,48,0,48,元大-大天母,2024-04-22,9893
8936,國統,73,28,45,元大-大天母,2024-04-22,9893
2515,中工,151,110,41,元大-大天母,2024-04-22,9893
2484,希華,40,0,40,元大-大天母,2024-04-22,9893
5515,建國,50,11,39,元大-大天母,2024-04-22,9893
5521,工信,75,40,35,元大-大天母,2024-04-22,9893
00632R,元大台灣50反1,44,10,34,元大-大天母,2024-04-22,9893
6176,瑞儀,30,0,30,元大-大天母,2024-04-22,9893
2329,華泰,29,5,24,元大-大天母,2024-04-22,9893
2609,陽明,110,87,23,元大-大天母,2024-04-22,9893
8996,高力,24,2,22,元大-大天母,2024-04-22,9893
2303,聯電,81,61,20,元大-大天母,2024-04-22,9893
5230,雷笛克光學,40,20,20,元大-大天母,2024-04-22,9893
1618,合機,48,29,19,元大-大天母,2024-04-22,9893
00751B,元大AAA至A公司債,26,10,16,元大-大天母,2024-04-22,9893
1524,耿鼎,15,0,15,元大-大天母,2024-04-22,9893
1608,華榮,36,21,15,元大-大天母,2024-04-22,9893
2317,鴻海,52,38,14,元大-大天母,2024-04-22,9893
1709,和益,14,0,14,元大-大天母,2024-04-22,9893
8033,雷虎,18,4,14,元大-大天母,2024-04-22,9893
2408,南亞科,17,4,13,元大-大天母,2024-04-22,9893
2603,長榮,39,27,12,元大-大天母,2024-04-22,9893
6875,國邑*,12,0,12,元大-大天母,2024-04-22,9893
0050,元大台灣50,18,7,11,元大-大天母,2024-04-22,9893
6770,力積電,13,2,11,元大-大天母,2024-04-22,9893
2324,仁寶,26,15,11,元大-大天母,2024-04-22,9893
8088,品安,16,5,11,元大-大天母,2024-04-22,9893
1795,美時,14,3,11,元大-大天母,2024-04-22,9893
1314,中石化,116,10,106,元大-大天母,2024-04-23,9893
00940,元大台灣價值高息,114,15,99,元大-大天母,2024-04-23,9893
2303,聯電,117,18,99,元大-大天母,2024-04-23,9893
2515,中工,128,50,78,元大-大天母,2024-04-23,9893
2301,光寶科,65,1,64,元大-大天母,2024-04-23,9893
00929,復華台灣科技優息,95,39,56,元大-大天母,2024-04-23,9893
2204,中華,57,3,54,元大-大天母,2024-04-23,9893
6264,富裔,53,0,53,元大-大天母,2024-04-23,9893
2449,京元電子,56,8,48,元大-大天母,2024-04-23,9893
1609,大亞,194,146,48,元大-大天母,2024-04-23,9893
1440,南紡,54,8,46,元大-大天母,2024-04-23,9893
1802,台玻,41,0,41,元大-大天母,2024-04-23,9893
2630,亞航,42,3,39,元大-大天母,2024-04-23,9893
2882,國泰金,40,5,35,元大-大天母,2024-04-23,9893
00878,國泰永續高股息,36,1,35,元大-大天母,2024-04-23,9893
00919,群益台灣精選高息,50,20,30,元大-大天母,2024-04-23,9893
6217,中探針,30,0,30,元大-大天母,2024-04-23,9893
8936,國統,76,49,27,元大-大天母,2024-04-23,9893
00937B,群益ESG投等債20,24,0,24,元大-大天母,2024-04-23,9893
3015,全漢,26,2,24,元大-大天母,2024-04-23,9893
0056,元大高股息,22,1,21,元大-大天母,2024-04-23,9893
8085,福華,21,1,20,元大-大天母,2024-04-23,9893
1216,統一,20,1,19,元大-大天母,2024-04-23,9893
2611,志信,22,3,19,元大-大天母,2024-04-23,9893
3715,定穎投控,20,2,18,元大-大天母,2024-04-23,9893
2344,華邦電,19,1,18,元大-大天母,2024-04-23,9893
8147,正淩,18,0,18,元大-大天母,2024-04-23,9893
2324,仁寶,18,0,18,元大-大天母,2024-04-23,9893
00665L,富邦�琤肭磪囓�2,20,3,17,元大-大天母,2024-04-23,9893
5251,天鉞電,16,0,16,元大-大天母,2024-04-23,9893
3024,憶聲,16,1,15,元大-大天母,2024-04-23,9893
8926,台汽電,16,2,14,元大-大天母,2024-04-23,9893
6005,群益證,27,13,14,元大-大天母,2024-04-23,9893
00941,中信上游半導體,12,0,12,元大-大天母,2024-04-23,9893
00713,元大台灣高息低波,12,0,12,元大-大天母,2024-04-23,9893
5425,台半,13,2,11,元大-大天母,2024-04-23,9893
4726,永昕,21,10,11,元大-大天母,2024-04-23,9893
2915,潤泰全,10,0,10,元大-大天母,2024-04-23,9893
2014,中鴻,10,0,10,元大-大天母,2024-04-23,9893
3284,太普高,39,29,10,元大-大天母,2024-04-23,9893
3034,聯詠,12,2,10,元大-大天母,2024-04-23,9893
3666,光耀,10,0,10,元大-大天母,2024-04-23,9893
2472,立隆電,10,0,10,元大-大天母,2024-04-23,9893
2883,凱基金,10,0,10,元大-大天母,2024-04-23,9893
2231,為升,10,0,10,元大-大天母,2024-04-23,9893
00939,統一台灣高息動能,9,0,9,元大-大天母,2024-04-23,9893
1104,環泥,10,1,9,元大-大天母,2024-04-23,9893
2359,所羅門,11,2,9,元大-大天母,2024-04-23,9893
8033,雷虎,12,4,8,元大-大天母,2024-04-23,9893
2009,第一銅,12,4,8,元大-大天母,2024-04-23,9893
2618,長榮航,1076,300,776,元大-大天母,2024-04-24,9893
2890,永豐金,200,0,200,元大-大天母,2024-04-24,9893
3481,群創,198,6,192,元大-大天母,2024-04-24,9893
2206,三陽工業,226,41,185,元大-大天母,2024-04-24,9893
2486,一詮,125,12,113,元大-大天母,2024-04-24,9893
6187,萬潤,111,2,109,元大-大天母,2024-04-24,9893
2886,兆豐金,168,60,108,元大-大天母,2024-04-24,9893
6274,台燿,112,9,103,元大-大天母,2024-04-24,9893
2887,台新金,73,0,73,元大-大天母,2024-04-24,9893
3011,今皓,68,0,68,元大-大天母,2024-04-24,9893
2515,中工,143,75,68,元大-大天母,2024-04-24,9893
2409,友達,70,6,64,元大-大天母,2024-04-24,9893
5512,力麒,57,0,57,元大-大天母,2024-04-24,9893
2867,三商壽,52,0,52,元大-大天母,2024-04-24,9893
00937B,群益ESG投等債20,50,0,50,元大-大天母,2024-04-24,9893
2706,第一店,41,0,41,元大-大天母,2024-04-24,9893
2834,臺企銀,51,12,39,元大-大天母,2024-04-24,9893
2745,五福,35,0,35,元大-大天母,2024-04-24,9893
6192,巨路,32,0,32,元大-大天母,2024-04-24,9893
5324,士開,31,0,31,元大-大天母,2024-04-24,9893
5284,jpp-KY,29,0,29,元大-大天母,2024-04-24,9893
2241,艾姆勒,29,0,29,元大-大天母,2024-04-24,9893
3230,錦明,25,0,25,元大-大天母,2024-04-24,9893
0050,元大台灣50,37,12,25,元大-大天母,2024-04-24,9893
2608,嘉里大榮,23,0,23,元大-大天母,2024-04-24,9893
00929,復華台灣科技優息,54,32,22,元大-大天母,2024-04-24,9893
1605,華新,23,2,21,元大-大天母,2024-04-24,9893
8227,巨有科技,21,0,21,元大-大天母,2024-04-24,9893
9934,成霖,20,0,20,元大-大天母,2024-04-24,9893
8050,廣積,20,0,20,元大-大天母,2024-04-24,9893
3466,德晉,19,0,19,元大-大天母,2024-04-24,9893
2504,國產,19,2,17,元大-大天母,2024-04-24,9893
3703,欣陸,44,28,16,元大-大天母,2024-04-24,9893
2801,彰銀,16,0,16,元大-大天母,2024-04-24,9893
00679B,元大美債20年,20,4,16,元大-大天母,2024-04-24,9893
00933B,國泰10Y+金融債,15,0,15,元大-大天母,2024-04-24,9893
00687B,國泰20年美債,16,2,14,元大-大天母,2024-04-24,9893
3055,蔚華科,12,0,12,元大-大天母,2024-04-24,9893
2324,仁寶,20,8,12,元大-大天母,2024-04-24,9893
3715,定穎投控,37,26,11,元大-大天母,2024-04-24,9893
6125,廣運,74,64,10,元大-大天母,2024-04-24,9893
1612,宏泰,16,6,10,元大-大天母,2024-04-24,9893
00680L,元大美債20正2,10,0,10,元大-大天母,2024-04-24,9893
6116,彩晶,10,0,10,元大-大天母,2024-04-24,9893
1789,神隆,10,0,10,元大-大天母,2024-04-24,9893
3694,海華,10,0,10,元大-大天母,2024-04-24,9893
2412,中華電,10,0,10,元大-大天母,2024-04-24,9893
3661,世芯-KY,11,2,9,元大-大天母,2024-04-24,9893
5009,榮剛,15,6,9,元大-大天母,2024-04-24,9893
2363,矽統,41,32,9,元大-大天母,2024-04-24,9893
2607,榮運,1305,0,1305,元大-大天母,2024-04-25,9893
2618,長榮航,611,95,516,元大-大天母,2024-04-25,9893
00919,群益台灣精選高息,223,21,202,元大-大天母,2024-04-25,9893
1467,南緯,160,0,160,元大-大天母,2024-04-25,9893
1440,南紡,182,61,121,元大-大天母,2024-04-25,9893
0056,元大高股息,119,4,115,元大-大天母,2024-04-25,9893
00940,元大台灣價值高息,145,34,111,元大-大天母,2024-04-25,9893
3231,緯創,115,12,103,元大-大天母,2024-04-25,9893
00941,中信上游半導體,102,6,96,元大-大天母,2024-04-25,9893
3024,憶聲,73,3,70,元大-大天母,2024-04-25,9893
2887,台新金,67,0,67,元大-大天母,2024-04-25,9893
2882,國泰金,73,9,64,元大-大天母,2024-04-25,9893
2892,第一金,55,0,55,元大-大天母,2024-04-25,9893
2890,永豐金,100,50,50,元大-大天母,2024-04-25,9893
00937B,群益ESG投等債20,49,0,49,元大-大天母,2024-04-25,9893
2371,大同,130,85,45,元大-大天母,2024-04-25,9893
2905,三商,56,11,45,元大-大天母,2024-04-25,9893
00929,復華台灣科技優息,59,15,44,元大-大天母,2024-04-25,9893
2886,兆豐金,61,21,40,元大-大天母,2024-04-25,9893
00878,國泰永續高股息,39,0,39,元大-大天母,2024-04-25,9893
2888,新光金,37,1,36,元大-大天母,2024-04-25,9893
1409,新纖,35,0,35,元大-大天母,2024-04-25,9893
9904,寶成,33,0,33,元大-大天母,2024-04-25,9893
1905,華紙,32,0,32,元大-大天母,2024-04-25,9893
3011,今皓,32,0,32,元大-大天母,2024-04-25,9893
00761B,國泰A級公司債,30,0,30,元大-大天母,2024-04-25,9893
2382,廣達,51,23,28,元大-大天母,2024-04-25,9893
2915,潤泰全,31,3,28,元大-大天母,2024-04-25,9893
3707,漢磊,30,4,26,元大-大天母,2024-04-25,9893
8464,億豐,25,0,25,元大-大天母,2024-04-25,9893
00679B,元大美債20年,27,4,23,元大-大天母,2024-04-25,9893
2317,鴻海,60,37,23,元大-大天母,2024-04-25,9893
3033,威健,21,0,21,元大-大天母,2024-04-25,9893
8213,志超,20,0,20,元大-大天母,2024-04-25,9893
5324,士開,20,0,20,元大-大天母,2024-04-25,9893
2362,藍天,20,2,18,元大-大天母,2024-04-25,9893
4716,大立,33,15,18,元大-大天母,2024-04-25,9893
1504,東元,17,0,17,元大-大天母,2024-04-25,9893
6139,亞翔,16,0,16,元大-大天母,2024-04-25,9893
5876,上海商銀,16,0,16,元大-大天母,2024-04-25,9893
3441,聯一光,15,0,15,元大-大天母,2024-04-25,9893
3230,錦明,20,5,15,元大-大天母,2024-04-25,9893
2356,英業達,19,4,15,元大-大天母,2024-04-25,9893
2376,技嘉,14,0,14,元大-大天母,2024-04-25,9893
2883,凱基金,16,2,14,元大-大天母,2024-04-25,9893
2002,中鋼,14,0,14,元大-大天母,2024-04-25,9893
2330,台積電,18,5,13,元大-大天母,2024-04-25,9893
2353,宏��,14,1,13,元大-大天母,2024-04-25,9893
6168,宏齊,12,0,12,元大-大天母,2024-04-25,9893
2357,華碩,12,0,12,元大-大天母,2024-04-25,9893
2303,聯電,189,12,177,元大-大天母,2024-04-26,9893
1532,勤美,166,3,163,元大-大天母,2024-04-26,9893
6274,台燿,164,11,153,元大-大天母,2024-04-26,9893
2486,一詮,185,52,133,元大-大天母,2024-04-26,9893
00937B,群益ESG投等債20,113,0,113,元大-大天母,2024-04-26,9893
2603,長榮,167,72,95,元大-大天母,2024-04-26,9893
00632R,元大台灣50反1,76,2,74,元大-大天母,2024-04-26,9893
2883,凱基金,72,0,72,元大-大天母,2024-04-26,9893
00679B,元大美債20年,93,22,71,元大-大天母,2024-04-26,9893
1459,聯發,65,0,65,元大-大天母,2024-04-26,9893
00919,群益台灣精選高息,67,6,61,元大-大天母,2024-04-26,9893
2387,精元,60,0,60,元大-大天母,2024-04-26,9893
5234,達興材料,61,1,60,元大-大天母,2024-04-26,9893
1903,士紙,56,6,50,元大-大天母,2024-04-26,9893
00929,復華台灣科技優息,61,13,48,元大-大天母,2024-04-26,9893
2241,艾姆勒,66,20,46,元大-大天母,2024-04-26,9893
2363,矽統,49,6,43,元大-大天母,2024-04-26,9893
1314,中石化,43,2,41,元大-大天母,2024-04-26,9893
3003,健和興,58,18,40,元大-大天母,2024-04-26,9893
6223,旺矽,40,3,37,元大-大天母,2024-04-26,9893
5531,鄉林,50,16,34,元大-大天母,2024-04-26,9893
4973,廣穎,30,0,30,元大-大天母,2024-04-26,9893
00751B,元大AAA至A公司債,30,0,30,元大-大天母,2024-04-26,9893
5251,天鉞電,30,1,29,元大-大天母,2024-04-26,9893
3033,威健,31,2,29,元大-大天母,2024-04-26,9893
2892,第一金,29,0,29,元大-大天母,2024-04-26,9893
2881,富邦金,34,7,27,元大-大天母,2024-04-26,9893
3380,明泰,26,0,26,元大-大天母,2024-04-26,9893
1809,中釉,33,9,24,元大-大天母,2024-04-26,9893
6451,訊芯-KY,28,6,22,元大-大天母,2024-04-26,9893
00687B,國泰20年美債,21,0,21,元大-大天母,2024-04-26,9893
6168,宏齊,21,0,21,元大-大天母,2024-04-26,9893
2913,農林,20,0,20,元大-大天母,2024-04-26,9893
1702,南僑,20,0,20,元大-大天母,2024-04-26,9893
3563,牧德,20,0,20,元大-大天母,2024-04-26,9893
2331,精英,20,0,20,元大-大天母,2024-04-26,9893
3438,類比科,20,0,20,元大-大天母,2024-04-26,9893
2066,世德,24,5,19,元大-大天母,2024-04-26,9893
2014,中鴻,18,0,18,元大-大天母,2024-04-26,9893
2915,潤泰全,19,2,17,元大-大天母,2024-04-26,9893
3583,辛耘,24,7,17,元大-大天母,2024-04-26,9893
2731,雄獅,18,2,16,元大-大天母,2024-04-26,9893
00942B,台新美A公司債20+,15,0,15,元大-大天母,2024-04-26,9893
3587,閎康,14,0,14,元大-大天母,2024-04-26,9893
2344,華邦電,15,1,14,元大-大天母,2024-04-26,9893
6290,良維,14,0,14,元大-大天母,2024-04-26,9893
00720B,元大投資級公司債,13,0,13,元大-大天母,2024-04-26,9893
5009,榮剛,16,3,13,元大-大天母,2024-04-26,9893
3035,智原,20,7,13,元大-大天母,2024-04-26,9893
6179,亞通,13,0,13,元大-大天母,2024-04-26,9893
2885,元大金,1700,18,1682,元大-大天母,2024-04-29,9893
00665L,富邦�琤肭磪囓�2,810,410,400,元大-大天母,2024-04-29,9893
2891,中信金,845,494,351,元大-大天母,2024-04-29,9893
2609,陽明,308,124,184,元大-大天母,2024-04-29,9893
2913,農林,171,4,167,元大-大天母,2024-04-29,9893
00882,中信中國高股息,150,6,144,元大-大天母,2024-04-29,9893
3163,波若威,114,8,106,元大-大天母,2024-04-29,9893
2308,台達電,92,2,90,元大-大天母,2024-04-29,9893
2515,中工,190,107,83,元大-大天母,2024-04-29,9893
2323,中環,91,14,77,元大-大天母,2024-04-29,9893
6189,豐藝,98,21,77,元大-大天母,2024-04-29,9893
6168,宏齊,122,60,62,元大-大天母,2024-04-29,9893
00772B,中信高評級公司債,61,9,52,元大-大天母,2024-04-29,9893
8096,擎亞,67,22,45,元大-大天母,2024-04-29,9893
6207,雷科,45,4,41,元大-大天母,2024-04-29,9893
00637L,元大滬深300正2,64,25,39,元大-大天母,2024-04-29,9893
1471,首利,33,0,33,元大-大天母,2024-04-29,9893
2303,聯電,98,65,33,元大-大天母,2024-04-29,9893
00650L,復華香港正2,266,234,32,元大-大天母,2024-04-29,9893
2101,南港,48,17,31,元大-大天母,2024-04-29,9893
3033,威健,34,3,31,元大-大天母,2024-04-29,9893
3706,神達,30,2,28,元大-大天母,2024-04-29,9893
5251,天鉞電,27,2,25,元大-大天母,2024-04-29,9893
2905,三商,30,6,24,元大-大天母,2024-04-29,9893
2731,雄獅,24,2,22,元大-大天母,2024-04-29,9893
2363,矽統,82,61,21,元大-大天母,2024-04-29,9893
3264,欣銓,20,0,20,元大-大天母,2024-04-29,9893
00631L,元大台灣50正2,20,0,20,元大-大天母,2024-04-29,9893
6223,旺矽,63,43,20,元大-大天母,2024-04-29,9893
3441,聯一光,20,0,20,元大-大天母,2024-04-29,9893
6204,艾華,20,0,20,元大-大天母,2024-04-29,9893
2897,王道銀行,20,0,20,元大-大天母,2024-04-29,9893
2888,新光金,75,55,20,元大-大天母,2024-04-29,9893
5706,鳳凰,21,1,20,元大-大天母,2024-04-29,9893
6175,立敦,19,0,19,元大-大天母,2024-04-29,9893
2739,寒舍,20,2,18,元大-大天母,2024-04-29,9893
8110,華東,27,9,18,元大-大天母,2024-04-29,9893
00919,群益台灣精選高息,39,22,17,元大-大天母,2024-04-29,9893
00690,兆豐藍籌30,17,0,17,元大-大天母,2024-04-29,9893
2883,凱基金,40,23,17,元大-大天母,2024-04-29,9893
2449,京元電子,44,29,15,元大-大天母,2024-04-29,9893
5608,四維航,15,0,15,元大-大天母,2024-04-29,9893
2486,一詮,48,33,15,元大-大天母,2024-04-29,9893
2915,潤泰全,16,1,15,元大-大天母,2024-04-29,9893
3005,神基,15,0,15,元大-大天母,2024-04-29,9893
6290,良維,16,3,13,元大-大天母,2024-04-29,9893
4532,瑞智,35,22,13,元大-大天母,2024-04-29,9893
2313,華通,17,4,13,元大-大天母,2024-04-29,9893
3703,欣陸,24,11,13,元大-大天母,2024-04-29,9893
6206,飛捷,13,0,13,元大-大天母,2024-04-29,9893
00650L,復華香港正2,221,10,211,元大-大天母,2024-04-30,9893
2891,中信金,174,25,149,元大-大天母,2024-04-30,9893
1314,中石化,158,55,103,元大-大天母,2024-04-30,9893
2913,農林,93,3,90,元大-大天母,2024-04-30,9893
2498,宏達電,85,0,85,元大-大天母,2024-04-30,9893
00632R,元大台灣50反1,70,0,70,元大-大天母,2024-04-30,9893
00772B,中信高評級公司債,67,0,67,元大-大天母,2024-04-30,9893
6168,宏齊,188,127,61,元大-大天母,2024-04-30,9893
2101,南港,95,35,60,元大-大天母,2024-04-30,9893
3266,昇陽,57,3,54,元大-大天母,2024-04-30,9893
3011,今皓,50,0,50,元大-大天母,2024-04-30,9893
2888,新光金,50,1,49,元大-大天母,2024-04-30,9893
6175,立敦,47,0,47,元大-大天母,2024-04-30,9893
00753L,中信中國50正2,45,0,45,元大-大天母,2024-04-30,9893
2890,永豐金,45,2,43,元大-大天母,2024-04-30,9893
2354,鴻準,51,11,40,元大-大天母,2024-04-30,9893
5324,士開,40,0,40,元大-大天母,2024-04-30,9893
2617,台航,41,2,39,元大-大天母,2024-04-30,9893
3055,蔚華科,32,1,31,元大-大天母,2024-04-30,9893
00929,復華台灣科技優息,30,4,26,元大-大天母,2024-04-30,9893
00706L,期元大S＆P日圓正2,25,0,25,元大-大天母,2024-04-30,9893
5347,世界,27,3,24,元大-大天母,2024-04-30,9893
6419,京晨科,23,0,23,元大-大天母,2024-04-30,9893
1795,美時,25,2,23,元大-大天母,2024-04-30,9893
8096,擎亞,125,102,23,元大-大天母,2024-04-30,9893
1316,上曜,66,44,22,元大-大天母,2024-04-30,9893
6425,易發,23,1,22,元大-大天母,2024-04-30,9893
6213,聯茂,34,13,21,元大-大天母,2024-04-30,9893
2317,鴻海,40,20,20,元大-大天母,2024-04-30,9893
8234,新漢,21,1,20,元大-大天母,2024-04-30,9893
3438,類比科,20,0,20,元大-大天母,2024-04-30,9893
5392,能率,20,0,20,元大-大天母,2024-04-30,9893
2301,光寶科,27,8,19,元大-大天母,2024-04-30,9893
5234,達興材料,19,0,19,元大-大天母,2024-04-30,9893
1608,華榮,19,0,19,元大-大天母,2024-04-30,9893
6875,國邑*,18,0,18,元大-大天母,2024-04-30,9893
2892,第一金,19,2,17,元大-大天母,2024-04-30,9893
3189,景碩,17,0,17,元大-大天母,2024-04-30,9893
1524,耿鼎,15,0,15,元大-大天母,2024-04-30,9893
00665L,富邦�琤肭磪囓�2,40,25,15,元大-大天母,2024-04-30,9893
4968,立積,20,5,15,元大-大天母,2024-04-30,9893
2427,三商電,15,1,14,元大-大天母,2024-04-30,9893
3363,上詮,22,9,13,元大-大天母,2024-04-30,9893
3005,神基,13,0,13,元大-大天母,2024-04-30,9893
3059,華晶科,16,3,13,元大-大天母,2024-04-30,9893
00915,凱基優選高股息30,13,1,12,元大-大天母,2024-04-30,9893
6581,鋼聯,12,0,12,元大-大天母,2024-04-30,9893
9904,寶成,15,3,12,元大-大天母,2024-04-30,9893
5426,振發,12,0,12,元大-大天母,2024-04-30,9893
2515,中工,85,74,11,元大-大天母,2024-04-30,9893
2618,長榮航,821,156,665,元大-大天母,2024-05-02,9893
2882,國泰金,325,3,322,元大-大天母,2024-05-02,9893
00680L,元大美債20正2,203,0,203,元大-大天母,2024-05-02,9893
2883,凱基金,191,2,189,元大-大天母,2024-05-02,9893
3481,群創,197,13,184,元大-大天母,2024-05-02,9893
2371,大同,283,125,158,元大-大天母,2024-05-02,9893
00878,國泰永續高股息,119,1,118,元大-大天母,2024-05-02,9893
00669R,國泰美國道瓊反1,100,0,100,元大-大天母,2024-05-02,9893
2891,中信金,658,567,91,元大-大天母,2024-05-02,9893
9938,百和,90,0,90,元大-大天母,2024-05-02,9893
00940,元大台灣價值高息,80,1,79,元大-大天母,2024-05-02,9893
1440,南紡,72,5,67,元大-大天母,2024-05-02,9893
2880,華南金,63,7,56,元大-大天母,2024-05-02,9893
5498,凱崴,50,0,50,元大-大天母,2024-05-02,9893
2303,聯電,48,6,42,元大-大天母,2024-05-02,9893
6770,力積電,65,25,40,元大-大天母,2024-05-02,9893
2603,長榮,59,19,40,元大-大天母,2024-05-02,9893
00937B,群益ESG投等債20,36,0,36,元大-大天母,2024-05-02,9893
1609,大亞,41,6,35,元大-大天母,2024-05-02,9893
1722,台肥,41,6,35,元大-大天母,2024-05-02,9893
2836,高雄銀,30,0,30,元大-大天母,2024-05-02,9893
00662,富邦NASDAQ,30,0,30,元大-大天母,2024-05-02,9893
8064,東捷,57,28,29,元大-大天母,2024-05-02,9893
2330,台積電,33,4,29,元大-大天母,2024-05-02,9893
2501,國建,140,112,28,元大-大天母,2024-05-02,9893
6026,福邦證,28,0,28,元大-大天母,2024-05-02,9893
1809,中釉,30,7,23,元大-大天母,2024-05-02,9893
1476,儒鴻,22,0,22,元大-大天母,2024-05-02,9893
3033,威健,66,44,22,元大-大天母,2024-05-02,9893
00919,群益台灣精選高息,31,9,22,元大-大天母,2024-05-02,9893
5469,瀚宇博,21,0,21,元大-大天母,2024-05-02,9893
2611,志信,47,26,21,元大-大天母,2024-05-02,9893
3715,定穎投控,54,33,21,元大-大天母,2024-05-02,9893
6188,廣明,20,0,20,元大-大天母,2024-05-02,9893
2530,華建,20,0,20,元大-大天母,2024-05-02,9893
5432,新門,20,0,20,元大-大天母,2024-05-02,9893
8234,新漢,21,1,20,元大-大天母,2024-05-02,9893
2913,農林,33,14,19,元大-大天母,2024-05-02,9893
2408,南亞科,20,2,18,元大-大天母,2024-05-02,9893
00679B,元大美債20年,18,0,18,元大-大天母,2024-05-02,9893
2809,京城銀,21,3,18,元大-大天母,2024-05-02,9893
2376,技嘉,21,3,18,元大-大天母,2024-05-02,9893
2905,三商,32,15,17,元大-大天母,2024-05-02,9893
00929,復華台灣科技優息,28,13,15,元大-大天母,2024-05-02,9893
2615,萬海,19,4,15,元大-大天母,2024-05-02,9893
2352,佳世達,14,0,14,元大-大天母,2024-05-02,9893
0050,元大台灣50,20,6,14,元大-大天母,2024-05-02,9893
3711,日月光投控,18,5,13,元大-大天母,2024-05-02,9893
9904,寶成,18,5,13,元大-大天母,2024-05-02,9893
6269,台郡,14,2,12,元大-大天母,2024-05-02,9893
2845,遠東銀,360,1,359,元大-大天母,2024-05-03,9893
2891,中信金,199,28,171,元大-大天母,2024-05-03,9893
2609,陽明,198,44,154,元大-大天母,2024-05-03,9893
3231,緯創,91,3,88,元大-大天母,2024-05-03,9893
5512,力麒,86,9,77,元大-大天母,2024-05-03,9893
1314,中石化,82,18,64,元大-大天母,2024-05-03,9893
00937B,群益ESG投等債20,64,2,62,元大-大天母,2024-05-03,9893
3033,威健,61,10,51,元大-大天母,2024-05-03,9893
2062,橋椿,50,0,50,元大-大天母,2024-05-03,9893
5324,士開,54,5,49,元大-大天母,2024-05-03,9893
2882,國泰金,48,0,48,元大-大天母,2024-05-03,9893
2241,艾姆勒,44,0,44,元大-大天母,2024-05-03,9893
1905,華紙,43,0,43,元大-大天母,2024-05-03,9893
00929,復華台灣科技優息,41,1,40,元大-大天母,2024-05-03,9893
2884,玉山金,43,6,37,元大-大天母,2024-05-03,9893
2392,正崴,49,15,34,元大-大天母,2024-05-03,9893
00637L,元大滬深300正2,32,0,32,元大-大天母,2024-05-03,9893
2515,中工,491,460,31,元大-大天母,2024-05-03,9893
8096,擎亞,121,90,31,元大-大天母,2024-05-03,9893
2538,基泰,30,0,30,元大-大天母,2024-05-03,9893
2618,長榮航,225,196,29,元大-大天母,2024-05-03,9893
1316,上曜,116,90,26,元大-大天母,2024-05-03,9893
1416,廣豐,32,6,26,元大-大天母,2024-05-03,9893
1608,華榮,64,38,26,元大-大天母,2024-05-03,9893
1605,華新,23,0,23,元大-大天母,2024-05-03,9893
1453,大將,25,2,23,元大-大天母,2024-05-03,9893
9945,潤泰新,67,46,21,元大-大天母,2024-05-03,9893
8112,至上,56,35,21,元大-大天母,2024-05-03,9893
5609,中菲行,16,0,16,元大-大天母,2024-05-03,9893
5521,工信,16,0,16,元大-大天母,2024-05-03,9893
00715L,期街口布蘭特正2,16,0,16,元大-大天母,2024-05-03,9893
1795,美時,16,1,15,元大-大天母,2024-05-03,9893
3313,斐成,15,0,15,元大-大天母,2024-05-03,9893
3230,錦明,15,0,15,元大-大天母,2024-05-03,9893
2537,聯上發,21,6,15,元大-大天母,2024-05-03,9893
2498,宏達電,50,35,15,元大-大天母,2024-05-03,9893
6196,帆宣,15,0,15,元大-大天母,2024-05-03,9893
3312,弘憶股,16,2,14,元大-大天母,2024-05-03,9893
1809,中釉,13,0,13,元大-大天母,2024-05-03,9893
00650L,復華香港正2,83,70,13,元大-大天母,2024-05-03,9893
6155,鈞寶,17,4,13,元大-大天母,2024-05-03,9893
3338,泰碩,16,3,13,元大-大天母,2024-05-03,9893
2330,台積電,17,4,13,元大-大天母,2024-05-03,9893
5009,榮剛,18,6,12,元大-大天母,2024-05-03,9893
1434,福懋,15,3,12,元大-大天母,2024-05-03,9893
2344,華邦電,27,15,12,元大-大天母,2024-05-03,9893
6147,頎邦,14,2,12,元大-大天母,2024-05-03,9893
00642U,期元大S＆P石油,11,0,11,元大-大天母,2024-05-03,9893
2388,威盛,15,5,10,元大-大天母,2024-05-03,9893
4513,福裕,10,0,10,元大-大天母,2024-05-03,9893
1101,台泥,512,19,493,元大-大天母,2024-05-06,9893
2618,長榮航,358,121,237,元大-大天母,2024-05-06,9893
1815,富喬,101,1,100,元大-大天母,2024-05-06,9893
2851,中再保,90,1,89,元大-大天母,2024-05-06,9893
9933,中鼎,83,2,81,元大-大天母,2024-05-06,9893
1440,南紡,72,2,70,元大-大天母,2024-05-06,9893
5531,鄉林,72,5,67,元大-大天母,2024-05-06,9893
9934,成霖,53,0,53,元大-大天母,2024-05-06,9893
2888,新光金,303,259,44,元大-大天母,2024-05-06,9893
4919,新唐,43,2,41,元大-大天母,2024-05-06,9893
00650L,復華香港正2,40,0,40,元大-大天母,2024-05-06,9893
00665L,富邦�琤肭磪囓�2,41,1,40,元大-大天母,2024-05-06,9893
1416,廣豐,40,1,39,元大-大天母,2024-05-06,9893
2344,華邦電,45,8,37,元大-大天母,2024-05-06,9893
9945,潤泰新,65,29,36,元大-大天母,2024-05-06,9893
9941,裕融,33,0,33,元大-大天母,2024-05-06,9893
1446,宏和,38,5,33,元大-大天母,2024-05-06,9893
3481,群創,36,9,27,元大-大天母,2024-05-06,9893
6213,聯茂,49,24,25,元大-大天母,2024-05-06,9893
4303,信立,59,34,25,元大-大天母,2024-05-06,9893
9904,寶成,27,3,24,元大-大天母,2024-05-06,9893
5609,中菲行,24,0,24,元大-大天母,2024-05-06,9893
1513,中興電,24,1,23,元大-大天母,2024-05-06,9893
3622,洋華,22,0,22,元大-大天母,2024-05-06,9893
2449,京元電子,38,17,21,元大-大天母,2024-05-06,9893
00927,群益半導體收益,20,0,20,元大-大天母,2024-05-06,9893
2371,大同,40,22,18,元大-大天母,2024-05-06,9893
00753L,中信中國50正2,19,0,19,元大-大天母,2024-05-06,9893
2501,國建,40,21,19,元大-大天母,2024-05-06,9893
3714,富采,20,2,18,元大-大天母,2024-05-06,9893
2881,富邦金,20,2,18,元大-大天母,2024-05-06,9893
2514,龍邦,17,0,17,元大-大天母,2024-05-06,9893
2014,中鴻,16,0,16,元大-大天母,2024-05-06,9893
8271,宇瞻,16,0,16,元大-大天母,2024-05-06,9893
912000,晨訊科-DR,15,0,15,元大-大天母,2024-05-06,9893
6179,亞通,15,0,15,元大-大天母,2024-05-06,9893
00715L,期街口布蘭特正2,15,0,15,元大-大天母,2024-05-06,9893
3703,欣陸,17,3,14,元大-大天母,2024-05-06,9893
3024,憶聲,30,16,14,元大-大天母,2024-05-06,9893
6282,康舒,14,1,13,元大-大天母,2024-05-06,9893
3312,弘憶股,50,37,13,元大-大天母,2024-05-06,9893
2492,華新科,21,8,13,元大-大天母,2024-05-06,9893
00907,永豐優息存股,15,3,12,元大-大天母,2024-05-06,9893
6016,康和證,12,0,12,元大-大天母,2024-05-06,9893
6770,力積電,84,72,12,元大-大天母,2024-05-06,9893
4532,瑞智,13,1,12,元大-大天母,2024-05-06,9893
2515,中工,35,23,12,元大-大天母,2024-05-06,9893
3163,波若威,27,15,12,元大-大天母,2024-05-06,9893
2607,榮運,11,0,11,元大-大天母,2024-05-06,9893
2406,國碩,11,0,11,元大-大天母,2024-05-06,9893
2618,長榮航,372,74,298,元大-大天母,2024-05-07,9893
00878,國泰永續高股息,160,4,156,元大-大天母,2024-05-07,9893
6269,台郡,134,2,132,元大-大天母,2024-05-07,9893
1903,士紙,139,10,129,元大-大天母,2024-05-07,9893
3363,上詮,128,15,113,元大-大天母,2024-05-07,9893
2883,凱基金,94,6,88,元大-大天母,2024-05-07,9893
2885,元大金,102,17,85,元大-大天母,2024-05-07,9893
00753L,中信中國50正2,84,0,84,元大-大天母,2024-05-07,9893
1440,南紡,76,5,71,元大-大天母,2024-05-07,9893
00715L,期街口布蘭特正2,61,0,61,元大-大天母,2024-05-07,9893
2506,太設,56,0,56,元大-大天母,2024-05-07,9893
2392,正崴,72,21,51,元大-大天母,2024-05-07,9893
6005,群益證,58,10,48,元大-大天母,2024-05-07,9893
2897,王道銀行,42,0,42,元大-大天母,2024-05-07,9893
6168,宏齊,43,2,41,元大-大天母,2024-05-07,9893
00929,復華台灣科技優息,42,3,39,元大-大天母,2024-05-07,9893
2357,華碩,41,3,38,元大-大天母,2024-05-07,9893
2206,三陽工業,37,0,37,元大-大天母,2024-05-07,9893
1609,大亞,75,41,34,元大-大天母,2024-05-07,9893
4303,信立,36,5,31,元大-大天母,2024-05-07,9893
6757,台灣虎航,30,0,30,元大-大天母,2024-05-07,9893
2323,中環,30,0,30,元大-大天母,2024-05-07,9893
5521,工信,30,1,29,元大-大天母,2024-05-07,9893
1215,卜蜂,30,2,28,元大-大天母,2024-05-07,9893
2344,華邦電,67,43,24,元大-大天母,2024-05-07,9893
00915,凱基優選高股息30,23,0,23,元大-大天母,2024-05-07,9893
2515,中工,53,31,22,元大-大天母,2024-05-07,9893
1808,潤隆,21,0,21,元大-大天母,2024-05-07,9893
3013,晟銘電,91,70,21,元大-大天母,2024-05-07,9893
00720B,元大投資級公司債,21,0,21,元大-大天母,2024-05-07,9893
8039,台虹,22,1,21,元大-大天母,2024-05-07,9893
3481,群創,21,0,21,元大-大天母,2024-05-07,9893
00764B,群益25年美債,20,0,20,元大-大天母,2024-05-07,9893
5432,新門,20,0,20,元大-大天母,2024-05-07,9893
6213,聯茂,104,84,20,元大-大天母,2024-05-07,9893
00637L,元大滬深300正2,31,11,20,元大-大天母,2024-05-07,9893
6204,艾華,20,0,20,元大-大天母,2024-05-07,9893
2308,台達電,24,4,20,元大-大天母,2024-05-07,9893
1815,富喬,20,3,17,元大-大天母,2024-05-07,9893
2353,宏��,31,14,17,元大-大天母,2024-05-07,9893
00882,中信中國高股息,18,2,16,元大-大天母,2024-05-07,9893
2486,一詮,55,40,15,元大-大天母,2024-05-07,9893
3033,威健,60,45,15,元大-大天母,2024-05-07,9893
8210,勤誠,17,3,14,元大-大天母,2024-05-07,9893
1795,美時,20,6,14,元大-大天母,2024-05-07,9893
3260,威剛,29,16,13,元大-大天母,2024-05-07,9893
3687,歐買尬,13,0,13,元大-大天母,2024-05-07,9893
00891,中信關鍵半導體,13,0,13,元大-大天母,2024-05-07,9893
9934,成霖,13,0,13,元大-大天母,2024-05-07,9893
3466,德晉,21,8,13,元大-大天母,2024-05-07,9893
1504,東元,706,5,701,元大-大天母,2024-05-08,9893
2618,長榮航,197,52,145,元大-大天母,2024-05-08,9893
00929,復華台灣科技優息,137,13,124,元大-大天母,2024-05-08,9893
4968,立積,122,1,121,元大-大天母,2024-05-08,9893
1513,中興電,102,6,96,元大-大天母,2024-05-08,9893
4938,和碩,82,3,79,元大-大天母,2024-05-08,9893
1314,中石化,62,2,60,元大-大天母,2024-05-08,9893
3481,群創,61,5,56,元大-大天母,2024-05-08,9893
00919,群益台灣精選高息,56,2,54,元大-大天母,2024-05-08,9893
2511,太子,50,0,50,元大-大天母,2024-05-08,9893
00637L,元大滬深300正2,41,0,41,元大-大天母,2024-05-08,9893
1102,亞泥,40,0,40,元大-大天母,2024-05-08,9893
5609,中菲行,35,1,34,元大-大天母,2024-05-08,9893
2883,凱基金,32,0,32,元大-大天母,2024-05-08,9893
6175,立敦,34,2,32,元大-大天母,2024-05-08,9893
00940,元大台灣價值高息,43,12,31,元大-大天母,2024-05-08,9893
5871,中租-KY,31,2,29,元大-大天母,2024-05-08,9893
2603,長榮,49,21,28,元大-大天母,2024-05-08,9893
9945,潤泰新,29,1,28,元大-大天母,2024-05-08,9893
1215,卜蜂,27,0,27,元大-大天母,2024-05-08,9893
1519,華城,30,4,26,元大-大天母,2024-05-08,9893
00937B,群益ESG投等債20,43,17,26,元大-大天母,2024-05-08,9893
6026,福邦證,24,0,24,元大-大天母,2024-05-08,9893
2605,新興,52,29,23,元大-大天母,2024-05-08,9893
2637,慧洋-KY,42,19,23,元大-大天母,2024-05-08,9893
00715L,期街口布蘭特正2,22,0,22,元大-大天母,2024-05-08,9893
9938,百和,21,0,21,元大-大天母,2024-05-08,9893
00655L,國泰中國A50正2,21,0,21,元大-大天母,2024-05-08,9893
00665L,富邦�琤肭磪囓�2,60,40,20,元大-大天母,2024-05-08,9893
3703,欣陸,21,1,20,元大-大天母,2024-05-08,9893
2101,南港,25,5,20,元大-大天母,2024-05-08,9893
00932,兆豐永續高息等權,18,0,18,元大-大天母,2024-05-08,9893
00878,國泰永續高股息,43,26,17,元大-大天母,2024-05-08,9893
3705,永信,17,0,17,元大-大天母,2024-05-08,9893
00753L,中信中國50正2,17,0,17,元大-大天母,2024-05-08,9893
00720B,元大投資級公司債,17,0,17,元大-大天母,2024-05-08,9893
2501,國建,23,7,16,元大-大天母,2024-05-08,9893
00679B,元大美債20年,24,8,16,元大-大天母,2024-05-08,9893
2376,技嘉,23,8,15,元大-大天母,2024-05-08,9893
3653,健策,23,8,15,元大-大天母,2024-05-08,9893
2062,橋椿,15,0,15,元大-大天母,2024-05-08,9893
00939,統一台灣高息動能,14,0,14,元大-大天母,2024-05-08,9893
2610,華航,30,17,13,元大-大天母,2024-05-08,9893
2328,廣宇,17,4,13,元大-大天母,2024-05-08,9893
5608,四維航,38,26,12,元大-大天母,2024-05-08,9893
5521,工信,12,0,12,元大-大天母,2024-05-08,9893
6215,和椿,85,73,12,元大-大天母,2024-05-08,9893
00664R,國泰臺灣加權反1,12,0,12,元大-大天母,2024-05-08,9893
3312,弘憶股,20,8,12,元大-大天母,2024-05-08,9893
1440,南紡,17,5,12,元大-大天母,2024-05-08,9893
2511,太子,400,1,399,元大-大天母,2024-05-09,9893
00946,群益科技高息成長,263,55,208,元大-大天母,2024-05-09,9893
2303,聯電,158,18,140,元大-大天母,2024-05-09,9893
3264,欣銓,119,0,119,元大-大天母,2024-05-09,9893
2618,長榮航,116,3,113,元大-大天母,2024-05-09,9893
3231,緯創,101,1,100,元大-大天母,2024-05-09,9893
6175,立敦,91,1,90,元大-大天母,2024-05-09,9893
00937B,群益ESG投等債20,83,1,82,元大-大天母,2024-05-09,9893
2883,凱基金,81,2,79,元大-大天母,2024-05-09,9893
6278,台表科,73,2,71,元大-大天母,2024-05-09,9893
00944,野村趨勢動能高息,65,1,64,元大-大天母,2024-05-09,9893
1714,和桐,72,12,60,元大-大天母,2024-05-09,9893
2367,燿華,126,66,60,元大-大天母,2024-05-09,9893
2363,矽統,94,36,58,元大-大天母,2024-05-09,9893
00929,復華台灣科技優息,53,0,53,元大-大天母,2024-05-09,9893
2498,宏達電,70,20,50,元大-大天母,2024-05-09,9893
2887,台新金,43,3,40,元大-大天母,2024-05-09,9893
2542,興富發,43,4,39,元大-大天母,2024-05-09,9893
1102,亞泥,40,1,39,元大-大天母,2024-05-09,9893
1609,大亞,48,15,33,元大-大天母,2024-05-09,9893
2317,鴻海,86,57,29,元大-大天母,2024-05-09,9893
6239,力成,30,1,29,元大-大天母,2024-05-09,9893
2408,南亞科,29,0,29,元大-大天母,2024-05-09,9893
1446,宏和,26,0,26,元大-大天母,2024-05-09,9893
9945,潤泰新,25,0,25,元大-大天母,2024-05-09,9893
5871,中租-KY,27,2,25,元大-大天母,2024-05-09,9893
2371,大同,63,40,23,元大-大天母,2024-05-09,9893
2605,新興,29,7,22,元大-大天母,2024-05-09,9893
8467,波力-KY,23,1,22,元大-大天母,2024-05-09,9893
3312,弘憶股,25,3,22,元大-大天母,2024-05-09,9893
1605,華新,30,8,22,元大-大天母,2024-05-09,9893
1809,中釉,56,34,22,元大-大天母,2024-05-09,9893
2886,兆豐金,27,6,21,元大-大天母,2024-05-09,9893
2947,振宇五金,21,0,21,元大-大天母,2024-05-09,9893
5521,工信,20,0,20,元大-大天母,2024-05-09,9893
00940,元大台灣價值高息,94,75,19,元大-大天母,2024-05-09,9893
00720B,元大投資級公司債,19,0,19,元大-大天母,2024-05-09,9893
00679B,元大美債20年,20,1,19,元大-大天母,2024-05-09,9893
00878,國泰永續高股息,34,17,17,元大-大天母,2024-05-09,9893
6168,宏齊,17,0,17,元大-大天母,2024-05-09,9893
2888,新光金,42,25,17,元大-大天母,2024-05-09,9893
0056,元大高股息,16,0,16,元大-大天母,2024-05-09,9893
00933B,國泰10Y+金融債,16,0,16,元大-大天母,2024-05-09,9893
3481,群創,48,32,16,元大-大天母,2024-05-09,9893
2610,華航,22,7,15,元大-大天母,2024-05-09,9893
2344,華邦電,15,0,15,元大-大天母,2024-05-09,9893
2393,億光,18,3,15,元大-大天母,2024-05-09,9893
2440,太空梭,14,0,14,元大-大天母,2024-05-09,9893
2101,南港,15,1,14,元大-大天母,2024-05-09,9893
00900,富邦特選高股息30,15,1,14,元大-大天母,2024-05-09,9893
2534,宏盛,369,1,368,元大-大天母,2024-05-10,9893
00882,中信中國高股息,200,2,198,元大-大天母,2024-05-10,9893
9934,成霖,147,0,147,元大-大天母,2024-05-10,9893
1101,台泥,151,5,146,元大-大天母,2024-05-10,9893
00632R,元大台灣50反1,114,0,114,元大-大天母,2024-05-10,9893
2834,臺企銀,106,1,105,元大-大天母,2024-05-10,9893
2601,益航,101,0,101,元大-大天母,2024-05-10,9893
2498,宏達電,78,1,77,元大-大天母,2024-05-10,9893
00929,復華台灣科技優息,80,4,76,元大-大天母,2024-05-10,9893
6790,永豐實,60,0,60,元大-大天母,2024-05-10,9893
9955,佳龍,60,0,60,元大-大天母,2024-05-10,9893
5284,jpp-KY,50,0,50,元大-大天母,2024-05-10,9893
1714,和桐,50,0,50,元大-大天母,2024-05-10,9893
00650L,復華香港正2,50,0,50,元大-大天母,2024-05-10,9893
2474,可成,50,0,50,元大-大天母,2024-05-10,9893
8112,至上,133,84,49,元大-大天母,2024-05-10,9893
00937B,群益ESG投等債20,46,0,46,元大-大天母,2024-05-10,9893
2211,長榮鋼,41,1,40,元大-大天母,2024-05-10,9893
5488,松普,40,0,40,元大-大天母,2024-05-10,9893
8926,台汽電,39,0,39,元大-大天母,2024-05-10,9893
1609,大亞,43,11,32,元大-大天母,2024-05-10,9893
2634,漢翔,31,0,31,元大-大天母,2024-05-10,9893
2887,台新金,33,2,31,元大-大天母,2024-05-10,9893
00940,元大台灣價值高息,32,3,29,元大-大天母,2024-05-10,9893
2313,華通,34,7,27,元大-大天母,2024-05-10,9893
2404,漢唐,27,0,27,元大-大天母,2024-05-10,9893
6168,宏齊,44,17,27,元大-大天母,2024-05-10,9893
2323,中環,25,0,25,元大-大天母,2024-05-10,9893
2409,友達,24,0,24,元大-大天母,2024-05-10,9893
2515,中工,22,0,22,元大-大天母,2024-05-10,9893
2367,燿華,74,52,22,元大-大天母,2024-05-10,9893
3481,群創,65,44,21,元大-大天母,2024-05-10,9893
00687B,國泰20年美債,34,13,21,元大-大天母,2024-05-10,9893
6770,力積電,21,0,21,元大-大天母,2024-05-10,9893
2493,揚博,21,0,21,元大-大天母,2024-05-10,9893
7402,邑錡,20,0,20,元大-大天母,2024-05-10,9893
1795,美時,25,5,20,元大-大天母,2024-05-10,9893
1108,幸福,20,0,20,元大-大天母,2024-05-10,9893
6204,艾華,20,0,20,元大-大天母,2024-05-10,9893
2371,大同,38,19,19,元大-大天母,2024-05-10,9893
6182,合晶,20,2,18,元大-大天母,2024-05-10,9893
2317,鴻海,42,26,16,元大-大天母,2024-05-10,9893
5521,工信,15,0,15,元大-大天母,2024-05-10,9893
4746,台耀,21,6,15,元大-大天母,2024-05-10,9893
3033,威健,17,2,15,元大-大天母,2024-05-10,9893
8227,巨有科技,16,2,14,元大-大天母,2024-05-10,9893
2363,矽統,24,10,14,元大-大天母,2024-05-10,9893
8150,南茂,16,3,13,元大-大天母,2024-05-10,9893
2484,希華,13,0,13,元大-大天母,2024-05-10,9893
8938,明安,13,0,13,元大-大天母,2024-05-10,9893
2883,凱基金,475,104,371,元大-大天母,2024-05-13,9893
00933B,國泰10Y+金融債,321,2,319,元大-大天母,2024-05-13,9893
00632R,元大台灣50反1,181,10,171,元大-大天母,2024-05-13,9893
2392,正崴,184,32,152,元大-大天母,2024-05-13,9893
00937B,群益ESG投等債20,101,5,96,元大-大天母,2024-05-13,9893
00929,復華台灣科技優息,148,53,95,元大-大天母,2024-05-13,9893
2498,宏達電,153,63,90,元大-大天母,2024-05-13,9893
00878,國泰永續高股息,114,27,87,元大-大天母,2024-05-13,9893
2882,國泰金,152,84,68,元大-大天母,2024-05-13,9893
3013,晟銘電,70,14,56,元大-大天母,2024-05-13,9893
00715L,期街口布蘭特正2,53,0,53,元大-大天母,2024-05-13,9893
3231,緯創,52,2,50,元大-大天母,2024-05-13,9893
2891,中信金,184,137,47,元大-大天母,2024-05-13,9893
2371,大同,112,70,42,元大-大天母,2024-05-13,9893
2211,長榮鋼,41,1,40,元大-大天母,2024-05-13,9893
00679B,元大美債20年,42,3,39,元大-大天母,2024-05-13,9893
2603,長榮,206,171,35,元大-大天母,2024-05-13,9893
2884,玉山金,56,21,35,元大-大天母,2024-05-13,9893
2404,漢唐,35,2,33,元大-大天母,2024-05-13,9893
2641,正德,39,6,33,元大-大天母,2024-05-13,9893
00637L,元大滬深300正2,32,0,32,元大-大天母,2024-05-13,9893
00700,富邦�琤肭磪�,30,0,30,元大-大天母,2024-05-13,9893
00944,野村趨勢動能高息,25,0,25,元大-大天母,2024-05-13,9893
2892,第一金,74,51,23,元大-大天母,2024-05-13,9893
8070,長華*,24,1,23,元大-大天母,2024-05-13,9893
2409,友達,26,4,22,元大-大天母,2024-05-13,9893
5488,松普,22,0,22,元大-大天母,2024-05-13,9893
6213,聯茂,48,27,21,元大-大天母,2024-05-13,9893
9802,鈺齊-KY,21,0,21,元大-大天母,2024-05-13,9893
00927,群益半導體收益,20,0,20,元大-大天母,2024-05-13,9893
6026,福邦證,20,0,20,元大-大天母,2024-05-13,9893
4562,穎漢,36,16,20,元大-大天母,2024-05-13,9893
9912,偉聯,20,0,20,元大-大天母,2024-05-13,9893
6873,泓德能源,24,6,18,元大-大天母,2024-05-13,9893
6117,迎廣,29,11,18,元大-大天母,2024-05-13,9893
5392,能率,17,0,17,元大-大天母,2024-05-13,9893
00940,元大台灣價值高息,75,59,16,元大-大天母,2024-05-13,9893
8150,南茂,16,0,16,元大-大天母,2024-05-13,9893
1609,大亞,28,12,16,元大-大天母,2024-05-13,9893
2607,榮運,35,20,15,元大-大天母,2024-05-13,9893
2317,鴻海,49,34,15,元大-大天母,2024-05-13,9893
2617,台航,18,4,14,元大-大天母,2024-05-13,9893
5009,榮剛,14,0,14,元大-大天母,2024-05-13,9893
2501,國建,29,15,14,元大-大天母,2024-05-13,9893
6438,迅得,41,27,14,元大-大天母,2024-05-13,9893
6869,雲豹能源,14,0,14,元大-大天母,2024-05-13,9893
3260,威剛,27,13,14,元大-大天母,2024-05-13,9893
8059,凱碩,13,0,13,元大-大天母,2024-05-13,9893
3026,禾伸堂,13,0,13,元大-大天母,2024-05-13,9893
00882,中信中國高股息,14,1,13,元大-大天母,2024-05-13,9893
2610,華航,217,48,169,元大-大天母,2024-05-14,9893
5608,四維航,144,19,125,元大-大天母,2024-05-14,9893
00937B,群益ESG投等債20,92,0,92,元大-大天母,2024-05-14,9893
2409,友達,71,1,70,元大-大天母,2024-05-14,9893
5534,長虹,70,0,70,元大-大天母,2024-05-14,9893
00665L,富邦�琤肭磪囓�2,60,0,60,元大-大天母,2024-05-14,9893
00878,國泰永續高股息,92,32,60,元大-大天母,2024-05-14,9893
2615,萬海,242,185,57,元大-大天母,2024-05-14,9893
3163,波若威,57,5,52,元大-大天母,2024-05-14,9893
0056,元大高股息,51,0,51,元大-大天母,2024-05-14,9893
2387,精元,50,0,50,元大-大天母,2024-05-14,9893
5531,鄉林,60,14,46,元大-大天母,2024-05-14,9893
2915,潤泰全,51,7,44,元大-大天母,2024-05-14,9893
6204,艾華,40,0,40,元大-大天母,2024-05-14,9893
1440,南紡,37,0,37,元大-大天母,2024-05-14,9893
00637L,元大滬深300正2,33,0,33,元大-大天母,2024-05-14,9893
2498,宏達電,40,9,31,元大-大天母,2024-05-14,9893
2374,佳能,104,73,31,元大-大天母,2024-05-14,9893
5324,士開,30,0,30,元大-大天母,2024-05-14,9893
9105,泰金寶-DR,30,0,30,元大-大天母,2024-05-14,9893
2317,鴻海,57,27,30,元大-大天母,2024-05-14,9893
6189,豐藝,31,2,29,元大-大天母,2024-05-14,9893
3013,晟銘電,46,17,29,元大-大天母,2024-05-14,9893
00720B,元大投資級公司債,25,0,25,元大-大天母,2024-05-14,9893
2618,長榮航,47,24,23,元大-大天母,2024-05-14,9893
00632R,元大台灣50反1,75,52,23,元大-大天母,2024-05-14,9893
4167,松瑞藥,22,0,22,元大-大天母,2024-05-14,9893
1316,上曜,22,1,21,元大-大天母,2024-05-14,9893
00932,兆豐永續高息等權,21,0,21,元大-大天母,2024-05-14,9893
00929,復華台灣科技優息,30,9,21,元大-大天母,2024-05-14,9893
2371,大同,53,33,20,元大-大天母,2024-05-14,9893
2211,長榮鋼,22,2,20,元大-大天母,2024-05-14,9893
00676R,富邦臺灣加權反1,20,0,20,元大-大天母,2024-05-14,9893
00887,永豐中國科技50大,20,0,20,元大-大天母,2024-05-14,9893
2014,中鴻,20,0,20,元大-大天母,2024-05-14,9893
4306,炎洲,20,0,20,元大-大天母,2024-05-14,9893
00753L,中信中國50正2,20,0,20,元大-大天母,2024-05-14,9893
2884,玉山金,27,8,19,元大-大天母,2024-05-14,9893
00933B,國泰10Y+金融債,18,0,18,元大-大天母,2024-05-14,9893
2882,國泰金,41,23,18,元大-大天母,2024-05-14,9893
1210,大成,20,3,17,元大-大天母,2024-05-14,9893
2885,元大金,18,1,17,元大-大天母,2024-05-14,9893
2609,陽明,912,897,15,元大-大天母,2024-05-14,9893
1514,亞力,15,0,15,元大-大天母,2024-05-14,9893
00772B,中信高評級公司債,15,0,15,元大-大天母,2024-05-14,9893
2427,三商電,21,6,15,元大-大天母,2024-05-14,9893
1609,大亞,20,5,15,元大-大天母,2024-05-14,9893
00915,凱基優選高股息30,14,0,14,元大-大天母,2024-05-14,9893
2880,華南金,20,6,14,元大-大天母,2024-05-14,9893
6274,台燿,14,0,14,元大-大天母,2024-05-14,9893
00632R,元大台灣50反1,398,0,398,元大-大天母,2024-05-15,9893
2609,陽明,528,319,209,元大-大天母,2024-05-15,9893
3163,波若威,211,18,193,元大-大天母,2024-05-15,9893
2618,長榮航,175,23,152,元大-大天母,2024-05-15,9893
00929,復華台灣科技優息,146,6,140,元大-大天母,2024-05-15,9893
3047,訊舟,153,58,95,元大-大天母,2024-05-15,9893
2356,英業達,142,49,93,元大-大天母,2024-05-15,9893
00937B,群益ESG投等債20,103,14,89,元大-大天母,2024-05-15,9893
00940,元大台灣價值高息,189,104,85,元大-大天母,2024-05-15,9893
6168,宏齊,90,32,58,元大-大天母,2024-05-15,9893
1440,南紡,65,18,47,元大-大天母,2024-05-15,9893
3479,安勤,45,0,45,元大-大天母,2024-05-15,9893
2208,台船,42,1,41,元大-大天母,2024-05-15,9893
2915,潤泰全,59,21,38,元大-大天母,2024-05-15,9893
1312,國喬,57,21,36,元大-大天母,2024-05-15,9893
2645,長榮航太,37,1,36,元大-大天母,2024-05-15,9893
6274,台燿,35,3,32,元大-大天母,2024-05-15,9893
00676R,富邦臺灣加權反1,30,0,30,元大-大天母,2024-05-15,9893
6579,研揚,31,2,29,元大-大天母,2024-05-15,9893
2603,長榮,92,65,27,元大-大天母,2024-05-15,9893
2405,輔信,44,17,27,元大-大天母,2024-05-15,9893
00946,群益科技高息成長,27,1,26,元大-大天母,2024-05-15,9893
3438,類比科,24,0,24,元大-大天母,2024-05-15,9893
00936,台新永續高息中小,27,4,23,元大-大天母,2024-05-15,9893
2498,宏達電,55,32,23,元大-大天母,2024-05-15,9893
5469,瀚宇博,24,4,20,元大-大天母,2024-05-15,9893
8049,晶采,20,0,20,元大-大天母,2024-05-15,9893
1210,大成,20,1,19,元大-大天母,2024-05-15,9893
2323,中環,20,1,19,元大-大天母,2024-05-15,9893
00664R,國泰臺灣加權反1,18,0,18,元大-大天母,2024-05-15,9893
1447,力鵬,20,2,18,元大-大天母,2024-05-15,9893
1903,士紙,30,13,17,元大-大天母,2024-05-15,9893
1609,大亞,26,9,17,元大-大天母,2024-05-15,9893
00679B,元大美債20年,18,2,16,元大-大天母,2024-05-15,9893
2607,榮運,16,0,16,元大-大天母,2024-05-15,9893
2328,廣宇,26,10,16,元大-大天母,2024-05-15,9893
6790,永豐實,16,0,16,元大-大天母,2024-05-15,9893
4533,協易機,65,51,14,元大-大天母,2024-05-15,9893
2486,一詮,17,3,14,元大-大天母,2024-05-15,9893
8096,擎亞,20,6,14,元大-大天母,2024-05-15,9893
00715L,期街口布蘭特正2,14,0,14,元大-大天母,2024-05-15,9893
2404,漢唐,13,0,13,元大-大天母,2024-05-15,9893
6873,泓德能源,13,0,13,元大-大天母,2024-05-15,9893
00919,群益台灣精選高息,19,6,13,元大-大天母,2024-05-15,9893
5353,台林,12,0,12,元大-大天母,2024-05-15,9893
5488,松普,12,0,12,元大-大天母,2024-05-15,9893
6770,力積電,17,6,11,元大-大天母,2024-05-15,9893
4584,君帆,11,0,11,元大-大天母,2024-05-15,9893
2543,皇昌,11,0,11,元大-大天母,2024-05-15,9893
6278,台表科,16,5,11,元大-大天母,2024-05-15,9893
00632R,元大台灣50反1,498,220,278,元大-大天母,2024-05-16,9893
2915,潤泰全,223,8,215,元大-大天母,2024-05-16,9893
00665L,富邦�琤肭磪囓�2,236,50,186,元大-大天母,2024-05-16,9893
1440,南紡,171,10,161,元大-大天母,2024-05-16,9893
2603,長榮,358,203,155,元大-大天母,2024-05-16,9893
1532,勤美,113,0,113,元大-大天母,2024-05-16,9893
1608,華榮,127,22,105,元大-大天母,2024-05-16,9893
2606,裕民,118,13,105,元大-大天母,2024-05-16,9893
4968,立積,122,26,96,元大-大天母,2024-05-16,9893
4513,福裕,90,0,90,元大-大天母,2024-05-16,9893
2834,臺企銀,100,10,90,元大-大天母,2024-05-16,9893
2356,英業達,83,7,76,元大-大天母,2024-05-16,9893
3231,緯創,85,19,66,元大-大天母,2024-05-16,9893
2382,廣達,104,42,62,元大-大天母,2024-05-16,9893
1210,大成,60,1,59,元大-大天母,2024-05-16,9893
5351,鈺創,66,9,57,元大-大天母,2024-05-16,9893
1714,和桐,50,0,50,元大-大天母,2024-05-16,9893
2440,太空梭,50,2,48,元大-大天母,2024-05-16,9893
00688L,國泰20年美債正2,47,0,47,元大-大天母,2024-05-16,9893
8440,綠電,50,4,46,元大-大天母,2024-05-16,9893
6264,富裔,51,10,41,元大-大天母,2024-05-16,9893
00650L,復華香港正2,41,0,41,元大-大天母,2024-05-16,9893
2317,鴻海,79,39,40,元大-大天母,2024-05-16,9893
2301,光寶科,47,7,40,元大-大天母,2024-05-16,9893
6175,立敦,45,8,37,元大-大天母,2024-05-16,9893
1312,國喬,40,3,37,元大-大天母,2024-05-16,9893
00878,國泰永續高股息,89,52,37,元大-大天母,2024-05-16,9893
00933B,國泰10Y+金融債,32,0,32,元大-大天母,2024-05-16,9893
5392,能率,50,19,31,元大-大天母,2024-05-16,9893
9105,泰金寶-DR,30,0,30,元大-大天母,2024-05-16,9893
1563,巧新,30,0,30,元大-大天母,2024-05-16,9893
6168,宏齊,157,127,30,元大-大天母,2024-05-16,9893
2520,冠德,35,6,29,元大-大天母,2024-05-16,9893
2404,漢唐,32,5,27,元大-大天母,2024-05-16,9893
2349,錸德,26,0,26,元大-大天母,2024-05-16,9893
1612,宏泰,30,6,24,元大-大天母,2024-05-16,9893
1605,華新,24,2,22,元大-大天母,2024-05-16,9893
6227,茂綸,62,41,21,元大-大天母,2024-05-16,9893
2385,群光,20,0,20,元大-大天母,2024-05-16,9893
6167,久正,20,0,20,元大-大天母,2024-05-16,9893
5512,力麒,20,0,20,元大-大天母,2024-05-16,9893
1905,華紙,20,0,20,元大-大天母,2024-05-16,9893
6231,系微,40,21,19,元大-大天母,2024-05-16,9893
3703,欣陸,22,5,17,元大-大天母,2024-05-16,9893
2474,可成,17,0,17,元大-大天母,2024-05-16,9893
1522,堤維西,17,0,17,元大-大天母,2024-05-16,9893
6525,捷敏-KY,16,0,16,元大-大天母,2024-05-16,9893
3715,定穎投控,18,2,16,元大-大天母,2024-05-16,9893
5009,榮剛,15,0,15,元大-大天母,2024-05-16,9893
00941,中信上游半導體,17,2,15,元大-大天母,2024-05-16,9893
2610,華航,337,165,172,元大-大天母,2024-05-17,9893
2886,兆豐金,133,7,126,元大-大天母,2024-05-17,9893
00878,國泰永續高股息,133,25,108,元大-大天母,2024-05-17,9893
2383,台光電,108,3,105,元大-大天母,2024-05-17,9893
2867,三商壽,119,33,86,元大-大天母,2024-05-17,9893
2915,潤泰全,82,10,72,元大-大天母,2024-05-17,9893
2374,佳能,188,118,70,元大-大天母,2024-05-17,9893
2883,凱基金,70,3,67,元大-大天母,2024-05-17,9893
6278,台表科,66,6,60,元大-大天母,2024-05-17,9893
2317,鴻海,55,13,42,元大-大天母,2024-05-17,9893
3059,華晶科,46,5,41,元大-大天母,2024-05-17,9893
1531,高林股,43,3,40,元大-大天母,2024-05-17,9893
5457,宣德,45,5,40,元大-大天母,2024-05-17,9893
2404,漢唐,37,1,36,元大-大天母,2024-05-17,9893
2504,國產,42,6,36,元大-大天母,2024-05-17,9893
00929,復華台灣科技優息,145,109,36,元大-大天母,2024-05-17,9893
1314,中石化,41,6,35,元大-大天母,2024-05-17,9893
2611,志信,38,4,34,元大-大天母,2024-05-17,9893
00919,群益台灣精選高息,33,1,32,元大-大天母,2024-05-17,9893
00933B,國泰10Y+金融債,32,0,32,元大-大天母,2024-05-17,9893
3024,憶聲,31,1,30,元大-大天母,2024-05-17,9893
9912,偉聯,30,0,30,元大-大天母,2024-05-17,9893
4952,凌通,32,4,28,元大-大天母,2024-05-17,9893
00936,台新永續高息中小,27,0,27,元大-大天母,2024-05-17,9893
00632R,元大台灣50反1,40,13,27,元大-大天母,2024-05-17,9893
8163,達方,29,3,26,元大-大天母,2024-05-17,9893
3033,威健,56,31,25,元大-大天母,2024-05-17,9893
6770,力積電,27,3,24,元大-大天母,2024-05-17,9893
4960,誠美材,30,7,23,元大-大天母,2024-05-17,9893
2603,長榮,46,25,21,元大-大天母,2024-05-17,9893
4968,立積,31,11,20,元大-大天母,2024-05-17,9893
2449,京元電子,31,11,20,元大-大天母,2024-05-17,9893
00706L,期元大S＆P日圓正2,20,0,20,元大-大天母,2024-05-17,9893
00760B,復華新興企業債,20,0,20,元大-大天母,2024-05-17,9893
9105,泰金寶-DR,30,10,20,元大-大天母,2024-05-17,9893
1563,巧新,20,0,20,元大-大天母,2024-05-17,9893
2211,長榮鋼,22,2,20,元大-大天母,2024-05-17,9893
5876,上海商銀,19,0,19,元大-大天母,2024-05-17,9893
8088,品安,16,0,16,元大-大天母,2024-05-17,9893
00939,統一台灣高息動能,27,11,16,元大-大天母,2024-05-17,9893
2609,陽明,42,27,15,元大-大天母,2024-05-17,9893
00944,野村趨勢動能高息,22,6,16,元大-大天母,2024-05-17,9893
2382,廣達,95,79,16,元大-大天母,2024-05-17,9893
6121,新普,15,0,15,元大-大天母,2024-05-17,9893
3038,全台,15,0,15,元大-大天母,2024-05-17,9893
5371,中光電,21,7,14,元大-大天母,2024-05-17,9893
1227,佳格,15,2,13,元大-大天母,2024-05-17,9893
2440,太空梭,13,0,13,元大-大天母,2024-05-17,9893
2605,新興,14,1,13,元大-大天母,2024-05-17,9893
2357,華碩,16,3,13,元大-大天母,2024-05-17,9893
00665L,富邦�琤肭磪囓�2,380,5,375,元大-大天母,2024-05-20,9893
2883,凱基金,172,7,165,元大-大天母,2024-05-20,9893
2618,長榮航,194,49,145,元大-大天母,2024-05-20,9893
9933,中鼎,106,3,103,元大-大天母,2024-05-20,9893
2801,彰銀,100,1,99,元大-大天母,2024-05-20,9893
00929,復華台灣科技優息,122,37,85,元大-大天母,2024-05-20,9893
2211,長榮鋼,83,1,82,元大-大天母,2024-05-20,9893
8155,博智,83,3,80,元大-大天母,2024-05-20,9893
00679B,元大美債20年,83,6,77,元大-大天母,2024-05-20,9893
2610,華航,335,273,62,元大-大天母,2024-05-20,9893
2467,志聖,64,2,62,元大-大天母,2024-05-20,9893
2031,新光鋼,53,1,52,元大-大天母,2024-05-20,9893
3483,力致,60,9,51,元大-大天母,2024-05-20,9893
00751B,元大AAA至A公司債,51,0,51,元大-大天母,2024-05-20,9893
3231,緯創,52,4,48,元大-大天母,2024-05-20,9893
00937B,群益ESG投等債20,59,12,47,元大-大天母,2024-05-20,9893
00878,國泰永續高股息,64,18,46,元大-大天母,2024-05-20,9893
00795B,中信美國公債20年,44,0,44,元大-大天母,2024-05-20,9893
9105,泰金寶-DR,40,0,40,元大-大天母,2024-05-20,9893
2317,鴻海,62,27,35,元大-大天母,2024-05-20,9893
00943,兆豐電子高息等權,35,0,35,元大-大天母,2024-05-20,9893
3264,欣銓,34,0,34,元大-大天母,2024-05-20,9893
6176,瑞儀,32,0,32,元大-大天母,2024-05-20,9893
2834,臺企銀,31,0,31,元大-大天母,2024-05-20,9893
1108,幸福,30,0,30,元大-大天母,2024-05-20,9893
2382,廣達,34,4,30,元大-大天母,2024-05-20,9893
00882,中信中國高股息,32,3,29,元大-大天母,2024-05-20,9893
4968,立積,30,1,29,元大-大天母,2024-05-20,9893
2363,矽統,192,163,29,元大-大天母,2024-05-20,9893
1227,佳格,28,1,27,元大-大天母,2024-05-20,9893
2915,潤泰全,35,8,27,元大-大天母,2024-05-20,9893
2509,全坤建,26,0,26,元大-大天母,2024-05-20,9893
3024,憶聲,25,0,25,元大-大天母,2024-05-20,9893
5324,士開,34,10,24,元大-大天母,2024-05-20,9893
2867,三商壽,40,16,24,元大-大天母,2024-05-20,9893
00680L,元大美債20正2,22,0,22,元大-大天母,2024-05-20,9893
4128,中天,22,0,22,元大-大天母,2024-05-20,9893
00946,群益科技高息成長,21,0,21,元大-大天母,2024-05-20,9893
8070,長華*,23,2,21,元大-大天母,2024-05-20,9893
9944,新麗,20,0,20,元大-大天母,2024-05-20,9893
2038,海光,20,0,20,元大-大天母,2024-05-20,9893
1532,勤美,30,10,20,元大-大天母,2024-05-20,9893
6263,普萊德,20,0,20,元大-大天母,2024-05-20,9893
6609,瀧澤科,19,0,19,元大-大天母,2024-05-20,9893
6005,群益證,16,0,16,元大-大天母,2024-05-20,9893
2906,高林,18,2,16,元大-大天母,2024-05-20,9893
2605,新興,16,1,15,元大-大天母,2024-05-20,9893
2887,台新金,16,1,15,元大-大天母,2024-05-20,9893
2611,志信,19,4,15,元大-大天母,2024-05-20,9893
3363,上詮,18,3,15,元大-大天母,2024-05-20,9893
2883,凱基金,617,5,612,元大-大天母,2024-05-21,9893
1815,富喬,612,187,425,元大-大天母,2024-05-21,9893
00933B,國泰10Y+金融債,301,0,301,元大-大天母,2024-05-21,9893
1314,中石化,107,0,107,元大-大天母,2024-05-21,9893
3264,欣銓,101,0,101,元大-大天母,2024-05-21,9893
2618,長榮航,122,22,100,元大-大天母,2024-05-21,9893
5392,能率,106,16,90,元大-大天母,2024-05-21,9893
00929,復華台灣科技優息,102,13,89,元大-大天母,2024-05-21,9893
00919,群益台灣精選高息,90,13,77,元大-大天母,2024-05-21,9893
00665L,富邦�琤肭磪囓�2,74,0,74,元大-大天母,2024-05-21,9893
5531,鄉林,61,0,61,元大-大天母,2024-05-21,9893
0056,元大高股息,61,5,56,元大-大天母,2024-05-21,9893
6207,雷科,62,9,53,元大-大天母,2024-05-21,9893
2367,燿華,202,149,53,元大-大天母,2024-05-21,9893
00878,國泰永續高股息,59,9,50,元大-大天母,2024-05-21,9893
00650L,復華香港正2,55,8,47,元大-大天母,2024-05-21,9893
2891,中信金,175,130,45,元大-大天母,2024-05-21,9893
2392,正崴,59,14,45,元大-大天母,2024-05-21,9893
1605,華新,93,51,42,元大-大天母,2024-05-21,9893
2884,玉山金,59,17,42,元大-大天母,2024-05-21,9893
2603,長榮,58,17,41,元大-大天母,2024-05-21,9893
3024,憶聲,40,0,40,元大-大天母,2024-05-21,9893
2031,新光鋼,37,3,34,元大-大天母,2024-05-21,9893
4766,南寶,35,2,33,元大-大天母,2024-05-21,9893
2882,國泰金,52,20,32,元大-大天母,2024-05-21,9893
2105,正新,32,2,30,元大-大天母,2024-05-21,9893
9105,泰金寶-DR,30,0,30,元大-大天母,2024-05-21,9893
6177,達麗,32,2,30,元大-大天母,2024-05-21,9893
1609,大亞,38,10,28,元大-大天母,2024-05-21,9893
00708L,期元大S＆P黃金正2,30,2,28,元大-大天母,2024-05-21,9893
3479,安勤,26,0,26,元大-大天母,2024-05-21,9893
2885,元大金,28,2,26,元大-大天母,2024-05-21,9893
2491,吉祥全,24,0,24,元大-大天母,2024-05-21,9893
1608,華榮,45,21,24,元大-大天母,2024-05-21,9893
2892,第一金,62,38,24,元大-大天母,2024-05-21,9893
2915,潤泰全,26,3,23,元大-大天母,2024-05-21,9893
00753L,中信中國50正2,23,0,23,元大-大天母,2024-05-21,9893
00679B,元大美債20年,35,12,23,元大-大天母,2024-05-21,9893
2317,鴻海,43,21,22,元大-大天母,2024-05-21,9893
2514,龍邦,27,5,22,元大-大天母,2024-05-21,9893
2211,長榮鋼,21,0,21,元大-大天母,2024-05-21,9893
00680L,元大美債20正2,21,0,21,元大-大天母,2024-05-21,9893
2633,台灣高鐵,21,0,21,元大-大天母,2024-05-21,9893
1201,味全,21,0,21,元大-大天母,2024-05-21,9893
3490,單井,20,0,20,元大-大天母,2024-05-21,9893
00715L,期街口布蘭特正2,19,0,19,元大-大天母,2024-05-21,9893
2607,榮運,21,2,19,元大-大天母,2024-05-21,9893
00713,元大台灣高息低波,19,0,19,元大-大天母,2024-05-21,9893
3047,訊舟,28,10,18,元大-大天母,2024-05-21,9893
4167,松瑞藥,19,2,17,元大-大天母,2024-05-21,9893
00632R,元大台灣50反1,259,0,259,元大-大天母,2024-05-22,9893
2486,一詮,206,7,199,元大-大天母,2024-05-22,9893
6168,宏齊,117,0,117,元大-大天母,2024-05-22,9893
6125,廣運,135,21,114,元大-大天母,2024-05-22,9893
2618,長榮航,146,33,113,元大-大天母,2024-05-22,9893
00933B,國泰10Y+金融債,108,0,108,元大-大天母,2024-05-22,9893
1102,亞泥,95,0,95,元大-大天母,2024-05-22,9893
00665L,富邦�琤肭磪囓�2,76,0,76,元大-大天母,2024-05-22,9893
2884,玉山金,60,0,60,元大-大天母,2024-05-22,9893
00946,群益科技高息成長,56,0,56,元大-大天母,2024-05-22,9893
2886,兆豐金,48,0,48,元大-大天母,2024-05-22,9893
2880,華南金,51,4,47,元大-大天母,2024-05-22,9893
6579,研揚,42,0,42,元大-大天母,2024-05-22,9893
3049,精金,50,10,40,元大-大天母,2024-05-22,9893
3057,喬鼎,37,0,37,元大-大天母,2024-05-22,9893
5324,士開,37,0,37,元大-大天母,2024-05-22,9893
2610,華航,46,10,36,元大-大天母,2024-05-22,9893
6442,光聖,35,0,35,元大-大天母,2024-05-22,9893
2881,富邦金,33,0,33,元大-大天母,2024-05-22,9893
2354,鴻準,43,12,31,元大-大天母,2024-05-22,9893
00662,富邦NASDAQ,31,0,31,元大-大天母,2024-05-22,9893
4306,炎洲,30,0,30,元大-大天母,2024-05-22,9893
6263,普萊德,30,0,30,元大-大天母,2024-05-22,9893
1532,勤美,30,1,29,元大-大天母,2024-05-22,9893
00715L,期街口布蘭特正2,32,4,28,元大-大天母,2024-05-22,9893
4766,南寶,23,0,23,元大-大天母,2024-05-22,9893
9945,潤泰新,23,0,23,元大-大天母,2024-05-22,9893
2002,中鋼,23,0,23,元大-大天母,2024-05-22,9893
00941,中信上游半導體,22,0,22,元大-大天母,2024-05-22,9893
6609,瀧澤科,22,0,22,元大-大天母,2024-05-22,9893
3028,增你強,22,0,22,元大-大天母,2024-05-22,9893
1303,南亞,20,0,20,元大-大天母,2024-05-22,9893
00676R,富邦臺灣加權反1,20,0,20,元大-大天母,2024-05-22,9893
3014,聯陽,20,0,20,元大-大天母,2024-05-22,9893
6770,力積電,36,16,20,元大-大天母,2024-05-22,9893
00929,復華台灣科技優息,26,6,20,元大-大天母,2024-05-22,9893
00937B,群益ESG投等債20,20,1,19,元大-大天母,2024-05-22,9893
00919,群益台灣精選高息,27,9,18,元大-大天母,2024-05-22,9893
2250,IKKA-KY,25,8,17,元大-大天母,2024-05-22,9893
00753L,中信中國50正2,17,0,17,元大-大天母,2024-05-22,9893
6278,台表科,20,3,17,元大-大天母,2024-05-22,9893
2062,橋椿,17,0,17,元大-大天母,2024-05-22,9893
2376,技嘉,21,5,16,元大-大天母,2024-05-22,9893
3060,銘異,38,22,16,元大-大天母,2024-05-22,9893
3483,力致,35,20,15,元大-大天母,2024-05-22,9893
2498,宏達電,25,10,15,元大-大天母,2024-05-22,9893
6176,瑞儀,14,0,14,元大-大天母,2024-05-22,9893
1227,佳格,14,0,14,元大-大天母,2024-05-22,9893
4906,正文,19,5,14,元大-大天母,2024-05-22,9893
3535,晶彩科,14,1,13,元大-大天母,2024-05-22,9893
2883,凱基金,479,9,470,元大-大天母,2024-05-23,9893
9934,成霖,190,0,190,元大-大天母,2024-05-23,9893
2886,兆豐金,111,8,103,元大-大天母,2024-05-23,9893
8071,能率網通,97,0,97,元大-大天母,2024-05-23,9893
2353,宏��,201,112,89,元大-大天母,2024-05-23,9893
2882,國泰金,91,6,85,元大-大天母,2024-05-23,9893
6168,宏齊,84,0,84,元大-大天母,2024-05-23,9893
2031,新光鋼,80,0,80,元大-大天母,2024-05-23,9893
2915,潤泰全,102,27,75,元大-大天母,2024-05-23,9893
5531,鄉林,61,0,61,元大-大天母,2024-05-23,9893
2881,富邦金,61,3,58,元大-大天母,2024-05-23,9893
6176,瑞儀,56,0,56,元大-大天母,2024-05-23,9893
00946,群益科技高息成長,54,0,54,元大-大天母,2024-05-23,9893
5534,長虹,54,1,53,元大-大天母,2024-05-23,9893
00665L,富邦�琤肭磪囓�2,52,0,52,元大-大天母,2024-05-23,9893
00937B,群益ESG投等債20,53,10,43,元大-大天母,2024-05-23,9893
00715L,期街口布蘭特正2,41,0,41,元大-大天母,2024-05-23,9893
2368,金像電,42,2,40,元大-大天母,2024-05-23,9893
9933,中鼎,40,0,40,元大-大天母,2024-05-23,9893
6209,今國光,58,19,39,元大-大天母,2024-05-23,9893
9110,越南控-DR,37,0,37,元大-大天母,2024-05-23,9893
2356,英業達,39,4,35,元大-大天母,2024-05-23,9893
00878,國泰永續高股息,58,28,30,元大-大天母,2024-05-23,9893
2365,昆盈,47,17,30,元大-大天母,2024-05-23,9893
1409,新纖,30,0,30,元大-大天母,2024-05-23,9893
00929,復華台灣科技優息,73,46,27,元大-大天母,2024-05-23,9893
2884,玉山金,29,2,27,元大-大天母,2024-05-23,9893
2464,盟立,115,91,24,元大-大天母,2024-05-23,9893
2534,宏盛,24,0,24,元大-大天母,2024-05-23,9893
3059,華晶科,53,29,24,元大-大天母,2024-05-23,9893
2009,第一銅,26,3,23,元大-大天母,2024-05-23,9893
00940,元大台灣價值高息,39,16,23,元大-大天母,2024-05-23,9893
5371,中光電,45,23,22,元大-大天母,2024-05-23,9893
2609,陽明,36,15,21,元大-大天母,2024-05-23,9893
2376,技嘉,28,7,21,元大-大天母,2024-05-23,9893
2889,國票金,21,0,21,元大-大天母,2024-05-23,9893
2548,華固,26,5,21,元大-大天母,2024-05-23,9893
6505,台塑化,21,0,21,元大-大天母,2024-05-23,9893
6116,彩晶,21,0,21,元大-大天母,2024-05-23,9893
4977,眾達-KY,20,0,20,元大-大天母,2024-05-23,9893
3666,光耀,20,0,20,元大-大天母,2024-05-23,9893
5324,士開,20,0,20,元大-大天母,2024-05-23,9893
5432,新門,20,0,20,元大-大天母,2024-05-23,9893
00936,台新永續高息中小,20,0,20,元大-大天母,2024-05-23,9893
00753L,中信中國50正2,21,1,20,元大-大天母,2024-05-23,9893
3231,緯創,42,23,19,元大-大天母,2024-05-23,9893
2324,仁寶,89,70,19,元大-大天母,2024-05-23,9893
2363,矽統,53,35,18,元大-大天母,2024-05-23,9893
8110,華東,18,0,18,元大-大天母,2024-05-23,9893
5871,中租-KY,19,1,18,元大-大天母,2024-05-23,9893
00937B,群益ESG投等債20,174,1,173,元大-大天母,2024-05-24,9893
00933B,國泰10Y+金融債,130,0,130,元大-大天母,2024-05-24,9893
2886,兆豐金,112,0,112,元大-大天母,2024-05-24,9893
1301,台塑,107,2,105,元大-大天母,2024-05-24,9893
00664R,國泰臺灣加權反1,100,0,100,元大-大天母,2024-05-24,9893
3363,上詮,114,17,97,元大-大天母,2024-05-24,9893
2368,金像電,78,1,77,元大-大天母,2024-05-24,9893
00632R,元大台灣50反1,66,0,66,元大-大天母,2024-05-24,9893
00665L,富邦�琤肭磪囓�2,65,5,60,元大-大天母,2024-05-24,9893
5511,德昌,60,0,60,元大-大天母,2024-05-24,9893
9933,中鼎,51,6,45,元大-大天母,2024-05-24,9893
00946,群益科技高息成長,44,0,44,元大-大天母,2024-05-24,9893
6168,宏齊,140,99,41,元大-大天母,2024-05-24,9893
8071,能率網通,40,0,40,元大-大天母,2024-05-24,9893
2303,聯電,55,16,39,元大-大天母,2024-05-24,9893
4549,桓達,40,1,39,元大-大天母,2024-05-24,9893
1314,中石化,40,3,37,元大-大天母,2024-05-24,9893
4566,時碩工業,44,7,37,元大-大天母,2024-05-24,9893
2002,中鋼,39,4,35,元大-大天母,2024-05-24,9893
1532,勤美,34,0,34,元大-大天母,2024-05-24,9893
2892,第一金,34,2,32,元大-大天母,2024-05-24,9893
00662,富邦NASDAQ,32,0,32,元大-大天母,2024-05-24,9893
1102,亞泥,27,0,27,元大-大天母,2024-05-24,9893
8028,昇陽半導體,55,28,27,元大-大天母,2024-05-24,9893
3234,光環,34,9,25,元大-大天母,2024-05-24,9893
6278,台表科,32,8,24,元大-大天母,2024-05-24,9893
3360,尚立,25,2,23,元大-大天母,2024-05-24,9893
2101,南港,26,3,23,元大-大天母,2024-05-24,9893
1605,華新,25,3,22,元大-大天母,2024-05-24,9893
2836,高雄銀,20,0,20,元大-大天母,2024-05-24,9893
3675,德微,19,0,19,元大-大天母,2024-05-24,9893
6190,萬泰科,37,18,19,元大-大天母,2024-05-24,9893
1809,中釉,25,6,19,元大-大天母,2024-05-24,9893
00712,復華富時不動產,18,0,18,元大-大天母,2024-05-24,9893
3003,健和興,20,2,18,元大-大天母,2024-05-24,9893
00679B,元大美債20年,24,7,17,元大-大天母,2024-05-24,9893
2498,宏達電,20,3,17,元大-大天母,2024-05-24,9893
1303,南亞,22,6,16,元大-大天母,2024-05-24,9893
00830,國泰費城半導體,16,0,16,元大-大天母,2024-05-24,9893
2392,正崴,39,23,16,元大-大天母,2024-05-24,9893
2371,大同,40,24,16,元大-大天母,2024-05-24,9893
1609,大亞,29,15,14,元大-大天母,2024-05-24,9893
8046,南電,14,0,14,元大-大天母,2024-05-24,9893
2409,友達,33,19,14,元大-大天母,2024-05-24,9893
00650L,復華香港正2,14,0,14,元大-大天母,2024-05-24,9893
6194,育富,14,0,14,元大-大天母,2024-05-24,9893
6139,亞翔,14,1,13,元大-大天母,2024-05-24,9893
6901,鑽石投資,13,0,13,元大-大天母,2024-05-24,9893
00895,富邦未來車,15,2,13,元大-大天母,2024-05-24,9893
00753L,中信中國50正2,13,0,13,元大-大天母,2024-05-24,9893
00632R,元大台灣50反1,359,20,339,元大-大天母,2024-05-27,9893
00679B,元大美債20年,230,9,221,元大-大天母,2024-05-27,9893
2886,兆豐金,166,1,165,元大-大天母,2024-05-27,9893
2501,國建,126,5,121,元大-大天母,2024-05-27,9893
3234,光環,108,6,102,元大-大天母,2024-05-27,9893
2486,一詮,120,24,96,元大-大天母,2024-05-27,9893
3047,訊舟,186,94,92,元大-大天母,2024-05-27,9893
9105,泰金寶-DR,117,31,86,元大-大天母,2024-05-27,9893
00937B,群益ESG投等債20,57,0,57,元大-大天母,2024-05-27,9893
1519,華城,54,4,50,元大-大天母,2024-05-27,9893
1815,富喬,88,38,50,元大-大天母,2024-05-27,9893
1714,和桐,50,0,50,元大-大天母,2024-05-27,9893
2401,凌陽,43,1,42,元大-大天母,2024-05-27,9893
4906,正文,66,27,39,元大-大天母,2024-05-27,9893
2498,宏達電,41,2,39,元大-大天母,2024-05-27,9893
2392,正崴,50,13,37,元大-大天母,2024-05-27,9893
2363,矽統,260,227,33,元大-大天母,2024-05-27,9893
00946,群益科技高息成長,32,0,32,元大-大天母,2024-05-27,9893
6834,天二科技,30,0,30,元大-大天母,2024-05-27,9893
1532,勤美,29,0,29,元大-大天母,2024-05-27,9893
3013,晟銘電,84,55,29,元大-大天母,2024-05-27,9893
2324,仁寶,40,13,27,元大-大天母,2024-05-27,9893
6147,頎邦,27,1,26,元大-大天母,2024-05-27,9893
2367,燿華,42,17,25,元大-大天母,2024-05-27,9893
3152,璟德,25,0,25,元大-大天母,2024-05-27,9893
00712,復華富時不動產,24,0,24,元大-大天母,2024-05-27,9893
9110,越南控-DR,23,0,23,元大-大天母,2024-05-27,9893
2308,台達電,52,29,23,元大-大天母,2024-05-27,9893
2545,皇翔,22,0,22,元大-大天母,2024-05-27,9893
5534,長虹,22,0,22,元大-大天母,2024-05-27,9893
6269,台郡,23,1,22,元大-大天母,2024-05-27,9893
2369,菱生,34,13,21,元大-大天母,2024-05-27,9893
2211,長榮鋼,21,0,21,元大-大天母,2024-05-27,9893
5388,中磊,21,0,21,元大-大天母,2024-05-27,9893
3059,華晶科,40,19,21,元大-大天母,2024-05-27,9893
2613,中櫃,22,1,21,元大-大天母,2024-05-27,9893
6757,台灣虎航,20,0,20,元大-大天母,2024-05-27,9893
1563,巧新,20,0,20,元大-大天母,2024-05-27,9893
8467,波力-KY,20,0,20,元大-大天母,2024-05-27,9893
00927,群益半導體收益,20,0,20,元大-大天母,2024-05-27,9893
6609,瀧澤科,20,0,20,元大-大天母,2024-05-27,9893
1809,中釉,19,0,19,元大-大天母,2024-05-27,9893
3306,鼎天,25,7,18,元大-大天母,2024-05-27,9893
6204,艾華,20,2,18,元大-大天母,2024-05-27,9893
2002,中鋼,18,1,17,元大-大天母,2024-05-27,9893
6155,鈞寶,17,0,17,元大-大天母,2024-05-27,9893
6770,力積電,36,19,17,元大-大天母,2024-05-27,9893
1314,中石化,21,4,17,元大-大天母,2024-05-27,9893
3675,德微,18,2,16,元大-大天母,2024-05-27,9893
5392,能率,30,14,16,元大-大天母,2024-05-27,9893
2349,錸德,225,1,224,元大-大天母,2024-05-28,9893
00679B,元大美債20年,208,0,208,元大-大天母,2024-05-28,9893
2891,中信金,250,71,179,元大-大天母,2024-05-28,9893
2886,兆豐金,156,2,154,元大-大天母,2024-05-28,9893
2610,華航,170,33,137,元大-大天母,2024-05-28,9893
00929,復華台灣科技優息,142,42,100,元大-大天母,2024-05-28,9893
00933B,國泰10Y+金融債,100,0,100,元大-大天母,2024-05-28,9893
00937B,群益ESG投等債20,102,12,90,元大-大天母,2024-05-28,9893
6125,廣運,104,18,86,元大-大天母,2024-05-28,9893
2382,廣達,81,8,73,元大-大天母,2024-05-28,9893
3231,緯創,194,125,69,元大-大天母,2024-05-28,9893
2641,正德,67,3,64,元大-大天母,2024-05-28,9893
2547,日勝生,50,0,50,元大-大天母,2024-05-28,9893
1903,士紙,54,6,48,元大-大天母,2024-05-28,9893
2472,立隆電,50,2,48,元大-大天母,2024-05-28,9893
2332,友訊,48,0,48,元大-大天母,2024-05-28,9893
2464,盟立,84,39,45,元大-大天母,2024-05-28,9893
1609,大亞,47,3,44,元大-大天母,2024-05-28,9893
2337,旺宏,50,7,43,元大-大天母,2024-05-28,9893
3479,安勤,41,0,41,元大-大天母,2024-05-28,9893
2308,台達電,41,7,34,元大-大天母,2024-05-28,9893
2363,矽統,140,106,34,元大-大天母,2024-05-28,9893
6188,廣明,95,62,33,元大-大天母,2024-05-28,9893
6264,富裔,30,0,30,元大-大天母,2024-05-28,9893
6486,互動,30,0,30,元大-大天母,2024-05-28,9893
6712,長聖,30,0,30,元大-大天母,2024-05-28,9893
5519,隆大,28,0,28,元大-大天母,2024-05-28,9893
3202,樺晟,31,4,27,元大-大天母,2024-05-28,9893
3035,智原,34,10,24,元大-大天母,2024-05-28,9893
3057,喬鼎,24,0,24,元大-大天母,2024-05-28,9893
2324,仁寶,46,22,24,元大-大天母,2024-05-28,9893
2457,飛宏,21,0,21,元大-大天母,2024-05-28,9893
00720B,元大投資級公司債,21,0,21,元大-大天母,2024-05-28,9893
1314,中石化,25,5,20,元大-大天母,2024-05-28,9893
5347,世界,80,60,20,元大-大天母,2024-05-28,9893
6548,長科*,30,10,20,元大-大天母,2024-05-28,9893
1605,華新,27,8,19,元大-大天母,2024-05-28,9893
5432,新門,20,1,19,元大-大天母,2024-05-28,9893
2313,華通,19,1,18,元大-大天母,2024-05-28,9893
2892,第一金,20,2,18,元大-大天母,2024-05-28,9893
4562,穎漢,18,0,18,元大-大天母,2024-05-28,9893
6456,GIS-KY,23,5,18,元大-大天母,2024-05-28,9893
3306,鼎天,24,6,18,元大-大天母,2024-05-28,9893
6719,力智,25,7,18,元大-大天母,2024-05-28,9893
8096,擎亞,25,8,17,元大-大天母,2024-05-28,9893
6869,雲豹能源,16,0,16,元大-大天母,2024-05-28,9893
2603,長榮,29,13,16,元大-大天母,2024-05-28,9893
00753L,中信中國50正2,15,0,15,元大-大天母,2024-05-28,9893
00687B,國泰20年美債,16,1,15,元大-大天母,2024-05-28,9893
1316,上曜,14,0,14,元大-大天母,2024-05-28,9893
2501,國建,679,13,666,元大-大天母,2024-05-29,9893
2883,凱基金,323,14,309,元大-大天母,2024-05-29,9893
00937B,群益ESG投等債20,261,11,250,元大-大天母,2024-05-29,9893
1513,中興電,253,4,249,元大-大天母,2024-05-29,9893
2880,華南金,170,0,170,元大-大天母,2024-05-29,9893
2891,中信金,302,141,161,元大-大天母,2024-05-29,9893
3047,訊舟,190,64,126,元大-大天母,2024-05-29,9893
0056,元大高股息,121,4,117,元大-大天母,2024-05-29,9893
2886,兆豐金,92,0,92,元大-大天母,2024-05-29,9893
4513,福裕,91,0,91,元大-大天母,2024-05-29,9893
2867,三商壽,75,1,74,元大-大天母,2024-05-29,9893
1784,訊聯,119,54,65,元大-大天母,2024-05-29,9893
6435,大中,65,0,65,元大-大天母,2024-05-29,9893
2317,鴻海,80,21,59,元大-大天母,2024-05-29,9893
2476,鉅祥,75,22,53,元大-大天母,2024-05-29,9893
2353,宏��,121,69,52,元大-大天母,2024-05-29,9893
1532,勤美,53,2,51,元大-大天母,2024-05-29,9893
1201,味全,50,0,50,元大-大天母,2024-05-29,9893
2882,國泰金,140,91,49,元大-大天母,2024-05-29,9893
00940,元大台灣價值高息,71,22,49,元大-大天母,2024-05-29,9893
2543,皇昌,61,12,49,元大-大天母,2024-05-29,9893
2332,友訊,45,0,45,元大-大天母,2024-05-29,9893
2324,仁寶,56,11,45,元大-大天母,2024-05-29,9893
2888,新光金,71,29,42,元大-大天母,2024-05-29,9893
5284,jpp-KY,41,1,40,元大-大天母,2024-05-29,9893
00795B,中信美國公債20年,39,0,39,元大-大天母,2024-05-29,9893
00665L,富邦�琤肭磪囓�2,39,0,39,元大-大天母,2024-05-29,9893
6005,群益證,42,4,38,元大-大天母,2024-05-29,9893
00720B,元大投資級公司債,35,0,35,元大-大天母,2024-05-29,9893
2884,玉山金,51,17,34,元大-大天母,2024-05-29,9893
8473,山林水,32,0,32,元大-大天母,2024-05-29,9893
00878,國泰永續高股息,45,13,32,元大-大天母,2024-05-29,9893
1101,台泥,33,3,30,元大-大天母,2024-05-29,9893
1563,巧新,30,0,30,元大-大天母,2024-05-29,9893
3059,華晶科,33,5,28,元大-大天母,2024-05-29,9893
00891,中信關鍵半導體,32,4,28,元大-大天母,2024-05-29,9893
00751B,元大AAA至A公司債,30,2,28,元大-大天母,2024-05-29,9893
00929,復華台灣科技優息,102,76,26,元大-大天母,2024-05-29,9893
1570,力肯,25,0,25,元大-大天母,2024-05-29,9893
2605,新興,73,50,23,元大-大天母,2024-05-29,9893
9904,寶成,23,0,23,元大-大天母,2024-05-29,9893
1802,台玻,24,1,23,元大-大天母,2024-05-29,9893
2401,凌陽,99,76,23,元大-大天母,2024-05-29,9893
2340,台亞,22,0,22,元大-大天母,2024-05-29,9893
2211,長榮鋼,22,0,22,元大-大天母,2024-05-29,9893
00753L,中信中國50正2,22,0,22,元大-大天母,2024-05-29,9893
6269,台郡,22,0,22,元大-大天母,2024-05-29,9893
3231,緯創,37,16,21,元大-大天母,2024-05-29,9893
00687B,國泰20年美債,27,6,21,元大-大天母,2024-05-29,9893
6176,瑞儀,20,0,20,元大-大天母,2024-05-29,9893
00937B,群益ESG投等債20,160,15,145,元大-大天母,2024-05-30,9893
2889,國票金,154,12,142,元大-大天母,2024-05-30,9893
2886,兆豐金,129,0,129,元大-大天母,2024-05-30,9893
2880,華南金,109,0,109,元大-大天母,2024-05-30,9893
3490,單井,115,10,105,元大-大天母,2024-05-30,9893
6117,迎廣,108,12,96,元大-大天母,2024-05-30,9893
00929,復華台灣科技優息,88,4,84,元大-大天母,2024-05-30,9893
00679B,元大美債20年,85,5,80,元大-大天母,2024-05-30,9893
0056,元大高股息,93,13,80,元大-大天母,2024-05-30,9893
6209,今國光,102,35,67,元大-大天母,2024-05-30,9893
2892,第一金,69,8,61,元大-大天母,2024-05-30,9893
1102,亞泥,56,0,56,元大-大天母,2024-05-30,9893
8054,安國,75,20,55,元大-大天母,2024-05-30,9893
6462,神盾,57,3,54,元大-大天母,2024-05-30,9893
8105,凌巨,144,95,49,元大-大天母,2024-05-30,9893
3714,富采,45,1,44,元大-大天母,2024-05-30,9893
3362,先進光,55,13,42,元大-大天母,2024-05-30,9893
2330,台積電,45,3,42,元大-大天母,2024-05-30,9893
2618,長榮航,52,13,39,元大-大天母,2024-05-30,9893
2884,玉山金,39,0,39,元大-大天母,2024-05-30,9893
2382,廣達,53,15,38,元大-大天母,2024-05-30,9893
3515,華擎,39,1,38,元大-大天母,2024-05-30,9893
4958,臻鼎-KY,41,4,37,元大-大天母,2024-05-30,9893
2002,中鋼,35,0,35,元大-大天母,2024-05-30,9893
2353,宏��,63,28,35,元大-大天母,2024-05-30,9893
3059,華晶科,35,3,32,元大-大天母,2024-05-30,9893
5324,士開,30,0,30,元大-大天母,2024-05-30,9893
2211,長榮鋼,30,0,30,元大-大天母,2024-05-30,9893
6264,富裔,30,0,30,元大-大天母,2024-05-30,9893
6005,群益證,29,0,29,元大-大天母,2024-05-30,9893
00921,兆豐龍頭等權重,29,0,29,元大-大天母,2024-05-30,9893
2356,英業達,32,3,29,元大-大天母,2024-05-30,9893
6213,聯茂,38,9,29,元大-大天母,2024-05-30,9893
2324,仁寶,31,2,29,元大-大天母,2024-05-30,9893
2354,鴻準,59,30,29,元大-大天母,2024-05-30,9893
1201,味全,26,0,26,元大-大天母,2024-05-30,9893
00726B,國泰新興投等債,25,0,25,元大-大天母,2024-05-30,9893
2367,燿華,32,7,25,元大-大天母,2024-05-30,9893
00878,國泰永續高股息,38,13,25,元大-大天母,2024-05-30,9893
2371,大同,45,21,24,元大-大天母,2024-05-30,9893
2489,瑞軒,52,28,24,元大-大天母,2024-05-30,9893
00680L,元大美債20正2,64,40,24,元大-大天母,2024-05-30,9893
4533,協易機,70,47,23,元大-大天母,2024-05-30,9893
3202,樺晟,23,0,23,元大-大天母,2024-05-30,9893
2834,臺企銀,22,0,22,元大-大天母,2024-05-30,9893
3006,晶豪科,29,7,22,元大-大天母,2024-05-30,9893
6176,瑞儀,22,0,22,元大-大天母,2024-05-30,9893
1519,華城,26,5,21,元大-大天母,2024-05-30,9893
4714,永捷,36,15,21,元大-大天母,2024-05-30,9893
2641,正德,37,16,21,元大-大天母,2024-05-30,9893
2609,陽明,530,130,400,元大-大天母,2024-05-31,9893
2889,國票金,355,26,329,元大-大天母,2024-05-31,9893
00688L,國泰20年美債正2,318,0,318,元大-大天母,2024-05-31,9893
2610,華航,313,54,259,元大-大天母,2024-05-31,9893
2464,盟立,250,70,180,元大-大天母,2024-05-31,9893
9934,成霖,180,0,180,元大-大天母,2024-05-31,9893
2317,鴻海,146,38,108,元大-大天母,2024-05-31,9893
00632R,元大台灣50反1,105,30,75,元大-大天母,2024-05-31,9893
00881,國泰台灣5G+,54,1,53,元大-大天母,2024-05-31,9893
2498,宏達電,100,49,51,元大-大天母,2024-05-31,9893
2886,兆豐金,46,1,45,元大-大天母,2024-05-31,9893
1563,巧新,41,0,41,元大-大天母,2024-05-31,9893
00919,群益台灣精選高息,50,9,41,元大-大天母,2024-05-31,9893
00929,復華台灣科技優息,48,8,40,元大-大天母,2024-05-31,9893
6176,瑞儀,40,2,38,元大-大天母,2024-05-31,9893
2382,廣達,43,10,33,元大-大天母,2024-05-31,9893
5880,合庫金,33,0,33,元大-大天母,2024-05-31,9893
2514,龍邦,59,27,32,元大-大天母,2024-05-31,9893
6264,富裔,31,0,31,元大-大天母,2024-05-31,9893
00680L,元大美債20正2,41,10,31,元大-大天母,2024-05-31,9893
2330,台積電,33,3,30,元大-大天母,2024-05-31,9893
2348,海悅,36,6,30,元大-大天母,2024-05-31,9893
2353,宏��,42,19,23,元大-大天母,2024-05-31,9893
2809,京城銀,26,3,23,元大-大天母,2024-05-31,9893
00921,兆豐龍頭等權重,22,0,22,元大-大天母,2024-05-31,9893
2408,南亞科,22,0,22,元大-大天母,2024-05-31,9893
0050,元大台灣50,24,3,21,元大-大天母,2024-05-31,9893
4306,炎洲,31,10,21,元大-大天母,2024-05-31,9893
00752,中信中國50,30,10,20,元大-大天母,2024-05-31,9893
5493,三聯,20,0,20,元大-大天母,2024-05-31,9893
5426,振發,44,25,19,元大-大天母,2024-05-31,9893
9928,中視,19,0,19,元大-大天母,2024-05-31,9893
2356,英業達,28,9,19,元大-大天母,2024-05-31,9893
1570,力肯,18,0,18,元大-大天母,2024-05-31,9893
2349,錸德,21,3,18,元大-大天母,2024-05-31,9893
2548,華固,18,1,17,元大-大天母,2024-05-31,9893
3268,海德威,18,1,17,元大-大天母,2024-05-31,9893
2344,華邦電,21,5,16,元大-大天母,2024-05-31,9893
1314,中石化,16,0,16,元大-大天母,2024-05-31,9893
00679B,元大美債20年,49,33,16,元大-大天母,2024-05-31,9893
8112,至上,15,0,15,元大-大天母,2024-05-31,9893
3466,德晉,15,0,15,元大-大天母,2024-05-31,9893
3006,晶豪科,19,4,15,元大-大天母,2024-05-31,9893
00937B,群益ESG投等債20,24,10,14,元大-大天母,2024-05-31,9893
00753L,中信中國50正2,14,0,14,元大-大天母,2024-05-31,9893
2891,中信金,43,30,13,元大-大天母,2024-05-31,9893
2618,長榮航,29,16,13,元大-大天母,2024-05-31,9893
2486,一詮,39,26,13,元大-大天母,2024-05-31,9893
6770,力積電,28,15,13,元大-大天母,2024-05-31,9893
1609,大亞,18,5,13,元大-大天母,2024-05-31,9893
2610,華航,309,24,285,元大-大天母,2024-06-03,9893
2889,國票金,216,1,215,元大-大天母,2024-06-03,9893
2609,陽明,712,599,113,元大-大天母,2024-06-03,9893
00919,群益台灣精選高息,174,70,104,元大-大天母,2024-06-03,9893
4513,福裕,87,0,87,元大-大天母,2024-06-03,9893
3376,新日興,100,19,81,元大-大天母,2024-06-03,9893
00632R,元大台灣50反1,70,0,70,元大-大天母,2024-06-03,9893
5425,台半,51,0,51,元大-大天母,2024-06-03,9893
3062,建漢,52,2,50,元大-大天母,2024-06-03,9893
1802,台玻,62,12,50,元大-大天母,2024-06-03,9893
2867,三商壽,49,0,49,元大-大天母,2024-06-03,9893
2317,鴻海,86,37,49,元大-大天母,2024-06-03,9893
4566,時碩工業,56,10,46,元大-大天母,2024-06-03,9893
6163,華電網,40,0,40,元大-大天母,2024-06-03,9893
1717,長興,44,4,40,元大-大天母,2024-06-03,9893
2406,國碩,41,1,40,元大-大天母,2024-06-03,9893
912000,晨訊科-DR,40,0,40,元大-大天母,2024-06-03,9893
2880,華南金,38,2,36,元大-大天母,2024-06-03,9893
2353,宏��,48,17,31,元大-大天母,2024-06-03,9893
00665L,富邦�琤肭磪囓�2,30,0,30,元大-大天母,2024-06-03,9893
3374,精材,33,3,30,元大-大天母,2024-06-03,9893
3202,樺晟,44,15,29,元大-大天母,2024-06-03,9893
2344,華邦電,31,2,29,元大-大天母,2024-06-03,9893
4306,炎洲,28,0,28,元大-大天母,2024-06-03,9893
2520,冠德,35,7,28,元大-大天母,2024-06-03,9893
00719B,元大美債1-3,31,4,27,元大-大天母,2024-06-03,9893
00679B,元大美債20年,37,11,26,元大-大天母,2024-06-03,9893
00715L,期街口布蘭特正2,25,0,25,元大-大天母,2024-06-03,9893
2615,萬海,66,41,25,元大-大天母,2024-06-03,9893
2618,長榮航,37,13,24,元大-大天母,2024-06-03,9893
2881,富邦金,24,0,24,元大-大天母,2024-06-03,9893
1303,南亞,28,5,23,元大-大天母,2024-06-03,9893
1718,中纖,22,0,22,元大-大天母,2024-06-03,9893
2002,中鋼,24,2,22,元大-大天母,2024-06-03,9893
2427,三商電,29,8,21,元大-大天母,2024-06-03,9893
5521,工信,22,1,21,元大-大天母,2024-06-03,9893
8070,長華*,20,0,20,元大-大天母,2024-06-03,9893
3086,華義,20,0,20,元大-大天母,2024-06-03,9893
2884,玉山金,21,1,20,元大-大天母,2024-06-03,9893
9945,潤泰新,20,0,20,元大-大天母,2024-06-03,9893
2354,鴻準,69,49,20,元大-大天母,2024-06-03,9893
2303,聯電,77,57,20,元大-大天母,2024-06-03,9893
00946,群益科技高息成長,20,1,19,元大-大天母,2024-06-03,9893
1563,巧新,20,1,19,元大-大天母,2024-06-03,9893
6609,瀧澤科,19,0,19,元大-大天母,2024-06-03,9893
2886,兆豐金,33,14,19,元大-大天母,2024-06-03,9893
2613,中櫃,23,4,19,元大-大天母,2024-06-03,9893
2329,華泰,17,0,17,元大-大天母,2024-06-03,9893
5355,佳總,15,0,15,元大-大天母,2024-06-03,9893
00664R,國泰臺灣加權反1,15,0,15,元大-大天母,2024-06-03,9893
2888,新光金,647,13,634,元大-大天母,2024-06-04,9893
2486,一詮,320,31,289,元大-大天母,2024-06-04,9893
2891,中信金,291,98,193,元大-大天母,2024-06-04,9893
6166,凌華,140,5,135,元大-大天母,2024-06-04,9893
3376,新日興,135,17,118,元大-大天母,2024-06-04,9893
00919,群益台灣精選高息,119,7,112,元大-大天母,2024-06-04,9893
9105,泰金寶-DR,114,3,111,元大-大天母,2024-06-04,9893
00936,台新永續高息中小,111,0,111,元大-大天母,2024-06-04,9893
2317,鴻海,126,20,106,元大-大天母,2024-06-04,9893
1503,士電,104,14,90,元大-大天母,2024-06-04,9893
1802,台玻,112,25,87,元大-大天母,2024-06-04,9893
00918,大華優利高填息30,90,3,87,元大-大天母,2024-06-04,9893
1102,亞泥,81,0,81,元大-大天母,2024-06-04,9893
2353,宏��,109,28,81,元大-大天母,2024-06-04,9893
00929,復華台灣科技優息,113,36,77,元大-大天母,2024-06-04,9893
2886,兆豐金,78,3,75,元大-大天母,2024-06-04,9893
2101,南港,117,43,74,元大-大天母,2024-06-04,9893
2845,遠東銀,69,0,69,元大-大天母,2024-06-04,9893
3594,磐儀,69,1,68,元大-大天母,2024-06-04,9893
2331,精英,144,88,56,元大-大天母,2024-06-04,9893
00726B,國泰新興投等債,56,0,56,元大-大天母,2024-06-04,9893
2303,聯電,59,8,51,元大-大天母,2024-06-04,9893
5521,工信,51,1,50,元大-大天母,2024-06-04,9893
2330,台積電,53,4,49,元大-大天母,2024-06-04,9893
00715L,期街口布蘭特正2,47,0,47,元大-大天母,2024-06-04,9893
6189,豐藝,55,9,46,元大-大天母,2024-06-04,9893
2312,金寶,71,30,41,元大-大天母,2024-06-04,9893
2344,華邦電,55,16,39,元大-大天母,2024-06-04,9893
4714,永捷,37,0,37,元大-大天母,2024-06-04,9893
2324,仁寶,57,23,34,元大-大天母,2024-06-04,9893
00878,國泰永續高股息,34,0,34,元大-大天母,2024-06-04,9893
2367,燿華,50,18,32,元大-大天母,2024-06-04,9893
2889,國票金,170,139,31,元大-大天母,2024-06-04,9893
2537,聯上發,36,5,31,元大-大天母,2024-06-04,9893
2409,友達,31,0,31,元大-大天母,2024-06-04,9893
00881,國泰台灣5G+,29,0,29,元大-大天母,2024-06-04,9893
00719B,元大美債1-3,30,1,29,元大-大天母,2024-06-04,9893
5353,台林,34,6,28,元大-大天母,2024-06-04,9893
2884,玉山金,29,2,27,元大-大天母,2024-06-04,9893
2603,長榮,45,21,24,元大-大天母,2024-06-04,9893
6270,倍微,39,15,24,元大-大天母,2024-06-04,9893
2465,麗臺,55,31,24,元大-大天母,2024-06-04,9893
0050,元大台灣50,23,0,23,元大-大天母,2024-06-04,9893
6005,群益證,24,1,23,元大-大天母,2024-06-04,9893
2467,志聖,27,4,23,元大-大天母,2024-06-04,9893
00946,群益科技高息成長,24,2,22,元大-大天母,2024-06-04,9893
6213,聯茂,22,0,22,元大-大天母,2024-06-04,9893
2915,潤泰全,22,0,22,元大-大天母,2024-06-04,9893
00713,元大台灣高息低波,22,0,22,元大-大天母,2024-06-04,9893
3231,緯創,24,3,21,元大-大天母,2024-06-04,9893
2504,國產,367,1,366,元大-大天母,2024-06-05,9893
2889,國票金,195,0,195,元大-大天母,2024-06-05,9893
2303,聯電,170,47,123,元大-大天母,2024-06-05,9893
6245,立端,117,2,115,元大-大天母,2024-06-05,9893
2101,南港,115,11,104,元大-大天母,2024-06-05,9893
2888,新光金,107,13,94,元大-大天母,2024-06-05,9893
2603,長榮,134,50,84,元大-大天母,2024-06-05,9893
00878,國泰永續高股息,100,16,84,元大-大天母,2024-06-05,9893
00929,復華台灣科技優息,82,12,70,元大-大天母,2024-06-05,9893
8354,冠好,70,0,70,元大-大天母,2024-06-05,9893
00936,台新永續高息中小,81,15,66,元大-大天母,2024-06-05,9893
1503,士電,77,19,58,元大-大天母,2024-06-05,9893
3048,益登,132,78,54,元大-大天母,2024-06-05,9893
6112,邁達特,53,3,50,元大-大天母,2024-06-05,9893
2323,中環,42,0,42,元大-大天母,2024-06-05,9893
1903,士紙,48,6,42,元大-大天母,2024-06-05,9893
6177,達麗,44,6,38,元大-大天母,2024-06-05,9893
2344,華邦電,39,2,37,元大-大天母,2024-06-05,9893
3305,昇貿,45,8,37,元大-大天母,2024-06-05,9893
2353,宏��,43,7,36,元大-大天母,2024-06-05,9893
3379,彬台,30,0,30,元大-大天母,2024-06-05,9893
3481,群創,40,11,29,元大-大天母,2024-06-05,9893
3057,喬鼎,26,0,26,元大-大天母,2024-06-05,9893
2331,精英,46,20,26,元大-大天母,2024-06-05,9893
3015,全漢,25,1,24,元大-大天母,2024-06-05,9893
2317,鴻海,59,35,24,元大-大天母,2024-06-05,9893
0056,元大高股息,23,0,23,元大-大天母,2024-06-05,9893
00919,群益台灣精選高息,24,2,22,元大-大天母,2024-06-05,9893
3376,新日興,25,3,22,元大-大天母,2024-06-05,9893
00712,復華富時不動產,21,0,21,元大-大天母,2024-06-05,9893
5009,榮剛,22,1,21,元大-大天母,2024-06-05,9893
2031,新光鋼,20,0,20,元大-大天母,2024-06-05,9893
5521,工信,20,0,20,元大-大天母,2024-06-05,9893
2867,三商壽,24,5,19,元大-大天母,2024-06-05,9893
00715L,期街口布蘭特正2,19,0,19,元大-大天母,2024-06-05,9893
4123,晟德,39,21,18,元大-大天母,2024-06-05,9893
2482,連宇,52,34,18,元大-大天母,2024-06-05,9893
2376,技嘉,18,1,17,元大-大天母,2024-06-05,9893
6270,倍微,34,17,17,元大-大天母,2024-06-05,9893
3088,艾訊,33,17,16,元大-大天母,2024-06-05,9893
6139,亞翔,16,0,16,元大-大天母,2024-06-05,9893
1524,耿鼎,18,2,16,元大-大天母,2024-06-05,9893
5392,能率,33,17,16,元大-大天母,2024-06-05,9893
2515,中工,44,28,16,元大-大天母,2024-06-05,9893
2356,英業達,19,4,15,元大-大天母,2024-06-05,9893
3005,神基,14,0,14,元大-大天母,2024-06-05,9893
2495,普安,15,1,14,元大-大天母,2024-06-05,9893
2105,正新,14,0,14,元大-大天母,2024-06-05,9893
9934,成霖,15,1,14,元大-大天母,2024-06-05,9893
2357,華碩,15,2,13,元大-大天母,2024-06-05,9893
00632R,元大台灣50反1,513,30,483,元大-大天母,2024-06-06,9893
2889,國票金,741,331,410,元大-大天母,2024-06-06,9893
2609,陽明,1496,1288,208,元大-大天母,2024-06-06,9893
2610,華航,200,13,187,元大-大天母,2024-06-06,9893
1503,士電,146,11,135,元大-大天母,2024-06-06,9893
2881,富邦金,172,39,133,元大-大天母,2024-06-06,9893
2615,萬海,466,344,122,元大-大天母,2024-06-06,9893
8039,台虹,118,11,107,元大-大天母,2024-06-06,9893
00665L,富邦�琤肭磪囓�2,100,0,100,元大-大天母,2024-06-06,9893
6245,立端,97,1,96,元大-大天母,2024-06-06,9893
2915,潤泰全,90,7,83,元大-大天母,2024-06-06,9893
5347,世界,101,22,79,元大-大天母,2024-06-06,9893
1519,華城,79,0,79,元大-大天母,2024-06-06,9893
2409,友達,71,0,71,元大-大天母,2024-06-06,9893
6207,雷科,60,8,52,元大-大天母,2024-06-06,9893
3481,群創,51,0,51,元大-大天母,2024-06-06,9893
00650L,復華香港正2,50,0,50,元大-大天母,2024-06-06,9893
3229,晟鈦,49,0,49,元大-大天母,2024-06-06,9893
2101,南港,56,7,49,元大-大天母,2024-06-06,9893
2002,中鋼,39,1,38,元大-大天母,2024-06-06,9893
2328,廣宇,49,11,38,元大-大天母,2024-06-06,9893
2323,中環,35,0,35,元大-大天母,2024-06-06,9893
2344,華邦電,33,0,33,元大-大天母,2024-06-06,9893
00919,群益台灣精選高息,62,31,31,元大-大天母,2024-06-06,9893
2049,上銀,31,0,31,元大-大天母,2024-06-06,9893
5355,佳總,30,0,30,元大-大天母,2024-06-06,9893
5493,三聯,30,0,30,元大-大天母,2024-06-06,9893
00676R,富邦臺灣加權反1,30,0,30,元大-大天母,2024-06-06,9893
6163,華電網,34,4,30,元大-大天母,2024-06-06,9893
6550,北極星藥業-KY,33,3,30,元大-大天母,2024-06-06,9893
3379,彬台,29,0,29,元大-大天母,2024-06-06,9893
1609,大亞,30,3,27,元大-大天母,2024-06-06,9893
2312,金寶,124,99,25,元大-大天母,2024-06-06,9893
00929,復華台灣科技優息,45,20,25,元大-大天母,2024-06-06,9893
6142,友勁,25,0,25,元大-大天母,2024-06-06,9893
5351,鈺創,25,1,24,元大-大天母,2024-06-06,9893
00885,富邦越南,30,6,24,元大-大天母,2024-06-06,9893
3231,緯創,28,5,23,元大-大天母,2024-06-06,9893
00918,大華優利高填息30,24,1,23,元大-大天母,2024-06-06,9893
0056,元大高股息,39,17,22,元大-大天母,2024-06-06,9893
1905,華紙,22,0,22,元大-大天母,2024-06-06,9893
00688L,國泰20年美債正2,21,0,21,元大-大天母,2024-06-06,9893
2301,光寶科,21,1,20,元大-大天母,2024-06-06,9893
2464,盟立,59,39,20,元大-大天母,2024-06-06,9893
2031,新光鋼,20,0,20,元大-大天母,2024-06-06,9893
5340,建榮,23,4,19,元大-大天母,2024-06-06,9893
6230,尼得科超眾,21,2,19,元大-大天母,2024-06-06,9893
1563,巧新,20,1,19,元大-大天母,2024-06-06,9893
1909,榮成,18,0,18,元大-大天母,2024-06-06,9893
3706,神達,24,6,18,元大-大天母,2024-06-06,9893
2888,新光金,648,128,520,元大-大天母,2024-06-07,9893
00936,台新永續高息中小,257,40,217,元大-大天母,2024-06-07,9893
9934,成霖,160,0,160,元大-大天母,2024-06-07,9893
9910,豐泰,150,11,139,元大-大天母,2024-06-07,9893
1712,興農,100,2,98,元大-大天母,2024-06-07,9893
2501,國建,135,55,80,元大-大天母,2024-06-07,9893
00637L,元大滬深300正2,74,0,74,元大-大天母,2024-06-07,9893
2330,台積電,82,14,68,元大-大天母,2024-06-07,9893
1612,宏泰,71,3,68,元大-大天母,2024-06-07,9893
3231,緯創,72,4,68,元大-大天母,2024-06-07,9893
3376,新日興,104,50,54,元大-大天母,2024-06-07,9893
2486,一詮,90,45,45,元大-大天母,2024-06-07,9893
2331,精英,45,3,42,元大-大天母,2024-06-07,9893
2609,陽明,198,161,37,元大-大天母,2024-06-07,9893
3481,群創,41,6,35,元大-大天母,2024-06-07,9893
5432,新門,31,1,30,元大-大天母,2024-06-07,9893
3379,彬台,29,0,29,元大-大天母,2024-06-07,9893
9105,泰金寶-DR,56,28,28,元大-大天母,2024-06-07,9893
2353,宏��,57,32,25,元大-大天母,2024-06-07,9893
8040,九暘,25,0,25,元大-大天母,2024-06-07,9893
3122,笙泉,39,15,24,元大-大天母,2024-06-07,9893
2610,華航,51,28,23,元大-大天母,2024-06-07,9893
2301,光寶科,22,2,20,元大-大天母,2024-06-07,9893
006206,元大上證50,20,0,20,元大-大天母,2024-06-07,9893
2885,元大金,21,1,20,元大-大天母,2024-06-07,9893
3062,建漢,20,0,20,元大-大天母,2024-06-07,9893
3706,神達,22,3,19,元大-大天母,2024-06-07,9893
2313,華通,31,12,19,元大-大天母,2024-06-07,9893
6215,和椿,25,6,19,元大-大天母,2024-06-07,9893
2367,燿華,33,15,18,元大-大天母,2024-06-07,9893
3105,穩懋,18,1,17,元大-大天母,2024-06-07,9893
00680L,元大美債20正2,17,0,17,元大-大天母,2024-06-07,9893
4967,十銓,20,3,17,元大-大天母,2024-06-07,9893
2317,鴻海,33,16,17,元大-大天母,2024-06-07,9893
4906,正文,22,6,16,元大-大天母,2024-06-07,9893
00712,復華富時不動產,16,0,16,元大-大天母,2024-06-07,9893
2344,華邦電,42,27,15,元大-大天母,2024-06-07,9893
3048,益登,20,5,15,元大-大天母,2024-06-07,9893
6168,宏齊,25,10,15,元大-大天母,2024-06-07,9893
8358,金居,19,4,15,元大-大天母,2024-06-07,9893
2351,順德,15,1,14,元大-大天母,2024-06-07,9893
2357,華碩,17,4,13,元大-大天母,2024-06-07,9893
3017,奇鋐,31,18,13,元大-大天母,2024-06-07,9893
2354,鴻準,44,31,13,元大-大天母,2024-06-07,9893
2882,國泰金,76,63,13,元大-大天母,2024-06-07,9893
2312,金寶,123,110,13,元大-大天母,2024-06-07,9893
2329,華泰,29,17,12,元大-大天母,2024-06-07,9893
2009,第一銅,16,4,12,元大-大天母,2024-06-07,9893
4915,致伸,14,2,12,元大-大天母,2024-06-07,9893
1522,堤維西,24,12,12,元大-大天母,2024-06-07,9893
00937B,群益ESG投等債20,498,35,463,元大-大天母,2024-06-11,9893
2889,國票金,1041,735,306,元大-大天母,2024-06-11,9893
2603,長榮,297,28,269,元大-大天母,2024-06-11,9893
00936,台新永續高息中小,227,0,227,元大-大天母,2024-06-11,9893
00918,大華優利高填息30,210,0,210,元大-大天母,2024-06-11,9893
00637L,元大滬深300正2,211,3,208,元大-大天母,2024-06-11,9893
00929,復華台灣科技優息,136,0,136,元大-大天母,2024-06-11,9893
2486,一詮,148,37,111,元大-大天母,2024-06-11,9893
2105,正新,103,1,102,元大-大天母,2024-06-11,9893
00878,國泰永續高股息,92,4,88,元大-大天母,2024-06-11,9893
00919,群益台灣精選高息,101,19,82,元大-大天母,2024-06-11,9893
00679B,元大美債20年,77,2,75,元大-大天母,2024-06-11,9893
00942B,台新美A公司債20+,71,0,71,元大-大天母,2024-06-11,9893
00921,兆豐龍頭等權重,71,0,71,元大-大天母,2024-06-11,9893
2886,兆豐金,74,9,65,元大-大天母,2024-06-11,9893
00933B,國泰10Y+金融債,60,2,58,元大-大天母,2024-06-11,9893
00935,野村臺灣新科技50,56,0,56,元大-大天母,2024-06-11,9893
00687B,國泰20年美債,61,7,54,元大-大天母,2024-06-11,9893
1714,和桐,50,2,48,元大-大天母,2024-06-11,9893
2615,萬海,211,166,45,元大-大天母,2024-06-11,9893
2303,聯電,56,11,45,元大-大天母,2024-06-11,9893
00881,國泰台灣5G+,46,1,45,元大-大天母,2024-06-11,9893
2002,中鋼,46,3,43,元大-大天母,2024-06-11,9893
2609,陽明,437,397,40,元大-大天母,2024-06-11,9893
3047,訊舟,56,19,37,元大-大天母,2024-06-11,9893
2014,中鴻,33,0,33,元大-大天母,2024-06-11,9893
2812,台中銀,32,0,32,元大-大天母,2024-06-11,9893
00673R,期元大S＆P原油反1,32,0,32,元大-大天母,2024-06-11,9893
00795B,中信美國公債20年,32,0,32,元大-大天母,2024-06-11,9893
1563,巧新,32,0,32,元大-大天母,2024-06-11,9893
2323,中環,30,0,30,元大-大天母,2024-06-11,9893
6026,福邦證,30,0,30,元大-大天母,2024-06-11,9893
2031,新光鋼,30,1,29,元大-大天母,2024-06-11,9893
00680L,元大美債20正2,28,0,28,元大-大天母,2024-06-11,9893
8358,金居,31,3,28,元大-大天母,2024-06-11,9893
2611,志信,44,16,28,元大-大天母,2024-06-11,9893
3379,彬台,26,0,26,元大-大天母,2024-06-11,9893
1316,上曜,200,174,26,元大-大天母,2024-06-11,9893
2485,兆赫,26,0,26,元大-大天母,2024-06-11,9893
2476,鉅祥,26,1,25,元大-大天母,2024-06-11,9893
8163,達方,25,1,24,元大-大天母,2024-06-11,9893
00751B,元大AAA至A公司債,24,0,24,元大-大天母,2024-06-11,9893
1603,華電,29,6,23,元大-大天母,2024-06-11,9893
1608,華榮,61,38,23,元大-大天母,2024-06-11,9893
2324,仁寶,27,4,23,元大-大天母,2024-06-11,9893
9907,統一實,23,0,23,元大-大天母,2024-06-11,9893
2888,新光金,31,8,23,元大-大天母,2024-06-11,9893
2356,英業達,40,19,21,元大-大天母,2024-06-11,9893
2344,華邦電,21,0,21,元大-大天母,2024-06-11,9893
2329,華泰,23,2,21,元大-大天母,2024-06-11,9893
2883,凱基金,336,161,175,元大-大天母,2024-06-12,9893
6213,聯茂,163,16,147,元大-大天母,2024-06-12,9893
2889,國票金,281,141,140,元大-大天母,2024-06-12,9893
2303,聯電,113,4,109,元大-大天母,2024-06-12,9893
00947,台新臺灣IC設計,109,0,109,元大-大天母,2024-06-12,9893
2610,華航,178,73,105,元大-大天母,2024-06-12,9893
6706,惠特,108,10,98,元大-大天母,2024-06-12,9893
3163,波若威,100,4,96,元大-大天母,2024-06-12,9893
00679B,元大美債20年,101,11,90,元大-大天母,2024-06-12,9893
2888,新光金,162,79,83,元大-大天母,2024-06-12,9893
00929,復華台灣科技優息,76,4,72,元大-大天母,2024-06-12,9893
3481,群創,100,35,65,元大-大天母,2024-06-12,9893
6164,華興,61,2,59,元大-大天母,2024-06-12,9893
2603,長榮,94,41,53,元大-大天母,2024-06-12,9893
3231,緯創,65,12,53,元大-大天母,2024-06-12,9893
00772B,中信高評級公司債,51,0,51,元大-大天母,2024-06-12,9893
00948B,中信優息投資級債,47,0,47,元大-大天母,2024-06-12,9893
3033,威健,44,0,44,元大-大天母,2024-06-12,9893
00919,群益台灣精選高息,45,3,42,元大-大天母,2024-06-12,9893
4906,正文,52,13,39,元大-大天母,2024-06-12,9893
00632R,元大台灣50反1,35,0,35,元大-大天母,2024-06-12,9893
00878,國泰永續高股息,45,11,34,元大-大天母,2024-06-12,9893
2031,新光鋼,33,0,33,元大-大天母,2024-06-12,9893
1532,勤美,31,1,30,元大-大天母,2024-06-12,9893
00673R,期元大S＆P原油反1,30,0,30,元大-大天母,2024-06-12,9893
9933,中鼎,30,0,30,元大-大天母,2024-06-12,9893
2723,美食-KY,29,0,29,元大-大天母,2024-06-12,9893
2515,中工,28,0,28,元大-大天母,2024-06-12,9893
8110,華東,28,1,27,元大-大天母,2024-06-12,9893
6005,群益證,27,1,26,元大-大天母,2024-06-12,9893
2385,群光,25,0,25,元大-大天母,2024-06-12,9893
2882,國泰金,42,17,25,元大-大天母,2024-06-12,9893
2486,一詮,45,21,24,元大-大天母,2024-06-12,9893
2547,日勝生,24,0,24,元大-大天母,2024-06-12,9893
6890,來億-KY,27,4,23,元大-大天母,2024-06-12,9893
4967,十銓,38,15,23,元大-大天母,2024-06-12,9893
1718,中纖,22,0,22,元大-大天母,2024-06-12,9893
2353,宏��,30,9,21,元大-大天母,2024-06-12,9893
5493,三聯,20,0,20,元大-大天母,2024-06-12,9893
5469,瀚宇博,22,2,20,元大-大天母,2024-06-12,9893
3706,神達,20,0,20,元大-大天母,2024-06-12,9893
6180,橘子,25,5,20,元大-大天母,2024-06-12,9893
00676R,富邦臺灣加權反1,20,0,20,元大-大天母,2024-06-12,9893
00712,復華富時不動產,33,14,19,元大-大天母,2024-06-12,9893
2354,鴻準,24,6,18,元大-大天母,2024-06-12,9893
5534,長虹,18,0,18,元大-大天母,2024-06-12,9893
9945,潤泰新,21,3,18,元大-大天母,2024-06-12,9893
8028,昇陽半導體,32,14,18,元大-大天母,2024-06-12,9893
3450,聯鈞,21,4,17,元大-大天母,2024-06-12,9893
4123,晟德,28,11,17,元大-大天母,2024-06-12,9893
00919,群益台灣精選高息,541,69,472,元大-大天母,2024-06-13,9893
2889,國票金,240,0,240,元大-大天母,2024-06-13,9893
2888,新光金,279,63,216,元大-大天母,2024-06-13,9893
9934,成霖,180,34,146,元大-大天母,2024-06-13,9893
00946,群益科技高息成長,137,0,137,元大-大天母,2024-06-13,9893
1784,訊聯,119,2,117,元大-大天母,2024-06-13,9893
2449,京元電子,106,12,94,元大-大天母,2024-06-13,9893
2618,長榮航,107,15,92,元大-大天母,2024-06-13,9893
00719B,元大美債1-3,80,0,80,元大-大天母,2024-06-13,9893
2476,鉅祥,136,70,66,元大-大天母,2024-06-13,9893
6164,華興,96,37,59,元大-大天母,2024-06-13,9893
2603,長榮,80,25,55,元大-大天母,2024-06-13,9893
2834,臺企銀,53,0,53,元大-大天母,2024-06-13,9893
2211,長榮鋼,52,0,52,元大-大天母,2024-06-13,9893
5534,長虹,51,0,51,元大-大天母,2024-06-13,9893
00679B,元大美債20年,55,10,45,元大-大天母,2024-06-13,9893
00948B,中信優息投資級債,44,0,44,元大-大天母,2024-06-13,9893
00936,台新永續高息中小,49,11,38,元大-大天母,2024-06-13,9893
00918,大華優利高填息30,38,1,37,元大-大天母,2024-06-13,9893
1815,富喬,87,51,36,元大-大天母,2024-06-13,9893
00927,群益半導體收益,36,1,35,元大-大天母,2024-06-13,9893
2002,中鋼,36,2,34,元大-大天母,2024-06-13,9893
00676R,富邦臺灣加權反1,30,0,30,元大-大天母,2024-06-13,9893
3013,晟銘電,28,3,25,元大-大天母,2024-06-13,9893
2606,裕民,30,6,24,元大-大天母,2024-06-13,9893
6126,信音,30,6,24,元大-大天母,2024-06-13,9893
8103,瀚荃,26,3,23,元大-大天母,2024-06-13,9893
2359,所羅門,166,144,22,元大-大天母,2024-06-13,9893
3037,欣興,25,3,22,元大-大天母,2024-06-13,9893
5302,太欣,22,0,22,元大-大天母,2024-06-13,9893
6188,廣明,23,2,21,元大-大天母,2024-06-13,9893
6789,采鈺,28,7,21,元大-大天母,2024-06-13,9893
3484,崧騰,22,1,21,元大-大天母,2024-06-13,9893
3055,蔚華科,22,1,21,元大-大天母,2024-06-13,9893
2353,宏��,31,10,21,元大-大天母,2024-06-13,9893
6176,瑞儀,20,0,20,元大-大天母,2024-06-13,9893
8110,華東,22,2,20,元大-大天母,2024-06-13,9893
1522,堤維西,22,2,20,元大-大天母,2024-06-13,9893
2467,志聖,20,0,20,元大-大天母,2024-06-13,9893
5355,佳總,20,0,20,元大-大天母,2024-06-13,9893
00947,台新臺灣IC設計,21,2,19,元大-大天母,2024-06-13,9893
2329,華泰,20,1,19,元大-大天母,2024-06-13,9893
8028,昇陽半導體,94,77,17,元大-大天母,2024-06-13,9893
8358,金居,20,3,17,元大-大天母,2024-06-13,9893
00923,群益台ESG低碳50,17,0,17,元大-大天母,2024-06-13,9893
6806,森崴能源,16,0,16,元大-大天母,2024-06-13,9893
00929,復華台灣科技優息,93,78,15,元大-大天母,2024-06-13,9893
00915,凱基優選高股息30,19,4,15,元大-大天母,2024-06-13,9893
6890,來億-KY,15,1,14,元大-大天母,2024-06-13,9893
2610,華航,19,5,14,元大-大天母,2024-06-13,9893
5398,慕康生醫,470,37,433,元大-大天母,2024-06-14,9893
2615,萬海,329,51,278,元大-大天母,2024-06-14,9893
00919,群益台灣精選高息,171,10,161,元大-大天母,2024-06-14,9893
2312,金寶,163,24,139,元大-大天母,2024-06-14,9893
00936,台新永續高息中小,137,16,121,元大-大天母,2024-06-14,9893
2889,國票金,102,0,102,元大-大天母,2024-06-14,9893
2303,聯電,78,6,72,元大-大天母,2024-06-14,9893
2887,台新金,101,34,67,元大-大天母,2024-06-14,9893
2241,艾姆勒,65,2,63,元大-大天母,2024-06-14,9893
2371,大同,80,29,51,元大-大天母,2024-06-14,9893
2211,長榮鋼,50,0,50,元大-大天母,2024-06-14,9893
2486,一詮,66,17,49,元大-大天母,2024-06-14,9893
00935,野村臺灣新科技50,56,10,46,元大-大天母,2024-06-14,9893
2886,兆豐金,51,9,42,元大-大天母,2024-06-14,9893
3086,華義,42,0,42,元大-大天母,2024-06-14,9893
1532,勤美,50,10,40,元大-大天母,2024-06-14,9893
00680L,元大美債20正2,35,0,35,元大-大天母,2024-06-14,9893
00878,國泰永續高股息,36,3,33,元大-大天母,2024-06-14,9893
2888,新光金,36,3,33,元大-大天母,2024-06-14,9893
3048,益登,99,69,30,元大-大天母,2024-06-14,9893
1101,台泥,46,17,29,元大-大天母,2024-06-14,9893
2356,英業達,31,5,26,元大-大天母,2024-06-14,9893
00632R,元大台灣50反1,25,0,25,元大-大天母,2024-06-14,9893
2367,燿華,35,10,25,元大-大天母,2024-06-14,9893
2882,國泰金,40,16,24,元大-大天母,2024-06-14,9893
5426,振發,23,0,23,元大-大天母,2024-06-14,9893
6719,力智,21,0,21,元大-大天母,2024-06-14,9893
2809,京城銀,21,0,21,元大-大天母,2024-06-14,9893
4919,新唐,20,0,20,元大-大天母,2024-06-14,9893
6121,新普,20,0,20,元大-大天母,2024-06-14,9893
2015,豐興,20,0,20,元大-大天母,2024-06-14,9893
3715,定穎投控,19,0,19,元大-大天母,2024-06-14,9893
00687B,國泰20年美債,20,2,18,元大-大天母,2024-06-14,9893
2002,中鋼,17,0,17,元大-大天母,2024-06-14,9893
00947,台新臺灣IC設計,16,0,16,元大-大天母,2024-06-14,9893
3037,欣興,16,0,16,元大-大天母,2024-06-14,9893
3178,公準,20,4,16,元大-大天母,2024-06-14,9893
5876,上海商銀,16,0,16,元大-大天母,2024-06-14,9893
00713,元大台灣高息低波,16,1,15,元大-大天母,2024-06-14,9893
1815,富喬,20,6,14,元大-大天母,2024-06-14,9893
2376,技嘉,19,5,14,元大-大天母,2024-06-14,9893
4956,光鋐,16,2,14,元大-大天母,2024-06-14,9893
2354,鴻準,15,1,14,元大-大天母,2024-06-14,9893
2885,元大金,14,0,14,元大-大天母,2024-06-14,9893
2353,宏��,16,3,13,元大-大天母,2024-06-14,9893
2014,中鴻,13,0,13,元大-大天母,2024-06-14,9893
00664R,國泰臺灣加權反1,13,0,13,元大-大天母,2024-06-14,9893
0050,元大台灣50,15,2,13,元大-大天母,2024-06-14,9893
2618,長榮航,45,33,12,元大-大天母,2024-06-14,9893
9945,潤泰新,18,6,12,元大-大天母,2024-06-14,9893
2449,京元電子,225,31,194,元大-大天母,2024-06-17,9893
2889,國票金,151,3,148,元大-大天母,2024-06-17,9893
00929,復華台灣科技優息,163,26,137,元大-大天母,2024-06-17,9893
1611,中電,101,2,99,元大-大天母,2024-06-17,9893
2303,聯電,125,37,88,元大-大天母,2024-06-17,9893
00918,大華優利高填息30,97,13,84,元大-大天母,2024-06-17,9893
00937B,群益ESG投等債20,76,0,76,元大-大天母,2024-06-17,9893
2486,一詮,99,46,53,元大-大天母,2024-06-17,9893
00753L,中信中國50正2,50,0,50,元大-大天母,2024-06-17,9893
2368,金像電,43,0,43,元大-大天母,2024-06-17,9893
8358,金居,47,6,41,元大-大天母,2024-06-17,9893
00942B,台新美A公司債20+,41,0,41,元大-大天母,2024-06-17,9893
00948B,中信優息投資級債,40,0,40,元大-大天母,2024-06-17,9893
6166,凌華,41,3,38,元大-大天母,2024-06-17,9893
4534,慶騰,38,4,34,元大-大天母,2024-06-17,9893
00936,台新永續高息中小,65,33,32,元大-大天母,2024-06-17,9893
8049,晶采,31,0,31,元大-大天母,2024-06-17,9893
1434,福懋,30,0,30,元大-大天母,2024-06-17,9893
00944,野村趨勢動能高息,27,0,27,元大-大天母,2024-06-17,9893
3033,威健,26,0,26,元大-大天母,2024-06-17,9893
2376,技嘉,25,1,24,元大-大天母,2024-06-17,9893
3231,緯創,46,24,22,元大-大天母,2024-06-17,9893
6176,瑞儀,22,0,22,元大-大天母,2024-06-17,9893
2545,皇翔,22,0,22,元大-大天母,2024-06-17,9893
2885,元大金,30,8,22,元大-大天母,2024-06-17,9893
2606,裕民,23,2,21,元大-大天母,2024-06-17,9893
2618,長榮航,55,35,20,元大-大天母,2024-06-17,9893
2356,英業達,26,6,20,元大-大天母,2024-06-17,9893
1563,巧新,20,0,20,元大-大天母,2024-06-17,9893
3622,洋華,29,9,20,元大-大天母,2024-06-17,9893
1503,士電,45,25,20,元大-大天母,2024-06-17,9893
2515,中工,21,2,19,元大-大天母,2024-06-17,9893
2615,萬海,71,52,19,元大-大天母,2024-06-17,9893
00946,群益科技高息成長,19,2,17,元大-大天母,2024-06-17,9893
00679B,元大美債20年,18,1,17,元大-大天母,2024-06-17,9893
2002,中鋼,23,7,16,元大-大天母,2024-06-17,9893
2354,鴻準,21,5,16,元大-大天母,2024-06-17,9893
6770,力積電,104,88,16,元大-大天母,2024-06-17,9893
2603,長榮,46,30,16,元大-大天母,2024-06-17,9893
2317,鴻海,72,56,16,元大-大天母,2024-06-17,9893
00923,群益台ESG低碳50,15,0,15,元大-大天母,2024-06-17,9893
3706,神達,14,0,14,元大-大天母,2024-06-17,9893
1513,中興電,22,8,14,元大-大天母,2024-06-17,9893
2867,三商壽,13,0,13,元大-大天母,2024-06-17,9893
4977,眾達-KY,13,0,13,元大-大天母,2024-06-17,9893
2049,上銀,13,0,13,元大-大天母,2024-06-17,9893
3312,弘憶股,14,2,12,元大-大天母,2024-06-17,9893
3048,益登,25,13,12,元大-大天母,2024-06-17,9893
3030,德律,15,3,12,元大-大天母,2024-06-17,9893
3324,雙鴻,17,5,12,元大-大天母,2024-06-17,9893
2885,元大金,314,32,282,元大-大天母,2024-06-18,9893
00936,台新永續高息中小,255,20,235,元大-大天母,2024-06-18,9893
00929,復華台灣科技優息,230,65,165,元大-大天母,2024-06-18,9893
2409,友達,163,2,161,元大-大天母,2024-06-18,9893
1447,力鵬,142,0,142,元大-大天母,2024-06-18,9893
2615,萬海,223,129,94,元大-大天母,2024-06-18,9893
00632R,元大台灣50反1,125,33,92,元大-大天母,2024-06-18,9893
1815,富喬,116,26,90,元大-大天母,2024-06-18,9893
00687B,國泰20年美債,93,5,88,元大-大天母,2024-06-18,9893
2353,宏��,64,2,62,元大-大天母,2024-06-18,9893
3305,昇貿,63,5,58,元大-大天母,2024-06-18,9893
2337,旺宏,53,1,52,元大-大天母,2024-06-18,9893
1101,台泥,51,6,45,元大-大天母,2024-06-18,9893
2388,威盛,42,0,42,元大-大天母,2024-06-18,9893
00673R,期元大S＆P原油反1,39,0,39,元大-大天母,2024-06-18,9893
4533,協易機,51,13,38,元大-大天母,2024-06-18,9893
2385,群光,38,1,37,元大-大天母,2024-06-18,9893
3483,力致,47,10,37,元大-大天母,2024-06-18,9893
6116,彩晶,37,0,37,元大-大天母,2024-06-18,9893
9105,泰金寶-DR,44,9,35,元大-大天母,2024-06-18,9893
8255,朋程,36,1,35,元大-大天母,2024-06-18,9893
2603,長榮,48,14,34,元大-大天母,2024-06-18,9893
1611,中電,47,13,34,元大-大天母,2024-06-18,9893
1608,華榮,38,5,33,元大-大天母,2024-06-18,9893
1504,東元,37,6,31,元大-大天母,2024-06-18,9893
00941,中信上游半導體,32,1,31,元大-大天母,2024-06-18,9893
2317,鴻海,69,39,30,元大-大天母,2024-06-18,9893
3324,雙鴻,33,3,30,元大-大天母,2024-06-18,9893
00636,國泰中國A50,30,0,30,元大-大天母,2024-06-18,9893
2371,大同,55,26,29,元大-大天母,2024-06-18,9893
3438,類比科,30,1,29,元大-大天母,2024-06-18,9893
3363,上詮,33,8,25,元大-大天母,2024-06-18,9893
3231,緯創,44,20,24,元大-大天母,2024-06-18,9893
8028,昇陽半導體,64,41,23,元大-大天母,2024-06-18,9893
2486,一詮,30,7,23,元大-大天母,2024-06-18,9893
6166,凌華,32,11,21,元大-大天母,2024-06-18,9893
5202,力新,21,0,21,元大-大天母,2024-06-18,9893
00939,統一台灣高息動能,22,1,21,元大-大天母,2024-06-18,9893
6176,瑞儀,24,3,21,元大-大天母,2024-06-18,9893
00915,凱基優選高股息30,20,0,20,元大-大天母,2024-06-18,9893
2723,美食-KY,19,0,19,元大-大天母,2024-06-18,9893
8096,擎亞,86,67,19,元大-大天母,2024-06-18,9893
8358,金居,25,6,19,元大-大天母,2024-06-18,9893
6282,康舒,74,56,18,元大-大天母,2024-06-18,9893
4566,時碩工業,63,45,18,元大-大天母,2024-06-18,9893
00713,元大台灣高息低波,20,3,17,元大-大天母,2024-06-18,9893
2354,鴻準,18,1,17,元大-大天母,2024-06-18,9893
3035,智原,24,7,17,元大-大天母,2024-06-18,9893
3312,弘憶股,23,7,16,元大-大天母,2024-06-18,9893
4906,正文,17,1,16,元大-大天母,2024-06-18,9893
3062,建漢,1068,64,1004,元大-大天母,2024-06-19,9893
00632R,元大台灣50反1,462,70,392,元大-大天母,2024-06-19,9893
2031,新光鋼,284,9,275,元大-大天母,2024-06-19,9893
00929,復華台灣科技優息,273,55,218,元大-大天母,2024-06-19,9893
2888,新光金,219,68,151,元大-大天母,2024-06-19,9893
8085,福華,145,15,130,元大-大天母,2024-06-19,9893
00673R,期元大S＆P原油反1,102,0,102,元大-大天母,2024-06-19,9893
2344,華邦電,127,37,90,元大-大天母,2024-06-19,9893
6168,宏齊,82,0,82,元大-大天母,2024-06-19,9893
2881,富邦金,78,8,70,元大-大天母,2024-06-19,9893
00676R,富邦臺灣加權反1,60,0,60,元大-大天母,2024-06-19,9893
00687B,國泰20年美債,60,2,58,元大-大天母,2024-06-19,9893
2408,南亞科,77,23,54,元大-大天母,2024-06-19,9893
5534,長虹,52,0,52,元大-大天母,2024-06-19,9893
00680L,元大美債20正2,52,1,51,元大-大天母,2024-06-19,9893
9105,泰金寶-DR,51,3,48,元大-大天母,2024-06-19,9893
6190,萬泰科,67,23,44,元大-大天母,2024-06-19,9893
6585,鼎基,50,13,37,元大-大天母,2024-06-19,9893
2882,國泰金,51,16,35,元大-大天母,2024-06-19,9893
00934,中信成長高股息,34,1,33,元大-大天母,2024-06-19,9893
2449,京元電子,186,155,31,元大-大天母,2024-06-19,9893
1101,台泥,44,14,30,元大-大天母,2024-06-19,9893
00933B,國泰10Y+金融債,30,0,30,元大-大天母,2024-06-19,9893
3438,類比科,60,30,30,元大-大天母,2024-06-19,9893
2883,凱基金,38,8,30,元大-大天母,2024-06-19,9893
00713,元大台灣高息低波,29,2,27,元大-大天母,2024-06-19,9893
2606,裕民,27,0,27,元大-大天母,2024-06-19,9893
6213,聯茂,37,10,27,元大-大天母,2024-06-19,9893
1785,光洋科,38,15,23,元大-大天母,2024-06-19,9893
4956,光鋐,25,3,22,元大-大天母,2024-06-19,9893
2301,光寶科,35,13,22,元大-大天母,2024-06-19,9893
4306,炎洲,22,1,21,元大-大天母,2024-06-19,9893
2409,友達,20,0,20,元大-大天母,2024-06-19,9893
6245,立端,20,0,20,元大-大天母,2024-06-19,9893
2440,太空梭,20,0,20,元大-大天母,2024-06-19,9893
6152,百一,20,0,20,元大-大天母,2024-06-19,9893
2241,艾姆勒,20,0,20,元大-大天母,2024-06-19,9893
2337,旺宏,20,0,20,元大-大天母,2024-06-19,9893
3149,正達,21,3,18,元大-大天母,2024-06-19,9893
2392,正崴,18,1,17,元大-大天母,2024-06-19,9893
4979,華星光,25,8,17,元大-大天母,2024-06-19,9893
4533,協易機,26,9,17,元大-大天母,2024-06-19,9893
00896,中信綠能及電動車,16,1,15,元大-大天母,2024-06-19,9893
00947,台新臺灣IC設計,14,0,14,元大-大天母,2024-06-19,9893
9945,潤泰新,30,16,14,元大-大天母,2024-06-19,9893
4967,十銓,19,5,14,元大-大天母,2024-06-19,9893
1707,葡萄王,13,0,13,元大-大天母,2024-06-19,9893
00664R,國泰臺灣加權反1,13,0,13,元大-大天母,2024-06-19,9893
5457,宣德,15,2,13,元大-大天母,2024-06-19,9893
3017,奇鋐,32,20,12,元大-大天母,2024-06-19,9893
1802,台玻,603,2,601,元大-大天母,2024-06-20,9893
2353,宏��,173,7,166,元大-大天母,2024-06-20,9893
2886,兆豐金,201,63,138,元大-大天母,2024-06-20,9893
00936,台新永續高息中小,125,1,124,元大-大天母,2024-06-20,9893
2883,凱基金,226,103,123,元大-大天母,2024-06-20,9893
00929,復華台灣科技優息,171,63,108,元大-大天母,2024-06-20,9893
4306,炎洲,91,0,91,元大-大天母,2024-06-20,9893
2363,矽統,109,37,72,元大-大天母,2024-06-20,9893
00632R,元大台灣50反1,71,0,71,元大-大天母,2024-06-20,9893
5014,建錩,65,0,65,元大-大天母,2024-06-20,9893
00918,大華優利高填息30,63,0,63,元大-大天母,2024-06-20,9893
3483,力致,142,89,53,元大-大天母,2024-06-20,9893
00687B,國泰20年美債,53,1,52,元大-大天母,2024-06-20,9893
2330,台積電,70,20,50,元大-大天母,2024-06-20,9893
00671R,富邦NASDAQ反1,50,0,50,元大-大天母,2024-06-20,9893
6245,立端,48,6,42,元大-大天母,2024-06-20,9893
8105,凌巨,48,7,41,元大-大天母,2024-06-20,9893
00947,台新臺灣IC設計,36,0,36,元大-大天母,2024-06-20,9893
00937B,群益ESG投等債20,58,23,35,元大-大天母,2024-06-20,9893
00673R,期元大S＆P原油反1,34,0,34,元大-大天母,2024-06-20,9893
00648R,元大S＆P500反1,30,0,30,元大-大天母,2024-06-20,9893
4714,永捷,30,0,30,元大-大天母,2024-06-20,9893
2618,長榮航,32,5,27,元大-大天母,2024-06-20,9893
9945,潤泰新,30,4,26,元大-大天母,2024-06-20,9893
8358,金居,35,9,26,元大-大天母,2024-06-20,9893
6168,宏齊,138,112,26,元大-大天母,2024-06-20,9893
00713,元大台灣高息低波,24,0,24,元大-大天母,2024-06-20,9893
00907,永豐優息存股,23,0,23,元大-大天母,2024-06-20,9893
3030,德律,20,0,20,元大-大天母,2024-06-20,9893
2376,技嘉,22,3,19,元大-大天母,2024-06-20,9893
2838,聯邦銀,20,1,19,元大-大天母,2024-06-20,9893
2337,旺宏,20,1,19,元大-大天母,2024-06-20,9893
6026,福邦證,17,0,17,元大-大天母,2024-06-20,9893
2545,皇翔,16,0,16,元大-大天母,2024-06-20,9893
4915,致伸,72,56,16,元大-大天母,2024-06-20,9893
2501,國建,15,0,15,元大-大天母,2024-06-20,9893
3591,艾笛森,16,1,15,元大-大天母,2024-06-20,9893
00927,群益半導體收益,16,1,15,元大-大天母,2024-06-20,9893
00948B,中信優息投資級債,15,0,15,元大-大天母,2024-06-20,9893
00751B,元大AAA至A公司債,15,0,15,元大-大天母,2024-06-20,9893
6175,立敦,14,0,14,元大-大天母,2024-06-20,9893
2440,太空梭,15,1,14,元大-大天母,2024-06-20,9893
2324,仁寶,24,10,14,元大-大天母,2024-06-20,9893
1301,台塑,19,5,14,元大-大天母,2024-06-20,9893
00923,群益台ESG低碳50,13,0,13,元大-大天母,2024-06-20,9893
00679B,元大美債20年,24,12,12,元大-大天母,2024-06-20,9893
00942B,台新美A公司債20+,12,0,12,元大-大天母,2024-06-20,9893
8085,福華,12,0,12,元大-大天母,2024-06-20,9893
2881,富邦金,37,25,12,元大-大天母,2024-06-20,9893
3264,欣銓,14,2,12,元大-大天母,2024-06-20,9893
3481,群創,2219,658,1561,元大-大天母,2024-06-21,9893
00937B,群益ESG投等債20,394,19,375,元大-大天母,2024-06-21,9893
2885,元大金,219,54,165,元大-大天母,2024-06-21,9893
00933B,國泰10Y+金融債,146,0,146,元大-大天母,2024-06-21,9893
6168,宏齊,504,376,128,元大-大天母,2024-06-21,9893
00792B,群益A級公司債,120,0,120,元大-大天母,2024-06-21,9893
00942B,台新美A公司債20+,118,0,118,元大-大天母,2024-06-21,9893
00936,台新永續高息中小,85,0,85,元大-大天母,2024-06-21,9893
2317,鴻海,173,89,84,元大-大天母,2024-06-21,9893
1802,台玻,79,2,77,元大-大天母,2024-06-21,9893
6449,鈺邦,75,3,72,元大-大天母,2024-06-21,9893
2610,華航,94,25,69,元大-大天母,2024-06-21,9893
5328,華容,53,0,53,元大-大天母,2024-06-21,9893
6245,立端,49,0,49,元大-大天母,2024-06-21,9893
2211,長榮鋼,46,0,46,元大-大天母,2024-06-21,9893
6005,群益證,48,6,42,元大-大天母,2024-06-21,9893
1903,士紙,39,0,39,元大-大天母,2024-06-21,9893
2376,技嘉,40,2,38,元大-大天母,2024-06-21,9893
3483,力致,49,11,38,元大-大天母,2024-06-21,9893
4768,晶呈科技,36,1,35,元大-大天母,2024-06-21,9893
2603,長榮,65,31,34,元大-大天母,2024-06-21,9893
1532,勤美,32,0,32,元大-大天母,2024-06-21,9893
5534,長虹,30,0,30,元大-大天母,2024-06-21,9893
00673R,期元大S＆P原油反1,30,0,30,元大-大天母,2024-06-21,9893
2349,錸德,34,5,29,元大-大天母,2024-06-21,9893
1609,大亞,31,2,29,元大-大天母,2024-06-21,9893
8011,台通,30,2,28,元大-大天母,2024-06-21,9893
2330,台積電,34,7,27,元大-大天母,2024-06-21,9893
2324,仁寶,37,12,25,元大-大天母,2024-06-21,9893
1611,中電,26,1,25,元大-大天母,2024-06-21,9893
00637L,元大滬深300正2,25,0,25,元大-大天母,2024-06-21,9893
2382,廣達,38,13,25,元大-大天母,2024-06-21,9893
2609,陽明,108,84,24,元大-大天母,2024-06-21,9893
00915,凱基優選高股息30,24,0,24,元大-大天母,2024-06-21,9893
3324,雙鴻,50,26,24,元大-大天母,2024-06-21,9893
2002,中鋼,24,1,23,元大-大天母,2024-06-21,9893
6531,愛普*,24,2,22,元大-大天母,2024-06-21,9893
6472,保瑞,23,1,22,元大-大天母,2024-06-21,9893
00882,中信中國高股息,21,0,21,元大-大天母,2024-06-21,9893
00905,FT臺灣Smart,21,0,21,元大-大天母,2024-06-21,9893
00764B,群益25年美債,21,0,21,元大-大天母,2024-06-21,9893
2412,中華電,26,5,21,元大-大天母,2024-06-21,9893
2312,金寶,36,16,20,元大-大天母,2024-06-21,9893
1414,東和,20,0,20,元大-大天母,2024-06-21,9893
2881,富邦金,21,2,19,元大-大天母,2024-06-21,9893
3556,禾瑞亞,19,0,19,元大-大天母,2024-06-21,9893
2353,宏��,32,14,18,元大-大天母,2024-06-21,9893
3305,昇貿,62,44,18,元大-大天母,2024-06-21,9893
2375,凱美,24,9,15,元大-大天母,2024-06-21,9893
0056,元大高股息,22,7,15,元大-大天母,2024-06-21,9893
00929,復華台灣科技優息,339,16,323,元大-大天母,2024-06-24,9893
00919,群益台灣精選高息,245,77,168,元大-大天母,2024-06-24,9893
00937B,群益ESG投等債20,153,1,152,元大-大天母,2024-06-24,9893
5469,瀚宇博,135,2,133,元大-大天母,2024-06-24,9893
2330,台積電,94,8,86,元大-大天母,2024-06-24,9893
3231,緯創,83,20,63,元大-大天母,2024-06-24,9893
6245,立端,63,0,63,元大-大天母,2024-06-24,9893
00679B,元大美債20年,61,1,60,元大-大天母,2024-06-24,9893
8085,福華,58,5,53,元大-大天母,2024-06-24,9893
2317,鴻海,72,20,52,元大-大天母,2024-06-24,9893
2344,華邦電,60,12,48,元大-大天母,2024-06-24,9893
6168,宏齊,48,0,48,元大-大天母,2024-06-24,9893
2609,陽明,67,22,45,元大-大天母,2024-06-24,9893
2504,國產,44,0,44,元大-大天母,2024-06-24,9893
2409,友達,53,10,43,元大-大天母,2024-06-24,9893
4526,東台,64,21,43,元大-大天母,2024-06-24,9893
00939,統一台灣高息動能,50,8,42,元大-大天母,2024-06-24,9893
00687B,國泰20年美債,42,0,42,元大-大天母,2024-06-24,9893
2439,美律,46,7,39,元大-大天母,2024-06-24,9893
4956,光鋐,55,17,38,元大-大天母,2024-06-24,9893
4306,炎洲,39,3,36,元大-大天母,2024-06-24,9893
3652,精聯,35,3,32,元大-大天母,2024-06-24,9893
6026,福邦證,31,0,31,元大-大天母,2024-06-24,9893
00918,大華優利高填息30,32,2,30,元大-大天母,2024-06-24,9893
2303,聯電,60,30,30,元大-大天母,2024-06-24,9893
1710,東聯,30,0,30,元大-大天母,2024-06-24,9893
00878,國泰永續高股息,34,4,30,元大-大天母,2024-06-24,9893
2489,瑞軒,29,0,29,元大-大天母,2024-06-24,9893
00680L,元大美債20正2,30,2,28,元大-大天母,2024-06-24,9893
00891,中信關鍵半導體,28,0,28,元大-大天母,2024-06-24,9893
1802,台玻,27,0,27,元大-大天母,2024-06-24,9893
0056,元大高股息,28,1,27,元大-大天母,2024-06-24,9893
3583,辛耘,26,0,26,元大-大天母,2024-06-24,9893
8112,至上,37,11,26,元大-大天母,2024-06-24,9893
2440,太空梭,25,0,25,元大-大天母,2024-06-24,9893
2611,志信,25,1,24,元大-大天母,2024-06-24,9893
3030,德律,23,0,23,元大-大天母,2024-06-24,9893
3305,昇貿,26,3,23,元大-大天母,2024-06-24,9893
2385,群光,23,1,22,元大-大天母,2024-06-24,9893
1503,士電,33,11,22,元大-大天母,2024-06-24,9893
00936,台新永續高息中小,21,0,21,元大-大天母,2024-06-24,9893
3588,通嘉,21,0,21,元大-大天母,2024-06-24,9893
8358,金居,21,0,21,元大-大天母,2024-06-24,9893
4973,廣穎,21,0,21,元大-大天母,2024-06-24,9893
1718,中纖,21,0,21,元大-大天母,2024-06-24,9893
6770,力積電,25,5,20,元大-大天母,2024-06-24,9893
00719B,元大美債1-3,20,0,20,元大-大天母,2024-06-24,9893
2897,王道銀行,20,0,20,元大-大天母,2024-06-24,9893
2884,玉山金,25,5,20,元大-大天母,2024-06-24,9893
1319,東陽,20,0,20,元大-大天母,2024-06-24,9893
00632R,元大台灣50反1,1070,97,973,元大-大天母,2024-06-25,9893
3481,群創,695,27,668,元大-大天母,2024-06-25,9893
2303,聯電,184,32,152,元大-大天母,2024-06-25,9893
2889,國票金,140,2,138,元大-大天母,2024-06-25,9893
00929,復華台灣科技優息,138,2,136,元大-大天母,2024-06-25,9893
2885,元大金,154,32,122,元大-大天母,2024-06-25,9893
00911,兆豐洲際半導體,100,0,100,元大-大天母,2024-06-25,9893
00688L,國泰20年美債正2,100,1,99,元大-大天母,2024-06-25,9893
00919,群益台灣精選高息,159,60,99,元大-大天母,2024-06-25,9893
1815,富喬,89,6,83,元大-大天母,2024-06-25,9893
3708,上緯投控,51,0,51,元大-大天母,2024-06-25,9893
1718,中纖,50,0,50,元大-大天母,2024-06-25,9893
00936,台新永續高息中小,50,0,50,元大-大天母,2024-06-25,9893
1314,中石化,47,2,45,元大-大天母,2024-06-25,9893
2409,友達,41,1,40,元大-大天母,2024-06-25,9893
4306,炎洲,47,8,39,元大-大天母,2024-06-25,9893
00939,統一台灣高息動能,39,0,39,元大-大天母,2024-06-25,9893
2881,富邦金,50,12,38,元大-大天母,2024-06-25,9893
6168,宏齊,37,0,37,元大-大天母,2024-06-25,9893
2401,凌陽,46,11,35,元大-大天母,2024-06-25,9893
2002,中鋼,77,42,35,元大-大天母,2024-06-25,9893
2317,鴻海,70,39,31,元大-大天母,2024-06-25,9893
6245,立端,28,0,28,元大-大天母,2024-06-25,9893
3037,欣興,29,2,27,元大-大天母,2024-06-25,9893
1785,光洋科,67,41,26,元大-大天母,2024-06-25,9893
5493,三聯,25,0,25,元大-大天母,2024-06-25,9893
2618,長榮航,47,22,25,元大-大天母,2024-06-25,9893
2344,華邦電,29,5,24,元大-大天母,2024-06-25,9893
00680L,元大美債20正2,30,7,23,元大-大天母,2024-06-25,9893
3324,雙鴻,53,30,23,元大-大天母,2024-06-25,9893
00673R,期元大S＆P原油反1,23,0,23,元大-大天母,2024-06-25,9893
00675L,富邦臺灣加權正2,22,0,22,元大-大天母,2024-06-25,9893
8110,華東,37,15,22,元大-大天母,2024-06-25,9893
2208,台船,20,0,20,元大-大天母,2024-06-25,9893
00636,國泰中國A50,20,0,20,元大-大天母,2024-06-25,9893
00687B,國泰20年美債,20,0,20,元大-大天母,2024-06-25,9893
2880,華南金,20,1,19,元大-大天母,2024-06-25,9893
00923,群益台ESG低碳50,19,0,19,元大-大天母,2024-06-25,9893
4526,東台,34,17,17,元大-大天母,2024-06-25,9893
4956,光鋐,45,28,17,元大-大天母,2024-06-25,9893
3265,台星科,20,4,16,元大-大天母,2024-06-25,9893
3663,鑫科,19,3,16,元大-大天母,2024-06-25,9893
3231,緯創,60,44,16,元大-大天母,2024-06-25,9893
2406,國碩,18,3,15,元大-大天母,2024-06-25,9893
00947,台新臺灣IC設計,15,0,15,元大-大天母,2024-06-25,9893
2330,台積電,21,7,14,元大-大天母,2024-06-25,9893
2610,華航,22,8,14,元大-大天母,2024-06-25,9893
2352,佳世達,36,22,14,元大-大天母,2024-06-25,9893
1611,中電,15,2,13,元大-大天母,2024-06-25,9893
2888,新光金,25,13,12,元大-大天母,2024-06-25,9893
2885,元大金,724,8,716,元大-大天母,2024-06-26,9893
2889,國票金,302,1,301,元大-大天母,2024-06-26,9893
2887,台新金,170,0,170,元大-大天母,2024-06-26,9893
00751B,元大AAA至A公司債,165,0,165,元大-大天母,2024-06-26,9893
2002,中鋼,169,7,162,元大-大天母,2024-06-26,9893
00680L,元大美債20正2,182,60,122,元大-大天母,2024-06-26,9893
2883,凱基金,161,46,115,元大-大天母,2024-06-26,9893
1314,中石化,107,0,107,元大-大天母,2024-06-26,9893
2303,聯電,110,28,82,元大-大天母,2024-06-26,9893
00936,台新永續高息中小,78,0,78,元大-大天母,2024-06-26,9893
00919,群益台灣精選高息,86,23,63,元大-大天母,2024-06-26,9893
8466,美吉吉-KY,50,0,50,元大-大天母,2024-06-26,9893
2610,華航,53,7,46,元大-大天母,2024-06-26,9893
00878,國泰永續高股息,42,1,41,元大-大天母,2024-06-26,9893
2618,長榮航,54,15,39,元大-大天母,2024-06-26,9893
006208,富邦台50,39,0,39,元大-大天母,2024-06-26,9893
6111,大宇資,41,3,38,元大-大天母,2024-06-26,9893
5609,中菲行,35,0,35,元大-大天母,2024-06-26,9893
2349,錸德,43,9,34,元大-大天母,2024-06-26,9893
3231,緯創,60,26,34,元大-大天母,2024-06-26,9893
2486,一詮,59,26,33,元大-大天母,2024-06-26,9893
2514,龍邦,32,0,32,元大-大天母,2024-06-26,9893
9910,豐泰,30,0,30,元大-大天母,2024-06-26,9893
6156,松上,30,1,29,元大-大天母,2024-06-26,9893
3580,友威科,32,3,29,元大-大天母,2024-06-26,9893
2882,國泰金,53,25,28,元大-大天母,2024-06-26,9893
00687B,國泰20年美債,33,5,28,元大-大天母,2024-06-26,9893
00830,國泰費城半導體,29,2,27,元大-大天母,2024-06-26,9893
8112,至上,27,0,27,元大-大天母,2024-06-26,9893
2440,太空梭,25,0,25,元大-大天母,2024-06-26,9893
8085,福華,30,6,24,元大-大天母,2024-06-26,9893
9904,寶成,24,0,24,元大-大天母,2024-06-26,9893
8096,擎亞,27,4,23,元大-大天母,2024-06-26,9893
5498,凱崴,23,0,23,元大-大天母,2024-06-26,9893
00929,復華台灣科技優息,75,52,23,元大-大天母,2024-06-26,9893
3163,波若威,34,12,22,元大-大天母,2024-06-26,9893
2409,友達,34,13,21,元大-大天母,2024-06-26,9893
3264,欣銓,21,0,21,元大-大天母,2024-06-26,9893
1785,光洋科,26,5,21,元大-大天母,2024-06-26,9893
2301,光寶科,23,3,20,元大-大天母,2024-06-26,9893
00675L,富邦臺灣加權正2,20,0,20,元大-大天母,2024-06-26,9893
2892,第一金,19,0,19,元大-大天母,2024-06-26,9893
2884,玉山金,19,1,18,元大-大天母,2024-06-26,9893
2354,鴻準,37,19,18,元大-大天母,2024-06-26,9893
2317,鴻海,62,45,17,元大-大天母,2024-06-26,9893
00720B,元大投資級公司債,19,2,17,元大-大天母,2024-06-26,9893
00935,野村臺灣新科技50,20,3,17,元大-大天母,2024-06-26,9893
4123,晟德,16,0,16,元大-大天母,2024-06-26,9893
3665,貿聯-KY,18,2,16,元大-大天母,2024-06-26,9893
6643,M31,15,0,15,元大-大天母,2024-06-26,9893
00937B,群益ESG投等債20,342,0,342,元大-大天母,2024-06-27,9893
2303,聯電,222,15,207,元大-大天母,2024-06-27,9893
00751B,元大AAA至A公司債,167,0,167,元大-大天母,2024-06-27,9893
2603,長榮,183,27,156,元大-大天母,2024-06-27,9893
2885,元大金,216,76,140,元大-大天母,2024-06-27,9893
8099,大世科,113,13,100,元大-大天母,2024-06-27,9893
00929,復華台灣科技優息,83,2,81,元大-大天母,2024-06-27,9893
00679B,元大美債20年,84,3,81,元大-大天母,2024-06-27,9893
9904,寶成,67,0,67,元大-大天母,2024-06-27,9893
4938,和碩,63,2,61,元大-大天母,2024-06-27,9893
00919,群益台灣精選高息,79,25,54,元大-大天母,2024-06-27,9893
1314,中石化,61,10,51,元大-大天母,2024-06-27,9893
3149,正達,57,6,51,元大-大天母,2024-06-27,9893
4167,松瑞藥,110,60,50,元大-大天母,2024-06-27,9893
2889,國票金,41,2,39,元大-大天母,2024-06-27,9893
00933B,國泰10Y+金融債,35,0,35,元大-大天母,2024-06-27,9893
00687B,國泰20年美債,33,2,31,元大-大天母,2024-06-27,9893
2485,兆赫,31,1,30,元大-大天母,2024-06-27,9893
3205,佰研,30,0,30,元大-大天母,2024-06-27,9893
3563,牧德,30,0,30,元大-大天母,2024-06-27,9893
2883,凱基金,29,0,29,元大-大天母,2024-06-27,9893
3481,群創,38,9,29,元大-大天母,2024-06-27,9893
2882,國泰金,32,3,29,元大-大天母,2024-06-27,9893
1303,南亞,29,1,28,元大-大天母,2024-06-27,9893
00720B,元大投資級公司債,28,0,28,元大-大天母,2024-06-27,9893
0056,元大高股息,24,0,24,元大-大天母,2024-06-27,9893
3047,訊舟,72,48,24,元大-大天母,2024-06-27,9893
2906,高林,24,1,23,元大-大天母,2024-06-27,9893
1611,中電,23,0,23,元大-大天母,2024-06-27,9893
00795B,中信美國公債20年,23,0,23,元大-大天母,2024-06-27,9893
1709,和益,60,37,23,元大-大天母,2024-06-27,9893
1326,台化,23,1,22,元大-大天母,2024-06-27,9893
6176,瑞儀,21,0,21,元大-大天母,2024-06-27,9893
1101,台泥,29,8,21,元大-大天母,2024-06-27,9893
2888,新光金,21,0,21,元大-大天母,2024-06-27,9893
2515,中工,21,0,21,元大-大天母,2024-06-27,9893
5534,長虹,20,0,20,元大-大天母,2024-06-27,9893
00878,國泰永續高股息,19,1,18,元大-大天母,2024-06-27,9893
3712,永崴投控,32,14,18,元大-大天母,2024-06-27,9893
2606,裕民,39,22,17,元大-大天母,2024-06-27,9893
00948B,中信優息投資級債,17,0,17,元大-大天母,2024-06-27,9893
3037,欣興,17,1,16,元大-大天母,2024-06-27,9893
6015,宏遠證,16,0,16,元大-大天母,2024-06-27,9893
5871,中租-KY,22,6,16,元大-大天母,2024-06-27,9893
5603,陸海,15,0,15,元大-大天母,2024-06-27,9893
6282,康舒,15,1,14,元大-大天母,2024-06-27,9893
2892,第一金,16,2,14,元大-大天母,2024-06-27,9893
00830,國泰費城半導體,19,6,13,元大-大天母,2024-06-27,9893
6806,森崴能源,58,45,13,元大-大天母,2024-06-27,9893
3011,今皓,13,0,13,元大-大天母,2024-06-27,9893
2449,京元電子,308,5,303,元大-大天母,2024-06-28,9893
2313,華通,316,29,287,元大-大天母,2024-06-28,9893
2836,高雄銀,200,0,200,元大-大天母,2024-06-28,9893
8234,新漢,136,6,130,元大-大天母,2024-06-28,9893
2883,凱基金,199,72,127,元大-大天母,2024-06-28,9893
00673R,期元大S＆P原油反1,100,0,100,元大-大天母,2024-06-28,9893
6168,宏齊,95,0,95,元大-大天母,2024-06-28,9893
2610,華航,115,27,88,元大-大天母,2024-06-28,9893
00937B,群益ESG投等債20,72,12,60,元大-大天母,2024-06-28,9893
3376,新日興,65,7,58,元大-大天母,2024-06-28,9893
3057,喬鼎,56,0,56,元大-大天母,2024-06-28,9893
8103,瀚荃,54,0,54,元大-大天母,2024-06-28,9893
8076,伍豐,59,6,53,元大-大天母,2024-06-28,9893
3576,聯合再生,137,97,40,元大-大天母,2024-06-28,9893
1210,大成,40,0,40,元大-大天母,2024-06-28,9893
8096,擎亞,41,2,39,元大-大天母,2024-06-28,9893
3149,正達,49,15,34,元大-大天母,2024-06-28,9893
5534,長虹,33,0,33,元大-大天母,2024-06-28,9893
3481,群創,35,6,29,元大-大天母,2024-06-28,9893
3455,由田,31,2,29,元大-大天母,2024-06-28,9893
2337,旺宏,28,0,28,元大-大天母,2024-06-28,9893
2406,國碩,78,50,28,元大-大天母,2024-06-28,9893
1785,光洋科,32,7,25,元大-大天母,2024-06-28,9893
2201,裕隆,25,1,24,元大-大天母,2024-06-28,9893
2324,仁寶,22,0,22,元大-大天母,2024-06-28,9893
9904,寶成,22,0,22,元大-大天母,2024-06-28,9893
2349,錸德,29,7,22,元大-大天母,2024-06-28,9893
00632R,元大台灣50反1,21,0,21,元大-大天母,2024-06-28,9893
8277,商丞,22,1,21,元大-大天母,2024-06-28,9893
00911,兆豐洲際半導體,21,0,21,元大-大天母,2024-06-28,9893
00933B,國泰10Y+金融債,21,0,21,元大-大天母,2024-06-28,9893
8440,綠電,21,1,20,元大-大天母,2024-06-28,9893
2701,萬企,20,0,20,元大-大天母,2024-06-28,9893
2353,宏��,18,0,18,元大-大天母,2024-06-28,9893
2317,鴻海,74,57,17,元大-大天母,2024-06-28,9893
2609,陽明,41,24,17,元大-大天母,2024-06-28,9893
00679B,元大美債20年,22,5,17,元大-大天母,2024-06-28,9893
2354,鴻準,32,16,16,元大-大天母,2024-06-28,9893
2069,運錩,16,0,16,元大-大天母,2024-06-28,9893
00936,台新永續高息中小,16,1,15,元大-大天母,2024-06-28,9893
1303,南亞,15,0,15,元大-大天母,2024-06-28,9893
1103,嘉泥,14,0,14,元大-大天母,2024-06-28,9893
00720B,元大投資級公司債,13,0,13,元大-大天母,2024-06-28,9893
1434,福懋,13,0,13,元大-大天母,2024-06-28,9893
2706,第一店,17,4,13,元大-大天母,2024-06-28,9893
3338,泰碩,20,7,13,元大-大天母,2024-06-28,9893
4532,瑞智,15,2,13,元大-大天母,2024-06-28,9893
4938,和碩,14,2,12,元大-大天母,2024-06-28,9893
5371,中光電,18,6,12,元大-大天母,2024-06-28,9893
3005,神基,12,0,12,元大-大天母,2024-06-28,9893
00937B,群益ESG投等債20,287,50,237,元大-大天母,2024-07-01,9893
0056,元大高股息,229,16,213,元大-大天母,2024-07-01,9893
2836,高雄銀,790,580,210,元大-大天母,2024-07-01,9893
2313,華通,175,15,160,元大-大天母,2024-07-01,9893
00679B,元大美債20年,152,13,139,元大-大天母,2024-07-01,9893
6658,聯策,128,2,126,元大-大天母,2024-07-01,9893
2359,所羅門,138,15,123,元大-大天母,2024-07-01,9893
00687B,國泰20年美債,119,2,117,元大-大天母,2024-07-01,9893
00688L,國泰20年美債正2,107,0,107,元大-大天母,2024-07-01,9893
3694,海華,100,0,100,元大-大天母,2024-07-01,9893
3481,群創,77,2,75,元大-大天母,2024-07-01,9893
1783,和康生,72,0,72,元大-大天母,2024-07-01,9893
00795B,中信美國公債20年,68,0,68,元大-大天母,2024-07-01,9893
00720B,元大投資級公司債,63,0,63,元大-大天母,2024-07-01,9893
00933B,國泰10Y+金融債,60,0,60,元大-大天母,2024-07-01,9893
6168,宏齊,170,114,56,元大-大天母,2024-07-01,9893
00949,復華日本龍頭,54,0,54,元大-大天母,2024-07-01,9893
1714,和桐,50,0,50,元大-大天母,2024-07-01,9893
00680L,元大美債20正2,49,0,49,元大-大天母,2024-07-01,9893
3057,喬鼎,55,7,48,元大-大天母,2024-07-01,9893
00673R,期元大S＆P原油反1,45,0,45,元大-大天母,2024-07-01,9893
1309,台達化,42,0,42,元大-大天母,2024-07-01,9893
2615,萬海,65,23,42,元大-大天母,2024-07-01,9893
6217,中探針,40,1,39,元大-大天母,2024-07-01,9893
1101,台泥,44,5,39,元大-大天母,2024-07-01,9893
2409,友達,37,0,37,元大-大天母,2024-07-01,9893
00931B,統一美債20年,30,0,30,元大-大天母,2024-07-01,9893
5443,均豪,43,14,29,元大-大天母,2024-07-01,9893
9904,寶成,31,3,28,元大-大天母,2024-07-01,9893
00948B,中信優息投資級債,25,0,25,元大-大天母,2024-07-01,9893
2609,陽明,54,29,25,元大-大天母,2024-07-01,9893
2867,三商壽,25,2,23,元大-大天母,2024-07-01,9893
3498,陽程,23,0,23,元大-大天母,2024-07-01,9893
8926,台汽電,23,1,22,元大-大天母,2024-07-01,9893
4306,炎洲,22,0,22,元大-大天母,2024-07-01,9893
3520,華盈,21,1,20,元大-大天母,2024-07-01,9893
1785,光洋科,21,2,19,元大-大天母,2024-07-01,9893
2352,佳世達,20,1,19,元大-大天母,2024-07-01,9893
3338,泰碩,20,1,19,元大-大天母,2024-07-01,9893
3703,欣陸,18,0,18,元大-大天母,2024-07-01,9893
2880,華南金,17,0,17,元大-大天母,2024-07-01,9893
4566,時碩工業,29,12,17,元大-大天母,2024-07-01,9893
00751B,元大AAA至A公司債,16,0,16,元大-大天母,2024-07-01,9893
1301,台塑,17,1,16,元大-大天母,2024-07-01,9893
2892,第一金,16,0,16,元大-大天母,2024-07-01,9893
006208,富邦台50,15,0,15,元大-大天母,2024-07-01,9893
1476,儒鴻,15,0,15,元大-大天母,2024-07-01,9893
5392,能率,15,0,15,元大-大天母,2024-07-01,9893
2374,佳能,19,4,15,元大-大天母,2024-07-01,9893
3593,力銘,15,0,15,元大-大天母,2024-07-01,9893
2303,聯電,252,14,238,元大-大天母,2024-07-02,9893
00934,中信成長高股息,193,0,193,元大-大天母,2024-07-02,9893
0056,元大高股息,160,0,160,元大-大天母,2024-07-02,9893
2317,鴻海,161,26,135,元大-大天母,2024-07-02,9893
00679B,元大美債20年,125,2,123,元大-大天母,2024-07-02,9893
00680L,元大美債20正2,114,0,114,元大-大天母,2024-07-02,9893
00688L,國泰20年美債正2,106,0,106,元大-大天母,2024-07-02,9893
4306,炎洲,112,7,105,元大-大天母,2024-07-02,9893
00706L,期元大S＆P日圓正2,100,0,100,元大-大天母,2024-07-02,9893
6239,力成,97,1,96,元大-大天母,2024-07-02,9893
3711,日月光投控,95,0,95,元大-大天母,2024-07-02,9893
00929,復華台灣科技優息,174,86,88,元大-大天母,2024-07-02,9893
1710,東聯,80,0,80,元大-大天母,2024-07-02,9893
00687B,國泰20年美債,75,1,74,元大-大天母,2024-07-02,9893
3481,群創,94,22,72,元大-大天母,2024-07-02,9893
00795B,中信美國公債20年,70,0,70,元大-大天母,2024-07-02,9893
00936,台新永續高息中小,63,0,63,元大-大天母,2024-07-02,9893
5355,佳總,55,0,55,元大-大天母,2024-07-02,9893
00948B,中信優息投資級債,53,0,53,元大-大天母,2024-07-02,9893
2486,一詮,50,0,50,元大-大天母,2024-07-02,9893
2617,台航,50,4,46,元大-大天母,2024-07-02,9893
00673R,期元大S＆P原油反1,42,0,42,元大-大天母,2024-07-02,9893
00949,復華日本龍頭,41,0,41,元大-大天母,2024-07-02,9893
2356,英業達,33,0,33,元大-大天母,2024-07-02,9893
1326,台化,33,0,33,元大-大天母,2024-07-02,9893
2834,臺企銀,30,0,30,元大-大天母,2024-07-02,9893
00885,富邦越南,30,0,30,元大-大天母,2024-07-02,9893
3441,聯一光,30,0,30,元大-大天母,2024-07-02,9893
1314,中石化,49,20,29,元大-大天母,2024-07-02,9893
2836,高雄銀,30,2,28,元大-大天母,2024-07-02,9893
3149,正達,27,0,27,元大-大天母,2024-07-02,9893
4534,慶騰,35,8,27,元大-大天母,2024-07-02,9893
8112,至上,27,0,27,元大-大天母,2024-07-02,9893
00919,群益台灣精選高息,26,0,26,元大-大天母,2024-07-02,9893
00881,國泰台灣5G+,28,2,26,元大-大天母,2024-07-02,9893
3030,德律,25,0,25,元大-大天母,2024-07-02,9893
1476,儒鴻,24,0,24,元大-大天母,2024-07-02,9893
00751B,元大AAA至A公司債,23,0,23,元大-大天母,2024-07-02,9893
2402,毅嘉,50,27,23,元大-大天母,2024-07-02,9893
6213,聯茂,45,23,22,元大-大天母,2024-07-02,9893
8104,錸寶,26,4,22,元大-大天母,2024-07-02,9893
3105,穩懋,21,0,21,元大-大天母,2024-07-02,9893
2344,華邦電,33,12,21,元大-大天母,2024-07-02,9893
2892,第一金,21,1,20,元大-大天母,2024-07-02,9893
3625,西勝,19,0,19,元大-大天母,2024-07-02,9893
8076,伍豐,38,20,18,元大-大天母,2024-07-02,9893
1305,華夏,17,0,17,元大-大天母,2024-07-02,9893
3702,大聯大,19,3,16,元大-大天母,2024-07-02,9893
00937B,群益ESG投等債20,21,5,16,元大-大天母,2024-07-02,9893
2514,龍邦,16,0,16,元大-大天母,2024-07-02,9893
00934,中信成長高股息,585,20,565,元大-大天母,2024-07-03,9893
4510,高鋒,212,0,212,元大-大天母,2024-07-03,9893
2891,中信金,207,32,175,元大-大天母,2024-07-03,9893
5347,世界,177,3,174,元大-大天母,2024-07-03,9893
00929,復華台灣科技優息,169,31,138,元大-大天母,2024-07-03,9893
6443,元晶,144,18,126,元大-大天母,2024-07-03,9893
1710,東聯,120,0,120,元大-大天母,2024-07-03,9893
2836,高雄銀,540,440,100,元大-大天母,2024-07-03,9893
2615,萬海,131,32,99,元大-大天母,2024-07-03,9893
1903,士紙,79,0,79,元大-大天母,2024-07-03,9893
3576,聯合再生,265,188,77,元大-大天母,2024-07-03,9893
6789,采鈺,72,0,72,元大-大天母,2024-07-03,9893
00673R,期元大S＆P原油反1,62,0,62,元大-大天母,2024-07-03,9893
3049,精金,85,25,60,元大-大天母,2024-07-03,9893
00949,復華日本龍頭,56,0,56,元大-大天母,2024-07-03,9893
1215,卜蜂,54,0,54,元大-大天母,2024-07-03,9893
4722,國精化,41,0,41,元大-大天母,2024-07-03,9893
2351,順德,40,0,40,元大-大天母,2024-07-03,9893
3520,華盈,41,1,40,元大-大天母,2024-07-03,9893
3673,TPK-KY,49,11,38,元大-大天母,2024-07-03,9893
2317,鴻海,65,28,37,元大-大天母,2024-07-03,9893
2301,光寶科,34,3,31,元大-大天母,2024-07-03,9893
6282,康舒,56,28,28,元大-大天母,2024-07-03,9893
3591,艾笛森,34,6,28,元大-大天母,2024-07-03,9893
00679B,元大美債20年,26,0,26,元大-大天母,2024-07-03,9893
2402,毅嘉,58,32,26,元大-大天母,2024-07-03,9893
3376,新日興,29,3,26,元大-大天母,2024-07-03,9893
1795,美時,27,3,24,元大-大天母,2024-07-03,9893
00632R,元大台灣50反1,24,0,24,元大-大天母,2024-07-03,9893
4938,和碩,23,0,23,元大-大天母,2024-07-03,9893
2303,聯電,41,18,23,元大-大天母,2024-07-03,9893
2340,台亞,28,6,22,元大-大天母,2024-07-03,9893
2014,中鴻,22,0,22,元大-大天母,2024-07-03,9893
3005,神基,24,2,22,元大-大天母,2024-07-03,9893
3712,永崴投控,21,0,21,元大-大天母,2024-07-03,9893
2609,陽明,80,60,20,元大-大天母,2024-07-03,9893
3213,茂訊,20,0,20,元大-大天母,2024-07-03,9893
4167,松瑞藥,19,0,19,元大-大天母,2024-07-03,9893
1471,首利,20,1,19,元大-大天母,2024-07-03,9893
4123,晟德,22,4,18,元大-大天母,2024-07-03,9893
6244,茂迪,62,44,18,元大-大天母,2024-07-03,9893
1785,光洋科,45,28,17,元大-大天母,2024-07-03,9893
5474,聰泰,17,0,17,元大-大天母,2024-07-03,9893
4906,正文,36,20,16,元大-大天母,2024-07-03,9893
00680L,元大美債20正2,136,120,16,元大-大天母,2024-07-03,9893
2347,聯強,26,11,15,元大-大天母,2024-07-03,9893
2412,中華電,14,0,14,元大-大天母,2024-07-03,9893
5607,遠雄港,14,0,14,元大-大天母,2024-07-03,9893
00931B,統一美債20年,13,0,13,元大-大天母,2024-07-03,9893
6182,合晶,16,3,13,元大-大天母,2024-07-03,9893
00632R,元大台灣50反1,271,0,271,元大-大天母,2024-07-04,9893
2886,兆豐金,259,68,191,元大-大天母,2024-07-04,9893
2481,強茂,183,14,169,元大-大天母,2024-07-04,9893
00929,復華台灣科技優息,145,23,122,元大-大天母,2024-07-04,9893
2449,京元電子,115,9,106,元大-大天母,2024-07-04,9893
2312,金寶,139,36,103,元大-大天母,2024-07-04,9893
2412,中華電,100,0,100,元大-大天母,2024-07-04,9893
2618,長榮航,113,33,80,元大-大天母,2024-07-04,9893
2836,高雄銀,620,540,80,元大-大天母,2024-07-04,9893
00934,中信成長高股息,111,34,77,元大-大天母,2024-07-04,9893
9933,中鼎,80,6,74,元大-大天母,2024-07-04,9893
00673R,期元大S＆P原油反1,70,0,70,元大-大天母,2024-07-04,9893
3323,加百裕,135,75,60,元大-大天母,2024-07-04,9893
2606,裕民,64,7,57,元大-大天母,2024-07-04,9893
6278,台表科,56,3,53,元大-大天母,2024-07-04,9893
6282,康舒,54,3,51,元大-大天母,2024-07-04,9893
2867,三商壽,85,41,44,元大-大天母,2024-07-04,9893
3312,弘憶股,156,113,43,元大-大天母,2024-07-04,9893
2405,輔信,48,9,39,元大-大天母,2024-07-04,9893
0056,元大高股息,60,21,39,元大-大天母,2024-07-04,9893
2367,燿華,40,9,31,元大-大天母,2024-07-04,9893
6121,新普,30,0,30,元大-大天母,2024-07-04,9893
00949,復華日本龍頭,30,0,30,元大-大天母,2024-07-04,9893
6026,福邦證,30,1,29,元大-大天母,2024-07-04,9893
2609,陽明,60,34,26,元大-大天母,2024-07-04,9893
00933B,國泰10Y+金融債,26,0,26,元大-大天母,2024-07-04,9893
5347,世界,36,10,26,元大-大天母,2024-07-04,9893
6239,力成,26,1,25,元大-大天母,2024-07-04,9893
8163,達方,24,0,24,元大-大天母,2024-07-04,9893
2340,台亞,26,2,24,元大-大天母,2024-07-04,9893
3264,欣銓,23,0,23,元大-大天母,2024-07-04,9893
2332,友訊,25,2,23,元大-大天母,2024-07-04,9893
4109,加捷生醫,50,27,23,元大-大天母,2024-07-04,9893
2349,錸德,24,1,23,元大-大天母,2024-07-04,9893
00687B,國泰20年美債,25,2,23,元大-大天母,2024-07-04,9893
00725B,國泰投資級公司債,22,0,22,元大-大天母,2024-07-04,9893
00937B,群益ESG投等債20,21,0,21,元大-大天母,2024-07-04,9893
6770,力積電,22,1,21,元大-大天母,2024-07-04,9893
8416,實威,21,0,21,元大-大天母,2024-07-04,9893
1795,美時,23,2,21,元大-大天母,2024-07-04,9893
1215,卜蜂,20,0,20,元大-大天母,2024-07-04,9893
3035,智原,22,3,19,元大-大天母,2024-07-04,9893
3338,泰碩,19,2,17,元大-大天母,2024-07-04,9893
8112,至上,22,5,17,元大-大天母,2024-07-04,9893
9945,潤泰新,16,0,16,元大-大天母,2024-07-04,9893
2323,中環,36,20,16,元大-大天母,2024-07-04,9893
00919,群益台灣精選高息,20,5,15,元大-大天母,2024-07-04,9893
6807,峰源-KY,15,0,15,元大-大天母,2024-07-04,9893
6133,金橋,15,0,15,元大-大天母,2024-07-04,9893
00753L,中信中國50正2,15,0,15,元大-大天母,2024-07-04,9893
00637L,元大滬深300正2,1016,0,1016,元大-大天母,2024-07-05,9893
6213,聯茂,179,16,163,元大-大天母,2024-07-05,9893
1513,中興電,177,46,131,元大-大天母,2024-07-05,9893
8390,金益鼎,122,0,122,元大-大天母,2024-07-05,9893
00929,復華台灣科技優息,123,4,119,元大-大天母,2024-07-05,9893
00696B,富邦美債20年,113,0,113,元大-大天母,2024-07-05,9893
2618,長榮航,129,18,111,元大-大天母,2024-07-05,9893
2888,新光金,129,30,99,元大-大天母,2024-07-05,9893
6168,宏齊,458,391,67,元大-大天母,2024-07-05,9893
00934,中信成長高股息,66,0,66,元大-大天母,2024-07-05,9893
1714,和桐,60,1,59,元大-大天母,2024-07-05,9893
3149,正達,70,12,58,元大-大天母,2024-07-05,9893
2883,凱基金,112,55,57,元大-大天母,2024-07-05,9893
5328,華容,56,7,49,元大-大天母,2024-07-05,9893
1504,東元,55,10,45,元大-大天母,2024-07-05,9893
3520,華盈,44,3,41,元大-大天母,2024-07-05,9893
00673R,期元大S＆P原油反1,40,0,40,元大-大天母,2024-07-05,9893
2489,瑞軒,75,38,37,元大-大天母,2024-07-05,9893
2481,強茂,37,1,36,元大-大天母,2024-07-05,9893
2349,錸德,40,4,36,元大-大天母,2024-07-05,9893
2617,台航,35,1,34,元大-大天母,2024-07-05,9893
8112,至上,44,12,32,元大-大天母,2024-07-05,9893
6282,康舒,38,6,32,元大-大天母,2024-07-05,9893
2301,光寶科,33,2,31,元大-大天母,2024-07-05,9893
2337,旺宏,55,24,31,元大-大天母,2024-07-05,9893
5432,新門,31,0,31,元大-大天母,2024-07-05,9893
00725B,國泰投資級公司債,30,0,30,元大-大天母,2024-07-05,9893
00946,群益科技高息成長,30,0,30,元大-大天母,2024-07-05,9893
1455,集盛,30,0,30,元大-大天母,2024-07-05,9893
2312,金寶,32,4,28,元大-大天母,2024-07-05,9893
3689,湧德,29,2,27,元大-大天母,2024-07-05,9893
2241,艾姆勒,27,1,26,元大-大天母,2024-07-05,9893
2882,國泰金,29,3,26,元大-大天母,2024-07-05,9893
3062,建漢,28,2,26,元大-大天母,2024-07-05,9893
00720B,元大投資級公司債,26,1,25,元大-大天母,2024-07-05,9893
6770,力積電,40,15,25,元大-大天母,2024-07-05,9893
2367,燿華,209,184,25,元大-大天母,2024-07-05,9893
1503,士電,39,15,24,元大-大天母,2024-07-05,9893
0056,元大高股息,31,9,22,元大-大天母,2024-07-05,9893
6244,茂迪,27,5,22,元大-大天母,2024-07-05,9893
00919,群益台灣精選高息,27,5,22,元大-大天母,2024-07-05,9893
2891,中信金,25,3,22,元大-大天母,2024-07-05,9893
2610,華航,35,13,22,元大-大天母,2024-07-05,9893
2356,英業達,94,73,21,元大-大天母,2024-07-05,9893
1789,神隆,20,0,20,元大-大天母,2024-07-05,9893
3402,漢科,21,1,20,元大-大天母,2024-07-05,9893
6152,百一,20,1,19,元大-大天母,2024-07-05,9893
6126,信音,21,2,19,元大-大天母,2024-07-05,9893
2603,長榮,34,15,19,元大-大天母,2024-07-05,9893
6207,雷科,30,12,18,元大-大天母,2024-07-05,9893
00632R,元大台灣50反1,167,1,166,元大-大天母,2024-07-08,9893
8390,金益鼎,154,0,154,元大-大天母,2024-07-08,9893
6217,中探針,138,35,103,元大-大天母,2024-07-08,9893
2888,新光金,107,14,93,元大-大天母,2024-07-08,9893
6190,萬泰科,85,6,79,元大-大天母,2024-07-08,9893
2618,長榮航,119,41,78,元大-大天母,2024-07-08,9893
00650L,復華香港正2,70,0,70,元大-大天母,2024-07-08,9893
5328,華容,72,11,61,元大-大天母,2024-07-08,9893
2464,盟立,100,42,58,元大-大天母,2024-07-08,9893
3163,波若威,65,9,56,元大-大天母,2024-07-08,9893
3045,台灣大,53,0,53,元大-大天母,2024-07-08,9893
2834,臺企銀,52,0,52,元大-大天母,2024-07-08,9893
2886,兆豐金,51,0,51,元大-大天母,2024-07-08,9893
00719B,元大美債1-3,50,0,50,元大-大天母,2024-07-08,9893
00881,國泰台灣5G+,55,6,49,元大-大天母,2024-07-08,9893
00929,復華台灣科技優息,98,53,45,元大-大天母,2024-07-08,9893
5452,佶優,49,5,44,元大-大天母,2024-07-08,9893
1605,華新,47,5,42,元大-大天母,2024-07-08,9893
2915,潤泰全,46,6,40,元大-大天母,2024-07-08,9893
3673,TPK-KY,76,36,40,元大-大天母,2024-07-08,9893
3481,群創,72,33,39,元大-大天母,2024-07-08,9893
1903,士紙,38,0,38,元大-大天母,2024-07-08,9893
3712,永崴投控,38,0,38,元大-大天母,2024-07-08,9893
2352,佳世達,44,8,36,元大-大天母,2024-07-08,9893
00919,群益台灣精選高息,83,52,31,元大-大天母,2024-07-08,9893
2417,圓剛,51,21,30,元大-大天母,2024-07-08,9893
6168,宏齊,468,439,29,元大-大天母,2024-07-08,9893
2534,宏盛,27,0,27,元大-大天母,2024-07-08,9893
2002,中鋼,44,17,27,元大-大天母,2024-07-08,9893
3049,精金,36,10,26,元大-大天母,2024-07-08,9893
3379,彬台,27,1,26,元大-大天母,2024-07-08,9893
3580,友威科,26,0,26,元大-大天母,2024-07-08,9893
2412,中華電,24,0,24,元大-大天母,2024-07-08,9893
6691,洋基工程,24,0,24,元大-大天母,2024-07-08,9893
00713,元大台灣高息低波,24,0,24,元大-大天母,2024-07-08,9893
1785,光洋科,62,39,23,元大-大天母,2024-07-08,9893
1604,聲寶,21,0,21,元大-大天母,2024-07-08,9893
6226,光鼎,21,0,21,元大-大天母,2024-07-08,9893
6153,嘉聯益,34,13,21,元大-大天母,2024-07-08,9893
3105,穩懋,22,1,21,元大-大天母,2024-07-08,9893
9958,世紀鋼,20,0,20,元大-大天母,2024-07-08,9893
3032,偉訓,20,0,20,元大-大天母,2024-07-08,9893
4721,美琪瑪,21,1,20,元大-大天母,2024-07-08,9893
2353,宏��,19,0,19,元大-大天母,2024-07-08,9893
6133,金橋,22,3,19,元大-大天母,2024-07-08,9893
2467,志聖,19,1,18,元大-大天母,2024-07-08,9893
2408,南亞科,20,2,18,元大-大天母,2024-07-08,9893
00915,凱基優選高股息30,19,2,17,元大-大天母,2024-07-08,9893
2636,台驊控股,16,0,16,元大-大天母,2024-07-08,9893
1513,中興電,67,51,16,元大-大天母,2024-07-08,9893
2836,高雄銀,1028,730,298,元大-大天母,2024-07-09,9893
00934,中信成長高股息,185,4,181,元大-大天母,2024-07-09,9893
2886,兆豐金,154,1,153,元大-大天母,2024-07-09,9893
2464,盟立,152,51,101,元大-大天母,2024-07-09,9893
00946,群益科技高息成長,100,0,100,元大-大天母,2024-07-09,9893
00679B,元大美債20年,122,25,97,元大-大天母,2024-07-09,9893
2317,鴻海,157,64,93,元大-大天母,2024-07-09,9893
9933,中鼎,90,3,87,元大-大天母,2024-07-09,9893
3044,健鼎,87,1,86,元大-大天母,2024-07-09,9893
2367,燿華,280,196,84,元大-大天母,2024-07-09,9893
2890,永豐金,84,0,84,元大-大天母,2024-07-09,9893
4306,炎洲,87,8,79,元大-大天母,2024-07-09,9893
8071,能率網通,79,11,68,元大-大天母,2024-07-09,9893
6190,萬泰科,68,2,66,元大-大天母,2024-07-09,9893
5309,系統電,70,4,66,元大-大天母,2024-07-09,9893
8105,凌巨,106,43,63,元大-大天母,2024-07-09,9893
9105,泰金寶-DR,176,115,61,元大-大天母,2024-07-09,9893
2534,宏盛,61,0,61,元大-大天母,2024-07-09,9893
6005,群益證,59,1,58,元大-大天母,2024-07-09,9893
00719B,元大美債1-3,50,0,50,元大-大天母,2024-07-09,9893
3047,訊舟,94,45,49,元大-大天母,2024-07-09,9893
2353,宏��,51,5,46,元大-大天母,2024-07-09,9893
3050,鈺德,62,19,43,元大-大天母,2024-07-09,9893
5511,德昌,42,0,42,元大-大天母,2024-07-09,9893
1903,士紙,44,5,39,元大-大天母,2024-07-09,9893
2601,益航,35,0,35,元大-大天母,2024-07-09,9893
2492,華新科,34,0,34,元大-大天母,2024-07-09,9893
4960,誠美材,38,5,33,元大-大天母,2024-07-09,9893
2606,裕民,33,0,33,元大-大天母,2024-07-09,9893
0056,元大高股息,39,7,32,元大-大天母,2024-07-09,9893
00878,國泰永續高股息,31,0,31,元大-大天母,2024-07-09,9893
2323,中環,38,7,31,元大-大天母,2024-07-09,9893
6116,彩晶,31,0,31,元大-大天母,2024-07-09,9893
2867,三商壽,71,40,31,元大-大天母,2024-07-09,9893
00881,國泰台灣5G+,35,4,31,元大-大天母,2024-07-09,9893
1611,中電,30,0,30,元大-大天母,2024-07-09,9893
4716,大立,32,2,30,元大-大天母,2024-07-09,9893
2834,臺企銀,47,18,29,元大-大天母,2024-07-09,9893
3379,彬台,30,1,29,元大-大天母,2024-07-09,9893
5328,華容,113,84,29,元大-大天母,2024-07-09,9893
3231,緯創,54,28,26,元大-大天母,2024-07-09,9893
5469,瀚宇博,26,0,26,元大-大天母,2024-07-09,9893
3019,亞光,26,1,25,元大-大天母,2024-07-09,9893
00936,台新永續高息中小,24,0,24,元大-大天母,2024-07-09,9893
5347,世界,34,10,24,元大-大天母,2024-07-09,9893
1815,富喬,32,8,24,元大-大天母,2024-07-09,9893
2301,光寶科,23,0,23,元大-大天母,2024-07-09,9893
6168,宏齊,24,1,23,元大-大天母,2024-07-09,9893
3535,晶彩科,38,17,21,元大-大天母,2024-07-09,9893
00949,復華日本龍頭,21,0,21,元大-大天母,2024-07-09,9893
2365,昆盈,232,46,186,元大-大天母,2024-07-10,9893
00706L,期元大S＆P日圓正2,100,0,100,元大-大天母,2024-07-10,9893
2312,金寶,133,34,99,元大-大天母,2024-07-10,9893
3481,群創,95,12,83,元大-大天母,2024-07-10,9893
2890,永豐金,81,0,81,元大-大天母,2024-07-10,9893
4904,遠傳,81,1,80,元大-大天母,2024-07-10,9893
8937,合騏,75,0,75,元大-大天母,2024-07-10,9893
5512,力麒,73,0,73,元大-大天母,2024-07-10,9893
9933,中鼎,72,12,60,元大-大天母,2024-07-10,9893
8105,凌巨,118,62,56,元大-大天母,2024-07-10,9893
3057,喬鼎,48,0,48,元大-大天母,2024-07-10,9893
5876,上海商銀,52,7,45,元大-大天母,2024-07-10,9893
2481,強茂,42,1,41,元大-大天母,2024-07-10,9893
4510,高鋒,42,2,40,元大-大天母,2024-07-10,9893
2392,正崴,84,45,39,元大-大天母,2024-07-10,9893
1218,泰山,39,0,39,元大-大天母,2024-07-10,9893
2464,盟立,96,60,36,元大-大天母,2024-07-10,9893
2367,燿華,105,69,36,元大-大天母,2024-07-10,9893
3037,欣興,36,4,32,元大-大天母,2024-07-10,9893
00720B,元大投資級公司債,31,0,31,元大-大天母,2024-07-10,9893
5309,系統電,50,20,30,元大-大天母,2024-07-10,9893
00881,國泰台灣5G+,29,1,28,元大-大天母,2024-07-10,9893
3083,網龍,28,0,28,元大-大天母,2024-07-10,9893
00944,野村趨勢動能高息,27,0,27,元大-大天母,2024-07-10,9893
5398,慕康生醫,25,0,25,元大-大天母,2024-07-10,9893
3149,正達,35,11,24,元大-大天母,2024-07-10,9893
1514,亞力,69,45,24,元大-大天母,2024-07-10,9893
1809,中釉,29,6,23,元大-大天母,2024-07-10,9893
2618,長榮航,35,13,22,元大-大天母,2024-07-10,9893
00679B,元大美債20年,22,1,21,元大-大天母,2024-07-10,9893
1536,和大,278,257,21,元大-大天母,2024-07-10,9893
2892,第一金,29,9,20,元大-大天母,2024-07-10,9893
00919,群益台灣精選高息,21,1,20,元大-大天母,2024-07-10,9893
4716,大立,21,1,20,元大-大天母,2024-07-10,9893
00885,富邦越南,20,0,20,元大-大天母,2024-07-10,9893
2543,皇昌,33,14,19,元大-大天母,2024-07-10,9893
3438,類比科,20,1,19,元大-大天母,2024-07-10,9893
2353,宏��,61,43,18,元大-大天母,2024-07-10,9893
2317,鴻海,34,16,18,元大-大天母,2024-07-10,9893
1616,億泰,20,2,18,元大-大天母,2024-07-10,9893
3234,光環,23,5,18,元大-大天母,2024-07-10,9893
2344,華邦電,17,0,17,元大-大天母,2024-07-10,9893
6806,森崴能源,37,20,17,元大-大天母,2024-07-10,9893
2330,台積電,25,8,17,元大-大天母,2024-07-10,9893
1795,美時,18,2,16,元大-大天母,2024-07-10,9893
3594,磐儀,21,5,16,元大-大天母,2024-07-10,9893
5443,均豪,39,23,16,元大-大天母,2024-07-10,9893
1618,合機,25,9,16,元大-大天母,2024-07-10,9893
00905,FT臺灣Smart,16,0,16,元大-大天母,2024-07-10,9893
2885,元大金,19,4,15,元大-大天母,2024-07-10,9893
2836,高雄銀,380,2,378,元大-大天母,2024-07-11,9893
2889,國票金,152,7,145,元大-大天母,2024-07-11,9893
2882,國泰金,229,96,133,元大-大天母,2024-07-11,9893
2365,昆盈,384,256,128,元大-大天母,2024-07-11,9893
2886,兆豐金,113,6,107,元大-大天母,2024-07-11,9893
5498,凱崴,111,7,104,元大-大天母,2024-07-11,9893
1101,台泥,103,4,99,元大-大天母,2024-07-11,9893
1609,大亞,103,14,89,元大-大天母,2024-07-11,9893
6443,元晶,106,23,83,元大-大天母,2024-07-11,9893
8289,泰藝,76,0,76,元大-大天母,2024-07-11,9893
00720B,元大投資級公司債,75,0,75,元大-大天母,2024-07-11,9893
00633L,富邦上証正2,70,1,69,元大-大天母,2024-07-11,9893
2618,長榮航,88,20,68,元大-大天母,2024-07-11,9893
3231,緯創,75,18,57,元大-大天母,2024-07-11,9893
4510,高鋒,59,4,55,元大-大天母,2024-07-11,9893
00945B,凱基美國非投等債,50,0,50,元大-大天母,2024-07-11,9893
00929,復華台灣科技優息,54,5,49,元大-大天母,2024-07-11,9893
00950B,凱基A級公司債,40,0,40,元大-大天母,2024-07-11,9893
2867,三商壽,53,13,40,元大-大天母,2024-07-11,9893
00725B,國泰投資級公司債,40,0,40,元大-大天母,2024-07-11,9893
9933,中鼎,40,1,39,元大-大天母,2024-07-11,9893
2382,廣達,44,6,38,元大-大天母,2024-07-11,9893
8028,昇陽半導體,60,26,34,元大-大天母,2024-07-11,9893
6689,伊雲谷,35,1,34,元大-大天母,2024-07-11,9893
2316,楠梓電,36,2,34,元大-大天母,2024-07-11,9893
2317,鴻海,80,46,34,元大-大天母,2024-07-11,9893
6438,迅得,33,0,33,元大-大天母,2024-07-11,9893
1336,台翰,39,9,30,元大-大天母,2024-07-11,9893
00934,中信成長高股息,33,3,30,元大-大天母,2024-07-11,9893
6217,中探針,31,2,29,元大-大天母,2024-07-11,9893
00637L,元大滬深300正2,30,3,27,元大-大天母,2024-07-11,9893
00673R,期元大S＆P原油反1,27,0,27,元大-大天母,2024-07-11,9893
8021,尖點,39,12,27,元大-大天母,2024-07-11,9893
2354,鴻準,54,28,26,元大-大天母,2024-07-11,9893
1532,勤美,26,1,25,元大-大天母,2024-07-11,9893
6282,康舒,60,36,24,元大-大天母,2024-07-11,9893
2353,宏��,55,33,22,元大-大天母,2024-07-11,9893
3189,景碩,48,27,21,元大-大天母,2024-07-11,9893
1314,中石化,21,0,21,元大-大天母,2024-07-11,9893
6026,福邦證,52,32,20,元大-大天母,2024-07-11,9893
3017,奇鋐,25,5,20,元大-大天母,2024-07-11,9893
00726B,國泰新興投等債,20,0,20,元大-大天母,2024-07-11,9893
00665L,富邦�琤肭磪囓�2,20,0,20,元大-大天母,2024-07-11,9893
3011,今皓,20,0,20,元大-大天母,2024-07-11,9893
00753L,中信中國50正2,20,0,20,元大-大天母,2024-07-11,9893
3050,鈺德,49,29,20,元大-大天母,2024-07-11,9893
2548,華固,20,0,20,元大-大天母,2024-07-11,9893
3149,正達,61,42,19,元大-大天母,2024-07-11,9893
8937,合騏,19,0,19,元大-大天母,2024-07-11,9893
5452,佶優,59,40,19,元大-大天母,2024-07-11,9893
00633L,富邦上証正2,500,0,500,元大-大天母,2024-07-12,9893
00929,復華台灣科技優息,190,0,190,元大-大天母,2024-07-12,9893
00937B,群益ESG投等債20,217,27,190,元大-大天母,2024-07-12,9893
1314,中石化,188,0,188,元大-大天母,2024-07-12,9893
2312,金寶,293,111,182,元大-大天母,2024-07-12,9893
2317,鴻海,173,22,151,元大-大天母,2024-07-12,9893
2449,京元電子,149,4,145,元大-大天母,2024-07-12,9893
2867,三商壽,120,0,120,元大-大天母,2024-07-12,9893
00679B,元大美債20年,148,29,119,元大-大天母,2024-07-12,9893
2303,聯電,118,6,112,元大-大天母,2024-07-12,9893
00680L,元大美債20正2,110,0,110,元大-大天母,2024-07-12,9893
00719B,元大美債1-3,100,0,100,元大-大天母,2024-07-12,9893
2888,新光金,301,204,97,元大-大天母,2024-07-12,9893
00934,中信成長高股息,90,2,88,元大-大天母,2024-07-12,9893
3711,日月光投控,90,4,86,元大-大天母,2024-07-12,9893
3363,上詮,83,1,82,元大-大天母,2024-07-12,9893
00919,群益台灣精選高息,96,20,76,元大-大天母,2024-07-12,9893
4306,炎洲,76,1,75,元大-大天母,2024-07-12,9893
1802,台玻,104,40,64,元大-大天母,2024-07-12,9893
2883,凱基金,66,8,58,元大-大天母,2024-07-12,9893
4707,磐亞,60,5,55,元大-大天母,2024-07-12,9893
00753L,中信中國50正2,46,0,46,元大-大天母,2024-07-12,9893
00688L,國泰20年美債正2,45,0,45,元大-大天母,2024-07-12,9893
2603,長榮,72,30,42,元大-大天母,2024-07-12,9893
00891,中信關鍵半導體,52,11,41,元大-大天母,2024-07-12,9893
2889,國票金,40,0,40,元大-大天母,2024-07-12,9893
2408,南亞科,40,0,40,元大-大天母,2024-07-12,9893
3034,聯詠,39,0,39,元大-大天母,2024-07-12,9893
00935,野村臺灣新科技50,35,0,35,元大-大天母,2024-07-12,9893
00632R,元大台灣50反1,120,86,34,元大-大天母,2024-07-12,9893
2885,元大金,38,4,34,元大-大天母,2024-07-12,9893
2330,台積電,52,18,34,元大-大天母,2024-07-12,9893
2313,華通,36,4,32,元大-大天母,2024-07-12,9893
3594,磐儀,30,1,29,元大-大天母,2024-07-12,9893
00927,群益半導體收益,40,12,28,元大-大天母,2024-07-12,9893
00923,群益台ESG低碳50,27,0,27,元大-大天母,2024-07-12,9893
1513,中興電,63,36,27,元大-大天母,2024-07-12,9893
9945,潤泰新,59,34,25,元大-大天母,2024-07-12,9893
2542,興富發,25,0,25,元大-大天母,2024-07-12,9893
8289,泰藝,24,0,24,元大-大天母,2024-07-12,9893
2464,盟立,28,5,23,元大-大天母,2024-07-12,9893
3231,緯創,25,3,22,元大-大天母,2024-07-12,9893
6834,天二科技,22,0,22,元大-大天母,2024-07-12,9893
2454,聯發科,24,2,22,元大-大天母,2024-07-12,9893
5522,遠雄,20,0,20,元大-大天母,2024-07-12,9893
3710,連展投控,20,0,20,元大-大天母,2024-07-12,9893
2316,楠梓電,37,17,20,元大-大天母,2024-07-12,9893
00944,野村趨勢動能高息,30,10,20,元大-大天母,2024-07-12,9893
2368,金像電,21,1,20,元大-大天母,2024-07-12,9893
3312,弘憶股,27,9,18,元大-大天母,2024-07-12,9893
2836,高雄銀,283,0,283,元大-大天母,2024-07-15,9893
2365,昆盈,201,25,176,元大-大天母,2024-07-15,9893
2888,新光金,249,81,168,元大-大天母,2024-07-15,9893
2891,中信金,322,170,152,元大-大天母,2024-07-15,9893
2890,永豐金,150,2,148,元大-大天母,2024-07-15,9893
00680L,元大美債20正2,125,0,125,元大-大天母,2024-07-15,9893
00679B,元大美債20年,130,5,125,元大-大天母,2024-07-15,9893
00934,中信成長高股息,120,7,113,元大-大天母,2024-07-15,9893
00929,復華台灣科技優息,112,2,110,元大-大天母,2024-07-15,9893
2886,兆豐金,103,0,103,元大-大天母,2024-07-15,9893
00944,野村趨勢動能高息,101,0,101,元大-大天母,2024-07-15,9893
6285,啟��,100,0,100,元大-大天母,2024-07-15,9893
2388,威盛,102,2,100,元大-大天母,2024-07-15,9893
4306,炎洲,87,0,87,元大-大天母,2024-07-15,9893
2618,長榮航,92,18,74,元大-大天母,2024-07-15,9893
2867,三商壽,81,17,64,元大-大天母,2024-07-15,9893
00935,野村臺灣新科技50,62,1,61,元大-大天母,2024-07-15,9893
3030,德律,58,0,58,元大-大天母,2024-07-15,9893
00641R,富邦日本反1,50,0,50,元大-大天母,2024-07-15,9893
2356,英業達,142,93,49,元大-大天母,2024-07-15,9893
2881,富邦金,51,7,44,元大-大天母,2024-07-15,9893
6116,彩晶,44,0,44,元大-大天母,2024-07-15,9893
1608,華榮,62,21,41,元大-大天母,2024-07-15,9893
00725B,國泰投資級公司債,40,0,40,元大-大天母,2024-07-15,9893
2489,瑞軒,182,146,36,元大-大天母,2024-07-15,9893
2889,國票金,35,0,35,元大-大天母,2024-07-15,9893
2344,華邦電,37,2,35,元大-大天母,2024-07-15,9893
00885,富邦越南,40,5,35,元大-大天母,2024-07-15,9893
00930,永豐ESG低碳高息,34,0,34,元大-大天母,2024-07-15,9893
1568,倉佑,33,0,33,元大-大天母,2024-07-15,9893
00882,中信中國高股息,33,0,33,元大-大天母,2024-07-15,9893
3625,西勝,30,0,30,元大-大天母,2024-07-15,9893
1304,台聚,30,0,30,元大-大天母,2024-07-15,9893
6168,宏齊,30,0,30,元大-大天母,2024-07-15,9893
2108,南帝,32,4,28,元大-大天母,2024-07-15,9893
00919,群益台灣精選高息,36,8,28,元大-大天母,2024-07-15,9893
2330,台積電,37,10,27,元大-大天母,2024-07-15,9893
00937B,群益ESG投等債20,29,2,27,元大-大天母,2024-07-15,9893
8021,尖點,28,1,27,元大-大天母,2024-07-15,9893
3379,彬台,45,18,27,元大-大天母,2024-07-15,9893
8103,瀚荃,31,4,27,元大-大天母,2024-07-15,9893
4960,誠美材,26,0,26,元大-大天母,2024-07-15,9893
2376,技嘉,27,2,25,元大-大天母,2024-07-15,9893
2399,映泰,29,4,25,元大-大天母,2024-07-15,9893
2324,仁寶,30,7,23,元大-大天母,2024-07-15,9893
2885,元大金,26,3,23,元大-大天母,2024-07-15,9893
00687B,國泰20年美債,28,5,23,元大-大天母,2024-07-15,9893
2323,中環,22,0,22,元大-大天母,2024-07-15,9893
2610,華航,32,10,22,元大-大天母,2024-07-15,9893
3163,波若威,39,18,21,元大-大天母,2024-07-15,9893
2890,永豐金,254,11,243,元大-大天母,2024-07-16,9893
00680L,元大美債20正2,215,24,191,元大-大天母,2024-07-16,9893
00929,復華台灣科技優息,232,71,161,元大-大天母,2024-07-16,9893
00937B,群益ESG投等債20,164,41,123,元大-大天母,2024-07-16,9893
00934,中信成長高股息,120,1,119,元大-大天母,2024-07-16,9893
0056,元大高股息,99,2,97,元大-大天母,2024-07-16,9893
1586,和勤,90,0,90,元大-大天母,2024-07-16,9893
2881,富邦金,106,19,87,元大-大天母,2024-07-16,9893
2317,鴻海,86,13,73,元大-大天母,2024-07-16,9893
1102,亞泥,72,0,72,元大-大天母,2024-07-16,9893
00905,FT臺灣Smart,69,0,69,元大-大天母,2024-07-16,9893
00919,群益台灣精選高息,82,15,67,元大-大天母,2024-07-16,9893
00650L,復華香港正2,60,0,60,元大-大天母,2024-07-16,9893
2891,中信金,193,134,59,元大-大天母,2024-07-16,9893
2489,瑞軒,96,40,56,元大-大天母,2024-07-16,9893
6285,啟��,54,1,53,元大-大天母,2024-07-16,9893
1532,勤美,52,0,52,元大-大天母,2024-07-16,9893
2354,鴻準,54,3,51,元大-大天母,2024-07-16,9893
2836,高雄銀,50,0,50,元大-大天母,2024-07-16,9893
6117,迎廣,60,10,50,元大-大天母,2024-07-16,9893
6190,萬泰科,44,0,44,元大-大天母,2024-07-16,9893
00933B,國泰10Y+金融債,38,0,38,元大-大天母,2024-07-16,9893
3652,精聯,31,0,31,元大-大天母,2024-07-16,9893
2615,萬海,33,3,30,元大-大天母,2024-07-16,9893
8937,合騏,30,1,29,元大-大天母,2024-07-16,9893
2481,強茂,37,11,26,元大-大天母,2024-07-16,9893
3379,彬台,28,3,25,元大-大天母,2024-07-16,9893
2867,三商壽,39,15,24,元大-大天母,2024-07-16,9893
5324,士開,24,0,24,元大-大天母,2024-07-16,9893
8011,台通,54,31,23,元大-大天母,2024-07-16,9893
2303,聯電,28,5,23,元大-大天母,2024-07-16,9893
2465,麗臺,49,27,22,元大-大天母,2024-07-16,9893
6150,撼訊,22,0,22,元大-大天母,2024-07-16,9893
4513,福裕,23,1,22,元大-大天母,2024-07-16,9893
3019,亞光,47,26,21,元大-大天母,2024-07-16,9893
1447,力鵬,21,0,21,元大-大天母,2024-07-16,9893
4304,勝昱,20,0,20,元大-大天母,2024-07-16,9893
5432,新門,20,0,20,元大-大天母,2024-07-16,9893
3520,華盈,24,4,20,元大-大天母,2024-07-16,9893
2243,宏旭-KY,37,17,20,元大-大天母,2024-07-16,9893
00724B,群益投資級金融債,20,0,20,元大-大天母,2024-07-16,9893
3594,磐儀,20,0,20,元大-大天母,2024-07-16,9893
00673R,期元大S＆P原油反1,20,0,20,元大-大天母,2024-07-16,9893
5871,中租-KY,20,1,19,元大-大天母,2024-07-16,9893
6239,力成,22,3,19,元大-大天母,2024-07-16,9893
9945,潤泰新,25,6,19,元大-大天母,2024-07-16,9893
6217,中探針,20,1,19,元大-大天母,2024-07-16,9893
6278,台表科,25,6,19,元大-大天母,2024-07-16,9893
00881,國泰台灣5G+,18,1,17,元大-大天母,2024-07-16,9893
2886,兆豐金,17,0,17,元大-大天母,2024-07-16,9893
2890,永豐金,354,6,348,元大-大天母,2024-07-17,9893
00929,復華台灣科技優息,137,2,135,元大-大天母,2024-07-17,9893
2891,中信金,340,207,133,元大-大天母,2024-07-17,9893
00632R,元大台灣50反1,184,55,129,元大-大天母,2024-07-17,9893
3163,波若威,147,21,126,元大-大天母,2024-07-17,9893
5498,凱崴,138,30,108,元大-大天母,2024-07-17,9893
00919,群益台灣精選高息,86,4,82,元大-大天母,2024-07-17,9893
0056,元大高股息,79,4,75,元大-大天母,2024-07-17,9893
3049,精金,96,23,73,元大-大天母,2024-07-17,9893
2881,富邦金,111,53,58,元大-大天母,2024-07-17,9893
1528,恩德,52,0,52,元大-大天母,2024-07-17,9893
2887,台新金,54,4,50,元大-大天母,2024-07-17,9893
1806,冠軍,50,0,50,元大-大天母,2024-07-17,9893
4304,勝昱,50,0,50,元大-大天母,2024-07-17,9893
2330,台積電,53,3,50,元大-大天母,2024-07-17,9893
1532,勤美,47,2,45,元大-大天母,2024-07-17,9893
3231,緯創,66,21,45,元大-大天母,2024-07-17,9893
3379,彬台,52,9,43,元大-大天母,2024-07-17,9893
3625,西勝,42,0,42,元大-大天母,2024-07-17,9893
1608,華榮,58,20,38,元大-大天母,2024-07-17,9893
00936,台新永續高息中小,39,3,36,元大-大天母,2024-07-17,9893
2408,南亞科,34,0,34,元大-大天母,2024-07-17,9893
2353,宏��,35,2,33,元大-大天母,2024-07-17,9893
1903,士紙,39,6,33,元大-大天母,2024-07-17,9893
1314,中石化,57,24,33,元大-大天母,2024-07-17,9893
3294,英濟,41,11,30,元大-大天母,2024-07-17,9893
1503,士電,45,16,29,元大-大天母,2024-07-17,9893
00679B,元大美債20年,44,15,29,元大-大天母,2024-07-17,9893
2609,陽明,40,12,28,元大-大天母,2024-07-17,9893
6173,信昌電,39,11,28,元大-大天母,2024-07-17,9893
9105,泰金寶-DR,29,2,27,元大-大天母,2024-07-17,9893
2618,長榮航,27,1,26,元大-大天母,2024-07-17,9893
2402,毅嘉,101,76,25,元大-大天母,2024-07-17,9893
00927,群益半導體收益,25,2,23,元大-大天母,2024-07-17,9893
2431,聯昌,31,8,23,元大-大天母,2024-07-17,9893
2376,技嘉,28,6,22,元大-大天母,2024-07-17,9893
006208,富邦台50,22,0,22,元大-大天母,2024-07-17,9893
00934,中信成長高股息,22,1,21,元大-大天母,2024-07-17,9893
3050,鈺德,22,1,21,元大-大天母,2024-07-17,9893
00891,中信關鍵半導體,21,0,21,元大-大天母,2024-07-17,9893
1536,和大,182,162,20,元大-大天母,2024-07-17,9893
3086,華義,20,0,20,元大-大天母,2024-07-17,9893
00948B,中信優息投資級債,20,0,20,元大-大天母,2024-07-17,9893
00945B,凱基美國非投等債,20,0,20,元大-大天母,2024-07-17,9893
2465,麗臺,20,0,20,元大-大天母,2024-07-17,9893
2014,中鴻,20,0,20,元大-大天母,2024-07-17,9893
2404,漢唐,20,0,20,元大-大天母,2024-07-17,9893
3323,加百裕,20,0,20,元大-大天母,2024-07-17,9893
2449,京元電子,26,6,20,元大-大天母,2024-07-17,9893
1303,南亞,19,0,19,元大-大天母,2024-07-17,9893
2365,昆盈,261,55,206,元大-大天母,2024-07-18,9893
2891,中信金,438,254,184,元大-大天母,2024-07-18,9893
00919,群益台灣精選高息,208,26,182,元大-大天母,2024-07-18,9893
2881,富邦金,175,8,167,元大-大天母,2024-07-18,9893
00929,復華台灣科技優息,214,54,160,元大-大天母,2024-07-18,9893
2317,鴻海,166,27,139,元大-大天母,2024-07-18,9893
00941,中信上游半導體,133,0,133,元大-大天母,2024-07-18,9893
6695,芯鼎,108,8,100,元大-大天母,2024-07-18,9893
2356,英業達,123,25,98,元大-大天母,2024-07-18,9893
00753L,中信中國50正2,100,5,95,元大-大天母,2024-07-18,9893
2401,凌陽,83,0,83,元大-大天母,2024-07-18,9893
3042,晶技,82,0,82,元大-大天母,2024-07-18,9893
1709,和益,92,10,82,元大-大天母,2024-07-18,9893
2890,永豐金,100,25,75,元大-大天母,2024-07-18,9893
2330,台積電,144,69,75,元大-大天母,2024-07-18,9893
1783,和康生,60,0,60,元大-大天母,2024-07-18,9893
1815,富喬,61,4,57,元大-大天母,2024-07-18,9893
6125,廣運,62,11,51,元大-大天母,2024-07-18,9893
00927,群益半導體收益,53,2,51,元大-大天母,2024-07-18,9893
3045,台灣大,60,9,51,元大-大天母,2024-07-18,9893
1611,中電,127,78,49,元大-大天母,2024-07-18,9893
2836,高雄銀,50,1,49,元大-大天母,2024-07-18,9893
6285,啟��,51,5,46,元大-大天母,2024-07-18,9893
4306,炎洲,48,3,45,元大-大天母,2024-07-18,9893
2382,廣達,67,23,44,元大-大天母,2024-07-18,9893
0056,元大高股息,71,28,43,元大-大天母,2024-07-18,9893
1711,永光,38,0,38,元大-大天母,2024-07-18,9893
3037,欣興,100,64,36,元大-大天母,2024-07-18,9893
00934,中信成長高股息,36,3,33,元大-大天母,2024-07-18,9893
00937B,群益ESG投等債20,58,26,32,元大-大天母,2024-07-18,9893
6116,彩晶,32,0,32,元大-大天母,2024-07-18,9893
00673R,期元大S＆P原油反1,32,0,32,元大-大天母,2024-07-18,9893
00687B,國泰20年美債,33,1,32,元大-大天母,2024-07-18,9893
00948B,中信優息投資級債,30,0,30,元大-大天母,2024-07-18,9893
6770,力積電,59,32,27,元大-大天母,2024-07-18,9893
2348,海悅,35,8,27,元大-大天母,2024-07-18,9893
6182,合晶,30,6,24,元大-大天母,2024-07-18,9893
3673,TPK-KY,47,23,24,元大-大天母,2024-07-18,9893
9904,寶成,35,11,24,元大-大天母,2024-07-18,9893
1402,遠東新,23,0,23,元大-大天母,2024-07-18,9893
2408,南亞科,24,2,22,元大-大天母,2024-07-18,9893
3230,錦明,21,0,21,元大-大天母,2024-07-18,9893
00935,野村臺灣新科技50,21,0,21,元大-大天母,2024-07-18,9893
2363,矽統,21,1,20,元大-大天母,2024-07-18,9893
00911,兆豐洲際半導體,20,0,20,元大-大天母,2024-07-18,9893
00773B,中信優先金融債,20,0,20,元大-大天母,2024-07-18,9893
6152,百一,20,0,20,元大-大天母,2024-07-18,9893
00688L,國泰20年美債正2,19,0,19,元大-大天母,2024-07-18,9893
2449,京元電子,26,8,18,元大-大天母,2024-07-18,9893
6168,宏齊,18,0,18,元大-大天母,2024-07-18,9893
3711,日月光投控,564,5,559,元大-大天母,2024-07-19,9893
1314,中石化,433,0,433,元大-大天母,2024-07-19,9893
2891,中信金,639,234,405,元大-大天母,2024-07-19,9893
1584,精剛,341,1,340,元大-大天母,2024-07-19,9893
00919,群益台灣精選高息,256,6,250,元大-大天母,2024-07-19,9893
2890,永豐金,200,4,196,元大-大天母,2024-07-19,9893
2892,第一金,173,6,167,元大-大天母,2024-07-19,9893
2330,台積電,149,12,137,元大-大天母,2024-07-19,9893
00671R,富邦NASDAQ反1,135,0,135,元大-大天母,2024-07-19,9893
2836,高雄銀,125,2,123,元大-大天母,2024-07-19,9893
00680L,元大美債20正2,110,1,109,元大-大天母,2024-07-19,9893
2886,兆豐金,105,3,102,元大-大天母,2024-07-19,9893
0056,元大高股息,153,61,92,元大-大天母,2024-07-19,9893
5512,力麒,126,51,75,元大-大天母,2024-07-19,9893
00632R,元大台灣50反1,285,210,75,元大-大天母,2024-07-19,9893
1802,台玻,69,0,69,元大-大天母,2024-07-19,9893
2408,南亞科,70,4,66,元大-大天母,2024-07-19,9893
2887,台新金,105,43,62,元大-大天母,2024-07-19,9893
00934,中信成長高股息,57,2,55,元大-大天母,2024-07-19,9893
6125,廣運,57,3,54,元大-大天母,2024-07-19,9893
2618,長榮航,72,19,53,元大-大天母,2024-07-19,9893
3481,群創,94,42,52,元大-大天母,2024-07-19,9893
2885,元大金,57,6,51,元大-大天母,2024-07-19,9893
4306,炎洲,50,0,50,元大-大天母,2024-07-19,9893
2401,凌陽,51,2,49,元大-大天母,2024-07-19,9893
6239,力成,43,1,42,元大-大天母,2024-07-19,9893
2377,微星,42,1,41,元大-大天母,2024-07-19,9893
00878,國泰永續高股息,91,50,41,元大-大天母,2024-07-19,9893
00650L,復華香港正2,50,10,40,元大-大天母,2024-07-19,9893
00937B,群益ESG投等債20,42,5,37,元大-大天母,2024-07-19,9893
2882,國泰金,94,58,36,元大-大天母,2024-07-19,9893
4121,優盛,34,0,34,元大-大天母,2024-07-19,9893
2883,凱基金,68,35,33,元大-大天母,2024-07-19,9893
2515,中工,31,0,31,元大-大天母,2024-07-19,9893
00927,群益半導體收益,30,0,30,元大-大天母,2024-07-19,9893
2427,三商電,30,1,29,元大-大天母,2024-07-19,9893
2603,長榮,48,19,29,元大-大天母,2024-07-19,9893
1611,中電,70,42,28,元大-大天母,2024-07-19,9893
2324,仁寶,28,0,28,元大-大天母,2024-07-19,9893
2312,金寶,74,47,27,元大-大天母,2024-07-19,9893
2317,鴻海,72,46,26,元大-大天母,2024-07-19,9893
2365,昆盈,68,43,25,元大-大天母,2024-07-19,9893
5475,德宏,25,0,25,元大-大天母,2024-07-19,9893
8936,國統,50,25,25,元大-大天母,2024-07-19,9893
2834,臺企銀,32,8,24,元大-大天母,2024-07-19,9893
3714,富采,24,0,24,元大-大天母,2024-07-19,9893
2337,旺宏,22,0,22,元大-大天母,2024-07-19,9893
3037,欣興,33,11,22,元大-大天母,2024-07-19,9893
00918,大華優利高填息30,24,3,21,元大-大天母,2024-07-19,9893
00933B,國泰10Y+金融債,30,9,21,元大-大天母,2024-07-19,9893
00632R,元大台灣50反1,1880,131,1749,元大-大天母,2024-07-22,9893
2615,萬海,567,121,446,元大-大天母,2024-07-22,9893
00929,復華台灣科技優息,469,122,347,元大-大天母,2024-07-22,9893
00671R,富邦NASDAQ反1,270,0,270,元大-大天母,2024-07-22,9893
00940,元大台灣價值高息,969,722,247,元大-大天母,2024-07-22,9893
00919,群益台灣精選高息,259,31,228,元大-大天母,2024-07-22,9893
2890,永豐金,209,1,208,元大-大天母,2024-07-22,9893
1584,精剛,186,2,184,元大-大天母,2024-07-22,9893
2365,昆盈,209,44,165,元大-大天母,2024-07-22,9893
2892,第一金,105,8,97,元大-大天母,2024-07-22,9893
00934,中信成長高股息,99,9,90,元大-大天母,2024-07-22,9893
2317,鴻海,154,69,85,元大-大天母,2024-07-22,9893
3481,群創,228,166,62,元大-大天母,2024-07-22,9893
2377,微星,60,0,60,元大-大天母,2024-07-22,9893
0056,元大高股息,124,67,57,元大-大天母,2024-07-22,9893
2330,台積電,99,46,53,元大-大天母,2024-07-22,9893
3231,緯創,82,41,41,元大-大天母,2024-07-22,9893
2880,華南金,50,9,41,元大-大天母,2024-07-22,9893
1903,士紙,40,0,40,元大-大天母,2024-07-22,9893
3551,世禾,40,0,40,元大-大天母,2024-07-22,9893
1609,大亞,69,30,39,元大-大天母,2024-07-22,9893
2303,聯電,111,73,38,元大-大天母,2024-07-22,9893
2882,國泰金,79,44,35,元大-大天母,2024-07-22,9893
6245,立端,40,5,35,元大-大天母,2024-07-22,9893
6278,台表科,127,94,33,元大-大天母,2024-07-22,9893
2886,兆豐金,58,25,33,元大-大天母,2024-07-22,9893
5512,力麒,99,69,30,元大-大天母,2024-07-22,9893
5432,新門,31,1,30,元大-大天母,2024-07-22,9893
00719B,元大美債1-3,30,0,30,元大-大天母,2024-07-22,9893
1314,中石化,30,0,30,元大-大天母,2024-07-22,9893
00679B,元大美債20年,72,42,30,元大-大天母,2024-07-22,9893
2538,基泰,30,3,27,元大-大天母,2024-07-22,9893
2884,玉山金,33,8,25,元大-大天母,2024-07-22,9893
0050,元大台灣50,29,5,24,元大-大天母,2024-07-22,9893
00937B,群益ESG投等債20,47,24,23,元大-大天母,2024-07-22,9893
2206,三陽工業,23,0,23,元大-大天母,2024-07-22,9893
5469,瀚宇博,22,0,22,元大-大天母,2024-07-22,9893
1608,華榮,21,0,21,元大-大天母,2024-07-22,9893
2515,中工,22,1,21,元大-大天母,2024-07-22,9893
2883,凱基金,69,48,21,元大-大天母,2024-07-22,9893
8464,億豐,20,0,20,元大-大天母,2024-07-22,9893
1319,東陽,20,0,20,元大-大天母,2024-07-22,9893
6203,海韻電,20,0,20,元大-大天母,2024-07-22,9893
4306,炎洲,20,0,20,元大-大天母,2024-07-22,9893
2449,京元電子,24,5,19,元大-大天母,2024-07-22,9893
3714,富采,19,0,19,元大-大天母,2024-07-22,9893
00946,群益科技高息成長,19,0,19,元大-大天母,2024-07-22,9893
5609,中菲行,19,1,18,元大-大天母,2024-07-22,9893
2603,長榮,45,27,18,元大-大天母,2024-07-22,9893
2356,英業達,27,10,17,元大-大天母,2024-07-22,9893
2609,陽明,666,25,641,元大-大天母,2024-07-23,9893
5364,力麗店,340,0,340,元大-大天母,2024-07-23,9893
2520,冠德,304,5,299,元大-大天母,2024-07-23,9893
2888,新光金,183,18,165,元大-大天母,2024-07-23,9893
00676R,富邦臺灣加權反1,150,0,150,元大-大天母,2024-07-23,9893
00946,群益科技高息成長,143,0,143,元大-大天母,2024-07-23,9893
2883,凱基金,212,73,139,元大-大天母,2024-07-23,9893
00937B,群益ESG投等債20,180,49,131,元大-大天母,2024-07-23,9893
3231,緯創,135,8,127,元大-大天母,2024-07-23,9893
00680L,元大美債20正2,108,0,108,元大-大天母,2024-07-23,9893
00671R,富邦NASDAQ反1,100,0,100,元大-大天母,2024-07-23,9893
2886,兆豐金,105,7,98,元大-大天母,2024-07-23,9893
00933B,國泰10Y+金融債,89,0,89,元大-大天母,2024-07-23,9893
8028,昇陽半導體,105,19,86,元大-大天母,2024-07-23,9893
3481,群創,150,73,77,元大-大天母,2024-07-23,9893
2891,中信金,190,122,68,元大-大天母,2024-07-23,9893
00679B,元大美債20年,108,40,68,元大-大天母,2024-07-23,9893
2312,金寶,69,2,67,元大-大天母,2024-07-23,9893
6190,萬泰科,68,3,65,元大-大天母,2024-07-23,9893
2812,台中銀,61,0,61,元大-大天母,2024-07-23,9893
2408,南亞科,59,0,59,元大-大天母,2024-07-23,9893
00713,元大台灣高息低波,59,6,53,元大-大天母,2024-07-23,9893
00929,復華台灣科技優息,85,33,52,元大-大天母,2024-07-23,9893
6239,力成,52,0,52,元大-大天母,2024-07-23,9893
2489,瑞軒,48,2,46,元大-大天母,2024-07-23,9893
00878,國泰永續高股息,53,7,46,元大-大天母,2024-07-23,9893
2409,友達,91,46,45,元大-大天母,2024-07-23,9893
2603,長榮,71,26,45,元大-大天母,2024-07-23,9893
0056,元大高股息,52,8,44,元大-大天母,2024-07-23,9893
2880,華南金,51,7,44,元大-大天母,2024-07-23,9893
00934,中信成長高股息,42,1,41,元大-大天母,2024-07-23,9893
4526,東台,32,4,28,元大-大天母,2024-07-23,9893
2405,輔信,25,0,25,元大-大天母,2024-07-23,9893
2317,鴻海,83,61,22,元大-大天母,2024-07-23,9893
2301,光寶科,24,4,20,元大-大天母,2024-07-23,9893
2915,潤泰全,21,1,20,元大-大天母,2024-07-23,9893
9105,泰金寶-DR,21,2,19,元大-大天母,2024-07-23,9893
3673,TPK-KY,18,1,17,元大-大天母,2024-07-23,9893
3032,偉訓,17,1,16,元大-大天母,2024-07-23,9893
00751B,元大AAA至A公司債,15,0,15,元大-大天母,2024-07-23,9893
5512,力麒,28,14,14,元大-大天母,2024-07-23,9893
00949,復華日本龍頭,14,0,14,元大-大天母,2024-07-23,9893
8096,擎亞,38,24,14,元大-大天母,2024-07-23,9893
00830,國泰費城半導體,15,2,13,元大-大天母,2024-07-23,9893
3094,聯傑,13,0,13,元大-大天母,2024-07-23,9893
3580,友威科,70,57,13,元大-大天母,2024-07-23,9893
006208,富邦台50,13,0,13,元大-大天母,2024-07-23,9893
1609,大亞,20,8,12,元大-大天母,2024-07-23,9893
2344,華邦電,11,0,11,元大-大天母,2024-07-23,9893
6957,裕慶-KY,11,0,11,元大-大天母,2024-07-23,9893
00937B,群益ESG投等債20,322,24,298,元大-大天母,2024-07-26,9893
00929,復華台灣科技優息,286,78,208,元大-大天母,2024-07-26,9893
2890,永豐金,158,0,158,元大-大天母,2024-07-26,9893
2884,玉山金,146,2,144,元大-大天母,2024-07-26,9893
1514,亞力,143,2,141,元大-大天母,2024-07-26,9893
00878,國泰永續高股息,126,4,122,元大-大天母,2024-07-26,9893
00671R,富邦NASDAQ反1,120,0,120,元大-大天母,2024-07-26,9893
2330,台積電,105,14,91,元大-大天母,2024-07-26,9893
3711,日月光投控,89,1,88,元大-大天母,2024-07-26,9893
00919,群益台灣精選高息,78,0,78,元大-大天母,2024-07-26,9893
00679B,元大美債20年,80,3,77,元大-大天母,2024-07-26,9893
2891,中信金,130,60,70,元大-大天母,2024-07-26,9893
00687B,國泰20年美債,72,6,66,元大-大天母,2024-07-26,9893
2885,元大金,196,130,66,元大-大天母,2024-07-26,9893
2467,志聖,64,2,62,元大-大天母,2024-07-26,9893
0056,元大高股息,62,4,58,元大-大天母,2024-07-26,9893
00933B,國泰10Y+金融債,67,10,57,元大-大天母,2024-07-26,9893
2609,陽明,59,10,49,元大-大天母,2024-07-26,9893
00949,復華日本龍頭,44,0,44,元大-大天母,2024-07-26,9893
00674R,期元大S＆P黃金反1,40,0,40,元大-大天母,2024-07-26,9893
00720B,元大投資級公司債,39,0,39,元大-大天母,2024-07-26,9893
2867,三商壽,37,1,36,元大-大天母,2024-07-26,9893
2382,廣達,41,6,35,元大-大天母,2024-07-26,9893
6664,群翊,35,0,35,元大-大天母,2024-07-26,9893
00951,台新日本半導體,34,0,34,元大-大天母,2024-07-26,9893
00927,群益半導體收益,40,6,34,元大-大天母,2024-07-26,9893
00934,中信成長高股息,36,3,33,元大-大天母,2024-07-26,9893
00724B,群益投資級金融債,32,0,32,元大-大天母,2024-07-26,9893
4714,永捷,30,0,30,元大-大天母,2024-07-26,9893
1722,台肥,30,0,30,元大-大天母,2024-07-26,9893
5512,力麒,30,0,30,元大-大天母,2024-07-26,9893
2408,南亞科,30,1,29,元大-大天母,2024-07-26,9893
6264,富裔,28,0,28,元大-大天母,2024-07-26,9893
6829,千附精密,45,17,28,元大-大天母,2024-07-26,9893
2303,聯電,31,4,27,元大-大天母,2024-07-26,9893
0050,元大台灣50,27,0,27,元大-大天母,2024-07-26,9893
3033,威健,29,2,27,元大-大天母,2024-07-26,9893
00946,群益科技高息成長,27,0,27,元大-大天母,2024-07-26,9893
1903,士紙,26,0,26,元大-大天母,2024-07-26,9893
8021,尖點,27,1,26,元大-大天母,2024-07-26,9893
2834,臺企銀,26,0,26,元大-大天母,2024-07-26,9893
00632R,元大台灣50反1,197,172,25,元大-大天母,2024-07-26,9893
3231,緯創,64,39,25,元大-大天母,2024-07-26,9893
2489,瑞軒,24,0,24,元大-大天母,2024-07-26,9893
006208,富邦台50,30,6,24,元大-大天母,2024-07-26,9893
2836,高雄銀,22,0,22,元大-大天母,2024-07-26,9893
3533,嘉澤,20,0,20,元大-大天母,2024-07-26,9893
2317,鴻海,52,34,18,元大-大天母,2024-07-26,9893
2365,昆盈,23,5,18,元大-大天母,2024-07-26,9893
00712,復華富時不動產,18,0,18,元大-大天母,2024-07-26,9893
00632R,元大台灣50反1,733,1,732,元大-大天母,2024-07-29,9893
00940,元大台灣價值高息,258,8,250,元大-大天母,2024-07-29,9893
8028,昇陽半導體,211,24,187,元大-大天母,2024-07-29,9893
00929,復華台灣科技優息,200,17,183,元大-大天母,2024-07-29,9893
2891,中信金,215,48,167,元大-大天母,2024-07-29,9893
9904,寶成,150,7,143,元大-大天母,2024-07-29,9893
3231,緯創,139,2,137,元大-大天母,2024-07-29,9893
2890,永豐金,99,0,99,元大-大天母,2024-07-29,9893
6239,力成,100,3,97,元大-大天母,2024-07-29,9893
00878,國泰永續高股息,84,10,74,元大-大天母,2024-07-29,9893
2888,新光金,78,25,53,元大-大天母,2024-07-29,9893
00919,群益台灣精選高息,56,3,53,元大-大天母,2024-07-29,9893
00934,中信成長高股息,56,6,50,元大-大天母,2024-07-29,9893
8201,無敵,42,0,42,元大-大天母,2024-07-29,9893
2884,玉山金,40,0,40,元大-大天母,2024-07-29,9893
2313,華通,44,6,38,元大-大天母,2024-07-29,9893
0056,元大高股息,81,43,38,元大-大天母,2024-07-29,9893
3086,華義,36,0,36,元大-大天母,2024-07-29,9893
6664,群翊,35,0,35,元大-大天母,2024-07-29,9893
3013,晟銘電,39,9,30,元大-大天母,2024-07-29,9893
9902,台火,35,5,30,元大-大天母,2024-07-29,9893
1608,華榮,30,0,30,元大-大天母,2024-07-29,9893
2356,英業達,71,42,29,元大-大天母,2024-07-29,9893
2467,志聖,37,8,29,元大-大天母,2024-07-29,9893
4977,眾達-KY,31,3,28,元大-大天母,2024-07-29,9893
2834,臺企銀,28,2,26,元大-大天母,2024-07-29,9893
2382,廣達,32,7,25,元大-大天母,2024-07-29,9893
2892,第一金,52,31,21,元大-大天母,2024-07-29,9893
2409,友達,33,12,21,元大-大天母,2024-07-29,9893
2537,聯上發,23,2,21,元大-大天母,2024-07-29,9893
6217,中探針,20,0,20,元大-大天母,2024-07-29,9893
4909,新復興,21,1,20,元大-大天母,2024-07-29,9893
00939,統一台灣高息動能,19,0,19,元大-大天母,2024-07-29,9893
2301,光寶科,22,3,19,元大-大天母,2024-07-29,9893
8936,國統,20,3,17,元大-大天母,2024-07-29,9893
2634,漢翔,17,0,17,元大-大天母,2024-07-29,9893
1536,和大,147,130,17,元大-大天母,2024-07-29,9893
2363,矽統,20,4,16,元大-大天母,2024-07-29,9893
6213,聯茂,207,192,15,元大-大天母,2024-07-29,9893
3037,欣興,29,15,14,元大-大天母,2024-07-29,9893
00946,群益科技高息成長,14,0,14,元大-大天母,2024-07-29,9893
00751B,元大AAA至A公司債,14,0,14,元大-大天母,2024-07-29,9893
6806,森崴能源,27,13,14,元大-大天母,2024-07-29,9893
6274,台燿,15,2,13,元大-大天母,2024-07-29,9893
1514,亞力,17,5,12,元大-大天母,2024-07-29,9893
2388,威盛,13,1,12,元大-大天母,2024-07-29,9893
2929,淘帝-KY,12,0,12,元大-大天母,2024-07-29,9893
4129,聯合,12,0,12,元大-大天母,2024-07-29,9893
00933B,國泰10Y+金融債,12,0,12,元大-大天母,2024-07-29,9893
6202,盛群,12,0,12,元大-大天母,2024-07-29,9893
2891,中信金,184,27,157,元大-大天母,2024-07-30,9893
6188,廣明,152,4,148,元大-大天母,2024-07-30,9893
00940,元大台灣價值高息,147,10,137,元大-大天母,2024-07-30,9893
2886,兆豐金,126,2,124,元大-大天母,2024-07-30,9893
00929,復華台灣科技優息,134,16,118,元大-大天母,2024-07-30,9893
00751B,元大AAA至A公司債,115,0,115,元大-大天母,2024-07-30,9893
2882,國泰金,92,5,87,元大-大天母,2024-07-30,9893
0056,元大高股息,97,15,82,元大-大天母,2024-07-30,9893
00637L,元大滬深300正2,81,0,81,元大-大天母,2024-07-30,9893
00878,國泰永續高股息,86,9,77,元大-大天母,2024-07-30,9893
6278,台表科,103,45,58,元大-大天母,2024-07-30,9893
2890,永豐金,56,1,55,元大-大天母,2024-07-30,9893
2892,第一金,62,9,53,元大-大天母,2024-07-30,9893
3663,鑫科,70,18,52,元大-大天母,2024-07-30,9893
2301,光寶科,52,0,52,元大-大天母,2024-07-30,9893
00936,台新永續高息中小,54,4,50,元大-大天母,2024-07-30,9893
00631L,元大台灣50正2,52,6,46,元大-大天母,2024-07-30,9893
2303,聯電,46,4,42,元大-大天母,2024-07-30,9893
00671R,富邦NASDAQ反1,40,0,40,元大-大天母,2024-07-30,9893
2344,華邦電,45,7,38,元大-大天母,2024-07-30,9893
00679B,元大美債20年,41,15,26,元大-大天母,2024-07-30,9893
6706,惠特,26,0,26,元大-大天母,2024-07-30,9893
00934,中信成長高股息,28,3,25,元大-大天母,2024-07-30,9893
2867,三商壽,33,10,23,元大-大天母,2024-07-30,9893
6239,力成,23,0,23,元大-大天母,2024-07-30,9893
2353,宏��,34,13,21,元大-大天母,2024-07-30,9893
6177,達麗,21,0,21,元大-大天母,2024-07-30,9893
2337,旺宏,26,5,21,元大-大天母,2024-07-30,9893
3013,晟銘電,30,10,20,元大-大天母,2024-07-30,9893
2401,凌陽,20,0,20,元大-大天母,2024-07-30,9893
5515,建國,20,0,20,元大-大天母,2024-07-30,9893
00946,群益科技高息成長,24,5,19,元大-大天母,2024-07-30,9893
3047,訊舟,40,21,19,元大-大天母,2024-07-30,9893
3293,鈊象,18,0,18,元大-大天母,2024-07-30,9893
6215,和椿,17,1,16,元大-大天母,2024-07-30,9893
1609,大亞,24,8,16,元大-大天母,2024-07-30,9893
2365,昆盈,46,31,15,元大-大天母,2024-07-30,9893
2515,中工,15,1,14,元大-大天母,2024-07-30,9893
2356,英業達,26,12,14,元大-大天母,2024-07-30,9893
3551,世禾,14,0,14,元大-大天母,2024-07-30,9893
3189,景碩,78,65,13,元大-大天母,2024-07-30,9893
00937B,群益ESG投等債20,34,22,12,元大-大天母,2024-07-30,9893
3024,憶聲,26,14,12,元大-大天母,2024-07-30,9893
2834,臺企銀,12,0,12,元大-大天母,2024-07-30,9893
5309,系統電,12,0,12,元大-大天母,2024-07-30,9893
3032,偉訓,11,0,11,元大-大天母,2024-07-30,9893
3019,亞光,17,6,11,元大-大天母,2024-07-30,9893
00948B,中信優息投資級債,11,0,11,元大-大天母,2024-07-30,9893
00685L,群益臺灣加權正2,11,0,11,元大-大天母,2024-07-30,9893
00850,元大臺灣ESG永續,10,0,10,元大-大天母,2024-07-30,9893
3481,群創,635,65,570,元大-大天母,2024-07-31,9893
2609,陽明,267,8,259,元大-大天母,2024-07-31,9893
00632R,元大台灣50反1,131,0,131,元大-大天母,2024-07-31,9893
2888,新光金,130,10,120,元大-大天母,2024-07-31,9893
8390,金益鼎,94,0,94,元大-大天母,2024-07-31,9893
00633L,富邦上証正2,76,0,76,元大-大天母,2024-07-31,9893
8028,昇陽半導體,65,15,50,元大-大天母,2024-07-31,9893
9935,慶豐富,50,0,50,元大-大天母,2024-07-31,9893
3711,日月光投控,43,2,41,元大-大天母,2024-07-31,9893
3221,台嘉碩,40,0,40,元大-大天母,2024-07-31,9893
00937B,群益ESG投等債20,60,24,36,元大-大天母,2024-07-31,9893
1609,大亞,45,11,34,元大-大天母,2024-07-31,9893
00687B,國泰20年美債,40,6,34,元大-大天母,2024-07-31,9893
6245,立端,33,0,33,元大-大天母,2024-07-31,9893
00878,國泰永續高股息,36,6,30,元大-大天母,2024-07-31,9893
3518,柏騰,41,12,29,元大-大天母,2024-07-31,9893
3105,穩懋,50,22,28,元大-大天母,2024-07-31,9893
2344,華邦電,26,2,24,元大-大天母,2024-07-31,9893
2241,艾姆勒,26,2,24,元大-大天母,2024-07-31,9893
3376,新日興,40,17,23,元大-大天母,2024-07-31,9893
6155,鈞寶,22,0,22,元大-大天母,2024-07-31,9893
00933B,國泰10Y+金融債,27,7,20,元大-大天母,2024-07-31,9893
1909,榮成,20,0,20,元大-大天母,2024-07-31,9893
00929,復華台灣科技優息,25,6,19,元大-大天母,2024-07-31,9893
3056,富華新,19,0,19,元大-大天母,2024-07-31,9893
2489,瑞軒,21,3,18,元大-大天母,2024-07-31,9893
2349,錸德,44,26,18,元大-大天母,2024-07-31,9893
00688L,國泰20年美債正2,17,0,17,元大-大天母,2024-07-31,9893
00900,富邦特選高股息30,17,0,17,元大-大天母,2024-07-31,9893
1104,環泥,20,3,17,元大-大天母,2024-07-31,9893
2883,凱基金,23,7,16,元大-大天母,2024-07-31,9893
2947,振宇五金,16,0,16,元大-大天母,2024-07-31,9893
2357,華碩,20,4,16,元大-大天母,2024-07-31,9893
4563,百德,16,0,16,元大-大天母,2024-07-31,9893
2409,友達,22,7,15,元大-大天母,2024-07-31,9893
00934,中信成長高股息,18,3,15,元大-大天母,2024-07-31,9893
00669R,國泰美國道瓊反1,15,0,15,元大-大天母,2024-07-31,9893
5213,亞昕,15,0,15,元大-大天母,2024-07-31,9893
00919,群益台灣精選高息,71,56,15,元大-大天母,2024-07-31,9893
2353,宏��,20,6,14,元大-大天母,2024-07-31,9893
9945,潤泰新,19,6,13,元大-大天母,2024-07-31,9893
3491,昇達科,18,5,13,元大-大天母,2024-07-31,9893
3706,神達,14,1,13,元大-大天母,2024-07-31,9893
3231,緯創,59,46,13,元大-大天母,2024-07-31,9893
0056,元大高股息,22,10,12,元大-大天母,2024-07-31,9893
2884,玉山金,12,0,12,元大-大天母,2024-07-31,9893
6578,達邦蛋白,12,0,12,元大-大天母,2024-07-31,9893
6116,彩晶,12,0,12,元大-大天母,2024-07-31,9893
3293,鈊象,11,0,11,元大-大天母,2024-07-31,9893
2348,海悅,17,6,11,元大-大天母,2024-07-31,9893
2547,日勝生,346,2,344,元大-大天母,2024-08-01,9893
2359,所羅門,236,9,227,元大-大天母,2024-08-01,9893
9955,佳龍,213,20,193,元大-大天母,2024-08-01,9893
5443,均豪,185,15,170,元大-大天母,2024-08-01,9893
00929,復華台灣科技優息,156,4,152,元大-大天母,2024-08-01,9893
00680L,元大美債20正2,102,0,102,元大-大天母,2024-08-01,9893
2542,興富發,80,0,80,元大-大天母,2024-08-01,9893
00687B,國泰20年美債,76,5,71,元大-大天母,2024-08-01,9893
00878,國泰永續高股息,66,6,60,元大-大天母,2024-08-01,9893
2891,中信金,80,24,56,元大-大天母,2024-08-01,9893
00934,中信成長高股息,58,5,53,元大-大天母,2024-08-01,9893
1710,東聯,50,1,49,元大-大天母,2024-08-01,9893
2882,國泰金,74,32,42,元大-大天母,2024-08-01,9893
2515,中工,59,19,40,元大-大天母,2024-08-01,9893
5905,南仁湖,40,0,40,元大-大天母,2024-08-01,9893
2881,富邦金,48,8,40,元大-大天母,2024-08-01,9893
00632R,元大台灣50反1,44,10,34,元大-大天母,2024-08-01,9893
9935,慶豐富,33,0,33,元大-大天母,2024-08-01,9893
5512,力麒,34,2,32,元大-大天母,2024-08-01,9893
2357,華碩,38,7,31,元大-大天母,2024-08-01,9893
3231,緯創,47,17,30,元大-大天母,2024-08-01,9893
2329,華泰,35,6,29,元大-大天母,2024-08-01,9893
00949,復華日本龍頭,29,0,29,元大-大天母,2024-08-01,9893
1314,中石化,50,21,29,元大-大天母,2024-08-01,9893
6239,力成,29,1,28,元大-大天母,2024-08-01,9893
5529,鉅陞,28,0,28,元大-大天母,2024-08-01,9893
2887,台新金,35,8,27,元大-大天母,2024-08-01,9893
2834,臺企銀,30,4,26,元大-大天母,2024-08-01,9893
2505,國揚,25,0,25,元大-大天母,2024-08-01,9893
5603,陸海,25,0,25,元大-大天母,2024-08-01,9893
2520,冠德,30,8,22,元大-大天母,2024-08-01,9893
8028,昇陽半導體,45,23,22,元大-大天母,2024-08-01,9893
00918,大華優利高填息30,34,13,21,元大-大天母,2024-08-01,9893
00676R,富邦臺灣加權反1,21,0,21,元大-大天母,2024-08-01,9893
1717,長興,30,10,20,元大-大天母,2024-08-01,9893
00857B,永豐20年美公債,20,0,20,元大-大天母,2024-08-01,9893
9930,中聯資源,20,0,20,元大-大天母,2024-08-01,9893
2363,矽統,46,27,19,元大-大天母,2024-08-01,9893
00679B,元大美債20年,44,25,19,元大-大天母,2024-08-01,9893
2449,京元電子,25,7,18,元大-大天母,2024-08-01,9893
2383,台光電,18,0,18,元大-大天母,2024-08-01,9893
00712,復華富時不動產,18,0,18,元大-大天母,2024-08-01,9893
2344,華邦電,20,3,17,元大-大天母,2024-08-01,9893
5876,上海商銀,17,0,17,元大-大天母,2024-08-01,9893
2610,華航,23,7,16,元大-大天母,2024-08-01,9893
1709,和益,21,5,16,元大-大天母,2024-08-01,9893
8105,凌巨,19,3,16,元大-大天母,2024-08-01,9893
1905,華紙,15,0,15,元大-大天母,2024-08-01,9893
5531,鄉林,15,0,15,元大-大天母,2024-08-01,9893
2486,一詮,34,19,15,元大-大天母,2024-08-01,9893
00940,元大台灣價值高息,309,8,301,元大-大天母,2024-08-02,9893
2891,中信金,353,97,256,元大-大天母,2024-08-02,9893
00878,國泰永續高股息,197,6,191,元大-大天母,2024-08-02,9893
2330,台積電,192,15,177,元大-大天母,2024-08-02,9893
00929,復華台灣科技優息,195,31,164,元大-大天母,2024-08-02,9893
2317,鴻海,168,19,149,元大-大天母,2024-08-02,9893
2887,台新金,152,5,147,元大-大天母,2024-08-02,9893
2337,旺宏,121,13,108,元大-大天母,2024-08-02,9893
3221,台嘉碩,102,0,102,元大-大天母,2024-08-02,9893
00680L,元大美債20正2,140,42,98,元大-大天母,2024-08-02,9893
2892,第一金,99,11,88,元大-大天母,2024-08-02,9893
2371,大同,123,41,82,元大-大天母,2024-08-02,9893
00919,群益台灣精選高息,107,26,81,元大-大天母,2024-08-02,9893
0056,元大高股息,93,14,79,元大-大天母,2024-08-02,9893
2885,元大金,74,1,73,元大-大天母,2024-08-02,9893
00679B,元大美債20年,119,52,67,元大-大天母,2024-08-02,9893
00687B,國泰20年美債,81,15,66,元大-大天母,2024-08-02,9893
00932,兆豐永續高息等權,64,0,64,元大-大天母,2024-08-02,9893
3037,欣興,54,1,53,元大-大天母,2024-08-02,9893
1528,恩德,52,0,52,元大-大天母,2024-08-02,9893
00881,國泰台灣5G+,65,15,50,元大-大天母,2024-08-02,9893
2501,國建,51,4,47,元大-大天母,2024-08-02,9893
3231,緯創,85,40,45,元大-大天母,2024-08-02,9893
00949,復華日本龍頭,46,1,45,元大-大天母,2024-08-02,9893
00951,台新日本半導體,44,0,44,元大-大天母,2024-08-02,9893
2382,廣達,51,7,44,元大-大天母,2024-08-02,9893
0050,元大台灣50,47,5,42,元大-大天母,2024-08-02,9893
9945,潤泰新,60,20,40,元大-大天母,2024-08-02,9893
2855,統一證,40,0,40,元大-大天母,2024-08-02,9893
00923,群益台ESG低碳50,38,0,38,元大-大天母,2024-08-02,9893
2408,南亞科,37,2,35,元大-大天母,2024-08-02,9893
6215,和椿,37,5,32,元大-大天母,2024-08-02,9893
2464,盟立,50,18,32,元大-大天母,2024-08-02,9893
00688L,國泰20年美債正2,32,0,32,元大-大天母,2024-08-02,9893
2834,臺企銀,30,0,30,元大-大天母,2024-08-02,9893
00948B,中信優息投資級債,30,0,30,元大-大天母,2024-08-02,9893
6239,力成,29,0,29,元大-大天母,2024-08-02,9893
00946,群益科技高息成長,28,0,28,元大-大天母,2024-08-02,9893
00947,台新臺灣IC設計,28,0,28,元大-大天母,2024-08-02,9893
2867,三商壽,27,0,27,元大-大天母,2024-08-02,9893
00631L,元大台灣50正2,37,10,27,元大-大天母,2024-08-02,9893
006208,富邦台50,28,2,26,元大-大天母,2024-08-02,9893
2514,龍邦,26,0,26,元大-大天母,2024-08-02,9893
00675L,富邦臺灣加權正2,25,0,25,元大-大天母,2024-08-02,9893
2303,聯電,50,25,25,元大-大天母,2024-08-02,9893
2880,華南金,26,4,22,元大-大天母,2024-08-02,9893
2481,強茂,23,1,22,元大-大天母,2024-08-02,9893
00640L,富邦日本正2,20,0,20,元大-大天母,2024-08-02,9893
00685L,群益臺灣加權正2,19,0,19,元大-大天母,2024-08-02,9893
2308,台達電,25,7,18,元大-大天母,2024-08-02,9893
00940,元大台灣價值高息,918,67,851,元大-大天母,2024-08-05,9893
2317,鴻海,371,44,327,元大-大天母,2024-08-05,9893
00929,復華台灣科技優息,369,61,308,元大-大天母,2024-08-05,9893
00878,國泰永續高股息,321,136,185,元大-大天母,2024-08-05,9893
2330,台積電,239,60,179,元大-大天母,2024-08-05,9893
2891,中信金,268,89,179,元大-大天母,2024-08-05,9893
2885,元大金,157,7,150,元大-大天母,2024-08-05,9893
00919,群益台灣精選高息,224,76,148,元大-大天母,2024-08-05,9893
1711,永光,151,8,143,元大-大天母,2024-08-05,9893
0056,元大高股息,139,17,122,元大-大天母,2024-08-05,9893
00679B,元大美債20年,338,225,113,元大-大天母,2024-08-05,9893
2887,台新金,105,0,105,元大-大天母,2024-08-05,9893
6239,力成,101,0,101,元大-大天母,2024-08-05,9893
00671R,富邦NASDAQ反1,107,6,101,元大-大天母,2024-08-05,9893
6152,百一,100,0,100,元大-大天母,2024-08-05,9893
00685L,群益臺灣加權正2,87,1,86,元大-大天母,2024-08-05,9893
1560,中砂,92,25,67,元大-大天母,2024-08-05,9893
6203,海韻電,62,0,62,元大-大天母,2024-08-05,9893
1584,精剛,60,1,59,元大-大天母,2024-08-05,9893
3481,群創,127,72,55,元大-大天母,2024-08-05,9893
2409,友達,62,10,52,元大-大天母,2024-08-05,9893
6257,矽格,53,3,50,元大-大天母,2024-08-05,9893
1903,士紙,52,4,48,元大-大天母,2024-08-05,9893
0050,元大台灣50,72,27,45,元大-大天母,2024-08-05,9893
3312,弘憶股,68,26,42,元大-大天母,2024-08-05,9893
2906,高林,40,0,40,元大-大天母,2024-08-05,9893
00674R,期元大S＆P黃金反1,40,0,40,元大-大天母,2024-08-05,9893
2371,大同,54,15,39,元大-大天母,2024-08-05,9893
2429,銘旺科,40,1,39,元大-大天母,2024-08-05,9893
006208,富邦台50,70,32,38,元大-大天母,2024-08-05,9893
2515,中工,36,0,36,元大-大天母,2024-08-05,9893
6121,新普,36,0,36,元大-大天母,2024-08-05,9893
8086,宏捷科,41,5,36,元大-大天母,2024-08-05,9893
00949,復華日本龍頭,36,0,36,元大-大天母,2024-08-05,9893
00922,國泰台灣領袖50,35,0,35,元大-大天母,2024-08-05,9893
2883,凱基金,56,21,35,元大-大天母,2024-08-05,9893
1605,華新,36,2,34,元大-大天母,2024-08-05,9893
00948B,中信優息投資級債,34,0,34,元大-大天母,2024-08-05,9893
4510,高鋒,121,88,33,元大-大天母,2024-08-05,9893
9927,泰銘,32,0,32,元大-大天母,2024-08-05,9893
00751B,元大AAA至A公司債,45,13,32,元大-大天母,2024-08-05,9893
2882,國泰金,110,79,31,元大-大天母,2024-08-05,9893
00764B,群益25年美債,30,0,30,元大-大天母,2024-08-05,9893
3532,台勝科,30,0,30,元大-大天母,2024-08-05,9893
00890B,凱基ESG BBB債,30,0,30,元大-大天母,2024-08-05,9893
2538,基泰,30,0,30,元大-大天母,2024-08-05,9893
2301,光寶科,51,21,30,元大-大天母,2024-08-05,9893
1219,福壽,28,0,28,元大-大天母,2024-08-05,9893
2881,富邦金,154,127,27,元大-大天母,2024-08-05,9893
2303,聯電,50,22,28,元大-大天母,2024-08-05,9893
2329,華泰,998,20,978,元大-大天母,2024-08-06,9893
1503,士電,318,106,212,元大-大天母,2024-08-06,9893
00878,國泰永續高股息,148,14,134,元大-大天母,2024-08-06,9893
00940,元大台灣價值高息,210,80,130,元大-大天母,2024-08-06,9893
2359,所羅門,157,30,127,元大-大天母,2024-08-06,9893
8028,昇陽半導體,118,20,98,元大-大天母,2024-08-06,9893
5534,長虹,94,3,91,元大-大天母,2024-08-06,9893
1319,東陽,90,0,90,元大-大天母,2024-08-06,9893
1513,中興電,126,39,87,元大-大天母,2024-08-06,9893
2883,凱基金,87,3,84,元大-大天母,2024-08-06,9893
2204,中華,85,1,84,元大-大天母,2024-08-06,9893
1711,永光,90,10,80,元大-大天母,2024-08-06,9893
00761B,國泰A級公司債,70,0,70,元大-大天母,2024-08-06,9893
3221,台嘉碩,63,1,62,元大-大天母,2024-08-06,9893
2801,彰銀,56,1,55,元大-大天母,2024-08-06,9893
4526,東台,55,2,53,元大-大天母,2024-08-06,9893
3481,群創,117,64,53,元大-大天母,2024-08-06,9893
2356,英業達,62,10,52,元大-大天母,2024-08-06,9893
00937B,群益ESG投等債20,66,15,51,元大-大天母,2024-08-06,9893
2382,廣達,111,60,51,元大-大天母,2024-08-06,9893
0050,元大台灣50,96,46,50,元大-大天母,2024-08-06,9893
8210,勤誠,53,7,46,元大-大天母,2024-08-06,9893
2371,大同,57,12,45,元大-大天母,2024-08-06,9893
1519,華城,50,7,43,元大-大天母,2024-08-06,9893
00934,中信成長高股息,42,1,41,元大-大天母,2024-08-06,9893
2892,第一金,81,42,39,元大-大天母,2024-08-06,9893
2409,友達,41,3,38,元大-大天母,2024-08-06,9893
3501,維熹,35,0,35,元大-大天母,2024-08-06,9893
5521,工信,55,21,34,元大-大天母,2024-08-06,9893
3163,波若威,37,3,34,元大-大天母,2024-08-06,9893
2884,玉山金,73,40,33,元大-大天母,2024-08-06,9893
2887,台新金,39,7,32,元大-大天母,2024-08-06,9893
6264,富裔,31,0,31,元大-大天母,2024-08-06,9893
3213,茂訊,30,0,30,元大-大天母,2024-08-06,9893
5512,力麒,31,1,30,元大-大天母,2024-08-06,9893
00890B,凱基ESG BBB債,30,0,30,元大-大天母,2024-08-06,9893
2812,台中銀,36,6,30,元大-大天母,2024-08-06,9893
1560,中砂,35,6,29,元大-大天母,2024-08-06,9893
8105,凌巨,31,2,29,元大-大天母,2024-08-06,9893
2515,中工,28,0,28,元大-大天母,2024-08-06,9893
2834,臺企銀,42,15,27,元大-大天母,2024-08-06,9893
3706,神達,29,4,25,元大-大天母,2024-08-06,9893
2610,華航,49,24,25,元大-大天母,2024-08-06,9893
2543,皇昌,49,25,24,元大-大天母,2024-08-06,9893
00715L,期街口布蘭特正2,24,0,24,元大-大天母,2024-08-06,9893
2618,長榮航,33,10,23,元大-大天母,2024-08-06,9893
3376,新日興,28,5,23,元大-大天母,2024-08-06,9893
2886,兆豐金,35,13,22,元大-大天母,2024-08-06,9893
0056,元大高股息,74,53,21,元大-大天母,2024-08-06,9893
00945B,凱基美國非投等債,21,0,21,元大-大天母,2024-08-06,9893
00632R,元大台灣50反1,917,205,712,元大-大天母,2024-08-07,9893
9938,百和,284,0,284,元大-大天母,2024-08-07,9893
00676R,富邦臺灣加權反1,260,10,250,元大-大天母,2024-08-07,9893
8404,百和興業-KY,199,0,199,元大-大天母,2024-08-07,9893
2317,鴻海,234,63,171,元大-大天母,2024-08-07,9893
00751B,元大AAA至A公司債,157,15,142,元大-大天母,2024-08-07,9893
2880,華南金,130,1,129,元大-大天母,2024-08-07,9893
1710,東聯,110,0,110,元大-大天母,2024-08-07,9893
00679B,元大美債20年,151,51,100,元大-大天母,2024-08-07,9893
0056,元大高股息,110,19,91,元大-大天母,2024-08-07,9893
00722B,群益投資級電信債,90,0,90,元大-大天母,2024-08-07,9893
2409,友達,79,0,79,元大-大天母,2024-08-07,9893
6026,福邦證,66,0,66,元大-大天母,2024-08-07,9893
00687B,國泰20年美債,169,104,65,元大-大天母,2024-08-07,9893
00940,元大台灣價值高息,157,97,60,元大-大天母,2024-08-07,9893
00937B,群益ESG投等債20,52,0,52,元大-大天母,2024-08-07,9893
6664,群翊,50,0,50,元大-大天母,2024-08-07,9893
00933B,國泰10Y+金融債,46,0,46,元大-大天母,2024-08-07,9893
4974,亞泰,45,0,45,元大-大天母,2024-08-07,9893
00680L,元大美債20正2,139,100,39,元大-大天母,2024-08-07,9893
2618,長榮航,44,13,31,元大-大天母,2024-08-07,9893
00665L,富邦�琤肭磪囓�2,30,0,30,元大-大天母,2024-08-07,9893
2881,富邦金,41,12,29,元大-大天母,2024-08-07,9893
00878,國泰永續高股息,49,22,27,元大-大天母,2024-08-07,9893
00919,群益台灣精選高息,39,15,24,元大-大天母,2024-08-07,9893
00706L,期元大S＆P日圓正2,25,1,24,元大-大天母,2024-08-07,9893
2887,台新金,23,0,23,元大-大天母,2024-08-07,9893
2892,第一金,37,14,23,元大-大天母,2024-08-07,9893
1711,永光,20,0,20,元大-大天母,2024-08-07,9893
1309,台達化,20,0,20,元大-大天母,2024-08-07,9893
2354,鴻準,22,2,20,元大-大天母,2024-08-07,9893
6285,啟��,20,0,20,元大-大天母,2024-08-07,9893
00929,復華台灣科技優息,55,39,16,元大-大天母,2024-08-07,9893
6278,台表科,22,7,15,元大-大天母,2024-08-07,9893
2382,廣達,38,23,15,元大-大天母,2024-08-07,9893
00720B,元大投資級公司債,20,5,15,元大-大天母,2024-08-07,9893
3034,聯詠,17,3,14,元大-大天母,2024-08-07,9893
2886,兆豐金,28,14,14,元大-大天母,2024-08-07,9893
00795B,中信美國公債20年,23,9,14,元大-大天母,2024-08-07,9893
1513,中興電,18,5,13,元大-大天母,2024-08-07,9893
00764B,群益25年美債,14,1,13,元大-大天母,2024-08-07,9893
2834,臺企銀,16,3,13,元大-大天母,2024-08-07,9893
2356,英業達,21,9,12,元大-大天母,2024-08-07,9893
00712,復華富時不動產,12,0,12,元大-大天母,2024-08-07,9893
2363,矽統,17,5,12,元大-大天母,2024-08-07,9893
2890,永豐金,11,0,11,元大-大天母,2024-08-07,9893
00949,復華日本龍頭,11,0,11,元大-大天母,2024-08-07,9893
00642U,期元大S＆P石油,11,0,11,元大-大天母,2024-08-07,9893
5309,系統電,11,0,11,元大-大天母,2024-08-07,9893
00922,國泰台灣領袖50,10,0,10,元大-大天母,2024-08-07,9893
2520,冠德,503,152,351,元大-大天母,2024-08-08,9893
9958,世紀鋼,263,0,263,元大-大天母,2024-08-08,9893
00680L,元大美債20正2,206,52,154,元大-大天母,2024-08-08,9893
00679B,元大美債20年,243,91,152,元大-大天母,2024-08-08,9893
00687B,國泰20年美債,157,7,150,元大-大天母,2024-08-08,9893
2886,兆豐金,132,11,121,元大-大天母,2024-08-08,9893
00751B,元大AAA至A公司債,107,0,107,元大-大天母,2024-08-08,9893
00929,復華台灣科技優息,127,21,106,元大-大天母,2024-08-08,9893
00878,國泰永續高股息,129,24,105,元大-大天母,2024-08-08,9893
2359,所羅門,120,17,103,元大-大天母,2024-08-08,9893
6160,欣技,104,4,100,元大-大天母,2024-08-08,9893
2888,新光金,102,3,99,元大-大天母,2024-08-08,9893
3167,大量,150,57,93,元大-大天母,2024-08-08,9893
00881,國泰台灣5G+,95,5,90,元大-大天母,2024-08-08,9893
00937B,群益ESG投等債20,93,10,83,元大-大天母,2024-08-08,9893
00665L,富邦�琤肭磪囓�2,100,30,70,元大-大天母,2024-08-08,9893
4714,永捷,60,2,58,元大-大天母,2024-08-08,9893
2880,華南金,53,2,51,元大-大天母,2024-08-08,9893
1314,中石化,82,31,51,元大-大天母,2024-08-08,9893
00933B,國泰10Y+金融債,50,0,50,元大-大天母,2024-08-08,9893
6213,聯茂,80,33,47,元大-大天母,2024-08-08,9893
2382,廣達,56,10,46,元大-大天母,2024-08-08,9893
00919,群益台灣精選高息,46,3,43,元大-大天母,2024-08-08,9893
6223,旺矽,42,1,41,元大-大天母,2024-08-08,9893
2408,南亞科,40,1,39,元大-大天母,2024-08-08,9893
3711,日月光投控,43,6,37,元大-大天母,2024-08-08,9893
2345,智邦,32,0,32,元大-大天母,2024-08-08,9893
2537,聯上發,33,1,32,元大-大天母,2024-08-08,9893
3024,憶聲,30,0,30,元大-大天母,2024-08-08,9893
00940,元大台灣價值高息,46,16,30,元大-大天母,2024-08-08,9893
6165,浪凡,28,0,28,元大-大天母,2024-08-08,9893
2884,玉山金,27,0,27,元大-大天母,2024-08-08,9893
2344,華邦電,28,2,26,元大-大天母,2024-08-08,9893
00671R,富邦NASDAQ反1,25,0,25,元大-大天母,2024-08-08,9893
3231,緯創,95,72,23,元大-大天母,2024-08-08,9893
1436,華友聯,21,0,21,元大-大天母,2024-08-08,9893
00949,復華日本龍頭,21,0,21,元大-大天母,2024-08-08,9893
2610,華航,21,2,19,元大-大天母,2024-08-08,9893
00795B,中信美國公債20年,19,0,19,元大-大天母,2024-08-08,9893
2365,昆盈,88,70,18,元大-大天母,2024-08-08,9893
1903,士紙,17,0,17,元大-大天母,2024-08-08,9893
2486,一詮,22,5,17,元大-大天母,2024-08-08,9893
6603,富強鑫,18,2,16,元大-大天母,2024-08-08,9893
5607,遠雄港,21,6,15,元大-大天母,2024-08-08,9893
2881,富邦金,51,37,14,元大-大天母,2024-08-08,9893
3481,群創,25,11,14,元大-大天母,2024-08-08,9893
6278,台表科,22,8,14,元大-大天母,2024-08-08,9893
4958,臻鼎-KY,14,1,13,元大-大天母,2024-08-08,9893
2883,凱基金,12,0,12,元大-大天母,2024-08-08,9893
6139,亞翔,12,0,12,元大-大天母,2024-08-08,9893
3481,群創,561,37,524,元大-大天母,2024-08-09,9893
00676R,富邦臺灣加權反1,500,0,500,元大-大天母,2024-08-09,9893
00679B,元大美債20年,447,28,419,元大-大天母,2024-08-09,9893
00665L,富邦�琤肭磪囓�2,360,0,360,元大-大天母,2024-08-09,9893
2615,萬海,217,13,204,元大-大天母,2024-08-09,9893
00937B,群益ESG投等債20,180,0,180,元大-大天母,2024-08-09,9893
3231,緯創,322,197,125,元大-大天母,2024-08-09,9893
00751B,元大AAA至A公司債,111,0,111,元大-大天母,2024-08-09,9893
00878,國泰永續高股息,104,15,89,元大-大天母,2024-08-09,9893
00680L,元大美債20正2,84,0,84,元大-大天母,2024-08-09,9893
6603,富強鑫,120,40,80,元大-大天母,2024-08-09,9893
00688L,國泰20年美債正2,75,0,75,元大-大天母,2024-08-09,9893
2353,宏��,74,6,68,元大-大天母,2024-08-09,9893
6285,啟��,65,13,52,元大-大天母,2024-08-09,9893
00933B,國泰10Y+金融債,51,0,51,元大-大天母,2024-08-09,9893
00900,富邦特選高股息30,52,2,50,元大-大天母,2024-08-09,9893
2880,華南金,51,8,43,元大-大天母,2024-08-09,9893
6770,力積電,42,0,42,元大-大天母,2024-08-09,9893
00919,群益台灣精選高息,42,7,35,元大-大天母,2024-08-09,9893
00761B,國泰A級公司債,30,0,30,元大-大天母,2024-08-09,9893
00890B,凱基ESG BBB債,30,0,30,元大-大天母,2024-08-09,9893
4564,元翎,30,0,30,元大-大天母,2024-08-09,9893
1560,中砂,33,3,30,元大-大天母,2024-08-09,9893
6239,力成,31,3,28,元大-大天母,2024-08-09,9893
8069,元太,40,12,28,元大-大天母,2024-08-09,9893
00795B,中信美國公債20年,44,17,27,元大-大天母,2024-08-09,9893
9105,泰金寶-DR,24,0,24,元大-大天母,2024-08-09,9893
6223,旺矽,22,1,21,元大-大天母,2024-08-09,9893
6294,智基,20,0,20,元大-大天母,2024-08-09,9893
6799,來頡,20,0,20,元大-大天母,2024-08-09,9893
2014,中鴻,21,1,20,元大-大天母,2024-08-09,9893
00671R,富邦NASDAQ反1,20,0,20,元大-大天母,2024-08-09,9893
8021,尖點,20,0,20,元大-大天母,2024-08-09,9893
00720B,元大投資級公司債,20,0,20,元大-大天母,2024-08-09,9893
6160,欣技,20,1,19,元大-大天母,2024-08-09,9893
3714,富采,34,15,19,元大-大天母,2024-08-09,9893
4533,協易機,35,17,18,元大-大天母,2024-08-09,9893
5432,新門,18,0,18,元大-大天母,2024-08-09,9893
5443,均豪,31,13,18,元大-大天母,2024-08-09,9893
2886,兆豐金,23,6,17,元大-大天母,2024-08-09,9893
3324,雙鴻,24,7,17,元大-大天母,2024-08-09,9893
1805,寶徠,17,0,17,元大-大天母,2024-08-09,9893
8096,擎亞,28,12,16,元大-大天母,2024-08-09,9893
00948B,中信優息投資級債,16,0,16,元大-大天母,2024-08-09,9893
00945B,凱基美國非投等債,16,0,16,元大-大天母,2024-08-09,9893
00753L,中信中國50正2,16,0,16,元大-大天母,2024-08-09,9893
2892,第一金,21,5,16,元大-大天母,2024-08-09,9893
3044,健鼎,15,0,15,元大-大天母,2024-08-09,9893
1785,光洋科,25,10,15,元大-大天母,2024-08-09,9893
2360,致茂,15,0,15,元大-大天母,2024-08-09,9893
00676R,富邦臺灣加權反1,519,0,519,元大-大天母,2024-08-12,9893
00632R,元大台灣50反1,458,10,448,元大-大天母,2024-08-12,9893
3481,群創,217,44,173,元大-大天母,2024-08-12,9893
2891,中信金,150,75,75,元大-大天母,2024-08-12,9893
3024,憶聲,98,26,72,元大-大天母,2024-08-12,9893
00929,復華台灣科技優息,61,8,53,元大-大天母,2024-08-12,9893
3048,益登,59,7,52,元大-大天母,2024-08-12,9893
3379,彬台,49,0,49,元大-大天母,2024-08-12,9893
5443,均豪,51,2,49,元大-大天母,2024-08-12,9893
2312,金寶,107,60,47,元大-大天母,2024-08-12,9893
3583,辛耘,60,13,47,元大-大天母,2024-08-12,9893
1519,華城,49,5,44,元大-大天母,2024-08-12,9893
2881,富邦金,45,3,42,元大-大天母,2024-08-12,9893
4562,穎漢,54,15,39,元大-大天母,2024-08-12,9893
5534,長虹,40,2,38,元大-大天母,2024-08-12,9893
6415,矽力*-KY,36,0,36,元大-大天母,2024-08-12,9893
2883,凱基金,36,0,36,元大-大天母,2024-08-12,9893
00919,群益台灣精選高息,36,1,35,元大-大天母,2024-08-12,9893
00900,富邦特選高股息30,38,4,34,元大-大天母,2024-08-12,9893
00937B,群益ESG投等債20,31,0,31,元大-大天母,2024-08-12,9893
00878,國泰永續高股息,34,4,30,元大-大天母,2024-08-12,9893
3518,柏騰,40,10,30,元大-大天母,2024-08-12,9893
6190,萬泰科,26,0,26,元大-大天母,2024-08-12,9893
00679B,元大美債20年,100,75,25,元大-大天母,2024-08-12,9893
4938,和碩,26,1,25,元大-大天母,2024-08-12,9893
6806,森崴能源,25,2,23,元大-大天母,2024-08-12,9893
1522,堤維西,27,5,22,元大-大天母,2024-08-12,9893
3045,台灣大,20,0,20,元大-大天母,2024-08-12,9893
6294,智基,20,0,20,元大-大天母,2024-08-12,9893
006206,元大上證50,20,0,20,元大-大天母,2024-08-12,9893
6706,惠特,25,5,20,元大-大天母,2024-08-12,9893
1717,長興,20,0,20,元大-大天母,2024-08-12,9893
2915,潤泰全,20,1,19,元大-大天母,2024-08-12,9893
1597,直得,44,25,19,元大-大天母,2024-08-12,9893
1609,大亞,59,43,16,元大-大天母,2024-08-12,9893
6239,力成,16,0,16,元大-大天母,2024-08-12,9893
1326,台化,16,0,16,元大-大天母,2024-08-12,9893
00673R,期元大S＆P原油反1,15,0,15,元大-大天母,2024-08-12,9893
3019,亞光,42,27,15,元大-大天母,2024-08-12,9893
4523,永彰,18,5,13,元大-大天母,2024-08-12,9893
00907,永豐優息存股,13,0,13,元大-大天母,2024-08-12,9893
2610,華航,24,12,12,元大-大天母,2024-08-12,9893
4306,炎洲,12,0,12,元大-大天母,2024-08-12,9893
2104,國際中橡,12,0,12,元大-大天母,2024-08-12,9893
8028,昇陽半導體,14,2,12,元大-大天母,2024-08-12,9893
3535,晶彩科,14,2,12,元大-大天母,2024-08-12,9893
00918,大華優利高填息30,13,2,11,元大-大天母,2024-08-12,9893
4908,前鼎,11,0,11,元大-大天母,2024-08-12,9893
2543,皇昌,31,20,11,元大-大天母,2024-08-12,9893
2353,宏��,14,4,10,元大-大天母,2024-08-12,9893
3481,群創,722,7,715,元大-大天母,2024-08-13,9893
00676R,富邦臺灣加權反1,501,0,501,元大-大天母,2024-08-13,9893
00673R,期元大S＆P原油反1,134,0,134,元大-大天母,2024-08-13,9893
2886,兆豐金,95,4,91,元大-大天母,2024-08-13,9893
00679B,元大美債20年,93,7,86,元大-大天母,2024-08-13,9893
4714,永捷,62,2,60,元大-大天母,2024-08-13,9893
2880,華南金,54,1,53,元大-大天母,2024-08-13,9893
8091,翔名,50,0,50,元大-大天母,2024-08-13,9893
2882,國泰金,46,1,45,元大-大天母,2024-08-13,9893
00878,國泰永續高股息,63,19,44,元大-大天母,2024-08-13,9893
2891,中信金,93,51,42,元大-大天母,2024-08-13,9893
6629,泰金-KY,42,0,42,元大-大天母,2024-08-13,9893
3231,緯創,62,22,40,元大-大天母,2024-08-13,9893
00632R,元大台灣50反1,39,0,39,元大-大天母,2024-08-13,9893
3013,晟銘電,190,154,36,元大-大天母,2024-08-13,9893
6285,啟��,46,11,35,元大-大天母,2024-08-13,9893
2836,高雄銀,32,0,32,元大-大天母,2024-08-13,9893
2603,長榮,41,11,30,元大-大天母,2024-08-13,9893
00687B,國泰20年美債,28,0,28,元大-大天母,2024-08-13,9893
6282,康舒,27,2,25,元大-大天母,2024-08-13,9893
2382,廣達,29,6,23,元大-大天母,2024-08-13,9893
2888,新光金,33,10,23,元大-大天母,2024-08-13,9893
2486,一詮,25,2,23,元大-大天母,2024-08-13,9893
3583,辛耘,31,9,22,元大-大天母,2024-08-13,9893
2615,萬海,23,1,22,元大-大天母,2024-08-13,9893
00940,元大台灣價值高息,25,4,21,元大-大天母,2024-08-13,9893
006206,元大上證50,20,0,20,元大-大天母,2024-08-13,9893
1513,中興電,36,18,18,元大-大天母,2024-08-13,9893
3379,彬台,30,14,16,元大-大天母,2024-08-13,9893
00937B,群益ESG投等債20,15,0,15,元大-大天母,2024-08-13,9893
2208,台船,15,0,15,元大-大天母,2024-08-13,9893
6122,擎邦,15,0,15,元大-大天母,2024-08-13,9893
00772B,中信高評級公司債,15,0,15,元大-大天母,2024-08-13,9893
2609,陽明,55,40,15,元大-大天母,2024-08-13,9893
00904,新光臺灣半導體30,15,0,15,元大-大天母,2024-08-13,9893
2476,鉅祥,20,6,14,元大-大天母,2024-08-13,9893
2020,美亞,14,0,14,元大-大天母,2024-08-13,9893
2884,玉山金,13,0,13,元大-大天母,2024-08-13,9893
2365,昆盈,56,43,13,元大-大天母,2024-08-13,9893
2493,揚博,13,0,13,元大-大天母,2024-08-13,9893
2610,華航,13,1,12,元大-大天母,2024-08-13,9893
4576,大銀微系統,20,8,12,元大-大天母,2024-08-13,9893
3048,益登,15,3,12,元大-大天母,2024-08-13,9893
8937,合騏,23,11,12,元大-大天母,2024-08-13,9893
5905,南仁湖,11,0,11,元大-大天母,2024-08-13,9893
4566,時碩工業,39,28,11,元大-大天母,2024-08-13,9893
00934,中信成長高股息,10,0,10,元大-大天母,2024-08-13,9893
3706,神達,25,15,10,元大-大天母,2024-08-13,9893
2108,南帝,10,0,10,元大-大天母,2024-08-13,9893
5512,力麒,10,0,10,元大-大天母,2024-08-13,9893
00687B,國泰20年美債,240,0,240,元大-大天母,2024-08-14,9893
6451,訊芯-KY,152,1,151,元大-大天母,2024-08-14,9893
4562,穎漢,123,16,107,元大-大天母,2024-08-14,9893
3035,智原,103,3,100,元大-大天母,2024-08-14,9893
3481,群創,195,110,85,元大-大天母,2024-08-14,9893
00937B,群益ESG投等債20,115,40,75,元大-大天母,2024-08-14,9893
00680L,元大美債20正2,87,14,73,元大-大天母,2024-08-14,9893
1702,南僑,70,0,70,元大-大天母,2024-08-14,9893
3438,類比科,68,0,68,元大-大天母,2024-08-14,9893
2836,高雄銀,54,2,52,元大-大天母,2024-08-14,9893
6152,百一,50,0,50,元大-大天母,2024-08-14,9893
00676R,富邦臺灣加權反1,50,0,50,元大-大天母,2024-08-14,9893
2356,英業達,89,42,47,元大-大天母,2024-08-14,9893
3062,建漢,55,10,45,元大-大天母,2024-08-14,9893
2408,南亞科,46,5,41,元大-大天母,2024-08-14,9893
6285,啟��,40,0,40,元大-大天母,2024-08-14,9893
1605,華新,40,2,38,元大-大天母,2024-08-14,9893
2845,遠東銀,37,0,37,元大-大天母,2024-08-14,9893
4563,百德,36,4,32,元大-大天母,2024-08-14,9893
2603,長榮,81,51,30,元大-大天母,2024-08-14,9893
3715,定穎投控,35,6,29,元大-大天母,2024-08-14,9893
2534,宏盛,28,0,28,元大-大天母,2024-08-14,9893
2464,盟立,47,20,27,元大-大天母,2024-08-14,9893
2352,佳世達,25,1,24,元大-大天母,2024-08-14,9893
00948B,中信優息投資級債,44,20,24,元大-大天母,2024-08-14,9893
9958,世紀鋼,22,1,21,元大-大天母,2024-08-14,9893
00932,兆豐永續高息等權,20,0,20,元大-大天母,2024-08-14,9893
3661,世芯-KY,23,3,20,元大-大天母,2024-08-14,9893
00900,富邦特選高股息30,32,12,20,元大-大天母,2024-08-14,9893
2801,彰銀,34,15,19,元大-大天母,2024-08-14,9893
2915,潤泰全,20,1,19,元大-大天母,2024-08-14,9893
2317,鴻海,41,23,18,元大-大天母,2024-08-14,9893
6187,萬潤,28,11,17,元大-大天母,2024-08-14,9893
00795B,中信美國公債20年,17,0,17,元大-大天母,2024-08-14,9893
00934,中信成長高股息,16,0,16,元大-大天母,2024-08-14,9893
2493,揚博,16,0,16,元大-大天母,2024-08-14,9893
8150,南茂,15,0,15,元大-大天母,2024-08-14,9893
2365,昆盈,112,97,15,元大-大天母,2024-08-14,9893
00951,台新日本半導體,15,0,15,元大-大天母,2024-08-14,9893
9945,潤泰新,39,24,15,元大-大天母,2024-08-14,9893
2867,三商壽,155,140,15,元大-大天母,2024-08-14,9893
00881,國泰台灣5G+,30,16,14,元大-大天母,2024-08-14,9893
2886,兆豐金,16,2,14,元大-大天母,2024-08-14,9893
4909,新復興,16,2,14,元大-大天母,2024-08-14,9893
1513,中興電,37,24,13,元大-大天母,2024-08-14,9893
00905,FT臺灣Smart,14,1,13,元大-大天母,2024-08-14,9893
6117,迎廣,16,3,13,元大-大天母,2024-08-14,9893
00679B,元大美債20年,24,11,13,元大-大天母,2024-08-14,9893
2355,敬鵬,11,0,11,元大-大天母,2024-08-14,9893
8043,蜜望實,17,6,11,元大-大天母,2024-08-14,9893
00900,富邦特選高股息30,176,1,175,元大-大天母,2024-08-15,9893
00679B,元大美債20年,189,24,165,元大-大天母,2024-08-15,9893
00945B,凱基美國非投等債,146,0,146,元大-大天母,2024-08-15,9893
00878,國泰永續高股息,170,24,146,元大-大天母,2024-08-15,9893
1702,南僑,117,0,117,元大-大天母,2024-08-15,9893
3167,大量,204,101,103,元大-大天母,2024-08-15,9893
1314,中石化,80,0,80,元大-大天母,2024-08-15,9893
00929,復華台灣科技優息,72,9,63,元大-大天母,2024-08-15,9893
00680L,元大美債20正2,115,55,60,元大-大天母,2024-08-15,9893
00632R,元大台灣50反1,55,0,55,元大-大天母,2024-08-15,9893
00687B,國泰20年美債,55,16,39,元大-大天母,2024-08-15,9893
8210,勤誠,55,17,38,元大-大天母,2024-08-15,9893
00715L,期街口布蘭特正2,31,0,31,元大-大天母,2024-08-15,9893
3390,旭軟,31,0,31,元大-大天母,2024-08-15,9893
2891,中信金,151,125,26,元大-大天母,2024-08-15,9893
00795B,中信美國公債20年,25,0,25,元大-大天母,2024-08-15,9893
3013,晟銘電,54,29,25,元大-大天母,2024-08-15,9893
2317,鴻海,40,17,23,元大-大天母,2024-08-15,9893
2880,華南金,23,0,23,元大-大天母,2024-08-15,9893
5469,瀚宇博,23,1,22,元大-大天母,2024-08-15,9893
4540,全球傳動,134,113,21,元大-大天母,2024-08-15,9893
2365,昆盈,48,27,21,元大-大天母,2024-08-15,9893
2886,兆豐金,25,4,21,元大-大天母,2024-08-15,9893
6285,啟��,20,0,20,元大-大天母,2024-08-15,9893
3045,台灣大,20,0,20,元大-大天母,2024-08-15,9893
3052,夆典,20,0,20,元大-大天母,2024-08-15,9893
2915,潤泰全,20,0,20,元大-大天母,2024-08-15,9893
00948B,中信優息投資級債,20,0,20,元大-大天母,2024-08-15,9893
6190,萬泰科,22,3,19,元大-大天母,2024-08-15,9893
00934,中信成長高股息,19,0,19,元大-大天母,2024-08-15,9893
2493,揚博,16,0,16,元大-大天母,2024-08-15,9893
2882,國泰金,17,1,16,元大-大天母,2024-08-15,9893
00919,群益台灣精選高息,16,1,15,元大-大天母,2024-08-15,9893
6629,泰金-KY,15,0,15,元大-大天母,2024-08-15,9893
2489,瑞軒,71,56,15,元大-大天母,2024-08-15,9893
0056,元大高股息,20,6,14,元大-大天母,2024-08-15,9893
2352,佳世達,18,4,14,元大-大天母,2024-08-15,9893
3501,維熹,14,0,14,元大-大天母,2024-08-15,9893
1805,寶徠,14,0,14,元大-大天母,2024-08-15,9893
00933B,國泰10Y+金融債,14,0,14,元大-大天母,2024-08-15,9893
2367,燿華,18,5,13,元大-大天母,2024-08-15,9893
00772B,中信高評級公司債,13,0,13,元大-大天母,2024-08-15,9893
9945,潤泰新,18,5,13,元大-大天母,2024-08-15,9893
2885,元大金,18,5,13,元大-大天母,2024-08-15,9893
2002,中鋼,14,2,12,元大-大天母,2024-08-15,9893
2408,南亞科,12,0,12,元大-大天母,2024-08-15,9893
00753L,中信中國50正2,12,0,12,元大-大天母,2024-08-15,9893
8299,群聯,20,8,12,元大-大天母,2024-08-15,9893
2327,國巨,12,1,11,元大-大天母,2024-08-15,9893
00936,台新永續高息中小,11,0,11,元大-大天母,2024-08-15,9893
00937B,群益ESG投等債20,567,63,504,元大-大天母,2024-08-16,9893
00688L,國泰20年美債正2,502,75,427,元大-大天母,2024-08-16,9893
2542,興富發,436,13,423,元大-大天母,2024-08-16,9893
00687B,國泰20年美債,214,3,211,元大-大天母,2024-08-16,9893
1503,士電,208,4,204,元大-大天母,2024-08-16,9893
00679B,元大美債20年,196,17,179,元大-大天母,2024-08-16,9893
2388,威盛,143,4,139,元大-大天母,2024-08-16,9893
2891,中信金,147,37,110,元大-大天母,2024-08-16,9893
00751B,元大AAA至A公司債,115,11,104,元大-大天母,2024-08-16,9893
6462,神盾,101,3,98,元大-大天母,2024-08-16,9893
8210,勤誠,107,14,93,元大-大天母,2024-08-16,9893
00720B,元大投資級公司債,88,0,88,元大-大天母,2024-08-16,9893
2062,橋椿,181,93,88,元大-大天母,2024-08-16,9893
00881,國泰台灣5G+,83,2,81,元大-大天母,2024-08-16,9893
00680L,元大美債20正2,82,15,67,元大-大天母,2024-08-16,9893
4562,穎漢,126,61,65,元大-大天母,2024-08-16,9893
1702,南僑,58,0,58,元大-大天母,2024-08-16,9893
00945B,凱基美國非投等債,49,0,49,元大-大天母,2024-08-16,9893
00929,復華台灣科技優息,52,7,45,元大-大天母,2024-08-16,9893
00932,兆豐永續高息等權,43,0,43,元大-大天母,2024-08-16,9893
1416,廣豐,50,8,42,元大-大天母,2024-08-16,9893
00795B,中信美國公債20年,42,0,42,元大-大天母,2024-08-16,9893
00760B,復華新興企業債,40,0,40,元大-大天母,2024-08-16,9893
8021,尖點,43,4,39,元大-大天母,2024-08-16,9893
8070,長華*,39,2,37,元大-大天母,2024-08-16,9893
1560,中砂,41,9,32,元大-大天母,2024-08-16,9893
5488,松普,30,0,30,元大-大天母,2024-08-16,9893
6869,雲豹能源,28,1,27,元大-大天母,2024-08-16,9893
00931B,統一美債20年,26,0,26,元大-大天母,2024-08-16,9893
2867,三商壽,28,5,23,元大-大天母,2024-08-16,9893
6294,智基,21,0,21,元大-大天母,2024-08-16,9893
00676R,富邦臺灣加權反1,20,0,20,元大-大天母,2024-08-16,9893
2537,聯上發,21,2,19,元大-大天母,2024-08-16,9893
2014,中鴻,20,1,19,元大-大天母,2024-08-16,9893
9105,泰金寶-DR,23,5,18,元大-大天母,2024-08-16,9893
3712,永崴投控,21,5,16,元大-大天母,2024-08-16,9893
00919,群益台灣精選高息,22,6,16,元大-大天母,2024-08-16,9893
00934,中信成長高股息,16,0,16,元大-大天母,2024-08-16,9893
00948B,中信優息投資級債,15,0,15,元大-大天母,2024-08-16,9893
3024,憶聲,15,0,15,元大-大天母,2024-08-16,9893
1536,和大,39,24,15,元大-大天母,2024-08-16,9893
00713,元大台灣高息低波,14,0,14,元大-大天母,2024-08-16,9893
2408,南亞科,17,3,14,元大-大天母,2024-08-16,9893
2363,矽統,26,12,14,元大-大天母,2024-08-16,9893
3447,展達,14,0,14,元大-大天母,2024-08-16,9893
2337,旺宏,16,2,14,元大-大天母,2024-08-16,9893
1218,泰山,14,0,14,元大-大天母,2024-08-16,9893
1903,士紙,14,1,13,元大-大天母,2024-08-16,9893
2486,一詮,22,10,12,元大-大天母,2024-08-16,9893
6278,台表科,17,5,12,元大-大天母,2024-08-16,9893
00687B,國泰20年美債,228,3,225,元大-大天母,2024-08-19,9893
00795B,中信美國公債20年,207,0,207,元大-大天母,2024-08-19,9893
3694,海華,205,0,205,元大-大天母,2024-08-19,9893
00929,復華台灣科技優息,215,20,195,元大-大天母,2024-08-19,9893
00937B,群益ESG投等債20,263,86,177,元大-大天母,2024-08-19,9893
2888,新光金,262,119,143,元大-大天母,2024-08-19,9893
2323,中環,110,7,103,元大-大天母,2024-08-19,9893
2359,所羅門,142,44,98,元大-大天母,2024-08-19,9893
00679B,元大美債20年,123,30,93,元大-大天母,2024-08-19,9893
1416,廣豐,76,0,76,元大-大天母,2024-08-19,9893
00948B,中信優息投資級債,72,0,72,元大-大天母,2024-08-19,9893
2062,橋椿,103,43,60,元大-大天母,2024-08-19,9893
00688L,國泰20年美債正2,59,10,49,元大-大天母,2024-08-19,9893
00945B,凱基美國非投等債,47,0,47,元大-大天母,2024-08-19,9893
5905,南仁湖,45,3,42,元大-大天母,2024-08-19,9893
00751B,元大AAA至A公司債,28,0,28,元大-大天母,2024-08-19,9893
6609,瀧澤科,43,15,28,元大-大天母,2024-08-19,9893
00720B,元大投資級公司債,28,0,28,元大-大天母,2024-08-19,9893
3048,益登,39,14,25,元大-大天母,2024-08-19,9893
4566,時碩工業,31,7,24,元大-大天母,2024-08-19,9893
8028,昇陽半導體,72,48,24,元大-大天母,2024-08-19,9893
00878,國泰永續高股息,27,4,23,元大-大天母,2024-08-19,9893
00933B,國泰10Y+金融債,22,0,22,元大-大天母,2024-08-19,9893
00764B,群益25年美債,21,0,21,元大-大天母,2024-08-19,9893
9904,寶成,20,0,20,元大-大天母,2024-08-19,9893
2887,台新金,20,0,20,元大-大天母,2024-08-19,9893
3363,上詮,24,5,19,元大-大天母,2024-08-19,9893
2344,華邦電,19,0,19,元大-大天母,2024-08-19,9893
2886,兆豐金,274,256,18,元大-大天母,2024-08-19,9893
4523,永彰,18,1,17,元大-大天母,2024-08-19,9893
2349,錸德,21,4,17,元大-大天母,2024-08-19,9893
1536,和大,46,30,16,元大-大天母,2024-08-19,9893
2905,三商,22,6,16,元大-大天母,2024-08-19,9893
3491,昇達科,24,9,15,元大-大天母,2024-08-19,9893
6116,彩晶,15,0,15,元大-大天母,2024-08-19,9893
3019,亞光,30,15,15,元大-大天母,2024-08-19,9893
1805,寶徠,15,0,15,元大-大天母,2024-08-19,9893
1528,恩德,15,0,15,元大-大天母,2024-08-19,9893
00923,群益台ESG低碳50,15,0,15,元大-大天母,2024-08-19,9893
8096,擎亞,44,30,14,元大-大天母,2024-08-19,9893
3645,達邁,17,3,14,元大-大天母,2024-08-19,9893
2002,中鋼,24,10,14,元大-大天母,2024-08-19,9893
3581,博磊,19,6,13,元大-大天母,2024-08-19,9893
2405,輔信,13,0,13,元大-大天母,2024-08-19,9893
00936,台新永續高息中小,13,0,13,元大-大天母,2024-08-19,9893
2367,燿華,15,2,13,元大-大天母,2024-08-19,9893
2376,技嘉,16,4,12,元大-大天母,2024-08-19,9893
00932,兆豐永續高息等權,12,0,12,元大-大天母,2024-08-19,9893
00715L,期街口布蘭特正2,12,0,12,元大-大天母,2024-08-19,9893
3447,展達,12,0,12,元大-大天母,2024-08-19,9893
00632R,元大台灣50反1,800,15,785,元大-大天母,2024-08-20,9893
2888,新光金,377,237,140,元大-大天母,2024-08-20,9893
3583,辛耘,144,13,131,元大-大天母,2024-08-20,9893
00687B,國泰20年美債,124,1,123,元大-大天母,2024-08-20,9893
00878,國泰永續高股息,121,3,118,元大-大天母,2024-08-20,9893
00753L,中信中國50正2,103,0,103,元大-大天母,2024-08-20,9893
2883,凱基金,96,2,94,元大-大天母,2024-08-20,9893
2610,華航,95,5,90,元大-大天母,2024-08-20,9893
2317,鴻海,84,12,72,元大-大天母,2024-08-20,9893
00907,永豐優息存股,68,0,68,元大-大天母,2024-08-20,9893
2351,順德,61,1,60,元大-大天母,2024-08-20,9893
00679B,元大美債20年,90,32,58,元大-大天母,2024-08-20,9893
1314,中石化,72,24,48,元大-大天母,2024-08-20,9893
3363,上詮,48,5,43,元大-大天母,2024-08-20,9893
2356,英業達,48,8,40,元大-大天母,2024-08-20,9893
00948B,中信優息投資級債,38,0,38,元大-大天母,2024-08-20,9893
6204,艾華,40,2,38,元大-大天母,2024-08-20,9893
2330,台積電,42,8,34,元大-大天母,2024-08-20,9893
00715L,期街口布蘭特正2,28,0,28,元大-大天母,2024-08-20,9893
6285,啟��,27,1,26,元大-大天母,2024-08-20,9893
3447,展達,24,0,24,元大-大天母,2024-08-20,9893
00933B,國泰10Y+金融債,26,3,23,元大-大天母,2024-08-20,9893
2543,皇昌,48,26,22,元大-大天母,2024-08-20,9893
00882,中信中國高股息,21,0,21,元大-大天母,2024-08-20,9893
5269,祥碩,21,1,20,元大-大天母,2024-08-20,9893
1409,新纖,20,0,20,元大-大天母,2024-08-20,9893
00642U,期元大S＆P石油,18,0,18,元大-大天母,2024-08-20,9893
0055,元大MSCI金融,18,0,18,元大-大天母,2024-08-20,9893
2881,富邦金,19,1,18,元大-大天母,2024-08-20,9893
2882,國泰金,97,80,17,元大-大天母,2024-08-20,9893
2886,兆豐金,17,0,17,元大-大天母,2024-08-20,9893
2049,上銀,16,0,16,元大-大天母,2024-08-20,9893
6282,康舒,20,4,16,元大-大天母,2024-08-20,9893
2486,一詮,16,1,15,元大-大天母,2024-08-20,9893
2464,盟立,65,50,15,元大-大天母,2024-08-20,9893
2417,圓剛,35,21,14,元大-大天母,2024-08-20,9893
2548,華固,13,0,13,元大-大天母,2024-08-20,9893
2374,佳能,23,10,13,元大-大天母,2024-08-20,9893
3017,奇鋐,24,11,13,元大-大天母,2024-08-20,9893
00929,復華台灣科技優息,53,41,12,元大-大天母,2024-08-20,9893
3663,鑫科,29,17,12,元大-大天母,2024-08-20,9893
00764B,群益25年美債,12,0,12,元大-大天母,2024-08-20,9893
9945,潤泰新,21,9,12,元大-大天母,2024-08-20,9893
1584,精剛,19,8,11,元大-大天母,2024-08-20,9893
1514,亞力,18,7,11,元大-大天母,2024-08-20,9893
3048,益登,31,20,11,元大-大天母,2024-08-20,9893
00923,群益台ESG低碳50,11,0,11,元大-大天母,2024-08-20,9893
1785,光洋科,32,21,11,元大-大天母,2024-08-20,9893
3312,弘憶股,20,10,10,元大-大天母,2024-08-20,9893
2376,技嘉,13,4,9,元大-大天母,2024-08-20,9893
00632R,元大台灣50反1,518,50,468,元大-大天母,2024-08-21,9893
2891,中信金,838,375,463,元大-大天母,2024-08-21,9893
2888,新光金,738,370,368,元大-大天母,2024-08-21,9893
00936,台新永續高息中小,97,0,97,元大-大天母,2024-08-21,9893
00881,國泰台灣5G+,92,0,92,元大-大天母,2024-08-21,9893
00929,復華台灣科技優息,122,30,92,元大-大天母,2024-08-21,9893
8028,昇陽半導體,157,71,86,元大-大天母,2024-08-21,9893
00715L,期街口布蘭特正2,59,0,59,元大-大天母,2024-08-21,9893
2317,鴻海,56,7,49,元大-大天母,2024-08-21,9893
9935,慶豐富,50,4,46,元大-大天母,2024-08-21,9893
1301,台塑,50,7,43,元大-大天母,2024-08-21,9893
00948B,中信優息投資級債,35,0,35,元大-大天母,2024-08-21,9893
2881,富邦金,33,5,28,元大-大天母,2024-08-21,9893
00940,元大台灣價值高息,33,6,27,元大-大天母,2024-08-21,9893
6901,鑽石投資,28,1,27,元大-大天母,2024-08-21,9893
2887,台新金,27,0,27,元大-大天母,2024-08-21,9893
00753L,中信中國50正2,25,1,24,元大-大天母,2024-08-21,9893
6869,雲豹能源,39,16,23,元大-大天母,2024-08-21,9893
6462,神盾,24,1,23,元大-大天母,2024-08-21,9893
2330,台積電,27,6,21,元大-大天母,2024-08-21,9893
2449,京元電子,29,9,20,元大-大天母,2024-08-21,9893
3019,亞光,31,11,20,元大-大天母,2024-08-21,9893
2892,第一金,38,18,20,元大-大天母,2024-08-21,9893
2884,玉山金,18,0,18,元大-大天母,2024-08-21,9893
00919,群益台灣精選高息,36,20,16,元大-大天母,2024-08-21,9893
8054,安國,16,1,15,元大-大天母,2024-08-21,9893
9945,潤泰新,25,10,15,元大-大天母,2024-08-21,9893
3535,晶彩科,62,48,14,元大-大天母,2024-08-21,9893
3033,威健,14,0,14,元大-大天母,2024-08-21,9893
0050,元大台灣50,13,0,13,元大-大天母,2024-08-21,9893
5347,世界,15,2,13,元大-大天母,2024-08-21,9893
2323,中環,14,1,13,元大-大天母,2024-08-21,9893
1609,大亞,17,4,13,元大-大天母,2024-08-21,9893
00687B,國泰20年美債,13,0,13,元大-大天母,2024-08-21,9893
5452,佶優,15,3,12,元大-大天母,2024-08-21,9893
2349,錸德,27,15,12,元大-大天母,2024-08-21,9893
2610,華航,11,0,11,元大-大天母,2024-08-21,9893
2486,一詮,13,2,11,元大-大天母,2024-08-21,9893
0055,元大MSCI金融,11,0,11,元大-大天母,2024-08-21,9893
2392,正崴,18,8,10,元大-大天母,2024-08-21,9893
00937B,群益ESG投等債20,11,1,10,元大-大天母,2024-08-21,9893
6239,力成,10,0,10,元大-大天母,2024-08-21,9893
3390,旭軟,10,0,10,元大-大天母,2024-08-21,9893
1314,中石化,10,0,10,元大-大天母,2024-08-21,9893
00900,富邦特選高股息30,10,0,10,元大-大天母,2024-08-21,9893
2408,南亞科,10,0,10,元大-大天母,2024-08-21,9893
00953B,群益優選非投等債,9,0,9,元大-大天母,2024-08-21,9893
8299,群聯,9,0,9,元大-大天母,2024-08-21,9893
3450,聯鈞,25,16,9,元大-大天母,2024-08-21,9893
3167,大量,19,10,9,元大-大天母,2024-08-21,9893
2890,永豐金,225,2,223,元大-大天母,2024-08-22,9893
00929,復華台灣科技優息,199,2,197,元大-大天母,2024-08-22,9893
2891,中信金,644,469,175,元大-大天母,2024-08-22,9893
00751B,元大AAA至A公司債,123,0,123,元大-大天母,2024-08-22,9893
5309,系統電,140,53,87,元大-大天母,2024-08-22,9893
9105,泰金寶-DR,80,0,80,元大-大天母,2024-08-22,9893
00632R,元大台灣50反1,312,240,72,元大-大天母,2024-08-22,9893
00720B,元大投資級公司債,69,0,69,元大-大天母,2024-08-22,9893
4716,大立,116,56,60,元大-大天母,2024-08-22,9893
8096,擎亞,78,30,48,元大-大天母,2024-08-22,9893
2383,台光電,50,2,48,元大-大天母,2024-08-22,9893
8070,長華*,52,5,47,元大-大天母,2024-08-22,9893
00878,國泰永續高股息,50,3,47,元大-大天母,2024-08-22,9893
00948B,中信優息投資級債,42,0,42,元大-大天母,2024-08-22,9893
2062,橋椿,60,28,32,元大-大天母,2024-08-22,9893
00687B,國泰20年美債,31,1,30,元大-大天母,2024-08-22,9893
1513,中興電,35,7,28,元大-大天母,2024-08-22,9893
8076,伍豐,27,0,27,元大-大天母,2024-08-22,9893
00937B,群益ESG投等債20,27,0,27,元大-大天母,2024-08-22,9893
2867,三商壽,26,0,26,元大-大天母,2024-08-22,9893
00753L,中信中國50正2,31,6,25,元大-大天母,2024-08-22,9893
5443,均豪,38,14,24,元大-大天母,2024-08-22,9893
2356,英業達,26,3,23,元大-大天母,2024-08-22,9893
2809,京城銀,22,0,22,元大-大天母,2024-08-22,9893
00715L,期街口布蘭特正2,21,0,21,元大-大天母,2024-08-22,9893
00881,國泰台灣5G+,21,0,21,元大-大天母,2024-08-22,9893
00935,野村臺灣新科技50,20,0,20,元大-大天母,2024-08-22,9893
5905,南仁湖,35,15,20,元大-大天母,2024-08-22,9893
9955,佳龍,37,18,19,元大-大天母,2024-08-22,9893
6282,康舒,20,3,17,元大-大天母,2024-08-22,9893
8021,尖點,30,13,17,元大-大天母,2024-08-22,9893
9945,潤泰新,28,12,16,元大-大天母,2024-08-22,9893
1536,和大,51,35,16,元大-大天母,2024-08-22,9893
3711,日月光投控,16,1,15,元大-大天母,2024-08-22,9893
2317,鴻海,31,16,15,元大-大天母,2024-08-22,9893
1584,精剛,28,13,15,元大-大天母,2024-08-22,9893
0050,元大台灣50,15,1,14,元大-大天母,2024-08-22,9893
1304,台聚,14,0,14,元大-大天母,2024-08-22,9893
3033,威健,16,2,14,元大-大天母,2024-08-22,9893
2349,錸德,128,114,14,元大-大天母,2024-08-22,9893
6264,富裔,13,0,13,元大-大天母,2024-08-22,9893
1101,台泥,22,10,12,元大-大天母,2024-08-22,9893
3324,雙鴻,17,5,12,元大-大天母,2024-08-22,9893
2520,冠德,20,8,12,元大-大天母,2024-08-22,9893
2204,中華,13,1,12,元大-大天母,2024-08-22,9893
00679B,元大美債20年,23,12,11,元大-大天母,2024-08-22,9893
00642U,期元大S＆P石油,11,0,11,元大-大天母,2024-08-22,9893
00635U,期元大S＆P黃金,11,0,11,元大-大天母,2024-08-22,9893
3535,晶彩科,21,10,11,元大-大天母,2024-08-22,9893
2939,永邑-KY,11,0,11,元大-大天母,2024-08-22,9893
00632R,元大台灣50反1,1168,0,1168,元大-大天母,2024-08-23,9893
2891,中信金,549,302,247,元大-大天母,2024-08-23,9893
8028,昇陽半導體,460,214,246,元大-大天母,2024-08-23,9893
3707,漢磊,208,8,200,元大-大天母,2024-08-23,9893
6125,廣運,204,7,197,元大-大天母,2024-08-23,9893
3037,欣興,152,5,147,元大-大天母,2024-08-23,9893
1409,新纖,110,1,109,元大-大天母,2024-08-23,9893
2359,所羅門,152,61,91,元大-大天母,2024-08-23,9893
2402,毅嘉,101,13,88,元大-大天母,2024-08-23,9893
1314,中石化,156,70,86,元大-大天母,2024-08-23,9893
8210,勤誠,71,8,63,元大-大天母,2024-08-23,9893
3363,上詮,155,104,51,元大-大天母,2024-08-23,9893
2303,聯電,47,3,44,元大-大天母,2024-08-23,9893
1316,上曜,53,13,40,元大-大天母,2024-08-23,9893
5269,祥碩,39,0,39,元大-大天母,2024-08-23,9893
00680L,元大美債20正2,37,0,37,元大-大天母,2024-08-23,9893
00687B,國泰20年美債,69,33,36,元大-大天母,2024-08-23,9893
8064,東捷,95,59,36,元大-大天母,2024-08-23,9893
2317,鴻海,41,10,31,元大-大天母,2024-08-23,9893
1532,勤美,30,0,30,元大-大天母,2024-08-23,9893
00948B,中信優息投資級債,30,0,30,元大-大天母,2024-08-23,9893
00795B,中信美國公債20年,30,0,30,元大-大天母,2024-08-23,9893
2014,中鴻,31,1,30,元大-大天母,2024-08-23,9893
8070,長華*,49,21,28,元大-大天母,2024-08-23,9893
00932,兆豐永續高息等權,27,0,27,元大-大天母,2024-08-23,9893
00772B,中信高評級公司債,26,0,26,元大-大天母,2024-08-23,9893
2887,台新金,54,28,26,元大-大天母,2024-08-23,9893
3149,正達,28,4,24,元大-大天母,2024-08-23,9893
00715L,期街口布蘭特正2,22,0,22,元大-大天母,2024-08-23,9893
8021,尖點,43,21,22,元大-大天母,2024-08-23,9893
4306,炎洲,20,0,20,元大-大天母,2024-08-23,9893
2885,元大金,19,1,18,元大-大天母,2024-08-23,9893
00929,復華台灣科技優息,20,3,17,元大-大天母,2024-08-23,9893
00937B,群益ESG投等債20,17,0,17,元大-大天母,2024-08-23,9893
2349,錸德,36,20,16,元大-大天母,2024-08-23,9893
1584,精剛,16,0,16,元大-大天母,2024-08-23,9893
00878,國泰永續高股息,16,1,15,元大-大天母,2024-08-23,9893
0050,元大台灣50,18,3,15,元大-大天母,2024-08-23,9893
2905,三商,15,0,15,元大-大天母,2024-08-23,9893
3163,波若威,39,24,15,元大-大天母,2024-08-23,9893
00720B,元大投資級公司債,15,1,14,元大-大天母,2024-08-23,9893
4729,熒茂,68,54,14,元大-大天母,2024-08-23,9893
00881,國泰台灣5G+,14,0,14,元大-大天母,2024-08-23,9893
4919,新唐,13,0,13,元大-大天母,2024-08-23,9893
3033,威健,13,0,13,元大-大天母,2024-08-23,9893
00679B,元大美債20年,22,10,12,元大-大天母,2024-08-23,9893
5871,中租-KY,11,0,11,元大-大天母,2024-08-23,9893
6282,康舒,11,0,11,元大-大天母,2024-08-23,9893
8076,伍豐,11,0,11,元大-大天母,2024-08-23,9893
3714,富采,14,3,11,元大-大天母,2024-08-23,9893
2888,新光金,716,405,311,元大-大天母,2024-08-26,9893
2882,國泰金,266,53,213,元大-大天母,2024-08-26,9893
00687B,國泰20年美債,190,4,186,元大-大天母,2024-08-26,9893
6719,力智,141,1,140,元大-大天母,2024-08-26,9893
00929,復華台灣科技優息,90,5,85,元大-大天母,2024-08-26,9893
00937B,群益ESG投等債20,80,0,80,元大-大天母,2024-08-26,9893
1711,永光,223,146,77,元大-大天母,2024-08-26,9893
2915,潤泰全,104,31,73,元大-大天母,2024-08-26,9893
3062,建漢,62,3,59,元大-大天母,2024-08-26,9893
8354,冠好,64,10,54,元大-大天母,2024-08-26,9893
2344,華邦電,51,1,50,元大-大天母,2024-08-26,9893
2409,友達,55,17,38,元大-大天母,2024-08-26,9893
4958,臻鼎-KY,32,1,31,元大-大天母,2024-08-26,9893
2890,永豐金,33,3,30,元大-大天母,2024-08-26,9893
1304,台聚,30,0,30,元大-大天母,2024-08-26,9893
2360,致茂,30,0,30,元大-大天母,2024-08-26,9893
8076,伍豐,30,0,30,元大-大天母,2024-08-26,9893
4927,泰鼎-KY,40,13,27,元大-大天母,2024-08-26,9893
00948B,中信優息投資級債,27,0,27,元大-大天母,2024-08-26,9893
2312,金寶,33,7,26,元大-大天母,2024-08-26,9893
4147,中裕,25,0,25,元大-大天母,2024-08-26,9893
2610,華航,24,0,24,元大-大天母,2024-08-26,9893
00637L,元大滬深300正2,22,0,22,元大-大天母,2024-08-26,9893
1513,中興電,22,1,21,元大-大天母,2024-08-26,9893
3081,聯亞,23,2,21,元大-大天母,2024-08-26,9893
00919,群益台灣精選高息,25,5,20,元大-大天母,2024-08-26,9893
5443,均豪,250,229,21,元大-大天母,2024-08-26,9893
00953B,群益優選非投等債,20,0,20,元大-大天母,2024-08-26,9893
00932,兆豐永續高息等權,90,70,20,元大-大天母,2024-08-26,9893
6134,萬旭,26,6,20,元大-大天母,2024-08-26,9893
1101,台泥,20,0,20,元大-大天母,2024-08-26,9893
2449,京元電子,23,4,19,元大-大天母,2024-08-26,9893
6806,森崴能源,28,9,19,元大-大天母,2024-08-26,9893
6208,日揚,39,21,18,元大-大天母,2024-08-26,9893
2349,錸德,23,6,17,元大-大天母,2024-08-26,9893
3706,神達,21,5,16,元大-大天母,2024-08-26,9893
3450,聯鈞,19,3,16,元大-大天母,2024-08-26,9893
9958,世紀鋼,19,3,16,元大-大天母,2024-08-26,9893
3583,辛耘,17,2,15,元大-大天母,2024-08-26,9893
4903,聯光通,16,1,15,元大-大天母,2024-08-26,9893
2376,技嘉,28,14,14,元大-大天母,2024-08-26,9893
1314,中石化,20,6,14,元大-大天母,2024-08-26,9893
00933B,國泰10Y+金融債,13,0,13,元大-大天母,2024-08-26,9893
3006,晶豪科,23,10,13,元大-大天母,2024-08-26,9893
3580,友威科,13,0,13,元大-大天母,2024-08-26,9893
00881,國泰台灣5G+,17,5,12,元大-大天母,2024-08-26,9893
6431,光麗-KY,12,0,12,元大-大天母,2024-08-26,9893
2363,矽統,12,0,12,元大-大天母,2024-08-26,9893
2486,一詮,13,1,12,元大-大天母,2024-08-26,9893
5871,中租-KY,23,11,12,元大-大天母,2024-08-26,9893
00632R,元大台灣50反1,250,0,250,元大-大天母,2024-08-27,9893
2402,毅嘉,217,35,182,元大-大天母,2024-08-27,9893
2201,裕隆,150,10,140,元大-大天母,2024-08-27,9893
00687B,國泰20年美債,112,2,110,元大-大天母,2024-08-27,9893
2881,富邦金,103,1,102,元大-大天母,2024-08-27,9893
00673R,期元大S＆P原油反1,86,0,86,元大-大天母,2024-08-27,9893
2891,中信金,250,166,84,元大-大天母,2024-08-27,9893
8076,伍豐,66,0,66,元大-大天母,2024-08-27,9893
6603,富強鑫,61,0,61,元大-大天母,2024-08-27,9893
3707,漢磊,54,3,51,元大-大天母,2024-08-27,9893
00679B,元大美債20年,51,2,49,元大-大天母,2024-08-27,9893
2365,昆盈,133,89,44,元大-大天母,2024-08-27,9893
3441,聯一光,40,0,40,元大-大天母,2024-08-27,9893
2610,華航,41,4,37,元大-大天母,2024-08-27,9893
00932,兆豐永續高息等權,36,0,36,元大-大天母,2024-08-27,9893
00937B,群益ESG投等債20,35,0,35,元大-大天母,2024-08-27,9893
3033,威健,36,3,33,元大-大天母,2024-08-27,9893
5432,新門,30,0,30,元大-大天母,2024-08-27,9893
00929,復華台灣科技優息,40,10,30,元大-大天母,2024-08-27,9893
3032,偉訓,28,1,27,元大-大天母,2024-08-27,9893
4510,高鋒,55,29,26,元大-大天母,2024-08-27,9893
00680L,元大美債20正2,25,0,25,元大-大天母,2024-08-27,9893
00948B,中信優息投資級債,25,0,25,元大-大天母,2024-08-27,9893
2062,橋椿,48,24,24,元大-大天母,2024-08-27,9893
00919,群益台灣精選高息,26,3,23,元大-大天母,2024-08-27,9893
1314,中石化,22,0,22,元大-大天母,2024-08-27,9893
8070,長華*,39,17,22,元大-大天母,2024-08-27,9893
2330,台積電,27,6,21,元大-大天母,2024-08-27,9893
3005,神基,20,0,20,元大-大天母,2024-08-27,9893
1304,台聚,20,0,20,元大-大天母,2024-08-27,9893
00752,中信中國50,20,0,20,元大-大天母,2024-08-27,9893
6264,富裔,20,0,20,元大-大天母,2024-08-27,9893
00715L,期街口布蘭特正2,23,3,20,元大-大天母,2024-08-27,9893
0056,元大高股息,23,3,20,元大-大天母,2024-08-27,9893
2501,國建,20,1,19,元大-大天母,2024-08-27,9893
1569,濱川,30,11,19,元大-大天母,2024-08-27,9893
2603,長榮,93,75,18,元大-大天母,2024-08-27,9893
8354,冠好,16,0,16,元大-大天母,2024-08-27,9893
2883,凱基金,16,0,16,元大-大天母,2024-08-27,9893
2609,陽明,23,8,15,元大-大天母,2024-08-27,9893
00881,國泰台灣5G+,16,1,15,元大-大天母,2024-08-27,9893
00635U,期元大S＆P黃金,14,0,14,元大-大天母,2024-08-27,9893
6153,嘉聯益,13,0,13,元大-大天母,2024-08-27,9893
6213,聯茂,22,9,13,元大-大天母,2024-08-27,9893
2303,聯電,48,36,12,元大-大天母,2024-08-27,9893
2615,萬海,22,10,12,元大-大天母,2024-08-27,9893
3447,展達,12,0,12,元大-大天母,2024-08-27,9893
6706,惠特,12,0,12,元大-大天母,2024-08-27,9893
8096,擎亞,30,19,11,元大-大天母,2024-08-27,9893
5498,凱崴,11,0,11,元大-大天母,2024-08-27,9893
4767,誠泰科技,252,0,252,元大-大天母,2024-08-28,9893
00632R,元大台灣50反1,250,1,249,元大-大天母,2024-08-28,9893
00753L,中信中國50正2,134,0,134,元大-大天母,2024-08-28,9893
2515,中工,100,1,99,元大-大天母,2024-08-28,9893
6269,台郡,100,1,99,元大-大天母,2024-08-28,9893
2891,中信金,495,397,98,元大-大天母,2024-08-28,9893
00919,群益台灣精選高息,101,5,96,元大-大天母,2024-08-28,9893
2353,宏��,69,1,68,元大-大天母,2024-08-28,9893
1722,台肥,53,0,53,元大-大天母,2024-08-28,9893
8076,伍豐,55,5,50,元大-大天母,2024-08-28,9893
6706,惠特,43,3,40,元大-大天母,2024-08-28,9893
00948B,中信優息投資級債,39,0,39,元大-大天母,2024-08-28,9893
6603,富強鑫,45,7,38,元大-大天母,2024-08-28,9893
00918,大華優利高填息30,36,0,36,元大-大天母,2024-08-28,9893
00687B,國泰20年美債,33,1,32,元大-大天母,2024-08-28,9893
2367,燿華,81,52,29,元大-大天母,2024-08-28,9893
2409,友達,38,10,28,元大-大天母,2024-08-28,9893
00679B,元大美債20年,35,9,26,元大-大天母,2024-08-28,9893
6264,富裔,24,0,24,元大-大天母,2024-08-28,9893
2062,橋椿,58,34,24,元大-大天母,2024-08-28,9893
00637L,元大滬深300正2,301,279,22,元大-大天母,2024-08-28,9893
8039,台虹,36,15,21,元大-大天母,2024-08-28,9893
2359,所羅門,22,2,20,元大-大天母,2024-08-28,9893
1101,台泥,20,0,20,元大-大天母,2024-08-28,9893
2548,華固,20,0,20,元大-大天母,2024-08-28,9893
3005,神基,20,0,20,元大-大天母,2024-08-28,9893
00959B,大華投等美債15Y+,20,0,20,元大-大天母,2024-08-28,9893
2537,聯上發,20,0,20,元大-大天母,2024-08-28,9893
2504,國產,23,5,18,元大-大天母,2024-08-28,9893
00937B,群益ESG投等債20,17,0,17,元大-大天母,2024-08-28,9893
4563,百德,17,0,17,元大-大天母,2024-08-28,9893
2883,凱基金,20,4,16,元大-大天母,2024-08-28,9893
1597,直得,19,3,16,元大-大天母,2024-08-28,9893
3376,新日興,16,1,15,元大-大天母,2024-08-28,9893
2867,三商壽,16,1,15,元大-大天母,2024-08-28,9893
3167,大量,15,1,14,元大-大天母,2024-08-28,9893
6177,達麗,13,0,13,元大-大天母,2024-08-28,9893
2337,旺宏,11,0,11,元大-大天母,2024-08-28,9893
2545,皇翔,11,0,11,元大-大天母,2024-08-28,9893
2905,三商,11,0,11,元大-大天母,2024-08-28,9893
3580,友威科,19,8,11,元大-大天母,2024-08-28,9893
2317,鴻海,40,30,10,元大-大天母,2024-08-28,9893
00929,復華台灣科技優息,12,2,10,元大-大天母,2024-08-28,9893
3019,亞光,21,11,10,元大-大天母,2024-08-28,9893
8028,昇陽半導體,27,17,10,元大-大天母,2024-08-28,9893
3231,緯創,18,8,10,元大-大天母,2024-08-28,9893
5880,合庫金,10,0,10,元大-大天母,2024-08-28,9893
1540,喬福,43,33,10,元大-大天母,2024-08-28,9893
4909,新復興,10,0,10,元大-大天母,2024-08-28,9893
2883B,凱基金乙特,10,0,10,元大-大天母,2024-08-28,9893
2891,中信金,261,113,148,元大-大天母,2024-08-29,9893
6603,富強鑫,141,18,123,元大-大天母,2024-08-29,9893
00632R,元大台灣50反1,200,100,100,元大-大天母,2024-08-29,9893
0056,元大高股息,98,6,92,元大-大天母,2024-08-29,9893
00795B,中信美國公債20年,83,0,83,元大-大天母,2024-08-29,9893
00937B,群益ESG投等債20,85,3,82,元大-大天母,2024-08-29,9893
2888,新光金,104,41,63,元大-大天母,2024-08-29,9893
00940,元大台灣價值高息,52,1,51,元大-大天母,2024-08-29,9893
00679B,元大美債20年,72,22,50,元大-大天母,2024-08-29,9893
2330,台積電,60,12,48,元大-大天母,2024-08-29,9893
6269,台郡,51,3,48,元大-大天母,2024-08-29,9893
4510,高鋒,341,294,47,元大-大天母,2024-08-29,9893
2618,長榮航,113,67,46,元大-大天母,2024-08-29,9893
2340,台亞,51,5,46,元大-大天母,2024-08-29,9893
2303,聯電,42,5,37,元大-大天母,2024-08-29,9893
00687B,國泰20年美債,29,2,27,元大-大天母,2024-08-29,9893
2417,圓剛,26,0,26,元大-大天母,2024-08-29,9893
4716,大立,25,0,25,元大-大天母,2024-08-29,9893
00959B,大華投等美債15Y+,24,0,24,元大-大天母,2024-08-29,9893
3481,群創,25,1,24,元大-大天母,2024-08-29,9893
1584,精剛,26,3,23,元大-大天母,2024-08-29,9893
00948B,中信優息投資級債,23,0,23,元大-大天母,2024-08-29,9893
3189,景碩,37,16,21,元大-大天母,2024-08-29,9893
2312,金寶,49,30,19,元大-大天母,2024-08-29,9893
2314,台揚,20,2,18,元大-大天母,2024-08-29,9893
3437,榮創,29,12,17,元大-大天母,2024-08-29,9893
2349,錸德,21,4,17,元大-大天母,2024-08-29,9893
00881,國泰台灣5G+,22,6,16,元大-大天母,2024-08-29,9893
3019,亞光,46,30,16,元大-大天母,2024-08-29,9893
1314,中石化,33,18,15,元大-大天母,2024-08-29,9893
00680L,元大美債20正2,24,9,15,元大-大天母,2024-08-29,9893
8091,翔名,18,3,15,元大-大天母,2024-08-29,9893
3338,泰碩,15,0,15,元大-大天母,2024-08-29,9893
1309,台達化,15,1,14,元大-大天母,2024-08-29,9893
3047,訊舟,15,2,13,元大-大天母,2024-08-29,9893
2886,兆豐金,13,0,13,元大-大天母,2024-08-29,9893
2867,三商壽,15,2,13,元大-大天母,2024-08-29,9893
3090,日電貿,12,0,12,元大-大天母,2024-08-29,9893
2887,台新金,17,6,11,元大-大天母,2024-08-29,9893
2441,超豐,11,0,11,元大-大天母,2024-08-29,9893
00720B,元大投資級公司債,11,0,11,元大-大天母,2024-08-29,9893
2331,精英,11,0,11,元大-大天母,2024-08-29,9893
4306,炎洲,11,0,11,元大-大天母,2024-08-29,9893
8096,擎亞,11,0,11,元大-大天母,2024-08-29,9893
3324,雙鴻,12,2,10,元大-大天母,2024-08-29,9893
5443,均豪,188,178,10,元大-大天母,2024-08-29,9893
1513,中興電,10,0,10,元大-大天母,2024-08-29,9893
3294,英濟,10,0,10,元大-大天母,2024-08-29,9893
6116,彩晶,12,2,10,元大-大天母,2024-08-29,9893
9907,統一實,10,0,10,元大-大天母,2024-08-29,9893
00665L,富邦�琤肭磪囓�2,320,0,320,元大-大天母,2024-08-30,9893
2883,凱基金,310,2,308,元大-大天母,2024-08-30,9893
2880,華南金,201,0,201,元大-大天母,2024-08-30,9893
3481,群創,213,21,192,元大-大天母,2024-08-30,9893
6269,台郡,115,2,113,元大-大天母,2024-08-30,9893
00688L,國泰20年美債正2,110,0,110,元大-大天母,2024-08-30,9893
1314,中石化,100,5,95,元大-大天母,2024-08-30,9893
1711,永光,264,170,94,元大-大天母,2024-08-30,9893
2504,國產,88,0,88,元大-大天母,2024-08-30,9893
00937B,群益ESG投等債20,52,0,52,元大-大天母,2024-08-30,9893
2367,燿華,70,18,52,元大-大天母,2024-08-30,9893
2313,華通,73,22,51,元大-大天母,2024-08-30,9893
00940,元大台灣價值高息,63,15,48,元大-大天母,2024-08-30,9893
00687B,國泰20年美債,43,2,41,元大-大天母,2024-08-30,9893
4979,華星光,49,11,38,元大-大天母,2024-08-30,9893
4908,前鼎,40,5,35,元大-大天母,2024-08-30,9893
3062,建漢,71,37,34,元大-大天母,2024-08-30,9893
00929,復華台灣科技優息,52,20,32,元大-大天母,2024-08-30,9893
00673R,期元大S＆P原油反1,31,0,31,元大-大天母,2024-08-30,9893
00915,凱基優選高股息30,30,0,30,元大-大天母,2024-08-30,9893
6603,富強鑫,34,4,30,元大-大天母,2024-08-30,9893
6156,松上,40,11,29,元大-大天母,2024-08-30,9893
8070,長華*,41,14,27,元大-大天母,2024-08-30,9893
6215,和椿,53,26,27,元大-大天母,2024-08-30,9893
2891,中信金,64,40,24,元大-大天母,2024-08-30,9893
6104,創惟,30,7,23,元大-大天母,2024-08-30,9893
00878,國泰永續高股息,25,2,23,元大-大天母,2024-08-30,9893
00680L,元大美債20正2,23,0,23,元大-大天母,2024-08-30,9893
3580,友威科,26,4,22,元大-大天母,2024-08-30,9893
00795B,中信美國公債20年,22,0,22,元大-大天母,2024-08-30,9893
3048,益登,21,0,21,元大-大天母,2024-08-30,9893
8091,翔名,24,3,21,元大-大天母,2024-08-30,9893
00650L,復華香港正2,20,0,20,元大-大天母,2024-08-30,9893
1218,泰山,20,0,20,元大-大天母,2024-08-30,9893
5234,達興材料,20,1,19,元大-大天母,2024-08-30,9893
4909,新復興,33,16,17,元大-大天母,2024-08-30,9893
2388,威盛,44,28,16,元大-大天母,2024-08-30,9893
2323,中環,16,0,16,元大-大天母,2024-08-30,9893
9933,中鼎,21,7,14,元大-大天母,2024-08-30,9893
2002,中鋼,20,7,13,元大-大天母,2024-08-30,9893
00948B,中信優息投資級債,13,0,13,元大-大天母,2024-08-30,9893
2243,宏旭-KY,12,0,12,元大-大天母,2024-08-30,9893
2886,兆豐金,12,1,11,元大-大天母,2024-08-30,9893
2349,錸德,11,0,11,元大-大天母,2024-08-30,9893
00918,大華優利高填息30,11,0,11,元大-大天母,2024-08-30,9893
8028,昇陽半導體,26,15,11,元大-大天母,2024-08-30,9893
1513,中興電,12,1,11,元大-大天母,2024-08-30,9893
4303,信立,28,18,10,元大-大天母,2024-08-30,9893
1611,中電,10,0,10,元大-大天母,2024-08-30,9893
6412,群電,10,0,10,元大-大天母,2024-08-30,9893
00929,復華台灣科技優息,253,33,220,元大-大天母,2024-09-02,9893
00637L,元大滬深300正2,227,20,207,元大-大天母,2024-09-02,9893
00687B,國泰20年美債,148,0,148,元大-大天母,2024-09-02,9893
00688L,國泰20年美債正2,106,0,106,元大-大天母,2024-09-02,9893
00940,元大台灣價值高息,95,0,95,元大-大天母,2024-09-02,9893
2368,金像電,84,0,84,元大-大天母,2024-09-02,9893
2891,中信金,105,22,83,元大-大天母,2024-09-02,9893
00680L,元大美債20正2,76,0,76,元大-大天母,2024-09-02,9893
2323,中環,77,1,76,元大-大天母,2024-09-02,9893
3663,鑫科,64,0,64,元大-大天母,2024-09-02,9893
00915,凱基優選高股息30,45,0,45,元大-大天母,2024-09-02,9893
1609,大亞,46,3,43,元大-大天母,2024-09-02,9893
3481,群創,102,60,42,元大-大天母,2024-09-02,9893
00919,群益台灣精選高息,40,0,40,元大-大天母,2024-09-02,9893
00715L,期街口布蘭特正2,46,8,38,元大-大天母,2024-09-02,9893
00937B,群益ESG投等債20,45,12,33,元大-大天母,2024-09-02,9893
1711,永光,99,67,32,元大-大天母,2024-09-02,9893
6231,系微,26,1,25,元大-大天母,2024-09-02,9893
8091,翔名,24,0,24,元大-大天母,2024-09-02,9893
2609,陽明,26,3,23,元大-大天母,2024-09-02,9893
4714,永捷,34,11,23,元大-大天母,2024-09-02,9893
00959B,大華投等美債15Y+,21,0,21,元大-大天母,2024-09-02,9893
2603,長榮,48,27,21,元大-大天母,2024-09-02,9893
2313,華通,30,10,20,元大-大天母,2024-09-02,9893
6150,撼訊,20,0,20,元大-大天母,2024-09-02,9893
2537,聯上發,23,4,19,元大-大天母,2024-09-02,9893
1805,寶徠,19,0,19,元大-大天母,2024-09-02,9893
6664,群翊,20,1,19,元大-大天母,2024-09-02,9893
00948B,中信優息投資級債,17,0,17,元大-大天母,2024-09-02,9893
2867,三商壽,17,0,17,元大-大天母,2024-09-02,9893
6213,聯茂,54,39,15,元大-大天母,2024-09-02,9893
1218,泰山,15,0,15,元大-大天母,2024-09-02,9893
8358,金居,24,9,15,元大-大天母,2024-09-02,9893
6530,創威,23,9,14,元大-大天母,2024-09-02,9893
6104,創惟,17,3,14,元大-大天母,2024-09-02,9893
6606,建德工業,15,1,14,元大-大天母,2024-09-02,9893
1303,南亞,14,0,14,元大-大天母,2024-09-02,9893
00881,國泰台灣5G+,14,0,14,元大-大天母,2024-09-02,9893
00713,元大台灣高息低波,14,0,14,元大-大天母,2024-09-02,9893
00882,中信中國高股息,13,0,13,元大-大天母,2024-09-02,9893
2402,毅嘉,19,6,13,元大-大天母,2024-09-02,9893
00878,國泰永續高股息,12,0,12,元大-大天母,2024-09-02,9893
1326,台化,12,0,12,元大-大天母,2024-09-02,9893
9955,佳龍,12,0,12,元大-大天母,2024-09-02,9893
00722B,群益投資級電信債,11,0,11,元大-大天母,2024-09-02,9893
3498,陽程,11,0,11,元大-大天母,2024-09-02,9893
6658,聯策,26,15,11,元大-大天母,2024-09-02,9893
4174,浩鼎,11,0,11,元大-大天母,2024-09-02,9893
1434,福懋,11,0,11,元大-大天母,2024-09-02,9893
1316,上曜,19,8,11,元大-大天母,2024-09-02,9893
00687B,國泰20年美債,375,13,362,元大-大天母,2024-09-03,9893
00632R,元大台灣50反1,250,50,200,元大-大天母,2024-09-03,9893
00918,大華優利高填息30,180,3,177,元大-大天母,2024-09-03,9893
00919,群益台灣精選高息,133,0,133,元大-大天母,2024-09-03,9893
00937B,群益ESG投等債20,125,0,125,元大-大天母,2024-09-03,9893
00680L,元大美債20正2,105,0,105,元大-大天母,2024-09-03,9893
2368,金像電,112,12,100,元大-大天母,2024-09-03,9893
00948B,中信優息投資級債,63,0,63,元大-大天母,2024-09-03,9893
2323,中環,53,0,53,元大-大天母,2024-09-03,9893
00878,國泰永續高股息,46,2,44,元大-大天母,2024-09-03,9893
2204,中華,42,1,41,元大-大天母,2024-09-03,9893
4526,東台,36,1,35,元大-大天母,2024-09-03,9893
4919,新唐,34,0,34,元大-大天母,2024-09-03,9893
4714,永捷,61,27,34,元大-大天母,2024-09-03,9893
00688L,國泰20年美債正2,30,0,30,元大-大天母,2024-09-03,9893
2449,京元電子,32,3,29,元大-大天母,2024-09-03,9893
1785,光洋科,36,10,26,元大-大天母,2024-09-03,9893
2486,一詮,30,7,23,元大-大天母,2024-09-03,9893
00637L,元大滬深300正2,22,0,22,元大-大天母,2024-09-03,9893
4566,時碩工業,27,6,21,元大-大天母,2024-09-03,9893
2887,台新金,23,3,20,元大-大天母,2024-09-03,9893
2345,智邦,20,0,20,元大-大天母,2024-09-03,9893
1815,富喬,31,11,20,元大-大天母,2024-09-03,9893
2489,瑞軒,18,0,18,元大-大天母,2024-09-03,9893
8076,伍豐,35,17,18,元大-大天母,2024-09-03,9893
00713,元大台灣高息低波,17,0,17,元大-大天母,2024-09-03,9893
2867,三商壽,24,7,17,元大-大天母,2024-09-03,9893
4909,新復興,26,9,17,元大-大天母,2024-09-03,9893
3481,群創,27,11,16,元大-大天母,2024-09-03,9893
9945,潤泰新,14,0,14,元大-大天母,2024-09-03,9893
6177,達麗,17,4,13,元大-大天母,2024-09-03,9893
4958,臻鼎-KY,19,6,13,元大-大天母,2024-09-03,9893
00722B,群益投資級電信債,12,0,12,元大-大天母,2024-09-03,9893
4906,正文,17,5,12,元大-大天母,2024-09-03,9893
1536,和大,21,9,12,元大-大天母,2024-09-03,9893
2308,台達電,12,0,12,元大-大天母,2024-09-03,9893
1303,南亞,11,0,11,元大-大天母,2024-09-03,9893
6530,創威,16,5,11,元大-大天母,2024-09-03,9893
6213,聯茂,75,65,10,元大-大天母,2024-09-03,9893
2636,台驊控股,10,0,10,元大-大天母,2024-09-03,9893
3711,日月光投控,10,0,10,元大-大天母,2024-09-03,9893
1532,勤美,10,0,10,元大-大天母,2024-09-03,9893
5309,系統電,10,0,10,元大-大天母,2024-09-03,9893
6449,鈺邦,10,0,10,元大-大天母,2024-09-03,9893
5443,均豪,37,28,9,元大-大天母,2024-09-03,9893
2543,皇昌,41,32,9,元大-大天母,2024-09-03,9893
4979,華星光,11,2,9,元大-大天母,2024-09-03,9893
3447,展達,10,1,9,元大-大天母,2024-09-03,9893
2885,元大金,23,14,9,元大-大天母,2024-09-03,9893
2371,大同,15,6,9,元大-大天母,2024-09-03,9893
00632R,元大台灣50反1,479,152,327,元大-大天母,2024-09-04,9893
2891,中信金,370,44,326,元大-大天母,2024-09-04,9893
00919,群益台灣精選高息,296,9,287,元大-大天母,2024-09-04,9893
00671R,富邦NASDAQ反1,200,0,200,元大-大天母,2024-09-04,9893
00940,元大台灣價值高息,205,26,179,元大-大天母,2024-09-04,9893
00878,國泰永續高股息,148,9,139,元大-大天母,2024-09-04,9893
2881,富邦金,142,5,137,元大-大天母,2024-09-04,9893
00929,復華台灣科技優息,204,68,136,元大-大天母,2024-09-04,9893
2883,凱基金,110,0,110,元大-大天母,2024-09-04,9893
2330,台積電,144,37,107,元大-大天母,2024-09-04,9893
00715L,期街口布蘭特正2,106,0,106,元大-大天母,2024-09-04,9893
2880,華南金,104,0,104,元大-大天母,2024-09-04,9893
3221,台嘉碩,100,1,99,元大-大天母,2024-09-04,9893
3481,群創,134,36,98,元大-大天母,2024-09-04,9893
1711,永光,121,31,90,元大-大天母,2024-09-04,9893
2888,新光金,134,60,74,元大-大天母,2024-09-04,9893
00918,大華優利高填息30,70,0,70,元大-大天母,2024-09-04,9893
1903,士紙,64,0,64,元大-大天母,2024-09-04,9893
0050,元大台灣50,83,21,62,元大-大天母,2024-09-04,9893
0056,元大高股息,58,2,56,元大-大天母,2024-09-04,9893
2317,鴻海,134,81,53,元大-大天母,2024-09-04,9893
1314,中石化,56,3,53,元大-大天母,2024-09-04,9893
5880,合庫金,53,0,53,元大-大天母,2024-09-04,9893
00764B,群益25年美債,64,14,50,元大-大天母,2024-09-04,9893
1536,和大,86,42,44,元大-大天母,2024-09-04,9893
3062,建漢,47,6,41,元大-大天母,2024-09-04,9893
2633,台灣高鐵,40,0,40,元大-大天母,2024-09-04,9893
00687B,國泰20年美債,103,65,38,元大-大天母,2024-09-04,9893
2382,廣達,41,5,36,元大-大天母,2024-09-04,9893
2344,華邦電,35,2,33,元大-大天母,2024-09-04,9893
4563,百德,40,7,33,元大-大天母,2024-09-04,9893
3532,台勝科,32,0,32,元大-大天母,2024-09-04,9893
2886,兆豐金,34,2,32,元大-大天母,2024-09-04,9893
4561,健椿,46,14,32,元大-大天母,2024-09-04,9893
00941,中信上游半導體,31,0,31,元大-大天母,2024-09-04,9893
006208,富邦台50,33,2,31,元大-大天母,2024-09-04,9893
00680L,元大美債20正2,134,104,30,元大-大天母,2024-09-04,9893
00751B,元大AAA至A公司債,30,1,29,元大-大天母,2024-09-04,9893
1303,南亞,30,1,29,元大-大天母,2024-09-04,9893
00881,國泰台灣5G+,38,10,28,元大-大天母,2024-09-04,9893
00930,永豐ESG低碳高息,27,0,27,元大-大天母,2024-09-04,9893
00943,兆豐電子高息等權,25,0,25,元大-大天母,2024-09-04,9893
2303,聯電,35,10,25,元大-大天母,2024-09-04,9893
2882,國泰金,45,21,24,元大-大天母,2024-09-04,9893
2885,元大金,27,4,23,元大-大天母,2024-09-04,9893
6160,欣技,21,0,21,元大-大天母,2024-09-04,9893
1785,光洋科,32,11,21,元大-大天母,2024-09-04,9893
2356,英業達,47,26,21,元大-大天母,2024-09-04,9893
2368,金像電,75,55,20,元大-大天母,2024-09-04,9893
5432,新門,20,0,20,元大-大天母,2024-09-04,9893
00632R,元大台灣50反1,311,0,311,元大-大天母,2024-09-05,9893
00637L,元大滬深300正2,204,2,202,元大-大天母,2024-09-05,9893
00915,凱基優選高股息30,169,0,169,元大-大天母,2024-09-05,9893
2464,盟立,307,165,142,元大-大天母,2024-09-05,9893
3481,群創,120,5,115,元大-大天母,2024-09-05,9893
2353,宏��,106,4,102,元大-大天母,2024-09-05,9893
3416,融程電,100,0,100,元大-大天母,2024-09-05,9893
00919,群益台灣精選高息,81,3,78,元大-大天母,2024-09-05,9893
00671R,富邦NASDAQ反1,70,0,70,元大-大天母,2024-09-05,9893
00715L,期街口布蘭特正2,78,10,68,元大-大天母,2024-09-05,9893
2881,富邦金,71,5,66,元大-大天母,2024-09-05,9893
2337,旺宏,68,4,64,元大-大天母,2024-09-05,9893
00650L,復華香港正2,64,0,64,元大-大天母,2024-09-05,9893
00878,國泰永續高股息,56,2,54,元大-大天母,2024-09-05,9893
00641R,富邦日本反1,50,0,50,元大-大天母,2024-09-05,9893
00952,凱基台灣AI50,47,1,46,元大-大天母,2024-09-05,9893
2317,鴻海,58,21,37,元大-大天母,2024-09-05,9893
1314,中石化,36,5,31,元大-大天母,2024-09-05,9893
00687B,國泰20年美債,66,37,29,元大-大天母,2024-09-05,9893
2367,燿華,30,4,26,元大-大天母,2024-09-05,9893
00918,大華優利高填息30,30,5,25,元大-大天母,2024-09-05,9893
00943,兆豐電子高息等權,28,3,25,元大-大天母,2024-09-05,9893
00712,復華富時不動產,23,0,23,元大-大天母,2024-09-05,9893
00929,復華台灣科技優息,61,41,20,元大-大天母,2024-09-05,9893
00941,中信上游半導體,20,1,19,元大-大天母,2024-09-05,9893
1326,台化,20,1,19,元大-大天母,2024-09-05,9893
9933,中鼎,18,1,17,元大-大天母,2024-09-05,9893
6278,台表科,18,2,16,元大-大天母,2024-09-05,9893
2495,普安,21,5,16,元大-大天母,2024-09-05,9893
3047,訊舟,23,9,14,元大-大天母,2024-09-05,9893
4576,大銀微系統,28,15,13,元大-大天母,2024-09-05,9893
6150,撼訊,13,0,13,元大-大天母,2024-09-05,9893
5309,系統電,13,0,13,元大-大天母,2024-09-05,9893
00882,中信中國高股息,12,0,12,元大-大天母,2024-09-05,9893
3374,精材,24,12,12,元大-大天母,2024-09-05,9893
6290,良維,12,0,12,元大-大天母,2024-09-05,9893
00753L,中信中國50正2,12,0,12,元大-大天母,2024-09-05,9893
0056,元大高股息,19,8,11,元大-大天母,2024-09-05,9893
2382,廣達,13,2,11,元大-大天母,2024-09-05,9893
2455,全新,11,0,11,元大-大天母,2024-09-05,9893
2548,華固,11,0,11,元大-大天母,2024-09-05,9893
9945,潤泰新,12,1,11,元大-大天母,2024-09-05,9893
2356,英業達,11,0,11,元大-大天母,2024-09-05,9893
1539,巨庭,20,9,11,元大-大天母,2024-09-05,9893
3062,建漢,22,11,11,元大-大天母,2024-09-05,9893
2489,瑞軒,13,2,11,元大-大天母,2024-09-05,9893
1210,大成,11,0,11,元大-大天母,2024-09-05,9893
2486,一詮,13,2,11,元大-大天母,2024-09-05,9893
2923,鼎固-KY,10,0,10,元大-大天母,2024-09-05,9893
2605,新興,10,0,10,元大-大天母,2024-09-05,9893
00937B,群益ESG投等債20,236,11,225,元大-大天母,2024-09-06,9893
00632R,元大台灣50反1,109,0,109,元大-大天母,2024-09-06,9893
00687B,國泰20年美債,74,2,72,元大-大天母,2024-09-06,9893
00929,復華台灣科技優息,99,32,67,元大-大天母,2024-09-06,9893
2511,太子,52,0,52,元大-大天母,2024-09-06,9893
3712,永崴投控,51,1,50,元大-大天母,2024-09-06,9893
2891,中信金,101,52,49,元大-大天母,2024-09-06,9893
1711,永光,46,1,45,元大-大天母,2024-09-06,9893
00915,凱基優選高股息30,52,10,42,元大-大天母,2024-09-06,9893
4538,大詠城,40,0,40,元大-大天母,2024-09-06,9893
00862B,中信投資級公司債,30,0,30,元大-大天母,2024-09-06,9893
3058,立德,30,0,30,元大-大天母,2024-09-06,9893
2506,太設,30,0,30,元大-大天母,2024-09-06,9893
00940,元大台灣價值高息,141,112,29,元大-大天母,2024-09-06,9893
00949,復華日本龍頭,29,0,29,元大-大天母,2024-09-06,9893
8091,翔名,28,0,28,元大-大天母,2024-09-06,9893
2618,長榮航,33,6,27,元大-大天母,2024-09-06,9893
00713,元大台灣高息低波,26,2,24,元大-大天母,2024-09-06,9893
00941,中信上游半導體,23,0,23,元大-大天母,2024-09-06,9893
2515,中工,23,0,23,元大-大天母,2024-09-06,9893
2905,三商,23,3,20,元大-大天母,2024-09-06,9893
00931B,統一美債20年,20,0,20,元大-大天母,2024-09-06,9893
00918,大華優利高填息30,33,14,19,元大-大天母,2024-09-06,9893
00878,國泰永續高股息,26,9,17,元大-大天母,2024-09-06,9893
5443,均豪,45,29,16,元大-大天母,2024-09-06,9893
3581,博磊,25,9,16,元大-大天母,2024-09-06,9893
2464,盟立,37,21,16,元大-大天母,2024-09-06,9893
2206,三陽工業,16,0,16,元大-大天母,2024-09-06,9893
00907,永豐優息存股,16,0,16,元大-大天母,2024-09-06,9893
4956,光鋐,19,4,15,元大-大天母,2024-09-06,9893
8043,蜜望實,16,1,15,元大-大天母,2024-09-06,9893
6190,萬泰科,15,0,15,元大-大天母,2024-09-06,9893
00715L,期街口布蘭特正2,13,0,13,元大-大天母,2024-09-06,9893
4958,臻鼎-KY,12,0,12,元大-大天母,2024-09-06,9893
2233,宇隆,15,3,12,元大-大天母,2024-09-06,9893
3447,展達,11,0,11,元大-大天母,2024-09-06,9893
00642U,期元大S＆P石油,10,0,10,元大-大天母,2024-09-06,9893
2388,威盛,13,3,10,元大-大天母,2024-09-06,9893
00951,台新日本半導體,10,0,10,元大-大天母,2024-09-06,9893
2337,旺宏,15,5,10,元大-大天母,2024-09-06,9893
00725B,國泰投資級公司債,35,25,10,元大-大天母,2024-09-06,9893
1314,中石化,12,2,10,元大-大天母,2024-09-06,9893
00943,兆豐電子高息等權,10,0,10,元大-大天母,2024-09-06,9893
2313,華通,15,5,10,元大-大天母,2024-09-06,9893
1219,福壽,10,0,10,元大-大天母,2024-09-06,9893
6706,惠特,18,8,10,元大-大天母,2024-09-06,9893
8039,台虹,9,0,9,元大-大天母,2024-09-06,9893
4566,時碩工業,13,4,9,元大-大天母,2024-09-06,9893
1815,富喬,36,27,9,元大-大天母,2024-09-06,9893
8936,國統,8,0,8,元大-大天母,2024-09-06,9893
00919,群益台灣精選高息,238,12,226,元大-大天母,2024-09-09,9893
2881,富邦金,119,16,103,元大-大天母,2024-09-09,9893
6104,創惟,101,3,98,元大-大天母,2024-09-09,9893
2885,元大金,87,7,80,元大-大天母,2024-09-09,9893
1711,永光,81,3,78,元大-大天母,2024-09-09,9893
00764B,群益25年美債,68,0,68,元大-大天母,2024-09-09,9893
00918,大華優利高填息30,70,11,59,元大-大天母,2024-09-09,9893
2618,長榮航,69,13,56,元大-大天母,2024-09-09,9893
00940,元大台灣價值高息,58,2,56,元大-大天母,2024-09-09,9893
00641R,富邦日本反1,50,0,50,元大-大天母,2024-09-09,9893
1303,南亞,50,6,44,元大-大天母,2024-09-09,9893
2330,台積電,52,9,43,元大-大天母,2024-09-09,9893
00679B,元大美債20年,73,36,37,元大-大天母,2024-09-09,9893
2317,鴻海,62,31,31,元大-大天母,2024-09-09,9893
5905,南仁湖,112,81,31,元大-大天母,2024-09-09,9893
00650L,復華香港正2,30,0,30,元大-大天母,2024-09-09,9893
00719B,元大美債1-3,30,0,30,元大-大天母,2024-09-09,9893
1536,和大,51,22,29,元大-大天母,2024-09-09,9893
00885,富邦越南,29,1,28,元大-大天母,2024-09-09,9893
00931B,統一美債20年,28,0,28,元大-大天母,2024-09-09,9893
00929,復華台灣科技優息,52,26,26,元大-大天母,2024-09-09,9893
00878,國泰永續高股息,29,4,25,元大-大天母,2024-09-09,9893
00881,國泰台灣5G+,24,0,24,元大-大天母,2024-09-09,9893
00687B,國泰20年美債,24,0,24,元大-大天母,2024-09-09,9893
00753L,中信中國50正2,21,0,21,元大-大天母,2024-09-09,9893
4927,泰鼎-KY,20,0,20,元大-大天母,2024-09-09,9893
0050,元大台灣50,20,1,19,元大-大天母,2024-09-09,9893
2308,台達電,18,1,17,元大-大天母,2024-09-09,9893
00795B,中信美國公債20年,15,0,15,元大-大天母,2024-09-09,9893
1540,喬福,34,19,15,元大-大天母,2024-09-09,9893
6757,台灣虎航,15,0,15,元大-大天母,2024-09-09,9893
2882,國泰金,58,44,14,元大-大天母,2024-09-09,9893
2228,劍麟,12,0,12,元大-大天母,2024-09-09,9893
2382,廣達,31,19,12,元大-大天母,2024-09-09,9893
00915,凱基優選高股息30,17,5,12,元大-大天母,2024-09-09,9893
00935,野村臺灣新科技50,12,0,12,元大-大天母,2024-09-09,9893
3019,亞光,20,9,11,元大-大天母,2024-09-09,9893
4747,強生,11,0,11,元大-大天母,2024-09-09,9893
4956,光鋐,93,82,11,元大-大天母,2024-09-09,9893
6606,建德工業,26,15,11,元大-大天母,2024-09-09,9893
0056,元大高股息,16,6,10,元大-大天母,2024-09-09,9893
00680L,元大美債20正2,20,10,10,元大-大天母,2024-09-09,9893
8103,瀚荃,10,0,10,元大-大天母,2024-09-09,9893
1309,台達化,10,0,10,元大-大天母,2024-09-09,9893
2883B,凱基金乙特,10,0,10,元大-大天母,2024-09-09,9893
2204,中華,10,0,10,元大-大天母,2024-09-09,9893
3189,景碩,10,0,10,元大-大天母,2024-09-09,9893
1314,中石化,10,0,10,元大-大天母,2024-09-09,9893
00959B,大華投等美債15Y+,10,0,10,元大-大天母,2024-09-09,9893
00907,永豐優息存股,10,0,10,元大-大天母,2024-09-09,9893
00687B,國泰20年美債,221,16,205,元大-大天母,2024-09-10,9893
00919,群益台灣精選高息,172,2,170,元大-大天母,2024-09-10,9893
2344,華邦電,111,3,108,元大-大天母,2024-09-10,9893
3597,映興,100,0,100,元大-大天母,2024-09-10,9893
2891,中信金,144,61,83,元大-大天母,2024-09-10,9893
6190,萬泰科,81,0,81,元大-大天母,2024-09-10,9893
3048,益登,74,4,70,元大-大天母,2024-09-10,9893
00688L,國泰20年美債正2,70,10,60,元大-大天母,2024-09-10,9893
2303,聯電,57,3,54,元大-大天母,2024-09-10,9893
00679B,元大美債20年,64,11,53,元大-大天母,2024-09-10,9893
1536,和大,146,95,51,元大-大天母,2024-09-10,9893
2887,台新金,51,1,50,元大-大天母,2024-09-10,9893
00706L,期元大S＆P日圓正2,50,0,50,元大-大天母,2024-09-10,9893
00671R,富邦NASDAQ反1,50,0,50,元大-大天母,2024-09-10,9893
0056,元大高股息,56,8,48,元大-大天母,2024-09-10,9893
00918,大華優利高填息30,49,5,44,元大-大天母,2024-09-10,9893
00632R,元大台灣50反1,100,60,40,元大-大天母,2024-09-10,9893
00878,國泰永續高股息,36,1,35,元大-大天母,2024-09-10,9893
00929,復華台灣科技優息,32,0,32,元大-大天母,2024-09-10,9893
2337,旺宏,32,2,30,元大-大天母,2024-09-10,9893
00641R,富邦日本反1,30,0,30,元大-大天母,2024-09-10,9893
00940,元大台灣價值高息,130,101,29,元大-大天母,2024-09-10,9893
4114,健喬,28,0,28,元大-大天母,2024-09-10,9893
00795B,中信美國公債20年,31,8,23,元大-大天母,2024-09-10,9893
1605,華新,22,0,22,元大-大天母,2024-09-10,9893
2881,富邦金,45,23,22,元大-大天母,2024-09-10,9893
6213,聯茂,61,40,21,元大-大天母,2024-09-10,9893
00934,中信成長高股息,21,0,21,元大-大天母,2024-09-10,9893
1101,台泥,20,0,20,元大-大天母,2024-09-10,9893
00881,國泰台灣5G+,19,0,19,元大-大天母,2024-09-10,9893
2382,廣達,25,8,17,元大-大天母,2024-09-10,9893
2317,鴻海,48,31,17,元大-大天母,2024-09-10,9893
3481,群創,42,26,16,元大-大天母,2024-09-10,9893
2618,長榮航,22,6,16,元大-大天母,2024-09-10,9893
5871,中租-KY,15,0,15,元大-大天母,2024-09-10,9893
2376,技嘉,14,0,14,元大-大天母,2024-09-10,9893
3047,訊舟,16,3,13,元大-大天母,2024-09-10,9893
8076,伍豐,13,0,13,元大-大天母,2024-09-10,9893
1609,大亞,24,11,13,元大-大天母,2024-09-10,9893
4432,銘旺實,13,0,13,元大-大天母,2024-09-10,9893
3066,李洲,12,0,12,元大-大天母,2024-09-10,9893
2330,台積電,23,11,12,元大-大天母,2024-09-10,9893
2363,矽統,13,2,11,元大-大天母,2024-09-10,9893
2367,燿華,14,3,11,元大-大天母,2024-09-10,9893
3013,晟銘電,36,25,11,元大-大天母,2024-09-10,9893
1722,台肥,10,0,10,元大-大天母,2024-09-10,9893
00719B,元大美債1-3,10,0,10,元大-大天母,2024-09-10,9893
6104,創惟,13,3,10,元大-大天母,2024-09-10,9893
4908,前鼎,27,17,10,元大-大天母,2024-09-10,9893
4107,邦特,10,0,10,元大-大天母,2024-09-10,9893
4979,華星光,137,5,132,元大-大天母,2024-09-11,9893
00687B,國泰20年美債,120,18,102,元大-大天母,2024-09-11,9893
9958,世紀鋼,98,0,98,元大-大天母,2024-09-11,9893
00679B,元大美債20年,134,37,97,元大-大天母,2024-09-11,9893
2883,凱基金,67,0,67,元大-大天母,2024-09-11,9893
00915,凱基優選高股息30,63,0,63,元大-大天母,2024-09-11,9893
00715L,期街口布蘭特正2,58,0,58,元大-大天母,2024-09-11,9893
00921,兆豐龍頭等權重,50,0,50,元大-大天母,2024-09-11,9893
6505,台塑化,38,0,38,元大-大天母,2024-09-11,9893
8936,國統,39,3,36,元大-大天母,2024-09-11,9893
00764B,群益25年美債,36,0,36,元大-大天母,2024-09-11,9893
00937B,群益ESG投等債20,38,3,35,元大-大天母,2024-09-11,9893
4538,大詠城,35,1,34,元大-大天母,2024-09-11,9893
00919,群益台灣精選高息,46,15,31,元大-大天母,2024-09-11,9893
2002,中鋼,47,17,30,元大-大天母,2024-09-11,9893
00862B,中信投資級公司債,30,0,30,元大-大天母,2024-09-11,9893
1303,南亞,37,9,28,元大-大天母,2024-09-11,9893
0056,元大高股息,29,2,27,元大-大天母,2024-09-11,9893
6530,創威,45,19,26,元大-大天母,2024-09-11,9893
6257,矽格,27,2,25,元大-大天母,2024-09-11,9893
2331,精英,25,0,25,元大-大天母,2024-09-11,9893
6104,創惟,27,2,25,元大-大天母,2024-09-11,9893
1447,力鵬,24,0,24,元大-大天母,2024-09-11,9893
2610,華航,18,0,18,元大-大天母,2024-09-11,9893
1301,台塑,22,4,18,元大-大天母,2024-09-11,9893
4561,健椿,18,0,18,元大-大天母,2024-09-11,9893
00934,中信成長高股息,17,0,17,元大-大天母,2024-09-11,9893
1540,喬福,41,24,17,元大-大天母,2024-09-11,9893
00935,野村臺灣新科技50,16,0,16,元大-大天母,2024-09-11,9893
00918,大華優利高填息30,23,7,16,元大-大天母,2024-09-11,9893
6133,金橋,21,6,15,元大-大天母,2024-09-11,9893
3013,晟銘電,24,9,15,元大-大天母,2024-09-11,9893
00878,國泰永續高股息,54,40,14,元大-大天母,2024-09-11,9893
6643,M31,14,0,14,元大-大天母,2024-09-11,9893
00712,復華富時不動產,13,0,13,元大-大天母,2024-09-11,9893
6899,創為精密,13,0,13,元大-大天母,2024-09-11,9893
8076,伍豐,16,4,12,元大-大天母,2024-09-11,9893
9933,中鼎,15,3,12,元大-大天母,2024-09-11,9893
3163,波若威,12,1,11,元大-大天母,2024-09-11,9893
2882,國泰金,12,1,11,元大-大天母,2024-09-11,9893
4908,前鼎,11,0,11,元大-大天母,2024-09-11,9893
2399,映泰,21,10,11,元大-大天母,2024-09-11,9893
1536,和大,101,90,11,元大-大天母,2024-09-11,9893
6122,擎邦,13,2,11,元大-大天母,2024-09-11,9893
3047,訊舟,17,7,10,元大-大天母,2024-09-11,9893
3711,日月光投控,10,0,10,元大-大天母,2024-09-11,9893
2323,中環,10,0,10,元大-大天母,2024-09-11,9893
2886,兆豐金,11,1,10,元大-大天母,2024-09-11,9893
6177,達麗,10,0,10,元大-大天母,2024-09-11,9893
00713,元大台灣高息低波,11,1,10,元大-大天母,2024-09-11,9893
2888,新光金,365,125,240,元大-大天母,2024-09-12,9893
00632R,元大台灣50反1,246,58,188,元大-大天母,2024-09-12,9893
00679B,元大美債20年,117,22,95,元大-大天母,2024-09-12,9893
2883,凱基金,100,6,94,元大-大天母,2024-09-12,9893
2891,中信金,211,138,73,元大-大天母,2024-09-12,9893
00937B,群益ESG投等債20,66,1,65,元大-大天母,2024-09-12,9893
3447,展達,61,0,61,元大-大天母,2024-09-12,9893
5460,同協,76,16,60,元大-大天母,2024-09-12,9893
8936,國統,58,2,56,元大-大天母,2024-09-12,9893
2399,映泰,74,23,51,元大-大天母,2024-09-12,9893
2344,華邦電,40,0,40,元大-大天母,2024-09-12,9893
8249,菱光,43,9,34,元大-大天母,2024-09-12,9893
6278,台表科,34,2,32,元大-大天母,2024-09-12,9893
6530,創威,56,25,31,元大-大天母,2024-09-12,9893
00676R,富邦臺灣加權反1,30,0,30,元大-大天母,2024-09-12,9893
2472,立隆電,27,0,27,元大-大天母,2024-09-12,9893
3088,艾訊,25,0,25,元大-大天母,2024-09-12,9893
6152,百一,25,0,25,元大-大天母,2024-09-12,9893
00795B,中信美國公債20年,21,0,21,元大-大天母,2024-09-12,9893
5388,中磊,20,0,20,元大-大天母,2024-09-12,9893
00719B,元大美債1-3,20,0,20,元大-大天母,2024-09-12,9893
2313,華通,81,62,19,元大-大天母,2024-09-12,9893
00878,國泰永續高股息,20,3,17,元大-大天母,2024-09-12,9893
4532,瑞智,15,0,15,元大-大天母,2024-09-12,9893
00641R,富邦日本反1,15,0,15,元大-大天母,2024-09-12,9893
3550,聯穎,15,0,15,元大-大天母,2024-09-12,9893
00948B,中信優息投資級債,15,0,15,元大-大天母,2024-09-12,9893
3533,嘉澤,23,9,14,元大-大天母,2024-09-12,9893
00915,凱基優選高股息30,15,2,13,元大-大天母,2024-09-12,9893
00940,元大台灣價值高息,23,10,13,元大-大天母,2024-09-12,9893
2610,華航,17,5,12,元大-大天母,2024-09-12,9893
2504,國產,12,1,11,元大-大天母,2024-09-12,9893
00687B,國泰20年美債,58,47,11,元大-大天母,2024-09-12,9893
3535,晶彩科,14,4,10,元大-大天母,2024-09-12,9893
2530,華建,10,0,10,元大-大天母,2024-09-12,9893
2867,三商壽,15,5,10,元大-大天母,2024-09-12,9893
8927,北基,10,0,10,元大-大天母,2024-09-12,9893
1402,遠東新,10,0,10,元大-大天母,2024-09-12,9893
6148,驊宏資,10,0,10,元大-大天母,2024-09-12,9893
00642U,期元大S＆P石油,10,0,10,元大-大天母,2024-09-12,9893
6643,M31,12,3,9,元大-大天母,2024-09-12,9893
00919,群益台灣精選高息,16,7,9,元大-大天母,2024-09-12,9893
9914,美利達,8,0,8,元大-大天母,2024-09-12,9893
00764B,群益25年美債,8,0,8,元大-大天母,2024-09-12,9893
2881,富邦金,50,43,7,元大-大天母,2024-09-12,9893
9921,巨大,7,0,7,元大-大天母,2024-09-12,9893
2542,興富發,7,0,7,元大-大天母,2024-09-12,9893
3289,宜特,8,1,7,元大-大天母,2024-09-12,9893
00722B,群益投資級電信債,6,0,6,元大-大天母,2024-09-12,9893
6125,廣運,8,2,6,元大-大天母,2024-09-12,9893
00687B,國泰20年美債,144,1,143,元大-大天母,2024-09-13,9893
5347,世界,129,1,128,元大-大天母,2024-09-13,9893
00680L,元大美債20正2,116,4,112,元大-大天母,2024-09-13,9893
2399,映泰,97,36,61,元大-大天母,2024-09-13,9893
3447,展達,51,2,49,元大-大天母,2024-09-13,9893
6706,惠特,60,12,48,元大-大天母,2024-09-13,9893
00937B,群益ESG投等債20,95,50,45,元大-大天母,2024-09-13,9893
8032,光菱,41,1,40,元大-大天母,2024-09-13,9893
2303,聯電,39,0,39,元大-大天母,2024-09-13,9893
00795B,中信美國公債20年,40,2,38,元大-大天母,2024-09-13,9893
00919,群益台灣精選高息,31,1,30,元大-大天母,2024-09-13,9893
4306,炎洲,30,0,30,元大-大天母,2024-09-13,9893
3088,艾訊,25,0,25,元大-大天母,2024-09-13,9893
5439,高技,22,0,22,元大-大天母,2024-09-13,9893
00929,復華台灣科技優息,76,54,22,元大-大天母,2024-09-13,9893
00637L,元大滬深300正2,21,0,21,元大-大天母,2024-09-13,9893
00679B,元大美債20年,24,4,20,元大-大天母,2024-09-13,9893
00708L,期元大S＆P黃金正2,20,0,20,元大-大天母,2024-09-13,9893
4123,晟德,20,0,20,元大-大天母,2024-09-13,9893
00915,凱基優選高股息30,22,2,20,元大-大天母,2024-09-13,9893
00921,兆豐龍頭等權重,20,0,20,元大-大天母,2024-09-13,9893
5234,達興材料,22,3,19,元大-大天母,2024-09-13,9893
2301,光寶科,21,2,19,元大-大天母,2024-09-13,9893
1307,三芳,19,0,19,元大-大天母,2024-09-13,9893
2345,智邦,22,3,19,元大-大天母,2024-09-13,9893
2328,廣宇,18,0,18,元大-大天母,2024-09-13,9893
00878,國泰永續高股息,17,0,17,元大-大天母,2024-09-13,9893
8039,台虹,44,27,17,元大-大天母,2024-09-13,9893
1711,永光,22,5,17,元大-大天母,2024-09-13,9893
6215,和椿,16,0,16,元大-大天母,2024-09-13,9893
1536,和大,36,20,16,元大-大天母,2024-09-13,9893
00641R,富邦日本反1,15,0,15,元大-大天母,2024-09-13,9893
3013,晟銘電,33,19,14,元大-大天母,2024-09-13,9893
2444,兆勁,14,0,14,元大-大天母,2024-09-13,9893
8390,金益鼎,13,0,13,元大-大天母,2024-09-13,9893
1540,喬福,52,40,12,元大-大天母,2024-09-13,9893
2888,新光金,22,10,12,元大-大天母,2024-09-13,9893
3017,奇鋐,24,12,12,元大-大天母,2024-09-13,9893
2408,南亞科,11,0,11,元大-大天母,2024-09-13,9893
8096,擎亞,11,0,11,元大-大天母,2024-09-13,9893
2464,盟立,23,12,11,元大-大天母,2024-09-13,9893
2530,華建,10,0,10,元大-大天母,2024-09-13,9893
2204,中華,10,0,10,元大-大天母,2024-09-13,9893
4747,強生,10,0,10,元大-大天母,2024-09-13,9893
2883,凱基金,15,5,10,元大-大天母,2024-09-13,9893
00918,大華優利高填息30,17,7,10,元大-大天母,2024-09-13,9893
1101,台泥,10,1,9,元大-大天母,2024-09-13,9893
2539,櫻花建,9,0,9,元大-大天母,2024-09-13,9893
2542,興富發,9,0,9,元大-大天母,2024-09-13,9893
3686,達能,8,0,8,元大-大天母,2024-09-13,9893
00712,復華富時不動產,237,0,237,元大-大天母,2024-09-16,9893
8936,國統,173,8,165,元大-大天母,2024-09-16,9893
2888,新光金,281,120,161,元大-大天母,2024-09-16,9893
00948B,中信優息投資級債,159,0,159,元大-大天母,2024-09-16,9893
00687B,國泰20年美債,154,12,142,元大-大天母,2024-09-16,9893
5234,達興材料,141,16,125,元大-大天母,2024-09-16,9893
1301,台塑,82,4,78,元大-大天母,2024-09-16,9893
8421,旭源,70,0,70,元大-大天母,2024-09-16,9893
3481,群創,238,171,67,元大-大天母,2024-09-16,9893
00929,復華台灣科技優息,81,15,66,元大-大天母,2024-09-16,9893
2353,宏��,61,0,61,元大-大天母,2024-09-16,9893
00945B,凱基美國非投等債,60,0,60,元大-大天母,2024-09-16,9893
3447,展達,59,0,59,元大-大天母,2024-09-16,9893
6269,台郡,55,0,55,元大-大天母,2024-09-16,9893
00942B,台新美A公司債20+,50,0,50,元大-大天母,2024-09-16,9893
2504,國產,50,0,50,元大-大天母,2024-09-16,9893
00919,群益台灣精選高息,48,0,48,元大-大天母,2024-09-16,9893
4903,聯光通,51,3,48,元大-大天母,2024-09-16,9893
9940,信義,45,0,45,元大-大天母,2024-09-16,9893
2834,臺企銀,54,14,40,元大-大天母,2024-09-16,9893
5438,東友,40,0,40,元大-大天母,2024-09-16,9893
1569,濱川,40,1,39,元大-大天母,2024-09-16,9893
2881,富邦金,41,5,36,元大-大天母,2024-09-16,9893
00957B,兆豐US優選投等債,30,0,30,元大-大天母,2024-09-16,9893
2409,友達,51,24,27,元大-大天母,2024-09-16,9893
2889,國票金,26,0,26,元大-大天母,2024-09-16,9893
00706L,期元大S＆P日圓正2,25,0,25,元大-大天母,2024-09-16,9893
1307,三芳,35,12,23,元大-大天母,2024-09-16,9893
2328,廣宇,36,14,22,元大-大天母,2024-09-16,9893
1536,和大,28,6,22,元大-大天母,2024-09-16,9893
8032,光菱,20,0,20,元大-大天母,2024-09-16,9893
00688L,國泰20年美債正2,39,20,19,元大-大天母,2024-09-16,9893
3032,偉訓,17,0,17,元大-大天母,2024-09-16,9893
00905,FT臺灣Smart,17,0,17,元大-大天母,2024-09-16,9893
00720B,元大投資級公司債,18,2,16,元大-大天母,2024-09-16,9893
2204,中華,15,0,15,元大-大天母,2024-09-16,9893
00949,復華日本龍頭,15,0,15,元大-大天母,2024-09-16,9893
00878,國泰永續高股息,25,10,15,元大-大天母,2024-09-16,9893
00915,凱基優選高股息30,14,0,14,元大-大天母,2024-09-16,9893
1539,巨庭,14,0,14,元大-大天母,2024-09-16,9893
4747,強生,14,0,14,元大-大天母,2024-09-16,9893
00795B,中信美國公債20年,13,0,13,元大-大天母,2024-09-16,9893
8096,擎亞,13,0,13,元大-大天母,2024-09-16,9893
2609,陽明,20,8,12,元大-大天母,2024-09-16,9893
3374,精材,19,7,12,元大-大天母,2024-09-16,9893
4513,福裕,18,6,12,元大-大天母,2024-09-16,9893
3078,僑威,14,3,11,元大-大天母,2024-09-16,9893
3189,景碩,11,0,11,元大-大天母,2024-09-16,9893
6643,M31,12,1,11,元大-大天母,2024-09-16,9893
2356,英業達,12,2,10,元大-大天母,2024-09-16,9893
00632R,元大台灣50反1,424,0,424,元大-大天母,2024-09-18,9893
8028,昇陽半導體,326,1,325,元大-大天母,2024-09-18,9893
2888,新光金,517,241,276,元大-大天母,2024-09-18,9893
6143,振曜,154,3,151,元大-大天母,2024-09-18,9893
00948B,中信優息投資級債,139,0,139,元大-大天母,2024-09-18,9893
00919,群益台灣精選高息,134,1,133,元大-大天母,2024-09-18,9893
00929,復華台灣科技優息,105,1,104,元大-大天母,2024-09-18,9893
3363,上詮,102,6,96,元大-大天母,2024-09-18,9893
00712,復華富時不動產,102,7,95,元大-大天母,2024-09-18,9893
00918,大華優利高填息30,97,6,91,元大-大天母,2024-09-18,9893
2316,楠梓電,75,0,75,元大-大天母,2024-09-18,9893
2504,國產,70,1,69,元大-大天母,2024-09-18,9893
00679B,元大美債20年,66,9,57,元大-大天母,2024-09-18,9893
2477,美隆電,60,4,56,元大-大天母,2024-09-18,9893
2382,廣達,57,2,55,元大-大天母,2024-09-18,9893
00764B,群益25年美債,55,0,55,元大-大天母,2024-09-18,9893
3040,遠見,52,0,52,元大-大天母,2024-09-18,9893
00687B,國泰20年美債,118,67,51,元大-大天母,2024-09-18,9893
00713,元大台灣高息低波,45,2,43,元大-大天母,2024-09-18,9893
00937B,群益ESG投等債20,67,24,43,元大-大天母,2024-09-18,9893
2317,鴻海,57,15,42,元大-大天母,2024-09-18,9893
00726B,國泰新興投等債,34,0,34,元大-大天母,2024-09-18,9893
4979,華星光,51,17,34,元大-大天母,2024-09-18,9893
2313,華通,35,4,31,元大-大天母,2024-09-18,9893
2887,台新金,30,0,30,元大-大天母,2024-09-18,9893
00706L,期元大S＆P日圓正2,25,0,25,元大-大天母,2024-09-18,9893
2472,立隆電,25,0,25,元大-大天母,2024-09-18,9893
5438,東友,42,17,25,元大-大天母,2024-09-18,9893
2323,中環,25,1,24,元大-大天母,2024-09-18,9893
2303,聯電,34,11,23,元大-大天母,2024-09-18,9893
6257,矽格,22,0,22,元大-大天母,2024-09-18,9893
2449,京元電子,23,2,21,元大-大天母,2024-09-18,9893
6438,迅得,23,3,20,元大-大天母,2024-09-18,9893
4906,正文,20,1,19,元大-大天母,2024-09-18,9893
00915,凱基優選高股息30,25,7,18,元大-大天母,2024-09-18,9893
3447,展達,25,7,18,元大-大天母,2024-09-18,9893
1711,永光,312,294,18,元大-大天母,2024-09-18,9893
5234,達興材料,27,10,17,元大-大天母,2024-09-18,9893
00934,中信成長高股息,20,3,17,元大-大天母,2024-09-18,9893
1717,長興,47,31,16,元大-大天母,2024-09-18,9893
2328,廣宇,16,0,16,元大-大天母,2024-09-18,9893
1536,和大,29,13,16,元大-大天母,2024-09-18,9893
00688L,國泰20年美債正2,45,30,15,元大-大天母,2024-09-18,9893
00641R,富邦日本反1,15,0,15,元大-大天母,2024-09-18,9893
6213,聯茂,27,12,15,元大-大天母,2024-09-18,9893
3019,亞光,19,4,15,元大-大天母,2024-09-18,9893
1785,光洋科,44,30,14,元大-大天母,2024-09-18,9893
00881,國泰台灣5G+,15,1,14,元大-大天母,2024-09-18,9893
6899,創為精密,14,0,14,元大-大天母,2024-09-18,9893
8299,群聯,13,0,13,元大-大天母,2024-09-18,9893
2891,中信金,404,77,327,元大-大天母,2024-09-19,9893
6125,廣運,278,3,275,元大-大天母,2024-09-19,9893
2888,新光金,307,66,241,元大-大天母,2024-09-19,9893
00958B,永豐ESG銀行債15,225,0,225,元大-大天母,2024-09-19,9893
2376,技嘉,164,2,162,元大-大天母,2024-09-19,9893
3049,精金,146,48,98,元大-大天母,2024-09-19,9893
1569,濱川,95,0,95,元大-大天母,2024-09-19,9893
2534,宏盛,86,0,86,元大-大天母,2024-09-19,9893
00878,國泰永續高股息,111,52,59,元大-大天母,2024-09-19,9893
00929,復華台灣科技優息,49,0,49,元大-大天母,2024-09-19,9893
3017,奇鋐,58,11,47,元大-大天母,2024-09-19,9893
00937B,群益ESG投等債20,45,0,45,元大-大天母,2024-09-19,9893
00919,群益台灣精選高息,44,3,41,元大-大天母,2024-09-19,9893
00680L,元大美債20正2,67,26,41,元大-大天母,2024-09-19,9893
2359,所羅門,42,4,38,元大-大天母,2024-09-19,9893
00687B,國泰20年美債,101,69,32,元大-大天母,2024-09-19,9893
2388,威盛,48,17,31,元大-大天母,2024-09-19,9893
2462,良得電,31,0,31,元大-大天母,2024-09-19,9893
00669R,國泰美國道瓊反1,30,0,30,元大-大天母,2024-09-19,9893
00778B,凱基金融債20+,30,0,30,元大-大天母,2024-09-19,9893
00720B,元大投資級公司債,30,0,30,元大-大天母,2024-09-19,9893
00648R,元大S＆P500反1,30,0,30,元大-大天母,2024-09-19,9893
4903,聯光通,53,24,29,元大-大天母,2024-09-19,9893
2834,臺企銀,28,0,28,元大-大天母,2024-09-19,9893
2881,富邦金,56,28,28,元大-大天母,2024-09-19,9893
3543,州巧,26,0,26,元大-大天母,2024-09-19,9893
3363,上詮,34,8,26,元大-大天母,2024-09-19,9893
2313,華通,30,5,25,元大-大天母,2024-09-19,9893
00915,凱基優選高股息30,24,0,24,元大-大天母,2024-09-19,9893
5438,東友,24,0,24,元大-大天母,2024-09-19,9893
5392,能率,25,1,24,元大-大天母,2024-09-19,9893
6288,聯嘉,23,0,23,元大-大天母,2024-09-19,9893
2426,鼎元,21,1,20,元大-大天母,2024-09-19,9893
00676R,富邦臺灣加權反1,20,0,20,元大-大天母,2024-09-19,9893
1301,台塑,21,1,20,元大-大天母,2024-09-19,9893
4716,大立,35,16,19,元大-大天母,2024-09-19,9893
3324,雙鴻,31,12,19,元大-大天母,2024-09-19,9893
3293,鈊象,19,1,18,元大-大天母,2024-09-19,9893
4747,強生,18,0,18,元大-大天母,2024-09-19,9893
00948B,中信優息投資級債,17,0,17,元大-大天母,2024-09-19,9893
1307,三芳,17,0,17,元大-大天母,2024-09-19,9893
3550,聯穎,21,7,14,元大-大天母,2024-09-19,9893
3450,聯鈞,15,2,13,元大-大天母,2024-09-19,9893
2889,國票金,12,0,12,元大-大天母,2024-09-19,9893
00706L,期元大S＆P日圓正2,12,0,12,元大-大天母,2024-09-19,9893
00918,大華優利高填息30,28,17,11,元大-大天母,2024-09-19,9893
2337,旺宏,11,0,11,元大-大天母,2024-09-19,9893
3217,優群,13,2,11,元大-大天母,2024-09-19,9893
6412,群電,10,0,10,元大-大天母,2024-09-19,9893
6239,力成,10,0,10,元大-大天母,2024-09-19,9893
00915,凱基優選高股息30,184,12,172,元大-大天母,2024-09-20,9893
1569,濱川,171,6,165,元大-大天母,2024-09-20,9893
1711,永光,416,256,160,元大-大天母,2024-09-20,9893
00919,群益台灣精選高息,120,6,114,元大-大天母,2024-09-20,9893
1717,長興,121,20,101,元大-大天母,2024-09-20,9893
00960,野村全球航運龍頭,80,0,80,元大-大天母,2024-09-20,9893
00688L,國泰20年美債正2,82,10,72,元大-大天母,2024-09-20,9893
00929,復華台灣科技優息,72,0,72,元大-大天母,2024-09-20,9893
3011,今皓,54,4,50,元大-大天母,2024-09-20,9893
4916,事欣科,51,1,50,元大-大天母,2024-09-20,9893
1709,和益,56,7,49,元大-大天母,2024-09-20,9893
2534,宏盛,50,2,48,元大-大天母,2024-09-20,9893
5905,南仁湖,52,4,48,元大-大天母,2024-09-20,9893
8091,翔名,110,66,44,元大-大天母,2024-09-20,9893
1903,士紙,42,0,42,元大-大天母,2024-09-20,9893
3535,晶彩科,40,0,40,元大-大天母,2024-09-20,9893
3010,華立,40,0,40,元大-大天母,2024-09-20,9893
2891,中信金,103,67,36,元大-大天母,2024-09-20,9893
2388,威盛,42,9,33,元大-大天母,2024-09-20,9893
2464,盟立,79,46,33,元大-大天母,2024-09-20,9893
2881,富邦金,53,24,29,元大-大天母,2024-09-20,9893
4909,新復興,33,6,27,元大-大天母,2024-09-20,9893
00680L,元大美債20正2,62,36,26,元大-大天母,2024-09-20,9893
00751B,元大AAA至A公司債,26,0,26,元大-大天母,2024-09-20,9893
00937B,群益ESG投等債20,31,6,25,元大-大天母,2024-09-20,9893
1536,和大,33,9,24,元大-大天母,2024-09-20,9893
00795B,中信美國公債20年,23,0,23,元大-大天母,2024-09-20,9893
2542,興富發,37,15,22,元大-大天母,2024-09-20,9893
2486,一詮,27,5,22,元大-大天母,2024-09-20,9893
2317,鴻海,71,49,22,元大-大天母,2024-09-20,9893
8096,擎亞,20,0,20,元大-大天母,2024-09-20,9893
2449,京元電子,21,1,20,元大-大天母,2024-09-20,9893
8086,宏捷科,20,0,20,元大-大天母,2024-09-20,9893
4747,強生,17,0,17,元大-大天母,2024-09-20,9893
3376,新日興,23,7,16,元大-大天母,2024-09-20,9893
3450,聯鈞,16,0,16,元大-大天母,2024-09-20,9893
8032,光菱,16,0,16,元大-大天母,2024-09-20,9893
4939,亞電,16,1,15,元大-大天母,2024-09-20,9893
0056,元大高股息,16,2,14,元大-大天母,2024-09-20,9893
3479,安勤,15,1,14,元大-大天母,2024-09-20,9893
00673R,期元大S＆P原油反1,14,0,14,元大-大天母,2024-09-20,9893
2887,台新金,15,2,13,元大-大天母,2024-09-20,9893
4576,大銀微系統,18,5,13,元大-大天母,2024-09-20,9893
2495,普安,14,1,13,元大-大天母,2024-09-20,9893
00720B,元大投資級公司債,13,0,13,元大-大天母,2024-09-20,9893
4526,東台,16,3,13,元大-大天母,2024-09-20,9893
3490,單井,13,0,13,元大-大天母,2024-09-20,9893
6274,台燿,19,6,13,元大-大天母,2024-09-20,9893
2382,廣達,28,16,12,元大-大天母,2024-09-20,9893
4306,炎洲,12,0,12,元大-大天母,2024-09-20,9893
2884,玉山金,398,0,398,元大-大天母,2024-09-23,9893
2888,新光金,226,40,186,元大-大天母,2024-09-23,9893
00688L,國泰20年美債正2,107,5,102,元大-大天母,2024-09-23,9893
4916,事欣科,100,0,100,元大-大天母,2024-09-23,9893
1536,和大,169,72,97,元大-大天母,2024-09-23,9893
00655L,國泰中國A50正2,80,0,80,元大-大天母,2024-09-23,9893
6438,迅得,86,6,80,元大-大天母,2024-09-23,9893
00687B,國泰20年美債,73,0,73,元大-大天母,2024-09-23,9893
00919,群益台灣精選高息,80,17,63,元大-大天母,2024-09-23,9893
6548,長科*,55,0,55,元大-大天母,2024-09-23,9893
1524,耿鼎,57,10,47,元大-大天母,2024-09-23,9893
00680L,元大美債20正2,44,0,44,元大-大天母,2024-09-23,9893
2426,鼎元,35,0,35,元大-大天母,2024-09-23,9893
2534,宏盛,33,0,33,元大-大天母,2024-09-23,9893
00795B,中信美國公債20年,32,2,30,元大-大天母,2024-09-23,9893
8032,光菱,28,0,28,元大-大天母,2024-09-23,9893
3450,聯鈞,36,9,27,元大-大天母,2024-09-23,9893
2464,盟立,112,85,27,元大-大天母,2024-09-23,9893
00934,中信成長高股息,26,0,26,元大-大天母,2024-09-23,9893
2301,光寶科,25,0,25,元大-大天母,2024-09-23,9893
3481,群創,43,18,25,元大-大天母,2024-09-23,9893
2885,元大金,27,3,24,元大-大天母,2024-09-23,9893
2618,長榮航,34,12,22,元大-大天母,2024-09-23,9893
00937B,群益ESG投等債20,73,52,21,元大-大天母,2024-09-23,9893
6288,聯嘉,31,10,21,元大-大天母,2024-09-23,9893
2495,普安,20,0,20,元大-大天母,2024-09-23,9893
6263,普萊德,20,0,20,元大-大天母,2024-09-23,9893
2449,京元電子,18,1,17,元大-大天母,2024-09-23,9893
6177,達麗,17,1,16,元大-大天母,2024-09-23,9893
2881,富邦金,24,9,15,元大-大天母,2024-09-23,9893
2409,友達,15,0,15,元大-大天母,2024-09-23,9893
2867,三商壽,15,0,15,元大-大天母,2024-09-23,9893
4113,聯上,14,0,14,元大-大天母,2024-09-23,9893
00673R,期元大S＆P原油反1,14,0,14,元大-大天母,2024-09-23,9893
00722B,群益投資級電信債,13,0,13,元大-大天母,2024-09-23,9893
3511,矽瑪,15,2,13,元大-大天母,2024-09-23,9893
8446,華研,13,0,13,元大-大天母,2024-09-23,9893
4977,眾達-KY,22,9,13,元大-大天母,2024-09-23,9893
8039,台虹,13,0,13,元大-大天母,2024-09-23,9893
3374,精材,26,14,12,元大-大天母,2024-09-23,9893
8255,朋程,10,0,10,元大-大天母,2024-09-23,9893
1218,泰山,10,0,10,元大-大天母,2024-09-23,9893
00676R,富邦臺灣加權反1,10,0,10,元大-大天母,2024-09-23,9893
00738U,期元大道瓊白銀,10,0,10,元大-大天母,2024-09-23,9893
2477,美隆電,15,5,10,元大-大天母,2024-09-23,9893
8089,康全電訊,10,0,10,元大-大天母,2024-09-23,9893
3149,正達,24,14,10,元大-大天母,2024-09-23,9893
4772,台特化,10,1,9,元大-大天母,2024-09-23,9893
3498,陽程,10,1,9,元大-大天母,2024-09-23,9893
00931B,統一美債20年,10,1,9,元大-大天母,2024-09-23,9893
00632R,元大台灣50反1,320,0,320,元大-大天母,2024-09-24,9893
1569,濱川,259,0,259,元大-大天母,2024-09-24,9893
4916,事欣科,152,0,152,元大-大天母,2024-09-24,9893
00637L,元大滬深300正2,124,20,104,元大-大天母,2024-09-24,9893
00960,野村全球航運龍頭,98,0,98,元大-大天母,2024-09-24,9893
00679B,元大美債20年,91,10,81,元大-大天母,2024-09-24,9893
00937B,群益ESG投等債20,81,10,71,元大-大天母,2024-09-24,9893
2388,威盛,69,12,57,元大-大天母,2024-09-24,9893
00915,凱基優選高股息30,54,0,54,元大-大天母,2024-09-24,9893
00687B,國泰20年美債,54,8,46,元大-大天母,2024-09-24,9893
2881,富邦金,64,21,43,元大-大天母,2024-09-24,9893
3149,正達,72,33,39,元大-大天母,2024-09-24,9893
6213,聯茂,50,16,34,元大-大天母,2024-09-24,9893
1584,精剛,39,5,34,元大-大天母,2024-09-24,9893
3293,鈊象,30,2,28,元大-大天母,2024-09-24,9893
3374,精材,44,17,27,元大-大天母,2024-09-24,9893
00700,富邦�琤肭磪�,26,0,26,元大-大天母,2024-09-24,9893
00878,國泰永續高股息,25,2,23,元大-大天母,2024-09-24,9893
3306,鼎天,24,1,23,元大-大天母,2024-09-24,9893
00929,復華台灣科技優息,28,5,23,元大-大天母,2024-09-24,9893
3056,富華新,21,0,21,元大-大天母,2024-09-24,9893
00948B,中信優息投資級債,20,0,20,元大-大天母,2024-09-24,9893
4526,東台,18,0,18,元大-大天母,2024-09-24,9893
1314,中石化,20,3,17,元大-大天母,2024-09-24,9893
5880,合庫金,17,1,16,元大-大天母,2024-09-24,9893
00952,凱基台灣AI50,15,0,15,元大-大天母,2024-09-24,9893
00918,大華優利高填息30,16,2,14,元大-大天母,2024-09-24,9893
3710,連展投控,22,8,14,元大-大天母,2024-09-24,9893
3019,亞光,31,18,13,元大-大天母,2024-09-24,9893
2472,立隆電,13,0,13,元大-大天母,2024-09-24,9893
3583,辛耘,18,6,12,元大-大天母,2024-09-24,9893
3581,博磊,26,14,12,元大-大天母,2024-09-24,9893
2634,漢翔,11,0,11,元大-大天母,2024-09-24,9893
8446,華研,11,0,11,元大-大天母,2024-09-24,9893
00722B,群益投資級電信債,11,0,11,元大-大天母,2024-09-24,9893
9938,百和,12,1,11,元大-大天母,2024-09-24,9893
2915,潤泰全,14,3,11,元大-大天母,2024-09-24,9893
00919,群益台灣精選高息,29,19,10,元大-大天母,2024-09-24,9893
0056,元大高股息,20,10,10,元大-大天母,2024-09-24,9893
3479,安勤,10,0,10,元大-大天母,2024-09-24,9893
00639,富邦深100,10,0,10,元大-大天母,2024-09-24,9893
00930,永豐ESG低碳高息,10,0,10,元大-大天母,2024-09-24,9893
6173,信昌電,10,0,10,元大-大天母,2024-09-24,9893
1815,富喬,10,0,10,元大-大天母,2024-09-24,9893
8039,台虹,10,1,9,元大-大天母,2024-09-24,9893
2313,華通,18,9,9,元大-大天母,2024-09-24,9893
1539,巨庭,24,15,9,元大-大天母,2024-09-24,9893
6197,佳必琪,10,1,9,元大-大天母,2024-09-24,9893
00635U,期元大S＆P黃金,9,0,9,元大-大天母,2024-09-24,9893
2399,映泰,58,49,9,元大-大天母,2024-09-24,9893
2888,新光金,300,27,273,元大-大天母,2024-09-25,9893
00637L,元大滬深300正2,318,59,259,元大-大天母,2024-09-25,9893
2891,中信金,171,53,118,元大-大天母,2024-09-25,9893
00937B,群益ESG投等債20,127,12,115,元大-大天母,2024-09-25,9893
2388,威盛,116,1,115,元大-大天母,2024-09-25,9893
00687B,國泰20年美債,137,27,110,元大-大天母,2024-09-25,9893
00882,中信中國高股息,102,6,96,元大-大天母,2024-09-25,9893
00665L,富邦�琤肭磪囓�2,110,16,94,元大-大天母,2024-09-25,9893
2534,宏盛,92,8,84,元大-大天母,2024-09-25,9893
5488,松普,409,337,72,元大-大天母,2024-09-25,9893
00676R,富邦臺灣加權反1,56,0,56,元大-大天母,2024-09-25,9893
00915,凱基優選高股息30,52,0,52,元大-大天母,2024-09-25,9893
2009,第一銅,51,0,51,元大-大天母,2024-09-25,9893
4916,事欣科,50,0,50,元大-大天母,2024-09-25,9893
00680L,元大美債20正2,46,1,45,元大-大天母,2024-09-25,9893
8921,沈氏,40,0,40,元大-大天母,2024-09-25,9893
4977,眾達-KY,46,6,40,元大-大天母,2024-09-25,9893
00650L,復華香港正2,30,0,30,元大-大天母,2024-09-25,9893
1519,華城,36,7,29,元大-大天母,2024-09-25,9893
3379,彬台,28,0,28,元大-大天母,2024-09-25,9893
1711,永光,96,70,26,元大-大天母,2024-09-25,9893
00929,復華台灣科技優息,61,36,25,元大-大天母,2024-09-25,9893
00960,野村全球航運龍頭,55,31,24,元大-大天母,2024-09-25,9893
2883,凱基金,23,1,22,元大-大天母,2024-09-25,9893
2323,中環,23,1,22,元大-大天母,2024-09-25,9893
2618,長榮航,58,36,22,元大-大天母,2024-09-25,9893
3035,智原,26,5,21,元大-大天母,2024-09-25,9893
8111,立��,40,19,21,元大-大天母,2024-09-25,9893
3550,聯穎,71,54,17,元大-大天母,2024-09-25,9893
1301,台塑,30,13,17,元大-大天母,2024-09-25,9893
1314,中石化,23,7,16,元大-大天母,2024-09-25,9893
00720B,元大投資級公司債,16,0,16,元大-大天母,2024-09-25,9893
1609,大亞,18,2,16,元大-大天母,2024-09-25,9893
6669,緯穎,23,7,16,元大-大天母,2024-09-25,9893
4903,聯光通,40,26,14,元大-大天母,2024-09-25,9893
1108,幸福,14,0,14,元大-大天母,2024-09-25,9893
2539,櫻花建,14,0,14,元大-大天母,2024-09-25,9893
3622,洋華,47,34,13,元大-大天母,2024-09-25,9893
1582,信錦,13,0,13,元大-大天母,2024-09-25,9893
6923,中台,16,3,13,元大-大天母,2024-09-25,9893
00635U,期元大S＆P黃金,13,1,12,元大-大天母,2024-09-25,9893
1532,勤美,12,0,12,元大-大天母,2024-09-25,9893
6168,宏齊,31,19,12,元大-大天母,2024-09-25,9893
2376,技嘉,16,4,12,元大-大天母,2024-09-25,9893
2408,南亞科,13,2,11,元大-大天母,2024-09-25,9893
5498,凱崴,11,0,11,元大-大天母,2024-09-25,9893
00795B,中信美國公債20年,11,0,11,元大-大天母,2024-09-25,9893
6869,雲豹能源,17,6,11,元大-大天母,2024-09-25,9893
3588,通嘉,11,0,11,元大-大天母,2024-09-25,9893
3711,日月光投控,12,2,10,元大-大天母,2024-09-25,9893
00919,群益台灣精選高息,128,17,111,元大-大天母,2024-09-26,9893
00671R,富邦NASDAQ反1,80,0,80,元大-大天母,2024-09-26,9893
3490,單井,79,0,79,元大-大天母,2024-09-26,9893
00687B,國泰20年美債,147,73,74,元大-大天母,2024-09-26,9893
1808,潤隆,84,12,72,元大-大天母,2024-09-26,9893
8921,沈氏,67,0,67,元大-大天母,2024-09-26,9893
2344,華邦電,64,7,57,元大-大天母,2024-09-26,9893
9933,中鼎,51,0,51,元大-大天母,2024-09-26,9893
00648R,元大S＆P500反1,50,0,50,元大-大天母,2024-09-26,9893
00679B,元大美債20年,55,6,49,元大-大天母,2024-09-26,9893
2613,中櫃,57,9,48,元大-大天母,2024-09-26,9893
00740B,富邦全球投等債,40,0,40,元大-大天母,2024-09-26,9893
00795B,中信美國公債20年,34,0,34,元大-大天母,2024-09-26,9893
00715L,期街口布蘭特正2,33,2,31,元大-大天母,2024-09-26,9893
1519,華城,43,12,31,元大-大天母,2024-09-26,9893
1710,東聯,30,0,30,元大-大天母,2024-09-26,9893
6923,中台,31,1,30,元大-大天母,2024-09-26,9893
1540,喬福,50,22,28,元大-大天母,2024-09-26,9893
6248,沛波,28,0,28,元大-大天母,2024-09-26,9893
00918,大華優利高填息30,48,21,27,元大-大天母,2024-09-26,9893
3019,亞光,49,22,27,元大-大天母,2024-09-26,9893
00720B,元大投資級公司債,28,2,26,元大-大天母,2024-09-26,9893
2408,南亞科,29,4,25,元大-大天母,2024-09-26,9893
3714,富采,91,71,20,元大-大天母,2024-09-26,9893
00929,復華台灣科技優息,22,2,20,元大-大天母,2024-09-26,9893
2457,飛宏,20,0,20,元大-大天母,2024-09-26,9893
5438,東友,20,0,20,元大-大天母,2024-09-26,9893
1909,榮成,20,0,20,元大-大天母,2024-09-26,9893
00937B,群益ESG投等債20,30,10,20,元大-大天母,2024-09-26,9893
00680L,元大美債20正2,70,52,18,元大-大天母,2024-09-26,9893
3715,定穎投控,27,10,17,元大-大天母,2024-09-26,9893
3710,連展投控,15,0,15,元大-大天母,2024-09-26,9893
3673,TPK-KY,45,30,15,元大-大天母,2024-09-26,9893
00907,永豐優息存股,15,0,15,元大-大天母,2024-09-26,9893
8996,高力,16,1,15,元大-大天母,2024-09-26,9893
1503,士電,20,5,15,元大-大天母,2024-09-26,9893
3094,聯傑,34,20,14,元大-大天母,2024-09-26,9893
3605,宏致,21,8,13,元大-大天母,2024-09-26,9893
2883,凱基金,20,7,13,元大-大天母,2024-09-26,9893
1815,富喬,13,0,13,元大-大天母,2024-09-26,9893
00751B,元大AAA至A公司債,13,0,13,元大-大天母,2024-09-26,9893
3661,世芯-KY,19,7,12,元大-大天母,2024-09-26,9893
3062,建漢,18,6,12,元大-大天母,2024-09-26,9893
3533,嘉澤,12,0,12,元大-大天母,2024-09-26,9893
2402,毅嘉,13,1,12,元大-大天母,2024-09-26,9893
6770,力積電,11,0,11,元大-大天母,2024-09-26,9893
2367,燿華,15,4,11,元大-大天母,2024-09-26,9893
5469,瀚宇博,12,1,11,元大-大天母,2024-09-26,9893
6139,亞翔,11,0,11,元大-大天母,2024-09-26,9893
3374,精材,14,3,11,元大-大天母,2024-09-26,9893
00740B,富邦全球投等債,100,0,100,元大-大天母,2024-09-27,9893
00939,統一台灣高息動能,100,1,99,元大-大天母,2024-09-27,9893
00679B,元大美債20年,104,14,90,元大-大天母,2024-09-27,9893
2891,中信金,109,39,70,元大-大天母,2024-09-27,9893
00687B,國泰20年美債,72,7,65,元大-大天母,2024-09-27,9893
2534,宏盛,58,0,58,元大-大天母,2024-09-27,9893
0061,元大寶滬深,54,0,54,元大-大天母,2024-09-27,9893
2201,裕隆,60,7,53,元大-大天母,2024-09-27,9893
3149,正達,120,68,52,元大-大天母,2024-09-27,9893
4916,事欣科,50,0,50,元大-大天母,2024-09-27,9893
1524,耿鼎,45,1,44,元大-大天母,2024-09-27,9893
8921,沈氏,40,0,40,元大-大天母,2024-09-27,9893
3711,日月光投控,39,0,39,元大-大天母,2024-09-27,9893
2049,上銀,45,7,38,元大-大天母,2024-09-27,9893
2317,鴻海,69,37,32,元大-大天母,2024-09-27,9893
3450,聯鈞,38,10,28,元大-大天母,2024-09-27,9893
6248,沛波,31,3,28,元大-大天母,2024-09-27,9893
00960,野村全球航運龍頭,30,4,26,元大-大天母,2024-09-27,9893
2884,玉山金,25,0,25,元大-大天母,2024-09-27,9893
4979,華星光,65,43,22,元大-大天母,2024-09-27,9893
2002,中鋼,110,87,23,元大-大天母,2024-09-27,9893
6104,創惟,39,18,21,元大-大天母,2024-09-27,9893
1108,幸福,21,0,21,元大-大天母,2024-09-27,9893
4128,中天,21,0,21,元大-大天母,2024-09-27,9893
2371,大同,33,13,20,元大-大天母,2024-09-27,9893
6213,聯茂,69,50,19,元大-大天母,2024-09-27,9893
2382,廣達,30,12,18,元大-大天母,2024-09-27,9893
2402,毅嘉,19,1,18,元大-大天母,2024-09-27,9893
5388,中磊,17,0,17,元大-大天母,2024-09-27,9893
00937B,群益ESG投等債20,72,55,17,元大-大天母,2024-09-27,9893
00931B,統一美債20年,15,0,15,元大-大天母,2024-09-27,9893
8032,光菱,13,0,13,元大-大天母,2024-09-27,9893
00642U,期元大S＆P石油,13,0,13,元大-大天母,2024-09-27,9893
00720B,元大投資級公司債,13,1,12,元大-大天母,2024-09-27,9893
2881,富邦金,15,3,12,元大-大天母,2024-09-27,9893
00927,群益半導體收益,12,0,12,元大-大天母,2024-09-27,9893
6442,光聖,19,7,12,元大-大天母,2024-09-27,9893
00676R,富邦臺灣加權反1,12,0,12,元大-大天母,2024-09-27,9893
2888,新光金,12,0,12,元大-大天母,2024-09-27,9893
2399,映泰,19,8,11,元大-大天母,2024-09-27,9893
00751B,元大AAA至A公司債,11,0,11,元大-大天母,2024-09-27,9893
00953B,群益優選非投等債,11,0,11,元大-大天母,2024-09-27,9893
006208,富邦台50,11,0,11,元大-大天母,2024-09-27,9893
1569,濱川,10,0,10,元大-大天母,2024-09-27,9893
5880,合庫金,11,1,10,元大-大天母,2024-09-27,9893
8299,群聯,11,1,10,元大-大天母,2024-09-27,9893
3030,德律,10,0,10,元大-大天母,2024-09-27,9893
3035,智原,36,26,10,元大-大天母,2024-09-27,9893
2809,京城銀,10,0,10,元大-大天母,2024-09-27,9893
00948B,中信優息投資級債,10,0,10,元大-大天母,2024-09-27,9893
00637L,元大滬深300正2,1968,370,1598,元大-大天母,2024-09-30,9893
00632R,元大台灣50反1,303,0,303,元大-大天母,2024-09-30,9893
00919,群益台灣精選高息,119,1,118,元大-大天母,2024-09-30,9893
2534,宏盛,106,0,106,元大-大天母,2024-09-30,9893
4916,事欣科,100,0,100,元大-大天母,2024-09-30,9893
1569,濱川,104,4,100,元大-大天母,2024-09-30,9893
00940,元大台灣價值高息,105,9,96,元大-大天母,2024-09-30,9893
2330,台積電,96,10,86,元大-大天母,2024-09-30,9893
00937B,群益ESG投等債20,80,0,80,元大-大天母,2024-09-30,9893
2605,新興,104,30,74,元大-大天母,2024-09-30,9893
00679B,元大美債20年,82,24,58,元大-大天母,2024-09-30,9893
00725B,國泰投資級公司債,152,104,48,元大-大天母,2024-09-30,9893
00929,復華台灣科技優息,55,8,47,元大-大天母,2024-09-30,9893
6438,迅得,56,11,45,元大-大天母,2024-09-30,9893
2888,新光金,40,2,38,元大-大天母,2024-09-30,9893
5432,新門,35,0,35,元大-大天母,2024-09-30,9893
4989,榮科,32,0,32,元大-大天母,2024-09-30,9893
1308,亞聚,31,0,31,元大-大天母,2024-09-30,9893
0056,元大高股息,31,0,31,元大-大天母,2024-09-30,9893
8921,沈氏,26,0,26,元大-大天母,2024-09-30,9893
6869,雲豹能源,26,0,26,元大-大天母,2024-09-30,9893
3167,大量,25,0,25,元大-大天母,2024-09-30,9893
2426,鼎元,25,0,25,元大-大天母,2024-09-30,9893
00934,中信成長高股息,24,0,24,元大-大天母,2024-09-30,9893
00720B,元大投資級公司債,26,3,23,元大-大天母,2024-09-30,9893
00936,台新永續高息中小,20,0,20,元大-大天母,2024-09-30,9893
1447,力鵬,20,0,20,元大-大天母,2024-09-30,9893
1513,中興電,20,2,18,元大-大天母,2024-09-30,9893
00650L,復華香港正2,32,14,18,元大-大天母,2024-09-30,9893
1809,中釉,19,1,18,元大-大天母,2024-09-30,9893
3588,通嘉,21,4,17,元大-大天母,2024-09-30,9893
2030,彰源,18,1,17,元大-大天母,2024-09-30,9893
00680L,元大美債20正2,17,0,17,元大-大天母,2024-09-30,9893
00687B,國泰20年美債,20,4,16,元大-大天母,2024-09-30,9893
4527,方土霖,15,0,15,元大-大天母,2024-09-30,9893
00948B,中信優息投資級債,15,0,15,元大-大天母,2024-09-30,9893
00685L,群益臺灣加權正2,15,0,15,元大-大天母,2024-09-30,9893
00960,野村全球航運龍頭,20,6,14,元大-大天母,2024-09-30,9893
2014,中鴻,65,51,14,元大-大天母,2024-09-30,9893
0061,元大寶滬深,17,3,14,元大-大天母,2024-09-30,9893
2308,台達電,14,0,14,元大-大天母,2024-09-30,9893
5905,南仁湖,14,1,13,元大-大天母,2024-09-30,9893
00636,國泰中國A50,13,0,13,元大-大天母,2024-09-30,9893
1307,三芳,21,8,13,元大-大天母,2024-09-30,9893
8028,昇陽半導體,17,5,12,元大-大天母,2024-09-30,9893
2303,聯電,21,9,12,元大-大天母,2024-09-30,9893
00665L,富邦�琤肭磪囓�2,164,152,12,元大-大天母,2024-09-30,9893
00905,FT臺灣Smart,14,2,12,元大-大天母,2024-09-30,9893
6156,松上,12,0,12,元大-大天母,2024-09-30,9893
6257,矽格,11,0,11,元大-大天母,2024-09-30,9893
00632R,元大台灣50反1,280,0,280,元大-大天母,2024-10-01,9893
2534,宏盛,171,0,171,元大-大天母,2024-10-01,9893
00637L,元大滬深300正2,165,19,146,元大-大天母,2024-10-01,9893
00719B,元大美債1-3,130,0,130,元大-大天母,2024-10-01,9893
1569,濱川,173,48,125,元大-大天母,2024-10-01,9893
00753L,中信中國50正2,119,13,106,元大-大天母,2024-10-01,9893
6188,廣明,102,1,101,元大-大天母,2024-10-01,9893
00725B,國泰投資級公司債,100,0,100,元大-大天母,2024-10-01,9893
2399,映泰,118,26,92,元大-大天母,2024-10-01,9893
00665L,富邦�琤肭磪囓�2,87,2,85,元大-大天母,2024-10-01,9893
0061,元大寶滬深,84,0,84,元大-大天母,2024-10-01,9893
00679B,元大美債20年,104,30,74,元大-大天母,2024-10-01,9893
00671R,富邦NASDAQ反1,70,0,70,元大-大天母,2024-10-01,9893
00650L,復華香港正2,65,10,55,元大-大天母,2024-10-01,9893
00648R,元大S＆P500反1,50,0,50,元大-大天母,2024-10-01,9893
2605,新興,51,4,47,元大-大天母,2024-10-01,9893
2371,大同,66,23,43,元大-大天母,2024-10-01,9893
00878,國泰永續高股息,43,0,43,元大-大天母,2024-10-01,9893
00929,復華台灣科技優息,43,0,43,元大-大天母,2024-10-01,9893
00633L,富邦上証正2,62,20,42,元大-大天母,2024-10-01,9893
0056,元大高股息,93,54,39,元大-大天母,2024-10-01,9893
1711,永光,39,0,39,元大-大天母,2024-10-01,9893
1776,展宇,31,0,31,元大-大天母,2024-10-01,9893
5905,南仁湖,30,0,30,元大-大天母,2024-10-01,9893
8112,至上,30,0,30,元大-大天母,2024-10-01,9893
2888,新光金,31,5,26,元大-大天母,2024-10-01,9893
00937B,群益ESG投等債20,26,0,26,元大-大天母,2024-10-01,9893
5452,佶優,26,0,26,元大-大天母,2024-10-01,9893
1513,中興電,27,2,25,元大-大天母,2024-10-01,9893
1304,台聚,21,0,21,元大-大天母,2024-10-01,9893
1307,三芳,23,3,20,元大-大天母,2024-10-01,9893
4527,方土霖,20,1,19,元大-大天母,2024-10-01,9893
2472,立隆電,19,0,19,元大-大天母,2024-10-01,9893
2303,聯電,20,1,19,元大-大天母,2024-10-01,9893
006205,富邦上証,18,0,18,元大-大天母,2024-10-01,9893
006208,富邦台50,17,0,17,元大-大天母,2024-10-01,9893
6239,力成,17,0,17,元大-大天母,2024-10-01,9893
3025,星通,20,3,17,元大-大天母,2024-10-01,9893
2883,凱基金,17,1,16,元大-大天母,2024-10-01,9893
00948B,中信優息投資級債,16,0,16,元大-大天母,2024-10-01,9893
3019,亞光,22,6,16,元大-大天母,2024-10-01,9893
1536,和大,37,21,16,元大-大天母,2024-10-01,9893
6168,宏齊,16,0,16,元大-大天母,2024-10-01,9893
1909,榮成,15,0,15,元大-大天母,2024-10-01,9893
2344,華邦電,55,40,15,元大-大天母,2024-10-01,9893
1504,東元,15,1,14,元大-大天母,2024-10-01,9893
6425,易發,24,10,14,元大-大天母,2024-10-01,9893
4747,強生,14,1,13,元大-大天母,2024-10-01,9893
2929,淘帝-KY,15,2,13,元大-大天母,2024-10-01,9893
2885,元大金,14,2,12,元大-大天母,2024-10-01,9893
00688L,國泰20年美債正2,359,90,269,元大-大天母,2024-10-04,9893
00673R,期元大S＆P原油反1,248,0,248,元大-大天母,2024-10-04,9893
00632R,元大台灣50反1,225,0,225,元大-大天母,2024-10-04,9893
1314,中石化,122,1,121,元大-大天母,2024-10-04,9893
00919,群益台灣精選高息,118,6,112,元大-大天母,2024-10-04,9893
00680L,元大美債20正2,127,40,87,元大-大天母,2024-10-04,9893
2609,陽明,93,11,82,元大-大天母,2024-10-04,9893
00915,凱基優選高股息30,79,0,79,元大-大天母,2024-10-04,9893
00940,元大台灣價值高息,85,30,55,元大-大天母,2024-10-04,9893
00932,兆豐永續高息等權,54,0,54,元大-大天母,2024-10-04,9893
0056,元大高股息,49,0,49,元大-大天母,2024-10-04,9893
2615,萬海,71,34,37,元大-大天母,2024-10-04,9893
2881,富邦金,45,8,37,元大-大天母,2024-10-04,9893
2303,聯電,39,3,36,元大-大天母,2024-10-04,9893
8466,美吉吉-KY,35,0,35,元大-大天母,2024-10-04,9893
1301,台塑,39,5,34,元大-大天母,2024-10-04,9893
00878,國泰永續高股息,34,2,32,元大-大天母,2024-10-04,9893
00934,中信成長高股息,32,0,32,元大-大天母,2024-10-04,9893
00948B,中信優息投資級債,32,0,32,元大-大天母,2024-10-04,9893
8049,晶采,30,0,30,元大-大天母,2024-10-04,9893
2892,第一金,31,3,28,元大-大天母,2024-10-04,9893
2308,台達電,28,0,28,元大-大天母,2024-10-04,9893
00943,兆豐電子高息等權,28,0,28,元大-大天母,2024-10-04,9893
2603,長榮,67,40,27,元大-大天母,2024-10-04,9893
00885,富邦越南,46,21,25,元大-大天母,2024-10-04,9893
00955,中信日本商社,25,0,25,元大-大天母,2024-10-04,9893
1513,中興電,30,7,23,元大-大天母,2024-10-04,9893
2613,中櫃,25,2,23,元大-大天母,2024-10-04,9893
00918,大華優利高填息30,23,2,21,元大-大天母,2024-10-04,9893
00929,復華台灣科技優息,76,56,20,元大-大天母,2024-10-04,9893
2605,新興,35,15,20,元大-大天母,2024-10-04,9893
00706L,期元大S＆P日圓正2,20,0,20,元大-大天母,2024-10-04,9893
4977,眾達-KY,23,3,20,元大-大天母,2024-10-04,9893
4540,全球傳動,20,0,20,元大-大天母,2024-10-04,9893
8039,台虹,25,5,20,元大-大天母,2024-10-04,9893
8937,合騏,19,0,19,元大-大天母,2024-10-04,9893
2009,第一銅,20,1,19,元大-大天母,2024-10-04,9893
00952,凱基台灣AI50,19,0,19,元大-大天母,2024-10-04,9893
1909,榮成,20,1,19,元大-大天母,2024-10-04,9893
2498,宏達電,43,24,19,元大-大天母,2024-10-04,9893
5351,鈺創,17,0,17,元大-大天母,2024-10-04,9893
2353,宏��,17,1,16,元大-大天母,2024-10-04,9893
8032,光菱,16,0,16,元大-大天母,2024-10-04,9893
2344,華邦電,17,1,16,元大-大天母,2024-10-04,9893
00922,國泰台灣領袖50,15,0,15,元大-大天母,2024-10-04,9893
2610,華航,16,1,15,元大-大天母,2024-10-04,9893
6188,廣明,20,5,15,元大-大天母,2024-10-04,9893
2472,立隆電,15,0,15,元大-大天母,2024-10-04,9893
2867,三商壽,14,0,14,元大-大天母,2024-10-04,9893
2382,廣達,15,1,14,元大-大天母,2024-10-04,9893
00665L,富邦�琤肭磪囓�2,640,110,530,元大-大天母,2024-10-07,9893
00637L,元大滬深300正2,446,176,270,元大-大天母,2024-10-07,9893
00882,中信中國高股息,187,48,139,元大-大天母,2024-10-07,9893
00639,富邦深100,109,2,107,元大-大天母,2024-10-07,9893
00752,中信中國50,97,6,91,元大-大天母,2024-10-07,9893
3062,建漢,61,0,61,元大-大天母,2024-10-07,9893
2603,長榮,79,37,42,元大-大天母,2024-10-07,9893
0056,元大高股息,36,3,33,元大-大天母,2024-10-07,9893
1569,濱川,43,10,33,元大-大天母,2024-10-07,9893
00887,永豐中國科技50大,43,15,28,元大-大天母,2024-10-07,9893
4747,強生,27,0,27,元大-大天母,2024-10-07,9893
6207,雷科,27,4,23,元大-大天母,2024-10-07,9893
4958,臻鼎-KY,22,0,22,元大-大天母,2024-10-07,9893
3591,艾笛森,26,4,22,元大-大天母,2024-10-07,9893
00673R,期元大S＆P原油反1,21,0,21,元大-大天母,2024-10-07,9893
2615,萬海,44,23,21,元大-大天母,2024-10-07,9893
3037,欣興,26,6,20,元大-大天母,2024-10-07,9893
2609,陽明,27,7,20,元大-大天母,2024-10-07,9893
00636,國泰中國A50,35,15,20,元大-大天母,2024-10-07,9893
4542,科嶠,20,0,20,元大-大天母,2024-10-07,9893
8076,伍豐,20,0,20,元大-大天母,2024-10-07,9893
00919,群益台灣精選高息,51,31,20,元大-大天母,2024-10-07,9893
2388,威盛,23,4,19,元大-大天母,2024-10-07,9893
00687B,國泰20年美債,31,12,19,元大-大天母,2024-10-07,9893
8466,美吉吉-KY,18,0,18,元大-大天母,2024-10-07,9893
5230,雷笛克光學,19,2,17,元大-大天母,2024-10-07,9893
00937B,群益ESG投等債20,17,1,16,元大-大天母,2024-10-07,9893
6703,軒郁,16,0,16,元大-大天母,2024-10-07,9893
00878,國泰永續高股息,24,9,15,元大-大天母,2024-10-07,9893
00934,中信成長高股息,15,0,15,元大-大天母,2024-10-07,9893
2353,宏��,15,0,15,元大-大天母,2024-10-07,9893
2313,華通,18,4,14,元大-大天母,2024-10-07,9893
2498,宏達電,21,8,13,元大-大天母,2024-10-07,9893
2886,兆豐金,13,0,13,元大-大天母,2024-10-07,9893
0061,元大寶滬深,31,18,13,元大-大天母,2024-10-07,9893
4979,華星光,33,20,13,元大-大天母,2024-10-07,9893
00915,凱基優選高股息30,12,0,12,元大-大天母,2024-10-07,9893
1307,三芳,29,17,12,元大-大天母,2024-10-07,9893
5443,均豪,23,11,12,元大-大天母,2024-10-07,9893
00940,元大台灣價值高息,32,20,12,元大-大天母,2024-10-07,9893
4909,新復興,26,14,12,元大-大天母,2024-10-07,9893
006208,富邦台50,14,2,12,元大-大天母,2024-10-07,9893
00713,元大台灣高息低波,13,2,11,元大-大天母,2024-10-07,9893
4772,台特化,11,0,11,元大-大天母,2024-10-07,9893
6670,復盛應用,11,0,11,元大-大天母,2024-10-07,9893
8921,沈氏,11,0,11,元大-大天母,2024-10-07,9893
00960,野村全球航運龍頭,14,3,11,元大-大天母,2024-10-07,9893
00931B,統一美債20年,11,0,11,元大-大天母,2024-10-07,9893
2316,楠梓電,28,17,11,元大-大天母,2024-10-07,9893
00712,復華富時不動產,11,0,11,元大-大天母,2024-10-07,9893
00637L,元大滬深300正2,1516,799,717,元大-大天母,2024-10-08,9893
00680L,元大美債20正2,160,46,114,元大-大天母,2024-10-08,9893
00940,元大台灣價值高息,125,22,103,元大-大天母,2024-10-08,9893
00887,永豐中國科技50大,173,75,98,元大-大天母,2024-10-08,9893
2363,矽統,111,34,77,元大-大天母,2024-10-08,9893
0056,元大高股息,66,3,63,元大-大天母,2024-10-08,9893
2344,華邦電,63,0,63,元大-大天母,2024-10-08,9893
00937B,群益ESG投等債20,76,14,62,元大-大天母,2024-10-08,9893
6438,迅得,69,9,60,元大-大天母,2024-10-08,9893
00753L,中信中國50正2,293,238,55,元大-大天母,2024-10-08,9893
2426,鼎元,53,2,51,元大-大天母,2024-10-08,9893
00673R,期元大S＆P原油反1,51,0,51,元大-大天母,2024-10-08,9893
2886,兆豐金,45,1,44,元大-大天母,2024-10-08,9893
00948B,中信優息投資級債,40,0,40,元大-大天母,2024-10-08,9893
2360,致茂,37,3,34,元大-大天母,2024-10-08,9893
5443,均豪,63,30,33,元大-大天母,2024-10-08,9893
00687B,國泰20年美債,45,12,33,元大-大天母,2024-10-08,9893
00878,國泰永續高股息,36,4,32,元大-大天母,2024-10-08,9893
00929,復華台灣科技優息,48,17,31,元大-大天母,2024-10-08,9893
00934,中信成長高股息,32,1,31,元大-大天母,2024-10-08,9893
2498,宏達電,39,12,27,元大-大天母,2024-10-08,9893
4909,新復興,36,10,26,元大-大天母,2024-10-08,9893
5880,合庫金,23,0,23,元大-大天母,2024-10-08,9893
00922,國泰台灣領袖50,23,0,23,元大-大天母,2024-10-08,9893
4747,強生,23,0,23,元大-大天母,2024-10-08,9893
8111,立��,24,2,22,元大-大天母,2024-10-08,9893
3209,全科,32,11,21,元大-大天母,2024-10-08,9893
0061,元大寶滬深,21,0,21,元大-大天母,2024-10-08,9893
00713,元大台灣高息低波,23,2,21,元大-大天母,2024-10-08,9893
3037,欣興,21,1,20,元大-大天母,2024-10-08,9893
00927,群益半導體收益,20,0,20,元大-大天母,2024-10-08,9893
00943,兆豐電子高息等權,20,0,20,元大-大天母,2024-10-08,9893
00740B,富邦全球投等債,20,0,20,元大-大天母,2024-10-08,9893
00882,中信中國高股息,77,57,20,元大-大天母,2024-10-08,9893
00959B,大華投等美債15Y+,20,3,17,元大-大天母,2024-10-08,9893
3591,艾笛森,22,5,17,元大-大天母,2024-10-08,9893
006205,富邦上証,16,0,16,元大-大天母,2024-10-08,9893
9945,潤泰新,16,0,16,元大-大天母,2024-10-08,9893
3019,亞光,16,0,16,元大-大天母,2024-10-08,9893
1711,永光,24,8,16,元大-大天母,2024-10-08,9893
2929,淘帝-KY,18,3,15,元大-大天母,2024-10-08,9893
00907,永豐優息存股,15,0,15,元大-大天母,2024-10-08,9893
6873,泓德能源,15,0,15,元大-大天母,2024-10-08,9893
6134,萬旭,39,24,15,元大-大天母,2024-10-08,9893
00949,復華日本龍頭,14,0,14,元大-大天母,2024-10-08,9893
2376,技嘉,14,1,13,元大-大天母,2024-10-08,9893
3049,精金,32,19,13,元大-大天母,2024-10-08,9893
1314,中石化,15,2,13,元大-大天母,2024-10-08,9893
2845,遠東銀,12,0,12,元大-大天母,2024-10-08,9893
2836,高雄銀,12,0,12,元大-大天母,2024-10-08,9893
00637L,元大滬深300正2,960,274,686,元大-大天母,2024-10-09,9893
2888,新光金,338,0,338,元大-大天母,2024-10-09,9893
00753L,中信中國50正2,499,220,279,元大-大天母,2024-10-09,9893
00882,中信中國高股息,178,31,147,元大-大天母,2024-10-09,9893
1569,濱川,139,7,132,元大-大天母,2024-10-09,9893
00679B,元大美債20年,127,7,120,元大-大天母,2024-10-09,9893
00772B,中信高評級公司債,101,0,101,元大-大天母,2024-10-09,9893
2880,華南金,100,0,100,元大-大天母,2024-10-09,9893
5439,高技,73,1,72,元大-大天母,2024-10-09,9893
00948B,中信優息投資級債,71,0,71,元大-大天母,2024-10-09,9893
1711,永光,67,0,67,元大-大天母,2024-10-09,9893
00633L,富邦上証正2,166,110,56,元大-大天母,2024-10-09,9893
00687B,國泰20年美債,55,0,55,元大-大天母,2024-10-09,9893
00665L,富邦�琤肭磪囓�2,160,105,55,元大-大天母,2024-10-09,9893
2609,陽明,58,5,53,元大-大天母,2024-10-09,9893
00632R,元大台灣50反1,50,0,50,元大-大天母,2024-10-09,9893
00922,國泰台灣領袖50,48,5,43,元大-大天母,2024-10-09,9893
00937B,群益ESG投等債20,40,0,40,元大-大天母,2024-10-09,9893
6160,欣技,38,0,38,元大-大天母,2024-10-09,9893
3714,富采,77,40,37,元大-大天母,2024-10-09,9893
8937,合騏,32,0,32,元大-大天母,2024-10-09,9893
2603,長榮,56,24,32,元大-大天母,2024-10-09,9893
00919,群益台灣精選高息,32,1,31,元大-大天母,2024-10-09,9893
4747,強生,30,0,30,元大-大天母,2024-10-09,9893
1536,和大,56,28,28,元大-大天母,2024-10-09,9893
2363,矽統,105,78,27,元大-大天母,2024-10-09,9893
3481,群創,29,5,24,元大-大天母,2024-10-09,9893
1808,潤隆,25,1,24,元大-大天母,2024-10-09,9893
4526,東台,30,7,23,元大-大天母,2024-10-09,9893
4977,眾達-KY,94,72,22,元大-大天母,2024-10-09,9893
3048,益登,27,5,22,元大-大天母,2024-10-09,9893
2408,南亞科,30,9,21,元大-大天母,2024-10-09,9893
6152,百一,20,0,20,元大-大天母,2024-10-09,9893
2352,佳世達,22,2,20,元大-大天母,2024-10-09,9893
00655L,國泰中國A50正2,29,9,20,元大-大天母,2024-10-09,9893
3025,星通,60,40,20,元大-大天母,2024-10-09,9893
3380,明泰,23,4,19,元大-大天母,2024-10-09,9893
00940,元大台灣價值高息,33,14,19,元大-大天母,2024-10-09,9893
00680L,元大美債20正2,34,16,18,元大-大天母,2024-10-09,9893
2303,聯電,24,6,18,元大-大天母,2024-10-09,9893
5443,均豪,44,27,17,元大-大天母,2024-10-09,9893
2601,益航,15,0,15,元大-大天母,2024-10-09,9893
3227,原相,24,9,15,元大-大天母,2024-10-09,9893
3013,晟銘電,30,16,14,元大-大天母,2024-10-09,9893
00751B,元大AAA至A公司債,14,0,14,元大-大天母,2024-10-09,9893
4909,新復興,20,6,14,元大-大天母,2024-10-09,9893
2436,偉詮電,17,3,14,元大-大天母,2024-10-09,9893
8096,擎亞,15,2,13,元大-大天母,2024-10-09,9893
00673R,期元大S＆P原油反1,35,22,13,元大-大天母,2024-10-09,9893
1595,川寶,25,12,13,元大-大天母,2024-10-09,9893
00679B,元大美債20年,143,5,138,元大-大天母,2024-10-11,9893
00632R,元大台灣50反1,135,0,135,元大-大天母,2024-10-11,9893
00680L,元大美債20正2,128,45,83,元大-大天母,2024-10-11,9893
00922,國泰台灣領袖50,67,0,67,元大-大天母,2024-10-11,9893
00637L,元大滬深300正2,489,425,64,元大-大天母,2024-10-11,9893
00948B,中信優息投資級債,63,0,63,元大-大天母,2024-10-11,9893
2449,京元電子,92,31,61,元大-大天母,2024-10-11,9893
0056,元大高股息,61,1,60,元大-大天母,2024-10-11,9893
00638R,元大滬深300反1,60,0,60,元大-大天母,2024-10-11,9893
00687B,國泰20年美債,66,7,59,元大-大天母,2024-10-11,9893
00740B,富邦全球投等債,50,0,50,元大-大天母,2024-10-11,9893
3060,銘異,93,52,41,元大-大天母,2024-10-11,9893
00937B,群益ESG投等債20,34,0,34,元大-大天母,2024-10-11,9893
8111,立��,62,28,34,元大-大天母,2024-10-11,9893
2317,鴻海,76,42,34,元大-大天母,2024-10-11,9893
00931B,統一美債20年,32,0,32,元大-大天母,2024-10-11,9893
00673R,期元大S＆P原油反1,32,0,32,元大-大天母,2024-10-11,9893
2356,英業達,33,1,32,元大-大天母,2024-10-11,9893
3379,彬台,34,3,31,元大-大天母,2024-10-11,9893
6913,鴻呈,30,0,30,元大-大天母,2024-10-11,9893
4956,光鋐,38,9,29,元大-大天母,2024-10-11,9893
2049,上銀,30,3,27,元大-大天母,2024-10-11,9893
2887,台新金,26,0,26,元大-大天母,2024-10-11,9893
00633L,富邦上証正2,44,18,26,元大-大天母,2024-10-11,9893
00882,中信中國高股息,33,8,25,元大-大天母,2024-10-11,9893
6108,競國,26,2,24,元大-大天母,2024-10-11,9893
00915,凱基優選高股息30,28,4,24,元大-大天母,2024-10-11,9893
00932,兆豐永續高息等權,23,0,23,元大-大天母,2024-10-11,9893
00878,國泰永續高股息,23,3,20,元大-大天母,2024-10-11,9893
6457,紘康,20,0,20,元大-大天母,2024-10-11,9893
6830,汎銓,24,6,18,元大-大天母,2024-10-11,9893
9914,美利達,17,0,17,元大-大天母,2024-10-11,9893
2201,裕隆,17,0,17,元大-大天母,2024-10-11,9893
2867,三商壽,17,0,17,元大-大天母,2024-10-11,9893
2615,萬海,27,11,16,元大-大天母,2024-10-11,9893
4958,臻鼎-KY,16,0,16,元大-大天母,2024-10-11,9893
3013,晟銘電,28,13,15,元大-大天母,2024-10-11,9893
3090,日電貿,15,0,15,元大-大天母,2024-10-11,9893
2344,華邦電,15,0,15,元大-大天母,2024-10-11,9893
1605,華新,17,2,15,元大-大天母,2024-10-11,9893
2363,矽統,63,48,15,元大-大天母,2024-10-11,9893
2464,盟立,23,9,14,元大-大天母,2024-10-11,9893
4909,新復興,18,6,12,元大-大天母,2024-10-11,9893
2886,兆豐金,12,0,12,元大-大天母,2024-10-11,9893
3708,上緯投控,21,10,11,元大-大天母,2024-10-11,9893
6937,天虹,14,3,11,元大-大天母,2024-10-11,9893
3715,定穎投控,18,7,11,元大-大天母,2024-10-11,9893
2637,慧洋-KY,12,1,11,元大-大天母,2024-10-11,9893
8089,康全電訊,12,1,11,元大-大天母,2024-10-11,9893
8937,合騏,22,11,11,元大-大天母,2024-10-11,9893
00637L,元大滬深300正2,247,128,119,元大-大天母,2024-10-14,9893
00887,永豐中國科技50大,100,1,99,元大-大天母,2024-10-14,9893
00638R,元大滬深300反1,87,0,87,元大-大天母,2024-10-14,9893
1464,得力,84,2,82,元大-大天母,2024-10-14,9893
00679B,元大美債20年,69,0,69,元大-大天母,2024-10-14,9893
00948B,中信優息投資級債,62,0,62,元大-大天母,2024-10-14,9893
6108,競國,60,3,57,元大-大天母,2024-10-14,9893
00632R,元大台灣50反1,55,0,55,元大-大天母,2024-10-14,9893
00722B,群益投資級電信債,50,0,50,元大-大天母,2024-10-14,9893
4916,事欣科,52,2,50,元大-大天母,2024-10-14,9893
00922,國泰台灣領袖50,43,0,43,元大-大天母,2024-10-14,9893
0056,元大高股息,42,0,42,元大-大天母,2024-10-14,9893
00933B,國泰10Y+金融債,42,0,42,元大-大天母,2024-10-14,9893
6005,群益證,40,0,40,元大-大天母,2024-10-14,9893
2882,國泰金,34,1,33,元大-大天母,2024-10-14,9893
00725B,國泰投資級公司債,31,1,30,元大-大天母,2024-10-14,9893
2312,金寶,68,42,26,元大-大天母,2024-10-14,9893
6913,鴻呈,25,0,25,元大-大天母,2024-10-14,9893
1785,光洋科,24,0,24,元大-大天母,2024-10-14,9893
00665L,富邦�琤肭磪囓�2,44,20,24,元大-大天母,2024-10-14,9893
2388,威盛,27,4,23,元大-大天母,2024-10-14,9893
3049,精金,29,6,23,元大-大天母,2024-10-14,9893
00937B,群益ESG投等債20,32,10,22,元大-大天母,2024-10-14,9893
2049,上銀,25,4,21,元大-大天母,2024-10-14,9893
5438,東友,21,1,20,元大-大天母,2024-10-14,9893
2367,燿華,19,0,19,元大-大天母,2024-10-14,9893
4991,環宇-KY,19,1,18,元大-大天母,2024-10-14,9893
00943,兆豐電子高息等權,17,0,17,元大-大天母,2024-10-14,9893
00878,國泰永續高股息,18,1,17,元大-大天母,2024-10-14,9893
00919,群益台灣精選高息,15,0,15,元大-大天母,2024-10-14,9893
8089,康全電訊,17,2,15,元大-大天母,2024-10-14,9893
3031,佰鴻,14,0,14,元大-大天母,2024-10-14,9893
2887,台新金,15,2,13,元大-大天母,2024-10-14,9893
00720B,元大投資級公司債,13,0,13,元大-大天母,2024-10-14,9893
3163,波若威,22,9,13,元大-大天母,2024-10-14,9893
2892,第一金,13,0,13,元大-大天母,2024-10-14,9893
00958B,永豐ESG銀行債15,11,0,11,元大-大天母,2024-10-14,9893
0061,元大寶滬深,17,6,11,元大-大天母,2024-10-14,9893
2723,美食-KY,11,0,11,元大-大天母,2024-10-14,9893
3380,明泰,14,3,11,元大-大天母,2024-10-14,9893
6530,創威,26,16,10,元大-大天母,2024-10-14,9893
8103,瀚荃,10,0,10,元大-大天母,2024-10-14,9893
4107,邦特,10,0,10,元大-大天母,2024-10-14,9893
3189,景碩,10,0,10,元大-大天母,2024-10-14,9893
6517,保勝光學,10,0,10,元大-大天母,2024-10-14,9893
4714,永捷,10,1,9,元大-大天母,2024-10-14,9893
4527,方土霖,10,1,9,元大-大天母,2024-10-14,9893
00882,中信中國高股息,11,2,9,元大-大天母,2024-10-14,9893
00636,國泰中國A50,12,3,9,元大-大天母,2024-10-14,9893
6278,台表科,9,0,9,元大-大天母,2024-10-14,9893
00650L,復華香港正2,159,0,159,元大-大天母,2024-10-15,9893
00948B,中信優息投資級債,100,0,100,元大-大天母,2024-10-15,9893
2888,新光金,130,34,96,元大-大天母,2024-10-15,9893
2891,中信金,123,28,95,元大-大天母,2024-10-15,9893
5452,佶優,135,55,80,元大-大天母,2024-10-15,9893
2449,京元電子,108,29,79,元大-大天母,2024-10-15,9893
00679B,元大美債20年,185,120,65,元大-大天母,2024-10-15,9893
2820,華票,60,0,60,元大-大天母,2024-10-15,9893
00937B,群益ESG投等債20,62,3,59,元大-大天母,2024-10-15,9893
1560,中砂,67,8,59,元大-大天母,2024-10-15,9893
00639,富邦深100,56,0,56,元大-大天母,2024-10-15,9893
3013,晟銘電,67,16,51,元大-大天母,2024-10-15,9893
00676R,富邦臺灣加權反1,50,0,50,元大-大天母,2024-10-15,9893
00671R,富邦NASDAQ反1,50,0,50,元大-大天母,2024-10-15,9893
00654R,富邦印度反1,50,0,50,元大-大天母,2024-10-15,9893
00648R,元大S＆P500反1,50,0,50,元大-大天母,2024-10-15,9893
00637L,元大滬深300正2,176,127,49,元大-大天母,2024-10-15,9893
00725B,國泰投資級公司債,50,1,49,元大-大天母,2024-10-15,9893
3447,展達,52,4,48,元大-大天母,2024-10-15,9893
6241,易通展,40,3,37,元大-大天母,2024-10-15,9893
00915,凱基優選高股息30,35,4,31,元大-大天母,2024-10-15,9893
00961,FT臺灣永續高息,30,0,30,元大-大天母,2024-10-15,9893
5438,東友,31,1,30,元大-大天母,2024-10-15,9893
6156,松上,116,86,30,元大-大天母,2024-10-15,9893
4977,眾達-KY,53,23,30,元大-大天母,2024-10-15,9893
00922,國泰台灣領袖50,61,32,29,元大-大天母,2024-10-15,9893
00687B,國泰20年美債,35,6,29,元大-大天母,2024-10-15,9893
2399,映泰,56,30,26,元大-大天母,2024-10-15,9893
8111,立��,43,19,24,元大-大天母,2024-10-15,9893
3149,正達,71,48,23,元大-大天母,2024-10-15,9893
2408,南亞科,28,6,22,元大-大天母,2024-10-15,9893
2312,金寶,72,51,21,元大-大天母,2024-10-15,9893
4542,科嶠,22,1,21,元大-大天母,2024-10-15,9893
00931B,統一美債20年,22,2,20,元大-大天母,2024-10-15,9893
00708L,期元大S＆P黃金正2,20,0,20,元大-大天母,2024-10-15,9893
2851,中再保,20,0,20,元大-大天母,2024-10-15,9893
3265,台星科,20,0,20,元大-大天母,2024-10-15,9893
8097,常珵,20,1,19,元大-大天母,2024-10-15,9893
1711,永光,17,3,14,元大-大天母,2024-10-15,9893
00633L,富邦上証正2,15,1,14,元大-大天母,2024-10-15,9893
3380,明泰,16,3,13,元大-大天母,2024-10-15,9893
3591,艾笛森,17,4,13,元大-大天母,2024-10-15,9893
1609,大亞,16,3,13,元大-大天母,2024-10-15,9893
00715L,期街口布蘭特正2,22,10,12,元大-大天母,2024-10-15,9893
00932,兆豐永續高息等權,12,0,12,元大-大天母,2024-10-15,9893
8096,擎亞,12,0,12,元大-大天母,2024-10-15,9893
00929,復華台灣科技優息,35,23,12,元大-大天母,2024-10-15,9893
5880,合庫金,13,2,11,元大-大天母,2024-10-15,9893
3605,宏致,12,1,11,元大-大天母,2024-10-15,9893
00693U,期街口S＆P黃豆,11,0,11,元大-大天母,2024-10-15,9893
00725B,國泰投資級公司債,282,0,282,元大-大天母,2024-10-16,9893
00887,永豐中國科技50大,169,3,166,元大-大天母,2024-10-16,9893
00753L,中信中國50正2,180,41,139,元大-大天母,2024-10-16,9893
6142,友勁,130,0,130,元大-大天母,2024-10-16,9893
2312,金寶,137,33,104,元大-大天母,2024-10-16,9893
1314,中石化,103,2,101,元大-大天母,2024-10-16,9893
2376,技嘉,113,12,101,元大-大天母,2024-10-16,9893
00922,國泰台灣領袖50,76,0,76,元大-大天母,2024-10-16,9893
0056,元大高股息,85,9,76,元大-大天母,2024-10-16,9893
00680L,元大美債20正2,80,5,75,元大-大天母,2024-10-16,9893
2330,台積電,66,6,60,元大-大天母,2024-10-16,9893
2820,華票,60,0,60,元大-大天母,2024-10-16,9893
2836,高雄銀,55,0,55,元大-大天母,2024-10-16,9893
1605,華新,52,0,52,元大-大天母,2024-10-16,9893
00943,兆豐電子高息等權,50,0,50,元大-大天母,2024-10-16,9893
1409,新纖,50,0,50,元大-大天母,2024-10-16,9893
2883,凱基金,44,0,44,元大-大天母,2024-10-16,9893
3209,全科,52,12,40,元大-大天母,2024-10-16,9893
2354,鴻準,38,1,37,元大-大天母,2024-10-16,9893
8032,光菱,51,17,34,元大-大天母,2024-10-16,9893
00638R,元大滬深300反1,32,2,30,元大-大天母,2024-10-16,9893
00688L,國泰20年美債正2,28,0,28,元大-大天母,2024-10-16,9893
00665L,富邦�琤肭磪囓�2,82,56,26,元大-大天母,2024-10-16,9893
3062,建漢,65,41,24,元大-大天母,2024-10-16,9893
00641R,富邦日本反1,24,0,24,元大-大天母,2024-10-16,9893
00919,群益台灣精選高息,22,0,22,元大-大天母,2024-10-16,9893
3703,欣陸,20,0,20,元大-大天母,2024-10-16,9893
00945B,凱基美國非投等債,20,0,20,元大-大天母,2024-10-16,9893
2303,聯電,26,7,19,元大-大天母,2024-10-16,9893
00687B,國泰20年美債,36,17,19,元大-大天母,2024-10-16,9893
00633L,富邦上証正2,28,10,18,元大-大天母,2024-10-16,9893
2359,所羅門,27,9,18,元大-大天母,2024-10-16,9893
6829,千附精密,19,1,18,元大-大天母,2024-10-16,9893
1536,和大,28,11,17,元大-大天母,2024-10-16,9893
6290,良維,17,0,17,元大-大天母,2024-10-16,9893
1569,濱川,15,0,15,元大-大天母,2024-10-16,9893
2880,華南金,16,1,15,元大-大天母,2024-10-16,9893
3447,展達,20,5,15,元大-大天母,2024-10-16,9893
00713,元大台灣高息低波,16,2,14,元大-大天母,2024-10-16,9893
3665,貿聯-KY,14,0,14,元大-大天母,2024-10-16,9893
3711,日月光投控,14,0,14,元大-大天母,2024-10-16,9893
6449,鈺邦,13,0,13,元大-大天母,2024-10-16,9893
2367,燿華,13,0,13,元大-大天母,2024-10-16,9893
2002,中鋼,13,0,13,元大-大天母,2024-10-16,9893
00961,FT臺灣永續高息,13,0,13,元大-大天母,2024-10-16,9893
2892,第一金,15,3,12,元大-大天母,2024-10-16,9893
2888,新光金,16,4,12,元大-大天母,2024-10-16,9893
6770,力積電,11,0,11,元大-大天母,2024-10-16,9893
6670,復盛應用,11,0,11,元大-大天母,2024-10-16,9893
1210,大成,11,0,11,元大-大天母,2024-10-16,9893
00637L,元大滬深300正2,576,60,516,元大-大天母,2024-10-17,9893
2312,金寶,696,212,484,元大-大天母,2024-10-17,9893
00922,國泰台灣領袖50,166,1,165,元大-大天母,2024-10-17,9893
3209,全科,186,21,165,元大-大天母,2024-10-17,9893
8390,金益鼎,97,0,97,元大-大天母,2024-10-17,9893
0056,元大高股息,100,16,84,元大-大天母,2024-10-17,9893
00753L,中信中國50正2,105,40,65,元大-大天母,2024-10-17,9893
2820,華票,62,0,62,元大-大天母,2024-10-17,9893
9105,泰金寶-DR,56,0,56,元大-大天母,2024-10-17,9893
00915,凱基優選高股息30,51,1,50,元大-大天母,2024-10-17,9893
00882,中信中國高股息,49,0,49,元大-大天母,2024-10-17,9893
00919,群益台灣精選高息,51,2,49,元大-大天母,2024-10-17,9893
00937B,群益ESG投等債20,44,0,44,元大-大天母,2024-10-17,9893
2605,新興,44,0,44,元大-大天母,2024-10-17,9893
00665L,富邦�琤肭磪囓�2,41,3,38,元大-大天母,2024-10-17,9893
00724B,群益投資級金融債,35,0,35,元大-大天母,2024-10-17,9893
00887,永豐中國科技50大,35,0,35,元大-大天母,2024-10-17,9893
00632R,元大台灣50反1,30,0,30,元大-大天母,2024-10-17,9893
00656R,國泰中國A50反1,30,0,30,元大-大天母,2024-10-17,9893
3714,富采,100,74,26,元大-大天母,2024-10-17,9893
00638R,元大滬深300反1,25,0,25,元大-大天母,2024-10-17,9893
2363,矽統,27,3,24,元大-大天母,2024-10-17,9893
4977,眾達-KY,25,2,23,元大-大天母,2024-10-17,9893
6438,迅得,26,4,22,元大-大天母,2024-10-17,9893
2330,台積電,34,13,21,元大-大天母,2024-10-17,9893
00941,中信上游半導體,20,0,20,元大-大天母,2024-10-17,9893
8358,金居,27,9,18,元大-大天母,2024-10-17,9893
2303,聯電,17,0,17,元大-大天母,2024-10-17,9893
3379,彬台,16,0,16,元大-大天母,2024-10-17,9893
6203,海韻電,15,0,15,元大-大天母,2024-10-17,9893
3290,東浦,26,11,15,元大-大天母,2024-10-17,9893
00960,野村全球航運龍頭,15,0,15,元大-大天母,2024-10-17,9893
3167,大量,14,0,14,元大-大天母,2024-10-17,9893
3591,艾笛森,15,1,14,元大-大天母,2024-10-17,9893
6274,台燿,17,3,14,元大-大天母,2024-10-17,9893
3149,正達,33,19,14,元大-大天母,2024-10-17,9893
00929,復華台灣科技優息,19,5,14,元大-大天母,2024-10-17,9893
2421,建準,20,7,13,元大-大天母,2024-10-17,9893
3711,日月光投控,19,7,12,元大-大天母,2024-10-17,9893
3710,連展投控,13,1,12,元大-大天母,2024-10-17,9893
2371,大同,12,0,12,元大-大天母,2024-10-17,9893
6005,群益證,12,0,12,元大-大天母,2024-10-17,9893
3715,定穎投控,13,1,12,元大-大天母,2024-10-17,9893
2543,皇昌,13,2,11,元大-大天母,2024-10-17,9893
4533,協易機,16,5,11,元大-大天母,2024-10-17,9893
2637,慧洋-KY,21,10,11,元大-大天母,2024-10-17,9893
6202,盛群,11,0,11,元大-大天母,2024-10-17,9893
2601,益航,11,0,11,元大-大天母,2024-10-17,9893
00650L,復華香港正2,150,140,10,元大-大天母,2024-10-17,9893
5475,德宏,10,0,10,元大-大天母,2024-10-17,9893
00937B,群益ESG投等債20,388,4,384,元大-大天母,2024-10-18,9893
2303,聯電,219,17,202,元大-大天母,2024-10-18,9893
00637L,元大滬深300正2,324,136,188,元大-大天母,2024-10-18,9893
00676R,富邦臺灣加權反1,160,0,160,元大-大天母,2024-10-18,9893
00887,永豐中國科技50大,140,10,130,元大-大天母,2024-10-18,9893
2354,鴻準,124,1,123,元大-大天母,2024-10-18,9893
3011,今皓,102,0,102,元大-大天母,2024-10-18,9893
8069,元太,96,6,90,元大-大天母,2024-10-18,9893
3209,全科,99,22,77,元大-大天母,2024-10-18,9893
00679B,元大美債20年,62,3,59,元大-大天母,2024-10-18,9893
00687B,國泰20年美債,66,11,55,元大-大天母,2024-10-18,9893
0056,元大高股息,67,12,55,元大-大天母,2024-10-18,9893
1569,濱川,54,1,53,元大-大天母,2024-10-18,9893
00722B,群益投資級電信債,50,0,50,元大-大天母,2024-10-18,9893
4916,事欣科,50,0,50,元大-大天母,2024-10-18,9893
2449,京元電子,77,39,38,元大-大天母,2024-10-18,9893
6213,聯茂,61,26,35,元大-大天母,2024-10-18,9893
5452,佶優,54,21,33,元大-大天母,2024-10-18,9893
00959B,大華投等美債15Y+,30,0,30,元大-大天母,2024-10-18,9893
00931B,統一美債20年,30,0,30,元大-大天母,2024-10-18,9893
4576,大銀微系統,66,36,30,元大-大天母,2024-10-18,9893
3031,佰鴻,37,8,29,元大-大天母,2024-10-18,9893
2867,三商壽,27,1,26,元大-大天母,2024-10-18,9893
00720B,元大投資級公司債,44,18,26,元大-大天母,2024-10-18,9893
4991,環宇-KY,27,2,25,元大-大天母,2024-10-18,9893
00751B,元大AAA至A公司債,23,0,23,元大-大天母,2024-10-18,9893
9105,泰金寶-DR,35,13,22,元大-大天母,2024-10-18,9893
6151,晉倫,22,0,22,元大-大天母,2024-10-18,9893
4542,科嶠,28,7,21,元大-大天母,2024-10-18,9893
2009,第一銅,20,0,20,元大-大天母,2024-10-18,9893
00724B,群益投資級金融債,20,0,20,元大-大天母,2024-10-18,9893
5475,德宏,20,0,20,元大-大天母,2024-10-18,9893
3490,單井,26,6,20,元大-大天母,2024-10-18,9893
00757,統一FANG+,19,0,19,元大-大天母,2024-10-18,9893
2467,志聖,24,6,18,元大-大天母,2024-10-18,9893
00948B,中信優息投資級債,18,0,18,元大-大天母,2024-10-18,9893
4977,眾達-KY,28,10,18,元大-大天母,2024-10-18,9893
8028,昇陽半導體,47,30,17,元大-大天母,2024-10-18,9893
1560,中砂,34,18,16,元大-大天母,2024-10-18,9893
00725B,國泰投資級公司債,15,0,15,元大-大天母,2024-10-18,9893
00939,統一台灣高息動能,15,0,15,元大-大天母,2024-10-18,9893
4533,協易機,17,2,15,元大-大天母,2024-10-18,9893
2374,佳能,28,13,15,元大-大天母,2024-10-18,9893
4510,高鋒,36,22,14,元大-大天母,2024-10-18,9893
2367,燿華,13,0,13,元大-大天母,2024-10-18,9893
1314,中石化,13,1,12,元大-大天母,2024-10-18,9893
6264,富裔,12,0,12,元大-大天母,2024-10-18,9893
5347,世界,11,0,11,元大-大天母,2024-10-18,9893
3374,精材,27,16,11,元大-大天母,2024-10-18,9893
5309,系統電,13,2,11,元大-大天母,2024-10-18,9893
00753L,中信中國50正2,558,30,528,元大-大天母,2024-10-21,9893
6125,廣運,211,4,207,元大-大天母,2024-10-21,9893
00655L,國泰中國A50正2,205,0,205,元大-大天母,2024-10-21,9893
2464,盟立,219,39,180,元大-大天母,2024-10-21,9893
00937B,群益ESG投等債20,142,0,142,元大-大天母,2024-10-21,9893
2891,中信金,366,234,132,元大-大天母,2024-10-21,9893
2359,所羅門,124,14,110,元大-大天母,2024-10-21,9893
8210,勤誠,100,0,100,元大-大天母,2024-10-21,9893
3011,今皓,95,9,86,元大-大天母,2024-10-21,9893
2885,元大金,80,0,80,元大-大天母,2024-10-21,9893
2388,威盛,103,25,78,元大-大天母,2024-10-21,9893
00687B,國泰20年美債,90,18,72,元大-大天母,2024-10-21,9893
3354,律勝,87,19,68,元大-大天母,2024-10-21,9893
00878,國泰永續高股息,81,18,63,元大-大天母,2024-10-21,9893
1560,中砂,63,5,58,元大-大天母,2024-10-21,9893
4540,全球傳動,63,8,55,元大-大天母,2024-10-21,9893
00948B,中信優息投資級債,53,0,53,元大-大天母,2024-10-21,9893
00680L,元大美債20正2,50,0,50,元大-大天母,2024-10-21,9893
1802,台玻,52,3,49,元大-大天母,2024-10-21,9893
2303,聯電,44,2,42,元大-大天母,2024-10-21,9893
2884,玉山金,42,0,42,元大-大天母,2024-10-21,9893
00887,永豐中國科技50大,60,22,38,元大-大天母,2024-10-21,9893
4729,熒茂,36,4,32,元大-大天母,2024-10-21,9893
2421,建準,31,1,30,元大-大天母,2024-10-21,9893
2880,華南金,29,0,29,元大-大天母,2024-10-21,9893
1569,濱川,40,13,27,元大-大天母,2024-10-21,9893
8028,昇陽半導體,30,6,24,元大-大天母,2024-10-21,9893
00720B,元大投資級公司債,23,0,23,元大-大天母,2024-10-21,9893
2634,漢翔,23,0,23,元大-大天母,2024-10-21,9893
2882,國泰金,23,1,22,元大-大天母,2024-10-21,9893
6117,迎廣,22,1,21,元大-大天母,2024-10-21,9893
2540,愛山林,21,0,21,元大-大天母,2024-10-21,9893
1108,幸福,20,0,20,元大-大天母,2024-10-21,9893
3447,展達,42,22,20,元大-大天母,2024-10-21,9893
8021,尖點,22,2,20,元大-大天母,2024-10-21,9893
2548,華固,20,1,19,元大-大天母,2024-10-21,9893
1785,光洋科,18,0,18,元大-大天母,2024-10-21,9893
2489,瑞軒,21,4,17,元大-大天母,2024-10-21,9893
4533,協易機,25,9,16,元大-大天母,2024-10-21,9893
00665L,富邦�琤肭磪囓�2,17,1,16,元大-大天母,2024-10-21,9893
0056,元大高股息,19,4,15,元大-大天母,2024-10-21,9893
2867,三商壽,36,21,15,元大-大天母,2024-10-21,9893
2402,毅嘉,61,47,14,元大-大天母,2024-10-21,9893
3532,台勝科,14,0,14,元大-大天母,2024-10-21,9893
2363,矽統,65,52,13,元大-大天母,2024-10-21,9893
8927,北基,16,3,13,元大-大天母,2024-10-21,9893
00706L,期元大S＆P日圓正2,13,0,13,元大-大天母,2024-10-21,9893
3711,日月光投控,13,0,13,元大-大天母,2024-10-21,9893
1312,國喬,12,0,12,元大-大天母,2024-10-21,9893
9955,佳龍,12,0,12,元大-大天母,2024-10-21,9893
00937B,群益ESG投等債20,378,96,282,元大-大天母,2024-10-22,9893
2836,高雄銀,171,0,171,元大-大天母,2024-10-22,9893
00927,群益半導體收益,133,1,132,元大-大天母,2024-10-22,9893
00637L,元大滬深300正2,124,28,96,元大-大天母,2024-10-22,9893
00933B,國泰10Y+金融債,122,30,92,元大-大天母,2024-10-22,9893
00877,復華中國5G,90,0,90,元大-大天母,2024-10-22,9893
5315,光聯,71,0,71,元大-大天母,2024-10-22,9893
00680L,元大美債20正2,140,82,58,元大-大天母,2024-10-22,9893
3011,今皓,68,20,48,元大-大天母,2024-10-22,9893
1307,三芳,80,32,48,元大-大天母,2024-10-22,9893
00720B,元大投資級公司債,43,0,43,元大-大天母,2024-10-22,9893
3209,全科,52,12,40,元大-大天母,2024-10-22,9893
2548,華固,39,0,39,元大-大天母,2024-10-22,9893
5452,佶優,110,71,39,元大-大天母,2024-10-22,9893
2809,京城銀,35,0,35,元大-大天母,2024-10-22,9893
6763,綠界科技*,36,4,32,元大-大天母,2024-10-22,9893
00687B,國泰20年美債,118,88,30,元大-大天母,2024-10-22,9893
00887,永豐中國科技50大,80,50,30,元大-大天母,2024-10-22,9893
1434,福懋,30,0,30,元大-大天母,2024-10-22,9893
8390,金益鼎,51,21,30,元大-大天母,2024-10-22,9893
00679B,元大美債20年,135,106,29,元大-大天母,2024-10-22,9893
3290,東浦,26,0,26,元大-大天母,2024-10-22,9893
00751B,元大AAA至A公司債,32,7,25,元大-大天母,2024-10-22,9893
6151,晉倫,32,10,22,元大-大天母,2024-10-22,9893
1711,永光,24,3,21,元大-大天母,2024-10-22,9893
6005,群益證,20,0,20,元大-大天母,2024-10-22,9893
2363,矽統,47,27,20,元大-大天母,2024-10-22,9893
4716,大立,21,2,19,元大-大天母,2024-10-22,9893
3703,欣陸,21,3,18,元大-大天母,2024-10-22,9893
6530,創威,16,0,16,元大-大天母,2024-10-22,9893
5269,祥碩,18,2,16,元大-大天母,2024-10-22,9893
6532,瑞耘,19,4,15,元大-大天母,2024-10-22,9893
2330,台積電,20,6,14,元大-大天母,2024-10-22,9893
1477,聚陽,16,2,14,元大-大天母,2024-10-22,9893
2887,台新金,23,9,14,元大-大天母,2024-10-22,9893
00753L,中信中國50正2,23,9,14,元大-大天母,2024-10-22,9893
00665L,富邦�琤肭磪囓�2,24,10,14,元大-大天母,2024-10-22,9893
00795B,中信美國公債20年,13,0,13,元大-大天母,2024-10-22,9893
00929,復華台灣科技優息,26,13,13,元大-大天母,2024-10-22,9893
6414,樺漢,15,2,13,元大-大天母,2024-10-22,9893
6213,聯茂,22,9,13,元大-大天母,2024-10-22,9893
1540,喬福,13,0,13,元大-大天母,2024-10-22,9893
3447,展達,26,13,13,元大-大天母,2024-10-22,9893
00882,中信中國高股息,12,0,12,元大-大天母,2024-10-22,9893
2467,志聖,15,3,12,元大-大天母,2024-10-22,9893
00764B,群益25年美債,11,0,11,元大-大天母,2024-10-22,9893
3019,亞光,13,2,11,元大-大天母,2024-10-22,9893
00959B,大華投等美債15Y+,11,0,11,元大-大天母,2024-10-22,9893
3588,通嘉,13,2,11,元大-大天母,2024-10-22,9893
2353,宏��,10,0,10,元大-大天母,2024-10-22,9893
00679B,元大美債20年,336,9,327,元大-大天母,2024-10-23,9893
9904,寶成,150,1,149,元大-大天母,2024-10-23,9893
00637L,元大滬深300正2,212,95,117,元大-大天母,2024-10-23,9893
4916,事欣科,101,2,99,元大-大天母,2024-10-23,9893
00948B,中信優息投資級債,90,0,90,元大-大天母,2024-10-23,9893
2836,高雄銀,80,0,80,元大-大天母,2024-10-23,9893
00907,永豐優息存股,74,0,74,元大-大天母,2024-10-23,9893
6168,宏齊,71,0,71,元大-大天母,2024-10-23,9893
6213,聯茂,84,13,71,元大-大天母,2024-10-23,9893
00945B,凱基美國非投等債,53,0,53,元大-大天母,2024-10-23,9893
00887,永豐中國科技50大,104,52,52,元大-大天母,2024-10-23,9893
2002,中鋼,51,0,51,元大-大天母,2024-10-23,9893
2431,聯昌,62,12,50,元大-大天母,2024-10-23,9893
00953B,群益優選非投等債,50,0,50,元大-大天母,2024-10-23,9893
6152,百一,50,12,38,元大-大天母,2024-10-23,9893
00937B,群益ESG投等債20,85,50,35,元大-大天母,2024-10-23,9893
5347,世界,35,1,34,元大-大天母,2024-10-23,9893
00878,國泰永續高股息,30,0,30,元大-大天母,2024-10-23,9893
2014,中鴻,30,0,30,元大-大天母,2024-10-23,9893
2317,鴻海,37,7,30,元大-大天母,2024-10-23,9893
2883,凱基金,29,0,29,元大-大天母,2024-10-23,9893
2884,玉山金,28,0,28,元大-大天母,2024-10-23,9893
4716,大立,27,2,25,元大-大天母,2024-10-23,9893
0056,元大高股息,31,7,24,元大-大天母,2024-10-23,9893
00938,凱基優選30,24,0,24,元大-大天母,2024-10-23,9893
2618,長榮航,24,0,24,元大-大天母,2024-10-23,9893
00922,國泰台灣領袖50,23,0,23,元大-大天母,2024-10-23,9893
2367,燿華,23,0,23,元大-大天母,2024-10-23,9893
00918,大華優利高填息30,22,0,22,元大-大天母,2024-10-23,9893
3402,漢科,23,1,22,元大-大天母,2024-10-23,9893
2615,萬海,28,10,18,元大-大天母,2024-10-23,9893
2423,固緯,18,0,18,元大-大天母,2024-10-23,9893
2345,智邦,17,0,17,元大-大天母,2024-10-23,9893
3715,定穎投控,22,5,17,元大-大天母,2024-10-23,9893
00680L,元大美債20正2,20,3,17,元大-大天母,2024-10-23,9893
3055,蔚華科,55,38,17,元大-大天母,2024-10-23,9893
00935,野村臺灣新科技50,17,1,16,元大-大天母,2024-10-23,9893
2303,聯電,20,5,15,元大-大天母,2024-10-23,9893
00751B,元大AAA至A公司債,15,0,15,元大-大天母,2024-10-23,9893
8028,昇陽半導體,19,4,15,元大-大天母,2024-10-23,9893
2419,仲琦,15,0,15,元大-大天母,2024-10-23,9893
2809,京城銀,15,0,15,元大-大天母,2024-10-23,9893
2890,永豐金,15,0,15,元大-大天母,2024-10-23,9893
8076,伍豐,15,0,15,元大-大天母,2024-10-23,9893
00933B,國泰10Y+金融債,14,0,14,元大-大天母,2024-10-23,9893
6505,台塑化,14,0,14,元大-大天母,2024-10-23,9893
1903,士紙,13,0,13,元大-大天母,2024-10-23,9893
006208,富邦台50,12,0,12,元大-大天母,2024-10-23,9893
00949,復華日本龍頭,12,0,12,元大-大天母,2024-10-23,9893
6763,綠界科技*,12,0,12,元大-大天母,2024-10-23,9893
00650L,復華香港正2,104,0,104,元大-大天母,2024-10-24,9893
00753L,中信中國50正2,124,25,99,元大-大天母,2024-10-24,9893
1711,永光,92,3,89,元大-大天母,2024-10-24,9893
9945,潤泰新,83,6,77,元大-大天母,2024-10-24,9893
6205,詮欣,75,0,75,元大-大天母,2024-10-24,9893
5522,遠雄,61,0,61,元大-大天母,2024-10-24,9893
0056,元大高股息,61,2,59,元大-大天母,2024-10-24,9893
2421,建準,60,2,58,元大-大天母,2024-10-24,9893
9904,寶成,50,0,50,元大-大天母,2024-10-24,9893
2489,瑞軒,66,19,47,元大-大天母,2024-10-24,9893
00937B,群益ESG投等債20,77,30,47,元大-大天母,2024-10-24,9893
2883,凱基金,49,6,43,元大-大天母,2024-10-24,9893
2303,聯電,41,1,40,元大-大天母,2024-10-24,9893
3231,緯創,37,3,34,元大-大天母,2024-10-24,9893
00960,野村全球航運龍頭,34,0,34,元大-大天母,2024-10-24,9893
00680L,元大美債20正2,34,0,34,元大-大天母,2024-10-24,9893
2388,威盛,37,6,31,元大-大天母,2024-10-24,9893
2882,國泰金,31,0,31,元大-大天母,2024-10-24,9893
00637L,元大滬深300正2,49,18,31,元大-大天母,2024-10-24,9893
2458,義隆,30,0,30,元大-大天母,2024-10-24,9893
4113,聯上,30,0,30,元大-大天母,2024-10-24,9893
8935,邦泰,30,0,30,元大-大天母,2024-10-24,9893
2892,第一金,32,2,30,元大-大天母,2024-10-24,9893
1721,三晃,40,11,29,元大-大天母,2024-10-24,9893
1795,美時,28,0,28,元大-大天母,2024-10-24,9893
6768,志強-KY,38,11,27,元大-大天母,2024-10-24,9893
3163,波若威,26,0,26,元大-大天母,2024-10-24,9893
1815,富喬,25,0,25,元大-大天母,2024-10-24,9893
00665L,富邦�琤肭磪囓�2,25,0,25,元大-大天母,2024-10-24,9893
4991,環宇-KY,27,2,25,元大-大天母,2024-10-24,9893
2382,廣達,27,3,24,元大-大天母,2024-10-24,9893
00934,中信成長高股息,25,2,23,元大-大天母,2024-10-24,9893
2486,一詮,25,5,20,元大-大天母,2024-10-24,9893
00881,國泰台灣5G+,21,1,20,元大-大天母,2024-10-24,9893
3030,德律,20,0,20,元大-大天母,2024-10-24,9893
5493,三聯,20,0,20,元大-大天母,2024-10-24,9893
00948B,中信優息投資級債,35,15,20,元大-大天母,2024-10-24,9893
00929,復華台灣科技優息,20,0,20,元大-大天母,2024-10-24,9893
0061,元大寶滬深,18,0,18,元大-大天母,2024-10-24,9893
1513,中興電,17,0,17,元大-大天母,2024-10-24,9893
4977,眾達-KY,18,1,17,元大-大天母,2024-10-24,9893
2495,普安,20,3,17,元大-大天母,2024-10-24,9893
2312,金寶,21,5,16,元大-大天母,2024-10-24,9893
2884,玉山金,16,0,16,元大-大天母,2024-10-24,9893
6609,瀧澤科,26,11,15,元大-大天母,2024-10-24,9893
00943,兆豐電子高息等權,15,0,15,元大-大天母,2024-10-24,9893
3290,東浦,15,0,15,元大-大天母,2024-10-24,9893
00720B,元大投資級公司債,16,1,15,元大-大天母,2024-10-24,9893
4545,銘鈺,23,9,14,元大-大天母,2024-10-24,9893
2344,華邦電,14,0,14,元大-大天母,2024-10-24,9893
2302,麗正,172,3,169,元大-大天母,2024-10-25,9893
6142,友勁,109,3,106,元大-大天母,2024-10-25,9893
00887,永豐中國科技50大,101,0,101,元大-大天母,2024-10-25,9893
0056,元大高股息,73,0,73,元大-大天母,2024-10-25,9893
00959B,大華投等美債15Y+,70,0,70,元大-大天母,2024-10-25,9893
2431,聯昌,65,4,61,元大-大天母,2024-10-25,9893
00885,富邦越南,60,0,60,元大-大天母,2024-10-25,9893
00937B,群益ESG投等債20,72,13,59,元大-大天母,2024-10-25,9893
6205,詮欣,55,0,55,元大-大天母,2024-10-25,9893
00679B,元大美債20年,55,2,53,元大-大天母,2024-10-25,9893
4916,事欣科,50,0,50,元大-大天母,2024-10-25,9893
2303,聯電,51,3,48,元大-大天母,2024-10-25,9893
2495,普安,194,152,42,元大-大天母,2024-10-25,9893
8390,金益鼎,40,0,40,元大-大天母,2024-10-25,9893
6168,宏齊,40,0,40,元大-大天母,2024-10-25,9893
8249,菱光,65,27,38,元大-大天母,2024-10-25,9893
2646,星宇航空,244,206,38,元大-大天母,2024-10-25,9893
6209,今國光,32,0,32,元大-大天母,2024-10-25,9893
6283,淳安,31,0,31,元大-大天母,2024-10-25,9893
6768,志強-KY,37,7,30,元大-大天母,2024-10-25,9893
00688L,國泰20年美債正2,26,0,26,元大-大天母,2024-10-25,9893
2477,美隆電,33,8,25,元大-大天母,2024-10-25,9893
9105,泰金寶-DR,23,2,21,元大-大天母,2024-10-25,9893
00715L,期街口布蘭特正2,20,0,20,元大-大天母,2024-10-25,9893
1532,勤美,20,0,20,元大-大天母,2024-10-25,9893
4919,新唐,89,69,20,元大-大天母,2024-10-25,9893
6177,達麗,19,0,19,元大-大天母,2024-10-25,9893
2884,玉山金,18,0,18,元大-大天母,2024-10-25,9893
4991,環宇-KY,18,0,18,元大-大天母,2024-10-25,9893
00900,富邦特選高股息30,17,0,17,元大-大天母,2024-10-25,9893
2354,鴻準,95,78,17,元大-大天母,2024-10-25,9893
2883,凱基金,67,51,16,元大-大天母,2024-10-25,9893
4545,銘鈺,23,7,16,元大-大天母,2024-10-25,9893
2101,南港,17,1,16,元大-大天母,2024-10-25,9893
2486,一詮,28,12,16,元大-大天母,2024-10-25,9893
2351,順德,18,3,15,元大-大天母,2024-10-25,9893
4510,高鋒,27,12,15,元大-大天母,2024-10-25,9893
2344,華邦電,16,2,14,元大-大天母,2024-10-25,9893
2809,京城銀,14,0,14,元大-大天母,2024-10-25,9893
3060,銘異,12,0,12,元大-大天母,2024-10-25,9893
00960,野村全球航運龍頭,12,0,12,元大-大天母,2024-10-25,9893
00687B,國泰20年美債,23,12,11,元大-大天母,2024-10-25,9893
5871,中租-KY,11,0,11,元大-大天母,2024-10-25,9893
5521,工信,11,0,11,元大-大天母,2024-10-25,9893
2489,瑞軒,12,1,11,元大-大天母,2024-10-25,9893
2887,台新金,11,0,11,元大-大天母,2024-10-25,9893
2388,威盛,11,1,10,元大-大天母,2024-10-25,9893
3037,欣興,20,10,10,元大-大天母,2024-10-25,9893
1101,台泥,10,0,10,元大-大天母,2024-10-25,9893
00680L,元大美債20正2,10,0,10,元大-大天母,2024-10-25,9893
00706L,期元大S＆P日圓正2,225,0,225,元大-大天母,2024-10-28,9893
9904,寶成,212,16,196,元大-大天母,2024-10-28,9893
0056,元大高股息,126,0,126,元大-大天母,2024-10-28,9893
2641,正德,117,0,117,元大-大天母,2024-10-28,9893
00937B,群益ESG投等債20,119,25,94,元大-大天母,2024-10-28,9893
2303,聯電,97,4,93,元大-大天母,2024-10-28,9893
2646,星宇航空,131,44,87,元大-大天母,2024-10-28,9893
8390,金益鼎,80,1,79,元大-大天母,2024-10-28,9893
5534,長虹,60,0,60,元大-大天母,2024-10-28,9893
00679B,元大美債20年,58,4,54,元大-大天母,2024-10-28,9893
00878,國泰永續高股息,53,1,52,元大-大天母,2024-10-28,9893
0061,元大寶滬深,52,0,52,元大-大天母,2024-10-28,9893
6205,詮欣,46,0,46,元大-大天母,2024-10-28,9893
5488,松普,53,15,38,元大-大天母,2024-10-28,9893
4162,智擎,39,2,37,元大-大天母,2024-10-28,9893
00665L,富邦�琤肭磪囓�2,36,0,36,元大-大天母,2024-10-28,9893
2883,凱基金,30,0,30,元大-大天母,2024-10-28,9893
6170,統振,30,0,30,元大-大天母,2024-10-28,9893
00715L,期街口布蘭特正2,27,0,27,元大-大天母,2024-10-28,9893
1536,和大,29,2,27,元大-大天母,2024-10-28,9893
00948B,中信優息投資級債,26,0,26,元大-大天母,2024-10-28,9893
00938,凱基優選30,25,0,25,元大-大天母,2024-10-28,9893
8446,華研,25,0,25,元大-大天母,2024-10-28,9893
00751B,元大AAA至A公司債,25,1,24,元大-大天母,2024-10-28,9893
6209,今國光,24,1,23,元大-大天母,2024-10-28,9893
2809,京城銀,22,0,22,元大-大天母,2024-10-28,9893
00680L,元大美債20正2,22,0,22,元大-大天母,2024-10-28,9893
8111,立��,40,19,21,元大-大天母,2024-10-28,9893
4111,濟生,20,0,20,元大-大天母,2024-10-28,9893
2354,鴻準,101,82,19,元大-大天母,2024-10-28,9893
00885,富邦越南,20,1,19,元大-大天母,2024-10-28,9893
3105,穩懋,17,0,17,元大-大天母,2024-10-28,9893
2317,鴻海,44,27,17,元大-大天母,2024-10-28,9893
00931B,統一美債20年,16,0,16,元大-大天母,2024-10-28,9893
2392,正崴,16,0,16,元大-大天母,2024-10-28,9893
00959B,大華投等美債15Y+,16,0,16,元大-大天母,2024-10-28,9893
2329,華泰,16,0,16,元大-大天母,2024-10-28,9893
5386,青雲,15,0,15,元大-大天母,2024-10-28,9893
2464,盟立,15,0,15,元大-大天母,2024-10-28,9893
2603,長榮,41,27,14,元大-大天母,2024-10-28,9893
8249,菱光,67,53,14,元大-大天母,2024-10-28,9893
2615,萬海,25,11,14,元大-大天母,2024-10-28,9893
2388,威盛,21,8,13,元大-大天母,2024-10-28,9893
3363,上詮,23,11,12,元大-大天母,2024-10-28,9893
00633L,富邦上証正2,13,2,11,元大-大天母,2024-10-28,9893
3712,永崴投控,11,0,11,元大-大天母,2024-10-28,9893
3059,華晶科,12,1,11,元大-大天母,2024-10-28,9893
6805,富世達,13,3,10,元大-大天母,2024-10-28,9893
1722,台肥,10,0,10,元大-大天母,2024-10-28,9893
3666,光耀,10,0,10,元大-大天母,2024-10-28,9893
1449,佳和,363,27,336,元大-大天母,2024-10-29,9893
00632R,元大台灣50反1,700,490,210,元大-大天母,2024-10-29,9893
6205,詮欣,144,0,144,元大-大天母,2024-10-29,9893
0056,元大高股息,152,8,144,元大-大天母,2024-10-29,9893
00664R,國泰臺灣加權反1,130,0,130,元大-大天母,2024-10-29,9893
00940,元大台灣價值高息,117,0,117,元大-大天母,2024-10-29,9893
00637L,元大滬深300正2,123,15,108,元大-大天母,2024-10-29,9893
1409,新纖,100,0,100,元大-大天母,2024-10-29,9893
5534,長虹,71,0,71,元大-大天母,2024-10-29,9893
2303,聯電,87,21,66,元大-大天母,2024-10-29,9893
6239,力成,54,2,52,元大-大天母,2024-10-29,9893
4916,事欣科,50,0,50,元大-大天母,2024-10-29,9893
00641R,富邦日本反1,50,0,50,元大-大天母,2024-10-29,9893
00654R,富邦印度反1,50,0,50,元大-大天母,2024-10-29,9893
3714,富采,55,13,42,元大-大天母,2024-10-29,9893
00679B,元大美債20年,41,2,39,元大-大天母,2024-10-29,9893
0061,元大寶滬深,34,0,34,元大-大天母,2024-10-29,9893
8032,光菱,41,11,30,元大-大天母,2024-10-29,9893
8044,網家,32,2,30,元大-大天母,2024-10-29,9893
2330,台積電,45,17,28,元大-大天母,2024-10-29,9893
006208,富邦台50,27,1,26,元大-大天母,2024-10-29,9893
1605,華新,24,0,24,元大-大天母,2024-10-29,9893
2382,廣達,29,5,24,元大-大天母,2024-10-29,9893
2884,玉山金,23,0,23,元大-大天母,2024-10-29,9893
3264,欣銓,22,0,22,元大-大天母,2024-10-29,9893
4927,泰鼎-KY,21,0,21,元大-大天母,2024-10-29,9893
2548,華固,20,0,20,元大-大天母,2024-10-29,9893
4958,臻鼎-KY,20,1,19,元大-大天母,2024-10-29,9893
5481,新華,48,30,18,元大-大天母,2024-10-29,9893
0050,元大台灣50,20,3,17,元大-大天母,2024-10-29,9893
00715L,期街口布蘭特正2,17,0,17,元大-大天母,2024-10-29,9893
6170,統振,15,0,15,元大-大天母,2024-10-29,9893
1802,台玻,19,4,15,元大-大天母,2024-10-29,9893
00939,統一台灣高息動能,14,0,14,元大-大天母,2024-10-29,9893
2646,星宇航空,36,23,13,元大-大天母,2024-10-29,9893
1711,永光,14,1,13,元大-大天母,2024-10-29,9893
3227,原相,14,1,13,元大-大天母,2024-10-29,9893
00934,中信成長高股息,13,0,13,元大-大天母,2024-10-29,9893
4906,正文,12,0,12,元大-大天母,2024-10-29,9893
00932,兆豐永續高息等權,14,3,11,元大-大天母,2024-10-29,9893
6257,矽格,13,2,11,元大-大天母,2024-10-29,9893
5371,中光電,12,1,11,元大-大天母,2024-10-29,9893
4915,致伸,11,0,11,元大-大天母,2024-10-29,9893
3437,榮創,11,0,11,元大-大天母,2024-10-29,9893
2495,普安,74,63,11,元大-大天母,2024-10-29,9893
6505,台塑化,10,0,10,元大-大天母,2024-10-29,9893
1723,中碳,10,0,10,元大-大天母,2024-10-29,9893
1524,耿鼎,10,0,10,元大-大天母,2024-10-29,9893
2492,華新科,10,0,10,元大-大天母,2024-10-29,9893
6120,達運,10,0,10,元大-大天母,2024-10-29,9893
00632R,元大台灣50反1,250,0,250,元大-大天母,2024-10-30,9893
2328,廣宇,180,10,170,元大-大天母,2024-10-30,9893
2354,鴻準,344,223,121,元大-大天母,2024-10-30,9893
2392,正崴,150,32,118,元大-大天母,2024-10-30,9893
006206,元大上證50,110,0,110,元大-大天母,2024-10-30,9893
00641R,富邦日本反1,100,0,100,元大-大天母,2024-10-30,9893
00680L,元大美債20正2,101,2,99,元大-大天母,2024-10-30,9893
1449,佳和,154,65,89,元大-大天母,2024-10-30,9893
2303,聯電,103,31,72,元大-大天母,2024-10-30,9893
0056,元大高股息,60,3,57,元大-大天母,2024-10-30,9893
00940,元大台灣價值高息,56,5,51,元大-大天母,2024-10-30,9893
00650L,復華香港正2,51,1,50,元大-大天母,2024-10-30,9893
00935,野村臺灣新科技50,50,0,50,元大-大天母,2024-10-30,9893
6257,矽格,47,1,46,元大-大天母,2024-10-30,9893
6160,欣技,40,0,40,元大-大天母,2024-10-30,9893
00679B,元大美債20年,35,7,28,元大-大天母,2024-10-30,9893
4991,環宇-KY,29,1,28,元大-大天母,2024-10-30,9893
5347,世界,30,4,26,元大-大天母,2024-10-30,9893
00919,群益台灣精選高息,67,41,26,元大-大天母,2024-10-30,9893
3704,合勤控,30,6,24,元大-大天母,2024-10-30,9893
00665L,富邦�琤肭磪囓�2,33,9,24,元大-大天母,2024-10-30,9893
8032,光菱,46,22,24,元大-大天母,2024-10-30,9893
00633L,富邦上証正2,23,0,23,元大-大天母,2024-10-30,9893
00715L,期街口布蘭特正2,21,0,21,元大-大天母,2024-10-30,9893
3231,緯創,24,3,21,元大-大天母,2024-10-30,9893
1319,東陽,20,0,20,元大-大天母,2024-10-30,9893
6168,宏齊,20,0,20,元大-大天母,2024-10-30,9893
00959B,大華投等美債15Y+,20,0,20,元大-大天母,2024-10-30,9893
1605,華新,20,0,20,元大-大天母,2024-10-30,9893
00878,國泰永續高股息,21,1,20,元大-大天母,2024-10-30,9893
2377,微星,19,0,19,元大-大天母,2024-10-30,9893
2885,元大金,23,4,19,元大-大天母,2024-10-30,9893
6229,研通,16,0,16,元大-大天母,2024-10-30,9893
6224,聚鼎,15,0,15,元大-大天母,2024-10-30,9893
00934,中信成長高股息,15,2,13,元大-大天母,2024-10-30,9893
6770,力積電,13,0,13,元大-大天母,2024-10-30,9893
00753L,中信中國50正2,13,0,13,元大-大天母,2024-10-30,9893
2337,旺宏,14,2,12,元大-大天母,2024-10-30,9893
2421,建準,12,0,12,元大-大天母,2024-10-30,9893
2312,金寶,25,13,12,元大-大天母,2024-10-30,9893
00937B,群益ESG投等債20,11,0,11,元大-大天母,2024-10-30,9893
3081,聯亞,12,1,11,元大-大天母,2024-10-30,9893
2472,立隆電,10,0,10,元大-大天母,2024-10-30,9893
3481,群創,67,57,10,元大-大天母,2024-10-30,9893
3042,晶技,10,0,10,元大-大天母,2024-10-30,9893
2867,三商壽,12,2,10,元大-大天母,2024-10-30,9893
00882,中信中國高股息,15,5,10,元大-大天母,2024-10-30,9893
4107,邦特,10,0,10,元大-大天母,2024-10-30,9893
2515,中工,10,0,10,元大-大天母,2024-10-30,9893
3703,欣陸,10,0,10,元大-大天母,2024-10-30,9893
1449,佳和,149,32,117,元大-大天母,2024-11-01,9893
2303,聯電,136,36,100,元大-大天母,2024-11-01,9893
00933B,國泰10Y+金融債,80,0,80,元大-大天母,2024-11-01,9893
00919,群益台灣精選高息,76,4,72,元大-大天母,2024-11-01,9893
00878,國泰永續高股息,74,1,73,元大-大天母,2024-11-01,9893
4991,環宇-KY,74,4,70,元大-大天母,2024-11-01,9893
00943,兆豐電子高息等權,70,0,70,元大-大天母,2024-11-01,9893
2328,廣宇,65,5,60,元大-大天母,2024-11-01,9893
5347,世界,52,8,44,元大-大天母,2024-11-01,9893
00725B,國泰投資級公司債,42,0,42,元大-大天母,2024-11-01,9893
3217,優群,48,9,39,元大-大天母,2024-11-01,9893
0056,元大高股息,39,1,38,元大-大天母,2024-11-01,9893
0061,元大寶滬深,37,0,37,元大-大天母,2024-11-01,9893
2317,鴻海,54,22,32,元大-大天母,2024-11-01,9893
2405,輔信,33,1,32,元大-大天母,2024-11-01,9893
8028,昇陽半導體,48,16,32,元大-大天母,2024-11-01,9893
6216,居易,58,26,32,元大-大天母,2024-11-01,9893
00687B,國泰20年美債,30,0,30,元大-大天母,2024-11-01,9893
2337,旺宏,30,1,29,元大-大天母,2024-11-01,9893
00712,復華富時不動產,25,0,25,元大-大天母,2024-11-01,9893
00708L,期元大S＆P黃金正2,25,0,25,元大-大天母,2024-11-01,9893
00885,富邦越南,24,0,24,元大-大天母,2024-11-01,9893
6821,聯寶,22,0,22,元大-大天母,2024-11-01,9893
6768,志強-KY,36,15,21,元大-大天母,2024-11-01,9893
00934,中信成長高股息,22,2,20,元大-大天母,2024-11-01,9893
8044,網家,27,7,20,元大-大天母,2024-11-01,9893
3324,雙鴻,30,13,17,元大-大天母,2024-11-01,9893
00922,國泰台灣領袖50,18,2,16,元大-大天母,2024-11-01,9893
6161,捷波,16,0,16,元大-大天母,2024-11-01,9893
00830,國泰費城半導體,16,0,16,元大-大天母,2024-11-01,9893
00679B,元大美債20年,16,0,16,元大-大天母,2024-11-01,9893
2330,台積電,23,8,15,元大-大天母,2024-11-01,9893
4114,健喬,14,0,14,元大-大天母,2024-11-01,9893
1477,聚陽,24,11,13,元大-大天母,2024-11-01,9893
2884,玉山金,13,0,13,元大-大天母,2024-11-01,9893
2887,台新金,13,0,13,元大-大天母,2024-11-01,9893
3062,建漢,16,3,13,元大-大天母,2024-11-01,9893
1785,光洋科,20,7,13,元大-大天母,2024-11-01,9893
9955,佳龍,13,0,13,元大-大天母,2024-11-01,9893
5871,中租-KY,13,0,13,元大-大天母,2024-11-01,9893
0050,元大台灣50,13,0,13,元大-大天母,2024-11-01,9893
1476,儒鴻,12,0,12,元大-大天母,2024-11-01,9893
4958,臻鼎-KY,13,1,12,元大-大天母,2024-11-01,9893
00635U,期元大S＆P黃金,16,5,11,元大-大天母,2024-11-01,9893
1532,勤美,11,0,11,元大-大天母,2024-11-01,9893
00929,復華台灣科技優息,31,20,11,元大-大天母,2024-11-01,9893
2886,兆豐金,10,0,10,元大-大天母,2024-11-01,9893
2881,富邦金,32,22,10,元大-大天母,2024-11-01,9893
2344,華邦電,10,0,10,元大-大天母,2024-11-01,9893
2413,環科,10,0,10,元大-大天母,2024-11-01,9893
00937B,群益ESG投等債20,547,30,517,元大-大天母,2024-11-04,9893
00679B,元大美債20年,222,0,222,元大-大天母,2024-11-04,9893
00918,大華優利高填息30,188,12,176,元大-大天母,2024-11-04,9893
00664R,國泰臺灣加權反1,130,0,130,元大-大天母,2024-11-04,9893
2354,鴻準,217,134,83,元大-大天母,2024-11-04,9893
2312,金寶,130,66,64,元大-大天母,2024-11-04,9893
00680L,元大美債20正2,63,0,63,元大-大天母,2024-11-04,9893
00948B,中信優息投資級債,60,0,60,元大-大天母,2024-11-04,9893
00878,國泰永續高股息,55,1,54,元大-大天母,2024-11-04,9893
006206,元大上證50,40,0,40,元大-大天母,2024-11-04,9893
2615,萬海,81,46,35,元大-大天母,2024-11-04,9893
6239,力成,41,8,33,元大-大天母,2024-11-04,9893
6770,力積電,32,0,32,元大-大天母,2024-11-04,9893
00929,復華台灣科技優息,50,20,30,元大-大天母,2024-11-04,9893
1565,精華,30,0,30,元大-大天母,2024-11-04,9893
00654R,富邦印度反1,30,0,30,元大-大天母,2024-11-04,9893
2609,陽明,50,21,29,元大-大天母,2024-11-04,9893
00637L,元大滬深300正2,30,2,28,元大-大天母,2024-11-04,9893
00751B,元大AAA至A公司債,29,3,26,元大-大天母,2024-11-04,9893
00720B,元大投資級公司債,25,0,25,元大-大天母,2024-11-04,9893
2467,志聖,34,10,24,元大-大天母,2024-11-04,9893
8044,網家,28,5,23,元大-大天母,2024-11-04,9893
2303,聯電,39,17,22,元大-大天母,2024-11-04,9893
00940,元大台灣價值高息,22,0,22,元大-大天母,2024-11-04,9893
2423,固緯,19,0,19,元大-大天母,2024-11-04,9893
6167,久正,19,0,19,元大-大天母,2024-11-04,9893
00725B,國泰投資級公司債,20,2,18,元大-大天母,2024-11-04,9893
6134,萬旭,68,52,16,元大-大天母,2024-11-04,9893
8011,台通,34,18,16,元大-大天母,2024-11-04,9893
2464,盟立,16,0,16,元大-大天母,2024-11-04,9893
8261,富鼎,17,2,15,元大-大天母,2024-11-04,9893
4527,方土霖,16,1,15,元大-大天母,2024-11-04,9893
3034,聯詠,13,0,13,元大-大天母,2024-11-04,9893
2881,富邦金,18,6,12,元大-大天母,2024-11-04,9893
4919,新唐,14,2,12,元大-大天母,2024-11-04,9893
2883,凱基金,13,1,12,元大-大天母,2024-11-04,9893
6546,正基,11,0,11,元大-大天母,2024-11-04,9893
5426,振發,23,12,11,元大-大天母,2024-11-04,9893
00712,復華富時不動產,12,2,10,元大-大天母,2024-11-04,9893
00708L,期元大S＆P黃金正2,10,0,10,元大-大天母,2024-11-04,9893
00706L,期元大S＆P日圓正2,10,0,10,元大-大天母,2024-11-04,9893
1605,華新,10,0,10,元大-大天母,2024-11-04,9893
00881,國泰台灣5G+,10,0,10,元大-大天母,2024-11-04,9893
0061,元大寶滬深,10,0,10,元大-大天母,2024-11-04,9893
2392,正崴,11,1,10,元大-大天母,2024-11-04,9893
3019,亞光,12,3,9,元大-大天母,2024-11-04,9893
00891,中信關鍵半導體,11,2,9,元大-大天母,2024-11-04,9893
00715L,期街口布蘭特正2,12,3,9,元大-大天母,2024-11-04,9893
6177,達麗,9,0,9,元大-大天母,2024-11-04,9893
1569,濱川,9,0,9,元大-大天母,2024-11-04,9893
00878,國泰永續高股息,178,3,175,元大-大天母,2024-11-05,9893
00637L,元大滬深300正2,268,109,159,元大-大天母,2024-11-05,9893
2354,鴻準,467,310,157,元大-大天母,2024-11-05,9893
00679B,元大美債20年,157,39,118,元大-大天母,2024-11-05,9893
6451,訊芯-KY,116,5,111,元大-大天母,2024-11-05,9893
2303,聯電,110,8,102,元大-大天母,2024-11-05,9893
00954,中信日本半導體,100,0,100,元大-大天母,2024-11-05,9893
00919,群益台灣精選高息,57,5,52,元大-大天母,2024-11-05,9893
2371,大同,51,1,50,元大-大天母,2024-11-05,9893
00665L,富邦�琤肭磪囓�2,100,50,50,元大-大天母,2024-11-05,9893
00756B,群益投等新興公債,40,0,40,元大-大天母,2024-11-05,9893
1449,佳和,45,5,40,元大-大天母,2024-11-05,9893
0061,元大寶滬深,35,0,35,元大-大天母,2024-11-05,9893
3551,世禾,35,0,35,元大-大天母,2024-11-05,9893
5315,光聯,30,0,30,元大-大天母,2024-11-05,9893
4903,聯光通,41,17,24,元大-大天母,2024-11-05,9893
3317,尼克森,40,16,24,元大-大天母,2024-11-05,9893
2486,一詮,41,18,23,元大-大天母,2024-11-05,9893
3490,單井,45,23,22,元大-大天母,2024-11-05,9893
00673R,期元大S＆P原油反1,22,0,22,元大-大天母,2024-11-05,9893
0056,元大高股息,32,12,20,元大-大天母,2024-11-05,9893
6550,北極星藥業-KY,20,0,20,元大-大天母,2024-11-05,9893
8107,大億金茂,18,3,15,元大-大天母,2024-11-05,9893
2454,聯發科,15,1,14,元大-大天母,2024-11-05,9893
6609,瀧澤科,22,8,14,元大-大天母,2024-11-05,9893
2809,京城銀,14,0,14,元大-大天母,2024-11-05,9893
00680L,元大美債20正2,20,6,14,元大-大天母,2024-11-05,9893
6530,創威,43,29,14,元大-大天母,2024-11-05,9893
00635U,期元大S＆P黃金,13,0,13,元大-大天母,2024-11-05,9893
00915,凱基優選高股息30,12,0,12,元大-大天母,2024-11-05,9893
2365,昆盈,13,1,12,元大-大天母,2024-11-05,9893
00930,永豐ESG低碳高息,11,0,11,元大-大天母,2024-11-05,9893
2351,順德,11,0,11,元大-大天母,2024-11-05,9893
2883,凱基金,21,10,11,元大-大天母,2024-11-05,9893
2369,菱生,18,7,11,元大-大天母,2024-11-05,9893
1307,三芳,17,6,11,元大-大天母,2024-11-05,9893
6546,正基,11,0,11,元大-大天母,2024-11-05,9893
3025,星通,18,8,10,元大-大天母,2024-11-05,9893
1565,精華,12,2,10,元大-大天母,2024-11-05,9893
4414,如興,10,0,10,元大-大天母,2024-11-05,9893
2801,彰銀,10,0,10,元大-大天母,2024-11-05,9893
6862,三集瑞-KY,11,1,10,元大-大天母,2024-11-05,9893
6821,聯寶,11,1,10,元大-大天母,2024-11-05,9893
2467,志聖,14,4,10,元大-大天母,2024-11-05,9893
2377,微星,17,7,10,元大-大天母,2024-11-05,9893
00937B,群益ESG投等債20,13,4,9,元大-大天母,2024-11-05,9893
00636,國泰中國A50,9,0,9,元大-大天母,2024-11-05,9893
2049,上銀,10,1,9,元大-大天母,2024-11-05,9893
1569,濱川,8,0,8,元大-大天母,2024-11-05,9893
1605,華新,9,1,8,元大-大天母,2024-11-05,9893
2344,華邦電,501,30,471,元大-大天母,2024-11-06,9893
00679B,元大美債20年,454,123,331,元大-大天母,2024-11-06,9893
00665L,富邦�琤肭磪囓�2,271,20,251,元大-大天母,2024-11-06,9893
5347,世界,193,11,182,元大-大天母,2024-11-06,9893
00680L,元大美債20正2,266,112,154,元大-大天母,2024-11-06,9893
2303,聯電,184,41,143,元大-大天母,2024-11-06,9893
2431,聯昌,180,52,128,元大-大天母,2024-11-06,9893
00706L,期元大S＆P日圓正2,100,0,100,元大-大天母,2024-11-06,9893
00671R,富邦NASDAQ反1,100,0,100,元大-大天母,2024-11-06,9893
00941,中信上游半導體,100,0,100,元大-大天母,2024-11-06,9893
00687B,國泰20年美債,101,11,90,元大-大天母,2024-11-06,9893
00688L,國泰20年美債正2,82,0,82,元大-大天母,2024-11-06,9893
2376,技嘉,124,56,68,元大-大天母,2024-11-06,9893
00648R,元大S＆P500反1,60,0,60,元大-大天母,2024-11-06,9893
00937B,群益ESG投等債20,59,0,59,元大-大天母,2024-11-06,9893
2317,鴻海,98,43,55,元大-大天母,2024-11-06,9893
00712,復華富時不動產,52,0,52,元大-大天母,2024-11-06,9893
1314,中石化,51,0,51,元大-大天母,2024-11-06,9893
00669R,國泰美國道瓊反1,50,0,50,元大-大天母,2024-11-06,9893
2354,鴻準,193,148,45,元大-大天母,2024-11-06,9893
2883,凱基金,45,0,45,元大-大天母,2024-11-06,9893
00641R,富邦日本反1,43,0,43,元大-大天母,2024-11-06,9893
00878,國泰永續高股息,115,72,43,元大-大天母,2024-11-06,9893
6768,志強-KY,45,5,40,元大-大天母,2024-11-06,9893
2328,廣宇,41,3,38,元大-大天母,2024-11-06,9893
00933B,國泰10Y+金融債,37,0,37,元大-大天母,2024-11-06,9893
1591,駿吉-KY,28,0,28,元大-大天母,2024-11-06,9893
00940,元大台灣價值高息,105,79,26,元大-大天母,2024-11-06,9893
00637L,元大滬深300正2,58,33,25,元大-大天母,2024-11-06,9893
6213,聯茂,28,4,24,元大-大天母,2024-11-06,9893
3035,智原,30,8,22,元大-大天母,2024-11-06,9893
3551,世禾,22,0,22,元大-大天母,2024-11-06,9893
2601,益航,20,0,20,元大-大天母,2024-11-06,9893
9933,中鼎,20,0,20,元大-大天母,2024-11-06,9893
00919,群益台灣精選高息,19,0,19,元大-大天母,2024-11-06,9893
6288,聯嘉,22,3,19,元大-大天母,2024-11-06,9893
2515,中工,20,2,18,元大-大天母,2024-11-06,9893
00929,復華台灣科技優息,52,35,17,元大-大天母,2024-11-06,9893
2314,台揚,17,0,17,元大-大天母,2024-11-06,9893
00943,兆豐電子高息等權,16,0,16,元大-大天母,2024-11-06,9893
3689,湧德,20,4,16,元大-大天母,2024-11-06,9893
8070,長華*,16,1,15,元大-大天母,2024-11-06,9893
4958,臻鼎-KY,14,0,14,元大-大天母,2024-11-06,9893
2464,盟立,16,2,14,元大-大天母,2024-11-06,9893
6205,詮欣,13,0,13,元大-大天母,2024-11-06,9893
00639,富邦深100,18,5,13,元大-大天母,2024-11-06,9893
6405,悅城,41,28,13,元大-大天母,2024-11-06,9893
00633L,富邦上証正2,21,8,13,元大-大天母,2024-11-06,9893
2646,星宇航空,13,1,12,元大-大天母,2024-11-06,9893
1449,佳和,51,39,12,元大-大天母,2024-11-06,9893
2324,仁寶,346,58,288,元大-大天母,2024-11-07,9893
00632R,元大台灣50反1,310,188,122,元大-大天母,2024-11-07,9893
2303,聯電,227,124,103,元大-大天母,2024-11-07,9893
2449,京元電子,113,17,96,元大-大天母,2024-11-07,9893
00671R,富邦NASDAQ反1,100,25,75,元大-大天母,2024-11-07,9893
00929,復華台灣科技優息,99,34,65,元大-大天母,2024-11-07,9893
00761B,國泰A級公司債,59,0,59,元大-大天母,2024-11-07,9893
1449,佳和,79,27,52,元大-大天母,2024-11-07,9893
00669R,國泰美國道瓊反1,50,0,50,元大-大天母,2024-11-07,9893
00648R,元大S＆P500反1,50,0,50,元大-大天母,2024-11-07,9893
00885,富邦越南,50,0,50,元大-大天母,2024-11-07,9893
2014,中鴻,61,12,49,元大-大天母,2024-11-07,9893
6190,萬泰科,51,4,47,元大-大天母,2024-11-07,9893
1802,台玻,50,5,45,元大-大天母,2024-11-07,9893
00637L,元大滬深300正2,88,45,43,元大-大天母,2024-11-07,9893
9105,泰金寶-DR,59,16,43,元大-大天母,2024-11-07,9893
3062,建漢,119,77,42,元大-大天母,2024-11-07,9893
4991,環宇-KY,68,27,41,元大-大天母,2024-11-07,9893
2642,宅配通,40,0,40,元大-大天母,2024-11-07,9893
2317,鴻海,60,22,38,元大-大天母,2024-11-07,9893
00641R,富邦日本反1,37,0,37,元大-大天母,2024-11-07,9893
2489,瑞軒,34,1,33,元大-大天母,2024-11-07,9893
2032,新鋼,30,0,30,元大-大天母,2024-11-07,9893
1536,和大,48,19,29,元大-大天母,2024-11-07,9893
00932,兆豐永續高息等權,27,0,27,元大-大天母,2024-11-07,9893
00631L,元大台灣50正2,31,6,25,元大-大天母,2024-11-07,9893
5309,系統電,30,5,25,元大-大天母,2024-11-07,9893
00655L,國泰中國A50正2,22,0,22,元大-大天母,2024-11-07,9893
00650L,復華香港正2,20,0,20,元大-大天母,2024-11-07,9893
2548,華固,19,0,19,元大-大天母,2024-11-07,9893
2603,長榮,42,25,17,元大-大天母,2024-11-07,9893
2457,飛宏,15,0,15,元大-大天母,2024-11-07,9893
2474,可成,16,1,15,元大-大天母,2024-11-07,9893
00680L,元大美債20正2,35,20,15,元大-大天母,2024-11-07,9893
3013,晟銘電,34,20,14,元大-大天母,2024-11-07,9893
6153,嘉聯益,14,0,14,元大-大天母,2024-11-07,9893
2425,承啟,24,10,14,元大-大天母,2024-11-07,9893
6213,聯茂,18,4,14,元大-大天母,2024-11-07,9893
00713,元大台灣高息低波,14,0,14,元大-大天母,2024-11-07,9893
4561,健椿,15,2,13,元大-大天母,2024-11-07,9893
4919,新唐,14,2,12,元大-大天母,2024-11-07,9893
1227,佳格,12,0,12,元大-大天母,2024-11-07,9893
2636,台驊控股,12,0,12,元大-大天母,2024-11-07,9893
6757,台灣虎航,12,0,12,元大-大天母,2024-11-07,9893
8464,億豐,11,0,11,元大-大天母,2024-11-07,9893
00919,群益台灣精選高息,14,3,11,元大-大天母,2024-11-07,9893
9933,中鼎,11,0,11,元大-大天母,2024-11-07,9893
6438,迅得,21,10,11,元大-大天母,2024-11-07,9893
3498,陽程,11,0,11,元大-大天母,2024-11-07,9893
6239,力成,12,1,11,元大-大天母,2024-11-07,9893
3231,緯創,517,135,382,元大-大天母,2024-11-08,9893
2615,萬海,355,73,282,元大-大天母,2024-11-08,9893
4991,環宇-KY,223,22,201,元大-大天母,2024-11-08,9893
00664R,國泰臺灣加權反1,200,0,200,元大-大天母,2024-11-08,9893
00676R,富邦臺灣加權反1,200,0,200,元大-大天母,2024-11-08,9893
2609,陽明,245,68,177,元大-大天母,2024-11-08,9893
00753L,中信中國50正2,246,102,144,元大-大天母,2024-11-08,9893
3037,欣興,125,13,112,元大-大天母,2024-11-08,9893
00679B,元大美債20年,91,1,90,元大-大天母,2024-11-08,9893
1301,台塑,87,0,87,元大-大天母,2024-11-08,9893
2489,瑞軒,106,31,75,元大-大天母,2024-11-08,9893
2302,麗正,71,0,71,元大-大天母,2024-11-08,9893
3211,順達,114,46,68,元大-大天母,2024-11-08,9893
2882,國泰金,68,4,64,元大-大天母,2024-11-08,9893
00632R,元大台灣50反1,76,15,61,元大-大天母,2024-11-08,9893
3059,華晶科,61,0,61,元大-大天母,2024-11-08,9893
00882,中信中國高股息,59,11,48,元大-大天母,2024-11-08,9893
2353,宏��,47,0,47,元大-大天母,2024-11-08,9893
3062,建漢,81,35,46,元大-大天母,2024-11-08,9893
2211,長榮鋼,46,0,46,元大-大天母,2024-11-08,9893
6168,宏齊,43,0,43,元大-大天母,2024-11-08,9893
2303,聯電,104,65,39,元大-大天母,2024-11-08,9893
00924,復華S＆P500成長,38,0,38,元大-大天母,2024-11-08,9893
2548,華固,36,0,36,元大-大天母,2024-11-08,9893
1711,永光,42,8,34,元大-大天母,2024-11-08,9893
3419,譁裕,32,0,32,元大-大天母,2024-11-08,9893
6505,台塑化,31,0,31,元大-大天母,2024-11-08,9893
00959B,大華投等美債15Y+,30,0,30,元大-大天母,2024-11-08,9893
1527,鑽全,30,0,30,元大-大天母,2024-11-08,9893
8044,網家,46,16,30,元大-大天母,2024-11-08,9893
00885,富邦越南,30,0,30,元大-大天母,2024-11-08,9893
6443,元晶,30,0,30,元大-大天母,2024-11-08,9893
3551,世禾,29,0,29,元大-大天母,2024-11-08,9893
6216,居易,30,2,28,元大-大天母,2024-11-08,9893
2520,冠德,26,0,26,元大-大天母,2024-11-08,9893
2881,富邦金,35,12,23,元大-大天母,2024-11-08,9893
1409,新纖,23,0,23,元大-大天母,2024-11-08,9893
3481,群創,24,1,23,元大-大天母,2024-11-08,9893
2388,威盛,33,11,22,元大-大天母,2024-11-08,9893
6182,合晶,24,2,22,元大-大天母,2024-11-08,9893
00641R,富邦日本反1,20,0,20,元大-大天母,2024-11-08,9893
6209,今國光,20,0,20,元大-大天母,2024-11-08,9893
2392,正崴,57,38,19,元大-大天母,2024-11-08,9893
00943,兆豐電子高息等權,18,0,18,元大-大天母,2024-11-08,9893
2426,鼎元,19,1,18,元大-大天母,2024-11-08,9893
2313,華通,20,3,17,元大-大天母,2024-11-08,9893
6116,彩晶,17,0,17,元大-大天母,2024-11-08,9893
6180,橘子,24,7,17,元大-大天母,2024-11-08,9893
4174,浩鼎,17,1,16,元大-大天母,2024-11-08,9893
00633L,富邦上証正2,61,45,16,元大-大天母,2024-11-08,9893
2302,麗正,155,7,148,元大-大天母,2024-11-11,9893
00706L,期元大S＆P日圓正2,110,0,110,元大-大天母,2024-11-11,9893
2603,長榮,103,19,84,元大-大天母,2024-11-11,9893
1711,永光,80,2,78,元大-大天母,2024-11-11,9893
2609,陽明,87,13,74,元大-大天母,2024-11-11,9893
00953B,群益優選非投等債,66,0,66,元大-大天母,2024-11-11,9893
00878,國泰永續高股息,60,5,55,元大-大天母,2024-11-11,9893
00885,富邦越南,60,5,55,元大-大天母,2024-11-11,9893
6763,綠界科技*,49,4,45,元大-大天母,2024-11-11,9893
00919,群益台灣精選高息,42,3,39,元大-大天母,2024-11-11,9893
5347,世界,41,2,39,元大-大天母,2024-11-11,9893
3714,富采,41,6,35,元大-大天母,2024-11-11,9893
1605,華新,31,0,31,元大-大天母,2024-11-11,9893
8011,台通,79,48,31,元大-大天母,2024-11-11,9893
0056,元大高股息,23,0,23,元大-大天母,2024-11-11,9893
4968,立積,24,3,21,元大-大天母,2024-11-11,9893
00929,復華台灣科技優息,23,2,21,元大-大天母,2024-11-11,9893
00680L,元大美債20正2,30,10,20,元大-大天母,2024-11-11,9893
2312,金寶,24,4,20,元大-大天母,2024-11-11,9893
4123,晟德,21,1,20,元大-大天母,2024-11-11,9893
5457,宣德,23,4,19,元大-大天母,2024-11-11,9893
6768,志強-KY,38,19,19,元大-大天母,2024-11-11,9893
3303,岱稜,41,22,19,元大-大天母,2024-11-11,9893
1449,佳和,60,41,19,元大-大天母,2024-11-11,9893
3003,健和興,18,0,18,元大-大天母,2024-11-11,9893
2495,普安,23,5,18,元大-大天母,2024-11-11,9893
2882,國泰金,19,2,17,元大-大天母,2024-11-11,9893
3711,日月光投控,17,0,17,元大-大天母,2024-11-11,9893
6116,彩晶,16,0,16,元大-大天母,2024-11-11,9893
3062,建漢,26,11,15,元大-大天母,2024-11-11,9893
5871,中租-KY,16,1,15,元大-大天母,2024-11-11,9893
3059,華晶科,15,0,15,元大-大天母,2024-11-11,9893
2489,瑞軒,15,0,15,元大-大天母,2024-11-11,9893
2520,冠德,30,15,15,元大-大天母,2024-11-11,9893
00633L,富邦上証正2,19,4,15,元大-大天母,2024-11-11,9893
3163,波若威,22,8,14,元大-大天母,2024-11-11,9893
9921,巨大,13,0,13,元大-大天母,2024-11-11,9893
1445,大宇,13,0,13,元大-大天母,2024-11-11,9893
9105,泰金寶-DR,23,10,13,元大-大天母,2024-11-11,9893
6548,長科*,13,0,13,元大-大天母,2024-11-11,9893
2337,旺宏,13,0,13,元大-大天母,2024-11-11,9893
2328,廣宇,18,5,13,元大-大天母,2024-11-11,9893
2353,宏��,15,2,13,元大-大天母,2024-11-11,9893
2449,京元電子,23,11,12,元大-大天母,2024-11-11,9893
2834,臺企銀,12,0,12,元大-大天母,2024-11-11,9893
2891,中信金,21,10,11,元大-大天母,2024-11-11,9893
2409,友達,11,0,11,元大-大天母,2024-11-11,9893
2801,彰銀,11,0,11,元大-大天母,2024-11-11,9893
2368,金像電,10,0,10,元大-大天母,2024-11-11,9893
4114,健喬,11,1,10,元大-大天母,2024-11-11,9893
00878,國泰永續高股息,272,0,272,元大-大天母,2024-11-12,9893
00632R,元大台灣50反1,260,12,248,元大-大天母,2024-11-12,9893
00715L,期街口布蘭特正2,205,0,205,元大-大天母,2024-11-12,9893
3231,緯創,238,59,179,元大-大天母,2024-11-12,9893
1409,新纖,177,0,177,元大-大天母,2024-11-12,9893
00664R,國泰臺灣加權反1,150,0,150,元大-大天母,2024-11-12,9893
00671R,富邦NASDAQ反1,150,0,150,元大-大天母,2024-11-12,9893
1711,永光,142,0,142,元大-大天母,2024-11-12,9893
2383,台光電,111,0,111,元大-大天母,2024-11-12,9893
00706L,期元大S＆P日圓正2,100,0,100,元大-大天母,2024-11-12,9893
00650L,復華香港正2,100,0,100,元大-大天母,2024-11-12,9893
2354,鴻準,163,72,91,元大-大天母,2024-11-12,9893
00753L,中信中國50正2,115,27,88,元大-大天母,2024-11-12,9893
1605,華新,80,0,80,元大-大天母,2024-11-12,9893
00887,永豐中國科技50大,81,4,77,元大-大天母,2024-11-12,9893
6168,宏齊,64,0,64,元大-大天母,2024-11-12,9893
0056,元大高股息,70,6,64,元大-大天母,2024-11-12,9893
00688L,國泰20年美債正2,60,0,60,元大-大天母,2024-11-12,9893
2603,長榮,75,21,54,元大-大天母,2024-11-12,9893
00919,群益台灣精選高息,47,0,47,元大-大天母,2024-11-12,9893
2330,台積電,49,8,41,元大-大天母,2024-11-12,9893
6245,立端,40,0,40,元大-大天母,2024-11-12,9893
5534,長虹,40,0,40,元大-大天母,2024-11-12,9893
2356,英業達,125,85,40,元大-大天母,2024-11-12,9893
006208,富邦台50,40,0,40,元大-大天母,2024-11-12,9893
00932,兆豐永續高息等權,39,0,39,元大-大天母,2024-11-12,9893
6505,台塑化,38,0,38,元大-大天母,2024-11-12,9893
4142,國光生,38,0,38,元大-大天母,2024-11-12,9893
1903,士紙,37,0,37,元大-大天母,2024-11-12,9893
2882,國泰金,36,0,36,元大-大天母,2024-11-12,9893
4931,新盛力,50,20,30,元大-大天母,2024-11-12,9893
5309,系統電,61,32,29,元大-大天母,2024-11-12,9893
5871,中租-KY,29,0,29,元大-大天母,2024-11-12,9893
00940,元大台灣價值高息,71,44,27,元大-大天母,2024-11-12,9893
6763,綠界科技*,70,44,26,元大-大天母,2024-11-12,9893
6139,亞翔,26,0,26,元大-大天母,2024-11-12,9893
2607,榮運,26,0,26,元大-大天母,2024-11-12,9893
4306,炎洲,25,0,25,元大-大天母,2024-11-12,9893
8210,勤誠,25,1,24,元大-大天母,2024-11-12,9893
00934,中信成長高股息,24,0,24,元大-大天母,2024-11-12,9893
00881,國泰台灣5G+,23,0,23,元大-大天母,2024-11-12,9893
9934,成霖,22,0,22,元大-大天母,2024-11-12,9893
1531,高林股,22,1,21,元大-大天母,2024-11-12,9893
3264,欣銓,20,0,20,元大-大天母,2024-11-12,9893
00877,復華中國5G,20,0,20,元大-大天母,2024-11-12,9893
5388,中磊,20,0,20,元大-大天母,2024-11-12,9893
00921,兆豐龍頭等權重,20,0,20,元大-大天母,2024-11-12,9893
00905,FT臺灣Smart,19,0,19,元大-大天母,2024-11-12,9893
4968,立積,19,0,19,元大-大天母,2024-11-12,9893
0050,元大台灣50,20,2,18,元大-大天母,2024-11-12,9893
00878,國泰永續高股息,172,0,172,元大-大天母,2024-11-13,9893
2354,鴻準,124,22,102,元大-大天母,2024-11-13,9893
00679B,元大美債20年,140,40,100,元大-大天母,2024-11-13,9893
6695,芯鼎,78,6,72,元大-大天母,2024-11-13,9893
2883,凱基金,68,0,68,元大-大天母,2024-11-13,9893
00655L,國泰中國A50正2,66,0,66,元大-大天母,2024-11-13,9893
0056,元大高股息,83,29,54,元大-大天母,2024-11-13,9893
5534,長虹,50,0,50,元大-大天母,2024-11-13,9893
2392,正崴,92,45,47,元大-大天母,2024-11-13,9893
00933B,國泰10Y+金融債,50,4,46,元大-大天母,2024-11-13,9893
00753L,中信中國50正2,37,0,37,元大-大天母,2024-11-13,9893
2605,新興,38,2,36,元大-大天母,2024-11-13,9893
1569,濱川,43,8,35,元大-大天母,2024-11-13,9893
00919,群益台灣精選高息,35,0,35,元大-大天母,2024-11-13,9893
00651R,復華香港反1,33,0,33,元大-大天母,2024-11-13,9893
2603,長榮,51,18,33,元大-大天母,2024-11-13,9893
2330,台積電,33,0,33,元大-大天母,2024-11-13,9893
6205,詮欣,30,0,30,元大-大天母,2024-11-13,9893
3047,訊舟,30,2,28,元大-大天母,2024-11-13,9893
2464,盟立,26,1,25,元大-大天母,2024-11-13,9893
00665L,富邦�琤肭磪囓�2,25,0,25,元大-大天母,2024-11-13,9893
2609,陽明,33,9,24,元大-大天母,2024-11-13,9893
5426,振發,36,13,23,元大-大天母,2024-11-13,9893
2834,臺企銀,23,0,23,元大-大天母,2024-11-13,9893
2882,國泰金,21,0,21,元大-大天母,2024-11-13,9893
00959B,大華投等美債15Y+,21,0,21,元大-大天母,2024-11-13,9893
00751B,元大AAA至A公司債,21,0,21,元大-大天母,2024-11-13,9893
00902,中信電池及儲能,20,0,20,元大-大天母,2024-11-13,9893
4155,訊映,20,0,20,元大-大天母,2024-11-13,9893
2419,仲琦,20,0,20,元大-大天母,2024-11-13,9893
6239,力成,20,0,20,元大-大天母,2024-11-13,9893
00937B,群益ESG投等債20,20,2,18,元大-大天母,2024-11-13,9893
2312,金寶,92,74,18,元大-大天母,2024-11-13,9893
2317,鴻海,28,11,17,元大-大天母,2024-11-13,9893
00666R,富邦�琤肭磪齯�1,17,0,17,元大-大天母,2024-11-13,9893
00713,元大台灣高息低波,18,1,17,元大-大天母,2024-11-13,9893
1513,中興電,26,10,16,元大-大天母,2024-11-13,9893
2353,宏��,18,2,16,元大-大天母,2024-11-13,9893
2303,聯電,35,20,15,元大-大天母,2024-11-13,9893
1536,和大,18,3,15,元大-大天母,2024-11-13,9893
3481,群創,18,4,14,元大-大天母,2024-11-13,9893
9914,美利達,15,1,14,元大-大天母,2024-11-13,9893
4979,華星光,21,7,14,元大-大天母,2024-11-13,9893
8046,南電,14,1,13,元大-大天母,2024-11-13,9893
3010,華立,13,0,13,元大-大天母,2024-11-13,9893
8069,元太,14,2,12,元大-大天母,2024-11-13,9893
8150,南茂,12,0,12,元大-大天母,2024-11-13,9893
1524,耿鼎,32,21,11,元大-大天母,2024-11-13,9893
2393,億光,13,2,11,元大-大天母,2024-11-13,9893
1591,駿吉-KY,11,0,11,元大-大天母,2024-11-13,9893
00878,國泰永續高股息,321,0,321,元大-大天母,2024-11-14,9893
00680L,元大美債20正2,260,25,235,元大-大天母,2024-11-14,9893
00664R,國泰臺灣加權反1,200,0,200,元大-大天母,2024-11-14,9893
5534,長虹,130,0,130,元大-大天母,2024-11-14,9893
2303,聯電,167,62,105,元大-大天母,2024-11-14,9893
00706L,期元大S＆P日圓正2,105,0,105,元大-大天母,2024-11-14,9893
00679B,元大美債20年,95,7,88,元大-大天母,2024-11-14,9893
0056,元大高股息,80,2,78,元大-大天母,2024-11-14,9893
5880,合庫金,77,0,77,元大-大天母,2024-11-14,9893
00674R,期元大S＆P黃金反1,60,0,60,元大-大天母,2024-11-14,9893
00650L,復華香港正2,53,0,53,元大-大天母,2024-11-14,9893
6443,元晶,51,0,51,元大-大天母,2024-11-14,9893
2349,錸德,62,12,50,元大-大天母,2024-11-14,9893
00671R,富邦NASDAQ反1,45,0,45,元大-大天母,2024-11-14,9893
9105,泰金寶-DR,60,16,44,元大-大天母,2024-11-14,9893
9945,潤泰新,42,0,42,元大-大天母,2024-11-14,9893
00919,群益台灣精選高息,44,2,42,元大-大天母,2024-11-14,9893
1795,美時,42,3,39,元大-大天母,2024-11-14,9893
3062,建漢,52,13,39,元大-大天母,2024-11-14,9893
2609,陽明,55,17,38,元大-大天母,2024-11-14,9893
2884,玉山金,35,0,35,元大-大天母,2024-11-14,9893
00891,中信關鍵半導體,34,0,34,元大-大天母,2024-11-14,9893
3689,湧德,31,1,30,元大-大天母,2024-11-14,9893
00915,凱基優選高股息30,27,0,27,元大-大天母,2024-11-14,9893
2344,華邦電,33,7,26,元大-大天母,2024-11-14,9893
3030,德律,24,0,24,元大-大天母,2024-11-14,9893
1808,潤隆,24,1,23,元大-大天母,2024-11-14,9893
2605,新興,24,1,23,元大-大天母,2024-11-14,9893
2393,億光,20,0,20,元大-大天母,2024-11-14,9893
6205,詮欣,20,0,20,元大-大天母,2024-11-14,9893
00933B,國泰10Y+金融債,20,0,20,元大-大天母,2024-11-14,9893
2354,鴻準,51,31,20,元大-大天母,2024-11-14,9893
00666R,富邦�琤肭磪齯�1,17,0,17,元大-大天母,2024-11-14,9893
2892,第一金,29,12,17,元大-大天母,2024-11-14,9893
00922,國泰台灣領袖50,16,0,16,元大-大天母,2024-11-14,9893
00687B,國泰20年美債,16,0,16,元大-大天母,2024-11-14,9893
2881,富邦金,17,2,15,元大-大天母,2024-11-14,9893
6245,立端,15,0,15,元大-大天母,2024-11-14,9893
1219,福壽,14,0,14,元大-大天母,2024-11-14,9893
5309,系統電,30,16,14,元大-大天母,2024-11-14,9893
3323,加百裕,15,1,14,元大-大天母,2024-11-14,9893
00761B,國泰A級公司債,14,0,14,元大-大天母,2024-11-14,9893
1314,中石化,14,0,14,元大-大天母,2024-11-14,9893
2449,京元電子,17,4,13,元大-大天母,2024-11-14,9893
2376,技嘉,13,0,13,元大-大天母,2024-11-14,9893
006208,富邦台50,16,3,13,元大-大天母,2024-11-14,9893
4931,新盛力,122,109,13,元大-大天母,2024-11-14,9893
6472,保瑞,17,4,13,元大-大天母,2024-11-14,9893
3034,聯詠,12,0,12,元大-大天母,2024-11-14,9893
2515,中工,12,0,12,元大-大天母,2024-11-14,9893
9105,泰金寶-DR,1006,190,816,元大-大天母,2024-11-15,9893
00679B,元大美債20年,401,0,401,元大-大天母,2024-11-15,9893
00878,國泰永續高股息,295,21,274,元大-大天母,2024-11-15,9893
00706L,期元大S＆P日圓正2,250,0,250,元大-大天母,2024-11-15,9893
00680L,元大美債20正2,113,32,81,元大-大天母,2024-11-15,9893
00632R,元大台灣50反1,60,0,60,元大-大天母,2024-11-15,9893
2317,鴻海,82,23,59,元大-大天母,2024-11-15,9893
00932,兆豐永續高息等權,55,0,55,元大-大天母,2024-11-15,9893
2474,可成,56,2,54,元大-大天母,2024-11-15,9893
9904,寶成,53,3,50,元大-大天母,2024-11-15,9893
2353,宏��,60,13,47,元大-大天母,2024-11-15,9893
2382,廣達,81,35,46,元大-大天母,2024-11-15,9893
1584,精剛,45,0,45,元大-大天母,2024-11-15,9893
5398,慕康生醫,48,12,36,元大-大天母,2024-11-15,9893
3211,順達,33,2,31,元大-大天母,2024-11-15,9893
0056,元大高股息,25,0,25,元大-大天母,2024-11-15,9893
00651R,復華香港反1,25,0,25,元大-大天母,2024-11-15,9893
1504,東元,60,35,25,元大-大天母,2024-11-15,9893
1569,濱川,24,0,24,元大-大天母,2024-11-15,9893
00887,永豐中國科技50大,32,10,22,元大-大天母,2024-11-15,9893
1565,精華,24,2,22,元大-大天母,2024-11-15,9893
2476,鉅祥,21,0,21,元大-大天母,2024-11-15,9893
2915,潤泰全,23,3,20,元大-大天母,2024-11-15,9893
3323,加百裕,73,53,20,元大-大天母,2024-11-15,9893
6821,聯寶,30,10,20,元大-大天母,2024-11-15,9893
2884,玉山金,20,0,20,元大-大天母,2024-11-15,9893
6670,復盛應用,20,0,20,元大-大天母,2024-11-15,9893
3037,欣興,26,7,19,元大-大天母,2024-11-15,9893
4977,眾達-KY,23,4,19,元大-大天母,2024-11-15,9893
1314,中石化,20,2,18,元大-大天母,2024-11-15,9893
3450,聯鈞,24,7,17,元大-大天母,2024-11-15,9893
2303,聯電,43,26,17,元大-大天母,2024-11-15,9893
6405,悅城,50,33,17,元大-大天母,2024-11-15,9893
00929,復華台灣科技優息,18,2,16,元大-大天母,2024-11-15,9893
5309,系統電,26,10,16,元大-大天母,2024-11-15,9893
1513,中興電,18,3,15,元大-大天母,2024-11-15,9893
5014,建錩,15,0,15,元大-大天母,2024-11-15,9893
3017,奇鋐,25,11,14,元大-大天母,2024-11-15,9893
4721,美琪瑪,15,1,14,元大-大天母,2024-11-15,9893
6505,台塑化,14,0,14,元大-大天母,2024-11-15,9893
3706,神達,277,264,13,元大-大天母,2024-11-15,9893
00633L,富邦上証正2,15,2,13,元大-大天母,2024-11-15,9893
3454,晶睿,12,0,12,元大-大天母,2024-11-15,9893
3213,茂訊,12,0,12,元大-大天母,2024-11-15,9893
5388,中磊,16,4,12,元大-大天母,2024-11-15,9893
2337,旺宏,17,5,12,元大-大天母,2024-11-15,9893
3711,日月光投控,16,4,12,元大-大天母,2024-11-15,9893
2359,所羅門,12,0,12,元大-大天母,2024-11-15,9893
3231,緯創,23,11,12,元大-大天母,2024-11-15,9893
6446,藥華藥,12,1,11,元大-大天母,2024-11-15,9893
00878,國泰永續高股息,273,72,201,元大-大天母,2024-11-18,9893
00887,永豐中國科技50大,162,20,142,元大-大天母,2024-11-18,9893
3625,西勝,113,0,113,元大-大天母,2024-11-18,9893
00676R,富邦臺灣加權反1,100,0,100,元大-大天母,2024-11-18,9893
00877,復華中國5G,100,0,100,元大-大天母,2024-11-18,9893
00680L,元大美債20正2,120,25,95,元大-大天母,2024-11-18,9893
2393,億光,75,0,75,元大-大天母,2024-11-18,9893
1815,富喬,55,0,55,元大-大天母,2024-11-18,9893
00940,元大台灣價值高息,51,1,50,元大-大天母,2024-11-18,9893
00664R,國泰臺灣加權反1,50,0,50,元大-大天母,2024-11-18,9893
5880,合庫金,51,3,48,元大-大天母,2024-11-18,9893
00953B,群益優選非投等債,40,0,40,元大-大天母,2024-11-18,9893
1504,東元,50,12,38,元大-大天母,2024-11-18,9893
00930,永豐ESG低碳高息,38,2,36,元大-大天母,2024-11-18,9893
3060,銘異,24,0,24,元大-大天母,2024-11-18,9893
3551,世禾,25,1,24,元大-大天母,2024-11-18,9893
2476,鉅祥,25,2,23,元大-大天母,2024-11-18,9893
9933,中鼎,22,0,22,元大-大天母,2024-11-18,9893
3374,精材,22,0,22,元大-大天母,2024-11-18,9893
0056,元大高股息,40,19,21,元大-大天母,2024-11-18,9893
0050,元大台灣50,21,0,21,元大-大天母,2024-11-18,9893
2303,聯電,42,21,21,元大-大天母,2024-11-18,9893
3030,德律,21,0,21,元大-大天母,2024-11-18,9893
2881,富邦金,31,10,21,元大-大天母,2024-11-18,9893
006208,富邦台50,22,2,20,元大-大天母,2024-11-18,9893
2354,鴻準,120,100,20,元大-大天母,2024-11-18,9893
00666R,富邦�琤肭磪齯�1,20,0,20,元大-大天母,2024-11-18,9893
1584,精剛,20,0,20,元大-大天母,2024-11-18,9893
6205,詮欣,31,11,20,元大-大天母,2024-11-18,9893
4306,炎洲,18,0,18,元大-大天母,2024-11-18,9893
2356,英業達,39,22,17,元大-大天母,2024-11-18,9893
2371,大同,19,3,16,元大-大天母,2024-11-18,9893
00641R,富邦日本反1,15,0,15,元大-大天母,2024-11-18,9893
2887,台新金,14,0,14,元大-大天母,2024-11-18,9893
2312,金寶,129,115,14,元大-大天母,2024-11-18,9893
00651R,復華香港反1,13,0,13,元大-大天母,2024-11-18,9893
1524,耿鼎,15,3,12,元大-大天母,2024-11-18,9893
00665L,富邦�琤肭磪囓�2,12,0,12,元大-大天母,2024-11-18,9893
2408,南亞科,14,2,12,元大-大天母,2024-11-18,9893
2002,中鋼,20,8,12,元大-大天母,2024-11-18,9893
3231,緯創,13,2,11,元大-大天母,2024-11-18,9893
2421,建準,11,0,11,元大-大天母,2024-11-18,9893
3037,欣興,19,8,11,元大-大天母,2024-11-18,9893
2634,漢翔,12,1,11,元大-大天母,2024-11-18,9893
4174,浩鼎,11,0,11,元大-大天母,2024-11-18,9893
6670,復盛應用,10,0,10,元大-大天母,2024-11-18,9893
5481,新華,10,0,10,元大-大天母,2024-11-18,9893
4766,南寶,10,0,10,元大-大天母,2024-11-18,9893
3090,日電貿,20,10,10,元大-大天母,2024-11-18,9893
00850,元大臺灣ESG永續,10,0,10,元大-大天母,2024-11-18,9893
2329,華泰,338,16,322,元大-大天母,2024-11-19,9893
00632R,元大台灣50反1,150,40,110,元大-大天母,2024-11-19,9893
2344,華邦電,104,2,102,元大-大天母,2024-11-19,9893
00664R,國泰臺灣加權反1,100,0,100,元大-大天母,2024-11-19,9893
00877,復華中國5G,100,0,100,元大-大天母,2024-11-19,9893
5347,世界,85,1,84,元大-大天母,2024-11-19,9893
2349,錸德,120,42,78,元大-大天母,2024-11-19,9893
1817,凱撒衛,70,0,70,元大-大天母,2024-11-19,9893
00930,永豐ESG低碳高息,102,36,66,元大-大天母,2024-11-19,9893
2303,聯電,89,38,51,元大-大天母,2024-11-19,9893
00878,國泰永續高股息,52,7,45,元大-大天母,2024-11-19,9893
3481,群創,53,8,45,元大-大天母,2024-11-19,9893
5529,鉅陞,44,0,44,元大-大天母,2024-11-19,9893
2317,鴻海,37,6,31,元大-大天母,2024-11-19,9893
00885,富邦越南,24,0,24,元大-大天母,2024-11-19,9893
2884,玉山金,24,0,24,元大-大天母,2024-11-19,9893
2382,廣達,33,10,23,元大-大天母,2024-11-19,9893
9914,美利達,20,0,20,元大-大天母,2024-11-19,9893
00756B,群益投等新興公債,20,0,20,元大-大天母,2024-11-19,9893
2883,凱基金,19,0,19,元大-大天母,2024-11-19,9893
1711,永光,23,4,19,元大-大天母,2024-11-19,9893
2881,富邦金,59,43,16,元大-大天母,2024-11-19,9893
4111,濟生,16,0,16,元大-大天母,2024-11-19,9893
2027,大成鋼,17,1,16,元大-大天母,2024-11-19,9893
2880,華南金,16,0,16,元大-大天母,2024-11-19,9893
00929,復華台灣科技優息,57,41,16,元大-大天母,2024-11-19,9893
2354,鴻準,186,171,15,元大-大天母,2024-11-19,9893
1102,亞泥,14,0,14,元大-大天母,2024-11-19,9893
2408,南亞科,16,2,14,元大-大天母,2024-11-19,9893
3032,偉訓,48,34,14,元大-大天母,2024-11-19,9893
2014,中鴻,16,3,13,元大-大天母,2024-11-19,9893
00633L,富邦上証正2,12,0,12,元大-大天母,2024-11-19,9893
3702,大聯大,12,0,12,元大-大天母,2024-11-19,9893
3231,緯創,18,6,12,元大-大天母,2024-11-19,9893
00713,元大台灣高息低波,13,1,12,元大-大天母,2024-11-19,9893
4919,新唐,12,1,11,元大-大天母,2024-11-19,9893
3236,千如,11,0,11,元大-大天母,2024-11-19,9893
6203,海韻電,10,0,10,元大-大天母,2024-11-19,9893
9105,泰金寶-DR,180,170,10,元大-大天母,2024-11-19,9893
4558,寶緯,15,5,10,元大-大天母,2024-11-19,9893
00670L,富邦NASDAQ正2,10,0,10,元大-大天母,2024-11-19,9893
8467,波力-KY,10,0,10,元大-大天母,2024-11-19,9893
1532,勤美,10,0,10,元大-大天母,2024-11-19,9893
2472,立隆電,10,0,10,元大-大天母,2024-11-19,9893
6670,復盛應用,10,0,10,元大-大天母,2024-11-19,9893
6416,瑞祺電通,10,0,10,元大-大天母,2024-11-19,9893
2515,中工,10,0,10,元大-大天母,2024-11-19,9893
2327,國巨,10,0,10,元大-大天母,2024-11-19,9893
1301,台塑,15,6,9,元大-大天母,2024-11-19,9893
9933,中鼎,9,0,9,元大-大天母,2024-11-19,9893
00664R,國泰臺灣加權反1,150,0,150,元大-大天母,2024-11-20,9893
00637L,元大滬深300正2,200,64,136,元大-大天母,2024-11-20,9893
1611,中電,132,5,127,元大-大天母,2024-11-20,9893
00680L,元大美債20正2,105,0,105,元大-大天母,2024-11-20,9893
3481,群創,116,11,105,元大-大天母,2024-11-20,9893
2332,友訊,104,4,100,元大-大天母,2024-11-20,9893
2354,鴻準,196,104,92,元大-大天母,2024-11-20,9893
1815,富喬,93,20,73,元大-大天母,2024-11-20,9893
3490,單井,72,1,71,元大-大天母,2024-11-20,9893
00932,兆豐永續高息等權,52,0,52,元大-大天母,2024-11-20,9893
00937B,群益ESG投等債20,60,10,50,元大-大天母,2024-11-20,9893
2603,長榮,102,57,45,元大-大天母,2024-11-20,9893
00755B,群益投資級公用債,44,0,44,元大-大天母,2024-11-20,9893
00930,永豐ESG低碳高息,42,2,40,元大-大天母,2024-11-20,9893
6558,興能高,50,13,37,元大-大天母,2024-11-20,9893
00878,國泰永續高股息,37,2,35,元大-大天母,2024-11-20,9893
4306,炎洲,32,0,32,元大-大天母,2024-11-20,9893
3706,神達,142,112,30,元大-大天母,2024-11-20,9893
2376,技嘉,21,0,21,元大-大天母,2024-11-20,9893
1477,聚陽,22,1,21,元大-大天母,2024-11-20,9893
8390,金益鼎,20,0,20,元大-大天母,2024-11-20,9893
3037,欣興,23,3,20,元大-大天母,2024-11-20,9893
1795,美時,23,3,20,元大-大天母,2024-11-20,9893
2885,元大金,19,0,19,元大-大天母,2024-11-20,9893
00929,復華台灣科技優息,42,25,17,元大-大天母,2024-11-20,9893
00756B,群益投等新興公債,17,0,17,元大-大天母,2024-11-20,9893
3081,聯亞,23,6,17,元大-大天母,2024-11-20,9893
3231,緯創,30,14,16,元大-大天母,2024-11-20,9893
2356,英業達,21,5,16,元大-大天母,2024-11-20,9893
00679B,元大美債20年,15,0,15,元大-大天母,2024-11-20,9893
2382,廣達,23,8,15,元大-大天母,2024-11-20,9893
2330,台積電,15,1,14,元大-大天母,2024-11-20,9893
8011,台通,14,0,14,元大-大天母,2024-11-20,9893
1817,凱撒衛,13,0,13,元大-大天母,2024-11-20,9893
00912,中信臺灣智慧50,12,0,12,元大-大天母,2024-11-20,9893
8467,波力-KY,12,0,12,元大-大天母,2024-11-20,9893
1513,中興電,13,2,11,元大-大天母,2024-11-20,9893
2353,宏��,11,0,11,元大-大天母,2024-11-20,9893
1476,儒鴻,11,0,11,元大-大天母,2024-11-20,9893
2317,鴻海,27,16,11,元大-大天母,2024-11-20,9893
1307,三芳,10,0,10,元大-大天母,2024-11-20,9893
4919,新唐,11,1,10,元大-大天母,2024-11-20,9893
2486,一詮,18,8,10,元大-大天母,2024-11-20,9893
6126,信音,10,0,10,元大-大天母,2024-11-20,9893
00687B,國泰20年美債,10,0,10,元大-大天母,2024-11-20,9893
6443,元晶,10,0,10,元大-大天母,2024-11-20,9893
2385,群光,10,0,10,元大-大天母,2024-11-20,9893
2002,中鋼,10,1,9,元大-大天母,2024-11-20,9893
00960,野村全球航運龍頭,14,5,9,元大-大天母,2024-11-20,9893
5426,振發,12,3,9,元大-大天母,2024-11-20,9893
9105,泰金寶-DR,451,263,188,元大-大天母,2024-11-21,9893
00941,中信上游半導體,140,0,140,元大-大天母,2024-11-21,9893
00664R,國泰臺灣加權反1,100,0,100,元大-大天母,2024-11-21,9893
2609,陽明,163,79,84,元大-大天母,2024-11-21,9893
1584,精剛,75,0,75,元大-大天母,2024-11-21,9893
00652,富邦印度,75,0,75,元大-大天母,2024-11-21,9893
2886,兆豐金,70,0,70,元大-大天母,2024-11-21,9893
2444,兆勁,58,0,58,元大-大天母,2024-11-21,9893
2303,聯電,86,31,55,元大-大天母,2024-11-21,9893
2312,金寶,194,144,50,元大-大天母,2024-11-21,9893
5880,合庫金,50,0,50,元大-大天母,2024-11-21,9893
00922,國泰台灣領袖50,46,0,46,元大-大天母,2024-11-21,9893
4987,科誠,42,0,42,元大-大天母,2024-11-21,9893
1817,凱撒衛,42,0,42,元大-大天母,2024-11-21,9893
0050,元大台灣50,54,15,39,元大-大天母,2024-11-21,9893
00878,國泰永續高股息,36,0,36,元大-大天母,2024-11-21,9893
8150,南茂,30,0,30,元大-大天母,2024-11-21,9893
00930,永豐ESG低碳高息,29,0,29,元大-大天母,2024-11-21,9893
2330,台積電,33,4,29,元大-大天母,2024-11-21,9893
5309,系統電,64,37,27,元大-大天母,2024-11-21,9893
2474,可成,26,0,26,元大-大天母,2024-11-21,9893
2882,國泰金,35,10,25,元大-大天母,2024-11-21,9893
0056,元大高股息,27,5,22,元大-大天母,2024-11-21,9893
3017,奇鋐,32,11,21,元大-大天母,2024-11-21,9893
00919,群益台灣精選高息,21,0,21,元大-大天母,2024-11-21,9893
2892,第一金,25,6,19,元大-大天母,2024-11-21,9893
4956,光鋐,29,10,19,元大-大天母,2024-11-21,9893
3711,日月光投控,17,0,17,元大-大天母,2024-11-21,9893
2353,宏��,17,0,17,元大-大天母,2024-11-21,9893
2317,鴻海,26,10,16,元大-大天母,2024-11-21,9893
2313,華通,22,6,16,元大-大天母,2024-11-21,9893
2618,長榮航,31,16,15,元大-大天母,2024-11-21,9893
2539,櫻花建,14,0,14,元大-大天母,2024-11-21,9893
6862,三集瑞-KY,13,0,13,元大-大天母,2024-11-21,9893
2801,彰銀,12,0,12,元大-大天母,2024-11-21,9893
4113,聯上,12,0,12,元大-大天母,2024-11-21,9893
1720,生達,14,2,12,元大-大天母,2024-11-21,9893
9939,宏全,24,12,12,元大-大天母,2024-11-21,9893
2605,新興,13,2,11,元大-大天母,2024-11-21,9893
5009,榮剛,11,0,11,元大-大天母,2024-11-21,9893
6821,聯寶,20,10,10,元大-大天母,2024-11-21,9893
2451,創見,10,0,10,元大-大天母,2024-11-21,9893
2467,志聖,10,1,9,元大-大天母,2024-11-21,9893
00687B,國泰20年美債,9,0,9,元大-大天母,2024-11-21,9893
3622,洋華,8,0,8,元大-大天母,2024-11-21,9893
3081,聯亞,20,12,8,元大-大天母,2024-11-21,9893
006208,富邦台50,12,5,7,元大-大天母,2024-11-21,9893
8104,錸寶,86,79,7,元大-大天母,2024-11-21,9893
3628,盈正,7,0,7,元大-大天母,2024-11-21,9893
2201,裕隆,8,1,7,元大-大天母,2024-11-21,9893
1802,台玻,350,168,182,元大-大天母,2024-11-22,9893
9105,泰金寶-DR,337,158,179,元大-大天母,2024-11-22,9893
9904,寶成,123,3,120,元大-大天母,2024-11-22,9893
912000,晨訊科-DR,101,0,101,元大-大天母,2024-11-22,9893
00953B,群益優選非投等債,93,0,93,元大-大天母,2024-11-22,9893
2331,精英,65,6,59,元大-大天母,2024-11-22,9893
5309,系統電,125,66,59,元大-大天母,2024-11-22,9893
006206,元大上證50,32,0,32,元大-大天母,2024-11-22,9893
3551,世禾,30,0,30,元大-大天母,2024-11-22,9893
6143,振曜,30,1,29,元大-大天母,2024-11-22,9893
5315,光聯,28,0,28,元大-大天母,2024-11-22,9893
1101,台泥,34,6,28,元大-大天母,2024-11-22,9893
2609,陽明,47,19,28,元大-大天母,2024-11-22,9893
2354,鴻準,94,66,28,元大-大天母,2024-11-22,9893
4987,科誠,25,0,25,元大-大天母,2024-11-22,9893
8039,台虹,25,0,25,元大-大天母,2024-11-22,9893
2444,兆勁,81,56,25,元大-大天母,2024-11-22,9893
3706,神達,272,250,22,元大-大天母,2024-11-22,9893
00909,國泰數位支付服務,21,0,21,元大-大天母,2024-11-22,9893
5243,乙盛-KY,43,23,20,元大-大天母,2024-11-22,9893
5522,遠雄,19,0,19,元大-大天母,2024-11-22,9893
00915,凱基優選高股息30,68,50,18,元大-大天母,2024-11-22,9893
2867,三商壽,25,10,15,元大-大天母,2024-11-22,9893
8163,達方,24,9,15,元大-大天母,2024-11-22,9893
00960,野村全球航運龍頭,14,0,14,元大-大天母,2024-11-22,9893
3211,順達,36,23,13,元大-大天母,2024-11-22,9893
2615,萬海,24,11,13,元大-大天母,2024-11-22,9893
3511,矽瑪,18,6,12,元大-大天母,2024-11-22,9893
2349,錸德,17,5,12,元大-大天母,2024-11-22,9893
2317,鴻海,16,5,11,元大-大天母,2024-11-22,9893
2408,南亞科,12,1,11,元大-大天母,2024-11-22,9893
2014,中鴻,15,4,11,元大-大天母,2024-11-22,9893
00692,富邦公司治理,10,0,10,元大-大天母,2024-11-22,9893
1563,巧新,10,0,10,元大-大天母,2024-11-22,9893
3520,華盈,10,0,10,元大-大天母,2024-11-22,9893
2211,長榮鋼,10,0,10,元大-大天母,2024-11-22,9893
8938,明安,10,0,10,元大-大天母,2024-11-22,9893
00639,富邦深100,10,0,10,元大-大天母,2024-11-22,9893
6282,康舒,14,4,10,元大-大天母,2024-11-22,9893
2356,英業達,26,16,10,元大-大天母,2024-11-22,9893
00679B,元大美債20年,12,2,10,元大-大天母,2024-11-22,9893
3374,精材,13,4,9,元大-大天母,2024-11-22,9893
3323,加百裕,52,43,9,元大-大天母,2024-11-22,9893
3062,建漢,12,3,9,元大-大天母,2024-11-22,9893
00633L,富邦上証正2,10,1,9,元大-大天母,2024-11-22,9893
2464,盟立,12,3,9,元大-大天母,2024-11-22,9893
8011,台通,13,5,8,元大-大天母,2024-11-22,9893
3017,奇鋐,31,23,8,元大-大天母,2024-11-22,9893
2504,國產,8,0,8,元大-大天母,2024-11-22,9893
00687B,國泰20年美債,8,0,8,元大-大天母,2024-11-22,9893
00637L,元大滬深300正2,311,38,273,元大-大天母,2024-11-25,9893
2312,金寶,601,345,256,元大-大天母,2024-11-25,9893
1802,台玻,225,56,169,元大-大天母,2024-11-25,9893
00915,凱基優選高股息30,154,0,154,元大-大天母,2024-11-25,9893
5347,世界,112,0,112,元大-大天母,2024-11-25,9893
6546,正基,112,11,101,元大-大天母,2024-11-25,9893
00671R,富邦NASDAQ反1,100,0,100,元大-大天母,2024-11-25,9893
4987,科誠,74,0,74,元大-大天母,2024-11-25,9893
1815,富喬,156,90,66,元大-大天母,2024-11-25,9893
2618,長榮航,72,11,61,元大-大天母,2024-11-25,9893
00919,群益台灣精選高息,54,1,53,元大-大天母,2024-11-25,9893
00953B,群益優選非投等債,51,0,51,元大-大天母,2024-11-25,9893
00648R,元大S＆P500反1,50,0,50,元大-大天母,2024-11-25,9893
00669R,國泰美國道瓊反1,50,0,50,元大-大天母,2024-11-25,9893
6695,芯鼎,50,0,50,元大-大天母,2024-11-25,9893
006206,元大上證50,50,0,50,元大-大天母,2024-11-25,9893
2371,大同,47,2,45,元大-大天母,2024-11-25,9893
1101,台泥,50,8,42,元大-大天母,2024-11-25,9893
1301,台塑,43,1,42,元大-大天母,2024-11-25,9893
1102,亞泥,40,0,40,元大-大天母,2024-11-25,9893
9105,泰金寶-DR,338,298,40,元大-大天母,2024-11-25,9893
00687B,國泰20年美債,44,7,37,元大-大天母,2024-11-25,9893
00641R,富邦日本反1,50,15,35,元大-大天母,2024-11-25,9893
3013,晟銘電,39,5,34,元大-大天母,2024-11-25,9893
2636,台驊控股,33,0,33,元大-大天母,2024-11-25,9893
2615,萬海,41,9,32,元大-大天母,2024-11-25,9893
00887,永豐中國科技50大,33,2,31,元大-大天母,2024-11-25,9893
2603,長榮,72,44,28,元大-大天母,2024-11-25,9893
2354,鴻準,100,72,28,元大-大天母,2024-11-25,9893
3030,德律,28,0,28,元大-大天母,2024-11-25,9893
5876,上海商銀,26,0,26,元大-大天母,2024-11-25,9893
00706L,期元大S＆P日圓正2,25,0,25,元大-大天母,2024-11-25,9893
6190,萬泰科,25,1,24,元大-大天母,2024-11-25,9893
00638R,元大滬深300反1,23,0,23,元大-大天母,2024-11-25,9893
5465,富驊,32,10,22,元大-大天母,2024-11-25,9893
3032,偉訓,24,4,20,元大-大天母,2024-11-25,9893
00665L,富邦�琤肭磪囓�2,20,0,20,元大-大天母,2024-11-25,9893
00720B,元大投資級公司債,19,0,19,元大-大天母,2024-11-25,9893
2368,金像電,22,4,18,元大-大天母,2024-11-25,9893
6213,聯茂,53,35,18,元大-大天母,2024-11-25,9893
6505,台塑化,18,0,18,元大-大天母,2024-11-25,9893
00960,野村全球航運龍頭,16,0,16,元大-大天母,2024-11-25,9893
2885,元大金,26,10,16,元大-大天母,2024-11-25,9893
2891,中信金,26,11,15,元大-大天母,2024-11-25,9893
2474,可成,15,0,15,元大-大天母,2024-11-25,9893
6164,華興,15,0,15,元大-大天母,2024-11-25,9893
00633L,富邦上証正2,15,0,15,元大-大天母,2024-11-25,9893
3374,精材,20,6,14,元大-大天母,2024-11-25,9893
2834,臺企銀,13,0,13,元大-大天母,2024-11-25,9893
3380,明泰,33,20,13,元大-大天母,2024-11-25,9893
00948B,中信優息投資級債,150,0,150,元大-大天母,2024-11-26,9893
2317,鴻海,138,15,123,元大-大天母,2024-11-26,9893
00887,永豐中國科技50大,100,0,100,元大-大天母,2024-11-26,9893
00937B,群益ESG投等債20,153,59,94,元大-大天母,2024-11-26,9893
1524,耿鼎,119,26,93,元大-大天母,2024-11-26,9893
6104,創惟,98,9,89,元大-大天母,2024-11-26,9893
2312,金寶,182,103,79,元大-大天母,2024-11-26,9893
2303,聯電,107,50,57,元大-大天母,2024-11-26,9893
1795,美時,54,3,51,元大-大天母,2024-11-26,9893
5347,世界,50,0,50,元大-大天母,2024-11-26,9893
9105,泰金寶-DR,142,101,41,元大-大天母,2024-11-26,9893
00751B,元大AAA至A公司債,37,0,37,元大-大天母,2024-11-26,9893
3231,緯創,44,7,37,元大-大天母,2024-11-26,9893
2426,鼎元,52,16,36,元大-大天母,2024-11-26,9893
3521,鴻翊,35,0,35,元大-大天母,2024-11-26,9893
6164,華興,35,0,35,元大-大天母,2024-11-26,9893
6143,振曜,34,0,34,元大-大天母,2024-11-26,9893
00878,國泰永續高股息,41,10,31,元大-大天母,2024-11-26,9893
2330,台積電,37,6,31,元大-大天母,2024-11-26,9893
2615,萬海,23,0,23,元大-大天母,2024-11-26,9893
6505,台塑化,22,0,22,元大-大天母,2024-11-26,9893
3017,奇鋐,29,8,21,元大-大天母,2024-11-26,9893
1531,高林股,31,11,20,元大-大天母,2024-11-26,9893
006208,富邦台50,19,1,18,元大-大天母,2024-11-26,9893
2486,一詮,19,3,16,元大-大天母,2024-11-26,9893
0056,元大高股息,16,0,16,元大-大天母,2024-11-26,9893
4584,君帆,16,0,16,元大-大天母,2024-11-26,9893
4973,廣穎,15,0,15,元大-大天母,2024-11-26,9893
1540,喬福,40,26,14,元大-大天母,2024-11-26,9893
1809,中釉,14,1,13,元大-大天母,2024-11-26,9893
4526,東台,18,5,13,元大-大天母,2024-11-26,9893
3036,文曄,16,3,13,元大-大天母,2024-11-26,9893
3211,順達,28,15,13,元大-大天母,2024-11-26,9893
1802,台玻,24,12,12,元大-大天母,2024-11-26,9893
3296,勝德,14,2,12,元大-大天母,2024-11-26,9893
2884,玉山金,12,0,12,元大-大天母,2024-11-26,9893
9945,潤泰新,14,3,11,元大-大天母,2024-11-26,9893
4532,瑞智,10,0,10,元大-大天母,2024-11-26,9893
3479,安勤,10,0,10,元大-大天母,2024-11-26,9893
0061,元大寶滬深,10,0,10,元大-大天母,2024-11-26,9893
6643,M31,10,0,10,元大-大天母,2024-11-26,9893
00650L,復華香港正2,10,0,10,元大-大天母,2024-11-26,9893
0050,元大台灣50,10,0,10,元大-大天母,2024-11-26,9893
2354,鴻準,35,26,9,元大-大天母,2024-11-26,9893
2338,光罩,8,0,8,元大-大天母,2024-11-26,9893
1504,東元,14,6,8,元大-大天母,2024-11-26,9893
8284,三竹,8,0,8,元大-大天母,2024-11-26,9893
00930,永豐ESG低碳高息,8,0,8,元大-大天母,2024-11-26,9893
3706,神達,77,70,7,元大-大天母,2024-11-26,9893
00960,野村全球航運龍頭,7,0,7,元大-大天母,2024-11-26,9893
00637L,元大滬深300正2,286,92,194,元大-大天母,2024-11-27,9893
2303,聯電,239,54,185,元大-大天母,2024-11-27,9893
3706,神達,269,113,156,元大-大天母,2024-11-27,9893
0056,元大高股息,149,2,147,元大-大天母,2024-11-27,9893
00919,群益台灣精選高息,135,5,130,元大-大天母,2024-11-27,9893
00878,國泰永續高股息,121,6,115,元大-大天母,2024-11-27,9893
6257,矽格,100,2,98,元大-大天母,2024-11-27,9893
2312,金寶,104,36,68,元大-大天母,2024-11-27,9893
2409,友達,52,3,49,元大-大天母,2024-11-27,9893
5439,高技,46,0,46,元大-大天母,2024-11-27,9893
00922,國泰台灣領袖50,45,1,44,元大-大天母,2024-11-27,9893
2330,台積電,47,4,43,元大-大天母,2024-11-27,9893
6143,振曜,39,0,39,元大-大天母,2024-11-27,9893
1504,東元,66,28,38,元大-大天母,2024-11-27,9893
3231,緯創,66,28,38,元大-大天母,2024-11-27,9893
00940,元大台灣價值高息,39,3,36,元大-大天母,2024-11-27,9893
2603,長榮,78,47,31,元大-大天母,2024-11-27,9893
2883,凱基金,30,0,30,元大-大天母,2024-11-27,9893
1536,和大,132,103,29,元大-大天母,2024-11-27,9893
2324,仁寶,30,1,29,元大-大天母,2024-11-27,9893
006208,富邦台50,28,1,27,元大-大天母,2024-11-27,9893
00929,復華台灣科技優息,29,3,26,元大-大天母,2024-11-27,9893
2881,富邦金,29,4,25,元大-大天母,2024-11-27,9893
2382,廣達,27,2,25,元大-大天母,2024-11-27,9893
2615,萬海,28,4,24,元大-大天母,2024-11-27,9893
0050,元大台灣50,28,6,22,元大-大天母,2024-11-27,9893
3019,亞光,24,2,22,元大-大天母,2024-11-27,9893
1402,遠東新,21,0,21,元大-大天母,2024-11-27,9893
2317,鴻海,74,53,21,元大-大天母,2024-11-27,9893
6203,海韻電,20,0,20,元大-大天母,2024-11-27,9893
9945,潤泰新,20,1,19,元大-大天母,2024-11-27,9893
6505,台塑化,19,0,19,元大-大天母,2024-11-27,9893
2204,中華,39,21,18,元大-大天母,2024-11-27,9893
2392,正崴,68,52,16,元大-大天母,2024-11-27,9893
1528,恩德,15,0,15,元大-大天母,2024-11-27,9893
1584,精剛,30,15,15,元大-大天母,2024-11-27,9893
3037,欣興,20,6,14,元大-大天母,2024-11-27,9893
4951,精拓科,12,0,12,元大-大天母,2024-11-27,9893
1611,中電,12,0,12,元大-大天母,2024-11-27,9893
1102,亞泥,11,0,11,元大-大天母,2024-11-27,9893
3580,友威科,11,0,11,元大-大天母,2024-11-27,9893
5481,新華,11,0,11,元大-大天母,2024-11-27,9893
00939,統一台灣高息動能,10,0,10,元大-大天母,2024-11-27,9893
2903,遠百,10,0,10,元大-大天母,2024-11-27,9893
2472,立隆電,10,0,10,元大-大天母,2024-11-27,9893
00638R,元大滬深300反1,10,0,10,元大-大天母,2024-11-27,9893
6191,精成科,10,0,10,元大-大天母,2024-11-27,9893
1218,泰山,10,0,10,元大-大天母,2024-11-27,9893
8028,昇陽半導體,11,2,9,元大-大天母,2024-11-27,9893
2834,臺企銀,11,2,9,元大-大天母,2024-11-27,9893
00632R,元大台灣50反1,622,31,591,元大-大天母,2024-11-28,9893
2888,新光金,300,5,295,元大-大天母,2024-11-28,9893
00919,群益台灣精選高息,172,1,171,元大-大天母,2024-11-28,9893
00878,國泰永續高股息,173,7,166,元大-大天母,2024-11-28,9893
2303,聯電,166,43,123,元大-大天母,2024-11-28,9893
2312,金寶,233,111,122,元大-大天母,2024-11-28,9893
2897,王道銀行,70,0,70,元大-大天母,2024-11-28,9893
0056,元大高股息,76,6,70,元大-大天母,2024-11-28,9893
3521,鴻翊,50,0,50,元大-大天母,2024-11-28,9893
00922,國泰台灣領袖50,46,0,46,元大-大天母,2024-11-28,9893
6104,創惟,47,3,44,元大-大天母,2024-11-28,9893
2317,鴻海,57,21,36,元大-大天母,2024-11-28,9893
00915,凱基優選高股息30,33,0,33,元大-大天母,2024-11-28,9893
3317,尼克森,31,0,31,元大-大天母,2024-11-28,9893
5347,世界,30,2,28,元大-大天母,2024-11-28,9893
00715L,期街口布蘭特正2,26,0,26,元大-大天母,2024-11-28,9893
2332,友訊,59,35,24,元大-大天母,2024-11-28,9893
00687B,國泰20年美債,23,0,23,元大-大天母,2024-11-28,9893
2646,星宇航空,22,0,22,元大-大天母,2024-11-28,9893
00725B,國泰投資級公司債,27,5,22,元大-大天母,2024-11-28,9893
6245,立端,20,0,20,元大-大天母,2024-11-28,9893
00862B,中信投資級公司債,19,0,19,元大-大天母,2024-11-28,9893
1536,和大,51,32,19,元大-大天母,2024-11-28,9893
00950B,凱基A級公司債,18,0,18,元大-大天母,2024-11-28,9893
2330,台積電,20,3,17,元大-大天母,2024-11-28,9893
0050,元大台灣50,20,2,18,元大-大天母,2024-11-28,9893
2367,燿華,15,0,15,元大-大天母,2024-11-28,9893
4510,高鋒,271,256,15,元大-大天母,2024-11-28,9893
2408,南亞科,18,3,15,元大-大天母,2024-11-28,9893
2881,富邦金,34,20,14,元大-大天母,2024-11-28,9893
4991,環宇-KY,17,3,14,元大-大天母,2024-11-28,9893
9105,泰金寶-DR,147,133,14,元大-大天母,2024-11-28,9893
8086,宏捷科,17,3,14,元大-大天母,2024-11-28,9893
5309,系統電,67,54,13,元大-大天母,2024-11-28,9893
2204,中華,56,44,12,元大-大天母,2024-11-28,9893
00929,復華台灣科技優息,50,38,12,元大-大天母,2024-11-28,9893
2002,中鋼,12,1,11,元大-大天母,2024-11-28,9893
6161,捷波,11,0,11,元大-大天母,2024-11-28,9893
00907,永豐優息存股,11,0,11,元大-大天母,2024-11-28,9893
2390,云辰,10,0,10,元大-大天母,2024-11-28,9893
00650L,復華香港正2,10,0,10,元大-大天母,2024-11-28,9893
1584,精剛,10,0,10,元大-大天母,2024-11-28,9893
1731,美吾華,10,0,10,元大-大天母,2024-11-28,9893
3060,銘異,10,0,10,元大-大天母,2024-11-28,9893
8271,宇瞻,10,0,10,元大-大天母,2024-11-28,9893
2882,國泰金,15,5,10,元大-大天母,2024-11-28,9893
00927,群益半導體收益,10,0,10,元大-大天母,2024-11-28,9893
2929,淘帝-KY,10,0,10,元大-大天母,2024-11-28,9893
3321,同泰,10,0,10,元大-大天母,2024-11-28,9893
4958,臻鼎-KY,10,1,9,元大-大天母,2024-11-28,9893
5347,世界,230,0,230,元大-大天母,2024-11-29,9893
00632R,元大台灣50反1,306,91,215,元大-大天母,2024-11-29,9893
00665L,富邦�琤肭磪囓�2,200,10,190,元大-大天母,2024-11-29,9893
00664R,國泰臺灣加權反1,155,0,155,元大-大天母,2024-11-29,9893
2383,台光電,104,3,101,元大-大天母,2024-11-29,9893
2348,海悅,94,1,93,元大-大天母,2024-11-29,9893
2886,兆豐金,77,1,76,元大-大天母,2024-11-29,9893
00959B,大華投等美債15Y+,51,0,51,元大-大天母,2024-11-29,9893
00878,國泰永續高股息,48,0,48,元大-大天母,2024-11-29,9893
00953B,群益優選非投等債,41,0,41,元大-大天母,2024-11-29,9893
4127,天良,40,0,40,元大-大天母,2024-11-29,9893
9105,泰金寶-DR,68,31,37,元大-大天母,2024-11-29,9893
00919,群益台灣精選高息,36,0,36,元大-大天母,2024-11-29,9893
3714,富采,40,7,33,元大-大天母,2024-11-29,9893
5309,系統電,163,130,33,元大-大天母,2024-11-29,9893
6180,橘子,39,7,32,元大-大天母,2024-11-29,9893
6770,力積電,31,0,31,元大-大天母,2024-11-29,9893
4977,眾達-KY,32,2,30,元大-大天母,2024-11-29,9893
2426,鼎元,52,22,30,元大-大天母,2024-11-29,9893
1301,台塑,34,4,30,元大-大天母,2024-11-29,9893
4991,環宇-KY,43,16,27,元大-大天母,2024-11-29,9893
2881,富邦金,31,6,25,元大-大天母,2024-11-29,9893
6530,創威,31,7,24,元大-大天母,2024-11-29,9893
2317,鴻海,47,23,24,元大-大天母,2024-11-29,9893
2371,大同,29,6,23,元大-大天母,2024-11-29,9893
00862B,中信投資級公司債,22,0,22,元大-大天母,2024-11-29,9893
2330,台積電,25,3,22,元大-大天母,2024-11-29,9893
3481,群創,20,0,20,元大-大天母,2024-11-29,9893
5009,榮剛,20,0,20,元大-大天母,2024-11-29,9893
00924,復華S＆P500成長,20,0,20,元大-大天母,2024-11-29,9893
6239,力成,20,0,20,元大-大天母,2024-11-29,9893
6541,泰福-KY,19,0,19,元大-大天母,2024-11-29,9893
0056,元大高股息,29,10,19,元大-大天母,2024-11-29,9893
1402,遠東新,18,5,13,元大-大天母,2024-11-29,9893
1101,台泥,13,0,13,元大-大天母,2024-11-29,9893
00751B,元大AAA至A公司債,22,10,12,元大-大天母,2024-11-29,9893
2618,長榮航,20,8,12,元大-大天母,2024-11-29,9893
2882,國泰金,19,8,11,元大-大天母,2024-11-29,9893
2615,萬海,18,7,11,元大-大天母,2024-11-29,9893
4927,泰鼎-KY,11,0,11,元大-大天母,2024-11-29,9893
00680L,元大美債20正2,11,0,11,元大-大天母,2024-11-29,9893
5469,瀚宇博,10,0,10,元大-大天母,2024-11-29,9893
3521,鴻翊,10,0,10,元大-大天母,2024-11-29,9893
3213,茂訊,11,1,10,元大-大天母,2024-11-29,9893
3265,台星科,10,0,10,元大-大天母,2024-11-29,9893
00795B,中信美國公債20年,10,0,10,元大-大天母,2024-11-29,9893
3455,由田,10,0,10,元大-大天母,2024-11-29,9893
3380,明泰,9,0,9,元大-大天母,2024-11-29,9893
1785,光洋科,10,1,9,元大-大天母,2024-11-29,9893
2002,中鋼,8,0,8,元大-大天母,2024-11-29,9893
00632R,元大台灣50反1,314,0,314,元大-大天母,2024-12-02,9893
1605,華新,210,1,209,元大-大天母,2024-12-02,9893
5439,高技,155,3,152,元大-大天母,2024-12-02,9893
00915,凱基優選高股息30,152,8,144,元大-大天母,2024-12-02,9893
2302,麗正,163,25,138,元大-大天母,2024-12-02,9893
00637L,元大滬深300正2,125,5,120,元大-大天母,2024-12-02,9893
2027,大成鋼,51,0,51,元大-大天母,2024-12-02,9893
2317,鴻海,55,11,44,元大-大天母,2024-12-02,9893
4766,南寶,41,0,41,元大-大天母,2024-12-02,9893
00950B,凱基A級公司債,37,2,35,元大-大天母,2024-12-02,9893
2426,鼎元,35,1,34,元大-大天母,2024-12-02,9893
2344,華邦電,34,0,34,元大-大天母,2024-12-02,9893
5009,榮剛,30,1,29,元大-大天母,2024-12-02,9893
00948B,中信優息投資級債,48,20,28,元大-大天母,2024-12-02,9893
4303,信立,51,25,26,元大-大天母,2024-12-02,9893
2337,旺宏,26,0,26,元大-大天母,2024-12-02,9893
6180,橘子,44,19,25,元大-大天母,2024-12-02,9893
2327,國巨,24,1,23,元大-大天母,2024-12-02,9893
1524,耿鼎,23,0,23,元大-大天母,2024-12-02,9893
1522,堤維西,28,6,22,元大-大天母,2024-12-02,9893
6257,矽格,21,1,20,元大-大天母,2024-12-02,9893
00924,復華S＆P500成長,20,0,20,元大-大天母,2024-12-02,9893
1434,福懋,18,0,18,元大-大天母,2024-12-02,9893
00878,國泰永續高股息,37,21,16,元大-大天母,2024-12-02,9893
5309,系統電,71,55,16,元大-大天母,2024-12-02,9893
5876,上海商銀,14,0,14,元大-大天母,2024-12-02,9893
4979,華星光,70,57,13,元大-大天母,2024-12-02,9893
4747,強生,12,0,12,元大-大天母,2024-12-02,9893
00740B,富邦全球投等債,12,0,12,元大-大天母,2024-12-02,9893
4123,晟德,12,0,12,元大-大天母,2024-12-02,9893
2834,臺企銀,11,0,11,元大-大天母,2024-12-02,9893
1528,恩德,11,0,11,元大-大天母,2024-12-02,9893
00830,國泰費城半導體,11,0,11,元大-大天母,2024-12-02,9893
3016,嘉晶,10,0,10,元大-大天母,2024-12-02,9893
1711,永光,10,0,10,元大-大天母,2024-12-02,9893
6155,鈞寶,10,0,10,元大-大天母,2024-12-02,9893
2915,潤泰全,13,3,10,元大-大天母,2024-12-02,9893
3380,明泰,12,2,10,元大-大天母,2024-12-02,9893
5469,瀚宇博,10,0,10,元大-大天母,2024-12-02,9893
2369,菱生,10,0,10,元大-大天母,2024-12-02,9893
2062,橋椿,11,2,9,元大-大天母,2024-12-02,9893
00708L,期元大S＆P黃金正2,9,0,9,元大-大天母,2024-12-02,9893
2402,毅嘉,8,0,8,元大-大天母,2024-12-02,9893
2359,所羅門,7,0,7,元大-大天母,2024-12-02,9893
3036,文曄,7,0,7,元大-大天母,2024-12-02,9893
3450,聯鈞,24,17,7,元大-大天母,2024-12-02,9893
2606,裕民,7,0,7,元大-大天母,2024-12-02,9893
5328,華容,14,7,7,元大-大天母,2024-12-02,9893
6530,創威,8,1,7,元大-大天母,2024-12-02,9893
3628,盈正,7,0,7,元大-大天母,2024-12-02,9893
00919,群益台灣精選高息,384,23,361,元大-大天母,2024-12-03,9893
6104,創惟,309,27,282,元大-大天母,2024-12-03,9893
00878,國泰永續高股息,155,10,145,元大-大天母,2024-12-03,9893
00918,大華優利高填息30,133,3,130,元大-大天母,2024-12-03,9893
2303,聯電,153,34,119,元大-大天母,2024-12-03,9893
3005,神基,96,2,94,元大-大天母,2024-12-03,9893
2317,鴻海,117,24,93,元大-大天母,2024-12-03,9893
2302,麗正,89,10,79,元大-大天母,2024-12-03,9893
4991,環宇-KY,112,37,75,元大-大天母,2024-12-03,9893
4303,信立,107,45,62,元大-大天母,2024-12-03,9893
1809,中釉,46,0,46,元大-大天母,2024-12-03,9893
2323,中環,43,0,43,元大-大天母,2024-12-03,9893
1536,和大,71,32,39,元大-大天母,2024-12-03,9893
0056,元大高股息,39,1,38,元大-大天母,2024-12-03,9893
1449,佳和,50,15,35,元大-大天母,2024-12-03,9893
3665,貿聯-KY,34,2,32,元大-大天母,2024-12-03,9893
00937B,群益ESG投等債20,165,135,30,元大-大天母,2024-12-03,9893
00687B,國泰20年美債,42,15,27,元大-大天母,2024-12-03,9893
2382,廣達,25,1,24,元大-大天母,2024-12-03,9893
6757,台灣虎航,33,10,23,元大-大天母,2024-12-03,9893
3323,加百裕,41,19,22,元大-大天母,2024-12-03,9893
00924,復華S＆P500成長,20,0,20,元大-大天母,2024-12-03,9893
3032,偉訓,40,20,20,元大-大天母,2024-12-03,9893
1605,華新,19,0,19,元大-大天母,2024-12-03,9893
00907,永豐優息存股,21,2,19,元大-大天母,2024-12-03,9893
1314,中石化,20,2,18,元大-大天母,2024-12-03,9893
8028,昇陽半導體,23,5,18,元大-大天母,2024-12-03,9893
2892,第一金,27,9,18,元大-大天母,2024-12-03,9893
2444,兆勁,17,0,17,元大-大天母,2024-12-03,9893
3526,凡甲,14,0,14,元大-大天母,2024-12-03,9893
2385,群光,13,0,13,元大-大天母,2024-12-03,9893
9105,泰金寶-DR,43,30,13,元大-大天母,2024-12-03,9893
6257,矽格,13,0,13,元大-大天母,2024-12-03,9893
00773B,中信優先金融債,13,0,13,元大-大天母,2024-12-03,9893
3550,聯穎,12,0,12,元大-大天母,2024-12-03,9893
3231,緯創,18,7,11,元大-大天母,2024-12-03,9893
6558,興能高,25,14,11,元大-大天母,2024-12-03,9893
00680L,元大美債20正2,11,0,11,元大-大天母,2024-12-03,9893
3558,神準,12,1,11,元大-大天母,2024-12-03,9893
6414,樺漢,10,0,10,元大-大天母,2024-12-03,9893
2211,長榮鋼,10,0,10,元大-大天母,2024-12-03,9893
2329,華泰,13,3,10,元大-大天母,2024-12-03,9893
1325,恆大,10,0,10,元大-大天母,2024-12-03,9893
2547,日勝生,10,0,10,元大-大天母,2024-12-03,9893
3090,日電貿,12,2,10,元大-大天母,2024-12-03,9893
2002,中鋼,9,0,9,元大-大天母,2024-12-03,9893
3447,展達,9,0,9,元大-大天母,2024-12-03,9893
6175,立敦,11,2,9,元大-大天母,2024-12-03,9893
4714,永捷,9,0,9,元大-大天母,2024-12-03,9893
1434,福懋,9,0,9,元大-大天母,2024-12-03,9893
3706,神達,519,172,347,元大-大天母,2024-12-04,9893
00679B,元大美債20年,269,36,233,元大-大天母,2024-12-04,9893
00953B,群益優選非投等債,230,0,230,元大-大天母,2024-12-04,9893
4991,環宇-KY,143,15,128,元大-大天母,2024-12-04,9893
2368,金像電,102,3,99,元大-大天母,2024-12-04,9893
2303,聯電,105,20,85,元大-大天母,2024-12-04,9893
1802,台玻,75,20,55,元大-大天母,2024-12-04,9893
5439,高技,72,18,54,元大-大天母,2024-12-04,9893
00669R,國泰美國道瓊反1,50,0,50,元大-大天母,2024-12-04,9893
3540,曜越,51,1,50,元大-大天母,2024-12-04,9893
1303,南亞,47,0,47,元大-大天母,2024-12-04,9893
6426,統新,40,0,40,元大-大天母,2024-12-04,9893
00712,復華富時不動產,38,0,38,元大-大天母,2024-12-04,9893
2356,英業達,60,22,38,元大-大天母,2024-12-04,9893
2371,大同,36,0,36,元大-大天母,2024-12-04,9893
2891,中信金,70,40,30,元大-大天母,2024-12-04,9893
2408,南亞科,29,0,29,元大-大天母,2024-12-04,9893
1605,華新,29,0,29,元大-大天母,2024-12-04,9893
2027,大成鋼,30,1,29,元大-大天母,2024-12-04,9893
00933B,國泰10Y+金融債,26,0,26,元大-大天母,2024-12-04,9893
2636,台驊控股,25,0,25,元大-大天母,2024-12-04,9893
6919,康霈*,29,5,24,元大-大天母,2024-12-04,9893
2606,裕民,24,0,24,元大-大天母,2024-12-04,9893
00713,元大台灣高息低波,24,2,22,元大-大天母,2024-12-04,9893
2376,技嘉,22,0,22,元大-大天母,2024-12-04,9893
3062,建漢,30,10,20,元大-大天母,2024-12-04,9893
00918,大華優利高填息30,21,1,20,元大-大天母,2024-12-04,9893
3591,艾笛森,20,0,20,元大-大天母,2024-12-04,9893
2302,麗正,52,32,20,元大-大天母,2024-12-04,9893
2312,金寶,25,5,20,元大-大天母,2024-12-04,9893
2211,長榮鋼,20,0,20,元大-大天母,2024-12-04,9893
2486,一詮,22,3,19,元大-大天母,2024-12-04,9893
2327,國巨,37,19,18,元大-大天母,2024-12-04,9893
00919,群益台灣精選高息,36,18,18,元大-大天母,2024-12-04,9893
3380,明泰,19,3,16,元大-大天母,2024-12-04,9893
1513,中興電,14,0,14,元大-大天母,2024-12-04,9893
5328,華容,35,21,14,元大-大天母,2024-12-04,9893
00673R,期元大S＆P原油反1,14,0,14,元大-大天母,2024-12-04,9893
0056,元大高股息,18,6,12,元大-大天母,2024-12-04,9893
2352,佳世達,13,1,12,元大-大天母,2024-12-04,9893
6143,振曜,11,0,11,元大-大天母,2024-12-04,9893
2385,群光,11,0,11,元大-大天母,2024-12-04,9893
00830,國泰費城半導體,10,0,10,元大-大天母,2024-12-04,9893
00924,復華S＆P500成長,10,0,10,元大-大天母,2024-12-04,9893
5469,瀚宇博,10,0,10,元大-大天母,2024-12-04,9893
00932,兆豐永續高息等權,10,0,10,元大-大天母,2024-12-04,9893
3043,科風,11,1,10,元大-大天母,2024-12-04,9893
2455,全新,17,7,10,元大-大天母,2024-12-04,9893
00885,富邦越南,10,0,10,元大-大天母,2024-12-04,9893
1785,光洋科,12,2,10,元大-大天母,2024-12-04,9893
2354,鴻準,584,202,382,元大-大天母,2024-12-05,9893
1815,富喬,398,73,325,元大-大天母,2024-12-05,9893
00715L,期街口布蘭特正2,210,0,210,元大-大天母,2024-12-05,9893
2303,聯電,145,39,106,元大-大天母,2024-12-05,9893
00671R,富邦NASDAQ反1,105,0,105,元大-大天母,2024-12-05,9893
00706L,期元大S＆P日圓正2,100,0,100,元大-大天母,2024-12-05,9893
00919,群益台灣精選高息,79,13,66,元大-大天母,2024-12-05,9893
00669R,國泰美國道瓊反1,50,0,50,元大-大天母,2024-12-05,9893
00648R,元大S＆P500反1,50,0,50,元大-大天母,2024-12-05,9893
2363,矽統,55,10,45,元大-大天母,2024-12-05,9893
6138,茂達,43,0,43,元大-大天母,2024-12-05,9893
4931,新盛力,102,59,43,元大-大天母,2024-12-05,9893
6191,精成科,40,0,40,元大-大天母,2024-12-05,9893
2317,鴻海,51,16,35,元大-大天母,2024-12-05,9893
2027,大成鋼,33,0,33,元大-大天母,2024-12-05,9893
2211,長榮鋼,29,0,29,元大-大天母,2024-12-05,9893
3481,群創,31,2,29,元大-大天母,2024-12-05,9893
2392,正崴,41,16,25,元大-大天母,2024-12-05,9893
00922,國泰台灣領袖50,25,0,25,元大-大天母,2024-12-05,9893
5439,高技,30,7,23,元大-大天母,2024-12-05,9893
2474,可成,23,0,23,元大-大天母,2024-12-05,9893
00887,永豐中國科技50大,22,0,22,元大-大天母,2024-12-05,9893
3032,偉訓,37,15,22,元大-大天母,2024-12-05,9893
2356,英業達,25,3,22,元大-大天母,2024-12-05,9893
3591,艾笛森,43,22,21,元大-大天母,2024-12-05,9893
2385,群光,21,0,21,元大-大天母,2024-12-05,9893
3090,日電貿,47,26,21,元大-大天母,2024-12-05,9893
0056,元大高股息,20,0,20,元大-大天母,2024-12-05,9893
2530,華建,20,0,20,元大-大天母,2024-12-05,9893
5371,中光電,26,7,19,元大-大天母,2024-12-05,9893
6175,立敦,21,3,18,元大-大天母,2024-12-05,9893
2312,金寶,20,2,18,元大-大天母,2024-12-05,9893
3540,曜越,22,4,18,元大-大天母,2024-12-05,9893
6472,保瑞,21,4,17,元大-大天母,2024-12-05,9893
6153,嘉聯益,17,0,17,元大-大天母,2024-12-05,9893
8299,群聯,15,0,15,元大-大天母,2024-12-05,9893
2464,盟立,15,0,15,元大-大天母,2024-12-05,9893
00937B,群益ESG投等債20,25,10,15,元大-大天母,2024-12-05,9893
1522,堤維西,15,1,14,元大-大天母,2024-12-05,9893
4956,光鋐,16,3,13,元大-大天母,2024-12-05,9893
1785,光洋科,13,0,13,元大-大天母,2024-12-05,9893
2371,大同,30,17,13,元大-大天母,2024-12-05,9893
1402,遠東新,13,1,12,元大-大天母,2024-12-05,9893
3211,順達,30,19,11,元大-大天母,2024-12-05,9893
00915,凱基優選高股息30,21,10,11,元大-大天母,2024-12-05,9893
1504,東元,11,0,11,元大-大天母,2024-12-05,9893
1802,台玻,11,0,11,元大-大天母,2024-12-05,9893
00778B,凱基金融債20+,11,0,11,元大-大天母,2024-12-05,9893
2603,長榮,27,16,11,元大-大天母,2024-12-05,9893
6163,華電網,15,4,11,元大-大天母,2024-12-05,9893
6962,ITH-KY,220,2,218,元大-大天母,2024-12-06,9893
2412,中華電,100,0,100,元大-大天母,2024-12-06,9893
00706L,期元大S＆P日圓正2,82,0,82,元大-大天母,2024-12-06,9893
00662,富邦NASDAQ,67,0,67,元大-大天母,2024-12-06,9893
00965,元大航太防衛科技,38,0,38,元大-大天母,2024-12-06,9893
2609,陽明,47,12,35,元大-大天母,2024-12-06,9893
3540,曜越,48,16,32,元大-大天母,2024-12-06,9893
2027,大成鋼,30,0,30,元大-大天母,2024-12-06,9893
00751B,元大AAA至A公司債,30,2,28,元大-大天母,2024-12-06,9893
5371,中光電,27,0,27,元大-大天母,2024-12-06,9893
5009,榮剛,25,0,25,元大-大天母,2024-12-06,9893
3447,展達,26,1,25,元大-大天母,2024-12-06,9893
1477,聚陽,25,1,24,元大-大天母,2024-12-06,9893
2351,順德,23,0,23,元大-大天母,2024-12-06,9893
00953B,群益優選非投等債,23,0,23,元大-大天母,2024-12-06,9893
2317,鴻海,36,13,23,元大-大天母,2024-12-06,9893
00715L,期街口布蘭特正2,22,0,22,元大-大天母,2024-12-06,9893
2615,萬海,23,1,22,元大-大天母,2024-12-06,9893
00919,群益台灣精選高息,23,2,21,元大-大天母,2024-12-06,9893
00778B,凱基金融債20+,21,0,21,元大-大天母,2024-12-06,9893
6188,廣明,29,8,21,元大-大天母,2024-12-06,9893
8042,金山電,25,5,20,元大-大天母,2024-12-06,9893
8358,金居,20,0,20,元大-大天母,2024-12-06,9893
6173,信昌電,22,2,20,元大-大天母,2024-12-06,9893
2312,金寶,23,3,20,元大-大天母,2024-12-06,9893
1536,和大,25,6,19,元大-大天母,2024-12-06,9893
00655L,國泰中國A50正2,18,0,18,元大-大天母,2024-12-06,9893
1605,華新,35,18,17,元大-大天母,2024-12-06,9893
6757,台灣虎航,24,7,17,元大-大天母,2024-12-06,9893
6138,茂達,17,0,17,元大-大天母,2024-12-06,9893
3025,星通,18,3,15,元大-大天母,2024-12-06,9893
2547,日勝生,15,0,15,元大-大天母,2024-12-06,9893
2392,正崴,18,4,14,元大-大天母,2024-12-06,9893
2618,長榮航,19,5,14,元大-大天母,2024-12-06,9893
2610,華航,16,4,12,元大-大天母,2024-12-06,9893
3548,兆利,17,5,12,元大-大天母,2024-12-06,9893
2464,盟立,12,0,12,元大-大天母,2024-12-06,9893
00712,復華富時不動產,11,0,11,元大-大天母,2024-12-06,9893
3257,虹冠電,11,0,11,元大-大天母,2024-12-06,9893
3043,科風,11,0,11,元大-大天母,2024-12-06,9893
2493,揚博,19,8,11,元大-大天母,2024-12-06,9893
2363,矽統,12,2,10,元大-大天母,2024-12-06,9893
3289,宜特,10,0,10,元大-大天母,2024-12-06,9893
9921,巨大,10,0,10,元大-大天母,2024-12-06,9893
2104,國際中橡,10,0,10,元大-大天母,2024-12-06,9893
4129,聯合,10,0,10,元大-大天母,2024-12-06,9893
1711,永光,10,0,10,元大-大天母,2024-12-06,9893
00676R,富邦臺灣加權反1,10,0,10,元大-大天母,2024-12-06,9893
2357,華碩,10,0,10,元大-大天母,2024-12-06,9893
3202,樺晟,10,0,10,元大-大天母,2024-12-06,9893
00909,國泰數位支付服務,204,3,201,元大-大天母,2024-12-09,9893
3211,順達,138,16,122,元大-大天母,2024-12-09,9893
2344,華邦電,113,0,113,元大-大天母,2024-12-09,9893
6877,鏵友益,112,3,109,元大-大天母,2024-12-09,9893
2354,鴻準,186,82,104,元大-大天母,2024-12-09,9893
6757,台灣虎航,117,31,86,元大-大天母,2024-12-09,9893
00715L,期街口布蘭特正2,64,0,64,元大-大天母,2024-12-09,9893
2886,兆豐金,73,9,64,元大-大天母,2024-12-09,9893
4931,新盛力,69,5,64,元大-大天母,2024-12-09,9893
00953B,群益優選非投等債,49,0,49,元大-大天母,2024-12-09,9893
2883,凱基金,41,0,41,元大-大天母,2024-12-09,9893
3060,銘異,40,0,40,元大-大天母,2024-12-09,9893
2409,友達,42,11,31,元大-大天母,2024-12-09,9893
5469,瀚宇博,31,0,31,元大-大天母,2024-12-09,9893
2646,星宇航空,36,6,30,元大-大天母,2024-12-09,9893
4956,光鋐,31,1,30,元大-大天母,2024-12-09,9893
2317,鴻海,38,8,30,元大-大天母,2024-12-09,9893
1802,台玻,50,21,29,元大-大天母,2024-12-09,9893
2375,凱美,50,24,26,元大-大天母,2024-12-09,9893
3234,光環,25,0,25,元大-大天母,2024-12-09,9893
2489,瑞軒,27,2,25,元大-大天母,2024-12-09,9893
3551,世禾,24,0,24,元大-大天母,2024-12-09,9893
00918,大華優利高填息30,24,0,24,元大-大天母,2024-12-09,9893
3714,富采,26,4,22,元大-大天母,2024-12-09,9893
2610,華航,73,51,22,元大-大天母,2024-12-09,9893
8121,越峰,20,0,20,元大-大天母,2024-12-09,9893
3521,鴻翊,20,0,20,元大-大天母,2024-12-09,9893
2449,京元電子,22,2,20,元大-大天母,2024-12-09,9893
00919,群益台灣精選高息,56,37,19,元大-大天母,2024-12-09,9893
6491,晶碩,18,0,18,元大-大天母,2024-12-09,9893
00706L,期元大S＆P日圓正2,18,0,18,元大-大天母,2024-12-09,9893
3607,谷崧,23,5,18,元大-大天母,2024-12-09,9893
4991,環宇-KY,28,11,17,元大-大天母,2024-12-09,9893
00907,永豐優息存股,17,0,17,元大-大天母,2024-12-09,9893
2474,可成,16,0,16,元大-大天母,2024-12-09,9893
8936,國統,17,1,16,元大-大天母,2024-12-09,9893
2890,永豐金,15,0,15,元大-大天母,2024-12-09,9893
8039,台虹,15,0,15,元大-大天母,2024-12-09,9893
00713,元大台灣高息低波,15,0,15,元大-大天母,2024-12-09,9893
2618,長榮航,133,120,13,元大-大天母,2024-12-09,9893
3032,偉訓,16,3,13,元大-大天母,2024-12-09,9893
9933,中鼎,12,0,12,元大-大天母,2024-12-09,9893
9939,宏全,12,0,12,元大-大天母,2024-12-09,9893
3213,茂訊,12,0,12,元大-大天母,2024-12-09,9893
2337,旺宏,12,1,11,元大-大天母,2024-12-09,9893
3706,神達,116,105,11,元大-大天母,2024-12-09,9893
00915,凱基優選高股息30,10,0,10,元大-大天母,2024-12-09,9893
2330,台積電,17,7,10,元大-大天母,2024-12-09,9893
6257,矽格,10,0,10,元大-大天母,2024-12-09,9893
4526,東台,10,0,10,元大-大天母,2024-12-09,9893
2888,新光金,500,8,492,元大-大天母,2024-12-10,9893
2880,華南金,300,1,299,元大-大天母,2024-12-10,9893
00679B,元大美債20年,108,5,103,元大-大天母,2024-12-10,9893
2610,華航,105,5,100,元大-大天母,2024-12-10,9893
00680L,元大美債20正2,101,8,93,元大-大天母,2024-12-10,9893
2547,日勝生,93,9,84,元大-大天母,2024-12-10,9893
00919,群益台灣精選高息,88,5,83,元大-大天母,2024-12-10,9893
00940,元大台灣價值高息,127,45,82,元大-大天母,2024-12-10,9893
5438,東友,73,0,73,元大-大天母,2024-12-10,9893
2646,星宇航空,54,1,53,元大-大天母,2024-12-10,9893
00662,富邦NASDAQ,45,0,45,元大-大天母,2024-12-10,9893
1449,佳和,62,23,39,元大-大天母,2024-12-10,9893
2609,陽明,68,29,39,元大-大天母,2024-12-10,9893
00751B,元大AAA至A公司債,35,0,35,元大-大天母,2024-12-10,9893
00918,大華優利高填息30,37,3,34,元大-大天母,2024-12-10,9893
2105,正新,30,0,30,元大-大天母,2024-12-10,9893
9904,寶成,30,0,30,元大-大天母,2024-12-10,9893
4167,松瑞藥,30,0,30,元大-大天母,2024-12-10,9893
00967B,元大優息美債,30,0,30,元大-大天母,2024-12-10,9893
1802,台玻,36,7,29,元大-大天母,2024-12-10,9893
00878,國泰永續高股息,30,3,27,元大-大天母,2024-12-10,9893
1409,新纖,25,0,25,元大-大天母,2024-12-10,9893
0056,元大高股息,26,4,22,元大-大天母,2024-12-10,9893
8936,國統,25,2,23,元大-大天母,2024-12-10,9893
4991,環宇-KY,20,0,20,元大-大天母,2024-12-10,9893
00968B,元大優息投等債,20,0,20,元大-大天母,2024-12-10,9893
3379,彬台,20,1,19,元大-大天母,2024-12-10,9893
2618,長榮航,65,47,18,元大-大天母,2024-12-10,9893
00922,國泰台灣領袖50,18,0,18,元大-大天母,2024-12-10,9893
3017,奇鋐,22,5,17,元大-大天母,2024-12-10,9893
6274,台燿,23,6,17,元大-大天母,2024-12-10,9893
2376,技嘉,21,6,15,元大-大天母,2024-12-10,9893
3037,欣興,17,2,15,元大-大天母,2024-12-10,9893
2883,凱基金,22,8,14,元大-大天母,2024-12-10,9893
2303,聯電,56,42,14,元大-大天母,2024-12-10,9893
6469,大樹,14,0,14,元大-大天母,2024-12-10,9893
2330,台積電,17,3,14,元大-大天母,2024-12-10,9893
8096,擎亞,19,7,12,元大-大天母,2024-12-10,9893
3714,富采,20,9,11,元大-大天母,2024-12-10,9893
8464,億豐,11,0,11,元大-大天母,2024-12-10,9893
2474,可成,11,0,11,元大-大天母,2024-12-10,9893
8028,昇陽半導體,12,1,11,元大-大天母,2024-12-10,9893
5608,四維航,11,0,11,元大-大天母,2024-12-10,9893
1220,台榮,11,0,11,元大-大天母,2024-12-10,9893
2449,京元電子,18,7,11,元大-大天母,2024-12-10,9893
00915,凱基優選高股息30,10,0,10,元大-大天母,2024-12-10,9893
2645,長榮航太,10,0,10,元大-大天母,2024-12-10,9893
3715,定穎投控,12,2,10,元大-大天母,2024-12-10,9893
00960,野村全球航運龍頭,10,0,10,元大-大天母,2024-12-10,9893
8929,富堡,10,0,10,元大-大天母,2024-12-10,9893
2888,新光金,300,10,290,元大-大天母,2024-12-11,9893
1220,台榮,142,2,140,元大-大天母,2024-12-11,9893
00918,大華優利高填息30,140,0,140,元大-大天母,2024-12-11,9893
3231,緯創,121,5,116,元大-大天母,2024-12-11,9893
00687B,國泰20年美債,114,0,114,元大-大天母,2024-12-11,9893
00679B,元大美債20年,112,3,109,元大-大天母,2024-12-11,9893
00919,群益台灣精選高息,114,12,102,元大-大天母,2024-12-11,9893
3379,彬台,99,2,97,元大-大天母,2024-12-11,9893
9910,豐泰,90,0,90,元大-大天母,2024-12-11,9893
00637L,元大滬深300正2,72,0,72,元大-大天母,2024-12-11,9893
2317,鴻海,66,6,60,元大-大天母,2024-12-11,9893
00940,元大台灣價值高息,183,130,53,元大-大天母,2024-12-11,9893
00959B,大華投等美債15Y+,50,0,50,元大-大天母,2024-12-11,9893
00753L,中信中國50正2,52,5,47,元大-大天母,2024-12-11,9893
6245,立端,43,1,42,元大-大天母,2024-12-11,9893
00878,國泰永續高股息,40,2,38,元大-大天母,2024-12-11,9893
00915,凱基優選高股息30,43,6,37,元大-大天母,2024-12-11,9893
2330,台積電,33,0,33,元大-大天母,2024-12-11,9893
3594,磐儀,32,0,32,元大-大天母,2024-12-11,9893
00673R,期元大S＆P原油反1,32,0,32,元大-大天母,2024-12-11,9893
5519,隆大,30,0,30,元大-大天母,2024-12-11,9893
6558,興能高,58,29,29,元大-大天母,2024-12-11,9893
6139,亞翔,29,1,28,元大-大天母,2024-12-11,9893
0056,元大高股息,26,1,25,元大-大天母,2024-12-11,9893
2515,中工,25,0,25,元大-大天母,2024-12-11,9893
2408,南亞科,22,1,21,元大-大天母,2024-12-11,9893
2382,廣達,25,4,21,元大-大天母,2024-12-11,9893
2385,群光,20,0,20,元大-大天母,2024-12-11,9893
00921,兆豐龍頭等權重,20,0,20,元大-大天母,2024-12-11,9893
1815,富喬,45,25,20,元大-大天母,2024-12-11,9893
00882,中信中國高股息,21,1,20,元大-大天母,2024-12-11,9893
00680L,元大美債20正2,101,85,16,元大-大天母,2024-12-11,9893
8422,可寧衛,15,0,15,元大-大天母,2024-12-11,9893
1326,台化,14,0,14,元大-大天母,2024-12-11,9893
3010,華立,15,2,13,元大-大天母,2024-12-11,9893
2303,聯電,73,60,13,元大-大天母,2024-12-11,9893
1708,東鹼,12,0,12,元大-大天母,2024-12-11,9893
3078,僑威,12,0,12,元大-大天母,2024-12-11,9893
6140,訊達,12,0,12,元大-大天母,2024-12-11,9893
3189,景碩,20,9,11,元大-大天母,2024-12-11,9893
2368,金像電,23,12,11,元大-大天母,2024-12-11,9893
00688L,國泰20年美債正2,11,0,11,元大-大天母,2024-12-11,9893
6288,聯嘉,11,0,11,元大-大天母,2024-12-11,9893
1540,喬福,11,0,11,元大-大天母,2024-12-11,9893
2645,長榮航太,11,0,11,元大-大天母,2024-12-11,9893
2609,陽明,26,15,11,元大-大天母,2024-12-11,9893
1513,中興電,10,0,10,元大-大天母,2024-12-11,9893
00720B,元大投資級公司債,10,0,10,元大-大天母,2024-12-11,9893
8039,台虹,10,0,10,元大-大天母,2024-12-11,9893
2601,益航,10,0,10,元大-大天母,2024-12-11,9893
2313,華通,647,70,577,元大-大天母,2024-12-12,9893
00931B,統一美債20年,103,0,103,元大-大天母,2024-12-12,9893
4540,全球傳動,101,1,100,元大-大天母,2024-12-12,9893
2891,中信金,200,115,85,元大-大天母,2024-12-12,9893
00919,群益台灣精選高息,82,0,82,元大-大天母,2024-12-12,9893
00679B,元大美債20年,72,3,69,元大-大天母,2024-12-12,9893
2031,新光鋼,59,0,59,元大-大天母,2024-12-12,9893
00915,凱基優選高股息30,56,5,51,元大-大天母,2024-12-12,9893
5522,遠雄,40,1,39,元大-大天母,2024-12-12,9893
00933B,國泰10Y+金融債,30,0,30,元大-大天母,2024-12-12,9893
9910,豐泰,30,0,30,元大-大天母,2024-12-12,9893
6139,亞翔,27,0,27,元大-大天母,2024-12-12,9893
2371,大同,23,0,23,元大-大天母,2024-12-12,9893
00687B,國泰20年美債,25,2,23,元大-大天母,2024-12-12,9893
00673R,期元大S＆P原油反1,22,0,22,元大-大天母,2024-12-12,9893
9945,潤泰新,29,8,21,元大-大天母,2024-12-12,9893
2351,順德,21,0,21,元大-大天母,2024-12-12,9893
1303,南亞,21,0,21,元大-大天母,2024-12-12,9893
3032,偉訓,37,17,20,元大-大天母,2024-12-12,9893
8039,台虹,20,0,20,元大-大天母,2024-12-12,9893
3594,磐儀,21,1,20,元大-大天母,2024-12-12,9893
6120,達運,20,0,20,元大-大天母,2024-12-12,9893
2374,佳能,41,23,18,元大-大天母,2024-12-12,9893
5469,瀚宇博,20,2,18,元大-大天母,2024-12-12,9893
2881,富邦金,36,19,17,元大-大天母,2024-12-12,9893
2317,鴻海,31,15,16,元大-大天母,2024-12-12,9893
2615,萬海,15,0,15,元大-大天母,2024-12-12,9893
2354,鴻準,29,14,15,元大-大天母,2024-12-12,9893
2385,群光,15,0,15,元大-大天母,2024-12-12,9893
5328,華容,116,102,14,元大-大天母,2024-12-12,9893
2312,金寶,32,18,14,元大-大天母,2024-12-12,9893
00918,大華優利高填息30,17,4,13,元大-大天母,2024-12-12,9893
6443,元晶,13,0,13,元大-大天母,2024-12-12,9893
00969B,元大零息超長美債,13,0,13,元大-大天母,2024-12-12,9893
00937B,群益ESG投等債20,13,0,13,元大-大天母,2024-12-12,9893
8261,富鼎,11,0,11,元大-大天母,2024-12-12,9893
2344,華邦電,34,23,11,元大-大天母,2024-12-12,9893
3715,定穎投控,11,0,11,元大-大天母,2024-12-12,9893
5351,鈺創,11,0,11,元大-大天母,2024-12-12,9893
00720B,元大投資級公司債,11,0,11,元大-大天母,2024-12-12,9893
4155,訊映,10,0,10,元大-大天母,2024-12-12,9893
2419,仲琦,10,0,10,元大-大天母,2024-12-12,9893
4167,松瑞藥,10,0,10,元大-大天母,2024-12-12,9893
6239,力成,10,0,10,元大-大天母,2024-12-12,9893
6143,振曜,10,0,10,元大-大天母,2024-12-12,9893
2382,廣達,15,5,10,元大-大天母,2024-12-12,9893
8936,國統,10,0,10,元大-大天母,2024-12-12,9893
4991,環宇-KY,41,32,9,元大-大天母,2024-12-12,9893
8097,常珵,10,1,9,元大-大天母,2024-12-12,9893
1618,合機,9,0,9,元大-大天母,2024-12-12,9893
5522,遠雄,183,30,153,元大-大天母,2024-12-13,9893
6245,立端,130,0,130,元大-大天母,2024-12-13,9893
00918,大華優利高填息30,127,0,127,元大-大天母,2024-12-13,9893
3060,銘異,124,0,124,元大-大天母,2024-12-13,9893
2031,新光鋼,103,0,103,元大-大天母,2024-12-13,9893
00680L,元大美債20正2,103,0,103,元大-大天母,2024-12-13,9893
3714,富采,147,48,99,元大-大天母,2024-12-13,9893
00919,群益台灣精選高息,101,5,96,元大-大天母,2024-12-13,9893
2303,聯電,222,130,92,元大-大天母,2024-12-13,9893
00937B,群益ESG投等債20,85,0,85,元大-大天母,2024-12-13,9893
1409,新纖,67,0,67,元大-大天母,2024-12-13,9893
2317,鴻海,77,16,61,元大-大天母,2024-12-13,9893
00650L,復華香港正2,60,0,60,元大-大天母,2024-12-13,9893
3207,耀勝,52,0,52,元大-大天母,2024-12-13,9893
00933B,國泰10Y+金融債,55,4,51,元大-大天母,2024-12-13,9893
2609,陽明,108,58,50,元大-大天母,2024-12-13,9893
2883,凱基金,47,1,46,元大-大天母,2024-12-13,9893
00945B,凱基美國非投等債,45,1,44,元大-大天母,2024-12-13,9893
2382,廣達,49,8,41,元大-大天母,2024-12-13,9893
6239,力成,36,0,36,元大-大天母,2024-12-13,9893
00637L,元大滬深300正2,34,0,34,元大-大天母,2024-12-13,9893
4991,環宇-KY,36,3,33,元大-大天母,2024-12-13,9893
3380,明泰,34,1,33,元大-大天母,2024-12-13,9893
00953B,群益優選非投等債,31,0,31,元大-大天母,2024-12-13,9893
00878,國泰永續高股息,30,2,28,元大-大天母,2024-12-13,9893
3706,神達,159,132,27,元大-大天母,2024-12-13,9893
3231,緯創,25,2,23,元大-大天母,2024-12-13,9893
5530,龍巖,26,3,23,元大-大天母,2024-12-13,9893
1785,光洋科,24,2,22,元大-大天母,2024-12-13,9893
8046,南電,22,1,21,元大-大天母,2024-12-13,9893
5009,榮剛,21,0,21,元大-大天母,2024-12-13,9893
2891,中信金,27,6,21,元大-大天母,2024-12-13,9893
00712,復華富時不動產,24,3,21,元大-大天母,2024-12-13,9893
2323,中環,20,0,20,元大-大天母,2024-12-13,9893
00665L,富邦�琤肭磪囓�2,20,0,20,元大-大天母,2024-12-13,9893
3481,群創,20,0,20,元大-大天母,2024-12-13,9893
2201,裕隆,20,0,20,元大-大天母,2024-12-13,9893
0056,元大高股息,48,29,19,元大-大天母,2024-12-13,9893
4956,光鋐,17,0,17,元大-大天母,2024-12-13,9893
2881,富邦金,17,2,15,元大-大天母,2024-12-13,9893
6855,數泓科,15,0,15,元大-大天母,2024-12-13,9893
2313,華通,126,112,14,元大-大天母,2024-12-13,9893
00633L,富邦上証正2,14,0,14,元大-大天母,2024-12-13,9893
5519,隆大,13,0,13,元大-大天母,2024-12-13,9893
00632R,元大台灣50反1,14,1,13,元大-大天母,2024-12-13,9893
2610,華航,16,3,13,元大-大天母,2024-12-13,9893
6112,邁達特,15,3,12,元大-大天母,2024-12-13,9893
2530,華建,12,0,12,元大-大天母,2024-12-13,9893
00751B,元大AAA至A公司債,12,0,12,元大-大天母,2024-12-13,9893
3037,欣興,19,7,12,元大-大天母,2024-12-13,9893
2031,新光鋼,164,0,164,元大-大天母,2024-12-16,9893
00918,大華優利高填息30,137,10,127,元大-大天母,2024-12-16,9893
00687B,國泰20年美債,126,4,122,元大-大天母,2024-12-16,9893
9945,潤泰新,107,0,107,元大-大天母,2024-12-16,9893
00919,群益台灣精選高息,100,14,86,元大-大天母,2024-12-16,9893
00679B,元大美債20年,82,1,81,元大-大天母,2024-12-16,9893
00924,復華S＆P500成長,80,0,80,元大-大天母,2024-12-16,9893
2886,兆豐金,73,1,72,元大-大天母,2024-12-16,9893
00680L,元大美債20正2,73,6,67,元大-大天母,2024-12-16,9893
00933B,國泰10Y+金融債,58,0,58,元大-大天母,2024-12-16,9893
00878,國泰永續高股息,59,1,58,元大-大天母,2024-12-16,9893
6245,立端,53,0,53,元大-大天母,2024-12-16,9893
4540,全球傳動,55,7,48,元大-大天母,2024-12-16,9893
00937B,群益ESG投等債20,46,1,45,元大-大天母,2024-12-16,9893
1785,光洋科,51,9,42,元大-大天母,2024-12-16,9893
8069,元太,41,0,41,元大-大天母,2024-12-16,9893
2317,鴻海,72,31,41,元大-大天母,2024-12-16,9893
0056,元大高股息,48,7,41,元大-大天母,2024-12-16,9893
3714,富采,71,32,39,元大-大天母,2024-12-16,9893
00673R,期元大S＆P原油反1,35,0,35,元大-大天母,2024-12-16,9893
3041,揚智,35,3,32,元大-大天母,2024-12-16,9893
00953B,群益優選非投等債,31,0,31,元大-大天母,2024-12-16,9893
1903,士紙,30,0,30,元大-大天母,2024-12-16,9893
3060,銘異,30,0,30,元大-大天母,2024-12-16,9893
3211,順達,43,16,27,元大-大天母,2024-12-16,9893
00751B,元大AAA至A公司債,25,0,25,元大-大天母,2024-12-16,9893
6533,晶心科,25,0,25,元大-大天母,2024-12-16,9893
00940,元大台灣價值高息,26,1,25,元大-大天母,2024-12-16,9893
2486,一詮,24,0,24,元大-大天母,2024-12-16,9893
00887,永豐中國科技50大,21,0,21,元大-大天母,2024-12-16,9893
2646,星宇航空,20,0,20,元大-大天母,2024-12-16,9893
6148,驊宏資,20,0,20,元大-大天母,2024-12-16,9893
6139,亞翔,19,0,19,元大-大天母,2024-12-16,9893
9105,泰金寶-DR,20,1,19,元大-大天母,2024-12-16,9893
2449,京元電子,20,2,18,元大-大天母,2024-12-16,9893
8437,大地-KY,17,0,17,元大-大天母,2024-12-16,9893
2609,陽明,44,27,17,元大-大天母,2024-12-16,9893
2313,華通,31,14,17,元大-大天母,2024-12-16,9893
3443,創意,19,3,16,元大-大天母,2024-12-16,9893
2312,金寶,18,3,15,元大-大天母,2024-12-16,9893
6239,力成,15,0,15,元大-大天母,2024-12-16,9893
6558,興能高,45,30,15,元大-大天母,2024-12-16,9893
6855,數泓科,14,0,14,元大-大天母,2024-12-16,9893
2615,萬海,15,2,13,元大-大天母,2024-12-16,9893
2723,美食-KY,13,0,13,元大-大天母,2024-12-16,9893
00631L,元大台灣50正2,14,1,13,元大-大天母,2024-12-16,9893
2618,長榮航,18,7,11,元大-大天母,2024-12-16,9893
2472,立隆電,11,0,11,元大-大天母,2024-12-16,9893
4755,三福化,11,0,11,元大-大天母,2024-12-16,9893
6161,捷波,11,0,11,元大-大天母,2024-12-16,9893
00637L,元大滬深300正2,808,3,805,元大-大天母,2024-12-17,9893
00680L,元大美債20正2,288,2,286,元大-大天母,2024-12-17,9893
2618,長榮航,248,19,229,元大-大天母,2024-12-17,9893
2610,華航,216,35,181,元大-大天母,2024-12-17,9893
00918,大華優利高填息30,124,4,120,元大-大天母,2024-12-17,9893
1536,和大,154,39,115,元大-大天母,2024-12-17,9893
2382,廣達,111,1,110,元大-大天母,2024-12-17,9893
00937B,群益ESG投等債20,107,0,107,元大-大天母,2024-12-17,9893
1605,華新,110,5,105,元大-大天母,2024-12-17,9893
00909,國泰數位支付服務,100,0,100,元大-大天母,2024-12-17,9893
00671R,富邦NASDAQ反1,100,0,100,元大-大天母,2024-12-17,9893
5439,高技,100,5,95,元大-大天母,2024-12-17,9893
0056,元大高股息,101,8,93,元大-大天母,2024-12-17,9893
00915,凱基優選高股息30,97,8,89,元大-大天母,2024-12-17,9893
2303,聯電,206,121,85,元大-大天母,2024-12-17,9893
3017,奇鋐,76,6,70,元大-大天母,2024-12-17,9893
2409,友達,58,0,58,元大-大天母,2024-12-17,9893
00945B,凱基美國非投等債,57,0,57,元大-大天母,2024-12-17,9893
4306,炎洲,55,0,55,元大-大天母,2024-12-17,9893
6223,旺矽,69,21,48,元大-大天母,2024-12-17,9893
5519,隆大,47,0,47,元大-大天母,2024-12-17,9893
2892,第一金,40,2,38,元大-大天母,2024-12-17,9893
2883,凱基金,45,7,38,元大-大天母,2024-12-17,9893
2889,國票金,36,1,35,元大-大天母,2024-12-17,9893
00764B,群益25年美債,35,0,35,元大-大天母,2024-12-17,9893
00713,元大台灣高息低波,33,1,32,元大-大天母,2024-12-17,9893
2337,旺宏,30,0,30,元大-大天母,2024-12-17,9893
00753L,中信中國50正2,30,0,30,元大-大天母,2024-12-17,9893
6962,ITH-KY,49,21,28,元大-大天母,2024-12-17,9893
2317,鴻海,57,29,28,元大-大天母,2024-12-17,9893
1301,台塑,26,0,26,元大-大天母,2024-12-17,9893
2609,陽明,33,9,24,元大-大天母,2024-12-17,9893
2885,元大金,31,9,22,元大-大天母,2024-12-17,9893
00948B,中信優息投資級債,21,0,21,元大-大天母,2024-12-17,9893
00922,國泰台灣領袖50,26,5,21,元大-大天母,2024-12-17,9893
9933,中鼎,21,0,21,元大-大天母,2024-12-17,9893
2474,可成,18,0,18,元大-大天母,2024-12-17,9893
00679B,元大美債20年,18,0,18,元大-大天母,2024-12-17,9893
2324,仁寶,18,0,18,元大-大天母,2024-12-17,9893
6104,創惟,18,0,18,元大-大天母,2024-12-17,9893
2834,臺企銀,20,2,18,元大-大天母,2024-12-17,9893
1409,新纖,17,0,17,元大-大天母,2024-12-17,9893
6191,精成科,17,0,17,元大-大天母,2024-12-17,9893
00720B,元大投資級公司債,17,0,17,元大-大天母,2024-12-17,9893
00878,國泰永續高股息,22,5,17,元大-大天母,2024-12-17,9893
2881,富邦金,16,0,16,元大-大天母,2024-12-17,9893
2002,中鋼,17,2,15,元大-大天母,2024-12-17,9893
6138,茂達,16,1,15,元大-大天母,2024-12-17,9893
2426,鼎元,20,5,15,元大-大天母,2024-12-17,9893
8042,金山電,33,18,15,元大-大天母,2024-12-17,9893
2887,台新金,904,8,896,元大-大天母,2024-12-18,9893
5243,乙盛-KY,242,24,218,元大-大天母,2024-12-18,9893
00679B,元大美債20年,202,11,191,元大-大天母,2024-12-18,9893
2498,宏達電,120,1,119,元大-大天母,2024-12-18,9893
1101,台泥,100,0,100,元大-大天母,2024-12-18,9893
00918,大華優利高填息30,104,10,94,元大-大天母,2024-12-18,9893
2489,瑞軒,81,0,81,元大-大天母,2024-12-18,9893
00665L,富邦�琤肭磪囓�2,76,10,66,元大-大天母,2024-12-18,9893
4576,大銀微系統,65,7,58,元大-大天母,2024-12-18,9893
00937B,群益ESG投等債20,60,5,55,元大-大天母,2024-12-18,9893
2348,海悅,52,2,50,元大-大天母,2024-12-18,9893
2449,京元電子,58,12,46,元大-大天母,2024-12-18,9893
00922,國泰台灣領袖50,42,0,42,元大-大天母,2024-12-18,9893
00688L,國泰20年美債正2,37,0,37,元大-大天母,2024-12-18,9893
2312,金寶,44,8,36,元大-大天母,2024-12-18,9893
2883,凱基金,33,1,32,元大-大天母,2024-12-18,9893
00933B,國泰10Y+金融債,30,0,30,元大-大天母,2024-12-18,9893
6962,ITH-KY,61,34,27,元大-大天母,2024-12-18,9893
2472,立隆電,21,0,21,元大-大天母,2024-12-18,9893
6104,創惟,21,1,20,元大-大天母,2024-12-18,9893
4974,亞泰,27,7,20,元大-大天母,2024-12-18,9893
5880,合庫金,17,0,17,元大-大天母,2024-12-18,9893
3017,奇鋐,25,8,17,元大-大天母,2024-12-18,9893
6168,宏齊,16,0,16,元大-大天母,2024-12-18,9893
3490,單井,15,0,15,元大-大天母,2024-12-18,9893
00632R,元大台灣50反1,15,0,15,元大-大天母,2024-12-18,9893
00713,元大台灣高息低波,14,0,14,元大-大天母,2024-12-18,9893
2886,兆豐金,14,1,13,元大-大天母,2024-12-18,9893
00712,復華富時不動產,13,0,13,元大-大天母,2024-12-18,9893
8249,菱光,37,24,13,元大-大天母,2024-12-18,9893
2354,鴻準,47,34,13,元大-大天母,2024-12-18,9893
2303,聯電,238,225,13,元大-大天母,2024-12-18,9893
3013,晟銘電,33,20,13,元大-大天母,2024-12-18,9893
6451,訊芯-KY,15,2,13,元大-大天母,2024-12-18,9893
2610,華航,32,19,13,元大-大天母,2024-12-18,9893
6139,亞翔,12,1,11,元大-大天母,2024-12-18,9893
2881,富邦金,11,0,11,元大-大天母,2024-12-18,9893
2331,精英,11,0,11,元大-大天母,2024-12-18,9893
1303,南亞,11,0,11,元大-大天母,2024-12-18,9893
9105,泰金寶-DR,33,23,10,元大-大天母,2024-12-18,9893
00715L,期街口布蘭特正2,10,0,10,元大-大天母,2024-12-18,9893
5534,長虹,10,0,10,元大-大天母,2024-12-18,9893
4953,緯軟,10,0,10,元大-大天母,2024-12-18,9893
3056,富華新,10,0,10,元大-大天母,2024-12-18,9893
2801,彰銀,10,0,10,元大-大天母,2024-12-18,9893
3029,零壹,36,26,10,元大-大天母,2024-12-18,9893
2891,中信金,9,0,9,元大-大天母,2024-12-18,9893
2723,美食-KY,9,0,9,元大-大天母,2024-12-18,9893
2368,金像電,15,6,9,元大-大天母,2024-12-18,9893
3515,華擎,9,0,9,元大-大天母,2024-12-18,9893
00937B,群益ESG投等債20,445,224,221,元大-大天母,2024-12-19,9893
00680L,元大美債20正2,197,10,187,元大-大天母,2024-12-19,9893
6962,ITH-KY,170,16,154,元大-大天母,2024-12-19,9893
2383,台光電,140,5,135,元大-大天母,2024-12-19,9893
2303,聯電,231,100,131,元大-大天母,2024-12-19,9893
00632R,元大台灣50反1,132,20,112,元大-大天母,2024-12-19,9893
3714,富采,190,89,101,元大-大天母,2024-12-19,9893
2883,凱基金,104,5,99,元大-大天母,2024-12-19,9893
2887,台新金,84,1,83,元大-大天母,2024-12-19,9893
6188,廣明,97,14,83,元大-大天母,2024-12-19,9893
00918,大華優利高填息30,75,0,75,元大-大天母,2024-12-19,9893
2006,東和鋼鐵,74,1,73,元大-大天母,2024-12-19,9893
2882,國泰金,78,5,73,元大-大天母,2024-12-19,9893
2417,圓剛,79,11,68,元大-大天母,2024-12-19,9893
00948B,中信優息投資級債,60,0,60,元大-大天母,2024-12-19,9893
4991,環宇-KY,93,45,48,元大-大天母,2024-12-19,9893
1409,新纖,45,0,45,元大-大天母,2024-12-19,9893
00919,群益台灣精選高息,121,78,43,元大-大天母,2024-12-19,9893
2317,鴻海,53,12,41,元大-大天母,2024-12-19,9893
4931,新盛力,89,48,41,元大-大天母,2024-12-19,9893
2031,新光鋼,40,0,40,元大-大天母,2024-12-19,9893
00715L,期街口布蘭特正2,34,0,34,元大-大天母,2024-12-19,9893
0056,元大高股息,34,0,34,元大-大天母,2024-12-19,9893
9904,寶成,34,1,33,元大-大天母,2024-12-19,9893
00959B,大華投等美債15Y+,31,0,31,元大-大天母,2024-12-19,9893
00931B,統一美債20年,31,0,31,元大-大天母,2024-12-19,9893
5880,合庫金,41,12,29,元大-大天母,2024-12-19,9893
00751B,元大AAA至A公司債,25,0,25,元大-大天母,2024-12-19,9893
00965,元大航太防衛科技,37,12,25,元大-大天母,2024-12-19,9893
00878,國泰永續高股息,79,54,25,元大-大天母,2024-12-19,9893
00687B,國泰20年美債,41,17,24,元大-大天母,2024-12-19,9893
006208,富邦台50,26,4,22,元大-大天母,2024-12-19,9893
1101,台泥,22,0,22,元大-大天母,2024-12-19,9893
00926,凱基全球菁英55,25,3,22,元大-大天母,2024-12-19,9893
00650L,復華香港正2,20,0,20,元大-大天母,2024-12-19,9893
2337,旺宏,20,0,20,元大-大天母,2024-12-19,9893
1785,光洋科,20,0,20,元大-大天母,2024-12-19,9893
3556,禾瑞亞,19,0,19,元大-大天母,2024-12-19,9893
00712,復華富時不動產,27,8,19,元大-大天母,2024-12-19,9893
2845,遠東銀,20,1,19,元大-大天母,2024-12-19,9893
1808,潤隆,17,0,17,元大-大天母,2024-12-19,9893
2618,長榮航,22,6,16,元大-大天母,2024-12-19,9893
6116,彩晶,20,4,16,元大-大天母,2024-12-19,9893
9958,世紀鋼,20,4,16,元大-大天母,2024-12-19,9893
00922,國泰台灣領袖50,15,0,15,元大-大天母,2024-12-19,9893
2736,富野,15,0,15,元大-大天母,2024-12-19,9893
2881,富邦金,18,3,15,元大-大天母,2024-12-19,9893
2606,裕民,14,0,14,元大-大天母,2024-12-19,9893
3231,緯創,16,3,13,元大-大天母,2024-12-19,9893
4737,華廣,13,0,13,元大-大天母,2024-12-19,9893
