Ticker,Name,buy,sell,diff,Branch,Date,Branch_Code
00680L,元大美債20正2,400,0,400,元大-台南,2023-01-03,9896
3481,群創,206,15,191,元大-台南,2023-01-03,9896
00830,國泰費城半導體,113,0,113,元大-台南,2023-01-03,9896
00632R,元大台灣50反1,174,65,109,元大-台南,2023-01-03,9896
3454,晶睿,95,11,84,元大-台南,2023-01-03,9896
5009,榮剛,67,4,63,元大-台南,2023-01-03,9896
2603,長榮,68,9,59,元大-台南,2023-01-03,9896
4129,聯合,57,0,57,元大-台南,2023-01-03,9896
00673R,期元大S＆P原油反1,41,0,41,元大-台南,2023-01-03,9896
3290,東浦,40,0,40,元大-台南,2023-01-03,9896
1710,東聯,50,19,31,元大-台南,2023-01-03,9896
2618,長榮航,46,19,27,元大-台南,2023-01-03,9896
1605,華新,51,26,25,元大-台南,2023-01-03,9896
00679B,元大美債20年,25,0,25,元大-台南,2023-01-03,9896
00904,新光臺灣半導體30,31,6,25,元大-台南,2023-01-03,9896
3515,華擎,26,8,18,元大-台南,2023-01-03,9896
2886,兆豐金,24,7,17,元大-台南,2023-01-03,9896
2615,萬海,19,4,15,元大-台南,2023-01-03,9896
2614,東森,15,0,15,元大-台南,2023-01-03,9896
00878,國泰永續高股息,22,8,14,元大-台南,2023-01-03,9896
2891,中信金,15,1,14,元大-台南,2023-01-03,9896
00712,復華富時不動產,12,0,12,元大-台南,2023-01-03,9896
1440,南紡,11,0,11,元大-台南,2023-01-03,9896
2612,中航,11,0,11,元大-台南,2023-01-03,9896
2736,富野,11,0,11,元大-台南,2023-01-03,9896
1529,樂事綠能,11,0,11,元大-台南,2023-01-03,9896
1319,東陽,26,15,11,元大-台南,2023-01-03,9896
9802,鈺齊-KY,17,6,11,元大-台南,2023-01-03,9896
6202,盛群,10,0,10,元大-台南,2023-01-03,9896
2105,正新,10,0,10,元大-台南,2023-01-03,9896
4114,健喬,56,46,10,元大-台南,2023-01-03,9896
1316,上曜,10,0,10,元大-台南,2023-01-03,9896
1711,永光,10,0,10,元大-台南,2023-01-03,9896
6244,茂迪,14,4,10,元大-台南,2023-01-03,9896
2732,六角,13,3,10,元大-台南,2023-01-03,9896
8028,昇陽半導體,11,2,9,元大-台南,2023-01-03,9896
6235,華孚,19,10,9,元大-台南,2023-01-03,9896
3014,聯陽,10,1,9,元大-台南,2023-01-03,9896
2352,佳世達,10,1,9,元大-台南,2023-01-03,9896
2609,陽明,24,15,9,元大-台南,2023-01-03,9896
6024,群益期,8,0,8,元大-台南,2023-01-03,9896
1210,大成,10,2,8,元大-台南,2023-01-03,9896
2388,威盛,11,4,7,元大-台南,2023-01-03,9896
1752,南光,27,20,7,元大-台南,2023-01-03,9896
4171,瑞基,26,19,7,元大-台南,2023-01-03,9896
00893,國泰智能電動車,17,11,6,元大-台南,2023-01-03,9896
2892,第一金,6,0,6,元大-台南,2023-01-03,9896
6278,台表科,6,0,6,元大-台南,2023-01-03,9896
4104,佳醫,6,0,6,元大-台南,2023-01-03,9896
2457,飛宏,6,0,6,元大-台南,2023-01-03,9896
2633,台灣高鐵,92,0,92,元大-台南,2023-01-04,9896
0056,元大高股息,78,7,71,元大-台南,2023-01-04,9896
00676R,富邦臺灣加權反1,53,0,53,元大-台南,2023-01-04,9896
3290,東浦,50,0,50,元大-台南,2023-01-04,9896
6235,華孚,101,54,47,元大-台南,2023-01-04,9896
00632R,元大台灣50反1,108,65,43,元大-台南,2023-01-04,9896
3171,炎洲流通,40,0,40,元大-台南,2023-01-04,9896
2317,鴻海,43,4,39,元大-台南,2023-01-04,9896
2465,麗臺,78,39,39,元大-台南,2023-01-04,9896
00902,中信電池及儲能,35,0,35,元大-台南,2023-01-04,9896
2601,益航,31,1,30,元大-台南,2023-01-04,9896
2884,玉山金,23,0,23,元大-台南,2023-01-04,9896
00642U,期元大S＆P石油,22,0,22,元大-台南,2023-01-04,9896
00773B,中信優先金融債,30,8,22,元大-台南,2023-01-04,9896
1440,南紡,21,0,21,元大-台南,2023-01-04,9896
4162,智擎,36,16,20,元大-台南,2023-01-04,9896
3037,欣興,29,11,18,元大-台南,2023-01-04,9896
8046,南電,31,14,17,元大-台南,2023-01-04,9896
2606,裕民,17,0,17,元大-台南,2023-01-04,9896
3532,台勝科,17,0,17,元大-台南,2023-01-04,9896
1795,美時,18,2,16,元大-台南,2023-01-04,9896
2615,萬海,24,8,16,元大-台南,2023-01-04,9896
1417,嘉裕,45,32,13,元大-台南,2023-01-04,9896
2637,慧洋-KY,15,3,12,元大-台南,2023-01-04,9896
1513,中興電,41,30,11,元大-台南,2023-01-04,9896
1304,台聚,10,0,10,元大-台南,2023-01-04,9896
2211,長榮鋼,10,0,10,元大-台南,2023-01-04,9896
2393,億光,10,0,10,元大-台南,2023-01-04,9896
00680L,元大美債20正2,11,2,9,元大-台南,2023-01-04,9896
8054,安國,10,1,9,元大-台南,2023-01-04,9896
1736,喬山,12,3,9,元大-台南,2023-01-04,9896
3081,聯亞,8,0,8,元大-台南,2023-01-04,9896
00893,國泰智能電動車,7,0,7,元大-台南,2023-01-04,9896
00688L,國泰20年美債正2,7,0,7,元大-台南,2023-01-04,9896
3665,貿聯-KY,6,0,6,元大-台南,2023-01-04,9896
8028,昇陽半導體,6,0,6,元大-台南,2023-01-04,9896
3272,東碩,12,6,6,元大-台南,2023-01-04,9896
00651R,復華香港反1,6,0,6,元大-台南,2023-01-04,9896
3454,晶睿,9,3,6,元大-台南,2023-01-04,9896
6111,大宇資,16,10,6,元大-台南,2023-01-04,9896
3704,合勤控,38,33,5,元大-台南,2023-01-04,9896
00728,第一金工業30,5,0,5,元大-台南,2023-01-04,9896
2002,中鋼,5,0,5,元大-台南,2023-01-04,9896
2729,瓦城,5,0,5,元大-台南,2023-01-04,9896
2368,金像電,5,0,5,元大-台南,2023-01-04,9896
1616,億泰,5,0,5,元大-台南,2023-01-04,9896
2497,怡利電,7,2,5,元大-台南,2023-01-04,9896
2612,中航,5,0,5,元大-台南,2023-01-04,9896
4153,鈺緯,7,2,5,元大-台南,2023-01-04,9896
3051,力特,5,0,5,元大-台南,2023-01-04,9896
00763U,期街口道瓊銅,100,0,100,元大-台南,2023-01-05,9896
00830,國泰費城半導體,101,7,94,元大-台南,2023-01-05,9896
00715L,期街口布蘭特正2,54,0,54,元大-台南,2023-01-05,9896
4960,誠美材,50,0,50,元大-台南,2023-01-05,9896
00692,富邦公司治理,45,0,45,元大-台南,2023-01-05,9896
5009,榮剛,56,14,42,元大-台南,2023-01-05,9896
2465,麗臺,60,23,37,元大-台南,2023-01-05,9896
2915,潤泰全,30,0,30,元大-台南,2023-01-05,9896
0056,元大高股息,39,10,29,元大-台南,2023-01-05,9896
1605,華新,61,35,26,元大-台南,2023-01-05,9896
1504,東元,22,1,21,元大-台南,2023-01-05,9896
3704,合勤控,40,19,21,元大-台南,2023-01-05,9896
5351,鈺創,30,9,21,元大-台南,2023-01-05,9896
1752,南光,42,21,21,元大-台南,2023-01-05,9896
3272,東碩,44,25,19,元大-台南,2023-01-05,9896
6288,聯嘉,20,1,19,元大-台南,2023-01-05,9896
3047,訊舟,20,2,18,元大-台南,2023-01-05,9896
2317,鴻海,54,36,18,元大-台南,2023-01-05,9896
1319,東陽,19,2,17,元大-台南,2023-01-05,9896
00878,國泰永續高股息,18,2,16,元大-台南,2023-01-05,9896
9103,美德醫療-DR,15,0,15,元大-台南,2023-01-05,9896
1513,中興電,61,46,15,元大-台南,2023-01-05,9896
00670L,富邦NASDAQ正2,14,0,14,元大-台南,2023-01-05,9896
2887,台新金,16,3,13,元大-台南,2023-01-05,9896
6235,華孚,13,1,12,元大-台南,2023-01-05,9896
3081,聯亞,11,0,11,元大-台南,2023-01-05,9896
8097,常珵,10,0,10,元大-台南,2023-01-05,9896
3209,全科,10,0,10,元大-台南,2023-01-05,9896
6005,群益證,10,0,10,元大-台南,2023-01-05,9896
00738U,期元大道瓊白銀,10,0,10,元大-台南,2023-01-05,9896
2498,宏達電,33,24,9,元大-台南,2023-01-05,9896
3380,明泰,9,0,9,元大-台南,2023-01-05,9896
4572,駐龍,8,0,8,元大-台南,2023-01-05,9896
5905,南仁湖,24,16,8,元大-台南,2023-01-05,9896
2884,玉山金,9,1,8,元大-台南,2023-01-05,9896
2313,華通,15,7,8,元大-台南,2023-01-05,9896
3037,欣興,22,15,7,元大-台南,2023-01-05,9896
4915,致伸,13,6,7,元大-台南,2023-01-05,9896
3218,大學光,15,8,7,元大-台南,2023-01-05,9896
2408,南亞科,9,2,7,元大-台南,2023-01-05,9896
9958,世紀鋼,7,0,7,元大-台南,2023-01-05,9896
3630,新鉅科,8,1,7,元大-台南,2023-01-05,9896
1760,寶齡富錦,19,12,7,元大-台南,2023-01-05,9896
3033,威健,7,0,7,元大-台南,2023-01-05,9896
6443,元晶,7,1,6,元大-台南,2023-01-05,9896
8916,光隆,6,0,6,元大-台南,2023-01-05,9896
2338,光罩,8,2,6,元大-台南,2023-01-05,9896
8150,南茂,6,0,6,元大-台南,2023-01-05,9896
6274,台燿,17,11,6,元大-台南,2023-01-05,9896
4904,遠傳,6,0,6,元大-台南,2023-01-05,9896
00885,富邦越南,212,1,211,元大-台南,2023-01-06,9896
00891,中信關鍵半導體,202,3,199,元大-台南,2023-01-06,9896
00632R,元大台灣50反1,171,20,151,元大-台南,2023-01-06,9896
1440,南紡,108,0,108,元大-台南,2023-01-06,9896
00830,國泰費城半導體,106,0,106,元大-台南,2023-01-06,9896
3702,大聯大,70,0,70,元大-台南,2023-01-06,9896
00642U,期元大S＆P石油,61,0,61,元大-台南,2023-01-06,9896
00720B,元大投資級公司債,48,1,47,元大-台南,2023-01-06,9896
8064,東捷,45,0,45,元大-台南,2023-01-06,9896
1701,中化,37,1,36,元大-台南,2023-01-06,9896
2884,玉山金,31,1,30,元大-台南,2023-01-06,9896
5309,系統電,31,1,30,元大-台南,2023-01-06,9896
00669R,國泰美國道瓊反1,30,0,30,元大-台南,2023-01-06,9896
3027,盛達,37,13,24,元大-台南,2023-01-06,9896
6116,彩晶,24,0,24,元大-台南,2023-01-06,9896
00878,國泰永續高股息,34,11,23,元大-台南,2023-01-06,9896
5607,遠雄港,23,0,23,元大-台南,2023-01-06,9896
1609,大亞,24,5,19,元大-台南,2023-01-06,9896
00895,富邦未來車,20,1,19,元大-台南,2023-01-06,9896
1467,南緯,20,2,18,元大-台南,2023-01-06,9896
2498,宏達電,21,5,16,元大-台南,2023-01-06,9896
6441,廣錠,16,0,16,元大-台南,2023-01-06,9896
2891,中信金,51,37,14,元大-台南,2023-01-06,9896
2206,三陽工業,12,0,12,元大-台南,2023-01-06,9896
1789,神隆,12,0,12,元大-台南,2023-01-06,9896
6215,和椿,11,0,11,元大-台南,2023-01-06,9896
2308,台達電,11,0,11,元大-台南,2023-01-06,9896
4114,健喬,33,23,10,元大-台南,2023-01-06,9896
6180,橘子,13,3,10,元大-台南,2023-01-06,9896
2462,良得電,10,0,10,元大-台南,2023-01-06,9896
2836,高雄銀,10,0,10,元大-台南,2023-01-06,9896
6288,聯嘉,10,0,10,元大-台南,2023-01-06,9896
3290,東浦,10,0,10,元大-台南,2023-01-06,9896
1718,中纖,11,1,10,元大-台南,2023-01-06,9896
00900,富邦特選高股息30,12,2,10,元大-台南,2023-01-06,9896
00640L,富邦日本正2,10,0,10,元大-台南,2023-01-06,9896
00916,國泰全球品牌50,10,0,10,元大-台南,2023-01-06,9896
1795,美時,13,4,9,元大-台南,2023-01-06,9896
5258,虹堡,13,4,9,元大-台南,2023-01-06,9896
00680L,元大美債20正2,12,4,8,元大-台南,2023-01-06,9896
4157,太景*-KY,8,0,8,元大-台南,2023-01-06,9896
3022,威強電,9,1,8,元大-台南,2023-01-06,9896
3710,連展投控,10,2,8,元大-台南,2023-01-06,9896
00679B,元大美債20年,7,0,7,元大-台南,2023-01-06,9896
8114,振樺電,7,0,7,元大-台南,2023-01-06,9896
5608,四維航,6,0,6,元大-台南,2023-01-06,9896
2352,佳世達,6,0,6,元大-台南,2023-01-06,9896
2527,宏璟,6,0,6,元大-台南,2023-01-06,9896
8046,南電,9,3,6,元大-台南,2023-01-06,9896
8033,雷虎,7,1,6,元大-台南,2023-01-06,9896
2867,三商壽,506,0,506,元大-台南,2023-01-09,9896
00676R,富邦臺灣加權反1,215,5,210,元大-台南,2023-01-09,9896
5880,合庫金,180,13,167,元大-台南,2023-01-09,9896
00830,國泰費城半導體,68,13,55,元大-台南,2023-01-09,9896
00885,富邦越南,50,4,46,元大-台南,2023-01-09,9896
1789,神隆,32,0,32,元大-台南,2023-01-09,9896
2409,友達,32,0,32,元大-台南,2023-01-09,9896
2812,台中銀,30,0,30,元大-台南,2023-01-09,9896
2317,鴻海,32,7,25,元大-台南,2023-01-09,9896
00715L,期街口布蘭特正2,23,0,23,元大-台南,2023-01-09,9896
00642U,期元大S＆P石油,52,30,22,元大-台南,2023-01-09,9896
1752,南光,60,38,22,元大-台南,2023-01-09,9896
4167,松瑞藥,24,4,20,元大-台南,2023-01-09,9896
2609,陽明,22,3,19,元大-台南,2023-01-09,9896
6770,力積電,32,13,19,元大-台南,2023-01-09,9896
4171,瑞基,19,0,19,元大-台南,2023-01-09,9896
1513,中興電,81,63,18,元大-台南,2023-01-09,9896
1722,台肥,16,0,16,元大-台南,2023-01-09,9896
1605,華新,79,63,16,元大-台南,2023-01-09,9896
2033,佳大,15,0,15,元大-台南,2023-01-09,9896
00881,國泰台灣5G+,20,7,13,元大-台南,2023-01-09,9896
8069,元太,48,36,12,元大-台南,2023-01-09,9896
1440,南紡,12,0,12,元大-台南,2023-01-09,9896
8358,金居,43,32,11,元大-台南,2023-01-09,9896
1475,業旺,10,0,10,元大-台南,2023-01-09,9896
4755,三福化,10,0,10,元大-台南,2023-01-09,9896
00680L,元大美債20正2,10,0,10,元大-台南,2023-01-09,9896
2836,高雄銀,10,0,10,元大-台南,2023-01-09,9896
2441,超豐,10,0,10,元大-台南,2023-01-09,9896
4533,協易機,10,0,10,元大-台南,2023-01-09,9896
3689,湧德,9,0,9,元大-台南,2023-01-09,9896
8016,矽創,10,1,9,元大-台南,2023-01-09,9896
2603,長榮,19,11,8,元大-台南,2023-01-09,9896
5321,美而快,23,15,8,元大-台南,2023-01-09,9896
8070,長華*,8,0,8,元大-台南,2023-01-09,9896
3686,達能,10,2,8,元大-台南,2023-01-09,9896
4961,天鈺,32,24,8,元大-台南,2023-01-09,9896
5258,虹堡,12,5,7,元大-台南,2023-01-09,9896
6283,淳安,7,0,7,元大-台南,2023-01-09,9896
6282,康舒,8,1,7,元大-台南,2023-01-09,9896
6196,帆宣,7,0,7,元大-台南,2023-01-09,9896
1232,大統益,6,0,6,元大-台南,2023-01-09,9896
3710,連展投控,6,0,6,元大-台南,2023-01-09,9896
2465,麗臺,7,1,6,元大-台南,2023-01-09,9896
00724B,群益投資級金融債,5,0,5,元大-台南,2023-01-09,9896
3558,神準,9,4,5,元大-台南,2023-01-09,9896
1457,宜進,5,0,5,元大-台南,2023-01-09,9896
3576,聯合再生,5,0,5,元大-台南,2023-01-09,9896
4989,榮科,5,0,5,元大-台南,2023-01-09,9896
3508,位速,5,0,5,元大-台南,2023-01-09,9896
00891,中信關鍵半導體,210,1,209,元大-台南,2023-01-10,9896
00632R,元大台灣50反1,206,71,135,元大-台南,2023-01-10,9896
1795,美時,44,3,41,元大-台南,2023-01-10,9896
6612,奈米醫材,35,0,35,元大-台南,2023-01-10,9896
8105,凌巨,42,7,35,元大-台南,2023-01-10,9896
3027,盛達,46,12,34,元大-台南,2023-01-10,9896
8064,東捷,30,0,30,元大-台南,2023-01-10,9896
1513,中興電,39,16,23,元大-台南,2023-01-10,9896
00882,中信中國高股息,22,0,22,元大-台南,2023-01-10,9896
00642U,期元大S＆P石油,21,0,21,元大-台南,2023-01-10,9896
4532,瑞智,20,0,20,元大-台南,2023-01-10,9896
5880,合庫金,20,1,19,元大-台南,2023-01-10,9896
1708,東鹼,18,0,18,元大-台南,2023-01-10,9896
3710,連展投控,16,0,16,元大-台南,2023-01-10,9896
3454,晶睿,24,8,16,元大-台南,2023-01-10,9896
1736,喬山,21,6,15,元大-台南,2023-01-10,9896
3290,東浦,15,1,14,元大-台南,2023-01-10,9896
5425,台半,65,51,14,元大-台南,2023-01-10,9896
00893,國泰智能電動車,12,0,12,元大-台南,2023-01-10,9896
5309,系統電,12,0,12,元大-台南,2023-01-10,9896
2353,宏��,13,1,12,元大-台南,2023-01-10,9896
8028,昇陽半導體,23,12,11,元大-台南,2023-01-10,9896
2465,麗臺,12,1,11,元大-台南,2023-01-10,9896
4743,合一,24,14,10,元大-台南,2023-01-10,9896
1734,杏輝,10,0,10,元大-台南,2023-01-10,9896
00885,富邦越南,20,10,10,元大-台南,2023-01-10,9896
00892,富邦台灣半導體,16,7,9,元大-台南,2023-01-10,9896
00676R,富邦臺灣加權反1,9,0,9,元大-台南,2023-01-10,9896
2323,中環,10,1,9,元大-台南,2023-01-10,9896
9951,皇田,9,0,9,元大-台南,2023-01-10,9896
4114,健喬,12,3,9,元大-台南,2023-01-10,9896
3714,富采,28,20,8,元大-台南,2023-01-10,9896
6625,必應,8,0,8,元大-台南,2023-01-10,9896
6129,普誠,8,0,8,元大-台南,2023-01-10,9896
2313,華通,15,8,7,元大-台南,2023-01-10,9896
1539,巨庭,7,0,7,元大-台南,2023-01-10,9896
2482,連宇,39,32,7,元大-台南,2023-01-10,9896
2888,新光金,7,0,7,元大-台南,2023-01-10,9896
4770,上品,7,0,7,元大-台南,2023-01-10,9896
2882,國泰金,11,4,7,元大-台南,2023-01-10,9896
3703,欣陸,6,0,6,元大-台南,2023-01-10,9896
2883,凱基金,6,0,6,元大-台南,2023-01-10,9896
6589,台康生技,7,1,6,元大-台南,2023-01-10,9896
5515,建國,6,0,6,元大-台南,2023-01-10,9896
8114,振樺電,6,0,6,元大-台南,2023-01-10,9896
6806,森崴能源,7,1,6,元大-台南,2023-01-10,9896
1503,士電,6,0,6,元大-台南,2023-01-10,9896
3163,波若威,6,0,6,元大-台南,2023-01-10,9896
2317,鴻海,21,16,5,元大-台南,2023-01-10,9896
8289,泰藝,5,0,5,元大-台南,2023-01-10,9896
2867,三商壽,500,1,499,元大-台南,2023-01-11,9896
5880,合庫金,107,3,104,元大-台南,2023-01-11,9896
2618,長榮航,99,37,62,元大-台南,2023-01-11,9896
00900,富邦特選高股息30,39,1,38,元大-台南,2023-01-11,9896
2887,台新金,32,0,32,元大-台南,2023-01-11,9896
3290,東浦,30,0,30,元大-台南,2023-01-11,9896
8050,廣積,26,2,24,元大-台南,2023-01-11,9896
2884,玉山金,16,0,16,元大-台南,2023-01-11,9896
2882,國泰金,20,4,16,元大-台南,2023-01-11,9896
6612,奈米醫材,15,0,15,元大-台南,2023-01-11,9896
3141,晶宏,14,0,14,元大-台南,2023-01-11,9896
2892,第一金,13,0,13,元大-台南,2023-01-11,9896
2404,漢唐,15,2,13,元大-台南,2023-01-11,9896
5425,台半,24,12,12,元大-台南,2023-01-11,9896
1529,樂事綠能,31,19,12,元大-台南,2023-01-11,9896
00635U,期元大S＆P黃金,10,0,10,元大-台南,2023-01-11,9896
1526,日馳,10,0,10,元大-台南,2023-01-11,9896
2344,華邦電,10,1,9,元大-台南,2023-01-11,9896
2881,富邦金,24,15,9,元大-台南,2023-01-11,9896
2313,華通,49,40,9,元大-台南,2023-01-11,9896
1718,中纖,8,0,8,元大-台南,2023-01-11,9896
8358,金居,12,4,8,元大-台南,2023-01-11,9896
4167,松瑞藥,10,2,8,元大-台南,2023-01-11,9896
00882,中信中國高股息,10,3,7,元大-台南,2023-01-11,9896
2880,華南金,7,0,7,元大-台南,2023-01-11,9896
1503,士電,7,0,7,元大-台南,2023-01-11,9896
2465,麗臺,104,97,7,元大-台南,2023-01-11,9896
00669R,國泰美國道瓊反1,11,4,7,元大-台南,2023-01-11,9896
8171,天宇,28,21,7,元大-台南,2023-01-11,9896
2317,鴻海,11,4,7,元大-台南,2023-01-11,9896
2201,裕隆,9,3,6,元大-台南,2023-01-11,9896
00772B,中信高評級公司債,6,0,6,元大-台南,2023-01-11,9896
3704,合勤控,49,43,6,元大-台南,2023-01-11,9896
6163,華電網,6,0,6,元大-台南,2023-01-11,9896
1605,華新,25,20,5,元大-台南,2023-01-11,9896
3515,華擎,6,1,5,元大-台南,2023-01-11,9896
6456,GIS-KY,5,0,5,元大-台南,2023-01-11,9896
1457,宜進,5,0,5,元大-台南,2023-01-11,9896
3710,連展投控,5,0,5,元大-台南,2023-01-11,9896
2342,茂矽,5,0,5,元大-台南,2023-01-11,9896
1417,嘉裕,5,0,5,元大-台南,2023-01-11,9896
1609,大亞,5,0,5,元大-台南,2023-01-11,9896
4417,金洲,5,0,5,元大-台南,2023-01-11,9896
1560,中砂,8,4,4,元大-台南,2023-01-11,9896
00724B,群益投資級金融債,4,0,4,元大-台南,2023-01-11,9896
4743,合一,6,2,4,元大-台南,2023-01-11,9896
9941,裕融,4,0,4,元大-台南,2023-01-11,9896
5251,天鉞電,4,0,4,元大-台南,2023-01-11,9896
4192,杏國,4,0,4,元大-台南,2023-01-11,9896
2890,永豐金,5,1,4,元大-台南,2023-01-11,9896
2603,長榮,265,3,262,元大-台南,2023-01-12,9896
2317,鴻海,116,4,112,元大-台南,2023-01-12,9896
00652,富邦印度,50,0,50,元大-台南,2023-01-12,9896
1304,台聚,30,0,30,元大-台南,2023-01-12,9896
00882,中信中國高股息,39,11,28,元大-台南,2023-01-12,9896
1605,華新,46,25,21,元大-台南,2023-01-12,9896
6188,廣明,22,1,21,元大-台南,2023-01-12,9896
00673R,期元大S＆P原油反1,30,10,20,元大-台南,2023-01-12,9896
9945,潤泰新,19,0,19,元大-台南,2023-01-12,9896
2888,新光金,21,4,17,元大-台南,2023-01-12,9896
6182,合晶,16,0,16,元大-台南,2023-01-12,9896
0056,元大高股息,19,4,15,元大-台南,2023-01-12,9896
6124,業強,15,0,15,元大-台南,2023-01-12,9896
4114,健喬,17,3,14,元大-台南,2023-01-12,9896
2609,陽明,14,0,14,元大-台南,2023-01-12,9896
2897,王道銀行,15,1,14,元大-台南,2023-01-12,9896
8926,台汽電,14,0,14,元大-台南,2023-01-12,9896
2009,第一銅,48,34,14,元大-台南,2023-01-12,9896
1513,中興電,34,21,13,元大-台南,2023-01-12,9896
2436,偉詮電,13,0,13,元大-台南,2023-01-12,9896
2342,茂矽,14,2,12,元大-台南,2023-01-12,9896
2610,華航,14,2,12,元大-台南,2023-01-12,9896
2308,台達電,11,0,11,元大-台南,2023-01-12,9896
6282,康舒,11,0,11,元大-台南,2023-01-12,9896
00631L,元大台灣50正2,11,0,11,元大-台南,2023-01-12,9896
00878,國泰永續高股息,23,13,10,元大-台南,2023-01-12,9896
2357,華碩,10,0,10,元大-台南,2023-01-12,9896
00740B,富邦全球投等債,10,0,10,元大-台南,2023-01-12,9896
2812,台中銀,10,0,10,元大-台南,2023-01-12,9896
3094,聯傑,10,0,10,元大-台南,2023-01-12,9896
00902,中信電池及儲能,10,0,10,元大-台南,2023-01-12,9896
2884,玉山金,10,1,9,元大-台南,2023-01-12,9896
2906,高林,9,0,9,元大-台南,2023-01-12,9896
2457,飛宏,13,4,9,元大-台南,2023-01-12,9896
1409,新纖,10,1,9,元大-台南,2023-01-12,9896
2465,麗臺,10,1,9,元大-台南,2023-01-12,9896
4743,合一,10,2,8,元大-台南,2023-01-12,9896
6245,立端,11,3,8,元大-台南,2023-01-12,9896
3037,欣興,29,22,7,元大-台南,2023-01-12,9896
3141,晶宏,10,3,7,元大-台南,2023-01-12,9896
1308,亞聚,9,2,7,元大-台南,2023-01-12,9896
6244,茂迪,14,7,7,元大-台南,2023-01-12,9896
2428,興勤,14,7,7,元大-台南,2023-01-12,9896
2352,佳世達,12,5,7,元大-台南,2023-01-12,9896
2892,第一金,7,1,6,元大-台南,2023-01-12,9896
5351,鈺創,6,0,6,元大-台南,2023-01-12,9896
00900,富邦特選高股息30,7,1,6,元大-台南,2023-01-12,9896
1475,業旺,6,0,6,元大-台南,2023-01-12,9896
2601,益航,6,0,6,元大-台南,2023-01-12,9896
1810,和成,6,0,6,元大-台南,2023-01-12,9896
00632R,元大台灣50反1,177,15,162,元大-台南,2023-01-13,9896
9945,潤泰新,71,21,50,元大-台南,2023-01-13,9896
2317,鴻海,49,2,47,元大-台南,2023-01-13,9896
00878,國泰永續高股息,50,10,40,元大-台南,2023-01-13,9896
2014,中鴻,44,7,37,元大-台南,2023-01-13,9896
3014,聯陽,20,0,20,元大-台南,2023-01-13,9896
9103,美德醫療-DR,20,0,20,元大-台南,2023-01-13,9896
5388,中磊,24,5,19,元大-台南,2023-01-13,9896
8050,廣積,18,3,15,元大-台南,2023-01-13,9896
1475,業旺,16,1,15,元大-台南,2023-01-13,9896
8064,東捷,15,0,15,元大-台南,2023-01-13,9896
00902,中信電池及儲能,13,0,13,元大-台南,2023-01-13,9896
1707,葡萄王,12,0,12,元大-台南,2023-01-13,9896
3703,欣陸,12,0,12,元大-台南,2023-01-13,9896
00676R,富邦臺灣加權反1,12,0,12,元大-台南,2023-01-13,9896
1101,台泥,71,59,12,元大-台南,2023-01-13,9896
3027,盛達,15,4,11,元大-台南,2023-01-13,9896
2312,金寶,11,0,11,元大-台南,2023-01-13,9896
2897,王道銀行,11,0,11,元大-台南,2023-01-13,9896
3059,華晶科,11,0,11,元大-台南,2023-01-13,9896
2498,宏達電,20,9,11,元大-台南,2023-01-13,9896
2367,燿華,10,0,10,元大-台南,2023-01-13,9896
00882,中信中國高股息,11,1,10,元大-台南,2023-01-13,9896
2609,陽明,14,4,10,元大-台南,2023-01-13,9896
8150,南茂,8,0,8,元大-台南,2023-01-13,9896
6245,立端,9,2,7,元大-台南,2023-01-13,9896
1466,聚隆,7,0,7,元大-台南,2023-01-13,9896
8114,振樺電,7,0,7,元大-台南,2023-01-13,9896
1720,生達,8,2,6,元大-台南,2023-01-13,9896
00921,兆豐龍頭等權重,6,0,6,元大-台南,2023-01-13,9896
00673R,期元大S＆P原油反1,6,0,6,元大-台南,2023-01-13,9896
5351,鈺創,6,0,6,元大-台南,2023-01-13,9896
1701,中化,7,1,6,元大-台南,2023-01-13,9896
3438,類比科,6,0,6,元大-台南,2023-01-13,9896
2892,第一金,6,0,6,元大-台南,2023-01-13,9896
2383,台光電,6,0,6,元大-台南,2023-01-13,9896
6752,叡揚,5,0,5,元大-台南,2023-01-13,9896
3707,漢磊,5,0,5,元大-台南,2023-01-13,9896
6788,華景電,7,2,5,元大-台南,2023-01-13,9896
3687,歐買尬,7,2,5,元大-台南,2023-01-13,9896
1784,訊聯,5,0,5,元大-台南,2023-01-13,9896
2358,廷鑫,22,17,5,元大-台南,2023-01-13,9896
4417,金洲,5,0,5,元大-台南,2023-01-13,9896
6235,華孚,6,1,5,元大-台南,2023-01-13,9896
2328,廣宇,10,5,5,元大-台南,2023-01-13,9896
6605,帝寶,5,0,5,元大-台南,2023-01-13,9896
5905,南仁湖,5,0,5,元大-台南,2023-01-13,9896
8171,天宇,5,0,5,元大-台南,2023-01-13,9896
6515,穎崴,5,0,5,元大-台南,2023-01-13,9896
6111,大宇資,4,0,4,元大-台南,2023-01-13,9896
00673R,期元大S＆P原油反1,280,0,280,元大-台南,2023-01-16,9896
2603,長榮,285,19,266,元大-台南,2023-01-16,9896
00720B,元大投資級公司債,178,0,178,元大-台南,2023-01-16,9896
2317,鴻海,157,1,156,元大-台南,2023-01-16,9896
00700,富邦�琤肭磪�,150,0,150,元大-台南,2023-01-16,9896
00637L,元大滬深300正2,101,8,93,元大-台南,2023-01-16,9896
00709,富邦歐洲,81,0,81,元大-台南,2023-01-16,9896
2457,飛宏,77,0,77,元大-台南,2023-01-16,9896
1512,瑞利,60,0,60,元大-台南,2023-01-16,9896
3702,大聯大,50,0,50,元大-台南,2023-01-16,9896
00878,國泰永續高股息,54,11,43,元大-台南,2023-01-16,9896
2891,中信金,52,20,32,元大-台南,2023-01-16,9896
2888,新光金,31,1,30,元大-台南,2023-01-16,9896
2367,燿華,21,1,20,元大-台南,2023-01-16,9896
00830,國泰費城半導體,30,10,20,元大-台南,2023-01-16,9896
1451,年興,20,0,20,元大-台南,2023-01-16,9896
2884,玉山金,18,0,18,元大-台南,2023-01-16,9896
3027,盛達,29,12,17,元大-台南,2023-01-16,9896
00669R,國泰美國道瓊反1,16,0,16,元大-台南,2023-01-16,9896
3231,緯創,16,1,15,元大-台南,2023-01-16,9896
2498,宏達電,17,3,14,元大-台南,2023-01-16,9896
2610,華航,16,2,14,元大-台南,2023-01-16,9896
2358,廷鑫,30,16,14,元大-台南,2023-01-16,9896
2609,陽明,25,12,13,元大-台南,2023-01-16,9896
3014,聯陽,12,0,12,元大-台南,2023-01-16,9896
00770,國泰北美科技,12,0,12,元大-台南,2023-01-16,9896
5009,榮剛,15,3,12,元大-台南,2023-01-16,9896
00916,國泰全球品牌50,11,0,11,元大-台南,2023-01-16,9896
0056,元大高股息,22,12,10,元大-台南,2023-01-16,9896
2882,國泰金,20,10,10,元大-台南,2023-01-16,9896
1795,美時,23,13,10,元大-台南,2023-01-16,9896
00631L,元大台灣50正2,11,2,9,元大-台南,2023-01-16,9896
00690,兆豐藍籌30,10,1,9,元大-台南,2023-01-16,9896
6215,和椿,9,0,9,元大-台南,2023-01-16,9896
2890,永豐金,9,1,8,元大-台南,2023-01-16,9896
1736,喬山,9,1,8,元大-台南,2023-01-16,9896
4157,太景*-KY,7,0,7,元大-台南,2023-01-16,9896
3037,欣興,16,10,6,元大-台南,2023-01-16,9896
3704,合勤控,7,1,6,元大-台南,2023-01-16,9896
5443,均豪,6,0,6,元大-台南,2023-01-16,9896
6589,台康生技,8,2,6,元大-台南,2023-01-16,9896
8440,綠電,6,0,6,元大-台南,2023-01-16,9896
00679B,元大美債20年,8,3,5,元大-台南,2023-01-16,9896
1752,南光,7,2,5,元大-台南,2023-01-16,9896
5475,德宏,5,0,5,元大-台南,2023-01-16,9896
2809,京城銀,5,0,5,元大-台南,2023-01-16,9896
00664R,國泰臺灣加權反1,5,0,5,元大-台南,2023-01-16,9896
4768,晶呈科技,5,0,5,元大-台南,2023-01-16,9896
2867,三商壽,5,0,5,元大-台南,2023-01-16,9896
6472,保瑞,5,0,5,元大-台南,2023-01-16,9896
2610,華航,100,3,97,元大-台南,2023-01-17,9896
2891,中信金,103,14,89,元大-台南,2023-01-17,9896
2358,廷鑫,62,0,62,元大-台南,2023-01-17,9896
3481,群創,65,8,57,元大-台南,2023-01-17,9896
2465,麗臺,94,39,55,元大-台南,2023-01-17,9896
2317,鴻海,57,3,54,元大-台南,2023-01-17,9896
00720B,元大投資級公司債,53,0,53,元大-台南,2023-01-17,9896
4960,誠美材,53,0,53,元大-台南,2023-01-17,9896
00673R,期元大S＆P原油反1,40,1,39,元大-台南,2023-01-17,9896
1451,年興,40,2,38,元大-台南,2023-01-17,9896
0050,元大台灣50,45,9,36,元大-台南,2023-01-17,9896
00634R,富邦上証反1,40,10,30,元大-台南,2023-01-17,9896
1752,南光,32,6,26,元大-台南,2023-01-17,9896
4111,濟生,26,0,26,元大-台南,2023-01-17,9896
2313,華通,21,2,19,元大-台南,2023-01-17,9896
00679B,元大美債20年,19,1,18,元大-台南,2023-01-17,9896
6190,萬泰科,18,0,18,元大-台南,2023-01-17,9896
00686R,群益臺灣加權反1,17,0,17,元大-台南,2023-01-17,9896
2884,玉山金,17,0,17,元大-台南,2023-01-17,9896
1219,福壽,18,3,15,元大-台南,2023-01-17,9896
1526,日馳,15,0,15,元大-台南,2023-01-17,9896
1101,台泥,38,23,15,元大-台南,2023-01-17,9896
5607,遠雄港,14,0,14,元大-台南,2023-01-17,9896
2002,中鋼,19,5,14,元大-台南,2023-01-17,9896
1471,首利,12,0,12,元大-台南,2023-01-17,9896
2201,裕隆,29,17,12,元大-台南,2023-01-17,9896
3037,欣興,14,3,11,元大-台南,2023-01-17,9896
6015,宏遠證,10,0,10,元大-台南,2023-01-17,9896
2457,飛宏,10,0,10,元大-台南,2023-01-17,9896
00773B,中信優先金融債,10,0,10,元大-台南,2023-01-17,9896
4934,太極,11,1,10,元大-台南,2023-01-17,9896
2009,第一銅,10,1,9,元大-台南,2023-01-17,9896
3013,晟銘電,8,0,8,元大-台南,2023-01-17,9896
6244,茂迪,10,2,8,元大-台南,2023-01-17,9896
6139,亞翔,8,0,8,元大-台南,2023-01-17,9896
4114,健喬,24,16,8,元大-台南,2023-01-17,9896
00878,國泰永續高股息,30,23,7,元大-台南,2023-01-17,9896
3520,華盈,7,0,7,元大-台南,2023-01-17,9896
8105,凌巨,9,2,7,元大-台南,2023-01-17,9896
8358,金居,13,6,7,元大-台南,2023-01-17,9896
2615,萬海,8,2,6,元大-台南,2023-01-17,9896
00713,元大台灣高息低波,6,0,6,元大-台南,2023-01-17,9896
2007,燁興,7,1,6,元大-台南,2023-01-17,9896
8926,台汽電,6,0,6,元大-台南,2023-01-17,9896
1709,和益,5,0,5,元大-台南,2023-01-17,9896
6589,台康生技,5,0,5,元大-台南,2023-01-17,9896
9802,鈺齊-KY,5,0,5,元大-台南,2023-01-17,9896
3042,晶技,5,0,5,元大-台南,2023-01-17,9896
2511,太子,5,0,5,元大-台南,2023-01-17,9896
00751B,元大AAA至A公司債,5,0,5,元大-台南,2023-01-17,9896
2867,三商壽,502,0,502,元大-台南,2023-01-30,9896
00632R,元大台灣50反1,338,73,265,元大-台南,2023-01-30,9896
2603,長榮,263,2,261,元大-台南,2023-01-30,9896
00676R,富邦臺灣加權反1,213,5,208,元大-台南,2023-01-30,9896
00720B,元大投資級公司債,126,3,123,元大-台南,2023-01-30,9896
2317,鴻海,85,8,77,元大-台南,2023-01-30,9896
1451,年興,72,0,72,元大-台南,2023-01-30,9896
1313,聯成,71,0,71,元大-台南,2023-01-30,9896
9939,宏全,62,0,62,元大-台南,2023-01-30,9896
00904,新光臺灣半導體30,50,1,49,元大-台南,2023-01-30,9896
1795,美時,39,8,31,元大-台南,2023-01-30,9896
00763U,期街口道瓊銅,30,0,30,元大-台南,2023-01-30,9896
4960,誠美材,25,0,25,元大-台南,2023-01-30,9896
00673R,期元大S＆P原油反1,103,80,23,元大-台南,2023-01-30,9896
2444,兆勁,20,0,20,元大-台南,2023-01-30,9896
00671R,富邦NASDAQ反1,17,0,17,元大-台南,2023-01-30,9896
2609,陽明,23,7,16,元大-台南,2023-01-30,9896
8069,元太,35,19,16,元大-台南,2023-01-30,9896
2881,富邦金,36,20,16,元大-台南,2023-01-30,9896
4977,眾達-KY,15,0,15,元大-台南,2023-01-30,9896
6547,高端疫苗,17,2,15,元大-台南,2023-01-30,9896
1305,華夏,22,9,13,元大-台南,2023-01-30,9896
6192,巨路,13,0,13,元大-台南,2023-01-30,9896
2308,台達電,12,0,12,元大-台南,2023-01-30,9896
00683L,期元大美元指正2,12,0,12,元大-台南,2023-01-30,9896
2497,怡利電,11,0,11,元大-台南,2023-01-30,9896
2484,希華,12,2,10,元大-台南,2023-01-30,9896
1460,宏遠,13,3,10,元大-台南,2023-01-30,9896
1616,億泰,10,0,10,元大-台南,2023-01-30,9896
8050,廣積,10,0,10,元大-台南,2023-01-30,9896
2017,官田鋼,9,0,9,元大-台南,2023-01-30,9896
1609,大亞,13,4,9,元大-台南,2023-01-30,9896
2031,新光鋼,11,3,8,元大-台南,2023-01-30,9896
3576,聯合再生,13,5,8,元大-台南,2023-01-30,9896
6541,泰福-KY,8,0,8,元大-台南,2023-01-30,9896
2009,第一銅,16,8,8,元大-台南,2023-01-30,9896
1216,統一,9,1,8,元大-台南,2023-01-30,9896
4979,華星光,30,23,7,元大-台南,2023-01-30,9896
1760,寶齡富錦,7,1,6,元大-台南,2023-01-30,9896
6274,台燿,6,0,6,元大-台南,2023-01-30,9896
00772B,中信高評級公司債,6,0,6,元大-台南,2023-01-30,9896
5607,遠雄港,6,0,6,元大-台南,2023-01-30,9896
00751B,元大AAA至A公司債,6,0,6,元大-台南,2023-01-30,9896
6245,立端,7,1,6,元大-台南,2023-01-30,9896
2201,裕隆,14,8,6,元大-台南,2023-01-30,9896
1736,喬山,5,0,5,元大-台南,2023-01-30,9896
2882,國泰金,13,7,6,元大-台南,2023-01-30,9896
00713,元大台灣高息低波,13,8,5,元大-台南,2023-01-30,9896
2342,茂矽,10,5,5,元大-台南,2023-01-30,9896
2204,中華,6,1,5,元大-台南,2023-01-30,9896
2867,三商壽,510,10,500,元大-台南,2023-01-31,9896
00720B,元大投資級公司債,146,5,141,元大-台南,2023-01-31,9896
2618,長榮航,158,37,121,元大-台南,2023-01-31,9896
00905,FT臺灣Smart,122,17,105,元大-台南,2023-01-31,9896
00878,國泰永續高股息,111,19,92,元大-台南,2023-01-31,9896
5425,台半,101,20,81,元大-台南,2023-01-31,9896
00673R,期元大S＆P原油反1,100,32,68,元大-台南,2023-01-31,9896
6443,元晶,75,18,57,元大-台南,2023-01-31,9896
1909,榮成,50,0,50,元大-台南,2023-01-31,9896
2330,台積電,44,4,40,元大-台南,2023-01-31,9896
5880,合庫金,35,0,35,元大-台南,2023-01-31,9896
00679B,元大美債20年,34,0,34,元大-台南,2023-01-31,9896
00882,中信中國高股息,41,11,30,元大-台南,2023-01-31,9896
00631L,元大台灣50正2,31,1,30,元大-台南,2023-01-31,9896
2888,新光金,31,2,29,元大-台南,2023-01-31,9896
1612,宏泰,27,1,26,元大-台南,2023-01-31,9896
2886,兆豐金,28,2,26,元大-台南,2023-01-31,9896
2484,希華,27,2,25,元大-台南,2023-01-31,9896
2892,第一金,25,0,25,元大-台南,2023-01-31,9896
9939,宏全,24,0,24,元大-台南,2023-01-31,9896
2409,友達,33,10,23,元大-台南,2023-01-31,9896
0056,元大高股息,51,28,23,元大-台南,2023-01-31,9896
2007,燁興,25,2,23,元大-台南,2023-01-31,9896
1722,台肥,20,0,20,元大-台南,2023-01-31,9896
00665L,富邦�琤肭磪囓�2,20,0,20,元大-台南,2023-01-31,9896
006205,富邦上証,20,0,20,元大-台南,2023-01-31,9896
2444,兆勁,20,0,20,元大-台南,2023-01-31,9896
3532,台勝科,20,1,19,元大-台南,2023-01-31,9896
3037,欣興,21,5,16,元大-台南,2023-01-31,9896
1101,台泥,18,3,15,元大-台南,2023-01-31,9896
6235,華孚,16,1,15,元大-台南,2023-01-31,9896
2002,中鋼,22,7,15,元大-台南,2023-01-31,9896
00885,富邦越南,15,1,14,元大-台南,2023-01-31,9896
1451,年興,14,0,14,元大-台南,2023-01-31,9896
6133,金橋,19,5,14,元大-台南,2023-01-31,9896
2834,臺企銀,17,3,14,元大-台南,2023-01-31,9896
00753L,中信中國50正2,22,9,13,元大-台南,2023-01-31,9896
00916,國泰全球品牌50,13,0,13,元大-台南,2023-01-31,9896
1810,和成,17,4,13,元大-台南,2023-01-31,9896
2880,華南金,12,0,12,元大-台南,2023-01-31,9896
9945,潤泰新,12,0,12,元大-台南,2023-01-31,9896
4979,華星光,60,48,12,元大-台南,2023-01-31,9896
3706,神達,13,1,12,元大-台南,2023-01-31,9896
8038,長園科,14,2,12,元大-台南,2023-01-31,9896
5871,中租-KY,13,2,11,元大-台南,2023-01-31,9896
00696B,富邦美債20年,11,0,11,元大-台南,2023-01-31,9896
2354,鴻準,13,3,10,元大-台南,2023-01-31,9896
2891,中信金,19,8,11,元大-台南,2023-01-31,9896
00902,中信電池及儲能,10,0,10,元大-台南,2023-01-31,9896
2324,仁寶,12,2,10,元大-台南,2023-01-31,9896
2317,鴻海,408,1,407,元大-台南,2023-02-01,9896
00891,中信關鍵半導體,168,5,163,元大-台南,2023-02-01,9896
2465,麗臺,66,2,64,元大-台南,2023-02-01,9896
1504,東元,60,0,60,元大-台南,2023-02-01,9896
00632R,元大台灣50反1,61,3,58,元大-台南,2023-02-01,9896
00673R,期元大S＆P原油反1,89,40,49,元大-台南,2023-02-01,9896
2888,新光金,64,22,42,元大-台南,2023-02-01,9896
00878,國泰永續高股息,48,6,42,元大-台南,2023-02-01,9896
1451,年興,37,0,37,元大-台南,2023-02-01,9896
1471,首利,40,10,30,元大-台南,2023-02-01,9896
00905,FT臺灣Smart,29,0,29,元大-台南,2023-02-01,9896
3576,聯合再生,50,21,29,元大-台南,2023-02-01,9896
2014,中鴻,36,8,28,元大-台南,2023-02-01,9896
5309,系統電,28,1,27,元大-台南,2023-02-01,9896
2891,中信金,33,6,27,元大-台南,2023-02-01,9896
0056,元大高股息,41,15,26,元大-台南,2023-02-01,9896
2358,廷鑫,39,15,24,元大-台南,2023-02-01,9896
00680L,元大美債20正2,24,0,24,元大-台南,2023-02-01,9896
4114,健喬,65,41,24,元大-台南,2023-02-01,9896
3290,東浦,24,0,24,元大-台南,2023-02-01,9896
3532,台勝科,22,0,22,元大-台南,2023-02-01,9896
00671R,富邦NASDAQ反1,21,0,21,元大-台南,2023-02-01,9896
2399,映泰,20,0,20,元大-台南,2023-02-01,9896
2820,華票,20,0,20,元大-台南,2023-02-01,9896
1609,大亞,72,55,17,元大-台南,2023-02-01,9896
1722,台肥,15,0,15,元大-台南,2023-02-01,9896
2007,燁興,35,20,15,元大-台南,2023-02-01,9896
1217,愛之味,14,0,14,元大-台南,2023-02-01,9896
2867,三商壽,13,0,13,元大-台南,2023-02-01,9896
2887,台新金,19,6,13,元大-台南,2023-02-01,9896
9935,慶豐富,13,0,13,元大-台南,2023-02-01,9896
3714,富采,21,9,12,元大-台南,2023-02-01,9896
2515,中工,12,0,12,元大-台南,2023-02-01,9896
1708,東鹼,11,0,11,元大-台南,2023-02-01,9896
3682,亞太電,11,0,11,元大-台南,2023-02-01,9896
1560,中砂,13,3,10,元大-台南,2023-02-01,9896
00679B,元大美債20年,11,1,10,元大-台南,2023-02-01,9896
2352,佳世達,10,0,10,元大-台南,2023-02-01,9896
3027,盛達,25,15,10,元大-台南,2023-02-01,9896
6546,正基,11,1,10,元大-台南,2023-02-01,9896
2312,金寶,10,0,10,元大-台南,2023-02-01,9896
6541,泰福-KY,10,0,10,元大-台南,2023-02-01,9896
00665L,富邦�琤肭磪囓�2,10,0,10,元大-台南,2023-02-01,9896
3481,群創,15,5,10,元大-台南,2023-02-01,9896
1466,聚隆,10,0,10,元大-台南,2023-02-01,9896
2929,淘帝-KY,13,4,9,元大-台南,2023-02-01,9896
4129,聯合,9,0,9,元大-台南,2023-02-01,9896
1409,新纖,10,1,9,元大-台南,2023-02-01,9896
3545,敦泰,10,1,9,元大-台南,2023-02-01,9896
2406,國碩,10,1,9,元大-台南,2023-02-01,9896
2603,長榮,258,6,252,元大-台南,2023-02-02,9896
00891,中信關鍵半導體,144,22,122,元大-台南,2023-02-02,9896
00720B,元大投資級公司債,140,41,99,元大-台南,2023-02-02,9896
3041,揚智,80,1,79,元大-台南,2023-02-02,9896
00679B,元大美債20年,73,10,63,元大-台南,2023-02-02,9896
3481,群創,58,11,47,元大-台南,2023-02-02,9896
00878,國泰永續高股息,53,7,46,元大-台南,2023-02-02,9896
00882,中信中國高股息,47,2,45,元大-台南,2023-02-02,9896
00715L,期街口布蘭特正2,41,0,41,元大-台南,2023-02-02,9896
4106,雃博,47,6,41,元大-台南,2023-02-02,9896
1512,瑞利,40,0,40,元大-台南,2023-02-02,9896
3290,東浦,37,0,37,元大-台南,2023-02-02,9896
00680L,元大美債20正2,36,0,36,元大-台南,2023-02-02,9896
2618,長榮航,36,7,29,元大-台南,2023-02-02,9896
2402,毅嘉,30,2,28,元大-台南,2023-02-02,9896
00642U,期元大S＆P石油,30,4,26,元大-台南,2023-02-02,9896
1451,年興,26,0,26,元大-台南,2023-02-02,9896
2888,新光金,24,1,23,元大-台南,2023-02-02,9896
6129,普誠,33,11,22,元大-台南,2023-02-02,9896
6477,安集,21,0,21,元大-台南,2023-02-02,9896
8349,�矬�,22,2,20,元大-台南,2023-02-02,9896
2201,裕隆,44,25,19,元大-台南,2023-02-02,9896
2413,環科,20,1,19,元大-台南,2023-02-02,9896
4968,立積,22,4,18,元大-台南,2023-02-02,9896
8069,元太,69,52,17,元大-台南,2023-02-02,9896
1513,中興電,33,17,16,元大-台南,2023-02-02,9896
6612,奈米醫材,16,0,16,元大-台南,2023-02-02,9896
2834,臺企銀,16,1,15,元大-台南,2023-02-02,9896
2002,中鋼,37,23,14,元大-台南,2023-02-02,9896
9935,慶豐富,14,0,14,元大-台南,2023-02-02,9896
6244,茂迪,26,13,13,元大-台南,2023-02-02,9896
1457,宜進,12,0,12,元大-台南,2023-02-02,9896
6285,啟��,12,0,12,元大-台南,2023-02-02,9896
2354,鴻準,14,3,11,元大-台南,2023-02-02,9896
2492,華新科,16,5,11,元大-台南,2023-02-02,9896
2867,三商壽,11,0,11,元大-台南,2023-02-02,9896
1314,中石化,21,10,11,元大-台南,2023-02-02,9896
8033,雷虎,11,0,11,元大-台南,2023-02-02,9896
00740B,富邦全球投等債,10,0,10,元大-台南,2023-02-02,9896
2314,台揚,15,5,10,元大-台南,2023-02-02,9896
2884,玉山金,11,1,10,元大-台南,2023-02-02,9896
00688L,國泰20年美債正2,10,0,10,元大-台南,2023-02-02,9896
02002L,兆豐富櫃200正二N,10,0,10,元大-台南,2023-02-02,9896
6670,復盛應用,10,0,10,元大-台南,2023-02-02,9896
6443,元晶,35,26,9,元大-台南,2023-02-02,9896
8038,長園科,16,7,9,元大-台南,2023-02-02,9896
1475,業旺,9,0,9,元大-台南,2023-02-02,9896
6235,華孚,20,11,9,元大-台南,2023-02-02,9896
2023,燁輝,10,1,9,元大-台南,2023-02-02,9896
2634,漢翔,10,1,9,元大-台南,2023-02-02,9896
3037,欣興,298,34,264,元大-台南,2023-02-03,9896
00676R,富邦臺灣加權反1,209,0,209,元大-台南,2023-02-03,9896
00882,中信中國高股息,204,0,204,元大-台南,2023-02-03,9896
00632R,元大台灣50反1,304,192,112,元大-台南,2023-02-03,9896
00878,國泰永續高股息,126,19,107,元大-台南,2023-02-03,9896
00642U,期元大S＆P石油,75,0,75,元大-台南,2023-02-03,9896
00715L,期街口布蘭特正2,70,0,70,元大-台南,2023-02-03,9896
00650L,復華香港正2,66,0,66,元大-台南,2023-02-03,9896
5009,榮剛,63,4,59,元大-台南,2023-02-03,9896
00669R,國泰美國道瓊反1,56,0,56,元大-台南,2023-02-03,9896
2618,長榮航,57,3,54,元大-台南,2023-02-03,9896
2402,毅嘉,50,0,50,元大-台南,2023-02-03,9896
00918,大華優利高填息30,46,1,45,元大-台南,2023-02-03,9896
3041,揚智,34,0,34,元大-台南,2023-02-03,9896
6138,茂達,31,3,28,元大-台南,2023-02-03,9896
1451,年興,27,0,27,元大-台南,2023-02-03,9896
2317,鴻海,31,4,27,元大-台南,2023-02-03,9896
3567,逸昌,25,0,25,元大-台南,2023-02-03,9896
1301,台塑,24,0,24,元大-台南,2023-02-03,9896
2014,中鴻,26,2,24,元大-台南,2023-02-03,9896
00893,國泰智能電動車,35,12,23,元大-台南,2023-02-03,9896
2027,大成鋼,23,1,22,元大-台南,2023-02-03,9896
5608,四維航,22,1,21,元大-台南,2023-02-03,9896
2358,廷鑫,24,3,21,元大-台南,2023-02-03,9896
6109,亞元,20,0,20,元大-台南,2023-02-03,9896
3290,東浦,20,0,20,元大-台南,2023-02-03,9896
2882,國泰金,21,2,19,元大-台南,2023-02-03,9896
2891,中信金,21,2,19,元大-台南,2023-02-03,9896
6257,矽格,19,0,19,元大-台南,2023-02-03,9896
9939,宏全,20,1,19,元大-台南,2023-02-03,9896
00712,復華富時不動產,20,2,18,元大-台南,2023-02-03,9896
2465,麗臺,38,21,17,元大-台南,2023-02-03,9896
2367,燿華,16,0,16,元大-台南,2023-02-03,9896
8069,元太,41,26,15,元大-台南,2023-02-03,9896
2498,宏達電,53,38,15,元大-台南,2023-02-03,9896
4961,天鈺,22,8,14,元大-台南,2023-02-03,9896
3707,漢磊,14,1,13,元大-台南,2023-02-03,9896
3035,智原,58,46,12,元大-台南,2023-02-03,9896
3576,聯合再生,20,8,12,元大-台南,2023-02-03,9896
2892,第一金,13,1,12,元大-台南,2023-02-03,9896
2409,友達,12,1,11,元大-台南,2023-02-03,9896
4114,健喬,12,1,11,元大-台南,2023-02-03,9896
00680L,元大美債20正2,12,1,11,元大-台南,2023-02-03,9896
2484,希華,16,5,11,元大-台南,2023-02-03,9896
6190,萬泰科,15,4,11,元大-台南,2023-02-03,9896
5452,佶優,11,0,11,元大-台南,2023-02-03,9896
2834,臺企銀,11,1,10,元大-台南,2023-02-03,9896
1216,統一,20,10,10,元大-台南,2023-02-03,9896
00762,元大全球AI,10,0,10,元大-台南,2023-02-03,9896
4960,誠美材,10,0,10,元大-台南,2023-02-03,9896
00632R,元大台灣50反1,226,91,135,元大-台南,2023-02-06,9896
00720B,元大投資級公司債,121,0,121,元大-台南,2023-02-06,9896
00878,國泰永續高股息,127,23,104,元大-台南,2023-02-06,9896
00715L,期街口布蘭特正2,94,3,91,元大-台南,2023-02-06,9896
00882,中信中國高股息,91,5,86,元大-台南,2023-02-06,9896
00642U,期元大S＆P石油,55,0,55,元大-台南,2023-02-06,9896
00679B,元大美債20年,35,0,35,元大-台南,2023-02-06,9896
6215,和椿,30,0,30,元大-台南,2023-02-06,9896
3006,晶豪科,26,2,24,元大-台南,2023-02-06,9896
00772B,中信高評級公司債,24,1,23,元大-台南,2023-02-06,9896
2482,連宇,103,80,23,元大-台南,2023-02-06,9896
2884,玉山金,23,0,23,元大-台南,2023-02-06,9896
00637L,元大滬深300正2,29,6,23,元大-台南,2023-02-06,9896
4167,松瑞藥,30,9,21,元大-台南,2023-02-06,9896
00905,FT臺灣Smart,20,0,20,元大-台南,2023-02-06,9896
00918,大華優利高填息30,20,0,20,元大-台南,2023-02-06,9896
3290,東浦,20,0,20,元大-台南,2023-02-06,9896
2609,陽明,27,8,19,元大-台南,2023-02-06,9896
00900,富邦特選高股息30,19,0,19,元大-台南,2023-02-06,9896
00738U,期元大道瓊白銀,19,0,19,元大-台南,2023-02-06,9896
00770,國泰北美科技,20,1,19,元大-台南,2023-02-06,9896
1503,士電,20,1,19,元大-台南,2023-02-06,9896
4130,健亞,19,2,17,元大-台南,2023-02-06,9896
1795,美時,29,13,16,元大-台南,2023-02-06,9896
2201,裕隆,23,8,15,元大-台南,2023-02-06,9896
1513,中興電,26,12,14,元大-台南,2023-02-06,9896
2880,華南金,13,0,13,元大-台南,2023-02-06,9896
8112,至上,12,0,12,元大-台南,2023-02-06,9896
2206,三陽工業,12,0,12,元大-台南,2023-02-06,9896
2888A,新光金甲特,10,0,10,元大-台南,2023-02-06,9896
3162,精確,10,0,10,元大-台南,2023-02-06,9896
8150,南茂,10,0,10,元大-台南,2023-02-06,9896
3479,安勤,10,0,10,元大-台南,2023-02-06,9896
3454,晶睿,15,5,10,元大-台南,2023-02-06,9896
1810,和成,10,0,10,元大-台南,2023-02-06,9896
6165,浪凡,10,0,10,元大-台南,2023-02-06,9896
6438,迅得,10,0,10,元大-台南,2023-02-06,9896
3443,創意,13,4,9,元大-台南,2023-02-06,9896
2538,基泰,10,1,9,元大-台南,2023-02-06,9896
00706L,期元大S＆P日圓正2,9,0,9,元大-台南,2023-02-06,9896
00903,富邦元宇宙,9,0,9,元大-台南,2023-02-06,9896
4746,台耀,14,5,9,元大-台南,2023-02-06,9896
2885,元大金,12,4,8,元大-台南,2023-02-06,9896
6546,正基,10,2,8,元大-台南,2023-02-06,9896
2344,華邦電,10,2,8,元大-台南,2023-02-06,9896
2883,凱基金,18,10,8,元大-台南,2023-02-06,9896
4533,協易機,8,0,8,元大-台南,2023-02-06,9896
5608,四維航,8,0,8,元大-台南,2023-02-06,9896
3704,合勤控,8,0,8,元大-台南,2023-02-06,9896
2356,英業達,8,0,8,元大-台南,2023-02-06,9896
00650L,復華香港正2,304,0,304,元大-台南,2023-02-07,9896
00878,國泰永續高股息,189,1,188,元大-台南,2023-02-07,9896
2603,長榮,154,0,154,元大-台南,2023-02-07,9896
3037,欣興,127,4,123,元大-台南,2023-02-07,9896
4938,和碩,100,0,100,元大-台南,2023-02-07,9896
8349,�矬�,60,0,60,元大-台南,2023-02-07,9896
6472,保瑞,67,9,58,元大-台南,2023-02-07,9896
00642U,期元大S＆P石油,61,3,58,元大-台南,2023-02-07,9896
1605,華新,84,38,46,元大-台南,2023-02-07,9896
1101,台泥,42,5,37,元大-台南,2023-02-07,9896
2618,長榮航,49,14,35,元大-台南,2023-02-07,9896
2610,華航,25,1,24,元大-台南,2023-02-07,9896
6282,康舒,47,23,24,元大-台南,2023-02-07,9896
4162,智擎,41,18,23,元大-台南,2023-02-07,9896
5309,系統電,21,0,21,元大-台南,2023-02-07,9896
00720B,元大投資級公司債,19,0,19,元大-台南,2023-02-07,9896
2892,第一金,20,1,19,元大-台南,2023-02-07,9896
00679B,元大美債20年,17,0,17,元大-台南,2023-02-07,9896
00885,富邦越南,17,1,16,元大-台南,2023-02-07,9896
6202,盛群,18,2,16,元大-台南,2023-02-07,9896
6770,力積電,17,3,14,元大-台南,2023-02-07,9896
2887,台新金,13,0,13,元大-台南,2023-02-07,9896
2511,太子,13,0,13,元大-台南,2023-02-07,9896
1432,大魯閣,21,8,13,元大-台南,2023-02-07,9896
1810,和成,22,10,12,元大-台南,2023-02-07,9896
00773B,中信優先金融債,12,0,12,元大-台南,2023-02-07,9896
1471,首利,11,0,11,元大-台南,2023-02-07,9896
1722,台肥,11,0,11,元大-台南,2023-02-07,9896
2344,華邦電,13,3,10,元大-台南,2023-02-07,9896
1451,年興,10,0,10,元大-台南,2023-02-07,9896
3038,全台,10,0,10,元大-台南,2023-02-07,9896
3290,東浦,10,0,10,元大-台南,2023-02-07,9896
00712,復華富時不動產,9,0,9,元大-台南,2023-02-07,9896
00683L,期元大美元指正2,9,0,9,元大-台南,2023-02-07,9896
00780B,國泰A級金融債,9,0,9,元大-台南,2023-02-07,9896
2454,聯發科,8,0,8,元大-台南,2023-02-07,9896
2380,虹光,20,12,8,元大-台南,2023-02-07,9896
8215,明基材,8,0,8,元大-台南,2023-02-07,9896
1522,堤維西,10,2,8,元大-台南,2023-02-07,9896
5530,龍巖,8,0,8,元大-台南,2023-02-07,9896
1760,寶齡富錦,12,4,8,元大-台南,2023-02-07,9896
3163,波若威,8,1,7,元大-台南,2023-02-07,9896
2201,裕隆,10,3,7,元大-台南,2023-02-07,9896
5353,台林,9,2,7,元大-台南,2023-02-07,9896
1752,南光,31,24,7,元大-台南,2023-02-07,9896
1513,中興電,14,7,7,元大-台南,2023-02-07,9896
6754,匯僑設計,7,0,7,元大-台南,2023-02-07,9896
6133,金橋,8,1,7,元大-台南,2023-02-07,9896
3362,先進光,7,0,7,元大-台南,2023-02-07,9896
8105,凌巨,13,7,6,元大-台南,2023-02-07,9896
00671R,富邦NASDAQ反1,147,0,147,元大-台南,2023-02-08,9896
00632R,元大台灣50反1,193,82,111,元大-台南,2023-02-08,9896
2603,長榮,107,0,107,元大-台南,2023-02-08,9896
00893,國泰智能電動車,148,41,107,元大-台南,2023-02-08,9896
4961,天鈺,90,5,85,元大-台南,2023-02-08,9896
4743,合一,90,28,62,元大-台南,2023-02-08,9896
2618,長榮航,58,2,56,元大-台南,2023-02-08,9896
00642U,期元大S＆P石油,65,9,56,元大-台南,2023-02-08,9896
2890,永豐金,50,0,50,元大-台南,2023-02-08,9896
8349,�矬�,48,0,48,元大-台南,2023-02-08,9896
6589,台康生技,61,19,42,元大-台南,2023-02-08,9896
6282,康舒,44,6,38,元大-台南,2023-02-08,9896
00679B,元大美債20年,36,1,35,元大-台南,2023-02-08,9896
3545,敦泰,33,1,32,元大-台南,2023-02-08,9896
5009,榮剛,31,4,27,元大-台南,2023-02-08,9896
2327,國巨,27,0,27,元大-台南,2023-02-08,9896
2465,麗臺,59,33,26,元大-台南,2023-02-08,9896
1471,首利,25,0,25,元大-台南,2023-02-08,9896
00772B,中信高評級公司債,24,0,24,元大-台南,2023-02-08,9896
00878,國泰永續高股息,44,20,24,元大-台南,2023-02-08,9896
9939,宏全,25,2,23,元大-台南,2023-02-08,9896
3536,誠創,22,0,22,元大-台南,2023-02-08,9896
1783,和康生,30,8,22,元大-台南,2023-02-08,9896
4114,健喬,35,14,21,元大-台南,2023-02-08,9896
2498,宏達電,35,14,21,元大-台南,2023-02-08,9896
2867,三商壽,21,2,19,元大-台南,2023-02-08,9896
2371,大同,17,0,17,元大-台南,2023-02-08,9896
2014,中鴻,16,0,16,元大-台南,2023-02-08,9896
2201,裕隆,46,30,16,元大-台南,2023-02-08,9896
8112,至上,18,2,16,元大-台南,2023-02-08,9896
00664R,國泰臺灣加權反1,16,0,16,元大-台南,2023-02-08,9896
00885,富邦越南,16,1,15,元大-台南,2023-02-08,9896
1451,年興,17,2,15,元大-台南,2023-02-08,9896
1609,大亞,15,0,15,元大-台南,2023-02-08,9896
1605,華新,28,13,15,元大-台南,2023-02-08,9896
2891,中信金,32,18,14,元大-台南,2023-02-08,9896
2338,光罩,22,8,14,元大-台南,2023-02-08,9896
2610,華航,14,1,13,元大-台南,2023-02-08,9896
3027,盛達,22,10,12,元大-台南,2023-02-08,9896
4551,智伸科,12,0,12,元大-台南,2023-02-08,9896
3455,由田,12,0,12,元大-台南,2023-02-08,9896
6235,華孚,83,71,12,元大-台南,2023-02-08,9896
2892,第一金,12,1,11,元大-台南,2023-02-08,9896
3588,通嘉,11,0,11,元大-台南,2023-02-08,9896
8358,金居,11,0,11,元大-台南,2023-02-08,9896
6244,茂迪,11,0,11,元大-台南,2023-02-08,9896
2474,可成,17,6,11,元大-台南,2023-02-08,9896
8016,矽創,13,2,11,元大-台南,2023-02-08,9896
1314,中石化,11,1,10,元大-台南,2023-02-08,9896
00753L,中信中國50正2,19,9,10,元大-台南,2023-02-08,9896
6806,森崴能源,133,0,133,元大-台南,2023-02-09,9896
00878,國泰永續高股息,133,7,126,元大-台南,2023-02-09,9896
2634,漢翔,94,24,70,元大-台南,2023-02-09,9896
3034,聯詠,46,2,44,元大-台南,2023-02-09,9896
00673R,期元大S＆P原油反1,40,0,40,元大-台南,2023-02-09,9896
1342,八貫,52,20,32,元大-台南,2023-02-09,9896
2408,南亞科,31,0,31,元大-台南,2023-02-09,9896
2465,麗臺,35,4,31,元大-台南,2023-02-09,9896
3236,千如,30,0,30,元大-台南,2023-02-09,9896
00679B,元大美債20年,30,0,30,元大-台南,2023-02-09,9896
00720B,元大投資級公司債,27,0,27,元大-台南,2023-02-09,9896
4746,台耀,32,5,27,元大-台南,2023-02-09,9896
6770,力積電,31,6,25,元大-台南,2023-02-09,9896
1760,寶齡富錦,35,10,25,元大-台南,2023-02-09,9896
00772B,中信高評級公司債,25,0,25,元大-台南,2023-02-09,9896
3014,聯陽,30,6,24,元大-台南,2023-02-09,9896
2359,所羅門,26,4,22,元大-台南,2023-02-09,9896
2609,陽明,25,4,21,元大-台南,2023-02-09,9896
00905,FT臺灣Smart,20,0,20,元大-台南,2023-02-09,9896
3706,神達,20,0,20,元大-台南,2023-02-09,9896
5488,松普,20,0,20,元大-台南,2023-02-09,9896
2108,南帝,20,1,19,元大-台南,2023-02-09,9896
2887,台新金,19,0,19,元大-台南,2023-02-09,9896
1512,瑞利,20,1,19,元大-台南,2023-02-09,9896
2498,宏達電,54,36,18,元大-台南,2023-02-09,9896
5351,鈺創,19,1,18,元大-台南,2023-02-09,9896
3047,訊舟,17,0,17,元大-台南,2023-02-09,9896
8033,雷虎,20,4,16,元大-台南,2023-02-09,9896
9802,鈺齊-KY,15,0,15,元大-台南,2023-02-09,9896
1736,喬山,14,0,14,元大-台南,2023-02-09,9896
6188,廣明,15,2,13,元大-台南,2023-02-09,9896
6546,正基,33,20,13,元大-台南,2023-02-09,9896
0056,元大高股息,21,9,12,元大-台南,2023-02-09,9896
00900,富邦特選高股息30,12,0,12,元大-台南,2023-02-09,9896
5475,德宏,12,0,12,元大-台南,2023-02-09,9896
6129,普誠,33,21,12,元大-台南,2023-02-09,9896
6612,奈米醫材,12,0,12,元大-台南,2023-02-09,9896
1409,新纖,11,0,11,元大-台南,2023-02-09,9896
2884,玉山金,11,0,11,元大-台南,2023-02-09,9896
3059,華晶科,12,1,11,元大-台南,2023-02-09,9896
1216,統一,10,0,10,元大-台南,2023-02-09,9896
6285,啟��,11,1,10,元大-台南,2023-02-09,9896
3708,上緯投控,10,0,10,元大-台南,2023-02-09,9896
2376,技嘉,10,0,10,元大-台南,2023-02-09,9896
2105,正新,10,0,10,元大-台南,2023-02-09,9896
1451,年興,10,0,10,元大-台南,2023-02-09,9896
3128,昇銳,13,3,10,元大-台南,2023-02-09,9896
02002L,兆豐富櫃200正二N,10,0,10,元大-台南,2023-02-09,9896
4105,東洋,11,1,10,元大-台南,2023-02-09,9896
9940,信義,10,0,10,元大-台南,2023-02-09,9896
00878,國泰永續高股息,158,13,145,元大-台南,2023-02-10,9896
00632R,元大台灣50反1,153,24,129,元大-台南,2023-02-10,9896
00882,中信中國高股息,116,0,116,元大-台南,2023-02-10,9896
1101,台泥,109,7,102,元大-台南,2023-02-10,9896
00671R,富邦NASDAQ反1,102,5,97,元大-台南,2023-02-10,9896
2634,漢翔,178,87,91,元大-台南,2023-02-10,9896
1342,八貫,84,22,62,元大-台南,2023-02-10,9896
2618,長榮航,75,23,52,元大-台南,2023-02-10,9896
6282,康舒,40,0,40,元大-台南,2023-02-10,9896
1605,華新,51,12,39,元大-台南,2023-02-10,9896
00720B,元大投資級公司債,40,1,39,元大-台南,2023-02-10,9896
3162,精確,37,2,35,元大-台南,2023-02-10,9896
00712,復華富時不動產,34,0,34,元大-台南,2023-02-10,9896
2882,國泰金,32,0,32,元大-台南,2023-02-10,9896
1584,精剛,43,13,30,元大-台南,2023-02-10,9896
00751B,元大AAA至A公司債,28,1,27,元大-台南,2023-02-10,9896
00772B,中信高評級公司債,26,0,26,元大-台南,2023-02-10,9896
1810,和成,30,5,25,元大-台南,2023-02-10,9896
0056,元大高股息,32,8,24,元大-台南,2023-02-10,9896
4960,誠美材,25,5,20,元大-台南,2023-02-10,9896
2884,玉山金,22,2,20,元大-台南,2023-02-10,9896
1451,年興,19,0,19,元大-台南,2023-02-10,9896
1609,大亞,23,4,19,元大-台南,2023-02-10,9896
3047,訊舟,19,0,19,元大-台南,2023-02-10,9896
2610,華航,24,5,19,元大-台南,2023-02-10,9896
2357,華碩,16,0,16,元大-台南,2023-02-10,9896
00680L,元大美債20正2,26,10,16,元大-台南,2023-02-10,9896
00679B,元大美債20年,15,0,15,元大-台南,2023-02-10,9896
3231,緯創,18,3,15,元大-台南,2023-02-10,9896
3027,盛達,24,9,15,元大-台南,2023-02-10,9896
4968,立積,17,4,13,元大-台南,2023-02-10,9896
4915,致伸,16,3,13,元大-台南,2023-02-10,9896
2748,雲品,13,0,13,元大-台南,2023-02-10,9896
6770,力積電,14,2,12,元大-台南,2023-02-10,9896
1409,新纖,12,0,12,元大-台南,2023-02-10,9896
4130,健亞,13,1,12,元大-台南,2023-02-10,9896
8028,昇陽半導體,11,0,11,元大-台南,2023-02-10,9896
2867,三商壽,12,1,11,元大-台南,2023-02-10,9896
00891,中信關鍵半導體,11,0,11,元大-台南,2023-02-10,9896
3624,光頡,19,8,11,元大-台南,2023-02-10,9896
3536,誠創,11,0,11,元大-台南,2023-02-10,9896
3455,由田,11,0,11,元大-台南,2023-02-10,9896
8064,東捷,11,0,11,元大-台南,2023-02-10,9896
4167,松瑞藥,16,5,11,元大-台南,2023-02-10,9896
00637L,元大滬深300正2,21,11,10,元大-台南,2023-02-10,9896
00674R,期元大S＆P黃金反1,10,0,10,元大-台南,2023-02-10,9896
1219,福壽,10,0,10,元大-台南,2023-02-10,9896
6269,台郡,10,0,10,元大-台南,2023-02-10,9896
5443,均豪,10,0,10,元大-台南,2023-02-10,9896
6558,興能高,10,0,10,元大-台南,2023-02-10,9896
1795,美時,212,41,171,元大-台南,2023-02-13,9896
00632R,元大台灣50反1,147,20,127,元大-台南,2023-02-13,9896
00878,國泰永續高股息,107,12,95,元大-台南,2023-02-13,9896
00891,中信關鍵半導體,70,1,69,元大-台南,2023-02-13,9896
1101,台泥,51,5,46,元大-台南,2023-02-13,9896
2634,漢翔,66,21,45,元大-台南,2023-02-13,9896
00712,復華富時不動產,42,0,42,元大-台南,2023-02-13,9896
2358,廷鑫,41,2,39,元大-台南,2023-02-13,9896
00673R,期元大S＆P原油反1,31,0,31,元大-台南,2023-02-13,9896
00772B,中信高評級公司債,30,0,30,元大-台南,2023-02-13,9896
00751B,元大AAA至A公司債,27,0,27,元大-台南,2023-02-13,9896
00720B,元大投資級公司債,24,0,24,元大-台南,2023-02-13,9896
2201,裕隆,24,0,24,元大-台南,2023-02-13,9896
2609,陽明,34,11,23,元大-台南,2023-02-13,9896
00900,富邦特選高股息30,27,5,22,元大-台南,2023-02-13,9896
5880,合庫金,22,1,21,元大-台南,2023-02-13,9896
00648R,元大S＆P500反1,20,0,20,元大-台南,2023-02-13,9896
9939,宏全,18,0,18,元大-台南,2023-02-13,9896
2409,友達,46,29,17,元大-台南,2023-02-13,9896
00679B,元大美債20年,22,6,16,元大-台南,2023-02-13,9896
2610,華航,26,10,16,元大-台南,2023-02-13,9896
1584,精剛,17,1,16,元大-台南,2023-02-13,9896
5426,振發,15,0,15,元大-台南,2023-02-13,9896
1451,年興,16,1,15,元大-台南,2023-02-13,9896
00885,富邦越南,15,0,15,元大-台南,2023-02-13,9896
0056,元大高股息,20,7,13,元大-台南,2023-02-13,9896
00918,大華優利高填息30,13,0,13,元大-台南,2023-02-13,9896
1609,大亞,13,0,13,元大-台南,2023-02-13,9896
00680L,元大美債20正2,13,0,13,元大-台南,2023-02-13,9896
8222,寶一,41,28,13,元大-台南,2023-02-13,9896
2352,佳世達,13,0,13,元大-台南,2023-02-13,9896
4931,新盛力,16,4,12,元大-台南,2023-02-13,9896
5009,榮剛,15,4,11,元大-台南,2023-02-13,9896
1216,統一,10,0,10,元大-台南,2023-02-13,9896
2105,正新,10,0,10,元大-台南,2023-02-13,9896
3715,定穎投控,10,0,10,元大-台南,2023-02-13,9896
00687B,國泰20年美債,10,0,10,元大-台南,2023-02-13,9896
1108,幸福,10,0,10,元大-台南,2023-02-13,9896
1707,葡萄王,10,0,10,元大-台南,2023-02-13,9896
4915,致伸,10,0,10,元大-台南,2023-02-13,9896
00862B,中信投資級公司債,10,0,10,元大-台南,2023-02-13,9896
2009,第一銅,15,5,10,元大-台南,2023-02-13,9896
8155,博智,12,2,10,元大-台南,2023-02-13,9896
8048,德勝,10,0,10,元大-台南,2023-02-13,9896
8150,南茂,9,0,9,元大-台南,2023-02-13,9896
2408,南亞科,9,0,9,元大-台南,2023-02-13,9896
1752,南光,46,37,9,元大-台南,2023-02-13,9896
3038,全台,10,1,9,元大-台南,2023-02-13,9896
1701,中化,34,25,9,元大-台南,2023-02-13,9896
2014,中鴻,16,8,8,元大-台南,2023-02-13,9896
00632R,元大台灣50反1,206,86,120,元大-台南,2023-02-14,9896
00673R,期元大S＆P原油反1,100,0,100,元大-台南,2023-02-14,9896
1101,台泥,104,6,98,元大-台南,2023-02-14,9896
00878,國泰永續高股息,156,60,96,元大-台南,2023-02-14,9896
2888,新光金,50,0,50,元大-台南,2023-02-14,9896
2367,燿華,50,1,49,元大-台南,2023-02-14,9896
5880,合庫金,50,6,44,元大-台南,2023-02-14,9896
00648R,元大S＆P500反1,40,0,40,元大-台南,2023-02-14,9896
00720B,元大投資級公司債,36,0,36,元大-台南,2023-02-14,9896
5425,台半,35,9,26,元大-台南,2023-02-14,9896
2884,玉山金,30,4,26,元大-台南,2023-02-14,9896
1605,華新,65,42,23,元大-台南,2023-02-14,9896
3038,全台,20,0,20,元大-台南,2023-02-14,9896
6188,廣明,21,2,19,元大-台南,2023-02-14,9896
2603,長榮,25,7,18,元大-台南,2023-02-14,9896
6269,台郡,18,0,18,元大-台南,2023-02-14,9896
2208,台船,17,0,17,元大-台南,2023-02-14,9896
6112,邁達特,17,0,17,元大-台南,2023-02-14,9896
6290,良維,26,9,17,元大-台南,2023-02-14,9896
00680L,元大美債20正2,16,0,16,元大-台南,2023-02-14,9896
3029,零壹,15,1,14,元大-台南,2023-02-14,9896
2332,友訊,14,1,13,元大-台南,2023-02-14,9896
6282,康舒,13,1,12,元大-台南,2023-02-14,9896
00885,富邦越南,12,0,12,元大-台南,2023-02-14,9896
2371,大同,11,0,11,元大-台南,2023-02-14,9896
2027,大成鋼,15,4,11,元大-台南,2023-02-14,9896
2498,宏達電,11,1,10,元大-台南,2023-02-14,9896
00669R,國泰美國道瓊反1,10,0,10,元大-台南,2023-02-14,9896
2352,佳世達,10,0,10,元大-台南,2023-02-14,9896
8466,美吉吉-KY,10,0,10,元大-台南,2023-02-14,9896
3047,訊舟,10,0,10,元大-台南,2023-02-14,9896
5328,華容,10,0,10,元大-台南,2023-02-14,9896
9902,台火,10,0,10,元大-台南,2023-02-14,9896
3042,晶技,10,1,9,元大-台南,2023-02-14,9896
2883,凱基金,10,1,9,元大-台南,2023-02-14,9896
2891,中信金,19,10,9,元大-台南,2023-02-14,9896
4743,合一,12,3,9,元大-台南,2023-02-14,9896
6482,弘煜科,8,0,8,元大-台南,2023-02-14,9896
4919,新唐,8,0,8,元大-台南,2023-02-14,9896
2471,資通,13,6,7,元大-台南,2023-02-14,9896
5258,虹堡,7,0,7,元大-台南,2023-02-14,9896
8043,蜜望實,7,0,7,元大-台南,2023-02-14,9896
6570,維田,7,0,7,元大-台南,2023-02-14,9896
2610,華航,32,25,7,元大-台南,2023-02-14,9896
00772B,中信高評級公司債,6,0,6,元大-台南,2023-02-14,9896
00664R,國泰臺灣加權反1,6,0,6,元大-台南,2023-02-14,9896
6457,紘康,6,0,6,元大-台南,2023-02-14,9896
2885,元大金,6,0,6,元大-台南,2023-02-14,9896
4105,東洋,6,0,6,元大-台南,2023-02-14,9896
2201,裕隆,16,11,5,元大-台南,2023-02-14,9896
00878,國泰永續高股息,378,81,297,元大-台南,2023-02-15,9896
2409,友達,317,33,284,元大-台南,2023-02-15,9896
00673R,期元大S＆P原油反1,150,8,142,元大-台南,2023-02-15,9896
2610,華航,86,15,71,元大-台南,2023-02-15,9896
2330,台積電,65,13,52,元大-台南,2023-02-15,9896
00664R,國泰臺灣加權反1,50,6,44,元大-台南,2023-02-15,9896
2027,大成鋼,48,7,41,元大-台南,2023-02-15,9896
00773B,中信優先金融債,40,0,40,元大-台南,2023-02-15,9896
6235,華孚,74,34,40,元大-台南,2023-02-15,9896
2618,長榮航,34,1,33,元大-台南,2023-02-15,9896
00900,富邦特選高股息30,32,0,32,元大-台南,2023-02-15,9896
4106,雃博,34,2,32,元大-台南,2023-02-15,9896
2009,第一銅,37,5,32,元大-台南,2023-02-15,9896
00891,中信關鍵半導體,32,1,31,元大-台南,2023-02-15,9896
2882,國泰金,130,101,29,元大-台南,2023-02-15,9896
1101,台泥,23,0,23,元大-台南,2023-02-15,9896
2511,太子,20,0,20,元大-台南,2023-02-15,9896
2891,中信金,19,0,19,元大-台南,2023-02-15,9896
1513,中興電,109,90,19,元大-台南,2023-02-15,9896
2884,玉山金,21,2,19,元大-台南,2023-02-15,9896
4960,誠美材,19,2,17,元大-台南,2023-02-15,9896
3078,僑威,22,6,16,元大-台南,2023-02-15,9896
3483,力致,16,0,16,元大-台南,2023-02-15,9896
3710,連展投控,19,4,15,元大-台南,2023-02-15,9896
8466,美吉吉-KY,15,0,15,元大-台南,2023-02-15,9896
3438,類比科,15,0,15,元大-台南,2023-02-15,9896
0056,元大高股息,22,8,14,元大-台南,2023-02-15,9896
1432,大魯閣,13,1,12,元大-台南,2023-02-15,9896
6509,聚和,11,0,11,元大-台南,2023-02-15,9896
4931,新盛力,11,0,11,元大-台南,2023-02-15,9896
3324,雙鴻,13,3,10,元大-台南,2023-02-15,9896
8358,金居,12,2,10,元大-台南,2023-02-15,9896
5907,大洋-KY,10,0,10,元大-台南,2023-02-15,9896
3038,全台,10,0,10,元大-台南,2023-02-15,9896
1216,統一,10,0,10,元大-台南,2023-02-15,9896
1314,中石化,10,0,10,元大-台南,2023-02-15,9896
2906,高林,10,0,10,元大-台南,2023-02-15,9896
00642U,期元大S＆P石油,10,0,10,元大-台南,2023-02-15,9896
3037,欣興,15,5,10,元大-台南,2023-02-15,9896
2498,宏達電,23,14,9,元大-台南,2023-02-15,9896
4128,中天,9,0,9,元大-台南,2023-02-15,9896
00772B,中信高評級公司債,9,0,9,元大-台南,2023-02-15,9896
0050,元大台灣50,21,12,9,元大-台南,2023-02-15,9896
5309,系統電,10,2,8,元大-台南,2023-02-15,9896
2885,元大金,8,0,8,元大-台南,2023-02-15,9896
5483,中美晶,10,2,8,元大-台南,2023-02-15,9896
6570,維田,8,0,8,元大-台南,2023-02-15,9896
2454,聯發科,7,0,7,元大-台南,2023-02-15,9896
2358,廷鑫,7,0,7,元大-台南,2023-02-15,9896
00679B,元大美債20年,8,1,7,元大-台南,2023-02-15,9896
00632R,元大台灣50反1,1104,350,754,元大-台南,2023-02-16,9896
00673R,期元大S＆P原油反1,185,0,185,元大-台南,2023-02-16,9896
2328,廣宇,116,1,115,元大-台南,2023-02-16,9896
00671R,富邦NASDAQ反1,100,0,100,元大-台南,2023-02-16,9896
00679B,元大美債20年,93,1,92,元大-台南,2023-02-16,9896
2457,飛宏,97,21,76,元大-台南,2023-02-16,9896
00772B,中信高評級公司債,65,2,63,元大-台南,2023-02-16,9896
1609,大亞,81,22,59,元大-台南,2023-02-16,9896
00720B,元大投資級公司債,53,0,53,元大-台南,2023-02-16,9896
2324,仁寶,51,0,51,元大-台南,2023-02-16,9896
2887,台新金,51,0,51,元大-台南,2023-02-16,9896
2889,國票金,50,0,50,元大-台南,2023-02-16,9896
00885,富邦越南,49,0,49,元大-台南,2023-02-16,9896
00773B,中信優先金融債,45,1,44,元大-台南,2023-02-16,9896
2511,太子,30,0,30,元大-台南,2023-02-16,9896
00878,國泰永續高股息,192,163,29,元大-台南,2023-02-16,9896
2014,中鴻,26,3,23,元大-台南,2023-02-16,9896
00680L,元大美債20正2,19,0,19,元大-台南,2023-02-16,9896
9939,宏全,19,1,18,元大-台南,2023-02-16,9896
2630,亞航,17,0,17,元大-台南,2023-02-16,9896
1101,台泥,30,14,16,元大-台南,2023-02-16,9896
6245,立端,19,4,15,元大-台南,2023-02-16,9896
2027,大成鋼,14,0,14,元大-台南,2023-02-16,9896
2206,三陽工業,16,2,14,元大-台南,2023-02-16,9896
2208,台船,14,1,13,元大-台南,2023-02-16,9896
4763,材料-KY,13,1,12,元大-台南,2023-02-16,9896
8046,南電,22,11,11,元大-台南,2023-02-16,9896
3038,全台,11,0,11,元大-台南,2023-02-16,9896
6235,華孚,21,10,11,元大-台南,2023-02-16,9896
6472,保瑞,12,1,11,元大-台南,2023-02-16,9896
2886,兆豐金,23,13,10,元大-台南,2023-02-16,9896
2603,長榮,12,2,10,元大-台南,2023-02-16,9896
00751B,元大AAA至A公司債,10,0,10,元大-台南,2023-02-16,9896
00795B,中信美國公債20年,10,0,10,元大-台南,2023-02-16,9896
00753L,中信中國50正2,10,0,10,元大-台南,2023-02-16,9896
3483,力致,13,3,10,元大-台南,2023-02-16,9896
2867,三商壽,10,0,10,元大-台南,2023-02-16,9896
3062,建漢,10,0,10,元大-台南,2023-02-16,9896
02002L,兆豐富櫃200正二N,10,0,10,元大-台南,2023-02-16,9896
00905,FT臺灣Smart,10,0,10,元大-台南,2023-02-16,9896
4942,嘉彰,10,0,10,元大-台南,2023-02-16,9896
5871,中租-KY,10,1,9,元大-台南,2023-02-16,9896
2498,宏達電,15,6,9,元大-台南,2023-02-16,9896
1503,士電,26,18,8,元大-台南,2023-02-16,9896
2890,永豐金,8,0,8,元大-台南,2023-02-16,9896
00687B,國泰20年美債,8,0,8,元大-台南,2023-02-16,9896
6752,叡揚,8,0,8,元大-台南,2023-02-16,9896
00683L,期元大美元指正2,8,0,8,元大-台南,2023-02-16,9896
3324,雙鴻,10,2,8,元大-台南,2023-02-16,9896
2883,凱基金,7,0,7,元大-台南,2023-02-16,9896
00676R,富邦臺灣加權反1,151,0,151,元大-台南,2023-02-17,9896
00878,國泰永續高股息,146,8,138,元大-台南,2023-02-17,9896
00673R,期元大S＆P原油反1,200,79,121,元大-台南,2023-02-17,9896
1444,力麗,110,1,109,元大-台南,2023-02-17,9896
00632R,元大台灣50反1,152,59,93,元大-台南,2023-02-17,9896
8222,寶一,60,9,51,元大-台南,2023-02-17,9896
2027,大成鋼,48,1,47,元大-台南,2023-02-17,9896
00772B,中信高評級公司債,47,1,46,元大-台南,2023-02-17,9896
2610,華航,124,80,44,元大-台南,2023-02-17,9896
00679B,元大美債20年,47,10,37,元大-台南,2023-02-17,9896
2884,玉山金,39,3,36,元大-台南,2023-02-17,9896
0056,元大高股息,40,5,35,元大-台南,2023-02-17,9896
00773B,中信優先金融債,31,0,31,元大-台南,2023-02-17,9896
00680L,元大美債20正2,23,0,23,元大-台南,2023-02-17,9896
6239,力成,21,0,21,元大-台南,2023-02-17,9896
2929,淘帝-KY,20,0,20,元大-台南,2023-02-17,9896
8043,蜜望實,26,6,20,元大-台南,2023-02-17,9896
1519,華城,22,3,19,元大-台南,2023-02-17,9896
1605,華新,61,42,19,元大-台南,2023-02-17,9896
00751B,元大AAA至A公司債,18,0,18,元大-台南,2023-02-17,9896
00893,國泰智能電動車,17,0,17,元大-台南,2023-02-17,9896
5351,鈺創,27,10,17,元大-台南,2023-02-17,9896
2634,漢翔,41,24,17,元大-台南,2023-02-17,9896
2344,華邦電,50,34,16,元大-台南,2023-02-17,9896
3105,穩懋,20,5,15,元大-台南,2023-02-17,9896
2867,三商壽,15,0,15,元大-台南,2023-02-17,9896
00905,FT臺灣Smart,14,0,14,元大-台南,2023-02-17,9896
4904,遠傳,14,0,14,元大-台南,2023-02-17,9896
6182,合晶,14,0,14,元大-台南,2023-02-17,9896
6531,愛普*,29,16,13,元大-台南,2023-02-17,9896
3209,全科,12,0,12,元大-台南,2023-02-17,9896
00882,中信中國高股息,14,3,11,元大-台南,2023-02-17,9896
1342,八貫,19,8,11,元大-台南,2023-02-17,9896
6415,矽力*-KY,11,0,11,元大-台南,2023-02-17,9896
00897,富邦基因免疫生技,11,0,11,元大-台南,2023-02-17,9896
2615,萬海,11,0,11,元大-台南,2023-02-17,9896
2375,凱美,11,0,11,元大-台南,2023-02-17,9896
00900,富邦特選高股息30,11,0,11,元大-台南,2023-02-17,9896
9939,宏全,10,0,10,元大-台南,2023-02-17,9896
1784,訊聯,10,0,10,元大-台南,2023-02-17,9896
5864,致和證,10,0,10,元大-台南,2023-02-17,9896
2834,臺企銀,12,2,10,元大-台南,2023-02-17,9896
6547,高端疫苗,12,3,9,元大-台南,2023-02-17,9896
00720B,元大投資級公司債,10,1,9,元大-台南,2023-02-17,9896
00903,富邦元宇宙,9,0,9,元大-台南,2023-02-17,9896
1529,樂事綠能,21,12,9,元大-台南,2023-02-17,9896
6104,創惟,55,46,9,元大-台南,2023-02-17,9896
6443,元晶,15,6,9,元大-台南,2023-02-17,9896
2892,第一金,10,1,9,元大-台南,2023-02-17,9896
2498,宏達電,18,9,9,元大-台南,2023-02-17,9896
2610,華航,295,145,150,元大-台南,2023-02-20,9896
2409,友達,211,73,138,元大-台南,2023-02-20,9896
1342,八貫,143,12,131,元大-台南,2023-02-20,9896
2104,國際中橡,102,0,102,元大-台南,2023-02-20,9896
1513,中興電,118,41,77,元大-台南,2023-02-20,9896
2891,中信金,59,3,56,元大-台南,2023-02-20,9896
00652,富邦印度,50,0,50,元大-台南,2023-02-20,9896
4126,太醫,50,0,50,元大-台南,2023-02-20,9896
5904,寶雅,48,0,48,元大-台南,2023-02-20,9896
1101,台泥,81,34,47,元大-台南,2023-02-20,9896
00720B,元大投資級公司債,42,0,42,元大-台南,2023-02-20,9896
6411,晶焱,55,14,41,元大-台南,2023-02-20,9896
6164,華興,40,0,40,元大-台南,2023-02-20,9896
4960,誠美材,44,4,40,元大-台南,2023-02-20,9896
1471,首利,36,0,36,元大-台南,2023-02-20,9896
1514,亞力,33,0,33,元大-台南,2023-02-20,9896
2867,三商壽,26,0,26,元大-台南,2023-02-20,9896
5905,南仁湖,25,0,25,元大-台南,2023-02-20,9896
3035,智原,35,13,22,元大-台南,2023-02-20,9896
00905,FT臺灣Smart,20,0,20,元大-台南,2023-02-20,9896
2727,王品,21,1,20,元大-台南,2023-02-20,9896
00763U,期街口道瓊銅,20,0,20,元大-台南,2023-02-20,9896
3710,連展投控,20,0,20,元大-台南,2023-02-20,9896
6488,環球晶,19,0,19,元大-台南,2023-02-20,9896
2332,友訊,20,1,19,元大-台南,2023-02-20,9896
2630,亞航,17,0,17,元大-台南,2023-02-20,9896
3704,合勤控,23,7,16,元大-台南,2023-02-20,9896
2851,中再保,16,0,16,元大-台南,2023-02-20,9896
00878,國泰永續高股息,29,14,15,元大-台南,2023-02-20,9896
6245,立端,21,6,15,元大-台南,2023-02-20,9896
00902,中信電池及儲能,14,0,14,元大-台南,2023-02-20,9896
00642U,期元大S＆P石油,14,0,14,元大-台南,2023-02-20,9896
8033,雷虎,24,11,13,元大-台南,2023-02-20,9896
00882,中信中國高股息,12,1,11,元大-台南,2023-02-20,9896
8261,富鼎,13,2,11,元大-台南,2023-02-20,9896
6284,佳邦,12,1,11,元大-台南,2023-02-20,9896
00637L,元大滬深300正2,19,8,11,元大-台南,2023-02-20,9896
1806,冠軍,11,0,11,元大-台南,2023-02-20,9896
4961,天鈺,39,28,11,元大-台南,2023-02-20,9896
2634,漢翔,15,4,11,元大-台南,2023-02-20,9896
00885,富邦越南,14,4,10,元大-台南,2023-02-20,9896
2201,裕隆,20,10,10,元大-台南,2023-02-20,9896
1319,東陽,10,0,10,元大-台南,2023-02-20,9896
2206,三陽工業,13,3,10,元大-台南,2023-02-20,9896
4743,合一,35,25,10,元大-台南,2023-02-20,9896
2537,聯上發,10,0,10,元大-台南,2023-02-20,9896
5388,中磊,10,0,10,元大-台南,2023-02-20,9896
3038,全台,10,0,10,元大-台南,2023-02-20,9896
00753L,中信中國50正2,10,0,10,元大-台南,2023-02-20,9896
2103,台橡,10,0,10,元大-台南,2023-02-20,9896
00676R,富邦臺灣加權反1,149,0,149,元大-台南,2023-02-21,9896
00632R,元大台灣50反1,209,70,139,元大-台南,2023-02-21,9896
00664R,國泰臺灣加權反1,100,0,100,元大-台南,2023-02-21,9896
4536,拓凱,104,4,100,元大-台南,2023-02-21,9896
2609,陽明,121,23,98,元大-台南,2023-02-21,9896
2618,長榮航,98,13,85,元大-台南,2023-02-21,9896
4960,誠美材,72,1,71,元大-台南,2023-02-21,9896
00665L,富邦�琤肭磪囓�2,62,0,62,元大-台南,2023-02-21,9896
00720B,元大投資級公司債,61,0,61,元大-台南,2023-02-21,9896
00878,國泰永續高股息,95,36,59,元大-台南,2023-02-21,9896
00637L,元大滬深300正2,61,3,58,元大-台南,2023-02-21,9896
00680L,元大美債20正2,52,0,52,元大-台南,2023-02-21,9896
2610,華航,93,46,47,元大-台南,2023-02-21,9896
1101,台泥,49,3,46,元大-台南,2023-02-21,9896
2367,燿華,47,3,44,元大-台南,2023-02-21,9896
1506,正道,43,3,40,元大-台南,2023-02-21,9896
3710,連展投控,40,3,37,元大-台南,2023-02-21,9896
2867,三商壽,35,0,35,元大-台南,2023-02-21,9896
6517,保勝光學,31,0,31,元大-台南,2023-02-21,9896
6187,萬潤,28,0,28,元大-台南,2023-02-21,9896
00715L,期街口布蘭特正2,27,0,27,元大-台南,2023-02-21,9896
2882,國泰金,26,1,25,元大-台南,2023-02-21,9896
2313,華通,25,0,25,元大-台南,2023-02-21,9896
2344,華邦電,35,11,24,元大-台南,2023-02-21,9896
4931,新盛力,33,10,23,元大-台南,2023-02-21,9896
8069,元太,73,50,23,元大-台南,2023-02-21,9896
5009,榮剛,28,6,22,元大-台南,2023-02-21,9896
4968,立積,40,19,21,元大-台南,2023-02-21,9896
00900,富邦特選高股息30,21,0,21,元大-台南,2023-02-21,9896
6285,啟��,20,0,20,元大-台南,2023-02-21,9896
4566,時碩工業,20,0,20,元大-台南,2023-02-21,9896
2358,廷鑫,20,0,20,元大-台南,2023-02-21,9896
6266,泰詠,25,8,17,元大-台南,2023-02-21,9896
1736,喬山,16,0,16,元大-台南,2023-02-21,9896
1605,華新,51,36,15,元大-台南,2023-02-21,9896
6752,叡揚,15,0,15,元大-台南,2023-02-21,9896
1503,士電,22,8,14,元大-台南,2023-02-21,9896
8936,國統,28,14,14,元大-台南,2023-02-21,9896
2317,鴻海,14,1,13,元大-台南,2023-02-21,9896
1513,中興電,49,36,13,元大-台南,2023-02-21,9896
00725B,國泰投資級公司債,14,1,13,元大-台南,2023-02-21,9896
8176,智捷,13,0,13,元大-台南,2023-02-21,9896
2881,富邦金,12,0,12,元大-台南,2023-02-21,9896
3022,威強電,13,1,12,元大-台南,2023-02-21,9896
6015,宏遠證,12,0,12,元大-台南,2023-02-21,9896
1609,大亞,20,8,12,元大-台南,2023-02-21,9896
1524,耿鼎,17,6,11,元大-台南,2023-02-21,9896
6142,友勁,11,0,11,元大-台南,2023-02-21,9896
1449,佳和,11,0,11,元大-台南,2023-02-21,9896
4977,眾達-KY,18,7,11,元大-台南,2023-02-21,9896
00632R,元大台灣50反1,313,136,177,元大-台南,2023-02-22,9896
00878,國泰永續高股息,233,70,163,元大-台南,2023-02-22,9896
00676R,富邦臺灣加權反1,158,0,158,元大-台南,2023-02-22,9896
3419,譁裕,78,3,75,元大-台南,2023-02-22,9896
6235,華孚,151,83,68,元大-台南,2023-02-22,9896
2603,長榮,76,18,58,元大-台南,2023-02-22,9896
00712,復華富時不動產,43,0,43,元大-台南,2023-02-22,9896
2344,華邦電,43,1,42,元大-台南,2023-02-22,9896
2812,台中銀,62,20,42,元大-台南,2023-02-22,9896
3035,智原,47,7,40,元大-台南,2023-02-22,9896
3710,連展投控,40,0,40,元大-台南,2023-02-22,9896
4960,誠美材,40,3,37,元大-台南,2023-02-22,9896
8033,雷虎,42,6,36,元大-台南,2023-02-22,9896
2547,日勝生,34,0,34,元大-台南,2023-02-22,9896
1513,中興電,65,31,34,元大-台南,2023-02-22,9896
6116,彩晶,70,38,32,元大-台南,2023-02-22,9896
4931,新盛力,33,1,32,元大-台南,2023-02-22,9896
1605,華新,49,18,31,元大-台南,2023-02-22,9896
3276,宇環,30,0,30,元大-台南,2023-02-22,9896
6443,元晶,32,6,26,元大-台南,2023-02-22,9896
00772B,中信高評級公司債,24,0,24,元大-台南,2023-02-22,9896
5880,合庫金,22,0,22,元大-台南,2023-02-22,9896
00720B,元大投資級公司債,21,0,21,元大-台南,2023-02-22,9896
8227,巨有科技,19,0,19,元大-台南,2023-02-22,9896
1342,八貫,33,14,19,元大-台南,2023-02-22,9896
4167,松瑞藥,18,0,18,元大-台南,2023-02-22,9896
0056,元大高股息,42,24,18,元大-台南,2023-02-22,9896
00751B,元大AAA至A公司債,19,2,17,元大-台南,2023-02-22,9896
6282,康舒,41,24,17,元大-台南,2023-02-22,9896
1717,長興,20,3,17,元大-台南,2023-02-22,9896
3037,欣興,24,7,17,元大-台南,2023-02-22,9896
2330,台積電,22,5,17,元大-台南,2023-02-22,9896
2303,聯電,23,8,15,元大-台南,2023-02-22,9896
00916,國泰全球品牌50,15,0,15,元大-台南,2023-02-22,9896
1785,光洋科,25,10,15,元大-台南,2023-02-22,9896
1722,台肥,16,1,15,元大-台南,2023-02-22,9896
00885,富邦越南,14,0,14,元大-台南,2023-02-22,9896
4979,華星光,13,0,13,元大-台南,2023-02-22,9896
0050,元大台灣50,13,0,13,元大-台南,2023-02-22,9896
4977,眾達-KY,14,1,13,元大-台南,2023-02-22,9896
00902,中信電池及儲能,12,0,12,元大-台南,2023-02-22,9896
00642U,期元大S＆P石油,12,0,12,元大-台南,2023-02-22,9896
3362,先進光,12,1,11,元大-台南,2023-02-22,9896
2105,正新,11,0,11,元大-台南,2023-02-22,9896
6770,力積電,14,3,11,元大-台南,2023-02-22,9896
2485,兆赫,11,0,11,元大-台南,2023-02-22,9896
2317,鴻海,17,7,10,元大-台南,2023-02-22,9896
2353,宏��,11,1,10,元大-台南,2023-02-22,9896
00665L,富邦�琤肭磪囓�2,10,0,10,元大-台南,2023-02-22,9896
2888,新光金,15,5,10,元大-台南,2023-02-22,9896
00632R,元大台灣50反1,3322,200,3122,元大-台南,2023-02-23,9896
2344,華邦電,1523,23,1500,元大-台南,2023-02-23,9896
5880,合庫金,359,0,359,元大-台南,2023-02-23,9896
00676R,富邦臺灣加權反1,159,0,159,元大-台南,2023-02-23,9896
00642U,期元大S＆P石油,118,2,116,元大-台南,2023-02-23,9896
4960,誠美材,118,12,106,元大-台南,2023-02-23,9896
00715L,期街口布蘭特正2,82,0,82,元大-台南,2023-02-23,9896
6806,森崴能源,81,2,79,元大-台南,2023-02-23,9896
5608,四維航,80,9,71,元大-台南,2023-02-23,9896
6116,彩晶,63,1,62,元大-台南,2023-02-23,9896
00664R,國泰臺灣加權反1,51,0,51,元大-台南,2023-02-23,9896
2812,台中銀,52,2,50,元大-台南,2023-02-23,9896
3708,上緯投控,55,7,48,元大-台南,2023-02-23,9896
2303,聯電,60,15,45,元大-台南,2023-02-23,9896
1444,力麗,71,26,45,元大-台南,2023-02-23,9896
3508,位速,43,1,42,元大-台南,2023-02-23,9896
1605,華新,56,20,36,元大-台南,2023-02-23,9896
2408,南亞科,36,4,32,元大-台南,2023-02-23,9896
2883,凱基金,36,5,31,元大-台南,2023-02-23,9896
00631L,元大台灣50正2,31,0,31,元大-台南,2023-02-23,9896
5512,力麒,42,13,29,元大-台南,2023-02-23,9896
2610,華航,35,8,27,元大-台南,2023-02-23,9896
00878,國泰永續高股息,49,22,27,元大-台南,2023-02-23,9896
00891,中信關鍵半導體,25,1,24,元大-台南,2023-02-23,9896
8936,國統,31,8,23,元大-台南,2023-02-23,9896
3481,群創,41,18,23,元大-台南,2023-02-23,9896
00720B,元大投資級公司債,23,1,22,元大-台南,2023-02-23,9896
1584,精剛,30,8,22,元大-台南,2023-02-23,9896
1519,華城,24,2,22,元大-台南,2023-02-23,9896
1301,台塑,20,1,19,元大-台南,2023-02-23,9896
6228,全譜,18,0,18,元大-台南,2023-02-23,9896
2618,長榮航,22,5,17,元大-台南,2023-02-23,9896
5905,南仁湖,69,52,17,元大-台南,2023-02-23,9896
2029,盛餘,17,0,17,元大-台南,2023-02-23,9896
2027,大成鋼,18,1,17,元大-台南,2023-02-23,9896
2208,台船,24,8,16,元大-台南,2023-02-23,9896
4770,上品,25,9,16,元大-台南,2023-02-23,9896
2705,六福,16,0,16,元大-台南,2023-02-23,9896
5364,力麗店,16,0,16,元大-台南,2023-02-23,9896
5222,全訊,16,0,16,元大-台南,2023-02-23,9896
3094,聯傑,24,8,16,元大-台南,2023-02-23,9896
4904,遠傳,15,0,15,元大-台南,2023-02-23,9896
00772B,中信高評級公司債,15,0,15,元大-台南,2023-02-23,9896
3224,三顧,14,0,14,元大-台南,2023-02-23,9896
2471,資通,18,4,14,元大-台南,2023-02-23,9896
2332,友訊,16,2,14,元大-台南,2023-02-23,9896
2308,台達電,37,24,13,元大-台南,2023-02-23,9896
00751B,元大AAA至A公司債,13,0,13,元大-台南,2023-02-23,9896
2601,益航,22,9,13,元大-台南,2023-02-23,9896
6285,啟��,16,3,13,元大-台南,2023-02-23,9896
2014,中鴻,119,15,104,元大-台南,2023-02-24,9896
00878,國泰永續高股息,100,9,91,元大-台南,2023-02-24,9896
2601,益航,105,16,89,元大-台南,2023-02-24,9896
2641,正德,64,4,60,元大-台南,2023-02-24,9896
00637L,元大滬深300正2,52,3,49,元大-台南,2023-02-24,9896
5009,榮剛,74,32,42,元大-台南,2023-02-24,9896
2317,鴻海,45,5,40,元大-台南,2023-02-24,9896
3481,群創,73,34,39,元大-台南,2023-02-24,9896
2615,萬海,62,24,38,元大-台南,2023-02-24,9896
2812,台中銀,39,2,37,元大-台南,2023-02-24,9896
3708,上緯投控,40,4,36,元大-台南,2023-02-24,9896
3264,欣銓,35,1,34,元大-台南,2023-02-24,9896
00642U,期元大S＆P石油,51,17,34,元大-台南,2023-02-24,9896
3037,欣興,41,8,33,元大-台南,2023-02-24,9896
00882,中信中國高股息,41,10,31,元大-台南,2023-02-24,9896
4930,燦星網,28,0,28,元大-台南,2023-02-24,9896
3006,晶豪科,32,4,28,元大-台南,2023-02-24,9896
2610,華航,39,11,28,元大-台南,2023-02-24,9896
3710,連展投控,27,0,27,元大-台南,2023-02-24,9896
2897,王道銀行,26,0,26,元大-台南,2023-02-24,9896
00905,FT臺灣Smart,23,0,23,元大-台南,2023-02-24,9896
2388,威盛,99,79,20,元大-台南,2023-02-24,9896
2618,長榮航,22,2,20,元大-台南,2023-02-24,9896
2367,燿華,20,0,20,元大-台南,2023-02-24,9896
2883,凱基金,20,0,20,元大-台南,2023-02-24,9896
3673,TPK-KY,21,1,20,元大-台南,2023-02-24,9896
5703,亞都,22,3,19,元大-台南,2023-02-24,9896
4968,立積,22,4,18,元大-台南,2023-02-24,9896
8150,南茂,21,3,18,元大-台南,2023-02-24,9896
1444,力麗,16,0,16,元大-台南,2023-02-24,9896
00632R,元大台灣50反1,59,44,15,元大-台南,2023-02-24,9896
00679B,元大美債20年,17,2,15,元大-台南,2023-02-24,9896
3078,僑威,15,0,15,元大-台南,2023-02-24,9896
2303,聯電,17,3,14,元大-台南,2023-02-24,9896
6290,良維,15,2,13,元大-台南,2023-02-24,9896
6469,大樹,13,0,13,元大-台南,2023-02-24,9896
2885,元大金,14,1,13,元大-台南,2023-02-24,9896
2886,兆豐金,12,0,12,元大-台南,2023-02-24,9896
8928,鉅明,12,0,12,元大-台南,2023-02-24,9896
2474,可成,19,7,12,元大-台南,2023-02-24,9896
00753L,中信中國50正2,12,0,12,元大-台南,2023-02-24,9896
9935,慶豐富,12,0,12,元大-台南,2023-02-24,9896
2330,台積電,16,4,12,元大-台南,2023-02-24,9896
5443,均豪,11,0,11,元大-台南,2023-02-24,9896
2105,正新,11,0,11,元大-台南,2023-02-24,9896
6129,普誠,11,0,11,元大-台南,2023-02-24,9896
6266,泰詠,14,3,11,元大-台南,2023-02-24,9896
5258,虹堡,32,21,11,元大-台南,2023-02-24,9896
00895,富邦未來車,10,0,10,元大-台南,2023-02-24,9896
4763,材料-KY,41,31,10,元大-台南,2023-02-24,9896
6116,彩晶,612,5,607,元大-台南,2023-03-01,9896
00878,國泰永續高股息,165,2,163,元大-台南,2023-03-01,9896
8069,元太,158,0,158,元大-台南,2023-03-01,9896
5009,榮剛,157,9,148,元大-台南,2023-03-01,9896
5880,合庫金,143,0,143,元大-台南,2023-03-01,9896
3481,群創,117,0,117,元大-台南,2023-03-01,9896
1605,華新,115,13,102,元大-台南,2023-03-01,9896
00664R,國泰臺灣加權反1,100,0,100,元大-台南,2023-03-01,9896
8936,國統,126,30,96,元大-台南,2023-03-01,9896
2324,仁寶,71,1,70,元大-台南,2023-03-01,9896
2002,中鋼,80,32,48,元大-台南,2023-03-01,9896
1101,台泥,64,19,45,元大-台南,2023-03-01,9896
2605,新興,85,45,40,元大-台南,2023-03-01,9896
2618,長榮航,48,9,39,元大-台南,2023-03-01,9896
6228,全譜,36,0,36,元大-台南,2023-03-01,9896
2317,鴻海,41,5,36,元大-台南,2023-03-01,9896
5608,四維航,48,15,33,元大-台南,2023-03-01,9896
00712,復華富時不動產,32,1,31,元大-台南,2023-03-01,9896
2885,元大金,29,0,29,元大-台南,2023-03-01,9896
00720B,元大投資級公司債,24,0,24,元大-台南,2023-03-01,9896
2637,慧洋-KY,40,17,23,元大-台南,2023-03-01,9896
8050,廣積,27,5,22,元大-台南,2023-03-01,9896
2610,華航,57,36,21,元大-台南,2023-03-01,9896
2892,第一金,23,2,21,元大-台南,2023-03-01,9896
6770,力積電,21,1,20,元大-台南,2023-03-01,9896
4142,國光生,20,0,20,元大-台南,2023-03-01,9896
2615,萬海,24,6,18,元大-台南,2023-03-01,9896
2606,裕民,38,21,17,元大-台南,2023-03-01,9896
2883,凱基金,17,0,17,元大-台南,2023-03-01,9896
1314,中石化,17,0,17,元大-台南,2023-03-01,9896
00773B,中信優先金融債,16,0,16,元大-台南,2023-03-01,9896
00772B,中信高評級公司債,16,1,15,元大-台南,2023-03-01,9896
6541,泰福-KY,15,0,15,元大-台南,2023-03-01,9896
2601,益航,30,16,14,元大-台南,2023-03-01,9896
8033,雷虎,14,0,14,元大-台南,2023-03-01,9896
4747,強生,13,0,13,元大-台南,2023-03-01,9896
5353,台林,17,5,12,元大-台南,2023-03-01,9896
2027,大成鋼,12,0,12,元大-台南,2023-03-01,9896
1217,愛之味,12,0,12,元大-台南,2023-03-01,9896
2344,華邦電,33,21,12,元大-台南,2023-03-01,9896
00900,富邦特選高股息30,12,1,11,元大-台南,2023-03-01,9896
6264,富裔,11,0,11,元大-台南,2023-03-01,9896
2881,富邦金,13,3,10,元大-台南,2023-03-01,9896
3313,斐成,10,0,10,元大-台南,2023-03-01,9896
5864,致和證,10,0,10,元大-台南,2023-03-01,9896
00676R,富邦臺灣加權反1,10,0,10,元大-台南,2023-03-01,9896
2421,建準,10,0,10,元大-台南,2023-03-01,9896
5512,力麒,13,3,10,元大-台南,2023-03-01,9896
00795B,中信美國公債20年,10,0,10,元大-台南,2023-03-01,9896
5464,霖宏,13,4,9,元大-台南,2023-03-01,9896
00878,國泰永續高股息,207,42,165,元大-台南,2023-03-02,9896
1605,華新,162,79,83,元大-台南,2023-03-02,9896
1609,大亞,89,10,79,元大-台南,2023-03-02,9896
6235,華孚,113,51,62,元大-台南,2023-03-02,9896
00712,復華富時不動產,56,0,56,元大-台南,2023-03-02,9896
6841,長佳智能,38,2,36,元大-台南,2023-03-02,9896
2886,兆豐金,38,2,36,元大-台南,2023-03-02,9896
6116,彩晶,59,26,33,元大-台南,2023-03-02,9896
00772B,中信高評級公司債,33,3,30,元大-台南,2023-03-02,9896
6167,久正,30,0,30,元大-台南,2023-03-02,9896
00720B,元大投資級公司債,29,0,29,元大-台南,2023-03-02,9896
00773B,中信優先金融債,26,0,26,元大-台南,2023-03-02,9896
2409,友達,52,26,26,元大-台南,2023-03-02,9896
2892,第一金,30,5,25,元大-台南,2023-03-02,9896
5880,合庫金,24,0,24,元大-台南,2023-03-02,9896
2340,台亞,25,2,23,元大-台南,2023-03-02,9896
3481,群創,26,5,21,元大-台南,2023-03-02,9896
3673,TPK-KY,20,0,20,元大-台南,2023-03-02,9896
1722,台肥,20,0,20,元大-台南,2023-03-02,9896
00722B,群益投資級電信債,20,0,20,元大-台南,2023-03-02,9896
3594,磐儀,21,2,19,元大-台南,2023-03-02,9896
1762,中化生,21,3,18,元大-台南,2023-03-02,9896
00632R,元大台灣50反1,25,8,17,元大-台南,2023-03-02,9896
2883,凱基金,17,0,17,元大-台南,2023-03-02,9896
1101,台泥,19,3,16,元大-台南,2023-03-02,9896
2367,燿華,17,1,16,元大-台南,2023-03-02,9896
5512,力麒,21,5,16,元大-台南,2023-03-02,9896
2609,陽明,53,38,15,元大-台南,2023-03-02,9896
2482,連宇,16,1,15,元大-台南,2023-03-02,9896
1444,力麗,15,0,15,元大-台南,2023-03-02,9896
2457,飛宏,15,1,14,元大-台南,2023-03-02,9896
00679B,元大美債20年,13,0,13,元大-台南,2023-03-02,9896
3430,奇鈦科,13,0,13,元大-台南,2023-03-02,9896
2891,中信金,13,0,13,元大-台南,2023-03-02,9896
3189,景碩,14,1,13,元大-台南,2023-03-02,9896
3027,盛達,27,14,13,元大-台南,2023-03-02,9896
00885,富邦越南,14,1,13,元大-台南,2023-03-02,9896
6266,泰詠,13,1,12,元大-台南,2023-03-02,9896
2201,裕隆,17,5,12,元大-台南,2023-03-02,9896
2498,宏達電,29,17,12,元大-台南,2023-03-02,9896
2505,國揚,12,0,12,元大-台南,2023-03-02,9896
2230,泰茂,17,5,12,元大-台南,2023-03-02,9896
6228,全譜,11,0,11,元大-台南,2023-03-02,9896
2014,中鴻,16,5,11,元大-台南,2023-03-02,9896
2897,王道銀行,11,0,11,元大-台南,2023-03-02,9896
2330,台積電,13,3,10,元大-台南,2023-03-02,9896
5519,隆大,10,0,10,元大-台南,2023-03-02,9896
8093,保銳,10,0,10,元大-台南,2023-03-02,9896
8044,網家,10,0,10,元大-台南,2023-03-02,9896
8289,泰藝,10,0,10,元大-台南,2023-03-02,9896
3481,群創,1327,138,1189,元大-台南,2023-03-03,9896
6116,彩晶,255,151,104,元大-台南,2023-03-03,9896
4938,和碩,90,1,89,元大-台南,2023-03-03,9896
8050,廣積,50,12,38,元大-台南,2023-03-03,9896
00878,國泰永續高股息,38,2,36,元大-台南,2023-03-03,9896
6488,環球晶,32,0,32,元大-台南,2023-03-03,9896
00673R,期元大S＆P原油反1,31,0,31,元大-台南,2023-03-03,9896
00773B,中信優先金融債,27,0,27,元大-台南,2023-03-03,9896
00885,富邦越南,26,0,26,元大-台南,2023-03-03,9896
5425,台半,30,7,23,元大-台南,2023-03-03,9896
00679B,元大美債20年,21,1,20,元大-台南,2023-03-03,9896
2337,旺宏,21,1,20,元大-台南,2023-03-03,9896
2408,南亞科,21,1,20,元大-台南,2023-03-03,9896
2615,萬海,23,4,19,元大-台南,2023-03-03,9896
2867,三商壽,18,0,18,元大-台南,2023-03-03,9896
5315,光聯,17,1,16,元大-台南,2023-03-03,9896
00712,復華富時不動產,15,0,15,元大-台南,2023-03-03,9896
2881,富邦金,15,0,15,元大-台南,2023-03-03,9896
8033,雷虎,18,3,15,元大-台南,2023-03-03,9896
00720B,元大投資級公司債,14,0,14,元大-台南,2023-03-03,9896
2892,第一金,14,0,14,元大-台南,2023-03-03,9896
5452,佶優,14,0,14,元大-台南,2023-03-03,9896
2324,仁寶,15,1,14,元大-台南,2023-03-03,9896
2915,潤泰全,14,0,14,元大-台南,2023-03-03,9896
9935,慶豐富,14,0,14,元大-台南,2023-03-03,9896
1605,華新,35,22,13,元大-台南,2023-03-03,9896
1471,首利,27,14,13,元大-台南,2023-03-03,9896
2897,王道銀行,12,0,12,元大-台南,2023-03-03,9896
2478,大毅,15,3,12,元大-台南,2023-03-03,9896
1529,樂事綠能,15,3,12,元大-台南,2023-03-03,9896
0056,元大高股息,20,8,12,元大-台南,2023-03-03,9896
2886,兆豐金,11,1,10,元大-台南,2023-03-03,9896
00751B,元大AAA至A公司債,10,0,10,元大-台南,2023-03-03,9896
2327,國巨,14,4,10,元大-台南,2023-03-03,9896
2748,雲品,10,0,10,元大-台南,2023-03-03,9896
3594,磐儀,12,2,10,元大-台南,2023-03-03,9896
3706,神達,11,1,10,元大-台南,2023-03-03,9896
1460,宏遠,10,0,10,元大-台南,2023-03-03,9896
2505,國揚,10,0,10,元大-台南,2023-03-03,9896
5347,世界,11,2,9,元大-台南,2023-03-03,9896
6728,上洋,9,0,9,元大-台南,2023-03-03,9896
2007,燁興,8,0,8,元大-台南,2023-03-03,9896
3260,威剛,8,0,8,元大-台南,2023-03-03,9896
3049,精金,9,1,8,元大-台南,2023-03-03,9896
00676R,富邦臺灣加權反1,8,0,8,元大-台南,2023-03-03,9896
2883,凱基金,8,0,8,元大-台南,2023-03-03,9896
5364,力麗店,12,4,8,元大-台南,2023-03-03,9896
2888,新光金,11,3,8,元大-台南,2023-03-03,9896
6191,精成科,10,2,8,元大-台南,2023-03-03,9896
1432,大魯閣,8,0,8,元大-台南,2023-03-03,9896
00673R,期元大S＆P原油反1,325,0,325,元大-台南,2023-03-06,9896
2891,中信金,117,8,109,元大-台南,2023-03-06,9896
3078,僑威,102,13,89,元大-台南,2023-03-06,9896
2609,陽明,99,15,84,元大-台南,2023-03-06,9896
3702,大聯大,82,0,82,元大-台南,2023-03-06,9896
2359,所羅門,64,2,62,元大-台南,2023-03-06,9896
1217,愛之味,52,1,51,元大-台南,2023-03-06,9896
9105,泰金寶-DR,50,0,50,元大-台南,2023-03-06,9896
9945,潤泰新,50,0,50,元大-台南,2023-03-06,9896
2344,華邦電,76,34,42,元大-台南,2023-03-06,9896
00637L,元大滬深300正2,42,4,38,元大-台南,2023-03-06,9896
2313,華通,38,4,34,元大-台南,2023-03-06,9896
2007,燁興,32,0,32,元大-台南,2023-03-06,9896
4919,新唐,124,97,27,元大-台南,2023-03-06,9896
3276,宇環,23,0,23,元大-台南,2023-03-06,9896
2201,裕隆,22,0,22,元大-台南,2023-03-06,9896
8473,山林水,20,0,20,元大-台南,2023-03-06,9896
6205,詮欣,20,0,20,元大-台南,2023-03-06,9896
2505,國揚,17,0,17,元大-台南,2023-03-06,9896
1471,首利,26,10,16,元大-台南,2023-03-06,9896
2605,新興,30,14,16,元大-台南,2023-03-06,9896
1101,台泥,20,5,15,元大-台南,2023-03-06,9896
8289,泰藝,39,24,15,元大-台南,2023-03-06,9896
2409,友達,46,31,15,元大-台南,2023-03-06,9896
006208,富邦台50,14,0,14,元大-台南,2023-03-06,9896
5443,均豪,13,0,13,元大-台南,2023-03-06,9896
3236,千如,12,0,12,元大-台南,2023-03-06,9896
3362,先進光,69,57,12,元大-台南,2023-03-06,9896
4503,金雨,11,0,11,元大-台南,2023-03-06,9896
2897,王道銀行,13,2,11,元大-台南,2023-03-06,9896
1527,鑽全,10,0,10,元大-台南,2023-03-06,9896
2358,廷鑫,10,0,10,元大-台南,2023-03-06,9896
00752,中信中國50,20,10,10,元大-台南,2023-03-06,9896
00669R,國泰美國道瓊反1,10,0,10,元大-台南,2023-03-06,9896
1465,偉全,10,0,10,元大-台南,2023-03-06,9896
6841,長佳智能,12,2,10,元大-台南,2023-03-06,9896
4904,遠傳,10,0,10,元大-台南,2023-03-06,9896
1210,大成,13,3,10,元大-台南,2023-03-06,9896
2834,臺企銀,16,7,9,元大-台南,2023-03-06,9896
00679B,元大美債20年,11,1,10,元大-台南,2023-03-06,9896
2886,兆豐金,10,1,9,元大-台南,2023-03-06,9896
3006,晶豪科,12,3,9,元大-台南,2023-03-06,9896
4167,松瑞藥,12,3,9,元大-台南,2023-03-06,9896
1220,台榮,10,1,9,元大-台南,2023-03-06,9896
1734,杏輝,9,0,9,元大-台南,2023-03-06,9896
6442,光聖,9,0,9,元大-台南,2023-03-06,9896
8358,金居,9,1,8,元大-台南,2023-03-06,9896
8150,南茂,9,1,8,元大-台南,2023-03-06,9896
1227,佳格,9,1,8,元大-台南,2023-03-06,9896
00712,復華富時不動產,8,0,8,元大-台南,2023-03-06,9896
00673R,期元大S＆P原油反1,535,0,535,元大-台南,2023-03-07,9896
2317,鴻海,208,29,179,元大-台南,2023-03-07,9896
00665L,富邦�琤肭磪囓�2,77,18,59,元大-台南,2023-03-07,9896
1605,華新,143,90,53,元大-台南,2023-03-07,9896
2881,富邦金,52,2,50,元大-台南,2023-03-07,9896
00679B,元大美債20年,48,0,48,元大-台南,2023-03-07,9896
6266,泰詠,50,2,48,元大-台南,2023-03-07,9896
2634,漢翔,51,5,46,元大-台南,2023-03-07,9896
3481,群創,90,46,44,元大-台南,2023-03-07,9896
1529,樂事綠能,41,0,41,元大-台南,2023-03-07,9896
5452,佶優,43,4,39,元大-台南,2023-03-07,9896
00885,富邦越南,41,3,38,元大-台南,2023-03-07,9896
1513,中興電,94,58,36,元大-台南,2023-03-07,9896
2409,友達,146,115,31,元大-台南,2023-03-07,9896
6226,光鼎,30,0,30,元大-台南,2023-03-07,9896
2486,一詮,32,7,25,元大-台南,2023-03-07,9896
6269,台郡,25,0,25,元大-台南,2023-03-07,9896
2609,陽明,39,14,25,元大-台南,2023-03-07,9896
6547,高端疫苗,26,2,24,元大-台南,2023-03-07,9896
4540,全球傳動,23,0,23,元大-台南,2023-03-07,9896
3059,華晶科,22,0,22,元大-台南,2023-03-07,9896
2344,華邦電,31,9,22,元大-台南,2023-03-07,9896
9935,慶豐富,22,0,22,元大-台南,2023-03-07,9896
2610,華航,22,1,21,元大-台南,2023-03-07,9896
1409,新纖,21,0,21,元大-台南,2023-03-07,9896
8111,立��,20,0,20,元大-台南,2023-03-07,9896
2352,佳世達,21,4,17,元大-台南,2023-03-07,9896
6472,保瑞,16,0,16,元大-台南,2023-03-07,9896
1514,亞力,24,8,16,元大-台南,2023-03-07,9896
00637L,元大滬深300正2,21,5,16,元大-台南,2023-03-07,9896
8071,能率網通,15,0,15,元大-台南,2023-03-07,9896
6026,福邦證,15,1,14,元大-台南,2023-03-07,9896
4915,致伸,17,3,14,元大-台南,2023-03-07,9896
8112,至上,14,0,14,元大-台南,2023-03-07,9896
6282,康舒,21,9,12,元大-台南,2023-03-07,9896
4736,泰博,12,0,12,元大-台南,2023-03-07,9896
4541,晟田,12,0,12,元大-台南,2023-03-07,9896
2405,輔信,12,0,12,元大-台南,2023-03-07,9896
6015,宏遠證,12,0,12,元大-台南,2023-03-07,9896
3013,晟銘電,18,7,11,元大-台南,2023-03-07,9896
8938,明安,11,0,11,元大-台南,2023-03-07,9896
5410,國眾,11,0,11,元大-台南,2023-03-07,9896
9945,潤泰新,11,0,11,元大-台南,2023-03-07,9896
2615,萬海,15,4,11,元大-台南,2023-03-07,9896
00712,復華富時不動產,11,0,11,元大-台南,2023-03-07,9896
00878,國泰永續高股息,24,13,11,元大-台南,2023-03-07,9896
00713,元大台灣高息低波,12,1,11,元大-台南,2023-03-07,9896
1762,中化生,11,0,11,元大-台南,2023-03-07,9896
1503,士電,30,19,11,元大-台南,2023-03-07,9896
4904,遠傳,10,0,10,元大-台南,2023-03-07,9896
00632R,元大台灣50反1,4017,13,4004,元大-台南,2023-03-08,9896
00676R,富邦臺灣加權反1,152,0,152,元大-台南,2023-03-08,9896
00673R,期元大S＆P原油反1,154,64,90,元大-台南,2023-03-08,9896
6770,力積電,64,6,58,元大-台南,2023-03-08,9896
00637L,元大滬深300正2,60,5,55,元大-台南,2023-03-08,9896
1504,東元,54,10,44,元大-台南,2023-03-08,9896
1308,亞聚,46,4,42,元大-台南,2023-03-08,9896
2317,鴻海,44,3,41,元大-台南,2023-03-08,9896
00885,富邦越南,40,0,40,元大-台南,2023-03-08,9896
2610,華航,36,1,35,元大-台南,2023-03-08,9896
6509,聚和,51,17,34,元大-台南,2023-03-08,9896
1519,華城,70,36,34,元大-台南,2023-03-08,9896
00900,富邦特選高股息30,37,3,34,元大-台南,2023-03-08,9896
2413,環科,33,1,32,元大-台南,2023-03-08,9896
00882,中信中國高股息,40,10,30,元大-台南,2023-03-08,9896
1584,精剛,36,6,30,元大-台南,2023-03-08,9896
1605,華新,60,32,28,元大-台南,2023-03-08,9896
2482,連宇,40,13,27,元大-台南,2023-03-08,9896
2634,漢翔,63,37,26,元大-台南,2023-03-08,9896
2603,長榮,67,43,24,元大-台南,2023-03-08,9896
1722,台肥,24,0,24,元大-台南,2023-03-08,9896
5230,雷笛克光學,20,0,20,元大-台南,2023-03-08,9896
3035,智原,33,14,19,元大-台南,2023-03-08,9896
2867,三商壽,19,0,19,元大-台南,2023-03-08,9896
2371,大同,19,1,18,元大-台南,2023-03-08,9896
4541,晟田,77,59,18,元大-台南,2023-03-08,9896
1709,和益,17,0,17,元大-台南,2023-03-08,9896
8150,南茂,24,8,16,元大-台南,2023-03-08,9896
00679B,元大美債20年,26,11,15,元大-台南,2023-03-08,9896
2376,技嘉,15,0,15,元大-台南,2023-03-08,9896
2886,兆豐金,28,14,14,元大-台南,2023-03-08,9896
1795,美時,34,20,14,元大-台南,2023-03-08,9896
00753L,中信中國50正2,14,0,14,元大-台南,2023-03-08,9896
00772B,中信高評級公司債,13,0,13,元大-台南,2023-03-08,9896
1514,亞力,18,5,13,元大-台南,2023-03-08,9896
5512,力麒,14,1,13,元大-台南,2023-03-08,9896
3706,神達,13,0,13,元大-台南,2023-03-08,9896
1101,台泥,16,3,13,元大-台南,2023-03-08,9896
2368,金像電,12,0,12,元大-台南,2023-03-08,9896
00633L,富邦上証正2,12,0,12,元大-台南,2023-03-08,9896
00712,復華富時不動產,16,5,11,元大-台南,2023-03-08,9896
2201,裕隆,24,13,11,元大-台南,2023-03-08,9896
1597,直得,13,2,11,元大-台南,2023-03-08,9896
00752,中信中國50,11,0,11,元大-台南,2023-03-08,9896
00893,國泰智能電動車,11,0,11,元大-台南,2023-03-08,9896
00715L,期街口布蘭特正2,11,0,11,元大-台南,2023-03-08,9896
4930,燦星網,11,0,11,元大-台南,2023-03-08,9896
1102,亞泥,11,1,10,元大-台南,2023-03-08,9896
2328,廣宇,11,1,10,元大-台南,2023-03-08,9896
3390,旭軟,10,0,10,元大-台南,2023-03-08,9896
2313,華通,183,6,177,元大-台南,2023-03-09,9896
2317,鴻海,141,2,139,元大-台南,2023-03-09,9896
5009,榮剛,136,32,104,元大-台南,2023-03-09,9896
6282,康舒,84,26,58,元大-台南,2023-03-09,9896
2457,飛宏,173,118,55,元大-台南,2023-03-09,9896
00885,富邦越南,107,57,50,元大-台南,2023-03-09,9896
8289,泰藝,50,7,43,元大-台南,2023-03-09,9896
3217,優群,40,0,40,元大-台南,2023-03-09,9896
6116,彩晶,74,36,38,元大-台南,2023-03-09,9896
2367,燿華,39,2,37,元大-台南,2023-03-09,9896
2886,兆豐金,34,0,34,元大-台南,2023-03-09,9896
00878,國泰永續高股息,42,9,33,元大-台南,2023-03-09,9896
2836,高雄銀,30,0,30,元大-台南,2023-03-09,9896
2495,普安,30,2,28,元大-台南,2023-03-09,9896
3022,威強電,47,19,28,元大-台南,2023-03-09,9896
2888,新光金,28,0,28,元大-台南,2023-03-09,9896
00712,復華富時不動產,27,0,27,元大-台南,2023-03-09,9896
6443,元晶,25,0,25,元大-台南,2023-03-09,9896
00882,中信中國高股息,28,3,25,元大-台南,2023-03-09,9896
5443,均豪,24,0,24,元大-台南,2023-03-09,9896
2027,大成鋼,25,1,24,元大-台南,2023-03-09,9896
8222,寶一,85,61,24,元大-台南,2023-03-09,9896
1708,東鹼,23,0,23,元大-台南,2023-03-09,9896
8358,金居,23,1,22,元大-台南,2023-03-09,9896
2409,友達,29,9,20,元大-台南,2023-03-09,9896
00637L,元大滬深300正2,27,7,20,元大-台南,2023-03-09,9896
2542,興富發,20,0,20,元大-台南,2023-03-09,9896
00706L,期元大S＆P日圓正2,20,0,20,元大-台南,2023-03-09,9896
5471,松翰,20,0,20,元大-台南,2023-03-09,9896
3041,揚智,20,0,20,元大-台南,2023-03-09,9896
1609,大亞,26,6,20,元大-台南,2023-03-09,9896
00713,元大台灣高息低波,21,1,20,元大-台南,2023-03-09,9896
3290,東浦,35,16,19,元大-台南,2023-03-09,9896
4979,華星光,22,3,19,元大-台南,2023-03-09,9896
4707,磐亞,24,6,18,元大-台南,2023-03-09,9896
2884,玉山金,17,0,17,元大-台南,2023-03-09,9896
1513,中興電,45,29,16,元大-台南,2023-03-09,9896
3209,全科,16,1,15,元大-台南,2023-03-09,9896
2610,華航,248,233,15,元大-台南,2023-03-09,9896
2359,所羅門,123,108,15,元大-台南,2023-03-09,9896
4968,立積,15,0,15,元大-台南,2023-03-09,9896
6187,萬潤,15,0,15,元大-台南,2023-03-09,9896
3188,鑫龍騰,15,0,15,元大-台南,2023-03-09,9896
2881,富邦金,14,0,14,元大-台南,2023-03-09,9896
5525,順天,14,0,14,元大-台南,2023-03-09,9896
3027,盛達,22,8,14,元大-台南,2023-03-09,9896
2634,漢翔,61,47,14,元大-台南,2023-03-09,9896
1909,榮成,13,0,13,元大-台南,2023-03-09,9896
6546,正基,14,1,13,元大-台南,2023-03-09,9896
3289,宜特,30,17,13,元大-台南,2023-03-09,9896
00878,國泰永續高股息,269,5,264,元大-台南,2023-03-10,9896
00676R,富邦臺灣加權反1,151,3,148,元大-台南,2023-03-10,9896
2610,華航,145,42,103,元大-台南,2023-03-10,9896
6116,彩晶,128,55,73,元大-台南,2023-03-10,9896
2344,華邦電,65,1,64,元大-台南,2023-03-10,9896
2634,漢翔,78,17,61,元大-台南,2023-03-10,9896
8069,元太,59,5,54,元大-台南,2023-03-10,9896
2359,所羅門,70,18,52,元大-台南,2023-03-10,9896
2883,凱基金,68,16,52,元大-台南,2023-03-10,9896
00712,復華富時不動產,54,5,49,元大-台南,2023-03-10,9896
2317,鴻海,56,9,47,元大-台南,2023-03-10,9896
00713,元大台灣高息低波,46,0,46,元大-台南,2023-03-10,9896
0056,元大高股息,49,5,44,元大-台南,2023-03-10,9896
00882,中信中國高股息,43,0,43,元大-台南,2023-03-10,9896
00905,FT臺灣Smart,39,0,39,元大-台南,2023-03-10,9896
2882,國泰金,38,0,38,元大-台南,2023-03-10,9896
00715L,期街口布蘭特正2,42,6,36,元大-台南,2023-03-10,9896
6290,良維,70,38,32,元大-台南,2023-03-10,9896
3481,群創,55,24,31,元大-台南,2023-03-10,9896
00881,國泰台灣5G+,30,1,29,元大-台南,2023-03-10,9896
6732,昇佳電子,30,2,28,元大-台南,2023-03-10,9896
2891,中信金,29,2,27,元大-台南,2023-03-10,9896
1471,首利,26,0,26,元大-台南,2023-03-10,9896
2884,玉山金,28,2,26,元大-台南,2023-03-10,9896
1402,遠東新,24,0,24,元大-台南,2023-03-10,9896
1101,台泥,38,14,24,元大-台南,2023-03-10,9896
6770,力積電,39,16,23,元大-台南,2023-03-10,9896
1504,東元,34,11,23,元大-台南,2023-03-10,9896
2313,華通,23,1,22,元大-台南,2023-03-10,9896
00893,國泰智能電動車,22,0,22,元大-台南,2023-03-10,9896
2887,台新金,25,3,22,元大-台南,2023-03-10,9896
3592,瑞鼎,21,0,21,元大-台南,2023-03-10,9896
1708,東鹼,21,0,21,元大-台南,2023-03-10,9896
3022,威強電,22,1,21,元大-台南,2023-03-10,9896
00642U,期元大S＆P石油,20,0,20,元大-台南,2023-03-10,9896
00900,富邦特選高股息30,20,0,20,元大-台南,2023-03-10,9896
1513,中興電,44,24,20,元大-台南,2023-03-10,9896
2607,榮運,26,6,20,元大-台南,2023-03-10,9896
2897,王道銀行,20,0,20,元大-台南,2023-03-10,9896
00923,群益台ESG低碳50,19,0,19,元大-台南,2023-03-10,9896
3264,欣銓,19,0,19,元大-台南,2023-03-10,9896
3105,穩懋,18,0,18,元大-台南,2023-03-10,9896
2851,中再保,18,0,18,元大-台南,2023-03-10,9896
1432,大魯閣,18,0,18,元大-台南,2023-03-10,9896
8150,南茂,23,5,18,元大-台南,2023-03-10,9896
1736,喬山,20,3,17,元大-台南,2023-03-10,9896
5706,鳳凰,61,44,17,元大-台南,2023-03-10,9896
0050,元大台灣50,17,0,17,元大-台南,2023-03-10,9896
00902,中信電池及儲能,16,0,16,元大-台南,2023-03-10,9896
6233,旺玖,16,0,16,元大-台南,2023-03-10,9896
00878,國泰永續高股息,328,17,311,元大-台南,2023-03-13,9896
2609,陽明,225,70,155,元大-台南,2023-03-13,9896
2891,中信金,116,1,115,元大-台南,2023-03-13,9896
00642U,期元大S＆P石油,101,3,98,元大-台南,2023-03-13,9896
2834,臺企銀,85,1,84,元大-台南,2023-03-13,9896
00712,復華富時不動產,56,2,54,元大-台南,2023-03-13,9896
00632R,元大台灣50反1,325,285,40,元大-台南,2023-03-13,9896
2888,新光金,41,0,41,元大-台南,2023-03-13,9896
4402,郡都開發,36,0,36,元大-台南,2023-03-13,9896
2897,王道銀行,30,1,29,元大-台南,2023-03-13,9896
6188,廣明,30,3,27,元大-台南,2023-03-13,9896
1101,台泥,35,8,27,元大-台南,2023-03-13,9896
6488,環球晶,27,1,26,元大-台南,2023-03-13,9896
1504,東元,32,6,26,元大-台南,2023-03-13,9896
00782B,國泰A級公用債,26,0,26,元大-台南,2023-03-13,9896
00720B,元大投資級公司債,25,0,25,元大-台南,2023-03-13,9896
6235,華孚,70,45,25,元大-台南,2023-03-13,9896
3059,華晶科,25,2,23,元大-台南,2023-03-13,9896
3046,建��,25,4,21,元大-台南,2023-03-13,9896
1506,正道,21,0,21,元大-台南,2023-03-13,9896
3264,欣銓,25,4,21,元大-台南,2023-03-13,9896
2327,國巨,20,0,20,元大-台南,2023-03-13,9896
2915,潤泰全,20,0,20,元大-台南,2023-03-13,9896
6732,昇佳電子,20,0,20,元大-台南,2023-03-13,9896
1714,和桐,20,0,20,元大-台南,2023-03-13,9896
911608,明輝-DR,20,0,20,元大-台南,2023-03-13,9896
2317,鴻海,34,15,19,元大-台南,2023-03-13,9896
3035,智原,25,6,19,元大-台南,2023-03-13,9896
2886,兆豐金,18,0,18,元大-台南,2023-03-13,9896
8150,南茂,18,0,18,元大-台南,2023-03-13,9896
6841,長佳智能,20,2,18,元大-台南,2023-03-13,9896
2884,玉山金,35,19,16,元大-台南,2023-03-13,9896
1319,東陽,32,16,16,元大-台南,2023-03-13,9896
8050,廣積,43,27,16,元大-台南,2023-03-13,9896
00669R,國泰美國道瓊反1,15,0,15,元大-台南,2023-03-13,9896
6612,奈米醫材,16,1,15,元大-台南,2023-03-13,9896
5425,台半,24,9,15,元大-台南,2023-03-13,9896
00713,元大台灣高息低波,18,4,14,元大-台南,2023-03-13,9896
00923,群益台ESG低碳50,14,1,13,元大-台南,2023-03-13,9896
2312,金寶,13,1,12,元大-台南,2023-03-13,9896
1216,統一,14,2,12,元大-台南,2023-03-13,9896
1108,幸福,12,0,12,元大-台南,2023-03-13,9896
2014,中鴻,12,1,11,元大-台南,2023-03-13,9896
3149,正達,11,0,11,元大-台南,2023-03-13,9896
2892,第一金,30,19,11,元大-台南,2023-03-13,9896
8454,富邦媒,10,0,10,元大-台南,2023-03-13,9896
00676R,富邦臺灣加權反1,10,0,10,元大-台南,2023-03-13,9896
6589,台康生技,13,3,10,元大-台南,2023-03-13,9896
00758B,復華能源債,10,0,10,元大-台南,2023-03-13,9896
00895,富邦未來車,10,0,10,元大-台南,2023-03-13,9896
00715L,期街口布蘭特正2,132,2,130,元大-台南,2023-03-14,9896
00642U,期元大S＆P石油,117,0,117,元大-台南,2023-03-14,9896
2317,鴻海,110,6,104,元大-台南,2023-03-14,9896
6122,擎邦,103,1,102,元大-台南,2023-03-14,9896
3481,群創,101,11,90,元大-台南,2023-03-14,9896
2027,大成鋼,151,61,90,元大-台南,2023-03-14,9896
2618,長榮航,102,13,89,元大-台南,2023-03-14,9896
3264,欣銓,96,11,85,元大-台南,2023-03-14,9896
2880,華南金,68,0,68,元大-台南,2023-03-14,9896
00712,復華富時不動產,61,0,61,元大-台南,2023-03-14,9896
2891,中信金,70,9,61,元大-台南,2023-03-14,9896
00882,中信中國高股息,57,0,57,元大-台南,2023-03-14,9896
1762,中化生,63,9,54,元大-台南,2023-03-14,9896
0056,元大高股息,87,35,52,元大-台南,2023-03-14,9896
2303,聯電,54,4,50,元大-台南,2023-03-14,9896
4960,誠美材,56,10,46,元大-台南,2023-03-14,9896
2884,玉山金,47,2,45,元大-台南,2023-03-14,9896
2610,華航,62,18,44,元大-台南,2023-03-14,9896
00637L,元大滬深300正2,47,16,31,元大-台南,2023-03-14,9896
2883,凱基金,49,18,31,元大-台南,2023-03-14,9896
2888,新光金,30,0,30,元大-台南,2023-03-14,9896
2885,元大金,31,1,30,元大-台南,2023-03-14,9896
00772B,中信高評級公司債,30,0,30,元大-台南,2023-03-14,9896
1784,訊聯,28,0,28,元大-台南,2023-03-14,9896
2892,第一金,31,5,26,元大-台南,2023-03-14,9896
5880,合庫金,25,0,25,元大-台南,2023-03-14,9896
3041,揚智,23,0,23,元大-台南,2023-03-14,9896
5512,力麒,23,0,23,元大-台南,2023-03-14,9896
6770,力積電,30,8,22,元大-台南,2023-03-14,9896
2887,台新金,22,0,22,元大-台南,2023-03-14,9896
00688L,國泰20年美債正2,20,0,20,元大-台南,2023-03-14,9896
00676R,富邦臺灣加權反1,21,1,20,元大-台南,2023-03-14,9896
1810,和成,20,0,20,元大-台南,2023-03-14,9896
2313,華通,21,2,19,元大-台南,2023-03-14,9896
1785,光洋科,20,1,19,元大-台南,2023-03-14,9896
2409,友達,19,1,18,元大-台南,2023-03-14,9896
1709,和益,22,4,18,元大-台南,2023-03-14,9896
2886,兆豐金,32,15,17,元大-台南,2023-03-14,9896
00713,元大台灣高息低波,25,8,17,元大-台南,2023-03-14,9896
1471,首利,16,0,16,元大-台南,2023-03-14,9896
2834,臺企銀,38,23,15,元大-台南,2023-03-14,9896
1477,聚陽,15,0,15,元大-台南,2023-03-14,9896
2344,華邦電,16,1,15,元大-台南,2023-03-14,9896
8033,雷虎,14,0,14,元大-台南,2023-03-14,9896
2609,陽明,43,29,14,元大-台南,2023-03-14,9896
5864,致和證,13,0,13,元大-台南,2023-03-14,9896
2327,國巨,13,0,13,元大-台南,2023-03-14,9896
6239,力成,13,0,13,元大-台南,2023-03-14,9896
2330,台積電,15,2,13,元大-台南,2023-03-14,9896
2881,富邦金,15,3,12,元大-台南,2023-03-14,9896
00671R,富邦NASDAQ反1,366,20,346,元大-台南,2023-03-15,9896
00680L,元大美債20正2,316,0,316,元大-台南,2023-03-15,9896
00715L,期街口布蘭特正2,309,0,309,元大-台南,2023-03-15,9896
2317,鴻海,164,8,156,元大-台南,2023-03-15,9896
2457,飛宏,183,50,133,元大-台南,2023-03-15,9896
00642U,期元大S＆P石油,89,0,89,元大-台南,2023-03-15,9896
2603,長榮,115,38,77,元大-台南,2023-03-15,9896
2880,華南金,74,1,73,元大-台南,2023-03-15,9896
2883,凱基金,48,2,46,元大-台南,2023-03-15,9896
6116,彩晶,55,10,45,元大-台南,2023-03-15,9896
00712,復華富時不動產,37,1,36,元大-台南,2023-03-15,9896
2515,中工,30,1,29,元大-台南,2023-03-15,9896
2504,國產,27,0,27,元大-台南,2023-03-15,9896
2891,中信金,25,0,25,元大-台南,2023-03-15,9896
5425,台半,35,12,23,元大-台南,2023-03-15,9896
2915,潤泰全,30,7,23,元大-台南,2023-03-15,9896
5512,力麒,22,0,22,元大-台南,2023-03-15,9896
4402,郡都開發,21,0,21,元大-台南,2023-03-15,9896
2812,台中銀,21,0,21,元大-台南,2023-03-15,9896
2486,一詮,30,12,18,元大-台南,2023-03-15,9896
1611,中電,23,6,17,元大-台南,2023-03-15,9896
5880,合庫金,16,0,16,元大-台南,2023-03-15,9896
2610,華航,47,32,15,元大-台南,2023-03-15,9896
2206,三陽工業,17,2,15,元大-台南,2023-03-15,9896
2888,新光金,15,0,15,元大-台南,2023-03-15,9896
2359,所羅門,76,62,14,元大-台南,2023-03-15,9896
2618,長榮航,23,9,14,元大-台南,2023-03-15,9896
3029,零壹,14,1,13,元大-台南,2023-03-15,9896
2886,兆豐金,13,0,13,元大-台南,2023-03-15,9896
1762,中化生,15,2,13,元大-台南,2023-03-15,9896
4938,和碩,23,11,12,元大-台南,2023-03-15,9896
2352,佳世達,11,0,11,元大-台南,2023-03-15,9896
3379,彬台,11,0,11,元大-台南,2023-03-15,9896
2601,益航,11,0,11,元大-台南,2023-03-15,9896
00713,元大台灣高息低波,16,5,11,元大-台南,2023-03-15,9896
1432,大魯閣,11,1,10,元大-台南,2023-03-15,9896
3149,正達,10,0,10,元大-台南,2023-03-15,9896
5864,致和證,10,0,10,元大-台南,2023-03-15,9896
4526,東台,10,0,10,元大-台南,2023-03-15,9896
00688L,國泰20年美債正2,10,0,10,元大-台南,2023-03-15,9896
4754,國碳科,10,0,10,元大-台南,2023-03-15,9896
3338,泰碩,10,0,10,元大-台南,2023-03-15,9896
2881,富邦金,15,6,9,元大-台南,2023-03-15,9896
3030,德律,9,0,9,元大-台南,2023-03-15,9896
2338,光罩,9,0,9,元大-台南,2023-03-15,9896
6133,金橋,9,0,9,元大-台南,2023-03-15,9896
2641,正德,10,1,9,元大-台南,2023-03-15,9896
6719,力智,11,2,9,元大-台南,2023-03-15,9896
8916,光隆,9,1,8,元大-台南,2023-03-15,9896
00720B,元大投資級公司債,9,1,8,元大-台南,2023-03-15,9896
2313,華通,425,1,424,元大-台南,2023-03-16,9896
00715L,期街口布蘭特正2,294,7,287,元大-台南,2023-03-16,9896
2891,中信金,268,16,252,元大-台南,2023-03-16,9896
00878,國泰永續高股息,226,17,209,元大-台南,2023-03-16,9896
00676R,富邦臺灣加權反1,158,5,153,元大-台南,2023-03-16,9896
2888,新光金,149,5,144,元大-台南,2023-03-16,9896
00642U,期元大S＆P石油,143,30,113,元大-台南,2023-03-16,9896
2603,長榮,118,39,79,元大-台南,2023-03-16,9896
2834,臺企銀,479,403,76,元大-台南,2023-03-16,9896
2883B,凱基金乙特,60,0,60,元大-台南,2023-03-16,9896
5905,南仁湖,91,41,50,元大-台南,2023-03-16,9896
2419,仲琦,43,0,43,元大-台南,2023-03-16,9896
2486,一詮,43,5,38,元大-台南,2023-03-16,9896
5525,順天,38,0,38,元大-台南,2023-03-16,9896
1101,台泥,39,3,36,元大-台南,2023-03-16,9896
5009,榮剛,44,11,33,元大-台南,2023-03-16,9896
2882,國泰金,33,1,32,元大-台南,2023-03-16,9896
2885,元大金,30,1,29,元大-台南,2023-03-16,9896
6443,元晶,44,15,29,元大-台南,2023-03-16,9896
2886,兆豐金,72,43,29,元大-台南,2023-03-16,9896
00713,元大台灣高息低波,32,4,28,元大-台南,2023-03-16,9896
3264,欣銓,33,7,26,元大-台南,2023-03-16,9896
1506,正道,25,0,25,元大-台南,2023-03-16,9896
2327,國巨,31,8,23,元大-台南,2023-03-16,9896
5014,建錩,22,0,22,元大-台南,2023-03-16,9896
2027,大成鋼,25,4,21,元大-台南,2023-03-16,9896
3535,晶彩科,21,0,21,元大-台南,2023-03-16,9896
1784,訊聯,21,0,21,元大-台南,2023-03-16,9896
1440,南紡,25,4,21,元大-台南,2023-03-16,9896
1708,東鹼,20,0,20,元大-台南,2023-03-16,9896
6142,友勁,20,0,20,元大-台南,2023-03-16,9896
2206,三陽工業,23,3,20,元大-台南,2023-03-16,9896
9945,潤泰新,39,20,19,元大-台南,2023-03-16,9896
2867,三商壽,19,0,19,元大-台南,2023-03-16,9896
00712,復華富時不動產,39,21,18,元大-台南,2023-03-16,9896
2881,富邦金,21,3,18,元大-台南,2023-03-16,9896
4114,健喬,24,7,17,元大-台南,2023-03-16,9896
6104,創惟,60,43,17,元大-台南,2023-03-16,9896
3027,盛達,34,18,16,元大-台南,2023-03-16,9896
00882,中信中國高股息,17,1,16,元大-台南,2023-03-16,9896
5425,台半,22,6,16,元大-台南,2023-03-16,9896
0050,元大台灣50,17,1,16,元大-台南,2023-03-16,9896
5880,合庫金,17,2,15,元大-台南,2023-03-16,9896
1712,興農,14,0,14,元大-台南,2023-03-16,9896
8150,南茂,14,0,14,元大-台南,2023-03-16,9896
2812,台中銀,24,10,14,元大-台南,2023-03-16,9896
3594,磐儀,16,3,13,元大-台南,2023-03-16,9896
4164,承業醫,21,8,13,元大-台南,2023-03-16,9896
2637,慧洋-KY,15,3,12,元大-台南,2023-03-16,9896
0056,元大高股息,75,63,12,元大-台南,2023-03-16,9896
00632R,元大台灣50反1,6438,717,5721,元大-台南,2023-03-17,9896
3037,欣興,227,8,219,元大-台南,2023-03-17,9896
00715L,期街口布蘭特正2,181,24,157,元大-台南,2023-03-17,9896
00676R,富邦臺灣加權反1,150,0,150,元大-台南,2023-03-17,9896
2891,中信金,115,0,115,元大-台南,2023-03-17,9896
2317,鴻海,122,27,95,元大-台南,2023-03-17,9896
9904,寶成,98,3,95,元大-台南,2023-03-17,9896
2337,旺宏,76,1,75,元大-台南,2023-03-17,9896
00878,國泰永續高股息,70,8,62,元大-台南,2023-03-17,9896
00679B,元大美債20年,53,0,53,元大-台南,2023-03-17,9896
00642U,期元大S＆P石油,48,0,48,元大-台南,2023-03-17,9896
3035,智原,64,19,45,元大-台南,2023-03-17,9896
2610,華航,30,2,28,元大-台南,2023-03-17,9896
3041,揚智,24,0,24,元大-台南,2023-03-17,9896
2211,長榮鋼,22,0,22,元大-台南,2023-03-17,9896
2883,凱基金,22,0,22,元大-台南,2023-03-17,9896
2618,長榮航,31,10,21,元大-台南,2023-03-17,9896
5425,台半,29,8,21,元大-台南,2023-03-17,9896
2614,東森,23,2,21,元大-台南,2023-03-17,9896
00671R,富邦NASDAQ反1,21,0,21,元大-台南,2023-03-17,9896
2547,日勝生,20,0,20,元大-台南,2023-03-17,9896
2505,國揚,20,0,20,元大-台南,2023-03-17,9896
5452,佶優,20,0,20,元大-台南,2023-03-17,9896
00713,元大台灣高息低波,23,5,18,元大-台南,2023-03-17,9896
2881,富邦金,19,1,18,元大-台南,2023-03-17,9896
9945,潤泰新,18,0,18,元大-台南,2023-03-17,9896
2888,新光金,22,5,17,元大-台南,2023-03-17,9896
1514,亞力,22,5,17,元大-台南,2023-03-17,9896
2884,玉山金,20,4,16,元大-台南,2023-03-17,9896
1784,訊聯,15,0,15,元大-台南,2023-03-17,9896
4904,遠傳,15,0,15,元大-台南,2023-03-17,9896
6153,嘉聯益,15,1,14,元大-台南,2023-03-17,9896
2409,友達,17,4,13,元大-台南,2023-03-17,9896
1513,中興電,18,6,12,元大-台南,2023-03-17,9896
2482,連宇,23,11,12,元大-台南,2023-03-17,9896
3594,磐儀,22,10,12,元大-台南,2023-03-17,9896
3046,建��,13,1,12,元大-台南,2023-03-17,9896
00902,中信電池及儲能,11,0,11,元大-台南,2023-03-17,9896
1101,台泥,12,1,11,元大-台南,2023-03-17,9896
2413,環科,12,1,11,元大-台南,2023-03-17,9896
8358,金居,11,1,10,元大-台南,2023-03-17,9896
2809,京城銀,10,0,10,元大-台南,2023-03-17,9896
6122,擎邦,22,12,10,元大-台南,2023-03-17,9896
3264,欣銓,17,7,10,元大-台南,2023-03-17,9896
1718,中纖,10,0,10,元大-台南,2023-03-17,9896
00665L,富邦�琤肭磪囓�2,20,10,10,元大-台南,2023-03-17,9896
1104,環泥,20,11,9,元大-台南,2023-03-17,9896
2609,陽明,20,11,9,元大-台南,2023-03-17,9896
00891,中信關鍵半導體,14,5,9,元大-台南,2023-03-17,9896
00720B,元大投資級公司債,7,0,7,元大-台南,2023-03-17,9896
00632R,元大台灣50反1,315,46,269,元大-台南,2023-03-20,9896
3481,群創,437,187,250,元大-台南,2023-03-20,9896
00715L,期街口布蘭特正2,215,6,209,元大-台南,2023-03-20,9896
00676R,富邦臺灣加權反1,150,0,150,元大-台南,2023-03-20,9896
00878,國泰永續高股息,170,36,134,元大-台南,2023-03-20,9896
6266,泰詠,100,0,100,元大-台南,2023-03-20,9896
4402,郡都開發,88,0,88,元大-台南,2023-03-20,9896
00642U,期元大S＆P石油,80,8,72,元大-台南,2023-03-20,9896
2892,第一金,65,1,64,元大-台南,2023-03-20,9896
2609,陽明,66,3,63,元大-台南,2023-03-20,9896
2834,臺企銀,72,26,46,元大-台南,2023-03-20,9896
2888,新光金,41,0,41,元大-台南,2023-03-20,9896
1101,台泥,53,14,39,元大-台南,2023-03-20,9896
2880,華南金,40,7,33,元大-台南,2023-03-20,9896
8112,至上,31,3,28,元大-台南,2023-03-20,9896
8016,矽創,30,2,28,元大-台南,2023-03-20,9896
3056,富華新,29,3,26,元大-台南,2023-03-20,9896
00637L,元大滬深300正2,35,9,26,元大-台南,2023-03-20,9896
5512,力麒,31,7,24,元大-台南,2023-03-20,9896
6733,博晟生醫,22,1,21,元大-台南,2023-03-20,9896
2882,國泰金,33,13,20,元大-台南,2023-03-20,9896
2014,中鴻,21,1,20,元大-台南,2023-03-20,9896
2501,國建,20,0,20,元大-台南,2023-03-20,9896
00674R,期元大S＆P黃金反1,20,0,20,元大-台南,2023-03-20,9896
2615,萬海,25,6,19,元大-台南,2023-03-20,9896
2399,映泰,19,1,18,元大-台南,2023-03-20,9896
6841,長佳智能,19,2,17,元大-台南,2023-03-20,9896
00671R,富邦NASDAQ反1,16,0,16,元大-台南,2023-03-20,9896
1609,大亞,18,3,15,元大-台南,2023-03-20,9896
2884,玉山金,38,24,14,元大-台南,2023-03-20,9896
6163,華電網,15,1,14,元大-台南,2023-03-20,9896
00712,復華富時不動產,14,0,14,元大-台南,2023-03-20,9896
00882,中信中國高股息,18,5,13,元大-台南,2023-03-20,9896
4526,東台,13,0,13,元大-台南,2023-03-20,9896
6515,穎崴,13,1,12,元大-台南,2023-03-20,9896
2867,三商壽,11,0,11,元大-台南,2023-03-20,9896
3535,晶彩科,12,1,11,元大-台南,2023-03-20,9896
2359,所羅門,14,3,11,元大-台南,2023-03-20,9896
00902,中信電池及儲能,10,0,10,元大-台南,2023-03-20,9896
1605,華新,18,8,10,元大-台南,2023-03-20,9896
3652,精聯,10,0,10,元大-台南,2023-03-20,9896
6133,金橋,14,4,10,元大-台南,2023-03-20,9896
2755,揚秦,10,0,10,元大-台南,2023-03-20,9896
3701,大眾控,15,6,9,元大-台南,2023-03-20,9896
2409,友達,12,3,9,元大-台南,2023-03-20,9896
2881,富邦金,9,1,8,元大-台南,2023-03-20,9896
2330,台積電,10,2,8,元大-台南,2023-03-20,9896
5315,光聯,11,3,8,元大-台南,2023-03-20,9896
2471,資通,83,75,8,元大-台南,2023-03-20,9896
00650L,復華香港正2,16,8,8,元大-台南,2023-03-20,9896
3481,群創,607,19,588,元大-台南,2023-03-21,9896
2408,南亞科,416,4,412,元大-台南,2023-03-21,9896
8936,國統,116,6,110,元大-台南,2023-03-21,9896
4402,郡都開發,89,0,89,元大-台南,2023-03-21,9896
6266,泰詠,85,4,81,元大-台南,2023-03-21,9896
2387,精元,82,3,79,元大-台南,2023-03-21,9896
00680L,元大美債20正2,63,0,63,元大-台南,2023-03-21,9896
00885,富邦越南,63,0,63,元大-台南,2023-03-21,9896
2303,聯電,64,9,55,元大-台南,2023-03-21,9896
6288,聯嘉,50,2,48,元大-台南,2023-03-21,9896
2504,國產,46,0,46,元大-台南,2023-03-21,9896
00632R,元大台灣50反1,158,116,42,元大-台南,2023-03-21,9896
2891,中信金,39,3,36,元大-台南,2023-03-21,9896
00642U,期元大S＆P石油,36,2,34,元大-台南,2023-03-21,9896
00676R,富邦臺灣加權反1,33,0,33,元大-台南,2023-03-21,9896
00878,國泰永續高股息,50,18,32,元大-台南,2023-03-21,9896
3017,奇鋐,47,19,28,元大-台南,2023-03-21,9896
3056,富華新,30,5,25,元大-台南,2023-03-21,9896
00715L,期街口布蘭特正2,47,24,23,元大-台南,2023-03-21,9896
00679B,元大美債20年,22,1,21,元大-台南,2023-03-21,9896
1609,大亞,20,0,20,元大-台南,2023-03-21,9896
6190,萬泰科,17,0,17,元大-台南,2023-03-21,9896
2413,環科,29,14,15,元大-台南,2023-03-21,9896
2615,萬海,15,1,14,元大-台南,2023-03-21,9896
00882,中信中國高股息,14,0,14,元大-台南,2023-03-21,9896
00712,復華富時不動產,15,1,14,元大-台南,2023-03-21,9896
3013,晟銘電,17,4,13,元大-台南,2023-03-21,9896
5525,順天,12,0,12,元大-台南,2023-03-21,9896
3624,光頡,13,2,11,元大-台南,2023-03-21,9896
00891,中信關鍵半導體,10,0,10,元大-台南,2023-03-21,9896
2812,台中銀,10,0,10,元大-台南,2023-03-21,9896
6712,長聖,11,1,10,元大-台南,2023-03-21,9896
00688L,國泰20年美債正2,10,0,10,元大-台南,2023-03-21,9896
2367,燿華,10,0,10,元大-台南,2023-03-21,9896
00673R,期元大S＆P原油反1,10,0,10,元大-台南,2023-03-21,9896
2388,威盛,17,7,10,元大-台南,2023-03-21,9896
3027,盛達,16,7,9,元大-台南,2023-03-21,9896
6191,精成科,10,1,9,元大-台南,2023-03-21,9896
4526,東台,10,1,9,元大-台南,2023-03-21,9896
2399,映泰,14,5,9,元大-台南,2023-03-21,9896
3443,創意,11,2,9,元大-台南,2023-03-21,9896
5512,力麒,9,1,8,元大-台南,2023-03-21,9896
3207,耀勝,8,0,8,元大-台南,2023-03-21,9896
5864,致和證,20,12,8,元大-台南,2023-03-21,9896
2603,長榮,16,9,7,元大-台南,2023-03-21,9896
2201,裕隆,16,9,7,元大-台南,2023-03-21,9896
1519,華城,27,20,7,元大-台南,2023-03-21,9896
3432,台端,7,0,7,元大-台南,2023-03-21,9896
1603,華電,10,3,7,元大-台南,2023-03-21,9896
00717,富邦美國特別股,7,0,7,元大-台南,2023-03-21,9896
00676R,富邦臺灣加權反1,202,0,202,元大-台南,2023-03-22,9896
2204,中華,63,3,60,元大-台南,2023-03-22,9896
00891,中信關鍵半導體,62,3,59,元大-台南,2023-03-22,9896
00885,富邦越南,61,2,59,元大-台南,2023-03-22,9896
2887,台新金,55,1,54,元大-台南,2023-03-22,9896
9904,寶成,53,0,53,元大-台南,2023-03-22,9896
2351,順德,50,1,49,元大-台南,2023-03-22,9896
00637L,元大滬深300正2,61,15,46,元大-台南,2023-03-22,9896
2317,鴻海,52,8,44,元大-台南,2023-03-22,9896
8299,群聯,38,0,38,元大-台南,2023-03-22,9896
00680L,元大美債20正2,43,5,38,元大-台南,2023-03-22,9896
00679B,元大美債20年,34,0,34,元大-台南,2023-03-22,9896
3576,聯合再生,57,25,32,元大-台南,2023-03-22,9896
6266,泰詠,60,28,32,元大-台南,2023-03-22,9896
3374,精材,31,0,31,元大-台南,2023-03-22,9896
6733,博晟生醫,43,15,28,元大-台南,2023-03-22,9896
1605,華新,30,6,24,元大-台南,2023-03-22,9896
8105,凌巨,22,0,22,元大-台南,2023-03-22,9896
4167,松瑞藥,21,0,21,元大-台南,2023-03-22,9896
00902,中信電池及儲能,24,4,20,元大-台南,2023-03-22,9896
4934,太極,21,1,20,元大-台南,2023-03-22,9896
3673,TPK-KY,20,0,20,元大-台南,2023-03-22,9896
2834,臺企銀,21,2,19,元大-台南,2023-03-22,9896
1529,樂事綠能,28,9,19,元大-台南,2023-03-22,9896
2727,王品,23,5,18,元大-台南,2023-03-22,9896
2359,所羅門,17,0,17,元大-台南,2023-03-22,9896
2409,友達,18,1,17,元大-台南,2023-03-22,9896
8936,國統,24,7,17,元大-台南,2023-03-22,9896
8996,高力,69,53,16,元大-台南,2023-03-22,9896
6282,康舒,17,1,16,元大-台南,2023-03-22,9896
2630,亞航,16,0,16,元大-台南,2023-03-22,9896
3714,富采,17,1,16,元大-台南,2023-03-22,9896
6156,松上,15,0,15,元大-台南,2023-03-22,9896
6235,華孚,27,13,14,元大-台南,2023-03-22,9896
5512,力麒,14,0,14,元大-台南,2023-03-22,9896
4961,天鈺,20,6,14,元大-台南,2023-03-22,9896
8033,雷虎,14,1,13,元大-台南,2023-03-22,9896
3056,富華新,16,3,13,元大-台南,2023-03-22,9896
4763,材料-KY,27,15,12,元大-台南,2023-03-22,9896
5452,佶優,12,0,12,元大-台南,2023-03-22,9896
2610,華航,13,1,12,元大-台南,2023-03-22,9896
3545,敦泰,18,7,11,元大-台南,2023-03-22,9896
3090,日電貿,11,0,11,元大-台南,2023-03-22,9896
3058,立德,12,1,11,元大-台南,2023-03-22,9896
2515,中工,12,1,11,元大-台南,2023-03-22,9896
9921,巨大,11,0,11,元大-台南,2023-03-22,9896
2886,兆豐金,14,3,11,元大-台南,2023-03-22,9896
2883,凱基金,12,2,10,元大-台南,2023-03-22,9896
6863,永道-KY,10,0,10,元大-台南,2023-03-22,9896
3008,大立光,10,0,10,元大-台南,2023-03-22,9896
2317,鴻海,113,12,101,元大-台南,2023-03-23,9896
4402,郡都開發,83,0,83,元大-台南,2023-03-23,9896
1524,耿鼎,81,18,63,元大-台南,2023-03-23,9896
6266,泰詠,60,0,60,元大-台南,2023-03-23,9896
5284,jpp-KY,60,2,58,元大-台南,2023-03-23,9896
2402,毅嘉,81,27,54,元大-台南,2023-03-23,9896
2504,國產,52,0,52,元大-台南,2023-03-23,9896
6167,久正,51,0,51,元大-台南,2023-03-23,9896
00632R,元大台灣50反1,273,222,51,元大-台南,2023-03-23,9896
3481,群創,195,145,50,元大-台南,2023-03-23,9896
00713,元大台灣高息低波,55,7,48,元大-台南,2023-03-23,9896
1802,台玻,55,8,47,元大-台南,2023-03-23,9896
00891,中信關鍵半導體,54,9,45,元大-台南,2023-03-23,9896
1440,南紡,39,4,35,元大-台南,2023-03-23,9896
2505,國揚,34,0,34,元大-台南,2023-03-23,9896
8201,無敵,21,0,21,元大-台南,2023-03-23,9896
6016,康和證,20,0,20,元大-台南,2023-03-23,9896
3322,建舜電,23,5,18,元大-台南,2023-03-23,9896
2603,長榮,23,6,17,元大-台南,2023-03-23,9896
8086,宏捷科,20,3,17,元大-台南,2023-03-23,9896
5425,台半,26,10,16,元大-台南,2023-03-23,9896
2002,中鋼,37,22,15,元大-台南,2023-03-23,9896
3149,正達,15,0,15,元大-台南,2023-03-23,9896
2637,慧洋-KY,23,9,14,元大-台南,2023-03-23,9896
5009,榮剛,14,0,14,元大-台南,2023-03-23,9896
4989,榮科,13,0,13,元大-台南,2023-03-23,9896
8222,寶一,35,22,13,元大-台南,2023-03-23,9896
6233,旺玖,15,3,12,元大-台南,2023-03-23,9896
2430,燦坤,12,0,12,元大-台南,2023-03-23,9896
8234,新漢,17,5,12,元大-台南,2023-03-23,9896
5525,順天,12,0,12,元大-台南,2023-03-23,9896
8044,網家,11,0,11,元大-台南,2023-03-23,9896
2362,藍天,13,2,11,元大-台南,2023-03-23,9896
8299,群聯,12,1,11,元大-台南,2023-03-23,9896
3035,智原,25,14,11,元大-台南,2023-03-23,9896
9921,巨大,10,0,10,元大-台南,2023-03-23,9896
6841,長佳智能,10,0,10,元大-台南,2023-03-23,9896
2476,鉅祥,10,0,10,元大-台南,2023-03-23,9896
00673R,期元大S＆P原油反1,10,0,10,元大-台南,2023-03-23,9896
8401,白紗科,10,0,10,元大-台南,2023-03-23,9896
2013,中鋼構,10,0,10,元大-台南,2023-03-23,9896
2609,陽明,23,14,9,元大-台南,2023-03-23,9896
5608,四維航,11,2,9,元大-台南,2023-03-23,9896
3479,安勤,18,9,9,元大-台南,2023-03-23,9896
3528,安馳,9,0,9,元大-台南,2023-03-23,9896
3094,聯傑,11,2,9,元大-台南,2023-03-23,9896
1529,樂事綠能,12,3,9,元大-台南,2023-03-23,9896
6113,亞矽,10,1,9,元大-台南,2023-03-23,9896
8176,智捷,9,0,9,元大-台南,2023-03-23,9896
6288,聯嘉,50,41,9,元大-台南,2023-03-23,9896
2618,長榮航,218,1,217,元大-台南,2023-03-24,9896
4129,聯合,139,0,139,元大-台南,2023-03-24,9896
2408,南亞科,153,21,132,元大-台南,2023-03-24,9896
00632R,元大台灣50反1,222,110,112,元大-台南,2023-03-24,9896
2014,中鴻,67,1,66,元大-台南,2023-03-24,9896
4536,拓凱,64,3,61,元大-台南,2023-03-24,9896
2892,第一金,52,1,51,元大-台南,2023-03-24,9896
6148,驊宏資,50,5,45,元大-台南,2023-03-24,9896
2881,富邦金,45,2,43,元大-台南,2023-03-24,9896
00679B,元大美債20年,37,0,37,元大-台南,2023-03-24,9896
00720B,元大投資級公司債,35,0,35,元大-台南,2023-03-24,9896
3028,增你強,35,1,34,元大-台南,2023-03-24,9896
00712,復華富時不動產,31,1,30,元大-台南,2023-03-24,9896
1605,華新,86,57,29,元大-台南,2023-03-24,9896
3432,台端,54,26,28,元大-台南,2023-03-24,9896
00885,富邦越南,28,0,28,元大-台南,2023-03-24,9896
2105,正新,57,31,26,元大-台南,2023-03-24,9896
6228,全譜,25,0,25,元大-台南,2023-03-24,9896
2897A,王道銀甲特,25,0,25,元大-台南,2023-03-24,9896
2883B,凱基金乙特,31,8,23,元大-台南,2023-03-24,9896
00715L,期街口布蘭特正2,28,6,22,元大-台南,2023-03-24,9896
5222,全訊,30,8,22,元大-台南,2023-03-24,9896
2542,興富發,22,0,22,元大-台南,2023-03-24,9896
2303,聯電,36,14,22,元大-台南,2023-03-24,9896
2357,華碩,21,0,21,元大-台南,2023-03-24,9896
2329,華泰,22,1,21,元大-台南,2023-03-24,9896
2103,台橡,22,1,21,元大-台南,2023-03-24,9896
2430,燦坤,20,0,20,元大-台南,2023-03-24,9896
00674R,期元大S＆P黃金反1,20,0,20,元大-台南,2023-03-24,9896
00673R,期元大S＆P原油反1,20,0,20,元大-台南,2023-03-24,9896
5425,台半,23,3,20,元大-台南,2023-03-24,9896
6147,頎邦,19,0,19,元大-台南,2023-03-24,9896
1471,首利,32,13,19,元大-台南,2023-03-24,9896
2313,華通,35,16,19,元大-台南,2023-03-24,9896
1795,美時,27,8,19,元大-台南,2023-03-24,9896
6233,旺玖,20,2,18,元大-台南,2023-03-24,9896
1784,訊聯,17,0,17,元大-台南,2023-03-24,9896
8201,無敵,20,3,17,元大-台南,2023-03-24,9896
6122,擎邦,17,1,16,元大-台南,2023-03-24,9896
2495,普安,18,2,16,元大-台南,2023-03-24,9896
6461,益得,16,1,15,元大-台南,2023-03-24,9896
1603,華電,14,0,14,元大-台南,2023-03-24,9896
2392,正崴,24,11,13,元大-台南,2023-03-24,9896
3715,定穎投控,18,6,12,元大-台南,2023-03-24,9896
3701,大眾控,14,2,12,元大-台南,2023-03-24,9896
6285,啟��,12,1,11,元大-台南,2023-03-24,9896
3013,晟銘電,17,6,11,元大-台南,2023-03-24,9896
8936,國統,21,10,11,元大-台南,2023-03-24,9896
00772B,中信高評級公司債,11,0,11,元大-台南,2023-03-24,9896
2449,京元電子,11,0,11,元大-台南,2023-03-24,9896
4402,郡都開發,91,0,91,元大-台南,2023-03-27,9896
00679B,元大美債20年,74,2,72,元大-台南,2023-03-27,9896
00772B,中信高評級公司債,72,1,71,元大-台南,2023-03-27,9896
2834,臺企銀,51,4,47,元大-台南,2023-03-27,9896
6228,全譜,41,0,41,元大-台南,2023-03-27,9896
00882,中信中國高股息,46,6,40,元大-台南,2023-03-27,9896
1319,東陽,42,4,38,元大-台南,2023-03-27,9896
5284,jpp-KY,43,6,37,元大-台南,2023-03-27,9896
1762,中化生,61,24,37,元大-台南,2023-03-27,9896
2482,連宇,48,12,36,元大-台南,2023-03-27,9896
2344,華邦電,50,16,34,元大-台南,2023-03-27,9896
6233,旺玖,30,0,30,元大-台南,2023-03-27,9896
00637L,元大滬深300正2,27,0,27,元大-台南,2023-03-27,9896
6546,正基,30,3,27,元大-台南,2023-03-27,9896
2413,環科,28,2,26,元大-台南,2023-03-27,9896
2897,王道銀行,25,0,25,元大-台南,2023-03-27,9896
4766,南寶,25,1,24,元大-台南,2023-03-27,9896
5243,乙盛-KY,23,1,22,元大-台南,2023-03-27,9896
1611,中電,21,1,20,元大-台南,2023-03-27,9896
1560,中砂,20,0,20,元大-台南,2023-03-27,9896
2357,華碩,20,0,20,元大-台南,2023-03-27,9896
3105,穩懋,27,7,20,元大-台南,2023-03-27,9896
3231,緯創,56,36,20,元大-台南,2023-03-27,9896
5011,久陽,33,15,18,元大-台南,2023-03-27,9896
1504,東元,104,86,18,元大-台南,2023-03-27,9896
00674R,期元大S＆P黃金反1,17,0,17,元大-台南,2023-03-27,9896
3264,欣銓,19,2,17,元大-台南,2023-03-27,9896
2634,漢翔,43,27,16,元大-台南,2023-03-27,9896
3715,定穎投控,16,1,15,元大-台南,2023-03-27,9896
1308,亞聚,15,0,15,元大-台南,2023-03-27,9896
3576,聯合再生,14,1,13,元大-台南,2023-03-27,9896
6182,合晶,14,1,13,元大-台南,2023-03-27,9896
6285,啟��,111,98,13,元大-台南,2023-03-27,9896
5315,光聯,12,0,12,元大-台南,2023-03-27,9896
2342,茂矽,22,10,12,元大-台南,2023-03-27,9896
3059,華晶科,12,0,12,元大-台南,2023-03-27,9896
3149,正達,11,0,11,元大-台南,2023-03-27,9896
8201,無敵,11,0,11,元大-台南,2023-03-27,9896
4536,拓凱,13,2,11,元大-台南,2023-03-27,9896
6230,尼得科超眾,12,1,11,元大-台南,2023-03-27,9896
9907,統一實,11,0,11,元大-台南,2023-03-27,9896
00712,復華富時不動產,11,0,11,元大-台南,2023-03-27,9896
4162,智擎,11,1,10,元大-台南,2023-03-27,9896
3714,富采,23,13,10,元大-台南,2023-03-27,9896
00673R,期元大S＆P原油反1,10,0,10,元大-台南,2023-03-27,9896
1514,亞力,11,1,10,元大-台南,2023-03-27,9896
00669R,國泰美國道瓊反1,10,0,10,元大-台南,2023-03-27,9896
6191,精成科,10,0,10,元大-台南,2023-03-27,9896
3005,神基,11,1,10,元大-台南,2023-03-27,9896
5490,同亨,10,0,10,元大-台南,2023-03-27,9896
1762,中化生,130,1,129,元大-台南,2023-03-28,9896
2371,大同,137,14,123,元大-台南,2023-03-28,9896
4402,郡都開發,85,0,85,元大-台南,2023-03-28,9896
00679B,元大美債20年,84,4,80,元大-台南,2023-03-28,9896
00673R,期元大S＆P原油反1,85,5,80,元大-台南,2023-03-28,9896
1605,華新,94,28,66,元大-台南,2023-03-28,9896
3231,緯創,104,38,66,元大-台南,2023-03-28,9896
00882,中信中國高股息,59,0,59,元大-台南,2023-03-28,9896
2880,華南金,50,1,49,元大-台南,2023-03-28,9896
2317,鴻海,46,0,46,元大-台南,2023-03-28,9896
00772B,中信高評級公司債,38,0,38,元大-台南,2023-03-28,9896
8996,高力,38,0,38,元大-台南,2023-03-28,9896
3017,奇鋐,41,4,37,元大-台南,2023-03-28,9896
5009,榮剛,52,18,34,元大-台南,2023-03-28,9896
00878,國泰永續高股息,41,11,30,元大-台南,2023-03-28,9896
8936,國統,29,0,29,元大-台南,2023-03-28,9896
0056,元大高股息,30,2,28,元大-台南,2023-03-28,9896
00720B,元大投資級公司債,27,0,27,元大-台南,2023-03-28,9896
2344,華邦電,48,22,26,元大-台南,2023-03-28,9896
2634,漢翔,44,19,25,元大-台南,2023-03-28,9896
00712,復華富時不動產,27,2,25,元大-台南,2023-03-28,9896
3576,聯合再生,23,0,23,元大-台南,2023-03-28,9896
2303,聯電,29,7,22,元大-台南,2023-03-28,9896
6168,宏齊,28,6,22,元大-台南,2023-03-28,9896
2515,中工,22,0,22,元大-台南,2023-03-28,9896
6148,驊宏資,52,30,22,元大-台南,2023-03-28,9896
3706,神達,21,0,21,元大-台南,2023-03-28,9896
5880,合庫金,20,0,20,元大-台南,2023-03-28,9896
8201,無敵,25,5,20,元大-台南,2023-03-28,9896
2312,金寶,20,0,20,元大-台南,2023-03-28,9896
3037,欣興,26,6,20,元大-台南,2023-03-28,9896
00922,國泰台灣領袖50,19,0,19,元大-台南,2023-03-28,9896
00751B,元大AAA至A公司債,19,0,19,元大-台南,2023-03-28,9896
8050,廣積,121,102,19,元大-台南,2023-03-28,9896
3264,欣銓,18,0,18,元大-台南,2023-03-28,9896
2014,中鴻,17,1,16,元大-台南,2023-03-28,9896
3322,建舜電,16,0,16,元大-台南,2023-03-28,9896
1784,訊聯,16,0,16,元大-台南,2023-03-28,9896
3027,盛達,26,11,15,元大-台南,2023-03-28,9896
2455,全新,16,1,15,元大-台南,2023-03-28,9896
6547,高端疫苗,16,2,14,元大-台南,2023-03-28,9896
8033,雷虎,18,5,13,元大-台南,2023-03-28,9896
1220,台榮,13,0,13,元大-台南,2023-03-28,9896
8466,美吉吉-KY,13,0,13,元大-台南,2023-03-28,9896
3260,威剛,15,2,13,元大-台南,2023-03-28,9896
2498,宏達電,16,4,12,元大-台南,2023-03-28,9896
00787B,元大10年IG醫療債,12,0,12,元大-台南,2023-03-28,9896
2332,友訊,15,3,12,元大-台南,2023-03-28,9896
00671R,富邦NASDAQ反1,12,0,12,元大-台南,2023-03-28,9896
2618,長榮航,16,4,12,元大-台南,2023-03-28,9896
3035,智原,245,13,232,元大-台南,2023-03-29,9896
2329,華泰,237,6,231,元大-台南,2023-03-29,9896
2618,長榮航,206,7,199,元大-台南,2023-03-29,9896
4960,誠美材,100,5,95,元大-台南,2023-03-29,9896
00673R,期元大S＆P原油反1,70,0,70,元大-台南,2023-03-29,9896
2731,雄獅,48,12,36,元大-台南,2023-03-29,9896
2374,佳能,35,0,35,元大-台南,2023-03-29,9896
3481,群創,50,16,34,元大-台南,2023-03-29,9896
2303,聯電,40,8,32,元大-台南,2023-03-29,9896
4966,譜瑞-KY,30,0,30,元大-台南,2023-03-29,9896
1471,首利,61,32,29,元大-台南,2023-03-29,9896
6120,達運,30,2,28,元大-台南,2023-03-29,9896
1584,精剛,27,0,27,元大-台南,2023-03-29,9896
3017,奇鋐,35,10,25,元大-台南,2023-03-29,9896
1460,宏遠,22,0,22,元大-台南,2023-03-29,9896
1301,台塑,20,0,20,元大-台南,2023-03-29,9896
6281,全國電,20,0,20,元大-台南,2023-03-29,9896
00679B,元大美債20年,20,0,20,元大-台南,2023-03-29,9896
1216,統一,20,0,20,元大-台南,2023-03-29,9896
00720B,元大投資級公司債,19,1,18,元大-台南,2023-03-29,9896
6228,全譜,18,0,18,元大-台南,2023-03-29,9896
00637L,元大滬深300正2,26,9,17,元大-台南,2023-03-29,9896
3011,今皓,15,0,15,元大-台南,2023-03-29,9896
6116,彩晶,14,0,14,元大-台南,2023-03-29,9896
1605,華新,22,9,13,元大-台南,2023-03-29,9896
00922,國泰台灣領袖50,13,0,13,元大-台南,2023-03-29,9896
8415,大國鋼,13,0,13,元大-台南,2023-03-29,9896
1529,樂事綠能,14,2,12,元大-台南,2023-03-29,9896
5243,乙盛-KY,20,9,11,元大-台南,2023-03-29,9896
1519,華城,15,4,11,元大-台南,2023-03-29,9896
8105,凌巨,11,0,11,元大-台南,2023-03-29,9896
2630,亞航,11,0,11,元大-台南,2023-03-29,9896
2357,華碩,10,0,10,元大-台南,2023-03-29,9896
4931,新盛力,10,0,10,元大-台南,2023-03-29,9896
5225,東科-KY,26,16,10,元大-台南,2023-03-29,9896
4938,和碩,10,0,10,元大-台南,2023-03-29,9896
4536,拓凱,26,16,10,元大-台南,2023-03-29,9896
6230,尼得科超眾,10,0,10,元大-台南,2023-03-29,9896
2331,精英,10,0,10,元大-台南,2023-03-29,9896
3231,緯創,19,10,9,元大-台南,2023-03-29,9896
5258,虹堡,20,11,9,元大-台南,2023-03-29,9896
00680L,元大美債20正2,9,0,9,元大-台南,2023-03-29,9896
00878,國泰永續高股息,34,25,9,元大-台南,2023-03-29,9896
2402,毅嘉,23,15,8,元大-台南,2023-03-29,9896
2495,普安,8,0,8,元大-台南,2023-03-29,9896
6531,愛普*,14,7,7,元大-台南,2023-03-29,9896
6719,力智,10,3,7,元大-台南,2023-03-29,9896
6182,合晶,8,1,7,元大-台南,2023-03-29,9896
1314,中石化,7,0,7,元大-台南,2023-03-29,9896
3682,亞太電,10,3,7,元大-台南,2023-03-29,9896
2603,長榮,259,3,256,元大-台南,2023-03-30,9896
00673R,期元大S＆P原油反1,160,20,140,元大-台南,2023-03-30,9896
00885,富邦越南,115,8,107,元大-台南,2023-03-30,9896
00882,中信中國高股息,84,10,74,元大-台南,2023-03-30,9896
2880,華南金,50,0,50,元大-台南,2023-03-30,9896
5309,系統電,61,15,46,元大-台南,2023-03-30,9896
5880,合庫金,42,0,42,元大-台南,2023-03-30,9896
1618,合機,36,2,34,元大-台南,2023-03-30,9896
00680L,元大美債20正2,32,0,32,元大-台南,2023-03-30,9896
1609,大亞,32,2,30,元大-台南,2023-03-30,9896
2884,玉山金,43,14,29,元大-台南,2023-03-30,9896
6266,泰詠,30,1,29,元大-台南,2023-03-30,9896
2610,華航,29,2,27,元大-台南,2023-03-30,9896
5222,全訊,26,4,22,元大-台南,2023-03-30,9896
2889,國票金,22,0,22,元大-台南,2023-03-30,9896
00773B,中信優先金融債,21,0,21,元大-台南,2023-03-30,9896
2883,凱基金,20,0,20,元大-台南,2023-03-30,9896
2342,茂矽,27,7,20,元大-台南,2023-03-30,9896
1762,中化生,39,20,19,元大-台南,2023-03-30,9896
3046,建��,21,2,19,元大-台南,2023-03-30,9896
3481,群創,21,3,18,元大-台南,2023-03-30,9896
6228,全譜,17,0,17,元大-台南,2023-03-30,9896
4960,誠美材,16,0,16,元大-台南,2023-03-30,9896
8936,國統,17,2,15,元大-台南,2023-03-30,9896
6443,元晶,19,5,14,元大-台南,2023-03-30,9896
3432,台端,13,0,13,元大-台南,2023-03-30,9896
6841,長佳智能,15,3,12,元大-台南,2023-03-30,9896
6244,茂迪,22,10,12,元大-台南,2023-03-30,9896
00712,復華富時不動產,12,1,11,元大-台南,2023-03-30,9896
5351,鈺創,11,0,11,元大-台南,2023-03-30,9896
3532,台勝科,11,0,11,元大-台南,2023-03-30,9896
6182,合晶,12,1,11,元大-台南,2023-03-30,9896
1101,台泥,11,0,11,元大-台南,2023-03-30,9896
8112,至上,10,0,10,元大-台南,2023-03-30,9896
2867,三商壽,10,0,10,元大-台南,2023-03-30,9896
2061,風青,10,0,10,元大-台南,2023-03-30,9896
00715L,期街口布蘭特正2,14,4,10,元大-台南,2023-03-30,9896
3521,鴻翊,10,0,10,元大-台南,2023-03-30,9896
00670L,富邦NASDAQ正2,10,0,10,元大-台南,2023-03-30,9896
00679B,元大美債20年,14,4,10,元大-台南,2023-03-30,9896
6276,安鈦克,10,1,9,元大-台南,2023-03-30,9896
2727,王品,51,42,9,元大-台南,2023-03-30,9896
2542,興富發,10,1,9,元大-台南,2023-03-30,9896
5512,力麒,9,0,9,元大-台南,2023-03-30,9896
2426,鼎元,8,0,8,元大-台南,2023-03-30,9896
3217,優群,9,1,8,元大-台南,2023-03-30,9896
6133,金橋,30,23,7,元大-台南,2023-03-30,9896
1605,華新,17,10,7,元大-台南,2023-03-30,9896
4979,華星光,16,9,7,元大-台南,2023-03-30,9896
4746,台耀,8,2,6,元大-台南,2023-03-30,9896
2834,臺企銀,337,86,251,元大-台南,2023-03-31,9896
00673R,期元大S＆P原油反1,176,0,176,元大-台南,2023-03-31,9896
1440,南紡,105,3,102,元大-台南,2023-03-31,9896
2891,中信金,100,4,96,元大-台南,2023-03-31,9896
1471,首利,87,0,87,元大-台南,2023-03-31,9896
1605,華新,65,5,60,元大-台南,2023-03-31,9896
3027,盛達,60,2,58,元大-台南,2023-03-31,9896
2867,三商壽,40,0,40,元大-台南,2023-03-31,9896
8271,宇瞻,39,1,38,元大-台南,2023-03-31,9896
6266,泰詠,39,9,30,元大-台南,2023-03-31,9896
6167,久正,25,0,25,元大-台南,2023-03-31,9896
8201,無敵,24,0,24,元大-台南,2023-03-31,9896
2402,毅嘉,29,6,23,元大-台南,2023-03-31,9896
8050,廣積,73,50,23,元大-台南,2023-03-31,9896
2884,玉山金,34,11,23,元大-台南,2023-03-31,9896
5880,合庫金,21,0,21,元大-台南,2023-03-31,9896
5388,中磊,23,3,20,元大-台南,2023-03-31,9896
4960,誠美材,25,5,20,元大-台南,2023-03-31,9896
9105,泰金寶-DR,20,0,20,元大-台南,2023-03-31,9896
3078,僑威,23,4,19,元大-台南,2023-03-31,9896
5009,榮剛,17,0,17,元大-台南,2023-03-31,9896
2382,廣達,15,0,15,元大-台南,2023-03-31,9896
6443,元晶,47,32,15,元大-台南,2023-03-31,9896
9919,康那香,15,0,15,元大-台南,2023-03-31,9896
8112,至上,18,4,14,元大-台南,2023-03-31,9896
2027,大成鋼,14,0,14,元大-台南,2023-03-31,9896
4973,廣穎,13,0,13,元大-台南,2023-03-31,9896
6163,華電網,34,21,13,元大-台南,2023-03-31,9896
3491,昇達科,36,23,13,元大-台南,2023-03-31,9896
00679B,元大美債20年,14,1,13,元大-台南,2023-03-31,9896
3218,大學光,13,3,10,元大-台南,2023-03-31,9896
3264,欣銓,10,1,9,元大-台南,2023-03-31,9896
5443,均豪,9,0,9,元大-台南,2023-03-31,9896
1504,東元,25,16,9,元大-台南,2023-03-31,9896
00712,復華富時不動產,8,0,8,元大-台南,2023-03-31,9896
1795,美時,10,2,8,元大-台南,2023-03-31,9896
4746,台耀,8,1,7,元大-台南,2023-03-31,9896
3035,智原,14,7,7,元大-台南,2023-03-31,9896
2883,凱基金,11,4,7,元大-台南,2023-03-31,9896
00885,富邦越南,7,0,7,元大-台南,2023-03-31,9896
1802,台玻,7,0,7,元大-台南,2023-03-31,9896
3664,安瑞-KY,8,1,7,元大-台南,2023-03-31,9896
6282,康舒,8,1,7,元大-台南,2023-03-31,9896
2605,新興,7,0,7,元大-台南,2023-03-31,9896
1314,中石化,7,0,7,元大-台南,2023-03-31,9896
2515,中工,8,1,7,元大-台南,2023-03-31,9896
2314,台揚,7,0,7,元大-台南,2023-03-31,9896
0056,元大高股息,23,16,7,元大-台南,2023-03-31,9896
6133,金橋,16,10,6,元大-台南,2023-03-31,9896
2603,長榮,6,0,6,元大-台南,2023-03-31,9896
00632R,元大台灣50反1,401,14,387,元大-台南,2023-04-06,9896
00673R,期元大S＆P原油反1,355,0,355,元大-台南,2023-04-06,9896
3078,僑威,78,2,76,元大-台南,2023-04-06,9896
5222,全訊,72,14,58,元大-台南,2023-04-06,9896
00720B,元大投資級公司債,60,7,53,元大-台南,2023-04-06,9896
2880,華南金,50,0,50,元大-台南,2023-04-06,9896
4960,誠美材,50,0,50,元大-台南,2023-04-06,9896
2344,華邦電,55,6,49,元大-台南,2023-04-06,9896
2884,玉山金,71,23,48,元大-台南,2023-04-06,9896
3032,偉訓,46,2,44,元大-台南,2023-04-06,9896
00679B,元大美債20年,52,13,39,元大-台南,2023-04-06,9896
8931,大汽電,40,1,39,元大-台南,2023-04-06,9896
00902,中信電池及儲能,38,0,38,元大-台南,2023-04-06,9896
00882,中信中國高股息,33,0,33,元大-台南,2023-04-06,9896
00893,國泰智能電動車,29,0,29,元大-台南,2023-04-06,9896
5243,乙盛-KY,30,1,29,元大-台南,2023-04-06,9896
8069,元太,33,8,25,元大-台南,2023-04-06,9896
6548,長科*,24,1,23,元大-台南,2023-04-06,9896
1605,華新,51,31,20,元大-台南,2023-04-06,9896
00885,富邦越南,23,4,19,元大-台南,2023-04-06,9896
6733,博晟生醫,18,0,18,元大-台南,2023-04-06,9896
8028,昇陽半導體,19,1,18,元大-台南,2023-04-06,9896
2337,旺宏,16,0,16,元大-台南,2023-04-06,9896
2891,中信金,16,0,16,元大-台南,2023-04-06,9896
3037,欣興,16,1,15,元大-台南,2023-04-06,9896
1802,台玻,16,1,15,元大-台南,2023-04-06,9896
4157,太景*-KY,15,0,15,元大-台南,2023-04-06,9896
2317,鴻海,19,5,14,元大-台南,2023-04-06,9896
6770,力積電,16,3,13,元大-台南,2023-04-06,9896
5309,系統電,19,6,13,元大-台南,2023-04-06,9896
2542,興富發,15,2,13,元大-台南,2023-04-06,9896
00712,復華富時不動產,63,51,12,元大-台南,2023-04-06,9896
8466,美吉吉-KY,12,0,12,元大-台南,2023-04-06,9896
2609,陽明,19,7,12,元大-台南,2023-04-06,9896
2834,臺企銀,18,7,11,元大-台南,2023-04-06,9896
3231,緯創,27,16,11,元大-台南,2023-04-06,9896
1611,中電,11,0,11,元大-台南,2023-04-06,9896
8088,品安,12,1,11,元大-台南,2023-04-06,9896
3042,晶技,12,1,11,元大-台南,2023-04-06,9896
1218,泰山,11,0,11,元大-台南,2023-04-06,9896
6228,全譜,11,0,11,元大-台南,2023-04-06,9896
6239,力成,10,0,10,元大-台南,2023-04-06,9896
5536,聖暉*,10,0,10,元大-台南,2023-04-06,9896
00669R,國泰美國道瓊反1,10,0,10,元大-台南,2023-04-06,9896
00719B,元大美債1-3,10,0,10,元大-台南,2023-04-06,9896
4938,和碩,10,0,10,元大-台南,2023-04-06,9896
1316,上曜,10,0,10,元大-台南,2023-04-06,9896
8110,華東,10,0,10,元大-台南,2023-04-06,9896
1733,五鼎,10,0,10,元大-台南,2023-04-06,9896
6154,順發,10,0,10,元大-台南,2023-04-06,9896
00632R,元大台灣50反1,247,2,245,元大-台南,2023-04-07,9896
5284,jpp-KY,89,11,78,元大-台南,2023-04-07,9896
00679B,元大美債20年,56,6,50,元大-台南,2023-04-07,9896
2208,台船,38,3,35,元大-台南,2023-04-07,9896
00673R,期元大S＆P原油反1,32,0,32,元大-台南,2023-04-07,9896
4977,眾達-KY,39,8,31,元大-台南,2023-04-07,9896
5512,力麒,29,0,29,元大-台南,2023-04-07,9896
2002,中鋼,28,1,27,元大-台南,2023-04-07,9896
1514,亞力,28,2,26,元大-台南,2023-04-07,9896
3512,皇龍,25,0,25,元大-台南,2023-04-07,9896
2867,三商壽,65,40,25,元大-台南,2023-04-07,9896
4960,誠美材,50,27,23,元大-台南,2023-04-07,9896
5880,合庫金,21,0,21,元大-台南,2023-04-07,9896
3006,晶豪科,37,16,21,元大-台南,2023-04-07,9896
6470,宇智,20,0,20,元大-台南,2023-04-07,9896
4402,郡都開發,20,0,20,元大-台南,2023-04-07,9896
6125,廣運,22,3,19,元大-台南,2023-04-07,9896
2609,陽明,30,12,18,元大-台南,2023-04-07,9896
3664,安瑞-KY,22,4,18,元大-台南,2023-04-07,9896
2302,麗正,22,5,17,元大-台南,2023-04-07,9896
6229,研通,17,0,17,元大-台南,2023-04-07,9896
00713,元大台灣高息低波,19,3,16,元大-台南,2023-04-07,9896
4938,和碩,20,4,16,元大-台南,2023-04-07,9896
2498,宏達電,25,9,16,元大-台南,2023-04-07,9896
6649,台生材,15,0,15,元大-台南,2023-04-07,9896
3276,宇環,15,0,15,元大-台南,2023-04-07,9896
1504,東元,49,35,14,元大-台南,2023-04-07,9896
6197,佳必琪,14,0,14,元大-台南,2023-04-07,9896
3056,富華新,23,10,13,元大-台南,2023-04-07,9896
2636,台驊控股,13,0,13,元大-台南,2023-04-07,9896
6841,長佳智能,48,36,12,元大-台南,2023-04-07,9896
6235,華孚,30,18,12,元大-台南,2023-04-07,9896
0056,元大高股息,13,1,12,元大-台南,2023-04-07,9896
2009,第一銅,11,0,11,元大-台南,2023-04-07,9896
6116,彩晶,11,0,11,元大-台南,2023-04-07,9896
3490,單井,11,0,11,元大-台南,2023-04-07,9896
2317,鴻海,15,5,10,元大-台南,2023-04-07,9896
1612,宏泰,10,0,10,元大-台南,2023-04-07,9896
6288,聯嘉,10,0,10,元大-台南,2023-04-07,9896
8936,國統,10,0,10,元大-台南,2023-04-07,9896
00720B,元大投資級公司債,19,10,9,元大-台南,2023-04-07,9896
2409,友達,9,0,9,元大-台南,2023-04-07,9896
5452,佶優,14,5,9,元大-台南,2023-04-07,9896
2495,普安,9,0,9,元大-台南,2023-04-07,9896
6147,頎邦,12,3,9,元大-台南,2023-04-07,9896
1909,榮成,9,0,9,元大-台南,2023-04-07,9896
4951,精拓科,10,1,9,元大-台南,2023-04-07,9896
006208,富邦台50,8,0,8,元大-台南,2023-04-07,9896
4114,健喬,13,5,8,元大-台南,2023-04-07,9896
2886,兆豐金,8,0,8,元大-台南,2023-04-07,9896
00632R,元大台灣50反1,468,10,458,元大-台南,2023-04-10,9896
00679B,元大美債20年,154,0,154,元大-台南,2023-04-10,9896
4402,郡都開發,149,0,149,元大-台南,2023-04-10,9896
00673R,期元大S＆P原油反1,121,0,121,元大-台南,2023-04-10,9896
8222,寶一,222,137,85,元大-台南,2023-04-10,9896
2211,長榮鋼,70,0,70,元大-台南,2023-04-10,9896
4142,國光生,70,15,55,元大-台南,2023-04-10,9896
8072,陞泰,50,0,50,元大-台南,2023-04-10,9896
2344,華邦電,121,72,49,元大-台南,2023-04-10,9896
5011,久陽,46,3,43,元大-台南,2023-04-10,9896
3715,定穎投控,38,0,38,元大-台南,2023-04-10,9896
3049,精金,37,0,37,元大-台南,2023-04-10,9896
5284,jpp-KY,46,10,36,元大-台南,2023-04-10,9896
1605,華新,48,14,34,元大-台南,2023-04-10,9896
4960,誠美材,50,16,34,元大-台南,2023-04-10,9896
1304,台聚,31,0,31,元大-台南,2023-04-10,9896
2607,榮運,30,0,30,元大-台南,2023-04-10,9896
9105,泰金寶-DR,30,0,30,元大-台南,2023-04-10,9896
3260,威剛,31,2,29,元大-台南,2023-04-10,9896
6290,良維,31,4,27,元大-台南,2023-04-10,9896
00720B,元大投資級公司債,24,0,24,元大-台南,2023-04-10,9896
4129,聯合,23,0,23,元大-台南,2023-04-10,9896
00773B,中信優先金融債,20,0,20,元大-台南,2023-04-10,9896
6167,久正,20,0,20,元大-台南,2023-04-10,9896
4919,新唐,20,1,19,元大-台南,2023-04-10,9896
00888,永豐台灣ESG,17,0,17,元大-台南,2023-04-10,9896
1752,南光,21,4,17,元大-台南,2023-04-10,9896
00712,復華富時不動產,16,0,16,元大-台南,2023-04-10,9896
2382,廣達,18,2,16,元大-台南,2023-04-10,9896
4148,全宇生技-KY,16,0,16,元大-台南,2023-04-10,9896
2603,長榮,25,10,15,元大-台南,2023-04-10,9896
2408,南亞科,14,0,14,元大-台南,2023-04-10,9896
1471,首利,14,0,14,元大-台南,2023-04-10,9896
6122,擎邦,14,0,14,元大-台南,2023-04-10,9896
8050,廣積,43,30,13,元大-台南,2023-04-10,9896
5483,中美晶,13,0,13,元大-台南,2023-04-10,9896
4168,醣聯,13,0,13,元大-台南,2023-04-10,9896
00725B,國泰投資級公司債,12,0,12,元大-台南,2023-04-10,9896
2495,普安,16,4,12,元大-台南,2023-04-10,9896
8033,雷虎,11,0,11,元大-台南,2023-04-10,9896
3479,安勤,13,2,11,元大-台南,2023-04-10,9896
8289,泰藝,11,0,11,元大-台南,2023-04-10,9896
1319,東陽,15,4,11,元大-台南,2023-04-10,9896
6125,廣運,12,1,11,元大-台南,2023-04-10,9896
2610,華航,11,0,11,元大-台南,2023-04-10,9896
5425,台半,22,11,11,元大-台南,2023-04-10,9896
6244,茂迪,20,9,11,元大-台南,2023-04-10,9896
6285,啟��,12,1,11,元大-台南,2023-04-10,9896
2609,陽明,41,31,10,元大-台南,2023-04-10,9896
4977,眾達-KY,17,7,10,元大-台南,2023-04-10,9896
2344,華邦電,345,152,193,元大-台南,2023-04-11,9896
1513,中興電,236,50,186,元大-台南,2023-04-11,9896
00673R,期元大S＆P原油反1,127,0,127,元大-台南,2023-04-11,9896
2027,大成鋼,111,1,110,元大-台南,2023-04-11,9896
3029,零壹,177,81,96,元大-台南,2023-04-11,9896
4402,郡都開發,72,0,72,元大-台南,2023-04-11,9896
1609,大亞,83,21,62,元大-台南,2023-04-11,9896
2367,燿華,48,0,48,元大-台南,2023-04-11,9896
4960,誠美材,70,23,47,元大-台南,2023-04-11,9896
2010,春源,42,0,42,元大-台南,2023-04-11,9896
6612,奈米醫材,39,3,36,元大-台南,2023-04-11,9896
00632R,元大台灣50反1,49,18,31,元大-台南,2023-04-11,9896
00679B,元大美債20年,33,4,29,元大-台南,2023-04-11,9896
00712,復華富時不動產,33,3,30,元大-台南,2023-04-11,9896
3046,建��,52,23,29,元大-台南,2023-04-11,9896
1736,喬山,30,4,26,元大-台南,2023-04-11,9896
8110,華東,37,13,24,元大-台南,2023-04-11,9896
2457,飛宏,37,13,24,元大-台南,2023-04-11,9896
00772B,中信高評級公司債,23,0,23,元大-台南,2023-04-11,9896
6770,力積電,30,7,23,元大-台南,2023-04-11,9896
5425,台半,31,9,22,元大-台南,2023-04-11,9896
4927,泰鼎-KY,22,1,21,元大-台南,2023-04-11,9896
9105,泰金寶-DR,20,0,20,元大-台南,2023-04-11,9896
00708L,期元大S＆P黃金正2,20,0,20,元大-台南,2023-04-11,9896
2317,鴻海,20,2,18,元大-台南,2023-04-11,9896
1440,南紡,20,2,18,元大-台南,2023-04-11,9896
3322,建舜電,22,6,16,元大-台南,2023-04-11,9896
00922,國泰台灣領袖50,19,3,16,元大-台南,2023-04-11,9896
00878,國泰永續高股息,62,47,15,元大-台南,2023-04-11,9896
1731,美吾華,15,0,15,元大-台南,2023-04-11,9896
00885,富邦越南,15,0,15,元大-台南,2023-04-11,9896
2634,漢翔,39,25,14,元大-台南,2023-04-11,9896
1109,信大,20,7,13,元大-台南,2023-04-11,9896
2303,聯電,14,1,13,元大-台南,2023-04-11,9896
3035,智原,17,5,12,元大-台南,2023-04-11,9896
3037,欣興,13,1,12,元大-台南,2023-04-11,9896
00888,永豐台灣ESG,12,0,12,元大-台南,2023-04-11,9896
2834,臺企銀,17,5,12,元大-台南,2023-04-11,9896
2867,三商壽,11,0,11,元大-台南,2023-04-11,9896
3714,富采,16,6,10,元大-台南,2023-04-11,9896
00719B,元大美債1-3,10,0,10,元大-台南,2023-04-11,9896
00787B,元大10年IG醫療債,10,0,10,元大-台南,2023-04-11,9896
4105,東洋,10,0,10,元大-台南,2023-04-11,9896
8112,至上,13,3,10,元大-台南,2023-04-11,9896
6245,立端,14,5,9,元大-台南,2023-04-11,9896
1471,首利,13,4,9,元大-台南,2023-04-11,9896
00725B,國泰投資級公司債,9,0,9,元大-台南,2023-04-11,9896
8210,勤誠,10,1,9,元大-台南,2023-04-11,9896
5009,榮剛,20,11,9,元大-台南,2023-04-11,9896
6753,龍德造船,10,1,9,元大-台南,2023-04-11,9896
3624,光頡,191,11,180,元大-台南,2023-04-12,9896
00673R,期元大S＆P原油反1,131,0,131,元大-台南,2023-04-12,9896
00720B,元大投資級公司債,99,0,99,元大-台南,2023-04-12,9896
00633L,富邦上証正2,96,0,96,元大-台南,2023-04-12,9896
2027,大成鋼,102,15,87,元大-台南,2023-04-12,9896
2610,華航,77,6,71,元大-台南,2023-04-12,9896
00912,中信臺灣智慧50,65,0,65,元大-台南,2023-04-12,9896
9105,泰金寶-DR,50,1,49,元大-台南,2023-04-12,9896
00637L,元大滬深300正2,69,23,46,元大-台南,2023-04-12,9896
5512,力麒,41,0,41,元大-台南,2023-04-12,9896
2367,燿華,50,12,38,元大-台南,2023-04-12,9896
2834,臺企銀,36,0,36,元大-台南,2023-04-12,9896
00712,復華富時不動產,34,2,32,元大-台南,2023-04-12,9896
1762,中化生,41,11,30,元大-台南,2023-04-12,9896
2495,普安,37,8,29,元大-台南,2023-04-12,9896
00708L,期元大S＆P黃金正2,27,0,27,元大-台南,2023-04-12,9896
1471,首利,127,102,25,元大-台南,2023-04-12,9896
8933,愛地雅,24,0,24,元大-台南,2023-04-12,9896
0056,元大高股息,57,34,23,元大-台南,2023-04-12,9896
3236,千如,21,0,21,元大-台南,2023-04-12,9896
2892,第一金,42,22,20,元大-台南,2023-04-12,9896
4968,立積,22,4,18,元大-台南,2023-04-12,9896
00632R,元大台灣50反1,27,10,17,元大-台南,2023-04-12,9896
4129,聯合,17,0,17,元大-台南,2023-04-12,9896
1709,和益,17,0,17,元大-台南,2023-04-12,9896
00679B,元大美債20年,21,4,17,元大-台南,2023-04-12,9896
2330,台積電,23,6,17,元大-台南,2023-04-12,9896
00878,國泰永續高股息,40,24,16,元大-台南,2023-04-12,9896
2481,強茂,20,5,15,元大-台南,2023-04-12,9896
8049,晶采,14,0,14,元大-台南,2023-04-12,9896
6470,宇智,14,0,14,元大-台南,2023-04-12,9896
9945,潤泰新,16,2,14,元大-台南,2023-04-12,9896
3046,建��,13,0,13,元大-台南,2023-04-12,9896
8046,南電,16,3,13,元大-台南,2023-04-12,9896
3056,富華新,21,8,13,元大-台南,2023-04-12,9896
8171,天宇,13,1,12,元大-台南,2023-04-12,9896
6733,博晟生醫,12,0,12,元大-台南,2023-04-12,9896
6548,長科*,12,0,12,元大-台南,2023-04-12,9896
2317,鴻海,15,4,11,元大-台南,2023-04-12,9896
1101,台泥,18,7,11,元大-台南,2023-04-12,9896
8112,至上,11,0,11,元大-台南,2023-04-12,9896
4967,十銓,17,7,10,元大-台南,2023-04-12,9896
00919,群益台灣精選高息,11,0,11,元大-台南,2023-04-12,9896
3406,玉晶光,10,0,10,元大-台南,2023-04-12,9896
1319,東陽,13,3,10,元大-台南,2023-04-12,9896
1718,中纖,10,0,10,元大-台南,2023-04-12,9896
6127,九豪,10,0,10,元大-台南,2023-04-12,9896
2105,正新,10,0,10,元大-台南,2023-04-12,9896
2618,長榮航,25,15,10,元大-台南,2023-04-12,9896
4973,廣穎,10,0,10,元大-台南,2023-04-12,9896
00673R,期元大S＆P原油反1,185,0,185,元大-台南,2023-04-13,9896
2329,華泰,156,5,151,元大-台南,2023-04-13,9896
2201,裕隆,112,10,102,元大-台南,2023-04-13,9896
5009,榮剛,134,57,77,元大-台南,2023-04-13,9896
00632R,元大台灣50反1,118,44,74,元大-台南,2023-04-13,9896
2367,燿華,74,0,74,元大-台南,2023-04-13,9896
4960,誠美材,75,1,74,元大-台南,2023-04-13,9896
2344,華邦電,86,20,66,元大-台南,2023-04-13,9896
1605,華新,70,4,66,元大-台南,2023-04-13,9896
2034,允強,51,0,51,元大-台南,2023-04-13,9896
00712,復華富時不動產,42,0,42,元大-台南,2023-04-13,9896
1752,南光,53,12,41,元大-台南,2023-04-13,9896
3260,威剛,41,1,40,元大-台南,2023-04-13,9896
3056,富華新,45,8,37,元大-台南,2023-04-13,9896
3276,宇環,36,0,36,元大-台南,2023-04-13,9896
2883,凱基金,36,2,34,元大-台南,2023-04-13,9896
2618,長榮航,64,30,34,元大-台南,2023-04-13,9896
0056,元大高股息,33,1,32,元大-台南,2023-04-13,9896
3032,偉訓,62,31,31,元大-台南,2023-04-13,9896
2867,三商壽,33,4,29,元大-台南,2023-04-13,9896
2330,台積電,32,4,28,元大-台南,2023-04-13,9896
2630,亞航,32,4,28,元大-台南,2023-04-13,9896
1609,大亞,73,46,27,元大-台南,2023-04-13,9896
00720B,元大投資級公司債,27,0,27,元大-台南,2023-04-13,9896
1514,亞力,75,49,26,元大-台南,2023-04-13,9896
1503,士電,44,20,24,元大-台南,2023-04-13,9896
3078,僑威,37,15,22,元大-台南,2023-04-13,9896
2812,台中銀,24,2,22,元大-台南,2023-04-13,9896
6187,萬潤,20,0,20,元大-台南,2023-04-13,9896
9962,有益,27,7,20,元大-台南,2023-04-13,9896
1718,中纖,20,1,19,元大-台南,2023-04-13,9896
2313,華通,19,0,19,元大-台南,2023-04-13,9896
3711,日月光投控,21,3,18,元大-台南,2023-04-13,9896
6163,華電網,39,22,17,元大-台南,2023-04-13,9896
5309,系統電,25,8,17,元大-台南,2023-04-13,9896
1611,中電,26,10,16,元大-台南,2023-04-13,9896
3499,環天科,34,18,16,元大-台南,2023-04-13,9896
1582,信錦,15,0,15,元大-台南,2023-04-13,9896
3390,旭軟,15,0,15,元大-台南,2023-04-13,9896
4129,聯合,16,1,15,元大-台南,2023-04-13,9896
6186,新潤,15,0,15,元大-台南,2023-04-13,9896
6182,合晶,20,5,15,元大-台南,2023-04-13,9896
2382,廣達,18,4,14,元大-台南,2023-04-13,9896
00725B,國泰投資級公司債,14,0,14,元大-台南,2023-04-13,9896
3006,晶豪科,46,33,13,元大-台南,2023-04-13,9896
8033,雷虎,15,2,13,元大-台南,2023-04-13,9896
00893,國泰智能電動車,12,0,12,元大-台南,2023-04-13,9896
8088,品安,17,5,12,元大-台南,2023-04-13,9896
5498,凱崴,12,0,12,元大-台南,2023-04-13,9896
8936,國統,16,5,11,元大-台南,2023-04-13,9896
3481,群創,826,68,758,元大-台南,2023-04-14,9896
00882,中信中國高股息,400,7,393,元大-台南,2023-04-14,9896
5347,世界,377,0,377,元大-台南,2023-04-14,9896
9958,世紀鋼,301,1,300,元大-台南,2023-04-14,9896
2367,燿華,128,3,125,元大-台南,2023-04-14,9896
3049,精金,118,6,112,元大-台南,2023-04-14,9896
2645,長榮航太,99,5,94,元大-台南,2023-04-14,9896
00632R,元大台灣50反1,229,137,92,元大-台南,2023-04-14,9896
00712,復華富時不動產,83,1,82,元大-台南,2023-04-14,9896
2208,台船,86,35,51,元大-台南,2023-04-14,9896
5512,力麒,52,2,50,元大-台南,2023-04-14,9896
00679B,元大美債20年,50,2,48,元大-台南,2023-04-14,9896
1584,精剛,89,46,43,元大-台南,2023-04-14,9896
6477,安集,47,5,42,元大-台南,2023-04-14,9896
00720B,元大投資級公司債,41,0,41,元大-台南,2023-04-14,9896
2634,漢翔,160,119,41,元大-台南,2023-04-14,9896
5222,全訊,42,1,41,元大-台南,2023-04-14,9896
00637L,元大滬深300正2,58,19,39,元大-台南,2023-04-14,9896
00751B,元大AAA至A公司債,36,0,36,元大-台南,2023-04-14,9896
9907,統一實,37,2,35,元大-台南,2023-04-14,9896
00673R,期元大S＆P原油反1,35,0,35,元大-台南,2023-04-14,9896
2382,廣達,41,7,34,元大-台南,2023-04-14,9896
2201,裕隆,40,10,30,元大-台南,2023-04-14,9896
8215,明基材,33,4,29,元大-台南,2023-04-14,9896
2014,中鴻,28,0,28,元大-台南,2023-04-14,9896
1720,生達,29,2,27,元大-台南,2023-04-14,9896
8222,寶一,48,23,25,元大-台南,2023-04-14,9896
1101,台泥,26,2,24,元大-台南,2023-04-14,9896
00885,富邦越南,23,0,23,元大-台南,2023-04-14,9896
2610,華航,45,22,23,元大-台南,2023-04-14,9896
2303,聯電,30,9,21,元大-台南,2023-04-14,9896
2867,三商壽,33,12,21,元大-台南,2023-04-14,9896
3013,晟銘電,21,1,20,元大-台南,2023-04-14,9896
00722B,群益投資級電信債,20,0,20,元大-台南,2023-04-14,9896
0056,元大高股息,18,0,18,元大-台南,2023-04-14,9896
4904,遠傳,20,2,18,元大-台南,2023-04-14,9896
1609,大亞,36,18,18,元大-台南,2023-04-14,9896
5353,台林,17,0,17,元大-台南,2023-04-14,9896
1718,中纖,16,0,16,元大-台南,2023-04-14,9896
6120,達運,20,5,15,元大-台南,2023-04-14,9896
2883,凱基金,41,26,15,元大-台南,2023-04-14,9896
5498,凱崴,15,0,15,元大-台南,2023-04-14,9896
2457,飛宏,46,31,15,元大-台南,2023-04-14,9896
8383,千附,16,2,14,元大-台南,2023-04-14,9896
8105,凌巨,15,1,14,元大-台南,2023-04-14,9896
00715L,期街口布蘭特正2,15,1,14,元大-台南,2023-04-14,9896
00708L,期元大S＆P黃金正2,13,0,13,元大-台南,2023-04-14,9896
3025,星通,13,1,12,元大-台南,2023-04-14,9896
3058,立德,16,4,12,元大-台南,2023-04-14,9896
3006,晶豪科,25,14,11,元大-台南,2023-04-14,9896
1605,華新,330,51,279,元大-台南,2023-04-17,9896
00720B,元大投資級公司債,151,0,151,元大-台南,2023-04-17,9896
2834,臺企銀,105,4,101,元大-台南,2023-04-17,9896
8924,大田,101,1,100,元大-台南,2023-04-17,9896
8936,國統,107,15,92,元大-台南,2023-04-17,9896
3231,緯創,93,14,79,元大-台南,2023-04-17,9896
5347,世界,79,3,76,元大-台南,2023-04-17,9896
00712,復華富時不動產,67,0,67,元大-台南,2023-04-17,9896
1101,台泥,81,18,63,元大-台南,2023-04-17,9896
6113,亞矽,114,62,52,元大-台南,2023-04-17,9896
6143,振曜,51,1,50,元大-台南,2023-04-17,9896
1519,華城,59,11,48,元大-台南,2023-04-17,9896
00885,富邦越南,47,0,47,元大-台南,2023-04-17,9896
1503,士電,58,13,45,元大-台南,2023-04-17,9896
00679B,元大美債20年,44,1,43,元大-台南,2023-04-17,9896
1718,中纖,43,1,42,元大-台南,2023-04-17,9896
2610,華航,42,2,40,元大-台南,2023-04-17,9896
2614,東森,38,2,36,元大-台南,2023-04-17,9896
00680L,元大美債20正2,32,0,32,元大-台南,2023-04-17,9896
6005,群益證,32,1,31,元大-台南,2023-04-17,9896
2731,雄獅,32,2,30,元大-台南,2023-04-17,9896
3093,港建*,30,2,28,元大-台南,2023-04-17,9896
2312,金寶,74,47,27,元大-台南,2023-04-17,9896
3013,晟銘電,47,21,26,元大-台南,2023-04-17,9896
00632R,元大台灣50反1,31,5,26,元大-台南,2023-04-17,9896
2206,三陽工業,89,65,24,元大-台南,2023-04-17,9896
2236,百達-KY,22,1,21,元大-台南,2023-04-17,9896
2002,中鋼,24,3,21,元大-台南,2023-04-17,9896
1517,利奇,20,0,20,元大-台南,2023-04-17,9896
4707,磐亞,20,0,20,元大-台南,2023-04-17,9896
3005,神基,34,14,20,元大-台南,2023-04-17,9896
5512,力麒,23,5,18,元大-台南,2023-04-17,9896
6116,彩晶,18,1,17,元大-台南,2023-04-17,9896
5258,虹堡,19,2,17,元大-台南,2023-04-17,9896
2329,華泰,26,9,17,元大-台南,2023-04-17,9896
8028,昇陽半導體,23,7,16,元大-台南,2023-04-17,9896
2634,漢翔,81,65,16,元大-台南,2023-04-17,9896
2645,長榮航太,20,5,15,元大-台南,2023-04-17,9896
1440,南紡,14,0,14,元大-台南,2023-04-17,9896
1609,大亞,28,14,14,元大-台南,2023-04-17,9896
2885,元大金,13,0,13,元大-台南,2023-04-17,9896
3702,大聯大,13,0,13,元大-台南,2023-04-17,9896
3499,環天科,17,4,13,元大-台南,2023-04-17,9896
6140,訊達,13,0,13,元大-台南,2023-04-17,9896
3011,今皓,12,0,12,元大-台南,2023-04-17,9896
2371,大同,12,0,12,元大-台南,2023-04-17,9896
5522,遠雄,12,0,12,元大-台南,2023-04-17,9896
1809,中釉,20,8,12,元大-台南,2023-04-17,9896
3484,崧騰,12,0,12,元大-台南,2023-04-17,9896
4541,晟田,15,3,12,元大-台南,2023-04-17,9896
00673R,期元大S＆P原油反1,260,3,257,元大-台南,2023-04-18,9896
3035,智原,225,3,222,元大-台南,2023-04-18,9896
00679B,元大美債20年,190,0,190,元大-台南,2023-04-18,9896
00632R,元大台灣50反1,169,4,165,元大-台南,2023-04-18,9896
2104,國際中橡,130,0,130,元大-台南,2023-04-18,9896
00680L,元大美債20正2,114,1,113,元大-台南,2023-04-18,9896
00772B,中信高評級公司債,92,1,91,元大-台南,2023-04-18,9896
00720B,元大投資級公司債,87,0,87,元大-台南,2023-04-18,9896
1519,華城,95,19,76,元大-台南,2023-04-18,9896
2634,漢翔,155,85,70,元大-台南,2023-04-18,9896
2208,台船,68,6,62,元大-台南,2023-04-18,9896
8299,群聯,60,0,60,元大-台南,2023-04-18,9896
6477,安集,59,7,52,元大-台南,2023-04-18,9896
6625,必應,48,1,47,元大-台南,2023-04-18,9896
5009,榮剛,67,27,40,元大-台南,2023-04-18,9896
2609,陽明,56,17,39,元大-台南,2023-04-18,9896
1471,首利,34,0,34,元大-台南,2023-04-18,9896
3231,緯創,40,7,33,元大-台南,2023-04-18,9896
5512,力麒,34,1,33,元大-台南,2023-04-18,9896
6770,力積電,107,75,32,元大-台南,2023-04-18,9896
00725B,國泰投資級公司債,31,0,31,元大-台南,2023-04-18,9896
00888,永豐台灣ESG,32,2,30,元大-台南,2023-04-18,9896
4550,長佳,30,1,29,元大-台南,2023-04-18,9896
1101,台泥,37,12,25,元大-台南,2023-04-18,9896
1809,中釉,47,23,24,元大-台南,2023-04-18,9896
6266,泰詠,26,2,24,元大-台南,2023-04-18,9896
00712,復華富時不動產,23,0,23,元大-台南,2023-04-18,9896
00751B,元大AAA至A公司債,22,0,22,元大-台南,2023-04-18,9896
2883,凱基金,36,15,21,元大-台南,2023-04-18,9896
00900,富邦特選高股息30,22,2,20,元大-台南,2023-04-18,9896
1529,樂事綠能,41,21,20,元大-台南,2023-04-18,9896
1605,華新,53,34,19,元大-台南,2023-04-18,9896
6470,宇智,32,14,18,元大-台南,2023-04-18,9896
6113,亞矽,26,8,18,元大-台南,2023-04-18,9896
6138,茂達,23,6,17,元大-台南,2023-04-18,9896
2409,友達,39,23,16,元大-台南,2023-04-18,9896
2601,益航,20,4,16,元大-台南,2023-04-18,9896
9103,美德醫療-DR,16,0,16,元大-台南,2023-04-18,9896
6148,驊宏資,15,0,15,元大-台南,2023-04-18,9896
6005,群益證,18,3,15,元大-台南,2023-04-18,9896
3013,晟銘電,40,26,14,元大-台南,2023-04-18,9896
3037,欣興,16,3,13,元大-台南,2023-04-18,9896
2637,慧洋-KY,14,1,13,元大-台南,2023-04-18,9896
1611,中電,13,0,13,元大-台南,2023-04-18,9896
3362,先進光,16,3,13,元大-台南,2023-04-18,9896
3289,宜特,19,6,13,元大-台南,2023-04-18,9896
6147,頎邦,13,0,13,元大-台南,2023-04-18,9896
6649,台生材,12,0,12,元大-台南,2023-04-18,9896
4739,康普,11,0,11,元大-台南,2023-04-18,9896
8476,台境*,12,1,11,元大-台南,2023-04-18,9896
00720B,元大投資級公司債,275,1,274,元大-台南,2023-04-19,9896
00673R,期元大S＆P原油反1,150,0,150,元大-台南,2023-04-19,9896
2886,兆豐金,136,6,130,元大-台南,2023-04-19,9896
9958,世紀鋼,102,4,98,元大-台南,2023-04-19,9896
00900,富邦特選高股息30,94,0,94,元大-台南,2023-04-19,9896
4164,承業醫,94,10,84,元大-台南,2023-04-19,9896
2367,燿華,78,2,76,元大-台南,2023-04-19,9896
2009,第一銅,60,4,56,元大-台南,2023-04-19,9896
6770,力積電,56,4,52,元大-台南,2023-04-19,9896
2634,漢翔,99,50,49,元大-台南,2023-04-19,9896
1504,東元,66,18,48,元大-台南,2023-04-19,9896
3046,建��,65,21,44,元大-台南,2023-04-19,9896
3058,立德,43,2,41,元大-台南,2023-04-19,9896
00637L,元大滬深300正2,111,71,40,元大-台南,2023-04-19,9896
00679B,元大美債20年,49,10,39,元大-台南,2023-04-19,9896
2748,雲品,52,18,34,元大-台南,2023-04-19,9896
3221,台嘉碩,27,0,27,元大-台南,2023-04-19,9896
2492,華新科,28,2,26,元大-台南,2023-04-19,9896
6806,森崴能源,68,44,24,元大-台南,2023-04-19,9896
00725B,國泰投資級公司債,23,0,23,元大-台南,2023-04-19,9896
1514,亞力,25,2,23,元大-台南,2023-04-19,9896
00712,復華富時不動產,22,0,22,元大-台南,2023-04-19,9896
00772B,中信高評級公司債,21,0,21,元大-台南,2023-04-19,9896
2610,華航,20,0,20,元大-台南,2023-04-19,9896
00680L,元大美債20正2,20,0,20,元大-台南,2023-04-19,9896
6570,維田,21,1,20,元大-台南,2023-04-19,9896
2375,凱美,18,0,18,元大-台南,2023-04-19,9896
0056,元大高股息,23,5,18,元大-台南,2023-04-19,9896
8033,雷虎,34,17,17,元大-台南,2023-04-19,9896
6125,廣運,21,4,17,元大-台南,2023-04-19,9896
00885,富邦越南,17,0,17,元大-台南,2023-04-19,9896
3664,安瑞-KY,15,0,15,元大-台南,2023-04-19,9896
2014,中鴻,15,0,15,元大-台南,2023-04-19,9896
4961,天鈺,20,5,15,元大-台南,2023-04-19,9896
3363,上詮,28,14,14,元大-台南,2023-04-19,9896
3027,盛達,17,3,14,元大-台南,2023-04-19,9896
2313,華通,14,1,13,元大-台南,2023-04-19,9896
00751B,元大AAA至A公司債,13,0,13,元大-台南,2023-04-19,9896
00891,中信關鍵半導體,14,1,13,元大-台南,2023-04-19,9896
6213,聯茂,13,0,13,元大-台南,2023-04-19,9896
2498,宏達電,15,3,12,元大-台南,2023-04-19,9896
3037,欣興,14,2,12,元大-台南,2023-04-19,9896
4916,事欣科,12,0,12,元大-台南,2023-04-19,9896
00687B,國泰20年美債,12,0,12,元大-台南,2023-04-19,9896
6228,全譜,12,0,12,元大-台南,2023-04-19,9896
6488,環球晶,12,1,11,元大-台南,2023-04-19,9896
2328,廣宇,20,9,11,元大-台南,2023-04-19,9896
2330,台積電,15,5,10,元大-台南,2023-04-19,9896
00888,永豐台灣ESG,11,1,10,元大-台南,2023-04-19,9896
020037,元大金融高股息N,10,0,10,元大-台南,2023-04-19,9896
00632R,元大台灣50反1,590,85,505,元大-台南,2023-04-20,9896
3032,偉訓,61,3,58,元大-台南,2023-04-20,9896
3046,建��,57,4,53,元大-台南,2023-04-20,9896
00720B,元大投資級公司債,50,0,50,元大-台南,2023-04-20,9896
1609,大亞,96,49,47,元大-台南,2023-04-20,9896
2317,鴻海,52,8,44,元大-台南,2023-04-20,9896
00673R,期元大S＆P原油反1,100,59,41,元大-台南,2023-04-20,9896
2618,長榮航,40,2,38,元大-台南,2023-04-20,9896
1795,美時,58,20,38,元大-台南,2023-04-20,9896
4707,磐亞,34,0,34,元大-台南,2023-04-20,9896
6235,華孚,49,19,30,元大-台南,2023-04-20,9896
1517,利奇,30,0,30,元大-台南,2023-04-20,9896
00900,富邦特選高股息30,29,0,29,元大-台南,2023-04-20,9896
6266,泰詠,28,0,28,元大-台南,2023-04-20,9896
2312,金寶,27,0,27,元大-台南,2023-04-20,9896
2457,飛宏,51,24,27,元大-台南,2023-04-20,9896
4123,晟德,31,5,26,元大-台南,2023-04-20,9896
4934,太極,28,4,24,元大-台南,2023-04-20,9896
2367,燿華,25,1,24,元大-台南,2023-04-20,9896
6290,良維,23,0,23,元大-台南,2023-04-20,9896
2303,聯電,32,9,23,元大-台南,2023-04-20,9896
3481,群創,42,21,21,元大-台南,2023-04-20,9896
6443,元晶,35,14,21,元大-台南,2023-04-20,9896
00712,復華富時不動產,20,0,20,元大-台南,2023-04-20,9896
0056,元大高股息,26,6,20,元大-台南,2023-04-20,9896
2753,八方雲集,23,3,20,元大-台南,2023-04-20,9896
2615,萬海,21,1,20,元大-台南,2023-04-20,9896
5009,榮剛,58,38,20,元大-台南,2023-04-20,9896
8111,立��,41,22,19,元大-台南,2023-04-20,9896
1402,遠東新,18,0,18,元大-台南,2023-04-20,9896
00637L,元大滬深300正2,20,3,17,元大-台南,2023-04-20,9896
2409,友達,18,1,17,元大-台南,2023-04-20,9896
3027,盛達,24,7,17,元大-台南,2023-04-20,9896
1301,台塑,17,0,17,元大-台南,2023-04-20,9896
00878,國泰永續高股息,63,46,17,元大-台南,2023-04-20,9896
3078,僑威,28,12,16,元大-台南,2023-04-20,9896
4968,立積,33,17,16,元大-台南,2023-04-20,9896
5309,系統電,17,1,16,元大-台南,2023-04-20,9896
8064,東捷,15,0,15,元大-台南,2023-04-20,9896
1802,台玻,18,4,14,元大-台南,2023-04-20,9896
2201,裕隆,24,10,14,元大-台南,2023-04-20,9896
00888,永豐台灣ESG,13,0,13,元大-台南,2023-04-20,9896
2324,仁寶,18,5,13,元大-台南,2023-04-20,9896
2637,慧洋-KY,13,0,13,元大-台南,2023-04-20,9896
8222,寶一,24,11,13,元大-台南,2023-04-20,9896
1786,科妍,25,12,13,元大-台南,2023-04-20,9896
00788B,元大10年IG電能債,13,0,13,元大-台南,2023-04-20,9896
4536,拓凱,15,3,12,元大-台南,2023-04-20,9896
8105,凌巨,11,0,11,元大-台南,2023-04-20,9896
00633L,富邦上証正2,12,1,11,元大-台南,2023-04-20,9896
00632R,元大台灣50反1,229,64,165,元大-台南,2023-04-21,9896
2913,農林,186,60,126,元大-台南,2023-04-21,9896
00680L,元大美債20正2,101,2,99,元大-台南,2023-04-21,9896
3481,群創,115,20,95,元大-台南,2023-04-21,9896
9946,三發地產,60,0,60,元大-台南,2023-04-21,9896
00900,富邦特選高股息30,59,1,58,元大-台南,2023-04-21,9896
6125,廣運,54,1,53,元大-台南,2023-04-21,9896
00637L,元大滬深300正2,58,9,49,元大-台南,2023-04-21,9896
3058,立德,72,25,47,元大-台南,2023-04-21,9896
1104,環泥,40,0,40,元大-台南,2023-04-21,9896
00878,國泰永續高股息,70,32,38,元大-台南,2023-04-21,9896
00772B,中信高評級公司債,35,0,35,元大-台南,2023-04-21,9896
1904,正隆,60,26,34,元大-台南,2023-04-21,9896
1909,榮成,48,16,32,元大-台南,2023-04-21,9896
9939,宏全,32,2,30,元大-台南,2023-04-21,9896
2867,三商壽,30,0,30,元大-台南,2023-04-21,9896
1517,利奇,30,0,30,元大-台南,2023-04-21,9896
2888,新光金,32,4,28,元大-台南,2023-04-21,9896
2208,台船,38,11,27,元大-台南,2023-04-21,9896
6547,高端疫苗,26,0,26,元大-台南,2023-04-21,9896
00715L,期街口布蘭特正2,30,5,25,元大-台南,2023-04-21,9896
0056,元大高股息,40,15,25,元大-台南,2023-04-21,9896
2605,新興,25,0,25,元大-台南,2023-04-21,9896
4142,國光生,25,0,25,元大-台南,2023-04-21,9896
00720B,元大投資級公司債,27,3,24,元大-台南,2023-04-21,9896
3047,訊舟,32,8,24,元大-台南,2023-04-21,9896
6285,啟��,27,3,24,元大-台南,2023-04-21,9896
6770,力積電,33,10,23,元大-台南,2023-04-21,9896
2027,大成鋼,25,2,23,元大-台南,2023-04-21,9896
2312,金寶,23,1,22,元大-台南,2023-04-21,9896
6147,頎邦,22,0,22,元大-台南,2023-04-21,9896
00679B,元大美債20年,23,1,22,元大-台南,2023-04-21,9896
2618,長榮航,21,0,21,元大-台南,2023-04-21,9896
3380,明泰,21,0,21,元大-台南,2023-04-21,9896
6163,華電網,22,1,21,元大-台南,2023-04-21,9896
6244,茂迪,52,31,21,元大-台南,2023-04-21,9896
5009,榮剛,52,32,20,元大-台南,2023-04-21,9896
00673R,期元大S＆P原油反1,50,30,20,元大-台南,2023-04-21,9896
4770,上品,20,0,20,元大-台南,2023-04-21,9896
6829,千附精密,30,11,19,元大-台南,2023-04-21,9896
3231,緯創,65,46,19,元大-台南,2023-04-21,9896
2317,鴻海,40,22,18,元大-台南,2023-04-21,9896
5498,凱崴,17,0,17,元大-台南,2023-04-21,9896
2344,華邦電,18,1,17,元大-台南,2023-04-21,9896
4934,太極,16,0,16,元大-台南,2023-04-21,9896
3704,合勤控,18,2,16,元大-台南,2023-04-21,9896
3038,全台,17,1,16,元大-台南,2023-04-21,9896
2482,連宇,16,0,16,元大-台南,2023-04-21,9896
4979,華星光,28,13,15,元大-台南,2023-04-21,9896
6290,良維,15,0,15,元大-台南,2023-04-21,9896
3035,智原,237,1,236,元大-台南,2023-04-24,9896
00679B,元大美債20年,126,0,126,元大-台南,2023-04-24,9896
00637L,元大滬深300正2,132,12,120,元大-台南,2023-04-24,9896
8936,國統,107,0,107,元大-台南,2023-04-24,9896
2027,大成鋼,72,3,69,元大-台南,2023-04-24,9896
00633L,富邦上証正2,68,0,68,元大-台南,2023-04-24,9896
5243,乙盛-KY,35,0,35,元大-台南,2023-04-24,9896
4960,誠美材,31,0,31,元大-台南,2023-04-24,9896
2313,華通,33,4,29,元大-台南,2023-04-24,9896
2630,亞航,29,0,29,元大-台南,2023-04-24,9896
2605,新興,33,5,28,元大-台南,2023-04-24,9896
00878,國泰永續高股息,42,14,28,元大-台南,2023-04-24,9896
00882,中信中國高股息,27,0,27,元大-台南,2023-04-24,9896
2303,聯電,71,46,25,元大-台南,2023-04-24,9896
00900,富邦特選高股息30,26,0,26,元大-台南,2023-04-24,9896
0056,元大高股息,27,2,25,元大-台南,2023-04-24,9896
9907,統一實,28,5,23,元大-台南,2023-04-24,9896
2330,台積電,28,5,23,元大-台南,2023-04-24,9896
3576,聯合再生,22,0,22,元大-台南,2023-04-24,9896
1709,和益,23,2,21,元大-台南,2023-04-24,9896
00680L,元大美債20正2,21,0,21,元大-台南,2023-04-24,9896
4770,上品,20,0,20,元大-台南,2023-04-24,9896
4540,全球傳動,20,0,20,元大-台南,2023-04-24,9896
00902,中信電池及儲能,19,0,19,元大-台南,2023-04-24,9896
1516,川飛,17,0,17,元大-台南,2023-04-24,9896
4968,立積,20,3,17,元大-台南,2023-04-24,9896
2913,農林,31,15,16,元大-台南,2023-04-24,9896
00712,復華富時不動產,15,1,14,元大-台南,2023-04-24,9896
2399,映泰,16,2,14,元大-台南,2023-04-24,9896
2634,漢翔,51,37,14,元大-台南,2023-04-24,9896
1605,華新,23,10,13,元大-台南,2023-04-24,9896
6576,逸達,12,0,12,元大-台南,2023-04-24,9896
00751B,元大AAA至A公司債,11,0,11,元大-台南,2023-04-24,9896
00789B,復華公司債A3,11,0,11,元大-台南,2023-04-24,9896
1519,華城,19,8,11,元大-台南,2023-04-24,9896
2610,華航,13,3,10,元大-台南,2023-04-24,9896
2903,遠百,10,0,10,元大-台南,2023-04-24,9896
2618,長榮航,11,1,10,元大-台南,2023-04-24,9896
00753L,中信中國50正2,10,0,10,元大-台南,2023-04-24,9896
6229,研通,10,0,10,元大-台南,2023-04-24,9896
2457,飛宏,25,16,9,元大-台南,2023-04-24,9896
2317,鴻海,10,1,9,元大-台南,2023-04-24,9896
2324,仁寶,9,0,9,元大-台南,2023-04-24,9896
5388,中磊,10,1,9,元大-台南,2023-04-24,9896
3479,安勤,9,0,9,元大-台南,2023-04-24,9896
6244,茂迪,11,2,9,元大-台南,2023-04-24,9896
6235,華孚,21,13,8,元大-台南,2023-04-24,9896
9946,三發地產,8,0,8,元大-台南,2023-04-24,9896
1905,華紙,33,25,8,元大-台南,2023-04-24,9896
1810,和成,12,4,8,元大-台南,2023-04-24,9896
1101,台泥,229,45,184,元大-台南,2023-04-25,9896
5880,合庫金,131,2,129,元大-台南,2023-04-25,9896
4919,新唐,115,1,114,元大-台南,2023-04-25,9896
1504,東元,118,19,99,元大-台南,2023-04-25,9896
00878,國泰永續高股息,118,23,95,元大-台南,2023-04-25,9896
00900,富邦特選高股息30,91,0,91,元大-台南,2023-04-25,9896
1909,榮成,84,4,80,元大-台南,2023-04-25,9896
6703,軒郁,75,1,74,元大-台南,2023-04-25,9896
3231,緯創,88,26,62,元大-台南,2023-04-25,9896
2489,瑞軒,60,0,60,元大-台南,2023-04-25,9896
00902,中信電池及儲能,61,5,56,元大-台南,2023-04-25,9896
6125,廣運,57,1,56,元大-台南,2023-04-25,9896
00671R,富邦NASDAQ反1,55,0,55,元大-台南,2023-04-25,9896
6026,福邦證,53,0,53,元大-台南,2023-04-25,9896
1314,中石化,55,9,46,元大-台南,2023-04-25,9896
2634,漢翔,279,234,45,元大-台南,2023-04-25,9896
2344,華邦電,46,3,43,元大-台南,2023-04-25,9896
2027,大成鋼,43,1,42,元大-台南,2023-04-25,9896
00637L,元大滬深300正2,71,31,40,元大-台南,2023-04-25,9896
9907,統一實,40,1,39,元大-台南,2023-04-25,9896
1905,華紙,113,74,39,元大-台南,2023-04-25,9896
1605,華新,54,20,34,元大-台南,2023-04-25,9896
2409,友達,38,5,33,元大-台南,2023-04-25,9896
2515,中工,38,5,33,元大-台南,2023-04-25,9896
1611,中電,32,0,32,元大-台南,2023-04-25,9896
6266,泰詠,34,5,29,元大-台南,2023-04-25,9896
2303,聯電,85,58,27,元大-台南,2023-04-25,9896
2618,長榮航,29,3,26,元大-台南,2023-04-25,9896
8936,國統,24,1,23,元大-台南,2023-04-25,9896
6282,康舒,145,122,23,元大-台南,2023-04-25,9896
2206,三陽工業,76,54,22,元大-台南,2023-04-25,9896
0050,元大台灣50,22,1,21,元大-台南,2023-04-25,9896
6148,驊宏資,23,2,21,元大-台南,2023-04-25,9896
2610,華航,33,13,20,元大-台南,2023-04-25,9896
2605,新興,20,0,20,元大-台南,2023-04-25,9896
2329,華泰,29,9,20,元大-台南,2023-04-25,9896
2330,台積電,27,9,18,元大-台南,2023-04-25,9896
1604,聲寶,17,0,17,元大-台南,2023-04-25,9896
2002,中鋼,18,1,17,元大-台南,2023-04-25,9896
2317,鴻海,23,8,15,元大-台南,2023-04-25,9896
4129,聯合,15,0,15,元大-台南,2023-04-25,9896
5498,凱崴,15,0,15,元大-台南,2023-04-25,9896
6228,全譜,15,0,15,元大-台南,2023-04-25,9896
00712,復華富時不動產,14,0,14,元大-台南,2023-04-25,9896
8069,元太,20,6,14,元大-台南,2023-04-25,9896
00753L,中信中國50正2,14,0,14,元大-台南,2023-04-25,9896
6443,元晶,16,2,14,元大-台南,2023-04-25,9896
4743,合一,15,2,13,元大-台南,2023-04-25,9896
2014,中鴻,16,3,13,元大-台南,2023-04-25,9896
6152,百一,13,0,13,元大-台南,2023-04-25,9896
3035,智原,250,22,228,元大-台南,2023-04-26,9896
2027,大成鋼,46,2,44,元大-台南,2023-04-26,9896
2610,華航,37,1,36,元大-台南,2023-04-26,9896
6218,豪勉,35,0,35,元大-台南,2023-04-26,9896
00712,復華富時不動產,56,21,35,元大-台南,2023-04-26,9896
00900,富邦特選高股息30,36,1,35,元大-台南,2023-04-26,9896
1584,精剛,35,1,34,元大-台南,2023-04-26,9896
00676R,富邦臺灣加權反1,31,0,31,元大-台南,2023-04-26,9896
1101,台泥,35,6,29,元大-台南,2023-04-26,9896
00878,國泰永續高股息,43,15,28,元大-台南,2023-04-26,9896
2618,長榮航,25,1,24,元大-台南,2023-04-26,9896
00891,中信關鍵半導體,26,3,23,元大-台南,2023-04-26,9896
0050,元大台灣50,22,0,22,元大-台南,2023-04-26,9896
3006,晶豪科,22,0,22,元大-台南,2023-04-26,9896
6770,力積電,23,3,20,元大-台南,2023-04-26,9896
6113,亞矽,21,1,20,元大-台南,2023-04-26,9896
4129,聯合,20,0,20,元大-台南,2023-04-26,9896
2337,旺宏,28,9,19,元大-台南,2023-04-26,9896
2888,新光金,20,1,19,元大-台南,2023-04-26,9896
4566,時碩工業,19,3,16,元大-台南,2023-04-26,9896
00902,中信電池及儲能,16,0,16,元大-台南,2023-04-26,9896
5243,乙盛-KY,15,1,14,元大-台南,2023-04-26,9896
5425,台半,21,8,13,元大-台南,2023-04-26,9896
5328,華容,13,0,13,元大-台南,2023-04-26,9896
006208,富邦台50,13,0,13,元大-台南,2023-04-26,9896
2352,佳世達,25,13,12,元大-台南,2023-04-26,9896
4934,太極,12,0,12,元大-台南,2023-04-26,9896
2605,新興,12,0,12,元大-台南,2023-04-26,9896
3712,永崴投控,14,2,12,元大-台南,2023-04-26,9896
2330,台積電,18,7,11,元大-台南,2023-04-26,9896
2641,正德,10,0,10,元大-台南,2023-04-26,9896
1316,上曜,10,0,10,元大-台南,2023-04-26,9896
3512,皇龍,10,0,10,元大-台南,2023-04-26,9896
1517,利奇,10,0,10,元大-台南,2023-04-26,9896
2903,遠百,10,0,10,元大-台南,2023-04-26,9896
00751B,元大AAA至A公司債,9,0,9,元大-台南,2023-04-26,9896
8222,寶一,39,30,9,元大-台南,2023-04-26,9896
6438,迅得,9,0,9,元大-台南,2023-04-26,9896
2913,農林,8,0,8,元大-台南,2023-04-26,9896
2208,台船,16,8,8,元大-台南,2023-04-26,9896
1806,冠軍,8,0,8,元大-台南,2023-04-26,9896
3071,協禧,14,6,8,元大-台南,2023-04-26,9896
3707,漢磊,8,0,8,元大-台南,2023-04-26,9896
2002,中鋼,13,5,8,元大-台南,2023-04-26,9896
2609,陽明,23,15,8,元大-台南,2023-04-26,9896
00885,富邦越南,7,0,7,元大-台南,2023-04-26,9896
1514,亞力,8,1,7,元大-台南,2023-04-26,9896
2515,中工,12,5,7,元大-台南,2023-04-26,9896
2882,國泰金,8,1,7,元大-台南,2023-04-26,9896
2748,雲品,14,8,6,元大-台南,2023-04-26,9896
00632R,元大台灣50反1,275,29,246,元大-台南,2023-04-27,9896
00715L,期街口布蘭特正2,175,5,170,元大-台南,2023-04-27,9896
00712,復華富時不動產,76,0,76,元大-台南,2023-04-27,9896
00679B,元大美債20年,59,3,56,元大-台南,2023-04-27,9896
00878,國泰永續高股息,72,21,51,元大-台南,2023-04-27,9896
00671R,富邦NASDAQ反1,50,0,50,元大-台南,2023-04-27,9896
2634,漢翔,168,120,48,元大-台南,2023-04-27,9896
6625,必應,46,0,46,元大-台南,2023-04-27,9896
2609,陽明,33,3,30,元大-台南,2023-04-27,9896
1314,中石化,30,0,30,元大-台南,2023-04-27,9896
2303,聯電,36,7,29,元大-台南,2023-04-27,9896
1721,三晃,46,17,29,元大-台南,2023-04-27,9896
00720B,元大投資級公司債,23,0,23,元大-台南,2023-04-27,9896
00772B,中信高評級公司債,19,0,19,元大-台南,2023-04-27,9896
3481,群創,17,0,17,元大-台南,2023-04-27,9896
00751B,元大AAA至A公司債,18,1,17,元大-台南,2023-04-27,9896
2886,兆豐金,18,2,16,元大-台南,2023-04-27,9896
8011,台通,16,0,16,元大-台南,2023-04-27,9896
2002,中鋼,24,9,15,元大-台南,2023-04-27,9896
3035,智原,21,6,15,元大-台南,2023-04-27,9896
2913,農林,18,3,15,元大-台南,2023-04-27,9896
2603,長榮,15,0,15,元大-台南,2023-04-27,9896
6116,彩晶,14,0,14,元大-台南,2023-04-27,9896
00888,永豐台灣ESG,13,0,13,元大-台南,2023-04-27,9896
1711,永光,49,36,13,元大-台南,2023-04-27,9896
2884,玉山金,17,5,12,元大-台南,2023-04-27,9896
2108,南帝,12,0,12,元大-台南,2023-04-27,9896
2605,新興,14,2,12,元大-台南,2023-04-27,9896
00924,復華S＆P500成長,12,0,12,元大-台南,2023-04-27,9896
8112,至上,11,0,11,元大-台南,2023-04-27,9896
006208,富邦台50,11,0,11,元大-台南,2023-04-27,9896
0056,元大高股息,11,1,10,元大-台南,2023-04-27,9896
00753L,中信中國50正2,14,4,10,元大-台南,2023-04-27,9896
6122,擎邦,10,0,10,元大-台南,2023-04-27,9896
4168,醣聯,10,0,10,元大-台南,2023-04-27,9896
4923,力士,10,0,10,元大-台南,2023-04-27,9896
00902,中信電池及儲能,10,0,10,元大-台南,2023-04-27,9896
6603,富強鑫,10,0,10,元大-台南,2023-04-27,9896
2330,台積電,17,7,10,元大-台南,2023-04-27,9896
00696B,富邦美債20年,9,0,9,元大-台南,2023-04-27,9896
00687B,國泰20年美債,10,1,9,元大-台南,2023-04-27,9896
00885,富邦越南,9,0,9,元大-台南,2023-04-27,9896
1762,中化生,12,3,9,元大-台南,2023-04-27,9896
2471,資通,17,8,9,元大-台南,2023-04-27,9896
00680L,元大美債20正2,9,1,8,元大-台南,2023-04-27,9896
1101,台泥,16,8,8,元大-台南,2023-04-27,9896
2889,國票金,10,2,8,元大-台南,2023-04-27,9896
1310,台苯,10,2,8,元大-台南,2023-04-27,9896
2409,友達,8,0,8,元大-台南,2023-04-27,9896
0050,元大台灣50,8,1,7,元大-台南,2023-04-27,9896
8936,國統,123,3,120,元大-台南,2023-04-28,9896
00632R,元大台灣50反1,119,15,104,元大-台南,2023-04-28,9896
2880,華南金,144,44,100,元大-台南,2023-04-28,9896
3481,群創,116,19,97,元大-台南,2023-04-28,9896
2409,友達,90,7,83,元大-台南,2023-04-28,9896
6767,台微醫,74,0,74,元大-台南,2023-04-28,9896
00679B,元大美債20年,84,22,62,元大-台南,2023-04-28,9896
00680L,元大美債20正2,60,5,55,元大-台南,2023-04-28,9896
6266,泰詠,64,10,54,元大-台南,2023-04-28,9896
2352,佳世達,53,8,45,元大-台南,2023-04-28,9896
6116,彩晶,37,0,37,元大-台南,2023-04-28,9896
6113,亞矽,86,49,37,元大-台南,2023-04-28,9896
3576,聯合再生,35,0,35,元大-台南,2023-04-28,9896
00715L,期街口布蘭特正2,30,2,28,元大-台南,2023-04-28,9896
3705,永信,27,1,26,元大-台南,2023-04-28,9896
1441,大東,18,0,18,元大-台南,2023-04-28,9896
2603,長榮,23,6,17,元大-台南,2023-04-28,9896
3013,晟銘電,15,0,15,元大-台南,2023-04-28,9896
2344,華邦電,27,12,15,元大-台南,2023-04-28,9896
00772B,中信高評級公司債,15,1,14,元大-台南,2023-04-28,9896
3552,同致,14,0,14,元大-台南,2023-04-28,9896
3276,宇環,14,0,14,元大-台南,2023-04-28,9896
2634,漢翔,97,84,13,元大-台南,2023-04-28,9896
00773B,中信優先金融債,13,0,13,元大-台南,2023-04-28,9896
006208,富邦台50,14,1,13,元大-台南,2023-04-28,9896
00637L,元大滬深300正2,51,39,12,元大-台南,2023-04-28,9896
1477,聚陽,12,0,12,元大-台南,2023-04-28,9896
00881,國泰台灣5G+,13,1,12,元大-台南,2023-04-28,9896
2913,農林,19,8,11,元大-台南,2023-04-28,9896
2915,潤泰全,11,0,11,元大-台南,2023-04-28,9896
4108,懷特,11,0,11,元大-台南,2023-04-28,9896
00720B,元大投資級公司債,10,0,10,元大-台南,2023-04-28,9896
6026,福邦證,10,0,10,元大-台南,2023-04-28,9896
2337,旺宏,10,0,10,元大-台南,2023-04-28,9896
3591,艾笛森,10,0,10,元大-台南,2023-04-28,9896
5469,瀚宇博,10,0,10,元大-台南,2023-04-28,9896
1709,和益,10,0,10,元大-台南,2023-04-28,9896
2489,瑞軒,10,0,10,元大-台南,2023-04-28,9896
2368,金像電,12,2,10,元大-台南,2023-04-28,9896
1513,中興電,15,6,9,元大-台南,2023-04-28,9896
00751B,元大AAA至A公司債,9,0,9,元大-台南,2023-04-28,9896
00924,復華S＆P500成長,9,0,9,元大-台南,2023-04-28,9896
2514,龍邦,9,0,9,元大-台南,2023-04-28,9896
1451,年興,9,0,9,元大-台南,2023-04-28,9896
5302,太欣,9,0,9,元大-台南,2023-04-28,9896
2834,臺企銀,30,22,8,元大-台南,2023-04-28,9896
5425,台半,23,15,8,元大-台南,2023-04-28,9896
6147,頎邦,8,0,8,元大-台南,2023-04-28,9896
1907,永豐餘,53,45,8,元大-台南,2023-04-28,9896
3006,晶豪科,10,2,8,元大-台南,2023-04-28,9896
2603,長榮,302,1,301,元大-台南,2023-05-02,9896
00878,國泰永續高股息,124,6,118,元大-台南,2023-05-02,9896
2834,臺企銀,106,10,96,元大-台南,2023-05-02,9896
1905,華紙,109,33,76,元大-台南,2023-05-02,9896
1101,台泥,130,55,75,元大-台南,2023-05-02,9896
00632R,元大台灣50反1,94,20,74,元大-台南,2023-05-02,9896
00642U,期元大S＆P石油,70,0,70,元大-台南,2023-05-02,9896
2634,漢翔,232,162,70,元大-台南,2023-05-02,9896
1503,士電,66,15,51,元大-台南,2023-05-02,9896
00706L,期元大S＆P日圓正2,49,0,49,元大-台南,2023-05-02,9896
3058,立德,50,2,48,元大-台南,2023-05-02,9896
00720B,元大投資級公司債,45,3,42,元大-台南,2023-05-02,9896
2610,華航,49,7,42,元大-台南,2023-05-02,9896
5425,台半,42,2,40,元大-台南,2023-05-02,9896
6414,樺漢,38,0,38,元大-台南,2023-05-02,9896
6113,亞矽,57,21,36,元大-台南,2023-05-02,9896
00680L,元大美債20正2,38,3,35,元大-台南,2023-05-02,9896
3715,定穎投控,39,7,32,元大-台南,2023-05-02,9896
2419,仲琦,30,0,30,元大-台南,2023-05-02,9896
2498,宏達電,32,3,29,元大-台南,2023-05-02,9896
00751B,元大AAA至A公司債,29,1,28,元大-台南,2023-05-02,9896
2630,亞航,30,3,27,元大-台南,2023-05-02,9896
2371,大同,26,0,26,元大-台南,2023-05-02,9896
9919,康那香,26,0,26,元大-台南,2023-05-02,9896
00772B,中信高評級公司債,26,1,25,元大-台南,2023-05-02,9896
6288,聯嘉,25,0,25,元大-台南,2023-05-02,9896
2753,八方雲集,25,0,25,元大-台南,2023-05-02,9896
3363,上詮,44,20,24,元大-台南,2023-05-02,9896
00679B,元大美債20年,27,4,23,元大-台南,2023-05-02,9896
3419,譁裕,22,1,21,元大-台南,2023-05-02,9896
6443,元晶,21,1,20,元大-台南,2023-05-02,9896
00907,永豐優息存股,20,0,20,元大-台南,2023-05-02,9896
2022,聚亨,20,0,20,元大-台南,2023-05-02,9896
3105,穩懋,22,2,20,元大-台南,2023-05-02,9896
8936,國統,21,2,19,元大-台南,2023-05-02,9896
4168,醣聯,18,0,18,元大-台南,2023-05-02,9896
1809,中釉,30,12,18,元大-台南,2023-05-02,9896
2344,華邦電,20,2,18,元大-台南,2023-05-02,9896
00687B,國泰20年美債,17,0,17,元大-台南,2023-05-02,9896
3141,晶宏,16,0,16,元大-台南,2023-05-02,9896
6111,大宇資,15,0,15,元大-台南,2023-05-02,9896
2913,農林,34,19,15,元大-台南,2023-05-02,9896
1784,訊聯,15,0,15,元大-台南,2023-05-02,9896
4160,訊聯基因,15,0,15,元大-台南,2023-05-02,9896
5009,榮剛,46,31,15,元大-台南,2023-05-02,9896
4541,晟田,20,5,15,元大-台南,2023-05-02,9896
00773B,中信優先金融債,14,0,14,元大-台南,2023-05-02,9896
9933,中鼎,14,0,14,元大-台南,2023-05-02,9896
3029,零壹,46,32,14,元大-台南,2023-05-02,9896
3289,宜特,15,1,14,元大-台南,2023-05-02,9896
00715L,期街口布蘭特正2,207,1,206,元大-台南,2023-05-03,9896
3481,群創,150,12,138,元大-台南,2023-05-03,9896
00712,復華富時不動產,106,0,106,元大-台南,2023-05-03,9896
1310,台苯,128,25,103,元大-台南,2023-05-03,9896
6142,友勁,100,0,100,元大-台南,2023-05-03,9896
4746,台耀,111,12,99,元大-台南,2023-05-03,9896
00680L,元大美債20正2,119,43,76,元大-台南,2023-05-03,9896
6589,台康生技,78,4,74,元大-台南,2023-05-03,9896
00642U,期元大S＆P石油,63,0,63,元大-台南,2023-05-03,9896
00632R,元大台灣50反1,60,0,60,元大-台南,2023-05-03,9896
2022,聚亨,53,4,49,元大-台南,2023-05-03,9896
1905,華紙,120,75,45,元大-台南,2023-05-03,9896
3231,緯創,51,11,40,元大-台南,2023-05-03,9896
3032,偉訓,77,39,38,元大-台南,2023-05-03,9896
00878,國泰永續高股息,66,32,34,元大-台南,2023-05-03,9896
2610,華航,32,0,32,元大-台南,2023-05-03,9896
2753,八方雲集,30,0,30,元大-台南,2023-05-03,9896
1101,台泥,33,4,29,元大-台南,2023-05-03,9896
6113,亞矽,26,0,26,元大-台南,2023-05-03,9896
5371,中光電,25,1,24,元大-台南,2023-05-03,9896
2603,長榮,37,13,24,元大-台南,2023-05-03,9896
5465,富驊,27,4,23,元大-台南,2023-05-03,9896
4968,立積,29,7,22,元大-台南,2023-05-03,9896
5512,力麒,20,0,20,元大-台南,2023-05-03,9896
3078,僑威,61,42,19,元大-台南,2023-05-03,9896
00882,中信中國高股息,19,0,19,元大-台南,2023-05-03,9896
2605,新興,26,9,17,元大-台南,2023-05-03,9896
1503,士電,29,13,16,元大-台南,2023-05-03,9896
0056,元大高股息,23,7,16,元大-台南,2023-05-03,9896
1514,亞力,45,30,15,元大-台南,2023-05-03,9896
00885,富邦越南,15,0,15,元大-台南,2023-05-03,9896
00637L,元大滬深300正2,15,0,15,元大-台南,2023-05-03,9896
6112,邁達特,26,11,15,元大-台南,2023-05-03,9896
2892,第一金,14,1,13,元大-台南,2023-05-03,9896
9907,統一實,16,3,13,元大-台南,2023-05-03,9896
006208,富邦台50,14,2,12,元大-台南,2023-05-03,9896
3038,全台,12,0,12,元大-台南,2023-05-03,9896
4105,東洋,12,0,12,元大-台南,2023-05-03,9896
00671R,富邦NASDAQ反1,12,0,12,元大-台南,2023-05-03,9896
2208,台船,15,3,12,元大-台南,2023-05-03,9896
00679B,元大美債20年,14,3,11,元大-台南,2023-05-03,9896
2337,旺宏,11,0,11,元大-台南,2023-05-03,9896
2886,兆豐金,11,0,11,元大-台南,2023-05-03,9896
3512,皇龍,11,0,11,元大-台南,2023-05-03,9896
00902,中信電池及儲能,10,0,10,元大-台南,2023-05-03,9896
3236,千如,10,0,10,元大-台南,2023-05-03,9896
6198,瑞築,10,0,10,元大-台南,2023-05-03,9896
00919,群益台灣精選高息,10,0,10,元大-台南,2023-05-03,9896
4933,友輝,10,0,10,元大-台南,2023-05-03,9896
8028,昇陽半導體,10,1,9,元大-台南,2023-05-03,9896
00715L,期街口布蘭特正2,604,60,544,元大-台南,2023-05-04,9896
00878,國泰永續高股息,282,14,268,元大-台南,2023-05-04,9896
00642U,期元大S＆P石油,156,4,152,元大-台南,2023-05-04,9896
2610,華航,102,0,102,元大-台南,2023-05-04,9896
00664R,國泰臺灣加權反1,100,0,100,元大-台南,2023-05-04,9896
2913,農林,86,3,83,元大-台南,2023-05-04,9896
00712,復華富時不動產,50,0,50,元大-台南,2023-05-04,9896
1760,寶齡富錦,53,3,50,元大-台南,2023-05-04,9896
1904,正隆,53,3,50,元大-台南,2023-05-04,9896
2457,飛宏,76,30,46,元大-台南,2023-05-04,9896
6767,台微醫,46,0,46,元大-台南,2023-05-04,9896
3276,宇環,50,4,46,元大-台南,2023-05-04,9896
00772B,中信高評級公司債,43,1,42,元大-台南,2023-05-04,9896
2371,大同,40,1,39,元大-台南,2023-05-04,9896
2609,陽明,43,4,39,元大-台南,2023-05-04,9896
6113,亞矽,37,0,37,元大-台南,2023-05-04,9896
2886,兆豐金,38,2,36,元大-台南,2023-05-04,9896
6229,研通,33,0,33,元大-台南,2023-05-04,9896
3712,永崴投控,36,6,30,元大-台南,2023-05-04,9896
3664,安瑞-KY,24,0,24,元大-台南,2023-05-04,9896
6234,高僑,26,3,23,元大-台南,2023-05-04,9896
2014,中鴻,21,0,21,元大-台南,2023-05-04,9896
1810,和成,20,0,20,元大-台南,2023-05-04,9896
8072,陞泰,31,11,20,元大-台南,2023-05-04,9896
2634,漢翔,93,73,20,元大-台南,2023-05-04,9896
4541,晟田,18,0,18,元大-台南,2023-05-04,9896
2002,中鋼,20,3,17,元大-台南,2023-05-04,9896
2352,佳世達,23,6,17,元大-台南,2023-05-04,9896
1104,環泥,22,6,16,元大-台南,2023-05-04,9896
8112,至上,16,0,16,元大-台南,2023-05-04,9896
5498,凱崴,17,2,15,元大-台南,2023-05-04,9896
2330,台積電,19,5,14,元大-台南,2023-05-04,9896
8222,寶一,31,17,14,元大-台南,2023-05-04,9896
8478,東哥遊艇,17,3,14,元大-台南,2023-05-04,9896
3013,晟銘電,23,10,13,元大-台南,2023-05-04,9896
2338,光罩,13,1,12,元大-台南,2023-05-04,9896
00751B,元大AAA至A公司債,11,0,11,元大-台南,2023-05-04,9896
6015,宏遠證,11,0,11,元大-台南,2023-05-04,9896
1608,華榮,11,0,11,元大-台南,2023-05-04,9896
4168,醣聯,11,0,11,元大-台南,2023-05-04,9896
3325,旭品,12,1,11,元大-台南,2023-05-04,9896
2845,遠東銀,10,0,10,元大-台南,2023-05-04,9896
1806,冠軍,10,0,10,元大-台南,2023-05-04,9896
3032,偉訓,19,9,10,元大-台南,2023-05-04,9896
00907,永豐優息存股,10,0,10,元大-台南,2023-05-04,9896
00670L,富邦NASDAQ正2,10,0,10,元大-台南,2023-05-04,9896
2208,台船,11,1,10,元大-台南,2023-05-04,9896
2881,富邦金,10,1,9,元大-台南,2023-05-04,9896
3006,晶豪科,10,1,9,元大-台南,2023-05-04,9896
2201,裕隆,12,3,9,元大-台南,2023-05-04,9896
00715L,期街口布蘭特正2,178,3,175,元大-台南,2023-05-05,9896
00878,國泰永續高股息,211,48,163,元大-台南,2023-05-05,9896
2630,亞航,102,4,98,元大-台南,2023-05-05,9896
00642U,期元大S＆P石油,75,0,75,元大-台南,2023-05-05,9896
2353,宏��,93,18,75,元大-台南,2023-05-05,9896
6767,台微醫,55,0,55,元大-台南,2023-05-05,9896
00632R,元大台灣50反1,133,80,53,元大-台南,2023-05-05,9896
00751B,元大AAA至A公司債,51,0,51,元大-台南,2023-05-05,9896
00712,復華富時不動產,60,10,50,元大-台南,2023-05-05,9896
4746,台耀,46,0,46,元大-台南,2023-05-05,9896
1504,東元,54,12,42,元大-台南,2023-05-05,9896
6443,元晶,39,0,39,元大-台南,2023-05-05,9896
00679B,元大美債20年,34,1,33,元大-台南,2023-05-05,9896
00720B,元大投資級公司債,30,0,30,元大-台南,2023-05-05,9896
8215,明基材,30,2,28,元大-台南,2023-05-05,9896
3481,群創,31,5,26,元大-台南,2023-05-05,9896
2614,東森,28,2,26,元大-台南,2023-05-05,9896
2359,所羅門,26,1,25,元大-台南,2023-05-05,9896
2344,華邦電,43,19,24,元大-台南,2023-05-05,9896
2886,兆豐金,24,1,23,元大-台南,2023-05-05,9896
00713,元大台灣高息低波,23,1,22,元大-台南,2023-05-05,9896
00773B,中信優先金融債,21,0,21,元大-台南,2023-05-05,9896
2105,正新,20,0,20,元大-台南,2023-05-05,9896
00907,永豐優息存股,20,0,20,元大-台南,2023-05-05,9896
00772B,中信高評級公司債,20,0,20,元大-台南,2023-05-05,9896
2352,佳世達,118,101,17,元大-台南,2023-05-05,9896
5009,榮剛,33,16,17,元大-台南,2023-05-05,9896
2002,中鋼,20,5,15,元大-台南,2023-05-05,9896
1718,中纖,15,0,15,元大-台南,2023-05-05,9896
1310,台苯,15,0,15,元大-台南,2023-05-05,9896
9955,佳龍,18,3,15,元大-台南,2023-05-05,9896
3005,神基,34,19,15,元大-台南,2023-05-05,9896
2634,漢翔,43,29,14,元大-台南,2023-05-05,9896
6005,群益證,16,2,14,元大-台南,2023-05-05,9896
00881,國泰台灣5G+,20,6,14,元大-台南,2023-05-05,9896
0056,元大高股息,28,15,13,元大-台南,2023-05-05,9896
00687B,國泰20年美債,13,0,13,元大-台南,2023-05-05,9896
3325,旭品,18,5,13,元大-台南,2023-05-05,9896
9902,台火,13,0,13,元大-台南,2023-05-05,9896
3071,協禧,15,3,12,元大-台南,2023-05-05,9896
1721,三晃,12,0,12,元大-台南,2023-05-05,9896
3338,泰碩,18,7,11,元大-台南,2023-05-05,9896
8463,潤泰材,12,1,11,元大-台南,2023-05-05,9896
2489,瑞軒,12,1,11,元大-台南,2023-05-05,9896
2421,建準,12,1,11,元大-台南,2023-05-05,9896
2605,新興,11,0,11,元大-台南,2023-05-05,9896
8403,盛弘,13,2,11,元大-台南,2023-05-05,9896
2891,中信金,11,0,11,元大-台南,2023-05-05,9896
00902,中信電池及儲能,12,2,10,元大-台南,2023-05-05,9896
3276,宇環,10,0,10,元大-台南,2023-05-05,9896
00632R,元大台灣50反1,174,13,161,元大-台南,2023-05-08,9896
6806,森崴能源,144,12,132,元大-台南,2023-05-08,9896
6142,友勁,100,0,100,元大-台南,2023-05-08,9896
5009,榮剛,85,5,80,元大-台南,2023-05-08,9896
00687B,國泰20年美債,61,0,61,元大-台南,2023-05-08,9896
00642U,期元大S＆P石油,66,13,53,元大-台南,2023-05-08,9896
00878,國泰永續高股息,131,81,50,元大-台南,2023-05-08,9896
6125,廣運,60,11,49,元大-台南,2023-05-08,9896
1605,華新,117,69,48,元大-台南,2023-05-08,9896
00679B,元大美債20年,48,2,46,元大-台南,2023-05-08,9896
1503,士電,65,24,41,元大-台南,2023-05-08,9896
3481,群創,41,3,38,元大-台南,2023-05-08,9896
6625,必應,38,1,37,元大-台南,2023-05-08,9896
2633,台灣高鐵,35,0,35,元大-台南,2023-05-08,9896
00720B,元大投資級公司債,33,1,32,元大-台南,2023-05-08,9896
1722,台肥,26,0,26,元大-台南,2023-05-08,9896
2344,華邦電,26,0,26,元大-台南,2023-05-08,9896
4744,皇將,26,4,22,元大-台南,2023-05-08,9896
3576,聯合再生,21,0,21,元大-台南,2023-05-08,9896
2605,新興,21,0,21,元大-台南,2023-05-08,9896
2834,臺企銀,32,12,20,元大-台南,2023-05-08,9896
2883B,凱基金乙特,20,0,20,元大-台南,2023-05-08,9896
2603,長榮,22,3,19,元大-台南,2023-05-08,9896
3035,智原,21,2,19,元大-台南,2023-05-08,9896
5302,太欣,17,0,17,元大-台南,2023-05-08,9896
3005,神基,25,8,17,元大-台南,2023-05-08,9896
4173,久裕,24,8,16,元大-台南,2023-05-08,9896
1513,中興電,26,11,15,元大-台南,2023-05-08,9896
2421,建準,54,40,14,元大-台南,2023-05-08,9896
1718,中纖,15,1,14,元大-台南,2023-05-08,9896
3703,欣陸,13,0,13,元大-台南,2023-05-08,9896
2515,中工,15,2,13,元大-台南,2023-05-08,9896
00891,中信關鍵半導體,14,1,13,元大-台南,2023-05-08,9896
00772B,中信高評級公司債,12,0,12,元大-台南,2023-05-08,9896
5498,凱崴,29,17,12,元大-台南,2023-05-08,9896
00712,復華富時不動產,13,2,11,元大-台南,2023-05-08,9896
00751B,元大AAA至A公司債,11,0,11,元大-台南,2023-05-08,9896
5425,台半,11,0,11,元大-台南,2023-05-08,9896
2104,國際中橡,11,0,11,元大-台南,2023-05-08,9896
0056,元大高股息,18,7,11,元大-台南,2023-05-08,9896
1904,正隆,10,0,10,元大-台南,2023-05-08,9896
9933,中鼎,10,0,10,元大-台南,2023-05-08,9896
2358,廷鑫,10,0,10,元大-台南,2023-05-08,9896
3346,麗清,10,0,10,元大-台南,2023-05-08,9896
2612,中航,10,0,10,元大-台南,2023-05-08,9896
3276,宇環,10,0,10,元大-台南,2023-05-08,9896
1326,台化,10,0,10,元大-台南,2023-05-08,9896
00907,永豐優息存股,10,0,10,元大-台南,2023-05-08,9896
1310,台苯,10,0,10,元大-台南,2023-05-08,9896
2801,彰銀,10,0,10,元大-台南,2023-05-08,9896
00687B,國泰20年美債,162,0,162,元大-台南,2023-05-09,9896
00772B,中信高評級公司債,150,0,150,元大-台南,2023-05-09,9896
6125,廣運,124,1,123,元大-台南,2023-05-09,9896
1609,大亞,150,61,89,元大-台南,2023-05-09,9896
00680L,元大美債20正2,65,0,65,元大-台南,2023-05-09,9896
1101,台泥,77,13,64,元大-台南,2023-05-09,9896
0056,元大高股息,69,11,58,元大-台南,2023-05-09,9896
3276,宇環,50,0,50,元大-台南,2023-05-09,9896
6589,台康生技,58,11,47,元大-台南,2023-05-09,9896
00751B,元大AAA至A公司債,44,0,44,元大-台南,2023-05-09,9896
00671R,富邦NASDAQ反1,50,9,41,元大-台南,2023-05-09,9896
6282,康舒,43,3,40,元大-台南,2023-05-09,9896
2634,漢翔,55,16,39,元大-台南,2023-05-09,9896
6612,奈米醫材,35,1,34,元大-台南,2023-05-09,9896
1513,中興電,64,36,28,元大-台南,2023-05-09,9896
00715L,期街口布蘭特正2,39,14,25,元大-台南,2023-05-09,9896
3005,神基,27,2,25,元大-台南,2023-05-09,9896
6127,九豪,26,1,25,元大-台南,2023-05-09,9896
3029,零壹,39,14,25,元大-台南,2023-05-09,9896
00720B,元大投資級公司債,24,0,24,元大-台南,2023-05-09,9896
8069,元太,26,4,22,元大-台南,2023-05-09,9896
1718,中纖,21,0,21,元大-台南,2023-05-09,9896
2419,仲琦,22,1,21,元大-台南,2023-05-09,9896
4906,正文,21,0,21,元大-台南,2023-05-09,9896
2605,新興,21,0,21,元大-台南,2023-05-09,9896
2913,農林,36,16,20,元大-台南,2023-05-09,9896
6767,台微醫,20,0,20,元大-台南,2023-05-09,9896
2880,華南金,20,1,19,元大-台南,2023-05-09,9896
3715,定穎投控,76,59,17,元大-台南,2023-05-09,9896
9939,宏全,17,0,17,元大-台南,2023-05-09,9896
1310,台苯,18,1,17,元大-台南,2023-05-09,9896
3038,全台,17,0,17,元大-台南,2023-05-09,9896
5498,凱崴,17,0,17,元大-台南,2023-05-09,9896
5284,jpp-KY,25,8,17,元大-台南,2023-05-09,9896
00679B,元大美債20年,30,14,16,元大-台南,2023-05-09,9896
2344,華邦電,21,5,16,元大-台南,2023-05-09,9896
6443,元晶,16,0,16,元大-台南,2023-05-09,9896
6113,亞矽,34,20,14,元大-台南,2023-05-09,9896
2515,中工,14,0,14,元大-台南,2023-05-09,9896
1708,東鹼,23,9,14,元大-台南,2023-05-09,9896
1618,合機,12,0,12,元大-台南,2023-05-09,9896
2353,宏��,14,2,12,元大-台南,2023-05-09,9896
1611,中電,23,11,12,元大-台南,2023-05-09,9896
3624,光頡,13,1,12,元大-台南,2023-05-09,9896
4123,晟德,14,2,12,元大-台南,2023-05-09,9896
4173,久裕,11,0,11,元大-台南,2023-05-09,9896
2495,普安,15,4,11,元大-台南,2023-05-09,9896
4168,醣聯,11,0,11,元大-台南,2023-05-09,9896
8064,東捷,11,0,11,元大-台南,2023-05-09,9896
4967,十銓,12,1,11,元大-台南,2023-05-09,9896
00772B,中信高評級公司債,110,0,110,元大-台南,2023-05-10,9896
5284,jpp-KY,95,14,81,元大-台南,2023-05-10,9896
5880,合庫金,62,0,62,元大-台南,2023-05-10,9896
00687B,國泰20年美債,58,0,58,元大-台南,2023-05-10,9896
2352,佳世達,57,3,54,元大-台南,2023-05-10,9896
2605,新興,121,71,50,元大-台南,2023-05-10,9896
3481,群創,52,5,47,元大-台南,2023-05-10,9896
1905,華紙,41,6,35,元大-台南,2023-05-10,9896
1611,中電,34,6,28,元大-台南,2023-05-10,9896
00720B,元大投資級公司債,25,0,25,元大-台南,2023-05-10,9896
00637L,元大滬深300正2,27,3,24,元大-台南,2023-05-10,9896
3596,智易,23,1,22,元大-台南,2023-05-10,9896
2834,臺企銀,22,0,22,元大-台南,2023-05-10,9896
00680L,元大美債20正2,22,0,22,元大-台南,2023-05-10,9896
00891,中信關鍵半導體,21,0,21,元大-台南,2023-05-10,9896
2340,台亞,20,0,20,元大-台南,2023-05-10,9896
2610,華航,33,13,20,元大-台南,2023-05-10,9896
1609,大亞,94,74,20,元大-台南,2023-05-10,9896
6234,高僑,25,6,19,元大-台南,2023-05-10,9896
6443,元晶,18,1,17,元大-台南,2023-05-10,9896
6806,森崴能源,35,18,17,元大-台南,2023-05-10,9896
00751B,元大AAA至A公司債,16,0,16,元大-台南,2023-05-10,9896
00712,復華富時不動產,23,7,16,元大-台南,2023-05-10,9896
4979,華星光,19,4,15,元大-台南,2023-05-10,9896
2634,漢翔,29,14,15,元大-台南,2023-05-10,9896
00690,兆豐藍籌30,15,0,15,元大-台南,2023-05-10,9896
6191,精成科,15,0,15,元大-台南,2023-05-10,9896
1506,正道,20,6,14,元大-台南,2023-05-10,9896
1722,台肥,13,0,13,元大-台南,2023-05-10,9896
5353,台林,13,0,13,元大-台南,2023-05-10,9896
3356,奇偶,13,1,12,元大-台南,2023-05-10,9896
1101,台泥,19,7,12,元大-台南,2023-05-10,9896
00713,元大台灣高息低波,11,0,11,元大-台南,2023-05-10,9896
6477,安集,11,0,11,元大-台南,2023-05-10,9896
6113,亞矽,82,71,11,元大-台南,2023-05-10,9896
8940,新天地,12,1,11,元大-台南,2023-05-10,9896
2891,中信金,32,21,11,元大-台南,2023-05-10,9896
2330,台積電,12,1,11,元大-台南,2023-05-10,9896
2344,華邦電,12,2,10,元大-台南,2023-05-10,9896
6213,聯茂,14,4,10,元大-台南,2023-05-10,9896
00830,國泰費城半導體,10,0,10,元大-台南,2023-05-10,9896
1529,樂事綠能,10,0,10,元大-台南,2023-05-10,9896
3325,旭品,10,0,10,元大-台南,2023-05-10,9896
00679B,元大美債20年,10,1,9,元大-台南,2023-05-10,9896
1216,統一,11,2,9,元大-台南,2023-05-10,9896
3013,晟銘電,11,2,9,元大-台南,2023-05-10,9896
6270,倍微,10,1,9,元大-台南,2023-05-10,9896
00665L,富邦�琤肭磪囓�2,12,3,9,元大-台南,2023-05-10,9896
3232,昱捷,9,0,9,元大-台南,2023-05-10,9896
6235,華孚,10,2,8,元大-台南,2023-05-10,9896
1609,大亞,107,43,64,元大-台南,2023-05-11,9896
2022,聚亨,77,15,62,元大-台南,2023-05-11,9896
6235,華孚,73,18,55,元大-台南,2023-05-11,9896
2618,長榮航,87,33,54,元大-台南,2023-05-11,9896
00687B,國泰20年美債,50,0,50,元大-台南,2023-05-11,9896
5498,凱崴,75,29,46,元大-台南,2023-05-11,9896
2630,亞航,53,12,41,元大-台南,2023-05-11,9896
6285,啟��,51,12,39,元大-台南,2023-05-11,9896
1905,華紙,42,5,37,元大-台南,2023-05-11,9896
2880,華南金,34,0,34,元大-台南,2023-05-11,9896
00882,中信中國高股息,40,7,33,元大-台南,2023-05-11,9896
1310,台苯,34,1,33,元大-台南,2023-05-11,9896
9907,統一實,31,0,31,元大-台南,2023-05-11,9896
5009,榮剛,45,14,31,元大-台南,2023-05-11,9896
00671R,富邦NASDAQ反1,30,0,30,元大-台南,2023-05-11,9896
00878,國泰永續高股息,45,15,30,元大-台南,2023-05-11,9896
2886,兆豐金,36,11,25,元大-台南,2023-05-11,9896
4123,晟德,25,0,25,元大-台南,2023-05-11,9896
0056,元大高股息,31,6,25,元大-台南,2023-05-11,9896
1718,中纖,25,3,22,元大-台南,2023-05-11,9896
1904,正隆,27,5,22,元大-台南,2023-05-11,9896
1517,利奇,21,0,21,元大-台南,2023-05-11,9896
2515,中工,24,3,21,元大-台南,2023-05-11,9896
8050,廣積,20,0,20,元大-台南,2023-05-11,9896
00713,元大台灣高息低波,21,1,20,元大-台南,2023-05-11,9896
5880,合庫金,20,0,20,元大-台南,2023-05-11,9896
1409,新纖,23,4,19,元大-台南,2023-05-11,9896
2834,臺企銀,19,0,19,元大-台南,2023-05-11,9896
1101,台泥,23,5,18,元大-台南,2023-05-11,9896
6234,高僑,22,4,18,元大-台南,2023-05-11,9896
1722,台肥,27,9,18,元大-台南,2023-05-11,9896
1529,樂事綠能,34,18,16,元大-台南,2023-05-11,9896
2892,第一金,21,5,16,元大-台南,2023-05-11,9896
5309,系統電,16,0,16,元大-台南,2023-05-11,9896
1402,遠東新,16,0,16,元大-台南,2023-05-11,9896
2344,華邦電,21,5,16,元大-台南,2023-05-11,9896
2449,京元電子,20,5,15,元大-台南,2023-05-11,9896
2010,春源,20,5,15,元大-台南,2023-05-11,9896
1605,華新,27,13,14,元大-台南,2023-05-11,9896
2330,台積電,16,1,15,元大-台南,2023-05-11,9896
6477,安集,18,4,14,元大-台南,2023-05-11,9896
5487,通泰,14,0,14,元大-台南,2023-05-11,9896
00720B,元大投資級公司債,14,0,14,元大-台南,2023-05-11,9896
6472,保瑞,15,1,14,元大-台南,2023-05-11,9896
1506,正道,13,0,13,元大-台南,2023-05-11,9896
2027,大成鋼,12,0,12,元大-台南,2023-05-11,9896
6767,台微醫,12,0,12,元大-台南,2023-05-11,9896
2885,元大金,12,0,12,元大-台南,2023-05-11,9896
9951,皇田,14,2,12,元大-台南,2023-05-11,9896
1785,光洋科,11,0,11,元大-台南,2023-05-11,9896
00642U,期元大S＆P石油,216,0,216,元大-台南,2023-05-12,9896
00676R,富邦臺灣加權反1,200,1,199,元大-台南,2023-05-12,9896
2408,南亞科,110,1,109,元大-台南,2023-05-12,9896
2317,鴻海,120,27,93,元大-台南,2023-05-12,9896
4138,曜亞,92,0,92,元大-台南,2023-05-12,9896
00720B,元大投資級公司債,52,1,51,元大-台南,2023-05-12,9896
5284,jpp-KY,74,24,50,元大-台南,2023-05-12,9896
1210,大成,50,3,47,元大-台南,2023-05-12,9896
2888,新光金,50,3,47,元大-台南,2023-05-12,9896
1609,大亞,79,35,44,元大-台南,2023-05-12,9896
2449,京元電子,42,0,42,元大-台南,2023-05-12,9896
5498,凱崴,40,2,38,元大-台南,2023-05-12,9896
00878,國泰永續高股息,55,17,38,元大-台南,2023-05-12,9896
1440,南紡,63,25,38,元大-台南,2023-05-12,9896
00633L,富邦上証正2,40,3,37,元大-台南,2023-05-12,9896
00902,中信電池及儲能,34,0,34,元大-台南,2023-05-12,9896
2887,台新金,38,4,34,元大-台南,2023-05-12,9896
00882,中信中國高股息,42,10,32,元大-台南,2023-05-12,9896
8446,華研,32,2,30,元大-台南,2023-05-12,9896
6285,啟��,38,11,27,元大-台南,2023-05-12,9896
1101,台泥,28,2,26,元大-台南,2023-05-12,9896
2409,友達,24,1,23,元大-台南,2023-05-12,9896
4111,濟生,23,0,23,元大-台南,2023-05-12,9896
2834,臺企銀,21,0,21,元大-台南,2023-05-12,9896
2883,凱基金,26,6,20,元大-台南,2023-05-12,9896
2605,新興,20,0,20,元大-台南,2023-05-12,9896
3041,揚智,20,0,20,元大-台南,2023-05-12,9896
2634,漢翔,37,18,19,元大-台南,2023-05-12,9896
3512,皇龍,19,0,19,元大-台南,2023-05-12,9896
4746,台耀,21,2,19,元大-台南,2023-05-12,9896
1605,華新,34,16,18,元大-台南,2023-05-12,9896
2886,兆豐金,24,6,18,元大-台南,2023-05-12,9896
6139,亞翔,29,12,17,元大-台南,2023-05-12,9896
2546,根基,16,0,16,元大-台南,2023-05-12,9896
2027,大成鋼,17,2,15,元大-台南,2023-05-12,9896
00687B,國泰20年美債,31,16,15,元大-台南,2023-05-12,9896
00772B,中信高評級公司債,16,1,15,元大-台南,2023-05-12,9896
6113,亞矽,27,12,15,元大-台南,2023-05-12,9896
2890,永豐金,13,0,13,元大-台南,2023-05-12,9896
1504,東元,20,7,13,元大-台南,2023-05-12,9896
2457,飛宏,28,16,12,元大-台南,2023-05-12,9896
2885,元大金,11,0,11,元大-台南,2023-05-12,9896
2881,富邦金,11,0,11,元大-台南,2023-05-12,9896
4503,金雨,12,1,11,元大-台南,2023-05-12,9896
00631L,元大台灣50正2,11,1,10,元大-台南,2023-05-12,9896
9907,統一實,10,0,10,元大-台南,2023-05-12,9896
1517,利奇,10,0,10,元大-台南,2023-05-12,9896
8044,網家,10,0,10,元大-台南,2023-05-12,9896
6024,群益期,10,0,10,元大-台南,2023-05-12,9896
2618,長榮航,15,5,10,元大-台南,2023-05-12,9896
00632R,元大台灣50反1,285,21,264,元大-台南,2023-05-15,9896
00882,中信中國高股息,170,3,167,元大-台南,2023-05-15,9896
1101,台泥,120,4,116,元大-台南,2023-05-15,9896
5284,jpp-KY,124,30,94,元大-台南,2023-05-15,9896
00642U,期元大S＆P石油,69,0,69,元大-台南,2023-05-15,9896
00715L,期街口布蘭特正2,61,0,61,元大-台南,2023-05-15,9896
6188,廣明,61,1,60,元大-台南,2023-05-15,9896
2489,瑞軒,55,0,55,元大-台南,2023-05-15,9896
4138,曜亞,53,0,53,元大-台南,2023-05-15,9896
0056,元大高股息,36,4,32,元大-台南,2023-05-15,9896
00687B,國泰20年美債,30,0,30,元大-台南,2023-05-15,9896
6024,群益期,30,0,30,元大-台南,2023-05-15,9896
4123,晟德,43,16,27,元大-台南,2023-05-15,9896
3231,緯創,34,8,26,元大-台南,2023-05-15,9896
00712,復華富時不動產,24,1,23,元大-台南,2023-05-15,9896
2317,鴻海,26,4,22,元大-台南,2023-05-15,9896
00679B,元大美債20年,24,2,22,元大-台南,2023-05-15,9896
6139,亞翔,25,3,22,元大-台南,2023-05-15,9896
2881,富邦金,23,2,21,元大-台南,2023-05-15,9896
00637L,元大滬深300正2,29,11,18,元大-台南,2023-05-15,9896
2610,華航,16,0,16,元大-台南,2023-05-15,9896
8403,盛弘,15,0,15,元大-台南,2023-05-15,9896
2371,大同,35,21,14,元大-台南,2023-05-15,9896
6443,元晶,14,1,13,元大-台南,2023-05-15,9896
2421,建準,14,1,13,元大-台南,2023-05-15,9896
00751B,元大AAA至A公司債,12,0,12,元大-台南,2023-05-15,9896
2630,亞航,12,0,12,元大-台南,2023-05-15,9896
00720B,元大投資級公司債,12,0,12,元大-台南,2023-05-15,9896
1609,大亞,22,11,11,元大-台南,2023-05-15,9896
00772B,中信高評級公司債,11,0,11,元大-台南,2023-05-15,9896
6191,精成科,11,0,11,元大-台南,2023-05-15,9896
2472,立隆電,11,0,11,元大-台南,2023-05-15,9896
6829,千附精密,10,0,10,元大-台南,2023-05-15,9896
5478,智冠,11,1,10,元大-台南,2023-05-15,9896
1513,中興電,12,2,10,元大-台南,2023-05-15,9896
4129,聯合,10,0,10,元大-台南,2023-05-15,9896
4111,濟生,10,0,10,元大-台南,2023-05-15,9896
2496,卓越,10,0,10,元大-台南,2023-05-15,9896
2605,新興,10,0,10,元大-台南,2023-05-15,9896
2615,萬海,12,2,10,元大-台南,2023-05-15,9896
2312,金寶,10,0,10,元大-台南,2023-05-15,9896
8048,德勝,10,0,10,元大-台南,2023-05-15,9896
2468,華經,10,0,10,元大-台南,2023-05-15,9896
2743,山富,10,0,10,元大-台南,2023-05-15,9896
6472,保瑞,12,2,10,元大-台南,2023-05-15,9896
4979,華星光,10,1,9,元大-台南,2023-05-15,9896
1605,華新,15,6,9,元大-台南,2023-05-15,9896
00725B,國泰投資級公司債,9,0,9,元大-台南,2023-05-15,9896
1460,宏遠,9,0,9,元大-台南,2023-05-15,9896
1259,安心,9,0,9,元大-台南,2023-05-15,9896
00632R,元大台灣50反1,338,75,263,元大-台南,2023-05-16,9896
00687B,國泰20年美債,74,0,74,元大-台南,2023-05-16,9896
4123,晟德,65,4,61,元大-台南,2023-05-16,9896
00642U,期元大S＆P石油,61,0,61,元大-台南,2023-05-16,9896
5284,jpp-KY,73,15,58,元大-台南,2023-05-16,9896
00772B,中信高評級公司債,57,0,57,元大-台南,2023-05-16,9896
00680L,元大美債20正2,55,0,55,元大-台南,2023-05-16,9896
2323,中環,78,27,51,元大-台南,2023-05-16,9896
00673R,期元大S＆P原油反1,51,1,50,元大-台南,2023-05-16,9896
00751B,元大AAA至A公司債,47,0,47,元大-台南,2023-05-16,9896
1504,東元,70,24,46,元大-台南,2023-05-16,9896
2371,大同,73,31,42,元大-台南,2023-05-16,9896
8163,達方,42,0,42,元大-台南,2023-05-16,9896
00720B,元大投資級公司債,31,0,31,元大-台南,2023-05-16,9896
00885,富邦越南,30,1,29,元大-台南,2023-05-16,9896
1762,中化生,27,2,25,元大-台南,2023-05-16,9896
2312,金寶,22,2,20,元大-台南,2023-05-16,9896
00725B,國泰投資級公司債,19,0,19,元大-台南,2023-05-16,9896
2885,元大金,17,1,16,元大-台南,2023-05-16,9896
2402,毅嘉,20,6,14,元大-台南,2023-05-16,9896
6443,元晶,15,1,14,元大-台南,2023-05-16,9896
2603,長榮,22,9,13,元大-台南,2023-05-16,9896
1440,南紡,20,7,13,元大-台南,2023-05-16,9896
6770,力積電,13,1,12,元大-台南,2023-05-16,9896
6005,群益證,11,0,11,元大-台南,2023-05-16,9896
2736,富野,19,8,11,元大-台南,2023-05-16,9896
6843,進典,11,0,11,元大-台南,2023-05-16,9896
8403,盛弘,20,10,10,元大-台南,2023-05-16,9896
8176,智捷,10,0,10,元大-台南,2023-05-16,9896
2731,雄獅,12,3,9,元大-台南,2023-05-16,9896
9921,巨大,10,1,9,元大-台南,2023-05-16,9896
1568,倉佑,10,1,9,元大-台南,2023-05-16,9896
4111,濟生,9,0,9,元大-台南,2023-05-16,9896
3081,聯亞,9,0,9,元大-台南,2023-05-16,9896
8150,南茂,12,3,9,元大-台南,2023-05-16,9896
2337,旺宏,9,0,9,元大-台南,2023-05-16,9896
2630,亞航,24,15,9,元大-台南,2023-05-16,9896
1513,中興電,10,1,9,元大-台南,2023-05-16,9896
6446,藥華藥,8,0,8,元大-台南,2023-05-16,9896
2313,華通,8,0,8,元大-台南,2023-05-16,9896
6244,茂迪,9,1,8,元大-台南,2023-05-16,9896
2421,建準,12,4,8,元大-台南,2023-05-16,9896
8112,至上,7,0,7,元大-台南,2023-05-16,9896
6712,長聖,8,1,7,元大-台南,2023-05-16,9896
00788B,元大10年IG電能債,7,0,7,元大-台南,2023-05-16,9896
2014,中鴻,8,1,7,元大-台南,2023-05-16,9896
00773B,中信優先金融債,7,0,7,元大-台南,2023-05-16,9896
6113,亞矽,13,6,7,元大-台南,2023-05-16,9896
1718,中纖,9,2,7,元大-台南,2023-05-16,9896
6214,精誠,7,0,7,元大-台南,2023-05-16,9896
2371,大同,605,14,591,元大-台南,2023-05-17,9896
00632R,元大台灣50反1,655,400,255,元大-台南,2023-05-17,9896
00878,國泰永續高股息,318,186,132,元大-台南,2023-05-17,9896
8163,達方,89,2,87,元大-台南,2023-05-17,9896
2317,鴻海,64,6,58,元大-台南,2023-05-17,9896
3034,聯詠,49,1,48,元大-台南,2023-05-17,9896
2489,瑞軒,45,6,39,元大-台南,2023-05-17,9896
3078,僑威,52,13,39,元大-台南,2023-05-17,9896
3058,立德,45,7,38,元大-台南,2023-05-17,9896
00720B,元大投資級公司債,38,0,38,元大-台南,2023-05-17,9896
00680L,元大美債20正2,37,0,37,元大-台南,2023-05-17,9896
3715,定穎投控,68,39,29,元大-台南,2023-05-17,9896
00687B,國泰20年美債,29,0,29,元大-台南,2023-05-17,9896
00712,復華富時不動產,27,0,27,元大-台南,2023-05-17,9896
2731,雄獅,26,0,26,元大-台南,2023-05-17,9896
00751B,元大AAA至A公司債,25,0,25,元大-台南,2023-05-17,9896
1584,精剛,23,0,23,元大-台南,2023-05-17,9896
2888,新光金,22,0,22,元大-台南,2023-05-17,9896
00772B,中信高評級公司債,21,0,21,元大-台南,2023-05-17,9896
00676R,富邦臺灣加權反1,21,0,21,元大-台南,2023-05-17,9896
5324,士開,20,0,20,元大-台南,2023-05-17,9896
00679B,元大美債20年,41,21,20,元大-台南,2023-05-17,9896
3289,宜特,19,0,19,元大-台南,2023-05-17,9896
5498,凱崴,20,3,17,元大-台南,2023-05-17,9896
00882,中信中國高股息,17,0,17,元大-台南,2023-05-17,9896
3231,緯創,44,28,16,元大-台南,2023-05-17,9896
2421,建準,15,0,15,元大-台南,2023-05-17,9896
1519,華城,25,11,14,元大-台南,2023-05-17,9896
1721,三晃,15,3,12,元大-台南,2023-05-17,9896
00664R,國泰臺灣加權反1,12,0,12,元大-台南,2023-05-17,9896
00670L,富邦NASDAQ正2,11,0,11,元大-台南,2023-05-17,9896
2603,長榮,15,4,11,元大-台南,2023-05-17,9896
00773B,中信優先金融債,10,0,10,元大-台南,2023-05-17,9896
4129,聯合,10,0,10,元大-台南,2023-05-17,9896
8176,智捷,10,0,10,元大-台南,2023-05-17,9896
1905,華紙,20,10,10,元大-台南,2023-05-17,9896
8415,大國鋼,10,0,10,元大-台南,2023-05-17,9896
6285,啟��,10,1,9,元大-台南,2023-05-17,9896
8107,大億金茂,9,0,9,元大-台南,2023-05-17,9896
2427,三商電,13,4,9,元大-台南,2023-05-17,9896
9921,巨大,11,2,9,元大-台南,2023-05-17,9896
9907,統一實,8,0,8,元大-台南,2023-05-17,9896
8926,台汽電,9,1,8,元大-台南,2023-05-17,9896
1504,東元,14,6,8,元大-台南,2023-05-17,9896
3576,聯合再生,8,0,8,元大-台南,2023-05-17,9896
3207,耀勝,13,6,7,元大-台南,2023-05-17,9896
4541,晟田,8,1,7,元大-台南,2023-05-17,9896
2027,大成鋼,9,3,6,元大-台南,2023-05-17,9896
3624,光頡,7,1,6,元大-台南,2023-05-17,9896
6125,廣運,6,0,6,元大-台南,2023-05-17,9896
00632R,元大台灣50反1,517,191,326,元大-台南,2023-05-18,9896
00687B,國泰20年美債,161,0,161,元大-台南,2023-05-18,9896
00715L,期街口布蘭特正2,202,78,124,元大-台南,2023-05-18,9896
2618,長榮航,149,60,89,元大-台南,2023-05-18,9896
2883,凱基金,84,19,65,元大-台南,2023-05-18,9896
2630,亞航,63,16,47,元大-台南,2023-05-18,9896
1905,華紙,44,13,31,元大-台南,2023-05-18,9896
00720B,元大投資級公司債,30,0,30,元大-台南,2023-05-18,9896
8446,華研,30,0,30,元大-台南,2023-05-18,9896
4129,聯合,31,2,29,元大-台南,2023-05-18,9896
00680L,元大美債20正2,49,20,29,元大-台南,2023-05-18,9896
6770,力積電,40,12,28,元大-台南,2023-05-18,9896
00637L,元大滬深300正2,43,17,26,元大-台南,2023-05-18,9896
00772B,中信高評級公司債,25,0,25,元大-台南,2023-05-18,9896
1609,大亞,84,60,24,元大-台南,2023-05-18,9896
3035,智原,24,1,23,元大-台南,2023-05-18,9896
2371,大同,61,39,22,元大-台南,2023-05-18,9896
2323,中環,46,26,20,元大-台南,2023-05-18,9896
5533,皇鼎,20,0,20,元大-台南,2023-05-18,9896
2634,漢翔,24,4,20,元大-台南,2023-05-18,9896
4123,晟德,20,1,19,元大-台南,2023-05-18,9896
2402,毅嘉,20,2,18,元大-台南,2023-05-18,9896
00751B,元大AAA至A公司債,18,0,18,元大-台南,2023-05-18,9896
5425,台半,17,0,17,元大-台南,2023-05-18,9896
8926,台汽電,20,3,17,元大-台南,2023-05-18,9896
6112,邁達特,72,56,16,元大-台南,2023-05-18,9896
5512,力麒,105,89,16,元大-台南,2023-05-18,9896
1514,亞力,26,11,15,元大-台南,2023-05-18,9896
2312,金寶,15,0,15,元大-台南,2023-05-18,9896
1504,東元,176,161,15,元大-台南,2023-05-18,9896
2812,台中銀,21,7,14,元大-台南,2023-05-18,9896
8112,至上,18,4,14,元大-台南,2023-05-18,9896
2329,華泰,14,1,13,元大-台南,2023-05-18,9896
00773B,中信優先金融債,13,0,13,元大-台南,2023-05-18,9896
4967,十銓,21,8,13,元大-台南,2023-05-18,9896
2362,藍天,13,0,13,元大-台南,2023-05-18,9896
3058,立德,38,25,13,元大-台南,2023-05-18,9896
00679B,元大美債20年,32,20,12,元大-台南,2023-05-18,9896
9921,巨大,11,0,11,元大-台南,2023-05-18,9896
4111,濟生,11,0,11,元大-台南,2023-05-18,9896
6472,保瑞,27,16,11,元大-台南,2023-05-18,9896
2352,佳世達,11,0,11,元大-台南,2023-05-18,9896
6125,廣運,20,9,11,元大-台南,2023-05-18,9896
00670L,富邦NASDAQ正2,11,0,11,元大-台南,2023-05-18,9896
2482,連宇,15,5,10,元大-台南,2023-05-18,9896
6218,豪勉,18,8,10,元大-台南,2023-05-18,9896
2888,新光金,32,22,10,元大-台南,2023-05-18,9896
8936,國統,12,2,10,元大-台南,2023-05-18,9896
4127,天良,10,0,10,元大-台南,2023-05-18,9896
5498,凱崴,10,0,10,元大-台南,2023-05-18,9896
00632R,元大台灣50反1,251,10,241,元大-台南,2023-05-19,9896
2317,鴻海,163,0,163,元大-台南,2023-05-19,9896
2323,中環,202,73,129,元大-台南,2023-05-19,9896
1609,大亞,159,62,97,元大-台南,2023-05-19,9896
00687B,國泰20年美債,77,0,77,元大-台南,2023-05-19,9896
00706L,期元大S＆P日圓正2,75,0,75,元大-台南,2023-05-19,9896
2399,映泰,65,0,65,元大-台南,2023-05-19,9896
00680L,元大美債20正2,61,0,61,元大-台南,2023-05-19,9896
3038,全台,65,5,60,元大-台南,2023-05-19,9896
00882,中信中國高股息,55,5,50,元大-台南,2023-05-19,9896
5531,鄉林,50,0,50,元大-台南,2023-05-19,9896
00772B,中信高評級公司債,47,0,47,元大-台南,2023-05-19,9896
5009,榮剛,81,35,46,元大-台南,2023-05-19,9896
00637L,元大滬深300正2,57,23,34,元大-台南,2023-05-19,9896
00633L,富邦上証正2,34,0,34,元大-台南,2023-05-19,9896
00720B,元大投資級公司債,33,0,33,元大-台南,2023-05-19,9896
4111,濟生,31,0,31,元大-台南,2023-05-19,9896
00679B,元大美債20年,36,5,31,元大-台南,2023-05-19,9896
3058,立德,97,73,24,元大-台南,2023-05-19,9896
3029,零壹,35,11,24,元大-台南,2023-05-19,9896
00712,復華富時不動產,24,1,23,元大-台南,2023-05-19,9896
00900,富邦特選高股息30,38,16,22,元大-台南,2023-05-19,9896
00754B,群益AAA-AA公司,21,0,21,元大-台南,2023-05-19,9896
00664R,國泰臺灣加權反1,20,0,20,元大-台南,2023-05-19,9896
6156,松上,19,0,19,元大-台南,2023-05-19,9896
2002,中鋼,22,4,18,元大-台南,2023-05-19,9896
00751B,元大AAA至A公司債,15,0,15,元大-台南,2023-05-19,9896
2471,資通,19,5,14,元大-台南,2023-05-19,9896
4104,佳醫,12,0,12,元大-台南,2023-05-19,9896
2442,新美齊,13,1,12,元大-台南,2023-05-19,9896
3056,富華新,12,0,12,元大-台南,2023-05-19,9896
6239,力成,12,0,12,元大-台南,2023-05-19,9896
2736,富野,15,3,12,元大-台南,2023-05-19,9896
00773B,中信優先金融債,15,3,12,元大-台南,2023-05-19,9896
8349,�矬�,11,0,11,元大-台南,2023-05-19,9896
1314,中石化,11,0,11,元大-台南,2023-05-19,9896
2031,新光鋼,11,0,11,元大-台南,2023-05-19,9896
2387,精元,11,0,11,元大-台南,2023-05-19,9896
00891,中信關鍵半導體,10,0,10,元大-台南,2023-05-19,9896
2421,建準,65,55,10,元大-台南,2023-05-19,9896
00690,兆豐藍籌30,10,0,10,元大-台南,2023-05-19,9896
1444,力麗,10,0,10,元大-台南,2023-05-19,9896
4126,太醫,10,0,10,元大-台南,2023-05-19,9896
8033,雷虎,10,0,10,元大-台南,2023-05-19,9896
8403,盛弘,10,0,10,元大-台南,2023-05-19,9896
4129,聯合,10,0,10,元大-台南,2023-05-19,9896
6505,台塑化,10,0,10,元大-台南,2023-05-19,9896
8076,伍豐,12,2,10,元大-台南,2023-05-19,9896
3680,家登,13,3,10,元大-台南,2023-05-19,9896
4979,華星光,11,2,9,元大-台南,2023-05-19,9896
2323,中環,144,8,136,元大-台南,2023-05-22,9896
00632R,元大台灣50反1,187,52,135,元大-台南,2023-05-22,9896
1513,中興電,160,62,98,元大-台南,2023-05-22,9896
2618,長榮航,284,200,84,元大-台南,2023-05-22,9896
3481,群創,166,92,74,元大-台南,2023-05-22,9896
2303,聯電,73,10,63,元大-台南,2023-05-22,9896
5243,乙盛-KY,75,29,46,元大-台南,2023-05-22,9896
2610,華航,111,68,43,元大-台南,2023-05-22,9896
2025,千興,48,6,42,元大-台南,2023-05-22,9896
1440,南紡,30,0,30,元大-台南,2023-05-22,9896
00882,中信中國高股息,28,1,27,元大-台南,2023-05-22,9896
00687B,國泰20年美債,24,0,24,元大-台南,2023-05-22,9896
1605,華新,27,3,24,元大-台南,2023-05-22,9896
3033,威健,24,0,24,元大-台南,2023-05-22,9896
4111,濟生,22,0,22,元大-台南,2023-05-22,9896
00751B,元大AAA至A公司債,22,0,22,元大-台南,2023-05-22,9896
00922,國泰台灣領袖50,20,0,20,元大-台南,2023-05-22,9896
1708,東鹼,20,0,20,元大-台南,2023-05-22,9896
00715L,期街口布蘭特正2,91,71,20,元大-台南,2023-05-22,9896
6697,東捷資訊,19,0,19,元大-台南,2023-05-22,9896
00878,國泰永續高股息,46,29,17,元大-台南,2023-05-22,9896
3017,奇鋐,19,3,16,元大-台南,2023-05-22,9896
00772B,中信高評級公司債,18,3,15,元大-台南,2023-05-22,9896
3037,欣興,40,25,15,元大-台南,2023-05-22,9896
6229,研通,15,0,15,元大-台南,2023-05-22,9896
2105,正新,16,2,14,元大-台南,2023-05-22,9896
6245,立端,15,1,14,元大-台南,2023-05-22,9896
6160,欣技,18,4,14,元大-台南,2023-05-22,9896
2388,威盛,15,1,14,元大-台南,2023-05-22,9896
00680L,元大美債20正2,14,0,14,元大-台南,2023-05-22,9896
3105,穩懋,14,1,13,元大-台南,2023-05-22,9896
5880,合庫金,19,6,13,元大-台南,2023-05-22,9896
8150,南茂,13,0,13,元大-台南,2023-05-22,9896
1101,台泥,18,5,13,元大-台南,2023-05-22,9896
3071,協禧,12,1,11,元大-台南,2023-05-22,9896
4979,華星光,11,1,10,元大-台南,2023-05-22,9896
2387,精元,10,0,10,元大-台南,2023-05-22,9896
4744,皇將,10,0,10,元大-台南,2023-05-22,9896
00664R,國泰臺灣加權反1,10,0,10,元大-台南,2023-05-22,9896
2331,精英,13,3,10,元大-台南,2023-05-22,9896
6112,邁達特,22,12,10,元大-台南,2023-05-22,9896
00679B,元大美債20年,17,7,10,元大-台南,2023-05-22,9896
6806,森崴能源,14,4,10,元大-台南,2023-05-22,9896
00720B,元大投資級公司債,9,0,9,元大-台南,2023-05-22,9896
8403,盛弘,9,0,9,元大-台南,2023-05-22,9896
4746,台耀,9,0,9,元大-台南,2023-05-22,9896
5355,佳總,9,0,9,元大-台南,2023-05-22,9896
3058,立德,16,7,9,元大-台南,2023-05-22,9896
2442,新美齊,22,13,9,元大-台南,2023-05-22,9896
1795,美時,11,3,8,元大-台南,2023-05-22,9896
5009,榮剛,665,19,646,元大-台南,2023-05-23,9896
1528,恩德,84,3,81,元大-台南,2023-05-23,9896
00680L,元大美債20正2,63,0,63,元大-台南,2023-05-23,9896
1513,中興電,66,13,53,元大-台南,2023-05-23,9896
4123,晟德,51,0,51,元大-台南,2023-05-23,9896
8163,達方,51,1,50,元大-台南,2023-05-23,9896
3325,旭品,50,0,50,元大-台南,2023-05-23,9896
00687B,國泰20年美債,45,1,44,元大-台南,2023-05-23,9896
6245,立端,59,18,41,元大-台南,2023-05-23,9896
1455,集盛,40,0,40,元大-台南,2023-05-23,9896
6799,來頡,51,11,40,元大-台南,2023-05-23,9896
3033,威健,35,0,35,元大-台南,2023-05-23,9896
6767,台微醫,29,0,29,元大-台南,2023-05-23,9896
1504,東元,40,13,27,元大-台南,2023-05-23,9896
3164,景岳,25,0,25,元大-台南,2023-05-23,9896
9904,寶成,24,1,23,元大-台南,2023-05-23,9896
6233,旺玖,24,1,23,元大-台南,2023-05-23,9896
00720B,元大投資級公司債,21,0,21,元大-台南,2023-05-23,9896
4129,聯合,20,0,20,元大-台南,2023-05-23,9896
5533,皇鼎,20,0,20,元大-台南,2023-05-23,9896
2421,建準,26,6,20,元大-台南,2023-05-23,9896
00637L,元大滬深300正2,15,0,15,元大-台南,2023-05-23,9896
9939,宏全,16,1,15,元大-台南,2023-05-23,9896
00751B,元大AAA至A公司債,14,0,14,元大-台南,2023-05-23,9896
00882,中信中國高股息,14,0,14,元大-台南,2023-05-23,9896
2313,華通,12,0,12,元大-台南,2023-05-23,9896
6461,益得,20,8,12,元大-台南,2023-05-23,9896
00688L,國泰20年美債正2,12,0,12,元大-台南,2023-05-23,9896
6026,福邦證,12,0,12,元大-台南,2023-05-23,9896
1227,佳格,11,0,11,元大-台南,2023-05-23,9896
00673R,期元大S＆P原油反1,11,0,11,元大-台南,2023-05-23,9896
00712,復華富時不動產,12,1,11,元大-台南,2023-05-23,9896
4106,雃博,11,0,11,元大-台南,2023-05-23,9896
4564,元翎,11,0,11,元大-台南,2023-05-23,9896
6016,康和證,11,0,11,元大-台南,2023-05-23,9896
5525,順天,11,1,10,元大-台南,2023-05-23,9896
4763,材料-KY,12,2,10,元大-台南,2023-05-23,9896
5245,智晶,10,0,10,元大-台南,2023-05-23,9896
9911,櫻花,10,0,10,元大-台南,2023-05-23,9896
2634,漢翔,24,14,10,元大-台南,2023-05-23,9896
2890,永豐金,10,0,10,元大-台南,2023-05-23,9896
00772B,中信高評級公司債,9,0,9,元大-台南,2023-05-23,9896
6446,藥華藥,32,23,9,元大-台南,2023-05-23,9896
4979,華星光,13,4,9,元大-台南,2023-05-23,9896
3380,明泰,9,0,9,元大-台南,2023-05-23,9896
5871A,中租-KY甲特,9,0,9,元大-台南,2023-05-23,9896
6156,松上,9,0,9,元大-台南,2023-05-23,9896
00679B,元大美債20年,32,24,8,元大-台南,2023-05-23,9896
1605,華新,21,13,8,元大-台南,2023-05-23,9896
2610,華航,48,40,8,元大-台南,2023-05-23,9896
2706,第一店,220,88,132,元大-台南,2023-05-24,9896
00882,中信中國高股息,87,0,87,元大-台南,2023-05-24,9896
00712,復華富時不動產,84,1,83,元大-台南,2023-05-24,9896
2377,微星,80,2,78,元大-台南,2023-05-24,9896
5009,榮剛,94,17,77,元大-台南,2023-05-24,9896
00687B,國泰20年美債,66,1,65,元大-台南,2023-05-24,9896
00673R,期元大S＆P原油反1,57,0,57,元大-台南,2023-05-24,9896
2834,臺企銀,54,2,52,元大-台南,2023-05-24,9896
3038,全台,123,75,48,元大-台南,2023-05-24,9896
0056,元大高股息,45,1,44,元大-台南,2023-05-24,9896
1618,合機,42,2,40,元大-台南,2023-05-24,9896
6164,華興,40,0,40,元大-台南,2023-05-24,9896
2457,飛宏,91,53,38,元大-台南,2023-05-24,9896
5243,乙盛-KY,43,5,38,元大-台南,2023-05-24,9896
2399,映泰,43,6,37,元大-台南,2023-05-24,9896
5905,南仁湖,80,47,33,元大-台南,2023-05-24,9896
2204,中華,55,26,29,元大-台南,2023-05-24,9896
00725B,國泰投資級公司債,28,0,28,元大-台南,2023-05-24,9896
6125,廣運,25,0,25,元大-台南,2023-05-24,9896
00928,中信上櫃ESG30,24,0,24,元大-台南,2023-05-24,9896
00878,國泰永續高股息,44,20,24,元大-台南,2023-05-24,9896
6266,泰詠,27,4,23,元大-台南,2023-05-24,9896
5258,虹堡,28,5,23,元大-台南,2023-05-24,9896
00772B,中信高評級公司債,22,0,22,元大-台南,2023-05-24,9896
2332,友訊,32,10,22,元大-台南,2023-05-24,9896
00680L,元大美債20正2,34,12,22,元大-台南,2023-05-24,9896
2442,新美齊,21,0,21,元大-台南,2023-05-24,9896
4114,健喬,23,2,21,元大-台南,2023-05-24,9896
2605,新興,20,0,20,元大-台南,2023-05-24,9896
3558,神準,21,2,19,元大-台南,2023-05-24,9896
1101,台泥,16,0,16,元大-台南,2023-05-24,9896
3664,安瑞-KY,15,0,15,元大-台南,2023-05-24,9896
2882,國泰金,20,5,15,元大-台南,2023-05-24,9896
2886,兆豐金,16,2,14,元大-台南,2023-05-24,9896
2881,富邦金,14,0,14,元大-台南,2023-05-24,9896
00891,中信關鍵半導體,13,1,12,元大-台南,2023-05-24,9896
00753L,中信中國50正2,12,0,12,元大-台南,2023-05-24,9896
2002,中鋼,12,0,12,元大-台南,2023-05-24,9896
2312,金寶,11,0,11,元大-台南,2023-05-24,9896
5864,致和證,11,0,11,元大-台南,2023-05-24,9896
4916,事欣科,13,2,11,元大-台南,2023-05-24,9896
1718,中纖,11,1,10,元大-台南,2023-05-24,9896
2358,廷鑫,10,0,10,元大-台南,2023-05-24,9896
8176,智捷,10,0,10,元大-台南,2023-05-24,9896
2885,元大金,13,4,9,元大-台南,2023-05-24,9896
00720B,元大投資級公司債,9,0,9,元大-台南,2023-05-24,9896
9921,巨大,10,1,9,元大-台南,2023-05-24,9896
2645,長榮航太,10,1,9,元大-台南,2023-05-24,9896
1529,樂事綠能,14,6,8,元大-台南,2023-05-24,9896
6213,聯茂,9,1,8,元大-台南,2023-05-24,9896
00882,中信中國高股息,203,0,203,元大-台南,2023-05-25,9896
2885,元大金,132,1,131,元大-台南,2023-05-25,9896
5243,乙盛-KY,133,3,130,元大-台南,2023-05-25,9896
1609,大亞,177,72,105,元大-台南,2023-05-25,9896
00633L,富邦上証正2,69,4,65,元大-台南,2023-05-25,9896
9930,中聯資源,60,1,59,元大-台南,2023-05-25,9896
2377,微星,97,39,58,元大-台南,2023-05-25,9896
00696B,富邦美債20年,53,0,53,元大-台南,2023-05-25,9896
2303,聯電,46,1,45,元大-台南,2023-05-25,9896
3522,御嵿,41,0,41,元大-台南,2023-05-25,9896
00680L,元大美債20正2,39,0,39,元大-台南,2023-05-25,9896
00720B,元大投資級公司債,38,0,38,元大-台南,2023-05-25,9896
00673R,期元大S＆P原油反1,35,0,35,元大-台南,2023-05-25,9896
00637L,元大滬深300正2,50,15,35,元大-台南,2023-05-25,9896
00712,復華富時不動產,43,8,35,元大-台南,2023-05-25,9896
2371,大同,49,16,33,元大-台南,2023-05-25,9896
3044,健鼎,32,0,32,元大-台南,2023-05-25,9896
5864,致和證,42,13,29,元大-台南,2023-05-25,9896
6112,邁達特,40,11,29,元大-台南,2023-05-25,9896
3013,晟銘電,43,15,28,元大-台南,2023-05-25,9896
00687B,國泰20年美債,28,0,28,元大-台南,2023-05-25,9896
9907,統一實,28,0,28,元大-台南,2023-05-25,9896
2208,台船,33,5,28,元大-台南,2023-05-25,9896
3038,全台,29,2,27,元大-台南,2023-05-25,9896
2457,飛宏,43,16,27,元大-台南,2023-05-25,9896
00751B,元大AAA至A公司債,26,0,26,元大-台南,2023-05-25,9896
5706,鳳凰,42,16,26,元大-台南,2023-05-25,9896
2883,凱基金,29,4,25,元大-台南,2023-05-25,9896
2748,雲品,33,8,25,元大-台南,2023-05-25,9896
2409,友達,38,13,25,元大-台南,2023-05-25,9896
3265,台星科,27,3,24,元大-台南,2023-05-25,9896
3481,群創,47,24,23,元大-台南,2023-05-25,9896
8940,新天地,33,10,23,元大-台南,2023-05-25,9896
9904,寶成,23,1,22,元大-台南,2023-05-25,9896
1710,東聯,22,0,22,元大-台南,2023-05-25,9896
1905,華紙,29,8,21,元大-台南,2023-05-25,9896
6185,幃翔,20,0,20,元大-台南,2023-05-25,9896
1528,恩德,20,0,20,元大-台南,2023-05-25,9896
4746,台耀,23,3,20,元大-台南,2023-05-25,9896
00772B,中信高評級公司債,21,1,20,元大-台南,2023-05-25,9896
2610,華航,76,57,19,元大-台南,2023-05-25,9896
1568,倉佑,18,0,18,元大-台南,2023-05-25,9896
2002,中鋼,37,19,18,元大-台南,2023-05-25,9896
2634,漢翔,23,6,17,元大-台南,2023-05-25,9896
4114,健喬,16,0,16,元大-台南,2023-05-25,9896
4938,和碩,19,4,15,元大-台南,2023-05-25,9896
3479,安勤,16,2,14,元大-台南,2023-05-25,9896
1589,永冠-KY,13,0,13,元大-台南,2023-05-25,9896
6770,力積電,14,1,13,元大-台南,2023-05-25,9896
8050,廣積,14,1,13,元大-台南,2023-05-25,9896
00632R,元大台灣50反1,379,120,259,元大-台南,2023-05-26,9896
00891,中信關鍵半導體,313,60,253,元大-台南,2023-05-26,9896
2317,鴻海,243,10,233,元大-台南,2023-05-26,9896
2323,中環,395,164,231,元大-台南,2023-05-26,9896
00892,富邦台灣半導體,287,92,195,元大-台南,2023-05-26,9896
00650L,復華香港正2,150,0,150,元大-台南,2023-05-26,9896
5880,合庫金,117,1,116,元大-台南,2023-05-26,9896
2376,技嘉,108,46,62,元大-台南,2023-05-26,9896
00882,中信中國高股息,58,1,57,元大-台南,2023-05-26,9896
2881,富邦金,55,0,55,元大-台南,2023-05-26,9896
00706L,期元大S＆P日圓正2,49,0,49,元大-台南,2023-05-26,9896
5009,榮剛,65,18,47,元大-台南,2023-05-26,9896
00715L,期街口布蘭特正2,49,5,44,元大-台南,2023-05-26,9896
1101,台泥,58,16,42,元大-台南,2023-05-26,9896
6282,康舒,81,41,40,元大-台南,2023-05-26,9896
6113,亞矽,55,17,38,元大-台南,2023-05-26,9896
00795B,中信美國公債20年,37,0,37,元大-台南,2023-05-26,9896
00680L,元大美債20正2,35,1,34,元大-台南,2023-05-26,9896
1504,東元,50,18,32,元大-台南,2023-05-26,9896
2634,漢翔,34,4,30,元大-台南,2023-05-26,9896
2605,新興,38,10,28,元大-台南,2023-05-26,9896
00687B,國泰20年美債,26,0,26,元大-台南,2023-05-26,9896
5905,南仁湖,43,17,26,元大-台南,2023-05-26,9896
2892,第一金,36,11,25,元大-台南,2023-05-26,9896
5324,士開,24,0,24,元大-台南,2023-05-26,9896
00907,永豐優息存股,23,0,23,元大-台南,2023-05-26,9896
8163,達方,23,0,23,元大-台南,2023-05-26,9896
1701,中化,22,1,21,元大-台南,2023-05-26,9896
00664R,國泰臺灣加權反1,21,0,21,元大-台南,2023-05-26,9896
6185,幃翔,22,1,21,元大-台南,2023-05-26,9896
6770,力積電,24,4,20,元大-台南,2023-05-26,9896
6142,友勁,20,0,20,元大-台南,2023-05-26,9896
5533,皇鼎,20,0,20,元大-台南,2023-05-26,9896
4564,元翎,48,28,20,元大-台南,2023-05-26,9896
2880,華南金,20,1,19,元大-台南,2023-05-26,9896
5864,致和證,21,2,19,元大-台南,2023-05-26,9896
2606,裕民,25,6,19,元大-台南,2023-05-26,9896
00902,中信電池及儲能,18,0,18,元大-台南,2023-05-26,9896
2356,英業達,33,15,18,元大-台南,2023-05-26,9896
00712,復華富時不動產,41,23,18,元大-台南,2023-05-26,9896
3664,安瑞-KY,20,2,18,元大-台南,2023-05-26,9896
2383,台光電,21,4,17,元大-台南,2023-05-26,9896
6217,中探針,22,5,17,元大-台南,2023-05-26,9896
1905,華紙,54,37,17,元大-台南,2023-05-26,9896
2610,華航,51,35,16,元大-台南,2023-05-26,9896
00878,國泰永續高股息,63,47,16,元大-台南,2023-05-26,9896
6239,力成,20,5,15,元大-台南,2023-05-26,9896
3583,辛耘,16,1,15,元大-台南,2023-05-26,9896
2367,燿華,14,0,14,元大-台南,2023-05-26,9896
00637L,元大滬深300正2,18,5,13,元大-台南,2023-05-26,9896
3105,穩懋,206,1,205,元大-台南,2023-05-29,9896
00706L,期元大S＆P日圓正2,160,0,160,元大-台南,2023-05-29,9896
00671R,富邦NASDAQ反1,148,0,148,元大-台南,2023-05-29,9896
2801,彰銀,125,0,125,元大-台南,2023-05-29,9896
00676R,富邦臺灣加權反1,101,10,91,元大-台南,2023-05-29,9896
2376,技嘉,96,12,84,元大-台南,2023-05-29,9896
2421,建準,133,52,81,元大-台南,2023-05-29,9896
00673R,期元大S＆P原油反1,55,0,55,元大-台南,2023-05-29,9896
2610,華航,133,78,55,元大-台南,2023-05-29,9896
8091,翔名,50,0,50,元大-台南,2023-05-29,9896
2630,亞航,56,6,50,元大-台南,2023-05-29,9896
00664R,國泰臺灣加權反1,48,0,48,元大-台南,2023-05-29,9896
00892,富邦台灣半導體,41,6,35,元大-台南,2023-05-29,9896
00891,中信關鍵半導體,46,12,34,元大-台南,2023-05-29,9896
00882,中信中國高股息,34,1,33,元大-台南,2023-05-29,9896
1608,華榮,46,13,33,元大-台南,2023-05-29,9896
2353,宏��,35,3,32,元大-台南,2023-05-29,9896
2329,華泰,30,1,29,元大-台南,2023-05-29,9896
00680L,元大美債20正2,28,0,28,元大-台南,2023-05-29,9896
00679B,元大美債20年,28,1,27,元大-台南,2023-05-29,9896
3037,欣興,33,10,23,元大-台南,2023-05-29,9896
3545,敦泰,23,2,21,元大-台南,2023-05-29,9896
5443,均豪,22,1,21,元大-台南,2023-05-29,9896
1609,大亞,34,13,21,元大-台南,2023-05-29,9896
6770,力積電,36,16,20,元大-台南,2023-05-29,9896
00687B,國泰20年美債,19,0,19,元大-台南,2023-05-29,9896
4919,新唐,23,4,19,元大-台南,2023-05-29,9896
00751B,元大AAA至A公司債,18,0,18,元大-台南,2023-05-29,9896
8044,網家,18,0,18,元大-台南,2023-05-29,9896
1618,合機,20,2,18,元大-台南,2023-05-29,9896
6113,亞矽,27,9,18,元大-台南,2023-05-29,9896
6274,台燿,17,0,17,元大-台南,2023-05-29,9896
3380,明泰,22,5,17,元大-台南,2023-05-29,9896
00902,中信電池及儲能,16,0,16,元大-台南,2023-05-29,9896
00772B,中信高評級公司債,17,1,16,元大-台南,2023-05-29,9896
1605,華新,18,2,16,元大-台南,2023-05-29,9896
2363,矽統,16,0,16,元大-台南,2023-05-29,9896
3035,智原,20,4,16,元大-台南,2023-05-29,9896
4979,華星光,56,41,15,元大-台南,2023-05-29,9896
2312,金寶,19,4,15,元大-台南,2023-05-29,9896
2382,廣達,16,1,15,元大-台南,2023-05-29,9896
00712,復華富時不動產,16,3,13,元大-台南,2023-05-29,9896
2324,仁寶,26,13,13,元大-台南,2023-05-29,9896
2489,瑞軒,12,0,12,元大-台南,2023-05-29,9896
00632R,元大台灣50反1,112,100,12,元大-台南,2023-05-29,9896
1519,華城,26,15,11,元大-台南,2023-05-29,9896
2495,普安,16,5,11,元大-台南,2023-05-29,9896
2547,日勝生,11,0,11,元大-台南,2023-05-29,9896
2002,中鋼,11,0,11,元大-台南,2023-05-29,9896
8069,元太,17,7,10,元大-台南,2023-05-29,9896
1312,國喬,192,0,192,元大-台南,2023-05-30,9896
00882,中信中國高股息,167,0,167,元大-台南,2023-05-30,9896
2421,建準,78,14,64,元大-台南,2023-05-30,9896
2834,臺企銀,52,0,52,元大-台南,2023-05-30,9896
6142,友勁,50,0,50,元大-台南,2023-05-30,9896
2371,大同,82,33,49,元大-台南,2023-05-30,9896
5009,榮剛,48,5,43,元大-台南,2023-05-30,9896
3032,偉訓,51,9,42,元大-台南,2023-05-30,9896
5328,華容,49,10,39,元大-台南,2023-05-30,9896
2324,仁寶,39,3,36,元大-台南,2023-05-30,9896
00679B,元大美債20年,33,0,33,元大-台南,2023-05-30,9896
00637L,元大滬深300正2,42,15,27,元大-台南,2023-05-30,9896
6282,康舒,39,13,26,元大-台南,2023-05-30,9896
2884,玉山金,26,0,26,元大-台南,2023-05-30,9896
2605,新興,26,0,26,元大-台南,2023-05-30,9896
2356,英業達,57,31,26,元大-台南,2023-05-30,9896
2618,長榮航,114,88,26,元大-台南,2023-05-30,9896
1609,大亞,38,14,24,元大-台南,2023-05-30,9896
1795,美時,26,2,24,元大-台南,2023-05-30,9896
00772B,中信高評級公司債,23,0,23,元大-台南,2023-05-30,9896
8112,至上,30,7,23,元大-台南,2023-05-30,9896
2382,廣達,36,13,23,元大-台南,2023-05-30,9896
5864,致和證,24,2,22,元大-台南,2023-05-30,9896
1513,中興電,36,15,21,元大-台南,2023-05-30,9896
8099,大世科,49,29,20,元大-台南,2023-05-30,9896
6191,精成科,20,0,20,元大-台南,2023-05-30,9896
8091,翔名,27,7,20,元大-台南,2023-05-30,9896
3078,僑威,26,7,19,元大-台南,2023-05-30,9896
2317,鴻海,72,54,18,元大-台南,2023-05-30,9896
00751B,元大AAA至A公司債,18,1,17,元大-台南,2023-05-30,9896
2206,三陽工業,26,10,16,元大-台南,2023-05-30,9896
5512,力麒,17,1,16,元大-台南,2023-05-30,9896
2002,中鋼,19,3,16,元大-台南,2023-05-30,9896
2399,映泰,19,4,15,元大-台南,2023-05-30,9896
5425,台半,21,7,14,元大-台南,2023-05-30,9896
2885,元大金,22,8,14,元大-台南,2023-05-30,9896
2637,慧洋-KY,13,0,13,元大-台南,2023-05-30,9896
2208,台船,13,0,13,元大-台南,2023-05-30,9896
8163,達方,20,7,13,元大-台南,2023-05-30,9896
00664R,國泰臺灣加權反1,18,6,12,元大-台南,2023-05-30,9896
1905,華紙,16,4,12,元大-台南,2023-05-30,9896
2883,凱基金,11,0,11,元大-台南,2023-05-30,9896
2882,國泰金,11,0,11,元大-台南,2023-05-30,9896
1701,中化,11,0,11,元大-台南,2023-05-30,9896
2634,漢翔,20,9,11,元大-台南,2023-05-30,9896
6112,邁達特,16,5,11,元大-台南,2023-05-30,9896
6770,力積電,13,2,11,元大-台南,2023-05-30,9896
3682,亞太電,11,1,10,元大-台南,2023-05-30,9896
3058,立德,10,0,10,元大-台南,2023-05-30,9896
8028,昇陽半導體,10,0,10,元大-台南,2023-05-30,9896
00882,中信中國高股息,305,10,295,元大-台南,2023-05-31,9896
00715L,期街口布蘭特正2,313,20,293,元大-台南,2023-05-31,9896
2618,長榮航,296,65,231,元大-台南,2023-05-31,9896
00637L,元大滬深300正2,171,5,166,元大-台南,2023-05-31,9896
00642U,期元大S＆P石油,150,0,150,元大-台南,2023-05-31,9896
2706,第一店,141,11,130,元大-台南,2023-05-31,9896
8210,勤誠,131,27,104,元大-台南,2023-05-31,9896
2888,新光金,100,10,90,元大-台南,2023-05-31,9896
2421,建準,76,5,71,元大-台南,2023-05-31,9896
00878,國泰永續高股息,75,8,67,元大-台南,2023-05-31,9896
2356,英業達,100,35,65,元大-台南,2023-05-31,9896
2605,新興,33,0,33,元大-台南,2023-05-31,9896
6156,松上,33,0,33,元大-台南,2023-05-31,9896
00688L,國泰20年美債正2,32,0,32,元大-台南,2023-05-31,9896
00902,中信電池及儲能,29,0,29,元大-台南,2023-05-31,9896
2603,長榮,27,1,26,元大-台南,2023-05-31,9896
4979,華星光,38,14,24,元大-台南,2023-05-31,9896
5388,中磊,28,5,23,元大-台南,2023-05-31,9896
9904,寶成,23,0,23,元大-台南,2023-05-31,9896
2317,鴻海,50,28,22,元大-台南,2023-05-31,9896
4919,新唐,24,3,21,元大-台南,2023-05-31,9896
2887,台新金,22,2,20,元大-台南,2023-05-31,9896
6589,台康生技,20,1,19,元大-台南,2023-05-31,9896
2382,廣達,41,23,18,元大-台南,2023-05-31,9896
00713,元大台灣高息低波,19,2,17,元大-台南,2023-05-31,9896
6115,鎰勝,16,0,16,元大-台南,2023-05-31,9896
8940,新天地,21,5,16,元大-台南,2023-05-31,9896
6125,廣運,25,10,15,元大-台南,2023-05-31,9896
1795,美時,18,4,14,元大-台南,2023-05-31,9896
3037,欣興,19,5,14,元大-台南,2023-05-31,9896
3031,佰鴻,22,9,13,元大-台南,2023-05-31,9896
5531,鄉林,13,1,12,元大-台南,2023-05-31,9896
4114,健喬,11,0,11,元大-台南,2023-05-31,9896
00679B,元大美債20年,16,5,11,元大-台南,2023-05-31,9896
5347,世界,11,0,11,元大-台南,2023-05-31,9896
8926,台汽電,11,0,11,元大-台南,2023-05-31,9896
8097,常珵,11,0,11,元大-台南,2023-05-31,9896
4968,立積,17,6,11,元大-台南,2023-05-31,9896
2885,元大金,34,23,11,元大-台南,2023-05-31,9896
5443,均豪,10,0,10,元大-台南,2023-05-31,9896
2431,聯昌,10,0,10,元大-台南,2023-05-31,9896
3325,旭品,10,0,10,元大-台南,2023-05-31,9896
1608,華榮,10,0,10,元大-台南,2023-05-31,9896
2897,王道銀行,10,0,10,元大-台南,2023-05-31,9896
1440,南紡,10,0,10,元大-台南,2023-05-31,9896
00753L,中信中國50正2,10,0,10,元大-台南,2023-05-31,9896
3591,艾笛森,11,1,10,元大-台南,2023-05-31,9896
2349,錸德,21,11,10,元大-台南,2023-05-31,9896
8171,天宇,10,0,10,元大-台南,2023-05-31,9896
2201,裕隆,22,12,10,元大-台南,2023-05-31,9896
2618,長榮航,689,170,519,元大-台南,2023-06-01,9896
2323,中環,340,125,215,元大-台南,2023-06-01,9896
2706,第一店,236,42,194,元大-台南,2023-06-01,9896
00715L,期街口布蘭特正2,193,11,182,元大-台南,2023-06-01,9896
00642U,期元大S＆P石油,121,0,121,元大-台南,2023-06-01,9896
2883,凱基金,119,9,110,元大-台南,2023-06-01,9896
2515,中工,141,66,75,元大-台南,2023-06-01,9896
4564,元翎,67,14,53,元大-台南,2023-06-01,9896
00637L,元大滬深300正2,58,7,51,元大-台南,2023-06-01,9896
2892,第一金,37,3,34,元大-台南,2023-06-01,9896
6229,研通,36,3,33,元大-台南,2023-06-01,9896
00632R,元大台灣50反1,40,10,30,元大-台南,2023-06-01,9896
2331,精英,29,1,28,元大-台南,2023-06-01,9896
2303,聯電,28,2,26,元大-台南,2023-06-01,9896
2356,英業達,27,1,26,元大-台南,2023-06-01,9896
5512,力麒,25,1,24,元大-台南,2023-06-01,9896
1513,中興電,26,3,23,元大-台南,2023-06-01,9896
00772B,中信高評級公司債,24,1,23,元大-台南,2023-06-01,9896
00882,中信中國高股息,22,0,22,元大-台南,2023-06-01,9896
00688L,國泰20年美債正2,22,1,21,元大-台南,2023-06-01,9896
2382,廣達,24,3,21,元大-台南,2023-06-01,9896
2371,大同,39,18,21,元大-台南,2023-06-01,9896
1101,台泥,26,6,20,元大-台南,2023-06-01,9896
5328,華容,20,0,20,元大-台南,2023-06-01,9896
6188,廣明,40,20,20,元大-台南,2023-06-01,9896
1529,樂事綠能,21,1,20,元大-台南,2023-06-01,9896
8271,宇瞻,23,4,19,元大-台南,2023-06-01,9896
6156,松上,19,0,19,元大-台南,2023-06-01,9896
1605,華新,27,8,19,元大-台南,2023-06-01,9896
2489,瑞軒,37,19,18,元大-台南,2023-06-01,9896
6015,宏遠證,20,3,17,元大-台南,2023-06-01,9896
2881,富邦金,18,2,16,元大-台南,2023-06-01,9896
1709,和益,16,0,16,元大-台南,2023-06-01,9896
2393,億光,16,1,15,元大-台南,2023-06-01,9896
2603,長榮,20,5,15,元大-台南,2023-06-01,9896
00885,富邦越南,14,0,14,元大-台南,2023-06-01,9896
1795,美時,14,0,14,元大-台南,2023-06-01,9896
2324,仁寶,18,5,13,元大-台南,2023-06-01,9896
8277,商丞,13,1,12,元大-台南,2023-06-01,9896
2399,映泰,12,0,12,元大-台南,2023-06-01,9896
3025,星通,22,10,12,元大-台南,2023-06-01,9896
2882,國泰金,13,2,11,元大-台南,2023-06-01,9896
8046,南電,12,1,11,元大-台南,2023-06-01,9896
4105,東洋,11,0,11,元大-台南,2023-06-01,9896
4129,聯合,19,8,11,元大-台南,2023-06-01,9896
00687B,國泰20年美債,11,0,11,元大-台南,2023-06-01,9896
1568,倉佑,12,1,11,元大-台南,2023-06-01,9896
2344,華邦電,17,7,10,元大-台南,2023-06-01,9896
2484,希華,10,0,10,元大-台南,2023-06-01,9896
1608,華榮,21,11,10,元大-台南,2023-06-01,9896
00632R,元大台灣50反1,7401,342,7059,元大-台南,2023-06-02,9896
3231,緯創,319,151,168,元大-台南,2023-06-02,9896
2618,長榮航,241,115,126,元大-台南,2023-06-02,9896
2356,英業達,141,22,119,元大-台南,2023-06-02,9896
6806,森崴能源,125,15,110,元大-台南,2023-06-02,9896
2820,華票,100,0,100,元大-台南,2023-06-02,9896
00892,富邦台灣半導體,100,1,99,元大-台南,2023-06-02,9896
00891,中信關鍵半導體,101,4,97,元大-台南,2023-06-02,9896
2883,凱基金,96,12,84,元大-台南,2023-06-02,9896
2323,中環,245,172,73,元大-台南,2023-06-02,9896
2610,華航,197,145,52,元大-台南,2023-06-02,9896
00679B,元大美債20年,48,2,46,元大-台南,2023-06-02,9896
5009,榮剛,48,2,46,元大-台南,2023-06-02,9896
5512,力麒,44,1,43,元大-台南,2023-06-02,9896
00882,中信中國高股息,59,19,40,元大-台南,2023-06-02,9896
6276,安鈦克,37,0,37,元大-台南,2023-06-02,9896
4979,華星光,210,175,35,元大-台南,2023-06-02,9896
00664R,國泰臺灣加權反1,34,0,34,元大-台南,2023-06-02,9896
2010,春源,30,0,30,元大-台南,2023-06-02,9896
3363,上詮,30,1,29,元大-台南,2023-06-02,9896
5328,華容,78,50,28,元大-台南,2023-06-02,9896
6015,宏遠證,27,1,26,元大-台南,2023-06-02,9896
00712,復華富時不動產,32,7,25,元大-台南,2023-06-02,9896
6275,元山,22,0,22,元大-台南,2023-06-02,9896
2331,精英,27,6,21,元大-台南,2023-06-02,9896
2371,大同,38,18,20,元大-台南,2023-06-02,9896
6113,亞矽,57,37,20,元大-台南,2023-06-02,9896
4908,前鼎,20,0,20,元大-台南,2023-06-02,9896
00907,永豐優息存股,21,2,19,元大-台南,2023-06-02,9896
00919,群益台灣精選高息,21,1,20,元大-台南,2023-06-02,9896
9919,康那香,25,5,20,元大-台南,2023-06-02,9896
6111,大宇資,37,19,18,元大-台南,2023-06-02,9896
3711,日月光投控,26,9,17,元大-台南,2023-06-02,9896
2892,第一金,16,0,16,元大-台南,2023-06-02,9896
1503,士電,28,12,16,元大-台南,2023-06-02,9896
6163,華電網,16,1,15,元大-台南,2023-06-02,9896
8021,尖點,16,1,15,元大-台南,2023-06-02,9896
8044,網家,14,0,14,元大-台南,2023-06-02,9896
00650L,復華香港正2,19,5,14,元大-台南,2023-06-02,9896
8277,商丞,15,1,14,元大-台南,2023-06-02,9896
2603,長榮,18,5,13,元大-台南,2023-06-02,9896
4916,事欣科,13,0,13,元大-台南,2023-06-02,9896
8930,青鋼,13,0,13,元大-台南,2023-06-02,9896
2206,三陽工業,35,22,13,元大-台南,2023-06-02,9896
3444,利機,12,0,12,元大-台南,2023-06-02,9896
2444,兆勁,12,0,12,元大-台南,2023-06-02,9896
2601,益航,13,2,11,元大-台南,2023-06-02,9896
2881,富邦金,28,17,11,元大-台南,2023-06-02,9896
2882,國泰金,18,7,11,元大-台南,2023-06-02,9896
00772B,中信高評級公司債,13,2,11,元大-台南,2023-06-02,9896
1905,華紙,366,26,340,元大-台南,2023-06-05,9896
2618,長榮航,224,87,137,元大-台南,2023-06-05,9896
9945,潤泰新,135,11,124,元大-台南,2023-06-05,9896
2317,鴻海,217,101,116,元大-台南,2023-06-05,9896
2353,宏��,112,13,99,元大-台南,2023-06-05,9896
6214,精誠,97,2,95,元大-台南,2023-06-05,9896
2888,新光金,228,158,70,元大-台南,2023-06-05,9896
1529,樂事綠能,95,26,69,元大-台南,2023-06-05,9896
2312,金寶,92,30,62,元大-台南,2023-06-05,9896
00919,群益台灣精選高息,43,0,43,元大-台南,2023-06-05,9896
8069,元太,43,3,40,元大-台南,2023-06-05,9896
6282,康舒,91,54,37,元大-台南,2023-06-05,9896
3481,群創,97,63,34,元大-台南,2023-06-05,9896
3044,健鼎,33,0,33,元大-台南,2023-06-05,9896
2610,華航,75,42,33,元大-台南,2023-06-05,9896
1514,亞力,54,23,31,元大-台南,2023-06-05,9896
00712,復華富時不動產,70,39,31,元大-台南,2023-06-05,9896
00878,國泰永續高股息,50,20,30,元大-台南,2023-06-05,9896
8044,網家,28,0,28,元大-台南,2023-06-05,9896
1731,美吾華,28,0,28,元大-台南,2023-06-05,9896
2382,廣達,38,11,27,元大-台南,2023-06-05,9896
5706,鳳凰,26,0,26,元大-台南,2023-06-05,9896
0056,元大高股息,52,31,21,元大-台南,2023-06-05,9896
00722B,群益投資級電信債,20,0,20,元大-台南,2023-06-05,9896
00640L,富邦日本正2,20,0,20,元大-台南,2023-06-05,9896
00679B,元大美債20年,24,5,19,元大-台南,2023-06-05,9896
2352,佳世達,27,9,18,元大-台南,2023-06-05,9896
2206,三陽工業,23,5,18,元大-台南,2023-06-05,9896
00713,元大台灣高息低波,20,2,18,元大-台南,2023-06-05,9896
8277,商丞,22,4,18,元大-台南,2023-06-05,9896
2332,友訊,18,0,18,元大-台南,2023-06-05,9896
3707,漢磊,23,6,17,元大-台南,2023-06-05,9896
4161,聿新科,16,0,16,元大-台南,2023-06-05,9896
3576,聯合再生,16,0,16,元大-台南,2023-06-05,9896
3406,玉晶光,21,6,15,元大-台南,2023-06-05,9896
00882,中信中國高股息,17,2,15,元大-台南,2023-06-05,9896
6112,邁達特,45,30,15,元大-台南,2023-06-05,9896
6806,森崴能源,31,16,15,元大-台南,2023-06-05,9896
2401,凌陽,16,1,15,元大-台南,2023-06-05,9896
2605,新興,16,1,15,元大-台南,2023-06-05,9896
4979,華星光,38,23,15,元大-台南,2023-06-05,9896
4906,正文,27,12,15,元大-台南,2023-06-05,9896
2603,長榮,24,9,15,元大-台南,2023-06-05,9896
1314,中石化,16,2,14,元大-台南,2023-06-05,9896
2867,三商壽,13,0,13,元大-台南,2023-06-05,9896
2883,凱基金,45,32,13,元大-台南,2023-06-05,9896
2349,錸德,13,1,12,元大-台南,2023-06-05,9896
00635U,期元大S＆P黃金,11,0,11,元大-台南,2023-06-05,9896
2014,中鴻,22,11,11,元大-台南,2023-06-05,9896
00720B,元大投資級公司債,10,0,10,元大-台南,2023-06-05,9896
1528,恩德,107,11,96,元大-台南,2023-06-06,9896
2885,元大金,111,16,95,元大-台南,2023-06-06,9896
00679B,元大美債20年,91,1,90,元大-台南,2023-06-06,9896
6116,彩晶,114,26,88,元大-台南,2023-06-06,9896
1609,大亞,180,111,69,元大-台南,2023-06-06,9896
9907,統一實,60,5,55,元大-台南,2023-06-06,9896
2402,毅嘉,66,18,48,元大-台南,2023-06-06,9896
2888,新光金,86,41,45,元大-台南,2023-06-06,9896
9945,潤泰新,45,5,40,元大-台南,2023-06-06,9896
2634,漢翔,50,11,39,元大-台南,2023-06-06,9896
6288,聯嘉,55,16,39,元大-台南,2023-06-06,9896
00642U,期元大S＆P石油,39,0,39,元大-台南,2023-06-06,9896
00712,復華富時不動產,42,10,32,元大-台南,2023-06-06,9896
00882,中信中國高股息,32,1,31,元大-台南,2023-06-06,9896
00664R,國泰臺灣加權反1,36,6,30,元大-台南,2023-06-06,9896
2461,光群雷,46,17,29,元大-台南,2023-06-06,9896
2371,大同,50,22,28,元大-台南,2023-06-06,9896
1513,中興電,44,16,28,元大-台南,2023-06-06,9896
2369,菱生,28,0,28,元大-台南,2023-06-06,9896
2618,長榮航,101,74,27,元大-台南,2023-06-06,9896
1909,榮成,32,5,27,元大-台南,2023-06-06,9896
2332,友訊,31,5,26,元大-台南,2023-06-06,9896
00919,群益台灣精選高息,24,0,24,元大-台南,2023-06-06,9896
2206,三陽工業,41,19,22,元大-台南,2023-06-06,9896
00640L,富邦日本正2,22,0,22,元大-台南,2023-06-06,9896
2605,新興,20,0,20,元大-台南,2023-06-06,9896
2331,精英,31,11,20,元大-台南,2023-06-06,9896
3032,偉訓,20,0,20,元大-台南,2023-06-06,9896
6142,友勁,20,0,20,元大-台南,2023-06-06,9896
2610,華航,51,32,19,元大-台南,2023-06-06,9896
3406,玉晶光,25,7,18,元大-台南,2023-06-06,9896
1504,東元,46,30,16,元大-台南,2023-06-06,9896
2427,三商電,23,7,16,元大-台南,2023-06-06,9896
4113,聯上,15,0,15,元大-台南,2023-06-06,9896
00713,元大台灣高息低波,22,8,14,元大-台南,2023-06-06,9896
2356,英業達,19,5,14,元大-台南,2023-06-06,9896
2314,台揚,14,1,13,元大-台南,2023-06-06,9896
2913,農林,14,1,13,元大-台南,2023-06-06,9896
00688L,國泰20年美債正2,13,0,13,元大-台南,2023-06-06,9896
3704,合勤控,13,1,12,元大-台南,2023-06-06,9896
1514,亞力,29,17,12,元大-台南,2023-06-06,9896
4931,新盛力,22,11,11,元大-台南,2023-06-06,9896
00632R,元大台灣50反1,21,10,11,元大-台南,2023-06-06,9896
1471,首利,41,30,11,元大-台南,2023-06-06,9896
6016,康和證,23,12,11,元大-台南,2023-06-06,9896
2891,中信金,10,0,10,元大-台南,2023-06-06,9896
2886,兆豐金,11,1,10,元大-台南,2023-06-06,9896
3236,千如,10,0,10,元大-台南,2023-06-06,9896
2337,旺宏,10,0,10,元大-台南,2023-06-06,9896
6194,育富,14,4,10,元大-台南,2023-06-06,9896
2888,新光金,173,40,133,元大-台南,2023-06-07,9896
00679B,元大美債20年,123,2,121,元大-台南,2023-06-07,9896
00632R,元大台灣50反1,151,54,97,元大-台南,2023-06-07,9896
00637L,元大滬深300正2,110,40,70,元大-台南,2023-06-07,9896
2634,漢翔,97,39,58,元大-台南,2023-06-07,9896
3711,日月光投控,79,29,50,元大-台南,2023-06-07,9896
00882,中信中國高股息,47,1,46,元大-台南,2023-06-07,9896
8069,元太,42,2,40,元大-台南,2023-06-07,9896
5009,榮剛,56,17,39,元大-台南,2023-06-07,9896
1605,華新,42,4,38,元大-台南,2023-06-07,9896
2618,長榮航,88,53,35,元大-台南,2023-06-07,9896
2605,新興,34,0,34,元大-台南,2023-06-07,9896
00919,群益台灣精選高息,34,2,32,元大-台南,2023-06-07,9896
1733,五鼎,30,0,30,元大-台南,2023-06-07,9896
1905,華紙,37,7,30,元大-台南,2023-06-07,9896
6603,富強鑫,30,0,30,元大-台南,2023-06-07,9896
6282,康舒,76,47,29,元大-台南,2023-06-07,9896
2402,毅嘉,54,27,27,元大-台南,2023-06-07,9896
0056,元大高股息,47,21,26,元大-台南,2023-06-07,9896
3035,智原,26,1,25,元大-台南,2023-06-07,9896
4113,聯上,25,0,25,元大-台南,2023-06-07,9896
00715L,期街口布蘭特正2,35,11,24,元大-台南,2023-06-07,9896
6214,精誠,20,0,20,元大-台南,2023-06-07,9896
2347,聯強,19,0,19,元大-台南,2023-06-07,9896
6125,廣運,71,53,18,元大-台南,2023-06-07,9896
6733,博晟生醫,38,21,17,元大-台南,2023-06-07,9896
8033,雷虎,31,15,16,元大-台南,2023-06-07,9896
2376,技嘉,30,14,16,元大-台南,2023-06-07,9896
9945,潤泰新,26,10,16,元大-台南,2023-06-07,9896
2401,凌陽,18,3,15,元大-台南,2023-06-07,9896
2369,菱生,14,0,14,元大-台南,2023-06-07,9896
2515,中工,34,20,14,元大-台南,2023-06-07,9896
2457,飛宏,22,9,13,元大-台南,2023-06-07,9896
5274,信驊,13,0,13,元大-台南,2023-06-07,9896
3037,欣興,18,5,13,元大-台南,2023-06-07,9896
1752,南光,13,1,12,元大-台南,2023-06-07,9896
2313,華通,13,1,12,元大-台南,2023-06-07,9896
6016,康和證,19,8,11,元大-台南,2023-06-07,9896
2328,廣宇,13,2,11,元大-台南,2023-06-07,9896
2014,中鴻,11,0,11,元大-台南,2023-06-07,9896
8234,新漢,11,1,10,元大-台南,2023-06-07,9896
00912,中信臺灣智慧50,10,0,10,元大-台南,2023-06-07,9896
2442,新美齊,10,0,10,元大-台南,2023-06-07,9896
1815,富喬,15,5,10,元大-台南,2023-06-07,9896
00907,永豐優息存股,10,0,10,元大-台南,2023-06-07,9896
3011,今皓,10,0,10,元大-台南,2023-06-07,9896
3024,憶聲,10,0,10,元大-台南,2023-06-07,9896
00720B,元大投資級公司債,10,1,9,元大-台南,2023-06-07,9896
00673R,期元大S＆P原油反1,10,1,9,元大-台南,2023-06-07,9896
2337,旺宏,11,2,9,元大-台南,2023-06-07,9896
5009,榮剛,244,26,218,元大-台南,2023-06-08,9896
2618,長榮航,390,193,197,元大-台南,2023-06-08,9896
00679B,元大美債20年,171,67,104,元大-台南,2023-06-08,9896
00772B,中信高評級公司債,102,0,102,元大-台南,2023-06-08,9896
8289,泰藝,80,0,80,元大-台南,2023-06-08,9896
4123,晟德,87,32,55,元大-台南,2023-06-08,9896
6441,廣錠,66,13,53,元大-台南,2023-06-08,9896
4960,誠美材,53,1,52,元大-台南,2023-06-08,9896
2881,富邦金,61,13,48,元大-台南,2023-06-08,9896
2611,志信,52,5,47,元大-台南,2023-06-08,9896
00687B,國泰20年美債,48,2,46,元大-台南,2023-06-08,9896
00919,群益台灣精選高息,68,25,43,元大-台南,2023-06-08,9896
00720B,元大投資級公司債,40,0,40,元大-台南,2023-06-08,9896
6016,康和證,65,25,40,元大-台南,2023-06-08,9896
1905,華紙,50,11,39,元大-台南,2023-06-08,9896
2382,廣達,48,9,39,元大-台南,2023-06-08,9896
00688L,國泰20年美債正2,32,0,32,元大-台南,2023-06-08,9896
2444,兆勁,30,0,30,元大-台南,2023-06-08,9896
6215,和椿,30,0,30,元大-台南,2023-06-08,9896
6190,萬泰科,38,8,30,元大-台南,2023-06-08,9896
4966,譜瑞-KY,32,2,30,元大-台南,2023-06-08,9896
00673R,期元大S＆P原油反1,29,0,29,元大-台南,2023-06-08,9896
6282,康舒,61,35,26,元大-台南,2023-06-08,9896
2457,飛宏,221,195,26,元大-台南,2023-06-08,9896
6274,台燿,31,6,25,元大-台南,2023-06-08,9896
0056,元大高股息,58,34,24,元大-台南,2023-06-08,9896
00751B,元大AAA至A公司債,24,0,24,元大-台南,2023-06-08,9896
6125,廣運,65,42,23,元大-台南,2023-06-08,9896
2458,義隆,24,1,23,元大-台南,2023-06-08,9896
2337,旺宏,23,3,20,元大-台南,2023-06-08,9896
3583,辛耘,23,3,20,元大-台南,2023-06-08,9896
1806,冠軍,20,0,20,元大-台南,2023-06-08,9896
6223,旺矽,22,2,20,元大-台南,2023-06-08,9896
1504,東元,33,14,19,元大-台南,2023-06-08,9896
2605,新興,20,1,19,元大-台南,2023-06-08,9896
1513,中興電,54,37,17,元大-台南,2023-06-08,9896
2401,凌陽,29,12,17,元大-台南,2023-06-08,9896
6288,聯嘉,17,0,17,元大-台南,2023-06-08,9896
2002,中鋼,21,4,17,元大-台南,2023-06-08,9896
6113,亞矽,60,44,16,元大-台南,2023-06-08,9896
4303,信立,16,0,16,元大-台南,2023-06-08,9896
1612,宏泰,27,12,15,元大-台南,2023-06-08,9896
2367,燿華,14,0,14,元大-台南,2023-06-08,9896
2324,仁寶,15,2,13,元大-台南,2023-06-08,9896
8940,新天地,17,4,13,元大-台南,2023-06-08,9896
6776,展�眥篕�,15,3,12,元大-台南,2023-06-08,9896
00725B,國泰投資級公司債,12,0,12,元大-台南,2023-06-08,9896
2461,光群雷,15,3,12,元大-台南,2023-06-08,9896
2633,台灣高鐵,13,1,12,元大-台南,2023-06-08,9896
6233,旺玖,12,0,12,元大-台南,2023-06-08,9896
2382,廣達,245,40,205,元大-台南,2023-06-09,9896
6190,萬泰科,202,0,202,元大-台南,2023-06-09,9896
00712,復華富時不動產,164,2,162,元大-台南,2023-06-09,9896
00929,復華台灣科技優息,119,2,117,元大-台南,2023-06-09,9896
00715L,期街口布蘭特正2,65,0,65,元大-台南,2023-06-09,9896
1504,東元,77,13,64,元大-台南,2023-06-09,9896
2376,技嘉,61,17,44,元大-台南,2023-06-09,9896
00919,群益台灣精選高息,47,5,42,元大-台南,2023-06-09,9896
00664R,國泰臺灣加權反1,35,0,35,元大-台南,2023-06-09,9896
2706,第一店,39,6,33,元大-台南,2023-06-09,9896
8150,南茂,34,2,32,元大-台南,2023-06-09,9896
6603,富強鑫,31,0,31,元大-台南,2023-06-09,9896
5009,榮剛,72,41,31,元大-台南,2023-06-09,9896
2615,萬海,33,5,28,元大-台南,2023-06-09,9896
2482,連宇,46,20,26,元大-台南,2023-06-09,9896
2630,亞航,49,24,25,元大-台南,2023-06-09,9896
1584,精剛,25,1,24,元大-台南,2023-06-09,9896
2882,國泰金,24,2,22,元大-台南,2023-06-09,9896
6026,福邦證,23,1,22,元大-台南,2023-06-09,9896
1609,大亞,323,301,22,元大-台南,2023-06-09,9896
2867,三商壽,25,4,21,元大-台南,2023-06-09,9896
2409,友達,21,0,21,元大-台南,2023-06-09,9896
00897,富邦基因免疫生技,20,0,20,元大-台南,2023-06-09,9896
4113,聯上,20,0,20,元大-台南,2023-06-09,9896
5315,光聯,20,0,20,元大-台南,2023-06-09,9896
6016,康和證,19,0,19,元大-台南,2023-06-09,9896
4960,誠美材,19,0,19,元大-台南,2023-06-09,9896
6441,廣錠,19,1,18,元大-台南,2023-06-09,9896
2337,旺宏,17,0,17,元大-台南,2023-06-09,9896
4533,協易機,43,27,16,元大-台南,2023-06-09,9896
3481,群創,16,0,16,元大-台南,2023-06-09,9896
1440,南紡,16,0,16,元大-台南,2023-06-09,9896
1802,台玻,15,0,15,元大-台南,2023-06-09,9896
2605,新興,15,0,15,元大-台南,2023-06-09,9896
4303,信立,15,0,15,元大-台南,2023-06-09,9896
6733,博晟生醫,15,1,14,元大-台南,2023-06-09,9896
6125,廣運,27,13,14,元大-台南,2023-06-09,9896
6112,邁達特,24,10,14,元大-台南,2023-06-09,9896
2731,雄獅,29,15,14,元大-台南,2023-06-09,9896
8210,勤誠,28,15,13,元大-台南,2023-06-09,9896
3252,海灣,13,0,13,元大-台南,2023-06-09,9896
3033,威健,11,0,11,元大-台南,2023-06-09,9896
2421,建準,16,5,11,元大-台南,2023-06-09,9896
2427,三商電,12,2,10,元大-台南,2023-06-09,9896
6278,台表科,10,0,10,元大-台南,2023-06-09,9896
3191,雲嘉南,10,0,10,元大-台南,2023-06-09,9896
2612,中航,10,0,10,元大-台南,2023-06-09,9896
2480,敦陽科,10,0,10,元大-台南,2023-06-09,9896
00907,永豐優息存股,10,0,10,元大-台南,2023-06-09,9896
00635U,期元大S＆P黃金,10,0,10,元大-台南,2023-06-09,9896
2888,新光金,372,136,236,元大-台南,2023-06-12,9896
00929,復華台灣科技優息,214,9,205,元大-台南,2023-06-12,9896
00715L,期街口布蘭特正2,129,0,129,元大-台南,2023-06-12,9896
2618,長榮航,139,22,117,元大-台南,2023-06-12,9896
2820,華票,112,0,112,元大-台南,2023-06-12,9896
2382,廣達,144,50,94,元大-台南,2023-06-12,9896
00642U,期元大S＆P石油,91,0,91,元大-台南,2023-06-12,9896
6589,台康生技,82,0,82,元大-台南,2023-06-12,9896
00919,群益台灣精選高息,77,6,71,元大-台南,2023-06-12,9896
00632R,元大台灣50反1,74,7,67,元大-台南,2023-06-12,9896
3231,緯創,123,58,65,元大-台南,2023-06-12,9896
00888,永豐台灣ESG,58,0,58,元大-台南,2023-06-12,9896
2312,金寶,54,3,51,元大-台南,2023-06-12,9896
2605,新興,46,0,46,元大-台南,2023-06-12,9896
3356,奇偶,51,7,44,元大-台南,2023-06-12,9896
2610,華航,53,9,44,元大-台南,2023-06-12,9896
8064,東捷,40,0,40,元大-台南,2023-06-12,9896
6603,富強鑫,40,0,40,元大-台南,2023-06-12,9896
4157,太景*-KY,45,7,38,元大-台南,2023-06-12,9896
1471,首利,63,30,33,元大-台南,2023-06-12,9896
1609,大亞,50,18,32,元大-台南,2023-06-12,9896
3202,樺晟,32,1,31,元大-台南,2023-06-12,9896
00895,富邦未來車,30,0,30,元大-台南,2023-06-12,9896
2353,宏��,32,3,29,元大-台南,2023-06-12,9896
3032,偉訓,183,155,28,元大-台南,2023-06-12,9896
1101,台泥,48,20,28,元大-台南,2023-06-12,9896
8358,金居,30,3,27,元大-台南,2023-06-12,9896
2504,國產,30,4,26,元大-台南,2023-06-12,9896
4979,華星光,37,11,26,元大-台南,2023-06-12,9896
8926,台汽電,34,9,25,元大-台南,2023-06-12,9896
5258,虹堡,33,9,24,元大-台南,2023-06-12,9896
8131,福懋科,24,0,24,元大-台南,2023-06-12,9896
5880,合庫金,24,0,24,元大-台南,2023-06-12,9896
3481,群創,36,13,23,元大-台南,2023-06-12,9896
6122,擎邦,30,7,23,元大-台南,2023-06-12,9896
5498,凱崴,21,0,21,元大-台南,2023-06-12,9896
1605,華新,25,5,20,元大-台南,2023-06-12,9896
2356,英業達,79,58,21,元大-台南,2023-06-12,9896
2409,友達,30,10,20,元大-台南,2023-06-12,9896
2511,太子,20,0,20,元大-台南,2023-06-12,9896
6113,亞矽,60,40,20,元大-台南,2023-06-12,9896
1752,南光,23,4,19,元大-台南,2023-06-12,9896
2495,普安,21,2,19,元大-台南,2023-06-12,9896
1513,中興電,25,7,18,元大-台南,2023-06-12,9896
2705,六福,24,6,18,元大-台南,2023-06-12,9896
6125,廣運,22,5,17,元大-台南,2023-06-12,9896
2388,威盛,21,4,17,元大-台南,2023-06-12,9896
5426,振發,17,0,17,元大-台南,2023-06-12,9896
4123,晟德,44,27,17,元大-台南,2023-06-12,9896
2882,國泰金,20,3,17,元大-台南,2023-06-12,9896
00632R,元大台灣50反1,306,74,232,元大-台南,2023-06-13,9896
00715L,期街口布蘭特正2,230,20,210,元大-台南,2023-06-13,9896
2881,富邦金,209,1,208,元大-台南,2023-06-13,9896
2618,長榮航,271,113,158,元大-台南,2023-06-13,9896
00919,群益台灣精選高息,152,3,149,元大-台南,2023-06-13,9896
00642U,期元大S＆P石油,110,0,110,元大-台南,2023-06-13,9896
5880,合庫金,100,15,85,元大-台南,2023-06-13,9896
4533,協易機,122,52,70,元大-台南,2023-06-13,9896
8926,台汽電,73,11,62,元大-台南,2023-06-13,9896
2358,廷鑫,50,0,50,元大-台南,2023-06-13,9896
5425,台半,57,9,48,元大-台南,2023-06-13,9896
2352,佳世達,57,20,37,元大-台南,2023-06-13,9896
00895,富邦未來車,50,15,35,元大-台南,2023-06-13,9896
2610,華航,108,74,34,元大-台南,2023-06-13,9896
2834,臺企銀,40,6,34,元大-台南,2023-06-13,9896
6288,聯嘉,98,64,34,元大-台南,2023-06-13,9896
00712,復華富時不動產,64,35,29,元大-台南,2023-06-13,9896
00882,中信中國高股息,28,0,28,元大-台南,2023-06-13,9896
8213,志超,28,0,28,元大-台南,2023-06-13,9896
2888,新光金,69,42,27,元大-台南,2023-06-13,9896
6548,長科*,25,1,24,元大-台南,2023-06-13,9896
8358,金居,29,5,24,元大-台南,2023-06-13,9896
00631L,元大台灣50正2,22,0,22,元大-台南,2023-06-13,9896
2357,華碩,22,0,22,元大-台南,2023-06-13,9896
4968,立積,25,3,22,元大-台南,2023-06-13,9896
6016,康和證,24,3,21,元大-台南,2023-06-13,9896
00637L,元大滬深300正2,26,5,21,元大-台南,2023-06-13,9896
6194,育富,21,0,21,元大-台南,2023-06-13,9896
4303,信立,20,0,20,元大-台南,2023-06-13,9896
00661,元大日經225,20,0,20,元大-台南,2023-06-13,9896
00907,永豐優息存股,20,0,20,元大-台南,2023-06-13,9896
2605,新興,21,1,20,元大-台南,2023-06-13,9896
2371,大同,28,9,19,元大-台南,2023-06-13,9896
3374,精材,24,6,18,元大-台南,2023-06-13,9896
00679B,元大美債20年,18,0,18,元大-台南,2023-06-13,9896
2515,中工,20,2,18,元大-台南,2023-06-13,9896
00893,國泰智能電動車,56,38,18,元大-台南,2023-06-13,9896
2482,連宇,28,11,17,元大-台南,2023-06-13,9896
5340,建榮,16,0,16,元大-台南,2023-06-13,9896
1785,光洋科,17,2,15,元大-台南,2023-06-13,9896
1733,五鼎,15,0,15,元大-台南,2023-06-13,9896
1440,南紡,15,0,15,元大-台南,2023-06-13,9896
6196,帆宣,22,7,15,元大-台南,2023-06-13,9896
2867,三商壽,14,0,14,元大-台南,2023-06-13,9896
00929,復華台灣科技優息,15,1,14,元大-台南,2023-06-13,9896
4961,天鈺,12,0,12,元大-台南,2023-06-13,9896
00772B,中信高評級公司債,12,0,12,元大-台南,2023-06-13,9896
1504,東元,28,17,11,元大-台南,2023-06-13,9896
6148,驊宏資,16,5,11,元大-台南,2023-06-13,9896
00725B,國泰投資級公司債,11,0,11,元大-台南,2023-06-13,9896
00712,復華富時不動產,246,8,238,元大-台南,2023-06-14,9896
6113,亞矽,191,93,98,元大-台南,2023-06-14,9896
5258,虹堡,116,29,87,元大-台南,2023-06-14,9896
00919,群益台灣精選高息,82,4,78,元大-台南,2023-06-14,9896
00720B,元大投資級公司債,114,40,74,元大-台南,2023-06-14,9896
2303,聯電,102,34,68,元大-台南,2023-06-14,9896
3078,僑威,85,27,58,元大-台南,2023-06-14,9896
00679B,元大美債20年,56,0,56,元大-台南,2023-06-14,9896
3033,威健,63,13,50,元大-台南,2023-06-14,9896
00882,中信中國高股息,67,17,50,元大-台南,2023-06-14,9896
2888,新光金,56,7,49,元大-台南,2023-06-14,9896
00632R,元大台灣50反1,100,52,48,元大-台南,2023-06-14,9896
2356,英業達,234,187,47,元大-台南,2023-06-14,9896
9907,統一實,41,1,40,元大-台南,2023-06-14,9896
6288,聯嘉,114,78,36,元大-台南,2023-06-14,9896
3044,健鼎,30,1,29,元大-台南,2023-06-14,9896
6026,福邦證,30,2,28,元大-台南,2023-06-14,9896
00751B,元大AAA至A公司債,27,0,27,元大-台南,2023-06-14,9896
5381,合正,30,3,27,元大-台南,2023-06-14,9896
00687B,國泰20年美債,26,0,26,元大-台南,2023-06-14,9896
6282,康舒,53,27,26,元大-台南,2023-06-14,9896
00891,中信關鍵半導體,95,70,25,元大-台南,2023-06-14,9896
6182,合晶,36,13,23,元大-台南,2023-06-14,9896
00642U,期元大S＆P石油,30,8,22,元大-台南,2023-06-14,9896
5880,合庫金,22,0,22,元大-台南,2023-06-14,9896
4557,永新-KY,22,0,22,元大-台南,2023-06-14,9896
00673R,期元大S＆P原油反1,22,0,22,元大-台南,2023-06-14,9896
3576,聯合再生,22,1,21,元大-台南,2023-06-14,9896
8150,南茂,21,0,21,元大-台南,2023-06-14,9896
2066,世德,20,0,20,元大-台南,2023-06-14,9896
1784,訊聯,20,0,20,元大-台南,2023-06-14,9896
00929,復華台灣科技優息,26,7,19,元大-台南,2023-06-14,9896
00752,中信中國50,23,4,19,元大-台南,2023-06-14,9896
3046,建��,41,25,16,元大-台南,2023-06-14,9896
3035,智原,21,5,16,元大-台南,2023-06-14,9896
3092,鴻碩,17,1,16,元大-台南,2023-06-14,9896
2301,光寶科,16,1,15,元大-台南,2023-06-14,9896
2605,新興,17,2,15,元大-台南,2023-06-14,9896
2388,威盛,18,4,14,元大-台南,2023-06-14,9896
3583,辛耘,25,12,13,元大-台南,2023-06-14,9896
2634,漢翔,16,3,13,元大-台南,2023-06-14,9896
8213,志超,13,0,13,元大-台南,2023-06-14,9896
1611,中電,61,48,13,元大-台南,2023-06-14,9896
00688L,國泰20年美債正2,13,0,13,元大-台南,2023-06-14,9896
3498,陽程,13,1,12,元大-台南,2023-06-14,9896
3265,台星科,16,4,12,元大-台南,2023-06-14,9896
1905,華紙,17,6,11,元大-台南,2023-06-14,9896
3356,奇偶,80,69,11,元大-台南,2023-06-14,9896
2637,慧洋-KY,11,0,11,元大-台南,2023-06-14,9896
00670L,富邦NASDAQ正2,11,0,11,元大-台南,2023-06-14,9896
00882,中信中國高股息,221,1,220,元大-台南,2023-06-15,9896
00637L,元大滬深300正2,155,11,144,元大-台南,2023-06-15,9896
1528,恩德,188,57,131,元大-台南,2023-06-15,9896
2317,鴻海,127,12,115,元大-台南,2023-06-15,9896
00919,群益台灣精選高息,91,7,84,元大-台南,2023-06-15,9896
00795B,中信美國公債20年,70,0,70,元大-台南,2023-06-15,9896
00715L,期街口布蘭特正2,63,0,63,元大-台南,2023-06-15,9896
2886,兆豐金,62,0,62,元大-台南,2023-06-15,9896
2891,中信金,64,3,61,元大-台南,2023-06-15,9896
3032,偉訓,49,2,47,元大-台南,2023-06-15,9896
5880,合庫金,40,0,40,元大-台南,2023-06-15,9896
00642U,期元大S＆P石油,39,0,39,元大-台南,2023-06-15,9896
8926,台汽電,37,2,35,元大-台南,2023-06-15,9896
3059,華晶科,35,2,33,元大-台南,2023-06-15,9896
2605,新興,32,0,32,元大-台南,2023-06-15,9896
00907,永豐優息存股,30,0,30,元大-台南,2023-06-15,9896
1504,東元,47,18,29,元大-台南,2023-06-15,9896
00687B,國泰20年美債,28,0,28,元大-台南,2023-06-15,9896
1905,華紙,30,3,27,元大-台南,2023-06-15,9896
2457,飛宏,28,3,25,元大-台南,2023-06-15,9896
2634,漢翔,57,33,24,元大-台南,2023-06-15,9896
1609,大亞,98,74,24,元大-台南,2023-06-15,9896
00712,復華富時不動產,37,14,23,元大-台南,2023-06-15,9896
2888,新光金,40,18,22,元大-台南,2023-06-15,9896
2882,國泰金,25,4,21,元大-台南,2023-06-15,9896
3013,晟銘電,29,8,21,元大-台南,2023-06-15,9896
00773B,中信優先金融債,21,0,21,元大-台南,2023-06-15,9896
6239,力成,21,0,21,元大-台南,2023-06-15,9896
6266,泰詠,19,0,19,元大-台南,2023-06-15,9896
4564,元翎,18,0,18,元大-台南,2023-06-15,9896
1806,冠軍,19,1,18,元大-台南,2023-06-15,9896
5009,榮剛,25,7,18,元大-台南,2023-06-15,9896
00751B,元大AAA至A公司債,18,0,18,元大-台南,2023-06-15,9896
6113,亞矽,74,57,17,元大-台南,2023-06-15,9896
4114,健喬,17,0,17,元大-台南,2023-06-15,9896
6282,康舒,74,59,15,元大-台南,2023-06-15,9896
2881,富邦金,15,0,15,元大-台南,2023-06-15,9896
5284,jpp-KY,18,3,15,元大-台南,2023-06-15,9896
1795,美時,22,8,14,元大-台南,2023-06-15,9896
00892,富邦台灣半導體,25,11,14,元大-台南,2023-06-15,9896
3576,聯合再生,20,6,14,元大-台南,2023-06-15,9896
2409,友達,18,5,13,元大-台南,2023-06-15,9896
3046,建��,14,1,13,元大-台南,2023-06-15,9896
6024,群益期,13,0,13,元大-台南,2023-06-15,9896
1802,台玻,40,28,12,元大-台南,2023-06-15,9896
8150,南茂,12,1,11,元大-台南,2023-06-15,9896
2408,南亞科,12,1,11,元大-台南,2023-06-15,9896
9938,百和,12,1,11,元大-台南,2023-06-15,9896
3702A,大聯大甲特,11,0,11,元大-台南,2023-06-15,9896
3078,僑威,18,7,11,元大-台南,2023-06-15,9896
6116,彩晶,227,10,217,元大-台南,2023-06-16,9896
00712,復華富時不動產,227,12,215,元大-台南,2023-06-16,9896
2610,華航,516,306,210,元大-台南,2023-06-16,9896
3260,威剛,147,27,120,元大-台南,2023-06-16,9896
00919,群益台灣精選高息,119,5,114,元大-台南,2023-06-16,9896
2323,中環,258,159,99,元大-台南,2023-06-16,9896
00673R,期元大S＆P原油反1,94,0,94,元大-台南,2023-06-16,9896
00878,國泰永續高股息,134,55,79,元大-台南,2023-06-16,9896
6113,亞矽,106,28,78,元大-台南,2023-06-16,9896
2356,英業達,132,64,68,元大-台南,2023-06-16,9896
2618,長榮航,218,168,50,元大-台南,2023-06-16,9896
3706,神達,100,54,46,元大-台南,2023-06-16,9896
2105,正新,47,2,45,元大-台南,2023-06-16,9896
6185,幃翔,36,0,36,元大-台南,2023-06-16,9896
2382,廣達,51,17,34,元大-台南,2023-06-16,9896
2834,臺企銀,34,0,34,元大-台南,2023-06-16,9896
020029,元大ESG高股息N,32,0,32,元大-台南,2023-06-16,9896
2605,新興,30,0,30,元大-台南,2023-06-16,9896
2457,飛宏,42,12,30,元大-台南,2023-06-16,9896
8446,華研,37,9,28,元大-台南,2023-06-16,9896
5009,榮剛,45,18,27,元大-台南,2023-06-16,9896
6026,福邦證,27,0,27,元大-台南,2023-06-16,9896
1611,中電,38,13,25,元大-台南,2023-06-16,9896
2915,潤泰全,25,1,24,元大-台南,2023-06-16,9896
9938,百和,24,0,24,元大-台南,2023-06-16,9896
5706,鳳凰,24,2,22,元大-台南,2023-06-16,9896
3481,群創,33,12,21,元大-台南,2023-06-16,9896
4157,太景*-KY,20,0,20,元大-台南,2023-06-16,9896
5284,jpp-KY,20,0,20,元大-台南,2023-06-16,9896
8050,廣積,18,1,17,元大-台南,2023-06-16,9896
2705,六福,18,1,17,元大-台南,2023-06-16,9896
4953,緯軟,17,0,17,元大-台南,2023-06-16,9896
6223,旺矽,19,2,17,元大-台南,2023-06-16,9896
2886,兆豐金,17,1,16,元大-台南,2023-06-16,9896
3013,晟銘電,21,5,16,元大-台南,2023-06-16,9896
1815,富喬,36,20,16,元大-台南,2023-06-16,9896
1905,華紙,37,21,16,元大-台南,2023-06-16,9896
2359,所羅門,27,11,16,元大-台南,2023-06-16,9896
00713,元大台灣高息低波,22,6,16,元大-台南,2023-06-16,9896
2409,友達,31,16,15,元大-台南,2023-06-16,9896
1301,台塑,15,0,15,元大-台南,2023-06-16,9896
00924,復華S＆P500成長,15,0,15,元大-台南,2023-06-16,9896
2482,連宇,20,6,14,元大-台南,2023-06-16,9896
1806,冠軍,15,1,14,元大-台南,2023-06-16,9896
2331,精英,18,4,14,元大-台南,2023-06-16,9896
2884,玉山金,13,0,13,元大-台南,2023-06-16,9896
8112,至上,13,0,13,元大-台南,2023-06-16,9896
1609,大亞,184,171,13,元大-台南,2023-06-16,9896
2313,華通,13,0,13,元大-台南,2023-06-16,9896
4533,協易機,21,8,13,元大-台南,2023-06-16,9896
2468,華經,467,14,453,元大-台南,2023-06-19,9896
2634,漢翔,313,72,241,元大-台南,2023-06-19,9896
00712,復華富時不動產,226,0,226,元大-台南,2023-06-19,9896
2610,華航,289,110,179,元大-台南,2023-06-19,9896
6120,達運,146,9,137,元大-台南,2023-06-19,9896
2888,新光金,84,2,82,元大-台南,2023-06-19,9896
2312,金寶,100,22,78,元大-台南,2023-06-19,9896
00929,復華台灣科技優息,47,0,47,元大-台南,2023-06-19,9896
2324,仁寶,59,14,45,元大-台南,2023-06-19,9896
5284,jpp-KY,44,4,40,元大-台南,2023-06-19,9896
00687B,國泰20年美債,40,0,40,元大-台南,2023-06-19,9896
1609,大亞,52,14,38,元大-台南,2023-06-19,9896
2615,萬海,38,1,37,元大-台南,2023-06-19,9896
3356,奇偶,34,2,32,元大-台南,2023-06-19,9896
2344,華邦電,34,3,31,元大-台南,2023-06-19,9896
4960,誠美材,34,5,29,元大-台南,2023-06-19,9896
8028,昇陽半導體,36,13,23,元大-台南,2023-06-19,9896
00795B,中信美國公債20年,33,10,23,元大-台南,2023-06-19,9896
00720B,元大投資級公司債,25,3,22,元大-台南,2023-06-19,9896
8150,南茂,22,0,22,元大-台南,2023-06-19,9896
2356,英業達,63,42,21,元大-台南,2023-06-19,9896
8277,商丞,22,2,20,元大-台南,2023-06-19,9896
3260,威剛,24,5,19,元大-台南,2023-06-19,9896
00679B,元大美債20年,27,8,19,元大-台南,2023-06-19,9896
3017,奇鋐,26,8,18,元大-台南,2023-06-19,9896
00882,中信中國高股息,17,0,17,元大-台南,2023-06-19,9896
00919,群益台灣精選高息,21,4,17,元大-台南,2023-06-19,9896
1717,長興,16,0,16,元大-台南,2023-06-19,9896
00762,元大全球AI,16,0,16,元大-台南,2023-06-19,9896
2353,宏��,37,22,15,元大-台南,2023-06-19,9896
2014,中鴻,18,3,15,元大-台南,2023-06-19,9896
2883,凱基金,27,12,15,元大-台南,2023-06-19,9896
8926,台汽電,29,15,14,元大-台南,2023-06-19,9896
3046,建��,42,29,13,元大-台南,2023-06-19,9896
1529,樂事綠能,16,3,13,元大-台南,2023-06-19,9896
2705,六福,16,5,11,元大-台南,2023-06-19,9896
6282,康舒,15,4,11,元大-台南,2023-06-19,9896
2385,群光,12,1,11,元大-台南,2023-06-19,9896
4938,和碩,14,3,11,元大-台南,2023-06-19,9896
00650L,復華香港正2,11,0,11,元大-台南,2023-06-19,9896
9904,寶成,11,0,11,元大-台南,2023-06-19,9896
6005,群益證,11,0,11,元大-台南,2023-06-19,9896
3025,星通,11,0,11,元大-台南,2023-06-19,9896
2515,中工,11,0,11,元大-台南,2023-06-19,9896
6207,雷科,11,0,11,元大-台南,2023-06-19,9896
00751B,元大AAA至A公司債,11,0,11,元大-台南,2023-06-19,9896
1201,味全,10,0,10,元大-台南,2023-06-19,9896
5425,台半,10,0,10,元大-台南,2023-06-19,9896
6697,東捷資訊,12,2,10,元大-台南,2023-06-19,9896
1301,台塑,10,0,10,元大-台南,2023-06-19,9896
2610,華航,238,28,210,元大-台南,2023-06-20,9896
00632R,元大台灣50反1,315,118,197,元大-台南,2023-06-20,9896
3481,群創,288,119,169,元大-台南,2023-06-20,9896
8210,勤誠,112,6,106,元大-台南,2023-06-20,9896
2888,新光金,104,1,103,元大-台南,2023-06-20,9896
1609,大亞,84,6,78,元大-台南,2023-06-20,9896
00712,復華富時不動產,77,10,67,元大-台南,2023-06-20,9896
1471,首利,61,3,58,元大-台南,2023-06-20,9896
1802,台玻,64,7,57,元大-台南,2023-06-20,9896
4960,誠美材,56,0,56,元大-台南,2023-06-20,9896
5009,榮剛,59,4,55,元大-台南,2023-06-20,9896
00673R,期元大S＆P原油反1,55,0,55,元大-台南,2023-06-20,9896
00882,中信中國高股息,53,0,53,元大-台南,2023-06-20,9896
6275,元山,45,0,45,元大-台南,2023-06-20,9896
2504,國產,38,0,38,元大-台南,2023-06-20,9896
2312,金寶,42,7,35,元大-台南,2023-06-20,9896
00929,復華台灣科技優息,28,1,27,元大-台南,2023-06-20,9896
2454,聯發科,29,2,27,元大-台南,2023-06-20,9896
00720B,元大投資級公司債,26,0,26,元大-台南,2023-06-20,9896
00679B,元大美債20年,27,2,25,元大-台南,2023-06-20,9896
6244,茂迪,30,6,24,元大-台南,2023-06-20,9896
1103,嘉泥,66,44,22,元大-台南,2023-06-20,9896
2468,華經,35,13,22,元大-台南,2023-06-20,9896
1905,華紙,31,9,22,元大-台南,2023-06-20,9896
2353,宏��,22,0,22,元大-台南,2023-06-20,9896
00687B,國泰20年美債,21,0,21,元大-台南,2023-06-20,9896
3049,精金,20,1,19,元大-台南,2023-06-20,9896
2104,國際中橡,22,4,18,元大-台南,2023-06-20,9896
4114,健喬,19,2,17,元大-台南,2023-06-20,9896
00751B,元大AAA至A公司債,17,0,17,元大-台南,2023-06-20,9896
2482,連宇,26,9,17,元大-台南,2023-06-20,9896
6245,立端,16,0,16,元大-台南,2023-06-20,9896
3652,精聯,18,2,16,元大-台南,2023-06-20,9896
1605,華新,53,38,15,元大-台南,2023-06-20,9896
8092,建暐,15,0,15,元大-台南,2023-06-20,9896
2337,旺宏,24,9,15,元大-台南,2023-06-20,9896
2027,大成鋼,25,12,13,元大-台南,2023-06-20,9896
2388,威盛,15,2,13,元大-台南,2023-06-20,9896
1612,宏泰,20,7,13,元大-台南,2023-06-20,9896
3325,旭品,20,7,13,元大-台南,2023-06-20,9896
2618,長榮航,79,67,12,元大-台南,2023-06-20,9896
2427,三商電,30,18,12,元大-台南,2023-06-20,9896
4968,立積,13,1,12,元大-台南,2023-06-20,9896
1522,堤維西,18,7,11,元大-台南,2023-06-20,9896
2890,永豐金,14,3,11,元大-台南,2023-06-20,9896
6147,頎邦,11,0,11,元大-台南,2023-06-20,9896
4536,拓凱,22,11,11,元大-台南,2023-06-20,9896
3056,富華新,14,3,11,元大-台南,2023-06-20,9896
5880,合庫金,10,0,10,元大-台南,2023-06-20,9896
4157,太景*-KY,10,0,10,元大-台南,2023-06-20,9896
3049,精金,304,11,293,元大-台南,2023-06-21,9896
2891,中信金,112,10,102,元大-台南,2023-06-21,9896
1522,堤維西,105,4,101,元大-台南,2023-06-21,9896
2323,中環,266,172,94,元大-台南,2023-06-21,9896
00882,中信中國高股息,76,0,76,元大-台南,2023-06-21,9896
6120,達運,69,27,42,元大-台南,2023-06-21,9896
2609,陽明,61,21,40,元大-台南,2023-06-21,9896
2603,長榮,53,15,38,元大-台南,2023-06-21,9896
5483,中美晶,42,5,37,元大-台南,2023-06-21,9896
2312,金寶,50,16,34,元大-台南,2023-06-21,9896
6477,安集,31,0,31,元大-台南,2023-06-21,9896
6116,彩晶,56,25,31,元大-台南,2023-06-21,9896
00670L,富邦NASDAQ正2,30,0,30,元大-台南,2023-06-21,9896
5258,虹堡,37,11,26,元大-台南,2023-06-21,9896
1471,首利,31,6,25,元大-台南,2023-06-21,9896
1101,台泥,26,1,25,元大-台南,2023-06-21,9896
3013,晟銘電,34,11,23,元大-台南,2023-06-21,9896
3558,神準,20,0,20,元大-台南,2023-06-21,9896
00738U,期元大道瓊白銀,19,0,19,元大-台南,2023-06-21,9896
00687B,國泰20年美債,23,4,19,元大-台南,2023-06-21,9896
3711,日月光投控,18,0,18,元大-台南,2023-06-21,9896
2605,新興,18,0,18,元大-台南,2023-06-21,9896
8277,商丞,18,0,18,元大-台南,2023-06-21,9896
6443,元晶,20,2,18,元大-台南,2023-06-21,9896
00679B,元大美債20年,30,13,17,元大-台南,2023-06-21,9896
5009,榮剛,22,6,16,元大-台南,2023-06-21,9896
3231,緯創,124,109,15,元大-台南,2023-06-21,9896
3287,廣寰科,26,11,15,元大-台南,2023-06-21,9896
2337,旺宏,21,6,15,元大-台南,2023-06-21,9896
2363,矽統,15,0,15,元大-台南,2023-06-21,9896
3264,欣銓,16,1,15,元大-台南,2023-06-21,9896
2515,中工,15,1,14,元大-台南,2023-06-21,9896
2405,輔信,36,23,13,元大-台南,2023-06-21,9896
00919,群益台灣精選高息,13,0,13,元大-台南,2023-06-21,9896
2748,雲品,45,32,13,元大-台南,2023-06-21,9896
2812,台中銀,12,0,12,元大-台南,2023-06-21,9896
6005,群益證,12,0,12,元大-台南,2023-06-21,9896
4916,事欣科,40,29,11,元大-台南,2023-06-21,9896
2352,佳世達,20,9,11,元大-台南,2023-06-21,9896
8105,凌巨,17,6,11,元大-台南,2023-06-21,9896
1409,新纖,11,0,11,元大-台南,2023-06-21,9896
9938,百和,12,2,10,元大-台南,2023-06-21,9896
6125,廣運,17,7,10,元大-台南,2023-06-21,9896
2356,英業達,61,51,10,元大-台南,2023-06-21,9896
1802,台玻,31,21,10,元大-台南,2023-06-21,9896
2913,農林,14,4,10,元大-台南,2023-06-21,9896
00753L,中信中國50正2,10,0,10,元大-台南,2023-06-21,9896
1711,永光,11,1,10,元大-台南,2023-06-21,9896
2701,萬企,10,0,10,元大-台南,2023-06-21,9896
1731,美吾華,10,0,10,元大-台南,2023-06-21,9896
00676R,富邦臺灣加權反1,311,31,280,元大-台南,2023-06-26,9896
3038,全台,264,25,239,元大-台南,2023-06-26,9896
8101,華冠,196,0,196,元大-台南,2023-06-26,9896
9912,偉聯,160,0,160,元大-台南,2023-06-26,9896
00642U,期元大S＆P石油,114,0,114,元大-台南,2023-06-26,9896
00715L,期街口布蘭特正2,81,1,80,元大-台南,2023-06-26,9896
2888,新光金,97,19,78,元大-台南,2023-06-26,9896
3032,偉訓,75,0,75,元大-台南,2023-06-26,9896
6282,康舒,76,23,53,元大-台南,2023-06-26,9896
1605,華新,58,5,53,元大-台南,2023-06-26,9896
00712,復華富時不動產,53,5,48,元大-台南,2023-06-26,9896
3711,日月光投控,52,15,37,元大-台南,2023-06-26,9896
00637L,元大滬深300正2,41,7,34,元大-台南,2023-06-26,9896
2801,彰銀,32,0,32,元大-台南,2023-06-26,9896
00882,中信中國高股息,56,25,31,元大-台南,2023-06-26,9896
2332,友訊,29,0,29,元大-台南,2023-06-26,9896
2457,飛宏,34,7,27,元大-台南,2023-06-26,9896
2449,京元電子,32,5,27,元大-台南,2023-06-26,9896
2887,台新金,26,1,25,元大-台南,2023-06-26,9896
2303,聯電,46,21,25,元大-台南,2023-06-26,9896
1504,東元,36,11,25,元大-台南,2023-06-26,9896
2344,華邦電,39,14,25,元大-台南,2023-06-26,9896
1802,台玻,76,51,25,元大-台南,2023-06-26,9896
2312,金寶,28,4,24,元大-台南,2023-06-26,9896
6120,達運,33,9,24,元大-台南,2023-06-26,9896
5905,南仁湖,32,10,22,元大-台南,2023-06-26,9896
00888,永豐台灣ESG,20,0,20,元大-台南,2023-06-26,9896
8072,陞泰,20,0,20,元大-台南,2023-06-26,9896
2340,台亞,54,34,20,元大-台南,2023-06-26,9896
2409,友達,27,8,19,元大-台南,2023-06-26,9896
2453,凌群,20,1,19,元大-台南,2023-06-26,9896
00706L,期元大S＆P日圓正2,19,0,19,元大-台南,2023-06-26,9896
3706,神達,31,14,17,元大-台南,2023-06-26,9896
1101,台泥,22,5,17,元大-台南,2023-06-26,9896
2201,裕隆,17,1,16,元大-台南,2023-06-26,9896
2883,凱基金,23,7,16,元大-台南,2023-06-26,9896
1513,中興電,25,9,16,元大-台南,2023-06-26,9896
2412,中華電,15,0,15,元大-台南,2023-06-26,9896
1611,中電,15,0,15,元大-台南,2023-06-26,9896
2002,中鋼,15,0,15,元大-台南,2023-06-26,9896
2702,華園,15,1,14,元大-台南,2023-06-26,9896
1337,再生-KY,14,0,14,元大-台南,2023-06-26,9896
0056,元大高股息,25,12,13,元大-台南,2023-06-26,9896
2308,台達電,18,5,13,元大-台南,2023-06-26,9896
00773B,中信優先金融債,11,0,11,元大-台南,2023-06-26,9896
6129,普誠,11,0,11,元大-台南,2023-06-26,9896
8446,華研,15,4,11,元大-台南,2023-06-26,9896
2211,長榮鋼,11,0,11,元大-台南,2023-06-26,9896
00919,群益台灣精選高息,14,4,10,元大-台南,2023-06-26,9896
00720B,元大投資級公司債,12,2,10,元大-台南,2023-06-26,9896
00632R,元大台灣50反1,401,198,203,元大-台南,2023-06-27,9896
3038,全台,287,132,155,元大-台南,2023-06-27,9896
3481,群創,196,46,150,元大-台南,2023-06-27,9896
5521,工信,120,0,120,元大-台南,2023-06-27,9896
2344,華邦電,121,4,117,元大-台南,2023-06-27,9896
2303,聯電,125,16,109,元大-台南,2023-06-27,9896
2610,華航,179,83,96,元大-台南,2023-06-27,9896
2891,中信金,84,0,84,元大-台南,2023-06-27,9896
2412,中華電,78,0,78,元大-台南,2023-06-27,9896
2409,友達,78,7,71,元大-台南,2023-06-27,9896
2618,長榮航,131,64,67,元大-台南,2023-06-27,9896
5880,合庫金,70,5,65,元大-台南,2023-06-27,9896
1605,華新,120,58,62,元大-台南,2023-06-27,9896
00642U,期元大S＆P石油,54,0,54,元大-台南,2023-06-27,9896
1609,大亞,76,31,45,元大-台南,2023-06-27,9896
00637L,元大滬深300正2,50,5,45,元大-台南,2023-06-27,9896
2323,中環,232,190,42,元大-台南,2023-06-27,9896
1441,大東,41,0,41,元大-台南,2023-06-27,9896
3231,緯創,75,34,41,元大-台南,2023-06-27,9896
8101,華冠,40,0,40,元大-台南,2023-06-27,9896
00929,復華台灣科技優息,37,0,37,元大-台南,2023-06-27,9896
6770,力積電,36,0,36,元大-台南,2023-06-27,9896
1301,台塑,38,6,32,元大-台南,2023-06-27,9896
4960,誠美材,31,0,31,元大-台南,2023-06-27,9896
00757,統一FANG+,31,3,28,元大-台南,2023-06-27,9896
2356,英業達,68,41,27,元大-台南,2023-06-27,9896
2515,中工,27,0,27,元大-台南,2023-06-27,9896
2371,大同,49,23,26,元大-台南,2023-06-27,9896
2888,新光金,33,8,25,元大-台南,2023-06-27,9896
3058,立德,24,0,24,元大-台南,2023-06-27,9896
1795,美時,31,9,22,元大-台南,2023-06-27,9896
1612,宏泰,21,0,21,元大-台南,2023-06-27,9896
6139,亞翔,20,0,20,元大-台南,2023-06-27,9896
00896,中信綠能及電動車,22,2,20,元大-台南,2023-06-27,9896
2363,矽統,20,0,20,元大-台南,2023-06-27,9896
6156,松上,76,56,20,元大-台南,2023-06-27,9896
00720B,元大投資級公司債,19,1,18,元大-台南,2023-06-27,9896
2340,台亞,26,10,16,元大-台南,2023-06-27,9896
4931,新盛力,15,0,15,元大-台南,2023-06-27,9896
4157,太景*-KY,14,0,14,元大-台南,2023-06-27,9896
00713,元大台灣高息低波,16,2,14,元大-台南,2023-06-27,9896
2428,興勤,18,5,13,元大-台南,2023-06-27,9896
3479,安勤,14,1,13,元大-台南,2023-06-27,9896
3706,神達,26,13,13,元大-台南,2023-06-27,9896
2884,玉山金,34,21,13,元大-台南,2023-06-27,9896
2883,凱基金,23,10,13,元大-台南,2023-06-27,9896
1734,杏輝,19,7,12,元大-台南,2023-06-27,9896
2611,志信,12,0,12,元大-台南,2023-06-27,9896
6841,長佳智能,11,0,11,元大-台南,2023-06-27,9896
1718,中纖,11,0,11,元大-台南,2023-06-27,9896
00715L,期街口布蘭特正2,358,0,358,元大-台南,2023-06-28,9896
3025,星通,187,27,160,元大-台南,2023-06-28,9896
00642U,期元大S＆P石油,143,0,143,元大-台南,2023-06-28,9896
4746,台耀,141,11,130,元大-台南,2023-06-28,9896
1605,華新,180,65,115,元大-台南,2023-06-28,9896
2906,高林,112,22,90,元大-台南,2023-06-28,9896
2010,春源,76,0,76,元大-台南,2023-06-28,9896
4157,太景*-KY,63,0,63,元大-台南,2023-06-28,9896
1467,南緯,62,0,62,元大-台南,2023-06-28,9896
1313,聯成,60,0,60,元大-台南,2023-06-28,9896
1444,力麗,70,14,56,元大-台南,2023-06-28,9896
2363,矽統,50,0,50,元大-台南,2023-06-28,9896
2537,聯上發,60,14,46,元大-台南,2023-06-28,9896
2357,華碩,45,0,45,元大-台南,2023-06-28,9896
3481,群創,50,14,36,元大-台南,2023-06-28,9896
1513,中興電,83,48,35,元大-台南,2023-06-28,9896
00706L,期元大S＆P日圓正2,35,0,35,元大-台南,2023-06-28,9896
00722B,群益投資級電信債,30,0,30,元大-台南,2023-06-28,9896
00712,復華富時不動產,33,6,27,元大-台南,2023-06-28,9896
2331,精英,50,25,25,元大-台南,2023-06-28,9896
4938,和碩,23,0,23,元大-台南,2023-06-28,9896
00878,國泰永續高股息,54,34,20,元大-台南,2023-06-28,9896
3049,精金,20,0,20,元大-台南,2023-06-28,9896
2344,華邦電,21,1,20,元大-台南,2023-06-28,9896
3032,偉訓,25,5,20,元大-台南,2023-06-28,9896
9958,世紀鋼,21,2,19,元大-台南,2023-06-28,9896
2913,農林,29,10,19,元大-台南,2023-06-28,9896
6191,精成科,30,11,19,元大-台南,2023-06-28,9896
2303,聯電,19,1,18,元大-台南,2023-06-28,9896
2382,廣達,36,18,18,元大-台南,2023-06-28,9896
4306,炎洲,18,0,18,元大-台南,2023-06-28,9896
2412,中華電,22,4,18,元大-台南,2023-06-28,9896
2892,第一金,17,0,17,元大-台南,2023-06-28,9896
2409,友達,21,5,16,元大-台南,2023-06-28,9896
3276,宇環,16,0,16,元大-台南,2023-06-28,9896
00900,富邦特選高股息30,15,0,15,元大-台南,2023-06-28,9896
2633,台灣高鐵,15,0,15,元大-台南,2023-06-28,9896
2353,宏��,24,10,14,元大-台南,2023-06-28,9896
00929,復華台灣科技優息,20,6,14,元大-台南,2023-06-28,9896
6113,亞矽,75,61,14,元大-台南,2023-06-28,9896
4121,優盛,17,3,14,元大-台南,2023-06-28,9896
8150,南茂,13,0,13,元大-台南,2023-06-28,9896
1802,台玻,18,5,13,元大-台南,2023-06-28,9896
6116,彩晶,15,2,13,元大-台南,2023-06-28,9896
1301,台塑,14,2,12,元大-台南,2023-06-28,9896
3078,僑威,22,10,12,元大-台南,2023-06-28,9896
2369,菱生,181,169,12,元大-台南,2023-06-28,9896
00679B,元大美債20年,16,4,12,元大-台南,2023-06-28,9896
6187,萬潤,15,4,11,元大-台南,2023-06-28,9896
1611,中電,11,0,11,元大-台南,2023-06-28,9896
2906,高林,253,0,253,元大-台南,2023-06-29,9896
2317,鴻海,117,19,98,元大-台南,2023-06-29,9896
2881,富邦金,101,12,89,元大-台南,2023-06-29,9896
2888,新光金,86,0,86,元大-台南,2023-06-29,9896
2419,仲琦,135,53,82,元大-台南,2023-06-29,9896
00712,復華富時不動產,72,11,61,元大-台南,2023-06-29,9896
00921,兆豐龍頭等權重,51,1,50,元大-台南,2023-06-29,9896
1795,美時,56,6,50,元大-台南,2023-06-29,9896
1802,台玻,50,2,48,元大-台南,2023-06-29,9896
1605,華新,53,7,46,元大-台南,2023-06-29,9896
2303,聯電,44,0,44,元大-台南,2023-06-29,9896
2506,太設,41,0,41,元大-台南,2023-06-29,9896
1447,力鵬,42,1,41,元大-台南,2023-06-29,9896
4121,優盛,44,4,40,元大-台南,2023-06-29,9896
00772B,中信高評級公司債,32,0,32,元大-台南,2023-06-29,9896
00900,富邦特選高股息30,34,3,31,元大-台南,2023-06-29,9896
00885,富邦越南,31,0,31,元大-台南,2023-06-29,9896
00919,群益台灣精選高息,27,1,26,元大-台南,2023-06-29,9896
00892,富邦台灣半導體,30,5,25,元大-台南,2023-06-29,9896
2618,長榮航,55,31,24,元大-台南,2023-06-29,9896
00882,中信中國高股息,24,0,24,元大-台南,2023-06-29,9896
00881,國泰台灣5G+,25,3,22,元大-台南,2023-06-29,9896
00652,富邦印度,20,0,20,元大-台南,2023-06-29,9896
2801,彰銀,20,0,20,元大-台南,2023-06-29,9896
8277,商丞,20,0,20,元大-台南,2023-06-29,9896
1316,上曜,20,0,20,元大-台南,2023-06-29,9896
00751B,元大AAA至A公司債,20,0,20,元大-台南,2023-06-29,9896
4526,東台,49,30,19,元大-台南,2023-06-29,9896
00753L,中信中國50正2,17,0,17,元大-台南,2023-06-29,9896
2884,玉山金,18,2,16,元大-台南,2023-06-29,9896
6589,台康生技,24,8,16,元大-台南,2023-06-29,9896
3447,展達,32,16,16,元大-台南,2023-06-29,9896
2409,友達,34,19,15,元大-台南,2023-06-29,9896
4414,如興,23,9,14,元大-台南,2023-06-29,9896
4157,太景*-KY,31,17,14,元大-台南,2023-06-29,9896
2882,國泰金,13,0,13,元大-台南,2023-06-29,9896
2883,凱基金,13,0,13,元大-台南,2023-06-29,9896
2327,國巨,13,0,13,元大-台南,2023-06-29,9896
1783,和康生,13,0,13,元大-台南,2023-06-29,9896
4763,材料-KY,21,8,13,元大-台南,2023-06-29,9896
2388,威盛,14,2,12,元大-台南,2023-06-29,9896
3038,全台,13,1,12,元大-台南,2023-06-29,9896
00878,國泰永續高股息,23,11,12,元大-台南,2023-06-29,9896
2449,京元電子,12,1,11,元大-台南,2023-06-29,9896
6806,森崴能源,16,5,11,元大-台南,2023-06-29,9896
6191,精成科,14,3,11,元大-台南,2023-06-29,9896
2331,精英,28,17,11,元大-台南,2023-06-29,9896
1609,大亞,21,10,11,元大-台南,2023-06-29,9896
3034,聯詠,12,1,11,元大-台南,2023-06-29,9896
2867,三商壽,11,0,11,元大-台南,2023-06-29,9896
00650L,復華香港正2,200,0,200,元大-台南,2023-06-30,9896
2344,華邦電,118,3,115,元大-台南,2023-06-30,9896
00680L,元大美債20正2,114,0,114,元大-台南,2023-06-30,9896
1605,華新,142,35,107,元大-台南,2023-06-30,9896
2618,長榮航,116,24,92,元大-台南,2023-06-30,9896
00632R,元大台灣50反1,100,18,82,元大-台南,2023-06-30,9896
2883,凱基金,80,1,79,元大-台南,2023-06-30,9896
6116,彩晶,62,1,61,元大-台南,2023-06-30,9896
8110,華東,61,0,61,元大-台南,2023-06-30,9896
3231,緯創,161,104,57,元大-台南,2023-06-30,9896
1101,台泥,58,4,54,元大-台南,2023-06-30,9896
00679B,元大美債20年,41,0,41,元大-台南,2023-06-30,9896
2885,元大金,37,0,37,元大-台南,2023-06-30,9896
2323,中環,61,25,36,元大-台南,2023-06-30,9896
3017,奇鋐,64,31,33,元大-台南,2023-06-30,9896
5483,中美晶,30,1,29,元大-台南,2023-06-30,9896
00885,富邦越南,35,7,28,元大-台南,2023-06-30,9896
2365,昆盈,32,5,27,元大-台南,2023-06-30,9896
2603,長榮,82,56,26,元大-台南,2023-06-30,9896
00706L,期元大S＆P日圓正2,26,0,26,元大-台南,2023-06-30,9896
4123,晟德,25,0,25,元大-台南,2023-06-30,9896
00919,群益台灣精選高息,30,6,24,元大-台南,2023-06-30,9896
2609,陽明,87,64,23,元大-台南,2023-06-30,9896
00720B,元大投資級公司債,23,0,23,元大-台南,2023-06-30,9896
00751B,元大AAA至A公司債,22,0,22,元大-台南,2023-06-30,9896
3481,群創,62,40,22,元大-台南,2023-06-30,9896
3045,台灣大,22,0,22,元大-台南,2023-06-30,9896
2845,遠東銀,22,0,22,元大-台南,2023-06-30,9896
2812,台中銀,30,9,21,元大-台南,2023-06-30,9896
1802,台玻,21,0,21,元大-台南,2023-06-30,9896
2317,鴻海,35,15,20,元大-台南,2023-06-30,9896
1440,南紡,30,10,20,元大-台南,2023-06-30,9896
2010,春源,20,0,20,元大-台南,2023-06-30,9896
1417,嘉裕,20,0,20,元大-台南,2023-06-30,9896
2303,聯電,25,7,18,元大-台南,2023-06-30,9896
1609,大亞,55,37,18,元大-台南,2023-06-30,9896
00712,復華富時不動產,38,20,18,元大-台南,2023-06-30,9896
6443,元晶,17,0,17,元大-台南,2023-06-30,9896
4967,十銓,16,0,16,元大-台南,2023-06-30,9896
3276,宇環,16,0,16,元大-台南,2023-06-30,9896
5864,致和證,18,2,16,元大-台南,2023-06-30,9896
2408,南亞科,17,1,16,元大-台南,2023-06-30,9896
00673R,期元大S＆P原油反1,15,0,15,元大-台南,2023-06-30,9896
2329,華泰,16,1,15,元大-台南,2023-06-30,9896
2882,國泰金,15,0,15,元大-台南,2023-06-30,9896
00687B,國泰20年美債,14,0,14,元大-台南,2023-06-30,9896
6806,森崴能源,36,22,14,元大-台南,2023-06-30,9896
00900,富邦特選高股息30,16,3,13,元大-台南,2023-06-30,9896
1504,東元,20,8,12,元大-台南,2023-06-30,9896
2412,中華電,12,0,12,元大-台南,2023-06-30,9896
0056,元大高股息,279,54,225,元大-台南,2023-07-03,9896
00632R,元大台灣50反1,163,25,138,元大-台南,2023-07-03,9896
8110,華東,120,1,119,元大-台南,2023-07-03,9896
2382,廣達,120,13,107,元大-台南,2023-07-03,9896
5285,界霖,101,0,101,元大-台南,2023-07-03,9896
1609,大亞,126,41,85,元大-台南,2023-07-03,9896
3231,緯創,126,58,68,元大-台南,2023-07-03,9896
1217,愛之味,67,2,65,元大-台南,2023-07-03,9896
5269,祥碩,57,0,57,元大-台南,2023-07-03,9896
8210,勤誠,50,1,49,元大-台南,2023-07-03,9896
3017,奇鋐,195,149,46,元大-台南,2023-07-03,9896
2906,高林,44,1,43,元大-台南,2023-07-03,9896
3706,神達,44,6,38,元大-台南,2023-07-03,9896
00712,復華富時不動產,44,8,36,元大-台南,2023-07-03,9896
8936,國統,43,10,33,元大-台南,2023-07-03,9896
00673R,期元大S＆P原油反1,31,0,31,元大-台南,2023-07-03,9896
2615,萬海,60,34,26,元大-台南,2023-07-03,9896
3481,群創,47,23,24,元大-台南,2023-07-03,9896
2412,中華電,21,0,21,元大-台南,2023-07-03,9896
2303,聯電,24,3,21,元大-台南,2023-07-03,9896
1336,台翰,20,0,20,元大-台南,2023-07-03,9896
3308,聯德,21,1,20,元大-台南,2023-07-03,9896
3715,定穎投控,20,0,20,元大-台南,2023-07-03,9896
5609,中菲行,22,5,17,元大-台南,2023-07-03,9896
020038,元大ESG配息N,15,0,15,元大-台南,2023-07-03,9896
2402,毅嘉,35,20,15,元大-台南,2023-07-03,9896
6438,迅得,16,2,14,元大-台南,2023-07-03,9896
8150,南茂,76,64,12,元大-台南,2023-07-03,9896
6441,廣錠,12,0,12,元大-台南,2023-07-03,9896
6829,千附精密,12,0,12,元大-台南,2023-07-03,9896
2885,元大金,14,3,11,元大-台南,2023-07-03,9896
8358,金居,37,26,11,元大-台南,2023-07-03,9896
5347,世界,12,1,11,元大-台南,2023-07-03,9896
9939,宏全,10,0,10,元大-台南,2023-07-03,9896
00652,富邦印度,10,0,10,元大-台南,2023-07-03,9896
4130,健亞,10,0,10,元大-台南,2023-07-03,9896
4111,濟生,10,0,10,元大-台南,2023-07-03,9896
2387,精元,10,0,10,元大-台南,2023-07-03,9896
2605,新興,10,0,10,元大-台南,2023-07-03,9896
00664R,國泰臺灣加權反1,10,0,10,元大-台南,2023-07-03,9896
1565,精華,10,0,10,元大-台南,2023-07-03,9896
6153,嘉聯益,10,0,10,元大-台南,2023-07-03,9896
00653L,富邦印度正2,10,0,10,元大-台南,2023-07-03,9896
00640L,富邦日本正2,10,0,10,元大-台南,2023-07-03,9896
8016,矽創,15,5,10,元大-台南,2023-07-03,9896
2014,中鴻,12,3,9,元大-台南,2023-07-03,9896
3045,台灣大,9,0,9,元大-台南,2023-07-03,9896
3380,明泰,10,1,9,元大-台南,2023-07-03,9896
1802,台玻,10,1,9,元大-台南,2023-07-03,9896
6016,康和證,9,0,9,元大-台南,2023-07-03,9896
8050,廣積,80,3,77,元大-台南,2023-07-04,9896
1905,華紙,139,68,71,元大-台南,2023-07-04,9896
2609,陽明,116,45,71,元大-台南,2023-07-04,9896
2317,鴻海,71,4,67,元大-台南,2023-07-04,9896
6188,廣明,205,142,63,元大-台南,2023-07-04,9896
3583,辛耘,81,20,61,元大-台南,2023-07-04,9896
2755,揚秦,60,0,60,元大-台南,2023-07-04,9896
1513,中興電,62,9,53,元大-台南,2023-07-04,9896
6112,邁達特,63,12,51,元大-台南,2023-07-04,9896
00929,復華台灣科技優息,52,7,45,元大-台南,2023-07-04,9896
1609,大亞,71,31,40,元大-台南,2023-07-04,9896
2344,華邦電,40,2,38,元大-台南,2023-07-04,9896
00664R,國泰臺灣加權反1,37,0,37,元大-台南,2023-07-04,9896
3652,精聯,41,4,37,元大-台南,2023-07-04,9896
2883,凱基金,76,40,36,元大-台南,2023-07-04,9896
3706,神達,56,23,33,元大-台南,2023-07-04,9896
6266,泰詠,32,0,32,元大-台南,2023-07-04,9896
00715L,期街口布蘭特正2,65,34,31,元大-台南,2023-07-04,9896
8110,華東,30,1,29,元大-台南,2023-07-04,9896
2208,台船,30,1,29,元大-台南,2023-07-04,9896
6122,擎邦,30,1,29,元大-台南,2023-07-04,9896
9907,統一實,28,0,28,元大-台南,2023-07-04,9896
00722B,群益投資級電信債,25,0,25,元大-台南,2023-07-04,9896
2412,中華電,25,0,25,元大-台南,2023-07-04,9896
8112,至上,27,3,24,元大-台南,2023-07-04,9896
00888,永豐台灣ESG,24,0,24,元大-台南,2023-07-04,9896
2312,金寶,45,22,23,元大-台南,2023-07-04,9896
6285,啟��,31,10,21,元大-台南,2023-07-04,9896
6509,聚和,20,0,20,元大-台南,2023-07-04,9896
3308,聯德,20,0,20,元大-台南,2023-07-04,9896
1710,東聯,30,10,20,元大-台南,2023-07-04,9896
2444,兆勁,20,0,20,元大-台南,2023-07-04,9896
2327,國巨,20,0,20,元大-台南,2023-07-04,9896
2340,台亞,32,15,17,元大-台南,2023-07-04,9896
00712,復華富時不動產,35,18,17,元大-台南,2023-07-04,9896
2731,雄獅,17,1,16,元大-台南,2023-07-04,9896
3013,晟銘電,37,21,16,元大-台南,2023-07-04,9896
8446,華研,16,1,15,元大-台南,2023-07-04,9896
00902,中信電池及儲能,17,2,15,元大-台南,2023-07-04,9896
2897,王道銀行,15,0,15,元大-台南,2023-07-04,9896
2891,中信金,17,3,14,元大-台南,2023-07-04,9896
5880,合庫金,20,6,14,元大-台南,2023-07-04,9896
2634,漢翔,17,3,14,元大-台南,2023-07-04,9896
2885,元大金,14,1,13,元大-台南,2023-07-04,9896
8016,矽創,15,2,13,元大-台南,2023-07-04,9896
6203,海韻電,14,1,13,元大-台南,2023-07-04,9896
8411,福貞-KY,13,0,13,元大-台南,2023-07-04,9896
00751B,元大AAA至A公司債,12,0,12,元大-台南,2023-07-04,9896
2482,連宇,15,3,12,元大-台南,2023-07-04,9896
2425,承啟,12,0,12,元大-台南,2023-07-04,9896
6282,康舒,400,77,323,元大-台南,2023-07-05,9896
2890,永豐金,153,0,153,元大-台南,2023-07-05,9896
00929,復華台灣科技優息,122,2,120,元大-台南,2023-07-05,9896
8110,華東,105,0,105,元大-台南,2023-07-05,9896
2356,英業達,120,43,77,元大-台南,2023-07-05,9896
4414,如興,94,20,74,元大-台南,2023-07-05,9896
1522,堤維西,68,2,66,元大-台南,2023-07-05,9896
3231,緯創,112,59,53,元大-台南,2023-07-05,9896
2891,中信金,52,0,52,元大-台南,2023-07-05,9896
2413,環科,51,0,51,元大-台南,2023-07-05,9896
2609,陽明,158,108,50,元大-台南,2023-07-05,9896
4116,明基醫,50,0,50,元大-台南,2023-07-05,9896
5309,系統電,49,0,49,元大-台南,2023-07-05,9896
2369,菱生,50,3,47,元大-台南,2023-07-05,9896
6156,松上,109,66,43,元大-台南,2023-07-05,9896
3011,今皓,42,0,42,元大-台南,2023-07-05,9896
00673R,期元大S＆P原油反1,42,0,42,元大-台南,2023-07-05,9896
6770,力積電,40,0,40,元大-台南,2023-07-05,9896
2883,凱基金,54,16,38,元大-台南,2023-07-05,9896
2618,長榮航,328,293,35,元大-台南,2023-07-05,9896
00922,國泰台灣領袖50,34,0,34,元大-台南,2023-07-05,9896
2317,鴻海,49,16,33,元大-台南,2023-07-05,9896
2352,佳世達,34,2,32,元大-台南,2023-07-05,9896
2409,友達,33,2,31,元大-台南,2023-07-05,9896
1101,台泥,31,1,30,元大-台南,2023-07-05,9896
2929,淘帝-KY,30,0,30,元大-台南,2023-07-05,9896
1611,中電,65,36,29,元大-台南,2023-07-05,9896
6190,萬泰科,29,1,28,元大-台南,2023-07-05,9896
4967,十銓,30,3,27,元大-台南,2023-07-05,9896
6125,廣運,26,0,26,元大-台南,2023-07-05,9896
4979,華星光,30,5,25,元大-台南,2023-07-05,9896
5328,華容,100,78,22,元大-台南,2023-07-05,9896
2734,易飛網,22,0,22,元大-台南,2023-07-05,9896
2915,潤泰全,21,0,21,元大-台南,2023-07-05,9896
6550,北極星藥業-KY,22,1,21,元大-台南,2023-07-05,9896
8112,至上,21,0,21,元大-台南,2023-07-05,9896
2419,仲琦,28,8,20,元大-台南,2023-07-05,9896
2888,新光金,20,1,19,元大-台南,2023-07-05,9896
3105,穩懋,19,1,18,元大-台南,2023-07-05,9896
8358,金居,21,3,18,元大-台南,2023-07-05,9896
2610,華航,53,35,18,元大-台南,2023-07-05,9896
2382,廣達,35,18,17,元大-台南,2023-07-05,9896
00679B,元大美債20年,17,0,17,元大-台南,2023-07-05,9896
6112,邁達特,31,14,17,元大-台南,2023-07-05,9896
2405,輔信,23,7,16,元大-台南,2023-07-05,9896
8222,寶一,16,0,16,元大-台南,2023-07-05,9896
2755,揚秦,15,0,15,元大-台南,2023-07-05,9896
3325,旭品,16,1,15,元大-台南,2023-07-05,9896
00927,群益半導體收益,15,0,15,元大-台南,2023-07-05,9896
2330,台積電,21,6,15,元大-台南,2023-07-05,9896
00673R,期元大S＆P原油反1,297,0,297,元大-台南,2023-07-06,9896
3231,緯創,251,100,151,元大-台南,2023-07-06,9896
2892,第一金,132,1,131,元大-台南,2023-07-06,9896
2881,富邦金,143,20,123,元大-台南,2023-07-06,9896
2906,高林,101,0,101,元大-台南,2023-07-06,9896
00680L,元大美債20正2,91,0,91,元大-台南,2023-07-06,9896
5880,合庫金,90,0,90,元大-台南,2023-07-06,9896
00882,中信中國高股息,78,3,75,元大-台南,2023-07-06,9896
00687B,國泰20年美債,76,5,71,元大-台南,2023-07-06,9896
2610,華航,67,0,67,元大-台南,2023-07-06,9896
2883,凱基金,75,14,61,元大-台南,2023-07-06,9896
6156,松上,116,60,56,元大-台南,2023-07-06,9896
00712,復華富時不動產,95,43,52,元大-台南,2023-07-06,9896
00929,復華台灣科技優息,52,1,51,元大-台南,2023-07-06,9896
00720B,元大投資級公司債,43,0,43,元大-台南,2023-07-06,9896
1718,中纖,43,2,41,元大-台南,2023-07-06,9896
4414,如興,41,0,41,元大-台南,2023-07-06,9896
1319,東陽,40,0,40,元大-台南,2023-07-06,9896
2891,中信金,45,8,37,元大-台南,2023-07-06,9896
3105,穩懋,46,9,37,元大-台南,2023-07-06,9896
2885,元大金,36,0,36,元大-台南,2023-07-06,9896
00751B,元大AAA至A公司債,37,1,36,元大-台南,2023-07-06,9896
3037,欣興,39,3,36,元大-台南,2023-07-06,9896
2887,台新金,37,2,35,元大-台南,2023-07-06,9896
2882,國泰金,33,1,32,元大-台南,2023-07-06,9896
2402,毅嘉,56,28,28,元大-台南,2023-07-06,9896
2002,中鋼,52,25,27,元大-台南,2023-07-06,9896
9907,統一實,26,0,26,元大-台南,2023-07-06,9896
3071,協禧,36,10,26,元大-台南,2023-07-06,9896
1301,台塑,27,1,26,元大-台南,2023-07-06,9896
6770,力積電,25,0,25,元大-台南,2023-07-06,9896
2888,新光金,27,3,24,元大-台南,2023-07-06,9896
2330,台積電,28,3,25,元大-台南,2023-07-06,9896
6116,彩晶,54,30,24,元大-台南,2023-07-06,9896
1611,中電,32,8,24,元大-台南,2023-07-06,9896
00675L,富邦臺灣加權正2,23,0,23,元大-台南,2023-07-06,9896
4908,前鼎,26,3,23,元大-台南,2023-07-06,9896
2014,中鴻,23,0,23,元大-台南,2023-07-06,9896
5009,榮剛,26,4,22,元大-台南,2023-07-06,9896
00688L,國泰20年美債正2,22,0,22,元大-台南,2023-07-06,9896
3703,欣陸,20,0,20,元大-台南,2023-07-06,9896
2633,台灣高鐵,21,1,20,元大-台南,2023-07-06,9896
6226,光鼎,20,0,20,元大-台南,2023-07-06,9896
00679B,元大美債20年,21,1,20,元大-台南,2023-07-06,9896
2356,英業達,86,66,20,元大-台南,2023-07-06,9896
2801,彰銀,20,0,20,元大-台南,2023-07-06,9896
2884,玉山金,19,0,19,元大-台南,2023-07-06,9896
6416,瑞祺電通,19,0,19,元大-台南,2023-07-06,9896
2812,台中銀,19,0,19,元大-台南,2023-07-06,9896
3362,先進光,24,7,17,元大-台南,2023-07-06,9896
00929,復華台灣科技優息,128,0,128,元大-台南,2023-07-07,9896
00679B,元大美債20年,75,0,75,元大-台南,2023-07-07,9896
00687B,國泰20年美債,74,0,74,元大-台南,2023-07-07,9896
2603,長榮,95,21,74,元大-台南,2023-07-07,9896
00680L,元大美債20正2,63,0,63,元大-台南,2023-07-07,9896
00673R,期元大S＆P原油反1,57,0,57,元大-台南,2023-07-07,9896
1710,東聯,54,0,54,元大-台南,2023-07-07,9896
5328,華容,209,158,51,元大-台南,2023-07-07,9896
2888,新光金,68,21,47,元大-台南,2023-07-07,9896
3006,晶豪科,48,5,43,元大-台南,2023-07-07,9896
00882,中信中國高股息,41,0,41,元大-台南,2023-07-07,9896
6116,彩晶,45,6,39,元大-台南,2023-07-07,9896
2344,華邦電,46,7,39,元大-台南,2023-07-07,9896
2105,正新,50,11,39,元大-台南,2023-07-07,9896
8064,東捷,37,0,37,元大-台南,2023-07-07,9896
2887,台新金,45,9,36,元大-台南,2023-07-07,9896
00878,國泰永續高股息,75,40,35,元大-台南,2023-07-07,9896
00720B,元大投資級公司債,36,7,29,元大-台南,2023-07-07,9896
2892,第一金,29,1,28,元大-台南,2023-07-07,9896
2883,凱基金,28,2,26,元大-台南,2023-07-07,9896
00885,富邦越南,27,1,26,元大-台南,2023-07-07,9896
2324,仁寶,28,3,25,元大-台南,2023-07-07,9896
2468,華經,30,5,25,元大-台南,2023-07-07,9896
1301,台塑,25,0,25,元大-台南,2023-07-07,9896
5009,榮剛,25,1,24,元大-台南,2023-07-07,9896
1513,中興電,25,2,23,元大-台南,2023-07-07,9896
6669,緯穎,26,3,23,元大-台南,2023-07-07,9896
2880,華南金,23,0,23,元大-台南,2023-07-07,9896
5864,致和證,22,0,22,元大-台南,2023-07-07,9896
1701,中化,21,0,21,元大-台南,2023-07-07,9896
1718,中纖,22,1,21,元大-台南,2023-07-07,9896
8277,商丞,20,0,20,元大-台南,2023-07-07,9896
0056,元大高股息,83,63,20,元大-台南,2023-07-07,9896
3481,群創,33,13,20,元大-台南,2023-07-07,9896
3234,光環,20,2,18,元大-台南,2023-07-07,9896
1101,台泥,27,10,17,元大-台南,2023-07-07,9896
2340,台亞,39,22,17,元大-台南,2023-07-07,9896
00675L,富邦臺灣加權正2,17,0,17,元大-台南,2023-07-07,9896
4968,立積,24,7,17,元大-台南,2023-07-07,9896
3011,今皓,18,1,17,元大-台南,2023-07-07,9896
6477,安集,16,0,16,元大-台南,2023-07-07,9896
5457,宣德,15,0,15,元大-台南,2023-07-07,9896
6125,廣運,22,7,15,元大-台南,2023-07-07,9896
8358,金居,15,1,14,元大-台南,2023-07-07,9896
3163,波若威,27,13,14,元大-台南,2023-07-07,9896
6117,迎廣,14,0,14,元大-台南,2023-07-07,9896
3652,精聯,19,5,14,元大-台南,2023-07-07,9896
9919,康那香,15,1,14,元大-台南,2023-07-07,9896
00751B,元大AAA至A公司債,20,6,14,元大-台南,2023-07-07,9896
2412,中華電,13,0,13,元大-台南,2023-07-07,9896
00673R,期元大S＆P原油反1,267,0,267,元大-台南,2023-07-10,9896
00679B,元大美債20年,83,0,83,元大-台南,2023-07-10,9896
2105,正新,59,4,55,元大-台南,2023-07-10,9896
5512,力麒,136,88,48,元大-台南,2023-07-10,9896
8086,宏捷科,53,9,44,元大-台南,2023-07-10,9896
2444,兆勁,43,0,43,元大-台南,2023-07-10,9896
2489,瑞軒,55,16,39,元大-台南,2023-07-10,9896
00882,中信中國高股息,39,1,38,元大-台南,2023-07-10,9896
00680L,元大美債20正2,38,1,37,元大-台南,2023-07-10,9896
1611,中電,38,1,37,元大-台南,2023-07-10,9896
1609,大亞,153,116,37,元大-台南,2023-07-10,9896
00687B,國泰20年美債,34,0,34,元大-台南,2023-07-10,9896
8038,長園科,35,1,34,元大-台南,2023-07-10,9896
2618,長榮航,37,5,32,元大-台南,2023-07-10,9896
2812,台中銀,32,2,30,元大-台南,2023-07-10,9896
00751B,元大AAA至A公司債,29,3,26,元大-台南,2023-07-10,9896
1440,南紡,25,0,25,元大-台南,2023-07-10,9896
2883,凱基金,30,6,24,元大-台南,2023-07-10,9896
00720B,元大投資級公司債,23,0,23,元大-台南,2023-07-10,9896
8064,東捷,23,0,23,元大-台南,2023-07-10,9896
6770,力積電,28,5,23,元大-台南,2023-07-10,9896
1402,遠東新,22,0,22,元大-台南,2023-07-10,9896
4746,台耀,34,12,22,元大-台南,2023-07-10,9896
2884,玉山金,25,3,22,元大-台南,2023-07-10,9896
2887,台新金,30,9,21,元大-台南,2023-07-10,9896
2605,新興,20,0,20,元大-台南,2023-07-10,9896
6443,元晶,21,1,20,元大-台南,2023-07-10,9896
00929,復華台灣科技優息,28,8,20,元大-台南,2023-07-10,9896
2457,飛宏,19,1,18,元大-台南,2023-07-10,9896
2606,裕民,17,0,17,元大-台南,2023-07-10,9896
3357,臺慶科,17,0,17,元大-台南,2023-07-10,9896
2881,富邦金,17,1,16,元大-台南,2023-07-10,9896
3481,群創,19,3,16,元大-台南,2023-07-10,9896
3305,昇貿,29,13,16,元大-台南,2023-07-10,9896
2303,聯電,16,0,16,元大-台南,2023-07-10,9896
1301,台塑,20,5,15,元大-台南,2023-07-10,9896
9958,世紀鋼,16,1,15,元大-台南,2023-07-10,9896
2409,友達,20,6,14,元大-台南,2023-07-10,9896
5880,合庫金,14,0,14,元大-台南,2023-07-10,9896
1319,東陽,14,0,14,元大-台南,2023-07-10,9896
4123,晟德,16,2,14,元大-台南,2023-07-10,9896
2412,中華電,13,0,13,元大-台南,2023-07-10,9896
00927,群益半導體收益,13,0,13,元大-台南,2023-07-10,9896
1514,亞力,18,6,12,元大-台南,2023-07-10,9896
1471,首利,18,6,12,元大-台南,2023-07-10,9896
2486,一詮,25,13,12,元大-台南,2023-07-10,9896
6416,瑞祺電通,11,0,11,元大-台南,2023-07-10,9896
6411,晶焱,11,0,11,元大-台南,2023-07-10,9896
2610,華航,21,10,11,元大-台南,2023-07-10,9896
3013,晟銘電,11,0,11,元大-台南,2023-07-10,9896
00632R,元大台灣50反1,430,9,421,元大-台南,2023-07-11,9896
2883,凱基金,220,7,213,元大-台南,2023-07-11,9896
6156,松上,221,71,150,元大-台南,2023-07-11,9896
1522,堤維西,130,11,119,元大-台南,2023-07-11,9896
1504,東元,106,3,103,元大-台南,2023-07-11,9896
1609,大亞,200,100,100,元大-台南,2023-07-11,9896
2444,兆勁,81,0,81,元大-台南,2023-07-11,9896
00665L,富邦�琤肭磪囓�2,110,30,80,元大-台南,2023-07-11,9896
3017,奇鋐,103,32,71,元大-台南,2023-07-11,9896
3481,群創,144,89,55,元大-台南,2023-07-11,9896
2884,玉山金,48,0,48,元大-台南,2023-07-11,9896
2881,富邦金,60,13,47,元大-台南,2023-07-11,9896
00673R,期元大S＆P原油反1,34,0,34,元大-台南,2023-07-11,9896
4532,瑞智,49,17,32,元大-台南,2023-07-11,9896
2369,菱生,36,6,30,元大-台南,2023-07-11,9896
2511,太子,30,0,30,元大-台南,2023-07-11,9896
5009,榮剛,29,0,29,元大-台南,2023-07-11,9896
2415,錩新,31,2,29,元大-台南,2023-07-11,9896
8064,東捷,27,0,27,元大-台南,2023-07-11,9896
2609,陽明,35,10,25,元大-台南,2023-07-11,9896
3231,緯創,106,81,25,元大-台南,2023-07-11,9896
3016,嘉晶,29,5,24,元大-台南,2023-07-11,9896
2382,廣達,59,35,24,元大-台南,2023-07-11,9896
1515,力山,26,2,24,元大-台南,2023-07-11,9896
2303,聯電,25,1,24,元大-台南,2023-07-11,9896
2328,廣宇,23,2,21,元大-台南,2023-07-11,9896
4510,高鋒,21,1,20,元大-台南,2023-07-11,9896
00653L,富邦印度正2,20,0,20,元大-台南,2023-07-11,9896
3141,晶宏,21,1,20,元大-台南,2023-07-11,9896
3058,立德,26,8,18,元大-台南,2023-07-11,9896
6285,啟��,38,20,18,元大-台南,2023-07-11,9896
3707,漢磊,23,6,17,元大-台南,2023-07-11,9896
2457,飛宏,26,10,16,元大-台南,2023-07-11,9896
6282,康舒,36,20,16,元大-台南,2023-07-11,9896
4527,方土霖,15,0,15,元大-台南,2023-07-11,9896
2401,凌陽,14,0,14,元大-台南,2023-07-11,9896
2402,毅嘉,21,7,14,元大-台南,2023-07-11,9896
3052,夆典,42,29,13,元大-台南,2023-07-11,9896
2913,農林,13,0,13,元大-台南,2023-07-11,9896
1503,士電,21,8,13,元大-台南,2023-07-11,9896
1618,合機,27,14,13,元大-台南,2023-07-11,9896
6288,聯嘉,28,15,13,元大-台南,2023-07-11,9896
1301,台塑,12,0,12,元大-台南,2023-07-11,9896
5443,均豪,12,0,12,元大-台南,2023-07-11,9896
00885,富邦越南,17,5,12,元大-台南,2023-07-11,9896
8930,青鋼,13,1,12,元大-台南,2023-07-11,9896
3356,奇偶,13,1,12,元大-台南,2023-07-11,9896
1513,中興電,19,7,12,元大-台南,2023-07-11,9896
00720B,元大投資級公司債,14,2,12,元大-台南,2023-07-11,9896
3346,麗清,18,7,11,元大-台南,2023-07-11,9896
2888,新光金,420,0,420,元大-台南,2023-07-12,9896
00673R,期元大S＆P原油反1,312,2,310,元大-台南,2023-07-12,9896
6806,森崴能源,213,1,212,元大-台南,2023-07-12,9896
2301,光寶科,118,24,94,元大-台南,2023-07-12,9896
2105,正新,62,0,62,元大-台南,2023-07-12,9896
2409,友達,73,12,61,元大-台南,2023-07-12,9896
2303,聯電,62,7,55,元大-台南,2023-07-12,9896
00722B,群益投資級電信債,55,1,54,元大-台南,2023-07-12,9896
6120,達運,68,14,54,元大-台南,2023-07-12,9896
1440,南紡,47,0,47,元大-台南,2023-07-12,9896
6266,泰詠,40,0,40,元大-台南,2023-07-12,9896
2014,中鴻,40,1,39,元大-台南,2023-07-12,9896
2481,強茂,52,13,39,元大-台南,2023-07-12,9896
2401,凌陽,45,9,36,元大-台南,2023-07-12,9896
2609,陽明,76,42,34,元大-台南,2023-07-12,9896
2356,英業達,140,106,34,元大-台南,2023-07-12,9896
3025,星通,44,11,33,元大-台南,2023-07-12,9896
5483,中美晶,70,39,31,元大-台南,2023-07-12,9896
00679B,元大美債20年,36,5,31,元大-台南,2023-07-12,9896
00885,富邦越南,30,0,30,元大-台南,2023-07-12,9896
2323,中環,45,15,30,元大-台南,2023-07-12,9896
2436,偉詮電,35,7,28,元大-台南,2023-07-12,9896
2867,三商壽,29,2,27,元大-台南,2023-07-12,9896
2002,中鋼,26,0,26,元大-台南,2023-07-12,9896
2419,仲琦,30,5,25,元大-台南,2023-07-12,9896
2834,臺企銀,24,0,24,元大-台南,2023-07-12,9896
2464,盟立,23,0,23,元大-台南,2023-07-12,9896
1513,中興電,46,24,22,元大-台南,2023-07-12,9896
8070,長華*,34,12,22,元大-台南,2023-07-12,9896
4968,立積,23,1,22,元大-台南,2023-07-12,9896
3576,聯合再生,21,0,21,元大-台南,2023-07-12,9896
8383,千附,21,0,21,元大-台南,2023-07-12,9896
2412,中華電,20,0,20,元大-台南,2023-07-12,9896
8411,福貞-KY,20,0,20,元大-台南,2023-07-12,9896
3704,合勤控,26,7,19,元大-台南,2023-07-12,9896
8936,國統,22,3,19,元大-台南,2023-07-12,9896
6140,訊達,18,1,17,元大-台南,2023-07-12,9896
1810,和成,17,0,17,元大-台南,2023-07-12,9896
2515,中工,16,0,16,元大-台南,2023-07-12,9896
3276,宇環,15,0,15,元大-台南,2023-07-12,9896
00905,FT臺灣Smart,17,2,15,元大-台南,2023-07-12,9896
6156,松上,150,136,14,元大-台南,2023-07-12,9896
1529,樂事綠能,16,2,14,元大-台南,2023-07-12,9896
6285,啟��,34,20,14,元大-台南,2023-07-12,9896
3037,欣興,18,5,13,元大-台南,2023-07-12,9896
3236,千如,13,0,13,元大-台南,2023-07-12,9896
5371,中光電,20,7,13,元大-台南,2023-07-12,9896
020038,元大ESG配息N,12,0,12,元大-台南,2023-07-12,9896
2605,新興,12,0,12,元大-台南,2023-07-12,9896
3058,立德,12,0,12,元大-台南,2023-07-12,9896
00673R,期元大S＆P原油反1,271,72,199,元大-台南,2023-07-13,9896
00637L,元大滬深300正2,200,41,159,元大-台南,2023-07-13,9896
00632R,元大台灣50反1,307,176,131,元大-台南,2023-07-13,9896
2906,高林,120,0,120,元大-台南,2023-07-13,9896
1102,亞泥,100,17,83,元大-台南,2023-07-13,9896
4533,協易機,101,33,68,元大-台南,2023-07-13,9896
2323,中環,77,11,66,元大-台南,2023-07-13,9896
2412,中華電,50,0,50,元大-台南,2023-07-13,9896
2399,映泰,53,3,50,元大-台南,2023-07-13,9896
5512,力麒,226,178,48,元大-台南,2023-07-13,9896
00664R,國泰臺灣加權反1,47,0,47,元大-台南,2023-07-13,9896
2609,陽明,71,24,47,元大-台南,2023-07-13,9896
1609,大亞,173,128,45,元大-台南,2023-07-13,9896
5439,高技,67,26,41,元大-台南,2023-07-13,9896
00930,永豐ESG低碳高息,39,0,39,元大-台南,2023-07-13,9896
00929,復華台灣科技優息,44,5,39,元大-台南,2023-07-13,9896
3481,群創,63,26,37,元大-台南,2023-07-13,9896
6188,廣明,89,53,36,元大-台南,2023-07-13,9896
6282,康舒,45,10,35,元大-台南,2023-07-13,9896
2303,聯電,43,10,33,元大-台南,2023-07-13,9896
2603,長榮,63,31,32,元大-台南,2023-07-13,9896
00907,永豐優息存股,30,0,30,元大-台南,2023-07-13,9896
2105,正新,28,0,28,元大-台南,2023-07-13,9896
3673,TPK-KY,24,0,24,元大-台南,2023-07-13,9896
1722,台肥,24,0,24,元大-台南,2023-07-13,9896
00687B,國泰20年美債,22,0,22,元大-台南,2023-07-13,9896
2369,菱生,28,6,22,元大-台南,2023-07-13,9896
2881,富邦金,26,5,21,元大-台南,2023-07-13,9896
4142,國光生,21,0,21,元大-台南,2023-07-13,9896
00905,FT臺灣Smart,22,2,20,元大-台南,2023-07-13,9896
1795,美時,20,1,19,元大-台南,2023-07-13,9896
2340,台亞,21,2,19,元大-台南,2023-07-13,9896
00751B,元大AAA至A公司債,18,0,18,元大-台南,2023-07-13,9896
5905,南仁湖,41,23,18,元大-台南,2023-07-13,9896
2605,新興,20,2,18,元大-台南,2023-07-13,9896
6443,元晶,17,0,17,元大-台南,2023-07-13,9896
6477,安集,17,0,17,元大-台南,2023-07-13,9896
6806,森崴能源,18,1,17,元大-台南,2023-07-13,9896
9907,統一實,18,2,16,元大-台南,2023-07-13,9896
5009,榮剛,21,5,16,元大-台南,2023-07-13,9896
5483,中美晶,24,9,15,元大-台南,2023-07-13,9896
5457,宣德,15,0,15,元大-台南,2023-07-13,9896
00722B,群益投資級電信債,15,0,15,元大-台南,2023-07-13,9896
4906,正文,16,1,15,元大-台南,2023-07-13,9896
6153,嘉聯益,15,0,15,元大-台南,2023-07-13,9896
00679B,元大美債20年,15,0,15,元大-台南,2023-07-13,9896
2317,鴻海,18,3,15,元大-台南,2023-07-13,9896
00712,復華富時不動產,48,34,14,元大-台南,2023-07-13,9896
8070,長華*,14,0,14,元大-台南,2023-07-13,9896
2312,金寶,32,19,13,元大-台南,2023-07-13,9896
00673R,期元大S＆P原油反1,277,35,242,元大-台南,2023-07-14,9896
2382,廣達,297,57,240,元大-台南,2023-07-14,9896
3706,神達,211,9,202,元大-台南,2023-07-14,9896
00632R,元大台灣50反1,153,10,143,元大-台南,2023-07-14,9896
2618,長榮航,183,62,121,元大-台南,2023-07-14,9896
2301,光寶科,168,57,111,元大-台南,2023-07-14,9896
00637L,元大滬深300正2,120,11,109,元大-台南,2023-07-14,9896
5439,高技,103,15,88,元大-台南,2023-07-14,9896
2610,華航,146,67,79,元大-台南,2023-07-14,9896
2881,富邦金,107,33,74,元大-台南,2023-07-14,9896
3032,偉訓,126,56,70,元大-台南,2023-07-14,9896
2356,英業達,208,151,57,元大-台南,2023-07-14,9896
1477,聚陽,57,1,56,元大-台南,2023-07-14,9896
2303,聯電,78,25,53,元大-台南,2023-07-14,9896
2344,華邦電,56,8,48,元大-台南,2023-07-14,9896
00671R,富邦NASDAQ反1,46,0,46,元大-台南,2023-07-14,9896
00664R,國泰臺灣加權反1,36,0,36,元大-台南,2023-07-14,9896
00930,永豐ESG低碳高息,32,0,32,元大-台南,2023-07-14,9896
2607,榮運,30,0,30,元大-台南,2023-07-14,9896
00919,群益台灣精選高息,39,11,28,元大-台南,2023-07-14,9896
6161,捷波,26,0,26,元大-台南,2023-07-14,9896
00929,復華台灣科技優息,26,3,23,元大-台南,2023-07-14,9896
8201,無敵,23,0,23,元大-台南,2023-07-14,9896
00882,中信中國高股息,21,0,21,元大-台南,2023-07-14,9896
6533,晶心科,23,2,21,元大-台南,2023-07-14,9896
1101,台泥,20,0,20,元大-台南,2023-07-14,9896
5457,宣德,20,0,20,元大-台南,2023-07-14,9896
00782B,國泰A級公用債,20,0,20,元大-台南,2023-07-14,9896
6113,亞矽,57,37,20,元大-台南,2023-07-14,9896
3017,奇鋐,32,13,19,元大-台南,2023-07-14,9896
00679B,元大美債20年,18,0,18,元大-台南,2023-07-14,9896
6282,康舒,27,10,17,元大-台南,2023-07-14,9896
3013,晟銘電,19,2,17,元大-台南,2023-07-14,9896
6548,長科*,25,8,17,元大-台南,2023-07-14,9896
1609,大亞,65,48,17,元大-台南,2023-07-14,9896
3693,營邦,26,9,17,元大-台南,2023-07-14,9896
2324,仁寶,24,8,16,元大-台南,2023-07-14,9896
8028,昇陽半導體,42,26,16,元大-台南,2023-07-14,9896
6235,華孚,29,14,15,元大-台南,2023-07-14,9896
1201,味全,15,0,15,元大-台南,2023-07-14,9896
00905,FT臺灣Smart,16,1,15,元大-台南,2023-07-14,9896
3058,立德,14,0,14,元大-台南,2023-07-14,9896
2208,台船,12,0,12,元大-台南,2023-07-14,9896
2812,台中銀,14,2,12,元大-台南,2023-07-14,9896
2367,燿華,12,0,12,元大-台南,2023-07-14,9896
020028,元大特選電動車N,12,0,12,元大-台南,2023-07-14,9896
3265,台星科,21,9,12,元大-台南,2023-07-14,9896
6214,精誠,12,0,12,元大-台南,2023-07-14,9896
3380,明泰,40,28,12,元大-台南,2023-07-14,9896
2449,京元電子,18,7,11,元大-台南,2023-07-14,9896
00632R,元大台灣50反1,7109,99,7010,元大-台南,2023-07-17,9896
2356,英業達,700,90,610,元大-台南,2023-07-17,9896
00673R,期元大S＆P原油反1,366,2,364,元大-台南,2023-07-17,9896
2888,新光金,222,38,184,元大-台南,2023-07-17,9896
8210,勤誠,164,19,145,元大-台南,2023-07-17,9896
3706,神達,154,45,109,元大-台南,2023-07-17,9896
2618,長榮航,89,6,83,元大-台南,2023-07-17,9896
6523,達爾膚,74,0,74,元大-台南,2023-07-17,9896
2301,光寶科,128,57,71,元大-台南,2023-07-17,9896
00929,復華台灣科技優息,87,22,65,元大-台南,2023-07-17,9896
3704,合勤控,79,26,53,元大-台南,2023-07-17,9896
00725B,國泰投資級公司債,38,0,38,元大-台南,2023-07-17,9896
2371,大同,59,22,37,元大-台南,2023-07-17,9896
8936,國統,53,16,37,元大-台南,2023-07-17,9896
00922,國泰台灣領袖50,35,1,34,元大-台南,2023-07-17,9896
2329,華泰,61,27,34,元大-台南,2023-07-17,9896
2495,普安,40,10,30,元大-台南,2023-07-17,9896
8064,東捷,30,0,30,元大-台南,2023-07-17,9896
2409,友達,34,5,29,元大-台南,2023-07-17,9896
2388,威盛,77,49,28,元大-台南,2023-07-17,9896
4746,台耀,34,6,28,元大-台南,2023-07-17,9896
2353,宏��,96,70,26,元大-台南,2023-07-17,9896
3032,偉訓,77,52,25,元大-台南,2023-07-17,9896
5483,中美晶,29,6,23,元大-台南,2023-07-17,9896
2436,偉詮電,25,2,23,元大-台南,2023-07-17,9896
6188,廣明,129,107,22,元大-台南,2023-07-17,9896
3481,群創,49,27,22,元大-台南,2023-07-17,9896
00720B,元大投資級公司債,22,1,21,元大-台南,2023-07-17,9896
1711,永光,27,7,20,元大-台南,2023-07-17,9896
00897,富邦基因免疫生技,20,0,20,元大-台南,2023-07-17,9896
2892,第一金,26,7,19,元大-台南,2023-07-17,9896
2515,中工,22,3,19,元大-台南,2023-07-17,9896
2883,凱基金,28,10,18,元大-台南,2023-07-17,9896
8112,至上,32,14,18,元大-台南,2023-07-17,9896
5426,振發,18,0,18,元大-台南,2023-07-17,9896
9907,統一實,18,0,18,元大-台南,2023-07-17,9896
2352,佳世達,41,24,17,元大-台南,2023-07-17,9896
3027,盛達,27,10,17,元大-台南,2023-07-17,9896
6191,精成科,20,3,17,元大-台南,2023-07-17,9896
3189,景碩,26,10,16,元大-台南,2023-07-17,9896
00751B,元大AAA至A公司債,16,0,16,元大-台南,2023-07-17,9896
2890,永豐金,22,6,16,元大-台南,2023-07-17,9896
5009,榮剛,21,5,16,元大-台南,2023-07-17,9896
4743,合一,21,6,15,元大-台南,2023-07-17,9896
2208,台船,15,0,15,元大-台南,2023-07-17,9896
8105,凌巨,58,43,15,元大-台南,2023-07-17,9896
00882,中信中國高股息,18,3,15,元大-台南,2023-07-17,9896
1301,台塑,15,0,15,元大-台南,2023-07-17,9896
6185,幃翔,14,0,14,元大-台南,2023-07-17,9896
6245,立端,23,9,14,元大-台南,2023-07-17,9896
2618,長榮航,741,40,701,元大-台南,2023-07-18,9896
00637L,元大滬深300正2,501,50,451,元大-台南,2023-07-18,9896
2603,長榮,445,6,439,元大-台南,2023-07-18,9896
00882,中信中國高股息,372,0,372,元大-台南,2023-07-18,9896
2888,新光金,146,6,140,元大-台南,2023-07-18,9896
3706,神達,332,194,138,元大-台南,2023-07-18,9896
2312,金寶,206,105,101,元大-台南,2023-07-18,9896
5512,力麒,259,171,88,元大-台南,2023-07-18,9896
1905,華紙,86,3,83,元大-台南,2023-07-18,9896
00929,復華台灣科技優息,86,6,80,元大-台南,2023-07-18,9896
2883,凱基金,77,1,76,元大-台南,2023-07-18,9896
6203,海韻電,70,2,68,元大-台南,2023-07-18,9896
2353,宏��,210,144,66,元大-台南,2023-07-18,9896
00878,國泰永續高股息,172,109,63,元大-台南,2023-07-18,9896
2382,廣達,161,97,64,元大-台南,2023-07-18,9896
2324,仁寶,130,68,62,元大-台南,2023-07-18,9896
9105,泰金寶-DR,117,55,62,元大-台南,2023-07-18,9896
1513,中興電,77,16,61,元大-台南,2023-07-18,9896
2481,強茂,71,12,59,元大-台南,2023-07-18,9896
1102,亞泥,57,0,57,元大-台南,2023-07-18,9896
6150,撼訊,58,2,56,元大-台南,2023-07-18,9896
1514,亞力,71,21,50,元大-台南,2023-07-18,9896
3032,偉訓,66,16,50,元大-台南,2023-07-18,9896
00720B,元大投資級公司債,49,1,48,元大-台南,2023-07-18,9896
2449,京元電子,75,28,47,元大-台南,2023-07-18,9896
3305,昇貿,63,17,46,元大-台南,2023-07-18,9896
8936,國統,47,7,40,元大-台南,2023-07-18,9896
3078,僑威,91,51,40,元大-台南,2023-07-18,9896
2357,華碩,61,22,39,元大-台南,2023-07-18,9896
00673R,期元大S＆P原油反1,42,6,36,元大-台南,2023-07-18,9896
2329,華泰,138,102,36,元大-台南,2023-07-18,9896
3060,銘異,31,1,30,元大-台南,2023-07-18,9896
6285,啟��,57,28,29,元大-台南,2023-07-18,9896
3481,群創,64,35,29,元大-台南,2023-07-18,9896
1305,華夏,25,0,25,元大-台南,2023-07-18,9896
6120,達運,24,0,24,元大-台南,2023-07-18,9896
3047,訊舟,27,6,21,元大-台南,2023-07-18,9896
3006,晶豪科,22,1,21,元大-台南,2023-07-18,9896
1101,台泥,22,1,21,元大-台南,2023-07-18,9896
6282,康舒,152,132,20,元大-台南,2023-07-18,9896
4533,協易機,40,20,20,元大-台南,2023-07-18,9896
8011,台通,20,0,20,元大-台南,2023-07-18,9896
2884,玉山金,23,4,19,元大-台南,2023-07-18,9896
3338,泰碩,38,19,19,元大-台南,2023-07-18,9896
00751B,元大AAA至A公司債,18,0,18,元大-台南,2023-07-18,9896
00679B,元大美債20年,17,0,17,元大-台南,2023-07-18,9896
1402,遠東新,17,0,17,元大-台南,2023-07-18,9896
00907,永豐優息存股,17,0,17,元大-台南,2023-07-18,9896
2425,承啟,23,6,17,元大-台南,2023-07-18,9896
2436,偉詮電,23,6,17,元大-台南,2023-07-18,9896
00671R,富邦NASDAQ反1,350,0,350,元大-台南,2023-07-19,9896
3483,力致,265,13,252,元大-台南,2023-07-19,9896
00882,中信中國高股息,173,27,146,元大-台南,2023-07-19,9896
2349,錸德,130,0,130,元大-台南,2023-07-19,9896
00637L,元大滬深300正2,112,0,112,元大-台南,2023-07-19,9896
00680L,元大美債20正2,105,0,105,元大-台南,2023-07-19,9896
2344,華邦電,127,34,93,元大-台南,2023-07-19,9896
4532,瑞智,91,6,85,元大-台南,2023-07-19,9896
9105,泰金寶-DR,90,10,80,元大-台南,2023-07-19,9896
2353,宏��,179,111,68,元大-台南,2023-07-19,9896
2329,華泰,131,66,65,元大-台南,2023-07-19,9896
2324,仁寶,121,62,59,元大-台南,2023-07-19,9896
2362,藍天,51,0,51,元大-台南,2023-07-19,9896
00673R,期元大S＆P原油反1,100,50,50,元大-台南,2023-07-19,9896
6120,達運,47,1,46,元大-台南,2023-07-19,9896
2887,台新金,38,0,38,元大-台南,2023-07-19,9896
2888,新光金,78,40,38,元大-台南,2023-07-19,9896
6235,華孚,71,34,37,元大-台南,2023-07-19,9896
2363,矽統,35,0,35,元大-台南,2023-07-19,9896
8210,勤誠,45,13,32,元大-台南,2023-07-19,9896
00891,中信關鍵半導體,31,0,31,元大-台南,2023-07-19,9896
2312,金寶,69,39,30,元大-台南,2023-07-19,9896
4938,和碩,101,71,30,元大-台南,2023-07-19,9896
5009,榮剛,30,1,29,元大-台南,2023-07-19,9896
5471,松翰,33,5,28,元大-台南,2023-07-19,9896
3710,連展投控,29,1,28,元大-台南,2023-07-19,9896
2618,長榮航,55,27,28,元大-台南,2023-07-19,9896
2402,毅嘉,33,6,27,元大-台南,2023-07-19,9896
00888,永豐台灣ESG,26,0,26,元大-台南,2023-07-19,9896
5328,華容,163,138,25,元大-台南,2023-07-19,9896
2303,聯電,46,22,24,元大-台南,2023-07-19,9896
00720B,元大投資級公司債,28,4,24,元大-台南,2023-07-19,9896
2481,強茂,36,12,24,元大-台南,2023-07-19,9896
2610,華航,39,17,22,元大-台南,2023-07-19,9896
2867,三商壽,22,0,22,元大-台南,2023-07-19,9896
3013,晟銘電,30,8,22,元大-台南,2023-07-19,9896
4566,時碩工業,32,11,21,元大-台南,2023-07-19,9896
2201,裕隆,24,3,21,元大-台南,2023-07-19,9896
3037,欣興,66,46,20,元大-台南,2023-07-19,9896
4931,新盛力,22,2,20,元大-台南,2023-07-19,9896
8940,新天地,20,0,20,元大-台南,2023-07-19,9896
1618,合機,31,11,20,元大-台南,2023-07-19,9896
2812,台中銀,31,12,19,元大-台南,2023-07-19,9896
6282,康舒,60,41,19,元大-台南,2023-07-19,9896
1513,中興電,19,0,19,元大-台南,2023-07-19,9896
00713,元大台灣高息低波,21,3,18,元大-台南,2023-07-19,9896
2801,彰銀,19,2,17,元大-台南,2023-07-19,9896
4563,百德,21,4,17,元大-台南,2023-07-19,9896
2609,陽明,34,19,15,元大-台南,2023-07-19,9896
8049,晶采,15,0,15,元大-台南,2023-07-19,9896
00632R,元大台灣50反1,140,0,140,元大-台南,2023-07-20,9896
00673R,期元大S＆P原油反1,110,12,98,元大-台南,2023-07-20,9896
2303,聯電,125,34,91,元大-台南,2023-07-20,9896
9939,宏全,75,0,75,元大-台南,2023-07-20,9896
8210,勤誠,87,22,65,元大-台南,2023-07-20,9896
2323,中環,59,14,45,元大-台南,2023-07-20,9896
2706,第一店,40,0,40,元大-台南,2023-07-20,9896
1313,聯成,46,8,38,元大-台南,2023-07-20,9896
00751B,元大AAA至A公司債,35,0,35,元大-台南,2023-07-20,9896
6142,友勁,35,0,35,元大-台南,2023-07-20,9896
00712,復華富時不動產,37,4,33,元大-台南,2023-07-20,9896
4123,晟德,60,28,32,元大-台南,2023-07-20,9896
1785,光洋科,30,0,30,元大-台南,2023-07-20,9896
3037,欣興,56,29,27,元大-台南,2023-07-20,9896
3234,光環,31,4,27,元大-台南,2023-07-20,9896
1795,美時,29,5,24,元大-台南,2023-07-20,9896
1102,亞泥,24,0,24,元大-台南,2023-07-20,9896
3289,宜特,27,4,23,元大-台南,2023-07-20,9896
2722,夏都,77,55,22,元大-台南,2023-07-20,9896
3481,群創,59,38,21,元大-台南,2023-07-20,9896
020038,元大ESG配息N,21,0,21,元大-台南,2023-07-20,9896
00772B,中信高評級公司債,21,1,20,元大-台南,2023-07-20,9896
8940,新天地,20,0,20,元大-台南,2023-07-20,9896
6282,康舒,76,58,18,元大-台南,2023-07-20,9896
3706,神達,53,35,18,元大-台南,2023-07-20,9896
2317,鴻海,23,6,17,元大-台南,2023-07-20,9896
1529,樂事綠能,25,8,17,元大-台南,2023-07-20,9896
00720B,元大投資級公司債,16,0,16,元大-台南,2023-07-20,9896
1504,東元,20,4,16,元大-台南,2023-07-20,9896
6523,達爾膚,16,0,16,元大-台南,2023-07-20,9896
00687B,國泰20年美債,19,3,16,元大-台南,2023-07-20,9896
2482,連宇,19,3,16,元大-台南,2023-07-20,9896
1104,環泥,18,2,16,元大-台南,2023-07-20,9896
3704,合勤控,23,7,16,元大-台南,2023-07-20,9896
2881,富邦金,28,12,16,元大-台南,2023-07-20,9896
2609,陽明,38,23,15,元大-台南,2023-07-20,9896
1907,永豐餘,29,14,15,元大-台南,2023-07-20,9896
6150,撼訊,17,2,15,元大-台南,2023-07-20,9896
1402,遠東新,15,0,15,元大-台南,2023-07-20,9896
2705,六福,30,15,15,元大-台南,2023-07-20,9896
2206,三陽工業,29,14,15,元大-台南,2023-07-20,9896
2313,華通,15,1,14,元大-台南,2023-07-20,9896
5009,榮剛,13,0,13,元大-台南,2023-07-20,9896
1618,合機,20,7,13,元大-台南,2023-07-20,9896
2337,旺宏,12,0,12,元大-台南,2023-07-20,9896
2449,京元電子,14,2,12,元大-台南,2023-07-20,9896
4938,和碩,44,33,11,元大-台南,2023-07-20,9896
1101,台泥,11,0,11,元大-台南,2023-07-20,9896
3380,明泰,12,1,11,元大-台南,2023-07-20,9896
2359,所羅門,12,1,11,元大-台南,2023-07-20,9896
2618,長榮航,159,28,131,元大-台南,2023-07-21,9896
00673R,期元大S＆P原油反1,119,0,119,元大-台南,2023-07-21,9896
3078,僑威,76,0,76,元大-台南,2023-07-21,9896
2027,大成鋼,78,8,70,元大-台南,2023-07-21,9896
5706,鳳凰,54,0,54,元大-台南,2023-07-21,9896
00652,富邦印度,50,0,50,元大-台南,2023-07-21,9896
2330,台積電,53,7,46,元大-台南,2023-07-21,9896
1101,台泥,45,1,44,元大-台南,2023-07-21,9896
5512,力麒,209,168,41,元大-台南,2023-07-21,9896
00637L,元大滬深300正2,100,61,39,元大-台南,2023-07-21,9896
2206,三陽工業,42,4,38,元大-台南,2023-07-21,9896
2303,聯電,65,28,37,元大-台南,2023-07-21,9896
00885,富邦越南,52,22,30,元大-台南,2023-07-21,9896
00763U,期街口道瓊銅,30,0,30,元大-台南,2023-07-21,9896
6235,華孚,42,12,30,元大-台南,2023-07-21,9896
3715,定穎投控,33,6,27,元大-台南,2023-07-21,9896
2312,金寶,36,10,26,元大-台南,2023-07-21,9896
2344,華邦電,27,2,25,元大-台南,2023-07-21,9896
6275,元山,34,10,24,元大-台南,2023-07-21,9896
2458,義隆,24,0,24,元大-台南,2023-07-21,9896
3234,光環,23,0,23,元大-台南,2023-07-21,9896
2356,英業達,64,42,22,元大-台南,2023-07-21,9896
2886,兆豐金,29,7,22,元大-台南,2023-07-21,9896
2405,輔信,30,8,22,元大-台南,2023-07-21,9896
0056,元大高股息,93,73,20,元大-台南,2023-07-21,9896
2890,永豐金,24,4,20,元大-台南,2023-07-21,9896
3037,欣興,47,28,19,元大-台南,2023-07-21,9896
00720B,元大投資級公司債,22,5,17,元大-台南,2023-07-21,9896
6282,康舒,44,27,17,元大-台南,2023-07-21,9896
6113,亞矽,314,297,17,元大-台南,2023-07-21,9896
4977,眾達-KY,28,12,16,元大-台南,2023-07-21,9896
2515,中工,18,2,16,元大-台南,2023-07-21,9896
2409,友達,17,1,16,元大-台南,2023-07-21,9896
4532,瑞智,18,3,15,元大-台南,2023-07-21,9896
3583,辛耘,27,13,14,元大-台南,2023-07-21,9896
2464,盟立,14,0,14,元大-台南,2023-07-21,9896
00712,復華富時不動產,19,5,14,元大-台南,2023-07-21,9896
00905,FT臺灣Smart,15,1,14,元大-台南,2023-07-21,9896
4160,訊聯基因,15,1,14,元大-台南,2023-07-21,9896
5607,遠雄港,17,3,14,元大-台南,2023-07-21,9896
00930,永豐ESG低碳高息,13,0,13,元大-台南,2023-07-21,9896
2883,凱基金,13,0,13,元大-台南,2023-07-21,9896
8411,福貞-KY,13,0,13,元大-台南,2023-07-21,9896
00923,群益台ESG低碳50,13,0,13,元大-台南,2023-07-21,9896
1102,亞泥,14,2,12,元大-台南,2023-07-21,9896
6505,台塑化,12,0,12,元大-台南,2023-07-21,9896
5009,榮剛,15,4,11,元大-台南,2023-07-21,9896
00680L,元大美債20正2,11,0,11,元大-台南,2023-07-21,9896
4123,晟德,18,7,11,元大-台南,2023-07-21,9896
00679B,元大美債20年,11,1,10,元大-台南,2023-07-21,9896
00637L,元大滬深300正2,321,1,320,元大-台南,2023-07-24,9896
2027,大成鋼,166,3,163,元大-台南,2023-07-24,9896
00668,國泰美國道瓊,90,0,90,元大-台南,2023-07-24,9896
1609,大亞,201,124,77,元大-台南,2023-07-24,9896
3032,偉訓,62,2,60,元大-台南,2023-07-24,9896
00673R,期元大S＆P原油反1,59,0,59,元大-台南,2023-07-24,9896
6266,泰詠,59,1,58,元大-台南,2023-07-24,9896
2454,聯發科,54,0,54,元大-台南,2023-07-24,9896
3481,群創,41,0,41,元大-台南,2023-07-24,9896
4938,和碩,59,19,40,元大-台南,2023-07-24,9896
2382,廣達,142,103,39,元大-台南,2023-07-24,9896
2890,永豐金,44,5,39,元大-台南,2023-07-24,9896
020038,元大ESG配息N,39,0,39,元大-台南,2023-07-24,9896
6113,亞矽,65,28,37,元大-台南,2023-07-24,9896
1101,台泥,36,1,35,元大-台南,2023-07-24,9896
8446,華研,35,0,35,元大-台南,2023-07-24,9896
2352,佳世達,43,10,33,元大-台南,2023-07-24,9896
2887,台新金,39,6,33,元大-台南,2023-07-24,9896
00751B,元大AAA至A公司債,32,0,32,元大-台南,2023-07-24,9896
2867,三商壽,31,0,31,元大-台南,2023-07-24,9896
2449,京元電子,42,12,30,元大-台南,2023-07-24,9896
2356,英業達,71,41,30,元大-台南,2023-07-24,9896
3338,泰碩,40,11,29,元大-台南,2023-07-24,9896
2891,中信金,27,0,27,元大-台南,2023-07-24,9896
00679B,元大美債20年,31,5,26,元大-台南,2023-07-24,9896
00712,復華富時不動產,48,22,26,元大-台南,2023-07-24,9896
6125,廣運,45,19,26,元大-台南,2023-07-24,9896
3702,大聯大,28,3,25,元大-台南,2023-07-24,9896
2303,聯電,28,4,24,元大-台南,2023-07-24,9896
1217,愛之味,26,3,23,元大-台南,2023-07-24,9896
2353,宏��,89,67,22,元大-台南,2023-07-24,9896
6168,宏齊,22,0,22,元大-台南,2023-07-24,9896
00929,復華台灣科技優息,21,0,21,元大-台南,2023-07-24,9896
1440,南紡,20,0,20,元大-台南,2023-07-24,9896
3105,穩懋,19,0,19,元大-台南,2023-07-24,9896
3047,訊舟,31,12,19,元大-台南,2023-07-24,9896
3689,湧德,23,4,19,元大-台南,2023-07-24,9896
3078,僑威,22,4,18,元大-台南,2023-07-24,9896
3231,緯創,39,21,18,元大-台南,2023-07-24,9896
3011,今皓,20,4,16,元大-台南,2023-07-24,9896
9951,皇田,20,4,16,元大-台南,2023-07-24,9896
1504,東元,38,23,15,元大-台南,2023-07-24,9896
2059,川湖,20,5,15,元大-台南,2023-07-24,9896
1503,士電,16,2,14,元大-台南,2023-07-24,9896
2492,華新科,16,2,14,元大-台南,2023-07-24,9896
1785,光洋科,14,1,13,元大-台南,2023-07-24,9896
2312,金寶,17,4,13,元大-台南,2023-07-24,9896
1514,亞力,15,2,13,元大-台南,2023-07-24,9896
1102,亞泥,13,1,12,元大-台南,2023-07-24,9896
2603,長榮,12,0,12,元大-台南,2023-07-24,9896
00680L,元大美債20正2,160,0,160,元大-台南,2023-07-25,9896
00878,國泰永續高股息,251,117,134,元大-台南,2023-07-25,9896
5483,中美晶,116,4,112,元大-台南,2023-07-25,9896
00882,中信中國高股息,117,11,106,元大-台南,2023-07-25,9896
00632R,元大台灣50反1,133,60,73,元大-台南,2023-07-25,9896
2887,台新金,64,14,50,元大-台南,2023-07-25,9896
00679B,元大美債20年,51,6,45,元大-台南,2023-07-25,9896
1314,中石化,50,5,45,元大-台南,2023-07-25,9896
1905,華紙,87,42,45,元大-台南,2023-07-25,9896
3711,日月光投控,49,4,45,元大-台南,2023-07-25,9896
6282,康舒,48,6,42,元大-台南,2023-07-25,9896
00712,復華富時不動產,41,1,40,元大-台南,2023-07-25,9896
5512,力麒,465,431,34,元大-台南,2023-07-25,9896
2382,廣達,125,92,33,元大-台南,2023-07-25,9896
2461,光群雷,37,4,33,元大-台南,2023-07-25,9896
6156,松上,64,34,30,元大-台南,2023-07-25,9896
6548,長科*,30,0,30,元大-台南,2023-07-25,9896
2881,富邦金,41,13,28,元大-台南,2023-07-25,9896
3037,欣興,56,28,28,元大-台南,2023-07-25,9896
4106,雃博,25,0,25,元大-台南,2023-07-25,9896
00929,復華台灣科技優息,29,5,24,元大-台南,2023-07-25,9896
8021,尖點,24,0,24,元大-台南,2023-07-25,9896
2610,華航,31,8,23,元大-台南,2023-07-25,9896
6770,力積電,30,8,22,元大-台南,2023-07-25,9896
00919,群益台灣精選高息,21,0,21,元大-台南,2023-07-25,9896
00670L,富邦NASDAQ正2,20,0,20,元大-台南,2023-07-25,9896
6125,廣運,30,10,20,元大-台南,2023-07-25,9896
3059,華晶科,20,1,19,元大-台南,2023-07-25,9896
1513,中興電,123,105,18,元大-台南,2023-07-25,9896
2301,光寶科,51,32,19,元大-台南,2023-07-25,9896
5469,瀚宇博,28,10,18,元大-台南,2023-07-25,9896
2352,佳世達,34,16,18,元大-台南,2023-07-25,9896
3029,零壹,20,3,17,元大-台南,2023-07-25,9896
00664R,國泰臺灣加權反1,16,0,16,元大-台南,2023-07-25,9896
6116,彩晶,25,10,15,元大-台南,2023-07-25,9896
2634,漢翔,20,5,15,元大-台南,2023-07-25,9896
3051,力特,15,0,15,元大-台南,2023-07-25,9896
1101,台泥,23,9,14,元大-台南,2023-07-25,9896
3702,大聯大,18,4,14,元大-台南,2023-07-25,9896
00722B,群益投資級電信債,14,0,14,元大-台南,2023-07-25,9896
2204,中華,24,11,13,元大-台南,2023-07-25,9896
1301,台塑,14,1,13,元大-台南,2023-07-25,9896
1102,亞泥,13,0,13,元大-台南,2023-07-25,9896
2323,中環,12,0,12,元大-台南,2023-07-25,9896
6111,大宇資,12,0,12,元大-台南,2023-07-25,9896
9941A,裕融甲特,12,0,12,元大-台南,2023-07-25,9896
1618,合機,13,1,12,元大-台南,2023-07-25,9896
3324,雙鴻,14,3,11,元大-台南,2023-07-25,9896
2312,金寶,11,0,11,元大-台南,2023-07-25,9896
8183,精星,11,0,11,元大-台南,2023-07-25,9896
00637L,元大滬深300正2,406,66,340,元大-台南,2023-07-26,9896
2329,華泰,345,93,252,元大-台南,2023-07-26,9896
4543,萬在,154,12,142,元大-台南,2023-07-26,9896
6266,泰詠,140,0,140,元大-台南,2023-07-26,9896
1471,首利,149,12,137,元大-台南,2023-07-26,9896
2882,國泰金,76,9,67,元大-台南,2023-07-26,9896
8358,金居,90,36,54,元大-台南,2023-07-26,9896
00921,兆豐龍頭等權重,50,0,50,元大-台南,2023-07-26,9896
1609,大亞,95,51,44,元大-台南,2023-07-26,9896
00673R,期元大S＆P原油反1,38,0,38,元大-台南,2023-07-26,9896
1504,東元,136,99,37,元大-台南,2023-07-26,9896
2371,大同,45,9,36,元大-台南,2023-07-26,9896
3032,偉訓,57,25,32,元大-台南,2023-07-26,9896
00929,復華台灣科技優息,32,0,32,元大-台南,2023-07-26,9896
5009,榮剛,31,0,31,元大-台南,2023-07-26,9896
6117,迎廣,32,3,29,元大-台南,2023-07-26,9896
6187,萬潤,39,11,28,元大-台南,2023-07-26,9896
1795,美時,27,3,24,元大-台南,2023-07-26,9896
1313,聯成,29,6,23,元大-台南,2023-07-26,9896
2883,凱基金,24,2,22,元大-台南,2023-07-26,9896
2449,京元電子,33,12,21,元大-台南,2023-07-26,9896
1529,樂事綠能,21,0,21,元大-台南,2023-07-26,9896
2888,新光金,198,177,21,元大-台南,2023-07-26,9896
2887,台新金,53,33,20,元大-台南,2023-07-26,9896
2337,旺宏,18,0,18,元大-台南,2023-07-26,9896
6274,台燿,40,22,18,元大-台南,2023-07-26,9896
6140,訊達,22,5,17,元大-台南,2023-07-26,9896
3013,晟銘電,18,1,17,元大-台南,2023-07-26,9896
2425,承啟,27,11,16,元大-台南,2023-07-26,9896
1603,華電,18,2,16,元大-台南,2023-07-26,9896
2520,冠德,16,0,16,元大-台南,2023-07-26,9896
00892,富邦台灣半導體,15,0,15,元大-台南,2023-07-26,9896
1337,再生-KY,15,0,15,元大-台南,2023-07-26,9896
5258,虹堡,17,2,15,元大-台南,2023-07-26,9896
00927,群益半導體收益,14,0,14,元大-台南,2023-07-26,9896
2402,毅嘉,22,8,14,元大-台南,2023-07-26,9896
6269,台郡,14,0,14,元大-台南,2023-07-26,9896
006208,富邦台50,13,0,13,元大-台南,2023-07-26,9896
1752,南光,13,0,13,元大-台南,2023-07-26,9896
00751B,元大AAA至A公司債,13,0,13,元大-台南,2023-07-26,9896
2376,技嘉,33,20,13,元大-台南,2023-07-26,9896
00891,中信關鍵半導體,15,3,12,元大-台南,2023-07-26,9896
6640,均華,12,0,12,元大-台南,2023-07-26,9896
4510,高鋒,12,0,12,元大-台南,2023-07-26,9896
6657,華安,16,4,12,元大-台南,2023-07-26,9896
2377,微星,17,5,12,元大-台南,2023-07-26,9896
00720B,元大投資級公司債,31,19,12,元大-台南,2023-07-26,9896
1513,中興電,48,36,12,元大-台南,2023-07-26,9896
5483,中美晶,13,2,11,元大-台南,2023-07-26,9896
4938,和碩,15,4,11,元大-台南,2023-07-26,9896
2409,友達,1221,463,758,元大-台南,2023-07-27,9896
1904,正隆,123,10,113,元大-台南,2023-07-27,9896
00673R,期元大S＆P原油反1,93,0,93,元大-台南,2023-07-27,9896
2883,凱基金,67,11,56,元大-台南,2023-07-27,9896
2891,中信金,62,8,54,元大-台南,2023-07-27,9896
1101,台泥,55,4,51,元大-台南,2023-07-27,9896
00679B,元大美債20年,48,0,48,元大-台南,2023-07-27,9896
1471,首利,165,126,39,元大-台南,2023-07-27,9896
6269,台郡,39,0,39,元大-台南,2023-07-27,9896
00712,復華富時不動產,39,0,39,元大-台南,2023-07-27,9896
00680L,元大美債20正2,38,0,38,元大-台南,2023-07-27,9896
3049,精金,44,6,38,元大-台南,2023-07-27,9896
6113,亞矽,218,181,37,元大-台南,2023-07-27,9896
2312,金寶,34,3,31,元大-台南,2023-07-27,9896
2887,台新金,61,30,31,元大-台南,2023-07-27,9896
2405,輔信,42,12,30,元大-台南,2023-07-27,9896
6843,進典,28,0,28,元大-台南,2023-07-27,9896
6125,廣運,55,28,27,元大-台南,2023-07-27,9896
2353,宏��,31,5,26,元大-台南,2023-07-27,9896
8215,明基材,30,5,25,元大-台南,2023-07-27,9896
3013,晟銘電,44,22,22,元大-台南,2023-07-27,9896
2356,英業達,32,12,20,元大-台南,2023-07-27,9896
2352,佳世達,27,7,20,元大-台南,2023-07-27,9896
2820,華票,20,0,20,元大-台南,2023-07-27,9896
4533,協易機,35,17,18,元大-台南,2023-07-27,9896
2002,中鋼,29,11,18,元大-台南,2023-07-27,9896
2359,所羅門,26,9,17,元大-台南,2023-07-27,9896
3037,欣興,36,19,17,元大-台南,2023-07-27,9896
6015,宏遠證,16,0,16,元大-台南,2023-07-27,9896
2884,玉山金,53,37,16,元大-台南,2023-07-27,9896
6488,環球晶,15,0,15,元大-台南,2023-07-27,9896
2323,中環,15,0,15,元大-台南,2023-07-27,9896
6657,華安,22,7,15,元大-台南,2023-07-27,9896
00664R,國泰臺灣加權反1,15,0,15,元大-台南,2023-07-27,9896
3338,泰碩,27,13,14,元大-台南,2023-07-27,9896
8234,新漢,19,5,14,元大-台南,2023-07-27,9896
6016,康和證,14,0,14,元大-台南,2023-07-27,9896
00929,復華台灣科技優息,16,2,14,元大-台南,2023-07-27,9896
6190,萬泰科,15,2,13,元大-台南,2023-07-27,9896
4989,榮科,13,0,13,元大-台南,2023-07-27,9896
2630,亞航,15,2,13,元大-台南,2023-07-27,9896
2603,長榮,20,8,12,元大-台南,2023-07-27,9896
00687B,國泰20年美債,13,0,13,元大-台南,2023-07-27,9896
3264,欣銓,15,3,12,元大-台南,2023-07-27,9896
6140,訊達,12,0,12,元大-台南,2023-07-27,9896
2371,大同,35,23,12,元大-台南,2023-07-27,9896
00713,元大台灣高息低波,16,5,11,元大-台南,2023-07-27,9896
2480,敦陽科,12,1,11,元大-台南,2023-07-27,9896
3231,緯創,37,26,11,元大-台南,2023-07-27,9896
8131,福懋科,11,0,11,元大-台南,2023-07-27,9896
2888,新光金,626,81,545,元大-台南,2023-07-28,9896
00680L,元大美債20正2,283,0,283,元大-台南,2023-07-28,9896
00679B,元大美債20年,117,2,115,元大-台南,2023-07-28,9896
1609,大亞,133,31,102,元大-台南,2023-07-28,9896
00632R,元大台灣50反1,226,126,100,元大-台南,2023-07-28,9896
2329,華泰,252,164,88,元大-台南,2023-07-28,9896
1101,台泥,85,8,77,元大-台南,2023-07-28,9896
1905,華紙,233,165,68,元大-台南,2023-07-28,9896
2609,陽明,121,55,66,元大-台南,2023-07-28,9896
2887,台新金,60,2,58,元大-台南,2023-07-28,9896
2885,元大金,48,0,48,元大-台南,2023-07-28,9896
3049,精金,62,20,42,元大-台南,2023-07-28,9896
5009,榮剛,37,1,36,元大-台南,2023-07-28,9896
00687B,國泰20年美債,37,1,36,元大-台南,2023-07-28,9896
1815,富喬,54,18,36,元大-台南,2023-07-28,9896
4533,協易機,43,10,33,元大-台南,2023-07-28,9896
2353,宏��,68,37,31,元大-台南,2023-07-28,9896
1504,東元,37,6,31,元大-台南,2023-07-28,9896
8215,明基材,29,0,29,元大-台南,2023-07-28,9896
00720B,元大投資級公司債,30,1,29,元大-台南,2023-07-28,9896
2605,新興,27,0,27,元大-台南,2023-07-28,9896
6187,萬潤,43,18,25,元大-台南,2023-07-28,9896
3231,緯創,245,221,24,元大-台南,2023-07-28,9896
00751B,元大AAA至A公司債,24,0,24,元大-台南,2023-07-28,9896
5425,台半,27,5,22,元大-台南,2023-07-28,9896
3533,嘉澤,20,0,20,元大-台南,2023-07-28,9896
00670L,富邦NASDAQ正2,20,0,20,元大-台南,2023-07-28,9896
6531,愛普*,39,19,20,元大-台南,2023-07-28,9896
3702,大聯大,19,0,19,元大-台南,2023-07-28,9896
00772B,中信高評級公司債,18,0,18,元大-台南,2023-07-28,9896
2401,凌陽,17,0,17,元大-台南,2023-07-28,9896
00891,中信關鍵半導體,17,1,16,元大-台南,2023-07-28,9896
2002,中鋼,17,1,16,元大-台南,2023-07-28,9896
6416,瑞祺電通,15,0,15,元大-台南,2023-07-28,9896
2913,農林,78,63,15,元大-台南,2023-07-28,9896
4919,新唐,19,5,14,元大-台南,2023-07-28,9896
6213,聯茂,28,15,13,元大-台南,2023-07-28,9896
2371,大同,22,9,13,元大-台南,2023-07-28,9896
00929,復華台灣科技優息,42,30,12,元大-台南,2023-07-28,9896
2610,華航,16,4,12,元大-台南,2023-07-28,9896
3013,晟銘電,33,21,12,元大-台南,2023-07-28,9896
1612,宏泰,12,0,12,元大-台南,2023-07-28,9896
6535,順藥,24,12,12,元大-台南,2023-07-28,9896
4402,郡都開發,12,0,12,元大-台南,2023-07-28,9896
2618,長榮航,20,9,11,元大-台南,2023-07-28,9896
6112,邁達特,20,9,11,元大-台南,2023-07-28,9896
3265,台星科,15,4,11,元大-台南,2023-07-28,9896
2405,輔信,15,4,11,元大-台南,2023-07-28,9896
6443,元晶,11,0,11,元大-台南,2023-07-28,9896
1736,喬山,11,0,11,元大-台南,2023-07-28,9896
2027,大成鋼,158,3,155,元大-台南,2023-07-31,9896
2382,廣達,150,58,92,元大-台南,2023-07-31,9896
2301,光寶科,272,186,86,元大-台南,2023-07-31,9896
00885,富邦越南,103,23,80,元大-台南,2023-07-31,9896
00673R,期元大S＆P原油反1,67,0,67,元大-台南,2023-07-31,9896
3231,緯創,150,84,66,元大-台南,2023-07-31,9896
00929,復華台灣科技優息,86,23,63,元大-台南,2023-07-31,9896
3047,訊舟,64,6,58,元大-台南,2023-07-31,9896
2891,中信金,61,6,55,元大-台南,2023-07-31,9896
3481,群創,77,23,54,元大-台南,2023-07-31,9896
1815,富喬,105,51,54,元大-台南,2023-07-31,9896
2329,華泰,150,100,50,元大-台南,2023-07-31,9896
00679B,元大美債20年,58,13,45,元大-台南,2023-07-31,9896
2603,長榮,49,6,43,元大-台南,2023-07-31,9896
2002,中鋼,66,30,36,元大-台南,2023-07-31,9896
2352,佳世達,64,29,35,元大-台南,2023-07-31,9896
3078,僑威,37,3,34,元大-台南,2023-07-31,9896
8446,華研,35,1,34,元大-台南,2023-07-31,9896
2834,臺企銀,50,17,33,元大-台南,2023-07-31,9896
3264,欣銓,34,3,31,元大-台南,2023-07-31,9896
00897,富邦基因免疫生技,30,0,30,元大-台南,2023-07-31,9896
3706,神達,38,8,30,元大-台南,2023-07-31,9896
6269,台郡,32,5,27,元大-台南,2023-07-31,9896
3049,精金,28,2,26,元大-台南,2023-07-31,9896
00930,永豐ESG低碳高息,26,2,24,元大-台南,2023-07-31,9896
8215,明基材,30,6,24,元大-台南,2023-07-31,9896
2402,毅嘉,31,8,23,元大-台南,2023-07-31,9896
1305,華夏,24,2,22,元大-台南,2023-07-31,9896
4402,郡都開發,22,0,22,元大-台南,2023-07-31,9896
020038,元大ESG配息N,22,0,22,元大-台南,2023-07-31,9896
6188,廣明,38,16,22,元大-台南,2023-07-31,9896
6117,迎廣,35,14,21,元大-台南,2023-07-31,9896
1905,華紙,85,65,20,元大-台南,2023-07-31,9896
00665L,富邦�琤肭磪囓�2,36,16,20,元大-台南,2023-07-31,9896
2881,富邦金,30,10,20,元大-台南,2023-07-31,9896
2609,陽明,24,6,18,元大-台南,2023-07-31,9896
2892,第一金,71,53,18,元大-台南,2023-07-31,9896
2618,長榮航,27,10,17,元大-台南,2023-07-31,9896
2889,國票金,17,0,17,元大-台南,2023-07-31,9896
1402,遠東新,17,0,17,元大-台南,2023-07-31,9896
3265,台星科,18,1,17,元大-台南,2023-07-31,9896
2369,菱生,30,13,17,元大-台南,2023-07-31,9896
2883,凱基金,18,1,17,元大-台南,2023-07-31,9896
2890,永豐金,19,3,16,元大-台南,2023-07-31,9896
3033,威健,16,0,16,元大-台南,2023-07-31,9896
8358,金居,62,46,16,元大-台南,2023-07-31,9896
3443,創意,16,0,16,元大-台南,2023-07-31,9896
00706L,期元大S＆P日圓正2,16,0,16,元大-台南,2023-07-31,9896
4908,前鼎,22,6,16,元大-台南,2023-07-31,9896
4572,駐龍,18,2,16,元大-台南,2023-07-31,9896
2027,大成鋼,101,3,98,元大-台南,2023-08-01,9896
00878,國泰永續高股息,183,92,91,元大-台南,2023-08-01,9896
00885,富邦越南,99,8,91,元大-台南,2023-08-01,9896
00673R,期元大S＆P原油反1,67,0,67,元大-台南,2023-08-01,9896
5388,中磊,69,15,54,元大-台南,2023-08-01,9896
6282,康舒,96,42,54,元大-台南,2023-08-01,9896
00929,復華台灣科技優息,51,5,46,元大-台南,2023-08-01,9896
00712,復華富時不動產,43,3,40,元大-台南,2023-08-01,9896
2312,金寶,45,7,38,元大-台南,2023-08-01,9896
1815,富喬,41,5,36,元大-台南,2023-08-01,9896
4402,郡都開發,34,0,34,元大-台南,2023-08-01,9896
3049,精金,35,1,34,元大-台南,2023-08-01,9896
3481,群創,97,65,32,元大-台南,2023-08-01,9896
3033,威健,38,7,31,元大-台南,2023-08-01,9896
1305,華夏,29,1,28,元大-台南,2023-08-01,9896
8215,明基材,27,0,27,元大-台南,2023-08-01,9896
1905,華紙,33,7,26,元大-台南,2023-08-01,9896
9939,宏全,25,0,25,元大-台南,2023-08-01,9896
3032,偉訓,49,24,25,元大-台南,2023-08-01,9896
8049,晶采,22,0,22,元大-台南,2023-08-01,9896
2891,中信金,20,1,19,元大-台南,2023-08-01,9896
1907,永豐餘,22,4,18,元大-台南,2023-08-01,9896
00882,中信中國高股息,25,8,17,元大-台南,2023-08-01,9896
1513,中興電,30,14,16,元大-台南,2023-08-01,9896
1504,東元,16,0,16,元大-台南,2023-08-01,9896
3706,神達,57,41,16,元大-台南,2023-08-01,9896
6669,緯穎,16,1,15,元大-台南,2023-08-01,9896
6005,群益證,15,0,15,元大-台南,2023-08-01,9896
6218,豪勉,18,4,14,元大-台南,2023-08-01,9896
2401,凌陽,29,16,13,元大-台南,2023-08-01,9896
3583,辛耘,20,7,13,元大-台南,2023-08-01,9896
6239,力成,12,0,12,元大-台南,2023-08-01,9896
8940,新天地,12,0,12,元大-台南,2023-08-01,9896
00713,元大台灣高息低波,12,1,11,元大-台南,2023-08-01,9896
6147,頎邦,24,13,11,元大-台南,2023-08-01,9896
3209,全科,15,4,11,元大-台南,2023-08-01,9896
2405,輔信,24,13,11,元大-台南,2023-08-01,9896
2603,長榮,14,4,10,元大-台南,2023-08-01,9896
00896,中信綠能及電動車,10,0,10,元大-台南,2023-08-01,9896
1309,台達化,10,0,10,元大-台南,2023-08-01,9896
5243,乙盛-KY,10,0,10,元大-台南,2023-08-01,9896
5512,力麒,185,175,10,元大-台南,2023-08-01,9896
2444,兆勁,10,0,10,元大-台南,2023-08-01,9896
00679B,元大美債20年,11,1,10,元大-台南,2023-08-01,9896
8112,至上,10,0,10,元大-台南,2023-08-01,9896
1709,和益,10,0,10,元大-台南,2023-08-01,9896
2605,新興,10,0,10,元大-台南,2023-08-01,9896
2601,益航,9,0,9,元大-台南,2023-08-01,9896
8028,昇陽半導體,9,0,9,元大-台南,2023-08-01,9896
2402,毅嘉,30,21,9,元大-台南,2023-08-01,9896
2317,鴻海,318,8,310,元大-台南,2023-08-02,9896
00637L,元大滬深300正2,317,9,308,元大-台南,2023-08-02,9896
00929,復華台灣科技優息,151,1,150,元大-台南,2023-08-02,9896
4746,台耀,163,24,139,元大-台南,2023-08-02,9896
00673R,期元大S＆P原油反1,131,15,116,元大-台南,2023-08-02,9896
0056,元大高股息,197,85,112,元大-台南,2023-08-02,9896
2880,華南金,105,0,105,元大-台南,2023-08-02,9896
2344,華邦電,99,4,95,元大-台南,2023-08-02,9896
00679B,元大美債20年,93,13,80,元大-台南,2023-08-02,9896
6282,康舒,103,24,79,元大-台南,2023-08-02,9896
00900,富邦特選高股息30,90,14,76,元大-台南,2023-08-02,9896
2888,新光金,92,19,73,元大-台南,2023-08-02,9896
00680L,元大美債20正2,71,0,71,元大-台南,2023-08-02,9896
00772B,中信高評級公司債,56,0,56,元大-台南,2023-08-02,9896
2913,農林,149,94,55,元大-台南,2023-08-02,9896
2301,光寶科,72,17,55,元大-台南,2023-08-02,9896
2353,宏��,62,11,51,元大-台南,2023-08-02,9896
2312,金寶,56,7,49,元大-台南,2023-08-02,9896
2002,中鋼,48,0,48,元大-台南,2023-08-02,9896
6116,彩晶,54,7,47,元大-台南,2023-08-02,9896
2834,臺企銀,45,1,44,元大-台南,2023-08-02,9896
00923,群益台ESG低碳50,54,10,44,元大-台南,2023-08-02,9896
1605,華新,307,265,42,元大-台南,2023-08-02,9896
00671R,富邦NASDAQ反1,40,0,40,元大-台南,2023-08-02,9896
00720B,元大投資級公司債,39,1,38,元大-台南,2023-08-02,9896
2033,佳大,37,0,37,元大-台南,2023-08-02,9896
00930,永豐ESG低碳高息,36,0,36,元大-台南,2023-08-02,9896
2867,三商壽,44,10,34,元大-台南,2023-08-02,9896
5880,合庫金,33,0,33,元大-台南,2023-08-02,9896
2881,富邦金,43,11,32,元大-台南,2023-08-02,9896
00751B,元大AAA至A公司債,31,0,31,元大-台南,2023-08-02,9896
1314,中石化,40,9,31,元大-台南,2023-08-02,9896
0055,元大MSCI金融,25,0,25,元大-台南,2023-08-02,9896
2605,新興,26,1,25,元大-台南,2023-08-02,9896
3049,精金,24,0,24,元大-台南,2023-08-02,9896
1402,遠東新,23,0,23,元大-台南,2023-08-02,9896
3231,緯創,90,67,23,元大-台南,2023-08-02,9896
3706,神達,35,12,23,元大-台南,2023-08-02,9896
2409,友達,25,3,22,元大-台南,2023-08-02,9896
2324,仁寶,30,8,22,元大-台南,2023-08-02,9896
8390,金益鼎,34,12,22,元大-台南,2023-08-02,9896
3006,晶豪科,21,0,21,元大-台南,2023-08-02,9896
6187,萬潤,24,4,20,元大-台南,2023-08-02,9896
2610,華航,45,25,20,元大-台南,2023-08-02,9896
00919,群益台灣精選高息,21,1,20,元大-台南,2023-08-02,9896
00773B,中信優先金融債,20,0,20,元大-台南,2023-08-02,9896
00907,永豐優息存股,18,0,18,元大-台南,2023-08-02,9896
2731,雄獅,21,3,18,元大-台南,2023-08-02,9896
2812,台中銀,18,0,18,元大-台南,2023-08-02,9896
8215,明基材,34,16,18,元大-台南,2023-08-02,9896
00688L,國泰20年美債正2,537,0,537,元大-台南,2023-08-04,9896
00680L,元大美債20正2,391,4,387,元大-台南,2023-08-04,9896
1609,大亞,305,39,266,元大-台南,2023-08-04,9896
00679B,元大美債20年,164,7,157,元大-台南,2023-08-04,9896
00720B,元大投資級公司債,233,79,154,元大-台南,2023-08-04,9896
2891,中信金,123,14,109,元大-台南,2023-08-04,9896
2344,華邦電,119,13,106,元大-台南,2023-08-04,9896
00751B,元大AAA至A公司債,87,5,82,元大-台南,2023-08-04,9896
00900,富邦特選高股息30,86,11,75,元大-台南,2023-08-04,9896
00687B,國泰20年美債,70,0,70,元大-台南,2023-08-04,9896
00712,復華富時不動產,72,3,69,元大-台南,2023-08-04,9896
00878,國泰永續高股息,125,64,61,元大-台南,2023-08-04,9896
00795B,中信美國公債20年,58,0,58,元大-台南,2023-08-04,9896
00923,群益台ESG低碳50,57,2,55,元大-台南,2023-08-04,9896
2027,大成鋼,56,4,52,元大-台南,2023-08-04,9896
00929,復華台灣科技優息,49,3,46,元大-台南,2023-08-04,9896
2913,農林,85,41,44,元大-台南,2023-08-04,9896
1785,光洋科,62,19,43,元大-台南,2023-08-04,9896
4402,郡都開發,39,0,39,元大-台南,2023-08-04,9896
00772B,中信高評級公司債,33,1,32,元大-台南,2023-08-04,9896
2401,凌陽,30,0,30,元大-台南,2023-08-04,9896
3231,緯創,134,107,27,元大-台南,2023-08-04,9896
2888,新光金,68,41,27,元大-台南,2023-08-04,9896
00722B,群益投資級電信債,24,0,24,元大-台南,2023-08-04,9896
2353,宏��,45,22,23,元大-台南,2023-08-04,9896
1326,台化,21,0,21,元大-台南,2023-08-04,9896
4746,台耀,24,3,21,元大-台南,2023-08-04,9896
3704,合勤控,23,2,21,元大-台南,2023-08-04,9896
00924,復華S＆P500成長,29,9,20,元大-台南,2023-08-04,9896
1815,富喬,22,2,20,元大-台南,2023-08-04,9896
1504,東元,26,6,20,元大-台南,2023-08-04,9896
2356,英業達,85,66,19,元大-台南,2023-08-04,9896
00882,中信中國高股息,29,11,18,元大-台南,2023-08-04,9896
00650L,復華香港正2,16,0,16,元大-台南,2023-08-04,9896
2801,彰銀,15,0,15,元大-台南,2023-08-04,9896
00725B,國泰投資級公司債,15,0,15,元大-台南,2023-08-04,9896
3169,亞信,15,0,15,元大-台南,2023-08-04,9896
2884,玉山金,17,2,15,元大-台南,2023-08-04,9896
1795,美時,14,0,14,元大-台南,2023-08-04,9896
00891,中信關鍵半導體,14,0,14,元大-台南,2023-08-04,9896
1216,統一,15,1,14,元大-台南,2023-08-04,9896
6284,佳邦,14,0,14,元大-台南,2023-08-04,9896
1905,華紙,36,22,14,元大-台南,2023-08-04,9896
2609,陽明,29,16,13,元大-台南,2023-08-04,9896
00764B,群益25年美債,13,0,13,元大-台南,2023-08-04,9896
5347,世界,17,4,13,元大-台南,2023-08-04,9896
1532,勤美,12,0,12,元大-台南,2023-08-04,9896
4906,正文,13,1,12,元大-台南,2023-08-04,9896
4113,聯上,11,0,11,元大-台南,2023-08-04,9896
2201,裕隆,11,0,11,元大-台南,2023-08-04,9896
00632R,元大台灣50反1,232,0,232,元大-台南,2023-08-07,9896
00929,復華台灣科技優息,129,9,120,元大-台南,2023-08-07,9896
00680L,元大美債20正2,109,26,83,元大-台南,2023-08-07,9896
3706,神達,176,95,81,元大-台南,2023-08-07,9896
00878,國泰永續高股息,138,73,65,元大-台南,2023-08-07,9896
00900,富邦特選高股息30,74,10,64,元大-台南,2023-08-07,9896
00753L,中信中國50正2,75,12,63,元大-台南,2023-08-07,9896
00931B,統一美債20年,59,0,59,元大-台南,2023-08-07,9896
2801,彰銀,61,2,59,元大-台南,2023-08-07,9896
2027,大成鋼,56,4,52,元大-台南,2023-08-07,9896
2401,凌陽,56,6,50,元大-台南,2023-08-07,9896
2610,華航,56,9,47,元大-台南,2023-08-07,9896
2618,長榮航,102,60,42,元大-台南,2023-08-07,9896
00751B,元大AAA至A公司債,37,0,37,元大-台南,2023-08-07,9896
00722B,群益投資級電信債,30,0,30,元大-台南,2023-08-07,9896
00673R,期元大S＆P原油反1,30,0,30,元大-台南,2023-08-07,9896
6550,北極星藥業-KY,30,0,30,元大-台南,2023-08-07,9896
2913,農林,83,54,29,元大-台南,2023-08-07,9896
2317,鴻海,30,1,29,元大-台南,2023-08-07,9896
00679B,元大美債20年,43,14,29,元大-台南,2023-08-07,9896
6869,雲豹能源,27,0,27,元大-台南,2023-08-07,9896
1326,台化,26,0,26,元大-台南,2023-08-07,9896
00720B,元大投資級公司債,23,0,23,元大-台南,2023-08-07,9896
2323,中環,24,2,22,元大-台南,2023-08-07,9896
1815,富喬,22,0,22,元大-台南,2023-08-07,9896
00772B,中信高評級公司債,21,0,21,元大-台南,2023-08-07,9896
00923,群益台ESG低碳50,19,0,19,元大-台南,2023-08-07,9896
1907,永豐餘,22,4,18,元大-台南,2023-08-07,9896
00888,永豐台灣ESG,17,0,17,元大-台南,2023-08-07,9896
3017,奇鋐,43,27,16,元大-台南,2023-08-07,9896
2867,三商壽,15,0,15,元大-台南,2023-08-07,9896
2885,元大金,17,3,14,元大-台南,2023-08-07,9896
6579,研揚,16,2,14,元大-台南,2023-08-07,9896
2002,中鋼,18,4,14,元大-台南,2023-08-07,9896
1216,統一,13,0,13,元大-台南,2023-08-07,9896
1904,正隆,20,7,13,元大-台南,2023-08-07,9896
6116,彩晶,13,0,13,元大-台南,2023-08-07,9896
2630,亞航,22,9,13,元大-台南,2023-08-07,9896
1795,美時,21,8,13,元大-台南,2023-08-07,9896
2645,長榮航太,12,0,12,元大-台南,2023-08-07,9896
1446,宏和,12,0,12,元大-台南,2023-08-07,9896
00924,復華S＆P500成長,12,0,12,元大-台南,2023-08-07,9896
2352,佳世達,46,34,12,元大-台南,2023-08-07,9896
2886,兆豐金,12,1,11,元大-台南,2023-08-07,9896
2425,承啟,18,7,11,元大-台南,2023-08-07,9896
1905,華紙,44,34,10,元大-台南,2023-08-07,9896
8940,新天地,10,0,10,元大-台南,2023-08-07,9896
1218,泰山,10,0,10,元大-台南,2023-08-07,9896
2204,中華,10,0,10,元大-台南,2023-08-07,9896
1515,力山,10,0,10,元大-台南,2023-08-07,9896
2618,長榮航,613,334,279,元大-台南,2023-08-08,9896
3231,緯創,316,116,200,元大-台南,2023-08-08,9896
00929,復華台灣科技優息,164,0,164,元大-台南,2023-08-08,9896
2834,臺企銀,121,0,121,元大-台南,2023-08-08,9896
00900,富邦特選高股息30,152,33,119,元大-台南,2023-08-08,9896
2890,永豐金,85,0,85,元大-台南,2023-08-08,9896
2867,三商壽,72,0,72,元大-台南,2023-08-08,9896
3032,偉訓,89,20,69,元大-台南,2023-08-08,9896
2883,凱基金,68,0,68,元大-台南,2023-08-08,9896
5864,致和證,76,12,64,元大-台南,2023-08-08,9896
00923,群益台ESG低碳50,49,0,49,元大-台南,2023-08-08,9896
00931B,統一美債20年,48,1,47,元大-台南,2023-08-08,9896
00878,國泰永續高股息,100,57,43,元大-台南,2023-08-08,9896
2356,英業達,156,114,42,元大-台南,2023-08-08,9896
2382,廣達,100,67,33,元大-台南,2023-08-08,9896
2313,華通,30,4,26,元大-台南,2023-08-08,9896
2891,中信金,24,0,24,元大-台南,2023-08-08,9896
4402,郡都開發,24,0,24,元大-台南,2023-08-08,9896
00665L,富邦�琤肭磪囓�2,24,0,24,元大-台南,2023-08-08,9896
2801,彰銀,34,10,24,元大-台南,2023-08-08,9896
2303,聯電,24,1,23,元大-台南,2023-08-08,9896
00882,中信中國高股息,22,0,22,元大-台南,2023-08-08,9896
2337,旺宏,23,1,22,元大-台南,2023-08-08,9896
2371,大同,37,15,22,元大-台南,2023-08-08,9896
00679B,元大美債20年,22,0,22,元大-台南,2023-08-08,9896
1795,美時,22,1,21,元大-台南,2023-08-08,9896
00907,永豐優息存股,20,0,20,元大-台南,2023-08-08,9896
3163,波若威,32,12,20,元大-台南,2023-08-08,9896
0055,元大MSCI金融,20,0,20,元大-台南,2023-08-08,9896
5272,笙科,19,0,19,元大-台南,2023-08-08,9896
6806,森崴能源,23,5,18,元大-台南,2023-08-08,9896
2880,華南金,18,0,18,元大-台南,2023-08-08,9896
1907,永豐餘,18,0,18,元大-台南,2023-08-08,9896
4114,健喬,17,0,17,元大-台南,2023-08-08,9896
2388,威盛,29,12,17,元大-台南,2023-08-08,9896
00795B,中信美國公債20年,17,0,17,元大-台南,2023-08-08,9896
00891,中信關鍵半導體,19,3,16,元大-台南,2023-08-08,9896
2915,潤泰全,15,0,15,元大-台南,2023-08-08,9896
1504,東元,15,0,15,元大-台南,2023-08-08,9896
2330,台積電,19,4,15,元大-台南,2023-08-08,9896
3306,鼎天,14,0,14,元大-台南,2023-08-08,9896
6282,康舒,18,4,14,元大-台南,2023-08-08,9896
00738U,期元大道瓊白銀,14,0,14,元大-台南,2023-08-08,9896
6770,力積電,13,0,13,元大-台南,2023-08-08,9896
2014,中鴻,19,6,13,元大-台南,2023-08-08,9896
6213,聯茂,13,0,13,元大-台南,2023-08-08,9896
6139,亞翔,19,6,13,元大-台南,2023-08-08,9896
2887,台新金,13,2,11,元大-台南,2023-08-08,9896
8938,明安,11,0,11,元大-台南,2023-08-08,9896
00892,富邦台灣半導體,11,0,11,元大-台南,2023-08-08,9896
00679B,元大美債20年,216,2,214,元大-台南,2023-08-09,9896
2374,佳能,168,1,167,元大-台南,2023-08-09,9896
2618,長榮航,176,14,162,元大-台南,2023-08-09,9896
2888,新光金,159,3,156,元大-台南,2023-08-09,9896
00929,復華台灣科技優息,143,15,128,元大-台南,2023-08-09,9896
2027,大成鋼,64,0,64,元大-台南,2023-08-09,9896
2610,華航,137,75,62,元大-台南,2023-08-09,9896
8942,森鉅,68,10,58,元大-台南,2023-08-09,9896
00900,富邦特選高股息30,64,7,57,元大-台南,2023-08-09,9896
00673R,期元大S＆P原油反1,52,0,52,元大-台南,2023-08-09,9896
3702,大聯大,51,1,50,元大-台南,2023-08-09,9896
00753L,中信中國50正2,45,0,45,元大-台南,2023-08-09,9896
2353,宏��,72,35,37,元大-台南,2023-08-09,9896
00919,群益台灣精選高息,35,0,35,元大-台南,2023-08-09,9896
8446,華研,36,1,35,元大-台南,2023-08-09,9896
00923,群益台ESG低碳50,28,0,28,元大-台南,2023-08-09,9896
2481,強茂,33,6,27,元大-台南,2023-08-09,9896
2867,三商壽,27,0,27,元大-台南,2023-08-09,9896
2913,農林,75,48,27,元大-台南,2023-08-09,9896
2376,技嘉,48,22,26,元大-台南,2023-08-09,9896
00878,國泰永續高股息,75,49,26,元大-台南,2023-08-09,9896
2890,永豐金,28,5,23,元大-台南,2023-08-09,9896
2323,中環,26,5,21,元大-台南,2023-08-09,9896
00637L,元大滬深300正2,33,13,20,元大-台南,2023-08-09,9896
4113,聯上,20,0,20,元大-台南,2023-08-09,9896
2812,台中銀,20,0,20,元大-台南,2023-08-09,9896
1736,喬山,21,2,19,元大-台南,2023-08-09,9896
1605,華新,20,2,18,元大-台南,2023-08-09,9896
2344,華邦電,17,0,17,元大-台南,2023-08-09,9896
2002,中鋼,16,0,16,元大-台南,2023-08-09,9896
2609,陽明,18,2,16,元大-台南,2023-08-09,9896
2317,鴻海,20,4,16,元大-台南,2023-08-09,9896
2303,聯電,19,4,15,元大-台南,2023-08-09,9896
00688L,國泰20年美債正2,15,0,15,元大-台南,2023-08-09,9896
1101,台泥,14,0,14,元大-台南,2023-08-09,9896
9951,皇田,14,0,14,元大-台南,2023-08-09,9896
00888,永豐台灣ESG,13,0,13,元大-台南,2023-08-09,9896
8049,晶采,13,0,13,元大-台南,2023-08-09,9896
6182,合晶,16,3,13,元大-台南,2023-08-09,9896
1210,大成,17,5,12,元大-台南,2023-08-09,9896
1905,華紙,13,1,12,元大-台南,2023-08-09,9896
9938,百和,12,0,12,元大-台南,2023-08-09,9896
2851,中再保,12,0,12,元大-台南,2023-08-09,9896
2883,凱基金,12,0,12,元大-台南,2023-08-09,9896
2314,台揚,12,0,12,元大-台南,2023-08-09,9896
1722,台肥,12,0,12,元大-台南,2023-08-09,9896
00891,中信關鍵半導體,11,0,11,元大-台南,2023-08-09,9896
4934,太極,15,4,11,元大-台南,2023-08-09,9896
6005,群益證,11,0,11,元大-台南,2023-08-09,9896
00927,群益半導體收益,11,0,11,元大-台南,2023-08-09,9896
00900,富邦特選高股息30,310,10,300,元大-台南,2023-08-10,9896
8112,至上,233,51,182,元大-台南,2023-08-10,9896
2888,新光金,1206,1048,158,元大-台南,2023-08-10,9896
00878,國泰永續高股息,239,87,152,元大-台南,2023-08-10,9896
00929,復華台灣科技優息,154,2,152,元大-台南,2023-08-10,9896
1305,華夏,103,0,103,元大-台南,2023-08-10,9896
2027,大成鋼,107,6,101,元大-台南,2023-08-10,9896
00931B,統一美債20年,88,1,87,元大-台南,2023-08-10,9896
00673R,期元大S＆P原油反1,72,0,72,元大-台南,2023-08-10,9896
00720B,元大投資級公司債,109,41,68,元大-台南,2023-08-10,9896
6770,力積電,62,1,61,元大-台南,2023-08-10,9896
2610,華航,76,16,60,元大-台南,2023-08-10,9896
1440,南紡,57,1,56,元大-台南,2023-08-10,9896
2002,中鋼,54,1,53,元大-台南,2023-08-10,9896
1609,大亞,45,4,41,元大-台南,2023-08-10,9896
1605,華新,42,5,37,元大-台南,2023-08-10,9896
00923,群益台ESG低碳50,37,0,37,元大-台南,2023-08-10,9896
3032,偉訓,75,40,35,元大-台南,2023-08-10,9896
6282,康舒,121,87,34,元大-台南,2023-08-10,9896
00751B,元大AAA至A公司債,35,2,33,元大-台南,2023-08-10,9896
2409,友達,32,2,30,元大-台南,2023-08-10,9896
2208,台船,48,20,28,元大-台南,2023-08-10,9896
2883,凱基金,37,11,26,元大-台南,2023-08-10,9896
1504,東元,26,0,26,元大-台南,2023-08-10,9896
4961,天鈺,27,2,25,元大-台南,2023-08-10,9896
2614,東森,25,0,25,元大-台南,2023-08-10,9896
2886,兆豐金,34,10,24,元大-台南,2023-08-10,9896
5880,合庫金,23,0,23,元大-台南,2023-08-10,9896
3266,昇陽,23,0,23,元大-台南,2023-08-10,9896
00888,永豐台灣ESG,23,1,22,元大-台南,2023-08-10,9896
2324,仁寶,21,0,21,元大-台南,2023-08-10,9896
2317,鴻海,28,7,21,元大-台南,2023-08-10,9896
00882,中信中國高股息,20,0,20,元大-台南,2023-08-10,9896
1516,川飛,20,0,20,元大-台南,2023-08-10,9896
8028,昇陽半導體,20,0,20,元大-台南,2023-08-10,9896
2363,矽統,45,26,19,元大-台南,2023-08-10,9896
4111,濟生,18,0,18,元大-台南,2023-08-10,9896
2303,聯電,20,2,18,元大-台南,2023-08-10,9896
00637L,元大滬深300正2,16,0,16,元大-台南,2023-08-10,9896
2312,金寶,18,2,16,元大-台南,2023-08-10,9896
00881,國泰台灣5G+,16,0,16,元大-台南,2023-08-10,9896
6156,松上,18,2,16,元大-台南,2023-08-10,9896
00919,群益台灣精選高息,36,20,16,元大-台南,2023-08-10,9896
6104,創惟,14,1,13,元大-台南,2023-08-10,9896
6116,彩晶,14,1,13,元大-台南,2023-08-10,9896
2201,裕隆,13,0,13,元大-台南,2023-08-10,9896
2352,佳世達,16,4,12,元大-台南,2023-08-10,9896
8050,廣積,23,11,12,元大-台南,2023-08-10,9896
4564,元翎,12,0,12,元大-台南,2023-08-10,9896
2731,雄獅,15,3,12,元大-台南,2023-08-10,9896
2892,第一金,147,0,147,元大-台南,2023-08-11,9896
8112,至上,182,43,139,元大-台南,2023-08-11,9896
00929,復華台灣科技優息,94,1,93,元大-台南,2023-08-11,9896
2027,大成鋼,98,14,84,元大-台南,2023-08-11,9896
00679B,元大美債20年,73,0,73,元大-台南,2023-08-11,9896
00931B,統一美債20年,72,0,72,元大-台南,2023-08-11,9896
2317,鴻海,55,9,46,元大-台南,2023-08-11,9896
2883,凱基金,42,0,42,元大-台南,2023-08-11,9896
2888,新光金,71,30,41,元大-台南,2023-08-11,9896
5512,力麒,124,84,40,元大-台南,2023-08-11,9896
00751B,元大AAA至A公司債,36,0,36,元大-台南,2023-08-11,9896
00900,富邦特選高股息30,47,13,34,元大-台南,2023-08-11,9896
2801,彰銀,33,0,33,元大-台南,2023-08-11,9896
00687B,國泰20年美債,33,0,33,元大-台南,2023-08-11,9896
00680L,元大美債20正2,60,30,30,元大-台南,2023-08-11,9896
3032,偉訓,43,15,28,元大-台南,2023-08-11,9896
2614,東森,25,0,25,元大-台南,2023-08-11,9896
2323,中環,30,5,25,元大-台南,2023-08-11,9896
1609,大亞,33,10,23,元大-台南,2023-08-11,9896
00772B,中信高評級公司債,24,1,23,元大-台南,2023-08-11,9896
3231,緯創,104,82,22,元大-台南,2023-08-11,9896
2002,中鋼,24,3,21,元大-台南,2023-08-11,9896
9951,皇田,25,5,20,元大-台南,2023-08-11,9896
2885,元大金,21,1,20,元大-台南,2023-08-11,9896
1795,美時,25,6,19,元大-台南,2023-08-11,9896
2731,雄獅,24,5,19,元大-台南,2023-08-11,9896
00878,國泰永續高股息,41,22,19,元大-台南,2023-08-11,9896
00923,群益台ESG低碳50,18,0,18,元大-台南,2023-08-11,9896
1312,國喬,22,5,17,元大-台南,2023-08-11,9896
00706L,期元大S＆P日圓正2,17,0,17,元大-台南,2023-08-11,9896
2618,長榮航,77,61,16,元大-台南,2023-08-11,9896
00665L,富邦�琤肭磪囓�2,19,4,15,元大-台南,2023-08-11,9896
00786B,元大10年IG銀行債,14,0,14,元大-台南,2023-08-11,9896
2458,義隆,17,3,14,元大-台南,2023-08-11,9896
1815,富喬,13,0,13,元大-台南,2023-08-11,9896
1714,和桐,14,1,13,元大-台南,2023-08-11,9896
3078,僑威,42,30,12,元大-台南,2023-08-11,9896
2356,英業達,59,48,11,元大-台南,2023-08-11,9896
00764B,群益25年美債,11,0,11,元大-台南,2023-08-11,9896
6116,彩晶,13,2,11,元大-台南,2023-08-11,9896
2606,裕民,13,2,11,元大-台南,2023-08-11,9896
2405,輔信,21,10,11,元大-台南,2023-08-11,9896
2330,台積電,14,3,11,元大-台南,2023-08-11,9896
2890,永豐金,13,2,11,元大-台南,2023-08-11,9896
1907,永豐餘,10,0,10,元大-台南,2023-08-11,9896
00795B,中信美國公債20年,10,0,10,元大-台南,2023-08-11,9896
6509,聚和,10,0,10,元大-台南,2023-08-11,9896
6443,元晶,11,1,10,元大-台南,2023-08-11,9896
00746B,富邦A級公司債,10,0,10,元大-台南,2023-08-11,9896
1611,中電,11,1,10,元大-台南,2023-08-11,9896
2618,長榮航,266,16,250,元大-台南,2023-08-14,9896
00900,富邦特選高股息30,237,1,236,元大-台南,2023-08-14,9896
00929,復華台灣科技優息,233,6,227,元大-台南,2023-08-14,9896
2610,華航,124,15,109,元大-台南,2023-08-14,9896
00753L,中信中國50正2,92,0,92,元大-台南,2023-08-14,9896
2323,中環,60,6,54,元大-台南,2023-08-14,9896
00923,群益台ESG低碳50,50,0,50,元大-台南,2023-08-14,9896
1701,中化,50,1,49,元大-台南,2023-08-14,9896
5457,宣德,50,1,49,元大-台南,2023-08-14,9896
2344,華邦電,56,15,41,元大-台南,2023-08-14,9896
2887,台新金,38,0,38,元大-台南,2023-08-14,9896
3231,緯創,135,98,37,元大-台南,2023-08-14,9896
2812,台中銀,34,0,34,元大-台南,2023-08-14,9896
2883,凱基金,59,25,34,元大-台南,2023-08-14,9896
00680L,元大美債20正2,34,2,32,元大-台南,2023-08-14,9896
2201,裕隆,32,0,32,元大-台南,2023-08-14,9896
00641R,富邦日本反1,30,0,30,元大-台南,2023-08-14,9896
2027,大成鋼,40,11,29,元大-台南,2023-08-14,9896
5512,力麒,110,84,26,元大-台南,2023-08-14,9896
2204,中華,45,21,24,元大-台南,2023-08-14,9896
2891,中信金,70,48,22,元大-台南,2023-08-14,9896
1718,中纖,22,0,22,元大-台南,2023-08-14,9896
2352,佳世達,24,3,21,元大-台南,2023-08-14,9896
8349,�矬�,21,0,21,元大-台南,2023-08-14,9896
00751B,元大AAA至A公司債,22,1,21,元大-台南,2023-08-14,9896
00671R,富邦NASDAQ反1,20,0,20,元大-台南,2023-08-14,9896
2634,漢翔,20,1,19,元大-台南,2023-08-14,9896
2609,陽明,37,18,19,元大-台南,2023-08-14,9896
2504,國產,18,0,18,元大-台南,2023-08-14,9896
00919,群益台灣精選高息,18,0,18,元大-台南,2023-08-14,9896
6245,立端,19,2,17,元大-台南,2023-08-14,9896
1565,精華,17,0,17,元大-台南,2023-08-14,9896
00679B,元大美債20年,17,0,17,元大-台南,2023-08-14,9896
2885,元大金,20,4,16,元大-台南,2023-08-14,9896
00665L,富邦�琤肭磪囓�2,16,0,16,元大-台南,2023-08-14,9896
2329,華泰,18,2,16,元大-台南,2023-08-14,9896
5864,致和證,22,6,16,元大-台南,2023-08-14,9896
9907,統一實,16,0,16,元大-台南,2023-08-14,9896
5880,合庫金,16,1,15,元大-台南,2023-08-14,9896
2881,富邦金,16,1,15,元大-台南,2023-08-14,9896
2495,普安,16,1,15,元大-台南,2023-08-14,9896
1785,光洋科,14,0,14,元大-台南,2023-08-14,9896
2880,華南金,15,1,14,元大-台南,2023-08-14,9896
3706,神達,49,36,13,元大-台南,2023-08-14,9896
2801,彰銀,13,0,13,元大-台南,2023-08-14,9896
2538,基泰,13,0,13,元大-台南,2023-08-14,9896
4933,友輝,13,0,13,元大-台南,2023-08-14,9896
9945,潤泰新,12,0,12,元大-台南,2023-08-14,9896
3049,精金,39,27,12,元大-台南,2023-08-14,9896
1810,和成,12,0,12,元大-台南,2023-08-14,9896
00929,復華台灣科技優息,296,13,283,元大-台南,2023-08-15,9896
00632R,元大台灣50反1,254,0,254,元大-台南,2023-08-15,9896
2363,矽統,315,109,206,元大-台南,2023-08-15,9896
00650L,復華香港正2,206,2,204,元大-台南,2023-08-15,9896
2382,廣達,289,85,204,元大-台南,2023-08-15,9896
2317,鴻海,163,4,159,元大-台南,2023-08-15,9896
00923,群益台ESG低碳50,144,6,138,元大-台南,2023-08-15,9896
5512,力麒,137,31,106,元大-台南,2023-08-15,9896
1605,華新,105,6,99,元大-台南,2023-08-15,9896
2891,中信金,99,7,92,元大-台南,2023-08-15,9896
00900,富邦特選高股息30,98,18,80,元大-台南,2023-08-15,9896
00878,國泰永續高股息,112,34,78,元大-台南,2023-08-15,9896
6156,松上,97,28,69,元大-台南,2023-08-15,9896
00706L,期元大S＆P日圓正2,55,0,55,元大-台南,2023-08-15,9896
2104,國際中橡,50,0,50,元大-台南,2023-08-15,9896
00720B,元大投資級公司債,37,0,37,元大-台南,2023-08-15,9896
2885,元大金,36,0,36,元大-台南,2023-08-15,9896
3231,緯創,121,87,34,元大-台南,2023-08-15,9896
00679B,元大美債20年,38,5,33,元大-台南,2023-08-15,9896
00712,復華富時不動產,66,33,33,元大-台南,2023-08-15,9896
3049,精金,39,7,32,元大-台南,2023-08-15,9896
2027,大成鋼,35,5,30,元大-台南,2023-08-15,9896
1444,力麗,30,0,30,元大-台南,2023-08-15,9896
6770,力積電,32,3,29,元大-台南,2023-08-15,9896
00881,國泰台灣5G+,26,0,26,元大-台南,2023-08-15,9896
2892,第一金,22,0,22,元大-台南,2023-08-15,9896
00641R,富邦日本反1,20,0,20,元大-台南,2023-08-15,9896
00931B,統一美債20年,19,0,19,元大-台南,2023-08-15,9896
00882,中信中國高股息,21,3,18,元大-台南,2023-08-15,9896
5516,雙喜,18,0,18,元大-台南,2023-08-15,9896
2883,凱基金,32,15,17,元大-台南,2023-08-15,9896
3481,群創,35,18,17,元大-台南,2023-08-15,9896
00722B,群益投資級電信債,17,0,17,元大-台南,2023-08-15,9896
2383,台光電,20,4,16,元大-台南,2023-08-15,9896
00751B,元大AAA至A公司債,18,3,15,元大-台南,2023-08-15,9896
1467,南緯,15,0,15,元大-台南,2023-08-15,9896
2886,兆豐金,15,1,14,元大-台南,2023-08-15,9896
1402,遠東新,14,0,14,元大-台南,2023-08-15,9896
2880,華南金,14,0,14,元大-台南,2023-08-15,9896
3693,營邦,38,25,13,元大-台南,2023-08-15,9896
1102,亞泥,13,0,13,元大-台南,2023-08-15,9896
00888,永豐台灣ESG,14,2,12,元大-台南,2023-08-15,9896
2002,中鋼,13,1,12,元大-台南,2023-08-15,9896
2887,台新金,22,11,11,元大-台南,2023-08-15,9896
00795B,中信美國公債20年,11,0,11,元大-台南,2023-08-15,9896
00673R,期元大S＆P原油反1,11,0,11,元大-台南,2023-08-15,9896
2851,中再保,11,0,11,元大-台南,2023-08-15,9896
2444,兆勁,10,0,10,元大-台南,2023-08-15,9896
8926,台汽電,10,0,10,元大-台南,2023-08-15,9896
00740B,富邦全球投等債,10,0,10,元大-台南,2023-08-15,9896
00929,復華台灣科技優息,808,3,805,元大-台南,2023-08-16,9896
00878,國泰永續高股息,137,22,115,元大-台南,2023-08-16,9896
00900,富邦特選高股息30,94,0,94,元大-台南,2023-08-16,9896
2303,聯電,107,14,93,元大-台南,2023-08-16,9896
00923,群益台ESG低碳50,88,4,84,元大-台南,2023-08-16,9896
00632R,元大台灣50反1,115,43,72,元大-台南,2023-08-16,9896
2618,長榮航,184,117,67,元大-台南,2023-08-16,9896
2913,農林,71,13,58,元大-台南,2023-08-16,9896
00679B,元大美債20年,55,7,48,元大-台南,2023-08-16,9896
2891,中信金,75,27,48,元大-台南,2023-08-16,9896
2374,佳能,46,1,45,元大-台南,2023-08-16,9896
2880,華南金,63,20,43,元大-台南,2023-08-16,9896
1101,台泥,38,1,37,元大-台南,2023-08-16,9896
1519,華城,42,7,35,元大-台南,2023-08-16,9896
00712,復華富時不動產,52,19,33,元大-台南,2023-08-16,9896
00772B,中信高評級公司債,35,2,33,元大-台南,2023-08-16,9896
00931B,統一美債20年,31,0,31,元大-台南,2023-08-16,9896
2002,中鋼,31,1,30,元大-台南,2023-08-16,9896
3706,神達,31,2,29,元大-台南,2023-08-16,9896
5009,榮剛,27,0,27,元大-台南,2023-08-16,9896
2892,第一金,33,7,26,元大-台南,2023-08-16,9896
00751B,元大AAA至A公司債,26,0,26,元大-台南,2023-08-16,9896
2610,華航,42,16,26,元大-台南,2023-08-16,9896
1305,華夏,25,0,25,元大-台南,2023-08-16,9896
2027,大成鋼,49,25,24,元大-台南,2023-08-16,9896
2324,仁寶,76,52,24,元大-台南,2023-08-16,9896
2409,友達,23,0,23,元大-台南,2023-08-16,9896
5457,宣德,22,0,22,元大-台南,2023-08-16,9896
6770,力積電,22,1,21,元大-台南,2023-08-16,9896
1718,中纖,30,10,20,元大-台南,2023-08-16,9896
2883B,凱基金乙特,20,0,20,元大-台南,2023-08-16,9896
2889,國票金,21,1,20,元大-台南,2023-08-16,9896
1440,南紡,20,0,20,元大-台南,2023-08-16,9896
2886,兆豐金,46,27,19,元大-台南,2023-08-16,9896
2881,富邦金,17,0,17,元大-台南,2023-08-16,9896
2801,彰銀,16,0,16,元大-台南,2023-08-16,9896
2890,永豐金,18,2,16,元大-台南,2023-08-16,9896
4113,聯上,16,0,16,元大-台南,2023-08-16,9896
5512,力麒,20,4,16,元大-台南,2023-08-16,9896
2204,中華,15,0,15,元大-台南,2023-08-16,9896
00795B,中信美國公債20年,15,0,15,元大-台南,2023-08-16,9896
8930,青鋼,17,2,15,元大-台南,2023-08-16,9896
2884,玉山金,18,3,15,元大-台南,2023-08-16,9896
2317,鴻海,34,19,15,元大-台南,2023-08-16,9896
0050,元大台灣50,16,1,15,元大-台南,2023-08-16,9896
1301,台塑,18,3,15,元大-台南,2023-08-16,9896
1504,東元,17,3,14,元大-台南,2023-08-16,9896
6275,元山,20,6,14,元大-台南,2023-08-16,9896
00671R,富邦NASDAQ反1,14,0,14,元大-台南,2023-08-16,9896
3205,佰研,15,1,14,元大-台南,2023-08-16,9896
00712,復華富時不動產,159,30,129,元大-台南,2023-08-17,9896
3231,緯創,221,140,81,元大-台南,2023-08-17,9896
00679B,元大美債20年,87,17,70,元大-台南,2023-08-17,9896
00713,元大台灣高息低波,56,5,51,元大-台南,2023-08-17,9896
2880,華南金,55,13,42,元大-台南,2023-08-17,9896
00882,中信中國高股息,47,6,41,元大-台南,2023-08-17,9896
00706L,期元大S＆P日圓正2,37,0,37,元大-台南,2023-08-17,9896
1215,卜蜂,36,3,33,元大-台南,2023-08-17,9896
00687B,國泰20年美債,31,0,31,元大-台南,2023-08-17,9896
2888,新光金,29,0,29,元大-台南,2023-08-17,9896
00637L,元大滬深300正2,28,0,28,元大-台南,2023-08-17,9896
2913,農林,34,7,27,元大-台南,2023-08-17,9896
00751B,元大AAA至A公司債,70,45,25,元大-台南,2023-08-17,9896
00929,復華台灣科技優息,27,2,25,元大-台南,2023-08-17,9896
00931B,統一美債20年,25,0,25,元大-台南,2023-08-17,9896
1305,華夏,25,1,24,元大-台南,2023-08-17,9896
00680L,元大美債20正2,33,10,23,元大-台南,2023-08-17,9896
2363,矽統,84,61,23,元大-台南,2023-08-17,9896
00881,國泰台灣5G+,23,0,23,元大-台南,2023-08-17,9896
2002,中鋼,22,0,22,元大-台南,2023-08-17,9896
3056,富華新,23,1,22,元大-台南,2023-08-17,9896
2834,臺企銀,23,2,21,元大-台南,2023-08-17,9896
2891,中信金,36,15,21,元大-台南,2023-08-17,9896
2618,長榮航,27,6,21,元大-台南,2023-08-17,9896
00795B,中信美國公債20年,20,0,20,元大-台南,2023-08-17,9896
2890,永豐金,20,0,20,元大-台南,2023-08-17,9896
00725B,國泰投資級公司債,24,4,20,元大-台南,2023-08-17,9896
00923,群益台ESG低碳50,18,0,18,元大-台南,2023-08-17,9896
1802,台玻,21,3,18,元大-台南,2023-08-17,9896
8358,金居,30,12,18,元大-台南,2023-08-17,9896
2892,第一金,17,0,17,元大-台南,2023-08-17,9896
00753L,中信中國50正2,17,0,17,元大-台南,2023-08-17,9896
00757,統一FANG+,16,0,16,元大-台南,2023-08-17,9896
1609,大亞,39,23,16,元大-台南,2023-08-17,9896
2881,富邦金,18,2,16,元大-台南,2023-08-17,9896
2883,凱基金,18,3,15,元大-台南,2023-08-17,9896
2610,華航,25,10,15,元大-台南,2023-08-17,9896
1815,富喬,17,2,15,元大-台南,2023-08-17,9896
00772B,中信高評級公司債,36,22,14,元大-台南,2023-08-17,9896
2801,彰銀,15,1,14,元大-台南,2023-08-17,9896
1101,台泥,16,3,13,元大-台南,2023-08-17,9896
1326,台化,15,2,13,元大-台南,2023-08-17,9896
1440,南紡,13,0,13,元大-台南,2023-08-17,9896
00722B,群益投資級電信債,19,6,13,元大-台南,2023-08-17,9896
6125,廣運,50,37,13,元大-台南,2023-08-17,9896
00720B,元大投資級公司債,50,38,12,元大-台南,2023-08-17,9896
6116,彩晶,13,1,12,元大-台南,2023-08-17,9896
2303,聯電,27,15,12,元大-台南,2023-08-17,9896
2356,英業達,82,70,12,元大-台南,2023-08-17,9896
6274,台燿,17,6,11,元大-台南,2023-08-17,9896
2363,矽統,311,127,184,元大-台南,2023-08-18,9896
2419,仲琦,150,3,147,元大-台南,2023-08-18,9896
00929,復華台灣科技優息,131,23,108,元大-台南,2023-08-18,9896
00773B,中信優先金融債,100,0,100,元大-台南,2023-08-18,9896
3231,緯創,214,152,62,元大-台南,2023-08-18,9896
4960,誠美材,60,0,60,元大-台南,2023-08-18,9896
3702,大聯大,62,4,58,元大-台南,2023-08-18,9896
00712,復華富時不動產,69,11,58,元大-台南,2023-08-18,9896
00878,國泰永續高股息,70,17,53,元大-台南,2023-08-18,9896
1102,亞泥,50,0,50,元大-台南,2023-08-18,9896
2332,友訊,95,45,50,元大-台南,2023-08-18,9896
1305,華夏,46,0,46,元大-台南,2023-08-18,9896
00900,富邦特選高股息30,46,1,45,元大-台南,2023-08-18,9896
2324,仁寶,74,31,43,元大-台南,2023-08-18,9896
00669R,國泰美國道瓊反1,52,10,42,元大-台南,2023-08-18,9896
3706,神達,66,24,42,元大-台南,2023-08-18,9896
2382,廣達,105,64,41,元大-台南,2023-08-18,9896
1519,華城,49,9,40,元大-台南,2023-08-18,9896
5512,力麒,115,80,35,元大-台南,2023-08-18,9896
8936,國統,34,2,32,元大-台南,2023-08-18,9896
00772B,中信高評級公司債,30,0,30,元大-台南,2023-08-18,9896
2892,第一金,30,0,30,元大-台南,2023-08-18,9896
5457,宣德,28,1,27,元大-台南,2023-08-18,9896
00720B,元大投資級公司債,32,7,25,元大-台南,2023-08-18,9896
2409,友達,28,3,25,元大-台南,2023-08-18,9896
3264,欣銓,24,0,24,元大-台南,2023-08-18,9896
00673R,期元大S＆P原油反1,25,1,24,元大-台南,2023-08-18,9896
2884,玉山金,26,2,24,元大-台南,2023-08-18,9896
2888,新光金,31,9,22,元大-台南,2023-08-18,9896
3035,智原,31,10,21,元大-台南,2023-08-18,9896
1319,東陽,27,6,21,元大-台南,2023-08-18,9896
2356,英業達,61,41,20,元大-台南,2023-08-18,9896
5864,致和證,20,0,20,元大-台南,2023-08-18,9896
9950,萬國通,20,0,20,元大-台南,2023-08-18,9896
00881,國泰台灣5G+,20,0,20,元大-台南,2023-08-18,9896
2820,華票,21,2,19,元大-台南,2023-08-18,9896
2436,偉詮電,20,2,18,元大-台南,2023-08-18,9896
3704,合勤控,19,1,18,元大-台南,2023-08-18,9896
1101,台泥,25,8,17,元大-台南,2023-08-18,9896
8050,廣積,28,11,17,元大-台南,2023-08-18,9896
1402,遠東新,16,0,16,元大-台南,2023-08-18,9896
00923,群益台ESG低碳50,15,0,15,元大-台南,2023-08-18,9896
2890,永豐金,30,15,15,元大-台南,2023-08-18,9896
2468,華經,15,0,15,元大-台南,2023-08-18,9896
2610,華航,26,12,14,元大-台南,2023-08-18,9896
00751B,元大AAA至A公司債,13,0,13,元大-台南,2023-08-18,9896
00931B,統一美債20年,13,0,13,元大-台南,2023-08-18,9896
2520,冠德,13,0,13,元大-台南,2023-08-18,9896
00738U,期元大道瓊白銀,15,2,13,元大-台南,2023-08-18,9896
2421,建準,47,35,12,元大-台南,2023-08-18,9896
00929,復華台灣科技優息,261,3,258,元大-台南,2023-08-21,9896
6125,廣運,179,22,157,元大-台南,2023-08-21,9896
00753L,中信中國50正2,111,0,111,元大-台南,2023-08-21,9896
2609,陽明,109,4,105,元大-台南,2023-08-21,9896
00632R,元大台灣50反1,100,6,94,元大-台南,2023-08-21,9896
00712,復華富時不動產,72,0,72,元大-台南,2023-08-21,9896
00720B,元大投資級公司債,53,0,53,元大-台南,2023-08-21,9896
2401,凌陽,37,0,37,元大-台南,2023-08-21,9896
2324,仁寶,51,15,36,元大-台南,2023-08-21,9896
2897,王道銀行,33,0,33,元大-台南,2023-08-21,9896
00679B,元大美債20年,56,26,30,元大-台南,2023-08-21,9896
3706,神達,33,8,25,元大-台南,2023-08-21,9896
2382,廣達,64,39,25,元大-台南,2023-08-21,9896
00882,中信中國高股息,26,4,22,元大-台南,2023-08-21,9896
00931B,統一美債20年,21,0,21,元大-台南,2023-08-21,9896
00751B,元大AAA至A公司債,20,0,20,元大-台南,2023-08-21,9896
00680L,元大美債20正2,20,1,19,元大-台南,2023-08-21,9896
2891,中信金,23,4,19,元大-台南,2023-08-21,9896
3013,晟銘電,23,5,18,元大-台南,2023-08-21,9896
2610,華航,40,24,16,元大-台南,2023-08-21,9896
2419,仲琦,17,1,16,元大-台南,2023-08-21,9896
00687B,國泰20年美債,15,0,15,元大-台南,2023-08-21,9896
1301,台塑,14,0,14,元大-台南,2023-08-21,9896
1513,中興電,17,4,13,元大-台南,2023-08-21,9896
00881,國泰台灣5G+,22,9,13,元大-台南,2023-08-21,9896
3512,皇龍,12,0,12,元大-台南,2023-08-21,9896
9904,寶成,13,2,11,元大-台南,2023-08-21,9896
5608,四維航,16,5,11,元大-台南,2023-08-21,9896
00907,永豐優息存股,10,0,10,元大-台南,2023-08-21,9896
6625,必應,10,0,10,元大-台南,2023-08-21,9896
4160,訊聯基因,10,0,10,元大-台南,2023-08-21,9896
2328,廣宇,10,0,10,元大-台南,2023-08-21,9896
2329,華泰,53,43,10,元大-台南,2023-08-21,9896
00638R,元大滬深300反1,10,0,10,元大-台南,2023-08-21,9896
1101,台泥,10,0,10,元大-台南,2023-08-21,9896
2892,第一金,10,1,9,元大-台南,2023-08-21,9896
1504,東元,12,3,9,元大-台南,2023-08-21,9896
2603,長榮,11,2,9,元大-台南,2023-08-21,9896
00665L,富邦�琤肭磪囓�2,21,12,9,元大-台南,2023-08-21,9896
00892,富邦台灣半導體,9,0,9,元大-台南,2023-08-21,9896
6139,亞翔,34,25,9,元大-台南,2023-08-21,9896
6282,康舒,15,6,9,元大-台南,2023-08-21,9896
00772B,中信高評級公司債,8,0,8,元大-台南,2023-08-21,9896
00878,國泰永續高股息,43,35,8,元大-台南,2023-08-21,9896
00795B,中信美國公債20年,8,0,8,元大-台南,2023-08-21,9896
1539,巨庭,8,0,8,元大-台南,2023-08-21,9896
2883,凱基金,12,5,7,元大-台南,2023-08-21,9896
2888,新光金,20,13,7,元大-台南,2023-08-21,9896
2017,官田鋼,11,4,7,元大-台南,2023-08-21,9896
6275,元山,7,0,7,元大-台南,2023-08-21,9896
2363,矽統,211,82,129,元大-台南,2023-08-22,9896
2618,長榮航,148,35,113,元大-台南,2023-08-22,9896
00795B,中信美國公債20年,66,2,64,元大-台南,2023-08-22,9896
00929,復華台灣科技優息,70,15,55,元大-台南,2023-08-22,9896
00773B,中信優先金融債,50,0,50,元大-台南,2023-08-22,9896
00706L,期元大S＆P日圓正2,50,0,50,元大-台南,2023-08-22,9896
2353,宏��,58,16,42,元大-台南,2023-08-22,9896
6142,友勁,40,0,40,元大-台南,2023-08-22,9896
00679B,元大美債20年,41,3,38,元大-台南,2023-08-22,9896
5512,力麒,134,98,36,元大-台南,2023-08-22,9896
2884,玉山金,37,1,36,元大-台南,2023-08-22,9896
2883,凱基金,38,9,29,元大-台南,2023-08-22,9896
1519,華城,55,28,27,元大-台南,2023-08-22,9896
6285,啟��,32,9,23,元大-台南,2023-08-22,9896
00931B,統一美債20年,23,0,23,元大-台南,2023-08-22,9896
00680L,元大美債20正2,22,0,22,元大-台南,2023-08-22,9896
00751B,元大AAA至A公司債,21,0,21,元大-台南,2023-08-22,9896
00670L,富邦NASDAQ正2,20,0,20,元大-台南,2023-08-22,9896
5371,中光電,20,0,20,元大-台南,2023-08-22,9896
5452,佶優,22,4,18,元大-台南,2023-08-22,9896
1504,東元,21,4,17,元大-台南,2023-08-22,9896
6188,廣明,49,33,16,元大-台南,2023-08-22,9896
2892,第一金,16,0,16,元大-台南,2023-08-22,9896
2002,中鋼,34,19,15,元大-台南,2023-08-22,9896
2402,毅嘉,20,5,15,元大-台南,2023-08-22,9896
2915,潤泰全,15,0,15,元大-台南,2023-08-22,9896
6446,藥華藥,20,5,15,元大-台南,2023-08-22,9896
2409,友達,14,0,14,元大-台南,2023-08-22,9896
6548,長科*,14,0,14,元大-台南,2023-08-22,9896
2542,興富發,14,0,14,元大-台南,2023-08-22,9896
1907,永豐餘,15,1,14,元大-台南,2023-08-22,9896
00882,中信中國高股息,14,1,13,元大-台南,2023-08-22,9896
3312,弘憶股,13,0,13,元大-台南,2023-08-22,9896
2356,英業達,57,44,13,元大-台南,2023-08-22,9896
1718,中纖,13,0,13,元大-台南,2023-08-22,9896
6125,廣運,37,24,13,元大-台南,2023-08-22,9896
1609,大亞,16,4,12,元大-台南,2023-08-22,9896
00720B,元大投資級公司債,12,0,12,元大-台南,2023-08-22,9896
2324,仁寶,84,73,11,元大-台南,2023-08-22,9896
2401,凌陽,23,12,11,元大-台南,2023-08-22,9896
1471,首利,13,2,11,元大-台南,2023-08-22,9896
1444,力麗,27,16,11,元大-台南,2023-08-22,9896
2886,兆豐金,12,1,11,元大-台南,2023-08-22,9896
1514,亞力,15,5,10,元大-台南,2023-08-22,9896
1103,嘉泥,10,0,10,元大-台南,2023-08-22,9896
00900,富邦特選高股息30,10,0,10,元大-台南,2023-08-22,9896
6005,群益證,10,0,10,元大-台南,2023-08-22,9896
5864,致和證,10,0,10,元大-台南,2023-08-22,9896
00772B,中信高評級公司債,12,2,10,元大-台南,2023-08-22,9896
3673,TPK-KY,10,0,10,元大-台南,2023-08-22,9896
2449,京元電子,252,39,213,元大-台南,2023-08-23,9896
2618,長榮航,130,38,92,元大-台南,2023-08-23,9896
3013,晟銘電,140,90,50,元大-台南,2023-08-23,9896
2880,華南金,34,0,34,元大-台南,2023-08-23,9896
3689,湧德,30,0,30,元大-台南,2023-08-23,9896
2634,漢翔,61,35,26,元大-台南,2023-08-23,9896
2485,兆赫,34,11,23,元大-台南,2023-08-23,9896
6167,久正,34,13,21,元大-台南,2023-08-23,9896
2392,正崴,21,1,20,元大-台南,2023-08-23,9896
2610,華航,39,20,19,元大-台南,2023-08-23,9896
2882,國泰金,20,2,18,元大-台南,2023-08-23,9896
2382,廣達,44,26,18,元大-台南,2023-08-23,9896
2002,中鋼,18,1,17,元大-台南,2023-08-23,9896
2886,兆豐金,17,1,16,元大-台南,2023-08-23,9896
6282,康舒,39,23,16,元大-台南,2023-08-23,9896
2731,雄獅,15,0,15,元大-台南,2023-08-23,9896
3380,明泰,19,4,15,元大-台南,2023-08-23,9896
2316,楠梓電,15,1,14,元大-台南,2023-08-23,9896
1471,首利,25,11,14,元大-台南,2023-08-23,9896
2630,亞航,32,19,13,元大-台南,2023-08-23,9896
2637,慧洋-KY,16,4,12,元大-台南,2023-08-23,9896
5512,力麒,72,60,12,元大-台南,2023-08-23,9896
5410,國眾,12,0,12,元大-台南,2023-08-23,9896
00753L,中信中國50正2,12,0,12,元大-台南,2023-08-23,9896
3652,精聯,10,0,10,元大-台南,2023-08-23,9896
1532,勤美,10,0,10,元大-台南,2023-08-23,9896
6841,長佳智能,12,2,10,元大-台南,2023-08-23,9896
00665L,富邦�琤肭磪囓�2,40,30,10,元大-台南,2023-08-23,9896
4944,兆遠,10,0,10,元大-台南,2023-08-23,9896
4906,正文,18,8,10,元大-台南,2023-08-23,9896
1504,東元,14,5,9,元大-台南,2023-08-23,9896
8027,鈦昇,14,5,9,元大-台南,2023-08-23,9896
00902,中信電池及儲能,8,0,8,元大-台南,2023-08-23,9896
3483,力致,15,7,8,元大-台南,2023-08-23,9896
3049,精金,97,89,8,元大-台南,2023-08-23,9896
1409,新纖,7,0,7,元大-台南,2023-08-23,9896
5880,合庫金,7,0,7,元大-台南,2023-08-23,9896
00751B,元大AAA至A公司債,8,1,7,元大-台南,2023-08-23,9896
4904,遠傳,7,0,7,元大-台南,2023-08-23,9896
00923,群益台ESG低碳50,7,0,7,元大-台南,2023-08-23,9896
1440,南紡,7,0,7,元大-台南,2023-08-23,9896
00900,富邦特選高股息30,7,0,7,元大-台南,2023-08-23,9896
3071,協禧,23,16,7,元大-台南,2023-08-23,9896
6223,旺矽,7,0,7,元大-台南,2023-08-23,9896
3443,創意,12,5,7,元大-台南,2023-08-23,9896
00772B,中信高評級公司債,6,0,6,元大-台南,2023-08-23,9896
00679B,元大美債20年,10,4,6,元大-台南,2023-08-23,9896
3675,德微,7,1,6,元大-台南,2023-08-23,9896
1701,中化,6,0,6,元大-台南,2023-08-23,9896
2913,農林,16,10,6,元大-台南,2023-08-23,9896
3231,緯創,727,363,364,元大-台南,2023-08-24,9896
00923,群益台ESG低碳50,206,2,204,元大-台南,2023-08-24,9896
6125,廣運,158,19,139,元大-台南,2023-08-24,9896
9950,萬國通,121,2,119,元大-台南,2023-08-24,9896
2609,陽明,113,1,112,元大-台南,2023-08-24,9896
2883,凱基金,109,0,109,元大-台南,2023-08-24,9896
00676R,富邦臺灣加權反1,106,0,106,元大-台南,2023-08-24,9896
00632R,元大台灣50反1,88,0,88,元大-台南,2023-08-24,9896
00929,復華台灣科技優息,92,13,79,元大-台南,2023-08-24,9896
2382,廣達,141,91,50,元大-台南,2023-08-24,9896
2884,玉山金,35,0,35,元大-台南,2023-08-24,9896
00712,復華富時不動產,57,24,33,元大-台南,2023-08-24,9896
00670L,富邦NASDAQ正2,31,0,31,元大-台南,2023-08-24,9896
2399,映泰,31,3,28,元大-台南,2023-08-24,9896
2332,友訊,42,18,24,元大-台南,2023-08-24,9896
3013,晟銘電,49,26,23,元大-台南,2023-08-24,9896
1815,富喬,23,0,23,元大-台南,2023-08-24,9896
6285,啟��,53,30,23,元大-台南,2023-08-24,9896
00679B,元大美債20年,23,1,22,元大-台南,2023-08-24,9896
3051,力特,27,6,21,元大-台南,2023-08-24,9896
2002,中鋼,22,1,21,元大-台南,2023-08-24,9896
00919,群益台灣精選高息,29,11,18,元大-台南,2023-08-24,9896
00888,永豐台灣ESG,18,0,18,元大-台南,2023-08-24,9896
2882,國泰金,17,0,17,元大-台南,2023-08-24,9896
6282,康舒,23,7,16,元大-台南,2023-08-24,9896
5457,宣德,16,0,16,元大-台南,2023-08-24,9896
2402,毅嘉,25,9,16,元大-台南,2023-08-24,9896
2301,光寶科,63,47,16,元大-台南,2023-08-24,9896
2618,長榮航,21,7,14,元大-台南,2023-08-24,9896
00720B,元大投資級公司債,14,1,13,元大-台南,2023-08-24,9896
2303,聯電,26,13,13,元大-台南,2023-08-24,9896
2880,華南金,13,0,13,元大-台南,2023-08-24,9896
3308,聯德,17,4,13,元大-台南,2023-08-24,9896
2356,英業達,77,65,12,元大-台南,2023-08-24,9896
2329,華泰,40,28,12,元大-台南,2023-08-24,9896
4960,誠美材,15,4,11,元大-台南,2023-08-24,9896
00900,富邦特選高股息30,31,20,11,元大-台南,2023-08-24,9896
1701,中化,10,0,10,元大-台南,2023-08-24,9896
1905,華紙,13,3,10,元大-台南,2023-08-24,9896
3034,聯詠,10,0,10,元大-台南,2023-08-24,9896
00882,中信中國高股息,10,0,10,元大-台南,2023-08-24,9896
8210,勤誠,24,14,10,元大-台南,2023-08-24,9896
2888,新光金,10,1,9,元大-台南,2023-08-24,9896
6284,佳邦,10,1,9,元大-台南,2023-08-24,9896
3363,上詮,11,2,9,元大-台南,2023-08-24,9896
3206,志豐,9,0,9,元大-台南,2023-08-24,9896
2897,王道銀行,10,1,9,元大-台南,2023-08-24,9896
5511,德昌,9,0,9,元大-台南,2023-08-24,9896
3035,智原,17,8,9,元大-台南,2023-08-24,9896
6112,邁達特,9,1,8,元大-台南,2023-08-24,9896
00878,國泰永續高股息,272,64,208,元大-台南,2023-08-25,9896
3231,緯創,297,182,115,元大-台南,2023-08-25,9896
00902,中信電池及儲能,112,0,112,元大-台南,2023-08-25,9896
1326,台化,100,0,100,元大-台南,2023-08-25,9896
2382,廣達,114,42,72,元大-台南,2023-08-25,9896
00929,復華台灣科技優息,87,24,63,元大-台南,2023-08-25,9896
00753L,中信中國50正2,62,6,56,元大-台南,2023-08-25,9896
1402,遠東新,54,0,54,元大-台南,2023-08-25,9896
6016,康和證,50,0,50,元大-台南,2023-08-25,9896
1303,南亞,51,1,50,元大-台南,2023-08-25,9896
00919,群益台灣精選高息,47,0,47,元大-台南,2023-08-25,9896
1310,台苯,45,0,45,元大-台南,2023-08-25,9896
00900,富邦特選高股息30,43,0,43,元大-台南,2023-08-25,9896
0056,元大高股息,51,10,41,元大-台南,2023-08-25,9896
00671R,富邦NASDAQ反1,40,0,40,元大-台南,2023-08-25,9896
2706,第一店,40,4,36,元大-台南,2023-08-25,9896
00670L,富邦NASDAQ正2,25,0,25,元大-台南,2023-08-25,9896
2356,英業達,42,21,21,元大-台南,2023-08-25,9896
2344,華邦電,20,0,20,元大-台南,2023-08-25,9896
2303,聯電,25,5,20,元大-台南,2023-08-25,9896
2891,中信金,19,0,19,元大-台南,2023-08-25,9896
2880,華南金,19,0,19,元大-台南,2023-08-25,9896
3363,上詮,21,2,19,元大-台南,2023-08-25,9896
1101,台泥,19,0,19,元大-台南,2023-08-25,9896
00757,統一FANG+,16,0,16,元大-台南,2023-08-25,9896
3443,創意,25,9,16,元大-台南,2023-08-25,9896
00893,國泰智能電動車,17,1,16,元大-台南,2023-08-25,9896
2618,長榮航,30,14,16,元大-台南,2023-08-25,9896
2002,中鋼,15,0,15,元大-台南,2023-08-25,9896
5009,榮剛,15,1,14,元大-台南,2023-08-25,9896
3706,神達,14,1,13,元大-台南,2023-08-25,9896
8033,雷虎,15,2,13,元大-台南,2023-08-25,9896
2436,偉詮電,13,0,13,元大-台南,2023-08-25,9896
5457,宣德,13,0,13,元大-台南,2023-08-25,9896
8926,台汽電,13,1,12,元大-台南,2023-08-25,9896
2883,凱基金,24,12,12,元大-台南,2023-08-25,9896
3051,力特,14,3,11,元大-台南,2023-08-25,9896
2884,玉山金,12,1,11,元大-台南,2023-08-25,9896
2324,仁寶,18,7,11,元大-台南,2023-08-25,9896
3041,揚智,11,0,11,元大-台南,2023-08-25,9896
6116,彩晶,11,0,11,元大-台南,2023-08-25,9896
00751B,元大AAA至A公司債,10,0,10,元大-台南,2023-08-25,9896
6770,力積電,10,0,10,元大-台南,2023-08-25,9896
3128,昇銳,110,100,10,元大-台南,2023-08-25,9896
3189,景碩,10,0,10,元大-台南,2023-08-25,9896
0050,元大台灣50,10,0,10,元大-台南,2023-08-25,9896
8069,元太,13,4,9,元大-台南,2023-08-25,9896
2460,建通,10,1,9,元大-台南,2023-08-25,9896
00882,中信中國高股息,9,0,9,元大-台南,2023-08-25,9896
3037,欣興,11,3,8,元大-台南,2023-08-25,9896
2888,新光金,151,0,151,元大-台南,2023-08-28,9896
2025,千興,140,1,139,元大-台南,2023-08-28,9896
00929,復華台灣科技優息,182,53,129,元大-台南,2023-08-28,9896
00919,群益台灣精選高息,120,3,117,元大-台南,2023-08-28,9896
00632R,元大台灣50反1,104,0,104,元大-台南,2023-08-28,9896
00637L,元大滬深300正2,106,10,96,元大-台南,2023-08-28,9896
2634,漢翔,105,38,67,元大-台南,2023-08-28,9896
5512,力麒,149,86,63,元大-台南,2023-08-28,9896
2618,長榮航,65,5,60,元大-台南,2023-08-28,9896
2511,太子,53,0,53,元大-台南,2023-08-28,9896
2610,華航,52,10,42,元大-台南,2023-08-28,9896
5457,宣德,42,0,42,元大-台南,2023-08-28,9896
4906,正文,85,45,40,元大-台南,2023-08-28,9896
00753L,中信中國50正2,53,16,37,元大-台南,2023-08-28,9896
2331,精英,54,19,35,元大-台南,2023-08-28,9896
2388,威盛,36,4,32,元大-台南,2023-08-28,9896
8940,新天地,36,4,32,元大-台南,2023-08-28,9896
1737,臺鹽,35,9,26,元大-台南,2023-08-28,9896
2897,王道銀行,25,0,25,元大-台南,2023-08-28,9896
8076,伍豐,24,0,24,元大-台南,2023-08-28,9896
00665L,富邦�琤肭磪囓�2,33,10,23,元大-台南,2023-08-28,9896
2630,亞航,42,22,20,元大-台南,2023-08-28,9896
3308,聯德,25,5,20,元大-台南,2023-08-28,9896
1513,中興電,19,0,19,元大-台南,2023-08-28,9896
0056,元大高股息,42,23,19,元大-台南,2023-08-28,9896
2880,華南金,20,2,18,元大-台南,2023-08-28,9896
1584,精剛,23,5,18,元大-台南,2023-08-28,9896
3481,群創,29,12,17,元大-台南,2023-08-28,9896
8027,鈦昇,17,2,15,元大-台南,2023-08-28,9896
6416,瑞祺電通,15,0,15,元大-台南,2023-08-28,9896
2748,雲品,14,0,14,元大-台南,2023-08-28,9896
6139,亞翔,14,1,13,元大-台南,2023-08-28,9896
2363,矽統,92,79,13,元大-台南,2023-08-28,9896
2301,光寶科,24,12,12,元大-台南,2023-08-28,9896
2369,菱生,14,2,12,元大-台南,2023-08-28,9896
2460,建通,12,0,12,元大-台南,2023-08-28,9896
4123,晟德,12,0,12,元大-台南,2023-08-28,9896
9951,皇田,14,2,12,元大-台南,2023-08-28,9896
6005,群益證,12,0,12,元大-台南,2023-08-28,9896
2409,友達,15,4,11,元大-台南,2023-08-28,9896
2885,元大金,11,0,11,元大-台南,2023-08-28,9896
2359,所羅門,23,12,11,元大-台南,2023-08-28,9896
6113,亞矽,51,40,11,元大-台南,2023-08-28,9896
2353,宏��,20,9,11,元大-台南,2023-08-28,9896
00712,復華富時不動產,11,0,11,元大-台南,2023-08-28,9896
2886,兆豐金,13,3,10,元大-台南,2023-08-28,9896
6288,聯嘉,20,10,10,元大-台南,2023-08-28,9896
2323,中環,11,1,10,元大-台南,2023-08-28,9896
2371,大同,13,3,10,元大-台南,2023-08-28,9896
2329,華泰,30,20,10,元大-台南,2023-08-28,9896
00637L,元大滬深300正2,622,2,620,元大-台南,2023-08-29,9896
2317,鴻海,161,5,156,元大-台南,2023-08-29,9896
00632R,元大台灣50反1,110,0,110,元大-台南,2023-08-29,9896
2412,中華電,100,0,100,元大-台南,2023-08-29,9896
00929,復華台灣科技優息,76,4,72,元大-台南,2023-08-29,9896
2474,可成,61,0,61,元大-台南,2023-08-29,9896
00679B,元大美債20年,52,0,52,元大-台南,2023-08-29,9896
00931B,統一美債20年,57,13,44,元大-台南,2023-08-29,9896
2002,中鋼,38,0,38,元大-台南,2023-08-29,9896
2329,華泰,48,19,29,元大-台南,2023-08-29,9896
5457,宣德,27,4,23,元大-台南,2023-08-29,9896
00664R,國泰臺灣加權反1,21,0,21,元大-台南,2023-08-29,9896
00878,國泰永續高股息,33,14,19,元大-台南,2023-08-29,9896
2610,華航,30,12,18,元大-台南,2023-08-29,9896
6235,華孚,37,20,17,元大-台南,2023-08-29,9896
2382,廣達,37,20,17,元大-台南,2023-08-29,9896
4207,環泰,15,0,15,元大-台南,2023-08-29,9896
2211,長榮鋼,15,0,15,元大-台南,2023-08-29,9896
00919,群益台灣精選高息,13,0,13,元大-台南,2023-08-29,9896
00900,富邦特選高股息30,13,0,13,元大-台南,2023-08-29,9896
2303,聯電,55,42,13,元大-台南,2023-08-29,9896
2883,凱基金,16,3,13,元大-台南,2023-08-29,9896
3033,威健,10,0,10,元大-台南,2023-08-29,9896
2323,中環,23,13,10,元大-台南,2023-08-29,9896
6443,元晶,17,7,10,元大-台南,2023-08-29,9896
6589,台康生技,10,0,10,元大-台南,2023-08-29,9896
00720B,元大投資級公司債,11,2,9,元大-台南,2023-08-29,9896
00922,國泰台灣領袖50,10,1,9,元大-台南,2023-08-29,9896
2886,兆豐金,9,0,9,元大-台南,2023-08-29,9896
2332,友訊,24,15,9,元大-台南,2023-08-29,9896
5880,合庫金,8,0,8,元大-台南,2023-08-29,9896
2105,正新,14,6,8,元大-台南,2023-08-29,9896
2485,兆赫,14,6,8,元大-台南,2023-08-29,9896
5534,長虹,8,0,8,元大-台南,2023-08-29,9896
5381,合正,8,0,8,元大-台南,2023-08-29,9896
2301,光寶科,12,4,8,元大-台南,2023-08-29,9896
4934,太極,11,4,7,元大-台南,2023-08-29,9896
00751B,元大AAA至A公司債,7,0,7,元大-台南,2023-08-29,9896
2312,金寶,10,3,7,元大-台南,2023-08-29,9896
4746,台耀,7,0,7,元大-台南,2023-08-29,9896
5469,瀚宇博,6,0,6,元大-台南,2023-08-29,9896
2314,台揚,6,0,6,元大-台南,2023-08-29,9896
5328,華容,59,53,6,元大-台南,2023-08-29,9896
4739,康普,6,0,6,元大-台南,2023-08-29,9896
3051,力特,12,6,6,元大-台南,2023-08-29,9896
00675L,富邦臺灣加權正2,6,0,6,元大-台南,2023-08-29,9896
5871,中租-KY,6,1,5,元大-台南,2023-08-29,9896
1101,台泥,7,2,5,元大-台南,2023-08-29,9896
1409,新纖,5,0,5,元大-台南,2023-08-29,9896
00907,永豐優息存股,5,0,5,元大-台南,2023-08-29,9896
00679B,元大美債20年,156,5,151,元大-台南,2023-08-30,9896
00632R,元大台灣50反1,171,22,149,元大-台南,2023-08-30,9896
2382,廣達,125,29,96,元大-台南,2023-08-30,9896
2303,聯電,126,45,81,元大-台南,2023-08-30,9896
6117,迎廣,72,0,72,元大-台南,2023-08-30,9896
00637L,元大滬深300正2,60,8,52,元大-台南,2023-08-30,9896
8070,長華*,50,0,50,元大-台南,2023-08-30,9896
2618,長榮航,53,7,46,元大-台南,2023-08-30,9896
5009,榮剛,36,1,35,元大-台南,2023-08-30,9896
2905,三商,35,0,35,元大-台南,2023-08-30,9896
5512,力麒,239,211,28,元大-台南,2023-08-30,9896
4906,正文,34,8,26,元大-台南,2023-08-30,9896
1217,愛之味,24,0,24,元大-台南,2023-08-30,9896
2409,友達,27,3,24,元大-台南,2023-08-30,9896
2498,宏達電,32,9,23,元大-台南,2023-08-30,9896
2367,燿華,29,7,22,元大-台南,2023-08-30,9896
6125,廣運,23,2,21,元大-台南,2023-08-30,9896
00919,群益台灣精選高息,54,35,19,元大-台南,2023-08-30,9896
3481,群創,54,35,19,元大-台南,2023-08-30,9896
9945,潤泰新,16,0,16,元大-台南,2023-08-30,9896
6235,華孚,25,9,16,元大-台南,2023-08-30,9896
2891,中信金,18,2,16,元大-台南,2023-08-30,9896
2401,凌陽,29,13,16,元大-台南,2023-08-30,9896
2884,玉山金,18,3,15,元大-台南,2023-08-30,9896
1513,中興電,24,9,15,元大-台南,2023-08-30,9896
6589,台康生技,13,0,13,元大-台南,2023-08-30,9896
00878,國泰永續高股息,32,19,13,元大-台南,2023-08-30,9896
00720B,元大投資級公司債,13,0,13,元大-台南,2023-08-30,9896
8069,元太,21,9,12,元大-台南,2023-08-30,9896
1815,富喬,34,22,12,元大-台南,2023-08-30,9896
00673R,期元大S＆P原油反1,12,0,12,元大-台南,2023-08-30,9896
00712,復華富時不動產,16,4,12,元大-台南,2023-08-30,9896
1752,南光,14,3,11,元大-台南,2023-08-30,9896
00931B,統一美債20年,11,0,11,元大-台南,2023-08-30,9896
3583,辛耘,26,15,11,元大-台南,2023-08-30,9896
1402,遠東新,12,1,11,元大-台南,2023-08-30,9896
2017,官田鋼,11,0,11,元大-台南,2023-08-30,9896
3049,精金,160,149,11,元大-台南,2023-08-30,9896
6116,彩晶,11,0,11,元大-台南,2023-08-30,9896
2883,凱基金,21,10,11,元大-台南,2023-08-30,9896
6150,撼訊,10,0,10,元大-台南,2023-08-30,9896
2371,大同,26,16,10,元大-台南,2023-08-30,9896
2838,聯邦銀,10,0,10,元大-台南,2023-08-30,9896
5457,宣德,11,1,10,元大-台南,2023-08-30,9896
6101,寬魚國際,10,0,10,元大-台南,2023-08-30,9896
1907,永豐餘,10,0,10,元大-台南,2023-08-30,9896
6126,信音,13,3,10,元大-台南,2023-08-30,9896
3406,玉晶光,10,0,10,元大-台南,2023-08-30,9896
4147,中裕,10,1,9,元大-台南,2023-08-30,9896
2419,仲琦,10,1,9,元大-台南,2023-08-30,9896
2474,可成,292,1,291,元大-台南,2023-08-31,9896
00637L,元大滬深300正2,101,0,101,元大-台南,2023-08-31,9896
00632R,元大台灣50反1,200,130,70,元大-台南,2023-08-31,9896
2436,偉詮電,70,19,51,元大-台南,2023-08-31,9896
6733,博晟生醫,42,0,42,元大-台南,2023-08-31,9896
2104,國際中橡,40,0,40,元大-台南,2023-08-31,9896
2913,農林,42,2,40,元大-台南,2023-08-31,9896
2867,三商壽,36,0,36,元大-台南,2023-08-31,9896
00923,群益台ESG低碳50,35,0,35,元大-台南,2023-08-31,9896
00878,國泰永續高股息,44,12,32,元大-台南,2023-08-31,9896
2609,陽明,35,3,32,元大-台南,2023-08-31,9896
2884,玉山金,37,8,29,元大-台南,2023-08-31,9896
2834,臺企銀,37,10,27,元大-台南,2023-08-31,9896
00929,復華台灣科技優息,42,15,27,元大-台南,2023-08-31,9896
3481,群創,29,3,26,元大-台南,2023-08-31,9896
3715,定穎投控,40,14,26,元大-台南,2023-08-31,9896
2337,旺宏,60,36,24,元大-台南,2023-08-31,9896
2401,凌陽,27,4,23,元大-台南,2023-08-31,9896
6443,元晶,31,9,22,元大-台南,2023-08-31,9896
00882,中信中國高股息,21,0,21,元大-台南,2023-08-31,9896
2880,華南金,21,0,21,元大-台南,2023-08-31,9896
2883,凱基金,24,3,21,元大-台南,2023-08-31,9896
2427,三商電,20,0,20,元大-台南,2023-08-31,9896
6547,高端疫苗,34,15,19,元大-台南,2023-08-31,9896
2324,仁寶,33,15,18,元大-台南,2023-08-31,9896
5880,合庫金,18,0,18,元大-台南,2023-08-31,9896
2890,永豐金,18,0,18,元大-台南,2023-08-31,9896
2330,台積電,18,2,16,元大-台南,2023-08-31,9896
3176,基亞,16,1,15,元大-台南,2023-08-31,9896
6806,森崴能源,16,1,15,元大-台南,2023-08-31,9896
2344,華邦電,24,9,15,元大-台南,2023-08-31,9896
2630,亞航,20,6,14,元大-台南,2023-08-31,9896
00679B,元大美債20年,14,0,14,元大-台南,2023-08-31,9896
5512,力麒,459,446,13,元大-台南,2023-08-31,9896
2002,中鋼,13,1,12,元大-台南,2023-08-31,9896
6282,康舒,12,0,12,元大-台南,2023-08-31,9896
2390,云辰,12,0,12,元大-台南,2023-08-31,9896
2618,長榮航,14,3,11,元大-台南,2023-08-31,9896
1101,台泥,16,5,11,元大-台南,2023-08-31,9896
2606,裕民,13,3,10,元大-台南,2023-08-31,9896
2409,友達,15,4,11,元大-台南,2023-08-31,9896
2027,大成鋼,12,2,10,元大-台南,2023-08-31,9896
1907,永豐餘,11,1,10,元大-台南,2023-08-31,9896
9904,寶成,10,0,10,元大-台南,2023-08-31,9896
2367,燿華,30,21,9,元大-台南,2023-08-31,9896
2610,華航,50,41,9,元大-台南,2023-08-31,9896
2392,正崴,12,3,9,元大-台南,2023-08-31,9896
2376,技嘉,28,19,9,元大-台南,2023-08-31,9896
8069,元太,16,8,8,元大-台南,2023-08-31,9896
2881,富邦金,8,0,8,元大-台南,2023-08-31,9896
1513,中興電,209,4,205,元大-台南,2023-09-01,9896
00932,兆豐永續高息等權,164,0,164,元大-台南,2023-09-01,9896
00673R,期元大S＆P原油反1,137,0,137,元大-台南,2023-09-01,9896
2363,矽統,255,143,112,元大-台南,2023-09-01,9896
00919,群益台灣精選高息,104,0,104,元大-台南,2023-09-01,9896
3231,緯創,146,56,90,元大-台南,2023-09-01,9896
00929,復華台灣科技優息,94,29,65,元大-台南,2023-09-01,9896
00632R,元大台灣50反1,60,0,60,元大-台南,2023-09-01,9896
2382,廣達,62,19,43,元大-台南,2023-09-01,9896
2913,農林,40,0,40,元大-台南,2023-09-01,9896
2402,毅嘉,152,113,39,元大-台南,2023-09-01,9896
1215,卜蜂,36,0,36,元大-台南,2023-09-01,9896
00902,中信電池及儲能,32,0,32,元大-台南,2023-09-01,9896
00878,國泰永續高股息,91,60,31,元大-台南,2023-09-01,9896
2516,新建,30,0,30,元大-台南,2023-09-01,9896
5488,松普,28,0,28,元大-台南,2023-09-01,9896
1609,大亞,44,17,27,元大-台南,2023-09-01,9896
1605,華新,34,9,25,元大-台南,2023-09-01,9896
2337,旺宏,32,11,21,元大-台南,2023-09-01,9896
6821,聯寶,21,0,21,元大-台南,2023-09-01,9896
00671R,富邦NASDAQ反1,20,0,20,元大-台南,2023-09-01,9896
2610,華航,27,8,19,元大-台南,2023-09-01,9896
1815,富喬,20,3,17,元大-台南,2023-09-01,9896
2368,金像電,17,2,15,元大-台南,2023-09-01,9896
2332,友訊,20,6,14,元大-台南,2023-09-01,9896
0056,元大高股息,16,3,13,元大-台南,2023-09-01,9896
2609,陽明,15,2,13,元大-台南,2023-09-01,9896
2399,映泰,16,3,13,元大-台南,2023-09-01,9896
6139,亞翔,14,2,12,元大-台南,2023-09-01,9896
6282,康舒,24,12,12,元大-台南,2023-09-01,9896
2312,金寶,11,0,11,元大-台南,2023-09-01,9896
00664R,國泰臺灣加權反1,11,0,11,元大-台南,2023-09-01,9896
3128,昇銳,45,34,11,元大-台南,2023-09-01,9896
6789,采鈺,11,0,11,元大-台南,2023-09-01,9896
2356,英業達,23,12,11,元大-台南,2023-09-01,9896
2401,凌陽,17,6,11,元大-台南,2023-09-01,9896
3289,宜特,10,0,10,元大-台南,2023-09-01,9896
3163,波若威,23,13,10,元大-台南,2023-09-01,9896
4171,瑞基,10,0,10,元大-台南,2023-09-01,9896
1305,華夏,10,0,10,元大-台南,2023-09-01,9896
6147,頎邦,10,0,10,元大-台南,2023-09-01,9896
2889,國票金,10,0,10,元大-台南,2023-09-01,9896
2419,仲琦,10,1,9,元大-台南,2023-09-01,9896
6005,群益證,9,0,9,元大-台南,2023-09-01,9896
3673,TPK-KY,9,0,9,元大-台南,2023-09-01,9896
3311,閎暉,11,2,9,元大-台南,2023-09-01,9896
2888,新光金,11,3,8,元大-台南,2023-09-01,9896
6547,高端疫苗,25,16,9,元大-台南,2023-09-01,9896
1522,堤維西,10,2,8,元大-台南,2023-09-01,9896
6441,廣錠,8,0,8,元大-台南,2023-09-01,9896
00929,復華台灣科技優息,257,5,252,元大-台南,2023-09-04,9896
2474,可成,160,1,159,元大-台南,2023-09-04,9896
00673R,期元大S＆P原油反1,114,0,114,元大-台南,2023-09-04,9896
00902,中信電池及儲能,97,0,97,元大-台南,2023-09-04,9896
1440,南紡,96,0,96,元大-台南,2023-09-04,9896
00931B,統一美債20年,69,0,69,元大-台南,2023-09-04,9896
1802,台玻,245,185,60,元大-台南,2023-09-04,9896
00632R,元大台灣50反1,58,2,56,元大-台南,2023-09-04,9896
00679B,元大美債20年,54,0,54,元大-台南,2023-09-04,9896
2888,新光金,57,9,48,元大-台南,2023-09-04,9896
3481,群創,45,0,45,元大-台南,2023-09-04,9896
2402,毅嘉,102,57,45,元大-台南,2023-09-04,9896
00664R,國泰臺灣加權反1,36,0,36,元大-台南,2023-09-04,9896
00751B,元大AAA至A公司債,34,0,34,元大-台南,2023-09-04,9896
2449,京元電子,42,8,34,元大-台南,2023-09-04,9896
2371,大同,37,5,32,元大-台南,2023-09-04,9896
2323,中環,56,31,25,元大-台南,2023-09-04,9896
00915,凱基優選高股息30,22,0,22,元大-台南,2023-09-04,9896
8358,金居,26,5,21,元大-台南,2023-09-04,9896
5880,合庫金,21,0,21,元大-台南,2023-09-04,9896
2618,長榮航,25,5,20,元大-台南,2023-09-04,9896
00641R,富邦日本反1,20,0,20,元大-台南,2023-09-04,9896
2103,台橡,20,0,20,元大-台南,2023-09-04,9896
1444,力麗,25,6,19,元大-台南,2023-09-04,9896
8088,品安,20,2,18,元大-台南,2023-09-04,9896
9919,康那香,26,8,18,元大-台南,2023-09-04,9896
2409,友達,61,45,16,元大-台南,2023-09-04,9896
2344,華邦電,22,6,16,元大-台南,2023-09-04,9896
2352,佳世達,15,0,15,元大-台南,2023-09-04,9896
00687B,國泰20年美債,14,0,14,元大-台南,2023-09-04,9896
3163,波若威,31,17,14,元大-台南,2023-09-04,9896
1504,東元,14,0,14,元大-台南,2023-09-04,9896
3034,聯詠,21,7,14,元大-台南,2023-09-04,9896
2201,裕隆,34,20,14,元大-台南,2023-09-04,9896
4747,強生,13,0,13,元大-台南,2023-09-04,9896
1313,聯成,13,0,13,元大-台南,2023-09-04,9896
8044,網家,13,0,13,元大-台南,2023-09-04,9896
2820,華票,12,0,12,元大-台南,2023-09-04,9896
6282,康舒,16,4,12,元大-台南,2023-09-04,9896
00720B,元大投資級公司債,11,0,11,元大-台南,2023-09-04,9896
3325,旭品,11,0,11,元大-台南,2023-09-04,9896
2630,亞航,15,4,11,元大-台南,2023-09-04,9896
2405,輔信,11,0,11,元大-台南,2023-09-04,9896
2010,春源,10,0,10,元大-台南,2023-09-04,9896
00713,元大台灣高息低波,11,1,10,元大-台南,2023-09-04,9896
6112,邁達特,35,25,10,元大-台南,2023-09-04,9896
5876,上海商銀,10,0,10,元大-台南,2023-09-04,9896
2495,普安,10,0,10,元大-台南,2023-09-04,9896
2812,台中銀,10,0,10,元大-台南,2023-09-04,9896
6161,捷波,10,0,10,元大-台南,2023-09-04,9896
00929,復華台灣科技優息,711,73,638,元大-台南,2023-09-05,9896
2474,可成,130,0,130,元大-台南,2023-09-05,9896
00931B,統一美債20年,126,0,126,元大-台南,2023-09-05,9896
00923,群益台ESG低碳50,113,5,108,元大-台南,2023-09-05,9896
00918,大華優利高填息30,90,0,90,元大-台南,2023-09-05,9896
2888,新光金,67,10,57,元大-台南,2023-09-05,9896
2323,中環,55,0,55,元大-台南,2023-09-05,9896
2610,華航,71,23,48,元大-台南,2023-09-05,9896
2618,長榮航,46,8,38,元大-台南,2023-09-05,9896
2886,兆豐金,39,4,35,元大-台南,2023-09-05,9896
00932,兆豐永續高息等權,37,3,34,元大-台南,2023-09-05,9896
00919,群益台灣精選高息,64,32,32,元大-台南,2023-09-05,9896
2402,毅嘉,41,10,31,元大-台南,2023-09-05,9896
2353,宏��,36,8,28,元大-台南,2023-09-05,9896
2884,玉山金,27,1,26,元大-台南,2023-09-05,9896
00673R,期元大S＆P原油反1,25,0,25,元大-台南,2023-09-05,9896
2330,台積電,28,3,25,元大-台南,2023-09-05,9896
00878,國泰永續高股息,38,14,24,元大-台南,2023-09-05,9896
3231,緯創,37,15,22,元大-台南,2023-09-05,9896
1101,台泥,21,1,20,元大-台南,2023-09-05,9896
9929,秋雨,20,0,20,元大-台南,2023-09-05,9896
00679B,元大美債20年,19,0,19,元大-台南,2023-09-05,9896
1444,力麗,19,0,19,元大-台南,2023-09-05,9896
6122,擎邦,36,17,19,元大-台南,2023-09-05,9896
1616,億泰,20,1,19,元大-台南,2023-09-05,9896
3059,華晶科,21,2,19,元大-台南,2023-09-05,9896
3041,揚智,20,2,18,元大-台南,2023-09-05,9896
6191,精成科,19,3,16,元大-台南,2023-09-05,9896
2455,全新,17,2,15,元大-台南,2023-09-05,9896
00664R,國泰臺灣加權反1,15,0,15,元大-台南,2023-09-05,9896
5512,力麒,569,554,15,元大-台南,2023-09-05,9896
2436,偉詮電,104,90,14,元大-台南,2023-09-05,9896
00706L,期元大S＆P日圓正2,14,0,14,元大-台南,2023-09-05,9896
2355,敬鵬,13,1,12,元大-台南,2023-09-05,9896
3036A,文曄甲特,12,0,12,元大-台南,2023-09-05,9896
2329,華泰,20,8,12,元大-台南,2023-09-05,9896
2634,漢翔,27,16,11,元大-台南,2023-09-05,9896
6125,廣運,11,0,11,元大-台南,2023-09-05,9896
2359,所羅門,11,0,11,元大-台南,2023-09-05,9896
9950,萬國通,47,36,11,元大-台南,2023-09-05,9896
4155,訊映,10,0,10,元大-台南,2023-09-05,9896
00642U,期元大S＆P石油,10,0,10,元大-台南,2023-09-05,9896
4707,磐亞,10,0,10,元大-台南,2023-09-05,9896
00632R,元大台灣50反1,14,5,9,元大-台南,2023-09-05,9896
6235,華孚,64,55,9,元大-台南,2023-09-05,9896
00857B,永豐20年美公債,9,0,9,元大-台南,2023-09-05,9896
5011,久陽,9,0,9,元大-台南,2023-09-05,9896
6418,詠昇,31,22,9,元大-台南,2023-09-05,9896
5457,宣德,34,25,9,元大-台南,2023-09-05,9896
6213,聯茂,12,4,8,元大-台南,2023-09-05,9896
2409,友達,309,3,306,元大-台南,2023-09-06,9896
00929,復華台灣科技優息,303,75,228,元大-台南,2023-09-06,9896
2474,可成,192,4,188,元大-台南,2023-09-06,9896
6164,華興,170,0,170,元大-台南,2023-09-06,9896
3481,群創,164,29,135,元大-台南,2023-09-06,9896
00753L,中信中國50正2,110,0,110,元大-台南,2023-09-06,9896
00919,群益台灣精選高息,98,5,93,元大-台南,2023-09-06,9896
00931B,統一美債20年,83,0,83,元大-台南,2023-09-06,9896
2881,富邦金,52,0,52,元大-台南,2023-09-06,9896
00632R,元大台灣50反1,50,0,50,元大-台南,2023-09-06,9896
2363,矽統,114,66,48,元大-台南,2023-09-06,9896
1802,台玻,47,0,47,元大-台南,2023-09-06,9896
00673R,期元大S＆P原油反1,63,20,43,元大-台南,2023-09-06,9896
2882,國泰金,43,2,41,元大-台南,2023-09-06,9896
2883,凱基金,36,4,32,元大-台南,2023-09-06,9896
1101,台泥,49,20,29,元大-台南,2023-09-06,9896
2891,中信金,29,2,27,元大-台南,2023-09-06,9896
2330,台積電,28,1,27,元大-台南,2023-09-06,9896
00915,凱基優選高股息30,26,1,25,元大-台南,2023-09-06,9896
00902,中信電池及儲能,26,2,24,元大-台南,2023-09-06,9896
8038,長園科,24,0,24,元大-台南,2023-09-06,9896
00772B,中信高評級公司債,26,2,24,元大-台南,2023-09-06,9896
2610,華航,23,1,22,元大-台南,2023-09-06,9896
3013,晟銘電,25,5,20,元大-台南,2023-09-06,9896
5381,合正,28,8,20,元大-台南,2023-09-06,9896
00751B,元大AAA至A公司債,19,0,19,元大-台南,2023-09-06,9896
2834,臺企銀,18,0,18,元大-台南,2023-09-06,9896
00900,富邦特選高股息30,19,1,18,元大-台南,2023-09-06,9896
2906,高林,17,0,17,元大-台南,2023-09-06,9896
2884,玉山金,23,7,16,元大-台南,2023-09-06,9896
2027,大成鋼,17,1,16,元大-台南,2023-09-06,9896
2887,台新金,17,2,15,元大-台南,2023-09-06,9896
2915,潤泰全,15,0,15,元大-台南,2023-09-06,9896
1305,華夏,15,0,15,元大-台南,2023-09-06,9896
4977,眾達-KY,20,6,14,元大-台南,2023-09-06,9896
2105,正新,15,1,14,元大-台南,2023-09-06,9896
2886,兆豐金,14,1,13,元大-台南,2023-09-06,9896
00932,兆豐永續高息等權,13,0,13,元大-台南,2023-09-06,9896
00882,中信中國高股息,12,0,12,元大-台南,2023-09-06,9896
00642U,期元大S＆P石油,12,0,12,元大-台南,2023-09-06,9896
2888,新光金,52,40,12,元大-台南,2023-09-06,9896
00740B,富邦全球投等債,11,0,11,元大-台南,2023-09-06,9896
00881,國泰台灣5G+,20,9,11,元大-台南,2023-09-06,9896
1616,億泰,12,1,11,元大-台南,2023-09-06,9896
3163,波若威,20,9,11,元大-台南,2023-09-06,9896
5880,合庫金,12,1,11,元大-台南,2023-09-06,9896
2002,中鋼,13,2,11,元大-台南,2023-09-06,9896
00713,元大台灣高息低波,11,0,11,元大-台南,2023-09-06,9896
00687B,國泰20年美債,11,1,10,元大-台南,2023-09-06,9896
6016,康和證,10,0,10,元大-台南,2023-09-06,9896
00929,復華台灣科技優息,395,77,318,元大-台南,2023-09-07,9896
4746,台耀,202,5,197,元大-台南,2023-09-07,9896
00712,復華富時不動產,196,3,193,元大-台南,2023-09-07,9896
00753L,中信中國50正2,165,0,165,元大-台南,2023-09-07,9896
00673R,期元大S＆P原油反1,127,0,127,元大-台南,2023-09-07,9896
2618,長榮航,175,62,113,元大-台南,2023-09-07,9896
00919,群益台灣精選高息,117,6,111,元大-台南,2023-09-07,9896
2323,中環,99,8,91,元大-台南,2023-09-07,9896
3481,群創,92,7,85,元大-台南,2023-09-07,9896
6116,彩晶,70,0,70,元大-台南,2023-09-07,9896
00902,中信電池及儲能,70,0,70,元大-台南,2023-09-07,9896
00632R,元大台灣50反1,103,40,63,元大-台南,2023-09-07,9896
2313,華通,76,27,49,元大-台南,2023-09-07,9896
2486,一詮,50,17,33,元大-台南,2023-09-07,9896
00878,國泰永續高股息,38,5,33,元大-台南,2023-09-07,9896
3078,僑威,52,19,33,元大-台南,2023-09-07,9896
2834,臺企銀,31,0,31,元大-台南,2023-09-07,9896
2330,台積電,32,1,31,元大-台南,2023-09-07,9896
2884,玉山金,32,2,30,元大-台南,2023-09-07,9896
00915,凱基優選高股息30,26,0,26,元大-台南,2023-09-07,9896
2891,中信金,34,9,25,元大-台南,2023-09-07,9896
2390,云辰,32,8,24,元大-台南,2023-09-07,9896
2504,國產,22,0,22,元大-台南,2023-09-07,9896
2317,鴻海,21,1,20,元大-台南,2023-09-07,9896
2489,瑞軒,20,0,20,元大-台南,2023-09-07,9896
00687B,國泰20年美債,20,0,20,元大-台南,2023-09-07,9896
2027,大成鋼,23,3,20,元大-台南,2023-09-07,9896
2485,兆赫,34,15,19,元大-台南,2023-09-07,9896
5009,榮剛,18,0,18,元大-台南,2023-09-07,9896
2409,友達,24,7,17,元大-台南,2023-09-07,9896
8038,長園科,17,0,17,元大-台南,2023-09-07,9896
1513,中興電,21,4,17,元大-台南,2023-09-07,9896
00888,永豐台灣ESG,17,0,17,元大-台南,2023-09-07,9896
3622,洋華,17,1,16,元大-台南,2023-09-07,9896
3512,皇龍,16,0,16,元大-台南,2023-09-07,9896
5457,宣德,114,99,15,元大-台南,2023-09-07,9896
5864,致和證,15,0,15,元大-台南,2023-09-07,9896
9907,統一實,15,0,15,元大-台南,2023-09-07,9896
6164,華興,15,0,15,元大-台南,2023-09-07,9896
4114,健喬,15,1,14,元大-台南,2023-09-07,9896
2316,楠梓電,19,6,13,元大-台南,2023-09-07,9896
2610,華航,21,8,13,元大-台南,2023-09-07,9896
2376,技嘉,26,13,13,元大-台南,2023-09-07,9896
2886,兆豐金,14,2,12,元大-台南,2023-09-07,9896
1802,台玻,20,8,12,元大-台南,2023-09-07,9896
6147,頎邦,12,1,11,元大-台南,2023-09-07,9896
2324,仁寶,14,3,11,元大-台南,2023-09-07,9896
00923,群益台ESG低碳50,12,1,11,元大-台南,2023-09-07,9896
2612,中航,11,0,11,元大-台南,2023-09-07,9896
3704,合勤控,35,24,11,元大-台南,2023-09-07,9896
4123,晟德,205,0,205,元大-台南,2023-09-08,9896
2474,可成,200,1,199,元大-台南,2023-09-08,9896
00919,群益台灣精選高息,183,12,171,元大-台南,2023-09-08,9896
3481,群創,155,17,138,元大-台南,2023-09-08,9896
2834,臺企銀,100,0,100,元大-台南,2023-09-08,9896
2888,新光金,101,3,98,元大-台南,2023-09-08,9896
2637,慧洋-KY,58,1,57,元大-台南,2023-09-08,9896
2538,基泰,53,0,53,元大-台南,2023-09-08,9896
3209,全科,51,2,49,元大-台南,2023-09-08,9896
2317,鴻海,46,4,42,元大-台南,2023-09-08,9896
2409,友達,40,1,39,元大-台南,2023-09-08,9896
3014,聯陽,37,3,34,元大-台南,2023-09-08,9896
6515,穎崴,33,0,33,元大-台南,2023-09-08,9896
2328,廣宇,32,0,32,元大-台南,2023-09-08,9896
2618,長榮航,32,1,31,元大-台南,2023-09-08,9896
3483,力致,43,14,29,元大-台南,2023-09-08,9896
1101,台泥,47,18,29,元大-台南,2023-09-08,9896
3706,神達,23,1,22,元大-台南,2023-09-08,9896
1312,國喬,23,1,22,元大-台南,2023-09-08,9896
2913,農林,27,6,21,元大-台南,2023-09-08,9896
00918,大華優利高填息30,20,0,20,元大-台南,2023-09-08,9896
5457,宣德,19,0,19,元大-台南,2023-09-08,9896
00673R,期元大S＆P原油反1,24,5,19,元大-台南,2023-09-08,9896
00900,富邦特選高股息30,18,0,18,元大-台南,2023-09-08,9896
00931B,統一美債20年,18,0,18,元大-台南,2023-09-08,9896
1605,華新,18,0,18,元大-台南,2023-09-08,9896
4931,新盛力,16,0,16,元大-台南,2023-09-08,9896
2313,華通,351,335,16,元大-台南,2023-09-08,9896
1304,台聚,20,5,15,元大-台南,2023-09-08,9896
8222,寶一,28,13,15,元大-台南,2023-09-08,9896
00637L,元大滬深300正2,14,0,14,元大-台南,2023-09-08,9896
00915,凱基優選高股息30,16,2,14,元大-台南,2023-09-08,9896
3078,僑威,16,3,13,元大-台南,2023-09-08,9896
3693,營邦,19,7,12,元大-台南,2023-09-08,9896
2324,仁寶,12,0,12,元大-台南,2023-09-08,9896
3406,玉晶光,12,0,12,元大-台南,2023-09-08,9896
1603,華電,32,21,11,元大-台南,2023-09-08,9896
3308,聯德,12,1,11,元大-台南,2023-09-08,9896
3213,茂訊,15,4,11,元大-台南,2023-09-08,9896
00679B,元大美債20年,11,0,11,元大-台南,2023-09-08,9896
3231,緯創,20,10,10,元大-台南,2023-09-08,9896
6116,彩晶,10,0,10,元大-台南,2023-09-08,9896
2515,中工,10,0,10,元大-台南,2023-09-08,9896
9907,統一實,10,0,10,元大-台南,2023-09-08,9896
9945,潤泰新,11,2,9,元大-台南,2023-09-08,9896
2392,正崴,14,5,9,元大-台南,2023-09-08,9896
2376,技嘉,23,14,9,元大-台南,2023-09-08,9896
00929,復華台灣科技優息,86,78,8,元大-台南,2023-09-08,9896
00902,中信電池及儲能,8,0,8,元大-台南,2023-09-08,9896
00665L,富邦�琤肭磪囓�2,13,5,8,元大-台南,2023-09-08,9896
00919,群益台灣精選高息,549,7,542,元大-台南,2023-09-11,9896
00878,國泰永續高股息,289,29,260,元大-台南,2023-09-11,9896
00673R,期元大S＆P原油反1,134,0,134,元大-台南,2023-09-11,9896
3047,訊舟,243,134,109,元大-台南,2023-09-11,9896
00929,復華台灣科技優息,135,28,107,元大-台南,2023-09-11,9896
00753L,中信中國50正2,102,0,102,元大-台南,2023-09-11,9896
00637L,元大滬深300正2,102,1,101,元大-台南,2023-09-11,9896
00679B,元大美債20年,85,0,85,元大-台南,2023-09-11,9896
00931B,統一美債20年,81,0,81,元大-台南,2023-09-11,9896
5864,致和證,77,0,77,元大-台南,2023-09-11,9896
2618,長榮航,86,22,64,元大-台南,2023-09-11,9896
5225,東科-KY,51,0,51,元大-台南,2023-09-11,9896
2511,太子,50,0,50,元大-台南,2023-09-11,9896
2363,矽統,174,124,50,元大-台南,2023-09-11,9896
0056,元大高股息,58,15,43,元大-台南,2023-09-11,9896
4123,晟德,42,0,42,元大-台南,2023-09-11,9896
2208,台船,39,0,39,元大-台南,2023-09-11,9896
1312,國喬,40,1,39,元大-台南,2023-09-11,9896
2317,鴻海,42,3,39,元大-台南,2023-09-11,9896
00751B,元大AAA至A公司債,42,4,38,元大-台南,2023-09-11,9896
2888,新光金,151,115,36,元大-台南,2023-09-11,9896
00932,兆豐永續高息等權,36,0,36,元大-台南,2023-09-11,9896
4157,太景*-KY,34,0,34,元大-台南,2023-09-11,9896
2352,佳世達,48,15,33,元大-台南,2023-09-11,9896
1618,合機,43,12,31,元大-台南,2023-09-11,9896
00665L,富邦�琤肭磪囓�2,38,8,30,元大-台南,2023-09-11,9896
6625,必應,37,8,29,元大-台南,2023-09-11,9896
1313,聯成,25,0,25,元大-台南,2023-09-11,9896
00900,富邦特選高股息30,25,1,24,元大-台南,2023-09-11,9896
2546,根基,24,0,24,元大-台南,2023-09-11,9896
00915,凱基優選高股息30,24,0,24,元大-台南,2023-09-11,9896
1513,中興電,29,7,22,元大-台南,2023-09-11,9896
2330,台積電,26,3,23,元大-台南,2023-09-11,9896
6226,光鼎,22,0,22,元大-台南,2023-09-11,9896
00881,國泰台灣5G+,22,1,21,元大-台南,2023-09-11,9896
6142,友勁,21,0,21,元大-台南,2023-09-11,9896
6282,康舒,25,4,21,元大-台南,2023-09-11,9896
2420,新巨,21,1,20,元大-台南,2023-09-11,9896
4133,亞諾法,20,0,20,元大-台南,2023-09-11,9896
4960,誠美材,20,0,20,元大-台南,2023-09-11,9896
2382,廣達,72,52,20,元大-台南,2023-09-11,9896
2634,漢翔,39,20,19,元大-台南,2023-09-11,9896
6197,佳必琪,16,0,16,元大-台南,2023-09-11,9896
00923,群益台ESG低碳50,20,5,15,元大-台南,2023-09-11,9896
3689,湧德,15,0,15,元大-台南,2023-09-11,9896
8038,長園科,15,0,15,元大-台南,2023-09-11,9896
1605,華新,17,3,14,元大-台南,2023-09-11,9896
5284,jpp-KY,18,4,14,元大-台南,2023-09-11,9896
2388,威盛,18,4,14,元大-台南,2023-09-11,9896
1522,堤維西,22,8,14,元大-台南,2023-09-11,9896
00632R,元大台灣50反1,316,24,292,元大-台南,2023-09-12,9896
2474,可成,270,2,268,元大-台南,2023-09-12,9896
00918,大華優利高填息30,134,0,134,元大-台南,2023-09-12,9896
00929,復華台灣科技優息,148,31,117,元大-台南,2023-09-12,9896
00919,群益台灣精選高息,112,2,110,元大-台南,2023-09-12,9896
3481,群創,123,62,61,元大-台南,2023-09-12,9896
3715,定穎投控,53,3,50,元大-台南,2023-09-12,9896
1524,耿鼎,69,27,42,元大-台南,2023-09-12,9896
2374,佳能,38,0,38,元大-台南,2023-09-12,9896
00673R,期元大S＆P原油反1,35,0,35,元大-台南,2023-09-12,9896
2913,農林,32,0,32,元大-台南,2023-09-12,9896
1616,億泰,24,0,24,元大-台南,2023-09-12,9896
2634,漢翔,42,19,23,元大-台南,2023-09-12,9896
3276,宇環,22,0,22,元大-台南,2023-09-12,9896
3078,僑威,93,71,22,元大-台南,2023-09-12,9896
00931B,統一美債20年,22,0,22,元大-台南,2023-09-12,9896
1587,吉茂,22,1,21,元大-台南,2023-09-12,9896
5457,宣德,28,9,19,元大-台南,2023-09-12,9896
00902,中信電池及儲能,18,0,18,元大-台南,2023-09-12,9896
1324,地球,20,2,18,元大-台南,2023-09-12,9896
2002,中鋼,23,6,17,元大-台南,2023-09-12,9896
3363,上詮,19,2,17,元大-台南,2023-09-12,9896
00720B,元大投資級公司債,17,0,17,元大-台南,2023-09-12,9896
1444,力麗,15,0,15,元大-台南,2023-09-12,9896
5880,合庫金,15,0,15,元大-台南,2023-09-12,9896
2402,毅嘉,20,6,14,元大-台南,2023-09-12,9896
00882,中信中國高股息,14,0,14,元大-台南,2023-09-12,9896
6117,迎廣,13,0,13,元大-台南,2023-09-12,9896
9928,中視,13,0,13,元大-台南,2023-09-12,9896
2353,宏��,20,7,13,元大-台南,2023-09-12,9896
3450,聯鈞,12,0,12,元大-台南,2023-09-12,9896
3231,緯創,47,36,11,元大-台南,2023-09-12,9896
0056,元大高股息,15,4,11,元大-台南,2023-09-12,9896
2834,臺企銀,11,0,11,元大-台南,2023-09-12,9896
3128,昇銳,10,0,10,元大-台南,2023-09-12,9896
2358,廷鑫,14,4,10,元大-台南,2023-09-12,9896
2488,漢平,10,0,10,元大-台南,2023-09-12,9896
6112,邁達特,10,0,10,元大-台南,2023-09-12,9896
6282,康舒,37,28,9,元大-台南,2023-09-12,9896
2731,雄獅,10,1,9,元大-台南,2023-09-12,9896
6120,達運,10,1,9,元大-台南,2023-09-12,9896
6113,亞矽,50,41,9,元大-台南,2023-09-12,9896
3058,立德,10,1,9,元大-台南,2023-09-12,9896
6139,亞翔,11,2,9,元大-台南,2023-09-12,9896
2618,長榮航,100,92,8,元大-台南,2023-09-12,9896
00751B,元大AAA至A公司債,8,0,8,元大-台南,2023-09-12,9896
1815,富喬,81,73,8,元大-台南,2023-09-12,9896
2884,玉山金,8,0,8,元大-台南,2023-09-12,9896
2357,華碩,9,1,8,元大-台南,2023-09-12,9896
6547,高端疫苗,11,4,7,元大-台南,2023-09-12,9896
3682,亞太電,130,0,130,元大-台南,2023-09-13,9896
00673R,期元大S＆P原油反1,129,0,129,元大-台南,2023-09-13,9896
00632R,元大台灣50反1,429,301,128,元大-台南,2023-09-13,9896
00929,復華台灣科技優息,125,14,111,元大-台南,2023-09-13,9896
00919,群益台灣精選高息,117,7,110,元大-台南,2023-09-13,9896
2317,鴻海,65,1,64,元大-台南,2023-09-13,9896
2601,益航,44,0,44,元大-台南,2023-09-13,9896
1616,億泰,33,0,33,元大-台南,2023-09-13,9896
2330,台積電,34,2,32,元大-台南,2023-09-13,9896
2913,農林,46,17,29,元大-台南,2023-09-13,9896
1618,合機,31,2,29,元大-台南,2023-09-13,9896
1312,國喬,30,1,29,元大-台南,2023-09-13,9896
2405,輔信,34,11,23,元大-台南,2023-09-13,9896
00772B,中信高評級公司債,22,0,22,元大-台南,2023-09-13,9896
00713,元大台灣高息低波,22,1,21,元大-台南,2023-09-13,9896
1309,台達化,20,0,20,元大-台南,2023-09-13,9896
3078,僑威,26,7,19,元大-台南,2023-09-13,9896
3704,合勤控,28,9,19,元大-台南,2023-09-13,9896
2618,長榮航,35,17,18,元大-台南,2023-09-13,9896
5512,力麒,160,143,17,元大-台南,2023-09-13,9896
6589,台康生技,17,0,17,元大-台南,2023-09-13,9896
00679B,元大美債20年,15,0,15,元大-台南,2023-09-13,9896
00751B,元大AAA至A公司債,15,0,15,元大-台南,2023-09-13,9896
4157,太景*-KY,15,0,15,元大-台南,2023-09-13,9896
2382,廣達,29,15,14,元大-台南,2023-09-13,9896
1301,台塑,15,1,14,元大-台南,2023-09-13,9896
00665L,富邦�琤肭磪囓�2,14,0,14,元大-台南,2023-09-13,9896
2402,毅嘉,18,4,14,元大-台南,2023-09-13,9896
3231,緯創,25,11,14,元大-台南,2023-09-13,9896
2883,凱基金,20,7,13,元大-台南,2023-09-13,9896
00918,大華優利高填息30,14,1,13,元大-台南,2023-09-13,9896
00738U,期元大道瓊白銀,13,0,13,元大-台南,2023-09-13,9896
2303,聯電,18,6,12,元大-台南,2023-09-13,9896
1504,東元,14,2,12,元大-台南,2023-09-13,9896
2313,華通,42,30,12,元大-台南,2023-09-13,9896
6449,鈺邦,12,0,12,元大-台南,2023-09-13,9896
1905,華紙,12,1,11,元大-台南,2023-09-13,9896
6282,康舒,13,2,11,元大-台南,2023-09-13,9896
6176,瑞儀,12,1,11,元大-台南,2023-09-13,9896
3276,宇環,11,0,11,元大-台南,2023-09-13,9896
5009,榮剛,19,8,11,元大-台南,2023-09-13,9896
5272,笙科,11,0,11,元大-台南,2023-09-13,9896
1524,耿鼎,50,39,11,元大-台南,2023-09-13,9896
1319,東陽,70,60,10,元大-台南,2023-09-13,9896
2610,華航,11,1,10,元大-台南,2023-09-13,9896
8086,宏捷科,13,3,10,元大-台南,2023-09-13,9896
6147,頎邦,11,1,10,元大-台南,2023-09-13,9896
6164,華興,10,0,10,元大-台南,2023-09-13,9896
2915,潤泰全,10,0,10,元大-台南,2023-09-13,9896
2419,仲琦,12,2,10,元大-台南,2023-09-13,9896
00632R,元大台灣50反1,560,18,542,元大-台南,2023-09-14,9896
00929,復華台灣科技優息,261,17,244,元大-台南,2023-09-14,9896
2474,可成,241,0,241,元大-台南,2023-09-14,9896
2405,輔信,219,39,180,元大-台南,2023-09-14,9896
2603,長榮,143,10,133,元大-台南,2023-09-14,9896
6120,達運,120,0,120,元大-台南,2023-09-14,9896
00919,群益台灣精選高息,130,12,118,元大-台南,2023-09-14,9896
3450,聯鈞,67,14,53,元大-台南,2023-09-14,9896
2618,長榮航,60,9,51,元大-台南,2023-09-14,9896
00900,富邦特選高股息30,69,20,49,元大-台南,2023-09-14,9896
00902,中信電池及儲能,30,0,30,元大-台南,2023-09-14,9896
2605,新興,81,53,28,元大-台南,2023-09-14,9896
00664R,國泰臺灣加權反1,28,0,28,元大-台南,2023-09-14,9896
00715L,期街口布蘭特正2,27,0,27,元大-台南,2023-09-14,9896
6235,華孚,29,3,26,元大-台南,2023-09-14,9896
2371,大同,26,3,23,元大-台南,2023-09-14,9896
2641,正德,22,0,22,元大-台南,2023-09-14,9896
00712,復華富時不動產,24,2,22,元大-台南,2023-09-14,9896
2436,偉詮電,48,28,20,元大-台南,2023-09-14,9896
00932,兆豐永續高息等權,18,0,18,元大-台南,2023-09-14,9896
4979,華星光,47,30,17,元大-台南,2023-09-14,9896
2344,華邦電,24,7,17,元大-台南,2023-09-14,9896
00882,中信中國高股息,16,0,16,元大-台南,2023-09-14,9896
2630,亞航,20,4,16,元大-台南,2023-09-14,9896
00665L,富邦�琤肭磪囓�2,16,0,16,元大-台南,2023-09-14,9896
2390,云辰,15,0,15,元大-台南,2023-09-14,9896
3011,今皓,15,0,15,元大-台南,2023-09-14,9896
2812,台中銀,15,0,15,元大-台南,2023-09-14,9896
1609,大亞,15,1,14,元大-台南,2023-09-14,9896
1504,東元,14,1,13,元大-台南,2023-09-14,9896
6113,亞矽,119,107,12,元大-台南,2023-09-14,9896
2485,兆赫,22,10,12,元大-台南,2023-09-14,9896
9921,巨大,11,0,11,元大-台南,2023-09-14,9896
3325,旭品,12,1,11,元大-台南,2023-09-14,9896
1101,台泥,14,3,11,元大-台南,2023-09-14,9896
2014,中鴻,10,0,10,元大-台南,2023-09-14,9896
6285,啟��,16,6,10,元大-台南,2023-09-14,9896
8069,元太,19,10,9,元大-台南,2023-09-14,9896
3045,台灣大,9,0,9,元大-台南,2023-09-14,9896
2105,正新,9,0,9,元大-台南,2023-09-14,9896
3049,精金,149,140,9,元大-台南,2023-09-14,9896
2634,漢翔,15,6,9,元大-台南,2023-09-14,9896
00915,凱基優選高股息30,19,11,8,元大-台南,2023-09-14,9896
3017,奇鋐,14,6,8,元大-台南,2023-09-14,9896
00679B,元大美債20年,8,0,8,元大-台南,2023-09-14,9896
1612,宏泰,9,1,8,元大-台南,2023-09-14,9896
8039,台虹,8,0,8,元大-台南,2023-09-14,9896
2329,華泰,29,21,8,元大-台南,2023-09-14,9896
1584,精剛,12,4,8,元大-台南,2023-09-14,9896
3264,欣銓,12,4,8,元大-台南,2023-09-14,9896
00919,群益台灣精選高息,422,136,286,元大-台南,2023-09-15,9896
00929,復華台灣科技優息,260,48,212,元大-台南,2023-09-15,9896
00712,復華富時不動產,212,9,203,元大-台南,2023-09-15,9896
00918,大華優利高填息30,188,9,179,元大-台南,2023-09-15,9896
2618,長榮航,158,3,155,元大-台南,2023-09-15,9896
2603,長榮,181,56,125,元大-台南,2023-09-15,9896
00637L,元大滬深300正2,103,0,103,元大-台南,2023-09-15,9896
6806,森崴能源,103,1,102,元大-台南,2023-09-15,9896
4746,台耀,111,10,101,元大-台南,2023-09-15,9896
00673R,期元大S＆P原油反1,116,15,101,元大-台南,2023-09-15,9896
00632R,元大台灣50反1,123,26,97,元大-台南,2023-09-15,9896
8034,榮群,71,1,70,元大-台南,2023-09-15,9896
2002,中鋼,65,0,65,元大-台南,2023-09-15,9896
2888,新光金,43,3,40,元大-台南,2023-09-15,9896
2884,玉山金,37,4,33,元大-台南,2023-09-15,9896
00679B,元大美債20年,34,1,33,元大-台南,2023-09-15,9896
00664R,國泰臺灣加權反1,40,10,30,元大-台南,2023-09-15,9896
2367,燿華,30,1,29,元大-台南,2023-09-15,9896
6282,康舒,34,6,28,元大-台南,2023-09-15,9896
00931B,統一美債20年,32,10,22,元大-台南,2023-09-15,9896
00772B,中信高評級公司債,21,0,21,元大-台南,2023-09-15,9896
4909,新復興,22,1,21,元大-台南,2023-09-15,9896
00932,兆豐永續高息等權,19,0,19,元大-台南,2023-09-15,9896
3035,智原,50,32,18,元大-台南,2023-09-15,9896
2486,一詮,47,29,18,元大-台南,2023-09-15,9896
6112,邁達特,17,0,17,元大-台南,2023-09-15,9896
2317,鴻海,26,9,17,元大-台南,2023-09-15,9896
3715,定穎投控,74,58,16,元大-台南,2023-09-15,9896
3481,群創,33,18,15,元大-台南,2023-09-15,9896
2610,華航,28,13,15,元大-台南,2023-09-15,9896
1905,華紙,17,2,15,元大-台南,2023-09-15,9896
1609,大亞,16,1,15,元大-台南,2023-09-15,9896
6104,創惟,14,0,14,元大-台南,2023-09-15,9896
5706,鳳凰,14,0,14,元大-台南,2023-09-15,9896
3545,敦泰,23,10,13,元大-台南,2023-09-15,9896
2436,偉詮電,28,15,13,元大-台南,2023-09-15,9896
2313,華通,83,71,12,元大-台南,2023-09-15,9896
2834,臺企銀,14,2,12,元大-台南,2023-09-15,9896
8068,全達,17,5,12,元大-台南,2023-09-15,9896
5880,合庫金,12,0,12,元大-台南,2023-09-15,9896
1802,台玻,11,0,11,元大-台南,2023-09-15,9896
1402,遠東新,11,0,11,元大-台南,2023-09-15,9896
00713,元大台灣高息低波,15,4,11,元大-台南,2023-09-15,9896
00795B,中信美國公債20年,11,0,11,元大-台南,2023-09-15,9896
2376,技嘉,17,6,11,元大-台南,2023-09-15,9896
2314,台揚,11,0,11,元大-台南,2023-09-15,9896
00892,富邦台灣半導體,12,1,11,元大-台南,2023-09-15,9896
3128,昇銳,121,111,10,元大-台南,2023-09-15,9896
3209,全科,10,0,10,元大-台南,2023-09-15,9896
00764B,群益25年美債,10,0,10,元大-台南,2023-09-15,9896
00929,復華台灣科技優息,579,91,488,元大-台南,2023-09-18,9896
00919,群益台灣精選高息,306,48,258,元大-台南,2023-09-18,9896
00679B,元大美債20年,102,0,102,元大-台南,2023-09-18,9896
1522,堤維西,124,32,92,元大-台南,2023-09-18,9896
00665L,富邦�琤肭磪囓�2,96,10,86,元大-台南,2023-09-18,9896
00878,國泰永續高股息,87,11,76,元大-台南,2023-09-18,9896
2363,矽統,210,146,64,元大-台南,2023-09-18,9896
2330,台積電,52,0,52,元大-台南,2023-09-18,9896
00751B,元大AAA至A公司債,46,0,46,元大-台南,2023-09-18,9896
00687B,國泰20年美債,43,1,42,元大-台南,2023-09-18,9896
6589,台康生技,44,2,42,元大-台南,2023-09-18,9896
00931B,統一美債20年,30,0,30,元大-台南,2023-09-18,9896
6187,萬潤,31,1,30,元大-台南,2023-09-18,9896
00720B,元大投資級公司債,30,0,30,元大-台南,2023-09-18,9896
00900,富邦特選高股息30,29,0,29,元大-台南,2023-09-18,9896
8034,榮群,30,1,29,元大-台南,2023-09-18,9896
1312,國喬,30,1,29,元大-台南,2023-09-18,9896
2382,廣達,33,4,29,元大-台南,2023-09-18,9896
00680L,元大美債20正2,28,0,28,元大-台南,2023-09-18,9896
00795B,中信美國公債20年,27,0,27,元大-台南,2023-09-18,9896
2887,台新金,30,4,26,元大-台南,2023-09-18,9896
2313,華通,171,147,24,元大-台南,2023-09-18,9896
2344,華邦電,30,7,23,元大-台南,2023-09-18,9896
00764B,群益25年美債,22,0,22,元大-台南,2023-09-18,9896
00738U,期元大道瓊白銀,20,0,20,元大-台南,2023-09-18,9896
3380,明泰,20,0,20,元大-台南,2023-09-18,9896
00915,凱基優選高股息30,21,3,18,元大-台南,2023-09-18,9896
2449,京元電子,18,1,17,元大-台南,2023-09-18,9896
2002,中鋼,24,8,16,元大-台南,2023-09-18,9896
00772B,中信高評級公司債,16,0,16,元大-台南,2023-09-18,9896
6275,元山,18,2,16,元大-台南,2023-09-18,9896
2352,佳世達,16,0,16,元大-台南,2023-09-18,9896
6282,康舒,21,6,15,元大-台南,2023-09-18,9896
3231,緯創,36,22,14,元大-台南,2023-09-18,9896
1584,精剛,13,0,13,元大-台南,2023-09-18,9896
8088,品安,17,4,13,元大-台南,2023-09-18,9896
00673R,期元大S＆P原油反1,13,0,13,元大-台南,2023-09-18,9896
00713,元大台灣高息低波,17,4,13,元大-台南,2023-09-18,9896
3276,宇環,12,0,12,元大-台南,2023-09-18,9896
2337,旺宏,12,0,12,元大-台南,2023-09-18,9896
00722B,群益投資級電信債,12,1,11,元大-台南,2023-09-18,9896
00882,中信中國高股息,11,0,11,元大-台南,2023-09-18,9896
3105,穩懋,11,0,11,元大-台南,2023-09-18,9896
2618,長榮航,55,44,11,元大-台南,2023-09-18,9896
5222,全訊,11,0,11,元大-台南,2023-09-18,9896
3419,譁裕,12,1,11,元大-台南,2023-09-18,9896
00932,兆豐永續高息等權,12,1,11,元大-台南,2023-09-18,9896
3715,定穎投控,114,103,11,元大-台南,2023-09-18,9896
0056,元大高股息,34,24,10,元大-台南,2023-09-18,9896
3324,雙鴻,21,11,10,元大-台南,2023-09-18,9896
00673R,期元大S＆P原油反1,426,0,426,元大-台南,2023-09-19,9896
2605,新興,253,2,251,元大-台南,2023-09-19,9896
2474,可成,245,0,245,元大-台南,2023-09-19,9896
00919,群益台灣精選高息,204,23,181,元大-台南,2023-09-19,9896
00712,復華富時不動產,141,5,136,元大-台南,2023-09-19,9896
00929,復華台灣科技優息,330,201,129,元大-台南,2023-09-19,9896
2344,華邦電,81,8,73,元大-台南,2023-09-19,9896
2618,長榮航,78,5,73,元大-台南,2023-09-19,9896
00918,大華優利高填息30,62,0,62,元大-台南,2023-09-19,9896
1524,耿鼎,56,0,56,元大-台南,2023-09-19,9896
00671R,富邦NASDAQ反1,55,0,55,元大-台南,2023-09-19,9896
3362,先進光,51,0,51,元大-台南,2023-09-19,9896
00665L,富邦�琤肭磪囓�2,50,4,46,元大-台南,2023-09-19,9896
2888,新光金,53,9,44,元大-台南,2023-09-19,9896
3231,緯創,81,45,36,元大-台南,2023-09-19,9896
2388,威盛,89,53,36,元大-台南,2023-09-19,9896
2330,台積電,39,5,34,元大-台南,2023-09-19,9896
2363,矽統,79,49,30,元大-台南,2023-09-19,9896
00900,富邦特選高股息30,32,6,26,元大-台南,2023-09-19,9896
00706L,期元大S＆P日圓正2,26,0,26,元大-台南,2023-09-19,9896
4979,華星光,50,27,23,元大-台南,2023-09-19,9896
00878,國泰永續高股息,35,12,23,元大-台南,2023-09-19,9896
00751B,元大AAA至A公司債,24,1,23,元大-台南,2023-09-19,9896
2355,敬鵬,28,7,21,元大-台南,2023-09-19,9896
00921,兆豐龍頭等權重,21,0,21,元大-台南,2023-09-19,9896
6153,嘉聯益,23,3,20,元大-台南,2023-09-19,9896
1584,精剛,27,8,19,元大-台南,2023-09-19,9896
00902,中信電池及儲能,17,0,17,元大-台南,2023-09-19,9896
00738U,期元大道瓊白銀,21,4,17,元大-台南,2023-09-19,9896
1101,台泥,19,2,17,元大-台南,2023-09-19,9896
6282,康舒,23,7,16,元大-台南,2023-09-19,9896
2312,金寶,16,0,16,元大-台南,2023-09-19,9896
00713,元大台灣高息低波,18,2,16,元大-台南,2023-09-19,9896
1809,中釉,19,5,14,元大-台南,2023-09-19,9896
2316,楠梓電,13,0,13,元大-台南,2023-09-19,9896
8027,鈦昇,14,1,13,元大-台南,2023-09-19,9896
6285,啟��,25,12,13,元大-台南,2023-09-19,9896
6901,鑽石投資,18,6,12,元大-台南,2023-09-19,9896
00893,國泰智能電動車,11,0,11,元大-台南,2023-09-19,9896
0056,元大高股息,13,2,11,元大-台南,2023-09-19,9896
2332,友訊,11,0,11,元大-台南,2023-09-19,9896
2002,中鋼,29,19,10,元大-台南,2023-09-19,9896
2392,正崴,10,0,10,元大-台南,2023-09-19,9896
2883,凱基金,21,11,10,元大-台南,2023-09-19,9896
6142,友勁,10,0,10,元大-台南,2023-09-19,9896
3709,鑫聯大投控,10,0,10,元大-台南,2023-09-19,9896
2495,普安,10,0,10,元大-台南,2023-09-19,9896
3264,欣銓,11,1,10,元大-台南,2023-09-19,9896
5516,雙喜,10,0,10,元大-台南,2023-09-19,9896
6139,亞翔,10,0,10,元大-台南,2023-09-19,9896
00673R,期元大S＆P原油反1,405,27,378,元大-台南,2023-09-20,9896
2888,新光金,132,2,130,元大-台南,2023-09-20,9896
1605,華新,121,18,103,元大-台南,2023-09-20,9896
0056,元大高股息,101,6,95,元大-台南,2023-09-20,9896
3481,群創,100,10,90,元大-台南,2023-09-20,9896
2883,凱基金,92,3,89,元大-台南,2023-09-20,9896
1324,地球,86,0,86,元大-台南,2023-09-20,9896
3265,台星科,141,63,78,元大-台南,2023-09-20,9896
2641,正德,82,5,77,元大-台南,2023-09-20,9896
00921,兆豐龍頭等權重,61,1,60,元大-台南,2023-09-20,9896
2330,台積電,44,1,43,元大-台南,2023-09-20,9896
3715,定穎投控,117,75,42,元大-台南,2023-09-20,9896
2834,臺企銀,40,0,40,元大-台南,2023-09-20,9896
00878,國泰永續高股息,59,22,37,元大-台南,2023-09-20,9896
1519,華城,39,2,37,元大-台南,2023-09-20,9896
3078,僑威,34,0,34,元大-台南,2023-09-20,9896
2605,新興,103,71,32,元大-台南,2023-09-20,9896
00773B,中信優先金融債,30,0,30,元大-台南,2023-09-20,9896
00753L,中信中國50正2,30,0,30,元大-台南,2023-09-20,9896
00923,群益台ESG低碳50,30,0,30,元大-台南,2023-09-20,9896
9950,萬國通,27,0,27,元大-台南,2023-09-20,9896
3005,神基,33,6,27,元大-台南,2023-09-20,9896
00931B,統一美債20年,26,0,26,元大-台南,2023-09-20,9896
00679B,元大美債20年,26,0,26,元大-台南,2023-09-20,9896
1524,耿鼎,45,21,24,元大-台南,2023-09-20,9896
00713,元大台灣高息低波,27,4,23,元大-台南,2023-09-20,9896
3706,神達,56,33,23,元大-台南,2023-09-20,9896
00932,兆豐永續高息等權,22,0,22,元大-台南,2023-09-20,9896
4960,誠美材,20,0,20,元大-台南,2023-09-20,9896
2838,聯邦銀,20,0,20,元大-台南,2023-09-20,9896
8088,品安,37,18,19,元大-台南,2023-09-20,9896
6901,鑽石投資,30,12,18,元大-台南,2023-09-20,9896
2890,永豐金,20,4,16,元大-台南,2023-09-20,9896
1101,台泥,16,0,16,元大-台南,2023-09-20,9896
2609,陽明,45,29,16,元大-台南,2023-09-20,9896
00751B,元大AAA至A公司債,15,0,15,元大-台南,2023-09-20,9896
5516,雙喜,15,0,15,元大-台南,2023-09-20,9896
00881,國泰台灣5G+,19,5,14,元大-台南,2023-09-20,9896
2344,華邦電,15,1,14,元大-台南,2023-09-20,9896
00720B,元大投資級公司債,13,0,13,元大-台南,2023-09-20,9896
1517,利奇,13,0,13,元大-台南,2023-09-20,9896
2537,聯上發,13,0,13,元大-台南,2023-09-20,9896
00922,國泰台灣領袖50,13,0,13,元大-台南,2023-09-20,9896
3042,晶技,11,0,11,元大-台南,2023-09-20,9896
6757,台灣虎航,11,0,11,元大-台南,2023-09-20,9896
2880,華南金,11,0,11,元大-台南,2023-09-20,9896
2401,凌陽,13,2,11,元大-台南,2023-09-20,9896
3037,欣興,13,2,11,元大-台南,2023-09-20,9896
6288,聯嘉,10,0,10,元大-台南,2023-09-20,9896
3346,麗清,12,2,10,元大-台南,2023-09-20,9896
00929,復華台灣科技優息,406,42,364,元大-台南,2023-09-21,9896
2474,可成,360,0,360,元大-台南,2023-09-21,9896
2882,國泰金,89,0,89,元大-台南,2023-09-21,9896
00712,復華富時不動產,81,0,81,元大-台南,2023-09-21,9896
2888,新光金,80,0,80,元大-台南,2023-09-21,9896
00919,群益台灣精選高息,98,18,80,元大-台南,2023-09-21,9896
2884,玉山金,78,0,78,元大-台南,2023-09-21,9896
2834,臺企銀,73,1,72,元大-台南,2023-09-21,9896
0050,元大台灣50,66,1,65,元大-台南,2023-09-21,9896
00878,國泰永續高股息,81,19,62,元大-台南,2023-09-21,9896
00751B,元大AAA至A公司債,65,4,61,元大-台南,2023-09-21,9896
1815,富喬,67,6,61,元大-台南,2023-09-21,9896
4123,晟德,51,0,51,元大-台南,2023-09-21,9896
2618,長榮航,66,16,50,元大-台南,2023-09-21,9896
2462,良得電,52,2,50,元大-台南,2023-09-21,9896
1101,台泥,50,6,44,元大-台南,2023-09-21,9896
00670L,富邦NASDAQ正2,41,0,41,元大-台南,2023-09-21,9896
2353,宏��,113,75,38,元大-台南,2023-09-21,9896
2891,中信金,37,2,35,元大-台南,2023-09-21,9896
2002,中鋼,35,0,35,元大-台南,2023-09-21,9896
1409,新纖,35,1,34,元大-台南,2023-09-21,9896
00881,國泰台灣5G+,34,1,33,元大-台南,2023-09-21,9896
00680L,元大美債20正2,35,2,33,元大-台南,2023-09-21,9896
2313,華通,61,28,33,元大-台南,2023-09-21,9896
0056,元大高股息,44,12,32,元大-台南,2023-09-21,9896
2367,燿華,53,22,31,元大-台南,2023-09-21,9896
2330,台積電,34,4,30,元大-台南,2023-09-21,9896
2606,裕民,27,2,25,元大-台南,2023-09-21,9896
00679B,元大美債20年,30,5,25,元大-台南,2023-09-21,9896
00902,中信電池及儲能,28,4,24,元大-台南,2023-09-21,9896
2887,台新金,25,2,23,元大-台南,2023-09-21,9896
3481,群創,23,2,21,元大-台南,2023-09-21,9896
00932,兆豐永續高息等權,19,0,19,元大-台南,2023-09-21,9896
2731,雄獅,22,4,18,元大-台南,2023-09-21,9896
2363,矽統,62,45,17,元大-台南,2023-09-21,9896
2344,華邦電,19,2,17,元大-台南,2023-09-21,9896
00915,凱基優選高股息30,20,4,16,元大-台南,2023-09-21,9896
00764B,群益25年美債,16,0,16,元大-台南,2023-09-21,9896
5213,亞昕,16,0,16,元大-台南,2023-09-21,9896
2880,華南金,15,0,15,元大-台南,2023-09-21,9896
2337,旺宏,16,1,15,元大-台南,2023-09-21,9896
5381,合正,18,3,15,元大-台南,2023-09-21,9896
1314,中石化,14,0,14,元大-台南,2023-09-21,9896
00795B,中信美國公債20年,14,0,14,元大-台南,2023-09-21,9896
9950,萬國通,13,0,13,元大-台南,2023-09-21,9896
2014,中鴻,14,2,12,元大-台南,2023-09-21,9896
2885,元大金,18,6,12,元大-台南,2023-09-21,9896
00757,統一FANG+,12,0,12,元大-台南,2023-09-21,9896
2332,友訊,12,0,12,元大-台南,2023-09-21,9896
00753L,中信中國50正2,12,0,12,元大-台南,2023-09-21,9896
00632R,元大台灣50反1,530,130,400,元大-台南,2023-09-22,9896
2883,凱基金,180,0,180,元大-台南,2023-09-22,9896
00679B,元大美債20年,172,0,172,元大-台南,2023-09-22,9896
00712,復華富時不動產,139,0,139,元大-台南,2023-09-22,9896
00720B,元大投資級公司債,123,0,123,元大-台南,2023-09-22,9896
00772B,中信高評級公司債,104,0,104,元大-台南,2023-09-22,9896
00929,復華台灣科技優息,102,29,73,元大-台南,2023-09-22,9896
00751B,元大AAA至A公司債,75,10,65,元大-台南,2023-09-22,9896
00680L,元大美債20正2,53,0,53,元大-台南,2023-09-22,9896
3122,笙泉,49,0,49,元大-台南,2023-09-22,9896
2353,宏��,47,1,46,元大-台南,2023-09-22,9896
2834,臺企銀,61,21,40,元大-台南,2023-09-22,9896
2888,新光金,37,0,37,元大-台南,2023-09-22,9896
00931B,統一美債20年,57,20,37,元大-台南,2023-09-22,9896
00687B,國泰20年美債,34,0,34,元大-台南,2023-09-22,9896
2610,華航,35,3,32,元大-台南,2023-09-22,9896
00857B,永豐20年美公債,29,0,29,元大-台南,2023-09-22,9896
6625,必應,33,4,29,元大-台南,2023-09-22,9896
5457,宣德,34,7,27,元大-台南,2023-09-22,9896
1101,台泥,27,0,27,元大-台南,2023-09-22,9896
1609,大亞,31,5,26,元大-台南,2023-09-22,9896
4123,晟德,30,6,24,元大-台南,2023-09-22,9896
1324,地球,29,5,24,元大-台南,2023-09-22,9896
00795B,中信美國公債20年,23,0,23,元大-台南,2023-09-22,9896
1524,耿鼎,132,111,21,元大-台南,2023-09-22,9896
1316,上曜,20,0,20,元大-台南,2023-09-22,9896
2890,永豐金,20,0,20,元大-台南,2023-09-22,9896
020020,元大台股領航N,20,0,20,元大-台南,2023-09-22,9896
2330,台積電,25,5,20,元大-台南,2023-09-22,9896
00885,富邦越南,19,0,19,元大-台南,2023-09-22,9896
2002,中鋼,20,2,18,元大-台南,2023-09-22,9896
3231,緯創,47,30,17,元大-台南,2023-09-22,9896
00878,國泰永續高股息,36,19,17,元大-台南,2023-09-22,9896
2462,良得電,18,2,16,元大-台南,2023-09-22,9896
2891,中信金,19,3,16,元大-台南,2023-09-22,9896
2303,聯電,15,0,15,元大-台南,2023-09-22,9896
8034,榮群,15,0,15,元大-台南,2023-09-22,9896
2606,裕民,15,1,14,元大-台南,2023-09-22,9896
6168,宏齊,22,8,14,元大-台南,2023-09-22,9896
2358,廷鑫,13,0,13,元大-台南,2023-09-22,9896
00655L,國泰中國A50正2,13,0,13,元大-台南,2023-09-22,9896
1717,長興,13,0,13,元大-台南,2023-09-22,9896
2454,聯發科,22,9,13,元大-台南,2023-09-22,9896
00757,統一FANG+,12,0,12,元大-台南,2023-09-22,9896
2637,慧洋-KY,12,0,12,元大-台南,2023-09-22,9896
6530,創威,19,7,12,元大-台南,2023-09-22,9896
5880,合庫金,12,0,12,元大-台南,2023-09-22,9896
00773B,中信優先金融債,11,0,11,元大-台南,2023-09-22,9896
2913,農林,20,9,11,元大-台南,2023-09-22,9896
1409,新纖,10,0,10,元大-台南,2023-09-22,9896
2474,可成,159,1,158,元大-台南,2023-09-25,9896
00929,復華台灣科技優息,156,11,145,元大-台南,2023-09-25,9896
00676R,富邦臺灣加權反1,100,0,100,元大-台南,2023-09-25,9896
00877,復華中國5G,67,0,67,元大-台南,2023-09-25,9896
3706,神達,64,13,51,元大-台南,2023-09-25,9896
1815,富喬,78,31,47,元大-台南,2023-09-25,9896
00679B,元大美債20年,46,0,46,元大-台南,2023-09-25,9896
6235,華孚,55,10,45,元大-台南,2023-09-25,9896
3122,笙泉,186,145,41,元大-台南,2023-09-25,9896
2382,廣達,59,21,38,元大-台南,2023-09-25,9896
00919,群益台灣精選高息,44,6,38,元大-台南,2023-09-25,9896
2425,承啟,35,0,35,元大-台南,2023-09-25,9896
3308,聯德,43,10,33,元大-台南,2023-09-25,9896
2891,中信金,33,1,32,元大-台南,2023-09-25,9896
3276,宇環,30,1,29,元大-台南,2023-09-25,9896
2313,華通,29,3,26,元大-台南,2023-09-25,9896
00706L,期元大S＆P日圓正2,24,0,24,元大-台南,2023-09-25,9896
2618,長榮航,29,5,24,元大-台南,2023-09-25,9896
00720B,元大投資級公司債,24,4,20,元大-台南,2023-09-25,9896
2610,華航,27,7,20,元大-台南,2023-09-25,9896
2033,佳大,20,0,20,元大-台南,2023-09-25,9896
1714,和桐,20,0,20,元大-台南,2023-09-25,9896
2303,聯電,32,13,19,元大-台南,2023-09-25,9896
2605,新興,21,2,19,元大-台南,2023-09-25,9896
2392,正崴,20,3,17,元大-台南,2023-09-25,9896
2881,富邦金,16,1,15,元大-台南,2023-09-25,9896
3231,緯創,29,15,14,元大-台南,2023-09-25,9896
00665L,富邦�琤肭磪囓�2,16,2,14,元大-台南,2023-09-25,9896
1101,台泥,19,5,14,元大-台南,2023-09-25,9896
2337,旺宏,13,0,13,元大-台南,2023-09-25,9896
1584,精剛,39,26,13,元大-台南,2023-09-25,9896
00902,中信電池及儲能,18,5,13,元大-台南,2023-09-25,9896
3014,聯陽,12,0,12,元大-台南,2023-09-25,9896
1504,東元,21,9,12,元大-台南,2023-09-25,9896
2421,建準,22,10,12,元大-台南,2023-09-25,9896
6282,康舒,13,1,12,元大-台南,2023-09-25,9896
1903,士紙,12,0,12,元大-台南,2023-09-25,9896
2330,台積電,15,3,12,元大-台南,2023-09-25,9896
1301,台塑,11,0,11,元大-台南,2023-09-25,9896
2816,旺旺保,11,0,11,元大-台南,2023-09-25,9896
2468,華經,15,4,11,元大-台南,2023-09-25,9896
2344,華邦電,12,1,11,元大-台南,2023-09-25,9896
2542,興富發,11,1,10,元大-台南,2023-09-25,9896
2455,全新,10,0,10,元大-台南,2023-09-25,9896
6684,安格,10,0,10,元大-台南,2023-09-25,9896
00772B,中信高評級公司債,10,0,10,元大-台南,2023-09-25,9896
5457,宣德,10,1,9,元大-台南,2023-09-25,9896
2376,技嘉,24,15,9,元大-台南,2023-09-25,9896
6485,點序,11,2,9,元大-台南,2023-09-25,9896
2537,聯上發,9,0,9,元大-台南,2023-09-25,9896
5880,合庫金,222,0,222,元大-台南,2023-09-26,9896
00929,復華台灣科技優息,139,21,118,元大-台南,2023-09-26,9896
00706L,期元大S＆P日圓正2,76,0,76,元大-台南,2023-09-26,9896
00931B,統一美債20年,72,0,72,元大-台南,2023-09-26,9896
00919,群益台灣精選高息,78,8,70,元大-台南,2023-09-26,9896
00680L,元大美債20正2,68,0,68,元大-台南,2023-09-26,9896
2208,台船,66,0,66,元大-台南,2023-09-26,9896
00878,國泰永續高股息,60,1,59,元大-台南,2023-09-26,9896
00720B,元大投資級公司債,54,0,54,元大-台南,2023-09-26,9896
6288,聯嘉,45,0,45,元大-台南,2023-09-26,9896
00679B,元大美債20年,103,64,39,元大-台南,2023-09-26,9896
2363,矽統,108,71,37,元大-台南,2023-09-26,9896
00772B,中信高評級公司債,36,0,36,元大-台南,2023-09-26,9896
2605,新興,35,0,35,元大-台南,2023-09-26,9896
0050,元大台灣50,35,0,35,元大-台南,2023-09-26,9896
2618,長榮航,35,2,33,元大-台南,2023-09-26,9896
2303,聯電,34,2,32,元大-台南,2023-09-26,9896
1314,中石化,31,0,31,元大-台南,2023-09-26,9896
1522,堤維西,53,23,30,元大-台南,2023-09-26,9896
6625,必應,29,0,29,元大-台南,2023-09-26,9896
2882,國泰金,26,0,26,元大-台南,2023-09-26,9896
00751B,元大AAA至A公司債,26,0,26,元大-台南,2023-09-26,9896
1524,耿鼎,79,55,24,元大-台南,2023-09-26,9896
2010,春源,25,1,24,元大-台南,2023-09-26,9896
3051,力特,31,8,23,元大-台南,2023-09-26,9896
9945,潤泰新,24,2,22,元大-台南,2023-09-26,9896
1402,遠東新,21,0,21,元大-台南,2023-09-26,9896
2337,旺宏,22,1,21,元大-台南,2023-09-26,9896
1503,士電,37,17,20,元大-台南,2023-09-26,9896
00712,復華富時不動產,29,9,20,元大-台南,2023-09-26,9896
4977,眾達-KY,26,6,20,元大-台南,2023-09-26,9896
1718,中纖,20,0,20,元大-台南,2023-09-26,9896
00673R,期元大S＆P原油反1,20,0,20,元大-台南,2023-09-26,9896
2330,台積電,17,0,17,元大-台南,2023-09-26,9896
00795B,中信美國公債20年,16,0,16,元大-台南,2023-09-26,9896
2606,裕民,16,0,16,元大-台南,2023-09-26,9896
2610,華航,31,15,16,元大-台南,2023-09-26,9896
2344,華邦電,16,1,15,元大-台南,2023-09-26,9896
2313,華通,41,26,15,元大-台南,2023-09-26,9896
1101,台泥,15,1,14,元大-台南,2023-09-26,9896
2634,漢翔,14,0,14,元大-台南,2023-09-26,9896
00885,富邦越南,15,2,13,元大-台南,2023-09-26,9896
00687B,國泰20年美債,18,5,13,元大-台南,2023-09-26,9896
2881,富邦金,13,0,13,元大-台南,2023-09-26,9896
2880,華南金,12,0,12,元大-台南,2023-09-26,9896
2462,良得電,12,0,12,元大-台南,2023-09-26,9896
00923,群益台ESG低碳50,12,0,12,元大-台南,2023-09-26,9896
2356,英業達,16,5,11,元大-台南,2023-09-26,9896
2328,廣宇,11,0,11,元大-台南,2023-09-26,9896
2816,旺旺保,13,2,11,元大-台南,2023-09-26,9896
00632R,元大台灣50反1,402,10,392,元大-台南,2023-09-27,9896
2474,可成,196,1,195,元大-台南,2023-09-27,9896
00720B,元大投資級公司債,104,0,104,元大-台南,2023-09-27,9896
00919,群益台灣精選高息,89,1,88,元大-台南,2023-09-27,9896
2358,廷鑫,60,0,60,元大-台南,2023-09-27,9896
00929,復華台灣科技優息,93,35,58,元大-台南,2023-09-27,9896
2605,新興,110,53,57,元大-台南,2023-09-27,9896
00712,復華富時不動產,51,0,51,元大-台南,2023-09-27,9896
1618,合機,69,31,38,元大-台南,2023-09-27,9896
3081,聯亞,32,1,31,元大-台南,2023-09-27,9896
2883B,凱基金乙特,30,0,30,元大-台南,2023-09-27,9896
2303,聯電,27,0,27,元大-台南,2023-09-27,9896
2834,臺企銀,25,0,25,元大-台南,2023-09-27,9896
1718,中纖,34,10,24,元大-台南,2023-09-27,9896
3715,定穎投控,116,93,23,元大-台南,2023-09-27,9896
00679B,元大美債20年,23,1,22,元大-台南,2023-09-27,9896
2812,台中銀,21,0,21,元大-台南,2023-09-27,9896
00671R,富邦NASDAQ反1,21,0,21,元大-台南,2023-09-27,9896
2337,旺宏,24,4,20,元大-台南,2023-09-27,9896
6770,力積電,18,0,18,元大-台南,2023-09-27,9896
2891,中信金,17,0,17,元大-台南,2023-09-27,9896
00931B,統一美債20年,17,0,17,元大-台南,2023-09-27,9896
2367,燿華,29,12,17,元大-台南,2023-09-27,9896
00680L,元大美債20正2,17,0,17,元大-台南,2023-09-27,9896
1802,台玻,21,5,16,元大-台南,2023-09-27,9896
1314,中石化,16,0,16,元大-台南,2023-09-27,9896
1519,華城,21,7,14,元大-台南,2023-09-27,9896
00902,中信電池及儲能,13,0,13,元大-台南,2023-09-27,9896
6901,鑽石投資,13,0,13,元大-台南,2023-09-27,9896
00932,兆豐永續高息等權,12,0,12,元大-台南,2023-09-27,9896
5460,同協,12,0,12,元大-台南,2023-09-27,9896
1609,大亞,41,29,12,元大-台南,2023-09-27,9896
9927,泰銘,12,0,12,元大-台南,2023-09-27,9896
1711,永光,12,0,12,元大-台南,2023-09-27,9896
6113,亞矽,120,109,11,元大-台南,2023-09-27,9896
6757,台灣虎航,11,0,11,元大-台南,2023-09-27,9896
3213,茂訊,11,0,11,元大-台南,2023-09-27,9896
1524,耿鼎,23,12,11,元大-台南,2023-09-27,9896
3443,創意,13,3,10,元大-台南,2023-09-27,9896
2612,中航,14,4,10,元大-台南,2023-09-27,9896
2851,中再保,10,0,10,元大-台南,2023-09-27,9896
4747,強生,10,0,10,元大-台南,2023-09-27,9896
3276,宇環,10,0,10,元大-台南,2023-09-27,9896
8150,南茂,9,0,9,元大-台南,2023-09-27,9896
2010,春源,9,0,9,元大-台南,2023-09-27,9896
3689,湧德,9,0,9,元大-台南,2023-09-27,9896
3017,奇鋐,19,10,9,元大-台南,2023-09-27,9896
2002,中鋼,37,28,9,元大-台南,2023-09-27,9896
1101,台泥,10,1,9,元大-台南,2023-09-27,9896
2883,凱基金,9,1,8,元大-台南,2023-09-27,9896
00679B,元大美債20年,127,0,127,元大-台南,2023-09-28,9896
00929,復華台灣科技優息,94,8,86,元大-台南,2023-09-28,9896
00712,復華富時不動產,82,0,82,元大-台南,2023-09-28,9896
00772B,中信高評級公司債,66,1,65,元大-台南,2023-09-28,9896
2363,矽統,117,54,63,元大-台南,2023-09-28,9896
6146,耕興,60,0,60,元大-台南,2023-09-28,9896
3231,緯創,97,45,52,元大-台南,2023-09-28,9896
2382,廣達,87,45,42,元大-台南,2023-09-28,9896
2303,聯電,39,8,31,元大-台南,2023-09-28,9896
8088,品安,41,12,29,元大-台南,2023-09-28,9896
2344,華邦電,26,2,24,元大-台南,2023-09-28,9896
2421,建準,22,1,21,元大-台南,2023-09-28,9896
00931B,統一美債20年,20,0,20,元大-台南,2023-09-28,9896
00670L,富邦NASDAQ正2,20,0,20,元大-台南,2023-09-28,9896
2641,正德,20,0,20,元大-台南,2023-09-28,9896
5460,同協,19,0,19,元大-台南,2023-09-28,9896
6418,詠昇,18,0,18,元大-台南,2023-09-28,9896
2610,華航,30,13,17,元大-台南,2023-09-28,9896
4961,天鈺,20,3,17,元大-台南,2023-09-28,9896
6806,森崴能源,20,3,17,元大-台南,2023-09-28,9896
9904,寶成,18,2,16,元大-台南,2023-09-28,9896
00751B,元大AAA至A公司債,37,21,16,元大-台南,2023-09-28,9896
00680L,元大美債20正2,14,0,14,元大-台南,2023-09-28,9896
2891,中信金,16,2,14,元大-台南,2023-09-28,9896
2408,南亞科,15,2,13,元大-台南,2023-09-28,9896
4944,兆遠,13,0,13,元大-台南,2023-09-28,9896
00900,富邦特選高股息30,16,3,13,元大-台南,2023-09-28,9896
2316,楠梓電,30,18,12,元大-台南,2023-09-28,9896
00795B,中信美國公債20年,11,0,11,元大-台南,2023-09-28,9896
3014,聯陽,11,0,11,元大-台南,2023-09-28,9896
1529,樂事綠能,12,1,11,元大-台南,2023-09-28,9896
2313,華通,22,11,11,元大-台南,2023-09-28,9896
00919,群益台灣精選高息,14,4,10,元大-台南,2023-09-28,9896
1301,台塑,11,1,10,元大-台南,2023-09-28,9896
3706,神達,13,3,10,元大-台南,2023-09-28,9896
2356,英業達,30,20,10,元大-台南,2023-09-28,9896
00714,群益道瓊美國地產,10,0,10,元大-台南,2023-09-28,9896
5864,致和證,10,0,10,元大-台南,2023-09-28,9896
2468,華經,20,10,10,元大-台南,2023-09-28,9896
020036,元大金融配息N,10,0,10,元大-台南,2023-09-28,9896
3276,宇環,10,0,10,元大-台南,2023-09-28,9896
5324,士開,10,0,10,元大-台南,2023-09-28,9896
5457,宣德,10,0,10,元大-台南,2023-09-28,9896
2317,鴻海,10,0,10,元大-台南,2023-09-28,9896
00713,元大台灣高息低波,11,2,9,元大-台南,2023-09-28,9896
2376,技嘉,24,15,9,元大-台南,2023-09-28,9896
5007,三星,9,0,9,元大-台南,2023-09-28,9896
2884,玉山金,9,0,9,元大-台南,2023-09-28,9896
2201,裕隆,13,5,8,元大-台南,2023-09-28,9896
3693,營邦,10,2,8,元大-台南,2023-09-28,9896
2474,可成,149,0,149,元大-台南,2023-10-02,9896
2603,長榮,168,62,106,元大-台南,2023-10-02,9896
00878,國泰永續高股息,122,27,95,元大-台南,2023-10-02,9896
00929,復華台灣科技優息,160,70,90,元大-台南,2023-10-02,9896
2382,廣達,138,54,84,元大-台南,2023-10-02,9896
2363,矽統,127,53,74,元大-台南,2023-10-02,9896
00720B,元大投資級公司債,61,0,61,元大-台南,2023-10-02,9896
2888,新光金,52,0,52,元大-台南,2023-10-02,9896
00713,元大台灣高息低波,50,2,48,元大-台南,2023-10-02,9896
2409,友達,59,13,46,元大-台南,2023-10-02,9896
2401,凌陽,41,0,41,元大-台南,2023-10-02,9896
2618,長榮航,38,0,38,元大-台南,2023-10-02,9896
00931B,統一美債20年,37,0,37,元大-台南,2023-10-02,9896
2887,台新金,37,1,36,元大-台南,2023-10-02,9896
2329,華泰,64,30,34,元大-台南,2023-10-02,9896
00679B,元大美債20年,54,22,32,元大-台南,2023-10-02,9896
6625,必應,30,0,30,元大-台南,2023-10-02,9896
2421,建準,43,15,28,元大-台南,2023-10-02,9896
00919,群益台灣精選高息,33,5,28,元大-台南,2023-10-02,9896
6146,耕興,27,0,27,元大-台南,2023-10-02,9896
00751B,元大AAA至A公司債,25,0,25,元大-台南,2023-10-02,9896
3036,文曄,38,13,25,元大-台南,2023-10-02,9896
00712,復華富時不動產,25,2,23,元大-台南,2023-10-02,9896
00772B,中信高評級公司債,23,0,23,元大-台南,2023-10-02,9896
00706L,期元大S＆P日圓正2,21,0,21,元大-台南,2023-10-02,9896
2884,玉山金,25,4,21,元大-台南,2023-10-02,9896
2610,華航,37,19,18,元大-台南,2023-10-02,9896
3715,定穎投控,76,60,16,元大-台南,2023-10-02,9896
2358,廷鑫,15,0,15,元大-台南,2023-10-02,9896
3011,今皓,15,0,15,元大-台南,2023-10-02,9896
00738U,期元大道瓊白銀,15,0,15,元大-台南,2023-10-02,9896
1101,台泥,15,0,15,元大-台南,2023-10-02,9896
6901,鑽石投資,16,2,14,元大-台南,2023-10-02,9896
8927,北基,13,0,13,元大-台南,2023-10-02,9896
8027,鈦昇,13,0,13,元大-台南,2023-10-02,9896
00740B,富邦全球投等債,13,0,13,元大-台南,2023-10-02,9896
6806,森崴能源,17,4,13,元大-台南,2023-10-02,9896
3014,聯陽,15,3,12,元大-台南,2023-10-02,9896
6166,凌華,12,0,12,元大-台南,2023-10-02,9896
3264,欣銓,12,0,12,元大-台南,2023-10-02,9896
00722B,群益投資級電信債,12,0,12,元大-台南,2023-10-02,9896
6113,亞矽,65,54,11,元大-台南,2023-10-02,9896
3450,聯鈞,27,16,11,元大-台南,2023-10-02,9896
6108,競國,11,1,10,元大-台南,2023-10-02,9896
2449,京元電子,13,3,10,元大-台南,2023-10-02,9896
00687B,國泰20年美債,9,0,9,元大-台南,2023-10-02,9896
3017,奇鋐,21,12,9,元大-台南,2023-10-02,9896
2356,英業達,78,69,9,元大-台南,2023-10-02,9896
6285,啟��,10,2,8,元大-台南,2023-10-02,9896
00795B,中信美國公債20年,8,0,8,元大-台南,2023-10-02,9896
00673R,期元大S＆P原油反1,301,32,269,元大-台南,2023-10-03,9896
2892,第一金,101,3,98,元大-台南,2023-10-03,9896
00712,復華富時不動產,93,0,93,元大-台南,2023-10-03,9896
00929,復華台灣科技優息,110,17,93,元大-台南,2023-10-03,9896
00632R,元大台灣50反1,100,25,75,元大-台南,2023-10-03,9896
00882,中信中國高股息,69,0,69,元大-台南,2023-10-03,9896
2017,官田鋼,60,0,60,元大-台南,2023-10-03,9896
0056,元大高股息,112,55,57,元大-台南,2023-10-03,9896
00772B,中信高評級公司債,49,0,49,元大-台南,2023-10-03,9896
2409,友達,72,25,47,元大-台南,2023-10-03,9896
00922,國泰台灣領袖50,46,0,46,元大-台南,2023-10-03,9896
4939,亞電,40,0,40,元大-台南,2023-10-03,9896
00720B,元大投資級公司債,41,5,36,元大-台南,2023-10-03,9896
00751B,元大AAA至A公司債,56,23,33,元大-台南,2023-10-03,9896
00877,復華中國5G,30,0,30,元大-台南,2023-10-03,9896
00679B,元大美債20年,27,0,27,元大-台南,2023-10-03,9896
3231,緯創,87,60,27,元大-台南,2023-10-03,9896
00931B,統一美債20年,25,0,25,元大-台南,2023-10-03,9896
00738U,期元大道瓊白銀,24,0,24,元大-台南,2023-10-03,9896
2329,華泰,36,12,24,元大-台南,2023-10-03,9896
2618,長榮航,48,27,21,元大-台南,2023-10-03,9896
00902,中信電池及儲能,21,0,21,元大-台南,2023-10-03,9896
00714,群益道瓊美國地產,20,0,20,元大-台南,2023-10-03,9896
00680L,元大美債20正2,40,20,20,元大-台南,2023-10-03,9896
2363,矽統,45,26,19,元大-台南,2023-10-03,9896
2353,宏��,25,6,19,元大-台南,2023-10-03,9896
00878,國泰永續高股息,22,3,19,元大-台南,2023-10-03,9896
00715L,期街口布蘭特正2,18,0,18,元大-台南,2023-10-03,9896
6282,康舒,18,0,18,元大-台南,2023-10-03,9896
1513,中興電,22,6,16,元大-台南,2023-10-03,9896
2002,中鋼,47,32,15,元大-台南,2023-10-03,9896
2382,廣達,24,10,14,元大-台南,2023-10-03,9896
2356,英業達,25,12,13,元大-台南,2023-10-03,9896
1605,華新,18,5,13,元大-台南,2023-10-03,9896
2313,華通,22,9,13,元大-台南,2023-10-03,9896
4908,前鼎,13,0,13,元大-台南,2023-10-03,9896
2367,燿華,18,5,13,元大-台南,2023-10-03,9896
2913,農林,15,2,13,元大-台南,2023-10-03,9896
8926,台汽電,13,0,13,元大-台南,2023-10-03,9896
1524,耿鼎,14,2,12,元大-台南,2023-10-03,9896
2374,佳能,15,3,12,元大-台南,2023-10-03,9896
00919,群益台灣精選高息,26,15,11,元大-台南,2023-10-03,9896
6139,亞翔,15,4,11,元大-台南,2023-10-03,9896
3034,聯詠,12,1,11,元大-台南,2023-10-03,9896
2537,聯上發,11,0,11,元大-台南,2023-10-03,9896
2633,台灣高鐵,11,0,11,元大-台南,2023-10-03,9896
3308,聯德,11,0,11,元大-台南,2023-10-03,9896
8064,東捷,11,0,11,元大-台南,2023-10-03,9896
00706L,期元大S＆P日圓正2,11,0,11,元大-台南,2023-10-03,9896
3265,台星科,20,9,11,元大-台南,2023-10-03,9896
2474,可成,165,0,165,元大-台南,2023-10-04,9896
2891,中信金,153,7,146,元大-台南,2023-10-04,9896
00772B,中信高評級公司債,117,0,117,元大-台南,2023-10-04,9896
00712,復華富時不動產,103,0,103,元大-台南,2023-10-04,9896
2618,長榮航,113,23,90,元大-台南,2023-10-04,9896
00679B,元大美債20年,99,15,84,元大-台南,2023-10-04,9896
3032,偉訓,100,20,80,元大-台南,2023-10-04,9896
2303,聯電,87,11,76,元大-台南,2023-10-04,9896
00720B,元大投資級公司債,73,1,72,元大-台南,2023-10-04,9896
2884,玉山金,73,1,72,元大-台南,2023-10-04,9896
00929,復華台灣科技優息,170,100,70,元大-台南,2023-10-04,9896
3481,群創,73,3,70,元大-台南,2023-10-04,9896
2002,中鋼,85,19,66,元大-台南,2023-10-04,9896
0056,元大高股息,72,10,62,元大-台南,2023-10-04,9896
00773B,中信優先金融債,61,0,61,元大-台南,2023-10-04,9896
2017,官田鋼,54,0,54,元大-台南,2023-10-04,9896
2883,凱基金,54,2,52,元大-台南,2023-10-04,9896
00931B,統一美債20年,45,0,45,元大-台南,2023-10-04,9896
00751B,元大AAA至A公司債,52,8,44,元大-台南,2023-10-04,9896
8271,宇瞻,43,0,43,元大-台南,2023-10-04,9896
2409,友達,55,13,42,元大-台南,2023-10-04,9896
2511,太子,38,0,38,元大-台南,2023-10-04,9896
1402,遠東新,35,0,35,元大-台南,2023-10-04,9896
00919,群益台灣精選高息,47,12,35,元大-台南,2023-10-04,9896
5512,力麒,346,313,33,元大-台南,2023-10-04,9896
2892,第一金,33,0,33,元大-台南,2023-10-04,9896
00922,國泰台灣領袖50,32,0,32,元大-台南,2023-10-04,9896
00680L,元大美債20正2,51,20,31,元大-台南,2023-10-04,9896
1605,華新,36,6,30,元大-台南,2023-10-04,9896
00673R,期元大S＆P原油反1,30,0,30,元大-台南,2023-10-04,9896
6625,必應,30,0,30,元大-台南,2023-10-04,9896
2882,國泰金,27,0,27,元大-台南,2023-10-04,9896
1524,耿鼎,38,12,26,元大-台南,2023-10-04,9896
2886,兆豐金,27,1,26,元大-台南,2023-10-04,9896
2887,台新金,26,2,24,元大-台南,2023-10-04,9896
4123,晟德,23,0,23,元大-台南,2023-10-04,9896
00708L,期元大S＆P黃金正2,22,0,22,元大-台南,2023-10-04,9896
2888,新光金,21,0,21,元大-台南,2023-10-04,9896
2834,臺企銀,36,15,21,元大-台南,2023-10-04,9896
00714,群益道瓊美國地產,21,0,21,元大-台南,2023-10-04,9896
2890,永豐金,21,0,21,元大-台南,2023-10-04,9896
00902,中信電池及儲能,20,0,20,元大-台南,2023-10-04,9896
00674R,期元大S＆P黃金反1,20,0,20,元大-台南,2023-10-04,9896
2427,三商電,22,2,20,元大-台南,2023-10-04,9896
00888,永豐台灣ESG,19,0,19,元大-台南,2023-10-04,9896
2353,宏��,31,13,18,元大-台南,2023-10-04,9896
2412,中華電,17,0,17,元大-台南,2023-10-04,9896
3715,定穎投控,66,49,17,元大-台南,2023-10-04,9896
00725B,國泰投資級公司債,17,0,17,元大-台南,2023-10-04,9896
2606,裕民,17,1,16,元大-台南,2023-10-04,9896
00712,復華富時不動產,251,20,231,元大-台南,2023-10-05,9896
00632R,元大台灣50反1,220,0,220,元大-台南,2023-10-05,9896
00676R,富邦臺灣加權反1,102,0,102,元大-台南,2023-10-05,9896
00929,復華台灣科技優息,145,70,75,元大-台南,2023-10-05,9896
2462,良得電,51,0,51,元大-台南,2023-10-05,9896
5512,力麒,337,291,46,元大-台南,2023-10-05,9896
6288,聯嘉,43,1,42,元大-台南,2023-10-05,9896
2201,裕隆,38,3,35,元大-台南,2023-10-05,9896
00715L,期街口布蘭特正2,55,22,33,元大-台南,2023-10-05,9896
2883,凱基金,34,2,32,元大-台南,2023-10-05,9896
6603,富強鑫,30,0,30,元大-台南,2023-10-05,9896
0056,元大高股息,48,19,29,元大-台南,2023-10-05,9896
3231,緯創,86,59,27,元大-台南,2023-10-05,9896
3669,圓展,22,0,22,元大-台南,2023-10-05,9896
3122,笙泉,21,0,21,元大-台南,2023-10-05,9896
00897,富邦基因免疫生技,20,0,20,元大-台南,2023-10-05,9896
2405,輔信,46,26,20,元大-台南,2023-10-05,9896
1101,台泥,19,0,19,元大-台南,2023-10-05,9896
2313,華通,44,25,19,元大-台南,2023-10-05,9896
2892,第一金,21,2,19,元大-台南,2023-10-05,9896
2610,華航,50,31,19,元大-台南,2023-10-05,9896
4543,萬在,18,0,18,元大-台南,2023-10-05,9896
00922,國泰台灣領袖50,18,0,18,元大-台南,2023-10-05,9896
3362,先進光,40,23,17,元大-台南,2023-10-05,9896
00679B,元大美債20年,18,4,14,元大-台南,2023-10-05,9896
1324,地球,14,0,14,元大-台南,2023-10-05,9896
2359,所羅門,13,1,12,元大-台南,2023-10-05,9896
2427,三商電,16,4,12,元大-台南,2023-10-05,9896
2486,一詮,41,29,12,元大-台南,2023-10-05,9896
4974,亞泰,11,0,11,元大-台南,2023-10-05,9896
2332,友訊,11,0,11,元大-台南,2023-10-05,9896
00665L,富邦�琤肭磪囓�2,15,4,11,元大-台南,2023-10-05,9896
00882,中信中國高股息,11,0,11,元大-台南,2023-10-05,9896
3044,健鼎,12,2,10,元大-台南,2023-10-05,9896
3265,台星科,23,13,10,元大-台南,2023-10-05,9896
2883B,凱基金乙特,10,0,10,元大-台南,2023-10-05,9896
1314,中石化,10,0,10,元大-台南,2023-10-05,9896
3567,逸昌,10,0,10,元大-台南,2023-10-05,9896
2382,廣達,18,8,10,元大-台南,2023-10-05,9896
1519,華城,24,16,8,元大-台南,2023-10-05,9896
3693,營邦,9,1,8,元大-台南,2023-10-05,9896
8942,森鉅,9,1,8,元大-台南,2023-10-05,9896
2618,長榮航,48,41,7,元大-台南,2023-10-05,9896
3037,欣興,9,2,7,元大-台南,2023-10-05,9896
3596,智易,8,1,7,元大-台南,2023-10-05,9896
6274,台燿,20,13,7,元大-台南,2023-10-05,9896
3017,奇鋐,13,6,7,元大-台南,2023-10-05,9896
6226,光鼎,37,30,7,元大-台南,2023-10-05,9896
2634,漢翔,8,1,7,元大-台南,2023-10-05,9896
1815,富喬,36,29,7,元大-台南,2023-10-05,9896
00929,復華台灣科技優息,230,42,188,元大-台南,2023-10-06,9896
2474,可成,105,0,105,元大-台南,2023-10-06,9896
00715L,期街口布蘭特正2,99,6,93,元大-台南,2023-10-06,9896
2618,長榮航,88,7,81,元大-台南,2023-10-06,9896
2603,長榮,77,0,77,元大-台南,2023-10-06,9896
00712,復華富時不動產,66,0,66,元大-台南,2023-10-06,9896
00679B,元大美債20年,62,3,59,元大-台南,2023-10-06,9896
8938,明安,56,0,56,元大-台南,2023-10-06,9896
2017,官田鋼,50,0,50,元大-台南,2023-10-06,9896
00680L,元大美債20正2,36,0,36,元大-台南,2023-10-06,9896
2409,友達,38,3,35,元大-台南,2023-10-06,9896
1402,遠東新,33,0,33,元大-台南,2023-10-06,9896
3014,聯陽,33,1,32,元大-台南,2023-10-06,9896
00772B,中信高評級公司債,30,0,30,元大-台南,2023-10-06,9896
2329,華泰,50,23,27,元大-台南,2023-10-06,9896
3531,先益,25,0,25,元大-台南,2023-10-06,9896
2365,昆盈,39,14,25,元大-台南,2023-10-06,9896
1718,中纖,24,0,24,元大-台南,2023-10-06,9896
3032,偉訓,26,4,22,元大-台南,2023-10-06,9896
2405,輔信,20,1,19,元大-台南,2023-10-06,9896
3231,緯創,47,29,18,元大-台南,2023-10-06,9896
00720B,元大投資級公司債,18,0,18,元大-台南,2023-10-06,9896
6477,安集,16,0,16,元大-台南,2023-10-06,9896
9105,泰金寶-DR,16,0,16,元大-台南,2023-10-06,9896
8271,宇瞻,16,1,15,元大-台南,2023-10-06,9896
2002,中鋼,19,6,13,元大-台南,2023-10-06,9896
2610,華航,16,3,13,元大-台南,2023-10-06,9896
3046,建��,13,0,13,元大-台南,2023-10-06,9896
2442,新美齊,13,1,12,元大-台南,2023-10-06,9896
00751B,元大AAA至A公司債,12,0,12,元大-台南,2023-10-06,9896
1101,台泥,13,1,12,元大-台南,2023-10-06,9896
8420,明揚,13,1,12,元大-台南,2023-10-06,9896
2449,京元電子,14,2,12,元大-台南,2023-10-06,9896
00738U,期元大道瓊白銀,11,0,11,元大-台南,2023-10-06,9896
2458,義隆,10,0,10,元大-台南,2023-10-06,9896
2912,統一超,10,0,10,元大-台南,2023-10-06,9896
00919,群益台灣精選高息,15,5,10,元大-台南,2023-10-06,9896
1506,正道,10,0,10,元大-台南,2023-10-06,9896
3689,湧德,10,0,10,元大-台南,2023-10-06,9896
2462,良得電,10,0,10,元大-台南,2023-10-06,9896
6204,艾華,10,0,10,元大-台南,2023-10-06,9896
00931B,統一美債20年,12,3,9,元大-台南,2023-10-06,9896
3105,穩懋,10,1,9,元大-台南,2023-10-06,9896
4938,和碩,12,3,9,元大-台南,2023-10-06,9896
2363,矽統,65,56,9,元大-台南,2023-10-06,9896
3081,聯亞,12,4,8,元大-台南,2023-10-06,9896
2641,正德,10,3,7,元大-台南,2023-10-06,9896
8086,宏捷科,7,0,7,元大-台南,2023-10-06,9896
00632R,元大台灣50反1,17,10,7,元大-台南,2023-10-06,9896
2455,全新,9,3,6,元大-台南,2023-10-06,9896
00632R,元大台灣50反1,270,30,240,元大-台南,2023-10-11,9896
2474,可成,125,2,123,元大-台南,2023-10-11,9896
00676R,富邦臺灣加權反1,101,0,101,元大-台南,2023-10-11,9896
3231,緯創,183,118,65,元大-台南,2023-10-11,9896
2883,凱基金,76,15,61,元大-台南,2023-10-11,9896
2603,長榮,124,68,56,元大-台南,2023-10-11,9896
1402,遠東新,40,2,38,元大-台南,2023-10-11,9896
2641,正德,39,2,37,元大-台南,2023-10-11,9896
2017,官田鋼,35,1,34,元大-台南,2023-10-11,9896
00919,群益台灣精選高息,35,2,33,元大-台南,2023-10-11,9896
6156,松上,47,18,29,元大-台南,2023-10-11,9896
2618,長榮航,48,22,26,元大-台南,2023-10-11,9896
00712,復華富時不動產,25,0,25,元大-台南,2023-10-11,9896
1310,台苯,25,0,25,元大-台南,2023-10-11,9896
3545,敦泰,24,0,24,元大-台南,2023-10-11,9896
2887,台新金,23,1,22,元大-台南,2023-10-11,9896
2332,友訊,22,0,22,元大-台南,2023-10-11,9896
3481,群創,35,14,21,元大-台南,2023-10-11,9896
00720B,元大投資級公司債,24,3,21,元大-台南,2023-10-11,9896
2329,華泰,42,24,18,元大-台南,2023-10-11,9896
2609,陽明,20,2,18,元大-台南,2023-10-11,9896
3540,曜越,16,0,16,元大-台南,2023-10-11,9896
2014,中鴻,16,0,16,元大-台南,2023-10-11,9896
2349,錸德,15,0,15,元大-台南,2023-10-11,9896
2436,偉詮電,16,1,15,元大-台南,2023-10-11,9896
2376,技嘉,74,59,15,元大-台南,2023-10-11,9896
00679B,元大美債20年,27,13,14,元大-台南,2023-10-11,9896
3325,旭品,31,17,14,元大-台南,2023-10-11,9896
00664R,國泰臺灣加權反1,13,0,13,元大-台南,2023-10-11,9896
6189,豐藝,16,3,13,元大-台南,2023-10-11,9896
4944,兆遠,12,0,12,元大-台南,2023-10-11,9896
6625,必應,11,0,11,元大-台南,2023-10-11,9896
5469,瀚宇博,12,1,11,元大-台南,2023-10-11,9896
6142,友勁,11,0,11,元大-台南,2023-10-11,9896
2501,國建,11,0,11,元大-台南,2023-10-11,9896
3689,湧德,11,0,11,元大-台南,2023-10-11,9896
1815,富喬,22,11,11,元大-台南,2023-10-11,9896
6477,安集,17,6,11,元大-台南,2023-10-11,9896
5258,虹堡,12,1,11,元大-台南,2023-10-11,9896
00637L,元大滬深300正2,18,7,11,元大-台南,2023-10-11,9896
1802,台玻,13,2,11,元大-台南,2023-10-11,9896
2356,英業達,18,7,11,元大-台南,2023-10-11,9896
00751B,元大AAA至A公司債,10,0,10,元大-台南,2023-10-11,9896
2388,威盛,18,8,10,元大-台南,2023-10-11,9896
1720,生達,12,2,10,元大-台南,2023-10-11,9896
6167,久正,10,0,10,元大-台南,2023-10-11,9896
1506,正道,10,0,10,元大-台南,2023-10-11,9896
9907,統一實,10,0,10,元大-台南,2023-10-11,9896
3037,欣興,11,2,9,元大-台南,2023-10-11,9896
00687B,國泰20年美債,9,0,9,元大-台南,2023-10-11,9896
00715L,期街口布蘭特正2,139,2,137,元大-台南,2023-10-12,9896
00671R,富邦NASDAQ反1,100,0,100,元大-台南,2023-10-12,9896
00679B,元大美債20年,88,1,87,元大-台南,2023-10-12,9896
2474,可成,82,0,82,元大-台南,2023-10-12,9896
2883,凱基金,79,17,62,元大-台南,2023-10-12,9896
2363,矽統,171,119,52,元大-台南,2023-10-12,9896
00929,復華台灣科技優息,51,10,41,元大-台南,2023-10-12,9896
2884,玉山金,42,1,41,元大-台南,2023-10-12,9896
2605,新興,41,0,41,元大-台南,2023-10-12,9896
1402,遠東新,50,11,39,元大-台南,2023-10-12,9896
2881,富邦金,38,2,36,元大-台南,2023-10-12,9896
2633,台灣高鐵,33,0,33,元大-台南,2023-10-12,9896
00680L,元大美債20正2,33,3,30,元大-台南,2023-10-12,9896
00751B,元大AAA至A公司債,34,6,28,元大-台南,2023-10-12,9896
0056,元大高股息,32,7,25,元大-台南,2023-10-12,9896
2409,友達,67,43,24,元大-台南,2023-10-12,9896
00664R,國泰臺灣加權反1,23,0,23,元大-台南,2023-10-12,9896
00919,群益台灣精選高息,24,3,21,元大-台南,2023-10-12,9896
2353,宏��,21,1,20,元大-台南,2023-10-12,9896
00878,國泰永續高股息,53,35,18,元大-台南,2023-10-12,9896
6282,康舒,24,8,16,元大-台南,2023-10-12,9896
2352,佳世達,17,1,16,元大-台南,2023-10-12,9896
00637L,元大滬深300正2,16,1,15,元大-台南,2023-10-12,9896
00738U,期元大道瓊白銀,20,6,14,元大-台南,2023-10-12,9896
2376,技嘉,37,23,14,元大-台南,2023-10-12,9896
6451,訊芯-KY,21,8,13,元大-台南,2023-10-12,9896
1609,大亞,16,3,13,元大-台南,2023-10-12,9896
2453,凌群,18,6,12,元大-台南,2023-10-12,9896
3264,欣銓,11,0,11,元大-台南,2023-10-12,9896
2537,聯上發,11,0,11,元大-台南,2023-10-12,9896
1584,精剛,10,0,10,元大-台南,2023-10-12,9896
1101,台泥,13,3,10,元大-台南,2023-10-12,9896
2515,中工,10,0,10,元大-台南,2023-10-12,9896
2538,基泰,10,0,10,元大-台南,2023-10-12,9896
2017,官田鋼,10,0,10,元大-台南,2023-10-12,9896
3311,閎暉,10,0,10,元大-台南,2023-10-12,9896
6288,聯嘉,10,1,9,元大-台南,2023-10-12,9896
1568,倉佑,10,1,9,元大-台南,2023-10-12,9896
2888,新光金,8,0,8,元大-台南,2023-10-12,9896
3227,原相,9,1,8,元大-台南,2023-10-12,9896
3081,聯亞,8,0,8,元大-台南,2023-10-12,9896
6015,宏遠證,8,0,8,元大-台南,2023-10-12,9896
2324,仁寶,7,0,7,元大-台南,2023-10-12,9896
4976,佳凌,7,0,7,元大-台南,2023-10-12,9896
1301,台塑,7,0,7,元大-台南,2023-10-12,9896
2731,雄獅,10,3,7,元大-台南,2023-10-12,9896
4161,聿新科,8,1,7,元大-台南,2023-10-12,9896
1514,亞力,6,0,6,元大-台南,2023-10-12,9896
2886,兆豐金,32,26,6,元大-台南,2023-10-12,9896
2408,南亞科,8,2,6,元大-台南,2023-10-12,9896
2892,第一金,301,0,301,元大-台南,2023-10-13,9896
2344,華邦電,141,5,136,元大-台南,2023-10-13,9896
00637L,元大滬深300正2,134,12,122,元大-台南,2023-10-13,9896
0056,元大高股息,100,1,99,元大-台南,2023-10-13,9896
3231,緯創,172,75,97,元大-台南,2023-10-13,9896
00919,群益台灣精選高息,99,6,93,元大-台南,2023-10-13,9896
00878,國泰永續高股息,94,10,84,元大-台南,2023-10-13,9896
2618,長榮航,77,7,70,元大-台南,2023-10-13,9896
2474,可成,64,2,62,元大-台南,2023-10-13,9896
00929,復華台灣科技優息,132,76,56,元大-台南,2023-10-13,9896
00632R,元大台灣50反1,143,90,53,元大-台南,2023-10-13,9896
6284,佳邦,69,22,47,元大-台南,2023-10-13,9896
2883,凱基金,109,74,35,元大-台南,2023-10-13,9896
2353,宏��,39,4,35,元大-台南,2023-10-13,9896
00885,富邦越南,32,0,32,元大-台南,2023-10-13,9896
00679B,元大美債20年,42,13,29,元大-台南,2023-10-13,9896
3715,定穎投控,76,52,24,元大-台南,2023-10-13,9896
1101,台泥,26,3,23,元大-台南,2023-10-13,9896
00720B,元大投資級公司債,23,0,23,元大-台南,2023-10-13,9896
4979,華星光,37,14,23,元大-台南,2023-10-13,9896
00902,中信電池及儲能,22,0,22,元大-台南,2023-10-13,9896
2881,富邦金,24,3,21,元大-台南,2023-10-13,9896
9105,泰金寶-DR,20,0,20,元大-台南,2023-10-13,9896
2641,正德,21,1,20,元大-台南,2023-10-13,9896
00712,復華富時不動產,19,0,19,元大-台南,2023-10-13,9896
8088,品安,20,1,19,元大-台南,2023-10-13,9896
2376,技嘉,29,12,17,元大-台南,2023-10-13,9896
2461,光群雷,17,0,17,元大-台南,2023-10-13,9896
3483,力致,28,12,16,元大-台南,2023-10-13,9896
2382,廣達,96,81,15,元大-台南,2023-10-13,9896
5009,榮剛,18,3,15,元大-台南,2023-10-13,9896
3062,建漢,16,1,15,元大-台南,2023-10-13,9896
2891,中信金,19,4,15,元大-台南,2023-10-13,9896
00751B,元大AAA至A公司債,26,14,12,元大-台南,2023-10-13,9896
6288,聯嘉,12,0,12,元大-台南,2023-10-13,9896
2610,華航,28,16,12,元大-台南,2023-10-13,9896
1905,華紙,13,2,11,元大-台南,2023-10-13,9896
00907,永豐優息存股,11,0,11,元大-台南,2023-10-13,9896
2511,太子,11,0,11,元大-台南,2023-10-13,9896
3046,建��,11,0,11,元大-台南,2023-10-13,9896
3325,旭品,14,3,11,元大-台南,2023-10-13,9896
2615,萬海,13,2,11,元大-台南,2023-10-13,9896
1504,東元,10,0,10,元大-台南,2023-10-13,9896
6148,驊宏資,10,0,10,元大-台南,2023-10-13,9896
00722B,群益投資級電信債,10,0,10,元大-台南,2023-10-13,9896
2367,燿華,10,0,10,元大-台南,2023-10-13,9896
4105,東洋,10,0,10,元大-台南,2023-10-13,9896
2301,光寶科,16,7,9,元大-台南,2023-10-13,9896
2329,華泰,12,3,9,元大-台南,2023-10-13,9896
2486,一詮,16,7,9,元大-台南,2023-10-13,9896
2474,可成,180,0,180,元大-台南,2023-10-16,9896
00929,復華台灣科技優息,142,10,132,元大-台南,2023-10-16,9896
3702,大聯大,101,0,101,元大-台南,2023-10-16,9896
6120,達運,98,13,85,元大-台南,2023-10-16,9896
2344,華邦電,86,6,80,元大-台南,2023-10-16,9896
2618,長榮航,100,22,78,元大-台南,2023-10-16,9896
5009,榮剛,81,10,71,元大-台南,2023-10-16,9896
0056,元大高股息,72,5,67,元大-台南,2023-10-16,9896
1609,大亞,68,5,63,元大-台南,2023-10-16,9896
1605,華新,54,0,54,元大-台南,2023-10-16,9896
00712,復華富時不動產,50,0,50,元大-台南,2023-10-16,9896
00922,國泰台灣領袖50,47,0,47,元大-台南,2023-10-16,9896
5347,世界,45,2,43,元大-台南,2023-10-16,9896
00720B,元大投資級公司債,44,1,43,元大-台南,2023-10-16,9896
2363,矽統,177,135,42,元大-台南,2023-10-16,9896
00919,群益台灣精選高息,42,6,36,元大-台南,2023-10-16,9896
2201,裕隆,66,31,35,元大-台南,2023-10-16,9896
2538,基泰,34,0,34,元大-台南,2023-10-16,9896
1722,台肥,33,0,33,元大-台南,2023-10-16,9896
020039,元大加權N,33,0,33,元大-台南,2023-10-16,9896
3715,定穎投控,54,24,30,元大-台南,2023-10-16,9896
1524,耿鼎,27,1,26,元大-台南,2023-10-16,9896
2605,新興,24,0,24,元大-台南,2023-10-16,9896
00882,中信中國高股息,23,0,23,元大-台南,2023-10-16,9896
8088,品安,21,0,21,元大-台南,2023-10-16,9896
00902,中信電池及儲能,20,0,20,元大-台南,2023-10-16,9896
2356,英業達,28,9,19,元大-台南,2023-10-16,9896
3231,緯創,47,30,17,元大-台南,2023-10-16,9896
6284,佳邦,21,6,15,元大-台南,2023-10-16,9896
00751B,元大AAA至A公司債,16,1,15,元大-台南,2023-10-16,9896
2206,三陽工業,14,0,14,元大-台南,2023-10-16,9896
3694,海華,14,0,14,元大-台南,2023-10-16,9896
2546,根基,13,0,13,元大-台南,2023-10-16,9896
00665L,富邦�琤肭磪囓�2,20,8,12,元大-台南,2023-10-16,9896
6531,愛普*,13,2,11,元大-台南,2023-10-16,9896
3540,曜越,11,0,11,元大-台南,2023-10-16,9896
5425,台半,10,0,10,元大-台南,2023-10-16,9896
2461,光群雷,10,0,10,元大-台南,2023-10-16,9896
2332,友訊,10,0,10,元大-台南,2023-10-16,9896
1339,昭輝,10,0,10,元大-台南,2023-10-16,9896
6443,元晶,10,0,10,元大-台南,2023-10-16,9896
2537,聯上發,10,0,10,元大-台南,2023-10-16,9896
5328,華容,10,0,10,元大-台南,2023-10-16,9896
6158,禾昌,10,0,10,元大-台南,2023-10-16,9896
2449,京元電子,12,2,10,元大-台南,2023-10-16,9896
8050,廣積,11,1,10,元大-台南,2023-10-16,9896
2603,長榮,10,0,10,元大-台南,2023-10-16,9896
2368,金像電,13,4,9,元大-台南,2023-10-16,9896
2324,仁寶,16,7,9,元大-台南,2023-10-16,9896
4977,眾達-KY,11,2,9,元大-台南,2023-10-16,9896
0056,元大高股息,155,15,140,元大-台南,2023-10-17,9896
00720B,元大投資級公司債,85,0,85,元大-台南,2023-10-17,9896
2883,凱基金,78,9,69,元大-台南,2023-10-17,9896
3231,緯創,137,68,69,元大-台南,2023-10-17,9896
1609,大亞,71,7,64,元大-台南,2023-10-17,9896
2618,長榮航,92,29,63,元大-台南,2023-10-17,9896
2474,可成,48,0,48,元大-台南,2023-10-17,9896
00878,國泰永續高股息,52,15,37,元大-台南,2023-10-17,9896
5460,同協,34,0,34,元大-台南,2023-10-17,9896
00680L,元大美債20正2,34,0,34,元大-台南,2023-10-17,9896
020039,元大加權N,33,1,32,元大-台南,2023-10-17,9896
00687B,國泰20年美債,31,0,31,元大-台南,2023-10-17,9896
1522,堤維西,29,0,29,元大-台南,2023-10-17,9896
00929,復華台灣科技優息,76,48,28,元大-台南,2023-10-17,9896
8064,東捷,25,0,25,元大-台南,2023-10-17,9896
6257,矽格,26,3,23,元大-台南,2023-10-17,9896
00715L,期街口布蘭特正2,51,28,23,元大-台南,2023-10-17,9896
1101,台泥,22,0,22,元大-台南,2023-10-17,9896
2201,裕隆,29,7,22,元大-台南,2023-10-17,9896
1504,東元,22,0,22,元大-台南,2023-10-17,9896
00857B,永豐20年美公債,20,0,20,元大-台南,2023-10-17,9896
6120,達運,20,0,20,元大-台南,2023-10-17,9896
00665L,富邦�琤肭磪囓�2,20,0,20,元大-台南,2023-10-17,9896
00919,群益台灣精選高息,24,6,18,元大-台南,2023-10-17,9896
00751B,元大AAA至A公司債,19,1,18,元大-台南,2023-10-17,9896
2323,中環,23,5,18,元大-台南,2023-10-17,9896
5434,崇越,18,0,18,元大-台南,2023-10-17,9896
00722B,群益投資級電信債,18,0,18,元大-台南,2023-10-17,9896
2610,華航,40,22,18,元大-台南,2023-10-17,9896
2352,佳世達,16,0,16,元大-台南,2023-10-17,9896
6187,萬潤,17,1,16,元大-台南,2023-10-17,9896
3036,文曄,19,4,15,元大-台南,2023-10-17,9896
3540,曜越,15,0,15,元大-台南,2023-10-17,9896
2891,中信金,24,9,15,元大-台南,2023-10-17,9896
00931B,統一美債20年,14,0,14,元大-台南,2023-10-17,9896
2356,英業達,32,20,12,元大-台南,2023-10-17,9896
2634,漢翔,14,3,11,元大-台南,2023-10-17,9896
3266,昇陽,11,0,11,元大-台南,2023-10-17,9896
00922,國泰台灣領袖50,11,0,11,元大-台南,2023-10-17,9896
1815,富喬,29,18,11,元大-台南,2023-10-17,9896
6821,聯寶,11,0,11,元大-台南,2023-10-17,9896
6274,台燿,14,3,11,元大-台南,2023-10-17,9896
2014,中鴻,11,1,10,元大-台南,2023-10-17,9896
2729,瓦城,10,0,10,元大-台南,2023-10-17,9896
5512,力麒,69,60,9,元大-台南,2023-10-17,9896
1513,中興電,12,3,9,元大-台南,2023-10-17,9896
2353,宏��,10,1,9,元大-台南,2023-10-17,9896
2329,華泰,15,6,9,元大-台南,2023-10-17,9896
6226,光鼎,9,0,9,元大-台南,2023-10-17,9896
00637L,元大滬深300正2,10,1,9,元大-台南,2023-10-17,9896
0056,元大高股息,260,6,254,元大-台南,2023-10-18,9896
00922,國泰台灣領袖50,135,0,135,元大-台南,2023-10-18,9896
3094,聯傑,137,14,123,元大-台南,2023-10-18,9896
00720B,元大投資級公司債,114,0,114,元大-台南,2023-10-18,9896
2474,可成,100,1,99,元大-台南,2023-10-18,9896
00919,群益台灣精選高息,101,5,96,元大-台南,2023-10-18,9896
00679B,元大美債20年,90,0,90,元大-台南,2023-10-18,9896
6168,宏齊,109,22,87,元大-台南,2023-10-18,9896
00929,復華台灣科技優息,160,91,69,元大-台南,2023-10-18,9896
2516,新建,69,2,67,元大-台南,2023-10-18,9896
00878,國泰永續高股息,301,238,63,元大-台南,2023-10-18,9896
2605,新興,61,0,61,元大-台南,2023-10-18,9896
2888,新光金,57,1,56,元大-台南,2023-10-18,9896
2382,廣達,76,23,53,元大-台南,2023-10-18,9896
020039,元大加權N,45,0,45,元大-台南,2023-10-18,9896
1101,台泥,45,4,41,元大-台南,2023-10-18,9896
2641,正德,42,3,39,元大-台南,2023-10-18,9896
6204,艾華,31,1,30,元大-台南,2023-10-18,9896
2538,基泰,30,0,30,元大-台南,2023-10-18,9896
2883,凱基金,49,20,29,元大-台南,2023-10-18,9896
2344,華邦電,35,7,28,元大-台南,2023-10-18,9896
5460,同協,26,0,26,元大-台南,2023-10-18,9896
2002,中鋼,48,22,26,元大-台南,2023-10-18,9896
00687B,國泰20年美債,29,5,24,元大-台南,2023-10-18,9896
3540,曜越,24,0,24,元大-台南,2023-10-18,9896
00680L,元大美債20正2,24,0,24,元大-台南,2023-10-18,9896
00673R,期元大S＆P原油反1,24,0,24,元大-台南,2023-10-18,9896
2610,華航,64,40,24,元大-台南,2023-10-18,9896
1605,華新,22,0,22,元大-台南,2023-10-18,9896
1444,力麗,22,0,22,元大-台南,2023-10-18,9896
2017,官田鋼,20,1,19,元大-台南,2023-10-18,9896
00772B,中信高評級公司債,18,0,18,元大-台南,2023-10-18,9896
9950,萬國通,21,3,18,元大-台南,2023-10-18,9896
2388,威盛,39,21,18,元大-台南,2023-10-18,9896
2328,廣宇,19,2,17,元大-台南,2023-10-18,9896
6245,立端,19,2,17,元大-台南,2023-10-18,9896
8088,品安,18,2,16,元大-台南,2023-10-18,9896
2486,一詮,17,2,15,元大-台南,2023-10-18,9896
2409,友達,15,0,15,元大-台南,2023-10-18,9896
2461,光群雷,15,0,15,元大-台南,2023-10-18,9896
2330,台積電,18,4,14,元大-台南,2023-10-18,9896
2313,華通,28,14,14,元大-台南,2023-10-18,9896
2364,倫飛,17,3,14,元大-台南,2023-10-18,9896
00931B,統一美債20年,14,0,14,元大-台南,2023-10-18,9896
00907,永豐優息存股,13,0,13,元大-台南,2023-10-18,9896
3481,群創,14,1,13,元大-台南,2023-10-18,9896
00885,富邦越南,13,0,13,元大-台南,2023-10-18,9896
00905,FT臺灣Smart,13,0,13,元大-台南,2023-10-18,9896
2913,農林,14,2,12,元大-台南,2023-10-18,9896
2014,中鴻,11,0,11,元大-台南,2023-10-18,9896
0056,元大高股息,203,19,184,元大-台南,2023-10-19,9896
00720B,元大投資級公司債,173,0,173,元大-台南,2023-10-19,9896
00933B,國泰10Y+金融債,104,0,104,元大-台南,2023-10-19,9896
00902,中信電池及儲能,102,0,102,元大-台南,2023-10-19,9896
00878,國泰永續高股息,120,23,97,元大-台南,2023-10-19,9896
00751B,元大AAA至A公司債,88,0,88,元大-台南,2023-10-19,9896
00929,復華台灣科技優息,88,4,84,元大-台南,2023-10-19,9896
00673R,期元大S＆P原油反1,75,0,75,元大-台南,2023-10-19,9896
00772B,中信高評級公司債,73,0,73,元大-台南,2023-10-19,9896
00679B,元大美債20年,73,2,71,元大-台南,2023-10-19,9896
1522,堤維西,61,1,60,元大-台南,2023-10-19,9896
00773B,中信優先金融債,55,0,55,元大-台南,2023-10-19,9896
00637L,元大滬深300正2,53,0,53,元大-台南,2023-10-19,9896
00687B,國泰20年美債,49,0,49,元大-台南,2023-10-19,9896
1324,地球,50,1,49,元大-台南,2023-10-19,9896
00900,富邦特選高股息30,41,0,41,元大-台南,2023-10-19,9896
2516,新建,104,63,41,元大-台南,2023-10-19,9896
00680L,元大美債20正2,40,0,40,元大-台南,2023-10-19,9896
00706L,期元大S＆P日圓正2,40,0,40,元大-台南,2023-10-19,9896
00712,復華富時不動產,34,0,34,元大-台南,2023-10-19,9896
1101,台泥,44,10,34,元大-台南,2023-10-19,9896
2816,旺旺保,35,1,34,元大-台南,2023-10-19,9896
1609,大亞,33,2,31,元大-台南,2023-10-19,9896
00882,中信中國高股息,21,0,21,元大-台南,2023-10-19,9896
00893,國泰智能電動車,21,0,21,元大-台南,2023-10-19,9896
00670L,富邦NASDAQ正2,21,0,21,元大-台南,2023-10-19,9896
00922,國泰台灣領袖50,20,0,20,元大-台南,2023-10-19,9896
6216,居易,20,0,20,元大-台南,2023-10-19,9896
2834,臺企銀,19,0,19,元大-台南,2023-10-19,9896
2892,第一金,22,3,19,元大-台南,2023-10-19,9896
2317,鴻海,21,3,18,元大-台南,2023-10-19,9896
9921,巨大,15,0,15,元大-台南,2023-10-19,9896
8930,青鋼,15,0,15,元大-台南,2023-10-19,9896
00633L,富邦上証正2,14,0,14,元大-台南,2023-10-19,9896
2888,新光金,20,6,14,元大-台南,2023-10-19,9896
00891,中信關鍵半導體,30,16,14,元大-台南,2023-10-19,9896
2402,毅嘉,14,1,13,元大-台南,2023-10-19,9896
00753L,中信中國50正2,13,0,13,元大-台南,2023-10-19,9896
5351,鈺創,11,0,11,元大-台南,2023-10-19,9896
020039,元大加權N,13,2,11,元大-台南,2023-10-19,9896
2388,威盛,101,90,11,元大-台南,2023-10-19,9896
00722B,群益投資級電信債,12,2,10,元大-台南,2023-10-19,9896
1519,華城,11,1,10,元大-台南,2023-10-19,9896
5512,力麒,80,70,10,元大-台南,2023-10-19,9896
1402,遠東新,10,0,10,元大-台南,2023-10-19,9896
00898,國泰基因免疫革命,10,0,10,元大-台南,2023-10-19,9896
2915,潤泰全,10,0,10,元大-台南,2023-10-19,9896
5706,鳳凰,10,0,10,元大-台南,2023-10-19,9896
2014,中鴻,10,0,10,元大-台南,2023-10-19,9896
2382,廣達,50,41,9,元大-台南,2023-10-19,9896
00673R,期元大S＆P原油反1,486,0,486,元大-台南,2023-10-20,9896
00712,復華富時不動產,273,61,212,元大-台南,2023-10-20,9896
00878,國泰永續高股息,206,10,196,元大-台南,2023-10-20,9896
00632R,元大台灣50反1,291,111,180,元大-台南,2023-10-20,9896
2474,可成,170,0,170,元大-台南,2023-10-20,9896
00720B,元大投資級公司債,147,12,135,元大-台南,2023-10-20,9896
00929,復華台灣科技優息,139,4,135,元大-台南,2023-10-20,9896
00751B,元大AAA至A公司債,118,0,118,元大-台南,2023-10-20,9896
00688L,國泰20年美債正2,101,0,101,元大-台南,2023-10-20,9896
2303,聯電,126,29,97,元大-台南,2023-10-20,9896
9950,萬國通,103,18,85,元大-台南,2023-10-20,9896
2618,長榮航,79,6,73,元大-台南,2023-10-20,9896
1522,堤維西,61,0,61,元大-台南,2023-10-20,9896
2323,中環,61,0,61,元大-台南,2023-10-20,9896
2017,官田鋼,52,0,52,元大-台南,2023-10-20,9896
2834,臺企銀,51,0,51,元大-台南,2023-10-20,9896
1802,台玻,57,8,49,元大-台南,2023-10-20,9896
2201,裕隆,46,4,42,元大-台南,2023-10-20,9896
00725B,國泰投資級公司債,36,0,36,元大-台南,2023-10-20,9896
00679B,元大美債20年,40,5,35,元大-台南,2023-10-20,9896
2892,第一金,35,0,35,元大-台南,2023-10-20,9896
2884,玉山金,39,4,35,元大-台南,2023-10-20,9896
00772B,中信高評級公司債,34,0,34,元大-台南,2023-10-20,9896
00687B,國泰20年美債,34,0,34,元大-台南,2023-10-20,9896
5864,致和證,32,0,32,元大-台南,2023-10-20,9896
00900,富邦特選高股息30,32,2,30,元大-台南,2023-10-20,9896
00933B,國泰10Y+金融債,25,0,25,元大-台南,2023-10-20,9896
2002,中鋼,48,23,25,元大-台南,2023-10-20,9896
00931B,統一美債20年,25,0,25,元大-台南,2023-10-20,9896
00670L,富邦NASDAQ正2,21,0,21,元大-台南,2023-10-20,9896
2641,正德,26,5,21,元大-台南,2023-10-20,9896
4714,永捷,20,0,20,元大-台南,2023-10-20,9896
6216,居易,20,0,20,元大-台南,2023-10-20,9896
2353,宏��,22,3,19,元大-台南,2023-10-20,9896
1605,華新,18,0,18,元大-台南,2023-10-20,9896
00881,國泰台灣5G+,27,10,17,元大-台南,2023-10-20,9896
2363,矽統,28,11,17,元大-台南,2023-10-20,9896
2516,新建,17,0,17,元大-台南,2023-10-20,9896
1324,地球,205,188,17,元大-台南,2023-10-20,9896
1609,大亞,20,4,16,元大-台南,2023-10-20,9896
2409,友達,17,1,16,元大-台南,2023-10-20,9896
020039,元大加權N,15,0,15,元大-台南,2023-10-20,9896
6235,華孚,16,1,15,元大-台南,2023-10-20,9896
1513,中興電,16,2,14,元大-台南,2023-10-20,9896
00885,富邦越南,34,20,14,元大-台南,2023-10-20,9896
2367,燿華,14,0,14,元大-台南,2023-10-20,9896
6231,系微,17,3,14,元大-台南,2023-10-20,9896
00795B,中信美國公債20年,22,9,13,元大-台南,2023-10-20,9896
3032,偉訓,14,1,13,元大-台南,2023-10-20,9896
2369,菱生,21,9,12,元大-台南,2023-10-20,9896
00929,復華台灣科技優息,239,10,229,元大-台南,2023-10-23,9896
020039,元大加權N,207,0,207,元大-台南,2023-10-23,9896
00712,復華富時不動產,207,0,207,元大-台南,2023-10-23,9896
00751B,元大AAA至A公司債,146,1,145,元大-台南,2023-10-23,9896
2317,鴻海,154,50,104,元大-台南,2023-10-23,9896
00720B,元大投資級公司債,72,2,70,元大-台南,2023-10-23,9896
00715L,期街口布蘭特正2,64,4,60,元大-台南,2023-10-23,9896
3041,揚智,80,20,60,元大-台南,2023-10-23,9896
00772B,中信高評級公司債,54,0,54,元大-台南,2023-10-23,9896
00878,國泰永續高股息,107,53,54,元大-台南,2023-10-23,9896
6603,富強鑫,52,0,52,元大-台南,2023-10-23,9896
2891,中信金,52,1,51,元大-台南,2023-10-23,9896
00679B,元大美債20年,44,0,44,元大-台南,2023-10-23,9896
9955,佳龍,48,8,40,元大-台南,2023-10-23,9896
5355,佳總,38,3,35,元大-台南,2023-10-23,9896
00919,群益台灣精選高息,33,1,32,元大-台南,2023-10-23,9896
0056,元大高股息,45,14,31,元大-台南,2023-10-23,9896
1711,永光,35,8,27,元大-台南,2023-10-23,9896
2002,中鋼,28,2,26,元大-台南,2023-10-23,9896
6284,佳邦,29,3,26,元大-台南,2023-10-23,9896
00687B,國泰20年美債,40,15,25,元大-台南,2023-10-23,9896
3363,上詮,35,10,25,元大-台南,2023-10-23,9896
00922,國泰台灣領袖50,25,0,25,元大-台南,2023-10-23,9896
00933B,國泰10Y+金融債,24,0,24,元大-台南,2023-10-23,9896
2605,新興,22,0,22,元大-台南,2023-10-23,9896
6187,萬潤,25,3,22,元大-台南,2023-10-23,9896
2438,翔耀,20,0,20,元大-台南,2023-10-23,9896
2641,正德,20,0,20,元大-台南,2023-10-23,9896
1402,遠東新,20,0,20,元大-台南,2023-10-23,9896
1101,台泥,26,6,20,元大-台南,2023-10-23,9896
2449,京元電子,27,10,17,元大-台南,2023-10-23,9896
8110,華東,22,5,17,元大-台南,2023-10-23,9896
3325,旭品,16,1,15,元大-台南,2023-10-23,9896
2355,敬鵬,14,0,14,元大-台南,2023-10-23,9896
2883B,凱基金乙特,14,0,14,元大-台南,2023-10-23,9896
2485,兆赫,13,0,13,元大-台南,2023-10-23,9896
2885,元大金,13,0,13,元大-台南,2023-10-23,9896
2201,裕隆,26,13,13,元大-台南,2023-10-23,9896
00900,富邦特選高股息30,12,0,12,元大-台南,2023-10-23,9896
00757,統一FANG+,12,0,12,元大-台南,2023-10-23,9896
6120,達運,12,0,12,元大-台南,2023-10-23,9896
00923,群益台ESG低碳50,11,0,11,元大-台南,2023-10-23,9896
1303,南亞,10,0,10,元大-台南,2023-10-23,9896
2881,富邦金,11,0,11,元大-台南,2023-10-23,9896
00931B,統一美債20年,11,1,10,元大-台南,2023-10-23,9896
2330,台積電,11,1,10,元大-台南,2023-10-23,9896
8404,百和興業-KY,10,0,10,元大-台南,2023-10-23,9896
4142,國光生,20,10,10,元大-台南,2023-10-23,9896
4938,和碩,12,3,9,元大-台南,2023-10-23,9896
00642U,期元大S＆P石油,9,0,9,元大-台南,2023-10-23,9896
00720B,元大投資級公司債,312,4,308,元大-台南,2023-10-24,9896
00751B,元大AAA至A公司債,295,0,295,元大-台南,2023-10-24,9896
00712,復華富時不動產,162,20,142,元大-台南,2023-10-24,9896
2618,長榮航,618,508,110,元大-台南,2023-10-24,9896
8110,華東,115,13,102,元大-台南,2023-10-24,9896
1795,美時,103,9,94,元大-台南,2023-10-24,9896
00687B,國泰20年美債,76,1,75,元大-台南,2023-10-24,9896
1609,大亞,75,1,74,元大-台南,2023-10-24,9896
00715L,期街口布蘭特正2,156,89,67,元大-台南,2023-10-24,9896
2892,第一金,51,1,50,元大-台南,2023-10-24,9896
00632R,元大台灣50反1,100,51,49,元大-台南,2023-10-24,9896
9950,萬國通,48,1,47,元大-台南,2023-10-24,9896
2883,凱基金,47,2,45,元大-台南,2023-10-24,9896
00725B,國泰投資級公司債,45,0,45,元大-台南,2023-10-24,9896
00637L,元大滬深300正2,32,0,32,元大-台南,2023-10-24,9896
3481,群創,55,25,30,元大-台南,2023-10-24,9896
2516,新建,77,49,28,元大-台南,2023-10-24,9896
2913,農林,27,0,27,元大-台南,2023-10-24,9896
1604,聲寶,23,0,23,元大-台南,2023-10-24,9896
2002,中鋼,41,19,22,元大-台南,2023-10-24,9896
2834,臺企銀,20,0,20,元大-台南,2023-10-24,9896
00919,群益台灣精選高息,18,0,18,元大-台南,2023-10-24,9896
5009,榮剛,20,2,18,元大-台南,2023-10-24,9896
2382,廣達,40,23,17,元大-台南,2023-10-24,9896
1514,亞力,21,5,16,元大-台南,2023-10-24,9896
3715,定穎投控,58,43,15,元大-台南,2023-10-24,9896
2369,菱生,47,32,15,元大-台南,2023-10-24,9896
2312,金寶,15,0,15,元大-台南,2023-10-24,9896
3051,力特,28,14,14,元大-台南,2023-10-24,9896
2014,中鴻,13,0,13,元大-台南,2023-10-24,9896
2332,友訊,13,0,13,元大-台南,2023-10-24,9896
2303,聯電,29,18,11,元大-台南,2023-10-24,9896
2388,威盛,14,3,11,元大-台南,2023-10-24,9896
2352,佳世達,19,8,11,元大-台南,2023-10-24,9896
2409,友達,18,8,10,元大-台南,2023-10-24,9896
00772B,中信高評級公司債,11,1,10,元大-台南,2023-10-24,9896
1219,福壽,10,0,10,元大-台南,2023-10-24,9896
00929,復華台灣科技優息,86,77,9,元大-台南,2023-10-24,9896
1101,台泥,11,2,9,元大-台南,2023-10-24,9896
1568,倉佑,13,4,9,元大-台南,2023-10-24,9896
5880,合庫金,10,1,9,元大-台南,2023-10-24,9896
00922,國泰台灣領袖50,8,0,8,元大-台南,2023-10-24,9896
3376,新日興,10,2,8,元大-台南,2023-10-24,9896
2888,新光金,11,3,8,元大-台南,2023-10-24,9896
00900,富邦特選高股息30,8,0,8,元大-台南,2023-10-24,9896
00881,國泰台灣5G+,9,1,8,元大-台南,2023-10-24,9896
6150,撼訊,24,16,8,元大-台南,2023-10-24,9896
2633,台灣高鐵,7,0,7,元大-台南,2023-10-24,9896
3339,泰谷,8,1,7,元大-台南,2023-10-24,9896
9105,泰金寶-DR,7,0,7,元大-台南,2023-10-24,9896
6109,亞元,112,3,109,元大-台南,2023-10-25,9896
00715L,期街口布蘭特正2,99,0,99,元大-台南,2023-10-25,9896
00712,復華富時不動產,73,0,73,元大-台南,2023-10-25,9896
00929,復華台灣科技優息,72,16,56,元大-台南,2023-10-25,9896
1795,美時,65,14,51,元大-台南,2023-10-25,9896
00679B,元大美債20年,65,18,47,元大-台南,2023-10-25,9896
2337,旺宏,49,8,41,元大-台南,2023-10-25,9896
1604,聲寶,40,0,40,元大-台南,2023-10-25,9896
00931B,統一美債20年,36,0,36,元大-台南,2023-10-25,9896
1721,三晃,26,1,25,元大-台南,2023-10-25,9896
2317,鴻海,32,10,22,元大-台南,2023-10-25,9896
4958,臻鼎-KY,22,1,21,元大-台南,2023-10-25,9896
3450,聯鈞,28,7,21,元大-台南,2023-10-25,9896
2308,台達電,21,0,21,元大-台南,2023-10-25,9896
4123,晟德,20,0,20,元大-台南,2023-10-25,9896
2449,京元電子,24,5,19,元大-台南,2023-10-25,9896
3711,日月光投控,22,4,18,元大-台南,2023-10-25,9896
2630,亞航,20,3,17,元大-台南,2023-10-25,9896
00919,群益台灣精選高息,17,1,16,元大-台南,2023-10-25,9896
00878,國泰永續高股息,19,4,15,元大-台南,2023-10-25,9896
2329,華泰,17,2,15,元大-台南,2023-10-25,9896
2009,第一銅,15,0,15,元大-台南,2023-10-25,9896
3535,晶彩科,14,0,14,元大-台南,2023-10-25,9896
2419,仲琦,14,0,14,元大-台南,2023-10-25,9896
6139,亞翔,22,8,14,元大-台南,2023-10-25,9896
1514,亞力,41,27,14,元大-台南,2023-10-25,9896
1216,統一,13,0,13,元大-台南,2023-10-25,9896
2344,華邦電,15,2,13,元大-台南,2023-10-25,9896
00642U,期元大S＆P石油,13,0,13,元大-台南,2023-10-25,9896
4162,智擎,16,3,13,元大-台南,2023-10-25,9896
2886,兆豐金,13,0,13,元大-台南,2023-10-25,9896
00891,中信關鍵半導體,18,6,12,元大-台南,2023-10-25,9896
00900,富邦特選高股息30,17,5,12,元大-台南,2023-10-25,9896
2355,敬鵬,12,0,12,元大-台南,2023-10-25,9896
3308,聯德,12,0,12,元大-台南,2023-10-25,9896
6282,康舒,13,1,12,元大-台南,2023-10-25,9896
6901,鑽石投資,11,0,11,元大-台南,2023-10-25,9896
8240,華宏,11,0,11,元大-台南,2023-10-25,9896
6684,安格,14,3,11,元大-台南,2023-10-25,9896
3035,智原,16,6,10,元大-台南,2023-10-25,9896
2538,基泰,10,0,10,元大-台南,2023-10-25,9896
8271,宇瞻,10,0,10,元大-台南,2023-10-25,9896
4401,東隆興,10,0,10,元大-台南,2023-10-25,9896
00751B,元大AAA至A公司債,10,1,9,元大-台南,2023-10-25,9896
1101,台泥,9,0,9,元大-台南,2023-10-25,9896
6213,聯茂,11,2,9,元大-台南,2023-10-25,9896
2892,第一金,13,4,9,元大-台南,2023-10-25,9896
2834,臺企銀,9,0,9,元大-台南,2023-10-25,9896
00902,中信電池及儲能,8,0,8,元大-台南,2023-10-25,9896
3376,新日興,10,2,8,元大-台南,2023-10-25,9896
2883,凱基金,278,0,278,元大-台南,2023-10-26,9896
6133,金橋,230,0,230,元大-台南,2023-10-26,9896
00929,復華台灣科技優息,166,33,133,元大-台南,2023-10-26,9896
00712,復華富時不動產,144,23,121,元大-台南,2023-10-26,9896
00919,群益台灣精選高息,101,3,98,元大-台南,2023-10-26,9896
00900,富邦特選高股息30,87,0,87,元大-台南,2023-10-26,9896
2303,聯電,81,4,77,元大-台南,2023-10-26,9896
3481,群創,77,2,75,元大-台南,2023-10-26,9896
00720B,元大投資級公司債,77,3,74,元大-台南,2023-10-26,9896
00679B,元大美債20年,74,0,74,元大-台南,2023-10-26,9896
0056,元大高股息,81,11,70,元大-台南,2023-10-26,9896
2884,玉山金,61,0,61,元大-台南,2023-10-26,9896
2344,華邦電,55,1,54,元大-台南,2023-10-26,9896
00885,富邦越南,54,6,48,元大-台南,2023-10-26,9896
6589,台康生技,41,0,41,元大-台南,2023-10-26,9896
2317,鴻海,43,3,40,元大-台南,2023-10-26,9896
0050,元大台灣50,37,0,37,元大-台南,2023-10-26,9896
00772B,中信高評級公司債,56,20,36,元大-台南,2023-10-26,9896
00922,國泰台灣領袖50,36,2,34,元大-台南,2023-10-26,9896
2382,廣達,43,10,33,元大-台南,2023-10-26,9896
2538,基泰,33,0,33,元大-台南,2023-10-26,9896
00933B,國泰10Y+金融債,33,0,33,元大-台南,2023-10-26,9896
00881,國泰台灣5G+,29,0,29,元大-台南,2023-10-26,9896
2816,旺旺保,35,6,29,元大-台南,2023-10-26,9896
00687B,國泰20年美債,29,0,29,元大-台南,2023-10-26,9896
00751B,元大AAA至A公司債,27,3,24,元大-台南,2023-10-26,9896
00757,統一FANG+,24,0,24,元大-台南,2023-10-26,9896
00631L,元大台灣50正2,24,0,24,元大-台南,2023-10-26,9896
2888,新光金,24,0,24,元大-台南,2023-10-26,9896
2369,菱生,28,6,22,元大-台南,2023-10-26,9896
00923,群益台ESG低碳50,21,0,21,元大-台南,2023-10-26,9896
00670L,富邦NASDAQ正2,20,0,20,元大-台南,2023-10-26,9896
2516,新建,28,8,20,元大-台南,2023-10-26,9896
6603,富強鑫,20,0,20,元大-台南,2023-10-26,9896
6684,安格,19,2,17,元大-台南,2023-10-26,9896
2014,中鴻,17,0,17,元大-台南,2023-10-26,9896
00878,國泰永續高股息,93,77,16,元大-台南,2023-10-26,9896
00893,國泰智能電動車,17,1,16,元大-台南,2023-10-26,9896
2887,台新金,17,1,16,元大-台南,2023-10-26,9896
00665L,富邦�琤肭磪囓�2,16,0,16,元大-台南,2023-10-26,9896
2337,旺宏,16,1,15,元大-台南,2023-10-26,9896
2886,兆豐金,20,5,15,元大-台南,2023-10-26,9896
6441,廣錠,15,0,15,元大-台南,2023-10-26,9896
4542,科嶠,15,1,14,元大-台南,2023-10-26,9896
2201,裕隆,18,4,14,元大-台南,2023-10-26,9896
6282,康舒,13,0,13,元大-台南,2023-10-26,9896
2520,冠德,13,0,13,元大-台南,2023-10-26,9896
1802,台玻,13,0,13,元大-台南,2023-10-26,9896
8936,國統,23,11,12,元大-台南,2023-10-26,9896
00706L,期元大S＆P日圓正2,11,0,11,元大-台南,2023-10-26,9896
00632R,元大台灣50反1,185,25,160,元大-台南,2023-10-27,9896
00929,復華台灣科技優息,84,3,81,元大-台南,2023-10-27,9896
00712,復華富時不動產,121,50,71,元大-台南,2023-10-27,9896
2303,聯電,72,3,69,元大-台南,2023-10-27,9896
00919,群益台灣精選高息,73,6,67,元大-台南,2023-10-27,9896
1795,美時,110,54,56,元大-台南,2023-10-27,9896
00715L,期街口布蘭特正2,59,4,55,元大-台南,2023-10-27,9896
8110,華東,40,2,38,元大-台南,2023-10-27,9896
00932,兆豐永續高息等權,36,0,36,元大-台南,2023-10-27,9896
6603,富強鑫,35,0,35,元大-台南,2023-10-27,9896
2883,凱基金,29,0,29,元大-台南,2023-10-27,9896
2353,宏��,30,1,29,元大-台南,2023-10-27,9896
2538,基泰,27,0,27,元大-台南,2023-10-27,9896
00687B,國泰20年美債,26,0,26,元大-台南,2023-10-27,9896
2317,鴻海,25,0,25,元大-台南,2023-10-27,9896
2329,華泰,44,22,22,元大-台南,2023-10-27,9896
1721,三晃,31,10,21,元大-台南,2023-10-27,9896
9907,統一實,20,0,20,元大-台南,2023-10-27,9896
2618,長榮航,32,13,19,元大-台南,2023-10-27,9896
00900,富邦特選高股息30,23,5,18,元大-台南,2023-10-27,9896
2337,旺宏,20,5,15,元大-台南,2023-10-27,9896
5355,佳總,15,0,15,元大-台南,2023-10-27,9896
8044,網家,14,0,14,元大-台南,2023-10-27,9896
2388,威盛,29,16,13,元大-台南,2023-10-27,9896
6139,亞翔,19,6,13,元大-台南,2023-10-27,9896
6418,詠昇,14,1,13,元大-台南,2023-10-27,9896
3213,茂訊,13,0,13,元大-台南,2023-10-27,9896
2002,中鋼,13,0,13,元大-台南,2023-10-27,9896
2363,矽統,18,5,13,元大-台南,2023-10-27,9896
6901,鑽石投資,13,1,12,元大-台南,2023-10-27,9896
4162,智擎,20,8,12,元大-台南,2023-10-27,9896
0056,元大高股息,17,5,12,元大-台南,2023-10-27,9896
1815,富喬,20,10,10,元大-台南,2023-10-27,9896
3257,虹冠電,12,2,10,元大-台南,2023-10-27,9896
3162,精確,10,0,10,元大-台南,2023-10-27,9896
4934,太極,10,0,10,元大-台南,2023-10-27,9896
4160,訊聯基因,10,0,10,元大-台南,2023-10-27,9896
3094,聯傑,21,11,10,元大-台南,2023-10-27,9896
00922,國泰台灣領袖50,9,0,9,元大-台南,2023-10-27,9896
3260,威剛,9,0,9,元大-台南,2023-10-27,9896
3264,欣銓,14,6,8,元大-台南,2023-10-27,9896
5009,榮剛,12,4,8,元大-台南,2023-10-27,9896
00679B,元大美債20年,9,2,7,元大-台南,2023-10-27,9896
8215,明基材,7,0,7,元大-台南,2023-10-27,9896
3041,揚智,8,1,7,元大-台南,2023-10-27,9896
6282,康舒,11,4,7,元大-台南,2023-10-27,9896
9105,泰金寶-DR,7,0,7,元大-台南,2023-10-27,9896
3221,台嘉碩,7,0,7,元大-台南,2023-10-27,9896
3322,建舜電,10,3,7,元大-台南,2023-10-27,9896
2208,台船,10,3,7,元大-台南,2023-10-27,9896
020039,元大加權N,104,0,104,元大-台南,2023-10-30,9896
00900,富邦特選高股息30,103,5,98,元大-台南,2023-10-30,9896
00712,復華富時不動產,81,0,81,元大-台南,2023-10-30,9896
00919,群益台灣精選高息,83,10,73,元大-台南,2023-10-30,9896
2618,長榮航,71,2,69,元大-台南,2023-10-30,9896
00751B,元大AAA至A公司債,64,0,64,元大-台南,2023-10-30,9896
2485,兆赫,56,6,50,元大-台南,2023-10-30,9896
6472,保瑞,71,24,47,元大-台南,2023-10-30,9896
6235,華孚,47,1,46,元大-台南,2023-10-30,9896
2883,凱基金,47,8,39,元大-台南,2023-10-30,9896
1216,統一,28,0,28,元大-台南,2023-10-30,9896
4123,晟德,27,0,27,元大-台南,2023-10-30,9896
2891,中信金,26,0,26,元大-台南,2023-10-30,9896
00665L,富邦�琤肭磪囓�2,31,8,23,元大-台南,2023-10-30,9896
2516,新建,26,5,21,元大-台南,2023-10-30,9896
00679B,元大美債20年,20,0,20,元大-台南,2023-10-30,9896
00929,復華台灣科技優息,63,43,20,元大-台南,2023-10-30,9896
3176,基亞,19,0,19,元大-台南,2023-10-30,9896
2885,元大金,19,0,19,元大-台南,2023-10-30,9896
4768,晶呈科技,20,2,18,元大-台南,2023-10-30,9896
1524,耿鼎,17,0,17,元大-台南,2023-10-30,9896
00720B,元大投資級公司債,15,0,15,元大-台南,2023-10-30,9896
1734,杏輝,15,0,15,元大-台南,2023-10-30,9896
8110,華東,19,4,15,元大-台南,2023-10-30,9896
2880,華南金,15,0,15,元大-台南,2023-10-30,9896
3483,力致,15,1,14,元大-台南,2023-10-30,9896
3037,欣興,15,1,14,元大-台南,2023-10-30,9896
3264,欣銓,16,3,13,元大-台南,2023-10-30,9896
0050,元大台灣50,15,3,12,元大-台南,2023-10-30,9896
4105,東洋,12,0,12,元大-台南,2023-10-30,9896
5880,合庫金,12,0,12,元大-台南,2023-10-30,9896
6443,元晶,17,6,11,元大-台南,2023-10-30,9896
2363,矽統,27,16,11,元大-台南,2023-10-30,9896
00898,國泰基因免疫革命,11,0,11,元大-台南,2023-10-30,9896
4114,健喬,13,2,11,元大-台南,2023-10-30,9896
2406,國碩,11,1,10,元大-台南,2023-10-30,9896
5410,國眾,10,0,10,元大-台南,2023-10-30,9896
2606,裕民,11,1,10,元大-台南,2023-10-30,9896
2913,農林,10,0,10,元大-台南,2023-10-30,9896
4142,國光生,10,0,10,元大-台南,2023-10-30,9896
3231,緯創,50,40,10,元大-台南,2023-10-30,9896
00885,富邦越南,9,0,9,元大-台南,2023-10-30,9896
2337,旺宏,11,2,9,元大-台南,2023-10-30,9896
2328,廣宇,10,1,9,元大-台南,2023-10-30,9896
2352,佳世達,9,1,8,元大-台南,2023-10-30,9896
1529,樂事綠能,8,0,8,元大-台南,2023-10-30,9896
1760,寶齡富錦,9,1,8,元大-台南,2023-10-30,9896
5512,力麒,36,28,8,元大-台南,2023-10-30,9896
00687B,國泰20年美債,11,3,8,元大-台南,2023-10-30,9896
2356,英業達,11,4,7,元大-台南,2023-10-30,9896
00751B,元大AAA至A公司債,352,0,352,元大-台南,2023-10-31,9896
00715L,期街口布蘭特正2,239,0,239,元大-台南,2023-10-31,9896
00679B,元大美債20年,161,0,161,元大-台南,2023-10-31,9896
00712,復華富時不動產,95,5,90,元大-台南,2023-10-31,9896
00929,復華台灣科技優息,90,4,86,元大-台南,2023-10-31,9896
00706L,期元大S＆P日圓正2,80,0,80,元大-台南,2023-10-31,9896
0056,元大高股息,82,7,75,元大-台南,2023-10-31,9896
00878,國泰永續高股息,82,11,71,元大-台南,2023-10-31,9896
00687B,國泰20年美債,66,0,66,元大-台南,2023-10-31,9896
00720B,元大投資級公司債,62,0,62,元大-台南,2023-10-31,9896
1785,光洋科,131,87,44,元大-台南,2023-10-31,9896
3702,大聯大,44,1,43,元大-台南,2023-10-31,9896
2201,裕隆,45,4,41,元大-台南,2023-10-31,9896
6282,康舒,36,3,33,元大-台南,2023-10-31,9896
3094,聯傑,55,23,32,元大-台南,2023-10-31,9896
8064,東捷,31,0,31,元大-台南,2023-10-31,9896
00719B,元大美債1-3,30,0,30,元大-台南,2023-10-31,9896
0050,元大台灣50,28,0,28,元大-台南,2023-10-31,9896
2344,華邦電,31,6,25,元大-台南,2023-10-31,9896
5272,笙科,46,24,22,元大-台南,2023-10-31,9896
3078,僑威,28,6,22,元大-台南,2023-10-31,9896
2880,華南金,21,0,21,元大-台南,2023-10-31,9896
1795,美時,23,3,20,元大-台南,2023-10-31,9896
1605,華新,22,2,20,元大-台南,2023-10-31,9896
2605,新興,21,1,20,元大-台南,2023-10-31,9896
00933B,國泰10Y+金融債,20,1,19,元大-台南,2023-10-31,9896
2515,中工,21,3,18,元大-台南,2023-10-31,9896
2382,廣達,55,37,18,元大-台南,2023-10-31,9896
2301,光寶科,21,4,17,元大-台南,2023-10-31,9896
00665L,富邦�琤肭磪囓�2,17,0,17,元大-台南,2023-10-31,9896
2363,矽統,23,7,16,元大-台南,2023-10-31,9896
00902,中信電池及儲能,16,0,16,元大-台南,2023-10-31,9896
2323,中環,16,0,16,元大-台南,2023-10-31,9896
1609,大亞,15,0,15,元大-台南,2023-10-31,9896
2204,中華,14,0,14,元大-台南,2023-10-31,9896
2609,陽明,19,5,14,元大-台南,2023-10-31,9896
00919,群益台灣精選高息,14,0,14,元大-台南,2023-10-31,9896
6235,華孚,68,55,13,元大-台南,2023-10-31,9896
3231,緯創,36,23,13,元大-台南,2023-10-31,9896
4768,晶呈科技,13,0,13,元大-台南,2023-10-31,9896
3017,奇鋐,23,11,12,元大-台南,2023-10-31,9896
2449,京元電子,19,7,12,元大-台南,2023-10-31,9896
3325,旭品,12,0,12,元大-台南,2023-10-31,9896
00922,國泰台灣領袖50,12,0,12,元大-台南,2023-10-31,9896
4977,眾達-KY,15,4,11,元大-台南,2023-10-31,9896
00642U,期元大S＆P石油,16,5,11,元大-台南,2023-10-31,9896
3682,亞太電,11,0,11,元大-台南,2023-10-31,9896
2406,國碩,15,4,11,元大-台南,2023-10-31,9896
8050,廣積,11,0,11,元大-台南,2023-10-31,9896
4961,天鈺,11,0,11,元大-台南,2023-10-31,9896
00751B,元大AAA至A公司債,563,0,563,元大-台南,2023-11-01,9896
00878,國泰永續高股息,104,1,103,元大-台南,2023-11-01,9896
00706L,期元大S＆P日圓正2,104,10,94,元大-台南,2023-11-01,9896
00715L,期街口布蘭特正2,74,0,74,元大-台南,2023-11-01,9896
0056,元大高股息,89,19,70,元大-台南,2023-11-01,9896
00934,中信成長高股息,68,0,68,元大-台南,2023-11-01,9896
2883,凱基金,63,2,61,元大-台南,2023-11-01,9896
00679B,元大美債20年,61,2,59,元大-台南,2023-11-01,9896
1721,三晃,60,4,56,元大-台南,2023-11-01,9896
00929,復華台灣科技優息,106,59,47,元大-台南,2023-11-01,9896
6757,台灣虎航,44,0,44,元大-台南,2023-11-01,9896
00933B,國泰10Y+金融債,40,0,40,元大-台南,2023-11-01,9896
2409,友達,32,0,32,元大-台南,2023-11-01,9896
3094,聯傑,46,14,32,元大-台南,2023-11-01,9896
4160,訊聯基因,31,0,31,元大-台南,2023-11-01,9896
2301,光寶科,37,13,24,元大-台南,2023-11-01,9896
00720B,元大投資級公司債,24,0,24,元大-台南,2023-11-01,9896
00935,野村臺灣新科技50,21,0,21,元大-台南,2023-11-01,9896
3481,群創,42,21,21,元大-台南,2023-11-01,9896
00665L,富邦�琤肭磪囓�2,20,0,20,元大-台南,2023-11-01,9896
00655L,國泰中國A50正2,20,0,20,元大-台南,2023-11-01,9896
2002,中鋼,22,3,19,元大-台南,2023-11-01,9896
2462,良得電,23,4,19,元大-台南,2023-11-01,9896
5607,遠雄港,17,0,17,元大-台南,2023-11-01,9896
8358,金居,19,2,17,元大-台南,2023-11-01,9896
2201,裕隆,17,1,16,元大-台南,2023-11-01,9896
9945,潤泰新,16,0,16,元大-台南,2023-11-01,9896
00885,富邦越南,15,0,15,元大-台南,2023-11-01,9896
2731,雄獅,23,8,15,元大-台南,2023-11-01,9896
6472,保瑞,17,3,14,元大-台南,2023-11-01,9896
2337,旺宏,13,0,13,元大-台南,2023-11-01,9896
3035,智原,22,10,12,元大-台南,2023-11-01,9896
5328,華容,15,3,12,元大-台南,2023-11-01,9896
3231,緯創,37,25,12,元大-台南,2023-11-01,9896
00642U,期元大S＆P石油,13,2,11,元大-台南,2023-11-01,9896
5469,瀚宇博,14,3,11,元大-台南,2023-11-01,9896
2313,華通,13,2,11,元大-台南,2023-11-01,9896
6288,聯嘉,10,0,10,元大-台南,2023-11-01,9896
2867,三商壽,10,0,10,元大-台南,2023-11-01,9896
00881,國泰台灣5G+,10,0,10,元大-台南,2023-11-01,9896
1216,統一,10,0,10,元大-台南,2023-11-01,9896
2353,宏��,9,0,9,元大-台南,2023-11-01,9896
1101,台泥,9,0,9,元大-台南,2023-11-01,9896
1795,美時,10,1,9,元大-台南,2023-11-01,9896
9921,巨大,8,0,8,元大-台南,2023-11-01,9896
4908,前鼎,13,5,8,元大-台南,2023-11-01,9896
3260,威剛,8,1,7,元大-台南,2023-11-01,9896
3036,文曄,8,1,7,元大-台南,2023-11-01,9896
3704,合勤控,17,10,7,元大-台南,2023-11-01,9896
4167,松瑞藥,38,31,7,元大-台南,2023-11-01,9896
00680L,元大美債20正2,410,17,393,元大-台南,2023-11-02,9896
00632R,元大台灣50反1,279,10,269,元大-台南,2023-11-02,9896
2382,廣達,219,52,167,元大-台南,2023-11-02,9896
5347,世界,100,2,98,元大-台南,2023-11-02,9896
5521,工信,43,0,43,元大-台南,2023-11-02,9896
2363,矽統,65,37,28,元大-台南,2023-11-02,9896
2618,長榮航,57,31,26,元大-台南,2023-11-02,9896
2516,新建,22,0,22,元大-台南,2023-11-02,9896
00919,群益台灣精選高息,27,5,22,元大-台南,2023-11-02,9896
2887,台新金,21,0,21,元大-台南,2023-11-02,9896
2356,英業達,25,5,20,元大-台南,2023-11-02,9896
3041,揚智,20,0,20,元大-台南,2023-11-02,9896
00676R,富邦臺灣加權反1,20,0,20,元大-台南,2023-11-02,9896
6233,旺玖,20,1,19,元大-台南,2023-11-02,9896
2427,三商電,25,6,19,元大-台南,2023-11-02,9896
00715L,期街口布蘭特正2,18,0,18,元大-台南,2023-11-02,9896
2890,永豐金,20,3,17,元大-台南,2023-11-02,9896
1301,台塑,17,0,17,元大-台南,2023-11-02,9896
00679B,元大美債20年,21,4,17,元大-台南,2023-11-02,9896
2485,兆赫,21,5,16,元大-台南,2023-11-02,9896
3715,定穎投控,97,83,14,元大-台南,2023-11-02,9896
5258,虹堡,26,13,13,元大-台南,2023-11-02,9896
2313,華通,46,33,13,元大-台南,2023-11-02,9896
3006,晶豪科,19,7,12,元大-台南,2023-11-02,9896
6139,亞翔,26,14,12,元大-台南,2023-11-02,9896
4961,天鈺,37,26,11,元大-台南,2023-11-02,9896
1513,中興電,11,0,11,元大-台南,2023-11-02,9896
00934,中信成長高股息,10,0,10,元大-台南,2023-11-02,9896
2340,台亞,10,0,10,元大-台南,2023-11-02,9896
2460,建通,10,0,10,元大-台南,2023-11-02,9896
2017,官田鋼,10,0,10,元大-台南,2023-11-02,9896
1784,訊聯,10,0,10,元大-台南,2023-11-02,9896
5351,鈺創,10,0,10,元大-台南,2023-11-02,9896
00642U,期元大S＆P石油,9,0,9,元大-台南,2023-11-02,9896
4768,晶呈科技,8,0,8,元大-台南,2023-11-02,9896
6733,博晟生醫,10,2,8,元大-台南,2023-11-02,9896
3376,新日興,8,0,8,元大-台南,2023-11-02,9896
00687B,國泰20年美債,11,3,8,元大-台南,2023-11-02,9896
3231,緯創,55,48,7,元大-台南,2023-11-02,9896
2913,農林,30,23,7,元大-台南,2023-11-02,9896
6015,宏遠證,7,0,7,元大-台南,2023-11-02,9896
00933B,國泰10Y+金融債,7,0,7,元大-台南,2023-11-02,9896
8086,宏捷科,7,1,6,元大-台南,2023-11-02,9896
6526,達發,6,0,6,元大-台南,2023-11-02,9896
4188,安克,9,3,6,元大-台南,2023-11-02,9896
6213,聯茂,10,4,6,元大-台南,2023-11-02,9896
1101,台泥,11,5,6,元大-台南,2023-11-02,9896
00650L,復華香港正2,6,0,6,元大-台南,2023-11-02,9896
1721,三晃,9,3,6,元大-台南,2023-11-02,9896
00935,野村臺灣新科技50,9,3,6,元大-台南,2023-11-02,9896
00650L,復華香港正2,400,4,396,元大-台南,2023-11-03,9896
2317,鴻海,385,25,360,元大-台南,2023-11-03,9896
020031,統一IC設計臺灣N,200,0,200,元大-台南,2023-11-03,9896
1609,大亞,93,4,89,元大-台南,2023-11-03,9896
2353,宏��,67,2,65,元大-台南,2023-11-03,9896
5880,合庫金,61,0,61,元大-台南,2023-11-03,9896
00632R,元大台灣50反1,140,80,60,元大-台南,2023-11-03,9896
3094,聯傑,59,3,56,元大-台南,2023-11-03,9896
00885,富邦越南,55,2,53,元大-台南,2023-11-03,9896
8110,華東,40,2,38,元大-台南,2023-11-03,9896
00878,國泰永續高股息,44,12,32,元大-台南,2023-11-03,9896
8150,南茂,34,2,32,元大-台南,2023-11-03,9896
6770,力積電,35,7,28,元大-台南,2023-11-03,9896
3213,茂訊,23,2,21,元大-台南,2023-11-03,9896
2498,宏達電,25,4,21,元大-台南,2023-11-03,9896
6104,創惟,20,0,20,元大-台南,2023-11-03,9896
2458,義隆,29,9,20,元大-台南,2023-11-03,9896
3231,緯創,60,41,19,元大-台南,2023-11-03,9896
2392,正崴,20,1,19,元大-台南,2023-11-03,9896
2358,廷鑫,20,1,19,元大-台南,2023-11-03,9896
2409,友達,36,19,17,元大-台南,2023-11-03,9896
00751B,元大AAA至A公司債,20,3,17,元大-台南,2023-11-03,9896
3176,基亞,20,4,16,元大-台南,2023-11-03,9896
1795,美時,22,6,16,元大-台南,2023-11-03,9896
1524,耿鼎,30,15,15,元大-台南,2023-11-03,9896
00931B,統一美債20年,19,4,15,元大-台南,2023-11-03,9896
6282,康舒,16,2,14,元大-台南,2023-11-03,9896
2884,玉山金,15,1,14,元大-台南,2023-11-03,9896
3376,新日興,51,38,13,元大-台南,2023-11-03,9896
6226,光鼎,81,70,11,元大-台南,2023-11-03,9896
1504,東元,11,0,11,元大-台南,2023-11-03,9896
1815,富喬,31,20,11,元大-台南,2023-11-03,9896
2731,雄獅,11,0,11,元大-台南,2023-11-03,9896
1752,南光,14,3,11,元大-台南,2023-11-03,9896
2883,凱基金,16,6,10,元大-台南,2023-11-03,9896
6257,矽格,10,0,10,元大-台南,2023-11-03,9896
2809,京城銀,10,0,10,元大-台南,2023-11-03,9896
00902,中信電池及儲能,10,0,10,元大-台南,2023-11-03,9896
4909,新復興,10,0,10,元大-台南,2023-11-03,9896
4160,訊聯基因,10,0,10,元大-台南,2023-11-03,9896
6203,海韻電,10,0,10,元大-台南,2023-11-03,9896
2376,技嘉,31,21,10,元大-台南,2023-11-03,9896
8096,擎亞,9,0,9,元大-台南,2023-11-03,9896
4130,健亞,10,1,9,元大-台南,2023-11-03,9896
00688L,國泰20年美債正2,9,0,9,元大-台南,2023-11-03,9896
2356,英業達,15,7,8,元大-台南,2023-11-03,9896
2324,仁寶,10,2,8,元大-台南,2023-11-03,9896
6472,保瑞,13,5,8,元大-台南,2023-11-03,9896
2449,京元電子,11,3,8,元大-台南,2023-11-03,9896
2354,鴻準,7,0,7,元大-台南,2023-11-03,9896
00632R,元大台灣50反1,742,0,742,元大-台南,2023-11-06,9896
00715L,期街口布蘭特正2,133,0,133,元大-台南,2023-11-06,9896
2883,凱基金,120,18,102,元大-台南,2023-11-06,9896
00934,中信成長高股息,95,11,84,元大-台南,2023-11-06,9896
00679B,元大美債20年,68,0,68,元大-台南,2023-11-06,9896
6603,富強鑫,66,0,66,元大-台南,2023-11-06,9896
00919,群益台灣精選高息,82,17,65,元大-台南,2023-11-06,9896
00720B,元大投資級公司債,63,2,61,元大-台南,2023-11-06,9896
2610,華航,74,13,61,元大-台南,2023-11-06,9896
8110,華東,38,0,38,元大-台南,2023-11-06,9896
6226,光鼎,73,39,34,元大-台南,2023-11-06,9896
00751B,元大AAA至A公司債,31,0,31,元大-台南,2023-11-06,9896
00896,中信綠能及電動車,30,0,30,元大-台南,2023-11-06,9896
3176,基亞,30,1,29,元大-台南,2023-11-06,9896
00923,群益台ESG低碳50,26,1,25,元大-台南,2023-11-06,9896
1519,華城,29,5,24,元大-台南,2023-11-06,9896
2002,中鋼,41,17,24,元大-台南,2023-11-06,9896
2885,元大金,24,0,24,元大-台南,2023-11-06,9896
00664R,國泰臺灣加權反1,25,3,22,元大-台南,2023-11-06,9896
8996,高力,20,0,20,元大-台南,2023-11-06,9896
1324,地球,30,10,20,元大-台南,2023-11-06,9896
4968,立積,20,0,20,元大-台南,2023-11-06,9896
00902,中信電池及儲能,20,0,20,元大-台南,2023-11-06,9896
00935,野村臺灣新科技50,18,0,18,元大-台南,2023-11-06,9896
00687B,國泰20年美債,20,2,18,元大-台南,2023-11-06,9896
2486,一詮,19,1,18,元大-台南,2023-11-06,9896
2884,玉山金,21,4,17,元大-台南,2023-11-06,9896
1605,華新,52,35,17,元大-台南,2023-11-06,9896
2913,農林,20,3,17,元大-台南,2023-11-06,9896
8150,南茂,16,0,16,元大-台南,2023-11-06,9896
2887,台新金,18,2,16,元大-台南,2023-11-06,9896
2427,三商電,21,5,16,元大-台南,2023-11-06,9896
6005,群益證,16,0,16,元大-台南,2023-11-06,9896
1101,台泥,24,9,15,元大-台南,2023-11-06,9896
00897,富邦基因免疫生技,15,0,15,元大-台南,2023-11-06,9896
2317,鴻海,24,9,15,元大-台南,2023-11-06,9896
2888,新光金,14,0,14,元大-台南,2023-11-06,9896
2355,敬鵬,13,0,13,元大-台南,2023-11-06,9896
8069,元太,19,6,13,元大-台南,2023-11-06,9896
8112,至上,14,1,13,元大-台南,2023-11-06,9896
00719B,元大美債1-3,12,0,12,元大-台南,2023-11-06,9896
2329,華泰,22,10,12,元大-台南,2023-11-06,9896
00676R,富邦臺灣加權反1,11,0,11,元大-台南,2023-11-06,9896
2356,英業達,27,16,11,元大-台南,2023-11-06,9896
4906,正文,12,1,11,元大-台南,2023-11-06,9896
6187,萬潤,12,2,10,元大-台南,2023-11-06,9896
6182,合晶,10,0,10,元大-台南,2023-11-06,9896
2359,所羅門,10,0,10,元大-台南,2023-11-06,9896
3029,零壹,11,1,10,元大-台南,2023-11-06,9896
6235,華孚,12,3,9,元大-台南,2023-11-06,9896
00712,復華富時不動產,112,2,110,元大-台南,2023-11-07,9896
6603,富強鑫,87,6,81,元大-台南,2023-11-07,9896
00878,國泰永續高股息,85,16,69,元大-台南,2023-11-07,9896
00929,復華台灣科技優息,81,21,60,元大-台南,2023-11-07,9896
3176,基亞,58,0,58,元大-台南,2023-11-07,9896
00688L,國泰20年美債正2,50,0,50,元大-台南,2023-11-07,9896
2002,中鋼,54,5,49,元大-台南,2023-11-07,9896
00679B,元大美債20年,46,0,46,元大-台南,2023-11-07,9896
2363,矽統,68,24,44,元大-台南,2023-11-07,9896
1815,富喬,304,264,40,元大-台南,2023-11-07,9896
00715L,期街口布蘭特正2,34,0,34,元大-台南,2023-11-07,9896
00720B,元大投資級公司債,33,0,33,元大-台南,2023-11-07,9896
1734,杏輝,31,1,30,元大-台南,2023-11-07,9896
6472,保瑞,35,6,29,元大-台南,2023-11-07,9896
1795,美時,39,14,25,元大-台南,2023-11-07,9896
2618,長榮航,64,39,25,元大-台南,2023-11-07,9896
00751B,元大AAA至A公司債,27,2,25,元大-台南,2023-11-07,9896
2610,華航,26,3,23,元大-台南,2023-11-07,9896
2359,所羅門,24,1,23,元大-台南,2023-11-07,9896
2722,夏都,23,1,22,元大-台南,2023-11-07,9896
2401,凌陽,43,22,21,元大-台南,2023-11-07,9896
00900,富邦特選高股息30,21,0,21,元大-台南,2023-11-07,9896
6226,光鼎,21,0,21,元大-台南,2023-11-07,9896
2605,新興,21,0,21,元大-台南,2023-11-07,9896
00902,中信電池及儲能,20,0,20,元大-台南,2023-11-07,9896
1784,訊聯,20,0,20,元大-台南,2023-11-07,9896
4108,懷特,22,2,20,元大-台南,2023-11-07,9896
00671R,富邦NASDAQ反1,20,0,20,元大-台南,2023-11-07,9896
2634,漢翔,45,26,19,元大-台南,2023-11-07,9896
1309,台達化,19,1,18,元大-台南,2023-11-07,9896
6104,創惟,21,6,15,元大-台南,2023-11-07,9896
2883,凱基金,15,1,14,元大-台南,2023-11-07,9896
2317,鴻海,16,2,14,元大-台南,2023-11-07,9896
00642U,期元大S＆P石油,14,0,14,元大-台南,2023-11-07,9896
3512,皇龍,14,0,14,元大-台南,2023-11-07,9896
4908,前鼎,14,1,13,元大-台南,2023-11-07,9896
2337,旺宏,14,1,13,元大-台南,2023-11-07,9896
00891,中信關鍵半導體,20,8,12,元大-台南,2023-11-07,9896
3265,台星科,16,4,12,元大-台南,2023-11-07,9896
6901,鑽石投資,23,12,11,元大-台南,2023-11-07,9896
1785,光洋科,10,0,10,元大-台南,2023-11-07,9896
00934,中信成長高股息,10,0,10,元大-台南,2023-11-07,9896
1707,葡萄王,10,0,10,元大-台南,2023-11-07,9896
3308,聯德,10,0,10,元大-台南,2023-11-07,9896
6712,長聖,10,1,9,元大-台南,2023-11-07,9896
5344,立衛,10,1,9,元大-台南,2023-11-07,9896
2201,裕隆,17,8,9,元大-台南,2023-11-07,9896
2421,建準,10,1,9,元大-台南,2023-11-07,9896
00850,元大臺灣ESG永續,9,0,9,元大-台南,2023-11-07,9896
6197,佳必琪,26,18,8,元大-台南,2023-11-07,9896
3231,緯創,310,150,160,元大-台南,2023-11-08,9896
00936,台新永續高息中小,104,1,103,元大-台南,2023-11-08,9896
00688L,國泰20年美債正2,100,0,100,元大-台南,2023-11-08,9896
00632R,元大台灣50反1,100,0,100,元大-台南,2023-11-08,9896
2382,廣達,131,35,96,元大-台南,2023-11-08,9896
00642U,期元大S＆P石油,93,1,92,元大-台南,2023-11-08,9896
2618,長榮航,206,137,69,元大-台南,2023-11-08,9896
00878,國泰永續高股息,71,21,50,元大-台南,2023-11-08,9896
2722,夏都,74,32,42,元大-台南,2023-11-08,9896
00715L,期街口布蘭特正2,39,1,38,元大-台南,2023-11-08,9896
2630,亞航,28,0,28,元大-台南,2023-11-08,9896
3013,晟銘電,64,36,28,元大-台南,2023-11-08,9896
8404,百和興業-KY,26,0,26,元大-台南,2023-11-08,9896
00679B,元大美債20年,22,0,22,元大-台南,2023-11-08,9896
6245,立端,22,0,22,元大-台南,2023-11-08,9896
2002,中鋼,22,1,21,元大-台南,2023-11-08,9896
3078,僑威,37,16,21,元大-台南,2023-11-08,9896
3062,建漢,23,3,20,元大-台南,2023-11-08,9896
00919,群益台灣精選高息,23,3,20,元大-台南,2023-11-08,9896
1219,福壽,19,0,19,元大-台南,2023-11-08,9896
8034,榮群,21,3,18,元大-台南,2023-11-08,9896
8044,網家,21,3,18,元大-台南,2023-11-08,9896
00751B,元大AAA至A公司債,17,0,17,元大-台南,2023-11-08,9896
2609,陽明,16,1,15,元大-台南,2023-11-08,9896
00882,中信中國高股息,14,0,14,元大-台南,2023-11-08,9896
9950,萬國通,14,0,14,元大-台南,2023-11-08,9896
2303,聯電,16,2,14,元大-台南,2023-11-08,9896
00720B,元大投資級公司債,19,6,13,元大-台南,2023-11-08,9896
3376,新日興,14,1,13,元大-台南,2023-11-08,9896
4908,前鼎,24,11,13,元大-台南,2023-11-08,9896
00719B,元大美債1-3,13,0,13,元大-台南,2023-11-08,9896
2401,凌陽,14,1,13,元大-台南,2023-11-08,9896
1326,台化,12,0,12,元大-台南,2023-11-08,9896
3706,神達,26,14,12,元大-台南,2023-11-08,9896
3213,茂訊,13,2,11,元大-台南,2023-11-08,9896
2014,中鴻,11,0,11,元大-台南,2023-11-08,9896
5272,笙科,21,10,11,元大-台南,2023-11-08,9896
6531,愛普*,18,7,11,元大-台南,2023-11-08,9896
6243,迅杰,19,9,10,元大-台南,2023-11-08,9896
2337,旺宏,10,0,10,元大-台南,2023-11-08,9896
3105,穩懋,9,0,9,元大-台南,2023-11-08,9896
3317,尼克森,9,0,9,元大-台南,2023-11-08,9896
6133,金橋,9,0,9,元大-台南,2023-11-08,9896
5258,虹堡,17,8,9,元大-台南,2023-11-08,9896
2882,國泰金,10,1,9,元大-台南,2023-11-08,9896
2388,威盛,38,30,8,元大-台南,2023-11-08,9896
3548,兆利,15,7,8,元大-台南,2023-11-08,9896
3034,聯詠,12,4,8,元大-台南,2023-11-08,9896
00712,復華富時不動產,9,1,8,元大-台南,2023-11-08,9896
00935,野村臺灣新科技50,8,0,8,元大-台南,2023-11-08,9896
00650L,復華香港正2,412,12,400,元大-台南,2023-11-09,9896
3044,健鼎,135,4,131,元大-台南,2023-11-09,9896
00679B,元大美債20年,264,148,116,元大-台南,2023-11-09,9896
2427,三商電,124,9,115,元大-台南,2023-11-09,9896
00878,國泰永續高股息,105,2,103,元大-台南,2023-11-09,9896
6603,富強鑫,104,2,102,元大-台南,2023-11-09,9896
2614,東森,90,0,90,元大-台南,2023-11-09,9896
2329,華泰,113,44,69,元大-台南,2023-11-09,9896
00929,復華台灣科技優息,95,29,66,元大-台南,2023-11-09,9896
00933B,國泰10Y+金融債,81,16,65,元大-台南,2023-11-09,9896
00632R,元大台灣50反1,64,0,64,元大-台南,2023-11-09,9896
4747,強生,60,0,60,元大-台南,2023-11-09,9896
2363,矽統,150,100,50,元大-台南,2023-11-09,9896
1815,富喬,54,17,37,元大-台南,2023-11-09,9896
00642U,期元大S＆P石油,30,0,30,元大-台南,2023-11-09,9896
6288,聯嘉,30,0,30,元大-台南,2023-11-09,9896
00715L,期街口布蘭特正2,36,6,30,元大-台南,2023-11-09,9896
6216,居易,29,1,28,元大-台南,2023-11-09,9896
2355,敬鵬,28,0,28,元大-台南,2023-11-09,9896
3078,僑威,34,7,27,元大-台南,2023-11-09,9896
1314,中石化,49,23,26,元大-台南,2023-11-09,9896
8034,榮群,23,0,23,元大-台南,2023-11-09,9896
6116,彩晶,23,0,23,元大-台南,2023-11-09,9896
1324,地球,31,10,21,元大-台南,2023-11-09,9896
2353,宏��,35,14,21,元大-台南,2023-11-09,9896
2515,中工,21,0,21,元大-台南,2023-11-09,9896
00830,國泰費城半導體,20,0,20,元大-台南,2023-11-09,9896
3260,威剛,22,2,20,元大-台南,2023-11-09,9896
2888,新光金,19,0,19,元大-台南,2023-11-09,9896
4906,正文,23,4,19,元大-台南,2023-11-09,9896
5272,笙科,21,2,19,元大-台南,2023-11-09,9896
00934,中信成長高股息,19,0,19,元大-台南,2023-11-09,9896
3062,建漢,20,2,18,元大-台南,2023-11-09,9896
5347,世界,17,0,17,元大-台南,2023-11-09,9896
3043,科風,17,0,17,元大-台南,2023-11-09,9896
2313,華通,23,7,16,元大-台南,2023-11-09,9896
00902,中信電池及儲能,16,0,16,元大-台南,2023-11-09,9896
3122,笙泉,34,18,16,元大-台南,2023-11-09,9896
2409,友達,20,4,16,元大-台南,2023-11-09,9896
1504,東元,16,1,15,元大-台南,2023-11-09,9896
1795,美時,17,2,15,元大-台南,2023-11-09,9896
1584,精剛,14,1,13,元大-台南,2023-11-09,9896
3041,揚智,14,2,12,元大-台南,2023-11-09,9896
6201,亞弘電,12,0,12,元大-台南,2023-11-09,9896
6282,康舒,15,4,11,元大-台南,2023-11-09,9896
00665L,富邦�琤肭磪囓�2,11,0,11,元大-台南,2023-11-09,9896
4743,合一,23,12,11,元大-台南,2023-11-09,9896
3308,聯德,10,0,10,元大-台南,2023-11-09,9896
1434,福懋,10,0,10,元大-台南,2023-11-09,9896
2867,三商壽,10,0,10,元大-台南,2023-11-09,9896
3044,健鼎,315,23,292,元大-台南,2023-11-10,9896
00929,復華台灣科技優息,166,29,137,元大-台南,2023-11-10,9896
00933B,國泰10Y+金融債,104,0,104,元大-台南,2023-11-10,9896
00936,台新永續高息中小,64,0,64,元大-台南,2023-11-10,9896
1101,台泥,54,0,54,元大-台南,2023-11-10,9896
1440,南紡,66,15,51,元大-台南,2023-11-10,9896
6901,鑽石投資,53,2,51,元大-台南,2023-11-10,9896
00878,國泰永續高股息,50,5,45,元大-台南,2023-11-10,9896
00680L,元大美債20正2,42,0,42,元大-台南,2023-11-10,9896
00720B,元大投資級公司債,41,2,39,元大-台南,2023-11-10,9896
2605,新興,31,0,31,元大-台南,2023-11-10,9896
2607,榮運,29,0,29,元大-台南,2023-11-10,9896
00632R,元大台灣50反1,28,0,28,元大-台南,2023-11-10,9896
5521,工信,26,0,26,元大-台南,2023-11-10,9896
2929,淘帝-KY,23,0,23,元大-台南,2023-11-10,9896
5864,致和證,22,0,22,元大-台南,2023-11-10,9896
1324,地球,22,0,22,元大-台南,2023-11-10,9896
4561,健椿,22,0,22,元大-台南,2023-11-10,9896
00679B,元大美債20年,23,1,22,元大-台南,2023-11-10,9896
2609,陽明,25,4,21,元大-台南,2023-11-10,9896
00687B,國泰20年美債,20,1,19,元大-台南,2023-11-10,9896
2401,凌陽,19,0,19,元大-台南,2023-11-10,9896
2618,長榮航,28,10,18,元大-台南,2023-11-10,9896
3231,緯創,57,41,16,元大-台南,2023-11-10,9896
00715L,期街口布蘭特正2,18,2,16,元大-台南,2023-11-10,9896
3163,波若威,15,0,15,元大-台南,2023-11-10,9896
3029,零壹,14,0,14,元大-台南,2023-11-10,9896
9955,佳龍,14,0,14,元大-台南,2023-11-10,9896
8112,至上,14,0,14,元大-台南,2023-11-10,9896
2409,友達,23,9,14,元大-台南,2023-11-10,9896
2388,威盛,24,11,13,元大-台南,2023-11-10,9896
2353,宏��,13,0,13,元大-台南,2023-11-10,9896
9950,萬國通,13,0,13,元大-台南,2023-11-10,9896
2425,承啟,16,3,13,元大-台南,2023-11-10,9896
00902,中信電池及儲能,13,0,13,元大-台南,2023-11-10,9896
2317,鴻海,12,0,12,元大-台南,2023-11-10,9896
4167,松瑞藥,35,23,12,元大-台南,2023-11-10,9896
6625,必應,12,0,12,元大-台南,2023-11-10,9896
00712,復華富時不動產,12,0,12,元大-台南,2023-11-10,9896
1314,中石化,12,0,12,元大-台南,2023-11-10,9896
00904,新光臺灣半導體30,11,0,11,元大-台南,2023-11-10,9896
2421,建準,14,3,11,元大-台南,2023-11-10,9896
2352,佳世達,16,5,11,元大-台南,2023-11-10,9896
1785,光洋科,13,2,11,元大-台南,2023-11-10,9896
4128,中天,34,23,11,元大-台南,2023-11-10,9896
00637L,元大滬深300正2,12,1,11,元大-台南,2023-11-10,9896
2606,裕民,20,10,10,元大-台南,2023-11-10,9896
6187,萬潤,22,12,10,元大-台南,2023-11-10,9896
2201,裕隆,18,8,10,元大-台南,2023-11-10,9896
1337,再生-KY,10,0,10,元大-台南,2023-11-10,9896
00751B,元大AAA至A公司債,266,0,266,元大-台南,2023-11-13,9896
00936,台新永續高息中小,214,0,214,元大-台南,2023-11-13,9896
00720B,元大投資級公司債,175,0,175,元大-台南,2023-11-13,9896
00679B,元大美債20年,57,1,56,元大-台南,2023-11-13,9896
00878,國泰永續高股息,63,8,55,元大-台南,2023-11-13,9896
2323,中環,55,0,55,元大-台南,2023-11-13,9896
2618,長榮航,71,21,50,元大-台南,2023-11-13,9896
5864,致和證,50,3,47,元大-台南,2023-11-13,9896
3346,麗清,46,0,46,元大-台南,2023-11-13,9896
00632R,元大台灣50反1,202,159,43,元大-台南,2023-11-13,9896
00687B,國泰20年美債,123,90,33,元大-台南,2023-11-13,9896
00900,富邦特選高股息30,46,14,32,元大-台南,2023-11-13,9896
6197,佳必琪,31,0,31,元大-台南,2023-11-13,9896
3576,聯合再生,32,2,30,元大-台南,2023-11-13,9896
2465,麗臺,32,2,30,元大-台南,2023-11-13,9896
6133,金橋,44,19,25,元大-台南,2023-11-13,9896
6485,點序,26,2,24,元大-台南,2023-11-13,9896
2883,凱基金,32,8,24,元大-台南,2023-11-13,9896
2355,敬鵬,23,0,23,元大-台南,2023-11-13,9896
00934,中信成長高股息,26,3,23,元大-台南,2023-11-13,9896
4123,晟德,25,2,23,元大-台南,2023-11-13,9896
8110,華東,22,0,22,元大-台南,2023-11-13,9896
2382,廣達,36,14,22,元大-台南,2023-11-13,9896
6216,居易,22,1,21,元大-台南,2023-11-13,9896
00642U,期元大S＆P石油,20,0,20,元大-台南,2023-11-13,9896
00738U,期元大道瓊白銀,19,0,19,元大-台南,2023-11-13,9896
3390,旭軟,27,9,18,元大-台南,2023-11-13,9896
2610,華航,17,1,16,元大-台南,2023-11-13,9896
8426,紅木-KY,15,0,15,元大-台南,2023-11-13,9896
00882,中信中國高股息,14,0,14,元大-台南,2023-11-13,9896
2352,佳世達,15,1,14,元大-台南,2023-11-13,9896
2891,中信金,21,8,13,元大-台南,2023-11-13,9896
4967,十銓,34,21,13,元大-台南,2023-11-13,9896
1440,南紡,13,0,13,元大-台南,2023-11-13,9896
3049,精金,81,68,13,元大-台南,2023-11-13,9896
3010,華立,13,0,13,元大-台南,2023-11-13,9896
6901,鑽石投資,24,11,13,元大-台南,2023-11-13,9896
2903,遠百,12,0,12,元大-台南,2023-11-13,9896
00706L,期元大S＆P日圓正2,12,0,12,元大-台南,2023-11-13,9896
1402,遠東新,12,0,12,元大-台南,2023-11-13,9896
2867,三商壽,12,0,12,元大-台南,2023-11-13,9896
6139,亞翔,12,1,11,元大-台南,2023-11-13,9896
6198,瑞築,10,0,10,元大-台南,2023-11-13,9896
2208,台船,10,0,10,元大-台南,2023-11-13,9896
00664R,國泰臺灣加權反1,10,0,10,元大-台南,2023-11-13,9896
1752,南光,10,0,10,元大-台南,2023-11-13,9896
2002,中鋼,30,20,10,元大-台南,2023-11-13,9896
0056,元大高股息,17,8,9,元大-台南,2023-11-13,9896
3227,原相,11,2,9,元大-台南,2023-11-13,9896
6282,康舒,18,9,9,元大-台南,2023-11-13,9896
00632R,元大台灣50反1,2718,0,2718,元大-台南,2023-11-14,9896
2417,圓剛,221,109,112,元大-台南,2023-11-14,9896
00679B,元大美債20年,108,2,106,元大-台南,2023-11-14,9896
6603,富強鑫,87,0,87,元大-台南,2023-11-14,9896
4123,晟德,86,3,83,元大-台南,2023-11-14,9896
3346,麗清,82,3,79,元大-台南,2023-11-14,9896
2427,三商電,64,5,59,元大-台南,2023-11-14,9896
2883,凱基金,66,10,56,元大-台南,2023-11-14,9896
6122,擎邦,76,23,53,元大-台南,2023-11-14,9896
2323,中環,51,0,51,元大-台南,2023-11-14,9896
00680L,元大美債20正2,35,0,35,元大-台南,2023-11-14,9896
3231,緯創,56,24,32,元大-台南,2023-11-14,9896
6015,宏遠證,31,0,31,元大-台南,2023-11-14,9896
5234,達興材料,30,0,30,元大-台南,2023-11-14,9896
9945,潤泰新,33,5,28,元大-台南,2023-11-14,9896
00900,富邦特選高股息30,29,4,25,元大-台南,2023-11-14,9896
2468,華經,25,0,25,元大-台南,2023-11-14,9896
2834,臺企銀,20,0,20,元大-台南,2023-11-14,9896
00881,國泰台灣5G+,22,2,20,元大-台南,2023-11-14,9896
2354,鴻準,20,1,19,元大-台南,2023-11-14,9896
8404,百和興業-KY,19,0,19,元大-台南,2023-11-14,9896
1504,東元,54,36,18,元大-台南,2023-11-14,9896
00687B,國泰20年美債,18,0,18,元大-台南,2023-11-14,9896
1609,大亞,18,3,15,元大-台南,2023-11-14,9896
00664R,國泰臺灣加權反1,15,0,15,元大-台南,2023-11-14,9896
2364,倫飛,30,16,14,元大-台南,2023-11-14,9896
00919,群益台灣精選高息,58,45,13,元大-台南,2023-11-14,9896
00934,中信成長高股息,14,1,13,元大-台南,2023-11-14,9896
2515,中工,14,1,13,元大-台南,2023-11-14,9896
1515,力山,23,10,13,元大-台南,2023-11-14,9896
1101,台泥,14,2,12,元大-台南,2023-11-14,9896
3260,威剛,16,4,12,元大-台南,2023-11-14,9896
2606,裕民,12,0,12,元大-台南,2023-11-14,9896
3264,欣銓,12,0,12,元大-台南,2023-11-14,9896
3489,森寶,11,0,11,元大-台南,2023-11-14,9896
3374,精材,11,0,11,元大-台南,2023-11-14,9896
6282,康舒,13,3,10,元大-台南,2023-11-14,9896
00720B,元大投資級公司債,10,0,10,元大-台南,2023-11-14,9896
8358,金居,11,1,10,元大-台南,2023-11-14,9896
4147,中裕,13,3,10,元大-台南,2023-11-14,9896
9939,宏全,10,0,10,元大-台南,2023-11-14,9896
00650L,復華香港正2,10,0,10,元大-台南,2023-11-14,9896
2206,三陽工業,10,0,10,元大-台南,2023-11-14,9896
3024,憶聲,10,0,10,元大-台南,2023-11-14,9896
6216,居易,10,0,10,元大-台南,2023-11-14,9896
2511,太子,10,0,10,元大-台南,2023-11-14,9896
3006,晶豪科,21,12,9,元大-台南,2023-11-14,9896
2498,宏達電,9,0,9,元大-台南,2023-11-14,9896
1522,堤維西,10,1,9,元大-台南,2023-11-14,9896
5243,乙盛-KY,9,0,9,元大-台南,2023-11-14,9896
00632R,元大台灣50反1,1428,182,1246,元大-台南,2023-11-15,9896
00720B,元大投資級公司債,210,6,204,元大-台南,2023-11-15,9896
4123,晟德,178,10,168,元大-台南,2023-11-15,9896
00665L,富邦�琤肭磪囓�2,102,8,94,元大-台南,2023-11-15,9896
2468,華經,92,0,92,元大-台南,2023-11-15,9896
1440,南紡,84,5,79,元大-台南,2023-11-15,9896
00935,野村臺灣新科技50,67,0,67,元大-台南,2023-11-15,9896
3014,聯陽,53,0,53,元大-台南,2023-11-15,9896
00878,國泰永續高股息,87,38,49,元大-台南,2023-11-15,9896
6573,虹揚-KY,30,0,30,元大-台南,2023-11-15,9896
2882,國泰金,37,7,30,元大-台南,2023-11-15,9896
2332,友訊,30,1,29,元大-台南,2023-11-15,9896
3036,文曄,32,5,27,元大-台南,2023-11-15,9896
2449,京元電子,29,4,25,元大-台南,2023-11-15,9896
00708L,期元大S＆P黃金正2,25,0,25,元大-台南,2023-11-15,9896
00687B,國泰20年美債,28,3,25,元大-台南,2023-11-15,9896
00679B,元大美債20年,23,1,22,元大-台南,2023-11-15,9896
2201,裕隆,61,39,22,元大-台南,2023-11-15,9896
2630,亞航,24,3,21,元大-台南,2023-11-15,9896
00655L,國泰中國A50正2,20,0,20,元大-台南,2023-11-15,9896
2605,新興,20,0,20,元大-台南,2023-11-15,9896
6122,擎邦,28,9,19,元大-台南,2023-11-15,9896
2845,遠東銀,20,2,18,元大-台南,2023-11-15,9896
3545,敦泰,28,11,17,元大-台南,2023-11-15,9896
3078,僑威,16,0,16,元大-台南,2023-11-15,9896
1717,長興,17,2,15,元大-台南,2023-11-15,9896
1513,中興電,40,25,15,元大-台南,2023-11-15,9896
2356,英業達,23,10,13,元大-台南,2023-11-15,9896
3035,智原,14,1,13,元大-台南,2023-11-15,9896
4768,晶呈科技,12,0,12,元大-台南,2023-11-15,9896
1449,佳和,13,1,12,元大-台南,2023-11-15,9896
3276,宇環,21,9,12,元大-台南,2023-11-15,9896
00637L,元大滬深300正2,14,3,11,元大-台南,2023-11-15,9896
2884,玉山金,14,3,11,元大-台南,2023-11-15,9896
3532,台勝科,12,1,11,元大-台南,2023-11-15,9896
00762,元大全球AI,11,0,11,元大-台南,2023-11-15,9896
1817,凱撒衛,12,1,11,元大-台南,2023-11-15,9896
2402,毅嘉,12,1,11,元大-台南,2023-11-15,9896
9939,宏全,12,1,11,元大-台南,2023-11-15,9896
2353,宏��,193,182,11,元大-台南,2023-11-15,9896
1795,美時,22,11,11,元大-台南,2023-11-15,9896
2382,廣達,25,15,10,元大-台南,2023-11-15,9896
6216,居易,10,0,10,元大-台南,2023-11-15,9896
00892,富邦台灣半導體,10,0,10,元大-台南,2023-11-15,9896
6198,瑞築,10,0,10,元大-台南,2023-11-15,9896
6139,亞翔,10,1,9,元大-台南,2023-11-15,9896
2492,華新科,9,0,9,元大-台南,2023-11-15,9896
3715,定穎投控,11,2,9,元大-台南,2023-11-15,9896
2357,華碩,9,0,9,元大-台南,2023-11-15,9896
3450,聯鈞,50,41,9,元大-台南,2023-11-15,9896
00679B,元大美債20年,376,53,323,元大-台南,2023-11-16,9896
00632R,元大台灣50反1,195,0,195,元大-台南,2023-11-16,9896
00720B,元大投資級公司債,139,2,137,元大-台南,2023-11-16,9896
00715L,期街口布蘭特正2,92,1,91,元大-台南,2023-11-16,9896
00751B,元大AAA至A公司債,69,0,69,元大-台南,2023-11-16,9896
00933B,國泰10Y+金融債,67,0,67,元大-台南,2023-11-16,9896
00687B,國泰20年美債,64,0,64,元大-台南,2023-11-16,9896
2329,華泰,129,68,61,元大-台南,2023-11-16,9896
00929,復華台灣科技優息,63,3,60,元大-台南,2023-11-16,9896
6016,康和證,60,0,60,元大-台南,2023-11-16,9896
4550,長佳,60,0,60,元大-台南,2023-11-16,9896
00878,國泰永續高股息,88,29,59,元大-台南,2023-11-16,9896
1440,南紡,50,1,49,元大-台南,2023-11-16,9896
2014,中鴻,53,17,36,元大-台南,2023-11-16,9896
2417,圓剛,192,157,35,元大-台南,2023-11-16,9896
2382,廣達,36,10,26,元大-台南,2023-11-16,9896
00919,群益台灣精選高息,24,0,24,元大-台南,2023-11-16,9896
2880,華南金,25,2,23,元大-台南,2023-11-16,9896
00680L,元大美債20正2,22,0,22,元大-台南,2023-11-16,9896
6235,華孚,33,12,21,元大-台南,2023-11-16,9896
00637L,元大滬深300正2,34,14,20,元大-台南,2023-11-16,9896
1584,精剛,20,0,20,元大-台南,2023-11-16,9896
2516,新建,20,1,19,元大-台南,2023-11-16,9896
3715,定穎投控,24,6,18,元大-台南,2023-11-16,9896
6125,廣運,31,14,17,元大-台南,2023-11-16,9896
2364,倫飛,18,2,16,元大-台南,2023-11-16,9896
4908,前鼎,16,1,15,元大-台南,2023-11-16,9896
3512,皇龍,15,0,15,元大-台南,2023-11-16,9896
3260,威剛,15,1,14,元大-台南,2023-11-16,9896
3049,精金,70,57,13,元大-台南,2023-11-16,9896
6472,保瑞,13,0,13,元大-台南,2023-11-16,9896
2882,國泰金,15,2,13,元大-台南,2023-11-16,9896
6584,南俊國際,13,1,12,元大-台南,2023-11-16,9896
6203,海韻電,11,0,11,元大-台南,2023-11-16,9896
6548,長科*,11,0,11,元大-台南,2023-11-16,9896
1519,華城,16,6,10,元大-台南,2023-11-16,9896
1795,美時,40,30,10,元大-台南,2023-11-16,9896
3450,聯鈞,13,3,10,元大-台南,2023-11-16,9896
4768,晶呈科技,11,1,10,元大-台南,2023-11-16,9896
2358,廷鑫,10,0,10,元大-台南,2023-11-16,9896
1605,華新,14,4,10,元大-台南,2023-11-16,9896
5234,達興材料,10,0,10,元大-台南,2023-11-16,9896
00671R,富邦NASDAQ反1,10,0,10,元大-台南,2023-11-16,9896
6216,居易,10,0,10,元大-台南,2023-11-16,9896
3231,緯創,19,10,9,元大-台南,2023-11-16,9896
00850,元大臺灣ESG永續,10,1,9,元大-台南,2023-11-16,9896
3623,富晶通,9,0,9,元大-台南,2023-11-16,9896
2352,佳世達,9,0,9,元大-台南,2023-11-16,9896
2801,彰銀,11,2,9,元大-台南,2023-11-16,9896
00795B,中信美國公債20年,8,0,8,元大-台南,2023-11-16,9896
00919,群益台灣精選高息,140,32,108,元大-台南,2023-11-17,9896
2409,友達,110,2,108,元大-台南,2023-11-17,9896
2618,長榮航,182,84,98,元大-台南,2023-11-17,9896
00929,復華台灣科技優息,99,9,90,元大-台南,2023-11-17,9896
00715L,期街口布蘭特正2,77,0,77,元大-台南,2023-11-17,9896
4746,台耀,89,14,75,元大-台南,2023-11-17,9896
2610,華航,72,11,61,元大-台南,2023-11-17,9896
00720B,元大投資級公司債,59,0,59,元大-台南,2023-11-17,9896
6125,廣運,97,45,52,元大-台南,2023-11-17,9896
00891,中信關鍵半導體,50,6,44,元大-台南,2023-11-17,9896
00642U,期元大S＆P石油,43,0,43,元大-台南,2023-11-17,9896
2515,中工,42,0,42,元大-台南,2023-11-17,9896
00637L,元大滬深300正2,51,10,41,元大-台南,2023-11-17,9896
1434,福懋,30,0,30,元大-台南,2023-11-17,9896
00712,復華富時不動產,27,0,27,元大-台南,2023-11-17,9896
00679B,元大美債20年,26,1,25,元大-台南,2023-11-17,9896
00878,國泰永續高股息,30,6,24,元大-台南,2023-11-17,9896
2722,夏都,23,3,20,元大-台南,2023-11-17,9896
6573,虹揚-KY,20,0,20,元大-台南,2023-11-17,9896
3041,揚智,128,108,20,元大-台南,2023-11-17,9896
00690,兆豐藍籌30,20,0,20,元大-台南,2023-11-17,9896
00724B,群益投資級金融債,20,0,20,元大-台南,2023-11-17,9896
3014,聯陽,21,1,20,元大-台南,2023-11-17,9896
00751B,元大AAA至A公司債,21,1,20,元大-台南,2023-11-17,9896
6603,富強鑫,19,0,19,元大-台南,2023-11-17,9896
3715,定穎投控,155,137,18,元大-台南,2023-11-17,9896
1815,富喬,28,10,18,元大-台南,2023-11-17,9896
2365,昆盈,19,1,18,元大-台南,2023-11-17,9896
00665L,富邦�琤肭磪囓�2,18,0,18,元大-台南,2023-11-17,9896
0056,元大高股息,22,5,17,元大-台南,2023-11-17,9896
2371,大同,17,0,17,元大-台南,2023-11-17,9896
00931B,統一美債20年,17,0,17,元大-台南,2023-11-17,9896
3260,威剛,17,1,16,元大-台南,2023-11-17,9896
2816,旺旺保,15,0,15,元大-台南,2023-11-17,9896
2887,台新金,16,2,14,元大-台南,2023-11-17,9896
6133,金橋,30,16,14,元大-台南,2023-11-17,9896
5381,合正,15,2,13,元大-台南,2023-11-17,9896
2201,裕隆,46,33,13,元大-台南,2023-11-17,9896
9939,宏全,12,0,12,元大-台南,2023-11-17,9896
3029,零壹,12,0,12,元大-台南,2023-11-17,9896
00687B,國泰20年美債,12,2,10,元大-台南,2023-11-17,9896
5469,瀚宇博,13,3,10,元大-台南,2023-11-17,9896
00674R,期元大S＆P黃金反1,10,0,10,元大-台南,2023-11-17,9896
8930,青鋼,10,0,10,元大-台南,2023-11-17,9896
1313,聯成,10,0,10,元大-台南,2023-11-17,9896
00753L,中信中國50正2,10,0,10,元大-台南,2023-11-17,9896
4952,凌通,10,0,10,元大-台南,2023-11-17,9896
6216,居易,10,0,10,元大-台南,2023-11-17,9896
2883,凱基金,45,35,10,元大-台南,2023-11-17,9896
1314,中石化,10,0,10,元大-台南,2023-11-17,9896
00632R,元大台灣50反1,2688,155,2533,元大-台南,2023-11-20,9896
1440,南紡,151,2,149,元大-台南,2023-11-20,9896
00679B,元大美債20年,109,0,109,元大-台南,2023-11-20,9896
2883,凱基金,105,6,99,元大-台南,2023-11-20,9896
00665L,富邦�琤肭磪囓�2,106,7,99,元大-台南,2023-11-20,9896
00751B,元大AAA至A公司債,73,0,73,元大-台南,2023-11-20,9896
00919,群益台灣精選高息,81,14,67,元大-台南,2023-11-20,9896
00929,復華台灣科技優息,91,30,61,元大-台南,2023-11-20,9896
2618,長榮航,74,27,47,元大-台南,2023-11-20,9896
2201,裕隆,42,0,42,元大-台南,2023-11-20,9896
6142,友勁,40,0,40,元大-台南,2023-11-20,9896
2882,國泰金,35,0,35,元大-台南,2023-11-20,9896
00933B,國泰10Y+金融債,31,0,31,元大-台南,2023-11-20,9896
00878,國泰永續高股息,31,2,29,元大-台南,2023-11-20,9896
00720B,元大投資級公司債,29,0,29,元大-台南,2023-11-20,9896
6182,合晶,26,0,26,元大-台南,2023-11-20,9896
6127,九豪,43,19,24,元大-台南,2023-11-20,9896
2834,臺企銀,23,0,23,元大-台南,2023-11-20,9896
9950,萬國通,22,0,22,元大-台南,2023-11-20,9896
3149,正達,22,1,21,元大-台南,2023-11-20,9896
2915,潤泰全,21,1,20,元大-台南,2023-11-20,9896
00673R,期元大S＆P原油反1,20,0,20,元大-台南,2023-11-20,9896
4129,聯合,21,1,20,元大-台南,2023-11-20,9896
2731,雄獅,23,4,19,元大-台南,2023-11-20,9896
2462,良得電,18,0,18,元大-台南,2023-11-20,9896
6584,南俊國際,17,0,17,元大-台南,2023-11-20,9896
2352,佳世達,17,0,17,元大-台南,2023-11-20,9896
3013,晟銘電,21,5,16,元大-台南,2023-11-20,9896
2356,英業達,31,16,15,元大-台南,2023-11-20,9896
2369,菱生,27,13,14,元大-台南,2023-11-20,9896
00637L,元大滬深300正2,16,3,13,元大-台南,2023-11-20,9896
00687B,國泰20年美債,16,3,13,元大-台南,2023-11-20,9896
00724B,群益投資級金融債,12,0,12,元大-台南,2023-11-20,9896
2816,旺旺保,14,2,12,元大-台南,2023-11-20,9896
3005,神基,49,37,12,元大-台南,2023-11-20,9896
2707,晶華,11,0,11,元大-台南,2023-11-20,9896
00690,兆豐藍籌30,21,10,11,元大-台南,2023-11-20,9896
00738U,期元大道瓊白銀,12,1,11,元大-台南,2023-11-20,9896
4714,永捷,20,9,11,元大-台南,2023-11-20,9896
9945,潤泰新,11,0,11,元大-台南,2023-11-20,9896
2368,金像電,12,2,10,元大-台南,2023-11-20,9896
1101,台泥,15,5,10,元大-台南,2023-11-20,9896
3078,僑威,18,8,10,元大-台南,2023-11-20,9896
6133,金橋,14,4,10,元大-台南,2023-11-20,9896
2722,夏都,55,45,10,元大-台南,2023-11-20,9896
2002,中鋼,14,5,9,元大-台南,2023-11-20,9896
2402,毅嘉,14,5,9,元大-台南,2023-11-20,9896
6757,台灣虎航,9,0,9,元大-台南,2023-11-20,9896
8930,青鋼,9,0,9,元大-台南,2023-11-20,9896
2387,精元,10,1,9,元大-台南,2023-11-20,9896
1440,南紡,223,16,207,元大-台南,2023-11-21,9896
00679B,元大美債20年,134,0,134,元大-台南,2023-11-21,9896
8069,元太,121,0,121,元大-台南,2023-11-21,9896
00665L,富邦�琤肭磪囓�2,110,20,90,元大-台南,2023-11-21,9896
9105,泰金寶-DR,53,1,52,元大-台南,2023-11-21,9896
2393,億光,36,0,36,元大-台南,2023-11-21,9896
3062,建漢,81,45,36,元大-台南,2023-11-21,9896
3481,群創,45,11,34,元大-台南,2023-11-21,9896
2367,燿華,72,39,33,元大-台南,2023-11-21,9896
00934,中信成長高股息,32,0,32,元大-台南,2023-11-21,9896
00738U,期元大道瓊白銀,34,3,31,元大-台南,2023-11-21,9896
3041,揚智,85,61,24,元大-台南,2023-11-21,9896
3231,緯創,100,76,24,元大-台南,2023-11-21,9896
00904,新光臺灣半導體30,23,1,22,元大-台南,2023-11-21,9896
6182,合晶,20,1,19,元大-台南,2023-11-21,9896
3287,廣寰科,32,13,19,元大-台南,2023-11-21,9896
00922,國泰台灣領袖50,22,3,19,元大-台南,2023-11-21,9896
3483,力致,27,9,18,元大-台南,2023-11-21,9896
2883,凱基金,33,15,18,元大-台南,2023-11-21,9896
2417,圓剛,20,3,17,元大-台南,2023-11-21,9896
3078,僑威,20,4,16,元大-台南,2023-11-21,9896
1609,大亞,45,29,16,元大-台南,2023-11-21,9896
2376,技嘉,30,15,15,元大-台南,2023-11-21,9896
5521,工信,15,0,15,元大-台南,2023-11-21,9896
00637L,元大滬深300正2,27,12,15,元大-台南,2023-11-21,9896
2421,建準,18,3,15,元大-台南,2023-11-21,9896
2352,佳世達,22,8,14,元大-台南,2023-11-21,9896
00673R,期元大S＆P原油反1,14,0,14,元大-台南,2023-11-21,9896
1815,富喬,14,1,13,元大-台南,2023-11-21,9896
2329,華泰,25,12,13,元大-台南,2023-11-21,9896
6139,亞翔,30,17,13,元大-台南,2023-11-21,9896
4123,晟德,15,2,13,元大-台南,2023-11-21,9896
6133,金橋,35,22,13,元大-台南,2023-11-21,9896
2486,一詮,13,1,12,元大-台南,2023-11-21,9896
00719B,元大美債1-3,12,0,12,元大-台南,2023-11-21,9896
2606,裕民,12,0,12,元大-台南,2023-11-21,9896
8088,品安,14,3,11,元大-台南,2023-11-21,9896
2609,陽明,12,1,11,元大-台南,2023-11-21,9896
3576,聯合再生,11,0,11,元大-台南,2023-11-21,9896
8930,青鋼,11,0,11,元大-台南,2023-11-21,9896
4979,華星光,16,6,10,元大-台南,2023-11-21,9896
00885,富邦越南,10,0,10,元大-台南,2023-11-21,9896
1721,三晃,10,0,10,元大-台南,2023-11-21,9896
5371,中光電,10,0,10,元大-台南,2023-11-21,9896
2845,遠東銀,10,0,10,元大-台南,2023-11-21,9896
5347,世界,29,19,10,元大-台南,2023-11-21,9896
2356,英業達,50,40,10,元大-台南,2023-11-21,9896
2344,華邦電,11,2,9,元大-台南,2023-11-21,9896
6187,萬潤,14,6,8,元大-台南,2023-11-21,9896
1524,耿鼎,15,7,8,元大-台南,2023-11-21,9896
1440,南紡,303,68,235,元大-台南,2023-11-22,9896
2883,凱基金,174,15,159,元大-台南,2023-11-22,9896
3231,緯創,133,24,109,元大-台南,2023-11-22,9896
00637L,元大滬深300正2,111,10,101,元大-台南,2023-11-22,9896
00715L,期街口布蘭特正2,102,10,92,元大-台南,2023-11-22,9896
00665L,富邦�琤肭磪囓�2,52,0,52,元大-台南,2023-11-22,9896
00919,群益台灣精選高息,43,2,41,元大-台南,2023-11-22,9896
2356,英業達,49,12,37,元大-台南,2023-11-22,9896
0056,元大高股息,41,4,37,元大-台南,2023-11-22,9896
2382,廣達,44,8,36,元大-台南,2023-11-22,9896
2352,佳世達,35,0,35,元大-台南,2023-11-22,9896
00878,國泰永續高股息,40,7,33,元大-台南,2023-11-22,9896
4116,明基醫,30,0,30,元大-台南,2023-11-22,9896
2393,億光,26,0,26,元大-台南,2023-11-22,9896
5234,達興材料,27,3,24,元大-台南,2023-11-22,9896
2313,華通,45,23,22,元大-台南,2023-11-22,9896
00751B,元大AAA至A公司債,21,0,21,元大-台南,2023-11-22,9896
2419,仲琦,21,0,21,元大-台南,2023-11-22,9896
2888,新光金,20,0,20,元大-台南,2023-11-22,9896
6187,萬潤,26,6,20,元大-台南,2023-11-22,9896
2010,春源,20,0,20,元大-台南,2023-11-22,9896
6603,富強鑫,20,0,20,元大-台南,2023-11-22,9896
3481,群創,23,4,19,元大-台南,2023-11-22,9896
00632R,元大台灣50反1,17,0,17,元大-台南,2023-11-22,9896
2358,廷鑫,25,8,17,元大-台南,2023-11-22,9896
6757,台灣虎航,20,3,17,元大-台南,2023-11-22,9896
2409,友達,16,0,16,元大-台南,2023-11-22,9896
00679B,元大美債20年,18,2,16,元大-台南,2023-11-22,9896
00680L,元大美債20正2,35,20,15,元大-台南,2023-11-22,9896
00931B,統一美債20年,15,0,15,元大-台南,2023-11-22,9896
2427,三商電,19,4,15,元大-台南,2023-11-22,9896
2301,光寶科,17,2,15,元大-台南,2023-11-22,9896
8112,至上,15,0,15,元大-台南,2023-11-22,9896
4960,誠美材,18,4,14,元大-台南,2023-11-22,9896
3149,正達,15,1,14,元大-台南,2023-11-22,9896
00922,國泰台灣領袖50,14,0,14,元大-台南,2023-11-22,9896
00712,復華富時不動產,14,0,14,元大-台南,2023-11-22,9896
2353,宏��,15,1,14,元大-台南,2023-11-22,9896
00905,FT臺灣Smart,18,5,13,元大-台南,2023-11-22,9896
3088,艾訊,13,0,13,元大-台南,2023-11-22,9896
5521,工信,31,18,13,元大-台南,2023-11-22,9896
4123,晟德,14,1,13,元大-台南,2023-11-22,9896
2376,技嘉,20,8,12,元大-台南,2023-11-22,9896
3057,喬鼎,20,8,12,元大-台南,2023-11-22,9896
00885,富邦越南,12,0,12,元大-台南,2023-11-22,9896
3049,精金,56,44,12,元大-台南,2023-11-22,9896
5258,虹堡,19,8,11,元大-台南,2023-11-22,9896
00687B,國泰20年美債,11,0,11,元大-台南,2023-11-22,9896
5351,鈺創,20,10,10,元大-台南,2023-11-22,9896
3706,神達,11,1,10,元大-台南,2023-11-22,9896
00929,復華台灣科技優息,244,49,195,元大-台南,2023-11-23,9896
2883,凱基金,147,8,139,元大-台南,2023-11-23,9896
2405,輔信,101,3,98,元大-台南,2023-11-23,9896
00715L,期街口布蘭特正2,98,12,86,元大-台南,2023-11-23,9896
1440,南紡,81,1,80,元大-台南,2023-11-23,9896
8069,元太,81,1,80,元大-台南,2023-11-23,9896
6282,康舒,134,71,63,元大-台南,2023-11-23,9896
3078,僑威,113,53,60,元大-台南,2023-11-23,9896
00679B,元大美債20年,57,4,53,元大-台南,2023-11-23,9896
00753L,中信中國50正2,50,0,50,元大-台南,2023-11-23,9896
00665L,富邦�琤肭磪囓�2,52,2,50,元大-台南,2023-11-23,9896
3231,緯創,62,16,46,元大-台南,2023-11-23,9896
00878,國泰永續高股息,44,1,43,元大-台南,2023-11-23,9896
3715,定穎投控,96,55,41,元大-台南,2023-11-23,9896
2845,遠東銀,40,0,40,元大-台南,2023-11-23,9896
6187,萬潤,38,3,35,元大-台南,2023-11-23,9896
00919,群益台灣精選高息,68,36,32,元大-台南,2023-11-23,9896
1584,精剛,30,1,29,元大-台南,2023-11-23,9896
1722,台肥,30,3,27,元大-台南,2023-11-23,9896
2363,矽統,80,53,27,元大-台南,2023-11-23,9896
3437,榮創,28,2,26,元大-台南,2023-11-23,9896
3041,揚智,267,242,25,元大-台南,2023-11-23,9896
3049,精金,157,133,24,元大-台南,2023-11-23,9896
00650L,復華香港正2,22,0,22,元大-台南,2023-11-23,9896
6695,芯鼎,28,7,21,元大-台南,2023-11-23,9896
2382,廣達,41,21,20,元大-台南,2023-11-23,9896
00907,永豐優息存股,20,0,20,元大-台南,2023-11-23,9896
3567,逸昌,20,0,20,元大-台南,2023-11-23,9896
00655L,國泰中國A50正2,18,0,18,元大-台南,2023-11-23,9896
6585,鼎基,18,0,18,元大-台南,2023-11-23,9896
3035,智原,21,3,18,元大-台南,2023-11-23,9896
1449,佳和,20,3,17,元大-台南,2023-11-23,9896
00934,中信成長高股息,17,0,17,元大-台南,2023-11-23,9896
2356,英業達,25,10,15,元大-台南,2023-11-23,9896
6657,華安,15,0,15,元大-台南,2023-11-23,9896
6237,驊訊,26,12,14,元大-台南,2023-11-23,9896
2455,全新,24,10,14,元大-台南,2023-11-23,9896
4960,誠美材,13,1,12,元大-台南,2023-11-23,9896
4979,華星光,12,1,11,元大-台南,2023-11-23,9896
1314,中石化,12,1,11,元大-台南,2023-11-23,9896
00633L,富邦上証正2,11,0,11,元大-台南,2023-11-23,9896
2409,友達,10,0,10,元大-台南,2023-11-23,9896
2439,美律,11,1,10,元大-台南,2023-11-23,9896
6125,廣運,51,41,10,元大-台南,2023-11-23,9896
3313,斐成,10,0,10,元大-台南,2023-11-23,9896
2441,超豐,10,0,10,元大-台南,2023-11-23,9896
020037,元大金融高股息N,10,0,10,元大-台南,2023-11-23,9896
6472,保瑞,14,4,10,元大-台南,2023-11-23,9896
1599,宏佳騰,10,0,10,元大-台南,2023-11-23,9896
3483,力致,36,26,10,元大-台南,2023-11-23,9896
00632R,元大台灣50反1,1451,5,1446,元大-台南,2023-11-24,9896
00650L,復華香港正2,412,2,410,元大-台南,2023-11-24,9896
00665L,富邦�琤肭磪囓�2,205,0,205,元大-台南,2023-11-24,9896
00753L,中信中國50正2,200,3,197,元大-台南,2023-11-24,9896
00680L,元大美債20正2,57,0,57,元大-台南,2023-11-24,9896
2618,長榮航,68,12,56,元大-台南,2023-11-24,9896
00929,復華台灣科技優息,64,16,48,元大-台南,2023-11-24,9896
3041,揚智,51,7,44,元大-台南,2023-11-24,9896
2731,雄獅,47,6,41,元大-台南,2023-11-24,9896
2515,中工,41,0,41,元大-台南,2023-11-24,9896
2363,矽統,68,36,32,元大-台南,2023-11-24,9896
3701,大眾控,23,0,23,元大-台南,2023-11-24,9896
1440,南紡,30,7,23,元大-台南,2023-11-24,9896
3105,穩懋,29,10,19,元大-台南,2023-11-24,9896
00878,國泰永續高股息,21,2,19,元大-台南,2023-11-24,9896
8033,雷虎,21,3,18,元大-台南,2023-11-24,9896
8088,品安,18,0,18,元大-台南,2023-11-24,9896
00715L,期街口布蘭特正2,21,4,17,元大-台南,2023-11-24,9896
3567,逸昌,15,0,15,元大-台南,2023-11-24,9896
2356,英業達,18,4,14,元大-台南,2023-11-24,9896
00932,兆豐永續高息等權,14,0,14,元大-台南,2023-11-24,9896
2002,中鋼,30,16,14,元大-台南,2023-11-24,9896
1609,大亞,52,38,14,元大-台南,2023-11-24,9896
5351,鈺創,31,17,14,元大-台南,2023-11-24,9896
2634,漢翔,63,50,13,元大-台南,2023-11-24,9896
1717,長興,13,0,13,元大-台南,2023-11-24,9896
00664R,國泰臺灣加權反1,13,0,13,元大-台南,2023-11-24,9896
3006,晶豪科,25,13,12,元大-台南,2023-11-24,9896
6689,伊雲谷,12,0,12,元大-台南,2023-11-24,9896
3094,聯傑,36,24,12,元大-台南,2023-11-24,9896
1584,精剛,17,5,12,元大-台南,2023-11-24,9896
2352,佳世達,12,1,11,元大-台南,2023-11-24,9896
2468,華經,11,0,11,元大-台南,2023-11-24,9896
2439,美律,11,1,10,元大-台南,2023-11-24,9896
6235,華孚,17,7,10,元大-台南,2023-11-24,9896
3052,夆典,10,0,10,元大-台南,2023-11-24,9896
00633L,富邦上証正2,14,4,10,元大-台南,2023-11-24,9896
2705,六福,10,0,10,元大-台南,2023-11-24,9896
00706L,期元大S＆P日圓正2,10,0,10,元大-台南,2023-11-24,9896
4744,皇將,10,0,10,元大-台南,2023-11-24,9896
6657,華安,10,0,10,元大-台南,2023-11-24,9896
6263,普萊德,10,0,10,元大-台南,2023-11-24,9896
8222,寶一,23,13,10,元大-台南,2023-11-24,9896
2353,宏��,13,4,9,元大-台南,2023-11-24,9896
2427,三商電,9,0,9,元大-台南,2023-11-24,9896
2337,旺宏,14,5,9,元大-台南,2023-11-24,9896
2610,華航,21,12,9,元大-台南,2023-11-24,9896
3260,威剛,8,0,8,元大-台南,2023-11-24,9896
00885,富邦越南,8,0,8,元大-台南,2023-11-24,9896
00687B,國泰20年美債,9,1,8,元大-台南,2023-11-24,9896
00751B,元大AAA至A公司債,218,1,217,元大-台南,2023-11-27,9896
2883,凱基金,194,23,171,元大-台南,2023-11-27,9896
00919,群益台灣精選高息,180,33,147,元大-台南,2023-11-27,9896
4746,台耀,126,18,108,元大-台南,2023-11-27,9896
2641,正德,101,5,96,元大-台南,2023-11-27,9896
2409,友達,81,2,79,元大-台南,2023-11-27,9896
1440,南紡,81,5,76,元大-台南,2023-11-27,9896
00715L,期街口布蘭特正2,76,1,75,元大-台南,2023-11-27,9896
1513,中興電,215,148,67,元大-台南,2023-11-27,9896
00632R,元大台灣50反1,162,97,65,元大-台南,2023-11-27,9896
00679B,元大美債20年,64,1,63,元大-台南,2023-11-27,9896
2605,新興,54,5,49,元大-台南,2023-11-27,9896
2382,廣達,55,9,46,元大-台南,2023-11-27,9896
1216,統一,41,1,40,元大-台南,2023-11-27,9896
5347,世界,34,3,31,元大-台南,2023-11-27,9896
2882,國泰金,30,1,29,元大-台南,2023-11-27,9896
00633L,富邦上証正2,28,0,28,元大-台南,2023-11-27,9896
00929,復華台灣科技優息,59,32,27,元大-台南,2023-11-27,9896
2457,飛宏,55,28,27,元大-台南,2023-11-27,9896
00720B,元大投資級公司債,26,0,26,元大-台南,2023-11-27,9896
2630,亞航,28,4,24,元大-台南,2023-11-27,9896
8996,高力,25,3,22,元大-台南,2023-11-27,9896
3437,榮創,27,5,22,元大-台南,2023-11-27,9896
2356,英業達,26,5,21,元大-台南,2023-11-27,9896
00712,復華富時不動產,22,2,20,元大-台南,2023-11-27,9896
2618,長榮航,44,24,20,元大-台南,2023-11-27,9896
2890,永豐金,20,0,20,元大-台南,2023-11-27,9896
3231,緯創,49,29,20,元大-台南,2023-11-27,9896
2834,臺企銀,21,1,20,元大-台南,2023-11-27,9896
00680L,元大美債20正2,19,0,19,元大-台南,2023-11-27,9896
3035,智原,22,3,19,元大-台南,2023-11-27,9896
911608,明輝-DR,19,0,19,元大-台南,2023-11-27,9896
8088,品安,19,0,19,元大-台南,2023-11-27,9896
4157,太景*-KY,20,1,19,元大-台南,2023-11-27,9896
6279,胡連,19,0,19,元大-台南,2023-11-27,9896
8086,宏捷科,25,7,18,元大-台南,2023-11-27,9896
00933B,國泰10Y+金融債,18,0,18,元大-台南,2023-11-27,9896
00902,中信電池及儲能,17,0,17,元大-台南,2023-11-27,9896
1584,精剛,18,1,17,元大-台南,2023-11-27,9896
00878,國泰永續高股息,30,14,16,元大-台南,2023-11-27,9896
0056,元大高股息,18,2,16,元大-台南,2023-11-27,9896
2313,華通,103,88,15,元大-台南,2023-11-27,9896
3705,永信,15,0,15,元大-台南,2023-11-27,9896
1449,佳和,15,0,15,元大-台南,2023-11-27,9896
4160,訊聯基因,15,0,15,元大-台南,2023-11-27,9896
2417,圓剛,14,0,14,元大-台南,2023-11-27,9896
00905,FT臺灣Smart,14,0,14,元大-台南,2023-11-27,9896
6806,森崴能源,15,1,14,元大-台南,2023-11-27,9896
6284,佳邦,21,7,14,元大-台南,2023-11-27,9896
5425,台半,13,0,13,元大-台南,2023-11-27,9896
00632R,元大台灣50反1,222,17,205,元大-台南,2023-11-28,9896
1514,亞力,207,100,107,元大-台南,2023-11-28,9896
1101,台泥,137,39,98,元大-台南,2023-11-28,9896
2474,可成,61,1,60,元大-台南,2023-11-28,9896
00919,群益台灣精選高息,57,6,51,元大-台南,2023-11-28,9896
2888,新光金,56,5,51,元大-台南,2023-11-28,9896
5347,世界,44,5,39,元大-台南,2023-11-28,9896
2367,燿華,65,31,34,元大-台南,2023-11-28,9896
2313,華通,146,116,30,元大-台南,2023-11-28,9896
8086,宏捷科,33,4,29,元大-台南,2023-11-28,9896
00715L,期街口布蘭特正2,22,0,22,元大-台南,2023-11-28,9896
00892,富邦台灣半導體,32,12,20,元大-台南,2023-11-28,9896
6185,幃翔,19,0,19,元大-台南,2023-11-28,9896
2353,宏��,20,2,18,元大-台南,2023-11-28,9896
2371,大同,20,2,18,元大-台南,2023-11-28,9896
00637L,元大滬深300正2,18,0,18,元大-台南,2023-11-28,9896
1781,合世,17,0,17,元大-台南,2023-11-28,9896
3705,永信,17,0,17,元大-台南,2023-11-28,9896
6226,光鼎,82,65,17,元大-台南,2023-11-28,9896
1584,精剛,17,0,17,元大-台南,2023-11-28,9896
00933B,國泰10Y+金融債,19,2,17,元大-台南,2023-11-28,9896
3376,新日興,21,5,16,元大-台南,2023-11-28,9896
2332,友訊,16,0,16,元大-台南,2023-11-28,9896
2303,聯電,25,11,14,元大-台南,2023-11-28,9896
6284,佳邦,17,4,13,元大-台南,2023-11-28,9896
6533,晶心科,14,1,13,元大-台南,2023-11-28,9896
4123,晟德,13,0,13,元大-台南,2023-11-28,9896
2882,國泰金,13,1,12,元大-台南,2023-11-28,9896
6133,金橋,22,10,12,元大-台南,2023-11-28,9896
1319,東陽,15,3,12,元大-台南,2023-11-28,9896
3017,奇鋐,12,1,11,元大-台南,2023-11-28,9896
2516,新建,10,0,10,元大-台南,2023-11-28,9896
00673R,期元大S＆P原油反1,10,0,10,元大-台南,2023-11-28,9896
3058,立德,10,0,10,元大-台南,2023-11-28,9896
4744,皇將,10,0,10,元大-台南,2023-11-28,9896
3308,聯德,10,0,10,元大-台南,2023-11-28,9896
3694,海華,14,5,9,元大-台南,2023-11-28,9896
2606,裕民,87,78,9,元大-台南,2023-11-28,9896
1905,華紙,9,1,8,元大-台南,2023-11-28,9896
2368,金像電,10,2,8,元大-台南,2023-11-28,9896
00830,國泰費城半導體,8,0,8,元大-台南,2023-11-28,9896
6505,台塑化,10,2,8,元大-台南,2023-11-28,9896
9919,康那香,12,4,8,元大-台南,2023-11-28,9896
1795,美時,11,3,8,元大-台南,2023-11-28,9896
1752,南光,7,0,7,元大-台南,2023-11-28,9896
4157,太景*-KY,7,0,7,元大-台南,2023-11-28,9896
6757,台灣虎航,7,0,7,元大-台南,2023-11-28,9896
4576,大銀微系統,7,0,7,元大-台南,2023-11-28,9896
4114,健喬,11,5,6,元大-台南,2023-11-28,9896
4167,松瑞藥,6,0,6,元大-台南,2023-11-28,9896
00680L,元大美債20正2,506,52,454,元大-台南,2023-11-29,9896
00671R,富邦NASDAQ反1,100,0,100,元大-台南,2023-11-29,9896
1440,南紡,68,1,67,元大-台南,2023-11-29,9896
00934,中信成長高股息,59,0,59,元大-台南,2023-11-29,9896
00772B,中信高評級公司債,57,0,57,元大-台南,2023-11-29,9896
1802,台玻,55,0,55,元大-台南,2023-11-29,9896
00882,中信中國高股息,52,0,52,元大-台南,2023-11-29,9896
2349,錸德,50,0,50,元大-台南,2023-11-29,9896
2376,技嘉,57,8,49,元大-台南,2023-11-29,9896
1514,亞力,236,192,44,元大-台南,2023-11-29,9896
9103,美德醫療-DR,39,0,39,元大-台南,2023-11-29,9896
6695,芯鼎,37,1,36,元大-台南,2023-11-29,9896
5457,宣德,32,0,32,元大-台南,2023-11-29,9896
1513,中興電,37,6,31,元大-台南,2023-11-29,9896
00933B,國泰10Y+金融債,28,0,28,元大-台南,2023-11-29,9896
2303,聯電,34,8,26,元大-台南,2023-11-29,9896
2891,中信金,30,4,26,元大-台南,2023-11-29,9896
2618,長榮航,27,1,26,元大-台南,2023-11-29,9896
00679B,元大美債20年,23,0,23,元大-台南,2023-11-29,9896
5608,四維航,28,5,23,元大-台南,2023-11-29,9896
00673R,期元大S＆P原油反1,23,0,23,元大-台南,2023-11-29,9896
5864,致和證,25,2,23,元大-台南,2023-11-29,9896
3481,群創,25,4,21,元大-台南,2023-11-29,9896
6127,九豪,31,11,20,元大-台南,2023-11-29,9896
5880,合庫金,20,1,19,元大-台南,2023-11-29,9896
2606,裕民,27,8,19,元大-台南,2023-11-29,9896
00885,富邦越南,24,5,19,元大-台南,2023-11-29,9896
6133,金橋,20,1,19,元大-台南,2023-11-29,9896
00720B,元大投資級公司債,23,5,18,元大-台南,2023-11-29,9896
5351,鈺創,22,4,18,元大-台南,2023-11-29,9896
2329,華泰,127,110,17,元大-台南,2023-11-29,9896
00719B,元大美債1-3,17,0,17,元大-台南,2023-11-29,9896
6233,旺玖,17,0,17,元大-台南,2023-11-29,9896
00687B,國泰20年美債,16,0,16,元大-台南,2023-11-29,9896
2317,鴻海,17,1,16,元大-台南,2023-11-29,9896
00650L,復華香港正2,15,0,15,元大-台南,2023-11-29,9896
4126,太醫,15,0,15,元大-台南,2023-11-29,9896
5525,順天,15,0,15,元大-台南,2023-11-29,9896
3078,僑威,15,1,14,元大-台南,2023-11-29,9896
2033,佳大,14,0,14,元大-台南,2023-11-29,9896
4973,廣穎,15,2,13,元大-台南,2023-11-29,9896
1605,華新,13,0,13,元大-台南,2023-11-29,9896
2002,中鋼,15,3,12,元大-台南,2023-11-29,9896
1506,正道,12,0,12,元大-台南,2023-11-29,9896
3025,星通,11,0,11,元大-台南,2023-11-29,9896
2369,菱生,20,9,11,元大-台南,2023-11-29,9896
6185,幃翔,11,0,11,元大-台南,2023-11-29,9896
6117,迎廣,14,3,11,元大-台南,2023-11-29,9896
6274,台燿,10,0,10,元大-台南,2023-11-29,9896
00674R,期元大S＆P黃金反1,10,0,10,元大-台南,2023-11-29,9896
00680L,元大美債20正2,569,0,569,元大-台南,2023-11-30,9896
1440,南紡,200,1,199,元大-台南,2023-11-30,9896
00915,凱基優選高股息30,122,3,119,元大-台南,2023-11-30,9896
00929,復華台灣科技優息,154,77,77,元大-台南,2023-11-30,9896
2329,華泰,236,170,66,元大-台南,2023-11-30,9896
2474,可成,70,6,64,元大-台南,2023-11-30,9896
00934,中信成長高股息,54,0,54,元大-台南,2023-11-30,9896
00720B,元大投資級公司債,61,7,54,元大-台南,2023-11-30,9896
2313,華通,66,16,50,元大-台南,2023-11-30,9896
3231,緯創,57,7,50,元大-台南,2023-11-30,9896
00679B,元大美債20年,54,13,41,元大-台南,2023-11-30,9896
4123,晟德,37,0,37,元大-台南,2023-11-30,9896
00673R,期元大S＆P原油反1,35,0,35,元大-台南,2023-11-30,9896
9924,福興,33,0,33,元大-台南,2023-11-30,9896
2618,長榮航,36,7,29,元大-台南,2023-11-30,9896
00882,中信中國高股息,28,0,28,元大-台南,2023-11-30,9896
4968,立積,27,2,25,元大-台南,2023-11-30,9896
2801,彰銀,25,2,23,元大-台南,2023-11-30,9896
00687B,國泰20年美債,22,0,22,元大-台南,2023-11-30,9896
2547,日勝生,20,0,20,元大-台南,2023-11-30,9896
0055,元大MSCI金融,20,0,20,元大-台南,2023-11-30,9896
2834,臺企銀,24,4,20,元大-台南,2023-11-30,9896
00891,中信關鍵半導體,32,15,17,元大-台南,2023-11-30,9896
5347,世界,17,0,17,元大-台南,2023-11-30,9896
3094,聯傑,22,5,17,元大-台南,2023-11-30,9896
3693,營邦,19,3,16,元大-台南,2023-11-30,9896
00885,富邦越南,16,0,16,元大-台南,2023-11-30,9896
3583,辛耘,22,6,16,元大-台南,2023-11-30,9896
00933B,國泰10Y+金融債,18,3,15,元大-台南,2023-11-30,9896
00931B,統一美債20年,20,5,15,元大-台南,2023-11-30,9896
8210,勤誠,28,14,14,元大-台南,2023-11-30,9896
2515,中工,14,0,14,元大-台南,2023-11-30,9896
2816,旺旺保,13,0,13,元大-台南,2023-11-30,9896
2201,裕隆,19,7,12,元大-台南,2023-11-30,9896
2369,菱生,20,8,12,元大-台南,2023-11-30,9896
5328,華容,21,9,12,元大-台南,2023-11-30,9896
2413,環科,12,0,12,元大-台南,2023-11-30,9896
2376,技嘉,21,10,11,元大-台南,2023-11-30,9896
6282,康舒,25,14,11,元大-台南,2023-11-30,9896
2903,遠百,11,0,11,元大-台南,2023-11-30,9896
3567,逸昌,11,0,11,元大-台南,2023-11-30,9896
2352,佳世達,10,0,10,元大-台南,2023-11-30,9896
6133,金橋,28,18,10,元大-台南,2023-11-30,9896
6121,新普,9,0,9,元大-台南,2023-11-30,9896
3059,華晶科,10,2,8,元大-台南,2023-11-30,9896
00725B,國泰投資級公司債,8,0,8,元大-台南,2023-11-30,9896
2387,精元,10,2,8,元大-台南,2023-11-30,9896
6185,幃翔,8,0,8,元大-台南,2023-11-30,9896
00665L,富邦�琤肭磪囓�2,18,10,8,元大-台南,2023-11-30,9896
2344,華邦電,30,22,8,元大-台南,2023-11-30,9896
00680L,元大美債20正2,192,0,192,元大-台南,2023-12-01,9896
2402,毅嘉,161,6,155,元大-台南,2023-12-01,9896
00715L,期街口布蘭特正2,89,3,86,元大-台南,2023-12-01,9896
2025,千興,60,0,60,元大-台南,2023-12-01,9896
00919,群益台灣精選高息,76,16,60,元大-台南,2023-12-01,9896
3231,緯創,83,29,54,元大-台南,2023-12-01,9896
00679B,元大美債20年,53,1,52,元大-台南,2023-12-01,9896
3545,敦泰,52,7,45,元大-台南,2023-12-01,9896
2474,可成,46,2,44,元大-台南,2023-12-01,9896
1513,中興電,164,121,43,元大-台南,2023-12-01,9896
00934,中信成長高股息,43,0,43,元大-台南,2023-12-01,9896
00897,富邦基因免疫生技,42,0,42,元大-台南,2023-12-01,9896
2382,廣達,47,14,33,元大-台南,2023-12-01,9896
5347,世界,34,2,32,元大-台南,2023-12-01,9896
1795,美時,67,35,32,元大-台南,2023-12-01,9896
5009,榮剛,37,6,31,元大-台南,2023-12-01,9896
4550,長佳,31,1,30,元大-台南,2023-12-01,9896
6133,金橋,54,24,30,元大-台南,2023-12-01,9896
2883,凱基金,35,7,28,元大-台南,2023-12-01,9896
00637L,元大滬深300正2,28,1,27,元大-台南,2023-12-01,9896
00878,國泰永續高股息,41,14,27,元大-台南,2023-12-01,9896
1325,恆大,29,3,26,元大-台南,2023-12-01,9896
1440,南紡,27,1,26,元大-台南,2023-12-01,9896
5351,鈺創,28,4,24,元大-台南,2023-12-01,9896
00687B,國泰20年美債,23,0,23,元大-台南,2023-12-01,9896
8358,金居,25,2,23,元大-台南,2023-12-01,9896
2363,矽統,39,17,22,元大-台南,2023-12-01,9896
6202,盛群,21,0,21,元大-台南,2023-12-01,9896
9103,美德醫療-DR,20,0,20,元大-台南,2023-12-01,9896
2618,長榮航,20,1,19,元大-台南,2023-12-01,9896
2472,立隆電,18,0,18,元大-台南,2023-12-01,9896
1101,台泥,21,3,18,元大-台南,2023-12-01,9896
3706,神達,32,15,17,元大-台南,2023-12-01,9896
2364,倫飛,35,18,17,元大-台南,2023-12-01,9896
00720B,元大投資級公司債,18,1,17,元大-台南,2023-12-01,9896
6213,聯茂,18,2,16,元大-台南,2023-12-01,9896
00931B,統一美債20年,15,0,15,元大-台南,2023-12-01,9896
00639,富邦深100,15,0,15,元大-台南,2023-12-01,9896
2887,台新金,15,0,15,元大-台南,2023-12-01,9896
6435,大中,15,1,14,元大-台南,2023-12-01,9896
2324,仁寶,28,15,13,元大-台南,2023-12-01,9896
2891,中信金,15,2,13,元大-台南,2023-12-01,9896
00885,富邦越南,13,0,13,元大-台南,2023-12-01,9896
1524,耿鼎,15,3,12,元大-台南,2023-12-01,9896
2641,正德,25,13,12,元大-台南,2023-12-01,9896
4114,健喬,27,15,12,元大-台南,2023-12-01,9896
2332,友訊,11,0,11,元大-台南,2023-12-01,9896
00751B,元大AAA至A公司債,12,2,10,元大-台南,2023-12-01,9896
3704,合勤控,12,2,10,元大-台南,2023-12-01,9896
3189,景碩,10,0,10,元大-台南,2023-12-01,9896
1440,南紡,161,4,157,元大-台南,2023-12-04,9896
00918,大華優利高填息30,158,2,156,元大-台南,2023-12-04,9896
00919,群益台灣精選高息,182,62,120,元大-台南,2023-12-04,9896
2382,廣達,132,13,119,元大-台南,2023-12-04,9896
00715L,期街口布蘭特正2,110,1,109,元大-台南,2023-12-04,9896
00719B,元大美債1-3,105,0,105,元大-台南,2023-12-04,9896
00687B,國泰20年美債,71,0,71,元大-台南,2023-12-04,9896
2355,敬鵬,117,51,66,元大-台南,2023-12-04,9896
2606,裕民,262,211,51,元大-台南,2023-12-04,9896
2025,千興,60,10,50,元大-台南,2023-12-04,9896
1605,華新,89,40,49,元大-台南,2023-12-04,9896
00882,中信中國高股息,45,0,45,元大-台南,2023-12-04,9896
2457,飛宏,52,12,40,元大-台南,2023-12-04,9896
2610,華航,50,11,39,元大-台南,2023-12-04,9896
5426,振發,46,9,37,元大-台南,2023-12-04,9896
9103,美德醫療-DR,42,6,36,元大-台南,2023-12-04,9896
4167,松瑞藥,54,18,36,元大-台南,2023-12-04,9896
1701,中化,35,0,35,元大-台南,2023-12-04,9896
2367,燿華,66,31,35,元大-台南,2023-12-04,9896
1504,東元,35,4,31,元大-台南,2023-12-04,9896
6282,康舒,29,3,26,元大-台南,2023-12-04,9896
3231,緯創,40,14,26,元大-台南,2023-12-04,9896
00642U,期元大S＆P石油,25,0,25,元大-台南,2023-12-04,9896
2460,建通,25,1,24,元大-台南,2023-12-04,9896
2033,佳大,24,0,24,元大-台南,2023-12-04,9896
1326,台化,25,1,24,元大-台南,2023-12-04,9896
2892,第一金,22,0,22,元大-台南,2023-12-04,9896
1325,恆大,22,1,21,元大-台南,2023-12-04,9896
3715,定穎投控,55,34,21,元大-台南,2023-12-04,9896
0055,元大MSCI金融,20,0,20,元大-台南,2023-12-04,9896
3450,聯鈞,23,3,20,元大-台南,2023-12-04,9896
00674R,期元大S＆P黃金反1,20,0,20,元大-台南,2023-12-04,9896
00664R,國泰臺灣加權反1,20,0,20,元大-台南,2023-12-04,9896
2356,英業達,30,10,20,元大-台南,2023-12-04,9896
00679B,元大美債20年,21,2,19,元大-台南,2023-12-04,9896
2884,玉山金,24,4,20,元大-台南,2023-12-04,9896
2353,宏��,19,0,19,元大-台南,2023-12-04,9896
2105,正新,20,2,18,元大-台南,2023-12-04,9896
2618,長榮航,44,27,17,元大-台南,2023-12-04,9896
2108,南帝,20,3,17,元大-台南,2023-12-04,9896
3483,力致,19,3,16,元大-台南,2023-12-04,9896
5443,均豪,16,0,16,元大-台南,2023-12-04,9896
5351,鈺創,18,3,15,元大-台南,2023-12-04,9896
00680L,元大美債20正2,45,30,15,元大-台南,2023-12-04,9896
1584,精剛,15,0,15,元大-台南,2023-12-04,9896
00936,台新永續高息中小,15,0,15,元大-台南,2023-12-04,9896
2313,華通,52,38,14,元大-台南,2023-12-04,9896
1524,耿鼎,16,2,14,元大-台南,2023-12-04,9896
00712,復華富時不動產,48,35,13,元大-台南,2023-12-04,9896
2891,中信金,13,0,13,元大-台南,2023-12-04,9896
00937B,群益ESG投等債20,327,20,307,元大-台南,2023-12-05,9896
2474,可成,256,1,255,元大-台南,2023-12-05,9896
00919,群益台灣精選高息,194,44,150,元大-台南,2023-12-05,9896
00882,中信中國高股息,165,30,135,元大-台南,2023-12-05,9896
2637,慧洋-KY,137,11,126,元大-台南,2023-12-05,9896
4167,松瑞藥,246,121,125,元大-台南,2023-12-05,9896
00676R,富邦臺灣加權反1,105,0,105,元大-台南,2023-12-05,9896
2317,鴻海,102,2,100,元大-台南,2023-12-05,9896
00918,大華優利高填息30,84,3,81,元大-台南,2023-12-05,9896
00680L,元大美債20正2,79,10,69,元大-台南,2023-12-05,9896
00752,中信中國50,67,0,67,元大-台南,2023-12-05,9896
2025,千興,60,0,60,元大-台南,2023-12-05,9896
9103,美德醫療-DR,56,2,54,元大-台南,2023-12-05,9896
00642U,期元大S＆P石油,52,0,52,元大-台南,2023-12-05,9896
2891,中信金,54,2,52,元大-台南,2023-12-05,9896
2883,凱基金,79,28,51,元大-台南,2023-12-05,9896
1605,華新,62,13,49,元大-台南,2023-12-05,9896
2382,廣達,52,4,48,元大-台南,2023-12-05,9896
00687B,國泰20年美債,55,7,48,元大-台南,2023-12-05,9896
2603,長榮,59,15,44,元大-台南,2023-12-05,9896
2355,敬鵬,47,9,38,元大-台南,2023-12-05,9896
00679B,元大美債20年,48,10,38,元大-台南,2023-12-05,9896
00885,富邦越南,33,0,33,元大-台南,2023-12-05,9896
00878,國泰永續高股息,53,25,28,元大-台南,2023-12-05,9896
2401,凌陽,29,4,25,元大-台南,2023-12-05,9896
2641,正德,44,20,24,元大-台南,2023-12-05,9896
3006,晶豪科,27,4,23,元大-台南,2023-12-05,9896
2457,飛宏,26,3,23,元大-台南,2023-12-05,9896
6187,萬潤,23,1,22,元大-台南,2023-12-05,9896
00857B,永豐20年美公債,22,0,22,元大-台南,2023-12-05,9896
00933B,國泰10Y+金融債,22,0,22,元大-台南,2023-12-05,9896
00934,中信成長高股息,21,0,21,元大-台南,2023-12-05,9896
5347,世界,23,2,21,元大-台南,2023-12-05,9896
2352,佳世達,23,2,21,元大-台南,2023-12-05,9896
00722B,群益投資級電信債,20,0,20,元大-台南,2023-12-05,9896
2014,中鴻,20,0,20,元大-台南,2023-12-05,9896
6241,易通展,20,0,20,元大-台南,2023-12-05,9896
1584,精剛,21,2,19,元大-台南,2023-12-05,9896
9950,萬國通,18,0,18,元大-台南,2023-12-05,9896
2610,華航,17,1,16,元大-台南,2023-12-05,9896
00715L,期街口布蘭特正2,16,0,16,元大-台南,2023-12-05,9896
3081,聯亞,16,0,16,元大-台南,2023-12-05,9896
5443,均豪,16,0,16,元大-台南,2023-12-05,9896
2344,華邦電,23,8,15,元大-台南,2023-12-05,9896
1609,大亞,17,2,15,元大-台南,2023-12-05,9896
2358,廷鑫,15,0,15,元大-台南,2023-12-05,9896
2303,聯電,15,0,15,元大-台南,2023-12-05,9896
3105,穩懋,25,11,14,元大-台南,2023-12-05,9896
1504,東元,18,4,14,元大-台南,2023-12-05,9896
3260,威剛,14,1,13,元大-台南,2023-12-05,9896
00680L,元大美債20正2,371,46,325,元大-台南,2023-12-06,9896
00937B,群益ESG投等債20,170,5,165,元大-台南,2023-12-06,9896
00671R,富邦NASDAQ反1,110,10,100,元大-台南,2023-12-06,9896
00919,群益台灣精選高息,114,16,98,元大-台南,2023-12-06,9896
00931B,統一美債20年,83,1,82,元大-台南,2023-12-06,9896
00933B,國泰10Y+金融債,86,6,80,元大-台南,2023-12-06,9896
2606,裕民,93,22,71,元大-台南,2023-12-06,9896
2457,飛宏,62,1,61,元大-台南,2023-12-06,9896
2025,千興,60,0,60,元大-台南,2023-12-06,9896
3481,群創,66,12,54,元大-台南,2023-12-06,9896
00679B,元大美債20年,53,7,46,元大-台南,2023-12-06,9896
00687B,國泰20年美債,44,2,42,元大-台南,2023-12-06,9896
00715L,期街口布蘭特正2,37,0,37,元大-台南,2023-12-06,9896
2303,聯電,38,4,34,元大-台南,2023-12-06,9896
6213,聯茂,35,2,33,元大-台南,2023-12-06,9896
2355,敬鵬,83,52,31,元大-台南,2023-12-06,9896
6245,立端,31,1,30,元大-台南,2023-12-06,9896
5347,世界,28,2,26,元大-台南,2023-12-06,9896
00720B,元大投資級公司債,42,17,25,元大-台南,2023-12-06,9896
00751B,元大AAA至A公司債,32,7,25,元大-台南,2023-12-06,9896
1795,美時,25,1,24,元大-台南,2023-12-06,9896
00637L,元大滬深300正2,31,7,24,元大-台南,2023-12-06,9896
00642U,期元大S＆P石油,23,0,23,元大-台南,2023-12-06,9896
1605,華新,39,16,23,元大-台南,2023-12-06,9896
1522,堤維西,26,3,23,元大-台南,2023-12-06,9896
00712,復華富時不動產,23,1,22,元大-台南,2023-12-06,9896
1515,力山,22,0,22,元大-台南,2023-12-06,9896
1618,合機,33,12,21,元大-台南,2023-12-06,9896
4968,立積,21,0,21,元大-台南,2023-12-06,9896
2601,益航,22,2,20,元大-台南,2023-12-06,9896
00795B,中信美國公債20年,20,1,19,元大-台南,2023-12-06,9896
2401,凌陽,35,17,18,元大-台南,2023-12-06,9896
6282,康舒,20,3,17,元大-台南,2023-12-06,9896
2409,友達,16,0,16,元大-台南,2023-12-06,9896
4942,嘉彰,16,0,16,元大-台南,2023-12-06,9896
6216,居易,15,0,15,元大-台南,2023-12-06,9896
2313,華通,22,7,15,元大-台南,2023-12-06,9896
6535,順藥,15,0,15,元大-台南,2023-12-06,9896
00636,國泰中國A50,14,0,14,元大-台南,2023-12-06,9896
8097,常珵,13,0,13,元大-台南,2023-12-06,9896
2344,華邦電,29,17,12,元大-台南,2023-12-06,9896
00665L,富邦�琤肭磪囓�2,12,0,12,元大-台南,2023-12-06,9896
3013,晟銘電,59,47,12,元大-台南,2023-12-06,9896
1752,南光,12,0,12,元大-台南,2023-12-06,9896
6446,藥華藥,11,0,11,元大-台南,2023-12-06,9896
3712,永崴投控,12,1,11,元大-台南,2023-12-06,9896
2356,英業達,17,6,11,元大-台南,2023-12-06,9896
3078,僑威,25,14,11,元大-台南,2023-12-06,9896
2612,中航,35,24,11,元大-台南,2023-12-06,9896
2881,富邦金,11,0,11,元大-台南,2023-12-06,9896
00919,群益台灣精選高息,361,0,361,元大-台南,2023-12-07,9896
2618,長榮航,259,60,199,元大-台南,2023-12-07,9896
00680L,元大美債20正2,142,26,116,元大-台南,2023-12-07,9896
2889,國票金,112,0,112,元大-台南,2023-12-07,9896
00937B,群益ESG投等債20,167,61,106,元大-台南,2023-12-07,9896
00715L,期街口布蘭特正2,97,1,96,元大-台南,2023-12-07,9896
00752,中信中國50,86,10,76,元大-台南,2023-12-07,9896
2605,新興,79,6,73,元大-台南,2023-12-07,9896
00687B,國泰20年美債,78,9,69,元大-台南,2023-12-07,9896
2025,千興,60,0,60,元大-台南,2023-12-07,9896
00706L,期元大S＆P日圓正2,55,0,55,元大-台南,2023-12-07,9896
2105,正新,54,0,54,元大-台南,2023-12-07,9896
2317,鴻海,56,4,52,元大-台南,2023-12-07,9896
00712,復華富時不動產,62,10,52,元大-台南,2023-12-07,9896
00679B,元大美債20年,77,27,50,元大-台南,2023-12-07,9896
6016,康和證,50,0,50,元大-台南,2023-12-07,9896
6185,幃翔,49,0,49,元大-台南,2023-12-07,9896
00642U,期元大S＆P石油,45,0,45,元大-台南,2023-12-07,9896
3041,揚智,121,80,41,元大-台南,2023-12-07,9896
00720B,元大投資級公司債,56,20,36,元大-台南,2023-12-07,9896
4561,健椿,45,12,33,元大-台南,2023-12-07,9896
2465,麗臺,30,4,26,元大-台南,2023-12-07,9896
1513,中興電,98,72,26,元大-台南,2023-12-07,9896
4744,皇將,25,0,25,元大-台南,2023-12-07,9896
1616,億泰,29,5,24,元大-台南,2023-12-07,9896
2425,承啟,119,95,24,元大-台南,2023-12-07,9896
2834,臺企銀,25,1,24,元大-台南,2023-12-07,9896
8936,國統,29,5,24,元大-台南,2023-12-07,9896
2606,裕民,32,10,22,元大-台南,2023-12-07,9896
2303,聯電,28,8,20,元大-台南,2023-12-07,9896
2722,夏都,21,1,20,元大-台南,2023-12-07,9896
5272,笙科,20,0,20,元大-台南,2023-12-07,9896
00688L,國泰20年美債正2,20,0,20,元大-台南,2023-12-07,9896
4967,十銓,38,18,20,元大-台南,2023-12-07,9896
2891,中信金,20,0,20,元大-台南,2023-12-07,9896
5009,榮剛,19,0,19,元大-台南,2023-12-07,9896
6150,撼訊,20,3,17,元大-台南,2023-12-07,9896
2457,飛宏,17,1,16,元大-台南,2023-12-07,9896
3576,聯合再生,16,0,16,元大-台南,2023-12-07,9896
00665L,富邦�琤肭磪囓�2,15,0,15,元大-台南,2023-12-07,9896
1731,美吾華,15,0,15,元大-台南,2023-12-07,9896
6216,居易,15,0,15,元大-台南,2023-12-07,9896
2399,映泰,156,141,15,元大-台南,2023-12-07,9896
00923,群益台ESG低碳50,15,0,15,元大-台南,2023-12-07,9896
2887,台新金,15,1,14,元大-台南,2023-12-07,9896
5347,世界,17,3,14,元大-台南,2023-12-07,9896
8088,品安,14,0,14,元大-台南,2023-12-07,9896
00857B,永豐20年美公債,14,0,14,元大-台南,2023-12-07,9896
1603,華電,15,1,14,元大-台南,2023-12-07,9896
00933B,國泰10Y+金融債,14,0,14,元大-台南,2023-12-07,9896
00919,群益台灣精選高息,572,13,559,元大-台南,2023-12-08,9896
00882,中信中國高股息,417,15,402,元大-台南,2023-12-08,9896
00680L,元大美債20正2,366,10,356,元大-台南,2023-12-08,9896
00679B,元大美債20年,195,24,171,元大-台南,2023-12-08,9896
00687B,國泰20年美債,189,20,169,元大-台南,2023-12-08,9896
00937B,群益ESG投等債20,82,0,82,元大-台南,2023-12-08,9896
00929,復華台灣科技優息,75,14,61,元大-台南,2023-12-08,9896
2025,千興,60,0,60,元大-台南,2023-12-08,9896
2515,中工,47,1,46,元大-台南,2023-12-08,9896
5351,鈺創,49,11,38,元大-台南,2023-12-08,9896
1440,南紡,53,15,38,元大-台南,2023-12-08,9896
00720B,元大投資級公司債,36,0,36,元大-台南,2023-12-08,9896
2412,中華電,36,0,36,元大-台南,2023-12-08,9896
00752,中信中國50,36,0,36,元大-台南,2023-12-08,9896
2356,英業達,83,51,32,元大-台南,2023-12-08,9896
2329,華泰,41,9,32,元大-台南,2023-12-08,9896
4142,國光生,31,0,31,元大-台南,2023-12-08,9896
2457,飛宏,32,1,31,元大-台南,2023-12-08,9896
00642U,期元大S＆P石油,30,0,30,元大-台南,2023-12-08,9896
9939,宏全,28,0,28,元大-台南,2023-12-08,9896
6005,群益證,30,3,27,元大-台南,2023-12-08,9896
2330,台積電,37,10,27,元大-台南,2023-12-08,9896
3413,京鼎,25,0,25,元大-台南,2023-12-08,9896
2903,遠百,25,0,25,元大-台南,2023-12-08,9896
1513,中興電,84,60,24,元大-台南,2023-12-08,9896
00918,大華優利高填息30,24,1,23,元大-台南,2023-12-08,9896
4533,協易機,29,7,22,元大-台南,2023-12-08,9896
00715L,期街口布蘭特正2,35,13,22,元大-台南,2023-12-08,9896
6207,雷科,22,0,22,元大-台南,2023-12-08,9896
2641,正德,25,6,19,元大-台南,2023-12-08,9896
00933B,國泰10Y+金融債,19,0,19,元大-台南,2023-12-08,9896
00772B,中信高評級公司債,18,0,18,元大-台南,2023-12-08,9896
1785,光洋科,18,0,18,元大-台南,2023-12-08,9896
8996,高力,21,4,17,元大-台南,2023-12-08,9896
1618,合機,56,39,17,元大-台南,2023-12-08,9896
3231,緯創,39,23,16,元大-台南,2023-12-08,9896
1609,大亞,35,20,15,元大-台南,2023-12-08,9896
2358,廷鑫,25,10,15,元大-台南,2023-12-08,9896
5905,南仁湖,15,0,15,元大-台南,2023-12-08,9896
6026,福邦證,14,0,14,元大-台南,2023-12-08,9896
6133,金橋,29,15,14,元大-台南,2023-12-08,9896
2017,官田鋼,14,0,14,元大-台南,2023-12-08,9896
2606,裕民,17,3,14,元大-台南,2023-12-08,9896
4543,萬在,13,0,13,元大-台南,2023-12-08,9896
2376,技嘉,39,26,13,元大-台南,2023-12-08,9896
00932,兆豐永續高息等權,12,0,12,元大-台南,2023-12-08,9896
00915,凱基優選高股息30,12,0,12,元大-台南,2023-12-08,9896
4726,永昕,12,0,12,元大-台南,2023-12-08,9896
2405,輔信,29,17,12,元大-台南,2023-12-08,9896
2731,雄獅,12,1,11,元大-台南,2023-12-08,9896
00919,群益台灣精選高息,306,5,301,元大-台南,2023-12-11,9896
4906,正文,239,3,236,元大-台南,2023-12-11,9896
2468,華經,111,0,111,元大-台南,2023-12-11,9896
00687B,國泰20年美債,90,0,90,元大-台南,2023-12-11,9896
5410,國眾,80,0,80,元大-台南,2023-12-11,9896
2412,中華電,80,3,77,元大-台南,2023-12-11,9896
1524,耿鼎,160,99,61,元大-台南,2023-12-11,9896
2025,千興,60,0,60,元大-台南,2023-12-11,9896
2888,新光金,69,9,60,元大-台南,2023-12-11,9896
00706L,期元大S＆P日圓正2,55,0,55,元大-台南,2023-12-11,9896
2317,鴻海,47,4,43,元大-台南,2023-12-11,9896
00752,中信中國50,40,0,40,元大-台南,2023-12-11,9896
00937B,群益ESG投等債20,39,1,38,元大-台南,2023-12-11,9896
00882,中信中國高股息,67,29,38,元大-台南,2023-12-11,9896
6282,康舒,56,23,33,元大-台南,2023-12-11,9896
00934,中信成長高股息,31,1,30,元大-台南,2023-12-11,9896
8215,明基材,29,0,29,元大-台南,2023-12-11,9896
2618,長榮航,31,3,28,元大-台南,2023-12-11,9896
00708L,期元大S＆P黃金正2,26,1,25,元大-台南,2023-12-11,9896
2002,中鋼,25,0,25,元大-台南,2023-12-11,9896
00641R,富邦日本反1,24,0,24,元大-台南,2023-12-11,9896
00642U,期元大S＆P石油,27,3,24,元大-台南,2023-12-11,9896
2605,新興,74,50,24,元大-台南,2023-12-11,9896
00929,復華台灣科技優息,35,14,21,元大-台南,2023-12-11,9896
4532,瑞智,20,0,20,元大-台南,2023-12-11,9896
2881,富邦金,20,0,20,元大-台南,2023-12-11,9896
1584,精剛,21,2,19,元大-台南,2023-12-11,9896
1440,南紡,17,0,17,元大-台南,2023-12-11,9896
2882,國泰金,18,2,16,元大-台南,2023-12-11,9896
2457,飛宏,22,7,15,元大-台南,2023-12-11,9896
1721,三晃,92,77,15,元大-台南,2023-12-11,9896
5905,南仁湖,15,0,15,元大-台南,2023-12-11,9896
00715L,期街口布蘭特正2,16,1,15,元大-台南,2023-12-11,9896
4123,晟德,15,0,15,元大-台南,2023-12-11,9896
2388,威盛,23,8,15,元大-台南,2023-12-11,9896
8110,華東,14,0,14,元大-台南,2023-12-11,9896
4142,國光生,13,0,13,元大-台南,2023-12-11,9896
1519,華城,25,12,13,元大-台南,2023-12-11,9896
1618,合機,39,27,12,元大-台南,2023-12-11,9896
3078,僑威,29,17,12,元大-台南,2023-12-11,9896
6024,群益期,12,0,12,元大-台南,2023-12-11,9896
00907,永豐優息存股,11,0,11,元大-台南,2023-12-11,9896
3056,富華新,15,4,11,元大-台南,2023-12-11,9896
1515,力山,12,1,11,元大-台南,2023-12-11,9896
2465,麗臺,11,1,10,元大-台南,2023-12-11,9896
6216,居易,10,0,10,元大-台南,2023-12-11,9896
3705,永信,10,0,10,元大-台南,2023-12-11,9896
00933B,國泰10Y+金融債,10,0,10,元大-台南,2023-12-11,9896
3062,建漢,12,2,10,元大-台南,2023-12-11,9896
2515,中工,10,0,10,元大-台南,2023-12-11,9896
00679B,元大美債20年,145,0,145,元大-台南,2023-12-12,9896
00680L,元大美債20正2,121,0,121,元大-台南,2023-12-12,9896
00751B,元大AAA至A公司債,83,0,83,元大-台南,2023-12-12,9896
2610,華航,91,25,66,元大-台南,2023-12-12,9896
3346,麗清,68,6,62,元大-台南,2023-12-12,9896
2618,長榮航,71,9,62,元大-台南,2023-12-12,9896
00897,富邦基因免疫生技,60,0,60,元大-台南,2023-12-12,9896
2025,千興,60,0,60,元大-台南,2023-12-12,9896
2382,廣達,55,3,52,元大-台南,2023-12-12,9896
00929,復華台灣科技優息,99,51,48,元大-台南,2023-12-12,9896
4123,晟德,45,0,45,元大-台南,2023-12-12,9896
3481,群創,104,61,43,元大-台南,2023-12-12,9896
1522,堤維西,47,6,41,元大-台南,2023-12-12,9896
2883,凱基金,38,0,38,元大-台南,2023-12-12,9896
3694,海華,75,38,37,元大-台南,2023-12-12,9896
3231,緯創,44,7,37,元大-台南,2023-12-12,9896
00919,群益台灣精選高息,130,94,36,元大-台南,2023-12-12,9896
00687B,國泰20年美債,72,39,33,元大-台南,2023-12-12,9896
6290,良維,34,2,32,元大-台南,2023-12-12,9896
9950,萬國通,29,0,29,元大-台南,2023-12-12,9896
6806,森崴能源,27,0,27,元大-台南,2023-12-12,9896
1609,大亞,46,21,25,元大-台南,2023-12-12,9896
2323,中環,25,1,24,元大-台南,2023-12-12,9896
3308,聯德,23,0,23,元大-台南,2023-12-12,9896
2002,中鋼,23,0,23,元大-台南,2023-12-12,9896
8112,至上,59,36,23,元大-台南,2023-12-12,9896
3227,原相,22,0,22,元大-台南,2023-12-12,9896
00715L,期街口布蘭特正2,22,0,22,元大-台南,2023-12-12,9896
6216,居易,21,0,21,元大-台南,2023-12-12,9896
00918,大華優利高填息30,20,0,20,元大-台南,2023-12-12,9896
2882,國泰金,23,5,18,元大-台南,2023-12-12,9896
1513,中興電,43,25,18,元大-台南,2023-12-12,9896
8088,品安,20,2,18,元大-台南,2023-12-12,9896
5351,鈺創,21,3,18,元大-台南,2023-12-12,9896
00937B,群益ESG投等債20,28,11,17,元大-台南,2023-12-12,9896
6282,康舒,20,3,17,元大-台南,2023-12-12,9896
00878,國泰永續高股息,33,16,17,元大-台南,2023-12-12,9896
3078,僑威,30,14,16,元大-台南,2023-12-12,9896
2313,華通,38,23,15,元大-台南,2023-12-12,9896
3413,京鼎,15,1,14,元大-台南,2023-12-12,9896
3532,台勝科,21,7,14,元大-台南,2023-12-12,9896
2889,國票金,13,0,13,元大-台南,2023-12-12,9896
9958,世紀鋼,13,0,13,元大-台南,2023-12-12,9896
00934,中信成長高股息,16,3,13,元大-台南,2023-12-12,9896
6205,詮欣,22,9,13,元大-台南,2023-12-12,9896
00795B,中信美國公債20年,12,0,12,元大-台南,2023-12-12,9896
1584,精剛,49,37,12,元大-台南,2023-12-12,9896
2402,毅嘉,21,9,12,元大-台南,2023-12-12,9896
2388,威盛,49,37,12,元大-台南,2023-12-12,9896
8096,擎亞,17,6,11,元大-台南,2023-12-12,9896
00919,群益台灣精選高息,320,37,283,元大-台南,2023-12-13,9896
00918,大華優利高填息30,254,0,254,元大-台南,2023-12-13,9896
00715L,期街口布蘭特正2,188,2,186,元大-台南,2023-12-13,9896
00882,中信中國高股息,170,3,167,元大-台南,2023-12-13,9896
00632R,元大台灣50反1,124,9,115,元大-台南,2023-12-13,9896
2515,中工,110,14,96,元大-台南,2023-12-13,9896
2002,中鋼,80,1,79,元大-台南,2023-12-13,9896
5355,佳總,77,0,77,元大-台南,2023-12-13,9896
2634,漢翔,51,4,47,元大-台南,2023-12-13,9896
00933B,國泰10Y+金融債,41,0,41,元大-台南,2023-12-13,9896
1584,精剛,47,6,41,元大-台南,2023-12-13,9896
5521,工信,52,12,40,元大-台南,2023-12-13,9896
00929,復華台灣科技優息,132,96,36,元大-台南,2023-12-13,9896
00687B,國泰20年美債,33,0,33,元大-台南,2023-12-13,9896
3481,群創,35,5,30,元大-台南,2023-12-13,9896
2419,仲琦,59,32,27,元大-台南,2023-12-13,9896
0050,元大台灣50,33,7,26,元大-台南,2023-12-13,9896
00642U,期元大S＆P石油,26,0,26,元大-台南,2023-12-13,9896
2886,兆豐金,28,3,25,元大-台南,2023-12-13,9896
6187,萬潤,24,1,23,元大-台南,2023-12-13,9896
1514,亞力,150,127,23,元大-台南,2023-12-13,9896
2892,第一金,25,2,23,元大-台南,2023-12-13,9896
9105,泰金寶-DR,22,0,22,元大-台南,2023-12-13,9896
3005,神基,54,33,21,元大-台南,2023-12-13,9896
2882,國泰金,22,1,21,元大-台南,2023-12-13,9896
2332,友訊,21,0,21,元大-台南,2023-12-13,9896
2605,新興,24,4,20,元大-台南,2023-12-13,9896
2201,裕隆,23,4,19,元大-台南,2023-12-13,9896
00637L,元大滬深300正2,24,6,18,元大-台南,2023-12-13,9896
4161,聿新科,18,0,18,元大-台南,2023-12-13,9896
6233,旺玖,22,4,18,元大-台南,2023-12-13,9896
2399,映泰,25,8,17,元大-台南,2023-12-13,9896
00934,中信成長高股息,17,0,17,元大-台南,2023-12-13,9896
4906,正文,30,14,16,元大-台南,2023-12-13,9896
00738U,期元大道瓊白銀,15,0,15,元大-台南,2023-12-13,9896
00896,中信綠能及電動車,15,0,15,元大-台南,2023-12-13,9896
00937B,群益ESG投等債20,15,1,14,元大-台南,2023-12-13,9896
5309,系統電,14,0,14,元大-台南,2023-12-13,9896
2834,臺企銀,17,3,14,元大-台南,2023-12-13,9896
3035,智原,20,6,14,元大-台南,2023-12-13,9896
1608,華榮,14,1,13,元大-台南,2023-12-13,9896
00722B,群益投資級電信債,12,0,12,元大-台南,2023-12-13,9896
00885,富邦越南,12,0,12,元大-台南,2023-12-13,9896
3362,先進光,16,5,11,元大-台南,2023-12-13,9896
00680L,元大美債20正2,14,3,11,元大-台南,2023-12-13,9896
3260,威剛,13,2,11,元大-台南,2023-12-13,9896
3264,欣銓,30,19,11,元大-台南,2023-12-13,9896
6806,森崴能源,10,0,10,元大-台南,2023-12-13,9896
2482,連宇,10,0,10,元大-台南,2023-12-13,9896
1101,台泥,10,0,10,元大-台南,2023-12-13,9896
00688L,國泰20年美債正2,258,0,258,元大-台南,2023-12-14,9896
00918,大華優利高填息30,191,16,175,元大-台南,2023-12-14,9896
00919,群益台灣精選高息,297,160,137,元大-台南,2023-12-14,9896
00680L,元大美債20正2,167,33,134,元大-台南,2023-12-14,9896
2883,凱基金,153,21,132,元大-台南,2023-12-14,9896
00934,中信成長高股息,116,0,116,元大-台南,2023-12-14,9896
3704,合勤控,75,1,74,元大-台南,2023-12-14,9896
00882,中信中國高股息,79,6,73,元大-台南,2023-12-14,9896
00937B,群益ESG投等債20,89,17,72,元大-台南,2023-12-14,9896
00664R,國泰臺灣加權反1,48,0,48,元大-台南,2023-12-14,9896
8011,台通,46,1,45,元大-台南,2023-12-14,9896
00933B,國泰10Y+金融債,43,0,43,元大-台南,2023-12-14,9896
2892,第一金,38,0,38,元大-台南,2023-12-14,9896
00936,台新永續高息中小,38,0,38,元大-台南,2023-12-14,9896
2365,昆盈,103,67,36,元大-台南,2023-12-14,9896
2606,裕民,43,8,35,元大-台南,2023-12-14,9896
00891,中信關鍵半導體,37,2,35,元大-台南,2023-12-14,9896
00687B,國泰20年美債,42,8,34,元大-台南,2023-12-14,9896
2903,遠百,32,0,32,元大-台南,2023-12-14,9896
3338,泰碩,32,0,32,元大-台南,2023-12-14,9896
2387,精元,60,29,31,元大-台南,2023-12-14,9896
00712,復華富時不動產,80,51,29,元大-台南,2023-12-14,9896
2317,鴻海,39,10,29,元大-台南,2023-12-14,9896
5388,中磊,41,13,28,元大-台南,2023-12-14,9896
2401,凌陽,28,0,28,元大-台南,2023-12-14,9896
2329,華泰,97,71,26,元大-台南,2023-12-14,9896
5272,笙科,25,0,25,元大-台南,2023-12-14,9896
8112,至上,37,13,24,元大-台南,2023-12-14,9896
1721,三晃,35,12,23,元大-台南,2023-12-14,9896
00679B,元大美債20年,60,37,23,元大-台南,2023-12-14,9896
00722B,群益投資級電信債,22,1,21,元大-台南,2023-12-14,9896
3231,緯創,56,35,21,元大-台南,2023-12-14,9896
5907,大洋-KY,20,0,20,元大-台南,2023-12-14,9896
6233,旺玖,53,33,20,元大-台南,2023-12-14,9896
2641,正德,20,0,20,元大-台南,2023-12-14,9896
2324,仁寶,29,9,20,元大-台南,2023-12-14,9896
9958,世紀鋼,20,1,19,元大-台南,2023-12-14,9896
5351,鈺創,46,27,19,元大-台南,2023-12-14,9896
00715L,期街口布蘭特正2,50,32,18,元大-台南,2023-12-14,9896
2888,新光金,43,25,18,元大-台南,2023-12-14,9896
2353,宏��,29,11,18,元大-台南,2023-12-14,9896
1513,中興電,23,6,17,元大-台南,2023-12-14,9896
2419,仲琦,30,14,16,元大-台南,2023-12-14,9896
8034,榮群,16,0,16,元大-台南,2023-12-14,9896
8349,�矬�,20,4,16,元大-台南,2023-12-14,9896
4102,永日,15,0,15,元大-台南,2023-12-14,9896
00904,新光臺灣半導體30,15,0,15,元大-台南,2023-12-14,9896
1618,合機,18,4,14,元大-台南,2023-12-14,9896
2731,雄獅,14,0,14,元大-台南,2023-12-14,9896
2303,聯電,41,27,14,元大-台南,2023-12-14,9896
00680L,元大美債20正2,562,195,367,元大-台南,2023-12-15,9896
00937B,群益ESG投等債20,314,10,304,元大-台南,2023-12-15,9896
00918,大華優利高填息30,244,67,177,元大-台南,2023-12-15,9896
2363,矽統,265,92,173,元大-台南,2023-12-15,9896
2427,三商電,160,0,160,元大-台南,2023-12-15,9896
00688L,國泰20年美債正2,105,0,105,元大-台南,2023-12-15,9896
00637L,元大滬深300正2,189,85,104,元大-台南,2023-12-15,9896
00687B,國泰20年美債,103,3,100,元大-台南,2023-12-15,9896
2356,英業達,449,356,93,元大-台南,2023-12-15,9896
1312,國喬,81,0,81,元大-台南,2023-12-15,9896
00720B,元大投資級公司債,92,25,67,元大-台南,2023-12-15,9896
00931B,統一美債20年,62,3,59,元大-台南,2023-12-15,9896
2603,長榮,76,19,57,元大-台南,2023-12-15,9896
9950,萬國通,53,0,53,元大-台南,2023-12-15,9896
5355,佳總,54,12,42,元大-台南,2023-12-15,9896
00885,富邦越南,39,0,39,元大-台南,2023-12-15,9896
00751B,元大AAA至A公司債,37,2,35,元大-台南,2023-12-15,9896
1440,南紡,31,2,29,元大-台南,2023-12-15,9896
2201,裕隆,33,7,26,元大-台南,2023-12-15,9896
4746,台耀,21,1,20,元大-台南,2023-12-15,9896
00933B,國泰10Y+金融債,19,0,19,元大-台南,2023-12-15,9896
3078,僑威,19,0,19,元大-台南,2023-12-15,9896
2884,玉山金,20,2,18,元大-台南,2023-12-15,9896
2358,廷鑫,18,0,18,元大-台南,2023-12-15,9896
2412,中華電,18,1,17,元大-台南,2023-12-15,9896
00935,野村臺灣新科技50,17,0,17,元大-台南,2023-12-15,9896
3231,緯創,43,25,18,元大-台南,2023-12-15,9896
3028,增你強,18,1,17,元大-台南,2023-12-15,9896
3532,台勝科,38,21,17,元大-台南,2023-12-15,9896
1519,華城,18,2,16,元大-台南,2023-12-15,9896
2009,第一銅,16,1,15,元大-台南,2023-12-15,9896
2421,建準,15,0,15,元大-台南,2023-12-15,9896
5905,南仁湖,15,0,15,元大-台南,2023-12-15,9896
2405,輔信,15,0,15,元大-台南,2023-12-15,9896
2352,佳世達,16,2,14,元大-台南,2023-12-15,9896
6257,矽格,26,12,14,元大-台南,2023-12-15,9896
6263,普萊德,18,4,14,元大-台南,2023-12-15,9896
00915,凱基優選高股息30,15,1,14,元大-台南,2023-12-15,9896
3005,神基,15,2,13,元大-台南,2023-12-15,9896
2367,燿華,15,2,13,元大-台南,2023-12-15,9896
3715,定穎投控,32,19,13,元大-台南,2023-12-15,9896
2313,華通,29,16,13,元大-台南,2023-12-15,9896
5009,榮剛,48,35,13,元大-台南,2023-12-15,9896
8088,品安,14,2,12,元大-台南,2023-12-15,9896
3094,聯傑,12,0,12,元大-台南,2023-12-15,9896
6806,森崴能源,12,0,12,元大-台南,2023-12-15,9896
4908,前鼎,11,0,11,元大-台南,2023-12-15,9896
00722B,群益投資級電信債,11,0,11,元大-台南,2023-12-15,9896
5321,美而快,11,0,11,元大-台南,2023-12-15,9896
2641,正德,12,2,10,元大-台南,2023-12-15,9896
00680L,元大美債20正2,311,66,245,元大-台南,2023-12-18,9896
00679B,元大美債20年,203,24,179,元大-台南,2023-12-18,9896
2356,英業達,205,71,134,元大-台南,2023-12-18,9896
00929,復華台灣科技優息,228,106,122,元大-台南,2023-12-18,9896
2032,新鋼,120,1,119,元大-台南,2023-12-18,9896
00676R,富邦臺灣加權反1,100,0,100,元大-台南,2023-12-18,9896
2609,陽明,182,94,88,元大-台南,2023-12-18,9896
00751B,元大AAA至A公司債,80,5,75,元大-台南,2023-12-18,9896
00937B,群益ESG投等債20,96,25,71,元大-台南,2023-12-18,9896
00931B,統一美債20年,71,7,64,元大-台南,2023-12-18,9896
00933B,國泰10Y+金融債,68,5,63,元大-台南,2023-12-18,9896
00897,富邦基因免疫生技,60,1,59,元大-台南,2023-12-18,9896
3532,台勝科,55,5,50,元大-台南,2023-12-18,9896
6182,合晶,55,6,49,元大-台南,2023-12-18,9896
00688L,國泰20年美債正2,78,30,48,元大-台南,2023-12-18,9896
00919,群益台灣精選高息,218,176,42,元大-台南,2023-12-18,9896
00752,中信中國50,40,0,40,元大-台南,2023-12-18,9896
00706L,期元大S＆P日圓正2,51,12,39,元大-台南,2023-12-18,9896
00687B,國泰20年美債,164,133,31,元大-台南,2023-12-18,9896
00712,復華富時不動產,54,23,31,元大-台南,2023-12-18,9896
8112,至上,43,13,30,元大-台南,2023-12-18,9896
6207,雷科,30,0,30,元大-台南,2023-12-18,9896
6668,中揚光,28,0,28,元大-台南,2023-12-18,9896
1319,東陽,26,1,25,元大-台南,2023-12-18,9896
2010,春源,41,20,21,元大-台南,2023-12-18,9896
00882,中信中國高股息,20,0,20,元大-台南,2023-12-18,9896
2020,美亞,21,1,20,元大-台南,2023-12-18,9896
8150,南茂,29,9,20,元大-台南,2023-12-18,9896
4114,健喬,19,0,19,元大-台南,2023-12-18,9896
2014,中鴻,66,48,18,元大-台南,2023-12-18,9896
6282,康舒,18,0,18,元大-台南,2023-12-18,9896
00795B,中信美國公債20年,17,0,17,元大-台南,2023-12-18,9896
3481,群創,48,31,17,元大-台南,2023-12-18,9896
2337,旺宏,21,5,16,元大-台南,2023-12-18,9896
00935,野村臺灣新科技50,16,0,16,元大-台南,2023-12-18,9896
5425,台半,16,1,15,元大-台南,2023-12-18,9896
2897,王道銀行,15,0,15,元大-台南,2023-12-18,9896
1709,和益,15,0,15,元大-台南,2023-12-18,9896
00726B,國泰新興投等債,15,0,15,元大-台南,2023-12-18,9896
2615,萬海,21,6,15,元大-台南,2023-12-18,9896
1618,合機,14,0,14,元大-台南,2023-12-18,9896
2637,慧洋-KY,16,2,14,元大-台南,2023-12-18,9896
2027,大成鋼,35,21,14,元大-台南,2023-12-18,9896
2204,中華,13,0,13,元大-台南,2023-12-18,9896
6127,九豪,15,2,13,元大-台南,2023-12-18,9896
00857B,永豐20年美公債,13,0,13,元大-台南,2023-12-18,9896
2313,華通,29,16,13,元大-台南,2023-12-18,9896
4968,立積,13,0,13,元大-台南,2023-12-18,9896
6191,精成科,19,6,13,元大-台南,2023-12-18,9896
5371,中光電,13,0,13,元大-台南,2023-12-18,9896
2382,廣達,288,9,279,元大-台南,2023-12-19,9896
00680L,元大美債20正2,340,260,80,元大-台南,2023-12-19,9896
00687B,國泰20年美債,125,53,72,元大-台南,2023-12-19,9896
2317,鴻海,79,8,71,元大-台南,2023-12-19,9896
00931B,統一美債20年,69,10,59,元大-台南,2023-12-19,9896
00933B,國泰10Y+金融債,53,0,53,元大-台南,2023-12-19,9896
3694,海華,52,0,52,元大-台南,2023-12-19,9896
00632R,元大台灣50反1,112,60,52,元大-台南,2023-12-19,9896
2033,佳大,44,1,43,元大-台南,2023-12-19,9896
00706L,期元大S＆P日圓正2,54,16,38,元大-台南,2023-12-19,9896
2913,農林,52,16,36,元大-台南,2023-12-19,9896
1522,堤維西,37,1,36,元大-台南,2023-12-19,9896
2323,中環,36,0,36,元大-台南,2023-12-19,9896
2615,萬海,43,11,32,元大-台南,2023-12-19,9896
4770,上品,30,0,30,元大-台南,2023-12-19,9896
00671R,富邦NASDAQ反1,30,0,30,元大-台南,2023-12-19,9896
2356,英業達,104,74,30,元大-台南,2023-12-19,9896
00726B,國泰新興投等債,26,0,26,元大-台南,2023-12-19,9896
1504,東元,22,0,22,元大-台南,2023-12-19,9896
00885,富邦越南,22,0,22,元大-台南,2023-12-19,9896
1718,中纖,23,3,20,元大-台南,2023-12-19,9896
00882,中信中國高股息,19,0,19,元大-台南,2023-12-19,9896
3078,僑威,21,2,19,元大-台南,2023-12-19,9896
6226,光鼎,35,16,19,元大-台南,2023-12-19,9896
5351,鈺創,31,12,19,元大-台南,2023-12-19,9896
2618,長榮航,58,40,18,元大-台南,2023-12-19,9896
00752,中信中國50,20,2,18,元大-台南,2023-12-19,9896
3005,神基,20,2,18,元大-台南,2023-12-19,9896
2352,佳世達,20,3,17,元大-台南,2023-12-19,9896
6191,精成科,32,15,17,元大-台南,2023-12-19,9896
9105,泰金寶-DR,21,5,16,元大-台南,2023-12-19,9896
2882,國泰金,16,1,15,元大-台南,2023-12-19,9896
2606,裕民,16,1,15,元大-台南,2023-12-19,9896
4915,致伸,31,17,14,元大-台南,2023-12-19,9896
1815,富喬,15,1,14,元大-台南,2023-12-19,9896
9907,統一實,14,0,14,元大-台南,2023-12-19,9896
00857B,永豐20年美公債,13,0,13,元大-台南,2023-12-19,9896
2731,雄獅,13,0,13,元大-台南,2023-12-19,9896
9904,寶成,33,20,13,元大-台南,2023-12-19,9896
2201,裕隆,14,2,12,元大-台南,2023-12-19,9896
2344,華邦電,19,7,12,元大-台南,2023-12-19,9896
00679B,元大美債20年,56,44,12,元大-台南,2023-12-19,9896
2324,仁寶,22,10,12,元大-台南,2023-12-19,9896
3715,定穎投控,34,23,11,元大-台南,2023-12-19,9896
00713,元大台灣高息低波,14,3,11,元大-台南,2023-12-19,9896
1609,大亞,21,10,11,元大-台南,2023-12-19,9896
6182,合晶,11,0,11,元大-台南,2023-12-19,9896
2332,友訊,11,0,11,元大-台南,2023-12-19,9896
3596,智易,10,0,10,元大-台南,2023-12-19,9896
2482,連宇,12,2,10,元大-台南,2023-12-19,9896
00934,中信成長高股息,296,3,293,元大-台南,2023-12-20,9896
00929,復華台灣科技優息,346,55,291,元大-台南,2023-12-20,9896
5515,建國,244,1,243,元大-台南,2023-12-20,9896
00680L,元大美債20正2,380,262,118,元大-台南,2023-12-20,9896
00706L,期元大S＆P日圓正2,109,0,109,元大-台南,2023-12-20,9896
1522,堤維西,85,1,84,元大-台南,2023-12-20,9896
00919,群益台灣精選高息,95,19,76,元大-台南,2023-12-20,9896
2880,華南金,71,0,71,元大-台南,2023-12-20,9896
00688L,國泰20年美債正2,65,0,65,元大-台南,2023-12-20,9896
6005,群益證,60,0,60,元大-台南,2023-12-20,9896
2892,第一金,62,8,54,元大-台南,2023-12-20,9896
2891,中信金,42,4,38,元大-台南,2023-12-20,9896
00673R,期元大S＆P原油反1,33,0,33,元大-台南,2023-12-20,9896
2801,彰銀,32,0,32,元大-台南,2023-12-20,9896
2885,元大金,31,0,31,元大-台南,2023-12-20,9896
00933B,國泰10Y+金融債,31,5,26,元大-台南,2023-12-20,9896
2002,中鋼,41,18,23,元大-台南,2023-12-20,9896
5234,達興材料,23,0,23,元大-台南,2023-12-20,9896
2889,國票金,22,0,22,元大-台南,2023-12-20,9896
6245,立端,20,0,20,元大-台南,2023-12-20,9896
00664R,國泰臺灣加權反1,20,0,20,元大-台南,2023-12-20,9896
00712,復華富時不動產,21,2,19,元大-台南,2023-12-20,9896
1733,五鼎,20,2,18,元大-台南,2023-12-20,9896
4770,上品,18,0,18,元大-台南,2023-12-20,9896
6147,頎邦,16,0,16,元大-台南,2023-12-20,9896
8349,�矬�,15,0,15,元大-台南,2023-12-20,9896
1101,台泥,17,2,15,元大-台南,2023-12-20,9896
2201,裕隆,18,4,14,元大-台南,2023-12-20,9896
2314,台揚,15,1,14,元大-台南,2023-12-20,9896
2886,兆豐金,13,0,13,元大-台南,2023-12-20,9896
2388,威盛,18,5,13,元大-台南,2023-12-20,9896
3706,神達,19,7,12,元大-台南,2023-12-20,9896
4167,松瑞藥,74,62,12,元大-台南,2023-12-20,9896
2401,凌陽,13,1,12,元大-台南,2023-12-20,9896
3105,穩懋,12,0,12,元大-台南,2023-12-20,9896
2882,國泰金,16,4,12,元大-台南,2023-12-20,9896
5521,工信,18,7,11,元大-台南,2023-12-20,9896
1905,華紙,16,5,11,元大-台南,2023-12-20,9896
00897,富邦基因免疫生技,11,0,11,元大-台南,2023-12-20,9896
00637L,元大滬深300正2,21,11,10,元大-台南,2023-12-20,9896
6109,亞元,10,0,10,元大-台南,2023-12-20,9896
4160,訊聯基因,10,0,10,元大-台南,2023-12-20,9896
2605,新興,15,5,10,元大-台南,2023-12-20,9896
2023,燁輝,11,1,10,元大-台南,2023-12-20,9896
00726B,國泰新興投等債,10,0,10,元大-台南,2023-12-20,9896
8050,廣積,10,0,10,元大-台南,2023-12-20,9896
8097,常珵,10,0,10,元大-台南,2023-12-20,9896
1707,葡萄王,9,0,9,元大-台南,2023-12-20,9896
3006,晶豪科,10,2,8,元大-台南,2023-12-20,9896
00631L,元大台灣50正2,10,2,8,元大-台南,2023-12-20,9896
00919,群益台灣精選高息,283,26,257,元大-台南,2023-12-21,9896
00929,復華台灣科技優息,179,18,161,元大-台南,2023-12-21,9896
00752,中信中國50,100,0,100,元大-台南,2023-12-21,9896
00632R,元大台灣50反1,100,13,87,元大-台南,2023-12-21,9896
00937B,群益ESG投等債20,73,17,56,元大-台南,2023-12-21,9896
2356,英業達,207,162,45,元大-台南,2023-12-21,9896
2303,聯電,48,5,43,元大-台南,2023-12-21,9896
0056,元大高股息,46,4,42,元大-台南,2023-12-21,9896
4123,晟德,37,1,36,元大-台南,2023-12-21,9896
6005,群益證,30,0,30,元大-台南,2023-12-21,9896
2324,仁寶,115,87,28,元大-台南,2023-12-21,9896
4770,上品,27,0,27,元大-台南,2023-12-21,9896
2014,中鴻,47,21,26,元大-台南,2023-12-21,9896
9105,泰金寶-DR,45,20,25,元大-台南,2023-12-21,9896
2880,華南金,26,2,24,元大-台南,2023-12-21,9896
00712,復華富時不動產,29,5,24,元大-台南,2023-12-21,9896
1314,中石化,35,12,23,元大-台南,2023-12-21,9896
2049,上銀,22,1,21,元大-台南,2023-12-21,9896
8163,達方,21,1,20,元大-台南,2023-12-21,9896
8112,至上,38,18,20,元大-台南,2023-12-21,9896
2886,兆豐金,20,1,19,元大-台南,2023-12-21,9896
00665L,富邦�琤肭磪囓�2,34,16,18,元大-台南,2023-12-21,9896
2353,宏��,71,54,17,元大-台南,2023-12-21,9896
5515,建國,17,1,16,元大-台南,2023-12-21,9896
1732,毛寶,28,12,16,元大-台南,2023-12-21,9896
3035,智原,22,6,16,元大-台南,2023-12-21,9896
2891,中信金,17,2,15,元大-台南,2023-12-21,9896
3694,海華,15,0,15,元大-台南,2023-12-21,9896
8349,�矬�,15,0,15,元大-台南,2023-12-21,9896
8110,華東,21,6,15,元大-台南,2023-12-21,9896
2892,第一金,14,0,14,元大-台南,2023-12-21,9896
4915,致伸,14,0,14,元大-台南,2023-12-21,9896
6443,元晶,15,1,14,元大-台南,2023-12-21,9896
3702,大聯大,97,84,13,元大-台南,2023-12-21,9896
2374,佳能,13,0,13,元大-台南,2023-12-21,9896
2064,晉椿,13,0,13,元大-台南,2023-12-21,9896
2331,精英,18,5,13,元大-台南,2023-12-21,9896
8085,福華,15,2,13,元大-台南,2023-12-21,9896
2454,聯發科,20,8,12,元大-台南,2023-12-21,9896
1102,亞泥,12,0,12,元大-台南,2023-12-21,9896
2002,中鋼,13,1,12,元大-台南,2023-12-21,9896
2369,菱生,12,0,12,元大-台南,2023-12-21,9896
1529,樂事綠能,12,0,12,元大-台南,2023-12-21,9896
3260,威剛,19,7,12,元大-台南,2023-12-21,9896
1319,東陽,13,2,11,元大-台南,2023-12-21,9896
6269,台郡,11,0,11,元大-台南,2023-12-21,9896
00726B,國泰新興投等債,11,0,11,元大-台南,2023-12-21,9896
2606,裕民,23,12,11,元大-台南,2023-12-21,9896
4968,立積,44,33,11,元大-台南,2023-12-21,9896
2382,廣達,76,66,10,元大-台南,2023-12-21,9896
00937B,群益ESG投等債20,344,41,303,元大-台南,2023-12-22,9896
00637L,元大滬深300正2,294,4,290,元大-台南,2023-12-22,9896
00933B,國泰10Y+金融債,158,2,156,元大-台南,2023-12-22,9896
00919,群益台灣精選高息,120,6,114,元大-台南,2023-12-22,9896
9105,泰金寶-DR,120,6,114,元大-台南,2023-12-22,9896
8112,至上,180,79,101,元大-台南,2023-12-22,9896
00719B,元大美債1-3,57,0,57,元大-台南,2023-12-22,9896
2324,仁寶,84,28,56,元大-台南,2023-12-22,9896
3617,碩天,53,3,50,元大-台南,2023-12-22,9896
2609,陽明,344,294,50,元大-台南,2023-12-22,9896
00687B,國泰20年美債,51,2,49,元大-台南,2023-12-22,9896
00929,復華台灣科技優息,69,23,46,元大-台南,2023-12-22,9896
1326,台化,43,0,43,元大-台南,2023-12-22,9896
00720B,元大投資級公司債,53,11,42,元大-台南,2023-12-22,9896
00706L,期元大S＆P日圓正2,37,0,37,元大-台南,2023-12-22,9896
2382,廣達,51,19,32,元大-台南,2023-12-22,9896
2834,臺企銀,30,0,30,元大-台南,2023-12-22,9896
3694,海華,31,2,29,元大-台南,2023-12-22,9896
6443,元晶,28,0,28,元大-台南,2023-12-22,9896
1314,中石化,23,0,23,元大-台南,2023-12-22,9896
6770,力積電,36,13,23,元大-台南,2023-12-22,9896
6207,雷科,22,0,22,元大-台南,2023-12-22,9896
4906,正文,21,0,21,元大-台南,2023-12-22,9896
2457,飛宏,21,0,21,元大-台南,2023-12-22,9896
6005,群益證,20,0,20,元大-台南,2023-12-22,9896
2337,旺宏,25,5,20,元大-台南,2023-12-22,9896
0055,元大MSCI金融,20,0,20,元大-台南,2023-12-22,9896
3013,晟銘電,31,12,19,元大-台南,2023-12-22,9896
2891,中信金,22,5,17,元大-台南,2023-12-22,9896
2313,華通,20,4,16,元大-台南,2023-12-22,9896
2301,光寶科,19,4,15,元大-台南,2023-12-22,9896
9950,萬國通,16,1,15,元大-台南,2023-12-22,9896
4142,國光生,15,0,15,元大-台南,2023-12-22,9896
4123,晟德,13,0,13,元大-台南,2023-12-22,9896
00665L,富邦�琤肭磪囓�2,13,0,13,元大-台南,2023-12-22,9896
5425,台半,13,1,12,元大-台南,2023-12-22,9896
00673R,期元大S＆P原油反1,12,0,12,元大-台南,2023-12-22,9896
2344,華邦電,118,107,11,元大-台南,2023-12-22,9896
4915,致伸,12,1,11,元大-台南,2023-12-22,9896
6214,精誠,11,0,11,元大-台南,2023-12-22,9896
4167,松瑞藥,10,0,10,元大-台南,2023-12-22,9896
4160,訊聯基因,10,0,10,元大-台南,2023-12-22,9896
2489,瑞軒,10,0,10,元大-台南,2023-12-22,9896
2387,精元,35,25,10,元大-台南,2023-12-22,9896
5512,力麒,10,0,10,元大-台南,2023-12-22,9896
00668,國泰美國道瓊,10,0,10,元大-台南,2023-12-22,9896
2515,中工,14,4,10,元大-台南,2023-12-22,9896
3576,聯合再生,10,0,10,元大-台南,2023-12-22,9896
3266,昇陽,10,0,10,元大-台南,2023-12-22,9896
6806,森崴能源,11,1,10,元大-台南,2023-12-22,9896
2324,仁寶,321,37,284,元大-台南,2023-12-25,9896
00919,群益台灣精選高息,184,2,182,元大-台南,2023-12-25,9896
2603,長榮,154,46,108,元大-台南,2023-12-25,9896
2421,建準,130,36,94,元大-台南,2023-12-25,9896
00933B,國泰10Y+金融債,105,15,90,元大-台南,2023-12-25,9896
1605,華新,77,0,77,元大-台南,2023-12-25,9896
2312,金寶,53,2,51,元大-台南,2023-12-25,9896
8088,品安,58,8,50,元大-台南,2023-12-25,9896
00719B,元大美債1-3,48,0,48,元大-台南,2023-12-25,9896
2014,中鴻,48,2,46,元大-台南,2023-12-25,9896
2610,華航,87,44,43,元大-台南,2023-12-25,9896
9904,寶成,35,0,35,元大-台南,2023-12-25,9896
2641,正德,35,3,32,元大-台南,2023-12-25,9896
2002,中鋼,34,3,31,元大-台南,2023-12-25,9896
6523,達爾膚,30,0,30,元大-台南,2023-12-25,9896
00642U,期元大S＆P石油,30,0,30,元大-台南,2023-12-25,9896
00934,中信成長高股息,29,1,28,元大-台南,2023-12-25,9896
9105,泰金寶-DR,30,2,28,元大-台南,2023-12-25,9896
2606,裕民,41,15,26,元大-台南,2023-12-25,9896
6282,康舒,30,7,23,元大-台南,2023-12-25,9896
2344,華邦電,28,5,23,元大-台南,2023-12-25,9896
6117,迎廣,76,54,22,元大-台南,2023-12-25,9896
4906,正文,24,4,20,元大-台南,2023-12-25,9896
4109,加捷生醫,20,0,20,元大-台南,2023-12-25,9896
2605,新興,25,5,20,元大-台南,2023-12-25,9896
4707,磐亞,20,0,20,元大-台南,2023-12-25,9896
2377,微星,27,9,18,元大-台南,2023-12-25,9896
8050,廣積,20,1,19,元大-台南,2023-12-25,9896
1513,中興電,20,2,18,元大-台南,2023-12-25,9896
00897,富邦基因免疫生技,20,3,17,元大-台南,2023-12-25,9896
9950,萬國通,18,2,16,元大-台南,2023-12-25,9896
2352,佳世達,18,2,16,元大-台南,2023-12-25,9896
2365,昆盈,20,4,16,元大-台南,2023-12-25,9896
1514,亞力,17,2,15,元大-台南,2023-12-25,9896
6139,亞翔,19,4,15,元大-台南,2023-12-25,9896
6197,佳必琪,14,0,14,元大-台南,2023-12-25,9896
4123,晟德,14,0,14,元大-台南,2023-12-25,9896
1752,南光,16,2,14,元大-台南,2023-12-25,9896
2368,金像電,15,2,13,元大-台南,2023-12-25,9896
3437,榮創,14,1,13,元大-台南,2023-12-25,9896
1102,亞泥,13,0,13,元大-台南,2023-12-25,9896
4105,東洋,13,0,13,元大-台南,2023-12-25,9896
4909,新復興,13,0,13,元大-台南,2023-12-25,9896
00720B,元大投資級公司債,17,5,12,元大-台南,2023-12-25,9896
6024,群益期,13,1,12,元大-台南,2023-12-25,9896
3081,聯亞,12,0,12,元大-台南,2023-12-25,9896
2331,精英,13,2,11,元大-台南,2023-12-25,9896
00637L,元大滬深300正2,17,6,11,元大-台南,2023-12-25,9896
6214,精誠,10,0,10,元大-台南,2023-12-25,9896
6173,信昌電,10,0,10,元大-台南,2023-12-25,9896
00632R,元大台灣50反1,156,0,156,元大-台南,2023-12-26,9896
00919,群益台灣精選高息,168,18,150,元大-台南,2023-12-26,9896
00929,復華台灣科技優息,103,18,85,元大-台南,2023-12-26,9896
6290,良維,65,4,61,元大-台南,2023-12-26,9896
2883B,凱基金乙特,60,0,60,元大-台南,2023-12-26,9896
2353,宏��,163,108,55,元大-台南,2023-12-26,9896
6241,易通展,54,0,54,元大-台南,2023-12-26,9896
2801,彰銀,49,0,49,元大-台南,2023-12-26,9896
6270,倍微,48,3,45,元大-台南,2023-12-26,9896
00687B,國泰20年美債,39,0,39,元大-台南,2023-12-26,9896
6153,嘉聯益,36,1,35,元大-台南,2023-12-26,9896
00664R,國泰臺灣加權反1,34,0,34,元大-台南,2023-12-26,9896
6117,迎廣,34,3,31,元大-台南,2023-12-26,9896
3078,僑威,36,5,31,元大-台南,2023-12-26,9896
00720B,元大投資級公司債,27,0,27,元大-台南,2023-12-26,9896
2515,中工,32,6,26,元大-台南,2023-12-26,9896
00937B,群益ESG投等債20,95,72,23,元大-台南,2023-12-26,9896
2603,長榮,37,16,21,元大-台南,2023-12-26,9896
00679B,元大美債20年,25,5,20,元大-台南,2023-12-26,9896
00688L,國泰20年美債正2,20,0,20,元大-台南,2023-12-26,9896
00934,中信成長高股息,31,11,20,元大-台南,2023-12-26,9896
8086,宏捷科,19,0,19,元大-台南,2023-12-26,9896
3231,緯創,30,16,14,元大-台南,2023-12-26,9896
00882,中信中國高股息,16,3,13,元大-台南,2023-12-26,9896
00725B,國泰投資級公司債,13,0,13,元大-台南,2023-12-26,9896
00751B,元大AAA至A公司債,13,1,12,元大-台南,2023-12-26,9896
2323,中環,12,0,12,元大-台南,2023-12-26,9896
3264,欣銓,16,4,12,元大-台南,2023-12-26,9896
8426,紅木-KY,10,0,10,元大-台南,2023-12-26,9896
6668,中揚光,10,0,10,元大-台南,2023-12-26,9896
1789,神隆,10,0,10,元大-台南,2023-12-26,9896
00897,富邦基因免疫生技,10,0,10,元大-台南,2023-12-26,9896
00830,國泰費城半導體,10,0,10,元大-台南,2023-12-26,9896
2607,榮運,11,1,10,元大-台南,2023-12-26,9896
8049,晶采,10,0,10,元大-台南,2023-12-26,9896
4915,致伸,10,0,10,元大-台南,2023-12-26,9896
2834,臺企銀,11,2,9,元大-台南,2023-12-26,9896
8028,昇陽半導體,11,2,9,元大-台南,2023-12-26,9896
4906,正文,12,4,8,元大-台南,2023-12-26,9896
2405,輔信,44,37,7,元大-台南,2023-12-26,9896
2107,厚生,7,0,7,元大-台南,2023-12-26,9896
2630,亞航,7,0,7,元大-台南,2023-12-26,9896
2358,廷鑫,7,0,7,元大-台南,2023-12-26,9896
2388,威盛,22,16,6,元大-台南,2023-12-26,9896
2492,華新科,9,3,6,元大-台南,2023-12-26,9896
6176,瑞儀,6,0,6,元大-台南,2023-12-26,9896
2618,長榮航,14,8,6,元大-台南,2023-12-26,9896
8097,常珵,6,0,6,元大-台南,2023-12-26,9896
6243,迅杰,13,7,6,元大-台南,2023-12-26,9896
2204,中華,6,0,6,元大-台南,2023-12-26,9896
00632R,元大台灣50反1,192,5,187,元大-台南,2023-12-27,9896
00929,復華台灣科技優息,196,60,136,元大-台南,2023-12-27,9896
2356,英業達,202,86,116,元大-台南,2023-12-27,9896
00937B,群益ESG投等債20,110,0,110,元大-台南,2023-12-27,9896
2603,長榮,149,53,96,元大-台南,2023-12-27,9896
00673R,期元大S＆P原油反1,84,0,84,元大-台南,2023-12-27,9896
3390,旭軟,93,17,76,元大-台南,2023-12-27,9896
6207,雷科,55,0,55,元大-台南,2023-12-27,9896
00933B,國泰10Y+金融債,42,1,41,元大-台南,2023-12-27,9896
00679B,元大美債20年,47,7,40,元大-台南,2023-12-27,9896
00919,群益台灣精選高息,63,31,32,元大-台南,2023-12-27,9896
00882,中信中國高股息,29,0,29,元大-台南,2023-12-27,9896
9105,泰金寶-DR,39,10,29,元大-台南,2023-12-27,9896
00720B,元大投資級公司債,30,2,28,元大-台南,2023-12-27,9896
1504,東元,27,1,26,元大-台南,2023-12-27,9896
3437,榮創,52,27,25,元大-台南,2023-12-27,9896
00706L,期元大S＆P日圓正2,20,0,20,元大-台南,2023-12-27,9896
00674R,期元大S＆P黃金反1,20,0,20,元大-台南,2023-12-27,9896
5347,世界,49,30,19,元大-台南,2023-12-27,9896
00664R,國泰臺灣加權反1,19,0,19,元大-台南,2023-12-27,9896
00687B,國泰20年美債,49,30,19,元大-台南,2023-12-27,9896
4564,元翎,18,0,18,元大-台南,2023-12-27,9896
2323,中環,31,13,18,元大-台南,2023-12-27,9896
2025,千興,16,0,16,元大-台南,2023-12-27,9896
2349,錸德,15,0,15,元大-台南,2023-12-27,9896
2329,華泰,18,4,14,元大-台南,2023-12-27,9896
2615,萬海,28,15,13,元大-台南,2023-12-27,9896
2362,藍天,14,1,13,元大-台南,2023-12-27,9896
2618,長榮航,25,13,12,元大-台南,2023-12-27,9896
2457,飛宏,13,1,12,元大-台南,2023-12-27,9896
2355,敬鵬,15,4,11,元大-台南,2023-12-27,9896
2204,中華,12,1,11,元大-台南,2023-12-27,9896
3078,僑威,10,0,10,元大-台南,2023-12-27,9896
8936,國統,24,14,10,元大-台南,2023-12-27,9896
9938,百和,10,0,10,元大-台南,2023-12-27,9896
6024,群益期,10,0,10,元大-台南,2023-12-27,9896
4960,誠美材,15,5,10,元大-台南,2023-12-27,9896
2903,遠百,14,4,10,元大-台南,2023-12-27,9896
5011,久陽,10,0,10,元大-台南,2023-12-27,9896
3303,岱稜,12,2,10,元大-台南,2023-12-27,9896
6523,達爾膚,11,1,10,元大-台南,2023-12-27,9896
3017,奇鋐,12,2,10,元大-台南,2023-12-27,9896
8112,至上,98,89,9,元大-台南,2023-12-27,9896
8068,全達,10,1,9,元大-台南,2023-12-27,9896
2405,輔信,89,80,9,元大-台南,2023-12-27,9896
6136,富爾特,9,0,9,元大-台南,2023-12-27,9896
6188,廣明,10,1,9,元大-台南,2023-12-27,9896
3231,緯創,31,22,9,元大-台南,2023-12-27,9896
00708L,期元大S＆P黃金正2,9,0,9,元大-台南,2023-12-27,9896
2374,佳能,10,2,8,元大-台南,2023-12-27,9896
00919,群益台灣精選高息,373,82,291,元大-台南,2023-12-28,9896
00937B,群益ESG投等債20,177,0,177,元大-台南,2023-12-28,9896
00680L,元大美債20正2,144,11,133,元大-台南,2023-12-28,9896
00715L,期街口布蘭特正2,189,62,127,元大-台南,2023-12-28,9896
9945,潤泰新,100,0,100,元大-台南,2023-12-28,9896
00720B,元大投資級公司債,103,19,84,元大-台南,2023-12-28,9896
2324,仁寶,89,51,38,元大-台南,2023-12-28,9896
2356,英業達,255,220,35,元大-台南,2023-12-28,9896
2637,慧洋-KY,34,3,31,元大-台南,2023-12-28,9896
2352,佳世達,30,0,30,元大-台南,2023-12-28,9896
00642U,期元大S＆P石油,33,5,28,元大-台南,2023-12-28,9896
8936,國統,33,9,24,元大-台南,2023-12-28,9896
00637L,元大滬深300正2,26,2,24,元大-台南,2023-12-28,9896
1514,亞力,76,53,23,元大-台南,2023-12-28,9896
5011,久陽,23,0,23,元大-台南,2023-12-28,9896
5351,鈺創,47,25,22,元大-台南,2023-12-28,9896
00933B,國泰10Y+金融債,42,21,21,元大-台南,2023-12-28,9896
3260,威剛,42,21,21,元大-台南,2023-12-28,9896
2365,昆盈,24,4,20,元大-台南,2023-12-28,9896
5515,建國,20,0,20,元大-台南,2023-12-28,9896
2313,華通,20,0,20,元大-台南,2023-12-28,9896
2353,宏��,190,171,19,元大-台南,2023-12-28,9896
1314,中石化,20,2,18,元大-台南,2023-12-28,9896
2025,千興,17,0,17,元大-台南,2023-12-28,9896
00687B,國泰20年美債,17,1,16,元大-台南,2023-12-28,9896
00891,中信關鍵半導體,20,4,16,元大-台南,2023-12-28,9896
4105,東洋,15,0,15,元大-台南,2023-12-28,9896
4123,晟德,15,0,15,元大-台南,2023-12-28,9896
00918,大華優利高填息30,26,12,14,元大-台南,2023-12-28,9896
3390,旭軟,20,6,14,元大-台南,2023-12-28,9896
0056,元大高股息,58,45,13,元大-台南,2023-12-28,9896
1513,中興電,32,19,13,元大-台南,2023-12-28,9896
00725B,國泰投資級公司債,13,0,13,元大-台南,2023-12-28,9896
3006,晶豪科,22,10,12,元大-台南,2023-12-28,9896
3013,晟銘電,23,11,12,元大-台南,2023-12-28,9896
2405,輔信,20,8,12,元大-台南,2023-12-28,9896
2038,海光,14,2,12,元大-台南,2023-12-28,9896
6112,邁達特,11,0,11,元大-台南,2023-12-28,9896
00935,野村臺灣新科技50,22,11,11,元大-台南,2023-12-28,9896
4906,正文,14,3,11,元大-台南,2023-12-28,9896
8215,明基材,11,0,11,元大-台南,2023-12-28,9896
6024,群益期,11,1,10,元大-台南,2023-12-28,9896
6821,聯寶,10,0,10,元大-台南,2023-12-28,9896
1612,宏泰,10,0,10,元大-台南,2023-12-28,9896
00713,元大台灣高息低波,10,1,9,元大-台南,2023-12-28,9896
3231,緯創,47,38,9,元大-台南,2023-12-28,9896
2605,新興,15,6,9,元大-台南,2023-12-28,9896
2489,瑞軒,9,0,9,元大-台南,2023-12-28,9896
3376,新日興,55,47,8,元大-台南,2023-12-28,9896
3707,漢磊,10,2,8,元大-台南,2023-12-28,9896
00688L,國泰20年美債正2,389,45,344,元大-台南,2023-12-29,9896
00937B,群益ESG投等債20,160,0,160,元大-台南,2023-12-29,9896
00919,群益台灣精選高息,127,7,120,元大-台南,2023-12-29,9896
00680L,元大美債20正2,129,18,111,元大-台南,2023-12-29,9896
2324,仁寶,175,65,110,元大-台南,2023-12-29,9896
00637L,元大滬深300正2,79,1,78,元大-台南,2023-12-29,9896
3313,斐成,69,0,69,元大-台南,2023-12-29,9896
6603,富強鑫,66,0,66,元大-台南,2023-12-29,9896
1514,亞力,233,170,63,元大-台南,2023-12-29,9896
2409,友達,104,41,63,元大-台南,2023-12-29,9896
00679B,元大美債20年,72,11,61,元大-台南,2023-12-29,9896
2353,宏��,231,172,59,元大-台南,2023-12-29,9896
2344,華邦電,74,32,42,元大-台南,2023-12-29,9896
00751B,元大AAA至A公司債,37,0,37,元大-台南,2023-12-29,9896
3481,群創,71,36,35,元大-台南,2023-12-29,9896
0056,元大高股息,40,10,30,元大-台南,2023-12-29,9896
3260,威剛,41,13,28,元大-台南,2023-12-29,9896
00878,國泰永續高股息,152,124,28,元大-台南,2023-12-29,9896
2367,燿華,28,0,28,元大-台南,2023-12-29,9896
4123,晟德,28,0,28,元大-台南,2023-12-29,9896
00712,復華富時不動產,27,1,26,元大-台南,2023-12-29,9896
00900,富邦特選高股息30,26,0,26,元大-台南,2023-12-29,9896
1609,大亞,35,10,25,元大-台南,2023-12-29,9896
2323,中環,25,0,25,元大-台南,2023-12-29,9896
00687B,國泰20年美債,26,1,25,元大-台南,2023-12-29,9896
00931B,統一美債20年,24,0,24,元大-台南,2023-12-29,9896
2027,大成鋼,32,10,22,元大-台南,2023-12-29,9896
5521,工信,35,15,20,元大-台南,2023-12-29,9896
9907,統一實,20,0,20,元大-台南,2023-12-29,9896
9950,萬國通,20,0,20,元大-台南,2023-12-29,9896
3413,京鼎,20,2,18,元大-台南,2023-12-29,9896
6125,廣運,49,32,17,元大-台南,2023-12-29,9896
8011,台通,30,13,17,元大-台南,2023-12-29,9896
4174,浩鼎,17,0,17,元大-台南,2023-12-29,9896
3006,晶豪科,32,15,17,元大-台南,2023-12-29,9896
2025,千興,16,0,16,元大-台南,2023-12-29,9896
00935,野村臺灣新科技50,16,0,16,元大-台南,2023-12-29,9896
6290,良維,15,0,15,元大-台南,2023-12-29,9896
2883,凱基金,17,3,14,元大-台南,2023-12-29,9896
2722,夏都,15,1,14,元大-台南,2023-12-29,9896
9912,偉聯,14,0,14,元大-台南,2023-12-29,9896
2303,聯電,25,11,14,元大-台南,2023-12-29,9896
3548,兆利,19,6,13,元大-台南,2023-12-29,9896
2107,厚生,13,0,13,元大-台南,2023-12-29,9896
1314,中石化,14,2,12,元大-台南,2023-12-29,9896
1504,東元,13,1,12,元大-台南,2023-12-29,9896
6187,萬潤,23,12,11,元大-台南,2023-12-29,9896
1513,中興電,16,5,11,元大-台南,2023-12-29,9896
2610,華航,21,10,11,元大-台南,2023-12-29,9896
3081,聯亞,11,0,11,元大-台南,2023-12-29,9896
00680L,元大美債20正2,698,0,698,元大-台南,2024-01-02,9896
00937B,群益ESG投等債20,216,3,213,元大-台南,2024-01-02,9896
00637L,元大滬深300正2,149,5,144,元大-台南,2024-01-02,9896
3231,緯創,111,22,89,元大-台南,2024-01-02,9896
00933B,國泰10Y+金融債,82,0,82,元大-台南,2024-01-02,9896
2356,英業達,83,19,64,元大-台南,2024-01-02,9896
00929,復華台灣科技優息,85,22,63,元大-台南,2024-01-02,9896
2501,國建,50,1,49,元大-台南,2024-01-02,9896
00931B,統一美債20年,44,3,41,元大-台南,2024-01-02,9896
2382,廣達,53,12,41,元大-台南,2024-01-02,9896
5425,台半,34,0,34,元大-台南,2024-01-02,9896
2890,永豐金,35,1,34,元大-台南,2024-01-02,9896
00919,群益台灣精選高息,53,19,34,元大-台南,2024-01-02,9896
2353,宏��,161,129,32,元大-台南,2024-01-02,9896
2344,華邦電,39,7,32,元大-台南,2024-01-02,9896
00715L,期街口布蘭特正2,30,0,30,元大-台南,2024-01-02,9896
5521,工信,54,26,28,元大-台南,2024-01-02,9896
00687B,國泰20年美債,32,5,27,元大-台南,2024-01-02,9896
2365,昆盈,26,0,26,元大-台南,2024-01-02,9896
2605,新興,31,5,26,元大-台南,2024-01-02,9896
2303,聯電,35,12,23,元大-台南,2024-01-02,9896
3706,神達,26,4,22,元大-台南,2024-01-02,9896
2031,新光鋼,21,0,21,元大-台南,2024-01-02,9896
00891,中信關鍵半導體,32,12,20,元大-台南,2024-01-02,9896
00882,中信中國高股息,32,14,18,元大-台南,2024-01-02,9896
2609,陽明,292,275,17,元大-台南,2024-01-02,9896
00650L,復華香港正2,16,0,16,元大-台南,2024-01-02,9896
0056,元大高股息,35,20,15,元大-台南,2024-01-02,9896
6139,亞翔,16,2,14,元大-台南,2024-01-02,9896
00632R,元大台灣50反1,50,36,14,元大-台南,2024-01-02,9896
4967,十銓,13,0,13,元大-台南,2024-01-02,9896
4938,和碩,20,7,13,元大-台南,2024-01-02,9896
6770,力積電,14,2,12,元大-台南,2024-01-02,9896
1905,華紙,12,0,12,元大-台南,2024-01-02,9896
8096,擎亞,13,1,12,元大-台南,2024-01-02,9896
6290,良維,12,0,12,元大-台南,2024-01-02,9896
2615,萬海,39,28,11,元大-台南,2024-01-02,9896
6188,廣明,11,0,11,元大-台南,2024-01-02,9896
2323,中環,11,0,11,元大-台南,2024-01-02,9896
00935,野村臺灣新科技50,10,0,10,元大-台南,2024-01-02,9896
6282,康舒,12,2,10,元大-台南,2024-01-02,9896
8150,南茂,10,0,10,元大-台南,2024-01-02,9896
5011,久陽,10,0,10,元大-台南,2024-01-02,9896
8110,華東,10,0,10,元大-台南,2024-01-02,9896
00751B,元大AAA至A公司債,10,0,10,元大-台南,2024-01-02,9896
2401,凌陽,9,0,9,元大-台南,2024-01-02,9896
2107,厚生,9,0,9,元大-台南,2024-01-02,9896
2331,精英,10,1,9,元大-台南,2024-01-02,9896
2454,聯發科,9,1,8,元大-台南,2024-01-02,9896
2883,凱基金,8,0,8,元大-台南,2024-01-02,9896
2376,技嘉,239,6,233,元大-台南,2024-01-03,9896
00929,復華台灣科技優息,214,70,144,元大-台南,2024-01-03,9896
00937B,群益ESG投等債20,117,1,116,元大-台南,2024-01-03,9896
0056,元大高股息,165,59,106,元大-台南,2024-01-03,9896
00878,國泰永續高股息,114,7,107,元大-台南,2024-01-03,9896
00931B,統一美債20年,104,0,104,元大-台南,2024-01-03,9896
9105,泰金寶-DR,101,2,99,元大-台南,2024-01-03,9896
2618,長榮航,636,548,88,元大-台南,2024-01-03,9896
00919,群益台灣精選高息,106,51,55,元大-台南,2024-01-03,9896
00772B,中信高評級公司債,52,0,52,元大-台南,2024-01-03,9896
2887,台新金,57,7,50,元大-台南,2024-01-03,9896
2303,聯電,59,11,48,元大-台南,2024-01-03,9896
9934,成霖,56,10,46,元大-台南,2024-01-03,9896
00918,大華優利高填息30,46,2,44,元大-台南,2024-01-03,9896
00637L,元大滬深300正2,42,0,42,元大-台南,2024-01-03,9896
2885,元大金,41,0,41,元大-台南,2024-01-03,9896
00882,中信中國高股息,61,25,36,元大-台南,2024-01-03,9896
5426,振發,36,1,35,元大-台南,2024-01-03,9896
2637,慧洋-KY,33,1,32,元大-台南,2024-01-03,9896
00720B,元大投資級公司債,38,6,32,元大-台南,2024-01-03,9896
4142,國光生,31,1,30,元大-台南,2024-01-03,9896
6603,富強鑫,30,0,30,元大-台南,2024-01-03,9896
1326,台化,29,0,29,元大-台南,2024-01-03,9896
2324,仁寶,61,32,29,元大-台南,2024-01-03,9896
00687B,國泰20年美債,29,0,29,元大-台南,2024-01-03,9896
2352,佳世達,30,2,28,元大-台南,2024-01-03,9896
00885,富邦越南,33,5,28,元大-台南,2024-01-03,9896
2486,一詮,48,20,28,元大-台南,2024-01-03,9896
3481,群創,27,0,27,元大-台南,2024-01-03,9896
2002,中鋼,44,17,27,元大-台南,2024-01-03,9896
1605,華新,26,0,26,元大-台南,2024-01-03,9896
2025,千興,26,0,26,元大-台南,2024-01-03,9896
2331,精英,38,13,25,元大-台南,2024-01-03,9896
00642U,期元大S＆P石油,25,0,25,元大-台南,2024-01-03,9896
2886,兆豐金,24,0,24,元大-台南,2024-01-03,9896
2882,國泰金,23,0,23,元大-台南,2024-01-03,9896
00934,中信成長高股息,24,1,23,元大-台南,2024-01-03,9896
2888,新光金,33,11,22,元大-台南,2024-01-03,9896
2501,國建,22,0,22,元大-台南,2024-01-03,9896
1609,大亞,24,4,20,元大-台南,2024-01-03,9896
3211,順達,20,0,20,元大-台南,2024-01-03,9896
6235,華孚,26,6,20,元大-台南,2024-01-03,9896
00715L,期街口布蘭特正2,49,31,18,元大-台南,2024-01-03,9896
2881,富邦金,18,1,17,元大-台南,2024-01-03,9896
1301,台塑,17,0,17,元大-台南,2024-01-03,9896
4167,松瑞藥,29,12,17,元大-台南,2024-01-03,9896
00922,國泰台灣領袖50,17,0,17,元大-台南,2024-01-03,9896
3266,昇陽,17,0,17,元大-台南,2024-01-03,9896
3105,穩懋,17,0,17,元大-台南,2024-01-03,9896
00935,野村臺灣新科技50,16,0,16,元大-台南,2024-01-03,9896
9105,泰金寶-DR,221,0,221,元大-台南,2024-01-04,9896
00637L,元大滬深300正2,140,0,140,元大-台南,2024-01-04,9896
00929,復華台灣科技優息,124,21,103,元大-台南,2024-01-04,9896
1466,聚隆,101,10,91,元大-台南,2024-01-04,9896
00919,群益台灣精選高息,83,11,72,元大-台南,2024-01-04,9896
00937B,群益ESG投等債20,54,0,54,元大-台南,2024-01-04,9896
2367,燿華,52,0,52,元大-台南,2024-01-04,9896
00671R,富邦NASDAQ反1,52,0,52,元大-台南,2024-01-04,9896
8163,達方,51,1,50,元大-台南,2024-01-04,9896
00720B,元大投資級公司債,50,0,50,元大-台南,2024-01-04,9896
00712,復華富時不動產,49,0,49,元大-台南,2024-01-04,9896
00673R,期元大S＆P原油反1,47,0,47,元大-台南,2024-01-04,9896
2801,彰銀,41,0,41,元大-台南,2024-01-04,9896
2312,金寶,40,2,38,元大-台南,2024-01-04,9896
3706,神達,37,3,34,元大-台南,2024-01-04,9896
2443,昶虹,30,0,30,元大-台南,2024-01-04,9896
5905,南仁湖,30,0,30,元大-台南,2024-01-04,9896
2357,華碩,37,8,29,元大-台南,2024-01-04,9896
2303,聯電,30,2,28,元大-台南,2024-01-04,9896
00882,中信中國高股息,28,0,28,元大-台南,2024-01-04,9896
2208,台船,24,0,24,元大-台南,2024-01-04,9896
00878,國泰永續高股息,23,0,23,元大-台南,2024-01-04,9896
3051,力特,25,2,23,元大-台南,2024-01-04,9896
0055,元大MSCI金融,20,0,20,元大-台南,2024-01-04,9896
00751B,元大AAA至A公司債,27,10,17,元大-台南,2024-01-04,9896
2603,長榮,85,68,17,元大-台南,2024-01-04,9896
00687B,國泰20年美債,17,0,17,元大-台南,2024-01-04,9896
9103,美德醫療-DR,16,0,16,元大-台南,2024-01-04,9896
1524,耿鼎,15,0,15,元大-台南,2024-01-04,9896
00933B,國泰10Y+金融債,15,0,15,元大-台南,2024-01-04,9896
8277,商丞,15,0,15,元大-台南,2024-01-04,9896
00927,群益半導體收益,15,0,15,元大-台南,2024-01-04,9896
00935,野村臺灣新科技50,14,0,14,元大-台南,2024-01-04,9896
2025,千興,14,0,14,元大-台南,2024-01-04,9896
00885,富邦越南,23,10,13,元大-台南,2024-01-04,9896
9945,潤泰新,13,0,13,元大-台南,2024-01-04,9896
4973,廣穎,21,8,13,元大-台南,2024-01-04,9896
1326,台化,13,0,13,元大-台南,2024-01-04,9896
4972,湯石照明,13,0,13,元大-台南,2024-01-04,9896
2353,宏��,223,210,13,元大-台南,2024-01-04,9896
9919,康那香,28,16,12,元大-台南,2024-01-04,9896
2356,英業達,61,49,12,元大-台南,2024-01-04,9896
00679B,元大美債20年,14,2,12,元大-台南,2024-01-04,9896
2328,廣宇,11,0,11,元大-台南,2024-01-04,9896
9934,成霖,39,28,11,元大-台南,2024-01-04,9896
2601,益航,11,0,11,元大-台南,2024-01-04,9896
4167,松瑞藥,12,2,10,元大-台南,2024-01-04,9896
9904,寶成,10,0,10,元大-台南,2024-01-04,9896
5522,遠雄,10,0,10,元大-台南,2024-01-04,9896
3078,僑威,36,26,10,元大-台南,2024-01-04,9896
00919,群益台灣精選高息,606,2,604,元大-台南,2024-01-05,9896
00929,復華台灣科技優息,471,0,471,元大-台南,2024-01-05,9896
00934,中信成長高股息,187,0,187,元大-台南,2024-01-05,9896
2501,國建,155,10,145,元大-台南,2024-01-05,9896
00720B,元大投資級公司債,146,5,141,元大-台南,2024-01-05,9896
00712,復華富時不動產,137,0,137,元大-台南,2024-01-05,9896
00706L,期元大S＆P日圓正2,72,0,72,元大-台南,2024-01-05,9896
2344,華邦電,63,4,59,元大-台南,2024-01-05,9896
00770,國泰北美科技,52,0,52,元大-台南,2024-01-05,9896
2618,長榮航,58,8,50,元大-台南,2024-01-05,9896
1326,台化,41,0,41,元大-台南,2024-01-05,9896
2607,榮運,53,14,39,元大-台南,2024-01-05,9896
00893,國泰智能電動車,41,4,37,元大-台南,2024-01-05,9896
2356,英業達,81,47,34,元大-台南,2024-01-05,9896
2382,廣達,61,29,32,元大-台南,2024-01-05,9896
2610,華航,32,4,28,元大-台南,2024-01-05,9896
2025,千興,27,0,27,元大-台南,2024-01-05,9896
2515,中工,26,1,25,元大-台南,2024-01-05,9896
00933B,國泰10Y+金融債,24,0,24,元大-台南,2024-01-05,9896
3576,聯合再生,23,0,23,元大-台南,2024-01-05,9896
1605,華新,23,2,21,元大-台南,2024-01-05,9896
5347,世界,21,0,21,元大-台南,2024-01-05,9896
2357,華碩,21,0,21,元大-台南,2024-01-05,9896
00679B,元大美債20年,55,35,20,元大-台南,2024-01-05,9896
2352,佳世達,31,11,20,元大-台南,2024-01-05,9896
5355,佳總,20,0,20,元大-台南,2024-01-05,9896
00673R,期元大S＆P原油反1,20,0,20,元大-台南,2024-01-05,9896
6603,富強鑫,20,0,20,元大-台南,2024-01-05,9896
1732,毛寶,221,203,18,元大-台南,2024-01-05,9896
0056,元大高股息,33,16,17,元大-台南,2024-01-05,9896
00937B,群益ESG投等債20,96,80,16,元大-台南,2024-01-05,9896
2615,萬海,32,16,16,元大-台南,2024-01-05,9896
4160,訊聯基因,15,0,15,元大-台南,2024-01-05,9896
00918,大華優利高填息30,15,0,15,元大-台南,2024-01-05,9896
9919,康那香,25,10,15,元大-台南,2024-01-05,9896
2027,大成鋼,14,0,14,元大-台南,2024-01-05,9896
00751B,元大AAA至A公司債,32,18,14,元大-台南,2024-01-05,9896
2204,中華,14,0,14,元大-台南,2024-01-05,9896
5905,南仁湖,14,0,14,元大-台南,2024-01-05,9896
3260,威剛,29,16,13,元大-台南,2024-01-05,9896
2101,南港,16,3,13,元大-台南,2024-01-05,9896
8150,南茂,12,0,12,元大-台南,2024-01-05,9896
00927,群益半導體收益,12,0,12,元大-台南,2024-01-05,9896
2332,友訊,12,0,12,元大-台南,2024-01-05,9896
00724B,群益投資級金融債,12,0,12,元大-台南,2024-01-05,9896
4916,事欣科,12,0,12,元大-台南,2024-01-05,9896
5498,凱崴,12,0,12,元大-台南,2024-01-05,9896
5864,致和證,12,0,12,元大-台南,2024-01-05,9896
2457,飛宏,22,11,11,元大-台南,2024-01-05,9896
00881,國泰台灣5G+,16,5,11,元大-台南,2024-01-05,9896
00929,復華台灣科技優息,258,27,231,元大-台南,2024-01-08,9896
00720B,元大投資級公司債,205,29,176,元大-台南,2024-01-08,9896
00919,群益台灣精選高息,106,3,103,元大-台南,2024-01-08,9896
00687B,國泰20年美債,63,2,61,元大-台南,2024-01-08,9896
00632R,元大台灣50反1,126,71,55,元大-台南,2024-01-08,9896
00665L,富邦�琤肭磪囓�2,50,0,50,元大-台南,2024-01-08,9896
00882,中信中國高股息,50,0,50,元大-台南,2024-01-08,9896
00937B,群益ESG投等債20,61,11,50,元大-台南,2024-01-08,9896
6770,力積電,95,47,48,元大-台南,2024-01-08,9896
2388,威盛,56,11,45,元大-台南,2024-01-08,9896
1308,亞聚,45,0,45,元大-台南,2024-01-08,9896
00933B,國泰10Y+金融債,45,1,44,元大-台南,2024-01-08,9896
8163,達方,41,2,39,元大-台南,2024-01-08,9896
00918,大華優利高填息30,38,1,37,元大-台南,2024-01-08,9896
2353,宏��,145,119,26,元大-台南,2024-01-08,9896
2303,聯電,32,8,24,元大-台南,2024-01-08,9896
00675L,富邦臺灣加權正2,24,0,24,元大-台南,2024-01-08,9896
00927,群益半導體收益,24,0,24,元大-台南,2024-01-08,9896
3231,緯創,45,22,23,元大-台南,2024-01-08,9896
6523,達爾膚,21,0,21,元大-台南,2024-01-08,9896
2367,燿華,20,0,20,元大-台南,2024-01-08,9896
6233,旺玖,19,0,19,元大-台南,2024-01-08,9896
2605,新興,21,2,19,元大-台南,2024-01-08,9896
2002,中鋼,20,1,19,元大-台南,2024-01-08,9896
2615,萬海,48,29,19,元大-台南,2024-01-08,9896
3714,富采,28,10,18,元大-台南,2024-01-08,9896
2208,台船,26,9,17,元大-台南,2024-01-08,9896
00637L,元大滬深300正2,17,0,17,元大-台南,2024-01-08,9896
2634,漢翔,20,3,17,元大-台南,2024-01-08,9896
00751B,元大AAA至A公司債,17,0,17,元大-台南,2024-01-08,9896
2025,千興,16,0,16,元大-台南,2024-01-08,9896
8271,宇瞻,16,0,16,元大-台南,2024-01-08,9896
00931B,統一美債20年,15,0,15,元大-台南,2024-01-08,9896
8150,南茂,15,0,15,元大-台南,2024-01-08,9896
0056,元大高股息,29,15,14,元大-台南,2024-01-08,9896
2492,華新科,12,0,12,元大-台南,2024-01-08,9896
3390,旭軟,13,2,11,元大-台南,2024-01-08,9896
6226,光鼎,23,12,11,元大-台南,2024-01-08,9896
6187,萬潤,35,24,11,元大-台南,2024-01-08,9896
8105,凌巨,15,4,11,元大-台南,2024-01-08,9896
6153,嘉聯益,11,0,11,元大-台南,2024-01-08,9896
2382,廣達,13,3,10,元大-台南,2024-01-08,9896
3540,曜越,10,0,10,元大-台南,2024-01-08,9896
2328,廣宇,10,0,10,元大-台南,2024-01-08,9896
4584,君帆,10,0,10,元大-台南,2024-01-08,9896
00650L,復華香港正2,18,8,10,元大-台南,2024-01-08,9896
00688L,國泰20年美債正2,10,0,10,元大-台南,2024-01-08,9896
6024,群益期,10,0,10,元大-台南,2024-01-08,9896
3078,僑威,11,1,10,元大-台南,2024-01-08,9896
2457,飛宏,13,4,9,元大-台南,2024-01-08,9896
2317,鴻海,310,3,307,元大-台南,2024-01-09,9896
00919,群益台灣精選高息,162,22,140,元大-台南,2024-01-09,9896
00680L,元大美債20正2,100,0,100,元大-台南,2024-01-09,9896
0056,元大高股息,104,7,97,元大-台南,2024-01-09,9896
2609,陽明,116,42,74,元大-台南,2024-01-09,9896
1605,華新,47,1,46,元大-台南,2024-01-09,9896
4157,太景*-KY,40,0,40,元大-台南,2024-01-09,9896
1326,台化,40,0,40,元大-台南,2024-01-09,9896
2356,英業達,89,52,37,元大-台南,2024-01-09,9896
2002,中鋼,38,2,36,元大-台南,2024-01-09,9896
2610,華航,49,15,34,元大-台南,2024-01-09,9896
00937B,群益ESG投等債20,35,2,33,元大-台南,2024-01-09,9896
2634,漢翔,46,17,29,元大-台南,2024-01-09,9896
3481,群創,42,14,28,元大-台南,2024-01-09,9896
2382,廣達,65,37,28,元大-台南,2024-01-09,9896
4123,晟德,27,0,27,元大-台南,2024-01-09,9896
6148,驊宏資,22,0,22,元大-台南,2024-01-09,9896
6005,群益證,22,0,22,元大-台南,2024-01-09,9896
2324,仁寶,47,27,20,元大-台南,2024-01-09,9896
00637L,元大滬深300正2,19,0,19,元大-台南,2024-01-09,9896
1504,東元,19,1,18,元大-台南,2024-01-09,9896
00770,國泰北美科技,19,1,18,元大-台南,2024-01-09,9896
2344,華邦電,35,17,18,元大-台南,2024-01-09,9896
00715L,期街口布蘭特正2,28,10,18,元大-台南,2024-01-09,9896
2357,華碩,22,5,17,元大-台南,2024-01-09,9896
2025,千興,17,0,17,元大-台南,2024-01-09,9896
2891,中信金,14,0,14,元大-台南,2024-01-09,9896
3051,力特,18,4,14,元大-台南,2024-01-09,9896
00642U,期元大S＆P石油,13,0,13,元大-台南,2024-01-09,9896
2641,正德,13,0,13,元大-台南,2024-01-09,9896
00927,群益半導體收益,13,0,13,元大-台南,2024-01-09,9896
2017,官田鋼,12,0,12,元大-台南,2024-01-09,9896
2206,三陽工業,12,0,12,元大-台南,2024-01-09,9896
3380,明泰,12,0,12,元大-台南,2024-01-09,9896
00897,富邦基因免疫生技,12,0,12,元大-台南,2024-01-09,9896
00882,中信中國高股息,13,1,12,元大-台南,2024-01-09,9896
6282,康舒,14,3,11,元大-台南,2024-01-09,9896
2329,華泰,22,11,11,元大-台南,2024-01-09,9896
8215,明基材,11,0,11,元大-台南,2024-01-09,9896
3622,洋華,11,0,11,元大-台南,2024-01-09,9896
1301,台塑,15,4,11,元大-台南,2024-01-09,9896
2883,凱基金,11,1,10,元大-台南,2024-01-09,9896
2027,大成鋼,11,1,10,元大-台南,2024-01-09,9896
2890,永豐金,10,0,10,元大-台南,2024-01-09,9896
4979,華星光,11,1,10,元大-台南,2024-01-09,9896
4584,君帆,15,5,10,元大-台南,2024-01-09,9896
1785,光洋科,11,1,10,元大-台南,2024-01-09,9896
6523,達爾膚,10,0,10,元大-台南,2024-01-09,9896
4770,上品,10,0,10,元大-台南,2024-01-09,9896
8049,晶采,10,0,10,元大-台南,2024-01-09,9896
00688L,國泰20年美債正2,307,0,307,元大-台南,2024-01-10,9896
00751B,元大AAA至A公司債,141,1,140,元大-台南,2024-01-10,9896
4129,聯合,126,0,126,元大-台南,2024-01-10,9896
00929,復華台灣科技優息,151,28,123,元大-台南,2024-01-10,9896
2317,鴻海,110,3,107,元大-台南,2024-01-10,9896
2344,華邦電,90,1,89,元大-台南,2024-01-10,9896
00725B,國泰投資級公司債,82,0,82,元大-台南,2024-01-10,9896
1326,台化,61,0,61,元大-台南,2024-01-10,9896
00919,群益台灣精選高息,84,27,57,元大-台南,2024-01-10,9896
2609,陽明,107,50,57,元大-台南,2024-01-10,9896
00720B,元大投資級公司債,53,1,52,元大-台南,2024-01-10,9896
00673R,期元大S＆P原油反1,52,0,52,元大-台南,2024-01-10,9896
00935,野村臺灣新科技50,53,8,45,元大-台南,2024-01-10,9896
2630,亞航,55,16,39,元大-台南,2024-01-10,9896
2353,宏��,86,49,37,元大-台南,2024-01-10,9896
1301,台塑,36,0,36,元大-台南,2024-01-10,9896
2025,千興,36,0,36,元大-台南,2024-01-10,9896
2885,元大金,36,1,35,元大-台南,2024-01-10,9896
2362,藍天,59,26,33,元大-台南,2024-01-10,9896
9105,泰金寶-DR,32,0,32,元大-台南,2024-01-10,9896
00907,永豐優息存股,31,0,31,元大-台南,2024-01-10,9896
2618,長榮航,48,20,28,元大-台南,2024-01-10,9896
2633,台灣高鐵,26,0,26,元大-台南,2024-01-10,9896
2641,正德,27,2,25,元大-台南,2024-01-10,9896
00680L,元大美債20正2,23,0,23,元大-台南,2024-01-10,9896
2382,廣達,31,9,22,元大-台南,2024-01-10,9896
1795,美時,23,1,22,元大-台南,2024-01-10,9896
1314,中石化,22,0,22,元大-台南,2024-01-10,9896
2352,佳世達,30,12,18,元大-台南,2024-01-10,9896
3046,建��,18,0,18,元大-台南,2024-01-10,9896
2363,矽統,29,12,17,元大-台南,2024-01-10,9896
6233,旺玖,18,1,17,元大-台南,2024-01-10,9896
5905,南仁湖,16,0,16,元大-台南,2024-01-10,9896
1608,華榮,16,0,16,元大-台南,2024-01-10,9896
6163,華電網,18,2,16,元大-台南,2024-01-10,9896
5465,富驊,15,0,15,元大-台南,2024-01-10,9896
2303,聯電,24,9,15,元大-台南,2024-01-10,9896
8349,�矬�,15,0,15,元大-台南,2024-01-10,9896
4303,信立,15,0,15,元大-台南,2024-01-10,9896
4973,廣穎,18,3,15,元大-台南,2024-01-10,9896
00665L,富邦�琤肭磪囓�2,14,0,14,元大-台南,2024-01-10,9896
2515,中工,15,1,14,元大-台南,2024-01-10,9896
1605,華新,16,2,14,元大-台南,2024-01-10,9896
2027,大成鋼,21,7,14,元大-台南,2024-01-10,9896
00687B,國泰20年美債,19,5,14,元大-台南,2024-01-10,9896
2324,仁寶,37,23,14,元大-台南,2024-01-10,9896
2610,華航,23,10,13,元大-台南,2024-01-10,9896
00937B,群益ESG投等債20,35,22,13,元大-台南,2024-01-10,9896
1802,台玻,13,0,13,元大-台南,2024-01-10,9896
2883,凱基金,15,2,13,元大-台南,2024-01-10,9896
00929,復華台灣科技優息,128,11,117,元大-台南,2024-01-11,9896
00919,群益台灣精選高息,124,27,97,元大-台南,2024-01-11,9896
00770,國泰北美科技,92,0,92,元大-台南,2024-01-11,9896
00632R,元大台灣50反1,85,2,83,元大-台南,2024-01-11,9896
2344,華邦電,77,3,74,元大-台南,2024-01-11,9896
2025,千興,71,0,71,元大-台南,2024-01-11,9896
5483,中美晶,84,20,64,元大-台南,2024-01-11,9896
2317,鴻海,63,4,59,元大-台南,2024-01-11,9896
1301,台塑,53,5,48,元大-台南,2024-01-11,9896
5355,佳總,51,5,46,元大-台南,2024-01-11,9896
00927,群益半導體收益,43,0,43,元大-台南,2024-01-11,9896
3706,神達,85,48,37,元大-台南,2024-01-11,9896
00882,中信中國高股息,36,0,36,元大-台南,2024-01-11,9896
2883,凱基金,32,1,31,元大-台南,2024-01-11,9896
00680L,元大美債20正2,31,0,31,元大-台南,2024-01-11,9896
2474,可成,30,0,30,元大-台南,2024-01-11,9896
1514,亞力,211,182,29,元大-台南,2024-01-11,9896
4956,光鋐,72,45,27,元大-台南,2024-01-11,9896
2002,中鋼,27,1,26,元大-台南,2024-01-11,9896
2606,裕民,26,0,26,元大-台南,2024-01-11,9896
00715L,期街口布蘭特正2,27,2,25,元大-台南,2024-01-11,9896
3037,欣興,23,0,23,元大-台南,2024-01-11,9896
2409,友達,23,1,22,元大-台南,2024-01-11,9896
3712,永崴投控,22,2,20,元大-台南,2024-01-11,9896
00725B,國泰投資級公司債,20,0,20,元大-台南,2024-01-11,9896
00934,中信成長高股息,21,1,20,元大-台南,2024-01-11,9896
5011,久陽,20,0,20,元大-台南,2024-01-11,9896
00937B,群益ESG投等債20,20,1,19,元大-台南,2024-01-11,9896
2014,中鴻,19,0,19,元大-台南,2024-01-11,9896
2605,新興,25,8,17,元大-台南,2024-01-11,9896
2368,金像電,20,4,16,元大-台南,2024-01-11,9896
00687B,國泰20年美債,15,0,15,元大-台南,2024-01-11,9896
2329,華泰,69,54,15,元大-台南,2024-01-11,9896
2449,京元電子,16,2,14,元大-台南,2024-01-11,9896
0056,元大高股息,19,5,14,元大-台南,2024-01-11,9896
00679B,元大美債20年,23,9,14,元大-台南,2024-01-11,9896
6226,光鼎,28,14,14,元大-台南,2024-01-11,9896
2884,玉山金,15,2,13,元大-台南,2024-01-11,9896
1326,台化,13,0,13,元大-台南,2024-01-11,9896
2618,長榮航,36,23,13,元大-台南,2024-01-11,9896
2324,仁寶,27,15,12,元大-台南,2024-01-11,9896
3380,明泰,17,5,12,元大-台南,2024-01-11,9896
3390,旭軟,13,1,12,元大-台南,2024-01-11,9896
2027,大成鋼,16,4,12,元大-台南,2024-01-11,9896
6625,必應,11,0,11,元大-台南,2024-01-11,9896
3481,群創,25,14,11,元大-台南,2024-01-11,9896
1702,南僑,12,1,11,元大-台南,2024-01-11,9896
00892,富邦台灣半導體,22,11,11,元大-台南,2024-01-11,9896
2356,英業達,44,33,11,元大-台南,2024-01-11,9896
2357,華碩,10,0,10,元大-台南,2024-01-11,9896
00929,復華台灣科技優息,237,21,216,元大-台南,2024-01-12,9896
00637L,元大滬深300正2,104,1,103,元大-台南,2024-01-12,9896
1326,台化,92,0,92,元大-台南,2024-01-12,9896
00673R,期元大S＆P原油反1,66,0,66,元大-台南,2024-01-12,9896
00680L,元大美債20正2,103,40,63,元大-台南,2024-01-12,9896
00919,群益台灣精選高息,117,60,57,元大-台南,2024-01-12,9896
2105,正新,56,0,56,元大-台南,2024-01-12,9896
2317,鴻海,57,2,55,元大-台南,2024-01-12,9896
2474,可成,51,0,51,元大-台南,2024-01-12,9896
00937B,群益ESG投等債20,50,0,50,元大-台南,2024-01-12,9896
2106,建大,50,0,50,元大-台南,2024-01-12,9896
2208,台船,63,15,48,元大-台南,2024-01-12,9896
3706,神達,53,8,45,元大-台南,2024-01-12,9896
2353,宏��,112,70,42,元大-台南,2024-01-12,9896
8096,擎亞,81,40,41,元大-台南,2024-01-12,9896
2412,中華電,40,1,39,元大-台南,2024-01-12,9896
4909,新復興,77,42,35,元大-台南,2024-01-12,9896
8150,南茂,34,0,34,元大-台南,2024-01-12,9896
2888,新光金,58,24,34,元大-台南,2024-01-12,9896
0056,元大高股息,37,4,33,元大-台南,2024-01-12,9896
2329,華泰,65,32,33,元大-台南,2024-01-12,9896
2303,聯電,33,2,31,元大-台南,2024-01-12,9896
00927,群益半導體收益,27,0,27,元大-台南,2024-01-12,9896
2492,華新科,26,0,26,元大-台南,2024-01-12,9896
4129,聯合,26,0,26,元大-台南,2024-01-12,9896
6233,旺玖,22,0,22,元大-台南,2024-01-12,9896
00934,中信成長高股息,22,1,21,元大-台南,2024-01-12,9896
2630,亞航,25,4,21,元大-台南,2024-01-12,9896
00725B,國泰投資級公司債,21,0,21,元大-台南,2024-01-12,9896
2025,千興,20,0,20,元大-台南,2024-01-12,9896
2897,王道銀行,20,0,20,元大-台南,2024-01-12,9896
2887,台新金,20,0,20,元大-台南,2024-01-12,9896
2486,一詮,78,59,19,元大-台南,2024-01-12,9896
8034,榮群,20,2,18,元大-台南,2024-01-12,9896
1609,大亞,17,0,17,元大-台南,2024-01-12,9896
2357,華碩,19,2,17,元大-台南,2024-01-12,9896
00679B,元大美債20年,19,3,16,元大-台南,2024-01-12,9896
8222,寶一,21,5,16,元大-台南,2024-01-12,9896
3024,憶聲,16,0,16,元大-台南,2024-01-12,9896
1736,喬山,15,0,15,元大-台南,2024-01-12,9896
2409,友達,23,8,15,元大-台南,2024-01-12,9896
4934,太極,15,0,15,元大-台南,2024-01-12,9896
6668,中揚光,17,2,15,元大-台南,2024-01-12,9896
3037,欣興,16,1,15,元大-台南,2024-01-12,9896
2449,京元電子,16,2,14,元大-台南,2024-01-12,9896
2365,昆盈,12,0,12,元大-台南,2024-01-12,9896
1432,大魯閣,12,0,12,元大-台南,2024-01-12,9896
2610,華航,24,13,11,元大-台南,2024-01-12,9896
00687B,國泰20年美債,13,2,11,元大-台南,2024-01-12,9896
00738U,期元大道瓊白銀,11,0,11,元大-台南,2024-01-12,9896
00632R,元大台灣50反1,263,3,260,元大-台南,2024-01-15,9896
00937B,群益ESG投等債20,294,40,254,元大-台南,2024-01-15,9896
00929,復華台灣科技優息,233,48,185,元大-台南,2024-01-15,9896
0056,元大高股息,109,23,86,元大-台南,2024-01-15,9896
2603,長榮,103,22,81,元大-台南,2024-01-15,9896
2025,千興,61,0,61,元大-台南,2024-01-15,9896
2317,鴻海,59,0,59,元大-台南,2024-01-15,9896
00687B,國泰20年美債,53,0,53,元大-台南,2024-01-15,9896
3481,群創,58,9,49,元大-台南,2024-01-15,9896
2867,三商壽,48,0,48,元大-台南,2024-01-15,9896
2382,廣達,57,10,47,元大-台南,2024-01-15,9896
00897,富邦基因免疫生技,43,0,43,元大-台南,2024-01-15,9896
2888,新光金,54,18,36,元大-台南,2024-01-15,9896
00933B,國泰10Y+金融債,112,80,32,元大-台南,2024-01-15,9896
6142,友勁,30,0,30,元大-台南,2024-01-15,9896
2449,京元電子,32,3,29,元大-台南,2024-01-15,9896
00725B,國泰投資級公司債,30,5,25,元大-台南,2024-01-15,9896
4909,新復興,32,8,24,元大-台南,2024-01-15,9896
3231,緯創,83,59,24,元大-台南,2024-01-15,9896
00720B,元大投資級公司債,24,0,24,元大-台南,2024-01-15,9896
2634,漢翔,32,9,23,元大-台南,2024-01-15,9896
2388,威盛,33,12,21,元大-台南,2024-01-15,9896
00665L,富邦�琤肭磪囓�2,21,0,21,元大-台南,2024-01-15,9896
3041,揚智,22,2,20,元大-台南,2024-01-15,9896
1784,訊聯,20,0,20,元大-台南,2024-01-15,9896
6733,博晟生醫,20,0,20,元大-台南,2024-01-15,9896
2367,燿華,20,0,20,元大-台南,2024-01-15,9896
2882,國泰金,20,1,19,元大-台南,2024-01-15,9896
6188,廣明,20,1,19,元大-台南,2024-01-15,9896
2356,英業達,42,23,19,元大-台南,2024-01-15,9896
2884,玉山金,16,0,16,元大-台南,2024-01-15,9896
3017,奇鋐,25,10,15,元大-台南,2024-01-15,9896
2731,雄獅,15,0,15,元大-台南,2024-01-15,9896
4157,太景*-KY,15,0,15,元大-台南,2024-01-15,9896
00934,中信成長高股息,14,0,14,元大-台南,2024-01-15,9896
2883,凱基金,15,2,13,元大-台南,2024-01-15,9896
4129,聯合,13,0,13,元大-台南,2024-01-15,9896
00679B,元大美債20年,22,9,13,元大-台南,2024-01-15,9896
2353,宏��,59,47,12,元大-台南,2024-01-15,9896
6125,廣運,24,12,12,元大-台南,2024-01-15,9896
3046,建��,12,0,12,元大-台南,2024-01-15,9896
2312,金寶,12,0,12,元大-台南,2024-01-15,9896
1529,樂事綠能,18,6,12,元大-台南,2024-01-15,9896
2615,萬海,15,3,12,元大-台南,2024-01-15,9896
00763U,期街口道瓊銅,11,0,11,元大-台南,2024-01-15,9896
00770,國泰北美科技,11,0,11,元大-台南,2024-01-15,9896
2630,亞航,19,9,10,元大-台南,2024-01-15,9896
6712,長聖,11,1,10,元大-台南,2024-01-15,9896
00639,富邦深100,10,0,10,元大-台南,2024-01-15,9896
8936,國統,17,7,10,元大-台南,2024-01-15,9896
4906,正文,224,14,210,元大-台南,2024-01-16,9896
00881,國泰台灣5G+,142,0,142,元大-台南,2024-01-16,9896
00929,復華台灣科技優息,147,5,142,元大-台南,2024-01-16,9896
2344,華邦電,117,1,116,元大-台南,2024-01-16,9896
5880,合庫金,119,5,114,元大-台南,2024-01-16,9896
0056,元大高股息,208,99,109,元大-台南,2024-01-16,9896
1718,中纖,70,0,70,元大-台南,2024-01-16,9896
1314,中石化,75,10,65,元大-台南,2024-01-16,9896
00927,群益半導體收益,74,10,64,元大-台南,2024-01-16,9896
2888,新光金,63,7,56,元大-台南,2024-01-16,9896
2401,凌陽,52,5,47,元大-台南,2024-01-16,9896
2002,中鋼,48,3,45,元大-台南,2024-01-16,9896
6695,芯鼎,117,73,44,元大-台南,2024-01-16,9896
2882,國泰金,49,9,40,元大-台南,2024-01-16,9896
00919,群益台灣精選高息,57,17,40,元大-台南,2024-01-16,9896
2412,中華電,40,4,36,元大-台南,2024-01-16,9896
00665L,富邦�琤肭磪囓�2,62,27,35,元大-台南,2024-01-16,9896
8096,擎亞,103,69,34,元大-台南,2024-01-16,9896
2883,凱基金,36,4,32,元大-台南,2024-01-16,9896
1466,聚隆,32,0,32,元大-台南,2024-01-16,9896
1605,華新,30,0,30,元大-台南,2024-01-16,9896
2887,台新金,31,1,30,元大-台南,2024-01-16,9896
00679B,元大美債20年,37,10,27,元大-台南,2024-01-16,9896
1609,大亞,68,41,27,元大-台南,2024-01-16,9896
2474,可成,24,0,24,元大-台南,2024-01-16,9896
2801,彰銀,24,0,24,元大-台南,2024-01-16,9896
2892,第一金,24,0,24,元大-台南,2024-01-16,9896
2731,雄獅,23,0,23,元大-台南,2024-01-16,9896
2881,富邦金,23,0,23,元大-台南,2024-01-16,9896
2880,華南金,23,1,22,元大-台南,2024-01-16,9896
1101,台泥,25,3,22,元大-台南,2024-01-16,9896
1301,台塑,22,1,21,元大-台南,2024-01-16,9896
2331,精英,22,1,21,元大-台南,2024-01-16,9896
2605,新興,21,0,21,元大-台南,2024-01-16,9896
8110,華東,20,0,20,元大-台南,2024-01-16,9896
00687B,國泰20年美債,21,1,20,元大-台南,2024-01-16,9896
1733,五鼎,19,0,19,元大-台南,2024-01-16,9896
1795,美時,27,8,19,元大-台南,2024-01-16,9896
2388,威盛,22,4,18,元大-台南,2024-01-16,9896
6005,群益證,18,0,18,元大-台南,2024-01-16,9896
1326,台化,17,0,17,元大-台南,2024-01-16,9896
00891,中信關鍵半導體,18,1,17,元大-台南,2024-01-16,9896
9945,潤泰新,17,0,17,元大-台南,2024-01-16,9896
00751B,元大AAA至A公司債,17,2,15,元大-台南,2024-01-16,9896
00885,富邦越南,15,0,15,元大-台南,2024-01-16,9896
3025,星通,52,37,15,元大-台南,2024-01-16,9896
00878,國泰永續高股息,20,6,14,元大-台南,2024-01-16,9896
5439,高技,22,8,14,元大-台南,2024-01-16,9896
00680L,元大美債20正2,40,26,14,元大-台南,2024-01-16,9896
00904,新光臺灣半導體30,22,8,14,元大-台南,2024-01-16,9896
00919,群益台灣精選高息,516,51,465,元大-台南,2024-01-17,9896
00929,復華台灣科技優息,426,87,339,元大-台南,2024-01-17,9896
0056,元大高股息,242,33,209,元大-台南,2024-01-17,9896
00882,中信中國高股息,203,15,188,元大-台南,2024-01-17,9896
2317,鴻海,139,8,131,元大-台南,2024-01-17,9896
2303,聯電,118,8,110,元大-台南,2024-01-17,9896
6116,彩晶,108,0,108,元大-台南,2024-01-17,9896
2330,台積電,101,4,97,元大-台南,2024-01-17,9896
2344,華邦電,93,10,83,元大-台南,2024-01-17,9896
00715L,期街口布蘭特正2,80,0,80,元大-台南,2024-01-17,9896
00927,群益半導體收益,77,0,77,元大-台南,2024-01-17,9896
00679B,元大美債20年,79,6,73,元大-台南,2024-01-17,9896
2888,新光金,76,13,63,元大-台南,2024-01-17,9896
00937B,群益ESG投等債20,65,5,60,元大-台南,2024-01-17,9896
2603,長榮,81,22,59,元大-台南,2024-01-17,9896
1802,台玻,56,0,56,元大-台南,2024-01-17,9896
2356,英業達,101,48,53,元大-台南,2024-01-17,9896
6733,博晟生醫,51,0,51,元大-台南,2024-01-17,9896
2883,凱基金,43,1,42,元大-台南,2024-01-17,9896
2412,中華電,43,2,41,元大-台南,2024-01-17,9896
2892,第一金,40,0,40,元大-台南,2024-01-17,9896
6770,力積電,48,10,38,元大-台南,2024-01-17,9896
1440,南紡,53,15,38,元大-台南,2024-01-17,9896
2025,千興,38,0,38,元大-台南,2024-01-17,9896
00881,國泰台灣5G+,35,0,35,元大-台南,2024-01-17,9896
2887,台新金,34,0,34,元大-台南,2024-01-17,9896
2002,中鋼,46,12,34,元大-台南,2024-01-17,9896
1314,中石化,33,1,32,元大-台南,2024-01-17,9896
2886,兆豐金,42,10,32,元大-台南,2024-01-17,9896
2401,凌陽,35,5,30,元大-台南,2024-01-17,9896
3041,揚智,30,0,30,元大-台南,2024-01-17,9896
0050,元大台灣50,30,0,30,元大-台南,2024-01-17,9896
00878,國泰永續高股息,66,37,29,元大-台南,2024-01-17,9896
1718,中纖,35,8,27,元大-台南,2024-01-17,9896
2882,國泰金,38,13,25,元大-台南,2024-01-17,9896
2884,玉山金,25,0,25,元大-台南,2024-01-17,9896
00637L,元大滬深300正2,22,1,21,元大-台南,2024-01-17,9896
00891,中信關鍵半導體,21,0,21,元大-台南,2024-01-17,9896
3049,精金,21,0,21,元大-台南,2024-01-17,9896
2104,國際中橡,21,0,21,元大-台南,2024-01-17,9896
3231,緯創,70,51,19,元大-台南,2024-01-17,9896
00687B,國泰20年美債,20,1,19,元大-台南,2024-01-17,9896
3357,臺慶科,21,2,19,元大-台南,2024-01-17,9896
3044,健鼎,23,5,18,元大-台南,2024-01-17,9896
6530,創威,20,2,18,元大-台南,2024-01-17,9896
2890,永豐金,17,0,17,元大-台南,2024-01-17,9896
00751B,元大AAA至A公司債,18,1,17,元大-台南,2024-01-17,9896
2486,一詮,40,23,17,元大-台南,2024-01-17,9896
4105,東洋,17,0,17,元大-台南,2024-01-17,9896
2208,台船,17,1,16,元大-台南,2024-01-17,9896
00632R,元大台灣50反1,170,33,137,元大-台南,2024-01-18,9896
00929,復華台灣科技優息,385,256,129,元大-台南,2024-01-18,9896
00637L,元大滬深300正2,126,11,115,元大-台南,2024-01-18,9896
4960,誠美材,122,16,106,元大-台南,2024-01-18,9896
2409,友達,215,110,105,元大-台南,2024-01-18,9896
00919,群益台灣精選高息,83,6,77,元大-台南,2024-01-18,9896
0056,元大高股息,60,6,54,元大-台南,2024-01-18,9896
00679B,元大美債20年,54,3,51,元大-台南,2024-01-18,9896
2303,聯電,56,8,48,元大-台南,2024-01-18,9896
2324,仁寶,57,16,41,元大-台南,2024-01-18,9896
5880,合庫金,40,5,35,元大-台南,2024-01-18,9896
2889,國票金,30,0,30,元大-台南,2024-01-18,9896
3532,台勝科,31,1,30,元大-台南,2024-01-18,9896
6120,達運,56,28,28,元大-台南,2024-01-18,9896
00882,中信中國高股息,76,50,26,元大-台南,2024-01-18,9896
00878,國泰永續高股息,29,4,25,元大-台南,2024-01-18,9896
2352,佳世達,27,2,25,元大-台南,2024-01-18,9896
00934,中信成長高股息,24,0,24,元大-台南,2024-01-18,9896
8112,至上,35,13,22,元大-台南,2024-01-18,9896
2610,華航,24,2,22,元大-台南,2024-01-18,9896
2633,台灣高鐵,21,0,21,元大-台南,2024-01-18,9896
2356,英業達,30,11,19,元大-台南,2024-01-18,9896
9950,萬國通,20,1,19,元大-台南,2024-01-18,9896
6770,力積電,18,1,17,元大-台南,2024-01-18,9896
5426,振發,27,10,17,元大-台南,2024-01-18,9896
00897,富邦基因免疫生技,17,0,17,元大-台南,2024-01-18,9896
1434,福懋,16,0,16,元大-台南,2024-01-18,9896
2353,宏��,49,34,15,元大-台南,2024-01-18,9896
3056,富華新,15,0,15,元大-台南,2024-01-18,9896
5488,松普,20,5,15,元大-台南,2024-01-18,9896
00687B,國泰20年美債,17,3,14,元大-台南,2024-01-18,9896
8027,鈦昇,14,1,13,元大-台南,2024-01-18,9896
00665L,富邦�琤肭磪囓�2,43,30,13,元大-台南,2024-01-18,9896
00937B,群益ESG投等債20,14,2,12,元大-台南,2024-01-18,9896
3694,海華,28,16,12,元大-台南,2024-01-18,9896
4979,華星光,17,5,12,元大-台南,2024-01-18,9896
6140,訊達,13,1,12,元大-台南,2024-01-18,9896
2313,華通,21,10,11,元大-台南,2024-01-18,9896
00927,群益半導體收益,11,0,11,元大-台南,2024-01-18,9896
2368,金像電,11,0,11,元大-台南,2024-01-18,9896
00896,中信綠能及電動車,11,0,11,元大-台南,2024-01-18,9896
3260,威剛,15,4,11,元大-台南,2024-01-18,9896
00936,台新永續高息中小,11,0,11,元大-台南,2024-01-18,9896
5213,亞昕,11,0,11,元大-台南,2024-01-18,9896
2511,太子,10,0,10,元大-台南,2024-01-18,9896
00891,中信關鍵半導體,16,6,10,元大-台南,2024-01-18,9896
1314,中石化,10,0,10,元大-台南,2024-01-18,9896
00676R,富邦臺灣加權反1,10,0,10,元大-台南,2024-01-18,9896
2883B,凱基金乙特,10,0,10,元大-台南,2024-01-18,9896
00725B,國泰投資級公司債,10,0,10,元大-台南,2024-01-18,9896
00665L,富邦�琤肭磪囓�2,623,0,623,元大-台南,2024-01-19,9896
00937B,群益ESG投等債20,129,0,129,元大-台南,2024-01-19,9896
2327,國巨,89,0,89,元大-台南,2024-01-19,9896
00679B,元大美債20年,122,40,82,元大-台南,2024-01-19,9896
2025,千興,61,1,60,元大-台南,2024-01-19,9896
00919,群益台灣精選高息,77,17,60,元大-台南,2024-01-19,9896
00931B,統一美債20年,59,0,59,元大-台南,2024-01-19,9896
00706L,期元大S＆P日圓正2,55,0,55,元大-台南,2024-01-19,9896
00687B,國泰20年美債,63,10,53,元大-台南,2024-01-19,9896
2329,華泰,196,144,52,元大-台南,2024-01-19,9896
00882,中信中國高股息,59,15,44,元大-台南,2024-01-19,9896
6770,力積電,54,13,41,元大-台南,2024-01-19,9896
4960,誠美材,50,14,36,元大-台南,2024-01-19,9896
00933B,國泰10Y+金融債,32,0,32,元大-台南,2024-01-19,9896
00673R,期元大S＆P原油反1,32,0,32,元大-台南,2024-01-19,9896
00680L,元大美債20正2,99,68,31,元大-台南,2024-01-19,9896
00720B,元大投資級公司債,48,18,30,元大-台南,2024-01-19,9896
00719B,元大美債1-3,30,0,30,元大-台南,2024-01-19,9896
00858,永豐美國500大,30,0,30,元大-台南,2024-01-19,9896
00772B,中信高評級公司債,26,0,26,元大-台南,2024-01-19,9896
2002,中鋼,24,0,24,元大-台南,2024-01-19,9896
1609,大亞,34,11,23,元大-台南,2024-01-19,9896
00631L,元大台灣50正2,24,2,22,元大-台南,2024-01-19,9896
6120,達運,60,41,19,元大-台南,2024-01-19,9896
3532,台勝科,20,1,19,元大-台南,2024-01-19,9896
2618,長榮航,71,53,18,元大-台南,2024-01-19,9896
2609,陽明,80,63,17,元大-台南,2024-01-19,9896
6241,易通展,17,0,17,元大-台南,2024-01-19,9896
2368,金像電,19,2,17,元大-台南,2024-01-19,9896
00927,群益半導體收益,21,5,16,元大-台南,2024-01-19,9896
00725B,國泰投資級公司債,16,0,16,元大-台南,2024-01-19,9896
2884,玉山金,16,1,15,元大-台南,2024-01-19,9896
2303,聯電,107,92,15,元大-台南,2024-01-19,9896
8112,至上,19,4,15,元大-台南,2024-01-19,9896
1513,中興電,13,0,13,元大-台南,2024-01-19,9896
2461,光群雷,13,1,12,元大-台南,2024-01-19,9896
3013,晟銘電,13,1,12,元大-台南,2024-01-19,9896
00751B,元大AAA至A公司債,16,4,12,元大-台南,2024-01-19,9896
8096,擎亞,26,14,12,元大-台南,2024-01-19,9896
3706,神達,28,17,11,元大-台南,2024-01-19,9896
2886,兆豐金,11,0,11,元大-台南,2024-01-19,9896
00904,新光臺灣半導體30,11,0,11,元大-台南,2024-01-19,9896
2408,南亞科,16,5,11,元大-台南,2024-01-19,9896
2367,燿華,11,0,11,元大-台南,2024-01-19,9896
2889,國票金,11,0,11,元大-台南,2024-01-19,9896
2731,雄獅,13,2,11,元大-台南,2024-01-19,9896
00929,復華台灣科技優息,71,60,11,元大-台南,2024-01-19,9896
6488,環球晶,11,1,10,元大-台南,2024-01-19,9896
9958,世紀鋼,10,0,10,元大-台南,2024-01-19,9896
3357,臺慶科,10,0,10,元大-台南,2024-01-19,9896
3231,緯創,864,522,342,元大-台南,2024-01-22,9896
2892,第一金,150,2,148,元大-台南,2024-01-22,9896
00937B,群益ESG投等債20,96,1,95,元大-台南,2024-01-22,9896
4906,正文,103,14,89,元大-台南,2024-01-22,9896
00687B,國泰20年美債,88,3,85,元大-台南,2024-01-22,9896
00919,群益台灣精選高息,105,39,66,元大-台南,2024-01-22,9896
00882,中信中國高股息,77,11,66,元大-台南,2024-01-22,9896
00679B,元大美債20年,56,3,53,元大-台南,2024-01-22,9896
00632R,元大台灣50反1,53,9,44,元大-台南,2024-01-22,9896
2886,兆豐金,51,11,40,元大-台南,2024-01-22,9896
00733,富邦臺灣中小,40,0,40,元大-台南,2024-01-22,9896
00719B,元大美債1-3,40,0,40,元大-台南,2024-01-22,9896
00933B,國泰10Y+金融債,38,2,36,元大-台南,2024-01-22,9896
1326,台化,37,2,35,元大-台南,2024-01-22,9896
2324,仁寶,80,46,34,元大-台南,2024-01-22,9896
3037,欣興,63,29,34,元大-台南,2024-01-22,9896
2359,所羅門,37,5,32,元大-台南,2024-01-22,9896
2025,千興,28,0,28,元大-台南,2024-01-22,9896
2002,中鋼,27,0,27,元大-台南,2024-01-22,9896
2401,凌陽,29,2,27,元大-台南,2024-01-22,9896
1802,台玻,30,5,25,元大-台南,2024-01-22,9896
5426,振發,27,4,23,元大-台南,2024-01-22,9896
3490,單井,20,0,20,元大-台南,2024-01-22,9896
8930,青鋼,20,0,20,元大-台南,2024-01-22,9896
2887,台新金,20,0,20,元大-台南,2024-01-22,9896
2605,新興,20,1,19,元大-台南,2024-01-22,9896
2884,玉山金,18,0,18,元大-台南,2024-01-22,9896
1514,亞力,31,14,17,元大-台南,2024-01-22,9896
00795B,中信美國公債20年,18,1,17,元大-台南,2024-01-22,9896
1605,華新,22,7,15,元大-台南,2024-01-22,9896
5347,世界,19,4,15,元大-台南,2024-01-22,9896
2329,華泰,155,140,15,元大-台南,2024-01-22,9896
2609,陽明,23,8,15,元大-台南,2024-01-22,9896
2467,志聖,16,2,14,元大-台南,2024-01-22,9896
00720B,元大投資級公司債,14,0,14,元大-台南,2024-01-22,9896
8027,鈦昇,15,1,14,元大-台南,2024-01-22,9896
6139,亞翔,14,0,14,元大-台南,2024-01-22,9896
00712,復華富時不動產,14,0,14,元大-台南,2024-01-22,9896
2316,楠梓電,13,0,13,元大-台南,2024-01-22,9896
2455,全新,15,4,11,元大-台南,2024-01-22,9896
2317,鴻海,13,3,10,元大-台南,2024-01-22,9896
1806,冠軍,10,0,10,元大-台南,2024-01-22,9896
4157,太景*-KY,10,0,10,元大-台南,2024-01-22,9896
00665L,富邦�琤肭磪囓�2,26,16,10,元大-台南,2024-01-22,9896
1314,中石化,9,0,9,元大-台南,2024-01-22,9896
2606,裕民,9,0,9,元大-台南,2024-01-22,9896
3049,精金,55,46,9,元大-台南,2024-01-22,9896
2486,一詮,16,7,9,元大-台南,2024-01-22,9896
2388,威盛,16,7,9,元大-台南,2024-01-22,9896
6024,群益期,9,0,9,元大-台南,2024-01-22,9896
2324,仁寶,226,29,197,元大-台南,2024-01-23,9896
00673R,期元大S＆P原油反1,104,0,104,元大-台南,2024-01-23,9896
5355,佳總,102,13,89,元大-台南,2024-01-23,9896
2356,英業達,200,134,66,元大-台南,2024-01-23,9896
2025,千興,67,2,65,元大-台南,2024-01-23,9896
1409,新纖,60,0,60,元大-台南,2024-01-23,9896
00680L,元大美債20正2,41,0,41,元大-台南,2024-01-23,9896
00632R,元大台灣50反1,39,0,39,元大-台南,2024-01-23,9896
00891,中信關鍵半導體,49,11,38,元大-台南,2024-01-23,9896
2609,陽明,45,13,32,元大-台南,2024-01-23,9896
00679B,元大美債20年,32,1,31,元大-台南,2024-01-23,9896
6113,亞矽,30,0,30,元大-台南,2024-01-23,9896
1795,美時,31,5,26,元大-台南,2024-01-23,9896
00919,群益台灣精選高息,60,35,25,元大-台南,2024-01-23,9896
00937B,群益ESG投等債20,24,2,22,元大-台南,2024-01-23,9896
5210,寶碩,20,0,20,元大-台南,2024-01-23,9896
2401,凌陽,20,0,20,元大-台南,2024-01-23,9896
2887,台新金,16,0,16,元大-台南,2024-01-23,9896
3615,安可,25,9,16,元大-台南,2024-01-23,9896
3622,洋華,15,0,15,元大-台南,2024-01-23,9896
1101,台泥,15,0,15,元大-台南,2024-01-23,9896
6116,彩晶,71,57,14,元大-台南,2024-01-23,9896
2486,一詮,15,2,13,元大-台南,2024-01-23,9896
00720B,元大投資級公司債,13,0,13,元大-台南,2024-01-23,9896
1326,台化,12,0,12,元大-台南,2024-01-23,9896
3380,明泰,15,3,12,元大-台南,2024-01-23,9896
1714,和桐,12,0,12,元大-台南,2024-01-23,9896
2511,太子,11,0,11,元大-台南,2024-01-23,9896
2355,敬鵬,13,2,11,元大-台南,2024-01-23,9896
9951,皇田,16,5,11,元大-台南,2024-01-23,9896
00725B,國泰投資級公司債,11,0,11,元大-台南,2024-01-23,9896
2883,凱基金,18,8,10,元大-台南,2024-01-23,9896
2352,佳世達,13,3,10,元大-台南,2024-01-23,9896
5007,三星,10,0,10,元大-台南,2024-01-23,9896
5234,達興材料,20,10,10,元大-台南,2024-01-23,9896
00830,國泰費城半導體,11,1,10,元大-台南,2024-01-23,9896
4979,華星光,20,10,10,元大-台南,2024-01-23,9896
2610,華航,9,0,9,元大-台南,2024-01-23,9896
1455,集盛,9,0,9,元大-台南,2024-01-23,9896
6223,旺矽,8,1,7,元大-台南,2024-01-23,9896
6789,采鈺,7,0,7,元大-台南,2024-01-23,9896
9927,泰銘,7,0,7,元大-台南,2024-01-23,9896
2634,漢翔,8,1,7,元大-台南,2024-01-23,9896
6187,萬潤,18,12,6,元大-台南,2024-01-23,9896
00751B,元大AAA至A公司債,6,0,6,元大-台南,2024-01-23,9896
2385,群光,6,0,6,元大-台南,2024-01-23,9896
8096,擎亞,42,36,6,元大-台南,2024-01-23,9896
6005,群益證,6,0,6,元大-台南,2024-01-23,9896
1529,樂事綠能,6,0,6,元大-台南,2024-01-23,9896
6179,亞通,6,0,6,元大-台南,2024-01-23,9896
2025,千興,229,0,229,元大-台南,2024-01-24,9896
00937B,群益ESG投等債20,208,0,208,元大-台南,2024-01-24,9896
3623,富晶通,111,13,98,元大-台南,2024-01-24,9896
00679B,元大美債20年,90,6,84,元大-台南,2024-01-24,9896
00891,中信關鍵半導體,35,2,33,元大-台南,2024-01-24,9896
3055,蔚華科,38,7,31,元大-台南,2024-01-24,9896
3532,台勝科,31,0,31,元大-台南,2024-01-24,9896
2356,英業達,94,64,30,元大-台南,2024-01-24,9896
00933B,國泰10Y+金融債,31,1,30,元大-台南,2024-01-24,9896
5210,寶碩,30,0,30,元大-台南,2024-01-24,9896
9904,寶成,30,2,28,元大-台南,2024-01-24,9896
00919,群益台灣精選高息,47,20,27,元大-台南,2024-01-24,9896
3260,威剛,37,11,26,元大-台南,2024-01-24,9896
9939,宏全,26,1,25,元大-台南,2024-01-24,9896
00882,中信中國高股息,23,0,23,元大-台南,2024-01-24,9896
00907,永豐優息存股,23,0,23,元大-台南,2024-01-24,9896
6120,達運,24,1,23,元大-台南,2024-01-24,9896
3712,永崴投控,34,11,23,元大-台南,2024-01-24,9896
2610,華航,37,15,22,元大-台南,2024-01-24,9896
8096,擎亞,61,39,22,元大-台南,2024-01-24,9896
00857B,永豐20年美公債,21,0,21,元大-台南,2024-01-24,9896
3437,榮創,19,0,19,元大-台南,2024-01-24,9896
3037,欣興,21,3,18,元大-台南,2024-01-24,9896
00688L,國泰20年美債正2,18,0,18,元大-台南,2024-01-24,9896
00931B,統一美債20年,18,0,18,元大-台南,2024-01-24,9896
00900,富邦特選高股息30,21,5,16,元大-台南,2024-01-24,9896
8931,大汽電,15,0,15,元大-台南,2024-01-24,9896
00712,復華富時不動產,15,0,15,元大-台南,2024-01-24,9896
2369,菱生,122,109,13,元大-台南,2024-01-24,9896
00772B,中信高評級公司債,13,0,13,元大-台南,2024-01-24,9896
00687B,國泰20年美債,35,22,13,元大-台南,2024-01-24,9896
6179,亞通,13,1,12,元大-台南,2024-01-24,9896
1773,勝一,12,0,12,元大-台南,2024-01-24,9896
00795B,中信美國公債20年,11,0,11,元大-台南,2024-01-24,9896
3059,華晶科,13,2,11,元大-台南,2024-01-24,9896
8936,國統,14,3,11,元大-台南,2024-01-24,9896
4160,訊聯基因,11,0,11,元大-台南,2024-01-24,9896
2312,金寶,15,4,11,元大-台南,2024-01-24,9896
8932,智通*,11,0,11,元大-台南,2024-01-24,9896
2382,廣達,31,20,11,元大-台南,2024-01-24,9896
2014,中鴻,15,5,10,元大-台南,2024-01-24,9896
2402,毅嘉,10,0,10,元大-台南,2024-01-24,9896
2457,飛宏,14,4,10,元大-台南,2024-01-24,9896
4534,慶騰,10,0,10,元大-台南,2024-01-24,9896
2392,正崴,10,0,10,元大-台南,2024-01-24,9896
2421,建準,21,11,10,元大-台南,2024-01-24,9896
5009,榮剛,10,1,9,元大-台南,2024-01-24,9896
3293,鈊象,11,2,9,元大-台南,2024-01-24,9896
00720B,元大投資級公司債,19,10,9,元大-台南,2024-01-24,9896
8046,南電,9,0,9,元大-台南,2024-01-24,9896
00937B,群益ESG投等債20,160,4,156,元大-台南,2024-01-25,9896
00687B,國泰20年美債,128,1,127,元大-台南,2024-01-25,9896
00891,中信關鍵半導體,120,13,107,元大-台南,2024-01-25,9896
00882,中信中國高股息,149,47,102,元大-台南,2024-01-25,9896
00679B,元大美債20年,103,5,98,元大-台南,2024-01-25,9896
00632R,元大台灣50反1,108,20,88,元大-台南,2024-01-25,9896
00637L,元大滬深300正2,88,11,77,元大-台南,2024-01-25,9896
00673R,期元大S＆P原油反1,58,0,58,元大-台南,2024-01-25,9896
00680L,元大美債20正2,165,115,50,元大-台南,2024-01-25,9896
4540,全球傳動,50,0,50,元大-台南,2024-01-25,9896
3481,群創,400,353,47,元大-台南,2024-01-25,9896
2324,仁寶,69,27,42,元大-台南,2024-01-25,9896
2025,千興,35,0,35,元大-台南,2024-01-25,9896
00720B,元大投資級公司債,25,0,25,元大-台南,2024-01-25,9896
00857B,永豐20年美公債,21,0,21,元大-台南,2024-01-25,9896
4909,新復興,66,45,21,元大-台南,2024-01-25,9896
5426,振發,32,11,21,元大-台南,2024-01-25,9896
6156,松上,20,0,20,元大-台南,2024-01-25,9896
1326,台化,20,1,19,元大-台南,2024-01-25,9896
00712,復華富時不動產,19,0,19,元大-台南,2024-01-25,9896
3615,安可,36,17,19,元大-台南,2024-01-25,9896
2609,陽明,22,3,19,元大-台南,2024-01-25,9896
1609,大亞,20,3,17,元大-台南,2024-01-25,9896
00664R,國泰臺灣加權反1,17,0,17,元大-台南,2024-01-25,9896
6155,鈞寶,16,0,16,元大-台南,2024-01-25,9896
2834,臺企銀,15,0,15,元大-台南,2024-01-25,9896
3231,緯創,112,97,15,元大-台南,2024-01-25,9896
3032,偉訓,15,0,15,元大-台南,2024-01-25,9896
4934,太極,15,0,15,元大-台南,2024-01-25,9896
00795B,中信美國公債20年,13,0,13,元大-台南,2024-01-25,9896
2365,昆盈,39,26,13,元大-台南,2024-01-25,9896
00772B,中信高評級公司債,12,0,12,元大-台南,2024-01-25,9896
2382,廣達,23,11,12,元大-台南,2024-01-25,9896
6472,保瑞,15,3,12,元大-台南,2024-01-25,9896
9939,宏全,12,0,12,元大-台南,2024-01-25,9896
1309,台達化,12,0,12,元大-台南,2024-01-25,9896
00688L,國泰20年美債正2,12,0,12,元大-台南,2024-01-25,9896
6799,來頡,15,3,12,元大-台南,2024-01-25,9896
1809,中釉,11,0,11,元大-台南,2024-01-25,9896
9950,萬國通,11,0,11,元大-台南,2024-01-25,9896
00931B,統一美債20年,14,4,10,元大-台南,2024-01-25,9896
3029,零壹,11,1,10,元大-台南,2024-01-25,9896
9951,皇田,10,0,10,元大-台南,2024-01-25,9896
2641,正德,10,0,10,元大-台南,2024-01-25,9896
2399,映泰,11,1,10,元大-台南,2024-01-25,9896
1519,華城,20,10,10,元大-台南,2024-01-25,9896
3047,訊舟,45,35,10,元大-台南,2024-01-25,9896
00751B,元大AAA至A公司債,9,0,9,元大-台南,2024-01-25,9896
1307,三芳,10,1,9,元大-台南,2024-01-25,9896
4123,晟德,9,0,9,元大-台南,2024-01-25,9896
00929,復華台灣科技優息,788,53,735,元大-台南,2024-01-26,9896
00680L,元大美債20正2,641,0,641,元大-台南,2024-01-26,9896
2025,千興,250,8,242,元大-台南,2024-01-26,9896
2303,聯電,158,14,144,元大-台南,2024-01-26,9896
00919,群益台灣精選高息,116,11,105,元大-台南,2024-01-26,9896
00632R,元大台灣50反1,129,45,84,元大-台南,2024-01-26,9896
00673R,期元大S＆P原油反1,84,0,84,元大-台南,2024-01-26,9896
00637L,元大滬深300正2,67,2,65,元大-台南,2024-01-26,9896
2356,英業達,100,56,44,元大-台南,2024-01-26,9896
00687B,國泰20年美債,41,1,40,元大-台南,2024-01-26,9896
2409,友達,173,140,33,元大-台南,2024-01-26,9896
9904,寶成,30,0,30,元大-台南,2024-01-26,9896
2324,仁寶,40,14,26,元大-台南,2024-01-26,9896
2353,宏��,62,37,25,元大-台南,2024-01-26,9896
2369,菱生,25,0,25,元大-台南,2024-01-26,9896
00878,國泰永續高股息,53,29,24,元大-台南,2024-01-26,9896
0056,元大高股息,28,7,21,元大-台南,2024-01-26,9896
6265,方土昶,26,6,20,元大-台南,2024-01-26,9896
4909,新復興,28,8,20,元大-台南,2024-01-26,9896
3694,海華,29,10,19,元大-台南,2024-01-26,9896
5426,振發,46,28,18,元大-台南,2024-01-26,9896
2027,大成鋼,16,0,16,元大-台南,2024-01-26,9896
00918,大華優利高填息30,15,0,15,元大-台南,2024-01-26,9896
1313,聯成,20,5,15,元大-台南,2024-01-26,9896
1326,台化,16,1,15,元大-台南,2024-01-26,9896
1519,華城,51,37,14,元大-台南,2024-01-26,9896
2884,玉山金,13,1,12,元大-台南,2024-01-26,9896
6770,力積電,13,1,12,元大-台南,2024-01-26,9896
6133,金橋,20,8,12,元大-台南,2024-01-26,9896
3623,富晶通,24,12,12,元大-台南,2024-01-26,9896
00664R,國泰臺灣加權反1,12,0,12,元大-台南,2024-01-26,9896
5519,隆大,13,1,12,元大-台南,2024-01-26,9896
00665L,富邦�琤肭磪囓�2,27,15,12,元大-台南,2024-01-26,9896
00937B,群益ESG投等債20,33,22,11,元大-台南,2024-01-26,9896
2313,華通,11,0,11,元大-台南,2024-01-26,9896
1319,東陽,26,15,11,元大-台南,2024-01-26,9896
2618,長榮航,29,19,10,元大-台南,2024-01-26,9896
00830,國泰費城半導體,10,0,10,元大-台南,2024-01-26,9896
3312,弘憶股,14,4,10,元大-台南,2024-01-26,9896
6276,安鈦克,10,0,10,元大-台南,2024-01-26,9896
4906,正文,10,0,10,元大-台南,2024-01-26,9896
00679B,元大美債20年,16,6,10,元大-台南,2024-01-26,9896
3665,貿聯-KY,9,0,9,元大-台南,2024-01-26,9896
3583,辛耘,9,1,8,元大-台南,2024-01-26,9896
5211,蒙恬,8,0,8,元大-台南,2024-01-26,9896
8150,南茂,8,0,8,元大-台南,2024-01-26,9896
6111,大宇資,8,0,8,元大-台南,2024-01-26,9896
5443,均豪,10,2,8,元大-台南,2024-01-26,9896
2344,華邦電,12,5,7,元大-台南,2024-01-26,9896
5347,世界,9,2,7,元大-台南,2024-01-26,9896
00632R,元大台灣50反1,159,0,159,元大-台南,2024-01-29,9896
00673R,期元大S＆P原油反1,126,0,126,元大-台南,2024-01-29,9896
00680L,元大美債20正2,109,3,106,元大-台南,2024-01-29,9896
00687B,國泰20年美債,101,1,100,元大-台南,2024-01-29,9896
2511,太子,100,0,100,元大-台南,2024-01-29,9896
00937B,群益ESG投等債20,85,0,85,元大-台南,2024-01-29,9896
2025,千興,87,4,83,元大-台南,2024-01-29,9896
00720B,元大投資級公司債,59,0,59,元大-台南,2024-01-29,9896
2365,昆盈,76,18,58,元大-台南,2024-01-29,9896
2303,聯電,164,111,53,元大-台南,2024-01-29,9896
2208,台船,50,0,50,元大-台南,2024-01-29,9896
3231,緯創,107,70,37,元大-台南,2024-01-29,9896
00753L,中信中國50正2,35,0,35,元大-台南,2024-01-29,9896
00679B,元大美債20年,37,3,34,元大-台南,2024-01-29,9896
1304,台聚,33,1,32,元大-台南,2024-01-29,9896
2465,麗臺,31,0,31,元大-台南,2024-01-29,9896
2324,仁寶,31,2,29,元大-台南,2024-01-29,9896
2344,華邦電,23,0,23,元大-台南,2024-01-29,9896
2337,旺宏,20,0,20,元大-台南,2024-01-29,9896
00665L,富邦�琤肭磪囓�2,22,3,19,元大-台南,2024-01-29,9896
3605,宏致,35,16,19,元大-台南,2024-01-29,9896
3066,李洲,19,1,18,元大-台南,2024-01-29,9896
3481,群創,142,126,16,元大-台南,2024-01-29,9896
2883,凱基金,16,0,16,元大-台南,2024-01-29,9896
8085,福華,22,7,15,元大-台南,2024-01-29,9896
3218,大學光,15,1,14,元大-台南,2024-01-29,9896
00751B,元大AAA至A公司債,13,0,13,元大-台南,2024-01-29,9896
1313,聯成,21,8,13,元大-台南,2024-01-29,9896
1785,光洋科,18,6,12,元大-台南,2024-01-29,9896
00933B,國泰10Y+金融債,12,0,12,元大-台南,2024-01-29,9896
00919,群益台灣精選高息,17,6,11,元大-台南,2024-01-29,9896
1312,國喬,12,1,11,元大-台南,2024-01-29,9896
00931B,統一美債20年,10,0,10,元大-台南,2024-01-29,9896
2331,精英,10,0,10,元大-台南,2024-01-29,9896
2443,昶虹,10,0,10,元大-台南,2024-01-29,9896
00932,兆豐永續高息等權,10,0,10,元大-台南,2024-01-29,9896
5907,大洋-KY,10,0,10,元大-台南,2024-01-29,9896
8088,品安,10,1,9,元大-台南,2024-01-29,9896
2014,中鴻,10,1,9,元大-台南,2024-01-29,9896
2393,億光,9,0,9,元大-台南,2024-01-29,9896
5706,鳳凰,8,0,8,元大-台南,2024-01-29,9896
8110,華東,11,3,8,元大-台南,2024-01-29,9896
8096,擎亞,63,55,8,元大-台南,2024-01-29,9896
6113,亞矽,16,9,7,元大-台南,2024-01-29,9896
2610,華航,22,15,7,元大-台南,2024-01-29,9896
00752,中信中國50,7,0,7,元大-台南,2024-01-29,9896
6140,訊達,8,1,7,元大-台南,2024-01-29,9896
6133,金橋,33,26,7,元大-台南,2024-01-29,9896
8150,南茂,7,0,7,元大-台南,2024-01-29,9896
6187,萬潤,8,2,6,元大-台南,2024-01-29,9896
2603,長榮,474,12,462,元大-台南,2024-01-30,9896
2025,千興,185,18,167,元大-台南,2024-01-30,9896
00687B,國泰20年美債,133,0,133,元大-台南,2024-01-30,9896
00919,群益台灣精選高息,172,70,102,元大-台南,2024-01-30,9896
00937B,群益ESG投等債20,94,4,90,元大-台南,2024-01-30,9896
4960,誠美材,136,56,80,元大-台南,2024-01-30,9896
9105,泰金寶-DR,66,5,61,元大-台南,2024-01-30,9896
5009,榮剛,56,1,55,元大-台南,2024-01-30,9896
1310,台苯,50,0,50,元大-台南,2024-01-30,9896
00637L,元大滬深300正2,37,0,37,元大-台南,2024-01-30,9896
6120,達運,36,0,36,元大-台南,2024-01-30,9896
00680L,元大美債20正2,34,1,33,元大-台南,2024-01-30,9896
00933B,國泰10Y+金融債,28,0,28,元大-台南,2024-01-30,9896
2886,兆豐金,28,0,28,元大-台南,2024-01-30,9896
00882,中信中國高股息,28,1,27,元大-台南,2024-01-30,9896
00753L,中信中國50正2,27,0,27,元大-台南,2024-01-30,9896
2337,旺宏,29,4,25,元大-台南,2024-01-30,9896
2344,華邦電,36,11,25,元大-台南,2024-01-30,9896
3481,群創,103,78,25,元大-台南,2024-01-30,9896
2887,台新金,22,0,22,元大-台南,2024-01-30,9896
2412,中華電,21,0,21,元大-台南,2024-01-30,9896
2421,建準,53,32,21,元大-台南,2024-01-30,9896
3715,定穎投控,67,47,20,元大-台南,2024-01-30,9896
8071,能率網通,20,0,20,元大-台南,2024-01-30,9896
00918,大華優利高填息30,20,0,20,元大-台南,2024-01-30,9896
2409,友達,20,1,19,元大-台南,2024-01-30,9896
00719B,元大美債1-3,17,0,17,元大-台南,2024-01-30,9896
6465,威潤,17,0,17,元大-台南,2024-01-30,9896
8064,東捷,86,69,17,元大-台南,2024-01-30,9896
2867,三商壽,16,0,16,元大-台南,2024-01-30,9896
00665L,富邦�琤肭磪囓�2,20,4,16,元大-台南,2024-01-30,9896
00679B,元大美債20年,17,4,13,元大-台南,2024-01-30,9896
2324,仁寶,13,0,13,元大-台南,2024-01-30,9896
4714,永捷,13,0,13,元大-台南,2024-01-30,9896
00751B,元大AAA至A公司債,13,0,13,元大-台南,2024-01-30,9896
5871,中租-KY,14,1,13,元大-台南,2024-01-30,9896
1605,華新,24,12,12,元大-台南,2024-01-30,9896
6140,訊達,12,0,12,元大-台南,2024-01-30,9896
2308,台達電,11,0,11,元大-台南,2024-01-30,9896
4123,晟德,11,0,11,元大-台南,2024-01-30,9896
2486,一詮,20,9,11,元大-台南,2024-01-30,9896
9921,巨大,10,0,10,元大-台南,2024-01-30,9896
00700,富邦�琤肭磪�,10,0,10,元大-台南,2024-01-30,9896
6155,鈞寶,10,0,10,元大-台南,2024-01-30,9896
00877,復華中國5G,10,0,10,元大-台南,2024-01-30,9896
2354,鴻準,10,0,10,元大-台南,2024-01-30,9896
5351,鈺創,11,1,10,元大-台南,2024-01-30,9896
6168,宏齊,10,0,10,元大-台南,2024-01-30,9896
00752,中信中國50,10,0,10,元大-台南,2024-01-30,9896
00720B,元大投資級公司債,9,0,9,元大-台南,2024-01-30,9896
2025,千興,229,9,220,元大-台南,2024-01-31,9896
4960,誠美材,137,25,112,元大-台南,2024-01-31,9896
00937B,群益ESG投等債20,129,22,107,元大-台南,2024-01-31,9896
00673R,期元大S＆P原油反1,82,0,82,元大-台南,2024-01-31,9896
3481,群創,133,63,70,元大-台南,2024-01-31,9896
1303,南亞,47,0,47,元大-台南,2024-01-31,9896
00687B,國泰20年美債,47,3,44,元大-台南,2024-01-31,9896
00882,中信中國高股息,45,2,43,元大-台南,2024-01-31,9896
00637L,元大滬深300正2,40,3,37,元大-台南,2024-01-31,9896
2303,聯電,40,4,36,元大-台南,2024-01-31,9896
2383,台光電,39,3,36,元大-台南,2024-01-31,9896
6270,倍微,39,7,32,元大-台南,2024-01-31,9896
00929,復華台灣科技優息,35,4,31,元大-台南,2024-01-31,9896
0056,元大高股息,36,5,31,元大-台南,2024-01-31,9896
3694,海華,67,37,30,元大-台南,2024-01-31,9896
9904,寶成,30,0,30,元大-台南,2024-01-31,9896
00753L,中信中國50正2,26,0,26,元大-台南,2024-01-31,9896
00722B,群益投資級電信債,25,0,25,元大-台南,2024-01-31,9896
2465,麗臺,32,10,22,元大-台南,2024-01-31,9896
00919,群益台灣精選高息,27,6,21,元大-台南,2024-01-31,9896
2609,陽明,25,4,21,元大-台南,2024-01-31,9896
00897,富邦基因免疫生技,20,0,20,元大-台南,2024-01-31,9896
2405,輔信,20,0,20,元大-台南,2024-01-31,9896
2412,中華電,20,2,18,元大-台南,2024-01-31,9896
2002,中鋼,17,0,17,元大-台南,2024-01-31,9896
2356,英業達,59,42,17,元大-台南,2024-01-31,9896
00878,國泰永續高股息,32,16,16,元大-台南,2024-01-31,9896
2409,友達,30,14,16,元大-台南,2024-01-31,9896
2618,長榮航,17,1,16,元大-台南,2024-01-31,9896
2329,華泰,40,25,15,元大-台南,2024-01-31,9896
00877,復華中國5G,15,0,15,元大-台南,2024-01-31,9896
3059,華晶科,15,1,14,元大-台南,2024-01-31,9896
00935,野村臺灣新科技50,14,0,14,元大-台南,2024-01-31,9896
3715,定穎投控,30,16,14,元大-台南,2024-01-31,9896
2353,宏��,33,19,14,元大-台南,2024-01-31,9896
2330,台積電,21,9,12,元大-台南,2024-01-31,9896
00830,國泰費城半導體,12,0,12,元大-台南,2024-01-31,9896
00665L,富邦�琤肭磪囓�2,12,0,12,元大-台南,2024-01-31,9896
3081,聯亞,15,3,12,元大-台南,2024-01-31,9896
00931B,統一美債20年,16,4,12,元大-台南,2024-01-31,9896
5426,振發,26,14,12,元大-台南,2024-01-31,9896
9945,潤泰新,11,0,11,元大-台南,2024-01-31,9896
1718,中纖,11,0,11,元大-台南,2024-01-31,9896
00720B,元大投資級公司債,13,2,11,元大-台南,2024-01-31,9896
1513,中興電,11,1,10,元大-台南,2024-01-31,9896
3051,力特,10,0,10,元大-台南,2024-01-31,9896
2328,廣宇,10,0,10,元大-台南,2024-01-31,9896
9939,宏全,10,0,10,元大-台南,2024-01-31,9896
4934,太極,10,0,10,元大-台南,2024-01-31,9896
5328,華容,10,0,10,元大-台南,2024-01-31,9896
00632R,元大台灣50反1,142,16,126,元大-台南,2024-02-01,9896
00929,復華台灣科技優息,117,4,113,元大-台南,2024-02-01,9896
3481,群創,199,91,108,元大-台南,2024-02-01,9896
2409,友達,112,21,91,元大-台南,2024-02-01,9896
00882,中信中國高股息,63,0,63,元大-台南,2024-02-01,9896
00712,復華富時不動產,52,1,51,元大-台南,2024-02-01,9896
5512,力麒,60,9,51,元大-台南,2024-02-01,9896
00647L,元大S＆P500正2,50,0,50,元大-台南,2024-02-01,9896
00919,群益台灣精選高息,41,2,39,元大-台南,2024-02-01,9896
00878,國泰永續高股息,60,23,37,元大-台南,2024-02-01,9896
00679B,元大美債20年,52,20,32,元大-台南,2024-02-01,9896
3176,基亞,30,1,29,元大-台南,2024-02-01,9896
2365,昆盈,47,19,28,元大-台南,2024-02-01,9896
1102,亞泥,27,0,27,元大-台南,2024-02-01,9896
3312,弘憶股,32,6,26,元大-台南,2024-02-01,9896
2845,遠東銀,24,0,24,元大-台南,2024-02-01,9896
8011,台通,32,11,21,元大-台南,2024-02-01,9896
6265,方土昶,45,25,20,元大-台南,2024-02-01,9896
6120,達運,20,0,20,元大-台南,2024-02-01,9896
1609,大亞,19,0,19,元大-台南,2024-02-01,9896
2014,中鴻,20,1,19,元大-台南,2024-02-01,9896
2303,聯電,42,25,17,元大-台南,2024-02-01,9896
4714,永捷,17,0,17,元大-台南,2024-02-01,9896
6140,訊達,17,0,17,元大-台南,2024-02-01,9896
6179,亞通,16,0,16,元大-台南,2024-02-01,9896
6770,力積電,15,0,15,元大-台南,2024-02-01,9896
3548,兆利,24,10,14,元大-台南,2024-02-01,9896
3712,永崴投控,14,0,14,元大-台南,2024-02-01,9896
3041,揚智,18,4,14,元大-台南,2024-02-01,9896
3437,榮創,15,2,13,元大-台南,2024-02-01,9896
2883,凱基金,14,1,13,元大-台南,2024-02-01,9896
2454,聯發科,15,2,13,元大-台南,2024-02-01,9896
00937B,群益ESG投等債20,47,35,12,元大-台南,2024-02-01,9896
8096,擎亞,14,3,11,元大-台南,2024-02-01,9896
00900,富邦特選高股息30,11,0,11,元大-台南,2024-02-01,9896
2344,華邦電,11,1,10,元大-台南,2024-02-01,9896
006205,富邦上証,10,0,10,元大-台南,2024-02-01,9896
2606,裕民,11,1,10,元大-台南,2024-02-01,9896
00877,復華中國5G,10,0,10,元大-台南,2024-02-01,9896
1532,勤美,10,0,10,元大-台南,2024-02-01,9896
3694,海華,31,22,9,元大-台南,2024-02-01,9896
00885,富邦越南,9,0,9,元大-台南,2024-02-01,9896
2356,英業達,52,43,9,元大-台南,2024-02-01,9896
8150,南茂,8,0,8,元大-台南,2024-02-01,9896
2610,華航,15,7,8,元大-台南,2024-02-01,9896
2367,燿華,8,0,8,元大-台南,2024-02-01,9896
6244,茂迪,10,2,8,元大-台南,2024-02-01,9896
9933,中鼎,8,0,8,元大-台南,2024-02-01,9896
6139,亞翔,12,5,7,元大-台南,2024-02-01,9896
1319,東陽,9,2,7,元大-台南,2024-02-01,9896
00937B,群益ESG投等債20,482,0,482,元大-台南,2024-02-02,9896
2025,千興,100,2,98,元大-台南,2024-02-02,9896
00929,復華台灣科技優息,83,2,81,元大-台南,2024-02-02,9896
00712,復華富時不動產,76,0,76,元大-台南,2024-02-02,9896
2303,聯電,64,1,63,元大-台南,2024-02-02,9896
00715L,期街口布蘭特正2,50,0,50,元大-台南,2024-02-02,9896
00891,中信關鍵半導體,50,0,50,元大-台南,2024-02-02,9896
1528,恩德,58,20,38,元大-台南,2024-02-02,9896
6113,亞矽,44,11,33,元大-台南,2024-02-02,9896
3402,漢科,32,0,32,元大-台南,2024-02-02,9896
00679B,元大美債20年,85,55,30,元大-台南,2024-02-02,9896
00680L,元大美債20正2,70,40,30,元大-台南,2024-02-02,9896
4171,瑞基,29,0,29,元大-台南,2024-02-02,9896
00637L,元大滬深300正2,28,0,28,元大-台南,2024-02-02,9896
00919,群益台灣精選高息,48,20,28,元大-台南,2024-02-02,9896
3036,文曄,101,77,24,元大-台南,2024-02-02,9896
1795,美時,24,1,23,元大-台南,2024-02-02,9896
2388,威盛,35,13,22,元大-台南,2024-02-02,9896
1536,和大,21,0,21,元大-台南,2024-02-02,9896
3264,欣銓,21,0,21,元大-台南,2024-02-02,9896
2845,遠東銀,21,0,21,元大-台南,2024-02-02,9896
8011,台通,20,0,20,元大-台南,2024-02-02,9896
00795B,中信美國公債20年,20,0,20,元大-台南,2024-02-02,9896
2603,長榮,21,3,18,元大-台南,2024-02-02,9896
1514,亞力,25,7,18,元大-台南,2024-02-02,9896
2409,友達,28,10,18,元大-台南,2024-02-02,9896
1310,台苯,15,0,15,元大-台南,2024-02-02,9896
6243,迅杰,33,18,15,元大-台南,2024-02-02,9896
4714,永捷,15,1,14,元大-台南,2024-02-02,9896
2337,旺宏,14,0,14,元大-台南,2024-02-02,9896
3312,弘憶股,15,2,13,元大-台南,2024-02-02,9896
3694,海華,19,6,13,元大-台南,2024-02-02,9896
00918,大華優利高填息30,13,0,13,元大-台南,2024-02-02,9896
2313,華通,26,14,12,元大-台南,2024-02-02,9896
2801,彰銀,14,2,12,元大-台南,2024-02-02,9896
00720B,元大投資級公司債,12,0,12,元大-台南,2024-02-02,9896
2834,臺企銀,12,0,12,元大-台南,2024-02-02,9896
2615,萬海,11,0,11,元大-台南,2024-02-02,9896
1319,東陽,15,4,11,元大-台南,2024-02-02,9896
1314,中石化,11,0,11,元大-台南,2024-02-02,9896
2883,凱基金,11,0,11,元大-台南,2024-02-02,9896
2385,群光,12,1,11,元大-台南,2024-02-02,9896
2885,元大金,11,0,11,元大-台南,2024-02-02,9896
2368,金像電,17,7,10,元大-台南,2024-02-02,9896
00642U,期元大S＆P石油,10,0,10,元大-台南,2024-02-02,9896
6155,鈞寶,10,0,10,元大-台南,2024-02-02,9896
2731,雄獅,10,0,10,元大-台南,2024-02-02,9896
2374,佳能,13,3,10,元大-台南,2024-02-02,9896
6462,神盾,11,1,10,元大-台南,2024-02-02,9896
1718,中纖,10,0,10,元大-台南,2024-02-02,9896
2025,千興,661,5,656,元大-台南,2024-02-05,9896
00688L,國泰20年美債正2,404,60,344,元大-台南,2024-02-05,9896
00665L,富邦�琤肭磪囓�2,300,26,274,元大-台南,2024-02-05,9896
00687B,國泰20年美債,191,20,171,元大-台南,2024-02-05,9896
00929,復華台灣科技優息,141,24,117,元大-台南,2024-02-05,9896
00671R,富邦NASDAQ反1,102,0,102,元大-台南,2024-02-05,9896
4960,誠美材,100,0,100,元大-台南,2024-02-05,9896
3346,麗清,101,2,99,元大-台南,2024-02-05,9896
00937B,群益ESG投等債20,148,50,98,元大-台南,2024-02-05,9896
00679B,元大美債20年,81,5,76,元大-台南,2024-02-05,9896
2356,英業達,141,68,73,元大-台南,2024-02-05,9896
5355,佳總,72,4,68,元大-台南,2024-02-05,9896
00715L,期街口布蘭特正2,71,6,65,元大-台南,2024-02-05,9896
2889,國票金,63,5,58,元大-台南,2024-02-05,9896
2421,建準,129,73,56,元大-台南,2024-02-05,9896
1102,亞泥,52,0,52,元大-台南,2024-02-05,9896
00751B,元大AAA至A公司債,52,0,52,元大-台南,2024-02-05,9896
00931B,統一美債20年,50,0,50,元大-台南,2024-02-05,9896
00706L,期元大S＆P日圓正2,50,0,50,元大-台南,2024-02-05,9896
1718,中纖,59,10,49,元大-台南,2024-02-05,9896
00919,群益台灣精選高息,54,9,45,元大-台南,2024-02-05,9896
00770,國泰北美科技,45,3,42,元大-台南,2024-02-05,9896
2884,玉山金,39,0,39,元大-台南,2024-02-05,9896
00680L,元大美債20正2,119,87,32,元大-台南,2024-02-05,9896
00891,中信關鍵半導體,32,0,32,元大-台南,2024-02-05,9896
00712,復華富時不動產,32,1,31,元大-台南,2024-02-05,9896
2329,華泰,50,20,30,元大-台南,2024-02-05,9896
00720B,元大投資級公司債,32,3,29,元大-台南,2024-02-05,9896
3530,晶相光,35,7,28,元大-台南,2024-02-05,9896
00900,富邦特選高股息30,28,0,28,元大-台南,2024-02-05,9896
6133,金橋,74,48,26,元大-台南,2024-02-05,9896
00642U,期元大S＆P石油,24,0,24,元大-台南,2024-02-05,9896
2888,新光金,48,26,22,元大-台南,2024-02-05,9896
00882,中信中國高股息,31,10,21,元大-台南,2024-02-05,9896
2883,凱基金,24,4,20,元大-台南,2024-02-05,9896
2886,兆豐金,21,2,19,元大-台南,2024-02-05,9896
2880,華南金,32,13,19,元大-台南,2024-02-05,9896
1605,華新,42,26,16,元大-台南,2024-02-05,9896
2337,旺宏,16,0,16,元大-台南,2024-02-05,9896
2390,云辰,23,7,16,元大-台南,2024-02-05,9896
2606,裕民,15,0,15,元大-台南,2024-02-05,9896
6120,達運,16,1,15,元大-台南,2024-02-05,9896
6179,亞通,15,0,15,元大-台南,2024-02-05,9896
8349,�矬�,15,0,15,元大-台南,2024-02-05,9896
00675L,富邦臺灣加權正2,14,0,14,元大-台南,2024-02-05,9896
5351,鈺創,18,5,13,元大-台南,2024-02-05,9896
2303,聯電,28,15,13,元大-台南,2024-02-05,9896
3622,洋華,19,6,13,元大-台南,2024-02-05,9896
2376,技嘉,20,8,12,元大-台南,2024-02-05,9896
00933B,國泰10Y+金融債,25,13,12,元大-台南,2024-02-05,9896
00680L,元大美債20正2,908,23,885,元大-台南,2024-02-15,9896
00937B,群益ESG投等債20,281,46,235,元大-台南,2024-02-15,9896
00679B,元大美債20年,240,12,228,元大-台南,2024-02-15,9896
00632R,元大台灣50反1,217,17,200,元大-台南,2024-02-15,9896
00720B,元大投資級公司債,206,7,199,元大-台南,2024-02-15,9896
00687B,國泰20年美債,207,11,196,元大-台南,2024-02-15,9896
00933B,國泰10Y+金融債,180,0,180,元大-台南,2024-02-15,9896
00706L,期元大S＆P日圓正2,162,0,162,元大-台南,2024-02-15,9896
00673R,期元大S＆P原油反1,153,0,153,元大-台南,2024-02-15,9896
6116,彩晶,102,0,102,元大-台南,2024-02-15,9896
3010,華立,95,1,94,元大-台南,2024-02-15,9896
00751B,元大AAA至A公司債,91,0,91,元大-台南,2024-02-15,9896
00712,復華富時不動產,86,10,76,元大-台南,2024-02-15,9896
3481,群創,97,38,59,元大-台南,2024-02-15,9896
00882,中信中國高股息,54,1,53,元大-台南,2024-02-15,9896
3038,全台,51,0,51,元大-台南,2024-02-15,9896
2605,新興,50,1,49,元大-台南,2024-02-15,9896
2409,友達,45,0,45,元大-台南,2024-02-15,9896
2612,中航,54,11,43,元大-台南,2024-02-15,9896
00795B,中信美國公債20年,49,7,42,元大-台南,2024-02-15,9896
00772B,中信高評級公司債,40,0,40,元大-台南,2024-02-15,9896
2344,華邦電,41,7,34,元大-台南,2024-02-15,9896
00688L,國泰20年美債正2,31,0,31,元大-台南,2024-02-15,9896
2618,長榮航,46,19,27,元大-台南,2024-02-15,9896
2489,瑞軒,29,3,26,元大-台南,2024-02-15,9896
9904,寶成,31,5,26,元大-台南,2024-02-15,9896
2317,鴻海,24,0,24,元大-台南,2024-02-15,9896
00918,大華優利高填息30,32,10,22,元大-台南,2024-02-15,9896
3535,晶彩科,25,4,21,元大-台南,2024-02-15,9896
3362,先進光,20,0,20,元大-台南,2024-02-15,9896
00891,中信關鍵半導體,51,31,20,元大-台南,2024-02-15,9896
2633,台灣高鐵,21,1,20,元大-台南,2024-02-15,9896
6226,光鼎,38,19,19,元大-台南,2024-02-15,9896
1101,台泥,20,1,19,元大-台南,2024-02-15,9896
2377,微星,32,13,19,元大-台南,2024-02-15,9896
4303,信立,17,0,17,元大-台南,2024-02-15,9896
00931B,統一美債20年,22,5,17,元大-台南,2024-02-15,9896
2412,中華電,16,0,16,元大-台南,2024-02-15,9896
6223,旺矽,18,2,16,元大-台南,2024-02-15,9896
2025,千興,39,23,16,元大-台南,2024-02-15,9896
1795,美時,20,4,16,元大-台南,2024-02-15,9896
2889,國票金,15,0,15,元大-台南,2024-02-15,9896
8926,台汽電,15,0,15,元大-台南,2024-02-15,9896
00725B,國泰投資級公司債,15,0,15,元大-台南,2024-02-15,9896
2328,廣宇,16,2,14,元大-台南,2024-02-15,9896
2883,凱基金,27,13,14,元大-台南,2024-02-15,9896
2383,台光電,16,3,13,元大-台南,2024-02-15,9896
2888,新光金,23,10,13,元大-台南,2024-02-15,9896
4938,和碩,15,2,13,元大-台南,2024-02-15,9896
6166,凌華,13,0,13,元大-台南,2024-02-15,9896
00680L,元大美債20正2,808,2,806,元大-台南,2024-02-16,9896
00688L,國泰20年美債正2,687,66,621,元大-台南,2024-02-16,9896
00933B,國泰10Y+金融債,204,0,204,元大-台南,2024-02-16,9896
00882,中信中國高股息,127,5,122,元大-台南,2024-02-16,9896
00687B,國泰20年美債,121,2,119,元大-台南,2024-02-16,9896
00632R,元大台灣50反1,123,5,118,元大-台南,2024-02-16,9896
00671R,富邦NASDAQ反1,101,4,97,元大-台南,2024-02-16,9896
2887,台新金,85,9,76,元大-台南,2024-02-16,9896
00937B,群益ESG投等債20,73,0,73,元大-台南,2024-02-16,9896
00679B,元大美債20年,65,6,59,元大-台南,2024-02-16,9896
00929,復華台灣科技優息,218,167,51,元大-台南,2024-02-16,9896
6757,台灣虎航,50,0,50,元大-台南,2024-02-16,9896
00919,群益台灣精選高息,107,61,46,元大-台南,2024-02-16,9896
00673R,期元大S＆P原油反1,40,0,40,元大-台南,2024-02-16,9896
00720B,元大投資級公司債,43,6,37,元大-台南,2024-02-16,9896
00751B,元大AAA至A公司債,38,3,35,元大-台南,2024-02-16,9896
00706L,期元大S＆P日圓正2,35,0,35,元大-台南,2024-02-16,9896
3010,華立,33,1,32,元大-台南,2024-02-16,9896
3483,力致,33,2,31,元大-台南,2024-02-16,9896
2888,新光金,32,2,30,元大-台南,2024-02-16,9896
00795B,中信美國公債20年,29,0,29,元大-台南,2024-02-16,9896
1773,勝一,29,1,28,元大-台南,2024-02-16,9896
00878,國泰永續高股息,112,84,28,元大-台南,2024-02-16,9896
0061,元大寶滬深,25,0,25,元大-台南,2024-02-16,9896
3032,偉訓,44,19,25,元大-台南,2024-02-16,9896
3041,揚智,33,10,23,元大-台南,2024-02-16,9896
6126,信音,33,10,23,元大-台南,2024-02-16,9896
2421,建準,29,7,22,元大-台南,2024-02-16,9896
3312,弘憶股,27,6,21,元大-台南,2024-02-16,9896
2409,友達,22,1,21,元大-台南,2024-02-16,9896
2891,中信金,24,3,21,元大-台南,2024-02-16,9896
6153,嘉聯益,22,3,19,元大-台南,2024-02-16,9896
5272,笙科,20,1,19,元大-台南,2024-02-16,9896
4167,松瑞藥,20,3,17,元大-台南,2024-02-16,9896
1785,光洋科,38,21,17,元大-台南,2024-02-16,9896
2886,兆豐金,18,2,16,元大-台南,2024-02-16,9896
8926,台汽電,21,6,15,元大-台南,2024-02-16,9896
3209,全科,19,4,15,元大-台南,2024-02-16,9896
3607,谷崧,14,0,14,元大-台南,2024-02-16,9896
3035,智原,18,4,14,元大-台南,2024-02-16,9896
00752,中信中國50,13,0,13,元大-台南,2024-02-16,9896
9105,泰金寶-DR,14,1,13,元大-台南,2024-02-16,9896
00931B,統一美債20年,13,0,13,元大-台南,2024-02-16,9896
2330,台積電,18,5,13,元大-台南,2024-02-16,9896
2615,萬海,12,0,12,元大-台南,2024-02-16,9896
2337,旺宏,13,1,12,元大-台南,2024-02-16,9896
3260,威剛,12,0,12,元大-台南,2024-02-16,9896
2382,廣達,57,45,12,元大-台南,2024-02-16,9896
6226,光鼎,13,2,11,元大-台南,2024-02-16,9896
3413,京鼎,12,1,11,元大-台南,2024-02-16,9896
6806,森崴能源,317,29,288,元大-台南,2024-02-19,9896
00679B,元大美債20年,262,7,255,元大-台南,2024-02-19,9896
5880,合庫金,210,14,196,元大-台南,2024-02-19,9896
1503,士電,220,29,191,元大-台南,2024-02-19,9896
00919,群益台灣精選高息,179,16,163,元大-台南,2024-02-19,9896
00687B,國泰20年美債,172,10,162,元大-台南,2024-02-19,9896
2353,宏��,219,72,147,元大-台南,2024-02-19,9896
00878,國泰永續高股息,156,17,139,元大-台南,2024-02-19,9896
00937B,群益ESG投等債20,141,10,131,元大-台南,2024-02-19,9896
2612,中航,132,4,128,元大-台南,2024-02-19,9896
00720B,元大投資級公司債,94,9,85,元大-台南,2024-02-19,9896
2887,台新金,81,0,81,元大-台南,2024-02-19,9896
00664R,國泰臺灣加權反1,65,0,65,元大-台南,2024-02-19,9896
00680L,元大美債20正2,101,45,56,元大-台南,2024-02-19,9896
00882,中信中國高股息,64,9,55,元大-台南,2024-02-19,9896
00885,富邦越南,60,8,52,元大-台南,2024-02-19,9896
2329,華泰,147,98,49,元大-台南,2024-02-19,9896
00712,復華富時不動產,63,16,47,元大-台南,2024-02-19,9896
00688L,國泰20年美債正2,109,66,43,元大-台南,2024-02-19,9896
2812,台中銀,41,0,41,元大-台南,2024-02-19,9896
3041,揚智,58,18,40,元大-台南,2024-02-19,9896
2356,英業達,81,49,32,元大-台南,2024-02-19,9896
00632R,元大台灣50反1,46,15,31,元大-台南,2024-02-19,9896
1536,和大,30,0,30,元大-台南,2024-02-19,9896
00891,中信關鍵半導體,31,1,30,元大-台南,2024-02-19,9896
00933B,國泰10Y+金融債,31,2,29,元大-台南,2024-02-19,9896
2883,凱基金,36,8,28,元大-台南,2024-02-19,9896
1597,直得,27,0,27,元大-台南,2024-02-19,9896
2355,敬鵬,40,15,25,元大-台南,2024-02-19,9896
2382,廣達,29,6,23,元大-台南,2024-02-19,9896
2352,佳世達,21,2,19,元大-台南,2024-02-19,9896
3363,上詮,38,19,19,元大-台南,2024-02-19,9896
00751B,元大AAA至A公司債,18,0,18,元大-台南,2024-02-19,9896
3035,智原,21,3,18,元大-台南,2024-02-19,9896
00772B,中信高評級公司債,17,0,17,元大-台南,2024-02-19,9896
6176,瑞儀,18,1,17,元大-台南,2024-02-19,9896
3715,定穎投控,20,4,16,元大-台南,2024-02-19,9896
6117,迎廣,17,2,15,元大-台南,2024-02-19,9896
5347,世界,15,0,15,元大-台南,2024-02-19,9896
8070,長華*,37,22,15,元大-台南,2024-02-19,9896
2610,華航,16,1,15,元大-台南,2024-02-19,9896
1504,東元,20,6,14,元大-台南,2024-02-19,9896
8110,華東,46,32,14,元大-台南,2024-02-19,9896
1721,三晃,89,75,14,元大-台南,2024-02-19,9896
00650L,復華香港正2,25,12,13,元大-台南,2024-02-19,9896
00752,中信中國50,17,4,13,元大-台南,2024-02-19,9896
2421,建準,17,5,12,元大-台南,2024-02-19,9896
3265,台星科,12,0,12,元大-台南,2024-02-19,9896
00764B,群益25年美債,12,0,12,元大-台南,2024-02-19,9896
3115,富榮綱,12,0,12,元大-台南,2024-02-19,9896
2312,金寶,200,0,200,元大-台南,2024-02-20,9896
2612,中航,176,1,175,元大-台南,2024-02-20,9896
00687B,國泰20年美債,160,1,159,元大-台南,2024-02-20,9896
00885,富邦越南,163,5,158,元大-台南,2024-02-20,9896
2349,錸德,145,0,145,元大-台南,2024-02-20,9896
00937B,群益ESG投等債20,103,3,100,元大-台南,2024-02-20,9896
00878,國泰永續高股息,104,22,82,元大-台南,2024-02-20,9896
00679B,元大美債20年,87,5,82,元大-台南,2024-02-20,9896
00680L,元大美債20正2,75,0,75,元大-台南,2024-02-20,9896
2511,太子,60,0,60,元大-台南,2024-02-20,9896
00933B,國泰10Y+金融債,53,0,53,元大-台南,2024-02-20,9896
3481,群創,103,57,46,元大-台南,2024-02-20,9896
1536,和大,45,0,45,元大-台南,2024-02-20,9896
00712,復華富時不動產,44,0,44,元大-台南,2024-02-20,9896
3712,永崴投控,50,8,42,元大-台南,2024-02-20,9896
2489,瑞軒,78,45,33,元大-台南,2024-02-20,9896
1514,亞力,42,9,33,元大-台南,2024-02-20,9896
3437,榮創,35,3,32,元大-台南,2024-02-20,9896
00753L,中信中國50正2,32,0,32,元大-台南,2024-02-20,9896
3035,智原,39,11,28,元大-台南,2024-02-20,9896
2329,華泰,101,75,26,元大-台南,2024-02-20,9896
00751B,元大AAA至A公司債,25,0,25,元大-台南,2024-02-20,9896
6104,創惟,23,0,23,元大-台南,2024-02-20,9896
2834,臺企銀,60,38,22,元大-台南,2024-02-20,9896
2884,玉山金,22,1,21,元大-台南,2024-02-20,9896
00688L,國泰20年美債正2,122,101,21,元大-台南,2024-02-20,9896
00720B,元大投資級公司債,20,0,20,元大-台南,2024-02-20,9896
3694,海華,27,7,20,元大-台南,2024-02-20,9896
00632R,元大台灣50反1,19,0,19,元大-台南,2024-02-20,9896
3041,揚智,90,71,19,元大-台南,2024-02-20,9896
5521,工信,20,1,19,元大-台南,2024-02-20,9896
00795B,中信美國公債20年,18,0,18,元大-台南,2024-02-20,9896
00673R,期元大S＆P原油反1,18,0,18,元大-台南,2024-02-20,9896
2353,宏��,39,21,18,元大-台南,2024-02-20,9896
2405,輔信,64,47,17,元大-台南,2024-02-20,9896
3013,晟銘電,17,0,17,元大-台南,2024-02-20,9896
8931,大汽電,17,0,17,元大-台南,2024-02-20,9896
00931B,統一美債20年,16,0,16,元大-台南,2024-02-20,9896
2382,廣達,18,3,15,元大-台南,2024-02-20,9896
1805,寶徠,14,0,14,元大-台南,2024-02-20,9896
2033,佳大,14,0,14,元大-台南,2024-02-20,9896
3115,富榮綱,14,0,14,元大-台南,2024-02-20,9896
2409,友達,17,4,13,元大-台南,2024-02-20,9896
8110,華東,27,15,12,元大-台南,2024-02-20,9896
6185,幃翔,12,0,12,元大-台南,2024-02-20,9896
8435,鉅邁,13,1,12,元大-台南,2024-02-20,9896
6789,采鈺,14,3,11,元大-台南,2024-02-20,9896
3312,弘憶股,30,19,11,元大-台南,2024-02-20,9896
8050,廣積,12,1,11,元大-台南,2024-02-20,9896
3362,先進光,42,31,11,元大-台南,2024-02-20,9896
00937B,群益ESG投等債20,218,0,218,元大-台南,2024-02-21,9896
2303,聯電,106,1,105,元大-台南,2024-02-21,9896
6806,森崴能源,121,25,96,元大-台南,2024-02-21,9896
00878,國泰永續高股息,92,8,84,元大-台南,2024-02-21,9896
2312,金寶,97,19,78,元大-台南,2024-02-21,9896
3047,訊舟,86,10,76,元大-台南,2024-02-21,9896
5880,合庫金,81,8,73,元大-台南,2024-02-21,9896
00632R,元大台灣50反1,111,40,71,元大-台南,2024-02-21,9896
00679B,元大美債20年,74,8,66,元大-台南,2024-02-21,9896
9904,寶成,56,0,56,元大-台南,2024-02-21,9896
6282,康舒,58,5,53,元大-台南,2024-02-21,9896
3481,群創,135,82,53,元大-台南,2024-02-21,9896
6153,嘉聯益,50,0,50,元大-台南,2024-02-21,9896
00933B,國泰10Y+金融債,42,0,42,元大-台南,2024-02-21,9896
3032,偉訓,43,2,41,元大-台南,2024-02-21,9896
2609,陽明,53,12,41,元大-台南,2024-02-21,9896
2103,台橡,35,0,35,元大-台南,2024-02-21,9896
1721,三晃,181,146,35,元大-台南,2024-02-21,9896
00720B,元大投資級公司債,38,7,31,元大-台南,2024-02-21,9896
00651R,復華香港反1,29,0,29,元大-台南,2024-02-21,9896
1316,上曜,54,25,29,元大-台南,2024-02-21,9896
00712,復華富時不動產,37,9,28,元大-台南,2024-02-21,9896
3035,智原,45,18,27,元大-台南,2024-02-21,9896
2515,中工,27,3,24,元大-台南,2024-02-21,9896
2888,新光金,24,0,24,元大-台南,2024-02-21,9896
00795B,中信美國公債20年,23,0,23,元大-台南,2024-02-21,9896
2352,佳世達,22,0,22,元大-台南,2024-02-21,9896
00680L,元大美債20正2,40,18,22,元大-台南,2024-02-21,9896
00639,富邦深100,20,0,20,元大-台南,2024-02-21,9896
00687B,國泰20年美債,65,45,20,元大-台南,2024-02-21,9896
00706L,期元大S＆P日圓正2,20,0,20,元大-台南,2024-02-21,9896
6167,久正,20,0,20,元大-台南,2024-02-21,9896
6472,保瑞,19,0,19,元大-台南,2024-02-21,9896
3230,錦明,19,0,19,元大-台南,2024-02-21,9896
3380,明泰,19,0,19,元大-台南,2024-02-21,9896
00919,群益台灣精選高息,76,60,16,元大-台南,2024-02-21,9896
2885,元大金,19,4,15,元大-台南,2024-02-21,9896
6189,豐藝,28,13,15,元大-台南,2024-02-21,9896
00643,群益深証中小,15,0,15,元大-台南,2024-02-21,9896
2884,玉山金,19,4,15,元大-台南,2024-02-21,9896
2401,凌陽,42,27,15,元大-台南,2024-02-21,9896
00688L,國泰20年美債正2,14,0,14,元大-台南,2024-02-21,9896
3115,富榮綱,14,0,14,元大-台南,2024-02-21,9896
5381,合正,33,19,14,元大-台南,2024-02-21,9896
2330,台積電,15,2,13,元大-台南,2024-02-21,9896
6550,北極星藥業-KY,12,0,12,元大-台南,2024-02-21,9896
2301,光寶科,11,0,11,元大-台南,2024-02-21,9896
3038,全台,12,1,11,元大-台南,2024-02-21,9896
4903,聯光通,11,0,11,元大-台南,2024-02-21,9896
2387,精元,12,1,11,元大-台南,2024-02-21,9896
2605,新興,243,51,192,元大-台南,2024-02-22,9896
5498,凱崴,203,33,170,元大-台南,2024-02-22,9896
2603,長榮,191,24,167,元大-台南,2024-02-22,9896
00937B,群益ESG投等債20,166,7,159,元大-台南,2024-02-22,9896
00878,國泰永續高股息,150,8,142,元大-台南,2024-02-22,9896
3231,緯創,207,89,118,元大-台南,2024-02-22,9896
00665L,富邦�琤肭磪囓�2,158,52,106,元大-台南,2024-02-22,9896
00933B,國泰10Y+金融債,102,1,101,元大-台南,2024-02-22,9896
00795B,中信美國公債20年,81,0,81,元大-台南,2024-02-22,9896
00751B,元大AAA至A公司債,88,8,80,元大-台南,2024-02-22,9896
6140,訊達,80,0,80,元大-台南,2024-02-22,9896
00687B,國泰20年美債,85,23,62,元大-台南,2024-02-22,9896
00673R,期元大S＆P原油反1,62,0,62,元大-台南,2024-02-22,9896
2303,聯電,59,1,58,元大-台南,2024-02-22,9896
5443,均豪,79,26,53,元大-台南,2024-02-22,9896
9105,泰金寶-DR,89,40,49,元大-台南,2024-02-22,9896
6133,金橋,66,23,43,元大-台南,2024-02-22,9896
1316,上曜,51,10,41,元大-台南,2024-02-22,9896
2356,英業達,108,67,41,元大-台南,2024-02-22,9896
00919,群益台灣精選高息,125,85,40,元大-台南,2024-02-22,9896
6153,嘉聯益,40,0,40,元大-台南,2024-02-22,9896
1515,力山,38,1,37,元大-台南,2024-02-22,9896
1536,和大,34,0,34,元大-台南,2024-02-22,9896
2344,華邦電,37,4,33,元大-台南,2024-02-22,9896
1314,中石化,32,0,32,元大-台南,2024-02-22,9896
5272,笙科,35,3,32,元大-台南,2024-02-22,9896
00679B,元大美債20年,38,6,32,元大-台南,2024-02-22,9896
6282,康舒,41,13,28,元大-台南,2024-02-22,9896
6257,矽格,29,2,27,元大-台南,2024-02-22,9896
4968,立積,25,2,23,元大-台南,2024-02-22,9896
6213,聯茂,26,3,23,元大-台南,2024-02-22,9896
2358,廷鑫,22,0,22,元大-台南,2024-02-22,9896
3312,弘憶股,29,7,22,元大-台南,2024-02-22,9896
2884,玉山金,30,8,22,元大-台南,2024-02-22,9896
8027,鈦昇,21,0,21,元大-台南,2024-02-22,9896
6113,亞矽,20,0,20,元大-台南,2024-02-22,9896
2376,技嘉,25,5,20,元大-台南,2024-02-22,9896
00857B,永豐20年美公債,18,0,18,元大-台南,2024-02-22,9896
00712,復華富時不動產,18,0,18,元大-台南,2024-02-22,9896
6179,亞通,31,13,18,元大-台南,2024-02-22,9896
4171,瑞基,18,0,18,元大-台南,2024-02-22,9896
2421,建準,48,31,17,元大-台南,2024-02-22,9896
2618,長榮航,24,7,17,元大-台南,2024-02-22,9896
6126,信音,20,3,17,元大-台南,2024-02-22,9896
2489,瑞軒,27,10,17,元大-台南,2024-02-22,9896
2888,新光金,17,1,16,元大-台南,2024-02-22,9896
8110,華東,29,13,16,元大-台南,2024-02-22,9896
3025,星通,118,102,16,元大-台南,2024-02-22,9896
00927,群益半導體收益,15,0,15,元大-台南,2024-02-22,9896
3047,訊舟,31,16,15,元大-台南,2024-02-22,9896
00680L,元大美債20正2,623,3,620,元大-台南,2024-02-23,9896
2618,長榮航,192,1,191,元大-台南,2024-02-23,9896
00937B,群益ESG投等債20,157,27,130,元大-台南,2024-02-23,9896
3481,群創,161,84,77,元大-台南,2024-02-23,9896
00885,富邦越南,95,22,73,元大-台南,2024-02-23,9896
00687B,國泰20年美債,76,11,65,元大-台南,2024-02-23,9896
2329,華泰,239,174,65,元大-台南,2024-02-23,9896
00933B,國泰10Y+金融債,61,1,60,元大-台南,2024-02-23,9896
8930,青鋼,50,0,50,元大-台南,2024-02-23,9896
00679B,元大美債20年,57,7,50,元大-台南,2024-02-23,9896
00712,復華富時不動產,59,13,46,元大-台南,2024-02-23,9896
3694,海華,55,9,46,元大-台南,2024-02-23,9896
00919,群益台灣精選高息,155,114,41,元大-台南,2024-02-23,9896
00878,國泰永續高股息,88,51,37,元大-台南,2024-02-23,9896
6104,創惟,41,5,36,元大-台南,2024-02-23,9896
2884,玉山金,39,4,35,元大-台南,2024-02-23,9896
8435,鉅邁,34,0,34,元大-台南,2024-02-23,9896
3437,榮創,37,3,34,元大-台南,2024-02-23,9896
3231,緯創,105,75,30,元大-台南,2024-02-23,9896
2610,華航,37,8,29,元大-台南,2024-02-23,9896
2888,新光金,38,10,28,元大-台南,2024-02-23,9896
00720B,元大投資級公司債,29,1,28,元大-台南,2024-02-23,9896
2303,聯電,31,5,26,元大-台南,2024-02-23,9896
3010,華立,27,1,26,元大-台南,2024-02-23,9896
00891,中信關鍵半導體,40,15,25,元大-台南,2024-02-23,9896
3041,揚智,26,2,24,元大-台南,2024-02-23,9896
1785,光洋科,25,1,24,元大-台南,2024-02-23,9896
1605,華新,26,3,23,元大-台南,2024-02-23,9896
2609,陽明,26,3,23,元大-台南,2024-02-23,9896
3402,漢科,25,3,22,元大-台南,2024-02-23,9896
00706L,期元大S＆P日圓正2,21,0,21,元大-台南,2024-02-23,9896
00688L,國泰20年美債正2,20,0,20,元大-台南,2024-02-23,9896
2885,元大金,22,2,20,元大-台南,2024-02-23,9896
2489,瑞軒,40,20,20,元大-台南,2024-02-23,9896
2033,佳大,20,0,20,元大-台南,2024-02-23,9896
6189,豐藝,23,4,19,元大-台南,2024-02-23,9896
1536,和大,19,2,17,元大-台南,2024-02-23,9896
2634,漢翔,19,2,17,元大-台南,2024-02-23,9896
3033,威健,24,7,17,元大-台南,2024-02-23,9896
3479,安勤,20,4,16,元大-台南,2024-02-23,9896
2408,南亞科,18,2,16,元大-台南,2024-02-23,9896
6112,邁達特,20,4,16,元大-台南,2024-02-23,9896
6141,柏承,16,0,16,元大-台南,2024-02-23,9896
2405,輔信,31,15,16,元大-台南,2024-02-23,9896
8076,伍豐,15,0,15,元大-台南,2024-02-23,9896
3380,明泰,27,13,14,元大-台南,2024-02-23,9896
2368,金像電,21,7,14,元大-台南,2024-02-23,9896
1717,長興,33,20,13,元大-台南,2024-02-23,9896
3006,晶豪科,15,2,13,元大-台南,2024-02-23,9896
5202,力新,13,0,13,元大-台南,2024-02-23,9896
00687B,國泰20年美債,395,15,380,元大-台南,2024-02-26,9896
8070,長華*,168,0,168,元大-台南,2024-02-26,9896
1513,中興電,255,91,164,元大-台南,2024-02-26,9896
00937B,群益ESG投等債20,183,26,157,元大-台南,2024-02-26,9896
00878,國泰永續高股息,167,27,140,元大-台南,2024-02-26,9896
3231,緯創,178,47,131,元大-台南,2024-02-26,9896
00919,群益台灣精選高息,152,23,129,元大-台南,2024-02-26,9896
6806,森崴能源,109,9,100,元大-台南,2024-02-26,9896
00680L,元大美債20正2,112,20,92,元大-台南,2024-02-26,9896
3390,旭軟,125,39,86,元大-台南,2024-02-26,9896
00753L,中信中國50正2,70,0,70,元大-台南,2024-02-26,9896
00933B,國泰10Y+金融債,81,25,56,元大-台南,2024-02-26,9896
8069,元太,58,5,53,元大-台南,2024-02-26,9896
2612,中航,39,0,39,元大-台南,2024-02-26,9896
2303,聯電,54,16,38,元大-台南,2024-02-26,9896
00715L,期街口布蘭特正2,40,2,38,元大-台南,2024-02-26,9896
8930,青鋼,32,0,32,元大-台南,2024-02-26,9896
00712,復華富時不動產,33,2,31,元大-台南,2024-02-26,9896
2208,台船,30,0,30,元大-台南,2024-02-26,9896
2610,華航,45,15,30,元大-台南,2024-02-26,9896
2329,華泰,60,32,28,元大-台南,2024-02-26,9896
4977,眾達-KY,29,2,27,元大-台南,2024-02-26,9896
2887,台新金,26,0,26,元大-台南,2024-02-26,9896
00706L,期元大S＆P日圓正2,25,0,25,元大-台南,2024-02-26,9896
00632R,元大台灣50反1,44,20,24,元大-台南,2024-02-26,9896
6168,宏齊,25,2,23,元大-台南,2024-02-26,9896
2883,凱基金,23,1,22,元大-台南,2024-02-26,9896
3260,威剛,36,15,21,元大-台南,2024-02-26,9896
5904,寶雅,20,0,20,元大-台南,2024-02-26,9896
6257,矽格,56,36,20,元大-台南,2024-02-26,9896
8454,富邦媒,20,0,20,元大-台南,2024-02-26,9896
2313,華通,38,18,20,元大-台南,2024-02-26,9896
2449,京元電子,24,4,20,元大-台南,2024-02-26,9896
00679B,元大美債20年,39,20,19,元大-台南,2024-02-26,9896
2002,中鋼,20,2,18,元大-台南,2024-02-26,9896
2405,輔信,41,23,18,元大-台南,2024-02-26,9896
00751B,元大AAA至A公司債,20,2,18,元大-台南,2024-02-26,9896
1314,中石化,29,11,18,元大-台南,2024-02-26,9896
4909,新復興,47,30,17,元大-台南,2024-02-26,9896
1717,長興,42,25,17,元大-台南,2024-02-26,9896
2353,宏��,18,2,16,元大-台南,2024-02-26,9896
3010,華立,19,3,16,元大-台南,2024-02-26,9896
2888,新光金,19,3,16,元大-台南,2024-02-26,9896
2634,漢翔,31,15,16,元大-台南,2024-02-26,9896
1101,台泥,24,8,16,元大-台南,2024-02-26,9896
8112,至上,16,0,16,元大-台南,2024-02-26,9896
3703,欣陸,19,4,15,元大-台南,2024-02-26,9896
2369,菱生,23,8,15,元大-台南,2024-02-26,9896
1301,台塑,15,0,15,元大-台南,2024-02-26,9896
6156,松上,15,0,15,元大-台南,2024-02-26,9896
00878,國泰永續高股息,329,51,278,元大-台南,2024-02-27,9896
00937B,群益ESG投等債20,255,42,213,元大-台南,2024-02-27,9896
1301,台塑,105,3,102,元大-台南,2024-02-27,9896
00673R,期元大S＆P原油反1,80,0,80,元大-台南,2024-02-27,9896
2834,臺企銀,80,7,73,元大-台南,2024-02-27,9896
9105,泰金寶-DR,88,20,68,元大-台南,2024-02-27,9896
2363,矽統,93,34,59,元大-台南,2024-02-27,9896
1795,美時,64,7,57,元大-台南,2024-02-27,9896
8040,九暘,62,7,55,元大-台南,2024-02-27,9896
2409,友達,54,1,53,元大-台南,2024-02-27,9896
00679B,元大美債20年,68,15,53,元大-台南,2024-02-27,9896
1326,台化,56,5,51,元大-台南,2024-02-27,9896
5498,凱崴,60,10,50,元大-台南,2024-02-27,9896
00770,國泰北美科技,48,0,48,元大-台南,2024-02-27,9896
9904,寶成,46,0,46,元大-台南,2024-02-27,9896
1609,大亞,61,19,42,元大-台南,2024-02-27,9896
00933B,國泰10Y+金融債,40,0,40,元大-台南,2024-02-27,9896
00795B,中信美國公債20年,39,3,36,元大-台南,2024-02-27,9896
00857B,永豐20年美公債,40,4,36,元大-台南,2024-02-27,9896
00680L,元大美債20正2,44,9,35,元大-台南,2024-02-27,9896
6133,金橋,136,102,34,元大-台南,2024-02-27,9896
1514,亞力,106,76,30,元大-台南,2024-02-27,9896
3481,群創,31,2,29,元大-台南,2024-02-27,9896
2301,光寶科,33,5,28,元大-台南,2024-02-27,9896
00929,復華台灣科技優息,206,179,27,元大-台南,2024-02-27,9896
2313,華通,63,37,26,元大-台南,2024-02-27,9896
4960,誠美材,26,0,26,元大-台南,2024-02-27,9896
2612,中航,26,0,26,元大-台南,2024-02-27,9896
8096,擎亞,111,85,26,元大-台南,2024-02-27,9896
2002,中鋼,32,6,26,元大-台南,2024-02-27,9896
2233,宇隆,25,0,25,元大-台南,2024-02-27,9896
4908,前鼎,35,11,24,元大-台南,2024-02-27,9896
4977,眾達-KY,28,5,23,元大-台南,2024-02-27,9896
5904,寶雅,22,0,22,元大-台南,2024-02-27,9896
2495,普安,23,1,22,元大-台南,2024-02-27,9896
6472,保瑞,22,0,22,元大-台南,2024-02-27,9896
3005,神基,24,3,21,元大-台南,2024-02-27,9896
00850,元大臺灣ESG永續,20,0,20,元大-台南,2024-02-27,9896
8454,富邦媒,20,0,20,元大-台南,2024-02-27,9896
6153,嘉聯益,20,0,20,元大-台南,2024-02-27,9896
4714,永捷,20,0,20,元大-台南,2024-02-27,9896
5355,佳總,20,0,20,元大-台南,2024-02-27,9896
2405,輔信,42,22,20,元大-台南,2024-02-27,9896
00712,復華富時不動產,24,4,20,元大-台南,2024-02-27,9896
6282,康舒,24,5,19,元大-台南,2024-02-27,9896
1785,光洋科,20,1,19,元大-台南,2024-02-27,9896
1513,中興電,76,57,19,元大-台南,2024-02-27,9896
00687B,國泰20年美債,24,5,19,元大-台南,2024-02-27,9896
00720B,元大投資級公司債,24,6,18,元大-台南,2024-02-27,9896
3037,欣興,31,13,18,元大-台南,2024-02-27,9896
2025,千興,950,4,946,元大-台南,2024-02-29,9896
00632R,元大台灣50反1,269,0,269,元大-台南,2024-02-29,9896
00937B,群益ESG投等債20,237,20,217,元大-台南,2024-02-29,9896
00665L,富邦�琤肭磪囓�2,150,12,138,元大-台南,2024-02-29,9896
00933B,國泰10Y+金融債,133,0,133,元大-台南,2024-02-29,9896
00929,復華台灣科技優息,170,47,123,元大-台南,2024-02-29,9896
8070,長華*,121,1,120,元大-台南,2024-02-29,9896
3105,穩懋,103,1,102,元大-台南,2024-02-29,9896
5498,凱崴,86,0,86,元大-台南,2024-02-29,9896
00687B,國泰20年美債,105,26,79,元大-台南,2024-02-29,9896
6116,彩晶,81,4,77,元大-台南,2024-02-29,9896
00706L,期元大S＆P日圓正2,70,0,70,元大-台南,2024-02-29,9896
6488,環球晶,64,0,64,元大-台南,2024-02-29,9896
00679B,元大美債20年,61,3,58,元大-台南,2024-02-29,9896
6226,光鼎,73,20,53,元大-台南,2024-02-29,9896
00673R,期元大S＆P原油反1,47,9,38,元大-台南,2024-02-29,9896
00919,群益台灣精選高息,96,60,36,元大-台南,2024-02-29,9896
3231,緯創,73,39,34,元大-台南,2024-02-29,9896
00918,大華優利高填息30,42,11,31,元大-台南,2024-02-29,9896
3033,威健,33,4,29,元大-台南,2024-02-29,9896
00712,復華富時不動產,27,1,26,元大-台南,2024-02-29,9896
8064,東捷,38,12,26,元大-台南,2024-02-29,9896
9904,寶成,24,0,24,元大-台南,2024-02-29,9896
00795B,中信美國公債20年,23,0,23,元大-台南,2024-02-29,9896
6288,聯嘉,31,8,23,元大-台南,2024-02-29,9896
3712,永崴投控,30,7,23,元大-台南,2024-02-29,9896
1503,士電,57,35,22,元大-台南,2024-02-29,9896
2324,仁寶,29,7,22,元大-台南,2024-02-29,9896
6472,保瑞,20,0,20,元大-台南,2024-02-29,9896
1303,南亞,20,0,20,元大-台南,2024-02-29,9896
1909,榮成,20,0,20,元大-台南,2024-02-29,9896
00720B,元大投資級公司債,27,10,17,元大-台南,2024-02-29,9896
00751B,元大AAA至A公司債,17,0,17,元大-台南,2024-02-29,9896
1711,永光,18,1,17,元大-台南,2024-02-29,9896
8028,昇陽半導體,16,0,16,元大-台南,2024-02-29,9896
5351,鈺創,29,14,15,元大-台南,2024-02-29,9896
6127,九豪,17,3,14,元大-台南,2024-02-29,9896
2014,中鴻,14,0,14,元大-台南,2024-02-29,9896
00688L,國泰20年美債正2,13,0,13,元大-台南,2024-02-29,9896
2605,新興,15,2,13,元大-台南,2024-02-29,9896
1104,環泥,13,0,13,元大-台南,2024-02-29,9896
3047,訊舟,20,7,13,元大-台南,2024-02-29,9896
8096,擎亞,27,14,13,元大-台南,2024-02-29,9896
2363,矽統,17,5,12,元大-台南,2024-02-29,9896
6104,創惟,14,2,12,元大-台南,2024-02-29,9896
3013,晟銘電,13,1,12,元大-台南,2024-02-29,9896
2405,輔信,16,4,12,元大-台南,2024-02-29,9896
2376,技嘉,18,6,12,元大-台南,2024-02-29,9896
2329,華泰,82,71,11,元大-台南,2024-02-29,9896
1795,美時,45,34,11,元大-台南,2024-02-29,9896
2618,長榮航,306,1,305,元大-台南,2024-03-01,9896
00918,大華優利高填息30,220,10,210,元大-台南,2024-03-01,9896
6125,廣運,285,80,205,元大-台南,2024-03-01,9896
00937B,群益ESG投等債20,208,9,199,元大-台南,2024-03-01,9896
00919,群益台灣精選高息,271,82,189,元大-台南,2024-03-01,9896
4960,誠美材,207,28,179,元大-台南,2024-03-01,9896
00673R,期元大S＆P原油反1,115,0,115,元大-台南,2024-03-01,9896
6271,同欣電,103,1,102,元大-台南,2024-03-01,9896
3515,華擎,110,9,101,元大-台南,2024-03-01,9896
00687B,國泰20年美債,118,23,95,元大-台南,2024-03-01,9896
2303,聯電,153,61,92,元大-台南,2024-03-01,9896
9105,泰金寶-DR,96,20,76,元大-台南,2024-03-01,9896
00933B,國泰10Y+金融債,63,0,63,元大-台南,2024-03-01,9896
1718,中纖,46,3,43,元大-台南,2024-03-01,9896
2371,大同,77,38,39,元大-台南,2024-03-01,9896
2883,凱基金,37,0,37,元大-台南,2024-03-01,9896
2409,友達,42,5,37,元大-台南,2024-03-01,9896
2313,華通,51,15,36,元大-台南,2024-03-01,9896
6288,聯嘉,37,3,34,元大-台南,2024-03-01,9896
3694,海華,34,2,32,元大-台南,2024-03-01,9896
2020,美亞,31,0,31,元大-台南,2024-03-01,9896
6275,元山,37,8,29,元大-台南,2024-03-01,9896
00680L,元大美債20正2,32,3,29,元大-台南,2024-03-01,9896
3706,神達,31,4,27,元大-台南,2024-03-01,9896
2367,燿華,49,23,26,元大-台南,2024-03-01,9896
2323,中環,28,2,26,元大-台南,2024-03-01,9896
2881,富邦金,26,0,26,元大-台南,2024-03-01,9896
2495,普安,27,2,25,元大-台南,2024-03-01,9896
3372,典範,42,17,25,元大-台南,2024-03-01,9896
1316,上曜,87,62,25,元大-台南,2024-03-01,9896
6112,邁達特,25,1,24,元大-台南,2024-03-01,9896
6257,矽格,30,7,23,元大-台南,2024-03-01,9896
2405,輔信,42,19,23,元大-台南,2024-03-01,9896
2399,映泰,49,27,22,元大-台南,2024-03-01,9896
2615,萬海,22,1,21,元大-台南,2024-03-01,9896
3583,辛耘,21,2,19,元大-台南,2024-03-01,9896
00720B,元大投資級公司債,19,0,19,元大-台南,2024-03-01,9896
8926,台汽電,22,3,19,元大-台南,2024-03-01,9896
4543,萬在,26,8,18,元大-台南,2024-03-01,9896
4770,上品,17,0,17,元大-台南,2024-03-01,9896
9904,寶成,21,5,16,元大-台南,2024-03-01,9896
1609,大亞,74,59,15,元大-台南,2024-03-01,9896
4904,遠傳,15,0,15,元大-台南,2024-03-01,9896
2332,友訊,14,0,14,元大-台南,2024-03-01,9896
3607,谷崧,13,0,13,元大-台南,2024-03-01,9896
00882,中信中國高股息,24,11,13,元大-台南,2024-03-01,9896
1101,台泥,12,0,12,元大-台南,2024-03-01,9896
8454,富邦媒,16,4,12,元大-台南,2024-03-01,9896
00891,中信關鍵半導體,12,0,12,元大-台南,2024-03-01,9896
1314,中石化,12,0,12,元大-台南,2024-03-01,9896
00673R,期元大S＆P原油反1,1270,0,1270,元大-台南,2024-03-04,9896
00632R,元大台灣50反1,298,5,293,元大-台南,2024-03-04,9896
00937B,群益ESG投等債20,297,67,230,元大-台南,2024-03-04,9896
2025,千興,307,82,225,元大-台南,2024-03-04,9896
00687B,國泰20年美債,167,4,163,元大-台南,2024-03-04,9896
3147,大綜,120,0,120,元大-台南,2024-03-04,9896
6116,彩晶,100,0,100,元大-台南,2024-03-04,9896
2382,廣達,76,21,55,元大-台南,2024-03-04,9896
00919,群益台灣精選高息,188,133,55,元大-台南,2024-03-04,9896
1326,台化,55,5,50,元大-台南,2024-03-04,9896
2404,漢唐,50,1,49,元大-台南,2024-03-04,9896
00933B,國泰10Y+金融債,175,127,48,元大-台南,2024-03-04,9896
6196,帆宣,50,3,47,元大-台南,2024-03-04,9896
00918,大華優利高填息30,53,9,44,元大-台南,2024-03-04,9896
2888,新光金,44,0,44,元大-台南,2024-03-04,9896
2367,燿華,96,56,40,元大-台南,2024-03-04,9896
1815,富喬,41,4,37,元大-台南,2024-03-04,9896
00712,復華富時不動產,43,7,36,元大-台南,2024-03-04,9896
6207,雷科,35,0,35,元大-台南,2024-03-04,9896
4968,立積,42,9,33,元大-台南,2024-03-04,9896
2609,陽明,44,12,32,元大-台南,2024-03-04,9896
3024,憶聲,30,0,30,元大-台南,2024-03-04,9896
5880,合庫金,30,1,29,元大-台南,2024-03-04,9896
00904,新光臺灣半導體30,34,6,28,元大-台南,2024-03-04,9896
1909,榮成,43,17,26,元大-台南,2024-03-04,9896
6282,康舒,28,4,24,元大-台南,2024-03-04,9896
3231,緯創,69,45,24,元大-台南,2024-03-04,9896
2002,中鋼,28,7,21,元大-台南,2024-03-04,9896
4714,永捷,21,0,21,元大-台南,2024-03-04,9896
1303,南亞,21,1,20,元大-台南,2024-03-04,9896
2034,允強,20,0,20,元大-台南,2024-03-04,9896
8064,東捷,33,14,19,元大-台南,2024-03-04,9896
6770,力積電,22,3,19,元大-台南,2024-03-04,9896
2312,金寶,22,3,19,元大-台南,2024-03-04,9896
5347,世界,21,2,19,元大-台南,2024-03-04,9896
2329,華泰,43,26,17,元大-台南,2024-03-04,9896
00665L,富邦�琤肭磪囓�2,133,116,17,元大-台南,2024-03-04,9896
8926,台汽電,16,0,16,元大-台南,2024-03-04,9896
9105,泰金寶-DR,26,10,16,元大-台南,2024-03-04,9896
2301,光寶科,24,9,15,元大-台南,2024-03-04,9896
2308,台達電,19,4,15,元大-台南,2024-03-04,9896
6446,藥華藥,15,0,15,元大-台南,2024-03-04,9896
2633,台灣高鐵,14,0,14,元大-台南,2024-03-04,9896
2014,中鴻,14,0,14,元大-台南,2024-03-04,9896
00882,中信中國高股息,19,5,14,元大-台南,2024-03-04,9896
2745,五福,13,0,13,元大-台南,2024-03-04,9896
2889,國票金,15,2,13,元大-台南,2024-03-04,9896
2605,新興,13,0,13,元大-台南,2024-03-04,9896
00915,凱基優選高股息30,22,10,12,元大-台南,2024-03-04,9896
2376,技嘉,34,22,12,元大-台南,2024-03-04,9896
00632R,元大台灣50反1,211,21,190,元大-台南,2024-03-05,9896
00919,群益台灣精選高息,256,95,161,元大-台南,2024-03-05,9896
3481,群創,161,15,146,元大-台南,2024-03-05,9896
3231,緯創,257,125,132,元大-台南,2024-03-05,9896
00929,復華台灣科技優息,124,13,111,元大-台南,2024-03-05,9896
00687B,國泰20年美債,118,11,107,元大-台南,2024-03-05,9896
00712,復華富時不動產,111,16,95,元大-台南,2024-03-05,9896
00673R,期元大S＆P原油反1,100,27,73,元大-台南,2024-03-05,9896
1303,南亞,58,1,57,元大-台南,2024-03-05,9896
00918,大華優利高填息30,100,48,52,元大-台南,2024-03-05,9896
00753L,中信中國50正2,50,0,50,元大-台南,2024-03-05,9896
2888,新光金,58,10,48,元大-台南,2024-03-05,9896
2344,華邦電,45,0,45,元大-台南,2024-03-05,9896
00679B,元大美債20年,45,2,43,元大-台南,2024-03-05,9896
2606,裕民,53,10,43,元大-台南,2024-03-05,9896
00715L,期街口布蘭特正2,42,0,42,元大-台南,2024-03-05,9896
4906,正文,70,34,36,元大-台南,2024-03-05,9896
00937B,群益ESG投等債20,61,25,36,元大-台南,2024-03-05,9896
3694,海華,49,15,34,元大-台南,2024-03-05,9896
1609,大亞,62,29,33,元大-台南,2024-03-05,9896
4770,上品,32,0,32,元大-台南,2024-03-05,9896
2025,千興,81,49,32,元大-台南,2024-03-05,9896
6120,達運,38,7,31,元大-台南,2024-03-05,9896
00915,凱基優選高股息30,29,0,29,元大-台南,2024-03-05,9896
2605,新興,27,1,26,元大-台南,2024-03-05,9896
2603,長榮,64,38,26,元大-台南,2024-03-05,9896
3372,典範,51,26,25,元大-台南,2024-03-05,9896
3360,尚立,24,0,24,元大-台南,2024-03-05,9896
00665L,富邦�琤肭磪囓�2,233,209,24,元大-台南,2024-03-05,9896
4171,瑞基,24,1,23,元大-台南,2024-03-05,9896
2002,中鋼,26,4,22,元大-台南,2024-03-05,9896
9921,巨大,22,1,21,元大-台南,2024-03-05,9896
6005,群益證,20,0,20,元大-台南,2024-03-05,9896
3024,憶聲,20,0,20,元大-台南,2024-03-05,9896
2303,聯電,20,1,19,元大-台南,2024-03-05,9896
2495,普安,19,1,18,元大-台南,2024-03-05,9896
5351,鈺創,16,1,15,元大-台南,2024-03-05,9896
1773,勝一,18,4,14,元大-台南,2024-03-05,9896
2353,宏��,16,2,14,元大-台南,2024-03-05,9896
00885,富邦越南,13,0,13,元大-台南,2024-03-05,9896
00752,中信中國50,13,0,13,元大-台南,2024-03-05,9896
2329,華泰,45,33,12,元大-台南,2024-03-05,9896
9105,泰金寶-DR,26,15,11,元大-台南,2024-03-05,9896
2354,鴻準,12,1,11,元大-台南,2024-03-05,9896
1905,華紙,16,5,11,元大-台南,2024-03-05,9896
2889,國票金,12,1,11,元大-台南,2024-03-05,9896
6651,全宇昕,12,1,11,元大-台南,2024-03-05,9896
3354,律勝,11,0,11,元大-台南,2024-03-05,9896
2324,仁寶,37,27,10,元大-台南,2024-03-05,9896
6217,中探針,24,14,10,元大-台南,2024-03-05,9896
2025,千興,219,18,201,元大-台南,2024-03-06,9896
00919,群益台灣精選高息,596,407,189,元大-台南,2024-03-06,9896
3049,精金,173,19,154,元大-台南,2024-03-06,9896
00706L,期元大S＆P日圓正2,90,0,90,元大-台南,2024-03-06,9896
2303,聯電,111,26,85,元大-台南,2024-03-06,9896
00937B,群益ESG投等債20,141,56,85,元大-台南,2024-03-06,9896
1773,勝一,78,8,70,元大-台南,2024-03-06,9896
1303,南亞,58,1,57,元大-台南,2024-03-06,9896
00933B,國泰10Y+金融債,61,4,57,元大-台南,2024-03-06,9896
2618,長榮航,59,8,51,元大-台南,2024-03-06,9896
00915,凱基優選高股息30,54,3,51,元大-台南,2024-03-06,9896
2889,國票金,50,0,50,元大-台南,2024-03-06,9896
00680L,元大美債20正2,49,3,46,元大-台南,2024-03-06,9896
00857B,永豐20年美公債,45,0,45,元大-台南,2024-03-06,9896
2633,台灣高鐵,42,2,40,元大-台南,2024-03-06,9896
1514,亞力,78,39,39,元大-台南,2024-03-06,9896
2314,台揚,35,0,35,元大-台南,2024-03-06,9896
2603,長榮,34,1,33,元大-台南,2024-03-06,9896
6166,凌華,32,0,32,元大-台南,2024-03-06,9896
3147,大綜,30,0,30,元大-台南,2024-03-06,9896
2352,佳世達,43,14,29,元大-台南,2024-03-06,9896
2324,仁寶,44,16,28,元大-台南,2024-03-06,9896
5009,榮剛,22,0,22,元大-台南,2024-03-06,9896
3325,旭品,35,14,21,元大-台南,2024-03-06,9896
6229,研通,21,0,21,元大-台南,2024-03-06,9896
3605,宏致,20,0,20,元大-台南,2024-03-06,9896
1609,大亞,124,105,19,元大-台南,2024-03-06,9896
3013,晟銘電,59,41,18,元大-台南,2024-03-06,9896
3483,力致,23,6,17,元大-台南,2024-03-06,9896
00918,大華優利高填息30,36,20,16,元大-台南,2024-03-06,9896
6591,動力-KY,16,0,16,元大-台南,2024-03-06,9896
4109,加捷生醫,22,6,16,元大-台南,2024-03-06,9896
2337,旺宏,16,0,16,元大-台南,2024-03-06,9896
2515,中工,23,7,16,元大-台南,2024-03-06,9896
4720,德淵,15,0,15,元大-台南,2024-03-06,9896
00687B,國泰20年美債,17,2,15,元大-台南,2024-03-06,9896
2543,皇昌,25,11,14,元大-台南,2024-03-06,9896
1104,環泥,15,1,14,元大-台南,2024-03-06,9896
2313,華通,44,30,14,元大-台南,2024-03-06,9896
1314,中石化,14,0,14,元大-台南,2024-03-06,9896
6227,茂綸,13,0,13,元大-台南,2024-03-06,9896
6266,泰詠,23,10,13,元大-台南,2024-03-06,9896
1795,美時,13,1,12,元大-台南,2024-03-06,9896
2890,永豐金,12,0,12,元大-台南,2024-03-06,9896
6126,信音,27,15,12,元大-台南,2024-03-06,9896
2501,國建,13,1,12,元大-台南,2024-03-06,9896
2897,王道銀行,23,11,12,元大-台南,2024-03-06,9896
2363,矽統,16,4,12,元大-台南,2024-03-06,9896
2353,宏��,12,0,12,元大-台南,2024-03-06,9896
4147,中裕,11,0,11,元大-台南,2024-03-06,9896
00688L,國泰20年美債正2,1077,2,1075,元大-台南,2024-03-07,9896
2025,千興,514,28,486,元大-台南,2024-03-07,9896
2889,國票金,311,0,311,元大-台南,2024-03-07,9896
2609,陽明,245,29,216,元大-台南,2024-03-07,9896
00632R,元大台灣50反1,214,0,214,元大-台南,2024-03-07,9896
2204,中華,111,7,104,元大-台南,2024-03-07,9896
00919,群益台灣精選高息,196,96,100,元大-台南,2024-03-07,9896
00933B,國泰10Y+金融債,107,21,86,元大-台南,2024-03-07,9896
8930,青鋼,91,20,71,元大-台南,2024-03-07,9896
6143,振曜,72,8,64,元大-台南,2024-03-07,9896
4960,誠美材,52,0,52,元大-台南,2024-03-07,9896
00764B,群益25年美債,50,0,50,元大-台南,2024-03-07,9896
1605,華新,47,1,46,元大-台南,2024-03-07,9896
00637L,元大滬深300正2,53,7,46,元大-台南,2024-03-07,9896
3231,緯創,78,34,44,元大-台南,2024-03-07,9896
3540,曜越,79,37,42,元大-台南,2024-03-07,9896
8112,至上,73,32,41,元大-台南,2024-03-07,9896
6226,光鼎,40,0,40,元大-台南,2024-03-07,9896
00673R,期元大S＆P原油反1,39,0,39,元大-台南,2024-03-07,9896
1815,富喬,135,96,39,元大-台南,2024-03-07,9896
1609,大亞,51,17,34,元大-台南,2024-03-07,9896
9945,潤泰新,30,0,30,元大-台南,2024-03-07,9896
6206,飛捷,30,0,30,元大-台南,2024-03-07,9896
00931B,統一美債20年,40,10,30,元大-台南,2024-03-07,9896
2484,希華,30,0,30,元大-台南,2024-03-07,9896
2409,友達,45,16,29,元大-台南,2024-03-07,9896
6488,環球晶,36,7,29,元大-台南,2024-03-07,9896
2002,中鋼,41,12,29,元大-台南,2024-03-07,9896
3481,群創,74,45,29,元大-台南,2024-03-07,9896
6125,廣運,55,27,28,元大-台南,2024-03-07,9896
8477,創業家,25,0,25,元大-台南,2024-03-07,9896
9950,萬國通,25,1,24,元大-台南,2024-03-07,9896
2352,佳世達,25,2,23,元大-台南,2024-03-07,9896
2323,中環,23,0,23,元大-台南,2024-03-07,9896
1316,上曜,93,70,23,元大-台南,2024-03-07,9896
2034,允強,22,0,22,元大-台南,2024-03-07,9896
6167,久正,22,1,21,元大-台南,2024-03-07,9896
6189,豐藝,25,4,21,元大-台南,2024-03-07,9896
6271,同欣電,20,0,20,元大-台南,2024-03-07,9896
2338,光罩,21,1,20,元大-台南,2024-03-07,9896
00918,大華優利高填息30,26,7,19,元大-台南,2024-03-07,9896
8071,能率網通,22,3,19,元大-台南,2024-03-07,9896
6282,康舒,20,2,18,元大-台南,2024-03-07,9896
00915,凱基優選高股息30,33,15,18,元大-台南,2024-03-07,9896
2431,聯昌,18,0,18,元大-台南,2024-03-07,9896
4167,松瑞藥,20,2,18,元大-台南,2024-03-07,9896
4128,中天,21,3,18,元大-台南,2024-03-07,9896
1101,台泥,19,2,17,元大-台南,2024-03-07,9896
6207,雷科,19,2,17,元大-台南,2024-03-07,9896
00937B,群益ESG投等債20,49,33,16,元大-台南,2024-03-07,9896
00919,群益台灣精選高息,457,252,205,元大-台南,2024-03-08,9896
1815,富喬,221,78,143,元大-台南,2024-03-08,9896
00673R,期元大S＆P原油反1,132,0,132,元大-台南,2024-03-08,9896
1522,堤維西,104,2,102,元大-台南,2024-03-08,9896
2609,陽明,135,36,99,元大-台南,2024-03-08,9896
3338,泰碩,127,31,96,元大-台南,2024-03-08,9896
6176,瑞儀,88,15,73,元大-台南,2024-03-08,9896
00687B,國泰20年美債,95,25,70,元大-台南,2024-03-08,9896
3049,精金,63,0,63,元大-台南,2024-03-08,9896
2034,允強,60,0,60,元大-台南,2024-03-08,9896
00764B,群益25年美債,50,0,50,元大-台南,2024-03-08,9896
00918,大華優利高填息30,72,25,47,元大-台南,2024-03-08,9896
2371,大同,51,11,40,元大-台南,2024-03-08,9896
6016,康和證,48,9,39,元大-台南,2024-03-08,9896
1316,上曜,94,56,38,元大-台南,2024-03-08,9896
2889,國票金,43,7,36,元大-台南,2024-03-08,9896
00937B,群益ESG投等債20,116,80,36,元大-台南,2024-03-08,9896
2317,鴻海,43,7,36,元大-台南,2024-03-08,9896
00637L,元大滬深300正2,35,0,35,元大-台南,2024-03-08,9896
2603,長榮,51,17,34,元大-台南,2024-03-08,9896
2328,廣宇,38,8,30,元大-台南,2024-03-08,9896
5347,世界,33,4,29,元大-台南,2024-03-08,9896
2344,華邦電,37,11,26,元大-台南,2024-03-08,9896
6166,凌華,26,0,26,元大-台南,2024-03-08,9896
9941,裕融,26,0,26,元大-台南,2024-03-08,9896
6229,研通,30,5,25,元大-台南,2024-03-08,9896
1314,中石化,25,1,24,元大-台南,2024-03-08,9896
2020,美亞,24,0,24,元大-台南,2024-03-08,9896
00915,凱基優選高股息30,42,19,23,元大-台南,2024-03-08,9896
2897,王道銀行,24,1,23,元大-台南,2024-03-08,9896
2327,國巨,29,6,23,元大-台南,2024-03-08,9896
2409,友達,24,2,22,元大-台南,2024-03-08,9896
1517,利奇,45,23,22,元大-台南,2024-03-08,9896
4714,永捷,23,2,21,元大-台南,2024-03-08,9896
6205,詮欣,23,2,21,元大-台南,2024-03-08,9896
00679B,元大美債20年,32,11,21,元大-台南,2024-03-08,9896
5483,中美晶,47,26,21,元大-台南,2024-03-08,9896
1785,光洋科,40,20,20,元大-台南,2024-03-08,9896
5009,榮剛,20,0,20,元大-台南,2024-03-08,9896
2867,三商壽,20,0,20,元大-台南,2024-03-08,9896
3078,僑威,20,1,19,元大-台南,2024-03-08,9896
4147,中裕,19,0,19,元大-台南,2024-03-08,9896
9105,泰金寶-DR,64,45,19,元大-台南,2024-03-08,9896
2356,英業達,30,11,19,元大-台南,2024-03-08,9896
8105,凌巨,25,7,18,元大-台南,2024-03-08,9896
2365,昆盈,36,18,18,元大-台南,2024-03-08,9896
1434,福懋,18,0,18,元大-台南,2024-03-08,9896
2881,富邦金,33,16,17,元大-台南,2024-03-08,9896
1609,大亞,31,14,17,元大-台南,2024-03-08,9896
00923,群益台ESG低碳50,17,0,17,元大-台南,2024-03-08,9896
00632R,元大台灣50反1,503,90,413,元大-台南,2024-03-11,9896
00919,群益台灣精選高息,393,105,288,元大-台南,2024-03-11,9896
00937B,群益ESG投等債20,180,10,170,元大-台南,2024-03-11,9896
00687B,國泰20年美債,163,2,161,元大-台南,2024-03-11,9896
2382,廣達,168,44,124,元大-台南,2024-03-11,9896
3231,緯創,254,147,107,元大-台南,2024-03-11,9896
2303,聯電,157,69,88,元大-台南,2024-03-11,9896
00665L,富邦�琤肭磪囓�2,122,40,82,元大-台南,2024-03-11,9896
2344,華邦電,69,3,66,元大-台南,2024-03-11,9896
2367,燿華,100,39,61,元大-台南,2024-03-11,9896
00931B,統一美債20年,80,40,40,元大-台南,2024-03-11,9896
5347,世界,40,1,39,元大-台南,2024-03-11,9896
8926,台汽電,48,10,38,元大-台南,2024-03-11,9896
1785,光洋科,44,8,36,元大-台南,2024-03-11,9896
2330,台積電,45,11,34,元大-台南,2024-03-11,9896
2610,華航,50,17,33,元大-台南,2024-03-11,9896
2889,國票金,32,0,32,元大-台南,2024-03-11,9896
00772B,中信高評級公司債,41,10,31,元大-台南,2024-03-11,9896
00933B,國泰10Y+金融債,33,3,30,元大-台南,2024-03-11,9896
00715L,期街口布蘭特正2,30,0,30,元大-台南,2024-03-11,9896
00918,大華優利高填息30,28,1,27,元大-台南,2024-03-11,9896
3481,群創,37,13,24,元大-台南,2024-03-11,9896
3564,其陽,23,0,23,元大-台南,2024-03-11,9896
2605,新興,27,5,22,元大-台南,2024-03-11,9896
8054,安國,28,7,21,元大-台南,2024-03-11,9896
00674R,期元大S＆P黃金反1,20,0,20,元大-台南,2024-03-11,9896
3021,鴻名,20,0,20,元大-台南,2024-03-11,9896
6205,詮欣,18,0,18,元大-台南,2024-03-11,9896
1513,中興電,36,18,18,元大-台南,2024-03-11,9896
2353,宏��,18,1,17,元大-台南,2024-03-11,9896
3706,神達,24,8,16,元大-台南,2024-03-11,9896
00693U,期街口S＆P黃豆,15,0,15,元大-台南,2024-03-11,9896
00680L,元大美債20正2,38,23,15,元大-台南,2024-03-11,9896
8112,至上,25,10,15,元大-台南,2024-03-11,9896
2371,大同,16,2,14,元大-台南,2024-03-11,9896
00891,中信關鍵半導體,17,4,13,元大-台南,2024-03-11,9896
2356,英業達,48,35,13,元大-台南,2024-03-11,9896
00712,復華富時不動產,15,2,13,元大-台南,2024-03-11,9896
3325,旭品,16,3,13,元大-台南,2024-03-11,9896
9945,潤泰新,13,1,12,元大-台南,2024-03-11,9896
2453,凌群,12,0,12,元大-台南,2024-03-11,9896
8105,凌巨,12,0,12,元大-台南,2024-03-11,9896
6591,動力-KY,12,0,12,元大-台南,2024-03-11,9896
4167,松瑞藥,13,1,12,元大-台南,2024-03-11,9896
2516,新建,12,0,12,元大-台南,2024-03-11,9896
3339,泰谷,11,0,11,元大-台南,2024-03-11,9896
2812,台中銀,11,0,11,元大-台南,2024-03-11,9896
4714,永捷,11,0,11,元大-台南,2024-03-11,9896
3711,日月光投控,14,3,11,元大-台南,2024-03-11,9896
1101,台泥,25,15,10,元大-台南,2024-03-11,9896
00937B,群益ESG投等債20,233,41,192,元大-台南,2024-03-12,9896
2317,鴻海,379,194,185,元大-台南,2024-03-12,9896
2888,新光金,179,14,165,元大-台南,2024-03-12,9896
2511,太子,151,0,151,元大-台南,2024-03-12,9896
00919,群益台灣精選高息,245,119,126,元大-台南,2024-03-12,9896
2801,彰銀,100,0,100,元大-台南,2024-03-12,9896
2027,大成鋼,102,40,62,元大-台南,2024-03-12,9896
00929,復華台灣科技優息,97,40,57,元大-台南,2024-03-12,9896
2025,千興,62,7,55,元大-台南,2024-03-12,9896
00712,復華富時不動產,54,1,53,元大-台南,2024-03-12,9896
00688L,國泰20年美債正2,152,100,52,元大-台南,2024-03-12,9896
2405,輔信,50,1,49,元大-台南,2024-03-12,9896
00897,富邦基因免疫生技,50,10,40,元大-台南,2024-03-12,9896
00918,大華優利高填息30,55,15,40,元大-台南,2024-03-12,9896
9904,寶成,58,19,39,元大-台南,2024-03-12,9896
00930,永豐ESG低碳高息,30,0,30,元大-台南,2024-03-12,9896
6016,康和證,30,0,30,元大-台南,2024-03-12,9896
2383,台光電,40,10,30,元大-台南,2024-03-12,9896
00687B,國泰20年美債,77,48,29,元大-台南,2024-03-12,9896
2371,大同,65,37,28,元大-台南,2024-03-12,9896
4714,永捷,27,3,24,元大-台南,2024-03-12,9896
2324,仁寶,27,4,23,元大-台南,2024-03-12,9896
6616,特昇-KY,22,0,22,元大-台南,2024-03-12,9896
5488,松普,22,0,22,元大-台南,2024-03-12,9896
6205,詮欣,20,0,20,元大-台南,2024-03-12,9896
6180,橘子,20,1,19,元大-台南,2024-03-12,9896
6125,廣運,34,15,19,元大-台南,2024-03-12,9896
2409,友達,50,32,18,元大-台南,2024-03-12,9896
00931B,統一美債20年,18,0,18,元大-台南,2024-03-12,9896
1301,台塑,19,2,17,元大-台南,2024-03-12,9896
3264,欣銓,22,5,17,元大-台南,2024-03-12,9896
8942,森鉅,18,1,17,元大-台南,2024-03-12,9896
5498,凱崴,36,21,15,元大-台南,2024-03-12,9896
3071,協禧,14,0,14,元大-台南,2024-03-12,9896
3443,創意,13,0,13,元大-台南,2024-03-12,9896
1815,富喬,31,19,12,元大-台南,2024-03-12,9896
2352,佳世達,19,7,12,元大-台南,2024-03-12,9896
2345,智邦,13,2,11,元大-台南,2024-03-12,9896
2301,光寶科,14,3,11,元大-台南,2024-03-12,9896
1314,中石化,11,0,11,元大-台南,2024-03-12,9896
5471,松翰,11,0,11,元大-台南,2024-03-12,9896
00915,凱基優選高股息30,31,20,11,元大-台南,2024-03-12,9896
2441,超豐,11,0,11,元大-台南,2024-03-12,9896
2323,中環,21,10,11,元大-台南,2024-03-12,9896
3583,辛耘,20,9,11,元大-台南,2024-03-12,9896
1316,上曜,17,6,11,元大-台南,2024-03-12,9896
2915,潤泰全,19,8,11,元大-台南,2024-03-12,9896
00885,富邦越南,10,0,10,元大-台南,2024-03-12,9896
2880,華南金,11,1,10,元大-台南,2024-03-12,9896
5251,天鉞電,10,0,10,元大-台南,2024-03-12,9896
00919,群益台灣精選高息,864,176,688,元大-台南,2024-03-13,9896
00933B,國泰10Y+金融債,544,21,523,元大-台南,2024-03-13,9896
2889,國票金,170,2,168,元大-台南,2024-03-13,9896
2511,太子,150,0,150,元大-台南,2024-03-13,9896
2883,凱基金,179,65,114,元大-台南,2024-03-13,9896
1503,士電,119,25,94,元大-台南,2024-03-13,9896
00706L,期元大S＆P日圓正2,81,0,81,元大-台南,2024-03-13,9896
2618,長榮航,87,12,75,元大-台南,2024-03-13,9896
00915,凱基優選高股息30,89,20,69,元大-台南,2024-03-13,9896
2603,長榮,81,20,61,元大-台南,2024-03-13,9896
00679B,元大美債20年,63,2,61,元大-台南,2024-03-13,9896
2362,藍天,61,1,60,元大-台南,2024-03-13,9896
00929,復華台灣科技優息,152,94,58,元大-台南,2024-03-13,9896
3338,泰碩,55,0,55,元大-台南,2024-03-13,9896
2323,中環,54,8,46,元大-台南,2024-03-13,9896
6282,康舒,49,4,45,元大-台南,2024-03-13,9896
5880,合庫金,45,0,45,元大-台南,2024-03-13,9896
00857B,永豐20年美公債,44,0,44,元大-台南,2024-03-13,9896
5498,凱崴,44,6,38,元大-台南,2024-03-13,9896
2344,華邦電,40,3,37,元大-台南,2024-03-13,9896
00687B,國泰20年美債,57,25,32,元大-台南,2024-03-13,9896
3704,合勤控,32,1,31,元大-台南,2024-03-13,9896
2880,華南金,31,0,31,元大-台南,2024-03-13,9896
6191,精成科,30,0,30,元大-台南,2024-03-13,9896
00650L,復華香港正2,30,0,30,元大-台南,2024-03-13,9896
8112,至上,42,12,30,元大-台南,2024-03-13,9896
1316,上曜,38,9,29,元大-台南,2024-03-13,9896
4420,光明,28,0,28,元大-台南,2024-03-13,9896
6125,廣運,45,20,25,元大-台南,2024-03-13,9896
00651R,復華香港反1,25,0,25,元大-台南,2024-03-13,9896
9105,泰金寶-DR,54,30,24,元大-台南,2024-03-13,9896
2431,聯昌,23,0,23,元大-台南,2024-03-13,9896
1227,佳格,23,0,23,元大-台南,2024-03-13,9896
4906,正文,23,0,23,元大-台南,2024-03-13,9896
2460,建通,22,0,22,元大-台南,2024-03-13,9896
00891,中信關鍵半導體,21,1,20,元大-台南,2024-03-13,9896
2367,燿華,28,9,19,元大-台南,2024-03-13,9896
2383,台光電,23,4,19,元大-台南,2024-03-13,9896
2376,技嘉,37,18,19,元大-台南,2024-03-13,9896
6488,環球晶,20,2,18,元大-台南,2024-03-13,9896
2002,中鋼,21,3,18,元大-台南,2024-03-13,9896
6120,達運,21,3,18,元大-台南,2024-03-13,9896
1101,台泥,19,2,17,元大-台南,2024-03-13,9896
00720B,元大投資級公司債,23,6,17,元大-台南,2024-03-13,9896
3706,神達,43,27,16,元大-台南,2024-03-13,9896
1513,中興電,118,101,17,元大-台南,2024-03-13,9896
2845,遠東銀,16,0,16,元大-台南,2024-03-13,9896
6005,群益證,15,0,15,元大-台南,2024-03-13,9896
1609,大亞,43,28,15,元大-台南,2024-03-13,9896
2834,臺企銀,62,47,15,元大-台南,2024-03-13,9896
00919,群益台灣精選高息,783,318,465,元大-台南,2024-03-14,9896
00937B,群益ESG投等債20,141,5,136,元大-台南,2024-03-14,9896
00929,復華台灣科技優息,199,103,96,元大-台南,2024-03-14,9896
1503,士電,135,50,85,元大-台南,2024-03-14,9896
2027,大成鋼,83,7,76,元大-台南,2024-03-14,9896
6873,泓德能源,72,0,72,元大-台南,2024-03-14,9896
2836,高雄銀,65,1,64,元大-台南,2024-03-14,9896
00687B,國泰20年美債,77,22,55,元大-台南,2024-03-14,9896
00679B,元大美債20年,61,6,55,元大-台南,2024-03-14,9896
00907,永豐優息存股,54,2,52,元大-台南,2024-03-14,9896
6005,群益證,59,8,51,元大-台南,2024-03-14,9896
00878,國泰永續高股息,56,15,41,元大-台南,2024-03-14,9896
1815,富喬,47,7,40,元大-台南,2024-03-14,9896
4960,誠美材,100,60,40,元大-台南,2024-03-14,9896
00650L,復華香港正2,120,82,38,元大-台南,2024-03-14,9896
3231,緯創,92,57,35,元大-台南,2024-03-14,9896
00931B,統一美債20年,31,0,31,元大-台南,2024-03-14,9896
3481,群創,44,13,31,元大-台南,2024-03-14,9896
2601,益航,30,1,29,元大-台南,2024-03-14,9896
9105,泰金寶-DR,53,25,28,元大-台南,2024-03-14,9896
00680L,元大美債20正2,34,6,28,元大-台南,2024-03-14,9896
2609,陽明,38,11,27,元大-台南,2024-03-14,9896
00673R,期元大S＆P原油反1,27,0,27,元大-台南,2024-03-14,9896
00918,大華優利高填息30,140,114,26,元大-台南,2024-03-14,9896
1608,華榮,33,11,22,元大-台南,2024-03-14,9896
2303,聯電,48,26,22,元大-台南,2024-03-14,9896
2812,台中銀,25,3,22,元大-台南,2024-03-14,9896
2002,中鋼,27,6,21,元大-台南,2024-03-14,9896
2328,廣宇,20,0,20,元大-台南,2024-03-14,9896
5011,久陽,24,4,20,元大-台南,2024-03-14,9896
1718,中纖,22,2,20,元大-台南,2024-03-14,9896
00751B,元大AAA至A公司債,19,0,19,元大-台南,2024-03-14,9896
8112,至上,23,4,19,元大-台南,2024-03-14,9896
5498,凱崴,25,6,19,元大-台南,2024-03-14,9896
2356,英業達,55,37,18,元大-台南,2024-03-14,9896
00632R,元大台灣50反1,108,90,18,元大-台南,2024-03-14,9896
3576,聯合再生,20,2,18,元大-台南,2024-03-14,9896
9945,潤泰新,22,5,17,元大-台南,2024-03-14,9896
8011,台通,27,10,17,元大-台南,2024-03-14,9896
1514,亞力,36,19,17,元大-台南,2024-03-14,9896
3413,京鼎,19,2,17,元大-台南,2024-03-14,9896
3540,曜越,22,5,17,元大-台南,2024-03-14,9896
3013,晟銘電,17,1,16,元大-台南,2024-03-14,9896
6120,達運,16,0,16,元大-台南,2024-03-14,9896
2880,華南金,21,5,16,元大-台南,2024-03-14,9896
3005,神基,42,26,16,元大-台南,2024-03-14,9896
3548,兆利,20,5,15,元大-台南,2024-03-14,9896
8107,大億金茂,15,0,15,元大-台南,2024-03-14,9896
2344,華邦電,19,5,14,元大-台南,2024-03-14,9896
2352,佳世達,16,2,14,元大-台南,2024-03-14,9896
00919,群益台灣精選高息,516,156,360,元大-台南,2024-03-15,9896
00679B,元大美債20年,267,30,237,元大-台南,2024-03-15,9896
00915,凱基優選高股息30,159,13,146,元大-台南,2024-03-15,9896
00687B,國泰20年美債,146,7,139,元大-台南,2024-03-15,9896
00937B,群益ESG投等債20,142,6,136,元大-台南,2024-03-15,9896
2834,臺企銀,251,119,132,元大-台南,2024-03-15,9896
00680L,元大美債20正2,128,4,124,元大-台南,2024-03-15,9896
2836,高雄銀,102,7,95,元大-台南,2024-03-15,9896
2317,鴻海,375,290,85,元大-台南,2024-03-15,9896
00941,中信上游半導體,144,63,81,元大-台南,2024-03-15,9896
00929,復華台灣科技優息,101,30,71,元大-台南,2024-03-15,9896
2618,長榮航,90,31,59,元大-台南,2024-03-15,9896
00764B,群益25年美債,54,0,54,元大-台南,2024-03-15,9896
00753L,中信中國50正2,54,0,54,元大-台南,2024-03-15,9896
2382,廣達,106,52,54,元大-台南,2024-03-15,9896
2002,中鋼,46,5,41,元大-台南,2024-03-15,9896
00712,復華富時不動產,40,0,40,元大-台南,2024-03-15,9896
2330,台積電,38,3,35,元大-台南,2024-03-15,9896
8011,台通,36,1,35,元大-台南,2024-03-15,9896
3313,斐成,33,0,33,元大-台南,2024-03-15,9896
00933B,國泰10Y+金融債,123,90,33,元大-台南,2024-03-15,9896
00795B,中信美國公債20年,32,0,32,元大-台南,2024-03-15,9896
9950,萬國通,31,0,31,元大-台南,2024-03-15,9896
00918,大華優利高填息30,61,30,31,元大-台南,2024-03-15,9896
2356,英業達,56,26,30,元大-台南,2024-03-15,9896
5388,中磊,28,0,28,元大-台南,2024-03-15,9896
2409,友達,74,48,26,元大-台南,2024-03-15,9896
2303,聯電,66,40,26,元大-台南,2024-03-15,9896
3390,旭軟,46,20,26,元大-台南,2024-03-15,9896
2611,志信,53,27,26,元大-台南,2024-03-15,9896
1732,毛寶,25,0,25,元大-台南,2024-03-15,9896
2610,華航,30,6,24,元大-台南,2024-03-15,9896
1815,富喬,29,5,24,元大-台南,2024-03-15,9896
00700,富邦�琤肭磪�,23,0,23,元大-台南,2024-03-15,9896
3325,旭品,23,0,23,元大-台南,2024-03-15,9896
1513,中興電,142,122,20,元大-台南,2024-03-15,9896
1210,大成,22,2,20,元大-台南,2024-03-15,9896
1906,寶隆,20,0,20,元大-台南,2024-03-15,9896
4420,光明,20,1,19,元大-台南,2024-03-15,9896
00885,富邦越南,27,8,19,元大-台南,2024-03-15,9896
2027,大成鋼,34,15,19,元大-台南,2024-03-15,9896
4906,正文,22,4,18,元大-台南,2024-03-15,9896
00720B,元大投資級公司債,23,5,18,元大-台南,2024-03-15,9896
2020,美亞,18,1,17,元大-台南,2024-03-15,9896
00637L,元大滬深300正2,25,8,17,元大-台南,2024-03-15,9896
9945,潤泰新,16,0,16,元大-台南,2024-03-15,9896
2327,國巨,16,0,16,元大-台南,2024-03-15,9896
2511,太子,15,0,15,元大-台南,2024-03-15,9896
6179,亞通,15,0,15,元大-台南,2024-03-15,9896
6120,達運,15,0,15,元大-台南,2024-03-15,9896
00919,群益台灣精選高息,301,42,259,元大-台南,2024-03-18,9896
00720B,元大投資級公司債,214,1,213,元大-台南,2024-03-18,9896
00632R,元大台灣50反1,208,0,208,元大-台南,2024-03-18,9896
00937B,群益ESG投等債20,141,12,129,元大-台南,2024-03-18,9896
00679B,元大美債20年,126,1,125,元大-台南,2024-03-18,9896
00941,中信上游半導體,136,12,124,元大-台南,2024-03-18,9896
2889,國票金,113,0,113,元大-台南,2024-03-18,9896
3056,富華新,101,0,101,元大-台南,2024-03-18,9896
00687B,國泰20年美債,88,0,88,元大-台南,2024-03-18,9896
00933B,國泰10Y+金融債,87,12,75,元大-台南,2024-03-18,9896
2834,臺企銀,289,216,73,元大-台南,2024-03-18,9896
2357,華碩,58,0,58,元大-台南,2024-03-18,9896
00650L,復華香港正2,58,0,58,元大-台南,2024-03-18,9896
5488,松普,57,0,57,元大-台南,2024-03-18,9896
1444,力麗,64,8,56,元大-台南,2024-03-18,9896
1326,台化,50,0,50,元大-台南,2024-03-18,9896
00673R,期元大S＆P原油反1,45,0,45,元大-台南,2024-03-18,9896
00680L,元大美債20正2,53,12,41,元大-台南,2024-03-18,9896
00918,大華優利高填息30,55,17,38,元大-台南,2024-03-18,9896
2884,玉山金,88,52,36,元大-台南,2024-03-18,9896
2883,凱基金,65,29,36,元大-台南,2024-03-18,9896
00725B,國泰投資級公司債,35,0,35,元大-台南,2024-03-18,9896
2025,千興,33,0,33,元大-台南,2024-03-18,9896
00688L,國泰20年美債正2,33,0,33,元大-台南,2024-03-18,9896
2888,新光金,38,8,30,元大-台南,2024-03-18,9896
00795B,中信美國公債20年,30,0,30,元大-台南,2024-03-18,9896
2882,國泰金,34,5,29,元大-台南,2024-03-18,9896
2002,中鋼,33,6,27,元大-台南,2024-03-18,9896
2107,厚生,26,0,26,元大-台南,2024-03-18,9896
00712,復華富時不動產,30,5,25,元大-台南,2024-03-18,9896
1522,堤維西,51,26,25,元大-台南,2024-03-18,9896
1102,亞泥,25,1,24,元大-台南,2024-03-18,9896
00857B,永豐20年美公債,23,0,23,元大-台南,2024-03-18,9896
00751B,元大AAA至A公司債,22,0,22,元大-台南,2024-03-18,9896
2324,仁寶,31,10,21,元大-台南,2024-03-18,9896
2353,宏��,24,3,21,元大-台南,2024-03-18,9896
6806,森崴能源,23,2,21,元大-台南,2024-03-18,9896
2449,京元電子,39,18,21,元大-台南,2024-03-18,9896
2880,華南金,20,0,20,元大-台南,2024-03-18,9896
2610,華航,19,0,19,元大-台南,2024-03-18,9896
2603,長榮,38,20,18,元大-台南,2024-03-18,9896
00878,國泰永續高股息,27,10,17,元大-台南,2024-03-18,9896
1101,台泥,18,1,17,元大-台南,2024-03-18,9896
00706L,期元大S＆P日圓正2,17,0,17,元大-台南,2024-03-18,9896
00891,中信關鍵半導體,15,0,15,元大-台南,2024-03-18,9896
2382,廣達,32,18,14,元大-台南,2024-03-18,9896
6125,廣運,24,10,14,元大-台南,2024-03-18,9896
3036,文曄,15,1,14,元大-台南,2024-03-18,9896
00927,群益半導體收益,14,1,13,元大-台南,2024-03-18,9896
8942,森鉅,13,0,13,元大-台南,2024-03-18,9896
00680L,元大美債20正2,676,7,669,元大-台南,2024-03-19,9896
00857B,永豐20年美公債,250,0,250,元大-台南,2024-03-19,9896
1504,東元,247,84,163,元大-台南,2024-03-19,9896
3231,緯創,234,78,156,元大-台南,2024-03-19,9896
00937B,群益ESG投等債20,146,2,144,元大-台南,2024-03-19,9896
00687B,國泰20年美債,129,0,129,元大-台南,2024-03-19,9896
2834,臺企銀,135,18,117,元大-台南,2024-03-19,9896
00679B,元大美債20年,114,6,108,元大-台南,2024-03-19,9896
2887,台新金,93,0,93,元大-台南,2024-03-19,9896
00919,群益台灣精選高息,229,138,91,元大-台南,2024-03-19,9896
3481,群創,91,2,89,元大-台南,2024-03-19,9896
00941,中信上游半導體,87,8,79,元大-台南,2024-03-19,9896
00931B,統一美債20年,60,0,60,元大-台南,2024-03-19,9896
1101,台泥,59,0,59,元大-台南,2024-03-19,9896
2345,智邦,57,1,56,元大-台南,2024-03-19,9896
00706L,期元大S＆P日圓正2,56,0,56,元大-台南,2024-03-19,9896
1326,台化,54,0,54,元大-台南,2024-03-19,9896
00673R,期元大S＆P原油反1,51,0,51,元大-台南,2024-03-19,9896
2367,燿華,94,50,44,元大-台南,2024-03-19,9896
00918,大華優利高填息30,45,3,42,元大-台南,2024-03-19,9896
2605,新興,43,1,42,元大-台南,2024-03-19,9896
3512,皇龍,34,0,34,元大-台南,2024-03-19,9896
2208,台船,41,10,31,元大-台南,2024-03-19,9896
1605,華新,38,9,29,元大-台南,2024-03-19,9896
9105,泰金寶-DR,58,30,28,元大-台南,2024-03-19,9896
1714,和桐,26,0,26,元大-台南,2024-03-19,9896
00632R,元大台灣50反1,72,47,25,元大-台南,2024-03-19,9896
1316,上曜,24,0,24,元大-台南,2024-03-19,9896
2344,華邦電,26,2,24,元大-台南,2024-03-19,9896
2889,國票金,23,0,23,元大-台南,2024-03-19,9896
6179,亞通,21,0,21,元大-台南,2024-03-19,9896
00878,國泰永續高股息,23,3,20,元大-台南,2024-03-19,9896
2353,宏��,30,10,20,元大-台南,2024-03-19,9896
3090,日電貿,20,0,20,元大-台南,2024-03-19,9896
1806,冠軍,20,0,20,元大-台南,2024-03-19,9896
6217,中探針,20,0,20,元大-台南,2024-03-19,9896
00720B,元大投資級公司債,48,30,18,元大-台南,2024-03-19,9896
6244,茂迪,17,0,17,元大-台南,2024-03-19,9896
1503,士電,53,36,17,元大-台南,2024-03-19,9896
5515,建國,18,2,16,元大-台南,2024-03-19,9896
3715,定穎投控,19,3,16,元大-台南,2024-03-19,9896
6275,元山,21,5,16,元大-台南,2024-03-19,9896
00724B,群益投資級金融債,15,0,15,元大-台南,2024-03-19,9896
00927,群益半導體收益,20,5,15,元大-台南,2024-03-19,9896
2603,長榮,56,42,14,元大-台南,2024-03-19,9896
2355,敬鵬,14,0,14,元大-台南,2024-03-19,9896
6770,力積電,23,9,14,元大-台南,2024-03-19,9896
2880,華南金,14,0,14,元大-台南,2024-03-19,9896
2025,千興,14,0,14,元大-台南,2024-03-19,9896
2542,興富發,13,0,13,元大-台南,2024-03-19,9896
00919,群益台灣精選高息,1961,315,1646,元大-台南,2024-03-20,9896
00939,統一台灣高息動能,1064,96,968,元大-台南,2024-03-20,9896
00680L,元大美債20正2,603,47,556,元大-台南,2024-03-20,9896
00929,復華台灣科技優息,257,92,165,元大-台南,2024-03-20,9896
3512,皇龍,140,0,140,元大-台南,2024-03-20,9896
00673R,期元大S＆P原油反1,127,0,127,元大-台南,2024-03-20,9896
00857B,永豐20年美公債,105,0,105,元大-台南,2024-03-20,9896
8069,元太,102,2,100,元大-台南,2024-03-20,9896
00665L,富邦�琤肭磪囓�2,529,435,94,元大-台南,2024-03-20,9896
00937B,群益ESG投等債20,108,19,89,元大-台南,2024-03-20,9896
2356,英業達,113,38,75,元大-台南,2024-03-20,9896
2883,凱基金,73,6,67,元大-台南,2024-03-20,9896
1609,大亞,71,6,65,元大-台南,2024-03-20,9896
8926,台汽電,71,6,65,元大-台南,2024-03-20,9896
00679B,元大美債20年,107,46,61,元大-台南,2024-03-20,9896
2303,聯電,145,84,61,元大-台南,2024-03-20,9896
4938,和碩,113,56,57,元大-台南,2024-03-20,9896
00706L,期元大S＆P日圓正2,57,0,57,元大-台南,2024-03-20,9896
2603,長榮,91,34,57,元大-台南,2024-03-20,9896
4960,誠美材,104,50,54,元大-台南,2024-03-20,9896
00688L,國泰20年美債正2,50,0,50,元大-台南,2024-03-20,9896
00712,復華富時不動產,115,68,47,元大-台南,2024-03-20,9896
2345,智邦,46,0,46,元大-台南,2024-03-20,9896
2317,鴻海,162,118,44,元大-台南,2024-03-20,9896
00720B,元大投資級公司債,56,13,43,元大-台南,2024-03-20,9896
5347,世界,52,11,41,元大-台南,2024-03-20,9896
2354,鴻準,55,16,39,元大-台南,2024-03-20,9896
2618,長榮航,54,16,38,元大-台南,2024-03-20,9896
6005,群益證,37,2,35,元大-台南,2024-03-20,9896
5009,榮剛,33,0,33,元大-台南,2024-03-20,9896
1101,台泥,33,2,31,元大-台南,2024-03-20,9896
3231,緯創,69,39,30,元大-台南,2024-03-20,9896
00915,凱基優選高股息30,47,17,30,元大-台南,2024-03-20,9896
5488,松普,40,12,28,元大-台南,2024-03-20,9896
2367,燿華,36,9,27,元大-台南,2024-03-20,9896
3056,富華新,26,0,26,元大-台南,2024-03-20,9896
2313,華通,39,13,26,元大-台南,2024-03-20,9896
2457,飛宏,24,0,24,元大-台南,2024-03-20,9896
2885,元大金,28,5,23,元大-台南,2024-03-20,9896
9907,統一實,23,0,23,元大-台南,2024-03-20,9896
5522,遠雄,23,0,23,元大-台南,2024-03-20,9896
00931B,統一美債20年,22,0,22,元大-台南,2024-03-20,9896
2393,億光,22,0,22,元大-台南,2024-03-20,9896
00941,中信上游半導體,42,20,22,元大-台南,2024-03-20,9896
6176,瑞儀,51,30,21,元大-台南,2024-03-20,9896
2337,旺宏,21,0,21,元大-台南,2024-03-20,9896
2880,華南金,21,0,21,元大-台南,2024-03-20,9896
5388,中磊,26,7,19,元大-台南,2024-03-20,9896
6139,亞翔,22,3,19,元大-台南,2024-03-20,9896
3481,群創,39,20,19,元大-台南,2024-03-20,9896
00632R,元大台灣50反1,483,162,321,元大-台南,2024-03-21,9896
00939,統一台灣高息動能,388,69,319,元大-台南,2024-03-21,9896
00929,復華台灣科技優息,233,74,159,元大-台南,2024-03-21,9896
00919,群益台灣精選高息,187,30,157,元大-台南,2024-03-21,9896
2002,中鋼,125,33,92,元大-台南,2024-03-21,9896
00857B,永豐20年美公債,90,10,80,元大-台南,2024-03-21,9896
00680L,元大美債20正2,79,0,79,元大-台南,2024-03-21,9896
00688L,國泰20年美債正2,78,0,78,元大-台南,2024-03-21,9896
00687B,國泰20年美債,198,131,67,元大-台南,2024-03-21,9896
00679B,元大美債20年,67,16,51,元大-台南,2024-03-21,9896
00719B,元大美債1-3,40,0,40,元大-台南,2024-03-21,9896
2845,遠東銀,40,1,39,元大-台南,2024-03-21,9896
2618,長榮航,90,57,33,元大-台南,2024-03-21,9896
00720B,元大投資級公司債,34,2,32,元大-台南,2024-03-21,9896
8926,台汽電,34,3,31,元大-台南,2024-03-21,9896
5483,中美晶,36,9,27,元大-台南,2024-03-21,9896
2367,燿華,98,73,25,元大-台南,2024-03-21,9896
2834,臺企銀,31,8,23,元大-台南,2024-03-21,9896
6191,精成科,52,29,23,元大-台南,2024-03-21,9896
2301,光寶科,50,27,23,元大-台南,2024-03-21,9896
4979,華星光,23,0,23,元大-台南,2024-03-21,9896
2354,鴻準,40,18,22,元大-台南,2024-03-21,9896
5288,豐祥-KY,22,0,22,元大-台南,2024-03-21,9896
2812,台中銀,23,2,21,元大-台南,2024-03-21,9896
00937B,群益ESG投等債20,56,34,22,元大-台南,2024-03-21,9896
2323,中環,23,3,20,元大-台南,2024-03-21,9896
8074,鉅橡,20,0,20,元大-台南,2024-03-21,9896
3576,聯合再生,20,1,19,元大-台南,2024-03-21,9896
2405,輔信,22,3,19,元大-台南,2024-03-21,9896
2603,長榮,39,20,19,元大-台南,2024-03-21,9896
00795B,中信美國公債20年,19,0,19,元大-台南,2024-03-21,9896
00933B,國泰10Y+金融債,18,0,18,元大-台南,2024-03-21,9896
5481,新華,17,0,17,元大-台南,2024-03-21,9896
3594,磐儀,18,1,17,元大-台南,2024-03-21,9896
2369,菱生,20,4,16,元大-台南,2024-03-21,9896
3005,神基,37,22,15,元大-台南,2024-03-21,9896
3024,憶聲,13,0,13,元大-台南,2024-03-21,9896
2231,為升,13,0,13,元大-台南,2024-03-21,9896
5508,永信建,14,1,13,元大-台南,2024-03-21,9896
2025,千興,13,0,13,元大-台南,2024-03-21,9896
6015,宏遠證,13,0,13,元大-台南,2024-03-21,9896
2329,華泰,42,29,13,元大-台南,2024-03-21,9896
2385,群光,19,6,13,元大-台南,2024-03-21,9896
2254,巨鎧精密-創,16,4,12,元大-台南,2024-03-21,9896
2355,敬鵬,13,1,12,元大-台南,2024-03-21,9896
8466,美吉吉-KY,12,0,12,元大-台南,2024-03-21,9896
6414,樺漢,15,3,12,元大-台南,2024-03-21,9896
2327,國巨,17,5,12,元大-台南,2024-03-21,9896
4906,正文,17,7,10,元大-台南,2024-03-21,9896
1460,宏遠,10,0,10,元大-台南,2024-03-21,9896
00632R,元大台灣50反1,16034,95,15939,元大-台南,2024-03-22,9896
00937B,群益ESG投等債20,783,44,739,元大-台南,2024-03-22,9896
00720B,元大投資級公司債,252,17,235,元大-台南,2024-03-22,9896
00650L,復華香港正2,214,0,214,元大-台南,2024-03-22,9896
00939,統一台灣高息動能,218,61,157,元大-台南,2024-03-22,9896
00679B,元大美債20年,145,2,143,元大-台南,2024-03-22,9896
2353,宏��,205,82,123,元大-台南,2024-03-22,9896
2323,中環,114,2,112,元大-台南,2024-03-22,9896
3706,神達,193,121,72,元大-台南,2024-03-22,9896
2354,鴻準,78,12,66,元大-台南,2024-03-22,9896
00941,中信上游半導體,81,15,66,元大-台南,2024-03-22,9896
1316,上曜,66,3,63,元大-台南,2024-03-22,9896
6248,沛波,50,0,50,元大-台南,2024-03-22,9896
00857B,永豐20年美公債,48,0,48,元大-台南,2024-03-22,9896
9105,泰金寶-DR,42,0,42,元大-台南,2024-03-22,9896
5706,鳳凰,40,0,40,元大-台南,2024-03-22,9896
4714,永捷,44,9,35,元大-台南,2024-03-22,9896
2303,聯電,89,56,33,元大-台南,2024-03-22,9896
1503,士電,68,36,32,元大-台南,2024-03-22,9896
2374,佳能,30,0,30,元大-台南,2024-03-22,9896
6770,力積電,33,3,30,元大-台南,2024-03-22,9896
3260,威剛,43,13,30,元大-台南,2024-03-22,9896
6182,合晶,28,0,28,元大-台南,2024-03-22,9896
5498,凱崴,33,6,27,元大-台南,2024-03-22,9896
6257,矽格,26,0,26,元大-台南,2024-03-22,9896
2206,三陽工業,27,1,26,元大-台南,2024-03-22,9896
6443,元晶,39,13,26,元大-台南,2024-03-22,9896
00931B,統一美債20年,25,0,25,元大-台南,2024-03-22,9896
00719B,元大美債1-3,31,8,23,元大-台南,2024-03-22,9896
00915,凱基優選高股息30,29,7,22,元大-台南,2024-03-22,9896
2408,南亞科,75,54,21,元大-台南,2024-03-22,9896
00676R,富邦臺灣加權反1,21,0,21,元大-台南,2024-03-22,9896
4303,信立,24,3,21,元大-台南,2024-03-22,9896
5469,瀚宇博,24,3,21,元大-台南,2024-03-22,9896
1736,喬山,20,0,20,元大-台南,2024-03-22,9896
3704,合勤控,27,7,20,元大-台南,2024-03-22,9896
1784,訊聯,20,0,20,元大-台南,2024-03-22,9896
8926,台汽電,22,3,19,元大-台南,2024-03-22,9896
8473,山林水,23,4,19,元大-台南,2024-03-22,9896
5288,豐祥-KY,20,1,19,元大-台南,2024-03-22,9896
5443,均豪,45,26,19,元大-台南,2024-03-22,9896
2406,國碩,29,10,19,元大-台南,2024-03-22,9896
1714,和桐,20,2,18,元大-台南,2024-03-22,9896
2208,台船,18,0,18,元大-台南,2024-03-22,9896
2371,大同,22,4,18,元大-台南,2024-03-22,9896
2609,陽明,21,4,17,元大-台南,2024-03-22,9896
1529,樂事綠能,18,1,17,元大-台南,2024-03-22,9896
3264,欣銓,18,1,17,元大-台南,2024-03-22,9896
2376,技嘉,52,35,17,元大-台南,2024-03-22,9896
2324,仁寶,64,48,16,元大-台南,2024-03-22,9896
00937B,群益ESG投等債20,190,27,163,元大-台南,2024-03-25,9896
00939,統一台灣高息動能,162,23,139,元大-台南,2024-03-25,9896
00680L,元大美債20正2,145,8,137,元大-台南,2024-03-25,9896
1301,台塑,102,3,99,元大-台南,2024-03-25,9896
2356,英業達,168,75,93,元大-台南,2024-03-25,9896
00941,中信上游半導體,118,31,87,元大-台南,2024-03-25,9896
2409,友達,109,24,85,元大-台南,2024-03-25,9896
00688L,國泰20年美債正2,180,106,74,元大-台南,2024-03-25,9896
00720B,元大投資級公司債,62,2,60,元大-台南,2024-03-25,9896
5880,合庫金,51,1,50,元大-台南,2024-03-25,9896
00687B,國泰20年美債,60,13,47,元大-台南,2024-03-25,9896
2367,燿華,82,42,40,元大-台南,2024-03-25,9896
2359,所羅門,44,5,39,元大-台南,2024-03-25,9896
1609,大亞,293,260,33,元大-台南,2024-03-25,9896
2353,宏��,76,47,29,元大-台南,2024-03-25,9896
3706,神達,74,45,29,元大-台南,2024-03-25,9896
00931B,統一美債20年,29,0,29,元大-台南,2024-03-25,9896
2834,臺企銀,32,3,29,元大-台南,2024-03-25,9896
3062,建漢,47,18,29,元大-台南,2024-03-25,9896
00632R,元大台灣50反1,58,31,27,元大-台南,2024-03-25,9896
00857B,永豐20年美公債,39,13,26,元大-台南,2024-03-25,9896
2401,凌陽,25,0,25,元大-台南,2024-03-25,9896
2354,鴻準,30,6,24,元大-台南,2024-03-25,9896
2002,中鋼,26,3,23,元大-台南,2024-03-25,9896
2301,光寶科,32,9,23,元大-台南,2024-03-25,9896
00679B,元大美債20年,45,22,23,元大-台南,2024-03-25,9896
1101,台泥,23,2,21,元大-台南,2024-03-25,9896
00772B,中信高評級公司債,21,0,21,元大-台南,2024-03-25,9896
00713,元大台灣高息低波,22,1,21,元大-台南,2024-03-25,9896
2303,聯電,77,57,20,元大-台南,2024-03-25,9896
4563,百德,21,1,20,元大-台南,2024-03-25,9896
1723,中碳,20,0,20,元大-台南,2024-03-25,9896
8112,至上,27,7,20,元大-台南,2024-03-25,9896
6016,康和證,23,4,19,元大-台南,2024-03-25,9896
5439,高技,26,8,18,元大-台南,2024-03-25,9896
2352,佳世達,24,6,18,元大-台南,2024-03-25,9896
2630,亞航,27,11,16,元大-台南,2024-03-25,9896
00933B,國泰10Y+金融債,25,10,15,元大-台南,2024-03-25,9896
2009,第一銅,16,1,15,元大-台南,2024-03-25,9896
4938,和碩,26,12,14,元大-台南,2024-03-25,9896
5258,虹堡,27,13,14,元大-台南,2024-03-25,9896
2891,中信金,14,2,12,元大-台南,2024-03-25,9896
2881,富邦金,15,3,12,元大-台南,2024-03-25,9896
00673R,期元大S＆P原油反1,12,0,12,元大-台南,2024-03-25,9896
2376,技嘉,19,7,12,元大-台南,2024-03-25,9896
6488,環球晶,11,0,11,元大-台南,2024-03-25,9896
3374,精材,12,1,11,元大-台南,2024-03-25,9896
3011,今皓,11,0,11,元大-台南,2024-03-25,9896
2017,官田鋼,11,0,11,元大-台南,2024-03-25,9896
1616,億泰,11,0,11,元大-台南,2024-03-25,9896
00939,統一台灣高息動能,291,72,219,元大-台南,2024-03-26,9896
00937B,群益ESG投等債20,208,14,194,元大-台南,2024-03-26,9896
2834,臺企銀,113,6,107,元大-台南,2024-03-26,9896
00923,群益台ESG低碳50,107,1,106,元大-台南,2024-03-26,9896
00650L,復華香港正2,100,0,100,元大-台南,2024-03-26,9896
00922,國泰台灣領袖50,102,6,96,元大-台南,2024-03-26,9896
2353,宏��,76,4,72,元大-台南,2024-03-26,9896
00907,永豐優息存股,61,0,61,元大-台南,2024-03-26,9896
00679B,元大美債20年,81,21,60,元大-台南,2024-03-26,9896
2356,英業達,128,72,56,元大-台南,2024-03-26,9896
3231,緯創,80,24,56,元大-台南,2024-03-26,9896
00720B,元大投資級公司債,112,57,55,元大-台南,2024-03-26,9896
2812,台中銀,50,0,50,元大-台南,2024-03-26,9896
2630,亞航,50,0,50,元大-台南,2024-03-26,9896
2618,長榮航,46,5,41,元大-台南,2024-03-26,9896
00688L,國泰20年美債正2,144,105,39,元大-台南,2024-03-26,9896
00941,中信上游半導體,63,25,38,元大-台南,2024-03-26,9896
1513,中興電,133,97,36,元大-台南,2024-03-26,9896
00687B,國泰20年美債,48,13,35,元大-台南,2024-03-26,9896
2317,鴻海,65,31,34,元大-台南,2024-03-26,9896
1609,大亞,202,169,33,元大-台南,2024-03-26,9896
9933,中鼎,35,2,33,元大-台南,2024-03-26,9896
8112,至上,43,12,31,元大-台南,2024-03-26,9896
3276,宇環,30,2,28,元大-台南,2024-03-26,9896
6282,康舒,28,4,24,元大-台南,2024-03-26,9896
3264,欣銓,24,0,24,元大-台南,2024-03-26,9896
2313,華通,42,23,19,元大-台南,2024-03-26,9896
3703,欣陸,20,1,19,元大-台南,2024-03-26,9896
8064,東捷,24,5,19,元大-台南,2024-03-26,9896
2101,南港,19,0,19,元大-台南,2024-03-26,9896
2352,佳世達,33,14,19,元大-台南,2024-03-26,9896
0056,元大高股息,36,18,18,元大-台南,2024-03-26,9896
6125,廣運,62,45,17,元大-台南,2024-03-26,9896
1514,亞力,42,25,17,元大-台南,2024-03-26,9896
2376,技嘉,25,9,16,元大-台南,2024-03-26,9896
2892,第一金,22,6,16,元大-台南,2024-03-26,9896
6147,頎邦,17,2,15,元大-台南,2024-03-26,9896
2603,長榮,19,4,15,元大-台南,2024-03-26,9896
4979,華星光,20,5,15,元大-台南,2024-03-26,9896
2417,圓剛,20,5,15,元大-台南,2024-03-26,9896
8121,越峰,15,0,15,元大-台南,2024-03-26,9896
6770,力積電,19,5,14,元大-台南,2024-03-26,9896
00673R,期元大S＆P原油反1,14,0,14,元大-台南,2024-03-26,9896
00696B,富邦美債20年,14,0,14,元大-台南,2024-03-26,9896
6133,金橋,126,112,14,元大-台南,2024-03-26,9896
2359,所羅門,98,85,13,元大-台南,2024-03-26,9896
5381,合正,15,2,13,元大-台南,2024-03-26,9896
3030,德律,12,0,12,元大-台南,2024-03-26,9896
2025,千興,12,0,12,元大-台南,2024-03-26,9896
4743,合一,12,0,12,元大-台南,2024-03-26,9896
00650L,復華香港正2,500,0,500,元大-台南,2024-03-27,9896
00918,大華優利高填息30,416,0,416,元大-台南,2024-03-27,9896
2834,臺企銀,240,0,240,元大-台南,2024-03-27,9896
3481,群創,123,14,109,元大-台南,2024-03-27,9896
00937B,群益ESG投等債20,97,0,97,元大-台南,2024-03-27,9896
2371,大同,176,91,85,元大-台南,2024-03-27,9896
1785,光洋科,75,14,61,元大-台南,2024-03-27,9896
00939,統一台灣高息動能,110,53,57,元大-台南,2024-03-27,9896
3231,緯創,70,25,45,元大-台南,2024-03-27,9896
2301,光寶科,52,7,45,元大-台南,2024-03-27,9896
00632R,元大台灣50反1,52,10,42,元大-台南,2024-03-27,9896
6248,沛波,40,1,39,元大-台南,2024-03-27,9896
2913,農林,37,0,37,元大-台南,2024-03-27,9896
8033,雷虎,41,8,33,元大-台南,2024-03-27,9896
1532,勤美,31,0,31,元大-台南,2024-03-27,9896
3047,訊舟,32,1,31,元大-台南,2024-03-27,9896
6133,金橋,132,101,31,元大-台南,2024-03-27,9896
00720B,元大投資級公司債,32,2,30,元大-台南,2024-03-27,9896
00941,中信上游半導體,38,9,29,元大-台南,2024-03-27,9896
00891,中信關鍵半導體,31,2,29,元大-台南,2024-03-27,9896
2002,中鋼,27,1,26,元大-台南,2024-03-27,9896
00923,群益台ESG低碳50,32,7,25,元大-台南,2024-03-27,9896
00706L,期元大S＆P日圓正2,23,0,23,元大-台南,2024-03-27,9896
00712,復華富時不動產,24,2,22,元大-台南,2024-03-27,9896
00857B,永豐20年美公債,20,0,20,元大-台南,2024-03-27,9896
6125,廣運,39,20,19,元大-台南,2024-03-27,9896
8112,至上,51,33,18,元大-台南,2024-03-27,9896
1529,樂事綠能,18,0,18,元大-台南,2024-03-27,9896
00679B,元大美債20年,34,16,18,元大-台南,2024-03-27,9896
2605,新興,20,3,17,元大-台南,2024-03-27,9896
2408,南亞科,18,1,17,元大-台南,2024-03-27,9896
00933B,國泰10Y+金融債,15,0,15,元大-台南,2024-03-27,9896
2888,新光金,14,0,14,元大-台南,2024-03-27,9896
2504,國產,20,6,14,元大-台南,2024-03-27,9896
2486,一詮,34,21,13,元大-台南,2024-03-27,9896
1808,潤隆,16,3,13,元大-台南,2024-03-27,9896
00715L,期街口布蘭特正2,13,0,13,元大-台南,2024-03-27,9896
2344,華邦電,13,1,12,元大-台南,2024-03-27,9896
3059,華晶科,13,1,12,元大-台南,2024-03-27,9896
3260,威剛,17,6,11,元大-台南,2024-03-27,9896
6197,佳必琪,12,2,10,元大-台南,2024-03-27,9896
5521,工信,41,31,10,元大-台南,2024-03-27,9896
3013,晟銘電,29,19,10,元大-台南,2024-03-27,9896
00931B,統一美債20年,10,0,10,元大-台南,2024-03-27,9896
6024,群益期,10,0,10,元大-台南,2024-03-27,9896
4157,太景*-KY,10,0,10,元大-台南,2024-03-27,9896
9105,泰金寶-DR,45,35,10,元大-台南,2024-03-27,9896
2104,國際中橡,10,0,10,元大-台南,2024-03-27,9896
2498,宏達電,10,0,10,元大-台南,2024-03-27,9896
2385,群光,11,2,9,元大-台南,2024-03-27,9896
00650L,復華香港正2,310,0,310,元大-台南,2024-03-28,9896
00857B,永豐20年美公債,201,35,166,元大-台南,2024-03-28,9896
6443,元晶,147,5,142,元大-台南,2024-03-28,9896
00673R,期元大S＆P原油反1,105,0,105,元大-台南,2024-03-28,9896
2883,凱基金,146,44,102,元大-台南,2024-03-28,9896
3706,神達,103,46,57,元大-台南,2024-03-28,9896
6248,沛波,62,11,51,元大-台南,2024-03-28,9896
2317,鴻海,146,98,48,元大-台南,2024-03-28,9896
00919,群益台灣精選高息,87,42,45,元大-台南,2024-03-28,9896
2356,英業達,58,13,45,元大-台南,2024-03-28,9896
2888,新光金,42,0,42,元大-台南,2024-03-28,9896
00937B,群益ESG投等債20,51,12,39,元大-台南,2024-03-28,9896
2002,中鋼,35,0,35,元大-台南,2024-03-28,9896
3062,建漢,63,29,34,元大-台南,2024-03-28,9896
2880,華南金,34,1,33,元大-台南,2024-03-28,9896
2457,飛宏,32,0,32,元大-台南,2024-03-28,9896
2367,燿華,53,21,32,元大-台南,2024-03-28,9896
00939,統一台灣高息動能,51,20,31,元大-台南,2024-03-28,9896
2913,農林,30,1,29,元大-台南,2024-03-28,9896
00882,中信中國高股息,29,1,28,元大-台南,2024-03-28,9896
6284,佳邦,32,5,27,元大-台南,2024-03-28,9896
00941,中信上游半導體,27,2,25,元大-台南,2024-03-28,9896
2025,千興,25,0,25,元大-台南,2024-03-28,9896
2301,光寶科,46,24,22,元大-台南,2024-03-28,9896
00934,中信成長高股息,22,0,22,元大-台南,2024-03-28,9896
3512,皇龍,45,23,22,元大-台南,2024-03-28,9896
2610,華航,43,22,21,元大-台南,2024-03-28,9896
1103,嘉泥,21,0,21,元大-台南,2024-03-28,9896
00923,群益台ESG低碳50,20,0,20,元大-台南,2024-03-28,9896
2867,三商壽,20,0,20,元大-台南,2024-03-28,9896
6196,帆宣,20,0,20,元大-台南,2024-03-28,9896
5483,中美晶,19,0,19,元大-台南,2024-03-28,9896
3294,英濟,19,2,17,元大-台南,2024-03-28,9896
00772B,中信高評級公司債,17,0,17,元大-台南,2024-03-28,9896
00933B,國泰10Y+金融債,16,0,16,元大-台南,2024-03-28,9896
2408,南亞科,19,3,16,元大-台南,2024-03-28,9896
2354,鴻準,153,138,15,元大-台南,2024-03-28,9896
2892,第一金,15,0,15,元大-台南,2024-03-28,9896
00662,富邦NASDAQ,15,0,15,元大-台南,2024-03-28,9896
6241,易通展,15,0,15,元大-台南,2024-03-28,9896
2303,聯電,109,94,15,元大-台南,2024-03-28,9896
8016,矽創,15,0,15,元大-台南,2024-03-28,9896
1101,台泥,18,4,14,元大-台南,2024-03-28,9896
2501,國建,15,1,14,元大-台南,2024-03-28,9896
1314,中石化,15,1,14,元大-台南,2024-03-28,9896
2887,台新金,14,0,14,元大-台南,2024-03-28,9896
00929,復華台灣科技優息,72,58,14,元大-台南,2024-03-28,9896
2618,長榮航,23,10,13,元大-台南,2024-03-28,9896
4105,東洋,15,2,13,元大-台南,2024-03-28,9896
2630,亞航,17,4,13,元大-台南,2024-03-28,9896
2301,光寶科,766,15,751,元大-台南,2024-03-29,9896
00933B,國泰10Y+金融債,200,0,200,元大-台南,2024-03-29,9896
00919,群益台灣精選高息,156,76,80,元大-台南,2024-03-29,9896
3481,群創,68,2,66,元大-台南,2024-03-29,9896
2317,鴻海,121,58,63,元大-台南,2024-03-29,9896
2704,國賓,59,0,59,元大-台南,2024-03-29,9896
1504,東元,77,19,58,元大-台南,2024-03-29,9896
2324,仁寶,56,4,52,元大-台南,2024-03-29,9896
5880,合庫金,51,0,51,元大-台南,2024-03-29,9896
2845,遠東銀,50,1,49,元大-台南,2024-03-29,9896
00941,中信上游半導體,51,6,45,元大-台南,2024-03-29,9896
00907,永豐優息存股,44,0,44,元大-台南,2024-03-29,9896
00673R,期元大S＆P原油反1,44,0,44,元大-台南,2024-03-29,9896
2352,佳世達,53,12,41,元大-台南,2024-03-29,9896
2630,亞航,34,2,32,元大-台南,2024-03-29,9896
2359,所羅門,45,13,32,元大-台南,2024-03-29,9896
2382,廣達,125,93,32,元大-台南,2024-03-29,9896
2614,東森,30,0,30,元大-台南,2024-03-29,9896
6133,金橋,120,90,30,元大-台南,2024-03-29,9896
00939,統一台灣高息動能,56,26,30,元大-台南,2024-03-29,9896
00857B,永豐20年美公債,31,1,30,元大-台南,2024-03-29,9896
6753,龍德造船,29,0,29,元大-台南,2024-03-29,9896
4306,炎洲,28,0,28,元大-台南,2024-03-29,9896
3013,晟銘電,100,73,27,元大-台南,2024-03-29,9896
2888,新光金,32,6,26,元大-台南,2024-03-29,9896
1609,大亞,48,22,26,元大-台南,2024-03-29,9896
2303,聯電,234,209,25,元大-台南,2024-03-29,9896
2371,大同,68,46,22,元大-台南,2024-03-29,9896
1815,富喬,52,30,22,元大-台南,2024-03-29,9896
3706,神達,48,28,20,元大-台南,2024-03-29,9896
1806,冠軍,20,0,20,元大-台南,2024-03-29,9896
8201,無敵,20,0,20,元大-台南,2024-03-29,9896
8054,安國,42,22,20,元大-台南,2024-03-29,9896
00764B,群益25年美債,30,11,19,元大-台南,2024-03-29,9896
8112,至上,19,3,16,元大-台南,2024-03-29,9896
00929,復華台灣科技優息,91,76,15,元大-台南,2024-03-29,9896
6284,佳邦,15,1,14,元大-台南,2024-03-29,9896
2025,千興,14,0,14,元大-台南,2024-03-29,9896
3680,家登,16,2,14,元大-台南,2024-03-29,9896
8942,森鉅,13,0,13,元大-台南,2024-03-29,9896
1785,光洋科,24,11,13,元大-台南,2024-03-29,9896
1795,美時,17,4,13,元大-台南,2024-03-29,9896
2417,圓剛,13,0,13,元大-台南,2024-03-29,9896
2820,華票,13,0,13,元大-台南,2024-03-29,9896
2547,日勝生,12,0,12,元大-台南,2024-03-29,9896
6257,矽格,24,12,12,元大-台南,2024-03-29,9896
00888,永豐台灣ESG,12,0,12,元大-台南,2024-03-29,9896
2314,台揚,13,2,11,元大-台南,2024-03-29,9896
3630,新鉅科,11,0,11,元大-台南,2024-03-29,9896
00687B,國泰20年美債,15,4,11,元大-台南,2024-03-29,9896
00940,元大台灣價值高息,2751,1266,1485,元大-台南,2024-04-01,9896
00937B,群益ESG投等債20,587,16,571,元大-台南,2024-04-01,9896
00637L,元大滬深300正2,199,119,80,元大-台南,2024-04-01,9896
00706L,期元大S＆P日圓正2,80,0,80,元大-台南,2024-04-01,9896
1504,東元,87,18,69,元大-台南,2024-04-01,9896
2382,廣達,120,51,69,元大-台南,2024-04-01,9896
2352,佳世達,70,2,68,元大-台南,2024-04-01,9896
00939,統一台灣高息動能,71,5,66,元大-台南,2024-04-01,9896
00919,群益台灣精選高息,108,48,60,元大-台南,2024-04-01,9896
2511,太子,60,0,60,元大-台南,2024-04-01,9896
5880,合庫金,50,0,50,元大-台南,2024-04-01,9896
2356,英業達,73,24,49,元大-台南,2024-04-01,9896
00941,中信上游半導體,54,6,48,元大-台南,2024-04-01,9896
2618,長榮航,124,77,47,元大-台南,2024-04-01,9896
2887,台新金,46,0,46,元大-台南,2024-04-01,9896
2891,中信金,64,20,44,元大-台南,2024-04-01,9896
3481,群創,45,1,44,元大-台南,2024-04-01,9896
2704,國賓,41,0,41,元大-台南,2024-04-01,9896
3231,緯創,61,20,41,元大-台南,2024-04-01,9896
1524,耿鼎,52,15,37,元大-台南,2024-04-01,9896
2328,廣宇,35,1,34,元大-台南,2024-04-01,9896
9933,中鼎,34,0,34,元大-台南,2024-04-01,9896
2025,千興,30,0,30,元大-台南,2024-04-01,9896
2834,臺企銀,31,1,30,元大-台南,2024-04-01,9896
00885,富邦越南,28,0,28,元大-台南,2024-04-01,9896
1609,大亞,35,9,26,元大-台南,2024-04-01,9896
8110,華東,26,0,26,元大-台南,2024-04-01,9896
9906,欣巴巴,26,1,25,元大-台南,2024-04-01,9896
00936,台新永續高息中小,25,1,24,元大-台南,2024-04-01,9896
2337,旺宏,40,16,24,元大-台南,2024-04-01,9896
00673R,期元大S＆P原油反1,24,0,24,元大-台南,2024-04-01,9896
2603,長榮,31,7,24,元大-台南,2024-04-01,9896
2538,基泰,22,0,22,元大-台南,2024-04-01,9896
0056,元大高股息,37,16,21,元大-台南,2024-04-01,9896
2501,國建,22,2,20,元大-台南,2024-04-01,9896
2888,新光金,28,9,19,元大-台南,2024-04-01,9896
3711,日月光投控,19,0,19,元大-台南,2024-04-01,9896
2301,光寶科,20,5,15,元大-台南,2024-04-01,9896
2367,燿華,20,5,15,元大-台南,2024-04-01,9896
4938,和碩,15,1,14,元大-台南,2024-04-01,9896
3036,文曄,16,2,14,元大-台南,2024-04-01,9896
2330,台積電,16,2,14,元大-台南,2024-04-01,9896
1605,華新,17,4,13,元大-台南,2024-04-01,9896
6147,頎邦,14,1,13,元大-台南,2024-04-01,9896
5519,隆大,13,0,13,元大-台南,2024-04-01,9896
00934,中信成長高股息,12,0,12,元大-台南,2024-04-01,9896
4934,太極,15,3,12,元大-台南,2024-04-01,9896
3164,景岳,12,0,12,元大-台南,2024-04-01,9896
6462,神盾,18,6,12,元大-台南,2024-04-01,9896
00679B,元大美債20年,20,8,12,元大-台南,2024-04-01,9896
00632R,元大台灣50反1,404,1,403,元大-台南,2024-04-02,9896
00706L,期元大S＆P日圓正2,351,0,351,元大-台南,2024-04-02,9896
00937B,群益ESG投等債20,289,59,230,元大-台南,2024-04-02,9896
00929,復華台灣科技優息,266,91,175,元大-台南,2024-04-02,9896
00940,元大台灣價值高息,592,419,173,元大-台南,2024-04-02,9896
00941,中信上游半導體,102,2,100,元大-台南,2024-04-02,9896
5880,合庫金,102,22,80,元大-台南,2024-04-02,9896
00637L,元大滬深300正2,76,0,76,元大-台南,2024-04-02,9896
00680L,元大美債20正2,69,0,69,元大-台南,2024-04-02,9896
2511,太子,60,0,60,元大-台南,2024-04-02,9896
6835,圓裕,60,0,60,元大-台南,2024-04-02,9896
00795B,中信美國公債20年,54,0,54,元大-台南,2024-04-02,9896
00688L,國泰20年美債正2,51,0,51,元大-台南,2024-04-02,9896
2371,大同,72,23,49,元大-台南,2024-04-02,9896
3673,TPK-KY,52,4,48,元大-台南,2024-04-02,9896
3706,神達,48,6,42,元大-台南,2024-04-02,9896
00939,統一台灣高息動能,50,11,39,元大-台南,2024-04-02,9896
2344,華邦電,39,1,38,元大-台南,2024-04-02,9896
00764B,群益25年美債,35,0,35,元大-台南,2024-04-02,9896
00931B,統一美債20年,33,0,33,元大-台南,2024-04-02,9896
9945,潤泰新,34,1,33,元大-台南,2024-04-02,9896
00665L,富邦�琤肭磪囓�2,466,436,30,元大-台南,2024-04-02,9896
2404,漢唐,35,5,30,元大-台南,2024-04-02,9896
3583,辛耘,37,9,28,元大-台南,2024-04-02,9896
00673R,期元大S＆P原油反1,30,2,28,元大-台南,2024-04-02,9896
2356,英業達,45,17,28,元大-台南,2024-04-02,9896
00933B,國泰10Y+金融債,44,19,25,元大-台南,2024-04-02,9896
00733,富邦臺灣中小,25,0,25,元大-台南,2024-04-02,9896
3056,富華新,24,0,24,元大-台南,2024-04-02,9896
2354,鴻準,38,14,24,元大-台南,2024-04-02,9896
2834,臺企銀,35,11,24,元大-台南,2024-04-02,9896
00751B,元大AAA至A公司債,22,0,22,元大-台南,2024-04-02,9896
3260,威剛,37,15,22,元大-台南,2024-04-02,9896
00725B,國泰投資級公司債,21,0,21,元大-台南,2024-04-02,9896
8942,森鉅,21,0,21,元大-台南,2024-04-02,9896
6282,康舒,21,0,21,元大-台南,2024-04-02,9896
9105,泰金寶-DR,30,10,20,元大-台南,2024-04-02,9896
8478,東哥遊艇,20,0,20,元大-台南,2024-04-02,9896
2630,亞航,24,6,18,元大-台南,2024-04-02,9896
00772B,中信高評級公司債,17,0,17,元大-台南,2024-04-02,9896
8938,明安,17,0,17,元大-台南,2024-04-02,9896
2408,南亞科,24,8,16,元大-台南,2024-04-02,9896
2892,第一金,17,1,16,元大-台南,2024-04-02,9896
3707,漢磊,18,2,16,元大-台南,2024-04-02,9896
6153,嘉聯益,15,0,15,元大-台南,2024-04-02,9896
1605,華新,16,1,15,元大-台南,2024-04-02,9896
5392,能率,16,1,15,元大-台南,2024-04-02,9896
8011,台通,16,1,15,元大-台南,2024-04-02,9896
0055,元大MSCI金融,15,0,15,元大-台南,2024-04-02,9896
1608,華榮,19,4,15,元大-台南,2024-04-02,9896
00940,元大台灣價值高息,444,199,245,元大-台南,2024-04-03,9896
00929,復華台灣科技優息,238,24,214,元大-台南,2024-04-03,9896
00679B,元大美債20年,169,1,168,元大-台南,2024-04-03,9896
1522,堤維西,97,3,94,元大-台南,2024-04-03,9896
5880,合庫金,84,0,84,元大-台南,2024-04-03,9896
00937B,群益ESG投等債20,190,107,83,元大-台南,2024-04-03,9896
00673R,期元大S＆P原油反1,92,9,83,元大-台南,2024-04-03,9896
00941,中信上游半導體,77,6,71,元大-台南,2024-04-03,9896
00687B,國泰20年美債,73,7,66,元大-台南,2024-04-03,9896
3481,群創,63,0,63,元大-台南,2024-04-03,9896
00795B,中信美國公債20年,62,0,62,元大-台南,2024-04-03,9896
2303,聯電,116,64,52,元大-台南,2024-04-03,9896
00753L,中信中國50正2,50,0,50,元大-台南,2024-04-03,9896
2409,友達,56,10,46,元大-台南,2024-04-03,9896
2486,一詮,118,73,45,元大-台南,2024-04-03,9896
00680L,元大美債20正2,45,0,45,元大-台南,2024-04-03,9896
00720B,元大投資級公司債,61,18,43,元大-台南,2024-04-03,9896
6288,聯嘉,49,9,40,元大-台南,2024-04-03,9896
2359,所羅門,42,3,39,元大-台南,2024-04-03,9896
2317,鴻海,62,28,34,元大-台南,2024-04-03,9896
1605,華新,43,11,32,元大-台南,2024-04-03,9896
2371,大同,44,13,31,元大-台南,2024-04-03,9896
00637L,元大滬深300正2,31,0,31,元大-台南,2024-04-03,9896
2603,長榮,31,5,26,元大-台南,2024-04-03,9896
00751B,元大AAA至A公司債,23,0,23,元大-台南,2024-04-03,9896
2382,廣達,43,20,23,元大-台南,2024-04-03,9896
2344,華邦電,21,0,21,元大-台南,2024-04-03,9896
00927,群益半導體收益,21,0,21,元大-台南,2024-04-03,9896
2354,鴻準,23,3,20,元大-台南,2024-04-03,9896
00857B,永豐20年美公債,20,0,20,元大-台南,2024-04-03,9896
1609,大亞,35,15,20,元大-台南,2024-04-03,9896
1795,美時,25,5,20,元大-台南,2024-04-03,9896
00933B,國泰10Y+金融債,28,9,19,元大-台南,2024-04-03,9896
1785,光洋科,21,2,19,元大-台南,2024-04-03,9896
2634,漢翔,33,14,19,元大-台南,2024-04-03,9896
6226,光鼎,98,80,18,元大-台南,2024-04-03,9896
2412,中華電,19,1,18,元大-台南,2024-04-03,9896
2208,台船,16,0,16,元大-台南,2024-04-03,9896
00931B,統一美債20年,15,0,15,元大-台南,2024-04-03,9896
2816,旺旺保,15,0,15,元大-台南,2024-04-03,9896
1617,榮星,18,3,15,元大-台南,2024-04-03,9896
00712,復華富時不動產,24,9,15,元大-台南,2024-04-03,9896
6438,迅得,26,12,14,元大-台南,2024-04-03,9896
3010,華立,14,0,14,元大-台南,2024-04-03,9896
2408,南亞科,17,3,14,元大-台南,2024-04-03,9896
2892,第一金,13,0,13,元大-台南,2024-04-03,9896
2885,元大金,14,1,13,元大-台南,2024-04-03,9896
8478,東哥遊艇,18,5,13,元大-台南,2024-04-03,9896
2612,中航,12,0,12,元大-台南,2024-04-03,9896
00939,統一台灣高息動能,62,50,12,元大-台南,2024-04-03,9896
00679B,元大美債20年,476,12,464,元大-台南,2024-04-08,9896
00929,復華台灣科技優息,245,18,227,元大-台南,2024-04-08,9896
00687B,國泰20年美債,222,16,206,元大-台南,2024-04-08,9896
00937B,群益ESG投等債20,212,20,192,元大-台南,2024-04-08,9896
1522,堤維西,183,6,177,元大-台南,2024-04-08,9896
2511,太子,123,4,119,元大-台南,2024-04-08,9896
00795B,中信美國公債20年,115,0,115,元大-台南,2024-04-08,9896
00632R,元大台灣50反1,103,1,102,元大-台南,2024-04-08,9896
00919,群益台灣精選高息,128,35,93,元大-台南,2024-04-08,9896
00673R,期元大S＆P原油反1,87,0,87,元大-台南,2024-04-08,9896
2371,大同,110,24,86,元大-台南,2024-04-08,9896
00751B,元大AAA至A公司債,68,0,68,元大-台南,2024-04-08,9896
2356,英業達,77,13,64,元大-台南,2024-04-08,9896
2017,官田鋼,63,0,63,元大-台南,2024-04-08,9896
00857B,永豐20年美公債,59,0,59,元大-台南,2024-04-08,9896
6207,雷科,61,6,55,元大-台南,2024-04-08,9896
00941,中信上游半導體,76,27,49,元大-台南,2024-04-08,9896
2317,鴻海,71,26,45,元大-台南,2024-04-08,9896
6120,達運,198,154,44,元大-台南,2024-04-08,9896
2312,金寶,42,2,40,元大-台南,2024-04-08,9896
2337,旺宏,45,8,37,元大-台南,2024-04-08,9896
2887,台新金,37,2,35,元大-台南,2024-04-08,9896
2845,遠東銀,33,1,32,元大-台南,2024-04-08,9896
00637L,元大滬深300正2,34,4,30,元大-台南,2024-04-08,9896
6578,達邦蛋白,30,0,30,元大-台南,2024-04-08,9896
2382,廣達,44,16,28,元大-台南,2024-04-08,9896
2495,普安,24,0,24,元大-台南,2024-04-08,9896
2359,所羅門,32,10,22,元大-台南,2024-04-08,9896
8064,東捷,27,5,22,元大-台南,2024-04-08,9896
00923,群益台ESG低碳50,20,0,20,元大-台南,2024-04-08,9896
2324,仁寶,21,2,19,元大-台南,2024-04-08,9896
00712,復華富時不動產,18,0,18,元大-台南,2024-04-08,9896
2344,華邦電,18,0,18,元大-台南,2024-04-08,9896
00933B,國泰10Y+金融債,40,23,17,元大-台南,2024-04-08,9896
3481,群創,29,12,17,元大-台南,2024-04-08,9896
00931B,統一美債20年,16,0,16,元大-台南,2024-04-08,9896
00764B,群益25年美債,16,0,16,元大-台南,2024-04-08,9896
6112,邁達特,16,0,16,元大-台南,2024-04-08,9896
00882,中信中國高股息,26,11,15,元大-台南,2024-04-08,9896
8930,青鋼,15,0,15,元大-台南,2024-04-08,9896
2801,彰銀,12,0,12,元大-台南,2024-04-08,9896
1815,富喬,21,9,12,元大-台南,2024-04-08,9896
6147,頎邦,11,0,11,元大-台南,2024-04-08,9896
6282,康舒,11,0,11,元大-台南,2024-04-08,9896
2465,麗臺,11,0,11,元大-台南,2024-04-08,9896
3081,聯亞,12,1,11,元大-台南,2024-04-08,9896
6189,豐藝,14,3,11,元大-台南,2024-04-08,9896
2354,鴻準,16,5,11,元大-台南,2024-04-08,9896
00935,野村臺灣新科技50,10,0,10,元大-台南,2024-04-08,9896
4746,台耀,11,1,10,元大-台南,2024-04-08,9896
00719B,元大美債1-3,203,1,202,元大-台南,2024-04-09,9896
00929,復華台灣科技優息,211,9,202,元大-台南,2024-04-09,9896
00927,群益半導體收益,201,0,201,元大-台南,2024-04-09,9896
3481,群創,236,49,187,元大-台南,2024-04-09,9896
00937B,群益ESG投等債20,211,26,185,元大-台南,2024-04-09,9896
00665L,富邦�琤肭磪囓�2,513,413,100,元大-台南,2024-04-09,9896
00673R,期元大S＆P原油反1,87,0,87,元大-台南,2024-04-09,9896
1229,聯華,83,3,80,元大-台南,2024-04-09,9896
6189,豐藝,99,27,72,元大-台南,2024-04-09,9896
3231,緯創,123,53,70,元大-台南,2024-04-09,9896
00680L,元大美債20正2,62,0,62,元大-台南,2024-04-09,9896
2313,華通,65,6,59,元大-台南,2024-04-09,9896
00919,群益台灣精選高息,72,20,52,元大-台南,2024-04-09,9896
00679B,元大美債20年,61,16,45,元大-台南,2024-04-09,9896
4533,協易機,50,6,44,元大-台南,2024-04-09,9896
6488,環球晶,40,0,40,元大-台南,2024-04-09,9896
00637L,元大滬深300正2,40,6,34,元大-台南,2024-04-09,9896
2537,聯上發,85,54,31,元大-台南,2024-04-09,9896
6116,彩晶,28,0,28,元大-台南,2024-04-09,9896
2317,鴻海,72,44,28,元大-台南,2024-04-09,9896
2033,佳大,28,2,26,元大-台南,2024-04-09,9896
1460,宏遠,25,0,25,元大-台南,2024-04-09,9896
2489,瑞軒,24,0,24,元大-台南,2024-04-09,9896
1513,中興電,100,77,23,元大-台南,2024-04-09,9896
6578,達邦蛋白,25,2,23,元大-台南,2024-04-09,9896
2449,京元電子,21,0,21,元大-台南,2024-04-09,9896
00706L,期元大S＆P日圓正2,20,0,20,元大-台南,2024-04-09,9896
00669R,國泰美國道瓊反1,20,0,20,元大-台南,2024-04-09,9896
2356,英業達,33,14,19,元大-台南,2024-04-09,9896
1101,台泥,25,6,19,元大-台南,2024-04-09,9896
6187,萬潤,19,1,18,元大-台南,2024-04-09,9896
1608,華榮,39,21,18,元大-台南,2024-04-09,9896
00795B,中信美國公債20年,17,0,17,元大-台南,2024-04-09,9896
6120,達運,19,2,17,元大-台南,2024-04-09,9896
8112,至上,79,62,17,元大-台南,2024-04-09,9896
3056,富華新,16,0,16,元大-台南,2024-04-09,9896
2023,燁輝,19,4,15,元大-台南,2024-04-09,9896
2609,陽明,26,11,15,元大-台南,2024-04-09,9896
2405,輔信,15,0,15,元大-台南,2024-04-09,9896
5457,宣德,15,0,15,元大-台南,2024-04-09,9896
4915,致伸,15,0,15,元大-台南,2024-04-09,9896
2382,廣達,32,18,14,元大-台南,2024-04-09,9896
5521,工信,30,16,14,元大-台南,2024-04-09,9896
00939,統一台灣高息動能,29,16,13,元大-台南,2024-04-09,9896
6227,茂綸,21,8,13,元大-台南,2024-04-09,9896
8070,長華*,26,13,13,元大-台南,2024-04-09,9896
2369,菱生,15,4,11,元大-台南,2024-04-09,9896
3294,英濟,11,0,11,元大-台南,2024-04-09,9896
8050,廣積,11,0,11,元大-台南,2024-04-09,9896
1612,宏泰,16,5,11,元大-台南,2024-04-09,9896
00927,群益半導體收益,270,4,266,元大-台南,2024-04-10,9896
00725B,國泰投資級公司債,160,0,160,元大-台南,2024-04-10,9896
2511,太子,133,1,132,元大-台南,2024-04-10,9896
00940,元大台灣價值高息,311,210,101,元大-台南,2024-04-10,9896
2353,宏��,188,94,94,元大-台南,2024-04-10,9896
00937B,群益ESG投等債20,67,3,64,元大-台南,2024-04-10,9896
00891,中信關鍵半導體,107,43,64,元大-台南,2024-04-10,9896
00722B,群益投資級電信債,50,0,50,元大-台南,2024-04-10,9896
00941,中信上游半導體,50,0,50,元大-台南,2024-04-10,9896
8926,台汽電,54,7,47,元大-台南,2024-04-10,9896
1605,華新,63,22,41,元大-台南,2024-04-10,9896
2891,中信金,42,1,41,元大-台南,2024-04-10,9896
8096,擎亞,80,41,39,元大-台南,2024-04-10,9896
3706,神達,40,2,38,元大-台南,2024-04-10,9896
2515,中工,122,84,38,元大-台南,2024-04-10,9896
1522,堤維西,38,0,38,元大-台南,2024-04-10,9896
00929,復華台灣科技優息,61,26,35,元大-台南,2024-04-10,9896
2337,旺宏,42,7,35,元大-台南,2024-04-10,9896
1503,士電,44,12,32,元大-台南,2024-04-10,9896
4402,郡都開發,31,0,31,元大-台南,2024-04-10,9896
2367,燿華,74,44,30,元大-台南,2024-04-10,9896
5347,世界,33,4,29,元大-台南,2024-04-10,9896
1714,和桐,27,0,27,元大-台南,2024-04-10,9896
6284,佳邦,28,1,27,元大-台南,2024-04-10,9896
3481,群創,148,124,24,元大-台南,2024-04-10,9896
2324,仁寶,27,5,22,元大-台南,2024-04-10,9896
1504,東元,25,3,22,元大-台南,2024-04-10,9896
2634,漢翔,47,27,20,元大-台南,2024-04-10,9896
3512,皇龍,20,0,20,元大-台南,2024-04-10,9896
2371,大同,38,19,19,元大-台南,2024-04-10,9896
1513,中興電,108,89,19,元大-台南,2024-04-10,9896
9906,欣巴巴,19,1,18,元大-台南,2024-04-10,9896
6177,達麗,17,0,17,元大-台南,2024-04-10,9896
8213,志超,17,0,17,元大-台南,2024-04-10,9896
2002,中鋼,26,10,16,元大-台南,2024-04-10,9896
2882,國泰金,19,3,16,元大-台南,2024-04-10,9896
6016,康和證,19,3,16,元大-台南,2024-04-10,9896
2014,中鴻,29,14,15,元大-台南,2024-04-10,9896
8942,森鉅,15,0,15,元大-台南,2024-04-10,9896
00857B,永豐20年美公債,15,0,15,元大-台南,2024-04-10,9896
1460,宏遠,14,0,14,元大-台南,2024-04-10,9896
1216,統一,14,0,14,元大-台南,2024-04-10,9896
2376,技嘉,30,16,14,元大-台南,2024-04-10,9896
2382,廣達,26,13,13,元大-台南,2024-04-10,9896
6125,廣運,17,4,13,元大-台南,2024-04-10,9896
8112,至上,53,40,13,元大-台南,2024-04-10,9896
5512,力麒,17,5,12,元大-台南,2024-04-10,9896
6015,宏遠證,13,1,12,元大-台南,2024-04-10,9896
8358,金居,12,0,12,元大-台南,2024-04-10,9896
3715,定穎投控,36,24,12,元大-台南,2024-04-10,9896
00680L,元大美債20正2,912,30,882,元大-台南,2024-04-11,9896
00937B,群益ESG投等債20,359,15,344,元大-台南,2024-04-11,9896
3481,群創,377,36,341,元大-台南,2024-04-11,9896
00929,復華台灣科技優息,220,13,207,元大-台南,2024-04-11,9896
00679B,元大美債20年,207,20,187,元大-台南,2024-04-11,9896
00687B,國泰20年美債,135,0,135,元大-台南,2024-04-11,9896
00927,群益半導體收益,103,0,103,元大-台南,2024-04-11,9896
00688L,國泰20年美債正2,90,1,89,元大-台南,2024-04-11,9896
2317,鴻海,129,45,84,元大-台南,2024-04-11,9896
00712,復華富時不動產,72,0,72,元大-台南,2024-04-11,9896
00686R,群益臺灣加權反1,50,0,50,元大-台南,2024-04-11,9896
00941,中信上游半導體,54,5,49,元大-台南,2024-04-11,9896
2033,佳大,46,0,46,元大-台南,2024-04-11,9896
00632R,元大台灣50反1,100,56,44,元大-台南,2024-04-11,9896
3013,晟銘電,104,62,42,元大-台南,2024-04-11,9896
1815,富喬,44,2,42,元大-台南,2024-04-11,9896
00857B,永豐20年美公債,41,0,41,元大-台南,2024-04-11,9896
1605,華新,61,21,40,元大-台南,2024-04-11,9896
2208,台船,37,0,37,元大-台南,2024-04-11,9896
00795B,中信美國公債20年,36,0,36,元大-台南,2024-04-11,9896
00673R,期元大S＆P原油反1,32,0,32,元大-台南,2024-04-11,9896
3260,威剛,48,16,32,元大-台南,2024-04-11,9896
00933B,國泰10Y+金融債,37,6,31,元大-台南,2024-04-11,9896
0056,元大高股息,39,8,31,元大-台南,2024-04-11,9896
6227,茂綸,43,15,28,元大-台南,2024-04-11,9896
2501,國建,44,16,28,元大-台南,2024-04-11,9896
1109,信大,27,0,27,元大-台南,2024-04-11,9896
00722B,群益投資級電信債,26,0,26,元大-台南,2024-04-11,9896
2634,漢翔,54,29,25,元大-台南,2024-04-11,9896
3052,夆典,23,1,22,元大-台南,2024-04-11,9896
2025,千興,23,1,22,元大-台南,2024-04-11,9896
3056,富華新,30,8,22,元大-台南,2024-04-11,9896
00923,群益台ESG低碳50,22,0,22,元大-台南,2024-04-11,9896
1514,亞力,97,75,22,元大-台南,2024-04-11,9896
00885,富邦越南,21,0,21,元大-台南,2024-04-11,9896
3231,緯創,79,59,20,元大-台南,2024-04-11,9896
2406,國碩,34,14,20,元大-台南,2024-04-11,9896
2610,華航,43,23,20,元大-台南,2024-04-11,9896
2324,仁寶,39,19,20,元大-台南,2024-04-11,9896
2303,聯電,80,61,19,元大-台南,2024-04-11,9896
1611,中電,20,1,19,元大-台南,2024-04-11,9896
8033,雷虎,18,0,18,元大-台南,2024-04-11,9896
8050,廣積,24,6,18,元大-台南,2024-04-11,9896
3546,宇峻,17,0,17,元大-台南,2024-04-11,9896
5457,宣德,17,0,17,元大-台南,2024-04-11,9896
2409,友達,22,5,17,元大-台南,2024-04-11,9896
2014,中鴻,23,7,16,元大-台南,2024-04-11,9896
1310,台苯,16,0,16,元大-台南,2024-04-11,9896
00706L,期元大S＆P日圓正2,16,0,16,元大-台南,2024-04-11,9896
6288,聯嘉,15,0,15,元大-台南,2024-04-11,9896
00929,復華台灣科技優息,202,47,155,元大-台南,2024-04-12,9896
5457,宣德,131,1,130,元大-台南,2024-04-12,9896
00688L,國泰20年美債正2,121,0,121,元大-台南,2024-04-12,9896
2409,友達,121,7,114,元大-台南,2024-04-12,9896
00937B,群益ESG投等債20,142,30,112,元大-台南,2024-04-12,9896
9958,世紀鋼,114,12,102,元大-台南,2024-04-12,9896
00665L,富邦�琤肭磪囓�2,100,0,100,元大-台南,2024-04-12,9896
00940,元大台灣價值高息,240,151,89,元大-台南,2024-04-12,9896
00679B,元大美債20年,90,5,85,元大-台南,2024-04-12,9896
2535,達欣工,79,0,79,元大-台南,2024-04-12,9896
2618,長榮航,82,9,73,元大-台南,2024-04-12,9896
00687B,國泰20年美債,79,7,72,元大-台南,2024-04-12,9896
00909,國泰數位支付服務,71,0,71,元大-台南,2024-04-12,9896
2353,宏��,111,46,65,元大-台南,2024-04-12,9896
1101,台泥,61,1,60,元大-台南,2024-04-12,9896
00927,群益半導體收益,57,2,55,元大-台南,2024-04-12,9896
2371,大同,180,127,53,元大-台南,2024-04-12,9896
0056,元大高股息,52,1,51,元大-台南,2024-04-12,9896
00673R,期元大S＆P原油反1,44,0,44,元大-台南,2024-04-12,9896
2382,廣達,50,8,42,元大-台南,2024-04-12,9896
00712,復華富時不動產,61,20,41,元大-台南,2024-04-12,9896
00933B,國泰10Y+金融債,47,10,37,元大-台南,2024-04-12,9896
5880,合庫金,35,0,35,元大-台南,2024-04-12,9896
2489,瑞軒,30,0,30,元大-台南,2024-04-12,9896
2352,佳世達,31,3,28,元大-台南,2024-04-12,9896
4306,炎洲,28,0,28,元大-台南,2024-04-12,9896
2356,英業達,35,9,26,元大-台南,2024-04-12,9896
00857B,永豐20年美公債,27,1,26,元大-台南,2024-04-12,9896
00725B,國泰投資級公司債,26,0,26,元大-台南,2024-04-12,9896
3313,斐成,26,0,26,元大-台南,2024-04-12,9896
2344,華邦電,22,0,22,元大-台南,2024-04-12,9896
3481,群創,40,18,22,元大-台南,2024-04-12,9896
2887,台新金,26,5,21,元大-台南,2024-04-12,9896
00751B,元大AAA至A公司債,41,20,21,元大-台南,2024-04-12,9896
00680L,元大美債20正2,66,47,19,元大-台南,2024-04-12,9896
2883,凱基金,25,5,20,元大-台南,2024-04-12,9896
5351,鈺創,40,22,18,元大-台南,2024-04-12,9896
2905,三商,20,3,17,元大-台南,2024-04-12,9896
2033,佳大,17,0,17,元大-台南,2024-04-12,9896
3715,定穎投控,22,6,16,元大-台南,2024-04-12,9896
3056,富華新,21,5,16,元大-台南,2024-04-12,9896
3583,辛耘,25,9,16,元大-台南,2024-04-12,9896
2888,新光金,15,0,15,元大-台南,2024-04-12,9896
00795B,中信美國公債20年,14,0,14,元大-台南,2024-04-12,9896
00878,國泰永續高股息,25,11,14,元大-台南,2024-04-12,9896
5324,士開,14,0,14,元大-台南,2024-04-12,9896
6770,力積電,25,12,13,元大-台南,2024-04-12,9896
8926,台汽電,14,2,12,元大-台南,2024-04-12,9896
2329,華泰,30,18,12,元大-台南,2024-04-12,9896
00650L,復華香港正2,22,10,12,元大-台南,2024-04-12,9896
2301,光寶科,737,1,736,元大-台南,2024-04-15,9896
00929,復華台灣科技優息,359,69,290,元大-台南,2024-04-15,9896
00937B,群益ESG投等債20,238,79,159,元大-台南,2024-04-15,9896
00891,中信關鍵半導體,143,0,143,元大-台南,2024-04-15,9896
3481,群創,158,21,137,元大-台南,2024-04-15,9896
00725B,國泰投資級公司債,80,0,80,元大-台南,2024-04-15,9896
3024,憶聲,77,0,77,元大-台南,2024-04-15,9896
1608,華榮,168,91,77,元大-台南,2024-04-15,9896
00720B,元大投資級公司債,65,1,64,元大-台南,2024-04-15,9896
00679B,元大美債20年,84,23,61,元大-台南,2024-04-15,9896
1513,中興電,118,58,60,元大-台南,2024-04-15,9896
2317,鴻海,88,29,59,元大-台南,2024-04-15,9896
00919,群益台灣精選高息,80,25,55,元大-台南,2024-04-15,9896
2501,國建,58,7,51,元大-台南,2024-04-15,9896
2344,華邦電,53,3,50,元大-台南,2024-04-15,9896
0056,元大高股息,56,7,49,元大-台南,2024-04-15,9896
2303,聯電,108,60,48,元大-台南,2024-04-15,9896
00688L,國泰20年美債正2,53,8,45,元大-台南,2024-04-15,9896
00687B,國泰20年美債,59,16,43,元大-台南,2024-04-15,9896
00909,國泰數位支付服務,42,0,42,元大-台南,2024-04-15,9896
00939,統一台灣高息動能,57,16,41,元大-台南,2024-04-15,9896
2014,中鴻,51,10,41,元大-台南,2024-04-15,9896
1314,中石化,40,4,36,元大-台南,2024-04-15,9896
2867,三商壽,50,15,35,元大-台南,2024-04-15,9896
8112,至上,69,35,34,元大-台南,2024-04-15,9896
3056,富華新,35,2,33,元大-台南,2024-04-15,9896
2618,長榮航,44,14,30,元大-台南,2024-04-15,9896
00927,群益半導體收益,29,0,29,元大-台南,2024-04-15,9896
00857B,永豐20年美公債,25,0,25,元大-台南,2024-04-15,9896
00941,中信上游半導體,50,25,25,元大-台南,2024-04-15,9896
2027,大成鋼,37,13,24,元大-台南,2024-04-15,9896
2330,台積電,25,1,24,元大-台南,2024-04-15,9896
2409,友達,40,17,23,元大-台南,2024-04-15,9896
00712,復華富時不動產,23,0,23,元大-台南,2024-04-15,9896
3715,定穎投控,23,2,21,元大-台南,2024-04-15,9896
2506,太設,41,20,21,元大-台南,2024-04-15,9896
1514,亞力,84,64,20,元大-台南,2024-04-15,9896
3059,華晶科,20,0,20,元大-台南,2024-04-15,9896
00915,凱基優選高股息30,20,0,20,元大-台南,2024-04-15,9896
00933B,國泰10Y+金融債,29,10,19,元大-台南,2024-04-15,9896
2439,美律,21,3,18,元大-台南,2024-04-15,9896
5009,榮剛,33,16,17,元大-台南,2024-04-15,9896
2887,台新金,19,2,17,元大-台南,2024-04-15,9896
8358,金居,23,6,17,元大-台南,2024-04-15,9896
3010,華立,17,0,17,元大-台南,2024-04-15,9896
2101,南港,20,3,17,元大-台南,2024-04-15,9896
00751B,元大AAA至A公司債,17,0,17,元大-台南,2024-04-15,9896
1905,華紙,16,0,16,元大-台南,2024-04-15,9896
9105,泰金寶-DR,16,0,16,元大-台南,2024-04-15,9896
00706L,期元大S＆P日圓正2,16,0,16,元大-台南,2024-04-15,9896
00940,元大台灣價值高息,1348,132,1216,元大-台南,2024-04-16,9896
00937B,群益ESG投等債20,568,52,516,元大-台南,2024-04-16,9896
00919,群益台灣精選高息,390,113,277,元大-台南,2024-04-16,9896
4960,誠美材,305,32,273,元大-台南,2024-04-16,9896
00939,統一台灣高息動能,198,12,186,元大-台南,2024-04-16,9896
00929,復華台灣科技優息,353,185,168,元大-台南,2024-04-16,9896
0056,元大高股息,206,57,149,元大-台南,2024-04-16,9896
9904,寶成,132,2,130,元大-台南,2024-04-16,9896
6216,居易,120,0,120,元大-台南,2024-04-16,9896
3481,群創,124,22,102,元大-台南,2024-04-16,9896
2883,凱基金,111,8,103,元大-台南,2024-04-16,9896
00941,中信上游半導體,107,6,101,元大-台南,2024-04-16,9896
00680L,元大美債20正2,103,8,95,元大-台南,2024-04-16,9896
00915,凱基優選高股息30,94,10,84,元大-台南,2024-04-16,9896
00720B,元大投資級公司債,92,12,80,元大-台南,2024-04-16,9896
00687B,國泰20年美債,106,26,80,元大-台南,2024-04-16,9896
2101,南港,74,0,74,元大-台南,2024-04-16,9896
00918,大華優利高填息30,76,8,68,元大-台南,2024-04-16,9896
2610,華航,66,2,64,元大-台南,2024-04-16,9896
3231,緯創,94,30,64,元大-台南,2024-04-16,9896
2027,大成鋼,72,14,58,元大-台南,2024-04-16,9896
00712,復華富時不動產,51,0,51,元大-台南,2024-04-16,9896
2353,宏��,80,32,48,元大-台南,2024-04-16,9896
2367,燿華,63,16,47,元大-台南,2024-04-16,9896
2867,三商壽,88,42,46,元大-台南,2024-04-16,9896
2812,台中銀,66,20,46,元大-台南,2024-04-16,9896
3056,富華新,45,0,45,元大-台南,2024-04-16,9896
8112,至上,49,6,43,元大-台南,2024-04-16,9896
00885,富邦越南,47,7,40,元大-台南,2024-04-16,9896
2881,富邦金,39,0,39,元大-台南,2024-04-16,9896
00878,國泰永續高股息,140,102,38,元大-台南,2024-04-16,9896
2409,友達,40,3,37,元大-台南,2024-04-16,9896
2888,新光金,38,2,36,元大-台南,2024-04-16,9896
1326,台化,36,0,36,元大-台南,2024-04-16,9896
3260,威剛,40,5,35,元大-台南,2024-04-16,9896
00751B,元大AAA至A公司債,46,12,34,元大-台南,2024-04-16,9896
5880,合庫金,34,1,33,元大-台南,2024-04-16,9896
1609,大亞,403,370,33,元大-台南,2024-04-16,9896
2374,佳能,39,6,33,元大-台南,2024-04-16,9896
2382,廣達,39,7,32,元大-台南,2024-04-16,9896
2880,華南金,36,5,31,元大-台南,2024-04-16,9896
2301,光寶科,33,1,32,元大-台南,2024-04-16,9896
00650L,復華香港正2,33,2,31,元大-台南,2024-04-16,9896
00679B,元大美債20年,81,50,31,元大-台南,2024-04-16,9896
2330,台積電,48,19,29,元大-台南,2024-04-16,9896
2356,英業達,51,23,28,元大-台南,2024-04-16,9896
2887,台新金,37,9,28,元大-台南,2024-04-16,9896
2515,中工,35,7,28,元大-台南,2024-04-16,9896
2884,玉山金,54,27,27,元大-台南,2024-04-16,9896
2344,華邦電,46,21,25,元大-台南,2024-04-16,9896
00937B,群益ESG投等債20,359,22,337,元大-台南,2024-04-17,9896
00940,元大台灣價值高息,311,91,220,元大-台南,2024-04-17,9896
00929,復華台灣科技優息,184,17,167,元大-台南,2024-04-17,9896
2101,南港,148,1,147,元大-台南,2024-04-17,9896
00688L,國泰20年美債正2,135,2,133,元大-台南,2024-04-17,9896
0056,元大高股息,148,26,122,元大-台南,2024-04-17,9896
00650L,復華香港正2,112,2,110,元大-台南,2024-04-17,9896
00679B,元大美債20年,115,8,107,元大-台南,2024-04-17,9896
00712,復華富時不動產,96,0,96,元大-台南,2024-04-17,9896
00919,群益台灣精選高息,124,35,89,元大-台南,2024-04-17,9896
00720B,元大投資級公司債,89,0,89,元大-台南,2024-04-17,9896
3481,群創,154,77,77,元大-台南,2024-04-17,9896
00933B,國泰10Y+金融債,138,65,73,元大-台南,2024-04-17,9896
00878,國泰永續高股息,90,21,69,元大-台南,2024-04-17,9896
5309,系統電,70,3,67,元大-台南,2024-04-17,9896
1316,上曜,71,5,66,元大-台南,2024-04-17,9896
00751B,元大AAA至A公司債,62,0,62,元大-台南,2024-04-17,9896
00680L,元大美債20正2,69,8,61,元大-台南,2024-04-17,9896
2883,凱基金,60,0,60,元大-台南,2024-04-17,9896
3231,緯創,94,36,58,元大-台南,2024-04-17,9896
8926,台汽電,53,5,48,元大-台南,2024-04-17,9896
8358,金居,51,3,48,元大-台南,2024-04-17,9896
2353,宏��,52,5,47,元大-台南,2024-04-17,9896
00687B,國泰20年美債,46,0,46,元大-台南,2024-04-17,9896
2618,長榮航,57,12,45,元大-台南,2024-04-17,9896
2344,華邦電,41,1,40,元大-台南,2024-04-17,9896
5371,中光電,41,4,37,元大-台南,2024-04-17,9896
2401,凌陽,40,6,34,元大-台南,2024-04-17,9896
1795,美時,35,2,33,元大-台南,2024-04-17,9896
00857B,永豐20年美公債,29,0,29,元大-台南,2024-04-17,9896
9933,中鼎,30,2,28,元大-台南,2024-04-17,9896
4979,華星光,31,3,28,元大-台南,2024-04-17,9896
00941,中信上游半導體,27,1,26,元大-台南,2024-04-17,9896
4953,緯軟,25,0,25,元大-台南,2024-04-17,9896
2303,聯電,37,14,23,元大-台南,2024-04-17,9896
2354,鴻準,24,3,21,元大-台南,2024-04-17,9896
2887,台新金,21,0,21,元大-台南,2024-04-17,9896
4306,炎洲,20,0,20,元大-台南,2024-04-17,9896
2317,鴻海,65,46,19,元大-台南,2024-04-17,9896
00795B,中信美國公債20年,20,2,18,元大-台南,2024-04-17,9896
9105,泰金寶-DR,18,0,18,元大-台南,2024-04-17,9896
8931,大汽電,18,0,18,元大-台南,2024-04-17,9896
2025,千興,18,0,18,元大-台南,2024-04-17,9896
2408,南亞科,19,2,17,元大-台南,2024-04-17,9896
2382,廣達,27,10,17,元大-台南,2024-04-17,9896
2489,瑞軒,24,8,16,元大-台南,2024-04-17,9896
5864,致和證,22,6,16,元大-台南,2024-04-17,9896
1326,台化,16,0,16,元大-台南,2024-04-17,9896
1319,東陽,20,4,16,元大-台南,2024-04-17,9896
00772B,中信高評級公司債,15,0,15,元大-台南,2024-04-17,9896
2615,萬海,1253,1,1252,元大-台南,2024-04-18,9896
00937B,群益ESG投等債20,245,4,241,元大-台南,2024-04-18,9896
00940,元大台灣價值高息,264,101,163,元大-台南,2024-04-18,9896
00632R,元大台灣50反1,164,32,132,元大-台南,2024-04-18,9896
2101,南港,123,10,113,元大-台南,2024-04-18,9896
00939,統一台灣高息動能,129,20,109,元大-台南,2024-04-18,9896
2511,太子,143,37,106,元大-台南,2024-04-18,9896
1608,華榮,181,80,101,元大-台南,2024-04-18,9896
00929,復華台灣科技優息,90,7,83,元大-台南,2024-04-18,9896
2610,華航,87,8,79,元大-台南,2024-04-18,9896
0056,元大高股息,84,5,79,元大-台南,2024-04-18,9896
2371,大同,244,169,75,元大-台南,2024-04-18,9896
2889,國票金,60,0,60,元大-台南,2024-04-18,9896
1504,東元,83,25,58,元大-台南,2024-04-18,9896
2367,燿華,102,51,51,元大-台南,2024-04-18,9896
00905,FT臺灣Smart,52,2,50,元大-台南,2024-04-18,9896
1808,潤隆,50,0,50,元大-台南,2024-04-18,9896
3481,群創,78,28,50,元大-台南,2024-04-18,9896
00688L,國泰20年美債正2,65,20,45,元大-台南,2024-04-18,9896
3313,斐成,35,0,35,元大-台南,2024-04-18,9896
00772B,中信高評級公司債,51,18,33,元大-台南,2024-04-18,9896
9955,佳龍,34,1,33,元大-台南,2024-04-18,9896
2002,中鋼,40,9,31,元大-台南,2024-04-18,9896
00919,群益台灣精選高息,38,10,28,元大-台南,2024-04-18,9896
6216,居易,27,0,27,元大-台南,2024-04-18,9896
8110,華東,30,4,26,元大-台南,2024-04-18,9896
9904,寶成,28,5,23,元大-台南,2024-04-18,9896
8112,至上,30,7,23,元大-台南,2024-04-18,9896
8085,福華,24,2,22,元大-台南,2024-04-18,9896
2329,華泰,57,36,21,元大-台南,2024-04-18,9896
00857B,永豐20年美公債,21,0,21,元大-台南,2024-04-18,9896
1905,華紙,20,0,20,元大-台南,2024-04-18,9896
00753L,中信中國50正2,20,0,20,元大-台南,2024-04-18,9896
00878,國泰永續高股息,29,10,19,元大-台南,2024-04-18,9896
1785,光洋科,20,1,19,元大-台南,2024-04-18,9896
00720B,元大投資級公司債,20,2,18,元大-台南,2024-04-18,9896
00712,復華富時不動產,17,0,17,元大-台南,2024-04-18,9896
3715,定穎投控,17,1,16,元大-台南,2024-04-18,9896
3056,富華新,30,14,16,元大-台南,2024-04-18,9896
2344,華邦電,15,0,15,元大-台南,2024-04-18,9896
4157,太景*-KY,14,0,14,元大-台南,2024-04-18,9896
00942B,台新美A公司債20+,13,0,13,元大-台南,2024-04-18,9896
4142,國光生,22,9,13,元大-台南,2024-04-18,9896
00733,富邦臺灣中小,13,1,12,元大-台南,2024-04-18,9896
6189,豐藝,16,4,12,元大-台南,2024-04-18,9896
6133,金橋,96,84,12,元大-台南,2024-04-18,9896
2489,瑞軒,21,9,12,元大-台南,2024-04-18,9896
2301,光寶科,21,9,12,元大-台南,2024-04-18,9896
00885,富邦越南,11,0,11,元大-台南,2024-04-18,9896
5493,三聯,12,1,11,元大-台南,2024-04-18,9896
00940,元大台灣價值高息,1189,493,696,元大-台南,2024-04-19,9896
00929,復華台灣科技優息,883,248,635,元大-台南,2024-04-19,9896
2515,中工,321,37,284,元大-台南,2024-04-19,9896
00937B,群益ESG投等債20,210,21,189,元大-台南,2024-04-19,9896
0056,元大高股息,204,40,164,元大-台南,2024-04-19,9896
2634,漢翔,181,23,158,元大-台南,2024-04-19,9896
2888,新光金,143,12,131,元大-台南,2024-04-19,9896
00939,統一台灣高息動能,147,28,119,元大-台南,2024-04-19,9896
00688L,國泰20年美債正2,139,27,112,元大-台南,2024-04-19,9896
00905,FT臺灣Smart,112,1,111,元大-台南,2024-04-19,9896
00900,富邦特選高股息30,109,0,109,元大-台南,2024-04-19,9896
00878,國泰永續高股息,184,76,108,元大-台南,2024-04-19,9896
2330,台積電,130,31,99,元大-台南,2024-04-19,9896
00941,中信上游半導體,104,8,96,元大-台南,2024-04-19,9896
2303,聯電,149,53,96,元大-台南,2024-04-19,9896
2371,大同,774,687,87,元大-台南,2024-04-19,9896
2317,鴻海,114,30,84,元大-台南,2024-04-19,9896
2501,國建,104,21,83,元大-台南,2024-04-19,9896
00891,中信關鍵半導體,90,15,75,元大-台南,2024-04-19,9896
2892,第一金,73,0,73,元大-台南,2024-04-19,9896
00680L,元大美債20正2,94,22,72,元大-台南,2024-04-19,9896
6005,群益證,92,26,66,元大-台南,2024-04-19,9896
2101,南港,68,4,64,元大-台南,2024-04-19,9896
1605,華新,103,43,60,元大-台南,2024-04-19,9896
5512,力麒,82,33,49,元大-台南,2024-04-19,9896
2809,京城銀,49,1,48,元大-台南,2024-04-19,9896
2511,太子,100,52,48,元大-台南,2024-04-19,9896
2801,彰銀,46,0,46,元大-台南,2024-04-19,9896
6120,達運,56,11,45,元大-台南,2024-04-19,9896
2355,敬鵬,42,0,42,元大-台南,2024-04-19,9896
8936,國統,71,29,42,元大-台南,2024-04-19,9896
00918,大華優利高填息30,45,5,40,元大-台南,2024-04-19,9896
2618,長榮航,53,13,40,元大-台南,2024-04-19,9896
00922,國泰台灣領袖50,39,0,39,元大-台南,2024-04-19,9896
006208,富邦台50,42,4,38,元大-台南,2024-04-19,9896
1504,東元,75,40,35,元大-台南,2024-04-19,9896
2409,友達,36,2,34,元大-台南,2024-04-19,9896
2603,長榮,75,42,33,元大-台南,2024-04-19,9896
3231,緯創,86,54,32,元大-台南,2024-04-19,9896
2883,凱基金,45,14,31,元大-台南,2024-04-19,9896
2208,台船,31,0,31,元大-台南,2024-04-19,9896
2025,千興,30,0,30,元大-台南,2024-04-19,9896
8390,金益鼎,39,9,30,元大-台南,2024-04-19,9896
00935,野村臺灣新科技50,35,5,30,元大-台南,2024-04-19,9896
9906,欣巴巴,29,0,29,元大-台南,2024-04-19,9896
2367,燿華,32,3,29,元大-台南,2024-04-19,9896
00881,國泰台灣5G+,28,0,28,元大-台南,2024-04-19,9896
3013,晟銘電,54,28,26,元大-台南,2024-04-19,9896
1802,台玻,28,2,26,元大-台南,2024-04-19,9896
2353,宏��,42,16,26,元大-台南,2024-04-19,9896
00929,復華台灣科技優息,420,25,395,元大-台南,2024-04-22,9896
00940,元大台灣價值高息,510,133,377,元大-台南,2024-04-22,9896
00632R,元大台灣50反1,429,57,372,元大-台南,2024-04-22,9896
2382,廣達,288,9,279,元大-台南,2024-04-22,9896
3481,群創,227,36,191,元大-台南,2024-04-22,9896
00937B,群益ESG投等債20,118,9,109,元大-台南,2024-04-22,9896
2101,南港,121,13,108,元大-台南,2024-04-22,9896
00680L,元大美債20正2,108,12,96,元大-台南,2024-04-22,9896
00772B,中信高評級公司債,100,6,94,元大-台南,2024-04-22,9896
00878,國泰永續高股息,109,22,87,元大-台南,2024-04-22,9896
00939,統一台灣高息動能,83,11,72,元大-台南,2024-04-22,9896
2355,敬鵬,58,0,58,元大-台南,2024-04-22,9896
5512,力麒,97,40,57,元大-台南,2024-04-22,9896
00891,中信關鍵半導體,59,3,56,元大-台南,2024-04-22,9896
2501,國建,88,33,55,元大-台南,2024-04-22,9896
2405,輔信,53,0,53,元大-台南,2024-04-22,9896
2618,長榮航,128,76,52,元大-台南,2024-04-22,9896
1504,東元,78,26,52,元大-台南,2024-04-22,9896
2371,大同,391,339,52,元大-台南,2024-04-22,9896
00664R,國泰臺灣加權反1,50,0,50,元大-台南,2024-04-22,9896
00857B,永豐20年美公債,43,0,43,元大-台南,2024-04-22,9896
00688L,國泰20年美債正2,41,0,41,元大-台南,2024-04-22,9896
2465,麗臺,42,3,39,元大-台南,2024-04-22,9896
00679B,元大美債20年,38,4,34,元大-台南,2024-04-22,9896
6189,豐藝,42,10,32,元大-台南,2024-04-22,9896
2303,聯電,44,13,31,元大-台南,2024-04-22,9896
4306,炎洲,34,4,30,元大-台南,2024-04-22,9896
1609,大亞,459,431,28,元大-台南,2024-04-22,9896
1617,榮星,58,31,27,元大-台南,2024-04-22,9896
8926,台汽電,39,13,26,元大-台南,2024-04-22,9896
4532,瑞智,27,1,26,元大-台南,2024-04-22,9896
5398,慕康生醫,25,0,25,元大-台南,2024-04-22,9896
2344,華邦電,33,9,24,元大-台南,2024-04-22,9896
3231,緯創,93,70,23,元大-台南,2024-04-22,9896
9933,中鼎,25,4,21,元大-台南,2024-04-22,9896
0056,元大高股息,62,41,21,元大-台南,2024-04-22,9896
2323,中環,24,4,20,元大-台南,2024-04-22,9896
00713,元大台灣高息低波,23,4,19,元大-台南,2024-04-22,9896
00687B,國泰20年美債,21,2,19,元大-台南,2024-04-22,9896
1603,華電,18,0,18,元大-台南,2024-04-22,9896
5230,雷笛克光學,29,12,17,元大-台南,2024-04-22,9896
8112,至上,30,14,16,元大-台南,2024-04-22,9896
2913,農林,17,1,16,元大-台南,2024-04-22,9896
8473,山林水,17,2,15,元大-台南,2024-04-22,9896
2374,佳能,23,8,15,元大-台南,2024-04-22,9896
1618,合機,40,25,15,元大-台南,2024-04-22,9896
2393,億光,16,1,15,元大-台南,2024-04-22,9896
1785,光洋科,19,4,15,元大-台南,2024-04-22,9896
3540,曜越,15,0,15,元大-台南,2024-04-22,9896
00933B,國泰10Y+金融債,14,0,14,元大-台南,2024-04-22,9896
00632R,元大台灣50反1,278,18,260,元大-台南,2024-04-23,9896
00929,復華台灣科技優息,259,46,213,元大-台南,2024-04-23,9896
2374,佳能,173,39,134,元大-台南,2024-04-23,9896
00919,群益台灣精選高息,79,7,72,元大-台南,2024-04-23,9896
00939,統一台灣高息動能,67,8,59,元大-台南,2024-04-23,9896
2465,麗臺,60,3,57,元大-台南,2024-04-23,9896
2101,南港,61,9,52,元大-台南,2024-04-23,9896
6120,達運,39,0,39,元大-台南,2024-04-23,9896
1605,華新,47,12,35,元大-台南,2024-04-23,9896
4167,松瑞藥,35,0,35,元大-台南,2024-04-23,9896
00878,國泰永續高股息,44,13,31,元大-台南,2024-04-23,9896
00937B,群益ESG投等債20,32,2,30,元大-台南,2024-04-23,9896
3576,聯合再生,25,0,25,元大-台南,2024-04-23,9896
2303,聯電,57,34,23,元大-台南,2024-04-23,9896
6235,華孚,23,3,20,元大-台南,2024-04-23,9896
3715,定穎投控,26,8,18,元大-台南,2024-04-23,9896
3024,憶聲,18,0,18,元大-台南,2024-04-23,9896
2317,鴻海,20,3,17,元大-台南,2024-04-23,9896
2489,瑞軒,28,11,17,元大-台南,2024-04-23,9896
8213,志超,16,0,16,元大-台南,2024-04-23,9896
6282,康舒,21,5,16,元大-台南,2024-04-23,9896
1608,華榮,44,28,16,元大-台南,2024-04-23,9896
1504,東元,32,18,14,元大-台南,2024-04-23,9896
2353,宏��,15,1,14,元大-台南,2024-04-23,9896
1337,再生-KY,13,0,13,元大-台南,2024-04-23,9896
3044,健鼎,28,15,13,元大-台南,2024-04-23,9896
2547,日勝生,13,0,13,元大-台南,2024-04-23,9896
2025,千興,13,0,13,元大-台南,2024-04-23,9896
1316,上曜,23,11,12,元大-台南,2024-04-23,9896
2031,新光鋼,12,0,12,元大-台南,2024-04-23,9896
2408,南亞科,13,1,12,元大-台南,2024-04-23,9896
2520,冠德,17,6,11,元大-台南,2024-04-23,9896
8054,安國,16,5,11,元大-台南,2024-04-23,9896
3005,神基,11,0,11,元大-台南,2024-04-23,9896
00651R,復華香港反1,11,0,11,元大-台南,2024-04-23,9896
8463,潤泰材,14,3,11,元大-台南,2024-04-23,9896
2301,光寶科,14,3,11,元大-台南,2024-04-23,9896
4931,新盛力,10,0,10,元大-台南,2024-04-23,9896
1464,得力,10,0,10,元大-台南,2024-04-23,9896
2002,中鋼,12,3,9,元大-台南,2024-04-23,9896
00941,中信上游半導體,9,0,9,元大-台南,2024-04-23,9896
2359,所羅門,12,3,9,元大-台南,2024-04-23,9896
3260,威剛,17,8,9,元大-台南,2024-04-23,9896
6264,富裔,9,0,9,元大-台南,2024-04-23,9896
2834,臺企銀,19,10,9,元大-台南,2024-04-23,9896
2020,美亞,13,5,8,元大-台南,2024-04-23,9896
5351,鈺創,9,1,8,元大-台南,2024-04-23,9896
1101,台泥,30,22,8,元大-台南,2024-04-23,9896
2885,元大金,7,0,7,元大-台南,2024-04-23,9896
2534,宏盛,7,0,7,元大-台南,2024-04-23,9896
3260,威剛,1606,49,1557,元大-台南,2024-04-24,9896
2515,中工,255,22,233,元大-台南,2024-04-24,9896
2511,太子,221,10,211,元大-台南,2024-04-24,9896
2371,大同,243,133,110,元大-台南,2024-04-24,9896
9958,世紀鋼,103,1,102,元大-台南,2024-04-24,9896
2801,彰銀,100,0,100,元大-台南,2024-04-24,9896
00937B,群益ESG投等債20,88,2,86,元大-台南,2024-04-24,9896
00933B,國泰10Y+金融債,65,0,65,元大-台南,2024-04-24,9896
1447,力鵬,63,0,63,元大-台南,2024-04-24,9896
3481,群創,79,21,58,元大-台南,2024-04-24,9896
3294,英濟,53,3,50,元大-台南,2024-04-24,9896
1609,大亞,241,191,50,元大-台南,2024-04-24,9896
6264,富裔,55,6,49,元大-台南,2024-04-24,9896
00679B,元大美債20年,48,0,48,元大-台南,2024-04-24,9896
00680L,元大美債20正2,46,0,46,元大-台南,2024-04-24,9896
6125,廣運,145,100,45,元大-台南,2024-04-24,9896
5880,合庫金,50,6,44,元大-台南,2024-04-24,9896
2867,三商壽,41,0,41,元大-台南,2024-04-24,9896
00687B,國泰20年美債,22,0,22,元大-台南,2024-04-24,9896
1304,台聚,26,4,22,元大-台南,2024-04-24,9896
8046,南電,41,19,22,元大-台南,2024-04-24,9896
2409,友達,23,3,20,元大-台南,2024-04-24,9896
2101,南港,26,6,20,元大-台南,2024-04-24,9896
00752,中信中國50,20,0,20,元大-台南,2024-04-24,9896
2368,金像電,20,3,17,元大-台南,2024-04-24,9896
2355,敬鵬,21,4,17,元大-台南,2024-04-24,9896
2886,兆豐金,19,2,17,元大-台南,2024-04-24,9896
8111,立��,16,0,16,元大-台南,2024-04-24,9896
2884,玉山金,16,1,15,元大-台南,2024-04-24,9896
2352,佳世達,16,1,15,元大-台南,2024-04-24,9896
2329,華泰,31,16,15,元大-台南,2024-04-24,9896
00772B,中信高評級公司債,15,0,15,元大-台南,2024-04-24,9896
00857B,永豐20年美公債,15,0,15,元大-台南,2024-04-24,9896
00941,中信上游半導體,17,3,14,元大-台南,2024-04-24,9896
5371,中光電,24,10,14,元大-台南,2024-04-24,9896
6207,雷科,16,2,14,元大-台南,2024-04-24,9896
2501,國建,18,5,13,元大-台南,2024-04-24,9896
8086,宏捷科,14,1,13,元大-台南,2024-04-24,9896
2105,正新,13,1,12,元大-台南,2024-04-24,9896
3010,華立,13,1,12,元大-台南,2024-04-24,9896
2520,冠德,17,5,12,元大-台南,2024-04-24,9896
2731,雄獅,18,6,12,元大-台南,2024-04-24,9896
3218,大學光,12,1,11,元大-台南,2024-04-24,9896
6275,元山,11,0,11,元大-台南,2024-04-24,9896
9945,潤泰新,13,3,10,元大-台南,2024-04-24,9896
6613,朋億*,11,1,10,元大-台南,2024-04-24,9896
2609,陽明,21,11,10,元大-台南,2024-04-24,9896
8435,鉅邁,10,0,10,元大-台南,2024-04-24,9896
00725B,國泰投資級公司債,10,0,10,元大-台南,2024-04-24,9896
2734,易飛網,10,0,10,元大-台南,2024-04-24,9896
2610,華航,345,41,304,元大-台南,2024-04-25,9896
2888,新光金,148,0,148,元大-台南,2024-04-25,9896
2886,兆豐金,115,0,115,元大-台南,2024-04-25,9896
2330,台積電,115,3,112,元大-台南,2024-04-25,9896
00940,元大台灣價值高息,102,15,87,元大-台南,2024-04-25,9896
00919,群益台灣精選高息,86,1,85,元大-台南,2024-04-25,9896
2883,凱基金,63,0,63,元大-台南,2024-04-25,9896
00679B,元大美債20年,56,0,56,元大-台南,2024-04-25,9896
00772B,中信高評級公司債,52,1,51,元大-台南,2024-04-25,9896
00937B,群益ESG投等債20,55,11,44,元大-台南,2024-04-25,9896
2409,友達,46,10,36,元大-台南,2024-04-25,9896
00720B,元大投資級公司債,40,6,34,元大-台南,2024-04-25,9896
00939,統一台灣高息動能,32,0,32,元大-台南,2024-04-25,9896
1808,潤隆,31,0,31,元大-台南,2024-04-25,9896
1605,華新,32,7,25,元大-台南,2024-04-25,9896
00687B,國泰20年美債,25,0,25,元大-台南,2024-04-25,9896
00878,國泰永續高股息,25,1,24,元大-台南,2024-04-25,9896
8110,華東,25,2,23,元大-台南,2024-04-25,9896
00751B,元大AAA至A公司債,22,0,22,元大-台南,2024-04-25,9896
3013,晟銘電,37,16,21,元大-台南,2024-04-25,9896
2359,所羅門,24,5,19,元大-台南,2024-04-25,9896
3260,威剛,33,14,19,元大-台南,2024-04-25,9896
3703,欣陸,32,13,19,元大-台南,2024-04-25,9896
2892,第一金,18,0,18,元大-台南,2024-04-25,9896
4306,炎洲,20,2,18,元大-台南,2024-04-25,9896
2891,中信金,18,0,18,元大-台南,2024-04-25,9896
3686,達能,19,2,17,元大-台南,2024-04-25,9896
2328,廣宇,16,0,16,元大-台南,2024-04-25,9896
0056,元大高股息,16,0,16,元大-台南,2024-04-25,9896
2367,燿華,17,2,15,元大-台南,2024-04-25,9896
3666,光耀,15,0,15,元大-台南,2024-04-25,9896
00933B,國泰10Y+金融債,15,0,15,元大-台南,2024-04-25,9896
6275,元山,16,1,15,元大-台南,2024-04-25,9896
2545,皇翔,25,10,15,元大-台南,2024-04-25,9896
8070,長華*,36,21,15,元大-台南,2024-04-25,9896
6125,廣運,60,46,14,元大-台南,2024-04-25,9896
00891,中信關鍵半導體,15,1,14,元大-台南,2024-04-25,9896
2880,華南金,14,0,14,元大-台南,2024-04-25,9896
00706L,期元大S＆P日圓正2,14,0,14,元大-台南,2024-04-25,9896
8064,東捷,17,4,13,元大-台南,2024-04-25,9896
9906,欣巴巴,13,0,13,元大-台南,2024-04-25,9896
00795B,中信美國公債20年,16,4,12,元大-台南,2024-04-25,9896
00905,FT臺灣Smart,12,0,12,元大-台南,2024-04-25,9896
2881,富邦金,12,0,12,元大-台南,2024-04-25,9896
00688L,國泰20年美債正2,106,95,11,元大-台南,2024-04-25,9896
6187,萬潤,13,2,11,元大-台南,2024-04-25,9896
3481,群創,29,18,11,元大-台南,2024-04-25,9896
2801,彰銀,10,0,10,元大-台南,2024-04-25,9896
2885,元大金,10,0,10,元大-台南,2024-04-25,9896
00927,群益半導體收益,10,0,10,元大-台南,2024-04-25,9896
00632R,元大台灣50反1,929,80,849,元大-台南,2024-04-26,9896
2511,太子,292,109,183,元大-台南,2024-04-26,9896
2382,廣達,182,20,162,元大-台南,2024-04-26,9896
00680L,元大美債20正2,154,16,138,元大-台南,2024-04-26,9896
5880,合庫金,131,0,131,元大-台南,2024-04-26,9896
00937B,群益ESG投等債20,188,58,130,元大-台南,2024-04-26,9896
5512,力麒,115,1,114,元大-台南,2024-04-26,9896
00679B,元大美債20年,97,5,92,元大-台南,2024-04-26,9896
00706L,期元大S＆P日圓正2,76,10,66,元大-台南,2024-04-26,9896
00772B,中信高評級公司債,56,0,56,元大-台南,2024-04-26,9896
00940,元大台灣價值高息,99,47,52,元大-台南,2024-04-26,9896
00687B,國泰20年美債,50,0,50,元大-台南,2024-04-26,9896
1314,中石化,79,32,47,元大-台南,2024-04-26,9896
00664R,國泰臺灣加權反1,50,5,45,元大-台南,2024-04-26,9896
2363,矽統,46,7,39,元大-台南,2024-04-26,9896
5443,均豪,39,5,34,元大-台南,2024-04-26,9896
00795B,中信美國公債20年,31,0,31,元大-台南,2024-04-26,9896
00933B,國泰10Y+金融債,30,0,30,元大-台南,2024-04-26,9896
2371,大同,123,97,26,元大-台南,2024-04-26,9896
2344,華邦電,26,1,25,元大-台南,2024-04-26,9896
00939,統一台灣高息動能,27,3,24,元大-台南,2024-04-26,9896
00941,中信上游半導體,24,1,23,元大-台南,2024-04-26,9896
00720B,元大投資級公司債,34,11,23,元大-台南,2024-04-26,9896
00919,群益台灣精選高息,35,12,23,元大-台南,2024-04-26,9896
1101,台泥,22,1,21,元大-台南,2024-04-26,9896
00891,中信關鍵半導體,26,5,21,元大-台南,2024-04-26,9896
2323,中環,92,71,21,元大-台南,2024-04-26,9896
1609,大亞,61,40,21,元大-台南,2024-04-26,9896
8112,至上,37,18,19,元大-台南,2024-04-26,9896
2505,國揚,21,3,18,元大-台南,2024-04-26,9896
00688L,國泰20年美債正2,18,0,18,元大-台南,2024-04-26,9896
2834,臺企銀,18,1,17,元大-台南,2024-04-26,9896
3706,神達,30,14,16,元大-台南,2024-04-26,9896
1605,華新,26,10,16,元大-台南,2024-04-26,9896
3264,欣銓,16,0,16,元大-台南,2024-04-26,9896
00942B,台新美A公司債20+,15,0,15,元大-台南,2024-04-26,9896
1721,三晃,61,46,15,元大-台南,2024-04-26,9896
00857B,永豐20年美公債,13,0,13,元大-台南,2024-04-26,9896
1702,南僑,14,1,13,元大-台南,2024-04-26,9896
6442,光聖,16,3,13,元大-台南,2024-04-26,9896
3338,泰碩,15,3,12,元大-台南,2024-04-26,9896
6757,台灣虎航,11,0,11,元大-台南,2024-04-26,9896
2355,敬鵬,11,0,11,元大-台南,2024-04-26,9896
00676R,富邦臺灣加權反1,11,0,11,元大-台南,2024-04-26,9896
6603,富強鑫,10,0,10,元大-台南,2024-04-26,9896
00651R,復華香港反1,10,0,10,元大-台南,2024-04-26,9896
4726,永昕,10,0,10,元大-台南,2024-04-26,9896
00878,國泰永續高股息,14,4,10,元大-台南,2024-04-26,9896
00712,復華富時不動產,9,0,9,元大-台南,2024-04-26,9896
2542,興富發,10,1,9,元大-台南,2024-04-26,9896
2618,長榮航,424,101,323,元大-台南,2024-04-29,9896
2801,彰銀,203,11,192,元大-台南,2024-04-29,9896
00632R,元大台灣50反1,344,178,166,元大-台南,2024-04-29,9896
00665L,富邦�琤肭磪囓�2,162,12,150,元大-台南,2024-04-29,9896
2511,太子,162,12,150,元大-台南,2024-04-29,9896
2363,矽統,205,105,100,元大-台南,2024-04-29,9896
00929,復華台灣科技優息,108,24,84,元大-台南,2024-04-29,9896
2610,華航,95,18,77,元大-台南,2024-04-29,9896
3056,富華新,57,5,52,元大-台南,2024-04-29,9896
00753L,中信中國50正2,50,1,49,元大-台南,2024-04-29,9896
2609,陽明,128,83,45,元大-台南,2024-04-29,9896
1808,潤隆,34,0,34,元大-台南,2024-04-29,9896
6668,中揚光,35,2,33,元大-台南,2024-04-29,9896
2014,中鴻,33,1,32,元大-台南,2024-04-29,9896
4716,大立,33,1,32,元大-台南,2024-04-29,9896
6282,康舒,30,0,30,元大-台南,2024-04-29,9896
2537,聯上發,71,41,30,元大-台南,2024-04-29,9896
2608,嘉里大榮,30,1,29,元大-台南,2024-04-29,9896
2323,中環,43,15,28,元大-台南,2024-04-29,9896
2017,官田鋼,27,0,27,元大-台南,2024-04-29,9896
4533,協易機,23,0,23,元大-台南,2024-04-29,9896
2324,仁寶,23,0,23,元大-台南,2024-04-29,9896
1611,中電,20,0,20,元大-台南,2024-04-29,9896
006207,復華滬深,20,0,20,元大-台南,2024-04-29,9896
5905,南仁湖,20,0,20,元大-台南,2024-04-29,9896
2845,遠東銀,21,2,19,元大-台南,2024-04-29,9896
2486,一詮,34,16,18,元大-台南,2024-04-29,9896
2634,漢翔,19,1,18,元大-台南,2024-04-29,9896
8110,華東,17,1,16,元大-台南,2024-04-29,9896
9945,潤泰新,27,12,15,元大-台南,2024-04-29,9896
3312,弘憶股,19,4,15,元大-台南,2024-04-29,9896
3264,欣銓,20,5,15,元大-台南,2024-04-29,9896
00751B,元大AAA至A公司債,14,0,14,元大-台南,2024-04-29,9896
5230,雷笛克光學,24,10,14,元大-台南,2024-04-29,9896
00878,國泰永續高股息,24,11,13,元大-台南,2024-04-29,9896
2409,友達,22,9,13,元大-台南,2024-04-29,9896
2913,農林,32,21,11,元大-台南,2024-04-29,9896
3402,漢科,11,0,11,元大-台南,2024-04-29,9896
2546,根基,12,1,11,元大-台南,2024-04-29,9896
6197,佳必琪,13,2,11,元大-台南,2024-04-29,9896
6125,廣運,23,13,10,元大-台南,2024-04-29,9896
6147,頎邦,10,0,10,元大-台南,2024-04-29,9896
6431,光麗-KY,10,0,10,元大-台南,2024-04-29,9896
6177,達麗,17,7,10,元大-台南,2024-04-29,9896
8097,常珵,10,0,10,元大-台南,2024-04-29,9896
8438,昶昕,12,2,10,元大-台南,2024-04-29,9896
1459,聯發,10,0,10,元大-台南,2024-04-29,9896
3059,華晶科,10,1,9,元大-台南,2024-04-29,9896
00936,台新永續高息中小,10,1,9,元大-台南,2024-04-29,9896
3049,精金,9,0,9,元大-台南,2024-04-29,9896
2515,中工,216,25,191,元大-台南,2024-04-30,9896
1314,中石化,170,51,119,元大-台南,2024-04-30,9896
00937B,群益ESG投等債20,111,5,106,元大-台南,2024-04-30,9896
00940,元大台灣價值高息,117,11,106,元大-台南,2024-04-30,9896
1524,耿鼎,102,2,100,元大-台南,2024-04-30,9896
2888,新光金,116,30,86,元大-台南,2024-04-30,9896
00919,群益台灣精選高息,58,6,52,元大-台南,2024-04-30,9896
1905,華紙,45,1,44,元大-台南,2024-04-30,9896
2889,國票金,43,2,41,元大-台南,2024-04-30,9896
6189,豐藝,31,1,30,元大-台南,2024-04-30,9896
3231,緯創,34,12,22,元大-台南,2024-04-30,9896
00637L,元大滬深300正2,33,11,22,元大-台南,2024-04-30,9896
00891,中信關鍵半導體,21,0,21,元大-台南,2024-04-30,9896
5531,鄉林,32,11,21,元大-台南,2024-04-30,9896
2834,臺企銀,26,6,20,元大-台南,2024-04-30,9896
2520,冠德,29,9,20,元大-台南,2024-04-30,9896
2317,鴻海,33,13,20,元大-台南,2024-04-30,9896
6264,富裔,23,4,19,元大-台南,2024-04-30,9896
3481,群創,48,30,18,元大-台南,2024-04-30,9896
6770,力積電,25,7,18,元大-台南,2024-04-30,9896
00715L,期街口布蘭特正2,18,0,18,元大-台南,2024-04-30,9896
5512,力麒,17,0,17,元大-台南,2024-04-30,9896
2449,京元電子,19,4,15,元大-台南,2024-04-30,9896
2913,農林,147,132,15,元大-台南,2024-04-30,9896
8942,森鉅,15,0,15,元大-台南,2024-04-30,9896
8110,華東,15,0,15,元大-台南,2024-04-30,9896
1605,華新,15,0,15,元大-台南,2024-04-30,9896
2511,太子,56,43,13,元大-台南,2024-04-30,9896
6226,光鼎,57,44,13,元大-台南,2024-04-30,9896
00900,富邦特選高股息30,12,0,12,元大-台南,2024-04-30,9896
8096,擎亞,24,12,12,元大-台南,2024-04-30,9896
2457,飛宏,14,3,11,元大-台南,2024-04-30,9896
3501,維熹,11,0,11,元大-台南,2024-04-30,9896
00941,中信上游半導體,12,1,11,元大-台南,2024-04-30,9896
3037,欣興,12,2,10,元大-台南,2024-04-30,9896
2464,盟立,15,5,10,元大-台南,2024-04-30,9896
00918,大華優利高填息30,10,0,10,元大-台南,2024-04-30,9896
00857B,永豐20年美公債,10,0,10,元大-台南,2024-04-30,9896
00934,中信成長高股息,10,0,10,元大-台南,2024-04-30,9896
2374,佳能,11,1,10,元大-台南,2024-04-30,9896
00687B,國泰20年美債,15,5,10,元大-台南,2024-04-30,9896
2409,友達,24,15,9,元大-台南,2024-04-30,9896
2883,凱基金,11,2,9,元大-台南,2024-04-30,9896
5347,世界,9,0,9,元大-台南,2024-04-30,9896
2427,三商電,19,10,9,元大-台南,2024-04-30,9896
1304,台聚,9,0,9,元大-台南,2024-04-30,9896
2363,矽統,147,139,8,元大-台南,2024-04-30,9896
2630,亞航,10,1,9,元大-台南,2024-04-30,9896
4127,天良,12,4,8,元大-台南,2024-04-30,9896
1587,吉茂,17,9,8,元大-台南,2024-04-30,9896
2317,鴻海,544,16,528,元大-台南,2024-05-02,9896
1314,中石化,323,38,285,元大-台南,2024-05-02,9896
00637L,元大滬深300正2,210,23,187,元大-台南,2024-05-02,9896
2515,中工,186,53,133,元大-台南,2024-05-02,9896
00878,國泰永續高股息,142,13,129,元大-台南,2024-05-02,9896
3481,群創,111,9,102,元大-台南,2024-05-02,9896
00706L,期元大S＆P日圓正2,100,0,100,元大-台南,2024-05-02,9896
00664R,國泰臺灣加權反1,100,0,100,元大-台南,2024-05-02,9896
00929,復華台灣科技優息,98,1,97,元大-台南,2024-05-02,9896
6757,台灣虎航,94,0,94,元大-台南,2024-05-02,9896
2409,友達,90,2,88,元大-台南,2024-05-02,9896
00937B,群益ESG投等債20,65,0,65,元大-台南,2024-05-02,9896
2851,中再保,55,1,54,元大-台南,2024-05-02,9896
2501,國建,135,85,50,元大-台南,2024-05-02,9896
2618,長榮航,318,272,46,元大-台南,2024-05-02,9896
8064,東捷,48,6,42,元大-台南,2024-05-02,9896
00715L,期街口布蘭特正2,41,3,38,元大-台南,2024-05-02,9896
6187,萬潤,31,0,31,元大-台南,2024-05-02,9896
2356,英業達,36,6,30,元大-台南,2024-05-02,9896
3715,定穎投控,74,44,30,元大-台南,2024-05-02,9896
00919,群益台灣精選高息,31,1,30,元大-台南,2024-05-02,9896
2832,台產,30,2,28,元大-台南,2024-05-02,9896
2330,台積電,32,6,26,元大-台南,2024-05-02,9896
2609,陽明,40,15,25,元大-台南,2024-05-02,9896
00857B,永豐20年美公債,25,0,25,元大-台南,2024-05-02,9896
00922,國泰台灣領袖50,24,0,24,元大-台南,2024-05-02,9896
00679B,元大美債20年,24,1,23,元大-台南,2024-05-02,9896
5608,四維航,23,0,23,元大-台南,2024-05-02,9896
1808,潤隆,23,1,22,元大-台南,2024-05-02,9896
2374,佳能,31,10,21,元大-台南,2024-05-02,9896
00720B,元大投資級公司債,21,0,21,元大-台南,2024-05-02,9896
3188,鑫龍騰,21,0,21,元大-台南,2024-05-02,9896
2605,新興,23,3,20,元大-台南,2024-05-02,9896
2608,嘉里大榮,20,0,20,元大-台南,2024-05-02,9896
2324,仁寶,23,4,19,元大-台南,2024-05-02,9896
9105,泰金寶-DR,18,0,18,元大-台南,2024-05-02,9896
2534,宏盛,37,19,18,元大-台南,2024-05-02,9896
2913,農林,48,31,17,元大-台南,2024-05-02,9896
2464,盟立,22,5,17,元大-台南,2024-05-02,9896
2401,凌陽,15,0,15,元大-台南,2024-05-02,9896
3234,光環,20,5,15,元大-台南,2024-05-02,9896
2101,南港,16,1,15,元大-台南,2024-05-02,9896
1609,大亞,40,26,14,元大-台南,2024-05-02,9896
2506,太設,14,0,14,元大-台南,2024-05-02,9896
1605,華新,14,2,12,元大-台南,2024-05-02,9896
00651R,復華香港反1,12,0,12,元大-台南,2024-05-02,9896
3576,聯合再生,12,0,12,元大-台南,2024-05-02,9896
8936,國統,19,8,11,元大-台南,2024-05-02,9896
2467,志聖,12,1,11,元大-台南,2024-05-02,9896
00936,台新永續高息中小,13,2,11,元大-台南,2024-05-02,9896
020031,統一IC設計臺灣N,200,0,200,元大-台南,2024-05-03,9896
020034,元大IC設計N,200,2,198,元大-台南,2024-05-03,9896
00664R,國泰臺灣加權反1,150,0,150,元大-台南,2024-05-03,9896
00937B,群益ESG投等債20,138,22,116,元大-台南,2024-05-03,9896
6770,力積電,150,42,108,元大-台南,2024-05-03,9896
00929,復華台灣科技優息,117,23,94,元大-台南,2024-05-03,9896
2897,王道銀行,70,0,70,元大-台南,2024-05-03,9896
1316,上曜,98,30,68,元大-台南,2024-05-03,9896
00919,群益台灣精選高息,57,1,56,元大-台南,2024-05-03,9896
5009,榮剛,56,4,52,元大-台南,2024-05-03,9896
9902,台火,47,0,47,元大-台南,2024-05-03,9896
00719B,元大美債1-3,44,0,44,元大-台南,2024-05-03,9896
00891,中信關鍵半導體,46,3,43,元大-台南,2024-05-03,9896
2609,陽明,43,13,30,元大-台南,2024-05-03,9896
8064,東捷,35,5,30,元大-台南,2024-05-03,9896
00878,國泰永續高股息,52,23,29,元大-台南,2024-05-03,9896
3013,晟銘電,43,15,28,元大-台南,2024-05-03,9896
2515,中工,60,33,27,元大-台南,2024-05-03,9896
1446,宏和,24,0,24,元大-台南,2024-05-03,9896
00857B,永豐20年美公債,24,0,24,元大-台南,2024-05-03,9896
1514,亞力,42,18,24,元大-台南,2024-05-03,9896
2465,麗臺,23,0,23,元大-台南,2024-05-03,9896
00687B,國泰20年美債,22,0,22,元大-台南,2024-05-03,9896
00715L,期街口布蘭特正2,22,0,22,元大-台南,2024-05-03,9896
6168,宏齊,22,0,22,元大-台南,2024-05-03,9896
1314,中石化,34,13,21,元大-台南,2024-05-03,9896
2851,中再保,22,1,21,元大-台南,2024-05-03,9896
2356,英業達,21,0,21,元大-台南,2024-05-03,9896
1609,大亞,68,47,21,元大-台南,2024-05-03,9896
1906,寶隆,20,0,20,元大-台南,2024-05-03,9896
00651R,復華香港反1,20,0,20,元大-台南,2024-05-03,9896
1611,中電,20,0,20,元大-台南,2024-05-03,9896
2401,凌陽,20,1,19,元大-台南,2024-05-03,9896
5608,四維航,20,1,19,元大-台南,2024-05-03,9896
4714,永捷,66,48,18,元大-台南,2024-05-03,9896
00939,統一台灣高息動能,22,5,17,元大-台南,2024-05-03,9896
3163,波若威,23,7,16,元大-台南,2024-05-03,9896
2367,燿華,22,6,16,元大-台南,2024-05-03,9896
1612,宏泰,28,12,16,元大-台南,2024-05-03,9896
1220,台榮,15,0,15,元大-台南,2024-05-03,9896
6757,台灣虎航,15,0,15,元大-台南,2024-05-03,9896
2323,中環,17,2,15,元大-台南,2024-05-03,9896
6282,康舒,17,3,14,元大-台南,2024-05-03,9896
2882,國泰金,16,2,14,元大-台南,2024-05-03,9896
2743,山富,14,0,14,元大-台南,2024-05-03,9896
1301,台塑,16,2,14,元大-台南,2024-05-03,9896
6125,廣運,32,18,14,元大-台南,2024-05-03,9896
5347,世界,19,5,14,元大-台南,2024-05-03,9896
2206,三陽工業,26,13,13,元大-台南,2024-05-03,9896
2374,佳能,16,3,13,元大-台南,2024-05-03,9896
00632R,元大台灣50反1,20280,34,20246,元大-台南,2024-05-06,9896
2609,陽明,178,13,165,元大-台南,2024-05-06,9896
3481,群創,125,5,120,元大-台南,2024-05-06,9896
00637L,元大滬深300正2,103,5,98,元大-台南,2024-05-06,9896
00715L,期街口布蘭特正2,69,3,66,元大-台南,2024-05-06,9896
2618,長榮航,280,214,66,元大-台南,2024-05-06,9896
2913,農林,63,2,61,元大-台南,2024-05-06,9896
00929,復華台灣科技優息,81,21,60,元大-台南,2024-05-06,9896
3024,憶聲,55,2,53,元大-台南,2024-05-06,9896
5529,鉅陞,51,0,51,元大-台南,2024-05-06,9896
00664R,國泰臺灣加權反1,50,0,50,元大-台南,2024-05-06,9896
00891,中信關鍵半導體,48,0,48,元大-台南,2024-05-06,9896
2605,新興,41,0,41,元大-台南,2024-05-06,9896
5608,四維航,40,0,40,元大-台南,2024-05-06,9896
3338,泰碩,41,2,39,元大-台南,2024-05-06,9896
2352,佳世達,42,7,35,元大-台南,2024-05-06,9896
2820,華票,33,0,33,元大-台南,2024-05-06,9896
2449,京元電子,57,25,32,元大-台南,2024-05-06,9896
1605,華新,34,2,32,元大-台南,2024-05-06,9896
00882,中信中國高股息,38,7,31,元大-台南,2024-05-06,9896
1337,再生-KY,30,0,30,元大-台南,2024-05-06,9896
2816,旺旺保,30,0,30,元大-台南,2024-05-06,9896
2014,中鴻,30,2,28,元大-台南,2024-05-06,9896
00937B,群益ESG投等債20,39,15,24,元大-台南,2024-05-06,9896
6770,力積電,34,10,24,元大-台南,2024-05-06,9896
6282,康舒,51,28,23,元大-台南,2024-05-06,9896
4714,永捷,27,4,23,元大-台南,2024-05-06,9896
2851,中再保,36,17,19,元大-台南,2024-05-06,9896
2501,國建,70,51,19,元大-台南,2024-05-06,9896
2371,大同,31,13,18,元大-台南,2024-05-06,9896
5521,工信,17,0,17,元大-台南,2024-05-06,9896
2606,裕民,18,1,17,元大-台南,2024-05-06,9896
6284,佳邦,23,6,17,元大-台南,2024-05-06,9896
00919,群益台灣精選高息,36,20,16,元大-台南,2024-05-06,9896
2515,中工,29,13,16,元大-台南,2024-05-06,9896
2504,國產,18,2,16,元大-台南,2024-05-06,9896
2884,玉山金,34,18,16,元大-台南,2024-05-06,9896
2615,萬海,22,7,15,元大-台南,2024-05-06,9896
2743,山富,14,0,14,元大-台南,2024-05-06,9896
00720B,元大投資級公司債,14,0,14,元大-台南,2024-05-06,9896
5531,鄉林,26,13,13,元大-台南,2024-05-06,9896
2603,長榮,22,10,12,元大-台南,2024-05-06,9896
3576,聯合再生,12,0,12,元大-台南,2024-05-06,9896
9933,中鼎,95,83,12,元大-台南,2024-05-06,9896
00795B,中信美國公債20年,12,1,11,元大-台南,2024-05-06,9896
2363,矽統,38,27,11,元大-台南,2024-05-06,9896
00700,富邦�琤肭磪�,11,0,11,元大-台南,2024-05-06,9896
00940,元大台灣價值高息,55,44,11,元大-台南,2024-05-06,9896
3059,華晶科,10,0,10,元大-台南,2024-05-06,9896
1722,台肥,10,0,10,元大-台南,2024-05-06,9896
00929,復華台灣科技優息,127,22,105,元大-台南,2024-05-07,9896
00753L,中信中國50正2,110,6,104,元大-台南,2024-05-07,9896
00664R,國泰臺灣加權反1,100,0,100,元大-台南,2024-05-07,9896
00632R,元大台灣50反1,96,5,91,元大-台南,2024-05-07,9896
6120,達運,80,0,80,元大-台南,2024-05-07,9896
3481,群創,79,4,75,元大-台南,2024-05-07,9896
2486,一詮,125,63,62,元大-台南,2024-05-07,9896
2515,中工,93,37,56,元大-台南,2024-05-07,9896
2511,太子,62,9,53,元大-台南,2024-05-07,9896
6188,廣明,69,17,52,元大-台南,2024-05-07,9896
00891,中信關鍵半導體,52,4,48,元大-台南,2024-05-07,9896
1316,上曜,51,4,47,元大-台南,2024-05-07,9896
9906,欣巴巴,44,1,43,元大-台南,2024-05-07,9896
3056,富華新,44,1,43,元大-台南,2024-05-07,9896
6757,台灣虎航,42,0,42,元大-台南,2024-05-07,9896
6168,宏齊,40,0,40,元大-台南,2024-05-07,9896
2722,夏都,30,0,30,元大-台南,2024-05-07,9896
6125,廣運,51,23,28,元大-台南,2024-05-07,9896
1609,大亞,91,63,28,元大-台南,2024-05-07,9896
3703,欣陸,35,9,26,元大-台南,2024-05-07,9896
2371,大同,56,30,26,元大-台南,2024-05-07,9896
8112,至上,62,38,24,元大-台南,2024-05-07,9896
9105,泰金寶-DR,22,0,22,元大-台南,2024-05-07,9896
2352,佳世達,27,5,22,元大-台南,2024-05-07,9896
1337,再生-KY,20,0,20,元大-台南,2024-05-07,9896
00665L,富邦�琤肭磪囓�2,20,0,20,元大-台南,2024-05-07,9896
2887,台新金,18,0,18,元大-台南,2024-05-07,9896
3013,晟銘電,32,14,18,元大-台南,2024-05-07,9896
3033,威健,29,12,17,元大-台南,2024-05-07,9896
3313,斐成,16,0,16,元大-台南,2024-05-07,9896
2363,矽統,32,17,15,元大-台南,2024-05-07,9896
1605,華新,24,9,15,元大-台南,2024-05-07,9896
2017,官田鋼,14,0,14,元大-台南,2024-05-07,9896
6213,聯茂,20,7,13,元大-台南,2024-05-07,9896
6005,群益證,20,7,13,元大-台南,2024-05-07,9896
6163,華電網,13,0,13,元大-台南,2024-05-07,9896
2834,臺企銀,16,3,13,元大-台南,2024-05-07,9896
2603,長榮,28,16,12,元大-台南,2024-05-07,9896
3576,聯合再生,16,4,12,元大-台南,2024-05-07,9896
00878,國泰永續高股息,44,32,12,元大-台南,2024-05-07,9896
3363,上詮,34,23,11,元大-台南,2024-05-07,9896
2025,千興,11,0,11,元大-台南,2024-05-07,9896
2367,燿華,21,10,11,元大-台南,2024-05-07,9896
4960,誠美材,12,1,11,元大-台南,2024-05-07,9896
8121,越峰,13,2,11,元大-台南,2024-05-07,9896
5871,中租-KY,11,0,11,元大-台南,2024-05-07,9896
6284,佳邦,15,4,11,元大-台南,2024-05-07,9896
5525,順天,10,0,10,元大-台南,2024-05-07,9896
2254,巨鎧精密-創,20,10,10,元大-台南,2024-05-07,9896
2107,厚生,10,0,10,元大-台南,2024-05-07,9896
1453,大將,217,0,217,元大-台南,2024-05-08,9896
2609,陽明,147,39,108,元大-台南,2024-05-08,9896
00753L,中信中國50正2,80,5,75,元大-台南,2024-05-08,9896
00857B,永豐20年美公債,72,0,72,元大-台南,2024-05-08,9896
00715L,期街口布蘭特正2,47,0,47,元大-台南,2024-05-08,9896
6189,豐藝,51,4,47,元大-台南,2024-05-08,9896
2612,中航,52,8,44,元大-台南,2024-05-08,9896
00929,復華台灣科技優息,69,27,42,元大-台南,2024-05-08,9896
00679B,元大美債20年,45,5,40,元大-台南,2024-05-08,9896
2352,佳世達,48,9,39,元大-台南,2024-05-08,9896
5608,四維航,43,7,36,元大-台南,2024-05-08,9896
00632R,元大台灣50反1,58,24,34,元大-台南,2024-05-08,9896
00932,兆豐永續高息等權,32,0,32,元大-台南,2024-05-08,9896
3564,其陽,33,1,32,元大-台南,2024-05-08,9896
1304,台聚,30,0,30,元大-台南,2024-05-08,9896
2515,中工,52,22,30,元大-台南,2024-05-08,9896
00651R,復華香港反1,30,0,30,元大-台南,2024-05-08,9896
00665L,富邦�琤肭磪囓�2,30,0,30,元大-台南,2024-05-08,9896
5871,中租-KY,31,2,29,元大-台南,2024-05-08,9896
2606,裕民,81,53,28,元大-台南,2024-05-08,9896
5864,致和證,25,0,25,元大-台南,2024-05-08,9896
00937B,群益ESG投等債20,25,0,25,元大-台南,2024-05-08,9896
2603,長榮,43,18,25,元大-台南,2024-05-08,9896
2374,佳能,46,22,24,元大-台南,2024-05-08,9896
2801,彰銀,25,1,24,元大-台南,2024-05-08,9896
3481,群創,25,4,21,元大-台南,2024-05-08,9896
1101,台泥,25,4,21,元大-台南,2024-05-08,9896
00940,元大台灣價值高息,126,107,19,元大-台南,2024-05-08,9896
2376,技嘉,45,27,18,元大-台南,2024-05-08,9896
2017,官田鋼,22,5,17,元大-台南,2024-05-08,9896
2025,千興,27,10,17,元大-台南,2024-05-08,9896
1617,榮星,19,2,17,元大-台南,2024-05-08,9896
4306,炎洲,17,0,17,元大-台南,2024-05-08,9896
8112,至上,55,38,17,元大-台南,2024-05-08,9896
3036,文曄,18,2,16,元大-台南,2024-05-08,9896
1314,中石化,29,13,16,元大-台南,2024-05-08,9896
8277,商丞,16,0,16,元大-台南,2024-05-08,9896
2312,金寶,18,3,15,元大-台南,2024-05-08,9896
1503,士電,33,18,15,元大-台南,2024-05-08,9896
00772B,中信高評級公司債,15,1,14,元大-台南,2024-05-08,9896
2617,台航,23,9,14,元大-台南,2024-05-08,9896
1721,三晃,19,5,14,元大-台南,2024-05-08,9896
2855,統一證,49,35,14,元大-台南,2024-05-08,9896
00933B,國泰10Y+金融債,13,0,13,元大-台南,2024-05-08,9896
00918,大華優利高填息30,13,0,13,元大-台南,2024-05-08,9896
8064,東捷,18,5,13,元大-台南,2024-05-08,9896
3034,聯詠,17,4,13,元大-台南,2024-05-08,9896
2204,中華,15,3,12,元大-台南,2024-05-08,9896
2359,所羅門,39,27,12,元大-台南,2024-05-08,9896
1612,宏泰,22,10,12,元大-台南,2024-05-08,9896
3231,緯創,158,43,115,元大-台南,2024-05-09,9896
2618,長榮航,118,12,106,元大-台南,2024-05-09,9896
00918,大華優利高填息30,104,0,104,元大-台南,2024-05-09,9896
00946,群益科技高息成長,113,20,93,元大-台南,2024-05-09,9896
5880,合庫金,82,0,82,元大-台南,2024-05-09,9896
00937B,群益ESG投等債20,70,10,60,元大-台南,2024-05-09,9896
00929,復華台灣科技優息,74,16,58,元大-台南,2024-05-09,9896
8112,至上,98,44,54,元大-台南,2024-05-09,9896
00931B,統一美債20年,52,0,52,元大-台南,2024-05-09,9896
1605,華新,64,20,44,元大-台南,2024-05-09,9896
2367,燿華,71,28,43,元大-台南,2024-05-09,9896
1301,台塑,39,0,39,元大-台南,2024-05-09,9896
00878,國泰永續高股息,57,19,38,元大-台南,2024-05-09,9896
5871,中租-KY,39,3,36,元大-台南,2024-05-09,9896
1515,力山,35,0,35,元大-台南,2024-05-09,9896
2409,友達,44,9,35,元大-台南,2024-05-09,9896
00882,中信中國高股息,38,4,34,元大-台南,2024-05-09,9896
2889,國票金,39,7,32,元大-台南,2024-05-09,9896
1522,堤維西,34,3,31,元大-台南,2024-05-09,9896
2515,中工,39,10,29,元大-台南,2024-05-09,9896
00679B,元大美債20年,34,6,28,元大-台南,2024-05-09,9896
2025,千興,25,0,25,元大-台南,2024-05-09,9896
2605,新興,34,9,25,元大-台南,2024-05-09,9896
3036,文曄,33,8,25,元大-台南,2024-05-09,9896
2363,矽統,53,30,23,元大-台南,2024-05-09,9896
2465,麗臺,23,0,23,元大-台南,2024-05-09,9896
1815,富喬,66,43,23,元大-台南,2024-05-09,9896
1307,三芳,23,2,21,元大-台南,2024-05-09,9896
6112,邁達特,20,0,20,元大-台南,2024-05-09,9896
3047,訊舟,22,3,19,元大-台南,2024-05-09,9896
2834,臺企銀,21,3,18,元大-台南,2024-05-09,9896
00932,兆豐永續高息等權,18,0,18,元大-台南,2024-05-09,9896
2354,鴻準,27,10,17,元大-台南,2024-05-09,9896
2017,官田鋼,27,10,17,元大-台南,2024-05-09,9896
3706,神達,21,4,17,元大-台南,2024-05-09,9896
00944,野村趨勢動能高息,17,0,17,元大-台南,2024-05-09,9896
8277,商丞,23,7,16,元大-台南,2024-05-09,9896
2887,台新金,16,1,15,元大-台南,2024-05-09,9896
00665L,富邦�琤肭磪囓�2,15,0,15,元大-台南,2024-05-09,9896
2206,三陽工業,16,2,14,元大-台南,2024-05-09,9896
2612,中航,14,0,14,元大-台南,2024-05-09,9896
8086,宏捷科,15,1,14,元大-台南,2024-05-09,9896
8938,明安,16,2,14,元大-台南,2024-05-09,9896
3312,弘憶股,64,50,14,元大-台南,2024-05-09,9896
5014,建錩,14,0,14,元大-台南,2024-05-09,9896
00680L,元大美債20正2,13,0,13,元大-台南,2024-05-09,9896
6683,雍智科技,13,0,13,元大-台南,2024-05-09,9896
1714,和桐,15,2,13,元大-台南,2024-05-09,9896
6257,矽格,12,0,12,元大-台南,2024-05-09,9896
5351,鈺創,11,0,11,元大-台南,2024-05-09,9896
00940,元大台灣價值高息,587,48,539,元大-台南,2024-05-10,9896
2883,凱基金,410,46,364,元大-台南,2024-05-10,9896
00929,復華台灣科技優息,340,36,304,元大-台南,2024-05-10,9896
00937B,群益ESG投等債20,224,33,191,元大-台南,2024-05-10,9896
00715L,期街口布蘭特正2,204,49,155,元大-台南,2024-05-10,9896
2634,漢翔,134,5,129,元大-台南,2024-05-10,9896
3706,神達,121,27,94,元大-台南,2024-05-10,9896
1909,榮成,93,3,90,元大-台南,2024-05-10,9896
8112,至上,130,48,82,元大-台南,2024-05-10,9896
00632R,元大台灣50反1,83,3,80,元大-台南,2024-05-10,9896
5243,乙盛-KY,71,0,71,元大-台南,2024-05-10,9896
6177,達麗,88,24,64,元大-台南,2024-05-10,9896
00946,群益科技高息成長,61,0,61,元大-台南,2024-05-10,9896
00891,中信關鍵半導體,57,1,56,元大-台南,2024-05-10,9896
2606,裕民,93,44,49,元大-台南,2024-05-10,9896
2390,云辰,49,0,49,元大-台南,2024-05-10,9896
2313,華通,70,27,43,元大-台南,2024-05-10,9896
2017,官田鋼,40,0,40,元大-台南,2024-05-10,9896
00944,野村趨勢動能高息,39,0,39,元大-台南,2024-05-10,9896
3044,健鼎,46,11,35,元大-台南,2024-05-10,9896
3356,奇偶,41,10,31,元大-台南,2024-05-10,9896
2331,精英,30,0,30,元大-台南,2024-05-10,9896
00857B,永豐20年美公債,29,0,29,元大-台南,2024-05-10,9896
8277,商丞,53,24,29,元大-台南,2024-05-10,9896
2352,佳世達,41,14,27,元大-台南,2024-05-10,9896
00919,群益台灣精選高息,36,9,27,元大-台南,2024-05-10,9896
4532,瑞智,25,0,25,元大-台南,2024-05-10,9896
00795B,中信美國公債20年,25,0,25,元大-台南,2024-05-10,9896
2317,鴻海,38,13,25,元大-台南,2024-05-10,9896
9950,萬國通,23,0,23,元大-台南,2024-05-10,9896
00939,統一台灣高息動能,28,7,21,元大-台南,2024-05-10,9896
3081,聯亞,20,0,20,元大-台南,2024-05-10,9896
6120,達運,20,0,20,元大-台南,2024-05-10,9896
00932,兆豐永續高息等權,19,0,19,元大-台南,2024-05-10,9896
2208,台船,22,4,18,元大-台南,2024-05-10,9896
2887,台新金,23,7,16,元大-台南,2024-05-10,9896
3036,文曄,26,11,15,元大-台南,2024-05-10,9896
6187,萬潤,14,0,14,元大-台南,2024-05-10,9896
2489,瑞軒,18,4,14,元大-台南,2024-05-10,9896
1784,訊聯,15,1,14,元大-台南,2024-05-10,9896
3303,岱稜,16,2,14,元大-台南,2024-05-10,9896
2355,敬鵬,13,0,13,元大-台南,2024-05-10,9896
2101,南港,13,0,13,元大-台南,2024-05-10,9896
3013,晟銘電,78,65,13,元大-台南,2024-05-10,9896
9105,泰金寶-DR,13,0,13,元大-台南,2024-05-10,9896
00713,元大台灣高息低波,15,3,12,元大-台南,2024-05-10,9896
2409,友達,13,1,12,元大-台南,2024-05-10,9896
00664R,國泰臺灣加權反1,12,0,12,元大-台南,2024-05-10,9896
9945,潤泰新,12,0,12,元大-台南,2024-05-10,9896
1906,寶隆,11,0,11,元大-台南,2024-05-10,9896
2888,新光金,281,2,279,元大-台南,2024-05-13,9896
00937B,群益ESG投等債20,303,79,224,元大-台南,2024-05-13,9896
00929,復華台灣科技優息,360,136,224,元大-台南,2024-05-13,9896
00632R,元大台灣50反1,132,0,132,元大-台南,2024-05-13,9896
2618,長榮航,333,208,125,元大-台南,2024-05-13,9896
00664R,國泰臺灣加權反1,100,0,100,元大-台南,2024-05-13,9896
1808,潤隆,76,1,75,元大-台南,2024-05-13,9896
00679B,元大美債20年,73,13,60,元大-台南,2024-05-13,9896
2634,漢翔,59,0,59,元大-台南,2024-05-13,9896
2867,三商壽,60,1,59,元大-台南,2024-05-13,9896
1524,耿鼎,64,9,55,元大-台南,2024-05-13,9896
2615,萬海,139,88,51,元大-台南,2024-05-13,9896
00857B,永豐20年美公債,50,0,50,元大-台南,2024-05-13,9896
2892,第一金,53,5,48,元大-台南,2024-05-13,9896
00720B,元大投資級公司債,48,0,48,元大-台南,2024-05-13,9896
3231,緯創,116,69,47,元大-台南,2024-05-13,9896
00715L,期街口布蘭特正2,48,10,38,元大-台南,2024-05-13,9896
00940,元大台灣價值高息,76,39,37,元大-台南,2024-05-13,9896
2317,鴻海,47,12,35,元大-台南,2024-05-13,9896
2605,新興,67,35,32,元大-台南,2024-05-13,9896
00687B,國泰20年美債,77,46,31,元大-台南,2024-05-13,9896
8926,台汽電,32,2,30,元大-台南,2024-05-13,9896
9950,萬國通,50,20,30,元大-台南,2024-05-13,9896
00891,中信關鍵半導體,30,0,30,元大-台南,2024-05-13,9896
6187,萬潤,27,2,25,元大-台南,2024-05-13,9896
2440,太空梭,23,0,23,元大-台南,2024-05-13,9896
1563,巧新,29,6,23,元大-台南,2024-05-13,9896
00946,群益科技高息成長,28,6,22,元大-台南,2024-05-13,9896
00772B,中信高評級公司債,41,19,22,元大-台南,2024-05-13,9896
2353,宏��,27,6,21,元大-台南,2024-05-13,9896
2352,佳世達,21,0,21,元大-台南,2024-05-13,9896
6505,台塑化,21,1,20,元大-台南,2024-05-13,9896
6177,達麗,21,1,20,元大-台南,2024-05-13,9896
911608,明輝-DR,20,0,20,元大-台南,2024-05-13,9896
2362,藍天,29,9,20,元大-台南,2024-05-13,9896
00919,群益台灣精選高息,23,3,20,元大-台南,2024-05-13,9896
00881,國泰台灣5G+,24,5,19,元大-台南,2024-05-13,9896
8277,商丞,60,41,19,元大-台南,2024-05-13,9896
00939,統一台灣高息動能,21,2,19,元大-台南,2024-05-13,9896
2489,瑞軒,21,3,18,元大-台南,2024-05-13,9896
2409,友達,21,5,16,元大-台南,2024-05-13,9896
1513,中興電,22,7,15,元大-台南,2024-05-13,9896
3540,曜越,15,0,15,元大-台南,2024-05-13,9896
6168,宏齊,15,0,15,元大-台南,2024-05-13,9896
6173,信昌電,14,0,14,元大-台南,2024-05-13,9896
8096,擎亞,19,6,13,元大-台南,2024-05-13,9896
2538,基泰,13,0,13,元大-台南,2024-05-13,9896
2017,官田鋼,33,20,13,元大-台南,2024-05-13,9896
2636,台驊控股,15,2,13,元大-台南,2024-05-13,9896
2356,英業達,29,17,12,元大-台南,2024-05-13,9896
9904,寶成,1089,29,1060,元大-台南,2024-05-14,9896
1314,中石化,400,1,399,元大-台南,2024-05-14,9896
00632R,元大台灣50反1,459,381,78,元大-台南,2024-05-14,9896
2891,中信金,83,14,69,元大-台南,2024-05-14,9896
2353,宏��,203,135,68,元大-台南,2024-05-14,9896
00712,復華富時不動產,61,6,55,元大-台南,2024-05-14,9896
6589,台康生技,50,0,50,元大-台南,2024-05-14,9896
3231,緯創,79,34,45,元大-台南,2024-05-14,9896
2801,彰銀,41,0,41,元大-台南,2024-05-14,9896
6177,達麗,41,1,40,元大-台南,2024-05-14,9896
1310,台苯,40,1,39,元大-台南,2024-05-14,9896
00664R,國泰臺灣加權反1,39,0,39,元大-台南,2024-05-14,9896
1101,台泥,46,8,38,元大-台南,2024-05-14,9896
00679B,元大美債20年,39,2,37,元大-台南,2024-05-14,9896
2888,新光金,50,16,34,元大-台南,2024-05-14,9896
00937B,群益ESG投等債20,31,1,30,元大-台南,2024-05-14,9896
6505,台塑化,29,0,29,元大-台南,2024-05-14,9896
00665L,富邦�琤肭磪囓�2,34,7,27,元大-台南,2024-05-14,9896
00932,兆豐永續高息等權,25,0,25,元大-台南,2024-05-14,9896
5529,鉅陞,25,0,25,元大-台南,2024-05-14,9896
2352,佳世達,20,0,20,元大-台南,2024-05-14,9896
5508,永信建,22,2,20,元大-台南,2024-05-14,9896
3236,千如,20,0,20,元大-台南,2024-05-14,9896
3481,群創,22,2,20,元大-台南,2024-05-14,9896
3036,文曄,22,3,19,元大-台南,2024-05-14,9896
2834,臺企銀,19,0,19,元大-台南,2024-05-14,9896
1522,堤維西,52,33,19,元大-台南,2024-05-14,9896
2915,潤泰全,47,29,18,元大-台南,2024-05-14,9896
5457,宣德,18,1,17,元大-台南,2024-05-14,9896
2363,矽統,68,52,16,元大-台南,2024-05-14,9896
2451,創見,16,0,16,元大-台南,2024-05-14,9896
1446,宏和,16,0,16,元大-台南,2024-05-14,9896
9945,潤泰新,51,35,16,元大-台南,2024-05-14,9896
2838,聯邦銀,16,0,16,元大-台南,2024-05-14,9896
2615,萬海,444,429,15,元大-台南,2024-05-14,9896
2731,雄獅,29,15,14,元大-台南,2024-05-14,9896
4903,聯光通,13,0,13,元大-台南,2024-05-14,9896
2855,統一證,18,5,13,元大-台南,2024-05-14,9896
2890,永豐金,13,1,12,元大-台南,2024-05-14,9896
6187,萬潤,12,0,12,元大-台南,2024-05-14,9896
2520,冠德,30,18,12,元大-台南,2024-05-14,9896
8299,群聯,17,5,12,元大-台南,2024-05-14,9896
2892,第一金,14,2,12,元大-台南,2024-05-14,9896
00946,群益科技高息成長,12,0,12,元大-台南,2024-05-14,9896
3576,聯合再生,12,0,12,元大-台南,2024-05-14,9896
2884,玉山金,13,2,11,元大-台南,2024-05-14,9896
1301,台塑,12,1,11,元大-台南,2024-05-14,9896
1584,精剛,11,0,11,元大-台南,2024-05-14,9896
2867,三商壽,11,0,11,元大-台南,2024-05-14,9896
5519,隆大,11,0,11,元大-台南,2024-05-14,9896
2356,英業達,215,47,168,元大-台南,2024-05-15,9896
00927,群益半導體收益,151,2,149,元大-台南,2024-05-15,9896
2405,輔信,127,24,103,元大-台南,2024-05-15,9896
00878,國泰永續高股息,145,43,102,元大-台南,2024-05-15,9896
00679B,元大美債20年,114,25,89,元大-台南,2024-05-15,9896
00919,群益台灣精選高息,103,27,76,元大-台南,2024-05-15,9896
2486,一詮,80,4,76,元大-台南,2024-05-15,9896
2323,中環,77,5,72,元大-台南,2024-05-15,9896
00929,復華台灣科技優息,86,20,66,元大-台南,2024-05-15,9896
00680L,元大美債20正2,62,0,62,元大-台南,2024-05-15,9896
2603,長榮,92,30,62,元大-台南,2024-05-15,9896
2449,京元電子,57,0,57,元大-台南,2024-05-15,9896
2371,大同,74,19,55,元大-台南,2024-05-15,9896
00665L,富邦�琤肭磪囓�2,52,0,52,元大-台南,2024-05-15,9896
00946,群益科技高息成長,52,0,52,元大-台南,2024-05-15,9896
2888,新光金,50,3,47,元大-台南,2024-05-15,9896
2605,新興,54,8,46,元大-台南,2024-05-15,9896
2882,國泰金,108,63,45,元大-台南,2024-05-15,9896
6505,台塑化,40,0,40,元大-台南,2024-05-15,9896
6284,佳邦,34,0,34,元大-台南,2024-05-15,9896
1312,國喬,35,2,33,元大-台南,2024-05-15,9896
6177,達麗,40,8,32,元大-台南,2024-05-15,9896
2014,中鴻,40,10,30,元大-台南,2024-05-15,9896
00933B,國泰10Y+金融債,26,1,25,元大-台南,2024-05-15,9896
5469,瀚宇博,28,3,25,元大-台南,2024-05-15,9896
2317,鴻海,91,66,25,元大-台南,2024-05-15,9896
5009,榮剛,25,1,24,元大-台南,2024-05-15,9896
00715L,期街口布蘭特正2,25,1,24,元大-台南,2024-05-15,9896
00637L,元大滬深300正2,28,5,23,元大-台南,2024-05-15,9896
5608,四維航,24,3,21,元大-台南,2024-05-15,9896
2250,IKKA-KY,23,3,20,元大-台南,2024-05-15,9896
2634,漢翔,28,8,20,元大-台南,2024-05-15,9896
2618,長榮航,37,19,18,元大-台南,2024-05-15,9896
3535,晶彩科,24,6,18,元大-台南,2024-05-15,9896
6753,龍德造船,63,47,16,元大-台南,2024-05-15,9896
6257,矽格,19,3,16,元大-台南,2024-05-15,9896
1808,潤隆,15,0,15,元大-台南,2024-05-15,9896
4533,協易機,28,13,15,元大-台南,2024-05-15,9896
4716,大立,21,6,15,元大-台南,2024-05-15,9896
1217,愛之味,15,0,15,元大-台南,2024-05-15,9896
00772B,中信高評級公司債,14,1,13,元大-台南,2024-05-15,9896
00795B,中信美國公債20年,13,0,13,元大-台南,2024-05-15,9896
2101,南港,12,0,12,元大-台南,2024-05-15,9896
1514,亞力,17,5,12,元大-台南,2024-05-15,9896
3013,晟銘電,16,4,12,元大-台南,2024-05-15,9896
2607,榮運,12,0,12,元大-台南,2024-05-15,9896
8936,國統,17,5,12,元大-台南,2024-05-15,9896
00700,富邦�琤肭磪�,12,0,12,元大-台南,2024-05-15,9896
1529,樂事綠能,14,2,12,元大-台南,2024-05-15,9896
4532,瑞智,13,1,12,元大-台南,2024-05-15,9896
00937B,群益ESG投等債20,917,213,704,元大-台南,2024-05-16,9896
00665L,富邦�琤肭磪囓�2,140,0,140,元大-台南,2024-05-16,9896
00878,國泰永續高股息,168,44,124,元大-台南,2024-05-16,9896
6753,龍德造船,105,0,105,元大-台南,2024-05-16,9896
00664R,國泰臺灣加權反1,100,0,100,元大-台南,2024-05-16,9896
2356,英業達,121,22,99,元大-台南,2024-05-16,9896
2634,漢翔,91,2,89,元大-台南,2024-05-16,9896
2014,中鴻,82,0,82,元大-台南,2024-05-16,9896
2609,陽明,549,473,76,元大-台南,2024-05-16,9896
2101,南港,63,8,55,元大-台南,2024-05-16,9896
3231,緯創,73,20,53,元大-台南,2024-05-16,9896
2382,廣達,82,35,47,元大-台南,2024-05-16,9896
00772B,中信高評級公司債,40,0,40,元大-台南,2024-05-16,9896
2882,國泰金,60,23,37,元大-台南,2024-05-16,9896
00929,復華台灣科技優息,109,71,38,元大-台南,2024-05-16,9896
00680L,元大美債20正2,54,23,31,元大-台南,2024-05-16,9896
4958,臻鼎-KY,30,0,30,元大-台南,2024-05-16,9896
1605,華新,30,1,29,元大-台南,2024-05-16,9896
4716,大立,30,3,27,元大-台南,2024-05-16,9896
2915,潤泰全,27,2,25,元大-台南,2024-05-16,9896
2515,中工,27,2,25,元大-台南,2024-05-16,9896
2365,昆盈,41,17,24,元大-台南,2024-05-16,9896
2731,雄獅,36,12,24,元大-台南,2024-05-16,9896
2301,光寶科,36,13,23,元大-台南,2024-05-16,9896
1312,國喬,25,3,22,元大-台南,2024-05-16,9896
00720B,元大投資級公司債,26,5,21,元大-台南,2024-05-16,9896
2359,所羅門,81,61,20,元大-台南,2024-05-16,9896
00891,中信關鍵半導體,19,0,19,元大-台南,2024-05-16,9896
5009,榮剛,24,5,19,元大-台南,2024-05-16,9896
00909,國泰數位支付服務,20,1,19,元大-台南,2024-05-16,9896
3706,神達,21,3,18,元大-台南,2024-05-16,9896
2405,輔信,20,2,18,元大-台南,2024-05-16,9896
8069,元太,17,0,17,元大-台南,2024-05-16,9896
2323,中環,22,5,17,元大-台南,2024-05-16,9896
00946,群益科技高息成長,18,2,16,元大-台南,2024-05-16,9896
5392,能率,43,27,16,元大-台南,2024-05-16,9896
00637L,元大滬深300正2,22,6,16,元大-台南,2024-05-16,9896
1784,訊聯,15,0,15,元大-台南,2024-05-16,9896
00651R,復華香港反1,15,0,15,元大-台南,2024-05-16,9896
9105,泰金寶-DR,35,20,15,元大-台南,2024-05-16,9896
6505,台塑化,14,0,14,元大-台南,2024-05-16,9896
9904,寶成,46,32,14,元大-台南,2024-05-16,9896
8358,金居,62,48,14,元大-台南,2024-05-16,9896
2511,太子,15,2,13,元大-台南,2024-05-16,9896
1314,中石化,15,2,13,元大-台南,2024-05-16,9896
6789,采鈺,16,3,13,元大-台南,2024-05-16,9896
3236,千如,13,0,13,元大-台南,2024-05-16,9896
2362,藍天,71,58,13,元大-台南,2024-05-16,9896
00650L,復華香港正2,13,0,13,元大-台南,2024-05-16,9896
00933B,國泰10Y+金融債,25,13,12,元大-台南,2024-05-16,9896
00937B,群益ESG投等債20,447,40,407,元大-台南,2024-05-17,9896
00878,國泰永續高股息,196,12,184,元大-台南,2024-05-17,9896
00632R,元大台灣50反1,144,14,130,元大-台南,2024-05-17,9896
00929,復華台灣科技優息,127,12,115,元大-台南,2024-05-17,9896
2888,新光金,102,15,87,元大-台南,2024-05-17,9896
2367,燿華,199,125,74,元大-台南,2024-05-17,9896
00665L,富邦�琤肭磪囓�2,65,0,65,元大-台南,2024-05-17,9896
00637L,元大滬深300正2,67,4,63,元大-台南,2024-05-17,9896
00940,元大台灣價值高息,75,15,60,元大-台南,2024-05-17,9896
00720B,元大投資級公司債,52,2,50,元大-台南,2024-05-17,9896
2409,友達,80,34,46,元大-台南,2024-05-17,9896
6505,台塑化,39,0,39,元大-台南,2024-05-17,9896
5392,能率,115,77,38,元大-台南,2024-05-17,9896
00712,復華富時不動產,37,0,37,元大-台南,2024-05-17,9896
2317,鴻海,62,26,36,元大-台南,2024-05-17,9896
00918,大華優利高填息30,40,5,35,元大-台南,2024-05-17,9896
6257,矽格,38,5,33,元大-台南,2024-05-17,9896
6264,富裔,38,8,30,元大-台南,2024-05-17,9896
3221,台嘉碩,30,0,30,元大-台南,2024-05-17,9896
00650L,復華香港正2,32,4,28,元大-台南,2024-05-17,9896
1303,南亞,25,0,25,元大-台南,2024-05-17,9896
2349,錸德,25,2,23,元大-台南,2024-05-17,9896
00680L,元大美債20正2,30,8,22,元大-台南,2024-05-17,9896
0055,元大MSCI金融,20,0,20,元大-台南,2024-05-17,9896
3312,弘憶股,50,31,19,元大-台南,2024-05-17,9896
2603,長榮,45,26,19,元大-台南,2024-05-17,9896
2489,瑞軒,66,48,18,元大-台南,2024-05-17,9896
2612,中航,18,0,18,元大-台南,2024-05-17,9896
2609,陽明,42,25,17,元大-台南,2024-05-17,9896
1582,信錦,19,2,17,元大-台南,2024-05-17,9896
00679B,元大美債20年,32,15,17,元大-台南,2024-05-17,9896
2103,台橡,16,0,16,元大-台南,2024-05-17,9896
2352,佳世達,17,1,16,元大-台南,2024-05-17,9896
3706,神達,16,0,16,元大-台南,2024-05-17,9896
1457,宜進,20,5,15,元大-台南,2024-05-17,9896
2630,亞航,19,4,15,元大-台南,2024-05-17,9896
8277,商丞,36,22,14,元大-台南,2024-05-17,9896
2033,佳大,14,0,14,元大-台南,2024-05-17,9896
3617,碩天,15,1,14,元大-台南,2024-05-17,9896
2474,可成,14,0,14,元大-台南,2024-05-17,9896
6147,頎邦,13,0,13,元大-台南,2024-05-17,9896
2883,凱基金,55,42,13,元大-台南,2024-05-17,9896
6789,采鈺,13,0,13,元大-台南,2024-05-17,9896
1808,潤隆,13,0,13,元大-台南,2024-05-17,9896
00751B,元大AAA至A公司債,12,0,12,元大-台南,2024-05-17,9896
2537,聯上發,29,17,12,元大-台南,2024-05-17,9896
2323,中環,20,8,12,元大-台南,2024-05-17,9896
3260,威剛,12,1,11,元大-台南,2024-05-17,9896
2520,冠德,27,16,11,元大-台南,2024-05-17,9896
2025,千興,11,0,11,元大-台南,2024-05-17,9896
00929,復華台灣科技優息,247,33,214,元大-台南,2024-05-20,9896
00632R,元大台灣50反1,216,51,165,元大-台南,2024-05-20,9896
00665L,富邦�琤肭磪囓�2,123,5,118,元大-台南,2024-05-20,9896
2515,中工,121,10,111,元大-台南,2024-05-20,9896
00919,群益台灣精選高息,131,22,109,元大-台南,2024-05-20,9896
00933B,國泰10Y+金融債,106,0,106,元大-台南,2024-05-20,9896
00679B,元大美債20年,103,2,101,元大-台南,2024-05-20,9896
00946,群益科技高息成長,101,0,101,元大-台南,2024-05-20,9896
00937B,群益ESG投等債20,105,16,89,元大-台南,2024-05-20,9896
1587,吉茂,107,38,69,元大-台南,2024-05-20,9896
00650L,復華香港正2,60,1,59,元大-台南,2024-05-20,9896
2888,新光金,73,26,47,元大-台南,2024-05-20,9896
00915,凱基優選高股息30,43,0,43,元大-台南,2024-05-20,9896
00720B,元大投資級公司債,50,10,40,元大-台南,2024-05-20,9896
2317,鴻海,67,27,40,元大-台南,2024-05-20,9896
3686,達能,38,1,37,元大-台南,2024-05-20,9896
2002,中鋼,46,13,33,元大-台南,2024-05-20,9896
2401,凌陽,43,14,29,元大-台南,2024-05-20,9896
00878,國泰永續高股息,77,49,28,元大-台南,2024-05-20,9896
2356,英業達,48,20,28,元大-台南,2024-05-20,9896
3390,旭軟,26,0,26,元大-台南,2024-05-20,9896
2353,宏��,27,2,25,元大-台南,2024-05-20,9896
00757,統一FANG+,25,0,25,元大-台南,2024-05-20,9896
3691,碩禾,25,0,25,元大-台南,2024-05-20,9896
00857B,永豐20年美公債,23,0,23,元大-台南,2024-05-20,9896
2618,長榮航,92,70,22,元大-台南,2024-05-20,9896
2449,京元電子,27,6,21,元大-台南,2024-05-20,9896
2352,佳世達,33,13,20,元大-台南,2024-05-20,9896
1313,聯成,20,1,19,元大-台南,2024-05-20,9896
3294,英濟,19,0,19,元大-台南,2024-05-20,9896
2344,華邦電,19,0,19,元大-台南,2024-05-20,9896
8044,網家,19,1,18,元大-台南,2024-05-20,9896
1785,光洋科,23,5,18,元大-台南,2024-05-20,9896
00712,復華富時不動產,48,30,18,元大-台南,2024-05-20,9896
2527,宏璟,18,2,16,元大-台南,2024-05-20,9896
5351,鈺創,19,3,16,元大-台南,2024-05-20,9896
6264,富裔,30,14,16,元大-台南,2024-05-20,9896
6189,豐藝,18,2,16,元大-台南,2024-05-20,9896
4763,材料-KY,19,4,15,元大-台南,2024-05-20,9896
00763U,期街口道瓊銅,15,0,15,元大-台南,2024-05-20,9896
00680L,元大美債20正2,17,3,14,元大-台南,2024-05-20,9896
8096,擎亞,28,14,14,元大-台南,2024-05-20,9896
3010,華立,18,4,14,元大-台南,2024-05-20,9896
2442,新美齊,19,5,14,元大-台南,2024-05-20,9896
3706,神達,29,16,13,元大-台南,2024-05-20,9896
2329,華泰,18,5,13,元大-台南,2024-05-20,9896
2382,廣達,26,13,13,元大-台南,2024-05-20,9896
3033,威健,34,21,13,元大-台南,2024-05-20,9896
2206,三陽工業,13,1,12,元大-台南,2024-05-20,9896
00688L,國泰20年美債正2,12,0,12,元大-台南,2024-05-20,9896
2409,友達,139,0,139,元大-台南,2024-05-21,9896
00712,復華富時不動產,104,0,104,元大-台南,2024-05-21,9896
00937B,群益ESG投等債20,96,2,94,元大-台南,2024-05-21,9896
00753L,中信中國50正2,101,26,75,元大-台南,2024-05-21,9896
00632R,元大台灣50反1,116,46,70,元大-台南,2024-05-21,9896
00650L,復華香港正2,65,3,62,元大-台南,2024-05-21,9896
6264,富裔,73,12,61,元大-台南,2024-05-21,9896
00929,復華台灣科技優息,100,47,53,元大-台南,2024-05-21,9896
2892,第一金,52,8,44,元大-台南,2024-05-21,9896
2883,凱基金,46,3,43,元大-台南,2024-05-21,9896
00878,國泰永續高股息,44,1,43,元大-台南,2024-05-21,9896
2888,新光金,197,161,36,元大-台南,2024-05-21,9896
00946,群益科技高息成長,34,0,34,元大-台南,2024-05-21,9896
2723,美食-KY,34,0,34,元大-台南,2024-05-21,9896
00693U,期街口S＆P黃豆,32,0,32,元大-台南,2024-05-21,9896
00857B,永豐20年美公債,31,0,31,元大-台南,2024-05-21,9896
00919,群益台灣精選高息,39,8,31,元大-台南,2024-05-21,9896
00679B,元大美債20年,35,5,30,元大-台南,2024-05-21,9896
6770,力積電,30,1,29,元大-台南,2024-05-21,9896
2515,中工,34,5,29,元大-台南,2024-05-21,9896
8028,昇陽半導體,31,3,28,元大-台南,2024-05-21,9896
2887,台新金,27,0,27,元大-台南,2024-05-21,9896
6548,長科*,26,0,26,元大-台南,2024-05-21,9896
2867,三商壽,80,56,24,元大-台南,2024-05-21,9896
2609,陽明,29,7,22,元大-台南,2024-05-21,9896
2634,漢翔,34,12,22,元大-台南,2024-05-21,9896
2027,大成鋼,57,35,22,元大-台南,2024-05-21,9896
3260,威剛,42,20,22,元大-台南,2024-05-21,9896
4533,協易機,61,41,20,元大-台南,2024-05-21,9896
2329,華泰,27,8,19,元大-台南,2024-05-21,9896
1303,南亞,21,3,18,元大-台南,2024-05-21,9896
3481,群創,26,8,18,元大-台南,2024-05-21,9896
2002,中鋼,16,1,15,元大-台南,2024-05-21,9896
2705,六福,14,0,14,元大-台南,2024-05-21,9896
2834,臺企銀,17,3,14,元大-台南,2024-05-21,9896
00665L,富邦�琤肭磪囓�2,14,0,14,元大-台南,2024-05-21,9896
1440,南紡,14,0,14,元大-台南,2024-05-21,9896
2365,昆盈,25,11,14,元大-台南,2024-05-21,9896
2891,中信金,19,6,13,元大-台南,2024-05-21,9896
2884,玉山金,18,5,13,元大-台南,2024-05-21,9896
4958,臻鼎-KY,13,0,13,元大-台南,2024-05-21,9896
2363,矽統,32,19,13,元大-台南,2024-05-21,9896
1702,南僑,13,0,13,元大-台南,2024-05-21,9896
3576,聯合再生,14,1,13,元大-台南,2024-05-21,9896
3703,欣陸,16,4,12,元大-台南,2024-05-21,9896
00680L,元大美債20正2,14,2,12,元大-台南,2024-05-21,9896
5521,工信,12,0,12,元大-台南,2024-05-21,9896
5392,能率,63,51,12,元大-台南,2024-05-21,9896
2603,長榮,14,3,11,元大-台南,2024-05-21,9896
1437,勤益控,11,0,11,元大-台南,2024-05-21,9896
6806,森崴能源,413,8,405,元大-台南,2024-05-22,9896
3430,奇鈦科,190,0,190,元大-台南,2024-05-22,9896
00933B,國泰10Y+金融債,208,19,189,元大-台南,2024-05-22,9896
2883,凱基金,200,40,160,元大-台南,2024-05-22,9896
00715L,期街口布蘭特正2,135,0,135,元大-台南,2024-05-22,9896
2618,長榮航,164,65,99,元大-台南,2024-05-22,9896
00937B,群益ESG投等債20,97,6,91,元大-台南,2024-05-22,9896
00679B,元大美債20年,79,3,76,元大-台南,2024-05-22,9896
2002,中鋼,61,2,59,元大-台南,2024-05-22,9896
2027,大成鋼,50,2,48,元大-台南,2024-05-22,9896
2367,燿華,119,74,45,元大-台南,2024-05-22,9896
3013,晟銘電,108,63,45,元大-台南,2024-05-22,9896
6266,泰詠,41,0,41,元大-台南,2024-05-22,9896
6215,和椿,41,1,40,元大-台南,2024-05-22,9896
2634,漢翔,39,0,39,元大-台南,2024-05-22,9896
00664R,國泰臺灣加權反1,39,0,39,元大-台南,2024-05-22,9896
2884,玉山金,35,3,32,元大-台南,2024-05-22,9896
5392,能率,134,102,32,元大-台南,2024-05-22,9896
2610,華航,35,3,32,元大-台南,2024-05-22,9896
3706,神達,65,35,30,元大-台南,2024-05-22,9896
2867,三商壽,56,27,29,元大-台南,2024-05-22,9896
2312,金寶,29,3,26,元大-台南,2024-05-22,9896
1605,華新,25,1,24,元大-台南,2024-05-22,9896
1303,南亞,24,0,24,元大-台南,2024-05-22,9896
2486,一詮,27,4,23,元大-台南,2024-05-22,9896
3014,聯陽,25,3,22,元大-台南,2024-05-22,9896
00878,國泰永續高股息,46,24,22,元大-台南,2024-05-22,9896
9904,寶成,27,7,20,元大-台南,2024-05-22,9896
6168,宏齊,20,0,20,元大-台南,2024-05-22,9896
8277,商丞,21,2,19,元大-台南,2024-05-22,9896
6116,彩晶,23,6,17,元大-台南,2024-05-22,9896
2206,三陽工業,21,4,17,元大-台南,2024-05-22,9896
00632R,元大台灣50反1,277,260,17,元大-台南,2024-05-22,9896
2363,矽統,41,24,17,元大-台南,2024-05-22,9896
1608,華榮,28,11,17,元大-台南,2024-05-22,9896
2915,潤泰全,17,1,16,元大-台南,2024-05-22,9896
5230,雷笛克光學,20,4,16,元大-台南,2024-05-22,9896
2349,錸德,16,0,16,元大-台南,2024-05-22,9896
1314,中石化,16,1,15,元大-台南,2024-05-22,9896
4111,濟生,18,3,15,元大-台南,2024-05-22,9896
3060,銘異,35,20,15,元大-台南,2024-05-22,9896
2313,華通,17,3,14,元大-台南,2024-05-22,9896
2504,國產,15,1,14,元大-台南,2024-05-22,9896
9912,偉聯,14,0,14,元大-台南,2024-05-22,9896
2611,志信,14,0,14,元大-台南,2024-05-22,9896
6189,豐藝,15,1,14,元大-台南,2024-05-22,9896
2017,官田鋼,14,0,14,元大-台南,2024-05-22,9896
3059,華晶科,26,12,14,元大-台南,2024-05-22,9896
2606,裕民,20,7,13,元大-台南,2024-05-22,9896
2882,國泰金,18,5,13,元大-台南,2024-05-22,9896
00929,復華台灣科技優息,604,161,443,元大-台南,2024-05-23,9896
00632R,元大台灣50反1,538,190,348,元大-台南,2024-05-23,9896
2409,友達,181,40,141,元大-台南,2024-05-23,9896
2883,凱基金,119,6,113,元大-台南,2024-05-23,9896
1101,台泥,83,2,81,元大-台南,2024-05-23,9896
2353,宏��,279,203,76,元大-台南,2024-05-23,9896
3481,群創,131,59,72,元大-台南,2024-05-23,9896
2324,仁寶,113,45,68,元大-台南,2024-05-23,9896
3260,威剛,72,16,56,元大-台南,2024-05-23,9896
2610,華航,101,50,51,元大-台南,2024-05-23,9896
00715L,期街口布蘭特正2,47,0,47,元大-台南,2024-05-23,9896
1409,新纖,42,1,41,元大-台南,2024-05-23,9896
1587,吉茂,44,4,40,元大-台南,2024-05-23,9896
3430,奇鈦科,40,0,40,元大-台南,2024-05-23,9896
4420,光明,40,0,40,元大-台南,2024-05-23,9896
00919,群益台灣精選高息,61,21,40,元大-台南,2024-05-23,9896
2356,英業達,56,16,40,元大-台南,2024-05-23,9896
2002,中鋼,76,37,39,元大-台南,2024-05-23,9896
2009,第一銅,44,8,36,元大-台南,2024-05-23,9896
2606,裕民,34,1,33,元大-台南,2024-05-23,9896
6147,頎邦,32,0,32,元大-台南,2024-05-23,9896
2331,精英,35,4,31,元大-台南,2024-05-23,9896
1815,富喬,203,172,31,元大-台南,2024-05-23,9896
4306,炎洲,32,1,31,元大-台南,2024-05-23,9896
2101,南港,30,0,30,元大-台南,2024-05-23,9896
4133,亞諾法,30,0,30,元大-台南,2024-05-23,9896
6209,今國光,36,8,28,元大-台南,2024-05-23,9896
2401,凌陽,27,0,27,元大-台南,2024-05-23,9896
6282,康舒,30,3,27,元大-台南,2024-05-23,9896
3419,譁裕,80,53,27,元大-台南,2024-05-23,9896
2206,三陽工業,32,5,27,元大-台南,2024-05-23,9896
2618,長榮航,64,40,24,元大-台南,2024-05-23,9896
2034,允強,24,1,23,元大-台南,2024-05-23,9896
2892,第一金,31,11,20,元大-台南,2024-05-23,9896
8064,東捷,31,11,20,元大-台南,2024-05-23,9896
6168,宏齊,20,0,20,元大-台南,2024-05-23,9896
5871,中租-KY,22,2,20,元大-台南,2024-05-23,9896
6188,廣明,62,43,19,元大-台南,2024-05-23,9896
2352,佳世達,26,8,18,元大-台南,2024-05-23,9896
1312,國喬,18,0,18,元大-台南,2024-05-23,9896
8068,全達,18,0,18,元大-台南,2024-05-23,9896
6234,高僑,43,25,18,元大-台南,2024-05-23,9896
9933,中鼎,18,0,18,元大-台南,2024-05-23,9896
2359,所羅門,192,174,18,元大-台南,2024-05-23,9896
2882,國泰金,26,9,17,元大-台南,2024-05-23,9896
2886,兆豐金,17,0,17,元大-台南,2024-05-23,9896
2014,中鴻,17,0,17,元大-台南,2024-05-23,9896
9904,寶成,27,10,17,元大-台南,2024-05-23,9896
1515,力山,17,0,17,元大-台南,2024-05-23,9896
2630,亞航,38,21,17,元大-台南,2024-05-23,9896
00632R,元大台灣50反1,905,104,801,元大-台南,2024-05-24,9896
00937B,群益ESG投等債20,516,78,438,元大-台南,2024-05-24,9896
00712,復華富時不動產,129,0,129,元大-台南,2024-05-24,9896
9904,寶成,117,0,117,元大-台南,2024-05-24,9896
2884,玉山金,117,5,112,元大-台南,2024-05-24,9896
5289,宜鼎,102,1,101,元大-台南,2024-05-24,9896
1587,吉茂,80,0,80,元大-台南,2024-05-24,9896
2303,聯電,71,7,64,元大-台南,2024-05-24,9896
00940,元大台灣價值高息,138,83,55,元大-台南,2024-05-24,9896
6177,達麗,54,1,53,元大-台南,2024-05-24,9896
2367,燿華,120,76,44,元大-台南,2024-05-24,9896
00679B,元大美債20年,54,12,42,元大-台南,2024-05-24,9896
2365,昆盈,133,95,38,元大-台南,2024-05-24,9896
6209,今國光,45,10,35,元大-台南,2024-05-24,9896
00772B,中信高評級公司債,30,0,30,元大-台南,2024-05-24,9896
6147,頎邦,30,1,29,元大-台南,2024-05-24,9896
00941,中信上游半導體,41,12,29,元大-台南,2024-05-24,9896
00878,國泰永續高股息,34,5,29,元大-台南,2024-05-24,9896
2834,臺企銀,28,0,28,元大-台南,2024-05-24,9896
2891,中信金,41,15,26,元大-台南,2024-05-24,9896
2453,凌群,32,7,25,元大-台南,2024-05-24,9896
2324,仁寶,86,61,25,元大-台南,2024-05-24,9896
2486,一詮,91,67,24,元大-台南,2024-05-24,9896
3081,聯亞,24,0,24,元大-台南,2024-05-24,9896
4979,華星光,29,6,23,元大-台南,2024-05-24,9896
6288,聯嘉,24,1,23,元大-台南,2024-05-24,9896
1609,大亞,45,23,22,元大-台南,2024-05-24,9896
3005,神基,23,1,22,元大-台南,2024-05-24,9896
2313,華通,22,1,21,元大-台南,2024-05-24,9896
00857B,永豐20年美公債,26,5,21,元大-台南,2024-05-24,9896
3706,神達,25,5,20,元大-台南,2024-05-24,9896
2606,裕民,22,2,20,元大-台南,2024-05-24,9896
5880,合庫金,19,0,19,元大-台南,2024-05-24,9896
2887,台新金,19,0,19,元大-台南,2024-05-24,9896
2002,中鋼,19,0,19,元大-台南,2024-05-24,9896
00687B,國泰20年美債,22,5,17,元大-台南,2024-05-24,9896
00665L,富邦�琤肭磪囓�2,17,0,17,元大-台南,2024-05-24,9896
2515,中工,17,0,17,元大-台南,2024-05-24,9896
00637L,元大滬深300正2,20,4,16,元大-台南,2024-05-24,9896
5009,榮剛,16,0,16,元大-台南,2024-05-24,9896
6264,富裔,111,95,16,元大-台南,2024-05-24,9896
3231,緯創,30,14,16,元大-台南,2024-05-24,9896
2017,官田鋼,15,0,15,元大-台南,2024-05-24,9896
2605,新興,17,2,15,元大-台南,2024-05-24,9896
1316,上曜,16,1,15,元大-台南,2024-05-24,9896
9945,潤泰新,16,1,15,元大-台南,2024-05-24,9896
3163,波若威,46,32,14,元大-台南,2024-05-24,9896
00715L,期街口布蘭特正2,16,2,14,元大-台南,2024-05-24,9896
00719B,元大美債1-3,16,3,13,元大-台南,2024-05-24,9896
6770,力積電,13,0,13,元大-台南,2024-05-24,9896
2301,光寶科,757,33,724,元大-台南,2024-05-27,9896
00933B,國泰10Y+金融債,213,2,211,元大-台南,2024-05-27,9896
1303,南亞,207,1,206,元大-台南,2024-05-27,9896
2883,凱基金,128,7,121,元大-台南,2024-05-27,9896
1326,台化,103,10,93,元大-台南,2024-05-27,9896
2353,宏��,180,95,85,元大-台南,2024-05-27,9896
00637L,元大滬深300正2,72,5,67,元大-台南,2024-05-27,9896
2618,長榮航,66,6,60,元大-台南,2024-05-27,9896
2002,中鋼,58,1,57,元大-台南,2024-05-27,9896
2511,太子,50,1,49,元大-台南,2024-05-27,9896
00679B,元大美債20年,64,17,47,元大-台南,2024-05-27,9896
1815,富喬,113,66,47,元大-台南,2024-05-27,9896
00632R,元大台灣50反1,147,100,47,元大-台南,2024-05-27,9896
2886,兆豐金,46,1,45,元大-台南,2024-05-27,9896
3481,群創,60,16,44,元大-台南,2024-05-27,9896
00941,中信上游半導體,38,0,38,元大-台南,2024-05-27,9896
2401,凌陽,49,13,36,元大-台南,2024-05-27,9896
2363,矽統,181,148,33,元大-台南,2024-05-27,9896
2887,台新金,32,1,31,元大-台南,2024-05-27,9896
3430,奇鈦科,30,0,30,元大-台南,2024-05-27,9896
0055,元大MSCI金融,30,0,30,元大-台南,2024-05-27,9896
3033,威健,35,6,29,元大-台南,2024-05-27,9896
8277,商丞,46,18,28,元大-台南,2024-05-27,9896
2313,華通,29,2,27,元大-台南,2024-05-27,9896
1617,榮星,27,0,27,元大-台南,2024-05-27,9896
1513,中興電,35,9,26,元大-台南,2024-05-27,9896
2392,正崴,60,34,26,元大-台南,2024-05-27,9896
3260,威剛,30,4,26,元大-台南,2024-05-27,9896
4420,光明,27,1,26,元大-台南,2024-05-27,9896
6120,達運,25,1,24,元大-台南,2024-05-27,9896
00650L,復華香港正2,22,0,22,元大-台南,2024-05-27,9896
3024,憶聲,28,8,20,元大-台南,2024-05-27,9896
00687B,國泰20年美債,20,1,19,元大-台南,2024-05-27,9896
00715L,期街口布蘭特正2,24,6,18,元大-台南,2024-05-27,9896
3535,晶彩科,21,3,18,元大-台南,2024-05-27,9896
2515,中工,20,2,18,元大-台南,2024-05-27,9896
00857B,永豐20年美公債,22,5,17,元大-台南,2024-05-27,9896
2884,玉山金,16,0,16,元大-台南,2024-05-27,9896
6264,富裔,43,27,16,元大-台南,2024-05-27,9896
2915,潤泰全,21,6,15,元大-台南,2024-05-27,9896
3419,譁裕,22,9,13,元大-台南,2024-05-27,9896
5498,凱崴,32,19,13,元大-台南,2024-05-27,9896
4979,華星光,24,12,12,元大-台南,2024-05-27,9896
2367,燿華,27,15,12,元大-台南,2024-05-27,9896
3498,陽程,13,1,12,元大-台南,2024-05-27,9896
3576,聯合再生,13,1,12,元大-台南,2024-05-27,9896
2330,台積電,14,3,11,元大-台南,2024-05-27,9896
6147,頎邦,13,2,11,元大-台南,2024-05-27,9896
00936,台新永續高息中小,12,1,11,元大-台南,2024-05-27,9896
3059,華晶科,17,6,11,元大-台南,2024-05-27,9896
00937B,群益ESG投等債20,152,6,146,元大-台南,2024-05-28,9896
00933B,國泰10Y+金融債,104,0,104,元大-台南,2024-05-28,9896
00882,中信中國高股息,105,12,93,元大-台南,2024-05-28,9896
2354,鴻準,213,133,80,元大-台南,2024-05-28,9896
2887,台新金,104,25,79,元大-台南,2024-05-28,9896
2409,友達,99,21,78,元大-台南,2024-05-28,9896
3231,緯創,116,47,69,元大-台南,2024-05-28,9896
1312,國喬,59,2,57,元大-台南,2024-05-28,9896
00679B,元大美債20年,56,0,56,元大-台南,2024-05-28,9896
2303,聯電,83,32,51,元大-台南,2024-05-28,9896
2615,萬海,57,10,47,元大-台南,2024-05-28,9896
2891,中信金,51,6,45,元大-台南,2024-05-28,9896
2317,鴻海,61,25,36,元大-台南,2024-05-28,9896
00751B,元大AAA至A公司債,34,0,34,元大-台南,2024-05-28,9896
2731,雄獅,37,5,32,元大-台南,2024-05-28,9896
2352,佳世達,28,2,26,元大-台南,2024-05-28,9896
2324,仁寶,31,7,24,元大-台南,2024-05-28,9896
00687B,國泰20年美債,26,4,22,元大-台南,2024-05-28,9896
2884,玉山金,23,1,22,元大-台南,2024-05-28,9896
2330,台積電,26,4,22,元大-台南,2024-05-28,9896
2867,三商壽,26,5,21,元大-台南,2024-05-28,9896
2603,長榮,46,25,21,元大-台南,2024-05-28,9896
3594,磐儀,29,9,20,元大-台南,2024-05-28,9896
2382,廣達,38,18,20,元大-台南,2024-05-28,9896
9945,潤泰新,29,9,20,元大-台南,2024-05-28,9896
6140,訊達,20,1,19,元大-台南,2024-05-28,9896
2401,凌陽,82,64,18,元大-台南,2024-05-28,9896
2027,大成鋼,19,1,18,元大-台南,2024-05-28,9896
2301,光寶科,32,14,18,元大-台南,2024-05-28,9896
6449,鈺邦,16,0,16,元大-台南,2024-05-28,9896
6264,富裔,122,106,16,元大-台南,2024-05-28,9896
8064,東捷,96,80,16,元大-台南,2024-05-28,9896
6477,安集,15,0,15,元大-台南,2024-05-28,9896
6188,廣明,51,36,15,元大-台南,2024-05-28,9896
2312,金寶,16,2,14,元大-台南,2024-05-28,9896
5905,南仁湖,20,6,14,元大-台南,2024-05-28,9896
3035,智原,35,22,13,元大-台南,2024-05-28,9896
00915,凱基優選高股息30,14,1,13,元大-台南,2024-05-28,9896
2357,華碩,14,1,13,元大-台南,2024-05-28,9896
1301,台塑,13,1,12,元大-台南,2024-05-28,9896
2313,華通,13,1,12,元大-台南,2024-05-28,9896
3056,富華新,12,0,12,元大-台南,2024-05-28,9896
3390,旭軟,16,4,12,元大-台南,2024-05-28,9896
8210,勤誠,17,6,11,元大-台南,2024-05-28,9896
3234,光環,11,0,11,元大-台南,2024-05-28,9896
2332,友訊,11,0,11,元大-台南,2024-05-28,9896
5443,均豪,13,2,11,元大-台南,2024-05-28,9896
6016,康和證,11,0,11,元大-台南,2024-05-28,9896
2353,宏��,61,50,11,元大-台南,2024-05-28,9896
5512,力麒,15,5,10,元大-台南,2024-05-28,9896
00937B,群益ESG投等債20,585,70,515,元大-台南,2024-05-29,9896
2883,凱基金,173,1,172,元大-台南,2024-05-29,9896
2610,華航,172,5,167,元大-台南,2024-05-29,9896
00679B,元大美債20年,190,39,151,元大-台南,2024-05-29,9896
00933B,國泰10Y+金融債,126,2,124,元大-台南,2024-05-29,9896
2412,中華電,93,0,93,元大-台南,2024-05-29,9896
2884,玉山金,89,2,87,元大-台南,2024-05-29,9896
9105,泰金寶-DR,85,9,76,元大-台南,2024-05-29,9896
00857B,永豐20年美公債,68,10,58,元大-台南,2024-05-29,9896
00751B,元大AAA至A公司債,56,0,56,元大-台南,2024-05-29,9896
00946,群益科技高息成長,67,11,56,元大-台南,2024-05-29,9896
1303,南亞,56,0,56,元大-台南,2024-05-29,9896
1326,台化,55,0,55,元大-台南,2024-05-29,9896
00772B,中信高評級公司債,61,10,51,元大-台南,2024-05-29,9896
2329,華泰,50,0,50,元大-台南,2024-05-29,9896
00680L,元大美債20正2,57,7,50,元大-台南,2024-05-29,9896
2888,新光金,81,31,50,元大-台南,2024-05-29,9896
2891,中信金,56,7,49,元大-台南,2024-05-29,9896
2887,台新金,48,0,48,元大-台南,2024-05-29,9896
00940,元大台灣價值高息,102,56,46,元大-台南,2024-05-29,9896
2317,鴻海,83,37,46,元大-台南,2024-05-29,9896
3430,奇鈦科,44,0,44,元大-台南,2024-05-29,9896
6189,豐藝,64,20,44,元大-台南,2024-05-29,9896
00712,復華富時不動產,46,2,44,元大-台南,2024-05-29,9896
00673R,期元大S＆P原油反1,41,0,41,元大-台南,2024-05-29,9896
2409,友達,57,17,40,元大-台南,2024-05-29,9896
3055,蔚華科,42,3,39,元大-台南,2024-05-29,9896
2609,陽明,46,7,39,元大-台南,2024-05-29,9896
1101,台泥,43,4,39,元大-台南,2024-05-29,9896
00687B,國泰20年美債,52,14,38,元大-台南,2024-05-29,9896
2867,三商壽,71,34,37,元大-台南,2024-05-29,9896
00720B,元大投資級公司債,34,0,34,元大-台南,2024-05-29,9896
00878,國泰永續高股息,36,2,34,元大-台南,2024-05-29,9896
2353,宏��,93,60,33,元大-台南,2024-05-29,9896
2401,凌陽,103,70,33,元大-台南,2024-05-29,9896
2393,億光,30,1,29,元大-台南,2024-05-29,9896
2634,漢翔,30,2,28,元大-台南,2024-05-29,9896
2892,第一金,28,0,28,元大-台南,2024-05-29,9896
1524,耿鼎,51,26,25,元大-台南,2024-05-29,9896
2890,永豐金,25,0,25,元大-台南,2024-05-29,9896
3380,明泰,36,11,25,元大-台南,2024-05-29,9896
2881,富邦金,25,0,25,元大-台南,2024-05-29,9896
2323,中環,24,0,24,元大-台南,2024-05-29,9896
6188,廣明,50,27,23,元大-台南,2024-05-29,9896
00795B,中信美國公債20年,29,8,21,元大-台南,2024-05-29,9896
2002,中鋼,22,1,21,元大-台南,2024-05-29,9896
00650L,復華香港正2,20,0,20,元大-台南,2024-05-29,9896
3047,訊舟,50,31,19,元大-台南,2024-05-29,9896
6140,訊達,20,1,19,元大-台南,2024-05-29,9896
3481,群創,20,1,19,元大-台南,2024-05-29,9896
00680L,元大美債20正2,885,6,879,元大-台南,2024-05-30,9896
00937B,群益ESG投等債20,433,55,378,元大-台南,2024-05-30,9896
00632R,元大台灣50反1,310,60,250,元大-台南,2024-05-30,9896
1303,南亞,191,0,191,元大-台南,2024-05-30,9896
00857B,永豐20年美公債,119,0,119,元大-台南,2024-05-30,9896
00940,元大台灣價值高息,126,16,110,元大-台南,2024-05-30,9896
00795B,中信美國公債20年,106,0,106,元大-台南,2024-05-30,9896
00679B,元大美債20年,106,2,104,元大-台南,2024-05-30,9896
5469,瀚宇博,94,1,93,元大-台南,2024-05-30,9896
4533,協易機,81,4,77,元大-台南,2024-05-30,9896
6168,宏齊,60,0,60,元大-台南,2024-05-30,9896
2891,中信金,58,0,58,元大-台南,2024-05-30,9896
1815,富喬,173,120,53,元大-台南,2024-05-30,9896
1326,台化,52,0,52,元大-台南,2024-05-30,9896
2489,瑞軒,90,39,51,元大-台南,2024-05-30,9896
4526,東台,48,0,48,元大-台南,2024-05-30,9896
2883,凱基金,49,2,47,元大-台南,2024-05-30,9896
00915,凱基優選高股息30,46,0,46,元大-台南,2024-05-30,9896
3430,奇鈦科,41,0,41,元大-台南,2024-05-30,9896
00946,群益科技高息成長,41,3,38,元大-台南,2024-05-30,9896
2618,長榮航,53,16,37,元大-台南,2024-05-30,9896
2515,中工,39,3,36,元大-台南,2024-05-30,9896
2392,正崴,44,8,36,元大-台南,2024-05-30,9896
00712,復華富時不動產,34,0,34,元大-台南,2024-05-30,9896
5880,合庫金,33,0,33,元大-台南,2024-05-30,9896
2890,永豐金,33,0,33,元大-台南,2024-05-30,9896
2104,國際中橡,31,0,31,元大-台南,2024-05-30,9896
2002,中鋼,33,2,31,元大-台南,2024-05-30,9896
8358,金居,32,2,30,元大-台南,2024-05-30,9896
00929,復華台灣科技優息,139,109,30,元大-台南,2024-05-30,9896
3321,同泰,28,0,28,元大-台南,2024-05-30,9896
00919,群益台灣精選高息,36,8,28,元大-台南,2024-05-30,9896
2356,英業達,29,3,26,元大-台南,2024-05-30,9896
2330,台積電,53,27,26,元大-台南,2024-05-30,9896
6140,訊達,31,6,25,元大-台南,2024-05-30,9896
4420,光明,25,1,24,元大-台南,2024-05-30,9896
00918,大華優利高填息30,27,3,24,元大-台南,2024-05-30,9896
2886,兆豐金,24,0,24,元大-台南,2024-05-30,9896
6180,橘子,27,4,23,元大-台南,2024-05-30,9896
4167,松瑞藥,24,1,23,元大-台南,2024-05-30,9896
00751B,元大AAA至A公司債,26,3,23,元大-台南,2024-05-30,9896
2834,臺企銀,22,0,22,元大-台南,2024-05-30,9896
00715L,期街口布蘭特正2,21,0,21,元大-台南,2024-05-30,9896
00939,統一台灣高息動能,23,2,21,元大-台南,2024-05-30,9896
00671R,富邦NASDAQ反1,20,0,20,元大-台南,2024-05-30,9896
2323,中環,23,3,20,元大-台南,2024-05-30,9896
2892,第一金,20,1,19,元大-台南,2024-05-30,9896
2317,鴻海,56,37,19,元大-台南,2024-05-30,9896
2301,光寶科,24,6,18,元大-台南,2024-05-30,9896
2888,新光金,35,17,18,元大-台南,2024-05-30,9896
00937B,群益ESG投等債20,383,42,341,元大-台南,2024-05-31,9896
2353,宏��,289,30,259,元大-台南,2024-05-31,9896
00940,元大台灣價值高息,703,450,253,元大-台南,2024-05-31,9896
9105,泰金寶-DR,239,4,235,元大-台南,2024-05-31,9896
2609,陽明,376,147,229,元大-台南,2024-05-31,9896
00857B,永豐20年美公債,207,0,207,元大-台南,2024-05-31,9896
00680L,元大美債20正2,106,3,103,元大-台南,2024-05-31,9896
2401,凌陽,85,12,73,元大-台南,2024-05-31,9896
00919,群益台灣精選高息,71,9,62,元大-台南,2024-05-31,9896
2489,瑞軒,70,8,62,元大-台南,2024-05-31,9896
2405,輔信,67,7,60,元大-台南,2024-05-31,9896
00715L,期街口布蘭特正2,57,0,57,元大-台南,2024-05-31,9896
2317,鴻海,84,30,54,元大-台南,2024-05-31,9896
00679B,元大美債20年,82,28,54,元大-台南,2024-05-31,9896
00687B,國泰20年美債,42,0,42,元大-台南,2024-05-31,9896
1909,榮成,40,0,40,元大-台南,2024-05-31,9896
1752,南光,35,0,35,元大-台南,2024-05-31,9896
8064,東捷,38,4,34,元大-台南,2024-05-31,9896
00929,復華台灣科技優息,81,50,31,元大-台南,2024-05-31,9896
2002,中鋼,34,4,30,元大-台南,2024-05-31,9896
00712,復華富時不動產,29,1,28,元大-台南,2024-05-31,9896
2641,正德,39,11,28,元大-台南,2024-05-31,9896
3231,緯創,38,11,27,元大-台南,2024-05-31,9896
00946,群益科技高息成長,36,9,27,元大-台南,2024-05-31,9896
00918,大華優利高填息30,25,0,25,元大-台南,2024-05-31,9896
2303,聯電,62,40,22,元大-台南,2024-05-31,9896
1316,上曜,33,12,21,元大-台南,2024-05-31,9896
2382,廣達,29,8,21,元大-台南,2024-05-31,9896
6160,欣技,21,0,21,元大-台南,2024-05-31,9896
00939,統一台灣高息動能,23,2,21,元大-台南,2024-05-31,9896
00753L,中信中國50正2,20,0,20,元大-台南,2024-05-31,9896
00915,凱基優選高股息30,19,0,19,元大-台南,2024-05-31,9896
2330,台積電,29,10,19,元大-台南,2024-05-31,9896
6278,台表科,19,1,18,元大-台南,2024-05-31,9896
3308,聯德,21,3,18,元大-台南,2024-05-31,9896
3006,晶豪科,19,1,18,元大-台南,2024-05-31,9896
00878,國泰永續高股息,35,17,18,元大-台南,2024-05-31,9896
2409,友達,17,0,17,元大-台南,2024-05-31,9896
8070,長華*,23,6,17,元大-台南,2024-05-31,9896
2633,台灣高鐵,17,0,17,元大-台南,2024-05-31,9896
3419,譁裕,69,52,17,元大-台南,2024-05-31,9896
3321,同泰,21,4,17,元大-台南,2024-05-31,9896
00891,中信關鍵半導體,16,0,16,元大-台南,2024-05-31,9896
1815,富喬,76,60,16,元大-台南,2024-05-31,9896
2349,錸德,25,10,15,元大-台南,2024-05-31,9896
2365,昆盈,22,8,14,元大-台南,2024-05-31,9896
2913,農林,17,3,14,元大-台南,2024-05-31,9896
6770,力積電,13,0,13,元大-台南,2024-05-31,9896
8028,昇陽半導體,17,4,13,元大-台南,2024-05-31,9896
4906,正文,22,9,13,元大-台南,2024-05-31,9896
00918,大華優利高填息30,458,6,452,元大-台南,2024-06-03,9896
1301,台塑,420,1,419,元大-台南,2024-06-03,9896
00937B,群益ESG投等債20,324,18,306,元大-台南,2024-06-03,9896
2401,凌陽,134,6,128,元大-台南,2024-06-03,9896
2367,燿華,97,6,91,元大-台南,2024-06-03,9896
6757,台灣虎航,80,1,79,元大-台南,2024-06-03,9896
00857B,永豐20年美公債,69,0,69,元大-台南,2024-06-03,9896
00929,復華台灣科技優息,179,112,67,元大-台南,2024-06-03,9896
3481,群創,63,3,60,元大-台南,2024-06-03,9896
1326,台化,54,3,51,元大-台南,2024-06-03,9896
00712,復華富時不動產,51,1,50,元大-台南,2024-06-03,9896
00895,富邦未來車,50,1,49,元大-台南,2024-06-03,9896
00715L,期街口布蘭特正2,67,20,47,元大-台南,2024-06-03,9896
3059,華晶科,52,5,47,元大-台南,2024-06-03,9896
1101,台泥,47,5,42,元大-台南,2024-06-03,9896
4543,萬在,40,0,40,元大-台南,2024-06-03,9896
8084,巨虹,40,0,40,元大-台南,2024-06-03,9896
00665L,富邦�琤肭磪囓�2,38,0,38,元大-台南,2024-06-03,9896
2353,宏��,82,44,38,元大-台南,2024-06-03,9896
2867,三商壽,57,20,37,元大-台南,2024-06-03,9896
2324,仁寶,51,15,36,元大-台南,2024-06-03,9896
4960,誠美材,36,0,36,元大-台南,2024-06-03,9896
00637L,元大滬深300正2,59,25,34,元大-台南,2024-06-03,9896
00946,群益科技高息成長,54,20,34,元大-台南,2024-06-03,9896
2303,聯電,69,36,33,元大-台南,2024-06-03,9896
5880,合庫金,31,0,31,元大-台南,2024-06-03,9896
4562,穎漢,45,14,31,元大-台南,2024-06-03,9896
2501,國建,37,7,30,元大-台南,2024-06-03,9896
6168,宏齊,30,1,29,元大-台南,2024-06-03,9896
2618,長榮航,44,16,28,元大-台南,2024-06-03,9896
6226,光鼎,38,10,28,元大-台南,2024-06-03,9896
1102,亞泥,27,0,27,元大-台南,2024-06-03,9896
3419,譁裕,51,24,27,元大-台南,2024-06-03,9896
6188,廣明,63,37,26,元大-台南,2024-06-03,9896
8112,至上,26,1,25,元大-台南,2024-06-03,9896
3055,蔚華科,24,2,22,元大-台南,2024-06-03,9896
4420,光明,24,2,22,元大-台南,2024-06-03,9896
1605,華新,23,2,21,元大-台南,2024-06-03,9896
2014,中鴻,21,0,21,元大-台南,2024-06-03,9896
2886,兆豐金,22,2,20,元大-台南,2024-06-03,9896
2354,鴻準,223,203,20,元大-台南,2024-06-03,9896
2883,凱基金,24,5,19,元大-台南,2024-06-03,9896
1752,南光,23,5,18,元大-台南,2024-06-03,9896
2105,正新,21,3,18,元大-台南,2024-06-03,9896
2524,京城,20,3,17,元大-台南,2024-06-03,9896
1304,台聚,17,0,17,元大-台南,2024-06-03,9896
4533,協易機,72,55,17,元大-台南,2024-06-03,9896
1218,泰山,16,0,16,元大-台南,2024-06-03,9896
6166,凌華,27,12,15,元大-台南,2024-06-03,9896
2301,光寶科,27,13,14,元大-台南,2024-06-03,9896
00937B,群益ESG投等債20,380,52,328,元大-台南,2024-06-04,9896
2888,新光金,317,21,296,元大-台南,2024-06-04,9896
00857B,永豐20年美公債,225,4,221,元大-台南,2024-06-04,9896
00919,群益台灣精選高息,201,27,174,元大-台南,2024-06-04,9896
00936,台新永續高息中小,248,95,153,元大-台南,2024-06-04,9896
00929,復華台灣科技優息,170,41,129,元大-台南,2024-06-04,9896
2610,華航,130,16,114,元大-台南,2024-06-04,9896
2353,宏��,130,29,101,元大-台南,2024-06-04,9896
00918,大華優利高填息30,98,0,98,元大-台南,2024-06-04,9896
00715L,期街口布蘭特正2,87,4,83,元大-台南,2024-06-04,9896
2303,聯電,101,21,80,元大-台南,2024-06-04,9896
2367,燿華,88,10,78,元大-台南,2024-06-04,9896
00878,國泰永續高股息,75,0,75,元大-台南,2024-06-04,9896
1326,台化,70,0,70,元大-台南,2024-06-04,9896
4533,協易機,112,42,70,元大-台南,2024-06-04,9896
2465,麗臺,79,17,62,元大-台南,2024-06-04,9896
6125,廣運,113,53,60,元大-台南,2024-06-04,9896
1802,台玻,84,27,57,元大-台南,2024-06-04,9896
00712,復華富時不動產,71,21,50,元大-台南,2024-06-04,9896
00830,國泰費城半導體,50,0,50,元大-台南,2024-06-04,9896
2002,中鋼,52,3,49,元大-台南,2024-06-04,9896
00882,中信中國高股息,53,7,46,元大-台南,2024-06-04,9896
2317,鴻海,89,44,45,元大-台南,2024-06-04,9896
2344,華邦電,57,19,38,元大-台南,2024-06-04,9896
9950,萬國通,40,2,38,元大-台南,2024-06-04,9896
2323,中環,38,0,38,元大-台南,2024-06-04,9896
2324,仁寶,36,1,35,元大-台南,2024-06-04,9896
1718,中纖,35,0,35,元大-台南,2024-06-04,9896
6270,倍微,51,17,34,元大-台南,2024-06-04,9896
8070,長華*,67,34,33,元大-台南,2024-06-04,9896
4716,大立,30,0,30,元大-台南,2024-06-04,9896
3231,緯創,33,4,29,元大-台南,2024-06-04,9896
2374,佳能,29,1,28,元大-台南,2024-06-04,9896
3013,晟銘電,59,34,25,元大-台南,2024-06-04,9896
2301,光寶科,38,13,25,元大-台南,2024-06-04,9896
3419,譁裕,48,23,25,元大-台南,2024-06-04,9896
2354,鴻準,60,35,25,元大-台南,2024-06-04,9896
3260,威剛,48,24,24,元大-台南,2024-06-04,9896
2337,旺宏,25,4,21,元大-台南,2024-06-04,9896
2612,中航,31,10,21,元大-台南,2024-06-04,9896
8215,明基材,20,0,20,元大-台南,2024-06-04,9896
2328,廣宇,30,10,20,元大-台南,2024-06-04,9896
1312,國喬,16,0,16,元大-台南,2024-06-04,9896
2363,矽統,38,22,16,元大-台南,2024-06-04,9896
2609,陽明,131,115,16,元大-台南,2024-06-04,9896
2603,長榮,19,3,16,元大-台南,2024-06-04,9896
6005,群益證,16,0,16,元大-台南,2024-06-04,9896
8234,新漢,38,23,15,元大-台南,2024-06-04,9896
8096,擎亞,29,14,15,元大-台南,2024-06-04,9896
1301,台塑,15,1,14,元大-台南,2024-06-04,9896
00632R,元大台灣50反1,320,8,312,元大-台南,2024-06-05,9896
00936,台新永續高息中小,325,51,274,元大-台南,2024-06-05,9896
00878,國泰永續高股息,138,2,136,元大-台南,2024-06-05,9896
00857B,永豐20年美公債,120,2,118,元大-台南,2024-06-05,9896
2618,長榮航,111,11,100,元大-台南,2024-06-05,9896
2610,華航,218,120,98,元大-台南,2024-06-05,9896
9950,萬國通,94,0,94,元大-台南,2024-06-05,9896
6125,廣運,107,24,83,元大-台南,2024-06-05,9896
00715L,期街口布蘭特正2,79,3,76,元大-台南,2024-06-05,9896
2888,新光金,99,24,75,元大-台南,2024-06-05,9896
00929,復華台灣科技優息,129,60,69,元大-台南,2024-06-05,9896
00937B,群益ESG投等債20,115,47,68,元大-台南,2024-06-05,9896
2354,鴻準,118,52,66,元大-台南,2024-06-05,9896
2867,三商壽,56,2,54,元大-台南,2024-06-05,9896
1785,光洋科,51,1,50,元大-台南,2024-06-05,9896
2812,台中銀,50,0,50,元大-台南,2024-06-05,9896
0056,元大高股息,44,0,44,元大-台南,2024-06-05,9896
1718,中纖,40,0,40,元大-台南,2024-06-05,9896
2344,華邦電,36,0,36,元大-台南,2024-06-05,9896
2331,精英,41,9,32,元大-台南,2024-06-05,9896
2457,飛宏,32,0,32,元大-台南,2024-06-05,9896
3081,聯亞,31,0,31,元大-台南,2024-06-05,9896
3419,譁裕,67,36,31,元大-台南,2024-06-05,9896
2353,宏��,69,38,31,元大-台南,2024-06-05,9896
4533,協易機,34,6,28,元大-台南,2024-06-05,9896
2303,聯電,44,17,27,元大-台南,2024-06-05,9896
5289,宜鼎,28,1,27,元大-台南,2024-06-05,9896
1314,中石化,30,3,27,元大-台南,2024-06-05,9896
2401,凌陽,43,17,26,元大-台南,2024-06-05,9896
00712,復華富時不動產,30,5,25,元大-台南,2024-06-05,9896
00642U,期元大S＆P石油,25,0,25,元大-台南,2024-06-05,9896
2105,正新,38,15,23,元大-台南,2024-06-05,9896
6282,康舒,23,0,23,元大-台南,2024-06-05,9896
2464,盟立,38,16,22,元大-台南,2024-06-05,9896
2323,中環,105,83,22,元大-台南,2024-06-05,9896
00679B,元大美債20年,103,82,21,元大-台南,2024-06-05,9896
8277,商丞,55,34,21,元大-台南,2024-06-05,9896
00753L,中信中國50正2,21,0,21,元大-台南,2024-06-05,9896
2603,長榮,104,83,21,元大-台南,2024-06-05,9896
6160,欣技,20,0,20,元大-台南,2024-06-05,9896
2002,中鋼,25,6,19,元大-台南,2024-06-05,9896
6757,台灣虎航,19,0,19,元大-台南,2024-06-05,9896
5371,中光電,21,3,18,元大-台南,2024-06-05,9896
2317,鴻海,68,51,17,元大-台南,2024-06-05,9896
2515,中工,22,4,18,元大-台南,2024-06-05,9896
8064,東捷,27,9,18,元大-台南,2024-06-05,9896
8028,昇陽半導體,17,0,17,元大-台南,2024-06-05,9896
2489,瑞軒,27,11,16,元大-台南,2024-06-05,9896
00946,群益科技高息成長,15,0,15,元大-台南,2024-06-05,9896
00637L,元大滬深300正2,15,0,15,元大-台南,2024-06-05,9896
00933B,國泰10Y+金融債,307,6,301,元大-台南,2024-06-06,9896
00936,台新永續高息中小,305,63,242,元大-台南,2024-06-06,9896
3711,日月光投控,237,1,236,元大-台南,2024-06-06,9896
00929,復華台灣科技優息,218,15,203,元大-台南,2024-06-06,9896
00768B,復華20年美債,140,0,140,元大-台南,2024-06-06,9896
2312,金寶,240,115,125,元大-台南,2024-06-06,9896
00918,大華優利高填息30,139,15,124,元大-台南,2024-06-06,9896
00937B,群益ESG投等債20,154,46,108,元大-台南,2024-06-06,9896
9105,泰金寶-DR,113,26,87,元大-台南,2024-06-06,9896
00878,國泰永續高股息,85,9,76,元大-台南,2024-06-06,9896
00680L,元大美債20正2,116,49,67,元大-台南,2024-06-06,9896
1815,富喬,84,24,60,元大-台南,2024-06-06,9896
00650L,復華香港正2,42,0,42,元大-台南,2024-06-06,9896
2367,燿華,67,31,36,元大-台南,2024-06-06,9896
3231,緯創,41,9,32,元大-台南,2024-06-06,9896
5519,隆大,39,9,30,元大-台南,2024-06-06,9896
8277,商丞,69,39,30,元大-台南,2024-06-06,9896
2409,友達,28,2,26,元大-台南,2024-06-06,9896
2331,精英,31,6,25,元大-台南,2024-06-06,9896
2611,志信,47,22,25,元大-台南,2024-06-06,9896
1718,中纖,23,0,23,元大-台南,2024-06-06,9896
5469,瀚宇博,22,0,22,元大-台南,2024-06-06,9896
5488,松普,22,1,21,元大-台南,2024-06-06,9896
6160,欣技,20,0,20,元大-台南,2024-06-06,9896
8044,網家,21,2,19,元大-台南,2024-06-06,9896
4566,時碩工業,30,11,19,元大-台南,2024-06-06,9896
00687B,國泰20年美債,46,27,19,元大-台南,2024-06-06,9896
3218,大學光,18,0,18,元大-台南,2024-06-06,9896
00882,中信中國高股息,24,7,17,元大-台南,2024-06-06,9896
2002,中鋼,23,8,15,元大-台南,2024-06-06,9896
5392,能率,18,3,15,元大-台南,2024-06-06,9896
2313,華通,20,5,15,元大-台南,2024-06-06,9896
8070,長華*,49,35,14,元大-台南,2024-06-06,9896
2382,廣達,24,11,13,元大-台南,2024-06-06,9896
2349,錸德,13,0,13,元大-台南,2024-06-06,9896
6757,台灣虎航,13,0,13,元大-台南,2024-06-06,9896
2495,普安,18,5,13,元大-台南,2024-06-06,9896
2402,毅嘉,15,2,13,元大-台南,2024-06-06,9896
3576,聯合再生,13,0,13,元大-台南,2024-06-06,9896
1609,大亞,14,1,13,元大-台南,2024-06-06,9896
5347,世界,62,49,13,元大-台南,2024-06-06,9896
2464,盟立,20,8,12,元大-台南,2024-06-06,9896
2867,三商壽,12,0,12,元大-台南,2024-06-06,9896
9934,成霖,13,1,12,元大-台南,2024-06-06,9896
2615,萬海,117,106,11,元大-台南,2024-06-06,9896
2605,新興,12,1,11,元大-台南,2024-06-06,9896
00931B,統一美債20年,11,0,11,元大-台南,2024-06-06,9896
6168,宏齊,12,1,11,元大-台南,2024-06-06,9896
6477,安集,11,0,11,元大-台南,2024-06-06,9896
1617,榮星,11,0,11,元大-台南,2024-06-06,9896
00680L,元大美債20正2,904,30,874,元大-台南,2024-06-07,9896
00929,復華台灣科技優息,278,65,213,元大-台南,2024-06-07,9896
00687B,國泰20年美債,195,42,153,元大-台南,2024-06-07,9896
00725B,國泰投資級公司債,133,3,130,元大-台南,2024-06-07,9896
00936,台新永續高息中小,260,133,127,元大-台南,2024-06-07,9896
8926,台汽電,101,16,85,元大-台南,2024-06-07,9896
00764B,群益25年美債,82,0,82,元大-台南,2024-06-07,9896
00919,群益台灣精選高息,101,27,74,元大-台南,2024-06-07,9896
00918,大華優利高填息30,70,0,70,元大-台南,2024-06-07,9896
00768B,復華20年美債,65,0,65,元大-台南,2024-06-07,9896
6120,達運,42,0,42,元大-台南,2024-06-07,9896
00673R,期元大S＆P原油反1,40,0,40,元大-台南,2024-06-07,9896
2353,宏��,40,4,36,元大-台南,2024-06-07,9896
00753L,中信中國50正2,32,0,32,元大-台南,2024-06-07,9896
3231,緯創,65,34,31,元大-台南,2024-06-07,9896
00632R,元大台灣50反1,30,0,30,元大-台南,2024-06-07,9896
8477,創業家,26,0,26,元大-台南,2024-06-07,9896
6164,華興,24,0,24,元大-台南,2024-06-07,9896
2313,華通,49,26,23,元大-台南,2024-06-07,9896
2367,燿華,45,22,23,元大-台南,2024-06-07,9896
2330,台積電,24,2,22,元大-台南,2024-06-07,9896
2002,中鋼,24,4,20,元大-台南,2024-06-07,9896
8064,東捷,37,17,20,元大-台南,2024-06-07,9896
1503,士電,39,21,18,元大-台南,2024-06-07,9896
2354,鴻準,27,10,17,元大-台南,2024-06-07,9896
3202,樺晟,18,1,17,元大-台南,2024-06-07,9896
2324,仁寶,16,1,15,元大-台南,2024-06-07,9896
2613,中櫃,33,18,15,元大-台南,2024-06-07,9896
8033,雷虎,14,0,14,元大-台南,2024-06-07,9896
2495,普安,15,3,12,元大-台南,2024-06-07,9896
9940,信義,12,0,12,元大-台南,2024-06-07,9896
8277,商丞,25,13,12,元大-台南,2024-06-07,9896
2382,廣達,27,15,12,元大-台南,2024-06-07,9896
3706,神達,18,7,11,元大-台南,2024-06-07,9896
6757,台灣虎航,11,0,11,元大-台南,2024-06-07,9896
1752,南光,11,0,11,元大-台南,2024-06-07,9896
00878,國泰永續高股息,30,19,11,元大-台南,2024-06-07,9896
1795,美時,13,2,11,元大-台南,2024-06-07,9896
2371,大同,27,17,10,元大-台南,2024-06-07,9896
3037,欣興,11,1,10,元大-台南,2024-06-07,9896
2101,南港,15,5,10,元大-台南,2024-06-07,9896
3312,弘憶股,11,1,10,元大-台南,2024-06-07,9896
2855,統一證,20,10,10,元大-台南,2024-06-07,9896
00650L,復華香港正2,18,8,10,元大-台南,2024-06-07,9896
3711,日月光投控,11,2,9,元大-台南,2024-06-07,9896
3707,漢磊,10,1,9,元大-台南,2024-06-07,9896
1326,台化,11,2,9,元大-台南,2024-06-07,9896
6197,佳必琪,18,9,9,元大-台南,2024-06-07,9896
2401,凌陽,10,1,9,元大-台南,2024-06-07,9896
3048,益登,13,5,8,元大-台南,2024-06-07,9896
00937B,群益ESG投等債20,355,29,326,元大-台南,2024-06-11,9896
00918,大華優利高填息30,177,0,177,元大-台南,2024-06-11,9896
00936,台新永續高息中小,166,0,166,元大-台南,2024-06-11,9896
00919,群益台灣精選高息,163,12,151,元大-台南,2024-06-11,9896
00679B,元大美債20年,144,20,124,元大-台南,2024-06-11,9896
1714,和桐,94,0,94,元大-台南,2024-06-11,9896
2615,萬海,184,105,79,元大-台南,2024-06-11,9896
00929,復華台灣科技優息,90,14,76,元大-台南,2024-06-11,9896
2002,中鋼,74,3,71,元大-台南,2024-06-11,9896
9105,泰金寶-DR,85,20,65,元大-台南,2024-06-11,9896
1608,華榮,69,7,62,元大-台南,2024-06-11,9896
00857B,永豐20年美公債,64,4,60,元大-台南,2024-06-11,9896
00680L,元大美債20正2,57,0,57,元大-台南,2024-06-11,9896
2374,佳能,283,231,52,元大-台南,2024-06-11,9896
3711,日月光投控,58,7,51,元大-台南,2024-06-11,9896
2892,第一金,50,0,50,元大-台南,2024-06-11,9896
2489,瑞軒,97,50,47,元大-台南,2024-06-11,9896
6164,華興,63,18,45,元大-台南,2024-06-11,9896
1815,富喬,55,10,45,元大-台南,2024-06-11,9896
3231,緯創,67,24,43,元大-台南,2024-06-11,9896
00637L,元大滬深300正2,50,7,43,元大-台南,2024-06-11,9896
00878,國泰永續高股息,46,4,42,元大-台南,2024-06-11,9896
00942B,台新美A公司債20+,40,0,40,元大-台南,2024-06-11,9896
00753L,中信中國50正2,40,1,39,元大-台南,2024-06-11,9896
00688L,國泰20年美債正2,238,200,38,元大-台南,2024-06-11,9896
2603,長榮,130,93,37,元大-台南,2024-06-11,9896
2609,陽明,485,449,36,元大-台南,2024-06-11,9896
1447,力鵬,38,2,36,元大-台南,2024-06-11,9896
2888,新光金,60,24,36,元大-台南,2024-06-11,9896
2515,中工,47,12,35,元大-台南,2024-06-11,9896
2520,冠德,34,2,32,元大-台南,2024-06-11,9896
00764B,群益25年美債,31,0,31,元大-台南,2024-06-11,9896
2014,中鴻,31,0,31,元大-台南,2024-06-11,9896
2495,普安,31,0,31,元大-台南,2024-06-11,9896
00712,復華富時不動產,33,3,30,元大-台南,2024-06-11,9896
3162,精確,30,0,30,元大-台南,2024-06-11,9896
2344,華邦電,31,1,30,元大-台南,2024-06-11,9896
2611,志信,32,2,30,元大-台南,2024-06-11,9896
1101,台泥,29,1,28,元大-台南,2024-06-11,9896
3047,訊舟,73,45,28,元大-台南,2024-06-11,9896
00907,永豐優息存股,29,1,28,元大-台南,2024-06-11,9896
2401,凌陽,28,3,25,元大-台南,2024-06-11,9896
2605,新興,53,28,25,元大-台南,2024-06-11,9896
1301,台塑,25,0,25,元大-台南,2024-06-11,9896
00939,統一台灣高息動能,31,8,23,元大-台南,2024-06-11,9896
00795B,中信美國公債20年,23,0,23,元大-台南,2024-06-11,9896
00933B,國泰10Y+金融債,22,0,22,元大-台南,2024-06-11,9896
5469,瀚宇博,22,0,22,元大-台南,2024-06-11,9896
5531,鄉林,22,0,22,元大-台南,2024-06-11,9896
2354,鴻準,31,9,22,元大-台南,2024-06-11,9896
2883,凱基金,527,106,421,元大-台南,2024-06-12,9896
00650L,復華香港正2,363,2,361,元大-台南,2024-06-12,9896
00664R,國泰臺灣加權反1,250,0,250,元大-台南,2024-06-12,9896
00687B,國泰20年美債,243,8,235,元大-台南,2024-06-12,9896
00937B,群益ESG投等債20,232,21,211,元大-台南,2024-06-12,9896
00632R,元大台灣50反1,129,0,129,元大-台南,2024-06-12,9896
00680L,元大美債20正2,126,0,126,元大-台南,2024-06-12,9896
00948B,中信優息投資級債,121,0,121,元大-台南,2024-06-12,9896
00712,復華富時不動產,115,4,111,元大-台南,2024-06-12,9896
8110,華東,103,0,103,元大-台南,2024-06-12,9896
00725B,國泰投資級公司債,102,0,102,元大-台南,2024-06-12,9896
00933B,國泰10Y+金融債,97,0,97,元大-台南,2024-06-12,9896
2609,陽明,393,307,86,元大-台南,2024-06-12,9896
2027,大成鋼,82,0,82,元大-台南,2024-06-12,9896
1714,和桐,81,2,79,元大-台南,2024-06-12,9896
00918,大華優利高填息30,75,0,75,元大-台南,2024-06-12,9896
1304,台聚,70,0,70,元大-台南,2024-06-12,9896
00857B,永豐20年美公債,68,0,68,元大-台南,2024-06-12,9896
2515,中工,59,4,55,元大-台南,2024-06-12,9896
00947,台新臺灣IC設計,93,40,53,元大-台南,2024-06-12,9896
2612,中航,47,0,47,元大-台南,2024-06-12,9896
00764B,群益25年美債,46,0,46,元大-台南,2024-06-12,9896
00679B,元大美債20年,55,9,46,元大-台南,2024-06-12,9896
1313,聯成,45,0,45,元大-台南,2024-06-12,9896
00919,群益台灣精選高息,61,16,45,元大-台南,2024-06-12,9896
2409,友達,45,3,42,元大-台南,2024-06-12,9896
8044,網家,45,4,41,元大-台南,2024-06-12,9896
2365,昆盈,52,14,38,元大-台南,2024-06-12,9896
3481,群創,46,8,38,元大-台南,2024-06-12,9896
00882,中信中國高股息,53,17,36,元大-台南,2024-06-12,9896
2888,新光金,55,20,35,元大-台南,2024-06-12,9896
9105,泰金寶-DR,112,77,35,元大-台南,2024-06-12,9896
2615,萬海,67,38,29,元大-台南,2024-06-12,9896
0056,元大高股息,34,7,27,元大-台南,2024-06-12,9896
2353,宏��,31,5,26,元大-台南,2024-06-12,9896
1609,大亞,37,12,25,元大-台南,2024-06-12,9896
00673R,期元大S＆P原油反1,25,0,25,元大-台南,2024-06-12,9896
2881,富邦金,23,0,23,元大-台南,2024-06-12,9896
2352,佳世達,22,0,22,元大-台南,2024-06-12,9896
2356,英業達,31,9,22,元大-台南,2024-06-12,9896
6226,光鼎,49,27,22,元大-台南,2024-06-12,9896
00878,國泰永續高股息,32,11,21,元大-台南,2024-06-12,9896
2344,華邦電,20,0,20,元大-台南,2024-06-12,9896
3321,同泰,20,0,20,元大-台南,2024-06-12,9896
3231,緯創,73,53,20,元大-台南,2024-06-12,9896
2486,一詮,40,20,20,元大-台南,2024-06-12,9896
2603,長榮,64,45,19,元大-台南,2024-06-12,9896
1101,台泥,21,2,19,元大-台南,2024-06-12,9896
4906,正文,27,8,19,元大-台南,2024-06-12,9896
2002,中鋼,19,2,17,元大-台南,2024-06-12,9896
00632R,元大台灣50反1,701,341,360,元大-台南,2024-06-13,9896
00679B,元大美債20年,217,78,139,元大-台南,2024-06-13,9896
00937B,群益ESG投等債20,170,38,132,元大-台南,2024-06-13,9896
00948B,中信優息投資級債,123,5,118,元大-台南,2024-06-13,9896
00947,台新臺灣IC設計,116,0,116,元大-台南,2024-06-13,9896
2867,三商壽,109,10,99,元大-台南,2024-06-13,9896
00687B,國泰20年美債,87,6,81,元大-台南,2024-06-13,9896
2888,新光金,49,4,45,元大-台南,2024-06-13,9896
6164,華興,68,24,44,元大-台南,2024-06-13,9896
00857B,永豐20年美公債,42,0,42,元大-台南,2024-06-13,9896
00725B,國泰投資級公司債,38,0,38,元大-台南,2024-06-13,9896
2618,長榮航,47,10,37,元大-台南,2024-06-13,9896
00637L,元大滬深300正2,40,4,36,元大-台南,2024-06-13,9896
6757,台灣虎航,35,0,35,元大-台南,2024-06-13,9896
6290,良維,37,5,32,元大-台南,2024-06-13,9896
1301,台塑,28,0,28,元大-台南,2024-06-13,9896
2606,裕民,30,2,28,元大-台南,2024-06-13,9896
1609,大亞,48,21,27,元大-台南,2024-06-13,9896
2359,所羅門,94,67,27,元大-台南,2024-06-13,9896
5289,宜鼎,22,0,22,元大-台南,2024-06-13,9896
6548,長科*,22,1,21,元大-台南,2024-06-13,9896
00830,國泰費城半導體,21,1,20,元大-台南,2024-06-13,9896
5328,華容,20,0,20,元大-台南,2024-06-13,9896
2820,華票,18,0,18,元大-台南,2024-06-13,9896
3202,樺晟,19,2,17,元大-台南,2024-06-13,9896
1815,富喬,30,13,17,元大-台南,2024-06-13,9896
6952,大武山,16,0,16,元大-台南,2024-06-13,9896
8455,大拓-KY,16,0,16,元大-台南,2024-06-13,9896
2603,長榮,27,11,16,元大-台南,2024-06-13,9896
4906,正文,22,7,15,元大-台南,2024-06-13,9896
00764B,群益25年美債,15,0,15,元大-台南,2024-06-13,9896
2020,美亞,22,8,14,元大-台南,2024-06-13,9896
2367,燿華,53,39,14,元大-台南,2024-06-13,9896
3056,富華新,15,1,14,元大-台南,2024-06-13,9896
6187,萬潤,18,4,14,元大-台南,2024-06-13,9896
2353,宏��,40,26,14,元大-台南,2024-06-13,9896
1447,力鵬,13,0,13,元大-台南,2024-06-13,9896
2498,宏達電,16,3,13,元大-台南,2024-06-13,9896
5443,均豪,14,1,13,元大-台南,2024-06-13,9896
2352,佳世達,13,0,13,元大-台南,2024-06-13,9896
2401,凌陽,18,6,12,元大-台南,2024-06-13,9896
00713,元大台灣高息低波,13,1,12,元大-台南,2024-06-13,9896
6213,聯茂,20,9,11,元大-台南,2024-06-13,9896
1524,耿鼎,14,3,11,元大-台南,2024-06-13,9896
5371,中光電,18,7,11,元大-台南,2024-06-13,9896
3419,譁裕,16,5,11,元大-台南,2024-06-13,9896
4111,濟生,12,1,11,元大-台南,2024-06-13,9896
6264,富裔,59,48,11,元大-台南,2024-06-13,9896
3176,基亞,11,0,11,元大-台南,2024-06-13,9896
6505,台塑化,11,0,11,元大-台南,2024-06-13,9896
00687B,國泰20年美債,221,27,194,元大-台南,2024-06-14,9896
2515,中工,161,20,141,元大-台南,2024-06-14,9896
2371,大同,207,98,109,元大-台南,2024-06-14,9896
00720B,元大投資級公司債,80,1,79,元大-台南,2024-06-14,9896
00946,群益科技高息成長,80,14,66,元大-台南,2024-06-14,9896
00937B,群益ESG投等債20,146,82,64,元大-台南,2024-06-14,9896
00929,復華台灣科技優息,102,38,64,元大-台南,2024-06-14,9896
1815,富喬,60,13,47,元大-台南,2024-06-14,9896
00948B,中信優息投資級債,55,20,35,元大-台南,2024-06-14,9896
2618,長榮航,43,14,29,元大-台南,2024-06-14,9896
6952,大武山,27,3,24,元大-台南,2024-06-14,9896
00830,國泰費城半導體,22,0,22,元大-台南,2024-06-14,9896
2353,宏��,26,5,21,元大-台南,2024-06-14,9896
5519,隆大,21,0,21,元大-台南,2024-06-14,9896
6164,華興,90,69,21,元大-台南,2024-06-14,9896
6548,長科*,21,0,21,元大-台南,2024-06-14,9896
4114,健喬,20,0,20,元大-台南,2024-06-14,9896
006206,元大上證50,20,0,20,元大-台南,2024-06-14,9896
00768B,復華20年美債,20,0,20,元大-台南,2024-06-14,9896
00919,群益台灣精選高息,94,74,20,元大-台南,2024-06-14,9896
2867,三商壽,20,1,19,元大-台南,2024-06-14,9896
2002,中鋼,28,10,18,元大-台南,2024-06-14,9896
6757,台灣虎航,21,3,18,元大-台南,2024-06-14,9896
9919,康那香,20,2,18,元大-台南,2024-06-14,9896
00878,國泰永續高股息,45,27,18,元大-台南,2024-06-14,9896
2603,長榮,37,20,17,元大-台南,2024-06-14,9896
8064,東捷,19,2,17,元大-台南,2024-06-14,9896
1440,南紡,16,0,16,元大-台南,2024-06-14,9896
1319,東陽,20,4,16,元大-台南,2024-06-14,9896
2885,元大金,22,7,15,元大-台南,2024-06-14,9896
1785,光洋科,45,30,15,元大-台南,2024-06-14,9896
3374,精材,33,19,14,元大-台南,2024-06-14,9896
6005,群益證,16,2,14,元大-台南,2024-06-14,9896
2442,新美齊,14,0,14,元大-台南,2024-06-14,9896
5443,均豪,15,1,14,元大-台南,2024-06-14,9896
2888,新光金,49,35,14,元大-台南,2024-06-14,9896
1503,士電,26,13,13,元大-台南,2024-06-14,9896
00713,元大台灣高息低波,16,3,13,元大-台南,2024-06-14,9896
00857B,永豐20年美公債,18,5,13,元大-台南,2024-06-14,9896
1617,榮星,13,0,13,元大-台南,2024-06-14,9896
6207,雷科,13,0,13,元大-台南,2024-06-14,9896
2101,南港,14,2,12,元大-台南,2024-06-14,9896
2208,台船,12,0,12,元大-台南,2024-06-14,9896
9912,偉聯,12,0,12,元大-台南,2024-06-14,9896
00764B,群益25年美債,12,0,12,元大-台南,2024-06-14,9896
2367,燿華,26,14,12,元大-台南,2024-06-14,9896
3661,世芯-KY,11,0,11,元大-台南,2024-06-14,9896
2498,宏達電,11,0,11,元大-台南,2024-06-14,9896
8234,新漢,11,0,11,元大-台南,2024-06-14,9896
2374,佳能,13,2,11,元大-台南,2024-06-14,9896
00687B,國泰20年美債,237,20,217,元大-台南,2024-06-17,9896
00918,大華優利高填息30,248,44,204,元大-台南,2024-06-17,9896
00882,中信中國高股息,203,7,196,元大-台南,2024-06-17,9896
2834,臺企銀,209,13,196,元大-台南,2024-06-17,9896
2883,凱基金,139,2,137,元大-台南,2024-06-17,9896
3037,欣興,132,8,124,元大-台南,2024-06-17,9896
00933B,國泰10Y+金融債,101,5,96,元大-台南,2024-06-17,9896
1514,亞力,187,91,96,元大-台南,2024-06-17,9896
00937B,群益ESG投等債20,108,45,63,元大-台南,2024-06-17,9896
5880,合庫金,53,0,53,元大-台南,2024-06-17,9896
2609,陽明,156,106,50,元大-台南,2024-06-17,9896
4306,炎洲,50,1,49,元大-台南,2024-06-17,9896
00929,復華台灣科技優息,84,38,46,元大-台南,2024-06-17,9896
2516,新建,52,10,42,元大-台南,2024-06-17,9896
2025,千興,49,11,38,元大-台南,2024-06-17,9896
2344,華邦電,54,18,36,元大-台南,2024-06-17,9896
3346,麗清,30,0,30,元大-台南,2024-06-17,9896
2515,中工,27,0,27,元大-台南,2024-06-17,9896
2312,金寶,32,5,27,元大-台南,2024-06-17,9896
1618,合機,67,44,23,元大-台南,2024-06-17,9896
5905,南仁湖,32,10,22,元大-台南,2024-06-17,9896
00650L,復華香港正2,22,0,22,元大-台南,2024-06-17,9896
00665L,富邦�琤肭磪囓�2,20,0,20,元大-台南,2024-06-17,9896
1605,華新,19,0,19,元大-台南,2024-06-17,9896
2542,興富發,39,20,19,元大-台南,2024-06-17,9896
00713,元大台灣高息低波,20,2,18,元大-台南,2024-06-17,9896
2390,云辰,18,0,18,元大-台南,2024-06-17,9896
3056,富華新,18,1,17,元大-台南,2024-06-17,9896
3231,緯創,24,7,17,元大-台南,2024-06-17,9896
8039,台虹,20,3,17,元大-台南,2024-06-17,9896
6164,華興,167,150,17,元大-台南,2024-06-17,9896
2330,台積電,18,1,17,元大-台南,2024-06-17,9896
2356,英業達,19,2,17,元大-台南,2024-06-17,9896
00885,富邦越南,15,0,15,元大-台南,2024-06-17,9896
2615,萬海,107,92,15,元大-台南,2024-06-17,9896
1503,士電,66,51,15,元大-台南,2024-06-17,9896
00632R,元大台灣50反1,19,5,14,元大-台南,2024-06-17,9896
6186,新潤,14,0,14,元大-台南,2024-06-17,9896
00947,台新臺灣IC設計,15,1,14,元大-台南,2024-06-17,9896
2888,新光金,19,5,14,元大-台南,2024-06-17,9896
00946,群益科技高息成長,13,0,13,元大-台南,2024-06-17,9896
1316,上曜,13,0,13,元大-台南,2024-06-17,9896
2354,鴻準,29,16,13,元大-台南,2024-06-17,9896
6197,佳必琪,25,12,13,元大-台南,2024-06-17,9896
3450,聯鈞,16,4,12,元大-台南,2024-06-17,9896
6806,森崴能源,13,1,12,元大-台南,2024-06-17,9896
2401,凌陽,17,5,12,元大-台南,2024-06-17,9896
00631L,元大台灣50正2,11,0,11,元大-台南,2024-06-17,9896
3033,威健,11,0,11,元大-台南,2024-06-17,9896
00942B,台新美A公司債20+,11,0,11,元大-台南,2024-06-17,9896
00929,復華台灣科技優息,272,54,218,元大-台南,2024-06-18,9896
00937B,群益ESG投等債20,242,43,199,元大-台南,2024-06-18,9896
9105,泰金寶-DR,173,24,149,元大-台南,2024-06-18,9896
00632R,元大台灣50反1,148,9,139,元大-台南,2024-06-18,9896
2618,長榮航,215,108,107,元大-台南,2024-06-18,9896
00946,群益科技高息成長,106,7,99,元大-台南,2024-06-18,9896
2515,中工,113,14,99,元大-台南,2024-06-18,9896
00673R,期元大S＆P原油反1,85,0,85,元大-台南,2024-06-18,9896
00936,台新永續高息中小,135,58,77,元大-台南,2024-06-18,9896
00687B,國泰20年美債,78,6,72,元大-台南,2024-06-18,9896
00919,群益台灣精選高息,110,44,66,元大-台南,2024-06-18,9896
2603,長榮,61,5,56,元大-台南,2024-06-18,9896
6026,福邦證,56,10,46,元大-台南,2024-06-18,9896
2353,宏��,53,7,46,元大-台南,2024-06-18,9896
00918,大華優利高填息30,56,12,44,元大-台南,2024-06-18,9896
00933B,國泰10Y+金融債,49,5,44,元大-台南,2024-06-18,9896
2401,凌陽,49,6,43,元大-台南,2024-06-18,9896
00948B,中信優息投資級債,62,20,42,元大-台南,2024-06-18,9896
6951,青新-創,40,0,40,元大-台南,2024-06-18,9896
2344,華邦電,96,56,40,元大-台南,2024-06-18,9896
00942B,台新美A公司債20+,38,0,38,元大-台南,2024-06-18,9896
2206,三陽工業,51,14,37,元大-台南,2024-06-18,9896
2317,鴻海,70,36,34,元大-台南,2024-06-18,9896
2352,佳世達,34,2,32,元大-台南,2024-06-18,9896
9103,美德醫療-DR,30,0,30,元大-台南,2024-06-18,9896
00713,元大台灣高息低波,33,4,29,元大-台南,2024-06-18,9896
2457,飛宏,31,2,29,元大-台南,2024-06-18,9896
2609,陽明,184,158,26,元大-台南,2024-06-18,9896
5371,中光電,27,3,24,元大-台南,2024-06-18,9896
00921,兆豐龍頭等權重,24,0,24,元大-台南,2024-06-18,9896
2390,云辰,63,39,24,元大-台南,2024-06-18,9896
00947,台新臺灣IC設計,43,21,22,元大-台南,2024-06-18,9896
4533,協易機,34,12,22,元大-台南,2024-06-18,9896
9919,康那香,23,1,22,元大-台南,2024-06-18,9896
1504,東元,25,4,21,元大-台南,2024-06-18,9896
4909,新復興,44,23,21,元大-台南,2024-06-18,9896
2615,萬海,54,33,21,元大-台南,2024-06-18,9896
5222,全訊,20,0,20,元大-台南,2024-06-18,9896
1442,名軒,20,0,20,元大-台南,2024-06-18,9896
6213,聯茂,22,3,19,元大-台南,2024-06-18,9896
00941,中信上游半導體,19,0,19,元大-台南,2024-06-18,9896
2061,風青,23,4,19,元大-台南,2024-06-18,9896
2486,一詮,25,6,19,元大-台南,2024-06-18,9896
3622,洋華,37,19,18,元大-台南,2024-06-18,9896
3481,群創,44,27,17,元大-台南,2024-06-18,9896
4906,正文,17,0,17,元大-台南,2024-06-18,9896
2371,大同,54,38,16,元大-台南,2024-06-18,9896
00720B,元大投資級公司債,28,12,16,元大-台南,2024-06-18,9896
4562,穎漢,57,41,16,元大-台南,2024-06-18,9896
6016,康和證,15,0,15,元大-台南,2024-06-18,9896
00664R,國泰臺灣加權反1,405,0,405,元大-台南,2024-06-19,9896
00946,群益科技高息成長,175,6,169,元大-台南,2024-06-19,9896
00936,台新永續高息中小,219,59,160,元大-台南,2024-06-19,9896
00687B,國泰20年美債,130,10,120,元大-台南,2024-06-19,9896
6605,帝寶,111,2,109,元大-台南,2024-06-19,9896
9105,泰金寶-DR,90,9,81,元大-台南,2024-06-19,9896
00948B,中信優息投資級債,72,2,70,元大-台南,2024-06-19,9896
00712,復華富時不動產,88,23,65,元大-台南,2024-06-19,9896
00907,永豐優息存股,63,2,61,元大-台南,2024-06-19,9896
00909,國泰數位支付服務,50,0,50,元大-台南,2024-06-19,9896
00937B,群益ESG投等債20,90,42,48,元大-台南,2024-06-19,9896
2365,昆盈,126,79,47,元大-台南,2024-06-19,9896
00830,國泰費城半導體,44,0,44,元大-台南,2024-06-19,9896
00673R,期元大S＆P原油反1,42,0,42,元大-台南,2024-06-19,9896
2618,長榮航,166,127,39,元大-台南,2024-06-19,9896
6290,良維,62,24,38,元大-台南,2024-06-19,9896
00918,大華優利高填息30,140,102,38,元大-台南,2024-06-19,9896
3048,益登,75,39,36,元大-台南,2024-06-19,9896
00882,中信中國高股息,50,14,36,元大-台南,2024-06-19,9896
2390,云辰,166,131,35,元大-台南,2024-06-19,9896
00929,復華台灣科技優息,198,165,33,元大-台南,2024-06-19,9896
4533,協易機,33,0,33,元大-台南,2024-06-19,9896
3231,緯創,154,122,32,元大-台南,2024-06-19,9896
1815,富喬,54,27,27,元大-台南,2024-06-19,9896
00679B,元大美債20年,51,25,26,元大-台南,2024-06-19,9896
2354,鴻準,52,26,26,元大-台南,2024-06-19,9896
2520,冠德,25,0,25,元大-台南,2024-06-19,9896
00941,中信上游半導體,29,5,24,元大-台南,2024-06-19,9896
6770,力積電,36,12,24,元大-台南,2024-06-19,9896
2486,一詮,32,8,24,元大-台南,2024-06-19,9896
8040,九暘,23,0,23,元大-台南,2024-06-19,9896
6834,天二科技,21,0,21,元大-台南,2024-06-19,9896
00713,元大台灣高息低波,22,1,21,元大-台南,2024-06-19,9896
2027,大成鋼,20,0,20,元大-台南,2024-06-19,9896
2258,鴻華先進-創,20,0,20,元大-台南,2024-06-19,9896
1909,榮成,20,0,20,元大-台南,2024-06-19,9896
3266,昇陽,20,0,20,元大-台南,2024-06-19,9896
2834,臺企銀,39,20,19,元大-台南,2024-06-19,9896
8096,擎亞,64,45,19,元大-台南,2024-06-19,9896
4562,穎漢,25,7,18,元大-台南,2024-06-19,9896
4919,新唐,21,3,18,元大-台南,2024-06-19,9896
2303,聯電,66,48,18,元大-台南,2024-06-19,9896
6282,康舒,19,3,16,元大-台南,2024-06-19,9896
00665L,富邦�琤肭磪囓�2,17,1,16,元大-台南,2024-06-19,9896
2399,映泰,20,4,16,元大-台南,2024-06-19,9896
2610,華航,74,58,16,元大-台南,2024-06-19,9896
1503,士電,35,20,15,元大-台南,2024-06-19,9896
4123,晟德,15,1,14,元大-台南,2024-06-19,9896
4534,慶騰,14,0,14,元大-台南,2024-06-19,9896
4306,炎洲,17,3,14,元大-台南,2024-06-19,9896
00918,大華優利高填息30,612,16,596,元大-台南,2024-06-20,9896
00929,復華台灣科技優息,362,88,274,元大-台南,2024-06-20,9896
6806,森崴能源,215,2,213,元大-台南,2024-06-20,9896
00687B,國泰20年美債,157,1,156,元大-台南,2024-06-20,9896
00919,群益台灣精選高息,173,47,126,元大-台南,2024-06-20,9896
3481,群創,128,22,106,元大-台南,2024-06-20,9896
00936,台新永續高息中小,111,12,99,元大-台南,2024-06-20,9896
00933B,國泰10Y+金融債,97,1,96,元大-台南,2024-06-20,9896
00937B,群益ESG投等債20,104,42,62,元大-台南,2024-06-20,9896
2883,凱基金,61,4,57,元大-台南,2024-06-20,9896
1303,南亞,55,7,48,元大-台南,2024-06-20,9896
00632R,元大台灣50反1,122,75,47,元大-台南,2024-06-20,9896
00946,群益科技高息成長,46,0,46,元大-台南,2024-06-20,9896
2353,宏��,63,18,45,元大-台南,2024-06-20,9896
0056,元大高股息,55,13,42,元大-台南,2024-06-20,9896
2412,中華電,41,0,41,元大-台南,2024-06-20,9896
4526,東台,92,51,41,元大-台南,2024-06-20,9896
5905,南仁湖,38,1,37,元大-台南,2024-06-20,9896
00680L,元大美債20正2,41,5,36,元大-台南,2024-06-20,9896
2409,友達,35,0,35,元大-台南,2024-06-20,9896
1319,東陽,35,2,33,元大-台南,2024-06-20,9896
00679B,元大美債20年,50,17,33,元大-台南,2024-06-20,9896
1802,台玻,35,3,32,元大-台南,2024-06-20,9896
5222,全訊,30,0,30,元大-台南,2024-06-20,9896
00650L,復華香港正2,35,10,25,元大-台南,2024-06-20,9896
1301,台塑,25,0,25,元大-台南,2024-06-20,9896
2330,台積電,30,8,22,元大-台南,2024-06-20,9896
1605,華新,20,0,20,元大-台南,2024-06-20,9896
8096,擎亞,38,18,20,元大-台南,2024-06-20,9896
9105,泰金寶-DR,28,9,19,元大-台南,2024-06-20,9896
2515,中工,26,7,19,元大-台南,2024-06-20,9896
2884,玉山金,21,2,19,元大-台南,2024-06-20,9896
2603,長榮,28,9,19,元大-台南,2024-06-20,9896
2206,三陽工業,19,1,18,元大-台南,2024-06-20,9896
8040,九暘,17,0,17,元大-台南,2024-06-20,9896
3443,創意,16,0,16,元大-台南,2024-06-20,9896
1714,和桐,17,1,16,元大-台南,2024-06-20,9896
2401,凌陽,28,12,16,元大-台南,2024-06-20,9896
5880,合庫金,16,0,16,元大-台南,2024-06-20,9896
9904,寶成,15,0,15,元大-台南,2024-06-20,9896
6117,迎廣,18,4,14,元大-台南,2024-06-20,9896
3059,華晶科,14,0,14,元大-台南,2024-06-20,9896
2371,大同,57,44,13,元大-台南,2024-06-20,9896
6264,富裔,85,72,13,元大-台南,2024-06-20,9896
00637L,元大滬深300正2,13,0,13,元大-台南,2024-06-20,9896
2892,第一金,13,0,13,元大-台南,2024-06-20,9896
1326,台化,15,2,13,元大-台南,2024-06-20,9896
00891,中信關鍵半導體,14,2,12,元大-台南,2024-06-20,9896
5468,凱鈺,12,0,12,元大-台南,2024-06-20,9896
00926,凱基全球菁英55,12,0,12,元大-台南,2024-06-20,9896
00650L,復華香港正2,222,0,222,元大-台南,2024-06-21,9896
00929,復華台灣科技優息,154,22,132,元大-台南,2024-06-21,9896
00937B,群益ESG投等債20,142,22,120,元大-台南,2024-06-21,9896
00882,中信中國高股息,169,52,117,元大-台南,2024-06-21,9896
2317,鴻海,118,29,89,元大-台南,2024-06-21,9896
00687B,國泰20年美債,83,0,83,元大-台南,2024-06-21,9896
00936,台新永續高息中小,79,1,78,元大-台南,2024-06-21,9896
00637L,元大滬深300正2,83,10,73,元大-台南,2024-06-21,9896
1305,華夏,85,13,72,元大-台南,2024-06-21,9896
2511,太子,70,0,70,元大-台南,2024-06-21,9896
2609,陽明,218,150,68,元大-台南,2024-06-21,9896
2412,中華電,55,0,55,元大-台南,2024-06-21,9896
2801,彰銀,57,4,53,元大-台南,2024-06-21,9896
1301,台塑,56,4,52,元大-台南,2024-06-21,9896
00673R,期元大S＆P原油反1,34,0,34,元大-台南,2024-06-21,9896
2548,華固,36,3,33,元大-台南,2024-06-21,9896
00933B,國泰10Y+金融債,31,2,29,元大-台南,2024-06-21,9896
2330,台積電,35,8,27,元大-台南,2024-06-21,9896
00878,國泰永續高股息,51,27,24,元大-台南,2024-06-21,9896
5347,世界,24,2,22,元大-台南,2024-06-21,9896
6217,中探針,28,8,20,元大-台南,2024-06-21,9896
00885,富邦越南,19,0,19,元大-台南,2024-06-21,9896
2516,新建,19,0,19,元大-台南,2024-06-21,9896
3163,波若威,29,11,18,元大-台南,2024-06-21,9896
6290,良維,30,13,17,元大-台南,2024-06-21,9896
00850,元大臺灣ESG永續,17,1,16,元大-台南,2024-06-21,9896
6695,芯鼎,27,11,16,元大-台南,2024-06-21,9896
2883,凱基金,196,181,15,元大-台南,2024-06-21,9896
2603,長榮,26,12,14,元大-台南,2024-06-21,9896
4123,晟德,19,5,14,元大-台南,2024-06-21,9896
1440,南紡,20,6,14,元大-台南,2024-06-21,9896
3305,昇貿,33,19,14,元大-台南,2024-06-21,9896
1326,台化,14,0,14,元大-台南,2024-06-21,9896
2382,廣達,25,11,14,元大-台南,2024-06-21,9896
6770,力積電,16,3,13,元大-台南,2024-06-21,9896
6598,ABC-KY,14,1,13,元大-台南,2024-06-21,9896
00680L,元大美債20正2,17,4,13,元大-台南,2024-06-21,9896
2353,宏��,17,4,13,元大-台南,2024-06-21,9896
3715,定穎投控,15,3,12,元大-台南,2024-06-21,9896
2009,第一銅,14,2,12,元大-台南,2024-06-21,9896
2368,金像電,14,3,11,元大-台南,2024-06-21,9896
8096,擎亞,22,11,11,元大-台南,2024-06-21,9896
8249,菱光,12,1,11,元大-台南,2024-06-21,9896
1721,三晃,13,2,11,元大-台南,2024-06-21,9896
2301,光寶科,13,2,11,元大-台南,2024-06-21,9896
6239,力成,11,0,11,元大-台南,2024-06-21,9896
00923,群益台ESG低碳50,10,0,10,元大-台南,2024-06-21,9896
2363,矽統,13,3,10,元大-台南,2024-06-21,9896
2031,新光鋼,10,0,10,元大-台南,2024-06-21,9896
6209,今國光,10,0,10,元大-台南,2024-06-21,9896
00679B,元大美債20年,269,47,222,元大-台南,2024-06-24,9896
00919,群益台灣精選高息,326,144,182,元大-台南,2024-06-24,9896
00687B,國泰20年美債,177,0,177,元大-台南,2024-06-24,9896
00942B,台新美A公司債20+,140,0,140,元大-台南,2024-06-24,9896
00650L,復華香港正2,135,4,131,元大-台南,2024-06-24,9896
2317,鴻海,130,35,95,元大-台南,2024-06-24,9896
2485,兆赫,84,7,77,元大-台南,2024-06-24,9896
00891,中信關鍵半導體,74,0,74,元大-台南,2024-06-24,9896
00936,台新永續高息中小,94,21,73,元大-台南,2024-06-24,9896
2409,友達,118,48,70,元大-台南,2024-06-24,9896
00918,大華優利高填息30,67,3,64,元大-台南,2024-06-24,9896
6152,百一,64,3,61,元大-台南,2024-06-24,9896
00882,中信中國高股息,60,0,60,元大-台南,2024-06-24,9896
1617,榮星,70,10,60,元大-台南,2024-06-24,9896
2888,新光金,75,19,56,元大-台南,2024-06-24,9896
2330,台積電,74,18,56,元大-台南,2024-06-24,9896
3062,建漢,105,56,49,元大-台南,2024-06-24,9896
3231,緯創,61,17,44,元大-台南,2024-06-24,9896
00878,國泰永續高股息,56,16,40,元大-台南,2024-06-24,9896
8112,至上,40,4,36,元大-台南,2024-06-24,9896
1409,新纖,40,5,35,元大-台南,2024-06-24,9896
8477,創業家,33,0,33,元大-台南,2024-06-24,9896
1449,佳和,31,0,31,元大-台南,2024-06-24,9896
6290,良維,33,2,31,元大-台南,2024-06-24,9896
6282,康舒,31,1,30,元大-台南,2024-06-24,9896
00673R,期元大S＆P原油反1,30,0,30,元大-台南,2024-06-24,9896
00764B,群益25年美債,32,2,30,元大-台南,2024-06-24,9896
2344,華邦電,30,1,29,元大-台南,2024-06-24,9896
00939,統一台灣高息動能,49,21,28,元大-台南,2024-06-24,9896
1785,光洋科,100,74,26,元大-台南,2024-06-24,9896
2615,萬海,114,88,26,元大-台南,2024-06-24,9896
9105,泰金寶-DR,41,16,25,元大-台南,2024-06-24,9896
4526,東台,39,14,25,元大-台南,2024-06-24,9896
1319,東陽,25,1,24,元大-台南,2024-06-24,9896
00881,國泰台灣5G+,21,0,21,元大-台南,2024-06-24,9896
5230,雷笛克光學,21,0,21,元大-台南,2024-06-24,9896
00706L,期元大S＆P日圓正2,21,0,21,元大-台南,2024-06-24,9896
2324,仁寶,28,7,21,元大-台南,2024-06-24,9896
00671R,富邦NASDAQ反1,20,0,20,元大-台南,2024-06-24,9896
3372,典範,22,4,18,元大-台南,2024-06-24,9896
2002,中鋼,22,4,18,元大-台南,2024-06-24,9896
3036,文曄,27,9,18,元大-台南,2024-06-24,9896
2369,菱生,20,3,17,元大-台南,2024-06-24,9896
2382,廣達,27,10,17,元大-台南,2024-06-24,9896
2354,鴻準,18,2,16,元大-台南,2024-06-24,9896
2352,佳世達,18,2,16,元大-台南,2024-06-24,9896
1605,華新,19,3,16,元大-台南,2024-06-24,9896
2609,陽明,49,34,15,元大-台南,2024-06-24,9896
6180,橘子,16,1,15,元大-台南,2024-06-24,9896
2610,華航,45,30,15,元大-台南,2024-06-24,9896
00929,復華台灣科技優息,1020,200,820,元大-台南,2024-06-25,9896
3481,群創,579,171,408,元大-台南,2024-06-25,9896
00919,群益台灣精選高息,324,113,211,元大-台南,2024-06-25,9896
00687B,國泰20年美債,213,15,198,元大-台南,2024-06-25,9896
2408,南亞科,201,22,179,元大-台南,2024-06-25,9896
1617,榮星,145,2,143,元大-台南,2024-06-25,9896
00857B,永豐20年美公債,102,0,102,元大-台南,2024-06-25,9896
00679B,元大美債20年,105,11,94,元大-台南,2024-06-25,9896
6182,合晶,81,0,81,元大-台南,2024-06-25,9896
00937B,群益ESG投等債20,91,12,79,元大-台南,2024-06-25,9896
00936,台新永續高息中小,73,0,73,元大-台南,2024-06-25,9896
2002,中鋼,73,2,71,元大-台南,2024-06-25,9896
4968,立積,70,0,70,元大-台南,2024-06-25,9896
00680L,元大美債20正2,97,44,53,元大-台南,2024-06-25,9896
00947,台新臺灣IC設計,89,42,47,元大-台南,2024-06-25,9896
00923,群益台ESG低碳50,40,0,40,元大-台南,2024-06-25,9896
00673R,期元大S＆P原油反1,37,0,37,元大-台南,2024-06-25,9896
2883,凱基金,41,5,36,元大-台南,2024-06-25,9896
9105,泰金寶-DR,43,7,36,元大-台南,2024-06-25,9896
00878,國泰永續高股息,42,6,36,元大-台南,2024-06-25,9896
6414,樺漢,37,2,35,元大-台南,2024-06-25,9896
3231,緯創,48,14,34,元大-台南,2024-06-25,9896
3663,鑫科,51,20,31,元大-台南,2024-06-25,9896
3062,建漢,44,14,30,元大-台南,2024-06-25,9896
00931B,統一美債20年,30,2,28,元大-台南,2024-06-25,9896
00946,群益科技高息成長,38,11,27,元大-台南,2024-06-25,9896
1605,華新,29,3,26,元大-台南,2024-06-25,9896
00896,中信綠能及電動車,25,0,25,元大-台南,2024-06-25,9896
00918,大華優利高填息30,29,6,23,元大-台南,2024-06-25,9896
6152,百一,57,34,23,元大-台南,2024-06-25,9896
2801,彰銀,21,0,21,元大-台南,2024-06-25,9896
3285,微端,20,0,20,元大-台南,2024-06-25,9896
00891,中信關鍵半導體,21,1,20,元大-台南,2024-06-25,9896
2352,佳世達,74,55,19,元大-台南,2024-06-25,9896
1219,福壽,19,0,19,元大-台南,2024-06-25,9896
5452,佶優,27,9,18,元大-台南,2024-06-25,9896
8110,華東,21,3,18,元大-台南,2024-06-25,9896
00915,凱基優選高股息30,17,0,17,元大-台南,2024-06-25,9896
1301,台塑,16,0,16,元大-台南,2024-06-25,9896
2317,鴻海,51,35,16,元大-台南,2024-06-25,9896
2371,大同,29,14,15,元大-台南,2024-06-25,9896
3580,友威科,20,6,14,元大-台南,2024-06-25,9896
2374,佳能,13,0,13,元大-台南,2024-06-25,9896
2485,兆赫,43,30,13,元大-台南,2024-06-25,9896
2891,中信金,17,4,13,元大-台南,2024-06-25,9896
00942B,台新美A公司債20+,12,0,12,元大-台南,2024-06-25,9896
3037,欣興,13,1,12,元大-台南,2024-06-25,9896
2464,盟立,21,10,11,元大-台南,2024-06-25,9896
1316,上曜,30,19,11,元大-台南,2024-06-25,9896
6189,豐藝,11,0,11,元大-台南,2024-06-25,9896
2344,華邦電,1015,2,1013,元大-台南,2024-06-26,9896
2603,長榮,129,18,111,元大-台南,2024-06-26,9896
00679B,元大美債20年,105,4,101,元大-台南,2024-06-26,9896
00687B,國泰20年美債,86,2,84,元大-台南,2024-06-26,9896
2409,友達,71,5,66,元大-台南,2024-06-26,9896
6589,台康生技,54,1,53,元大-台南,2024-06-26,9896
2317,鴻海,71,21,50,元大-台南,2024-06-26,9896
3481,群創,359,312,47,元大-台南,2024-06-26,9896
2002,中鋼,52,6,46,元大-台南,2024-06-26,9896
2353,宏��,48,6,42,元大-台南,2024-06-26,9896
00637L,元大滬深300正2,46,5,41,元大-台南,2024-06-26,9896
2324,仁寶,42,4,38,元大-台南,2024-06-26,9896
00937B,群益ESG投等債20,51,14,37,元大-台南,2024-06-26,9896
2464,盟立,77,42,35,元大-台南,2024-06-26,9896
1301,台塑,38,5,33,元大-台南,2024-06-26,9896
00919,群益台灣精選高息,66,35,31,元大-台南,2024-06-26,9896
2834,臺企銀,31,1,30,元大-台南,2024-06-26,9896
00688L,國泰20年美債正2,30,0,30,元大-台南,2024-06-26,9896
00946,群益科技高息成長,29,0,29,元大-台南,2024-06-26,9896
2888,新光金,42,13,29,元大-台南,2024-06-26,9896
2885,元大金,38,10,28,元大-台南,2024-06-26,9896
1712,興農,26,0,26,元大-台南,2024-06-26,9896
1609,大亞,39,13,26,元大-台南,2024-06-26,9896
00927,群益半導體收益,25,0,25,元大-台南,2024-06-26,9896
3048,益登,38,13,25,元大-台南,2024-06-26,9896
4906,正文,24,0,24,元大-台南,2024-06-26,9896
2303,聯電,35,11,24,元大-台南,2024-06-26,9896
5371,中光電,26,3,23,元大-台南,2024-06-26,9896
8028,昇陽半導體,59,36,23,元大-台南,2024-06-26,9896
00878,國泰永續高股息,24,1,23,元大-台南,2024-06-26,9896
2801,彰銀,22,0,22,元大-台南,2024-06-26,9896
0056,元大高股息,32,11,21,元大-台南,2024-06-26,9896
1785,光洋科,53,32,21,元大-台南,2024-06-26,9896
3303,岱稜,21,1,20,元大-台南,2024-06-26,9896
00936,台新永續高息中小,36,16,20,元大-台南,2024-06-26,9896
6168,宏齊,20,0,20,元大-台南,2024-06-26,9896
8112,至上,28,9,19,元大-台南,2024-06-26,9896
4976,佳凌,21,3,18,元大-台南,2024-06-26,9896
00929,復華台灣科技優息,32,16,16,元大-台南,2024-06-26,9896
5351,鈺創,17,1,16,元大-台南,2024-06-26,9896
3032,偉訓,15,0,15,元大-台南,2024-06-26,9896
2615,萬海,21,7,14,元大-台南,2024-06-26,9896
2392,正崴,32,18,14,元大-台南,2024-06-26,9896
1617,榮星,14,0,14,元大-台南,2024-06-26,9896
6284,佳邦,16,2,14,元大-台南,2024-06-26,9896
2365,昆盈,18,5,13,元大-台南,2024-06-26,9896
3062,建漢,23,10,13,元大-台南,2024-06-26,9896
2891,中信金,15,2,13,元大-台南,2024-06-26,9896
4128,中天,14,1,13,元大-台南,2024-06-26,9896
2374,佳能,22,9,13,元大-台南,2024-06-26,9896
00679B,元大美債20年,320,22,298,元大-台南,2024-06-27,9896
00687B,國泰20年美債,180,2,178,元大-台南,2024-06-27,9896
2885,元大金,186,8,178,元大-台南,2024-06-27,9896
00937B,群益ESG投等債20,320,147,173,元大-台南,2024-06-27,9896
00929,復華台灣科技優息,200,32,168,元大-台南,2024-06-27,9896
00948B,中信優息投資級債,108,0,108,元大-台南,2024-06-27,9896
00650L,復華香港正2,100,0,100,元大-台南,2024-06-27,9896
00919,群益台灣精選高息,102,38,64,元大-台南,2024-06-27,9896
00946,群益科技高息成長,66,6,60,元大-台南,2024-06-27,9896
00680L,元大美債20正2,60,1,59,元大-台南,2024-06-27,9896
00751B,元大AAA至A公司債,57,0,57,元大-台南,2024-06-27,9896
3047,訊舟,150,94,56,元大-台南,2024-06-27,9896
00936,台新永續高息中小,56,2,54,元大-台南,2024-06-27,9896
4968,立積,56,3,53,元大-台南,2024-06-27,9896
2888,新光金,63,13,50,元大-台南,2024-06-27,9896
2489,瑞軒,67,19,48,元大-台南,2024-06-27,9896
8064,東捷,73,29,44,元大-台南,2024-06-27,9896
3712,永崴投控,71,27,44,元大-台南,2024-06-27,9896
9105,泰金寶-DR,57,14,43,元大-台南,2024-06-27,9896
2258,鴻華先進-創,42,1,41,元大-台南,2024-06-27,9896
1785,光洋科,60,24,36,元大-台南,2024-06-27,9896
00878,國泰永續高股息,44,9,35,元大-台南,2024-06-27,9896
3622,洋華,47,13,34,元大-台南,2024-06-27,9896
2352,佳世達,36,5,31,元大-台南,2024-06-27,9896
00712,復華富時不動產,31,0,31,元大-台南,2024-06-27,9896
00915,凱基優選高股息30,31,0,31,元大-台南,2024-06-27,9896
00939,統一台灣高息動能,49,21,28,元大-台南,2024-06-27,9896
4532,瑞智,28,2,26,元大-台南,2024-06-27,9896
00933B,國泰10Y+金融債,27,2,25,元大-台南,2024-06-27,9896
0056,元大高股息,23,1,22,元大-台南,2024-06-27,9896
00713,元大台灣高息低波,21,1,20,元大-台南,2024-06-27,9896
8076,伍豐,28,9,19,元大-台南,2024-06-27,9896
5905,南仁湖,20,1,19,元大-台南,2024-06-27,9896
6290,良維,19,0,19,元大-台南,2024-06-27,9896
5871,中租-KY,19,0,19,元大-台南,2024-06-27,9896
2354,鴻準,20,2,18,元大-台南,2024-06-27,9896
8150,南茂,16,0,16,元大-台南,2024-06-27,9896
8028,昇陽半導體,35,19,16,元大-台南,2024-06-27,9896
8112,至上,27,11,16,元大-台南,2024-06-27,9896
6806,森崴能源,49,34,15,元大-台南,2024-06-27,9896
6548,長科*,15,0,15,元大-台南,2024-06-27,9896
00720B,元大投資級公司債,23,9,14,元大-台南,2024-06-27,9896
1319,東陽,16,2,14,元大-台南,2024-06-27,9896
5347,世界,15,1,14,元大-台南,2024-06-27,9896
2344,華邦電,15,1,14,元大-台南,2024-06-27,9896
3715,定穎投控,18,4,14,元大-台南,2024-06-27,9896
6446,藥華藥,23,9,14,元大-台南,2024-06-27,9896
3062,建漢,21,8,13,元大-台南,2024-06-27,9896
4938,和碩,14,2,12,元大-台南,2024-06-27,9896
00900,富邦特選高股息30,12,0,12,元大-台南,2024-06-27,9896
00687B,國泰20年美債,205,1,204,元大-台南,2024-06-28,9896
00946,群益科技高息成長,109,1,108,元大-台南,2024-06-28,9896
3481,群創,247,141,106,元大-台南,2024-06-28,9896
020034,元大IC設計N,100,0,100,元大-台南,2024-06-28,9896
1617,榮星,117,19,98,元大-台南,2024-06-28,9896
00929,復華台灣科技優息,142,55,87,元大-台南,2024-06-28,9896
00937B,群益ESG投等債20,120,34,86,元大-台南,2024-06-28,9896
1303,南亞,98,14,84,元大-台南,2024-06-28,9896
3576,聯合再生,165,87,78,元大-台南,2024-06-28,9896
00936,台新永續高息中小,94,17,77,元大-台南,2024-06-28,9896
2406,國碩,151,78,73,元大-台南,2024-06-28,9896
5355,佳總,77,7,70,元大-台南,2024-06-28,9896
00673R,期元大S＆P原油反1,68,0,68,元大-台南,2024-06-28,9896
2401,凌陽,79,12,67,元大-台南,2024-06-28,9896
6182,合晶,53,0,53,元大-台南,2024-06-28,9896
00650L,復華香港正2,62,12,50,元大-台南,2024-06-28,9896
00919,群益台灣精選高息,87,41,46,元大-台南,2024-06-28,9896
00679B,元大美債20年,74,31,43,元大-台南,2024-06-28,9896
6952,大武山,37,0,37,元大-台南,2024-06-28,9896
00878,國泰永續高股息,43,11,32,元大-台南,2024-06-28,9896
2618,長榮航,82,53,29,元大-台南,2024-06-28,9896
00720B,元大投資級公司債,28,0,28,元大-台南,2024-06-28,9896
00725B,國泰投資級公司債,27,0,27,元大-台南,2024-06-28,9896
1609,大亞,42,15,27,元大-台南,2024-06-28,9896
00933B,國泰10Y+金融債,55,30,25,元大-台南,2024-06-28,9896
00712,復華富時不動產,25,0,25,元大-台南,2024-06-28,9896
2352,佳世達,26,2,24,元大-台南,2024-06-28,9896
6443,元晶,29,7,22,元大-台南,2024-06-28,9896
2317,鴻海,32,10,22,元大-台南,2024-06-28,9896
00897,富邦基因免疫生技,20,0,20,元大-台南,2024-06-28,9896
6160,欣技,40,20,20,元大-台南,2024-06-28,9896
8027,鈦昇,20,1,19,元大-台南,2024-06-28,9896
2379,瑞昱,19,1,18,元大-台南,2024-06-28,9896
6806,森崴能源,32,15,17,元大-台南,2024-06-28,9896
00706L,期元大S＆P日圓正2,16,0,16,元大-台南,2024-06-28,9896
6244,茂迪,45,29,16,元大-台南,2024-06-28,9896
911868,同方友友-DR,16,0,16,元大-台南,2024-06-28,9896
3050,鈺德,16,0,16,元大-台南,2024-06-28,9896
00713,元大台灣高息低波,16,0,16,元大-台南,2024-06-28,9896
8050,廣積,15,0,15,元大-台南,2024-06-28,9896
2330,台積電,22,8,14,元大-台南,2024-06-28,9896
2883,凱基金,48,35,13,元大-台南,2024-06-28,9896
2637,慧洋-KY,13,0,13,元大-台南,2024-06-28,9896
1440,南紡,14,1,13,元大-台南,2024-06-28,9896
1309,台達化,13,0,13,元大-台南,2024-06-28,9896
8028,昇陽半導體,60,47,13,元大-台南,2024-06-28,9896
5392,能率,22,9,13,元大-台南,2024-06-28,9896
3048,益登,21,9,12,元大-台南,2024-06-28,9896
2347,聯強,12,0,12,元大-台南,2024-06-28,9896
2101,南港,14,2,12,元大-台南,2024-06-28,9896
00679B,元大美債20年,458,0,458,元大-台南,2024-07-01,9896
00929,復華台灣科技優息,429,9,420,元大-台南,2024-07-01,9896
00687B,國泰20年美債,403,0,403,元大-台南,2024-07-01,9896
00937B,群益ESG投等債20,340,132,208,元大-台南,2024-07-01,9896
00936,台新永續高息中小,220,16,204,元大-台南,2024-07-01,9896
00680L,元大美債20正2,181,24,157,元大-台南,2024-07-01,9896
020031,統一IC設計臺灣N,130,0,130,元大-台南,2024-07-01,9896
00637L,元大滬深300正2,102,4,98,元大-台南,2024-07-01,9896
0056,元大高股息,91,13,78,元大-台南,2024-07-01,9896
00949,復華日本龍頭,74,0,74,元大-台南,2024-07-01,9896
2313,華通,84,12,72,元大-台南,2024-07-01,9896
00751B,元大AAA至A公司債,70,2,68,元大-台南,2024-07-01,9896
1802,台玻,65,4,61,元大-台南,2024-07-01,9896
2836,高雄銀,60,0,60,元大-台南,2024-07-01,9896
00933B,國泰10Y+金融債,58,2,56,元大-台南,2024-07-01,9896
6589,台康生技,59,5,54,元大-台南,2024-07-01,9896
6282,康舒,44,0,44,元大-台南,2024-07-01,9896
00948B,中信優息投資級債,42,0,42,元大-台南,2024-07-01,9896
00946,群益科技高息成長,51,10,41,元大-台南,2024-07-01,9896
00931B,統一美債20年,36,0,36,元大-台南,2024-07-01,9896
00772B,中信高評級公司債,36,1,35,元大-台南,2024-07-01,9896
2609,陽明,62,29,33,元大-台南,2024-07-01,9896
2883,凱基金,62,29,33,元大-台南,2024-07-01,9896
5484,慧友,32,1,31,元大-台南,2024-07-01,9896
00857B,永豐20年美公債,35,5,30,元大-台南,2024-07-01,9896
1717,長興,30,1,29,元大-台南,2024-07-01,9896
2367,燿華,33,6,27,元大-台南,2024-07-01,9896
5355,佳總,52,25,27,元大-台南,2024-07-01,9896
2882,國泰金,37,13,24,元大-台南,2024-07-01,9896
2317,鴻海,48,24,24,元大-台南,2024-07-01,9896
1785,光洋科,32,10,22,元大-台南,2024-07-01,9896
3691,碩禾,22,1,21,元大-台南,2024-07-01,9896
00720B,元大投資級公司債,24,4,20,元大-台南,2024-07-01,9896
00915,凱基優選高股息30,21,1,20,元大-台南,2024-07-01,9896
2359,所羅門,67,49,18,元大-台南,2024-07-01,9896
6226,光鼎,20,2,18,元大-台南,2024-07-01,9896
6753,龍德造船,20,3,17,元大-台南,2024-07-01,9896
9904,寶成,17,0,17,元大-台南,2024-07-01,9896
4726,永昕,17,0,17,元大-台南,2024-07-01,9896
00795B,中信美國公債20年,17,0,17,元大-台南,2024-07-01,9896
2615,萬海,78,62,16,元大-台南,2024-07-01,9896
6285,啟��,16,0,16,元大-台南,2024-07-01,9896
1101,台泥,19,3,16,元大-台南,2024-07-01,9896
2355,敬鵬,16,1,15,元大-台南,2024-07-01,9896
2374,佳能,61,47,14,元大-台南,2024-07-01,9896
6182,合晶,16,3,13,元大-台南,2024-07-01,9896
3024,憶聲,23,10,13,元大-台南,2024-07-01,9896
2402,毅嘉,14,1,13,元大-台南,2024-07-01,9896
1609,大亞,34,22,12,元大-台南,2024-07-01,9896
6188,廣明,24,12,12,元大-台南,2024-07-01,9896
00673R,期元大S＆P原油反1,1652,0,1652,元大-台南,2024-07-02,9896
2303,聯電,375,30,345,元大-台南,2024-07-02,9896
00687B,國泰20年美債,349,14,335,元大-台南,2024-07-02,9896
00934,中信成長高股息,261,35,226,元大-台南,2024-07-02,9896
00929,復華台灣科技優息,353,146,207,元大-台南,2024-07-02,9896
00679B,元大美債20年,211,10,201,元大-台南,2024-07-02,9896
00937B,群益ESG投等債20,194,2,192,元大-台南,2024-07-02,9896
9105,泰金寶-DR,173,17,156,元大-台南,2024-07-02,9896
00680L,元大美債20正2,108,5,103,元大-台南,2024-07-02,9896
2317,鴻海,136,33,103,元大-台南,2024-07-02,9896
0056,元大高股息,96,1,95,元大-台南,2024-07-02,9896
00936,台新永續高息中小,74,0,74,元大-台南,2024-07-02,9896
00688L,國泰20年美債正2,73,5,68,元大-台南,2024-07-02,9896
3481,群創,94,31,63,元大-台南,2024-07-02,9896
00919,群益台灣精選高息,57,11,46,元大-台南,2024-07-02,9896
2349,錸德,110,68,42,元大-台南,2024-07-02,9896
8112,至上,48,7,41,元大-台南,2024-07-02,9896
00933B,國泰10Y+金融債,40,0,40,元大-台南,2024-07-02,9896
00857B,永豐20年美公債,36,0,36,元大-台南,2024-07-02,9896
5210,寶碩,36,0,36,元大-台南,2024-07-02,9896
2002,中鋼,32,1,31,元大-台南,2024-07-02,9896
00931B,統一美債20年,29,0,29,元大-台南,2024-07-02,9896
2605,新興,34,5,29,元大-台南,2024-07-02,9896
5452,佶優,32,4,28,元大-台南,2024-07-02,9896
00751B,元大AAA至A公司債,26,0,26,元大-台南,2024-07-02,9896
8064,東捷,79,54,25,元大-台南,2024-07-02,9896
2464,盟立,41,16,25,元大-台南,2024-07-02,9896
1301,台塑,28,4,24,元大-台南,2024-07-02,9896
5230,雷笛克光學,24,1,23,元大-台南,2024-07-02,9896
3706,神達,22,0,22,元大-台南,2024-07-02,9896
00712,復華富時不動產,22,1,21,元大-台南,2024-07-02,9896
6438,迅得,24,3,21,元大-台南,2024-07-02,9896
6290,良維,22,2,20,元大-台南,2024-07-02,9896
8271,宇瞻,20,0,20,元大-台南,2024-07-02,9896
2354,鴻準,30,10,20,元大-台南,2024-07-02,9896
00948B,中信優息投資級債,19,0,19,元大-台南,2024-07-02,9896
2258,鴻華先進-創,20,1,19,元大-台南,2024-07-02,9896
4938,和碩,24,8,16,元大-台南,2024-07-02,9896
00878,國泰永續高股息,27,12,15,元大-台南,2024-07-02,9896
00918,大華優利高填息30,15,0,15,元大-台南,2024-07-02,9896
3520,華盈,15,0,15,元大-台南,2024-07-02,9896
6270,倍微,15,0,15,元大-台南,2024-07-02,9896
4562,穎漢,50,35,15,元大-台南,2024-07-02,9896
2883,凱基金,28,13,15,元大-台南,2024-07-02,9896
1326,台化,15,0,15,元大-台南,2024-07-02,9896
2406,國碩,108,94,14,元大-台南,2024-07-02,9896
1785,光洋科,55,41,14,元大-台南,2024-07-02,9896
3702,大聯大,14,0,14,元大-台南,2024-07-02,9896
6239,力成,15,1,14,元大-台南,2024-07-02,9896
8076,伍豐,14,0,14,元大-台南,2024-07-02,9896
00934,中信成長高股息,270,0,270,元大-台南,2024-07-03,9896
00937B,群益ESG投等債20,162,5,157,元大-台南,2024-07-03,9896
00687B,國泰20年美債,152,0,152,元大-台南,2024-07-03,9896
00679B,元大美債20年,164,18,146,元大-台南,2024-07-03,9896
6244,茂迪,138,19,119,元大-台南,2024-07-03,9896
9105,泰金寶-DR,159,50,109,元大-台南,2024-07-03,9896
2303,聯電,107,29,78,元大-台南,2024-07-03,9896
3576,聯合再生,178,111,67,元大-台南,2024-07-03,9896
2356,英業達,78,22,56,元大-台南,2024-07-03,9896
00688L,國泰20年美債正2,56,0,56,元大-台南,2024-07-03,9896
4532,瑞智,40,0,40,元大-台南,2024-07-03,9896
6257,矽格,40,0,40,元大-台南,2024-07-03,9896
3591,艾笛森,41,2,39,元大-台南,2024-07-03,9896
2317,鴻海,47,14,33,元大-台南,2024-07-03,9896
00927,群益半導體收益,29,1,28,元大-台南,2024-07-03,9896
2460,建通,27,0,27,元大-台南,2024-07-03,9896
6227,茂綸,25,0,25,元大-台南,2024-07-03,9896
00949,復華日本龍頭,21,0,21,元大-台南,2024-07-03,9896
4938,和碩,29,9,20,元大-台南,2024-07-03,9896
4906,正文,44,25,19,元大-台南,2024-07-03,9896
6538,倉和,21,2,19,元大-台南,2024-07-03,9896
2610,華航,34,16,18,元大-台南,2024-07-03,9896
3005,神基,25,8,17,元大-台南,2024-07-03,9896
00632R,元大台灣50反1,16,0,16,元大-台南,2024-07-03,9896
6477,安集,18,2,16,元大-台南,2024-07-03,9896
2915,潤泰全,18,2,16,元大-台南,2024-07-03,9896
2402,毅嘉,45,29,16,元大-台南,2024-07-03,9896
2301,光寶科,16,0,16,元大-台南,2024-07-03,9896
3105,穩懋,18,3,15,元大-台南,2024-07-03,9896
2489,瑞軒,20,5,15,元大-台南,2024-07-03,9896
3550,聯穎,15,0,15,元大-台南,2024-07-03,9896
00673R,期元大S＆P原油反1,15,0,15,元大-台南,2024-07-03,9896
2352,佳世達,15,1,14,元大-台南,2024-07-03,9896
4904,遠傳,15,1,14,元大-台南,2024-07-03,9896
4562,穎漢,82,68,14,元大-台南,2024-07-03,9896
3047,訊舟,97,83,14,元大-台南,2024-07-03,9896
00720B,元大投資級公司債,13,0,13,元大-台南,2024-07-03,9896
8044,網家,13,0,13,元大-台南,2024-07-03,9896
3021,鴻名,12,0,12,元大-台南,2024-07-03,9896
4566,時碩工業,28,16,12,元大-台南,2024-07-03,9896
8215,明基材,12,0,12,元大-台南,2024-07-03,9896
4915,致伸,13,2,11,元大-台南,2024-07-03,9896
00885,富邦越南,23,12,11,元大-台南,2024-07-03,9896
5443,均豪,69,59,10,元大-台南,2024-07-03,9896
8271,宇瞻,10,0,10,元大-台南,2024-07-03,9896
2906,高林,11,1,10,元大-台南,2024-07-03,9896
1731,美吾華,10,0,10,元大-台南,2024-07-03,9896
1514,亞力,24,14,10,元大-台南,2024-07-03,9896
00918,大華優利高填息30,10,0,10,元大-台南,2024-07-03,9896
3483,力致,12,2,10,元大-台南,2024-07-03,9896
4919,新唐,323,2,321,元大-台南,2024-07-04,9896
00632R,元大台灣50反1,431,116,315,元大-台南,2024-07-04,9896
2603,長榮,321,17,304,元大-台南,2024-07-04,9896
00679B,元大美債20年,234,35,199,元大-台南,2024-07-04,9896
1314,中石化,171,33,138,元大-台南,2024-07-04,9896
9105,泰金寶-DR,296,164,132,元大-台南,2024-07-04,9896
00687B,國泰20年美債,121,0,121,元大-台南,2024-07-04,9896
2888,新光金,126,24,102,元大-台南,2024-07-04,9896
00934,中信成長高股息,78,0,78,元大-台南,2024-07-04,9896
2883,凱基金,88,13,75,元大-台南,2024-07-04,9896
3047,訊舟,86,32,54,元大-台南,2024-07-04,9896
2412,中華電,48,0,48,元大-台南,2024-07-04,9896
00764B,群益25年美債,47,0,47,元大-台南,2024-07-04,9896
2618,長榮航,63,23,40,元大-台南,2024-07-04,9896
00912,中信臺灣智慧50,40,0,40,元大-台南,2024-07-04,9896
00937B,群益ESG投等債20,58,20,38,元大-台南,2024-07-04,9896
00936,台新永續高息中小,36,1,35,元大-台南,2024-07-04,9896
6257,矽格,45,10,35,元大-台南,2024-07-04,9896
2344,華邦電,67,34,33,元大-台南,2024-07-04,9896
00650L,復華香港正2,32,0,32,元大-台南,2024-07-04,9896
1815,富喬,58,27,31,元大-台南,2024-07-04,9896
8110,華東,32,3,29,元大-台南,2024-07-04,9896
00706L,期元大S＆P日圓正2,27,0,27,元大-台南,2024-07-04,9896
00929,復華台灣科技優息,109,84,25,元大-台南,2024-07-04,9896
00680L,元大美債20正2,24,0,24,元大-台南,2024-07-04,9896
1785,光洋科,130,106,24,元大-台南,2024-07-04,9896
00919,群益台灣精選高息,36,12,24,元大-台南,2024-07-04,9896
2406,國碩,29,7,22,元大-台南,2024-07-04,9896
5347,世界,26,4,22,元大-台南,2024-07-04,9896
8163,達方,22,0,22,元大-台南,2024-07-04,9896
00673R,期元大S＆P原油反1,20,0,20,元大-台南,2024-07-04,9896
00664R,國泰臺灣加權反1,20,0,20,元大-台南,2024-07-04,9896
3312,弘憶股,71,53,18,元大-台南,2024-07-04,9896
2867,三商壽,18,1,17,元大-台南,2024-07-04,9896
4109,加捷生醫,23,7,16,元大-台南,2024-07-04,9896
6761,穩得,16,0,16,元大-台南,2024-07-04,9896
2324,仁寶,17,1,16,元大-台南,2024-07-04,9896
1409,新纖,30,16,14,元大-台南,2024-07-04,9896
2615,萬海,21,8,13,元大-台南,2024-07-04,9896
2017,官田鋼,15,2,13,元大-台南,2024-07-04,9896
2349,錸德,26,13,13,元大-台南,2024-07-04,9896
3576,聯合再生,36,23,13,元大-台南,2024-07-04,9896
3078,僑威,13,0,13,元大-台南,2024-07-04,9896
3450,聯鈞,43,31,12,元大-台南,2024-07-04,9896
00885,富邦越南,12,0,12,元大-台南,2024-07-04,9896
3189,景碩,13,1,12,元大-台南,2024-07-04,9896
2401,凌陽,12,1,11,元大-台南,2024-07-04,9896
00882,中信中國高股息,21,10,11,元大-台南,2024-07-04,9896
3615,安可,15,4,11,元大-台南,2024-07-04,9896
2258,鴻華先進-創,11,0,11,元大-台南,2024-07-04,9896
00934,中信成長高股息,323,1,322,元大-台南,2024-07-05,9896
2888,新光金,256,54,202,元大-台南,2024-07-05,9896
4562,穎漢,214,13,201,元大-台南,2024-07-05,9896
2312,金寶,150,13,137,元大-台南,2024-07-05,9896
2606,裕民,75,0,75,元大-台南,2024-07-05,9896
1314,中石化,105,32,73,元大-台南,2024-07-05,9896
00882,中信中國高股息,66,0,66,元大-台南,2024-07-05,9896
00679B,元大美債20年,69,11,58,元大-台南,2024-07-05,9896
00637L,元大滬深300正2,61,5,56,元大-台南,2024-07-05,9896
1718,中纖,57,1,56,元大-台南,2024-07-05,9896
00650L,復華香港正2,56,8,48,元大-台南,2024-07-05,9896
6153,嘉聯益,42,3,39,元大-台南,2024-07-05,9896
5011,久陽,40,1,39,元大-台南,2024-07-05,9896
00919,群益台灣精選高息,44,6,38,元大-台南,2024-07-05,9896
2367,燿華,100,65,35,元大-台南,2024-07-05,9896
3048,益登,104,70,34,元大-台南,2024-07-05,9896
9919,康那香,39,8,31,元大-台南,2024-07-05,9896
00632R,元大台灣50反1,49,19,30,元大-台南,2024-07-05,9896
6603,富強鑫,30,0,30,元大-台南,2024-07-05,9896
1909,榮成,30,0,30,元大-台南,2024-07-05,9896
8105,凌巨,35,7,28,元大-台南,2024-07-05,9896
6189,豐藝,39,12,27,元大-台南,2024-07-05,9896
00665L,富邦�琤肭磪囓�2,30,3,27,元大-台南,2024-07-05,9896
00673R,期元大S＆P原油反1,25,0,25,元大-台南,2024-07-05,9896
2317,鴻海,57,34,23,元大-台南,2024-07-05,9896
00857B,永豐20年美公債,22,0,22,元大-台南,2024-07-05,9896
2883,凱基金,24,3,21,元大-台南,2024-07-05,9896
5328,華容,20,0,20,元大-台南,2024-07-05,9896
1721,三晃,25,5,20,元大-台南,2024-07-05,9896
4532,瑞智,20,1,19,元大-台南,2024-07-05,9896
2543,皇昌,43,25,18,元大-台南,2024-07-05,9896
00687B,國泰20年美債,25,8,17,元大-台南,2024-07-05,9896
8163,達方,17,0,17,元大-台南,2024-07-05,9896
3576,聯合再生,39,22,17,元大-台南,2024-07-05,9896
6625,必應,17,0,17,元大-台南,2024-07-05,9896
2885,元大金,20,4,16,元大-台南,2024-07-05,9896
00655L,國泰中國A50正2,15,0,15,元大-台南,2024-07-05,9896
3303,岱稜,15,0,15,元大-台南,2024-07-05,9896
6290,良維,17,3,14,元大-台南,2024-07-05,9896
2258,鴻華先進-創,14,0,14,元大-台南,2024-07-05,9896
00885,富邦越南,13,0,13,元大-台南,2024-07-05,9896
3005,神基,15,3,12,元大-台南,2024-07-05,9896
3450,聯鈞,61,49,12,元大-台南,2024-07-05,9896
1447,力鵬,12,0,12,元大-台南,2024-07-05,9896
2371,大同,17,5,12,元大-台南,2024-07-05,9896
4566,時碩工業,21,9,12,元大-台南,2024-07-05,9896
3037,欣興,14,2,12,元大-台南,2024-07-05,9896
5498,凱崴,12,1,11,元大-台南,2024-07-05,9896
8103,瀚荃,11,0,11,元大-台南,2024-07-05,9896
2365,昆盈,33,22,11,元大-台南,2024-07-05,9896
00632R,元大台灣50反1,632,150,482,元大-台南,2024-07-08,9896
00650L,復華香港正2,192,50,142,元大-台南,2024-07-08,9896
3691,碩禾,132,1,131,元大-台南,2024-07-08,9896
6177,達麗,103,0,103,元大-台南,2024-07-08,9896
1563,巧新,103,3,100,元大-台南,2024-07-08,9896
6182,合晶,92,6,86,元大-台南,2024-07-08,9896
9945,潤泰新,66,0,66,元大-台南,2024-07-08,9896
00882,中信中國高股息,63,1,62,元大-台南,2024-07-08,9896
2427,三商電,83,25,58,元大-台南,2024-07-08,9896
2495,普安,74,16,58,元大-台南,2024-07-08,9896
2352,佳世達,60,5,55,元大-台南,2024-07-08,9896
2606,裕民,52,1,51,元大-台南,2024-07-08,9896
2618,長榮航,85,37,48,元大-台南,2024-07-08,9896
00934,中信成長高股息,60,14,46,元大-台南,2024-07-08,9896
2892,第一金,51,5,46,元大-台南,2024-07-08,9896
00936,台新永續高息中小,56,10,46,元大-台南,2024-07-08,9896
00687B,國泰20年美債,49,7,42,元大-台南,2024-07-08,9896
1785,光洋科,107,65,42,元大-台南,2024-07-08,9896
5452,佶優,45,10,35,元大-台南,2024-07-08,9896
2344,華邦電,37,2,35,元大-台南,2024-07-08,9896
00929,復華台灣科技優息,93,59,34,元大-台南,2024-07-08,9896
2363,矽統,66,33,33,元大-台南,2024-07-08,9896
2464,盟立,97,65,32,元大-台南,2024-07-08,9896
6213,聯茂,39,8,31,元大-台南,2024-07-08,9896
9904,寶成,30,2,28,元大-台南,2024-07-08,9896
2382,廣達,43,18,25,元大-台南,2024-07-08,9896
1409,新纖,43,18,25,元大-台南,2024-07-08,9896
3520,華盈,30,7,23,元大-台南,2024-07-08,9896
2515,中工,23,0,23,元大-台南,2024-07-08,9896
4720,德淵,23,0,23,元大-台南,2024-07-08,9896
4919,新唐,24,1,23,元大-台南,2024-07-08,9896
00857B,永豐20年美公債,22,0,22,元大-台南,2024-07-08,9896
6189,豐藝,22,0,22,元大-台南,2024-07-08,9896
00673R,期元大S＆P原油反1,21,0,21,元大-台南,2024-07-08,9896
6005,群益證,21,0,21,元大-台南,2024-07-08,9896
6446,藥華藥,25,4,21,元大-台南,2024-07-08,9896
8028,昇陽半導體,30,10,20,元大-台南,2024-07-08,9896
6153,嘉聯益,53,32,21,元大-台南,2024-07-08,9896
1802,台玻,20,1,19,元大-台南,2024-07-08,9896
6152,百一,19,0,19,元大-台南,2024-07-08,9896
2417,圓剛,23,4,19,元大-台南,2024-07-08,9896
5443,均豪,51,32,19,元大-台南,2024-07-08,9896
2486,一詮,22,4,18,元大-台南,2024-07-08,9896
00919,群益台灣精選高息,48,30,18,元大-台南,2024-07-08,9896
2406,國碩,25,7,18,元大-台南,2024-07-08,9896
1609,大亞,25,7,18,元大-台南,2024-07-08,9896
2337,旺宏,32,16,16,元大-台南,2024-07-08,9896
3056,富華新,17,1,16,元大-台南,2024-07-08,9896
2359,所羅門,30,15,15,元大-台南,2024-07-08,9896
6217,中探針,31,16,15,元大-台南,2024-07-08,9896
4960,誠美材,312,12,300,元大-台南,2024-07-09,9896
2303,聯電,261,47,214,元大-台南,2024-07-09,9896
00632R,元大台灣50反1,141,9,132,元大-台南,2024-07-09,9896
4906,正文,123,13,110,元大-台南,2024-07-09,9896
00637L,元大滬深300正2,118,11,107,元大-台南,2024-07-09,9896
1563,巧新,106,0,106,元大-台南,2024-07-09,9896
00673R,期元大S＆P原油反1,100,0,100,元大-台南,2024-07-09,9896
00764B,群益25年美債,100,0,100,元大-台南,2024-07-09,9896
2312,金寶,192,93,99,元大-台南,2024-07-09,9896
2834,臺企銀,101,1,100,元大-台南,2024-07-09,9896
1785,光洋科,113,41,72,元大-台南,2024-07-09,9896
00679B,元大美債20年,173,105,68,元大-台南,2024-07-09,9896
3033,威健,64,5,59,元大-台南,2024-07-09,9896
2353,宏��,79,21,58,元大-台南,2024-07-09,9896
2317,鴻海,144,93,51,元大-台南,2024-07-09,9896
00936,台新永續高息中小,62,12,50,元大-台南,2024-07-09,9896
2609,陽明,169,122,47,元大-台南,2024-07-09,9896
00878,國泰永續高股息,60,14,46,元大-台南,2024-07-09,9896
2367,燿華,140,96,44,元大-台南,2024-07-09,9896
00929,復華台灣科技優息,126,83,43,元大-台南,2024-07-09,9896
1301,台塑,56,16,40,元大-台南,2024-07-09,9896
00944,野村趨勢動能高息,38,0,38,元大-台南,2024-07-09,9896
3047,訊舟,96,58,38,元大-台南,2024-07-09,9896
6532,瑞耘,36,0,36,元大-台南,2024-07-09,9896
00950B,凱基A級公司債,35,0,35,元大-台南,2024-07-09,9896
1314,中石化,42,12,30,元大-台南,2024-07-09,9896
00795B,中信美國公債20年,30,0,30,元大-台南,2024-07-09,9896
3231,緯創,56,27,29,元大-台南,2024-07-09,9896
2349,錸德,60,33,27,元大-台南,2024-07-09,9896
2365,昆盈,83,58,25,元大-台南,2024-07-09,9896
2352,佳世達,28,4,24,元大-台南,2024-07-09,9896
2537,聯上發,24,0,24,元大-台南,2024-07-09,9896
00945B,凱基美國非投等債,23,0,23,元大-台南,2024-07-09,9896
00933B,國泰10Y+金融債,50,27,23,元大-台南,2024-07-09,9896
3576,聯合再生,38,16,22,元大-台南,2024-07-09,9896
00946,群益科技高息成長,34,13,21,元大-台南,2024-07-09,9896
2313,華通,35,15,20,元大-台南,2024-07-09,9896
3013,晟銘電,41,21,20,元大-台南,2024-07-09,9896
3537,堡達,23,3,20,元大-台南,2024-07-09,9896
8064,東捷,47,28,19,元大-台南,2024-07-09,9896
2330,台積電,25,6,19,元大-台南,2024-07-09,9896
1605,華新,19,0,19,元大-台南,2024-07-09,9896
2515,中工,19,0,19,元大-台南,2024-07-09,9896
3050,鈺德,23,4,19,元大-台南,2024-07-09,9896
3062,建漢,20,1,19,元大-台南,2024-07-09,9896
2393,億光,19,2,17,元大-台南,2024-07-09,9896
3260,威剛,29,12,17,元大-台南,2024-07-09,9896
6005,群益證,17,0,17,元大-台南,2024-07-09,9896
5475,德宏,18,1,17,元大-台南,2024-07-09,9896
0056,元大高股息,25,9,16,元大-台南,2024-07-09,9896
00929,復華台灣科技優息,311,40,271,元大-台南,2024-07-10,9896
9105,泰金寶-DR,118,16,102,元大-台南,2024-07-10,9896
2303,聯電,120,19,101,元大-台南,2024-07-10,9896
00934,中信成長高股息,107,8,99,元大-台南,2024-07-10,9896
00937B,群益ESG投等債20,103,5,98,元大-台南,2024-07-10,9896
2354,鴻準,106,10,96,元大-台南,2024-07-10,9896
6177,達麗,102,12,90,元大-台南,2024-07-10,9896
1563,巧新,83,0,83,元大-台南,2024-07-10,9896
00725B,國泰投資級公司債,75,1,74,元大-台南,2024-07-10,9896
00933B,國泰10Y+金融債,78,10,68,元大-台南,2024-07-10,9896
2353,宏��,106,51,55,元大-台南,2024-07-10,9896
00740B,富邦全球投等債,52,0,52,元大-台南,2024-07-10,9896
2834,臺企銀,49,0,49,元大-台南,2024-07-10,9896
2317,鴻海,65,17,48,元大-台南,2024-07-10,9896
2489,瑞軒,91,52,39,元大-台南,2024-07-10,9896
3576,聯合再生,40,2,38,元大-台南,2024-07-10,9896
2301,光寶科,55,19,36,元大-台南,2024-07-10,9896
2618,長榮航,49,13,36,元大-台南,2024-07-10,9896
2002,中鋼,32,0,32,元大-台南,2024-07-10,9896
2464,盟立,100,70,30,元大-台南,2024-07-10,9896
00706L,期元大S＆P日圓正2,30,0,30,元大-台南,2024-07-10,9896
2313,華通,37,10,27,元大-台南,2024-07-10,9896
3202,樺晟,25,0,25,元大-台南,2024-07-10,9896
00713,元大台灣高息低波,24,0,24,元大-台南,2024-07-10,9896
4510,高鋒,26,2,24,元大-台南,2024-07-10,9896
00946,群益科技高息成長,34,10,24,元大-台南,2024-07-10,9896
6443,元晶,42,18,24,元大-台南,2024-07-10,9896
00936,台新永續高息中小,50,27,23,元大-台南,2024-07-10,9896
00688L,國泰20年美債正2,49,26,23,元大-台南,2024-07-10,9896
2801,彰銀,23,0,23,元大-台南,2024-07-10,9896
00944,野村趨勢動能高息,22,0,22,元大-台南,2024-07-10,9896
2867,三商壽,30,9,21,元大-台南,2024-07-10,9896
2412,中華電,21,0,21,元大-台南,2024-07-10,9896
00949,復華日本龍頭,30,10,20,元大-台南,2024-07-10,9896
1616,億泰,31,11,20,元大-台南,2024-07-10,9896
6661,威健生技,20,0,20,元大-台南,2024-07-10,9896
6187,萬潤,43,24,19,元大-台南,2024-07-10,9896
6133,金橋,20,1,19,元大-台南,2024-07-10,9896
9945,潤泰新,30,12,18,元大-台南,2024-07-10,9896
2406,國碩,23,6,17,元大-台南,2024-07-10,9896
6026,福邦證,20,3,17,元大-台南,2024-07-10,9896
2049,上銀,21,5,16,元大-台南,2024-07-10,9896
2603,長榮,18,2,16,元大-台南,2024-07-10,9896
5371,中光電,18,2,16,元大-台南,2024-07-10,9896
4526,東台,19,3,16,元大-台南,2024-07-10,9896
2312,金寶,232,217,15,元大-台南,2024-07-10,9896
5347,世界,21,6,15,元大-台南,2024-07-10,9896
5876,上海商銀,19,5,14,元大-台南,2024-07-10,9896
00945B,凱基美國非投等債,14,0,14,元大-台南,2024-07-10,9896
3703,欣陸,13,0,13,元大-台南,2024-07-10,9896
4906,正文,307,5,302,元大-台南,2024-07-11,9896
00934,中信成長高股息,254,14,240,元大-台南,2024-07-11,9896
00673R,期元大S＆P原油反1,200,0,200,元大-台南,2024-07-11,9896
00679B,元大美債20年,185,16,169,元大-台南,2024-07-11,9896
1314,中石化,116,1,115,元大-台南,2024-07-11,9896
00632R,元大台灣50反1,255,151,104,元大-台南,2024-07-11,9896
2618,長榮航,65,3,62,元大-台南,2024-07-11,9896
2888,新光金,113,60,53,元大-台南,2024-07-11,9896
3707,漢磊,55,5,50,元大-台南,2024-07-11,9896
1101,台泥,47,2,45,元大-台南,2024-07-11,9896
00725B,國泰投資級公司債,47,4,43,元大-台南,2024-07-11,9896
2489,瑞軒,151,112,39,元大-台南,2024-07-11,9896
2303,聯電,82,47,35,元大-台南,2024-07-11,9896
00687B,國泰20年美債,40,5,35,元大-台南,2024-07-11,9896
2392,正崴,87,53,34,元大-台南,2024-07-11,9896
1447,力鵬,37,3,34,元大-台南,2024-07-11,9896
6118,建達,32,0,32,元大-台南,2024-07-11,9896
6182,合晶,33,1,32,元大-台南,2024-07-11,9896
00764B,群益25年美債,30,0,30,元大-台南,2024-07-11,9896
6005,群益證,29,0,29,元大-台南,2024-07-11,9896
3266,昇陽,29,1,28,元大-台南,2024-07-11,9896
1795,美時,29,3,26,元大-台南,2024-07-11,9896
6789,采鈺,26,0,26,元大-台南,2024-07-11,9896
1609,大亞,33,8,25,元大-台南,2024-07-11,9896
2365,昆盈,147,123,24,元大-台南,2024-07-11,9896
00946,群益科技高息成長,32,10,22,元大-台南,2024-07-11,9896
1513,中興電,73,52,21,元大-台南,2024-07-11,9896
0056,元大高股息,31,11,20,元大-台南,2024-07-11,9896
3576,聯合再生,24,4,20,元大-台南,2024-07-11,9896
00922,國泰台灣領袖50,21,1,20,元大-台南,2024-07-11,9896
2401,凌陽,36,17,19,元大-台南,2024-07-11,9896
2316,楠梓電,35,16,19,元大-台南,2024-07-11,9896
4561,健椿,20,1,19,元大-台南,2024-07-11,9896
8111,立��,19,0,19,元大-台南,2024-07-11,9896
6187,萬潤,27,9,18,元大-台南,2024-07-11,9896
2891,中信金,38,20,18,元大-台南,2024-07-11,9896
2354,鴻準,32,16,16,元大-台南,2024-07-11,9896
00949,復華日本龍頭,16,0,16,元大-台南,2024-07-11,9896
2329,華泰,16,1,15,元大-台南,2024-07-11,9896
9946,三發地產,16,1,15,元大-台南,2024-07-11,9896
2836,高雄銀,15,0,15,元大-台南,2024-07-11,9896
5213,亞昕,15,0,15,元大-台南,2024-07-11,9896
8358,金居,56,41,15,元大-台南,2024-07-11,9896
2605,新興,15,1,14,元大-台南,2024-07-11,9896
2362,藍天,22,8,14,元大-台南,2024-07-11,9896
2388,威盛,26,12,14,元大-台南,2024-07-11,9896
2363,矽統,30,17,13,元大-台南,2024-07-11,9896
4526,東台,17,4,13,元大-台南,2024-07-11,9896
2537,聯上發,20,7,13,元大-台南,2024-07-11,9896
4743,合一,13,0,13,元大-台南,2024-07-11,9896
00929,復華台灣科技優息,286,7,279,元大-台南,2024-07-12,9896
00919,群益台灣精選高息,276,46,230,元大-台南,2024-07-12,9896
00934,中信成長高股息,169,26,143,元大-台南,2024-07-12,9896
2312,金寶,503,415,88,元大-台南,2024-07-12,9896
0056,元大高股息,104,17,87,元大-台南,2024-07-12,9896
2867,三商壽,229,146,83,元大-台南,2024-07-12,9896
00942B,台新美A公司債20+,72,1,71,元大-台南,2024-07-12,9896
4716,大立,66,0,66,元大-台南,2024-07-12,9896
2303,聯電,191,126,65,元大-台南,2024-07-12,9896
00949,復華日本龍頭,66,2,64,元大-台南,2024-07-12,9896
00706L,期元大S＆P日圓正2,60,0,60,元大-台南,2024-07-12,9896
00936,台新永續高息中小,55,5,50,元大-台南,2024-07-12,9896
00673R,期元大S＆P原油反1,50,0,50,元大-台南,2024-07-12,9896
3047,訊舟,55,6,49,元大-台南,2024-07-12,9896
3046,建��,46,0,46,元大-台南,2024-07-12,9896
2330,台積電,65,19,46,元大-台南,2024-07-12,9896
00881,國泰台灣5G+,58,16,42,元大-台南,2024-07-12,9896
00725B,國泰投資級公司債,77,36,41,元大-台南,2024-07-12,9896
00948B,中信優息投資級債,37,0,37,元大-台南,2024-07-12,9896
00891,中信關鍵半導體,38,4,34,元大-台南,2024-07-12,9896
00688L,國泰20年美債正2,32,0,32,元大-台南,2024-07-12,9896
00945B,凱基美國非投等債,32,0,32,元大-台南,2024-07-12,9896
2495,普安,35,4,31,元大-台南,2024-07-12,9896
1455,集盛,30,0,30,元大-台南,2024-07-12,9896
1529,樂事綠能,42,13,29,元大-台南,2024-07-12,9896
0050,元大台灣50,28,1,27,元大-台南,2024-07-12,9896
2812,台中銀,26,0,26,元大-台南,2024-07-12,9896
2313,華通,34,9,25,元大-台南,2024-07-12,9896
1447,力鵬,109,84,25,元大-台南,2024-07-12,9896
00878,國泰永續高股息,53,29,24,元大-台南,2024-07-12,9896
00947,台新臺灣IC設計,28,5,23,元大-台南,2024-07-12,9896
2317,鴻海,139,116,23,元大-台南,2024-07-12,9896
00935,野村臺灣新科技50,33,10,23,元大-台南,2024-07-12,9896
2855,統一證,36,15,21,元大-台南,2024-07-12,9896
00933B,國泰10Y+金融債,26,6,20,元大-台南,2024-07-12,9896
00923,群益台ESG低碳50,19,0,19,元大-台南,2024-07-12,9896
2618,長榮航,20,3,17,元大-台南,2024-07-12,9896
2363,矽統,31,14,17,元大-台南,2024-07-12,9896
1536,和大,38,21,17,元大-台南,2024-07-12,9896
3715,定穎投控,20,4,16,元大-台南,2024-07-12,9896
00675L,富邦臺灣加權正2,18,2,16,元大-台南,2024-07-12,9896
1785,光洋科,30,15,15,元大-台南,2024-07-12,9896
00679B,元大美債20年,110,96,14,元大-台南,2024-07-12,9896
006208,富邦台50,16,1,15,元大-台南,2024-07-12,9896
2887,台新金,47,33,14,元大-台南,2024-07-12,9896
3711,日月光投控,18,3,15,元大-台南,2024-07-12,9896
3374,精材,21,7,14,元大-台南,2024-07-12,9896
4906,正文,25,11,14,元大-台南,2024-07-12,9896
6026,福邦證,14,0,14,元大-台南,2024-07-12,9896
00740B,富邦全球投等債,14,0,14,元大-台南,2024-07-12,9896
00937B,群益ESG投等債20,507,24,483,元大-台南,2024-07-15,9896
2891,中信金,171,5,166,元大-台南,2024-07-15,9896
2356,英業達,199,46,153,元大-台南,2024-07-15,9896
2489,瑞軒,321,204,117,元大-台南,2024-07-15,9896
00934,中信成長高股息,123,13,110,元大-台南,2024-07-15,9896
2867,三商壽,111,6,105,元大-台南,2024-07-15,9896
00933B,國泰10Y+金融債,114,10,104,元大-台南,2024-07-15,9896
8069,元太,96,1,95,元大-台南,2024-07-15,9896
1303,南亞,92,1,91,元大-台南,2024-07-15,9896
00929,復華台灣科技優息,97,7,90,元大-台南,2024-07-15,9896
2618,長榮航,112,22,90,元大-台南,2024-07-15,9896
1569,濱川,81,4,77,元大-台南,2024-07-15,9896
00665L,富邦�琤肭磪囓�2,73,0,73,元大-台南,2024-07-15,9896
2883,凱基金,108,35,73,元大-台南,2024-07-15,9896
00680L,元大美債20正2,95,26,69,元大-台南,2024-07-15,9896
0056,元大高股息,67,10,57,元大-台南,2024-07-15,9896
1785,光洋科,72,19,53,元大-台南,2024-07-15,9896
00673R,期元大S＆P原油反1,50,0,50,元大-台南,2024-07-15,9896
3712,永崴投控,58,9,49,元大-台南,2024-07-15,9896
2312,金寶,309,261,48,元大-台南,2024-07-15,9896
2409,友達,49,2,47,元大-台南,2024-07-15,9896
00687B,國泰20年美債,46,0,46,元大-台南,2024-07-15,9896
00632R,元大台灣50反1,74,30,44,元大-台南,2024-07-15,9896
3357,臺慶科,40,0,40,元大-台南,2024-07-15,9896
00919,群益台灣精選高息,65,26,39,元大-台南,2024-07-15,9896
00720B,元大投資級公司債,38,0,38,元大-台南,2024-07-15,9896
3520,華盈,57,21,36,元大-台南,2024-07-15,9896
00927,群益半導體收益,33,0,33,元大-台南,2024-07-15,9896
4953,緯軟,34,1,33,元大-台南,2024-07-15,9896
6612,奈米醫材,33,0,33,元大-台南,2024-07-15,9896
00752,中信中國50,34,1,33,元大-台南,2024-07-15,9896
8103,瀚荃,39,7,32,元大-台南,2024-07-15,9896
3141,晶宏,32,0,32,元大-台南,2024-07-15,9896
9945,潤泰新,39,7,32,元大-台南,2024-07-15,9896
00941,中信上游半導體,31,0,31,元大-台南,2024-07-15,9896
1563,巧新,51,21,30,元大-台南,2024-07-15,9896
6182,合晶,31,1,30,元大-台南,2024-07-15,9896
1709,和益,30,0,30,元大-台南,2024-07-15,9896
5230,雷笛克光學,34,5,29,元大-台南,2024-07-15,9896
1815,富喬,48,21,27,元大-台南,2024-07-15,9896
00679B,元大美債20年,48,21,27,元大-台南,2024-07-15,9896
00688L,國泰20年美債正2,27,0,27,元大-台南,2024-07-15,9896
1597,直得,47,21,26,元大-台南,2024-07-15,9896
4510,高鋒,26,0,26,元大-台南,2024-07-15,9896
2313,華通,30,4,26,元大-台南,2024-07-15,9896
3046,建��,25,0,25,元大-台南,2024-07-15,9896
6695,芯鼎,27,2,25,元大-台南,2024-07-15,9896
2353,宏��,27,3,24,元大-台南,2024-07-15,9896
00725B,國泰投資級公司債,36,12,24,元大-台南,2024-07-15,9896
00905,FT臺灣Smart,24,0,24,元大-台南,2024-07-15,9896
00937B,群益ESG投等債20,616,2,614,元大-台南,2024-07-16,9896
3035,智原,325,28,297,元大-台南,2024-07-16,9896
1314,中石化,200,7,193,元大-台南,2024-07-16,9896
2489,瑞軒,352,159,193,元大-台南,2024-07-16,9896
2888,新光金,338,146,192,元大-台南,2024-07-16,9896
00882,中信中國高股息,156,0,156,元大-台南,2024-07-16,9896
3481,群創,143,9,134,元大-台南,2024-07-16,9896
9945,潤泰新,131,10,121,元大-台南,2024-07-16,9896
9105,泰金寶-DR,125,7,118,元大-台南,2024-07-16,9896
0056,元大高股息,113,5,108,元大-台南,2024-07-16,9896
00919,群益台灣精選高息,128,21,107,元大-台南,2024-07-16,9896
00905,FT臺灣Smart,100,0,100,元大-台南,2024-07-16,9896
2891,中信金,71,3,68,元大-台南,2024-07-16,9896
00934,中信成長高股息,104,37,67,元大-台南,2024-07-16,9896
00881,國泰台灣5G+,73,7,66,元大-台南,2024-07-16,9896
2317,鴻海,73,12,61,元大-台南,2024-07-16,9896
2405,輔信,56,0,56,元大-台南,2024-07-16,9896
6658,聯策,49,0,49,元大-台南,2024-07-16,9896
3594,磐儀,50,2,48,元大-台南,2024-07-16,9896
2610,華航,63,17,46,元大-台南,2024-07-16,9896
2913,農林,46,7,39,元大-台南,2024-07-16,9896
6548,長科*,26,0,26,元大-台南,2024-07-16,9896
1608,華榮,30,5,25,元大-台南,2024-07-16,9896
6005,群益證,27,5,22,元大-台南,2024-07-16,9896
1312,國喬,24,2,22,元大-台南,2024-07-16,9896
4953,緯軟,23,1,22,元大-台南,2024-07-16,9896
2206,三陽工業,24,3,21,元大-台南,2024-07-16,9896
2379,瑞昱,21,0,21,元大-台南,2024-07-16,9896
3691,碩禾,21,0,21,元大-台南,2024-07-16,9896
9907,統一實,21,0,21,元大-台南,2024-07-16,9896
00650L,復華香港正2,26,5,21,元大-台南,2024-07-16,9896
2609,陽明,30,10,20,元大-台南,2024-07-16,9896
00947,台新臺灣IC設計,20,0,20,元大-台南,2024-07-16,9896
2834,臺企銀,20,0,20,元大-台南,2024-07-16,9896
00949,復華日本龍頭,20,1,19,元大-台南,2024-07-16,9896
00936,台新永續高息中小,27,9,18,元大-台南,2024-07-16,9896
6182,合晶,32,14,18,元大-台南,2024-07-16,9896
2478,大毅,18,0,18,元大-台南,2024-07-16,9896
2365,昆盈,34,17,17,元大-台南,2024-07-16,9896
5347,世界,18,2,16,元大-台南,2024-07-16,9896
4526,東台,33,17,16,元大-台南,2024-07-16,9896
2406,國碩,25,9,16,元大-台南,2024-07-16,9896
2382,廣達,20,4,16,元大-台南,2024-07-16,9896
1316,上曜,17,2,15,元大-台南,2024-07-16,9896
6684,安格,27,12,15,元大-台南,2024-07-16,9896
1440,南紡,23,8,15,元大-台南,2024-07-16,9896
1304,台聚,15,0,15,元大-台南,2024-07-16,9896
8473,山林水,18,3,15,元大-台南,2024-07-16,9896
2353,宏��,22,9,13,元大-台南,2024-07-16,9896
00942B,台新美A公司債20+,12,0,12,元大-台南,2024-07-16,9896
00929,復華台灣科技優息,289,6,283,元大-台南,2024-07-17,9896
00919,群益台灣精選高息,143,15,128,元大-台南,2024-07-17,9896
4906,正文,108,10,98,元大-台南,2024-07-17,9896
2303,聯電,142,50,92,元大-台南,2024-07-17,9896
00680L,元大美債20正2,133,48,85,元大-台南,2024-07-17,9896
2353,宏��,88,5,83,元大-台南,2024-07-17,9896
00937B,群益ESG投等債20,84,6,78,元大-台南,2024-07-17,9896
3231,緯創,83,12,71,元大-台南,2024-07-17,9896
0056,元大高股息,66,2,64,元大-台南,2024-07-17,9896
00882,中信中國高股息,65,1,64,元大-台南,2024-07-17,9896
00948B,中信優息投資級債,56,0,56,元大-台南,2024-07-17,9896
9945,潤泰新,92,37,55,元大-台南,2024-07-17,9896
6770,力積電,68,16,52,元大-台南,2024-07-17,9896
00936,台新永續高息中小,49,0,49,元大-台南,2024-07-17,9896
2618,長榮航,79,33,46,元大-台南,2024-07-17,9896
2401,凌陽,70,24,46,元大-台南,2024-07-17,9896
2330,台積電,62,18,44,元大-台南,2024-07-17,9896
00878,國泰永續高股息,43,1,42,元大-台南,2024-07-17,9896
3520,華盈,54,14,40,元大-台南,2024-07-17,9896
00946,群益科技高息成長,57,17,40,元大-台南,2024-07-17,9896
2382,廣達,38,1,37,元大-台南,2024-07-17,9896
00725B,國泰投資級公司債,36,0,36,元大-台南,2024-07-17,9896
00942B,台新美A公司債20+,35,0,35,元大-台南,2024-07-17,9896
00679B,元大美債20年,55,25,30,元大-台南,2024-07-17,9896
2495,普安,33,5,28,元大-台南,2024-07-17,9896
3294,英濟,36,8,28,元大-台南,2024-07-17,9896
00918,大華優利高填息30,28,0,28,元大-台南,2024-07-17,9896
2845,遠東銀,26,0,26,元大-台南,2024-07-17,9896
00934,中信成長高股息,29,3,26,元大-台南,2024-07-17,9896
00905,FT臺灣Smart,27,1,26,元大-台南,2024-07-17,9896
1471,首利,38,13,25,元大-台南,2024-07-17,9896
2367,燿華,22,0,22,元大-台南,2024-07-17,9896
2405,輔信,27,6,21,元大-台南,2024-07-17,9896
00885,富邦越南,21,0,21,元大-台南,2024-07-17,9896
2374,佳能,21,1,20,元大-台南,2024-07-17,9896
2515,中工,50,30,20,元大-台南,2024-07-17,9896
00650L,復華香港正2,20,0,20,元大-台南,2024-07-17,9896
00935,野村臺灣新科技50,18,0,18,元大-台南,2024-07-17,9896
00740B,富邦全球投等債,21,3,18,元大-台南,2024-07-17,9896
2511,太子,23,5,18,元大-台南,2024-07-17,9896
006208,富邦台50,17,0,17,元大-台南,2024-07-17,9896
3360,尚立,16,0,16,元大-台南,2024-07-17,9896
1815,富喬,28,12,16,元大-台南,2024-07-17,9896
2392,正崴,20,5,15,元大-台南,2024-07-17,9896
2449,京元電子,21,6,15,元大-台南,2024-07-17,9896
3019,亞光,31,16,15,元大-台南,2024-07-17,9896
00891,中信關鍵半導體,23,9,14,元大-台南,2024-07-17,9896
5876,上海商銀,14,0,14,元大-台南,2024-07-17,9896
4562,穎漢,15,2,13,元大-台南,2024-07-17,9896
2317,鴻海,79,67,12,元大-台南,2024-07-17,9896
00929,復華台灣科技優息,258,18,240,元大-台南,2024-07-18,9896
3035,智原,140,7,133,元大-台南,2024-07-18,9896
00946,群益科技高息成長,125,0,125,元大-台南,2024-07-18,9896
1301,台塑,133,9,124,元大-台南,2024-07-18,9896
2317,鴻海,125,27,98,元大-台南,2024-07-18,9896
00919,群益台灣精選高息,154,61,93,元大-台南,2024-07-18,9896
9907,統一實,83,0,83,元大-台南,2024-07-18,9896
00891,中信關鍵半導體,97,21,76,元大-台南,2024-07-18,9896
2888,新光金,126,50,76,元大-台南,2024-07-18,9896
00673R,期元大S＆P原油反1,66,0,66,元大-台南,2024-07-18,9896
0056,元大高股息,68,5,63,元大-台南,2024-07-18,9896
3231,緯創,75,19,56,元大-台南,2024-07-18,9896
00936,台新永續高息中小,62,7,55,元大-台南,2024-07-18,9896
00942B,台新美A公司債20+,65,12,53,元大-台南,2024-07-18,9896
00934,中信成長高股息,50,0,50,元大-台南,2024-07-18,9896
00923,群益台ESG低碳50,52,3,49,元大-台南,2024-07-18,9896
00881,國泰台灣5G+,59,12,47,元大-台南,2024-07-18,9896
2356,英業達,69,25,44,元大-台南,2024-07-18,9896
2313,華通,45,1,44,元大-台南,2024-07-18,9896
3691,碩禾,41,0,41,元大-台南,2024-07-18,9896
00927,群益半導體收益,38,0,38,元大-台南,2024-07-18,9896
00918,大華優利高填息30,49,11,38,元大-台南,2024-07-18,9896
00878,國泰永續高股息,89,55,34,元大-台南,2024-07-18,9896
2344,華邦電,35,2,33,元大-台南,2024-07-18,9896
6770,力積電,47,15,32,元大-台南,2024-07-18,9896
1402,遠東新,30,0,30,元大-台南,2024-07-18,9896
5475,德宏,30,0,30,元大-台南,2024-07-18,9896
00679B,元大美債20年,64,34,30,元大-台南,2024-07-18,9896
2382,廣達,45,16,29,元大-台南,2024-07-18,9896
8069,元太,28,0,28,元大-台南,2024-07-18,9896
00941,中信上游半導體,30,3,27,元大-台南,2024-07-18,9896
00949,復華日本龍頭,36,10,26,元大-台南,2024-07-18,9896
3037,欣興,39,15,24,元大-台南,2024-07-18,9896
2330,台積電,81,59,22,元大-台南,2024-07-18,9896
2401,凌陽,26,4,22,元大-台南,2024-07-18,9896
00935,野村臺灣新科技50,22,0,22,元大-台南,2024-07-18,9896
2881,富邦金,36,14,22,元大-台南,2024-07-18,9896
00948B,中信優息投資級債,21,0,21,元大-台南,2024-07-18,9896
1308,亞聚,38,17,21,元大-台南,2024-07-18,9896
00905,FT臺灣Smart,23,3,20,元大-台南,2024-07-18,9896
2618,長榮航,40,20,20,元大-台南,2024-07-18,9896
0055,元大MSCI金融,20,0,20,元大-台南,2024-07-18,9896
006208,富邦台50,19,0,19,元大-台南,2024-07-18,9896
2891,中信金,28,9,19,元大-台南,2024-07-18,9896
4526,東台,27,8,19,元大-台南,2024-07-18,9896
8016,矽創,20,1,19,元大-台南,2024-07-18,9896
2449,京元電子,42,24,18,元大-台南,2024-07-18,9896
3715,定穎投控,18,0,18,元大-台南,2024-07-18,9896
3163,波若威,55,38,17,元大-台南,2024-07-18,9896
4903,聯光通,18,2,16,元大-台南,2024-07-18,9896
00937B,群益ESG投等債20,267,23,244,元大-台南,2024-07-19,9896
2002,中鋼,216,0,216,元大-台南,2024-07-19,9896
00671R,富邦NASDAQ反1,200,0,200,元大-台南,2024-07-19,9896
00918,大華優利高填息30,203,52,151,元大-台南,2024-07-19,9896
00878,國泰永續高股息,158,13,145,元大-台南,2024-07-19,9896
00919,群益台灣精選高息,172,28,144,元大-台南,2024-07-19,9896
00929,復華台灣科技優息,243,107,136,元大-台南,2024-07-19,9896
00934,中信成長高股息,126,11,115,元大-台南,2024-07-19,9896
2537,聯上發,110,7,103,元大-台南,2024-07-19,9896
2605,新興,101,2,99,元大-台南,2024-07-19,9896
5880,合庫金,118,21,97,元大-台南,2024-07-19,9896
2891,中信金,105,12,93,元大-台南,2024-07-19,9896
6142,友勁,88,0,88,元大-台南,2024-07-19,9896
2330,台積電,102,37,65,元大-台南,2024-07-19,9896
00936,台新永續高息中小,75,13,62,元大-台南,2024-07-19,9896
6182,合晶,60,0,60,元大-台南,2024-07-19,9896
00905,FT臺灣Smart,55,1,54,元大-台南,2024-07-19,9896
00891,中信關鍵半導體,51,0,51,元大-台南,2024-07-19,9896
00713,元大台灣高息低波,48,6,42,元大-台南,2024-07-19,9896
00949,復華日本龍頭,42,0,42,元大-台南,2024-07-19,9896
1785,光洋科,64,23,41,元大-台南,2024-07-19,9896
2812,台中銀,41,0,41,元大-台南,2024-07-19,9896
0056,元大高股息,94,56,38,元大-台南,2024-07-19,9896
2882,國泰金,42,8,34,元大-台南,2024-07-19,9896
00927,群益半導體收益,35,1,34,元大-台南,2024-07-19,9896
00881,國泰台灣5G+,51,17,34,元大-台南,2024-07-19,9896
1617,榮星,32,0,32,元大-台南,2024-07-19,9896
2618,長榮航,44,13,31,元大-台南,2024-07-19,9896
00752,中信中國50,30,0,30,元大-台南,2024-07-19,9896
2867,三商壽,48,19,29,元大-台南,2024-07-19,9896
3037,欣興,51,22,29,元大-台南,2024-07-19,9896
2887,台新金,30,1,29,元大-台南,2024-07-19,9896
4903,聯光通,34,6,28,元大-台南,2024-07-19,9896
4967,十銓,29,2,27,元大-台南,2024-07-19,9896
3481,群創,97,70,27,元大-台南,2024-07-19,9896
00665L,富邦�琤肭磪囓�2,31,4,27,元大-台南,2024-07-19,9896
2834,臺企銀,35,8,27,元大-台南,2024-07-19,9896
2419,仲琦,72,45,27,元大-台南,2024-07-19,9896
1312,國喬,46,20,26,元大-台南,2024-07-19,9896
1709,和益,111,85,26,元大-台南,2024-07-19,9896
00946,群益科技高息成長,43,18,25,元大-台南,2024-07-19,9896
2885,元大金,35,11,24,元大-台南,2024-07-19,9896
00882,中信中國高股息,25,2,23,元大-台南,2024-07-19,9896
00947,台新臺灣IC設計,22,1,21,元大-台南,2024-07-19,9896
2801,彰銀,21,0,21,元大-台南,2024-07-19,9896
6168,宏齊,21,0,21,元大-台南,2024-07-19,9896
6770,力積電,29,9,20,元大-台南,2024-07-19,9896
1718,中纖,20,0,20,元大-台南,2024-07-19,9896
4183,福永生技,20,0,20,元大-台南,2024-07-19,9896
0055,元大MSCI金融,20,0,20,元大-台南,2024-07-19,9896
00929,復華台灣科技優息,1122,120,1002,元大-台南,2024-07-22,9896
00940,元大台灣價值高息,842,72,770,元大-台南,2024-07-22,9896
3481,群創,849,667,182,元大-台南,2024-07-22,9896
00919,群益台灣精選高息,320,142,178,元大-台南,2024-07-22,9896
00918,大華優利高填息30,179,20,159,元大-台南,2024-07-22,9896
2409,友達,162,11,151,元大-台南,2024-07-22,9896
00878,國泰永續高股息,194,85,109,元大-台南,2024-07-22,9896
2303,聯電,169,87,82,元大-台南,2024-07-22,9896
2431,聯昌,67,0,67,元大-台南,2024-07-22,9896
00891,中信關鍵半導體,55,0,55,元大-台南,2024-07-22,9896
00936,台新永續高息中小,68,14,54,元大-台南,2024-07-22,9896
00946,群益科技高息成長,57,5,52,元大-台南,2024-07-22,9896
0055,元大MSCI金融,50,0,50,元大-台南,2024-07-22,9896
00935,野村臺灣新科技50,51,7,44,元大-台南,2024-07-22,9896
00751B,元大AAA至A公司債,50,7,43,元大-台南,2024-07-22,9896
00939,統一台灣高息動能,60,24,36,元大-台南,2024-07-22,9896
00947,台新臺灣IC設計,34,0,34,元大-台南,2024-07-22,9896
9105,泰金寶-DR,48,15,33,元大-台南,2024-07-22,9896
5880,合庫金,35,5,30,元大-台南,2024-07-22,9896
00927,群益半導體收益,30,0,30,元大-台南,2024-07-22,9896
2888,新光金,88,59,29,元大-台南,2024-07-22,9896
00905,FT臺灣Smart,34,5,29,元大-台南,2024-07-22,9896
00881,國泰台灣5G+,51,24,27,元大-台南,2024-07-22,9896
2891,中信金,33,6,27,元大-台南,2024-07-22,9896
8473,山林水,109,83,26,元大-台南,2024-07-22,9896
2731,雄獅,26,0,26,元大-台南,2024-07-22,9896
2867,三商壽,41,16,25,元大-台南,2024-07-22,9896
9945,潤泰新,43,20,23,元大-台南,2024-07-22,9896
0056,元大高股息,112,89,23,元大-台南,2024-07-22,9896
2618,長榮航,52,29,23,元大-台南,2024-07-22,9896
1440,南紡,25,3,22,元大-台南,2024-07-22,9896
2337,旺宏,22,0,22,元大-台南,2024-07-22,9896
8069,元太,23,2,21,元大-台南,2024-07-22,9896
5488,松普,20,0,20,元大-台南,2024-07-22,9896
0050,元大台灣50,26,6,20,元大-台南,2024-07-22,9896
2603,長榮,30,10,20,元大-台南,2024-07-22,9896
4991,環宇-KY,23,4,19,元大-台南,2024-07-22,9896
2442,新美齊,20,1,19,元大-台南,2024-07-22,9896
2812,台中銀,19,0,19,元大-台南,2024-07-22,9896
2489,瑞軒,20,2,18,元大-台南,2024-07-22,9896
2408,南亞科,20,2,18,元大-台南,2024-07-22,9896
2352,佳世達,17,1,16,元大-台南,2024-07-22,9896
2607,榮運,16,0,16,元大-台南,2024-07-22,9896
3081,聯亞,16,0,16,元大-台南,2024-07-22,9896
1709,和益,18,3,15,元大-台南,2024-07-22,9896
2392,正崴,18,3,15,元大-台南,2024-07-22,9896
5234,達興材料,15,0,15,元大-台南,2024-07-22,9896
6142,友勁,20,6,14,元大-台南,2024-07-22,9896
3231,緯創,37,23,14,元大-台南,2024-07-22,9896
3260,威剛,29,16,13,元大-台南,2024-07-22,9896
00946,群益科技高息成長,353,7,346,元大-台南,2024-07-23,9896
00632R,元大台灣50反1,750,463,287,元大-台南,2024-07-23,9896
00919,群益台灣精選高息,187,6,181,元大-台南,2024-07-23,9896
00937B,群益ESG投等債20,152,3,149,元大-台南,2024-07-23,9896
6177,達麗,151,6,145,元大-台南,2024-07-23,9896
00929,復華台灣科技優息,151,31,120,元大-台南,2024-07-23,9896
00881,國泰台灣5G+,108,1,107,元大-台南,2024-07-23,9896
3481,群創,279,176,103,元大-台南,2024-07-23,9896
2834,臺企銀,85,6,79,元大-台南,2024-07-23,9896
00940,元大台灣價值高息,156,78,78,元大-台南,2024-07-23,9896
00878,國泰永續高股息,79,9,70,元大-台南,2024-07-23,9896
2103,台橡,50,0,50,元大-台南,2024-07-23,9896
2489,瑞軒,65,19,46,元大-台南,2024-07-23,9896
1440,南紡,44,0,44,元大-台南,2024-07-23,9896
2409,友達,54,13,41,元大-台南,2024-07-23,9896
00706L,期元大S＆P日圓正2,41,0,41,元大-台南,2024-07-23,9896
2515,中工,61,20,41,元大-台南,2024-07-23,9896
2888,新光金,55,15,40,元大-台南,2024-07-23,9896
2477,美隆電,40,0,40,元大-台南,2024-07-23,9896
3663,鑫科,64,26,38,元大-台南,2024-07-23,9896
4953,緯軟,38,1,37,元大-台南,2024-07-23,9896
4916,事欣科,51,17,34,元大-台南,2024-07-23,9896
0056,元大高股息,44,11,33,元大-台南,2024-07-23,9896
2605,新興,31,1,30,元大-台南,2024-07-23,9896
00931B,統一美債20年,31,2,29,元大-台南,2024-07-23,9896
9945,潤泰新,62,34,28,元大-台南,2024-07-23,9896
4991,環宇-KY,26,0,26,元大-台南,2024-07-23,9896
2414,精技,24,0,24,元大-台南,2024-07-23,9896
2365,昆盈,54,31,23,元大-台南,2024-07-23,9896
2408,南亞科,23,1,22,元大-台南,2024-07-23,9896
2379,瑞昱,24,3,21,元大-台南,2024-07-23,9896
00950B,凱基A級公司債,20,0,20,元大-台南,2024-07-23,9896
3494,誠研,20,0,20,元大-台南,2024-07-23,9896
00934,中信成長高股息,27,8,19,元大-台南,2024-07-23,9896
8033,雷虎,21,3,18,元大-台南,2024-07-23,9896
6477,安集,19,1,18,元大-台南,2024-07-23,9896
8905,裕國,17,0,17,元大-台南,2024-07-23,9896
2867,三商壽,35,18,17,元大-台南,2024-07-23,9896
00923,群益台ESG低碳50,20,4,16,元大-台南,2024-07-23,9896
3013,晟銘電,29,14,15,元大-台南,2024-07-23,9896
1447,力鵬,15,0,15,元大-台南,2024-07-23,9896
4979,華星光,15,0,15,元大-台南,2024-07-23,9896
3576,聯合再生,22,8,14,元大-台南,2024-07-23,9896
8105,凌巨,17,3,14,元大-台南,2024-07-23,9896
2329,華泰,16,3,13,元大-台南,2024-07-23,9896
2368,金像電,13,0,13,元大-台南,2024-07-23,9896
3048,益登,13,0,13,元大-台南,2024-07-23,9896
2548,華固,20,7,13,元大-台南,2024-07-23,9896
8054,安國,23,10,13,元大-台南,2024-07-23,9896
3163,波若威,19,7,12,元大-台南,2024-07-23,9896
00650L,復華香港正2,926,225,701,元大-台南,2024-07-26,9896
00929,復華台灣科技優息,460,65,395,元大-台南,2024-07-26,9896
00919,群益台灣精選高息,258,70,188,元大-台南,2024-07-26,9896
00937B,群益ESG投等債20,250,65,185,元大-台南,2024-07-26,9896
00947,台新臺灣IC設計,170,2,168,元大-台南,2024-07-26,9896
00940,元大台灣價值高息,408,280,128,元大-台南,2024-07-26,9896
2337,旺宏,117,1,116,元大-台南,2024-07-26,9896
0056,元大高股息,162,53,109,元大-台南,2024-07-26,9896
00878,國泰永續高股息,114,11,103,元大-台南,2024-07-26,9896
00946,群益科技高息成長,107,5,102,元大-台南,2024-07-26,9896
00918,大華優利高填息30,109,50,59,元大-台南,2024-07-26,9896
2330,台積電,91,33,58,元大-台南,2024-07-26,9896
2002,中鋼,68,10,58,元大-台南,2024-07-26,9896
2317,鴻海,100,44,56,元大-台南,2024-07-26,9896
006208,富邦台50,56,1,55,元大-台南,2024-07-26,9896
00936,台新永續高息中小,68,13,55,元大-台南,2024-07-26,9896
00713,元大台灣高息低波,55,2,53,元大-台南,2024-07-26,9896
00665L,富邦�琤肭磪囓�2,62,13,49,元大-台南,2024-07-26,9896
2884,玉山金,47,1,46,元大-台南,2024-07-26,9896
2349,錸德,62,19,43,元大-台南,2024-07-26,9896
2356,英業達,47,6,41,元大-台南,2024-07-26,9896
00891,中信關鍵半導體,40,0,40,元大-台南,2024-07-26,9896
2352,佳世達,40,3,37,元大-台南,2024-07-26,9896
2888,新光金,49,13,36,元大-台南,2024-07-26,9896
00712,復華富時不動產,90,55,35,元大-台南,2024-07-26,9896
2382,廣達,42,8,34,元大-台南,2024-07-26,9896
1314,中石化,34,5,29,元大-台南,2024-07-26,9896
00949,復華日本龍頭,29,0,29,元大-台南,2024-07-26,9896
2409,友達,31,4,27,元大-台南,2024-07-26,9896
5880,合庫金,30,4,26,元大-台南,2024-07-26,9896
5234,達興材料,27,2,25,元大-台南,2024-07-26,9896
00881,國泰台灣5G+,27,1,26,元大-台南,2024-07-26,9896
00882,中信中國高股息,31,6,25,元大-台南,2024-07-26,9896
00941,中信上游半導體,24,0,24,元大-台南,2024-07-26,9896
00915,凱基優選高股息30,35,12,23,元大-台南,2024-07-26,9896
00948B,中信優息投資級債,22,0,22,元大-台南,2024-07-26,9896
8071,能率網通,21,0,21,元大-台南,2024-07-26,9896
3703,欣陸,20,1,19,元大-台南,2024-07-26,9896
00679B,元大美債20年,74,55,19,元大-台南,2024-07-26,9896
00934,中信成長高股息,42,24,18,元大-台南,2024-07-26,9896
00935,野村臺灣新科技50,19,1,18,元大-台南,2024-07-26,9896
3167,大量,18,0,18,元大-台南,2024-07-26,9896
00715L,期街口布蘭特正2,17,0,17,元大-台南,2024-07-26,9896
3711,日月光投控,16,0,16,元大-台南,2024-07-26,9896
00680L,元大美債20正2,16,0,16,元大-台南,2024-07-26,9896
00757,統一FANG+,16,0,16,元大-台南,2024-07-26,9896
3231,緯創,42,27,15,元大-台南,2024-07-26,9896
00631L,元大台灣50正2,15,0,15,元大-台南,2024-07-26,9896
00687B,國泰20年美債,43,30,13,元大-台南,2024-07-26,9896
00927,群益半導體收益,20,7,13,元大-台南,2024-07-26,9896
00940,元大台灣價值高息,373,126,247,元大-台南,2024-07-29,9896
00919,群益台灣精選高息,236,15,221,元大-台南,2024-07-29,9896
0056,元大高股息,193,7,186,元大-台南,2024-07-29,9896
00706L,期元大S＆P日圓正2,117,0,117,元大-台南,2024-07-29,9896
00878,國泰永續高股息,121,14,107,元大-台南,2024-07-29,9896
2409,友達,104,4,100,元大-台南,2024-07-29,9896
1617,榮星,73,0,73,元大-台南,2024-07-29,9896
00946,群益科技高息成長,70,7,63,元大-台南,2024-07-29,9896
6177,達麗,52,2,50,元大-台南,2024-07-29,9896
2888,新光金,60,13,47,元大-台南,2024-07-29,9896
4916,事欣科,45,5,40,元大-台南,2024-07-29,9896
00715L,期街口布蘭特正2,40,1,39,元大-台南,2024-07-29,9896
2356,英業達,58,20,38,元大-台南,2024-07-29,9896
2609,陽明,72,37,35,元大-台南,2024-07-29,9896
3481,群創,79,47,32,元大-台南,2024-07-29,9896
2884,玉山金,38,6,32,元大-台南,2024-07-29,9896
00945B,凱基美國非投等債,32,0,32,元大-台南,2024-07-29,9896
2324,仁寶,34,3,31,元大-台南,2024-07-29,9896
00713,元大台灣高息低波,36,5,31,元大-台南,2024-07-29,9896
1802,台玻,40,11,29,元大-台南,2024-07-29,9896
00918,大華優利高填息30,33,4,29,元大-台南,2024-07-29,9896
6142,友勁,115,87,28,元大-台南,2024-07-29,9896
3663,鑫科,61,34,27,元大-台南,2024-07-29,9896
2845,遠東銀,24,0,24,元大-台南,2024-07-29,9896
1101,台泥,31,7,24,元大-台南,2024-07-29,9896
00934,中信成長高股息,38,17,21,元大-台南,2024-07-29,9896
6806,森崴能源,24,3,21,元大-台南,2024-07-29,9896
3035,智原,23,3,20,元大-台南,2024-07-29,9896
4128,中天,24,4,20,元大-台南,2024-07-29,9896
5880,合庫金,20,0,20,元大-台南,2024-07-29,9896
2002,中鋼,20,1,19,元大-台南,2024-07-29,9896
2515,中工,93,74,19,元大-台南,2024-07-29,9896
3167,大量,19,0,19,元大-台南,2024-07-29,9896
2897,王道銀行,21,2,19,元大-台南,2024-07-29,9896
00891,中信關鍵半導體,19,0,19,元大-台南,2024-07-29,9896
6168,宏齊,18,0,18,元大-台南,2024-07-29,9896
9105,泰金寶-DR,21,3,18,元大-台南,2024-07-29,9896
1609,大亞,19,3,16,元大-台南,2024-07-29,9896
6152,百一,17,2,15,元大-台南,2024-07-29,9896
4743,合一,23,8,15,元大-台南,2024-07-29,9896
00915,凱基優選高股息30,24,10,14,元大-台南,2024-07-29,9896
2313,華通,16,2,14,元大-台南,2024-07-29,9896
4968,立積,14,0,14,元大-台南,2024-07-29,9896
2401,凌陽,15,2,13,元大-台南,2024-07-29,9896
8086,宏捷科,13,0,13,元大-台南,2024-07-29,9896
2382,廣達,48,35,13,元大-台南,2024-07-29,9896
6431,光麗-KY,12,0,12,元大-台南,2024-07-29,9896
2338,光罩,12,0,12,元大-台南,2024-07-29,9896
3576,聯合再生,12,0,12,元大-台南,2024-07-29,9896
2376,技嘉,13,1,12,元大-台南,2024-07-29,9896
00940,元大台灣價值高息,441,63,378,元大-台南,2024-07-30,9896
2884,玉山金,128,8,120,元大-台南,2024-07-30,9896
00937B,群益ESG投等債20,166,56,110,元大-台南,2024-07-30,9896
00929,復華台灣科技優息,242,135,107,元大-台南,2024-07-30,9896
00948B,中信優息投資級債,105,0,105,元大-台南,2024-07-30,9896
4564,元翎,107,4,103,元大-台南,2024-07-30,9896
6806,森崴能源,117,18,99,元大-台南,2024-07-30,9896
00632R,元大台灣50反1,358,263,95,元大-台南,2024-07-30,9896
00946,群益科技高息成長,109,15,94,元大-台南,2024-07-30,9896
00919,群益台灣精選高息,98,12,86,元大-台南,2024-07-30,9896
00878,國泰永續高股息,146,73,73,元大-台南,2024-07-30,9896
0056,元大高股息,94,29,65,元大-台南,2024-07-30,9896
00751B,元大AAA至A公司債,75,11,64,元大-台南,2024-07-30,9896
00687B,國泰20年美債,64,3,61,元大-台南,2024-07-30,9896
2891,中信金,101,47,54,元大-台南,2024-07-30,9896
2603,長榮,57,3,54,元大-台南,2024-07-30,9896
00738U,期元大道瓊白銀,51,0,51,元大-台南,2024-07-30,9896
00942B,台新美A公司債20+,50,0,50,元大-台南,2024-07-30,9896
00939,統一台灣高息動能,42,0,42,元大-台南,2024-07-30,9896
00688L,國泰20年美債正2,40,0,40,元大-台南,2024-07-30,9896
00915,凱基優選高股息30,41,2,39,元大-台南,2024-07-30,9896
00679B,元大美債20年,36,2,34,元大-台南,2024-07-30,9896
00715L,期街口布蘭特正2,36,5,31,元大-台南,2024-07-30,9896
2303,聯電,67,38,29,元大-台南,2024-07-30,9896
00713,元大台灣高息低波,32,4,28,元大-台南,2024-07-30,9896
00936,台新永續高息中小,29,2,27,元大-台南,2024-07-30,9896
00712,復華富時不動產,25,2,23,元大-台南,2024-07-30,9896
5880,合庫金,23,0,23,元大-台南,2024-07-30,9896
2344,華邦電,23,1,22,元大-台南,2024-07-30,9896
3260,威剛,29,7,22,元大-台南,2024-07-30,9896
2409,友達,25,4,21,元大-台南,2024-07-30,9896
2881,富邦金,28,7,21,元大-台南,2024-07-30,9896
6488,環球晶,20,0,20,元大-台南,2024-07-30,9896
2313,華通,21,2,19,元大-台南,2024-07-30,9896
00934,中信成長高股息,58,40,18,元大-台南,2024-07-30,9896
2845,遠東銀,18,0,18,元大-台南,2024-07-30,9896
00947,台新臺灣IC設計,17,0,17,元大-台南,2024-07-30,9896
00882,中信中國高股息,16,0,16,元大-台南,2024-07-30,9896
3706,神達,21,5,16,元大-台南,2024-07-30,9896
2882,國泰金,28,13,15,元大-台南,2024-07-30,9896
00680L,元大美債20正2,15,0,15,元大-台南,2024-07-30,9896
00795B,中信美國公債20年,15,0,15,元大-台南,2024-07-30,9896
1605,華新,18,4,14,元大-台南,2024-07-30,9896
2365,昆盈,20,6,14,元大-台南,2024-07-30,9896
00930,永豐ESG低碳高息,14,0,14,元大-台南,2024-07-30,9896
00941,中信上游半導體,14,0,14,元大-台南,2024-07-30,9896
8105,凌巨,16,2,14,元大-台南,2024-07-30,9896
00650L,復華香港正2,14,0,14,元大-台南,2024-07-30,9896
006208,富邦台50,13,0,13,元大-台南,2024-07-30,9896
3105,穩懋,15,3,12,元大-台南,2024-07-30,9896
00680L,元大美債20正2,341,8,333,元大-台南,2024-07-31,9896
2610,華航,250,10,240,元大-台南,2024-07-31,9896
00919,群益台灣精選高息,175,26,149,元大-台南,2024-07-31,9896
00929,復華台灣科技優息,131,13,118,元大-台南,2024-07-31,9896
00937B,群益ESG投等債20,116,2,114,元大-台南,2024-07-31,9896
00940,元大台灣價值高息,171,61,110,元大-台南,2024-07-31,9896
2027,大成鋼,108,1,107,元大-台南,2024-07-31,9896
2867,三商壽,74,0,74,元大-台南,2024-07-31,9896
3481,群創,183,121,62,元大-台南,2024-07-31,9896
2312,金寶,112,53,59,元大-台南,2024-07-31,9896
00687B,國泰20年美債,54,1,53,元大-台南,2024-07-31,9896
00942B,台新美A公司債20+,50,0,50,元大-台南,2024-07-31,9896
00878,國泰永續高股息,55,10,45,元大-台南,2024-07-31,9896
2061,風青,40,3,37,元大-台南,2024-07-31,9896
0056,元大高股息,36,6,30,元大-台南,2024-07-31,9896
00946,群益科技高息成長,40,10,30,元大-台南,2024-07-31,9896
1721,三晃,23,0,23,元大-台南,2024-07-31,9896
1101,台泥,22,0,22,元大-台南,2024-07-31,9896
3037,欣興,34,14,20,元大-台南,2024-07-31,9896
00945B,凱基美國非投等債,19,0,19,元大-台南,2024-07-31,9896
2330,台積電,30,12,18,元大-台南,2024-07-31,9896
2070,精湛,21,3,18,元大-台南,2024-07-31,9896
3105,穩懋,23,6,17,元大-台南,2024-07-31,9896
2382,廣達,20,4,16,元大-台南,2024-07-31,9896
2464,盟立,35,19,16,元大-台南,2024-07-31,9896
2431,聯昌,25,9,16,元大-台南,2024-07-31,9896
00724B,群益投資級金融債,16,0,16,元大-台南,2024-07-31,9896
2884,玉山金,18,3,15,元大-台南,2024-07-31,9896
00948B,中信優息投資級債,15,0,15,元大-台南,2024-07-31,9896
3711,日月光投控,17,3,14,元大-台南,2024-07-31,9896
3050,鈺德,19,5,14,元大-台南,2024-07-31,9896
00706L,期元大S＆P日圓正2,18,4,14,元大-台南,2024-07-31,9896
3703,欣陸,18,4,14,元大-台南,2024-07-31,9896
5392,能率,13,0,13,元大-台南,2024-07-31,9896
1513,中興電,13,0,13,元大-台南,2024-07-31,9896
1605,華新,14,1,13,元大-台南,2024-07-31,9896
1319,東陽,16,4,12,元大-台南,2024-07-31,9896
2365,昆盈,27,15,12,元大-台南,2024-07-31,9896
00934,中信成長高股息,15,3,12,元大-台南,2024-07-31,9896
6548,長科*,11,0,11,元大-台南,2024-07-31,9896
3715,定穎投控,31,20,11,元大-台南,2024-07-31,9896
2891,中信金,28,17,11,元大-台南,2024-07-31,9896
2020,美亞,10,0,10,元大-台南,2024-07-31,9896
6282,康舒,10,0,10,元大-台南,2024-07-31,9896
2406,國碩,11,1,10,元大-台南,2024-07-31,9896
00947,台新臺灣IC設計,10,0,10,元大-台南,2024-07-31,9896
8271,宇瞻,10,0,10,元大-台南,2024-07-31,9896
3231,緯創,13,3,10,元大-台南,2024-07-31,9896
2489,瑞軒,10,1,9,元大-台南,2024-07-31,9896
5508,永信建,23,14,9,元大-台南,2024-07-31,9896
00679B,元大美債20年,155,38,117,元大-台南,2024-08-01,9896
00878,國泰永續高股息,117,8,109,元大-台南,2024-08-01,9896
2337,旺宏,151,61,90,元大-台南,2024-08-01,9896
00712,復華富時不動產,76,19,57,元大-台南,2024-08-01,9896
2515,中工,170,114,56,元大-台南,2024-08-01,9896
00942B,台新美A公司債20+,40,0,40,元大-台南,2024-08-01,9896
2409,友達,35,1,34,元大-台南,2024-08-01,9896
2417,圓剛,37,3,34,元大-台南,2024-08-01,9896
2609,陽明,69,37,32,元大-台南,2024-08-01,9896
3481,群創,54,28,26,元大-台南,2024-08-01,9896
3535,晶彩科,36,10,26,元大-台南,2024-08-01,9896
00919,群益台灣精選高息,31,9,22,元大-台南,2024-08-01,9896
00931B,統一美債20年,34,12,22,元大-台南,2024-08-01,9896
2061,風青,24,2,22,元大-台南,2024-08-01,9896
1722,台肥,22,0,22,元大-台南,2024-08-01,9896
00918,大華優利高填息30,40,19,21,元大-台南,2024-08-01,9896
8028,昇陽半導體,24,4,20,元大-台南,2024-08-01,9896
2405,輔信,19,0,19,元大-台南,2024-08-01,9896
2363,矽統,61,43,18,元大-台南,2024-08-01,9896
00945B,凱基美國非投等債,23,5,18,元大-台南,2024-08-01,9896
00881,國泰台灣5G+,17,0,17,元大-台南,2024-08-01,9896
2501,國建,27,10,17,元大-台南,2024-08-01,9896
6147,頎邦,15,0,15,元大-台南,2024-08-01,9896
0050,元大台灣50,17,2,15,元大-台南,2024-08-01,9896
3715,定穎投控,22,8,14,元大-台南,2024-08-01,9896
2884,玉山金,15,1,14,元大-台南,2024-08-01,9896
2887,台新金,14,0,14,元大-台南,2024-08-01,9896
00935,野村臺灣新科技50,14,0,14,元大-台南,2024-08-01,9896
2379,瑞昱,15,1,14,元大-台南,2024-08-01,9896
00891,中信關鍵半導體,16,3,13,元大-台南,2024-08-01,9896
00687B,國泰20年美債,19,7,12,元大-台南,2024-08-01,9896
2402,毅嘉,13,1,12,元大-台南,2024-08-01,9896
1210,大成,11,0,11,元大-台南,2024-08-01,9896
2408,南亞科,11,0,11,元大-台南,2024-08-01,9896
1216,統一,15,4,11,元大-台南,2024-08-01,9896
00632R,元大台灣50反1,132,122,10,元大-台南,2024-08-01,9896
2464,盟立,61,51,10,元大-台南,2024-08-01,9896
00753L,中信中國50正2,10,0,10,元大-台南,2024-08-01,9896
00722B,群益投資級電信債,10,0,10,元大-台南,2024-08-01,9896
00650L,復華香港正2,23,13,10,元大-台南,2024-08-01,9896
6603,富強鑫,11,2,9,元大-台南,2024-08-01,9896
2520,冠德,17,8,9,元大-台南,2024-08-01,9896
2014,中鴻,10,1,9,元大-台南,2024-08-01,9896
00928,中信上櫃ESG30,9,0,9,元大-台南,2024-08-01,9896
6187,萬潤,13,4,9,元大-台南,2024-08-01,9896
2633,台灣高鐵,9,0,9,元大-台南,2024-08-01,9896
2886,兆豐金,9,0,9,元大-台南,2024-08-01,9896
00725B,國泰投資級公司債,8,0,8,元大-台南,2024-08-01,9896
00949,復華日本龍頭,8,0,8,元大-台南,2024-08-01,9896
00795B,中信美國公債20年,9,1,8,元大-台南,2024-08-01,9896
00878,國泰永續高股息,465,10,455,元大-台南,2024-08-02,9896
00940,元大台灣價值高息,459,42,417,元大-台南,2024-08-02,9896
00929,復華台灣科技優息,843,545,298,元大-台南,2024-08-02,9896
00919,群益台灣精選高息,299,24,275,元大-台南,2024-08-02,9896
00687B,國泰20年美債,193,16,177,元大-台南,2024-08-02,9896
00947,台新臺灣IC設計,145,2,143,元大-台南,2024-08-02,9896
2317,鴻海,268,130,138,元大-台南,2024-08-02,9896
00951,台新日本半導體,127,0,127,元大-台南,2024-08-02,9896
2337,旺宏,133,7,126,元大-台南,2024-08-02,9896
2891,中信金,122,14,108,元大-台南,2024-08-02,9896
00679B,元大美債20年,178,73,105,元大-台南,2024-08-02,9896
00881,國泰台灣5G+,85,1,84,元大-台南,2024-08-02,9896
2330,台積電,84,7,77,元大-台南,2024-08-02,9896
00891,中信關鍵半導體,74,3,71,元大-台南,2024-08-02,9896
00946,群益科技高息成長,88,19,69,元大-台南,2024-08-02,9896
00680L,元大美債20正2,70,13,57,元大-台南,2024-08-02,9896
00637L,元大滬深300正2,53,2,51,元大-台南,2024-08-02,9896
00927,群益半導體收益,50,0,50,元大-台南,2024-08-02,9896
00948B,中信優息投資級債,62,12,50,元大-台南,2024-08-02,9896
00942B,台新美A公司債20+,50,0,50,元大-台南,2024-08-02,9896
00665L,富邦�琤肭磪囓�2,50,0,50,元大-台南,2024-08-02,9896
2515,中工,98,49,49,元大-台南,2024-08-02,9896
00941,中信上游半導體,48,1,47,元大-台南,2024-08-02,9896
00712,復華富時不動產,148,102,46,元大-台南,2024-08-02,9896
00936,台新永續高息中小,41,1,40,元大-台南,2024-08-02,9896
5905,南仁湖,65,25,40,元大-台南,2024-08-02,9896
00688L,國泰20年美債正2,42,2,40,元大-台南,2024-08-02,9896
2382,廣達,48,8,40,元大-台南,2024-08-02,9896
2801,彰銀,39,0,39,元大-台南,2024-08-02,9896
2609,陽明,98,59,39,元大-台南,2024-08-02,9896
3037,欣興,48,10,38,元大-台南,2024-08-02,9896
006208,富邦台50,38,0,38,元大-台南,2024-08-02,9896
0056,元大高股息,91,55,36,元大-台南,2024-08-02,9896
2313,華通,38,3,35,元大-台南,2024-08-02,9896
1609,大亞,50,15,35,元大-台南,2024-08-02,9896
00885,富邦越南,34,0,34,元大-台南,2024-08-02,9896
2365,昆盈,180,146,34,元大-台南,2024-08-02,9896
1605,華新,33,0,33,元大-台南,2024-08-02,9896
1440,南紡,33,0,33,元大-台南,2024-08-02,9896
6213,聯茂,37,5,32,元大-台南,2024-08-02,9896
00949,復華日本龍頭,33,1,32,元大-台南,2024-08-02,9896
3703,欣陸,36,4,32,元大-台南,2024-08-02,9896
3024,憶聲,35,4,31,元大-台南,2024-08-02,9896
5009,榮剛,31,0,31,元大-台南,2024-08-02,9896
2027,大成鋼,46,15,31,元大-台南,2024-08-02,9896
00905,FT臺灣Smart,30,0,30,元大-台南,2024-08-02,9896
00923,群益台ESG低碳50,30,0,30,元大-台南,2024-08-02,9896
1316,上曜,205,175,30,元大-台南,2024-08-02,9896
2881,富邦金,35,6,29,元大-台南,2024-08-02,9896
00931B,統一美債20年,46,18,28,元大-台南,2024-08-02,9896
00940,元大台灣價值高息,1746,140,1606,元大-台南,2024-08-05,9896
00929,復華台灣科技優息,998,225,773,元大-台南,2024-08-05,9896
2002,中鋼,575,11,564,元大-台南,2024-08-05,9896
2883,凱基金,578,127,451,元大-台南,2024-08-05,9896
00664R,國泰臺灣加權反1,400,30,370,元大-台南,2024-08-05,9896
00919,群益台灣精選高息,442,90,352,元大-台南,2024-08-05,9896
00878,國泰永續高股息,514,195,319,元大-台南,2024-08-05,9896
00934,中信成長高股息,271,20,251,元大-台南,2024-08-05,9896
00712,復華富時不動產,229,65,164,元大-台南,2024-08-05,9896
2882,國泰金,221,70,151,元大-台南,2024-08-05,9896
2317,鴻海,236,112,124,元大-台南,2024-08-05,9896
00680L,元大美債20正2,231,124,107,元大-台南,2024-08-05,9896
3481,群創,174,68,106,元大-台南,2024-08-05,9896
2610,華航,110,9,101,元大-台南,2024-08-05,9896
00715L,期街口布蘭特正2,98,0,98,元大-台南,2024-08-05,9896
2409,友達,104,14,90,元大-台南,2024-08-05,9896
2891,中信金,171,82,89,元大-台南,2024-08-05,9896
00946,群益科技高息成長,119,32,87,元大-台南,2024-08-05,9896
1314,中石化,80,0,80,元大-台南,2024-08-05,9896
00941,中信上游半導體,79,4,75,元大-台南,2024-08-05,9896
2025,千興,73,0,73,元大-台南,2024-08-05,9896
2511,太子,69,2,67,元大-台南,2024-08-05,9896
2515,中工,69,3,66,元大-台南,2024-08-05,9896
00881,國泰台灣5G+,99,35,64,元大-台南,2024-08-05,9896
2330,台積電,143,81,62,元大-台南,2024-08-05,9896
00631L,元大台灣50正2,64,4,60,元大-台南,2024-08-05,9896
0056,元大高股息,193,137,56,元大-台南,2024-08-05,9896
2615,萬海,217,162,55,元大-台南,2024-08-05,9896
006208,富邦台50,67,14,53,元大-台南,2024-08-05,9896
2892,第一金,58,5,53,元大-台南,2024-08-05,9896
0050,元大台灣50,71,19,52,元大-台南,2024-08-05,9896
2834,臺企銀,84,33,51,元大-台南,2024-08-05,9896
1605,華新,56,8,48,元大-台南,2024-08-05,9896
1611,中電,43,0,43,元大-台南,2024-08-05,9896
00891,中信關鍵半導體,59,17,42,元大-台南,2024-08-05,9896
2618,長榮航,53,13,40,元大-台南,2024-08-05,9896
2605,新興,40,1,39,元大-台南,2024-08-05,9896
1785,光洋科,51,16,35,元大-台南,2024-08-05,9896
00713,元大台灣高息低波,56,21,35,元大-台南,2024-08-05,9896
00932,兆豐永續高息等權,35,0,35,元大-台南,2024-08-05,9896
1617,榮星,33,0,33,元大-台南,2024-08-05,9896
00927,群益半導體收益,40,8,32,元大-台南,2024-08-05,9896
6142,友勁,72,40,32,元大-台南,2024-08-05,9896
4533,協易機,33,1,32,元大-台南,2024-08-05,9896
00936,台新永續高息中小,51,21,30,元大-台南,2024-08-05,9896
00949,復華日本龍頭,30,1,29,元大-台南,2024-08-05,9896
2887,台新金,54,26,28,元大-台南,2024-08-05,9896
2606,裕民,28,0,28,元大-台南,2024-08-05,9896
00947,台新臺灣IC設計,28,0,28,元大-台南,2024-08-05,9896
2401,凌陽,31,4,27,元大-台南,2024-08-05,9896
00940,元大台灣價值高息,732,189,543,元大-台南,2024-08-06,9896
9105,泰金寶-DR,229,0,229,元大-台南,2024-08-06,9896
00918,大華優利高填息30,231,8,223,元大-台南,2024-08-06,9896
6177,達麗,122,0,122,元大-台南,2024-08-06,9896
2888,新光金,150,43,107,元大-台南,2024-08-06,9896
00680L,元大美債20正2,441,338,103,元大-台南,2024-08-06,9896
00878,國泰永續高股息,212,119,93,元大-台南,2024-08-06,9896
00927,群益半導體收益,104,17,87,元大-台南,2024-08-06,9896
2337,旺宏,76,19,57,元大-台南,2024-08-06,9896
3481,群創,218,164,54,元大-台南,2024-08-06,9896
00946,群益科技高息成長,48,1,47,元大-台南,2024-08-06,9896
2317,鴻海,207,168,39,元大-台南,2024-08-06,9896
2609,陽明,129,92,37,元大-台南,2024-08-06,9896
2887,台新金,43,8,35,元大-台南,2024-08-06,9896
00919,群益台灣精選高息,85,51,34,元大-台南,2024-08-06,9896
00948B,中信優息投資級債,34,0,34,元大-台南,2024-08-06,9896
00650L,復華香港正2,30,0,30,元大-台南,2024-08-06,9896
00936,台新永續高息中小,38,9,29,元大-台南,2024-08-06,9896
0050,元大台灣50,50,21,29,元大-台南,2024-08-06,9896
2603,長榮,107,78,29,元大-台南,2024-08-06,9896
9945,潤泰新,43,16,27,元大-台南,2024-08-06,9896
0056,元大高股息,98,73,25,元大-台南,2024-08-06,9896
5905,南仁湖,50,25,25,元大-台南,2024-08-06,9896
9904,寶成,43,18,25,元大-台南,2024-08-06,9896
1540,喬福,87,63,24,元大-台南,2024-08-06,9896
4510,高鋒,67,43,24,元大-台南,2024-08-06,9896
3006,晶豪科,24,0,24,元大-台南,2024-08-06,9896
00891,中信關鍵半導體,42,19,23,元大-台南,2024-08-06,9896
006208,富邦台50,33,11,22,元大-台南,2024-08-06,9896
2409,友達,73,53,20,元大-台南,2024-08-06,9896
2542,興富發,29,9,20,元大-台南,2024-08-06,9896
3484,崧騰,20,0,20,元大-台南,2024-08-06,9896
2059,川湖,20,0,20,元大-台南,2024-08-06,9896
5498,凱崴,20,0,20,元大-台南,2024-08-06,9896
1605,華新,26,9,17,元大-台南,2024-08-06,9896
6239,力成,19,2,17,元大-台南,2024-08-06,9896
1609,大亞,29,13,16,元大-台南,2024-08-06,9896
1316,上曜,18,3,15,元大-台南,2024-08-06,9896
4128,中天,14,0,14,元大-台南,2024-08-06,9896
1312,國喬,14,0,14,元大-台南,2024-08-06,9896
3715,定穎投控,20,7,13,元大-台南,2024-08-06,9896
1617,榮星,25,12,13,元大-台南,2024-08-06,9896
00715L,期街口布蘭特正2,28,15,13,元大-台南,2024-08-06,9896
00688L,國泰20年美債正2,51,39,12,元大-台南,2024-08-06,9896
8064,東捷,27,15,12,元大-台南,2024-08-06,9896
1536,和大,21,9,12,元大-台南,2024-08-06,9896
6477,安集,12,0,12,元大-台南,2024-08-06,9896
2356,英業達,33,22,11,元大-台南,2024-08-06,9896
2543,皇昌,12,1,11,元大-台南,2024-08-06,9896
5234,達興材料,11,0,11,元大-台南,2024-08-06,9896
00632R,元大台灣50反1,859,108,751,元大-台南,2024-08-07,9896
00929,復華台灣科技優息,677,122,555,元大-台南,2024-08-07,9896
00937B,群益ESG投等債20,647,138,509,元大-台南,2024-08-07,9896
00679B,元大美債20年,282,48,234,元大-台南,2024-08-07,9896
00715L,期街口布蘭特正2,176,0,176,元大-台南,2024-08-07,9896
00687B,國泰20年美債,136,30,106,元大-台南,2024-08-07,9896
00948B,中信優息投資級債,75,0,75,元大-台南,2024-08-07,9896
2892,第一金,58,0,58,元大-台南,2024-08-07,9896
00919,群益台灣精選高息,119,64,55,元大-台南,2024-08-07,9896
00936,台新永續高息中小,63,12,51,元大-台南,2024-08-07,9896
00934,中信成長高股息,51,9,42,元大-台南,2024-08-07,9896
2317,鴻海,150,111,39,元大-台南,2024-08-07,9896
2313,華通,46,10,36,元大-台南,2024-08-07,9896
2409,友達,37,5,32,元大-台南,2024-08-07,9896
2312,金寶,60,28,32,元大-台南,2024-08-07,9896
3481,群創,38,8,30,元大-台南,2024-08-07,9896
00907,永豐優息存股,30,0,30,元大-台南,2024-08-07,9896
2408,南亞科,27,1,26,元大-台南,2024-08-07,9896
00931B,統一美債20年,26,1,25,元大-台南,2024-08-07,9896
5880,合庫金,24,0,24,元大-台南,2024-08-07,9896
2615,萬海,53,30,23,元大-台南,2024-08-07,9896
00878,國泰永續高股息,54,32,22,元大-台南,2024-08-07,9896
3037,欣興,25,4,21,元大-台南,2024-08-07,9896
00720B,元大投資級公司債,23,2,21,元大-台南,2024-08-07,9896
6216,居易,20,0,20,元大-台南,2024-08-07,9896
6770,力積電,20,0,20,元大-台南,2024-08-07,9896
1522,堤維西,20,1,19,元大-台南,2024-08-07,9896
2885,元大金,24,8,16,元大-台南,2024-08-07,9896
0056,元大高股息,64,48,16,元大-台南,2024-08-07,9896
6523,達爾膚,16,0,16,元大-台南,2024-08-07,9896
2886,兆豐金,31,16,15,元大-台南,2024-08-07,9896
6182,合晶,14,0,14,元大-台南,2024-08-07,9896
3019,亞光,24,10,14,元大-台南,2024-08-07,9896
6213,聯茂,21,9,12,元大-台南,2024-08-07,9896
00725B,國泰投資級公司債,16,4,12,元大-台南,2024-08-07,9896
00941,中信上游半導體,12,0,12,元大-台南,2024-08-07,9896
4903,聯光通,12,0,12,元大-台南,2024-08-07,9896
2867,三商壽,14,2,12,元大-台南,2024-08-07,9896
6877,鏵友益,58,46,12,元大-台南,2024-08-07,9896
5876,上海商銀,12,0,12,元大-台南,2024-08-07,9896
1617,榮星,13,2,11,元大-台南,2024-08-07,9896
4513,福裕,11,0,11,元大-台南,2024-08-07,9896
4967,十銓,14,4,10,元大-台南,2024-08-07,9896
00665L,富邦�琤肭磪囓�2,10,0,10,元大-台南,2024-08-07,9896
1529,樂事綠能,22,12,10,元大-台南,2024-08-07,9896
00693U,期街口S＆P黃豆,10,0,10,元大-台南,2024-08-07,9896
00942B,台新美A公司債20+,10,0,10,元大-台南,2024-08-07,9896
00722B,群益投資級電信債,10,0,10,元大-台南,2024-08-07,9896
2365,昆盈,21,11,10,元大-台南,2024-08-07,9896
00751B,元大AAA至A公司債,9,0,9,元大-台南,2024-08-07,9896
00937B,群益ESG投等債20,479,38,441,元大-台南,2024-08-08,9896
00933B,國泰10Y+金融債,309,2,307,元大-台南,2024-08-08,9896
00679B,元大美債20年,251,8,243,元大-台南,2024-08-08,9896
2615,萬海,247,24,223,元大-台南,2024-08-08,9896
5880,合庫金,201,0,201,元大-台南,2024-08-08,9896
00680L,元大美債20正2,198,0,198,元大-台南,2024-08-08,9896
00929,復華台灣科技優息,204,18,186,元大-台南,2024-08-08,9896
2834,臺企銀,166,7,159,元大-台南,2024-08-08,9896
00940,元大台灣價值高息,192,45,147,元大-台南,2024-08-08,9896
00878,國泰永續高股息,149,11,138,元大-台南,2024-08-08,9896
6160,欣技,120,0,120,元大-台南,2024-08-08,9896
2887,台新金,101,2,99,元大-台南,2024-08-08,9896
6603,富強鑫,108,10,98,元大-台南,2024-08-08,9896
00673R,期元大S＆P原油反1,70,0,70,元大-台南,2024-08-08,9896
2888,新光金,67,6,61,元大-台南,2024-08-08,9896
2886,兆豐金,63,6,57,元大-台南,2024-08-08,9896
4534,慶騰,56,1,55,元大-台南,2024-08-08,9896
2317,鴻海,260,206,54,元大-台南,2024-08-08,9896
00687B,國泰20年美債,51,1,50,元大-台南,2024-08-08,9896
0056,元大高股息,87,39,48,元大-台南,2024-08-08,9896
2371,大同,46,0,46,元大-台南,2024-08-08,9896
3189,景碩,96,56,40,元大-台南,2024-08-08,9896
00945B,凱基美國非投等債,34,0,34,元大-台南,2024-08-08,9896
2892,第一金,34,0,34,元大-台南,2024-08-08,9896
3481,群創,157,125,32,元大-台南,2024-08-08,9896
00712,復華富時不動產,31,1,30,元大-台南,2024-08-08,9896
00881,國泰台灣5G+,29,0,29,元大-台南,2024-08-08,9896
00751B,元大AAA至A公司債,28,2,26,元大-台南,2024-08-08,9896
1605,華新,23,0,23,元大-台南,2024-08-08,9896
2515,中工,26,5,21,元大-台南,2024-08-08,9896
0050,元大台灣50,35,15,20,元大-台南,2024-08-08,9896
3024,憶聲,30,10,20,元大-台南,2024-08-08,9896
00686R,群益臺灣加權反1,20,0,20,元大-台南,2024-08-08,9896
4532,瑞智,20,0,20,元大-台南,2024-08-08,9896
3540,曜越,20,0,20,元大-台南,2024-08-08,9896
2344,華邦電,20,1,19,元大-台南,2024-08-08,9896
1785,光洋科,25,7,18,元大-台南,2024-08-08,9896
1326,台化,17,0,17,元大-台南,2024-08-08,9896
4906,正文,16,0,16,元大-台南,2024-08-08,9896
1301,台塑,16,0,16,元大-台南,2024-08-08,9896
2382,廣達,27,12,15,元大-台南,2024-08-08,9896
2330,台積電,31,16,15,元大-台南,2024-08-08,9896
4566,時碩工業,17,3,14,元大-台南,2024-08-08,9896
8105,凌巨,17,3,14,元大-台南,2024-08-08,9896
2401,凌陽,14,0,14,元大-台南,2024-08-08,9896
2374,佳能,13,0,13,元大-台南,2024-08-08,9896
4157,太景*-KY,13,0,13,元大-台南,2024-08-08,9896
1536,和大,13,0,13,元大-台南,2024-08-08,9896
2324,仁寶,13,0,13,元大-台南,2024-08-08,9896
5607,遠雄港,14,1,13,元大-台南,2024-08-08,9896
00937B,群益ESG投等債20,345,40,305,元大-台南,2024-08-09,9896
00679B,元大美債20年,309,29,280,元大-台南,2024-08-09,9896
00632R,元大台灣50反1,414,153,261,元大-台南,2024-08-09,9896
00933B,國泰10Y+金融債,125,1,124,元大-台南,2024-08-09,9896
9105,泰金寶-DR,192,86,106,元大-台南,2024-08-09,9896
00948B,中信優息投資級債,103,0,103,元大-台南,2024-08-09,9896
3046,建��,72,1,71,元大-台南,2024-08-09,9896
3024,憶聲,87,17,70,元大-台南,2024-08-09,9896
6770,力積電,73,5,68,元大-台南,2024-08-09,9896
9945,潤泰新,115,63,52,元大-台南,2024-08-09,9896
00665L,富邦�琤肭磪囓�2,50,0,50,元大-台南,2024-08-09,9896
3715,定穎投控,116,66,50,元大-台南,2024-08-09,9896
3481,群創,120,71,49,元大-台南,2024-08-09,9896
00680L,元大美債20正2,67,26,41,元大-台南,2024-08-09,9896
6125,廣運,44,5,39,元大-台南,2024-08-09,9896
00946,群益科技高息成長,45,6,39,元大-台南,2024-08-09,9896
00942B,台新美A公司債20+,35,0,35,元大-台南,2024-08-09,9896
00795B,中信美國公債20年,37,4,33,元大-台南,2024-08-09,9896
2615,萬海,148,116,32,元大-台南,2024-08-09,9896
6160,欣技,31,0,31,元大-台南,2024-08-09,9896
2312,金寶,76,45,31,元大-台南,2024-08-09,9896
00720B,元大投資級公司債,32,2,30,元大-台南,2024-08-09,9896
00712,復華富時不動產,30,1,29,元大-台南,2024-08-09,9896
1709,和益,28,0,28,元大-台南,2024-08-09,9896
2515,中工,38,10,28,元大-台南,2024-08-09,9896
3044,健鼎,35,10,25,元大-台南,2024-08-09,9896
3231,緯創,37,12,25,元大-台南,2024-08-09,9896
4513,福裕,26,3,23,元大-台南,2024-08-09,9896
2401,凌陽,27,5,22,元大-台南,2024-08-09,9896
2892,第一金,21,0,21,元大-台南,2024-08-09,9896
00936,台新永續高息中小,77,56,21,元大-台南,2024-08-09,9896
1785,光洋科,30,9,21,元大-台南,2024-08-09,9896
00878,國泰永續高股息,54,34,20,元大-台南,2024-08-09,9896
8905,裕國,20,0,20,元大-台南,2024-08-09,9896
1540,喬福,22,2,20,元大-台南,2024-08-09,9896
00751B,元大AAA至A公司債,19,0,19,元大-台南,2024-08-09,9896
00922,國泰台灣領袖50,20,1,19,元大-台南,2024-08-09,9896
00900,富邦特選高股息30,20,3,17,元大-台南,2024-08-09,9896
1536,和大,18,1,17,元大-台南,2024-08-09,9896
2520,冠德,24,8,16,元大-台南,2024-08-09,9896
0056,元大高股息,70,54,16,元大-台南,2024-08-09,9896
2353,宏��,35,20,15,元大-台南,2024-08-09,9896
00951,台新日本半導體,15,0,15,元大-台南,2024-08-09,9896
8069,元太,21,6,15,元大-台南,2024-08-09,9896
00881,國泰台灣5G+,16,2,14,元大-台南,2024-08-09,9896
00931B,統一美債20年,13,0,13,元大-台南,2024-08-09,9896
2884,玉山金,17,4,13,元大-台南,2024-08-09,9896
2886,兆豐金,12,0,12,元大-台南,2024-08-09,9896
3522,御嵿,12,0,12,元大-台南,2024-08-09,9896
00687B,國泰20年美債,27,15,12,元大-台南,2024-08-09,9896
00929,復華台灣科技優息,664,22,642,元大-台南,2024-08-12,9896
00632R,元大台灣50反1,434,222,212,元大-台南,2024-08-12,9896
0056,元大高股息,124,9,115,元大-台南,2024-08-12,9896
00679B,元大美債20年,115,1,114,元大-台南,2024-08-12,9896
2312,金寶,114,34,80,元大-台南,2024-08-12,9896
4306,炎洲,65,0,65,元大-台南,2024-08-12,9896
2834,臺企銀,66,1,65,元大-台南,2024-08-12,9896
00919,群益台灣精選高息,92,40,52,元大-台南,2024-08-12,9896
00933B,國泰10Y+金融債,51,2,49,元大-台南,2024-08-12,9896
00878,國泰永續高股息,54,13,41,元大-台南,2024-08-12,9896
00650L,復華香港正2,39,0,39,元大-台南,2024-08-12,9896
1609,大亞,62,26,36,元大-台南,2024-08-12,9896
3512,皇龍,30,0,30,元大-台南,2024-08-12,9896
4402,郡都開發,30,0,30,元大-台南,2024-08-12,9896
00948B,中信優息投資級債,31,3,28,元大-台南,2024-08-12,9896
00687B,國泰20年美債,31,3,28,元大-台南,2024-08-12,9896
00688L,國泰20年美債正2,30,3,27,元大-台南,2024-08-12,9896
3481,群創,124,98,26,元大-台南,2024-08-12,9896
2615,萬海,65,39,26,元大-台南,2024-08-12,9896
00719B,元大美債1-3,24,0,24,元大-台南,2024-08-12,9896
2610,華航,24,0,24,元大-台南,2024-08-12,9896
3712,永崴投控,23,0,23,元大-台南,2024-08-12,9896
00830,國泰費城半導體,23,1,22,元大-台南,2024-08-12,9896
00675L,富邦臺灣加權正2,23,1,22,元大-台南,2024-08-12,9896
2365,昆盈,99,78,21,元大-台南,2024-08-12,9896
2353,宏��,24,3,21,元大-台南,2024-08-12,9896
2891,中信金,24,4,20,元大-台南,2024-08-12,9896
4523,永彰,20,0,20,元大-台南,2024-08-12,9896
2883,凱基金,18,0,18,元大-台南,2024-08-12,9896
6223,旺矽,19,3,16,元大-台南,2024-08-12,9896
2867,三商壽,27,11,16,元大-台南,2024-08-12,9896
3535,晶彩科,20,5,15,元大-台南,2024-08-12,9896
3030,德律,15,0,15,元大-台南,2024-08-12,9896
00712,復華富時不動產,14,0,14,元大-台南,2024-08-12,9896
1513,中興電,28,15,13,元大-台南,2024-08-12,9896
3046,建��,13,0,13,元大-台南,2024-08-12,9896
8096,擎亞,29,17,12,元大-台南,2024-08-12,9896
3708,上緯投控,12,0,12,元大-台南,2024-08-12,9896
2317,鴻海,97,85,12,元大-台南,2024-08-12,9896
3715,定穎投控,15,4,11,元大-台南,2024-08-12,9896
2049,上銀,11,0,11,元大-台南,2024-08-12,9896
6285,啟��,11,1,10,元大-台南,2024-08-12,9896
00936,台新永續高息中小,10,0,10,元大-台南,2024-08-12,9896
3663,鑫科,20,11,9,元大-台南,2024-08-12,9896
2359,所羅門,30,21,9,元大-台南,2024-08-12,9896
8358,金居,9,0,9,元大-台南,2024-08-12,9896
2421,建準,13,4,9,元大-台南,2024-08-12,9896
00946,群益科技高息成長,18,9,9,元大-台南,2024-08-12,9896
6189,豐藝,8,0,8,元大-台南,2024-08-12,9896
1597,直得,14,6,8,元大-台南,2024-08-12,9896
00664R,國泰臺灣加權反1,999,0,999,元大-台南,2024-08-13,9896
00948B,中信優息投資級債,573,0,573,元大-台南,2024-08-13,9896
5880,合庫金,204,0,204,元大-台南,2024-08-13,9896
00632R,元大台灣50反1,170,0,170,元大-台南,2024-08-13,9896
00679B,元大美債20年,134,9,125,元大-台南,2024-08-13,9896
0056,元大高股息,115,4,111,元大-台南,2024-08-13,9896
3715,定穎投控,108,7,101,元大-台南,2024-08-13,9896
00713,元大台灣高息低波,101,3,98,元大-台南,2024-08-13,9896
00673R,期元大S＆P原油反1,95,0,95,元大-台南,2024-08-13,9896
00687B,國泰20年美債,84,0,84,元大-台南,2024-08-13,9896
00933B,國泰10Y+金融債,73,2,71,元大-台南,2024-08-13,9896
2402,毅嘉,66,0,66,元大-台南,2024-08-13,9896
2880,華南金,61,1,60,元大-台南,2024-08-13,9896
2609,陽明,73,20,53,元大-台南,2024-08-13,9896
00688L,國泰20年美債正2,52,0,52,元大-台南,2024-08-13,9896
00936,台新永續高息中小,47,1,46,元大-台南,2024-08-13,9896
00878,國泰永續高股息,50,13,37,元大-台南,2024-08-13,9896
00680L,元大美債20正2,36,0,36,元大-台南,2024-08-13,9896
2885,元大金,32,3,29,元大-台南,2024-08-13,9896
1513,中興電,33,7,26,元大-台南,2024-08-13,9896
2405,輔信,23,0,23,元大-台南,2024-08-13,9896
2017,官田鋼,20,0,20,元大-台南,2024-08-13,9896
00693U,期街口S＆P黃豆,19,0,19,元大-台南,2024-08-13,9896
1301,台塑,24,5,19,元大-台南,2024-08-13,9896
3481,群創,159,141,18,元大-台南,2024-08-13,9896
1609,大亞,43,25,18,元大-台南,2024-08-13,9896
1708,東鹼,19,1,18,元大-台南,2024-08-13,9896
2886,兆豐金,18,1,17,元大-台南,2024-08-13,9896
2891,中信金,21,5,16,元大-台南,2024-08-13,9896
1316,上曜,18,3,15,元大-台南,2024-08-13,9896
3062,建漢,53,38,15,元大-台南,2024-08-13,9896
2374,佳能,24,9,15,元大-台南,2024-08-13,9896
3540,曜越,14,0,14,元大-台南,2024-08-13,9896
1536,和大,27,13,14,元大-台南,2024-08-13,9896
1326,台化,20,7,13,元大-台南,2024-08-13,9896
6180,橘子,13,0,13,元大-台南,2024-08-13,9896
6269,台郡,12,0,12,元大-台南,2024-08-13,9896
2476,鉅祥,25,13,12,元大-台南,2024-08-13,9896
2892,第一金,11,0,11,元大-台南,2024-08-13,9896
3013,晟銘電,35,25,10,元大-台南,2024-08-13,9896
1815,富喬,21,11,10,元大-台南,2024-08-13,9896
00894,中信小資高價30,11,1,10,元大-台南,2024-08-13,9896
1314,中石化,12,2,10,元大-台南,2024-08-13,9896
00932,兆豐永續高息等權,10,0,10,元大-台南,2024-08-13,9896
00905,FT臺灣Smart,15,5,10,元大-台南,2024-08-13,9896
1409,新纖,10,0,10,元大-台南,2024-08-13,9896
6603,富強鑫,12,3,9,元大-台南,2024-08-13,9896
2352,佳世達,9,0,9,元大-台南,2024-08-13,9896
2401,凌陽,9,1,8,元大-台南,2024-08-13,9896
00720B,元大投資級公司債,8,0,8,元大-台南,2024-08-13,9896
2834,臺企銀,311,5,306,元大-台南,2024-08-14,9896
2883,凱基金,400,142,258,元大-台南,2024-08-14,9896
00900,富邦特選高股息30,195,6,189,元大-台南,2024-08-14,9896
00679B,元大美債20年,180,16,164,元大-台南,2024-08-14,9896
00687B,國泰20年美債,119,3,116,元大-台南,2024-08-14,9896
00929,復華台灣科技優息,103,8,95,元大-台南,2024-08-14,9896
1101,台泥,77,5,72,元大-台南,2024-08-14,9896
00937B,群益ESG投等債20,75,12,63,元大-台南,2024-08-14,9896
00680L,元大美債20正2,65,2,63,元大-台南,2024-08-14,9896
00878,國泰永續高股息,60,18,42,元大-台南,2024-08-14,9896
3019,亞光,74,35,39,元大-台南,2024-08-14,9896
2365,昆盈,106,69,37,元大-台南,2024-08-14,9896
00881,國泰台灣5G+,58,21,37,元大-台南,2024-08-14,9896
2882,國泰金,41,4,37,元大-台南,2024-08-14,9896
2888,新光金,51,19,32,元大-台南,2024-08-14,9896
4526,東台,34,4,30,元大-台南,2024-08-14,9896
2405,輔信,28,0,28,元大-台南,2024-08-14,9896
2033,佳大,29,2,27,元大-台南,2024-08-14,9896
00945B,凱基美國非投等債,26,0,26,元大-台南,2024-08-14,9896
00712,復華富時不動產,26,1,25,元大-台南,2024-08-14,9896
3481,群創,358,334,24,元大-台南,2024-08-14,9896
00688L,國泰20年美債正2,21,0,21,元大-台南,2024-08-14,9896
6446,藥華藥,32,11,21,元大-台南,2024-08-14,9896
3202,樺晟,22,1,21,元大-台南,2024-08-14,9896
2845,遠東銀,20,0,20,元大-台南,2024-08-14,9896
00772B,中信高評級公司債,20,0,20,元大-台南,2024-08-14,9896
5701,劍湖山,20,0,20,元大-台南,2024-08-14,9896
00918,大華優利高填息30,20,1,19,元大-台南,2024-08-14,9896
2867,三商壽,27,8,19,元大-台南,2024-08-14,9896
6770,力積電,20,2,18,元大-台南,2024-08-14,9896
2401,凌陽,22,5,17,元大-台南,2024-08-14,9896
2610,華航,18,1,17,元大-台南,2024-08-14,9896
00685L,群益臺灣加權正2,17,0,17,元大-台南,2024-08-14,9896
6215,和椿,25,8,17,元大-台南,2024-08-14,9896
2349,錸德,22,6,16,元大-台南,2024-08-14,9896
6147,頎邦,29,13,16,元大-台南,2024-08-14,9896
00936,台新永續高息中小,26,10,16,元大-台南,2024-08-14,9896
2880,華南金,17,2,15,元大-台南,2024-08-14,9896
3522,御嵿,14,0,14,元大-台南,2024-08-14,9896
00949,復華日本龍頭,14,1,13,元大-台南,2024-08-14,9896
3048,益登,15,3,12,元大-台南,2024-08-14,9896
8043,蜜望實,40,28,12,元大-台南,2024-08-14,9896
00946,群益科技高息成長,12,1,11,元大-台南,2024-08-14,9896
1785,光洋科,24,13,11,元大-台南,2024-08-14,9896
8942,森鉅,12,1,11,元大-台南,2024-08-14,9896
2615,萬海,37,26,11,元大-台南,2024-08-14,9896
2905,三商,15,5,10,元大-台南,2024-08-14,9896
9945,潤泰新,22,12,10,元大-台南,2024-08-14,9896
0056,元大高股息,14,4,10,元大-台南,2024-08-14,9896
00693U,期街口S＆P黃豆,10,0,10,元大-台南,2024-08-14,9896
00929,復華台灣科技優息,401,45,356,元大-台南,2024-08-15,9896
00900,富邦特選高股息30,290,0,290,元大-台南,2024-08-15,9896
00937B,群益ESG投等債20,395,111,284,元大-台南,2024-08-15,9896
00632R,元大台灣50反1,125,5,120,元大-台南,2024-08-15,9896
00878,國泰永續高股息,118,16,102,元大-台南,2024-08-15,9896
00680L,元大美債20正2,142,47,95,元大-台南,2024-08-15,9896
00687B,國泰20年美債,162,70,92,元大-台南,2024-08-15,9896
00688L,國泰20年美債正2,131,56,75,元大-台南,2024-08-15,9896
4540,全球傳動,71,11,60,元大-台南,2024-08-15,9896
5905,南仁湖,82,25,57,元大-台南,2024-08-15,9896
00795B,中信美國公債20年,55,0,55,元大-台南,2024-08-15,9896
2867,三商壽,95,43,52,元大-台南,2024-08-15,9896
2887,台新金,46,5,41,元大-台南,2024-08-15,9896
6190,萬泰科,30,1,29,元大-台南,2024-08-15,9896
2884,玉山金,28,0,28,元大-台南,2024-08-15,9896
2885,元大金,24,1,23,元大-台南,2024-08-15,9896
00881,國泰台灣5G+,25,2,23,元大-台南,2024-08-15,9896
3189,景碩,23,1,22,元大-台南,2024-08-15,9896
00945B,凱基美國非投等債,22,0,22,元大-台南,2024-08-15,9896
4526,東台,21,0,21,元大-台南,2024-08-15,9896
2002,中鋼,23,2,21,元大-台南,2024-08-15,9896
2892,第一金,21,0,21,元大-台南,2024-08-15,9896
6418,詠昇,20,0,20,元大-台南,2024-08-15,9896
00641R,富邦日本反1,20,0,20,元大-台南,2024-08-15,9896
2317,鴻海,74,56,18,元大-台南,2024-08-15,9896
2033,佳大,20,2,18,元大-台南,2024-08-15,9896
4958,臻鼎-KY,17,1,16,元大-台南,2024-08-15,9896
2881,富邦金,25,10,15,元大-台南,2024-08-15,9896
2891,中信金,14,0,14,元大-台南,2024-08-15,9896
00731,復華富時高息低波,14,0,14,元大-台南,2024-08-15,9896
2489,瑞軒,37,24,13,元大-台南,2024-08-15,9896
00933B,國泰10Y+金融債,14,1,13,元大-台南,2024-08-15,9896
6257,矽格,12,0,12,元大-台南,2024-08-15,9896
1326,台化,12,0,12,元大-台南,2024-08-15,9896
2882,國泰金,29,17,12,元大-台南,2024-08-15,9896
2801,彰銀,11,0,11,元大-台南,2024-08-15,9896
1444,力麗,11,0,11,元大-台南,2024-08-15,9896
00753L,中信中國50正2,11,0,11,元大-台南,2024-08-15,9896
3188,鑫龍騰,11,0,11,元大-台南,2024-08-15,9896
6112,邁達特,10,0,10,元大-台南,2024-08-15,9896
00830,國泰費城半導體,10,0,10,元大-台南,2024-08-15,9896
00931B,統一美債20年,10,0,10,元大-台南,2024-08-15,9896
6451,訊芯-KY,11,1,10,元大-台南,2024-08-15,9896
00923,群益台ESG低碳50,10,0,10,元大-台南,2024-08-15,9896
9935,慶豐富,19,10,9,元大-台南,2024-08-15,9896
3167,大量,13,4,9,元大-台南,2024-08-15,9896
00919,群益台灣精選高息,12,3,9,元大-台南,2024-08-15,9896
5371,中光電,10,2,8,元大-台南,2024-08-15,9896
2501,國建,9,1,8,元大-台南,2024-08-15,9896
3303,岱稜,8,0,8,元大-台南,2024-08-15,9896
00632R,元大台灣50反1,696,166,530,元大-台南,2024-08-16,9896
00687B,國泰20年美債,209,5,204,元大-台南,2024-08-16,9896
00706L,期元大S＆P日圓正2,113,0,113,元大-台南,2024-08-16,9896
00948B,中信優息投資級債,105,2,103,元大-台南,2024-08-16,9896
2888,新光金,111,15,96,元大-台南,2024-08-16,9896
00679B,元大美債20年,128,46,82,元大-台南,2024-08-16,9896
00878,國泰永續高股息,94,31,63,元大-台南,2024-08-16,9896
00688L,國泰20年美債正2,71,15,56,元大-台南,2024-08-16,9896
2609,陽明,73,19,54,元大-台南,2024-08-16,9896
2845,遠東銀,51,0,51,元大-台南,2024-08-16,9896
00712,復華富時不動產,43,1,42,元大-台南,2024-08-16,9896
00673R,期元大S＆P原油反1,41,0,41,元大-台南,2024-08-16,9896
00795B,中信美國公債20年,33,0,33,元大-台南,2024-08-16,9896
9105,泰金寶-DR,28,0,28,元大-台南,2024-08-16,9896
2033,佳大,28,1,27,元大-台南,2024-08-16,9896
8096,擎亞,94,69,25,元大-台南,2024-08-16,9896
00932,兆豐永續高息等權,25,0,25,元大-台南,2024-08-16,9896
2025,千興,25,0,25,元大-台南,2024-08-16,9896
00929,復華台灣科技優息,58,35,23,元大-台南,2024-08-16,9896
00731,復華富時高息低波,22,0,22,元大-台南,2024-08-16,9896
2401,凌陽,23,1,22,元大-台南,2024-08-16,9896
00942B,台新美A公司債20+,21,0,21,元大-台南,2024-08-16,9896
2337,旺宏,22,2,20,元大-台南,2024-08-16,9896
2464,盟立,52,32,20,元大-台南,2024-08-16,9896
2002,中鋼,19,3,16,元大-台南,2024-08-16,9896
00933B,國泰10Y+金融債,28,12,16,元大-台南,2024-08-16,9896
00936,台新永續高息中小,17,1,16,元大-台南,2024-08-16,9896
6120,達運,20,5,15,元大-台南,2024-08-16,9896
00693U,期街口S＆P黃豆,15,0,15,元大-台南,2024-08-16,9896
2867,三商壽,15,0,15,元大-台南,2024-08-16,9896
6125,廣運,23,8,15,元大-台南,2024-08-16,9896
1609,大亞,18,3,15,元大-台南,2024-08-16,9896
00919,群益台灣精選高息,33,19,14,元大-台南,2024-08-16,9896
6757,台灣虎航,14,0,14,元大-台南,2024-08-16,9896
2489,瑞軒,27,13,14,元大-台南,2024-08-16,9896
2363,矽統,29,15,14,元大-台南,2024-08-16,9896
00945B,凱基美國非投等債,13,0,13,元大-台南,2024-08-16,9896
00857B,永豐20年美公債,13,0,13,元大-台南,2024-08-16,9896
3645,達邁,17,5,12,元大-台南,2024-08-16,9896
2515,中工,12,0,12,元大-台南,2024-08-16,9896
2610,華航,22,10,12,元大-台南,2024-08-16,9896
6187,萬潤,28,16,12,元大-台南,2024-08-16,9896
2367,燿華,20,9,11,元大-台南,2024-08-16,9896
1444,力麗,11,0,11,元大-台南,2024-08-16,9896
3202,樺晟,31,20,11,元大-台南,2024-08-16,9896
6603,富強鑫,11,0,11,元大-台南,2024-08-16,9896
2605,新興,10,0,10,元大-台南,2024-08-16,9896
00637L,元大滬深300正2,12,2,10,元大-台南,2024-08-16,9896
4739,康普,10,0,10,元大-台南,2024-08-16,9896
4960,誠美材,10,1,9,元大-台南,2024-08-16,9896
00687B,國泰20年美債,431,4,427,元大-台南,2024-08-19,9896
9904,寶成,82,0,82,元大-台南,2024-08-19,9896
2405,輔信,84,6,78,元大-台南,2024-08-19,9896
00937B,群益ESG投等債20,127,52,75,元大-台南,2024-08-19,9896
5880,合庫金,67,0,67,元大-台南,2024-08-19,9896
5905,南仁湖,122,60,62,元大-台南,2024-08-19,9896
00942B,台新美A公司債20+,61,0,61,元大-台南,2024-08-19,9896
00680L,元大美債20正2,65,9,56,元大-台南,2024-08-19,9896
2002,中鋼,48,15,33,元大-台南,2024-08-19,9896
00679B,元大美債20年,66,34,32,元大-台南,2024-08-19,9896
00719B,元大美債1-3,30,1,29,元大-台南,2024-08-19,9896
2409,友達,39,12,27,元大-台南,2024-08-19,9896
00795B,中信美國公債20年,53,26,27,元大-台南,2024-08-19,9896
3047,訊舟,90,65,25,元大-台南,2024-08-19,9896
00931B,統一美債20年,25,0,25,元大-台南,2024-08-19,9896
3715,定穎投控,47,23,24,元大-台南,2024-08-19,9896
6269,台郡,23,0,23,元大-台南,2024-08-19,9896
3491,昇達科,26,4,22,元大-台南,2024-08-19,9896
2317,鴻海,68,46,22,元大-台南,2024-08-19,9896
2359,所羅門,53,32,21,元大-台南,2024-08-19,9896
00651R,復華香港反1,20,0,20,元大-台南,2024-08-19,9896
00712,復華富時不動產,19,0,19,元大-台南,2024-08-19,9896
00923,群益台ESG低碳50,19,1,18,元大-台南,2024-08-19,9896
00945B,凱基美國非投等債,23,5,18,元大-台南,2024-08-19,9896
5519,隆大,22,5,17,元大-台南,2024-08-19,9896
00948B,中信優息投資級債,14,0,14,元大-台南,2024-08-19,9896
6152,百一,14,0,14,元大-台南,2024-08-19,9896
2354,鴻準,30,16,14,元大-台南,2024-08-19,9896
0056,元大高股息,24,10,14,元大-台南,2024-08-19,9896
2892,第一金,14,0,14,元大-台南,2024-08-19,9896
2886,兆豐金,14,1,13,元大-台南,2024-08-19,9896
4909,新復興,24,11,13,元大-台南,2024-08-19,9896
3202,樺晟,99,86,13,元大-台南,2024-08-19,9896
00715L,期街口布蘭特正2,13,1,12,元大-台南,2024-08-19,9896
00951,台新日本半導體,12,0,12,元大-台南,2024-08-19,9896
2464,盟立,56,45,11,元大-台南,2024-08-19,9896
3665,貿聯-KY,13,2,11,元大-台南,2024-08-19,9896
6147,頎邦,11,0,11,元大-台南,2024-08-19,9896
3013,晟銘電,24,13,11,元大-台南,2024-08-19,9896
8028,昇陽半導體,45,35,10,元大-台南,2024-08-19,9896
6603,富強鑫,10,0,10,元大-台南,2024-08-19,9896
8021,尖點,23,13,10,元大-台南,2024-08-19,9896
3450,聯鈞,15,5,10,元大-台南,2024-08-19,9896
6188,廣明,14,4,10,元大-台南,2024-08-19,9896
2308,台達電,12,3,9,元大-台南,2024-08-19,9896
6207,雷科,25,16,9,元大-台南,2024-08-19,9896
5484,慧友,12,3,9,元大-台南,2024-08-19,9896
2867,三商壽,9,0,9,元大-台南,2024-08-19,9896
2204,中華,9,0,9,元大-台南,2024-08-19,9896
00688L,國泰20年美債正2,8,0,8,元大-台南,2024-08-19,9896
00632R,元大台灣50反1,543,20,523,元大-台南,2024-08-20,9896
00937B,群益ESG投等債20,565,43,522,元大-台南,2024-08-20,9896
00929,復華台灣科技優息,221,29,192,元大-台南,2024-08-20,9896
00680L,元大美債20正2,166,15,151,元大-台南,2024-08-20,9896
00687B,國泰20年美債,121,17,104,元大-台南,2024-08-20,9896
00948B,中信優息投資級債,84,15,69,元大-台南,2024-08-20,9896
00715L,期街口布蘭特正2,67,0,67,元大-台南,2024-08-20,9896
00671R,富邦NASDAQ反1,65,0,65,元大-台南,2024-08-20,9896
0056,元大高股息,60,2,58,元大-台南,2024-08-20,9896
2365,昆盈,103,47,56,元大-台南,2024-08-20,9896
2882,國泰金,53,0,53,元大-台南,2024-08-20,9896
3715,定穎投控,62,16,46,元大-台南,2024-08-20,9896
00679B,元大美債20年,69,28,41,元大-台南,2024-08-20,9896
2313,華通,46,5,41,元大-台南,2024-08-20,9896
2374,佳能,66,25,41,元大-台南,2024-08-20,9896
2888,新光金,329,288,41,元大-台南,2024-08-20,9896
00651R,復華香港反1,40,0,40,元大-台南,2024-08-20,9896
6112,邁達特,32,1,31,元大-台南,2024-08-20,9896
2883,凱基金,32,3,29,元大-台南,2024-08-20,9896
2367,燿華,30,5,25,元大-台南,2024-08-20,9896
00706L,期元大S＆P日圓正2,23,0,23,元大-台南,2024-08-20,9896
2352,佳世達,27,6,21,元大-台南,2024-08-20,9896
00940,元大台灣價值高息,84,63,21,元大-台南,2024-08-20,9896
3037,欣興,20,0,20,元大-台南,2024-08-20,9896
2356,英業達,48,29,19,元大-台南,2024-08-20,9896
2417,圓剛,23,5,18,元大-台南,2024-08-20,9896
2388,威盛,21,6,15,元大-台南,2024-08-20,9896
00931B,統一美債20年,15,0,15,元大-台南,2024-08-20,9896
3691,碩禾,15,0,15,元大-台南,2024-08-20,9896
00907,永豐優息存股,14,0,14,元大-台南,2024-08-20,9896
3712,永崴投控,18,4,14,元大-台南,2024-08-20,9896
00713,元大台灣高息低波,14,1,13,元大-台南,2024-08-20,9896
1708,東鹼,17,4,13,元大-台南,2024-08-20,9896
2062,橋椿,14,1,13,元大-台南,2024-08-20,9896
2453,凌群,13,0,13,元大-台南,2024-08-20,9896
8027,鈦昇,17,4,13,元大-台南,2024-08-20,9896
4526,東台,15,3,12,元大-台南,2024-08-20,9896
4157,太景*-KY,14,2,12,元大-台南,2024-08-20,9896
2392,正崴,16,4,12,元大-台南,2024-08-20,9896
6219,富旺,12,0,12,元大-台南,2024-08-20,9896
8477,創業家,12,0,12,元大-台南,2024-08-20,9896
00795B,中信美國公債20年,11,0,11,元大-台南,2024-08-20,9896
1301,台塑,17,6,11,元大-台南,2024-08-20,9896
00945B,凱基美國非投等債,11,0,11,元大-台南,2024-08-20,9896
6120,達運,11,0,11,元大-台南,2024-08-20,9896
1440,南紡,11,0,11,元大-台南,2024-08-20,9896
6418,詠昇,24,13,11,元大-台南,2024-08-20,9896
2537,聯上發,20,9,11,元大-台南,2024-08-20,9896
8110,華東,11,0,11,元大-台南,2024-08-20,9896
00881,國泰台灣5G+,10,0,10,元大-台南,2024-08-20,9896
00929,復華台灣科技優息,468,21,447,元大-台南,2024-08-21,9896
2891,中信金,272,10,262,元大-台南,2024-08-21,9896
00919,群益台灣精選高息,178,4,174,元大-台南,2024-08-21,9896
1314,中石化,102,0,102,元大-台南,2024-08-21,9896
00937B,群益ESG投等債20,139,42,97,元大-台南,2024-08-21,9896
00715L,期街口布蘭特正2,92,0,92,元大-台南,2024-08-21,9896
00895,富邦未來車,60,0,60,元大-台南,2024-08-21,9896
00933B,國泰10Y+金融債,42,0,42,元大-台南,2024-08-21,9896
00940,元大台灣價值高息,61,20,41,元大-台南,2024-08-21,9896
00878,國泰永續高股息,45,8,37,元大-台南,2024-08-21,9896
2002,中鋼,31,1,30,元大-台南,2024-08-21,9896
00923,群益台ESG低碳50,29,0,29,元大-台南,2024-08-21,9896
6603,富強鑫,28,0,28,元大-台南,2024-08-21,9896
00687B,國泰20年美債,44,17,27,元大-台南,2024-08-21,9896
00953B,群益優選非投等債,22,0,22,元大-台南,2024-08-21,9896
00650L,復華香港正2,22,0,22,元大-台南,2024-08-21,9896
3450,聯鈞,33,12,21,元大-台南,2024-08-21,9896
8064,東捷,69,49,20,元大-台南,2024-08-21,9896
00936,台新永續高息中小,21,1,20,元大-台南,2024-08-21,9896
00795B,中信美國公債20年,31,13,18,元大-台南,2024-08-21,9896
2354,鴻準,23,7,16,元大-台南,2024-08-21,9896
3339,泰谷,19,3,16,元大-台南,2024-08-21,9896
2349,錸德,58,42,16,元大-台南,2024-08-21,9896
0056,元大高股息,18,2,16,元大-台南,2024-08-21,9896
3141,晶宏,17,2,15,元大-台南,2024-08-21,9896
00637L,元大滬深300正2,15,0,15,元大-台南,2024-08-21,9896
2356,英業達,37,23,14,元大-台南,2024-08-21,9896
00945B,凱基美國非投等債,14,0,14,元大-台南,2024-08-21,9896
6869,雲豹能源,23,9,14,元大-台南,2024-08-21,9896
00882,中信中國高股息,13,0,13,元大-台南,2024-08-21,9896
6156,松上,18,5,13,元大-台南,2024-08-21,9896
2388,威盛,18,5,13,元大-台南,2024-08-21,9896
2323,中環,12,0,12,元大-台南,2024-08-21,9896
2401,凌陽,34,22,12,元大-台南,2024-08-21,9896
3535,晶彩科,50,39,11,元大-台南,2024-08-21,9896
4563,百德,23,12,11,元大-台南,2024-08-21,9896
3028,增你強,10,0,10,元大-台南,2024-08-21,9896
6578,達邦蛋白,11,1,10,元大-台南,2024-08-21,9896
2069,運錩,12,2,10,元大-台南,2024-08-21,9896
6667,信紘科,10,0,10,元大-台南,2024-08-21,9896
6187,萬潤,10,0,10,元大-台南,2024-08-21,9896
3312,弘憶股,24,14,10,元大-台南,2024-08-21,9896
1785,光洋科,36,27,9,元大-台南,2024-08-21,9896
1319,東陽,12,3,9,元大-台南,2024-08-21,9896
3296,勝德,9,0,9,元大-台南,2024-08-21,9896
3202,樺晟,11,2,9,元大-台南,2024-08-21,9896
00881,國泰台灣5G+,9,0,9,元大-台南,2024-08-21,9896
006208,富邦台50,8,0,8,元大-台南,2024-08-21,9896
1609,大亞,12,4,8,元大-台南,2024-08-21,9896
2070,精湛,15,7,8,元大-台南,2024-08-21,9896
00937B,群益ESG投等債20,167,2,165,元大-台南,2024-08-22,9896
00715L,期街口布蘭特正2,134,0,134,元大-台南,2024-08-22,9896
2890,永豐金,106,0,106,元大-台南,2024-08-22,9896
00720B,元大投資級公司債,82,1,81,元大-台南,2024-08-22,9896
2891,中信金,93,15,78,元大-台南,2024-08-22,9896
00687B,國泰20年美債,64,1,63,元大-台南,2024-08-22,9896
00940,元大台灣價值高息,111,58,53,元大-台南,2024-08-22,9896
00949,復華日本龍頭,40,0,40,元大-台南,2024-08-22,9896
00907,永豐優息存股,41,2,39,元大-台南,2024-08-22,9896
2356,英業達,52,16,36,元大-台南,2024-08-22,9896
2349,錸德,177,141,36,元大-台南,2024-08-22,9896
2867,三商壽,42,11,31,元大-台南,2024-08-22,9896
00632R,元大台灣50反1,55,28,27,元大-台南,2024-08-22,9896
00688L,國泰20年美債正2,27,0,27,元大-台南,2024-08-22,9896
00882,中信中國高股息,26,0,26,元大-台南,2024-08-22,9896
6603,富強鑫,47,21,26,元大-台南,2024-08-22,9896
5371,中光電,35,11,24,元大-台南,2024-08-22,9896
00929,復華台灣科技優息,47,23,24,元大-台南,2024-08-22,9896
3047,訊舟,83,60,23,元大-台南,2024-08-22,9896
3019,亞光,47,25,22,元大-台南,2024-08-22,9896
2885,元大金,19,0,19,元大-台南,2024-08-22,9896
00919,群益台灣精選高息,20,1,19,元大-台南,2024-08-22,9896
3615,安可,22,4,18,元大-台南,2024-08-22,9896
2330,台積電,19,3,16,元大-台南,2024-08-22,9896
00795B,中信美國公債20年,16,0,16,元大-台南,2024-08-22,9896
00953B,群益優選非投等債,16,0,16,元大-台南,2024-08-22,9896
00878,國泰永續高股息,24,9,15,元大-台南,2024-08-22,9896
3296,勝德,14,0,14,元大-台南,2024-08-22,9896
2401,凌陽,14,1,13,元大-台南,2024-08-22,9896
6177,達麗,16,3,13,元大-台南,2024-08-22,9896
2354,鴻準,13,1,12,元大-台南,2024-08-22,9896
9105,泰金寶-DR,12,0,12,元大-台南,2024-08-22,9896
1708,東鹼,50,39,11,元大-台南,2024-08-22,9896
00945B,凱基美國非投等債,10,0,10,元大-台南,2024-08-22,9896
00740B,富邦全球投等債,10,0,10,元大-台南,2024-08-22,9896
00955,中信日本商社,10,0,10,元大-台南,2024-08-22,9896
2025,千興,10,0,10,元大-台南,2024-08-22,9896
6187,萬潤,11,1,10,元大-台南,2024-08-22,9896
2317,鴻海,59,50,9,元大-台南,2024-08-22,9896
00931B,統一美債20年,13,4,9,元大-台南,2024-08-22,9896
0056,元大高股息,12,3,9,元大-台南,2024-08-22,9896
2388,威盛,14,5,9,元大-台南,2024-08-22,9896
5905,南仁湖,34,26,8,元大-台南,2024-08-22,9896
00637L,元大滬深300正2,18,10,8,元大-台南,2024-08-22,9896
6016,康和證,8,0,8,元大-台南,2024-08-22,9896
1513,中興電,17,10,7,元大-台南,2024-08-22,9896
8064,東捷,33,26,7,元大-台南,2024-08-22,9896
6125,廣運,16,9,7,元大-台南,2024-08-22,9896
2405,輔信,7,0,7,元大-台南,2024-08-22,9896
00725B,國泰投資級公司債,14,7,7,元大-台南,2024-08-22,9896
00680L,元大美債20正2,401,52,349,元大-台南,2024-08-23,9896
2845,遠東銀,200,1,199,元大-台南,2024-08-23,9896
00929,復華台灣科技優息,148,23,125,元大-台南,2024-08-23,9896
00687B,國泰20年美債,106,2,104,元大-台南,2024-08-23,9896
00688L,國泰20年美債正2,141,40,101,元大-台南,2024-08-23,9896
2609,陽明,98,10,88,元大-台南,2024-08-23,9896
2349,錸德,105,42,63,元大-台南,2024-08-23,9896
00936,台新永續高息中小,60,2,58,元大-台南,2024-08-23,9896
2891,中信金,59,4,55,元大-台南,2024-08-23,9896
00937B,群益ESG投等債20,72,20,52,元大-台南,2024-08-23,9896
00651R,復華香港反1,50,0,50,元大-台南,2024-08-23,9896
00679B,元大美債20年,75,33,42,元大-台南,2024-08-23,9896
1409,新纖,40,3,37,元大-台南,2024-08-23,9896
1314,中石化,45,14,31,元大-台南,2024-08-23,9896
3189,景碩,57,26,31,元大-台南,2024-08-23,9896
2834,臺企銀,35,5,30,元大-台南,2024-08-23,9896
2867,三商壽,29,1,28,元大-台南,2024-08-23,9896
1727,中華化,28,5,23,元大-台南,2024-08-23,9896
00933B,國泰10Y+金融債,22,0,22,元大-台南,2024-08-23,9896
1785,光洋科,38,16,22,元大-台南,2024-08-23,9896
00897,富邦基因免疫生技,20,0,20,元大-台南,2024-08-23,9896
1618,合機,20,0,20,元大-台南,2024-08-23,9896
2885,元大金,21,1,20,元大-台南,2024-08-23,9896
00795B,中信美國公債20年,18,0,18,元大-台南,2024-08-23,9896
5309,系統電,22,4,18,元大-台南,2024-08-23,9896
2542,興富發,18,1,17,元大-台南,2024-08-23,9896
2313,華通,22,6,16,元大-台南,2024-08-23,9896
00751B,元大AAA至A公司債,15,1,14,元大-台南,2024-08-23,9896
1447,力鵬,106,92,14,元大-台南,2024-08-23,9896
00919,群益台灣精選高息,31,18,13,元大-台南,2024-08-23,9896
2344,華邦電,15,3,12,元大-台南,2024-08-23,9896
00953B,群益優選非投等債,11,0,11,元大-台南,2024-08-23,9896
1326,台化,11,0,11,元大-台南,2024-08-23,9896
1532,勤美,11,0,11,元大-台南,2024-08-23,9896
2402,毅嘉,13,2,11,元大-台南,2024-08-23,9896
8927,北基,11,0,11,元大-台南,2024-08-23,9896
6156,松上,11,0,11,元大-台南,2024-08-23,9896
3708,上緯投控,11,0,11,元大-台南,2024-08-23,9896
8942,森鉅,10,0,10,元大-台南,2024-08-23,9896
1515,力山,10,0,10,元大-台南,2024-08-23,9896
1723,中碳,10,0,10,元大-台南,2024-08-23,9896
6743,安普新,10,0,10,元大-台南,2024-08-23,9896
2528,皇普,11,1,10,元大-台南,2024-08-23,9896
00725B,國泰投資級公司債,10,0,10,元大-台南,2024-08-23,9896
00951,台新日本半導體,10,0,10,元大-台南,2024-08-23,9896
3171,炎洲流通,10,0,10,元大-台南,2024-08-23,9896
6952,大武山,10,0,10,元大-台南,2024-08-23,9896
1570,力肯,29,20,9,元大-台南,2024-08-23,9896
2539,櫻花建,9,0,9,元大-台南,2024-08-23,9896
4729,熒茂,9,0,9,元大-台南,2024-08-23,9896
2845,遠東銀,317,0,317,元大-台南,2024-08-26,9896
00937B,群益ESG投等債20,283,31,252,元大-台南,2024-08-26,9896
00679B,元大美債20年,190,15,175,元大-台南,2024-08-26,9896
00954,中信日本半導體,100,0,100,元大-台南,2024-08-26,9896
00953B,群益優選非投等債,76,3,73,元大-台南,2024-08-26,9896
2409,友達,78,21,57,元大-台南,2024-08-26,9896
2891,中信金,75,21,54,元大-台南,2024-08-26,9896
6151,晉倫,51,1,50,元大-台南,2024-08-26,9896
00651R,復華香港反1,50,0,50,元大-台南,2024-08-26,9896
00673R,期元大S＆P原油反1,50,0,50,元大-台南,2024-08-26,9896
00632R,元大台灣50反1,167,130,37,元大-台南,2024-08-26,9896
00687B,國泰20年美債,39,3,36,元大-台南,2024-08-26,9896
00929,復華台灣科技優息,62,29,33,元大-台南,2024-08-26,9896
00637L,元大滬深300正2,37,5,32,元大-台南,2024-08-26,9896
4171,瑞基,30,0,30,元大-台南,2024-08-26,9896
00892,富邦台灣半導體,30,1,29,元大-台南,2024-08-26,9896
00688L,國泰20年美債正2,28,0,28,元大-台南,2024-08-26,9896
6469,大樹,28,0,28,元大-台南,2024-08-26,9896
1609,大亞,32,6,26,元大-台南,2024-08-26,9896
2313,華通,24,0,24,元大-台南,2024-08-26,9896
2890,永豐金,27,4,23,元大-台南,2024-08-26,9896
00882,中信中國高股息,23,0,23,元大-台南,2024-08-26,9896
1785,光洋科,50,29,21,元大-台南,2024-08-26,9896
00919,群益台灣精選高息,44,23,21,元大-台南,2024-08-26,9896
2303,聯電,93,73,20,元大-台南,2024-08-26,9896
3543,州巧,20,0,20,元大-台南,2024-08-26,9896
2883B,凱基金乙特,20,0,20,元大-台南,2024-08-26,9896
2855,統一證,20,0,20,元大-台南,2024-08-26,9896
2317,鴻海,41,23,18,元大-台南,2024-08-26,9896
8070,長華*,41,24,17,元大-台南,2024-08-26,9896
00751B,元大AAA至A公司債,21,5,16,元大-台南,2024-08-26,9896
2405,輔信,21,5,16,元大-台南,2024-08-26,9896
00936,台新永續高息中小,16,1,15,元大-台南,2024-08-26,9896
5905,南仁湖,20,5,15,元大-台南,2024-08-26,9896
00795B,中信美國公債20年,15,0,15,元大-台南,2024-08-26,9896
00948B,中信優息投資級債,15,0,15,元大-台南,2024-08-26,9896
3062,建漢,20,5,15,元大-台南,2024-08-26,9896
2402,毅嘉,77,63,14,元大-台南,2024-08-26,9896
3711,日月光投控,13,0,13,元大-台南,2024-08-26,9896
2464,盟立,15,2,13,元大-台南,2024-08-26,9896
6208,日揚,18,5,13,元大-台南,2024-08-26,9896
1570,力肯,28,16,12,元大-台南,2024-08-26,9896
6156,松上,12,0,12,元大-台南,2024-08-26,9896
6187,萬潤,11,0,11,元大-台南,2024-08-26,9896
3202,樺晟,24,13,11,元大-台南,2024-08-26,9896
8089,康全電訊,11,1,10,元大-台南,2024-08-26,9896
00933B,國泰10Y+金融債,10,0,10,元大-台南,2024-08-26,9896
6275,元山,10,0,10,元大-台南,2024-08-26,9896
8076,伍豐,10,0,10,元大-台南,2024-08-26,9896
00895,富邦未來車,10,0,10,元大-台南,2024-08-26,9896
00687B,國泰20年美債,218,0,218,元大-台南,2024-08-27,9896
00929,復華台灣科技優息,223,9,214,元大-台南,2024-08-27,9896
2891,中信金,120,8,112,元大-台南,2024-08-27,9896
00673R,期元大S＆P原油反1,67,0,67,元大-台南,2024-08-27,9896
5880,合庫金,52,0,52,元大-台南,2024-08-27,9896
2515,中工,54,8,46,元大-台南,2024-08-27,9896
00679B,元大美債20年,46,10,36,元大-台南,2024-08-27,9896
00919,群益台灣精選高息,42,7,35,元大-台南,2024-08-27,9896
00948B,中信優息投資級債,35,2,33,元大-台南,2024-08-27,9896
2609,陽明,35,6,29,元大-台南,2024-08-27,9896
3481,群創,370,341,29,元大-台南,2024-08-27,9896
2883,凱基金,27,0,27,元大-台南,2024-08-27,9896
00878,國泰永續高股息,35,8,27,元大-台南,2024-08-27,9896
6188,廣明,23,0,23,元大-台南,2024-08-27,9896
00725B,國泰投資級公司債,22,0,22,元大-台南,2024-08-27,9896
3019,亞光,30,13,17,元大-台南,2024-08-27,9896
6151,晉倫,18,1,17,元大-台南,2024-08-27,9896
00720B,元大投資級公司債,16,0,16,元大-台南,2024-08-27,9896
00688L,國泰20年美債正2,16,0,16,元大-台南,2024-08-27,9896
3047,訊舟,32,17,15,元大-台南,2024-08-27,9896
00881,國泰台灣5G+,14,0,14,元大-台南,2024-08-27,9896
2610,華航,13,0,13,元大-台南,2024-08-27,9896
2399,映泰,35,22,13,元大-台南,2024-08-27,9896
2409,友達,20,8,12,元大-台南,2024-08-27,9896
8076,伍豐,12,0,12,元大-台南,2024-08-27,9896
5443,均豪,61,49,12,元大-台南,2024-08-27,9896
2890,永豐金,12,0,12,元大-台南,2024-08-27,9896
8027,鈦昇,19,9,10,元大-台南,2024-08-27,9896
2365,昆盈,34,24,10,元大-台南,2024-08-27,9896
2887,台新金,21,11,10,元大-台南,2024-08-27,9896
2637,慧洋-KY,10,0,10,元大-台南,2024-08-27,9896
6952,大武山,10,0,10,元大-台南,2024-08-27,9896
6418,詠昇,10,0,10,元大-台南,2024-08-27,9896
2367,燿華,12,2,10,元大-台南,2024-08-27,9896
2330,台積電,10,0,10,元大-台南,2024-08-27,9896
2353,宏��,16,7,9,元大-台南,2024-08-27,9896
1101,台泥,10,1,9,元大-台南,2024-08-27,9896
2880,華南金,9,0,9,元大-台南,2024-08-27,9896
5469,瀚宇博,10,1,9,元大-台南,2024-08-27,9896
5525,順天,9,0,9,元大-台南,2024-08-27,9896
6806,森崴能源,9,0,9,元大-台南,2024-08-27,9896
1301,台塑,8,0,8,元大-台南,2024-08-27,9896
2882,國泰金,12,4,8,元大-台南,2024-08-27,9896
00934,中信成長高股息,8,0,8,元大-台南,2024-08-27,9896
2603,長榮,14,6,8,元大-台南,2024-08-27,9896
3260,威剛,15,7,8,元大-台南,2024-08-27,9896
00637L,元大滬深300正2,18,10,8,元大-台南,2024-08-27,9896
2312,金寶,9,2,7,元大-台南,2024-08-27,9896
00895,富邦未來車,7,0,7,元大-台南,2024-08-27,9896
6223,旺矽,15,8,7,元大-台南,2024-08-27,9896
2025,千興,149,0,149,元大-台南,2024-08-28,9896
2891,中信金,98,19,79,元大-台南,2024-08-28,9896
00679B,元大美債20年,81,8,73,元大-台南,2024-08-28,9896
00687B,國泰20年美債,61,0,61,元大-台南,2024-08-28,9896
00688L,國泰20年美債正2,50,0,50,元大-台南,2024-08-28,9896
00940,元大台灣價值高息,65,22,43,元大-台南,2024-08-28,9896
2367,燿華,80,38,42,元大-台南,2024-08-28,9896
2867,三商壽,57,20,37,元大-台南,2024-08-28,9896
5880,合庫金,35,0,35,元大-台南,2024-08-28,9896
2405,輔信,47,14,33,元大-台南,2024-08-28,9896
00632R,元大台灣50反1,63,30,33,元大-台南,2024-08-28,9896
00959B,大華投等美債15Y+,32,0,32,元大-台南,2024-08-28,9896
2349,錸德,45,16,29,元大-台南,2024-08-28,9896
2409,友達,34,8,26,元大-台南,2024-08-28,9896
00878,國泰永續高股息,45,22,23,元大-台南,2024-08-28,9896
3715,定穎投控,41,18,23,元大-台南,2024-08-28,9896
6241,易通展,22,0,22,元大-台南,2024-08-28,9896
2425,承啟,29,7,22,元大-台南,2024-08-28,9896
00648R,元大S＆P500反1,20,0,20,元大-台南,2024-08-28,9896
00937B,群益ESG投等債20,22,4,18,元大-台南,2024-08-28,9896
2464,盟立,31,14,17,元大-台南,2024-08-28,9896
00637L,元大滬深300正2,17,0,17,元大-台南,2024-08-28,9896
3498,陽程,20,4,16,元大-台南,2024-08-28,9896
3615,安可,17,2,15,元大-台南,2024-08-28,9896
00936,台新永續高息中小,16,1,15,元大-台南,2024-08-28,9896
8111,立��,33,18,15,元大-台南,2024-08-28,9896
8076,伍豐,20,5,15,元大-台南,2024-08-28,9896
1785,光洋科,18,4,14,元大-台南,2024-08-28,9896
2431,聯昌,68,54,14,元大-台南,2024-08-28,9896
2392,正崴,29,15,14,元大-台南,2024-08-28,9896
5443,均豪,94,81,13,元大-台南,2024-08-28,9896
3673,TPK-KY,15,2,13,元大-台南,2024-08-28,9896
2845,遠東銀,12,0,12,元大-台南,2024-08-28,9896
2301,光寶科,12,0,12,元大-台南,2024-08-28,9896
00918,大華優利高填息30,12,0,12,元大-台南,2024-08-28,9896
6418,詠昇,28,16,12,元大-台南,2024-08-28,9896
2890,永豐金,12,1,11,元大-台南,2024-08-28,9896
1301,台塑,13,2,11,元大-台南,2024-08-28,9896
2101,南港,12,1,11,元大-台南,2024-08-28,9896
8096,擎亞,29,19,10,元大-台南,2024-08-28,9896
3013,晟銘電,43,33,10,元大-台南,2024-08-28,9896
00881,國泰台灣5G+,13,3,10,元大-台南,2024-08-28,9896
00725B,國泰投資級公司債,10,0,10,元大-台南,2024-08-28,9896
2855,統一證,20,10,10,元大-台南,2024-08-28,9896
8070,長華*,24,14,10,元大-台南,2024-08-28,9896
2836,高雄銀,10,0,10,元大-台南,2024-08-28,9896
3607,谷崧,10,0,10,元大-台南,2024-08-28,9896
2365,昆盈,14,5,9,元大-台南,2024-08-28,9896
2374,佳能,10,1,9,元大-台南,2024-08-28,9896
2543,皇昌,15,6,9,元大-台南,2024-08-28,9896
00680L,元大美債20正2,519,15,504,元大-台南,2024-08-29,9896
00632R,元大台灣50反1,330,72,258,元大-台南,2024-08-29,9896
00937B,群益ESG投等債20,181,5,176,元大-台南,2024-08-29,9896
2891,中信金,178,32,146,元大-台南,2024-08-29,9896
00929,復華台灣科技優息,123,13,110,元大-台南,2024-08-29,9896
00940,元大台灣價值高息,117,7,110,元大-台南,2024-08-29,9896
00687B,國泰20年美債,108,0,108,元大-台南,2024-08-29,9896
00688L,國泰20年美債正2,84,0,84,元大-台南,2024-08-29,9896
00679B,元大美債20年,177,94,83,元大-台南,2024-08-29,9896
2025,千興,72,0,72,元大-台南,2024-08-29,9896
2641,正德,65,1,64,元大-台南,2024-08-29,9896
00895,富邦未來車,60,0,60,元大-台南,2024-08-29,9896
2890,永豐金,45,0,45,元大-台南,2024-08-29,9896
3149,正達,83,39,44,元大-台南,2024-08-29,9896
00919,群益台灣精選高息,47,4,43,元大-台南,2024-08-29,9896
00948B,中信優息投資級債,40,0,40,元大-台南,2024-08-29,9896
2515,中工,59,23,36,元大-台南,2024-08-29,9896
2887,台新金,34,1,33,元大-台南,2024-08-29,9896
2317,鴻海,75,43,32,元大-台南,2024-08-29,9896
8927,北基,30,0,30,元大-台南,2024-08-29,9896
00878,國泰永續高股息,35,6,29,元大-台南,2024-08-29,9896
2313,華通,77,50,27,元大-台南,2024-08-29,9896
2353,宏��,37,11,26,元大-台南,2024-08-29,9896
2330,台積電,33,7,26,元大-台南,2024-08-29,9896
5880,合庫金,23,0,23,元大-台南,2024-08-29,9896
00830,國泰費城半導體,23,0,23,元大-台南,2024-08-29,9896
00751B,元大AAA至A公司債,22,0,22,元大-台南,2024-08-29,9896
3006,晶豪科,22,0,22,元大-台南,2024-08-29,9896
2405,輔信,29,7,22,元大-台南,2024-08-29,9896
1314,中石化,22,1,21,元大-台南,2024-08-29,9896
8096,擎亞,27,7,20,元大-台南,2024-08-29,9896
00918,大華優利高填息30,21,2,19,元大-台南,2024-08-29,9896
00953B,群益優選非投等債,20,1,19,元大-台南,2024-08-29,9896
2426,鼎元,47,30,17,元大-台南,2024-08-29,9896
2489,瑞軒,17,1,16,元大-台南,2024-08-29,9896
5309,系統電,16,0,16,元大-台南,2024-08-29,9896
00945B,凱基美國非投等債,16,0,16,元大-台南,2024-08-29,9896
5443,均豪,80,64,16,元大-台南,2024-08-29,9896
00772B,中信高評級公司債,15,0,15,元大-台南,2024-08-29,9896
2539,櫻花建,15,0,15,元大-台南,2024-08-29,9896
1540,喬福,40,26,14,元大-台南,2024-08-29,9896
3550,聯穎,43,28,15,元大-台南,2024-08-29,9896
1570,力肯,14,0,14,元大-台南,2024-08-29,9896
00637L,元大滬深300正2,17,3,14,元大-台南,2024-08-29,9896
2431,聯昌,77,63,14,元大-台南,2024-08-29,9896
00713,元大台灣高息低波,14,0,14,元大-台南,2024-08-29,9896
2834,臺企銀,12,0,12,元大-台南,2024-08-29,9896
3047,訊舟,28,16,12,元大-台南,2024-08-29,9896
3437,榮創,18,6,12,元大-台南,2024-08-29,9896
6443,元晶,11,0,11,元大-台南,2024-08-29,9896
00900,富邦特選高股息30,161,42,119,元大-台南,2024-08-30,9896
2891,中信金,129,11,118,元大-台南,2024-08-30,9896
00919,群益台灣精選高息,118,9,109,元大-台南,2024-08-30,9896
00632R,元大台灣50反1,319,210,109,元大-台南,2024-08-30,9896
00639,富邦深100,100,0,100,元大-台南,2024-08-30,9896
2025,千興,84,0,84,元大-台南,2024-08-30,9896
1449,佳和,70,3,67,元大-台南,2024-08-30,9896
2409,友達,81,15,66,元大-台南,2024-08-30,9896
00680L,元大美債20正2,56,0,56,元大-台南,2024-08-30,9896
3481,群創,110,56,54,元大-台南,2024-08-30,9896
6215,和椿,71,21,50,元大-台南,2024-08-30,9896
00929,復華台灣科技優息,102,53,49,元大-台南,2024-08-30,9896
00959B,大華投等美債15Y+,46,0,46,元大-台南,2024-08-30,9896
6698,旭暉應材,45,6,39,元大-台南,2024-08-30,9896
00687B,國泰20年美債,40,1,39,元大-台南,2024-08-30,9896
00719B,元大美債1-3,35,0,35,元大-台南,2024-08-30,9896
1711,永光,58,24,34,元大-台南,2024-08-30,9896
2392,正崴,65,33,32,元大-台南,2024-08-30,9896
00679B,元大美債20年,69,39,30,元大-台南,2024-08-30,9896
00688L,國泰20年美債正2,27,0,27,元大-台南,2024-08-30,9896
6114,久威,27,0,27,元大-台南,2024-08-30,9896
00936,台新永續高息中小,28,1,27,元大-台南,2024-08-30,9896
00878,國泰永續高股息,37,11,26,元大-台南,2024-08-30,9896
00948B,中信優息投資級債,25,0,25,元大-台南,2024-08-30,9896
6213,聯茂,35,11,24,元大-台南,2024-08-30,9896
4526,東台,115,92,23,元大-台南,2024-08-30,9896
2367,燿華,82,62,20,元大-台南,2024-08-30,9896
00931B,統一美債20年,25,6,19,元大-台南,2024-08-30,9896
3540,曜越,22,4,18,元大-台南,2024-08-30,9896
2369,菱生,18,0,18,元大-台南,2024-08-30,9896
3303,岱稜,24,6,18,元大-台南,2024-08-30,9896
4909,新復興,34,18,16,元大-台南,2024-08-30,9896
5355,佳總,24,8,16,元大-台南,2024-08-30,9896
3645,達邁,31,15,16,元大-台南,2024-08-30,9896
1314,中石化,21,6,15,元大-台南,2024-08-30,9896
2431,聯昌,34,21,13,元大-台南,2024-08-30,9896
4109,加捷生醫,13,0,13,元大-台南,2024-08-30,9896
8064,東捷,26,13,13,元大-台南,2024-08-30,9896
2603,長榮,22,10,12,元大-台南,2024-08-30,9896
6269,台郡,15,4,11,元大-台南,2024-08-30,9896
3015,全漢,13,2,11,元大-台南,2024-08-30,9896
6218,豪勉,16,5,11,元大-台南,2024-08-30,9896
8086,宏捷科,27,16,11,元大-台南,2024-08-30,9896
5309,系統電,11,1,10,元大-台南,2024-08-30,9896
1709,和益,10,0,10,元大-台南,2024-08-30,9896
00892,富邦台灣半導體,10,0,10,元大-台南,2024-08-30,9896
3356,奇偶,10,0,10,元大-台南,2024-08-30,9896
5007,三星,10,0,10,元大-台南,2024-08-30,9896
2356,英業達,17,7,10,元大-台南,2024-08-30,9896
6257,矽格,22,13,9,元大-台南,2024-08-30,9896
00937B,群益ESG投等債20,134,0,134,元大-台南,2024-09-02,9896
2025,千興,131,0,131,元大-台南,2024-09-02,9896
00665L,富邦�琤肭磪囓�2,169,71,98,元大-台南,2024-09-02,9896
2409,友達,92,5,87,元大-台南,2024-09-02,9896
00679B,元大美債20年,89,4,85,元大-台南,2024-09-02,9896
00915,凱基優選高股息30,82,2,80,元大-台南,2024-09-02,9896
00715L,期街口布蘭特正2,79,0,79,元大-台南,2024-09-02,9896
00688L,國泰20年美債正2,65,5,60,元大-台南,2024-09-02,9896
00892,富邦台灣半導體,60,0,60,元大-台南,2024-09-02,9896
2891,中信金,79,28,51,元大-台南,2024-09-02,9896
2812,台中銀,48,0,48,元大-台南,2024-09-02,9896
6187,萬潤,48,12,36,元大-台南,2024-09-02,9896
00687B,國泰20年美債,40,7,33,元大-台南,2024-09-02,9896
00680L,元大美債20正2,32,0,32,元大-台南,2024-09-02,9896
00881,國泰台灣5G+,31,1,30,元大-台南,2024-09-02,9896
4526,東台,37,7,30,元大-台南,2024-09-02,9896
00878,國泰永續高股息,33,4,29,元大-台南,2024-09-02,9896
1314,中石化,30,4,26,元大-台南,2024-09-02,9896
00918,大華優利高填息30,23,0,23,元大-台南,2024-09-02,9896
8070,長華*,58,36,22,元大-台南,2024-09-02,9896
3362,先進光,24,2,22,元大-台南,2024-09-02,9896
2371,大同,22,0,22,元大-台南,2024-09-02,9896
00713,元大台灣高息低波,24,3,21,元大-台南,2024-09-02,9896
2442,新美齊,21,0,21,元大-台南,2024-09-02,9896
1409,新纖,21,0,21,元大-台南,2024-09-02,9896
2317,鴻海,49,28,21,元大-台南,2024-09-02,9896
2401,凌陽,20,0,20,元大-台南,2024-09-02,9896
5512,力麒,22,2,20,元大-台南,2024-09-02,9896
1711,永光,36,17,19,元大-台南,2024-09-02,9896
2323,中環,18,0,18,元大-台南,2024-09-02,9896
8111,立��,29,12,17,元大-台南,2024-09-02,9896
00795B,中信美國公債20年,16,0,16,元大-台南,2024-09-02,9896
00637L,元大滬深300正2,31,15,16,元大-台南,2024-09-02,9896
1301,台塑,13,0,13,元大-台南,2024-09-02,9896
00751B,元大AAA至A公司債,13,0,13,元大-台南,2024-09-02,9896
3260,威剛,17,5,12,元大-台南,2024-09-02,9896
6269,台郡,12,0,12,元大-台南,2024-09-02,9896
6213,聯茂,15,3,12,元大-台南,2024-09-02,9896
1516,川飛,12,0,12,元大-台南,2024-09-02,9896
2515,中工,26,14,12,元大-台南,2024-09-02,9896
00719B,元大美債1-3,12,0,12,元大-台南,2024-09-02,9896
00936,台新永續高息中小,12,1,11,元大-台南,2024-09-02,9896
2603,長榮,51,40,11,元大-台南,2024-09-02,9896
00720B,元大投資級公司債,11,0,11,元大-台南,2024-09-02,9896
00932,兆豐永續高息等權,11,0,11,元大-台南,2024-09-02,9896
00650L,復華香港正2,11,0,11,元大-台南,2024-09-02,9896
4714,永捷,16,5,11,元大-台南,2024-09-02,9896
2539,櫻花建,11,0,11,元大-台南,2024-09-02,9896
3021,鴻名,10,0,10,元大-台南,2024-09-02,9896
6168,宏齊,10,0,10,元大-台南,2024-09-02,9896
00680L,元大美債20正2,2296,0,2296,元大-台南,2024-09-03,9896
00918,大華優利高填息30,388,0,388,元大-台南,2024-09-03,9896
00937B,群益ESG投等債20,168,1,167,元大-台南,2024-09-03,9896
00940,元大台灣價值高息,175,28,147,元大-台南,2024-09-03,9896
00687B,國泰20年美債,140,0,140,元大-台南,2024-09-03,9896
2025,千興,123,0,123,元大-台南,2024-09-03,9896
00919,群益台灣精選高息,133,16,117,元大-台南,2024-09-03,9896
2618,長榮航,155,54,101,元大-台南,2024-09-03,9896
00679B,元大美債20年,69,0,69,元大-台南,2024-09-03,9896
2515,中工,46,0,46,元大-台南,2024-09-03,9896
6213,聯茂,66,27,39,元大-台南,2024-09-03,9896
2887,台新金,39,4,35,元大-台南,2024-09-03,9896
2449,京元電子,35,1,34,元大-台南,2024-09-03,9896
00878,國泰永續高股息,36,2,34,元大-台南,2024-09-03,9896
00892,富邦台灣半導體,33,0,33,元大-台南,2024-09-03,9896
2002,中鋼,42,10,32,元大-台南,2024-09-03,9896
6125,廣運,30,2,28,元大-台南,2024-09-03,9896
5905,南仁湖,25,0,25,元大-台南,2024-09-03,9896
2537,聯上發,25,0,25,元大-台南,2024-09-03,9896
2367,燿華,51,27,24,元大-台南,2024-09-03,9896
2867,三商壽,42,19,23,元大-台南,2024-09-03,9896
1301,台塑,31,9,22,元大-台南,2024-09-03,9896
5386,青雲,27,5,22,元大-台南,2024-09-03,9896
00688L,國泰20年美債正2,22,0,22,元大-台南,2024-09-03,9896
1101,台泥,23,1,22,元大-台南,2024-09-03,9896
00931B,統一美債20年,21,0,21,元大-台南,2024-09-03,9896
2356,英業達,23,4,19,元大-台南,2024-09-03,9896
2882,國泰金,19,0,19,元大-台南,2024-09-03,9896
2891,中信金,28,10,18,元大-台南,2024-09-03,9896
1815,富喬,33,15,18,元大-台南,2024-09-03,9896
9919,康那香,17,0,17,元大-台南,2024-09-03,9896
00915,凱基優選高股息30,18,1,17,元大-台南,2024-09-03,9896
2369,菱生,16,0,16,元大-台南,2024-09-03,9896
1314,中石化,24,9,15,元大-台南,2024-09-03,9896
2884,玉山金,16,2,14,元大-台南,2024-09-03,9896
2486,一詮,22,8,14,元大-台南,2024-09-03,9896
1785,光洋科,35,21,14,元大-台南,2024-09-03,9896
2834,臺企銀,14,0,14,元大-台南,2024-09-03,9896
4566,時碩工業,16,3,13,元大-台南,2024-09-03,9896
6142,友勁,72,59,13,元大-台南,2024-09-03,9896
5512,力麒,14,1,13,元大-台南,2024-09-03,9896
6215,和椿,16,3,13,元大-台南,2024-09-03,9896
3062,建漢,68,55,13,元大-台南,2024-09-03,9896
1444,力麗,12,0,12,元大-台南,2024-09-03,9896
2405,輔信,16,4,12,元大-台南,2024-09-03,9896
3037,欣興,18,6,12,元大-台南,2024-09-03,9896
2812,台中銀,12,1,11,元大-台南,2024-09-03,9896
3689,湧德,10,0,10,元大-台南,2024-09-03,9896
1219,福壽,10,0,10,元大-台南,2024-09-03,9896
4526,東台,15,5,10,元大-台南,2024-09-03,9896
00940,元大台灣價值高息,718,24,694,元大-台南,2024-09-04,9896
00919,群益台灣精選高息,418,24,394,元大-台南,2024-09-04,9896
2337,旺宏,381,1,380,元大-台南,2024-09-04,9896
00918,大華優利高填息30,260,1,259,元大-台南,2024-09-04,9896
00715L,期街口布蘭特正2,242,1,241,元大-台南,2024-09-04,9896
00915,凱基優選高股息30,221,3,218,元大-台南,2024-09-04,9896
2025,千興,203,0,203,元大-台南,2024-09-04,9896
00878,國泰永續高股息,212,20,192,元大-台南,2024-09-04,9896
2883,凱基金,189,20,169,元大-台南,2024-09-04,9896
2409,友達,149,0,149,元大-台南,2024-09-04,9896
2891,中信金,130,4,126,元大-台南,2024-09-04,9896
00905,FT臺灣Smart,87,0,87,元大-台南,2024-09-04,9896
2330,台積電,97,10,87,元大-台南,2024-09-04,9896
0056,元大高股息,93,9,84,元大-台南,2024-09-04,9896
00706L,期元大S＆P日圓正2,80,1,79,元大-台南,2024-09-04,9896
2511,太子,65,0,65,元大-台南,2024-09-04,9896
3481,群創,91,32,59,元大-台南,2024-09-04,9896
2890,永豐金,56,0,56,元大-台南,2024-09-04,9896
00713,元大台灣高息低波,54,2,52,元大-台南,2024-09-04,9896
1301,台塑,57,7,50,元大-台南,2024-09-04,9896
0050,元大台灣50,49,2,47,元大-台南,2024-09-04,9896
00881,國泰台灣5G+,42,0,42,元大-台南,2024-09-04,9896
006208,富邦台50,44,4,40,元大-台南,2024-09-04,9896
2317,鴻海,137,98,39,元大-台南,2024-09-04,9896
00712,復華富時不動產,37,0,37,元大-台南,2024-09-04,9896
00947,台新臺灣IC設計,36,0,36,元大-台南,2024-09-04,9896
1609,大亞,38,4,34,元大-台南,2024-09-04,9896
00943,兆豐電子高息等權,35,3,32,元大-台南,2024-09-04,9896
2812,台中銀,30,0,30,元大-台南,2024-09-04,9896
3346,麗清,31,1,30,元大-台南,2024-09-04,9896
00934,中信成長高股息,30,0,30,元大-台南,2024-09-04,9896
2382,廣達,35,7,28,元大-台南,2024-09-04,9896
00955,中信日本商社,28,0,28,元大-台南,2024-09-04,9896
2605,新興,32,4,28,元大-台南,2024-09-04,9896
9105,泰金寶-DR,28,0,28,元大-台南,2024-09-04,9896
5386,青雲,27,0,27,元大-台南,2024-09-04,9896
00670L,富邦NASDAQ正2,29,4,25,元大-台南,2024-09-04,9896
00927,群益半導體收益,25,0,25,元大-台南,2024-09-04,9896
1314,中石化,224,200,24,元大-台南,2024-09-04,9896
2344,華邦電,32,8,24,元大-台南,2024-09-04,9896
00631L,元大台灣50正2,39,16,23,元大-台南,2024-09-04,9896
00935,野村臺灣新科技50,22,0,22,元大-台南,2024-09-04,9896
1101,台泥,30,8,22,元大-台南,2024-09-04,9896
00642U,期元大S＆P石油,22,0,22,元大-台南,2024-09-04,9896
3231,緯創,32,10,22,元大-台南,2024-09-04,9896
3714,富采,21,0,21,元大-台南,2024-09-04,9896
2356,英業達,29,8,21,元大-台南,2024-09-04,9896
6770,力積電,23,2,21,元大-台南,2024-09-04,9896
3576,聯合再生,21,0,21,元大-台南,2024-09-04,9896
6187,萬潤,34,14,20,元大-台南,2024-09-04,9896
00632R,元大台灣50反1,464,94,370,元大-台南,2024-09-05,9896
00715L,期街口布蘭特正2,208,3,205,元大-台南,2024-09-05,9896
2025,千興,177,0,177,元大-台南,2024-09-05,9896
00712,復華富時不動產,89,10,79,元大-台南,2024-09-05,9896
00940,元大台灣價值高息,184,109,75,元大-台南,2024-09-05,9896
2603,長榮,81,9,72,元大-台南,2024-09-05,9896
00952,凱基台灣AI50,70,0,70,元大-台南,2024-09-05,9896
2317,鴻海,92,32,60,元大-台南,2024-09-05,9896
2349,錸德,66,13,53,元大-台南,2024-09-05,9896
00878,國泰永續高股息,68,22,46,元大-台南,2024-09-05,9896
8069,元太,43,1,42,元大-台南,2024-09-05,9896
00915,凱基優選高股息30,42,1,41,元大-台南,2024-09-05,9896
2002,中鋼,39,1,38,元大-台南,2024-09-05,9896
6151,晉倫,34,0,34,元大-台南,2024-09-05,9896
2402,毅嘉,58,24,34,元大-台南,2024-09-05,9896
2891,中信金,39,6,33,元大-台南,2024-09-05,9896
1785,光洋科,36,3,33,元大-台南,2024-09-05,9896
00946,群益科技高息成長,31,0,31,元大-台南,2024-09-05,9896
3481,群創,33,4,29,元大-台南,2024-09-05,9896
00720B,元大投資級公司債,33,5,28,元大-台南,2024-09-05,9896
0056,元大高股息,34,6,28,元大-台南,2024-09-05,9896
1316,上曜,27,0,27,元大-台南,2024-09-05,9896
00919,群益台灣精選高息,160,135,25,元大-台南,2024-09-05,9896
2867,三商壽,24,1,23,元大-台南,2024-09-05,9896
5607,遠雄港,22,0,22,元大-台南,2024-09-05,9896
1722,台肥,22,1,21,元大-台南,2024-09-05,9896
2353,宏��,22,2,20,元大-台南,2024-09-05,9896
1536,和大,20,0,20,元大-台南,2024-09-05,9896
2884,玉山金,32,13,19,元大-台南,2024-09-05,9896
4526,東台,22,3,19,元大-台南,2024-09-05,9896
2408,南亞科,19,0,19,元大-台南,2024-09-05,9896
3062,建漢,54,36,18,元大-台南,2024-09-05,9896
6770,力積電,22,4,18,元大-台南,2024-09-05,9896
1723,中碳,22,5,17,元大-台南,2024-09-05,9896
2495,普安,22,5,17,元大-台南,2024-09-05,9896
2356,英業達,21,5,16,元大-台南,2024-09-05,9896
2344,華邦電,16,0,16,元大-台南,2024-09-05,9896
2313,華通,17,3,14,元大-台南,2024-09-05,9896
2365,昆盈,24,10,14,元大-台南,2024-09-05,9896
4576,大銀微系統,21,8,13,元大-台南,2024-09-05,9896
2546,根基,13,0,13,元大-台南,2024-09-05,9896
006208,富邦台50,13,0,13,元大-台南,2024-09-05,9896
4909,新復興,20,7,13,元大-台南,2024-09-05,9896
00947,台新臺灣IC設計,13,0,13,元大-台南,2024-09-05,9896
2027,大成鋼,25,13,12,元大-台南,2024-09-05,9896
00713,元大台灣高息低波,14,2,12,元大-台南,2024-09-05,9896
3006,晶豪科,16,4,12,元大-台南,2024-09-05,9896
2515,中工,19,7,12,元大-台南,2024-09-05,9896
4109,加捷生醫,12,0,12,元大-台南,2024-09-05,9896
3374,精材,16,5,11,元大-台南,2024-09-05,9896
00632R,元大台灣50反1,362,21,341,元大-台南,2024-09-06,9896
00715L,期街口布蘭特正2,125,0,125,元大-台南,2024-09-06,9896
00937B,群益ESG投等債20,145,39,106,元大-台南,2024-09-06,9896
00918,大華優利高填息30,88,2,86,元大-台南,2024-09-06,9896
00948B,中信優息投資級債,80,0,80,元大-台南,2024-09-06,9896
00940,元大台灣價值高息,109,32,77,元大-台南,2024-09-06,9896
2025,千興,91,17,74,元大-台南,2024-09-06,9896
00919,群益台灣精選高息,68,7,61,元大-台南,2024-09-06,9896
1314,中石化,61,3,58,元大-台南,2024-09-06,9896
00929,復華台灣科技優息,57,12,45,元大-台南,2024-09-06,9896
1605,華新,38,0,38,元大-台南,2024-09-06,9896
1444,力麗,35,0,35,元大-台南,2024-09-06,9896
8016,矽創,32,0,32,元大-台南,2024-09-06,9896
00687B,國泰20年美債,35,4,31,元大-台南,2024-09-06,9896
3481,群創,45,16,29,元大-台南,2024-09-06,9896
6216,居易,29,0,29,元大-台南,2024-09-06,9896
2610,華航,30,1,29,元大-台南,2024-09-06,9896
2313,華通,30,4,26,元大-台南,2024-09-06,9896
4974,亞泰,25,2,23,元大-台南,2024-09-06,9896
3303,岱稜,22,0,22,元大-台南,2024-09-06,9896
6163,華電網,25,7,18,元大-台南,2024-09-06,9896
2002,中鋼,20,2,18,元大-台南,2024-09-06,9896
5905,南仁湖,30,12,18,元大-台南,2024-09-06,9896
2883,凱基金,19,1,18,元大-台南,2024-09-06,9896
00720B,元大投資級公司債,18,3,15,元大-台南,2024-09-06,9896
1718,中纖,30,15,15,元大-台南,2024-09-06,9896
00954,中信日本半導體,14,0,14,元大-台南,2024-09-06,9896
3437,榮創,28,15,13,元大-台南,2024-09-06,9896
00882,中信中國高股息,23,10,13,元大-台南,2024-09-06,9896
2618,長榮航,39,27,12,元大-台南,2024-09-06,9896
2383,台光電,15,3,12,元大-台南,2024-09-06,9896
00952,凱基台灣AI50,12,0,12,元大-台南,2024-09-06,9896
2399,映泰,11,0,11,元大-台南,2024-09-06,9896
6156,松上,11,0,11,元大-台南,2024-09-06,9896
6015,宏遠證,11,0,11,元大-台南,2024-09-06,9896
00713,元大台灣高息低波,14,3,11,元大-台南,2024-09-06,9896
8112,至上,17,7,10,元大-台南,2024-09-06,9896
2855,統一證,10,0,10,元大-台南,2024-09-06,9896
3289,宜特,10,0,10,元大-台南,2024-09-06,9896
3051,力特,10,0,10,元大-台南,2024-09-06,9896
6168,宏齊,11,1,10,元大-台南,2024-09-06,9896
6477,安集,10,0,10,元大-台南,2024-09-06,9896
4306,炎洲,10,0,10,元大-台南,2024-09-06,9896
1711,永光,29,20,9,元大-台南,2024-09-06,9896
8028,昇陽半導體,19,10,9,元大-台南,2024-09-06,9896
4561,健椿,11,2,9,元大-台南,2024-09-06,9896
00945B,凱基美國非投等債,10,1,9,元大-台南,2024-09-06,9896
4909,新復興,12,3,9,元大-台南,2024-09-06,9896
2439,美律,11,2,9,元大-台南,2024-09-06,9896
2881,富邦金,11,2,9,元大-台南,2024-09-06,9896
3481,群創,275,23,252,元大-台南,2024-09-09,9896
00715L,期街口布蘭特正2,215,26,189,元大-台南,2024-09-09,9896
00919,群益台灣精選高息,171,2,169,元大-台南,2024-09-09,9896
00688L,國泰20年美債正2,196,30,166,元大-台南,2024-09-09,9896
00918,大華優利高填息30,143,2,141,元大-台南,2024-09-09,9896
00940,元大台灣價值高息,141,13,128,元大-台南,2024-09-09,9896
2025,千興,122,0,122,元大-台南,2024-09-09,9896
00900,富邦特選高股息30,117,1,116,元大-台南,2024-09-09,9896
3715,定穎投控,138,32,106,元大-台南,2024-09-09,9896
2885,元大金,101,0,101,元大-台南,2024-09-09,9896
00632R,元大台灣50反1,402,304,98,元大-台南,2024-09-09,9896
00878,國泰永續高股息,95,11,84,元大-台南,2024-09-09,9896
00929,復華台灣科技優息,142,67,75,元大-台南,2024-09-09,9896
2891,中信金,101,39,62,元大-台南,2024-09-09,9896
2353,宏��,66,6,60,元大-台南,2024-09-09,9896
2881,富邦金,56,0,56,元大-台南,2024-09-09,9896
2002,中鋼,57,4,53,元大-台南,2024-09-09,9896
00882,中信中國高股息,51,0,51,元大-台南,2024-09-09,9896
00915,凱基優選高股息30,46,0,46,元大-台南,2024-09-09,9896
2313,華通,61,20,41,元大-台南,2024-09-09,9896
9105,泰金寶-DR,38,0,38,元大-台南,2024-09-09,9896
00687B,國泰20年美債,63,27,36,元大-台南,2024-09-09,9896
00642U,期元大S＆P石油,31,0,31,元大-台南,2024-09-09,9896
2511,太子,30,0,30,元大-台南,2024-09-09,9896
2317,鴻海,98,69,29,元大-台南,2024-09-09,9896
0056,元大高股息,50,25,25,元大-台南,2024-09-09,9896
2382,廣達,26,1,25,元大-台南,2024-09-09,9896
4906,正文,24,0,24,元大-台南,2024-09-09,9896
00951,台新日本半導體,22,0,22,元大-台南,2024-09-09,9896
00881,國泰台灣5G+,22,0,22,元大-台南,2024-09-09,9896
5905,南仁湖,139,118,21,元大-台南,2024-09-09,9896
00669R,國泰美國道瓊反1,20,0,20,元大-台南,2024-09-09,9896
4541,晟田,20,0,20,元大-台南,2024-09-09,9896
006208,富邦台50,22,2,20,元大-台南,2024-09-09,9896
2834,臺企銀,19,0,19,元大-台南,2024-09-09,9896
1605,華新,20,1,19,元大-台南,2024-09-09,9896
1785,光洋科,30,11,19,元大-台南,2024-09-09,9896
2883,凱基金,22,4,18,元大-台南,2024-09-09,9896
3231,緯創,20,4,16,元大-台南,2024-09-09,9896
6156,松上,15,0,15,元大-台南,2024-09-09,9896
6266,泰詠,15,0,15,元大-台南,2024-09-09,9896
2330,台積電,22,7,15,元大-台南,2024-09-09,9896
1540,喬福,31,17,14,元大-台南,2024-09-09,9896
1326,台化,17,3,14,元大-台南,2024-09-09,9896
00713,元大台灣高息低波,15,2,13,元大-台南,2024-09-09,9896
2356,英業達,21,8,13,元大-台南,2024-09-09,9896
00947,台新臺灣IC設計,13,0,13,元大-台南,2024-09-09,9896
2609,陽明,29,17,12,元大-台南,2024-09-09,9896
2615,萬海,13,1,12,元大-台南,2024-09-09,9896
2495,普安,12,0,12,元大-台南,2024-09-09,9896
00687B,國泰20年美債,284,12,272,元大-台南,2024-09-10,9896
00918,大華優利高填息30,223,0,223,元大-台南,2024-09-10,9896
00936,台新永續高息中小,155,3,152,元大-台南,2024-09-10,9896
00940,元大台灣價值高息,156,10,146,元大-台南,2024-09-10,9896
2025,千興,118,0,118,元大-台南,2024-09-10,9896
00919,群益台灣精選高息,118,3,115,元大-台南,2024-09-10,9896
00900,富邦特選高股息30,100,1,99,元大-台南,2024-09-10,9896
00688L,國泰20年美債正2,102,4,98,元大-台南,2024-09-10,9896
00929,復華台灣科技優息,156,74,82,元大-台南,2024-09-10,9896
2399,映泰,72,11,61,元大-台南,2024-09-10,9896
1710,東聯,55,0,55,元大-台南,2024-09-10,9896
2883,凱基金,43,1,42,元大-台南,2024-09-10,9896
00715L,期街口布蘭特正2,38,0,38,元大-台南,2024-09-10,9896
0056,元大高股息,41,3,38,元大-台南,2024-09-10,9896
2618,長榮航,49,11,38,元大-台南,2024-09-10,9896
2382,廣達,49,13,36,元大-台南,2024-09-10,9896
4526,東台,41,5,36,元大-台南,2024-09-10,9896
00878,國泰永續高股息,37,2,35,元大-台南,2024-09-10,9896
1605,華新,37,2,35,元大-台南,2024-09-10,9896
00946,群益科技高息成長,34,1,33,元大-台南,2024-09-10,9896
6152,百一,31,2,29,元大-台南,2024-09-10,9896
00680L,元大美債20正2,58,30,28,元大-台南,2024-09-10,9896
2337,旺宏,29,1,28,元大-台南,2024-09-10,9896
6187,萬潤,49,22,27,元大-台南,2024-09-10,9896
2313,華通,66,39,27,元大-台南,2024-09-10,9896
2330,台積電,38,12,26,元大-台南,2024-09-10,9896
1815,富喬,35,12,23,元大-台南,2024-09-10,9896
1609,大亞,33,10,23,元大-台南,2024-09-10,9896
00795B,中信美國公債20年,20,0,20,元大-台南,2024-09-10,9896
2002,中鋼,23,3,20,元大-台南,2024-09-10,9896
3047,訊舟,24,5,19,元大-台南,2024-09-10,9896
2027,大成鋼,49,30,19,元大-台南,2024-09-10,9896
2464,盟立,19,1,18,元大-台南,2024-09-10,9896
1718,中纖,51,33,18,元大-台南,2024-09-10,9896
5905,南仁湖,24,7,17,元大-台南,2024-09-10,9896
00934,中信成長高股息,18,1,17,元大-台南,2024-09-10,9896
2344,華邦電,16,0,16,元大-台南,2024-09-10,9896
3303,岱稜,20,4,16,元大-台南,2024-09-10,9896
5871,中租-KY,17,1,16,元大-台南,2024-09-10,9896
5011,久陽,15,0,15,元大-台南,2024-09-10,9896
3189,景碩,25,12,13,元大-台南,2024-09-10,9896
2376,技嘉,22,8,14,元大-台南,2024-09-10,9896
2408,南亞科,13,0,13,元大-台南,2024-09-10,9896
6016,康和證,18,5,13,元大-台南,2024-09-10,9896
3715,定穎投控,31,18,13,元大-台南,2024-09-10,9896
0050,元大台灣50,24,11,13,元大-台南,2024-09-10,9896
00947,台新臺灣IC設計,12,0,12,元大-台南,2024-09-10,9896
3025,星通,36,24,12,元大-台南,2024-09-10,9896
00882,中信中國高股息,14,3,11,元大-台南,2024-09-10,9896
2356,英業達,16,5,11,元大-台南,2024-09-10,9896
00632R,元大台灣50反1,305,20,285,元大-台南,2024-09-11,9896
3481,群創,347,85,262,元大-台南,2024-09-11,9896
00915,凱基優選高股息30,242,0,242,元大-台南,2024-09-11,9896
6727,亞泰金屬,210,0,210,元大-台南,2024-09-11,9896
2409,友達,301,117,184,元大-台南,2024-09-11,9896
00642U,期元大S＆P石油,167,1,166,元大-台南,2024-09-11,9896
00715L,期街口布蘭特正2,172,16,156,元大-台南,2024-09-11,9896
2025,千興,129,0,129,元大-台南,2024-09-11,9896
00940,元大台灣價值高息,162,51,111,元大-台南,2024-09-11,9896
00948B,中信優息投資級債,93,2,91,元大-台南,2024-09-11,9896
00688L,國泰20年美債正2,108,20,88,元大-台南,2024-09-11,9896
1522,堤維西,69,2,67,元大-台南,2024-09-11,9896
00929,復華台灣科技優息,85,26,59,元大-台南,2024-09-11,9896
8358,金居,62,4,58,元大-台南,2024-09-11,9896
6152,百一,62,7,55,元大-台南,2024-09-11,9896
00687B,國泰20年美債,78,25,53,元大-台南,2024-09-11,9896
2891,中信金,56,3,53,元大-台南,2024-09-11,9896
00882,中信中國高股息,54,2,52,元大-台南,2024-09-11,9896
2609,陽明,66,16,50,元大-台南,2024-09-11,9896
1711,永光,57,9,48,元大-台南,2024-09-11,9896
2867,三商壽,50,5,45,元大-台南,2024-09-11,9896
00878,國泰永續高股息,40,0,40,元大-台南,2024-09-11,9896
8011,台通,35,0,35,元大-台南,2024-09-11,9896
2313,華通,47,13,34,元大-台南,2024-09-11,9896
00738U,期元大道瓊白銀,35,1,34,元大-台南,2024-09-11,9896
2540,愛山林,31,0,31,元大-台南,2024-09-11,9896
2353,宏��,34,5,29,元大-台南,2024-09-11,9896
00708L,期元大S＆P黃金正2,25,0,25,元大-台南,2024-09-11,9896
6216,居易,22,0,22,元大-台南,2024-09-11,9896
00900,富邦特選高股息30,21,0,21,元大-台南,2024-09-11,9896
1710,東聯,21,0,21,元大-台南,2024-09-11,9896
2905,三商,21,0,21,元大-台南,2024-09-11,9896
00955,中信日本商社,20,0,20,元大-台南,2024-09-11,9896
2892,第一金,20,0,20,元大-台南,2024-09-11,9896
00679B,元大美債20年,42,23,19,元大-台南,2024-09-11,9896
0056,元大高股息,20,2,18,元大-台南,2024-09-11,9896
00751B,元大AAA至A公司債,19,3,16,元大-台南,2024-09-11,9896
3284,太普高,16,0,16,元大-台南,2024-09-11,9896
00959B,大華投等美債15Y+,15,0,15,元大-台南,2024-09-11,9896
4526,東台,20,5,15,元大-台南,2024-09-11,9896
00712,復華富時不動產,15,0,15,元大-台南,2024-09-11,9896
2002,中鋼,17,2,15,元大-台南,2024-09-11,9896
00720B,元大投資級公司債,17,3,14,元大-台南,2024-09-11,9896
00919,群益台灣精選高息,66,52,14,元大-台南,2024-09-11,9896
2464,盟立,14,0,14,元大-台南,2024-09-11,9896
2317,鴻海,18,5,13,元大-台南,2024-09-11,9896
4907,富宇,12,0,12,元大-台南,2024-09-11,9896
2834,臺企銀,12,1,11,元大-台南,2024-09-11,9896
3062,建漢,20,9,11,元大-台南,2024-09-11,9896
2495,普安,11,0,11,元大-台南,2024-09-11,9896
00632R,元大台灣50反1,1206,62,1144,元大-台南,2024-09-12,9896
00937B,群益ESG投等債20,871,52,819,元大-台南,2024-09-12,9896
00680L,元大美債20正2,198,51,147,元大-台南,2024-09-12,9896
00688L,國泰20年美債正2,137,4,133,元大-台南,2024-09-12,9896
00706L,期元大S＆P日圓正2,129,10,119,元大-台南,2024-09-12,9896
2025,千興,90,0,90,元大-台南,2024-09-12,9896
2891,中信金,91,5,86,元大-台南,2024-09-12,9896
2885,元大金,57,3,54,元大-台南,2024-09-12,9896
00919,群益台灣精選高息,63,16,47,元大-台南,2024-09-12,9896
00878,國泰永續高股息,52,10,42,元大-台南,2024-09-12,9896
00959B,大華投等美債15Y+,40,0,40,元大-台南,2024-09-12,9896
8358,金居,40,0,40,元大-台南,2024-09-12,9896
2905,三商,31,0,31,元大-台南,2024-09-12,9896
00948B,中信優息投資級債,29,2,27,元大-台南,2024-09-12,9896
6134,萬旭,34,8,26,元大-台南,2024-09-12,9896
2352,佳世達,25,0,25,元大-台南,2024-09-12,9896
6133,金橋,22,1,21,元大-台南,2024-09-12,9896
6125,廣運,19,1,18,元大-台南,2024-09-12,9896
0050,元大台灣50,32,14,18,元大-台南,2024-09-12,9896
00929,復華台灣科技優息,57,40,17,元大-台南,2024-09-12,9896
00915,凱基優選高股息30,18,2,16,元大-台南,2024-09-12,9896
6727,亞泰金屬,14,0,14,元大-台南,2024-09-12,9896
1711,永光,46,33,13,元大-台南,2024-09-12,9896
5905,南仁湖,14,1,13,元大-台南,2024-09-12,9896
6805,富世達,13,0,13,元大-台南,2024-09-12,9896
3303,岱稜,76,63,13,元大-台南,2024-09-12,9896
8070,長華*,28,16,12,元大-台南,2024-09-12,9896
3047,訊舟,12,0,12,元大-台南,2024-09-12,9896
2002,中鋼,14,2,12,元大-台南,2024-09-12,9896
4766,南寶,11,0,11,元大-台南,2024-09-12,9896
3535,晶彩科,17,7,10,元大-台南,2024-09-12,9896
00857B,永豐20年美公債,10,0,10,元大-台南,2024-09-12,9896
3607,谷崧,11,1,10,元大-台南,2024-09-12,9896
2349,錸德,10,0,10,元大-台南,2024-09-12,9896
6767,台微醫,10,0,10,元大-台南,2024-09-12,9896
8071,能率網通,10,0,10,元大-台南,2024-09-12,9896
2464,盟立,15,6,9,元大-台南,2024-09-12,9896
00720B,元大投資級公司債,8,0,8,元大-台南,2024-09-12,9896
2329,華泰,11,3,8,元大-台南,2024-09-12,9896
2542,興富發,8,0,8,元大-台南,2024-09-12,9896
2399,映泰,24,17,7,元大-台南,2024-09-12,9896
3013,晟銘電,14,7,7,元大-台南,2024-09-12,9896
2883,凱基金,17,10,7,元大-台南,2024-09-12,9896
2618,長榮航,27,21,6,元大-台南,2024-09-12,9896
1584,精剛,10,4,6,元大-台南,2024-09-12,9896
00669R,國泰美國道瓊反1,6,0,6,元大-台南,2024-09-12,9896
2020,美亞,6,0,6,元大-台南,2024-09-12,9896
2472,立隆電,6,0,6,元大-台南,2024-09-12,9896
5355,佳總,8,2,6,元大-台南,2024-09-12,9896
00941,中信上游半導體,10,5,5,元大-台南,2024-09-12,9896
00687B,國泰20年美債,222,11,211,元大-台南,2024-09-13,9896
2025,千興,114,0,114,元大-台南,2024-09-13,9896
00948B,中信優息投資級債,114,4,110,元大-台南,2024-09-13,9896
00679B,元大美債20年,118,26,92,元大-台南,2024-09-13,9896
00680L,元大美債20正2,104,20,84,元大-台南,2024-09-13,9896
6177,達麗,71,5,66,元大-台南,2024-09-13,9896
00919,群益台灣精選高息,78,17,61,元大-台南,2024-09-13,9896
5876,上海商銀,50,0,50,元大-台南,2024-09-13,9896
2515,中工,50,8,42,元大-台南,2024-09-13,9896
6285,啟��,40,0,40,元大-台南,2024-09-13,9896
00929,復華台灣科技優息,46,7,39,元大-台南,2024-09-13,9896
1718,中纖,35,0,35,元大-台南,2024-09-13,9896
1524,耿鼎,35,4,31,元大-台南,2024-09-13,9896
00673R,期元大S＆P原油反1,71,40,31,元大-台南,2024-09-13,9896
00918,大華優利高填息30,29,2,27,元大-台南,2024-09-13,9896
2348,海悅,25,0,25,元大-台南,2024-09-13,9896
1309,台達化,24,1,23,元大-台南,2024-09-13,9896
00941,中信上游半導體,21,0,21,元大-台南,2024-09-13,9896
2883,凱基金,26,5,21,元大-台南,2024-09-13,9896
2390,云辰,20,0,20,元大-台南,2024-09-13,9896
00715L,期街口布蘭特正2,47,28,19,元大-台南,2024-09-13,9896
8277,商丞,19,2,17,元大-台南,2024-09-13,9896
8074,鉅橡,17,1,16,元大-台南,2024-09-13,9896
2317,鴻海,36,20,16,元大-台南,2024-09-13,9896
3013,晟銘電,33,18,15,元大-台南,2024-09-13,9896
6805,富世達,14,0,14,元大-台南,2024-09-13,9896
2867,三商壽,18,5,13,元大-台南,2024-09-13,9896
2905,三商,13,0,13,元大-台南,2024-09-13,9896
1795,美時,12,0,12,元大-台南,2024-09-13,9896
3550,聯穎,15,3,12,元大-台南,2024-09-13,9896
2401,凌陽,11,0,11,元大-台南,2024-09-13,9896
8091,翔名,11,0,11,元大-台南,2024-09-13,9896
8932,智通*,11,0,11,元大-台南,2024-09-13,9896
2393,億光,11,0,11,元大-台南,2024-09-13,9896
6194,育富,14,4,10,元大-台南,2024-09-13,9896
00915,凱基優選高股息30,15,5,10,元大-台南,2024-09-13,9896
00933B,國泰10Y+金融債,10,0,10,元大-台南,2024-09-13,9896
3290,東浦,10,0,10,元大-台南,2024-09-13,9896
00885,富邦越南,10,0,10,元大-台南,2024-09-13,9896
00953B,群益優選非投等債,10,0,10,元大-台南,2024-09-13,9896
3296,勝德,10,0,10,元大-台南,2024-09-13,9896
4510,高鋒,14,4,10,元大-台南,2024-09-13,9896
1727,中華化,10,0,10,元大-台南,2024-09-13,9896
2449,京元電子,13,4,9,元大-台南,2024-09-13,9896
2497,怡利電,50,41,9,元大-台南,2024-09-13,9896
1584,精剛,11,2,9,元大-台南,2024-09-13,9896
6830,汎銓,13,4,9,元大-台南,2024-09-13,9896
8039,台虹,11,2,9,元大-台南,2024-09-13,9896
00931B,統一美債20年,11,2,9,元大-台南,2024-09-13,9896
2049,上銀,9,0,9,元大-台南,2024-09-13,9896
00687B,國泰20年美債,222,11,211,元大-台南,2024-09-16,9896
2025,千興,130,0,130,元大-台南,2024-09-16,9896
00915,凱基優選高股息30,117,1,116,元大-台南,2024-09-16,9896
00918,大華優利高填息30,109,3,106,元大-台南,2024-09-16,9896
00919,群益台灣精選高息,107,7,100,元大-台南,2024-09-16,9896
00929,復華台灣科技優息,116,23,93,元大-台南,2024-09-16,9896
2033,佳大,55,5,50,元大-台南,2024-09-16,9896
00679B,元大美債20年,103,53,50,元大-台南,2024-09-16,9896
00948B,中信優息投資級債,51,3,48,元大-台南,2024-09-16,9896
1711,永光,57,22,35,元大-台南,2024-09-16,9896
00715L,期街口布蘭特正2,34,0,34,元大-台南,2024-09-16,9896
00688L,國泰20年美債正2,43,18,25,元大-台南,2024-09-16,9896
6177,達麗,26,1,25,元大-台南,2024-09-16,9896
3290,東浦,31,10,21,元大-台南,2024-09-16,9896
2449,京元電子,25,5,20,元大-台南,2024-09-16,9896
00952,凱基台灣AI50,20,0,20,元大-台南,2024-09-16,9896
8150,南茂,20,0,20,元大-台南,2024-09-16,9896
0056,元大高股息,25,6,19,元大-台南,2024-09-16,9896
00885,富邦越南,18,0,18,元大-台南,2024-09-16,9896
2348,海悅,18,0,18,元大-台南,2024-09-16,9896
00857B,永豐20年美公債,18,0,18,元大-台南,2024-09-16,9896
00719B,元大美債1-3,17,0,17,元大-台南,2024-09-16,9896
00942B,台新美A公司債20+,15,0,15,元大-台南,2024-09-16,9896
9905,大華,15,0,15,元大-台南,2024-09-16,9896
2390,云辰,15,0,15,元大-台南,2024-09-16,9896
00650L,復華香港正2,15,0,15,元大-台南,2024-09-16,9896
00933B,國泰10Y+金融債,16,1,15,元大-台南,2024-09-16,9896
2637,慧洋-KY,15,1,14,元大-台南,2024-09-16,9896
2426,鼎元,18,4,14,元大-台南,2024-09-16,9896
3577,泓格,13,0,13,元大-台南,2024-09-16,9896
2399,映泰,14,1,13,元大-台南,2024-09-16,9896
00637L,元大滬深300正2,23,10,13,元大-台南,2024-09-16,9896
2464,盟立,14,2,12,元大-台南,2024-09-16,9896
5355,佳總,16,4,12,元大-台南,2024-09-16,9896
5347,世界,12,1,11,元大-台南,2024-09-16,9896
6612,奈米醫材,13,2,11,元大-台南,2024-09-16,9896
3024,憶聲,11,0,11,元大-台南,2024-09-16,9896
2349,錸德,65,54,11,元大-台南,2024-09-16,9896
00931B,統一美債20年,17,6,11,元大-台南,2024-09-16,9896
2365,昆盈,16,6,10,元大-台南,2024-09-16,9896
1319,東陽,11,1,10,元大-台南,2024-09-16,9896
1563,巧新,10,0,10,元大-台南,2024-09-16,9896
00773B,中信優先金融債,10,0,10,元大-台南,2024-09-16,9896
3266,昇陽,10,0,10,元大-台南,2024-09-16,9896
00664R,國泰臺灣加權反1,10,0,10,元大-台南,2024-09-16,9896
5438,東友,10,0,10,元大-台南,2024-09-16,9896
00953B,群益優選非投等債,10,0,10,元大-台南,2024-09-16,9896
2406,國碩,11,2,9,元大-台南,2024-09-16,9896
00946,群益科技高息成長,10,1,9,元大-台南,2024-09-16,9896
2883,凱基金,10,1,9,元大-台南,2024-09-16,9896
00929,復華台灣科技優息,213,35,178,元大-台南,2024-09-18,9896
3550,聯穎,178,69,109,元大-台南,2024-09-18,9896
00878,國泰永續高股息,115,7,108,元大-台南,2024-09-18,9896
00919,群益台灣精選高息,125,20,105,元大-台南,2024-09-18,9896
2033,佳大,141,38,103,元大-台南,2024-09-18,9896
00679B,元大美債20年,93,1,92,元大-台南,2024-09-18,9896
00918,大華優利高填息30,92,0,92,元大-台南,2024-09-18,9896
3715,定穎投控,94,5,89,元大-台南,2024-09-18,9896
00713,元大台灣高息低波,76,2,74,元大-台南,2024-09-18,9896
1301,台塑,74,4,70,元大-台南,2024-09-18,9896
2025,千興,66,0,66,元大-台南,2024-09-18,9896
2489,瑞軒,62,1,61,元大-台南,2024-09-18,9896
00930,永豐ESG低碳高息,61,0,61,元大-台南,2024-09-18,9896
2317,鴻海,92,32,60,元大-台南,2024-09-18,9896
4108,懷特,60,1,59,元大-台南,2024-09-18,9896
00687B,國泰20年美債,61,6,55,元大-台南,2024-09-18,9896
00915,凱基優選高股息30,57,3,54,元大-台南,2024-09-18,9896
00934,中信成長高股息,54,1,53,元大-台南,2024-09-18,9896
00673R,期元大S＆P原油反1,47,0,47,元大-台南,2024-09-18,9896
9105,泰金寶-DR,50,4,46,元大-台南,2024-09-18,9896
0056,元大高股息,47,2,45,元大-台南,2024-09-18,9896
3062,建漢,64,19,45,元大-台南,2024-09-18,9896
00945B,凱基美國非投等債,43,0,43,元大-台南,2024-09-18,9896
2867,三商壽,49,14,35,元大-台南,2024-09-18,9896
4958,臻鼎-KY,32,0,32,元大-台南,2024-09-18,9896
1776,展宇,30,1,29,元大-台南,2024-09-18,9896
2324,仁寶,30,1,29,元大-台南,2024-09-18,9896
1717,長興,67,42,25,元大-台南,2024-09-18,9896
00680L,元大美債20正2,32,9,23,元大-台南,2024-09-18,9896
4909,新復興,42,22,20,元大-台南,2024-09-18,9896
2344,華邦電,16,0,16,元大-台南,2024-09-18,9896
2356,英業達,18,2,16,元大-台南,2024-09-18,9896
00927,群益半導體收益,14,0,14,元大-台南,2024-09-18,9896
3264,欣銓,14,0,14,元大-台南,2024-09-18,9896
00891,中信關鍵半導體,15,1,14,元大-台南,2024-09-18,9896
00935,野村臺灣新科技50,13,0,13,元大-台南,2024-09-18,9896
1711,永光,69,57,12,元大-台南,2024-09-18,9896
5871,中租-KY,12,0,12,元大-台南,2024-09-18,9896
1718,中纖,22,10,12,元大-台南,2024-09-18,9896
5206,坤悅,12,0,12,元大-台南,2024-09-18,9896
00881,國泰台灣5G+,18,6,12,元大-台南,2024-09-18,9896
00631L,元大台灣50正2,13,1,12,元大-台南,2024-09-18,9896
1309,台達化,20,9,11,元大-台南,2024-09-18,9896
8086,宏捷科,11,0,11,元大-台南,2024-09-18,9896
1515,力山,13,2,11,元大-台南,2024-09-18,9896
4155,訊映,11,0,11,元大-台南,2024-09-18,9896
3033,威健,12,1,11,元大-台南,2024-09-18,9896
1609,大亞,26,15,11,元大-台南,2024-09-18,9896
3540,曜越,15,5,10,元大-台南,2024-09-18,9896
00753L,中信中國50正2,10,0,10,元大-台南,2024-09-18,9896
00937B,群益ESG投等債20,1040,105,935,元大-台南,2024-09-19,9896
2025,千興,645,0,645,元大-台南,2024-09-19,9896
00632R,元大台灣50反1,419,5,414,元大-台南,2024-09-19,9896
00680L,元大美債20正2,453,74,379,元大-台南,2024-09-19,9896
00688L,國泰20年美債正2,287,40,247,元大-台南,2024-09-19,9896
00919,群益台灣精選高息,209,45,164,元大-台南,2024-09-19,9896
00679B,元大美債20年,188,35,153,元大-台南,2024-09-19,9896
00933B,國泰10Y+金融債,127,0,127,元大-台南,2024-09-19,9896
00687B,國泰20年美債,223,115,108,元大-台南,2024-09-19,9896
00929,復華台灣科技優息,129,32,97,元大-台南,2024-09-19,9896
00706L,期元大S＆P日圓正2,127,64,63,元大-台南,2024-09-19,9896
2897,王道銀行,50,0,50,元大-台南,2024-09-19,9896
00948B,中信優息投資級債,150,101,49,元大-台南,2024-09-19,9896
2313,華通,53,4,49,元大-台南,2024-09-19,9896
6125,廣運,61,12,49,元大-台南,2024-09-19,9896
00958B,永豐ESG銀行債15,48,0,48,元大-台南,2024-09-19,9896
00915,凱基優選高股息30,54,7,47,元大-台南,2024-09-19,9896
0056,元大高股息,47,2,45,元大-台南,2024-09-19,9896
8040,九暘,31,0,31,元大-台南,2024-09-19,9896
00918,大華優利高填息30,34,6,28,元大-台南,2024-09-19,9896
2891,中信金,34,7,27,元大-台南,2024-09-19,9896
5905,南仁湖,48,22,26,元大-台南,2024-09-19,9896
3049,精金,60,36,24,元大-台南,2024-09-19,9896
1301,台塑,36,14,22,元大-台南,2024-09-19,9896
00940,元大台灣價值高息,38,16,22,元大-台南,2024-09-19,9896
2344,華邦電,22,4,18,元大-台南,2024-09-19,9896
8011,台通,22,5,17,元大-台南,2024-09-19,9896
3580,友威科,14,3,11,元大-台南,2024-09-19,9896
00795B,中信美國公債20年,11,0,11,元大-台南,2024-09-19,9896
00930,永豐ESG低碳高息,11,0,11,元大-台南,2024-09-19,9896
3607,谷崧,21,10,11,元大-台南,2024-09-19,9896
00713,元大台灣高息低波,16,5,11,元大-台南,2024-09-19,9896
00931B,統一美債20年,11,0,11,元大-台南,2024-09-19,9896
2615,萬海,12,2,10,元大-台南,2024-09-19,9896
2462,良得電,10,0,10,元大-台南,2024-09-19,9896
2390,云辰,10,0,10,元大-台南,2024-09-19,9896
00651R,復華香港反1,10,0,10,元大-台南,2024-09-19,9896
1718,中纖,10,0,10,元大-台南,2024-09-19,9896
1609,大亞,14,5,9,元大-台南,2024-09-19,9896
00953B,群益優選非投等債,9,0,9,元大-台南,2024-09-19,9896
00738U,期元大道瓊白銀,9,0,9,元大-台南,2024-09-19,9896
00635U,期元大S＆P黃金,8,0,8,元大-台南,2024-09-19,9896
00673R,期元大S＆P原油反1,8,0,8,元大-台南,2024-09-19,9896
2401,凌陽,8,0,8,元大-台南,2024-09-19,9896
2002,中鋼,8,1,7,元大-台南,2024-09-19,9896
2515,中工,7,0,7,元大-台南,2024-09-19,9896
1524,耿鼎,7,0,7,元大-台南,2024-09-19,9896
6290,良維,7,0,7,元大-台南,2024-09-19,9896
4513,福裕,9,2,7,元大-台南,2024-09-19,9896
6806,森崴能源,7,1,6,元大-台南,2024-09-19,9896
2025,千興,266,0,266,元大-台南,2024-09-20,9896
2888,新光金,233,20,213,元大-台南,2024-09-20,9896
00919,群益台灣精選高息,229,23,206,元大-台南,2024-09-20,9896
2313,華通,188,6,182,元大-台南,2024-09-20,9896
00948B,中信優息投資級債,110,0,110,元大-台南,2024-09-20,9896
00673R,期元大S＆P原油反1,80,0,80,元大-台南,2024-09-20,9896
00937B,群益ESG投等債20,95,25,70,元大-台南,2024-09-20,9896
00688L,國泰20年美債正2,86,20,66,元大-台南,2024-09-20,9896
2891,中信金,137,85,52,元大-台南,2024-09-20,9896
3049,精金,73,26,47,元大-台南,2024-09-20,9896
00706L,期元大S＆P日圓正2,41,0,41,元大-台南,2024-09-20,9896
1785,光洋科,86,45,41,元大-台南,2024-09-20,9896
6727,亞泰金屬,41,2,39,元大-台南,2024-09-20,9896
00929,復華台灣科技優息,60,25,35,元大-台南,2024-09-20,9896
4306,炎洲,35,0,35,元大-台南,2024-09-20,9896
00915,凱基優選高股息30,41,8,33,元大-台南,2024-09-20,9896
00715L,期街口布蘭特正2,102,71,31,元大-台南,2024-09-20,9896
00687B,國泰20年美債,61,30,31,元大-台南,2024-09-20,9896
9945,潤泰新,33,3,30,元大-台南,2024-09-20,9896
3512,皇龍,30,0,30,元大-台南,2024-09-20,9896
00772B,中信高評級公司債,25,0,25,元大-台南,2024-09-20,9896
00680L,元大美債20正2,53,28,25,元大-台南,2024-09-20,9896
2515,中工,35,11,24,元大-台南,2024-09-20,9896
2408,南亞科,25,1,24,元大-台南,2024-09-20,9896
2542,興富發,22,1,21,元大-台南,2024-09-20,9896
00655L,國泰中國A50正2,20,0,20,元大-台南,2024-09-20,9896
00637L,元大滬深300正2,31,12,19,元大-台南,2024-09-20,9896
3576,聯合再生,19,0,19,元大-台南,2024-09-20,9896
3062,建漢,62,44,18,元大-台南,2024-09-20,9896
00679B,元大美債20年,32,16,16,元大-台南,2024-09-20,9896
6757,台灣虎航,16,0,16,元大-台南,2024-09-20,9896
2520,冠德,21,6,15,元大-台南,2024-09-20,9896
2867,三商壽,39,24,15,元大-台南,2024-09-20,9896
00713,元大台灣高息低波,29,14,15,元大-台南,2024-09-20,9896
8070,長華*,83,69,14,元大-台南,2024-09-20,9896
2399,映泰,66,53,13,元大-台南,2024-09-20,9896
2002,中鋼,14,1,13,元大-台南,2024-09-20,9896
8277,商丞,12,0,12,元大-台南,2024-09-20,9896
2312,金寶,14,2,12,元大-台南,2024-09-20,9896
2062,橋椿,16,5,11,元大-台南,2024-09-20,9896
00946,群益科技高息成長,12,1,11,元大-台南,2024-09-20,9896
5905,南仁湖,64,53,11,元大-台南,2024-09-20,9896
2883,凱基金,22,11,11,元大-台南,2024-09-20,9896
1446,宏和,10,0,10,元大-台南,2024-09-20,9896
1316,上曜,14,4,10,元大-台南,2024-09-20,9896
6506,雙邦,10,0,10,元大-台南,2024-09-20,9896
1718,中纖,10,0,10,元大-台南,2024-09-20,9896
8110,華東,10,0,10,元大-台南,2024-09-20,9896
3596,智易,10,0,10,元大-台南,2024-09-20,9896
8421,旭源,10,0,10,元大-台南,2024-09-20,9896
00687B,國泰20年美債,311,97,214,元大-台南,2024-09-23,9896
1718,中纖,131,0,131,元大-台南,2024-09-23,9896
00706L,期元大S＆P日圓正2,128,0,128,元大-台南,2024-09-23,9896
00919,群益台灣精選高息,143,58,85,元大-台南,2024-09-23,9896
00679B,元大美債20年,101,24,77,元大-台南,2024-09-23,9896
2025,千興,66,0,66,元大-台南,2024-09-23,9896
00937B,群益ESG投等債20,57,8,49,元大-台南,2024-09-23,9896
00929,復華台灣科技優息,66,21,45,元大-台南,2024-09-23,9896
8040,九暘,45,1,44,元大-台南,2024-09-23,9896
3062,建漢,61,17,44,元大-台南,2024-09-23,9896
3615,安可,53,13,40,元大-台南,2024-09-23,9896
00915,凱基優選高股息30,46,6,40,元大-台南,2024-09-23,9896
00948B,中信優息投資級債,102,63,39,元大-台南,2024-09-23,9896
2409,友達,35,0,35,元大-台南,2024-09-23,9896
2464,盟立,39,6,33,元大-台南,2024-09-23,9896
6506,雙邦,42,10,32,元大-台南,2024-09-23,9896
1709,和益,31,0,31,元大-台南,2024-09-23,9896
00673R,期元大S＆P原油反1,31,0,31,元大-台南,2024-09-23,9896
4306,炎洲,32,3,29,元大-台南,2024-09-23,9896
2495,普安,29,3,26,元大-台南,2024-09-23,9896
6213,聯茂,26,1,25,元大-台南,2024-09-23,9896
00665L,富邦�琤肭磪囓�2,25,0,25,元大-台南,2024-09-23,9896
2027,大成鋼,37,12,25,元大-台南,2024-09-23,9896
1438,三地開發,23,0,23,元大-台南,2024-09-23,9896
1785,光洋科,37,14,23,元大-台南,2024-09-23,9896
4108,懷特,22,0,22,元大-台南,2024-09-23,9896
2390,云辰,29,7,22,元大-台南,2024-09-23,9896
00900,富邦特選高股息30,20,0,20,元大-台南,2024-09-23,9896
4707,磐亞,18,0,18,元大-台南,2024-09-23,9896
2399,映泰,51,34,17,元大-台南,2024-09-23,9896
00713,元大台灣高息低波,20,4,16,元大-台南,2024-09-23,9896
2228,劍麟,15,0,15,元大-台南,2024-09-23,9896
6488,環球晶,16,1,15,元大-台南,2024-09-23,9896
00958B,永豐ESG銀行債15,15,0,15,元大-台南,2024-09-23,9896
6134,萬旭,15,0,15,元大-台南,2024-09-23,9896
2431,聯昌,15,1,14,元大-台南,2024-09-23,9896
8064,東捷,20,7,13,元大-台南,2024-09-23,9896
1725,元禎,13,0,13,元大-台南,2024-09-23,9896
00960,野村全球航運龍頭,13,0,13,元大-台南,2024-09-23,9896
4711,永純,16,3,13,元大-台南,2024-09-23,9896
6425,易發,12,1,11,元大-台南,2024-09-23,9896
1723,中碳,11,0,11,元大-台南,2024-09-23,9896
4303,信立,11,0,11,元大-台南,2024-09-23,9896
3312,弘憶股,11,0,11,元大-台南,2024-09-23,9896
9105,泰金寶-DR,17,6,11,元大-台南,2024-09-23,9896
2449,京元電子,11,1,10,元大-台南,2024-09-23,9896
4114,健喬,10,0,10,元大-台南,2024-09-23,9896
5905,南仁湖,11,1,10,元大-台南,2024-09-23,9896
5481,新華,27,17,10,元大-台南,2024-09-23,9896
1721,三晃,68,58,10,元大-台南,2024-09-23,9896
6177,達麗,161,4,157,元大-台南,2024-09-24,9896
2025,千興,155,0,155,元大-台南,2024-09-24,9896
2610,華航,164,23,141,元大-台南,2024-09-24,9896
2891,中信金,155,29,126,元大-台南,2024-09-24,9896
00679B,元大美債20年,92,3,89,元大-台南,2024-09-24,9896
00919,群益台灣精選高息,84,2,82,元大-台南,2024-09-24,9896
00929,復華台灣科技優息,96,23,73,元大-台南,2024-09-24,9896
00632R,元大台灣50反1,88,20,68,元大-台南,2024-09-24,9896
00687B,國泰20年美債,67,5,62,元大-台南,2024-09-24,9896
2887,台新金,58,2,56,元大-台南,2024-09-24,9896
2348,海悅,56,1,55,元大-台南,2024-09-24,9896
3019,亞光,58,5,53,元大-台南,2024-09-24,9896
2439,美律,50,0,50,元大-台南,2024-09-24,9896
00700,富邦�琤肭磪�,50,0,50,元大-台南,2024-09-24,9896
1718,中纖,51,7,44,元大-台南,2024-09-24,9896
0056,元大高股息,43,0,43,元大-台南,2024-09-24,9896
6405,悅城,40,8,32,元大-台南,2024-09-24,9896
00958B,永豐ESG銀行債15,31,0,31,元大-台南,2024-09-24,9896
4442,竣邦-KY,30,0,30,元大-台南,2024-09-24,9896
1711,永光,48,19,29,元大-台南,2024-09-24,9896
00933B,國泰10Y+金融債,30,3,27,元大-台南,2024-09-24,9896
6706,惠特,37,10,27,元大-台南,2024-09-24,9896
00680L,元大美債20正2,45,20,25,元大-台南,2024-09-24,9896
2634,漢翔,32,8,24,元大-台南,2024-09-24,9896
2464,盟立,30,8,22,元大-台南,2024-09-24,9896
00753L,中信中國50正2,22,0,22,元大-台南,2024-09-24,9896
00918,大華優利高填息30,46,25,21,元大-台南,2024-09-24,9896
00915,凱基優選高股息30,27,6,21,元大-台南,2024-09-24,9896
00673R,期元大S＆P原油反1,20,1,19,元大-台南,2024-09-24,9896
3284,太普高,27,8,19,元大-台南,2024-09-24,9896
00665L,富邦�琤肭磪囓�2,20,1,19,元大-台南,2024-09-24,9896
4967,十銓,20,1,19,元大-台南,2024-09-24,9896
1303,南亞,21,4,17,元大-台南,2024-09-24,9896
00720B,元大投資級公司債,16,0,16,元大-台南,2024-09-24,9896
6241,易通展,15,1,14,元大-台南,2024-09-24,9896
2481,強茂,20,7,13,元大-台南,2024-09-24,9896
3537,堡達,13,0,13,元大-台南,2024-09-24,9896
00878,國泰永續高股息,25,12,13,元大-台南,2024-09-24,9896
3714,富采,20,8,12,元大-台南,2024-09-24,9896
3013,晟銘電,32,20,12,元大-台南,2024-09-24,9896
3037,欣興,13,1,12,元大-台南,2024-09-24,9896
6929,佑全,12,0,12,元大-台南,2024-09-24,9896
1539,巨庭,23,11,12,元大-台南,2024-09-24,9896
6446,藥華藥,17,6,11,元大-台南,2024-09-24,9896
00725B,國泰投資級公司債,11,0,11,元大-台南,2024-09-24,9896
2344,華邦電,12,1,11,元大-台南,2024-09-24,9896
2313,華通,26,15,11,元大-台南,2024-09-24,9896
00960,野村全球航運龍頭,22,11,11,元大-台南,2024-09-24,9896
00948B,中信優息投資級債,11,0,11,元大-台南,2024-09-24,9896
2349,錸德,23,13,10,元大-台南,2024-09-24,9896
00960,野村全球航運龍頭,293,58,235,元大-台南,2024-09-25,9896
3231,緯創,217,17,200,元大-台南,2024-09-25,9896
8069,元太,153,2,151,元大-台南,2024-09-25,9896
2025,千興,103,0,103,元大-台南,2024-09-25,9896
4530,宏易,69,0,69,元大-台南,2024-09-25,9896
6241,易通展,66,1,65,元大-台南,2024-09-25,9896
2888,新光金,120,56,64,元大-台南,2024-09-25,9896
00632R,元大台灣50反1,201,144,57,元大-台南,2024-09-25,9896
00639,富邦深100,50,0,50,元大-台南,2024-09-25,9896
00651R,復華香港反1,70,20,50,元大-台南,2024-09-25,9896
00772B,中信高評級公司債,50,0,50,元大-台南,2024-09-25,9896
2892,第一金,35,2,33,元大-台南,2024-09-25,9896
2017,官田鋼,32,0,32,元大-台南,2024-09-25,9896
00937B,群益ESG投等債20,41,9,32,元大-台南,2024-09-25,9896
2883,凱基金,47,16,31,元大-台南,2024-09-25,9896
00673R,期元大S＆P原油反1,30,0,30,元大-台南,2024-09-25,9896
3715,定穎投控,58,29,29,元大-台南,2024-09-25,9896
00919,群益台灣精選高息,36,11,25,元大-台南,2024-09-25,9896
00679B,元大美債20年,43,18,25,元大-台南,2024-09-25,9896
00720B,元大投資級公司債,25,2,23,元大-台南,2024-09-25,9896
6425,易發,36,13,23,元大-台南,2024-09-25,9896
00752,中信中國50,22,0,22,元大-台南,2024-09-25,9896
8039,台虹,23,1,22,元大-台南,2024-09-25,9896
2605,新興,35,14,21,元大-台南,2024-09-25,9896
00687B,國泰20年美債,70,50,20,元大-台南,2024-09-25,9896
6449,鈺邦,20,0,20,元大-台南,2024-09-25,9896
2388,威盛,26,6,20,元大-台南,2024-09-25,9896
2313,華通,27,7,20,元大-台南,2024-09-25,9896
2442,新美齊,20,0,20,元大-台南,2024-09-25,9896
00933B,國泰10Y+金融債,20,1,19,元大-台南,2024-09-25,9896
3036,文曄,19,0,19,元大-台南,2024-09-25,9896
1438,三地開發,18,0,18,元大-台南,2024-09-25,9896
00929,復華台灣科技優息,67,50,17,元大-台南,2024-09-25,9896
1785,光洋科,24,8,16,元大-台南,2024-09-25,9896
2033,佳大,14,0,14,元大-台南,2024-09-25,9896
4510,高鋒,17,3,14,元大-台南,2024-09-25,9896
6215,和椿,21,8,13,元大-台南,2024-09-25,9896
4903,聯光通,24,12,12,元大-台南,2024-09-25,9896
2367,燿華,35,23,12,元大-台南,2024-09-25,9896
00751B,元大AAA至A公司債,12,1,11,元大-台南,2024-09-25,9896
2353,宏��,14,3,11,元大-台南,2024-09-25,9896
2402,毅嘉,38,27,11,元大-台南,2024-09-25,9896
4908,前鼎,12,1,11,元大-台南,2024-09-25,9896
00706L,期元大S＆P日圓正2,12,1,11,元大-台南,2024-09-25,9896
8064,東捷,22,11,11,元大-台南,2024-09-25,9896
5243,乙盛-KY,13,2,11,元大-台南,2024-09-25,9896
4977,眾達-KY,16,6,10,元大-台南,2024-09-25,9896
2399,映泰,22,12,10,元大-台南,2024-09-25,9896
00676R,富邦臺灣加權反1,10,0,10,元大-台南,2024-09-25,9896
5392,能率,10,0,10,元大-台南,2024-09-25,9896
00632R,元大台灣50反1,275,0,275,元大-台南,2024-09-26,9896
00679B,元大美債20年,258,62,196,元大-台南,2024-09-26,9896
00937B,群益ESG投等債20,122,12,110,元大-台南,2024-09-26,9896
00960,野村全球航運龍頭,220,116,104,元大-台南,2024-09-26,9896
00795B,中信美國公債20年,90,0,90,元大-台南,2024-09-26,9896
00687B,國泰20年美債,257,175,82,元大-台南,2024-09-26,9896
2025,千興,80,0,80,元大-台南,2024-09-26,9896
00772B,中信高評級公司債,61,1,60,元大-台南,2024-09-26,9896
2401,凌陽,47,2,45,元大-台南,2024-09-26,9896
00712,復華富時不動產,44,0,44,元大-台南,2024-09-26,9896
00948B,中信優息投資級債,63,20,43,元大-台南,2024-09-26,9896
5460,同協,44,2,42,元大-台南,2024-09-26,9896
0056,元大高股息,51,10,41,元大-台南,2024-09-26,9896
00715L,期街口布蘭特正2,41,0,41,元大-台南,2024-09-26,9896
2888,新光金,77,39,38,元大-台南,2024-09-26,9896
5355,佳總,103,66,37,元大-台南,2024-09-26,9896
3296,勝德,33,0,33,元大-台南,2024-09-26,9896
2344,華邦電,32,1,31,元大-台南,2024-09-26,9896
3715,定穎投控,43,15,28,元大-台南,2024-09-26,9896
1540,喬福,36,12,24,元大-台南,2024-09-26,9896
4974,亞泰,23,0,23,元大-台南,2024-09-26,9896
5347,世界,22,0,22,元大-台南,2024-09-26,9896
00720B,元大投資級公司債,24,3,21,元大-台南,2024-09-26,9896
3607,谷崧,21,0,21,元大-台南,2024-09-26,9896
00706L,期元大S＆P日圓正2,21,0,21,元大-台南,2024-09-26,9896
1808,潤隆,21,1,20,元大-台南,2024-09-26,9896
2017,官田鋼,20,0,20,元大-台南,2024-09-26,9896
00942B,台新美A公司債20+,30,10,20,元大-台南,2024-09-26,9896
8039,台虹,25,5,20,元大-台南,2024-09-26,9896
3006,晶豪科,34,15,19,元大-台南,2024-09-26,9896
2887,台新金,19,0,19,元大-台南,2024-09-26,9896
00751B,元大AAA至A公司債,28,10,18,元大-台南,2024-09-26,9896
00688L,國泰20年美債正2,55,37,18,元大-台南,2024-09-26,9896
3019,亞光,34,16,18,元大-台南,2024-09-26,9896
2337,旺宏,21,4,17,元大-台南,2024-09-26,9896
00713,元大台灣高息低波,19,2,17,元大-台南,2024-09-26,9896
00959B,大華投等美債15Y+,16,0,16,元大-台南,2024-09-26,9896
006205,富邦上証,17,1,16,元大-台南,2024-09-26,9896
6770,力積電,16,0,16,元大-台南,2024-09-26,9896
00665L,富邦�琤肭磪囓�2,48,34,14,元大-台南,2024-09-26,9896
2426,鼎元,14,0,14,元大-台南,2024-09-26,9896
4716,大立,32,18,14,元大-台南,2024-09-26,9896
2317,鴻海,50,37,13,元大-台南,2024-09-26,9896
2324,仁寶,14,0,14,元大-台南,2024-09-26,9896
00830,國泰費城半導體,20,7,13,元大-台南,2024-09-26,9896
00637L,元大滬深300正2,43,31,12,元大-台南,2024-09-26,9896
2393,億光,15,3,12,元大-台南,2024-09-26,9896
00650L,復華香港正2,12,0,12,元大-台南,2024-09-26,9896
2444,兆勁,12,0,12,元大-台南,2024-09-26,9896
8111,立��,25,13,12,元大-台南,2024-09-26,9896
00687B,國泰20年美債,226,35,191,元大-台南,2024-09-27,9896
00680L,元大美債20正2,220,52,168,元大-台南,2024-09-27,9896
2891,中信金,153,17,136,元大-台南,2024-09-27,9896
00679B,元大美債20年,185,49,136,元大-台南,2024-09-27,9896
00937B,群益ESG投等債20,106,2,104,元大-台南,2024-09-27,9896
00715L,期街口布蘭特正2,106,4,102,元大-台南,2024-09-27,9896
00651R,復華香港反1,100,0,100,元大-台南,2024-09-27,9896
00753L,中信中國50正2,110,11,99,元大-台南,2024-09-27,9896
2009,第一銅,100,5,95,元大-台南,2024-09-27,9896
00933B,國泰10Y+金融債,90,0,90,元大-台南,2024-09-27,9896
2363,矽統,117,33,84,元大-台南,2024-09-27,9896
00637L,元大滬深300正2,91,36,55,元大-台南,2024-09-27,9896
6488,環球晶,52,0,52,元大-台南,2024-09-27,9896
00700,富邦�琤肭磪�,61,11,50,元大-台南,2024-09-27,9896
00948B,中信優息投資級債,46,0,46,元大-台南,2024-09-27,9896
00665L,富邦�琤肭磪囓�2,55,10,45,元大-台南,2024-09-27,9896
00633L,富邦上証正2,51,10,41,元大-台南,2024-09-27,9896
00960,野村全球航運龍頭,119,78,41,元大-台南,2024-09-27,9896
00639,富邦深100,40,0,40,元大-台南,2024-09-27,9896
2888,新光金,66,30,36,元大-台南,2024-09-27,9896
00940,元大台灣價值高息,73,37,36,元大-台南,2024-09-27,9896
2025,千興,55,25,30,元大-台南,2024-09-27,9896
00712,復華富時不動產,34,4,30,元大-台南,2024-09-27,9896
00632R,元大台灣50反1,47,21,26,元大-台南,2024-09-27,9896
2399,映泰,28,2,26,元大-台南,2024-09-27,9896
8150,南茂,28,6,22,元大-台南,2024-09-27,9896
00929,復華台灣科技優息,79,57,22,元大-台南,2024-09-27,9896
00706L,期元大S＆P日圓正2,21,0,21,元大-台南,2024-09-27,9896
006208,富邦台50,30,9,21,元大-台南,2024-09-27,9896
00719B,元大美債1-3,20,0,20,元大-台南,2024-09-27,9896
00954,中信日本半導體,20,0,20,元大-台南,2024-09-27,9896
8096,擎亞,32,13,19,元大-台南,2024-09-27,9896
3141,晶宏,18,1,17,元大-台南,2024-09-27,9896
6187,萬潤,16,0,16,元大-台南,2024-09-27,9896
00795B,中信美國公債20年,15,0,15,元大-台南,2024-09-27,9896
00676R,富邦臺灣加權反1,15,0,15,元大-台南,2024-09-27,9896
5213,亞昕,15,0,15,元大-台南,2024-09-27,9896
1319,東陽,17,2,15,元大-台南,2024-09-27,9896
2023,燁輝,21,6,15,元大-台南,2024-09-27,9896
00642U,期元大S＆P石油,14,0,14,元大-台南,2024-09-27,9896
2401,凌陽,17,3,14,元大-台南,2024-09-27,9896
2486,一詮,51,38,13,元大-台南,2024-09-27,9896
5481,新華,13,0,13,元大-台南,2024-09-27,9896
2610,華航,12,0,12,元大-台南,2024-09-27,9896
1522,堤維西,11,0,11,元大-台南,2024-09-27,9896
3711,日月光投控,11,0,11,元大-台南,2024-09-27,9896
6143,振曜,11,0,11,元大-台南,2024-09-27,9896
9105,泰金寶-DR,11,0,11,元大-台南,2024-09-27,9896
00668,國泰美國道瓊,10,0,10,元大-台南,2024-09-27,9896
2327,國巨,11,1,10,元大-台南,2024-09-27,9896
00637L,元大滬深300正2,238,75,163,元大-台南,2024-09-30,9896
00753L,中信中國50正2,146,0,146,元大-台南,2024-09-30,9896
00680L,元大美債20正2,348,205,143,元大-台南,2024-09-30,9896
00679B,元大美債20年,144,9,135,元大-台南,2024-09-30,9896
00929,復華台灣科技優息,169,50,119,元大-台南,2024-09-30,9896
00919,群益台灣精選高息,141,23,118,元大-台南,2024-09-30,9896
00887,永豐中國科技50大,101,0,101,元大-台南,2024-09-30,9896
00639,富邦深100,100,0,100,元大-台南,2024-09-30,9896
2888,新光金,115,16,99,元大-台南,2024-09-30,9896
00687B,國泰20年美債,97,0,97,元大-台南,2024-09-30,9896
0056,元大高股息,93,3,90,元大-台南,2024-09-30,9896
912000,晨訊科-DR,80,0,80,元大-台南,2024-09-30,9896
00665L,富邦�琤肭磪囓�2,91,23,68,元大-台南,2024-09-30,9896
00937B,群益ESG投等債20,131,67,64,元大-台南,2024-09-30,9896
9105,泰金寶-DR,59,5,54,元大-台南,2024-09-30,9896
2303,聯電,76,29,47,元大-台南,2024-09-30,9896
2515,中工,44,4,40,元大-台南,2024-09-30,9896
6488,環球晶,40,3,37,元大-台南,2024-09-30,9896
2330,台積電,42,6,36,元大-台南,2024-09-30,9896
2014,中鴻,98,64,34,元大-台南,2024-09-30,9896
00958B,永豐ESG銀行債15,30,0,30,元大-台南,2024-09-30,9896
00878,國泰永續高股息,84,57,27,元大-台南,2024-09-30,9896
1785,光洋科,31,4,27,元大-台南,2024-09-30,9896
00931B,統一美債20年,27,1,26,元大-台南,2024-09-30,9896
00915,凱基優選高股息30,27,2,25,元大-台南,2024-09-30,9896
00918,大華優利高填息30,24,0,24,元大-台南,2024-09-30,9896
00885,富邦越南,20,0,20,元大-台南,2024-09-30,9896
2007,燁興,20,0,20,元大-台南,2024-09-30,9896
00719B,元大美債1-3,21,1,20,元大-台南,2024-09-30,9896
00954,中信日本半導體,20,0,20,元大-台南,2024-09-30,9896
00720B,元大投資級公司債,20,0,20,元大-台南,2024-09-30,9896
00633L,富邦上証正2,31,11,20,元大-台南,2024-09-30,9896
006208,富邦台50,20,0,20,元大-台南,2024-09-30,9896
2913,農林,20,1,19,元大-台南,2024-09-30,9896
00675L,富邦臺灣加權正2,19,0,19,元大-台南,2024-09-30,9896
2421,建準,18,0,18,元大-台南,2024-09-30,9896
2603,長榮,29,11,18,元大-台南,2024-09-30,9896
1711,永光,34,17,17,元大-台南,2024-09-30,9896
00881,國泰台灣5G+,17,1,16,元大-台南,2024-09-30,9896
8039,台虹,16,0,16,元大-台南,2024-09-30,9896
00922,國泰台灣領袖50,16,0,16,元大-台南,2024-09-30,9896
3037,欣興,15,0,15,元大-台南,2024-09-30,9896
1905,華紙,14,0,14,元大-台南,2024-09-30,9896
1718,中纖,15,1,14,元大-台南,2024-09-30,9896
00948B,中信優息投資級債,16,2,14,元大-台南,2024-09-30,9896
00927,群益半導體收益,14,1,13,元大-台南,2024-09-30,9896
1303,南亞,15,2,13,元大-台南,2024-09-30,9896
4919,新唐,15,2,13,元大-台南,2024-09-30,9896
2033,佳大,13,0,13,元大-台南,2024-09-30,9896
00725B,國泰投資級公司債,13,0,13,元大-台南,2024-09-30,9896
00680L,元大美債20正2,7418,35,7383,元大-台南,2024-10-01,9896
00927,群益半導體收益,105,0,105,元大-台南,2024-10-01,9896
00929,復華台灣科技優息,102,17,85,元大-台南,2024-10-01,9896
0056,元大高股息,81,9,72,元大-台南,2024-10-01,9896
00753L,中信中國50正2,74,5,69,元大-台南,2024-10-01,9896
2303,聯電,52,3,49,元大-台南,2024-10-01,9896
2412,中華電,45,1,44,元大-台南,2024-10-01,9896
3576,聯合再生,43,10,33,元大-台南,2024-10-01,9896
2313,華通,33,2,31,元大-台南,2024-10-01,9896
2615,萬海,82,51,31,元大-台南,2024-10-01,9896
2609,陽明,90,59,31,元大-台南,2024-10-01,9896
00632R,元大台灣50反1,125,95,30,元大-台南,2024-10-01,9896
00937B,群益ESG投等債20,34,5,29,元大-台南,2024-10-01,9896
2363,矽統,46,17,29,元大-台南,2024-10-01,9896
00918,大華優利高填息30,27,0,27,元大-台南,2024-10-01,9896
00650L,復華香港正2,23,0,23,元大-台南,2024-10-01,9896
00943,兆豐電子高息等權,22,0,22,元大-台南,2024-10-01,9896
00919,群益台灣精選高息,33,12,21,元大-台南,2024-10-01,9896
9105,泰金寶-DR,25,4,21,元大-台南,2024-10-01,9896
00915,凱基優選高股息30,20,0,20,元大-台南,2024-10-01,9896
1721,三晃,18,0,18,元大-台南,2024-10-01,9896
00725B,國泰投資級公司債,20,2,18,元大-台南,2024-10-01,9896
00706L,期元大S＆P日圓正2,16,0,16,元大-台南,2024-10-01,9896
3715,定穎投控,46,30,16,元大-台南,2024-10-01,9896
00940,元大台灣價值高息,24,8,16,元大-台南,2024-10-01,9896
00763U,期街口道瓊銅,15,0,15,元大-台南,2024-10-01,9896
8429,金麗-KY,15,0,15,元大-台南,2024-10-01,9896
1536,和大,14,0,14,元大-台南,2024-10-01,9896
00882,中信中國高股息,28,14,14,元大-台南,2024-10-01,9896
2888,新光金,32,18,14,元大-台南,2024-10-01,9896
00922,國泰台灣領袖50,14,0,14,元大-台南,2024-10-01,9896
00720B,元大投資級公司債,14,1,13,元大-台南,2024-10-01,9896
00946,群益科技高息成長,12,0,12,元大-台南,2024-10-01,9896
2409,友達,13,1,12,元大-台南,2024-10-01,9896
2451,創見,12,0,12,元大-台南,2024-10-01,9896
1605,華新,11,0,11,元大-台南,2024-10-01,9896
2103,台橡,12,1,11,元大-台南,2024-10-01,9896
5905,南仁湖,13,2,11,元大-台南,2024-10-01,9896
3481,群創,26,15,11,元大-台南,2024-10-01,9896
8111,立��,36,26,10,元大-台南,2024-10-01,9896
6188,廣明,10,0,10,元大-台南,2024-10-01,9896
5309,系統電,10,0,10,元大-台南,2024-10-01,9896
2406,國碩,15,5,10,元大-台南,2024-10-01,9896
00955,中信日本商社,10,0,10,元大-台南,2024-10-01,9896
00905,FT臺灣Smart,10,0,10,元大-台南,2024-10-01,9896
5425,台半,11,1,10,元大-台南,2024-10-01,9896
2025,千興,10,0,10,元大-台南,2024-10-01,9896
4109,加捷生醫,10,0,10,元大-台南,2024-10-01,9896
2801,彰銀,16,6,10,元大-台南,2024-10-01,9896
2613,中櫃,17,7,10,元大-台南,2024-10-01,9896
00680L,元大美債20正2,1417,140,1277,元大-台南,2024-10-04,9896
00919,群益台灣精選高息,295,23,272,元大-台南,2024-10-04,9896
2610,華航,178,10,168,元大-台南,2024-10-04,9896
2303,聯電,151,20,131,元大-台南,2024-10-04,9896
00679B,元大美債20年,135,9,126,元大-台南,2024-10-04,9896
2382,廣達,112,9,103,元大-台南,2024-10-04,9896
00673R,期元大S＆P原油反1,86,0,86,元大-台南,2024-10-04,9896
00940,元大台灣價值高息,206,127,79,元大-台南,2024-10-04,9896
2498,宏達電,100,33,67,元大-台南,2024-10-04,9896
2609,陽明,98,39,59,元大-台南,2024-10-04,9896
00927,群益半導體收益,58,0,58,元大-台南,2024-10-04,9896
00937B,群益ESG投等債20,54,0,54,元大-台南,2024-10-04,9896
00948B,中信優息投資級債,54,1,53,元大-台南,2024-10-04,9896
00706L,期元大S＆P日圓正2,51,0,51,元大-台南,2024-10-04,9896
1540,喬福,52,2,50,元大-台南,2024-10-04,9896
5452,佶優,45,0,45,元大-台南,2024-10-04,9896
2603,長榮,53,10,43,元大-台南,2024-10-04,9896
00918,大華優利高填息30,42,0,42,元大-台南,2024-10-04,9896
2618,長榮航,60,19,41,元大-台南,2024-10-04,9896
8201,無敵,40,0,40,元大-台南,2024-10-04,9896
00643,群益深証中小,37,0,37,元大-台南,2024-10-04,9896
2883,凱基金,35,0,35,元大-台南,2024-10-04,9896
1785,光洋科,55,22,33,元大-台南,2024-10-04,9896
00955,中信日本商社,31,0,31,元大-台南,2024-10-04,9896
3714,富采,33,2,31,元大-台南,2024-10-04,9896
1718,中纖,30,1,29,元大-台南,2024-10-04,9896
0056,元大高股息,31,4,27,元大-台南,2024-10-04,9896
2353,宏��,25,0,25,元大-台南,2024-10-04,9896
2615,萬海,32,9,23,元大-台南,2024-10-04,9896
2402,毅嘉,30,8,22,元大-台南,2024-10-04,9896
2383,台光電,24,2,22,元大-台南,2024-10-04,9896
00885,富邦越南,20,0,20,元大-台南,2024-10-04,9896
00712,復華富時不動產,19,0,19,元大-台南,2024-10-04,9896
2905,三商,18,0,18,元大-台南,2024-10-04,9896
2881,富邦金,18,1,17,元大-台南,2024-10-04,9896
00725B,國泰投資級公司債,20,3,17,元大-台南,2024-10-04,9896
2887,台新金,17,0,17,元大-台南,2024-10-04,9896
2637,慧洋-KY,32,16,16,元大-台南,2024-10-04,9896
00878,國泰永續高股息,32,16,16,元大-台南,2024-10-04,9896
4958,臻鼎-KY,17,2,15,元大-台南,2024-10-04,9896
3019,亞光,28,14,14,元大-台南,2024-10-04,9896
2025,千興,14,0,14,元大-台南,2024-10-04,9896
3508,位速,14,0,14,元大-台南,2024-10-04,9896
00922,國泰台灣領袖50,13,0,13,元大-台南,2024-10-04,9896
6274,台燿,16,3,13,元大-台南,2024-10-04,9896
00933B,國泰10Y+金融債,15,2,13,元大-台南,2024-10-04,9896
6166,凌華,13,0,13,元大-台南,2024-10-04,9896
5347,世界,13,0,13,元大-台南,2024-10-04,9896
2891,中信金,16,3,13,元大-台南,2024-10-04,9896
2880,華南金,12,0,12,元大-台南,2024-10-04,9896
00632R,元大台灣50反1,1173,150,1023,元大-台南,2024-10-07,9896
00725B,國泰投資級公司債,297,3,294,元大-台南,2024-10-07,9896
00937B,群益ESG投等債20,245,2,243,元大-台南,2024-10-07,9896
00637L,元大滬深300正2,604,374,230,元大-台南,2024-10-07,9896
00680L,元大美債20正2,206,20,186,元大-台南,2024-10-07,9896
00919,群益台灣精選高息,137,9,128,元大-台南,2024-10-07,9896
2025,千興,123,0,123,元大-台南,2024-10-07,9896
00706L,期元大S＆P日圓正2,113,0,113,元大-台南,2024-10-07,9896
00953B,群益優選非投等債,100,1,99,元大-台南,2024-10-07,9896
00929,復華台灣科技優息,119,52,67,元大-台南,2024-10-07,9896
1314,中石化,81,17,64,元大-台南,2024-10-07,9896
00651R,復華香港反1,59,0,59,元大-台南,2024-10-07,9896
00753L,中信中國50正2,55,0,55,元大-台南,2024-10-07,9896
6152,百一,51,1,50,元大-台南,2024-10-07,9896
5905,南仁湖,55,7,48,元大-台南,2024-10-07,9896
6125,廣運,49,3,46,元大-台南,2024-10-07,9896
00752,中信中國50,62,17,45,元大-台南,2024-10-07,9896
00665L,富邦�琤肭磪囓�2,130,89,41,元大-台南,2024-10-07,9896
0056,元大高股息,76,35,41,元大-台南,2024-10-07,9896
2316,楠梓電,63,23,40,元大-台南,2024-10-07,9896
00679B,元大美債20年,154,117,37,元大-台南,2024-10-07,9896
2412,中華電,34,0,34,元大-台南,2024-10-07,9896
00955,中信日本商社,32,0,32,元大-台南,2024-10-07,9896
00958B,永豐ESG銀行債15,33,1,32,元大-台南,2024-10-07,9896
00949,復華日本龍頭,30,0,30,元大-台南,2024-10-07,9896
00688L,國泰20年美債正2,56,26,30,元大-台南,2024-10-07,9896
2201,裕隆,30,1,29,元大-台南,2024-10-07,9896
00700,富邦�琤肭磪�,30,1,29,元大-台南,2024-10-07,9896
6530,創威,39,11,28,元大-台南,2024-10-07,9896
8404,百和興業-KY,34,6,28,元大-台南,2024-10-07,9896
2601,益航,32,6,26,元大-台南,2024-10-07,9896
2401,凌陽,25,0,25,元大-台南,2024-10-07,9896
3710,連展投控,22,0,22,元大-台南,2024-10-07,9896
00878,國泰永續高股息,25,4,21,元大-台南,2024-10-07,9896
00915,凱基優選高股息30,20,0,20,元大-台南,2024-10-07,9896
00943,兆豐電子高息等權,22,2,20,元大-台南,2024-10-07,9896
3047,訊舟,21,1,20,元大-台南,2024-10-07,9896
00643,群益深証中小,19,0,19,元大-台南,2024-10-07,9896
8111,立��,50,32,18,元大-台南,2024-10-07,9896
2495,普安,20,3,17,元大-台南,2024-10-07,9896
00631L,元大台灣50正2,17,0,17,元大-台南,2024-10-07,9896
5309,系統電,17,0,17,元大-台南,2024-10-07,9896
00960,野村全球航運龍頭,23,8,15,元大-台南,2024-10-07,9896
2515,中工,23,8,15,元大-台南,2024-10-07,9896
3037,欣興,16,1,15,元大-台南,2024-10-07,9896
2356,英業達,18,3,15,元大-台南,2024-10-07,9896
1301,台塑,19,4,15,元大-台南,2024-10-07,9896
3591,艾笛森,28,13,15,元大-台南,2024-10-07,9896
0061,元大寶滬深,17,3,14,元大-台南,2024-10-07,9896
5864,致和證,14,0,14,元大-台南,2024-10-07,9896
00929,復華台灣科技優息,259,48,211,元大-台南,2024-10-08,9896
00937B,群益ESG投等債20,148,11,137,元大-台南,2024-10-08,9896
00882,中信中國高股息,357,221,136,元大-台南,2024-10-08,9896
00940,元大台灣價值高息,137,7,130,元大-台南,2024-10-08,9896
00919,群益台灣精選高息,118,4,114,元大-台南,2024-10-08,9896
2891,中信金,108,1,107,元大-台南,2024-10-08,9896
2025,千興,100,0,100,元大-台南,2024-10-08,9896
4903,聯光通,90,21,69,元大-台南,2024-10-08,9896
00680L,元大美債20正2,68,0,68,元大-台南,2024-10-08,9896
00948B,中信優息投資級債,120,54,66,元大-台南,2024-10-08,9896
00878,國泰永續高股息,72,9,63,元大-台南,2024-10-08,9896
00673R,期元大S＆P原油反1,62,0,62,元大-台南,2024-10-08,9896
00687B,國泰20年美債,78,18,60,元大-台南,2024-10-08,9896
3049,精金,61,3,58,元大-台南,2024-10-08,9896
0056,元大高股息,81,29,52,元大-台南,2024-10-08,9896
00725B,國泰投資級公司債,53,3,50,元大-台南,2024-10-08,9896
1314,中石化,109,64,45,元大-台南,2024-10-08,9896
00946,群益科技高息成長,45,0,45,元大-台南,2024-10-08,9896
00933B,國泰10Y+金融債,42,0,42,元大-台南,2024-10-08,9896
3481,群創,50,9,41,元大-台南,2024-10-08,9896
00720B,元大投資級公司債,42,2,40,元大-台南,2024-10-08,9896
2399,映泰,99,60,39,元大-台南,2024-10-08,9896
2303,聯電,61,22,39,元大-台南,2024-10-08,9896
00712,復華富時不動產,49,10,39,元大-台南,2024-10-08,9896
00931B,統一美債20年,34,0,34,元大-台南,2024-10-08,9896
3303,岱稜,39,5,34,元大-台南,2024-10-08,9896
2880,華南金,33,0,33,元大-台南,2024-10-08,9896
1718,中纖,32,0,32,元大-台南,2024-10-08,9896
6216,居易,31,0,31,元大-台南,2024-10-08,9896
00751B,元大AAA至A公司債,43,12,31,元大-台南,2024-10-08,9896
2405,輔信,30,0,30,元大-台南,2024-10-08,9896
00665L,富邦�琤肭磪囓�2,294,265,29,元大-台南,2024-10-08,9896
00918,大華優利高填息30,27,0,27,元大-台南,2024-10-08,9896
1802,台玻,24,0,24,元大-台南,2024-10-08,9896
00943,兆豐電子高息等權,22,0,22,元大-台南,2024-10-08,9896
00688L,國泰20年美債正2,22,0,22,元大-台南,2024-10-08,9896
3673,TPK-KY,22,0,22,元大-台南,2024-10-08,9896
2317,鴻海,45,24,21,元大-台南,2024-10-08,9896
2731,雄獅,20,0,20,元大-台南,2024-10-08,9896
1721,三晃,25,5,20,元大-台南,2024-10-08,9896
4956,光鋐,21,1,20,元大-台南,2024-10-08,9896
00885,富邦越南,18,0,18,元大-台南,2024-10-08,9896
2881,富邦金,18,0,18,元大-台南,2024-10-08,9896
2610,華航,18,0,18,元大-台南,2024-10-08,9896
1815,富喬,17,1,16,元大-台南,2024-10-08,9896
2027,大成鋼,16,1,15,元大-台南,2024-10-08,9896
2355,敬鵬,15,0,15,元大-台南,2024-10-08,9896
1710,東聯,15,0,15,元大-台南,2024-10-08,9896
8064,東捷,17,2,15,元大-台南,2024-10-08,9896
4958,臻鼎-KY,14,0,14,元大-台南,2024-10-08,9896
00882,中信中國高股息,362,25,337,元大-台南,2024-10-09,9896
00927,群益半導體收益,300,9,291,元大-台南,2024-10-09,9896
00937B,群益ESG投等債20,149,2,147,元大-台南,2024-10-09,9896
1314,中石化,143,7,136,元大-台南,2024-10-09,9896
00679B,元大美債20年,188,59,129,元大-台南,2024-10-09,9896
1718,中纖,115,2,113,元大-台南,2024-10-09,9896
00940,元大台灣價值高息,147,37,110,元大-台南,2024-10-09,9896
2025,千興,91,0,91,元大-台南,2024-10-09,9896
2399,映泰,140,54,86,元大-台南,2024-10-09,9896
2303,聯電,103,24,79,元大-台南,2024-10-09,9896
00637L,元大滬深300正2,528,449,79,元大-台南,2024-10-09,9896
9105,泰金寶-DR,79,2,77,元大-台南,2024-10-09,9896
00948B,中信優息投資級債,75,0,75,元大-台南,2024-10-09,9896
00725B,國泰投資級公司債,65,0,65,元大-台南,2024-10-09,9896
00753L,中信中國50正2,187,123,64,元大-台南,2024-10-09,9896
00655L,國泰中國A50正2,63,10,53,元大-台南,2024-10-09,9896
00895,富邦未來車,50,0,50,元大-台南,2024-10-09,9896
5905,南仁湖,47,0,47,元大-台南,2024-10-09,9896
2605,新興,48,1,47,元大-台南,2024-10-09,9896
00643,群益深証中小,43,1,42,元大-台南,2024-10-09,9896
1301,台塑,43,1,42,元大-台南,2024-10-09,9896
00915,凱基優選高股息30,39,2,37,元大-台南,2024-10-09,9896
3048,益登,69,33,36,元大-台南,2024-10-09,9896
2002,中鋼,38,4,34,元大-台南,2024-10-09,9896
2515,中工,31,0,31,元大-台南,2024-10-09,9896
2489,瑞軒,31,3,28,元大-台南,2024-10-09,9896
2603,長榮,27,0,27,元大-台南,2024-10-09,9896
00919,群益台灣精選高息,38,13,25,元大-台南,2024-10-09,9896
2363,矽統,176,151,25,元大-台南,2024-10-09,9896
2601,益航,35,12,23,元大-台南,2024-10-09,9896
00878,國泰永續高股息,25,2,23,元大-台南,2024-10-09,9896
2887,台新金,22,0,22,元大-台南,2024-10-09,9896
00955,中信日本商社,20,0,20,元大-台南,2024-10-09,9896
00922,國泰台灣領袖50,23,3,20,元大-台南,2024-10-09,9896
6821,聯寶,19,0,19,元大-台南,2024-10-09,9896
00688L,國泰20年美債正2,19,0,19,元大-台南,2024-10-09,9896
2609,陽明,31,14,17,元大-台南,2024-10-09,9896
2618,長榮航,26,9,17,元大-台南,2024-10-09,9896
2464,盟立,19,2,17,元大-台南,2024-10-09,9896
3049,精金,20,3,17,元大-台南,2024-10-09,9896
5443,均豪,27,10,17,元大-台南,2024-10-09,9896
6126,信音,20,4,16,元大-台南,2024-10-09,9896
8028,昇陽半導體,22,6,16,元大-台南,2024-10-09,9896
00633L,富邦上証正2,17,1,16,元大-台南,2024-10-09,9896
3379,彬台,16,0,16,元大-台南,2024-10-09,9896
00680L,元大美債20正2,31,16,15,元大-台南,2024-10-09,9896
00918,大華優利高填息30,16,1,15,元大-台南,2024-10-09,9896
3706,神達,33,18,15,元大-台南,2024-10-09,9896
6187,萬潤,22,7,15,元大-台南,2024-10-09,9896
2344,華邦電,14,1,13,元大-台南,2024-10-09,9896
00927,群益半導體收益,150,0,150,元大-台南,2024-10-11,9896
00753L,中信中國50正2,137,10,127,元大-台南,2024-10-11,9896
00637L,元大滬深300正2,143,17,126,元大-台南,2024-10-11,9896
00632R,元大台灣50反1,219,110,109,元大-台南,2024-10-11,9896
00687B,國泰20年美債,129,28,101,元大-台南,2024-10-11,9896
00956,中信日經高股息,100,0,100,元大-台南,2024-10-11,9896
00673R,期元大S＆P原油反1,97,0,97,元大-台南,2024-10-11,9896
2025,千興,93,0,93,元大-台南,2024-10-11,9896
2887,台新金,80,1,79,元大-台南,2024-10-11,9896
00680L,元大美債20正2,143,69,74,元大-台南,2024-10-11,9896
00665L,富邦�琤肭磪囓�2,81,12,69,元大-台南,2024-10-11,9896
00937B,群益ESG投等債20,103,44,59,元大-台南,2024-10-11,9896
00772B,中信高評級公司債,51,0,51,元大-台南,2024-10-11,9896
00679B,元大美債20年,84,37,47,元大-台南,2024-10-11,9896
00919,群益台灣精選高息,56,14,42,元大-台南,2024-10-11,9896
0056,元大高股息,52,12,40,元大-台南,2024-10-11,9896
00882,中信中國高股息,112,72,40,元大-台南,2024-10-11,9896
1101,台泥,38,2,36,元大-台南,2024-10-11,9896
2905,三商,32,0,32,元大-台南,2024-10-11,9896
00933B,國泰10Y+金融債,27,0,27,元大-台南,2024-10-11,9896
00720B,元大投資級公司債,29,2,27,元大-台南,2024-10-11,9896
00915,凱基優選高股息30,27,1,26,元大-台南,2024-10-11,9896
1721,三晃,53,27,26,元大-台南,2024-10-11,9896
2812,台中銀,23,0,23,元大-台南,2024-10-11,9896
2303,聯電,22,0,22,元大-台南,2024-10-11,9896
3149,正達,102,80,22,元大-台南,2024-10-11,9896
00642U,期元大S＆P石油,25,4,21,元大-台南,2024-10-11,9896
6216,居易,20,0,20,元大-台南,2024-10-11,9896
8240,華宏,20,0,20,元大-台南,2024-10-11,9896
00878,國泰永續高股息,34,14,20,元大-台南,2024-10-11,9896
00949,復華日本龍頭,21,1,20,元大-台南,2024-10-11,9896
2605,新興,21,2,19,元大-台南,2024-10-11,9896
2363,矽統,71,52,19,元大-台南,2024-10-11,9896
1527,鑽全,16,0,16,元大-台南,2024-10-11,9896
2634,漢翔,14,0,14,元大-台南,2024-10-11,9896
8111,立��,21,7,14,元大-台南,2024-10-11,9896
8011,台通,14,0,14,元大-台南,2024-10-11,9896
9914,美利達,13,0,13,元大-台南,2024-10-11,9896
00960,野村全球航運龍頭,13,0,13,元大-台南,2024-10-11,9896
2390,云辰,38,25,13,元大-台南,2024-10-11,9896
1605,華新,16,4,12,元大-台南,2024-10-11,9896
2405,輔信,12,0,12,元大-台南,2024-10-11,9896
00955,中信日本商社,12,0,12,元大-台南,2024-10-11,9896
00959B,大華投等美債15Y+,17,5,12,元大-台南,2024-10-11,9896
3522,御嵿,12,0,12,元大-台南,2024-10-11,9896
2356,英業達,22,10,12,元大-台南,2024-10-11,9896
5355,佳總,45,33,12,元大-台南,2024-10-11,9896
4906,正文,17,6,11,元大-台南,2024-10-11,9896
2419,仲琦,12,1,11,元大-台南,2024-10-11,9896
4908,前鼎,12,1,11,元大-台南,2024-10-11,9896
00687B,國泰20年美債,171,3,168,元大-台南,2024-10-14,9896
00882,中信中國高股息,206,41,165,元大-台南,2024-10-14,9896
00953B,群益優選非投等債,150,0,150,元大-台南,2024-10-14,9896
00887,永豐中國科技50大,133,2,131,元大-台南,2024-10-14,9896
00679B,元大美債20年,140,61,79,元大-台南,2024-10-14,9896
00948B,中信優息投資級債,77,0,77,元大-台南,2024-10-14,9896
2025,千興,74,0,74,元大-台南,2024-10-14,9896
00885,富邦越南,73,3,70,元大-台南,2024-10-14,9896
00753L,中信中國50正2,116,58,58,元大-台南,2024-10-14,9896
00937B,群益ESG投等債20,74,27,47,元大-台南,2024-10-14,9896
00772B,中信高評級公司債,71,26,45,元大-台南,2024-10-14,9896
0056,元大高股息,47,4,43,元大-台南,2024-10-14,9896
2312,金寶,117,80,37,元大-台南,2024-10-14,9896
00720B,元大投資級公司債,32,0,32,元大-台南,2024-10-14,9896
00891,中信關鍵半導體,30,0,30,元大-台南,2024-10-14,9896
00712,復華富時不動產,30,0,30,元大-台南,2024-10-14,9896
00930,永豐ESG低碳高息,30,0,30,元大-台南,2024-10-14,9896
00715L,期街口布蘭特正2,55,28,27,元大-台南,2024-10-14,9896
00725B,國泰投資級公司債,25,1,24,元大-台南,2024-10-14,9896
2367,燿華,23,0,23,元大-台南,2024-10-14,9896
00706L,期元大S＆P日圓正2,22,0,22,元大-台南,2024-10-14,9896
5483,中美晶,22,0,22,元大-台南,2024-10-14,9896
00680L,元大美債20正2,48,27,21,元大-台南,2024-10-14,9896
8011,台通,85,64,21,元大-台南,2024-10-14,9896
2344,華邦電,21,1,20,元大-台南,2024-10-14,9896
9105,泰金寶-DR,104,84,20,元大-台南,2024-10-14,9896
00919,群益台灣精選高息,23,3,20,元大-台南,2024-10-14,9896
00632R,元大台灣50反1,121,104,17,元大-台南,2024-10-14,9896
6187,萬潤,29,13,16,元大-台南,2024-10-14,9896
4991,環宇-KY,18,2,16,元大-台南,2024-10-14,9896
2609,陽明,26,11,15,元大-台南,2024-10-14,9896
2887,台新金,45,30,15,元大-台南,2024-10-14,9896
00795B,中信美國公債20年,14,0,14,元大-台南,2024-10-14,9896
1326,台化,16,2,14,元大-台南,2024-10-14,9896
3576,聯合再生,16,2,14,元大-台南,2024-10-14,9896
4532,瑞智,13,1,12,元大-台南,2024-10-14,9896
5871,中租-KY,14,2,12,元大-台南,2024-10-14,9896
00688L,國泰20年美債正2,12,0,12,元大-台南,2024-10-14,9896
2812,台中銀,12,0,12,元大-台南,2024-10-14,9896
2511,太子,11,0,11,元大-台南,2024-10-14,9896
2337,旺宏,11,0,11,元大-台南,2024-10-14,9896
00752,中信中國50,11,0,11,元大-台南,2024-10-14,9896
1815,富喬,10,0,10,元大-台南,2024-10-14,9896
1409,新纖,10,0,10,元大-台南,2024-10-14,9896
6216,居易,10,0,10,元大-台南,2024-10-14,9896
2867,三商壽,10,0,10,元大-台南,2024-10-14,9896
00648R,元大S＆P500反1,10,0,10,元大-台南,2024-10-14,9896
1515,力山,10,0,10,元大-台南,2024-10-14,9896
00857B,永豐20年美公債,10,0,10,元大-台南,2024-10-14,9896
6229,研通,10,0,10,元大-台南,2024-10-14,9896
00688L,國泰20年美債正2,241,0,241,元大-台南,2024-10-15,9896
1314,中石化,154,7,147,元大-台南,2024-10-15,9896
00715L,期街口布蘭特正2,149,11,138,元大-台南,2024-10-15,9896
00885,富邦越南,80,16,64,元大-台南,2024-10-15,9896
3049,精金,72,9,63,元大-台南,2024-10-15,9896
00915,凱基優選高股息30,60,0,60,元大-台南,2024-10-15,9896
2025,千興,58,0,58,元大-台南,2024-10-15,9896
00679B,元大美債20年,70,12,58,元大-台南,2024-10-15,9896
00713,元大台灣高息低波,53,1,52,元大-台南,2024-10-15,9896
00712,復華富時不動產,52,1,51,元大-台南,2024-10-15,9896
00953B,群益優選非投等債,50,0,50,元大-台南,2024-10-15,9896
00887,永豐中國科技50大,81,32,49,元大-台南,2024-10-15,9896
00919,群益台灣精選高息,62,13,49,元大-台南,2024-10-15,9896
00637L,元大滬深300正2,54,8,46,元大-台南,2024-10-15,9896
2887,台新金,62,19,43,元大-台南,2024-10-15,9896
00725B,國泰投資級公司債,44,1,43,元大-台南,2024-10-15,9896
4979,華星光,71,29,42,元大-台南,2024-10-15,9896
00753L,中信中國50正2,71,32,39,元大-台南,2024-10-15,9896
00665L,富邦�琤肭磪囓�2,50,11,39,元大-台南,2024-10-15,9896
1301,台塑,34,0,34,元大-台南,2024-10-15,9896
00706L,期元大S＆P日圓正2,32,0,32,元大-台南,2024-10-15,9896
00882,中信中國高股息,88,56,32,元大-台南,2024-10-15,9896
8033,雷虎,31,1,30,元大-台南,2024-10-15,9896
4526,東台,40,15,25,元大-台南,2024-10-15,9896
00687B,國泰20年美債,29,5,24,元大-台南,2024-10-15,9896
2002,中鋼,25,2,23,元大-台南,2024-10-15,9896
2605,新興,23,0,23,元大-台南,2024-10-15,9896
6216,居易,20,0,20,元大-台南,2024-10-15,9896
00650L,復華香港正2,20,0,20,元大-台南,2024-10-15,9896
3062,建漢,45,25,20,元大-台南,2024-10-15,9896
2303,聯電,62,44,18,元大-台南,2024-10-15,9896
2905,三商,18,0,18,元大-台南,2024-10-15,9896
00947,台新臺灣IC設計,17,0,17,元大-台南,2024-10-15,9896
2515,中工,17,0,17,元大-台南,2024-10-15,9896
00752,中信中國50,25,8,17,元大-台南,2024-10-15,9896
2324,仁寶,18,2,16,元大-台南,2024-10-15,9896
3149,正達,69,53,16,元大-台南,2024-10-15,9896
3591,艾笛森,25,9,16,元大-台南,2024-10-15,9896
4956,光鋐,25,10,15,元大-台南,2024-10-15,9896
2399,映泰,57,42,15,元大-台南,2024-10-15,9896
6244,茂迪,14,0,14,元大-台南,2024-10-15,9896
5460,同協,15,1,14,元大-台南,2024-10-15,9896
2388,威盛,20,6,14,元大-台南,2024-10-15,9896
2888,新光金,87,73,14,元大-台南,2024-10-15,9896
00960,野村全球航運龍頭,15,1,14,元大-台南,2024-10-15,9896
3013,晟銘電,43,29,14,元大-台南,2024-10-15,9896
00756B,群益投等新興公債,13,0,13,元大-台南,2024-10-15,9896
2009,第一銅,14,1,13,元大-台南,2024-10-15,9896
5230,雷笛克光學,14,1,13,元大-台南,2024-10-15,9896
6142,友勁,18,5,13,元大-台南,2024-10-15,9896
00650L,復華香港正2,311,8,303,元大-台南,2024-10-16,9896
00887,永豐中國科技50大,122,0,122,元大-台南,2024-10-16,9896
00878,國泰永續高股息,145,24,121,元大-台南,2024-10-16,9896
0056,元大高股息,126,19,107,元大-台南,2024-10-16,9896
006208,富邦台50,98,2,96,元大-台南,2024-10-16,9896
1101,台泥,79,0,79,元大-台南,2024-10-16,9896
00919,群益台灣精選高息,74,3,71,元大-台南,2024-10-16,9896
2025,千興,63,0,63,元大-台南,2024-10-16,9896
6116,彩晶,60,0,60,元大-台南,2024-10-16,9896
2888,新光金,55,4,51,元大-台南,2024-10-16,9896
00679B,元大美債20年,67,16,51,元大-台南,2024-10-16,9896
00885,富邦越南,50,0,50,元大-台南,2024-10-16,9896
00922,國泰台灣領袖50,39,1,38,元大-台南,2024-10-16,9896
3710,連展投控,47,10,37,元大-台南,2024-10-16,9896
1314,中石化,32,0,32,元大-台南,2024-10-16,9896
00637L,元大滬深300正2,92,66,26,元大-台南,2024-10-16,9896
00881,國泰台灣5G+,30,5,25,元大-台南,2024-10-16,9896
2062,橋椿,26,1,25,元大-台南,2024-10-16,9896
6125,廣運,28,4,24,元大-台南,2024-10-16,9896
8021,尖點,24,0,24,元大-台南,2024-10-16,9896
3450,聯鈞,44,21,23,元大-台南,2024-10-16,9896
6488,環球晶,22,1,21,元大-台南,2024-10-16,9896
00936,台新永續高息中小,20,0,20,元大-台南,2024-10-16,9896
00960,野村全球航運龍頭,21,2,19,元大-台南,2024-10-16,9896
00905,FT臺灣Smart,19,0,19,元大-台南,2024-10-16,9896
1605,華新,17,0,17,元大-台南,2024-10-16,9896
00915,凱基優選高股息30,17,1,16,元大-台南,2024-10-16,9896
2881,富邦金,16,0,16,元大-台南,2024-10-16,9896
00715L,期街口布蘭特正2,16,0,16,元大-台南,2024-10-16,9896
3591,艾笛森,18,2,16,元大-台南,2024-10-16,9896
4510,高鋒,17,1,16,元大-台南,2024-10-16,9896
2014,中鴻,24,8,16,元大-台南,2024-10-16,9896
00918,大華優利高填息30,16,0,16,元大-台南,2024-10-16,9896
00712,復華富時不動產,15,0,15,元大-台南,2024-10-16,9896
00941,中信上游半導體,15,1,14,元大-台南,2024-10-16,9896
3019,亞光,14,0,14,元大-台南,2024-10-16,9896
6215,和椿,37,23,14,元大-台南,2024-10-16,9896
1785,光洋科,27,14,13,元大-台南,2024-10-16,9896
2027,大成鋼,13,0,13,元大-台南,2024-10-16,9896
2884,玉山金,14,1,13,元大-台南,2024-10-16,9896
6609,瀧澤科,31,18,13,元大-台南,2024-10-16,9896
2356,英業達,14,2,12,元大-台南,2024-10-16,9896
00934,中信成長高股息,12,0,12,元大-台南,2024-10-16,9896
6142,友勁,29,17,12,元大-台南,2024-10-16,9896
00680L,元大美債20正2,47,35,12,元大-台南,2024-10-16,9896
2408,南亞科,12,1,11,元大-台南,2024-10-16,9896
2845,遠東銀,11,0,11,元大-台南,2024-10-16,9896
2464,盟立,12,1,11,元大-台南,2024-10-16,9896
6919,康霈*,14,3,11,元大-台南,2024-10-16,9896
00687B,國泰20年美債,22,11,11,元大-台南,2024-10-16,9896
00650L,復華香港正2,465,0,465,元大-台南,2024-10-17,9896
00753L,中信中國50正2,127,3,124,元大-台南,2024-10-17,9896
00887,永豐中國科技50大,122,5,117,元大-台南,2024-10-17,9896
00922,國泰台灣領袖50,113,0,113,元大-台南,2024-10-17,9896
2399,映泰,125,58,67,元大-台南,2024-10-17,9896
8069,元太,52,2,50,元大-台南,2024-10-17,9896
00929,復華台灣科技優息,91,44,47,元大-台南,2024-10-17,9896
0056,元大高股息,67,22,45,元大-台南,2024-10-17,9896
00637L,元大滬深300正2,54,14,40,元大-台南,2024-10-17,9896
2025,千興,38,0,38,元大-台南,2024-10-17,9896
00680L,元大美債20正2,37,3,34,元大-台南,2024-10-17,9896
00882,中信中國高股息,38,8,30,元大-台南,2024-10-17,9896
00941,中信上游半導體,29,2,27,元大-台南,2024-10-17,9896
00953B,群益優選非投等債,26,0,26,元大-台南,2024-10-17,9896
1605,華新,36,10,26,元大-台南,2024-10-17,9896
00885,富邦越南,21,0,21,元大-台南,2024-10-17,9896
2880,華南金,21,0,21,元大-台南,2024-10-17,9896
1789,神隆,20,0,20,元大-台南,2024-10-17,9896
00679B,元大美債20年,28,9,19,元大-台南,2024-10-17,9896
5481,新華,34,15,19,元大-台南,2024-10-17,9896
00632R,元大台灣50反1,43,25,18,元大-台南,2024-10-17,9896
2374,佳能,29,11,18,元大-台南,2024-10-17,9896
1528,恩德,35,18,17,元大-台南,2024-10-17,9896
3710,連展投控,18,1,17,元大-台南,2024-10-17,9896
2303,聯電,21,5,16,元大-台南,2024-10-17,9896
00919,群益台灣精選高息,25,9,16,元大-台南,2024-10-17,9896
2845,遠東銀,15,0,15,元大-台南,2024-10-17,9896
2887,台新金,15,0,15,元大-台南,2024-10-17,9896
2330,台積電,25,11,14,元大-台南,2024-10-17,9896
3062,建漢,46,32,14,元大-台南,2024-10-17,9896
00912,中信臺灣智慧50,12,0,12,元大-台南,2024-10-17,9896
1721,三晃,137,125,12,元大-台南,2024-10-17,9896
2464,盟立,27,15,12,元大-台南,2024-10-17,9896
6125,廣運,17,6,11,元大-台南,2024-10-17,9896
00664R,國泰臺灣加權反1,11,0,11,元大-台南,2024-10-17,9896
6216,居易,11,0,11,元大-台南,2024-10-17,9896
3379,彬台,12,1,11,元大-台南,2024-10-17,9896
8076,伍豐,11,0,11,元大-台南,2024-10-17,9896
6488,環球晶,10,0,10,元大-台南,2024-10-17,9896
00951,台新日本半導體,10,0,10,元大-台南,2024-10-17,9896
3615,安可,76,66,10,元大-台南,2024-10-17,9896
3591,艾笛森,11,1,10,元大-台南,2024-10-17,9896
1569,濱川,11,1,10,元大-台南,2024-10-17,9896
2727,王品,10,0,10,元大-台南,2024-10-17,9896
5309,系統電,11,1,10,元大-台南,2024-10-17,9896
2426,鼎元,12,2,10,元大-台南,2024-10-17,9896
00715L,期街口布蘭特正2,9,0,9,元大-台南,2024-10-17,9896
8111,立��,26,17,9,元大-台南,2024-10-17,9896
00720B,元大投資級公司債,28,19,9,元大-台南,2024-10-17,9896
4903,聯光通,26,17,9,元大-台南,2024-10-17,9896
00937B,群益ESG投等債20,286,8,278,元大-台南,2024-10-18,9896
00650L,復華香港正2,400,154,246,元大-台南,2024-10-18,9896
2303,聯電,230,39,191,元大-台南,2024-10-18,9896
00632R,元大台灣50反1,227,45,182,元大-台南,2024-10-18,9896
00687B,國泰20年美債,125,12,113,元大-台南,2024-10-18,9896
00679B,元大美債20年,109,1,108,元大-台南,2024-10-18,9896
00953B,群益優選非投等債,100,0,100,元大-台南,2024-10-18,9896
0056,元大高股息,92,5,87,元大-台南,2024-10-18,9896
00948B,中信優息投資級債,104,22,82,元大-台南,2024-10-18,9896
00688L,國泰20年美債正2,68,0,68,元大-台南,2024-10-18,9896
00680L,元大美債20正2,58,0,58,元大-台南,2024-10-18,9896
2371,大同,56,1,55,元大-台南,2024-10-18,9896
2449,京元電子,111,64,47,元大-台南,2024-10-18,9896
00887,永豐中國科技50大,49,5,44,元大-台南,2024-10-18,9896
2025,千興,41,0,41,元大-台南,2024-10-18,9896
00639,富邦深100,45,5,40,元大-台南,2024-10-18,9896
00929,復華台灣科技優息,77,37,40,元大-台南,2024-10-18,9896
00676R,富邦臺灣加權反1,35,0,35,元大-台南,2024-10-18,9896
2402,毅嘉,34,0,34,元大-台南,2024-10-18,9896
2634,漢翔,33,0,33,元大-台南,2024-10-18,9896
2495,普安,60,31,29,元大-台南,2024-10-18,9896
6216,居易,29,0,29,元大-台南,2024-10-18,9896
3354,律勝,32,3,29,元大-台南,2024-10-18,9896
2887,台新金,31,4,27,元大-台南,2024-10-18,9896
4114,健喬,26,0,26,元大-台南,2024-10-18,9896
2313,華通,33,8,25,元大-台南,2024-10-18,9896
00931B,統一美債20年,24,0,24,元大-台南,2024-10-18,9896
4707,磐亞,22,0,22,元大-台南,2024-10-18,9896
2888,新光金,27,7,20,元大-台南,2024-10-18,9896
3312,弘憶股,28,8,20,元大-台南,2024-10-18,9896
00720B,元大投資級公司債,19,0,19,元大-台南,2024-10-18,9896
00725B,國泰投資級公司債,18,0,18,元大-台南,2024-10-18,9896
6231,系微,18,1,17,元大-台南,2024-10-18,9896
5452,佶優,27,10,17,元大-台南,2024-10-18,9896
3450,聯鈞,26,9,17,元大-台南,2024-10-18,9896
5347,世界,20,4,16,元大-台南,2024-10-18,9896
00751B,元大AAA至A公司債,17,1,16,元大-台南,2024-10-18,9896
00918,大華優利高填息30,21,6,15,元大-台南,2024-10-18,9896
00912,中信臺灣智慧50,15,0,15,元大-台南,2024-10-18,9896
2905,三商,14,0,14,元大-台南,2024-10-18,9896
6530,創威,42,29,13,元大-台南,2024-10-18,9896
3031,佰鴻,19,6,13,元大-台南,2024-10-18,9896
5460,同協,13,0,13,元大-台南,2024-10-18,9896
1528,恩德,20,7,13,元大-台南,2024-10-18,9896
2615,萬海,19,6,13,元大-台南,2024-10-18,9896
00941,中信上游半導體,19,7,12,元大-台南,2024-10-18,9896
6187,萬潤,13,1,12,元大-台南,2024-10-18,9896
00945B,凱基美國非投等債,14,2,12,元大-台南,2024-10-18,9896
2324,仁寶,16,4,12,元大-台南,2024-10-18,9896
5483,中美晶,11,0,11,元大-台南,2024-10-18,9896
00632R,元大台灣50反1,6007,20,5987,元大-台南,2024-10-21,9896
00937B,群益ESG投等債20,332,25,307,元大-台南,2024-10-21,9896
2883,凱基金,188,2,186,元大-台南,2024-10-21,9896
00637L,元大滬深300正2,243,67,176,元大-台南,2024-10-21,9896
00643,群益深証中小,151,0,151,元大-台南,2024-10-21,9896
00715L,期街口布蘭特正2,120,4,116,元大-台南,2024-10-21,9896
00948B,中信優息投資級債,93,0,93,元大-台南,2024-10-21,9896
00950B,凱基A級公司債,91,0,91,元大-台南,2024-10-21,9896
00679B,元大美債20年,82,3,79,元大-台南,2024-10-21,9896
00687B,國泰20年美債,72,11,61,元大-台南,2024-10-21,9896
00635U,期元大S＆P黃金,60,1,59,元大-台南,2024-10-21,9896
00706L,期元大S＆P日圓正2,58,0,58,元大-台南,2024-10-21,9896
00725B,國泰投資級公司債,51,0,51,元大-台南,2024-10-21,9896
5315,光聯,50,0,50,元大-台南,2024-10-21,9896
2881,富邦金,52,3,49,元大-台南,2024-10-21,9896
2025,千興,47,1,46,元大-台南,2024-10-21,9896
2891,中信金,60,23,37,元大-台南,2024-10-21,9896
00959B,大華投等美債15Y+,36,0,36,元大-台南,2024-10-21,9896
00922,國泰台灣領袖50,37,2,35,元大-台南,2024-10-21,9896
00929,復華台灣科技優息,67,32,35,元大-台南,2024-10-21,9896
00688L,國泰20年美債正2,30,0,30,元大-台南,2024-10-21,9896
00912,中信臺灣智慧50,25,0,25,元大-台南,2024-10-21,9896
6182,合晶,25,1,24,元大-台南,2024-10-21,9896
2303,聯電,56,34,22,元大-台南,2024-10-21,9896
2882,國泰金,30,9,21,元大-台南,2024-10-21,9896
00882,中信中國高股息,34,14,20,元大-台南,2024-10-21,9896
00795B,中信美國公債20年,19,0,19,元大-台南,2024-10-21,9896
2495,普安,20,1,19,元大-台南,2024-10-21,9896
00751B,元大AAA至A公司債,19,0,19,元大-台南,2024-10-21,9896
0056,元大高股息,24,8,16,元大-台南,2024-10-21,9896
00713,元大台灣高息低波,19,3,16,元大-台南,2024-10-21,9896
00931B,統一美債20年,15,0,15,元大-台南,2024-10-21,9896
2880,華南金,14,0,14,元大-台南,2024-10-21,9896
00942B,台新美A公司債20+,13,0,13,元大-台南,2024-10-21,9896
00933B,國泰10Y+金融債,13,0,13,元大-台南,2024-10-21,9896
00900,富邦特選高股息30,15,3,12,元大-台南,2024-10-21,9896
00753L,中信中國50正2,15,3,12,元大-台南,2024-10-21,9896
1785,光洋科,15,3,12,元大-台南,2024-10-21,9896
1301,台塑,12,0,12,元大-台南,2024-10-21,9896
00772B,中信高評級公司債,11,0,11,元大-台南,2024-10-21,9896
3149,正達,54,43,11,元大-台南,2024-10-21,9896
2884,玉山金,11,0,11,元大-台南,2024-10-21,9896
2885,元大金,15,5,10,元大-台南,2024-10-21,9896
2344,華邦電,22,12,10,元大-台南,2024-10-21,9896
0061,元大寶滬深,10,0,10,元大-台南,2024-10-21,9896
00741B,富邦全球非投等債,10,0,10,元大-台南,2024-10-21,9896
00676R,富邦臺灣加權反1,10,0,10,元大-台南,2024-10-21,9896
00936,台新永續高息中小,10,0,10,元大-台南,2024-10-21,9896
2887,台新金,18,9,9,元大-台南,2024-10-21,9896
2002,中鋼,9,0,9,元大-台南,2024-10-21,9896
00937B,群益ESG投等債20,470,51,419,元大-台南,2024-10-22,9896
00687B,國泰20年美債,327,15,312,元大-台南,2024-10-22,9896
00688L,國泰20年美債正2,239,35,204,元大-台南,2024-10-22,9896
00679B,元大美債20年,222,30,192,元大-台南,2024-10-22,9896
00948B,中信優息投資級債,144,0,144,元大-台南,2024-10-22,9896
00950B,凱基A級公司債,88,0,88,元大-台南,2024-10-22,9896
00680L,元大美債20正2,105,21,84,元大-台南,2024-10-22,9896
00764B,群益25年美債,56,0,56,元大-台南,2024-10-22,9896
6202,盛群,56,1,55,元大-台南,2024-10-22,9896
00751B,元大AAA至A公司債,48,1,47,元大-台南,2024-10-22,9896
00725B,國泰投資級公司債,46,0,46,元大-台南,2024-10-22,9896
5521,工信,41,0,41,元大-台南,2024-10-22,9896
00959B,大華投等美債15Y+,39,2,37,元大-台南,2024-10-22,9896
9105,泰金寶-DR,36,0,36,元大-台南,2024-10-22,9896
1301,台塑,31,0,31,元大-台南,2024-10-22,9896
1605,華新,30,0,30,元大-台南,2024-10-22,9896
3615,安可,49,19,30,元大-台南,2024-10-22,9896
00795B,中信美國公債20年,28,0,28,元大-台南,2024-10-22,9896
00772B,中信高評級公司債,34,7,27,元大-台南,2024-10-22,9896
2363,矽統,63,39,24,元大-台南,2024-10-22,9896
00712,復華富時不動產,23,0,23,元大-台南,2024-10-22,9896
3049,精金,39,16,23,元大-台南,2024-10-22,9896
8021,尖點,24,3,21,元大-台南,2024-10-22,9896
2883,凱基金,24,4,20,元大-台南,2024-10-22,9896
00713,元大台灣高息低波,20,1,19,元大-台南,2024-10-22,9896
00753L,中信中國50正2,24,6,18,元大-台南,2024-10-22,9896
0056,元大高股息,21,5,16,元大-台南,2024-10-22,9896
00941,中信上游半導體,17,1,16,元大-台南,2024-10-22,9896
006208,富邦台50,21,5,16,元大-台南,2024-10-22,9896
00905,FT臺灣Smart,16,1,15,元大-台南,2024-10-22,9896
00958B,永豐ESG銀行債15,15,0,15,元大-台南,2024-10-22,9896
00706L,期元大S＆P日圓正2,20,6,14,元大-台南,2024-10-22,9896
3708,上緯投控,13,0,13,元大-台南,2024-10-22,9896
00907,永豐優息存股,16,3,13,元大-台南,2024-10-22,9896
00675L,富邦臺灣加權正2,12,0,12,元大-台南,2024-10-22,9896
2634,漢翔,14,2,12,元大-台南,2024-10-22,9896
8033,雷虎,12,0,12,元大-台南,2024-10-22,9896
3189,景碩,41,29,12,元大-台南,2024-10-22,9896
00903,富邦元宇宙,12,0,12,元大-台南,2024-10-22,9896
1815,富喬,28,16,12,元大-台南,2024-10-22,9896
1609,大亞,12,0,12,元大-台南,2024-10-22,9896
2477,美隆電,20,9,11,元大-台南,2024-10-22,9896
2014,中鴻,12,1,11,元大-台南,2024-10-22,9896
00730,富邦臺灣優質高息,11,0,11,元大-台南,2024-10-22,9896
00857B,永豐20年美公債,11,0,11,元大-台南,2024-10-22,9896
2543,皇昌,12,2,10,元大-台南,2024-10-22,9896
2303,聯電,33,23,10,元大-台南,2024-10-22,9896
1303,南亞,10,0,10,元大-台南,2024-10-22,9896
00956,中信日經高股息,10,0,10,元大-台南,2024-10-22,9896
4945,陞達科技,10,0,10,元大-台南,2024-10-22,9896
2312,金寶,261,40,221,元大-台南,2024-10-23,9896
00937B,群益ESG投等債20,351,138,213,元大-台南,2024-10-23,9896
2511,太子,150,0,150,元大-台南,2024-10-23,9896
00929,復華台灣科技優息,148,22,126,元大-台南,2024-10-23,9896
00772B,中信高評級公司債,110,0,110,元大-台南,2024-10-23,9896
00751B,元大AAA至A公司債,102,1,101,元大-台南,2024-10-23,9896
00950B,凱基A級公司債,77,0,77,元大-台南,2024-10-23,9896
00700,富邦�琤肭磪�,70,2,68,元大-台南,2024-10-23,9896
006208,富邦台50,68,1,67,元大-台南,2024-10-23,9896
1301,台塑,62,0,62,元大-台南,2024-10-23,9896
00948B,中信優息投資級債,59,0,59,元大-台南,2024-10-23,9896
2025,千興,55,0,55,元大-台南,2024-10-23,9896
2880,華南金,51,0,51,元大-台南,2024-10-23,9896
0061,元大寶滬深,51,0,51,元大-台南,2024-10-23,9896
00956,中信日經高股息,50,0,50,元大-台南,2024-10-23,9896
00885,富邦越南,50,0,50,元大-台南,2024-10-23,9896
2409,友達,51,3,48,元大-台南,2024-10-23,9896
2303,聯電,97,55,42,元大-台南,2024-10-23,9896
00712,復華富時不動產,52,11,41,元大-台南,2024-10-23,9896
6168,宏齊,40,0,40,元大-台南,2024-10-23,9896
0056,元大高股息,41,2,39,元大-台南,2024-10-23,9896
6142,友勁,38,3,35,元大-台南,2024-10-23,9896
00680L,元大美債20正2,53,18,35,元大-台南,2024-10-23,9896
00637L,元大滬深300正2,76,42,34,元大-台南,2024-10-23,9896
00918,大華優利高填息30,34,1,33,元大-台南,2024-10-23,9896
00940,元大台灣價值高息,63,35,28,元大-台南,2024-10-23,9896
2329,華泰,55,27,28,元大-台南,2024-10-23,9896
00878,國泰永續高股息,30,2,28,元大-台南,2024-10-23,9896
00635U,期元大S＆P黃金,25,0,25,元大-台南,2024-10-23,9896
00633L,富邦上証正2,25,1,24,元大-台南,2024-10-23,9896
00922,國泰台灣領袖50,24,1,23,元大-台南,2024-10-23,9896
2812,台中銀,22,0,22,元大-台南,2024-10-23,9896
00687B,國泰20年美債,43,21,22,元大-台南,2024-10-23,9896
00720B,元大投資級公司債,21,0,21,元大-台南,2024-10-23,9896
00673R,期元大S＆P原油反1,18,0,18,元大-台南,2024-10-23,9896
6152,百一,18,0,18,元大-台南,2024-10-23,9896
00905,FT臺灣Smart,18,0,18,元大-台南,2024-10-23,9896
00907,永豐優息存股,18,0,18,元大-台南,2024-10-23,9896
00725B,國泰投資級公司債,18,1,17,元大-台南,2024-10-23,9896
00881,國泰台灣5G+,23,6,17,元大-台南,2024-10-23,9896
00919,群益台灣精選高息,46,30,16,元大-台南,2024-10-23,9896
3481,群創,77,61,16,元大-台南,2024-10-23,9896
3013,晟銘電,33,18,15,元大-台南,2024-10-23,9896
00724B,群益投資級金融債,15,0,15,元大-台南,2024-10-23,9896
00688L,國泰20年美債正2,14,0,14,元大-台南,2024-10-23,9896
2892,第一金,14,0,14,元大-台南,2024-10-23,9896
00795B,中信美國公債20年,14,0,14,元大-台南,2024-10-23,9896
5347,世界,14,0,14,元大-台南,2024-10-23,9896
8021,尖點,14,0,14,元大-台南,2024-10-23,9896
1815,富喬,37,24,13,元大-台南,2024-10-23,9896
00878,國泰永續高股息,282,2,280,元大-台南,2024-10-24,9896
00930,永豐ESG低碳高息,275,0,275,元大-台南,2024-10-24,9896
2312,金寶,309,44,265,元大-台南,2024-10-24,9896
00953B,群益優選非投等債,141,0,141,元大-台南,2024-10-24,9896
0056,元大高股息,140,6,134,元大-台南,2024-10-24,9896
2489,瑞軒,133,11,122,元大-台南,2024-10-24,9896
00937B,群益ESG投等債20,94,0,94,元大-台南,2024-10-24,9896
00680L,元大美債20正2,90,0,90,元大-台南,2024-10-24,9896
00665L,富邦�琤肭磪囓�2,93,19,74,元大-台南,2024-10-24,9896
1721,三晃,212,138,74,元大-台南,2024-10-24,9896
2025,千興,97,30,67,元大-台南,2024-10-24,9896
00919,群益台灣精選高息,86,22,64,元大-台南,2024-10-24,9896
00679B,元大美債20年,69,7,62,元大-台南,2024-10-24,9896
00637L,元大滬深300正2,84,31,53,元大-台南,2024-10-24,9896
2883,凱基金,52,1,51,元大-台南,2024-10-24,9896
00929,復華台灣科技優息,57,7,50,元大-台南,2024-10-24,9896
00882,中信中國高股息,49,1,48,元大-台南,2024-10-24,9896
6727,亞泰金屬,43,0,43,元大-台南,2024-10-24,9896
9105,泰金寶-DR,45,4,41,元大-台南,2024-10-24,9896
6288,聯嘉,40,0,40,元大-台南,2024-10-24,9896
1301,台塑,30,2,28,元大-台南,2024-10-24,9896
00922,國泰台灣領袖50,28,0,28,元大-台南,2024-10-24,9896
2427,三商電,44,16,28,元大-台南,2024-10-24,9896
00959B,大華投等美債15Y+,27,0,27,元大-台南,2024-10-24,9896
2884,玉山金,24,0,24,元大-台南,2024-10-24,9896
8064,東捷,39,17,22,元大-台南,2024-10-24,9896
2882,國泰金,24,3,21,元大-台南,2024-10-24,9896
1528,恩德,44,23,21,元大-台南,2024-10-24,9896
2344,華邦電,32,12,20,元大-台南,2024-10-24,9896
2538,基泰,20,0,20,元大-台南,2024-10-24,9896
5521,工信,20,0,20,元大-台南,2024-10-24,9896
00712,復華富時不動產,19,0,19,元大-台南,2024-10-24,9896
2609,陽明,25,6,19,元大-台南,2024-10-24,9896
1806,冠軍,19,0,19,元大-台南,2024-10-24,9896
00753L,中信中國50正2,19,0,19,元大-台南,2024-10-24,9896
2634,漢翔,19,0,19,元大-台南,2024-10-24,9896
00905,FT臺灣Smart,18,0,18,元大-台南,2024-10-24,9896
00948B,中信優息投資級債,17,0,17,元大-台南,2024-10-24,9896
2388,威盛,32,15,17,元大-台南,2024-10-24,9896
2208,台船,25,8,17,元大-台南,2024-10-24,9896
6763,綠界科技*,23,6,17,元大-台南,2024-10-24,9896
1609,大亞,17,1,16,元大-台南,2024-10-24,9896
8466,美吉吉-KY,15,0,15,元大-台南,2024-10-24,9896
00675L,富邦臺灣加權正2,14,0,14,元大-台南,2024-10-24,9896
00706L,期元大S＆P日圓正2,19,5,14,元大-台南,2024-10-24,9896
2382,廣達,19,6,13,元大-台南,2024-10-24,9896
2303,聯電,26,12,14,元大-台南,2024-10-24,9896
00664R,國泰臺灣加權反1,13,0,13,元大-台南,2024-10-24,9896
3708,上緯投控,13,0,13,元大-台南,2024-10-24,9896
1605,華新,13,1,12,元大-台南,2024-10-24,9896
00680L,元大美債20正2,517,37,480,元大-台南,2024-10-25,9896
2646,星宇航空,330,146,184,元大-台南,2024-10-25,9896
1597,直得,150,0,150,元大-台南,2024-10-25,9896
00937B,群益ESG投等債20,116,13,103,元大-台南,2024-10-25,9896
00772B,中信高評級公司債,101,0,101,元大-台南,2024-10-25,9896
2025,千興,76,0,76,元大-台南,2024-10-25,9896
2883,凱基金,50,0,50,元大-台南,2024-10-25,9896
00687B,國泰20年美債,57,12,45,元大-台南,2024-10-25,9896
8043,蜜望實,61,17,44,元大-台南,2024-10-25,9896
00929,復華台灣科技優息,39,4,35,元大-台南,2024-10-25,9896
4545,銘鈺,50,16,34,元大-台南,2024-10-25,9896
2303,聯電,34,0,34,元大-台南,2024-10-25,9896
6168,宏齊,33,0,33,元大-台南,2024-10-25,9896
00959B,大華投等美債15Y+,33,0,33,元大-台南,2024-10-25,9896
00650L,復華香港正2,30,0,30,元大-台南,2024-10-25,9896
2374,佳能,33,3,30,元大-台南,2024-10-25,9896
5521,工信,30,1,29,元大-台南,2024-10-25,9896
2344,華邦電,41,12,29,元大-台南,2024-10-25,9896
00637L,元大滬深300正2,43,14,29,元大-台南,2024-10-25,9896
00919,群益台灣精選高息,29,2,27,元大-台南,2024-10-25,9896
0056,元大高股息,28,2,26,元大-台南,2024-10-25,9896
2405,輔信,44,20,24,元大-台南,2024-10-25,9896
3149,正達,32,10,22,元大-台南,2024-10-25,9896
2603,長榮,32,11,21,元大-台南,2024-10-25,9896
8240,華宏,25,4,21,元大-台南,2024-10-25,9896
1718,中纖,20,0,20,元大-台南,2024-10-25,9896
00899,FT潔淨能源,20,0,20,元大-台南,2024-10-25,9896
00665L,富邦�琤肭磪囓�2,42,22,20,元大-台南,2024-10-25,9896
6442,光聖,23,4,19,元大-台南,2024-10-25,9896
4743,合一,23,5,18,元大-台南,2024-10-25,9896
00930,永豐ESG低碳高息,20,2,18,元大-台南,2024-10-25,9896
6418,詠昇,80,63,17,元大-台南,2024-10-25,9896
8404,百和興業-KY,27,12,15,元大-台南,2024-10-25,9896
1605,華新,15,0,15,元大-台南,2024-10-25,9896
2495,普安,65,50,15,元大-台南,2024-10-25,9896
00642U,期元大S＆P石油,15,0,15,元大-台南,2024-10-25,9896
4958,臻鼎-KY,18,4,14,元大-台南,2024-10-25,9896
00933B,國泰10Y+金融債,13,0,13,元大-台南,2024-10-25,9896
6213,聯茂,15,2,13,元大-台南,2024-10-25,9896
1802,台玻,13,1,12,元大-台南,2024-10-25,9896
3202,樺晟,14,2,12,元大-台南,2024-10-25,9896
4903,聯光通,18,6,12,元大-台南,2024-10-25,9896
6589,台康生技,13,1,12,元大-台南,2024-10-25,9896
2884,玉山金,11,0,11,元大-台南,2024-10-25,9896
00915,凱基優選高股息30,11,0,11,元大-台南,2024-10-25,9896
3217,優群,11,0,11,元大-台南,2024-10-25,9896
00946,群益科技高息成長,10,0,10,元大-台南,2024-10-25,9896
4729,熒茂,10,0,10,元大-台南,2024-10-25,9896
6140,訊達,10,0,10,元大-台南,2024-10-25,9896
6226,光鼎,10,0,10,元大-台南,2024-10-25,9896
00937B,群益ESG投等債20,163,6,157,元大-台南,2024-10-28,9896
00679B,元大美債20年,187,42,145,元大-台南,2024-10-28,9896
2883,凱基金,140,1,139,元大-台南,2024-10-28,9896
00680L,元大美債20正2,165,38,127,元大-台南,2024-10-28,9896
2025,千興,95,0,95,元大-台南,2024-10-28,9896
00715L,期街口布蘭特正2,100,6,94,元大-台南,2024-10-28,9896
00950B,凱基A級公司債,74,0,74,元大-台南,2024-10-28,9896
00948B,中信優息投資級債,63,0,63,元大-台南,2024-10-28,9896
00712,復華富時不動產,43,0,43,元大-台南,2024-10-28,9896
00687B,國泰20年美債,99,56,43,元大-台南,2024-10-28,9896
00959B,大華投等美債15Y+,40,0,40,元大-台南,2024-10-28,9896
00665L,富邦�琤肭磪囓�2,60,20,40,元大-台南,2024-10-28,9896
2303,聯電,79,43,36,元大-台南,2024-10-28,9896
00637L,元大滬深300正2,39,6,33,元大-台南,2024-10-28,9896
2312,金寶,39,8,31,元大-台南,2024-10-28,9896
6120,達運,30,0,30,元大-台南,2024-10-28,9896
00632R,元大台灣50反1,90,61,29,元大-台南,2024-10-28,9896
4114,健喬,25,0,25,元大-台南,2024-10-28,9896
00929,復華台灣科技優息,34,11,23,元大-台南,2024-10-28,9896
00946,群益科技高息成長,21,3,18,元大-台南,2024-10-28,9896
0056,元大高股息,25,7,18,元大-台南,2024-10-28,9896
00919,群益台灣精選高息,39,24,15,元大-台南,2024-10-28,9896
5521,工信,15,0,15,元大-台南,2024-10-28,9896
2374,佳能,24,9,15,元大-台南,2024-10-28,9896
5328,華容,15,0,15,元大-台南,2024-10-28,9896
6288,聯嘉,72,57,15,元大-台南,2024-10-28,9896
2330,台積電,25,10,15,元大-台南,2024-10-28,9896
1605,華新,24,10,14,元大-台南,2024-10-28,9896
2352,佳世達,16,2,14,元大-台南,2024-10-28,9896
00725B,國泰投資級公司債,14,0,14,元大-台南,2024-10-28,9896
00795B,中信美國公債20年,13,0,13,元大-台南,2024-10-28,9896
3551,世禾,13,0,13,元大-台南,2024-10-28,9896
00922,國泰台灣領袖50,13,0,13,元大-台南,2024-10-28,9896
2615,萬海,18,5,13,元大-台南,2024-10-28,9896
2881,富邦金,20,8,12,元大-台南,2024-10-28,9896
3217,優群,13,1,12,元大-台南,2024-10-28,9896
00931B,統一美債20年,13,1,12,元大-台南,2024-10-28,9896
6530,創威,15,3,12,元大-台南,2024-10-28,9896
8096,擎亞,13,1,12,元大-台南,2024-10-28,9896
3264,欣銓,12,0,12,元大-台南,2024-10-28,9896
4919,新唐,25,13,12,元大-台南,2024-10-28,9896
2891,中信金,16,5,11,元大-台南,2024-10-28,9896
00642U,期元大S＆P石油,11,0,11,元大-台南,2024-10-28,9896
5536,聖暉*,11,0,11,元大-台南,2024-10-28,9896
00953B,群益優選非投等債,11,0,11,元大-台南,2024-10-28,9896
1449,佳和,28,18,10,元大-台南,2024-10-28,9896
00892,富邦台灣半導體,30,20,10,元大-台南,2024-10-28,9896
3093,港建*,10,0,10,元大-台南,2024-10-28,9896
6865,偉康科技,10,0,10,元大-台南,2024-10-28,9896
2838,聯邦銀,10,0,10,元大-台南,2024-10-28,9896
2610,華航,239,28,211,元大-台南,2024-10-29,9896
00919,群益台灣精選高息,195,63,132,元大-台南,2024-10-29,9896
00715L,期街口布蘭特正2,128,0,128,元大-台南,2024-10-29,9896
00940,元大台灣價值高息,170,51,119,元大-台南,2024-10-29,9896
6139,亞翔,105,3,102,元大-台南,2024-10-29,9896
006208,富邦台50,92,5,87,元大-台南,2024-10-29,9896
2025,千興,77,0,77,元大-台南,2024-10-29,9896
00878,國泰永續高股息,82,7,75,元大-台南,2024-10-29,9896
00637L,元大滬深300正2,86,13,73,元大-台南,2024-10-29,9896
00929,復華台灣科技優息,122,50,72,元大-台南,2024-10-29,9896
0056,元大高股息,148,84,64,元大-台南,2024-10-29,9896
2303,聯電,83,21,62,元大-台南,2024-10-29,9896
2883,凱基金,53,0,53,元大-台南,2024-10-29,9896
2834,臺企銀,50,1,49,元大-台南,2024-10-29,9896
00943,兆豐電子高息等權,49,0,49,元大-台南,2024-10-29,9896
00712,復華富時不動產,45,0,45,元大-台南,2024-10-29,9896
2344,華邦電,44,1,43,元大-台南,2024-10-29,9896
2506,太設,39,0,39,元大-台南,2024-10-29,9896
00680L,元大美債20正2,36,0,36,元大-台南,2024-10-29,9896
2882,國泰金,42,10,32,元大-台南,2024-10-29,9896
00881,國泰台灣5G+,30,1,29,元大-台南,2024-10-29,9896
00922,國泰台灣領袖50,36,7,29,元大-台南,2024-10-29,9896
2330,台積電,34,6,28,元大-台南,2024-10-29,9896
2515,中工,27,0,27,元大-台南,2024-10-29,9896
2103,台橡,29,2,27,元大-台南,2024-10-29,9896
1605,華新,46,21,25,元大-台南,2024-10-29,9896
2880,華南金,25,0,25,元大-台南,2024-10-29,9896
1314,中石化,23,0,23,元大-台南,2024-10-29,9896
1301,台塑,24,2,22,元大-台南,2024-10-29,9896
00933B,國泰10Y+金融債,21,0,21,元大-台南,2024-10-29,9896
1785,光洋科,21,0,21,元大-台南,2024-10-29,9896
2338,光罩,22,1,21,元大-台南,2024-10-29,9896
3714,富采,60,40,20,元大-台南,2024-10-29,9896
1712,興農,20,0,20,元大-台南,2024-10-29,9896
00892,富邦台灣半導體,20,0,20,元大-台南,2024-10-29,9896
00706L,期元大S＆P日圓正2,30,10,20,元大-台南,2024-10-29,9896
2449,京元電子,25,7,18,元大-台南,2024-10-29,9896
2495,普安,60,42,18,元大-台南,2024-10-29,9896
00631L,元大台灣50正2,18,0,18,元大-台南,2024-10-29,9896
00850,元大臺灣ESG永續,17,0,17,元大-台南,2024-10-29,9896
00937B,群益ESG投等債20,20,3,17,元大-台南,2024-10-29,9896
00918,大華優利高填息30,19,2,17,元大-台南,2024-10-29,9896
00952,凱基台灣AI50,16,0,16,元大-台南,2024-10-29,9896
00915,凱基優選高股息30,28,12,16,元大-台南,2024-10-29,9896
2890,永豐金,15,0,15,元大-台南,2024-10-29,9896
2399,映泰,72,57,15,元大-台南,2024-10-29,9896
00905,FT臺灣Smart,15,0,15,元大-台南,2024-10-29,9896
3189,景碩,18,4,14,元大-台南,2024-10-29,9896
6589,台康生技,15,1,14,元大-台南,2024-10-29,9896
00927,群益半導體收益,14,0,14,元大-台南,2024-10-29,9896
2303,聯電,142,45,97,元大-台南,2024-10-30,9896
2025,千興,73,0,73,元大-台南,2024-10-30,9896
00665L,富邦�琤肭磪囓�2,142,70,72,元大-台南,2024-10-30,9896
00919,群益台灣精選高息,81,13,68,元大-台南,2024-10-30,9896
00937B,群益ESG投等債20,69,2,67,元大-台南,2024-10-30,9896
2337,旺宏,62,0,62,元大-台南,2024-10-30,9896
1605,華新,54,1,53,元大-台南,2024-10-30,9896
00715L,期街口布蘭特正2,56,5,51,元大-台南,2024-10-30,9896
6505,台塑化,51,2,49,元大-台南,2024-10-30,9896
3481,群創,55,9,46,元大-台南,2024-10-30,9896
5905,南仁湖,46,1,45,元大-台南,2024-10-30,9896
1528,恩德,137,100,37,元大-台南,2024-10-30,9896
2892,第一金,35,0,35,元大-台南,2024-10-30,9896
4526,東台,50,17,33,元大-台南,2024-10-30,9896
00882,中信中國高股息,29,0,29,元大-台南,2024-10-30,9896
00712,復華富時不動產,28,0,28,元大-台南,2024-10-30,9896
00753L,中信中國50正2,77,50,27,元大-台南,2024-10-30,9896
0056,元大高股息,39,13,26,元大-台南,2024-10-30,9896
2890,永豐金,24,0,24,元大-台南,2024-10-30,9896
1802,台玻,36,13,23,元大-台南,2024-10-30,9896
3231,緯創,29,9,20,元大-台南,2024-10-30,9896
6257,矽格,42,22,20,元大-台南,2024-10-30,9896
1449,佳和,20,0,20,元大-台南,2024-10-30,9896
00688L,國泰20年美債正2,20,0,20,元大-台南,2024-10-30,9896
2465,麗臺,20,0,20,元大-台南,2024-10-30,9896
8240,華宏,26,7,19,元大-台南,2024-10-30,9896
2887,台新金,19,0,19,元大-台南,2024-10-30,9896
2605,新興,19,1,18,元大-台南,2024-10-30,9896
006208,富邦台50,21,5,16,元大-台南,2024-10-30,9896
00915,凱基優選高股息30,15,0,15,元大-台南,2024-10-30,9896
2409,友達,15,0,15,元大-台南,2024-10-30,9896
2313,華通,16,2,14,元大-台南,2024-10-30,9896
5347,世界,15,1,14,元大-台南,2024-10-30,9896
2330,台積電,20,6,14,元大-台南,2024-10-30,9896
00934,中信成長高股息,13,0,13,元大-台南,2024-10-30,9896
2413,環科,13,0,13,元大-台南,2024-10-30,9896
4919,新唐,48,36,12,元大-台南,2024-10-30,9896
2103,台橡,12,0,12,元大-台南,2024-10-30,9896
6156,松上,17,5,12,元大-台南,2024-10-30,9896
2327,國巨,13,1,12,元大-台南,2024-10-30,9896
2406,國碩,11,0,11,元大-台南,2024-10-30,9896
2349,錸德,23,12,11,元大-台南,2024-10-30,9896
00929,復華台灣科技優息,40,30,10,元大-台南,2024-10-30,9896
00940,元大台灣價值高息,38,28,10,元大-台南,2024-10-30,9896
2809,京城銀,10,0,10,元大-台南,2024-10-30,9896
4532,瑞智,10,0,10,元大-台南,2024-10-30,9896
3491,昇達科,10,0,10,元大-台南,2024-10-30,9896
2374,佳能,10,0,10,元大-台南,2024-10-30,9896
1732,毛寶,10,0,10,元大-台南,2024-10-30,9896
3591,艾笛森,10,0,10,元大-台南,2024-10-30,9896
00632R,元大台灣50反1,662,232,430,元大-台南,2024-11-01,9896
2025,千興,328,7,321,元大-台南,2024-11-01,9896
2303,聯電,122,9,113,元大-台南,2024-11-01,9896
00929,復華台灣科技優息,136,23,113,元大-台南,2024-11-01,9896
00720B,元大投資級公司債,98,2,96,元大-台南,2024-11-01,9896
00919,群益台灣精選高息,106,16,90,元大-台南,2024-11-01,9896
00878,國泰永續高股息,100,13,87,元大-台南,2024-11-01,9896
00680L,元大美債20正2,80,10,70,元大-台南,2024-11-01,9896
2317,鴻海,73,14,59,元大-台南,2024-11-01,9896
00712,復華富時不動產,44,0,44,元大-台南,2024-11-01,9896
3025,星通,48,7,41,元大-台南,2024-11-01,9896
2891,中信金,59,19,40,元大-台南,2024-11-01,9896
2312,金寶,47,8,39,元大-台南,2024-11-01,9896
0056,元大高股息,58,19,39,元大-台南,2024-11-01,9896
00637L,元大滬深300正2,50,13,37,元大-台南,2024-11-01,9896
2354,鴻準,324,290,34,元大-台南,2024-11-01,9896
00891,中信關鍵半導體,32,0,32,元大-台南,2024-11-01,9896
2328,廣宇,48,17,31,元大-台南,2024-11-01,9896
2337,旺宏,91,60,31,元大-台南,2024-11-01,9896
2431,聯昌,33,2,31,元大-台南,2024-11-01,9896
2892,第一金,31,1,30,元大-台南,2024-11-01,9896
1436,華友聯,28,1,27,元大-台南,2024-11-01,9896
00738U,期元大道瓊白銀,24,0,24,元大-台南,2024-11-01,9896
00953B,群益優選非投等債,24,0,24,元大-台南,2024-11-01,9896
00918,大華優利高填息30,24,0,24,元大-台南,2024-11-01,9896
00922,國泰台灣領袖50,24,1,23,元大-台南,2024-11-01,9896
2409,友達,25,2,23,元大-台南,2024-11-01,9896
2344,華邦電,34,12,22,元大-台南,2024-11-01,9896
2884,玉山金,22,0,22,元大-台南,2024-11-01,9896
3014,聯陽,20,0,20,元大-台南,2024-11-01,9896
00753L,中信中國50正2,20,0,20,元大-台南,2024-11-01,9896
6443,元晶,20,0,20,元大-台南,2024-11-01,9896
1785,光洋科,39,20,19,元大-台南,2024-11-01,9896
3481,群創,32,13,19,元大-台南,2024-11-01,9896
00946,群益科技高息成長,17,0,17,元大-台南,2024-11-01,9896
00948B,中信優息投資級債,16,0,16,元大-台南,2024-11-01,9896
006208,富邦台50,19,3,16,元大-台南,2024-11-01,9896
00635U,期元大S＆P黃金,20,5,15,元大-台南,2024-11-01,9896
5512,力麒,15,0,15,元大-台南,2024-11-01,9896
00675L,富邦臺灣加權正2,15,0,15,元大-台南,2024-11-01,9896
00713,元大台灣高息低波,15,2,13,元大-台南,2024-11-01,9896
0050,元大台灣50,13,0,13,元大-台南,2024-11-01,9896
00959B,大華投等美債15Y+,13,0,13,元大-台南,2024-11-01,9896
00960,野村全球航運龍頭,12,0,12,元大-台南,2024-11-01,9896
00905,FT臺灣Smart,15,3,12,元大-台南,2024-11-01,9896
5438,東友,18,6,12,元大-台南,2024-11-01,9896
00941,中信上游半導體,12,0,12,元大-台南,2024-11-01,9896
2368,金像電,12,1,11,元大-台南,2024-11-01,9896
3324,雙鴻,15,4,11,元大-台南,2024-11-01,9896
00934,中信成長高股息,10,0,10,元大-台南,2024-11-01,9896
2884,玉山金,168,0,168,元大-台南,2024-11-04,9896
3049,精金,182,27,155,元大-台南,2024-11-04,9896
00632R,元大台灣50反1,147,0,147,元大-台南,2024-11-04,9896
00878,國泰永續高股息,145,1,144,元大-台南,2024-11-04,9896
00706L,期元大S＆P日圓正2,100,0,100,元大-台南,2024-11-04,9896
00937B,群益ESG投等債20,185,86,99,元大-台南,2024-11-04,9896
00679B,元大美債20年,87,1,86,元大-台南,2024-11-04,9896
00712,復華富時不動產,81,0,81,元大-台南,2024-11-04,9896
00687B,國泰20年美債,104,26,78,元大-台南,2024-11-04,9896
2025,千興,77,0,77,元大-台南,2024-11-04,9896
9105,泰金寶-DR,56,1,55,元大-台南,2024-11-04,9896
00929,復華台灣科技優息,124,74,50,元大-台南,2024-11-04,9896
00933B,國泰10Y+金融債,46,0,46,元大-台南,2024-11-04,9896
2615,萬海,164,123,41,元大-台南,2024-11-04,9896
5488,松普,41,0,41,元大-台南,2024-11-04,9896
00919,群益台灣精選高息,64,25,39,元大-台南,2024-11-04,9896
0056,元大高股息,48,9,39,元大-台南,2024-11-04,9896
2646,星宇航空,46,10,36,元大-台南,2024-11-04,9896
00637L,元大滬深300正2,48,13,35,元大-台南,2024-11-04,9896
3481,群創,48,18,30,元大-台南,2024-11-04,9896
00948B,中信優息投資級債,26,0,26,元大-台南,2024-11-04,9896
1605,華新,25,0,25,元大-台南,2024-11-04,9896
00751B,元大AAA至A公司債,24,0,24,元大-台南,2024-11-04,9896
00680L,元大美債20正2,26,2,24,元大-台南,2024-11-04,9896
6197,佳必琪,24,2,22,元大-台南,2024-11-04,9896
6216,居易,22,0,22,元大-台南,2024-11-04,9896
3019,亞光,31,10,21,元大-台南,2024-11-04,9896
2609,陽明,62,41,21,元大-台南,2024-11-04,9896
2412,中華電,21,0,21,元大-台南,2024-11-04,9896
00950B,凱基A級公司債,21,0,21,元大-台南,2024-11-04,9896
00725B,國泰投資級公司債,33,15,18,元大-台南,2024-11-04,9896
00885,富邦越南,18,0,18,元大-台南,2024-11-04,9896
2409,友達,20,2,18,元大-台南,2024-11-04,9896
00795B,中信美國公債20年,16,0,16,元大-台南,2024-11-04,9896
9802,鈺齊-KY,16,0,16,元大-台南,2024-11-04,9896
3607,谷崧,15,0,15,元大-台南,2024-11-04,9896
00772B,中信高評級公司債,14,0,14,元大-台南,2024-11-04,9896
3711,日月光投控,16,3,13,元大-台南,2024-11-04,9896
2455,全新,13,0,13,元大-台南,2024-11-04,9896
8107,大億金茂,13,0,13,元大-台南,2024-11-04,9896
6133,金橋,20,7,13,元大-台南,2024-11-04,9896
00900,富邦特選高股息30,14,2,12,元大-台南,2024-11-04,9896
8111,立��,21,9,12,元大-台南,2024-11-04,9896
00953B,群益優選非投等債,12,0,12,元大-台南,2024-11-04,9896
8089,康全電訊,13,1,12,元大-台南,2024-11-04,9896
00932,兆豐永續高息等權,11,0,11,元大-台南,2024-11-04,9896
2408,南亞科,16,5,11,元大-台南,2024-11-04,9896
4915,致伸,11,1,10,元大-台南,2024-11-04,9896
00959B,大華投等美債15Y+,10,0,10,元大-台南,2024-11-04,9896
00927,群益半導體收益,10,0,10,元大-台南,2024-11-04,9896
2409,友達,100,2,98,元大-台南,2024-11-05,9896
2303,聯電,151,72,79,元大-台南,2024-11-05,9896
2025,千興,75,8,67,元大-台南,2024-11-05,9896
00720B,元大投資級公司債,62,1,61,元大-台南,2024-11-05,9896
00919,群益台灣精選高息,66,11,55,元大-台南,2024-11-05,9896
3025,星通,62,14,48,元大-台南,2024-11-05,9896
2401,凌陽,48,1,47,元大-台南,2024-11-05,9896
00632R,元大台灣50反1,42,0,42,元大-台南,2024-11-05,9896
00892,富邦台灣半導體,41,3,38,元大-台南,2024-11-05,9896
8107,大億金茂,30,0,30,元大-台南,2024-11-05,9896
00932,兆豐永續高息等權,28,0,28,元大-台南,2024-11-05,9896
2884,玉山金,23,0,23,元大-台南,2024-11-05,9896
00712,復華富時不動產,22,0,22,元大-台南,2024-11-05,9896
6216,居易,23,2,21,元大-台南,2024-11-05,9896
2344,華邦電,21,0,21,元大-台南,2024-11-05,9896
00673R,期元大S＆P原油反1,20,0,20,元大-台南,2024-11-05,9896
2399,映泰,32,13,19,元大-台南,2024-11-05,9896
00905,FT臺灣Smart,18,0,18,元大-台南,2024-11-05,9896
00891,中信關鍵半導體,15,0,15,元大-台南,2024-11-05,9896
4967,十銓,15,0,15,元大-台南,2024-11-05,9896
2883B,凱基金乙特,15,0,15,元大-台南,2024-11-05,9896
4128,中天,16,2,14,元大-台南,2024-11-05,9896
1595,川寶,15,1,14,元大-台南,2024-11-05,9896
00688L,國泰20年美債正2,20,6,14,元大-台南,2024-11-05,9896
00878,國泰永續高股息,58,44,14,元大-台南,2024-11-05,9896
00934,中信成長高股息,14,1,13,元大-台南,2024-11-05,9896
00959B,大華投等美債15Y+,13,0,13,元大-台南,2024-11-05,9896
2615,萬海,151,138,13,元大-台南,2024-11-05,9896
00940,元大台灣價值高息,62,51,11,元大-台南,2024-11-05,9896
00933B,國泰10Y+金融債,11,0,11,元大-台南,2024-11-05,9896
006208,富邦台50,15,4,11,元大-台南,2024-11-05,9896
1718,中纖,10,0,10,元大-台南,2024-11-05,9896
1727,中華化,10,0,10,元大-台南,2024-11-05,9896
6234,高僑,10,0,10,元大-台南,2024-11-05,9896
3257,虹冠電,10,0,10,元大-台南,2024-11-05,9896
6182,合晶,13,3,10,元大-台南,2024-11-05,9896
4956,光鋐,12,2,10,元大-台南,2024-11-05,9896
8421,旭源,10,0,10,元大-台南,2024-11-05,9896
3231,緯創,98,88,10,元大-台南,2024-11-05,9896
00665L,富邦�琤肭磪囓�2,43,34,9,元大-台南,2024-11-05,9896
8111,立��,21,12,9,元大-台南,2024-11-05,9896
2464,盟立,11,2,9,元大-台南,2024-11-05,9896
1307,三芳,14,5,9,元大-台南,2024-11-05,9896
00946,群益科技高息成長,8,0,8,元大-台南,2024-11-05,9896
3711,日月光投控,10,2,8,元大-台南,2024-11-05,9896
2727,王品,10,3,7,元大-台南,2024-11-05,9896
00950B,凱基A級公司債,7,0,7,元大-台南,2024-11-05,9896
6285,啟��,10,3,7,元大-台南,2024-11-05,9896
0050,元大台灣50,7,1,6,元大-台南,2024-11-05,9896
2328,廣宇,19,12,7,元大-台南,2024-11-05,9896
00953B,群益優選非投等債,1000,0,1000,元大-台南,2024-11-06,9896
00679B,元大美債20年,547,47,500,元大-台南,2024-11-06,9896
3036,文曄,403,3,400,元大-台南,2024-11-06,9896
00637L,元大滬深300正2,190,93,97,元大-台南,2024-11-06,9896
4526,東台,132,48,84,元大-台南,2024-11-06,9896
00937B,群益ESG投等債20,97,15,82,元大-台南,2024-11-06,9896
00650L,復華香港正2,80,0,80,元大-台南,2024-11-06,9896
2025,千興,73,10,63,元大-台南,2024-11-06,9896
00922,國泰台灣領袖50,76,21,55,元大-台南,2024-11-06,9896
2883,凱基金,39,1,38,元大-台南,2024-11-06,9896
00878,國泰永續高股息,47,13,34,元大-台南,2024-11-06,9896
8150,南茂,28,1,27,元大-台南,2024-11-06,9896
2615,萬海,35,8,27,元大-台南,2024-11-06,9896
00720B,元大投資級公司債,32,6,26,元大-台南,2024-11-06,9896
2354,鴻準,281,256,25,元大-台南,2024-11-06,9896
2603,長榮,28,3,25,元大-台南,2024-11-06,9896
00795B,中信美國公債20年,23,0,23,元大-台南,2024-11-06,9896
6216,居易,25,2,23,元大-台南,2024-11-06,9896
00919,群益台灣精選高息,30,7,23,元大-台南,2024-11-06,9896
00915,凱基優選高股息30,61,39,22,元大-台南,2024-11-06,9896
3049,精金,56,34,22,元大-台南,2024-11-06,9896
2609,陽明,43,22,21,元大-台南,2024-11-06,9896
6151,晉倫,20,0,20,元大-台南,2024-11-06,9896
2409,友達,21,1,20,元大-台南,2024-11-06,9896
3615,安可,55,35,20,元大-台南,2024-11-06,9896
00673R,期元大S＆P原油反1,20,0,20,元大-台南,2024-11-06,9896
6757,台灣虎航,19,0,19,元大-台南,2024-11-06,9896
00857B,永豐20年美公債,18,0,18,元大-台南,2024-11-06,9896
00931B,統一美債20年,16,0,16,元大-台南,2024-11-06,9896
2646,星宇航空,19,4,15,元大-台南,2024-11-06,9896
00959B,大華投等美債15Y+,15,0,15,元大-台南,2024-11-06,9896
3540,曜越,14,0,14,元大-台南,2024-11-06,9896
911868,同方友友-DR,14,0,14,元大-台南,2024-11-06,9896
1101,台泥,13,0,13,元大-台南,2024-11-06,9896
6530,創威,18,5,13,元大-台南,2024-11-06,9896
2884,玉山金,13,0,13,元大-台南,2024-11-06,9896
1609,大亞,12,0,12,元大-台南,2024-11-06,9896
00930,永豐ESG低碳高息,20,8,12,元大-台南,2024-11-06,9896
6446,藥華藥,14,3,11,元大-台南,2024-11-06,9896
00942B,台新美A公司債20+,11,0,11,元大-台南,2024-11-06,9896
9907,統一實,11,0,11,元大-台南,2024-11-06,9896
8374,羅昇,16,6,10,元大-台南,2024-11-06,9896
1528,恩德,19,9,10,元大-台南,2024-11-06,9896
1314,中石化,12,2,10,元大-台南,2024-11-06,9896
2305,全友,10,0,10,元大-台南,2024-11-06,9896
2328,廣宇,11,1,10,元大-台南,2024-11-06,9896
9105,泰金寶-DR,86,76,10,元大-台南,2024-11-06,9896
2385,群光,9,0,9,元大-台南,2024-11-06,9896
00706L,期元大S＆P日圓正2,19,10,9,元大-台南,2024-11-06,9896
1326,台化,11,2,9,元大-台南,2024-11-06,9896
00632R,元大台灣50反1,380,105,275,元大-台南,2024-11-07,9896
00878,國泰永續高股息,154,21,133,元大-台南,2024-11-07,9896
00679B,元大美債20年,131,19,112,元大-台南,2024-11-07,9896
00687B,國泰20年美債,106,21,85,元大-台南,2024-11-07,9896
00919,群益台灣精選高息,75,7,68,元大-台南,2024-11-07,9896
00712,復華富時不動產,73,20,53,元大-台南,2024-11-07,9896
2367,燿華,64,17,47,元大-台南,2024-11-07,9896
2025,千興,57,10,47,元大-台南,2024-11-07,9896
00673R,期元大S＆P原油反1,46,0,46,元大-台南,2024-11-07,9896
2615,萬海,50,7,43,元大-台南,2024-11-07,9896
00631L,元大台灣50正2,32,0,32,元大-台南,2024-11-07,9896
00933B,國泰10Y+金融債,30,0,30,元大-台南,2024-11-07,9896
0056,元大高股息,64,38,26,元大-台南,2024-11-07,9896
00918,大華優利高填息30,31,6,25,元大-台南,2024-11-07,9896
6244,茂迪,22,0,22,元大-台南,2024-11-07,9896
00942B,台新美A公司債20+,20,0,20,元大-台南,2024-11-07,9896
00887,永豐中國科技50大,25,5,20,元大-台南,2024-11-07,9896
2609,陽明,60,44,16,元大-台南,2024-11-07,9896
2892,第一金,21,5,16,元大-台南,2024-11-07,9896
00655L,國泰中國A50正2,15,0,15,元大-台南,2024-11-07,9896
2426,鼎元,16,1,15,元大-台南,2024-11-07,9896
00676R,富邦臺灣加權反1,15,0,15,元大-台南,2024-11-07,9896
4903,聯光通,36,21,15,元大-台南,2024-11-07,9896
00937B,群益ESG投等債20,22,8,14,元大-台南,2024-11-07,9896
2888,新光金,14,0,14,元大-台南,2024-11-07,9896
2014,中鴻,36,22,14,元大-台南,2024-11-07,9896
00932,兆豐永續高息等權,13,0,13,元大-台南,2024-11-07,9896
00713,元大台灣高息低波,17,4,13,元大-台南,2024-11-07,9896
8086,宏捷科,14,2,12,元大-台南,2024-11-07,9896
3701,大眾控,21,10,11,元大-台南,2024-11-07,9896
2605,新興,11,0,11,元大-台南,2024-11-07,9896
00669R,國泰美國道瓊反1,10,0,10,元大-台南,2024-11-07,9896
8131,福懋科,10,0,10,元大-台南,2024-11-07,9896
1710,東聯,10,0,10,元大-台南,2024-11-07,9896
4510,高鋒,18,9,9,元大-台南,2024-11-07,9896
1314,中石化,9,0,9,元大-台南,2024-11-07,9896
00938,凱基優選30,9,0,9,元大-台南,2024-11-07,9896
5243,乙盛-KY,20,11,9,元大-台南,2024-11-07,9896
2399,映泰,18,10,8,元大-台南,2024-11-07,9896
2349,錸德,10,2,8,元大-台南,2024-11-07,9896
2353,宏��,9,1,8,元大-台南,2024-11-07,9896
00690,兆豐藍籌30,8,0,8,元大-台南,2024-11-07,9896
2493,揚博,10,2,8,元大-台南,2024-11-07,9896
5014,建錩,18,10,8,元大-台南,2024-11-07,9896
1101,台泥,9,1,8,元大-台南,2024-11-07,9896
2903,遠百,8,0,8,元大-台南,2024-11-07,9896
5386,青雲,19,11,8,元大-台南,2024-11-07,9896
8070,長華*,9,1,8,元大-台南,2024-11-07,9896
2421,建準,8,0,8,元大-台南,2024-11-07,9896
3037,欣興,24,16,8,元大-台南,2024-11-07,9896
00632R,元大台灣50反1,2089,1,2088,元大-台南,2024-11-08,9896
00937B,群益ESG投等債20,501,184,317,元大-台南,2024-11-08,9896
2892,第一金,112,3,109,元大-台南,2024-11-08,9896
00953B,群益優選非投等債,107,0,107,元大-台南,2024-11-08,9896
00637L,元大滬深300正2,113,6,107,元大-台南,2024-11-08,9896
00753L,中信中國50正2,114,12,102,元大-台南,2024-11-08,9896
9105,泰金寶-DR,172,72,100,元大-台南,2024-11-08,9896
00933B,國泰10Y+金融債,102,13,89,元大-台南,2024-11-08,9896
3062,建漢,104,46,58,元大-台南,2024-11-08,9896
00943,兆豐電子高息等權,50,0,50,元大-台南,2024-11-08,9896
00633L,富邦上証正2,56,7,49,元大-台南,2024-11-08,9896
00878,國泰永續高股息,79,33,46,元大-台南,2024-11-08,9896
2025,千興,66,20,46,元大-台南,2024-11-08,9896
2303,聯電,66,21,45,元大-台南,2024-11-08,9896
2345,智邦,44,0,44,元大-台南,2024-11-08,9896
2489,瑞軒,42,0,42,元大-台南,2024-11-08,9896
00730,富邦臺灣優質高息,40,0,40,元大-台南,2024-11-08,9896
2731,雄獅,36,1,35,元大-台南,2024-11-08,9896
2356,英業達,93,58,35,元大-台南,2024-11-08,9896
00915,凱基優選高股息30,37,2,35,元大-台南,2024-11-08,9896
6282,康舒,30,0,30,元大-台南,2024-11-08,9896
2354,鴻準,311,282,29,元大-台南,2024-11-08,9896
3689,湧德,34,10,24,元大-台南,2024-11-08,9896
6215,和椿,25,1,24,元大-台南,2024-11-08,9896
6151,晉倫,24,0,24,元大-台南,2024-11-08,9896
8043,蜜望實,24,0,24,元大-台南,2024-11-08,9896
00751B,元大AAA至A公司債,22,0,22,元大-台南,2024-11-08,9896
00673R,期元大S＆P原油反1,21,0,21,元大-台南,2024-11-08,9896
2605,新興,20,0,20,元大-台南,2024-11-08,9896
00951,台新日本半導體,20,0,20,元大-台南,2024-11-08,9896
2887,台新金,20,0,20,元大-台南,2024-11-08,9896
2409,友達,19,0,19,元大-台南,2024-11-08,9896
6285,啟��,24,6,18,元大-台南,2024-11-08,9896
2385,群光,18,0,18,元大-台南,2024-11-08,9896
6609,瀧澤科,22,7,15,元大-台南,2024-11-08,9896
2344,華邦電,16,1,15,元大-台南,2024-11-08,9896
6477,安集,15,0,15,元大-台南,2024-11-08,9896
2368,金像電,19,4,15,元大-台南,2024-11-08,9896
6182,合晶,21,7,14,元大-台南,2024-11-08,9896
2388,威盛,30,16,14,元大-台南,2024-11-08,9896
6191,精成科,14,0,14,元大-台南,2024-11-08,9896
8111,立��,18,4,14,元大-台南,2024-11-08,9896
3535,晶彩科,14,0,14,元大-台南,2024-11-08,9896
1524,耿鼎,18,4,14,元大-台南,2024-11-08,9896
3533,嘉澤,14,0,14,元大-台南,2024-11-08,9896
2353,宏��,16,4,12,元大-台南,2024-11-08,9896
00679B,元大美債20年,31,19,12,元大-台南,2024-11-08,9896
2313,華通,17,5,12,元大-台南,2024-11-08,9896
3044,健鼎,14,2,12,元大-台南,2024-11-08,9896
5876,上海商銀,12,0,12,元大-台南,2024-11-08,9896
00679B,元大美債20年,172,10,162,元大-台南,2024-11-11,9896
00650L,復華香港正2,150,0,150,元大-台南,2024-11-11,9896
2884,玉山金,100,1,99,元大-台南,2024-11-11,9896
2025,千興,81,0,81,元大-台南,2024-11-11,9896
00665L,富邦�琤肭磪囓�2,72,6,66,元大-台南,2024-11-11,9896
00878,國泰永續高股息,54,3,51,元大-台南,2024-11-11,9896
2892,第一金,49,1,48,元大-台南,2024-11-11,9896
00637L,元大滬深300正2,72,30,42,元大-台南,2024-11-11,9896
1605,華新,44,2,42,元大-台南,2024-11-11,9896
6216,居易,42,2,40,元大-台南,2024-11-11,9896
8011,台通,40,3,37,元大-台南,2024-11-11,9896
00915,凱基優選高股息30,58,23,35,元大-台南,2024-11-11,9896
2312,金寶,53,19,34,元大-台南,2024-11-11,9896
00919,群益台灣精選高息,37,4,33,元大-台南,2024-11-11,9896
2303,聯電,36,6,30,元大-台南,2024-11-11,9896
1444,力麗,30,0,30,元大-台南,2024-11-11,9896
00946,群益科技高息成長,29,0,29,元大-台南,2024-11-11,9896
00713,元大台灣高息低波,28,0,28,元大-台南,2024-11-11,9896
0056,元大高股息,64,36,28,元大-台南,2024-11-11,9896
6285,啟��,35,9,26,元大-台南,2024-11-11,9896
2354,鴻準,253,227,26,元大-台南,2024-11-11,9896
2392,正崴,56,30,26,元大-台南,2024-11-11,9896
2609,陽明,43,20,23,元大-台南,2024-11-11,9896
00688L,國泰20年美債正2,33,12,21,元大-台南,2024-11-11,9896
2337,旺宏,20,0,20,元大-台南,2024-11-11,9896
6244,茂迪,20,0,20,元大-台南,2024-11-11,9896
00918,大華優利高填息30,20,0,20,元大-台南,2024-11-11,9896
2429,銘旺科,20,0,20,元大-台南,2024-11-11,9896
00687B,國泰20年美債,40,22,18,元大-台南,2024-11-11,9896
2374,佳能,21,3,18,元大-台南,2024-11-11,9896
2313,華通,17,0,17,元大-台南,2024-11-11,9896
3231,緯創,52,35,17,元大-台南,2024-11-11,9896
2353,宏��,30,14,16,元大-台南,2024-11-11,9896
00933B,國泰10Y+金融債,15,0,15,元大-台南,2024-11-11,9896
2369,菱生,15,0,15,元大-台南,2024-11-11,9896
2615,萬海,37,23,14,元大-台南,2024-11-11,9896
5483,中美晶,14,0,14,元大-台南,2024-11-11,9896
4716,大立,16,2,14,元大-台南,2024-11-11,9896
00795B,中信美國公債20年,13,0,13,元大-台南,2024-11-11,9896
00738U,期元大道瓊白銀,13,0,13,元大-台南,2024-11-11,9896
5011,久陽,12,0,12,元大-台南,2024-11-11,9896
006208,富邦台50,13,1,12,元大-台南,2024-11-11,9896
2409,友達,12,1,11,元大-台南,2024-11-11,9896
00706L,期元大S＆P日圓正2,11,0,11,元大-台南,2024-11-11,9896
6215,和椿,11,0,11,元大-台南,2024-11-11,9896
4916,事欣科,11,0,11,元大-台南,2024-11-11,9896
2349,錸德,13,2,11,元大-台南,2024-11-11,9896
911868,同方友友-DR,11,0,11,元大-台南,2024-11-11,9896
3710,連展投控,11,0,11,元大-台南,2024-11-11,9896
2449,京元電子,53,42,11,元大-台南,2024-11-11,9896
00878,國泰永續高股息,366,32,334,元大-台南,2024-11-12,9896
00933B,國泰10Y+金融債,181,0,181,元大-台南,2024-11-12,9896
0056,元大高股息,156,1,155,元大-台南,2024-11-12,9896
00650L,復華香港正2,120,0,120,元大-台南,2024-11-12,9896
2025,千興,105,0,105,元大-台南,2024-11-12,9896
1440,南紡,102,1,101,元大-台南,2024-11-12,9896
1536,和大,91,5,86,元大-台南,2024-11-12,9896
00715L,期街口布蘭特正2,84,2,82,元大-台南,2024-11-12,9896
2882,國泰金,80,0,80,元大-台南,2024-11-12,9896
00929,復華台灣科技優息,75,2,73,元大-台南,2024-11-12,9896
1314,中石化,68,0,68,元大-台南,2024-11-12,9896
2356,英業達,103,36,67,元大-台南,2024-11-12,9896
00688L,國泰20年美債正2,60,0,60,元大-台南,2024-11-12,9896
00915,凱基優選高股息30,102,46,56,元大-台南,2024-11-12,9896
2353,宏��,58,2,56,元大-台南,2024-11-12,9896
3231,緯創,84,31,53,元大-台南,2024-11-12,9896
00943,兆豐電子高息等權,52,0,52,元大-台南,2024-11-12,9896
5871,中租-KY,51,1,50,元大-台南,2024-11-12,9896
1464,得力,50,0,50,元大-台南,2024-11-12,9896
2892,第一金,48,0,48,元大-台南,2024-11-12,9896
2646,星宇航空,53,6,47,元大-台南,2024-11-12,9896
2014,中鴻,46,0,46,元大-台南,2024-11-12,9896
5880,合庫金,46,0,46,元大-台南,2024-11-12,9896
00922,國泰台灣領袖50,46,1,45,元大-台南,2024-11-12,9896
4906,正文,45,0,45,元大-台南,2024-11-12,9896
006208,富邦台50,48,8,40,元大-台南,2024-11-12,9896
00882,中信中國高股息,62,26,36,元大-台南,2024-11-12,9896
00919,群益台灣精選高息,45,9,36,元大-台南,2024-11-12,9896
9934,成霖,35,0,35,元大-台南,2024-11-12,9896
3062,建漢,33,1,32,元大-台南,2024-11-12,9896
00909,國泰數位支付服務,32,0,32,元大-台南,2024-11-12,9896
00713,元大台灣高息低波,33,2,31,元大-台南,2024-11-12,9896
6216,居易,33,3,30,元大-台南,2024-11-12,9896
00730,富邦臺灣優質高息,30,0,30,元大-台南,2024-11-12,9896
00891,中信關鍵半導體,29,0,29,元大-台南,2024-11-12,9896
2002,中鋼,28,0,28,元大-台南,2024-11-12,9896
6763,綠界科技*,37,10,27,元大-台南,2024-11-12,9896
2883,凱基金,34,8,26,元大-台南,2024-11-12,9896
2317,鴻海,38,13,25,元大-台南,2024-11-12,9896
6657,華安,23,0,23,元大-台南,2024-11-12,9896
00932,兆豐永續高息等權,22,0,22,元大-台南,2024-11-12,9896
0050,元大台灣50,35,13,22,元大-台南,2024-11-12,9896
00881,國泰台灣5G+,26,5,21,元大-台南,2024-11-12,9896
00631L,元大台灣50正2,22,2,20,元大-台南,2024-11-12,9896
2615,萬海,41,21,20,元大-台南,2024-11-12,9896
2330,台積電,22,3,19,元大-台南,2024-11-12,9896
6288,聯嘉,30,12,18,元大-台南,2024-11-12,9896
1301,台塑,18,1,17,元大-台南,2024-11-12,9896
3044,健鼎,17,0,17,元大-台南,2024-11-12,9896
00680L,元大美債20正2,25,9,16,元大-台南,2024-11-12,9896
00937B,群益ESG投等債20,312,9,303,元大-台南,2024-11-13,9896
00679B,元大美債20年,334,70,264,元大-台南,2024-11-13,9896
00878,國泰永續高股息,199,3,196,元大-台南,2024-11-13,9896
3706,神達,287,210,77,元大-台南,2024-11-13,9896
2883,凱基金,71,3,68,元大-台南,2024-11-13,9896
2025,千興,63,0,63,元大-台南,2024-11-13,9896
3481,群創,62,6,56,元大-台南,2024-11-13,9896
5880,合庫金,54,0,54,元大-台南,2024-11-13,9896
1536,和大,52,3,49,元大-台南,2024-11-13,9896
00919,群益台灣精選高息,45,1,44,元大-台南,2024-11-13,9896
8011,台通,66,25,41,元大-台南,2024-11-13,9896
2465,麗臺,40,0,40,元大-台南,2024-11-13,9896
2027,大成鋼,43,3,40,元大-台南,2024-11-13,9896
00882,中信中國高股息,49,10,39,元大-台南,2024-11-13,9896
00715L,期街口布蘭特正2,41,2,39,元大-台南,2024-11-13,9896
00680L,元大美債20正2,38,0,38,元大-台南,2024-11-13,9896
00688L,國泰20年美債正2,35,0,35,元大-台南,2024-11-13,9896
2882,國泰金,35,0,35,元大-台南,2024-11-13,9896
1301,台塑,36,4,32,元大-台南,2024-11-13,9896
2303,聯電,60,29,31,元大-台南,2024-11-13,9896
1605,華新,30,0,30,元大-台南,2024-11-13,9896
00948B,中信優息投資級債,30,0,30,元大-台南,2024-11-13,9896
2344,華邦電,29,0,29,元大-台南,2024-11-13,9896
0056,元大高股息,31,5,26,元大-台南,2024-11-13,9896
00725B,國泰投資級公司債,24,0,24,元大-台南,2024-11-13,9896
5202,力新,24,1,23,元大-台南,2024-11-13,9896
00751B,元大AAA至A公司債,22,0,22,元大-台南,2024-11-13,9896
2615,萬海,29,7,22,元大-台南,2024-11-13,9896
00915,凱基優選高股息30,24,2,22,元大-台南,2024-11-13,9896
00932,兆豐永續高息等權,21,0,21,元大-台南,2024-11-13,9896
2884,玉山金,22,1,21,元大-台南,2024-11-13,9896
3003,健和興,21,1,20,元大-台南,2024-11-13,9896
2603,長榮,27,8,19,元大-台南,2024-11-13,9896
2834,臺企銀,19,0,19,元大-台南,2024-11-13,9896
00713,元大台灣高息低波,19,0,19,元大-台南,2024-11-13,9896
00637L,元大滬深300正2,40,22,18,元大-台南,2024-11-13,9896
00922,國泰台灣領袖50,17,0,17,元大-台南,2024-11-13,9896
6147,頎邦,17,1,16,元大-台南,2024-11-13,9896
00712,復華富時不動產,15,0,15,元大-台南,2024-11-13,9896
9105,泰金寶-DR,35,20,15,元大-台南,2024-11-13,9896
2317,鴻海,35,20,15,元大-台南,2024-11-13,9896
2892,第一金,19,6,13,元大-台南,2024-11-13,9896
2881,富邦金,13,0,13,元大-台南,2024-11-13,9896
006208,富邦台50,23,10,13,元大-台南,2024-11-13,9896
3450,聯鈞,30,17,13,元大-台南,2024-11-13,9896
2353,宏��,14,2,12,元大-台南,2024-11-13,9896
2368,金像電,13,1,12,元大-台南,2024-11-13,9896
6505,台塑化,13,1,12,元大-台南,2024-11-13,9896
3607,谷崧,12,0,12,元大-台南,2024-11-13,9896
00943,兆豐電子高息等權,12,0,12,元大-台南,2024-11-13,9896
00878,國泰永續高股息,315,10,305,元大-台南,2024-11-14,9896
00664R,國泰臺灣加權反1,300,100,200,元大-台南,2024-11-14,9896
00937B,群益ESG投等債20,206,31,175,元大-台南,2024-11-14,9896
00929,復華台灣科技優息,127,1,126,元大-台南,2024-11-14,9896
0056,元大高股息,141,32,109,元大-台南,2024-11-14,9896
1440,南紡,94,0,94,元大-台南,2024-11-14,9896
00706L,期元大S＆P日圓正2,104,19,85,元大-台南,2024-11-14,9896
2025,千興,71,0,71,元大-台南,2024-11-14,9896
3481,群創,90,31,59,元大-台南,2024-11-14,9896
4931,新盛力,132,74,58,元大-台南,2024-11-14,9896
2495,普安,53,1,52,元大-台南,2024-11-14,9896
2892,第一金,51,0,51,元大-台南,2024-11-14,9896
2303,聯電,62,12,50,元大-台南,2024-11-14,9896
2301,光寶科,52,6,46,元大-台南,2024-11-14,9896
2880,華南金,44,0,44,元大-台南,2024-11-14,9896
00915,凱基優選高股息30,45,3,42,元大-台南,2024-11-14,9896
2646,星宇航空,43,2,41,元大-台南,2024-11-14,9896
2905,三商,40,0,40,元大-台南,2024-11-14,9896
00943,兆豐電子高息等權,35,0,35,元大-台南,2024-11-14,9896
1785,光洋科,41,8,33,元大-台南,2024-11-14,9896
4306,炎洲,33,0,33,元大-台南,2024-11-14,9896
2349,錸德,73,41,32,元大-台南,2024-11-14,9896
2603,長榮,41,9,32,元大-台南,2024-11-14,9896
00891,中信關鍵半導體,36,4,32,元大-台南,2024-11-14,9896
00919,群益台灣精選高息,59,29,30,元大-台南,2024-11-14,9896
2449,京元電子,36,7,29,元大-台南,2024-11-14,9896
00927,群益半導體收益,29,1,28,元大-台南,2024-11-14,9896
8011,台通,55,27,28,元大-台南,2024-11-14,9896
6147,頎邦,27,0,27,元大-台南,2024-11-14,9896
00950B,凱基A級公司債,25,0,25,元大-台南,2024-11-14,9896
00687B,國泰20年美債,33,10,23,元大-台南,2024-11-14,9896
1301,台塑,25,2,23,元大-台南,2024-11-14,9896
0050,元大台灣50,26,4,22,元大-台南,2024-11-14,9896
00932,兆豐永續高息等權,21,0,21,元大-台南,2024-11-14,9896
00665L,富邦�琤肭磪囓�2,20,0,20,元大-台南,2024-11-14,9896
6168,宏齊,20,0,20,元大-台南,2024-11-14,9896
2344,華邦電,30,10,20,元大-台南,2024-11-14,9896
3231,緯創,82,63,19,元大-台南,2024-11-14,9896
00922,國泰台灣領袖50,19,0,19,元大-台南,2024-11-14,9896
2409,友達,19,0,19,元大-台南,2024-11-14,9896
2615,萬海,28,9,19,元大-台南,2024-11-14,9896
3013,晟銘電,38,20,18,元大-台南,2024-11-14,9896
00679B,元大美債20年,124,107,17,元大-台南,2024-11-14,9896
2408,南亞科,17,1,16,元大-台南,2024-11-14,9896
2609,陽明,44,28,16,元大-台南,2024-11-14,9896
006208,富邦台50,16,1,15,元大-台南,2024-11-14,9896
00948B,中信優息投資級債,15,0,15,元大-台南,2024-11-14,9896
5309,系統電,16,1,15,元大-台南,2024-11-14,9896
2382,廣達,17,3,14,元大-台南,2024-11-14,9896
00713,元大台灣高息低波,20,6,14,元大-台南,2024-11-14,9896
2891,中信金,588,16,572,元大-台南,2024-11-15,9896
00878,國泰永續高股息,442,5,437,元大-台南,2024-11-15,9896
00664R,國泰臺灣加權反1,350,0,350,元大-台南,2024-11-15,9896
00937B,群益ESG投等債20,211,12,199,元大-台南,2024-11-15,9896
9105,泰金寶-DR,236,98,138,元大-台南,2024-11-15,9896
00953B,群益優選非投等債,97,0,97,元大-台南,2024-11-15,9896
2382,廣達,85,9,76,元大-台南,2024-11-15,9896
2025,千興,75,0,75,元大-台南,2024-11-15,9896
2027,大成鋼,72,2,70,元大-台南,2024-11-15,9896
00930,永豐ESG低碳高息,46,0,46,元大-台南,2024-11-15,9896
00933B,國泰10Y+金融債,44,1,43,元大-台南,2024-11-15,9896
4931,新盛力,46,4,42,元大-台南,2024-11-15,9896
2324,仁寶,54,14,40,元大-台南,2024-11-15,9896
2317,鴻海,85,49,36,元大-台南,2024-11-15,9896
2888,新光金,51,18,33,元大-台南,2024-11-15,9896
0056,元大高股息,32,0,32,元大-台南,2024-11-15,9896
6952,大武山,29,1,28,元大-台南,2024-11-15,9896
00637L,元大滬深300正2,34,8,26,元大-台南,2024-11-15,9896
3706,神達,185,162,23,元大-台南,2024-11-15,9896
00948B,中信優息投資級債,23,0,23,元大-台南,2024-11-15,9896
00929,復華台灣科技優息,38,15,23,元大-台南,2024-11-15,9896
6177,達麗,26,5,21,元大-台南,2024-11-15,9896
00713,元大台灣高息低波,21,1,20,元大-台南,2024-11-15,9896
6558,興能高,20,2,18,元大-台南,2024-11-15,9896
00943,兆豐電子高息等權,17,0,17,元大-台南,2024-11-15,9896
00665L,富邦�琤肭磪囓�2,37,20,17,元大-台南,2024-11-15,9896
1815,富喬,13,0,13,元大-台南,2024-11-15,9896
2303,聯電,33,20,13,元大-台南,2024-11-15,9896
2637,慧洋-KY,16,3,13,元大-台南,2024-11-15,9896
00887,永豐中國科技50大,13,0,13,元大-台南,2024-11-15,9896
2414,精技,17,5,12,元大-台南,2024-11-15,9896
00932,兆豐永續高息等權,11,0,11,元大-台南,2024-11-15,9896
6191,精成科,10,0,10,元大-台南,2024-11-15,9896
4771,望隼,10,0,10,元大-台南,2024-11-15,9896
00922,國泰台灣領袖50,10,0,10,元大-台南,2024-11-15,9896
8064,東捷,15,6,9,元大-台南,2024-11-15,9896
6405,悅城,25,16,9,元大-台南,2024-11-15,9896
9904,寶成,47,39,8,元大-台南,2024-11-15,9896
4977,眾達-KY,18,10,8,元大-台南,2024-11-15,9896
2392,正崴,33,25,8,元大-台南,2024-11-15,9896
6215,和椿,8,0,8,元大-台南,2024-11-15,9896
9939,宏全,8,0,8,元大-台南,2024-11-15,9896
3293,鈊象,11,4,7,元大-台南,2024-11-15,9896
5871,中租-KY,17,10,7,元大-台南,2024-11-15,9896
1785,光洋科,7,0,7,元大-台南,2024-11-15,9896
2356,英業達,12,5,7,元大-台南,2024-11-15,9896
2474,可成,13,6,7,元大-台南,2024-11-15,9896
5202,力新,7,0,7,元大-台南,2024-11-15,9896
3701,大眾控,7,0,7,元大-台南,2024-11-15,9896
3037,欣興,28,22,6,元大-台南,2024-11-15,9896
00706L,期元大S＆P日圓正2,881,0,881,元大-台南,2024-11-18,9896
00878,國泰永續高股息,423,29,394,元大-台南,2024-11-18,9896
00929,復華台灣科技優息,150,31,119,元大-台南,2024-11-18,9896
0056,元大高股息,103,0,103,元大-台南,2024-11-18,9896
00715L,期街口布蘭特正2,101,0,101,元大-台南,2024-11-18,9896
2881,富邦金,74,4,70,元大-台南,2024-11-18,9896
2025,千興,69,0,69,元大-台南,2024-11-18,9896
2354,鴻準,269,227,42,元大-台南,2024-11-18,9896
2409,友達,52,14,38,元大-台南,2024-11-18,9896
00679B,元大美債20年,70,32,38,元大-台南,2024-11-18,9896
2301,光寶科,36,1,35,元大-台南,2024-11-18,9896
00713,元大台灣高息低波,32,2,30,元大-台南,2024-11-18,9896
2317,鴻海,48,18,30,元大-台南,2024-11-18,9896
006208,富邦台50,27,1,26,元大-台南,2024-11-18,9896
1471,首利,26,3,23,元大-台南,2024-11-18,9896
2884,玉山金,23,0,23,元大-台南,2024-11-18,9896
00943,兆豐電子高息等權,21,0,21,元大-台南,2024-11-18,9896
00665L,富邦�琤肭磪囓�2,32,12,20,元大-台南,2024-11-18,9896
3037,欣興,33,14,19,元大-台南,2024-11-18,9896
00891,中信關鍵半導體,20,1,19,元大-台南,2024-11-18,9896
2646,星宇航空,21,4,17,元大-台南,2024-11-18,9896
00881,國泰台灣5G+,22,5,17,元大-台南,2024-11-18,9896
6285,啟��,23,7,16,元大-台南,2024-11-18,9896
2312,金寶,66,50,16,元大-台南,2024-11-18,9896
00919,群益台灣精選高息,22,6,16,元大-台南,2024-11-18,9896
3481,群創,27,11,16,元大-台南,2024-11-18,9896
4157,太景*-KY,15,0,15,元大-台南,2024-11-18,9896
2356,英業達,23,9,14,元大-台南,2024-11-18,9896
3062,建漢,20,6,14,元大-台南,2024-11-18,9896
00935,野村臺灣新科技50,14,0,14,元大-台南,2024-11-18,9896
8240,華宏,15,1,14,元大-台南,2024-11-18,9896
00918,大華優利高填息30,13,0,13,元大-台南,2024-11-18,9896
00922,國泰台灣領袖50,13,0,13,元大-台南,2024-11-18,9896
00894,中信小資高價30,13,0,13,元大-台南,2024-11-18,9896
00642U,期元大S＆P石油,12,0,12,元大-台南,2024-11-18,9896
00937B,群益ESG投等債20,14,2,12,元大-台南,2024-11-18,9896
1326,台化,28,16,12,元大-台南,2024-11-18,9896
1785,光洋科,14,2,12,元大-台南,2024-11-18,9896
2313,華通,14,2,12,元大-台南,2024-11-18,9896
00932,兆豐永續高息等權,12,0,12,元大-台南,2024-11-18,9896
3231,緯創,30,18,12,元大-台南,2024-11-18,9896
6187,萬潤,12,1,11,元大-台南,2024-11-18,9896
00915,凱基優選高股息30,17,6,11,元大-台南,2024-11-18,9896
6213,聯茂,13,2,11,元大-台南,2024-11-18,9896
2548,華固,11,0,11,元大-台南,2024-11-18,9896
00905,FT臺灣Smart,15,5,10,元大-台南,2024-11-18,9896
3024,憶聲,10,0,10,元大-台南,2024-11-18,9896
2643,捷迅,10,0,10,元大-台南,2024-11-18,9896
2905,三商,10,0,10,元大-台南,2024-11-18,9896
0050,元大台灣50,17,7,10,元大-台南,2024-11-18,9896
00706L,期元大S＆P日圓正2,185,14,171,元大-台南,2024-11-19,9896
9105,泰金寶-DR,235,112,123,元大-台南,2024-11-19,9896
1301,台塑,108,2,106,元大-台南,2024-11-19,9896
2344,華邦電,103,6,97,元大-台南,2024-11-19,9896
2349,錸德,190,100,90,元大-台南,2024-11-19,9896
00948B,中信優息投資級債,80,0,80,元大-台南,2024-11-19,9896
2025,千興,70,0,70,元大-台南,2024-11-19,9896
2888,新光金,99,39,60,元大-台南,2024-11-19,9896
00937B,群益ESG投等債20,57,1,56,元大-台南,2024-11-19,9896
00637L,元大滬深300正2,62,13,49,元大-台南,2024-11-19,9896
00932,兆豐永續高息等權,51,6,45,元大-台南,2024-11-19,9896
00950B,凱基A級公司債,40,0,40,元大-台南,2024-11-19,9896
00933B,國泰10Y+金融債,30,0,30,元大-台南,2024-11-19,9896
00635U,期元大S＆P黃金,27,0,27,元大-台南,2024-11-19,9896
2610,華航,57,32,25,元大-台南,2024-11-19,9896
5905,南仁湖,23,0,23,元大-台南,2024-11-19,9896
2382,廣達,30,8,22,元大-台南,2024-11-19,9896
2317,鴻海,44,22,22,元大-台南,2024-11-19,9896
6246,臺龍,22,0,22,元大-台南,2024-11-19,9896
6216,居易,20,0,20,元大-台南,2024-11-19,9896
4532,瑞智,20,0,20,元大-台南,2024-11-19,9896
6213,聯茂,20,0,20,元大-台南,2024-11-19,9896
4526,東台,20,1,19,元大-台南,2024-11-19,9896
2303,聯電,46,28,18,元大-台南,2024-11-19,9896
3231,緯創,24,6,18,元大-台南,2024-11-19,9896
00673R,期元大S＆P原油反1,18,0,18,元大-台南,2024-11-19,9896
3481,群創,34,18,16,元大-台南,2024-11-19,9896
2324,仁寶,19,4,15,元大-台南,2024-11-19,9896
2891,中信金,15,0,15,元大-台南,2024-11-19,9896
006208,富邦台50,16,2,14,元大-台南,2024-11-19,9896
00632R,元大台灣50反1,115,102,13,元大-台南,2024-11-19,9896
3710,連展投控,13,1,12,元大-台南,2024-11-19,9896
3025,星通,11,0,11,元大-台南,2024-11-19,9896
1611,中電,11,0,11,元大-台南,2024-11-19,9896
00679B,元大美債20年,13,2,11,元大-台南,2024-11-19,9896
00713,元大台灣高息低波,12,1,11,元大-台南,2024-11-19,9896
00795B,中信美國公債20年,10,0,10,元大-台南,2024-11-19,9896
2884,玉山金,10,0,10,元大-台南,2024-11-19,9896
2027,大成鋼,11,1,10,元大-台南,2024-11-19,9896
4716,大立,10,0,10,元大-台南,2024-11-19,9896
00887,永豐中國科技50大,10,0,10,元大-台南,2024-11-19,9896
5202,力新,11,1,10,元大-台南,2024-11-19,9896
00655L,國泰中國A50正2,20,10,10,元大-台南,2024-11-19,9896
2002,中鋼,10,0,10,元大-台南,2024-11-19,9896
2809,京城銀,10,1,9,元大-台南,2024-11-19,9896
3006,晶豪科,10,1,9,元大-台南,2024-11-19,9896
6005,群益證,10,1,9,元大-台南,2024-11-19,9896
9933,中鼎,15,6,9,元大-台南,2024-11-19,9896
8021,尖點,12,3,9,元大-台南,2024-11-19,9896
0056,元大高股息,21,12,9,元大-台南,2024-11-19,9896
00706L,期元大S＆P日圓正2,1280,0,1280,元大-台南,2024-11-20,9896
2354,鴻準,197,69,128,元大-台南,2024-11-20,9896
00959B,大華投等美債15Y+,101,0,101,元大-台南,2024-11-20,9896
00937B,群益ESG投等債20,102,2,100,元大-台南,2024-11-20,9896
2888,新光金,101,18,83,元大-台南,2024-11-20,9896
00878,國泰永續高股息,71,0,71,元大-台南,2024-11-20,9896
2025,千興,59,0,59,元大-台南,2024-11-20,9896
2312,金寶,69,19,50,元大-台南,2024-11-20,9896
00950B,凱基A級公司債,46,0,46,元大-台南,2024-11-20,9896
2344,華邦電,46,1,45,元大-台南,2024-11-20,9896
2409,友達,46,5,41,元大-台南,2024-11-20,9896
2356,英業達,49,9,40,元大-台南,2024-11-20,9896
3512,皇龍,37,0,37,元大-台南,2024-11-20,9896
00929,復華台灣科技優息,44,13,31,元大-台南,2024-11-20,9896
2328,廣宇,30,2,28,元大-台南,2024-11-20,9896
2834,臺企銀,26,0,26,元大-台南,2024-11-20,9896
5905,南仁湖,26,0,26,元大-台南,2024-11-20,9896
2603,長榮,55,31,24,元大-台南,2024-11-20,9896
2027,大成鋼,26,5,21,元大-台南,2024-11-20,9896
1446,宏和,19,1,18,元大-台南,2024-11-20,9896
2303,聯電,37,20,17,元大-台南,2024-11-20,9896
5009,榮剛,20,3,17,元大-台南,2024-11-20,9896
00930,永豐ESG低碳高息,16,0,16,元大-台南,2024-11-20,9896
00922,國泰台灣領袖50,16,0,16,元大-台南,2024-11-20,9896
4123,晟德,17,2,15,元大-台南,2024-11-20,9896
2331,精英,15,0,15,元大-台南,2024-11-20,9896
00795B,中信美國公債20年,14,0,14,元大-台南,2024-11-20,9896
00909,國泰數位支付服務,13,0,13,元大-台南,2024-11-20,9896
2646,星宇航空,14,1,13,元大-台南,2024-11-20,9896
00919,群益台灣精選高息,20,7,13,元大-台南,2024-11-20,9896
6005,群益證,12,0,12,元大-台南,2024-11-20,9896
6657,華安,12,0,12,元大-台南,2024-11-20,9896
3710,連展投控,12,0,12,元大-台南,2024-11-20,9896
9907,統一實,13,1,12,元大-台南,2024-11-20,9896
00915,凱基優選高股息30,12,1,11,元大-台南,2024-11-20,9896
00725B,國泰投資級公司債,22,11,11,元大-台南,2024-11-20,9896
6164,華興,11,1,10,元大-台南,2024-11-20,9896
00635U,期元大S＆P黃金,10,0,10,元大-台南,2024-11-20,9896
6191,精成科,10,0,10,元大-台南,2024-11-20,9896
6216,居易,10,0,10,元大-台南,2024-11-20,9896
3630,新鉅科,11,1,10,元大-台南,2024-11-20,9896
6168,宏齊,10,0,10,元大-台南,2024-11-20,9896
8050,廣積,10,0,10,元大-台南,2024-11-20,9896
1316,上曜,9,0,9,元大-台南,2024-11-20,9896
4303,信立,12,3,9,元大-台南,2024-11-20,9896
3059,華晶科,10,1,9,元大-台南,2024-11-20,9896
2330,台積電,12,3,9,元大-台南,2024-11-20,9896
1477,聚陽,9,0,9,元大-台南,2024-11-20,9896
3706,神達,223,214,9,元大-台南,2024-11-20,9896
3209,全科,8,0,8,元大-台南,2024-11-20,9896
00959B,大華投等美債15Y+,126,0,126,元大-台南,2024-11-21,9896
00878,國泰永續高股息,92,0,92,元大-台南,2024-11-21,9896
00953B,群益優選非投等債,75,0,75,元大-台南,2024-11-21,9896
2025,千興,61,0,61,元大-台南,2024-11-21,9896
2303,聯電,79,26,53,元大-台南,2024-11-21,9896
6657,華安,46,0,46,元大-台南,2024-11-21,9896
9904,寶成,68,22,46,元大-台南,2024-11-21,9896
2330,台積電,37,1,36,元大-台南,2024-11-21,9896
2881,富邦金,36,0,36,元大-台南,2024-11-21,9896
4931,新盛力,32,0,32,元大-台南,2024-11-21,9896
0056,元大高股息,37,7,30,元大-台南,2024-11-21,9896
2349,錸德,69,40,29,元大-台南,2024-11-21,9896
00937B,群益ESG投等債20,30,2,28,元大-台南,2024-11-21,9896
2344,華邦電,28,2,26,元大-台南,2024-11-21,9896
0050,元大台灣50,27,2,25,元大-台南,2024-11-21,9896
00706L,期元大S＆P日圓正2,25,0,25,元大-台南,2024-11-21,9896
6005,群益證,23,0,23,元大-台南,2024-11-21,9896
00635U,期元大S＆P黃金,23,0,23,元大-台南,2024-11-21,9896
2882,國泰金,20,0,20,元大-台南,2024-11-21,9896
3047,訊舟,22,2,20,元大-台南,2024-11-21,9896
2301,光寶科,20,0,20,元大-台南,2024-11-21,9896
1605,華新,22,3,19,元大-台南,2024-11-21,9896
00712,復華富時不動產,17,0,17,元大-台南,2024-11-21,9896
00922,國泰台灣領袖50,17,0,17,元大-台南,2024-11-21,9896
00915,凱基優選高股息30,17,2,15,元大-台南,2024-11-21,9896
006208,富邦台50,16,1,15,元大-台南,2024-11-21,9896
1301,台塑,25,10,15,元大-台南,2024-11-21,9896
2002,中鋼,13,0,13,元大-台南,2024-11-21,9896
2890,永豐金,14,1,13,元大-台南,2024-11-21,9896
3025,星通,13,0,13,元大-台南,2024-11-21,9896
1446,宏和,12,0,12,元大-台南,2024-11-21,9896
00637L,元大滬深300正2,12,0,12,元大-台南,2024-11-21,9896
00943,兆豐電子高息等權,12,0,12,元大-台南,2024-11-21,9896
2317,鴻海,24,13,11,元大-台南,2024-11-21,9896
2867,三商壽,11,0,11,元大-台南,2024-11-21,9896
5876,上海商銀,11,0,11,元大-台南,2024-11-21,9896
1326,台化,10,0,10,元大-台南,2024-11-21,9896
00753L,中信中國50正2,10,0,10,元大-台南,2024-11-21,9896
6233,旺玖,10,0,10,元大-台南,2024-11-21,9896
4510,高鋒,10,0,10,元大-台南,2024-11-21,9896
3231,緯創,27,18,9,元大-台南,2024-11-21,9896
00881,國泰台灣5G+,9,0,9,元大-台南,2024-11-21,9896
3481,群創,16,7,9,元大-台南,2024-11-21,9896
2027,大成鋼,9,0,9,元大-台南,2024-11-21,9896
00909,國泰數位支付服務,12,3,9,元大-台南,2024-11-21,9896
2618,長榮航,29,20,9,元大-台南,2024-11-21,9896
2354,鴻準,244,235,9,元大-台南,2024-11-21,9896
00687B,國泰20年美債,11,3,8,元大-台南,2024-11-21,9896
2891,中信金,13,5,8,元大-台南,2024-11-21,9896
2905,三商,8,0,8,元大-台南,2024-11-21,9896
00937B,群益ESG投等債20,814,501,313,元大-台南,2024-11-22,9896
00632R,元大台灣50反1,512,205,307,元大-台南,2024-11-22,9896
00713,元大台灣高息低波,110,2,108,元大-台南,2024-11-22,9896
5876,上海商銀,75,0,75,元大-台南,2024-11-22,9896
1446,宏和,93,24,69,元大-台南,2024-11-22,9896
2025,千興,67,0,67,元大-台南,2024-11-22,9896
2867,三商壽,65,6,59,元大-台南,2024-11-22,9896
00953B,群益優選非投等債,40,0,40,元大-台南,2024-11-22,9896
2317,鴻海,50,13,37,元大-台南,2024-11-22,9896
00941,中信上游半導體,30,0,30,元大-台南,2024-11-22,9896
5347,世界,52,24,28,元大-台南,2024-11-22,9896
00915,凱基優選高股息30,25,0,25,元大-台南,2024-11-22,9896
00882,中信中國高股息,44,19,25,元大-台南,2024-11-22,9896
8044,網家,35,11,24,元大-台南,2024-11-22,9896
6134,萬旭,25,1,24,元大-台南,2024-11-22,9896
00959B,大華投等美債15Y+,23,0,23,元大-台南,2024-11-22,9896
2354,鴻準,100,77,23,元大-台南,2024-11-22,9896
00637L,元大滬深300正2,22,0,22,元大-台南,2024-11-22,9896
1587,吉茂,22,0,22,元大-台南,2024-11-22,9896
2615,萬海,58,37,21,元大-台南,2024-11-22,9896
2014,中鴻,20,0,20,元大-台南,2024-11-22,9896
00885,富邦越南,20,0,20,元大-台南,2024-11-22,9896
00673R,期元大S＆P原油反1,20,0,20,元大-台南,2024-11-22,9896
3706,神達,153,134,19,元大-台南,2024-11-22,9896
00919,群益台灣精選高息,30,13,17,元大-台南,2024-11-22,9896
00933B,國泰10Y+金融債,17,0,17,元大-台南,2024-11-22,9896
2353,宏��,17,1,16,元大-台南,2024-11-22,9896
00950B,凱基A級公司債,15,0,15,元大-台南,2024-11-22,9896
9904,寶成,20,5,15,元大-台南,2024-11-22,9896
2609,陽明,98,84,14,元大-台南,2024-11-22,9896
00795B,中信美國公債20年,13,0,13,元大-台南,2024-11-22,9896
00665L,富邦�琤肭磪囓�2,22,9,13,元大-台南,2024-11-22,9896
3535,晶彩科,21,8,13,元大-台南,2024-11-22,9896
00655L,國泰中國A50正2,12,0,12,元大-台南,2024-11-22,9896
00635U,期元大S＆P黃金,11,0,11,元大-台南,2024-11-22,9896
8163,達方,13,2,11,元大-台南,2024-11-22,9896
6770,力積電,12,1,11,元大-台南,2024-11-22,9896
1436,華友聯,10,0,10,元大-台南,2024-11-22,9896
5011,久陽,10,0,10,元大-台南,2024-11-22,9896
2374,佳能,12,2,10,元大-台南,2024-11-22,9896
2745,五福,10,0,10,元大-台南,2024-11-22,9896
00708L,期元大S＆P黃金正2,10,0,10,元大-台南,2024-11-22,9896
6168,宏齊,10,0,10,元大-台南,2024-11-22,9896
6667,信紘科,11,1,10,元大-台南,2024-11-22,9896
6901,鑽石投資,9,0,9,元大-台南,2024-11-22,9896
2646,星宇航空,9,0,9,元大-台南,2024-11-22,9896
2882,國泰金,9,0,9,元大-台南,2024-11-22,9896
3062,建漢,10,1,9,元大-台南,2024-11-22,9896
4513,福裕,16,7,9,元大-台南,2024-11-22,9896
6535,順藥,8,0,8,元大-台南,2024-11-22,9896
00632R,元大台灣50反1,371,39,332,元大-台南,2024-11-25,9896
6657,華安,133,0,133,元大-台南,2024-11-25,9896
00945B,凱基美國非投等債,116,0,116,元大-台南,2024-11-25,9896
00919,群益台灣精選高息,98,0,98,元大-台南,2024-11-25,9896
9105,泰金寶-DR,123,32,91,元大-台南,2024-11-25,9896
2312,金寶,280,195,85,元大-台南,2024-11-25,9896
2025,千興,64,0,64,元大-台南,2024-11-25,9896
2834,臺企銀,51,0,51,元大-台南,2024-11-25,9896
00950B,凱基A級公司債,51,0,51,元大-台南,2024-11-25,9896
2888,新光金,86,42,44,元大-台南,2024-11-25,9896
00673R,期元大S＆P原油反1,42,0,42,元大-台南,2024-11-25,9896
00953B,群益優選非投等債,33,0,33,元大-台南,2024-11-25,9896
00665L,富邦�琤肭磪囓�2,42,12,30,元大-台南,2024-11-25,9896
3512,皇龍,27,0,27,元大-台南,2024-11-25,9896
3090,日電貿,26,1,25,元大-台南,2024-11-25,9896
2618,長榮航,31,6,25,元大-台南,2024-11-25,9896
00830,國泰費城半導體,21,0,21,元大-台南,2024-11-25,9896
3714,富采,19,1,18,元大-台南,2024-11-25,9896
2330,台積電,19,4,15,元大-台南,2024-11-25,9896
2603,長榮,48,34,14,元大-台南,2024-11-25,9896
3481,群創,19,5,14,元大-台南,2024-11-25,9896
1815,富喬,71,59,12,元大-台南,2024-11-25,9896
6288,聯嘉,13,1,12,元大-台南,2024-11-25,9896
2887,台新金,13,2,11,元大-台南,2024-11-25,9896
3049,精金,12,1,11,元大-台南,2024-11-25,9896
2449,京元電子,26,15,11,元大-台南,2024-11-25,9896
00878,國泰永續高股息,31,21,10,元大-台南,2024-11-25,9896
2474,可成,56,45,11,元大-台南,2024-11-25,9896
5483,中美晶,10,0,10,元大-台南,2024-11-25,9896
2867,三商壽,14,4,10,元大-台南,2024-11-25,9896
2891,中信金,15,5,10,元大-台南,2024-11-25,9896
00706L,期元大S＆P日圓正2,10,0,10,元大-台南,2024-11-25,9896
2356,英業達,53,43,10,元大-台南,2024-11-25,9896
1799,易威,9,0,9,元大-台南,2024-11-25,9896
2301,光寶科,32,23,9,元大-台南,2024-11-25,9896
3535,晶彩科,8,0,8,元大-台南,2024-11-25,9896
2497,怡利電,8,0,8,元大-台南,2024-11-25,9896
3450,聯鈞,22,14,8,元大-台南,2024-11-25,9896
3706,神達,128,120,8,元大-台南,2024-11-25,9896
5876,上海商銀,8,0,8,元大-台南,2024-11-25,9896
1101,台泥,13,6,7,元大-台南,2024-11-25,9896
6005,群益證,7,0,7,元大-台南,2024-11-25,9896
4161,聿新科,22,15,7,元大-台南,2024-11-25,9896
6187,萬潤,9,3,6,元大-台南,2024-11-25,9896
00894,中信小資高價30,6,0,6,元大-台南,2024-11-25,9896
3013,晟銘電,9,3,6,元大-台南,2024-11-25,9896
00885,富邦越南,6,0,6,元大-台南,2024-11-25,9896
2344,華邦電,6,0,6,元大-台南,2024-11-25,9896
2105,正新,11,5,6,元大-台南,2024-11-25,9896
2023,燁輝,6,0,6,元大-台南,2024-11-25,9896
00950B,凱基A級公司債,658,0,658,元大-台南,2024-11-26,9896
2834,臺企銀,108,0,108,元大-台南,2024-11-26,9896
2605,新興,100,0,100,元大-台南,2024-11-26,9896
2317,鴻海,99,18,81,元大-台南,2024-11-26,9896
6134,萬旭,72,1,71,元大-台南,2024-11-26,9896
00878,國泰永續高股息,67,7,60,元大-台南,2024-11-26,9896
2025,千興,48,0,48,元大-台南,2024-11-26,9896
2887,台新金,46,0,46,元大-台南,2024-11-26,9896
3231,緯創,58,20,38,元大-台南,2024-11-26,9896
2344,華邦電,34,0,34,元大-台南,2024-11-26,9896
00960,野村全球航運龍頭,32,0,32,元大-台南,2024-11-26,9896
1301,台塑,35,3,32,元大-台南,2024-11-26,9896
006208,富邦台50,30,1,29,元大-台南,2024-11-26,9896
5905,南仁湖,27,0,27,元大-台南,2024-11-26,9896
1528,恩德,23,0,23,元大-台南,2024-11-26,9896
0050,元大台灣50,23,1,22,元大-台南,2024-11-26,9896
2615,萬海,56,34,22,元大-台南,2024-11-26,9896
9904,寶成,26,5,21,元大-台南,2024-11-26,9896
5880,合庫金,20,0,20,元大-台南,2024-11-26,9896
3006,晶豪科,20,0,20,元大-台南,2024-11-26,9896
00669R,國泰美國道瓊反1,20,0,20,元大-台南,2024-11-26,9896
00919,群益台灣精選高息,21,2,19,元大-台南,2024-11-26,9896
1464,得力,19,0,19,元大-台南,2024-11-26,9896
2330,台積電,19,2,17,元大-台南,2024-11-26,9896
2312,金寶,212,197,15,元大-台南,2024-11-26,9896
00922,國泰台灣領袖50,15,0,15,元大-台南,2024-11-26,9896
3706,神達,91,77,14,元大-台南,2024-11-26,9896
00715L,期街口布蘭特正2,13,0,13,元大-台南,2024-11-26,9896
4931,新盛力,16,4,12,元大-台南,2024-11-26,9896
00918,大華優利高填息30,12,0,12,元大-台南,2024-11-26,9896
8064,東捷,14,3,11,元大-台南,2024-11-26,9896
00946,群益科技高息成長,11,0,11,元大-台南,2024-11-26,9896
6213,聯茂,12,1,11,元大-台南,2024-11-26,9896
00637L,元大滬深300正2,26,15,11,元大-台南,2024-11-26,9896
2417,圓剛,18,7,11,元大-台南,2024-11-26,9896
2367,燿華,14,4,10,元大-台南,2024-11-26,9896
00915,凱基優選高股息30,20,10,10,元大-台南,2024-11-26,9896
5347,世界,10,0,10,元大-台南,2024-11-26,9896
00959B,大華投等美債15Y+,10,0,10,元大-台南,2024-11-26,9896
1517,利奇,10,0,10,元大-台南,2024-11-26,9896
00706L,期元大S＆P日圓正2,10,0,10,元大-台南,2024-11-26,9896
00887,永豐中國科技50大,10,0,10,元大-台南,2024-11-26,9896
00664R,國泰臺灣加權反1,10,0,10,元大-台南,2024-11-26,9896
3047,訊舟,10,0,10,元大-台南,2024-11-26,9896
1781,合世,10,0,10,元大-台南,2024-11-26,9896
6168,宏齊,10,0,10,元大-台南,2024-11-26,9896
6215,和椿,10,0,10,元大-台南,2024-11-26,9896
00942B,台新美A公司債20+,10,0,10,元大-台南,2024-11-26,9896
1815,富喬,80,70,10,元大-台南,2024-11-26,9896
00675L,富邦臺灣加權正2,8,0,8,元大-台南,2024-11-26,9896
00919,群益台灣精選高息,279,21,258,元大-台南,2024-11-27,9896
00878,國泰永續高股息,191,5,186,元大-台南,2024-11-27,9896
2605,新興,181,1,180,元大-台南,2024-11-27,9896
0056,元大高股息,150,10,140,元大-台南,2024-11-27,9896
00940,元大台灣價值高息,133,16,117,元大-台南,2024-11-27,9896
1440,南紡,107,0,107,元大-台南,2024-11-27,9896
2303,聯電,90,8,82,元大-台南,2024-11-27,9896
00918,大華優利高填息30,72,0,72,元大-台南,2024-11-27,9896
2834,臺企銀,69,3,66,元大-台南,2024-11-27,9896
1605,華新,67,4,63,元大-台南,2024-11-27,9896
2025,千興,60,0,60,元大-台南,2024-11-27,9896
00929,復華台灣科技優息,58,5,53,元大-台南,2024-11-27,9896
2409,友達,49,1,48,元大-台南,2024-11-27,9896
2317,鴻海,95,50,45,元大-台南,2024-11-27,9896
00915,凱基優選高股息30,40,2,38,元大-台南,2024-11-27,9896
2330,台積電,42,8,34,元大-台南,2024-11-27,9896
3231,緯創,69,34,35,元大-台南,2024-11-27,9896
6770,力積電,42,15,27,元大-台南,2024-11-27,9896
00946,群益科技高息成長,29,4,25,元大-台南,2024-11-27,9896
2881,富邦金,27,2,25,元大-台南,2024-11-27,9896
00922,國泰台灣領袖50,24,1,23,元大-台南,2024-11-27,9896
2356,英業達,73,50,23,元大-台南,2024-11-27,9896
0050,元大台灣50,23,1,22,元大-台南,2024-11-27,9896
1524,耿鼎,22,1,21,元大-台南,2024-11-27,9896
2382,廣達,24,3,21,元大-台南,2024-11-27,9896
2002,中鋼,36,15,21,元大-台南,2024-11-27,9896
006208,富邦台50,23,3,20,元大-台南,2024-11-27,9896
00927,群益半導體收益,22,2,20,元大-台南,2024-11-27,9896
6168,宏齊,20,0,20,元大-台南,2024-11-27,9896
3540,曜越,20,0,20,元大-台南,2024-11-27,9896
6216,居易,20,0,20,元大-台南,2024-11-27,9896
1536,和大,97,78,19,元大-台南,2024-11-27,9896
2426,鼎元,33,14,19,元大-台南,2024-11-27,9896
2603,長榮,51,33,18,元大-台南,2024-11-27,9896
2539,櫻花建,17,0,17,元大-台南,2024-11-27,9896
3481,群創,30,15,15,元大-台南,2024-11-27,9896
00891,中信關鍵半導體,14,0,14,元大-台南,2024-11-27,9896
3622,洋華,14,0,14,元大-台南,2024-11-27,9896
00905,FT臺灣Smart,19,6,13,元大-台南,2024-11-27,9896
2641,正德,13,0,13,元大-台南,2024-11-27,9896
2374,佳能,15,2,13,元大-台南,2024-11-27,9896
2419,仲琦,17,4,13,元大-台南,2024-11-27,9896
6657,華安,13,0,13,元大-台南,2024-11-27,9896
2324,仁寶,20,7,13,元大-台南,2024-11-27,9896
3037,欣興,13,1,12,元大-台南,2024-11-27,9896
6235,華孚,14,2,12,元大-台南,2024-11-27,9896
00930,永豐ESG低碳高息,12,0,12,元大-台南,2024-11-27,9896
5905,南仁湖,12,0,12,元大-台南,2024-11-27,9896
2408,南亞科,11,0,11,元大-台南,2024-11-27,9896
3047,訊舟,11,0,11,元大-台南,2024-11-27,9896
00665L,富邦�琤肭磪囓�2,182,11,171,元大-台南,2024-11-28,9896
00878,國泰永續高股息,168,17,151,元大-台南,2024-11-28,9896
00919,群益台灣精選高息,149,7,142,元大-台南,2024-11-28,9896
00632R,元大台灣50反1,177,42,135,元大-台南,2024-11-28,9896
2312,金寶,240,105,135,元大-台南,2024-11-28,9896
0056,元大高股息,134,11,123,元大-台南,2024-11-28,9896
2025,千興,76,0,76,元大-台南,2024-11-28,9896
00940,元大台灣價值高息,135,71,64,元大-台南,2024-11-28,9896
00637L,元大滬深300正2,61,0,61,元大-台南,2024-11-28,9896
9105,泰金寶-DR,92,33,59,元大-台南,2024-11-28,9896
00680L,元大美債20正2,74,16,58,元大-台南,2024-11-28,9896
00706L,期元大S＆P日圓正2,63,5,58,元大-台南,2024-11-28,9896
2834,臺企銀,57,0,57,元大-台南,2024-11-28,9896
4991,環宇-KY,55,5,50,元大-台南,2024-11-28,9896
4927,泰鼎-KY,49,7,42,元大-台南,2024-11-28,9896
2332,友訊,67,29,38,元大-台南,2024-11-28,9896
1605,華新,42,5,37,元大-台南,2024-11-28,9896
3481,群創,40,5,35,元大-台南,2024-11-28,9896
2352,佳世達,26,0,26,元大-台南,2024-11-28,9896
2408,南亞科,30,5,25,元大-台南,2024-11-28,9896
2409,友達,22,0,22,元大-台南,2024-11-28,9896
2303,聯電,67,46,21,元大-台南,2024-11-28,9896
4510,高鋒,118,97,21,元大-台南,2024-11-28,9896
00960,野村全球航運龍頭,20,0,20,元大-台南,2024-11-28,9896
2338,光罩,20,0,20,元大-台南,2024-11-28,9896
00922,國泰台灣領袖50,20,1,19,元大-台南,2024-11-28,9896
00943,兆豐電子高息等權,19,0,19,元大-台南,2024-11-28,9896
6657,華安,19,0,19,元大-台南,2024-11-28,9896
2317,鴻海,56,37,19,元大-台南,2024-11-28,9896
00929,復華台灣科技優息,35,16,19,元大-台南,2024-11-28,9896
3380,明泰,18,0,18,元大-台南,2024-11-28,9896
3706,神達,110,92,18,元大-台南,2024-11-28,9896
00918,大華優利高填息30,16,0,16,元大-台南,2024-11-28,9896
006208,富邦台50,19,3,16,元大-台南,2024-11-28,9896
2349,錸德,26,10,16,元大-台南,2024-11-28,9896
1531,高林股,17,1,16,元大-台南,2024-11-28,9896
1718,中纖,15,0,15,元大-台南,2024-11-28,9896
00713,元大台灣高息低波,17,3,14,元大-台南,2024-11-28,9896
2646,星宇航空,23,9,14,元大-台南,2024-11-28,9896
00715L,期街口布蘭特正2,15,1,14,元大-台南,2024-11-28,9896
00946,群益科技高息成長,21,8,13,元大-台南,2024-11-28,9896
1802,台玻,23,10,13,元大-台南,2024-11-28,9896
2419,仲琦,19,6,13,元大-台南,2024-11-28,9896
00934,中信成長高股息,13,0,13,元大-台南,2024-11-28,9896
00930,永豐ESG低碳高息,12,0,12,元大-台南,2024-11-28,9896
3450,聯鈞,39,27,12,元大-台南,2024-11-28,9896
3022,威強電,12,0,12,元大-台南,2024-11-28,9896
9907,統一實,12,0,12,元大-台南,2024-11-28,9896
1815,富喬,59,47,12,元大-台南,2024-11-28,9896
00891,中信關鍵半導體,12,1,11,元大-台南,2024-11-28,9896
00945B,凱基美國非投等債,603,0,603,元大-台南,2024-11-29,9896
2834,臺企銀,261,5,256,元大-台南,2024-11-29,9896
00632R,元大台灣50反1,156,5,151,元大-台南,2024-11-29,9896
00637L,元大滬深300正2,121,7,114,元大-台南,2024-11-29,9896
00927,群益半導體收益,104,0,104,元大-台南,2024-11-29,9896
00878,國泰永續高股息,110,7,103,元大-台南,2024-11-29,9896
00950B,凱基A級公司債,91,0,91,元大-台南,2024-11-29,9896
2025,千興,70,0,70,元大-台南,2024-11-29,9896
00919,群益台灣精選高息,64,18,46,元大-台南,2024-11-29,9896
3231,緯創,55,12,43,元大-台南,2024-11-29,9896
00665L,富邦�琤肭磪囓�2,58,17,41,元大-台南,2024-11-29,9896
00929,復華台灣科技優息,36,2,34,元大-台南,2024-11-29,9896
0056,元大高股息,44,12,32,元大-台南,2024-11-29,9896
6657,華安,31,0,31,元大-台南,2024-11-29,9896
2317,鴻海,44,16,28,元大-台南,2024-11-29,9896
00687B,國泰20年美債,34,6,28,元大-台南,2024-11-29,9896
00915,凱基優選高股息30,27,0,27,元大-台南,2024-11-29,9896
2303,聯電,69,43,26,元大-台南,2024-11-29,9896
3625,西勝,24,0,24,元大-台南,2024-11-29,9896
2002,中鋼,25,2,23,元大-台南,2024-11-29,9896
1301,台塑,22,0,22,元大-台南,2024-11-29,9896
00959B,大華投等美債15Y+,20,0,20,元大-台南,2024-11-29,9896
00706L,期元大S＆P日圓正2,23,6,17,元大-台南,2024-11-29,9896
9105,泰金寶-DR,40,24,16,元大-台南,2024-11-29,9896
2609,陽明,42,27,15,元大-台南,2024-11-29,9896
4526,東台,17,2,15,元大-台南,2024-11-29,9896
2615,萬海,36,22,14,元大-台南,2024-11-29,9896
2344,華邦電,16,3,13,元大-台南,2024-11-29,9896
1605,華新,14,1,13,元大-台南,2024-11-29,9896
3706,神達,232,220,12,元大-台南,2024-11-29,9896
3712,永崴投控,13,1,12,元大-台南,2024-11-29,9896
6530,創威,15,3,12,元大-台南,2024-11-29,9896
00918,大華優利高填息30,12,0,12,元大-台南,2024-11-29,9896
2882,國泰金,12,0,12,元大-台南,2024-11-29,9896
2330,台積電,15,4,11,元大-台南,2024-11-29,9896
5353,台林,12,1,11,元大-台南,2024-11-29,9896
1611,中電,12,1,11,元大-台南,2024-11-29,9896
6197,佳必琪,19,8,11,元大-台南,2024-11-29,9896
2613,中櫃,10,0,10,元大-台南,2024-11-29,9896
9904,寶成,11,1,10,元大-台南,2024-11-29,9896
1718,中纖,10,0,10,元大-台南,2024-11-29,9896
5355,佳總,12,2,10,元大-台南,2024-11-29,9896
3508,位速,10,0,10,元大-台南,2024-11-29,9896
6156,松上,10,0,10,元大-台南,2024-11-29,9896
2892,第一金,9,0,9,元大-台南,2024-11-29,9896
3033,威健,11,2,9,元大-台南,2024-11-29,9896
2312,金寶,154,146,8,元大-台南,2024-11-29,9896
6505,台塑化,13,5,8,元大-台南,2024-11-29,9896
4967,十銓,8,0,8,元大-台南,2024-11-29,9896
2501,國建,25,17,8,元大-台南,2024-11-29,9896
00632R,元大台灣50反1,2339,377,1962,元大-台南,2024-12-02,9896
00945B,凱基美國非投等債,100,0,100,元大-台南,2024-12-02,9896
2610,華航,142,68,74,元大-台南,2024-12-02,9896
2025,千興,65,0,65,元大-台南,2024-12-02,9896
6657,華安,62,1,61,元大-台南,2024-12-02,9896
1605,華新,50,1,49,元大-台南,2024-12-02,9896
2356,英業達,82,54,28,元大-台南,2024-12-02,9896
2317,鴻海,39,11,28,元大-台南,2024-12-02,9896
2464,盟立,28,2,26,元大-台南,2024-12-02,9896
6414,樺漢,26,1,25,元大-台南,2024-12-02,9896
6547,高端疫苗,22,0,22,元大-台南,2024-12-02,9896
3706,神達,100,79,21,元大-台南,2024-12-02,9896
00909,國泰數位支付服務,20,1,19,元大-台南,2024-12-02,9896
00719B,元大美債1-3,18,0,18,元大-台南,2024-12-02,9896
2886,兆豐金,18,0,18,元大-台南,2024-12-02,9896
6168,宏齊,17,0,17,元大-台南,2024-12-02,9896
2337,旺宏,26,10,16,元大-台南,2024-12-02,9896
6196,帆宣,16,0,16,元大-台南,2024-12-02,9896
00918,大華優利高填息30,16,0,16,元大-台南,2024-12-02,9896
6257,矽格,15,0,15,元大-台南,2024-12-02,9896
6962,ITH-KY,15,0,15,元大-台南,2024-12-02,9896
3013,晟銘電,22,7,15,元大-台南,2024-12-02,9896
2354,鴻準,216,202,14,元大-台南,2024-12-02,9896
2495,普安,14,1,13,元大-台南,2024-12-02,9896
00965,元大航太防衛科技,34,21,13,元大-台南,2024-12-02,9896
3211,順達,27,15,12,元大-台南,2024-12-02,9896
2392,正崴,18,6,12,元大-台南,2024-12-02,9896
5905,南仁湖,12,0,12,元大-台南,2024-12-02,9896
5353,台林,12,1,11,元大-台南,2024-12-02,9896
9933,中鼎,11,0,11,元大-台南,2024-12-02,9896
3231,緯創,34,24,10,元大-台南,2024-12-02,9896
3025,星通,21,10,11,元大-台南,2024-12-02,9896
5864,致和證,14,4,10,元大-台南,2024-12-02,9896
4123,晟德,11,1,10,元大-台南,2024-12-02,9896
1815,富喬,25,15,10,元大-台南,2024-12-02,9896
1528,恩德,11,1,10,元大-台南,2024-12-02,9896
6182,合晶,10,0,10,元大-台南,2024-12-02,9896
2408,南亞科,10,1,9,元大-台南,2024-12-02,9896
4968,立積,19,10,9,元大-台南,2024-12-02,9896
6770,力積電,9,0,9,元大-台南,2024-12-02,9896
00924,復華S＆P500成長,8,0,8,元大-台南,2024-12-02,9896
8931,大汽電,8,0,8,元大-台南,2024-12-02,9896
3508,位速,8,0,8,元大-台南,2024-12-02,9896
00753L,中信中國50正2,25,17,8,元大-台南,2024-12-02,9896
00959B,大華投等美債15Y+,7,0,7,元大-台南,2024-12-02,9896
3710,連展投控,7,0,7,元大-台南,2024-12-02,9896
2302,麗正,16,9,7,元大-台南,2024-12-02,9896
2382,廣達,7,0,7,元大-台南,2024-12-02,9896
2014,中鴻,6,0,6,元大-台南,2024-12-02,9896
2615,萬海,30,24,6,元大-台南,2024-12-02,9896
00919,群益台灣精選高息,324,6,318,元大-台南,2024-12-03,9896
2845,遠東銀,150,0,150,元大-台南,2024-12-03,9896
00878,國泰永續高股息,118,21,97,元大-台南,2024-12-03,9896
2834,臺企銀,154,57,97,元大-台南,2024-12-03,9896
00715L,期街口布蘭特正2,73,0,73,元大-台南,2024-12-03,9896
2025,千興,69,0,69,元大-台南,2024-12-03,9896
2888,新光金,87,23,64,元大-台南,2024-12-03,9896
00918,大華優利高填息30,69,10,59,元大-台南,2024-12-03,9896
3062,建漢,61,8,53,元大-台南,2024-12-03,9896
0050,元大台灣50,41,4,37,元大-台南,2024-12-03,9896
6962,ITH-KY,37,1,36,元大-台南,2024-12-03,9896
5353,台林,38,2,36,元大-台南,2024-12-03,9896
5905,南仁湖,38,3,35,元大-台南,2024-12-03,9896
0056,元大高股息,40,6,34,元大-台南,2024-12-03,9896
2516,新建,30,0,30,元大-台南,2024-12-03,9896
5371,中光電,34,6,28,元大-台南,2024-12-03,9896
2317,鴻海,46,18,28,元大-台南,2024-12-03,9896
4303,信立,26,0,26,元大-台南,2024-12-03,9896
1301,台塑,43,17,26,元大-台南,2024-12-03,9896
6657,華安,26,0,26,元大-台南,2024-12-03,9896
00713,元大台灣高息低波,23,0,23,元大-台南,2024-12-03,9896
00959B,大華投等美債15Y+,24,1,23,元大-台南,2024-12-03,9896
8429,金麗-KY,35,12,23,元大-台南,2024-12-03,9896
6285,啟��,31,11,20,元大-台南,2024-12-03,9896
00664R,國泰臺灣加權反1,20,0,20,元大-台南,2024-12-03,9896
2313,華通,20,1,19,元大-台南,2024-12-03,9896
00915,凱基優選高股息30,23,4,19,元大-台南,2024-12-03,9896
2929,淘帝-KY,18,0,18,元大-台南,2024-12-03,9896
00909,國泰數位支付服務,17,0,17,元大-台南,2024-12-03,9896
00642U,期元大S＆P石油,16,0,16,元大-台南,2024-12-03,9896
1605,華新,17,2,15,元大-台南,2024-12-03,9896
3338,泰碩,18,5,13,元大-台南,2024-12-03,9896
00712,復華富時不動產,20,7,13,元大-台南,2024-12-03,9896
1802,台玻,12,0,12,元大-台南,2024-12-03,9896
3703,欣陸,12,0,12,元大-台南,2024-12-03,9896
3231,緯創,21,10,11,元大-台南,2024-12-03,9896
00950B,凱基A級公司債,10,0,10,元大-台南,2024-12-03,9896
4716,大立,10,0,10,元大-台南,2024-12-03,9896
6952,大武山,10,0,10,元大-台南,2024-12-03,9896
2809,京城銀,10,0,10,元大-台南,2024-12-03,9896
4909,新復興,20,10,10,元大-台南,2024-12-03,9896
3049,精金,13,4,9,元大-台南,2024-12-03,9896
1504,東元,13,4,9,元大-台南,2024-12-03,9896
2312,金寶,45,36,9,元大-台南,2024-12-03,9896
2324,仁寶,19,11,8,元大-台南,2024-12-03,9896
2363,矽統,12,4,8,元大-台南,2024-12-03,9896
2301,光寶科,13,6,7,元大-台南,2024-12-03,9896
3031,佰鴻,10,3,7,元大-台南,2024-12-03,9896
5515,建國,7,0,7,元大-台南,2024-12-03,9896
8033,雷虎,7,0,7,元大-台南,2024-12-03,9896
00950B,凱基A級公司債,555,0,555,元大-台南,2024-12-04,9896
3036,文曄,416,1,415,元大-台南,2024-12-04,9896
2025,千興,65,0,65,元大-台南,2024-12-04,9896
00937B,群益ESG投等債20,44,1,43,元大-台南,2024-12-04,9896
00918,大華優利高填息30,36,0,36,元大-台南,2024-12-04,9896
00953B,群益優選非投等債,30,0,30,元大-台南,2024-12-04,9896
1802,台玻,38,12,26,元大-台南,2024-12-04,9896
00673R,期元大S＆P原油反1,25,0,25,元大-台南,2024-12-04,9896
00900,富邦特選高股息30,30,5,25,元大-台南,2024-12-04,9896
00948B,中信優息投資級債,23,0,23,元大-台南,2024-12-04,9896
2303,聯電,55,35,20,元大-台南,2024-12-04,9896
00712,復華富時不動產,105,85,20,元大-台南,2024-12-04,9896
1595,川寶,25,6,19,元大-台南,2024-12-04,9896
1301,台塑,19,1,18,元大-台南,2024-12-04,9896
00915,凱基優選高股息30,18,0,18,元大-台南,2024-12-04,9896
3323,加百裕,83,66,17,元大-台南,2024-12-04,9896
6271,同欣電,17,1,16,元大-台南,2024-12-04,9896
2027,大成鋼,14,0,14,元大-台南,2024-12-04,9896
5371,中光電,16,2,14,元大-台南,2024-12-04,9896
4906,正文,14,0,14,元大-台南,2024-12-04,9896
00795B,中信美國公債20年,13,0,13,元大-台南,2024-12-04,9896
9105,泰金寶-DR,63,50,13,元大-台南,2024-12-04,9896
2002,中鋼,13,1,12,元大-台南,2024-12-04,9896
1326,台化,12,0,12,元大-台南,2024-12-04,9896
3706,神達,245,234,11,元大-台南,2024-12-04,9896
8931,大汽電,11,0,11,元大-台南,2024-12-04,9896
5309,系統電,36,25,11,元大-台南,2024-12-04,9896
2884,玉山金,10,0,10,元大-台南,2024-12-04,9896
3518,柏騰,10,0,10,元大-台南,2024-12-04,9896
3508,位速,10,0,10,元大-台南,2024-12-04,9896
2880,華南金,10,0,10,元大-台南,2024-12-04,9896
2646,星宇航空,14,4,10,元大-台南,2024-12-04,9896
3481,群創,26,17,9,元大-台南,2024-12-04,9896
5880,合庫金,10,1,9,元大-台南,2024-12-04,9896
1587,吉茂,9,0,9,元大-台南,2024-12-04,9896
6216,居易,9,0,9,元大-台南,2024-12-04,9896
00958B,永豐ESG銀行債15,9,0,9,元大-台南,2024-12-04,9896
00959B,大華投等美債15Y+,11,2,9,元大-台南,2024-12-04,9896
3029,零壹,9,1,8,元大-台南,2024-12-04,9896
3548,兆利,14,6,8,元大-台南,2024-12-04,9896
4716,大立,8,0,8,元大-台南,2024-12-04,9896
6952,大武山,8,0,8,元大-台南,2024-12-04,9896
6285,啟��,10,2,8,元大-台南,2024-12-04,9896
6530,創威,23,15,8,元大-台南,2024-12-04,9896
2605,新興,18,10,8,元大-台南,2024-12-04,9896
0056,元大高股息,14,6,8,元大-台南,2024-12-04,9896
2382,廣達,9,2,7,元大-台南,2024-12-04,9896
6919,康霈*,8,1,7,元大-台南,2024-12-04,9896
2349,錸德,14,7,7,元大-台南,2024-12-04,9896
8171,天宇,8,1,7,元大-台南,2024-12-04,9896
00713,元大台灣高息低波,408,2,406,元大-台南,2024-12-05,9896
00918,大華優利高填息30,252,1,251,元大-台南,2024-12-05,9896
00919,群益台灣精選高息,270,29,241,元大-台南,2024-12-05,9896
2618,長榮航,219,37,182,元大-台南,2024-12-05,9896
0056,元大高股息,137,25,112,元大-台南,2024-12-05,9896
2888,新光金,106,4,102,元大-台南,2024-12-05,9896
3090,日電貿,97,31,66,元大-台南,2024-12-05,9896
2025,千興,65,0,65,元大-台南,2024-12-05,9896
1815,富喬,119,57,62,元大-台南,2024-12-05,9896
00715L,期街口布蘭特正2,41,6,35,元大-台南,2024-12-05,9896
6657,華安,30,0,30,元大-台南,2024-12-05,9896
2204,中華,43,14,29,元大-台南,2024-12-05,9896
00909,國泰數位支付服務,35,7,28,元大-台南,2024-12-05,9896
2338,光罩,25,0,25,元大-台南,2024-12-05,9896
8107,大億金茂,23,0,23,元大-台南,2024-12-05,9896
4931,新盛力,45,24,21,元大-台南,2024-12-05,9896
8171,天宇,21,0,21,元大-台南,2024-12-05,9896
00915,凱基優選高股息30,20,0,20,元大-台南,2024-12-05,9896
3508,位速,20,0,20,元大-台南,2024-12-05,9896
6558,興能高,54,34,20,元大-台南,2024-12-05,9896
2317,鴻海,29,9,20,元大-台南,2024-12-05,9896
2303,聯電,81,62,19,元大-台南,2024-12-05,9896
00637L,元大滬深300正2,20,1,19,元大-台南,2024-12-05,9896
00712,復華富時不動產,18,0,18,元大-台南,2024-12-05,9896
3323,加百裕,94,76,18,元大-台南,2024-12-05,9896
8042,金山電,25,8,17,元大-台南,2024-12-05,9896
2646,星宇航空,20,3,17,元大-台南,2024-12-05,9896
1709,和益,16,0,16,元大-台南,2024-12-05,9896
5309,系統電,18,3,15,元大-台南,2024-12-05,9896
2301,光寶科,15,1,14,元大-台南,2024-12-05,9896
2392,正崴,67,53,14,元大-台南,2024-12-05,9896
2489,瑞軒,13,0,13,元大-台南,2024-12-05,9896
3450,聯鈞,27,15,12,元大-台南,2024-12-05,9896
3003,健和興,14,2,12,元大-台南,2024-12-05,9896
1587,吉茂,12,1,11,元大-台南,2024-12-05,9896
2344,華邦電,14,3,11,元大-台南,2024-12-05,9896
00725B,國泰投資級公司債,11,0,11,元大-台南,2024-12-05,9896
4906,正文,10,0,10,元大-台南,2024-12-05,9896
2027,大成鋼,10,0,10,元大-台南,2024-12-05,9896
3041,揚智,16,6,10,元大-台南,2024-12-05,9896
1584,精剛,10,1,9,元大-台南,2024-12-05,9896
6757,台灣虎航,9,0,9,元大-台南,2024-12-05,9896
2332,友訊,11,2,9,元大-台南,2024-12-05,9896
3049,精金,10,1,9,元大-台南,2024-12-05,9896
6216,居易,11,2,9,元大-台南,2024-12-05,9896
00953B,群益優選非投等債,9,0,9,元大-台南,2024-12-05,9896
1802,台玻,10,1,9,元大-台南,2024-12-05,9896
6111,大宇資,9,0,9,元大-台南,2024-12-05,9896
3537,堡達,9,1,8,元大-台南,2024-12-05,9896
3078,僑威,9,1,8,元大-台南,2024-12-05,9896
00918,大華優利高填息30,493,2,491,元大-台南,2024-12-06,9896
00715L,期街口布蘭特正2,131,0,131,元大-台南,2024-12-06,9896
00878,國泰永續高股息,121,38,83,元大-台南,2024-12-06,9896
2025,千興,70,0,70,元大-台南,2024-12-06,9896
00919,群益台灣精選高息,63,5,58,元大-台南,2024-12-06,9896
00953B,群益優選非投等債,51,0,51,元大-台南,2024-12-06,9896
2354,鴻準,326,282,44,元大-台南,2024-12-06,9896
2618,長榮航,44,4,40,元大-台南,2024-12-06,9896
00962,台新AI優息動能,37,0,37,元大-台南,2024-12-06,9896
00706L,期元大S＆P日圓正2,30,0,30,元大-台南,2024-12-06,9896
3706,神達,169,140,29,元大-台南,2024-12-06,9896
2317,鴻海,43,15,28,元大-台南,2024-12-06,9896
4906,正文,27,0,27,元大-台南,2024-12-06,9896
2408,南亞科,28,3,25,元大-台南,2024-12-06,9896
1605,華新,33,9,24,元大-台南,2024-12-06,9896
2303,聯電,26,3,23,元大-台南,2024-12-06,9896
1815,富喬,62,40,22,元大-台南,2024-12-06,9896
2516,新建,20,0,20,元大-台南,2024-12-06,9896
2886,兆豐金,20,1,19,元大-台南,2024-12-06,9896
00637L,元大滬深300正2,21,3,18,元大-台南,2024-12-06,9896
3035,智原,17,0,17,元大-台南,2024-12-06,9896
6657,華安,17,0,17,元大-台南,2024-12-06,9896
8111,立��,23,6,17,元大-台南,2024-12-06,9896
00712,復華富時不動產,14,0,14,元大-台南,2024-12-06,9896
1708,東鹼,13,0,13,元大-台南,2024-12-06,9896
4743,合一,29,16,13,元大-台南,2024-12-06,9896
00915,凱基優選高股息30,12,0,12,元大-台南,2024-12-06,9896
4968,立積,30,18,12,元大-台南,2024-12-06,9896
3508,位速,12,0,12,元大-台南,2024-12-06,9896
3689,湧德,14,2,12,元大-台南,2024-12-06,9896
2834,臺企銀,12,1,11,元大-台南,2024-12-06,9896
2646,星宇航空,14,3,11,元大-台南,2024-12-06,9896
4909,新復興,12,1,11,元大-台南,2024-12-06,9896
0056,元大高股息,35,24,11,元大-台南,2024-12-06,9896
6776,展�眥篕�,10,0,10,元大-台南,2024-12-06,9896
2812,台中銀,10,0,10,元大-台南,2024-12-06,9896
00932,兆豐永續高息等權,10,0,10,元大-台南,2024-12-06,9896
2002,中鋼,12,3,9,元大-台南,2024-12-06,9896
00830,國泰費城半導體,9,0,9,元大-台南,2024-12-06,9896
8097,常珵,16,7,9,元大-台南,2024-12-06,9896
2474,可成,10,2,8,元大-台南,2024-12-06,9896
4123,晟德,10,2,8,元大-台南,2024-12-06,9896
4588,玖鼎電力,10,2,8,元大-台南,2024-12-06,9896
1536,和大,10,2,8,元大-台南,2024-12-06,9896
2375,凱美,12,4,8,元大-台南,2024-12-06,9896
2535,達欣工,10,2,8,元大-台南,2024-12-06,9896
8069,元太,8,0,8,元大-台南,2024-12-06,9896
3019,亞光,7,0,7,元大-台南,2024-12-06,9896
1802,台玻,10,3,7,元大-台南,2024-12-06,9896
3265,台星科,15,8,7,元大-台南,2024-12-06,9896
00715L,期街口布蘭特正2,92,4,88,元大-台南,2024-12-09,9896
2025,千興,68,0,68,元大-台南,2024-12-09,9896
00919,群益台灣精選高息,78,14,64,元大-台南,2024-12-09,9896
2883,凱基金,75,13,62,元大-台南,2024-12-09,9896
00915,凱基優選高股息30,53,0,53,元大-台南,2024-12-09,9896
1609,大亞,51,0,51,元大-台南,2024-12-09,9896
00878,國泰永續高股息,58,13,45,元大-台南,2024-12-09,9896
1301,台塑,40,9,31,元大-台南,2024-12-09,9896
2449,京元電子,30,0,30,元大-台南,2024-12-09,9896
00687B,國泰20年美債,32,3,29,元大-台南,2024-12-09,9896
2834,臺企銀,35,8,27,元大-台南,2024-12-09,9896
2317,鴻海,40,14,26,元大-台南,2024-12-09,9896
4906,正文,24,0,24,元大-台南,2024-12-09,9896
00954,中信日本半導體,23,0,23,元大-台南,2024-12-09,9896
2356,英業達,44,23,21,元大-台南,2024-12-09,9896
2892,第一金,21,0,21,元大-台南,2024-12-09,9896
00946,群益科技高息成長,22,2,20,元大-台南,2024-12-09,9896
00941,中信上游半導體,20,0,20,元大-台南,2024-12-09,9896
2801,彰銀,20,0,20,元大-台南,2024-12-09,9896
4526,東台,22,2,20,元大-台南,2024-12-09,9896
0056,元大高股息,21,1,20,元大-台南,2024-12-09,9896
00953B,群益優選非投等債,19,0,19,元大-台南,2024-12-09,9896
2002,中鋼,19,1,18,元大-台南,2024-12-09,9896
00918,大華優利高填息30,22,5,17,元大-台南,2024-12-09,9896
00642U,期元大S＆P石油,16,0,16,元大-台南,2024-12-09,9896
2436,偉詮電,25,9,16,元大-台南,2024-12-09,9896
2891,中信金,18,3,15,元大-台南,2024-12-09,9896
3323,加百裕,21,6,15,元大-台南,2024-12-09,9896
9105,泰金寶-DR,19,5,14,元大-台南,2024-12-09,9896
00905,FT臺灣Smart,13,0,13,元大-台南,2024-12-09,9896
1718,中纖,13,0,13,元大-台南,2024-12-09,9896
2344,華邦電,19,6,13,元大-台南,2024-12-09,9896
2354,鴻準,66,53,13,元大-台南,2024-12-09,9896
3037,欣興,13,1,12,元大-台南,2024-12-09,9896
1815,富喬,29,17,12,元大-台南,2024-12-09,9896
5309,系統電,22,10,12,元大-台南,2024-12-09,9896
2312,金寶,24,13,11,元大-台南,2024-12-09,9896
2515,中工,11,0,11,元大-台南,2024-12-09,9896
6188,廣明,11,0,11,元大-台南,2024-12-09,9896
00713,元大台灣高息低波,12,1,11,元大-台南,2024-12-09,9896
1447,力鵬,10,0,10,元大-台南,2024-12-09,9896
1584,精剛,10,0,10,元大-台南,2024-12-09,9896
3508,位速,10,0,10,元大-台南,2024-12-09,9896
2014,中鴻,10,0,10,元大-台南,2024-12-09,9896
6168,宏齊,10,0,10,元大-台南,2024-12-09,9896
1708,東鹼,18,8,10,元大-台南,2024-12-09,9896
1326,台化,11,2,9,元大-台南,2024-12-09,9896
3260,威剛,15,6,9,元大-台南,2024-12-09,9896
2474,可成,11,2,9,元大-台南,2024-12-09,9896
4123,晟德,9,0,9,元大-台南,2024-12-09,9896
00918,大華優利高填息30,163,0,163,元大-台南,2024-12-10,9896
2883,凱基金,153,8,145,元大-台南,2024-12-10,9896
2025,千興,79,0,79,元大-台南,2024-12-10,9896
00679B,元大美債20年,104,38,66,元大-台南,2024-12-10,9896
3706,神達,155,90,65,元大-台南,2024-12-10,9896
2618,長榮航,72,20,52,元大-台南,2024-12-10,9896
2317,鴻海,65,22,43,元大-台南,2024-12-10,9896
0056,元大高股息,62,19,43,元大-台南,2024-12-10,9896
2834,臺企銀,41,0,41,元大-台南,2024-12-10,9896
2609,陽明,91,50,41,元大-台南,2024-12-10,9896
00643,群益深証中小,40,0,40,元大-台南,2024-12-10,9896
3231,緯創,45,6,39,元大-台南,2024-12-10,9896
1815,富喬,51,12,39,元大-台南,2024-12-10,9896
00919,群益台灣精選高息,42,14,28,元大-台南,2024-12-10,9896
2354,鴻準,31,4,27,元大-台南,2024-12-10,9896
2352,佳世達,24,0,24,元大-台南,2024-12-10,9896
2388,威盛,30,8,22,元大-台南,2024-12-10,9896
2615,萬海,22,0,22,元大-台南,2024-12-10,9896
9105,泰金寶-DR,60,39,21,元大-台南,2024-12-10,9896
00915,凱基優選高股息30,22,2,20,元大-台南,2024-12-10,9896
00965,元大航太防衛科技,26,7,19,元大-台南,2024-12-10,9896
4931,新盛力,25,6,19,元大-台南,2024-12-10,9896
00753L,中信中國50正2,59,40,19,元大-台南,2024-12-10,9896
8054,安國,30,11,19,元大-台南,2024-12-10,9896
1314,中石化,30,12,18,元大-台南,2024-12-10,9896
2474,可成,18,0,18,元大-台南,2024-12-10,9896
2880,華南金,20,3,17,元大-台南,2024-12-10,9896
00959B,大華投等美債15Y+,16,0,16,元大-台南,2024-12-10,9896
8249,菱光,20,4,16,元大-台南,2024-12-10,9896
1449,佳和,18,2,16,元大-台南,2024-12-10,9896
2449,京元電子,17,1,16,元大-台南,2024-12-10,9896
1101,台泥,15,0,15,元大-台南,2024-12-10,9896
4909,新復興,17,2,15,元大-台南,2024-12-10,9896
6282,康舒,15,0,15,元大-台南,2024-12-10,9896
2014,中鴻,15,0,15,元大-台南,2024-12-10,9896
1584,精剛,15,0,15,元大-台南,2024-12-10,9896
00909,國泰數位支付服務,15,0,15,元大-台南,2024-12-10,9896
3481,群創,25,11,14,元大-台南,2024-12-10,9896
2610,華航,31,17,14,元大-台南,2024-12-10,9896
2603,長榮,19,6,13,元大-台南,2024-12-10,9896
00968B,元大優息投等債,12,0,12,元大-台南,2024-12-10,9896
6657,華安,12,0,12,元大-台南,2024-12-10,9896
2353,宏��,35,24,11,元大-台南,2024-12-10,9896
2303,聯電,43,32,11,元大-台南,2024-12-10,9896
1326,台化,16,5,11,元大-台南,2024-12-10,9896
9941,裕融,11,0,11,元大-台南,2024-12-10,9896
2867,三商壽,30,20,10,元大-台南,2024-12-10,9896
00930,永豐ESG低碳高息,10,0,10,元大-台南,2024-12-10,9896
00954,中信日本半導體,10,0,10,元大-台南,2024-12-10,9896
5347,世界,10,0,10,元大-台南,2024-12-10,9896
00918,大華優利高填息30,179,2,177,元大-台南,2024-12-11,9896
00930,永豐ESG低碳高息,101,0,101,元大-台南,2024-12-11,9896
00687B,國泰20年美債,113,14,99,元大-台南,2024-12-11,9896
2317,鴻海,100,16,84,元大-台南,2024-12-11,9896
00878,國泰永續高股息,73,6,67,元大-台南,2024-12-11,9896
00919,群益台灣精選高息,102,39,63,元大-台南,2024-12-11,9896
2344,華邦電,67,8,59,元大-台南,2024-12-11,9896
2002,中鋼,58,1,57,元大-台南,2024-12-11,9896
1303,南亞,54,1,53,元大-台南,2024-12-11,9896
0056,元大高股息,62,13,49,元大-台南,2024-12-11,9896
00655L,國泰中國A50正2,51,10,41,元大-台南,2024-12-11,9896
00933B,國泰10Y+金融債,35,0,35,元大-台南,2024-12-11,9896
00940,元大台灣價值高息,37,4,33,元大-台南,2024-12-11,9896
1605,華新,29,0,29,元大-台南,2024-12-11,9896
2880,華南金,31,4,27,元大-台南,2024-12-11,9896
00665L,富邦�琤肭磪囓�2,31,7,24,元大-台南,2024-12-11,9896
6244,茂迪,23,0,23,元大-台南,2024-12-11,9896
00679B,元大美債20年,23,0,23,元大-台南,2024-12-11,9896
00915,凱基優選高股息30,22,1,21,元大-台南,2024-12-11,9896
1101,台泥,20,0,20,元大-台南,2024-12-11,9896
2883,凱基金,20,0,20,元大-台南,2024-12-11,9896
2382,廣達,20,1,19,元大-台南,2024-12-11,9896
2618,長榮航,53,35,18,元大-台南,2024-12-11,9896
1584,精剛,16,0,16,元大-台南,2024-12-11,9896
1326,台化,21,6,15,元大-台南,2024-12-11,9896
2409,友達,22,7,15,元大-台南,2024-12-11,9896
2892,第一金,17,2,15,元大-台南,2024-12-11,9896
2303,聯電,41,27,14,元大-台南,2024-12-11,9896
1449,佳和,14,1,13,元大-台南,2024-12-11,9896
2615,萬海,19,6,13,元大-台南,2024-12-11,9896
2605,新興,13,0,13,元大-台南,2024-12-11,9896
6174,安��,13,0,13,元大-台南,2024-12-11,9896
2371,大同,12,0,12,元大-台南,2024-12-11,9896
00968B,元大優息投等債,17,5,12,元大-台南,2024-12-11,9896
6191,精成科,12,0,12,元大-台南,2024-12-11,9896
6558,興能高,20,8,12,元大-台南,2024-12-11,9896
5328,華容,22,10,12,元大-台南,2024-12-11,9896
6274,台燿,26,14,12,元大-台南,2024-12-11,9896
2449,京元電子,13,2,11,元大-台南,2024-12-11,9896
00713,元大台灣高息低波,13,2,11,元大-台南,2024-12-11,9896
00922,國泰台灣領袖50,11,0,11,元大-台南,2024-12-11,9896
2401,凌陽,11,0,11,元大-台南,2024-12-11,9896
2867,三商壽,11,0,11,元大-台南,2024-12-11,9896
2610,華航,32,21,11,元大-台南,2024-12-11,9896
5309,系統電,13,2,11,元大-台南,2024-12-11,9896
1519,華城,10,0,10,元大-台南,2024-12-11,9896
2547,日勝生,10,0,10,元大-台南,2024-12-11,9896
00632R,元大台灣50反1,10,0,10,元大-台南,2024-12-11,9896
00965,元大航太防衛科技,13,3,10,元大-台南,2024-12-11,9896
3260,威剛,15,5,10,元大-台南,2024-12-11,9896
00950B,凱基A級公司債,175,0,175,元大-台南,2024-12-12,9896
00937B,群益ESG投等債20,201,63,138,元大-台南,2024-12-12,9896
00679B,元大美債20年,120,1,119,元大-台南,2024-12-12,9896
2002,中鋼,80,0,80,元大-台南,2024-12-12,9896
00687B,國泰20年美債,84,5,79,元大-台南,2024-12-12,9896
2382,廣達,82,4,78,元大-台南,2024-12-12,9896
00919,群益台灣精選高息,92,17,75,元大-台南,2024-12-12,9896
6177,達麗,55,0,55,元大-台南,2024-12-12,9896
00688L,國泰20年美債正2,52,0,52,元大-台南,2024-12-12,9896
2027,大成鋼,53,2,51,元大-台南,2024-12-12,9896
2888,新光金,50,5,45,元大-台南,2024-12-12,9896
00673R,期元大S＆P原油反1,32,0,32,元大-台南,2024-12-12,9896
2731,雄獅,30,0,30,元大-台南,2024-12-12,9896
2317,鴻海,47,17,30,元大-台南,2024-12-12,9896
00918,大華優利高填息30,29,1,28,元大-台南,2024-12-12,9896
5905,南仁湖,28,0,28,元大-台南,2024-12-12,9896
2367,燿華,26,1,25,元大-台南,2024-12-12,9896
2312,金寶,32,10,22,元大-台南,2024-12-12,9896
4968,立積,31,9,22,元大-台南,2024-12-12,9896
4526,東台,22,0,22,元大-台南,2024-12-12,9896
1301,台塑,32,11,21,元大-台南,2024-12-12,9896
00713,元大台灣高息低波,21,0,21,元大-台南,2024-12-12,9896
2892,第一金,25,4,21,元大-台南,2024-12-12,9896
3013,晟銘電,33,13,20,元大-台南,2024-12-12,9896
1464,得力,20,1,19,元大-台南,2024-12-12,9896
8111,立��,20,2,18,元大-台南,2024-12-12,9896
6558,興能高,32,15,17,元大-台南,2024-12-12,9896
3607,谷崧,17,0,17,元大-台南,2024-12-12,9896
00915,凱基優選高股息30,23,6,17,元大-台南,2024-12-12,9896
00933B,國泰10Y+金融債,16,0,16,元大-台南,2024-12-12,9896
8249,菱光,16,0,16,元大-台南,2024-12-12,9896
6446,藥華藥,16,0,16,元大-台南,2024-12-12,9896
2316,楠梓電,15,0,15,元大-台南,2024-12-12,9896
2328,廣宇,23,10,13,元大-台南,2024-12-12,9896
6152,百一,20,7,13,元大-台南,2024-12-12,9896
2867,三商壽,12,0,12,元大-台南,2024-12-12,9896
6684,安格,12,0,12,元大-台南,2024-12-12,9896
2609,陽明,37,25,12,元大-台南,2024-12-12,9896
1309,台達化,12,1,11,元大-台南,2024-12-12,9896
2468,華經,18,7,11,元大-台南,2024-12-12,9896
3576,聯合再生,11,0,11,元大-台南,2024-12-12,9896
2363,矽統,12,1,11,元大-台南,2024-12-12,9896
8069,元太,12,2,10,元大-台南,2024-12-12,9896
00969B,元大零息超長美債,11,1,10,元大-台南,2024-12-12,9896
2348,海悅,15,5,10,元大-台南,2024-12-12,9896
2457,飛宏,10,0,10,元大-台南,2024-12-12,9896
6274,台燿,23,13,10,元大-台南,2024-12-12,9896
2405,輔信,10,0,10,元大-台南,2024-12-12,9896
1611,中電,10,0,10,元大-台南,2024-12-12,9896
9934,成霖,10,0,10,元大-台南,2024-12-12,9896
00680L,元大美債20正2,267,7,260,元大-台南,2024-12-13,9896
00937B,群益ESG投等債20,191,0,191,元大-台南,2024-12-13,9896
2888,新光金,123,9,114,元大-台南,2024-12-13,9896
00919,群益台灣精選高息,109,1,108,元大-台南,2024-12-13,9896
00915,凱基優選高股息30,104,0,104,元大-台南,2024-12-13,9896
00772B,中信高評級公司債,103,0,103,元大-台南,2024-12-13,9896
00918,大華優利高填息30,91,1,90,元大-台南,2024-12-13,9896
00950B,凱基A級公司債,55,0,55,元大-台南,2024-12-13,9896
4931,新盛力,79,24,55,元大-台南,2024-12-13,9896
2317,鴻海,75,22,53,元大-台南,2024-12-13,9896
0056,元大高股息,55,6,49,元大-台南,2024-12-13,9896
2303,聯電,129,83,46,元大-台南,2024-12-13,9896
00878,國泰永續高股息,55,9,46,元大-台南,2024-12-13,9896
00679B,元大美債20年,51,6,45,元大-台南,2024-12-13,9896
3706,神達,113,68,45,元大-台南,2024-12-13,9896
2027,大成鋼,46,2,44,元大-台南,2024-12-13,9896
3481,群創,45,9,36,元大-台南,2024-12-13,9896
6244,茂迪,33,0,33,元大-台南,2024-12-13,9896
3313,斐成,29,0,29,元大-台南,2024-12-13,9896
1524,耿鼎,38,12,26,元大-台南,2024-12-13,9896
1605,華新,27,1,26,元大-台南,2024-12-13,9896
00713,元大台灣高息低波,27,2,25,元大-台南,2024-12-13,9896
00882,中信中國高股息,24,0,24,元大-台南,2024-12-13,9896
2002,中鋼,22,0,22,元大-台南,2024-12-13,9896
2353,宏��,22,0,22,元大-台南,2024-12-13,9896
6182,合晶,23,4,19,元大-台南,2024-12-13,9896
2883,凱基金,22,3,19,元大-台南,2024-12-13,9896
2368,金像電,31,12,19,元大-台南,2024-12-13,9896
00933B,國泰10Y+金融債,17,0,17,元大-台南,2024-12-13,9896
2313,華通,17,0,17,元大-台南,2024-12-13,9896
00969B,元大零息超長美債,16,0,16,元大-台南,2024-12-13,9896
00948B,中信優息投資級債,15,0,15,元大-台南,2024-12-13,9896
00738U,期元大道瓊白銀,14,0,14,元大-台南,2024-12-13,9896
2515,中工,14,0,14,元大-台南,2024-12-13,9896
5392,能率,16,2,14,元大-台南,2024-12-13,9896
3491,昇達科,14,1,13,元大-台南,2024-12-13,9896
2867,三商壽,13,0,13,元大-台南,2024-12-13,9896
4906,正文,13,0,13,元大-台南,2024-12-13,9896
6418,詠昇,20,8,12,元大-台南,2024-12-13,9896
6684,安格,12,0,12,元大-台南,2024-12-13,9896
8076,伍豐,12,0,12,元大-台南,2024-12-13,9896
3231,緯創,16,4,12,元大-台南,2024-12-13,9896
2356,英業達,14,3,11,元大-台南,2024-12-13,9896
2324,仁寶,15,4,11,元大-台南,2024-12-13,9896
2332,友訊,22,11,11,元大-台南,2024-12-13,9896
6282,康舒,11,0,11,元大-台南,2024-12-13,9896
2834,臺企銀,11,0,11,元大-台南,2024-12-13,9896
1326,台化,11,0,11,元大-台南,2024-12-13,9896
00687B,國泰20年美債,11,0,11,元大-台南,2024-12-13,9896
3037,欣興,10,0,10,元大-台南,2024-12-13,9896
00680L,元大美債20正2,313,8,305,元大-台南,2024-12-16,9896
00968B,元大優息投等債,304,1,303,元大-台南,2024-12-16,9896
00937B,群益ESG投等債20,255,0,255,元大-台南,2024-12-16,9896
00679B,元大美債20年,298,103,195,元大-台南,2024-12-16,9896
00950B,凱基A級公司債,150,0,150,元大-台南,2024-12-16,9896
00918,大華優利高填息30,151,2,149,元大-台南,2024-12-16,9896
00772B,中信高評級公司債,110,0,110,元大-台南,2024-12-16,9896
00959B,大華投等美債15Y+,104,16,88,元大-台南,2024-12-16,9896
00919,群益台灣精選高息,83,0,83,元大-台南,2024-12-16,9896
2317,鴻海,88,26,62,元大-台南,2024-12-16,9896
0056,元大高股息,62,12,50,元大-台南,2024-12-16,9896
00688L,國泰20年美債正2,43,0,43,元大-台南,2024-12-16,9896
2002,中鋼,46,3,43,元大-台南,2024-12-16,9896
00687B,國泰20年美債,52,14,38,元大-台南,2024-12-16,9896
1605,華新,46,13,33,元大-台南,2024-12-16,9896
6657,華安,33,0,33,元大-台南,2024-12-16,9896
00673R,期元大S＆P原油反1,31,0,31,元大-台南,2024-12-16,9896
8429,金麗-KY,32,1,31,元大-台南,2024-12-16,9896
2449,京元電子,32,1,31,元大-台南,2024-12-16,9896
2511,太子,30,0,30,元大-台南,2024-12-16,9896
2618,長榮航,36,11,25,元大-台南,2024-12-16,9896
00878,國泰永續高股息,51,28,23,元大-台南,2024-12-16,9896
2609,陽明,69,47,22,元大-台南,2024-12-16,9896
8404,百和興業-KY,20,0,20,元大-台南,2024-12-16,9896
00945B,凱基美國非投等債,20,0,20,元大-台南,2024-12-16,9896
1714,和桐,20,0,20,元大-台南,2024-12-16,9896
6216,居易,18,0,18,元大-台南,2024-12-16,9896
00946,群益科技高息成長,17,0,17,元大-台南,2024-12-16,9896
6684,安格,17,0,17,元大-台南,2024-12-16,9896
1785,光洋科,32,16,16,元大-台南,2024-12-16,9896
00900,富邦特選高股息30,16,0,16,元大-台南,2024-12-16,9896
5481,新華,17,1,16,元大-台南,2024-12-16,9896
2027,大成鋼,20,4,16,元大-台南,2024-12-16,9896
2409,友達,22,7,15,元大-台南,2024-12-16,9896
3313,斐成,14,0,14,元大-台南,2024-12-16,9896
2356,英業達,28,15,13,元大-台南,2024-12-16,9896
2382,廣達,28,15,13,元大-台南,2024-12-16,9896
1802,台玻,107,94,13,元大-台南,2024-12-16,9896
00665L,富邦�琤肭磪囓�2,24,11,13,元大-台南,2024-12-16,9896
2316,楠梓電,17,4,13,元大-台南,2024-12-16,9896
00830,國泰費城半導體,12,0,12,元大-台南,2024-12-16,9896
2455,全新,17,5,12,元大-台南,2024-12-16,9896
00882,中信中國高股息,12,0,12,元大-台南,2024-12-16,9896
4909,新復興,11,0,11,元大-台南,2024-12-16,9896
2363,矽統,17,6,11,元大-台南,2024-12-16,9896
3540,曜越,11,0,11,元大-台南,2024-12-16,9896
00910,第一金太空衛星,11,0,11,元大-台南,2024-12-16,9896
3450,聯鈞,26,15,11,元大-台南,2024-12-16,9896
2731,雄獅,10,0,10,元大-台南,2024-12-16,9896
2912,統一超,10,0,10,元大-台南,2024-12-16,9896
00680L,元大美債20正2,305,0,305,元大-台南,2024-12-17,9896
00937B,群益ESG投等債20,267,0,267,元大-台南,2024-12-17,9896
00878,國泰永續高股息,217,14,203,元大-台南,2024-12-17,9896
00918,大華優利高填息30,191,14,177,元大-台南,2024-12-17,9896
00950B,凱基A級公司債,170,5,165,元大-台南,2024-12-17,9896
00706L,期元大S＆P日圓正2,153,0,153,元大-台南,2024-12-17,9896
2834,臺企銀,130,0,130,元大-台南,2024-12-17,9896
2409,友達,115,0,115,元大-台南,2024-12-17,9896
00930,永豐ESG低碳高息,103,0,103,元大-台南,2024-12-17,9896
00713,元大台灣高息低波,85,8,77,元大-台南,2024-12-17,9896
0056,元大高股息,82,9,73,元大-台南,2024-12-17,9896
00915,凱基優選高股息30,62,0,62,元大-台南,2024-12-17,9896
00905,FT臺灣Smart,59,0,59,元大-台南,2024-12-17,9896
2034,允強,45,0,45,元大-台南,2024-12-17,9896
00665L,富邦�琤肭磪囓�2,41,0,41,元大-台南,2024-12-17,9896
2352,佳世達,41,0,41,元大-台南,2024-12-17,9896
2883,凱基金,38,0,38,元大-台南,2024-12-17,9896
00673R,期元大S＆P原油反1,30,0,30,元大-台南,2024-12-17,9896
6657,華安,30,0,30,元大-台南,2024-12-17,9896
4974,亞泰,32,5,27,元大-台南,2024-12-17,9896
3694,海華,27,0,27,元大-台南,2024-12-17,9896
00687B,國泰20年美債,36,10,26,元大-台南,2024-12-17,9896
00909,國泰數位支付服務,24,1,23,元大-台南,2024-12-17,9896
00895,富邦未來車,21,2,19,元大-台南,2024-12-17,9896
9941,裕融,19,0,19,元大-台南,2024-12-17,9896
3481,群創,39,21,18,元大-台南,2024-12-17,9896
6446,藥華藥,22,4,18,元大-台南,2024-12-17,9896
00948B,中信優息投資級債,18,0,18,元大-台南,2024-12-17,9896
4533,協易機,20,2,18,元大-台南,2024-12-17,9896
9105,泰金寶-DR,65,48,17,元大-台南,2024-12-17,9896
3413,京鼎,16,0,16,元大-台南,2024-12-17,9896
4510,高鋒,72,57,15,元大-台南,2024-12-17,9896
6234,高僑,15,0,15,元大-台南,2024-12-17,9896
4114,健喬,25,10,15,元大-台南,2024-12-17,9896
8074,鉅橡,15,0,15,元大-台南,2024-12-17,9896
00720B,元大投資級公司債,27,13,14,元大-台南,2024-12-17,9896
6274,台燿,17,3,14,元大-台南,2024-12-17,9896
00882,中信中國高股息,14,0,14,元大-台南,2024-12-17,9896
2882,國泰金,14,0,14,元大-台南,2024-12-17,9896
2374,佳能,53,40,13,元大-台南,2024-12-17,9896
2317,鴻海,32,19,13,元大-台南,2024-12-17,9896
00959B,大華投等美債15Y+,12,0,12,元大-台南,2024-12-17,9896
5871,中租-KY,12,1,11,元大-台南,2024-12-17,9896
3706,神達,75,63,12,元大-台南,2024-12-17,9896
2646,星宇航空,11,0,11,元大-台南,2024-12-17,9896
1584,精剛,11,0,11,元大-台南,2024-12-17,9896
1605,華新,12,1,11,元大-台南,2024-12-17,9896
2892,第一金,11,0,11,元大-台南,2024-12-17,9896
00946,群益科技高息成長,10,0,10,元大-台南,2024-12-17,9896
1718,中纖,10,0,10,元大-台南,2024-12-17,9896
00953B,群益優選非投等債,214,0,214,元大-台南,2024-12-18,9896
00950B,凱基A級公司債,200,0,200,元大-台南,2024-12-18,9896
00918,大華優利高填息30,195,8,187,元大-台南,2024-12-18,9896
2511,太子,116,0,116,元大-台南,2024-12-18,9896
00937B,群益ESG投等債20,114,0,114,元大-台南,2024-12-18,9896
2303,聯電,152,44,108,元大-台南,2024-12-18,9896
00959B,大華投等美債15Y+,100,0,100,元大-台南,2024-12-18,9896
6806,森崴能源,86,3,83,元大-台南,2024-12-18,9896
00679B,元大美債20年,106,37,69,元大-台南,2024-12-18,9896
2891,中信金,61,5,56,元大-台南,2024-12-18,9896
3694,海華,56,2,54,元大-台南,2024-12-18,9896
00712,復華富時不動產,49,0,49,元大-台南,2024-12-18,9896
00687B,國泰20年美債,55,9,46,元大-台南,2024-12-18,9896
6657,華安,40,0,40,元大-台南,2024-12-18,9896
5309,系統電,45,6,39,元大-台南,2024-12-18,9896
4576,大銀微系統,63,25,38,元大-台南,2024-12-18,9896
2353,宏��,32,0,32,元大-台南,2024-12-18,9896
2409,友達,31,0,31,元大-台南,2024-12-18,9896
00900,富邦特選高股息30,25,0,25,元大-台南,2024-12-18,9896
00919,群益台灣精選高息,32,9,23,元大-台南,2024-12-18,9896
00676R,富邦臺灣加權反1,20,0,20,元大-台南,2024-12-18,9896
1718,中纖,20,0,20,元大-台南,2024-12-18,9896
2027,大成鋼,20,2,18,元大-台南,2024-12-18,9896
4974,亞泰,23,5,18,元大-台南,2024-12-18,9896
00713,元大台灣高息低波,20,2,18,元大-台南,2024-12-18,9896
3706,神達,53,36,17,元大-台南,2024-12-18,9896
2609,陽明,47,31,16,元大-台南,2024-12-18,9896
1785,光洋科,31,16,15,元大-台南,2024-12-18,9896
00720B,元大投資級公司債,14,0,14,元大-台南,2024-12-18,9896
2615,萬海,16,2,14,元大-台南,2024-12-18,9896
3059,華晶科,13,0,13,元大-台南,2024-12-18,9896
3413,京鼎,13,0,13,元大-台南,2024-12-18,9896
2354,鴻準,15,3,12,元大-台南,2024-12-18,9896
6187,萬潤,12,0,12,元大-台南,2024-12-18,9896
5272,笙科,12,0,12,元大-台南,2024-12-18,9896
1605,華新,15,3,12,元大-台南,2024-12-18,9896
2312,金寶,13,2,11,元大-台南,2024-12-18,9896
2903,遠百,10,0,10,元大-台南,2024-12-18,9896
8028,昇陽半導體,11,1,10,元大-台南,2024-12-18,9896
1303,南亞,18,8,10,元大-台南,2024-12-18,9896
00830,國泰費城半導體,9,0,9,元大-台南,2024-12-18,9896
6234,高僑,9,0,9,元大-台南,2024-12-18,9896
2392,正崴,12,3,9,元大-台南,2024-12-18,9896
0056,元大高股息,18,10,8,元大-台南,2024-12-18,9896
6531,愛普*,10,2,8,元大-台南,2024-12-18,9896
2892,第一金,8,0,8,元大-台南,2024-12-18,9896
2464,盟立,9,1,8,元大-台南,2024-12-18,9896
00680L,元大美債20正2,8,0,8,元大-台南,2024-12-18,9896
3499,環天科,8,0,8,元大-台南,2024-12-18,9896
8476,台境*,8,0,8,元大-台南,2024-12-18,9896
00937B,群益ESG投等債20,392,0,392,元大-台南,2024-12-19,9896
2344,華邦電,306,4,302,元大-台南,2024-12-19,9896
00918,大華優利高填息30,200,11,189,元大-台南,2024-12-19,9896
00679B,元大美債20年,188,18,170,元大-台南,2024-12-19,9896
00950B,凱基A級公司債,111,0,111,元大-台南,2024-12-19,9896
2883,凱基金,104,3,101,元大-台南,2024-12-19,9896
00712,復華富時不動產,93,0,93,元大-台南,2024-12-19,9896
00878,國泰永續高股息,86,23,63,元大-台南,2024-12-19,9896
2337,旺宏,51,0,51,元大-台南,2024-12-19,9896
1444,力麗,50,0,50,元大-台南,2024-12-19,9896
00680L,元大美債20正2,62,14,48,元大-台南,2024-12-19,9896
00919,群益台灣精選高息,97,50,47,元大-台南,2024-12-19,9896
2382,廣達,57,12,45,元大-台南,2024-12-19,9896
2888,新光金,43,0,43,元大-台南,2024-12-19,9896
2409,友達,37,0,37,元大-台南,2024-12-19,9896
00953B,群益優選非投等債,33,0,33,元大-台南,2024-12-19,9896
2317,鴻海,49,17,32,元大-台南,2024-12-19,9896
1718,中纖,31,0,31,元大-台南,2024-12-19,9896
4123,晟德,30,0,30,元大-台南,2024-12-19,9896
0056,元大高股息,35,5,30,元大-台南,2024-12-19,9896
2618,長榮航,37,9,28,元大-台南,2024-12-19,9896
2609,陽明,41,14,27,元大-台南,2024-12-19,9896
00713,元大台灣高息低波,28,3,25,元大-台南,2024-12-19,9896
3313,斐成,25,0,25,元大-台南,2024-12-19,9896
2374,佳能,163,139,24,元大-台南,2024-12-19,9896
00892,富邦台灣半導體,23,0,23,元大-台南,2024-12-19,9896
2845,遠東銀,22,0,22,元大-台南,2024-12-19,9896
2633,台灣高鐵,22,0,22,元大-台南,2024-12-19,9896
1301,台塑,34,13,21,元大-台南,2024-12-19,9896
2881,富邦金,21,0,21,元大-台南,2024-12-19,9896
00909,國泰數位支付服務,20,1,19,元大-台南,2024-12-19,9896
2349,錸德,18,0,18,元大-台南,2024-12-19,9896
2002,中鋼,18,0,18,元大-台南,2024-12-19,9896
3211,順達,32,15,17,元大-台南,2024-12-19,9896
00915,凱基優選高股息30,18,1,17,元大-台南,2024-12-19,9896
2886,兆豐金,17,0,17,元大-台南,2024-12-19,9896
5880,合庫金,17,0,17,元大-台南,2024-12-19,9896
00933B,國泰10Y+金融債,16,0,16,元大-台南,2024-12-19,9896
00922,國泰台灣領袖50,15,0,15,元大-台南,2024-12-19,9896
00948B,中信優息投資級債,13,0,13,元大-台南,2024-12-19,9896
00926,凱基全球菁英55,12,0,12,元大-台南,2024-12-19,9896
0050,元大台灣50,11,0,11,元大-台南,2024-12-19,9896
4576,大銀微系統,19,8,11,元大-台南,2024-12-19,9896
1609,大亞,11,0,11,元大-台南,2024-12-19,9896
00945B,凱基美國非投等債,11,0,11,元大-台南,2024-12-19,9896
006208,富邦台50,12,2,10,元大-台南,2024-12-19,9896
00930,永豐ESG低碳高息,10,0,10,元大-台南,2024-12-19,9896
6841,長佳智能,10,0,10,元大-台南,2024-12-19,9896
8105,凌巨,10,0,10,元大-台南,2024-12-19,9896
1528,恩德,10,0,10,元大-台南,2024-12-19,9896
